rank,tier,name,mmr,points,wins,losses,played,winrate,age
1,1,Hukuro,6108,3372,281,96,377,74.5%,4m
2,1,㞺㞺㞺㞺㞺㞺㞺㞺,5967,1910,184,41,225,81.8%,28m
3,1,[守护内心秩序]神气宝贝,5959,96,2,1,3,66.7%,35m
4,1,[2天一盘]Reyna,5945,2220,126,35,161,78.3%,22m
5,1,[一觞醉红颜]执笔道思念,5795,3379,613,178,791,77.5%,4m
6,1,iGXiGua,5739,1647,104,16,120,86.7%,1h
7,1,雅雅国国王王雅雅,5650,1499,86,33,119,72.3%,35m
8,1,[皇子]Fluctus,5623,756,20,3,23,87.0%,27m
9,1,[FDSJ]密苏里号,5568,750,17,10,27,63.0%,27m
10,1,[丨SLT丨]柳丁,5522,2986,229,160,389,58.9%,4m
11,1,[龍之帝国]泡默,5503,2040,92,34,126,73.0%,4m
12,1,石原里美,5494,2016,91,49,140,65.0%,21m
13,1,刘珂嘉最帅,5482,745,38,12,50,76.0%,28m
14,1,HenI,5471,96,3,2,5,60.0%,15m
15,1,[Solo]饿坏了的渐冻,5389,0,0,1,1,0.0%,1h
16,1,[你已经死啦]Ccli,5378,0,1,0,1,100.0%,21m
17,1,[青娱乐]IIIIIIIII,5370,0,0,1,1,0.0%,27m
18,1,[Ogier]反正我又不会玩,5358,272,7,4,11,63.6%,1h
19,1,WinterZerg,5350,1587,71,43,114,62.3%,27m
20,1,[ToHost]CLastZ,5334,2697,124,87,211,58.8%,4m
21,1,[猪一样的盟友]神一样的高手,5330,0,1,0,1,100.0%,30m
22,1,[Rhusky]TOTO,5329,1034,30,6,36,83.3%,22m
23,1,llllllllllll,5324,0,1,0,1,100.0%,34m
24,1,[狄恩]ScParadise,5320,0,0,1,1,0.0%,30m
25,1,[武汉理工大学]Serral,5296,1310,59,35,94,62.8%,37m
26,1,强者,5277,0,0,1,1,0.0%,30m
27,1,[人族是我爹]仲夏夜粉丝,5245,0,1,0,1,100.0%,27m
28,1,[圣光无用]鸿爪踏雪泥,5234,0,0,1,1,0.0%,35m
29,1,[心锁]花绮千雪,5231,0,0,1,1,0.0%,22m
30,1,llllllllllll,5222,46,2,0,2,100.0%,7m
31,1,[所向无前]虎牙丶苏黎,5221,424,22,8,30,73.3%,7m
32,1,混元星际大师兄,5219,2987,210,144,354,59.3%,4m
33,1,IIIIIIIIIIII,5215,228,5,5,10,50.0%,21m
34,1,[孙红雷]Braveheart,5213,1474,68,48,116,58.6%,4m
35,1,[ToHost]涂山红红,5211,627,28,8,36,77.8%,28m
36,1,[PTB]Heller,5202,2458,167,112,279,59.9%,4m
37,1,Clay,5201,0,1,0,1,100.0%,34m
38,1,[金灿灿狙击队]如是我闻,5200,837,36,32,68,52.9%,24m
39,1,[Shawk]Danny,5198,0,1,1,2,50.0%,7m
40,1,[Thpj]喵發,5195,46,1,1,2,50.0%,34m
40,1,[姜中实验小学]和泉纱雾,5195,0,0,1,1,0.0%,35m
42,1,[Hist]淄博虫王,5193,46,1,1,2,50.0%,35m
43,1,[恶狗服粗棍]GOLDMADMAN,5192,1299,150,111,261,57.5%,1h
44,1,孤鸿寄语,5189,2410,148,114,262,56.5%,27m
44,1,[哔哩哔哩乾杯]泽城美雪,5189,944,38,26,64,59.4%,22m
46,1,[金灿灿狙击队]FoolishYX,5187,132,4,4,8,50.0%,15m
47,1,[情谊至上]臭八八,5171,0,0,1,1,0.0%,22m
48,1,[我不是乱舞]狂花,5163,855,35,26,61,57.4%,37m
49,1,[SteEng]DEPEE,5148,2155,110,61,171,64.3%,4m
50,1,[华尔街股神]罗杰斯,5139,0,1,0,1,100.0%,1h
51,1,[节操满满的]犬走椛,5137,0,0,1,1,0.0%,37m
52,1,[小小怪怪]Dark,5131,735,32,32,64,50.0%,21m
53,1,[丨SLT丨]Kira,5126,864,36,18,54,66.7%,4m
54,1,[RSTAR]红柚依然,5124,791,29,32,61,47.5%,4m
55,1,shuailai,5122,2744,281,246,527,53.3%,4m
56,1,[tiandi]Mercury,5119,0,0,1,1,0.0%,22m
57,1,㞺㞺㞺㞺㞺㞺㞺㞺,5118,88,2,5,7,28.6%,7m
58,1,猪头肉好吃,5113,255,19,12,31,61.3%,7m
58,1,晚萤,5113,73,0,1,1,0.0%,30m
60,1,[SK]绯想剑,5112,422,45,29,74,60.8%,7m
61,1,[肉鸡的饲养]时崎狂三,5111,1846,172,111,283,60.8%,21m
62,1,光头苏哥,5110,92,2,1,3,66.7%,15m
63,1,[衣之咲璃乃]此号放假一天,5092,736,20,10,30,66.7%,34m
64,1,[IQ901]Hiiro,5090,0,0,1,1,0.0%,1h
65,1,Number,5089,1949,84,67,151,55.6%,22m
66,1,[羊驼羊驼羊]AbyssApostl,5072,967,27,28,55,49.1%,22m
66,1,[Hist]海王孙一峰,5072,494,13,6,19,68.4%,27m
68,1,[我们是无敌的]Morgana,5054,805,68,28,96,70.8%,4m
68,1,[我天生要凉]夜凌,5054,0,0,1,1,0.0%,30m
70,1,[白给的神]动作指导,5050,0,0,1,1,0.0%,35m
71,1,IIIiiIIIii,5048,0,0,1,1,0.0%,27m
72,1,救赎,5046,0,0,2,2,0.0%,30m
73,1,[星际圆永仁]鹿目小圆,5041,0,0,1,1,0.0%,15m
74,1,[JJFly]llllllllllll,5033,46,2,1,3,66.7%,37m
75,1,[炼狱修罗]猫爷,5028,956,80,23,103,77.7%,4m
75,1,[小狐狸真可爱]睡不醒的栗子喵,5028,0,3,2,5,60.0%,24m
77,1,[由我们重回]llllllllllll,5023,0,0,1,1,0.0%,35m
78,1,旁白白,5022,672,18,12,30,60.0%,15m
79,1,[SK]沉默之剑,5011,1305,49,29,78,62.8%,7m
80,1,[KPG]IIIIIIIIIII,5005,1870,137,58,195,70.3%,21m
81,1,Melody,5004,1024,45,29,74,60.8%,22m
81,1,[Shawk]HappyStar,5004,407,11,8,19,57.9%,21m
83,1,聋五,5000,0,1,0,1,100.0%,1h
83,1,[Ogier]肥雨涵,5000,0,0,1,1,0.0%,35m
85,1,[每日一问]暴雪今天倒闭了吗,4998,0,0,1,1,0.0%,7m
86,1,[目標諾森德]酒醉的蝴蝶,4997,44,2,2,4,50.0%,35m
87,1,艾蕾因奥克雷尔,4993,300,7,5,12,58.3%,37m
88,1,[神族真简单]MaXWell,4985,1178,91,65,156,58.3%,24m
88,1,[丨SLT丨]Yukki,4985,1389,60,44,104,57.7%,4m
90,1,[YU]新谷灯华,4978,0,1,0,1,100.0%,15m
91,1,Ange,4976,36,1,3,4,25.0%,37m
92,1,[YAYA]绚辻词,4974,0,0,1,1,0.0%,27m
93,1,[混元星际]蜡笔小燊,4973,703,33,20,53,62.3%,24m
93,1,[封弊者]三世,4973,0,1,0,1,100.0%,35m
95,1,[炼狱修罗]纯粹玩单机,4972,930,56,9,65,86.2%,4m
95,1,[白给滴神]血花缭乱,4972,877,41,24,65,63.1%,27m
97,1,大王让我来巡山,4964,0,0,1,1,0.0%,30m
98,1,[隐杀]xicn,4949,2000,89,85,174,51.1%,4m
99,1,[炼狱修罗]Protoss,4941,813,42,10,52,80.8%,4m
99,1,[Rhusky]相亲相爱好小孩,4941,0,0,1,1,0.0%,1h
101,1,[传说萌娘团]灵乌路空,4935,0,0,1,1,0.0%,22m
102,1,[星选组]坂上智代,4934,0,0,1,1,0.0%,34m
103,1,zyc,4931,92,2,6,8,25.0%,22m
104,1,[Marry]AlbaDiva,4929,0,0,1,1,0.0%,37m
105,1,[Beasty]吉大一彩笔,4928,1018,53,31,84,63.1%,7m
106,1,[你毒爆呢]llllllllllll,4926,0,0,1,1,0.0%,27m
107,1,[狗逼神族]StarKiller,4922,636,20,10,30,66.7%,35m
107,1,SOS,4922,494,13,13,26,50.0%,28m
109,1,[Rhusky]公子酥,4921,0,0,1,1,0.0%,27m
110,1,[LlQUlD]Brocky,4914,0,0,1,1,0.0%,35m
111,1,他人即地狱,4908,0,0,1,1,0.0%,27m
112,1,太太家的野男人,4906,1436,73,27,100,73.0%,4m
113,1,grezmuc,4903,506,13,4,17,76.5%,15m
114,1,[RyH键谈坊]寂寞杀手,4901,2689,576,441,1017,56.6%,4m
115,1,[b站直播搜索]已经废萌的花木兰,4896,0,0,2,2,0.0%,28m
116,1,[LDP]Twins,4891,0,0,1,1,0.0%,24m
117,1,幽兰黛尔,4890,0,0,1,1,0.0%,22m
118,1,[GHet]心如止水,4886,0,1,0,1,100.0%,7m
119,1,[Beasty]Damocles,4882,2737,196,161,357,54.9%,4m
119,1,[集英社]Shiori,4882,0,1,0,1,100.0%,30m
121,1,[曾经一群兔子]我不是兔子的兔子,4881,120,3,3,6,50.0%,35m
122,3,人类,4878,0,0,1,1,0.0%,16m
123,1,[Anticw]那个男人,4877,0,0,1,1,0.0%,22m
124,1,[a嗨了]我是黄哥,4876,1025,47,33,80,58.8%,4m
125,1,[BLaDe]小坚强,4872,564,15,13,28,53.6%,1h
126,1,Kratos,4869,46,1,7,8,12.5%,37m
126,1,[IMRTS]小纯洁,4869,0,0,1,1,0.0%,22m
128,1,苏州孙一峰,4859,0,2,3,5,40.0%,1h
129,1,[最后一次集结]奈乆千,4858,674,41,3,44,93.2%,37m
129,1,llllllllllll,4858,128,3,5,8,37.5%,22m
131,2,[Shawk]风间琉璃,4857,210,8,5,13,61.5%,7m
131,1,十年荣耀你我共勉,4857,0,1,0,1,100.0%,35m
133,1,[情谊至上]炒股养家,4850,0,0,1,1,0.0%,21m
134,3,爱神,4849,0,1,0,1,100.0%,16m
135,1,冷酷之盗贼,4848,340,9,9,18,50.0%,35m
136,1,[六爷唯一女粉]六花妹,4839,760,36,31,67,53.7%,22m
137,1,[情谊至上]永丿灭灬,4838,1508,76,58,134,56.7%,4m
138,1,IIIIIIIIIIII,4837,0,1,0,1,100.0%,35m
139,1,[此生灬无惧]ArChoN,4836,0,0,1,1,0.0%,28m
140,1,[PTB]爆炸即是艺术,4835,0,0,1,1,0.0%,35m
141,1,[幻世情缘]Nawkham,4834,0,0,1,1,0.0%,22m
142,1,[Beasty]Aragon,4833,2332,504,493,997,50.6%,4m
143,3,神绮,4832,0,0,1,1,0.0%,17m
144,1,[SK]千幻,4831,536,56,47,103,54.4%,24m
144,1,[这游戏太难了]llllllllllll,4831,0,0,1,1,0.0%,21m
146,1,[黄漫老师]香风和泉,4830,666,28,15,43,65.1%,4m
146,1,ByuN,4830,46,1,1,2,50.0%,37m
148,1,[情谊至上]丸子,4829,560,27,17,44,61.4%,4m
149,1,[Beasty]Mai,4823,1480,165,90,255,64.7%,1h
150,1,woshibaba,4821,2457,166,142,308,53.9%,4m
151,1,[浙江工商大学]Sarrrrrright,4819,1221,55,43,98,56.1%,4m
152,1,[青春恋爱物语]耗子尾汁,4817,0,0,1,1,0.0%,22m
153,1,[NT]Lingling,4815,0,0,1,1,0.0%,37m
154,1,[你单刷我躺啦]我从嘤影中降临,4814,0,1,0,1,100.0%,35m
155,1,[Beasty]IIIIIIII,4813,1297,59,43,102,57.8%,35m
156,1,[Sfae]堕天使的使魔,4809,0,0,1,1,0.0%,34m
157,1,[孙红雷]南京孙一峰,4808,0,1,0,1,100.0%,28m
157,1,[五月花]宫内莲华,4808,0,1,1,2,50.0%,28m
159,1,[情谊至上]Truth,4807,535,26,13,39,66.7%,4m
159,1,[女仆之心]CharAznable,4807,0,0,2,2,0.0%,1h
161,1,[SK]Enliven,4806,456,12,13,25,48.0%,35m
161,1,器大活好解天笑,4806,0,0,1,1,0.0%,22m
163,1,[杀戮集团]阿基宇德,4804,0,0,1,1,0.0%,35m
164,1,[我超弱]雨季,4798,268,6,12,18,33.3%,1h
165,1,lllllllllll,4797,94,3,0,3,100.0%,27m
166,1,[鸡家军]落晨曦,4793,0,0,1,1,0.0%,27m
167,1,[金灿灿狙击队]你尽然不知道韬哥,4791,2043,89,81,170,52.4%,4m
167,1,[TPoA]Dark,4791,0,0,1,1,0.0%,30m
169,1,机甲刺蛇,4790,0,1,0,1,100.0%,22m
169,1,[很萌日很新]王英俊,4790,40,1,1,2,50.0%,22m
171,1,llllllllllll,4789,0,0,1,1,0.0%,22m
172,1,[64天安門]林志駿,4786,0,1,1,2,50.0%,35m
173,1,IIIIIIIIIII,4785,0,1,0,1,100.0%,35m
174,1,[猎妈人联盟]SophiA,4784,1370,62,60,122,50.8%,4m
175,1,[KPG2]螺蛳粉小妹,4782,2118,110,86,196,56.1%,4m
176,1,[褚嬴]MinDen,4781,2058,99,76,175,56.6%,4m
177,1,金沙,4780,298,7,11,18,38.9%,34m
178,1,[不讲武德]橘里橘气,4779,139,4,0,4,100.0%,4m
178,1,世界万千再难遇我,4779,0,0,1,1,0.0%,35m
180,1,[丨SLT丨]陈忱只会跳鸡猎,4778,639,28,4,32,87.5%,21m
181,1,[怀中抱M杀]sunuanu,4777,0,0,2,2,0.0%,22m
182,1,[金灿灿狙击队]神速偷鸡,4776,596,17,14,31,54.8%,28m
183,1,[AnSwer]Rogue,4774,0,1,1,2,50.0%,34m
184,1,[萝莉即是正义]超级大喵咕,4773,0,0,1,1,0.0%,34m
185,1,[Holyam]ReFuse,4772,198,5,4,9,55.6%,15m
186,1,三色堇,4771,247,27,4,31,87.1%,34m
187,1,[枫殇]BipolarTrans,4770,0,0,5,5,0.0%,37m
188,1,[Beasty]张天志,4765,1383,76,31,107,71.0%,4m
189,1,[中南大学官网]邓紫棋,4763,0,0,1,1,0.0%,35m
190,1,[Beasty]CenturiesBoy,4762,1052,60,48,108,55.6%,37m
190,1,[Sv]狭缝间的原住民,4762,84,2,2,4,50.0%,15m
192,1,[大佬请把鞋给]揽明月入怀,4756,0,0,2,2,0.0%,22m
193,1,[六奇]TOTO,4755,0,1,0,1,100.0%,1h
193,2,你信不信我会哭,4755,0,1,0,1,100.0%,35m
195,1,[Beasty]想想凛宝会怎么做,4754,2584,143,130,273,52.4%,27m
195,1,[Anticw]痴线高高必,4754,0,1,0,1,100.0%,1h
197,1,[GHet]战歌,4752,660,22,6,28,78.6%,1h
197,1,[我们是无敌的]ScPARADISE,4752,212,8,5,13,61.5%,4m
199,1,SomnusM,4746,0,0,1,1,0.0%,35m
200,3,[孙红雷]DreameReader,4743,0,0,1,1,0.0%,28m
201,1,MiyaMiyaMiya,4742,824,37,28,65,56.9%,27m
202,1,[丨SLT丨]大河,4734,737,33,33,66,50.0%,28m
202,1,想要吃排骨,4734,411,12,5,17,70.6%,28m
202,1,[Hist]梦幻拉面,4734,0,0,1,1,0.0%,30m
205,1,lig,4733,2974,417,409,826,50.5%,7m
206,1,[禽禽禽]IIIIIIIIIII,4728,1036,45,36,81,55.6%,35m
207,1,[蝙蝠侠]llllllllllll,4725,268,10,3,13,76.9%,27m
208,1,[赌怪]东京孙一峰,4724,0,4,5,9,44.4%,21m
209,1,[余裕余裕]MinatoAqua,4723,624,32,9,41,78.0%,24m
210,1,igxyFANS,4722,298,11,9,20,55.0%,21m
210,1,[YR]泽拉图,4722,0,1,0,1,100.0%,28m
212,1,AlphaGo,4720,0,1,0,1,100.0%,22m
213,1,lllllllll,4716,0,1,0,1,100.0%,28m
213,1,[星空点灯]yooo,4716,0,0,1,1,0.0%,35m
215,1,[Beasty]llllllllllll,4715,1806,70,61,131,53.4%,7m
216,1,[FAFA]TITAN,4713,0,0,1,1,0.0%,37m
216,1,[小青梅佐酒]GLBGL,4713,0,0,1,1,0.0%,22m
218,1,mtk,4712,0,0,1,1,0.0%,7m
219,1,IIIIIIIIIIII,4708,2713,417,297,714,58.4%,15m
220,1,LOST,4707,318,9,3,12,75.0%,28m
221,1,[刺蛇互助天团]rest,4706,0,1,0,1,100.0%,37m
222,1,DeathHunter,4702,821,39,28,67,58.2%,37m
222,1,[猛的一逼]Liqutid,4702,0,1,0,1,100.0%,30m
224,1,MiracleP,4701,385,27,21,48,56.2%,7m
225,1,[eXoN]SPY,4699,440,18,12,30,60.0%,24m
225,1,xJmc,4699,134,4,6,10,40.0%,28m
227,1,Lunker,4695,866,37,12,49,75.5%,28m
227,1,[宋哈娜]MyLady,4695,682,28,20,48,58.3%,7m
229,1,IIIIIIIIIIII,4694,2307,92,79,171,53.8%,37m
229,1,FortuneCat,4694,0,0,1,1,0.0%,15m
231,3,llllllllllll,4693,0,0,6,6,0.0%,32m
232,1,[SoloAs]萌宝宝,4689,0,0,1,1,0.0%,22m
233,1,[TCP]kennyS,4687,1041,34,36,70,48.6%,7m
233,1,[KPG]部长,4687,0,0,1,1,0.0%,22m
233,1,[cslg]goubiscboy,4687,0,0,1,1,0.0%,22m
236,1,[SCJWJ3]加山天佑,4686,0,1,0,1,100.0%,21m
237,1,[Beasty]避雷针,4682,73,1,0,1,100.0%,22m
238,1,[XYFANS]AdrenalinE,4681,940,31,29,60,51.7%,34m
238,1,青衫磊落险峰行,4681,0,0,1,1,0.0%,30m
238,1,[猎妈人联盟]强欲猎马人,4681,0,0,1,1,0.0%,21m
241,1,[巨像吊炸天]智如智如,4680,0,5,0,5,100.0%,7m
242,1,POPO,4679,395,44,6,50,88.0%,22m
243,1,[BGD]IIIIIIIII,4678,40,1,1,2,50.0%,7m
244,1,shuxd,4677,2986,630,644,1274,49.5%,37m
245,1,[Thpj]NaUShiKa,4675,1634,66,72,138,47.8%,21m
245,1,不讲武德,4675,0,0,1,1,0.0%,7m
247,1,[我们是无敌的]牛蛙,4674,648,19,27,46,41.3%,35m
248,1,[IGS]是逗比还是逗逼,4672,0,1,0,1,100.0%,1h
248,1,[半个菜鸟]大诗念歪歪,4672,0,0,1,1,0.0%,24m
250,1,[我们是无敌的]ZergFans,4670,0,1,0,1,100.0%,1h
251,1,[一GOGO一]ALEX,4665,36,1,1,2,50.0%,7m
252,1,[PTB]诗乃,4664,0,2,3,5,40.0%,32m
252,1,[天行九歌]心若移动如何联通,4664,0,0,1,1,0.0%,7m
254,1,[ZTSCAP]晓响雷电王提督,4662,6,3,1,4,75.0%,37m
254,1,MISSyy,4662,0,0,1,1,0.0%,34m
256,3,[永不灭的战火]zippo,4661,0,1,0,1,100.0%,16m
257,1,[iGSCII]iGMacSed,4660,0,0,1,1,0.0%,35m
258,1,[金灿灿狙击队]TOTO,4658,0,1,0,1,100.0%,27m
258,1,丨丨丨丨丨丨丨丨,4658,44,1,1,2,50.0%,15m
260,1,吃草的牛,4654,0,1,0,1,100.0%,37m
260,1,[半个大哥]Zerofoll,4654,0,0,1,1,0.0%,15m
262,1,llllllllllll,4651,0,0,1,1,0.0%,1h
263,1,Nichloas,4647,1456,189,178,367,51.5%,7m
264,1,Number,4646,222,5,9,14,35.7%,35m
264,1,[喵呜喵呜]瞧本,4646,0,1,0,1,100.0%,15m
266,1,[哔哩哔哩乾杯]Frozen,4645,2787,512,505,1017,50.3%,30m
266,1,QosTerry,4645,2929,475,482,957,49.6%,28m
266,2,小金者,4645,0,1,6,7,14.3%,27m
269,1,[不灭燃星]为了真理,4644,0,0,1,1,0.0%,35m
269,1,[LandSr]Ramu,4644,0,0,1,1,0.0%,35m
271,1,小星星,4640,849,29,24,53,54.7%,28m
271,3,[IMRTS]IIIIIIlIlII,4640,0,0,1,1,0.0%,28m
273,1,[你渴望力量吗]michaelqu,4638,0,0,1,1,0.0%,27m
274,3,[契约星辰]邪神降临,4636,146,7,4,11,63.6%,38m
275,1,[Sv]羽瀨川小笛,4634,338,10,20,30,33.3%,22m
275,1,[KPG]大爱许单言,4634,84,4,6,10,40.0%,1h
275,1,[塔达林净化者]夜雨声烦,4634,42,1,7,8,12.5%,27m
278,1,[CQWS]CNcolorpupil,4631,95,4,1,5,80.0%,15m
278,1,Reason,4631,0,0,1,1,0.0%,35m
280,1,[RvA]皇家胜利者小鸡,4629,0,0,3,3,0.0%,30m
281,1,[城管拆迁大队]不屈战魂,4628,206,5,4,9,55.6%,22m
281,1,[南京理工大]honest,4628,0,1,0,1,100.0%,22m
283,1,普罗托斯真简单,4625,1172,54,21,75,72.0%,21m
284,1,[SK]IlovELJJ,4624,2894,234,233,467,50.1%,24m
285,1,[我们是无敌的]犬儒,4623,0,1,1,2,50.0%,35m
286,1,[清水]清水,4622,42,1,1,2,50.0%,24m
287,1,[羽翼]贤良淑德列克星敦,4621,0,0,1,1,0.0%,15m
288,1,山河故人,4618,66,2,3,5,40.0%,28m
289,1,[RBQ联萌]Zero,4617,340,9,11,20,45.0%,1h
289,2,全宇宙最帅的男人,4617,192,8,0,8,100.0%,27m
291,1,[SK]土六小埋,4613,36,2,1,3,66.7%,21m
292,1,[TPoA]全都是等号,4612,297,11,8,19,57.9%,22m
292,1,比尔那名居天子,4612,76,3,2,5,60.0%,35m
294,1,IIIIllIIIIll,4611,0,1,7,8,12.5%,30m
295,1,霜狼,4610,209,7,3,10,70.0%,27m
296,1,[HustSC]灬烈艹焰灬,4609,1807,99,80,179,55.3%,27m
297,1,[CQWS]magician,4606,44,1,1,2,50.0%,37m
298,1,DRG,4605,1946,97,78,175,55.4%,24m
298,1,[KPG]聆听你最后的遗言,4605,244,7,10,17,41.2%,27m
298,1,[New]Newpp,4605,0,0,1,1,0.0%,21m
301,1,[HTW]手无缚鸡之力,4603,2363,231,214,445,51.9%,34m
301,1,Wargasm,4603,832,28,22,50,56.0%,22m
303,1,[Hydra0]AraGakkiYui,4602,0,0,1,1,0.0%,24m
304,1,白白球,4599,0,1,0,1,100.0%,21m
305,2,IIIIIlllIIlI,4598,402,18,5,23,78.3%,27m
306,1,IIIIIIII,4597,0,0,1,1,0.0%,34m
307,1,lllllllll,4596,1492,53,60,113,46.9%,35m
307,1,[RvA]Korlar,4596,0,0,1,1,0.0%,7m
309,1,光反应,4594,247,6,4,10,60.0%,27m
310,1,Paaaaaaaaper,4593,0,0,1,1,0.0%,37m
311,1,寂静,4587,88,2,4,6,33.3%,21m
312,1,[SK]CHNszxy,4578,739,81,74,155,52.3%,7m
312,1,灵寒舞,4578,0,0,1,1,0.0%,7m
314,1,imagination,4577,842,27,25,52,51.9%,15m
315,1,[loveMM]爱妃朕封你为太子,4576,0,1,0,1,100.0%,35m
315,2,[ToHo]别争了大主教最强,4576,0,1,0,1,100.0%,35m
317,1,[星际阴阳门]你在教我打星际,4575,73,2,4,6,33.3%,15m
318,1,[SK]哔哔哔哔,4573,876,68,58,126,54.0%,24m
319,1,肖甜菜,4572,1301,135,136,271,49.8%,37m
319,1,深过冷的熔体,4572,467,20,16,36,55.6%,7m
321,1,恶魔史莱姆,4571,396,12,12,24,50.0%,28m
322,1,[SoloAs]沧海客,4570,586,19,18,37,51.4%,28m
323,1,[萌新保护协议]ColdSeadling,4569,1122,50,28,78,64.1%,21m
323,1,银月,4569,984,46,33,79,58.2%,35m
323,1,[凯哥集团]Tony,4569,0,0,1,1,0.0%,30m
323,1,[布鲁斯弗莱]凹凹,4569,0,0,1,1,0.0%,1h
327,1,llllllllllll,4568,226,5,8,13,38.5%,28m
327,1,[SK]启元星际,4568,0,0,1,1,0.0%,28m
329,1,[KSARet]小蜜蜂,4567,0,0,1,1,0.0%,22m
330,1,SoulKey,4566,1640,117,81,198,59.1%,21m
330,1,[i5]牛不牛我说了算,4566,0,0,1,1,0.0%,35m
332,1,llllllllllll,4565,1398,115,105,220,52.3%,22m
332,1,IIIIIIIIIIII,4565,644,27,15,42,64.3%,22m
334,1,[SK]氵雨丶神灬,4564,248,29,25,54,53.7%,30m
335,1,IIIIIIIIIIII,4562,92,2,1,3,66.7%,28m
336,1,IIIIIIIIIIII,4561,661,37,21,58,63.8%,21m
336,1,[我高贵的族人]Kurumi,4561,0,0,1,1,0.0%,28m
338,1,frostmourne,4560,368,11,19,30,36.7%,7m
339,1,lllllllll,4559,0,1,3,4,25.0%,22m
340,1,[80后丶]阔落加冰才好喝,4558,0,0,1,1,0.0%,35m
341,2,IIIIIIIIIIII,4557,796,97,52,149,65.1%,6m
342,1,[80后丶]城之内,4556,2847,283,255,538,52.6%,37m
342,2,[代睡别人老公]慕琉璃,4556,0,0,1,1,0.0%,19m
344,1,[Beasty]风暴要火,4552,2676,213,219,432,49.3%,37m
345,2,查尔没有小女仆,4548,77,3,1,4,75.0%,35m
345,1,[Hist]HistOG,4548,0,0,1,1,0.0%,24m
345,1,whiter,4548,0,0,2,2,0.0%,28m
348,2,放学还要挨打,4547,309,63,35,98,64.3%,6m
348,1,[吹毛]沧海客,4547,356,11,12,23,47.8%,24m
350,1,[D3D]llllllllllll,4545,2745,261,258,519,50.3%,22m
350,1,[TCP]Snorlax,4545,133,5,1,6,83.3%,15m
350,2,[SoloAs]这游戏好难,4545,0,0,1,1,0.0%,30m
353,3,[星选组]暴雪的爹,4543,0,0,1,1,0.0%,28m
354,1,Ylc,4539,2868,546,582,1128,48.4%,24m
355,1,[大佬请把鞋给]君心可晴,4537,1663,60,65,125,48.0%,37m
355,1,llllllllllll,4537,715,27,24,51,52.9%,27m
357,1,[Holyam]SwansSong,4535,85,1,2,3,33.3%,35m
358,1,废铁二号,4534,1802,314,322,636,49.4%,7m
358,2,Overmind,4534,0,0,1,1,0.0%,22m
360,2,[無輪幻想]清风千叶,4531,0,0,1,1,0.0%,22m
361,2,[SK]BOBO,4529,0,1,0,1,100.0%,7m
362,1,[Beasty]宗师也是鸡,4528,2646,240,240,480,50.0%,7m
363,1,llllllllllll,4526,1189,92,90,182,50.5%,37m
363,2,[ASAHI]夜莺,4526,0,0,1,1,0.0%,22m
365,2,IDCOD,4524,196,9,1,10,90.0%,6m
365,1,[上分女孩]Neko,4524,0,1,1,2,50.0%,33m
367,1,[Anticw]阿泣卤,4522,2840,261,263,524,49.8%,37m
367,1,[PTB]布基波普,4522,96,3,5,8,37.5%,6m
369,2,IIIIIIIIIII,4521,74,3,4,7,42.9%,7m
369,1,[Solo]nEOiMAGING,4521,0,0,1,1,0.0%,19m
371,1,[砖业团队]偷心盗贼,4519,84,2,6,8,25.0%,27m
371,2,AnimalYang,4519,0,0,2,2,0.0%,30m
373,2,[新的蜜蜂]我永远爱维多利加,4517,194,7,6,13,53.8%,35m
374,2,[80s丶]Dancer,4516,0,1,0,1,100.0%,22m
374,2,[柏林功德殿]逃亡的死变态,4516,0,0,1,1,0.0%,35m
376,2,[USCK]KyaruSuki,4515,0,0,1,1,0.0%,7m
376,2,咕咕咕,4515,0,0,1,1,0.0%,16m
378,2,提馏线方程,4514,306,12,11,23,52.2%,16m
378,2,[SK]暴雪我是你爹,4514,0,1,0,1,100.0%,16m
380,2,天靈,4513,26,1,3,4,25.0%,30m
380,2,[六芒星s]Nameless,4513,0,0,1,1,0.0%,13m
382,1,[RTSGo]冰晶雪色,4512,635,35,12,47,74.5%,37m
382,2,[恋战皇朝]原神真好玩,4512,0,0,1,1,0.0%,6m
384,1,[YM]hjx,4511,1575,112,97,209,53.6%,37m
385,1,[SK]IIIIIIIII,4510,346,20,23,43,46.5%,34m
386,2,[ToHo]愤怒的小鸡,4508,54,3,1,4,75.0%,30m
386,1,[莉莉柯林斯]BVB,4508,0,2,3,5,40.0%,17m
388,1,[快乐上分]馒不讲理,4506,0,1,3,4,25.0%,22m
388,2,[Beasty]KayleStorM,4506,0,0,1,1,0.0%,13m
390,2,[Solo]LeoHeart,4505,0,0,1,1,0.0%,22m
391,2,CenturiesBoy,4504,1359,69,55,124,55.6%,6m
391,1,[雨何时会下]ATRI,4504,485,16,18,34,47.1%,34m
393,2,[IMRTS]拔出去再道歉啊,4503,0,1,0,1,100.0%,13m
394,2,五九司机,4502,86,3,3,6,50.0%,7m
394,2,RushGOoN,4502,28,2,2,4,50.0%,22m
396,2,rUhUa,4500,1480,109,79,188,58.0%,7m
396,1,[选神族就赢了]魔法虫海,4500,2613,109,122,231,47.2%,37m
396,2,[BGD]SEA,4500,138,6,6,12,50.0%,13m
399,2,星空凛凛凛凛凛凛,4499,494,21,15,36,58.3%,27m
399,1,sue,4499,0,1,0,1,100.0%,10m
401,1,[Killyo]AIliang,4498,2643,331,334,665,49.8%,28m
402,3,果子叔叔,4497,293,16,0,16,100.0%,28m
402,2,入口柔一线喉,4497,0,0,1,1,0.0%,16m
404,1,xmsquall,4496,2296,940,796,1736,54.1%,21m
404,1,冻土森林的大蒜头,4496,48,1,1,2,50.0%,34m
406,1,蛮力之库,4494,446,13,21,34,38.2%,35m
407,1,light,4492,644,19,30,49,38.8%,1h
408,1,[卡炸飞]单手推火车,4491,715,28,27,55,50.9%,35m
408,2,[Beasty]LuckyZerg,4491,0,1,0,1,100.0%,22m
410,2,步瓜,4490,0,0,1,1,0.0%,30m
411,1,DrEaMzerg,4488,2001,82,99,181,45.3%,37m
412,1,[上帝的叹息]KurokiTomoko,4487,976,41,23,64,64.1%,1h
413,2,[你渴望力量吗]Good,4486,236,32,28,60,53.3%,27m
414,2,DRGgo,4485,476,18,23,41,43.9%,7m
414,2,Jerry,4485,127,7,8,15,46.7%,22m
416,3,[大佬请把鞋给]月之泪,4484,97,2,3,5,40.0%,17m
417,2,[Sv]Guider,4482,0,2,3,5,40.0%,19m
418,2,[SK]necrophagist,4480,168,8,7,15,53.3%,22m
419,2,llllllllllll,4479,36,1,1,2,50.0%,16m
420,1,llllllllllll,4478,2592,550,543,1093,50.3%,37m
420,2,呆头鹅,4478,0,0,1,1,0.0%,16m
422,3,[四斋蒸蚝片]OREO,4477,0,1,0,1,100.0%,16m
422,2,[NT]水果,4477,0,0,1,1,0.0%,30m
422,2,知道深浅了,4477,0,0,3,3,0.0%,22m
425,2,Earlysummer,4475,34,1,2,3,33.3%,16m
425,2,Finally,4475,0,0,1,1,0.0%,35m
427,2,[虫群永不休止]ALEX,4472,0,0,1,1,0.0%,22m
428,1,[一块晶体矿]苏打苏打苏,4470,391,16,16,32,50.0%,35m
429,1,[KPG]小哥哥带带我,4469,566,17,24,41,41.5%,28m
429,2,男同竟是所有人呢,4469,36,1,1,2,50.0%,27m
431,1,IIIIIIIIIIII,4468,2616,508,476,984,51.6%,28m
431,2,[Anticw]delete,4468,152,9,4,13,69.2%,35m
433,2,leon,4462,2307,103,80,183,56.3%,7m
434,2,[BGD]一剑霜寒十四州,4461,44,2,3,5,40.0%,6m
434,2,[羊驼羊驼羊]落天依然星痕在,4461,0,0,1,1,0.0%,13m
436,1,[四叶草]星空之翼,4460,0,0,1,1,0.0%,12m
437,2,[世界上最帅的]与我一战三生有幸,4459,994,46,33,79,58.2%,27m
437,2,[永不灭的战火]不从心的青本青山,4459,0,1,0,1,100.0%,13m
439,2,青丝重,4458,0,0,1,1,0.0%,30m
440,1,wapp,4457,2818,135,138,273,49.5%,24m
440,3,llllllllllll,4457,0,1,4,5,20.0%,31m
442,3,[理赔难加油]原神高级玩家,4456,276,18,1,19,94.7%,27m
443,2,[胖胖白白球]汗小毛,4455,507,27,2,29,93.1%,22m
443,2,紫月下的原野,4455,0,0,1,1,0.0%,6m
445,1,Vee,4454,145,4,15,19,21.1%,15m
446,1,[SteEng]潮流哥,4452,2654,144,140,284,50.7%,24m
446,2,切糕终结者,4452,2024,124,107,231,53.7%,27m
448,1,[o瞳孔o]吹梦到西洲,4451,0,0,1,1,0.0%,4m
449,2,FlashGOGOGO,4450,489,22,18,40,55.0%,6m
450,1,[KPG]我爱天天,4448,2795,389,400,789,49.3%,34m
450,2,hahahahaha,4448,253,30,7,37,81.1%,27m
452,2,[海德单推协会]痴人说梦,4446,1139,66,18,84,78.6%,30m
453,2,仙子,4445,0,1,0,1,100.0%,30m
454,2,困难,4444,737,45,9,54,83.3%,16m
454,2,[IMRTS2]曾经的诺言,4444,0,0,1,1,0.0%,16m
456,2,萨瑟兰尼,4443,2012,277,234,511,54.2%,16m
456,2,[老婆一喊就退]用泪点烟,4443,0,0,1,1,0.0%,19m
458,2,IIIIIIIIII,4442,0,1,0,1,100.0%,35m
459,2,春日野穹,4441,0,1,0,1,100.0%,7m
459,2,[新伊甸统合部]雷电裔演化枝,4441,0,0,1,1,0.0%,35m
461,3,[AnSwer]IIIIIIIIII,4439,0,0,4,4,0.0%,4m
462,1,[卡炸飞]杀他你只千刀,4438,2633,212,223,435,48.7%,21m
462,2,BRTTLENET,4438,396,23,2,25,92.0%,19m
464,1,柰子罫,4437,2009,155,134,289,53.6%,7m
465,2,IIIIIIIII,4436,935,65,74,139,46.8%,27m
465,2,IIIIIIIIIIII,4436,0,1,0,1,100.0%,35m
467,1,[AnSwer]ChamHoo,4435,660,25,32,57,43.9%,37m
467,2,[目標諾森德]莆红团,4435,253,9,8,17,52.9%,19m
469,2,EMTD,4433,0,1,0,1,100.0%,30m
470,1,ooooooo,4432,44,1,11,12,8.3%,7m
471,2,[153cm]diao,4431,140,6,9,15,40.0%,35m
471,2,IIIIIIIIIIII,4431,0,0,1,1,0.0%,22m
473,1,llllllllllll,4430,2074,104,110,214,48.6%,35m
473,2,多数例外规则,4430,267,16,28,44,36.4%,27m
473,2,[叫我兔本]这太不人道了,4430,0,0,1,1,0.0%,35m
476,1,BLADE,4428,1402,57,55,112,50.9%,27m
477,3,智商经常被压倒,4427,291,13,8,21,61.9%,9m
477,2,[1057]癫骨,4427,0,0,2,2,0.0%,27m
479,2,DKz,4426,251,21,4,25,84.0%,13m
479,2,[斜星连萌]可爱的小灵儿,4426,142,5,6,11,45.5%,27m
479,1,[02与广]HiRo,4426,0,0,1,1,0.0%,8m
482,2,你猜我是谁,4425,308,11,15,26,42.3%,27m
482,2,[SK]Ice,4425,136,6,5,11,54.5%,30m
482,2,书妖夜焚心,4425,0,0,1,1,0.0%,6m
485,2,[Misty]星海迷航,4424,0,0,1,1,0.0%,13m
485,2,[IMRTS2]樱井智树,4424,0,0,1,1,0.0%,35m
485,1,[Pro]LindL,4424,0,0,7,7,0.0%,11m
488,2,[SLTHHH]SADFANS,4423,246,13,8,21,61.9%,13m
489,1,[Inero]堕落的天使,4422,2818,404,394,798,50.6%,27m
490,2,大狗,4421,1228,59,41,100,59.0%,27m
490,2,[Goodg]怪盗小葵,4421,0,1,0,1,100.0%,22m
490,2,[风纪委员会]夜空之下,4421,0,0,1,1,0.0%,35m
493,2,llllllllllll,4420,139,9,2,11,81.8%,27m
494,2,llllllllll,4419,616,100,74,174,57.5%,30m
494,2,南飞鸿,4419,0,1,0,1,100.0%,35m
496,2,[XYFANS]LiquidClem,4418,68,2,14,16,12.5%,27m
497,2,黑光,4417,0,0,1,1,0.0%,30m
498,2,[暴雪三十二隊]左能者,4416,908,60,13,73,82.2%,22m
499,2,正在折跃的扎加拉,4415,26,2,2,4,50.0%,16m
500,2,[樱火之森]乱舞,4413,0,1,0,1,100.0%,13m
501,2,[Beasty]faceless,4411,829,56,56,112,50.0%,30m
501,2,[四叶草]这还打毛啊,4411,946,43,27,70,61.4%,16m
501,2,极夜,4411,215,8,4,12,66.7%,19m
504,2,小夏,4410,128,5,7,12,41.7%,35m
504,2,[lnaba]夜鹰之星,4410,0,0,1,1,0.0%,30m
506,2,[四叶草]wwww,4407,2002,95,79,174,54.6%,19m
506,2,[SK]虎丶痴,4407,753,35,33,68,51.5%,13m
506,3,[APIN]Cyheadache,4407,127,20,1,21,95.2%,17m
506,2,愿美好环环相扣,4407,10,1,3,4,25.0%,16m
506,2,雷诺,4407,0,0,1,1,0.0%,7m
511,1,[NT]DraCula,4404,1094,46,50,96,47.9%,28m
512,2,[TJMU]同济医大丨云玩家,4403,0,0,1,1,0.0%,35m
512,2,[Toss]伊波杏樹,4403,0,0,4,4,0.0%,6m
514,2,[野生无公害]像极了爱情,4402,178,7,10,17,41.2%,13m
515,2,[TNLtr]荒塞沫寒,4401,700,33,31,64,51.6%,16m
516,2,WilsonZZM,4400,2015,126,124,250,50.4%,6m
516,2,[旷远能源]我好菜啊,4400,225,7,6,13,53.8%,30m
518,2,[Rhusky]iNaive,4398,244,10,12,22,45.5%,19m
519,2,爱你的九号,4397,0,1,4,5,20.0%,12m
519,2,[FET]BossL,4397,0,0,1,1,0.0%,27m
519,2,[出售此号]桃子,4397,0,0,1,1,0.0%,35m
519,3,[混元太极]星际马保国,4397,0,0,1,1,0.0%,29m
523,2,IIIIIIIIIIII,4396,1394,172,166,338,50.9%,7m
523,2,[NEET姬]蓬莱山辉夜,4396,1771,137,72,209,65.6%,16m
523,3,雨中曲與風之唄,4396,361,19,2,21,90.5%,17m
526,2,[Wifi]Rival,4395,2005,148,143,291,50.9%,13m
526,2,[SCAP]xiaobai,4395,0,1,0,1,100.0%,27m
526,2,知乎水友赛主办方,4395,0,0,1,1,0.0%,35m
529,2,[Flowex]Name,4394,20,1,1,2,50.0%,22m
530,2,Nature,4393,0,0,1,1,0.0%,6m
531,2,[小鸡啄小鱼]小鸡,4392,436,21,21,42,50.0%,19m
531,2,[Solo]皮蛋瘦肉周,4392,0,0,1,1,0.0%,19m
531,2,[太平洋舰队]Zeratul,4392,0,0,1,1,0.0%,35m
534,2,五眼联盟,4390,0,1,2,3,33.3%,35m
535,2,[THX]FiNeSiTi,4389,1939,143,150,293,48.8%,27m
535,2,llllllllllll,4389,448,20,24,44,45.5%,6m
535,2,[OsTi]Sasori,4389,88,5,5,10,50.0%,7m
535,2,soyfans,4389,0,1,0,1,100.0%,27m
539,2,IIIIIIIIIIII,4388,2431,475,448,923,51.5%,7m
539,2,[大师联邦]Tink,4388,1615,136,119,255,53.3%,16m
541,2,只会打运营,4386,138,4,12,16,25.0%,13m
542,1,[星河气象学院]谁狗谁孙子,4385,145,2,2,4,50.0%,9m
542,2,IIIIIIIIIII,4385,0,1,0,1,100.0%,13m
544,3,懒得讲武德,4384,346,18,4,22,81.8%,5m
544,2,无聊随便玩玩,4384,24,1,1,2,50.0%,22m
544,2,lllllllll,4384,0,0,1,1,0.0%,19m
547,2,[一库]回忆余温,4383,0,1,0,1,100.0%,35m
548,3,[CPT]粉红泡泡,4382,317,11,7,18,61.1%,9m
548,2,[SK]莽霸天,4382,196,7,6,13,53.8%,16m
550,2,[雾雨魔法森林]萌萌铃仙酱,4379,241,11,15,26,42.3%,35m
550,2,[太平洋舰队]IIIIIIIIII,4379,0,0,1,1,0.0%,22m
550,2,HandSonic,4379,0,0,1,1,0.0%,35m
553,2,我怕你起的飞咧,4377,0,1,0,1,100.0%,19m
554,2,[EP]秋风之墩,4375,374,49,44,93,52.7%,22m
554,2,[太平洋舰队]Messi,4375,0,0,3,3,0.0%,22m
556,2,Least,4373,80,3,6,9,33.3%,13m
557,1,罗岗村民,4372,2749,139,155,294,47.3%,27m
557,2,原始野人,4372,624,30,15,45,66.7%,13m
557,2,[白银联盟]怡宝,4372,259,16,16,32,50.0%,16m
557,2,llllllllllll,4372,0,1,0,1,100.0%,35m
561,1,悠然然然然然,4371,130,3,22,25,12.0%,7m
562,2,[SK]头疼的啄木鸟,4370,84,7,6,13,53.8%,30m
563,1,Leo,4369,2086,199,219,418,47.6%,28m
563,2,[SteEng]土之土狗,4369,78,1,1,2,50.0%,19m
565,2,iiiIIIIIii,4368,1207,59,37,96,61.5%,16m
566,2,IIIIIIIIII,4367,20,2,1,3,66.7%,19m
567,2,[星际就要争霸]OverMind,4365,244,29,28,57,50.9%,6m
568,2,大马哈哈鱼,4364,90,1,1,2,50.0%,27m
569,2,[寡妇雷就无敌]MagicWang,4359,1019,47,45,92,51.1%,13m
570,3,[华政之光]身经百战见得多,4358,0,0,1,1,0.0%,29m
571,2,熊猫君,4357,610,36,9,45,80.0%,16m
571,3,[听风时雨]FoehnRevolt,4357,128,19,3,22,86.4%,17m
573,1,IIIIIIIIIIII,4356,216,8,1,9,88.9%,17m
573,1,[KPG]天煞落世,4356,0,1,0,1,100.0%,4m
573,3,llllllllllll,4356,0,0,1,1,0.0%,31m
573,3,[第一戦門舰隊]归鹤,4356,0,0,1,1,0.0%,4m
577,1,[SK]亲生野爹,4353,2097,228,223,451,50.6%,16m
577,2,[KPG]IIIIIIIIIIII,4353,2446,172,175,347,49.6%,30m
577,2,[begin]牙神,4353,1859,80,84,164,48.8%,16m
577,2,猪猪党,4353,200,10,11,21,47.6%,22m
581,2,[SCAP]坚强的肾,4352,2457,111,118,229,48.5%,6m
581,3,白给丸,4352,0,0,1,1,0.0%,37m
583,3,IIIIIIIIIII,4351,495,27,18,45,60.0%,28m
583,3,[WFFF]大肠粉,4351,0,1,0,1,100.0%,37m
585,3,zrzr,4350,0,1,0,1,100.0%,16m
585,3,sinke,4350,0,0,1,1,0.0%,37m
585,3,[9999im]丶繁谷空梦,4350,0,0,1,1,0.0%,29m
585,3,[合肥孙一峰]Oats,4350,0,0,1,1,0.0%,16m
589,3,[时间]远古机械指环,4348,0,1,3,4,25.0%,9m
590,2,zyf,4347,574,26,25,51,51.0%,6m
591,3,[野生无公害]野生的浅宇柒,4346,0,1,0,1,100.0%,37m
591,3,TomStar,4346,0,0,1,1,0.0%,16m
591,3,[WZerg]XElNagA,4346,0,0,1,1,0.0%,16m
594,2,[GAFASC]Jayecc,4345,340,18,15,33,54.5%,7m
595,2,[龙王氵]AnXin,4344,0,1,0,1,100.0%,24m
596,2,大梦谁先觉,4343,866,34,43,77,44.2%,27m
596,2,修地堡单矿一波,4343,619,32,17,49,65.3%,27m
598,2,[小金上天队]slahserk,4342,692,34,30,64,53.1%,30m
598,2,[蓝色学者]小太妹,4342,262,16,9,25,64.0%,19m
598,2,TsuKi,4342,355,15,11,26,57.7%,19m
598,3,德阳人肥的似猪,4342,58,5,1,6,83.3%,4m
598,3,[找靠谱战队]雅儿贝德,4342,10,1,2,3,33.3%,28m
603,3,独饮月色,4340,384,20,0,20,100.0%,28m
603,3,[FPT]玩的累啊,4340,74,6,3,9,66.7%,37m
603,3,[头孢与啤酒]王包包,4340,0,0,1,1,0.0%,38m
606,3,[Epochs]Kala,4339,0,0,1,1,0.0%,32m
607,3,[miku守护]御神夜,4338,166,9,5,14,64.3%,17m
607,3,IIIIIIIIIIII,4338,0,0,1,1,0.0%,31m
609,2,不羁的灵魂,4336,272,13,11,24,54.2%,7m
610,2,有馬貴將,4335,154,4,6,10,40.0%,22m
610,3,[肉鸡的饲养]Deceiver,4335,0,1,0,1,100.0%,17m
610,3,[屑屑]Uninkself,4335,0,0,1,1,0.0%,9m
613,2,Toilet,4332,285,11,12,23,47.8%,35m
614,2,锦清,4331,1282,272,263,535,50.8%,27m
614,3,llllllllllll,4331,644,31,14,45,68.9%,37m
616,3,[HTW]Origin,4330,150,9,6,15,60.0%,31m
616,3,[SoloAs]Madlife,4330,0,1,0,1,100.0%,32m
618,3,[太微玉清宫]天九儿,4329,392,20,3,23,87.0%,17m
618,3,NightVoyager,4329,0,0,1,1,0.0%,9m
620,2,[贫下中农]恶通天,4328,1480,71,54,125,56.8%,22m
620,3,[太微玉清宫]伊斯,4328,410,21,3,24,87.5%,4m
622,2,[NS]世界第一虫族肉鸽,4327,159,11,13,24,45.8%,22m
623,2,IIIIIIIIIIII,4326,1205,69,68,137,50.4%,22m
623,3,[ZSG]Rogue,4326,0,1,0,1,100.0%,37m
623,3,[Ours]Asasi,4326,0,0,1,1,0.0%,4m
623,3,lIlllllllIII,4326,0,0,1,1,0.0%,37m
627,2,[OgiNA]斗鱼小唧唧,4325,596,23,33,56,41.1%,16m
628,2,[KPG]IIIIIIIIIIII,4324,1371,72,50,122,59.0%,16m
628,3,spand,4324,123,21,3,24,87.5%,17m
630,3,[武汉理工大学]你甚至不叫我教父,4323,80,7,5,12,58.3%,31m
630,3,[Igirls]萌萌哒沫惜,4323,18,2,3,5,40.0%,16m
632,3,[浙江工商大学]superMC,4322,0,1,0,1,100.0%,16m
633,3,蛋炒饭很好吃,4321,0,1,0,1,100.0%,4m
634,2,illya,4320,1920,77,75,152,50.7%,19m
634,3,[廣東財經大學]FruitsBasket,4320,8,2,0,2,100.0%,29m
636,3,[蜜臀姐姐联盟]喆文,4318,0,0,1,1,0.0%,31m
637,2,lllllllllll,4317,36,1,5,6,16.7%,19m
637,3,[FPT]人中吕布李信衡,4317,0,0,1,1,0.0%,28m
639,3,重金求梓,4316,1470,114,112,226,50.4%,29m
639,2,[五月花]equip,4316,319,14,16,30,46.7%,22m
641,2,[TuiELF]猫喜欢吉良,4315,1462,66,72,138,47.8%,27m
641,2,[SK]星际争霸嘴上过,4315,346,17,13,30,56.7%,19m
643,3,[Shawk]喵了个咪,4313,121,3,0,3,100.0%,28m
643,3,三个贷表重要思想,4313,0,0,1,1,0.0%,4m
645,3,[火焰雷兽]失了智,4312,0,3,0,3,100.0%,32m
645,3,LIN,4312,0,1,0,1,100.0%,17m
647,3,[Igirls]林檎,4310,664,35,2,37,94.6%,28m
647,3,[打到你报警]forever,4310,48,4,1,5,80.0%,31m
649,1,飞翔的菜鸟,4309,1349,57,80,137,41.6%,35m
649,3,IIIIIIIIIIII,4309,838,46,23,69,66.7%,5m
649,3,[青娱乐]llllllllllll,4309,0,0,1,1,0.0%,31m
652,3,ArimaKisho,4308,329,19,9,28,67.9%,38m
652,3,[凯哥集团]他们叫我条码,4308,0,0,1,1,0.0%,16m
652,3,[诹访神教]诶嘿嘿,4308,0,0,1,1,0.0%,17m
655,3,[笙风]sddddd,4306,510,51,35,86,59.3%,28m
656,3,围檩,4305,0,0,1,1,0.0%,31m
657,3,[ZTSCAP]竹海旁回眸,4304,340,20,22,42,47.6%,17m
658,3,连五鞭,4303,96,8,9,17,47.1%,17m
658,2,Stalker,4303,0,1,5,6,16.7%,4m
658,3,[TeamNL]HooinKyoma,4303,0,0,1,1,0.0%,16m
661,3,[NSDs]土豆你个马铃薯,4302,0,1,0,1,100.0%,17m
661,1,小顾顾,4302,0,0,3,3,0.0%,32m
663,2,[为了地球]寒霜飞雪,4299,1754,108,100,208,51.9%,30m
663,3,桑德拉,4299,869,52,32,84,61.9%,28m
663,3,[CNboi]屠夫凯文,4299,282,18,19,37,48.6%,38m
663,3,[Ogier]turn,4299,0,0,2,2,0.0%,9m
663,3,IIIIIIIIIIII,4299,0,0,2,2,0.0%,9m
668,3,Ivorker,4298,0,0,1,1,0.0%,16m
669,3,[星际小马]友谊的魔法,4297,0,1,0,1,100.0%,17m
670,3,[又胖了]馒头,4296,0,1,0,1,100.0%,32m
670,3,[思辨者]老瞎狗,4296,0,1,1,2,50.0%,32m
672,2,Natusvincere,4293,1694,162,158,320,50.6%,22m
673,3,月小柳,4292,1414,83,57,140,59.3%,17m
673,3,[CHW]kakalu,4292,0,0,1,1,0.0%,16m
675,3,私奔到月球,4291,0,0,1,1,0.0%,5m
676,2,[Flowex]GoTNT,4289,793,99,117,216,45.8%,14m
676,3,[AF]怪兽叔叔,4289,0,0,1,1,0.0%,38m
678,2,[ELSD]DestInyuI,4288,132,7,17,24,29.2%,27m
678,3,[济宁天梯独苗]菜鸟先飞何惧输,4288,0,0,1,1,0.0%,17m
678,3,[i5]划过天空的板砖,4288,0,0,1,1,0.0%,9m
681,3,高鸭稳乃,4287,20,2,2,4,50.0%,28m
682,3,星际教科书,4286,32,4,2,6,66.7%,16m
682,2,[我是一只机]雪夜音,4286,0,1,0,1,100.0%,18m
682,3,[亚洲盗播天团]专业解说黄旭东,4286,0,0,1,1,0.0%,11m
682,3,IIIIIIIIII,4286,0,0,1,1,0.0%,28m
686,3,[武德]年轻人,4285,24,3,5,8,37.5%,9m
686,3,[Solo]IIIIIIIIIIII,4285,0,0,1,1,0.0%,9m
688,3,[BUCEA]要一个黄昏,4282,867,198,149,347,57.1%,28m
688,3,[HTW]迷路的小胖子,4282,858,40,28,68,58.8%,5m
690,2,galaxy,4281,2519,470,483,953,49.3%,14m
690,3,[不打奖勵速刷]王牌指挥官二号,4281,0,0,1,1,0.0%,38m
692,2,[团不胜独]CyanWinG,4280,2429,329,295,624,52.7%,27m
692,3,真的要卡死了,4280,1625,161,136,297,54.2%,16m
694,3,肚子疼请假,4278,48,4,7,11,36.4%,16m
694,3,桃太郎,4278,0,1,0,1,100.0%,32m
694,3,[我们是无敌的]ppxxyy,4278,0,1,0,1,100.0%,4m
697,1,[毛毛]IIIlllIIIlll,4276,1223,75,82,157,47.8%,34m
697,3,[丨SLT丨]IIIIIIIIIIII,4276,0,0,1,1,0.0%,32m
699,3,[湖南大学]掠影,4275,16,3,7,10,30.0%,5m
699,3,[一等星]海百合海底谭,4275,0,0,1,1,0.0%,37m
701,2,[Flowex]soupsword,4274,2217,343,360,703,48.8%,27m
701,2,[丨SLT丨]残酷天使,4274,142,6,14,20,30.0%,27m
701,3,[NavyF]isenguard,4274,42,5,1,6,83.3%,18m
704,3,djsi,4273,440,24,7,31,77.4%,9m
704,3,[你们都是渣]我真的不会防守,4273,0,1,0,1,100.0%,16m
706,3,[miku守护]miku,4272,1096,66,18,84,78.6%,29m
706,3,[SK]IIIIIIIIII,4272,923,40,34,74,54.1%,11m
706,3,JZong,4272,0,1,0,1,100.0%,9m
706,3,IzeGitoLc,4272,6,1,1,2,50.0%,4m
706,3,Leon,4272,0,0,1,1,0.0%,16m
711,3,[三三教会]不是大白是巨白,4271,335,37,27,64,57.8%,29m
712,2,游城二代,4270,591,41,37,78,52.6%,30m
712,3,IIIIIIII,4270,0,1,0,1,100.0%,29m
714,3,大师以下跳逼没妈,4269,0,0,1,1,0.0%,32m
715,3,[ISAC]SakuraChiyo,4268,0,0,1,1,0.0%,32m
715,3,[HNU]INnoVation,4268,0,0,1,1,0.0%,29m
717,3,[Guider]从竹议官,4266,14,3,1,4,75.0%,9m
717,3,能不能别狗好好打,4266,6,2,0,2,100.0%,32m
717,3,[国民]Lin,4266,10,1,1,2,50.0%,38m
720,3,旧城,4265,211,15,5,20,75.0%,37m
721,2,[FsA]LuckySon,4264,2320,101,107,208,48.6%,19m
722,3,Zimba,4263,0,0,2,2,0.0%,28m
723,3,[白银联盟]Memory,4262,0,1,0,1,100.0%,16m
723,3,[IMRTS2]一枝红杏出墙来,4262,0,0,1,1,0.0%,28m
723,2,[SoloAs]IIIIIIIIIIII,4262,0,0,1,1,0.0%,19m
726,3,[逸仙谐星]SYSUoZJU,4260,0,0,2,2,0.0%,5m
727,3,[SC2近卫军]Meepo,4258,289,19,14,33,57.6%,5m
727,3,IIIIIIIIIIII,4258,148,10,12,22,45.5%,28m
727,3,IIIIIIIIIIII,4258,24,3,5,8,37.5%,16m
730,2,条形码,4257,2494,383,386,769,49.8%,7m
731,1,黑无常,4256,290,15,1,16,93.8%,28m
732,2,九三,4255,2524,341,335,676,50.4%,7m
732,2,[IMRTS]老汉推车,4255,2006,202,237,439,46.0%,7m
732,3,[HNU]LeGend,4255,8,1,2,3,33.3%,9m
732,3,[Flowex]四月是你的谎言,4255,0,0,1,1,0.0%,38m
736,3,快递难找,4252,663,29,27,56,51.8%,4m
736,3,钱仕腾,4252,405,25,10,35,71.4%,16m
736,3,马保国本人,4252,0,0,2,2,0.0%,9m
739,3,[传说萌娘团]星际之龙,4251,18,2,0,2,100.0%,17m
740,1,levelzero,4250,328,17,1,18,94.4%,36m
740,2,[星之公主]天之川绮罗,4250,0,0,4,4,0.0%,12m
742,3,llllllllllll,4249,724,35,17,52,67.3%,18m
742,2,[乃一开特]TKZerg,4249,0,4,1,5,80.0%,12m
742,3,[教我玩神族]时崎狂北小北姬,4249,24,3,1,4,75.0%,18m
742,3,IIIIIIIIIIII,4249,0,0,1,1,0.0%,9m
746,1,IIIIIIIIIIII,4248,1359,308,309,617,49.9%,16m
746,3,[ErebuS]Rhapsody,4248,0,0,1,1,0.0%,37m
748,3,[NUAA]invorker,4247,0,1,0,1,100.0%,17m
749,3,qwer,4246,294,24,22,46,52.2%,31m
750,3,[渣男王小花]大炮,4245,6,2,0,2,100.0%,38m
750,3,[印度虫王]车队队长藤原拓海,4245,12,1,3,4,25.0%,4m
752,3,[北京城管]第十三月丶默念,4244,0,0,1,1,0.0%,28m
753,2,泠鸢形意口胡门,4243,0,2,3,5,40.0%,16m
753,3,[辉煌华夏]劉華強,4243,0,0,1,1,0.0%,17m
755,2,[香風智乃]卡布奇诺,4242,2486,215,241,456,47.1%,7m
755,2,仗剑走天涯,4242,24,2,7,9,22.2%,22m
757,2,IIIIIIIIIII,4241,1484,88,83,171,51.5%,27m
757,3,[神族最棒了]protoss,4241,44,6,4,10,60.0%,28m
759,2,轻狂,4240,245,12,15,27,44.4%,14m
759,3,[他上王者]红叶,4240,0,1,0,1,100.0%,29m
761,3,Eushully,4239,373,34,27,61,55.7%,28m
762,3,[Beasty]Free,4238,2255,241,256,497,48.5%,38m
762,3,[Tilt]蛋奶星星,4238,4,2,0,2,100.0%,29m
764,3,未闻花名,4237,50,6,4,10,60.0%,38m
765,2,lllllllllll,4236,679,41,55,96,42.7%,14m
765,3,IlIlIlIlIlIl,4236,0,1,0,1,100.0%,31m
767,3,太上忘情豆,4235,0,1,0,1,100.0%,11m
768,3,[千里共婵娟]惟愿君长安,4234,0,1,0,1,100.0%,32m
768,3,[武汉理工大学]冷面杀手,4234,0,1,0,1,100.0%,29m
768,3,[星际老徐坤]IIIIIIIII,4234,0,0,1,1,0.0%,4m
768,3,[又胖了]蒸馍,4234,0,0,1,1,0.0%,9m
772,3,[基金会]闪烁的星辰,4233,0,1,0,1,100.0%,17m
772,3,IIIIIIIIIIII,4233,0,1,0,1,100.0%,32m
772,3,Scy,4233,0,0,1,1,0.0%,29m
775,3,IIIIIIIII,4232,54,5,6,11,45.5%,9m
775,3,[真理]麻花控,4232,0,1,0,1,100.0%,16m
777,3,[拉稀]小仙女,4231,0,1,0,1,100.0%,16m
778,3,Gunter,4230,16,3,1,4,75.0%,9m
778,3,嫽皇丶,4230,0,0,1,1,0.0%,11m
780,3,LAN,4229,155,8,3,11,72.7%,16m
780,3,[miku守护]ghoti,4229,0,1,0,1,100.0%,17m
782,3,你知深浅我知长短,4227,0,1,0,1,100.0%,32m
783,3,[死亡收割]独角仙,4226,68,8,7,15,53.3%,29m
783,3,趣多多麦旋风,4226,0,1,0,1,100.0%,9m
785,3,[一块晶体矿]电脑,4225,0,0,1,1,0.0%,38m
786,3,[GHet]bbpler,4224,834,75,64,139,54.0%,9m
786,3,[KPG2]洛殇,4224,0,1,0,1,100.0%,28m
786,3,[小金上天队]IIIIIIIIIII,4224,0,1,0,1,100.0%,11m
789,3,[Pro]leckcc,4223,0,0,1,1,0.0%,32m
789,3,[启元星际门]MakiMakiMa,4223,0,0,1,1,0.0%,38m
791,3,尼玛拉姆,4222,125,6,3,9,66.7%,18m
792,3,强哥哥,4220,475,55,43,98,56.1%,11m
792,3,[专业防地堡]单排狂魔,4220,0,0,1,1,0.0%,31m
792,3,[萌新真的菜]lllllllll,4220,0,0,1,1,0.0%,5m
795,3,尤朵拉,4218,356,26,26,52,50.0%,31m
796,3,[北邮孙一峰]小豆豆,4217,116,10,10,20,50.0%,38m
797,3,[认真你就輸了]樱下古河花田汐,4216,377,20,5,25,80.0%,5m
797,3,[PITB]dark,4216,303,16,7,23,69.6%,4m
797,3,Aqualung,4216,10,2,0,2,100.0%,32m
797,3,ANDA,4216,6,1,6,7,14.3%,5m
801,3,Psyqhical,4215,14,2,2,4,50.0%,28m
801,3,[TNLet]STAR,4215,14,1,2,3,33.3%,37m
803,3,[FlaSh啊]涛涛涛涛套子,4214,6,1,2,3,33.3%,29m
804,3,IIIIIIIIIIII,4213,0,1,1,2,50.0%,9m
804,3,cxxx,4213,8,1,1,2,50.0%,28m
806,3,RangerLeader,4212,138,14,13,27,51.9%,29m
806,3,OverMind,4212,0,0,1,1,0.0%,28m
808,2,Izayoi,4210,0,2,4,6,33.3%,38m
809,3,[P就]二仙桥,4209,10,1,1,2,50.0%,9m
810,2,[刺蛇互助社团]TureNo,4208,2393,170,180,350,48.6%,19m
810,2,麻辣鱼丸,4208,58,10,19,29,34.5%,22m
810,3,咩呜咔,4208,20,3,6,9,33.3%,16m
813,3,[山东蓝翔]Gravity,4207,357,52,34,86,60.5%,28m
813,3,llllllllllll,4207,30,4,1,5,80.0%,28m
813,3,比古清十郎,4207,0,0,1,1,0.0%,9m
813,3,Mabinogi,4207,0,0,1,1,0.0%,32m
817,3,胡喵喵,4206,444,43,32,75,57.3%,32m
817,3,[亚X]虎牙彼岸的宁静,4206,0,1,0,1,100.0%,16m
817,3,萌萌喵,4206,0,0,1,1,0.0%,5m
817,3,[DMRe]马老师,4206,0,0,1,1,0.0%,17m
817,3,IIIIIIIIIIII,4206,0,0,1,1,0.0%,18m
817,3,[洁白之巅]良好,4206,0,0,2,2,0.0%,38m
823,3,Invincible,4205,371,18,8,26,69.2%,29m
823,3,[我们是无敌的]天生贵人霍去病,4205,42,6,11,17,35.3%,38m
823,3,青绾,4205,6,2,0,2,100.0%,38m
823,3,西岐,4205,0,0,1,1,0.0%,18m
827,2,geath,4204,224,6,4,10,60.0%,38m
828,3,[Solo]nature,4203,0,0,1,1,0.0%,9m
829,1,小吉姆,4202,335,17,3,20,85.0%,11m
829,3,[Rhusky]化学课呆表,4202,0,1,0,1,100.0%,17m
829,3,[狗逼速成班]Kono,4202,8,1,1,2,50.0%,16m
829,3,Evil,4202,10,1,2,3,33.3%,32m
829,3,[武汉理工大学]WHT,4202,0,0,1,1,0.0%,18m
829,3,吉安娜,4202,0,0,1,1,0.0%,32m
835,3,[单推人]llIlIIIIIlll,4201,0,0,1,1,0.0%,38m
835,3,[i马士]Yuanbaicai,4201,0,0,1,1,0.0%,29m
837,3,Yoki,4200,20,2,4,6,33.3%,29m
837,3,[为了地球]电光,4200,0,0,1,1,0.0%,29m
837,3,[YA]醉了的小生,4200,0,0,2,2,0.0%,9m
840,3,[虫群永不休止]鬼竹,4199,507,31,29,60,51.7%,32m
841,3,llllllllllll,4198,1480,190,162,352,54.0%,9m
841,3,[星选组]熙超小婷呀,4198,109,4,1,5,80.0%,4m
843,3,民主候选人拜登,4197,1328,85,83,168,50.6%,28m
843,3,[哔哩哔哩乾杯]Illyasviel,4197,0,1,1,2,50.0%,29m
843,3,[一库]SayaEndeist,4197,0,0,1,1,0.0%,29m
843,3,[被情所慯]吃鱼鱼碎觉觉,4197,0,0,1,1,0.0%,37m
847,3,[NZNZ]GhostTown,4196,859,300,270,570,52.6%,18m
847,3,沧海客,4196,912,47,52,99,47.5%,11m
847,1,[yOsyOs]鸢一折纸,4196,224,13,1,14,92.9%,36m
847,3,[LFY]Soulworld,4196,124,11,19,30,36.7%,17m
847,3,[iWoWi]histBigGun,4196,0,0,1,1,0.0%,32m
847,3,[瑶瑶公主]MAXLove,4196,0,0,1,1,0.0%,18m
847,3,香风智乃,4196,0,0,1,1,0.0%,28m
854,3,[KPG]巢导,4195,687,32,18,50,64.0%,4m
855,3,[JJFIY]撅腚的鸭子,4194,301,32,24,56,57.1%,28m
855,3,[染年霜霜]teemon,4194,0,0,1,1,0.0%,9m
855,3,[禽禽禽]小黄鸡,4194,0,0,1,1,0.0%,16m
858,3,DietmarP,4193,8,1,1,2,50.0%,29m
859,3,[五月花]暴打养鸡场,4192,647,28,6,34,82.4%,18m
859,3,[小氺就是水]rubers,4192,8,1,3,4,25.0%,17m
859,3,[暴雪我是你爹]sky,4192,0,0,1,1,0.0%,18m
859,3,Infinite,4192,0,0,1,1,0.0%,29m
863,3,[萌面喵星人]蛋挞,4191,644,37,20,57,64.9%,29m
863,3,[小刺蛇嗷]AngelLuNai,4191,10,2,0,2,100.0%,28m
863,3,[我们是无敌的]子颜大大,4191,0,1,3,4,25.0%,28m
863,1,核平先锋,4191,0,0,1,1,0.0%,17m
863,3,Mrisxiyu,4191,0,0,1,1,0.0%,4m
863,3,[艾抖露]BlackHand,4191,0,0,1,1,0.0%,17m
869,3,[谐能打鸡]EricWang,4190,0,0,1,1,0.0%,16m
869,3,IIIIIIIIIII,4190,0,0,2,2,0.0%,29m
871,3,[虫群永不休止]SNOW,4189,349,17,2,19,89.5%,16m
871,3,[Killyo]海洋大鲸鱼尾巴,4189,0,0,1,1,0.0%,11m
871,3,搂着空的白,4189,0,0,1,1,0.0%,16m
874,3,hunter,4188,1374,72,73,145,49.7%,38m
874,3,DaydReamIao,4188,0,0,1,1,0.0%,16m
874,3,景之致美,4188,0,0,1,1,0.0%,5m
874,3,[東方写真馆]鹿乃,4188,0,0,1,1,0.0%,38m
874,3,[逸仙谐星]我大意了啊没有闪,4188,0,0,1,1,0.0%,9m
874,3,[DMRe]夜深狼吟,4188,0,0,1,1,0.0%,9m
874,3,[OZG]Overmind,4188,0,0,1,1,0.0%,32m
881,1,[BIG联盟]kun,4187,625,217,239,456,47.6%,22m
881,3,[Holygl]苹果贩子,4187,12,3,3,6,50.0%,18m
881,1,[SCJWJ3]丿醉梦丶听风灬,4187,0,2,6,8,25.0%,6m
881,3,[OhNo]紫色双华,4187,0,0,1,1,0.0%,18m
885,3,佐伊,4186,0,0,1,1,0.0%,17m
886,3,[左岸天空]eViLr,4185,1175,404,379,783,51.6%,5m
886,3,[Syf键谈坊]周星星,4185,0,0,1,1,0.0%,32m
888,2,[第七舰队丶]阿尔萨斯,4184,2093,466,493,959,48.6%,7m
889,3,[失恋阵线联盟]张国荣,4183,589,65,10,75,86.7%,9m
889,3,[北京城管]霸天猛虎,4183,473,18,16,34,52.9%,28m
889,3,小白龙,4183,24,3,6,9,33.3%,38m
889,3,Momoko,4183,10,1,2,3,33.3%,18m
893,3,zeratul,4182,198,7,2,9,77.8%,37m
893,3,[琴吹七濑]式部帆夏,4182,0,1,0,1,100.0%,17m
893,3,[博云星际学院]乖仔虫,4182,0,0,1,1,0.0%,28m
893,3,[北极光小组]JerryYung,4182,0,0,1,1,0.0%,38m
897,3,IIIIIIII,4181,1462,79,81,160,49.4%,37m
897,3,llllllllllll,4181,93,1,1,2,50.0%,32m
897,3,慕容熙,4181,0,0,1,1,0.0%,32m
900,3,Rechange,4180,1336,81,77,158,51.3%,37m
900,3,活好不粘人,4180,778,45,31,76,59.2%,37m
900,3,[青生浮梦]青木裕光,4180,592,22,15,37,59.5%,18m
900,3,[目標諾森德]打个毛的星际,4180,28,4,6,10,40.0%,38m
900,3,星际好玩极了,4180,127,3,2,5,60.0%,16m
900,3,一级顶别人一百级,4180,0,0,1,1,0.0%,5m
906,3,[执政联盟]吉姆谨慎,4178,499,24,7,31,77.4%,4m
906,3,[帝国Aeon]哈斯卡,4178,79,4,5,9,44.4%,9m
906,3,[送分大佬]海若有因,4178,0,0,1,1,0.0%,28m
909,3,[丨SLT丨]榜白白,4177,903,44,31,75,58.7%,18m
909,3,TNT,4177,147,5,3,8,62.5%,29m
909,3,[TS嘉年华]sjz,4177,0,1,0,1,100.0%,32m
912,3,夏弥,4176,188,84,61,145,57.9%,16m
912,3,INnoVation,4176,144,53,23,76,69.7%,38m
912,3,Momo,4176,184,16,18,34,47.1%,18m
912,2,[四叶草]深海鱼人蝶,4176,275,10,19,29,34.5%,30m
912,3,[miku守护]warrior,4176,171,5,2,7,71.4%,19m
912,3,[PUSC2]Moriarty,4176,0,0,1,1,0.0%,29m
918,3,[KPG]咱家不怕酸,4175,1249,375,354,729,51.4%,28m
918,3,小白兔,4175,740,35,9,44,79.5%,18m
918,3,[白银联盟]雷诺的小迷妹,4175,97,13,3,16,81.2%,32m
918,3,Serana,4175,0,1,0,1,100.0%,16m
918,3,[HK丶S]屠杀弟弟,4175,0,0,1,1,0.0%,32m
923,3,[教我玩神族]Kirito,4174,12,1,3,4,25.0%,9m
923,1,[大魔王先生]KarCher,4174,0,0,3,3,0.0%,6m
925,3,省油的灯,4173,1434,132,103,235,56.2%,4m
925,3,[GAGA]银鳞胸甲,4173,848,119,111,230,51.7%,16m
925,3,[幽灵闪现wo]TheSoldier,4173,1005,65,50,115,56.5%,28m
925,3,[蓝鲸何平]肥宅的快乐,4173,854,56,17,73,76.7%,9m
925,3,[EC]歪嘴战神,4173,417,44,10,54,81.5%,38m
930,3,沉默之剑,4172,957,228,225,453,50.3%,18m
930,3,[采儒基]宅可夫斯基,4172,92,115,99,214,53.7%,17m
930,3,llllllllllll,4172,651,57,60,117,48.7%,17m
933,3,七零后,4171,903,40,27,67,59.7%,9m
933,3,[你们都是渣]你们都是渣,4171,566,26,1,27,96.3%,4m
935,3,[太微玉清宫]开天持符御天上帝,4170,368,19,6,25,76.0%,4m
935,3,[BREEZ]咲暗,4170,96,9,1,10,90.0%,32m
937,3,[不会散枪兵]呼啦啦旋风,4169,1471,242,233,475,50.9%,5m
937,3,[东华大学]练出来了,4169,799,78,65,143,54.5%,11m
937,3,时空旋,4169,757,56,20,76,73.7%,28m
937,3,KPOkaht,4169,139,28,2,30,93.3%,17m
937,3,羽落星辰,4169,169,4,1,5,80.0%,9m
937,2,[WHU]SevenChen,4169,0,0,1,1,0.0%,26m
943,3,黑岛视界,4168,177,47,1,48,97.9%,16m
944,3,lllllllllll,4167,1092,84,75,159,52.8%,5m
944,3,[qweqwe]二块钱的人,4167,527,26,7,33,78.8%,4m
946,3,NADA,4166,1211,49,45,94,52.1%,18m
947,3,IIIIIIIIII,4165,1575,308,288,596,51.7%,19m
947,3,[Igirls]愿我人族星火世传,4165,1130,64,65,129,49.6%,17m
947,3,BlueSun,4165,239,8,0,8,100.0%,17m
947,1,已连接灭亡迅雷站,4165,0,0,1,1,0.0%,17m
951,3,吟风弄月,4164,160,14,16,30,46.7%,5m
951,3,[CMbiss]臭鱼烂虾,4164,48,6,14,20,30.0%,9m
951,3,[PTB]血色天籁,4164,0,1,2,3,33.3%,32m
951,2,IIIIIIIIIIII,4164,0,0,1,1,0.0%,19m
955,3,气挖,4163,1387,64,43,107,59.8%,4m
955,3,夜隐游花,4163,127,3,3,6,50.0%,16m
955,3,[丨SLT丨]残酷天使,4163,0,1,3,4,25.0%,28m
955,3,[猫猫神教]九条命的猫神,4163,0,0,1,1,0.0%,32m
959,3,叽里咕噜长蘑菇,4162,174,8,3,11,72.7%,29m
959,3,九筒,4162,0,0,1,1,0.0%,16m
959,3,[我们是无敌的]IIIIIIIIIIII,4162,0,0,2,2,0.0%,32m
962,3,一夜懆邢凯仑六次,4161,382,27,8,35,77.1%,28m
962,3,[谁在呼叫舰队]红茶奶昔,4161,0,0,1,1,0.0%,16m
964,3,[五月花]由崎星空,4160,620,58,24,82,70.7%,9m
964,3,[拜仁]Ballack,4160,0,1,0,1,100.0%,28m
964,3,[耀夜]aurora,4160,0,0,1,1,0.0%,9m
967,2,[叫我兔本]mikasa,4159,2430,205,225,430,47.7%,22m
967,3,llllllll,4159,1589,100,100,200,50.0%,9m
969,3,[H1st]奔五大叔,4158,596,57,56,113,50.4%,37m
970,3,别偷看我,4157,2273,507,516,1023,49.6%,37m
970,1,摔跤不带滚,4157,192,5,0,5,100.0%,4m
972,2,[NVKR]姑娘别跑呀,4155,1022,57,57,114,50.0%,27m
973,3,[我们是无敌的]纵横熊猫,4154,569,36,31,67,53.7%,16m
973,2,[Chivo]llllllllllll,4154,0,0,5,5,0.0%,16m
973,3,Paulyau,4154,0,0,5,5,0.0%,11m
976,3,[SK]IIIIIIIIIIII,4153,982,107,103,210,51.0%,38m
977,3,[SC2近卫军]茜佳佳,4152,267,8,5,13,61.5%,16m
978,2,喵喵只,4151,259,15,22,37,40.5%,14m
978,3,[刺蛇互助天团]Artia,4151,0,1,1,2,50.0%,9m
980,3,三水,4149,543,38,4,42,90.5%,11m
980,1,[TLA]Wehrmacht,4149,0,0,1,1,0.0%,30m
982,3,[宇宙职业战队]耗子尾汁,4148,478,19,16,35,54.3%,11m
982,3,[EZWIN]llllllllllll,4148,200,7,4,11,63.6%,5m
982,1,NieJiPi,4148,0,0,1,1,0.0%,32m
985,3,玖娘丸子,4147,920,51,30,81,63.0%,38m
985,3,越前龙雅,4147,578,24,19,43,55.8%,38m
987,1,[Elite]TYPEMOON,4146,1508,51,26,77,66.2%,4m
988,3,[情谊至上]星群大战,4145,464,27,15,42,64.3%,28m
988,3,[小练家子]摆地摊卖毒爆,4145,104,9,16,25,36.0%,37m
988,3,[一等星]lingzhengjie,4145,58,6,7,13,46.2%,32m
991,1,[登陆是无敌哒]小乔要努力变强,4144,0,0,1,1,0.0%,28m
991,1,avacheung,4144,0,0,1,1,0.0%,28m
993,3,[这人倍儿帅]王二牛,4143,274,19,28,47,40.4%,38m
994,3,[南京工业大学]重熙累叶,4142,196,13,13,26,50.0%,11m
995,3,吾妻刘娇娇,4141,763,58,24,82,70.7%,28m
996,2,沉默内漂泊,4140,0,5,0,5,100.0%,18m
997,1,[YA]快仙刀,4139,0,1,0,1,100.0%,6m
997,1,[pp]YHC,4139,0,0,2,2,0.0%,32m
999,2,[你渴望力量吗]锁妖,4138,510,25,37,62,40.3%,27m
1000,3,[VirGo]鲜明,4136,0,1,3,4,25.0%,11m
1001,3,林肯公园,4135,107,49,43,92,53.3%,28m
1001,1,[凯哥集团]单排狂魔,4135,190,5,2,7,71.4%,32m
1003,3,[NeXT]MrZain,4134,18,3,12,15,20.0%,9m
1004,3,黑马王子,4133,185,9,15,24,37.5%,29m
1005,1,[白给李老八]TIME,4131,0,0,1,1,0.0%,34m
1006,3,[秋毫第七分队]唧唧复唧唧,4129,1008,79,82,161,49.1%,38m
1007,1,LuckyNaki,4128,2179,254,239,493,51.5%,12m
1007,2,[全天在线]全网最高虫族陪练,4128,48,2,8,10,20.0%,7m
1009,3,AIFOX,4125,560,28,25,53,52.8%,28m
1009,3,菜鸟,4125,119,4,3,7,57.1%,17m
1011,3,shuipingxian,4124,1005,50,38,88,56.8%,9m
1011,3,ilcsc,4124,241,19,20,39,48.7%,32m
1013,3,Eric,4123,2261,215,214,429,50.1%,16m
1014,3,[冰泪湖的岸边]冰冻誓言,4122,180,11,23,34,32.4%,37m
1015,3,jerry,4121,74,7,16,23,30.4%,28m
1015,3,风吹裤裆蛋蛋凉,4121,0,0,4,4,0.0%,28m
1017,1,shownow,4120,0,0,1,1,0.0%,11m
1018,1,密斯姐姐的斯密,4119,0,0,1,1,0.0%,18m
1019,1,划水摸鱼真开心,4118,170,6,28,34,17.6%,34m
1020,3,[那里不可以]Marsspider,4117,196,6,5,11,54.5%,16m
1021,1,fantasy,4116,144,4,3,7,57.1%,24m
1022,3,[谐逼]成都毒奶色,4115,477,21,16,37,56.8%,9m
1023,3,iiiiiiiiii,4114,1432,171,162,333,51.4%,38m
1024,3,云里雾里莎,4113,120,5,6,11,45.5%,32m
1025,3,[Shawk]萌新神族,4112,1150,87,98,185,47.0%,32m
1026,3,多线爆炸,4111,550,40,39,79,50.6%,17m
1027,1,援气少女柠檬酱,4110,0,0,1,1,0.0%,27m
1027,3,lllllll,4110,0,0,6,6,0.0%,32m
1029,3,[汉堡FANS]cjcc,4109,596,172,151,323,53.3%,16m
1029,3,DrSk,4109,823,143,133,276,51.8%,9m
1029,3,magiczerg,4109,1318,66,79,145,45.5%,5m
1032,1,奥尔加一直卡,4107,48,1,3,4,25.0%,4m
1033,3,llllllllllll,4106,817,103,66,169,60.9%,28m
1033,1,IIIIIIIII,4106,48,2,1,3,66.7%,17m
1035,3,[世纪末救世主]炽丶芯,4105,97,2,3,5,40.0%,28m
1036,1,[五月花]摇头猫,4104,48,2,2,4,50.0%,10m
1037,1,[青铜树]曼珠沙华,4103,48,2,2,4,50.0%,27m
1038,1,[Warp]希格斯玻色子,4102,424,9,10,19,47.4%,31m
1038,1,[瀚海星云]SColdman,4102,48,2,1,3,66.7%,24m
1038,1,把我的宿主还给我,4102,0,0,2,2,0.0%,6m
1041,3,[你画我瞎]究极神兵绝境战,4100,1087,183,162,345,53.0%,16m
1042,1,大魔王李解冻,4099,1939,223,205,428,52.1%,6m
1042,1,[KPG]曾經最美最美曾經,4099,1474,40,31,71,56.3%,6m
1042,1,[TNLet]Spirit,4099,48,2,0,2,100.0%,34m
1045,3,IIIIIIIIIII,4097,1910,152,154,306,49.7%,18m
1045,2,[雪月]回归的狙击手,4097,0,3,3,6,50.0%,16m
1045,3,反贪方知无官正,4097,0,0,4,4,0.0%,38m
1048,3,Jonathan,4096,1057,56,57,113,49.6%,4m
1048,1,夜醉金陵,4096,652,17,3,20,85.0%,17m
1048,1,[小剑人]竹子,4096,96,3,1,4,75.0%,32m
1051,3,橘子,4095,730,63,60,123,51.2%,16m
1051,1,[浪啊浪]闲逛的馒头,4095,1149,28,22,50,56.0%,18m
1051,1,沙河口南波万,4095,830,19,18,37,51.4%,17m
1051,1,[很萌日很新]王英俊,4095,166,3,3,6,50.0%,31m
1055,3,[武汉理工大学]鹤望兰,4094,269,18,16,34,52.9%,10m
1056,1,ggsimida,4093,1086,33,27,60,55.0%,8m
1056,3,Tensor,4093,189,10,13,23,43.5%,17m
1056,1,[北京城管]值得回忆,4093,0,0,1,1,0.0%,10m
1056,2,[Shawk]伊莉雅,4093,0,0,1,1,0.0%,9m
1060,3,lakemoon,4092,1460,84,93,177,47.5%,37m
1060,1,[喝馄饨]阿要辣油啊,4092,544,16,13,29,55.2%,10m
1060,3,llllllllllll,4092,41,7,9,16,43.8%,17m
1060,3,[禽禽禽]IIIIIIIIIIII,4092,104,7,17,24,29.2%,17m
1064,1,[SK]灵能风暴中的跳虫,4091,1506,40,33,73,54.8%,28m
1064,2,[威震天下]Aoney,4091,0,1,0,1,100.0%,12m
1066,1,[二战统帅部]linear,4090,192,5,7,12,41.7%,8m
1066,1,[YA]llllllllllll,4090,48,2,0,2,100.0%,18m
1068,2,zxrai,4089,2380,259,250,509,50.9%,30m
1068,1,[只想干神族]尼玛花园,4089,468,11,3,14,78.6%,4m
1068,1,[SK]七月流火,4089,332,7,4,11,63.6%,5m
1071,1,ZHZHZ,4088,0,1,1,2,50.0%,33m
1072,1,MagicRevive,4086,2025,82,32,114,71.9%,36m
1072,2,[萌新保护协议]Nico,4086,250,12,1,13,92.3%,34m
1074,1,[扫黄]踹铺七分钟打不死,4085,1590,53,42,95,55.8%,17m
1074,1,咦这只竹鼠中暑了,4085,1416,35,29,64,54.7%,31m
1076,3,LastZerg,4084,276,18,27,45,40.0%,16m
1076,1,御坂美琴,4084,48,1,6,7,14.3%,31m
1076,2,[肃清者]陨落之殇,4084,0,0,5,5,0.0%,24m
1079,1,[NGA观察团]莽莽莽莽女王,4082,1807,93,95,188,49.5%,10m
1079,3,[直男玩具]一米九的玩具,4082,485,29,28,57,50.9%,16m
1079,3,[AnSwer]和你开玩笑,4082,36,4,10,14,28.6%,16m
1079,1,[铁窗之友]life,4082,94,2,1,3,66.7%,6m
1079,1,[YR]HappyOct,4082,0,0,1,1,0.0%,32m
1084,1,半糖提拉米苏,4081,0,0,1,1,0.0%,31m
1085,1,[星际争霸第一]EnterprisE,4080,715,18,22,40,45.0%,30m
1085,1,[雨何时会停]Akiha,4080,376,9,2,11,81.8%,6m
1087,1,[Revive]我只爱绿茶表,4079,991,34,15,49,69.4%,11m
1088,1,[变态萝莉控]艾尔又双叒叕停电,4076,0,0,3,3,0.0%,36m
1089,3,Lindada,4075,56,7,13,20,35.0%,11m
1090,1,[极坐标]练回去了,4074,715,26,12,38,68.4%,5m
1090,2,Atns,4074,0,1,0,1,100.0%,11m
1092,2,[火焰雷兽]Wangjiet,4073,2224,428,326,754,56.8%,14m
1092,3,[金灿灿狙击队]llllllllllll,4073,490,29,41,70,41.4%,29m
1092,2,杀手皇后,4073,292,11,26,37,29.7%,19m
1092,1,star,4073,286,6,8,14,42.9%,27m
1096,3,幸福一家人,4071,1726,121,126,247,49.0%,32m
1096,1,FatBird,4071,144,3,4,7,42.9%,11m
1098,1,一人一,4070,2169,136,134,270,50.4%,10m
1098,1,[C02337]阿发,4070,565,20,2,22,90.9%,8m
1100,2,[水光潋滟]klk,4069,473,25,39,64,39.1%,7m
1100,3,ASK,4069,278,11,11,22,50.0%,9m
1100,1,[一起多人运动]肥崽,4069,48,1,3,4,25.0%,36m
1100,1,神族是我爹,4069,0,0,4,4,0.0%,11m
1104,2,[KPG]浅浅,4067,0,0,1,1,0.0%,31m
1105,1,[CnNami]谢谢你苏小洛,4066,981,26,11,37,70.3%,36m
1105,1,三毛,4066,0,0,1,1,0.0%,32m
1107,3,[暴雪我是你爹]虎皮海椒,4065,1546,253,243,496,51.0%,18m
1108,3,[肉鸡的饲养]魔法少女鸭鸭酱,4064,794,72,70,142,50.7%,32m
1108,1,[YM]Littlefly,4064,990,24,21,45,53.3%,6m
1110,3,[SdDdG]LEE,4063,1630,450,468,918,49.0%,32m
1110,2,[KPG]龟田一峰,4063,0,1,0,1,100.0%,38m
1110,1,花园百合铃,4063,0,1,0,1,100.0%,18m
1110,1,RomainsPB,4063,0,0,1,1,0.0%,6m
1114,1,Satie,4061,310,11,6,17,64.7%,12m
1115,1,[NPUED]Stalker,4060,0,2,3,5,40.0%,8m
1115,1,[二狗星际]百地希留耶,4060,0,0,1,1,0.0%,8m
1117,2,[手握黄金舰队]挽星,4058,0,0,1,1,0.0%,16m
1118,1,自我发电友友酱,4057,938,25,18,43,58.1%,17m
1119,3,四十而立,4056,385,77,74,151,51.0%,16m
1119,3,[萌新保护协议]扣得怎么这么菜,4056,415,20,20,40,50.0%,9m
1121,3,[Rhusky]IceLin,4054,1438,71,82,153,46.4%,17m
1122,3,jump,4053,178,12,26,38,31.6%,10m
1123,3,[TAPC]jhxz,4052,143,6,11,17,35.3%,11m
1124,2,[KPG]现实中我沉默不语,4049,2313,455,441,896,50.8%,27m
1124,1,[SK]十六夜咲夜,4049,898,26,20,46,56.5%,17m
1126,1,[ZTSCAP]塔下意识粉,4048,674,49,39,88,55.7%,19m
1127,1,[文韬武略]越狱兔,4047,1053,34,17,51,66.7%,10m
1127,1,冰冰敲可耐,4047,0,1,0,1,100.0%,10m
1129,2,[此生灬无惧]竹外秋生渐作威丶,4046,0,0,1,1,0.0%,9m
1130,1,[FORI2]加藤鹰之鸡,4044,2075,148,125,273,54.2%,34m
1130,1,[兔兔之家]OOOOOO,4044,466,10,11,21,47.6%,4m
1132,1,[SC联盟]BloodRainbow,4043,1496,289,282,571,50.6%,19m
1132,2,李小耗子,4043,251,8,5,13,61.5%,19m
1132,3,IIIIIIIIIIII,4043,78,8,17,25,32.0%,33m
1132,1,专门狙击一束七,4043,280,6,2,8,75.0%,11m
1132,1,[TwT]黒猫,4043,0,1,0,1,100.0%,30m
1137,3,别狗好好打,4042,1215,62,51,113,54.9%,5m
1138,1,[Igirls]Summer,4041,0,0,1,1,0.0%,17m
1138,1,薛定谔的慕斯里,4041,0,0,1,1,0.0%,30m
1140,1,[五月花]歨冥谷乂,4040,0,0,4,4,0.0%,11m
1141,1,[FFJ]快看我和善的眼神,4039,1125,36,37,73,49.3%,18m
1141,2,[SK]竹杖芒鞋,4039,0,1,1,2,50.0%,27m
1141,1,廉颇老矣,4039,48,1,6,7,14.3%,19m
1141,1,[五月花]舞殇,4039,0,0,1,1,0.0%,36m
1145,1,[四傻]PalaDin,4038,1667,68,47,115,59.1%,32m
1146,2,[Ace丶]花样作死冠军,4036,0,0,1,1,0.0%,12m
1147,1,妈个鸡泽哥,4035,590,14,8,22,63.6%,6m
1148,1,好闻的胖次,4034,624,36,26,62,58.1%,30m
1148,3,[CNN1]卷鸡神经网,4034,32,2,2,4,50.0%,37m
1148,2,[亚洲气质虫王]predator,4034,0,1,1,2,50.0%,27m
1151,1,Alex,4032,1576,126,102,228,55.3%,34m
1152,1,面如霜下雪,4030,0,0,1,1,0.0%,11m
1153,1,山丘,4029,190,4,1,5,80.0%,11m
1153,2,SAJ,4029,0,0,1,1,0.0%,38m
1155,1,[TLGD]IIIIIIIIIII,4028,284,7,10,17,41.2%,6m
1156,2,[白银联盟]孤狼,4027,181,9,4,13,69.2%,7m
1157,3,[TS嘉年华]猪头山,4026,610,80,76,156,51.3%,16m
1157,3,建议你别让我回头,4026,0,0,1,1,0.0%,37m
1159,1,llllllllllll,4024,2112,123,79,202,60.9%,6m
1159,1,[TYLOO]Foued,4024,406,11,8,19,57.9%,19m
1161,1,慧英,4021,1506,45,29,74,60.8%,6m
1162,3,[同浙星际]Gravity,4019,1952,105,115,220,47.7%,10m
1163,1,冮洚民,4018,561,15,13,28,53.6%,17m
1164,1,[小金上天队]久睡成瘾,4017,0,1,2,3,33.3%,6m
1165,3,llllllllllll,4016,135,5,9,14,35.7%,28m
1165,1,[左边的兄弟]再信我一次,4016,0,0,1,1,0.0%,19m
1165,1,[WILLE]Stevie,4016,0,0,1,1,0.0%,19m
1168,3,[SK]重新开始练,4015,1116,66,58,124,53.2%,5m
1168,1,[禽禽禽]白斩鸡,4015,1111,48,9,57,84.2%,34m
1168,1,[丨SLT丨]Stats,4015,806,32,5,37,86.5%,10m
1168,3,向死而生,4015,0,3,2,5,60.0%,24m
1172,2,嘤帼星际大力士,4014,128,4,3,7,57.1%,22m
1172,1,久红,4014,144,4,6,10,40.0%,4m
1174,2,[送温暖战队]焦焦,4013,0,1,5,6,16.7%,6m
1174,1,夜樱,4013,0,0,1,1,0.0%,27m
1176,3,[FPT]vajva,4011,1461,207,196,403,51.4%,5m
1176,1,DietmarP,4011,144,3,3,6,50.0%,31m
1178,1,久溺沉海,4010,162,5,1,6,83.3%,30m
1178,1,lllllllll,4010,48,1,1,2,50.0%,36m
1180,2,[不会散枪兵]冬眠中的肥猫,4009,116,7,1,8,87.5%,22m
1180,1,[毛毛]llllllllllll,4009,46,2,0,2,100.0%,6m
1180,1,llllllllllll,4009,0,0,1,1,0.0%,10m
1180,2,[萝莉之芯]搞搞,4009,0,0,1,1,0.0%,19m
1184,3,[哔翻天梯鸡]湖州张智霖,4008,1475,149,147,296,50.3%,4m
1184,1,[五月花]aiko,4008,985,82,76,158,51.9%,6m
1184,3,[北京大学鸡协]小蛋壳,4008,421,42,53,95,44.2%,29m
1184,1,IIIIIIIIIIII,4008,278,10,5,15,66.7%,17m
1184,1,Dark,4008,372,8,8,16,50.0%,8m
1184,1,励志上宗师,4008,0,1,1,2,50.0%,17m
1190,3,[KPG]没头脑,4007,2052,98,105,203,48.3%,18m
1190,1,时之回声,4007,705,23,13,36,63.9%,11m
1192,1,流响疏桐,4006,188,4,6,10,40.0%,24m
1193,1,IIIIIIIIIIII,4004,280,7,3,10,70.0%,6m
1193,1,[火猫哥斯拉]SoO,4004,46,2,3,5,40.0%,11m
1193,1,Noobfxxker,4004,0,1,0,1,100.0%,11m
1196,1,EleVen,4003,1593,133,110,243,54.7%,17m
1196,1,CowSheep,4003,1093,31,31,62,50.0%,30m
1196,1,horO,4003,890,27,21,48,56.2%,5m
1196,1,[辉煌华夏]jiaserj,4003,922,22,21,43,51.2%,8m
1200,3,本名字仅供参考,4002,2116,413,428,841,49.1%,38m
1201,1,[暴雪我是你爹]gene,4000,2114,161,157,318,50.6%,8m
1201,2,埃蒙,4000,121,8,0,8,100.0%,16m
1201,3,[1232]次元之恋,4000,0,1,4,5,20.0%,20m
1201,1,[呼啸山鹰]薯条单推人,4000,0,0,1,1,0.0%,10m
1201,2,[麻酱罐]陈王,4000,0,0,1,1,0.0%,29m
1201,1,孤儿请滚,4000,0,0,1,1,0.0%,34m
1207,1,[雾雨魔法森林]那个男人,3999,0,1,0,1,100.0%,27m
1208,1,[YM]凉城旧梦,3996,0,0,1,1,0.0%,6m
1209,1,[KPG]Soskovka,3995,48,2,6,8,25.0%,34m
1209,1,[娱乐吃鸡]人在塔在,3995,0,0,3,3,0.0%,6m
1211,3,lllllllllll,3994,320,12,21,33,36.4%,5m
1212,1,UntilWeDie,3992,600,14,10,24,58.3%,28m
1213,2,[看啥]tankboy,3991,236,12,2,14,85.7%,29m
1213,2,Reol,3991,173,8,4,12,66.7%,10m
1213,1,[爱国武术家]可爱的小树,3991,48,1,3,4,25.0%,36m
1216,1,[叫我兔本]王朗,3990,0,0,2,2,0.0%,10m
1217,1,llllllllll,3989,48,1,6,7,14.3%,36m
1218,3,[1990]斗鱼直播继良云,3988,0,0,1,1,0.0%,30m
1218,1,天禄的小鬼本人,3988,0,0,3,3,0.0%,17m
1220,1,llllllllllll,3987,94,2,5,7,28.6%,4m
1221,1,Summer,3986,959,43,38,81,53.1%,24m
1222,1,[月下夜袭]月光下的螳螂,3985,179,6,1,7,85.7%,12m
1222,2,弱智也有春天,3985,0,0,1,1,0.0%,24m
1222,1,Creativity,3985,0,0,4,4,0.0%,6m
1225,1,[野怪也是虫]Misaka,3983,0,0,1,1,0.0%,8m
1226,1,IIIIIIIIIIII,3982,902,22,15,37,59.5%,4m
1226,1,[Holyam]palion,3982,801,20,20,40,50.0%,30m
1226,1,太仓药贩子,3982,0,1,0,1,100.0%,17m
1226,1,嘤嘤嘤,3982,46,1,2,3,33.3%,33m
1230,1,[HeroZP]索伦之眼,3981,2078,330,324,654,50.5%,10m
1230,1,[rush2]DNA,3981,94,2,2,4,50.0%,8m
1232,1,lllll,3980,281,6,5,11,54.5%,31m
1232,1,[银荡可方万物]爱是一道绿光,3980,0,0,1,1,0.0%,6m
1234,3,[I徐佳莹I]沧海客,3979,4,2,9,11,18.2%,9m
1234,1,llllllllll,3979,0,1,0,1,100.0%,36m
1234,1,IIIIIIIIIIII,3979,0,1,2,3,33.3%,4m
1234,1,大魔王,3979,0,0,2,2,0.0%,11m
1238,1,随机尼玛呢随机,3978,2095,323,305,628,51.4%,24m
1238,2,Paul,3978,1122,183,200,383,47.8%,14m
1238,1,ZYL,3978,1288,80,54,134,59.7%,28m
1241,1,FateHarlaown,3977,48,2,3,5,40.0%,18m
1241,1,起名无能,3977,0,1,0,1,100.0%,24m
1241,1,[Borne]团子,3977,0,0,1,1,0.0%,6m
1241,1,[LyN]ice,3977,0,0,3,3,0.0%,4m
1245,1,sebenshu,3975,0,0,1,1,0.0%,10m
1246,2,海沧岚,3974,0,1,0,1,100.0%,23m
1247,1,银枪小霸王,3973,982,27,24,51,52.9%,27m
1247,1,sMo,3973,0,1,0,1,100.0%,11m
1249,1,[YT]布鲁诺,3972,2083,303,282,585,51.8%,5m
1249,3,[传说萌娘团]IIIIIIIIIIII,3972,2025,260,265,525,49.5%,11m
1251,1,七喜,3971,0,0,1,1,0.0%,6m
1252,1,凉白开,3969,140,3,10,13,23.1%,17m
1253,1,[丨SLT丨]洪承畴,3968,666,15,13,28,53.6%,4m
1253,1,暗龙,3968,370,8,5,13,61.5%,30m
1255,1,attiii,3967,2083,377,357,734,51.4%,17m
1255,1,xyfansNMSL,3967,2064,302,279,581,52.0%,5m
1255,1,[NVKR]徘徊底层的大佬,3967,1965,103,81,184,56.0%,33m
1255,1,[卡钦斯基跤流]JustMonika,3967,598,20,18,38,52.6%,17m
1255,1,快乐星际,3967,0,0,1,1,0.0%,31m
1255,1,Maru,3967,0,0,2,2,0.0%,18m
1261,1,bangeV,3965,96,3,3,6,50.0%,27m
1262,3,suyouck,3964,62,3,5,8,37.5%,6m
1263,1,[orjer]orjer,3963,1514,84,68,152,55.3%,11m
1263,1,leexzq,3963,1642,45,45,90,50.0%,8m
1263,1,mumu,3963,0,1,0,1,100.0%,34m
1266,1,[近卫第二师团]飞侠,3962,2099,173,167,340,50.9%,33m
1266,1,[七咕咕]自动机炮,3962,920,22,24,46,47.8%,17m
1268,1,[格里芬克鲁格]荒原老铁,3961,2004,74,69,143,51.7%,31m
1268,1,DietmarP,3961,964,24,23,47,51.1%,6m
1268,1,lacker,3961,238,5,15,20,25.0%,31m
1268,1,舍弃与改变,3961,0,1,1,2,50.0%,33m
1268,1,[星灵王]我以为先生,3961,0,0,1,1,0.0%,33m
1273,1,Senior,3959,743,29,10,39,74.4%,28m
1273,1,Aozora,3959,0,1,1,2,50.0%,17m
1275,3,[Happy]若龍,3957,2082,756,767,1523,49.6%,29m
1275,1,老年人打星际,3957,2046,298,291,589,50.6%,11m
1275,1,拥抱凯瑞根,3957,418,9,13,22,40.9%,11m
1275,1,whybwhyb,3957,0,0,2,2,0.0%,10m
1279,1,美丽可爱大桃子,3956,1435,45,44,89,50.6%,17m
1279,1,[SoloAs]FiveSix,3956,0,0,1,1,0.0%,8m
1281,1,isafire,3955,0,1,0,1,100.0%,11m
1282,1,HellBoy,3954,2055,516,529,1045,49.4%,24m
1282,3,[Pro]GSCC,3954,1941,141,134,275,51.3%,9m
1282,1,[RyH键谈坊]魂魄妖梦,3954,278,7,3,10,70.0%,10m
1282,1,[GaHo]虎牙易大师,3954,0,0,1,1,0.0%,8m
1286,2,小骨瑞克,3953,248,10,1,11,90.9%,24m
1286,1,chinahudie,3953,0,0,2,2,0.0%,24m
1288,1,DietmarP,3952,1160,35,34,69,50.7%,17m
1288,1,[红魔馆的主人]东风谷早苗,3952,0,1,1,2,50.0%,6m
1288,1,[INS48]阴险的老母鸡,3952,0,0,1,1,0.0%,17m
1291,2,[百香果菠萝人]止损,3951,127,5,1,6,83.3%,18m
1292,1,大王叫我来巡山,3950,1681,51,53,104,49.0%,30m
1292,2,SDF,3950,358,10,9,19,52.6%,16m
1294,1,专治粪坑机械化,3949,1888,99,90,189,52.4%,6m
1294,1,lllllllllll,3949,859,57,45,102,55.9%,18m
1294,1,Maru,3949,928,22,20,42,52.4%,8m
1294,1,phmeet,3949,590,14,14,28,50.0%,18m
1294,1,Veneno,3949,412,9,7,16,56.2%,11m
1294,3,Wilhelmine,3949,0,1,0,1,100.0%,35m
1300,1,东霸天,3948,144,3,9,12,25.0%,6m
1300,1,[学习使我快乐]不要以为你赢了,3948,94,2,2,4,50.0%,5m
1302,1,老虚无,3946,48,2,2,4,50.0%,5m
1302,1,阿巴阿巴阿巴瑟,3946,0,1,0,1,100.0%,8m
1302,1,[抱兔望月归]racconOak,3946,0,0,1,1,0.0%,11m
1305,1,[BGD]比比,3945,574,14,12,26,53.8%,8m
1306,1,shadow,3944,276,6,6,12,50.0%,6m
1307,2,LinkDran,3943,46,4,6,10,40.0%,31m
1308,1,赵红兵,3942,1909,253,213,466,54.3%,6m
1308,2,要分直说别狗,3942,148,6,12,18,33.3%,23m
1310,1,树梢上的霜,3941,0,0,1,1,0.0%,8m
1311,1,IIIIIIIIIIII,3940,186,4,4,8,50.0%,28m
1312,3,草莓熊小粉拳,3939,192,10,0,10,100.0%,25m
1312,1,青青的叶子,3939,280,7,13,20,35.0%,33m
1312,3,九条都,3939,58,3,0,3,100.0%,18m
1315,1,[Solo]无星天吹,3938,0,1,0,1,100.0%,34m
1315,1,iGFox,3938,48,1,4,5,20.0%,34m
1315,1,SKTBisu,3938,0,0,2,2,0.0%,10m
1318,1,LazyTurtle,3937,952,71,62,133,53.4%,18m
1318,1,llllllllllll,3937,0,3,2,5,60.0%,6m
1320,1,[SKT俱乐部]老胸哥,3935,2058,439,447,886,49.5%,11m
1320,1,猫爷,3935,0,0,1,1,0.0%,33m
1322,2,desk,3934,314,12,7,19,63.2%,16m
1323,1,商小影,3933,289,25,68,93,26.9%,35m
1323,2,[DMDG]qpc,3933,206,8,13,21,38.1%,16m
1325,1,greatCSS,3932,471,13,3,16,81.2%,31m
1325,2,xxxxx,3932,312,13,7,20,65.0%,35m
1325,1,llllllllllll,3932,0,1,5,6,16.7%,6m
1328,3,丶唐尔盖茨,3931,46,7,19,26,26.9%,38m
1329,1,无视,3930,1449,93,99,192,48.4%,8m
1329,3,[C02337]阿葵,3930,145,8,0,8,100.0%,18m
1331,1,[HDV]李晓桐,3929,0,1,0,1,100.0%,4m
1332,1,[艾利克斯]温柔可爱的小女仆,3928,0,0,3,3,0.0%,10m
1333,1,[哥哥帮我]打手冲,3927,358,8,4,12,66.7%,24m
1333,1,咦咦咦,3927,48,2,3,5,40.0%,33m
1335,3,[内蒙古海军]内蒙古人皇,3925,10,2,14,16,12.5%,38m
1336,1,[小萝莉的日常]八云蓝,3924,454,10,12,22,45.5%,4m
1336,1,[YMET]IIIIIIIIIIII,3924,186,5,2,7,71.4%,34m
1338,1,[OKC]距离感,3923,46,1,1,2,50.0%,4m
1339,3,[艾尔之主]狡猾之异虫,3918,390,122,133,255,47.8%,11m
1339,1,[大阪男同王]言尽,3918,1010,24,30,54,44.4%,8m
1339,1,[凯哥集团]打不过就用接化发,3918,339,9,8,17,52.9%,19m
1342,2,wwj,3917,2161,300,312,612,49.0%,27m
1343,1,[纸壳]誓死效忠埃蒙,3916,228,5,3,8,62.5%,4m
1343,1,[萌佬同好会]夏利沫沫,3916,92,3,0,3,100.0%,33m
1343,1,[鹿枝猫]鹿枝诺白,3916,0,0,1,1,0.0%,6m
1343,1,IIIIIIIIIIII,3916,0,0,2,2,0.0%,8m
1347,1,yumiko,3915,1249,54,52,106,50.9%,19m
1347,3,希里吉薇艾尔之父,3915,0,1,1,2,50.0%,29m
1347,1,liebecalls,3915,48,1,10,11,9.1%,6m
1350,1,lllllllllll,3914,186,4,9,13,30.8%,8m
1351,1,[Hist]remiss,3912,1716,104,98,202,51.5%,24m
1351,1,[PTB]DPGEnchant,3912,92,2,2,4,50.0%,5m
1353,1,WJW,3911,2046,403,403,806,50.0%,10m
1353,1,[查尔高阶枪兵]星辰,3911,1706,88,79,167,52.7%,36m
1353,3,llllllllllll,3911,214,10,21,31,32.3%,32m
1353,1,木西子,3911,0,0,2,2,0.0%,8m
1357,1,[广场舞领队]阿姨,3910,0,1,0,1,100.0%,28m
1358,1,[看啥]老庙,3908,2066,263,266,529,49.7%,18m
1358,1,[制杖也有春天]SunDarkPao,3908,108,10,6,16,62.5%,7m
1358,1,[Hindi]JJSYDW,3908,0,1,0,1,100.0%,10m
1358,1,[小剑人]小闲闲闲闲闲,3908,48,1,2,3,33.3%,19m
1362,1,[SLB]落天血,3907,92,3,1,4,75.0%,31m
1362,1,[孙红雷]llllllllllll,3907,0,0,1,1,0.0%,30m
1364,3,jiubalian,3906,254,197,211,408,48.3%,37m
1364,3,茎肛互撸娃,3906,1541,89,107,196,45.4%,38m
1364,1,ZZOFSTZZ,3906,44,1,3,4,25.0%,30m
1364,1,兔子会飞,3906,0,0,1,1,0.0%,36m
1368,1,乾坤无定,3904,973,25,21,46,54.3%,18m
1368,1,三死神跳牛,3904,0,1,0,1,100.0%,4m
1370,3,[Beasty]阳光,3903,0,0,5,5,0.0%,8m
1371,3,白玉京,3902,2053,330,347,677,48.7%,29m
1371,3,[SK]我们每天都在努力,3902,1688,89,102,191,46.6%,33m
1371,1,[目標諾森德]TYTY,3902,737,36,7,43,83.7%,8m
1371,1,[星选组]小疯子,3902,0,0,1,1,0.0%,33m
1375,1,小斯,3900,92,3,1,4,75.0%,5m
1375,3,我好菜啊,3900,0,0,2,2,0.0%,15m
1377,1,[探索者]montaro,3899,285,7,0,7,100.0%,8m
1377,3,[GaHo]瑚太郎小鸟,3899,0,1,4,5,20.0%,4m
1377,2,stuffyuri,3899,0,0,1,1,0.0%,6m
1380,1,Apex,3897,0,0,2,2,0.0%,6m
1381,2,亚帕亚帕,3896,230,10,0,10,100.0%,16m
1381,1,[SK]陆仁,3896,72,2,7,9,22.2%,10m
1383,1,timbapimba,3895,1714,72,65,137,52.6%,8m
1383,1,llllllllllll,3895,1551,51,53,104,49.0%,8m
1383,1,[野马星际]History,3895,48,1,3,4,25.0%,6m
1386,1,Die,3894,0,0,1,1,0.0%,27m
1386,1,FallenSakura,3894,0,0,2,2,0.0%,24m
1388,1,[Tora]Cellina,3892,92,3,3,6,50.0%,10m
1388,1,[萝莉之芯]过断流霜,3892,96,2,12,14,14.3%,5m
1388,1,[QAQ]燃烧的锅盖,3892,0,1,3,4,25.0%,28m
1388,1,mumu,3892,0,0,1,1,0.0%,34m
1392,1,[狗才玩神族]MagicTom,3891,1302,32,35,67,47.8%,4m
1392,1,[中国美术学院]DreamCatcher,3891,46,2,1,3,66.7%,11m
1392,3,选择神族选择胜利,3891,30,2,2,4,50.0%,33m
1392,1,tsuki,3891,0,0,1,1,0.0%,10m
1396,1,[SFTRA3]Sphere,3890,2029,232,208,440,52.7%,10m
1396,1,[萌新萌新萌]YukikazeU,3890,510,21,6,27,77.8%,10m
1396,3,Errorist,3890,0,0,1,1,0.0%,18m
1396,1,巴姆,3890,0,0,1,1,0.0%,34m
1396,1,樱海双叶,3890,0,0,1,1,0.0%,27m
1396,1,[人族最强近战]孝和,3890,0,0,4,4,0.0%,33m
1396,1,gongfu,3890,0,0,7,7,0.0%,10m
1403,1,Tom,3889,90,3,0,3,100.0%,8m
1403,1,电脑玩家塔达林,3889,0,0,1,1,0.0%,33m
1405,1,DAMIMI,3888,888,55,42,97,56.7%,4m
1405,1,[KPG2]夏色祭,3888,607,13,10,23,56.5%,18m
1405,1,[四叶草]漫长总是不满,3888,0,1,0,1,100.0%,24m
1408,1,LycheeFM,3887,1381,62,61,123,50.4%,8m
1408,3,[神秘的力量]导哥,3887,361,29,43,72,40.3%,38m
1408,2,[不鸡RBQ]神秘奥特曼,3887,200,6,2,8,75.0%,12m
1408,1,[学习使我快乐]超新星一号,3887,0,1,0,1,100.0%,19m
1408,1,[SCAP]蚍蜉渡海,3887,0,1,0,1,100.0%,10m
1408,1,[EL骑士团]TPDSA,3887,0,1,0,1,100.0%,24m
1414,1,[A灬shOw]preDiLeCtion,3886,1779,65,68,133,48.9%,8m
1414,3,你是猪,3886,0,1,2,3,33.3%,12m
1416,1,[传说萌娘团]涩气媛萝沧海客,3885,402,10,9,19,52.6%,4m
1416,1,[半个大哥]IIIIIIIII,3885,138,3,4,7,42.9%,4m
1416,1,[SoloAs]Fck,3885,48,2,5,7,28.6%,8m
1416,1,lliuhuo,3885,46,1,1,2,50.0%,17m
1420,1,fagda,3883,188,3,1,4,75.0%,33m
1421,2,[小言]xiaoyan,3882,160,4,5,9,44.4%,35m
1421,1,[Shawk]青岛安纳,3882,48,2,0,2,100.0%,11m
1423,1,SuperSeraph,3881,588,35,15,50,70.0%,6m
1423,3,[TSOD]大头君,3881,30,3,3,6,50.0%,22m
1425,1,[KPG]Innovation,3880,275,9,6,15,60.0%,10m
1425,1,旗木,3880,290,8,8,16,50.0%,24m
1425,1,止步钻石三,3880,0,1,0,1,100.0%,4m
1425,1,[GL7]Shinami,3880,0,0,1,1,0.0%,17m
1429,1,IIIIIIIII,3879,1162,32,24,56,57.1%,34m
1430,3,死马电信,3878,0,0,2,2,0.0%,12m
1431,1,[政委]全家老小一波流,3877,1648,174,163,337,51.6%,10m
1431,1,Zerus,3877,1928,130,127,257,50.6%,8m
1433,1,[BWarmy]JOHSON,3876,2021,209,196,405,51.6%,30m
1433,1,[白羽蘇芳]JerryMou,3876,0,1,0,1,100.0%,6m
1433,1,[我们是无敌的]jmx,3876,0,0,2,2,0.0%,31m
1436,1,[Sv]版小将,3875,458,10,14,24,41.7%,30m
1436,1,llllllllllll,3875,0,1,0,1,100.0%,31m
1436,1,[辉煌华夏]MrKing,3875,0,1,0,1,100.0%,18m
1436,1,[桜公馆]高性能星际机器人,3875,102,1,3,4,25.0%,6m
1436,1,蜻蜓队长,3875,0,0,2,2,0.0%,8m
1441,1,llllllllllll,3874,972,26,26,52,50.0%,5m
1441,1,byun,3874,46,1,1,2,50.0%,4m
1443,1,[YR]天坑丶盒纸,3873,260,29,22,51,56.9%,19m
1443,1,[SteEng]酱肘子给谁吃,3873,282,9,3,12,75.0%,34m
1443,1,Dark,3873,230,5,6,11,45.5%,12m
1443,3,[白给机器]Deathtea,3873,0,1,5,6,16.7%,29m
1447,1,满堂花醉三千客,3872,393,19,7,26,73.1%,10m
1447,1,[SCAP]星际争霸嘴上过,3872,0,0,1,1,0.0%,28m
1449,1,WSK,3871,92,3,3,6,50.0%,19m
1450,1,TaeYeoN,3870,1289,69,64,133,51.9%,18m
1450,1,[逸仙谐星]skyPL,3870,144,4,8,12,33.3%,18m
1450,1,可乐要加冰,3870,0,0,3,3,0.0%,7m
1453,3,大炮,3869,1967,257,207,464,55.4%,9m
1453,1,MSAImcneila,3869,0,1,1,2,50.0%,11m
1455,1,垃圾,3867,129,5,7,12,41.7%,27m
1456,1,[SC2近卫军]咕咕喵的笨咕,3866,1915,89,84,173,51.4%,8m
1457,1,飞舞的石子,3865,552,18,15,33,54.5%,36m
1457,2,[传说萌娘团]wjh,3865,34,1,2,3,33.3%,14m
1457,1,sIEgfrIEd,3865,46,1,3,4,25.0%,11m
1460,1,初生婴儿,3863,2010,207,215,422,49.1%,30m
1460,1,[老婆一吼就退]三公子,3863,46,1,5,6,16.7%,18m
1462,3,John,3862,1701,250,239,489,51.1%,11m
1462,1,[萌神]御坂美琴,3862,1740,142,139,281,50.5%,8m
1462,1,萌粽郎,3862,1913,77,88,165,46.7%,12m
1462,1,[铁男2019]脸滚键盘,3862,92,1,3,4,25.0%,8m
1466,1,Baymax,3861,1943,160,143,303,52.8%,33m
1466,3,[大漢]DNA,3861,781,155,163,318,48.7%,28m
1466,1,化竟大神,3861,1841,149,126,275,54.2%,10m
1466,1,[Holyam]solves,3861,1610,44,55,99,44.4%,28m
1466,1,[2000年]king,3861,395,14,6,20,70.0%,5m
1466,1,[狗头狗头]shino,3861,228,6,4,10,60.0%,8m
1472,1,[KPG2]lIlIlIlIlIlI,3860,2038,483,499,982,49.2%,27m
1473,1,[YH]Brolly,3859,2008,266,269,535,49.7%,30m
1473,1,电棍,3859,0,0,1,1,0.0%,10m
1475,1,我要打游戏,3858,1406,155,155,310,50.0%,10m
1475,1,[方少云狗断手]初级水军,3858,268,7,9,16,43.8%,28m
1475,1,Kura,3858,92,2,3,5,40.0%,18m
1475,2,[爆笑科普卢]幽暗城的月亮,3858,0,1,0,1,100.0%,1h
1479,1,随便,3857,1365,126,90,216,58.3%,28m
1479,1,[乳主头子]那只狗是我的,3857,1489,61,43,104,58.7%,18m
1479,1,[TPoA]星辰,3857,667,28,11,39,71.8%,4m
1479,3,THOOH,3857,0,1,0,1,100.0%,37m
1479,1,小小婕,3857,0,1,1,2,50.0%,4m
1484,1,llllllllllll,3856,937,40,26,66,60.6%,33m
1484,1,[VSua3]万丈尘寰终独赴,3856,138,4,3,7,57.1%,8m
1486,1,[SCL]小辉,3855,756,58,39,97,59.8%,18m
1486,1,SHzSM,3855,938,21,30,51,41.2%,11m
1486,1,[意外之外]TTTTT,3855,274,7,6,13,53.8%,36m
1489,3,赵兄托你帮办点事,3854,2030,208,212,420,49.5%,32m
1490,1,BravohAcKer,3853,1957,107,113,220,48.6%,8m
1490,1,Retro,3853,186,5,5,10,50.0%,8m
1490,1,千之仙水,3853,48,1,4,5,20.0%,31m
1490,1,[Hist]采风者,3853,0,0,2,2,0.0%,6m
1494,1,[KPG2]ssn,3852,1474,62,40,102,60.8%,10m
1494,2,[TShark]酸酸甜甜就是我,3852,88,2,7,9,22.2%,27m
1494,1,[OgiNA]Fruit,3852,0,0,1,1,0.0%,10m
1497,1,小代,3850,932,39,25,64,60.9%,10m
1498,3,jacob,3849,2021,352,349,701,50.2%,9m
1498,1,亨利大叔,3849,278,10,7,17,58.8%,5m
1498,1,恶犬,3849,199,5,1,6,83.3%,4m
1498,1,Lairinis,3849,48,2,0,2,100.0%,5m
1502,1,[神族赢不了]IIIIII,3848,46,2,0,2,100.0%,5m
1503,1,[一等星]minamotoF,3847,428,18,14,32,56.2%,33m
1503,1,[miku守护]Duron,3847,414,12,6,18,66.7%,6m
1503,1,[深远Hist]MICO,3847,0,0,1,1,0.0%,24m
1503,1,铂金的神,3847,0,0,1,1,0.0%,11m
1507,1,JIMO,3846,1053,42,52,94,44.7%,11m
1507,1,llllllllllll,3846,46,1,2,3,33.3%,4m
1509,1,love,3845,270,9,5,14,64.3%,17m
1509,1,[北约]烧麦,3845,0,0,1,1,0.0%,10m
1509,1,hellokity,3845,0,0,4,4,0.0%,33m
1512,1,惜澄,3844,668,23,12,35,65.7%,6m
1512,1,[BXH]Salty,3844,138,4,5,9,44.4%,24m
1512,3,[TNL]我有一只小可爱,3844,0,0,3,3,0.0%,6m
1515,1,GZYwkqd,3843,813,39,38,77,50.6%,17m
1515,1,Sherry,3843,0,1,0,1,100.0%,24m
1515,1,[Sv]ccbb,3843,0,0,1,1,0.0%,10m
1518,2,trumpV,3842,218,5,4,9,55.6%,39m
1518,1,[SK]超高校级的泰伦,3842,88,3,2,5,60.0%,6m
1518,1,鹿目圆香,3842,90,3,4,7,42.9%,24m
1518,3,llllllllllll,3842,0,1,4,5,20.0%,7m
1518,1,[幻想绯靡]射命丸文,3842,0,0,1,1,0.0%,12m
1523,1,IIIIIIIIIII,3841,0,1,0,1,100.0%,4m
1523,1,DLDL,3841,0,0,1,1,0.0%,34m
1525,1,IIIIIIIIIIII,3840,543,34,22,56,60.7%,36m
1525,1,[WeOnE]ghy,3840,0,0,4,4,0.0%,31m
1527,1,查尔星大猛哥,3839,932,55,44,99,55.6%,5m
1527,1,CQshowtime,3839,670,15,21,36,41.7%,7m
1527,1,dkga,3839,140,4,3,7,57.1%,27m
1527,1,[第九舰队丶]Killen,3839,0,1,0,1,100.0%,10m
1527,1,跑跑拉臭臭,3839,0,1,1,2,50.0%,11m
1532,3,天天修地堡,3838,0,2,1,3,66.7%,8m
1532,1,飘扬的红裤衩,3838,46,1,2,3,33.3%,6m
1534,1,[天堂岛]Nero,3837,406,14,9,23,60.9%,4m
1534,3,[1983]斗鱼直播继良云,3837,0,0,4,4,0.0%,30m
1536,1,IIIIIIIIIIII,3836,2011,221,216,437,50.6%,19m
1536,1,[IMRTS]我真的很菜啊,3836,303,12,6,18,66.7%,36m
1536,1,[然哥强无敌]害人精,3836,134,4,2,6,66.7%,30m
1536,1,外星人酱,3836,48,2,14,16,12.5%,4m
1536,1,[幼稚园电竞班]CYY,3836,0,0,2,2,0.0%,19m
1541,1,ZYZY,3835,1341,355,369,724,49.0%,7m
1541,1,小金天梯号,3835,767,34,21,55,61.8%,10m
1541,1,[金灿灿狙击队]你尽然不知道袖哥,3835,0,1,0,1,100.0%,10m
1541,1,解灵,3835,0,1,0,1,100.0%,27m
1541,1,绝对零度,3835,0,0,1,1,0.0%,28m
1546,1,[小鸡屠宰场b]毒液,3834,396,9,10,19,47.4%,6m
1547,3,[幽灵闪现wo]金灿灿,3833,0,0,1,1,0.0%,26m
1548,1,宇文逸豆归,3832,400,18,11,29,62.1%,8m
1548,1,兔田佩克拉,3832,407,17,11,28,60.7%,34m
1548,1,[丨哔哩哔哩丨]AYCwawa,3832,90,2,4,6,33.3%,19m
1551,1,syd,3831,99,7,3,10,70.0%,10m
1551,1,[Do]GaMi,3831,180,4,4,8,50.0%,34m
1551,1,[PTB]Alka,3831,154,3,2,5,60.0%,11m
1551,1,兔子不高兴,3831,0,0,1,1,0.0%,10m
1551,3,[不要叫我毒爆]艾尔毒爆,3831,0,0,1,1,0.0%,28m
1556,2,抱紧林雨,3830,2186,675,705,1380,48.9%,8m
1557,1,可惜你不够溜,3829,685,61,63,124,49.2%,7m
1557,1,狙击司令二号,3829,232,5,13,18,27.8%,33m
1559,1,幸运魔法兔,3828,1743,51,50,101,50.5%,7m
1559,1,SHNXWSZ,3828,341,12,9,21,57.1%,33m
1561,1,[FORI2]VanHaser,3827,78,2,8,10,20.0%,17m
1561,1,[雏巢]zzzzzp,3827,0,1,0,1,100.0%,4m
1561,1,[SCAP]轰天雷战士,3827,0,0,4,4,0.0%,33m
1564,1,[四叶草]加冰流,3826,1803,415,398,813,51.0%,6m
1564,1,[Anticw]脚踏飞剑来看你,3826,270,6,7,13,46.2%,18m
1564,1,[肉鸡的饲养]UNccccc,3826,92,3,2,5,60.0%,36m
1564,1,[KPG]Misslavendar,3826,0,1,2,3,33.3%,24m
1568,3,[NHSD]PREFECT,3825,60,6,2,8,75.0%,9m
1568,1,[情谊至上]扒拉猛干,3825,129,4,0,4,100.0%,24m
1568,1,本名龙在天,3825,180,4,8,12,33.3%,33m
1571,3,虎牙搜索蔡小新吖,3824,297,13,2,15,86.7%,29m
1571,1,[博云星际学院]beibi,3824,0,0,1,1,0.0%,33m
1571,1,[GHet]灬冬月丶,3824,0,0,1,1,0.0%,18m
1574,1,RESPECTtime,3823,284,9,8,17,52.9%,19m
1574,2,龙神战皇,3823,0,1,0,1,100.0%,24m
1574,1,[FPT]白银萌新,3823,0,1,1,2,50.0%,5m
1577,1,[Encore]欢歌,3822,1537,343,336,679,50.5%,6m
1577,1,llllllllllll,3822,1405,68,63,131,51.9%,36m
1577,1,[Etern谐]showtime,3822,605,23,13,36,63.9%,18m
1577,3,[SKT1]soO,3822,281,13,2,15,86.7%,17m
1577,1,[Kiloli]霸双无绝,3822,524,13,12,25,52.0%,7m
1577,1,IIIIIIIIIIII,3822,383,10,13,23,43.5%,19m
1583,1,bobby,3821,1717,235,235,470,50.0%,10m
1583,1,herbalistbw,3821,94,3,6,9,33.3%,8m
1583,2,[Epochs]流月蔻鸳,3821,35,1,2,3,33.3%,9m
1586,1,赤樱,3820,48,1,2,3,33.3%,27m
1587,3,[威严满满DZ]蕾米莉亚,3819,516,28,24,52,53.8%,17m
1587,1,[Beastp]neachal,3819,572,26,20,46,56.5%,18m
1587,3,IIIIIII,3819,168,8,1,9,88.9%,15m
1590,3,IIIIIIIIIIII,3818,1770,407,417,824,49.4%,10m
1590,1,[甜甜圈]牵绊,3818,1766,62,68,130,47.7%,18m
1590,3,[XellOs]支持天降之物,3818,257,12,3,15,80.0%,18m
1593,1,[SCJWJ3]Stormrage,3817,457,18,14,32,56.2%,36m
1593,1,一只鸡,3817,324,9,7,16,56.2%,18m
1593,1,RoyMustang,3817,0,0,1,1,0.0%,10m
1593,1,[YA]啦啦啦啦啦啦啦,3817,0,0,1,1,0.0%,4m
1597,3,Rabby,3816,30,3,3,6,50.0%,21m
1597,1,[12306]ourpairs,3816,0,0,1,1,0.0%,17m
1597,1,上神,3816,0,0,1,1,0.0%,28m
1597,3,[TNLet]Isaac,3816,0,0,5,5,0.0%,16m
1601,1,FeAtHers,3815,0,1,0,1,100.0%,10m
1601,1,[FPT]嗜血战神,3815,0,0,4,4,0.0%,27m
1603,1,IIIIIIIII,3814,1579,45,46,91,49.5%,8m
1603,1,[丨SLT丨]FpxBest,3814,182,5,5,10,50.0%,11m
1603,1,四乃森苍紫,3814,155,4,2,6,66.7%,7m
1606,1,[海螺先生]iDamon,3813,1521,112,111,223,50.2%,31m
1606,1,[人族最强近战]mainmas,3813,884,66,69,135,48.9%,30m
1608,1,[大哥队]安工大,3812,942,48,15,63,76.2%,36m
1608,1,[AHO骑士团]艾酱,3812,518,14,21,35,40.0%,10m
1610,1,[哭本]吊丝化的亮亮,3811,230,5,8,13,38.5%,8m
1611,2,上巴伐利亚,3810,70,2,3,5,40.0%,18m
1611,2,[半个菜鸟]孔明吃荔枝丶,3810,0,0,1,1,0.0%,12m
1611,1,堡本,3810,0,0,2,2,0.0%,27m
1614,1,你不要探路好不好,3809,48,2,2,4,50.0%,11m
1614,1,虫乳不惊,3809,0,1,1,2,50.0%,8m
1614,2,scpAKBMAYUYU,3809,0,0,1,1,0.0%,12m
1617,1,xxxx,3808,0,1,2,3,33.3%,33m
1617,2,[银闪的风姬]Alanach,3808,0,0,1,1,0.0%,11m
1619,2,楚云飞,3807,485,24,10,34,70.6%,36m
1619,2,[衣钵之卫]sadd,3807,417,18,7,25,72.0%,16m
1621,1,不到三千五不改名,3806,1144,91,55,146,62.3%,10m
1621,1,[铜锣湾话事人]大飞,3806,1420,37,42,79,46.8%,27m
1621,2,[ImFive]我是废物,3806,404,19,7,26,73.1%,39m
1621,2,愚夫,3806,0,1,0,1,100.0%,33m
1621,2,[汉堡FANS]战争结束了指挥官,3806,0,1,0,1,100.0%,19m
1621,2,[D3D]你是恶魔吗,3806,38,1,1,2,50.0%,6m
1627,1,ladaman,3805,1540,64,61,125,51.2%,27m
1627,3,[埃蒙打的好呀]逆菊,3805,0,5,0,5,100.0%,15m
1627,3,[情谊至上]次元大介,3805,0,1,0,1,100.0%,7m
1627,2,SROW,3805,0,0,1,1,0.0%,5m
1631,2,猪小明,3803,0,0,1,1,0.0%,35m
1632,1,IIIIIIIIIIII,3802,1849,69,63,132,52.3%,18m
1632,1,[兔兔之家]超级蓝兔兔,3802,619,23,17,40,57.5%,11m
1634,2,CaptainBiken,3801,494,20,5,25,80.0%,24m
1634,1,SecondsoO,3801,94,2,6,8,25.0%,10m
1634,2,[NTUSL]zhou,3801,0,1,0,1,100.0%,5m
1634,3,双败女人孙一峰,3801,0,1,3,4,25.0%,33m
1634,1,nanjolno,3801,0,0,2,2,0.0%,11m
1639,1,llllllllllll,3800,1951,1632,1625,3257,50.1%,33m
1639,1,[指尖奶茶]蕾米莉亚,3800,700,31,49,80,38.8%,27m
1639,2,TJH,3800,728,27,25,52,51.9%,16m
1639,1,机械化死个吗,3800,281,7,6,13,53.8%,33m
1643,1,kingofnerds,3799,1872,276,256,532,51.9%,24m
1643,1,devildemon,3799,838,42,27,69,60.9%,33m
1643,2,DarkPanda,3799,0,1,0,1,100.0%,34m
1646,2,无声抗,3798,598,24,23,47,51.1%,29m
1646,2,[KFC]ShowTime,3798,0,0,1,1,0.0%,14m
1646,2,嘿丶马小跳,3798,0,0,1,1,0.0%,19m
1649,2,飞龙者,3797,246,18,3,21,85.7%,36m
1649,1,买办大叔叔,3797,46,2,2,4,50.0%,10m
1649,1,白夜,3797,111,2,4,6,33.3%,36m
1649,2,mumu,3797,0,0,1,1,0.0%,39m
1653,1,末日咒夜,3796,0,1,7,8,12.5%,34m
1654,1,[在这停顿]IROI,3795,1944,229,205,434,52.8%,33m
1654,2,eli,3795,0,1,0,1,100.0%,23m
1654,3,[我是徐佳莹]杭州孙一峰,3795,0,0,1,1,0.0%,18m
1657,1,ScRaTcHP,3794,1381,150,151,301,49.8%,19m
1658,2,[ZTSCAP]艾可儿,3793,0,1,0,1,100.0%,26m
1658,3,Him,3793,0,0,2,2,0.0%,30m
1660,3,[SCJWJ3]IIIIIIIIIIII,3792,1820,117,136,253,46.2%,17m
1660,1,[Do]帝王,3792,1017,52,53,105,49.5%,12m
1660,1,小郑姑娘,3792,506,13,16,29,44.8%,33m
1660,2,[BGD]里见莲太郎,3792,220,7,6,13,53.8%,7m
1660,2,koao,3792,0,0,1,1,0.0%,11m
1665,2,阳光小李,3791,593,31,18,49,63.3%,35m
1666,2,鹿杖客,3790,34,2,0,2,100.0%,35m
1667,1,Heirito,3788,709,16,19,35,45.7%,6m
1667,2,[titit]香烟火柴盒啊,3788,218,8,2,10,80.0%,6m
1667,2,阿米娜,3788,102,3,2,5,60.0%,16m
1667,2,闪灵一击,3788,0,0,2,2,0.0%,39m
1671,3,Fritzamoy,3787,236,12,2,14,85.7%,7m
1671,3,滄海客,3787,0,1,0,1,100.0%,21m
1671,2,梦之国度,3787,0,0,1,1,0.0%,38m
1674,2,[Beasty]lingyu,3786,110,4,3,7,57.1%,35m
1674,2,条码仁,3786,0,0,1,1,0.0%,35m
1676,2,[SK]balabala,3785,1687,131,128,259,50.6%,39m
1676,2,[Mayuki]JuNgLe,3785,0,0,2,2,0.0%,19m
1678,1,DietmarP,3784,182,4,12,16,25.0%,12m
1678,2,[我们超可爱鸭]一只大北,3784,0,1,0,1,100.0%,39m
1678,2,[SCL]Wilhelmina,3784,0,0,1,1,0.0%,29m
1681,2,[80s丶]我深爱着的卢旖玥,3783,490,30,12,42,71.4%,34m
1681,1,[懒癌疗养协会]武勛戰艦榛名號,3783,238,7,8,15,46.7%,4m
1681,2,YZY,3783,0,0,1,1,0.0%,19m
1684,1,[SK]HavoC,3782,1185,170,146,316,53.8%,18m
1684,2,[TPoR]Shady,3782,0,1,0,1,100.0%,24m
1686,1,xuefeihu,3781,1851,141,133,274,51.5%,24m
1686,1,[您好]白球带冲锋,3781,1242,120,105,225,53.3%,11m
1686,1,风寂影灭,3781,343,12,6,18,66.7%,30m
1686,2,[ZTSCAP]llllllllllll,3781,36,1,1,2,50.0%,11m
1690,1,拳王破阵曲,3780,788,24,23,47,51.1%,10m
1690,1,Today,3780,134,3,10,13,23.1%,17m
1692,1,IIIIIIIIII,3779,1836,459,450,909,50.5%,18m
1692,1,[北师大二附中]Annihilation,3779,1940,70,85,155,45.2%,12m
1694,2,IIIIIIIIIIII,3778,60,6,1,7,85.7%,39m
1694,2,上杉绘梨衣,3778,0,0,2,2,0.0%,22m
1696,1,afawefeaw,3777,575,16,15,31,51.6%,33m
1696,1,[loveMM]人仙,3777,92,6,4,10,60.0%,4m
1696,2,褪色往昔,3777,0,0,1,1,0.0%,7m
1699,1,lllllllll,3776,1865,531,542,1073,49.5%,10m
1699,2,[Fear]Poison,3776,372,12,10,22,54.5%,22m
1699,2,[六芒星]黑曼巴,3776,0,0,1,1,0.0%,12m
1702,1,[Toss]神族就输不了,3775,1722,89,91,180,49.4%,34m
1702,2,llllllllllll,3775,72,2,3,5,40.0%,16m
1704,2,[Mikon]FrankinZerg,3774,534,25,20,45,55.6%,11m
1704,2,Cmswindzerg,3774,0,1,0,1,100.0%,2m
1704,1,[萝莉控丶]MUZI,3774,46,1,7,8,12.5%,33m
1707,1,[YM]Henrietta,3773,1920,93,98,191,48.7%,7m
1707,3,tya,3773,168,9,1,10,90.0%,35m
1707,1,浊酒一杯温如言,3773,165,5,3,8,62.5%,33m
1707,2,[时间]夏天好和煦,3773,0,0,1,1,0.0%,16m
1707,1,doubleL,3773,0,0,3,3,0.0%,3m
1712,1,SCVonBulaga,3772,512,30,15,45,66.7%,7m
1712,1,[禽禽禽]邪灬火,3772,1096,29,35,64,45.3%,31m
1712,2,老肥,3772,165,7,0,7,100.0%,19m
1712,2,[打一辈子星际]社会你金哥,3772,0,0,1,1,0.0%,33m
1712,2,[無輪幻想]汐风秋桐,3772,0,0,1,1,0.0%,33m
1717,1,[KPG2]蛮力之枭,3771,1983,355,360,715,49.7%,7m
1717,3,IIIIIIIIIIII,3771,169,4,2,6,66.7%,30m
1719,1,[NS]孤身一人进女厕,3770,226,5,14,19,26.3%,8m
1720,1,[幽栏小筑]WAW,3769,154,4,5,9,44.4%,4m
1720,1,IIIIIIIIIIII,3769,92,3,8,11,27.3%,33m
1720,2,高效液相,3769,116,2,3,5,40.0%,29m
1720,3,樱岛麻衣,3769,0,0,1,1,0.0%,19m
1720,2,毁灭冰封,3769,0,0,3,3,0.0%,28m
1725,2,llllllllllll,3768,281,9,9,18,50.0%,28m
1725,2,[我太帅666]小金子,3768,0,0,1,1,0.0%,9m
1727,2,[北京城管]一只翻滚的爆爆虫,3767,114,2,2,4,50.0%,33m
1727,2,[拯救凯瑞甘]冰本,3767,0,1,0,1,100.0%,32m
1729,3,全是内战,3766,176,17,34,51,33.3%,18m
1729,1,[又鸟]鸡本,3766,136,3,6,9,33.3%,8m
1729,1,[浪啊浪]韩少校,3766,68,2,8,10,20.0%,31m
1729,2,killer,3766,0,1,0,1,100.0%,35m
1733,2,IIIIIIIIIIII,3765,32,2,0,2,100.0%,21m
1733,2,[紫gbawe]alex,3765,64,2,2,4,50.0%,29m
1735,1,IIIIIIIII,3764,1930,241,241,482,50.0%,7m
1735,1,IIIIIIIIIIII,3764,1804,229,224,453,50.6%,5m
1735,1,大脚游戏论坛,3764,943,29,37,66,43.9%,13m
1735,1,[二仙桥]成华大道,3764,756,20,37,57,35.1%,17m
1739,3,[DB]长呢是有点丑呢,3763,146,8,1,9,88.9%,17m
1739,2,[樱花殿]天堂中的天堂,3763,104,4,4,8,50.0%,33m
1741,2,[一起多人运动]HuangQ,3762,976,49,41,90,54.4%,11m
1741,2,[刺蛇单推协会]king,3762,214,7,3,10,70.0%,13m
1741,1,[CA神教]Gungnir,3762,0,0,6,6,0.0%,5m
1744,1,嘎嘣脆鸡肉味儿,3761,1940,247,253,500,49.4%,13m
1744,2,[阿萨去]Rock,3761,36,2,1,3,66.7%,3m
1744,2,[Killyo]陈阳,3761,0,1,0,1,100.0%,20m
1747,1,iconfour,3760,1120,37,40,77,48.1%,33m
1748,1,[Shawk]打不过就是不够多,3759,1827,110,104,214,51.4%,33m
1748,1,nutshell,3759,1261,45,64,109,41.3%,5m
1748,3,[四叶草]俯首甘为孺子牛,3759,220,11,3,14,78.6%,12m
1751,2,[迷宫丨极限组]sbboy,3758,681,31,1,32,96.9%,33m
1751,2,[第八舰队丶]奥万大,3758,276,10,4,14,71.4%,16m
1751,2,[双手离开键盘]xingchen,3758,0,0,1,1,0.0%,24m
1754,2,我儿尚柠檬,3757,643,32,14,46,69.6%,5m
1754,1,davis,3757,605,22,24,46,47.8%,10m
1754,2,[gee客]逆鳞小狮,3757,276,9,7,16,56.2%,1m
1754,1,[一波]小鸡的勇敢,3757,120,3,5,8,37.5%,7m
1754,2,三千奈何流,3757,0,0,3,3,0.0%,24m
1759,1,IIIIIIIIIIII,3756,1935,346,348,694,49.9%,30m
1759,1,[半个菜鸟]星星爱杰,3756,1895,86,85,171,50.3%,18m
1759,2,你的兵没我多,3756,392,34,22,56,60.7%,16m
1759,1,lwl,3756,630,17,21,38,44.7%,34m
1759,2,[糯米丸子]橘子与晚安,3756,0,0,1,1,0.0%,21m
1764,3,TRON,3755,285,11,4,15,73.3%,10m
1764,2,[我即是菜狗]luckydestroy,3755,166,5,6,11,45.5%,24m
1764,3,Kiki,3755,97,2,0,2,100.0%,15m
1764,2,[凛风]雏咲深羽,3755,70,2,4,6,33.3%,7m
1764,2,[江璃的乱炖锅]yourenA,3755,0,1,0,1,100.0%,33m
1764,2,skforever,3755,0,0,1,1,0.0%,11m
1770,1,IIIIIIII,3754,1280,66,65,131,50.4%,19m
1770,1,[IMRTS2]键盘冒毒奶,3754,882,29,25,54,53.7%,10m
1770,2,[刺蛇互助天团]西北望射天狼,3754,0,0,1,1,0.0%,1m
1773,2,林北吼力戏,3753,244,13,2,15,86.7%,32m
1773,1,[锉刀酱真可爱]紫罗兰,3753,404,11,12,23,47.8%,18m
1775,1,arthas,3752,1908,508,507,1015,50.0%,34m
1775,1,IIIIIIIIIIII,3752,953,384,382,766,50.1%,33m
1775,2,菜的抠脚的电脑,3752,823,33,17,50,66.0%,24m
1775,2,llllllllllll,3752,382,14,12,26,53.8%,31m
1779,1,rtyr,3751,1915,125,116,241,51.9%,34m
1779,1,[SK]DirtyProtoss,3751,1330,45,51,96,46.9%,8m
1779,1,[死亡收割]收割队长归来,3751,372,12,13,25,48.0%,8m
1779,2,[withme]立大功,3751,253,8,5,13,61.5%,5m
1779,2,我小弟叫彭狄,3751,32,1,1,2,50.0%,7m
1779,1,[半个大哥]工具人,3751,44,1,5,6,16.7%,11m
1779,2,Minteeeeeeee,3751,0,0,1,1,0.0%,13m
1786,2,[東方心念語]快速度,3750,106,4,4,8,50.0%,18m
1786,1,烟头,3750,128,4,7,11,36.4%,4m
1786,2,[战旗第十分队]小胖,3750,32,2,1,3,66.7%,19m
1786,2,[传说萌娘团]星际争霸灬灵,3750,0,1,1,2,50.0%,5m
1786,2,Dave,3750,0,0,1,1,0.0%,39m
1791,2,[Do]谐星胜利者冰红茶,3749,402,18,9,27,66.7%,5m
1791,3,[FPT]BrisTorch,3749,0,3,2,5,60.0%,22m
1791,2,[秋毫第七分队]臣卜木曹,3749,34,2,0,2,100.0%,34m
1791,2,伤痛灬,3749,0,1,3,4,25.0%,23m
1791,2,[你已经死啦]熊猫丶,3749,0,0,1,1,0.0%,32m
1796,1,shirosakiren,3747,509,16,13,29,55.2%,8m
1797,2,[Ours]IIIIIIIIIIII,3746,216,8,6,14,57.1%,13m
1797,2,[燕大SC]llllllllll,3746,130,4,4,8,50.0%,39m
1799,2,[天朝]乱世王者,3745,1654,92,72,164,56.1%,13m
1799,2,[i5]Ticoiiii,3745,102,3,4,7,42.9%,20m
1801,1,[ZJU]Archer,3744,1311,93,95,188,49.5%,11m
1801,2,[野马星际]biaji,3744,0,1,1,2,50.0%,24m
1803,1,GDUTer,3743,1357,170,179,349,48.7%,8m
1803,3,[幺幺]Lucky,3743,30,2,1,3,66.7%,14m
1803,2,OOOOOOOOOOOO,3743,88,2,12,14,14.3%,11m
1803,3,NiceBody,3743,0,1,0,1,100.0%,9m
1807,3,Waaaaagh,3742,322,39,64,103,37.9%,10m
1807,2,[SCJWJ3]仗剑走天涯,3742,466,22,56,78,28.2%,7m
1807,1,DHardwell,3742,762,20,24,44,45.5%,25m
1807,2,[魔法少女小屋]SnowTown,3742,180,7,3,10,70.0%,19m
1807,2,[洛天依我老婆]人生凄惨,3742,0,0,1,1,0.0%,16m
1812,2,琦迹,3741,1292,65,58,123,52.8%,12m
1812,1,[DMRc]happygame,3741,751,31,25,56,55.4%,7m
1812,2,人族就赢不了,3741,144,4,7,11,36.4%,29m
1812,3,[RyH]猫猫,3741,0,0,1,1,0.0%,5m
1812,2,[大阪大学]lekbuss,3741,0,0,1,1,0.0%,23m
1817,2,仅余舟一芥,3740,427,65,52,117,55.6%,11m
1817,2,[常州大学]Mazino,3740,262,10,9,19,52.6%,33m
1817,3,[耀光]艾奇零零黑,3740,144,4,0,4,100.0%,16m
1817,2,[人殱失格]Sarkis,3740,0,1,0,1,100.0%,23m
1817,2,[GTV]我就活该被辜负嘛,3740,0,0,1,1,0.0%,14m
1822,2,无奈无语无辜,3739,558,51,37,88,58.0%,19m
1822,2,[文韬武略]SuperLuck,3739,104,3,1,4,75.0%,20m
1822,2,[KPG]落叶伤悲,3739,34,2,1,3,66.7%,29m
1822,2,[北邮猎猪人]ColdBird,3739,72,2,3,5,40.0%,3m
1826,2,[核电站怎么输]陰天樂,3738,346,11,10,21,52.4%,16m
1826,2,[肉鸡的饲养]曼珠沙华,3738,30,1,1,2,50.0%,23m
1828,2,[t就imba]llllllllllll,3737,0,1,0,1,100.0%,22m
1828,2,Saiki,3737,0,1,0,1,100.0%,31m
1828,2,衡阳市八中二六九,3737,0,0,1,1,0.0%,3m
1831,1,[SK]RERzeng,3736,1841,58,75,133,43.6%,11m
1831,2,[同化失败了]晴新短夏,3736,32,2,1,3,66.7%,5m
1831,2,死亡绕狗,3736,0,1,0,1,100.0%,5m
1831,1,[初雪的樱花]小坂井绫,3736,46,1,10,11,9.1%,33m
1835,1,月苍茫,3735,1297,48,48,96,50.0%,8m
1835,3,小坦克,3735,30,2,0,2,100.0%,19m
1835,2,[一叶之秋]Makira,3735,0,0,1,1,0.0%,16m
1838,2,[青铜树]狂奔的蜗牛,3734,508,17,20,37,45.9%,18m
1838,1,[i5]Maru,3734,534,13,15,28,46.4%,7m
1840,1,MiKe,3733,1901,238,247,485,49.1%,17m
1840,1,风停息的瞬间,3733,740,96,90,186,51.6%,5m
1840,1,周大胆,3733,1068,42,40,82,51.2%,4m
1840,1,llllllllllll,3733,508,13,23,36,36.1%,7m
1840,1,[开军舰]静刃,3733,314,7,16,23,30.4%,4m
1840,1,[TS嘉年华]MADEOFSHEEP,3733,180,4,10,14,28.6%,8m
1840,2,[新手打专家]sellitatfree,3733,0,1,0,1,100.0%,5m
1847,2,小涛歌,3732,1634,267,267,534,50.0%,32m
1847,2,[盲人康复院]欲沐东湖的父亲,3732,1667,179,160,339,52.8%,28m
1847,2,zzyy,3732,674,26,21,47,55.3%,6m
1847,2,GiannaJun,3732,98,3,3,6,50.0%,14m
1847,2,仙子,3732,30,1,2,3,33.3%,19m
1847,2,[Holyfe]codmy,3732,0,0,2,2,0.0%,16m
1853,2,紫罗兰,3731,1234,47,45,92,51.1%,28m
1853,1,[CUSTE]女王榨汁机,3731,222,5,13,18,27.8%,25m
1855,1,[青铜树]Vassago,3730,1925,363,357,720,50.4%,4m
1855,2,[大姐酒家]莽夫虫族,3730,422,15,12,27,55.6%,12m
1855,2,[NBU]女王大人,3730,36,1,4,5,20.0%,12m
1855,2,[ANNEX]哼哼哼,3730,0,0,1,1,0.0%,24m
1855,2,Pgoneyoyoyo,3730,0,0,1,1,0.0%,23m
1860,3,[他是个老人]IIIIIIIIIIII,3729,1910,485,490,975,49.7%,39m
1860,2,[SCUT]marvelous,3729,0,0,2,2,0.0%,19m
1862,1,[star星]城市化的缔造者,3728,898,23,30,53,43.4%,25m
1862,1,Mutalisk,3728,360,9,10,19,47.4%,11m
1862,2,[KSARrk]ImbaBoshu,3728,0,0,1,1,0.0%,16m
1865,1,北风劫,3727,1901,444,439,883,50.3%,4m
1865,1,[不可解]花谱,3727,1900,153,167,320,47.8%,17m
1865,2,[olg]武林虾米,3727,556,21,16,37,56.8%,22m
1865,1,情多误美人,3727,363,14,19,33,42.4%,28m
1869,2,超能之鱼人,3726,1657,89,68,157,56.7%,6m
1869,2,xingqidian,3726,925,59,55,114,51.8%,29m
1869,1,天地返,3726,1125,30,35,65,46.2%,7m
1869,2,MagicZerg,3726,102,5,2,7,71.4%,3m
1869,2,我长得帅我怕谁,3726,32,2,2,4,50.0%,16m
1869,2,Kalafina,3726,0,1,0,1,100.0%,14m
1875,1,昨夜,3725,549,27,19,46,58.7%,8m
1875,1,金三胖,3725,247,5,9,14,35.7%,8m
1875,3,吃饭有点累,3725,97,2,4,6,33.3%,32m
1875,2,[Aleria]月夜,3725,0,1,0,1,100.0%,3m
1875,2,[GoONE]季行丶心名,3725,34,1,4,5,20.0%,33m
1880,1,IIIIIIIIIIII,3724,684,105,108,213,49.3%,18m
1880,2,IIIIIIIIIII,3724,1106,56,48,104,53.8%,17m
1880,3,[Legacy]PerraN,3724,0,1,3,4,25.0%,15m
1880,2,[目標諾森德]YAXeair,3724,0,1,4,5,20.0%,20m
1884,2,EVE,3723,408,13,14,27,48.1%,35m
1885,1,丶丶丶,3722,1654,49,60,109,45.0%,13m
1885,3,tina,3722,170,4,3,7,57.1%,34m
1885,2,scfreu,3722,64,3,1,4,75.0%,1m
1885,2,[TToM]越来越没意思,3722,34,2,2,4,50.0%,29m
1885,2,[永夜樂想]超级嗨客,3722,0,1,1,2,50.0%,16m
1890,1,阳光中年人,3721,1403,136,139,275,49.5%,7m
1890,1,[学姐是我的]樱岛麻衣,3721,1223,105,101,206,51.0%,11m
1890,1,[暴雪我是你爹]白痴,3721,275,7,18,25,28.0%,34m
1893,2,一生之敌,3720,1269,137,105,242,56.6%,23m
1893,2,[我们都是萌新]心如薄荷天生凉,3720,972,38,30,68,55.9%,20m
1893,1,AMooMi,3720,626,30,33,63,47.6%,25m
1893,1,南燕,3720,864,23,31,54,42.6%,28m
1893,2,[粪坑怎么输]lIIllIllIIIl,3720,158,6,3,9,66.7%,20m
1898,1,小可爱,3719,1907,163,143,306,53.3%,29m
1898,2,[子旭FANS]Gradually,3719,248,8,8,16,50.0%,17m
1898,3,[DMRz]空城旧忆故人离,3719,97,4,2,6,66.7%,33m
1898,2,[绝望星灵]Deralygohst,3719,106,3,8,11,27.3%,35m
1902,2,有闪电就输不了,3718,1090,89,60,149,59.7%,3m
1902,2,[神奇的联萌]IIIIIIIIIIII,3718,723,41,6,47,87.2%,16m
1902,2,爹爹,3718,396,15,11,26,57.7%,35m
1902,2,zergling,3718,264,9,5,14,64.3%,34m
1902,2,刺儿,3718,0,0,1,1,0.0%,11m
1902,2,快仙刀,3718,0,0,2,2,0.0%,18m
1908,1,[北京大学鸡协]llllllllllll,3717,1901,57,62,119,47.9%,8m
1908,2,Walkman,3717,470,15,19,34,44.1%,19m
1908,2,还有谁,3717,204,7,7,14,50.0%,13m
1908,3,Goat,3717,97,6,0,6,100.0%,18m
1908,2,IIIIIIIIIIII,3717,0,1,0,1,100.0%,17m
1913,2,KingOfNoob,3716,1562,245,229,474,51.7%,14m
1913,1,[GAC]BadApple,3716,468,11,21,32,34.4%,33m
1913,3,[旭东黄]phage,3716,0,1,0,1,100.0%,2m
1913,2,[Solo]LosTATlantis,3716,0,0,1,1,0.0%,5m
1917,2,[丨SLT丨]秋月爱莉,3715,170,5,1,6,83.3%,33m
1917,3,最美不过夕阳红,3715,0,1,0,1,100.0%,14m
1917,2,非阿贝尔规范场,3715,32,1,4,5,20.0%,21m
1920,1,我准备好了,3714,1874,366,353,719,50.9%,7m
1920,1,[oshima]马尔都克,3714,1784,259,239,498,52.0%,11m
1920,2,Prowl,3714,0,0,1,1,0.0%,29m
1920,2,[不主动不拒绝]跟你就是走流程,3714,0,0,1,1,0.0%,6m
1920,3,Namur,3714,0,0,3,3,0.0%,4m
1925,1,香豆腐,3713,1883,124,136,260,47.7%,7m
1925,1,wangfan,3713,1079,79,87,166,47.6%,30m
1925,1,海军大将藤虎一笑,3713,612,32,33,65,49.2%,18m
1925,2,大宗保,3713,186,6,8,14,42.9%,16m
1925,2,llllllllllll,3713,0,1,1,2,50.0%,13m
1930,1,淋浴的小石头,3712,1845,178,177,355,50.1%,11m
1930,2,llllllllllll,3712,1198,90,78,168,53.6%,9m
1930,1,[Period]Tarzan,3712,834,33,27,60,55.0%,4m
1930,2,Scandal,3712,373,31,15,46,67.4%,28m
1930,2,[炸天帮丶]炸天帮丶赵曰天,3712,0,1,0,1,100.0%,16m
1930,2,[Sun下的我]青铜谐星,3712,0,0,1,1,0.0%,29m
1936,1,春天的蟲,3711,799,139,114,253,54.9%,8m
1936,2,Heart,3711,0,0,1,1,0.0%,11m
1938,1,通商寛农,3710,1029,254,260,514,49.4%,28m
1938,2,KakA,3710,1404,53,49,102,52.0%,35m
1938,3,[PoWs]水星人开拖拉机,3710,212,11,3,14,78.6%,22m
1938,3,年轻人好自为之,3710,144,7,2,9,77.8%,33m
1938,2,[CPT]黑夜的光,3710,94,4,2,6,66.7%,29m
1938,2,[百鬼夜行丶]魑魅魍魉,3710,0,0,1,1,0.0%,11m
1944,2,一生之敌丶,3709,1204,92,64,156,59.0%,12m
1944,2,neeb,3709,198,8,11,19,42.1%,34m
1944,1,Christino,3709,308,8,13,21,38.1%,29m
1944,3,金华孙一峰,3709,30,1,2,3,33.3%,30m
1948,2,FGX,3708,70,2,8,10,20.0%,18m
1949,3,PAZZO,3707,173,5,2,7,71.4%,15m
1949,2,[BJTU]FTDfangge,3707,154,5,3,8,62.5%,13m
1949,2,[PITB]红红火火恍恍惚惚,3707,100,3,4,7,42.9%,23m
1949,2,[Quar]ulio,3707,0,0,1,1,0.0%,23m
1953,1,wtf,3706,1811,72,72,144,50.0%,7m
1953,2,下雨天散步,3706,315,43,38,81,53.1%,24m
1953,2,[ZTSCAP]FallenAsh,3706,294,11,7,18,61.1%,12m
1953,3,[锤爆你的头]Slime,3706,244,9,5,14,64.3%,35m
1953,2,小菜鸟,3706,156,5,6,11,45.5%,5m
1953,2,[TNL]一个好人,3706,92,4,3,7,57.1%,3m
1953,2,[不败的魔术师]奇迹的杨,3706,0,0,2,2,0.0%,17m
1960,1,大壯,3705,782,56,59,115,48.7%,5m
1960,3,llllllllllll,3705,165,9,1,10,90.0%,18m
1960,2,GUANR,3705,200,8,3,11,72.7%,1m
1960,2,GeminiQ,3705,0,0,1,1,0.0%,14m
1960,2,[Vgirls]云浅雪,3705,0,0,1,1,0.0%,22m
1960,2,[YR]Solresol,3705,0,0,1,1,0.0%,33m
1966,1,[嗜血BaSa]雨人,3703,536,13,17,30,43.3%,29m
1966,3,[艾尔之名]吊丝化的土肥圆,3703,0,1,0,1,100.0%,26m
1966,2,[练出来了协会]陨落之星,3703,34,1,1,2,50.0%,28m
1969,1,黄金脆皮鸡,3702,1904,178,180,358,49.7%,8m
1969,2,Bisu,3702,247,38,36,74,51.4%,11m
1969,2,YuQian,3702,374,20,19,39,51.3%,16m
1969,1,[我队伍很强大]一只呆呆的泽兽,3702,317,12,15,27,44.4%,13m
1969,3,[Rhusky]root,3702,0,0,2,2,0.0%,4m
1974,1,IIIIIIIIII,3701,1354,441,429,870,50.7%,33m
1974,1,[凯哥集团]金中山已几,3701,1889,165,164,329,50.2%,7m
1974,2,[萌萌哒双马尾]水菓芒,3701,1065,105,97,202,52.0%,18m
1974,2,[钉宫病]NefertariL,3701,0,1,1,2,50.0%,32m
1974,2,Mryesyu,3701,32,1,3,4,25.0%,19m
1974,2,[加特林的问候]RainNight,3701,0,0,1,1,0.0%,34m
1974,3,逼良为娼,3701,0,0,8,8,0.0%,4m
1981,2,llllllllllll,3700,1576,399,361,760,52.5%,24m
1981,2,herNPC,3700,1600,201,173,374,53.7%,12m
1981,1,lichadebo,3700,873,59,55,114,51.8%,28m
1981,1,[九虚空神教]末代王粉,3700,1121,42,31,73,57.5%,7m
1981,2,[智乃超可爱w]圆桌的鬼神,3700,0,1,0,1,100.0%,17m
1981,2,潘哲超,3700,0,0,1,1,0.0%,11m
1981,2,我即是虫群,3700,0,0,1,1,0.0%,23m
1988,2,ljx,3699,1664,330,306,636,51.9%,21m
1988,2,slucifer,3699,34,2,0,2,100.0%,11m
1988,2,[萌新抱团协会]汉尼拔,3699,0,1,1,2,50.0%,3m
1988,2,二麻子哥哥,3699,0,0,3,3,0.0%,12m
1992,3,直翅目跳虫,3698,1797,128,128,256,50.0%,29m
1992,1,[Beasty]Erynnyes,3698,1177,71,86,157,45.2%,11m
1992,2,[泰古]taenggu,3698,1421,68,56,124,54.8%,24m
1992,1,[夏空的英仙座]遠野恋,3698,646,28,22,50,56.0%,7m
1992,2,[80s丶]等你等得蛋疼,3698,134,5,6,11,45.5%,6m
1992,2,假美食博主,3698,154,5,6,11,45.5%,35m
1992,2,亚麻色头发的爷们,3698,0,0,1,1,0.0%,5m
1992,2,[ESP三队]Voldemort,3698,0,0,1,1,0.0%,32m
2000,2,[SoloAs]yyf,3697,1357,55,47,102,53.9%,17m
2000,2,[单推五河宗]NanaKoori,3697,401,22,27,49,44.9%,32m
2000,3,RKO,3697,278,10,2,12,83.3%,4m
2000,2,在你家起地堡,3697,30,2,1,3,66.7%,6m
2000,1,[Legacy]酱肘子给谁吃,3697,0,0,11,11,0.0%,5m
2005,2,KindBM,3696,906,38,28,66,57.6%,6m
2005,3,seed,3696,0,1,0,1,100.0%,5m
2007,1,穹妹,3695,791,24,29,53,45.3%,11m
2007,2,[谐91]Howdareyou,3695,162,6,6,12,50.0%,3m
2009,1,伊卡洛斯,3694,1877,308,286,594,51.9%,13m
2009,2,[丨SLT丨]NanYi,3694,809,36,18,54,66.7%,33m
2009,1,[陽光男孩]sio,3694,756,20,24,44,45.5%,11m
2009,1,影子影子,3694,340,9,16,25,36.0%,11m
2009,2,无敌,3694,30,2,1,3,66.7%,32m
2009,2,避雷针,3694,0,1,0,1,100.0%,39m
2015,2,[华附谐会]EyesShu,3693,764,45,32,77,58.4%,19m
2015,2,[赞助商我大哥]脑门刻忠赞小弟,3693,66,3,2,5,60.0%,16m
2017,3,[ReExp]Resol,3692,931,267,280,547,48.8%,1m
2017,2,Memory,3692,151,9,10,19,47.4%,18m
2019,1,[SC2近卫军]IIIIIIIlllll,3691,1483,225,214,439,51.3%,3m
2019,1,[gan死x哥]蟑螂舞娘钱赞企,3691,759,77,55,132,58.3%,30m
2019,2,lllllll,3691,492,17,21,38,44.7%,3m
2019,3,amumu,3691,190,8,3,11,72.7%,30m
2019,2,运气不太好,3691,0,1,0,1,100.0%,24m
2019,2,萌新黑剑,3691,0,0,1,1,0.0%,12m
2025,3,[LSDsc2]SisterEr,3690,0,1,0,1,100.0%,15m
2025,2,纯情大表哥,3690,0,1,1,2,50.0%,33m
2027,2,Acane,3689,260,10,4,14,71.4%,24m
2027,2,[Guard]kingdom,3689,118,3,4,7,42.9%,25m
2029,2,Rain,3688,766,37,13,50,74.0%,33m
2029,2,iiiiiiiii,3688,408,23,26,49,46.9%,17m
2029,2,[NGZK46]steven,3688,140,4,10,14,28.6%,29m
2029,3,憨憨跟筒筒是狗狗,3688,0,1,0,1,100.0%,3m
2033,2,[TAmG]乱码无名,3687,386,15,9,24,62.5%,25m
2033,2,[暴雪十队]lxitt,3687,212,7,5,12,58.3%,24m
2033,2,Chaos,3687,88,4,0,4,100.0%,32m
2033,3,[浙大战队]MoneySniper,3687,30,3,3,6,50.0%,29m
2033,2,IIIIIIIIIIII,3687,0,0,1,1,0.0%,35m
2038,2,我是星际迷,3686,488,18,14,32,56.2%,33m
2038,2,隆尧华夏,3686,341,17,4,21,81.0%,7m
2038,2,IIIIIIIIIIII,3686,0,0,1,1,0.0%,23m
2038,2,[圣谕]老唐,3686,0,0,1,1,0.0%,13m
2042,1,任君爽,3685,1107,109,98,207,52.7%,11m
2042,2,[兔兔之家]ThisIsMeNow,3685,687,29,16,45,64.4%,6m
2042,2,IIIIIIIIIIII,3685,606,24,16,40,60.0%,33m
2042,2,好吃不过饺子,3685,172,5,2,7,71.4%,3m
2042,3,[1sA]Ray,3685,0,1,3,4,25.0%,21m
2042,2,[二次元同好会]皮卡丘,3685,0,0,1,1,0.0%,18m
2042,3,阿西吧,3685,0,0,1,1,0.0%,4m
2049,1,[KPG2]又得浮生半夜闲,3684,1869,523,518,1041,50.2%,5m
2049,2,死亡舰队已经抵达,3684,120,6,5,11,54.5%,29m
2049,2,龙经理,3684,0,0,1,1,0.0%,35m
2049,2,CFACPAFRM,3684,0,0,1,1,0.0%,3m
2053,3,[TNLet]奈拉齐姆渣女头子,3683,171,9,2,11,81.8%,3m
2053,1,[神族难民]栗子蛋糕,3683,0,0,1,1,0.0%,39m
2055,1,儿子真帅星际好玩,3682,1900,121,141,262,46.2%,9m
2055,2,WastedYears,3682,909,39,43,82,47.6%,24m
2055,2,toM,3682,654,24,19,43,55.8%,31m
2055,1,[SDEt]彩云之南打星际,3682,767,24,25,49,49.0%,11m
2055,3,[是我赢了]星际小萌新,3682,30,1,3,4,25.0%,3m
2055,2,[禽禽禽]全太阳,3682,0,0,1,1,0.0%,4m
2061,2,[肉鸡的饲养]YogSothothDD,3681,506,28,20,48,58.3%,28m
2061,2,旅行到宇宙边缘,3681,435,22,23,45,48.9%,19m
2061,2,[维庆是我儿]第一发言人,3681,472,15,18,33,45.5%,35m
2061,2,[RtN]DNA,3681,90,4,7,11,36.4%,5m
2061,3,[GUF]时过境迁,3681,97,2,0,2,100.0%,31m
2066,2,[地质大学武汉]Sapphire,3680,539,28,17,45,62.2%,19m
2066,1,[守望黎明]幼灵,3680,483,13,17,30,43.3%,33m
2066,3,[白给先生]人无迷途枉流连,3680,167,4,2,6,66.7%,10m
2066,2,igXY,3680,0,1,0,1,100.0%,32m
2070,2,IIIIIIII,3679,594,89,53,142,62.7%,23m
2070,2,[玛莎哥牛B]DREAM,3679,60,2,1,3,66.7%,3m
2070,2,FreeDTG,3679,0,1,0,1,100.0%,3m
2070,2,[星云]吾心成魔奈何成佛,3679,38,1,1,2,50.0%,12m
2070,3,九千七,3679,0,0,1,1,0.0%,1m
2075,1,[Tov]林清,3678,1797,640,622,1262,50.7%,7m
2075,2,[YT]萌妹玩星际,3678,1417,58,47,105,55.2%,18m
2075,1,Lycan,3678,1051,40,49,89,44.9%,13m
2075,2,July,3678,582,19,24,43,44.2%,9m
2075,2,[cgnb]LLLLLLgq,3678,156,7,5,12,58.3%,12m
2075,2,炒蛋大元帅,3678,138,5,7,12,41.7%,6m
2075,2,我是一只鸡,3678,0,1,1,2,50.0%,19m
2075,2,玉饼藏陷,3678,0,0,1,1,0.0%,1m
2083,1,老王,3677,1890,183,179,362,50.6%,9m
2083,1,IIIIIIIIIIII,3677,1239,94,102,196,48.0%,5m
2083,2,[我爱吃西瓜]Ace,3677,0,1,1,2,50.0%,24m
2083,2,[肉鸡的饲养]jldfhnslkvns,3677,0,0,1,1,0.0%,29m
2087,1,[黄昏风暴]大狼啊大狼,3676,702,17,40,57,29.8%,19m
2087,2,梁非凡,3676,36,1,1,2,50.0%,3m
2087,2,DragonAAAA,3676,20,1,2,3,33.3%,13m
2087,2,[咸梅干]长岛冰茬,3676,0,0,2,2,0.0%,23m
2091,2,[MTO]魉默,3675,664,28,13,41,68.3%,31m
2091,1,斯诺达科斯,3675,435,21,26,47,44.7%,5m
2091,2,[我队伍很强大]幽灵,3675,150,6,4,10,60.0%,17m
2091,2,[异乱]雇佣兵,3675,66,2,3,5,40.0%,7m
2095,1,[KD]welcometo,3674,1804,134,145,279,48.0%,13m
2095,1,IIIIIIIIIII,3674,183,5,7,12,41.7%,11m
2095,3,IIIIIIIIIIII,3674,0,0,1,1,0.0%,2m
2098,1,[Mensa]老年人玩星际,3673,1876,210,222,432,48.6%,11m
2098,2,develop,3673,1218,108,95,203,53.2%,29m
2098,1,[SK]llllllllllll,3673,1869,93,87,180,51.7%,11m
2098,1,[Amoy]xxxxx,3673,585,53,78,131,40.5%,33m
2098,1,[ZJU]Unununium,3673,792,24,40,64,37.5%,30m
2098,2,state,3673,34,1,1,2,50.0%,32m
2098,2,[笙风]菜菜山萌世歌,3673,30,1,3,4,25.0%,22m
2098,2,[就是锉刀怪]緒方理奈,3673,0,0,1,1,0.0%,17m
2106,2,[暴力喵星]LinYuCain,3672,1443,241,234,475,50.7%,3m
2106,1,oOOOOOOOOOOO,3672,711,36,43,79,45.6%,13m
2106,2,[kotomi]Kotomi,3672,394,15,10,25,60.0%,3m
2106,3,[死亡收割]MixJdcy,3672,120,8,10,18,44.4%,21m
2106,3,Nicholas,3672,30,2,6,8,25.0%,33m
2106,2,[染年霜霜]魔法少女昊昊,3672,0,1,0,1,100.0%,19m
2112,3,闪翼,3671,1928,640,659,1299,49.3%,10m
2112,1,vicious,3671,1735,202,196,398,50.8%,11m
2112,2,游戏之王,3671,1490,95,98,193,49.2%,32m
2112,2,bilibili,3671,633,26,31,57,45.6%,19m
2112,2,[四叶草]大星淡,3671,368,14,9,23,60.9%,19m
2117,1,[17173]老北京鸡肉卷,3670,344,9,18,27,33.3%,9m
2117,2,大蝙蝠,3670,60,3,0,3,100.0%,16m
2117,2,我是你的霸霸,3670,0,1,0,1,100.0%,18m
2120,2,[北极光小组]BBVS,3669,1305,227,227,454,50.0%,34m
2120,2,[雾雨魔法森林]射命丸丶文,3669,889,42,21,63,66.7%,25m
2120,2,[乱打]所到之处寸草不生,3669,0,0,1,1,0.0%,19m
2120,2,[矿物储量过足]命运捉弄着我,3669,0,0,1,1,0.0%,12m
2124,1,Alasinongya,3668,1893,162,171,333,48.6%,13m
2124,2,[HAOREN]Jesse,3668,1252,92,66,158,58.2%,13m
2124,3,[APT]AsadaShino,3668,0,1,0,1,100.0%,12m
2124,2,[3GPP]减肥成功的基王,3668,0,0,1,1,0.0%,13m
2124,2,[偽娘万歳]Victorique,3668,0,0,1,1,0.0%,33m
2129,2,小禹,3667,0,0,1,1,0.0%,26m
2129,2,tim,3667,0,0,2,2,0.0%,13m
2131,2,[RoH]神德李耳,3666,1516,78,79,157,49.7%,17m
2131,2,[SC2近卫军]lllllllllll,3666,630,62,67,129,48.1%,33m
2131,2,[北极光小组]寒风,3666,60,2,3,5,40.0%,22m
2131,2,BigPotato,3666,30,1,2,3,33.3%,30m
2131,2,二十四岁是沧海客,3666,32,1,6,7,14.3%,12m
2131,2,[吉林舰队司令]IIIIIIIIIIII,3666,0,0,1,1,0.0%,12m
2137,1,染陌憂,3665,0,0,1,1,0.0%,7m
2138,2,哇啊,3664,487,64,66,130,49.2%,9m
2138,1,llllllllllll,3664,1496,54,53,107,50.5%,11m
2138,2,[花花]MRmoney,3664,860,33,30,63,52.4%,17m
2138,1,[暴雪我是你爹]嘤嘤嘤喏卫星,3664,1062,29,35,64,45.3%,11m
2138,1,小岛童鞋,3664,468,11,25,36,30.6%,7m
2138,2,[SoloAs]Tkak,3664,60,3,5,8,37.5%,21m
2138,2,Goodlive,3664,58,2,1,3,66.7%,6m
2138,2,[输本夺冠啦]Fenix,3664,62,2,3,5,40.0%,3m
2146,1,[萨尔那加之刃]自己人,3662,1646,89,84,173,51.4%,13m
2146,2,[鬼谷]Tianzai,3662,976,42,26,68,61.8%,23m
2146,2,Wind,3662,321,17,7,24,70.8%,13m
2146,3,English,3662,240,10,4,14,71.4%,27m
2146,2,[RAJA]VANClassic,3662,122,5,7,12,41.7%,24m
2146,2,InSperable,3662,0,1,0,1,100.0%,13m
2146,2,佑丨昕,3662,0,1,2,3,33.3%,39m
2146,2,烤地瓜,3662,30,1,3,4,25.0%,20m
2154,2,[小鸡屠宰场a]鬼魂之龙,3661,1063,290,277,567,51.1%,3m
2154,1,[不会散枪兵]王白,3661,1606,116,119,235,49.4%,11m
2154,2,为了女王,3661,524,21,12,33,63.6%,25m
2154,3,[007]欧仔,3661,60,6,4,10,60.0%,18m
2154,1,llllllllllll,3661,0,3,2,5,60.0%,7m
2154,1,IIIIIIIIIIII,3661,48,2,5,7,28.6%,23m
2160,2,[831]一只鸡,3660,608,23,20,43,53.5%,16m
2160,2,[刺蛇女装协会]IIIIIIIIIIII,3660,82,4,3,7,57.1%,18m
2160,2,[猪头哥]猪猪侠,3660,0,1,0,1,100.0%,19m
2160,1,[皓蒙之剑]有礼有貌安度因,3660,0,1,4,5,20.0%,5m
2164,1,urusai,3659,1052,31,49,80,38.8%,9m
2164,2,TTTLLL,3659,58,3,0,3,100.0%,19m
2164,2,Rubick,3659,0,1,0,1,100.0%,23m
2164,2,我觉得我又可以了,3659,0,1,1,2,50.0%,30m
2164,2,anywhere,3659,0,0,2,2,0.0%,12m
2169,2,[DMR]大八哥,3658,430,16,19,35,45.7%,28m
2169,2,IIIIIIIIIIII,3658,153,13,11,24,54.2%,21m
2169,2,翡翠梦玲珑,3658,346,12,12,24,50.0%,17m
2169,2,水晶贩子,3658,218,8,8,16,50.0%,32m
2169,2,joe,3658,58,2,6,8,25.0%,32m
2169,2,Pluto,3658,0,0,1,1,0.0%,24m
2175,2,[武汉理工大学]琴吹紬,3657,905,37,37,74,50.0%,19m
2175,2,[荣耀归于我主]dearxiaogao,3657,0,1,1,2,50.0%,12m
2175,2,BiggestBug,3657,32,1,1,2,50.0%,5m
2178,2,无情,3656,860,33,26,59,55.9%,16m
2178,3,[stkse]targetZ,3656,233,14,4,18,77.8%,28m
2178,3,IIIIIIIIIIII,3656,269,11,8,19,57.9%,30m
2178,2,世界灵,3656,122,7,3,10,70.0%,21m
2178,2,[沉沦深渊]梁魈,3656,238,7,8,15,46.7%,1m
2178,2,[90星际部落]Black,3656,66,2,5,7,28.6%,18m
2178,2,[某科学的]博丽灵梦,3656,0,0,1,1,0.0%,7m
2185,1,拉雷,3655,1672,200,192,392,51.0%,11m
2185,1,Styrol,3655,1861,116,114,230,50.4%,18m
2185,2,[好多小兔兔]虫群的小领主,3655,1218,104,99,203,51.2%,6m
2185,1,奥氏体不锈钢,3655,432,21,26,47,44.7%,31m
2185,2,Tioe,3655,278,10,8,18,55.6%,35m
2185,2,[净化者执行官]Valkyire,3655,0,1,0,1,100.0%,6m
2191,2,harzon,3654,636,32,29,61,52.5%,32m
2191,1,[四叶草]西湖级前十秒钟,3654,48,1,4,5,20.0%,25m
2193,1,全教主最强解说,3653,1257,237,244,481,49.3%,8m
2193,1,beyondlwm,3653,1655,161,168,329,48.9%,11m
2193,2,[横扫全服]konakona,3653,94,4,1,5,80.0%,13m
2193,2,[绝望星灵]dxokc,3653,126,4,8,12,33.3%,28m
2193,2,[TBL]树的墓志铭,3653,68,2,7,9,22.2%,18m
2193,2,新行星的要塞,3653,32,1,9,10,10.0%,6m
2199,2,[龙骑舞尹志平]小花,3652,674,28,16,44,63.6%,14m
2199,2,法鸡你太美,3652,431,17,8,25,68.0%,35m
2199,2,FeFe,3652,0,1,0,1,100.0%,3m
2199,2,Sanguine,3652,0,1,0,1,100.0%,13m
2203,2,BOY,3651,1357,76,55,131,58.0%,25m
2203,2,yuriyuri,3651,482,26,26,52,50.0%,6m
2203,2,青丿灬小溪,3651,280,11,14,25,44.0%,5m
2203,2,Lyzz,3651,30,1,1,2,50.0%,13m
2207,2,接受正义的制裁吧,3650,1122,52,31,83,62.7%,29m
2207,3,zqz,3650,249,12,4,16,75.0%,21m
2207,2,[突变攻略组]GENG,3650,0,0,1,1,0.0%,32m
2210,2,金刚芭比宋小宝,3649,389,25,24,49,51.0%,13m
2210,3,LJL,3649,174,9,3,12,75.0%,28m
2210,2,envy,3649,86,4,2,6,66.7%,28m
2210,2,[超自研]千里朱音,3649,0,1,0,1,100.0%,35m
2210,2,[E丶home]OneLife,3649,32,1,2,3,33.3%,33m
2210,2,十八相送主持人,3649,0,0,1,1,0.0%,5m
2210,2,紫厌红莲,3649,0,0,1,1,0.0%,4m
2217,2,[妈妈船回头]淹没,3648,0,0,1,1,0.0%,11m
2218,1,Viscosity,3647,1369,151,157,308,49.0%,28m
2218,2,[玉虚门下]清源妙道真君,3647,102,4,8,12,33.3%,25m
2218,2,研默,3647,90,3,1,4,75.0%,12m
2218,2,[软泥怪大团圆]自有科意,3647,30,2,0,2,100.0%,9m
2218,3,[背着预言家的]醉酒茬红尘,3647,0,1,0,1,100.0%,8m
2223,1,可可里拉,3646,1679,98,90,188,52.1%,25m
2223,3,奥巴牛,3646,1786,88,117,205,42.9%,18m
2223,2,[扫黄]角落亦清,3646,924,37,31,68,54.4%,32m
2223,2,星际争霸,3646,374,12,15,27,44.4%,7m
2223,2,[zombie]OCTAVIA,3646,0,0,1,1,0.0%,13m
2228,2,spelling,3645,1097,47,30,77,61.0%,13m
2228,2,听说你很叼,3645,707,31,31,62,50.0%,29m
2228,2,Shinnlucifer,3645,0,1,0,1,100.0%,20m
2228,2,小刺蛇,3645,0,0,5,5,0.0%,12m
2232,1,间谍一号,3644,803,63,72,135,46.7%,6m
2232,2,感动然拒,3644,1403,55,52,107,51.4%,13m
2232,1,[KPG]IIIIIIIIIIII,3644,941,25,33,58,43.1%,18m
2232,2,[DRI]战无不胜,3644,124,4,6,10,40.0%,35m
2232,2,[禽禽禽]凤姐门口装蟾蜍,3644,96,4,7,11,36.4%,14m
2232,2,[探基物语]苦中作乐,3644,0,0,2,2,0.0%,39m
2238,2,主人,3643,404,18,11,29,62.1%,29m
2238,3,再见宋哈娜,3643,288,12,6,18,66.7%,31m
2238,2,TTDDD,3643,118,5,3,8,62.5%,1m
2238,2,[Mensa]厦大孙一峰,3643,0,1,0,1,100.0%,22m
2242,2,[SoloAs]神之赵老,3642,114,2,2,4,50.0%,18m
2242,3,[超级智障]百变智障,3642,0,1,0,1,100.0%,1m
2242,2,星竹,3642,0,0,2,2,0.0%,23m
2245,2,terasa,3641,534,21,14,35,60.0%,13m
2245,2,Solar,3641,394,15,10,25,60.0%,33m
2245,2,AIDI,3641,0,0,1,1,0.0%,3m
2248,2,呼叫舰队,3640,1064,50,47,97,51.5%,23m
2248,2,水生大理,3640,30,2,0,2,100.0%,3m
2248,2,晓为,3640,0,1,0,1,100.0%,13m
2248,2,[传说萌娘团]炒鸡无敌七七酱,3640,0,1,0,1,100.0%,23m
2248,2,[我們的奇跡]ChampionsoO,3640,0,0,1,1,0.0%,25m
2253,2,胡桃夹子,3639,94,4,7,11,36.4%,34m
2253,2,[XXHZN2]羽时俱竞,3639,88,3,3,6,50.0%,19m
2253,2,养生星际,3639,0,1,0,1,100.0%,13m
2253,2,[莽成一匹野马]DOOM,3639,0,0,1,1,0.0%,3m
2257,1,MrZhai,3638,1638,77,86,163,47.2%,7m
2257,2,透里妈批,3638,356,37,42,79,46.8%,32m
2257,2,IIIIIIIIIIII,3638,296,10,12,22,45.5%,35m
2257,3,燃烧的卵毛,3638,30,2,0,2,100.0%,20m
2261,2,出虚空等于无敌,3637,1643,304,302,606,50.2%,25m
2261,1,[闭嘴基佬]虾卤,3637,1637,162,141,303,53.5%,7m
2261,1,[NeXT]SoOFANS,3637,1533,50,55,105,47.6%,7m
2261,2,[湖南工大]我是小白,3637,479,24,20,44,54.5%,16m
2265,1,[丨SLT丨]meltdown,3636,1314,63,63,126,50.0%,5m
2265,2,lllllllllll,3636,0,1,0,1,100.0%,18m
2265,2,[TS嘉年华]BlueSoul,3636,0,1,1,2,50.0%,3m
2265,2,[蕾米0莉亚]IIIIIIIIIIII,3636,0,1,3,4,25.0%,3m
2265,3,[上帝的叹息]龙影随风,3636,0,0,1,1,0.0%,34m
2265,2,[达拉姆内务部]工蜂,3636,0,0,1,1,0.0%,13m
2265,3,[窈窕淑女]我不逑,3636,0,0,1,1,0.0%,15m
2272,2,LIAR,3635,586,23,17,40,57.5%,11m
2272,2,七夜,3635,62,2,2,4,50.0%,22m
2272,2,Beijingfans,3635,0,1,0,1,100.0%,16m
2275,1,凰琊幻翼,3634,1813,304,318,622,48.9%,19m
2275,2,tcy,3634,1298,79,51,130,60.8%,39m
2275,2,[Beasty]Wave,3634,620,24,18,42,57.1%,11m
2275,3,[随心所欲流]停雲,3634,208,7,5,12,58.3%,17m
2275,1,[南京工业大学]dhran,3634,103,5,5,10,50.0%,7m
2275,2,Cnmelon,3634,0,0,2,2,0.0%,1m
2275,3,[HST]墨染,3634,0,0,3,3,0.0%,2m
2282,2,RCB,3633,165,10,12,22,45.5%,12m
2282,2,用脚爆虚空,3633,200,7,7,14,50.0%,26m
2282,3,[快乐肥宅玩法]掠夺者,3633,0,1,0,1,100.0%,15m
2282,2,一梦歌哉,3633,0,1,2,3,33.3%,14m
2286,1,[LOHv]NIMAB,3632,1699,224,219,443,50.6%,18m
2286,2,我是吖吖,3632,210,8,6,14,57.1%,6m
2286,3,RedViolin,3632,227,7,5,12,58.3%,10m
2286,2,Rico,3632,0,0,1,1,0.0%,16m
2290,2,坳里催花,3631,784,47,40,87,54.0%,30m
2290,2,苏双羊,3631,30,1,2,3,33.3%,22m
2292,1,難唸的經,3630,320,90,83,173,52.0%,19m
2292,3,eEmpireLol,3630,145,8,2,10,80.0%,35m
2294,2,ooooooooooo,3629,1253,51,45,96,53.1%,13m
2294,2,[幼儿园W]深巷观花,3629,0,1,0,1,100.0%,18m
2294,2,[运营之神]MixParG,3629,0,0,1,1,0.0%,12m
2294,2,空心汤圆,3629,0,0,3,3,0.0%,11m
2298,2,莽爸,3628,461,29,18,47,61.7%,21m
2298,2,dersta,3628,536,22,25,47,46.8%,3m
2298,1,戏言,3628,140,4,17,21,19.0%,32m
2298,1,无夜,3628,0,2,1,3,66.7%,15m
2298,2,病毒,3628,62,2,2,4,50.0%,21m
2298,2,[西伯利亚土豆]西伯利亚土豆,3628,0,0,1,1,0.0%,16m
2304,2,Los,3627,225,94,84,178,52.8%,28m
2304,2,[医学奇迹之花]花很讨厌,3627,113,6,2,8,75.0%,33m
2304,1,MILD,3627,180,5,15,20,25.0%,6m
2304,2,[目標諾森德]小猪仔,3627,86,4,0,4,100.0%,1m
2308,1,软萌萝莉小仙,3626,1037,31,38,69,44.9%,8m
2308,2,shadowings,3626,243,19,21,40,47.5%,9m
2308,3,Yolooooooo,3626,385,17,5,22,77.3%,8m
2308,3,llllllllllll,3626,121,7,2,9,77.8%,32m
2308,2,凹凸曼,3626,0,1,0,1,100.0%,22m
2308,2,[UPRPRC]八云红,3626,0,0,1,1,0.0%,16m
2308,3,[少年星际梦]耕耘,3626,0,0,1,1,0.0%,31m
2315,2,WANG,3625,631,39,38,77,50.6%,26m
2315,2,大花轿,3625,604,24,20,44,54.5%,13m
2315,2,IIlllIIIll,3625,472,17,26,43,39.5%,39m
2315,2,美女请别这样,3625,178,16,13,29,55.2%,28m
2315,2,[X少NB]狛枝凪斗,3625,218,7,9,16,43.8%,9m
2315,2,[汉堡FANS]伊吹木疯,3625,32,1,1,2,50.0%,9m
2315,2,上将潘凤,3625,0,0,1,1,0.0%,35m
2315,2,一切战术转换家,3625,0,0,1,1,0.0%,11m
2323,1,aasd,3624,1619,115,116,231,49.8%,18m
2323,2,[FAFA]sTarMoon,3624,1087,99,105,204,48.5%,22m
2323,2,[大东营帝国]上岸成功,3624,1158,48,34,82,58.5%,19m
2323,2,IIIIIIIIIIII,3624,160,18,2,20,90.0%,19m
2323,2,丁香与醋栗,3624,0,1,3,4,25.0%,6m
2328,1,[糖稀日天帮]此处我贩剑,3623,1437,69,76,145,47.6%,18m
2328,2,[80s丶]小脑斧丶,3623,605,32,31,63,50.8%,24m
2328,2,[我队伍很强大]正在找撤硕的波波,3623,0,1,0,1,100.0%,33m
2331,2,Demon,3622,1265,70,54,124,56.5%,17m
2331,2,[纸壳]重创刀锋女王,3622,1446,62,57,119,52.1%,39m
2331,2,呼啦圈,3622,316,10,14,24,41.7%,13m
2331,3,ZeR,3622,149,6,5,11,54.5%,29m
2331,2,高手坟墓,3622,146,5,8,13,38.5%,13m
2336,2,星空交错,3621,1351,64,34,98,65.3%,35m
2336,2,[繁星俱乐部]蒂耶鲁,3621,343,18,6,24,75.0%,11m
2336,2,[失败者联盟]不是塞肉是个菜姬,3621,408,15,10,25,60.0%,7m
2336,2,[谁在呼叫舰队]星际战神,3621,184,7,3,10,70.0%,23m
2336,2,[月光]SApraYer,3621,0,1,0,1,100.0%,5m
2341,2,你不要过来啊,3620,541,21,15,36,58.3%,33m
2341,1,[SoloAs]RitaLai,3620,774,20,33,53,37.7%,7m
2341,2,manu,3620,194,12,13,25,48.0%,28m
2341,1,每天睡不够,3620,215,9,26,35,25.7%,11m
2341,2,[雾雨魔法森林]小苏,3620,86,3,3,6,50.0%,16m
2346,1,上的飞机快乐,3619,1635,231,230,461,50.1%,8m
2346,2,[铁血判官]interment,3619,814,96,87,183,52.5%,16m
2346,2,SCPLAYER,3619,328,12,5,17,70.6%,35m
2346,2,就这么爱着我的宁,3619,242,10,5,15,66.7%,33m
2346,2,Hao,3619,0,0,1,1,0.0%,6m
2351,2,便士,3618,274,21,16,37,56.8%,28m
2351,2,潮汕来福渊,3618,116,3,4,7,42.9%,35m
2351,2,[NT]Kiril,3618,0,1,4,5,20.0%,18m
2354,2,endagu,3617,1625,347,340,687,50.5%,14m
2354,1,MirDH,3617,1871,310,309,619,50.1%,11m
2354,2,[CNboi]辰想,3617,1230,53,55,108,49.1%,24m
2354,2,[把别人晾起来]时间之逝,3617,116,4,4,8,50.0%,35m
2354,3,[obob]Inkheart,3617,58,3,2,5,60.0%,10m
2354,2,[谁在呼叫舰队]十次血字,3617,0,1,0,1,100.0%,6m
2360,2,Chuck,3616,1643,239,196,435,54.9%,13m
2360,2,Polestar,3616,1582,136,144,280,48.6%,9m
2360,2,[秋毫第七分队]llllllllllll,3616,36,2,1,3,66.7%,17m
2360,2,不是星辰哦,3616,0,1,5,6,16.7%,32m
2360,1,Mirage,3616,0,0,1,1,0.0%,28m
2365,2,DLDL,3615,493,23,9,32,71.9%,11m
2365,3,[摸鱼探姬]汪小白,3615,183,8,0,8,100.0%,27m
2365,2,Dio,3615,158,5,12,17,29.4%,23m
2365,2,破天荒之风,3615,0,0,1,1,0.0%,32m
2369,1,[holyhp]Suvix,3614,1852,219,233,452,48.5%,18m
2369,2,llllllllllll,3614,1527,105,103,208,50.5%,13m
2369,2,[ATLS]氙气灯,3614,856,37,24,61,60.7%,3m
2369,3,潦草人生,3614,284,13,5,18,72.2%,3m
2369,3,我是一撮呆毛,3614,232,11,3,14,78.6%,21m
2369,3,oNSKYo,3614,143,8,2,10,80.0%,8m
2369,2,[哔哩哔哩杯乾]链子,3614,0,1,0,1,100.0%,33m
2369,2,干爆诺娃,3614,0,0,1,1,0.0%,30m
2377,2,[绅士]jiey,3613,827,36,24,60,60.0%,32m
2377,2,[辉煌华夏]Kira,3613,60,2,1,3,66.7%,28m
2377,2,[输入队标]白开水,3613,0,0,3,3,0.0%,3m
2380,2,[学习使我快乐]Artanis,3612,212,8,9,17,47.1%,6m
2380,2,[刺蛇单推协会]天下钻石斯一家,3612,0,1,0,1,100.0%,18m
2380,2,[没有F2]旋涡云,3612,30,1,1,2,50.0%,32m
2383,2,[七咕咕]灰烬天堂,3611,1290,177,163,340,52.1%,13m
2383,2,[慢手e族]最可爱的波波,3611,880,81,78,159,50.9%,21m
2383,2,[NTOS]DaXun,3611,648,50,27,77,64.9%,16m
2383,2,Diamond,3611,90,4,4,8,50.0%,39m
2383,2,四季和你五选一,3611,0,1,0,1,100.0%,13m
2388,2,人族就输不了,3610,875,35,26,61,57.4%,11m
2388,2,[那里不可以]Mercury,3610,184,6,1,7,85.7%,23m
2388,1,宇智波鼬,3610,0,3,2,5,60.0%,30m
2391,1,[埃蒙好可爱]可爱的脸,3609,1802,135,143,278,48.6%,11m
2391,2,Leviathan,3609,395,16,9,25,64.0%,9m
2391,2,星际老小孩,3609,0,1,1,2,50.0%,32m
2391,3,港澳富豪重金求子,3609,0,1,2,3,33.3%,8m
2391,2,桃源晓,3609,0,0,1,1,0.0%,19m
2396,2,budatvt,3608,982,34,40,74,45.9%,39m
2396,2,llllllllllll,3608,82,5,10,15,33.3%,28m
2396,2,[UnionP]Rouge,3608,0,1,0,1,100.0%,16m
2399,2,传说的星际老男人,3607,1588,242,203,445,54.4%,4m
2399,2,微笑,3607,0,0,1,1,0.0%,4m
2401,2,福特号,3606,205,9,5,14,64.3%,19m
2401,2,IIIIIIIII,3606,48,3,1,4,75.0%,6m
2401,2,[Fe3o4]Ray,3606,0,0,1,1,0.0%,13m
2404,2,朴啊,3605,382,24,28,52,46.2%,17m
2404,2,[CNboi]来自星星的猩猩,3605,393,20,15,35,57.1%,14m
2404,2,[Rhusky]不巧者,3605,272,10,8,18,55.6%,19m
2404,2,笨丶笨,3605,30,1,3,4,25.0%,21m
2404,2,SchoolDays,3605,0,0,1,1,0.0%,32m
2404,2,眉如远山,3605,0,0,1,1,0.0%,39m
2404,2,[poise]瀚海飞扬,3605,0,0,2,2,0.0%,19m
2411,2,[够比人神组]Frank,3604,1213,83,85,168,49.4%,5m
2411,1,[神族天下无敌]阿毛,3604,347,9,16,25,36.0%,7m
2411,2,wulusi,3604,60,3,3,6,50.0%,16m
2411,2,大牛儿子光头爸爸,3604,0,0,1,1,0.0%,16m
2411,2,[浪啊浪]bois,3604,0,0,1,1,0.0%,35m
2416,1,[星际丶老男孩]滚平机枪,3603,963,153,155,308,49.7%,8m
2416,2,小辣鸡,3603,522,19,17,36,52.8%,30m
2416,2,XiaoLeiVSXM,3603,114,5,1,6,83.3%,13m
2416,2,[高樂集团]老子来了,3603,0,1,0,1,100.0%,23m
2416,2,IIIIIIIII,3603,0,1,0,1,100.0%,35m
2416,2,[鸡家军]AsagumoWang,3603,0,0,1,1,0.0%,11m
2422,2,[TPoA]星辰不及眉中山河,3602,308,12,9,21,57.1%,33m
2422,2,[金枪手徐宁]Crazy,3602,153,4,11,15,26.7%,13m
2422,2,DXF,3602,30,2,2,4,50.0%,20m
2422,2,[我们是无敌的]赤名莉香,3602,0,0,1,1,0.0%,23m
2422,2,[哔翻天梯鸡]MarineKing,3602,0,0,1,1,0.0%,7m
2422,2,INNoVation,3602,0,0,2,2,0.0%,32m
2428,1,月光光照大床,3601,1743,501,508,1009,49.7%,9m
2428,1,IIIIIIIIII,3601,1084,31,50,81,38.3%,8m
2428,2,高阶领主阿拉纳克,3601,384,15,10,25,60.0%,1m
2428,2,llllllllllll,3601,0,1,0,1,100.0%,7m
2428,2,猥琐打法全家炭化,3601,0,0,1,1,0.0%,18m
2433,2,Leifo,3600,1582,175,171,346,50.6%,12m
2433,2,[莴苣]小天狼星,3600,1228,87,66,153,56.9%,14m
2433,2,killik,3600,632,27,14,41,65.9%,17m
2433,2,hello,3600,512,22,13,35,62.9%,23m
2433,2,[Ogier]lela,3600,379,21,11,32,65.6%,30m
2433,2,从前有只猫,3600,253,14,11,25,56.0%,14m
2433,2,VVVVV,3600,30,2,0,2,100.0%,6m
2433,2,胡尼玛,3600,60,2,3,5,40.0%,3m
2433,2,钇子钇,3600,0,1,0,1,100.0%,21m
2433,2,Bruce,3600,0,1,4,5,20.0%,33m
2433,2,ppt,3600,0,0,1,1,0.0%,33m
2444,1,不内战,3599,1820,551,530,1081,51.0%,8m
2444,1,打毛线,3599,1728,363,364,727,49.9%,7m
2444,2,[CPT]虚空之王,3599,915,50,37,87,57.5%,20m
2444,2,别急能赢,3599,417,50,42,92,54.3%,11m
2444,2,[Encore]MrLoveQ,3599,494,19,13,32,59.4%,20m
2444,2,[四叶草]面具人,3599,314,10,17,27,37.0%,29m
2444,2,暴走的豆豆,3599,118,5,2,7,71.4%,39m
2444,2,选神族就输不了,3599,60,3,3,6,50.0%,13m
2444,3,极昼永夜,3599,30,2,1,3,66.7%,27m
2453,2,Vanish,3598,1598,164,158,322,50.9%,24m
2453,2,[暴雪我是你爹]RNMsbBLZ,3598,674,27,20,47,57.4%,13m
2453,2,中原中也,3598,288,10,4,14,71.4%,35m
2453,2,[萝莉之芯]LeiGe,3598,58,2,1,3,66.7%,39m
2453,2,[Forwar]骁勇善战丶,3598,0,0,2,2,0.0%,35m
2458,2,泡沫丶漓,3597,580,22,24,46,47.8%,35m
2458,2,上城丶上城,3597,390,17,12,29,58.6%,33m
2458,2,[Onceme]OnlyOne,3597,30,2,1,3,66.7%,20m
2458,2,小鬼狂,3597,32,1,1,2,50.0%,30m
2458,2,砖家叫兽,3597,0,0,1,1,0.0%,11m
2458,2,[搬砖实录]你的民工父亲,3597,0,0,1,1,0.0%,6m
2464,1,哲顿,3596,1775,95,103,198,48.0%,18m
2464,1,乐芙兰,3596,1005,33,41,74,44.6%,18m
2464,2,[DSE]lIlIllllIIII,3596,638,25,20,45,55.6%,3m
2464,2,[我们的奇迹]养猪的大叔,3596,30,2,0,2,100.0%,35m
2464,2,宝盖压丁,3596,0,1,0,1,100.0%,3m
2464,2,打星际你快乐吗,3596,0,1,0,1,100.0%,6m
2470,2,撸一发,3595,940,201,162,363,55.4%,3m
2470,2,IIIIIIIIIIII,3595,1280,52,50,102,51.0%,6m
2470,2,Cry,3595,0,1,0,1,100.0%,3m
2470,2,快乐的龙九,3595,0,0,3,3,0.0%,19m
2474,1,Fantaisie,3594,1791,877,854,1731,50.7%,7m
2474,2,[oxyed]氧化钾,3594,1465,129,129,258,50.0%,22m
2474,2,[BXH]连接中请稍候,3594,296,11,19,30,36.7%,33m
2474,3,[辉煌华夏]ChL,3594,167,9,2,11,81.8%,8m
2474,3,楚楚持矢,3594,108,5,7,12,41.7%,32m
2474,2,[云雾黎明]沁音的手指面包,3594,60,3,2,5,60.0%,26m
2474,2,[蓬莱伝説]泄矢蛤蛤子,3594,0,0,1,1,0.0%,25m
2481,1,EtdEdsion,3593,1545,509,510,1019,50.0%,33m
2481,2,[Holyam]芥子尘,3593,1274,51,47,98,52.0%,3m
2481,2,[Ogier]IIIIIIIIIIII,3593,58,2,1,3,66.7%,6m
2484,2,IIIIIIIIIIII,3592,1603,229,217,446,51.3%,3m
2484,2,lxoclo,3592,1412,53,57,110,48.2%,29m
2484,2,[Do]Burning,3592,206,7,10,17,41.2%,25m
2484,2,Should,3592,122,5,6,11,45.5%,18m
2484,2,[IMRTS2]南华虫王蒋跃迪,3592,92,3,2,5,60.0%,33m
2484,2,[WAST]Min,3592,58,2,6,8,25.0%,9m
2484,1,GTV,3592,0,1,0,1,100.0%,23m
2484,3,[君之家]llllllllllll,3592,0,0,3,3,0.0%,4m
2492,2,夏日骄阳,3591,968,39,31,70,55.7%,11m
2492,2,SuperAllen,3591,628,22,28,50,44.0%,14m
2492,2,songtou,3591,462,16,22,38,42.1%,29m
2492,2,[CLaffy]悟空,3591,328,12,15,27,44.4%,13m
2496,2,Reald,3590,645,106,104,210,50.5%,28m
2496,3,随机狗,3590,393,17,7,24,70.8%,17m
2496,2,CILDK,3590,336,12,9,21,57.1%,13m
2496,2,搏命玩家司马,3590,134,6,4,10,60.0%,21m
2496,2,Xavier,3590,0,0,1,1,0.0%,26m
2496,2,[星际哪有妹子]LuckyPants,3590,0,0,1,1,0.0%,21m
2502,1,[黯殇]卓玛的悲惨遭遇,3589,1812,102,118,220,46.4%,5m
2502,2,[薄暮之光]lvyaqiao,3589,1201,55,41,96,57.3%,39m
2502,2,好吃鸡的虫子,3589,1302,46,52,98,46.9%,26m
2502,2,[暴雪养鸡场]啊松啊啊啊,3589,778,28,28,56,50.0%,33m
2502,2,SNAKE,3589,142,6,2,8,75.0%,23m
2502,2,llllllllllll,3589,0,2,3,5,40.0%,20m
2502,1,[VGS]AlexMercer,3589,0,1,0,1,100.0%,15m
2502,3,勾勾,3589,0,1,0,1,100.0%,31m
2510,2,HAIILO,3588,438,20,14,34,58.8%,7m
2510,2,ish,3588,42,4,7,11,36.4%,32m
2510,2,LXLXLXLXLX,3588,30,2,4,6,33.3%,34m
2510,2,[Dark势力]starhy,3588,0,1,0,1,100.0%,39m
2510,2,[西窗法雨]深夜诗人,3588,0,1,0,1,100.0%,1m
2510,2,罗宾范佩西,3588,0,0,1,1,0.0%,3m
2516,2,Frank,3587,1159,81,85,166,48.8%,19m
2516,2,好难玩呀,3587,88,4,0,4,100.0%,25m
2516,2,画地为牢,3587,0,1,0,1,100.0%,32m
2519,2,[Vcc]Vspring,3586,886,31,38,69,44.9%,32m
2519,2,浮生如梦,3586,154,15,5,20,75.0%,5m
2519,2,[笙风]笙风,3586,0,1,4,5,20.0%,35m
2522,1,乔鲁诺乔巴拿,3585,1734,82,92,174,47.1%,18m
2522,2,BluePlay,3585,261,57,54,111,51.4%,12m
2522,2,[天天打电脑]IIIIIIIIIIII,3585,368,14,13,27,51.9%,26m
2522,2,Jet,3585,0,1,0,1,100.0%,13m
2522,2,我超甜你爱不爱我,3585,0,0,1,1,0.0%,6m
2527,2,打完一局做俯卧撑,3584,1603,341,326,667,51.1%,14m
2527,2,格里芬小将叶戈尔,3584,433,20,7,27,74.1%,39m
2527,2,DeadGame,3584,260,9,17,26,34.6%,21m
2527,2,[西电]destan,3584,0,0,1,1,0.0%,11m
2531,1,passacaglia,3583,1725,498,490,988,50.4%,3m
2531,2,[TFOD]kaitouKID,3583,1508,107,89,196,54.6%,6m
2531,2,[青娱乐]阿弥陀佛,3583,986,47,40,87,54.0%,17m
2531,3,为了呜喵王,3583,205,10,3,13,76.9%,12m
2535,2,[鬼谷]氯化氢公主,3582,1564,314,287,601,52.2%,39m
2535,2,[这不起飞]skty,3582,141,14,14,28,50.0%,9m
2535,2,[天地會总舵]iGXlous,3582,64,2,7,9,22.2%,14m
2535,2,Kevin,3582,0,0,1,1,0.0%,25m
2535,2,甜橙,3582,0,0,3,3,0.0%,19m
2540,2,murphy,3581,1172,227,211,438,51.8%,1m
2540,1,菜鸟一个,3581,1773,91,95,186,48.9%,33m
2540,2,[花开彼岸天]尔等有罪,3581,1602,90,83,173,52.0%,13m
2540,2,[喵内噶]LuckyRabbit,3581,549,22,15,37,59.5%,17m
2540,2,[衣钵之卫]吟绿颂青,3581,278,11,5,16,68.8%,35m
2540,2,[为星光而战]你爹重回战场,3581,0,0,1,1,0.0%,35m
2546,3,[暴雪我是你爹]braveterran,3580,256,8,3,11,72.7%,3m
2546,2,[SoloBM]Beyond,3580,120,5,3,8,62.5%,13m
2546,2,shava,3580,98,3,12,15,20.0%,28m
2546,2,[镜花水月丿]AYILY,3580,0,0,1,1,0.0%,25m
2546,1,[哔哩哔哩乾杯]Corrupt,3580,0,0,1,1,0.0%,32m
2551,1,知秋一叶,3579,1290,98,74,172,57.0%,11m
2551,1,[薪之古战场]乱世水电工,3579,1574,51,61,112,45.5%,19m
2551,2,[马保国]实验狗招专用号,3579,222,9,6,15,60.0%,11m
2551,2,[老年人反应]不要打我一波好嘛,3579,90,4,2,6,66.7%,23m
2551,2,PlaYFair,3579,86,3,6,9,33.3%,35m
2551,2,孙君陌的爹,3579,30,1,3,4,25.0%,23m
2551,2,[自丶由]青山埋忠骨,3579,0,0,1,1,0.0%,9m
2558,2,hwappyZerg,3578,511,21,27,48,43.8%,5m
2558,2,[万物齐一]随心自在,3578,90,4,2,6,66.7%,21m
2558,2,[QAQ]南面称孤,3578,30,2,1,3,66.7%,4m
2558,2,[foryss]zEAlotyc,3578,0,1,1,2,50.0%,17m
2558,2,[此地白门楼]你家吴叔叔,3578,0,0,1,1,0.0%,23m
2563,2,[esport]Clear,3577,1288,67,73,140,47.9%,30m
2563,2,LOMOI,3577,30,2,2,4,50.0%,33m
2563,2,[BGD]KILLER,3577,0,1,0,1,100.0%,20m
2563,3,SpiderYao,3577,0,0,1,1,0.0%,21m
2563,2,天王巨兽,3577,0,0,3,3,0.0%,19m
2568,2,EtdAL,3576,1577,260,269,529,49.1%,23m
2568,2,IIIIIIIIIIII,3576,1051,42,44,86,48.8%,29m
2568,2,llllllllllll,3576,952,37,35,72,51.4%,13m
2568,2,[我队伍很强大]惊了个呆呆呆,3576,624,29,17,46,63.0%,13m
2568,2,玫瑰,3576,86,4,2,6,66.7%,17m
2568,2,switch,3576,86,3,4,7,42.9%,39m
2574,2,烟火,3575,1584,224,229,453,49.4%,14m
2574,2,[七咕咕]伪物的妖妖,3575,1604,91,81,172,52.9%,11m
2574,2,[艾尔小圆盾]小野芒果,3575,1317,67,63,130,51.5%,30m
2574,2,啦啦啦德玛西亚,3575,1246,63,31,94,67.0%,7m
2574,3,wei,3575,285,13,5,18,72.2%,1m
2574,3,[传说萌娘团]井盖侠,3575,0,1,0,1,100.0%,12m
2574,2,挪威的森林,3575,0,0,1,1,0.0%,13m
2574,2,[线性代数]Amadeus,3575,0,0,1,1,0.0%,22m
2582,2,DreamHunter,3574,1511,215,196,411,52.3%,17m
2582,1,[闭嘴基佬]LunaMSS,3574,1028,36,44,80,45.0%,7m
2582,2,西木野真姬,3574,353,12,6,18,66.7%,4m
2582,2,风之殇,3574,70,8,4,12,66.7%,19m
2582,2,[HypeR]LiquidSnute,3574,0,0,1,1,0.0%,24m
2582,1,[山包]MarineKing,3574,0,0,1,1,0.0%,31m
2582,2,[AgCu电池]INoVatio,3574,0,0,1,1,0.0%,23m
2589,1,二道街孙一峰,3573,254,7,22,29,24.1%,11m
2589,3,夜凌寒,3573,0,1,0,1,100.0%,33m
2589,2,[WinWin]hellforever,3573,0,1,1,2,50.0%,25m
2589,2,[古剑魂梦]折戟沉沙,3573,0,0,1,1,0.0%,17m
2593,2,aresvil,3572,759,62,56,118,52.5%,22m
2593,2,[红白梦恋]招财夢,3572,114,4,3,7,57.1%,35m
2595,1,[一等星]时间领主,3571,1803,256,267,523,48.9%,32m
2595,2,小葡,3571,296,11,13,24,45.8%,18m
2595,3,Iori,3571,146,8,3,11,72.7%,34m
2595,2,[壮士打我队友]superkiller,3571,30,2,0,2,100.0%,23m
2595,3,maru,3571,30,2,2,4,50.0%,31m
2595,2,[世风第三帝国]大宇神,3571,0,0,1,1,0.0%,28m
2601,2,LeoLiu,3570,836,34,41,75,45.3%,9m
2601,2,googe,3570,664,24,26,50,48.0%,17m
2601,1,[才不是妹控]凉風青葉,3570,0,1,2,3,33.3%,24m
2601,2,[KUMA28]FadeAway,3570,0,0,1,1,0.0%,9m
2605,1,[Holyam]LUCKGODSPEED,3569,858,72,77,149,48.3%,34m
2605,2,[晶晶]这是种病得治,3569,390,12,24,36,33.3%,25m
2605,2,[SteEng]风子,3569,250,10,9,19,52.6%,6m
2605,2,Encounter,3569,172,6,9,15,40.0%,13m
2605,2,[CIE]IIIIIIIIIIII,3569,0,1,0,1,100.0%,21m
2605,2,[迪克boy]五更琉璃,3569,30,1,1,2,50.0%,33m
2605,2,[华东师大]lck,3569,30,1,1,2,50.0%,1m
2605,2,WSX,3569,32,1,2,3,33.3%,1m
2605,2,桐生马子,3569,0,0,1,1,0.0%,30m
2614,2,[AnSwer]Rhythm,3568,1279,53,58,111,47.7%,19m
2614,2,[框本之魂]老框本,3568,692,24,31,55,43.6%,7m
2614,3,Stats,3568,97,2,1,3,66.7%,10m
2617,2,[31CM]MasterDA,3567,1113,62,40,102,60.8%,35m
2617,2,[现世执妄]人生之遂,3567,480,18,16,34,52.9%,21m
2617,2,选神族或选胜利,3567,209,15,5,20,75.0%,32m
2617,2,SpeciaForce,3567,258,10,6,16,62.5%,9m
2617,2,[sbcoys]pandasssss,3567,18,1,9,10,10.0%,1m
2622,2,[四叶草]良月十八,3566,895,236,205,441,53.5%,19m
2622,2,一蓑烟雨任平生,3566,410,19,13,32,59.4%,35m
2622,2,IIIIIIII,3566,0,0,2,2,0.0%,6m
2625,2,youareonly,3565,1573,155,146,301,51.5%,12m
2625,2,九九子,3565,88,4,3,7,57.1%,18m
2625,2,心态爆炸的菜鸡,3565,58,2,1,3,66.7%,17m
2625,2,[能白给就白给]奇遇,3565,30,1,1,2,50.0%,33m
2625,2,银色之风,3565,0,0,1,1,0.0%,39m
2625,2,TYTY,3565,0,0,1,1,0.0%,39m
2631,2,[剑b狗逼t]llllllllllll,3564,401,133,115,248,53.6%,6m
2631,2,[SoIoAs]血花缭乱,3564,629,24,19,43,55.8%,14m
2631,2,十系,3564,534,20,20,40,50.0%,26m
2631,2,[SK]古明地觉,3564,116,5,3,8,62.5%,13m
2631,3,[KPG2]Lotus,3564,120,4,13,17,23.5%,4m
2631,2,苟且偷生,3564,0,1,0,1,100.0%,6m
2631,2,leonardotang,3564,0,0,1,1,0.0%,4m
2638,2,卑鄙大魔王,3563,383,111,112,223,49.8%,33m
2638,2,SmallSnow,3563,747,34,17,51,66.7%,28m
2638,2,旭日东升照一峰,3563,214,8,8,16,50.0%,25m
2638,2,foreveryao,3563,88,4,5,9,44.4%,16m
2638,2,xzcccccccccc,3563,30,2,5,7,28.6%,1m
2638,1,WDLN,3563,0,1,0,1,100.0%,3m
2644,2,雪深,3562,1576,224,218,442,50.7%,12m
2644,2,[一等星]CoLa,3562,492,27,29,56,48.2%,25m
2644,2,Zincye,3562,273,12,11,23,52.2%,33m
2644,2,[鸡会友狗服人]黄金先生,3562,78,3,6,9,33.3%,19m
2644,2,[TossSE]樱小路,3562,90,3,6,9,33.3%,13m
2644,2,[wtf啊]西陵葬月,3562,98,3,10,13,23.1%,13m
2644,2,CymbiDD,3562,0,1,0,1,100.0%,18m
2644,2,[GDG]剑不归,3562,0,1,2,3,33.3%,13m
2652,2,IIIIIIIIIIII,3561,412,16,12,28,57.1%,3m
2652,2,Jinna,3561,0,1,0,1,100.0%,39m
2652,2,[禽禽禽]voxbay,3561,30,1,3,4,25.0%,6m
2652,2,[RyH键谈坊]龙战,3561,0,0,1,1,0.0%,13m
2656,1,[虚空贱队]lvzhen,3560,1783,498,491,989,50.4%,35m
2656,2,八云芦苇,3560,270,9,15,24,37.5%,13m
2656,2,Mefistofele,3560,148,6,5,11,54.5%,13m
2656,2,Silence,3560,88,4,4,8,50.0%,23m
2656,2,[Sparta]GreatBowl,3560,30,1,4,5,20.0%,29m
2656,2,Saber,3560,0,0,2,2,0.0%,25m
2662,2,吴彦祖,3559,661,31,16,47,66.0%,33m
2662,2,[KPG2]来找小秘书,3559,600,22,22,44,50.0%,5m
2662,2,月林星鱼,3559,454,20,12,32,62.5%,39m
2662,2,小破,3559,274,9,7,16,56.2%,6m
2662,2,夜夜,3559,88,4,4,8,50.0%,35m
2662,2,[橘子洲头]艺术就是爆炸,3559,0,1,0,1,100.0%,35m
2662,2,[SK]不开矿怎么暴兵,3559,30,1,3,4,25.0%,39m
2662,2,[BGD]浙西丁俊晖,3559,0,0,3,3,0.0%,13m
2670,2,Monicakou,3558,1538,599,602,1201,49.9%,28m
2670,2,[BOOMER]TYTY,3558,190,9,7,16,56.2%,9m
2670,2,[哔哩哔哩杯乾]琉璃易碎,3558,30,1,5,6,16.7%,11m
2670,1,跳不动的跳跳骑士,3558,0,0,1,1,0.0%,22m
2670,2,[高素质]XYling,3558,0,0,2,2,0.0%,29m
2675,2,[花姐Fan]magiczerg,3557,180,7,6,13,53.8%,19m
2675,2,IIIIIIIIIIII,3557,30,2,0,2,100.0%,29m
2675,2,枪神尤里,3557,0,0,1,1,0.0%,19m
2675,2,MatoiRyuuko,3557,0,0,1,1,0.0%,24m
2675,2,BossLing,3557,0,0,1,1,0.0%,11m
2680,2,[绝对防御]RippeR,3556,1103,71,68,139,51.1%,19m
2680,2,[七月与安生]Geemini,3556,0,0,1,1,0.0%,21m
2682,1,地主,3555,1756,329,349,678,48.5%,18m
2682,2,打不过就是不够多,3555,959,306,280,586,52.2%,23m
2682,2,[梦想彼方]Chronosphere,3555,58,3,0,3,100.0%,19m
2682,3,大姬霸,3555,97,2,1,3,66.7%,4m
2686,2,moose,3554,1533,275,267,542,50.7%,12m
2686,2,新的开始,3554,1539,133,115,248,53.6%,35m
2686,2,ColdWater,3554,816,131,136,267,49.1%,17m
2686,2,BravoSix,3554,211,9,3,12,75.0%,19m
2686,2,长呢是有点丑呢,3554,60,2,12,14,14.3%,17m
2686,2,[鸡饲料协会]大蒜拌黄瓜,3554,0,1,0,1,100.0%,17m
2692,2,张璐是个好姐姐,3553,1460,75,50,125,60.0%,34m
2692,2,[天生鬈毛]不喜内战,3553,1533,59,52,111,53.2%,23m
2692,2,artificial,3553,566,22,15,37,59.5%,21m
2692,2,[svmoon]蠕动之潮,3553,0,0,1,1,0.0%,3m
2692,2,浮世千寻沐,3553,0,0,1,1,0.0%,23m
2697,2,yasaka,3552,1573,446,439,885,50.4%,19m
2697,2,MagicZerg,3552,1118,46,47,93,49.5%,14m
2697,1,我是你爹,3552,1178,34,52,86,39.5%,18m
2697,2,SpeakNow,3552,0,2,0,2,100.0%,33m
2697,2,llllllllllll,3552,30,1,2,3,33.3%,23m
2697,2,[我随便打打的]月季,3552,30,1,2,3,33.3%,25m
2697,2,[青葱与纯色]凌星静夜,3552,0,0,1,1,0.0%,13m
2704,2,大恶魔,3551,1522,406,406,812,50.0%,12m
2704,2,[名最好别太长]CRCaptain,3551,1578,71,68,139,51.1%,3m
2704,2,统一,3551,250,8,16,24,33.3%,34m
2704,2,[Goodg]森宫苍乃,3551,0,5,0,5,100.0%,20m
2704,2,[ETG]icestyleTYTY,3551,0,1,0,1,100.0%,26m
2704,2,[查尔之矛]我又不会玩,3551,0,1,0,1,100.0%,5m
2704,2,[上海龙]LeeJaeGon,3551,30,1,3,4,25.0%,10m
2704,3,Hderrick,3551,0,0,2,2,0.0%,32m
2712,2,[Toss]IIIIIIIIIIII,3550,1555,481,465,946,50.8%,21m
2712,2,ElderArtist,3550,1638,277,255,532,52.1%,17m
2712,2,前锋,3550,670,24,31,55,43.6%,29m
2712,3,[Ompc]Sixgods,3550,224,11,7,18,61.1%,7m
2712,2,[真天堂之魔]零九六,3550,0,0,1,1,0.0%,34m
2717,2,Wen,3549,60,3,6,9,33.3%,17m
2717,2,香艹不再,3549,64,3,10,13,23.1%,13m
2717,2,[LoveBG]霞之丘诗羽,3549,0,1,0,1,100.0%,3m
2717,2,[Melt病毒]必死无疑九条喵,3549,30,1,1,2,50.0%,4m
2721,1,IIIIIIIIIII,3548,1361,534,522,1056,50.6%,11m
2721,2,天若有情天亦老,3548,1100,45,37,82,54.9%,29m
2721,3,[MP]帝殒,3548,258,9,6,15,60.0%,10m
2721,2,不过是新鲜感,3548,0,5,0,5,100.0%,33m
2721,2,风阵,3548,88,4,9,13,30.8%,11m
2721,3,施政卓,3548,30,2,0,2,100.0%,6m
2721,2,[荒野之鹰]纯洁,3548,0,0,1,1,0.0%,17m
2721,2,leon,3548,0,0,1,1,0.0%,33m
2729,2,少年祭,3547,1078,153,152,305,50.2%,12m
2729,2,Root,3547,268,10,11,21,47.6%,12m
2729,2,[卡钦斯基跤流]龙啸九天,3547,223,8,6,14,57.1%,33m
2729,3,IIIIIIIIIIII,3547,58,2,5,7,28.6%,32m
2733,1,Yellowkobe,3546,1530,233,230,463,50.3%,32m
2733,2,[半夏]人畜无害的幼虫,3546,544,22,16,38,57.9%,21m
2733,2,RamboIsBug,3546,467,20,11,31,64.5%,3m
2733,2,[致敬蒙斯克]请冷静,3546,387,16,23,39,41.0%,19m
2733,2,[RTSGo]IIIIIIIIIIII,3546,0,0,1,1,0.0%,35m
2738,2,[斗鱼大纲]飘的很,3545,1383,137,131,268,51.1%,21m
2738,2,坠落于空,3545,1340,74,77,151,49.0%,11m
2738,2,IIIIIIIIIIII,3545,928,44,34,78,56.4%,4m
2738,2,[星球大战]星河浩瀚,3545,32,1,5,6,16.7%,32m
2742,2,[KPG2]skyline,3544,0,0,1,1,0.0%,39m
2743,1,Cadenza,3543,651,242,241,483,50.1%,32m
2743,2,[Borne]怕天黑的小黑,3543,1368,97,83,180,53.9%,12m
2743,2,蒲公英,3543,657,93,67,160,58.1%,12m
2743,2,会痛的石头,3543,1165,84,70,154,54.5%,10m
2743,2,IIIIIIIIII,3543,764,52,38,90,57.8%,7m
2743,2,haha,3543,856,31,36,67,46.3%,35m
2743,2,[CUSTE]Emerald,3543,86,3,2,5,60.0%,17m
2743,2,[唯爱彦神]BYDY,3543,90,3,7,10,30.0%,21m
2743,2,TIGERONFIRE,3543,0,1,0,1,100.0%,21m
2743,2,艾尔电力局局长,3543,0,1,0,1,100.0%,7m
2743,2,[Ginuna]Nidhoog,3543,0,0,1,1,0.0%,34m
2754,2,跳跳虫,3542,1541,160,143,303,52.8%,21m
2754,2,帝血弑天,3542,804,78,74,152,51.3%,26m
2754,2,[鸡饲料1]奈文摩尔,3542,1229,53,43,96,55.2%,13m
2754,2,[IWARI]彧星,3542,503,19,21,40,47.5%,32m
2754,2,[DMRc]hero,3542,186,7,8,15,46.7%,14m
2754,2,[最菜]拆迁队队长,3542,0,1,0,1,100.0%,1m
2754,2,[昊灵]zxx,3542,0,1,1,2,50.0%,19m
2761,1,windwhere,3541,1765,406,405,811,50.1%,18m
2761,2,[神子]魔力红,3541,427,19,7,26,73.1%,17m
2761,2,MVPLegend,3541,315,12,5,17,70.6%,35m
2761,2,萌萌哒的君君酱,3541,114,5,7,12,41.7%,3m
2761,2,[天青车道]hehedeyifang,3541,0,0,1,1,0.0%,6m
2761,2,双刃追火者,3541,0,0,1,1,0.0%,18m
2767,2,狂虫,3540,1397,447,399,846,52.8%,29m
2767,2,王小明,3540,773,129,124,253,51.0%,10m
2767,2,黑叔叔,3540,225,50,13,63,79.4%,19m
2767,2,王主任,3540,178,6,13,19,31.6%,32m
2767,2,[风后奇门]StephaY,3540,0,5,0,5,100.0%,15m
2767,2,我超凶的,3540,142,5,4,9,55.6%,17m
2767,2,[萨尔那加之刃]怂本,3540,114,5,4,9,55.6%,21m
2767,2,IIIIIIIIIIII,3540,60,4,5,9,44.4%,35m
2767,2,[时光易逝]岁月的沉淀,3540,58,3,0,3,100.0%,18m
2767,3,[且行且珍惜]foreverTao,3540,30,1,2,3,33.3%,4m
2777,2,[文韬武略]xiaoxiao,3539,722,28,29,57,49.1%,13m
2777,2,[Oceanx]JamesRccl,3539,130,15,22,37,40.5%,3m
2777,3,暖风,3539,229,11,2,13,84.6%,5m
2777,2,黄鸡舰队,3539,272,10,10,20,50.0%,32m
2777,2,[不会散枪兵]ACCOMPANY,3539,0,0,1,1,0.0%,3m
2777,2,[盲人康复院]潇逸宸,3539,0,0,1,1,0.0%,13m
2783,1,[CnNami]菜鸟,3538,1875,138,159,297,46.5%,18m
2783,2,[IMRTS]CROSS,3538,818,34,31,65,52.3%,30m
2783,2,FROZEN,3538,692,28,20,48,58.3%,17m
2783,2,神武,3538,342,13,7,20,65.0%,4m
2783,3,醉剑,3538,211,10,3,13,76.9%,20m
2783,2,[KPG]llllllllllll,3538,30,2,1,3,66.7%,19m
2783,2,Encounter,3538,30,2,3,5,40.0%,19m
2783,2,[Sc养老]Tory,3538,0,1,0,1,100.0%,13m
2783,2,[YINGJI]三只松鼠,3538,0,1,0,1,100.0%,32m
2783,2,Neko,3538,0,0,1,1,0.0%,39m
2793,2,Rozanne,3537,1315,55,60,115,47.8%,3m
2793,2,SWTT,3537,456,31,40,71,43.7%,34m
2795,2,小马挺住哦,3536,1424,127,120,247,51.4%,13m
2795,2,燕南赵北石家庄,3536,221,10,1,11,90.9%,29m
2795,2,[大陆谐会]西北孙一峰,3536,162,4,1,5,80.0%,14m
2795,2,龙帝,3536,30,1,3,4,25.0%,6m
2795,2,[黑人抬棺团队]雨之希留,3536,0,0,2,2,0.0%,17m
2800,1,sleepyshaman,3535,1687,110,102,212,51.9%,35m
2800,2,阿夏的意志,3535,289,103,87,190,54.2%,17m
2800,2,疯了的大牛,3535,1568,77,81,158,48.7%,25m
2800,2,[温柔兔公主]JJJJJJJ,3535,748,26,32,58,44.8%,22m
2800,3,[Deepdk]hitori,3535,0,0,1,1,0.0%,4m
2800,2,[今天超市打折]DIO,3535,0,0,1,1,0.0%,11m
2800,2,教父,3535,0,0,1,1,0.0%,26m
2800,2,Boos,3535,0,0,1,1,0.0%,23m
2808,2,llllllllllll,3534,542,22,13,35,62.9%,6m
2808,2,你吃火锅底料,3534,437,19,15,34,55.9%,18m
2808,2,huangmingfei,3534,0,1,0,1,100.0%,33m
2811,2,[佩佩FANS]Sholva,3533,1561,78,69,147,53.1%,32m
2811,2,再打就打死了,3533,563,20,26,46,43.5%,33m
2811,2,GOOD,3533,174,12,22,34,35.3%,5m
2811,2,IIIIIIII,3533,260,9,10,19,47.4%,25m
2811,2,黄龙,3533,200,7,2,9,77.8%,20m
2811,2,先秦遗民,3533,30,2,2,4,50.0%,20m
2817,2,[五月花]回忆在你不在,3532,1552,283,262,545,51.9%,35m
2817,2,Tangist,3532,473,32,33,65,49.2%,23m
2817,2,鳝变的色长,3532,655,28,18,46,60.9%,23m
2817,2,wAo,3532,551,23,13,36,63.9%,23m
2817,2,[专打嘤嘤怪]希尔瓦娜斯,3532,228,9,2,11,81.8%,4m
2817,2,[HoSeeB]叫我小李子,3532,0,1,0,1,100.0%,23m
2817,2,IIIIIIIIIIII,3532,0,0,1,1,0.0%,17m
2817,1,IIIIIIIIIIII,3532,0,0,2,2,0.0%,14m
2817,2,星空彼岸,3532,0,0,3,3,0.0%,32m
2826,2,MixTokYoHoT,3531,764,43,42,85,50.6%,20m
2826,2,[轻岁月]HEalldin,3531,178,6,8,14,42.9%,11m
2826,2,[是嫂子自愿的]御倾,3531,60,3,1,4,75.0%,12m
2826,2,[谐星联盟]菜头,3531,0,1,0,1,100.0%,39m
2826,2,[我们的奇迹]我即是虫群,3531,0,1,0,1,100.0%,17m
2826,2,[一波]阿卜杜买买提飞踢,3531,0,0,1,1,0.0%,3m
2832,2,新鲜土豆丝,3530,1486,104,98,202,51.5%,35m
2832,2,DraGonkid,3530,382,89,93,182,48.9%,12m
2832,2,[Beasty]被简单电脑暴捶,3530,521,21,20,41,51.2%,19m
2832,2,[TNT]nicole,3530,438,19,9,28,67.9%,4m
2832,2,[享受星际]Crazydiamond,3530,368,14,9,23,60.9%,23m
2832,2,[空中劈叉]RaidenMei,3530,136,4,0,4,100.0%,21m
2832,2,Waawaatatata,3530,104,4,4,8,50.0%,22m
2839,2,妈个鸡泰伦人,3529,1564,115,96,211,54.5%,17m
2839,2,[Tricky]IIIIIIIIIII,3529,618,35,29,64,54.7%,35m
2839,2,[虞城星际]口爆毒龙转,3529,466,19,16,35,54.3%,28m
2839,2,[侦测到喵入侵]不疯魔不成活,3529,207,18,19,37,48.6%,28m
2839,2,[单矿跳大牛]HouBen,3529,334,11,9,20,55.0%,25m
2839,2,likejuly,3529,207,7,13,20,35.0%,4m
2839,2,[SK]艾尔小圆盾,3529,58,3,1,4,75.0%,34m
2839,2,sorafenib,3529,0,1,0,1,100.0%,4m
2839,2,月痕,3529,0,1,0,1,100.0%,20m
2848,2,caici,3528,1563,95,74,169,56.2%,6m
2848,2,开门暗影卫队,3528,240,9,15,24,37.5%,10m
2848,1,FIIA,3528,180,6,2,8,75.0%,5m
2848,2,Butterfly,3528,0,1,0,1,100.0%,13m
2848,2,[幽明异路]SuchLife,3528,30,1,2,3,33.3%,23m
2853,2,霜落夜,3527,162,5,12,17,29.4%,34m
2853,2,萌多多,3527,0,1,0,1,100.0%,10m
2853,2,[WAL]WangJie,3527,0,0,1,1,0.0%,25m
2853,3,AAAAA,3527,0,0,1,1,0.0%,2m
2857,2,EtdMaMaMia,3526,1099,60,43,103,58.3%,21m
2857,2,mandery,3526,1222,55,49,104,52.9%,26m
2857,2,游击队长,3526,579,32,20,52,61.5%,5m
2857,1,易琉璃,3526,190,8,3,11,72.7%,35m
2857,2,随风看海,3526,244,8,15,23,34.8%,32m
2857,2,绝望尽头还是绝望,3526,0,1,5,6,16.7%,28m
2857,2,[正义的退魔士]QAQ,3526,0,0,1,1,0.0%,11m
2864,2,[KPG2]我是新手让让我啊,3525,1351,110,72,182,60.4%,39m
2864,2,IIIIIIII,3525,774,27,34,61,44.3%,21m
2864,2,探机甩死提速狗,3525,311,19,21,40,47.5%,23m
2864,2,Saber,3525,0,3,2,5,60.0%,21m
2864,3,[解放碑]航航,3525,60,3,10,13,23.1%,15m
2869,2,SDDDDDDD,3524,486,23,20,43,53.5%,19m
2869,2,阿巴瑟,3524,184,7,11,18,38.9%,26m
2869,2,kmday,3524,0,0,1,1,0.0%,23m
2872,1,[KPG2]星际迷航二号,3523,1710,95,93,188,50.5%,5m
2872,2,[你的剑很美]MSGA,3523,262,10,11,21,47.6%,20m
2872,2,机智的代数,3523,180,7,11,18,38.9%,32m
2872,2,Sundowner,3523,0,0,1,1,0.0%,30m
2876,2,[Fblood]打你妹,3522,1563,96,92,188,51.1%,19m
2876,1,llllllllll,3522,967,44,51,95,46.3%,5m
2876,2,鸡饲料,3522,300,9,13,22,40.9%,6m
2876,2,云玩家,3522,0,1,1,2,50.0%,35m
2876,2,[SK]胖胖的猪,3522,0,1,8,9,11.1%,23m
2876,2,含泪甩飞龙,3522,0,0,1,1,0.0%,4m
2882,2,[Borne]Vikingman,3521,681,25,28,53,47.2%,21m
2882,2,ArBITrary,3521,171,15,14,29,51.7%,19m
2882,2,园游会丶,3521,305,11,7,18,61.1%,30m
2882,2,黑骑,3521,194,10,6,16,62.5%,17m
2882,1,Rise,3521,46,2,1,3,66.7%,8m
2882,2,[STL]我是小菜鸟,3521,0,1,1,2,50.0%,35m
2882,2,[我们的奇迹]假面魔方,3521,0,0,1,1,0.0%,1m
2882,2,[2233娘]半裘梦,3521,0,0,1,1,0.0%,17m
2882,2,[津富会]irony,3521,0,0,1,1,0.0%,25m
2882,2,天龙,3521,0,0,2,2,0.0%,4m
2892,1,IIIIIIIIIIII,3520,1726,245,237,482,50.8%,7m
2892,2,[HUC轩辕]NICK,3520,1591,99,100,199,49.7%,17m
2892,2,迷失艾尔的小泽格,3520,666,28,21,49,57.1%,30m
2892,2,[DMR]死兆星,3520,595,23,18,41,56.1%,28m
2892,2,Gavin,3520,139,6,2,8,75.0%,7m
2892,2,llllllllllll,3520,164,5,2,7,71.4%,34m
2892,2,永远有多远,3520,30,2,3,5,40.0%,6m
2892,2,夜靥,3520,0,1,0,1,100.0%,39m
2892,2,新人关照,3520,0,1,0,1,100.0%,21m
2892,2,冬虫夏草,3520,0,1,2,3,33.3%,22m
2892,2,尼飞彼多,3520,0,1,2,3,33.3%,17m
2892,2,[我是菜比菜比]你的女王,3520,0,1,2,3,33.3%,32m
2892,2,lappsia,3520,0,0,1,1,0.0%,13m
2892,3,莫功,3520,0,0,1,1,0.0%,5m
2892,2,小展展,3520,0,0,2,2,0.0%,8m
2907,1,[Jesse]CarlyZ,3519,1757,186,176,362,51.4%,7m
2907,2,[沙漠疯豹]酱油,3519,408,73,53,126,57.9%,32m
2907,2,[KPG2]志希我老婆,3519,1543,70,62,132,53.0%,17m
2907,1,[基金会]滚呐,3519,911,36,41,77,46.8%,11m
2907,1,[文韬武略]绝影,3519,708,19,34,53,35.8%,9m
2907,3,苍蓝猛兽,3519,255,11,4,15,73.3%,31m
2907,2,MrLumingfei,3519,246,10,8,18,55.6%,28m
2907,2,IIIIIIIIIIII,3519,146,6,6,12,50.0%,6m
2907,2,过分丶迷恋,3519,0,5,0,5,100.0%,9m
2907,2,Addy,3519,58,3,1,4,75.0%,5m
2907,2,[月满亏水满溢]春江花月夜,3519,30,2,2,4,50.0%,3m
2907,2,[软萌甜小萝莉]MisterFrog,3519,0,0,1,1,0.0%,20m
2919,2,lllllllll,3518,1168,65,56,121,53.7%,21m
2919,2,[七咕咕]历史的见证者,3518,738,48,41,89,53.9%,29m
2919,2,没有名字的主角,3518,0,5,0,5,100.0%,8m
2919,2,[菜鸡球带]星海泛舟,3518,86,3,2,5,60.0%,30m
2919,2,[老油条死全家]我是彩笔别杀我,3518,0,0,2,2,0.0%,18m
2924,2,[四叶草]Faliscr,3517,1567,221,199,420,52.6%,13m
2924,2,陈总不说话,3517,357,17,8,25,68.0%,12m
2924,2,rampage,3517,176,7,7,14,50.0%,6m
2924,2,[拉稀]Aimer,3517,116,2,6,8,25.0%,6m
2924,2,[快乐幼儿园]花火花,3517,0,0,1,1,0.0%,23m
2929,1,[浪啊浪]QIRIIYUE,3516,1439,61,75,136,44.9%,34m
2929,2,[白给兄弟]QeLin,3516,524,41,28,69,59.4%,30m
2929,1,铅笔小健,3516,201,7,4,11,63.6%,31m
2929,2,aifao,3516,178,6,10,16,37.5%,39m
2929,2,鼓浪屿孙一峰,3516,58,3,0,3,100.0%,13m
2929,2,墨霜,3516,78,3,6,9,33.3%,20m
2929,2,[Icycry]DeathKnight,3516,0,0,1,1,0.0%,12m
2929,2,[心如死灰]stats,3516,0,0,1,1,0.0%,13m
2929,2,Wayne,3516,0,0,1,1,0.0%,32m
2938,2,烂柯人,3515,636,51,45,96,53.1%,21m
2938,2,不爱吃豆豆,3515,966,40,31,71,56.3%,32m
2938,2,木雨,3515,440,16,14,30,53.3%,21m
2938,1,[学姐赛高]野人一拳有多猛,3515,140,7,2,9,77.8%,5m
2938,2,[KKA1]Chost,3515,0,4,1,5,80.0%,6m
2938,2,[手残老年组]dreamdown,3515,88,4,3,7,57.1%,14m
2938,2,[Ginuna]汤糖躺烫,3515,60,2,1,3,66.7%,29m
2945,3,[一波]花飞扬,3514,232,11,4,15,73.3%,13m
2945,2,cure,3514,240,10,3,13,76.9%,21m
2945,1,[由我们重回]我只会神族,3514,0,5,1,6,83.3%,5m
2945,2,[喷射战士]LasTZerGGGG,3514,30,1,1,2,50.0%,34m
2945,2,ZzZz,3514,0,1,4,5,20.0%,11m
2945,2,[孙红雷]毳哥,3514,0,0,1,1,0.0%,22m
2945,2,korrey,3514,0,0,1,1,0.0%,39m
2945,2,[江南虫王]混元星际孙一峰,3514,0,0,1,1,0.0%,19m
2945,2,Rose,3514,0,0,1,1,0.0%,19m
2945,2,[抽爷]Eiros,3514,0,0,2,2,0.0%,6m
2955,2,[不凡]skyRF,3513,1649,447,422,869,51.4%,13m
2955,2,[我亲爱的对手]恶魔天使,3513,1506,113,104,217,52.1%,13m
2955,2,seeight,3513,432,15,16,31,48.4%,35m
2955,2,[点到为止]我们是害虫,3513,116,5,3,8,62.5%,6m
2955,2,[萝莉即是王道]提露密努斯艾斯特,3513,0,3,2,5,60.0%,27m
2955,2,[不可能那么萌]北方,3513,0,1,0,1,100.0%,23m
2955,2,[就硬莽]championsoO,3513,0,0,1,1,0.0%,26m
2955,2,酒中仙灬,3513,0,0,2,2,0.0%,19m
2963,2,onirii,3512,299,13,8,21,61.9%,17m
2963,2,[异乱]我是菜鸟,3512,70,4,6,10,40.0%,12m
2963,2,[小鸡屠宰场9]远期,3512,90,3,5,8,37.5%,13m
2963,2,moon,3512,0,1,0,1,100.0%,17m
2963,2,[这人是菜鸡]我是鸽手,3512,0,0,1,1,0.0%,32m
2963,3,[圆环之理教会]八重樱我老婆,3512,0,0,1,1,0.0%,10m
2969,2,[Hist]destiny,3511,1340,49,53,102,48.0%,13m
2969,2,没有智力就是瞎莽,3511,30,2,1,3,66.7%,26m
2969,2,鱼塘一渔夫,3511,92,2,1,3,66.7%,36m
2969,2,[Conque]MaloRNe,3511,0,1,0,1,100.0%,35m
2969,2,Learner,3511,0,0,1,1,0.0%,17m
2969,2,PurpleSoul,3511,0,0,1,1,0.0%,10m
2975,2,DavidWai,3510,853,143,131,274,52.2%,3m
2975,3,[瞧本FANS]瞧本哥哥好帅,3510,384,15,6,21,71.4%,9m
2975,2,MaggieYoung,3510,0,2,3,5,40.0%,33m
2975,2,Max,3510,73,0,2,2,0.0%,29m
2979,1,Ins,3509,1493,440,410,850,51.8%,8m
2979,2,Rask,3509,1215,75,63,138,54.3%,13m
2979,1,再带我集结一次吧,3509,962,30,46,76,39.5%,34m
2979,2,白夜星辰,3509,601,25,17,42,59.5%,39m
2979,3,月下舞清影,3509,163,5,1,6,83.3%,12m
2979,2,Vinci,3509,0,1,0,1,100.0%,6m
2979,2,llllllllllll,3509,0,1,2,3,33.3%,13m
2979,2,[永不放弃91]BurningAries,3509,0,0,1,1,0.0%,21m
2979,3,[李天逸强啊]Ayanami,3509,0,0,1,1,0.0%,28m
2988,2,LittlePrayer,3508,534,22,19,41,53.7%,28m
2988,2,[暴雪养鸡场]老年人休闲星际,3508,241,18,0,18,100.0%,35m
2990,2,IIIIIIIIII,3507,1156,70,44,114,61.4%,6m
2990,2,[丨SLT丨]不配赢人族,3507,1046,36,45,81,44.4%,12m
2990,2,Legato,3507,569,26,18,44,59.1%,4m
2990,2,llllllIIllIl,3507,101,6,5,11,54.5%,33m
2990,2,[NeXT]老虎舔蝴蝶,3507,0,5,0,5,100.0%,15m
2990,2,[腾杨天下]火焰鼠,3507,0,5,0,5,100.0%,30m
2990,2,不服就干,3507,86,3,2,5,60.0%,6m
2990,3,[RAJA]zeppelin,3507,0,0,1,1,0.0%,21m
2998,2,万事,3506,118,34,13,47,72.3%,5m
2998,2,[XYFANS]SLIMSHADY,3506,401,18,8,26,69.2%,33m
2998,2,[死亡收割]魅影,3506,256,10,4,14,71.4%,4m
2998,2,无奈的杰森,3506,30,1,1,2,50.0%,13m
2998,2,[叫醒我]纳兰性德,3506,30,1,1,2,50.0%,35m
2998,1,乌云一片,3506,0,0,1,1,0.0%,15m
3004,2,转转,3505,1303,282,287,569,49.6%,17m
3004,2,明月当空,3505,194,14,4,18,77.8%,23m
3004,2,IIIIIIIIIIII,3505,174,6,4,10,60.0%,25m
3004,2,牛旭蓬,3505,30,2,4,6,33.3%,30m
3004,2,[CNboi]刺眼蔷薇,3505,0,1,2,3,33.3%,11m
3004,2,[人菜灬瘾大]TinaAI,3505,0,0,1,1,0.0%,11m
3004,2,Fire,3505,0,0,2,2,0.0%,35m
3011,1,闲云野鹤,3504,1732,83,96,179,46.4%,32m
3011,2,SHUO,3504,1301,75,73,148,50.7%,20m
3011,2,IIIIIIIII,3504,593,25,19,44,56.8%,2m
3011,2,LostInAByss,3504,567,24,15,39,61.5%,6m
3011,2,新垣结衣,3504,318,19,26,45,42.2%,5m
3011,2,[sweetb]山沟里的风,3504,0,2,3,5,40.0%,17m
3011,2,[秋毫第七分队]BoPeeP,3504,0,1,2,3,33.3%,10m
3018,2,[火花骑士]兔兔伯爵,3503,1094,180,169,349,51.6%,39m
3018,2,YUKINO,3503,1259,165,151,316,52.2%,27m
3018,2,[浪啊浪]logo,3503,989,49,24,73,67.1%,4m
3018,2,[新手保护协会]余生阿迎,3503,719,35,31,66,53.0%,5m
3018,2,魔法虫族尿急王,3503,770,33,30,63,52.4%,12m
3018,2,DragonPaPa,3503,260,15,21,36,41.7%,5m
3018,2,[中南大学官网]乾坤深似海,3503,230,7,6,13,53.8%,4m
3018,2,MyOlogy,3503,0,1,0,1,100.0%,32m
3018,2,杜汶泽,3503,0,0,1,1,0.0%,17m
3018,2,[为了地球]风风风,3503,0,0,2,2,0.0%,35m
3028,2,[死亡收割]NOZVZ,3502,1508,152,150,302,50.3%,6m
3028,2,最终科技无限,3502,1044,47,31,78,60.3%,34m
3028,2,moemoe,3502,861,36,34,70,51.4%,27m
3028,2,因为我添腹一饼,3502,313,16,51,67,23.9%,31m
3028,2,[北极光小组]龙之神,3502,0,2,3,5,40.0%,33m
3028,2,[一波]珠海金城武,3502,0,0,1,1,0.0%,17m
3034,2,tigerhuxiao,3501,149,18,12,30,60.0%,5m
3034,2,虐死高手,3501,204,8,6,14,57.1%,17m
3034,2,风转竹门,3501,30,1,5,6,16.7%,35m
3034,2,奥西里斯,3501,0,0,1,1,0.0%,5m
3038,2,MacGuffin,3500,1542,131,128,259,50.6%,27m
3038,2,[despai]ChoseOwnLife,3500,259,9,8,17,52.9%,20m
3038,2,[刺蛇互助社团]Demons,3500,0,0,1,1,0.0%,27m
3041,2,[ZerinR]Moonlight,3499,1514,157,158,315,49.8%,20m
3041,2,Cooker,3499,1319,120,115,235,51.1%,21m
3041,2,大威天龙孙一峰,3499,1604,98,85,183,53.6%,33m
3041,2,Darker,3499,1566,98,90,188,52.1%,32m
3041,2,海妖出动,3499,251,29,28,57,50.9%,33m
3041,2,[我爱熊猫头]LightDragon,3499,30,1,5,6,16.7%,23m
3041,2,[SKTT3]爱萝莉,3499,0,0,1,1,0.0%,20m
3048,2,loner,3498,212,73,70,143,51.0%,25m
3048,2,一级响应,3498,283,13,12,25,52.0%,39m
3048,2,longzq,3498,0,0,1,1,0.0%,17m
3051,2,[嘤嘤樱]黑子,3497,1000,44,33,77,57.1%,29m
3051,2,草原狼,3497,348,16,9,25,64.0%,33m
3051,2,浮影掠过,3497,143,8,6,14,57.1%,21m
3051,3,郁闷些,3497,248,8,10,18,44.4%,23m
3051,2,卧龙岗王大锤,3497,92,3,9,12,25.0%,4m
3051,1,[Skt]定春与小流氓,3497,0,0,1,1,0.0%,2m
3051,2,[永不灭的战火]听风讲,3497,0,0,1,1,0.0%,28m
3051,2,[Shawk]一一,3497,0,0,1,1,0.0%,8m
3059,3,[KPG]喵内噶,3496,137,14,5,19,73.7%,25m
3060,2,kkDonkey,3495,514,19,22,41,46.3%,21m
3060,2,[丨SLT丨]假装是旁白白,3495,308,12,11,23,52.2%,32m
3060,2,[虫族最棒了]Zerg,3495,117,6,1,7,85.7%,10m
3060,2,osos,3495,0,1,0,1,100.0%,25m
3060,2,Madrior,3495,0,1,1,2,50.0%,4m
3060,2,太上忘情豆,3495,0,0,2,2,0.0%,14m
3066,2,AurorA,3494,1407,75,37,112,67.0%,32m
3066,2,谁再呼叫舰队,3494,30,2,1,3,66.7%,23m
3066,2,[芈芈]简约主义,3494,0,0,1,1,0.0%,17m
3066,2,软妹仙女酱,3494,0,0,1,1,0.0%,13m
3070,2,PrettyPhenix,3493,568,74,70,144,51.4%,12m
3070,2,[Hist]Rainbow,3493,283,9,16,25,36.0%,30m
3070,2,TTTTTTTTT,3493,171,8,7,15,53.3%,30m
3070,2,逼格之链第一人,3493,24,6,8,14,42.9%,6m
3070,2,[我菜我骄傲]酷拉玛,3493,0,0,1,1,0.0%,6m
3070,2,BOSS,3493,0,0,2,2,0.0%,19m
3076,2,老狗,3492,1567,369,337,706,52.3%,6m
3076,2,[Pimbaa]嘤嘤孙一峰你坏坏,3492,1378,90,71,161,55.9%,19m
3076,2,[名最好别太长]Attack,3492,916,43,43,86,50.0%,20m
3076,2,奇怪的虫族,3492,135,6,9,15,40.0%,25m
3076,2,SOS,3492,0,1,0,1,100.0%,32m
3076,2,[miku守护]Futech,3492,30,1,3,4,25.0%,21m
3082,2,老友记,3491,1574,152,152,304,50.0%,20m
3082,2,[白银联盟]star,3491,201,19,21,40,47.5%,11m
3082,2,金陵吕布,3491,204,8,10,18,44.4%,4m
3082,2,[DMR]掌管小鸡群,3491,58,3,5,8,37.5%,32m
3082,2,MrKiKo,3491,0,0,1,1,0.0%,25m
3082,2,sunwuk,3491,0,0,1,1,0.0%,35m
3088,2,东哥,3490,1259,155,151,306,50.7%,14m
3088,2,大魔王,3490,1492,124,102,226,54.9%,34m
3088,2,[七咕咕]Linus,3490,1466,53,64,117,45.3%,23m
3088,2,llllll,3490,330,12,9,21,57.1%,30m
3088,2,[西南风]Mapleleaf,3490,166,6,1,7,85.7%,6m
3088,2,星河之翼,3490,0,4,0,4,100.0%,29m
3088,1,龙之心,3490,119,3,7,10,30.0%,31m
3088,2,[彡基佬之家]玩笑,3490,30,1,1,2,50.0%,28m
3088,2,[KPG2]做个幸福的神族,3490,30,1,2,3,33.3%,13m
3088,2,[HustSC]JokerGreed,3490,0,0,1,1,0.0%,3m
3088,2,天河望舒,3490,0,0,1,1,0.0%,4m
3099,2,[BadM]franklo,3489,1390,242,237,479,50.5%,3m
3099,2,[LDP]玩玩,3489,383,15,18,33,45.5%,13m
3099,2,Fantasy,3489,164,4,3,7,57.1%,21m
3099,2,风城玫瑰,3489,114,3,1,4,75.0%,17m
3099,2,[星云际会]时光蓑湿,3489,0,0,1,1,0.0%,20m
3099,2,那一战的温柔,3489,0,0,1,1,0.0%,23m
3105,2,亚太天能指纹锁,3488,1563,207,190,397,52.1%,35m
3105,2,Mihai,3488,306,55,39,94,58.5%,35m
3105,2,[JPS]神棍德,3488,846,30,34,64,46.9%,35m
3105,2,[童话小镇]hydrallsks,3488,409,20,11,31,64.5%,28m
3105,1,imkoni,3488,185,9,3,12,75.0%,17m
3105,2,[洛水伊人]暗夜亡灵族,3488,202,8,8,16,50.0%,35m
3105,1,ChangedF,3488,48,1,1,2,50.0%,24m
3112,2,无梦灬生,3487,30,1,2,3,33.3%,25m
3112,3,JACKEY,3487,0,0,1,1,0.0%,36m
3114,2,坚定淡定,3486,1569,628,612,1240,50.6%,12m
3114,2,六竹,3486,1552,88,81,169,52.1%,32m
3114,2,XiaoXiao,3486,939,67,57,124,54.0%,25m
3114,2,ghgiugiu,3486,1106,43,44,87,49.4%,35m
3114,2,黛殇酱,3486,433,18,13,31,58.1%,32m
3114,2,simon,3486,182,6,3,9,66.7%,25m
3114,2,Berlinsyf,3486,160,4,3,7,57.1%,12m
3114,2,[丹东男神天团]丹东大老肥,3486,90,3,5,8,37.5%,25m
3114,2,[哔翻天梯鸡]Dobby,3486,30,2,2,4,50.0%,35m
3123,2,[三体]破壁人,3485,592,22,20,42,52.4%,17m
3123,2,hyfxiaohao,3485,266,11,7,18,61.1%,21m
3123,2,[百年老店]巭孬嫑夯昆,3485,0,5,0,5,100.0%,3m
3123,3,[LDP]gclhfjk,3485,0,1,1,2,50.0%,21m
3123,2,Eternal,3485,88,1,9,10,10.0%,24m
3123,2,Lapland,3485,0,0,1,1,0.0%,30m
3129,2,[软泥怪大团圆]黏糊糊的软泥怪,3484,601,51,8,59,86.4%,21m
3129,2,[小小合作任务]Robert,3484,276,17,9,26,65.4%,13m
3129,2,llllllllllll,3484,0,1,1,2,50.0%,32m
3129,2,无尽的争斗,3484,0,1,2,3,33.3%,24m
3133,2,Dreamflsh,3483,1063,180,154,334,53.9%,39m
3133,2,Rys,3483,1090,50,36,86,58.1%,39m
3133,3,[eStRO]消逝的瞬间,3483,301,13,8,21,61.9%,35m
3133,2,叫兽,3483,337,13,8,21,61.9%,28m
3133,2,[IMRTS]Mmyue,3483,88,4,6,10,40.0%,21m
3138,2,[老油条战队4]牛的很,3482,1553,100,106,206,48.5%,23m
3138,2,[SoloAs]白泽,3482,548,27,18,45,60.0%,21m
3138,2,mhvhm,3482,168,19,9,28,67.9%,33m
3138,2,[一盒峰我大哥]Lunar,3482,492,18,15,33,54.5%,25m
3138,2,舞幻,3482,318,12,8,20,60.0%,17m
3138,1,[琦琦宝儿]佐仓杏子,3482,96,2,1,3,66.7%,23m
3138,2,嘤嘤嘤孙一峰你坏,3482,0,1,0,1,100.0%,13m
3138,2,魔天,3482,88,1,1,2,50.0%,4m
3138,2,[星际恶霸]Kojer,3482,0,0,1,1,0.0%,19m
3138,2,凤凰院番茄,3482,0,0,1,1,0.0%,11m
3148,2,[埃辛诺斯战刃]机械化怎么打哦,3481,90,4,0,4,100.0%,13m
3148,2,湮灭,3481,0,1,0,1,100.0%,13m
3148,3,[BRN卡路里]卡尔维诺,3481,0,1,0,1,100.0%,17m
3148,2,IIIIIIIIIIII,3481,0,1,0,1,100.0%,18m
3148,2,[菜的没人带]宫泽有纪宁,3481,0,1,1,2,50.0%,29m
3153,1,姐夫,3480,1727,1175,1182,2357,49.9%,18m
3153,2,[今晚谁是鸡]小热狗,3480,1496,156,144,300,52.0%,28m
3153,2,IIIIIIIIIIII,3480,1605,140,141,281,49.8%,23m
3153,2,南泽泉理,3480,747,75,82,157,47.8%,14m
3153,2,kusotori,3480,847,37,29,66,56.1%,39m
3153,2,IIIIIIIIIIII,3480,142,6,7,13,46.2%,3m
3153,2,神域小胖,3480,30,2,2,4,50.0%,30m
3160,2,小小枪兵,3479,1044,55,30,85,64.7%,7m
3160,2,alex,3479,60,2,3,5,40.0%,3m
3160,2,Luka,3479,30,1,2,3,33.3%,30m
3160,2,[最弱的玩家]死神,3479,0,1,2,3,33.3%,30m
3160,2,粉眸懒猫,3479,0,0,1,1,0.0%,28m
3160,2,[Borne]孙哥与黄哥的浪漫,3479,0,0,1,1,0.0%,7m
3160,2,IIIIIII,3479,0,0,1,1,0.0%,32m
3167,2,妖怪,3478,1333,172,164,336,51.2%,17m
3167,2,sarah,3478,1558,154,151,305,50.5%,35m
3167,2,[折翼丿天使灬]evilangel,3478,728,33,21,54,61.1%,21m
3167,1,RedMoon,3478,262,11,1,12,91.7%,3m
3167,2,shadowking,3478,60,3,4,7,42.9%,21m
3167,2,CAL,3478,88,1,1,2,50.0%,17m
3167,2,[Anticw]SeeKfaithman,3478,0,0,5,5,0.0%,22m
3174,2,卡卡西,3477,829,66,63,129,51.2%,12m
3174,2,Dieprinzen,3477,868,64,41,105,61.0%,23m
3174,2,哈密瓜叔叔,3477,276,10,20,30,33.3%,35m
3174,1,[郭家桥四大天]宾克斯的美酒,3477,183,8,2,10,80.0%,25m
3174,2,Stark,3477,180,7,2,9,77.8%,21m
3174,3,Emerson,3477,199,6,6,12,50.0%,6m
3174,2,Terran,3477,30,2,2,4,50.0%,21m
3174,2,[永远的平安京]历战王临光,3477,0,1,0,1,100.0%,27m
3174,2,[星河气象学院]littleforest,3477,95,1,1,2,50.0%,23m
3174,2,[七咕咕]Ulysses,3477,0,1,3,4,25.0%,30m
3174,2,[暴雪我是你爹]德日天,3477,0,0,1,1,0.0%,20m
3174,2,dogjk,3477,0,0,1,1,0.0%,21m
3174,3,[单人模拟战]新手电脑,3477,0,0,1,1,0.0%,19m
3174,2,[BGD]再见了宋哈娜,3477,0,0,2,2,0.0%,6m
3188,2,[闪电伍连鞭]你伟大的爹,3476,1577,862,840,1702,50.6%,17m
3188,2,[节操]ilkd,3476,1623,246,243,489,50.3%,23m
3188,2,[请叫我萌本]我儿子爱造航母,3476,1225,74,61,135,54.8%,2m
3188,1,[扬州名字要长]怒怒,3476,1463,70,103,173,40.5%,11m
3188,2,BlueCatGG,3476,648,61,42,103,59.2%,25m
3188,2,旭东黄,3476,420,17,12,29,58.6%,3m
3188,2,Johnson,3476,128,13,7,20,65.0%,19m
3188,2,[暴雪我是你爹]RangerX,3476,200,7,10,17,41.2%,8m
3188,2,IIIIIIIII,3476,120,6,7,13,46.2%,6m
3188,2,[CRSC2]Crazedzerg,3476,116,3,1,4,75.0%,19m
3198,2,野蛮的包子,3475,612,22,20,42,52.4%,32m
3198,2,[龙姐姐真棒]空投小王子,3475,397,18,9,27,66.7%,32m
3198,2,高精,3475,482,18,22,40,45.0%,32m
3198,2,[C91509]兰哥,3475,169,8,15,23,34.8%,17m
3198,2,[极限菜鸟]TUSKIN,3475,102,3,0,3,100.0%,8m
3198,2,[OYE]糖果,3475,58,2,3,5,40.0%,20m
3198,2,[别一波丶疼]有本事拼运营,3475,0,0,1,1,0.0%,20m
3205,2,prettydt,3474,1588,177,170,347,51.0%,6m
3205,2,qwmunyvr,3474,700,30,37,67,44.8%,28m
3205,2,年轻人耗子尾汁,3474,523,24,13,37,64.9%,3m
3205,2,[美少年组合]IIIIIIIIIIII,3474,555,21,19,40,52.5%,39m
3205,2,oGsMC,3474,370,14,17,31,45.2%,25m
3205,2,[探机反恐联盟]gamelife,3474,0,0,1,1,0.0%,2m
3205,2,[bnuphy]ggboud,3474,0,0,1,1,0.0%,12m
3212,2,[浪啊浪]忘记你需要多久,3473,1048,53,35,88,60.2%,5m
3212,2,Say,3473,371,15,10,25,60.0%,20m
3212,2,点到为止,3473,161,7,2,9,77.8%,23m
3212,2,[无敌青铜]我呆呆兽打死你们,3473,0,0,1,1,0.0%,12m
3216,2,[暴雪我是你爹]瑞小鼠,3472,1620,161,160,321,50.2%,35m
3216,2,happyend,3472,582,21,20,41,51.2%,6m
3216,2,[OIO]蚂菲亚,3472,331,12,9,21,57.1%,32m
3216,3,Stella,3472,193,6,7,13,46.2%,30m
3216,2,浮华一场不过游戏,3472,130,5,1,6,83.3%,20m
3216,2,[DMR]我玩虫族只换家,3472,143,5,2,7,71.4%,35m
3216,2,[黄漫老师]Raven,3472,0,0,1,1,0.0%,17m
3223,2,willian,3471,1592,225,207,432,52.1%,33m
3223,3,明道若昧,3471,262,11,5,16,68.8%,11m
3223,2,[神圣刘毅天国]研究生,3471,298,10,12,22,45.5%,6m
3223,2,[星际永不为奴]完结的电锯,3471,0,1,0,1,100.0%,8m
3223,2,[棉花种植合作]Hydralisk,3471,0,0,2,2,0.0%,3m
3228,2,呆头灰鸟,3470,490,17,24,41,41.5%,28m
3228,2,[洁白之巅]IIIIIIIIIIII,3470,244,9,11,20,45.0%,7m
3228,2,[斗鱼丶冰尘阁]低语,3470,58,7,7,14,50.0%,6m
3228,1,泪木偶,3470,118,4,5,9,44.4%,20m
3228,2,[星辰之海]SoChel,3470,88,1,2,3,33.3%,33m
3228,2,虫子,3470,88,1,2,3,33.3%,13m
3228,2,[Beasty]白衣夜歌行丶,3470,18,1,7,8,12.5%,12m
3235,2,[同济大学]长门秘书舰,3469,1393,60,46,106,56.6%,5m
3235,2,[暴雪十四队]出言吐词,3469,956,35,36,71,49.3%,21m
3235,2,DIESWZ,3469,322,22,10,32,68.8%,13m
3235,2,Cypress,3469,182,7,2,9,77.8%,17m
3235,2,[DMRc]紫色,3469,136,6,7,13,46.2%,6m
3235,2,[星歌]Akira,3469,0,1,0,1,100.0%,30m
3235,2,哈斯卡武士,3469,0,0,1,1,0.0%,17m
3242,2,[浙江大学战队]混元星际掌门人,3468,546,24,16,40,60.0%,17m
3242,2,[VKR]西湖底的二五仔,3468,102,3,0,3,100.0%,39m
3242,2,莽汉亲你的小菊花,3468,60,3,5,8,37.5%,27m
3242,2,福利路小霸王,3468,30,2,1,3,66.7%,13m
3242,2,[forSAT]天下一斤,3468,0,1,2,3,33.3%,14m
3242,2,老象小象小小象,3468,0,0,1,1,0.0%,27m
3242,2,[沧月女装协会]神宫司玉藻,3468,0,0,2,2,0.0%,21m
3249,2,我到河北省来,3467,1588,237,222,459,51.6%,29m
3249,1,[ZAS]Thymus,3467,1652,112,124,236,47.5%,25m
3249,1,缪染,3467,227,11,2,13,84.6%,35m
3249,2,IIIIIIIIIIII,3467,187,11,9,20,55.0%,32m
3249,2,神族没妈真可怜,3467,238,9,12,21,42.9%,5m
3249,2,[战略轰炸鸡]哼哼哈嘿,3467,116,4,1,5,80.0%,13m
3249,2,星际霸爸,3467,58,3,2,5,60.0%,27m
3249,3,[SCLR]loner,3467,30,2,0,2,100.0%,9m
3249,2,一般性与大众性,3467,30,1,2,3,33.3%,17m
3258,2,[SWUST灬]Justman,3466,847,37,27,64,57.8%,17m
3258,3,[黄漫老师]上白泽慧音,3466,431,16,3,19,84.2%,21m
3258,2,守夜人,3466,30,2,2,4,50.0%,3m
3261,2,sfhdsuo,3465,1531,945,951,1896,49.8%,28m
3261,2,[北极光小组]Sam,3465,472,19,19,38,50.0%,23m
3261,3,[电脑难度]专家,3465,136,11,6,17,64.7%,24m
3261,2,谐星鬼王,3465,176,6,3,9,66.7%,35m
3261,2,[等待四月]IIIIIIIIIIII,3465,139,6,6,12,50.0%,23m
3261,2,写字,3465,58,3,4,7,42.9%,3m
3261,3,[老司机翻船]魔天,3465,0,1,0,1,100.0%,22m
3261,3,[不爽就干]水月年华,3465,0,1,0,1,100.0%,4m
3261,3,[攻略团]魔法少女沃拉尊,3465,0,1,0,1,100.0%,21m
3261,3,七七,3465,0,1,0,1,100.0%,27m
3261,3,Bbaucl,3465,0,0,1,1,0.0%,19m
3261,2,[最后的蟑螂]光明与黑暗,3465,0,0,2,2,0.0%,21m
3273,2,[战神]KadourZiani,3464,640,54,57,111,48.6%,14m
3273,2,冬马丶和纱,3464,302,18,4,22,81.8%,3m
3273,2,[练不出来啊]现役男子小学生,3464,454,16,18,34,47.1%,13m
3273,2,Ckira,3464,410,15,16,31,48.4%,13m
3273,2,dovetoo,3464,206,8,4,12,66.7%,35m
3273,2,永远爱潇潇,3464,229,8,6,14,57.1%,20m
3273,2,浪漫老掊哥,3464,0,0,2,2,0.0%,6m
3280,2,[Metro]翡翠独享,3463,998,292,261,553,52.8%,19m
3280,2,苦瓜,3463,1076,187,163,350,53.4%,25m
3280,2,SoSo,3463,1589,129,119,248,52.0%,29m
3280,2,最强生物卡兹,3463,1254,52,44,96,54.2%,29m
3280,2,llllllllllll,3463,548,19,27,46,41.3%,24m
3280,2,BRBLMD,3463,158,6,19,25,24.0%,7m
3280,1,[䋯䋯䋯]AEtaTISnovAE,3463,185,5,6,11,45.5%,16m
3280,1,殴鸡酱,3463,139,4,2,6,66.7%,24m
3280,2,Immortal,3463,114,3,2,5,60.0%,35m
3280,3,[Miku骑士]都市天际线玩家,3463,30,2,1,3,66.7%,13m
3280,2,[TeamCD]星陨凡尘,3463,0,1,0,1,100.0%,9m
3280,3,zzy,3463,0,0,1,1,0.0%,2m
3292,2,[社交学讲师]亵渎,3462,1558,94,94,188,50.0%,6m
3292,2,[刺蛇单推协会]天行,3462,676,31,20,51,60.8%,39m
3292,2,白菜菜,3462,408,21,10,31,67.7%,39m
3292,2,IIIIIIIIIIII,3462,446,18,20,38,47.4%,32m
3292,2,我的比你大,3462,420,15,13,28,53.6%,23m
3292,3,[Aaron]阿荣,3462,306,13,3,16,81.2%,3m
3292,3,[黄漫老师]东风谷早苗,3462,0,1,0,1,100.0%,3m
3292,2,[Brust]剪子卖萌,3462,0,0,3,3,0.0%,32m
3300,2,[入侵地球]农夫三拳有点疼,3461,919,198,181,379,52.2%,23m
3300,2,[i5]DarkArchon,3461,180,6,4,10,60.0%,8m
3302,2,[KPG2]队长别开枪是我,3460,1427,233,232,465,50.1%,17m
3302,2,我是一只鸡,3460,1640,211,198,409,51.6%,39m
3302,3,不懂浪漫,3460,222,11,9,20,55.0%,24m
3302,2,[BUPTNB]JInAirRouge,3460,0,4,4,8,50.0%,19m
3302,2,[EtdNew]peter,3460,88,1,2,3,33.3%,28m
3302,3,[QFD]Discord,3460,0,0,1,1,0.0%,1m
3308,2,罪之骸髓,3459,819,101,104,205,49.3%,12m
3308,2,Gameworldboy,3459,1199,55,66,121,45.5%,13m
3308,2,[LIDP]云紫宝贝,3459,696,24,35,59,40.7%,17m
3308,2,[尤摩扬禁卫军]不开矿怎么爆兵,3459,346,13,17,30,43.3%,28m
3308,2,张了个村,3459,186,6,12,18,33.3%,32m
3308,2,沈梦欣的地心引力,3459,192,5,6,11,45.5%,20m
3308,3,[我们都是铁头]艾尔之子,3459,0,3,6,9,33.3%,23m
3308,3,[中华兄弟会]我和黄哥击剑,3459,0,0,1,1,0.0%,33m
3308,3,阿丽米热,3459,0,0,1,1,0.0%,7m
3317,2,结城明日奈,3458,1558,121,104,225,53.8%,30m
3317,2,查尔的星空,3458,620,33,41,74,44.6%,20m
3317,2,秋月爱莉,3458,94,20,8,28,71.4%,23m
3317,2,zzztj,3458,371,17,9,26,65.4%,23m
3317,2,[浐灞孙一峰]阿布大魔王,3458,182,7,8,15,46.7%,35m
3322,2,llllllllllll,3457,618,31,32,63,49.2%,23m
3322,2,[首义学院]我还需要一个探姬,3457,720,27,29,56,48.2%,2m
3322,3,[苍青色的幻影]湛蓝水晶,3457,0,1,0,1,100.0%,34m
3322,2,[哔哩哔哩乾杯]艾尔必将光复,3457,0,1,0,1,100.0%,7m
3322,3,[NEUer]Weirdo,3457,0,0,1,1,0.0%,21m
3322,1,ByuN,3457,0,0,1,1,0.0%,20m
3322,2,[舔无止境]国士无双吕奉先,3457,0,0,3,3,0.0%,33m
3329,2,PrincipalZ,3456,348,12,11,23,52.2%,6m
3329,2,Triste,3456,133,12,15,27,44.4%,10m
3329,2,Cloudymoon,3456,318,11,18,29,37.9%,32m
3329,3,herO,3456,0,3,2,5,60.0%,15m
3329,3,SeRral,3456,0,1,0,1,100.0%,34m
3329,2,Fus,3456,0,1,3,4,25.0%,33m
3329,3,余钱两千块,3456,0,0,1,1,0.0%,2m
3336,2,faint,3455,600,27,24,51,52.9%,30m
3336,2,[目標諾森德]两面宿傩第一手,3455,112,3,2,5,60.0%,17m
3336,2,小福报,3455,126,3,4,7,42.9%,20m
3336,2,天梯马保国,3455,30,2,2,4,50.0%,2m
3336,2,white,3455,30,2,2,4,50.0%,30m
3336,3,[MostAI]Forgave,3455,0,1,0,1,100.0%,15m
3336,3,[Holydr]Blaylock,3455,0,0,1,1,0.0%,21m
3336,3,[YMSB]robin,3455,0,0,1,1,0.0%,16m
3344,2,[Beasty]SoyaSauce,3454,750,38,25,63,60.3%,3m
3344,2,llllllllllll,3454,162,5,0,5,100.0%,4m
3344,2,realifox,3454,140,3,4,7,42.9%,20m
3344,2,[谁在呼叫舰队]IIIIIIIIIIII,3454,60,2,4,6,33.3%,20m
3344,3,船长,3454,0,0,1,1,0.0%,13m
3349,2,[别脱人家内内]注意看我的眼神,3453,556,39,46,85,45.9%,3m
3349,2,save,3453,442,15,17,32,46.9%,28m
3349,2,马达加斯加甴曱,3453,248,13,15,28,46.4%,6m
3349,3,[菜有菜的道理]IIIIIIII,3453,314,12,9,21,57.1%,31m
3349,2,有什么冲我来,3453,268,10,13,23,43.5%,30m
3349,2,[lmbaP]相馬一也,3453,202,7,5,12,58.3%,13m
3349,2,面包与星际,3453,0,5,1,6,83.3%,24m
3349,3,WenZIc,3453,0,3,1,4,75.0%,10m
3357,2,[堡垒混子]奶妈洗衣粉,3452,1528,142,135,277,51.3%,21m
3357,1,[第八舰队丶]Kingdom,3452,1717,93,100,193,48.2%,18m
3357,3,[一颗赛艇]消失的海岸线,3452,30,1,1,2,50.0%,3m
3357,2,CowiNdeR,3452,30,1,3,4,25.0%,19m
3357,3,[CnNami]KillerElite,3452,0,0,1,1,0.0%,17m
3357,2,晖哥传说,3452,0,0,1,1,0.0%,32m
3363,2,柠天空,3451,1481,166,177,343,48.4%,10m
3363,2,困困困困困,3451,921,83,51,134,61.9%,28m
3363,1,[TNLtr]DevilToKing,3451,1293,43,58,101,42.6%,20m
3363,3,野生丶凹凸曼,3451,752,30,20,50,60.0%,21m
3363,2,马本座出狱,3451,571,24,23,47,51.1%,32m
3363,3,[lSCVl]zxxy,3451,169,4,5,9,44.4%,27m
3363,2,小虫子,3451,60,3,4,7,42.9%,23m
3363,3,[略萌]RaiQian,3451,30,2,0,2,100.0%,34m
3363,3,[萝莉扎加拉]风影丶,3451,0,0,1,1,0.0%,7m
3363,2,[GAGA]magejizerg,3451,0,0,2,2,0.0%,27m
3373,2,可以死,3450,1438,144,123,267,53.9%,32m
3373,2,IIIIIIII,3450,598,22,25,47,46.8%,17m
3373,2,[萌新在下挨打]二次猿生态研究者,3450,86,3,3,6,50.0%,32m
3373,3,[MUL]风吹的猫助,3450,0,1,0,1,100.0%,2m
3377,2,钻石做的渣渣,3449,650,29,18,47,61.7%,4m
3377,2,[四叶草]明理知秋,3449,709,28,24,52,53.8%,35m
3377,2,一叶知秋,3449,364,18,7,25,72.0%,35m
3377,2,[马氏太极拳]MoonKesin,3449,323,14,8,22,63.6%,25m
3377,3,[HEX]hexagram,3449,0,1,0,1,100.0%,31m
3377,3,[一戳一蹦跶]桃子,3449,0,0,1,1,0.0%,8m
3383,2,[KPL1vc]贝伦卡斯泰露,3448,756,35,32,67,52.2%,20m
3383,2,[柳叶刀]苍之雪痕,3448,938,31,47,78,39.7%,35m
3383,2,Thyme,3448,272,10,13,23,43.5%,5m
3383,2,爷傲丿奈我何,3448,175,8,2,10,80.0%,35m
3383,3,[LDP]Tmiole,3448,86,3,1,4,75.0%,19m
3383,3,[我们是无敌的]DictaTors,3448,30,2,1,3,66.7%,22m
3383,3,[合作拆迁队]小肥羊,3448,0,0,1,1,0.0%,35m
3390,2,YUSOBAD,3447,1148,45,42,87,51.7%,2m
3390,2,[随性琐欲]独角仙,3447,193,8,3,11,72.7%,13m
3390,1,[巨像吊炸天]手撕酱,3447,0,0,1,1,0.0%,35m
3393,3,IceTea,3446,224,10,4,14,71.4%,24m
3393,2,[tsnclf]ztpwp,3446,224,8,9,17,47.1%,21m
3393,3,[re艾米莉亚]始末之光,3446,0,1,0,1,100.0%,8m
3396,2,比我秒的快闹哪样,3445,1148,48,44,92,52.2%,7m
3396,3,IIIIIIIIIII,3445,681,29,23,52,55.8%,24m
3396,2,[传说萌娘团]Flood,3445,584,25,16,41,61.0%,7m
3396,2,[我队伍很强大]立华奏我老婆,3445,154,5,3,8,62.5%,17m
3396,3,搭不搭,3445,30,1,3,4,25.0%,23m
3396,3,[KK开]kzqj,3445,0,0,1,1,0.0%,11m
3396,3,[打星际快乐么]LiArRn,3445,0,0,3,3,0.0%,3m
3403,2,[SCer]xiaoxiao,3444,1571,200,198,398,50.3%,27m
3403,2,桥言,3444,1329,152,129,281,54.1%,30m
3403,2,[暴雪我是你爹]进攻型门将,3444,1390,56,53,109,51.4%,34m
3403,3,lhp,3444,410,15,20,35,42.9%,22m
3403,2,[大鸟转转转]unnerf,3444,58,3,4,7,42.9%,7m
3403,2,无名,3444,58,2,5,7,28.6%,33m
3409,2,小满,3443,1431,99,95,194,51.0%,33m
3409,2,ArSonMan,3443,790,75,84,159,47.2%,4m
3409,3,ZooIGhost,3443,651,43,29,72,59.7%,22m
3409,2,oooooooo,3443,442,21,15,36,58.3%,3m
3409,2,初初,3443,210,7,11,18,38.9%,19m
3409,3,大野智,3443,88,4,2,6,66.7%,14m
3409,2,[查尔之矛]风律,3443,60,2,5,7,28.6%,6m
3409,3,灵魂猎手,3443,0,0,1,1,0.0%,9m
3409,2,[薄暮之光]amaplay,3443,0,0,2,2,0.0%,39m
3418,2,[hd5v5]开黑日记,3442,1102,214,186,400,53.5%,3m
3418,2,[NVKR]虫族肄业生,3442,1426,119,87,206,57.8%,39m
3418,2,[跟你好好运营]陈激动再玩一盘,3442,1543,104,83,187,55.6%,6m
3418,2,[gusl]PrinCess,3442,490,18,18,36,50.0%,25m
3418,2,iiiiiiiiiii,3442,256,9,9,18,50.0%,20m
3418,2,[BGD]dream,3442,204,8,9,17,47.1%,24m
3418,3,IIIIIIIIIIII,3442,0,0,1,1,0.0%,4m
3425,2,IIIIIIIIIII,3441,115,6,1,7,85.7%,21m
3425,2,店长,3441,126,4,2,6,66.7%,21m
3425,3,前排坦克孙迪娃,3441,30,2,0,2,100.0%,15m
3425,3,超级无敌帅小鸡,3441,0,0,1,1,0.0%,5m
3429,3,[CNboys]血色蔷薇,3440,308,13,9,22,59.1%,32m
3429,2,[SK]ZerO,3440,224,9,9,18,50.0%,19m
3429,2,[東佰往事]泛希腊太守,3440,206,7,6,13,53.8%,6m
3432,2,芬妮不是一,3439,1614,95,99,194,49.0%,11m
3432,2,[壮哉萌]zhan,3439,1135,64,45,109,58.7%,7m
3432,2,zergling,3439,368,13,14,27,48.1%,3m
3432,2,[死亡战队]影杀,3439,141,4,4,8,50.0%,30m
3432,2,[RUBE]Tango,3439,30,2,4,6,33.3%,6m
3432,2,[光光6]闪光亚丝娜,3439,112,2,4,6,33.3%,6m
3432,3,肖爸爸给你的绿帽,3439,0,1,0,1,100.0%,16m
3432,3,[NLD]APS,3439,0,1,0,1,100.0%,7m
3432,1,[幻想崩坏]娜丽塔雅,3439,46,1,1,2,50.0%,3m
3432,3,[星戰同盟會]清风无痕,3439,0,0,1,1,0.0%,10m
3442,2,孙一喵,3438,1310,125,107,232,53.9%,23m
3442,2,[水师主教之刃]一曲未竟东方白,3438,529,21,22,43,48.8%,30m
3442,2,[天马流星狗]皇后大道东,3438,526,19,23,42,45.2%,33m
3442,3,ForsakenSoul,3438,144,5,6,11,45.5%,34m
3442,3,莎拉凯瑞肝,3438,0,0,1,1,0.0%,36m
3447,2,八斤,3437,1593,288,284,572,50.3%,33m
3447,2,sampro,3437,1368,194,190,384,50.5%,4m
3447,2,MtAsFlash,3437,332,13,10,23,56.5%,30m
3447,2,[龙湖战队]龙湖之都,3437,0,0,1,1,0.0%,21m
3447,3,赵小墨,3437,0,0,1,1,0.0%,8m
3452,1,Leon,3436,1487,141,147,288,49.0%,6m
3452,2,[我们是无敌的]watch,3436,673,23,31,54,42.6%,19m
3452,1,[指尖奶茶]池田小雪,3436,136,8,5,13,61.5%,7m
3452,2,[Davi]三岁,3436,114,5,9,14,35.7%,6m
3452,2,FeE,3436,120,4,7,11,36.4%,36m
3452,3,荒漠残阳,3436,0,0,1,1,0.0%,36m
3452,3,树上的男爵,3436,0,0,2,2,0.0%,19m
3459,2,satiety,3435,633,36,35,71,50.7%,30m
3459,2,红枫,3435,694,25,30,55,45.5%,27m
3459,3,球杆,3435,285,13,7,20,65.0%,28m
3459,3,泪落在梦中,3435,180,6,2,8,75.0%,12m
3459,2,[LvFer]花语黛香,3435,0,5,1,6,83.3%,21m
3459,3,[慢手e族]IIIIIIIIIIII,3435,86,4,1,5,80.0%,14m
3459,3,[mantis]天灾刺蛇,3435,30,2,0,2,100.0%,10m
3459,3,[在鹿上]ARC,3435,30,2,1,3,66.7%,9m
3459,1,[GAC]夜黑风搞,3435,0,1,2,3,33.3%,7m
3468,2,[Eve联盟]中老年妇女之友,3434,1575,81,78,159,50.9%,20m
3468,2,我只吃熊猫,3434,392,14,18,32,43.8%,12m
3468,2,故乡的原风景,3434,102,3,2,5,60.0%,35m
3468,3,PTimba,3434,30,1,2,3,33.3%,2m
3472,2,[战场原荡漾丶]我得重新集结部队,3433,547,56,43,99,56.6%,35m
3472,2,SoO,3433,1154,44,48,92,47.8%,17m
3472,2,Mrlin,3433,418,16,16,32,50.0%,13m
3472,2,蔚蓝之海,3433,382,15,12,27,55.6%,17m
3472,2,玊玉,3433,0,5,1,6,83.3%,4m
3472,2,ZHY,3433,30,1,5,6,16.7%,17m
3472,3,[丨SLT丨]llllllllllll,3433,0,0,1,1,0.0%,21m
3479,2,[核平宇宙]冠状毒爆虫,3432,1562,313,299,612,51.1%,24m
3479,3,LYQQ,3432,392,22,13,35,62.9%,8m
3479,2,[GAGA]清泉石上流,3432,232,7,18,25,28.0%,25m
3479,3,wcaocao,3432,143,6,2,8,75.0%,36m
3479,2,[羊驼羊驼羊]Poca,3432,194,6,6,12,50.0%,10m
3479,3,[最菜战队]纯新手,3432,140,5,5,10,50.0%,15m
3479,2,[青铜树]GAMEKING,3432,84,4,9,13,30.8%,33m
3479,3,沐源晨歌,3432,0,1,0,1,100.0%,21m
3479,3,[Star丶P]Leviathan,3432,30,1,2,3,33.3%,13m
3488,2,[NUAA]BfMoSang,3431,598,21,26,47,44.7%,20m
3488,3,酷酷,3431,497,20,14,34,58.8%,32m
3488,2,ccac,3431,32,9,16,25,36.0%,10m
3488,3,[我菜啊]你爹临死前,3431,0,1,0,1,100.0%,20m
3488,3,[沙漠天团]白羊神经男,3431,30,1,1,2,50.0%,25m
3488,3,Cardamine,3431,30,1,3,4,25.0%,25m
3488,3,cocoon,3431,0,0,1,1,0.0%,34m
3495,2,鸡冠,3430,0,1,3,4,25.0%,24m
3495,3,带把的核桃,3430,0,0,1,1,0.0%,18m
3495,2,Composure,3430,0,0,3,3,0.0%,28m
3498,2,[帅哥之家]starhu,3429,1449,279,277,556,50.2%,33m
3498,2,Rain,3429,1184,125,113,238,52.5%,20m
3498,2,心念不肯改,3429,1503,117,115,232,50.4%,23m
3498,2,杨乐辰,3429,769,70,55,125,56.0%,17m
3498,2,kirtio,3429,135,11,6,17,64.7%,17m
3498,3,NSIN,3429,0,5,0,5,100.0%,6m
3498,2,beieifjs,3429,0,0,1,1,0.0%,16m
3505,2,WBYYing,3428,1405,85,71,156,54.5%,7m
3505,2,[傻憋死QJ]Foever,3428,934,57,44,101,56.4%,6m
3505,2,[不谐]武圣马保国,3428,1163,57,59,116,49.1%,23m
3505,3,假面骑士电王,3428,0,0,1,1,0.0%,20m
3509,2,假鈔换贞艹,3427,1540,675,630,1305,51.7%,17m
3509,2,calvindy,3427,88,2,2,4,50.0%,13m
3509,3,Shimakaze,3427,0,1,0,1,100.0%,24m
3509,3,[IMRTS2]ghost,3427,0,1,0,1,100.0%,35m
3509,3,[优纪]美味鱼肉,3427,0,0,1,1,0.0%,33m
3509,2,[哔翻天梯鸡]水静先生,3427,0,0,4,4,0.0%,35m
3515,2,[艾尔之巅]Nonesense,3426,1543,268,236,504,53.2%,7m
3515,2,[老奶奶]用脚玩神族,3426,1090,45,51,96,46.9%,35m
3515,2,[CaiBLu]十二,3426,332,11,13,24,45.8%,32m
3515,3,ToSsGirL,3426,30,2,0,2,100.0%,23m
3515,3,[如天下]华灯初上如墨,3426,0,1,0,1,100.0%,22m
3515,2,DarJumpKing,3426,0,1,1,2,50.0%,7m
3515,1,[喂了虫群]TilinZuokana,3426,48,1,5,6,16.7%,31m
3522,2,baskt,3425,1500,111,99,210,52.9%,35m
3522,2,Nietzsche,3425,378,104,87,191,54.5%,30m
3522,3,HandSomeHaw,3425,362,15,5,20,75.0%,2m
3522,3,Shine,3425,292,12,5,17,70.6%,34m
3522,1,[Abadon]游侠,3425,208,8,5,13,61.5%,8m
3522,3,[中南大学官网]MOMO,3425,60,3,2,5,60.0%,17m
3522,3,猫猫人,3425,30,1,2,3,33.3%,5m
3522,3,[直男]内牛满面,3425,0,0,1,1,0.0%,16m
3530,2,我要放大招,3424,604,115,105,220,52.3%,25m
3530,2,face,3424,1438,81,92,173,46.8%,23m
3530,2,[aloha]兮兮,3424,1265,68,67,135,50.4%,30m
3530,1,[文韬武略]SlientCold,3424,1408,66,88,154,42.9%,7m
3530,2,[CRSC]神天涯,3424,886,62,66,128,48.4%,4m
3530,2,尘埃之影,3424,1033,42,35,77,54.5%,25m
3530,2,IIIIIIIIIIII,3424,520,21,20,41,51.2%,8m
3530,3,哥记,3424,121,6,0,6,100.0%,9m
3530,3,[思思骑士团]死机,3424,0,1,0,1,100.0%,6m
3530,3,GGG,3424,0,1,2,3,33.3%,21m
3530,3,sunny,3424,0,0,1,1,0.0%,21m
3530,2,[御皇]肖谨年,3424,0,0,1,1,0.0%,33m
3542,3,skrskr,3423,533,67,47,114,58.8%,24m
3542,2,土豆味薯片,3423,395,29,28,57,50.9%,17m
3542,3,Fog,3423,294,20,16,36,55.6%,7m
3542,2,[Rhusky]TomTom,3423,512,18,21,39,46.2%,21m
3542,3,[公事公办]人生当苦无妨,3423,434,17,12,29,58.6%,24m
3542,1,糖糖糖糖,3423,86,3,4,7,42.9%,32m
3542,3,鸮鸮夜雨,3423,0,1,0,1,100.0%,21m
3542,3,[RTSGo]CareDownCool,3423,0,0,1,1,0.0%,35m
3542,3,[网瘾督导官]ALLCHOBO,3423,0,0,2,2,0.0%,16m
3551,2,[yxfans]静介,3422,862,54,33,87,62.1%,8m
3551,2,[电风扇]TOP,3422,352,12,16,28,42.9%,30m
3551,2,聚魂棺,3422,244,10,8,18,55.6%,23m
3551,3,lllllllllll,3422,254,10,8,18,55.6%,25m
3551,2,[LEor]诶偶亿偶啊软柿子,3422,140,4,2,6,66.7%,14m
3551,3,[Maiar]時崎狂三,3422,0,1,0,1,100.0%,7m
3551,3,zero,3422,30,1,1,2,50.0%,28m
3551,3,DDaLL,3422,0,0,5,5,0.0%,35m
3559,3,小怪兽其乐无穷,3421,1011,132,120,252,52.4%,2m
3559,2,[青娱乐]llllllllll,3421,737,26,27,53,49.1%,13m
3559,3,innovative,3421,149,5,2,7,71.4%,35m
3559,3,[KPG]帝林,3421,0,1,0,1,100.0%,14m
3559,3,柯一一,3421,0,1,0,1,100.0%,28m
3559,2,我大意了啊没有闪,3421,0,1,0,1,100.0%,33m
3559,3,qds,3421,30,1,1,2,50.0%,5m
3559,2,[MN]Sneaky,3421,0,0,1,1,0.0%,12m
3567,2,隐约雷鸣阴霾天空,3420,687,38,35,73,52.1%,13m
3567,2,帅气的潜质,3420,442,15,26,41,36.6%,33m
3569,2,IIIIIIIII,3419,1587,217,215,432,50.2%,13m
3569,2,GGGDinDinDon,3419,171,58,56,114,50.9%,25m
3569,3,[蟹蟹老板]大粉狗,3419,344,14,4,18,77.8%,19m
3569,3,Alex,3419,58,3,0,3,100.0%,15m
3573,3,wuyulin,3418,1516,82,76,158,51.9%,17m
3573,3,Ophelia,3418,189,12,8,20,60.0%,24m
3573,2,[薪王]航母我是你爹,3418,206,8,11,19,42.1%,28m
3573,2,IIIIIIIIIIII,3418,158,5,6,11,45.5%,21m
3573,3,菜鸡萌新,3418,58,2,3,5,40.0%,33m
3573,3,妖妖灵,3418,0,1,0,1,100.0%,11m
3573,3,多糟,3418,30,1,2,3,33.3%,24m
3573,3,[SoloAs]Eze,3418,0,0,1,1,0.0%,21m
3573,3,black,3418,0,0,1,1,0.0%,19m
3582,2,Death,3417,111,6,7,13,46.2%,21m
3582,3,[深远Hist]Alienware,3417,60,2,2,4,50.0%,2m
3582,3,[天羽不榖]不要欺负虫虫,3417,0,1,0,1,100.0%,24m
3582,3,[哔哩哔哩肝杯]躺赢的豆豆,3417,0,0,1,1,0.0%,32m
3586,3,[茶队星分部]雨过添晴,3416,622,37,15,52,71.2%,10m
3586,2,[ILlLl]fox,3416,571,23,20,43,53.5%,8m
3586,2,Nanking,3416,198,9,15,24,37.5%,10m
3586,2,suki,3416,0,5,1,6,83.3%,23m
3586,3,小兔,3416,86,4,3,7,57.1%,8m
3586,3,[艦Colle]Thanos,3416,60,2,3,5,40.0%,18m
3586,2,JackeySmile,3416,0,1,2,3,33.3%,23m
3586,3,[中中网咖]Rosefinch,3416,0,1,2,3,33.3%,10m
3586,2,[timefa]吉他手,3416,0,0,1,1,0.0%,20m
3586,3,[浪啊浪]杀我农民就一波,3416,0,0,1,1,0.0%,25m
3596,2,[十班好星际]pandalei,3415,1105,76,69,145,52.4%,35m
3596,2,Bladeboy,3415,432,30,16,46,65.2%,32m
3596,3,[资江钓鱼]主宰的存在,3415,638,26,15,41,63.4%,21m
3596,3,[TeamNL]黛维忒,3415,620,26,17,43,60.5%,19m
3596,2,[星之所在RI]StarFish,3415,376,15,18,33,45.5%,11m
3596,3,[Shawk]反正游戏都凉了,3415,280,12,1,13,92.3%,28m
3596,3,腊月,3415,90,4,2,6,66.7%,33m
3596,3,[鸽子窝]我不是富翁,3415,60,3,2,5,60.0%,22m
3596,3,Coach,3415,60,2,4,6,33.3%,32m
3596,3,旅店老板,3415,0,0,1,1,0.0%,2m
3596,3,zhsj,3415,0,0,1,1,0.0%,2m
3607,2,[一二一]IIIIIIIIII,3414,1556,128,110,238,53.8%,34m
3607,2,[我们都是铁头]一拳超人,3414,432,14,27,41,34.1%,4m
3607,3,过去,3414,240,11,6,17,64.7%,28m
3607,2,[FORI]烟花过後,3414,238,9,11,20,45.0%,25m
3607,3,超级肥兔,3414,192,8,3,11,72.7%,4m
3607,3,火爆浪子,3414,30,2,1,3,66.7%,34m
3613,3,带带梁慕容霸,3413,198,8,4,12,66.7%,32m
3613,2,[夜烬十字]无欢喜哈来来,3413,0,5,1,6,83.3%,21m
3613,3,[Magic]加强猫,3413,0,1,0,1,100.0%,7m
3613,3,[P就输不了]打星际选神族包赢,3413,0,1,1,2,50.0%,13m
3617,2,[武纺星际切磋]darkfantasy,3412,1488,173,175,348,49.7%,8m
3617,3,[SC2近卫军]icerJTR,3412,622,23,23,46,50.0%,34m
3617,3,你与秋风皆过客,3412,143,6,1,7,85.7%,8m
3617,2,[RTSGo]JamesWang,3412,118,4,8,12,33.3%,17m
3617,3,[不想打tvt]zsewqsc,3412,30,2,1,3,66.7%,13m
3617,3,[刺蛇互助协会]刺蛇桑,3412,0,1,0,1,100.0%,14m
3617,3,[qhfz]ZxyZxy,3412,0,1,0,1,100.0%,36m
3617,3,[洪兴十二堂口]陈浩南,3412,0,0,1,1,0.0%,8m
3617,3,Tiddler,3412,0,0,1,1,0.0%,15m
3617,3,小祖,3412,0,0,3,3,0.0%,34m
3627,3,[四斋蒸蚝片]冷瞳,3411,296,13,7,20,65.0%,22m
3627,3,[丨SLT丨]苍生涂涂天下渺渺,3411,252,10,5,15,66.7%,35m
3627,3,Prophet,3411,114,4,4,8,50.0%,34m
3627,3,[uEstc]电子科大美女多,3411,0,3,2,5,60.0%,22m
3627,3,[抽爷]你好我要杀你,3411,0,1,0,1,100.0%,27m
3627,3,Kanye,3411,0,0,1,1,0.0%,5m
3627,3,[小鱼塘]大青花鱼,3411,0,0,1,1,0.0%,29m
3634,3,鹿目圆,3410,602,24,18,42,57.1%,24m
3634,3,[星歌]danceInDark,3410,519,22,7,29,75.9%,31m
3634,2,maybe,3410,443,19,12,31,61.3%,32m
3634,3,xsghf,3410,284,10,9,19,52.6%,9m
3634,3,Joker,3410,58,3,2,5,60.0%,27m
3634,3,[Thpj]AwaykingWing,3410,30,1,2,3,33.3%,34m
3640,3,IMAOHW,3409,604,45,26,71,63.4%,5m
3640,3,nekoi,3409,117,3,2,5,60.0%,10m
3642,3,[飞云之上]HelloWorld,3408,1483,111,100,211,52.6%,29m
3642,2,[魔法少女小屋]智慧虫族尿急王,3408,1583,62,64,126,49.2%,30m
3642,3,brook,3408,664,48,41,89,53.9%,20m
3642,3,忘了,3408,530,21,13,34,61.8%,35m
3642,2,[GFA]Nightbane,3408,502,20,29,49,40.8%,13m
3642,3,[thu战队]Hazyknight,3408,388,13,15,28,46.4%,31m
3642,2,奈姆斯灵沼,3408,226,6,9,15,40.0%,36m
3642,3,叛徒,3408,97,2,1,3,66.7%,5m
3642,3,[帝门的小萌新]SCPLAYER,3408,30,2,2,4,50.0%,7m
3642,3,luvesyx,3408,0,1,0,1,100.0%,10m
3642,3,[holyhp]MarineKing,3408,30,1,2,3,33.3%,36m
3642,3,[TMUSC2]ArkFrostNova,3408,30,1,3,4,25.0%,27m
3642,3,[半个菜鸟]nist,3408,30,1,4,5,20.0%,10m
3642,2,[HeroZP]Dark,3408,0,0,4,4,0.0%,4m
3656,2,[小鸡屠宰场9]ythtyrd,3407,681,55,43,98,56.1%,6m
3656,3,丘丘人,3407,455,18,9,27,66.7%,28m
3656,3,瓦力,3407,230,9,5,14,64.3%,12m
3656,3,[银河喵波隆]PicACG,3407,0,1,0,1,100.0%,13m
3656,3,THEMERE,3407,0,0,1,1,0.0%,5m
3656,3,villo,3407,0,0,1,1,0.0%,34m
3662,2,Archer,3406,1466,69,60,129,53.5%,39m
3662,2,虫群暴君,3406,1520,63,62,125,50.4%,12m
3662,3,[时光回廊]失落的奇迹,3406,0,3,2,5,60.0%,2m
3662,3,柚子,3406,0,3,2,5,60.0%,7m
3662,3,jbr,3406,30,1,1,2,50.0%,12m
3662,3,[海石三叉戟]LYandGB,3406,0,0,1,1,0.0%,14m
3668,2,[Fear]杀生大神,3405,1504,186,190,376,49.5%,19m
3668,3,[无边之空]sdf,3405,236,8,9,17,47.1%,24m
3668,3,[GHet]灬冬月,3405,135,3,0,3,100.0%,2m
3668,3,[谐神]紫宫初雪,3405,60,3,1,4,75.0%,28m
3668,3,人皇出征寸草不生,3405,0,1,4,5,20.0%,4m
3668,3,[华政之光]虫群意识,3405,30,1,5,6,16.7%,6m
3674,2,DeBrunk,3404,1505,208,189,397,52.4%,4m
3674,2,虫二,3404,1634,178,166,344,51.7%,7m
3674,2,[莫妮卡]Monika,3404,747,48,46,94,51.1%,20m
3674,2,云之渺,3404,360,12,19,31,38.7%,39m
3674,3,繁花落尽,3404,314,10,8,18,55.6%,21m
3674,3,狗咬毒爆,3404,60,2,4,6,33.3%,6m
3674,2,[TNLet]Solar,3404,30,2,8,10,20.0%,17m
3674,2,[RDFZsc]tonculax,3404,0,1,7,8,12.5%,30m
3674,3,[上古战魂]亡灵挽歌灬红莲,3404,0,0,1,1,0.0%,17m
3674,3,[田所浩二厨]古尔德施坦因,3404,0,0,1,1,0.0%,4m
3674,3,scplayer,3404,0,0,2,2,0.0%,3m
3685,3,[Beastp]夜听风,3403,773,34,15,49,69.4%,28m
3685,2,[miku守护]killer,3403,750,33,25,58,56.9%,24m
3685,3,杨超越隐藏男友,3403,223,6,6,12,50.0%,33m
3685,3,[HTW]我爱薇妹,3403,60,2,3,5,40.0%,3m
3685,3,Desperado,3403,0,1,0,1,100.0%,21m
3685,3,树懒,3403,0,1,2,3,33.3%,35m
3685,3,某李姓后勤部部长,3403,30,1,3,4,25.0%,7m
3685,3,神奇小嘉大冒险,3403,0,0,2,2,0.0%,21m
3693,2,[永恒自由]你爹临死前,3402,1571,284,280,564,50.4%,2m
3693,2,[永恒自由]NBA,3402,1536,92,103,195,47.2%,4m
3693,3,NTRfirst,3402,60,3,2,5,60.0%,27m
3693,3,Tany,3402,0,1,2,3,33.3%,6m
3693,3,[后新星]SNinfinite,3402,0,0,1,1,0.0%,9m
3698,2,cwg,3401,1119,144,139,283,50.9%,13m
3698,2,狮心王,3401,1030,86,78,164,52.4%,2m
3698,2,kaki,3401,827,34,29,63,54.0%,33m
3698,3,light,3401,344,12,16,28,42.9%,20m
3698,3,大喵,3401,205,7,4,11,63.6%,10m
3698,3,lhwfish,3401,58,2,2,4,50.0%,26m
3698,3,[绯世梦璃花]砂糖少女以爱为食,3401,0,1,0,1,100.0%,22m
3698,3,大白丶,3401,0,0,1,1,0.0%,16m
3698,3,[七彩斑斓]lemOnoxygen,3401,0,0,1,1,0.0%,24m
3707,3,orangesixone,3400,1070,80,61,141,56.7%,16m
3707,2,LoveGodZ,3400,1134,71,61,132,53.8%,13m
3707,2,[艾尔之主]我是新手,3400,397,18,21,39,46.2%,17m
3707,3,[哟呵呵]天满八纯,3400,328,13,6,19,68.4%,27m
3707,3,[玩人族先想想]你凭什么赢神族,3400,137,2,2,4,50.0%,15m
3712,3,顾浅浅,3399,1618,157,136,293,53.6%,34m
3712,2,jdjdbommm,3399,1280,63,73,136,46.3%,17m
3712,2,Darin,3399,607,29,34,63,46.0%,35m
3712,3,[P太IMBA]牧濑红莉栖,3399,257,16,10,26,61.5%,4m
3712,3,IIIIIIII,3399,0,3,2,5,60.0%,8m
3712,3,落寞水晶,3399,0,0,1,1,0.0%,7m
3718,2,[闪击战]五十块的好兄弟,3398,1313,175,168,343,51.0%,17m
3718,2,重新开始,3398,783,138,133,271,50.9%,32m
3718,2,[钉宫病]vampirelian,3398,354,99,111,210,47.1%,12m
3718,3,[一拜天地]方才,3398,278,10,5,15,66.7%,10m
3718,3,flytothemoon,3398,198,7,9,16,43.8%,20m
3718,3,duxingz,3398,116,5,2,7,71.4%,32m
3718,2,IIIIIIIIIIII,3398,88,4,6,10,40.0%,23m
3718,3,[吃个糖卖个萌]柠檬味,3398,0,3,1,4,75.0%,13m
3718,3,[Flowex]米小五,3398,0,0,1,1,0.0%,3m
3718,3,[我怎么这么菜]MAGICMING,3398,0,0,2,2,0.0%,15m
3728,3,春困秋乏夏无力,3397,886,35,29,64,54.7%,10m
3728,2,鱼香肉丝来啦,3397,655,25,29,54,46.3%,15m
3728,3,zaku,3397,214,11,4,15,73.3%,17m
3728,2,[CM]Elric,3397,152,10,9,19,52.6%,21m
3728,3,鯰川若葉,3397,186,6,10,16,37.5%,2m
3728,3,[查尔之矛]小金爱吃炸酥肉,3397,30,2,0,2,100.0%,9m
3728,3,斯巴达克斯,3397,0,0,1,1,0.0%,11m
3728,3,[NYJC]HardWorKnG,3397,0,0,1,1,0.0%,32m
3728,3,llllllllllll,3397,0,0,1,1,0.0%,24m
3737,3,cijief,3396,1518,161,142,303,53.1%,24m
3737,3,狂风劲夫,3396,680,29,17,46,63.0%,34m
3737,3,木丁西,3396,390,15,5,20,75.0%,16m
3737,3,Timeless,3396,224,8,2,10,80.0%,11m
3737,3,耿彬吃粑粑,3396,0,1,0,1,100.0%,23m
3737,3,心凌,3396,0,0,1,1,0.0%,18m
3737,3,天堂失格,3396,0,0,1,1,0.0%,13m
3737,3,[歌者李仙姬]杀不完的机枪兵,3396,0,0,3,3,0.0%,34m
3745,2,奶骑风向标,3395,398,14,22,36,38.9%,39m
3745,3,贤者瓜,3395,287,13,4,17,76.5%,17m
3745,3,[虫卵保护协会]拟态虫,3395,30,2,0,2,100.0%,17m
3745,3,半份幻丶庭师,3395,0,1,0,1,100.0%,2m
3745,3,羽落凡尘,3395,0,1,1,2,50.0%,32m
3745,3,[Etd]SeNTea,3395,0,0,1,1,0.0%,2m
3745,3,康孝宇,3395,0,0,1,1,0.0%,2m
3752,2,[七咕咕]天幕下的银翼,3394,1330,164,158,322,50.9%,23m
3752,3,[为了虫群zz]是的长官,3394,816,93,60,153,60.8%,26m
3752,2,雪梅花,3394,1480,76,77,153,49.7%,32m
3752,3,摩诃不可思议,3394,638,25,21,46,54.3%,5m
3752,3,电脑困难模式,3394,364,17,7,24,70.8%,36m
3752,2,放大看什么,3394,452,15,19,34,44.1%,23m
3752,3,十一月丶,3394,62,3,4,7,42.9%,27m
3752,3,[扫黄咑峰]源来氏佐田田,3394,0,1,0,1,100.0%,11m
3760,2,流浪泰伦,3393,1565,96,93,189,50.8%,36m
3760,3,残月丿落花,3393,479,20,10,30,66.7%,2m
3760,3,[萨尔那加之刃]jiuzi,3393,192,8,2,10,80.0%,5m
3760,2,喧哗上等,3393,148,6,9,15,40.0%,13m
3760,3,[上海大学]明明,3393,97,4,2,6,66.7%,34m
3760,3,[肉鸡的饲养]魔法骚女凯露酱,3393,58,3,1,4,75.0%,8m
3766,2,IIIIIIIIIIII,3392,1522,285,273,558,51.1%,33m
3766,2,那就晚安,3392,944,44,33,77,57.1%,39m
3766,3,嘤熊,3392,188,29,17,46,63.0%,24m
3766,3,[区区八婆紫]Doooomino,3392,486,16,14,30,53.3%,23m
3766,3,ForeverMsh,3392,0,4,1,5,80.0%,9m
3766,2,[银河舰队]虫群之心,3392,115,3,1,4,75.0%,26m
3766,3,[萝莉压身]虫给砍废了,3392,0,1,0,1,100.0%,19m
3766,3,[我队伍很强大]我不会玩,3392,0,0,1,1,0.0%,21m
3774,2,[ANNEX]克丽丝岚,3391,1608,633,630,1263,50.1%,10m
3774,3,[SC2ACG]IIIIIIIIIIII,3391,565,24,14,38,63.2%,6m
3774,3,TheYuan,3391,300,11,6,17,64.7%,24m
3774,3,[Awyr]klim,3391,164,5,4,9,55.6%,11m
3774,3,最帅的那个,3391,0,1,0,1,100.0%,21m
3774,3,onlyfire,3391,0,0,1,1,0.0%,34m
3780,2,ShowTime,3390,635,162,145,307,52.8%,6m
3780,3,破两票,3390,1106,97,59,156,62.2%,16m
3780,2,lllllllllll,3390,1344,53,49,102,52.0%,6m
3780,3,[凛凛拎个鳖]血翼鸿鹄,3390,535,23,12,35,65.7%,36m
3780,3,lllllllll,3390,332,14,4,18,77.8%,31m
3780,3,[共鸣的鸣]悲鸣的鸣,3390,114,4,4,8,50.0%,19m
3780,3,青铜莽夫,3390,90,3,3,6,50.0%,32m
3787,2,不上宗不改名,3389,1534,417,388,805,51.8%,19m
3787,3,湊阿库娅,3389,120,6,1,7,85.7%,29m
3787,3,[黑人抬棺团队]CIhuhu,3389,0,0,1,1,0.0%,16m
3790,3,ZaknaFein,3388,940,107,93,200,53.5%,4m
3790,3,就这破游戏瞎玩呗,3388,30,2,2,4,50.0%,13m
3790,3,[Borne]Kingofclubs,3388,96,1,1,2,50.0%,7m
3790,3,简单的电脑,3388,0,1,4,5,20.0%,5m
3790,3,[CHN共青团]Fox,3388,0,0,1,1,0.0%,2m
3790,3,[Csquad]MrR,3388,0,0,1,1,0.0%,31m
3790,3,[白翎舰队]Cleveland,3388,0,0,1,1,0.0%,30m
3790,3,[C41826]LYK,3388,0,0,1,1,0.0%,6m
3790,3,qdlsqxy,3388,0,0,3,3,0.0%,13m
3799,3,[MUL]sum,3387,292,10,11,21,47.6%,32m
3799,3,[腥基佬男骸]AmazingLYH,3387,150,5,5,10,50.0%,8m
3799,3,[你好可爱]Ashlost,3387,88,3,4,7,42.9%,29m
3799,3,玖月,3387,0,1,0,1,100.0%,26m
3799,3,[Helens]超级小黑咪,3387,30,1,3,4,25.0%,20m
3799,3,虫虫,3387,0,0,1,1,0.0%,7m
3805,3,PIGKING,3386,1298,88,56,144,61.1%,31m
3805,3,[刺蛇互助协会]祝暴雪早日倒闭,3386,1340,70,59,129,54.3%,18m
3805,3,panicmonster,3386,252,9,8,17,52.9%,4m
3805,3,[其徐如风]Angel,3386,97,5,1,6,83.3%,21m
3805,3,[Igirls]天真可爱小喵呜,3386,0,1,0,1,100.0%,13m
3805,3,Betelgeuse,3386,0,1,0,1,100.0%,35m
3805,3,[星空第二猛]迷人的危险,3386,30,1,5,6,16.7%,7m
3805,3,你好啊,3386,0,0,2,2,0.0%,8m
3813,2,鞭性茎肛,3385,773,30,32,62,48.4%,5m
3813,2,孤寂的寒星,3385,660,27,27,54,50.0%,27m
3813,3,ForFun,3385,424,19,12,31,61.3%,11m
3813,3,元始天王,3385,142,6,5,11,54.5%,18m
3813,3,[虚拟歌手团体]乐正绫,3385,0,0,1,1,0.0%,4m
3818,3,SApphire,3384,1065,117,98,215,54.4%,16m
3818,3,传说中的啦啦,3384,1186,44,44,88,50.0%,21m
3818,2,可以吗,3384,404,13,17,30,43.3%,23m
3818,3,[落日飞车]爱和巴黎,3384,295,11,5,16,68.8%,25m
3818,3,[老油条战队4]CoolDot,3384,226,9,7,16,56.2%,12m
3818,3,[白银联盟]风莺月怡,3384,97,6,0,6,100.0%,5m
3818,3,[不說話装高手]怪物之父,3384,58,2,1,3,66.7%,19m
3818,3,[偽娘万歳]地狱咆哮,3384,0,0,2,2,0.0%,17m
3826,3,鞭笞万物的阿卡莎,3383,1627,193,182,375,51.5%,13m
3826,2,榕江小子,3383,792,31,32,63,49.2%,17m
3826,3,谁还不穿洛丽塔呢,3383,402,27,17,44,61.4%,23m
3826,2,[喵喵]ChinaTopZerg,3383,448,20,18,38,52.6%,35m
3826,2,yoshily,3383,159,6,8,14,42.9%,13m
3826,3,的卢,3383,88,4,2,6,66.7%,16m
3826,3,Biltz,3383,0,1,0,1,100.0%,34m
3826,3,[赶紧补补水]燃尽踌躇,3383,0,1,0,1,100.0%,21m
3826,3,[捏噗]八云幽香,3383,0,0,1,1,0.0%,34m
3835,3,[艾尔之巅]体验不佳,3382,377,77,66,143,53.8%,4m
3835,2,三年不洗卵,3382,688,38,37,75,50.7%,12m
3835,3,[野蛮猫骑士]llllllllllll,3382,922,35,32,67,52.2%,25m
3835,3,[NMSL战队]DragonWarior,3382,575,26,26,52,50.0%,2m
3835,2,打不好也打,3382,319,15,14,29,51.7%,5m
3835,3,基阿迪芒迪大师,3382,181,10,6,16,62.5%,17m
3835,3,izaya,3382,0,1,0,1,100.0%,19m
3835,3,Lawliet,3382,0,0,2,2,0.0%,32m
3835,3,[有刀踏天涯丶]兜兜坏小白,3382,0,0,2,2,0.0%,13m
3844,2,[miku守护]萨尔纳加,3381,1513,77,71,148,52.0%,32m
3844,3,阳三爷,3381,1360,69,57,126,54.8%,2m
3844,2,啊啊啊啊,3381,821,36,31,67,53.7%,17m
3844,3,曾经的回忆,3381,140,6,1,7,85.7%,2m
3844,3,[大连理工]梦羽,3381,90,4,3,7,57.1%,5m
3844,3,soO,3381,0,1,0,1,100.0%,30m
3844,3,Lovekeke,3381,0,0,1,1,0.0%,29m
3844,3,[暴雪我是你爹]Gustaf,3381,0,0,5,5,0.0%,5m
3852,2,zik,3380,616,76,44,120,63.3%,28m
3852,3,吕布又倒了,3380,119,3,1,4,75.0%,2m
3852,3,xiaozhi,3380,0,1,0,1,100.0%,5m
3852,3,[滑稽神教TM]可惜丶,3380,0,1,1,2,50.0%,5m
3856,3,大头爸爸,3379,1416,290,239,529,54.8%,11m
3856,2,沉睡的雄狮,3379,1226,126,128,254,49.6%,40m
3856,3,樱空桃,3379,134,11,7,18,61.1%,25m
3856,3,[刺蛇互助天团]Yuna,3379,197,7,1,8,87.5%,27m
3856,2,[NLD]逆向行驶,3379,150,6,10,16,37.5%,7m
3856,3,[我即是菜狗]西安孙一峰,3379,118,4,4,8,50.0%,12m
3856,3,三三,3379,30,2,0,2,100.0%,3m
3856,3,叨叨,3379,0,0,1,1,0.0%,16m
3864,2,[老油条战队4]solostart,3378,875,249,242,491,50.7%,22m
3864,3,Value,3378,1394,62,61,123,50.4%,23m
3864,2,[SC联盟]Maru,3378,572,20,27,47,42.6%,20m
3864,3,[乱世]思言,3378,443,18,14,32,56.2%,2m
3864,3,[Anonym]TasKiller,3378,247,14,7,21,66.7%,7m
3864,3,[黑粉头子]桐人,3378,0,0,1,1,0.0%,8m
3864,3,你们都上网冲浪啊,3378,0,0,1,1,0.0%,24m
3864,3,都是大哥,3378,0,0,1,1,0.0%,9m
3872,3,空条承太郎,3377,137,7,1,8,87.5%,10m
3872,3,[暴雪我是你爹]rye,3377,114,5,1,6,83.3%,34m
3872,3,[prgirl]Miku,3377,60,3,4,7,42.9%,15m
3872,3,死亡的爱情,3377,0,1,0,1,100.0%,2m
3872,3,IIIIIIIIIIII,3377,0,1,0,1,100.0%,5m
3872,3,[刺蛇互助天团]love,3377,30,1,1,2,50.0%,24m
3872,3,越年轻越薄情,3377,0,1,2,3,33.3%,5m
3872,3,[极俗便是雅]Moment,3377,0,0,1,1,0.0%,33m
3872,3,[镜花水月]涂山红红,3377,0,0,1,1,0.0%,13m
3881,2,MYxdu,3376,1504,203,190,393,51.7%,3m
3881,3,白门楼工程建造师,3376,477,24,23,47,51.1%,24m
3881,3,无上光荣,3376,480,17,21,38,44.7%,6m
3881,3,loveY,3376,367,16,5,21,76.2%,5m
3881,2,MingA,3376,116,6,2,8,75.0%,4m
3881,3,距离,3376,58,3,0,3,100.0%,18m
3881,2,IIIIIIIIIIII,3376,94,3,9,12,25.0%,11m
3881,3,[别狗想赢打字]霸王之锁,3376,58,2,5,7,28.6%,35m
3881,3,[樱华月想]Suzumiya,3376,0,0,1,1,0.0%,31m
3881,3,依水何安丶,3376,0,0,1,1,0.0%,17m
3891,2,eagle,3375,1363,108,102,210,51.4%,6m
3891,2,krisk,3375,476,16,22,38,42.1%,27m
3891,3,[DMRe]zero,3375,280,10,10,20,50.0%,20m
3891,3,小仓朝阳,3375,30,2,1,3,66.7%,32m
3891,3,队长饶命,3375,30,1,2,3,33.3%,28m
3896,2,靠谱为什么这么帅,3374,1554,198,186,384,51.6%,19m
3896,2,[KPG2]柜子里的老王,3374,1556,100,80,180,55.6%,39m
3896,2,[纱雾姐姐]鹿田纱雾,3374,325,41,33,74,55.4%,35m
3896,2,[小狐狸]澪幽,3374,136,6,13,19,31.6%,10m
3896,3,千神,3374,0,5,0,5,100.0%,22m
3896,3,Grubby,3374,134,3,2,5,60.0%,20m
3896,3,七夜死贵,3374,62,3,3,6,50.0%,32m
3896,3,[OLY]vvvv,3374,0,1,0,1,100.0%,22m
3896,3,乙烯,3374,0,0,1,1,0.0%,5m
3896,3,[冰雨的风暴]忘言,3374,0,0,1,1,0.0%,2m
3896,3,[KPG]AloneWolf,3374,0,0,1,1,0.0%,2m
3896,3,[斯巴达血战团]独步杀戮,3374,0,0,1,1,0.0%,4m
3896,3,[谁遭得住]战争机器,3374,0,0,2,2,0.0%,15m
3909,2,fyyy,3373,972,93,91,184,50.5%,20m
3909,3,EGJD,3373,1617,85,72,157,54.1%,16m
3909,3,[我菜请打队友]亚特兰蒂斯,3373,631,26,19,45,57.8%,16m
3909,3,[暴雪我是你爹]电脑玩家詹姆斯,3373,348,12,12,24,50.0%,11m
3909,3,ppyy,3373,0,4,2,6,66.7%,18m
3909,3,kudyun,3373,30,2,2,4,50.0%,3m
3909,3,[C70843]黎明,3373,30,2,3,5,40.0%,32m
3909,3,Nirvana,3373,0,0,2,2,0.0%,32m
3917,2,地狱小叶子,3372,1658,146,146,292,50.0%,25m
3917,3,绝望中想起了换家,3372,978,73,68,141,51.8%,2m
3917,3,IIIIIIIIIIII,3372,118,4,6,10,40.0%,3m
3917,3,电眼帅哥,3372,60,3,4,7,42.9%,36m
3917,2,[三千分的幽灵]沧海客,3372,94,3,11,14,21.4%,30m
3917,3,烈焰轨迹,3372,0,1,0,1,100.0%,3m
3917,3,逆流成河,3372,0,1,0,1,100.0%,22m
3917,1,周润发柯北,3372,95,1,1,2,50.0%,40m
3925,1,[贵州人]小春我的阳,3371,1656,1364,1363,2727,50.0%,32m
3925,3,ZHT,3371,1614,147,126,273,53.8%,31m
3925,2,[杀马特洗剪吹]益达,3371,1477,114,119,233,48.9%,20m
3925,3,ppcren,3371,121,21,16,37,56.8%,2m
3925,3,乖乖龙滴隆,3371,260,9,12,21,42.9%,31m
3925,3,[四斋蒸蚝片]七樹,3371,88,4,2,6,66.7%,34m
3925,3,钱赞企,3371,30,1,1,2,50.0%,11m
3925,1,zXt,3371,96,1,4,5,20.0%,16m
3925,3,LOVESC,3371,0,0,1,1,0.0%,9m
3925,3,[星歌]Kagamine,3371,0,0,5,5,0.0%,22m
3935,2,[心机争霸]别猥琐,3370,1466,289,291,580,49.8%,34m
3935,3,Sarah,3370,1612,71,53,124,57.3%,2m
3935,2,[风后奇门]ToliSeaSon,3370,1491,69,63,132,52.3%,21m
3935,3,Tins,3370,338,12,10,22,54.5%,7m
3935,3,Twistzz,3370,58,3,5,8,37.5%,5m
3935,3,四十岁的菜鸡,3370,0,1,0,1,100.0%,13m
3935,2,[ZJU]迷迭香,3370,0,0,3,3,0.0%,33m
3942,2,[又高又硬]混元星际闪电鞭,3369,1592,432,430,862,50.1%,10m
3942,2,[DMRc]saber,3369,1168,199,194,393,50.6%,30m
3942,2,夏沐,3369,1349,119,109,228,52.2%,17m
3942,3,[Etern谐]xxxxxx,3369,670,23,25,48,47.9%,16m
3942,3,阿龙,3369,300,12,7,19,63.2%,9m
3942,3,克劳德琪露诺,3369,0,4,2,6,66.7%,2m
3942,3,[第999舰队]风暴,3369,30,4,4,8,50.0%,20m
3942,3,IIIIIIIIII,3369,0,3,2,5,60.0%,9m
3950,3,[薪王]狡猾的异虫,3368,1507,150,127,277,54.2%,21m
3950,2,[废铁组]晓天之锚,3368,1247,60,66,126,47.6%,28m
3950,3,yuzi,3368,549,59,29,88,67.0%,10m
3950,3,[六骑]红圆锈钢,3368,312,30,22,52,57.7%,34m
3950,3,快乐的小刺蛇,3368,662,24,26,50,48.0%,20m
3950,2,冷藏,3368,252,9,5,14,64.3%,4m
3950,3,圣剑路德维格,3368,153,5,1,6,83.3%,14m
3950,3,feng,3368,0,1,0,1,100.0%,22m
3950,3,Cortana,3368,0,0,1,1,0.0%,5m
3950,2,杀狗的,3368,0,0,1,1,0.0%,13m
3960,1,东风静静吹,3367,1183,93,99,192,48.4%,35m
3960,2,GGtaste,3367,1437,82,79,161,50.9%,2m
3960,3,IIIIIIIIIIII,3367,1237,53,34,87,60.9%,35m
3960,3,Jbw,3367,114,4,5,9,44.4%,8m
3960,3,萌小喵,3367,122,4,8,12,33.3%,17m
3960,2,[七咕咕]一束七,3367,134,2,3,5,40.0%,20m
3960,3,[空中劈叉]兰夜行歌,3367,0,0,1,1,0.0%,34m
3967,2,[miku守护]京中有善口技者,3366,1341,117,122,239,49.0%,6m
3967,2,星云际会,3366,1197,43,59,102,42.2%,21m
3967,3,[ASDF]lethe,3366,602,25,24,49,51.0%,2m
3967,3,[Lff的主人]mztkb,3366,438,18,12,30,60.0%,2m
3967,2,smous,3366,302,11,18,29,37.9%,30m
3967,2,[风后奇门]ToliSeaSon,3366,158,5,1,6,83.3%,34m
3967,3,Berba,3366,114,5,1,6,83.3%,4m
3967,3,[北京大学鸡协]芭芭拉冲鸭,3366,140,5,5,10,50.0%,19m
3967,3,[自由的气息]瘪大,3366,58,3,0,3,100.0%,20m
3967,3,智障也有春天,3366,0,1,0,1,100.0%,21m
3967,3,[保护伞公司]ZARD,3366,0,1,0,1,100.0%,25m
3967,3,[星际太难啦]Charles,3366,0,1,0,1,100.0%,5m
3967,3,[s黑色玫瑰s]骨茶雨,3366,0,0,1,1,0.0%,2m
3980,3,云灵苏,3365,995,102,69,171,59.6%,14m
3980,3,无言柳下,3365,1569,94,80,174,54.0%,18m
3980,2,imba,3365,833,67,63,130,51.5%,4m
3980,2,[兆景埋土大学]Rinne,3365,933,49,58,107,45.8%,11m
3980,2,巨噬细胞,3365,406,16,16,32,50.0%,25m
3980,3,[Beasty]来一览美景吧,3365,384,14,15,29,48.3%,15m
3980,3,拉蒂兹,3365,159,9,4,13,69.2%,22m
3980,2,[文韬武略]有基佬拉我苦练,3365,36,3,7,10,30.0%,10m
3980,3,[miku守护]Zknight,3365,0,1,1,2,50.0%,9m
3980,3,越小,3365,0,0,1,1,0.0%,31m
3980,2,[凶猛]ssdadas,3365,0,0,1,1,0.0%,33m
3980,3,[孫DVA]Scarlett,3365,0,0,1,1,0.0%,18m
3980,3,嘤嘤嘤嘤漏卫星,3365,0,0,2,2,0.0%,12m
3993,2,IIIIIIIIIIII,3364,1607,286,273,559,51.2%,8m
3993,2,ASURAN,3364,1325,76,75,151,50.3%,21m
3993,2,DZcn,3364,941,40,38,78,51.3%,32m
3993,3,IIIIIIIIIIII,3364,174,7,8,15,46.7%,23m
3997,3,[浪啊浪]MUZI,3363,1436,139,126,265,52.5%,22m
3997,2,[您好]sheeper,3363,1161,77,87,164,47.0%,10m
3997,3,多少次愛,3363,1125,70,65,135,51.9%,11m
3997,3,紫语青酸,3363,520,22,15,37,59.5%,32m
3997,3,MrYu,3363,222,9,6,15,60.0%,16m
3997,2,Schamhorst,3363,183,8,3,11,72.7%,20m
3997,3,[北极光小组]cuhddd,3363,30,2,0,2,100.0%,5m
3997,3,[五月花]丨成丨,3363,30,2,3,5,40.0%,30m
3997,3,NKcyAN,3363,0,1,0,1,100.0%,33m
3997,3,一个苹果的,3363,0,0,2,2,0.0%,19m
4007,2,[纪念陈一发]老小狗,3362,1571,1034,1036,2070,50.0%,4m
4007,1,[沙漠老男人]gcd,3362,1615,144,150,294,49.0%,6m
4007,2,[后宫园]异端,3362,925,50,49,99,50.5%,35m
4007,3,[柠檬汁]条码人,3362,60,2,5,7,28.6%,25m
4007,3,[LYFANS]Zest,3362,0,1,0,1,100.0%,20m
4012,2,神枪手,3361,1379,424,414,838,50.6%,14m
4012,2,tiansky,3361,538,59,45,104,56.7%,36m
4012,2,[C26289]遇事不决莽一波,3361,1192,51,44,95,53.7%,39m
4012,2,新鸡争霸,3361,347,26,21,47,55.3%,25m
4012,2,[Digita]Nebula,3361,556,21,26,47,44.7%,12m
4012,3,[SK]圣光小熊,3361,287,16,14,30,53.3%,29m
4012,3,[舰队已抵达]沟通,3361,140,5,3,8,62.5%,8m
4012,3,Jackson,3361,0,0,1,1,0.0%,13m
4020,2,龅牙大神,3360,1494,279,259,538,51.9%,17m
4020,2,[中指]nuonuo,3360,1481,258,263,521,49.5%,20m
4020,3,珥瑶,3360,1479,110,96,206,53.4%,18m
4020,3,刀锋女王,3360,894,46,46,92,50.0%,24m
4020,2,对面的都是鸡,3360,1272,46,56,102,45.1%,23m
4020,3,[SKT俱乐部]Life,3360,386,12,31,43,27.9%,27m
4020,3,[ETG]小狐狸太棒了,3360,238,10,1,11,90.9%,14m
4020,3,[你看到了法神]Vurtnelol,3360,0,1,0,1,100.0%,23m
4020,3,kxkc,3360,0,1,0,1,100.0%,26m
4020,3,[SC2近卫军]Zerg,3360,30,1,7,8,12.5%,21m
4020,3,[Beastp]六地选手,3360,0,0,1,1,0.0%,30m
4020,3,[强制喵化]叶重,3360,0,0,1,1,0.0%,32m
4032,3,guanswer,3359,1651,260,241,501,51.9%,11m
4032,2,[暴雪七队]秣陵沈公子,3359,640,22,31,53,41.5%,20m
4032,3,[温柔兔公主]我爱修地堡,3359,230,10,3,13,76.9%,5m
4032,3,[TsFz]YiXiNi,3359,58,3,0,3,100.0%,5m
4032,3,[CNboys]只会狗招,3359,0,2,2,4,50.0%,15m
4032,3,[哒哒子]十六夜咲夜,3359,0,0,2,2,0.0%,10m
4038,3,[清姬神教总坛]咕哒子,3358,276,11,9,20,55.0%,13m
4038,3,[魔法少女小屋]玖诺,3358,236,10,1,11,90.9%,18m
4038,3,[Can]Samtair,3358,134,6,4,10,60.0%,17m
4038,1,ddcat,3358,136,3,5,8,37.5%,26m
4038,3,tyt,3358,88,3,7,10,30.0%,19m
4038,3,IIIIIIIIIIII,3358,0,0,1,1,0.0%,23m
4044,3,[A2B]lanius,3357,1387,58,52,110,52.7%,29m
4044,3,多线起飞,3357,805,45,21,66,68.2%,9m
4044,3,恶魔,3357,888,40,25,65,61.5%,34m
4044,2,开图没马,3357,259,21,21,42,50.0%,19m
4044,3,缘灭,3357,146,6,3,9,66.7%,19m
4044,3,僵尸,3357,140,5,3,8,62.5%,34m
4044,3,汉堡哥哥丫霸,3357,0,1,0,1,100.0%,13m
4044,3,[谐新部落]sOs,3357,0,1,1,2,50.0%,18m
4044,3,擎苍龍,3357,0,0,1,1,0.0%,21m
4044,3,[异乱]wushuang,3357,0,0,1,1,0.0%,20m
4054,3,Violet,3356,461,26,15,41,63.4%,2m
4054,3,EVAN,3356,582,22,17,39,56.4%,13m
4054,3,TIMO,3356,450,17,18,35,48.6%,26m
4054,2,Tohsaka,3356,326,11,17,28,39.3%,17m
4054,1,[DWFS]绯绯金,3356,185,9,7,16,56.2%,16m
4054,2,我们还行吧,3356,172,6,18,24,25.0%,21m
4054,3,不知道取什么名字,3356,60,2,4,6,33.3%,40m
4054,3,[Tov]freedom,3356,0,1,0,1,100.0%,36m
4054,3,[魏无羡的魔笛]serral,3356,0,1,0,1,100.0%,16m
4054,3,[一波]叫我帅哥就好了,3356,0,0,1,1,0.0%,29m
4064,3,[硬朗派]阿嵬茨小志,3355,989,45,44,89,50.6%,33m
4064,3,supuo,3355,186,7,9,16,43.8%,14m
4064,3,[血港魅影]糖心,3355,114,5,1,6,83.3%,6m
4064,3,星际与魔兽的区别,3355,60,3,1,4,75.0%,16m
4064,3,[WGwar]steve,3355,60,3,3,6,50.0%,4m
4064,2,[L4WUDU]GAI,3355,44,2,0,2,100.0%,9m
4064,3,求得一世乐逍遥,3355,0,1,4,5,20.0%,9m
4071,2,磊哥,3354,676,112,100,212,52.8%,13m
4071,3,CrazyStar,3354,461,24,13,37,64.9%,22m
4071,3,[四叶草]芽间美依子,3354,302,11,6,17,64.7%,31m
4071,3,[不打内战随机]粑本,3354,86,3,2,5,60.0%,7m
4071,3,道一一,3354,0,1,0,1,100.0%,30m
4071,3,[Shawk]Goya,3354,0,0,1,1,0.0%,29m
4077,3,中二好柃,3353,339,15,12,27,55.6%,13m
4077,2,来找小秘书,3353,318,11,17,28,39.3%,17m
4077,3,KIR,3353,266,10,5,15,66.7%,22m
4077,3,fengye,3353,92,4,6,10,40.0%,7m
4077,3,东风,3353,0,1,0,1,100.0%,19m
4077,3,[学习使我快乐]小林者,3353,0,1,0,1,100.0%,9m
4077,3,[ZTM]纸袋,3353,0,1,2,3,33.3%,21m
4077,3,dafeiji,3353,0,0,4,4,0.0%,23m
4085,2,lllllllllll,3352,331,14,12,26,53.8%,19m
4085,3,[DMRc]Tricker,3352,0,0,1,1,0.0%,31m
4085,3,你不要过来啊,3352,0,0,1,1,0.0%,34m
4085,3,[时空巡逻队]大神官,3352,0,0,1,1,0.0%,7m
4089,3,jackchengkin,3351,1518,166,162,328,50.6%,7m
4089,3,[绝世高手]龙耀寰宇,3351,726,29,20,49,59.2%,2m
4089,2,[DK龍]暗黑行为艺术家万,3351,308,11,15,26,42.3%,22m
4089,3,[KPL1vc]Violet,3351,210,8,9,17,47.1%,23m
4089,3,[HUC妖皇]运行者,3351,120,6,2,8,75.0%,13m
4089,3,刺蛇没有刺,3351,118,5,6,11,45.5%,22m
4089,3,普罗德摩尔海军,3351,0,1,0,1,100.0%,23m
4089,3,ucenen,3351,0,1,0,1,100.0%,24m
4089,1,多啦个梦,3351,0,0,2,2,0.0%,24m
4098,3,[Rich]andyoungcrew,3350,578,21,17,38,55.3%,2m
4098,2,斩服丶缠流子,3350,177,8,3,11,72.7%,4m
4098,3,[斯巴达血战团]JohnAnder,3350,176,7,4,11,63.6%,32m
4098,3,Paradise,3350,58,2,1,3,66.7%,21m
4098,3,毒爆能买来放生吗,3350,0,1,0,1,100.0%,37m
4098,3,slimeSB,3350,30,1,2,3,33.3%,12m
4104,2,[KPG]Muzzle,3349,1535,279,273,552,50.5%,40m
4104,2,[CnNami]gleam,3349,176,63,57,120,52.5%,6m
4104,2,一忘情一,3349,179,8,3,11,72.7%,10m
4104,3,Tattoo,3349,60,3,5,8,37.5%,30m
4104,3,Bonnenuit,3349,0,0,1,1,0.0%,8m
4109,3,TomYan,3348,1106,166,142,308,53.9%,22m
4109,2,MagicBlue,3348,1435,129,134,263,49.0%,24m
4109,3,xinzealot,3348,313,14,7,21,66.7%,32m
4109,3,sunlight,3348,54,3,3,6,50.0%,24m
4109,3,Artanis,3348,30,2,2,4,50.0%,10m
4109,3,[红魔SDEP]古龙顶端宝石虫,3348,0,1,0,1,100.0%,23m
4109,3,[江南剑客]Swordsman,3348,0,1,0,1,100.0%,17m
4109,3,朽木冬子,3348,0,1,1,2,50.0%,3m
4109,3,[谐神]Requisition,3348,0,0,2,2,0.0%,18m
4118,3,[Tinnba]IIIIIIIIII,3347,552,22,10,32,68.8%,13m
4118,3,shadowkiller,3347,185,10,1,11,90.9%,12m
4118,3,六翼的炽天使,3347,97,6,0,6,100.0%,12m
4118,1,地狱咆哮,3347,0,4,1,5,80.0%,21m
4118,3,泳于樱色之海,3347,133,4,3,7,57.1%,6m
4118,2,[4399]IlllIIlIIllI,3347,117,3,2,5,60.0%,9m
4118,3,[挚爱白蛇]小白快到我怀里来,3347,0,1,0,1,100.0%,31m
4118,3,TWSZAN,3347,0,1,0,1,100.0%,16m
4118,3,[火车烧基地]八两,3347,14,1,7,8,12.5%,20m
4127,3,[混元星际小队]那梦境太过深刻,3346,1121,65,62,127,51.2%,32m
4127,2,llllllllllll,3346,1106,41,43,84,48.8%,17m
4127,3,放大招的都是弟弟,3346,166,7,0,7,100.0%,10m
4127,3,superseven,3346,151,7,3,10,70.0%,7m
4127,3,[肌肉]常师傅千锤百炼,3346,58,2,7,9,22.2%,28m
4127,3,JianGLai,3346,0,0,1,1,0.0%,2m
4133,2,快乐之裤,3345,592,22,29,51,43.1%,12m
4133,3,发椿人,3345,500,21,7,28,75.0%,17m
4133,2,[今天超市打折]ALOOP,3345,148,11,14,25,44.0%,21m
4133,3,潇洒,3345,250,9,4,13,69.2%,7m
4133,3,aqa,3345,130,6,2,8,75.0%,29m
4133,3,[白银圣斗士]andrew,3345,139,6,3,9,66.7%,10m
4133,3,[谐神]Etihw,3345,97,5,1,6,83.3%,21m
4133,3,[ZJU]Tuymango,3345,30,2,2,4,50.0%,11m
4133,3,轻松,3345,60,2,3,5,40.0%,4m
4142,2,[鲲之大]金三胖,3344,1484,92,93,185,49.7%,6m
4142,2,炸鸡叔,3344,267,12,18,30,40.0%,28m
4142,3,一波先生,3344,206,8,12,20,40.0%,3m
4142,3,VivaLaVida,3344,60,3,2,5,60.0%,24m
4142,3,[只会Rush]水果猎人,3344,0,0,4,4,0.0%,29m
4147,2,[我们是无敌的]呆呆,3343,1552,90,108,198,45.5%,2m
4147,2,[随便]waez,3343,1033,61,60,121,50.4%,25m
4147,3,YuNMaster,3343,1028,44,29,73,60.3%,23m
4147,3,[杀马特集中营]三球,3343,504,18,21,39,46.2%,17m
4147,2,Charles,3343,384,14,18,32,43.8%,17m
4147,3,[PTB]King,3343,152,9,10,19,47.4%,17m
4147,2,Purerape,3343,94,1,3,4,25.0%,3m
4154,3,fxm,3342,229,17,9,26,65.4%,32m
4154,3,上户彩,3342,266,12,6,18,66.7%,5m
4154,1,史诗之鼠,3342,235,11,6,17,64.7%,14m
4154,3,侧耳倾听,3342,58,2,2,4,50.0%,27m
4154,3,[Encore]有杯牛奶,3342,30,1,3,4,25.0%,7m
4154,3,[幽明异路]白狼,3342,0,0,1,1,0.0%,35m
4154,3,IIIIIIIIIIII,3342,0,0,1,1,0.0%,2m
4154,3,[浪啊浪]运气游戏输赢看淡,3342,0,0,1,1,0.0%,2m
4162,3,Oneminute,3341,161,6,4,10,60.0%,2m
4162,3,zardlike,3341,152,6,10,16,37.5%,22m
4162,3,[渣男]AirRayPotter,3341,58,3,5,8,37.5%,5m
4162,3,somnosz,3341,60,2,2,4,50.0%,4m
4162,3,[青铜树]Tdctpmu,3341,0,0,1,1,0.0%,20m
4162,3,[TDtr]IMBxiaoxi,3341,0,0,4,4,0.0%,31m
4168,3,Hazy,3340,999,71,69,140,50.7%,34m
4168,3,[Rsh]AKAswiper,3340,86,4,0,4,100.0%,16m
4168,1,[AOSmt]白兔糖,3340,136,3,10,13,23.1%,33m
4168,3,Casinos,3340,0,1,0,1,100.0%,16m
4168,3,[神之长子1]king,3340,30,1,4,5,20.0%,13m
4173,3,[扫黄]野人教我防隐刀,3339,898,36,27,63,57.1%,25m
4173,2,[MDN]麻烦让我发育一下,3339,662,31,36,67,46.3%,35m
4173,1,圆梦仙人,3339,0,4,1,5,80.0%,1h
4173,2,真男人不操作,3339,0,1,0,1,100.0%,4m
4177,2,[大宇宙时代]通天鸣彻个头,3338,1533,384,393,777,49.4%,12m
4177,2,阿白,3338,474,20,19,39,51.3%,13m
4177,3,[阳航一生推]绝望中的歌,3338,439,18,4,22,81.8%,11m
4177,3,Bxcn,3338,456,17,15,32,53.1%,34m
4177,3,IIIIIIIIIIII,3338,168,7,3,10,70.0%,7m
4177,3,InNEo,3338,0,0,5,5,0.0%,29m
4183,3,foe,3337,684,63,59,122,51.6%,3m
4183,3,[哈莉奎茵丶]MarScarrY,3337,971,42,23,65,64.6%,18m
4183,3,[六芒星s]ALIVEING,3337,488,18,18,36,50.0%,28m
4183,2,[色割脖]Hellhound,3337,331,11,15,26,42.3%,33m
4183,3,不懂装懂,3337,119,6,2,8,75.0%,3m
4183,3,[XJTU]风檐展书读,3337,30,2,1,3,66.7%,25m
4183,1,[TSU109]cisu,3337,95,1,1,2,50.0%,3m
4190,2,[Conque]顺顺,3336,1466,277,281,558,49.6%,23m
4190,2,[一亿只蟑螂]你们最好包夹我,3336,1590,139,133,272,51.1%,21m
4190,3,小羊羊,3336,1472,58,54,112,51.8%,6m
4190,2,我来弄洪七公,3336,551,57,60,117,48.7%,21m
4190,3,Winter,3336,650,50,24,74,67.6%,22m
4190,2,[我们菜的1b]北虚川,3336,638,31,42,73,42.5%,25m
4190,3,Meanwcharon,3336,370,14,15,29,48.3%,12m
4190,3,FirstKiller,3336,152,6,3,9,66.7%,20m
4190,3,fgjmk,3336,86,3,3,6,50.0%,18m
4190,3,小强尼莫,3336,0,1,0,1,100.0%,9m
4190,3,Haeta,3336,0,1,0,1,100.0%,4m
4190,3,混元星际太极门,3336,0,1,0,1,100.0%,4m
4190,3,猎妈人,3336,0,1,0,1,100.0%,32m
4190,3,我很随便,3336,0,0,1,1,0.0%,3m
4204,2,纸鸢,3335,1605,225,221,446,50.4%,20m
4204,2,Max,3335,1078,133,110,243,54.7%,36m
4204,2,Flashing,3335,1547,95,104,199,47.7%,10m
4204,3,[玫瑰十字会]沙漠风暴战神,3335,500,29,21,50,58.0%,29m
4204,3,[自贡冷吃兔]Hosino,3335,339,13,9,22,59.1%,24m
4204,3,[孙一峰小迷妹]你星际打的针不戳,3335,252,10,7,17,58.8%,16m
4204,3,追猎骑脸怎么输,3335,97,5,1,6,83.3%,16m
4204,3,[LuckyE]Aeroblop,3335,86,3,1,4,75.0%,20m
4204,3,[Kids]kid,3335,58,3,1,4,75.0%,5m
4204,3,[喵星人]我猥琐我快乐,3335,0,1,0,1,100.0%,25m
4204,3,[嗑药小分队]llllllllllll,3335,0,1,0,1,100.0%,16m
4204,3,[传说萌娘团]monarch,3335,0,1,0,1,100.0%,18m
4204,3,[殿手F91]她似秋风,3335,0,0,1,1,0.0%,19m
4204,3,黑哥,3335,0,0,3,3,0.0%,8m
4204,3,[星际传销组织]我不玩英雄联盟,3335,0,0,3,3,0.0%,18m
4219,3,华皇旋影,3334,1424,58,47,105,55.2%,4m
4219,3,遂宁孙一峰,3334,402,14,14,28,50.0%,18m
4219,2,Reborn,3334,112,4,3,7,57.1%,44m
4219,3,[限定款RBQ]吊锤一切花里古哨,3334,0,1,0,1,100.0%,23m
4219,3,lucky,3334,0,1,0,1,100.0%,31m
4219,3,[飞云之上]孤独的影子,3334,0,1,0,1,100.0%,10m
4219,3,孙哥的最爱佳慧,3334,30,1,2,3,33.3%,20m
4226,3,[KPG]cjy,3333,385,13,20,33,39.4%,22m
4226,3,自信枪兵,3333,200,8,8,16,50.0%,6m
4228,2,天空,3332,1241,184,174,358,51.4%,40m
4228,2,杭电四幺,3332,1393,92,93,185,49.7%,7m
4228,2,mike,3332,1113,79,69,148,53.4%,32m
4228,2,bosssos,3332,864,36,33,69,52.2%,30m
4228,1,[寻风]SanFa,3332,255,12,6,18,66.7%,11m
4228,1,kill,3332,284,12,8,20,60.0%,28m
4228,2,停尸房毛宗,3332,156,4,10,14,28.6%,17m
4228,3,BOETR,3332,0,1,0,1,100.0%,25m
4228,3,NUMB,3332,0,1,0,1,100.0%,17m
4228,3,当代恶臭青年,3332,0,0,2,2,0.0%,13m
4238,3,different,3331,1485,119,105,224,53.1%,32m
4238,2,帅到被人骂,3331,803,74,73,147,50.3%,2m
4238,2,默默然,3331,1204,56,50,106,52.8%,6m
4238,3,baqi,3331,1151,46,45,91,50.5%,35m
4238,3,lllllllllIII,3331,558,24,16,40,60.0%,16m
4238,3,knk,3331,332,12,9,21,57.1%,3m
4238,3,[山东滨州]IIIIIIIIIIII,3331,86,3,4,7,42.9%,34m
4238,3,欧颜之蠢菜鸟,3331,60,2,4,6,33.3%,31m
4238,3,VOID,3331,30,1,1,2,50.0%,8m
4238,3,[吹个牛B而已]星际争霸嘴上过,3331,0,1,3,4,25.0%,13m
4238,3,[华东师大]少龙,3331,0,0,1,1,0.0%,24m
4249,2,coconut,3330,895,51,46,97,52.6%,24m
4249,1,[刀锋男皇]尼哥杀手,3330,278,11,8,19,57.9%,16m
4249,3,[ESKT]星际拿破仑,3330,282,10,11,21,47.6%,10m
4249,3,[超电磁炉]栗山未来,3330,140,6,1,7,85.7%,29m
4249,1,[TMUSC2]Empress,3330,157,3,3,6,50.0%,8m
4249,3,Zest,3330,30,2,0,2,100.0%,2m
4249,3,[上古世纪]ylnx,3330,58,2,2,4,50.0%,9m
4249,3,[听雨轩]CrazyEd,3330,0,0,3,3,0.0%,16m
4257,3,我从不狗人,3329,908,41,20,61,67.2%,2m
4257,3,[社会]枫钟同年,3329,328,14,10,24,58.3%,17m
4257,3,[战意不熄]叹云兮,3329,346,13,14,27,48.1%,27m
4257,3,Nob,3329,121,6,1,7,85.7%,14m
4257,3,[SRD]youzics,3329,0,1,0,1,100.0%,31m
4257,3,[最菜战队]我帅打我,3329,0,0,3,3,0.0%,18m
4263,3,[梅洛fans]SIns,3328,166,7,0,7,100.0%,17m
4263,3,[FJUT]pimba,3328,88,3,3,6,50.0%,16m
4263,3,Hamaliel,3328,30,2,2,4,50.0%,11m
4263,3,[Potato]SCA,3328,30,1,1,2,50.0%,10m
4263,3,[东部战区]战场原黑仪,3328,0,0,1,1,0.0%,4m
4268,2,影末,3327,1506,296,292,588,50.3%,6m
4268,3,Michael,3327,1588,268,251,519,51.6%,13m
4268,2,LeeMaybee,3327,992,66,65,131,50.4%,21m
4268,2,mkz,3327,566,46,37,83,55.4%,17m
4268,3,冷忆,3327,384,17,12,29,58.6%,27m
4268,3,[暴雪十五队]LXPartinG,3327,352,15,8,23,65.2%,24m
4268,3,徘徊,3327,153,8,2,10,80.0%,11m
4268,3,llllllllllll,3327,120,5,7,12,41.7%,19m
4268,3,Light,3327,58,3,1,4,75.0%,2m
4268,3,[哔哩哔哩乾杯]情曦,3327,58,3,2,5,60.0%,31m
4268,3,小心渣男,3327,30,2,0,2,100.0%,25m
4268,3,快乐,3327,97,1,1,2,50.0%,37m
4268,3,[莽夫智障团]Ender,3327,0,0,1,1,0.0%,25m
4281,3,无法阻挡,3326,1045,83,71,154,53.9%,24m
4281,3,MKKKKKKK,3326,58,2,3,5,40.0%,24m
4281,3,IIIIIIIIIIII,3326,0,1,0,1,100.0%,17m
4281,3,Viva,3326,0,0,1,1,0.0%,22m
4281,3,[太微玉清宫]乐山黄旭东,3326,0,0,1,1,0.0%,36m
4281,3,江上舟,3326,0,0,3,3,0.0%,5m
4287,3,Kidult,3325,1205,93,87,180,51.7%,7m
4287,2,冥想神族鸦喵喵,3325,1114,60,66,126,47.6%,33m
4287,2,[i马士]YuanBaicai,3325,633,50,44,94,53.2%,13m
4287,3,小怪兽,3325,376,15,14,29,51.7%,35m
4287,3,时时时时时时说,3325,294,11,8,19,57.9%,10m
4287,3,IlIlIIIlllIl,3325,114,5,2,7,71.4%,25m
4287,3,wwwww,3325,86,4,1,5,80.0%,27m
4287,3,[刀使之巫女]衛藤可奈美,3325,116,4,4,8,50.0%,13m
4287,3,[卡达鲁卡司]沙特毒爆虫,3325,30,2,0,2,100.0%,4m
4287,2,Rogue,3325,117,2,7,9,22.2%,4m
4287,3,[Ziyan]Wayne,3325,0,1,0,1,100.0%,32m
4287,3,[Nostop]小羊羊,3325,0,1,0,1,100.0%,5m
4287,3,[李少牛b]Yellow,3325,30,1,3,4,25.0%,32m
4300,2,DarlinG,3324,1437,124,134,258,48.1%,14m
4300,2,[红萌馆]badapple,3324,771,60,62,122,49.2%,2m
4300,3,[OB丶]浪荡少女橘子酱,3324,214,9,0,9,100.0%,34m
4300,3,运气是实力的全部,3324,0,3,2,5,60.0%,19m
4300,3,那逼有炸,3324,0,0,1,1,0.0%,18m
4305,2,digua,3323,1318,113,99,212,53.3%,19m
4305,2,[KPG]ykyk,3323,1452,96,97,193,49.7%,24m
4305,3,class,3323,406,26,15,41,63.4%,10m
4305,3,Jefry,3323,297,14,9,23,60.9%,13m
4305,3,[唯有]超电磁炮永世长存,3323,283,13,9,22,59.1%,11m
4305,3,Tinker,3323,182,10,6,16,62.5%,32m
4305,3,[PImba不]小小,3323,60,2,8,10,20.0%,8m
4305,3,Destiny,3323,30,1,1,2,50.0%,5m
4305,3,[不会散枪兵]风中追沙,3323,30,1,3,4,25.0%,24m
4314,3,[Riders]嗜血红手,3322,674,25,27,52,48.1%,17m
4314,3,白门楼建设委员会,3322,86,3,2,5,60.0%,22m
4314,1,[Dracoi]sqrtthree,3322,0,1,0,1,100.0%,1h
4314,3,[LFR]神经奶爸,3322,0,0,1,1,0.0%,34m
4318,3,放进去自己动,3321,62,4,3,7,57.1%,20m
4318,3,[哔哩哔哩杯乾]ZYX,3321,0,1,0,1,100.0%,22m
4318,3,费总,3321,0,0,1,1,0.0%,37m
4321,3,[浪啊浪]贵州生物老师,3320,1120,71,61,132,53.8%,10m
4321,2,LimpBizkit,3320,867,70,61,131,53.4%,32m
4321,2,[Hnlg]灵魂当铺,3320,723,70,66,136,51.5%,36m
4321,3,[萌新保护协议]屑老板,3320,244,9,4,13,69.2%,18m
4321,3,胸不大会暖床,3320,190,8,0,8,100.0%,20m
4321,3,[我瘾大技术差]呆萌的探姬,3320,179,7,5,12,58.3%,25m
4321,3,星际二五仔,3320,155,6,10,16,37.5%,17m
4321,3,[北京城管]小虫子,3320,118,4,6,10,40.0%,21m
4321,3,[小鸡屠宰场9]ssssdadwaf,3320,30,2,0,2,100.0%,26m
4321,3,Critical,3320,30,1,1,2,50.0%,16m
4321,3,LXPITAYA,3320,0,0,2,2,0.0%,3m
4332,3,[暴雪嘉年华]星际争爸,3319,1597,85,82,167,50.9%,24m
4332,1,wuliwu,3319,259,13,4,17,76.5%,35m
4332,3,[Satan9]异次元的校长,3319,218,8,3,11,72.7%,37m
4332,3,伽马星座,3319,80,7,3,10,70.0%,25m
4332,3,[PITB]Dylan,3319,116,5,5,10,50.0%,20m
4332,3,[Beasty]废柴叔,3319,0,1,0,1,100.0%,37m
4332,3,[lmpala]EinXh,3319,30,1,2,3,33.3%,30m
4332,3,BOG,3319,0,0,1,1,0.0%,3m
4332,3,[术力口拆迁组]飞刀客,3319,0,0,1,1,0.0%,20m
4341,2,llllllllllll,3318,1514,206,198,404,51.0%,25m
4341,3,Mars,3318,1176,44,43,87,50.6%,18m
4341,3,[奥鲁斯的人选]少校,3318,936,42,28,70,60.0%,3m
4341,3,TIMBA,3318,356,14,1,15,93.3%,30m
4341,3,雪之下雪乃,3318,251,9,6,15,60.0%,34m
4341,3,[UIR]NOREVILOPSC,3318,114,4,2,6,66.7%,27m
4341,3,[半个菜鸟II]ForeverQi,3318,0,1,0,1,100.0%,18m
4341,2,燃烧的卵毛,3318,0,1,0,1,100.0%,9m
4341,3,FunGuy,3318,0,1,0,1,100.0%,36m
4341,3,太上忘情豆,3318,0,1,1,2,50.0%,37m
4341,3,[天使的3p]DKJ,3318,30,1,2,3,33.3%,18m
4341,3,起峰了,3318,30,1,2,3,33.3%,9m
4341,3,[济南]黄旭东,3318,0,0,1,1,0.0%,19m
4341,3,InLife,3318,0,0,1,1,0.0%,2m
4341,3,MIKEzhang,3318,0,0,1,1,0.0%,27m
4356,3,[深远Hist]Wakatsuki,3317,1305,317,300,617,51.4%,3m
4356,3,xingzhizi,3317,144,6,2,8,75.0%,22m
4356,3,lastwhisper,3317,144,6,3,9,66.7%,34m
4356,3,[从阴影中现身]逐火之荧,3317,144,6,6,12,50.0%,32m
4356,3,西湖雅座有请,3317,116,5,4,9,55.6%,18m
4356,2,哈哈哈瞎李哈哈哈,3317,93,4,4,8,50.0%,33m
4356,3,[超级大谐星]VHwy,3317,30,2,5,7,28.6%,29m
4356,3,LEAF,3317,0,0,1,1,0.0%,18m
4364,3,[闪电伍连鞭]奶茶壶,3316,1168,43,42,85,50.6%,23m
4364,3,一条二十五元的狗,3316,509,22,20,42,52.4%,4m
4364,3,[ZJU]Moonlight,3316,499,20,7,27,74.1%,35m
4364,2,[污萌哒吉祥物]坎德鸡儿颖梆梆,3316,492,17,23,40,42.5%,22m
4364,3,[舞铲阶级]专打艾尔刁民,3316,252,10,8,18,55.6%,29m
4364,3,堕落丿月痕,3316,88,4,4,8,50.0%,10m
4364,3,不拿拿,3316,58,2,3,5,40.0%,25m
4364,3,隔壁黄瑟,3316,0,1,0,1,100.0%,3m
4364,3,[鸽子窝]TEMplar,3316,0,1,0,1,100.0%,32m
4364,3,贼一一,3316,0,1,1,2,50.0%,16m
4364,3,[PITB]珞珈山炮王,3316,30,1,3,4,25.0%,27m
4364,3,[传说之下]Moon,3316,0,0,1,1,0.0%,37m
4364,3,[莽成一匹野马]Ryan,3316,0,0,1,1,0.0%,14m
4364,3,想好名字在重新改,3316,0,0,2,2,0.0%,19m
4378,3,永远有多远嘞,3315,1541,209,182,391,53.5%,16m
4378,3,[IMRTS]傲然诶,3315,1058,40,40,80,50.0%,22m
4378,3,杜力终结者,3315,359,36,36,72,50.0%,40m
4378,3,[Trow]Zone,3315,720,28,26,54,51.9%,34m
4378,3,monokuma,3315,368,20,16,36,55.6%,25m
4378,3,我是鸡,3315,0,1,0,1,100.0%,20m
4378,3,hawsud,3315,0,1,0,1,100.0%,23m
4378,3,暗宙晨星,3315,0,1,0,1,100.0%,35m
4378,3,IoriKing,3315,0,1,1,2,50.0%,34m
4378,3,Leslie,3315,30,1,1,2,50.0%,30m
4378,3,[holyhp]Gostop,3315,0,0,1,1,0.0%,24m
4378,3,[浪啊浪]SCPLAYER,3315,0,0,1,1,0.0%,30m
4378,3,Blackjack,3315,0,0,1,1,0.0%,7m
4391,3,福建任贤齐,3314,751,76,59,135,56.3%,35m
4391,3,[艾尔大断电]ziposcar,3314,474,19,10,29,65.5%,35m
4391,3,[哔翻天梯鸡]新型冠状病毒,3314,176,7,7,14,50.0%,17m
4391,3,[Shawk]Lanthanum,3314,120,4,4,8,50.0%,11m
4391,3,[东大电竞]雪之下雪乃,3314,30,2,0,2,100.0%,16m
4391,3,[Tilt]SorryMaker,3314,0,1,0,1,100.0%,22m
4391,3,[影塔噜塔萨哒]东风橘,3314,0,0,1,1,0.0%,32m
4391,3,[今生必干花开]Forgettable,3314,0,0,1,1,0.0%,34m
4399,2,[KPG2]西门大飞,3313,1524,497,474,971,51.2%,33m
4399,2,萌新小工蜂,3313,1213,151,163,314,48.1%,29m
4399,2,[Helens]destiny,3313,1073,53,62,115,46.1%,10m
4399,3,潜水员先生,3313,58,6,2,8,75.0%,14m
4399,3,[TCP]Pureyellow,3313,118,5,3,8,62.5%,25m
4399,3,[bldm]abeisc,3313,30,2,2,4,50.0%,20m
4399,3,深圳孙一峰,3313,0,1,0,1,100.0%,10m
4399,3,漓雨糖,3313,0,1,0,1,100.0%,4m
4399,3,恋心乄恋情,3313,30,1,3,4,25.0%,32m
4408,3,IIIIIIIIIIII,3312,1400,110,89,199,55.3%,2m
4408,2,[学姐赛高]老年人也要打生化,3312,288,58,66,124,46.8%,4m
4408,2,Xuan,3312,808,33,39,72,45.8%,18m
4408,2,[白银联盟]壮壮,3312,578,23,27,50,46.0%,13m
4408,2,暴雪令人失望,3312,389,15,18,33,45.5%,3m
4408,2,[Beasty]揭世白,3312,332,12,20,32,37.5%,32m
4408,2,爷爷,3312,91,2,0,2,100.0%,19m
4415,2,[Holyam]云逸风,3311,1476,171,174,345,49.6%,8m
4415,2,[三四]哾鱼,3311,1141,61,61,122,50.0%,6m
4415,3,turion,3311,236,39,32,71,54.9%,34m
4415,3,[NOBO]拂晓之光,3311,534,21,15,36,58.3%,3m
4415,3,[TeamCD]我不会玩,3311,382,15,9,24,62.5%,21m
4415,3,[鸡王争爸]Mseveneight,3311,141,4,1,5,80.0%,37m
4415,3,向井户爱花,3311,0,0,1,1,0.0%,5m
4415,3,[CNboi]线影,3311,0,0,1,1,0.0%,11m
4423,3,[草帽海贼团]AolaOnePiece,3310,429,125,119,244,51.2%,24m
4423,3,cucMemo,3310,1529,74,61,135,54.8%,20m
4423,2,[谐神]southred,3310,707,51,57,108,47.2%,14m
4423,3,[叔叔不要啊]野怪怪怪怪怪,3310,980,37,34,71,52.1%,17m
4423,3,[牌面]DawningBreak,3310,170,4,4,8,50.0%,3m
4423,1,[噩梦跳跳]猪肉臊子刀削面,3310,0,3,2,5,60.0%,33m
4423,3,[Csquad]小鸟游六花的姐夫,3310,0,0,1,1,0.0%,20m
4423,3,[刺蛇互助协会]DrawingSword,3310,0,0,1,1,0.0%,24m
4431,3,[五月花]DYDY,3309,1464,198,186,384,51.6%,34m
4431,3,人帅何须艾迪拽,3309,852,32,33,65,49.2%,36m
4431,2,[HoA]四季夏目,3309,536,19,28,47,40.4%,24m
4431,3,金角大王,3309,178,7,7,14,50.0%,3m
4431,1,亦白,3309,0,4,1,5,80.0%,39m
4431,3,Leaves,3309,36,3,3,6,50.0%,9m
4431,3,[古剑魂]熊猫,3309,0,1,0,1,100.0%,16m
4431,3,[目標諾森德]那冬宝用力嗦,3309,0,1,0,1,100.0%,22m
4431,3,[为了艾萌酱]敏女王的虫群,3309,0,1,6,7,14.3%,36m
4440,2,想飞的小鱼,3308,994,129,123,252,51.2%,17m
4440,2,greehand,3308,1525,123,114,237,51.9%,7m
4440,2,Anger,3308,449,37,33,70,52.9%,34m
4440,3,jolteon,3308,376,31,28,59,52.5%,7m
4440,3,[RaMoC]单人浪漫,3308,512,21,19,40,52.5%,7m
4440,3,[鬼谷]离天,3308,518,20,21,41,48.8%,13m
4440,1,[Storme]Mourning,3308,152,5,1,6,83.3%,4m
4440,3,[LGMG]GozZ,3308,30,2,0,2,100.0%,36m
4440,3,[丨SLT丨]Yurisa,3308,0,1,1,2,50.0%,17m
4440,1,[sawiv]likesc,3308,0,0,1,1,0.0%,42m
4440,3,[gusl]AlphaStar,3308,0,0,1,1,0.0%,23m
4451,3,Crucifix,3307,1607,225,210,435,51.7%,34m
4451,3,[无须奉天]这就是你的运营吗,3307,1559,125,110,235,53.2%,20m
4451,3,[练出来了协会]练出来了,3307,420,16,16,32,50.0%,21m
4451,3,如梦令,3307,220,9,4,13,69.2%,4m
4451,3,[邪恶化身]醉饮千殇,3307,240,9,5,14,64.3%,2m
4451,2,[星舟环宇]GameKiller,3307,4,2,7,9,22.2%,12m
4451,3,Mike,3307,18,1,3,4,25.0%,13m
4458,3,[NLHR]叄点一客,3306,1619,374,337,711,52.6%,23m
4458,2,LuckyMan,3306,1433,85,86,171,49.7%,14m
4458,3,小代,3306,1408,60,41,101,59.4%,11m
4458,3,[红色锤镰]天启,3306,1156,44,45,89,49.4%,3m
4458,3,[目標諾森德]哈哈哈拉开,3306,684,27,22,49,55.1%,28m
4458,3,白蔷薇,3306,375,14,9,23,60.9%,15m
4458,3,[BUPTNB]LoveRain,3306,342,12,12,24,50.0%,24m
4458,3,[Beasty]白给的李遥尘,3306,286,11,7,18,61.1%,2m
4458,1,国服阴间人真的多,3306,186,4,5,9,44.4%,21m
4458,3,[妹控万岁]妹控都是好人,3306,122,3,4,7,42.9%,30m
4458,3,[尹志平来运营]彪悍的小章,3306,58,2,5,7,28.6%,28m
4458,3,[黑灬手灬党]饕餮,3306,0,1,0,1,100.0%,4m
4458,3,SSSS,3306,0,1,0,1,100.0%,34m
4458,3,fanzhong,3306,30,1,1,2,50.0%,4m
4458,3,[RTSGo]Dacret,3306,0,0,1,1,0.0%,4m
4473,3,[LLLLL]KillMeBaby,3305,308,12,14,26,46.2%,32m
4473,3,[0610]nLak,3305,168,7,1,8,87.5%,31m
4473,3,探机,3305,186,7,12,19,36.8%,31m
4473,2,[Z10]叉叉,3305,218,7,18,25,28.0%,29m
4473,3,[love西瓜]胸奴人,3305,180,6,9,15,40.0%,31m
4473,2,[一等星]耂婆霞,3305,204,6,11,17,35.3%,18m
4473,2,Liz,3305,175,5,6,11,45.5%,20m
4473,3,养生星际,3305,62,3,3,6,50.0%,24m
4473,3,害羞的西兰花,3305,0,3,3,6,50.0%,11m
4473,3,[噶姐美如花]花枝,3305,30,2,0,2,100.0%,31m
4473,3,[永磁帮]牛迪,3305,30,2,0,2,100.0%,24m
4484,2,工蜂,3304,1379,259,267,526,49.2%,10m
4484,3,LQH,3304,1589,131,106,237,55.3%,25m
4484,3,[这就是天t]Tocqueville,3304,380,14,10,24,58.3%,34m
4484,3,yozomi,3304,186,7,11,18,38.9%,11m
4484,1,最佳损友,3304,0,4,1,5,80.0%,9m
4484,3,[哔翻天梯鸡]Guile,3304,30,1,3,4,25.0%,17m
4484,2,[极楽净土]卖萌的肉包子,3304,0,0,1,1,0.0%,24m
4491,3,naan,3303,1552,207,199,406,51.0%,24m
4491,3,KOyours,3303,603,26,18,44,59.1%,17m
4491,3,scientist,3303,321,18,14,32,56.2%,12m
4491,3,[小米集团]warpdrive,3303,221,6,11,17,35.3%,31m
4491,3,[龙卷风]Ganriner,3303,0,1,0,1,100.0%,32m
4491,3,[天雪]随波逐流,3303,0,1,0,1,100.0%,9m
4491,3,[HK丶S]醉后反杀哥哥,3303,0,1,0,1,100.0%,21m
4491,3,兰登,3303,30,1,1,2,50.0%,9m
4491,2,HandSome,3303,92,1,2,3,33.3%,11m
4491,3,[苟逼无敌]忧伤的墙头草,3303,0,0,2,2,0.0%,12m
4491,3,酷酷朝南,3303,0,0,2,2,0.0%,10m
4502,2,胡曰鬼,3302,1535,283,278,561,50.4%,19m
4502,3,生菜,3302,517,24,19,43,55.8%,26m
4502,1,[Sc养老]切尔诺贝利,3302,226,9,5,14,64.3%,16m
4502,1,如东掘港人,3302,46,5,2,7,71.4%,20m
4502,3,[gusl]owenbin,3302,118,4,6,10,40.0%,36m
4502,3,神陈之心,3302,0,1,0,1,100.0%,5m
4502,3,耿直性不行,3302,0,1,1,2,50.0%,31m
4502,3,[SK]弱者心态,3302,30,1,3,4,25.0%,12m
4502,3,叫我小七就行,3302,0,0,1,1,0.0%,17m
4502,3,humudne,3302,0,0,1,1,0.0%,15m
4512,2,[IMG]TheMan,3301,980,172,171,343,50.1%,13m
4512,2,ihlown,3301,1561,107,102,209,51.2%,34m
4512,3,CLAAFresno,3301,1587,82,69,151,54.3%,29m
4512,2,刀大杀人多,3301,737,41,42,83,49.4%,21m
4512,3,[小鸡屠宰场9]黑黑黑,3301,603,24,21,45,53.3%,40m
4512,3,lzzzz,3301,568,21,22,43,48.8%,36m
4512,2,Yifan,3301,351,18,15,33,54.5%,15m
4512,3,[社会]风中童年,3301,390,15,11,26,57.7%,35m
4512,3,IIIIIIIIIIII,3301,30,2,0,2,100.0%,34m
4512,3,[ToHo]涛哥,3301,0,0,1,1,0.0%,12m
4512,3,长野原美绪,3301,0,0,1,1,0.0%,25m
4523,3,WIZZID,3300,1478,68,58,126,54.0%,34m
4523,2,[Beasty]一切都是为了兄弟,3300,1145,63,74,137,46.0%,6m
4523,3,rider,3300,537,34,25,59,57.6%,23m
4523,3,IIIIIIII,3300,316,21,18,39,53.8%,29m
4523,3,我大意了啊,3300,220,18,10,28,64.3%,35m
4523,2,STXBoGus,3300,231,9,7,16,56.2%,10m
4523,3,正大光明,3300,161,5,8,13,38.5%,4m
4523,2,death,3300,139,3,2,5,60.0%,10m
4523,3,牛奶是个萌妹子,3300,0,1,0,1,100.0%,31m
4523,3,[Hs浪]单机狂魔,3300,95,1,1,2,50.0%,27m
4523,3,老工人去哪了,3300,0,0,1,1,0.0%,7m
4523,1,SIX,3300,0,0,5,5,0.0%,20m
4535,2,[SW]冰封剑痕,3299,1557,262,255,517,50.7%,24m
4535,3,IIIIIIIIIII,3299,1656,71,68,139,51.1%,12m
4535,3,越天,3299,180,7,6,13,53.8%,31m
4535,3,山东吴彦祖,3299,174,7,9,16,43.8%,17m
4539,2,[Fe3o4]windeaves,3298,1198,225,227,452,49.8%,17m
4539,3,IIIIIIIII,3298,1054,57,35,92,62.0%,19m
4539,3,llllllllllll,3298,1045,52,57,109,47.7%,8m
4539,3,[老头星际]GGBreaker,3298,434,19,10,29,65.5%,2m
4539,3,[Hist]又是寂寞,3298,254,10,11,21,47.6%,3m
4539,3,[GKDQLG]xzm,3298,114,4,3,7,57.1%,22m
4539,3,[DMRc]Dedicated,3298,60,3,2,5,60.0%,13m
4539,1,[H1st]帅气小枫,3298,0,1,0,1,100.0%,40m
4539,3,其实我不坏,3298,0,0,1,1,0.0%,9m
4539,3,[粪坑大队]Dango,3298,0,0,3,3,0.0%,18m
4549,2,Fish,3297,900,71,80,151,47.0%,14m
4549,3,凡雪之属,3297,133,12,7,19,63.2%,33m
4549,3,[利兹与青鸟]Chen,3297,199,7,5,12,58.3%,31m
4549,3,BBB,3297,165,5,6,11,45.5%,16m
4549,3,穆拉丁,3297,90,3,4,7,42.9%,8m
4549,3,[温柔兔公主]快乐星际,3297,30,2,2,4,50.0%,9m
4549,1,[1232]亡灵,3297,0,1,4,5,20.0%,1h
4549,3,[NZNZ]IIIIIIIIIIII,3297,0,0,1,1,0.0%,31m
4549,3,[楛玲虫群]XelNaga,3297,0,0,1,1,0.0%,20m
4549,3,[斯巴达血战团]空一座丶孤城,3297,0,0,1,1,0.0%,28m
4559,3,[匹特拉姆]蛇屠箱,3296,116,4,4,8,50.0%,11m
4559,3,[白银联盟]havoc,3296,58,3,0,3,100.0%,3m
4559,3,Allen,3296,60,3,2,5,60.0%,16m
4559,3,[对面瞎子你好]辻丨指,3296,0,0,4,4,0.0%,10m
4563,1,喜欢殴打虫族,3295,1504,260,220,480,54.2%,11m
4563,3,差点被你打死,3295,1613,179,165,344,52.0%,12m
4563,3,[GAGA]YiyiYaya,3295,423,24,14,38,63.2%,31m
4563,3,[蘑菇神教]小猪,3295,428,17,8,25,68.0%,16m
4563,3,[薄暮之光]慕笺年,3295,310,11,14,25,44.0%,22m
4563,3,glory,3295,188,6,5,11,54.5%,15m
4563,3,[HDU]Serenity,3295,30,2,0,2,100.0%,24m
4563,3,[TAPC]陈树丶逆风飞扬,3295,30,2,0,2,100.0%,3m
4563,3,坐下坐下基本懆作,3295,0,1,5,6,16.7%,22m
4563,1,牵线木偶,3295,0,0,1,1,0.0%,1h
4563,3,[残雪映月]潘二狗,3295,0,0,1,1,0.0%,31m
4563,3,zzzzzzz,3295,0,0,1,1,0.0%,21m
4575,3,风静静地吹,3294,1500,118,100,218,54.1%,10m
4575,3,[不会散枪兵]imbasupertnt,3294,1377,50,57,107,46.7%,32m
4575,3,笑小仙,3294,114,18,17,35,51.4%,33m
4575,3,[透一下清酒]连翘,3294,236,9,7,16,56.2%,8m
4575,3,想想菲斯会怎么做,3294,176,5,1,6,83.3%,5m
4575,3,[时间]Shadow,3294,94,4,7,11,36.4%,36m
4575,1,狗哥且战且退,3294,0,2,1,3,66.7%,8m
4575,3,thead,3294,0,0,1,1,0.0%,8m
4575,3,[双手离开键盘]MrJC,3294,0,0,2,2,0.0%,13m
4575,3,[倩影]容你一生,3294,0,0,5,5,0.0%,9m
4585,2,宽锚人未来可期,3293,1353,78,88,166,47.0%,12m
4585,2,[真的叼]Potato,3293,1400,66,86,152,43.4%,30m
4585,3,NoBraiNoPain,3293,361,48,32,80,60.0%,7m
4585,3,解家华,3293,60,2,3,5,40.0%,7m
4585,3,头头,3293,62,2,10,12,16.7%,13m
4585,3,[Fe3o4]世界,3293,0,1,1,2,50.0%,16m
4585,3,我疯问佛,3293,0,0,1,1,0.0%,23m
4592,3,[TNLtr]Arpeggio,3292,234,8,15,23,34.8%,34m
4592,3,[中华讲武堂]starlett,3292,58,2,2,4,50.0%,4m
4592,3,[NOFUN]POWER,3292,0,1,0,1,100.0%,39m
4592,3,陌上花开,3292,0,0,1,1,0.0%,8m
4596,3,gto,3291,453,18,12,30,60.0%,36m
4596,3,llllllllll,3291,312,14,10,24,58.3%,26m
4596,3,trump,3291,97,5,2,7,71.4%,5m
4596,3,战姬,3291,60,3,1,4,75.0%,22m
4596,1,CollApSing,3291,48,3,4,7,42.9%,1h
4596,3,[AJNB]魔法少女郭德纲,3291,30,2,3,5,40.0%,9m
4596,3,鬼箭羽,3291,0,1,0,1,100.0%,4m
4596,3,这就是青春,3291,30,1,2,3,33.3%,21m
4596,3,[麻酱罐]枪兵团子,3291,0,0,1,1,0.0%,12m
4605,3,[怎么赢P]顾非池,3290,259,9,11,20,45.0%,33m
4605,3,[五十块的兄弟]skythrough,3290,176,7,5,12,58.3%,21m
4605,1,showtime,3290,0,4,1,5,80.0%,16m
4605,2,sCsH,3290,130,3,2,5,60.0%,29m
4605,3,帅如玄彬总司令,3290,60,3,3,6,50.0%,14m
4605,3,[星月神族]chengshao,3290,60,2,3,5,40.0%,16m
4605,3,南山孙一峰,3290,0,1,0,1,100.0%,17m
4605,3,[长沙大学]大飞机大飞机,3290,30,1,3,4,25.0%,20m
4605,3,ptd,3290,0,0,1,1,0.0%,29m
4605,3,[人菜灬瘾大]tREE,3290,0,0,1,1,0.0%,34m
4605,3,[给里给气]铃鹿御前,3290,0,0,2,2,0.0%,9m
4616,3,呆呆熊丶,3289,1532,160,146,306,52.3%,18m
4616,3,史莱克,3289,1557,140,117,257,54.5%,5m
4616,3,妈咪妈咪哄,3289,394,28,22,50,56.0%,2m
4616,2,清风之歌,3289,564,19,29,48,39.6%,30m
4616,3,WangLeeSak,3289,266,12,9,21,57.1%,16m
4616,3,[北京城管]大飞吃不胖,3289,124,4,7,11,36.4%,12m
4616,2,mystery,3289,121,3,1,4,75.0%,40m
4616,3,[青铜树]Gamble,3289,0,0,1,1,0.0%,36m
4624,3,[stkse]stkse,3288,608,193,160,353,54.7%,19m
4624,3,[紫gbawe]blackrock,3288,887,147,141,288,51.0%,20m
4624,2,[我们是无敌的]一粒尘埃,3288,766,27,36,63,42.9%,17m
4624,3,[中南大学官网]himehina,3288,140,6,1,7,85.7%,12m
4624,1,DarkTempar,3288,0,4,1,5,80.0%,6m
4624,3,[BGD]SuperPants,3288,86,3,2,5,60.0%,10m
4624,3,[南天寂静]彼岸嶙峋,3288,0,0,1,1,0.0%,19m
4624,3,[SNShna]本鸡供您调遣,3288,0,0,1,1,0.0%,20m
4632,2,[YA]一个渣渣,3287,1568,316,295,611,51.7%,19m
4632,3,WDDW,3287,416,41,22,63,65.1%,5m
4632,3,王礼,3287,330,12,7,19,63.2%,10m
4632,3,[汉堡FANS]祺神,3287,0,1,1,2,50.0%,4m
4632,1,炬羽玄,3287,0,1,4,5,20.0%,1h
4637,3,[水光潋滟]AliceOU,3286,365,14,17,31,45.2%,35m
4637,3,llllllllllll,3286,46,5,3,8,62.5%,2m
4637,1,扮猪吃老虎,3286,0,4,1,5,80.0%,1h
4637,3,Dark,3286,96,1,3,4,25.0%,27m
4637,3,solost,3286,0,0,5,5,0.0%,37m
4642,2,SCPLAYER,3285,802,231,230,461,50.1%,13m
4642,3,黄博导,3285,687,43,27,70,61.4%,3m
4642,3,lazyandfat,3285,488,20,13,33,60.6%,5m
4642,3,[GaHo]liar,3285,374,13,17,30,43.3%,30m
4642,3,六道佩恩花,3285,86,4,3,7,57.1%,17m
4642,3,盆满钵满蟹老板,3285,0,1,0,1,100.0%,33m
4648,3,[看我朵蜜你]巨臀队长,3284,1596,113,91,204,55.4%,17m
4648,3,[HeroZP]激动无脑艾斯蒂,3284,1186,49,40,89,55.1%,16m
4648,3,[killer]操我的队友不在,3284,634,24,24,48,50.0%,2m
4648,1,xiaoxuan,3284,0,4,1,5,80.0%,55m
4648,3,fengzi,3284,0,1,0,1,100.0%,5m
4648,3,[工大真善美]不巧者,3284,30,1,1,2,50.0%,36m
4648,3,Xiaoze,3284,32,1,3,4,25.0%,23m
4655,3,ROBBIN,3283,884,90,79,169,53.3%,22m
4655,3,[誰与争锋]魔鬼军团风雪一笑,3283,375,56,52,108,51.9%,25m
4655,3,[通灵女孩]勇敢的狗子,3283,1122,40,46,86,46.5%,20m
4655,3,bbi,3283,1016,39,36,75,52.0%,22m
4655,3,[中南大学]Hilbert,3283,250,9,4,13,69.2%,4m
4655,3,[菜鸡敢输队]Seth,3283,200,7,4,11,63.6%,13m
4655,3,戏子,3283,148,6,4,10,60.0%,2m
4655,3,[KPGSC2]TarGax,3283,86,4,1,5,80.0%,27m
4655,3,[THUDE]Freeqiang,3283,62,2,6,8,25.0%,8m
4655,3,[Kratos]SWS,3283,0,1,0,1,100.0%,32m
4655,3,xswl,3283,0,1,4,5,20.0%,16m
4655,3,最可爱的怪兽君,3283,0,0,1,1,0.0%,31m
4655,3,帅呆呆,3283,0,0,1,1,0.0%,4m
4655,3,scgirl,3283,0,0,5,5,0.0%,31m
4669,2,[啥1]kaven,3282,1486,427,414,841,50.8%,13m
4669,2,[DMRe]小阵雨,3282,1494,361,365,726,49.7%,14m
4669,3,[Shawk]Michelangelo,3282,784,100,93,193,51.8%,33m
4669,3,[吻丶Say]LoseControl,3282,1444,63,50,113,55.8%,20m
4669,3,[二次元bis]冬马和纱天下第一,3282,804,37,12,49,75.5%,34m
4669,3,派大星,3282,346,15,11,26,57.7%,31m
4669,3,[破剑茶寨]弦上有春秋,3282,179,11,13,24,45.8%,32m
4669,3,leng,3282,226,9,10,19,47.4%,3m
4669,3,Conceal,3282,144,6,5,11,54.5%,36m
4669,1,[一拜天地]方才,3282,0,4,1,5,80.0%,44m
4669,3,啊杰,3282,24,4,4,8,50.0%,18m
4669,3,[一般赢不了]顾楠,3282,88,4,5,9,44.4%,25m
4669,3,[QWQa]城春艸木深,3282,56,3,3,6,50.0%,23m
4669,3,[蒙牛集团]胡你一脸蒙牛,3282,0,1,2,3,33.3%,8m
4683,2,abook,3281,1583,533,539,1072,49.7%,6m
4683,3,ldota,3281,1094,77,77,154,50.0%,29m
4683,3,[Encore]LinZero,3281,1123,50,22,72,69.4%,13m
4683,3,LeBronHang,3281,221,36,41,77,46.8%,18m
4683,3,东京不热,3281,682,27,18,45,60.0%,19m
4683,2,浅笑,3281,278,25,35,60,41.7%,6m
4683,3,free,3281,440,16,13,29,55.2%,17m
4683,3,见招拆招,3281,404,15,10,25,60.0%,14m
4683,3,[rush2]ywis,3281,58,2,1,3,66.7%,31m
4683,3,[武大萌新]TohsakaRin,3281,58,2,2,4,50.0%,2m
4683,3,[IKUN]篮球王子蔡徐坤,3281,30,1,1,2,50.0%,5m
4683,3,矿物储量不族,3281,0,0,1,1,0.0%,34m
4695,2,[Holyfe]teewss,3280,0,5,2,7,71.4%,20m
4695,3,子龙,3280,24,3,0,3,100.0%,22m
4695,3,IIIIIIIIIII,3280,119,3,0,3,100.0%,34m
4695,3,cynicism,3280,128,2,1,3,66.7%,14m
4695,2,[NWP]软萌甜萱酱,3280,0,0,2,2,0.0%,27m
4700,2,派对动物,3279,1495,189,191,380,49.7%,19m
4700,3,[love西瓜]rollingdice,3279,1437,124,104,228,54.4%,35m
4700,3,llllllllll,3279,1407,60,56,116,51.7%,18m
4700,3,ryanatgz,3279,995,45,43,88,51.1%,4m
4700,3,Crazy,3279,287,32,15,47,68.1%,2m
4700,3,养生星际,3279,720,29,22,51,56.9%,28m
4700,3,[挨萌愚忠分子]疯狂的疯子,3279,465,19,8,27,70.4%,21m
4700,3,[星歌]DASHGO,3279,291,10,3,13,76.9%,17m
4700,3,[智障欢乐多]missqq,3279,86,3,3,6,50.0%,5m
4700,3,Walker,3279,58,2,3,5,40.0%,32m
4700,3,[Essaim]陆上最强萝莉控,3279,58,2,4,6,33.3%,13m
4700,3,日撸炼金只需三招,3279,0,1,1,2,50.0%,3m
4700,3,[纸片人老婆]玛奇玛的狗,3279,0,0,1,1,0.0%,9m
4700,3,[菜鸡啄老鹰]Freeza,3279,0,0,1,1,0.0%,4m
4700,3,大橙子,3279,0,0,1,1,0.0%,25m
4700,3,相忘于江湖,3279,0,0,2,2,0.0%,4m
4716,2,[DMR]暴君,3278,424,15,25,40,37.5%,12m
4716,3,IIIIIIIIIIII,3278,262,10,7,17,58.8%,11m
4716,3,[素貭極差]车马邮件比较慢,3278,140,5,2,7,71.4%,35m
4716,3,[斗鱼直播]红茶,3278,0,1,1,2,50.0%,6m
4716,3,灬知止灬,3278,0,0,4,4,0.0%,35m
4721,2,天澜彡,3277,1584,212,193,405,52.3%,35m
4721,2,呵呵哒,3277,1494,101,84,185,54.6%,5m
4721,3,维托萨洛扬,3277,412,31,35,66,47.0%,3m
4721,3,Filtration,3277,206,19,20,39,48.7%,32m
4721,3,Logosh,3277,469,18,10,28,64.3%,20m
4721,3,翱翔的上仙,3277,256,15,8,23,65.2%,23m
4721,3,音乐阳,3277,336,12,19,31,38.7%,35m
4721,3,VINNIE,3277,0,1,2,3,33.3%,18m
4721,3,[华东师大]末日时有空补番吗,3277,0,0,1,1,0.0%,20m
4721,3,Ayanami,3277,0,0,1,1,0.0%,16m
4721,3,Seven,3277,0,0,2,2,0.0%,13m
4732,2,除却巫山不是云,3276,856,63,69,132,47.7%,29m
4732,2,今晨启,3276,150,7,3,10,70.0%,27m
4732,3,lolo,3276,150,6,10,16,37.5%,12m
4732,3,[逗比神教]涛涛好可爱呀,3276,30,2,0,2,100.0%,8m
4732,1,[Rhusky]IIIIIIIIl,3276,0,1,5,6,16.7%,26m
4732,3,[Mousee]几千万基佬同时,3276,0,0,2,2,0.0%,21m
4738,2,朱彦卿,3275,1552,202,195,397,50.9%,24m
4738,2,[暴雪三十队]吉霸醉尝,3275,403,92,99,191,48.2%,4m
4738,3,符大大,3275,1099,55,41,96,57.3%,3m
4738,3,媛三胖,3275,270,28,27,55,50.9%,40m
4738,3,Relativity,3275,144,6,6,12,50.0%,23m
4738,1,打西边来的喇蟆,3275,0,4,1,5,80.0%,32m
4738,3,空虚的雪,3275,0,0,1,1,0.0%,33m
4738,3,草莓味布丁吖,3275,0,0,1,1,0.0%,30m
4738,1,cole,3275,0,0,1,1,0.0%,11m
4738,3,[镜花水月]萌萌的白团子,3275,0,0,1,1,0.0%,17m
4748,3,PingGuo,3274,974,71,54,125,56.8%,4m
4748,3,LanTiss,3274,166,6,4,10,60.0%,23m
4748,3,[璀璨群星之刃]璀璨阿克尔蒙德,3274,114,5,1,6,83.3%,4m
4748,3,Mac,3274,30,2,0,2,100.0%,5m
4748,3,[i5]Thanatos,3274,0,1,0,1,100.0%,33m
4748,3,Cloudychang,3274,0,1,0,1,100.0%,21m
4754,1,[C01680]lyh,3273,206,16,7,23,69.6%,31m
4754,3,拉顿哈给顿,3273,454,15,21,36,41.7%,9m
4754,1,[神奇的联萌]麦谧,3273,0,3,3,6,50.0%,7m
4754,3,ppp,3273,0,3,3,6,50.0%,17m
4754,3,[单人模拟战]新手电脑,3273,0,1,0,1,100.0%,23m
4754,3,半藏一峰孙森林,3273,0,0,1,1,0.0%,35m
4760,3,[九天星辰同萌]CCknight,3272,1484,289,274,563,51.3%,12m
4760,3,[江南狗王]冷兔肉,3272,920,34,41,75,45.3%,25m
4760,3,[Onceme]TONY,3272,362,13,12,25,52.0%,6m
4760,3,[教我玩神族]AbsoluteZero,3272,190,7,10,17,41.2%,24m
4760,1,星域战舰,3272,48,5,2,7,71.4%,60m
4760,1,烙素,3272,0,4,1,5,80.0%,1h
4760,3,[SKT1]自由之翼,3272,92,4,9,13,30.8%,19m
4760,3,[永不灭的战火]wcmaster,3272,0,1,0,1,100.0%,33m
4760,3,大控初音,3272,0,0,1,1,0.0%,31m
4760,3,以父之名,3272,0,0,2,2,0.0%,17m
4770,3,[Fe3o4]阿日日,3271,787,80,79,159,50.3%,34m
4770,2,守护者孙一鸡,3271,939,66,82,148,44.6%,20m
4770,3,[Borne]云在哭泣,3271,1501,65,69,134,48.5%,2m
4770,3,llllllll,3271,648,27,19,46,58.7%,16m
4770,2,大师傅,3271,766,26,36,62,41.9%,33m
4770,3,搞个大新闻,3271,490,18,17,35,51.4%,36m
4770,1,刀疤川,3271,0,5,0,5,100.0%,10m
4770,3,[YR]yiiouo,3271,142,3,1,4,75.0%,3m
4770,3,[目標諾森德]鹿目圆香,3271,90,3,8,11,27.3%,15m
4770,3,KISSmm,3271,0,1,0,1,100.0%,33m
4770,3,Shakespeare,3271,0,1,1,2,50.0%,14m
4770,3,Envy,3271,0,0,3,3,0.0%,36m
4782,3,菜虫,3270,514,26,21,47,55.3%,40m
4782,3,[东大电竞]IntoTheAsh,3270,62,3,4,7,42.9%,8m
4782,3,闪电风暴,3270,0,0,1,1,0.0%,17m
4782,3,看戏,3270,0,0,1,1,0.0%,36m
4786,3,AST,3269,738,29,26,55,52.7%,4m
4786,2,[艾尔之巅]乘风御剑绘昙花丶,3269,412,13,25,38,34.2%,12m
4786,3,[CNboys]萌萌的克尔苏加德,3269,334,12,13,25,48.0%,40m
4786,3,封逸琎,3269,60,3,1,4,75.0%,34m
4786,3,[凌宇]LinYuBuTcHeR,3269,0,0,1,1,0.0%,28m
4786,1,与蕾姆笑谈人生,3269,0,0,1,1,0.0%,10m
4786,3,小工蜂,3269,0,0,2,2,0.0%,7m
4793,3,Urun,3268,891,82,73,155,52.9%,34m
4793,3,Darwin,3268,686,31,14,45,68.9%,20m
4793,3,酷酷使徒汪,3268,116,5,1,6,83.3%,40m
4793,1,奈何一生傲骨,3268,0,4,1,5,80.0%,1h
4793,3,[AzOnE]最原终轶,3268,58,2,3,5,40.0%,26m
4793,3,[圣德怀特学园]宛枫,3268,0,0,1,1,0.0%,34m
4793,3,别和我发抛,3268,0,0,1,1,0.0%,24m
4793,3,sycshc,3268,0,0,1,1,0.0%,24m
4801,3,[无敌小鱼鱼]无敌小鱼鱼,3267,548,21,18,39,53.8%,5m
4801,1,专业打喵,3267,250,11,7,18,61.1%,18m
4801,3,特浓咖啡,3267,146,8,1,9,88.9%,11m
4801,3,金鳞岂是池中物,3267,176,6,7,13,46.2%,3m
4801,3,[DMRe]我很渣你小心,3267,90,3,3,6,50.0%,24m
4801,2,[最菜战队]easss,3267,0,0,2,2,0.0%,19m
4807,2,MagicBiken,3266,761,33,44,77,42.9%,35m
4807,3,[第一萌新帝国]蓬门今始为君开,3266,548,24,24,48,50.0%,24m
4807,2,[龙帝星云]阳江绝版好男人,3266,592,23,24,47,48.9%,14m
4807,2,学童,3266,143,7,4,11,63.6%,30m
4807,3,鸡中之霸,3266,120,5,6,11,45.5%,26m
4807,3,AzuraGLJ,3266,0,4,2,6,66.7%,30m
4807,3,[绝望中闪追猎]泊地水鬼,3266,90,4,3,7,57.1%,16m
4807,3,龙七,3266,58,2,1,3,66.7%,13m
4807,3,我在鱼市场巡逻,3266,97,1,2,3,33.3%,5m
4807,3,[TeamGB]loveDd,3266,0,0,1,1,0.0%,16m
4807,3,[征服地球]WANGYEFEI,3266,0,0,1,1,0.0%,24m
4807,3,Azrael,3266,0,0,1,1,0.0%,16m
4819,3,Poison,3265,668,86,90,176,48.9%,24m
4819,2,玄门道人,3265,1031,80,68,148,54.1%,4m
4819,3,[Borne]翩跹,3265,512,20,22,42,47.6%,26m
4819,3,[博丽大结界]博丽灵梦,3265,455,17,9,26,65.4%,5m
4819,3,[WXBC]YYEW,3265,166,7,3,10,70.0%,37m
4819,1,Duiess,3265,156,5,3,8,62.5%,25m
4819,3,[Lemona]Cloudscwq,3265,0,1,0,1,100.0%,24m
4819,3,[DSE]啵啵鸡,3265,0,1,0,1,100.0%,3m
4819,3,[sofia]魂爱,3265,0,0,1,1,0.0%,2m
4819,1,[AIMBA]柯然,3265,0,0,1,1,0.0%,60m
4819,3,永诀,3265,0,0,2,2,0.0%,8m
4830,3,流云飞月,3264,754,29,22,51,56.9%,3m
4830,3,[社交学教官]我曾经迷信科学,3264,278,11,4,15,73.3%,9m
4830,2,[社交学大可爱]ZYZ,3264,188,5,12,17,29.4%,33m
4830,1,[别呼叫舰队了]丨超级索尼子丨,3264,0,4,1,5,80.0%,50m
4830,3,潜行者,3264,30,2,0,2,100.0%,4m
4830,3,黑鳍白鱼,3264,0,1,0,1,100.0%,3m
4830,3,[星歌]IllllllllIII,3264,0,1,0,1,100.0%,8m
4830,3,[女人影响剑速]帅比,3264,0,1,0,1,100.0%,23m
4830,3,MuSE,3264,30,1,1,2,50.0%,24m
4830,3,SUNNY,3264,0,0,1,1,0.0%,16m
4830,3,星海,3264,0,0,2,2,0.0%,33m
4841,3,IlllIIIllllI,3263,1212,46,43,89,51.7%,37m
4841,3,[镜花水月丿]水光一色,3263,266,10,6,16,62.5%,5m
4841,3,同化完成,3263,254,9,10,19,47.4%,28m
4841,3,星梦月殇,3263,144,6,3,9,66.7%,36m
4841,3,流浪的大妈,3263,131,5,4,9,55.6%,36m
4841,3,连云之城,3263,58,2,2,4,50.0%,20m
4841,3,[荣耀丶殿堂]六味地黄芄,3263,30,1,3,4,25.0%,19m
4841,3,Soul,3263,0,0,7,7,0.0%,12m
4849,3,忘吾,3262,874,46,26,72,63.9%,34m
4849,3,鲨鱼辣椒,3262,194,13,8,21,61.9%,23m
4849,3,[头文字TB]DUTY,3262,161,7,3,10,70.0%,33m
4849,2,DingF,3262,0,4,1,5,80.0%,24m
4849,3,某科学的咕咕码,3262,0,3,2,5,60.0%,34m
4849,3,[小媛]皇马之魂,3262,60,3,3,6,50.0%,19m
4849,3,中断之吻,3262,60,2,2,4,50.0%,11m
4849,3,士大夫事,3262,0,1,0,1,100.0%,21m
4849,3,llllllllllll,3262,0,0,2,2,0.0%,5m
4849,3,[武形秘仪]我也好萌,3262,0,0,3,3,0.0%,31m
4859,2,[IMRTS2]yin,3261,1003,147,150,297,49.5%,26m
4859,3,MagejiTerren,3261,141,7,2,9,77.8%,10m
4859,3,[萌新保护谐会]雅典幽灵,3261,62,3,3,6,50.0%,23m
4859,3,fskyq,3261,0,1,0,1,100.0%,33m
4859,3,angles,3261,0,1,0,1,100.0%,22m
4859,2,[KENNEL]毒奶泡泡,3261,36,1,1,2,50.0%,25m
4859,3,[宠爱]弟弟丶舔她,3261,0,0,1,1,0.0%,32m
4866,3,菜的很,3260,1565,79,72,151,52.3%,9m
4866,3,天爱,3260,273,10,5,15,66.7%,11m
4866,3,[THLC]Troway,3260,186,9,14,23,39.1%,23m
4866,1,灭世毒爆,3260,0,4,2,6,66.7%,1h
4866,3,[XYFANS]一个菜鸟,3260,0,1,0,1,100.0%,37m
4866,3,[HoASD]gameboy,3260,0,0,1,1,0.0%,26m
4866,3,[同卵双狗]上海孙一峰,3260,0,0,1,1,0.0%,14m
4866,3,lllllllll,3260,0,0,1,1,0.0%,7m
4866,3,[咸鱼咸鱼咸]鶸鸡菜逼,3260,0,0,1,1,0.0%,4m
4866,3,[Beastp]RedEyed,3260,0,0,1,1,0.0%,25m
4876,3,毛蛋,3259,619,33,27,60,55.0%,29m
4876,3,Zzz,3259,452,17,16,33,51.5%,8m
4876,1,菜鸟,3259,322,14,6,20,70.0%,5m
4876,3,[幽冥之狼]TheOverMind,3259,296,11,8,19,57.9%,22m
4876,3,Ares,3259,90,3,7,10,30.0%,18m
4876,3,[四叶草]花落影榭,3259,0,1,1,2,50.0%,13m
4876,3,梁笑堂,3259,30,1,4,5,20.0%,20m
4876,3,翻滚的叉烧包,3259,0,0,1,1,0.0%,9m
4884,3,Richard,3258,1226,47,51,98,48.0%,16m
4884,3,[地嗪专卖店]楼主,3258,590,22,20,42,52.4%,28m
4884,1,Aerith,3258,96,2,0,2,100.0%,1h
4884,3,IIIIIIIIIIII,3258,0,0,1,1,0.0%,7m
4888,3,WHY,3257,1563,122,95,217,56.2%,30m
4888,3,彩笔中最强的男人,3257,1165,89,79,168,53.0%,32m
4888,3,savelove,3257,276,10,9,19,52.6%,3m
4888,3,白菜,3257,30,5,3,8,62.5%,10m
4888,2,[抗奶]狂热者,3257,0,4,1,5,80.0%,1h
4888,3,[XCode]泰州小绵羊,3257,30,2,2,4,50.0%,30m
4888,3,HOYI,3257,58,2,2,4,50.0%,29m
4888,3,[阿塔尼斯]星际喵,3257,0,1,0,1,100.0%,13m
4888,3,[IMRTS2]aBgrUnD,3257,30,1,3,4,25.0%,14m
4888,3,[折纸后援团]阿库卢马卡卡,3257,0,1,4,5,20.0%,20m
4888,3,Jacob,3257,0,0,1,1,0.0%,17m
4899,2,Matthew,3256,1663,1151,1142,2293,50.2%,21m
4899,3,Depressed,3256,382,15,11,26,57.7%,10m
4899,3,光环,3256,66,3,2,5,60.0%,25m
4899,3,[一二一]社会主义铁拳,3256,0,1,0,1,100.0%,36m
4899,3,[壮哉我胖哥]TENG,3256,0,1,0,1,100.0%,27m
4899,3,[Vgirls]暗夜中的杀手,3256,0,1,3,4,25.0%,6m
4899,3,[THUDE]OhYes,3256,0,0,1,1,0.0%,17m
4899,3,Kerrigan,3256,0,0,1,1,0.0%,20m
4899,3,[火焰雷兽]你运营有点慢,3256,0,0,3,3,0.0%,22m
4908,3,freedom,3255,1168,43,44,87,49.4%,30m
4908,3,[隆德貝爾]田中庄司,3255,616,25,19,44,56.8%,15m
4908,3,[五月花]aaa,3255,400,17,15,32,53.1%,16m
4908,2,[充气团]夜刀神十香,3255,468,15,26,41,36.6%,26m
4908,3,[闪电伍连鞭]贝塔,3255,122,5,8,13,38.5%,35m
4908,3,风轻云淡,3255,56,3,1,4,75.0%,4m
4908,2,[HotR]IIIIIIIIIII,3255,165,3,3,6,50.0%,13m
4908,3,flyingfish,3255,0,1,0,1,100.0%,35m
4908,3,[Mensa]jayven,3255,0,0,1,1,0.0%,22m
4908,3,[青铜树]Romance,3255,0,0,1,1,0.0%,28m
4918,3,橙子西柚,3254,385,18,12,30,60.0%,3m
4918,3,[八一六]Seven,3254,118,4,8,12,33.3%,5m
4918,3,冰浊,3254,0,1,1,2,50.0%,2m
4918,3,[MWG]MLTQiao,3254,0,0,1,1,0.0%,15m
4922,3,saintseven,3253,1164,102,83,185,55.1%,22m
4922,2,killer,3253,528,53,65,118,44.9%,36m
4922,3,我又不浪,3253,664,27,27,54,50.0%,6m
4922,3,萌新的潜行者,3253,88,4,2,6,66.7%,18m
4922,2,大地之怒,3253,132,4,2,6,66.7%,20m
4922,3,[UNDEAT]Nazul,3253,58,3,1,4,75.0%,20m
4922,3,[Brave]Rice,3253,62,3,7,10,30.0%,33m
4922,3,七月,3253,30,2,0,2,100.0%,15m
4922,3,[血腥狂热]寂寞的贪吃蛇,3253,0,1,0,1,100.0%,34m
4922,3,[死宅]团言,3253,0,1,0,1,100.0%,2m
4922,3,whysoserious,3253,0,1,0,1,100.0%,32m
4922,3,理查德没汤姆帅,3253,0,1,2,3,33.3%,32m
4922,2,商纣王,3253,0,1,4,5,20.0%,22m
4935,2,exiazs,3252,1602,248,237,485,51.1%,17m
4935,2,DayDreamer,3252,1504,140,139,279,50.2%,7m
4935,3,王启同,3252,1089,43,38,81,53.1%,32m
4935,3,[厨二组]funnyFORever,3252,209,12,3,15,80.0%,8m
4935,3,裤裆有杀气,3252,146,6,4,10,60.0%,22m
4935,3,MagejiTarren,3252,86,3,1,4,75.0%,21m
4935,3,iiiiiiiiiiii,3252,24,2,5,7,28.6%,20m
4935,3,Scott,3252,0,0,1,1,0.0%,4m
4935,3,redbird,3252,0,0,1,1,0.0%,16m
4944,3,大资本家,3251,1618,68,62,130,52.3%,8m
4944,3,SatacsA,3251,1278,60,55,115,52.2%,20m
4944,3,Milky,3251,1139,58,47,105,55.2%,27m
4944,3,[FORI2]小比比醬,3251,544,21,25,46,45.7%,26m
4944,3,rushhour,3251,490,18,17,35,51.4%,6m
4944,3,战神,3251,362,13,14,27,48.1%,22m
4944,3,[KPG]INnoVation,3251,86,3,9,12,25.0%,16m
4944,3,一方萝莉控,3251,30,1,1,2,50.0%,2m
4944,3,[湖北郧阳中学]因幡爱瑠,3251,0,0,1,1,0.0%,29m
4944,3,[闲散人员]夜刀神十香,3251,0,0,1,1,0.0%,8m
4954,3,[钻石联盟]月光疾风,3250,1187,62,49,111,55.9%,18m
4954,3,[Shawk]炸鱼死马嗷,3250,235,13,4,17,76.5%,32m
4954,3,[三浦透子]今天又是什么奶茶,3250,238,9,6,15,60.0%,2m
4954,1,唯爱黄旭东,3250,119,5,2,7,71.4%,32m
4954,3,Scholl,3250,58,2,3,5,40.0%,11m
4954,3,[JPS]AshRoller,3250,0,1,0,1,100.0%,29m
4954,3,[恋染色]Stardust,3250,0,1,0,1,100.0%,18m
4954,3,[RPGBoY]lllllllll,3250,30,1,2,3,33.3%,20m
4954,3,llllllllllll,3250,0,0,4,4,0.0%,5m
4963,2,Deannn,3249,968,169,164,333,50.8%,31m
4963,3,[随便玩]東門吹水,3249,1463,65,48,113,57.5%,16m
4963,3,[IGS]叉烧味的包子,3249,368,13,14,27,48.1%,18m
4963,3,[牌面]傲魄,3249,102,13,18,31,41.9%,24m
4963,3,繁星夜空下,3249,245,12,8,20,60.0%,25m
4963,1,[羊驼驼]英雄王子,3249,266,9,13,22,40.9%,40m
4963,3,[废墟图书館]KelThuzad,3249,247,7,7,14,50.0%,17m
4963,1,llllllllllll,3249,144,6,2,8,75.0%,24m
4963,3,FIRTY,3249,30,2,4,6,33.3%,4m
4963,3,[暴雪零队]星际二五仔,3249,58,2,4,6,33.3%,7m
4963,2,[瘾大眼瞎]桐予,3249,0,1,0,1,100.0%,11m
4963,3,[QwQYo]IDMissing,3249,30,1,1,2,50.0%,15m
4963,3,百度强力推荐,3249,0,1,2,3,33.3%,29m
4963,1,坐看竹林峰,3249,0,1,2,3,33.3%,4m
4977,3,[中华讲武堂]到发上,3248,1088,39,44,83,47.0%,4m
4977,3,Seele,3248,657,33,21,54,61.1%,3m
4977,3,真老了,3248,226,9,5,14,64.3%,30m
4977,3,[基金会]迪特里希,3248,92,4,4,8,50.0%,29m
4977,3,李永菜,3248,171,4,8,12,33.3%,7m
4977,3,GameBoy,3248,90,3,4,7,42.9%,16m
4977,3,[七彩斑斓]相声大师丘吉尔,3248,0,0,2,2,0.0%,29m
4977,3,stephano,3248,0,0,3,3,0.0%,27m
4985,2,Rikka,3247,1352,126,120,246,51.2%,34m
4985,3,[就这就这]bobo,3247,793,41,33,74,55.4%,16m
4985,3,[火拳]艾斯,3247,374,14,18,32,43.8%,20m
4985,3,绝对零度,3247,226,9,6,15,60.0%,37m
4985,3,[风后奇门]DeliciousVii,3247,0,3,2,5,60.0%,21m
4985,3,[末日孤舰]TordINA,3247,30,2,0,2,100.0%,2m
4985,3,优势了就要送一波,3247,0,1,0,1,100.0%,26m
4985,3,[拉比安罗斯]别杀我农民,3247,0,1,1,2,50.0%,18m
4985,3,[sc扫黄大队]人沫沫,3247,0,0,3,3,0.0%,13m
4994,3,IIIIIIIIII,3246,1355,329,328,657,50.1%,15m
4994,3,[火焰雷兽]烟雨,3246,465,19,18,37,51.4%,17m
4994,3,IIIIIIIIIIII,3246,437,16,12,28,57.1%,25m
4994,2,IIIIIIiiiiII,3246,478,16,30,46,34.8%,30m
4994,3,二十八天速成鸡,3246,259,10,4,14,71.4%,25m
4994,3,劲爆的锤子,3246,278,10,7,17,58.8%,9m
4994,3,黄金冲击,3246,292,10,14,24,41.7%,29m
4994,3,Karotor,3246,198,7,7,14,50.0%,25m
4994,3,IIIIIIIIIIII,3246,180,6,10,16,37.5%,5m
4994,3,[我们是无敌的]不偷不狗顶正面,3246,93,2,0,2,100.0%,36m
4994,3,勇士终成龙,3246,30,2,1,3,66.7%,15m
4994,3,[斯巴达血战团]一月狂欢,3246,60,2,2,4,50.0%,20m
4994,3,吾儿丨旭东,3246,62,2,7,9,22.2%,8m
4994,3,混沌三式,3246,0,0,1,1,0.0%,23m
5008,3,藐视群雄,3245,968,48,20,68,70.6%,32m
5008,3,赫赫,3245,485,18,10,28,64.3%,2m
5008,2,[哀木涕]Miss,3245,0,3,2,5,60.0%,34m
5008,1,[Miku骑士]lunar,3245,97,2,0,2,100.0%,1h
5008,3,[我队伍很强大]虚幻,3245,58,2,1,3,66.7%,25m
5008,1,llllllllllll,3245,131,2,4,6,33.3%,17m
5008,1,[東方心念語]心曲之都,3245,0,1,0,1,100.0%,1h
5008,3,乐园归来,3245,30,1,2,3,33.3%,33m
5008,3,GeSiy,3245,0,0,1,1,0.0%,4m
5017,3,臭豆腐集团总裁,3244,1219,100,86,186,53.8%,9m
5017,3,LOVEzw,3244,1564,63,60,123,51.2%,4m
5017,3,天照之子,3244,753,32,22,54,59.3%,6m
5017,3,你不知道我是谁,3244,341,17,18,35,48.6%,36m
5017,3,[噶姐]星尘的回忆,3244,156,11,19,30,36.7%,35m
5017,2,llllllllllll,3244,239,10,5,15,66.7%,8m
5017,3,[内华达数学系]Galois,3244,190,8,2,10,80.0%,31m
5017,2,[逗比神教]零零小副官,3244,222,8,4,12,66.7%,23m
5017,3,水中客,3244,92,4,8,12,33.3%,12m
5017,3,[拱墅车王]MagicZerg,3244,60,2,6,8,25.0%,24m
5017,3,[牛头人战队]Tadger,3244,0,0,1,1,0.0%,30m
5028,3,睡觉奥,3243,1653,152,144,296,51.4%,3m
5028,2,[日常]敏锐驻马店潜伏者,3243,524,19,29,48,39.6%,4m
5028,3,葱油饼,3243,30,5,1,6,83.3%,11m
5028,3,似水流年,3243,104,5,4,9,55.6%,33m
5028,3,[星图]xiangg,3243,0,0,1,1,0.0%,35m
5033,3,Evilyy,3242,1023,57,52,109,52.3%,3m
5033,3,[可我没有狗]我的狗狗叫马达,3242,524,44,36,80,55.0%,23m
5033,2,高党,3242,408,31,48,79,39.2%,4m
5033,2,Swith,3242,270,12,5,17,70.6%,19m
5033,3,[爱之信仰]Jzen,3242,182,8,4,12,66.7%,40m
5033,3,[STSTST]IIIIIIIIIIII,3242,196,8,7,15,53.3%,31m
5033,3,江西孙一峰,3242,144,6,5,11,54.5%,22m
5033,3,[SCJWJ3]乌克兰小乳猪,3242,58,3,1,4,75.0%,28m
5033,3,阿虚的小弟,3242,0,1,0,1,100.0%,32m
5033,3,MarineKing,3242,30,1,1,2,50.0%,36m
5033,3,KEVIN,3242,0,0,1,1,0.0%,18m
5033,1,佛系玩家,3242,0,0,1,1,0.0%,23m
5033,3,[倥偬]纯乾三,3242,0,0,1,1,0.0%,23m
5033,3,[Killyo]林枫,3242,0,0,1,1,0.0%,22m
5047,3,Habby,3241,1588,148,146,294,50.3%,33m
5047,3,南风知我意,3241,194,8,4,12,66.7%,18m
5047,3,[真de白给]风化流逝,3241,86,3,1,4,75.0%,6m
5047,1,[我队伍很强大]小青酱,3241,0,1,2,3,33.3%,10m
5047,3,[东方非想天则]齐藤千佳,3241,0,0,1,1,0.0%,16m
5047,3,[肉鸡的饲养]思薇,3241,0,0,1,1,0.0%,25m
5047,3,小老虎,3241,0,0,2,2,0.0%,32m
5054,3,leiyifan,3240,1608,344,337,681,50.5%,25m
5054,3,花待葬,3240,1593,125,108,233,53.6%,19m
5054,3,Benjamin,3240,803,120,95,215,55.8%,19m
5054,3,[EtdNew]赢了都靠运气好,3240,904,36,31,67,53.7%,4m
5054,3,派大星,3240,482,17,23,40,42.5%,3m
5054,1,[601]幽夜紫羽,3240,46,5,2,7,71.4%,35m
5054,3,嘢马星,3240,142,5,6,11,45.5%,29m
5054,3,IIIIIIIIII,3240,0,2,3,5,40.0%,21m
5054,3,[嫣然笑里传声]笙歌初寒夜未央,3240,0,0,1,1,0.0%,23m
5063,3,UWYGDUYES,3239,1370,280,255,535,52.3%,34m
5063,3,dangerliu,3239,1580,186,175,361,51.5%,22m
5063,3,[浪啊浪]嘎嘎的猪队友,3239,1312,185,177,362,51.1%,25m
5063,3,[火焰雷兽]String,3239,394,30,23,53,56.6%,6m
5063,3,哔站直播一一味觉,3239,304,19,15,34,55.9%,33m
5063,2,藤原妹红,3239,442,14,39,53,26.4%,21m
5063,3,时间走快点,3239,257,9,2,11,81.8%,36m
5063,2,[一起多人运动]野怪,3239,161,5,9,14,35.7%,34m
5063,3,[苏大星际]枪兵滚毒爆,3239,146,4,2,6,66.7%,19m
5063,3,[神灵飞电]雪儿,3239,114,4,2,6,66.7%,2m
5063,3,[Bravo]我既是虫群,3239,30,2,1,3,66.7%,4m
5063,3,缘圆就爱吃桃子,3239,0,0,1,1,0.0%,12m
5075,3,[一花一世界]乱世辽夜,3238,206,7,8,15,46.7%,29m
5075,2,丨氢氧化钠丨,3238,0,4,1,5,80.0%,1h
5075,3,牛大侠,3238,0,1,0,1,100.0%,4m
5075,3,宿命天翔,3238,0,0,4,4,0.0%,36m
5079,3,Iron,3237,853,56,48,104,53.8%,31m
5079,3,[贰0]oops,3237,444,16,17,33,48.5%,26m
5079,1,生姜,3237,294,10,9,19,52.6%,8m
5079,3,PIPI,3237,49,4,4,8,50.0%,25m
5079,3,[GOTAL]只会玩小狗的菜鸟,3237,58,2,1,3,66.7%,9m
5079,3,Royitoh,3237,0,1,0,1,100.0%,11m
5079,3,[龙眠山下的猫]泰伦基建狂魔,3237,0,0,1,1,0.0%,33m
5079,3,[拗硬]白泽,3237,0,0,2,2,0.0%,2m
5087,3,瑾木,3236,1287,186,143,329,56.5%,28m
5087,3,[一等星]Eternity,3236,796,94,82,176,53.4%,28m
5087,3,[ELSD]Threnody,3236,719,47,44,91,51.6%,33m
5087,3,[Fear]讲武德,3236,880,37,23,60,61.7%,32m
5087,3,零零小林,3236,272,10,7,17,58.8%,2m
5087,3,[NVKR]青落菌,3236,144,6,7,13,46.2%,5m
5087,3,OOO,3236,114,4,3,7,57.1%,15m
5087,1,[CnNami]Largo,3236,96,3,4,7,42.9%,9m
5087,3,云淡,3236,30,1,1,2,50.0%,32m
5087,3,patient,3236,0,0,1,1,0.0%,3m
5087,3,[YMFM丶]Seele,3236,0,0,1,1,0.0%,9m
5098,3,[你瞅啥]海奥瑞泽,3235,980,59,62,121,48.8%,5m
5098,3,[TCP]柑橘奶昔,3235,469,20,15,35,57.1%,2m
5098,3,soKiva,3235,194,8,9,17,47.1%,26m
5098,1,[KD]妄想心音,3235,143,7,2,9,77.8%,1h
5098,1,星邪不是星谐,3235,142,6,2,8,75.0%,22m
5098,2,蓬莱山辉夜,3235,0,4,1,5,80.0%,1h
5098,3,向阳道与莲儿,3235,139,3,2,5,60.0%,9m
5098,3,[C33856]赵三湾银枪小霸王,3235,30,1,2,3,33.3%,23m
5098,3,Takasakifuko,3235,0,1,2,3,33.3%,4m
5098,2,身下下士,3235,0,1,2,3,33.3%,11m
5098,3,国服炸鱼亲妈暴毙,3235,0,0,1,1,0.0%,4m
5098,3,[OgiNA]云何降伏其心,3235,0,0,1,1,0.0%,26m
5098,3,Eternity,3235,0,0,1,1,0.0%,3m
5098,3,[Ttree]今晚打老虎,3235,0,0,2,2,0.0%,33m
5112,3,Alex,3234,1586,171,144,315,54.3%,18m
5112,3,njan,3234,354,15,11,26,57.7%,29m
5112,1,晓美焰,3234,144,6,2,8,75.0%,3m
5112,2,[真理卐高中]asdq,3234,0,4,1,5,80.0%,1h
5112,3,zealot,3234,118,4,7,11,36.4%,8m
5112,2,迷路的七秒,3234,112,3,2,5,60.0%,8m
5112,3,[CNboys]Linford,3234,0,1,0,1,100.0%,33m
5112,3,低调低调呵,3234,0,1,1,2,50.0%,15m
5112,3,南京市二十岁脑瘫,3234,0,0,1,1,0.0%,36m
5112,3,[暴雪一队]路明非,3234,0,0,1,1,0.0%,36m
5122,1,[SteEng]Fighter,3233,1554,306,332,638,48.0%,29m
5122,3,[雷本]马格努斯,3233,1276,49,46,95,51.6%,6m
5122,3,美人之迟暮,3233,180,21,19,40,52.5%,36m
5122,3,[一般赢不了]白给永不放弃,3233,242,13,6,19,68.4%,37m
5122,3,鸦猫酱,3233,142,5,2,7,71.4%,25m
5122,3,[QAQa]dede,3233,0,1,0,1,100.0%,25m
5122,1,苏铭,3233,0,1,0,1,100.0%,56m
5122,2,[月亮船]萌萌的蛋包糕,3233,0,1,0,1,100.0%,40m
5122,3,bois,3233,0,1,0,1,100.0%,10m
5122,3,[各种SOS]Gilgamesh,3233,0,0,1,1,0.0%,36m
5122,3,[抽爷]冷酷无情上分机器,3233,0,0,1,1,0.0%,36m
5122,3,[LvThNu]Vengeance,3233,0,0,1,1,0.0%,35m
5122,3,[Beasty]thepath,3233,0,0,1,1,0.0%,7m
5135,3,吾爱永恒,3232,1083,295,282,577,51.1%,3m
5135,3,Caramel,3232,1601,112,92,204,54.9%,31m
5135,2,大笨狗,3232,1546,94,105,199,47.2%,8m
5135,3,[洁白之巅]wxd,3232,235,13,12,25,52.0%,35m
5135,1,我的眼瞎治不好,3232,143,6,2,8,75.0%,40m
5135,3,[小鸡屠宰场8]moonky,3232,0,1,0,1,100.0%,22m
5135,3,Gitr,3232,30,1,3,4,25.0%,6m
5135,3,[死神永生]羽落,3232,0,0,1,1,0.0%,7m
5135,3,Helloween,3232,0,0,1,1,0.0%,10m
5135,3,FGwings,3232,0,0,1,1,0.0%,33m
5145,2,[刺蛇单推协会]裂空座,3231,990,61,61,122,50.0%,22m
5145,2,[传说萌俍团]沧海空,3231,642,37,33,70,52.9%,33m
5145,3,瓜皮,3231,277,19,4,23,82.6%,4m
5145,3,sky,3231,150,5,9,14,35.7%,25m
5145,3,Sustain,3231,58,3,0,3,100.0%,8m
5145,3,[张博文是只鸡]瞧尔萨斯,3231,30,2,1,3,66.7%,6m
5145,2,Callo,3231,114,2,2,4,50.0%,22m
5145,3,捷克斯洛伐克,3231,0,1,0,1,100.0%,8m
5145,3,prince,3231,0,1,0,1,100.0%,29m
5145,3,[o瞳孔o]心有所属丶帆,3231,0,1,1,2,50.0%,23m
5145,3,大绅士,3231,30,1,1,2,50.0%,37m
5145,3,[NtS媚娘队]虚星,3231,0,1,2,3,33.3%,29m
5145,3,[凯哥集团]凛冬将至,3231,0,0,3,3,0.0%,5m
5158,3,loisdiying,3230,1040,63,43,106,59.4%,14m
5158,3,轻吟星语,3230,624,23,31,54,42.6%,31m
5158,3,[s黑色玫瑰s]禁区枭歌,3230,210,7,8,15,46.7%,37m
5158,3,rusher,3230,60,3,2,5,60.0%,15m
5158,3,[miku守护]黑暗骑士,3230,30,2,2,4,50.0%,4m
5158,3,白给是门好艺术,3230,0,1,0,1,100.0%,21m
5158,3,[喵喵星人]呆萌丶,3230,30,1,1,2,50.0%,19m
5158,3,[80后丶]我都闭着眼打游戏,3230,0,0,1,1,0.0%,5m
5158,3,[夜苍鹭]武圣,3230,0,0,1,1,0.0%,17m
5167,2,[莽夫智障团]跳跃猫杰西,3229,1550,130,132,262,49.6%,12m
5167,3,三笠,3229,1121,53,44,97,54.6%,35m
5167,3,[THRON]套中人,3229,310,36,25,61,59.0%,5m
5167,3,腌辣椒,3229,615,28,22,50,56.0%,12m
5167,3,lililililili,3229,114,4,6,10,40.0%,11m
5167,3,MrJohn,3229,58,3,3,6,50.0%,29m
5167,3,RadeonVll,3229,0,1,0,1,100.0%,33m
5167,3,暗影空间,3229,0,0,1,1,0.0%,24m
5167,3,肖邦,3229,0,0,4,4,0.0%,23m
5176,3,Tonysee,3228,534,26,22,48,54.2%,25m
5176,3,[破晓黎明]十六西洲尘丶,3228,478,18,20,38,47.4%,26m
5176,2,依稀远空,3228,261,12,6,18,66.7%,23m
5176,3,[美少女萬華鏡]顶级萝莉控,3228,116,5,4,9,55.6%,25m
5176,3,[国足救星]yelg,3228,116,4,9,13,30.8%,6m
5176,3,[小鸡屠宰场9]星河舰队,3228,62,3,3,6,50.0%,28m
5176,3,Iamfine,3228,60,2,2,4,50.0%,11m
5176,3,怕死的毒爆,3228,0,0,1,1,0.0%,36m
5184,2,倔强的小火鱼,3227,1487,225,205,430,52.3%,24m
5184,3,[文韬武略]Helium,3227,1400,150,157,307,48.9%,23m
5184,3,kip,3227,998,39,39,78,50.0%,36m
5184,3,yudian,3227,194,8,4,12,66.7%,9m
5184,3,zcmorning,3227,30,2,1,3,66.7%,7m
5184,3,胡阳,3227,0,1,0,1,100.0%,23m
5184,3,[HZNU]寂灭原子弹,3227,0,1,0,1,100.0%,11m
5184,3,[阿板大队]potato,3227,0,0,1,1,0.0%,8m
5192,2,[CoWo]irishman,3226,1553,192,199,391,49.1%,23m
5192,3,Assassin,3226,892,133,131,264,50.4%,13m
5192,3,[夏恋]卡兰,3226,493,25,16,41,61.0%,6m
5192,1,[29CM]白嫖到底,3226,293,14,7,21,66.7%,26m
5192,3,[AM]西湖底战指部,3226,200,8,4,12,66.7%,7m
5192,3,[青风堂]屠夫,3226,236,7,2,9,77.8%,14m
5192,3,IAWIA,3226,142,6,3,9,66.7%,4m
5192,3,acdc,3226,140,5,2,7,71.4%,33m
5192,3,[韩湾土锤搬家]YueChuNexus,3226,116,4,6,10,40.0%,33m
5192,3,kkklkkk,3226,94,4,7,11,36.4%,19m
5192,3,筱寒,3226,58,2,1,3,66.7%,7m
5192,3,[科普鲁苏维埃]ghghgh,3226,60,2,2,4,50.0%,8m
5192,3,暴走谐星,3226,58,2,6,8,25.0%,8m
5192,3,ajax,3226,0,1,0,1,100.0%,34m
5192,3,蓝白,3226,0,1,1,2,50.0%,13m
5192,2,[FsA]falseC,3226,0,1,3,4,25.0%,22m
5192,1,苏筱北,3226,0,0,1,1,0.0%,1h
5192,3,张小连,3226,0,0,1,1,0.0%,11m
5192,3,Flttcst,3226,0,0,1,1,0.0%,28m
5192,3,AAAA,3226,0,0,1,1,0.0%,35m
5192,3,鹰巢城的伊鲁席尔,3226,0,0,2,2,0.0%,4m
5192,3,[盲人康复院]头像越粉一波越狠,3226,0,0,3,3,0.0%,22m
5214,3,老实人,3225,1549,110,95,205,53.7%,3m
5214,2,kilua,3225,1515,97,84,181,53.6%,14m
5214,2,TATQwQ,3225,943,85,89,174,48.9%,4m
5214,3,MAD,3225,634,23,28,51,45.1%,32m
5214,3,[sc日记]卡兰,3225,428,16,14,30,53.3%,17m
5214,3,菜花香胸,3225,244,9,4,13,69.2%,22m
5214,3,一拳超人,3225,30,2,1,3,66.7%,4m
5214,3,Somnus,3225,62,2,6,8,25.0%,31m
5214,3,[糯米丸子]knjj,3225,58,2,7,9,22.2%,22m
5214,3,LiIce,3225,0,0,1,1,0.0%,34m
5214,2,llllllllllll,3225,0,0,5,5,0.0%,1h
5225,2,[我不會TVT]black,3224,1600,1484,1478,2962,50.1%,14m
5225,3,[GAC]soso,3224,109,5,6,11,45.5%,4m
5225,1,维罗妮卡,3224,222,5,11,16,31.2%,36m
5225,3,[星之所在RI]IIIIIIIIIIII,3224,0,1,0,1,100.0%,33m
5225,3,[基金会]小宅,3224,0,1,0,1,100.0%,15m
5225,3,渣渣辉,3224,97,1,1,2,50.0%,5m
5225,3,翱玥七星,3224,0,1,1,2,50.0%,30m
5225,3,Spray,3224,0,1,4,5,20.0%,31m
5225,1,[荣耀武士团]岚狐,3224,0,0,1,1,0.0%,25m
5225,3,Chantworea,3224,0,0,1,1,0.0%,15m
5225,3,Serral,3224,0,0,1,1,0.0%,28m
5225,3,krownkkk,3224,0,0,3,3,0.0%,14m
5237,3,IIIIIIIIIIII,3223,1512,154,151,305,50.5%,26m
5237,3,[阿特兹]将你溺死在厕所,3223,1106,40,49,89,44.9%,36m
5237,3,[CNboys]月赋情长,3223,745,33,18,51,64.7%,30m
5237,3,[肉鸡的饲养]魔法少女菜夜白,3223,321,16,9,25,64.0%,6m
5237,3,耀光,3223,333,14,9,23,60.9%,4m
5237,3,Deepseashark,3223,182,5,3,8,62.5%,3m
5237,3,[抱舔天物]风中飘落的叶,3223,116,4,4,8,50.0%,32m
5237,3,colintao,3223,60,2,3,5,40.0%,36m
5237,3,[格拉摩根]glycoprotien,3223,30,1,1,2,50.0%,31m
5237,3,黑娇喵,3223,0,0,1,1,0.0%,6m
5247,3,medium,3222,1524,133,114,247,53.8%,7m
5247,3,Motse,3222,1423,78,45,123,63.4%,28m
5247,3,[薄暮之光]Bruce,3222,977,37,32,69,53.6%,10m
5247,3,爱上悠雅,3222,736,31,29,60,51.7%,22m
5247,1,wby,3222,135,11,11,22,50.0%,2m
5247,3,fuy,3222,129,7,5,12,58.3%,37m
5247,3,[SUIBE]IIIIIIII,3222,168,7,6,13,53.8%,22m
5247,3,Dejavu,3222,124,5,3,8,62.5%,33m
5247,3,[腹黑傲娇受]于是,3222,146,5,7,12,41.7%,11m
5247,3,[响当当水友]PartinG,3222,88,4,3,7,57.1%,3m
5247,3,[MOD]Jack,3222,86,3,3,6,50.0%,32m
5247,3,顾念,3222,60,2,2,4,50.0%,36m
5247,3,[没头脑]dingshuo,3222,30,1,3,4,25.0%,18m
5247,3,星际之旅雷应昊,3222,0,0,1,1,0.0%,15m
5261,2,qlights,3221,248,10,7,17,58.8%,25m
5261,2,[华尔街股神]巴菲特,3221,0,4,1,5,80.0%,1h
5261,3,[炮炮]炮炮,3221,114,4,2,6,66.7%,35m
5261,3,SUMMER,3221,120,4,5,9,44.4%,14m
5261,3,Pan,3221,120,4,8,12,33.3%,19m
5261,3,[YM]Zimba,3221,0,1,0,1,100.0%,6m
5261,3,生无可恋,3221,30,1,1,2,50.0%,11m
5261,3,毕竟你巍哥,3221,0,1,1,2,50.0%,3m
5261,3,东北倒数第一蝶泳,3221,0,0,2,2,0.0%,1m
5261,1,我真的不是小灰灰,3221,0,0,5,5,0.0%,17m
5271,3,让机械化虐死我吧,3220,1537,339,320,659,51.4%,19m
5271,2,Vampirerider,3220,1422,106,106,212,50.0%,12m
5271,3,[般若巴巴空]恭迎隆王,3220,1159,58,58,116,50.0%,29m
5271,3,吴曦,3220,658,28,15,43,65.1%,16m
5271,3,[啊里奎]Lking,3220,438,21,8,29,72.4%,32m
5271,3,control,3220,193,8,5,13,61.5%,22m
5271,3,blackeyes,3220,92,3,6,9,33.3%,13m
5278,3,天天向尚,3219,168,56,56,112,50.0%,15m
5278,3,两仪式,3219,152,5,8,13,38.5%,35m
5278,1,uThermal,3219,91,2,0,2,100.0%,25m
5278,3,蛋蛋鹏利,3219,113,2,2,4,50.0%,8m
5278,2,llllllllllll,3219,0,2,3,5,40.0%,25m
5278,3,[天青车道]Kitakaze,3219,0,1,0,1,100.0%,15m
5278,3,派拉蒙,3219,30,1,1,2,50.0%,18m
5278,3,Serral,3219,0,0,1,1,0.0%,15m
5278,3,IIIIIIIIIIII,3219,0,0,3,3,0.0%,12m
5287,2,杀手游戏,3218,943,221,217,438,50.5%,35m
5287,2,拉斯玛祭司,3218,310,13,6,19,68.4%,16m
5287,3,givemestar,3218,326,12,14,26,46.2%,11m
5287,3,vivalavida,3218,218,8,8,16,50.0%,9m
5287,3,Shadowhunter,3218,116,3,1,4,75.0%,11m
5287,3,为了艾尔,3218,30,2,3,5,40.0%,4m
5287,3,[叶良树飞妈]星夜神话,3218,30,1,1,2,50.0%,9m
5287,3,[艾尔高等星灵]MagicGlory,3218,30,1,1,2,50.0%,9m
5287,3,推进之王,3218,0,0,1,1,0.0%,9m
5287,3,[输本夺冠啦]风魂,3218,0,0,1,1,0.0%,32m
5297,2,IIIIIIIII,3217,1561,712,692,1404,50.7%,31m
5297,3,[火焰雷兽]wjxtwilight,3217,846,301,273,574,52.4%,15m
5297,1,llllllllllll,3217,314,14,8,22,63.6%,16m
5297,3,[火焰雷兽]Qianniu,3217,350,13,12,25,52.0%,4m
5297,3,[星际鸽子组]大湿,3217,300,11,16,27,40.7%,3m
5297,1,Upia,3217,139,4,0,4,100.0%,26m
5297,3,YakumoRan,3217,120,3,1,4,75.0%,5m
5297,3,[你的剑很美]此岸的魔女,3217,60,3,2,5,60.0%,8m
5305,3,Machackx,3216,1419,144,139,283,50.9%,7m
5305,3,[JiTEAM]犹豫就会白给,3216,725,40,25,65,61.5%,36m
5305,3,[神武骑士团]打奥特曼的小怪兽,3216,558,22,17,39,56.4%,37m
5305,3,[白玉楼的幽灵]墨染的吃货,3216,520,19,17,36,52.8%,19m
5305,2,永远寂寞的小远,3216,344,12,20,32,37.5%,14m
5305,3,一地流星,3216,263,11,15,26,42.3%,12m
5305,3,二龙附身,3216,86,4,1,5,80.0%,4m
5305,3,[我们是无敌的]IIIIIIIIIIII,3216,30,2,4,6,33.3%,26m
5305,3,[神圣龙猪]龙小霞,3216,0,0,1,1,0.0%,11m
5305,3,[GO萌新分队]梅西,3216,0,0,1,1,0.0%,25m
5315,3,错过花开,3215,781,61,38,99,61.6%,4m
5315,3,[GhostV]Joker,3215,0,0,1,1,0.0%,19m
5317,2,[Amani]星哥吃饭用瓢羹,3214,1522,261,257,518,50.4%,19m
5317,3,[咖啡Fans]梦蝶蝶蝶蝶蝶,3214,666,24,21,45,53.3%,29m
5317,3,[埃蒙好可爱]蛋黄加汤,3214,306,19,19,38,50.0%,1m
5317,3,sandom,3214,250,9,15,24,37.5%,22m
5317,3,令人发笑的电脑,3214,114,4,1,5,80.0%,22m
5322,3,木毛野獸神楽夸,3213,1616,111,106,217,51.2%,17m
5322,2,kanGaXX,3213,970,66,80,146,45.2%,22m
5322,3,什么东西,3213,837,31,41,72,43.1%,36m
5322,3,加藤鹰,3213,777,29,30,59,49.2%,4m
5322,3,好肥的大橘猫,3213,373,19,13,32,59.4%,34m
5322,3,[Shawk]惜梦,3213,288,12,4,16,75.0%,22m
5322,3,zici,3213,306,12,8,20,60.0%,25m
5322,3,Naive,3213,169,8,6,14,57.1%,34m
5322,3,[妈个鸡谐会]MaGeJiTerran,3213,144,5,5,10,50.0%,32m
5322,3,Convergent,3213,30,2,0,2,100.0%,3m
5322,3,IIIIII,3213,60,2,2,4,50.0%,31m
5322,3,[侦查靠猜]theRobins,3213,0,1,0,1,100.0%,3m
5322,3,本鸡需要援助,3213,0,1,1,2,50.0%,30m
5322,3,[盖世双谐]clown,3213,30,1,2,3,33.3%,22m
5322,1,鸽屿,3213,0,1,2,3,33.3%,31m
5322,3,你从没见过我,3213,0,0,1,1,0.0%,23m
5322,3,[三只小鸡]剪影的模样,3213,0,0,1,1,0.0%,8m
5322,3,[西装暴徒]IIIIIIIII,3213,0,0,1,1,0.0%,14m
5322,1,矿区风大听不清,3213,0,0,6,6,0.0%,60m
5341,3,解放者猥琐,3212,1364,95,85,180,52.8%,3m
5341,2,[TNL]风之伤,3212,1201,53,61,114,46.5%,35m
5341,3,[老油条战队]抗病毒颗粒,3212,442,23,16,39,59.0%,25m
5341,3,[养生休闲]SugarMan,3212,190,20,6,26,76.9%,8m
5341,1,IIIIIIIIIIII,3212,266,6,9,15,40.0%,12m
5341,2,羊马它,3212,110,3,2,5,60.0%,4m
5341,2,[贫乳即是正义]SXIZOK,3212,96,2,0,2,100.0%,43m
5341,3,[SCD]蘑菇,3212,30,1,2,3,33.3%,10m
5341,3,[暴雪三十队]新手灬别打脸,3212,30,1,3,4,25.0%,30m
5341,3,obo,3212,0,0,1,1,0.0%,11m
5341,3,[懒散]Reprise,3212,0,0,1,1,0.0%,2m
5341,3,[胖墩儿]Arcturus,3212,0,0,2,2,0.0%,25m
5353,3,[小三爷]IIIIIIIIIIII,3211,578,24,19,43,55.8%,4m
5353,3,yan,3211,180,9,3,12,75.0%,16m
5353,2,[幻海奇妙夜]antipart,3211,192,6,3,9,66.7%,25m
5353,3,英俊的老菜鸟,3211,186,6,13,19,31.6%,32m
5353,3,kirakira,3211,118,4,7,11,36.4%,1m
5353,3,[侍奉社]雪之下雪乃,3211,30,2,0,2,100.0%,15m
5353,3,库巴大魔王,3211,30,2,4,6,33.3%,16m
5353,3,羽飞羽落,3211,0,1,0,1,100.0%,9m
5353,3,Kaystallos,3211,0,1,0,1,100.0%,8m
5353,3,[一块晶化瓦斯]kira,3211,0,1,0,1,100.0%,16m
5353,3,无一幸免,3211,0,1,1,2,50.0%,29m
5353,3,起个昵称太麻烦,3211,30,1,2,3,33.3%,24m
5353,3,家有大白咪,3211,0,0,6,6,0.0%,17m
5366,3,夕阳的痕迹,3210,1359,188,164,352,53.4%,19m
5366,3,[RaMoC]BLacK,3210,787,30,24,54,55.6%,18m
5366,3,[二人组]暴走天使,3210,309,13,11,24,54.2%,3m
5366,1,头塔切发,3210,164,7,2,9,77.8%,17m
5366,3,天很黑,3210,157,5,4,9,55.6%,6m
5366,2,imbap,3210,141,5,9,14,35.7%,28m
5366,3,FOVR,3210,88,4,2,6,66.7%,6m
5366,2,[在下菜鸡一只]蔚蓝天际,3210,95,3,1,4,75.0%,1h
5366,3,IIIIIIIIIIII,3210,30,2,0,2,100.0%,4m
5366,3,[QAQ]爱上萝莉的三好,3210,30,2,0,2,100.0%,30m
5366,3,Musan,3210,0,0,1,1,0.0%,34m
5366,3,[MGT谐星会]天凌,3210,0,0,1,1,0.0%,5m
5366,3,[眼瞎的车万苟]西行寺幽幽纸,3210,0,0,1,1,0.0%,9m
5379,3,cinereus,3209,1355,73,72,145,50.3%,25m
5379,3,沉默等待崛起死亡,3209,287,9,6,15,60.0%,7m
5379,1,[专制各种不服]戏中人易散,3209,88,7,6,13,53.8%,16m
5379,3,[ENIAC]Eone,3209,60,3,2,5,60.0%,2m
5379,3,IIIIIIIIIIII,3209,90,3,4,7,42.9%,5m
5379,2,PiNoJ,3209,0,3,7,10,30.0%,37m
5379,3,学姐不要这样,3209,94,3,8,11,27.3%,16m
5379,3,西湖底灵感大王,3209,30,2,0,2,100.0%,1m
5379,3,布拉格,3209,30,1,3,4,25.0%,35m
5379,3,April,3209,0,0,1,1,0.0%,14m
5379,2,[NanTeS]jkai,3209,0,0,2,2,0.0%,33m
5379,3,[满汉全席]土豆牛腩,3209,0,0,3,3,0.0%,11m
5379,3,[游戏风云OL]我叫小奔,3209,0,0,3,3,0.0%,19m
5392,3,打星际要讲武德,3208,1463,233,207,440,53.0%,30m
5392,3,yosang,3208,1487,136,120,256,53.1%,7m
5392,3,天狼,3208,625,27,21,48,56.2%,2m
5392,3,[HHZX]十点半的人生,3208,401,17,10,27,63.0%,26m
5392,3,llllllllllll,3208,239,8,4,12,66.7%,10m
5392,3,[Shout]OumaHaruka,3208,191,8,5,13,61.5%,12m
5392,3,[鹌鹑带星]高坚果,3208,162,7,3,10,70.0%,5m
5392,3,silver,3208,112,4,3,7,57.1%,22m
5392,3,[救赎蔷薇]天国副君萨斯利尔,3208,162,4,3,7,57.1%,7m
5392,3,友方,3208,51,3,1,4,75.0%,37m
5392,3,MissileTruck,3208,0,1,0,1,100.0%,31m
5392,3,莫殇痕,3208,0,1,0,1,100.0%,4m
5392,3,Cooooo,3208,0,0,1,1,0.0%,23m
5392,3,[4399]夏炎,3208,0,0,1,1,0.0%,35m
5406,2,愤怒摇滚,3207,1577,235,238,473,49.7%,24m
5406,2,MnMWing,3207,1471,115,128,243,47.3%,21m
5406,3,HIM,3207,608,81,72,153,52.9%,7m
5406,3,IIIIIIIIIIII,3207,1140,46,49,95,48.4%,7m
5406,3,STATE,3207,512,21,17,38,55.3%,17m
5406,3,Elijah,3207,386,18,15,33,54.5%,32m
5406,3,[KPG]SeleiXi,3207,458,17,16,33,51.5%,3m
5406,3,落星,3207,266,16,13,29,55.2%,22m
5406,3,[AGC]华南施工,3207,176,7,7,14,50.0%,37m
5406,3,無訁,3207,116,4,3,7,57.1%,2m
5406,3,[娱乐玩家]一束九,3207,0,1,1,2,50.0%,5m
5406,3,[80后丶]鳴上泉,3207,97,1,3,4,25.0%,16m
5406,3,虫儿飞,3207,0,0,1,1,0.0%,8m
5406,3,[雁门苍云]咬人猫,3207,0,0,7,7,0.0%,17m
5420,3,EDC,3206,828,45,43,88,51.1%,25m
5420,3,肯定会发达,3206,694,26,26,52,50.0%,7m
5420,3,墨殇,3206,194,20,21,41,48.8%,7m
5420,3,change,3206,530,17,24,41,41.5%,8m
5420,3,丿情谊灬至上,3206,440,16,16,32,50.0%,11m
5420,3,[赢一盘就睡]dustin,3206,404,14,22,36,38.9%,26m
5420,3,铲车人领袖,3206,286,13,8,21,61.9%,5m
5420,3,不会放大招,3206,354,11,14,25,44.0%,22m
5420,1,李璐江,3206,162,7,3,10,70.0%,34m
5420,3,[半天打不赢]Nicholas,3206,106,5,3,8,62.5%,7m
5420,3,Grafa,3206,0,1,1,2,50.0%,21m
5420,3,Aubergine,3206,0,0,1,1,0.0%,4m
5420,3,[暴雪全能亡]来世再做二五仔,3206,0,0,1,1,0.0%,37m
5420,3,[火炬的合法]田哥不要啊,3206,0,0,1,1,0.0%,25m
5420,3,[逗帝]跪下叫虎哥,3206,0,0,1,1,0.0%,29m
5435,2,[Borne]老油条,3205,1398,603,589,1192,50.6%,30m
5435,2,我是你爹,3205,1425,162,169,331,48.9%,26m
5435,3,[XMG00]都来灰灰,3205,936,100,95,195,51.3%,4m
5435,2,南充高级中学,3205,1500,76,90,166,45.8%,1m
5435,3,magiczerg,3205,154,10,9,19,52.6%,2m
5435,3,[贝贝龙]梦蝶蝶蝶蝶蝶,3205,58,3,2,5,60.0%,25m
5435,3,Spin,3205,0,2,4,6,33.3%,33m
5435,3,我要曹哩啊,3205,62,2,5,7,28.6%,15m
5435,3,[城市建设集团]JOKE,3205,0,1,1,2,50.0%,12m
5435,3,[浙江大学]繁华落尽,3205,0,1,2,3,33.3%,17m
5445,3,和我无关的猫,3204,1667,115,110,225,51.1%,2m
5445,3,在家睡觉,3204,818,31,29,60,51.7%,15m
5445,1,猪兔子,3204,336,14,10,24,58.3%,9m
5445,3,Chembuster,3204,282,10,12,22,45.5%,29m
5445,3,一届差生,3204,224,8,7,15,53.3%,32m
5445,3,阿薇最可爱,3204,216,6,3,9,66.7%,35m
5445,3,[萝莉之芯]影月仇,3204,180,6,8,14,42.9%,25m
5445,3,钱若水,3204,97,5,3,8,62.5%,17m
5445,3,keke,3204,184,4,11,15,26.7%,14m
5445,3,[久美子珠宝]渣渣徽,3204,127,3,1,4,75.0%,35m
5445,3,[Ds丶]霸主,3204,81,3,2,5,60.0%,4m
5445,3,[被感染的旭东]Nanami,3204,0,0,1,1,0.0%,3m
5445,3,[欧拉欧拉欧拉]日常白给,3204,0,0,1,1,0.0%,26m
5458,3,地狱老妖,3203,399,17,17,34,50.0%,37m
5458,2,大蛇丸酱,3203,0,4,1,5,80.0%,1h
5458,3,[CUGer]Yukipedia,3203,0,4,1,5,80.0%,21m
5458,2,Lemon,3203,92,3,2,5,60.0%,26m
5458,3,[欢乐星际]FalsE,3203,30,2,1,3,66.7%,19m
5458,3,小浪浪,3203,0,1,0,1,100.0%,36m
5458,3,[中二狂魔]少丶天,3203,0,1,0,1,100.0%,22m
5458,3,hollow,3203,0,1,4,5,20.0%,15m
5458,3,[sc谐盟]嘿嘿嘿呵呵,3203,0,0,1,1,0.0%,4m
5458,2,martaT,3203,0,0,1,1,0.0%,4m
5458,3,迦楼罗,3203,0,0,1,1,0.0%,7m
5458,3,[不偷不狗硬顶]可恨的菜逼,3203,0,0,1,1,0.0%,2m
5470,3,Bustling,3202,1566,293,266,559,52.4%,34m
5470,3,Pro,3202,1393,78,63,141,55.3%,32m
5470,3,[浪啊浪]仁义无双野人王,3202,1322,48,53,101,47.5%,16m
5470,3,快乐菜鸟,3202,323,13,11,24,54.2%,34m
5470,1,WindSpeaker,3202,118,6,3,9,66.7%,35m
5470,3,泽琦,3202,86,3,1,4,75.0%,15m
5470,3,diat,3202,60,3,3,6,50.0%,23m
5470,3,[四叶草]请输入姓名,3202,0,1,0,1,100.0%,18m
5470,3,Jim,3202,0,1,1,2,50.0%,14m
5470,3,aada,3202,0,1,1,2,50.0%,35m
5470,3,漾哥打星际,3202,0,0,1,1,0.0%,8m
5470,3,danbi,3202,0,0,1,1,0.0%,25m
5470,3,[为了地球]musha,3202,0,0,2,2,0.0%,23m
5483,2,IIlIlIIIIIll,3201,1478,156,157,313,49.8%,7m
5483,3,毛毛,3201,1245,56,31,87,64.4%,22m
5483,2,熙珹,3201,108,3,1,4,75.0%,34m
5483,1,[北京城管]小小晨钰,3201,118,3,2,5,60.0%,41m
5483,3,她那晚才十三岁,3201,60,2,3,5,40.0%,32m
5483,3,Skyyyyyy,3201,0,0,1,1,0.0%,19m
5483,3,[盖拉多]CleanZerg,3201,0,0,1,1,0.0%,36m
5490,3,roVerWill,3200,1568,79,81,160,49.4%,9m
5490,3,奋进的追,3200,1126,72,73,145,49.7%,16m
5490,3,逃跑冠军丶,3200,960,35,36,71,49.3%,7m
5490,3,Leosnoeil,3200,699,30,23,53,56.6%,37m
5490,3,[TNL]AstraeaViva,3200,399,17,13,30,56.7%,4m
5490,3,XiaoZhaoQAQ,3200,90,4,4,8,50.0%,18m
5490,1,[智氏家族]智智智智智,3200,110,3,2,5,60.0%,29m
5490,3,rei,3200,0,1,0,1,100.0%,33m
5490,3,九阴争茎,3200,0,1,0,1,100.0%,8m
5490,3,REPULSER,3200,30,1,2,3,33.3%,7m
5490,3,喵喵喵喵喵喵喵,3200,0,0,1,1,0.0%,30m
5490,3,[一盒峰我大哥]莫子枫卿,3200,0,0,2,2,0.0%,20m
5502,3,[浪啊浪]大怪兽,3199,1672,129,118,247,52.2%,36m
5502,3,xiaoF,3199,466,55,50,105,52.4%,35m
5502,3,[董魔王制霸军]瞄了个咪咪,3199,293,46,36,82,56.1%,29m
5502,3,猜猜看,3199,765,44,52,96,45.8%,36m
5502,3,SNAIL,3199,568,20,15,35,57.1%,4m
5502,3,Tian,3199,211,9,4,13,69.2%,11m
5502,3,[小鸡屠宰场]XingYe,3199,82,8,8,16,50.0%,35m
5502,3,怒虐倒跌,3199,228,8,9,17,47.1%,17m
5502,3,杨嘉禾,3199,30,2,1,3,66.7%,16m
5502,3,[萌新抱团协会]小阳阳,3199,30,2,2,4,50.0%,9m
5502,3,[星歌]命运,3199,0,1,0,1,100.0%,37m
5502,3,Skywalker,3199,0,1,0,1,100.0%,33m
5502,3,[刺蛇互助社团]SpecTrum,3199,0,0,1,1,0.0%,19m
5502,1,[艾尔之名]XYJ,3199,0,0,3,3,0.0%,2m
5516,3,年轻人不讲武德,3198,1593,184,155,339,54.3%,21m
5516,3,[NS]拥凌,3198,1556,122,141,263,46.4%,8m
5516,3,让你叫爸爸,3198,982,40,34,74,54.1%,21m
5516,3,新概念英语,3198,362,18,12,30,60.0%,25m
5516,3,完美地狱,3198,324,16,8,24,66.7%,15m
5516,3,Moore,3198,234,8,8,16,50.0%,17m
5516,3,[亀山社中]白石麻衣毕业快乐,3198,192,7,6,13,53.8%,3m
5516,3,[情谊至上]丿有解丶,3198,97,6,2,8,75.0%,7m
5516,1,[QAQooo]黑白,3198,255,6,15,21,28.6%,23m
5516,3,[ToHo]米格二三七,3198,0,1,0,1,100.0%,8m
5516,3,[遗忘之人]恋如雨止,3198,0,0,1,1,0.0%,29m
5516,3,[化鲸]奶茶,3198,0,0,1,1,0.0%,6m
5516,2,大菜逼,3198,0,0,5,5,0.0%,36m
5529,3,VSTOM,3197,1268,73,65,138,52.9%,36m
5529,3,DJeff,3197,537,22,11,33,66.7%,35m
5529,3,囡囡,3197,460,20,12,32,62.5%,14m
5529,3,[z好弱啊]LenmeeSander,3197,286,9,6,15,60.0%,31m
5529,3,昕昕,3197,167,5,0,5,100.0%,19m
5529,3,九代目,3197,144,5,6,11,45.5%,13m
5529,3,[星际兄弟]二班学霸,3197,30,2,0,2,100.0%,36m
5529,3,Tuteli,3197,62,2,6,8,25.0%,8m
5529,3,xuGREAN,3197,0,1,0,1,100.0%,22m
5529,3,ciallo,3197,0,1,0,1,100.0%,25m
5529,3,秒我是哪个,3197,0,1,0,1,100.0%,9m
5529,3,王灰机这尼玛,3197,0,0,2,2,0.0%,5m
5541,3,奥利奥的微笑,3196,391,15,11,26,57.7%,4m
5541,2,[王文博大黑人]TasVinor,3196,117,6,4,10,60.0%,26m
5541,3,宇宙无敌美洲豹,3196,122,6,4,10,60.0%,37m
5541,3,CazzForever,3196,94,5,1,6,83.3%,20m
5541,2,相叶丶弘树,3196,0,4,1,5,80.0%,1h
5541,3,[YZ]我是大国王,3196,30,2,1,3,66.7%,6m
5541,2,[我是萌新Q]暗影独行,3196,0,0,1,1,0.0%,15m
5541,3,死王灵,3196,0,0,1,1,0.0%,5m
5541,3,Zackya,3196,0,0,1,1,0.0%,19m
5541,3,llllllllllll,3196,0,0,1,1,0.0%,5m
5541,2,nemesis,3196,0,0,3,3,0.0%,11m
5552,2,新开豆腐干,3195,1189,83,82,165,50.3%,18m
5552,3,这个世界需要勇士,3195,1478,55,59,114,48.2%,35m
5552,3,MagejiTerran,3195,1270,50,49,99,50.5%,28m
5552,3,Taeja,3195,132,4,13,17,23.5%,36m
5552,3,ruler,3195,0,1,0,1,100.0%,7m
5552,3,长河待日落,3195,0,1,0,1,100.0%,3m
5552,3,[NVKR]TED,3195,0,0,1,1,0.0%,17m
5552,3,[pypypy]TIME,3195,0,0,1,1,0.0%,29m
5552,3,[堕天使之翼]堕落的天使,3195,0,0,2,2,0.0%,5m
5561,3,林耀东,3194,1555,120,105,225,53.3%,25m
5561,3,ryan,3194,1178,61,67,128,47.7%,5m
5561,3,Sephiroth,3194,197,15,8,23,65.2%,22m
5561,3,[Borne]sixsixsix,3194,278,11,15,26,42.3%,35m
5561,3,jimmilos,3194,252,8,15,23,34.8%,2m
5561,3,[旋风游骑兵]克己,3194,0,1,0,1,100.0%,25m
5561,3,[i5]沈繁,3194,0,1,0,1,100.0%,30m
5561,1,[蓝色星尘]LRY,3194,0,1,2,3,33.3%,9m
5561,3,[虫子觉醒]隐三叶,3194,0,0,1,1,0.0%,21m
5561,3,[黑鲨]东京王者,3194,0,0,1,1,0.0%,32m
5561,2,时军锋,3194,0,0,2,2,0.0%,1h
5572,2,退堂鼓表演艺术家,3193,1456,108,108,216,50.0%,30m
5572,3,[半个菜鸟]IlilI,3193,1213,79,72,151,52.3%,17m
5572,3,Faiz,3193,1020,44,29,73,60.3%,14m
5572,3,[游戏风云OL]二次元刀酱,3193,601,26,27,53,49.1%,35m
5572,3,武藤游戏,3193,464,17,26,43,39.5%,36m
5572,3,gqz,3193,381,16,13,29,55.2%,32m
5572,3,[我们是瞎子]东北独角仙,3193,210,10,3,13,76.9%,22m
5572,3,打硬铁的铁匠,3193,224,8,9,17,47.1%,19m
5572,2,[刃下心]忍野忍,3193,0,4,1,5,80.0%,25m
5572,3,[Namic]打铁还需自身硬,3193,58,3,0,3,100.0%,8m
5572,3,[文丑之考验]张小白,3193,0,1,0,1,100.0%,32m
5572,3,[HK丶S]夕颜凉,3193,0,1,0,1,100.0%,9m
5572,1,菜鸡一个,3193,73,1,2,3,33.3%,3m
5572,3,终末之冬,3193,0,0,1,1,0.0%,33m
5572,3,[SoloAs]卍天痕卍,3193,0,0,1,1,0.0%,19m
5587,3,[CPT]永远滴虫,3192,1606,163,149,312,52.2%,7m
5587,3,[闭眼虐你]郑州孙一峰,3192,1508,117,124,241,48.5%,15m
5587,2,[三四]界辰,3192,1309,90,85,175,51.4%,24m
5587,3,不打内战,3192,1128,78,80,158,49.4%,32m
5587,2,[老油条战队4]占卜阿里巴巴,3192,1045,71,80,151,47.0%,22m
5587,3,Kuroro,3192,290,12,9,21,57.1%,9m
5587,3,[AcePoX]Roy,3192,270,9,9,18,50.0%,11m
5587,3,Korlar,3192,243,8,8,16,50.0%,30m
5587,3,[怎么赢z]一束七,3192,207,8,13,21,38.1%,29m
5587,3,鸡立鹤群,3192,0,1,0,1,100.0%,22m
5587,3,[堕落使徒]Handgun,3192,0,1,3,4,25.0%,15m
5587,3,[橫須賀鎮守府]金正思,3192,0,0,1,1,0.0%,1m
5587,3,[暴兵军团]欲望之血,3192,0,0,2,2,0.0%,18m
5600,3,yumao,3191,1634,264,252,516,51.2%,17m
5600,3,文文,3191,1469,191,185,376,50.8%,25m
5600,3,Prismriver,3191,1256,88,82,170,51.8%,3m
5600,3,萌萌小宠虫,3191,925,53,7,60,88.3%,10m
5600,3,江南人见愁,3191,974,37,37,74,50.0%,35m
5600,3,[一般赢不了]自闭只想下棋,3191,464,18,17,35,51.4%,3m
5600,3,[凑崎纱夏]Dark,3191,328,12,15,27,44.4%,26m
5600,3,真不错,3191,264,9,4,13,69.2%,26m
5600,1,Symbol,3191,262,9,12,21,42.9%,29m
5600,3,tarfet,3191,178,6,8,14,42.9%,35m
5600,3,[GIE]古明地恋天下第一,3191,60,3,2,5,60.0%,29m
5600,3,[恶魔之眼]butters,3191,0,1,0,1,100.0%,5m
5600,3,xiaoxx,3191,0,1,2,3,33.3%,11m
5600,3,[星际2谐会]知道不知道,3191,0,0,1,1,0.0%,12m
5600,3,[幽金贮藏堆]那你不是很棒棒哦,3191,0,0,1,1,0.0%,9m
5600,3,IIIIIIIIIIII,3191,0,0,1,1,0.0%,25m
5616,3,Nnnn,3190,1587,254,233,487,52.2%,2m
5616,3,秋矢菊,3190,1073,48,33,81,59.3%,37m
5616,2,青檀郎,3190,263,39,64,103,37.9%,34m
5616,3,萧克明,3190,934,36,36,72,50.0%,32m
5616,3,可可,3190,936,33,41,74,44.6%,11m
5616,3,曾哥,3190,113,8,7,15,53.3%,25m
5616,3,MMbloodAI,3190,0,2,3,5,40.0%,21m
5616,3,[WILLE]夜游君,3190,0,1,0,1,100.0%,36m
5616,3,王阿姨,3190,0,1,0,1,100.0%,9m
5616,3,[木山]木繁枝,3190,0,1,3,4,25.0%,17m
5616,3,kloseVictor,3190,0,0,1,1,0.0%,28m
5616,3,真的菜鸡,3190,0,0,1,1,0.0%,4m
5628,2,[艾尔的荣誉]菲斯菲斯,3189,936,144,137,281,51.2%,9m
5628,2,天殇,3189,115,6,4,10,60.0%,36m
5628,3,Innovation,3189,119,5,3,8,62.5%,25m
5628,2,ZhangSiTu,3189,145,4,5,9,44.4%,34m
5628,3,[龙背上的骑兵]恋留阳,3189,146,4,8,12,33.3%,22m
5628,3,[SC2近卫军]我乱打的,3189,0,1,0,1,100.0%,17m
5628,3,养鱼啊,3189,0,0,1,1,0.0%,26m
5628,3,Devil,3189,0,0,1,1,0.0%,17m
5628,3,[抱走我家吹雪]詅楪,3189,0,0,1,1,0.0%,9m
5628,2,[ODSC]晦明,3189,0,0,2,2,0.0%,34m
5638,2,游王子讴歌,3188,1518,113,121,234,48.3%,12m
5638,3,蛋蛋的忧伤,3188,1054,107,102,209,51.2%,9m
5638,3,[东南西北战区]拓孚大吊哥,3188,874,58,44,102,56.9%,8m
5638,3,[BGD]教皇丶,3188,984,35,43,78,44.9%,12m
5638,3,枯萎之地,3188,304,11,6,17,64.7%,20m
5638,3,碍尹思坦,3188,173,10,5,15,66.7%,36m
5638,1,拾来运转,3188,95,5,2,7,71.4%,20m
5638,3,[华东师大]zealotCCP,3188,147,4,2,6,66.7%,16m
5638,3,先天圣体道胎,3188,92,4,6,10,40.0%,4m
5638,3,爱到底,3188,94,4,9,13,30.8%,15m
5638,3,王教授,3188,30,2,1,3,66.7%,15m
5638,3,Sirius,3188,38,2,6,8,25.0%,17m
5638,3,新手电脑,3188,0,1,1,2,50.0%,35m
5638,3,[星光咖啡馆]三司绫濑,3188,0,0,1,1,0.0%,5m
5638,3,[大魔王刀刀酱]sakura,3188,0,0,1,1,0.0%,32m
5653,2,[六魔将军]白熊警长,3187,1517,350,354,704,49.7%,36m
5653,3,小花仙张小绯,3187,1514,324,309,633,51.2%,18m
5653,3,国服工蜂,3187,558,51,33,84,60.7%,5m
5653,3,[希靈使徒]铃村悟,3187,458,19,12,31,61.3%,21m
5653,3,疯魂,3187,417,18,13,31,58.1%,28m
5653,3,sda,3187,435,17,13,30,56.7%,4m
5653,3,Janos,3187,294,15,10,25,60.0%,21m
5653,3,Clover,3187,404,13,20,33,39.4%,23m
5653,3,中国科学技术大学,3187,298,10,12,22,45.5%,11m
5653,2,[XXHZ30]下岗的屠户,3187,274,7,7,14,50.0%,7m
5653,3,[这把打快攻]五十块的好兄弟,3187,204,7,7,14,50.0%,6m
5653,2,HEIdiiie,3187,0,4,1,5,80.0%,26m
5653,3,玖琳吾妻,3187,90,4,5,9,44.4%,17m
5653,3,[野蛮猫骑士]匹夫一怒血溅五步,3187,0,1,0,1,100.0%,5m
5653,3,[EGL]Aurelien,3187,30,1,3,4,25.0%,8m
5653,2,有天赋的选手,3187,0,1,4,5,20.0%,10m
5653,3,SOUL,3187,0,0,1,1,0.0%,8m
5653,3,[一只大咸鱼]为什么我这么菜,3187,0,0,1,1,0.0%,37m
5653,3,永远须臾罪人,3187,0,0,1,1,0.0%,18m
5672,3,善解人衣,3186,986,52,39,91,57.1%,4m
5672,3,秋风瑟瑟,3186,980,44,40,84,52.4%,11m
5672,3,接化发最棒了,3186,114,5,2,7,71.4%,31m
5672,3,[刺蛇互助社团]wwwgogogo,3186,116,4,3,7,57.1%,2m
5672,3,手残泰伦,3186,86,3,3,6,50.0%,19m
5672,3,[奕子我儿子]若离啊不哭,3186,30,2,0,2,100.0%,32m
5672,3,[零柒零柒]liggia,3186,0,1,0,1,100.0%,24m
5672,2,枪兵,3186,0,0,1,1,0.0%,24m
5672,3,Hades,3186,0,0,1,1,0.0%,25m
5672,3,[Beasty]FLInovation,3186,0,0,1,1,0.0%,35m
5672,3,Sindoria,3186,0,0,2,2,0.0%,14m
5683,3,神之魅影,3185,1505,232,221,453,51.2%,36m
5683,3,songge,3185,1328,87,88,175,49.7%,25m
5683,3,[小猪仔]star,3185,1615,64,59,123,52.0%,30m
5683,3,pbx,3185,1061,43,35,78,55.1%,32m
5683,3,[雾之湖红魔馆]芙兰朵露斯卡雷特,3185,94,9,8,17,52.9%,3m
5683,1,[一波]凤茗渝,3185,96,6,1,7,85.7%,2m
5683,3,[肌肉]知止,3185,170,6,14,20,30.0%,21m
5683,3,[死海虚妄]死海灬德克拉斯,3185,112,5,6,11,45.5%,25m
5683,3,Thinker,3185,122,4,10,14,28.6%,31m
5683,3,[自由朝鲜]大浦洞金正男,3185,30,2,0,2,100.0%,33m
5683,1,splash,3185,91,2,1,3,66.7%,21m
5683,3,[妹液]带枪的尼姑,3185,58,2,4,6,33.3%,32m
5683,3,[Ryon榕]王菜花,3185,30,1,1,2,50.0%,16m
5683,3,Anliter,3185,0,0,3,3,0.0%,3m
5697,3,骆驼,3184,1592,143,127,270,53.0%,23m
5697,3,[AM]IIIIIIIIIIII,3184,1322,52,52,104,50.0%,37m
5697,3,新手也阴人,3184,330,16,16,32,50.0%,5m
5697,3,半岛的风,3184,353,12,9,21,57.1%,9m
5697,3,[楔机]箱神,3184,218,10,8,18,55.6%,20m
5697,2,影劫,3184,126,6,4,10,60.0%,19m
5697,2,万年马冬梅,3184,0,3,2,5,60.0%,19m
5697,3,暗影之风暴,3184,30,2,0,2,100.0%,32m
5697,3,DoomHammer,3184,0,1,0,1,100.0%,14m
5697,3,kira,3184,0,0,1,1,0.0%,33m
5707,1,无彡夏,3183,165,8,3,11,72.7%,1h
5707,3,lethe,3183,204,7,9,16,43.8%,14m
5707,3,苏远烟,3183,159,4,1,5,80.0%,7m
5707,3,orz,3183,86,4,1,5,80.0%,20m
5707,3,LubovSolonRz,3183,58,3,1,4,75.0%,7m
5707,3,你皮,3183,30,2,1,3,66.7%,7m
5707,3,友情客串,3183,0,1,0,1,100.0%,32m
5707,3,[阿库西斯教团]客串炮灰,3183,0,1,0,1,100.0%,3m
5707,3,[星痕]秦心,3183,0,1,1,2,50.0%,25m
5707,3,孙焕佳的前男友,3183,30,1,4,5,20.0%,12m
5707,3,[LP战队]晨晨大宝贝,3183,0,0,1,1,0.0%,2m
5707,2,blankXD,3183,0,0,2,2,0.0%,36m
5719,3,龙泽,3182,1518,160,141,301,53.2%,37m
5719,3,不探路会被野,3182,479,31,16,47,66.0%,5m
5719,3,枫之云,3182,430,15,19,34,44.1%,7m
5719,2,[三个二五仔]zzty,3182,118,6,1,7,85.7%,38m
5719,3,[庭庭中一棵]请叫我罗浪浪,3182,148,6,7,13,46.2%,3m
5719,3,Leaderone,3182,112,4,6,10,40.0%,22m
5719,3,[G3后援会]阿露艾露玛,3182,30,2,0,2,100.0%,10m
5719,3,酷酷的瞳,3182,0,0,1,1,0.0%,28m
5727,3,[天下大同]bird,3181,548,20,25,45,44.4%,7m
5727,3,SourLemon,3181,236,14,9,23,60.9%,23m
5727,3,猫的自画像,3181,293,11,3,14,78.6%,18m
5727,3,紫苑寺有子,3181,62,3,3,6,50.0%,26m
5727,3,缥缈彼岸,3181,0,1,0,1,100.0%,9m
5727,3,纵横孤独,3181,97,1,1,2,50.0%,37m
5727,3,星际这么难打毛,3181,30,1,1,2,50.0%,17m
5727,3,INnoVation,3181,0,0,1,1,0.0%,2m
5727,1,Savior,3181,0,0,1,1,0.0%,8m
5727,3,[文明公正诚信]低语的剥皮人,3181,0,0,1,1,0.0%,22m
5727,3,[GUNA]bluki,3181,0,0,1,1,0.0%,33m
5727,2,Daydreamer,3181,0,0,1,1,0.0%,22m
5739,3,干净虫族,3180,1497,157,141,298,52.7%,11m
5739,3,twilight,3180,260,30,34,64,46.9%,4m
5739,3,Darkrabbit,3180,591,28,15,43,65.1%,19m
5739,3,极品菜鸟,3180,547,25,15,40,62.5%,37m
5739,3,IIIIIIIIIIII,3180,328,13,10,23,56.5%,7m
5739,3,[四川四川]西境之西南境之南,3180,114,5,5,10,50.0%,3m
5739,3,demonluq,3180,30,2,0,2,100.0%,20m
5739,3,[ZTSCAP]羽落,3180,0,1,0,1,100.0%,33m
5739,3,Alonso,3180,30,1,1,2,50.0%,25m
5739,3,[迷死他波波]胖子,3180,30,1,3,4,25.0%,25m
5739,3,[路人谐星]振振君子,3180,0,0,1,1,0.0%,21m
5739,3,[噶姐守护协会]Vivian,3180,0,0,1,1,0.0%,14m
5739,2,[无谐可鸡]强尼爬着,3180,0,0,1,1,0.0%,1h
5739,3,[咏春]InNoVation,3180,0,0,1,1,0.0%,32m
5753,3,[ACG系]凄隐落枫,3179,1299,122,125,247,49.4%,32m
5753,3,Distort,3179,750,100,81,181,55.2%,7m
5753,3,共体,3179,1539,67,52,119,56.3%,8m
5753,2,Sakura,3179,422,22,29,51,43.1%,26m
5753,2,灬玖,3179,268,11,5,16,68.8%,44m
5753,3,易淼,3179,51,10,12,22,45.5%,2m
5753,3,[九条命的狐狸]野生的镜子,3179,152,5,0,5,100.0%,3m
5753,1,Win,3179,167,4,5,9,44.4%,1h
5753,3,[Beasty]路漫漫,3179,52,2,2,4,50.0%,25m
5753,3,IIIIIIIIIIII,3179,58,2,3,5,40.0%,11m
5753,3,qwedcr,3179,0,1,0,1,100.0%,22m
5753,3,黑暗森林,3179,0,0,1,1,0.0%,23m
5753,2,巅峰游侠,3179,0,0,2,2,0.0%,1h
5766,3,隔壁老王,3178,951,99,72,171,57.9%,36m
5766,3,Ryan,3178,1209,53,54,107,49.5%,35m
5766,3,蛇皮养生怪,3178,733,35,19,54,64.8%,31m
5766,3,[CUSTE]WAlTER,3178,946,35,36,71,49.3%,22m
5766,3,大橘为重,3178,522,26,8,34,76.5%,22m
5766,3,[ToHo]诸葛小亮,3178,353,20,32,52,38.5%,35m
5766,3,[秋毫]spacer,3178,251,9,2,11,81.8%,11m
5766,2,Withzzz,3178,251,8,12,20,40.0%,4m
5766,3,ByuN,3178,111,5,3,8,62.5%,18m
5766,3,[DMRe]哀泣的梦魇,3178,0,3,2,5,60.0%,26m
5766,3,[动能矩阵开启]yyccvwic,3178,62,3,3,6,50.0%,32m
5766,3,[InsS]陆离,3178,0,1,1,2,50.0%,17m
5766,3,[SC2VIP]VIPSM,3178,30,1,1,2,50.0%,25m
5766,3,[我们是探机]右京,3178,0,0,1,1,0.0%,22m
5766,3,神罗天征,3178,0,0,1,1,0.0%,36m
5766,3,[uui]pterosaurrun,3178,0,0,2,2,0.0%,14m
5782,2,西瓜刀少年,3177,1451,294,298,592,49.7%,24m
5782,3,卡拉卡拉,3177,961,36,32,68,52.9%,16m
5782,3,狗二蛋,3177,203,19,18,37,51.4%,2m
5782,3,Revolution,3177,144,5,6,11,45.5%,2m
5782,3,夜羽酱,3177,88,3,4,7,42.9%,23m
5782,3,Curtain,3177,30,2,0,2,100.0%,3m
5782,3,[三族同萌会]MonsTeR,3177,0,1,0,1,100.0%,35m
5782,3,去看海,3177,0,0,1,1,0.0%,14m
5782,1,[你们都是渣]非常狠得,3177,0,0,8,8,0.0%,45m
5791,3,Ghostking,3176,1041,122,103,225,54.2%,35m
5791,3,[DJDNB]胖天天,3176,1282,57,46,103,55.3%,14m
5791,3,[狮心会]lin,3176,1011,44,43,87,50.6%,16m
5791,3,正义的鱼,3176,368,33,19,52,63.5%,17m
5791,2,[凤凰集]酷酷的多,3176,290,13,7,20,65.0%,4m
5791,3,Tempest,3176,352,13,12,25,52.0%,29m
5791,3,[一扎实其余猪]圆辊辊,3176,195,9,16,25,36.0%,20m
5791,3,海贼王路飞,3176,202,8,8,16,50.0%,8m
5791,3,[专打嘤嘤怪]sLIKALIE,3176,173,7,7,14,50.0%,15m
5791,3,Crimmmm,3176,116,4,4,8,50.0%,17m
5791,3,darkcarrot,3176,0,2,3,5,40.0%,14m
5791,2,星际迷航记,3176,0,1,0,1,100.0%,1h
5791,3,地狱狼,3176,0,0,1,1,0.0%,35m
5791,3,[永猛]markII,3176,0,0,2,2,0.0%,3m
5791,2,使命召唤,3176,0,0,3,3,0.0%,7m
5791,3,最后一号,3176,0,0,5,5,0.0%,3m
5807,3,jackdad,3175,264,9,4,13,69.2%,1m
5807,3,GGwP,3175,172,6,7,13,46.2%,20m
5807,3,IIIIIIII,3175,142,5,6,11,45.5%,33m
5807,3,[不是单推人]Mousepad,3175,60,3,1,4,75.0%,16m
5807,1,MarineKing,3175,0,1,0,1,100.0%,43m
5807,3,卡莉娜快乐风信子,3175,0,1,0,1,100.0%,1m
5807,3,龙皇,3175,0,0,1,1,0.0%,22m
5807,3,地堡专业户,3175,0,0,4,4,0.0%,7m
5815,3,zerg,3174,1291,131,134,265,49.4%,4m
5815,3,小熊,3174,1339,64,41,105,61.0%,5m
5815,3,[济南]CurTain,3174,654,23,30,53,43.4%,35m
5815,3,SCPLAYER,3174,467,19,13,32,59.4%,6m
5815,3,[二次元联盟军]丧钟为谁而鸣,3174,355,13,9,22,59.1%,16m
5815,2,crazydogs,3174,95,5,1,6,83.3%,1h
5815,3,虫骸,3174,144,5,8,13,38.5%,6m
5815,1,[弗雷之眼]魇酱才不是大魔王,3174,0,4,2,6,66.7%,11m
5815,3,[赶紧补补水]Noah,3174,89,4,5,9,44.4%,16m
5815,3,[DDOS无邪]COIII,3174,95,3,5,8,37.5%,25m
5815,3,烩兔肉,3174,0,1,0,1,100.0%,29m
5815,3,[知乎战队]长门有希,3174,0,0,1,1,0.0%,31m
5815,3,怪兽,3174,0,0,2,2,0.0%,6m
5815,3,张宣丨灬蔡徐坤,3174,0,0,3,3,0.0%,22m
5829,2,[FORI2]会飞的沙,3173,1567,467,469,936,49.9%,7m
5829,3,wild,3173,1474,118,106,224,52.7%,4m
5829,2,[BHSC]zaku,3173,1104,36,56,92,39.1%,34m
5829,3,[CHN]CHNraGingX,3173,671,25,24,49,51.0%,14m
5829,3,华丽雨林,3173,422,16,16,32,50.0%,17m
5829,2,Qzz,3173,277,13,6,19,68.4%,12m
5829,2,[宅爱]夏色祭,3173,132,7,1,8,87.5%,39m
5829,3,panshixiang,3173,199,6,2,8,75.0%,31m
5829,3,FYFYFY,3173,86,3,3,6,50.0%,25m
5829,2,烧饼包子,3173,0,2,1,3,66.7%,1h
5829,2,[明教]月暮,3173,0,1,4,5,20.0%,1h
5829,3,桐生一马,3173,0,0,1,1,0.0%,32m
5829,3,[谐星2333]ads,3173,0,0,1,1,0.0%,4m
5829,3,忧郁的土匪,3173,0,0,2,2,0.0%,20m
5829,3,我从不存在于过去,3173,0,0,2,2,0.0%,18m
5829,3,润羽露西娅,3173,0,0,2,2,0.0%,22m
5845,3,unintended,3172,1604,355,331,686,51.7%,22m
5845,3,[老油条战队4]星际老油条,3172,1130,70,73,143,49.0%,22m
5845,3,[Beauty]半澤直樹,3172,817,38,38,76,50.0%,19m
5845,3,[我们是无敌的]jim,3172,607,31,9,40,77.5%,28m
5845,2,[萌萌吃包]早花怜羽,3172,276,12,9,21,57.1%,22m
5845,2,谁在呼叫舒哥,3172,241,11,8,19,57.9%,24m
5845,3,[LCKS]天外来客,3172,252,9,2,11,81.8%,5m
5845,3,ARBAlex,3172,222,6,10,16,37.5%,36m
5845,3,火辣的小嘴巴,3172,101,5,5,10,50.0%,37m
5845,2,直接投降吧,3172,0,4,2,6,66.7%,1h
5845,3,[艾尔发电厂]黑月灵,3172,0,1,0,1,100.0%,35m
5845,3,塔达林高阶刺蛇,3172,0,1,0,1,100.0%,2m
5845,3,GVisbest,3172,30,1,4,5,20.0%,5m
5845,3,Youknow,3172,0,0,1,1,0.0%,16m
5845,1,[至诚娱乐]IIIIIIIIIIII,3172,0,0,1,1,0.0%,1h
5845,3,爱德华帝奇,3172,0,0,2,2,0.0%,15m
5845,3,永远是少女时代,3172,0,0,4,4,0.0%,23m
5862,3,[一等星]默本无声,3171,1289,53,50,103,51.5%,25m
5862,3,做一辈子朋友,3171,500,20,16,36,55.6%,3m
5862,3,何弃疗,3171,467,18,14,32,56.2%,13m
5862,3,我的小狗死得好惨,3171,127,11,11,22,50.0%,28m
5862,3,[TSOD]掠夺者饿狼,3171,269,9,6,15,60.0%,18m
5862,3,[学习使我快乐]沧海一厘米,3171,250,9,11,20,45.0%,16m
5862,2,huanghuang,3171,116,6,2,8,75.0%,4m
5862,3,[嗜血BaSa]杀意之波动,3171,112,4,7,11,36.4%,7m
5862,3,[狗不理战队]暴走黑衣人,3171,92,3,11,14,21.4%,23m
5862,2,好汉请杀我队友,3171,0,2,3,5,40.0%,33m
5862,3,[曾经一群兔子]lalala,3171,0,1,0,1,100.0%,17m
5862,3,[QFD]网骗梅林,3171,30,1,2,3,33.3%,33m
5862,3,[GA]辰辰,3171,0,0,1,1,0.0%,16m
5862,3,[SUST1]Buqun,3171,0,0,1,1,0.0%,2m
5862,3,[樱夏]剑舞的凪白,3171,0,0,1,1,0.0%,32m
5862,3,Drrr,3171,0,0,2,2,0.0%,16m
5878,3,[七星]黑暗杀戮,3170,1609,124,121,245,50.6%,35m
5878,3,[FLDSCL]Flandre,3170,352,65,53,118,55.1%,13m
5878,3,[暗室逢灯]瑟雷尼亚,3170,895,37,28,65,56.9%,31m
5878,3,[琴之森]阿姨我不想努力了,3170,846,36,25,61,59.0%,10m
5878,3,不死战神道友明,3170,429,22,10,32,68.8%,4m
5878,3,[蕙质兰心]呐呐呐,3170,473,20,11,31,64.5%,31m
5878,3,[BGD]有点甜,3170,376,14,12,26,53.8%,14m
5878,1,[DMRc]两个年轻人,3170,270,9,5,14,64.3%,29m
5878,2,[星潆]星潆,3170,204,9,6,15,60.0%,25m
5878,3,NeymarJr,3170,145,4,1,5,80.0%,11m
5878,3,[xgnb]圣达,3170,30,2,4,6,33.3%,7m
5878,3,[第五駆逐鑑隊]贞德达尔克,3170,30,2,5,7,28.6%,20m
5878,3,[27CM]SOLA,3170,0,1,0,1,100.0%,32m
5878,3,Hero,3170,0,1,1,2,50.0%,33m
5878,3,[菲雅利]风中风铃,3170,0,0,1,1,0.0%,8m
5878,3,Leo,3170,0,0,1,1,0.0%,16m
5878,3,闪光之裤,3170,0,0,1,1,0.0%,25m
5878,3,[兰均竹空]MinNin,3170,0,0,2,2,0.0%,14m
5896,3,[温柔兔公主]zfr,3169,1562,179,177,356,50.3%,7m
5896,3,[孤独患者]快到碗里来,3169,563,30,31,61,49.2%,29m
5896,3,[你的剑很美]涛涛,3169,526,19,29,48,39.6%,36m
5896,3,Dust,3169,180,7,8,15,46.7%,2m
5896,3,IIIIIIIIIIII,3169,116,5,4,9,55.6%,15m
5896,3,[七咕咕]兄弟你老婆真棒,3169,58,3,1,4,75.0%,37m
5896,3,[快跑]vicomo,3169,86,3,3,6,50.0%,17m
5896,3,紫水栈桥,3169,58,2,2,4,50.0%,37m
5896,3,[鸡家军]TongHickey,3169,62,2,5,7,28.6%,15m
5896,1,[暴雪嘉年华]小小土人,3169,0,1,0,1,100.0%,4m
5896,3,fafafa,3169,0,0,1,1,0.0%,8m
5896,3,橘子夏丶,3169,0,0,1,1,0.0%,23m
5908,2,醉后不知天在水,3168,1464,122,126,248,49.2%,15m
5908,3,AideLuo,3168,1568,78,80,158,49.4%,22m
5908,3,甚都,3168,1533,77,61,138,55.8%,22m
5908,3,[刺蛇互助社团]众星,3168,642,24,27,51,47.1%,7m
5908,3,[用不服谁]瞎打发卡,3168,412,18,15,33,54.5%,35m
5908,3,奇迹之海,3168,450,17,15,32,53.1%,20m
5908,3,[退休总统]DonaldTrumP,3168,335,14,6,20,70.0%,16m
5908,3,SoWhat,3168,0,5,0,5,100.0%,8m
5908,3,魔力鸟,3168,0,1,0,1,100.0%,33m
5908,3,[RPG神教]卖萌的探机,3168,0,1,0,1,100.0%,5m
5908,2,[多个老年人]快乐星际不快乐,3168,0,1,0,1,100.0%,36m
5908,3,浪漫的白金,3168,30,1,1,2,50.0%,36m
5908,3,三千,3168,0,0,1,1,0.0%,22m
5908,3,Eastwinds,3168,0,0,1,1,0.0%,11m
5908,3,[呼啸山鹰]与神之假身的接触,3168,0,0,3,3,0.0%,1m
5923,3,打死菠萝,3167,1573,299,270,569,52.5%,1m
5923,3,[饲料姐姐无敌]Marine,3167,438,16,11,27,59.3%,32m
5923,3,pppp,3167,340,13,18,31,41.9%,7m
5923,3,[扫黄]运气是实力的全部,3167,323,11,10,21,52.4%,22m
5923,1,[TPoA]影子零号,3167,271,9,8,17,52.9%,17m
5923,1,[阿尔泰瑟斯]IIIIIIIIIIII,3167,167,6,6,12,50.0%,26m
5923,3,[混元崔欣门]DDFanTasy,3167,142,5,8,13,38.5%,7m
5923,3,守护木叶的少年,3167,0,4,1,5,80.0%,58m
5923,3,[灵轩阁]上官轩宇,3167,86,3,4,7,42.9%,28m
5923,3,IIIIIIIIIIII,3167,60,2,2,4,50.0%,3m
5923,3,thriftshop,3167,30,2,2,4,50.0%,32m
5923,3,Yangnannan,3167,0,1,0,1,100.0%,22m
5923,3,包子包子,3167,0,1,1,2,50.0%,29m
5923,3,LGKK,3167,30,1,1,2,50.0%,23m
5923,3,仰天一刀,3167,30,1,3,4,25.0%,8m
5923,3,[HosG]YellOw,3167,0,0,1,1,0.0%,24m
5923,3,[单矿一大波牛]zzzlyn,3167,0,0,1,1,0.0%,20m
5923,3,lliilliiiiii,3167,0,0,3,3,0.0%,3m
5941,3,[黑粉头子]青肆,3166,114,5,4,9,55.6%,1m
5941,3,zest,3166,0,1,0,1,100.0%,18m
5941,2,TVace,3166,0,1,0,1,100.0%,34m
5941,3,[OgiNA]蒜泥,3166,30,1,6,7,14.3%,32m
5941,3,[单身任性]从入坑到入土,3166,0,0,1,1,0.0%,16m
5941,3,[一等星]魔装变态,3166,0,0,1,1,0.0%,5m
5941,3,[leepay]为了达拉然,3166,0,0,1,1,0.0%,2m
5941,3,[净化者x]秩序灬缘,3166,0,0,1,1,0.0%,5m
5941,3,[HDU]鸭嘴兽,3166,0,0,1,1,0.0%,14m
5941,3,[Rhusky]璃沫桜殇,3166,0,0,1,1,0.0%,20m
5941,2,[SC2夜总会]给块糖就笑嘻嘻,3166,0,0,2,2,0.0%,1h
5952,3,越玩越菜,3165,1603,342,327,669,51.1%,17m
5952,3,Guikarist,3165,1072,46,40,86,53.5%,35m
5952,2,jianVShao,3165,681,31,48,79,39.2%,7m
5952,3,[专业单一小组]boorZerg,3165,549,21,15,36,58.3%,35m
5952,3,[洛水伊人]魔之轩辕,3165,474,18,24,42,42.9%,33m
5952,3,九尾剑姬,3165,407,15,11,26,57.7%,17m
5952,1,恩曲他滨替诺福韦,3165,164,7,3,10,70.0%,27m
5952,3,苍阳,3165,208,7,11,18,38.9%,14m
5952,1,[CoiNs]NoOby,3165,205,5,2,7,71.4%,20m
5952,3,亡月,3165,88,3,4,7,42.9%,5m
5952,3,flash,3165,88,3,5,8,37.5%,22m
5952,3,[虚拟歌手团体]洛天依,3165,58,2,5,7,28.6%,17m
5952,3,sun,3165,0,1,1,2,50.0%,23m
5952,2,sos,3165,96,1,1,2,50.0%,1h
5952,3,[C84131]TSEC,3165,0,1,2,3,33.3%,19m
5952,3,有贱的人,3165,30,1,3,4,25.0%,29m
5952,3,[醉生梦死]东临碣石,3165,0,0,1,1,0.0%,3m
5969,3,[青莲剑阁]枯林,3164,1471,118,112,230,51.3%,22m
5969,2,资深男酮,3164,1501,108,105,213,50.7%,26m
5969,3,莽我,3164,1071,59,47,106,55.7%,14m
5969,3,[素貭極差]flyinbed,3164,815,37,36,73,50.7%,11m
5969,3,michellemxa,3164,176,30,29,59,50.8%,35m
5969,3,sddddddgg,3164,454,19,16,35,54.3%,11m
5969,3,[最菜战队]marinelord,3164,448,19,19,38,50.0%,16m
5969,3,团圞意,3164,142,13,5,18,72.2%,29m
5969,3,[Borne]文人秋月,3164,245,11,14,25,44.0%,25m
5969,1,[DMRz]雷布朗多星人,3164,225,7,5,12,58.3%,32m
5969,3,IIIIIIIIIIII,3164,83,5,8,13,38.5%,23m
5969,3,[瘾大眼瞎]pimba,3164,137,3,1,4,75.0%,33m
5969,1,Ragrander,3164,141,3,2,5,60.0%,8m
5969,3,我今年八岁啦,3164,0,0,1,1,0.0%,3m
5969,3,[TNLet]HOODWEI,3164,0,0,1,1,0.0%,20m
5969,2,[我们是无敌的]daddyhm,3164,0,0,1,1,0.0%,1h
5969,3,[镜花水月]一之天梦梦梦,3164,0,0,2,2,0.0%,3m
5986,3,[KPG]咕咕王,3163,1599,273,253,526,51.9%,9m
5986,3,要你命三千,3163,1658,163,150,313,52.1%,26m
5986,3,[澄碧]微微微微微微微笑,3163,195,5,7,12,41.7%,37m
5986,3,[SCAP]arthursaber,3163,0,1,0,1,100.0%,7m
5986,3,time,3163,0,1,2,3,33.3%,3m
5986,3,ToT,3163,0,0,3,3,0.0%,25m
5992,3,[炮姐粉丝团]医尽女人心,3162,316,147,152,299,49.2%,18m
5992,3,沉稳的牧凡,3162,1316,74,72,146,50.7%,18m
5992,3,看你个锤子看,3162,876,36,35,71,50.7%,18m
5992,3,[EP]蜜糖菠萝,3162,602,22,27,49,44.9%,33m
5992,3,星际萌萌新,3162,167,16,5,21,76.2%,7m
5992,3,[KPG]狂暴的小咩羊,3162,290,10,16,26,38.5%,11m
5992,3,[可爱的探姬们]我现在怀里有只猫,3162,58,3,1,4,75.0%,14m
5992,3,低配版塞肉,3162,0,2,3,5,40.0%,30m
5992,3,Dark,3162,0,1,0,1,100.0%,18m
5992,3,Exactwin,3162,0,1,0,1,100.0%,21m
5992,3,ddexp,3162,0,1,0,1,100.0%,15m
5992,2,那条黄瓜,3162,97,1,1,2,50.0%,34m
5992,3,皇家胜利者盖本,3162,0,0,2,2,0.0%,37m
6005,3,Dopamine,3161,1600,126,112,238,52.9%,1m
6005,3,[KPG]brownners,3161,955,57,61,118,48.3%,17m
6005,2,Ikaros,3161,571,30,51,81,37.0%,7m
6005,3,[神子]一个可爱的队友,3161,203,10,4,14,71.4%,31m
6005,3,桐叶,3161,198,7,1,8,87.5%,36m
6005,3,red,3161,138,3,1,4,75.0%,29m
6005,3,火云邪神,3161,30,2,5,7,28.6%,22m
6005,3,[谢绝反击]叫我认同,3161,0,1,0,1,100.0%,22m
6005,3,[噗噗噗]光之影面,3161,30,1,5,6,16.7%,36m
6005,2,[乌尔纳之刃]Negev,3161,0,1,5,6,16.7%,34m
6005,1,[中老年车队]人之剑仙,3161,0,0,1,1,0.0%,1h
6016,3,飯鍥叁碗,3160,1503,190,195,385,49.4%,37m
6016,3,奥罗拉,3160,1315,71,52,123,57.7%,11m
6016,3,今晚一定早睡,3160,1198,65,42,107,60.7%,5m
6016,3,SuiKA,3160,601,54,54,108,50.0%,1m
6016,3,Terminator,3160,496,18,23,41,43.9%,16m
6016,3,乱丶舞,3160,123,11,4,15,73.3%,7m
6016,3,[tyyt]llIIIIlllIII,3160,164,6,0,6,100.0%,10m
6016,3,塔达林高阶跳虫,3160,114,5,5,10,50.0%,8m
6016,3,[我们是萌新]再见宋哈娜,3160,86,4,8,12,33.3%,6m
6016,2,陈老板的腹肌,3160,93,2,0,2,100.0%,22m
6016,2,白狼,3160,0,1,0,1,100.0%,43m
6016,3,borinpp,3160,0,1,1,2,50.0%,9m
6016,3,热爱星际,3160,0,0,1,1,0.0%,3m
6029,3,DarkSide,3159,1576,491,487,978,50.2%,34m
6029,2,[专业单一小组]家长会领衔主演,3159,1607,155,160,315,49.2%,33m
6029,3,ZeroTiger,3159,1564,154,141,295,52.2%,14m
6029,3,limerence,3159,1410,89,66,155,57.4%,18m
6029,3,[亀山社中]这么小声还开航母,3159,388,28,14,42,66.7%,8m
6029,3,[媳妇一喊就G]太空小丑,3159,736,27,37,64,42.2%,6m
6029,3,茶色蔓延丶,3159,211,12,5,17,70.6%,29m
6029,3,克哈贱民不配赢,3159,246,10,8,18,55.6%,9m
6029,3,das,3159,206,7,3,10,70.0%,12m
6029,3,[GoONE]感情骗子,3159,0,1,0,1,100.0%,37m
6029,3,VashMX,3159,0,0,1,1,0.0%,23m
6029,3,[MS13战术]幻化成风,3159,0,0,1,1,0.0%,20m
6029,3,[肌肉]Restless,3159,0,0,1,1,0.0%,32m
6029,3,lilikaxi,3159,0,0,3,3,0.0%,25m
6043,3,怨恨之怒,3158,599,22,20,42,52.4%,8m
6043,3,[刀锋男皇]以德服人,3158,265,19,16,35,54.3%,7m
6043,3,疯恰恰,3158,241,11,13,24,45.8%,6m
6043,3,soSo,3158,190,6,3,9,66.7%,5m
6043,3,[爆裂吧现实]alphashe,3158,220,6,5,11,54.5%,22m
6043,3,Lightning,3158,0,3,2,5,60.0%,14m
6043,2,[TCP]黎明卿,3158,42,1,2,3,33.3%,29m
6043,3,[TPobab]皓小子,3158,30,1,3,4,25.0%,32m
6043,3,LXX,3158,0,0,1,1,0.0%,20m
6043,3,ango,3158,0,0,1,1,0.0%,11m
6043,3,[察哈尔路县中]Quin,3158,0,0,1,1,0.0%,3m
6043,3,[VCTO]无情,3158,0,0,5,5,0.0%,8m
6055,3,SunSky,3157,178,55,50,105,52.4%,29m
6055,3,桔梗,3157,795,35,23,58,60.3%,31m
6055,3,[至诚娱乐]神父我有罪,3157,669,31,29,60,51.7%,5m
6055,3,七代加藤鹰,3157,735,28,21,49,57.1%,17m
6055,3,[东大电竞]Prok,3157,350,12,17,29,41.4%,24m
6055,1,[霸气雄图]小小呆,3157,186,6,5,11,54.5%,1h
6055,2,[吾三美如画]达拉姆带主教,3157,0,4,2,6,66.7%,4m
6055,3,[吉高由里子]Yoriko,3157,60,2,3,5,40.0%,3m
6055,2,你赢了,3157,94,1,5,6,16.7%,1h
6055,3,忠肝义胆邢育森,3157,0,0,1,1,0.0%,28m
6065,3,[CPT]夏恋花火,3156,746,28,28,56,50.0%,3m
6065,2,[C24930]dfghjklcf,3156,164,8,5,13,61.5%,33m
6065,2,LiebeAn,3156,116,7,0,7,100.0%,43m
6065,3,xuwu,3156,0,4,1,5,80.0%,8m
6065,3,[鬼杀队]某科学的我妻善逸,3156,48,2,5,7,28.6%,35m
6065,3,幽灵狗,3156,0,1,0,1,100.0%,15m
6065,3,兰瑟,3156,30,1,1,2,50.0%,6m
6065,3,TossMan,3156,30,1,5,6,16.7%,14m
6065,2,Campas,3156,0,0,1,1,0.0%,25m
6074,3,瘟疫之心,3155,544,175,164,339,51.6%,16m
6074,2,霹雳菠萝包,3155,1486,172,166,338,50.9%,24m
6074,3,书寒雨季,3155,176,6,13,19,31.6%,18m
6074,3,RainbowC,3155,108,3,0,3,100.0%,35m
6074,3,[scuob]soO,3155,30,2,2,4,50.0%,8m
6074,3,[星际老男孩K]孙一峰,3155,95,1,1,2,50.0%,35m
6074,3,魔法少女黄旭东,3155,0,1,1,2,50.0%,36m
6074,2,[有趣]MelonPan,3155,0,0,1,1,0.0%,48m
6074,3,VLB,3155,0,0,1,1,0.0%,18m
6074,3,寒流,3155,0,0,1,1,0.0%,22m
6074,3,LBellaRufis,3155,0,0,3,3,0.0%,16m
6085,3,[好哥哥抬一手]RocketBo,3154,1383,55,56,111,49.5%,25m
6085,3,[好哥哥让让我]北方有条咸鱼,3154,560,25,17,42,59.5%,5m
6085,3,IIIIIIII,3154,570,22,14,36,61.1%,19m
6085,2,Aomine,3154,493,19,34,53,35.8%,1m
6085,3,llllllllllll,3154,420,18,23,41,43.9%,5m
6085,3,[五月花]虚无,3154,343,13,7,20,65.0%,28m
6085,3,ZeroTwo,3154,179,13,12,25,52.0%,22m
6085,3,荆门李信衡,3154,185,6,3,9,66.7%,3m
6085,3,逆天而行,3154,0,1,0,1,100.0%,14m
6085,3,imok,3154,30,1,1,2,50.0%,8m
6085,3,Lee,3154,30,1,3,4,25.0%,21m
6085,3,[爆笑科普卢]KID,3154,0,0,1,1,0.0%,16m
6085,3,[電脑难度]雷鶸,3154,0,0,1,1,0.0%,25m
6085,3,痞老板,3154,0,0,3,3,0.0%,33m
6099,3,一脚踢死贝尔,3153,971,66,52,118,55.9%,18m
6099,3,娱乐天空,3153,808,29,29,58,50.0%,14m
6099,3,[冬马和纱]nightmare,3153,293,11,5,16,68.8%,16m
6099,3,whisper,3153,314,11,12,23,47.8%,35m
6099,3,[HeroZP]无限寂寥,3153,270,10,15,25,40.0%,8m
6099,3,[在命运中挣扎]裂空苍鹰,3153,97,5,3,8,62.5%,7m
6099,3,九头蛇,3153,119,2,1,3,66.7%,14m
6099,2,[孤独与烈酒]零功,3153,102,2,12,14,14.3%,25m
6099,3,[是在下输了]blueboat,3153,0,1,0,1,100.0%,23m
6099,3,[KENNEL]Pulannis,3153,0,1,0,1,100.0%,18m
6099,1,AlphaGo,3153,0,1,1,2,50.0%,1h
6099,3,sun,3153,30,1,1,2,50.0%,8m
6099,1,[HTN]napusi,3153,96,1,2,3,33.3%,1h
6099,3,[CDC丶TQ]JaxHermes,3153,0,0,1,1,0.0%,21m
6099,3,[一盒峰我大哥]evolution,3153,0,0,1,1,0.0%,9m
6099,3,洋洋,3153,0,0,1,1,0.0%,6m
6099,3,IIIIIIIIIIII,3153,0,0,2,2,0.0%,4m
6099,3,[苦战新手电脑]菜的真实啊队友,3153,0,0,2,2,0.0%,28m
6117,3,[334小分队]苍蓝野兽,3152,1171,68,63,131,51.9%,17m
6117,3,晶状体,3152,438,30,23,53,56.6%,9m
6117,3,ZeaLousFRog,3152,470,16,25,41,39.0%,22m
6117,2,[肉鸡的饲养]rorisaiko,3152,416,13,25,38,34.2%,34m
6117,3,一千年以前,3152,250,8,9,17,47.1%,6m
6117,3,Odin,3152,88,4,3,7,57.1%,14m
6117,3,[艾洛格姆]阿尔托利亚,3152,30,2,1,3,66.7%,15m
6117,3,[暴雪我是你爹]醉花荫磊,3152,30,2,2,4,50.0%,22m
6117,3,[毒雨]自然选择号,3152,0,1,0,1,100.0%,20m
6117,3,星海畅游,3152,0,1,0,1,100.0%,2m
6117,3,白咕咕,3152,0,1,6,7,14.3%,8m
6117,3,Beefalo,3152,0,0,1,1,0.0%,32m
6117,3,[1939CN]乐高呆高乐,3152,0,0,1,1,0.0%,18m
6117,2,[枪兵二营]blinkheart,3152,0,0,2,2,0.0%,19m
6117,3,fantasyD,3152,0,0,3,3,0.0%,37m
6132,2,CallMeAZ,3151,1589,282,289,571,49.4%,36m
6132,3,[上帝之首]chzzir,3151,1533,268,271,539,49.7%,25m
6132,3,宠蝴蝶的小时光丶,3151,568,49,44,93,52.7%,10m
6132,3,IWS,3151,1182,49,45,94,52.1%,3m
6132,3,Nalra,3151,150,19,15,34,55.9%,36m
6132,3,YDH,3151,542,19,18,37,51.4%,6m
6132,3,Qopjva,3151,419,18,13,31,58.1%,25m
6132,1,IIIIIIIIIIII,3151,205,9,4,13,69.2%,27m
6132,3,[星河气象学院]Pionoor,3151,242,7,5,12,58.3%,14m
6132,3,DDaLL,3151,174,7,6,13,53.8%,23m
6132,2,xlking,3151,118,6,1,7,85.7%,32m
6132,3,[Shawk]Linghun,3151,78,4,2,6,66.7%,25m
6132,3,弱弱的幼女控桑,3151,0,0,1,1,0.0%,23m
6145,3,hfiisy,3150,1460,334,323,657,50.8%,33m
6145,3,[MUL]GuluCAT,3150,495,19,12,31,61.3%,29m
6145,3,爱与和平,3150,374,15,14,29,51.7%,28m
6145,3,[霍霍酷铁锤]友谊之船上的死神,3150,63,14,21,35,40.0%,20m
6145,3,Apple,3150,326,12,7,19,63.2%,36m
6145,3,[风后奇门]TyCimU,3150,338,12,10,22,54.5%,14m
6145,3,逍遥兽,3150,99,4,7,11,36.4%,25m
6145,3,[打到你报警]bloodtear,3150,121,3,0,3,100.0%,5m
6145,3,[桜公馆]新垣绫濑,3150,0,1,2,3,33.3%,17m
6145,3,[Buakaw]一匹野驴,3150,0,0,1,1,0.0%,22m
6145,3,我再为你动情一次,3150,0,0,2,2,0.0%,29m
6156,3,llllllllllll,3149,1569,157,135,292,53.8%,37m
6156,3,Creep,3149,1149,88,79,167,52.7%,26m
6156,2,BPD,3149,1413,77,90,167,46.1%,20m
6156,3,深深大鱼海棠,3149,1028,40,38,78,51.3%,14m
6156,3,Pimab,3149,312,11,5,16,68.8%,34m
6156,3,[虞城星际]ZesT,3149,208,6,3,9,66.7%,23m
6156,3,mzp,3149,118,2,1,3,66.7%,2m
6156,3,[星际爱好者队]网鱼胖哥,3149,30,2,1,3,66.7%,5m
6156,3,快乐就好,3149,0,0,1,1,0.0%,36m
6156,3,[詹弗妮]虫苔上的阿花,3149,0,0,1,1,0.0%,19m
6166,2,peter,3148,1547,199,220,419,47.5%,18m
6166,3,Kella,3148,1164,48,42,90,53.3%,17m
6166,3,[升格之链hh]Gloud,3148,750,28,24,52,53.8%,11m
6166,3,IIIIIIIIIIII,3148,446,17,18,35,48.6%,32m
6166,3,[TOPZEG]vaioS,3148,348,12,9,21,57.1%,23m
6166,3,[快乐星际ru]是非,3148,322,12,13,25,48.0%,35m
6166,3,[DMRc]下一秒星火,3148,290,11,7,18,61.1%,23m
6166,3,炸鱼仔四圈加,3148,174,7,9,16,43.8%,25m
6166,3,[北极光小组]藏逝,3148,138,3,1,4,75.0%,12m
6166,3,[DMRe]Hoklin,3148,141,3,3,6,50.0%,3m
6166,3,SlientStirm,3148,111,2,1,3,66.7%,35m
6166,1,被砍掉的流海,3148,117,2,3,5,40.0%,1h
6166,3,龙卷风摧毁停车场,3148,58,2,3,5,40.0%,6m
6166,3,[北方汽修]金色黎明,3148,0,1,0,1,100.0%,25m
6166,3,IIIIII,3148,0,1,0,1,100.0%,20m
6166,3,[无影丶神]迪斯洛克,3148,0,0,1,1,0.0%,7m
6166,3,[灰冥]Isshin,3148,0,0,1,1,0.0%,26m
6166,3,lxq,3148,0,0,1,1,0.0%,3m
6166,2,GouGouMan,3148,0,0,1,1,0.0%,1h
6185,3,我说文政帅,3147,1591,138,125,263,52.5%,19m
6185,3,[抹除开始]好兄弟吃了没,3147,997,46,24,70,65.7%,33m
6185,3,[斑斓]Coloryellow,3147,549,33,39,72,45.8%,2m
6185,3,[磨烂席]依依妖妖,3147,808,29,31,60,48.3%,37m
6185,3,[主宰之剑]璀璨之群星之巅,3147,98,8,0,8,100.0%,33m
6185,2,SDDDGG,3147,179,8,6,14,57.1%,22m
6185,1,[飞鸟牡丹配]timo,3147,171,5,3,8,62.5%,17m
6185,3,[生物即是正义]依卡萝娜,3147,0,1,0,1,100.0%,1m
6185,3,[XYFANS]OGAlexsib,3147,30,1,4,5,20.0%,31m
6185,3,Dopa,3147,0,0,1,1,0.0%,36m
6185,3,myzhimes,3147,0,0,1,1,0.0%,9m
6185,3,月岛真面目,3147,0,0,1,1,0.0%,2m
6185,2,myytjrx,3147,0,0,2,2,0.0%,19m
6198,3,Filthy,3146,1533,67,57,124,54.0%,9m
6198,2,羽幕丶,3146,378,12,29,41,29.3%,21m
6198,3,chyoo,3146,200,7,18,25,28.0%,15m
6198,2,[奉贤孙一峰]腿软走不动,3146,0,4,2,6,66.7%,1h
6198,3,[刺蛇单推协会]落雪,3146,58,3,3,6,50.0%,6m
6198,3,渐先夏烦,3146,30,2,0,2,100.0%,9m
6198,3,[汉堡FANS]deadkill,3146,30,2,2,4,50.0%,6m
6198,3,时崎狂三,3146,0,1,0,1,100.0%,20m
6198,3,寂寞冷少,3146,30,1,2,3,33.3%,8m
6198,3,[德哈卡神教]可乐,3146,0,0,1,1,0.0%,20m
6198,3,[社交学导教]煮酒醉三生,3146,0,0,2,2,0.0%,6m
6209,3,星际风云,3145,1379,149,130,279,53.4%,5m
6209,3,自燃,3145,1171,92,77,169,54.4%,20m
6209,3,[重新集结虫群]小熊守护,3145,695,44,28,72,61.1%,2m
6209,3,unbeatableP,3145,824,37,26,63,58.7%,8m
6209,3,我是一只小小鸟,3145,712,32,25,57,56.1%,4m
6209,3,Timba,3145,412,14,18,32,43.8%,9m
6209,3,泰伦不攻击泰伦,3145,236,9,11,20,45.0%,12m
6209,3,[飞天面神]源源房佳贴一贴,3145,124,6,2,8,75.0%,11m
6209,3,[上帝的叹息]邪王真眼是最强的,3145,93,2,0,2,100.0%,2m
6209,3,[我们是无敌的]求道者,3145,30,2,1,3,66.7%,7m
6209,3,[破风之矛]sinLuke,3145,30,2,2,4,50.0%,18m
6209,3,zzzbbbwww,3145,0,1,0,1,100.0%,25m
6209,3,[人族无敌]香风智乃,3145,0,1,1,2,50.0%,29m
6209,3,藤狸喵喵子,3145,0,1,1,2,50.0%,23m
6209,2,[咏春]萌纳龙,3145,0,0,1,1,0.0%,35m
6224,3,无产阶级劳动人民,3144,1456,133,128,261,51.0%,31m
6224,3,[浪啊浪]白奶茶,3144,1195,59,62,121,48.8%,35m
6224,3,梨生,3144,471,23,7,30,76.7%,14m
6224,3,[嘟嘟嘟噜]最不会起名字了,3144,143,15,8,23,65.2%,9m
6224,3,无缺点总司令,3144,402,14,19,33,42.4%,25m
6224,3,Teajea,3144,173,12,11,23,52.2%,12m
6224,3,LuckyTime,3144,162,5,2,7,71.4%,19m
6224,3,[文韬武略]HLM,3144,60,3,6,9,33.3%,19m
6232,3,[萝莉之芯]lili,3143,1576,259,243,502,51.6%,22m
6232,3,WALLE,3143,1517,104,100,204,51.0%,21m
6232,3,我是三三啊,3143,727,31,22,53,58.5%,19m
6232,3,[306]Phoenix,3143,720,27,32,59,45.8%,17m
6232,2,[Shawk]lelouch,3143,44,1,1,2,50.0%,26m
6232,3,[浪啊浪]王小雨,3143,95,1,1,2,50.0%,18m
6232,3,[NKTJ]Yetsion,3143,30,1,2,3,33.3%,33m
6232,3,[神威灵装五番]ItsukaKotori,3143,30,1,3,4,25.0%,4m
6232,3,[董魔王制霸军]莫问,3143,0,0,1,1,0.0%,33m
6241,3,各种卖,3142,659,66,54,120,55.0%,4m
6241,3,小茶,3142,60,2,6,8,25.0%,18m
6241,3,[王者归来]小智,3142,0,1,0,1,100.0%,6m
6241,3,[希靈使徒]Raven,3142,0,1,4,5,20.0%,1h
6241,3,AbAcUS,3142,0,0,1,1,0.0%,25m
6241,3,[暴力喵族]GDBoy,3142,0,0,1,1,0.0%,7m
6247,2,神座千流,3141,898,39,54,93,41.9%,29m
6247,3,[豪爽豪爽]手术刀,3141,722,24,36,60,40.0%,21m
6247,3,[暴雪全能亡]本群最跳狗逼嘴宗,3141,363,15,8,23,65.2%,18m
6247,3,[纸壳]降伏泰伦帝国,3141,234,9,8,17,52.9%,3m
6247,3,Shinichi,3141,238,8,7,15,53.3%,11m
6247,2,刁民你也想害我,3141,214,7,4,11,63.6%,11m
6247,3,野人不需要智力,3141,146,4,4,8,50.0%,31m
6247,3,MUJUN,3141,0,3,2,5,60.0%,46m
6247,3,破天,3141,0,1,1,2,50.0%,27m
6247,3,[地球卫队]王小明,3141,30,1,2,3,33.3%,30m
6247,3,Deathscy,3141,92,1,2,3,33.3%,30m
6247,2,请侬吃头特,3141,93,1,2,3,33.3%,12m
6247,2,李信衡,3141,0,0,1,1,0.0%,1h
6247,3,[通附谐会]南通孙一峰,3141,0,0,1,1,0.0%,37m
6247,3,[BOOMER]llllllllllll,3141,0,0,1,1,0.0%,14m
6247,3,[华夏远征军]萧残,3141,0,0,1,1,0.0%,1h
6247,3,[有为青年]十六夜咲夜,3141,0,0,2,2,0.0%,3m
6247,3,[Hist]慕容小月,3141,0,0,3,3,0.0%,21m
6265,3,一人,3140,930,39,45,84,46.4%,9m
6265,3,[颜值女神]奶味小仙女,3140,625,22,26,48,45.8%,29m
6265,3,Posoon,3140,452,20,20,40,50.0%,25m
6265,3,[大姐酒家]Stephen,3140,442,17,13,30,56.7%,11m
6265,3,[握槽皮好痒]防不来一波,3140,367,16,13,29,55.2%,28m
6265,3,[三族同萌会]ACG,3140,376,14,15,29,48.3%,33m
6265,3,对不起让你心塞了,3140,333,13,10,23,56.5%,22m
6265,3,[Fisher]儒花,3140,306,11,16,27,40.7%,22m
6265,3,Abcd,3140,318,10,10,20,50.0%,6m
6265,2,[以爱之名55]再见宋哈娜,3140,204,6,5,11,54.5%,20m
6265,3,holy,3140,134,3,1,4,75.0%,8m
6265,3,贼人,3140,30,1,4,5,20.0%,3m
6265,3,[mdfz]鲍迪,3140,0,0,1,1,0.0%,10m
6265,3,[野人time]大和炮打探姬,3140,0,0,1,1,0.0%,32m
6279,3,野良神,3139,1471,61,59,120,50.8%,4m
6279,3,IzayoiSakuya,3139,849,58,48,106,54.7%,17m
6279,3,[折磨星际]Iron,3139,1017,49,20,69,71.0%,11m
6279,3,[谐星战术]lvyxEven,3139,614,21,32,53,39.6%,16m
6279,3,vanilla,3139,380,17,11,28,60.7%,18m
6279,3,水无月,3139,246,9,4,13,69.2%,9m
6279,3,chris,3139,232,7,4,11,63.6%,11m
6279,3,[糖心煎蛋]给钱啥都干,3139,141,4,2,6,66.7%,17m
6279,2,[Vgirls]命运天使,3139,102,3,1,4,75.0%,17m
6279,3,[阿里巴巴战队]家有娇花,3139,86,3,7,10,30.0%,33m
6279,3,职业法师,3139,129,2,2,4,50.0%,33m
6279,3,[肉鸡的饲养]小魔女伊蕾娜酱,3139,93,1,1,2,50.0%,22m
6279,3,冬雪沐霜亦风寒,3139,0,1,1,2,50.0%,1h
6279,3,yuki,3139,0,0,1,1,0.0%,18m
6293,3,贪婪和掠食,3138,1641,157,155,312,50.3%,2m
6293,3,NuclearPiano,3138,1266,99,82,181,54.7%,18m
6293,3,[虫群永不休止]IIIIIIIIIIII,3138,1109,57,23,80,71.2%,14m
6293,3,IIIIIIIIIIII,3138,417,17,11,28,60.7%,20m
6293,3,[DMRe]心宿二,3138,359,14,9,23,60.9%,31m
6293,2,iloveasu,3138,165,8,7,15,53.3%,2m
6293,3,MagejiTerren,3138,153,4,1,5,80.0%,37m
6293,3,何处惹尘埃,3138,97,3,1,4,75.0%,53m
6293,3,IIIIIIIIIII,3138,18,2,1,3,66.7%,11m
6293,3,[天雪丶葬花]Crow,3138,0,1,0,1,100.0%,6m
6293,3,顶级手法,3138,30,1,4,5,20.0%,32m
6293,2,[骂人]talecolor,3138,0,0,1,1,0.0%,5m
6305,2,nevermind,3137,1215,105,111,216,48.6%,18m
6305,3,[来骗来偷袭]战神龙猫,3137,1191,71,72,143,49.7%,5m
6305,3,为了虫群,3137,605,66,50,116,56.9%,35m
6305,3,[4everY]deadfisheye,3137,540,50,55,105,47.6%,1m
6305,3,[我队伍很强大]俊英的天空,3137,974,40,33,73,54.8%,5m
6305,3,[oo]black,3137,630,24,24,48,50.0%,35m
6305,3,[南京工业大学]Laplace,3137,648,23,24,47,48.9%,9m
6305,3,[黑暗先锋]幻梦帝星,3137,474,20,14,34,58.8%,7m
6305,3,lllllllllll,3137,511,20,19,39,51.3%,17m
6305,3,[CPT]混元星际门辞寒,3137,458,19,9,28,67.9%,25m
6305,1,怎么也打不过小强,3137,219,8,5,13,61.5%,1h
6305,3,紧小肾危,3137,174,7,5,12,58.3%,33m
6305,2,丧病的龙娘,3137,97,1,1,2,50.0%,1h
6318,3,风壶壶,3136,1516,143,119,262,54.6%,35m
6318,3,绝世月夜枫,3136,713,34,15,49,69.4%,9m
6318,3,夜北凉,3136,824,33,35,68,48.5%,6m
6318,3,夏男人,3136,386,26,20,46,56.5%,32m
6318,3,[大姐酒家]Bluetea,3136,451,20,15,35,57.1%,19m
6318,3,[北京城管]麻袋不要乱来,3136,389,13,12,25,52.0%,6m
6318,3,[超电磁炉]今朝梦初情,3136,327,12,8,20,60.0%,17m
6318,1,orctr,3136,96,5,2,7,71.4%,43m
6318,2,exile,3136,121,5,2,7,71.4%,2m
6318,3,[PZHSC]Shine,3136,94,2,0,2,100.0%,3m
6318,3,heeh,3136,30,2,1,3,66.7%,5m
6318,3,zdux,3136,97,2,4,6,33.3%,1h
6318,3,ARTIII,3136,0,0,2,2,0.0%,6m
6318,3,[星际鸽子组]DCproduction,3136,0,0,2,2,0.0%,35m
6318,3,luck,3136,0,0,3,3,0.0%,10m
6333,3,小呱呱萌萌哒,3135,523,24,15,39,61.5%,5m
6333,3,llllllllllll,3135,442,17,13,30,56.7%,9m
6333,3,[镜花水月丶]白泽,3135,432,16,13,29,55.2%,3m
6333,3,IIIIIIIIIIII,3135,336,15,10,25,60.0%,28m
6333,3,[地刺速埋协会]这就是地刺么,3135,260,10,7,17,58.8%,5m
6333,3,[横槊赋诗1]Rorschach,3135,225,9,4,13,69.2%,14m
6333,3,[爱吃辣椒的猫]啦啦啦,3135,190,8,7,15,53.3%,3m
6333,3,Mortis,3135,107,7,9,16,43.8%,7m
6333,1,ExTra,3135,96,5,3,8,62.5%,45m
6333,1,你怎么看,3135,145,5,3,8,62.5%,9m
6333,3,星爵,3135,140,4,1,5,80.0%,15m
6333,3,PIPI,3135,60,2,7,9,22.2%,33m
6333,2,[XUSC]Martin,3135,95,1,2,3,33.3%,39m
6333,3,查尔慈善组织,3135,30,1,2,3,33.3%,33m
6333,3,[好哥哥求让]慕清,3135,0,0,1,1,0.0%,17m
6333,3,ppcy,3135,0,0,1,1,0.0%,17m
6333,3,尹晨旭是你爹,3135,0,0,2,2,0.0%,17m
6333,3,[刺蛇互助协会]索然无味刺蛇娘,3135,0,0,2,2,0.0%,5m
6333,3,[巨龙降临]ZhaJ,3135,0,0,5,5,0.0%,16m
6352,3,IIIIIIIIIIII,3134,1558,99,102,201,49.3%,35m
6352,3,sicreature,3134,1072,49,50,99,49.5%,3m
6352,3,[鹌鹑带星]leon,3134,917,47,39,86,54.7%,14m
6352,3,[樱火之森]梦违,3134,956,44,29,73,60.3%,11m
6352,3,生而狂怒,3134,779,39,17,56,69.6%,3m
6352,3,张仙人,3134,346,16,13,29,55.2%,10m
6352,3,[疼王阁]傻子被盘子打死,3134,106,13,8,21,61.9%,25m
6352,3,IlIlIIIlllII,3134,332,12,14,26,46.2%,2m
6352,3,[Smiths]longly,3134,300,10,9,19,52.6%,14m
6352,3,Mac,3134,228,9,12,21,42.9%,33m
6352,3,[炸鱼大队]上海老鸡,3134,182,6,3,9,66.7%,5m
6352,3,[埃蒙好可爱]锤子,3134,0,3,2,5,60.0%,1h
6352,3,QingniQ,3134,0,1,0,1,100.0%,3m
6352,1,彩虹的彼方,3134,0,1,0,1,100.0%,8m
6352,3,[py8888]Arrow,3134,30,1,7,8,12.5%,14m
6352,3,叶落有孤城,3134,0,0,3,3,0.0%,33m
6368,3,Jackie,3133,1503,78,72,150,52.0%,36m
6368,2,Convexity,3133,1352,53,62,115,46.1%,37m
6368,3,翟椎,3133,883,36,33,69,52.2%,7m
6368,3,星际萌新,3133,452,20,20,40,50.0%,3m
6368,3,[镜花水月丿]dsrnFC,3133,292,11,4,15,73.3%,5m
6368,3,[能输跟你姓]电竞教父张一峰,3133,228,8,4,12,66.7%,18m
6368,3,孙掌门倒立拉稀,3133,0,0,1,1,0.0%,1h
6375,3,[不会散枪兵]餤玁狁,3132,1371,149,144,293,50.9%,5m
6375,3,Moonquake,3132,1552,121,127,248,48.8%,9m
6375,3,我爱吃番茄,3132,692,80,57,137,58.4%,10m
6375,3,[Sfae]千堂瑛里华,3132,1459,68,60,128,53.1%,5m
6375,3,[AICa]PZdog,3132,1280,63,34,97,64.9%,21m
6375,3,[星歌]ArthasMeneth,3132,912,56,33,89,62.9%,20m
6375,3,[真理卐高中]极限,3132,110,30,13,43,69.8%,35m
6375,3,[致逝去的青春]天神下凡一锤四,3132,667,30,16,46,65.2%,29m
6375,3,鸡飞狗跳,3132,569,24,21,45,53.3%,25m
6375,3,[CNU星际]莱莱莱莱莱茵,3132,393,17,18,35,48.6%,25m
6375,3,IIIIIIIIIII,3132,298,15,4,19,78.9%,23m
6375,3,[KPG]zimba,3132,168,8,9,17,47.1%,33m
6375,3,[Atoms]修罗,3132,158,4,2,6,66.7%,5m
6375,3,[Tpb]Thanatos,3132,94,2,0,2,100.0%,3m
6375,3,[加州室内装修]蓬莱山辉夜,3132,94,2,0,2,100.0%,21m
6375,3,DYLAN,3132,0,2,3,5,40.0%,35m
6375,3,[格里芬克鲁格]TosakaUCW,3132,0,0,1,1,0.0%,34m
6375,3,Mattin,3132,0,0,1,1,0.0%,16m
6375,3,[夕颜]中华气死喵,3132,0,0,4,4,0.0%,3m
6394,3,PSUCK,3131,1337,84,48,132,63.6%,7m
6394,3,IIIIIIIIIIII,3131,798,70,30,100,70.0%,17m
6394,3,shidianyanlu,3131,1195,70,64,134,52.2%,35m
6394,3,塔兔,3131,494,57,34,91,62.6%,4m
6394,3,[波板糖]热呢,3131,671,31,22,53,58.5%,32m
6394,1,Valkyrie,3131,193,7,5,12,58.3%,35m
6394,3,天魔,3131,142,6,5,11,54.5%,36m
6394,3,[萨尔那加之刃]tourist,3131,155,5,1,6,83.3%,9m
6394,3,今天不洗澡,3131,87,5,8,13,38.5%,25m
6394,1,Demon,3131,116,4,4,8,50.0%,21m
6394,3,[再抗战15年]闻疯丧胆,3131,90,3,7,10,30.0%,35m
6394,1,巡山,3131,95,2,0,2,100.0%,11m
6394,3,SHAY,3131,58,2,3,5,40.0%,13m
6394,3,今非昔比,3131,0,1,0,1,100.0%,15m
6394,2,IIIIIIIIIIII,3131,0,1,0,1,100.0%,4m
6394,3,[天生带感]喵喵怪,3131,0,1,1,2,50.0%,16m
6394,3,Lkerenl,3131,30,1,4,5,20.0%,30m
6394,3,[ME丶]MIsshY,3131,0,0,1,1,0.0%,3m
6394,3,[我们的奇迹]雪色光晕橙色奇迹,3131,0,0,1,1,0.0%,26m
6394,3,棺材里的森森,3131,0,0,1,1,0.0%,1h
6394,3,[Sc养老]Serrall,3131,0,0,7,7,0.0%,3m
6415,3,比格,3130,408,40,23,63,63.5%,36m
6415,3,[突变攻略组]苍蓝野兽,3130,556,23,14,37,62.2%,8m
6415,3,萌喵酱,3130,267,18,15,33,54.5%,4m
6415,3,wenfeng,3130,236,13,12,25,52.0%,36m
6415,3,[四叶草]卡亚,3130,170,12,5,17,70.6%,23m
6415,2,瓦力,3130,95,5,2,7,71.4%,1h
6415,3,[Mariss]毅童年,3130,183,5,3,8,62.5%,14m
6415,3,[妖馆]教练我要学星际,3130,132,4,0,4,100.0%,4m
6415,2,[毛毛保护协会]Starxil,3130,0,3,3,6,50.0%,1h
6415,2,DELETE,3130,0,1,0,1,100.0%,25m
6415,3,[红烛昏罗帐]貳拾肆,3130,38,1,4,5,20.0%,10m
6415,3,小红帽,3130,0,0,1,1,0.0%,10m
6415,3,[蕾米莉亚赛高]灰烬重生榨菜丝,3130,0,0,1,1,0.0%,22m
6415,3,Lair,3130,0,0,4,4,0.0%,14m
6429,3,[镜花水月丶]不会玩怎么办,3129,1202,109,97,206,52.9%,28m
6429,3,[华弟是巴子]xingege,3129,1393,61,49,110,55.5%,37m
6429,3,DoubleFinger,3129,1455,56,58,114,49.1%,11m
6429,3,[超实验级的]IIIIIIIIIIII,3129,401,15,10,25,60.0%,13m
6429,3,[装大佬的鸡]红白故人,3129,322,12,11,23,52.2%,3m
6429,2,井中月,3129,134,4,9,13,30.8%,34m
6429,3,[GGES]REIKSGUARD,3129,95,1,1,2,50.0%,30m
6429,3,[来游戏吖]鸡饲料,3129,30,1,2,3,33.3%,35m
6429,3,[大爱星际二]扮猪吃老虎,3129,0,0,1,1,0.0%,25m
6429,3,[银森]long,3129,0,0,3,3,0.0%,12m
6439,3,[菜有菜的道理]小梆,3128,1526,138,141,279,49.5%,14m
6439,3,wangmouren,3128,1534,110,85,195,56.4%,21m
6439,3,IIIIIIIIIIII,3128,1526,97,86,183,53.0%,9m
6439,3,[禽禽禽]枫叶红,3128,257,60,64,124,48.4%,33m
6439,3,欢欢好漂亮,3128,1052,51,55,106,48.1%,25m
6439,3,[焖敦儿杀手]小付请你吃屁,3128,1126,49,45,94,52.1%,31m
6439,3,路德,3128,847,40,41,81,49.4%,21m
6439,3,忏悔,3128,603,26,21,47,55.3%,3m
6439,3,[软萌甜小萝莉]笛卡尔公式,3128,326,20,1,21,95.2%,28m
6439,3,耍酷丿丶,3128,352,15,12,27,55.6%,3m
6439,3,[TLA]Deepest,3128,349,13,10,23,56.5%,14m
6439,3,[追随自由指引]行之,3128,277,12,9,21,57.1%,5m
6439,3,海盗旗,3128,234,7,6,13,53.8%,14m
6439,3,[莽夫智障团]兰帝斯,3128,227,7,10,17,41.2%,36m
6439,3,[七咕咕]llllllllllll,3128,114,5,3,8,62.5%,6m
6439,3,[Mica]你爹重回战场,3128,92,4,0,4,100.0%,34m
6439,3,空归不管旁人说,3128,0,4,1,5,80.0%,1h
6439,3,[Fe3o4]白骑士,3128,114,3,0,3,100.0%,26m
6439,3,[黎明将至]嘤嘤怪,3128,94,2,0,2,100.0%,9m
6439,3,[旭日之心]snoW,3128,97,2,2,4,50.0%,10m
6439,3,[北极光小组]我将再次修起地堡,3128,0,1,0,1,100.0%,24m
6439,3,[萌新保护协议]胯下韩信,3128,0,1,1,2,50.0%,10m
6439,2,我们始终都是朋友,3128,0,0,1,1,0.0%,21m
6462,3,Ayo,3127,983,276,242,518,53.3%,17m
6462,3,[QWQa]今日解签宜下江南,3127,885,54,48,102,52.9%,17m
6462,3,[守护孙保国]Aaa,3127,1235,49,44,93,52.7%,13m
6462,3,见芒,3127,839,35,27,62,56.5%,9m
6462,3,[NS]渤海,3127,695,32,21,53,60.4%,35m
6462,3,[笙风]沐雨笙风,3127,446,25,8,33,75.8%,31m
6462,3,[holyhp]恶魔之泪,3127,411,16,10,26,61.5%,4m
6462,3,妖精萧筱,3127,427,16,28,44,36.4%,22m
6462,3,[暴雪三队]小丫丫,3127,400,14,11,25,56.0%,31m
6462,3,[IMRTS]简单电脑,3127,388,14,15,29,48.3%,31m
6462,3,[由难到易]YURI,3127,303,12,6,18,66.7%,7m
6462,3,浅蓝,3127,176,6,7,13,46.2%,14m
6462,3,[TuiELF]白羽,3127,172,5,2,7,71.4%,6m
6462,2,不败之神,3127,0,4,2,6,66.7%,22m
6462,3,KAIYIFODOM,3127,126,4,8,12,33.3%,32m
6462,3,瞬间永恒,3127,0,3,2,5,60.0%,1h
6462,3,[星歌]言明曦无,3127,94,2,0,2,100.0%,31m
6462,3,是金子涵呀,3127,94,2,0,2,100.0%,37m
6462,3,我爱你有左灯右行,3127,96,2,1,3,66.7%,10m
6462,3,送经验宝宝,3127,30,2,1,3,66.7%,33m
6462,3,yazeroO,3127,30,1,2,3,33.3%,15m
6462,3,全自动上海人小黄,3127,0,0,1,1,0.0%,8m
6462,3,[UDI]NoteamSOS,3127,0,0,1,1,0.0%,6m
6462,3,xiaofan,3127,0,0,4,4,0.0%,7m
6486,3,[老油条战队]偷撒一滴泪,3126,1626,270,274,544,49.6%,5m
6486,3,[HFUOT]Sarrel,3126,615,56,32,88,63.6%,12m
6486,3,[老吴天下第一]普通人族李信衡,3126,687,42,26,68,61.8%,14m
6486,3,llllllllllll,3126,645,37,21,58,63.8%,12m
6486,3,[洛河LH]柠檬不萌,3126,507,25,9,34,73.5%,17m
6486,3,[第九世纪]sssssssssss,3126,322,12,13,25,48.0%,22m
6486,3,DRG,3126,285,11,7,18,61.1%,23m
6486,3,Ivan,3126,145,3,3,6,50.0%,18m
6486,3,cGay,3126,0,2,0,2,100.0%,31m
6486,3,[起点]快到我碗里来,3126,115,2,2,4,50.0%,9m
6486,3,搓澡兽,3126,120,2,5,7,28.6%,8m
6486,1,RageOfAngles,3126,45,2,6,8,25.0%,7m
6486,3,江瘤儿,3126,0,1,0,1,100.0%,37m
6486,1,二十四小时,3126,96,1,3,4,25.0%,32m
6500,3,二奶要翻身,3125,1645,626,604,1230,50.9%,11m
6500,3,[天天向上1]铺不上菌毯的虫母,3125,1582,131,123,254,51.6%,37m
6500,3,[才不是傲娇]ALVA,3125,1423,77,67,144,53.5%,27m
6500,3,以心献技,3125,605,29,13,42,69.0%,35m
6500,3,[某鸽学研究所]雪花飘散,3125,479,22,10,32,68.8%,19m
6500,3,[睫毛哥八百部]maoxinshu,3125,435,20,19,39,51.3%,18m
6500,3,[德拉米尔]战争精英,3125,172,6,8,14,42.9%,17m
6500,3,名字一向难起,3125,180,6,18,24,25.0%,3m
6500,3,[JEIBO]陈老板,3125,167,5,3,8,62.5%,18m
6500,3,KyDParzival,3125,138,4,1,5,80.0%,3m
6500,1,xiaoccccc,3125,48,2,4,6,33.3%,1h
6500,3,[YH]jsbyyz,3125,0,1,1,2,50.0%,12m
6500,3,DemonLord,3125,0,0,1,1,0.0%,28m
6500,3,[萌萌哒萌萌哒]pomie,3125,0,0,2,2,0.0%,4m
6500,3,凉城旧梦,3125,0,0,2,2,0.0%,3m
6515,3,[火焰雷兽]skzhujin,3124,776,38,29,67,56.7%,14m
6515,3,子木,3124,694,33,15,48,68.8%,20m
6515,3,NYJ,3124,900,32,38,70,45.7%,15m
6515,3,asjhduobg,3124,367,15,8,23,65.2%,21m
6515,3,Microsad,3124,238,9,15,24,37.5%,8m
6515,2,sagittarius,3124,228,8,27,35,22.9%,29m
6515,3,[白鸦]BTseven,3124,154,5,1,6,83.3%,14m
6515,3,对酒当歌,3124,58,3,5,8,37.5%,33m
6515,3,IIIIIIIIIIII,3124,58,2,4,6,33.3%,15m
6515,3,淡雅,3124,58,2,5,7,28.6%,33m
6515,3,lxqlldt,3124,0,0,2,2,0.0%,19m
6515,3,天堂在人间,3124,0,0,2,2,0.0%,26m
6527,3,scorpio,3123,1484,284,270,554,51.3%,29m
6527,3,Blackmoon,3123,844,40,30,70,57.1%,15m
6527,3,唐尸三摆手,3123,790,35,30,65,53.8%,17m
6527,3,[葬媛]莪嘚嬡沵芣慬,3123,156,23,12,35,65.7%,33m
6527,3,[熊大和熊二]NAXX,3123,299,21,9,30,70.0%,19m
6527,3,[社交学超可爱]我是菜鸟,3123,474,16,17,33,48.5%,7m
6527,3,[白手团]功夫熊猫,3123,230,9,3,12,75.0%,6m
6527,3,四季栞那,3123,262,9,6,15,60.0%,17m
6527,3,DOIT,3123,101,8,5,13,61.5%,11m
6527,3,么哈么哈,3123,178,6,1,7,85.7%,18m
6527,1,HicN,3123,119,5,3,8,62.5%,43m
6527,3,白云城主不戒大师,3123,139,3,3,6,50.0%,18m
6527,3,[暴雪二十一队]YounGG,3123,60,2,3,5,40.0%,28m
6527,3,nbnbNDG,3123,0,1,0,1,100.0%,27m
6527,3,提尔米拉,3123,30,1,2,3,33.3%,29m
6527,3,[老油条战队]肥美的小羊羔,3123,30,1,4,5,20.0%,22m
6527,3,VClin,3123,0,0,1,1,0.0%,11m
6544,3,Summer,3122,775,91,69,160,56.9%,14m
6544,2,星际行者,3122,1026,55,78,133,41.4%,18m
6544,3,建筑老师陈宏,3122,540,33,24,57,57.9%,30m
6544,3,好小一只妍妍,3122,674,26,27,53,49.1%,3m
6544,3,兜儿里有糖,3122,264,10,5,15,66.7%,9m
6544,3,johnDoo,3122,95,6,3,9,66.7%,37m
6544,3,IIIIIIIIIIII,3122,143,4,6,10,40.0%,31m
6544,3,LITTLEknife,3122,58,2,8,10,20.0%,3m
6544,3,[MYC]拉克希尔大乱斗,3122,0,1,0,1,100.0%,21m
6544,2,Joe,3122,0,1,2,3,33.3%,1h
6554,3,此地可是白门楼,3121,1228,100,107,207,48.3%,20m
6554,3,[XXHZN1]暴风,3121,1038,68,60,128,53.1%,5m
6554,2,IIIIIIIIIIII,3121,767,48,65,113,42.5%,7m
6554,3,[马辉没有马]马辉永远的神,3121,547,25,16,41,61.0%,19m
6554,3,耗自为汁,3121,426,18,13,31,58.1%,2m
6554,3,[红色锤镰]宇宙战神郭奉孝,3121,466,18,17,35,51.4%,8m
6554,3,LiarsDice,3121,121,5,2,7,71.4%,14m
6554,3,对面有七个人干我,3121,122,5,9,14,35.7%,15m
6554,2,[为星光而战]美味鱼肉,3121,0,4,2,6,66.7%,55m
6554,3,Quartet,3121,157,4,3,7,57.1%,32m
6554,3,努力努力再努力,3121,116,4,15,19,21.1%,6m
6554,3,[彼岸鸽友会]yukikaze,3121,58,3,4,7,42.9%,33m
6554,3,[FAZE]冷樟,3121,95,2,0,2,100.0%,28m
6554,3,Noble,3121,30,1,2,3,33.3%,11m
6554,3,Miracle,3121,30,1,5,6,16.7%,34m
6554,3,屁小迪,3121,30,1,6,7,14.3%,11m
6554,3,Sin,3121,0,0,1,1,0.0%,11m
6554,3,伍子的小尾巴,3121,0,0,4,4,0.0%,33m
6554,3,星空,3121,0,0,5,5,0.0%,8m
6573,3,tofu,3120,1499,120,86,206,58.3%,18m
6573,3,[Embers]YDM,3120,934,41,30,71,57.7%,37m
6573,3,电脑,3120,395,35,25,60,58.3%,29m
6573,3,[叫我兔本]深海中的三叉戟,3120,518,24,17,41,58.5%,14m
6573,3,Sadness,3120,426,18,16,34,52.9%,19m
6573,3,[JNUSC]LittleFlower,3120,236,9,4,13,69.2%,19m
6573,3,wuhao,3120,145,8,5,13,61.5%,36m
6573,3,[输本保护协会]有节操啊有节操,3120,211,7,6,13,53.8%,10m
6573,3,漆園巡禮,3120,204,7,11,18,38.9%,6m
6573,1,[葛温王下骑士]卫宫士郎,3120,95,2,0,2,100.0%,21m
6573,1,[混元体我女仆]乌冬丸铃仙,3120,0,1,0,1,100.0%,17m
6573,3,[哔哩哔哩乾杯]黑框眼镜渡边曜,3120,0,0,1,1,0.0%,2m
6585,3,[HUC不凡]伤心之刃,3119,1534,145,143,288,50.3%,21m
6585,3,[TPLINK]CreeperJimTH,3119,145,42,34,76,55.3%,8m
6585,1,羽幕丶,3119,374,15,12,27,55.6%,32m
6585,2,[星际同萌]和平还是核平,3119,314,10,28,38,26.3%,36m
6585,3,EvoluTioN,3119,121,5,2,7,71.4%,1h
6585,3,MJXxi,3119,116,3,2,5,60.0%,10m
6585,3,天资卓越的小男孩,3119,126,3,4,7,42.9%,8m
6585,3,李欣怡,3119,58,2,6,8,25.0%,3m
6585,1,[第九舰队丶]Gouxiaoyun,3119,0,0,1,1,0.0%,17m
6594,3,ZzzzzD,3118,1211,55,66,121,45.5%,33m
6594,3,HelloSC,3118,261,8,9,17,47.1%,35m
6594,3,[KPG]彼岸星辰,3118,148,6,7,13,46.2%,9m
6594,3,[ACG系]乱击蟞灬乱,3118,88,4,4,8,50.0%,14m
6594,3,蟑螂王,3118,58,3,4,7,42.9%,29m
6594,3,小面包啃起来,3118,0,1,2,3,33.3%,36m
6594,3,jaky,3118,0,1,2,3,33.3%,9m
6594,3,今天风儿真喧嚣,3118,0,1,2,3,33.3%,37m
6594,2,Elaina,3118,0,0,1,1,0.0%,6m
6603,3,IIIIIIIIIIII,3117,784,43,45,88,48.9%,3m
6603,3,[MaKers]NightSecret,3117,419,16,22,38,42.1%,33m
6603,3,[传奇人物]半岛铁盒,3117,187,7,1,8,87.5%,19m
6603,3,[奛汉]风间苍月,3117,148,6,15,21,28.6%,23m
6603,3,Moon,3117,0,3,2,5,60.0%,1h
6603,3,挥别笑留名,3117,96,1,1,2,50.0%,30m
6609,1,[菜有菜的道理]幼儿园手残党,3116,1400,83,66,149,55.7%,34m
6609,3,[北有吾王1队]绞肉机,3116,560,21,21,42,50.0%,32m
6609,3,Odin,3116,400,17,14,31,54.8%,17m
6609,3,[WCI]Los,3116,488,15,24,39,38.5%,5m
6609,2,北海怪兽,3116,331,13,10,23,56.5%,37m
6609,3,lunatea,3116,124,4,2,6,66.7%,25m
6609,1,風十一郎,3116,94,3,9,12,25.0%,1h
6609,3,IIIIIIIIII,3116,112,2,2,4,50.0%,18m
6609,3,[惊呆了]勇士,3116,49,2,5,7,28.6%,2m
6609,3,GeekShow,3116,0,1,1,2,50.0%,23m
6609,1,[P就IMBA]Ayanami,3116,0,1,1,2,50.0%,1h
6609,1,[泰拉多尔港湾]败瘠薄攒其我,3116,0,0,1,1,0.0%,16m
6609,3,[仨大傻子之队]传说之巅,3116,0,0,2,2,0.0%,32m
6609,1,这是绿色吗,3116,0,0,5,5,0.0%,31m
6623,3,Baldur,3115,1566,80,86,166,48.2%,36m
6623,3,[大雨的逆袭]儿子,3115,798,35,21,56,62.5%,37m
6623,3,[主宰巢群]DEX,3115,658,22,28,50,44.0%,35m
6623,3,[薄荷的指挥官]夏沫,3115,146,18,6,24,75.0%,33m
6623,3,[逐火之蛾]艾姬多娜,3115,416,16,16,32,50.0%,21m
6623,3,文者舞剑影若徐,3115,227,11,6,17,64.7%,4m
6623,3,[东方非想天则]比利海灵顿,3115,120,5,2,7,71.4%,49m
6623,1,山川流水,3115,82,3,2,5,60.0%,18m
6623,3,[Hoorai]JamesRaynor,3115,0,1,1,2,50.0%,21m
6623,3,[百宝箱]xbxing,3115,0,1,5,6,16.7%,22m
6623,3,蝴蝶苏畅,3115,0,0,2,2,0.0%,9m
6634,3,火影合拍,3114,573,64,44,108,59.3%,25m
6634,3,[全村之希望]星际不死,3114,492,18,15,33,54.5%,30m
6634,3,秋月白,3114,280,11,12,23,47.8%,32m
6634,1,[透一下清酒]FNAFSL,3114,222,6,2,8,75.0%,25m
6634,3,DragonYang,3114,148,6,8,14,42.9%,21m
6634,3,百鬼狂少,3114,0,4,1,5,80.0%,1h
6634,3,大绝,3114,58,3,5,8,37.5%,4m
6634,3,[天下何平]亡灵天灾,3114,30,2,2,4,50.0%,19m
6634,3,IIIIIIIIIIII,3114,0,1,0,1,100.0%,1h
6643,3,Tamis,3113,1123,130,87,217,59.9%,32m
6643,3,fenenzhanshe,3113,1330,98,88,186,52.7%,12m
6643,3,Jingyu,3113,1479,68,54,122,55.7%,28m
6643,3,猥琐浪别发育,3113,410,18,12,30,60.0%,26m
6643,3,[恋染色]Punishment,3113,214,10,13,23,43.5%,22m
6643,3,[SDEt]Jeager,3113,159,9,8,17,52.9%,25m
6643,3,[TShark]牛在灰翔,3113,258,9,11,20,45.0%,10m
6643,3,dawn,3113,189,8,7,15,53.3%,13m
6643,3,wsns,3113,94,4,4,8,50.0%,10m
6643,1,[SKT俱乐部]要用魔法打败魔法,3113,0,1,0,1,100.0%,2m
6643,1,由内而外,3113,42,1,1,2,50.0%,17m
6643,1,[为了埃萌]紫魂丿晓,3113,0,0,1,1,0.0%,7m
6643,3,NXX,3113,0,0,3,3,0.0%,6m
6656,3,FlandreS,3112,1193,62,60,122,50.8%,10m
6656,3,桃花弄影,3112,865,42,25,67,62.7%,11m
6656,3,Piezo,3112,947,40,35,75,53.3%,4m
6656,3,德富猫与立冬猫,3112,667,25,25,50,50.0%,23m
6656,3,Nofic,3112,494,22,14,36,61.1%,3m
6656,1,[浪啊浪]病毒,3112,266,13,7,20,65.0%,31m
6656,3,春开那夜,3112,124,4,7,11,36.4%,9m
6656,3,Zest,3112,141,3,3,6,50.0%,30m
6656,3,[Tuip]穿本,3112,94,1,2,3,33.3%,8m
6656,1,皓然来袭,3112,0,0,1,1,0.0%,31m
6666,3,广东程序猿,3111,1493,222,208,430,51.6%,8m
6666,3,NewPlayer,3111,752,34,21,55,61.8%,12m
6666,3,jockersun,3111,754,29,27,56,51.8%,3m
6666,1,[长夜将至]LLLLL,3111,429,14,5,19,73.7%,36m
6666,1,[萌新保护协议]你的探姬都去哪了,3111,273,13,1,14,92.9%,10m
6666,1,DCfprelo,3111,170,10,5,15,66.7%,16m
6666,3,海月,3111,218,8,5,13,61.5%,8m
6666,3,三姓家奴丶吕布,3111,216,8,13,21,38.1%,21m
6666,3,Flamingo,3111,174,6,17,23,26.1%,37m
6666,1,[博爱之城]士官长,3111,42,2,1,3,66.7%,3m
6666,2,碧之剑士,3111,0,2,5,7,28.6%,4m
6666,3,[北京大学鸡协]MaGeJiProtos,3111,0,1,0,1,100.0%,1h
6666,1,SAGE,3111,0,1,0,1,100.0%,6m
6666,1,[红魔地下藏书]帕秋莉诺蕾姬,3111,42,1,1,2,50.0%,16m
6666,3,莫大峰,3111,0,0,1,1,0.0%,1h
6681,3,[LUNA]破茧化蝶,3110,881,122,109,231,52.8%,19m
6681,3,[巨龙降临]迦拉克隆,3110,1236,52,38,90,57.8%,31m
6681,1,[无聊组团]零度空间,3110,542,24,16,40,60.0%,17m
6681,1,[别骚会防F2]IIIIIIIIIIII,3110,257,8,4,12,66.7%,8m
6681,2,[0APM]和和,3110,225,7,6,13,53.8%,31m
6681,1,可乐实验体,3110,76,2,1,3,66.7%,2m
6681,1,sasj,3110,40,1,2,3,33.3%,4m
6681,3,Crazyzerg,3110,97,1,5,6,16.7%,17m
6681,3,Zeczery,3110,0,0,1,1,0.0%,36m
6690,2,hotwingice,3109,1511,616,624,1240,49.7%,20m
6690,3,Zneollllllll,3109,592,62,57,119,52.1%,30m
6690,3,IIIIIIIIIIII,3109,230,30,35,65,46.2%,37m
6690,3,SSS,3109,309,12,10,22,54.5%,15m
6690,1,[在原七海]Mashiro,3109,294,12,12,24,50.0%,19m
6690,3,[死妈]wazjjaa,3109,235,11,5,16,68.8%,33m
6690,1,扯淡的生活,3109,120,4,0,4,100.0%,26m
6690,3,[相爱一家亲]山高勿远,3109,124,4,8,12,33.3%,6m
6690,1,xiaoxiong,3109,114,3,3,6,50.0%,24m
6690,1,那个男人,3109,40,1,1,2,50.0%,16m
6690,3,[青风堂]EtdTheAnswer,3109,30,1,14,15,6.7%,14m
6701,3,[Fantsy]Pluto,3108,1534,86,66,152,56.6%,34m
6701,3,Accelerator,3108,260,8,5,13,61.5%,31m
6701,3,蛇皮怪木无过过,3108,219,7,6,13,53.8%,21m
6701,3,小凶许,3108,229,7,9,16,43.8%,3m
6701,3,博宝宝,3108,188,6,6,12,50.0%,9m
6701,1,lllllllllll,3108,182,5,4,9,55.6%,21m
6701,3,[绀野木绵季]援气少女卷毛酱,3108,112,3,1,4,75.0%,5m
6701,3,NotNilc,3108,92,3,15,18,16.7%,17m
6701,1,[瘾大眼瞎]TATQwQ,3108,0,1,0,1,100.0%,32m
6701,3,[艾尔我唆了蒜]二良狗影,3108,0,1,2,3,33.3%,26m
6701,1,Saber,3108,0,1,4,5,20.0%,34m
6701,3,PanzerIV,3108,0,1,4,5,20.0%,38m
6701,1,[SoloAs]无名王者,3108,0,0,1,1,0.0%,32m
6714,2,linfee,3107,1414,74,84,158,46.8%,21m
6714,3,[五月花]DAVID,3107,446,47,46,93,50.5%,37m
6714,3,我没空,3107,449,27,20,47,57.4%,23m
6714,3,[洁白之巅]Templar,3107,566,26,25,51,51.0%,26m
6714,1,[LFZ]JustSlowly,3107,260,7,5,12,58.3%,4m
6714,3,[暴雪六队]shenmegui,3107,221,7,6,13,53.8%,35m
6714,1,PoLin,3107,40,3,12,15,20.0%,36m
6714,2,黄婷婷的口音饭,3107,118,2,2,4,50.0%,18m
6714,3,Simple,3107,30,1,6,7,14.3%,22m
6714,3,[CNboys]INnoVation,3107,0,0,2,2,0.0%,9m
6714,3,zzzzzzzz,3107,0,0,3,3,0.0%,17m
6725,3,南七技校大学渣,3106,1567,69,58,127,54.3%,10m
6725,3,蛇皮与皮皮虾,3106,426,19,13,32,59.4%,12m
6725,3,[TPoA]laplace,3106,272,9,9,18,50.0%,18m
6725,3,玩神族的都是废物,3106,157,5,1,6,83.3%,30m
6725,1,[HCG]Violet,3106,42,2,0,2,100.0%,33m
6725,1,Orochi,3106,42,1,1,2,50.0%,32m
6725,3,nothing,3106,0,1,1,2,50.0%,5m
6725,1,[我菜的]Overtu,3106,0,0,1,1,0.0%,2m
6733,3,至尊黑铁,3105,1569,147,141,288,51.0%,14m
6733,3,[屠夫预备队]SKTrealy,3105,364,16,8,24,66.7%,15m
6733,2,大男孩,3105,300,14,8,22,63.6%,35m
6733,3,黯然销魂者,3105,364,14,14,28,50.0%,17m
6733,3,[沧月女装协会]星空,3105,191,9,7,16,56.2%,36m
6733,3,[AsC]采姑娘的小蘑菇,3105,245,9,10,19,47.4%,17m
6733,1,[93589]ShadowHunter,3105,251,8,4,12,66.7%,23m
6733,1,请不要,3105,184,6,2,8,75.0%,1h
6733,3,一拳超人,3105,148,5,9,14,35.7%,14m
6733,1,古风海豹,3105,44,4,5,9,44.4%,1h
6733,3,soi,3105,88,3,9,12,25.0%,18m
6733,1,[X英雄圣域X]wensh,3105,0,1,0,1,100.0%,25m
6733,1,besttime,3105,0,0,1,1,0.0%,26m
6746,3,小熊,3104,1412,98,99,197,49.7%,10m
6746,3,统一酸菜牛肉面,3104,990,47,27,74,63.5%,18m
6746,3,不打内战,3104,726,34,23,57,59.6%,17m
6746,3,ooxx,3104,395,16,11,27,59.3%,6m
6746,3,WZT,3104,151,11,5,16,68.8%,6m
6746,3,[Shawk]星际真难玩,3104,210,8,8,16,50.0%,36m
6746,3,[HK丶S]麒麟竞技,3104,172,6,9,15,40.0%,15m
6746,2,霸罢,3104,0,4,2,6,66.7%,6m
6746,3,[暴雪二十六队]初见丶,3104,143,4,2,6,66.7%,8m
6746,1,SpringField,3104,80,2,2,4,50.0%,22m
6746,3,格式文,3104,0,1,0,1,100.0%,38m
6746,1,[寒冰不朽]坑人西瓜侠,3104,0,1,1,2,50.0%,1h
6746,3,[暴雪线上实测]星际争霸平衡组,3104,0,1,4,5,20.0%,15m
6746,1,Tim,3104,0,0,1,1,0.0%,19m
6746,1,[刺蛇单推协会]千水苓拾,3104,0,0,1,1,0.0%,12m
6761,3,小蜗,3103,1620,91,99,190,47.9%,18m
6761,3,Guikarist,3103,1588,78,83,161,48.4%,26m
6761,3,[暗中观察]askeladd,3103,320,27,20,47,57.4%,8m
6761,3,ChinaDragon,3103,450,16,20,36,44.4%,9m
6761,1,[罗马帝国]liuyunping,3103,356,11,6,17,64.7%,15m
6761,3,星际小师,3103,253,9,8,17,52.9%,21m
6761,1,[白银联盟]JKdagger,3103,82,3,0,3,100.0%,16m
6761,1,桃源叶问,3103,95,2,2,4,50.0%,35m
6761,1,Warrior,3103,0,2,6,8,25.0%,1h
6761,1,DOUBLEHAPPLY,3103,0,1,0,1,100.0%,16m
6761,1,[暴雪我是你爹]ktx,3103,0,1,0,1,100.0%,3m
6761,1,Sarrel,3103,40,1,1,2,50.0%,6m
6761,1,[茶会大作战]鬼人正邪,3103,0,0,1,1,0.0%,1h
6774,3,兄弟看好你农民,3102,1488,168,173,341,49.3%,34m
6774,3,gwsgtwq,3102,264,10,10,20,50.0%,21m
6774,3,[Chiken]淡定,3102,148,5,10,15,33.3%,15m
6774,2,[我是龙的传人]唐纳德川普,3102,0,4,2,6,66.7%,2m
6774,2,kidd,3102,95,4,7,11,36.4%,13m
6774,3,[GGC]泰山压顶,3102,96,1,2,3,33.3%,2m
6774,3,越今朝,3102,30,1,3,4,25.0%,37m
6774,3,[不知不觉天亮]Lin,3102,28,1,4,5,20.0%,7m
6774,3,Alone,3102,0,1,5,6,16.7%,1m
6774,3,[K39]keep,3102,0,0,1,1,0.0%,10m
6774,1,手握萝莉摘星辰,3102,0,0,1,1,0.0%,17m
6774,1,eth,3102,0,0,2,2,0.0%,3m
6786,3,天地逍遥,3101,908,32,41,73,43.8%,26m
6786,3,[TGone]朗个嫩锅骚,3101,371,13,12,25,52.0%,5m
6786,1,[江北星际]我猛得不配赢,3101,154,4,3,7,57.1%,33m
6786,2,只会送,3101,121,3,2,5,60.0%,34m
6786,3,fox,3101,30,2,2,4,50.0%,19m
6786,1,白酱,3101,0,1,0,1,100.0%,6m
6786,3,吃饭了吃饭了,3101,0,1,2,3,33.3%,33m
6786,1,过后才明白,3101,42,1,2,3,33.3%,30m
6786,2,[红萌馆]命运之诅咒,3101,0,0,1,1,0.0%,14m
6786,3,[百宝箱]星月凛,3101,0,0,3,3,0.0%,21m
6796,3,能动手尽量不吵吵,3100,857,107,92,199,53.8%,17m
6796,3,[钉宫病露娜癌]雪化晴散,3100,792,33,27,60,55.0%,10m
6796,3,我真不会玩,3100,691,29,21,50,58.0%,22m
6796,3,[NKT]LLawlite,3100,371,16,9,25,64.0%,10m
6796,3,稻叶依织,3100,164,7,5,12,58.3%,31m
6796,2,[暗黑执政官]怎么说,3100,186,6,2,8,75.0%,1h
6796,1,小豆豆,3100,40,2,0,2,100.0%,32m
6796,3,EtdHermes,3100,30,2,2,4,50.0%,37m
6796,1,飞鱼火花,3100,0,0,1,1,0.0%,16m
6796,1,[永恒者]奥柏伦亲王,3100,0,0,1,1,0.0%,21m
6806,3,埃罗忙啊老师,3099,1644,645,626,1271,50.7%,3m
6806,3,[Zergs]mDLrgb,3099,1462,203,173,376,54.0%,26m
6806,3,NaneeWa,3099,1047,114,99,213,53.5%,22m
6806,3,[咖啡Fans]NightQueen,3099,600,20,28,48,41.7%,33m
6806,2,斜眼笑,3099,330,13,11,24,54.2%,12m
6806,1,[紫金魔龙皇]Eikasang,3099,318,10,6,16,62.5%,32m
6806,3,kyo,3099,164,7,4,11,63.6%,4m
6806,3,HideToshi,3099,165,5,7,12,41.7%,22m
6806,3,clthegoat,3099,113,3,2,5,60.0%,9m
6806,3,[珂学]MagejiTerran,3099,116,2,2,4,50.0%,7m
6806,1,紫轩,3099,0,0,2,2,0.0%,43m
6817,3,惩罚者,3098,1465,324,311,635,51.0%,11m
6817,3,[剑走偏锋]arcadia,3098,722,29,24,53,54.7%,37m
6817,3,barenet,3098,275,10,7,17,58.8%,14m
6817,3,法海禅师,3098,176,7,13,20,35.0%,19m
6817,3,[赛博朋克]Magiczerg,3098,154,6,9,15,40.0%,4m
6817,3,自贡超人黄旭东,3098,173,5,4,9,55.6%,31m
6817,1,浮沉,3098,116,3,2,5,60.0%,18m
6817,1,[111]oldman,3098,38,2,1,3,66.7%,25m
6817,1,打不过就是打不过,3098,42,1,2,3,33.3%,25m
6817,1,LAS,3098,0,0,1,1,0.0%,10m
6817,1,DayLighT,3098,0,0,1,1,0.0%,17m
6817,3,[懟懟懟懟懟]努力冲铂金的佩奇,3098,0,0,3,3,0.0%,25m
6829,3,星际联盟司令官,3097,865,70,72,142,49.3%,28m
6829,3,lllllllll,3097,452,28,19,47,59.6%,8m
6829,3,[一个小菜鸡]佐守承梦,3097,606,27,17,44,61.4%,21m
6829,1,FallinSheild,3097,106,3,2,5,60.0%,30m
6829,3,大灰狼,3097,58,2,4,6,33.3%,10m
6829,1,[蠢萌呆]萱萱小溪,3097,0,1,0,1,100.0%,33m
6829,3,[BLZSC2]神话哥哥,3097,0,0,1,1,0.0%,10m
6829,1,致命之足,3097,0,0,1,1,0.0%,2m
6829,1,[CRSC2]Yahevh,3097,0,0,2,2,0.0%,30m
6829,3,色胚小茄子,3097,0,0,4,4,0.0%,9m
6839,3,cryforyou,3096,1570,188,189,377,49.9%,25m
6839,3,咆哮的耳朵,3096,1444,124,114,238,52.1%,32m
6839,3,zlczkx,3096,115,3,2,5,60.0%,26m
6839,3,[专业de团队]太行上帝,3096,117,3,3,6,50.0%,33m
6839,3,Victorange,3096,129,3,3,6,50.0%,7m
6839,1,[四叶草]苍蓝的回忆,3096,116,2,1,3,66.7%,22m
6839,3,[DR]自然主义,3096,0,1,0,1,100.0%,6m
6839,1,[C97]DuangDuang,3096,0,0,1,1,0.0%,17m
6839,1,shinga,3096,0,0,1,1,0.0%,10m
6848,3,RenaiSsancE,3095,1433,84,81,165,50.9%,8m
6848,3,[psadnj]我是酒店老板,3095,1480,64,58,122,52.5%,14m
6848,1,[死亡降临]猛兽,3095,120,4,3,7,57.1%,24m
6848,3,[我爱黄嘉彦]伟大温度计,3095,173,4,6,10,40.0%,4m
6848,3,[WIK]Faker,3095,120,4,9,13,30.8%,2m
6848,1,[KSAR]建瓯弓鱼,3095,72,3,2,5,60.0%,22m
6848,3,火星大王,3095,0,0,1,1,0.0%,31m
6848,1,[休闲的电脑]电脑,3095,0,0,1,1,0.0%,16m
6848,3,放开那个姑娘,3095,0,0,5,5,0.0%,6m
6857,1,牵奇奇,3094,1503,141,136,277,50.9%,16m
6857,1,bigdaddy,3094,504,26,21,47,55.3%,7m
6857,3,[M8]好兄弟无穷无尽,3094,508,17,23,40,42.5%,19m
6857,3,城市化就输不了,3094,334,12,9,21,57.1%,19m
6857,1,傻九九,3094,124,4,3,7,57.1%,32m
6857,1,illusion,3094,0,1,0,1,100.0%,25m
6857,3,[Shawk]老司机进行时,3094,96,1,1,2,50.0%,36m
6864,3,上兵伐谋,3093,1423,123,127,250,49.2%,26m
6864,3,高城望断,3093,222,16,10,26,61.5%,26m
6864,2,sOngtOm,3093,346,14,10,24,58.3%,36m
6864,1,OldYu,3093,160,5,4,9,55.6%,33m
6864,3,[RPIMBA]MrFuc,3093,140,4,5,9,44.4%,21m
6864,1,whilelight,3093,76,3,1,4,75.0%,17m
6864,1,[孙依枫]上将潘凤,3093,116,3,1,4,75.0%,22m
6864,3,[Vgirls]驻马店孙一峰,3093,0,1,9,10,10.0%,2m
6864,1,威猛的小老虎,3093,0,0,1,1,0.0%,19m
6864,1,[白云城主]ZARD,3093,0,0,1,1,0.0%,4m
6864,3,[同卵好兄弟]一只大汪八,3093,0,0,3,3,0.0%,34m
6875,3,[NBE]seveN,3092,1577,254,229,483,52.6%,5m
6875,1,kisa,3092,1057,47,41,88,53.4%,4m
6875,3,easticeufo,3092,799,36,36,72,50.0%,17m
6875,3,梅西又进球啦,3092,592,27,17,44,61.4%,4m
6875,3,[装大佬的鸡]WSPHY,3092,444,16,17,33,48.5%,21m
6875,1,[黑豹]rubyruby,3092,194,5,3,8,62.5%,15m
6875,3,这个名字,3092,146,4,4,8,50.0%,11m
6875,3,[星际旅游团]asgardking,3092,0,3,2,5,60.0%,1h
6875,1,[似曾相识]似曾相识,3092,0,1,0,1,100.0%,36m
6875,1,Auroth,3092,40,1,1,2,50.0%,33m
6875,3,daodao,3092,30,1,4,5,20.0%,3m
6875,3,牛币较真搞毛,3092,30,1,4,5,20.0%,23m
6875,1,[第四駆逐鑑隊]十丶王,3092,0,0,1,1,0.0%,16m
6875,1,我是一只鸡,3092,0,0,1,1,0.0%,29m
6875,1,汉斯,3092,0,0,2,2,0.0%,1h
6890,3,beanbee,3091,653,31,39,70,44.3%,3m
6890,3,穆赫兰之梦,3091,432,19,14,33,57.6%,35m
6890,1,鼓鼓,3091,362,11,8,19,57.9%,23m
6890,3,ken,3091,97,4,2,6,66.7%,1h
6890,3,[传统星际届]laohu,3091,86,3,8,11,27.3%,35m
6890,1,[TYFANS]湖底典狱长,3091,92,2,1,3,66.7%,18m
6890,3,[CNU星际]RangerWD,3091,30,2,3,5,40.0%,25m
6890,1,[timba6]蔡徐坤,3091,0,1,0,1,100.0%,8m
6890,1,XMR,3091,0,1,0,1,100.0%,51m
6890,3,[无锡老油条]阿良良木歷,3091,0,0,1,1,0.0%,31m
6890,1,[i5]FANTA,3091,0,0,1,1,0.0%,10m
6890,1,[丨SLT丨]北维,3091,0,0,1,1,0.0%,9m
6902,3,[NVKR]Ning,3090,1607,94,88,182,51.6%,7m
6902,3,FatHead,3090,627,58,54,112,51.8%,3m
6902,3,[SRI]彩笔没办法,3090,946,35,39,74,47.3%,35m
6902,3,[Beasty]lei,3090,444,24,18,42,57.1%,3m
6902,3,[ylx]Raven,3090,253,13,13,26,50.0%,15m
6902,3,鬼月,3090,60,3,5,8,37.5%,3m
6902,3,[鸽子六发]元莫,3090,62,3,6,9,33.3%,31m
6902,3,abel,3090,0,1,0,1,100.0%,12m
6902,3,[EZWIN]破晓惊云,3090,0,1,2,3,33.3%,12m
6902,1,[B站T老师]TeacherT,3090,0,1,2,3,33.3%,56m
6902,1,TonFroid,3090,0,0,1,1,0.0%,34m
6913,3,好汉饶命,3089,1544,501,498,999,50.2%,28m
6913,3,chicken,3089,1417,160,145,305,52.5%,19m
6913,3,[开始掠夺]黑珍珠号的小弟,3089,1367,149,143,292,51.0%,13m
6913,2,[不偷不狗全靠]可以吗,3089,1051,47,66,113,41.6%,7m
6913,3,phoenix,3089,390,40,24,64,62.5%,13m
6913,1,[海德单推协会]白痴,3089,704,34,9,43,79.1%,22m
6913,3,[血战菜鸡]KURONG,3089,472,16,18,34,47.1%,16m
6913,1,无尽温柔的幻想乡,3089,340,12,4,16,75.0%,9m
6913,3,[两道菜]稳稳稳,3089,194,7,8,15,46.7%,3m
6913,2,虚空者,3089,162,5,0,5,100.0%,34m
6913,1,情商,3089,186,5,3,8,62.5%,17m
6913,3,[嘶哈]全部杀掉,3089,148,4,3,7,57.1%,25m
6913,3,[KickF]cloud,3089,120,4,8,12,33.3%,13m
6913,1,丷星痕,3089,80,2,3,5,40.0%,17m
6913,2,MistyForce,3089,0,1,0,1,100.0%,25m
6913,3,Revolution,3089,93,1,2,3,33.3%,7m
6913,1,[雾雨魔法森林]空空空,3089,0,0,1,1,0.0%,17m
6913,1,[鱼苗养殖场]seter,3089,0,0,2,2,0.0%,9m
6931,3,Leo,3088,481,49,42,91,53.8%,17m
6931,1,Janvias,3088,1220,48,35,83,57.8%,33m
6931,1,llllIIIlllI,3088,575,26,12,38,68.4%,27m
6931,3,一只狼,3088,177,25,27,52,48.1%,34m
6931,3,[浙江大学战队]Demonic,3088,272,10,5,15,66.7%,4m
6931,3,[专克嫩头]wyj,3088,234,8,4,12,66.7%,10m
6931,1,[星戰同盟會]幽灵军团,3088,118,4,2,6,66.7%,2m
6931,3,剑指苍天,3088,130,4,13,17,23.5%,19m
6931,1,机械师,3088,78,3,1,4,75.0%,23m
6931,3,[古代萌新保护]IIIIIIIIIIII,3088,0,3,2,5,60.0%,26m
6931,3,[法兰街舞队w]Arthas,3088,0,1,0,1,100.0%,1h
6931,3,KTflash,3088,30,1,6,7,14.3%,29m
6931,1,[萌芯]March,3088,0,0,2,2,0.0%,2m
6944,3,Particular,3087,1558,325,316,641,50.7%,17m
6944,1,[菜鸟降落区]珞登,3087,1566,73,43,116,62.9%,26m
6944,3,[Sc养老]hinanawi,3087,1101,63,55,118,53.4%,28m
6944,3,羊刀,3087,951,38,35,73,52.1%,21m
6944,1,孤城,3087,714,22,18,40,55.0%,30m
6944,3,[RvA]yesung,3087,407,13,15,28,46.4%,17m
6944,1,lsy,3087,346,10,8,18,55.6%,12m
6944,1,[千亿颗星辰]月夜,3087,212,8,7,15,53.3%,7m
6944,1,[GCT]cooooooool,3087,159,5,3,8,62.5%,10m
6944,3,不快乐吗,3087,142,4,4,8,50.0%,31m
6944,3,[我忘记升折跃]zeratul,3087,88,4,7,11,36.4%,35m
6944,1,MMA,3087,138,3,2,5,60.0%,57m
6944,1,热开水很香,3087,0,1,0,1,100.0%,27m
6944,1,[NPUED]孙焕佳,3087,0,0,1,1,0.0%,9m
6944,1,超先生,3087,0,0,1,1,0.0%,16m
6944,3,丝烤人参,3087,0,0,1,1,0.0%,7m
6960,3,超级菜鸟,3086,1571,687,640,1327,51.8%,9m
6960,3,千秋一目,3086,1445,206,205,411,50.1%,17m
6960,3,[JOKER]SKTpartinG,3086,1328,48,57,105,45.7%,26m
6960,3,[Sc养老]BIBOU,3086,806,45,48,93,48.4%,5m
6960,3,[别嚼]MoRanMoGui,3086,656,28,26,54,51.9%,5m
6960,3,潘凤大战邢道荣,3086,224,11,13,24,45.8%,8m
6960,1,[饭太稀]娜迦之泪,3086,285,9,2,11,81.8%,8m
6960,1,天弑,3086,142,7,3,10,70.0%,1h
6960,3,[第九舰队丶]小玉米面条,3086,150,6,12,18,33.3%,26m
6960,1,杰明,3086,0,4,2,6,66.7%,40m
6960,2,[Achill]大连吴彦祖,3086,0,4,2,6,66.7%,1h
6960,3,我只是探姬啊喂,3086,94,3,8,11,27.3%,28m
6960,3,[文韬武略]表妹依旧消魂,3086,90,3,9,12,25.0%,5m
6960,2,[HUC妖皇]SKTMsJoy,3086,93,1,1,2,50.0%,1h
6960,1,kokoforever,3086,96,1,3,4,25.0%,25m
6960,1,长沙黄旭东,3086,0,0,1,1,0.0%,21m
6960,1,鲨鱼辣椒,3086,0,0,2,2,0.0%,6m
6977,1,llllllllllll,3085,1680,161,159,320,50.3%,34m
6977,3,IllIIIIlIIIl,3085,607,46,44,90,51.1%,2m
6977,2,[FSY]Alex,3085,321,41,56,97,42.3%,2m
6977,3,狗我丶死全家,3085,572,21,23,44,47.7%,29m
6977,3,[空条承太郎]DBJlhz,3085,517,19,17,36,52.8%,18m
6977,1,CCCCL,3085,510,16,12,28,57.1%,31m
6977,3,[入侵地球]MIAOtong,3085,118,4,7,11,36.4%,12m
6977,1,小鹿乱撞,3085,120,3,1,4,75.0%,32m
6977,1,新手学星际,3085,120,3,3,6,50.0%,29m
6977,3,机智如超哥,3085,30,1,4,5,20.0%,21m
6977,2,煞笔女人被狗日,3085,0,0,1,1,0.0%,1h
6988,3,[Bistu]帅得一逼,3084,1550,149,151,300,49.7%,18m
6988,3,[暴雪十一队]llll,3084,846,61,43,104,58.7%,31m
6988,3,虚空巴士,3084,1180,56,42,98,57.1%,11m
6988,3,Davidhan,3084,234,29,31,60,48.3%,16m
6988,3,嗜虐,3084,328,11,16,27,40.7%,15m
6988,3,IIIIIIIIIIII,3084,234,8,7,15,53.3%,11m
6988,1,[暴雪三十队]豆丁,3084,214,7,1,8,87.5%,34m
6988,1,[18公分]黑暗剑二十二,3084,184,5,5,10,50.0%,8m
6988,1,楚休红在水,3084,144,4,2,6,66.7%,9m
6988,3,黄泉回音,3084,0,3,2,5,60.0%,1h
6988,3,[麒云]IIIIIIIIIIII,3084,100,3,4,7,42.9%,8m
6988,2,[最菜战队]iloveyiming,3084,0,1,0,1,100.0%,1h
6988,1,PLZPICK,3084,38,1,1,2,50.0%,2m
6988,3,[Flowex]GUL,3084,30,1,8,9,11.1%,37m
6988,1,IIIIIIIIIIII,3084,0,0,1,1,0.0%,7m
6988,1,[小鸡屠宰场a]Bigman,3084,0,0,1,1,0.0%,12m
7004,3,冲一辈子坦克,3083,1543,408,407,815,50.1%,37m
7004,3,乔娜李莎的微笑,3083,576,31,42,73,42.5%,3m
7004,3,[赞助商我大哥]codie,3083,354,21,19,40,52.5%,33m
7004,1,[最菜战队]花式杠开,3083,492,15,12,27,55.6%,23m
7004,2,[Debu]KagamineRen,3083,309,14,10,24,58.3%,13m
7004,1,[单人的2V2]超级菜,3083,190,14,20,34,41.2%,2m
7004,1,Nting,3083,313,12,13,25,48.0%,26m
7004,1,花悦婿艳,3083,344,10,7,17,58.8%,2m
7004,1,[幻海奇妙夜]ArusuMaria,3083,329,9,7,16,56.2%,17m
7004,3,[MFJ]captain,3083,60,2,6,8,25.0%,15m
7004,1,[不知道叫什么]圣诞诞诞,3083,0,1,0,1,100.0%,17m
7004,1,羽根,3083,0,1,0,1,100.0%,9m
7004,3,[哔翻天梯鸡]BrandoFSu,3083,96,1,2,3,33.3%,36m
7004,1,[S09]asuna,3083,0,0,1,1,0.0%,29m
7004,1,[心如止水]易者,3083,0,0,1,1,0.0%,9m
7019,1,hdajsdf,3082,984,34,30,64,53.1%,22m
7019,1,TerranLife,3082,813,30,30,60,50.0%,32m
7019,1,Moster,3082,322,10,7,17,58.8%,7m
7019,3,qjhsfather,3082,257,8,9,17,47.1%,8m
7019,1,梦太重,3082,234,5,2,7,71.4%,10m
7019,3,checkmate,3082,138,3,4,7,42.9%,22m
7019,1,Mojito,3082,95,2,1,3,66.7%,41m
7019,1,DLA,3082,96,1,2,3,33.3%,56m
7019,1,[哔翻天梯鸡]阿莱克修斯,3082,34,1,2,3,33.3%,22m
7019,3,sktwulaodog,3082,0,0,3,3,0.0%,19m
7029,1,kjd,3081,921,34,25,59,57.6%,26m
7029,1,andydai,3081,720,34,30,64,53.1%,2m
7029,3,[SC2老男孩]蛇尾,3081,170,25,24,49,51.0%,5m
7029,3,[虚拟歌手团体]钻石鸡苦练运营,3081,351,15,8,23,65.2%,36m
7029,1,Innochicken,3081,262,10,7,17,58.8%,37m
7029,3,阿甘,3081,133,8,18,26,30.8%,9m
7029,2,[永夜安港]星空流尘,3081,219,7,5,12,58.3%,20m
7029,1,机枪滚毒爆,3081,82,3,2,5,60.0%,4m
7029,3,[五月花]阿呆阿克,3081,0,3,2,5,60.0%,1h
7029,3,Convict,3081,30,2,3,5,40.0%,15m
7029,1,大触,3081,0,1,0,1,100.0%,16m
7029,1,Fearless,3081,0,0,1,1,0.0%,11m
7041,1,Justin,3080,1617,97,74,171,56.7%,25m
7041,3,taoyong,3080,471,85,76,161,52.8%,3m
7041,1,你的死兆星在闪烁,3080,685,25,16,41,61.0%,34m
7041,3,THOSO,3080,319,18,19,37,48.6%,13m
7041,3,马晓壮,3080,408,14,14,28,50.0%,36m
7041,2,克哈机动队,3080,140,7,6,13,53.8%,10m
7041,2,小小跳虫可笑可笑,3080,118,5,3,8,62.5%,5m
7041,1,是橘猫大人,3080,194,5,7,12,41.7%,2m
7041,1,[不不要求求你]柏崎星奈,3080,44,2,1,3,66.7%,4m
7041,1,[霸气军团]洗胖次的林阿狗,3080,78,2,2,4,50.0%,9m
7041,3,[盖世双谐]最帅男公关,3080,30,2,4,6,33.3%,9m
7041,1,[30CM]BattleSuck,3080,0,1,0,1,100.0%,25m
7041,3,纸先生,3080,0,1,0,1,100.0%,1h
7041,3,杰哥,3080,0,1,2,3,33.3%,35m
7041,3,憨色的虚拟鸟蛋,3080,0,0,1,1,0.0%,15m
7056,3,翔云破晓月,3079,932,70,69,139,50.4%,27m
7056,3,[灰冥]摔下二楼的杰洛特,3079,742,25,29,54,46.3%,25m
7056,1,[博灬弈丶论]叫我嚣张,3079,290,8,8,16,50.0%,16m
7056,1,输本一样的智力,3079,0,1,0,1,100.0%,22m
7056,1,SBZ,3079,0,1,0,1,100.0%,37m
7056,1,山东郭奉孝,3079,0,0,1,1,0.0%,27m
7056,1,[21483]NEST,3079,0,0,1,1,0.0%,22m
7056,1,[教主别动队]锦绣柒阅,3079,0,0,2,2,0.0%,22m
7064,3,第四虫,3078,508,53,58,111,47.7%,3m
7064,1,[仙豆]一库,3078,797,30,22,52,57.7%,3m
7064,1,碎的喧嚣,3078,530,16,16,32,50.0%,3m
7064,3,[soki]Mordor,3078,410,14,19,33,42.4%,20m
7064,3,柚子鱼,3078,280,10,9,19,52.6%,22m
7064,1,Artorias,3078,0,4,3,7,57.1%,1h
7064,1,猫儿儿,3078,80,2,1,3,66.7%,2m
7064,3,Dreamer,3078,122,2,1,3,66.7%,11m
7064,1,[死亡之火]涂山王,3078,0,1,0,1,100.0%,12m
7064,1,段段,3078,0,1,0,1,100.0%,57m
7064,3,[Sc养老]muinbib,3078,0,1,1,2,50.0%,36m
7075,2,哥曾信佛,3077,1525,605,608,1213,49.9%,18m
7075,3,[洁白之巅]谱尼,3077,1380,59,72,131,45.0%,8m
7075,3,虚空回音,3077,1082,46,39,85,54.1%,6m
7075,3,帅气舒,3077,267,17,14,31,54.8%,33m
7075,1,彬彬好逊,3077,292,12,4,16,75.0%,16m
7075,1,Zenont,3077,232,10,10,20,50.0%,9m
7075,1,索然无味小刺蛇娘,3077,106,4,2,6,66.7%,34m
7075,3,[不玩同族对抗]中山大学朱晨文,3077,116,4,7,11,36.4%,29m
7075,1,[西红柿炒]荷包蛋,3077,40,2,2,4,50.0%,27m
7075,1,[小鸡屠宰场b]罪雷挽歌,3077,0,1,0,1,100.0%,2m
7075,1,[数字菌的后宫]InsaneCorn,3077,38,1,3,4,25.0%,2m
7086,3,TTB,3076,1581,319,322,641,49.8%,19m
7086,2,Encounter,3076,767,308,316,624,49.4%,5m
7086,3,阿克蜀黍,3076,389,17,15,32,53.1%,29m
7086,1,wywk,3076,150,5,5,10,50.0%,32m
7086,3,沧海客,3076,118,5,6,11,45.5%,9m
7086,3,无敌的不死小强,3076,140,3,6,9,33.3%,14m
7092,3,[s黑色孤儿s]帝国军,3075,1369,236,214,450,52.4%,8m
7092,3,[火焰雷兽]ted,3075,1602,80,89,169,47.3%,6m
7092,3,Sirmin,3075,945,36,38,74,48.6%,34m
7092,3,[零度星际]疯狂微软,3075,702,25,29,54,46.3%,21m
7092,1,[益虫]Wall,3075,171,10,6,16,62.5%,1h
7092,1,[CNboys]小马不过桥,3075,264,7,5,12,58.3%,2m
7092,3,[SFloor]随去风来,3075,97,1,1,2,50.0%,49m
7092,1,Beast,3075,0,0,1,1,0.0%,34m
7092,3,老夫乃天选之人,3075,0,0,1,1,0.0%,58m
7092,1,[芜湖wuho]无辜的路人丙,3075,0,0,1,1,0.0%,9m
7102,3,闷骚的洛丽塔,3074,1402,330,329,659,50.1%,33m
7102,1,Doctor,3074,1665,67,55,122,54.9%,26m
7102,3,[我们是无敌的]菜鸟克高手,3074,492,18,21,39,46.2%,37m
7102,3,麦田里的大牛,3074,391,13,15,28,46.4%,18m
7102,3,[就怕对手弱]seabiscuit,3074,193,6,3,9,66.7%,25m
7102,1,[输了穿女装]chara,3074,223,6,3,9,66.7%,9m
7102,1,常草草,3074,154,5,1,6,83.3%,37m
7102,2,古月,3074,44,5,3,8,62.5%,1h
7102,1,瑶瑟铅华,3074,120,3,3,6,50.0%,17m
7102,3,[为星光而战]小蓝星光,3074,121,3,3,6,50.0%,2m
7102,1,[迷路的小狗]diary,3074,0,0,1,1,0.0%,16m
7102,1,Ray,3074,0,0,2,2,0.0%,32m
7102,1,[XXHZ8]药水,3074,0,0,3,3,0.0%,34m
7102,3,[天地会分舵]IlIlIlIlIlIl,3074,0,0,4,4,0.0%,23m
7116,3,随便弄弄,3073,1481,112,112,224,50.0%,5m
7116,3,Sakura,3073,1155,109,100,209,52.2%,12m
7116,3,我需要视力,3073,239,10,7,17,58.8%,3m
7116,2,电竞乔北陆,3073,189,6,5,11,54.5%,10m
7116,1,FlyingLoum,3073,0,1,2,3,33.3%,3m
7116,1,rhythm,3073,0,0,1,1,0.0%,2m
7122,3,桔子,3072,1587,166,169,335,49.6%,33m
7122,1,iweiko,3072,604,19,14,33,57.6%,25m
7122,3,小心我狗你,3072,286,10,19,29,34.5%,25m
7122,1,Sparkling,3072,301,9,3,12,75.0%,22m
7122,1,田儿子真的蠢,3072,171,4,3,7,57.1%,25m
7122,3,[Happy]EndlessDream,3072,97,4,4,8,50.0%,3m
7122,2,[辣鸡儿小队]Onepiece,3072,0,3,1,4,75.0%,6m
7122,3,命运审判,3072,0,1,0,1,100.0%,1h
7122,3,后月樂,3072,0,1,3,4,25.0%,30m
7122,3,RNGkuangxiao,3072,0,0,1,1,0.0%,17m
7122,1,chuck,3072,0,0,3,3,0.0%,10m
7133,3,酥铭铭,3071,941,54,56,110,49.1%,10m
7133,3,传说,3071,285,13,11,24,54.2%,17m
7133,1,[UNSC海军]玛修基列莱特,3071,390,12,10,22,54.5%,23m
7133,1,吕归尘,3071,224,7,6,13,53.8%,25m
7133,3,[萌蛋组合]风吹屁屁凉,3071,60,2,6,8,25.0%,14m
7133,2,[僵尸快跑]飞行荷兰人,3071,0,1,0,1,100.0%,23m
7133,2,浩然正气,3071,0,1,0,1,100.0%,35m
7133,3,EEnglish,3071,0,1,0,1,100.0%,13m
7133,3,[西伯利亚土豆]mute,3071,0,1,0,1,100.0%,1h
7133,1,[出来挨打]长生,3071,40,1,4,5,20.0%,29m
7133,3,Fish,3071,0,0,1,1,0.0%,1h
7133,1,llllllllllll,3071,0,0,1,1,0.0%,22m
7133,3,IvesZero,3071,0,0,1,1,0.0%,15m
7146,3,ZwilL,3070,1363,134,123,257,52.1%,21m
7146,3,[菜有菜的道理]黄小益,3070,1051,110,110,220,50.0%,27m
7146,3,魔法小侏儒,3070,1641,105,108,213,49.3%,37m
7146,1,干死黄旭东,3070,991,36,31,67,53.7%,22m
7146,1,参商永隔,3070,421,21,15,36,58.3%,9m
7146,1,[小仙女上线啦]行建国,3070,409,15,10,25,60.0%,17m
7146,3,llllllllllll,3070,451,15,17,32,46.9%,14m
7146,3,冰冰冰,3070,184,9,15,24,37.5%,33m
7146,3,食色,3070,164,7,9,16,43.8%,21m
7146,2,小林,3070,133,3,0,3,100.0%,1h
7146,1,[25boy]XIAOJU,3070,40,2,2,4,50.0%,16m
7146,1,[NKTJ]阿尔萨斯诺林,3070,38,1,1,2,50.0%,4m
7146,1,走向宇宙,3070,0,0,1,1,0.0%,30m
7159,3,[八爪鱼]本子成林,3069,1472,69,63,132,52.3%,27m
7159,3,GreyGoo,3069,1340,56,50,106,52.8%,14m
7159,1,Blackmoth,3069,399,16,12,28,57.1%,32m
7159,2,阿巴阿巴,3069,162,5,0,5,100.0%,5m
7159,1,zxc,3069,150,5,4,9,55.6%,34m
7159,1,牧羊人的怀抱,3069,196,5,4,9,55.6%,3m
7159,3,开坦克的贝塔,3069,58,2,7,9,22.2%,36m
7159,1,神仙妖怪谢谢,3069,78,2,7,9,22.2%,7m
7159,1,[地瓜非红薯]糟糕,3069,0,1,0,1,100.0%,32m
7159,3,indolent,3069,94,1,4,5,20.0%,33m
7169,3,[麻酱万岁]llllllllllll,3068,1447,108,86,194,55.7%,18m
7169,3,[晨风]鬼丞相,3068,1421,55,56,111,49.5%,18m
7169,1,云中不知雀,3068,529,45,26,71,63.4%,9m
7169,2,[ToHo]lona,3068,277,13,10,23,56.5%,27m
7169,1,[秋名山老斯基]RKRK,3068,354,10,10,20,50.0%,3m
7169,3,杉木炎,3068,212,9,9,18,50.0%,12m
7169,3,天空,3068,225,7,7,14,50.0%,22m
7169,1,素质特别差的选手,3068,0,4,1,5,80.0%,16m
7169,1,[只想一直空想]PLongBao,3068,0,3,1,4,75.0%,48m
7169,1,[暴雪四队]陈雅洁是你祖母,3068,78,3,1,4,75.0%,22m
7169,1,超级菜鸟,3068,82,3,1,4,75.0%,4m
7169,1,丨黯灬,3068,0,3,2,5,60.0%,51m
7169,1,Rebel,3068,78,3,4,7,42.9%,4m
7169,2,IIIIIIIIIIII,3068,46,1,2,3,33.3%,1h
7169,2,[M8]ISISISIS,3068,0,0,1,1,0.0%,1h
7169,1,commander,3068,0,0,2,2,0.0%,7m
7169,1,我想你了,3068,0,0,2,2,0.0%,16m
7169,1,[血橘]糖拌酱,3068,0,0,3,3,0.0%,5m
7187,3,健忘的鱼,3067,1458,77,68,145,53.1%,4m
7187,3,大大,3067,379,62,59,121,51.2%,26m
7187,3,醉不复醒,3067,309,12,19,31,38.7%,4m
7187,3,爱吃红烧牛肉面,3067,200,7,16,23,30.4%,24m
7187,1,探索黑暗未见光明,3067,203,6,2,8,75.0%,35m
7187,3,[海神波赛东]一一,3067,148,5,9,14,35.7%,36m
7187,1,[DSE]游龙八卦掌,3067,81,4,0,4,100.0%,7m
7187,1,[炸鱼biss]Lenor,3067,162,4,6,10,40.0%,2m
7187,2,[FILL]醉仙王,3067,93,1,2,3,33.3%,1h
7187,1,疾风光刃,3067,0,0,1,1,0.0%,6m
7187,1,[JAG]IntotheLcq,3067,0,0,1,1,0.0%,16m
7198,3,[汉堡FANS]天依,3066,1515,124,120,244,50.8%,14m
7198,3,深深深,3066,1504,58,60,118,49.2%,14m
7198,1,青衫负雪,3066,148,5,2,7,71.4%,32m
7198,1,[文韬武略]小户,3066,182,5,4,9,55.6%,17m
7198,3,cdy,3066,166,5,5,10,50.0%,20m
7198,1,[纸鸢i]zzreal,3066,112,4,3,7,57.1%,22m
7198,1,[暴雪八队]狐狸不是妖,3066,82,2,2,4,50.0%,25m
7198,1,[美丽的风景线]climaxform,3066,82,2,4,6,33.3%,26m
7198,3,Walte,3066,62,2,10,12,16.7%,25m
7198,3,[白鸦]ylainiya,3066,30,1,7,8,12.5%,35m
7198,1,咸鱼,3066,0,0,1,1,0.0%,7m
7198,3,所识,3066,0,0,1,1,0.0%,1h
7210,3,李海龙,3065,1028,342,312,654,52.3%,38m
7210,3,本因坊丈育,3065,1542,153,143,296,51.7%,35m
7210,1,Aoliao,3065,680,21,17,38,55.3%,15m
7210,1,PenBrush,3065,309,8,5,13,61.5%,33m
7210,3,zzzzz,3065,182,6,6,12,50.0%,6m
7210,3,SleepWalker,3065,109,6,8,14,42.9%,31m
7210,3,长泽雅美,3065,172,6,10,16,37.5%,38m
7210,1,[败给]ZIMBA,3065,132,4,2,6,66.7%,57m
7210,3,BPinarea,3065,120,3,4,7,42.9%,1h
7210,1,魃魈魁魌,3065,40,2,1,3,66.7%,33m
7210,1,Diamonds,3065,96,2,1,3,66.7%,31m
7210,1,[神圣]呆头部落,3065,0,1,3,4,25.0%,12m
7210,1,[丨SLT丨]uwuThermy,3065,0,0,1,1,0.0%,5m
7210,1,[ByuNgl]xOnEmAnArmYx,3065,0,0,1,1,0.0%,33m
7224,3,裴柱现你也杀,3064,1538,147,134,281,52.3%,14m
7224,3,鸽子军团长,3064,1248,74,66,140,52.9%,14m
7224,3,猪兔子,3064,517,55,52,107,51.4%,23m
7224,1,[KPG]爱国者,3064,586,18,14,32,56.2%,17m
7224,3,[雾之湖红萌馆]铃仙,3064,288,12,6,18,66.7%,9m
7224,1,谪仙,3064,302,8,5,13,61.5%,2m
7224,3,打团让领导先走,3064,30,3,8,11,27.3%,23m
7224,3,SolaR,3064,0,2,2,4,50.0%,1h
7224,1,沈渊,3064,0,1,0,1,100.0%,6m
7224,3,DavyJones,3064,30,1,5,6,16.7%,20m
7224,3,[丨虫族灬战队]夜深,3064,30,1,6,7,14.3%,35m
7224,1,[捌柒柒叁]旃东,3064,0,0,1,1,0.0%,23m
7224,1,[暴风雨]上杉绘梨衣,3064,0,0,1,1,0.0%,2m
7237,3,[不要TVT]朱晨文的账号,3063,1416,113,124,237,47.7%,9m
7237,3,MinkyX,3063,798,30,38,68,44.1%,34m
7237,3,[上海大学]夏至泡泡,3063,424,18,15,33,54.5%,28m
7237,1,会长,3063,382,13,7,20,65.0%,32m
7237,1,warriors,3063,205,7,0,7,100.0%,23m
7237,3,[SUPSC]zhong,3063,190,6,6,12,50.0%,14m
7237,1,iiLiiIIILIIL,3063,189,5,8,13,38.5%,41m
7237,1,[为了遥远的]柚子茶,3063,113,4,4,8,50.0%,23m
7237,1,月不明风止,3063,154,4,5,9,44.4%,34m
7237,3,[星域神界]apple,3063,97,2,0,2,100.0%,1h
7237,1,[某科学的]可乐丶九条,3063,32,2,1,3,66.7%,29m
7237,1,[拱墅车王]斬島,3063,75,2,3,5,40.0%,16m
7237,1,心怡不倒翁,3063,90,2,5,7,28.6%,1h
7237,2,[YM]艾辰学长,3063,0,0,1,1,0.0%,23m
7251,3,黄药师,3062,1453,177,171,348,50.9%,18m
7251,1,年轻人耗子喂汁,3062,1581,103,89,192,53.6%,26m
7251,3,[STKY]飞燕绝尘,3062,753,98,107,205,47.8%,19m
7251,3,非常懒猪,3062,1520,62,61,123,50.4%,19m
7251,3,[BWB]IIIIIIIIIIII,3062,620,43,43,86,50.0%,4m
7251,3,[TCP]HiddenKnife,3062,720,34,23,57,59.6%,21m
7251,1,[星之所在RI]环忧,3062,744,30,31,61,49.2%,25m
7251,3,太上忘情豆,3062,330,16,12,28,57.1%,10m
7251,3,[LEor]FrostMourne,3062,128,4,13,17,23.5%,7m
7251,1,dark,3062,0,3,2,5,60.0%,19m
7251,3,mistake,3062,122,3,3,6,50.0%,11m
7251,1,[废物乐园]佞臣,3062,80,2,3,5,40.0%,23m
7251,1,[SKT俱乐部]llllllllllll,3062,0,1,0,1,100.0%,33m
7251,2,有点东西,3062,0,1,0,1,100.0%,1h
7251,3,没有待定,3062,0,1,2,3,33.3%,49m
7251,3,[WIE]Colin,3062,0,0,1,1,0.0%,10m
7251,2,水至清,3062,0,0,1,1,0.0%,1h
7268,1,生命之弦,3061,1748,217,215,432,50.2%,26m
7268,3,saadg,3061,806,56,39,95,58.9%,10m
7268,1,龙腾,3061,508,35,17,52,67.3%,24m
7268,1,[艾尔之巅]仙师二口合,3061,254,8,8,16,50.0%,19m
7268,1,[A丶rash]CTRahmRemm,3061,263,6,4,10,60.0%,3m
7268,1,[去玩儿法T]VagusNerve,3061,116,4,3,7,57.1%,34m
7268,1,小力力无敌,3061,66,2,5,7,28.6%,5m
7268,1,装逼狂魔珠心算,3061,0,0,1,1,0.0%,2m
7276,3,playsc,3060,1619,310,298,608,51.0%,32m
7276,1,鬼谷子,3060,457,41,36,77,53.2%,17m
7276,3,Escapist,3060,764,39,37,76,51.3%,33m
7276,3,Antarc,3060,278,11,7,18,61.1%,29m
7276,3,Rocky,3060,155,9,10,19,47.4%,30m
7276,2,xingmeng,3060,141,3,2,5,60.0%,1h
7276,1,纵一世轻狂,3060,160,3,5,8,37.5%,1h
7276,1,[C69128]假装大佬,3060,0,1,0,1,100.0%,6m
7276,1,[打狗棒法]影殇洛月,3060,0,1,0,1,100.0%,29m
7276,1,雷光一闪,3060,38,1,1,2,50.0%,5m
7276,1,绫音,3060,40,1,3,4,25.0%,32m
7276,3,笑容背后丶乐逍遥,3060,0,0,1,1,0.0%,1h
7276,1,龙骑吴奇隆,3060,0,0,2,2,0.0%,19m
7289,3,接我肥皂,3059,480,52,48,100,52.0%,3m
7289,3,[星战分部]麦子,3059,799,34,26,60,56.7%,31m
7289,3,been,3059,750,28,29,57,49.1%,30m
7289,1,周先丶森,3059,593,20,16,36,55.6%,32m
7289,3,BestRivan,3059,452,15,17,32,46.9%,2m
7289,3,[你已经死啦]圆环之理,3059,157,4,5,9,44.4%,14m
7289,3,冷酷的电脑,3059,30,1,6,7,14.3%,6m
7296,1,SANGRITA,3058,844,30,28,58,51.7%,30m
7296,1,不会玩,3058,198,8,5,13,61.5%,36m
7296,2,smileZhong,3058,165,7,5,12,58.3%,20m
7296,1,SRJ,3058,260,7,9,16,43.8%,5m
7296,3,[瘾大眼瞎]艾尔暗影卫队,3058,178,6,0,6,100.0%,23m
7296,1,guoyufan,3058,38,2,0,2,100.0%,18m
7296,1,kog,3058,0,1,0,1,100.0%,9m
7296,3,猪小帆,3058,0,0,1,1,0.0%,1h
7296,1,Moon,3058,0,0,2,2,0.0%,24m
7305,1,[季季]幸福的小潇潇潇潇,3057,878,104,90,194,53.6%,16m
7305,3,我不是谐星,3057,1533,88,93,181,48.6%,25m
7305,3,自命不凡,3057,775,31,33,64,48.4%,12m
7305,1,[Sc养老]过尘,3057,503,22,11,33,66.7%,17m
7305,3,[鱼玩]上杉冰妍,3057,361,15,0,15,100.0%,23m
7305,3,重复购买奶粉,3057,344,12,19,31,38.7%,9m
7305,3,喵喵学古风,3057,97,4,2,6,66.7%,1h
7305,3,jianguihao,3057,85,4,2,6,66.7%,7m
7305,1,黑灬红,3057,0,1,0,1,100.0%,15m
7305,1,[觀天習文]光陨,3057,0,1,1,2,50.0%,23m
7305,1,完颜兀术,3057,40,1,4,5,20.0%,23m
7305,1,[洛丹伦的雨夜]Alan,3057,0,0,1,1,0.0%,37m
7305,1,[萌新总队]萌新,3057,0,0,1,1,0.0%,32m
7305,1,[妈个小鸡]菜鸡小戴,3057,0,0,1,1,0.0%,16m
7305,1,筱瑜,3057,0,0,2,2,0.0%,6m
7320,3,结束先生,3056,1593,202,192,394,51.3%,17m
7320,3,添溢,3056,1482,130,134,264,49.2%,26m
7320,3,钵钵鸡,3056,841,34,32,66,51.5%,14m
7320,1,[衡水中学]Shadow,3056,281,10,7,17,58.8%,23m
7320,3,别碰爷的小熊,3056,273,10,10,20,50.0%,13m
7320,3,Ayane,3056,204,7,6,13,53.8%,18m
7320,1,[又没气啦]Brave,3056,250,7,6,13,53.8%,10m
7320,1,[NUC]IIIIIIIIIIII,3056,120,4,3,7,57.1%,30m
7320,1,bOor,3056,112,4,6,10,40.0%,26m
7320,3,Egoist,3056,120,4,13,17,23.5%,17m
7320,1,[李培楠NB]寰宇彼方,3056,78,2,2,4,50.0%,5m
7320,2,[CSTGD]一秦仙一,3056,0,1,0,1,100.0%,30m
7320,1,最爱司马,3056,34,1,1,2,50.0%,17m
7320,3,[GaHo]nihao,3056,0,0,5,5,0.0%,22m
7334,3,[ZJoU]Anastasia,3055,1273,76,76,152,50.0%,26m
7334,3,Ddmz,3055,1342,73,72,145,50.3%,22m
7334,3,llllllllllll,3055,301,19,22,41,46.3%,2m
7334,3,暴雪爷爷,3055,534,19,24,43,44.2%,19m
7334,3,[越南洗剪吹]啊灰,3055,262,7,11,18,38.9%,8m
7334,3,[刺蛇互助社团]水晶系,3055,143,4,2,6,66.7%,16m
7334,2,Ayden,3055,97,4,3,7,57.1%,1h
7334,1,TIME,3055,42,2,1,3,66.7%,5m
7334,1,Novear,3055,80,2,3,5,40.0%,5m
7334,1,卖女孩的小火柴,3055,78,2,4,6,33.3%,3m
7334,1,LoaF,3055,40,1,1,2,50.0%,22m
7334,1,[宇宙说你皮]宇宙之梦,3055,0,0,1,1,0.0%,22m
7334,1,阿仁科老师傅,3055,0,0,1,1,0.0%,30m
7334,3,常威不会武功,3055,0,0,1,1,0.0%,14m
7348,1,镜影,3054,1498,122,103,225,54.2%,22m
7348,1,人民的名义,3054,1729,84,82,166,50.6%,30m
7348,3,TIANYAKING,3054,1085,73,65,138,52.9%,23m
7348,1,玉川现食葱,3054,1262,53,38,91,58.2%,24m
7348,3,Ranger,3054,1075,44,39,83,53.0%,29m
7348,1,东瘟疫大蛆蛆,3054,875,35,29,64,54.7%,17m
7348,3,脱法摇滚,3054,487,23,17,40,57.5%,37m
7348,1,[网瘾主治医师]杨叔,3054,250,9,2,11,81.8%,27m
7348,3,MaGejiI,3054,97,4,2,6,66.7%,1h
7348,1,ROCKX,3054,0,3,2,5,60.0%,1h
7348,1,[辉光骑士团]机甲旋风,3054,78,3,3,6,50.0%,30m
7348,3,骨灰猎人,3054,97,2,0,2,100.0%,38m
7348,1,haha,3054,38,2,1,3,66.7%,18m
7348,3,VorAzUn,3054,36,2,6,8,25.0%,5m
7348,3,TimeTraveler,3054,0,1,0,1,100.0%,1h
7348,3,好好玩加油别放弃,3054,97,1,1,2,50.0%,1h
7348,1,[淮阴师范]Ricardo,3054,40,1,3,4,25.0%,2m
7348,2,magician,3054,0,0,1,1,0.0%,19m
7348,1,东方,3054,0,0,1,1,0.0%,32m
7348,2,[艾尔之主]罪恶的米,3054,0,0,2,2,0.0%,1h
7348,1,就这么容易,3054,0,0,2,2,0.0%,17m
7369,3,送那八个大,3053,464,19,18,37,51.4%,15m
7369,3,在遇见你一次也好,3053,146,10,6,16,62.5%,6m
7369,1,[Zero丿]小伙计,3053,260,10,7,17,58.8%,8m
7369,2,[鸽德]所罗门的疯狗,3053,121,6,2,8,75.0%,1h
7369,3,颜帝,3053,105,4,4,8,50.0%,30m
7369,1,Sonny,3053,0,3,2,5,60.0%,9m
7369,1,十三少灬,3053,0,1,1,2,50.0%,37m
7369,1,丸子,3053,0,0,1,1,0.0%,17m
7369,1,龙卷风,3053,0,0,1,1,0.0%,9m
7378,3,[TeamLP]医生姐姐来了,3052,1024,105,100,205,51.2%,35m
7378,1,爱喝雪碧的灰,3052,800,31,25,56,55.4%,22m
7378,3,[MxXW]阿瑞斯之灵,3052,289,31,26,57,54.4%,18m
7378,3,叶叶叶叶,3052,299,12,8,20,60.0%,10m
7378,3,IlIlllIlIllI,3052,233,9,8,17,52.9%,16m
7378,2,[虞城星际]我就是逗,3052,164,7,4,11,63.6%,35m
7378,1,data,3052,38,2,2,4,50.0%,32m
7378,1,Fumino,3052,0,2,3,5,40.0%,9m
7378,1,Komecnli,3052,0,2,7,9,22.2%,1h
7378,3,[CNboys]茫然,3052,60,2,7,9,22.2%,27m
7378,1,[CPT]混元星际门的喽啰,3052,42,1,3,4,25.0%,16m
7378,1,INnoVation,3052,0,0,1,1,0.0%,7m
7378,3,[萌新大队]肉蛋葱鸡乄,3052,0,0,3,3,0.0%,2m
7391,3,GGKING,3051,1600,102,101,203,50.2%,26m
7391,3,她说五十一级爱我,3051,222,30,19,49,61.2%,33m
7391,1,landmine,3051,514,18,14,32,56.2%,33m
7391,1,凛冬,3051,441,14,9,23,60.9%,17m
7391,1,[星际把妹王]我永远单推鲨鲨,3051,325,10,6,16,62.5%,33m
7391,3,Demon,3051,220,8,13,21,38.1%,15m
7391,2,Mrdu,3051,80,6,4,10,60.0%,1h
7391,1,[青铜树]飞龙,3051,122,4,2,6,66.7%,29m
7391,3,[燕大SC]冈田麿里之钉,3051,114,4,9,13,30.8%,20m
7391,2,MarineOppa,3051,0,1,0,1,100.0%,20m
7391,1,[狗不理战队]SKTinzkuku,3051,0,1,1,2,50.0%,18m
7391,1,[上地主]撒哈拉的星空,3051,0,1,3,4,25.0%,2m
7391,3,Sky,3051,6,1,7,8,12.5%,31m
7391,1,小油门,3051,0,0,1,1,0.0%,17m
7391,1,[银河喵波隆]Batista,3051,0,0,1,1,0.0%,16m
7406,3,circle,3050,1372,144,124,268,53.7%,19m
7406,3,KAKINE,3050,810,34,37,71,47.9%,6m
7406,1,Erosion,3050,227,10,7,17,58.8%,34m
7406,3,sun,3050,284,9,10,19,47.4%,38m
7406,3,小弟归来了,3050,141,8,11,19,42.1%,34m
7406,1,Lsz,3050,104,4,3,7,57.1%,15m
7406,1,[blabla]阿九,3050,38,2,2,4,50.0%,33m
7406,1,小航狙击你的心,3050,92,2,6,8,25.0%,1h
7406,1,梵天,3050,40,1,2,3,33.3%,26m
7406,1,[6G芯片研發]桐人水门,3050,0,0,1,1,0.0%,6m
7406,1,Mooooop,3050,0,0,1,1,0.0%,9m
7417,3,[龙语冰川]龙语者冰兰,3049,1566,233,226,459,50.8%,2m
7417,3,moonfan,3049,1503,168,144,312,53.8%,25m
7417,3,dkrtt,3049,1259,141,135,276,51.1%,17m
7417,1,[瑞兽]汐山凉音我老婆,3049,909,56,32,88,63.6%,19m
7417,1,[玄武堂]taq,3049,742,24,22,46,52.2%,2m
7417,1,[KPG2]woailaopo,3049,388,16,9,25,64.0%,24m
7417,3,Marklope,3049,149,15,13,28,53.6%,23m
7417,1,[一束七粉丝团]哥本含根,3049,240,10,6,16,62.5%,34m
7417,3,DIA,3049,252,9,6,15,60.0%,13m
7417,1,[暴雪二十七队]两仪天落,3049,300,8,8,16,50.0%,16m
7417,1,[lxh123]往事已然苍老,3049,180,6,4,10,60.0%,6m
7417,1,[123432]鬼车,3049,137,4,2,6,66.7%,32m
7417,3,宋兔子,3049,0,4,2,6,66.7%,54m
7417,1,[大宇恩]Doomsday,3049,36,2,2,4,50.0%,33m
7417,1,麻辣小龙虾,3049,80,2,3,5,40.0%,19m
7417,1,FenGX,3049,89,2,4,6,33.3%,2m
7417,1,陌南尘,3049,0,1,0,1,100.0%,2m
7417,1,Kundera,3049,0,0,1,1,0.0%,17m
7417,1,[幽冥之狼]峰哥,3049,0,0,2,2,0.0%,10m
7436,1,[星际茶馆]我与微风皆过客丶,3048,1617,304,270,574,53.0%,37m
7436,1,[五月花]潇洒哥大战黑大帅,3048,1377,88,67,155,56.8%,2m
7436,1,瑞星星星,3048,1302,54,41,95,56.8%,30m
7436,1,[LTY]comL,3048,1457,53,50,103,51.5%,34m
7436,3,[一二三二一]妖叶,3048,331,16,11,27,59.3%,2m
7436,1,凌天,3048,238,8,6,14,57.1%,25m
7436,1,allllllllen,3048,120,4,5,9,44.4%,3m
7436,1,[唯爱泰尼]浅唱似水柔情,3048,0,3,0,3,100.0%,51m
7436,1,Pairous,3048,0,1,0,1,100.0%,17m
7436,1,Placeb,3048,0,0,1,1,0.0%,10m
7436,1,鸡儿炸了,3048,0,0,1,1,0.0%,6m
7436,1,千羽,3048,0,0,1,1,0.0%,33m
7448,3,羽灵念,3047,338,11,12,23,47.8%,10m
7448,3,[青铜树]coyotes,3047,272,9,16,25,36.0%,17m
7448,1,油豆腐塞肉,3047,226,7,7,14,50.0%,17m
7448,1,bomber,3047,231,6,4,10,60.0%,26m
7448,1,[华弟是巴子]Johnny,3047,154,5,3,8,62.5%,30m
7448,3,reverofniw,3047,165,5,4,9,55.6%,1h
7448,3,Boss,3047,97,4,3,7,57.1%,1h
7448,1,Ancr,3047,76,2,4,6,33.3%,9m
7448,3,xiao,3047,97,1,1,2,50.0%,3m
7448,1,[Faith]当然是选择原谅她,3047,0,0,2,2,0.0%,33m
7458,3,[嘤嘤嘤呜呜]IIIIIIIIIIII,3046,969,150,139,289,51.9%,14m
7458,1,苏豪,3046,1492,137,132,269,50.9%,3m
7458,1,sage,3046,209,7,6,13,53.8%,2m
7458,1,[充气团]IIIIIIIIII,3046,198,4,2,6,66.7%,17m
7458,1,再见前任,3046,102,2,2,4,50.0%,2m
7458,1,[孤影]这个士兵有点菜,3046,0,1,7,8,12.5%,1h
7458,1,[小鸟游十花]白泽,3046,0,0,1,1,0.0%,33m
7458,1,繁华落尽倾城泪,3046,0,0,3,3,0.0%,9m
7466,2,[今晚谁是鸡]帕帕奇诺,3045,1535,194,214,408,47.5%,14m
7466,1,[新手电脑粋]迷亭,3045,918,62,53,115,53.9%,27m
7466,3,铁板鱿鱼,3045,1230,50,44,94,53.2%,20m
7466,1,令人发笑的电脑,3045,862,28,32,60,46.7%,26m
7466,3,BBOYK,3045,477,27,32,59,45.8%,34m
7466,3,鱼唇的偶逗逗,3045,145,6,3,9,66.7%,1h
7466,3,[3KDC]不二,3045,129,6,6,12,50.0%,9m
7466,3,钥石,3045,120,5,2,7,71.4%,1h
7466,1,sosh,3045,202,5,6,11,45.5%,1h
7466,1,永远,3045,0,3,2,5,60.0%,41m
7466,1,肯爱千金轻一笑,3045,112,3,2,5,60.0%,17m
7466,2,[小霸王學習機]灰太狼,3045,93,2,0,2,100.0%,1h
7466,1,三司绫濑,3045,80,2,4,6,33.3%,30m
7466,1,莫里亚蒂,3045,0,1,0,1,100.0%,1h
7466,3,ccTV,3045,0,1,5,6,16.7%,6m
7466,1,Sunday,3045,0,0,3,3,0.0%,6m
7466,1,我要上三千分,3045,0,0,3,3,0.0%,24m
7483,2,[绝望星灵]沙皮你只鸡,3044,942,127,143,270,47.0%,13m
7483,3,[专治格种不服]devil,3044,886,70,73,143,49.0%,22m
7483,3,[极限菜鸟]ConstanTine,3044,1051,44,39,83,53.0%,5m
7483,1,呜呜呜我好菜啊,3044,576,23,15,38,60.5%,26m
7483,3,[WINED]快乐就完事了,3044,520,23,18,41,56.1%,34m
7483,3,[ATKs]IIIIIIIIIIII,3044,328,11,18,29,37.9%,23m
7483,1,lonelyTV,3044,324,9,9,18,50.0%,32m
7483,1,塞肉是暴雪爹,3044,242,6,3,9,66.7%,33m
7483,1,赫里内勒多,3044,185,5,2,7,71.4%,6m
7483,1,恐怖猎杀,3044,104,4,3,7,57.1%,26m
7483,1,撸子毁你宜生,3044,114,3,0,3,100.0%,8m
7483,1,[谁都打不赢]打铁还需自身硬,3044,78,2,1,3,66.7%,30m
7483,1,暗影卫队卡路迪亚,3044,0,1,0,1,100.0%,1h
7483,3,[小狐狸]电波波波酱嘤嘤嘤,3044,0,1,0,1,100.0%,1h
7483,1,珠穆朗玛,3044,0,0,2,2,0.0%,9m
7483,1,[吃原味麻酱]史诗之蛙,3044,73,0,3,3,0.0%,3m
7499,3,别让我看见神族,3043,530,102,90,192,53.1%,9m
7499,3,[菜有菜的道理]太湖虫王,3043,711,31,30,61,50.8%,14m
7499,1,[Accre]Tony,3043,365,17,11,28,60.7%,17m
7499,1,[櫻花莊]大帝集中营,3043,548,16,18,34,47.1%,18m
7499,1,我是菜鸡,3043,398,11,15,26,42.3%,33m
7499,2,慕容冷雪,3043,198,10,8,18,55.6%,34m
7499,1,[慕灬小冷]高级指挥官,3043,226,6,7,13,46.2%,30m
7499,1,[TG1]城市,3043,224,5,4,9,55.6%,2m
7499,1,南山亦谷,3043,122,3,4,7,42.9%,16m
7499,1,[暴雪十七队]黑暗之神,3043,0,1,0,1,100.0%,18m
7499,1,[残日星宿]大天使鱼,3043,0,1,1,2,50.0%,18m
7499,1,胖爷肥神,3043,44,1,2,3,33.3%,29m
7499,1,细羽纷飞,3043,0,1,5,6,16.7%,2m
7499,1,Damon,3043,0,0,1,1,0.0%,6m
7499,3,我们都曾灬,3043,0,0,1,1,0.0%,27m
7499,1,黑手寻梅,3043,0,0,1,1,0.0%,33m
7499,1,帅气的洋叔,3043,0,0,3,3,0.0%,16m
7516,3,hughes,3042,1166,43,47,90,47.8%,14m
7516,1,天枰丶浮一大白,3042,784,40,31,71,56.3%,26m
7516,3,一只大西瓜,3042,258,19,13,32,59.4%,25m
7516,3,[SoloAs]llllllllllll,3042,546,19,21,40,47.5%,17m
7516,3,IIIIIIIIII,3042,340,14,5,19,73.7%,11m
7516,1,[风涩]二十五夜,3042,259,8,5,13,61.5%,26m
7516,1,奥特曼,3042,196,8,8,16,50.0%,17m
7516,3,blackknife,3042,278,8,12,20,40.0%,30m
7516,1,[DDOS不凡]SharpBugs,3042,0,4,1,5,80.0%,27m
7516,1,[有好有坏]燃烧千本樱,3042,160,4,6,10,40.0%,9m
7516,2,烟雾怪,3042,0,1,0,1,100.0%,23m
7527,1,[KPG2]RyanSoong,3041,1551,66,61,127,52.0%,26m
7527,3,[四叶草]小小小棠芫,3041,1429,61,53,114,53.5%,14m
7527,3,[Flowex]这游戏没办法玩了,3041,1226,51,60,111,45.9%,21m
7527,1,包子,3041,624,30,27,57,52.6%,16m
7527,1,acczare,3041,654,21,19,40,52.5%,30m
7527,3,pornhubuser,3041,383,15,17,32,46.9%,9m
7527,3,[缘来是你]玖伍贰柒,3041,42,4,4,8,50.0%,9m
7527,1,瓜大侠,3041,204,4,6,10,40.0%,34m
7527,1,[肉鸡的饲养]mageji,3041,120,3,4,7,42.9%,19m
7527,2,破晓,3041,125,2,3,5,40.0%,5m
7527,1,[干死]对面的死妈玩意,3041,122,2,5,7,28.6%,32m
7538,3,hongbaba,3040,1576,120,123,243,49.4%,14m
7538,3,[天梯引路人]醪糟睡觉,3040,114,4,9,13,30.8%,22m
7538,1,龙神,3040,30,2,1,3,66.7%,17m
7538,3,Trap,3040,119,2,2,4,50.0%,36m
7538,1,OUKAMA,3040,0,0,1,1,0.0%,7m
7543,3,用机械化的是我儿,3039,1548,197,202,399,49.4%,14m
7543,3,[VirGo]云在青天,3039,1582,93,77,170,54.7%,29m
7543,1,redt,3039,560,22,17,39,56.4%,33m
7543,1,predator,3039,482,18,9,27,66.7%,25m
7543,1,杞人忧天丶,3039,278,14,3,17,82.4%,32m
7543,3,一只减肥牛,3039,254,11,9,20,55.0%,31m
7543,1,麦克柯里昂,3039,190,8,6,14,57.1%,1h
7543,1,[龍狗毒爆]IIIIIIIIIIII,3039,132,4,6,10,40.0%,24m
7543,2,ZEALOT,3039,102,3,1,4,75.0%,9m
7543,2,佛挡杀佛,3039,135,3,1,4,75.0%,1h
7543,1,[123猫猫]名词是名字,3039,90,2,0,2,100.0%,37m
7543,1,[星区总指挥部]十二渧,3039,0,1,1,2,50.0%,29m
7543,3,牛牛,3039,0,1,4,5,20.0%,28m
7556,1,大腿,3038,1674,114,113,227,50.2%,7m
7556,3,zbm,3038,1040,69,61,130,53.1%,14m
7556,3,[传说萌鸡团]Shaquille,3038,617,23,31,54,42.6%,20m
7556,1,[我心所向]light,3038,511,21,17,38,55.3%,30m
7556,3,ekinLxp,3038,361,15,15,30,50.0%,20m
7556,3,[ToGT]龙虾,3038,311,12,10,22,54.5%,11m
7556,1,挽秋才幸福,3038,159,8,6,14,57.1%,27m
7556,2,战歌氏族,3038,176,7,5,12,58.3%,1h
7556,1,[底特律KAR]Blinker,3038,110,2,3,5,40.0%,24m
7556,2,堡垒说得对,3038,95,1,3,4,25.0%,1h
7556,1,[神虫一家亲]孙一喵是我老婆,3038,0,0,1,1,0.0%,18m
7556,1,[小奏亲卫队]笼中将,3038,0,0,2,2,0.0%,18m
7568,1,save,3037,1404,53,48,101,52.5%,17m
7568,2,[中华军武堂]看戏王,3037,1114,36,59,95,37.9%,19m
7568,1,[四叶草]逆蝶,3037,807,33,25,58,56.9%,2m
7568,1,[同福客栈]mist,3037,203,17,8,25,68.0%,32m
7568,3,羚羊,3037,434,14,25,39,35.9%,38m
7568,2,Shanks,3037,108,8,8,16,50.0%,30m
7568,2,Romantic,3037,172,7,4,11,63.6%,23m
7568,1,[FDG后援团]王叭,3037,91,4,4,8,50.0%,24m
7568,1,Seraph,3037,48,2,0,2,100.0%,31m
7568,1,[SXG]Stray,3037,40,1,1,2,50.0%,19m
7568,3,[桥桥奇妙星际]我不做人了,3037,97,1,2,3,33.3%,1h
7568,1,护月者,3037,0,0,1,1,0.0%,1h
7568,1,[zergin]祈愿挚爱,3037,0,0,1,1,0.0%,30m
7568,1,VanNESS,3037,0,0,1,1,0.0%,32m
7582,3,[斜星连萌]章魚哥,3036,1278,43,59,102,42.2%,38m
7582,3,[Anticw]星际天涯,3036,490,30,22,52,57.7%,3m
7582,3,[星际争霸第一]夏夏最美,3036,318,12,12,24,50.0%,9m
7582,3,白给泰伦,3036,139,4,1,5,80.0%,18m
7582,1,lifelover,3036,80,2,5,7,28.6%,25m
7582,1,unknown,3036,0,1,0,1,100.0%,26m
7582,1,IIIIIIIIIIII,3036,40,1,3,4,25.0%,24m
7582,1,黎明,3036,0,0,1,1,0.0%,33m
7582,1,[抽风机]小聋瞎,3036,0,0,2,2,0.0%,34m
7591,1,我很菜轻点打,3035,1413,200,163,363,55.1%,17m
7591,1,[雾雨魔法森林]聊然,3035,1614,83,74,157,52.9%,22m
7591,3,[NKTJ]蟑螂舞女,3035,860,32,42,74,43.2%,21m
7591,1,[TPZTPZ]llllllllllll,3035,446,20,14,34,58.8%,33m
7591,3,[人族是我爹]HyperMes,3035,236,7,10,17,41.2%,17m
7591,3,[虫合虫合虫合]GuZIZB,3035,0,5,1,6,83.3%,1h
7591,3,高高,3035,145,4,4,8,50.0%,6m
7591,1,assa,3035,118,3,5,8,37.5%,15m
7591,1,[西伯利亚土豆]不想做废物,3035,112,3,5,8,37.5%,30m
7591,1,[Iknow]第五丶,3035,0,0,1,1,0.0%,5m
7591,3,桥打木鸟,3035,0,0,2,2,0.0%,17m
7602,1,陈十一来找人,3034,1224,84,66,150,56.0%,26m
7602,1,简单的电脑,3034,918,68,55,123,55.3%,34m
7602,2,吊比石头硬夫斯基,3034,1334,52,68,120,43.3%,22m
7602,1,旭日东升,3034,433,39,35,74,52.7%,2m
7602,1,[百万是狗]HbD,3034,97,3,1,4,75.0%,38m
7602,1,Chen,3034,40,2,2,4,50.0%,32m
7602,1,壮志小青年,3034,0,1,0,1,100.0%,10m
7602,2,禅智两字,3034,0,1,0,1,100.0%,1h
7602,3,[Months]July,3034,97,1,1,2,50.0%,1h
7602,1,第一秩序,3034,30,1,2,3,33.3%,2m
7602,1,[柠檬保护协会]EPICgaster,3034,0,0,1,1,0.0%,5m
7602,1,作草莓,3034,0,0,1,1,0.0%,2m
7614,1,牛宝宝要逆天,3033,520,45,26,71,63.4%,17m
7614,3,[Shawk]泰伦,3033,594,20,32,52,38.5%,4m
7614,3,[ETT]deadlycool,3033,538,19,30,49,38.8%,13m
7614,1,[巴啦啦小金刚]徐鼎丞,3033,152,4,6,10,40.0%,2m
7614,1,[紫槿]水泠,3033,0,0,1,1,0.0%,30m
7619,3,从没赢过,3032,1551,160,142,302,53.0%,6m
7619,1,老仙奶我被吊打,3032,1509,78,34,112,69.6%,18m
7619,1,woaicaiyue,3032,1713,70,62,132,53.0%,22m
7619,1,[艰难电脑]光羽,3032,779,27,24,51,52.9%,27m
7619,1,叉子骑牛烧火车,3032,310,9,11,20,45.0%,9m
7619,1,[Tgirl]放纵的青春,3032,0,3,3,6,50.0%,17m
7619,1,穆尧,3032,76,2,3,5,40.0%,15m
7619,1,玩失忆,3032,0,1,0,1,100.0%,9m
7619,1,[CnNami]阿萨德,3032,0,0,1,1,0.0%,30m
7628,1,DYc,3031,1671,86,80,166,51.8%,24m
7628,1,[IMRTS2]MarvinLuis,3031,1656,83,68,151,55.0%,17m
7628,3,[StyOne]SCPLAYER,3031,674,25,30,55,45.5%,25m
7628,3,[四叶草]这个凯子,3031,331,13,17,30,43.3%,5m
7628,1,[自由朝鲜]人间芭比郭德纲,3031,202,9,6,15,60.0%,33m
7628,1,loveOO,3031,165,4,2,6,66.7%,33m
7628,1,[专业丶团队]光明审判者,3031,74,3,1,4,75.0%,5m
7628,1,COldzera,3031,76,3,2,5,60.0%,10m
7628,2,灵梦的风语,3031,95,2,1,3,66.7%,1h
7628,1,[高调]小胡小胡麻将全胡,3031,42,1,2,3,33.3%,34m
7628,1,逃避,3031,44,1,3,4,25.0%,30m
7628,3,白衣夜歌行丶,3031,30,1,4,5,20.0%,9m
7628,1,hnbc,3031,0,0,1,1,0.0%,9m
7628,1,[死亡大河]Mycroft,3031,0,0,3,3,0.0%,3m
7642,3,[雷本]黎明之刃,3030,1404,79,75,154,51.3%,31m
7642,3,[谐莽狗偷稳奶]爱睡觉的橙子,3030,892,48,35,83,57.8%,17m
7642,1,骑驴大咖,3030,1157,43,35,78,55.1%,17m
7642,3,[星际最强亡者]萌新,3030,376,13,20,33,39.4%,33m
7642,1,[RyH]Sweetiey,3030,220,9,2,11,81.8%,17m
7642,1,[iN]路飞会飞,3030,244,8,6,14,57.1%,32m
7642,2,梦不断春水,3030,161,5,6,11,45.5%,26m
7642,1,wqwqwq,3030,97,4,2,6,66.7%,6m
7642,3,YaGues,3030,126,4,9,13,30.8%,36m
7642,2,初音未来,3030,117,3,1,4,75.0%,1h
7642,1,[孙红雷]把青春拿去喂鸡,3030,0,1,0,1,100.0%,22m
7642,1,nevver,3030,0,0,1,1,0.0%,33m
7642,1,superT,3030,0,0,1,1,0.0%,15m
7642,1,[鸡哥永远的神]上衫绘梨衣,3030,0,0,1,1,0.0%,7m
7642,1,湯音,3030,0,0,2,2,0.0%,9m
7642,1,[白玉楼庭师]水上浸透,3030,0,0,3,3,0.0%,18m
7642,1,HihI,3030,0,0,3,3,0.0%,1h
7659,3,幼稚园杀手,3029,1659,230,221,451,51.0%,4m
7659,1,HAPPIII,3029,1668,203,194,397,51.1%,2m
7659,3,[KPG2]小群群,3029,1292,155,141,296,52.4%,18m
7659,3,[月野兔]嗷嗷嗷的小仙女,3029,1638,123,120,243,50.6%,16m
7659,3,黑夜海贼鸥,3029,1354,121,115,236,51.3%,16m
7659,1,AWESOME,3029,774,94,72,166,56.6%,13m
7659,3,[Beauty]MAKEYC,3029,1019,71,65,136,52.2%,7m
7659,3,[信仰圣光指引]终极飞翔的权力,3029,1112,56,51,107,52.3%,17m
7659,3,挥剑只为红颜,3029,812,53,60,113,46.9%,29m
7659,1,姿势摆好了,3029,514,21,23,44,47.7%,22m
7659,3,俊英的天空,3029,524,21,23,44,47.7%,5m
7659,1,BlackFriday,3029,313,11,7,18,61.1%,1h
7659,1,Fallen,3029,202,5,4,9,55.6%,37m
7659,1,[国足救星]sunny,3029,0,4,1,5,80.0%,19m
7659,3,[Etd]鬼蝶,3029,97,4,3,7,57.1%,15m
7659,1,吴小迪,3029,0,1,0,1,100.0%,2m
7659,1,嘟吧哒,3029,42,1,2,3,33.3%,37m
7659,1,mikkkeyy,3029,42,1,5,6,16.7%,6m
7659,1,[内鬼]Shiki,3029,0,0,1,1,0.0%,2m
7678,2,LeGuoGo,3028,512,229,228,457,50.1%,15m
7678,1,IIIIIIIIIIII,3028,1660,100,96,196,51.0%,9m
7678,3,TZC,3028,1131,68,55,123,55.3%,12m
7678,1,Ignize,3028,731,32,20,52,61.5%,22m
7678,2,IIIIIIIIIIII,3028,272,9,5,14,64.3%,10m
7678,1,[艾尔之巅]唐糖塘溏瑭,3028,144,5,0,5,100.0%,27m
7678,1,南征北战,3028,0,5,0,5,100.0%,48m
7678,1,[猫耳千冬]沢旋,3028,158,4,7,11,36.4%,22m
7678,1,thefool,3028,82,3,4,7,42.9%,30m
7678,1,[纯路人]chb,3028,74,2,6,8,25.0%,24m
7678,3,李朝阳自豪,3028,0,1,0,1,100.0%,32m
7678,1,[SC2近卫军]璀璨,3028,38,1,3,4,25.0%,6m
7678,1,[浪啊浪]ttx,3028,38,1,4,5,20.0%,6m
7678,1,醉忆那年春,3028,42,1,6,7,14.3%,24m
7692,3,果橙,3027,955,47,42,89,52.8%,21m
7692,3,mydream,3027,805,39,45,84,46.4%,16m
7692,3,大番薯,3027,337,15,14,29,51.7%,34m
7692,1,Wcl,3027,0,4,1,5,80.0%,60m
7692,1,SBZR,3027,116,4,6,10,40.0%,22m
7692,1,Outsider,3027,80,2,6,8,25.0%,16m
7692,1,这欧文头,3027,48,1,1,2,50.0%,54m
7692,3,[TAPC]灬就是馋她身子,3027,0,0,1,1,0.0%,2m
7692,3,[不会散枪兵]艾泽尼亚特,3027,0,0,1,1,0.0%,6m
7692,1,开锁你得找我,3027,0,0,1,1,0.0%,10m
7702,1,金灯剑客,3026,896,31,28,59,52.5%,17m
7702,3,你要蛋蛋吗,3026,457,20,16,36,55.6%,19m
7702,1,[长夜将至]TrY,3026,97,4,2,6,66.7%,1h
7702,3,周爸爸,3026,0,3,3,6,50.0%,39m
7702,3,无敌的阿标,3026,131,3,7,10,30.0%,6m
7702,3,toybear,3026,30,2,5,7,28.6%,3m
7702,1,换家乐,3026,0,1,1,2,50.0%,46m
7702,3,很能顶,3026,0,1,5,6,16.7%,1h
7702,1,[真实大帝哦]清雨,3026,0,0,1,1,0.0%,18m
7711,1,俯瞰风景,3025,1589,71,69,140,50.7%,22m
7711,1,丢丢鱼,3025,1698,60,64,124,48.4%,2m
7711,1,丿翻山越岭丶,3025,1012,39,29,68,57.4%,26m
7711,1,RvAWayne,3025,824,34,30,64,53.1%,17m
7711,1,[鬼谷]星生,3025,793,31,22,53,58.5%,9m
7711,1,LULA,3025,647,27,18,45,60.0%,9m
7711,3,IIIIIIIIIIII,3025,388,14,13,27,51.9%,37m
7711,1,[H丶X丶D]快乐喵,3025,302,12,5,17,70.6%,6m
7711,1,路人甲,3025,284,11,6,17,64.7%,22m
7711,1,[汉堡FANS]求教怎么玩星际,3025,144,6,1,7,85.7%,1h
7711,1,眸杀丶,3025,0,4,1,5,80.0%,32m
7711,1,[叫我杰哥]野兽仙贝,3025,0,3,2,5,60.0%,48m
7711,1,[谐谐谐莽莽莽]跟我鲁迅有啥关系,3025,125,2,1,3,66.7%,30m
7711,1,[魔法少女小屋]命运神龙超级萌新,3025,0,1,0,1,100.0%,1h
7711,1,SuperShinHye,3025,0,0,1,1,0.0%,32m
7726,3,人族英霸,3024,1526,207,216,423,48.9%,34m
7726,3,无名,3024,743,125,118,243,51.4%,5m
7726,1,[缘起幻想乡]葛饰应为,3024,891,35,25,60,58.3%,37m
7726,1,[菜有菜的道理]求求你不要狗我,3024,252,9,9,18,50.0%,18m
7726,1,藤宫香织,3024,112,4,3,7,57.1%,25m
7726,1,[埃蒙饲养员]Awakener,3024,94,2,0,2,100.0%,1h
7726,1,[ZZZAKU]机巧武者八一八,3024,40,2,3,5,40.0%,2m
7726,1,[千杯酒酬知己]BlueSun,3024,0,2,3,5,40.0%,1h
7726,1,老阔疼,3024,0,1,1,2,50.0%,27m
7726,3,irgsgjs,3024,30,1,2,3,33.3%,11m
7726,1,电脑,3024,38,1,3,4,25.0%,16m
7726,1,[红魔馆侍卫]雾雨魔理沙,3024,0,0,1,1,0.0%,3m
7726,1,Drakfans,3024,0,0,1,1,0.0%,34m
7726,1,[SK]神月只会耍杂技,3024,0,0,1,1,0.0%,26m
7740,3,呢招对我冇用,3023,1489,262,270,532,49.2%,2m
7740,1,[旺旺战士]woolf,3023,1579,81,53,134,60.4%,9m
7740,1,Phinkself,3023,767,30,25,55,54.5%,24m
7740,1,[TIAD]bugz,3023,234,7,8,15,46.7%,6m
7740,3,马叉虫,3023,0,5,1,6,83.3%,1h
7740,3,Fantasy,3023,122,5,3,8,62.5%,1h
7740,1,[文韬武略]新兵伦伦,3023,74,5,4,9,55.6%,19m
7740,1,[YA]咚咚快递,3023,144,4,6,10,40.0%,18m
7740,1,宝钟玛琳,3023,0,3,2,5,60.0%,10m
7740,1,[VKR]选神族就赢不了,3023,112,3,4,7,42.9%,5m
7740,1,小怪兽的崛起,3023,40,2,1,3,66.7%,17m
7740,1,[大元师]吾义赴死,3023,115,2,2,4,50.0%,35m
7740,3,[C94941]信赖的竹马,3023,95,1,2,3,33.3%,38m
7753,3,帅与俊的化身,3022,1544,231,233,464,49.8%,34m
7753,3,[手残眼瞎瘾大]白门楼破产律师,3022,897,52,58,110,47.3%,17m
7753,1,瓦塔诺,3022,711,28,24,52,53.8%,34m
7753,1,[loveMM]IIIIIIIIIIII,3022,450,17,15,32,53.1%,9m
7753,3,[CPT]竹礼薰,3022,292,11,13,24,45.8%,3m
7753,1,电脑训练模式,3022,270,10,5,15,66.7%,17m
7753,1,梦忆居士,3022,140,6,6,12,50.0%,27m
7753,3,[星辰陨落]青鸟尾戒,3022,121,5,3,8,62.5%,9m
7753,2,葫芦小金刚,3022,120,5,4,9,55.6%,10m
7753,1,艾尔之光,3022,114,2,1,3,66.7%,27m
7753,1,[Gabe]MagicRoy,3022,78,2,3,5,40.0%,30m
7753,1,[sc谐盟]小白,3022,0,0,1,1,0.0%,32m
7765,1,MoonMyth,3021,1620,380,376,756,50.3%,27m
7765,1,[麻雀]AragakiYui,3021,1186,94,81,175,53.7%,17m
7765,1,[若来世生为z]智慧神,3021,522,26,19,45,57.8%,30m
7765,3,我叫大水年,3021,129,11,7,18,61.1%,35m
7765,3,像羊树,3021,316,11,17,28,39.3%,3m
7765,1,HTvsDLvsMJY,3021,356,10,7,17,58.8%,37m
7765,2,天狼,3021,223,8,5,13,61.5%,35m
7765,3,只喝特仑苏,3021,181,7,4,11,63.6%,54m
7765,1,[键盘在冒奶]灰烬使者,3021,154,4,1,5,80.0%,26m
7765,1,[丿Es灬回忆]周大侠,3021,0,1,0,1,100.0%,32m
7765,1,woqu,3021,0,1,0,1,100.0%,25m
7765,3,[盛先生粉丝团]求老仙奶诺不开心,3021,42,1,2,3,33.3%,1h
7765,1,[小鸡屠宰场3]一柱擎天,3021,0,0,1,1,0.0%,16m
7765,1,[BWP]银翼空灵,3021,0,0,2,2,0.0%,33m
7779,2,[Beasty]禅虫,3020,1130,277,280,557,49.7%,8m
7779,1,暗影之刃,3020,1578,258,239,497,51.9%,33m
7779,1,放开我队友冲我来,3020,1622,113,90,203,55.7%,26m
7779,3,凝聚,3020,684,82,74,156,52.6%,21m
7779,1,Uncleju,3020,1276,53,44,97,54.6%,24m
7779,3,[正常人]毒光,3020,423,41,36,77,53.2%,11m
7779,1,[三族同萌会]魔法少年郭冬临,3020,755,30,29,59,50.8%,22m
7779,1,[Solo]SoloEmyth,3020,304,10,6,16,62.5%,22m
7779,1,星际指挥官,3020,314,10,6,16,62.5%,10m
7779,1,shenxin,3020,248,8,8,16,50.0%,2m
7779,3,[马辉没有马]phoenix,3020,164,7,3,10,70.0%,1h
7779,1,IIIIIIIIIIII,3020,116,5,3,8,62.5%,6m
7779,1,[愿如月照雪]寥寥若晨星,3020,112,4,7,11,36.4%,16m
7779,3,天使,3020,128,4,12,16,25.0%,25m
7779,1,XSGing,3020,146,3,6,9,33.3%,18m
7779,1,临渊羡鱼,3020,38,2,0,2,100.0%,13m
7779,1,几千里,3020,0,1,0,1,100.0%,10m
7779,1,[kirara]DreDiki,3020,0,1,0,1,100.0%,34m
7779,1,ByuN,3020,0,1,0,1,100.0%,18m
7779,1,超仔芬多,3020,0,1,0,1,100.0%,33m
7779,1,[Etern谐]Tristenking,3020,0,1,0,1,100.0%,26m
7779,1,喧嚣骸骨,3020,0,0,1,1,0.0%,3m
7779,1,Premise,3020,0,0,2,2,0.0%,1h
7779,1,SepeSusi,3020,0,0,3,3,0.0%,18m
7803,3,Sosha,3019,734,65,72,137,47.4%,33m
7803,3,[APM50]汪汪,3019,857,33,30,63,52.4%,24m
7803,1,[Anno]荔枝无敌,3019,817,31,23,54,57.4%,30m
7803,1,NOe,3019,259,11,9,20,55.0%,2m
7803,3,陈林,3019,234,8,8,16,50.0%,17m
7803,1,Style,3019,162,5,8,13,38.5%,33m
7803,1,[黎椛夜暮]liszt,3019,120,4,0,4,100.0%,26m
7803,1,埃蒙打得针不戳,3019,0,3,2,5,60.0%,48m
7803,1,akira,3019,89,2,0,2,100.0%,19m
7803,1,[无形白给]小小雷神,3019,0,1,0,1,100.0%,32m
7803,1,[蓝蓝路]MrWhiteWolF,3019,0,1,0,1,100.0%,27m
7803,1,[NS]单刷女宿舍,3019,0,0,1,1,0.0%,30m
7803,1,[SoyE]SoyEee,3019,0,0,1,1,0.0%,3m
7803,1,FlanDRe,3019,0,0,2,2,0.0%,24m
7803,2,青山慕雪,3019,0,0,3,3,0.0%,39m
7818,3,[Edge]蔚蓝之翼,3018,1154,236,222,458,51.5%,17m
7818,3,神的烦恼,3018,1545,185,179,364,50.8%,19m
7818,1,SCPLAYER,3018,1524,90,69,159,56.6%,9m
7818,1,[干翻机械化]基本无敌,3018,942,66,55,121,54.5%,5m
7818,3,史瓦西半径,3018,1226,44,51,95,46.3%,4m
7818,3,[AOT]诸神之黄昏,3018,702,27,30,57,47.4%,30m
7818,1,[巨龙降临]YMYM,3018,544,24,18,42,57.1%,10m
7818,3,塔木德,3018,592,23,27,50,46.0%,22m
7818,1,zzz,3018,267,13,4,17,76.5%,27m
7818,3,吃鸡孙一峰,3018,264,11,9,20,55.0%,18m
7818,1,术高莫用,3018,329,9,9,18,50.0%,33m
7818,3,[Biu哔]顺左能呼,3018,143,6,3,9,66.7%,39m
7818,1,ArroganceSC,3018,0,3,2,5,60.0%,60m
7818,1,小仓朝日,3018,102,3,5,8,37.5%,32m
7818,1,包子,3018,38,2,1,3,66.7%,22m
7818,2,[专业de团队]宗师王虫,3018,92,2,6,8,25.0%,38m
7818,3,王二,3018,64,2,14,16,12.5%,9m
7818,2,[撤回阴影中]昊夜,3018,0,0,1,1,0.0%,26m
7836,3,星际争霸,3017,1183,137,127,264,51.9%,33m
7836,3,[夜猫IIII]小狗一两只,3017,1145,102,86,188,54.3%,4m
7836,3,SPQR,3017,472,67,65,132,50.8%,38m
7836,3,jerrymo,3017,868,56,53,109,51.4%,9m
7836,1,Teardrop,3017,972,44,25,69,63.8%,26m
7836,3,GTVguangmo,3017,326,29,24,53,54.7%,6m
7836,1,[不想打内战]Nerazim,3017,473,15,11,26,57.7%,5m
7836,3,[东大电竞]windawn,3017,414,15,19,34,44.1%,8m
7836,1,LandisNL,3017,170,8,7,15,53.3%,56m
7836,1,[零度星际]EterNau,3017,248,7,11,18,38.9%,22m
7836,2,Sybmars,3017,121,5,6,11,45.5%,1h
7836,1,笨啦啦八级大狂风,3017,0,3,2,5,60.0%,1h
7836,1,尘埃之光,3017,88,2,0,2,100.0%,9m
7836,1,业界良心电竞毒奶,3017,38,2,2,4,50.0%,17m
7836,1,OoO,3017,40,2,3,5,40.0%,6m
7836,1,[途吉狂魔]凉薄少女梦,3017,38,2,3,5,40.0%,22m
7836,1,[浪啊浪]漂移后仰马桶投篮,3017,0,0,5,5,0.0%,24m
7853,1,fastlorde,3016,1644,130,113,243,53.5%,34m
7853,1,[萌萌拳]魔刹,3016,1690,104,90,194,53.6%,24m
7853,1,武汉刘德华,3016,1216,58,41,99,58.6%,37m
7853,1,一二三四五六七,3016,638,39,35,74,52.7%,17m
7853,1,两岸风景,3016,921,36,30,66,54.5%,32m
7853,1,一只海龟成功入水,3016,123,19,11,30,63.3%,3m
7853,1,卡了就行了,3016,384,18,8,26,69.2%,32m
7853,3,[vvww]死为鬼雄,3016,510,18,24,42,42.9%,9m
7853,3,暗月殇,3016,279,12,8,20,60.0%,23m
7853,1,野猫,3016,316,9,9,18,50.0%,33m
7853,1,休息一下,3016,213,8,8,16,50.0%,36m
7853,1,[梁上君子]子弹划过红玫瑰,3016,119,3,1,4,75.0%,26m
7853,1,北念,3016,150,3,2,5,60.0%,7m
7853,1,JackiePen,3016,0,3,2,5,60.0%,1h
7853,1,彭州陈奕迅,3016,108,3,5,8,37.5%,26m
7853,1,Funeral,3016,40,2,1,3,66.7%,17m
7853,1,[南京工业大学]小裤头,3016,0,1,0,1,100.0%,34m
7853,1,哀伤止战,3016,0,0,3,3,0.0%,26m
7871,1,随便玩玩,3015,1487,73,66,139,52.5%,16m
7871,1,Iisasb,3015,1072,48,41,89,53.9%,24m
7871,1,[土著神]泄矢诹访子,3015,699,34,22,56,60.7%,9m
7871,1,IIIIIIIIIIII,3015,308,9,9,18,50.0%,9m
7871,1,[TeamGB]RainDrop,3015,0,4,1,5,80.0%,1h
7871,1,深睡的方解石,3015,0,3,2,5,60.0%,38m
7871,1,[FF2f1A]你的当当,3015,0,1,0,1,100.0%,58m
7878,1,maoku,3014,1682,156,124,280,55.7%,18m
7878,1,alisterking,3014,871,50,45,95,52.6%,16m
7878,1,magiczero,3014,905,39,28,67,58.2%,26m
7878,1,Fairygirl,3014,324,10,9,19,52.6%,30m
7878,3,FXF,3014,294,9,13,22,40.9%,8m
7878,1,[白银联盟]象屿,3014,276,8,9,17,47.1%,22m
7878,1,天歌,3014,185,7,2,9,77.8%,34m
7878,1,[喜欢自定义]聖韻,3014,173,7,4,11,63.6%,13m
7878,1,我永远喜欢上学酱,3014,96,2,1,3,66.7%,33m
7878,3,ziluojs,3014,0,1,0,1,100.0%,24m
7878,1,[此处乃虎牢关]我爱欧依士,3014,0,1,1,2,50.0%,16m
7878,1,rainymonn,3014,0,0,1,1,0.0%,9m
7878,1,[孙一喵]oldblack,3014,0,0,1,1,0.0%,1h
7891,1,安稳,3013,786,34,21,55,61.8%,9m
7891,3,Star,3013,469,23,31,54,42.6%,10m
7891,3,陆羽,3013,264,11,10,21,52.4%,20m
7891,3,不二阿,3013,301,11,11,22,50.0%,20m
7891,3,神罚为了谁,3013,179,10,17,27,37.0%,33m
7891,1,[Hist]猫儿哟,3013,217,8,5,13,61.5%,17m
7891,2,[Sc养老]残心,3013,248,8,9,17,47.1%,4m
7891,1,[刺蛇互助社团]白之契约,3013,132,7,7,14,50.0%,7m
7891,3,roo,3013,30,4,4,8,50.0%,31m
7891,3,绝风帝国,3013,149,4,6,10,40.0%,30m
7891,1,[星际2虫族吧]Printa,3013,80,3,2,5,60.0%,18m
7891,1,[舰队训练营]wgg,3013,0,3,2,5,60.0%,1h
7891,3,[星2一群狗]虚空湮灭,3013,144,3,7,10,30.0%,34m
7891,1,[PGSG]heheda,3013,42,2,3,5,40.0%,19m
7891,1,Marineking,3013,92,1,1,2,50.0%,33m
7891,1,[瘾大眼瞎]宅宅萝卜,3013,89,1,1,2,50.0%,26m
7891,1,VIEN,3013,0,0,1,1,0.0%,1h
7908,3,[五庄观]镇元子,3012,1559,155,144,299,51.8%,38m
7908,3,[小伞保护协会]Khyal,3012,1593,70,72,142,49.3%,37m
7908,3,灭梦神,3012,796,30,31,61,49.2%,12m
7908,1,MPTMFZ,3012,304,23,16,39,59.0%,33m
7908,2,这就是无敌航母么,3012,264,9,6,15,60.0%,44m
7908,1,绝不投降法兰西,3012,340,9,9,18,50.0%,13m
7908,3,Agoni,3012,145,6,3,9,66.7%,17m
7908,1,[一起多人运动]我梦,3012,192,6,5,11,54.5%,18m
7908,3,青冥紫幽,3012,184,6,17,23,26.1%,35m
7908,1,Friday,3012,97,4,2,6,66.7%,1h
7908,1,longCC,3012,74,3,2,5,60.0%,10m
7908,1,juweigg,3012,89,2,0,2,100.0%,34m
7908,1,八级大狂风,3012,90,2,0,2,100.0%,3m
7908,3,IIIIIIIIIIII,3012,60,2,8,10,20.0%,36m
7908,1,Masaou,3012,0,1,2,3,33.3%,5m
7908,1,天命,3012,0,1,3,4,25.0%,17m
7908,2,孤月,3012,95,1,3,4,25.0%,1h
7925,3,IIIIIIIIIIII,3011,1610,95,99,194,49.0%,4m
7925,1,[手撕鸡]TaKaShi,3011,646,30,17,47,63.8%,22m
7925,1,[广龙日天]IMRealTaeja,3011,779,29,26,55,52.7%,5m
7925,1,[SoloAs]冰枫,3011,734,25,21,46,54.3%,9m
7925,1,战神之林登万,3011,591,21,15,36,58.3%,9m
7925,1,落花流水春去也,3011,482,20,14,34,58.8%,26m
7925,1,冲进白宫,3011,598,19,18,37,51.4%,26m
7925,1,[一块晶化瓦斯]西野七濑,3011,420,18,10,28,64.3%,18m
7925,3,闪电,3011,418,17,17,34,50.0%,14m
7925,3,watch,3011,304,13,8,21,61.9%,31m
7925,3,曰了个五河琴里,3011,233,12,9,21,57.1%,4m
7925,1,min,3011,360,11,8,19,57.9%,5m
7925,1,[向程序员致敬]lumos,3011,261,10,7,17,58.8%,24m
7925,3,[物探]星殒之殇,3011,165,8,1,9,88.9%,1h
7925,1,[黑白猫]白给虫王,3011,255,8,4,12,66.7%,26m
7925,1,Momoko,3011,201,7,9,16,43.8%,16m
7925,1,[Rhusky]IOIO,3011,160,6,2,8,75.0%,33m
7925,3,电脑不好会闪退,3011,80,6,4,10,60.0%,1h
7925,2,Arteezy,3011,163,6,6,12,50.0%,33m
7925,1,自古法师多近战,3011,174,5,6,11,45.5%,33m
7925,1,世勋,3011,0,3,2,5,60.0%,1h
7925,1,孙若晨,3011,0,3,2,5,60.0%,1h
7925,2,[四世三公]ggbobn,3011,92,1,1,2,50.0%,3m
7925,1,明轩亦梦,3011,0,1,1,2,50.0%,33m
7925,1,[主播大全]Fansankesi,3011,0,0,1,1,0.0%,17m
7950,1,月楼,3010,942,147,133,280,52.5%,9m
7950,3,[LOHv]海洋,3010,1481,104,104,208,50.0%,8m
7950,3,[华夏远征军]zeratul,3010,304,15,18,33,45.5%,13m
7950,1,[社交学导教]青椒炒巧克力,3010,290,8,10,18,44.4%,30m
7950,1,[TCP]西湖雅座有请,3010,144,5,8,13,38.5%,17m
7950,1,ZzzXxxLll,3010,0,4,1,5,80.0%,16m
7950,1,无心不灭,3010,0,3,2,5,60.0%,1h
7950,1,lkk,3010,65,2,3,5,40.0%,22m
7950,1,[CIE]迪奥,3010,40,2,4,6,33.3%,3m
7950,1,成王败寇,3010,0,1,0,1,100.0%,5m
7950,1,llllllllllll,3010,0,1,0,1,100.0%,18m
7950,1,秒退狗死全家,3010,0,0,1,1,0.0%,10m
7962,1,梦总是那么美,3009,1455,135,123,258,52.3%,13m
7962,1,[色格脖]罗德,3009,677,29,20,49,59.2%,5m
7962,1,柠檬心晴,3009,641,24,16,40,60.0%,17m
7962,3,ReMa,3009,523,21,22,43,48.8%,31m
7962,3,[XXHZN1]虚空之灵,3009,169,17,18,35,48.6%,37m
7962,1,真的是你,3009,362,13,11,24,54.2%,2m
7962,1,[Borne]IIIIIIIIIIII,3009,368,12,15,27,44.4%,22m
7962,1,Zerg,3009,273,9,11,20,45.0%,16m
7962,2,雪之下雪乃,3009,187,7,5,12,58.3%,1h
7962,1,[纸色茉莉]迭夜,3009,232,7,7,14,50.0%,17m
7962,1,[宇宙职业战队]Classical,3009,169,6,2,8,75.0%,26m
7962,1,[神之族]黑火,3009,225,6,5,11,54.5%,9m
7962,3,HYSwind,3009,121,5,3,8,62.5%,1h
7962,1,光滑滑,3009,0,3,2,5,60.0%,1h
7962,1,[dogeK]伊利丹,3009,0,3,2,5,60.0%,7m
7962,1,银白魔女,3009,0,1,0,1,100.0%,19m
7962,1,[二次元联盟军]IIIIIIIIIIII,3009,0,0,1,1,0.0%,30m
7962,1,[小仙女上线啦]年轻人不讲武德,3009,0,0,2,2,0.0%,32m
7962,1,yqx,3009,0,0,2,2,0.0%,22m
7962,1,沉默风暴,3009,0,0,2,2,0.0%,33m
7982,1,[CPT]喵喵爱恰小鱼干,3008,1689,128,102,230,55.7%,34m
7982,3,vdi,3008,1556,56,64,120,46.7%,5m
7982,3,[PhysRL]打星际你快乐吗,3008,877,44,45,89,49.4%,15m
7982,1,IIIIIIIIIIII,3008,568,42,32,74,56.8%,3m
7982,3,巨像能对空,3008,864,36,38,74,48.6%,37m
7982,1,[foryss]唐瓜点,3008,285,25,7,32,78.1%,19m
7982,1,虫族之王,3008,556,24,13,37,64.9%,17m
7982,1,玩星际学跳舞,3008,397,20,14,34,58.8%,7m
7982,3,[珈百璃的天堂]我爱樱岛麻衣学姐,3008,251,18,22,40,45.0%,3m
7982,1,这馒头没馅儿,3008,262,11,7,18,61.1%,34m
7982,1,德莉莎第一可爱,3008,246,9,6,15,60.0%,9m
7982,1,[12DBF]飞翔的板砖,3008,218,9,8,17,52.9%,5m
7982,1,静静,3008,201,7,7,14,50.0%,9m
7982,2,[UNAME]Lancelot,3008,95,5,3,8,62.5%,1h
7982,1,大鸡肉一二一三八,3008,188,5,6,11,45.5%,33m
7982,1,暴躁的裤子,3008,122,2,2,4,50.0%,9m
7982,1,[大刀队]故事里的小白菜,3008,38,1,2,3,33.3%,9m
7982,1,[tiandi]黑夜蓝瞳,3008,36,1,2,3,33.3%,8m
7982,1,萌新啊,3008,0,0,1,1,0.0%,6m
8001,1,门后有人,3007,1663,99,90,189,52.4%,9m
8001,1,[笑傲星球]SunDay,3007,1591,75,74,149,50.3%,5m
8001,1,Tycoris,3007,293,9,8,17,52.9%,27m
8001,1,[Beastp]fdhyluy,3007,228,8,8,16,50.0%,36m
8001,3,几回魂梦与君同,3007,97,4,3,7,57.1%,17m
8001,1,来过的路,3007,115,3,2,5,60.0%,6m
8001,1,忽远忽近的洒脱,3007,42,2,0,2,100.0%,1h
8001,1,JumpiAndroid,3007,102,2,1,3,66.7%,16m
8001,2,[大胸神族]男神灬不凡,3007,84,2,5,7,28.6%,48m
8001,3,[AI]Xelnaga,3007,64,2,14,16,12.5%,26m
8001,1,那棵树生气了,3007,0,1,0,1,100.0%,16m
8001,1,菜悔,3007,0,1,0,1,100.0%,26m
8001,1,[谐星联邦]我是巨魔他是狗,3007,0,0,2,2,0.0%,9m
8001,1,[LOD黎明]DayBreak,3007,0,0,2,2,0.0%,22m
8001,1,[Eason]我讯话筒在飞,3007,0,0,3,3,0.0%,22m
8016,1,ScarpeLQQ,3006,1721,161,141,302,53.3%,16m
8016,1,范尼是德鲁伊,3006,1018,107,87,194,55.2%,17m
8016,1,PZCS,3006,1694,101,102,203,49.8%,16m
8016,1,[雄心挥剑笔]源稚女,3006,951,38,31,69,55.1%,22m
8016,1,welldoom,3006,380,12,12,24,50.0%,17m
8016,1,不会玩星际,3006,267,8,7,15,53.3%,33m
8016,1,[B站君煌夜]弑神遗忘者,3006,97,5,1,6,83.3%,10m
8016,1,aaaaaaa,3006,147,5,2,7,71.4%,17m
8016,1,我的天,3006,132,4,3,7,57.1%,22m
8016,1,暖夏,3006,114,4,5,9,44.4%,26m
8016,1,[艾尔之名]Yolandale,3006,0,3,1,4,75.0%,1h
8016,1,fightero,3006,124,3,2,5,60.0%,37m
8016,1,[萌思课帝国]LikeSnowing,3006,122,3,4,7,42.9%,26m
8016,1,[星际旅游团]saligia,3006,152,3,4,7,42.9%,30m
8016,1,[洪元星际门]夜夜笙歌凉城梦,3006,0,1,0,1,100.0%,9m
8016,1,[极限战团]白给的阿米娅,3006,0,0,1,1,0.0%,26m
8016,1,萌新菜菜子,3006,0,0,1,1,0.0%,30m
8016,3,[谁在呼叫舰队]雨天思念,3006,0,0,2,2,0.0%,1h
8016,3,大叉马,3006,0,0,2,2,0.0%,27m
8035,3,[Mikon]宫本武藏,3005,1259,87,80,167,52.1%,37m
8035,1,alax,3005,1313,60,47,107,56.1%,18m
8035,3,[浪啊浪]野人王,3005,1058,40,45,85,47.1%,8m
8035,3,[DFL]肥炜,3005,664,31,34,65,47.7%,30m
8035,1,CarryteZero,3005,597,24,16,40,60.0%,10m
8035,1,[KPG]NCA,3005,286,18,4,22,81.8%,2m
8035,3,向天再借五厘米,3005,493,18,20,38,47.4%,4m
8035,1,Devotion,3005,413,11,13,24,45.8%,2m
8035,1,大白菜,3005,168,7,4,11,63.6%,10m
8035,1,[DDOS心跳]李陪楠说过会娶我,3005,120,6,7,13,46.2%,17m
8035,3,垃圾顺,3005,142,5,3,8,62.5%,6m
8035,2,[肉鸡的饲养]TYty,3005,120,5,5,10,50.0%,1h
8035,1,Chroma,3005,38,2,1,3,66.7%,5m
8035,1,[吕布FANS]不羡鸳鸯不羡仙,3005,0,1,0,1,100.0%,34m
8035,1,[Faith]落樱吹雪,3005,88,1,1,2,50.0%,33m
8035,1,骑着蜗牛追飞机,3005,88,1,1,2,50.0%,18m
8051,3,[暴雪三十二隊]Presents,3004,1504,151,139,290,52.1%,16m
8051,1,IIIIIIIIIIII,3004,366,43,35,78,55.1%,9m
8051,1,我没名字,3004,953,37,35,72,51.4%,8m
8051,1,矿物储量不族,3004,337,34,33,67,50.7%,3m
8051,1,暗鱼,3004,674,31,14,45,68.9%,22m
8051,3,您逗我,3004,230,9,11,20,45.0%,3m
8051,2,[Etern谐]墨色,3004,198,8,5,13,61.5%,1h
8051,1,[世纪之舟]拉普兰德,3004,157,8,7,15,53.3%,6m
8051,1,你挺胖啊,3004,213,7,6,13,53.8%,1h
8051,1,不死鸟,3004,70,3,2,5,60.0%,33m
8051,2,ReSlamDunk,3004,92,2,0,2,100.0%,45m
8051,3,Luluuuuuuu,3004,119,2,2,4,50.0%,23m
8051,1,[宇宙职业战队]Maru,3004,46,2,4,6,33.3%,1h
8051,1,FFFFFF,3004,0,1,2,3,33.3%,33m
8051,1,落尘,3004,40,1,5,6,16.7%,24m
8066,1,沙卡,3003,310,15,7,22,68.2%,17m
8066,1,蛋蛋的忧伤,3003,344,14,12,26,53.8%,37m
8066,1,[铁华团]蓬莱月夜,3003,395,13,11,24,54.2%,16m
8066,3,[玩个虫子]帅猫,3003,214,8,16,24,33.3%,21m
8066,1,[FIND]复活节也要蛋,3003,140,6,1,7,85.7%,2m
8066,1,千岛寒流,3003,90,6,5,11,54.5%,6m
8066,1,阿克苏大苹果,3003,152,5,2,7,71.4%,16m
8066,1,[九尾]mooncowboy,3003,142,5,5,10,50.0%,13m
8066,1,[暗夜王牌]周大爷,3003,134,5,6,11,45.5%,2m
8066,3,艾尔必将沦陷,3003,170,5,7,12,41.7%,19m
8066,1,[秋名山赛车组]AIXT,3003,48,3,3,6,50.0%,1h
8066,1,啊豆,3003,30,2,1,3,66.7%,5m
8066,1,scv,3003,0,1,0,1,100.0%,26m
8066,1,RGH,3003,0,0,1,1,0.0%,1h
8066,3,觉悟的新手,3003,0,0,1,1,0.0%,32m
8066,1,吉格,3003,0,0,1,1,0.0%,17m
8082,3,showtime,3002,928,77,61,138,55.8%,21m
8082,1,IIIIIIIIIIII,3002,411,13,13,26,50.0%,17m
8082,1,且听风起,3002,303,9,7,16,56.2%,18m
8082,1,终梦,3002,195,5,4,9,55.6%,3m
8082,1,[梦的第七章]蒂影,3002,180,5,4,9,55.6%,10m
8082,3,星耀九天,3002,8,5,11,16,31.2%,38m
8082,1,[请先打我隊友]laoshi,3002,102,3,2,5,60.0%,8m
8082,1,zerg,3002,38,2,1,3,66.7%,6m
8082,1,[随便玩]回忆,3002,95,2,3,5,40.0%,36m
8082,3,鱼和尚,3002,42,2,7,9,22.2%,1h
8082,1,日天库里,3002,0,1,0,1,100.0%,17m
8082,1,康斯坦汀,3002,0,1,0,1,100.0%,17m
8082,1,[龙在野]孤狼天,3002,89,1,1,2,50.0%,9m
8082,1,[桜公馆]magejiTerran,3002,0,1,1,2,50.0%,6m
8082,1,[NtS特工队]AiseYan,3002,0,0,1,1,0.0%,24m
8097,1,[妹控万岁]Asura,3001,1707,195,182,377,51.7%,10m
8097,1,SCfish,3001,1168,73,68,141,51.8%,24m
8097,1,[TPoA]Chtholly,3001,475,17,13,30,56.7%,37m
8097,3,[鸡猪]我就是死肥宅啊,3001,462,14,20,34,41.2%,23m
8097,1,[Mikon]仈月,3001,272,9,6,15,60.0%,16m
8097,3,不帅朝脸踹,3001,286,9,18,27,33.3%,19m
8097,1,小萌新,3001,180,5,7,12,41.7%,27m
8097,1,[Stein]凤凰院凶真,3001,116,3,6,9,33.3%,5m
8097,1,舒心雨,3001,90,2,1,3,66.7%,3m
8097,1,[Mai]大魔王大熊,3001,0,1,0,1,100.0%,7m
8097,1,BABYJACKEY,3001,0,1,0,1,100.0%,33m
8097,1,[Anticw]迷桐,3001,0,0,1,1,0.0%,8m
8097,1,lbns,3001,0,0,3,3,0.0%,10m
8110,3,IIIIIIIII,3000,1444,474,455,929,51.0%,30m
8110,1,[冲就完了]天涯明月刀,3000,1556,122,98,220,55.5%,27m
8110,1,Yufei,3000,834,97,81,178,54.5%,7m
8110,3,谐星耍星际,3000,1522,95,106,201,47.3%,23m
8110,1,chihiro,3000,537,23,21,44,52.3%,27m
8110,1,[星际争霸第一]blizzarnmsl,3000,582,18,16,34,52.9%,27m
8110,3,[透一下清酒]TsukiLAG,3000,386,13,21,34,38.2%,3m
8110,1,[刺蛇互助协会]WatuZhY,3000,236,12,1,13,92.3%,8m
8110,1,innnnnnocent,3000,234,9,9,18,50.0%,32m
8110,2,比利海林顿,3000,184,7,5,12,58.3%,35m
8110,1,[丨SLT丨]逐光,3000,160,6,3,9,66.7%,34m
8110,1,伊利蛮牛,3000,144,4,5,9,44.4%,9m
8110,1,简单,3000,0,3,2,5,60.0%,38m
8110,1,[VirGo]Shaco,3000,38,2,2,4,50.0%,22m
8110,1,龙睛,3000,0,1,3,4,25.0%,9m
8125,3,hoshgonen,2999,1208,244,224,468,52.1%,4m
8125,3,[超神给你看哦]Expecto,2999,1286,102,108,210,48.6%,26m
8125,3,疯狂搞事的小鸡,2999,486,57,54,111,51.4%,22m
8125,1,[德哈卡小分队]星际小菜鸡,2999,519,29,9,38,76.3%,27m
8125,1,白糖糖,2999,457,19,16,35,54.3%,30m
8125,3,没有对象的屠戮机,2999,228,8,14,22,36.4%,26m
8125,1,[Naz]lllllllllll,2999,108,4,5,9,44.4%,34m
8125,1,[MD2]SilveryGospe,2999,121,2,2,4,50.0%,24m
8125,1,李逍遥,2999,120,2,2,4,50.0%,9m
8125,1,[SC2近卫军]诡计,2999,124,2,3,5,40.0%,18m
8125,2,[TPZTPZ]神明,2999,116,2,5,7,28.6%,36m
8125,2,[肉鸡的饲养]TAISHOU,2999,0,1,0,1,100.0%,20m
8125,1,[XYFANS]ManUtd,2999,0,1,2,3,33.3%,30m
8125,2,包了个媛,2999,94,1,2,3,33.3%,58m
8139,1,LOVESTORY,2998,1376,173,154,327,52.9%,4m
8139,3,[梦之涯]IIIIIIIIIIII,2998,1430,113,106,219,51.6%,26m
8139,1,lengwuhuo,2998,1598,58,60,118,49.2%,4m
8139,1,xxxyyy,2998,1194,54,45,99,54.5%,32m
8139,1,南美尼哥内马尔,2998,302,10,9,19,52.6%,27m
8139,1,RagnaroK,2998,222,7,4,11,63.6%,27m
8139,1,想想塞肉会怎么做,2998,198,6,3,9,66.7%,18m
8139,3,丛羽,2998,97,4,3,7,57.1%,13m
8139,2,长命百岁苏沐秋,2998,32,2,0,2,100.0%,2m
8139,2,[大姐酒家]呆毛王,2998,30,2,0,2,100.0%,6m
8149,3,Letme,2997,1269,95,78,173,54.9%,8m
8149,1,斯托克夫中将,2997,689,70,53,123,56.9%,9m
8149,1,[不知不觉天亮]CoyZhiv,2997,323,23,12,35,65.7%,30m
8149,1,两只小蜜蜂,2997,150,4,2,6,66.7%,34m
8149,1,颖颖的病猫,2997,127,3,2,5,60.0%,5m
8149,2,爱吃小白兔的熊,2997,30,2,0,2,100.0%,38m
8149,1,omgCCC,2997,89,2,1,3,66.7%,24m
8149,3,[猪星人在地球]骚猪最萌,2997,133,2,2,4,50.0%,1h
8149,3,[冲就完了]卧枕盼星还,2997,0,1,0,1,100.0%,8m
8149,3,[龙骑舞尹志平]Nanny,2997,0,0,1,1,0.0%,3m
8149,2,黑色巫师,2997,0,0,1,1,0.0%,5m
8149,1,llllllllllll,2997,0,0,2,2,0.0%,33m
8149,1,shadow,2997,0,0,3,3,0.0%,33m
8162,1,allies,2996,416,155,118,273,56.8%,9m
8162,1,IIIIIIIIIIII,2996,340,83,69,152,54.6%,16m
8162,1,[summer]伏见老贼,2996,1622,58,59,117,49.6%,34m
8162,3,[LOHs]asdfiujhs,2996,612,52,44,96,54.2%,15m
8162,1,[净罪的殉仪]KousakaReina,2996,577,22,21,43,51.2%,24m
8162,2,溜溜球,2996,472,20,7,27,74.1%,13m
8162,1,moxuanX,2996,412,16,15,31,51.6%,34m
8162,1,GrimPigeon,2996,325,10,11,21,47.6%,9m
8162,3,[萌新萌萌哒]小太壹,2996,294,10,17,27,37.0%,15m
8162,3,[二层楼]梳碧湖砍柴人,2996,322,10,32,42,23.8%,7m
8162,1,萌新,2996,208,6,5,11,54.5%,51m
8162,3,[星际爱好者队]空白,2996,0,5,1,6,83.3%,13m
8162,1,探机,2996,177,5,4,9,55.6%,35m
8162,2,[妈个小鸡]Neptune,2996,82,4,0,4,100.0%,20m
8162,1,[麻酱罐]羽翼,2996,104,3,8,11,27.3%,30m
8162,2,efw,2996,78,2,3,5,40.0%,1h
8162,2,gansihxdqudg,2996,0,1,0,1,100.0%,11m
8162,2,Gforcens,2996,32,1,1,2,50.0%,10m
8162,2,master,2996,0,1,2,3,33.3%,11m
8162,1,lllllllllll,2996,38,1,4,5,20.0%,34m
8162,2,hal,2996,0,0,1,1,0.0%,25m
8162,2,大风起裙飞扬,2996,0,0,1,1,0.0%,13m
8162,1,[QWQa]清明上河图,2996,0,0,2,2,0.0%,3m
8162,1,[DMR]苍山有井名为空,2996,0,0,6,6,0.0%,33m
8186,3,老朴,2995,1306,135,135,270,50.0%,18m
8186,2,[暴雪我是你爹]张老瓜,2995,1245,112,135,247,45.3%,27m
8186,2,llllllllllll,2995,566,100,90,190,52.6%,31m
8186,3,[江上数峰青]石膏博士,2995,1493,59,56,115,51.3%,19m
8186,1,[XXHZ33]人菜瘾大,2995,407,12,17,29,41.4%,5m
8186,3,BBJ,2995,135,5,4,9,55.6%,17m
8186,1,skyTree,2995,48,4,3,7,57.1%,1h
8186,1,llllllllllll,2995,102,3,6,9,33.3%,17m
8186,2,wdzhuang,2995,38,1,1,2,50.0%,2m
8186,1,大坑,2995,90,1,2,3,33.3%,17m
8186,2,[大爱露娜樣]樱小路露娜,2995,0,0,1,1,0.0%,27m
8197,1,太空军校生,2994,1634,148,143,291,50.9%,27m
8197,1,不水船,2994,1631,90,77,167,53.9%,17m
8197,3,[社交学小可爱]Together,2994,1474,88,87,175,50.3%,12m
8197,3,Overmind,2994,1577,87,76,163,53.4%,4m
8197,1,[小金上天队]比利,2994,938,44,26,70,62.9%,33m
8197,1,中二五彩小王子,2994,998,41,31,72,56.9%,3m
8197,1,ODaNobuNaga,2994,1120,41,37,78,52.6%,32m
8197,3,缺爱的缺缺,2994,129,32,25,57,56.1%,34m
8197,3,lililililili,2994,751,30,36,66,45.5%,9m
8197,1,[BLaDe]一把大宝剑,2994,495,19,19,38,50.0%,3m
8197,1,[宇宙何平]wlitrun,2994,252,10,7,17,58.8%,27m
8197,2,碎纸机,2994,196,8,2,10,80.0%,3m
8197,1,[撒硕之王]秘制小汉堡,2994,146,7,10,17,41.2%,2m
8197,1,伏羲,2994,112,4,6,10,40.0%,7m
8197,1,农民,2994,94,3,5,8,37.5%,22m
8197,2,要鸭梨才有冻梨,2994,124,3,6,9,33.3%,20m
8197,2,kokodayo,2994,34,2,0,2,100.0%,11m
8197,2,被杀超鬼,2994,0,1,0,1,100.0%,35m
8197,2,[你单刷我躺啦]风间琉璃,2994,0,1,0,1,100.0%,16m
8197,1,[索尔特雷吉]竜胆尊尊尊尊,2994,0,1,4,5,20.0%,17m
8197,2,[快乐好基友]DARK,2994,0,0,1,1,0.0%,37m
8218,3,[虎捉急]颂灬,2993,1433,150,150,300,50.0%,36m
8218,1,人族无敵,2993,130,4,2,6,66.7%,27m
8218,2,wsh,2993,88,3,2,5,60.0%,35m
8218,1,mangzhong,2993,76,2,6,8,25.0%,16m
8218,2,[miku守护]蓝宗,2993,0,1,0,1,100.0%,11m
8218,3,[凛风]bala,2993,0,1,2,3,33.3%,7m
8218,2,Dark,2993,0,0,1,1,0.0%,21m
8225,3,洗钱,2992,1592,630,605,1235,51.0%,23m
8225,1,暴君,2992,1616,70,56,126,55.6%,27m
8225,1,[王富贵]王富贵二号,2992,96,4,4,8,50.0%,30m
8225,1,PLUfamely,2992,0,3,2,5,60.0%,41m
8225,1,[EoD]THDTJ,2992,0,3,2,5,60.0%,1h
8225,1,你掀起波澜,2992,106,3,6,9,33.3%,26m
8225,2,菊花侠,2992,32,2,0,2,100.0%,29m
8225,1,Gameking,2992,80,2,5,7,28.6%,34m
8225,2,[懒散]云瑶,2992,0,1,0,1,100.0%,33m
8225,3,常被绿,2992,0,0,1,1,0.0%,1h
8225,1,Joker,2992,0,0,2,2,0.0%,17m
8225,1,Anakin,2992,0,0,2,2,0.0%,7m
8237,2,[KPG2]Flash,2991,1358,53,64,117,45.3%,5m
8237,1,不吃猪的香菜,2991,907,34,26,60,56.7%,18m
8237,1,Zero,2991,518,16,17,33,48.5%,31m
8237,2,Balalalala,2991,258,9,4,13,69.2%,6m
8237,1,Geass,2991,282,9,11,20,45.0%,23m
8237,2,Bitxxxxxxch,2991,193,8,8,16,50.0%,15m
8237,1,帕拉瑞尔,2991,102,3,3,6,50.0%,17m
8237,1,[夏姬八莽]玩具人,2991,106,3,6,9,33.3%,7m
8237,2,llllllllllll,2991,58,2,1,3,66.7%,13m
8237,2,蝶舞星魂,2991,62,2,3,5,40.0%,12m
8237,2,Jessica,2991,0,1,0,1,100.0%,2m
8237,2,[TAPC]Nain,2991,0,1,0,1,100.0%,30m
8237,1,[Au丶Mus]llllllllll,2991,0,1,1,2,50.0%,36m
8237,2,[OTO]人间大炮,2991,0,1,1,2,50.0%,1h
8237,2,[虫群无穷无尽]虫群虫母,2991,32,1,1,2,50.0%,27m
8237,1,knight,2991,0,1,1,2,50.0%,18m
8237,2,[萌新教会]幻想乡,2991,0,0,1,1,0.0%,6m
8237,2,[一冰一火]嗦了又裹,2991,0,0,1,1,0.0%,26m
8237,2,MSIKLANTKnow,2991,0,0,1,1,0.0%,4m
8237,1,[SCLR]叶落归根,2991,0,0,2,2,0.0%,33m
8237,3,[Rhusky]伊藤失之咲,2991,0,0,2,2,0.0%,12m
8258,2,boy,2990,1484,216,233,449,48.1%,16m
8258,1,[CPT]yolime,2990,674,100,89,189,52.9%,13m
8258,1,MarK,2990,628,45,30,75,60.0%,7m
8258,1,名字太帅无法显示,2990,962,34,31,65,52.3%,34m
8258,3,[Mensa]guanboy,2990,956,34,46,80,42.5%,23m
8258,1,Snorlax,2990,770,32,30,62,51.6%,17m
8258,2,lIllllIIIIlI,2990,466,17,11,28,60.7%,13m
8258,3,[王者家族]异次元碎片,2990,422,16,20,36,44.4%,2m
8258,1,不如怀念,2990,274,15,12,27,55.6%,4m
8258,1,水轉雪中冰,2990,464,15,16,31,48.4%,5m
8258,2,sfp,2990,164,5,0,5,100.0%,35m
8258,3,过火丶,2990,0,4,2,6,66.7%,38m
8258,2,[建设白门楼]llllllllllll,2990,64,3,0,3,100.0%,11m
8258,1,BladeLord,2990,76,3,5,8,37.5%,34m
8258,2,快播徐,2990,34,2,0,2,100.0%,5m
8258,2,[黎明航向]王者的狗带,2990,0,1,0,1,100.0%,9m
8258,1,每天都想偷小孩,2990,0,1,1,2,50.0%,33m
8258,1,云之遥,2990,89,1,2,3,33.3%,27m
8258,1,HenryLight,2990,0,1,3,4,25.0%,10m
8258,2,[基金会]Bogus,2990,0,0,1,1,0.0%,16m
8258,2,BOBOY,2990,0,0,1,1,0.0%,11m
8258,2,路明非,2990,0,0,1,1,0.0%,27m
8258,1,戢殺司令,2990,0,0,1,1,0.0%,1h
8258,1,[ZJU]褪色年华,2990,0,0,2,2,0.0%,23m
8282,1,TifaTsubasa,2989,925,36,26,62,58.1%,5m
8282,2,五更琉璃,2989,212,32,58,90,35.6%,32m
8282,3,西游之路,2989,169,5,2,7,71.4%,47m
8282,2,[C06904]sky,2989,86,4,0,4,100.0%,35m
8282,3,李天七,2989,0,4,2,6,66.7%,15m
8282,1,肉肉,2989,138,4,7,11,36.4%,16m
8282,1,狂刀三浪,2989,0,3,2,5,60.0%,1h
8282,2,麻辣龙利鱼,2989,0,1,0,1,100.0%,13m
8282,1,消经疼,2989,0,1,1,2,50.0%,18m
8282,1,[致逝去的青春]光羽,2989,0,0,1,1,0.0%,46m
8282,1,[SLUK]文四爷,2989,0,0,5,5,0.0%,1h
8293,1,木吉铁平,2988,1645,305,278,583,52.3%,10m
8293,1,rogerlikeu,2988,312,166,152,318,52.2%,33m
8293,1,[我们是瞎子]老鼠特工,2988,1315,83,80,163,50.9%,5m
8293,1,evolee,2988,1284,81,64,145,55.9%,34m
8293,1,花钱日下死,2988,585,72,73,145,49.7%,30m
8293,3,TYTTY,2988,800,56,56,112,50.0%,20m
8293,1,癞蛤蟆,2988,948,40,25,65,61.5%,10m
8293,1,折折折折折,2988,853,39,21,60,65.0%,17m
8293,1,[谐星联盟]DBOY,2988,838,29,30,59,49.2%,19m
8293,1,[原谅兄弟会]不讲武德耗子尾汁,2988,489,27,8,35,77.1%,18m
8293,1,[3Ky]Rabbit,2988,218,14,11,25,56.0%,34m
8293,1,[社交学教练]蓝色血腥,2988,318,12,11,23,52.2%,30m
8293,1,曾经小坑刘冬雨,2988,329,12,13,25,48.0%,16m
8293,1,LDQ,2988,196,7,7,14,50.0%,24m
8293,2,[白手团]QTGcreed,2988,122,6,4,10,60.0%,1h
8293,2,夜魅丶寒,2988,100,4,3,7,57.1%,23m
8293,1,爆爆虫,2988,0,3,2,5,60.0%,1h
8293,2,十二的转大龙,2988,92,3,2,5,60.0%,2m
8293,2,Baco,2988,60,2,3,5,40.0%,15m
8293,2,致命袭击,2988,0,1,0,1,100.0%,26m
8293,1,梧叶飘黄,2988,36,1,4,5,20.0%,9m
8293,2,雪茄头,2988,0,0,1,1,0.0%,11m
8315,1,暗夜装逼者,2987,1234,255,248,503,50.7%,5m
8315,1,victor,2987,1164,194,182,376,51.6%,7m
8315,1,llOrzll,2987,672,89,80,169,52.7%,33m
8315,1,小丑,2987,879,34,31,65,52.3%,24m
8315,1,蟑螂不就很好嘛,2987,637,27,21,48,56.2%,9m
8315,1,[武大萌新]sagiri,2987,508,21,26,47,44.7%,16m
8315,3,[有手就行]海门罗志祥,2987,229,8,10,18,44.4%,4m
8315,3,llllllllllll,2987,209,7,5,12,58.3%,3m
8315,2,火羽无双,2987,117,6,4,10,60.0%,1h
8315,1,小草的燃烧,2987,179,4,4,8,50.0%,10m
8315,2,LuHua,2987,62,3,1,4,75.0%,29m
8315,1,[马辉没有马]参宿四爆炸了吗,2987,0,3,2,5,60.0%,20m
8315,1,[染年霜霜]梦本永远是我大哥,2987,138,3,3,6,50.0%,18m
8315,3,[Moeee]青梅吃茶,2987,97,2,1,3,66.7%,1h
8315,1,三千世界,2987,80,2,6,8,25.0%,22m
8315,1,CCFudsa,2987,42,1,4,5,20.0%,32m
8315,2,[AIMBA]orsahiabyss,2987,0,0,1,1,0.0%,35m
8315,1,NOGAMENOLIFE,2987,0,0,2,2,0.0%,27m
8333,1,[德国骨科]六月很忙,2986,353,19,9,28,67.9%,2m
8333,1,静听现实黯嗳,2986,428,18,13,31,58.1%,19m
8333,1,小科,2986,260,14,17,31,45.2%,23m
8333,2,Noah,2986,292,10,3,13,76.9%,23m
8333,2,[暴雪九队]bloodfe,2986,232,9,7,16,56.2%,20m
8333,1,[KK开]影舞灬涟,2986,144,5,6,11,45.5%,3m
8333,2,比比西斗二龙,2986,34,2,1,3,66.7%,5m
8333,1,HKBS,2986,38,2,2,4,50.0%,22m
8333,2,大神带带我,2986,0,1,0,1,100.0%,32m
8333,1,[巨魔之家]偷袭,2986,0,0,1,1,0.0%,1h
8343,3,御坂钢琴,2985,1506,177,170,347,51.0%,38m
8343,2,iiiiiiiiiiii,2985,1489,87,92,179,48.6%,15m
8343,3,[龙骑舞尹志平]鬼才,2985,1184,43,52,95,45.3%,12m
8343,1,普朗克叔叔,2985,576,34,30,64,53.1%,10m
8343,3,ASHA,2985,252,30,30,60,50.0%,26m
8343,3,[粉红公主]LambRazor,2985,541,24,18,42,57.1%,4m
8343,3,风中的火柴,2985,352,13,9,22,59.1%,18m
8343,1,解冻,2985,296,11,8,19,57.9%,10m
8343,3,tong,2985,210,9,8,17,52.9%,2m
8343,1,随便玩玩,2985,246,8,3,11,72.7%,44m
8343,1,[JOKER]夏洛克大仙人,2985,208,6,7,13,46.2%,24m
8343,1,翼尾蝎,2985,0,5,0,5,100.0%,48m
8343,1,春风得意马蹄琴,2985,212,5,6,11,45.5%,17m
8343,3,WhiteSc,2985,97,4,3,7,57.1%,24m
8343,1,都别给我墨迹,2985,78,2,6,8,25.0%,8m
8343,3,[野生无公害]ocg,2985,0,1,1,2,50.0%,31m
8343,1,[刺蛇单推协会]INNovaTion,2985,0,0,3,3,0.0%,7m
8360,1,infily,2984,812,43,36,79,54.4%,30m
8360,1,speqe,2984,758,33,29,62,53.2%,5m
8360,3,[不堪一击]afters,2984,518,21,22,43,48.8%,12m
8360,1,[Faith]牛肉炒饭,2984,634,19,20,39,48.7%,27m
8360,1,[Thpj]跳黄浦江,2984,394,13,16,29,44.8%,33m
8360,3,[星痕]哥是神,2984,177,11,11,22,50.0%,16m
8360,1,恨天笑,2984,322,9,14,23,39.1%,3m
8360,3,我爱熊爱洁,2984,305,9,15,24,37.5%,17m
8360,3,究极的大鸽子,2984,121,5,3,8,62.5%,1h
8360,2,相汝仆园,2984,138,3,2,5,60.0%,39m
8360,1,[暴雪七队]蓝白画质小霸王机,2984,0,3,2,5,60.0%,40m
8360,2,战疫必胜,2984,143,3,6,9,33.3%,25m
8360,3,[七咕咕]时崎狂三,2984,38,2,0,2,100.0%,1h
8360,2,[不死突袭3]老童哥,2984,62,2,1,3,66.7%,6m
8360,1,weihanggl,2984,78,2,4,6,33.3%,5m
8360,2,[请帮我嘴交谢]羊羔的梦碎,2984,0,1,0,1,100.0%,11m
8360,1,[社交学大可爱]sheely,2984,0,1,0,1,100.0%,1h
8360,2,彼季离,2984,30,1,1,2,50.0%,3m
8378,1,柯西不等式,2983,560,21,14,35,60.0%,27m
8378,1,[星歌]三千,2983,636,19,20,39,48.7%,18m
8378,1,[冰川镜华]狗狗,2983,551,18,18,36,50.0%,27m
8378,1,[ATeam]跳跳斧,2983,186,7,3,10,70.0%,31m
8378,1,可可可可可可,2983,279,7,7,14,50.0%,17m
8378,3,落叶随风,2983,0,5,1,6,83.3%,49m
8378,1,FIREQIU,2983,78,3,4,7,42.9%,7m
8378,3,[JJFly]小虫强大,2983,40,2,2,4,50.0%,1h
8378,2,那份情那么美,2983,0,1,0,1,100.0%,12m
8378,2,孤单向右,2983,30,1,1,2,50.0%,26m
8378,2,枉叹之,2983,34,1,2,3,33.3%,19m
8378,2,来之火星的贪吃猫,2983,0,0,1,1,0.0%,20m
8378,2,Euripides,2983,0,0,1,1,0.0%,5m
8378,2,[目標諾森德]YAXeair,2983,0,0,1,1,0.0%,12m
8378,3,[SaiL]老狼,2983,0,0,2,2,0.0%,1h
8378,1,侬看我老乱伐,2983,0,0,2,2,0.0%,1h
8394,3,Allin,2982,1331,130,137,267,48.7%,26m
8394,3,die,2982,454,53,45,98,54.1%,33m
8394,3,ttabl,2982,754,32,29,61,52.5%,20m
8394,3,天涯人生,2982,690,25,34,59,42.4%,36m
8394,1,Simas,2982,382,14,14,28,50.0%,3m
8394,2,[野人time]无敌辰哥哥,2982,144,5,3,8,62.5%,35m
8394,1,hohoge,2982,0,3,2,5,60.0%,10m
8394,1,推敲,2982,88,1,2,3,33.3%,18m
8394,3,光照之星,2982,0,0,1,1,0.0%,13m
8403,1,lcf,2981,888,170,156,326,52.1%,26m
8403,3,枣阳孙一峰,2981,891,123,105,228,53.9%,37m
8403,3,BOSS,2981,1370,60,69,129,46.5%,36m
8403,1,[浮世清欢]锐步,2981,685,35,23,58,60.3%,26m
8403,1,光刻的遗迹,2981,700,27,26,53,50.9%,26m
8403,3,[老油条战队]机枪兵都死了,2981,714,26,35,61,42.6%,26m
8403,1,[一剑光寒九州]麻雀,2981,617,23,19,42,54.8%,10m
8403,3,hypocrite,2981,121,5,3,8,62.5%,9m
8403,2,[XYFANS]Misaki,2981,96,4,1,5,80.0%,12m
8403,2,沫璃,2981,86,4,1,5,80.0%,30m
8403,1,[羊驼羊驼羊]星河弟弟,2981,159,4,4,8,50.0%,16m
8403,1,修闲玩家就是我,2981,0,3,2,5,60.0%,37m
8403,1,玩世不恭,2981,97,3,3,6,50.0%,58m
8403,1,[剑与玫瑰]空中漫步,2981,130,3,4,7,42.9%,18m
8403,1,[hct]IIIIIIIIIIII,2981,72,2,5,7,28.6%,23m
8403,1,[真实之泪]石动乃绘,2981,91,1,3,4,25.0%,34m
8403,2,[FYXZ]theedge,2981,0,0,1,1,0.0%,35m
8403,1,camille,2981,0,0,1,1,0.0%,1h
8421,2,RuiTI,2980,1651,209,209,418,50.0%,15m
8421,1,曲鹏润,2980,1544,77,74,151,51.0%,16m
8421,1,憨豆先生的小泰迪,2980,414,44,34,78,56.4%,16m
8421,2,[miku守护]ScarLeet,2980,505,22,9,31,71.0%,2m
8421,1,[电竞老年人]Cizo,2980,584,22,20,42,52.4%,24m
8421,1,曹佳佳,2980,489,21,21,42,50.0%,7m
8421,3,[神龍鬥士]emperor,2980,259,12,10,22,54.5%,3m
8421,1,Zanzx,2980,0,3,2,5,60.0%,1h
8421,1,[cRn]shmily,2980,139,3,3,6,50.0%,3m
8421,3,[沙漠天团]Poison,2980,0,3,3,6,50.0%,8m
8421,2,Hunter,2980,121,2,2,4,50.0%,16m
8421,2,Mrlemon,2980,0,1,0,1,100.0%,19m
8421,2,天凉好个秋,2980,0,1,0,1,100.0%,35m
8421,2,星期二,2980,0,0,2,2,0.0%,5m
8421,2,锅巴喷火,2980,0,0,5,5,0.0%,45m
8436,1,雾蜂,2979,858,67,62,129,51.9%,33m
8436,1,[暴雪三十二隊]iron,2979,737,30,27,57,52.6%,18m
8436,1,[XCode]无限非概率驱动,2979,613,29,16,45,64.4%,16m
8436,3,[浴火银河]ZGB,2979,288,29,35,64,45.3%,14m
8436,3,star,2979,470,27,43,70,38.6%,27m
8436,3,博丽灵梦,2979,532,19,25,44,43.2%,33m
8436,2,seaeye,2979,424,16,14,30,53.3%,16m
8436,2,[蓝军车路士]化身孤岛的鲸,2979,188,8,3,11,72.7%,23m
8436,2,[飞龙骑脸咋输]喂丶兔孨,2979,116,4,4,8,50.0%,15m
8436,2,shakeIII,2979,60,3,2,5,60.0%,21m
8436,1,残花碎梦,2979,0,3,2,5,60.0%,20m
8436,2,tovy,2979,0,0,1,1,0.0%,3m
8436,2,栉风沐雨,2979,0,0,2,2,0.0%,5m
8436,2,litlep,2979,0,0,2,2,0.0%,12m
8450,3,珂朵莉酱太可爱了,2978,1529,372,362,734,50.7%,18m
8450,2,CrazyCat,2978,1496,101,114,215,47.0%,21m
8450,3,[肌肉]谐峰戏语,2978,1522,71,85,156,45.5%,10m
8450,2,ACMKTT,2978,581,24,20,44,54.5%,23m
8450,1,[镜花水月丶]不翔的预感,2978,581,19,21,40,47.5%,19m
8450,3,老大反着念,2978,253,8,7,15,53.3%,21m
8450,1,我听见虚空的低语,2978,200,6,5,11,54.5%,19m
8450,2,[欢迎来蓝月城]刘老基呀,2978,161,5,3,8,62.5%,1h
8450,1,SmallOB,2978,0,3,2,5,60.0%,1h
8450,2,Etherooo,2978,88,3,3,6,50.0%,9m
8450,2,[羊驼羊驼羊]IIIIIIIIIIII,2978,38,2,3,5,40.0%,1h
8450,2,[哲学研究谐会]仙踪,2978,0,1,0,1,100.0%,26m
8450,2,[4399]凡人,2978,32,1,1,2,50.0%,16m
8450,3,Cher,2978,0,1,2,3,33.3%,33m
8450,2,Maxmix,2978,0,0,2,2,0.0%,27m
8450,3,[寻风]五行缺郭德纲,2978,0,0,2,2,0.0%,31m
8466,3,小板狗,2977,1330,137,137,274,50.0%,10m
8466,3,SoSooo,2977,1163,60,55,115,52.2%,20m
8466,3,sycshc,2977,1105,46,61,107,43.0%,4m
8466,1,天宇,2977,993,44,29,73,60.3%,34m
8466,1,SiriusOne,2977,602,21,23,44,47.7%,33m
8466,2,[盈盈一水间]土豆小胡,2977,510,17,18,35,48.6%,3m
8466,3,萝卜,2977,454,16,22,38,42.1%,15m
8466,3,千叶小豆豆,2977,207,10,7,17,58.8%,31m
8466,1,[M8]cavaliersile,2977,129,6,5,11,54.5%,37m
8466,2,IIIIIIIIIIII,2977,0,5,0,5,100.0%,3m
8466,1,机械烈海王,2977,138,5,6,11,45.5%,31m
8466,1,[HeroZP]Musk,2977,138,4,3,7,57.1%,17m
8466,1,[狗哥NO01]King,2977,0,3,2,5,60.0%,12m
8466,3,飞奔的世雄,2977,0,3,3,6,50.0%,1h
8466,1,[上地主]香蕉,2977,36,2,2,4,50.0%,5m
8466,2,[NLH]岸回霖风,2977,0,1,0,1,100.0%,13m
8466,2,MagejiTerran,2977,94,1,1,2,50.0%,1h
8466,1,灭亡却百合,2977,30,1,4,5,20.0%,37m
8466,2,某低调虐菜的少年,2977,0,0,1,1,0.0%,9m
8466,2,[城市规划局]Altale,2977,0,0,1,1,0.0%,31m
8466,2,伯利恒星,2977,0,0,2,2,0.0%,35m
8487,3,[灰冥]被玩坏的神,2976,1528,128,133,261,49.0%,26m
8487,3,小小的牢饭,2976,1184,66,61,127,52.0%,33m
8487,3,[菜有菜的道理]Aries,2976,492,58,54,112,51.8%,30m
8487,2,[PlTB]IIIIIIIIIIII,2976,787,30,23,53,56.6%,19m
8487,2,coincidence,2976,713,28,22,50,56.0%,12m
8487,1,[XXG]枫舞,2976,252,11,6,17,64.7%,36m
8487,1,微睡,2976,212,11,9,20,55.0%,5m
8487,3,[萌新是怪物]无敌小绵羊,2976,270,9,7,16,56.2%,17m
8487,3,gtv,2976,97,4,3,7,57.1%,9m
8487,2,八方古剑,2976,30,2,0,2,100.0%,9m
8487,2,个个叫爸爸,2976,0,1,0,1,100.0%,17m
8487,2,[虫群开始行动]温故而知新,2976,0,1,0,1,100.0%,20m
8487,1,打不赢神族,2976,0,1,4,5,20.0%,34m
8487,2,酷酷的柠檬,2976,0,0,1,1,0.0%,38m
8501,1,Halbert,2975,524,17,20,37,45.9%,17m
8501,2,hideshadous,2975,344,12,6,18,66.7%,26m
8501,3,slover,2975,155,8,6,14,57.1%,11m
8501,3,Oyster,2975,212,7,16,23,30.4%,33m
8501,3,平安时代的黑云,2975,131,3,2,5,60.0%,59m
8501,1,带你个十娘,2975,104,3,5,8,37.5%,22m
8501,1,zhousan,2975,0,2,3,5,40.0%,52m
8501,2,[NONAME]AND,2975,68,2,4,6,33.3%,4m
8501,2,sherlock,2975,0,1,0,1,100.0%,36m
8501,2,[老吴天下第一]Tgglol,2975,0,1,0,1,100.0%,25m
8501,1,[GOLK]奴隶少女孙一峰,2975,0,1,0,1,100.0%,18m
8501,1,ZanyDruid,2975,0,0,1,1,0.0%,46m
8501,2,[C10687]vbgdrt,2975,0,0,1,1,0.0%,15m
8514,3,andy,2974,1496,90,87,177,50.8%,12m
8514,2,姑娘莫怕,2974,287,12,13,25,48.0%,8m
8514,1,爸爸,2974,253,10,8,18,55.6%,1h
8514,2,[老年特战队]PATIENCE,2974,142,6,1,7,85.7%,19m
8514,1,[爱禽]克尔苏加狗,2974,170,5,5,10,50.0%,3m
8514,3,蛮力之兽,2974,120,5,6,11,45.5%,23m
8514,1,JustRight,2974,177,5,8,13,38.5%,24m
8514,2,Nefertair,2974,0,1,0,1,100.0%,16m
8514,2,reality,2974,0,1,0,1,100.0%,13m
8514,2,我得重新集结部队,2974,0,1,1,2,50.0%,23m
8514,2,paryyy,2974,0,0,1,1,0.0%,2m
8525,3,黄缘,2973,1546,177,172,349,50.7%,5m
8525,3,[BG]你的屁屁嘿嘿,2973,663,78,83,161,48.4%,9m
8525,1,阳光泰伦,2973,1258,48,42,90,53.3%,33m
8525,3,[YA]MeGuMI,2973,390,14,22,36,38.9%,37m
8525,3,玩游戏要头脑,2973,283,12,10,22,54.5%,3m
8525,1,leon,2973,166,4,5,9,44.4%,31m
8525,2,[刺蛇互助社团]RAiNYSTARS,2973,30,2,1,3,66.7%,11m
8525,1,[牌面]Figo,2973,70,2,6,8,25.0%,23m
8525,2,[工程萌男]圣龙,2973,0,0,1,1,0.0%,26m
8534,3,金陵副将马国成,2972,1581,101,96,197,51.3%,4m
8534,1,terminator,2972,866,45,21,66,68.2%,18m
8534,1,套马汉子,2972,728,25,27,52,48.1%,5m
8534,3,桑榆,2972,282,13,9,22,59.1%,17m
8534,2,[极品二五仔]孙一峰,2972,0,1,4,5,20.0%,11m
8534,2,GKAAA,2972,0,0,1,1,0.0%,3m
8540,1,随心所欲,2971,1597,211,209,420,50.2%,18m
8540,3,盖世闲鱼,2971,1458,161,155,316,50.9%,23m
8540,3,[周婉馨]馨儿,2971,141,90,99,189,47.6%,34m
8540,2,[奶飞天]你为何这么谐,2971,816,33,25,58,56.9%,33m
8540,1,我考掉线了,2971,284,8,13,21,38.1%,33m
8540,3,喻奕扬,2971,192,7,5,12,58.3%,1h
8540,1,kywqqt,2971,166,5,12,17,29.4%,33m
8540,1,[艾尔之巅]梦天,2971,73,4,5,9,44.4%,5m
8540,2,鲤鱼的盔甲架,2971,30,2,0,2,100.0%,12m
8540,2,清浅旧时光,2971,0,1,0,1,100.0%,12m
8540,1,斯蒂芬森打发似的,2971,38,1,3,4,25.0%,33m
8540,2,[孙红雷]SamTsui,2971,0,0,1,1,0.0%,12m
8540,1,[舞鹤海军工厂]特型吹雪级晓,2971,0,0,1,1,0.0%,44m
8553,3,iiiiiiiiiiii,2970,1560,456,457,913,49.9%,6m
8553,1,胖胡,2970,1686,108,97,205,52.7%,10m
8553,1,烨子,2970,1136,92,89,181,50.8%,24m
8553,1,Dominic,2970,703,39,31,70,55.7%,2m
8553,1,wzm,2970,891,32,26,58,55.2%,17m
8553,1,IIIIIIIII,2970,224,8,7,15,53.3%,3m
8553,2,[GGG第三代]我问问,2970,198,7,4,11,63.6%,35m
8553,1,命运就慢了半拍,2970,192,6,7,13,46.2%,18m
8553,1,[末世纪]小鱼的跟班,2970,108,4,6,10,40.0%,33m
8553,1,放开那个女孩,2970,0,3,2,5,60.0%,1h
8553,2,鲲飞九霄,2970,0,1,0,1,100.0%,33m
8553,2,[泰伦保护协会]volahri,2970,0,1,0,1,100.0%,10m
8553,2,wimpyJK,2970,0,1,0,1,100.0%,37m
8553,2,[永恒的信念]光荣之猫咪,2970,0,1,1,2,50.0%,35m
8553,2,天蓝色,2970,0,0,1,1,0.0%,25m
8568,2,激光顺序,2969,1628,1248,1216,2464,50.6%,32m
8568,1,神秘的星灵,2969,1234,46,44,90,51.1%,31m
8568,1,[TCP]IIIIIII,2969,1020,38,34,72,52.8%,24m
8568,1,[大谐会]地下深水层,2969,1094,38,40,78,48.7%,32m
8568,1,[盖世双谐]打星际我只玩神族,2969,222,6,10,16,37.5%,7m
8568,1,[艾尔之主]VFskyrim,2969,186,5,6,11,45.5%,51m
8568,1,Infirm,2969,94,3,5,8,37.5%,32m
8568,2,Nemo,2969,179,3,6,9,33.3%,33m
8568,2,开心就好,2969,0,1,0,1,100.0%,23m
8568,2,[TNLtr]Ayame,2969,0,1,1,2,50.0%,45m
8568,2,[小鸡屠宰场3]你大哥,2969,0,1,1,2,50.0%,25m
8568,3,[KOTRT]鸡饲料保护协会,2969,0,0,1,1,0.0%,3m
8568,2,FanscDragon,2969,0,0,2,2,0.0%,11m
8568,1,在途的巨便打鸡,2969,0,0,4,4,0.0%,33m
8568,1,死星,2969,0,0,4,4,0.0%,3m
8568,3,QHlight,2969,0,0,6,6,0.0%,27m
8584,1,seed,2968,1657,123,107,230,53.5%,33m
8584,3,看见你我蛋疼,2968,729,41,49,90,45.6%,23m
8584,1,真男人,2968,1027,34,35,69,49.3%,27m
8584,3,长安李不白,2968,591,28,33,61,45.9%,10m
8584,3,[基金会]一云,2968,485,28,34,62,45.2%,10m
8584,1,[你已经死啦]lsc,2968,414,13,14,27,48.1%,7m
8584,1,[DNF]曦晨,2968,202,6,5,11,54.5%,30m
8584,2,[笑傲江湖oL]辟邪剑丶林平之,2968,148,5,7,12,41.7%,6m
8584,3,JinAirTrap,2968,143,4,4,8,50.0%,27m
8584,1,[小鸡屠宰场a]fly,2968,132,4,7,11,36.4%,4m
8584,3,自在极意功孙悟空,2968,60,3,10,13,23.1%,24m
8584,1,席应情,2968,44,1,4,5,20.0%,41m
8584,2,[NPSC]神马,2968,0,0,1,1,0.0%,1h
8584,2,[遥远的拂晓]FakeNews,2968,0,0,1,1,0.0%,38m
8584,2,Hwze,2968,0,0,1,1,0.0%,23m
8599,1,静宝宝,2967,1654,182,176,358,50.8%,16m
8599,1,烫着火锅把你留,2967,518,67,54,121,55.4%,26m
8599,2,sora,2967,380,20,8,28,71.4%,10m
8599,1,韩版小七,2967,252,11,6,17,64.7%,1h
8599,3,atearasd,2967,165,6,4,10,60.0%,47m
8599,1,夜神月,2967,134,6,5,11,54.5%,16m
8599,1,狂暴小刀,2967,221,6,6,12,50.0%,33m
8599,3,[TPoR]fourteen,2967,184,5,4,9,55.6%,4m
8599,2,业火袭吊,2967,40,5,5,10,50.0%,1h
8599,2,源源源源源丨,2967,60,3,0,3,100.0%,20m
8599,3,[XXHZ10]仰望星空,2967,38,1,1,2,50.0%,54m
8599,2,萌新蟹蟹,2967,30,1,1,2,50.0%,13m
8599,1,何不入我神教,2967,0,1,1,2,50.0%,20m
8599,1,[阿莎丽突击队]hjh,2967,0,1,3,4,25.0%,3m
8599,2,[孤独与烈酒]Ash,2967,0,0,2,2,0.0%,15m
8614,1,核弹头,2966,1584,67,49,116,57.8%,22m
8614,1,牙膏,2966,502,16,17,33,48.5%,33m
8614,2,IIIIIIIIIIII,2966,240,13,12,25,52.0%,29m
8614,2,鬼魂,2966,305,9,10,19,47.4%,36m
8614,2,[快星际乐]聋狗读报,2966,213,5,5,10,50.0%,27m
8614,1,个顶顶顶,2966,167,4,2,6,66.7%,27m
8614,2,[为谁而忧伤]Metrix,2966,30,2,1,3,66.7%,6m
8614,1,[love西瓜]与狼共舞,2966,0,1,0,1,100.0%,1h
8614,1,暗影手冲,2966,0,1,1,2,50.0%,31m
8614,1,llllllllllll,2966,0,1,4,5,20.0%,30m
8614,3,幽灵,2966,0,0,1,1,0.0%,1h
8614,2,[吕布看女团]fbh,2966,0,0,1,1,0.0%,5m
8614,2,梦回魁星楼,2966,0,0,1,1,0.0%,12m
8614,2,[NavyF]逢坂大河,2966,0,0,2,2,0.0%,16m
8614,2,[序列sao]低音号黄前久美子,2966,0,0,2,2,0.0%,25m
8629,1,小春,2965,939,72,50,122,59.0%,18m
8629,2,evangelioner,2965,814,43,32,75,57.3%,15m
8629,1,[Shawk]QCsweet,2965,1117,40,38,78,51.3%,33m
8629,3,maru,2965,396,13,24,37,35.1%,5m
8629,1,Blueblink,2965,143,6,5,11,54.5%,1h
8629,1,浪月,2965,112,4,9,13,30.8%,31m
8629,2,[幻想神社]远空,2965,34,2,0,2,100.0%,33m
8629,2,[肉鸡的饲养]魔法少女咕咕酱,2965,0,1,1,2,50.0%,23m
8629,2,[40066]Field,2965,0,0,1,1,0.0%,3m
8629,2,[1939CN]一个打酱油的坑货,2965,0,0,1,1,0.0%,3m
8629,2,lmy,2965,0,0,2,2,0.0%,22m
8640,2,IIIIIIIIIIII,2964,576,74,67,141,52.5%,20m
8640,1,IiIiIiIiIiIi,2964,447,34,20,54,63.0%,27m
8640,2,山风,2964,284,11,7,18,61.1%,11m
8640,1,IOKingGgwF,2964,242,9,10,19,47.4%,33m
8640,2,[KPG2]邪恶蠢鱼,2964,204,7,5,12,58.3%,29m
8640,1,[暴雪十五队]honggl,2964,122,3,3,6,50.0%,4m
8640,2,[伊修加德男团]一森,2964,42,2,1,3,66.7%,56m
8640,1,[社交学大可爱]AMG,2964,44,1,1,2,50.0%,25m
8640,2,归零丶噬神者,2964,32,1,2,3,33.3%,29m
8640,2,LOOO,2964,30,1,3,4,25.0%,6m
8640,2,[YT]皂滑弄人,2964,0,0,1,1,0.0%,35m
8640,2,轩镰,2964,0,0,1,1,0.0%,20m
8640,1,[ChSp]阿狸鱼子酱,2964,0,0,3,3,0.0%,33m
8653,1,搞事啦,2963,1638,84,81,165,50.9%,27m
8653,1,[社交学大可爱]虚空墨世,2963,818,40,32,72,55.6%,16m
8653,1,Betrayer,2963,703,30,22,52,57.7%,18m
8653,1,Tyr,2963,794,25,29,54,46.3%,9m
8653,2,CounTingsTar,2963,502,22,16,38,57.9%,8m
8653,3,[人间黎明]养金鱼,2963,432,14,33,47,29.8%,15m
8653,3,[星基佬男孩]一马当先锋盾,2963,342,11,23,34,32.4%,8m
8653,2,[Tiller]单先生,2963,201,7,2,9,77.8%,23m
8653,3,晨曦,2963,202,7,4,11,63.6%,9m
8653,1,hello,2963,244,7,11,18,38.9%,26m
8653,1,亚比坦公爵,2963,176,7,13,20,35.0%,10m
8653,1,SKTeiecomDP,2963,118,5,3,8,62.5%,1h
8653,2,Skywalker,2963,126,4,5,9,44.4%,23m
8653,2,[ESU二五仔]ELvis,2963,117,3,3,6,50.0%,49m
8653,2,美哉长平,2963,30,1,1,2,50.0%,22m
8653,1,某科学的御坂,2963,0,1,2,3,33.3%,23m
8653,2,[镜花水月丶]专注输出某椛酱,2963,0,0,1,1,0.0%,20m
8653,2,[大神1]星际小菜鸟,2963,0,0,2,2,0.0%,35m
8671,1,[你画我瞎]抽烟喝酒烫头,2962,1441,85,90,175,48.6%,27m
8671,1,[核平大队]作业狂人,2962,1604,63,65,128,49.2%,18m
8671,1,[薄荷的指挥官]那一片树林,2962,1148,62,58,120,51.7%,2m
8671,1,指尖的艺术,2962,1490,61,50,111,55.0%,24m
8671,2,[Rhusky]Yoga,2962,1175,52,36,88,59.1%,23m
8671,1,大弊,2962,732,27,25,52,51.9%,31m
8671,1,[sc谐盟]可怕君,2962,368,24,22,46,52.2%,18m
8671,1,erbxiexin,2962,258,9,11,20,45.0%,24m
8671,1,[底特律KAR]狂妄之英雄,2962,182,6,9,15,40.0%,18m
8671,1,Ring,2962,46,5,2,7,71.4%,20m
8671,2,[DukeA]Stork,2962,187,5,7,12,41.7%,1h
8671,2,夏伤沫痕,2962,58,3,2,5,60.0%,23m
8671,1,xiaochou,2962,116,3,6,9,33.3%,18m
8671,3,KingSpeech,2962,0,2,5,7,28.6%,49m
8671,1,稳住等躺赢,2962,0,1,0,1,100.0%,1h
8671,2,[拉拉]洛神子建,2962,0,1,1,2,50.0%,12m
8671,2,腌笃鲜,2962,0,0,1,1,0.0%,8m
8671,3,soynim,2962,0,0,1,1,0.0%,9m
8689,1,[永生水域]瑶玑,2961,1002,178,173,351,50.7%,16m
8689,1,虫群之主,2961,1523,79,72,151,52.3%,9m
8689,1,土豆受害者,2961,340,24,25,49,49.0%,32m
8689,1,骨灰级萌新,2961,600,22,19,41,53.7%,27m
8689,2,菜姬,2961,300,11,9,20,55.0%,15m
8689,2,AOS,2961,236,9,1,10,90.0%,23m
8689,1,fengya,2961,139,6,6,12,50.0%,1h
8689,2,[白银联盟]NoahsArk,2961,148,5,2,7,71.4%,38m
8689,2,black,2961,60,2,2,4,50.0%,16m
8689,3,[葬魂]Jei,2961,97,2,4,6,33.3%,1h
8689,2,[224]忒修斯,2961,0,1,1,2,50.0%,3m
8689,1,DIETsummer,2961,0,0,1,1,0.0%,1h
8689,1,萌呆综合症,2961,0,0,3,3,0.0%,9m
8702,2,MWMWMWMMWMWM,2960,699,30,18,48,62.5%,5m
8702,1,凤池,2960,655,26,23,49,53.1%,9m
8702,2,苦逼的平民,2960,313,16,9,25,64.0%,20m
8702,2,苏明憬,2960,318,11,12,23,47.8%,30m
8702,1,比企谷八幡,2960,315,10,9,19,52.6%,46m
8702,1,[够不够莽]卖了否冷,2960,318,9,13,22,40.9%,32m
8702,1,[底特律KAR]这游戏真鸡儿难,2960,96,4,2,6,66.7%,13m
8702,1,六面兽,2960,156,4,5,9,44.4%,24m
8702,1,代代版本玩盖伦,2960,0,3,2,5,60.0%,20m
8702,2,小立哥,2960,0,2,3,5,40.0%,38m
8702,1,BigApple,2960,36,2,4,6,33.3%,10m
8702,2,Borning,2960,30,1,1,2,50.0%,5m
8702,1,moshen,2960,0,0,1,1,0.0%,1h
8702,2,IIIIlIlIlIlI,2960,0,0,2,2,0.0%,35m
8702,2,田中秀桜,2960,0,0,3,3,0.0%,12m
8717,3,jamestan,2959,1569,500,489,989,50.6%,36m
8717,3,[天雪丶葬花]颓废丶,2959,1498,169,180,349,48.4%,36m
8717,1,Allen,2959,331,14,9,23,60.9%,18m
8717,2,施老头,2959,174,9,6,15,60.0%,1h
8717,1,[不知不觉天亮]GYT,2959,276,7,8,15,46.7%,31m
8717,3,[突变攻略组]hatsunemiku,2959,137,6,4,10,60.0%,1h
8717,1,山风流苏,2959,97,4,2,6,66.7%,1h
8717,1,[艾尔的荣誉]天韵絮葵,2959,0,3,2,5,60.0%,59m
8717,1,甘大神,2959,0,3,2,5,60.0%,13m
8717,1,[社交学超可爱]我也找不着,2959,64,2,5,7,28.6%,33m
8717,2,豪睿睿,2959,48,1,1,2,50.0%,16m
8717,2,天杀的,2959,0,0,1,1,0.0%,5m
8729,2,浪蝶对狂蜂,2958,1562,66,55,121,54.5%,13m
8729,3,璀璨星华,2958,761,28,32,60,46.7%,4m
8729,2,PASSION,2958,634,24,21,45,53.3%,10m
8729,1,MXDFS,2958,627,22,18,40,55.0%,27m
8729,1,水墨孤影,2958,584,19,22,41,46.3%,23m
8729,2,egg,2958,377,15,13,28,53.6%,27m
8729,2,[Vgirls]Agoni,2958,316,10,7,17,58.8%,31m
8729,2,IIFIIZIIQII,2958,215,6,4,10,60.0%,30m
8729,2,[梦瑾空人心]一盘都赢不了,2958,44,2,2,4,50.0%,1h
8729,2,祖国的花,2958,30,1,2,3,33.3%,23m
8729,1,技术宅阿巴瑟,2958,0,1,4,5,20.0%,13m
8729,1,随风而来,2958,0,0,1,1,0.0%,41m
8729,2,[UNN]清平乐,2958,0,0,1,1,0.0%,16m
8729,2,[星街彗星单推]二宮飛鳥担当有力,2958,0,0,1,1,0.0%,11m
8729,2,[D0F]shinichi,2958,0,0,3,3,0.0%,25m
8744,3,JumpJump,2957,1332,180,162,342,52.6%,7m
8744,1,星际男孩,2957,1424,104,96,200,52.0%,17m
8744,3,[旧日塔罗会]道格拉斯冯巩,2957,480,48,32,80,60.0%,7m
8744,1,[重理工]whybbabo,2957,673,33,17,50,66.0%,18m
8744,3,haolou,2957,488,19,29,48,39.6%,30m
8744,3,STARWOWER,2957,384,16,18,34,47.1%,6m
8744,1,ByHero,2957,400,13,17,30,43.3%,19m
8744,1,[APM50]噗叽,2957,306,10,10,20,50.0%,18m
8744,1,[第七駆逐鑑隊]矿物储量不族,2957,190,6,9,15,40.0%,10m
8744,2,llllllllllll,2957,120,5,4,9,55.6%,38m
8744,2,[盲人协会]jzq,2957,116,4,3,7,57.1%,26m
8744,1,[白昼]Legend,2957,0,3,2,5,60.0%,1h
8744,1,[msyx]冥圣,2957,0,3,2,5,60.0%,1h
8744,3,暗夜骑士,2957,0,1,0,1,100.0%,1h
8744,2,DarkTemplar,2957,0,0,2,2,0.0%,23m
8759,2,骚爆的小虫子,2956,1231,52,44,96,54.2%,3m
8759,3,[龙腾]heybabe,2956,822,52,54,106,49.1%,26m
8759,1,koslk,2956,1206,50,41,91,54.9%,22m
8759,3,[有梦想的团]旭东探女,2956,544,23,32,55,41.8%,8m
8759,1,苍苍蒹葭,2956,454,13,18,31,41.9%,17m
8759,1,你是哪块小饼干,2956,208,9,7,16,56.2%,57m
8759,1,[大漢]Marineking,2956,251,9,12,21,42.9%,18m
8759,3,[OAQ]Ceteris,2956,181,8,4,12,66.7%,4m
8759,3,犬夜叉,2956,264,8,13,21,38.1%,17m
8759,1,Desweet,2956,154,5,10,15,33.3%,9m
8759,1,游星际的鱼儿,2956,0,3,2,5,60.0%,9m
8759,2,Doragiaogiao,2956,86,3,4,7,42.9%,16m
8759,2,MagicSnorlax,2956,60,2,2,4,50.0%,15m
8759,1,yuo,2956,0,1,4,5,20.0%,34m
8759,1,[刑事组之虎]aoao,2956,38,1,6,7,14.3%,8m
8759,2,[愿召唤吾王]珺鸦,2956,0,0,1,1,0.0%,13m
8759,2,奈何桥上的狗,2956,0,0,1,1,0.0%,15m
8759,2,[浪啊浪]潇潇梧桐,2956,0,0,1,1,0.0%,23m
8777,1,nanaya,2955,1532,202,173,375,53.9%,10m
8777,2,Too,2955,1066,46,34,80,57.5%,14m
8777,1,这把有点悬,2955,350,14,15,29,48.3%,22m
8777,2,人族无敌,2955,266,13,3,16,81.2%,32m
8777,2,haibara,2955,291,12,13,25,48.0%,12m
8777,2,zhz,2955,144,6,3,9,66.7%,29m
8777,1,李奇,2955,140,5,3,8,62.5%,27m
8777,2,virl,2955,148,5,5,10,50.0%,30m
8777,2,[使劲tao]想一想,2955,121,4,4,8,50.0%,1h
8777,2,烧香,2955,60,3,1,4,75.0%,35m
8777,1,来一打大和,2955,144,2,2,4,50.0%,10m
8777,2,[杀戮team]StarDiablo,2955,0,1,0,1,100.0%,29m
8777,1,ASD,2955,0,1,0,1,100.0%,31m
8777,1,[worst]NANGONG,2955,38,1,5,6,16.7%,19m
8777,2,briantio,2955,0,0,1,1,0.0%,33m
8777,1,老牛锻金态,2955,0,0,1,1,0.0%,32m
8793,1,firefly,2954,1067,97,92,189,51.3%,27m
8793,2,[菜有菜的道理]狗头人军团,2954,1185,92,73,165,55.8%,2m
8793,3,cfen,2954,790,51,58,109,46.8%,22m
8793,1,[最菜战队]kayanon,2954,1173,44,43,87,50.6%,24m
8793,2,IIIIIIIIIIII,2954,531,27,24,51,52.9%,25m
8793,2,大王,2954,385,16,10,26,61.5%,38m
8793,3,poi,2954,309,14,8,22,63.6%,12m
8793,1,斐波那契兔,2954,291,11,9,20,55.0%,3m
8793,1,折戟沉沙,2954,200,10,8,18,55.6%,57m
8793,1,[envy]EnvyAngle,2954,312,10,13,23,43.5%,24m
8793,2,[老年之家]欧基霸凯,2954,189,9,4,13,69.2%,27m
8793,3,[RPGBoY]儿子许杰,2954,242,9,20,29,31.0%,6m
8793,1,你来杀我呀,2954,220,7,9,16,43.8%,32m
8793,1,djckawf,2954,0,4,1,5,80.0%,17m
8793,1,[凯露天下第一]AkiRinco,2954,0,3,2,5,60.0%,1h
8793,1,TiToMi,2954,0,3,2,5,60.0%,1h
8793,2,[小金上天队]费拉不堪凯露酱,2954,138,3,3,6,50.0%,11m
8793,3,星际魔人,2954,97,2,1,3,66.7%,1h
8793,2,[战旗第六分队]觐天丶佐羽,2954,0,1,0,1,100.0%,10m
8793,2,kkkkk,2954,0,1,0,1,100.0%,23m
8793,3,决战之长河落日,2954,0,1,1,2,50.0%,59m
8793,2,[垃圾站]魔王之力,2954,0,0,1,1,0.0%,16m
8793,2,[辉煌华夏]十分甜加奶霜,2954,0,0,1,1,0.0%,31m
8793,2,[DSC]llllllllllll,2954,0,0,2,2,0.0%,39m
8793,2,[Fiend]Coldwords,2954,0,0,3,3,0.0%,11m
8818,1,[loveMM]gameplayer,2953,1686,993,982,1975,50.3%,5m
8818,3,SpaceCowboy,2953,94,20,30,50,40.0%,4m
8818,2,不是很快乐,2953,425,19,7,26,73.1%,16m
8818,1,神族难民,2953,430,13,16,29,44.8%,33m
8818,2,RealChange,2953,238,9,1,10,90.0%,11m
8818,1,[求狙击]最上启示,2953,0,1,0,1,100.0%,1h
8818,2,Ptner,2953,0,1,1,2,50.0%,14m
8818,1,[呜呜呜嘤嘤]IIIIIIIIIIII,2953,0,1,3,4,25.0%,17m
8818,1,[绝望星灵]再见了星际,2953,88,1,4,5,20.0%,11m
8827,3,[睫毛哥八百部]睫毛哥八百部,2952,1535,92,108,200,46.0%,6m
8827,3,peterq,2952,1466,62,68,130,47.7%,3m
8827,1,[sosuck]yumhzzz,2952,771,28,26,54,51.9%,22m
8827,1,[下饭]下酒,2952,730,24,26,50,48.0%,19m
8827,3,希米蝈蝈,2952,359,14,9,23,60.9%,37m
8827,1,心暖阳光,2952,338,10,10,20,50.0%,10m
8827,2,WANGZHE,2952,266,9,4,13,69.2%,26m
8827,1,devil,2952,358,9,12,21,42.9%,30m
8827,2,IIIIIIIIIIII,2952,236,8,5,13,61.5%,10m
8827,3,剑鞘掉了丶亚索,2952,201,6,2,8,75.0%,1h
8827,2,hape,2952,0,5,2,7,71.4%,33m
8827,2,[为高建国效命]天梯少主,2952,130,5,3,8,62.5%,11m
8827,2,secret,2952,142,5,4,9,55.6%,16m
8827,1,再唱一首歌谣吧,2952,96,4,2,6,66.7%,17m
8827,2,[DMRe]疯子离洛,2952,30,2,2,4,50.0%,31m
8827,2,[Sneak]霓虹,2952,0,1,0,1,100.0%,29m
8827,1,zjd,2952,30,1,6,7,14.3%,26m
8827,2,石头哥,2952,0,0,1,1,0.0%,32m
8827,2,[科普鲁苏维埃]中立单位,2952,0,0,1,1,0.0%,36m
8827,2,在云端,2952,0,0,1,1,0.0%,33m
8827,2,任癸,2952,0,0,1,1,0.0%,23m
8848,1,Farley,2951,1648,174,151,325,53.5%,19m
8848,1,李娜同学水里吻我,2951,917,104,90,194,53.6%,9m
8848,1,[社交学小可爱]骑摩托的北方娃儿,2951,1638,66,73,139,47.5%,17m
8848,1,转虫先锋,2951,484,17,20,37,45.9%,5m
8848,1,[红色贝雷帽]星际,2951,214,9,8,17,52.9%,23m
8848,2,Change,2951,144,5,3,8,62.5%,26m
8848,1,航哥,2951,48,4,3,7,57.1%,11m
8848,1,[Swing]IIIIIIIIIIII,2951,142,4,8,12,33.3%,18m
8848,1,暗之锋芒,2951,48,2,1,3,66.7%,22m
8848,2,深知你是梦,2951,64,2,3,5,40.0%,33m
8848,2,[XXHZ36]积木,2951,0,1,0,1,100.0%,10m
8848,1,西北女马个鸡泰伦,2951,38,1,6,7,14.3%,30m
8860,3,koslk,2950,1124,79,69,148,53.4%,30m
8860,2,nDaye,2950,1004,50,45,95,52.6%,30m
8860,3,AnkH,2950,1050,42,44,86,48.8%,29m
8860,1,大小白帝,2950,315,15,10,25,60.0%,11m
8860,1,盼盼,2950,422,12,14,26,46.2%,32m
8860,2,felixcxj,2950,206,9,6,15,60.0%,1h
8860,3,[萝莉之芯]没天赋的人族,2950,270,9,22,31,29.0%,18m
8860,2,前列腺供给,2950,267,8,6,14,57.1%,32m
8860,2,在水一方,2950,90,4,5,9,44.4%,31m
8860,1,青衣月华舞,2950,212,4,6,10,40.0%,23m
8860,2,[神圣F2]AiursHand,2950,0,3,2,5,60.0%,28m
8860,1,Thedevil,2950,116,3,4,7,42.9%,9m
8860,1,XiaoBaiChi,2950,44,3,9,12,25.0%,1h
8860,1,水银,2950,95,2,2,4,50.0%,26m
8860,1,[神奇的联萌]Cyclone,2950,70,2,6,8,25.0%,10m
8860,2,[无法吴天]风落去,2950,0,0,1,1,0.0%,21m
8860,2,矛盾螺旋,2950,0,0,1,1,0.0%,6m
8877,2,SEVEN,2949,1622,210,198,408,51.5%,31m
8877,1,[没有闪]我是菜鸡泰伦,2949,1658,186,171,357,52.1%,16m
8877,1,Demonhunter,2949,500,86,87,173,49.7%,24m
8877,1,Nyalotha,2949,918,37,31,68,54.4%,3m
8877,2,[天才mvp]RHO,2949,542,33,23,56,58.9%,20m
8877,2,薇光,2949,751,31,27,58,53.4%,35m
8877,2,郝星辉,2949,488,19,13,32,59.4%,29m
8877,2,[幻想神社]二十七秒,2949,289,16,13,29,55.2%,22m
8877,2,星际少女牙牙酱,2949,188,6,2,8,75.0%,5m
8877,2,[迦勒底]RBQ,2949,100,4,4,8,50.0%,16m
8877,1,[IDS]XTY,2949,0,3,2,5,60.0%,4m
8877,1,混元星际编外门徒,2949,104,3,3,6,50.0%,19m
8877,1,Neilby,2949,96,2,3,5,40.0%,4m
8877,2,[重理工]Statz,2949,62,2,4,6,33.3%,14m
8877,3,[Utada]TYTY,2949,0,1,0,1,100.0%,31m
8877,2,星际争霸,2949,0,1,1,2,50.0%,11m
8877,2,菁菁鲸,2949,30,1,3,4,25.0%,14m
8894,1,骑着蜗牛追太阳,2948,1588,178,160,338,52.7%,33m
8894,1,Mourner,2948,1677,175,173,348,50.3%,2m
8894,1,tyrant,2948,1330,51,51,102,50.0%,22m
8894,3,[菜就对了]qqq,2948,1240,46,57,103,44.7%,26m
8894,1,llllllllllll,2948,739,35,32,67,52.2%,27m
8894,1,超哥的秘密,2948,870,35,32,67,52.2%,10m
8894,1,[SUSTC]孤独狼,2948,794,26,31,57,45.6%,33m
8894,2,风流倜傥丶花爷,2948,537,24,10,34,70.6%,23m
8894,2,[花影]Starry,2948,431,15,19,34,44.1%,26m
8894,3,[0o0]GYGT,2948,244,9,9,18,50.0%,17m
8894,1,[大魔王先生]白羽,2948,260,9,9,18,50.0%,33m
8894,1,冰是睡着的水,2948,302,9,13,22,40.9%,24m
8894,2,[文轩有大牛]晨先生,2948,198,7,5,12,58.3%,31m
8894,1,HandsomeK,2948,140,5,4,9,55.6%,1h
8894,2,Sam,2948,121,5,4,9,55.6%,16m
8894,1,[上车]soulshadow,2948,36,2,4,6,33.3%,35m
8894,1,[TGC]猫崽,2948,48,2,5,7,28.6%,31m
8894,1,达子,2948,37,2,5,7,28.6%,7m
8894,2,这波不亏,2948,0,1,0,1,100.0%,30m
8894,2,EnterPrise,2948,94,1,3,4,25.0%,23m
8914,3,mua,2947,1580,105,100,205,51.2%,23m
8914,2,西湖优质二五仔,2947,810,41,27,68,60.3%,5m
8914,1,[Etd]MAGICYJ,2947,697,28,26,54,51.9%,37m
8914,2,流光,2947,400,17,10,27,63.0%,23m
8914,3,无垠,2947,164,7,16,23,30.4%,34m
8914,2,阿萨德,2947,214,6,3,9,66.7%,22m
8914,2,yuka,2947,154,5,1,6,83.3%,29m
8914,3,大能喵,2947,98,5,3,8,62.5%,7m
8914,1,鬼邪,2947,96,4,2,6,66.7%,1h
8914,2,SilentMary,2947,116,4,6,10,40.0%,26m
8914,1,爱上抹茶,2947,0,3,2,5,60.0%,1h
8914,1,[镇魂]UFine,2947,109,3,3,6,50.0%,16m
8914,2,warriarking,2947,129,3,5,8,37.5%,45m
8914,2,[大威天龙oc]闲卿,2947,64,2,1,3,66.7%,29m
8914,2,[NLH]wsgh,2947,0,1,0,1,100.0%,6m
8914,1,[CPT]冶瞳三炼,2947,0,1,0,1,100.0%,1h
8914,2,她说她是晒黑的,2947,0,1,1,2,50.0%,12m
8914,2,[半个菜鸟II]Rod,2947,0,0,1,1,0.0%,1h
8914,2,[咬不断的粘痰]JIEFANGJUN,2947,0,0,1,1,0.0%,16m
8933,1,doubi,2946,780,26,28,54,48.1%,27m
8933,2,[CPT]zoun,2946,535,24,9,33,72.7%,11m
8933,3,happy,2946,596,20,32,52,38.5%,14m
8933,1,刚玩求轻虐,2946,416,18,14,32,56.2%,10m
8933,2,木木,2946,376,14,12,26,53.8%,28m
8933,1,狗头人,2946,163,3,7,10,30.0%,33m
8933,2,咱没有名气,2946,0,1,0,1,100.0%,38m
8933,2,驱逐舰弥生,2946,0,1,1,2,50.0%,32m
8933,1,布鲁惠斯,2946,0,0,1,1,0.0%,1h
8942,1,StealHeart,2945,395,21,15,36,58.3%,10m
8942,1,LiuPeiTong,2945,219,9,7,16,56.2%,57m
8942,1,拜拜,2945,0,4,1,5,80.0%,54m
8942,1,暴躁之,2945,0,4,1,5,80.0%,5m
8942,1,[仁者]从小就很帅,2945,94,2,1,3,66.7%,23m
8942,1,偶也,2945,119,2,6,8,25.0%,48m
8942,1,路过的杀手,2945,0,1,0,1,100.0%,1h
8942,3,[人菜灬瘾大]雷鸣舞台,2945,0,1,0,1,100.0%,49m
8942,2,浅唱灬悲殇,2945,30,1,1,2,50.0%,5m
8942,2,[可爱的你们]xxxxxx,2945,0,1,1,2,50.0%,3m
8942,2,[HK丶S]阳光果粒橙,2945,30,1,2,3,33.3%,35m
8942,3,禁止非法炸鱼,2945,93,1,2,3,33.3%,1h
8942,2,读书人罢了,2945,30,1,3,4,25.0%,28m
8942,2,ZweiG,2945,0,0,1,1,0.0%,8m
8942,1,[Solo]弹指间湮灭,2945,0,0,2,2,0.0%,27m
8942,1,lmlAlter,2945,0,0,2,2,0.0%,1h
8958,1,[Encore]我爱米咪,2944,1519,59,59,118,50.0%,34m
8958,1,Juhe,2944,831,40,37,77,51.9%,13m
8958,2,开水,2944,714,32,31,63,50.8%,23m
8958,1,[小剑人]长沙孙一峰,2944,586,19,22,41,46.3%,18m
8958,2,诞生,2944,249,8,7,15,53.3%,13m
8958,1,流光织雨,2944,234,8,10,18,44.4%,24m
8958,2,Kirin,2944,0,1,0,1,100.0%,21m
8958,2,Pflegefur,2944,0,0,2,2,0.0%,26m
8958,2,[KNAT]SCPLAYER,2944,0,0,3,3,0.0%,8m
8958,2,再见宋哈娜,2944,0,0,3,3,0.0%,8m
8968,1,一石,2943,459,29,30,59,49.2%,17m
8968,1,[上古之神]飞飞飞飞飞,2943,259,21,17,38,55.3%,26m
8968,1,[半个大哥]DriveaF,2943,358,13,10,23,56.5%,35m
8968,3,判官,2943,296,10,20,30,33.3%,12m
8968,2,[我们是无敌的]究极黑暗,2943,236,9,7,16,56.2%,36m
8968,1,雁阵惊寒,2943,276,9,11,20,45.0%,9m
8968,1,Lcso,2943,282,8,14,22,36.4%,3m
8968,1,艾文,2943,236,7,12,19,36.8%,33m
8968,2,老年人,2943,200,6,2,8,75.0%,32m
8968,1,卢本伟,2943,0,5,1,6,83.3%,32m
8968,1,星盟,2943,0,3,2,5,60.0%,48m
8968,2,苏苏丶,2943,30,2,1,3,66.7%,39m
8968,1,Doot,2943,0,2,4,6,33.3%,20m
8968,2,郁闷蜘蛛,2943,0,1,0,1,100.0%,1h
8968,2,小酷鬼,2943,30,1,2,3,33.3%,19m
8968,2,[超神给你看哦]玩人族母亲必出事,2943,30,1,3,4,25.0%,29m
8968,2,[TZPer]靓仔,2943,0,0,1,1,0.0%,1h
8985,3,[Dagr]Chtholly,2942,1421,168,172,340,49.4%,34m
8985,1,阿呆傻狗,2942,1253,97,93,190,51.1%,17m
8985,2,最后的泰伦,2942,756,54,44,98,55.1%,26m
8985,2,[DBC]CarlJY,2942,190,6,3,9,66.7%,1h
8985,2,有话直说,2942,163,6,4,10,60.0%,1h
8985,2,[社交学教师]地狱疯子,2942,178,6,7,13,46.2%,35m
8985,2,[妖妖梦]Wasted,2942,142,4,0,4,100.0%,45m
8985,2,VioletDance,2942,90,3,3,6,50.0%,19m
8985,2,ghost,2942,78,3,3,6,50.0%,1h
8985,2,Overmind,2942,0,0,1,1,0.0%,22m
8985,2,[铃仙二号]望月,2942,0,0,2,2,0.0%,32m
8985,2,[魔法少女小屋]EXmachina,2942,0,0,2,2,0.0%,15m
8997,1,[ETSK]元素,2941,1662,122,121,243,50.2%,26m
8997,1,上饶孙一峰,2941,1648,70,65,135,51.9%,27m
8997,3,wuyuan,2941,1154,69,52,121,57.0%,13m
8997,2,洛丹伦的夜,2941,921,36,30,66,54.5%,12m
8997,2,梦幻迷途之境,2941,789,33,24,57,57.9%,20m
8997,1,[五月花]黄旭西,2941,894,29,31,60,48.3%,16m
8997,3,打吊针,2941,166,10,9,19,52.6%,32m
8997,1,[欧佩克]龙眼,2941,211,6,6,12,50.0%,12m
8997,1,[NXGZ]GoldenWillow,2941,221,5,12,17,29.4%,4m
8997,2,[Conque]龙之魂,2941,90,4,2,6,66.7%,29m
8997,2,香蒲,2941,0,4,4,8,50.0%,1h
8997,2,[暴雪我是你爹]亿万萝莉的身下受,2941,60,3,1,4,75.0%,26m
8997,1,[上帝的叹息]作死骚年,2941,0,3,2,5,60.0%,1h
8997,2,flyinbed,2941,0,1,0,1,100.0%,5m
8997,1,[社交学导教]小豪,2941,0,0,1,1,0.0%,3m
9012,1,[星魂]纪元明,2940,944,33,31,64,51.6%,33m
9012,1,巴西琉斯终成帕夏,2940,564,23,21,44,52.3%,18m
9012,2,kku,2940,548,19,20,39,48.7%,11m
9012,1,Arestronger,2940,409,16,18,34,47.1%,26m
9012,2,[败犬孙一喵]Bunny,2940,206,12,8,20,60.0%,31m
9012,3,AlexChen,2940,205,8,19,27,29.6%,6m
9012,2,这不贪一波,2940,117,5,5,10,50.0%,1h
9012,2,nowhereelse,2940,30,3,3,6,50.0%,8m
9012,2,落雪弥寒,2940,58,2,5,7,28.6%,19m
9012,2,[普残l攻略组]星辉,2940,0,1,0,1,100.0%,16m
9012,2,[Miku骑士]绘梨衣,2940,30,1,1,2,50.0%,12m
9012,2,蕾米莉亚,2940,0,0,1,1,0.0%,19m
9024,1,[CPT]Classic,2939,1543,142,118,260,54.6%,10m
9024,2,[扫黄]妈个鸡泰伦,2939,672,27,25,52,51.9%,38m
9024,1,[炎发灼眼]极梦雅界,2939,570,21,18,39,53.8%,17m
9024,2,偷家吃粑粑吧,2939,328,11,9,20,55.0%,20m
9024,2,[恶劣玩家]波波,2939,220,6,4,10,60.0%,31m
9024,3,[盲人集散中心]deadnickky,2939,173,4,6,10,40.0%,16m
9024,2,[JADE]Geraint,2939,86,3,3,6,50.0%,23m
9024,2,[橘裡橘气]Flowers,2939,30,2,1,3,66.7%,35m
9024,2,[炮火46]FHYZS,2939,113,2,3,5,40.0%,48m
9024,2,Irrational,2939,0,1,1,2,50.0%,36m
9024,2,日天小狗,2939,0,1,2,3,33.3%,39m
9024,2,锐风执剑,2939,0,0,1,1,0.0%,37m
9024,2,cappuccino,2939,0,0,1,1,0.0%,21m
9024,2,堂口兄弟,2939,0,0,2,2,0.0%,6m
9024,1,[TNH]iiiiiiiiiiii,2939,0,0,3,3,0.0%,20m
9024,1,[丨哔哩哔哩丨]James,2939,0,0,4,4,0.0%,10m
9040,3,多喝点,2938,1560,324,313,637,50.9%,5m
9040,2,抗着步枪,2938,993,48,26,74,64.9%,36m
9040,2,Bettye,2938,694,41,27,68,60.3%,33m
9040,2,五位堂家的千金,2938,1019,40,42,82,48.8%,20m
9040,2,我和皇子都有巨龙,2938,554,30,23,53,56.6%,20m
9040,2,[SmartX]将军,2938,321,12,14,26,46.2%,13m
9040,1,[灌灌灌灌0]darkbreak,2938,268,9,6,15,60.0%,32m
9040,1,久安嘉禾,2938,148,6,8,14,42.9%,17m
9040,1,舒克,2938,116,3,3,6,50.0%,22m
9040,2,SiriusSix,2938,86,3,4,7,42.9%,6m
9040,3,白花花,2938,97,2,3,5,40.0%,25m
9040,2,fsweee,2938,30,1,2,3,33.3%,12m
9040,2,[Csquad]任凭这空虚沸腾,2938,0,0,1,1,0.0%,35m
9053,3,灬伊藤亚希子,2937,716,127,133,260,48.8%,26m
9053,2,烂苹果,2937,750,46,33,79,58.2%,19m
9053,1,[炮火46]yingnovation,2937,1100,44,42,86,51.2%,17m
9053,1,Miyazono,2937,850,29,32,61,47.5%,13m
9053,2,shgdjdjh,2937,618,22,22,44,50.0%,6m
9053,1,[GAGA]所谓肉香,2937,422,15,18,33,45.5%,19m
9053,1,[中二谐会]末世,2937,172,5,9,14,35.7%,33m
9053,2,终有弱水替沧海,2937,90,4,2,6,66.7%,23m
9053,2,llllllllllll,2937,58,3,0,3,100.0%,26m
9053,1,矿物储量不足,2937,0,3,2,5,60.0%,48m
9053,1,孫煥佳,2937,0,3,2,5,60.0%,1h
9053,2,Pacino,2937,62,3,4,7,42.9%,6m
9053,1,小东西往哪跑,2937,154,3,6,9,33.3%,27m
9053,1,妈个鸡泰伦,2937,102,3,7,10,30.0%,35m
9053,2,Ophelia,2937,30,2,0,2,100.0%,28m
9053,2,LeoSydney,2937,30,2,2,4,50.0%,32m
9053,2,[暴雪十队]eric,2937,58,2,2,4,50.0%,11m
9053,2,奥丁之子,2937,30,1,1,2,50.0%,5m
9053,3,金刚葫芦娃,2937,38,1,4,5,20.0%,1h
9053,2,myloveg,2937,0,0,1,1,0.0%,35m
9073,3,[超级哈皮]无可取代,2936,1470,159,168,327,48.6%,24m
9073,1,ZHENDEHENGAN,2936,892,53,50,103,51.5%,28m
9073,1,[GJW]stitches,2936,1243,50,50,100,50.0%,35m
9073,1,寓言,2936,501,20,19,39,51.3%,19m
9073,3,[熊大和熊二]一波流大师,2936,392,15,24,39,38.5%,22m
9073,2,鹏锐,2936,232,10,8,18,55.6%,1h
9073,2,naxx,2936,199,7,7,14,50.0%,25m
9073,2,[C91394]Alone,2936,232,7,7,14,50.0%,22m
9073,1,牛法拉,2936,0,3,2,5,60.0%,7m
9073,1,[XXHZ4]nice,2936,119,3,3,6,50.0%,60m
9073,3,条码人,2936,120,2,2,4,50.0%,1h
9073,2,持枪证,2936,0,1,0,1,100.0%,36m
9073,1,影触流觞,2936,89,1,4,5,20.0%,3m
9086,3,小明,2935,1600,828,812,1640,50.5%,7m
9086,3,杨晏,2935,1218,169,158,327,51.7%,16m
9086,3,Askeladd,2935,1038,73,85,158,46.2%,16m
9086,3,[孙红雷]西门坡,2935,97,11,4,15,73.3%,24m
9086,2,[西伯利亚]盗将,2935,187,8,6,14,57.1%,1h
9086,2,ffgi,2935,88,4,2,6,66.7%,11m
9086,2,[赶紧补补水]okb,2935,58,3,0,3,100.0%,29m
9086,1,Nointellect,2935,0,3,2,5,60.0%,22m
9086,2,立陶宛农民,2935,86,3,3,6,50.0%,3m
9086,2,阴郁之风,2935,66,3,3,6,50.0%,22m
9086,2,[YINGJI]龙井茶,2935,30,2,0,2,100.0%,46m
9086,2,[QWQa]小凛敢日坑道虫,2935,62,2,2,4,50.0%,35m
9086,2,落叶落下落地时,2935,0,0,1,1,0.0%,26m
9086,2,烤全羊,2935,0,0,1,1,0.0%,29m
9086,2,种族觉醒,2935,0,0,2,2,0.0%,23m
9086,1,祖国花骨朵,2935,0,0,4,4,0.0%,27m
9102,3,半夜人族全是狗,2934,1567,397,379,776,51.2%,4m
9102,1,shadow,2934,807,33,30,63,52.4%,10m
9102,2,彩笔,2934,626,23,21,44,52.3%,35m
9102,1,我儿子于洋张刚,2934,563,23,21,44,52.3%,10m
9102,2,赛塔姆布里尼,2934,389,15,10,25,60.0%,12m
9102,1,心灵捕手,2934,423,13,19,32,40.6%,24m
9102,3,[中韩好星际]探姬导师,2934,185,10,9,19,52.6%,23m
9102,1,Silence,2934,208,7,9,16,43.8%,22m
9102,1,Triste,2934,236,7,12,19,36.8%,9m
9102,2,谢舜生,2934,119,5,2,7,71.4%,3m
9102,3,SCHS,2934,121,5,4,9,55.6%,15m
9102,2,汝可识得此阵,2934,49,3,5,8,37.5%,23m
9102,1,战狂,2934,66,2,7,9,22.2%,3m
9102,1,小叮当,2934,0,1,0,1,100.0%,32m
9102,2,[陕服]温暖男网友丶,2934,0,1,0,1,100.0%,29m
9102,2,TOTORO,2934,0,1,0,1,100.0%,20m
9102,2,辣味女警黄小色,2934,30,1,1,2,50.0%,6m
9102,2,humen,2934,0,0,2,2,0.0%,38m
9102,2,Nectar,2934,0,0,3,3,0.0%,28m
9121,2,万年船长,2933,801,158,153,311,50.8%,32m
9121,1,[情谊至上]林玙,2933,1210,42,43,85,49.4%,18m
9121,2,艾思徽尔,2933,296,18,9,27,66.7%,11m
9121,2,破岚万丈,2933,470,17,18,35,48.6%,26m
9121,2,mark,2933,364,13,12,25,52.0%,35m
9121,1,ciwei,2933,374,12,14,26,46.2%,18m
9121,2,村正,2933,248,8,5,13,61.5%,36m
9121,3,[血鸦旅馆]圣王,2933,122,6,3,9,66.7%,1h
9121,1,雅思娜,2933,0,4,1,5,80.0%,1h
9121,2,LemonScarlet,2933,136,3,1,4,75.0%,33m
9121,1,Sariel,2933,0,3,1,4,75.0%,20m
9121,1,娱乐至上,2933,0,2,3,5,40.0%,7m
9121,2,[三三教会]IIIIIIIIIIII,2933,0,1,0,1,100.0%,8m
9121,2,SCiVessel,2933,30,1,1,2,50.0%,28m
9121,2,[嘟嘟噜]JAVA,2933,30,1,3,4,25.0%,19m
9121,2,远坂凛,2933,0,0,1,1,0.0%,15m
9121,2,帅到极致就是菜,2933,0,0,1,1,0.0%,35m
9138,1,OguriShun,2932,1644,98,88,186,52.7%,33m
9138,3,lyn,2932,1185,78,84,162,48.1%,19m
9138,1,[海石三叉戟]纠纷的苹果,2932,922,46,45,91,50.5%,3m
9138,3,IIIIIIIIIIII,2932,828,31,42,73,42.5%,7m
9138,2,狂潮丶临天下,2932,607,26,18,44,59.1%,14m
9138,2,geez,2932,652,25,23,48,52.1%,23m
9138,2,荀文若,2932,566,23,20,43,53.5%,26m
9138,2,[不乐意]飞翔煤球炉,2932,302,12,8,20,60.0%,12m
9138,3,脆脆,2932,226,11,9,20,55.0%,19m
9138,3,[咱是老实人]来火的不良,2932,201,8,5,13,61.5%,26m
9138,2,[TCP]Loong,2932,181,7,1,8,87.5%,36m
9138,1,SNNN,2932,166,7,2,9,77.8%,47m
9138,3,我将痛击我的队友,2932,155,6,5,11,54.5%,1h
9138,2,可爱的小跳虫,2932,154,6,6,12,50.0%,35m
9138,1,[火焰雷兽]我有一剑名扶摇,2932,192,6,12,18,33.3%,5m
9138,1,超级无敌范范范,2932,144,5,8,13,38.5%,5m
9138,1,[喵蛋]羊在红尘,2932,0,3,2,5,60.0%,55m
9138,1,[谐星乐园]Enemy,2932,114,3,8,11,27.3%,18m
9138,2,llllllllllll,2932,0,0,1,1,0.0%,36m
9138,2,陨星,2932,0,0,2,2,0.0%,31m
9158,1,榆中三汉,2931,1381,108,82,190,56.8%,22m
9158,1,过段时间,2931,1491,103,95,198,52.0%,27m
9158,3,Taker,2931,1156,101,96,197,51.3%,27m
9158,2,赟丨健,2931,394,14,15,29,48.3%,35m
9158,3,王某人,2931,299,13,11,24,54.2%,11m
9158,2,倔强萝卜,2931,230,12,6,18,66.7%,5m
9158,2,[Ps]DoChocolate,2931,245,11,7,18,61.1%,16m
9158,2,不妥协,2931,263,10,15,25,40.0%,35m
9158,1,Green,2931,223,8,7,15,53.3%,57m
9158,3,黑色之血,2931,146,6,5,11,54.5%,54m
9158,3,[萌佬同好会]szia,2931,97,2,2,4,50.0%,7m
9158,2,眼泪,2931,0,1,0,1,100.0%,37m
9158,2,[银翼之光]查无此人,2931,30,1,1,2,50.0%,3m
9158,3,[FFUC]意呆本呆,2931,0,1,1,2,50.0%,39m
9158,2,hoppop,2931,30,1,5,6,16.7%,23m
9158,2,皮皮猫,2931,0,0,1,1,0.0%,12m
9158,1,入骨相思知不知,2931,0,0,9,9,0.0%,35m
9175,1,[刑事组之虎]龙王赘婿,2930,1279,70,68,138,50.7%,11m
9175,2,不一般的人类,2930,508,18,14,32,56.2%,26m
9175,2,南传兄贵泰伦,2930,334,13,15,28,46.4%,36m
9175,1,[HQX]ZXZXZX,2930,404,11,15,26,42.3%,28m
9175,3,爱丽丝人仙,2930,189,7,6,13,53.8%,36m
9175,3,[创世纪]漆原琉华,2930,157,6,5,11,54.5%,1h
9175,2,艾萌酱,2930,86,6,6,12,50.0%,20m
9175,1,[嘴宗]Terry,2930,145,4,4,8,50.0%,17m
9175,1,[养生会馆]肆谑,2930,0,3,2,5,60.0%,26m
9175,2,骚猪,2930,92,3,3,6,50.0%,23m
9175,1,[残疾人组]Louis,2930,0,2,1,3,66.7%,48m
9175,2,[浪啊浪]苞米地里的黑寡妇,2930,0,0,1,1,0.0%,26m
9187,2,刺茶,2929,458,18,14,32,56.2%,14m
9187,2,乱拳打死老师傅,2929,464,18,19,37,48.6%,46m
9187,1,gwcgxj,2929,235,10,8,18,55.6%,8m
9187,1,[南建盟]兔头人,2929,225,9,8,17,52.9%,27m
9187,2,稽佬,2929,202,8,6,14,57.1%,15m
9187,2,[工程萌男]MagicXM,2929,174,7,3,10,70.0%,11m
9187,2,可爱毒爆喵,2929,164,6,0,6,100.0%,21m
9187,2,嘻哈之韩同学,2929,95,5,6,11,45.5%,5m
9187,2,[嗑药小分队]夜空中最亮的星,2929,0,3,2,5,60.0%,15m
9187,2,[沙星部]sanzy,2929,30,2,3,5,40.0%,26m
9187,2,SuPerMinD,2929,30,1,1,2,50.0%,26m
9187,2,JohnnyQ,2929,30,1,1,2,50.0%,21m
9187,2,[峡谷]我星际逆战版,2929,32,1,2,3,33.3%,6m
9187,2,Lson,2929,0,0,2,2,0.0%,5m
9187,2,Forbormer,2929,0,0,3,3,0.0%,15m
9202,3,[XJTU]star,2928,1278,72,79,151,47.7%,23m
9202,2,NEJFD,2928,1523,64,46,110,58.2%,18m
9202,1,[我开矿了你呢]脑残必死,2928,1164,61,60,121,50.4%,11m
9202,2,秦梦轩,2928,322,14,11,25,56.0%,5m
9202,2,cross,2928,208,8,6,14,57.1%,29m
9202,2,IIIIIIIIIIII,2928,153,5,2,7,71.4%,26m
9202,2,[异形入侵]炫月,2928,0,4,1,5,80.0%,1h
9202,2,[一起单推小狗]人菜瘾大,2928,88,4,1,5,80.0%,29m
9202,3,[QRADIO]IIIlIlIIIlII,2928,166,4,2,6,66.7%,1h
9202,1,燃魂,2928,196,4,7,11,36.4%,44m
9202,2,ProRandom,2928,120,4,8,12,33.3%,29m
9202,2,[辩证法]徐政委遛弯,2928,60,3,1,4,75.0%,17m
9202,2,[AdamxL]臉基尼,2928,30,2,1,3,66.7%,26m
9202,2,[lyg一生追]雪域山鹰,2928,0,1,0,1,100.0%,20m
9202,2,zzjR,2928,30,1,1,2,50.0%,12m
9202,1,地锅排骨,2928,0,1,2,3,33.3%,33m
9202,1,[萌萌萌萌萌]狗粮,2928,0,1,4,5,20.0%,24m
9202,2,[幽灵军校]Yalic,2928,0,0,2,2,0.0%,11m
9202,2,Visnu,2928,0,0,2,2,0.0%,10m
9221,3,薛涛,2927,1407,179,189,368,48.6%,26m
9221,2,千夜绯罗,2927,993,75,63,138,54.3%,20m
9221,1,[NLD]Catch,2927,506,16,19,35,45.7%,34m
9221,2,[神智无知]杨永信,2927,322,13,6,19,68.4%,36m
9221,2,呆呆,2927,320,13,12,25,52.0%,36m
9221,1,Beimoy,2927,287,13,14,27,48.1%,5m
9221,2,Fantastic,2927,300,12,7,19,63.2%,16m
9221,2,鹦鹉螺中螺,2927,146,6,4,10,60.0%,20m
9221,1,老王大人,2927,92,1,5,6,16.7%,8m
9221,1,[Canton]莫作栋,2927,0,0,1,1,0.0%,20m
9231,1,zhangyy,2926,848,78,64,142,54.9%,10m
9231,3,言笑,2926,1525,60,68,128,46.9%,6m
9231,1,[僵尸博士牛X]小小饼干,2926,627,25,22,47,53.2%,27m
9231,2,[艾尔高等星灵]影之梦魇,2926,225,8,3,11,72.7%,3m
9231,1,丨丨丨丨丨丨丨丨,2926,331,8,13,21,38.1%,33m
9231,2,Mocolisk,2926,179,5,5,10,50.0%,29m
9231,2,[大健王朝]幻冰寒月,2926,155,4,2,6,66.7%,26m
9231,2,九天凡尘,2926,86,3,3,6,50.0%,22m
9231,2,[諳魇]zxc,2926,58,2,2,4,50.0%,20m
9231,2,游佐,2926,0,1,0,1,100.0%,6m
9231,2,[沙星部]冷艳全欺雪,2926,0,1,0,1,100.0%,22m
9231,2,小客,2926,0,1,0,1,100.0%,18m
9231,2,鲥鱼不是鱼,2926,0,0,1,1,0.0%,20m
9231,3,[谁在呼叫舰队]逼格之王,2926,0,0,1,1,0.0%,1h
9231,2,[镜花水月丨]演员不该演,2926,0,0,1,1,0.0%,3m
9231,1,[93589]bow,2926,0,0,2,2,0.0%,1h
9247,3,六六六六六六老黄,2925,953,158,149,307,51.5%,4m
9247,2,adidas,2925,1473,70,45,115,60.9%,23m
9247,1,[萌M]与圣光作对,2925,754,52,49,101,51.5%,16m
9247,1,老年二五仔,2925,530,45,43,88,51.1%,10m
9247,1,Demon,2925,809,31,36,67,46.3%,3m
9247,2,鸡贼哥,2925,506,23,15,38,60.5%,21m
9247,2,虐的就是你,2925,520,20,16,36,55.6%,33m
9247,2,萌受,2925,418,17,12,29,58.6%,33m
9247,2,[MiRacL]fringe,2925,278,12,4,16,75.0%,23m
9247,2,欣舞东风,2925,164,4,3,7,57.1%,8m
9247,1,lilian,2925,140,4,10,14,28.6%,30m
9247,2,Dov,2925,60,3,2,5,60.0%,21m
9247,2,zwzwzwz,2925,76,3,3,6,50.0%,15m
9247,2,[Anonym]Level,2925,62,3,4,7,42.9%,32m
9247,2,暗影之龙,2925,20,2,2,4,50.0%,23m
9247,2,镜花水月,2925,58,2,4,6,33.3%,22m
9247,2,睾处不胜含,2925,0,1,0,1,100.0%,22m
9247,1,Aquarius,2925,40,1,6,7,14.3%,32m
9247,1,[极限菜鸟]水院你东哥,2925,0,0,1,1,0.0%,54m
9266,1,[全线开花]虚空充能完毕,2924,792,53,50,103,51.5%,31m
9266,2,糙子,2924,912,44,31,75,58.7%,11m
9266,2,[璀璨群星之刃]INGsunyu,2924,506,18,17,35,51.4%,29m
9266,2,治愈你毛病,2924,440,17,13,30,56.7%,35m
9266,2,[不怕念起]孙浩淼,2924,340,14,8,22,63.6%,15m
9266,1,[不灭青铜]菜鸟,2924,383,14,13,27,51.9%,4m
9266,2,[星际马保国]黄旭东的儿子,2924,303,11,7,18,61.1%,1h
9266,1,库艾库拉楚,2924,171,10,12,22,45.5%,17m
9266,2,Halloween,2924,161,9,6,15,60.0%,26m
9266,1,[盲眼钟表匠]ZestySky,2924,268,8,11,19,42.1%,18m
9266,1,[不打虫族内战]长泽雅美,2924,200,6,11,17,35.3%,7m
9266,2,[星绘]麻麻,2924,162,5,2,7,71.4%,14m
9266,3,ROxxxE,2924,144,4,1,5,80.0%,36m
9266,2,[盲人村鸡窝]Georgeking,2924,154,4,3,7,57.1%,26m
9266,1,玻璃心的媽寶,2924,48,4,4,8,50.0%,9m
9266,3,[2233娘]掐柠檬的帕露西,2924,97,4,4,8,50.0%,1h
9266,2,钱噜噜,2924,0,3,1,4,75.0%,1h
9266,2,峨眉峰,2924,0,3,2,5,60.0%,1h
9266,1,wenbaba,2924,70,3,8,11,27.3%,33m
9266,2,我带你们打,2924,0,1,0,1,100.0%,28m
9266,2,嘤嘤怪,2924,0,1,0,1,100.0%,1h
9287,1,LOL,2923,1645,128,119,247,51.8%,35m
9287,2,风火雷电走,2923,416,73,62,135,54.1%,32m
9287,1,庄严的执法者,2923,1450,72,73,145,49.7%,13m
9287,1,clem,2923,820,41,31,72,56.9%,28m
9287,2,吴翰,2923,499,18,11,29,62.1%,14m
9287,3,DackStar,2923,530,17,35,52,32.7%,22m
9287,3,开塞露,2923,329,14,10,24,58.3%,15m
9287,2,zhttty,2923,322,13,6,19,68.4%,23m
9287,2,许某人,2923,253,11,9,20,55.0%,29m
9287,2,[s金色玫瑰s]xuese,2923,268,9,6,15,60.0%,38m
9287,2,麋露露只会乱玩,2923,228,7,6,13,53.8%,15m
9287,1,紫衫,2923,129,5,2,7,71.4%,46m
9287,2,小洛克侠,2923,162,5,7,12,41.7%,38m
9287,2,slassddd,2923,132,4,1,5,80.0%,35m
9287,1,艾尔越挫越勇,2923,97,4,2,6,66.7%,32m
9287,1,EnumaElish,2923,97,4,3,7,57.1%,1h
9287,2,Jason,2923,88,4,5,9,44.4%,11m
9287,1,[圣德怀特学园]lucifer,2923,187,4,8,12,33.3%,25m
9287,2,Kisshot,2923,0,3,2,5,60.0%,58m
9287,3,[4Aiur]轻风,2923,95,1,3,4,25.0%,3m
9307,1,馒头就是力量,2922,1634,117,122,239,49.0%,32m
9307,2,幽夜灬悬空,2922,397,16,11,27,59.3%,20m
9307,2,這一代的非凡,2922,0,4,1,5,80.0%,1h
9307,2,[YH]八云蓝,2922,0,1,0,1,100.0%,32m
9307,2,[烽夜长歌]agadg,2922,30,1,4,5,20.0%,32m
9307,2,[跟我们混]晓天,2922,0,0,1,1,0.0%,26m
9313,2,风云,2921,1492,642,630,1272,50.5%,23m
9313,3,Thiswolf,2921,1479,111,121,232,47.8%,23m
9313,3,[Esc]逊神,2921,1583,80,88,168,47.6%,4m
9313,2,不会开矿,2921,441,51,36,87,58.6%,22m
9313,2,[IGS]llllllllllll,2921,570,22,21,43,51.2%,46m
9313,1,哦不住,2921,548,22,21,43,51.2%,13m
9313,1,CHAOS,2921,318,13,19,32,40.6%,8m
9313,2,幸运馨月,2921,292,11,8,19,57.9%,6m
9313,2,天怒,2921,142,7,4,11,63.6%,39m
9313,3,[GCT]以和为贵,2921,177,7,7,14,50.0%,1h
9313,2,Hades,2921,176,5,4,9,55.6%,39m
9313,1,[花樣作死冠軍]闪耀的白菜,2921,64,5,6,11,45.5%,18m
9313,2,伏地魔王,2921,86,4,2,6,66.7%,8m
9313,1,只会这一招,2921,97,4,3,7,57.1%,11m
9313,1,天梯战神,2921,148,4,10,14,28.6%,34m
9313,2,叶却邪,2921,0,3,2,5,60.0%,1h
9313,2,太哈人了,2921,0,3,2,5,60.0%,1h
9313,2,Tany,2921,121,3,5,8,37.5%,14m
9313,2,就捏孙铮,2921,30,2,1,3,66.7%,15m
9313,2,[萌虫争霸]小西瓜打天下,2921,0,1,0,1,100.0%,1h
9313,2,巴蜀腐夫张发强,2921,0,1,1,2,50.0%,16m
9313,2,[风云天下]百晓生,2921,0,1,2,3,33.3%,33m
9313,2,少年之心,2921,0,1,3,4,25.0%,36m
9313,2,[黄旭东说]你的优势很大,2921,0,0,1,1,0.0%,36m
9313,2,[GooLuk]llll,2921,0,0,1,1,0.0%,26m
9338,3,[一群谐星]星际漫游者,2920,1589,290,288,578,50.2%,20m
9338,1,[GOTAL]烨殒,2920,1544,65,66,131,49.6%,23m
9338,2,zzlhb,2920,816,58,53,111,52.3%,22m
9338,2,饼干,2920,1030,46,36,82,56.1%,36m
9338,2,冬雨冬雨不下雨,2920,972,37,35,72,51.4%,37m
9338,3,做个吃货呀,2920,289,13,11,24,54.2%,8m
9338,2,war,2920,358,13,16,29,44.8%,21m
9338,1,KelvinsTem,2920,322,12,10,22,54.5%,26m
9338,2,会钓鱼的猫昕,2920,306,10,6,16,62.5%,16m
9338,1,两矿一憋炸断肠,2920,206,7,10,17,41.2%,7m
9338,1,[都是二五仔]嘤嘤嘤,2920,244,7,13,20,35.0%,7m
9338,1,[猛的一B]冷大侠,2920,202,6,11,17,35.3%,34m
9338,2,[华文中学]ASDUH,2920,154,5,2,7,71.4%,14m
9338,2,[NPUED]ShauN,2920,144,5,5,10,50.0%,21m
9338,2,宇智波鼬,2920,42,5,5,10,50.0%,1h
9338,2,[大疯狗]兄弟别走再打会儿,2920,126,4,0,4,100.0%,38m
9338,1,[基础楼]侦测到在途的氢弹,2920,48,4,3,7,57.1%,11m
9338,2,[CHP]久皇叔,2920,0,3,2,5,60.0%,52m
9338,2,LEO,2920,0,1,0,1,100.0%,35m
9338,1,鲍之晨,2920,0,1,0,1,100.0%,25m
9338,2,[德哈卡神教]戏中人,2920,0,1,0,1,100.0%,12m
9338,2,knighttheone,2920,0,0,1,1,0.0%,12m
9338,2,[二中星际男孩]雨夜,2920,0,0,2,2,0.0%,39m
9361,2,[Fetter]NexusNoah,2919,697,82,72,154,53.2%,13m
9361,1,[TJMU]虚空自由之心,2919,1174,67,54,121,55.4%,17m
9361,1,love,2919,1096,56,52,108,51.9%,35m
9361,2,[NSG致一]小猪爱睡觉,2919,1235,51,44,95,53.7%,18m
9361,1,[最菜战队]京烟忘宇,2919,799,30,26,56,53.6%,26m
9361,1,夏天,2919,352,13,14,27,48.1%,9m
9361,1,[白给了]llllll,2919,237,8,9,17,47.1%,3m
9361,2,陕西孙一峰,2919,174,5,3,8,62.5%,26m
9361,1,[繁花落尽]西行寺幽幽子,2919,48,5,3,8,62.5%,20m
9361,2,yaomeng,2919,0,3,2,5,60.0%,36m
9361,3,[斩月]天下第一呆,2919,0,1,1,2,50.0%,39m
9372,1,申时行,2918,1549,260,250,510,51.0%,18m
9372,1,接化发,2918,929,231,214,445,51.9%,34m
9372,1,[闭嘴基佬]SDDDDDDDDDGG,2918,1419,105,105,210,50.0%,10m
9372,2,龙少若星,2918,1380,60,47,107,56.1%,46m
9372,1,年轻人不讲武德,2918,1068,41,44,85,48.2%,26m
9372,3,弦之奏,2918,1027,40,43,83,48.2%,7m
9372,2,[文韬武略]小怪兽,2918,644,34,32,66,51.5%,31m
9372,1,打星际你快乐吗,2918,653,28,24,52,53.8%,23m
9372,2,芹泽多摩雄,2918,506,19,16,35,54.3%,14m
9372,2,淡雅儒风,2918,357,14,14,28,50.0%,5m
9372,2,hsh,2918,218,13,9,22,59.1%,3m
9372,2,[XXHZ21]旭东之考验,2918,262,10,4,14,71.4%,32m
9372,2,MiRoiR,2918,146,6,6,12,50.0%,1h
9372,3,younggzzheng,2918,121,5,4,9,55.6%,1h
9372,2,[TAK]SamAir,2918,0,4,1,5,80.0%,46m
9372,1,[罗马方标]秋色咕噜,2918,97,4,3,7,57.1%,7m
9372,1,摇滚男孩,2918,97,4,3,7,57.1%,40m
9372,2,[我棱镜掉了]Rether,2918,112,2,1,3,66.7%,39m
9372,2,Rous,2918,60,2,3,5,40.0%,32m
9372,2,古明地盆,2918,0,1,0,1,100.0%,38m
9372,2,迈克尔,2918,0,0,2,2,0.0%,28m
9372,1,良澄,2918,0,0,2,2,0.0%,1h
9394,1,Sirius,2917,1644,166,160,326,50.9%,17m
9394,2,不怕神一样的对手,2917,676,83,67,150,55.3%,36m
9394,2,咩咩羊,2917,1458,55,58,113,48.7%,26m
9394,2,AlphaStar,2917,643,32,35,67,47.8%,35m
9394,2,Sky,2917,409,25,19,44,56.8%,23m
9394,1,water,2917,670,21,28,49,42.9%,19m
9394,3,穆雪暗影,2917,335,13,11,24,54.2%,3m
9394,3,[Mirana]米拉娜月影,2917,285,12,13,25,48.0%,8m
9394,3,[北京大学鸡协]左泉乾坤,2917,271,11,12,23,47.8%,13m
9394,2,阿毛叔,2917,286,9,8,17,52.9%,22m
9394,2,凤羽,2917,142,6,7,13,46.2%,24m
9394,1,宙斯的怒涛,2917,183,5,5,10,50.0%,1h
9394,3,[第八舰队丶]迷途坊,2917,143,4,1,5,80.0%,1h
9394,1,JamousJi,2917,144,4,1,5,80.0%,1h
9394,2,破坏神,2917,0,3,2,5,60.0%,15m
9394,2,命缘,2917,0,3,2,5,60.0%,1h
9394,2,clem,2917,30,2,0,2,100.0%,31m
9394,1,卢本伟,2917,111,2,4,6,33.3%,1h
9394,2,蛤蛤铪,2917,0,1,0,1,100.0%,29m
9394,2,宇月麻里奈,2917,0,0,1,1,0.0%,26m
9414,3,Pimba,2916,753,86,101,187,46.0%,16m
9414,1,[艾尔之主]waiyinhehao,2916,1417,56,58,114,49.1%,33m
9414,1,Elijah,2916,345,54,29,83,65.1%,10m
9414,1,果师,2916,1084,38,39,77,49.4%,3m
9414,1,Dartagnan,2916,726,35,26,61,57.4%,10m
9414,2,ShaDow,2916,833,34,34,68,50.0%,20m
9414,1,CleanProtoss,2916,622,21,25,46,45.7%,7m
9414,2,虫山虫海,2916,396,16,9,25,64.0%,19m
9414,2,辣鸡暴雪还我星际,2916,278,10,9,19,52.6%,30m
9414,2,[黑牧涯]THEONE,2916,153,10,12,22,45.5%,37m
9414,2,[Rhusky]Tianbian,2916,156,5,11,16,31.2%,1h
9414,1,西尔维娅,2916,48,4,3,7,57.1%,1h
9414,3,锦衣夜行,2916,0,1,0,1,100.0%,1h
9414,2,[玄梦丶樱雪]魔王雪,2916,0,1,0,1,100.0%,23m
9414,2,[写进诗的结尾]七里香,2916,0,1,0,1,100.0%,21m
9414,2,KNGG,2916,30,1,1,2,50.0%,36m
9414,1,[B站星际小德]老面包啊,2916,0,0,1,1,0.0%,1h
9414,1,[夜羊社]月社妃,2916,0,0,1,1,0.0%,10m
9414,2,Exia,2916,0,0,4,4,0.0%,1h
9433,2,[小鸡屠宰场4]Minecraft,2915,669,28,24,52,53.8%,36m
9433,1,三零柒亲友团,2915,560,21,23,44,47.7%,33m
9433,2,海绵丶乐宝宝,2915,472,18,13,31,58.1%,12m
9433,2,随便玩玩,2915,395,17,10,27,63.0%,12m
9433,3,Song,2915,185,9,3,12,75.0%,54m
9433,2,[天羽不榖]程诺的毁志,2915,228,9,4,13,69.2%,22m
9433,1,Showserral,2915,150,5,11,16,31.2%,23m
9433,2,飞机大官人,2915,146,4,1,5,80.0%,33m
9433,2,MarsAirgemo,2915,86,4,3,7,57.1%,31m
9433,2,葫芦娃,2915,84,4,5,9,44.4%,21m
9433,2,[为了天灾军团]镜花水月,2915,124,4,5,9,44.4%,35m
9433,2,[透一下清酒]喜欢小郑同学,2915,88,3,3,6,50.0%,27m
9433,1,恩赐姐脱,2915,45,2,0,2,100.0%,1h
9433,2,[MOOOON]帅帅的小罗,2915,94,2,1,3,66.7%,1h
9433,2,醉笑苍天,2915,60,2,4,6,33.3%,21m
9433,1,[丷国民情夫丷]霸霸,2915,0,1,0,1,100.0%,24m
9433,1,[萌新爱萌]zyhgmy,2915,0,1,5,6,16.7%,31m
9433,1,天晴,2915,88,1,6,7,14.3%,18m
9451,3,猥琐大叔,2914,1339,166,176,342,48.5%,10m
9451,1,[丶花]snake,2914,758,49,54,103,47.6%,33m
9451,1,Pleaseruinme,2914,294,27,24,51,52.9%,11m
9451,1,暴躁的卫生纸,2914,464,20,18,38,52.6%,20m
9451,2,Osia,2914,121,12,10,22,54.5%,15m
9451,2,即将爆发,2914,314,12,13,25,48.0%,6m
9451,1,krad,2914,182,9,6,15,60.0%,1h
9451,2,[鸡变体]Celiever,2914,124,5,7,12,41.7%,5m
9451,2,culmings,2914,30,2,1,3,66.7%,39m
9451,1,昊昊,2914,92,2,2,4,50.0%,46m
9451,1,纯乾三,2914,0,1,1,2,50.0%,34m
9451,2,我呐喊啊啊,2914,0,1,1,2,50.0%,1h
9451,2,久下,2914,91,1,3,4,25.0%,1h
9451,2,[贪玩]Ramsey,2914,30,1,3,4,25.0%,20m
9451,2,名字好难取,2914,0,0,1,1,0.0%,36m
9451,2,[云散无踪]漂流的云,2914,0,0,1,1,0.0%,24m
9451,2,yun,2914,0,0,3,3,0.0%,22m
9468,3,koko,2913,1559,181,182,363,49.9%,22m
9468,1,流良,2913,1619,122,105,227,53.7%,17m
9468,3,[南湖匈奴]回忆始终是回忆,2913,1543,111,107,218,50.9%,24m
9468,3,拜见女王大人,2913,1205,59,72,131,45.0%,27m
9468,1,TZP,2913,724,34,28,62,54.8%,10m
9468,2,[我是一只机]王子涵,2913,539,22,15,37,59.5%,3m
9468,2,[斯巴达血战团]peanut,2913,572,20,18,38,52.6%,36m
9468,2,无悔孤玖,2913,268,16,13,29,55.2%,37m
9468,1,只玩一波流,2913,335,11,12,23,47.8%,5m
9468,2,赤佬,2913,174,7,6,13,53.8%,12m
9468,1,夜航星,2913,228,7,9,16,43.8%,7m
9468,1,TerRin,2913,97,4,3,7,57.1%,46m
9468,2,ARTHUR,2913,78,3,5,8,37.5%,36m
9468,2,一只小菜鸡,2913,30,2,0,2,100.0%,39m
9468,2,邪恶的大香蕉,2913,0,2,3,5,40.0%,17m
9468,3,Showshowtime,2913,0,1,0,1,100.0%,4m
9468,2,屯长,2913,30,1,3,4,25.0%,16m
9468,2,[STARV]look,2913,34,1,4,5,20.0%,6m
9468,2,LuRenZhu,2913,0,0,1,1,0.0%,11m
9468,2,自由之翼,2913,0,0,1,1,0.0%,17m
9468,2,诸司马迹,2913,0,0,3,3,0.0%,21m
9489,3,[英雄协会]骑士的称号,2912,1215,141,139,280,50.4%,10m
9489,2,steven,2912,706,102,92,194,52.6%,12m
9489,2,夜沐风,2912,1171,49,49,98,50.0%,15m
9489,1,[暴雪我是你爹]津门孙一峰,2912,1055,40,35,75,53.3%,18m
9489,2,llllllllllll,2912,727,29,23,52,55.8%,39m
9489,2,要你命三千,2912,444,17,17,34,50.0%,39m
9489,2,OFU,2912,376,14,13,27,51.9%,32m
9489,2,Fish,2912,256,10,9,19,52.6%,26m
9489,2,[航向黎明]LCY,2912,0,4,1,5,80.0%,54m
9489,1,Landgrave,2912,97,4,3,7,57.1%,7m
9489,2,Air,2912,0,3,2,5,60.0%,1h
9489,2,[LKJ789]啦啦啦,2912,94,3,6,9,33.3%,10m
9489,2,史彼得羊,2912,30,2,1,3,66.7%,36m
9489,2,lhy,2912,58,2,2,4,50.0%,11m
9489,1,cyhsss,2912,0,2,4,6,33.3%,11m
9489,2,[你下面凉快吗]龙逆天,2912,0,1,0,1,100.0%,3m
9489,2,泥头车,2912,0,1,0,1,100.0%,21m
9489,2,[北京肥宅]Tomerbaiwu,2912,34,1,1,2,50.0%,22m
9489,2,[太狠了]太狠了,2912,30,1,1,2,50.0%,3m
9489,2,[熊人永不为奴]Loner,2912,0,0,1,1,0.0%,3m
9489,2,bogy,2912,0,0,3,3,0.0%,12m
9489,2,打死了鞭尸,2912,0,0,3,3,0.0%,19m
9511,1,[逆子天团]接化发,2911,1445,99,84,183,54.1%,35m
9511,2,[fvv]好想睡觉,2911,1448,95,72,167,56.9%,36m
9511,2,[秋毫]绝境只能想到坦克,2911,1025,45,28,73,61.6%,27m
9511,2,[小鸡屠宰场3]幻瞬,2911,858,34,27,61,55.7%,29m
9511,2,蚂蚁,2911,272,21,18,39,53.8%,35m
9511,2,WSK,2911,182,6,7,13,46.2%,10m
9511,1,[咸鱼大家庭]躺着赢的咸鱼,2911,184,5,3,8,62.5%,1h
9511,2,[抹除开始]潶絪緂鸮,2911,182,5,3,8,62.5%,23m
9511,2,吟魂何归,2911,116,2,2,4,50.0%,28m
9511,1,幽冥神刺,2911,97,2,5,7,28.6%,1h
9511,2,米拉波利亚斯,2911,0,1,1,2,50.0%,36m
9511,2,清风柒墨琉璃夏,2911,97,1,4,5,20.0%,18m
9511,2,Elysion,2911,0,0,1,1,0.0%,5m
9511,1,FZhu,2911,0,0,1,1,0.0%,1h
9511,2,[大哥勘探谐会]桥本环奈天下第一,2911,0,0,3,3,0.0%,39m
9526,2,玉帝,2910,709,75,62,137,54.7%,36m
9526,2,[星战分部]Misakimei,2910,1401,66,61,127,52.0%,30m
9526,2,[无魂之鸭]暴打狗儿,2910,568,47,36,83,56.6%,35m
9526,1,[秋毫七队]朱灿,2910,575,30,28,58,51.7%,20m
9526,1,[海德单推协会]做虫虫好累鸭,2910,440,21,18,39,53.8%,16m
9526,1,[青铜星友汇]美利坚合众国,2910,586,17,22,39,43.6%,33m
9526,3,一只阴险的咩,2910,0,5,2,7,71.4%,4m
9526,2,[KUEL]llllllllllll,2910,0,4,1,5,80.0%,1h
9526,1,阿炜,2910,0,4,2,6,66.7%,1h
9526,2,hgvy,2910,158,4,9,13,30.8%,8m
9526,2,Sphielard,2910,30,2,3,5,40.0%,37m
9526,1,[我是萌新Q]雾雨爱丽丝,2910,74,2,8,10,20.0%,17m
9526,2,[刺蛇单推协会]trtzh,2910,0,0,1,1,0.0%,35m
9526,2,西湖溅狼,2910,0,0,2,2,0.0%,32m
9526,2,lyhcaipi,2910,0,0,2,2,0.0%,7m
9526,2,我要上三千分,2910,0,0,4,4,0.0%,11m
9542,1,[百战百败]诛文丑,2909,1314,59,56,115,51.3%,9m
9542,3,Twilight,2909,1030,36,49,85,42.4%,6m
9542,3,Atherine,2909,625,26,26,52,50.0%,36m
9542,1,枪兵推销员,2909,666,23,24,47,48.9%,27m
9542,2,[Holygl]世界第二公主殿下,2909,252,10,10,20,50.0%,26m
9542,2,[残梦之忆]afaasfsa,2909,232,8,10,18,44.4%,32m
9542,2,[长夜将至]柠檬琉璃夏,2909,0,3,2,5,60.0%,23m
9542,2,不知道为什么,2909,0,3,2,5,60.0%,12m
9542,2,电脑,2909,60,2,2,4,50.0%,35m
9542,2,高温帅,2909,0,2,3,5,40.0%,1h
9542,2,mdzz,2909,0,0,1,1,0.0%,22m
9542,2,克尔苏加德,2909,0,0,3,3,0.0%,24m
9554,3,llllllllllll,2908,1501,784,779,1563,50.2%,24m
9554,2,MeOwSirrr,2908,1136,98,94,192,51.0%,16m
9554,1,乞龍,2908,1226,68,67,135,50.4%,35m
9554,2,年老老主宰,2908,314,27,16,43,62.8%,21m
9554,2,小小棉花糖,2908,524,22,13,35,62.9%,12m
9554,2,叮叮当当,2908,297,14,9,23,60.9%,36m
9554,2,子兮不懂人族,2908,285,9,9,18,50.0%,6m
9554,1,哔哩哔哩丶竹萧,2908,0,5,1,6,83.3%,1h
9554,1,[粑粑雄吃粑粑]realbird,2908,116,4,3,7,57.1%,52m
9554,2,[快乐白给]菲尼克斯,2908,112,3,0,3,100.0%,27m
9554,2,Ryan,2908,30,2,0,2,100.0%,19m
9554,2,星球基地,2908,0,2,0,2,100.0%,1h
9554,2,[四叶草]xyxyxyxyxy,2908,0,1,0,1,100.0%,15m
9554,2,[整编74师]总有刁民想害孤,2908,30,1,4,5,20.0%,11m
9554,2,青铜宅男,2908,0,0,1,1,0.0%,6m
9554,1,水墨江山,2908,0,0,1,1,0.0%,42m
9554,2,樱岛麻衣,2908,0,0,1,1,0.0%,11m
9554,2,雾雨魔理沙,2908,0,0,1,1,0.0%,19m
9572,1,[刺客槶]海阔天空,2907,1474,76,72,148,51.4%,30m
9572,1,[火焰雷兽]JiNoVaTion,2907,862,35,32,67,52.2%,11m
9572,2,紫竹,2907,619,34,20,54,63.0%,35m
9572,2,雏凤峰,2907,760,33,23,56,58.9%,14m
9572,2,maru,2907,688,26,25,51,51.0%,36m
9572,2,llllllllllll,2907,440,20,7,27,74.1%,38m
9572,2,会飞的猪,2907,222,9,7,16,56.2%,22m
9572,2,IIIIIIIIIIII,2907,180,7,2,9,77.8%,38m
9572,1,[注意防守]黑桐,2907,145,5,4,9,55.6%,4m
9572,1,[Aforce]Dreamboy,2907,94,5,5,10,50.0%,1h
9572,2,达芬蛋壳,2907,84,5,5,10,50.0%,38m
9572,1,万俟凌懿,2907,96,5,5,10,50.0%,25m
9572,2,[牡丹花]Kiss,2907,0,4,1,5,80.0%,53m
9572,2,[搞毛啊]dalaoqiudai,2907,0,4,1,5,80.0%,53m
9572,2,熊爷,2907,116,4,4,8,50.0%,28m
9572,2,魂殇,2907,49,4,6,10,40.0%,26m
9572,2,暗鸦之殇绝灭,2907,126,3,2,5,60.0%,18m
9572,2,[最菜战队]不知春去,2907,126,3,2,5,60.0%,3m
9572,3,[Months]IIIIIIIIII,2907,143,3,2,5,60.0%,1h
9572,2,炸鱼狗死妈,2907,30,2,0,2,100.0%,6m
9572,3,风暴之怒,2907,97,2,6,8,25.0%,36m
9572,1,LittleSoft,2907,0,1,0,1,100.0%,1h
9572,2,apofh,2907,0,0,1,1,0.0%,3m
9572,2,鑫晗,2907,0,0,1,1,0.0%,29m
9572,2,暗影猎手,2907,0,0,3,3,0.0%,39m
9597,3,范海辛,2906,1576,58,61,119,48.7%,33m
9597,2,[全国修车]flydragon,2906,633,29,16,45,64.4%,3m
9597,2,SalemXL,2906,170,10,10,20,50.0%,26m
9597,1,[SCVF2]未知目标,2906,320,9,16,25,36.0%,11m
9597,2,折扣,2906,176,7,6,13,53.8%,10m
9597,2,NewBee,2906,150,4,3,7,57.1%,1h
9597,3,fearless,2906,0,4,4,8,50.0%,1h
9597,2,FOX,2906,0,3,2,5,60.0%,9m
9597,2,[比心老子爱你]xiaomi,2906,128,3,8,11,27.3%,25m
9597,2,试试水,2906,0,1,0,1,100.0%,12m
9597,2,[赞美生物质]RushB,2906,0,1,0,1,100.0%,33m
9597,2,[BGD]asdfghjkl,2906,0,1,0,1,100.0%,1h
9597,2,[星际黄旭东]几何,2906,0,1,1,2,50.0%,5m
9597,2,注册大师,2906,30,1,4,5,20.0%,16m
9597,1,Marian,2906,0,0,1,1,0.0%,1h
9597,2,[天津北洋大学]Line,2906,0,0,2,2,0.0%,3m
9597,2,[民主自由]无所谓,2906,0,0,4,4,0.0%,16m
9614,2,迷失,2905,790,29,32,61,47.5%,6m
9614,2,牛刀小试,2905,277,27,21,48,56.2%,17m
9614,3,虫族我是你爹,2905,351,13,19,32,40.6%,11m
9614,3,[冲就完了]零九二号陆战队员,2905,194,7,5,12,58.3%,42m
9614,2,[古明地瓜]不愿露面的觉妖怪,2905,216,7,9,16,43.8%,33m
9614,2,[流氓高手]晨鸣,2905,204,6,5,11,54.5%,23m
9614,1,陌欢,2905,146,4,7,11,36.4%,8m
9614,3,lihai,2905,119,3,1,4,75.0%,1h
9614,2,realbin,2905,0,3,2,5,60.0%,26m
9614,2,VIRGINIA,2905,36,1,3,4,25.0%,39m
9614,2,顾影自怜,2905,30,1,4,5,20.0%,21m
9614,2,[旭东白丝圣奶]绘梨,2905,30,1,6,7,14.3%,33m
9614,2,[黑长直赛高]霞之丘诗羽,2905,0,0,1,1,0.0%,35m
9614,2,流恋,2905,0,0,1,1,0.0%,3m
9614,2,IIIIII,2905,0,0,4,4,0.0%,8m
9629,3,Aspcoder,2904,983,58,67,125,46.4%,20m
9629,3,fdddk,2904,485,23,31,54,42.6%,39m
9629,2,变成娜哈特的狗,2904,331,17,10,27,63.0%,35m
9629,1,洛神,2904,494,16,21,37,43.2%,18m
9629,2,无情的注卵机器,2904,426,15,14,29,51.7%,3m
9629,1,[LHZ]叶知恩的莓籽儿,2904,498,15,17,32,46.9%,17m
9629,1,鳌头满,2904,372,11,16,27,40.7%,3m
9629,3,AlphaClock,2904,194,8,9,17,47.1%,9m
9629,3,[酒问青天]月山,2904,173,6,2,8,75.0%,26m
9629,1,oyoy,2904,162,5,4,9,55.6%,17m
9629,2,我叫波波,2904,60,3,2,5,60.0%,13m
9629,2,[MYC]YouDareDogMe,2904,30,2,1,3,66.7%,22m
9629,3,Lss,2904,121,2,2,4,50.0%,32m
9629,2,[ISMU星际]innovation,2904,36,2,3,5,40.0%,39m
9629,2,飞翔的猪,2904,0,0,1,1,0.0%,46m
9629,3,孤独成性,2904,0,0,1,1,0.0%,1h
9629,2,[瘾大眼瞎]星雨,2904,0,0,1,1,0.0%,36m
9646,1,虫巢霸主,2903,1230,80,78,158,50.6%,10m
9646,2,最强女友,2903,388,23,23,46,50.0%,20m
9646,2,暴躁的风,2903,436,18,15,33,54.5%,3m
9646,1,feilong,2903,522,15,26,41,36.6%,11m
9646,2,IIIIIIIII,2903,317,13,7,20,65.0%,14m
9646,3,[北京大学鸡协]Stats,2903,332,13,11,24,54.2%,24m
9646,2,comeX,2903,279,9,9,18,50.0%,37m
9646,2,不懂输,2903,69,6,6,12,50.0%,15m
9646,1,Dzq,2903,216,6,9,15,40.0%,26m
9646,2,[ASMR]马杀鸡神族,2903,120,4,4,8,50.0%,33m
9646,2,Furck,2903,90,4,5,9,44.4%,12m
9646,2,星际争妈,2903,0,1,1,2,50.0%,12m
9646,2,[星之所在RI]因蟠月夜,2903,0,1,2,3,33.3%,21m
9646,2,弱小的普洛陀斯,2903,32,1,5,6,16.7%,13m
9646,2,George,2903,0,0,1,1,0.0%,36m
9646,2,你是我的好兄弟,2903,0,0,1,1,0.0%,1h
9646,2,Andy,2903,0,0,1,1,0.0%,30m
9646,2,[可遇不可求]练出来了,2903,0,0,5,5,0.0%,5m
9664,3,ttt,2902,726,139,130,269,51.7%,30m
9664,2,萌萌的小萌新,2902,834,41,29,70,58.6%,14m
9664,2,xiaochen,2902,228,9,10,19,47.4%,20m
9664,1,天魔晨殇,2902,166,7,3,10,70.0%,10m
9664,2,[落星落个星]Noblecat,2902,165,5,2,7,71.4%,14m
9664,1,DEMAND,2902,208,4,2,6,66.7%,1h
9664,2,[脆皮鸡]WDDCXUZ,2902,116,4,7,11,36.4%,30m
9664,3,神之长子万世长存,2902,120,3,1,4,75.0%,42m
9664,3,[吾王世界第一]Altria,2902,95,2,2,4,50.0%,7m
9664,2,雨与林,2902,0,2,3,5,40.0%,1h
9664,2,克哈小兵,2902,92,1,1,2,50.0%,11m
9664,2,[長髿咾氿門]我也能撒你,2902,0,0,3,3,0.0%,6m
9664,1,[童话小镇]fallen,2902,0,0,7,7,0.0%,6m
9677,2,Adele,2901,1116,84,75,159,52.8%,3m
9677,2,fiv,2901,456,37,36,73,50.7%,20m
9677,2,Lancer,2901,864,31,31,62,50.0%,3m
9677,2,悔丶,2901,620,26,18,44,59.1%,16m
9677,1,[探机之怒]单眼工蜂,2901,297,12,7,19,63.2%,36m
9677,2,jkln,2901,239,10,8,18,55.6%,1h
9677,2,山木,2901,218,8,4,12,66.7%,33m
9677,3,[萌新保护协议]莫宇,2901,209,8,6,14,57.1%,1h
9677,2,是离泽丫,2901,150,6,7,13,46.2%,12m
9677,2,黑色的宇,2901,154,5,2,7,71.4%,6m
9677,2,本地人,2901,148,5,7,12,41.7%,22m
9677,2,baby,2901,0,3,2,5,60.0%,9m
9677,3,[scttt]德玛西亚,2901,127,3,8,11,27.3%,8m
9677,2,槐序十六,2901,30,2,1,3,66.7%,26m
9677,2,[黄旭东之子]求大佬指点,2901,30,2,3,5,40.0%,39m
9677,1,[列克星敦天下]第一,2901,97,2,8,10,20.0%,8m
9677,1,[Borne]Kirito,2901,76,2,12,14,14.3%,18m
9677,2,SKY,2901,0,1,0,1,100.0%,13m
9677,2,ERtao,2901,0,1,1,2,50.0%,23m
9677,2,绿企鹅,2901,0,1,2,3,33.3%,6m
9677,2,狠厉害,2901,30,1,2,3,33.3%,23m
9677,2,瘋癲,2901,0,0,1,1,0.0%,33m
9677,2,benson,2901,0,0,1,1,0.0%,18m
9700,2,[边缘]CatCrossbow,2900,376,44,40,84,52.4%,21m
9700,1,虚荣,2900,462,24,23,47,51.1%,18m
9700,1,sliceRest,2900,721,24,26,50,48.0%,33m
9700,2,维斯维尔星港,2900,512,22,19,41,53.7%,14m
9700,1,[夙愿东流]Far,2900,334,13,9,22,59.1%,33m
9700,1,fovery,2900,212,6,10,16,37.5%,18m
9700,2,[ljk]白小纯,2900,88,4,5,9,44.4%,36m
9700,3,千幻,2900,40,2,4,6,33.3%,4m
9700,2,我是一条鱼,2900,0,1,0,1,100.0%,26m
9700,1,Clean,2900,0,1,3,4,25.0%,10m
9700,2,[埃蒙好可爱]Rocky,2900,0,0,1,1,0.0%,3m
9700,2,[为星光而战]小蓝女光,2900,0,0,1,1,0.0%,13m
9700,2,[魔虫教主万岁]乌怕,2900,0,0,2,2,0.0%,3m
9713,2,如月影,2899,996,43,37,80,53.8%,11m
9713,1,SUPERHEART,2899,1030,36,43,79,45.6%,3m
9713,1,莫得感情,2899,894,31,34,65,47.7%,16m
9713,2,布鲁仛,2899,203,8,3,11,72.7%,8m
9713,2,垒垒垒,2899,206,8,9,17,47.1%,27m
9713,2,豆沙的大包仔,2899,166,7,7,14,50.0%,11m
9713,2,你能把到我吗,2899,116,5,5,10,50.0%,27m
9713,2,肆月,2899,102,3,0,3,100.0%,35m
9713,3,[至翼二中]君莫笑,2899,0,3,2,5,60.0%,27m
9713,2,[花开彼岸天]圣魔,2899,0,3,2,5,60.0%,1h
9713,2,[浙江谐会]ever,2899,90,3,4,7,42.9%,11m
9713,2,zcz,2899,34,2,1,3,66.7%,21m
9713,2,魔王,2899,30,2,1,3,66.7%,32m
9713,2,这种事情要讲天分,2899,26,2,1,3,66.7%,26m
9713,1,[我们是无敌的]维纳斯的回忆,2899,97,2,5,7,28.6%,13m
9713,2,逍遥鹏,2899,0,0,1,1,0.0%,6m
9729,1,王小刀,2898,1590,373,369,742,50.3%,3m
9729,2,春哥的爱,2898,1089,47,47,94,50.0%,31m
9729,2,[天火]CELESTE,2898,908,46,36,82,56.1%,26m
9729,1,SkcKC,2898,460,23,15,38,60.5%,10m
9729,2,包包,2898,595,22,21,43,51.2%,11m
9729,2,[第一次玩]Nryu,2898,191,8,3,11,72.7%,3m
9729,3,紫灬龍,2898,37,8,9,17,47.1%,26m
9729,1,Blackrock,2898,235,7,9,16,43.8%,35m
9729,3,找死的兔子,2898,105,6,3,9,66.7%,1h
9729,2,今天也很想佩佩,2898,162,4,4,8,50.0%,16m
9729,2,暴躁的浣熊,2898,122,4,5,9,44.4%,24m
9729,1,希提亚小汤圆,2898,193,3,5,8,37.5%,1h
9729,2,遥远的它,2898,30,2,0,2,100.0%,6m
9729,2,[就是现在]火化他们,2898,133,2,3,5,40.0%,11m
9729,2,[小鸡屠宰场3]大嫖,2898,60,2,5,7,28.6%,21m
9729,2,[HUC轩辕]商业头脑,2898,0,1,0,1,100.0%,6m
9729,2,只求不狗打运营,2898,88,1,1,2,50.0%,5m
9729,3,[SteEng]八木,2898,97,1,8,9,11.1%,4m
9729,2,zerzeg,2898,0,0,1,1,0.0%,29m
9748,2,cqmx,2897,988,132,105,237,55.7%,31m
9748,3,神无,2897,1514,102,107,209,48.8%,5m
9748,2,vality,2897,750,31,28,59,52.5%,35m
9748,2,[FFJ]简则美,2897,692,27,24,51,52.9%,12m
9748,2,惘畸里海,2897,574,25,23,48,52.1%,14m
9748,2,咸鱼塘塘主,2897,412,14,12,26,53.8%,22m
9748,2,[Beasty]十二翼天使,2897,206,7,8,15,46.7%,5m
9748,2,谐星之超兵丿,2897,188,6,4,10,60.0%,38m
9748,2,依然冷瑟,2897,189,5,6,11,45.5%,1h
9748,3,[五月花]蟑螂舞姬,2897,118,5,11,16,31.2%,5m
9748,2,离熟之痕,2897,126,3,3,6,50.0%,6m
9748,2,TerranX,2897,88,1,1,2,50.0%,14m
9748,1,[呆毛来我迦]Llxiang,2897,0,1,6,7,14.3%,10m
9748,1,[暴民永不低头]某科学的吉太,2897,0,0,1,1,0.0%,46m
9762,1,[在下萌新一只]鲍大将军,2896,1565,170,145,315,54.0%,23m
9762,2,ltaaa,2896,1523,120,107,227,52.9%,14m
9762,2,[不乐意]TunblingDown,2896,1109,68,67,135,50.4%,11m
9762,1,[雪乃万岁]wkw,2896,824,59,58,117,50.4%,7m
9762,2,[GL0HF]ittwiner,2896,844,34,28,62,54.8%,6m
9762,2,常威,2896,540,19,22,41,46.3%,29m
9762,2,[玛德治杖]小耗,2896,349,17,11,28,60.7%,19m
9762,1,[Strike]TheExileZAnd,2896,470,17,18,35,48.6%,17m
9762,2,Shiki,2896,240,9,8,17,52.9%,11m
9762,2,Nobody,2896,234,6,7,13,46.2%,26m
9762,1,captain,2896,175,5,9,14,35.7%,4m
9762,2,[么都馆]鲲霁,2896,0,3,2,5,60.0%,9m
9762,1,AlexKenCN,2896,120,3,2,5,60.0%,60m
9762,2,[您好]StevenLI,2896,60,3,6,9,33.3%,11m
9762,2,[爱之信仰]東风丶若言丿,2896,0,1,0,1,100.0%,5m
9762,2,紫夜,2896,0,0,1,1,0.0%,33m
9762,2,杭喆,2896,0,0,1,1,0.0%,39m
9762,2,[鱼人永不败]wko,2896,0,0,2,2,0.0%,12m
9780,2,范大将军,2895,1360,53,53,106,50.0%,26m
9780,2,[半个菜鸟]Pine,2895,709,32,22,54,59.3%,36m
9780,2,[劲夫团]SuperNova,2895,643,26,22,48,54.2%,16m
9780,2,木之下和也,2895,559,24,21,45,53.3%,27m
9780,2,rongshu,2895,442,17,12,29,58.6%,14m
9780,2,[PL4y]EDward,2895,290,15,16,31,48.4%,8m
9780,3,人渣的本愿,2895,118,12,10,22,54.5%,7m
9780,3,进击的小学生,2895,292,11,5,16,68.8%,3m
9780,2,[F2A手残]小刘来了,2895,290,11,7,18,61.1%,6m
9780,2,张战天,2895,329,10,8,18,55.6%,23m
9780,1,[怀念曾经温柔]WADU,2895,194,7,1,8,87.5%,1h
9780,2,都是好事儿,2895,188,7,10,17,41.2%,6m
9780,3,浩聚天下,2895,40,6,14,20,30.0%,18m
9780,2,BLANKliming,2895,142,5,1,6,83.3%,8m
9780,1,猫耳琪露诺,2895,94,5,4,9,55.6%,7m
9780,1,小付,2895,96,4,3,7,57.1%,1h
9780,1,面壁者泰勒奥瑞斯,2895,44,2,0,2,100.0%,1h
9780,1,小少,2895,99,2,6,8,25.0%,20m
9780,1,拒绝者,2895,0,1,1,2,50.0%,57m
9780,2,lyy,2895,30,1,3,4,25.0%,26m
9780,2,blue,2895,0,0,1,1,0.0%,37m
9780,2,serral,2895,0,0,2,2,0.0%,16m
9802,2,Rain,2894,1101,46,38,84,54.8%,6m
9802,1,孤独的人,2894,824,41,37,78,52.6%,10m
9802,2,[教我玩神族]huadao,2894,380,13,13,26,50.0%,11m
9802,2,熊猫盖饭,2894,276,11,4,15,73.3%,6m
9802,3,[名非]DADADA,2894,230,9,7,16,56.2%,1h
9802,1,宫本光的小领带,2894,229,9,8,17,52.9%,42m
9802,3,凹凸曼,2894,290,9,16,25,36.0%,3m
9802,1,Ricardo,2894,96,4,3,7,57.1%,57m
9802,1,坟葬,2894,146,4,11,15,26.7%,24m
9802,2,average,2894,0,3,2,5,60.0%,53m
9802,2,lorthgred,2894,90,3,3,6,50.0%,6m
9802,2,ZHUJIAHE,2894,0,1,0,1,100.0%,3m
9802,1,King,2894,0,1,1,2,50.0%,55m
9802,3,Ash,2894,97,1,3,4,25.0%,1h
9802,1,MEC,2894,0,1,6,7,14.3%,33m
9802,2,[北部战区]Awx,2894,0,0,1,1,0.0%,32m
9802,2,dogdays,2894,0,0,1,1,0.0%,13m
9802,1,阿米娅,2894,0,0,1,1,0.0%,1h
9802,2,Reyi,2894,0,0,4,4,0.0%,11m
9821,2,随机死个马,2893,1603,115,110,225,51.1%,3m
9821,2,[xy饲料厂]鸟哥的小迷妹,2893,351,13,7,20,65.0%,6m
9821,1,[就会一9D]IIllIIlIIlII,2893,323,12,9,21,57.1%,1h
9821,1,hhhhhhhhhhhh,2893,307,11,11,22,50.0%,10m
9821,3,葫芦娃,2893,229,8,5,13,61.5%,1h
9821,2,[不灭青铜]崇义将军,2893,206,7,8,15,46.7%,22m
9821,2,[假的战队]king,2893,132,6,6,12,50.0%,1h
9821,1,[风起云涌0]chris,2893,149,4,3,7,57.1%,44m
9821,2,龙的传人,2893,0,3,2,5,60.0%,1h
9821,2,[键盘冒毒奶]超能之狼炎,2893,60,3,3,6,50.0%,35m
9821,2,[UNN新闻]你的探鸡遭到公鸡,2893,30,2,1,3,66.7%,12m
9821,2,[赫鲁晓夫玉米]银色舞者,2893,64,2,6,8,25.0%,35m
9821,2,[菜有菜的道理]Ilyich,2893,30,1,2,3,33.3%,26m
9834,2,pkw,2892,1526,77,61,138,55.8%,36m
9834,2,笛子,2892,1090,47,36,83,56.6%,33m
9834,1,[虚拟歌手团体]Goldwatch,2892,737,32,25,57,56.1%,18m
9834,2,执剑,2892,491,27,24,51,52.9%,21m
9834,2,莱茵哈特的光辉,2892,437,18,14,32,56.2%,13m
9834,2,[底特律KAR]无敌老剑客,2892,279,17,3,20,85.0%,46m
9834,3,[昨晚没睡好]Crazy,2892,385,15,28,43,34.9%,4m
9834,2,[JUELE]JUELE,2892,374,13,15,28,46.4%,26m
9834,2,[妖精卜卜口]QAQ,2892,367,10,12,22,45.5%,8m
9834,2,[最菜战队]赤瞳,2892,154,9,2,11,81.8%,29m
9834,2,tyq,2892,206,8,4,12,66.7%,28m
9834,2,[艾尔之主]我好了你呢,2892,204,8,4,12,66.7%,23m
9834,2,炸鱼崽种亲妈必死,2892,143,6,0,6,100.0%,16m
9834,2,Graendal,2892,164,6,3,9,66.7%,6m
9834,2,[小鸡屠宰场a]虎牙丶小姐姐想要,2892,90,4,4,8,50.0%,35m
9834,1,输给我死个妈,2892,34,4,5,9,44.4%,7m
9834,2,[Holyfe]中二病也要打星际,2892,0,3,2,5,60.0%,1h
9834,2,[懟懟懟懟懟]漆欣然,2892,88,3,6,9,33.3%,17m
9834,1,[Rexel]nor,2892,137,3,8,11,27.3%,33m
9834,2,[ZoZion]Hank,2892,58,2,5,7,28.6%,31m
9834,1,kevin,2892,97,2,5,7,28.6%,1h
9834,2,道提劲,2892,0,1,0,1,100.0%,15m
9834,2,大佬让我一把,2892,0,1,0,1,100.0%,12m
9834,2,[彡暁弎彡鞺灘]Hades,2892,0,1,1,2,50.0%,12m
9834,1,奔放的旋律,2892,0,1,3,4,25.0%,31m
9834,1,ccloudy,2892,44,1,5,6,16.7%,46m
9834,2,Airpastor,2892,0,0,1,1,0.0%,6m
9834,2,BLOODAWAKE,2892,0,0,1,1,0.0%,24m
9834,2,[永恒中华]AAA,2892,0,0,1,1,0.0%,23m
9834,2,太仓黄老湿,2892,0,0,2,2,0.0%,38m
9834,2,[暴雪三十一队]云狂风虐,2892,0,0,3,3,0.0%,12m
9865,3,孙门弄换钱门弄智,2891,493,57,63,120,47.5%,38m
9865,1,xixi,2891,1193,47,46,93,50.5%,27m
9865,3,胖子,2891,1241,47,56,103,45.6%,34m
9865,1,阿慢,2891,606,20,26,46,43.5%,33m
9865,2,[黑白丝双马尾]救世神棍泽拉图,2891,424,19,8,27,70.4%,6m
9865,2,[腥灬红]DragonIIIIII,2891,0,3,2,5,60.0%,48m
9865,3,[笑傲星球]刘德华,2891,0,3,5,8,37.5%,10m
9865,1,imbavictor,2891,0,2,4,6,33.3%,1h
9865,1,[秋毫]年轻人不讲武德,2891,114,2,4,6,33.3%,42m
9865,2,Gray,2891,58,2,5,7,28.6%,36m
9865,1,杀我农民就投降,2891,96,1,1,2,50.0%,25m
9876,1,skyfly,2890,1163,200,187,387,51.7%,13m
9876,3,北部之光,2890,1286,141,139,280,50.4%,9m
9876,1,残夜魂,2890,1281,90,87,177,50.8%,35m
9876,2,[Beastp]HNC,2890,536,20,20,40,50.0%,21m
9876,2,[25鸡]谈笑风生,2890,446,17,20,37,45.9%,29m
9876,2,随便干的二五仔,2890,312,13,12,25,52.0%,26m
9876,2,IIIIIIIIIIII,2890,288,11,11,22,50.0%,12m
9876,1,[DSSQ]叶立德,2890,118,6,1,7,85.7%,31m
9876,2,举饮將醉,2890,208,6,5,11,54.5%,10m
9876,2,饕餮,2890,127,4,3,7,57.1%,29m
9876,2,[咕咕学院]幻想乡乡长,2890,68,2,3,5,40.0%,20m
9876,2,[战巡]LMH,2890,0,1,0,1,100.0%,6m
9876,2,[感觉优势很大]烈风天翼,2890,0,1,2,3,33.3%,27m
9876,2,ULTRATE,2890,0,1,4,5,20.0%,1h
9876,2,[丨SLT丨]Magejiterran,2890,0,0,1,1,0.0%,16m
9876,2,DrZ,2890,0,0,2,2,0.0%,37m
9876,3,丸子,2890,0,0,3,3,0.0%,1h
9893,3,Mvp,2889,1480,91,92,183,49.7%,36m
9893,1,[iGSCII]Liong,2889,1119,43,42,85,50.6%,25m
9893,2,snaky,2889,488,35,31,66,53.0%,5m
9893,2,jzzz,2889,717,33,26,59,55.9%,36m
9893,2,[幻想神社]MorinoSeika,2889,498,18,17,35,51.4%,3m
9893,2,卡卡希,2889,375,15,16,31,48.4%,23m
9893,1,马铃薯,2889,280,13,8,21,61.9%,11m
9893,2,芭芭拉冲鸭,2889,405,13,18,31,41.9%,18m
9893,3,幻月见明,2889,279,9,6,15,60.0%,25m
9893,2,好像一波,2889,138,7,4,11,63.6%,17m
9893,2,YUKO,2889,94,4,3,7,57.1%,12m
9893,2,Ashes,2889,120,4,7,11,36.4%,15m
9893,2,ooo,2889,60,3,4,7,42.9%,20m
9893,2,tianci,2889,0,1,0,1,100.0%,59m
9893,1,knightkami,2889,0,1,2,3,33.3%,28m
9893,1,[暴雪养鸡场]Shuyining,2889,44,1,2,3,33.3%,1h
9893,2,[西方极乐世界]Daosi,2889,0,0,1,1,0.0%,13m
9893,2,[miku守护]MagicAiur,2889,0,0,1,1,0.0%,9m
9893,2,[要啥没啥爱咋]木券可待,2889,0,0,2,2,0.0%,33m
9893,2,[Holyfe]DarkeDave,2889,0,0,3,3,0.0%,12m
9913,2,Outstanding,2888,1125,57,38,95,60.0%,29m
9913,1,[找虐]泽拉瑞斯大主教,2888,516,15,19,34,44.1%,7m
9913,2,gao,2888,207,8,4,12,66.7%,24m
9913,2,[南邮憨B联盟]Howdy,2888,218,7,5,12,58.3%,39m
9913,2,QuanTum,2888,233,7,6,13,53.8%,20m
9913,3,艾尔之子,2888,191,7,7,14,50.0%,15m
9913,2,努力痊愈,2888,212,6,6,12,50.0%,1h
9913,2,[暴雪二十队]怪大叔,2888,0,4,1,5,80.0%,1h
9913,2,默默大帅哥,2888,58,3,3,6,50.0%,12m
9913,1,拾捌,2888,66,3,8,11,27.3%,17m
9923,2,IIIIIIIIII,2887,918,119,108,227,52.4%,14m
9923,1,李大爷,2887,1318,88,78,166,53.0%,27m
9923,2,Neo,2887,272,11,7,18,61.1%,1h
9923,2,[克哈的女团]许大大,2887,223,10,5,15,66.7%,36m
9923,1,[灰冥]赤瞳是我老婆,2887,273,9,16,25,36.0%,17m
9923,1,[XXHZN2]排空剑雨,2887,0,5,1,6,83.3%,10m
9923,1,[你好抱歉]lllllll,2887,159,4,4,8,50.0%,35m
9923,2,不许黑大主教,2887,88,4,5,9,44.4%,22m
9923,2,打星际我只玩神族,2887,116,3,1,4,75.0%,13m
9923,2,艾尔之子,2887,0,3,1,4,75.0%,1h
9923,1,RainbowCandy,2887,0,3,3,6,50.0%,1h
9923,2,红门馆,2887,0,2,3,5,40.0%,22m
9923,2,[歌者]玉面小兽龙,2887,83,2,3,5,40.0%,53m
9923,2,晃晃,2887,0,1,0,1,100.0%,1h
9937,2,战狼,2886,774,31,26,57,54.4%,9m
9937,2,auir,2886,334,12,11,23,52.2%,6m
9937,2,IIIIIIIIIII,2886,156,6,2,8,75.0%,17m
9937,2,SKTone,2886,148,5,7,12,41.7%,29m
9937,2,[47]反转十字,2886,0,4,1,5,80.0%,46m
9937,2,装甲蜗牛,2886,116,4,1,5,80.0%,15m
9937,2,双城,2886,0,3,2,5,60.0%,5m
9937,2,狂龙,2886,62,2,3,5,40.0%,35m
9937,2,[潸然丶那些年]Bachelor,2886,0,1,0,1,100.0%,6m
9937,2,崇宫澪,2886,0,1,1,2,50.0%,14m
9937,2,[节操满满的]绿豆泥红豆泥,2886,0,0,1,1,0.0%,9m
9937,2,[传奇舰队]宝贝龙,2886,0,0,1,1,0.0%,35m
9937,2,SupplyBlock,2886,0,0,1,1,0.0%,1h
9937,2,[胖子触电]LEFTEYE,2886,0,0,2,2,0.0%,36m
9951,3,[no总之遗]莫岚,2885,1334,158,165,323,48.9%,15m
9951,1,applefly,2885,1178,52,54,106,49.1%,3m
9951,1,FLAME,2885,882,52,56,108,48.1%,18m
9951,1,来点阳间的东西吧,2885,911,44,40,84,52.4%,27m
9951,2,肖战哥哥打星际狗,2885,676,44,44,88,50.0%,32m
9951,2,Myth,2885,482,35,29,64,54.7%,33m
9951,2,[杀生业报]maru,2885,391,14,12,26,53.8%,23m
9951,2,风灵星空,2885,268,11,8,19,57.9%,1h
9951,1,clkirito,2885,320,11,14,25,44.0%,7m
9951,2,Async,2885,242,9,5,14,64.3%,12m
9951,2,冒个泡泡,2885,227,6,6,12,50.0%,1h
9951,2,[2676]初成,2885,176,6,7,13,46.2%,35m
9951,2,年轻人,2885,150,5,3,8,62.5%,16m
9951,2,[皇家科院]盲人星际,2885,138,4,2,6,66.7%,32m
9951,2,FearX,2885,140,4,2,6,66.7%,17m
9951,1,Kerei,2885,117,4,3,7,57.1%,25m
9951,1,星尘,2885,100,4,7,11,36.4%,26m
9951,2,桐原亮司,2885,102,3,0,3,100.0%,26m
9951,2,[SCASS]AlIlI,2885,102,3,1,4,75.0%,16m
9951,2,gansita,2885,0,3,2,5,60.0%,1h
9951,3,[奔驰何平]梁非凡,2885,97,2,2,4,50.0%,32m
9951,1,CleanZerg,2885,20,2,7,9,22.2%,6m
9951,2,林笑宇,2885,0,1,0,1,100.0%,17m
9951,1,狍子吃栗子,2885,0,1,0,1,100.0%,38m
9951,1,流小年,2885,0,1,1,2,50.0%,1h
9951,2,守护恩星,2885,0,1,3,4,25.0%,20m
9951,2,Kurisu,2885,0,0,1,1,0.0%,24m
9951,2,[BF攻略组]Stardust,2885,0,0,1,1,0.0%,5m
9951,2,何忆,2885,0,0,1,1,0.0%,36m
9951,2,么么哒小兔兔,2885,0,0,4,4,0.0%,39m
9981,2,woxing,2884,1589,179,164,343,52.2%,22m
9981,2,[夺命大乌苏]TylerdurdeN,2884,1558,115,117,232,49.6%,27m
9981,2,专业坑爹三十年,2884,1548,107,76,183,58.5%,32m
9981,2,忘忧岛,2884,1327,85,73,158,53.8%,12m
9981,2,[大毛无与伦比]二毛,2884,1177,67,56,123,54.5%,23m
9981,2,Djcj,2884,1380,58,48,106,54.7%,22m
9981,1,周淑怡的逼也很嫩,2884,1007,42,48,90,46.7%,19m
9981,2,苇怡是炜青的唯一,2884,333,16,13,29,55.2%,15m
9981,2,无敌寂寞,2884,256,12,7,19,63.2%,16m
9981,1,拉拉肥,2884,382,12,19,31,38.7%,10m
9981,3,[不知不觉天亮]Horfey,2884,229,8,4,12,66.7%,42m
9981,2,kissabc,2884,248,8,8,16,50.0%,31m
9981,1,[甜软]Zilters,2884,234,7,16,23,30.4%,18m
9981,2,IIIIIIIIIIII,2884,158,4,4,8,50.0%,13m
9981,2,wdk,2884,130,4,5,9,44.4%,22m
9981,1,[星际黑店]瓦萨德,2884,0,3,3,6,50.0%,1h
9981,2,AAASWRRR,2884,102,2,1,3,66.7%,28m
9981,3,[MDT]火翼,2884,97,2,2,4,50.0%,1h
9981,2,宗大爷爷,2884,30,2,3,5,40.0%,14m
9981,2,[应塔罗塔杀哒]浮生若梦,2884,0,1,0,1,100.0%,29m
9981,2,[背着预言家的]血色血族,2884,0,1,0,1,100.0%,13m
9981,1,SmallCow,2884,92,1,3,4,25.0%,10m
9981,2,[社交学超可爱]昵昌锅,2884,0,0,2,2,0.0%,21m
9981,3,[浙大战队]gugu,2884,0,0,3,3,0.0%,59m
10005,1,[俞哲泓保卫战]Man,2883,1383,231,229,460,50.2%,19m
10005,1,先生夺仁,2883,1551,178,164,342,52.0%,4m
10005,1,[虚空王座]蛇皮大仙,2883,969,41,46,87,47.1%,18m
10005,2,[舰队我是你爹]Xel,2883,599,25,18,43,58.1%,24m
10005,2,[TCP]TinyQingYY,2883,398,23,9,32,71.9%,46m
10005,2,cool,2883,436,19,11,30,63.3%,7m
10005,2,[宫吧老哥狂喜]夏利文,2883,385,18,14,32,56.2%,27m
10005,2,黄昏的祭祀,2883,326,11,8,19,57.9%,26m
10005,2,晓风肆雪,2883,180,5,5,10,50.0%,27m
10005,1,[四叶草]不闪不避全凭内力,2883,0,4,3,7,57.1%,1h
10005,2,索马里的肉山,2883,0,3,2,5,60.0%,3m
10005,1,[以君之名]卖肾的小骚年,2883,0,3,3,6,50.0%,1h
10005,2,[萌完吃个糖丶]淡定才是福,2883,114,2,2,4,50.0%,17m
10005,3,[浮世清欢]虎牙丶指挥,2883,129,2,4,6,33.3%,50m
10005,2,闪现大龙,2883,30,2,6,8,25.0%,21m
10005,1,[蒙蔽梦游团]Sanya,2883,0,1,0,1,100.0%,55m
10005,3,血色盛宴,2883,30,1,9,10,10.0%,17m
10005,2,[202NB]你的百布里,2883,0,0,1,1,0.0%,10m
10023,1,zhangbi,2882,1475,244,225,469,52.0%,19m
10023,2,[入侵地球]麻烦死了,2882,1529,111,99,210,52.9%,36m
10023,2,向我开炮,2882,1569,95,89,184,51.6%,22m
10023,2,何山,2882,1097,57,56,113,50.4%,35m
10023,2,零度冰寒,2882,773,48,44,92,52.2%,26m
10023,2,漆黑之帐,2882,352,17,12,29,58.6%,35m
10023,2,wdijan,2882,355,15,8,23,65.2%,36m
10023,2,IIIIIIIIIIII,2882,337,15,14,29,51.7%,14m
10023,2,[女帝1号]稳妥的,2882,378,14,12,26,53.8%,12m
10023,2,[星耀]木悠沫,2882,274,10,8,18,55.6%,38m
10023,2,[万龙之眼]龙之眼,2882,102,3,2,5,60.0%,36m
10023,2,云白,2882,88,2,0,2,100.0%,15m
10023,2,热心网友小陈,2882,88,2,0,2,100.0%,36m
10023,2,[TOKYO]Sakura,2882,30,2,1,3,66.7%,37m
10023,2,[两道菜]急急急,2882,30,2,2,4,50.0%,36m
10023,3,六月勇者,2882,0,1,0,1,100.0%,48m
10023,2,杰兰特,2882,0,1,0,1,100.0%,6m
10023,2,你脑缠,2882,0,1,0,1,100.0%,14m
10023,2,[乌鸦营]天马行空,2882,88,1,1,2,50.0%,21m
10023,2,龙兔,2882,88,1,1,2,50.0%,10m
10023,2,[TZPer]ThunderBird,2882,0,1,3,4,25.0%,16m
10023,2,LanceChen,2882,0,0,1,1,0.0%,3m
10045,2,EvenDark,2881,601,26,22,48,54.2%,24m
10045,2,IIIIIIIIIIII,2881,116,4,1,5,80.0%,15m
10045,1,菠萝,2881,167,4,8,12,33.3%,14m
10045,1,KAmier,2881,0,3,2,5,60.0%,1h
10045,2,[Mikon]Rinne,2881,0,3,2,5,60.0%,13m
10045,2,浪波涛,2881,0,3,2,5,60.0%,1h
10045,2,鬼头明里,2881,46,3,3,6,50.0%,1h
10045,2,沃德法克,2881,0,1,0,1,100.0%,35m
10045,2,朋友的妈妈,2881,30,1,3,4,25.0%,27m
10045,2,[星际玩家加一]轻狂,2881,0,0,1,1,0.0%,9m
10045,2,[我们是反抗军]隐葬,2881,0,0,1,1,0.0%,3m
10045,2,刘老三,2881,0,0,1,1,0.0%,1h
10045,2,[wean]阿拉纳克,2881,0,0,1,1,0.0%,29m
10045,2,金凤凰,2881,0,0,2,2,0.0%,33m
10059,3,Eagle,2880,1615,1020,990,2010,50.7%,5m
10059,2,ILOVEYOU,2880,1162,48,45,93,51.6%,31m
10059,2,[DNF]IIIIIIIIIIII,2880,685,38,18,56,67.9%,36m
10059,2,[老年娱乐团]时间跳跃者的妄想,2880,729,34,25,59,57.6%,21m
10059,2,甲壳布,2880,545,34,30,64,53.1%,33m
10059,1,[丨哔哩哔哩丨]IIIIIIIIIIII,2880,536,17,22,39,43.6%,4m
10059,2,pain,2880,329,15,11,26,57.7%,12m
10059,1,losePEAR,2880,266,12,11,23,52.2%,28m
10059,2,钢铁菊花,2880,348,9,16,25,36.0%,14m
10059,2,哦列哇可挖诺噶,2880,169,7,2,9,77.8%,14m
10059,2,希望的光芒,2880,189,6,5,11,54.5%,12m
10059,2,准风月谈,2880,180,6,8,14,42.9%,3m
10059,2,克鲁斯约翰,2880,102,3,0,3,100.0%,46m
10059,2,wangbababa,2880,95,3,8,11,27.3%,1h
10059,2,bszsdresbqzj,2880,46,2,1,3,66.7%,58m
10059,3,Aspire,2880,0,1,0,1,100.0%,25m
10059,2,[冲就完了]CKCZ,2880,0,1,0,1,100.0%,32m
10059,3,[主观唯心主义]wHisPeR,2880,30,1,1,2,50.0%,32m
10059,1,[咋哇撸多]龙骑士制作大师,2880,0,1,1,2,50.0%,1h
10059,2,亦木永,2880,0,0,1,1,0.0%,1h
10079,3,低调逃生,2879,1498,542,512,1054,51.4%,8m
10079,1,Rage,2879,1638,83,62,145,57.2%,27m
10079,2,SunIFox,2879,1505,64,55,119,53.8%,7m
10079,1,[Holyfe]张小十十十吖,2879,323,40,37,77,51.9%,17m
10079,2,[GANGAN]VISTA,2879,917,38,34,72,52.8%,36m
10079,2,孤独莫,2879,501,21,15,36,58.3%,39m
10079,2,GoodDayUp,2879,314,11,14,25,44.0%,22m
10079,2,[热血即是浪漫]七月,2879,225,8,3,11,72.7%,1h
10079,2,一刀,2879,184,7,9,16,43.8%,35m
10079,2,[轻风候君来]清风雨,2879,128,4,3,7,57.1%,29m
10079,2,[四蛆兄弟]夜凌丶冥,2879,0,2,3,5,40.0%,60m
10079,2,SOMA,2879,62,2,3,5,40.0%,18m
10079,3,虫子,2879,0,0,1,1,0.0%,22m
10079,3,[ACG系]yinyinmaster,2879,0,0,1,1,0.0%,35m
10093,1,今天第一次打星际,2878,1139,73,61,134,54.5%,16m
10093,2,杀我王虫跟你拼命,2878,1409,60,52,112,53.6%,46m
10093,2,霸气你晨哥,2878,1013,46,36,82,56.1%,6m
10093,2,阻碍战争,2878,611,30,20,50,60.0%,39m
10093,3,Hyperion,2878,343,15,9,24,62.5%,14m
10093,1,雨樱花,2878,482,15,21,36,41.7%,11m
10093,2,[B11313]老歌与陈酒,2878,336,12,10,22,54.5%,12m
10093,1,物我无界,2878,320,12,11,23,52.2%,27m
10093,2,Dcring,2878,140,6,5,11,54.5%,30m
10093,1,冬衣,2878,96,5,2,7,71.4%,60m
10093,2,HiZijin,2878,184,4,6,10,40.0%,35m
10093,2,血月,2878,78,3,4,7,42.9%,46m
10093,2,IIIIIIIIIIII,2878,60,2,4,6,33.3%,3m
10093,2,kofluo,2878,30,1,4,5,20.0%,12m
10093,3,[永恒的光辉]DOMINATE,2878,0,0,1,1,0.0%,14m
10093,3,空条承太郎,2878,0,0,1,1,0.0%,18m
10093,3,[SCiiii]阿飞,2878,0,0,2,2,0.0%,18m
10093,2,[建着玩儿]favouriteHXB,2878,0,0,3,3,0.0%,3m
10111,3,那句晚安你听了吗,2877,1377,79,59,138,57.2%,19m
10111,3,xhcchxjdbwpx,2877,535,20,12,32,62.5%,32m
10111,2,dimer,2877,426,18,11,29,62.1%,46m
10111,1,创世纪,2877,407,14,14,28,50.0%,6m
10111,1,trhrhrhrynh,2877,316,13,10,23,56.5%,1h
10111,2,AbOvo,2877,300,10,8,18,55.6%,14m
10111,3,使坏,2877,165,6,2,8,75.0%,36m
10111,2,[暴雪我是你爹]他就一边甩一边哭,2877,202,6,9,15,40.0%,45m
10111,1,Yruikk,2877,163,5,3,8,62.5%,1h
10111,3,弗笑,2877,142,5,4,9,55.6%,5m
10111,1,智力无法接受,2877,165,3,3,6,50.0%,57m
10111,2,happygg,2877,42,2,0,2,100.0%,12m
10111,2,[我们是无敌的]盈潇诗雨,2877,46,2,4,6,33.3%,58m
10111,3,helloKitty,2877,0,1,0,1,100.0%,17m
10111,2,[NukSub]Justice,2877,0,1,2,3,33.3%,33m
10111,3,hrguvbq,2877,30,1,2,3,33.3%,7m
10111,2,[miku守护]Dealer,2877,30,1,3,4,25.0%,36m
10111,3,[I苏维埃I]前略,2877,0,0,1,1,0.0%,17m
10111,3,NOVA,2877,0,0,1,1,0.0%,32m
10111,2,葫芦爷救娃娃,2877,0,0,2,2,0.0%,39m
10111,2,COUREGE,2877,0,0,2,2,0.0%,32m
10111,1,[雷霆半月斩]七九要谦虚,2877,0,0,2,2,0.0%,1h
10111,2,mDay,2877,0,0,2,2,0.0%,13m
10134,2,SKI,2876,1627,156,154,310,50.3%,20m
10134,2,[星际新手上路]rookie,2876,980,63,49,112,56.2%,24m
10134,2,[Rush丿]meng,2876,1465,60,59,119,50.4%,35m
10134,1,虫王之王,2876,609,20,25,45,44.4%,30m
10134,1,GreatAxe,2876,265,9,10,19,47.4%,14m
10134,3,[NS2憋牛群]WinterFTTF,2876,129,6,2,8,75.0%,37m
10134,1,bldg,2876,172,6,9,15,40.0%,16m
10134,2,TIMdeng,2876,138,4,3,7,57.1%,16m
10134,2,[七宫智音]艾尔之霜,2876,86,4,4,8,50.0%,28m
10134,3,[小仙女已上线]IIIIIIIIIIII,2876,121,2,3,5,40.0%,1h
10134,2,Stan,2876,60,2,5,7,28.6%,35m
10134,3,[西伯利亚土豆]秘制小憨包,2876,0,1,0,1,100.0%,36m
10134,2,[情义天下]暴暴龙,2876,88,1,2,3,33.3%,11m
10134,2,rook,2876,0,0,2,2,0.0%,11m
10148,2,heifer,2875,709,29,26,55,52.7%,27m
10148,1,暴雪不在乎你意见,2875,401,17,24,41,41.5%,25m
10148,2,[社交学教导]二货,2875,405,16,13,29,55.2%,3m
10148,1,[大jj美少女]大吊少女,2875,468,16,21,37,43.2%,3m
10148,3,[黄旭东奶我输]efefwe,2875,331,14,20,34,41.2%,32m
10148,2,StrongToufu,2875,172,6,7,13,46.2%,30m
10148,2,zoeyqaq,2875,182,6,8,14,42.9%,30m
10148,1,traveler,2875,96,5,5,10,50.0%,55m
10148,1,LonelyRainy,2875,170,5,9,14,35.7%,33m
10148,2,[超合金战队]魔虫激光,2875,120,4,6,10,40.0%,23m
10148,2,埃蒙,2875,0,3,2,5,60.0%,12m
10148,3,[GTA丶SE]TAGer,2875,0,2,3,5,40.0%,5m
10148,3,Hydralisk,2875,97,1,2,3,33.3%,50m
10148,2,DisDoR,2875,0,1,4,5,20.0%,1h
10148,3,[SoloBM]谈笑间风生起,2875,0,0,1,1,0.0%,39m
10148,2,[看星星咯]远坂时臣,2875,0,0,1,1,0.0%,35m
10148,3,[火焰雷兽]喳巴彡,2875,0,0,1,1,0.0%,38m
10148,2,[暴雪十队]倾风雨里爱你,2875,0,0,2,2,0.0%,5m
10148,2,瘟疫之神,2875,0,0,3,3,0.0%,16m
10148,2,盗跖庄屩流誉后,2875,0,0,5,5,0.0%,20m
10168,2,污耀王,2874,1062,134,107,241,55.6%,24m
10168,2,[蕾姆酱]灵符掌握,2874,860,57,41,98,58.2%,6m
10168,2,愛的承諾,2874,698,40,38,78,51.3%,20m
10168,2,战地跑路,2874,454,17,18,35,48.6%,21m
10168,3,刚玩星际大佬轻虐,2874,294,13,1,14,92.9%,16m
10168,3,我既是虫群,2874,315,11,6,17,64.7%,11m
10168,2,三花六,2874,292,11,10,21,52.4%,22m
10168,3,新手试玩,2874,124,3,2,5,60.0%,17m
10168,2,肛正不畸,2874,30,3,5,8,37.5%,14m
10177,2,Poseidon,2873,1080,60,55,115,52.2%,30m
10177,3,[景沐阳]非玩家角色,2873,999,59,40,99,59.6%,14m
10177,2,JUDGE,2873,1451,56,53,109,51.4%,39m
10177,2,[嘻哈战队]Zero,2873,888,45,24,69,65.2%,39m
10177,2,IIIIIIIIII,2873,639,26,21,47,55.3%,18m
10177,1,[孤独与烈酒]慕容秋,2873,412,18,19,37,48.6%,25m
10177,2,galax,2873,256,17,19,36,47.2%,39m
10177,1,Nephalem,2873,334,14,19,33,42.4%,6m
10177,2,POSEIDON,2873,262,10,10,20,50.0%,31m
10177,2,友人甲,2873,274,9,9,18,50.0%,23m
10177,3,[komada]栗悟饭与龟波功,2873,235,8,8,16,50.0%,1h
10177,2,[剑七]夕惕若厉,2873,58,3,3,6,50.0%,7m
10177,2,橘子,2873,128,3,4,7,42.9%,12m
10177,3,[CNboys]Death,2873,30,1,1,2,50.0%,3m
10177,3,投降输一半,2873,30,1,1,2,50.0%,18m
10177,3,[Remf]nexus,2873,0,0,1,1,0.0%,17m
10177,3,[只为更强]生存的理由,2873,0,0,1,1,0.0%,8m
10177,3,[IlIll]hunterluo,2873,0,0,1,1,0.0%,9m
10177,3,一人国王,2873,0,0,1,1,0.0%,12m
10196,1,[浑元星际]盲辉,2872,1676,727,707,1434,50.7%,25m
10196,3,[一波正面]劈波斩浪,2872,1543,329,315,644,51.1%,5m
10196,2,FKY,2872,1616,179,164,343,52.2%,13m
10196,1,IIIIIIIIIIII,2872,1058,47,39,86,54.7%,33m
10196,2,油炸狮子头,2872,854,36,35,71,50.7%,11m
10196,1,IIIIIIIIIIII,2872,785,27,31,58,46.6%,26m
10196,3,[我亲爱的对手]yuuu,2872,344,21,8,29,72.4%,28m
10196,2,清纯帝,2872,236,19,20,39,48.7%,38m
10196,3,icarus,2872,153,12,11,23,52.2%,23m
10196,3,烟雨过客,2872,203,11,8,19,57.9%,17m
10196,2,[三国终结者]落花独舞笑看繁华,2872,194,8,7,15,53.3%,35m
10196,3,莽就完了,2872,192,7,21,28,25.0%,21m
10196,2,JKa,2872,174,5,4,9,55.6%,5m
10196,1,[真就离谱]轩辕丶烈火,2872,138,4,0,4,100.0%,4m
10196,1,水哥,2872,103,4,8,12,33.3%,7m
10196,1,朱旭宇,2872,0,1,0,1,100.0%,31m
10196,2,[魔夜]NONO,2872,0,0,1,1,0.0%,1h
10196,3,[詹姆斯T]柯克舰长,2872,0,0,1,1,0.0%,13m
10196,2,零海,2872,0,0,6,6,0.0%,18m
10215,2,你的爱丽丝,2871,1511,108,82,190,56.8%,12m
10215,1,ASDFF,2871,1558,103,81,184,56.0%,23m
10215,2,星界拾荒者,2871,725,31,28,59,52.5%,17m
10215,3,白衣,2871,494,18,12,30,60.0%,39m
10215,1,IIIIIIIIIIII,2871,334,13,10,23,56.5%,9m
10215,2,Daryal,2871,231,11,8,19,57.9%,10m
10215,2,EnTaroZertul,2871,311,11,9,20,55.0%,14m
10215,3,[北极光小组]Laevatein,2871,141,4,1,5,80.0%,17m
10215,1,呜呜,2871,48,4,4,8,50.0%,1h
10215,3,归海一刀,2871,0,3,2,5,60.0%,39m
10215,3,ItsukaKotori,2871,86,3,4,7,42.9%,24m
10215,3,艾尔之子,2871,58,2,1,3,66.7%,5m
10215,2,打我死全家,2871,88,1,2,3,33.3%,27m
10215,1,星辰,2871,0,1,2,3,33.3%,55m
10215,3,[是我赢了]loschristmas,2871,0,1,4,5,20.0%,24m
10215,2,[我们是无敌的]difei,2871,30,1,5,6,16.7%,10m
10215,3,cary,2871,0,0,1,1,0.0%,6m
10232,1,IIIIIIIIIIII,2870,1507,135,122,257,52.5%,35m
10232,2,DANAKKKA,2870,1256,120,114,234,51.3%,7m
10232,2,Revolution,2870,1486,90,82,172,52.3%,12m
10232,2,Superrui,2870,1131,61,55,116,52.6%,33m
10232,1,Batman,2870,688,58,52,110,52.7%,3m
10232,2,恶魔之少,2870,547,46,52,98,46.9%,22m
10232,3,忧郁人生,2870,967,45,40,85,52.9%,25m
10232,3,[野怪也是虫]Rival,2870,1326,45,68,113,39.8%,33m
10232,2,睚眦,2870,870,36,37,73,49.3%,22m
10232,2,空白,2870,771,31,30,61,50.8%,17m
10232,2,孙一喵喵,2870,575,23,19,42,54.8%,22m
10232,1,Jasmin,2870,524,17,22,39,43.6%,16m
10232,2,[景沐阳]快乐的大儿童附体,2870,383,15,10,25,60.0%,38m
10232,2,[艾尔之巅]郭嘉,2870,142,6,7,13,46.2%,17m
10232,3,专抢海盗,2870,99,5,5,10,50.0%,36m
10232,3,正康,2870,86,3,2,5,60.0%,10m
10232,2,NICEgood,2870,0,3,2,5,60.0%,48m
10232,2,[DMR]北沐,2870,116,3,3,6,50.0%,36m
10232,2,在黑夜里隐身,2870,0,2,2,4,50.0%,60m
10232,1,椒烤鱿鱼,2870,0,2,4,6,33.3%,1h
10232,3,[炸天帮万岁]狸九,2870,0,1,0,1,100.0%,5m
10232,3,混三第二帅,2870,0,1,0,1,100.0%,14m
10232,3,[常输将军会]焚风,2870,0,1,0,1,100.0%,8m
10232,1,Mastershy,2870,48,1,3,4,25.0%,1h
10232,2,yhy,2870,32,1,7,8,12.5%,24m
10232,3,Byun,2870,0,0,1,1,0.0%,12m
10232,2,[菜是原罪]Nothing,2870,0,0,3,3,0.0%,37m
10259,3,[傻妞]机械化说声我就退,2869,1574,131,141,272,48.2%,36m
10259,3,Aaron,2869,801,101,110,211,47.9%,11m
10259,1,霸者归来,2869,1534,93,96,189,49.2%,31m
10259,1,kai,2869,1605,79,82,161,49.1%,3m
10259,1,zero,2869,448,20,18,38,52.6%,19m
10259,2,山的一边,2869,150,6,10,16,37.5%,21m
10259,3,hhh,2869,177,5,6,11,45.5%,17m
10259,2,软泥,2869,0,4,1,5,80.0%,4m
10259,2,小杰子,2869,133,3,2,5,60.0%,1h
10259,2,[德国骨科医院]小奇,2869,60,3,2,5,60.0%,39m
10259,1,[SoLi]MYM,2869,0,3,4,7,42.9%,1h
10259,2,天难理容,2869,58,3,4,7,42.9%,21m
10259,3,一只可爱的小考拉,2869,88,3,4,7,42.9%,28m
10259,3,[境界铭]第三只的猫,2869,30,2,0,2,100.0%,23m
10259,2,苍井已成空,2869,88,2,1,3,66.7%,39m
10259,2,[quake]电池不要,2869,0,1,1,2,50.0%,15m
10259,2,[HZAU]milka,2869,30,1,3,4,25.0%,46m
10276,1,银银,2868,1119,162,156,318,50.9%,10m
10276,2,陈曦,2868,854,33,30,63,52.4%,35m
10276,3,玩游戏生气不值得,2868,608,22,19,41,53.7%,12m
10276,2,怒艹麻花藤,2868,187,21,15,36,58.3%,17m
10276,2,DDTABA,2868,331,15,16,31,48.4%,18m
10276,1,[莽狗偷]brokenheart,2868,306,11,5,16,68.8%,22m
10276,2,[miku守护]LXF,2868,218,7,6,13,53.8%,39m
10276,2,低调滴浪漫,2868,0,4,1,5,80.0%,1h
10276,1,[歌者]Steven,2868,156,4,6,10,40.0%,21m
10276,3,杀你血吗,2868,121,4,6,10,40.0%,1h
10276,3,caote,2868,0,2,3,5,40.0%,8m
10276,2,SLI,2868,64,2,5,7,28.6%,10m
10276,1,WaterOS,2868,64,2,10,12,16.7%,27m
10276,3,[我意凌云]Cynosure,2868,0,1,0,1,100.0%,8m
10276,1,[南京大学]疯狂的兔儿爷,2868,0,1,0,1,100.0%,1h
10276,2,[中华兄弟会]YhxLJY,2868,0,1,1,2,50.0%,36m
10276,2,[Cinder]噶姐的炮灰宠物狗,2868,0,1,1,2,50.0%,37m
10276,3,[天命组织]中二病也不谈恋爱,2868,30,1,2,3,33.3%,17m
10276,3,[星际新手上路]lowbee,2868,30,1,2,3,33.3%,14m
10276,3,真心不太会玩,2868,0,0,1,1,0.0%,1h
10276,2,poqi,2868,0,0,2,2,0.0%,4m
10297,2,Adair,2867,1307,121,106,227,53.3%,28m
10297,3,Zillion,2867,420,16,13,29,55.2%,17m
10297,2,饕餮,2867,90,3,7,10,30.0%,32m
10297,3,却月,2867,30,2,0,2,100.0%,32m
10297,3,[宇宙职业战队]腐竹,2867,30,2,1,3,66.7%,8m
10297,2,[暴打假萌新]超威蓝猫总舵主,2867,0,1,1,2,50.0%,3m
10297,3,ggg,2867,94,1,3,4,25.0%,8m
10297,3,好一个泰伦虫,2867,0,0,2,2,0.0%,1h
10305,1,新手,2866,460,41,42,83,49.4%,18m
10305,2,[东方幻想鄉]技巧之场,2866,563,23,18,41,56.1%,33m
10305,1,[40hour]Schumann,2866,630,21,26,47,44.7%,34m
10305,2,[二刺螈肥宅]中叼丝丶,2866,306,11,11,22,50.0%,28m
10305,2,小胖,2866,227,9,9,18,50.0%,1h
10305,1,白门楼,2866,199,8,2,10,80.0%,1h
10305,2,[装甲猎妈骑兵]鲁豫有约,2866,192,8,4,12,66.7%,17m
10305,2,IIIIIIIIIIII,2866,0,3,2,5,60.0%,60m
10305,1,Taeja,2866,125,3,2,5,60.0%,47m
10305,3,houhou,2866,86,3,3,6,50.0%,28m
10305,2,Veritas,2866,60,3,4,7,42.9%,28m
10305,2,JacobFranci,2866,88,3,5,8,37.5%,46m
10305,2,[夏日香气]冰柠檬物语,2866,90,3,6,9,33.3%,13m
10305,3,新手电脑,2866,30,2,0,2,100.0%,8m
10305,3,好汉请打我同桌,2866,30,2,1,3,66.7%,32m
10305,1,[四叶草]他可是孙哥啊,2866,97,2,1,3,66.7%,1h
10305,2,SCPLAYER,2866,0,1,0,1,100.0%,1h
10305,2,parkchoron,2866,0,1,0,1,100.0%,1h
10305,3,秒退之前想想马,2866,0,0,1,1,0.0%,1h
10324,2,Bilibobo,2865,1037,49,31,80,61.2%,17m
10324,2,浅安时光丶,2865,360,32,25,57,56.1%,39m
10324,2,Forgetmenot,2865,669,29,26,55,52.7%,12m
10324,2,再见送哈哪,2865,616,28,28,56,50.0%,11m
10324,1,ufsdfhs,2865,519,17,25,42,40.5%,18m
10324,2,IIIIIIIIIIII,2865,376,14,16,30,46.7%,22m
10324,3,炸鱼号死全家,2865,157,12,15,27,44.4%,7m
10324,1,hzhp,2865,172,7,5,12,58.3%,1h
10324,1,六学神剑,2865,223,6,9,15,40.0%,57m
10324,2,[SUSTC]白烛葵,2865,156,5,11,16,31.2%,35m
10324,1,[联盟最高议会]Skyrim,2865,122,3,1,4,75.0%,40m
10324,2,reaper,2865,0,3,2,5,60.0%,58m
10324,1,EchO,2865,143,3,3,6,50.0%,28m
10324,3,阿九的约定,2865,30,2,1,3,66.7%,13m
10324,3,阿瑞斯,2865,0,1,0,1,100.0%,19m
10324,3,[喵喵]滍语,2865,0,1,0,1,100.0%,23m
10324,2,雀神怪鸟,2865,0,1,1,2,50.0%,11m
10324,2,Orange,2865,0,1,4,5,20.0%,23m
10324,2,[谢拉单推人]音羽,2865,0,1,4,5,20.0%,16m
10324,3,[半藏为你效命]一只虫族罢了,2865,0,0,1,1,0.0%,17m
10324,2,[问卧龙几两钱]郑什么郑,2865,0,0,2,2,0.0%,36m
10345,2,管子大哥,2864,1567,122,105,227,53.7%,6m
10345,2,Light,2864,359,19,12,31,61.3%,7m
10345,1,西雨听风,2864,238,7,8,15,46.7%,42m
10345,2,極楓,2864,214,6,5,11,54.5%,27m
10345,1,煲汤比写诗重要,2864,156,5,4,9,55.6%,52m
10345,2,Volta,2864,0,4,5,9,44.4%,1h
10345,2,淡然,2864,94,4,6,10,40.0%,38m
10345,3,人间不值得,2864,30,2,0,2,100.0%,24m
10345,3,[小鸡屠宰场a]世间无我这般人,2864,0,1,0,1,100.0%,5m
10345,2,[西南风]会哭的佩可莉姆,2864,0,1,0,1,100.0%,1h
10345,2,[大熊猫饲养员]星际好难啊,2864,0,1,1,2,50.0%,46m
10345,3,[秋千千秋]蟑螂舞娘钱赞企,2864,30,1,2,3,33.3%,17m
10345,3,[社交学教员]地中海渔民,2864,0,0,1,1,0.0%,1h
10345,2,用心感化对手,2864,0,0,2,2,0.0%,13m
10359,2,神龙虾米,2863,897,42,29,71,59.2%,12m
10359,2,华仔给的忘情水,2863,333,36,39,75,48.0%,28m
10359,3,[SDE]卖女孩的小火柴,2863,875,33,28,61,54.1%,4m
10359,3,Virtue,2863,421,16,13,29,55.2%,15m
10359,3,超人气铭某,2863,325,14,9,23,60.9%,24m
10359,2,哎呦,2863,339,12,7,19,63.2%,26m
10359,2,[Shawk]房子轩,2863,235,12,9,21,57.1%,37m
10359,1,[asdasf]恶人丶宿主,2863,297,11,13,24,45.8%,31m
10359,1,[名人集团]星海游牧,2863,342,11,17,28,39.3%,23m
10359,2,[沙漠联盟]鸢豪,2863,250,10,6,16,62.5%,23m
10359,2,NumbFEverQAQ,2863,266,10,12,22,45.5%,35m
10359,1,葵葵的小熊软糖,2863,314,10,15,25,40.0%,4m
10359,3,鞭性精肛,2863,204,8,5,13,61.5%,37m
10359,1,LayoSHY,2863,201,6,12,18,33.3%,58m
10359,3,JmsZzQ,2863,0,4,3,7,57.1%,1h
10359,2,深海鱼,2863,60,2,8,10,20.0%,17m
10359,2,星羽,2863,0,1,0,1,100.0%,27m
10359,3,bibi,2863,0,0,1,1,0.0%,24m
10359,3,千年幻想,2863,0,0,1,1,0.0%,13m
10359,2,NAMCO,2863,0,0,1,1,0.0%,1h
10379,2,[春兰]暴雪背叛了星际,2862,1048,50,45,95,52.6%,13m
10379,2,[蟹堡王]咬嘴,2862,822,37,26,63,58.7%,6m
10379,2,西门吹雪,2862,567,23,19,42,54.8%,36m
10379,3,Love,2862,357,16,10,26,61.5%,22m
10379,2,[RGFC]进击的王日狗,2862,270,12,6,18,66.7%,27m
10379,2,golden,2862,264,9,8,17,52.9%,21m
10379,1,爱鬼混,2862,278,9,16,25,36.0%,31m
10379,1,阿拉纳克,2862,190,7,4,11,63.6%,57m
10379,3,苏艺瑶,2862,144,7,8,15,46.7%,7m
10379,1,[oO弃船Oo]RoyMustang,2862,141,5,3,8,62.5%,40m
10379,1,[SteEng]耗子尾汁,2862,132,5,14,19,26.3%,19m
10379,3,友好的小肉包,2862,121,3,1,4,75.0%,1h
10379,1,loop,2862,119,2,1,3,66.7%,1h
10379,1,[XYFANS]沐雨橙风,2862,0,2,2,4,50.0%,1h
10379,3,Arbiter,2862,0,1,0,1,100.0%,10m
10379,3,葬花礼,2862,0,1,1,2,50.0%,28m
10379,3,[瘾大眼瞎]大和骑脸怎么输,2862,30,1,1,2,50.0%,12m
10396,2,[LFY]南皇,2861,432,18,18,36,50.0%,36m
10396,3,[天依的御厨]陈鹜霞,2861,429,17,23,40,42.5%,11m
10396,2,幻小欣,2861,305,13,7,20,65.0%,22m
10396,2,Mojo,2861,334,13,15,28,46.4%,12m
10396,1,ANDY,2861,251,10,12,22,45.5%,52m
10396,2,[一起多人运动]oodmw,2861,286,9,10,19,47.4%,12m
10396,3,[第八舰队丶]yuting,2861,114,5,0,5,100.0%,6m
10396,3,[混元星际門]小木曾雪菜,2861,86,4,1,5,80.0%,17m
10396,3,喜欢你波,2861,144,4,2,6,66.7%,5m
10396,2,奕歌,2861,0,4,4,8,50.0%,36m
10396,2,Litte,2861,0,3,2,5,60.0%,58m
10396,3,悲情小文,2861,58,2,1,3,66.7%,16m
10396,3,[练出来了协会]还在练,2861,30,2,1,3,66.7%,25m
10396,2,喜欢轻井泽惠,2861,114,2,3,5,40.0%,27m
10396,2,[星际爱好者队]全靠内力,2861,0,1,1,2,50.0%,11m
10396,2,[老东西]龙舌兰姑娘,2861,0,0,1,1,0.0%,1h
10412,1,自己菜不要怪种族,2860,1476,1081,1085,2166,49.9%,10m
10412,2,苏咪咪,2860,1474,121,107,228,53.1%,12m
10412,1,[DMRe]封杀不果,2860,1108,88,91,179,49.2%,6m
10412,2,demon,2860,1468,78,68,146,53.4%,18m
10412,2,Tricker,2860,1021,72,71,143,50.3%,11m
10412,3,翼之队丶钱,2860,1489,70,65,135,51.9%,23m
10412,1,浑圆星际门大弟子,2860,414,54,51,105,51.4%,10m
10412,1,Sora,2860,453,37,37,74,50.0%,9m
10412,2,[钻石守门员]SHIROHA,2860,731,32,27,59,54.2%,13m
10412,2,可樂,2860,253,31,29,60,51.7%,15m
10412,2,[您好]我没有基态,2860,274,12,4,16,75.0%,36m
10412,1,落花成殇丶雨萌萌,2860,237,9,11,20,45.0%,11m
10412,1,[查尔之矛]冠位御宅,2860,246,6,13,19,31.6%,23m
10412,3,[曰帝国]longdistance,2860,144,5,4,9,55.6%,28m
10412,1,Magicka,2860,139,4,4,8,50.0%,17m
10412,3,[八爪鱼]紫影幻月,2860,0,1,0,1,100.0%,39m
10412,2,[黑骑]心向一,2860,0,1,3,4,25.0%,9m
10412,3,[圣龙佣兵团]大工匠梅卡托克,2860,0,0,1,1,0.0%,8m
10412,3,[XXHZ28]八级大狂风,2860,0,0,1,1,0.0%,12m
10412,1,莉灬零,2860,0,0,1,1,0.0%,12m
10432,2,[大宇恩]独角兽的执着,2859,832,153,144,297,51.5%,22m
10432,3,在下马保国,2859,1201,122,118,240,50.8%,19m
10432,1,[富贵不存在]夏步,2859,1231,68,61,129,52.7%,20m
10432,1,[天雪]星云,2859,364,39,41,80,48.8%,34m
10432,1,[桔梗花咲]拉扎尔苏,2859,662,35,34,69,50.7%,31m
10432,2,灰灰,2859,336,13,12,25,52.0%,35m
10432,2,自无風之明日,2859,336,11,10,21,52.4%,33m
10432,3,打打更健康,2859,246,10,6,16,62.5%,9m
10432,2,呆呆的虫子,2859,126,10,8,18,55.6%,17m
10432,2,Trytrytry,2859,143,6,4,10,60.0%,3m
10432,2,ADFA,2859,0,4,1,5,80.0%,1h
10432,2,[棒棒堂]vempire,2859,0,1,0,1,100.0%,53m
10432,2,[审判日号]IIIIIIIIII,2859,0,1,1,2,50.0%,15m
10432,3,[626]艾尔,2859,30,1,3,4,25.0%,8m
10432,3,IIIIIIIIIII,2859,30,1,4,5,20.0%,9m
10432,3,INnoVation,2859,0,0,1,1,0.0%,6m
10432,3,CFH,2859,0,0,1,1,0.0%,8m
10432,3,Thechosenone,2859,0,0,1,1,0.0%,39m
10432,2,ssss,2859,0,0,3,3,0.0%,36m
10451,2,你家隔壁王叔叔,2858,795,57,51,108,52.8%,3m
10451,1,leon,2858,822,28,36,64,43.8%,10m
10451,3,[336]Komorebi,2858,512,23,10,33,69.7%,12m
10451,3,SJONE,2858,547,22,9,31,71.0%,39m
10451,3,avota,2858,472,21,11,32,65.6%,7m
10451,2,[老年养生星际]GHGGGH,2858,503,21,24,45,46.7%,22m
10451,2,[黑白猫]花生牛奶配小乳酸,2858,324,15,8,23,65.2%,14m
10451,3,市政之光,2858,355,12,8,20,60.0%,13m
10451,1,PoiFQu,2858,272,12,9,21,57.1%,52m
10451,1,会飞的猪龙,2858,142,6,3,9,66.7%,54m
10451,3,[白银联盟]舟山星际老男孩,2858,140,5,6,11,45.5%,13m
10451,3,BlaCkAppLe,2858,118,4,6,10,40.0%,6m
10451,3,[Ours]Taoge,2858,60,3,2,5,60.0%,24m
10451,1,PIPIPIGD,2858,48,3,5,8,37.5%,11m
10451,2,Asgardian,2858,64,2,6,8,25.0%,11m
10451,3,Ruin,2858,0,1,1,2,50.0%,28m
10451,3,[星塵联萌]CrazyBoy,2858,0,1,1,2,50.0%,13m
10451,1,星空,2858,95,1,1,2,50.0%,1h
10451,1,栗子,2858,0,1,1,2,50.0%,25m
10451,3,灰烬,2858,30,1,2,3,33.3%,16m
10451,2,[Shawk]Tripatree,2858,92,1,2,3,33.3%,1h
10451,2,Yasin,2858,32,1,4,5,20.0%,13m
10451,3,[惠妻知我]普残遇疯子就退,2858,0,0,1,1,0.0%,37m
10474,3,Winson,2857,1503,167,154,321,52.0%,22m
10474,3,[火焰雷兽]IIIIIIIIIIII,2857,1264,52,42,94,55.3%,35m
10474,3,llllllllllll,2857,282,9,4,13,69.2%,13m
10474,2,rakim,2857,180,7,8,15,46.7%,23m
10474,1,[HUC群雄]奥特曼,2857,248,7,11,18,38.9%,17m
10474,1,[萌佬同好会]暴君熊,2857,144,6,3,9,66.7%,59m
10474,2,[EFT]神户小鸟,2857,46,5,2,7,71.4%,1h
10474,3,厉小成,2857,0,5,2,7,71.4%,16m
10474,2,悠云孤鸿,2857,98,5,10,15,33.3%,21m
10474,2,绯想天,2857,0,3,2,5,60.0%,1h
10474,1,[闪电]Dubhe,2857,0,3,3,6,50.0%,4m
10474,2,Recalling,2857,143,3,3,6,50.0%,50m
10474,3,[贪玩]HiveMind,2857,0,1,0,1,100.0%,7m
10474,3,凯因谢爾,2857,0,1,1,2,50.0%,5m
10474,3,菜鸡互啄,2857,30,1,1,2,50.0%,37m
10474,1,猎魔人杰洛特,2857,0,1,1,2,50.0%,1h
10474,3,GBET,2857,30,1,2,3,33.3%,28m
10474,2,[大河向东流]Grommashlee,2857,0,1,2,3,33.3%,1h
10474,1,机智的嘎鱼,2857,46,1,3,4,25.0%,9m
10474,2,[拉比安罗斯]NetFlix,2857,0,0,1,1,0.0%,14m
10474,3,[暴打假萌新]我是新手不会玩,2857,0,0,1,1,0.0%,32m
10495,2,Revolution,2856,1520,106,98,204,52.0%,22m
10495,3,[BJTU]Hidlw,2856,1353,63,72,135,46.7%,4m
10495,2,ACEsch,2856,345,48,34,82,58.5%,38m
10495,1,[C030]蓝色风暴,2856,467,23,20,43,53.5%,18m
10495,2,[小鸡屠宰场8]相心,2856,584,22,23,45,48.9%,24m
10495,2,IIIIIIIIIIII,2856,401,18,20,38,47.4%,31m
10495,3,小宝上线了,2856,359,12,8,20,60.0%,18m
10495,2,WUXI,2856,174,7,7,14,50.0%,10m
10495,3,混元星际张保国,2856,171,4,7,11,36.4%,50m
10495,3,[KPG]scvimba,2856,86,3,1,4,75.0%,4m
10495,3,[Etern谐]Neil,2856,129,3,2,5,60.0%,19m
10495,2,秋裤超人,2856,0,3,2,5,60.0%,60m
10495,3,jacksun,2856,58,2,3,5,40.0%,32m
10495,3,AiXiaoKe,2856,0,1,0,1,100.0%,9m
10495,3,人生道路不犹豫,2856,0,1,1,2,50.0%,38m
10495,1,iiiiii,2856,0,1,1,2,50.0%,59m
10495,3,[悲伤熊猫]白金之星,2856,0,0,1,1,0.0%,14m
10495,2,专打不要脸族,2856,0,0,4,4,0.0%,36m
10513,3,DrBamboo,2855,1641,76,58,134,56.7%,22m
10513,3,神奇妖怪,2855,1129,54,50,104,51.9%,13m
10513,2,砍三刀,2855,1143,47,40,87,54.0%,46m
10513,3,脑瘀血玩家,2855,768,29,27,56,51.8%,28m
10513,1,lychnis,2855,513,26,19,45,57.8%,34m
10513,3,EinhartreMan,2855,600,24,18,42,57.1%,12m
10513,2,一二三四,2855,448,19,17,36,52.8%,36m
10513,1,[嘟嘟嘟噜]melodydei,2855,279,10,5,15,66.7%,36m
10513,2,昵称就五字,2855,249,7,8,15,46.7%,1h
10513,1,hdjky,2855,121,5,4,9,55.6%,1h
10513,1,Nanxiaoqi,2855,136,5,6,11,45.5%,58m
10513,1,Tomcat,2855,188,5,11,16,31.2%,18m
10513,2,[老油条战队]拳打幼儿园,2855,161,4,3,7,57.1%,20m
10513,1,[幼儿园老大]寻一缕残温,2855,117,3,1,4,75.0%,1h
10513,2,幸运的小艺,2855,58,3,5,8,37.5%,33m
10513,2,[Beauty]黄开发,2855,62,2,5,7,28.6%,39m
10513,2,三天之内杀了你,2855,64,2,5,7,28.6%,4m
10513,3,[刺蛇互助社团]忠肝义胆孙一峰,2855,0,1,0,1,100.0%,17m
10513,3,[专业de团队]Skadi,2855,30,1,2,3,33.3%,33m
10513,3,去你的轻轻,2855,0,0,1,1,0.0%,13m
10513,3,sdfg,2855,0,0,1,1,0.0%,19m
10513,3,[CHP]aklhwek,2855,0,0,2,2,0.0%,26m
10535,3,[NVKR]爽朗君的心,2854,1487,228,213,441,51.7%,23m
10535,2,[野人time]Hersh,2854,1211,98,88,186,52.7%,39m
10535,1,让我骚一下,2854,1215,87,87,174,50.0%,8m
10535,2,lmhrtn,2854,1550,73,64,137,53.3%,12m
10535,2,made,2854,746,30,28,58,51.7%,21m
10535,2,[绝世佳人]Yamato,2854,513,25,13,38,65.8%,17m
10535,2,[不知不觉天亮]doctor,2854,460,22,12,34,64.7%,38m
10535,2,Flamingo,2854,498,22,21,43,51.2%,22m
10535,1,[不纯洁了]亚麻的春天,2854,452,14,22,36,38.9%,34m
10535,2,[河马体育]Sunkey,2854,358,12,14,26,46.2%,23m
10535,3,孑孓,2854,244,9,6,15,60.0%,17m
10535,1,熊光和熊强,2854,232,8,15,23,34.8%,28m
10535,2,卜咚咚,2854,180,7,6,13,53.8%,11m
10535,3,Mercy,2854,182,7,7,14,50.0%,37m
10535,3,AGHWEIWEI,2854,191,7,9,16,43.8%,25m
10535,1,mdc,2854,252,7,19,26,26.9%,6m
10535,1,大阳根一甩,2854,144,6,5,11,54.5%,1h
10535,3,[铁头一波]天降之灾,2854,146,6,6,12,50.0%,1h
10535,1,[WRQ]天魂,2854,0,4,2,6,66.7%,1h
10535,2,TopMaxL,2854,46,4,3,7,57.1%,1h
10535,2,[Rhusky]ANKH,2854,90,4,5,9,44.4%,4m
10535,2,[lypppp]Cokaree,2854,0,3,2,5,60.0%,53m
10535,1,浮生若梦,2854,0,3,3,6,50.0%,27m
10535,2,蛟龙号,2854,126,3,5,8,37.5%,36m
10535,3,[12D专业]影墨,2854,58,2,2,4,50.0%,24m
10535,3,MrBao,2854,0,1,0,1,100.0%,37m
10535,2,[神奇的海螺]Dearsuger,2854,0,1,0,1,100.0%,36m
10535,3,次次失败,2854,0,1,0,1,100.0%,11m
10535,3,群殴无敌菜鸟,2854,30,1,1,2,50.0%,35m
10535,3,第六天魔王,2854,96,1,1,2,50.0%,9m
10535,3,Assassins,2854,30,1,1,2,50.0%,17m
10535,3,[196]YummySad,2854,0,0,1,1,0.0%,38m
10535,3,YMin,2854,0,0,1,1,0.0%,9m
10568,2,老牛种草,2853,1519,65,67,132,49.2%,6m
10568,2,nixnix,2853,578,62,54,116,53.4%,13m
10568,2,拖了板儿,2853,284,10,15,25,40.0%,11m
10568,2,[面具老流氓]PAGE,2853,205,8,5,13,61.5%,22m
10568,1,Forestaurora,2853,199,7,2,9,77.8%,1h
10568,1,我好菜啊,2853,254,7,12,19,36.8%,3m
10568,2,[SnLo]MagicStrong,2853,30,2,2,4,50.0%,21m
10568,3,zcy,2853,0,1,0,1,100.0%,8m
10568,3,[大主教后援团]欧尼酱,2853,0,1,0,1,100.0%,25m
10568,2,OverWhelming,2853,0,0,1,1,0.0%,1h
10568,2,[童话]恋语轻唱,2853,0,0,1,1,0.0%,34m
10568,2,[烽夜长歌]帝国元首,2853,0,0,3,3,0.0%,23m
10580,2,windifsh,2852,1535,153,139,292,52.4%,46m
10580,2,wken,2852,1550,118,106,224,52.7%,14m
10580,2,AForrest,2852,1524,57,57,114,50.0%,17m
10580,3,坚挺乱放炮,2852,1228,52,44,96,54.2%,24m
10580,3,瘟疫之源致命污染,2852,153,48,46,94,51.1%,10m
10580,3,浩鹏呐,2852,1296,47,66,113,41.6%,27m
10580,3,浪无夜极星,2852,521,23,18,41,56.1%,38m
10580,3,米其林,2852,391,17,8,25,68.0%,12m
10580,3,[月野兔]不会打神族,2852,425,17,15,32,53.1%,14m
10580,1,[残疾人组]DaKe,2852,302,11,7,18,61.1%,1h
10580,1,IIIIIIII,2852,239,8,6,14,57.1%,33m
10580,3,快乐之裤,2852,242,7,8,15,46.7%,39m
10580,1,第二适格者明日香,2852,96,5,4,9,55.6%,1h
10580,2,烟云神剑,2852,145,4,2,6,66.7%,1h
10580,2,[李惠利]金明洙,2852,0,3,2,5,60.0%,9m
10580,2,[FKA]DTSknanLP,2852,0,3,3,6,50.0%,38m
10580,2,斯图可夫,2852,40,2,0,2,100.0%,1h
10580,2,疯狂山鸡,2852,30,2,2,4,50.0%,17m
10580,2,blackhuwn,2852,114,2,5,7,28.6%,1h
10580,2,[禽禽禽]不用再集结部队了,2852,64,2,9,11,18.2%,17m
10580,2,雷子丶,2852,0,1,0,1,100.0%,1h
10580,2,[DC战队]流云,2852,0,1,1,2,50.0%,37m
10580,1,eggman,2852,0,1,1,2,50.0%,31m
10580,2,[丨SLT丨]小雨天天晴,2852,0,1,4,5,20.0%,46m
10580,3,[长理白给]Inflame,2852,0,0,1,1,0.0%,1h
10605,3,asd,2851,407,96,104,200,48.0%,28m
10605,3,幽幽以往情深,2851,1569,84,67,151,55.6%,19m
10605,3,王小秋,2851,1200,58,37,95,61.1%,12m
10605,1,yAh,2851,1371,58,63,121,47.9%,25m
10605,2,黑宝,2851,1409,57,52,109,52.3%,11m
10605,1,得得得得得得得,2851,1098,38,45,83,45.8%,17m
10605,2,[ChAngE]wxffn,2851,874,32,31,63,50.8%,20m
10605,2,[太微玉清宫]虚竹,2851,467,19,23,42,45.2%,38m
10605,2,IGJACKlove,2851,463,18,15,33,54.5%,22m
10605,2,死神麒麟,2851,317,17,6,23,73.9%,24m
10605,3,[脑虫执政官]SLRaven,2851,251,11,7,18,61.1%,8m
10605,2,咬人猫,2851,216,7,10,17,41.2%,4m
10605,3,地球末日,2851,60,2,3,5,40.0%,5m
10605,2,[我高贵的族人]THEONE,2851,30,2,4,6,33.3%,35m
10605,2,[子非我知我鸡]奶我考试不过,2851,94,2,4,6,33.3%,27m
10605,3,[子小一口苗]子小火央亻圭,2851,0,1,0,1,100.0%,25m
10605,3,KING,2851,30,1,1,2,50.0%,19m
10605,1,吾王还能再战,2851,97,1,2,3,33.3%,1h
10605,1,代价什么都不是,2851,97,1,2,3,33.3%,13m
10605,1,[SDE]yyyyyyyyyyyl,2851,0,0,1,1,0.0%,25m
10605,2,[星之所在RI]援气少女天灾酱,2851,0,0,1,1,0.0%,55m
10626,3,此间少年,2850,1613,302,268,570,53.0%,32m
10626,2,土方十四郎,2850,1554,137,116,253,54.2%,28m
10626,1,Ohyes,2850,1288,82,71,153,53.6%,34m
10626,2,llllllllllll,2850,987,64,64,128,50.0%,24m
10626,2,SHOWoOO,2850,1219,52,51,103,50.5%,30m
10626,2,Randomwarl,2850,494,20,18,38,52.6%,5m
10626,2,shadow,2850,490,17,18,35,48.6%,31m
10626,2,[APM30]LGHK,2850,394,17,20,37,45.9%,5m
10626,3,幻梦丶星辰,2850,289,10,5,15,66.7%,17m
10626,3,史蒂夫的乔布斯,2850,166,7,5,12,58.3%,7m
10626,3,艾尔的利刃,2850,22,6,3,9,66.7%,4m
10626,2,casear,2850,196,6,8,14,42.9%,36m
10626,1,海子,2850,0,3,3,6,50.0%,1h
10626,3,Fire,2850,60,2,3,5,40.0%,17m
10626,3,[千只鹤]鹿目圆,2850,0,1,0,1,100.0%,16m
10626,3,[SC2战队]IIIIIIIIIIII,2850,0,1,0,1,100.0%,24m
10626,3,[艾尔之巅]LihgtningTPQ,2850,0,1,0,1,100.0%,17m
10626,2,[ANNEX]风暴无双,2850,0,1,1,2,50.0%,15m
10626,3,道法自然,2850,30,1,2,3,33.3%,8m
10626,3,易影,2850,0,1,4,5,20.0%,8m
10626,3,怒斥天尊江长老,2850,0,0,1,1,0.0%,8m
10626,3,[是我赢了]bht,2850,0,0,2,2,0.0%,36m
10648,2,Crystal,2849,1375,170,148,318,53.5%,39m
10648,3,PImba,2849,840,32,28,60,53.3%,17m
10648,2,[香槟神教]邪能小黄人,2849,610,23,29,52,44.2%,31m
10648,2,IIIIIIIIIIII,2849,410,14,16,30,46.7%,13m
10648,3,Dark,2849,45,4,3,7,57.1%,11m
10648,1,十七,2849,143,3,2,5,60.0%,42m
10648,2,[瑾萱姐姐]无痕烈阳,2849,105,3,4,7,42.9%,15m
10648,3,CrushLI,2849,30,2,0,2,100.0%,18m
10648,2,hiking,2849,40,2,2,4,50.0%,1h
10648,1,[Abadon]evilangela,2849,127,2,8,10,20.0%,9m
10648,3,沧海客,2849,0,1,0,1,100.0%,9m
10648,3,天雪蓝,2849,0,1,0,1,100.0%,37m
10648,1,花落无泪丶,2849,95,1,4,5,20.0%,1h
10648,1,羡才,2849,0,0,1,1,0.0%,25m
10648,2,灭蟑螂大队,2849,0,0,1,1,0.0%,1h
10648,3,JJJffrey,2849,0,0,2,2,0.0%,24m
10664,2,爷很持久,2848,968,36,40,76,47.4%,3m
10664,2,[整个活]毛在飞,2848,782,31,27,58,53.4%,27m
10664,3,ZPXMMK,2848,586,22,18,40,55.0%,33m
10664,2,[Beastp]bobeiya,2848,492,16,21,37,43.2%,26m
10664,3,pylonlord,2848,386,14,15,29,48.3%,28m
10664,2,烛龙,2848,295,11,9,20,55.0%,21m
10664,3,寒刀胜雪,2848,278,10,5,15,66.7%,37m
10664,3,Journal,2848,178,6,1,7,85.7%,37m
10664,2,[秋毫第五分队]幽冥流沙,2848,30,2,5,7,28.6%,7m
10664,3,[战旗COCO]梦翼彼岸,2848,0,1,0,1,100.0%,4m
10664,1,[菜有菜的道理]故故故久,2848,0,1,0,1,100.0%,1h
10664,3,起个名字真难,2848,30,1,1,2,50.0%,6m
10664,3,[莽夫苟熊]盲人能看到的条码,2848,0,0,1,1,0.0%,38m
10664,3,[戴德给拇]禅璃子单推夏色祭,2848,0,0,1,1,0.0%,5m
10664,1,嫩么气质,2848,0,0,1,1,0.0%,1h
10664,1,什么,2848,0,0,6,6,0.0%,1h
10680,1,madala,2847,667,257,237,494,52.0%,20m
10680,3,[Esc]不和同族玩,2847,656,68,59,127,53.5%,25m
10680,1,枫溪风兮,2847,1070,44,47,91,48.4%,34m
10680,2,大圣贝尔,2847,827,42,34,76,55.3%,24m
10680,2,Pudge,2847,204,33,33,66,50.0%,21m
10680,2,IIIIIIIIII,2847,471,21,19,40,52.5%,11m
10680,2,[一起加油吧]穹穹,2847,365,20,21,41,48.8%,21m
10680,2,吉姆追着夸父日,2847,328,16,15,31,51.6%,18m
10680,3,中也,2847,90,4,2,6,66.7%,9m
10680,2,[暴雪二十一队]菜鸡卫星,2847,128,3,2,5,60.0%,40m
10680,2,[X英雄圣域X]甜不辣,2847,0,3,2,5,60.0%,9m
10680,1,暴雪公司总裁,2847,97,3,5,8,37.5%,52m
10680,2,请不要打我小狗呀,2847,30,2,4,6,33.3%,15m
10680,1,哈德圣杯,2847,0,1,1,2,50.0%,1h
10680,2,[最菜战队]我好菜我想变强,2847,0,1,3,4,25.0%,36m
10680,3,[虚空守望]bacteria,2847,30,1,5,6,16.7%,5m
10680,1,虹滨,2847,0,0,2,2,0.0%,57m
10697,1,母兔,2846,1132,119,111,230,51.7%,18m
10697,2,xiaozhe,2846,855,36,30,66,54.5%,36m
10697,3,多多多米诺,2846,253,11,4,15,73.3%,39m
10697,1,Mac,2846,230,11,11,22,50.0%,19m
10697,3,[镜花水月丶]黄头发妹妹爱黑丝,2846,230,10,6,16,62.5%,1h
10697,1,[浴火银河]Amanda,2846,142,6,3,9,66.7%,1h
10697,1,水果虫虫,2846,224,6,14,20,30.0%,31m
10697,1,皮皮猪,2846,188,4,2,6,66.7%,1h
10697,1,[来自深海]贾尘,2846,117,4,4,8,50.0%,10m
10697,2,[北京城管]永恒国度,2846,166,4,6,10,40.0%,6m
10697,1,马栏山孙一峰,2846,93,2,0,2,100.0%,42m
10697,3,Auslese,2846,92,2,1,3,66.7%,18m
10697,3,狼牙兽表示不服,2846,0,1,0,1,100.0%,1h
10697,3,JOJO,2846,0,1,0,1,100.0%,13m
10697,1,安吧尼莱梦,2846,96,1,1,2,50.0%,11m
10712,1,不准狗人,2845,796,42,35,77,54.5%,28m
10712,2,Jeff,2845,888,34,32,66,51.5%,21m
10712,3,[TGone]妖魔,2845,635,31,36,67,46.3%,7m
10712,2,Lannister,2845,543,22,18,40,55.0%,38m
10712,3,你信吗,2845,460,17,15,32,53.1%,8m
10712,3,[放蕩者的茶会]跳跳虎,2845,347,14,13,27,51.9%,5m
10712,3,一片空白,2845,284,11,9,20,55.0%,25m
10712,2,DevotionLK,2845,266,10,8,18,55.6%,36m
10712,3,[Sc养老]蕾姆我的你们吃屁,2845,226,9,7,16,56.2%,24m
10712,2,ladaeaar,2845,176,6,0,6,100.0%,1h
10712,3,[混元形意星际]嘤国大力士,2845,142,6,2,8,75.0%,36m
10712,3,TaskForce,2845,124,5,11,16,31.2%,16m
10712,2,[永恒星域]变形金刚,2845,0,3,2,5,60.0%,1h
10712,3,[SHNU]斗鹰,2845,0,1,0,1,100.0%,12m
10712,2,kuangzhe,2845,30,1,5,6,16.7%,13m
10712,3,[已同化完成]Vulcan,2845,0,0,1,1,0.0%,5m
10728,1,Charlock,2844,1571,142,141,283,50.2%,25m
10728,1,[落魄山]TrickyZerg,2844,772,32,40,72,44.4%,19m
10728,3,llllllllllll,2844,288,12,5,17,70.6%,37m
10728,2,阿萨德,2844,314,12,17,29,41.4%,13m
10728,2,[XXHZ0]一只恋厨,2844,260,10,13,23,43.5%,12m
10728,3,我菜我骄傲,2844,140,6,1,7,85.7%,33m
10728,2,[一道石]永夜之殇,2844,182,6,5,11,54.5%,21m
10728,3,[天地丶无双]死神,2844,121,4,3,7,57.1%,1h
10728,1,变态无极限,2844,48,4,4,8,50.0%,21m
10728,3,[无魂之鸭]mck,2844,118,4,5,9,44.4%,22m
10728,2,ZeroWindBlow,2844,120,4,9,13,30.8%,3m
10728,2,[内蒙星际联盟]稚嫩的二五仔,2844,114,3,3,6,50.0%,6m
10728,3,轻松熊,2844,110,2,1,3,66.7%,8m
10728,3,Arthas,2844,58,2,2,4,50.0%,17m
10728,3,小玉米哦,2844,0,1,0,1,100.0%,7m
10728,3,PansD,2844,30,1,3,4,25.0%,7m
10728,3,庐山升龙霸,2844,0,0,1,1,0.0%,7m
10728,3,[水师主教之刃]PhoenixT,2844,0,0,1,1,0.0%,12m
10728,3,最强康复治疗师,2844,0,0,1,1,0.0%,39m
10728,2,沈菲洋吾儿,2844,0,0,1,1,0.0%,1h
10748,1,sdfa,2843,747,94,83,177,53.1%,28m
10748,3,风铃,2843,748,35,26,61,57.4%,16m
10748,3,心痛到无法呼吸,2843,506,18,23,41,43.9%,37m
10748,3,[皇室联盟]雨疏江影,2843,197,9,6,15,60.0%,1h
10748,3,[TPoA]我永远喜欢伊莉雅,2843,245,9,10,19,47.4%,17m
10748,3,小王,2843,169,5,8,13,38.5%,34m
10748,2,[大家的农林]钳子,2843,0,4,1,5,80.0%,48m
10748,2,IIIIIIIIIIII,2843,64,2,5,7,28.6%,46m
10748,2,[诺娃小姐姐]路过的假面骑士,2843,0,0,1,1,0.0%,1h
10748,2,百江渚与巴麻美,2843,0,0,1,1,0.0%,36m
10758,3,[喵喵]千山独行路曼曼,2842,1523,334,332,666,50.2%,19m
10758,3,[镜花水月丨]霸气的辰哥,2842,514,19,18,37,51.4%,14m
10758,2,[铁十字骷髅师]moon,2842,450,16,16,32,50.0%,3m
10758,1,notgood,2842,309,12,12,24,50.0%,52m
10758,2,醉卧沙场君莫笑,2842,360,12,19,31,38.7%,21m
10758,2,[一群谐星]DayNine,2842,250,7,13,20,35.0%,1h
10758,2,[JD]HSX,2842,118,4,11,15,26.7%,3m
10758,2,XTXT,2842,0,3,2,5,60.0%,1h
10758,2,Recall,2842,142,3,5,8,37.5%,60m
10758,2,旋风叉,2842,142,3,10,13,23.1%,1h
10758,2,[RSTAR]吾名为宙宇尘星,2842,102,2,4,6,33.3%,12m
10758,3,最菜的菜鸟,2842,0,1,0,1,100.0%,26m
10758,3,大江千里,2842,30,1,1,2,50.0%,17m
10758,2,[学习使我快乐]eating,2842,0,1,2,3,33.3%,46m
10758,3,许诺,2842,0,0,1,1,0.0%,32m
10758,3,edrfg,2842,0,0,1,1,0.0%,24m
10758,3,还我飘飘拳,2842,0,0,2,2,0.0%,9m
10775,3,梁家和的两百斤麦,2841,1523,533,529,1062,50.2%,17m
10775,3,[艾尔之巅]科学养猪第一人,2841,489,102,97,199,51.3%,19m
10775,1,[谐星联盟]xin,2841,1510,75,73,148,50.7%,28m
10775,1,treefriend,2841,961,61,61,122,50.0%,34m
10775,2,Smar,2841,529,42,26,68,61.8%,21m
10775,2,无尽空洞,2841,147,42,39,81,51.9%,31m
10775,2,邢道荣,2841,623,28,25,53,52.8%,4m
10775,3,[头号玩家]盛世豪杰,2841,590,21,21,42,50.0%,28m
10775,2,[Mikon]恰克队长,2841,526,19,18,37,51.4%,6m
10775,2,奎尔沙拉斯,2841,396,14,17,31,45.2%,21m
10775,3,Momo,2841,170,7,5,12,58.3%,13m
10775,2,无疑的滑稽怪,2841,38,5,6,11,45.5%,1h
10775,2,天夏,2841,46,4,4,8,50.0%,20m
10775,3,毒奶打击就绪,2841,58,3,0,3,100.0%,39m
10775,3,四地尅,2841,88,3,3,6,50.0%,38m
10775,3,氓僧,2841,88,3,5,8,37.5%,14m
10775,2,吃人的杜九,2841,45,2,7,9,22.2%,24m
10775,3,[圆环之理教会]超高校级的圆学家,2841,0,1,0,1,100.0%,7m
10775,3,little,2841,0,1,0,1,100.0%,35m
10775,2,smokebad,2841,38,1,1,2,50.0%,1h
10775,3,没有你的绿色,2841,0,0,1,1,0.0%,24m
10775,3,[打死不修放空]老朱,2841,0,0,1,1,0.0%,39m
10775,3,Jeff,2841,0,0,1,1,0.0%,10m
10775,3,winds,2841,0,0,1,1,0.0%,18m
10799,3,[NLHR]风痕之醉,2840,782,51,26,77,66.2%,37m
10799,2,[KNAT]黑猫,2840,713,34,37,71,47.9%,38m
10799,3,无头吃货三,2840,603,24,20,44,54.5%,13m
10799,3,[FsArH]狂派威震天,2840,426,18,17,35,51.4%,5m
10799,2,[折翼丿天使灬]goodman,2840,158,14,19,33,42.4%,17m
10799,2,Naplean,2840,299,10,3,13,76.9%,1h
10799,2,[Wsp]路明非,2840,128,10,10,20,50.0%,4m
10799,3,MISSHY,2840,220,10,14,24,41.7%,22m
10799,3,心理咨询师,2840,227,7,4,11,63.6%,25m
10799,3,[LFY]fvc,2840,86,4,0,4,100.0%,18m
10799,3,luman,2840,58,3,2,5,60.0%,17m
10799,1,你的骑士,2840,142,2,2,4,50.0%,10m
10799,3,籦儒,2840,97,1,1,2,50.0%,34m
10799,3,音律,2840,97,1,1,2,50.0%,1h
10799,2,[inene]inene,2840,0,1,2,3,33.3%,10m
10799,3,夏天协奏曲,2840,30,1,3,4,25.0%,5m
10799,2,[大爱EMT]江田岛聋哑学校,2840,88,1,3,4,25.0%,12m
10799,1,jimmy,2840,0,0,1,1,0.0%,1h
10799,3,[守夜]枕边男友,2840,0,0,1,1,0.0%,8m
10818,2,nixieo,2839,1354,79,69,148,53.4%,23m
10818,3,拒绝沉默,2839,1268,76,64,140,54.3%,15m
10818,3,异虫是食物,2839,873,36,28,64,56.2%,19m
10818,3,[天际线]龙狮,2839,461,24,19,43,55.8%,36m
10818,1,xmc,2839,286,12,12,24,50.0%,52m
10818,3,SHDark,2839,211,11,5,16,68.8%,12m
10818,3,[tree]晚安夕阳,2839,287,10,7,17,58.8%,24m
10818,3,[上班族牌护手]迷儿,2839,195,7,6,13,53.8%,1h
10818,3,HomeSandMan,2839,30,2,1,3,66.7%,16m
10818,3,茫然的星灵,2839,58,2,2,4,50.0%,8m
10818,1,TOSSterran,2839,0,2,3,5,40.0%,1h
10818,3,[loveMM]江东徐大大,2839,30,1,1,2,50.0%,36m
10818,3,[哔哩哔哩杯乾]biubiubiu,2839,0,1,1,2,50.0%,10m
10818,3,子非鱼,2839,30,1,2,3,33.3%,13m
10818,3,[洛天依]Eternal,2839,0,0,1,1,0.0%,12m
10818,1,[Google]小女王和小毛驴,2839,0,0,1,1,0.0%,11m
10818,2,七秒的记忆,2839,0,0,1,1,0.0%,1h
10818,3,[Kiloli]暗夜之牙,2839,0,0,1,1,0.0%,1h
10818,3,古德里安,2839,0,0,2,2,0.0%,18m
10837,2,lifvamp,2838,1582,208,190,398,52.3%,34m
10837,2,Griffithgouf,2838,512,92,71,163,56.4%,34m
10837,2,[艾尔之巅]ocean,2838,1194,63,59,122,51.6%,12m
10837,3,客即至当如何,2838,755,31,25,56,55.4%,39m
10837,2,你给得晴天,2838,242,9,11,20,45.0%,22m
10837,3,巅峰苇名一心,2838,206,7,7,14,50.0%,35m
10837,2,我怕发光闪瞎你,2838,0,4,1,5,80.0%,59m
10837,3,反杀闰土的猹,2838,121,3,3,6,50.0%,59m
10837,1,[胧月无眠]两仪式,2838,141,2,7,9,22.2%,36m
10837,2,BuHuan,2838,0,1,1,2,50.0%,1h
10837,3,暗殇,2838,30,1,1,2,50.0%,25m
10837,3,lxl,2838,30,1,3,4,25.0%,32m
10837,3,Lrassion,2838,0,0,1,1,0.0%,27m
10837,3,牛博大侠,2838,0,0,2,2,0.0%,19m
10837,2,严严,2838,0,0,5,5,0.0%,10m
10852,2,浅色丸子,2837,1117,138,124,262,52.7%,16m
10852,3,溶解恋色中,2837,904,77,64,141,54.6%,35m
10852,2,[C92331]要你命三千,2837,964,67,71,138,48.6%,32m
10852,2,一米,2837,488,31,27,58,53.4%,7m
10852,3,青山客,2837,335,15,11,26,57.7%,16m
10852,2,qcg,2837,181,15,18,33,45.5%,38m
10852,1,MEFQSQ,2837,335,9,16,25,36.0%,19m
10852,1,我只放六地,2837,188,6,17,23,26.1%,18m
10852,2,[飞云之上]Wondeful,2837,114,4,6,10,40.0%,22m
10852,3,天梯鸡饲料,2837,58,3,0,3,100.0%,25m
10852,2,大师是个梦,2837,125,3,2,5,60.0%,56m
10852,1,魔法大爷赵本山,2837,0,3,3,6,50.0%,1h
10852,1,吴主任,2837,97,2,1,3,66.7%,6m
10852,3,[USNavy]Enterprise,2837,0,1,0,1,100.0%,7m
10852,3,重剑无锋,2837,0,1,0,1,100.0%,18m
10852,3,[君临天下丶]redballs,2837,30,1,1,2,50.0%,26m
10852,2,[大陆谐会]乘舆,2837,0,1,1,2,50.0%,1h
10852,3,异虫图标,2837,0,1,1,2,50.0%,22m
10852,3,丿痞灬子,2837,0,1,2,3,33.3%,39m
10852,3,相见时难别亦难,2837,30,1,2,3,33.3%,12m
10852,2,刘莎莎,2837,0,1,3,4,25.0%,24m
10852,1,[鬼谷]DavidMeng,2837,0,1,3,4,25.0%,1h
10852,3,zxr,2837,0,0,1,1,0.0%,37m
10852,1,纟经,2837,0,0,3,3,0.0%,55m
10876,2,凤晨,2836,1048,209,197,406,51.5%,13m
10876,1,ZerpMao,2836,258,17,16,33,51.5%,17m
10876,1,Goldforjoy,2836,232,7,5,12,58.3%,41m
10876,1,Cqf,2836,169,6,5,11,54.5%,1h
10876,1,猛地一逼,2836,98,4,10,14,28.6%,28m
10876,3,[為伱丶变乖]终成空,2836,30,2,1,3,66.7%,9m
10876,3,[超实验级的]wrh,2836,58,2,1,3,66.7%,9m
10876,2,教父的三米一,2836,88,2,2,4,50.0%,32m
10876,3,llllllllllll,2836,60,2,4,6,33.3%,32m
10876,3,ydydm,2836,0,1,0,1,100.0%,24m
10876,3,IIIIIIIIIIII,2836,0,1,0,1,100.0%,28m
10876,1,阿宇呀呀,2836,90,1,1,2,50.0%,1h
10876,3,小虫虫,2836,30,1,3,4,25.0%,14m
10876,2,我是盲人,2836,0,0,1,1,0.0%,1h
10876,1,海洋游侠,2836,0,0,2,2,0.0%,1h
10876,2,[我心有猛虎]梦是林下夕,2836,0,0,3,3,0.0%,30m
10892,3,小显,2835,1454,274,265,539,50.8%,34m
10892,1,JerkJ,2835,1172,196,193,389,50.4%,17m
10892,3,就是艾斯特了,2835,1353,65,77,142,45.8%,9m
10892,3,你需要更多的王虫,2835,306,11,9,20,55.0%,9m
10892,3,刻进心的名字,2835,254,10,8,18,55.6%,48m
10892,3,犀利马大哈,2835,212,7,4,11,63.6%,39m
10892,3,半个菜鸡,2835,108,7,5,12,58.3%,24m
10892,3,[刺蛇互助社团]枫叶漫漫,2835,86,3,1,4,75.0%,39m
10892,2,MYMlost,2835,102,3,3,6,50.0%,30m
10892,2,美丽的潘姐姐,2835,23,3,4,7,42.9%,31m
10892,3,[Beam]VoidVoyage,2835,62,2,4,6,33.3%,1h
10892,2,[六味地黄丸]油油,2835,127,2,5,7,28.6%,11m
10892,2,[HK丶S]KhanLing,2835,58,2,6,8,25.0%,17m
10892,2,[Hs浪]虫群万睡,2835,0,1,0,1,100.0%,1h
10892,2,ImmoRtaL,2835,0,1,0,1,100.0%,46m
10907,2,涛少,2834,1454,59,59,118,50.0%,28m
10907,2,Huebeck,2834,1161,55,41,96,57.3%,36m
10907,3,BloodEagle,2834,1005,46,32,78,59.0%,18m
10907,2,闪电五鞭,2834,588,24,22,46,52.2%,12m
10907,2,[SCMIW]笔芯,2834,472,17,18,35,48.6%,17m
10907,1,孤青鸾影,2834,141,5,5,10,50.0%,42m
10907,2,zbc,2834,139,4,4,8,50.0%,53m
10907,2,[小鸡屠宰场7]勇者,2834,116,4,7,11,36.4%,39m
10907,3,不会运营只会斗狗,2834,58,3,0,3,100.0%,32m
10907,3,喵神,2834,60,3,2,5,60.0%,38m
10907,2,堂口兄弟真的猛,2834,0,3,2,5,60.0%,20m
10907,3,KOAJUST,2834,83,3,4,7,42.9%,33m
10907,3,药物喂了喵呜肉,2834,30,2,1,3,66.7%,22m
10907,3,[就这就这]Cephedra,2834,0,1,0,1,100.0%,13m
10907,3,FYlike,2834,0,1,1,2,50.0%,16m
10907,3,[乾坤星际门]FFK,2834,30,1,3,4,25.0%,4m
10907,3,RedCraaot,2834,0,0,1,1,0.0%,9m
10907,1,TZP,2834,0,0,2,2,0.0%,11m
10907,3,哈无闻,2834,0,0,2,2,0.0%,28m
10926,3,monkeyking,2833,1492,282,297,579,48.7%,30m
10926,3,您的智商已欠费,2833,770,32,21,53,60.4%,33m
10926,2,galaxyc,2833,340,24,20,44,54.5%,6m
10926,1,罗卡,2833,471,21,30,51,41.2%,19m
10926,2,[蠢萌呆]萌萌的小喵喵,2833,408,16,15,31,51.6%,21m
10926,2,墨灬竹,2833,305,12,11,23,52.2%,37m
10926,3,[不知不觉天亮]supercandy,2833,262,10,8,18,55.6%,38m
10926,2,lzh,2833,218,8,3,11,72.7%,12m
10926,3,不能语音,2833,131,7,7,14,50.0%,24m
10926,1,[TNLet]Courtyard,2833,165,6,4,10,60.0%,27m
10926,3,星灬焱,2833,146,6,6,12,50.0%,8m
10926,2,rozerta,2833,30,4,4,8,50.0%,16m
10926,2,[SSSolo]瑞文戴尔男爵,2833,94,3,3,6,50.0%,1h
10926,1,[菜鸡球带]八千米蔚蓝,2833,0,1,0,1,100.0%,13m
10926,2,绘崎可乐助,2833,0,1,0,1,100.0%,55m
10926,3,[四叶草]千年之狐,2833,0,1,0,1,100.0%,32m
10926,3,APPLE,2833,0,0,1,1,0.0%,8m
10926,2,[鸠UP]JoASHER,2833,0,0,1,1,0.0%,1h
10926,3,[蜜臀姐姐联盟]fire,2833,0,0,1,1,0.0%,8m
10926,3,[星歌]妄言,2833,0,0,1,1,0.0%,3m
10926,3,[柠檬保护协会]SuperLemon,2833,0,0,1,1,0.0%,7m
10926,2,酱油,2833,0,0,1,1,0.0%,30m
10926,3,[乖乖3站好]BLACK,2833,0,0,2,2,0.0%,14m
10949,1,权限狗必死,2832,1601,129,102,231,55.8%,28m
10949,2,[知乎战队]快看有逗逼,2832,1287,52,56,108,48.1%,22m
10949,3,PatrChenk,2832,370,12,9,21,57.1%,14m
10949,3,[星辰腰子队]暗键师,2832,265,11,12,23,47.8%,22m
10949,3,[MQ双狗]汤元度,2832,239,8,9,17,47.1%,1h
10949,1,[舰队训练营]Lancerlot,2832,48,5,4,9,55.6%,32m
10949,3,ZHI,2832,58,3,1,4,75.0%,39m
10949,1,蔚蓝,2832,96,3,2,5,60.0%,1h
10949,2,Timeknight,2832,0,2,2,4,50.0%,1h
10949,2,基情四射,2832,30,2,3,5,40.0%,32m
10949,2,无冬夜,2832,0,2,3,5,40.0%,20m
10949,2,烦味丶凌驰,2832,0,2,3,5,40.0%,1h
10949,2,不可休思,2832,120,2,4,6,33.3%,32m
10949,1,[红莲骑士团]寂静的琴声,2832,117,2,6,8,25.0%,21m
10949,3,出其东门,2832,0,1,0,1,100.0%,18m
10949,3,和泉纱雾,2832,0,1,0,1,100.0%,32m
10949,3,无事忙,2832,0,1,0,1,100.0%,35m
10949,3,天下最白,2832,0,1,0,1,100.0%,19m
10949,3,[梦幻之星ol]轻井泽惠,2832,0,1,0,1,100.0%,33m
10949,2,[坚决泽格]kissingher,2832,45,1,4,5,20.0%,38m
10949,3,[重新集结虫群]二十三丝动紫皇,2832,0,0,1,1,0.0%,17m
10949,3,蛛丝马迹,2832,0,0,1,1,0.0%,25m
10949,1,黑崎一护,2832,0,0,7,7,0.0%,38m
10972,3,[旺旺战士]ShenKe,2831,1536,206,190,396,52.0%,24m
10972,2,yanglv,2831,1482,77,68,145,53.1%,6m
10972,2,此乃天意,2831,809,32,31,63,50.8%,12m
10972,3,[红莲骑士团]yesandno,2831,649,27,22,49,55.1%,9m
10972,2,[EnE]迷途浪子,2831,635,27,25,52,51.9%,20m
10972,2,[欧派萌新团]渺小的星星,2831,268,14,7,21,66.7%,7m
10972,3,一波狗全家暴毙,2831,269,12,11,23,52.2%,9m
10972,2,[FORI2]小春,2831,350,12,14,26,46.2%,12m
10972,2,总有刁民想害朕,2831,172,10,13,23,43.5%,38m
10972,3,你要找茬吗小子,2831,263,9,5,14,64.3%,32m
10972,2,[熊出没注意]湾区吴彦祖,2831,236,9,13,22,40.9%,12m
10972,1,Loris,2831,186,6,4,10,60.0%,1h
10972,3,小草,2831,148,5,4,9,55.6%,12m
10972,2,Laguz,2831,86,4,9,13,30.8%,28m
10972,2,一般通过的车车人,2831,107,3,3,6,50.0%,13m
10972,1,[四世三公]聂颍莎,2831,0,3,4,7,42.9%,1h
10972,3,好春光,2831,0,1,0,1,100.0%,8m
10972,3,[萌新zd]人各友志,2831,0,1,0,1,100.0%,8m
10972,3,[巨魔之家]混元马婷婷,2831,91,1,1,2,50.0%,9m
10972,1,PAPAHAN,2831,48,1,3,4,25.0%,38m
10972,2,被打进未知领域,2831,88,1,4,5,20.0%,22m
10972,3,我要重新集结部队,2831,0,0,1,1,0.0%,9m
10972,3,[兄弟一起星际]埃蒙,2831,0,0,1,1,0.0%,8m
10972,2,[有空就摸一摸]自摸三万,2831,0,0,1,1,0.0%,1h
10996,2,NewPlayer,2830,1280,49,51,100,49.0%,10m
10996,2,[NewbeI]没有自由的翼,2830,677,29,28,57,50.9%,14m
10996,2,得过且过,2830,604,26,21,47,55.3%,12m
10996,3,[什么价钱]NagaeIku,2830,483,20,14,34,58.8%,18m
10996,2,wupeng,2830,145,19,18,37,51.4%,4m
10996,3,[TNLet]喵内噶,2830,274,15,11,26,57.7%,9m
10996,2,[我们爱苍井龙]Ein,2830,269,10,10,20,50.0%,1h
10996,1,ysx,2830,190,5,6,11,45.5%,1h
10996,2,sdd,2830,0,3,2,5,60.0%,1h
10996,1,ERic,2830,0,3,4,7,42.9%,1h
10996,3,INnoVation,2830,88,3,5,8,37.5%,12m
10996,1,voice,2830,82,2,7,9,22.2%,9m
10996,3,RYTYTU,2830,0,1,0,1,100.0%,32m
10996,3,[传奇二五仔]干啥啥不行,2830,0,1,0,1,100.0%,17m
10996,3,Goldberg,2830,30,1,3,4,25.0%,35m
10996,3,[暴雪八队]DarkRanger,2830,0,0,1,1,0.0%,8m
10996,3,[comes]SKT,2830,0,0,1,1,0.0%,15m
10996,3,[DMR]HALO,2830,0,0,1,1,0.0%,23m
10996,2,[OoAoO]电脑玩家,2830,0,0,4,4,0.0%,32m
11015,2,狗毒爆都是儿子,2829,351,14,11,25,56.0%,39m
11015,3,北有疑兵,2829,345,14,11,25,56.0%,14m
11015,1,[萌萌大军团]哼唧哼唧,2829,284,8,11,19,42.1%,4m
11015,2,Dome,2829,178,7,9,16,43.8%,38m
11015,1,edumodu,2829,207,6,7,13,46.2%,33m
11015,3,在半路,2829,141,3,1,4,75.0%,17m
11015,3,[火焰雷兽]innovating,2829,58,2,1,3,66.7%,18m
11015,3,[Beasty]关灯吃面,2829,58,2,2,4,50.0%,4m
11015,3,[FwgsOB]wintermelon,2829,0,1,0,1,100.0%,9m
11015,3,[Elite]IlllllllIlll,2829,96,1,1,2,50.0%,1h
11015,3,提尔比茨,2829,30,1,1,2,50.0%,27m
11015,3,[CNEB]SKTTossGirl,2829,0,0,1,1,0.0%,8m
11015,3,[6G芯片研發]开罗宣言,2829,0,0,1,1,0.0%,8m
11015,3,[羊驼羊驼羊]Deathstoke,2829,0,0,1,1,0.0%,35m
11015,1,岳不群,2829,0,0,1,1,0.0%,14m
11030,1,时光荏苒岁月静好,2828,683,130,108,238,54.6%,5m
11030,3,怅怅莫怪少年时,2828,1520,130,112,242,53.7%,13m
11030,2,[果断]多么痛的领悟,2828,1132,130,118,248,52.4%,14m
11030,1,Allstar,2828,597,97,97,194,50.0%,20m
11030,1,[JEIBO]akira,2828,819,35,44,79,44.3%,24m
11030,3,罗杰船长,2828,725,29,25,54,53.7%,9m
11030,3,左眼皮老跳,2828,486,21,18,39,53.8%,22m
11030,2,[Mikon]Night,2828,453,20,21,41,48.8%,6m
11030,1,[毛毛球]苍穹魅影,2828,183,8,4,12,66.7%,55m
11030,1,一拳超人,2828,212,8,5,13,61.5%,1h
11030,2,Linda,2828,185,7,7,14,50.0%,12m
11030,1,Dumm,2828,142,5,3,8,62.5%,1h
11030,1,[柳岩玩星际]contra,2828,123,4,9,13,30.8%,27m
11030,2,郑郭,2828,130,3,0,3,100.0%,53m
11030,2,Pororo,2828,0,3,2,5,60.0%,23m
11030,1,胆大如斗黄旭东,2828,84,2,0,2,100.0%,1h
11030,3,[死宅同盟会]三闯虎牢关,2828,30,2,1,3,66.7%,13m
11030,2,米饭铺铺,2828,130,2,4,6,33.3%,41m
11030,3,阿疯,2828,0,1,0,1,100.0%,17m
11030,3,李建军,2828,0,1,0,1,100.0%,24m
11030,2,ASDonew,2828,0,1,0,1,100.0%,1h
11030,2,渣渣催,2828,0,1,3,4,25.0%,11m
11030,3,[倥偬]LonelyBlack,2828,0,0,1,1,0.0%,18m
11030,3,[自创]Aster,2828,0,0,1,1,0.0%,38m
11030,2,摸鱼天王稀神探女,2828,0,0,1,1,0.0%,26m
11030,3,我是猪,2828,0,0,2,2,0.0%,27m
11056,1,DRAGON,2827,1605,252,249,501,50.3%,17m
11056,3,Duck,2827,1283,90,73,163,55.2%,25m
11056,2,zzz,2827,704,40,38,78,51.3%,14m
11056,3,Cincelia,2827,524,27,15,42,64.3%,7m
11056,3,RainyStars,2827,329,13,13,26,50.0%,16m
11056,1,hdjfmjgfukg,2827,229,8,5,13,61.5%,33m
11056,1,[鬼谷]零壹魔,2827,181,5,4,9,55.6%,19m
11056,2,黎明,2827,144,5,8,13,38.5%,27m
11056,3,[无双]YcDan,2827,144,4,4,8,50.0%,1h
11056,2,[bati]小猫带刀,2827,94,3,3,6,50.0%,1h
11056,3,最爱打气球,2827,0,1,0,1,100.0%,33m
11056,2,Geoffrey,2827,0,1,0,1,100.0%,34m
11056,3,[远坂世家]紫夜辰逸丶,2827,0,1,0,1,100.0%,32m
11056,3,[Ompc]安芸伦也,2827,0,1,1,2,50.0%,9m
11056,3,沈小鱼,2827,0,0,1,1,0.0%,38m
11056,2,MagicGnome,2827,0,0,3,3,0.0%,35m
11072,3,哈拉骚,2826,459,19,15,34,55.9%,16m
11072,3,[我菜请打队友]懒猫,2826,409,18,14,32,56.2%,5m
11072,3,战闪新星,2826,305,13,4,17,76.5%,12m
11072,2,[日最野的狗]wqdsfgf,2826,316,12,11,23,52.2%,20m
11072,2,[可恶啊]tfty,2826,232,9,13,22,40.9%,21m
11072,3,星际憋憋乐玩家,2826,188,6,1,7,85.7%,17m
11072,3,firmament,2826,192,6,2,8,75.0%,10m
11072,3,Tigger,2826,72,6,6,12,50.0%,39m
11072,2,[白丝黑丝萝莉]狂杀落雪,2826,140,5,4,9,55.6%,17m
11072,1,WADAXIWAKT,2826,97,4,4,8,50.0%,1h
11072,1,geyucong,2826,0,3,3,6,50.0%,1h
11072,3,IIIIIIIIIIII,2826,92,3,4,7,42.9%,12m
11072,3,[造物主泰勒]human,2826,122,2,2,4,50.0%,32m
11072,2,llllllllllll,2826,0,1,0,1,100.0%,14m
11072,2,[无畏巡洋]猎人,2826,0,0,6,6,0.0%,4m
11087,2,youlin,2825,1223,125,109,234,53.4%,17m
11087,3,Ling,2825,1224,72,57,129,55.8%,5m
11087,3,含光,2825,971,44,27,71,62.0%,38m
11087,3,北沫,2825,538,23,13,36,63.9%,18m
11087,3,低调小王,2825,405,16,9,25,64.0%,39m
11087,1,llllIIIIIlll,2825,422,14,24,38,36.8%,23m
11087,3,瞿帅比,2825,373,13,10,23,56.5%,32m
11087,3,[怒气]须进时,2825,264,9,4,13,69.2%,32m
11087,3,TNGT,2825,226,8,7,15,53.3%,14m
11087,3,舞法天女黄旭东,2825,180,6,7,13,46.2%,13m
11087,2,卷土重来,2825,126,4,3,7,57.1%,36m
11087,3,艾尔小圆盾,2825,0,4,4,8,50.0%,18m
11087,2,[艹狗狂黄旭东]IIIIIIIIIIII,2825,95,3,3,6,50.0%,58m
11087,3,[星际丶老男孩]寂文夕,2825,60,2,3,5,40.0%,13m
11087,3,包子在空中,2825,0,1,0,1,100.0%,38m
11087,3,[DMRc]Raynor,2825,0,0,1,1,0.0%,19m
11087,3,闲云野鹤,2825,0,0,1,1,0.0%,10m
11104,1,[暮Licht]Ichigao,2824,1588,223,225,448,49.8%,19m
11104,2,新手,2824,1533,213,205,418,51.0%,22m
11104,3,[KPG2]cherry,2824,1443,82,98,180,45.6%,5m
11104,2,aaeleven,2824,665,78,67,145,53.8%,11m
11104,3,[HustSC]消逝离去,2824,373,13,15,28,46.4%,25m
11104,3,IIIIIIIIII,2824,261,10,2,12,83.3%,5m
11104,3,卡其脱离太,2824,227,10,8,18,55.6%,14m
11104,1,ILLUMINATION,2824,187,7,6,13,53.8%,12m
11104,3,龙霸天,2824,169,7,8,15,46.7%,16m
11104,3,GEO,2824,142,5,3,8,62.5%,37m
11104,3,爱过我足矣,2824,86,3,5,8,37.5%,13m
11104,3,无名守候,2824,0,1,0,1,100.0%,33m
11104,2,都是弟弟,2824,30,1,10,11,9.1%,38m
11104,3,[KPG2]Mauvais,2824,0,0,5,5,0.0%,13m
11118,1,维度,2823,1034,142,123,265,53.6%,28m
11118,3,[丨SLT丨]ZeroZero,2823,1562,121,101,222,54.5%,19m
11118,3,[loveMM]moyu,2823,529,39,25,64,60.9%,37m
11118,3,[老油条战队2]DLyaoguo,2823,585,24,17,41,58.5%,33m
11118,2,Jay,2823,539,20,19,39,51.3%,27m
11118,3,缝合怪,2823,322,13,4,17,76.5%,12m
11118,3,xsw,2823,345,13,15,28,46.4%,5m
11118,1,[北部战区]SoS,2823,416,13,21,34,38.2%,25m
11118,2,鬼叁,2823,356,12,18,30,40.0%,11m
11118,3,[冠冕]lingtas,2823,220,10,7,17,58.8%,1h
11118,3,永恒的秩序,2823,213,6,3,9,66.7%,25m
11118,2,魔法少女绫波,2823,163,6,8,14,42.9%,45m
11118,2,宋少,2823,91,5,1,6,83.3%,52m
11118,3,Sakura,2823,122,5,7,12,41.7%,43m
11118,3,railgun,2823,141,4,0,4,100.0%,16m
11118,2,ooooo,2823,90,4,7,11,36.4%,12m
11118,1,黑夜之中看着你,2823,0,3,4,7,42.9%,1h
11118,3,飞度,2823,60,2,5,7,28.6%,25m
11118,3,极珏幽璃,2823,0,1,1,2,50.0%,8m
11118,2,[东方非想天则]奈仓,2823,93,1,4,5,20.0%,1h
11118,2,亮亮,2823,0,0,1,1,0.0%,1h
11118,1,IIIIIIIIIIII,2823,0,0,2,2,0.0%,25m
11140,1,doopower,2822,1392,169,176,345,49.0%,17m
11140,3,tommyvan,2822,1327,55,52,107,51.4%,22m
11140,3,SAOBTerran,2822,1169,45,43,88,51.1%,13m
11140,1,[Icycry]我不是美女儿,2822,456,40,47,87,46.0%,5m
11140,2,Shadow,2822,1012,37,41,78,47.4%,21m
11140,1,斗鱼小宇丶,2822,735,25,35,60,41.7%,23m
11140,3,狂野之狼,2822,459,20,16,36,55.6%,24m
11140,3,我讨厌刺蛇,2822,383,16,16,32,50.0%,9m
11140,3,HAVEN,2822,336,14,13,27,51.9%,6m
11140,2,在下喜欢飙车,2822,275,9,12,21,42.9%,31m
11140,3,qqqq,2822,226,8,9,17,47.1%,8m
11140,3,FReeloo,2822,203,7,1,8,87.5%,25m
11140,1,Hypocrisy,2822,0,4,2,6,66.7%,1h
11140,3,小菜鸟,2822,58,3,0,3,100.0%,10m
11140,1,我是大怪物,2822,123,3,2,5,60.0%,26m
11140,1,诺玛,2822,142,2,1,3,66.7%,5m
11140,3,[Fear]浩瀚哥生日快乐,2822,0,1,0,1,100.0%,18m
11140,1,[感恩]指挥官,2822,0,1,1,2,50.0%,8m
11140,3,鬼魅之犬,2822,0,1,1,2,50.0%,24m
11159,1,MrLong,2821,810,98,101,199,49.2%,14m
11159,1,龟壳黄旭东,2821,1034,40,42,82,48.8%,18m
11159,3,白炽灯,2821,824,38,22,60,63.3%,13m
11159,3,SyuuJhin,2821,1028,33,55,88,37.5%,10m
11159,3,[黄金战队]洛殿,2821,409,20,12,32,62.5%,7m
11159,3,[四叶草]RainySky,2821,262,9,10,19,47.4%,17m
11159,2,[玛莎哥牛B]天从人愿,2821,177,7,8,15,46.7%,49m
11159,1,YONG,2821,121,4,4,8,50.0%,55m
11159,1,[神樂七奈ol]阳菜,2821,141,3,1,4,75.0%,57m
11159,3,安装,2821,0,3,2,5,60.0%,15m
11159,1,有只元素萨,2821,96,3,5,8,37.5%,14m
11159,3,[XXHZ33]魔皇邪帝,2821,30,1,1,2,50.0%,13m
11159,3,IIIIIIIIIIII,2821,0,1,1,2,50.0%,25m
11159,2,曾经来过,2821,44,1,2,3,33.3%,1h
11159,2,WanZi,2821,36,1,3,4,25.0%,47m
11159,3,[韩宗快乐屋]菜鸡,2821,0,0,1,1,0.0%,25m
11159,3,[初音未来01]初音未来,2821,0,0,1,1,0.0%,5m
11159,2,[DX战队]KINGBHZX,2821,0,0,1,1,0.0%,14m
11177,1,奉先,2820,1569,65,62,127,51.2%,28m
11177,3,向风偏笑艳阳人,2820,761,45,39,84,53.6%,10m
11177,2,llllllllllll,2820,296,28,24,52,53.8%,11m
11177,1,风过无痕,2820,549,23,27,50,46.0%,20m
11177,3,[zxtgt]holmes,2820,395,14,9,23,60.9%,32m
11177,3,[五月花]佐仓枫,2820,194,7,3,10,70.0%,18m
11177,2,简单的电脑,2820,188,7,12,19,36.8%,11m
11177,3,英格李氏,2820,140,6,4,10,60.0%,17m
11177,1,叆叇,2820,118,4,14,18,22.2%,17m
11177,1,那个男孩,2820,0,3,4,7,42.9%,1h
11177,3,[ceeeeb]陆夯,2820,30,2,1,3,66.7%,28m
11177,1,雨落狂流之暗,2820,34,1,12,13,7.7%,4m
11177,3,陆战队员,2820,0,0,1,1,0.0%,23m
11177,3,zzqmm,2820,0,0,1,1,0.0%,39m
11191,2,[童话小镇]大战三百合,2819,959,83,65,148,56.1%,37m
11191,2,哈哈,2819,1417,73,76,149,49.0%,22m
11191,2,[NVKR]呆表永远滴神,2819,851,34,37,71,47.9%,24m
11191,2,生如夏花死如秋叶,2819,196,9,4,13,69.2%,13m
11191,2,llllllllllll,2819,204,8,6,14,57.1%,22m
11191,3,IIIIIIIII,2819,172,7,4,11,63.6%,16m
11191,1,别动老子农民,2819,179,5,3,8,62.5%,1h
11191,2,TNT,2819,137,3,2,5,60.0%,12m
11191,1,[你们都是渣]嘿嘿嘿,2819,120,3,2,5,60.0%,1h
11191,3,asdoku,2819,58,2,1,3,66.7%,5m
11191,1,DALI,2819,0,2,7,9,22.2%,25m
11191,2,星际爱好者,2819,0,1,0,1,100.0%,13m
11191,1,Dionysus,2819,0,1,0,1,100.0%,21m
11191,2,BYuN,2819,0,0,1,1,0.0%,1h
11191,3,[唯爱三三]QAQ,2819,0,0,1,1,0.0%,18m
11191,3,阿布,2819,0,0,1,1,0.0%,8m
11191,3,西山铁头娃,2819,0,0,2,2,0.0%,38m
11208,3,Vertigo,2818,1002,43,34,77,55.8%,24m
11208,2,[SC2近卫军]路标,2818,990,39,40,79,49.4%,12m
11208,3,风轻云淡,2818,363,24,8,32,75.0%,5m
11208,3,[WCD]StanleyAlex,2818,539,18,16,34,52.9%,17m
11208,2,HIDER,2818,280,16,12,28,57.1%,36m
11208,3,不玩同族对抗,2818,357,15,14,29,51.7%,32m
11208,2,sochralar,2818,290,11,13,24,45.8%,9m
11208,3,[KF一大群C]雨丶小冰,2818,308,10,8,18,55.6%,4m
11208,1,blue,2818,193,9,7,16,56.2%,10m
11208,3,柯雨,2818,120,5,5,10,50.0%,1h
11208,3,落无星,2818,0,4,1,5,80.0%,19m
11208,3,[大宇恩]炸鱼的废物,2818,88,4,3,7,57.1%,13m
11208,3,[马鹿子]海兔柒,2818,137,4,8,12,33.3%,26m
11208,3,[老头星际]比企谷彩加,2818,60,3,2,5,60.0%,38m
11208,2,Linkou,2818,0,2,4,6,33.3%,1h
11208,3,恶人,2818,0,1,1,2,50.0%,17m
11208,1,倾卿,2818,95,1,1,2,50.0%,33m
11208,3,DNP,2818,30,1,3,4,25.0%,19m
11208,3,loseitall,2818,0,0,2,2,0.0%,38m
11227,2,小六毛,2817,400,31,25,56,55.4%,7m
11227,2,[梦瑾空人心]路名渊,2817,340,13,12,25,52.0%,36m
11227,3,[最强灬狼牙队]YHW,2817,210,12,9,21,57.1%,17m
11227,3,不上钻石不改名,2817,186,8,6,14,57.1%,1h
11227,2,siru,2817,123,6,3,9,66.7%,26m
11227,1,沉默黑夜,2817,119,4,5,9,44.4%,1h
11227,2,[OldGuy]湖广按察使,2817,0,3,3,6,50.0%,58m
11227,2,剜心小叔,2817,0,1,0,1,100.0%,1h
11227,1,姜丝,2817,0,1,0,1,100.0%,19m
11227,3,[黑暗圣堂棱镜]冰弦结御,2817,30,1,1,2,50.0%,32m
11227,1,[灵猫]诺大的娃,2817,96,1,1,2,50.0%,49m
11227,2,金星石,2817,0,1,1,2,50.0%,1h
11227,3,给爷笑一个,2817,0,0,1,1,0.0%,13m
11227,1,Gradually,2817,0,0,2,2,0.0%,1h
11241,2,xiaoc,2816,1191,116,99,215,54.0%,20m
11241,2,[婬蕙涩情]lIIllIlIlIlI,2816,1526,116,113,229,50.7%,24m
11241,2,morphling,2816,1039,85,75,160,53.1%,13m
11241,3,南邮码王,2816,885,64,55,119,53.8%,9m
11241,3,[机械混成旅]菌毯裹尸还,2816,1482,59,68,127,46.5%,16m
11241,3,[s黑色玫瑰s]贤贤易色,2816,912,41,30,71,57.7%,12m
11241,3,绝活多线送兵,2816,690,31,32,63,49.2%,8m
11241,2,卑微的熊大,2816,600,27,23,50,54.0%,12m
11241,1,[天国之魔]GGmoonlight,2816,792,26,41,67,38.8%,11m
11241,2,Licion,2816,494,24,22,46,52.2%,3m
11241,2,[孙岱玹]oasis,2816,459,18,15,33,54.5%,16m
11241,2,鬼才海绵宝宝,2816,385,17,11,28,60.7%,37m
11241,3,oooooooooooo,2816,279,13,9,22,59.1%,10m
11241,3,阿斯缔,2816,330,12,14,26,46.2%,5m
11241,3,凛冬,2816,118,10,7,17,58.8%,1h
11241,3,[潮了]Spoony,2816,252,9,10,19,47.4%,12m
11241,3,[多人皆可]言之严,2816,224,8,6,14,57.1%,39m
11241,2,[兆景埋土大学]兆君主,2816,152,5,6,11,45.5%,36m
11241,1,wuyu,2816,48,4,4,8,50.0%,49m
11241,2,[LOHv]真的好生气,2816,94,3,3,6,50.0%,60m
11241,1,[我爱SCII]NJKG,2816,0,3,3,6,50.0%,40m
11241,3,梁唐晋汉周,2816,30,2,1,3,66.7%,5m
11241,2,周数壬,2816,0,1,0,1,100.0%,1h
11241,3,手速快的都是单身,2816,0,1,0,1,100.0%,19m
11241,3,平康大魔王,2816,0,0,1,1,0.0%,18m
11266,2,霹雳侠,2815,1594,125,115,240,52.1%,11m
11266,3,[小土鸡]saber,2815,474,17,18,35,48.6%,37m
11266,1,御剑冥夜,2815,301,13,11,24,54.2%,1h
11266,2,[CPT]神族舰队都没傻,2815,191,9,17,26,34.6%,38m
11266,3,南有丶嘉木,2815,176,7,4,11,63.6%,8m
11266,2,忧愁,2815,239,7,5,12,58.3%,1h
11266,3,[小小泰伦人]就是辣个天神,2815,142,6,6,12,50.0%,37m
11266,3,爱神,2815,86,4,3,7,57.1%,33m
11266,3,她与疾风都是过客,2815,116,4,4,8,50.0%,9m
11266,3,丨冰糖,2815,127,3,1,4,75.0%,1h
11266,3,凯瑞甘首席女弟子,2815,58,3,2,5,60.0%,13m
11266,2,[陪我闹]飒冥,2815,0,3,2,5,60.0%,36m
11266,3,[旧日塔罗会]章鱼丸子,2815,34,3,4,7,42.9%,17m
11266,2,ASKJ,2815,30,1,5,6,16.7%,39m
11266,2,花泽类,2815,30,1,5,6,16.7%,6m
11266,2,kcyclever,2815,0,0,1,1,0.0%,54m
11266,3,[HJ灬GD]异端者,2815,0,0,3,3,0.0%,16m
11266,3,喻鹏翰我的儿,2815,0,0,3,3,0.0%,38m
11284,3,黄旭东,2814,1498,177,152,329,53.8%,13m
11284,1,TOSS,2814,1380,58,69,127,45.7%,6m
11284,2,xxxxxxxxxxxx,2814,104,36,37,73,49.3%,22m
11284,3,IIIIIIIIIIII,2814,623,26,18,44,59.1%,18m
11284,2,那个啥棒槌,2814,520,23,16,39,59.0%,37m
11284,2,棒男孩,2814,626,23,19,42,54.8%,19m
11284,1,[好大一只龙猫]ORC,2814,317,12,13,25,48.0%,1h
11284,3,皮黑投资小项宰,2814,298,11,11,22,50.0%,8m
11284,1,斗魂幽冥,2814,97,5,3,8,62.5%,53m
11284,3,索拉的行星,2814,60,3,1,4,75.0%,5m
11284,3,Frederic,2814,60,3,2,5,60.0%,15m
11284,2,[睾能瓦斯不足]你喜欢吃柚子嘛,2814,46,3,4,7,42.9%,16m
11284,3,红黄蓝,2814,58,2,2,4,50.0%,14m
11284,2,Marin,2814,0,2,3,5,40.0%,1h
11284,2,浪仙,2814,0,2,3,5,40.0%,1h
11284,1,[20CM]HFserral,2814,0,1,0,1,100.0%,33m
11300,3,[听潮阁]徐凤年,2813,516,37,27,64,57.8%,28m
11300,2,魅影,2813,792,31,29,60,51.7%,4m
11300,2,Riricho,2813,624,23,25,48,47.9%,6m
11300,3,icelatte,2813,584,21,21,42,50.0%,12m
11300,2,这个世界有点骚,2813,291,11,16,27,40.7%,34m
11300,2,FATE,2813,232,10,7,17,58.8%,30m
11300,2,我得重新集结部队,2813,145,6,11,17,35.3%,19m
11300,2,[练出来了协会]Compass,2813,0,4,2,6,66.7%,27m
11300,3,浪迹天涯,2813,30,2,1,3,66.7%,25m
11300,3,[EL骑士团]Alice,2813,0,1,0,1,100.0%,25m
11300,3,哈拉休,2813,30,1,1,2,50.0%,19m
11300,3,hank,2813,0,0,1,1,0.0%,33m
11300,3,咲瞳,2813,0,0,1,1,0.0%,33m
11313,3,ZhsqZ,2812,1352,91,76,167,54.5%,13m
11313,2,芋头,2812,837,42,27,69,60.9%,39m
11313,3,[iGMM]Peterinter,2812,465,30,19,49,61.2%,18m
11313,2,[ljk]zrzaaa,2812,603,26,17,43,60.5%,24m
11313,3,[DSE]专业坑队友,2812,526,22,16,38,57.9%,39m
11313,3,salvation,2812,288,13,12,25,52.0%,13m
11313,3,萌新,2812,159,6,7,13,46.2%,55m
11313,3,IIIIIIIIIIII,2812,124,5,6,11,45.5%,18m
11313,2,飞龙骑脸,2812,0,4,1,5,80.0%,46m
11313,3,IIIIIIIIII,2812,90,4,5,9,44.4%,16m
11313,3,sober,2812,60,4,5,9,44.4%,19m
11313,3,peanut,2812,116,4,7,11,36.4%,35m
11313,2,[APM50]南枫,2812,0,3,2,5,60.0%,1h
11313,2,slmqwe,2812,0,3,2,5,60.0%,1h
11313,2,武田信玄,2812,0,3,2,5,60.0%,46m
11313,2,冯文龙,2812,0,3,2,5,60.0%,15m
11313,2,[我意凌云]殇丶櫖,2812,126,3,3,6,50.0%,1h
11313,1,[CPT]金艾尔马鹿,2812,73,2,8,10,20.0%,6m
11313,3,简单难度电脑,2812,0,0,3,3,0.0%,18m
11332,3,[HUC铭心]潇洒猪,2811,1559,849,833,1682,50.5%,13m
11332,3,盖尔加曲,2811,1480,144,118,262,55.0%,22m
11332,2,江南狗王,2811,696,27,23,50,54.0%,12m
11332,3,leoviking,2811,374,24,23,47,51.1%,28m
11332,1,MisDJ,2811,246,23,29,52,44.2%,34m
11332,3,陨落星辰,2811,461,20,16,36,55.6%,6m
11332,2,[ZEXAL]water,2811,237,8,11,19,42.1%,30m
11332,3,死一样难过,2811,174,7,5,12,58.3%,25m
11332,1,[Sv]XiaoK,2811,166,7,6,13,53.8%,11m
11332,3,扎加拉,2811,92,2,0,2,100.0%,13m
11332,3,Sylarjin,2811,60,2,2,4,50.0%,18m
11332,3,[IMRTS]HHT,2811,30,2,19,21,9.5%,31m
11332,3,Mark,2811,0,1,2,3,33.3%,1h
11332,2,[鸡饲料一堆]genggeng,2811,44,1,3,4,25.0%,12m
11332,3,小卖叔,2811,0,0,1,1,0.0%,12m
11347,2,CHRIS,2810,877,87,90,177,49.2%,33m
11347,3,空中劈叉的清洁工,2810,744,35,16,51,68.6%,18m
11347,3,[艾尔之巅]我是余威我怕谁,2810,909,35,28,63,55.6%,18m
11347,3,[DAK]BlackNight,2810,376,14,14,28,50.0%,17m
11347,3,[软萌甜小萝莉]RedLotus,2810,120,4,8,12,33.3%,13m
11347,2,氖酆,2810,0,3,3,6,50.0%,58m
11347,3,我狂妄我嚣张,2810,0,1,1,2,50.0%,28m
11347,1,年轻人要讲武德,2810,0,0,1,1,0.0%,33m
11347,1,[Okiam]孑孓,2810,0,0,1,1,0.0%,27m
11347,1,[哔哩哔哩乾杯]古德莉安,2810,0,0,1,1,0.0%,12m
11357,3,[nmsLJP]Maru,2809,1498,58,55,113,51.3%,17m
11357,2,[干si孙一鸡]少侠你好,2809,635,30,32,62,48.4%,32m
11357,2,豁老子,2809,567,20,27,47,42.6%,21m
11357,3,HoNyarara,2809,303,12,4,16,75.0%,25m
11357,3,流星,2809,146,6,3,9,66.7%,33m
11357,3,[浓酸屁味]小泽玛莉亚丶,2809,58,3,1,4,75.0%,17m
11357,2,Xmy,2809,0,3,2,5,60.0%,49m
11357,2,剑藏,2809,0,3,2,5,60.0%,1h
11357,2,JinAirMaru,2809,62,3,7,10,30.0%,16m
11357,2,血色的祝福,2809,65,3,9,12,25.0%,24m
11357,3,MetalStorm,2809,97,2,1,3,66.7%,1h
11357,3,[科普卢老车队]Hym,2809,60,2,2,4,50.0%,33m
11357,3,一颗电竞梦想的心,2809,0,1,0,1,100.0%,16m
11357,3,[虫族sm]NllRyu,2809,0,1,1,2,50.0%,12m
11357,3,TKTIM,2809,30,1,1,2,50.0%,13m
11357,2,[SUEPNB]ZagZoo,2809,0,1,4,5,20.0%,38m
11357,3,[Ggame]INnoVation,2809,0,0,1,1,0.0%,37m
11357,3,[星之开拓者]Tim,2809,0,0,1,1,0.0%,38m
11375,2,打虫虫,2808,1537,259,250,509,50.9%,12m
11375,3,转头一群狗,2808,1030,82,68,150,54.7%,12m
11375,2,[艾尔之巅]huazhu,2808,1437,68,72,140,48.6%,12m
11375,3,按时恰个饭,2808,420,35,55,90,38.9%,16m
11375,3,狗骑士,2808,739,30,22,52,57.7%,38m
11375,3,[下船了大主教]以黯为名,2808,584,25,14,39,64.1%,13m
11375,3,菜鸡孙一峰,2808,593,25,17,42,59.5%,13m
11375,1,scpone,2808,78,25,24,49,51.0%,34m
11375,3,原地大风车,2808,530,21,17,38,55.3%,5m
11375,3,[萌蛋组合]IIIIIIIIIIII,2808,294,10,12,22,45.5%,9m
11375,2,[装甲冲击]苏醒锈雪,2808,284,9,12,21,42.9%,37m
11375,3,haha,2808,230,8,8,16,50.0%,4m
11375,3,[唯独你没懂]哔哩哔哩双音浮华,2808,160,5,0,5,100.0%,28m
11375,2,IIIIIIIIIIII,2808,196,4,7,11,36.4%,19m
11375,2,llllllll,2808,0,3,3,6,50.0%,1h
11375,3,Murky,2808,58,2,1,3,66.7%,4m
11375,3,[我要打11个]多吃手机身体好,2808,0,1,0,1,100.0%,38m
11375,3,虫皇降世,2808,0,0,1,1,0.0%,12m
11375,3,[别害怕少年]蜗牛,2808,0,0,1,1,0.0%,38m
11375,3,[DMRe]小磊,2808,0,0,1,1,0.0%,13m
11375,3,NessCurie,2808,0,0,1,1,0.0%,15m
11375,3,盛开妖姬,2808,0,0,2,2,0.0%,12m
11375,3,Entity,2808,0,0,3,3,0.0%,1h
11375,3,diewithpain,2808,0,0,4,4,0.0%,18m
11399,2,prince,2807,733,36,27,63,57.1%,28m
11399,2,大连狗哥,2807,332,11,15,26,42.3%,13m
11399,2,[KNAT]因爱而入,2807,186,7,8,15,46.7%,59m
11399,1,李二傻,2807,167,7,9,16,43.8%,58m
11399,3,[司马恒星]IIIIIIIIIIII,2807,146,6,2,8,75.0%,38m
11399,2,[太阳能战斧]singal,2807,186,6,10,16,37.5%,11m
11399,3,霸王叉叉叉,2807,30,2,1,3,66.7%,4m
11399,1,[求狙击]不归路,2807,93,1,1,2,50.0%,1h
11399,2,桦默,2807,0,0,5,5,0.0%,13m
11408,2,[联合动物园]苏维埃狗熊,2806,1598,213,189,402,53.0%,46m
11408,3,三嗦螺丝,2806,1391,165,157,322,51.2%,19m
11408,3,sakura,2806,748,56,64,120,46.7%,38m
11408,2,[野蛮猫骑士]icerainbow,2806,1323,55,46,101,54.5%,36m
11408,2,腓特烈大帝,2806,640,24,28,52,46.2%,16m
11408,3,JJJJJJJJJJJJ,2806,494,19,14,33,57.6%,14m
11408,3,喵苏鲁的呼唤,2806,329,14,4,18,77.8%,16m
11408,3,[FsA]FsAxBurner,2806,289,12,12,24,50.0%,23m
11408,2,realcola,2806,291,11,11,22,50.0%,49m
11408,3,lovezzt,2806,118,4,5,9,44.4%,39m
11408,3,[玄門]dydsg,2806,58,3,1,4,75.0%,15m
11408,2,今朝有酒今朝醉,2806,94,3,3,6,50.0%,1h
11408,2,吴员外,2806,0,3,3,6,50.0%,60m
11408,1,ChenDaPao,2806,143,3,7,10,30.0%,12m
11408,2,TianJcC,2806,90,3,9,12,25.0%,20m
11408,3,Mahesvara,2806,30,2,1,3,66.7%,24m
11408,3,甜甜圈儿机枪兵,2806,30,2,2,4,50.0%,8m
11408,1,asdasd,2806,92,2,4,6,33.3%,27m
11408,3,妆妻之美万人尝,2806,58,2,4,6,33.3%,23m
11408,3,往事如梦,2806,34,1,3,4,25.0%,4m
11428,1,UNclear,2805,1588,429,442,871,49.3%,6m
11428,3,雷米阿萨德,2805,1534,191,162,353,54.1%,18m
11428,1,虫哥,2805,1139,60,62,122,49.2%,28m
11428,1,chenbin,2805,830,47,58,105,44.8%,19m
11428,3,IIIIIIIIIIII,2805,540,21,20,41,51.2%,6m
11428,2,Evel,2805,188,10,15,25,40.0%,4m
11428,2,大对门,2805,220,6,10,16,37.5%,37m
11428,1,无线火力,2805,96,4,4,8,50.0%,1h
11428,3,[暮云春树fa]大厦大时代,2805,58,3,4,7,42.9%,18m
11428,3,[Emc2]爱美的究极小迷妹,2805,30,1,1,2,50.0%,8m
11428,3,Pepsi,2805,0,0,1,1,0.0%,24m
11428,3,Layman,2805,0,0,1,1,0.0%,12m
11440,3,Sugar,2804,555,49,29,78,62.8%,5m
11440,3,夜尽,2804,720,23,43,66,34.8%,35m
11440,1,zyzza,2804,484,16,25,41,39.0%,34m
11440,1,ByuN,2804,284,13,11,24,54.2%,1h
11440,3,[艾尔之巅]QAQ,2804,135,8,9,17,47.1%,17m
11440,2,Ruin,2804,194,7,8,15,46.7%,12m
11440,1,[野蛮猫骑士]qwe,2804,186,4,4,8,50.0%,25m
11440,2,[长不大的]hhx,2804,60,3,6,9,33.3%,16m
11440,2,AjiN,2804,32,2,6,8,25.0%,24m
11440,3,[超会玩]我爱果果,2804,0,1,0,1,100.0%,17m
11440,2,仙阁天帝,2804,0,0,1,1,0.0%,1h
11451,1,好汉饶命,2803,1225,308,305,613,50.2%,27m
11451,2,小布点,2803,325,71,62,133,53.4%,39m
11451,1,[X英雄圣域X]Uve,2803,999,49,59,108,45.4%,17m
11451,3,[火焰雷兽]你还活在过去吗,2803,568,46,36,82,56.1%,17m
11451,3,棕色的浣熊,2803,595,27,19,46,58.7%,17m
11451,3,指间的闪光,2803,526,20,18,38,52.6%,37m
11451,2,seekfun,2803,328,11,21,32,34.4%,36m
11451,2,[TeamEK]伊红美蓝,2803,237,8,3,11,72.7%,1h
11451,3,[往事如风]莫才,2803,142,8,5,13,61.5%,28m
11451,3,Vicccc,2803,176,6,6,12,50.0%,27m
11451,3,花花小学生,2803,97,5,4,9,55.6%,8m
11451,2,无敌老剑客,2803,0,1,0,1,100.0%,1h
11451,1,哟哦,2803,0,0,1,1,0.0%,26m
11451,3,祸首亮,2803,0,0,1,1,0.0%,13m
11451,3,[西湖水产巨子]Legion,2803,0,0,2,2,0.0%,5m
11466,2,[Beastp]逸丨尘灬,2802,1267,73,75,148,49.3%,17m
11466,1,kirkl,2802,1228,70,73,143,49.0%,18m
11466,2,[Fe3o4]芷若,2802,296,12,11,23,52.2%,12m
11466,2,killerbig,2802,296,11,7,18,61.1%,7m
11466,2,[老年之家]欧青辣少,2802,225,9,8,17,52.9%,1h
11466,2,Overmind,2802,69,7,11,18,38.9%,27m
11466,3,白音黑歌,2802,176,6,2,8,75.0%,1h
11466,2,[铭殿]我在春楼当男优,2802,0,3,2,5,60.0%,16m
11466,2,[万事皆允]苍穹之链,2802,0,3,2,5,60.0%,1h
11466,3,暴徒,2802,0,1,0,1,100.0%,25m
11476,2,Timba,2801,593,128,111,239,53.6%,40m
11476,2,刺客,2801,1197,96,85,181,53.0%,33m
11476,3,[伢伢乐]Ryon,2801,1408,67,55,122,54.9%,33m
11476,2,[暴雪十队]一寸灰,2801,807,33,34,67,49.3%,37m
11476,2,[暴雪十队]不会打星际啦,2801,555,26,28,54,48.1%,18m
11476,3,梦蝶由依,2801,250,8,9,17,47.1%,16m
11476,2,fredning,2801,154,6,9,15,40.0%,37m
11476,2,请砍科哥谢谢,2801,160,5,4,9,55.6%,1h
11476,3,解放牌汽车人,2801,154,3,5,8,37.5%,8m
11476,3,Thanatos,2801,109,2,1,3,66.7%,13m
11476,1,不知道,2801,118,2,2,4,50.0%,50m
11476,3,[纸飞机的梦想]安生,2801,0,1,0,1,100.0%,18m
11476,3,千古老庸医,2801,30,1,5,6,16.7%,39m
11476,2,[嘎嘎嘎嘎]Sherry,2801,88,1,5,6,16.7%,30m
11476,3,[薄暮之光]卡卡殷墟,2801,0,0,1,1,0.0%,1h
11476,3,风流梦丶,2801,0,0,1,1,0.0%,37m
11492,1,不太会内战,2800,1540,334,337,671,49.8%,34m
11492,2,spue,2800,986,76,59,135,56.3%,31m
11492,3,Denny,2800,1568,72,67,139,51.8%,8m
11492,3,[孙岱玹]大头最厉害,2800,1060,58,43,101,57.4%,38m
11492,1,白驹过隙,2800,784,48,59,107,44.9%,3m
11492,2,wnjj,2800,916,42,40,82,51.2%,13m
11492,2,The,2800,268,11,10,21,52.4%,1h
11492,2,爱丽丝神皇,2800,257,10,9,19,52.6%,9m
11492,3,夜游神代号幽灵,2800,206,7,2,9,77.8%,27m
11492,1,[AB神教]caicai,2800,151,7,8,15,46.7%,19m
11492,3,[查尔之矛]大狂风,2800,178,7,8,15,46.7%,25m
11492,1,血夜晨曦,2800,48,4,5,9,44.4%,1h
11492,2,何故,2800,0,3,3,6,50.0%,5m
11492,1,祖尔温,2800,141,3,7,10,30.0%,55m
11492,1,我爱宝宝思妍,2800,0,0,2,2,0.0%,50m
11492,2,[只会平推]独角鲸先生,2800,0,0,2,2,0.0%,47m
11492,3,牛哥,2800,0,0,2,2,0.0%,38m
11509,2,[温柔兔公主]虎皮猫猫,2799,1345,58,42,100,58.0%,12m
11509,1,Contra,2799,1399,54,63,117,46.2%,3m
11509,3,[小鸡屠宰场b]Jack,2799,277,45,55,100,45.0%,8m
11509,3,CrazyDeBoy,2799,488,28,28,56,50.0%,33m
11509,2,QAQ,2799,486,17,22,39,43.6%,17m
11509,3,[神圣的大佐]tangxp,2799,283,10,6,16,62.5%,5m
11509,3,EnTaroAtanis,2799,175,5,2,7,71.4%,14m
11509,1,prts,2799,96,4,4,8,50.0%,1h
11509,1,大魚傢,2799,118,3,1,4,75.0%,39m
11509,3,啦啦啦,2799,142,3,2,5,60.0%,5m
11509,2,[TOD死神]聚义城,2799,89,2,5,7,28.6%,18m
11509,3,[KPG]dart,2799,30,2,5,7,28.6%,14m
11509,2,[0D]OvO,2799,30,1,7,8,12.5%,4m
11522,3,陈旭元,2798,1184,184,186,370,49.7%,13m
11522,2,[萨尔那加神殿]破壁人,2798,311,12,13,25,48.0%,4m
11522,3,ZNEWER,2798,219,6,12,18,33.3%,1h
11522,3,寒沙折羽,2798,157,5,1,6,83.3%,5m
11522,2,轻吻飞扬,2798,140,5,3,8,62.5%,54m
11522,3,时雨泠月,2798,108,4,3,7,57.1%,10m
11522,3,吊二,2798,141,3,3,6,50.0%,1h
11522,3,狂雷,2798,0,1,0,1,100.0%,16m
11522,3,[SFTRA3]MisakaMikoto,2798,0,1,0,1,100.0%,38m
11522,2,Smallpancake,2798,90,1,5,6,16.7%,34m
11522,3,[ToHo]带带大师兄,2798,0,0,1,1,0.0%,40m
11522,3,[肯瑞托议会]Rhonin,2798,0,0,1,1,0.0%,25m
11522,3,[德哈卡神教]明明,2798,0,0,1,1,0.0%,28m
11522,3,Serendipity,2798,0,0,1,1,0.0%,15m
11522,3,eyes,2798,0,0,4,4,0.0%,16m
11537,3,北上佳欢,2797,1535,72,64,136,52.9%,16m
11537,3,[123478]小楠爷,2797,971,58,44,102,56.9%,18m
11537,2,[艾尔之主]守住丫口,2797,1011,40,38,78,51.3%,47m
11537,3,llllllllllll,2797,580,22,21,43,51.2%,17m
11537,2,Valerian,2797,294,18,18,36,50.0%,33m
11537,3,KTunicorn,2797,326,14,13,27,51.9%,25m
11537,1,一起去坑爹,2797,280,10,18,28,35.7%,11m
11537,2,dio,2797,134,4,4,8,50.0%,1h
11537,3,[喵星有关部门]喵星国防部,2797,109,3,0,3,100.0%,25m
11537,3,[蓝色星辰]梦回,2797,97,1,1,2,50.0%,1h
11537,3,壮士请先杀队友,2797,30,1,2,3,33.3%,40m
11537,3,Pretty,2797,0,1,3,4,25.0%,5m
11537,2,战网超哥,2797,0,1,4,5,20.0%,58m
11537,3,寂寞星辰,2797,0,0,1,1,0.0%,9m
11537,3,无聊走火,2797,0,0,1,1,0.0%,10m
11537,3,[Skrrr]楚云飞,2797,0,0,2,2,0.0%,12m
11537,3,kinghhn,2797,0,0,4,4,0.0%,33m
11554,1,itjlkjoijero,2796,1442,156,157,313,49.8%,18m
11554,1,谁明浪子心,2796,1573,154,151,305,50.5%,36m
11554,3,zane,2796,1061,60,49,109,55.0%,17m
11554,3,Coldfire,2796,1299,59,42,101,58.4%,32m
11554,3,[一起9]心夜旭天尊,2796,579,27,17,44,61.4%,12m
11554,3,[看我朵蜜你]阿尔托莉雅,2796,544,27,20,47,57.4%,12m
11554,1,我很菜,2796,565,27,32,59,45.8%,18m
11554,3,llllllllllll,2796,555,21,16,37,56.8%,24m
11554,2,盘盘,2796,530,18,23,41,43.9%,33m
11554,2,明旭安,2796,239,9,11,20,45.0%,27m
11554,2,DiabloLee,2796,254,8,12,20,40.0%,40m
11554,1,sora,2796,230,7,3,10,70.0%,1h
11554,3,[基金会]sky,2796,213,7,4,11,63.6%,13m
11554,3,赤蝶殇,2796,202,7,8,15,46.7%,17m
11554,3,mmp,2796,176,6,6,12,50.0%,38m
11554,1,白日,2796,46,4,4,8,50.0%,6m
11554,3,Vermirian,2796,88,3,6,9,33.3%,38m
11554,3,LaderBen,2796,0,1,0,1,100.0%,17m
11554,3,杂草,2796,0,1,0,1,100.0%,25m
11554,3,llllllllllll,2796,0,1,1,2,50.0%,14m
11554,3,EASTMO,2796,30,1,2,3,33.3%,17m
11554,1,Wittness,2796,0,1,2,3,33.3%,19m
11554,3,shaozh,2796,30,1,2,3,33.3%,4m
11554,1,[oshima]neoooxx,2796,32,1,12,13,7.7%,21m
11554,3,越今朝,2796,0,0,1,1,0.0%,38m
11554,3,[为谁而忧伤]为了虫族,2796,0,0,1,1,0.0%,8m
11554,3,SmallBobo,2796,0,0,1,1,0.0%,8m
11554,2,[魔灵圣域]梦星,2796,0,0,4,4,0.0%,32m
11582,1,[鸟人]sepo,2795,1572,241,238,479,50.3%,6m
11582,2,Strawberry,2795,1160,148,136,284,52.1%,7m
11582,2,NBCC,2795,686,45,41,86,52.3%,29m
11582,2,浪漫是错,2795,884,35,37,72,48.6%,22m
11582,2,只看侧面,2795,506,22,23,45,48.9%,12m
11582,2,血杀之影,2795,482,19,18,37,51.4%,27m
11582,3,陈墨的我,2795,411,17,8,25,68.0%,5m
11582,3,TapetAxian,2795,269,10,4,14,71.4%,38m
11582,1,小短腿,2795,325,10,19,29,34.5%,18m
11582,3,[QWQa]雨之陌,2795,190,6,3,9,66.7%,19m
11582,2,[雾之湖红萌馆]东风谷早苗,2795,0,3,2,5,60.0%,16m
11582,2,野蛮人,2795,0,3,2,5,60.0%,1h
11582,3,云星,2795,30,2,1,3,66.7%,8m
11582,2,[我开矿了你呢]ooo,2795,0,2,4,6,33.3%,59m
11582,3,[要啥没啥爱咋]西尔维斯特,2795,0,1,0,1,100.0%,25m
11582,3,Fire,2795,30,1,1,2,50.0%,4m
11582,2,kirito,2795,0,1,1,2,50.0%,1h
11582,3,糖果屋,2795,30,1,2,3,33.3%,17m
11582,3,VICTORIA,2795,0,0,1,1,0.0%,33m
11601,1,[havfun]ALONE,2794,1542,201,190,391,51.4%,19m
11601,2,egocoo,2794,1507,111,113,224,49.6%,16m
11601,2,术高莫用,2794,952,60,42,102,58.8%,13m
11601,1,三日月夜空,2794,582,26,37,63,41.3%,18m
11601,3,[瘾大眼瞎]大马罗,2794,194,7,8,15,46.7%,17m
11601,3,泽拉图,2794,148,5,8,13,38.5%,8m
11601,2,ZoHoY,2794,42,4,3,7,57.1%,23m
11601,3,[NMSL战队]会当凌绝顶,2794,150,3,4,7,42.9%,1h
11601,2,迟暮,2794,0,1,0,1,100.0%,1h
11601,3,[玲喵卡哇伊]REvoLution,2794,0,1,3,4,25.0%,6m
11601,3,Carpoon,2794,0,0,1,1,0.0%,32m
11601,3,soldiers,2794,0,0,1,1,0.0%,9m
11601,1,虚夜,2794,0,0,4,4,0.0%,47m
11614,3,[LM]道爷,2793,1497,135,154,289,46.7%,38m
11614,2,鸭子光线,2793,525,40,40,80,50.0%,12m
11614,2,[天堂之魔]laomao,2793,529,18,21,39,46.2%,12m
11614,2,不败小强,2793,257,10,10,20,50.0%,24m
11614,3,Gideon,2793,225,8,4,12,66.7%,22m
11614,3,仁义无双总司令,2793,194,7,1,8,87.5%,9m
11614,3,[荒芜岁月]情如朝露去匆匆,2793,178,7,8,15,46.7%,17m
11614,3,[XXS]awsl,2793,165,6,1,7,85.7%,13m
11614,2,[JUVE]栗悟饭与龟波气功,2793,89,6,11,17,35.3%,40m
11614,3,[野人time]白河愁,2793,114,5,4,9,55.6%,27m
11614,3,[红萌馆]Assassin,2793,30,2,2,4,50.0%,12m
11614,2,Podeos,2793,88,2,3,5,40.0%,1h
11614,1,木夕,2793,95,1,3,4,25.0%,1h
11614,3,[指尖奶茶]环市东少女的祈祷,2793,0,0,1,1,0.0%,4m
11614,3,[奔驰何平]光照于生化,2793,0,0,1,1,0.0%,23m
11614,3,我是胖次君,2793,0,0,2,2,0.0%,4m
11630,1,[嚣张萌新]Revolution,2792,1172,111,104,215,51.6%,32m
11630,3,这里是少爷广场,2792,493,24,7,31,77.4%,22m
11630,2,猪油拌饭,2792,568,19,27,46,41.3%,7m
11630,3,myMeow,2792,330,14,12,26,53.8%,5m
11630,3,浪呀嘛浪打浪,2792,354,13,10,23,56.5%,13m
11630,3,[维包子]士官长,2792,230,8,6,14,57.1%,27m
11630,3,[菠萝君]真打,2792,150,6,8,14,42.9%,17m
11630,2,[未来穗香]普陀谢广坤,2792,153,6,10,16,37.5%,18m
11630,3,[火焰雷兽]神印游,2792,171,5,6,11,45.5%,1h
11630,3,镜花水月,2792,88,4,4,8,50.0%,40m
11630,3,落丶樱,2792,132,3,1,4,75.0%,25m
11630,2,PFUN,2792,86,3,13,16,18.8%,12m
11630,3,[社交学超可爱]神一般的菜鸟,2792,0,1,0,1,100.0%,33m
11630,2,[1057]布衣怒,2792,0,1,0,1,100.0%,58m
11630,3,鸟黑头子,2792,0,1,0,1,100.0%,15m
11630,3,[梨花]太阳花上的幽香,2792,0,1,1,2,50.0%,28m
11630,2,IIIIIIIIIIII,2792,30,1,6,7,14.3%,7m
11630,3,[野生无公害]SacYNa,2792,0,0,2,2,0.0%,12m
11648,3,wangyanji,2791,286,80,79,159,50.3%,37m
11648,3,CireStick,2791,1072,48,36,84,57.1%,23m
11648,2,幸运之翼,2791,141,11,5,16,68.8%,1h
11648,3,[天行九歌]真气运行办主任,2791,264,10,13,23,43.5%,8m
11648,3,Mike,2791,246,9,8,17,52.9%,6m
11648,3,Halleyino,2791,271,8,8,16,50.0%,25m
11648,3,[神的降临]Vampire,2791,178,7,7,14,50.0%,9m
11648,1,山脚下,2791,97,5,3,8,62.5%,1h
11648,3,Trace,2791,86,4,5,9,44.4%,17m
11648,2,[XXHZ0]鲁哈鲁哈,2791,0,3,2,5,60.0%,36m
11648,2,四号电脑,2791,0,3,3,6,50.0%,1h
11648,3,十秒起个名,2791,117,2,1,3,66.7%,13m
11648,2,HappyTime,2791,0,2,2,4,50.0%,1h
11648,3,蛇胆川贝,2791,0,1,0,1,100.0%,18m
11648,3,[社交学教导]炉石大师,2791,0,1,1,2,50.0%,33m
11648,3,NesTea,2791,0,0,1,1,0.0%,19m
11648,3,[loveMM]无限争霸,2791,0,0,3,3,0.0%,9m
11665,3,[五月花]人菜瘾大智力差,2790,821,91,78,169,53.8%,33m
11665,3,Clement,2790,1180,49,42,91,53.8%,38m
11665,3,黄昏,2790,791,31,30,61,50.8%,4m
11665,3,Shihiso,2790,151,20,14,34,58.8%,33m
11665,3,南布岛,2790,294,13,12,25,52.0%,25m
11665,3,[桜公馆]Crush,2790,292,10,14,24,41.7%,8m
11665,2,[YT]DarkSkull,2790,214,9,9,18,50.0%,39m
11665,3,天幻邪,2790,150,8,8,16,50.0%,18m
11665,1,fansykk,2790,276,7,5,12,58.3%,1h
11665,2,眼月,2790,139,4,4,8,50.0%,1h
11665,3,[YINGJI]GGboom,2790,110,4,4,8,50.0%,8m
11665,3,AIRBORNE,2790,90,4,5,9,44.4%,9m
11665,1,初见,2790,96,3,4,7,42.9%,56m
11665,2,KIKI,2790,0,2,3,5,40.0%,36m
11665,2,[暴雪二队]dolf,2790,0,2,4,6,33.3%,1h
11665,2,霸天橙子,2790,88,1,1,2,50.0%,6m
11665,3,[金城江二中]大攻无私,2790,30,1,5,6,16.7%,9m
11665,3,雏鹤枫,2790,0,0,1,1,0.0%,13m
11665,3,[LJZ]gaoliangyi,2790,0,0,1,1,0.0%,25m
11665,3,神界之战,2790,0,0,1,1,0.0%,16m
11665,2,gongnan,2790,0,0,1,1,0.0%,15m
11665,1,[三大动力]sss,2790,0,0,2,2,0.0%,56m
11687,2,沙坪坝勇士,2789,1361,569,560,1129,50.4%,4m
11687,1,[H1st]SCPLAYER,2789,1405,70,80,150,46.7%,34m
11687,3,hahaha,2789,1363,65,55,120,54.2%,5m
11687,3,[暴雪十五队]大多数,2789,480,17,18,35,48.6%,23m
11687,3,[天枢]DFG,2789,322,14,16,30,46.7%,40m
11687,3,缠绕指尖的妩媚,2789,241,8,10,18,44.4%,1h
11687,1,guqinghao,2789,188,6,6,12,50.0%,1h
11687,3,[曾经一群兔兔]曾经有一只兔子,2789,108,6,8,14,42.9%,19m
11687,3,[Igirls]冥氡,2789,120,5,5,10,50.0%,25m
11687,3,风画清颜,2789,114,5,8,13,38.5%,14m
11687,1,小丈夫,2789,97,4,5,9,44.4%,32m
11687,1,晚来天欲雪,2789,91,2,3,5,40.0%,1h
11687,2,下课下课,2789,0,1,0,1,100.0%,1h
11687,1,[超级二五仔]NaviSimple,2789,46,1,1,2,50.0%,28m
11687,3,[SCoM]BINLOSTSOUL,2789,0,1,3,4,25.0%,27m
11687,2,血翼小杰,2789,0,1,4,5,20.0%,58m
11687,2,陈琛,2789,0,1,5,6,16.7%,40m
11687,3,[大明忠臣]bandelist,2789,0,0,1,1,0.0%,16m
11705,2,[NKTJ]被遗忘者,2788,901,77,80,157,49.0%,12m
11705,1,小黄狗,2788,654,38,40,78,48.7%,14m
11705,2,EagleYing,2788,151,35,41,76,46.1%,40m
11705,2,烟梦蓝,2788,282,24,28,52,46.2%,6m
11705,3,[昆明RANK]Gwagen,2788,487,22,20,42,52.4%,14m
11705,2,Snoopy,2788,111,5,2,7,71.4%,1h
11705,2,IIIIIIIIIIII,2788,156,5,6,11,45.5%,24m
11705,2,[GaGaga]匠人金,2788,156,5,9,14,35.7%,24m
11705,3,[佩刀]白门楼吕布,2788,58,3,1,4,75.0%,13m
11705,3,deer,2788,30,1,2,3,33.3%,24m
11705,2,[汉堡FANS]也许我是臭八八,2788,46,1,3,4,25.0%,58m
11705,3,[疯狂掉分]zlxyxs,2788,0,0,1,1,0.0%,24m
11705,3,[M8]叶问,2788,0,0,4,4,0.0%,16m
11718,1,小鲤鱼跃龙门,2787,1460,196,197,393,49.9%,31m
11718,3,香飘飘,2787,757,107,92,199,53.8%,13m
11718,2,[欧佩克]鳄鱼,2787,1079,86,87,173,49.7%,11m
11718,3,[天羽不榖]无敌爆爆虫,2787,1153,75,66,141,53.2%,8m
11718,1,一品梅,2787,1522,64,63,127,50.4%,4m
11718,1,TangZz,2787,956,58,61,119,48.7%,12m
11718,3,[大刀队]故事里的安徒生,2787,539,44,34,78,56.4%,5m
11718,3,枯叶,2787,339,19,14,33,57.6%,4m
11718,3,萌新玩星际,2787,235,11,13,24,45.8%,18m
11718,3,沖繩流浪貓,2787,219,8,4,12,66.7%,16m
11718,3,[帝王江山如画]wqe,2787,212,7,10,17,41.2%,38m
11718,1,傲狮,2787,170,5,14,19,26.3%,34m
11718,2,[miku守护]哔哔哔,2787,90,4,2,6,66.7%,1h
11718,3,[卐二五仔]三生,2787,58,3,1,4,75.0%,9m
11718,3,小玲吃西瓜,2787,60,3,3,6,50.0%,10m
11718,3,命运石之门,2787,30,2,1,3,66.7%,17m
11718,3,[祖安迎你]你马炸了,2787,30,2,1,3,66.7%,38m
11718,2,炫喧轩眩旋,2787,0,2,3,5,40.0%,1h
11718,3,OBE,2787,116,2,3,5,40.0%,19m
11718,3,小学神,2787,0,0,1,1,0.0%,38m
11718,3,IIIIIIII,2787,0,0,1,1,0.0%,18m
11718,3,山田赫敏,2787,0,0,1,1,0.0%,39m
11718,3,[HPT]Bakyun,2787,0,0,1,1,0.0%,13m
11741,3,KKKKK,2786,1542,210,195,405,51.9%,40m
11741,1,枫叶,2786,1131,47,56,103,45.6%,33m
11741,3,Evolution,2786,330,21,17,38,55.3%,18m
11741,3,IIIIIIIIIII,2786,406,16,9,25,64.0%,4m
11741,2,HCmvp,2786,436,15,19,34,44.1%,27m
11741,2,[TMUSC2]warriorJING,2786,278,9,11,20,45.0%,36m
11741,1,Moreleven,2786,218,6,14,20,30.0%,24m
11741,3,[SSD]kanaima,2786,148,5,0,5,100.0%,4m
11741,3,[枪兵营]小少爷,2786,148,5,5,10,50.0%,5m
11741,2,[ATLS]啧啧啧沼泽,2786,168,5,8,13,38.5%,7m
11741,1,[独裁人机]呵呵呵呵,2786,162,4,2,6,66.7%,8m
11741,3,问问为什么玩生化,2786,124,4,7,11,36.4%,8m
11741,3,恐怕很菜哦,2786,122,4,7,11,36.4%,9m
11741,2,秋滟,2786,135,3,1,4,75.0%,1h
11741,2,爬满树,2786,118,3,6,9,33.3%,22m
11741,3,[DMRe]锦衣年华,2786,0,1,0,1,100.0%,10m
11741,3,低调灬男子,2786,30,1,4,5,20.0%,10m
11741,3,[柚子]封茗囧菌,2786,0,0,1,1,0.0%,19m
11759,1,忒修斯之船,2785,1320,66,66,132,50.0%,19m
11759,2,[996]您需要更多的瓦斯,2785,1057,46,41,87,52.9%,12m
11759,2,[社交学教练]溺水的鱼,2785,501,22,22,44,50.0%,13m
11759,3,孤舟白衣北海少年,2785,513,21,13,34,61.8%,5m
11759,3,[白丝黑丝萝莉]平尺淮,2785,361,16,5,21,76.2%,40m
11759,3,很强的探机,2785,437,16,14,30,53.3%,6m
11759,3,[NKTJ]Templar,2785,410,15,14,29,51.7%,18m
11759,3,[火焰雷兽]xuanily,2785,368,13,9,22,59.1%,8m
11759,3,凑阿库娅,2785,198,8,9,17,47.1%,1h
11759,3,我曾触及星辰,2785,98,7,7,14,50.0%,1h
11759,1,新人,2785,181,5,7,12,41.7%,1h
11759,3,我是兔兔,2785,183,5,8,13,38.5%,33m
11759,1,[Allin]thief,2785,189,4,4,8,50.0%,1h
11759,3,SuperJoven,2785,135,3,1,4,75.0%,25m
11759,3,我没有智力,2785,30,2,1,3,66.7%,17m
11759,2,[月月月]大萌眼,2785,0,2,3,5,40.0%,1h
11759,2,战场原黑仪,2785,0,1,0,1,100.0%,1h
11759,3,[它们到处都是]日最野的虫,2785,0,1,1,2,50.0%,18m
11759,2,波波龙,2785,94,1,1,2,50.0%,49m
11759,3,[萌萌的真可爱]fuyuzumi,2785,30,1,3,4,25.0%,33m
11759,3,[充气团]蚂蚱晨晨,2785,0,0,1,1,0.0%,12m
11759,2,[嘤嘤嘤啊]光芒,2785,0,0,1,1,0.0%,13m
11759,3,庞紫,2785,0,0,1,1,0.0%,32m
11782,2,[冲就完了]新手电脑,2784,652,108,95,203,53.2%,31m
11782,3,DecastRossin,2784,457,36,32,68,52.9%,14m
11782,3,iiiiiiiiiiii,2784,782,30,31,61,49.2%,27m
11782,3,[我们为了粉丝]larryou,2784,473,19,27,46,41.3%,27m
11782,3,[地大人]sass,2784,392,15,17,32,46.9%,37m
11782,3,企鹅人,2784,325,13,12,25,52.0%,19m
11782,3,Nature,2784,140,6,6,12,50.0%,6m
11782,2,vtns,2784,170,6,7,13,46.2%,9m
11782,1,[文韬武略]小满冬至霜降惊蛰,2784,236,5,8,13,38.5%,42m
11782,2,毒奶黄旭东喵,2784,0,4,2,6,66.7%,1h
11782,2,[大新闻记者]Ori,2784,115,4,4,8,50.0%,1h
11782,2,[至翼二中]SakuraMint,2784,142,4,5,9,44.4%,1h
11782,3,[Toss]Skai,2784,112,3,0,3,100.0%,33m
11782,1,扫清六合席卷八荒,2784,48,2,2,4,50.0%,11m
11782,3,冬科,2784,30,2,4,6,33.3%,37m
11782,3,[银翼之光]死亡之翼,2784,0,1,0,1,100.0%,27m
11782,3,FrozenThrone,2784,32,1,3,4,25.0%,1h
11782,2,[我不做人了]nilins,2784,30,1,7,8,12.5%,15m
11782,3,别问问就是修地堡,2784,0,0,1,1,0.0%,33m
11801,1,苍白的木耳,2783,1532,217,222,439,49.4%,34m
11801,3,Deemored,2783,675,30,26,56,53.6%,22m
11801,3,犀利菜鸟,2783,111,17,10,27,63.0%,38m
11801,3,[風林火山]chineseidiot,2783,307,9,8,17,52.9%,19m
11801,3,[Holygl]Los,2783,182,6,8,14,42.9%,38m
11801,3,原罪,2783,0,4,1,5,80.0%,1h
11801,2,[XYFANS]识花认雪,2783,0,3,3,6,50.0%,1h
11801,2,Trap,2783,0,3,4,7,42.9%,1h
11801,3,[这就对了]寰宇,2783,30,2,1,3,66.7%,19m
11801,3,[王者家族]GFO,2783,0,1,2,3,33.3%,1h
11801,3,[实地]缺啥找啥,2783,0,0,1,1,0.0%,17m
11801,3,TERA,2783,0,0,1,1,0.0%,13m
11801,3,前行者,2783,0,0,1,1,0.0%,19m
11801,3,年轻人耗子尾汁,2783,0,0,1,1,0.0%,17m
11801,3,[王者家族]清风野老,2783,0,0,1,1,0.0%,8m
11801,3,[永不白给]夜探青楼,2783,0,0,1,1,0.0%,17m
11801,3,[菜鸡球带]hankgao,2783,0,0,1,1,0.0%,27m
11801,3,巴拉拉,2783,0,0,2,2,0.0%,37m
11801,3,[斯巴达血战团]南天,2783,0,0,2,2,0.0%,33m
11820,3,光芒耀眼,2782,1523,174,173,347,50.1%,8m
11820,3,投降输一半,2782,1152,102,77,179,57.0%,22m
11820,3,剹弑,2782,966,41,33,74,55.4%,40m
11820,1,[GFA]沉心,2782,869,31,40,71,43.7%,32m
11820,3,兰斯,2782,496,22,14,36,61.1%,22m
11820,2,[火法]lulululunat,2782,407,13,19,32,40.6%,25m
11820,3,[海德单推协会]无敌鸦鸦者,2782,276,11,5,16,68.8%,22m
11820,3,[lxh123]alleria,2782,318,11,14,25,44.0%,37m
11820,3,[激情男女]Endenr,2782,165,5,1,6,83.3%,6m
11820,3,EpicMouse,2782,195,5,5,10,50.0%,26m
11820,3,ghy,2782,88,3,3,6,50.0%,18m
11820,2,不冲基地龙魂桑,2782,94,3,4,7,42.9%,37m
11820,2,[X英雄圣域X]资本主义好,2782,116,3,6,9,33.3%,33m
11820,2,[棒棒糖丶]双瞳,2782,30,2,6,8,25.0%,19m
11820,3,夏默丹竹,2782,36,1,2,3,33.3%,19m
11820,3,[校园谐恶势力]yyymgg,2782,30,1,5,6,16.7%,26m
11836,3,[loveMM]阿道夫特朗普,2781,1110,44,36,80,55.0%,5m
11836,3,sona,2781,966,42,33,75,56.0%,27m
11836,2,电竞马保国,2781,468,20,25,45,44.4%,12m
11836,3,杜祥明,2781,435,16,11,27,59.3%,5m
11836,3,[七海]七海千夜,2781,232,9,2,11,81.8%,38m
11836,3,孤独的假面,2781,245,7,7,14,50.0%,24m
11836,3,深夜的活动,2781,144,6,7,13,46.2%,28m
11836,3,Sucer,2781,88,4,2,6,66.7%,19m
11836,3,rua,2781,90,3,7,10,30.0%,10m
11836,3,[唯爱彦神]战巡舰掌柜,2781,108,2,1,3,66.7%,9m
11836,3,Gentleman,2781,30,1,2,3,33.3%,33m
11836,3,wushang,2781,0,1,3,4,25.0%,14m
11836,3,全部出动,2781,0,0,1,1,0.0%,19m
11836,3,小鸟儿小,2781,0,0,1,1,0.0%,12m
11836,2,[狂风暴风雨]llllllll,2781,0,0,1,1,0.0%,37m
11851,3,影峰,2780,1410,141,130,271,52.0%,8m
11851,3,maruke,2780,1490,124,107,231,53.7%,23m
11851,3,[风暴领主]你是真的狗,2780,803,54,55,109,49.5%,4m
11851,3,[YRS党委会]三水加,2780,280,10,11,21,47.6%,9m
11851,1,[魂祀]Blingbling,2780,253,8,8,16,50.0%,41m
11851,3,逆转使者,2780,207,6,7,13,46.2%,24m
11851,2,[盲人协会]孔维康最帅,2780,152,4,9,13,30.8%,37m
11851,3,魔想十六夜,2780,0,3,2,5,60.0%,57m
11851,3,Black,2780,58,3,2,5,60.0%,25m
11851,3,wolfTT,2780,30,2,1,3,66.7%,38m
11851,3,[SoloAs]一束七教我玩神族,2780,114,2,1,3,66.7%,33m
11851,2,Renegade,2780,95,1,3,4,25.0%,16m
11851,1,[戲丶天下]戏丶逆鳞,2780,0,0,1,1,0.0%,1h
11851,3,[秀气男孩]炮炮打在菌毯上,2780,0,0,1,1,0.0%,25m
11851,2,大主教万岁,2780,0,0,6,6,0.0%,12m
11866,1,我爱肥肥喜,2779,1380,92,102,194,47.4%,36m
11866,3,[琴筝]星际争霸,2779,1109,74,63,137,54.0%,28m
11866,2,[人族最强近战]魔狱,2779,498,38,27,65,58.5%,22m
11866,3,[艾尔之主]solarash,2779,617,23,20,43,53.5%,18m
11866,3,花开安静,2779,511,23,25,48,47.9%,26m
11866,3,Lewis,2779,349,13,10,23,56.5%,10m
11866,2,月半王耑,2779,218,12,11,23,52.2%,24m
11866,2,Sandy,2779,354,12,22,34,35.3%,30m
11866,3,[襄铃]黑虎阿福,2779,265,11,5,16,68.8%,15m
11866,2,EnTaroArisu,2779,284,11,10,21,52.4%,22m
11866,3,illuma,2779,222,9,10,19,47.4%,5m
11866,2,岁月如歌,2779,175,7,11,18,38.9%,33m
11866,1,[五月花]東邪,2779,159,5,9,14,35.7%,1h
11866,3,[雪Snow]Tragedy,2779,130,3,1,4,75.0%,37m
11866,3,swmrw,2779,142,3,3,6,50.0%,38m
11866,2,[二刺螈肥宅]微叼丝丿,2779,46,2,1,3,66.7%,21m
11866,3,我是兔子,2779,60,2,2,4,50.0%,37m
11866,3,[NGFIRE]FtoAdm,2779,0,1,1,2,50.0%,13m
11866,3,[我们的故事]弱鸡,2779,0,1,1,2,50.0%,19m
11866,3,uhicu,2779,30,1,2,3,33.3%,16m
11866,3,[o3]就是找虐,2779,0,0,1,1,0.0%,15m
11866,3,妹妹你好漂亮,2779,0,0,1,1,0.0%,9m
11866,3,[WRQ]Seapiano,2779,0,0,2,2,0.0%,39m
11866,3,[核桃]HHHHHHH,2779,0,0,2,2,0.0%,38m
11890,2,王宝强的经纪人,2778,1327,56,58,114,49.1%,14m
11890,3,别闹,2778,882,33,35,68,48.5%,14m
11890,3,Vingilote,2778,697,31,31,62,50.0%,25m
11890,3,打我减一攻,2778,496,27,23,50,54.0%,18m
11890,2,星空,2778,470,16,21,37,43.2%,36m
11890,3,[一群小菜鸡]进击的逗比,2778,342,15,7,22,68.2%,26m
11890,3,尾巴,2778,366,15,15,30,50.0%,24m
11890,3,周大福豆腐干,2778,147,8,8,16,50.0%,37m
11890,1,妹妹来一发,2778,156,8,10,18,44.4%,1h
11890,3,heyang,2778,188,6,3,9,66.7%,1h
11890,2,[我们是无敌的]人皇武圣星际魔君,2778,143,3,2,5,60.0%,19m
11890,3,跳跳气球,2778,146,3,4,7,42.9%,33m
11890,3,[秦皇岛一中]Happyending,2778,62,3,4,7,42.9%,18m
11890,1,Acidule,2778,119,2,3,5,40.0%,23m
11890,3,wxy,2778,0,2,3,5,40.0%,1h
11890,1,[东京有点热]showhand,2778,142,2,3,5,40.0%,26m
11890,3,[那萨力克]tenshiAqua,2778,0,1,0,1,100.0%,1h
11890,2,专杀肺炎病毒,2778,0,0,1,1,0.0%,59m
11890,3,忍尔,2778,0,0,1,1,0.0%,40m
11890,3,freeXeme,2778,0,0,2,2,0.0%,24m
11910,3,seveneleven,2777,572,26,16,42,61.9%,23m
11910,3,faker,2777,631,26,27,53,49.1%,13m
11910,3,马叉虫,2777,418,15,16,31,48.4%,12m
11910,3,材狼,2777,322,12,7,19,63.2%,16m
11910,1,[神依]墨染的樱,2777,165,5,1,6,83.3%,18m
11910,3,月牙,2777,161,5,3,8,62.5%,27m
11910,3,Slient,2777,97,4,4,8,50.0%,60m
11910,3,[人菜灬瘾大]风起云散,2777,135,3,4,7,42.9%,1h
11910,3,hevgo,2777,97,2,1,3,66.7%,16m
11910,3,无尽虚空丶,2777,93,1,1,2,50.0%,9m
11910,3,断幺九,2777,0,1,1,2,50.0%,24m
11910,3,[PLUTV]真岚,2777,0,0,1,1,0.0%,37m
11910,2,猪猪飞,2777,0,0,1,1,0.0%,60m
11910,2,[相爱一家亲]北栀,2777,0,0,1,1,0.0%,1h
11910,1,[紧插蜀黍]青豆雅美,2777,0,0,2,2,0.0%,8m
11925,2,[肉鸡的饲养]落泪的梦,2776,1086,41,45,86,47.7%,12m
11925,1,蛤是大,2776,707,40,42,82,48.8%,14m
11925,3,预见,2776,898,38,37,75,50.7%,37m
11925,3,训练有素的医生,2776,640,26,20,46,56.5%,18m
11925,3,广州恒大,2776,499,21,16,37,56.8%,9m
11925,3,樱岛麻衣,2776,202,7,7,14,50.0%,19m
11925,3,[双神教小主教]FairyAzis,2776,150,6,6,12,50.0%,16m
11925,3,JACKHE,2776,90,4,5,9,44.4%,17m
11925,3,好名字被狗起了,2776,0,3,2,5,60.0%,1h
11925,1,[Asv]AloneGhost,2776,0,3,3,6,50.0%,1h
11925,2,[对镜只影]永夜之曦,2776,93,3,3,6,50.0%,28m
11925,3,ZxChaos,2776,0,2,3,5,40.0%,12m
11925,3,[多个老年人]止咳糖浆,2776,30,1,2,3,33.3%,28m
11925,3,khgk,2776,0,1,3,4,25.0%,6m
11925,3,百万大军,2776,0,0,1,1,0.0%,12m
11925,3,麦兜,2776,0,0,1,1,0.0%,5m
11925,3,妈个鸡泰伦,2776,0,0,1,1,0.0%,10m
11925,3,[I20I]sixks,2776,0,0,1,1,0.0%,19m
11943,2,tutu,2775,935,84,77,161,52.2%,33m
11943,3,jeff,2775,1255,65,47,112,58.0%,15m
11943,3,双笙,2775,528,23,13,36,63.9%,14m
11943,3,[开饭了]田教授,2775,391,18,11,29,62.1%,10m
11943,1,[混吃混喝]虚空之遗,2775,104,4,11,15,26.7%,34m
11943,3,[Shawk]衡安学校没有妈妈,2775,30,2,2,4,50.0%,22m
11943,3,悲悯,2775,30,1,4,5,20.0%,8m
11943,3,lyf,2775,0,1,4,5,20.0%,19m
11951,3,政政必拿奥斯卡,2774,1575,72,61,133,54.1%,13m
11951,3,[Rhusky]我是条码人,2774,938,51,19,70,72.9%,13m
11951,3,cyouketsu,2774,610,26,23,49,53.1%,6m
11951,1,[星星你全家]铁吊小叮当,2774,299,9,8,17,52.9%,1h
11951,3,[神子]HaiWuLiang,2774,231,8,5,13,61.5%,38m
11951,3,[北京大学鸡协]Unterseeboot,2774,120,5,5,10,50.0%,14m
11951,3,Fury,2774,144,4,2,6,66.7%,15m
11951,1,kivvf,2774,96,4,4,8,50.0%,12m
11951,3,迷路的艾蒙,2774,114,4,7,11,36.4%,4m
11951,3,[SS天羽]foever,2774,86,3,4,7,42.9%,7m
11951,2,[lmbaP]风笛,2774,0,3,4,7,42.9%,1h
11951,3,洋洋得意,2774,0,2,3,5,40.0%,1h
11951,2,[南湖匈奴]赌神,2774,0,1,0,1,100.0%,5m
11951,2,[do啊do]华昭,2774,0,1,0,1,100.0%,60m
11951,2,阿尼姆斯菲亚,2774,0,1,0,1,100.0%,20m
11951,2,[南昌一枝花]小色意,2774,0,1,0,1,100.0%,12m
11951,1,[醉生梦死]眼眸印溫柔,2774,48,1,1,2,50.0%,1h
11951,2,Thebugc,2774,0,1,3,4,25.0%,1h
11951,2,[逗帝]萧炎,2774,0,1,6,7,14.3%,28m
11951,3,心跳回忆,2774,0,0,1,1,0.0%,19m
11951,3,llllllllllll,2774,0,0,2,2,0.0%,8m
11972,3,eagle,2773,1137,70,72,142,49.3%,17m
11972,3,古明地玃,2773,1177,45,41,86,52.3%,13m
11972,2,蓝色空间,2773,747,30,27,57,52.6%,37m
11972,2,执魔,2773,602,27,28,55,49.1%,20m
11972,3,[grief]Alkan,2773,313,15,10,25,60.0%,6m
11972,3,[Mentor]CJHAAAAAA,2773,410,14,13,27,51.9%,37m
11972,1,超级爸爸,2773,283,10,11,21,47.6%,19m
11972,3,[滑稽联盟]Puerum,2773,172,8,7,15,53.3%,1h
11972,3,[银杏居]天祺,2773,226,8,11,19,42.1%,9m
11972,1,[听雨轩]wanghui,2773,215,6,13,19,31.6%,21m
11972,3,kira,2773,120,4,5,9,44.4%,6m
11972,3,臣妾紧握朕龙根,2773,30,1,3,4,25.0%,9m
11972,3,[没有战队]无畏舰贱长,2773,0,0,1,1,0.0%,29m
11972,2,[love西瓜]只爱内战,2773,0,0,1,1,0.0%,54m
11972,3,马官人,2773,0,0,1,1,0.0%,1h
11972,3,黑色小刀,2773,0,0,3,3,0.0%,7m
11988,1,[五等分的花嫁]浪味仙,2772,1528,189,191,380,49.7%,4m
11988,2,李狗嗨,2772,1018,126,124,250,50.4%,30m
11988,3,凌舞雩,2772,1011,44,37,81,54.3%,19m
11988,3,InNOvation,2772,1086,44,47,91,48.4%,23m
11988,3,NSK,2772,965,43,38,81,53.1%,12m
11988,3,winson,2772,544,21,22,43,48.8%,6m
11988,3,[YiHz]执念,2772,337,16,4,20,80.0%,8m
11988,3,[晋升者]IIIIIIIIIIII,2772,280,13,3,16,81.2%,33m
11988,3,我是菜鸟请多关照,2772,315,11,8,19,57.9%,24m
11988,3,Fury,2772,276,11,10,21,52.4%,28m
11988,3,异能灵类,2772,219,10,1,11,90.9%,10m
11988,1,丁大款,2772,332,10,26,36,27.8%,5m
11988,3,adassdwa,2772,242,8,5,13,61.5%,10m
11988,3,阿里斯古,2772,97,8,8,16,50.0%,12m
11988,1,Liadrin,2772,145,5,6,11,45.5%,12m
11988,3,摄政王阿强,2772,0,3,2,5,60.0%,1h
11988,2,[无道德]神族领袖条毛毛,2772,120,3,11,14,21.4%,47m
11988,2,Twilight,2772,0,0,1,1,0.0%,22m
11988,3,[芜湖难铜]名字喂狗去了,2772,0,0,1,1,0.0%,25m
12007,2,皮英霸,2771,958,38,39,77,49.4%,7m
12007,3,IIIIIIIIIIII,2771,519,23,10,33,69.7%,22m
12007,3,zest,2771,337,17,8,25,68.0%,19m
12007,3,我不是姓崔的,2771,91,7,9,16,43.8%,38m
12007,3,DaveXu,2771,182,6,4,10,60.0%,25m
12007,3,各种肉色,2771,213,6,5,11,54.5%,29m
12007,1,[竞赛]寒剑冰心,2771,160,5,7,12,41.7%,1h
12007,3,不羁哟,2771,157,5,7,12,41.7%,1h
12007,3,ZHULU,2771,158,5,9,14,35.7%,19m
12007,3,Qdoctor,2771,0,3,1,4,75.0%,1h
12007,1,Hadoken,2771,116,3,1,4,75.0%,50m
12007,2,[曾经一群兔子]快乐的菜鸟,2771,0,3,1,4,75.0%,1h
12007,3,哦哟,2771,0,3,2,5,60.0%,58m
12007,3,EXGomorra,2771,62,3,5,8,37.5%,8m
12007,1,[knsk]Zagra,2771,0,1,2,3,33.3%,56m
12007,3,MagicTerran,2771,0,0,1,1,0.0%,9m
12023,1,[国产奶粉]最恨粪坑流,2770,1485,353,346,699,50.5%,35m
12023,3,Jhin,2770,1463,135,123,258,52.3%,33m
12023,2,柳肥宅,2770,605,64,70,134,47.8%,29m
12023,3,[土肥圓]想像豬一樣的飛,2770,451,46,39,85,54.1%,26m
12023,3,[基金会]大虾吃掉你,2770,500,40,37,77,51.9%,24m
12023,3,唯独在大地,2770,828,29,29,58,50.0%,18m
12023,3,tenevil,2770,373,13,9,22,59.1%,17m
12023,2,wtxj,2770,341,12,15,27,44.4%,13m
12023,3,苏科孙红雷,2770,228,7,5,12,58.3%,38m
12023,2,周木木,2770,0,3,3,6,50.0%,1h
12023,1,[长征小白]我叫小难,2770,0,3,4,7,42.9%,56m
12023,3,再菜也爱玩,2770,142,3,5,8,37.5%,6m
12023,3,卖豆皮,2770,110,2,2,4,50.0%,29m
12023,3,[Pb丶pB]批爆丶正正南,2770,30,2,5,7,28.6%,13m
12023,2,[星际战争]时候,2770,94,1,1,2,50.0%,1h
12023,3,邪王真眼赛高,2770,91,1,1,2,50.0%,13m
12023,3,[非洲度假]sora,2770,0,1,1,2,50.0%,1h
12023,1,[蜜臀姐姐联盟]小浩,2770,0,1,3,4,25.0%,1h
12023,1,别打我先打我队友,2770,30,1,14,15,6.7%,26m
12023,3,[OkOKk]英文,2770,0,0,1,1,0.0%,19m
12023,3,[开花]荣耀之链,2770,0,0,1,1,0.0%,6m
12023,3,[星际最强亡者]ZERO,2770,0,0,1,1,0.0%,1h
12045,2,CyberVisionY,2769,749,84,89,173,48.6%,7m
12045,1,LaoK,2769,120,8,6,14,57.1%,47m
12045,3,明阳,2769,186,8,8,16,50.0%,26m
12045,1,[世界大战]飘零落英,2769,113,3,0,3,100.0%,21m
12045,3,Faker,2769,0,2,2,4,50.0%,1h
12045,2,[拨云见日]卧龙,2769,46,2,6,8,25.0%,59m
12045,3,[浮夸的]江潭落月复西斜,2769,0,1,0,1,100.0%,18m
12045,3,清醉,2769,32,1,5,6,16.7%,1h
12045,1,Theyu,2769,48,1,5,6,16.7%,50m
12045,3,lkooopop,2769,0,0,3,3,0.0%,22m
12045,2,情葬离恨天,2769,0,0,4,4,0.0%,34m
12056,3,[萌新小分队]默默默默含,2768,760,75,65,140,53.6%,17m
12056,3,紫云雀,2768,650,75,72,147,51.0%,16m
12056,3,灬飒爽英姿灬,2768,1403,60,46,106,56.6%,33m
12056,3,[Canton]夏风听雨,2768,199,56,20,76,73.7%,19m
12056,3,Chokyi,2768,416,16,19,35,45.7%,17m
12056,3,Jumbo,2768,324,14,5,19,73.7%,18m
12056,3,江南狗王孙一峰,2768,172,5,3,8,62.5%,15m
12056,1,执念浅殇,2768,48,4,5,9,44.4%,1h
12056,3,[猫跑去田间了]猫掉进井里了,2768,0,3,2,5,60.0%,1h
12056,2,无味浪味仙,2768,0,3,3,6,50.0%,1h
12056,3,琳琅朗朗,2768,83,2,2,4,50.0%,12m
12056,3,[黄金战队]MCSAFS,2768,0,2,3,5,40.0%,1h
12056,2,[KingL]逃亡者,2768,0,2,3,5,40.0%,60m
12056,3,[反黑行动组]阿尔萨斯,2768,0,1,0,1,100.0%,10m
12056,1,Nautilus,2768,0,1,1,2,50.0%,1h
12056,3,小菜鸡,2768,30,1,2,3,33.3%,7m
12056,3,[NT]星际太难了,2768,30,1,4,5,20.0%,13m
12056,3,可乐加雪碧,2768,0,0,1,1,0.0%,33m
12074,3,我为狂三上王者,2767,928,75,39,114,65.8%,17m
12074,3,heheyang,2767,1192,75,68,143,52.4%,23m
12074,3,[DMUNB]星际练席生,2767,414,20,8,28,71.4%,39m
12074,3,TVTGG,2767,398,20,18,38,52.6%,9m
12074,3,[草死尼玛哦]老咸鱼,2767,428,17,15,32,53.1%,13m
12074,3,[最菜战队]一边甩飞龙一边哭,2767,347,16,5,21,76.2%,33m
12074,3,顶级死法,2767,231,10,7,17,58.8%,25m
12074,3,高某东,2767,227,8,5,13,61.5%,18m
12074,2,GuangMo,2767,189,8,9,17,47.1%,1h
12074,3,猎马人,2767,155,7,1,8,87.5%,8m
12074,3,Zkao,2767,153,7,7,14,50.0%,33m
12074,3,[太刀天下第一]垃圾人,2767,166,6,10,16,37.5%,22m
12074,2,Mitterora,2767,148,4,8,12,33.3%,13m
12074,2,真名,2767,93,3,3,6,50.0%,1h
12074,3,[星际一号]玩星际的渣渣辉,2767,30,2,1,3,66.7%,17m
12074,3,Kazusa,2767,30,2,2,4,50.0%,17m
12074,3,逗比乖巧猪,2767,30,1,4,5,20.0%,33m
12074,3,子乔,2767,0,0,2,2,0.0%,23m
12074,3,如沐清风,2767,0,0,2,2,0.0%,8m
12074,3,麦对有,2767,0,0,2,2,0.0%,18m
12074,3,[和风]Wtasqr,2767,0,0,3,3,0.0%,38m
12095,1,要写论文辣,2766,1563,332,332,664,50.0%,18m
12095,1,不想浦头,2766,1541,242,235,477,50.7%,24m
12095,2,Soukey,2766,826,53,53,106,50.0%,36m
12095,2,达死你,2766,620,24,27,51,47.1%,13m
12095,3,你的阳哥哈哈哈哈,2766,353,15,8,23,65.2%,38m
12095,3,心已失梦已碎,2766,365,14,9,23,60.9%,25m
12095,3,Aiyaya,2766,359,14,11,25,56.0%,26m
12095,3,Umbrella,2766,318,13,11,24,54.2%,13m
12095,1,里予,2766,298,9,7,16,56.2%,40m
12095,3,离殇夜尽天明,2766,132,4,2,6,66.7%,8m
12095,3,lifengxu,2766,86,4,3,7,57.1%,24m
12095,3,story,2766,60,3,3,6,50.0%,5m
12095,3,[无畏巡洋]太虚冥殇掌门人,2766,72,3,5,8,37.5%,20m
12095,3,克洛佐斯的喵喵酱,2766,30,2,1,3,66.7%,13m
12095,2,Renekton,2766,95,2,4,6,33.3%,1h
12095,3,[SoloAs]嘤嘤嘤,2766,0,1,0,1,100.0%,19m
12095,3,saberlily,2766,0,1,0,1,100.0%,8m
12095,3,[逝去之风]冷霜,2766,92,1,1,2,50.0%,18m
12095,3,慢慢尝试,2766,0,1,4,5,20.0%,24m
12095,3,死神嫉妒我,2766,0,0,1,1,0.0%,19m
12095,3,[生生不息]普通人机,2766,0,0,1,1,0.0%,34m
12095,3,PrinceLunar,2766,0,0,1,1,0.0%,40m
12117,3,cjluwxh,2765,569,53,43,96,55.2%,10m
12117,3,wangbaba,2765,722,36,15,51,70.6%,14m
12117,2,[耗子尾汁]mIaO,2765,410,17,20,37,45.9%,47m
12117,3,[Strike]okay,2765,310,14,5,19,73.7%,4m
12117,3,jxws,2765,302,11,7,18,61.1%,18m
12117,3,[没有风脸]CloudKnight,2765,140,5,7,12,41.7%,13m
12117,2,Nate,2765,122,3,1,4,75.0%,21m
12117,1,我真的不会玩合作,2765,118,2,3,5,40.0%,1h
12117,3,[在下菜鸡一只]日京木华,2765,60,2,7,9,22.2%,4m
12117,2,普通电脑,2765,93,1,1,2,50.0%,20m
12117,2,ZLCK,2765,0,0,2,2,0.0%,55m
12117,3,mahoezio,2765,0,0,4,4,0.0%,37m
12129,2,fireyh,2764,491,43,42,85,50.6%,21m
12129,2,我玩你,2764,502,20,19,39,51.3%,40m
12129,3,[屑魔女]抱着洋葱猫不说话,2764,346,18,10,28,64.3%,38m
12129,2,法尔,2764,91,14,24,38,36.8%,32m
12129,3,clearlove,2764,298,13,5,18,72.2%,13m
12129,2,[119]自由之翼,2764,333,11,16,27,40.7%,14m
12129,3,khas,2764,238,9,9,18,50.0%,27m
12129,2,让麻酱同化神族吧,2764,204,5,11,16,31.2%,21m
12129,2,sbzby,2764,152,5,13,18,27.8%,23m
12129,3,OSO,2764,88,4,3,7,57.1%,9m
12129,3,黑白信仰,2764,0,3,2,5,60.0%,1h
12129,3,[中老年交友群]Fullen,2764,58,2,4,6,33.3%,13m
12129,3,恰克与飞鸟,2764,125,2,5,7,28.6%,6m
12129,1,zeratul,2764,0,1,0,1,100.0%,1h
12129,2,[aboth]乌鲁克斧王,2764,0,1,0,1,100.0%,28m
12144,1,渣渣天乐,2763,1111,149,141,290,51.4%,8m
12144,3,崽崽酱,2763,1089,50,36,86,58.1%,6m
12144,2,[我笑你阿巴阿]Corgi,2763,585,25,25,50,50.0%,7m
12144,2,[星舰与太阳x]Crane,2763,416,15,19,34,44.1%,27m
12144,2,路过的假面骑士,2763,390,14,18,32,43.8%,28m
12144,3,Devil,2763,288,10,8,18,55.6%,4m
12144,3,[KK开]心陨,2763,219,7,4,11,63.6%,38m
12144,3,不会刺蛇狗毒爆,2763,116,5,3,8,62.5%,19m
12144,3,TheSTaR,2763,187,5,4,9,55.6%,17m
12144,3,[电风扇]咕噜灵波,2763,26,5,9,14,35.7%,9m
12144,3,[GKM]MuMafu,2763,62,3,5,8,37.5%,10m
12144,3,泰伦之光,2763,0,1,0,1,100.0%,10m
12144,3,[何平]JACKYANG,2763,0,0,1,1,0.0%,40m
12144,2,[SC小流子]摇摆骚狗,2763,0,0,1,1,0.0%,21m
12144,3,鸢言凛空,2763,0,0,1,1,0.0%,13m
12159,2,[Saigao]Dionysus,2762,865,62,67,129,48.1%,7m
12159,3,七重人格,2762,1140,42,43,85,49.4%,7m
12159,3,[沙漠之鹰]StarHuang,2762,558,23,17,40,57.5%,20m
12159,3,IIIIIIIIIIII,2762,441,16,16,32,50.0%,33m
12159,2,[璇玑]啊这丷,2762,432,16,18,34,47.1%,17m
12159,3,[意映卿卿如晤]hyun,2762,330,11,17,28,39.3%,18m
12159,3,[Tsing]PeanchesBoy,2762,141,8,5,13,61.5%,33m
12159,3,[作死万岁]小黑,2762,126,7,1,8,87.5%,18m
12159,2,MKing,2762,207,6,1,7,85.7%,17m
12159,1,冲上云霄,2762,142,5,6,11,45.5%,56m
12159,3,iiiii,2762,82,5,6,11,45.5%,12m
12159,2,loveddoouuu,2762,124,5,11,16,31.2%,12m
12159,1,[半人马座分部]haha,2762,96,4,5,9,44.4%,56m
12159,2,星空的天,2762,136,3,4,7,42.9%,39m
12159,3,[基金会]神圣联盟,2762,30,2,4,6,33.3%,14m
12159,3,那你真的很棒帮哦,2762,0,1,0,1,100.0%,8m
12159,1,不灭战神,2762,0,1,1,2,50.0%,56m
12159,3,sdajja,2762,0,1,3,4,25.0%,1h
12159,3,冬眠的小熊猫,2762,0,0,1,1,0.0%,18m
12159,2,爱玩游戏的达桑,2762,0,0,1,1,0.0%,1h
12159,3,chegan,2762,0,0,4,4,0.0%,12m
12180,3,Thomas,2761,1528,237,220,457,51.9%,37m
12180,2,InnerHeart,2761,1457,104,92,196,53.1%,13m
12180,3,withon,2761,1075,46,44,90,51.1%,33m
12180,1,[TCP]Lupo,2761,1074,37,47,84,44.0%,34m
12180,3,IIIIIIIIIIII,2761,250,11,9,20,55.0%,56m
12180,3,zhandou,2761,262,10,7,17,58.8%,43m
12180,1,敢杀我的马,2761,168,4,5,9,44.4%,1h
12180,2,这不是机克迷,2761,93,3,3,6,50.0%,1h
12180,1,Sora,2761,0,3,4,7,42.9%,11m
12180,3,[knsk]国民老婆孙一峰,2761,0,1,0,1,100.0%,18m
12180,3,[PL4y]BlackJack,2761,93,1,1,2,50.0%,29m
12180,3,[社交学大可爱]新手玩家,2761,30,1,2,3,33.3%,5m
12180,3,颂伊雪,2761,0,0,1,1,0.0%,17m
12180,3,Neber,2761,0,0,2,2,0.0%,6m
12194,2,IIIIIIIIIIII,2760,1289,78,62,140,55.7%,36m
12194,3,[O栋444]四川康王龙,2760,636,29,19,48,60.4%,10m
12194,2,[我太帅]运气是实力的全部,2760,480,26,30,56,46.4%,4m
12194,3,[你的剑很美]本毒物,2760,368,14,8,22,63.6%,25m
12194,2,[专业de团队]艾尔建筑大师,2760,269,10,12,22,45.5%,28m
12194,3,蟒王,2760,270,9,11,20,45.0%,26m
12194,1,炉石结,2760,119,4,6,10,40.0%,1h
12194,2,丨丨丨丨丨丨丨丨,2760,91,3,1,4,75.0%,1h
12194,3,LeviAckerman,2760,58,3,5,8,37.5%,13m
12194,2,[二次元联盟军]calypso,2760,86,3,10,13,23.1%,37m
12194,1,玩玩飞刀,2760,82,2,2,4,50.0%,24m
12194,1,SDemon,2760,0,1,0,1,100.0%,47m
12194,3,[全自动星际]苦瓜大王,2760,0,1,0,1,100.0%,14m
12194,1,[情谊至上]闪击英雄,2760,40,1,1,2,50.0%,1h
12194,3,冰菓,2760,0,0,1,1,0.0%,6m
12194,2,枯叶飘零,2760,0,0,5,5,0.0%,41m
12210,1,durate,2759,448,21,2,23,91.3%,38m
12210,2,Bass,2759,494,18,23,41,43.9%,37m
12210,1,[暴雪我是你爹]闵行孙一峰,2759,345,15,12,27,55.6%,47m
12210,3,lovezly,2759,224,8,5,13,61.5%,38m
12210,1,[黑丝小幼女]阿疯,2759,203,7,4,11,63.6%,19m
12210,3,[星核战队]天道,2759,167,5,4,9,55.6%,8m
12210,3,余辰,2759,192,5,6,11,45.5%,56m
12210,2,[女儿名爱莉]我是小学生,2759,137,4,5,9,44.4%,1h
12210,1,完美演绎,2759,80,2,2,4,50.0%,12m
12210,3,按钮,2759,0,2,2,4,50.0%,1h
12210,3,[CQT]秋明山老马夫,2759,58,2,4,6,33.3%,36m
12210,1,ZEN,2759,37,1,1,2,50.0%,47m
12210,3,[莽的不行]大瑞明不爱刷牙丶,2759,0,1,1,2,50.0%,15m
12210,3,Tenet,2759,30,1,2,3,33.3%,13m
12210,2,RicaroMLU,2759,0,1,7,8,12.5%,12m
12210,3,[炎神战队]圣堂之魂,2759,0,0,2,2,0.0%,6m
12226,3,ForT,2758,1362,52,51,103,50.5%,18m
12226,3,[为谁而忧伤]chunyu,2758,858,42,30,72,58.3%,18m
12226,3,IIIIIIIIIII,2758,796,29,31,60,48.3%,20m
12226,1,[C09]手游废宅,2758,619,20,16,36,55.6%,1h
12226,2,[菜的徐坤都怕]拳打南山养老院,2758,298,12,17,29,41.4%,14m
12226,1,你顶住我先撤了,2758,216,6,2,8,75.0%,5m
12226,3,想不出,2758,176,6,10,16,37.5%,26m
12226,3,喵先生,2758,140,5,6,11,45.5%,14m
12226,3,Verde,2758,120,5,6,11,45.5%,9m
12226,2,Nakira,2758,150,3,7,10,30.0%,28m
12226,3,你皮,2758,95,2,1,3,66.7%,13m
12226,3,Sup,2758,30,1,2,3,33.3%,26m
12226,1,[东大电竞]血色黄昏,2758,48,1,3,4,25.0%,1h
12226,1,三硝基甲苯,2758,0,0,1,1,0.0%,5m
12240,2,[HUC水军]herokinggggg,2757,1605,88,88,176,50.0%,33m
12240,2,[中南大学官网]JJLucky,2757,763,53,48,101,52.5%,34m
12240,3,[Fear]星际渣渣辉,2757,635,24,21,45,53.3%,10m
12240,3,花天墨骨,2757,338,14,6,20,70.0%,13m
12240,3,Bereavement,2757,320,12,3,15,80.0%,4m
12240,1,WIDOWMINE,2757,318,10,8,18,55.6%,1h
12240,1,Swezzzzz,2757,116,6,4,10,60.0%,1h
12240,2,少女与战车喀秋莎,2757,138,4,4,8,50.0%,1h
12240,3,NZyan,2757,96,2,0,2,100.0%,11m
12240,3,皮完,2757,0,1,1,2,50.0%,33m
12240,3,仙落红尘欲哭无泪,2757,0,1,4,5,20.0%,59m
12240,1,[小鸡屠宰场3]蓝黑之殇,2757,0,0,1,1,0.0%,1h
12252,1,visitordp,2756,569,48,47,95,50.5%,18m
12252,3,[Anticw]ShangRen,2756,531,21,16,37,56.8%,37m
12252,3,哇哇,2756,395,20,13,33,60.6%,22m
12252,3,mmmm,2756,513,20,18,38,52.6%,9m
12252,2,花水雨离子,2756,472,18,26,44,40.9%,25m
12252,1,llllllllll,2756,240,9,1,10,90.0%,6m
12252,1,Yutto,2756,112,9,1,10,90.0%,33m
12252,3,[爷不能死]霜之谐星,2756,273,9,8,17,52.9%,17m
12252,1,[你怕是没睡醒]scv,2756,165,4,3,7,57.1%,8m
12252,3,风吹蛋凉,2756,90,4,5,9,44.4%,27m
12252,3,青山,2756,97,4,5,9,44.4%,33m
12252,3,算命先生,2756,0,0,1,1,0.0%,1h
12252,3,打死李佑熙,2756,0,0,2,2,0.0%,12m
12265,3,蛇皮老沙发,2755,740,27,26,53,50.9%,14m
12265,3,sungel,2755,678,23,29,52,44.2%,25m
12265,3,萝莉控,2755,414,17,17,34,50.0%,26m
12265,3,小雨下大了,2755,246,10,4,14,71.4%,38m
12265,1,umisonoda,2755,262,10,7,17,58.8%,12m
12265,3,乌龟,2755,220,9,6,15,60.0%,1h
12265,2,wwklk,2755,252,7,13,20,35.0%,7m
12265,3,[零点五个菜鸟]tossgirls,2755,193,6,4,10,60.0%,26m
12265,1,橄榄虫集结,2755,158,6,5,11,54.5%,1h
12265,3,阿炜不俊,2755,86,4,7,11,36.4%,6m
12265,1,春江花月夜,2755,76,3,1,4,75.0%,10m
12265,3,[浪啊浪]吕同轩帅,2755,90,3,7,10,30.0%,8m
12265,2,IIIIIIIIIII,2755,93,2,0,2,100.0%,47m
12265,3,[艾尔之巅]新手无虐,2755,60,2,4,6,33.3%,8m
12265,1,[橘里橘气]啊啦啦垃圾君,2755,0,0,1,1,0.0%,12m
12265,1,[打傻队友]蓝莓味泡泡水,2755,0,0,1,1,0.0%,24m
12281,1,sos,2754,723,26,23,49,53.1%,1h
12281,2,小怂,2754,153,8,10,18,44.4%,1h
12281,1,影丶墨,2754,157,6,2,8,75.0%,33m
12281,3,OldCaptain,2754,44,4,6,10,40.0%,9m
12281,3,邪恶丶小处男,2754,96,3,1,4,75.0%,12m
12281,3,LIA,2754,30,2,2,4,50.0%,33m
12281,1,SIHAI,2754,0,1,0,1,100.0%,38m
12281,1,辣辣的香蕉,2754,0,1,0,1,100.0%,1h
12281,3,[带你上分]陨落,2754,0,1,1,2,50.0%,18m
12281,2,不凡,2754,0,0,1,1,0.0%,1h
12291,3,暗裔蚊子,2753,486,100,71,171,58.5%,17m
12291,3,龙蛇影,2753,612,31,26,57,54.4%,19m
12291,3,ingory,2753,357,19,12,31,61.3%,14m
12291,2,[KRT]鸿殇,2753,378,17,14,31,54.8%,7m
12291,2,壹玖贰,2753,419,15,14,29,51.7%,34m
12291,3,晴天,2753,372,13,14,27,48.1%,10m
12291,3,[QWQa]Azrael,2753,289,10,8,18,55.6%,56m
12291,2,Perry,2753,126,9,16,25,36.0%,6m
12291,3,Vant,2753,202,8,8,16,50.0%,7m
12291,1,汗五帝,2753,232,8,9,17,47.1%,1h
12291,3,[我们要娶老婆]暗鸦,2753,148,6,6,12,50.0%,39m
12291,1,hanxiaozhi,2753,138,6,7,13,46.2%,1h
12291,3,sunny,2753,114,5,6,11,45.5%,38m
12291,3,[NoToss]Mercurial,2753,0,2,2,4,50.0%,1h
12291,3,[幼稚园的故事]yjj,2753,58,2,4,6,33.3%,18m
12291,3,[大漢]奔跑的小雄猫,2753,0,1,1,2,50.0%,49m
12291,3,[DRI]幽灵,2753,93,1,2,3,33.3%,17m
12308,3,pbcdarker,2752,1473,69,59,128,53.9%,26m
12308,3,Mercury,2752,1015,53,60,113,46.9%,19m
12308,3,小七,2752,510,23,14,37,62.2%,40m
12308,3,死囚漫步,2752,116,19,16,35,54.3%,7m
12308,1,宫保蟋蟀,2752,370,18,11,29,62.1%,38m
12308,3,[艾尔之巅]寒风凛冽,2752,376,18,22,40,45.0%,10m
12308,3,[秋千千秋]lavender,2752,491,16,35,51,31.4%,36m
12308,3,windsky,2752,291,12,8,20,60.0%,60m
12308,3,[为谁而忧伤]Starry,2752,170,7,6,13,53.8%,24m
12308,3,[西安石油大学]生气老表,2752,178,6,8,14,42.9%,22m
12308,1,roy,2752,170,5,2,7,71.4%,1h
12308,3,[约定弑神之剑]起名真难哎,2752,122,5,5,10,50.0%,33m
12308,2,JunIoR,2752,196,5,6,11,45.5%,1h
12308,3,白夜弧光,2752,0,2,3,5,40.0%,1h
12308,3,肉祖宗,2752,60,2,4,6,33.3%,25m
12308,3,WBWB,2752,0,0,2,2,0.0%,8m
12324,2,玛格基贾德诺,2751,971,94,83,177,53.1%,21m
12324,2,苗二狗,2751,494,52,35,87,59.8%,12m
12324,2,[X英雄圣域X]轻狂书生,2751,685,32,37,69,46.4%,12m
12324,3,[风之灵]蓬莱苮人,2751,146,6,6,12,50.0%,26m
12324,3,四维生物,2751,130,4,1,5,80.0%,1m
12324,1,易灬,2751,36,4,2,6,66.7%,19m
12324,3,牧濑红莉栖,2751,58,3,6,9,33.3%,26m
12324,3,[水猫哥斯拉]没法打,2751,0,2,0,2,100.0%,1h
12324,3,[歪比]llllllllllll,2751,0,2,3,5,40.0%,29m
12324,1,YumeKara,2751,0,1,0,1,100.0%,1h
12324,1,[萌萌哒鸡]芳香的猪,2751,0,0,1,1,0.0%,23m
12324,2,IIIIIIII,2751,0,0,2,2,0.0%,15m
12324,2,无法显示,2751,0,0,2,2,0.0%,1h
12324,3,lyokoS,2751,0,0,3,3,0.0%,17m
12338,3,[创世会]Diver,2750,1583,196,182,378,51.9%,25m
12338,1,[被情所慯]SprongeBob,2750,1550,68,63,131,51.9%,11m
12338,2,Luciferw,2750,334,35,41,76,46.1%,25m
12338,2,[火焰雷兽]幽魂零,2750,636,22,31,53,41.5%,23m
12338,3,cactuss,2750,592,21,22,43,48.8%,7m
12338,3,IIIIIIIIIIII,2750,536,20,19,39,51.3%,36m
12338,1,可可豆,2750,317,10,4,14,71.4%,7m
12338,3,[我队伍很强大]byj,2750,237,10,5,15,66.7%,6m
12338,3,[火猫哥斯拉]我类个去,2750,228,7,4,11,63.6%,60m
12338,3,吾曾称作电竞,2750,42,3,3,6,50.0%,1h
12338,3,JinYukihira,2750,58,3,3,6,50.0%,5m
12338,3,南初妹妹,2750,93,2,1,3,66.7%,15m
12338,3,Timber,2750,0,2,3,5,40.0%,3m
12338,2,一纸素炎,2750,36,2,5,7,28.6%,10m
12338,3,丶一个人挺好灬,2750,60,2,6,8,25.0%,18m
12338,3,umemaro,2750,0,1,2,3,33.3%,9m
12338,1,萝卜蛋,2750,0,0,1,1,0.0%,1h
12355,3,约书亚,2749,1382,88,74,162,54.3%,26m
12355,1,[CPT]墓志铭结婚时代,2749,713,25,23,48,52.1%,9m
12355,2,[XXHZN2]stone,2749,490,22,14,36,61.1%,23m
12355,3,[泰伦斧头帮]scboyfaren,2749,474,18,14,32,56.2%,16m
12355,2,DrEric,2749,258,9,16,25,36.0%,12m
12355,1,猫猫,2749,190,6,7,13,46.2%,22m
12355,3,[杰希]Zai,2749,92,3,6,9,33.3%,8m
12355,1,JokerXu,2749,106,2,9,11,18.2%,26m
12355,3,[Swing]CheckMate,2749,0,1,1,2,50.0%,29m
12355,3,麦克尔杰克骚,2749,0,1,1,2,50.0%,37m
12355,2,Kratos,2749,0,0,1,1,0.0%,15m
12355,3,[给你一颗糖吧]小尾巴,2749,0,0,2,2,0.0%,23m
12367,2,[miku守护]chck,2748,1644,615,608,1223,50.3%,36m
12367,2,子沐淼,2748,602,40,37,77,51.9%,12m
12367,1,IlIIllIIIllI,2748,461,31,18,49,63.3%,27m
12367,1,[西瓜保熟不]孙红雷,2748,893,31,24,55,56.4%,36m
12367,1,voncarstein,2748,286,10,14,24,41.7%,34m
12367,3,Phoneix,2748,138,7,8,15,46.7%,38m
12367,2,米猪,2748,174,5,13,18,27.8%,1h
12367,2,拉布拉多,2748,93,4,3,7,57.1%,23m
12367,2,[键盘冒毒奶]avenger,2748,0,1,0,1,100.0%,1h
12367,3,暗神梦魇,2748,92,1,2,3,33.3%,19m
12367,1,介石,2748,0,0,1,1,0.0%,58m
12378,2,阿史那特勤,2747,893,81,69,150,54.0%,33m
12378,3,憨批机械化,2747,1345,61,54,115,53.0%,18m
12378,1,[XDUSC2]IIIIIIIIIIII,2747,432,16,7,23,69.6%,1h
12378,1,[o唔姆o]白门楼的阶梯,2747,315,10,3,13,76.9%,29m
12378,2,虫虫,2747,212,7,12,19,36.8%,40m
12378,3,[蒸汽姬海老名]zjh,2747,177,6,8,14,42.9%,19m
12378,2,[五年目放課後]Tian,2747,125,4,4,8,50.0%,60m
12378,1,花儿笑哈哈,2747,0,1,0,1,100.0%,1h
12378,1,技术不好把我送,2747,0,1,2,3,33.3%,40m
12378,3,阿拉纳克,2747,0,0,2,2,0.0%,38m
12378,3,[菊花神教]Bill,2747,0,0,3,3,0.0%,16m
12389,2,Green,2746,1552,220,216,436,50.5%,3m
12389,3,[低楽集团]Eta,2746,853,34,52,86,39.5%,3m
12389,1,[混元形意星际]JIANG,2746,168,12,5,17,70.6%,34m
12389,3,战闪新星,2746,226,9,9,18,50.0%,14m
12389,3,LIJI,2746,241,8,8,16,50.0%,36m
12389,2,[统治]Kaiser,2746,0,3,3,6,50.0%,17m
12389,3,全自动上海人,2746,13,2,5,7,28.6%,26m
12396,2,asfbesrdf,2745,1580,541,533,1074,50.4%,22m
12396,3,feng,2745,1592,100,100,200,50.0%,25m
12396,2,[保证不秀地堡]恐怖如斯,2745,519,71,78,149,47.7%,12m
12396,2,菠萝,2745,1228,46,52,98,46.9%,36m
12396,1,修行的小刚,2745,1006,41,36,77,53.2%,1h
12396,2,[黑桃A]Joker,2745,793,35,38,73,47.9%,13m
12396,2,蛭子小比奈,2745,888,32,39,71,45.1%,40m
12396,3,乾坤贪狼,2745,333,17,22,39,43.6%,18m
12396,2,Timsless,2745,378,14,18,32,43.8%,3m
12396,3,Oyi,2745,246,11,9,20,55.0%,33m
12396,3,董大白,2745,240,10,9,19,52.6%,1h
12396,1,鱼咸枚一,2745,162,5,9,14,35.7%,1m
12396,3,bmw,2745,151,4,3,7,57.1%,20m
12396,1,理赔难,2745,138,4,4,8,50.0%,22m
12396,1,[雾雨魔法森林]我家猫想你,2745,0,3,4,7,42.9%,1h
12396,2,smallegg,2745,94,3,4,7,42.9%,49m
12396,3,和利,2745,109,2,2,4,50.0%,8m
12396,3,Varian,2745,0,2,3,5,40.0%,3m
12396,3,帅哥轩,2745,0,2,3,5,40.0%,13m
12396,3,江峰雨,2745,58,2,8,10,20.0%,20m
12396,1,xxxl,2745,0,1,0,1,100.0%,23m
12396,3,dtMAGA,2745,30,1,3,4,25.0%,4m
12396,3,李泽言,2745,30,1,3,4,25.0%,37m
12396,3,魔羯座,2745,0,0,2,2,0.0%,26m
12420,3,爱放核弹,2744,638,26,21,47,55.3%,13m
12420,3,中尉副官,2744,427,20,8,28,71.4%,38m
12420,1,[冲就完了]只玩无敌的鸡谐化,2744,501,20,16,36,55.6%,6m
12420,1,伴皖,2744,118,5,5,10,50.0%,33m
12420,2,zyde,2744,141,3,3,6,50.0%,1h
12420,3,铁锹战神王老七,2744,0,2,3,5,40.0%,1h
12420,1,[狼牙盟]Qgoodboy,2744,119,2,14,16,12.5%,7m
12420,1,[埃蒙保护局]大地,2744,0,1,0,1,100.0%,13m
12420,3,夏虫语冰,2744,0,0,1,1,0.0%,1h
12420,3,kenny,2744,0,0,1,1,0.0%,55m
12420,3,剥开你的心,2744,0,0,2,2,0.0%,18m
12420,1,明月清风,2744,0,0,3,3,0.0%,11m
12432,1,风随,2743,1618,254,229,483,52.6%,1h
12432,2,摸金校尉,2743,1542,94,99,193,48.7%,18m
12432,3,[星际丨老男孩]星际宇,2743,605,38,25,63,60.3%,18m
12432,2,虫群之心,2743,656,28,35,63,44.4%,22m
12432,3,致命鼠辈,2743,626,25,29,54,46.3%,39m
12432,3,雨中女郎,2743,264,12,7,19,63.2%,2m
12432,1,东卸西堵,2743,119,6,4,10,60.0%,1h
12432,1,[PGR]李铱,2743,64,3,0,3,100.0%,43m
12432,3,leviathare,2743,30,2,0,2,100.0%,9m
12432,3,沉默的猫,2743,0,2,3,5,40.0%,1h
12432,3,ysy,2743,0,2,3,5,40.0%,1h
12432,3,无叶樱,2743,40,2,3,5,40.0%,51m
12432,2,[天子这大菜B]杠惊,2743,0,1,1,2,50.0%,28m
12432,1,WEQSADW,2743,96,1,2,3,33.3%,41m
12432,2,权宜之计,2743,0,0,1,1,0.0%,15m
12432,2,Xumics,2743,0,0,2,2,0.0%,1h
12448,3,SEA,2742,760,34,32,66,51.5%,13m
12448,2,Afterglow,2742,117,4,3,7,57.1%,1h
12448,1,[死军]迷惘之万千假面,2742,0,3,4,7,42.9%,1h
12448,3,叶落知秋是也,2742,90,3,5,8,37.5%,6m
12448,1,奥澳嗷力给,2742,38,2,1,3,66.7%,10m
12448,1,炉火煲粥,2742,70,2,1,3,66.7%,43m
12448,3,Joka,2742,0,2,3,5,40.0%,59m
12448,1,[ABigS]joker,2742,36,1,1,2,50.0%,45m
12448,1,Zero,2742,0,0,1,1,0.0%,1h
12457,1,ccooll,2741,1216,104,108,212,49.1%,7m
12457,2,[西伯利亚土豆]kindshen,2741,1083,53,53,106,50.0%,36m
12457,3,IIIIIIII,2741,1374,50,56,106,47.2%,1m
12457,3,[红烧兔头]惊涛骇浪五娃,2741,189,19,15,34,55.9%,1m
12457,3,小小萌新,2741,426,18,16,34,52.9%,38m
12457,2,hzqj,2741,458,16,24,40,40.0%,13m
12457,1,寂寞的腿毛,2741,237,8,7,15,53.3%,1h
12457,3,gordonflyer,2741,173,6,4,10,60.0%,17m
12457,2,[HUC轩辕]叫兽砖家欢迎咨询,2741,188,6,6,12,50.0%,1h
12457,2,待时间嘉许,2741,210,5,6,11,45.5%,25m
12457,3,[白给丶兄弟]麦麦的春紫苑,2741,133,4,3,7,57.1%,18m
12457,2,[绅士]哦笨发,2741,106,3,2,5,60.0%,55m
12457,3,少奕丶,2741,92,2,1,3,66.7%,38m
12457,3,MRSMILE,2741,60,2,4,6,33.3%,37m
12457,3,Cinder,2741,30,1,4,5,20.0%,33m
12457,1,[AOAOA]superggn,2741,0,0,1,1,0.0%,43m
12473,2,insomniachu,2740,554,26,19,45,57.8%,13m
12473,3,皈依红姑娘丶,2740,180,13,9,22,59.1%,18m
12473,3,[构造部]DeathL,2740,243,12,9,21,57.1%,20m
12473,1,神阿德斯,2740,160,5,2,7,71.4%,1h
12473,3,三上悠亚天下无敌,2740,116,5,6,11,45.5%,20m
12473,2,WGY,2740,94,4,8,12,33.3%,12m
12473,2,清茶,2740,120,3,2,5,60.0%,13m
12473,3,[liga]Akanalika,2740,88,3,6,9,33.3%,8m
12473,1,[濯星]星蓝女子,2740,116,3,8,11,27.3%,24m
12473,2,绝世无双,2740,114,2,1,3,66.7%,53m
12473,1,lixin,2740,42,2,1,3,66.7%,43m
12473,3,[Z黑imba]Satellite,2740,92,2,1,3,66.7%,8m
12473,3,冻住不准洗澡,2740,91,2,1,3,66.7%,8m
12473,3,Legend,2740,0,1,0,1,100.0%,19m
12473,3,[21CM]阳光比我耀眼,2740,0,1,1,2,50.0%,19m
12473,1,小澪丶,2740,0,0,2,2,0.0%,1h
12473,3,IIIIIIIIIIII,2740,0,0,2,2,0.0%,2m
12473,1,mediator,2740,0,0,2,2,0.0%,7m
12491,1,独丗,2739,1443,216,204,420,51.4%,1h
12491,2,最爱,2739,1375,77,77,154,50.0%,34m
12491,3,鬻族之裔,2739,1593,75,66,141,53.2%,39m
12491,3,可哥可妻孙一峰,2739,855,40,23,63,63.5%,13m
12491,1,航母出击,2739,717,27,22,49,55.1%,26m
12491,2,[XXHZ33]岚峪,2739,399,15,17,32,46.9%,7m
12491,1,zhangzongrui,2739,275,7,5,12,58.3%,41m
12491,3,alltheplayer,2739,117,3,2,5,60.0%,18m
12491,3,尤利西斯,2739,115,3,2,5,60.0%,38m
12491,3,[miku守护]消失的雨,2739,30,2,4,6,33.3%,7m
12491,3,FrezeeMe,2739,17,2,7,9,22.2%,13m
12491,1,Green,2739,0,1,0,1,100.0%,1h
12491,1,amazing,2739,0,0,1,1,0.0%,1m
12504,1,NarthurE,2738,1385,326,344,670,48.7%,3m
12504,3,JoekevinDown,2738,476,63,63,126,50.0%,14m
12504,3,SWEG,2738,580,44,21,65,67.7%,33m
12504,2,[CNB]无色十二月,2738,508,18,30,48,37.5%,24m
12504,3,[Timbar]我的皮肤漂亮吗,2738,182,6,8,14,42.9%,39m
12504,1,[怎么赢P]一束七,2738,233,5,10,15,33.3%,1h
12504,1,[红果果QwQ]ARKhaM,2738,38,2,0,2,100.0%,1h
12504,1,梧痕,2738,73,1,1,2,50.0%,36m
12504,1,[KGIC]三日月夜空,2738,46,1,2,3,33.3%,34m
12504,1,永远不进攻,2738,0,0,1,1,0.0%,28m
12504,3,vvm,2738,0,0,4,4,0.0%,13m
12515,2,蒜这小子后劲大,2737,1342,101,96,197,51.3%,36m
12515,1,随风,2737,789,31,20,51,60.8%,38m
12515,1,[温柔兔公主]大傻猫,2737,904,31,30,61,50.8%,1h
12515,3,黑子,2737,610,27,23,50,54.0%,13m
12515,3,GFGS,2737,487,20,16,36,55.6%,6m
12515,3,ShadowBoy,2737,338,12,8,20,60.0%,60m
12515,3,[Sc养老]Sherlock,2737,204,7,11,18,38.9%,20m
12515,3,NorthX,2737,212,7,13,20,35.0%,17m
12515,3,legend,2737,97,4,2,6,66.7%,1h
12515,3,hehuaqi,2737,97,3,3,6,50.0%,57m
12515,2,XiaoXianJ,2737,0,3,3,6,50.0%,1h
12515,3,恰克船长,2737,30,2,2,4,50.0%,33m
12515,3,[伢伢乐]lngtiam,2737,0,2,3,5,40.0%,29m
12515,3,你摊上大事了,2737,58,2,6,8,25.0%,3m
12515,1,llllllllllll,2737,94,2,6,8,25.0%,40m
12515,1,[国际第91号]classices,2737,0,1,0,1,100.0%,1h
12515,3,艾尔,2737,94,1,2,3,33.3%,23m
12515,1,吼吼,2737,0,0,1,1,0.0%,37m
12515,3,御坂美琴的妹夫,2737,0,0,2,2,0.0%,18m
12534,3,馋慌兔,2736,1531,1421,1391,2812,50.5%,16m
12534,1,无敌小耗子,2736,1142,180,182,362,49.7%,32m
12534,2,[秋毫]迟来的缠,2736,448,48,41,89,53.9%,32m
12534,2,IIIIIIIOOOOO,2736,462,42,47,89,47.2%,5m
12534,1,[x不打内战x]整活小王子,2736,379,15,14,29,51.7%,26m
12534,3,角色名,2736,329,14,12,26,53.8%,33m
12534,3,烈火封印,2736,404,14,18,32,43.8%,19m
12534,3,俺有三十公分,2736,224,10,9,19,52.6%,1h
12534,1,[聚变打鸡就绪]諽命永恒,2736,325,9,9,18,50.0%,1h
12534,3,Yuki,2736,266,9,13,22,40.9%,18m
12534,1,[czlp]苏大小达克,2736,68,2,3,5,40.0%,1h
12534,1,[NZNZ]llt,2736,0,1,0,1,100.0%,50m
12534,3,墨色轨迹,2736,0,1,4,5,20.0%,57m
12534,3,Ecopter,2736,30,1,12,13,7.7%,36m
12534,1,全球冰淇淋,2736,0,0,1,1,0.0%,48m
12534,1,xiaot,2736,0,0,1,1,0.0%,37m
12550,1,WCCD,2735,1230,110,88,198,55.6%,46m
12550,3,富贵儿,2735,824,54,55,109,49.5%,18m
12550,1,送你个核弹,2735,1046,47,41,88,53.4%,1h
12550,2,THISISNPC,2735,301,13,8,21,61.9%,25m
12550,1,VacUum,2735,232,7,8,15,46.7%,12m
12550,3,RokiRokiRock,2735,158,6,10,16,37.5%,5m
12550,1,[東方幻月舞會]归曼火花一闪,2735,112,4,2,6,66.7%,25m
12550,3,地狱裁决,2735,121,3,5,8,37.5%,1h
12550,3,[入門電脳]痛苦星际,2735,112,2,2,4,50.0%,6m
12550,3,shane,2735,0,2,3,5,40.0%,1h
12550,3,小青歌吖,2735,0,2,3,5,40.0%,1h
12550,2,观阴菩萨,2735,0,2,8,10,20.0%,1h
12550,3,Lazer,2735,0,1,0,1,100.0%,1h
12550,1,straTOPhere,2735,0,0,1,1,0.0%,13m
12550,1,小郝,2735,0,0,2,2,0.0%,14m
12565,3,[sOO]THISTIME,2734,1446,161,135,296,54.4%,13m
12565,2,泽哥,2734,214,8,16,24,33.3%,12m
12565,3,Mason,2734,74,7,9,16,43.8%,12m
12565,1,万宝路小麻批,2734,141,4,2,6,66.7%,1m
12565,2,攻击之爪,2734,113,4,4,8,50.0%,1h
12565,1,LuckyTerran,2734,78,3,1,4,75.0%,36m
12565,3,kyo,2734,126,3,4,7,42.9%,6m
12565,2,sakura,2734,92,3,4,7,42.9%,54m
12565,1,gdtjw,2734,0,2,3,5,40.0%,36m
12565,3,[星际三舰客]幽宇,2734,36,2,3,5,40.0%,26m
12565,3,DontRushMe,2734,0,2,3,5,40.0%,1h
12565,1,[因爱之名]浪子葱,2734,0,1,0,1,100.0%,48m
12565,2,sjj,2734,0,1,0,1,100.0%,1h
12565,1,温故知新,2734,0,1,0,1,100.0%,1h
12565,1,[诗酒和远方]唯一的你,2734,0,1,2,3,33.3%,7m
12565,1,[暗黑战皇]邪王真眼,2734,0,0,1,1,0.0%,59m
12565,2,[暴雪家族]FATE,2734,0,0,1,1,0.0%,1h
12565,1,[来玩牛肉面]Jack,2734,0,0,2,2,0.0%,1h
12583,2,zhanhuoys,2733,1546,395,373,768,51.4%,34m
12583,3,颅献皇座血祭神皇,2733,911,34,34,68,50.0%,6m
12583,2,竟然又,2733,422,30,24,54,55.6%,6m
12583,1,tyrant,2733,615,24,16,40,60.0%,53m
12583,3,Caesar,2733,481,19,15,34,55.9%,11m
12583,1,Cronus,2733,544,17,15,32,53.1%,20m
12583,3,菜鸟至尊,2733,157,8,7,15,53.3%,33m
12583,3,amwwzi,2733,255,8,8,16,50.0%,25m
12583,3,[敢犯我河南者]kamijo,2733,239,8,8,16,50.0%,15m
12583,3,[天河联盟]star,2733,152,6,8,14,42.9%,6m
12583,1,Muzi,2733,94,5,7,12,41.7%,14m
12583,3,小俊俊,2733,142,4,4,8,50.0%,13m
12583,3,墨色轻语,2733,0,3,2,5,60.0%,3m
12583,3,爱得痛了,2733,148,3,5,8,37.5%,15m
12583,1,哎呦哦阿斯顿,2733,38,2,2,4,50.0%,1h
12583,1,[埃蒙调教团]freedom,2733,0,1,0,1,100.0%,36m
12583,3,[soki]别西卜缪林,2733,0,1,0,1,100.0%,1h
12583,1,四糸乃,2733,34,1,1,2,50.0%,10m
12583,2,星际刘德华,2733,0,0,1,1,0.0%,1h
12583,3,[你好抱歉]绫濑川修也,2733,0,0,4,4,0.0%,10m
12603,3,[银翼之光]哥特式的华丽,2732,1334,67,50,117,57.3%,25m
12603,3,[神武骑士团]东皇阁下,2732,374,16,13,29,55.2%,15m
12603,1,[XXHZ30]小菜基也要玩,2732,328,10,12,22,45.5%,6m
12603,1,muster,2732,117,3,2,5,60.0%,49m
12603,3,白金机甲,2732,97,3,3,6,50.0%,13m
12603,2,ESEgva,2732,0,3,4,7,42.9%,1h
12603,3,嗜血,2732,0,2,3,5,40.0%,57m
12603,3,Superstition,2732,30,2,3,5,40.0%,25m
12603,1,木偶,2732,82,2,4,6,33.3%,20m
12603,1,AURELIEN,2732,48,2,8,10,20.0%,22m
12603,1,提耶拉,2732,0,1,1,2,50.0%,1h
12603,1,deathlemon,2732,38,1,1,2,50.0%,1h
12603,1,勥氼,2732,38,1,2,3,33.3%,1h
12603,1,狗不讲武德,2732,0,0,1,1,0.0%,19m
12603,2,Sukaru,2732,0,0,2,2,0.0%,1h
12603,3,[狗窝猪圈]读报,2732,0,0,5,5,0.0%,1h
12619,3,雾雨听雷,2731,1429,60,53,113,53.1%,15m
12619,3,sun,2731,597,28,17,45,62.2%,38m
12619,3,Rhapsody,2731,666,24,25,49,49.0%,12m
12619,2,帅哥,2731,92,7,8,15,46.7%,27m
12619,2,[Rhusky]markjimken,2731,218,7,12,19,36.8%,39m
12619,2,[心有明月]傻毕丨尼采丨老子,2731,32,5,7,12,41.7%,46m
12619,1,大宝剑,2731,0,4,4,8,50.0%,7m
12619,2,不念则忘,2731,0,3,3,6,50.0%,5m
12619,1,wine,2731,0,1,0,1,100.0%,1h
12628,3,三土爹,2730,690,58,58,116,50.0%,39m
12628,3,大哥我还敢,2730,1037,49,44,93,52.7%,19m
12628,1,熊吉菌,2730,851,37,20,57,64.9%,2m
12628,1,SpoKe,2730,224,20,12,32,62.5%,48m
12628,1,腾云,2730,417,19,13,32,59.4%,36m
12628,3,貝吉塔,2730,467,18,20,38,47.4%,17m
12628,1,[风趣幽默]IIInazuma,2730,357,11,10,21,52.4%,34m
12628,3,[DSR]惡夢,2730,121,10,11,21,47.6%,28m
12628,3,wyz,2730,176,6,3,9,66.7%,4m
12628,3,凤凰圣主,2730,122,5,8,13,38.5%,12m
12628,3,Warrior,2730,0,2,1,3,66.7%,13m
12628,2,村子里的文化仔,2730,0,1,0,1,100.0%,15m
12628,1,blindness,2730,0,1,1,2,50.0%,1h
12628,3,KKKLolLol,2730,0,0,1,1,0.0%,1h
12628,1,YUKI,2730,0,0,1,1,0.0%,48m
12628,2,[暴雪我是你爹]Ulysses,2730,0,0,1,1,0.0%,1h
12628,2,[社交学超可爱]llllllllllll,2730,0,0,1,1,0.0%,1h
12645,1,[vaccin]只会虚空的都是傻,2729,1663,74,61,135,54.8%,1h
12645,1,Fate,2729,1500,61,51,112,54.5%,53m
12645,1,安静的美男子,2729,280,59,43,102,57.8%,5m
12645,2,[不知道叫什么]新年年年,2729,1519,55,62,117,47.0%,38m
12645,3,[OK]BELIEVE,2729,729,33,30,63,52.4%,23m
12645,3,卡冈图雅,2729,268,8,14,22,36.4%,33m
12645,1,Alex,2729,183,7,6,13,53.8%,56m
12645,2,ToneMba,2729,125,6,13,19,31.6%,16m
12645,1,artificial,2729,180,5,5,10,50.0%,41m
12645,2,镜花水月,2729,162,3,7,10,30.0%,1h
12645,3,[忠义二五仔]DiabolicalAd,2729,0,2,3,5,40.0%,1h
12645,1,[YOYOY]老毒虫,2729,36,1,2,3,33.3%,43m
12645,3,[抢矿小分队]芝士,2729,93,1,3,4,25.0%,34m
12658,2,凌幽,2728,473,47,46,93,50.5%,36m
12658,3,[RDFZsc]无常,2728,681,27,25,52,51.9%,37m
12658,3,蔷薇,2728,499,19,19,38,50.0%,14m
12658,3,战役,2728,336,14,18,32,43.8%,26m
12658,3,[盲人协会]XelNaga,2728,235,11,11,22,50.0%,38m
12658,1,Fred,2728,329,10,7,17,58.8%,25m
12658,3,EnTaroZ,2728,227,9,11,20,45.0%,19m
12658,1,我的神仙哈哈是你,2728,224,6,6,12,50.0%,46m
12658,1,琉璃殿主,2728,112,4,1,5,80.0%,34m
12658,1,hhhhhhhhhhhh,2728,160,4,8,12,33.3%,1h
12658,1,LeViAtHaN,2728,38,2,2,4,50.0%,34m
12658,1,TEwager,2728,0,0,1,1,0.0%,26m
12658,1,你需要更多的王虫,2728,0,0,1,1,0.0%,1h
12658,1,Ruichack,2728,0,0,2,2,0.0%,59m
12672,2,money,2727,1171,204,194,398,51.3%,3m
12672,1,快乐,2727,402,40,45,85,47.1%,32m
12672,3,天行者,2727,810,34,27,61,55.7%,38m
12672,3,[GZDI]顾北良辰,2727,246,12,10,22,54.5%,14m
12672,1,樱井智树,2727,242,8,5,13,61.5%,1h
12672,2,[冬予]scarcely,2727,161,7,4,11,63.6%,1h
12672,2,未闻花落,2727,88,5,6,11,45.5%,54m
12672,2,拱火天喵孙一峰,2727,116,4,4,8,50.0%,1h
12672,3,[似曾相识]别闹了,2727,143,4,5,9,44.4%,9m
12672,2,[断牙超帅的啊]Optimusprime,2727,94,2,1,3,66.7%,1h
12672,3,牙丸伤心地,2727,93,1,3,4,25.0%,10m
12672,3,Zyx,2727,0,1,4,5,20.0%,32m
12684,3,半夜那啥没带纸,2726,1170,51,38,89,57.3%,10m
12684,3,林加德,2726,983,37,35,72,51.4%,17m
12684,3,永州人,2726,560,22,20,42,52.4%,16m
12684,1,公关广告,2726,580,19,16,35,54.3%,48m
12684,3,单手上荣耀,2726,399,14,15,29,48.3%,13m
12684,1,地狱灬寒冰,2726,154,5,1,6,83.3%,59m
12684,1,电脑,2726,152,4,4,8,50.0%,1h
12684,3,WindowsXP,2726,0,4,5,9,44.4%,1h
12684,2,hhh,2726,118,3,2,5,60.0%,1h
12684,3,BATTLECRY,2726,60,2,6,8,25.0%,15m
12684,2,[途吉狂魔]就是锖,2726,0,1,0,1,100.0%,54m
12684,2,不解释,2726,0,1,1,2,50.0%,47m
12684,1,沫沫丶,2726,0,0,1,1,0.0%,59m
12684,1,[基金会]勇敢的蟑螂,2726,0,0,2,2,0.0%,13m
12684,3,北宅,2726,0,0,3,3,0.0%,14m
12699,2,Google,2725,1561,203,208,411,49.4%,16m
12699,3,舒肤佳,2725,359,47,40,87,54.0%,18m
12699,2,给他生,2725,186,7,9,16,43.8%,1h
12699,1,inK,2725,104,4,1,5,80.0%,43m
12699,2,颜如玉,2725,0,4,2,6,66.7%,1h
12699,3,[Mtp]绝望中忘了使徒,2725,150,4,6,10,40.0%,13m
12699,3,Vampire,2725,60,3,4,7,42.9%,8m
12699,3,[混吃混喝]暗夜破坏娃,2725,0,1,0,1,100.0%,1h
12699,3,斩九天,2725,0,1,3,4,25.0%,9m
12699,1,心殇,2725,0,0,1,1,0.0%,53m
12699,1,星光灿烂,2725,0,0,2,2,0.0%,34m
12710,2,YRM,2724,1109,138,136,274,50.4%,12m
12710,3,不气不气不气,2724,749,94,79,173,54.3%,17m
12710,3,[誰与争锋]峥维,2724,536,72,66,138,52.2%,13m
12710,3,多情男,2724,857,35,33,68,51.5%,9m
12710,3,魔术星际,2724,518,19,23,42,45.2%,9m
12710,1,一注,2724,491,18,10,28,64.3%,59m
12710,1,无聊的镜子,2724,463,13,15,28,46.4%,10m
12710,3,scv,2724,215,9,10,19,47.4%,56m
12710,3,额额飞,2724,275,8,9,17,47.1%,1h
12710,3,February,2724,116,3,3,6,50.0%,25m
12710,3,外比巴卜,2724,30,2,0,2,100.0%,17m
12710,3,Prayeon,2724,0,2,3,5,40.0%,34m
12710,3,Alan,2724,40,2,4,6,33.3%,32m
12710,1,傻熹,2724,0,1,0,1,100.0%,1h
12710,3,gravatation,2724,0,1,0,1,100.0%,1h
12710,3,孤城,2724,93,1,2,3,33.3%,9m
12710,1,GGNeverBack,2724,0,0,1,1,0.0%,33m
12710,1,[打招呼的方式]椛媊蚏圷,2724,0,0,1,1,0.0%,1h
12710,1,舞曲歌颂者,2724,0,0,1,1,0.0%,28m
12710,3,江户川,2724,0,0,3,3,0.0%,15m
12710,2,[亚丝娜大白腿]结城明日奈,2724,0,0,13,13,0.0%,28m
12731,3,barkcat,2723,190,24,10,34,70.6%,8m
12731,2,IIIIIIIIIII,2723,180,7,9,16,43.8%,28m
12731,1,clpcp,2723,48,5,5,10,50.0%,1h
12731,1,westpg,2723,142,3,4,7,42.9%,5m
12731,3,乐山孙一峰,2723,92,3,8,11,27.3%,38m
12731,1,[桃园结义]逆鳞,2723,0,1,0,1,100.0%,43m
12731,1,哈哈哈哈哈哈哈,2723,0,1,0,1,100.0%,13m
12731,1,花克,2723,36,1,4,5,20.0%,34m
12731,1,Bxianshen,2723,0,0,1,1,0.0%,58m
12731,1,[埃蒙调教团]越影千年,2723,0,0,2,2,0.0%,1h
12731,1,[孙一峰小迷妹]不敢晚上上厕所,2723,0,0,2,2,0.0%,43m
12731,3,Favor,2723,0,0,3,3,0.0%,18m
12743,1,SBisDavie,2722,648,216,219,435,49.7%,19m
12743,2,[暴雪三十二隊]悄悄点否折磨队友,2722,857,148,122,270,54.8%,15m
12743,3,Icesprit,2722,402,46,45,91,50.5%,26m
12743,2,Leonzzz,2722,682,35,36,71,49.3%,34m
12743,2,james,2722,712,24,30,54,44.4%,14m
12743,3,可怜无助弱小菜鸡,2722,399,18,16,34,52.9%,33m
12743,1,哈喽卖地罚款,2722,327,13,13,26,50.0%,36m
12743,3,毛毛虫大魔王,2722,234,8,13,21,38.1%,3m
12743,3,[闲散人员]烟消云散,2722,182,6,11,17,35.3%,18m
12743,1,[白银联盟]笨拙,2722,138,5,2,7,71.4%,1h
12743,2,一梦入泡,2722,92,5,5,10,50.0%,1h
12743,1,smile,2722,148,4,3,7,57.1%,46m
12743,1,limitations,2722,74,3,3,6,50.0%,1h
12743,2,竹男,2722,95,3,4,7,42.9%,37m
12743,1,[星际一条心]lmy,2722,70,2,1,3,66.7%,1h
12743,3,lumingfei,2722,0,2,2,4,50.0%,1h
12743,3,明日之后,2722,0,2,3,5,40.0%,1h
12743,1,wingswind,2722,0,1,0,1,100.0%,1h
12743,1,asdsa,2722,0,1,0,1,100.0%,36m
12743,3,MeAque,2722,0,1,0,1,100.0%,57m
12743,3,[龙族战队]专属我用,2722,0,0,1,1,0.0%,1h
12743,1,Ooplus,2722,0,0,1,1,0.0%,28m
12765,2,忠犬洪七公,2721,1248,86,83,169,50.9%,22m
12765,3,[慢手e族]吾非空,2721,1387,78,72,150,52.0%,6m
12765,3,笨熊,2721,578,22,26,48,45.8%,13m
12765,1,[X英雄圣域X]张海,2721,506,18,11,29,62.1%,1h
12765,1,[中原]fcheng,2721,276,9,9,18,50.0%,11m
12765,3,守夜人,2721,270,9,16,25,36.0%,37m
12765,3,Never,2721,224,8,5,13,61.5%,25m
12765,1,GameMadmen,2721,254,7,8,15,46.7%,1h
12765,3,爱吃萝卜的老猫,2721,178,5,6,11,45.5%,25m
12765,3,被强煎的蛋,2721,0,4,1,5,80.0%,1h
12765,2,sry,2721,0,4,2,6,66.7%,6m
12765,2,violet,2721,135,4,5,9,44.4%,31m
12765,1,[狼牙盟]ICEY,2721,40,1,1,2,50.0%,59m
12765,1,墨栀,2721,0,1,1,2,50.0%,12m
12765,1,以理服人,2721,88,1,5,6,16.7%,23m
12765,2,大石碎胸口,2721,0,0,1,1,0.0%,1h
12765,1,京东食尸鬼,2721,0,0,1,1,0.0%,13m
12765,1,[再闹卖了你]嗜血伊利丹,2721,0,0,1,1,0.0%,50m
12765,1,皮皮,2721,0,0,2,2,0.0%,43m
12784,3,ACfan,2720,729,570,580,1150,49.6%,32m
12784,1,[LDP]imbzp,2720,1514,180,166,346,52.0%,19m
12784,3,小火,2720,617,52,38,90,57.8%,16m
12784,3,[丨SLT丨]HowToWinZVT,2720,421,25,30,55,45.5%,7m
12784,3,[喵呜喵呜]别打了我头像,2720,685,24,23,47,51.1%,36m
12784,3,快乐星际,2720,262,10,16,26,38.5%,4m
12784,3,Lombert,2720,198,8,9,17,47.1%,33m
12784,1,[极限菜鸟]mountainmoon,2720,210,7,6,13,53.8%,1h
12784,3,[人类防卫阵线]黑白大老鼠,2720,178,6,3,9,66.7%,7m
12784,1,[鲁德欢]小鸡,2720,94,6,5,11,54.5%,40m
12784,1,丶包子,2720,74,3,1,4,75.0%,36m
12784,3,[最后的呼吸]寻风者,2720,0,2,3,5,40.0%,1h
12784,3,月耀,2720,0,2,3,5,40.0%,58m
12784,1,[镜花水月]有妹是穹,2720,0,1,0,1,100.0%,43m
12784,2,sherry,2720,0,1,1,2,50.0%,17m
12784,3,Sakura,2720,0,1,2,3,33.3%,1h
12784,3,[暴雪十二队]科学院,2720,30,1,3,4,25.0%,25m
12784,1,[HW4]FUBUKI,2720,0,0,1,1,0.0%,10m
12784,1,[EGG]LonelyLove,2720,0,0,1,1,0.0%,59m
12784,1,幽冥,2720,0,0,1,1,0.0%,1h
12784,3,[萌新总队]云落秋殇,2720,0,0,1,1,0.0%,1h
12784,1,maru,2720,0,0,2,2,0.0%,1h
12806,2,与孤独相吻,2719,1245,136,139,275,49.5%,18m
12806,2,阿发,2719,783,58,39,97,59.8%,33m
12806,2,[四佑]生命一号,2719,1195,55,60,115,47.8%,33m
12806,3,[基尼太美]柠檬怪兽,2719,968,46,27,73,63.0%,23m
12806,1,沃德吉尔贼长,2719,889,32,25,57,56.1%,1h
12806,3,[鲁德欢]虚空来客,2719,513,22,14,36,61.1%,20m
12806,3,RXanadu,2719,497,21,20,41,51.2%,18m
12806,3,焦作人,2719,453,21,21,42,50.0%,17m
12806,2,冲锋是胜利荣光,2719,288,10,15,25,40.0%,23m
12806,3,莱月桑,2719,154,6,8,14,42.9%,17m
12806,3,Blood,2719,144,5,10,15,33.3%,25m
12806,1,[SCFFFF]zez,2719,205,4,5,9,44.4%,1h
12806,3,莪希醉厉嗐的异虫,2719,42,3,2,5,60.0%,3m
12806,1,祁罪,2719,0,0,1,1,0.0%,26m
12820,3,自爆最刺激了,2718,1510,171,154,325,52.6%,14m
12820,3,Yeezsue,2718,1295,73,62,135,54.1%,20m
12820,1,小心勺勺,2718,767,41,20,61,67.2%,11m
12820,1,人皇,2718,1044,39,36,75,52.0%,10m
12820,2,承影,2718,459,17,20,37,45.9%,3m
12820,3,芙兰朵露斯卡蕾特,2718,278,13,9,22,59.1%,20m
12820,3,澪同学,2718,260,10,10,20,50.0%,1h
12820,1,ACE,2718,310,9,10,19,47.4%,1h
12820,2,爱洋洋,2718,189,7,6,13,53.8%,24m
12820,1,YCFL,2718,137,6,4,10,60.0%,48m
12820,3,风羽翼之,2718,78,6,7,13,46.2%,19m
12820,1,ToT,2718,190,4,5,9,44.4%,29m
12820,1,Kill,2718,0,4,8,12,33.3%,46m
12820,3,芋头在此,2718,96,2,2,4,50.0%,14m
12820,3,几朵,2718,58,2,5,7,28.6%,26m
12820,2,nananewe,2718,0,1,0,1,100.0%,1h
12820,1,[无花也浪漫]闄影时刻,2718,0,1,0,1,100.0%,20m
12837,2,StrayOpossum,2717,1531,195,177,372,52.4%,39m
12837,2,[KPG]Luminous,2717,1501,60,69,129,46.5%,37m
12837,1,magejizerg,2717,486,17,10,27,63.0%,59m
12837,3,[2u]SoulZeuS,2717,324,13,10,23,56.5%,56m
12837,1,[沧月女装协会]Shikar,2717,68,3,2,5,60.0%,46m
12837,2,LuoLe,2717,0,3,4,7,42.9%,37m
12837,1,李逍遥,2717,0,3,5,8,37.5%,1h
12837,2,星心雪,2717,129,2,2,4,50.0%,1h
12837,1,[混元体我女仆]血无琉,2717,76,2,2,4,50.0%,13m
12837,1,[北极光小组]求求你做个人吧,2717,0,1,0,1,100.0%,1h
12837,1,黑色冰激凌,2717,0,1,2,3,33.3%,1h
12837,3,卢本伟,2717,30,1,4,5,20.0%,26m
12837,2,drakedog,2717,30,1,10,11,9.1%,8m
12837,3,我们故事起于星海,2717,0,0,1,1,0.0%,3m
12837,3,[女神惊叹]Lunamiracle,2717,0,0,2,2,0.0%,1h
12852,2,lizhen,2716,1224,58,63,121,47.9%,11m
12852,3,kidnight,2716,1001,43,34,77,55.8%,11m
12852,1,shadow,2716,935,40,29,69,58.0%,29m
12852,3,WON,2716,376,14,12,26,53.8%,38m
12852,1,Ring,2716,430,13,13,26,50.0%,26m
12852,1,她听着他说话,2716,379,11,9,20,55.0%,1h
12852,3,[鸡烈]tossboy,2716,318,11,10,21,52.4%,8m
12852,1,粉红喵喵拳,2716,205,6,2,8,75.0%,46m
12852,1,苍颜轻尘,2716,154,4,0,4,100.0%,1h
12852,1,FallenAngels,2716,178,4,1,5,80.0%,12m
12852,1,[Marry]阿塔尼斯,2716,76,3,1,4,75.0%,13m
12852,3,西木野探姬,2716,0,2,3,5,40.0%,1h
12852,3,小小先生,2716,0,1,4,5,20.0%,8m
12852,1,scared,2716,0,0,1,1,0.0%,13m
12852,3,莽夫,2716,0,0,1,1,0.0%,35m
12867,3,[RKT]Thor,2715,624,87,57,144,60.4%,11m
12867,1,[闪电伍连鞭]smileboy,2715,921,46,29,75,61.3%,1h
12867,1,[五月花]bodliu,2715,694,26,20,46,56.5%,59m
12867,1,稀有金属,2715,182,4,3,7,57.1%,11m
12867,1,君莫笑,2715,38,2,1,3,66.7%,58m
12867,1,城南花已开,2715,0,1,1,2,50.0%,1h
12867,1,青城,2715,38,1,1,2,50.0%,26m
12867,1,[世界大战]方玲霞,2715,30,1,2,3,33.3%,1h
12867,3,ANTIGONE,2715,30,1,5,6,16.7%,26m
12867,3,[NKTJ]AIcup,2715,30,1,5,6,16.7%,2m
12867,3,幻影,2715,0,0,1,1,0.0%,1h
12867,3,[腥基佬男骸]极客大会,2715,0,0,1,1,0.0%,57m
12867,1,gesila,2715,0,0,4,4,0.0%,1h
12880,2,[我方黄金舰队]久久六批,2714,1546,149,132,281,53.0%,19m
12880,2,爱莎公猪,2714,1124,132,132,264,50.0%,33m
12880,2,永夜君王,2714,1334,59,62,121,48.8%,34m
12880,3,魔掼光杀炮,2714,992,41,36,77,53.2%,6m
12880,2,Xel,2714,414,14,25,39,35.9%,13m
12880,1,芝加哥打字员,2714,208,7,4,11,63.6%,1h
12880,1,[YINGJI]HyperRich,2714,200,7,5,12,58.3%,1h
12880,1,firstblood,2714,186,6,4,10,60.0%,1h
12880,1,[香香香奈儿]badwoman,2714,188,5,1,6,83.3%,34m
12880,2,王籽,2714,0,4,2,6,66.7%,53m
12880,3,黄帅帅先生,2714,95,3,0,3,100.0%,19m
12880,2,enoch,2714,0,3,3,6,50.0%,1h
12880,1,[男人该干男人]该干的事,2714,34,2,1,3,66.7%,38m
12880,1,哎辣油,2714,74,2,5,7,28.6%,10m
12880,1,战丶狼,2714,0,0,1,1,0.0%,23m
12880,1,糖果盒,2714,0,0,1,1,0.0%,1h
12880,3,GGGxxx,2714,0,0,1,1,0.0%,3m
12897,3,苍玄,2713,1267,54,43,97,55.7%,13m
12897,3,IIIIIIIIIIII,2713,522,47,45,92,51.1%,18m
12897,1,[埃辛诺斯战刃]likeddd,2713,779,34,20,54,63.0%,23m
12897,3,断章,2713,382,14,13,27,51.9%,13m
12897,2,天下耀莱,2713,342,11,16,27,40.7%,12m
12897,3,[慢手e族]过来我给你说,2713,336,11,17,28,39.3%,10m
12897,1,爱你么么哒,2713,182,7,3,10,70.0%,20m
12897,3,Ezio,2713,180,5,7,12,41.7%,34m
12897,1,[XYG]越打越菜,2713,152,4,6,10,40.0%,2m
12897,3,晓龍,2713,42,3,4,7,42.9%,60m
12897,1,[雾雨魔法森林]Eternity,2713,40,2,0,2,100.0%,34m
12897,3,Alexius,2713,0,2,3,5,40.0%,53m
12897,1,银色闪光亚丝娜,2713,0,1,0,1,100.0%,2m
12897,1,[DMRe]rushcrazy,2713,0,1,0,1,100.0%,58m
12897,3,[tttyyy]蝴蝶现象,2713,0,1,0,1,100.0%,1h
12897,1,alkfhlk,2713,40,1,2,3,33.3%,1h
12897,1,[譏颰]Suker,2713,0,0,1,1,0.0%,11m
12897,3,[多瑙河之珠]游城,2713,0,0,1,1,0.0%,41m
12915,3,奋斗不止的老张,2712,696,31,29,60,51.7%,17m
12915,3,[逆袭]死忠守护者,2712,489,17,18,35,48.6%,25m
12915,1,老左二货,2712,288,8,6,14,57.1%,12m
12915,2,倾红颜丶笑一心,2712,216,7,6,13,53.8%,1h
12915,3,WYP,2712,144,6,11,17,35.3%,40m
12915,1,[EA丶F天启]人格分裂先生,2712,186,5,8,13,38.5%,44m
12915,3,[C13063]Story,2712,0,2,3,5,40.0%,57m
12915,1,愿雨,2712,0,1,1,2,50.0%,1h
12915,1,李云龙,2712,0,1,1,2,50.0%,18m
12915,1,[蒙蔽梦游团]四川大学第一跪躺,2712,38,1,2,3,33.3%,34m
12915,1,浅岚色,2712,0,1,2,3,33.3%,11m
12915,1,[我三玖]天下第一,2712,40,1,3,4,25.0%,58m
12915,1,scv,2712,0,0,1,1,0.0%,19m
12928,3,[混元形意拳]along,2711,403,17,25,42,40.5%,14m
12928,3,ragnarok,2711,207,8,10,18,44.4%,1h
12928,2,[Maiden]幺秀,2711,248,8,19,27,29.6%,22m
12928,3,howmuchsoso,2711,152,5,8,13,38.5%,17m
12928,1,无敌的大飞机,2711,96,4,5,9,44.4%,11m
12928,3,妹妹胖,2711,97,3,3,6,50.0%,11m
12928,1,DKrose,2711,110,3,3,6,50.0%,34m
12928,2,Cherrycoal,2711,0,3,3,6,50.0%,1h
12928,1,[大主教的兄弟]Laowhite,2711,40,2,1,3,66.7%,20m
12928,3,紫檀箭,2711,0,2,3,5,40.0%,34m
12928,1,迷茫的收割者,2711,96,2,7,9,22.2%,7m
12928,1,Sumail,2711,0,1,0,1,100.0%,1h
12928,1,无畏之刃,2711,0,1,0,1,100.0%,28m
12928,1,[亚X]古月兴,2711,0,1,1,2,50.0%,48m
12928,1,LAMARTT,2711,0,1,2,3,33.3%,1h
12928,1,[Shawk]一六鸽只想恰饱饭,2711,93,1,7,8,12.5%,25m
12928,3,乌瑟尔,2711,0,0,1,1,0.0%,1h
12945,3,[你选的嘛偶像]武君罗喉,2710,1128,60,60,120,50.0%,20m
12945,3,骚到死,2710,621,47,49,96,49.0%,9m
12945,1,moon,2710,805,46,34,80,57.5%,6m
12945,1,麻瓜,2710,815,28,23,51,54.9%,12m
12945,1,llllllllllll,2710,554,22,13,35,62.9%,1h
12945,2,[秋毫]种花家,2710,487,20,20,40,50.0%,33m
12945,3,Maru,2710,268,11,9,20,55.0%,1h
12945,1,[月野兔]啊啊啊的小仙女,2710,214,8,12,20,40.0%,43m
12945,1,瀮雨,2710,32,5,2,7,71.4%,23m
12945,1,[曾经一群兔兔]古楚小狼,2710,209,5,4,9,55.6%,10m
12945,1,happyxi,2710,182,5,6,11,45.5%,1h
12945,1,Lelouch,2710,171,5,7,12,41.7%,43m
12945,3,复制品,2710,0,4,2,6,66.7%,1h
12945,1,[逐梦之影]山顶上听歌,2710,82,3,3,6,50.0%,25m
12945,2,仰望星辰,2710,93,2,0,2,100.0%,1h
12945,1,IIIIIIIIIIII,2710,0,1,1,2,50.0%,59m
12945,1,永远单推星街彗星,2710,38,1,1,2,50.0%,48m
12945,1,TorresTao,2710,44,1,3,4,25.0%,27m
12945,3,萝卜慝,2710,0,1,3,4,25.0%,13m
12945,2,暴兵神器,2710,0,1,6,7,14.3%,37m
12965,3,[星际一号]Ranger,2709,1142,42,51,93,45.2%,36m
12965,1,[疯月]缘生梦,2709,860,40,26,66,60.6%,37m
12965,3,[ToHo]UncleH,2709,724,32,25,57,56.1%,19m
12965,1,你含含我,2709,822,29,29,58,50.0%,36m
12965,3,LIIIIIIIIIPN,2709,578,24,27,51,47.1%,13m
12965,1,永恒大空,2709,276,14,8,22,63.6%,27m
12965,1,花丶酸菜,2709,193,7,1,8,87.5%,25m
12965,1,seacooky,2709,138,5,4,9,55.6%,48m
12965,1,WhiteLex,2709,162,5,5,10,50.0%,1h
12965,2,人叫我猴哥,2709,0,4,2,6,66.7%,1h
12965,1,nightblack,2709,82,3,3,6,50.0%,2m
12965,3,阿毛耍星际,2709,155,3,6,9,33.3%,49m
12965,2,[过山车来袭]魔界人一萌道,2709,62,3,10,13,23.1%,24m
12965,1,wudixiaoyu,2709,38,2,1,3,66.7%,7m
12965,2,决战青铜王,2709,48,2,2,4,50.0%,1h
12965,3,[ghsy]肉干,2709,30,2,3,5,40.0%,23m
12965,1,进弟表,2709,45,1,2,3,33.3%,1h
12965,1,HeiTaoGG,2709,0,0,1,1,0.0%,1h
12965,2,[混元极意星际]我说了算,2709,0,0,1,1,0.0%,1h
12965,1,岚玄,2709,0,0,2,2,0.0%,10m
12985,1,真夏夜的野兽先辈,2708,774,41,29,70,58.6%,6m
12985,1,回来,2708,645,23,17,40,57.5%,29m
12985,1,Rainbow,2708,564,17,19,36,47.2%,6m
12985,3,[91二五仔]轰鸣之翼,2708,331,12,10,22,54.5%,14m
12985,1,FINDAIR,2708,384,12,13,25,48.0%,1h
12985,3,[随意从心]离坤,2708,226,8,6,14,57.1%,26m
12985,3,[Aleria]微笑深呼吸,2708,179,7,9,16,43.8%,38m
12985,3,[奥意]sXMantoU,2708,234,6,14,20,30.0%,9m
12985,1,[浮世清欢]Rollyoo,2708,209,4,9,13,30.8%,48m
12985,3,[北有吾王2队]Glp,2708,0,3,2,5,60.0%,1h
12985,1,[在下萌新一只]永恒即逝,2708,70,3,4,7,42.9%,36m
12985,1,[雄鹰]LUPINIII,2708,0,3,4,7,42.9%,1h
12985,3,博博文,2708,58,3,8,11,27.3%,8m
12985,2,希尔瓦娜斯,2708,44,2,2,4,50.0%,1h
12985,1,驱逐船,2708,0,1,0,1,100.0%,2m
12985,1,[无情沛块]和泉丨纱雾,2708,0,0,1,1,0.0%,20m
12985,2,[SK]BurNIng,2708,0,0,2,2,0.0%,21m
13002,3,[为了宇宙和平]gondor,2707,1527,174,161,335,51.9%,19m
13002,1,[媛气少女]不改一次浪费了,2707,931,86,70,156,55.1%,9m
13002,3,[皮断腿]孝悌,2707,1492,67,64,131,51.1%,34m
13002,2,[老班干]灰太郎,2707,577,43,38,81,53.1%,23m
13002,3,[SC2近卫军]青铜骑士,2707,1120,40,47,87,46.0%,7m
13002,3,妖灬亦丶仙,2707,610,25,24,49,51.0%,19m
13002,1,我就是个控,2707,301,9,18,27,33.3%,59m
13002,3,小七,2707,0,3,2,5,60.0%,1h
13002,3,雨人的抽屉,2707,0,3,3,6,50.0%,1h
13002,3,骨贰,2707,48,3,4,7,42.9%,3m
13002,1,阿道夫叔叔,2707,42,2,1,3,66.7%,1h
13002,3,天雅,2707,0,2,3,5,40.0%,34m
13002,1,MagicLAN,2707,0,1,0,1,100.0%,13m
13002,1,[Rash]joy,2707,42,1,2,3,33.3%,1h
13002,1,殇逝琉璃,2707,0,0,3,3,0.0%,5m
13017,3,poisonkiss,2706,1221,107,109,216,49.5%,26m
13017,2,丶冰丨,2706,1442,75,66,141,53.2%,47m
13017,3,[BGA]BiGAcO,2706,836,31,31,62,50.0%,6m
13017,3,[ACG系]TheGrist,2706,673,28,19,47,59.6%,39m
13017,1,[凤凰之门]蒜仔,2706,390,15,9,24,62.5%,29m
13017,1,[教父遇刺]innovat,2706,488,15,18,33,45.5%,1h
13017,3,freedom,2706,38,5,2,7,71.4%,13m
13017,3,MCzz,2706,123,4,1,5,80.0%,55m
13017,2,内科大小学生,2706,0,3,1,4,75.0%,37m
13017,1,FROST,2706,76,3,2,5,60.0%,34m
13017,3,[妹子嘿嘿嘿]小天之影,2706,86,3,7,10,30.0%,34m
13017,2,[狂野战队]苏雨凝,2706,0,1,0,1,100.0%,1h
13017,1,吉凯,2706,0,0,1,1,0.0%,1h
13017,1,water,2706,0,0,1,1,0.0%,59m
13017,2,ZiHao,2706,0,0,1,1,0.0%,1h
13032,3,superchen,2705,1559,285,285,570,50.0%,23m
13032,1,[浙江大学战队]DAAD,2705,1665,112,107,219,51.1%,1h
13032,3,[萌的一笔]惑星指揮官,2705,1180,87,87,174,50.0%,23m
13032,1,只是一只猫,2705,1323,54,39,93,58.1%,23m
13032,2,raymond,2705,810,28,36,64,43.8%,7m
13032,3,Yearn,2705,699,26,29,55,47.3%,10m
13032,2,拉斐尔门前的树,2705,449,19,18,37,51.4%,14m
13032,1,你才是猪猪呢,2705,309,11,9,20,55.0%,58m
13032,3,电脑玩家,2705,240,9,11,20,45.0%,6m
13032,1,逆袭,2705,274,8,9,17,47.1%,1h
13032,1,加特林哒哒哒,2705,46,4,6,10,40.0%,12m
13032,3,Curtain,2705,58,3,7,10,30.0%,20m
13032,3,沙雕之人,2705,97,2,0,2,100.0%,1h
13032,1,[霸气军团]Apocalypse,2705,0,1,0,1,100.0%,7m
13032,1,serral,2705,0,1,2,3,33.3%,13m
13032,1,[聚变打鸡就绪]歪比巴卜,2705,96,1,2,3,33.3%,1h
13032,3,刺客之心,2705,0,1,3,4,25.0%,8m
13032,1,人族机械,2705,0,0,1,1,0.0%,10m
13032,1,wcjsdb,2705,0,0,1,1,0.0%,1h
13032,1,[Encore]星际娜,2705,0,0,2,2,0.0%,36m
13032,2,赫利肯之冬,2705,0,0,2,2,0.0%,1h
13053,2,[旺旺战士]michaelgbw,2704,1116,92,90,182,50.5%,31m
13053,3,Biut,2704,537,42,44,86,48.8%,6m
13053,3,种族狂热,2704,306,9,11,20,45.0%,40m
13053,1,噩梦使者,2704,230,8,10,18,44.4%,1h
13053,3,范真人,2704,97,5,1,6,83.3%,1h
13053,1,免费体验真给力,2704,38,2,1,3,66.7%,20m
13053,3,Blackangel,2704,0,2,3,5,40.0%,1h
13053,3,推倒尐怪兽,2704,0,2,3,5,40.0%,50m
13053,1,dddd,2704,36,1,1,2,50.0%,1h
13053,1,[柚刀社总部]ace,2704,0,1,2,3,33.3%,22m
13053,1,[k121]john,2704,0,0,1,1,0.0%,46m
13053,1,憨色是小天使,2704,0,0,2,2,0.0%,48m
13053,1,[快乐白给]艺术就是派大星,2704,0,0,2,2,0.0%,1h
13066,3,蹦霸尔波,2703,673,26,24,50,52.0%,13m
13066,1,阿斯达,2703,477,21,13,34,61.8%,1h
13066,3,[傲世丨听雨轩]夜雨秋寒,2703,72,3,5,8,37.5%,24m
13066,2,[TAPC]我们快要完蛋啦,2703,93,2,1,3,66.7%,1h
13066,1,疤瘌味的桃子,2703,0,0,1,1,0.0%,36m
13066,1,[拉稀]Yellow,2703,0,0,3,3,0.0%,1h
13072,2,[禽禽禽]大帝丶屠鸡虐狗,2702,1520,86,72,158,54.4%,3m
13072,2,[二里桥猎魔人]WaneAncient,2702,1133,70,66,136,51.5%,15m
13072,3,IIIIIIIIIII,2702,643,22,25,47,46.8%,6m
13072,1,天涯纵横,2702,350,11,11,22,50.0%,29m
13072,1,pestak,2702,162,5,2,7,71.4%,23m
13072,1,[NLD]赤羽信之介,2702,144,5,5,10,50.0%,5m
13072,3,Kuroi,2702,97,4,6,10,40.0%,1h
13072,3,肉肉肉,2702,38,2,3,5,40.0%,55m
13072,3,地球联邦,2702,0,1,5,6,16.7%,1h
13072,1,[只会666]nobble,2702,0,0,1,1,0.0%,1h
13072,1,[BGD]BLove,2702,0,0,1,1,0.0%,13m
13072,2,[蕾丝花边]艾弗盘的秘密,2702,0,0,2,2,0.0%,1h
13084,3,星星不会玩,2701,1364,50,54,104,48.1%,25m
13084,1,[DJTCG]BEILIDADI,2701,835,32,21,53,60.4%,1h
13084,3,千年德鲁伊,2701,681,28,28,56,50.0%,23m
13084,1,罗十一,2701,780,25,39,64,39.1%,15m
13084,1,斩月无踪,2701,302,13,6,19,68.4%,1h
13084,3,[探索]邪恶的大狼,2701,317,13,7,20,65.0%,5m
13084,1,勾流,2701,258,9,6,15,60.0%,34m
13084,1,南云的主人,2701,194,8,7,15,53.3%,1h
13084,3,韩厉枫,2701,97,5,6,11,45.5%,60m
13084,3,白给真善美,2701,86,3,7,10,30.0%,18m
13084,1,东南信风,2701,34,2,0,2,100.0%,12m
13084,3,mvpjames,2701,0,2,3,5,40.0%,32m
13084,2,Forever,2701,0,1,0,1,100.0%,5m
13084,1,[柒堇年华]远汀,2701,0,1,1,2,50.0%,1h
13084,1,Sheringham,2701,0,1,1,2,50.0%,5m
13084,3,[董魔王制霸军]人傻地多陶太守,2701,0,1,4,5,20.0%,14m
13100,3,樱岛麻衣,2700,1276,53,47,100,53.0%,33m
13100,3,[Dspcs]Trisomy,2700,253,31,22,53,58.5%,18m
13100,3,困特,2700,529,20,20,40,50.0%,33m
13100,1,[混元形意]Fighter,2700,512,17,15,32,53.1%,23m
13100,1,长岛冰茶,2700,402,14,9,23,60.9%,1h
13100,1,插眼踢裆石灰粉,2700,242,9,3,12,75.0%,25m
13100,1,magicka,2700,96,4,5,9,44.4%,1h
13100,1,NTOPLL,2700,48,4,6,10,40.0%,1h
13100,1,leeannsoul,2700,90,1,1,2,50.0%,5m
13109,1,无敌赫赫,2699,858,72,69,141,51.1%,1h
13109,1,austin,2699,1369,56,44,100,56.0%,58m
13109,1,[贰伍仔集中营]横自在,2699,401,34,24,58,58.6%,35m
13109,2,[sakiwa]princew,2699,398,13,24,37,35.1%,4m
13109,1,[五月花]养朱刘老根,2699,236,8,8,16,50.0%,14m
13109,1,[菜有菜的道理]酒辛,2699,259,6,8,14,42.9%,33m
13109,2,[老司机翻船]wouldhelp,2699,90,5,6,11,45.5%,53m
13109,1,[DMR]冬小梦,2699,194,5,7,12,41.7%,36m
13109,2,[琴之森]凉城,2699,91,3,4,7,42.9%,37m
13109,3,[龙族]SAnni,2699,0,2,3,5,40.0%,24m
13109,3,sir,2699,0,2,3,5,40.0%,1h
13109,1,爱笑的大哥哥,2699,144,2,5,7,28.6%,1h
13109,2,[单人模拟战]简单电脑,2699,0,1,0,1,100.0%,49m
13109,3,国民小骄傲,2699,0,1,0,1,100.0%,1h
13109,1,星际领主,2699,0,0,1,1,0.0%,48m
13109,1,杨洪泽的父亲,2699,0,0,2,2,0.0%,1h
13109,1,凌虚子,2699,0,0,3,3,0.0%,48m
13109,1,段筱侃,2699,0,0,5,5,0.0%,53m
13127,3,shadow,2698,1336,68,68,136,50.0%,39m
13127,1,[菜有菜的道理]这游戏就离谱,2698,679,52,36,88,59.1%,1h
13127,2,[SiW]山的哩,2698,1146,44,54,98,44.9%,37m
13127,3,[菜有菜的道理]屠农啦,2698,418,22,22,44,50.0%,18m
13127,3,暗黑之翼,2698,431,20,21,41,48.8%,19m
13127,3,扫地僧红酒,2698,186,14,17,31,45.2%,4m
13127,2,Delruce,2698,210,8,10,18,44.4%,37m
13127,2,求一把风剑,2698,102,8,16,24,33.3%,31m
13127,1,甄落,2698,138,4,2,6,66.7%,1h
13127,2,TiAmo,2698,0,4,7,11,36.4%,1h
13127,1,mind,2698,123,3,0,3,100.0%,44m
13127,2,[仙女的云朵喵]樱花呀,2698,126,3,1,4,75.0%,1h
13127,1,灰暗,2698,38,2,1,3,66.7%,1h
13127,3,不几道叫什么伐,2698,0,2,1,3,66.7%,1h
13127,1,提线,2698,0,1,0,1,100.0%,59m
13127,2,[我错了ya]我还敢,2698,0,1,0,1,100.0%,1h
13127,1,xiao,2698,0,1,1,2,50.0%,1h
13127,1,史上可能最强人类,2698,0,1,3,4,25.0%,49m
13127,1,Genshin,2698,0,0,1,1,0.0%,6m
13127,1,鸽帝熙离,2698,0,0,1,1,0.0%,10m
13147,1,一拳江南,2697,1534,83,81,164,50.6%,36m
13147,3,姑娘你别摸了,2697,689,55,50,105,52.4%,20m
13147,3,月之泪,2697,637,22,24,46,47.8%,18m
13147,3,Azealyang,2697,570,21,24,45,46.7%,15m
13147,2,自废双蛋,2697,547,21,32,53,39.6%,39m
13147,1,gggg,2697,163,6,5,11,54.5%,1h
13147,1,bkb,2697,130,6,7,13,46.2%,1h
13147,1,姣姣妹,2697,119,5,6,11,45.5%,1h
13147,1,[ZTSCAP]JOKE,2697,40,2,1,3,66.7%,1h
13147,1,染柒,2697,62,2,2,4,50.0%,59m
13147,3,泡芙小姐,2697,76,2,14,16,12.5%,1h
13147,1,[刺蛇互助社团]ZYS,2697,0,1,0,1,100.0%,29m
13147,3,[基王之王]MoMingYiS,2697,0,0,1,1,0.0%,57m
13147,1,好快的刀,2697,0,0,1,1,0.0%,29m
13161,1,冠位大酋长,2696,406,11,10,21,52.4%,29m
13161,1,阿斯塔特修士,2696,318,9,14,23,39.1%,29m
13161,1,lovelypea,2696,145,7,6,13,53.8%,12m
13161,3,阿豆,2696,138,4,1,5,80.0%,11m
13161,1,XRay,2696,0,1,0,1,100.0%,29m
13161,1,azen,2696,0,1,0,1,100.0%,13m
13161,1,七叔贼啦菜,2696,0,1,2,3,33.3%,29m
13161,1,BOD,2696,0,0,1,1,0.0%,27m
13161,1,[麋鹿迷路]IIIIIIIIIIII,2696,0,0,3,3,0.0%,1h
13170,3,无畏,2695,766,32,30,62,51.6%,15m
13170,3,[艾尔之巅]飞龙,2695,239,10,6,16,62.5%,19m
13170,1,敢采于部,2695,255,6,5,11,54.5%,1h
13170,3,爱刷牙的侦探,2695,160,4,6,10,40.0%,12m
13170,1,无功无过,2695,0,1,0,1,100.0%,44m
13170,1,艾泽拉斯,2695,0,1,0,1,100.0%,23m
13170,1,qweasdqwe,2695,38,1,1,2,50.0%,1h
13170,3,[萌物狩猎者]溯世老妖,2695,0,0,1,1,0.0%,57m
13170,1,[洛水天依]Scarlett,2695,0,0,1,1,0.0%,48m
13170,1,九尾,2695,0,0,1,1,0.0%,1h
13180,3,李艾文,2694,1076,111,107,218,50.9%,38m
13180,1,海叶枫,2694,811,35,20,55,63.6%,1h
13180,1,Waaagh,2694,303,13,14,27,48.1%,13m
13180,1,[瘾大眼瞎]机械小鱼,2694,192,6,7,13,46.2%,1h
13180,3,菜逼,2694,0,5,0,5,100.0%,1h
13180,1,DegenerateKN,2694,134,4,3,7,57.1%,5m
13180,3,[黎明航向]Ozine,2694,0,3,4,7,42.9%,9m
13180,1,梦回京华,2694,70,3,5,8,37.5%,10m
13180,3,[菜有菜的道理]chara,2694,116,3,9,12,25.0%,19m
13180,1,伟大的紫炎,2694,95,2,0,2,100.0%,2m
13180,3,无聊的恐惧之神,2694,0,2,3,5,40.0%,1h
13180,1,apostle,2694,0,1,0,1,100.0%,25m
13180,1,NjxxDT,2694,0,1,2,3,33.3%,13m
13193,1,小无敌,2693,1645,184,175,359,51.3%,1h
13193,1,寒影火舞,2693,512,21,19,40,52.5%,7m
13193,1,玩星际你快乐吗,2693,387,15,8,23,65.2%,10m
13193,3,[X英雄圣域X]诸星,2693,292,11,13,24,45.8%,14m
13193,1,[专业de团队]泰伦永远在白给,2693,339,10,7,17,58.8%,35m
13193,3,[哀伤]ArdynSama,2693,264,9,8,17,52.9%,26m
13193,1,BarCode,2693,160,7,0,7,100.0%,34m
13193,1,Sunnyboy,2693,238,7,4,11,63.6%,1h
13193,2,Rstars,2693,237,7,7,14,50.0%,59m
13193,1,夏特,2693,274,7,18,25,28.0%,1h
13193,1,专打外地狗,2693,0,4,4,8,50.0%,1h
13193,1,你阿妈炸了,2693,148,4,5,9,44.4%,6m
13193,3,moran,2693,0,3,2,5,60.0%,57m
13193,1,骷髅乞丐,2693,36,1,3,4,25.0%,10m
13193,1,HUIHUI,2693,34,1,3,4,25.0%,11m
13193,1,恶趣味,2693,38,1,4,5,20.0%,1h
13193,2,[洁白之巅]BATTLRENET,2693,0,0,1,1,0.0%,15m
13193,1,人菜瘾还大,2693,0,0,1,1,0.0%,1h
13193,1,吃豆子的鱼,2693,0,0,1,1,0.0%,1h
13212,2,[CPT]绝望亚伦,2692,1395,86,80,166,51.8%,37m
13212,3,alexu,2692,776,38,41,79,48.1%,26m
13212,3,春水向东流,2692,887,34,37,71,47.9%,6m
13212,3,我要起个好名字,2692,489,22,23,45,48.9%,25m
13212,1,[XCode]夜行书生,2692,469,16,14,30,53.3%,36m
13212,1,感染肉团,2692,180,7,3,10,70.0%,59m
13212,1,功夫,2692,144,4,1,5,80.0%,58m
13212,1,[华溪岛]极光,2692,106,4,2,6,66.7%,1h
13212,3,谐星要塞,2692,145,4,2,6,66.7%,1h
13212,2,[世界树]雾雨星月,2692,0,3,4,7,42.9%,1h
13212,3,[Vans]懦夫救星,2692,0,1,0,1,100.0%,1h
13212,1,无言丶,2692,0,1,1,2,50.0%,5m
13212,2,[看星星咯]梦露,2692,0,1,1,2,50.0%,1h
13212,1,YesnO,2692,0,1,3,4,25.0%,14m
13226,1,[KNZW]llllllllllll,2691,1250,55,53,108,50.9%,10m
13226,1,[FKA]FAONLE,2691,587,20,16,36,55.6%,59m
13226,1,[旺旺战士]大意没有闪,2691,586,20,18,38,52.6%,1h
13226,2,[孤傲就完事]还是败给了时间,2691,365,13,14,27,48.1%,14m
13226,3,[B1acK]虚空恐惧,2691,311,12,11,23,52.2%,26m
13226,1,我玩神族只搞后期,2691,48,5,6,11,45.5%,1h
13226,1,[我没有女朋友]氵丶骚猪,2691,118,3,4,7,42.9%,35m
13226,1,拉啊啦啦啦啦,2691,74,2,2,4,50.0%,1h
13226,2,nitai,2691,0,1,0,1,100.0%,60m
13226,1,[一个军的兵力]满李先生,2691,89,1,1,2,50.0%,34m
13226,1,[超实验级的]magicmarine,2691,0,1,3,4,25.0%,43m
13226,3,[清华野大学]吴一凡,2691,0,0,1,1,0.0%,13m
13238,1,眉如远山,2690,1651,88,84,172,51.2%,1h
13238,1,handsome,2690,1558,82,74,156,52.6%,29m
13238,3,IIIIIIIIIIII,2690,669,60,57,117,51.3%,4m
13238,3,麻子祖师爷丶,2690,644,24,27,51,47.1%,25m
13238,3,wero,2690,692,23,32,55,41.8%,6m
13238,1,[最菜战队]Zerg,2690,400,17,7,24,70.8%,38m
13238,2,要煤的叉叉,2690,404,17,20,37,45.9%,13m
13238,1,[有组织无纪录]sdrcf,2690,405,14,8,22,63.6%,1h
13238,1,BenimaruCC,2690,321,12,14,26,46.2%,38m
13238,1,[MS13战术]citybaboon,2690,215,10,12,22,45.5%,1h
13238,1,明镜止水,2690,205,7,4,11,63.6%,1h
13238,2,佳期如梦,2690,197,7,5,12,58.3%,1h
13238,3,[妹子万岁]冥心,2690,120,5,5,10,50.0%,1h
13238,3,八九年生人,2690,147,5,6,11,45.5%,34m
13238,2,零度,2690,0,3,3,6,50.0%,21m
13238,1,[红萌馆]毒奶黄旭东丶,2690,113,3,4,7,42.9%,7m
13238,2,[Gj]风花雪月,2690,138,2,2,4,50.0%,1h
13238,3,Forjunjun,2690,0,2,3,5,40.0%,18m
13238,3,机智如我么么哒,2690,0,2,3,5,40.0%,1h
13238,1,DXK,2690,108,2,5,7,28.6%,12m
13238,1,mybookgood,2690,0,0,1,1,0.0%,2m
13259,3,泽拉图,2689,674,75,69,144,52.1%,6m
13259,1,Will,2689,352,14,13,27,51.9%,25m
13259,3,QAQ,2689,142,4,2,6,66.7%,38m
13259,1,Sleep,2689,114,4,4,8,50.0%,1h
13259,1,慢走,2689,131,3,1,4,75.0%,59m
13259,1,TDCheng,2689,0,1,0,1,100.0%,35m
13259,3,[圣堂黑丝武士]ASKBOOS,2689,0,0,1,1,0.0%,9m
13259,3,MrWU,2689,0,0,2,2,0.0%,1h
13267,1,新手,2688,316,10,11,21,47.6%,27m
13267,1,[你已经死啦]氯丙嗪,2688,158,6,4,10,60.0%,1h
13267,1,我就是百度,2688,162,6,7,13,46.2%,1h
13267,3,癫疯时刻,2688,151,6,8,14,42.9%,28m
13267,1,流光陷沙,2688,158,5,7,12,41.7%,14m
13267,3,残刀魄藏念韶华,2688,0,4,1,5,80.0%,1h
13267,1,[单人模拟战]沉默之风暴,2688,160,4,2,6,66.7%,1h
13267,2,venus,2688,137,4,5,9,44.4%,5m
13267,2,匿冷笑月,2688,97,3,5,8,37.5%,1h
13267,2,Denis,2688,0,1,0,1,100.0%,17m
13277,1,GSniper,2687,1654,214,188,402,53.2%,36m
13277,3,fgfdfd,2687,197,59,63,122,48.4%,18m
13277,1,五月,2687,573,21,17,38,55.3%,11m
13277,1,Destroy,2687,174,6,4,10,60.0%,1h
13277,1,Althemist,2687,156,6,5,11,54.5%,59m
13277,2,魔法潇潇雨,2687,163,6,6,12,50.0%,60m
13277,2,南狐,2687,146,5,6,11,45.5%,28m
13277,1,强者的苦痛,2687,178,4,3,7,57.1%,53m
13277,3,FLY,2687,110,3,3,6,50.0%,34m
13277,2,[虚空守望]一只新萌啊,2687,42,3,6,9,33.3%,21m
13277,1,小猪乔治,2687,0,2,3,5,40.0%,10m
13277,3,Anystar,2687,0,2,3,5,40.0%,1h
13277,1,[很有婧神]核糖不好吃,2687,0,1,0,1,100.0%,13m
13277,3,jimv,2687,0,1,4,5,20.0%,53m
13277,1,[谐星Xie]EndLessPower,2687,0,0,1,1,0.0%,10m
13277,1,休眠火山,2687,0,0,2,2,0.0%,11m
13293,2,[二五仔联盟]innovation,2686,1571,234,236,470,49.8%,12m
13293,1,无爱式回忆,2686,727,28,27,55,50.9%,1h
13293,3,[loveMM]king,2686,504,18,26,44,40.9%,11m
13293,3,超亚煞极,2686,378,17,13,30,56.7%,19m
13293,3,ABCEH,2686,390,14,16,30,46.7%,36m
13293,3,健次郎,2686,350,13,16,29,44.8%,3m
13293,2,[菜有菜的道理]油漆加糖,2686,296,11,1,12,91.7%,24m
13293,1,SHISEN,2686,168,6,6,12,50.0%,25m
13293,1,[SFTRA3]舔我高跟鞋,2686,135,5,1,6,83.3%,1h
13293,2,奈亚拉托提普,2686,121,4,0,4,100.0%,1h
13293,2,[Shawk]雪落南花,2686,152,4,2,6,66.7%,1h
13293,3,shengzhan,2686,97,4,2,6,66.7%,32m
13293,2,虫群,2686,0,3,4,7,42.9%,21m
13293,1,世界中枢,2686,58,3,5,8,37.5%,27m
13293,1,一一一一,2686,66,2,4,6,33.3%,1h
13293,1,[RwGami]墨守,2686,54,2,4,6,33.3%,1h
13293,1,[钢铁远征军]Falsec,2686,0,1,0,1,100.0%,1h
13293,2,[SC日常]李知恩,2686,0,1,0,1,100.0%,1h
13293,1,[队花探姬]风渡人影剑渡天,2686,0,1,1,2,50.0%,38m
13293,1,真的好玩么,2686,0,1,2,3,33.3%,11m
13293,1,Ardo,2686,0,0,2,2,0.0%,1h
13314,3,啊啊啊啊啊岚,2685,410,16,17,33,48.5%,26m
13314,3,[ELC]Dalaran,2685,313,15,37,52,28.8%,6m
13314,1,尚大的露米娅,2685,280,14,1,15,93.3%,34m
13314,1,rachel,2685,220,11,1,12,91.7%,59m
13314,1,[倚栏夜听雨]BreathlnG,2685,222,9,3,12,75.0%,1h
13314,3,星火燎原丶,2685,155,4,5,9,44.4%,1h
13314,2,bobo,2685,0,3,3,6,50.0%,31m
13314,3,SUNBOY,2685,0,2,3,5,40.0%,60m
13314,3,奥利奥变薄了,2685,0,2,3,5,40.0%,34m
13314,3,铁血杀场,2685,0,2,3,5,40.0%,1h
13314,1,[RxZ]星期天,2685,0,1,0,1,100.0%,2m
13314,2,一拳超人,2685,0,1,1,2,50.0%,53m
13314,1,[灌灌灌灌0]aofij,2685,38,1,3,4,25.0%,1h
13314,1,月影,2685,38,1,4,5,20.0%,1h
13314,2,闪电海中做自己,2685,0,0,1,1,0.0%,1h
13314,3,[星基佬男孩]黄旭北,2685,0,0,1,1,0.0%,60m
13314,1,ruin,2685,0,0,2,2,0.0%,48m
13331,2,Berserker,2684,1372,60,68,128,46.9%,33m
13331,2,[打我一波S全]新手,2684,1401,54,51,105,51.4%,23m
13331,3,[菊花朵朵开]地堡小王子,2684,1292,52,62,114,45.6%,12m
13331,3,yuz,2684,125,35,39,74,47.3%,13m
13331,2,光子流,2684,836,32,39,71,45.1%,40m
13331,3,TreeSea,2684,669,26,30,56,46.4%,20m
13331,1,[智商]Action,2684,497,18,19,37,48.6%,1h
13331,1,琴魔,2684,270,10,7,17,58.8%,2m
13331,1,[舰C]枫叶椛,2684,104,3,0,3,100.0%,25m
13331,3,梦乄,2684,0,2,3,5,40.0%,43m
13331,3,wanzxl,2684,110,2,4,6,33.3%,8m
13331,3,我是你老豆,2684,0,2,4,6,33.3%,1h
13331,1,微笑的橙子,2684,0,1,0,1,100.0%,23m
13331,3,VVVVV,2684,30,1,2,3,33.3%,33m
13331,1,[FLPPY]爱萌吃雷诺,2684,0,0,1,1,0.0%,44m
13346,2,淮安孙一峰,2683,1179,97,96,193,50.3%,10m
13346,3,[小仙女上线啦]zyd,2683,1453,59,57,116,50.9%,6m
13346,1,浪江湖雨后,2683,270,18,15,33,54.5%,1h
13346,1,悟空,2683,374,15,20,35,42.9%,35m
13346,1,[染之炼狱]yuko,2683,415,14,15,29,48.3%,14m
13346,1,soldier,2683,214,6,3,9,66.7%,6m
13346,1,鱼唇的叶某人,2683,168,4,10,14,28.6%,59m
13346,1,[CPT]刘丽楠,2683,104,2,1,3,66.7%,10m
13346,2,[合作无敌手]可是我无法绝恋,2683,136,2,3,5,40.0%,1h
13346,3,death,2683,0,2,3,5,40.0%,1h
13346,1,[DMRc]龚羿达,2683,0,1,0,1,100.0%,30m
13346,3,浅梦无岸,2683,0,1,0,1,100.0%,18m
13346,1,shadowarrior,2683,0,0,1,1,0.0%,23m
13346,1,[蒸汽姬海老名]时间神玩,2683,0,0,2,2,0.0%,48m
13360,1,我是彩笔的小行家,2682,1648,145,140,285,50.9%,59m
13360,2,llllllllllll,2682,1231,53,65,118,44.9%,33m
13360,2,diablo,2682,821,46,46,92,50.0%,23m
13360,1,Lucky,2682,256,13,7,20,65.0%,7m
13360,3,我是谁,2682,165,13,13,26,50.0%,14m
13360,1,[伢伢乐]堕天使,2682,223,7,7,14,50.0%,22m
13360,2,李狗嗨,2682,208,6,6,12,50.0%,40m
13360,1,垣根帝督,2682,167,5,2,7,71.4%,1h
13360,3,断水,2682,122,5,8,13,38.5%,1h
13360,3,[鬼谷]你敬爱的宁哥哥,2682,118,5,10,15,33.3%,39m
13360,3,探鸡不是鸡,2682,0,3,0,3,100.0%,1h
13360,2,[星际合作群]龙语者,2682,135,3,7,10,30.0%,1h
13360,3,Zealot,2682,91,1,6,7,14.3%,8m
13360,2,我太菜拜拜了星际,2682,0,0,1,1,0.0%,49m
13374,2,timothy,2681,1492,152,152,304,50.0%,13m
13374,1,冲不下来怎么办,2681,1268,56,35,91,61.5%,13m
13374,1,[aeahz]休闲玩家,2681,656,30,24,54,55.6%,35m
13374,3,幼稚鬼,2681,434,18,18,36,50.0%,26m
13374,1,白求帶衝鋒,2681,389,15,16,31,48.4%,29m
13374,1,满洲小狐狸,2681,353,14,13,27,51.9%,11m
13374,1,nidhogg,2681,205,9,3,12,75.0%,59m
13374,2,IIIIIII,2681,164,5,5,10,50.0%,15m
13374,3,[Tov]贾维斯,2681,181,5,8,13,38.5%,15m
13374,3,Killer,2681,126,5,12,17,29.4%,18m
13374,3,[夕阳下的浪客]历世的世语者世战,2681,40,4,3,7,57.1%,1h
13374,2,妖鬼,2681,0,3,4,7,42.9%,1h
13374,1,Brian,2681,0,3,5,8,37.5%,19m
13374,2,chtsky,2681,115,3,5,8,37.5%,5m
13374,3,Nanaya,2681,40,2,1,3,66.7%,39m
13374,2,秀一脸,2681,95,2,2,4,50.0%,31m
13374,3,zhou,2681,0,2,3,5,40.0%,59m
13374,3,[WLSA]TimWu,2681,0,1,2,3,33.3%,1h
13374,1,[GCB]等我运营八分钟,2681,38,1,3,4,25.0%,20m
13374,1,[RD彩虹小马]丶丶丶,2681,38,1,3,4,25.0%,1h
13374,2,我来修地堡了,2681,40,1,7,8,12.5%,20m
13374,1,光芒万丈陈彦祖,2681,0,0,1,1,0.0%,13m
13374,1,[Toss一峰]WUXIE,2681,0,0,1,1,0.0%,28m
13397,2,鬼哭狼嚎,2680,1137,68,75,143,47.6%,10m
13397,1,大舰巨炮,2680,638,24,21,45,53.3%,1h
13397,1,[同浙星际]CNInnovation,2680,286,12,5,17,70.6%,20m
13397,1,LOCK,2680,313,12,15,27,44.4%,46m
13397,3,一念天堂一念地狱,2680,277,9,14,23,39.1%,6m
13397,1,[星海绚丽]AvaLanche,2680,118,3,2,5,60.0%,19m
13397,3,wuyanzu,2680,0,3,2,5,60.0%,1h
13397,2,[DWGDC]加藤惠惠惠惠惠惠,2680,0,1,1,2,50.0%,1h
13397,1,[ACG系]Sentry,2680,0,1,2,3,33.3%,27m
13397,1,爱星际的老男孩,2680,0,0,1,1,0.0%,1h
13397,1,[乌拉拉啦啦啦]鑫爷,2680,0,0,2,2,0.0%,24m
13397,1,[以炮交友协会]scarlet,2680,0,0,2,2,0.0%,1h
13397,3,星阵神父,2680,0,0,2,2,0.0%,1h
13410,1,[NLHR]fluito,2679,1643,112,98,210,53.3%,59m
13410,1,飞行员舒克,2679,1170,108,100,208,51.9%,1h
13410,3,星海如梦,2679,1558,93,100,193,48.2%,6m
13410,3,[不知不觉天亮]孙一喵,2679,552,24,21,45,53.3%,40m
13410,1,五庄观偷吃人参果,2679,557,21,20,41,51.2%,48m
13410,1,宿伞无常,2679,222,15,15,30,50.0%,14m
13410,3,[NsfzSc]Rual,2679,220,6,9,15,40.0%,1h
13410,2,别晃我晕奶,2679,46,5,3,8,62.5%,28m
13410,3,vov,2679,160,5,4,9,55.6%,1h
13410,2,小莫满满,2679,136,5,7,12,41.7%,3m
13410,3,[绝不白给]司离,2679,96,4,1,5,80.0%,40m
13410,3,Appreciation,2679,114,4,5,9,44.4%,3m
13410,3,[龙腾九天]火舌,2679,0,1,0,1,100.0%,1h
13410,1,光之悲恸,2679,0,1,1,2,50.0%,59m
13410,1,[恶臭肥仔]黑丝控的卤蛋超人,2679,0,0,1,1,0.0%,58m
13410,1,[逐光]MeRcy,2679,0,0,1,1,0.0%,1h
13410,1,爱与希望,2679,0,0,1,1,0.0%,1h
13427,1,[柑橘之息]白上吹雪,2678,616,21,22,43,48.8%,34m
13427,1,良哥依旧,2678,177,7,2,9,77.8%,1h
13427,3,雪兔子,2678,214,7,13,20,35.0%,17m
13427,1,菜石子,2678,168,6,2,8,75.0%,13m
13427,1,[工程萌男]misCor,2678,204,6,10,16,37.5%,48m
13427,3,QINGQING,2678,169,6,10,16,37.5%,38m
13427,2,白羽,2678,144,5,5,10,50.0%,21m
13427,1,allish,2678,108,4,3,7,57.1%,44m
13427,1,多回首,2678,98,3,4,7,42.9%,10m
13427,1,dasfd,2678,0,1,2,3,33.3%,10m
13427,2,书生,2678,0,1,2,3,33.3%,15m
13427,1,甘比诺教父,2678,34,1,6,7,14.3%,25m
13427,1,kold,2678,0,0,1,1,0.0%,59m
13440,3,SHOX,2677,1328,107,101,208,51.4%,19m
13440,1,逆流的时光,2677,1448,74,51,125,59.2%,24m
13440,3,王獭獭,2677,433,30,28,58,51.7%,2m
13440,3,小哥哥来坐爱么,2677,683,26,26,52,50.0%,11m
13440,2,[白给TV]Salieri,2677,605,21,30,51,41.2%,5m
13440,3,名字真难起,2677,250,10,14,24,41.7%,19m
13440,1,霍尔布鲁克,2677,218,7,13,20,35.0%,22m
13440,2,[海德单推协会]一个笨比,2677,0,1,0,1,100.0%,28m
13440,2,[北京大学鸡协]Helium,2677,0,1,1,2,50.0%,49m
13440,1,joe,2677,0,0,2,2,0.0%,1h
13450,3,[暴雪三十二隊]jbdmsl,2676,403,18,20,38,47.4%,19m
13450,3,神都,2676,296,16,18,34,47.1%,34m
13450,3,[幽冥之狼]要把握好时机,2676,346,13,16,29,44.8%,13m
13450,1,医生,2676,267,11,10,21,52.4%,23m
13450,1,[KPG2]Megatron,2676,225,7,3,10,70.0%,6m
13450,1,魔浪,2676,94,5,6,11,45.5%,1h
13450,2,专心狙击一束七,2676,118,4,5,9,44.4%,10m
13450,1,[艾尔之主]风相,2676,34,2,1,3,66.7%,48m
13450,1,金波,2676,42,2,3,5,40.0%,1h
13450,1,梦想成为欧皇,2676,68,2,4,6,33.3%,44m
13450,3,Mars,2676,0,2,4,6,33.3%,34m
13450,1,[龙之逆鳞]冥界皇太子,2676,76,2,5,7,28.6%,48m
13450,3,为了艾尔,2676,0,0,1,1,0.0%,57m
13450,1,[自由虚空]历史之痕迹,2676,0,0,1,1,0.0%,11m
13450,1,阿兰德虎,2676,0,0,1,1,0.0%,28m
13465,1,她似白月中来,2675,778,36,26,62,58.1%,46m
13465,3,[DMR]石头,2675,513,18,23,41,43.9%,18m
13465,3,[亀山社中]Brick,2675,324,13,22,35,37.1%,39m
13465,1,百战秋铭,2675,242,7,8,15,46.7%,7m
13465,1,speed,2675,167,6,3,9,66.7%,13m
13465,1,[xlx]没方向的兔子,2675,225,6,6,12,50.0%,1h
13465,1,didiid,2675,138,5,0,5,100.0%,14m
13465,1,西風吟笑,2675,136,4,6,10,40.0%,10m
13465,1,八级大狂风,2675,138,4,7,11,36.4%,6m
13465,3,[loveMM]阳光虫,2675,0,2,3,5,40.0%,1h
13465,1,[菜有菜的道理]惜败丶阿飞,2675,0,1,0,1,100.0%,44m
13465,3,张十八,2675,0,1,0,1,100.0%,1h
13465,1,xiaoliu,2675,0,1,2,3,33.3%,34m
13465,1,[月下兄贵]Wack,2675,0,0,1,1,0.0%,22m
13479,1,为了弗瑞,2674,606,25,25,50,50.0%,34m
13479,1,困于井中的寂寞,2674,409,18,14,32,56.2%,1h
13479,1,[暴雪十队]hxdgssyf,2674,478,16,17,33,48.5%,59m
13479,1,[Ba1l]拉赫玛尼诺夫,2674,154,12,11,23,52.2%,36m
13479,1,[社交学大可爱]妇科大夫,2674,320,10,12,22,45.5%,1h
13479,1,Aoip,2674,166,5,2,7,71.4%,5m
13479,1,榆垄,2674,174,4,3,7,57.1%,1h
13479,1,[Fear]stop,2674,136,4,6,10,40.0%,46m
13479,1,[XMQ]Lowkey,2674,114,3,2,5,60.0%,1h
13479,1,qiaoshen,2674,67,3,2,5,60.0%,34m
13479,2,重新集结部队,2674,0,3,4,7,42.9%,1h
13479,1,interest,2674,91,2,0,2,100.0%,10m
13479,1,[刺蛇互助天团]Kithri,2674,34,2,1,3,66.7%,35m
13479,3,Ateam,2674,0,2,3,5,40.0%,1h
13479,1,Legolas,2674,0,1,0,1,100.0%,2m
13479,1,[海王星舰队]萌新,2674,0,1,0,1,100.0%,1h
13479,1,海南,2674,0,0,1,1,0.0%,36m
13479,3,菲亚特合同法,2674,0,0,1,1,0.0%,1h
13479,1,[菜有菜的道理]叶修,2674,0,0,2,2,0.0%,38m
13498,3,暴力严,2673,1447,62,64,126,49.2%,6m
13498,3,[百宝箱]TreeSea,2673,273,15,23,38,39.5%,9m
13498,1,[由我们重回]十一十七,2673,406,14,9,23,60.9%,59m
13498,1,[Uaena]你喜欢奶茶吗,2673,340,13,13,26,50.0%,38m
13498,3,邪魔之神,2673,297,9,13,22,40.9%,2m
13498,1,[鸽德]LAOFE,2673,177,7,3,10,70.0%,2m
13498,3,lkj,2673,88,5,8,13,38.5%,8m
13498,1,[影流之主劫]单色孤独,2673,106,4,3,7,57.1%,1h
13498,1,[倥偬]Zangll,2673,155,3,3,6,50.0%,1h
13498,1,[星鸡争爸]立白就是白,2673,70,3,4,7,42.9%,59m
13498,3,拳拳,2673,119,2,3,5,40.0%,38m
13498,3,我一下就,2673,0,2,3,5,40.0%,9m
13498,3,[小仙女上线啦]天之蓝,2673,0,2,3,5,40.0%,1h
13498,1,IIIIIIIIIIII,2673,78,2,5,7,28.6%,46m
13498,1,[Fe3o4]老妹防御塔怎么走,2673,0,0,1,1,0.0%,13m
13498,3,深渊,2673,0,0,5,5,0.0%,19m
13514,1,杀羊,2672,491,51,48,99,51.5%,14m
13514,1,[UES]宇智波瞎,2672,656,25,15,40,62.5%,36m
13514,2,[奥利给857]别喷我行么,2672,420,15,23,38,39.5%,13m
13514,1,银色重炮,2672,312,11,9,20,55.0%,23m
13514,1,[半个菜鸟II]黑天大神,2672,251,9,4,13,69.2%,5m
13514,2,[秘封俱樂部]境界的舞者,2672,159,6,5,11,54.5%,1h
13514,1,苯环,2672,178,6,7,13,46.2%,19m
13514,1,hamber,2672,142,5,5,10,50.0%,13m
13514,2,可欣,2672,151,4,7,11,36.4%,1h
13514,3,Allalms,2672,141,4,9,13,30.8%,15m
13514,2,[合作任务萌新]颠沛世间,2672,0,3,4,7,42.9%,40m
13514,1,[三个二五仔]Final,2672,88,2,0,2,100.0%,28m
13514,3,Recort,2672,0,2,3,5,40.0%,4m
13514,3,COa,2672,0,1,1,2,50.0%,1h
13514,3,[败犬的胜利]UTAHA,2672,0,1,5,6,16.7%,56m
13514,1,[NKTJ]tuguapi,2672,0,0,2,2,0.0%,56m
13514,2,达斯维达黄旭东,2672,0,0,2,2,0.0%,28m
13531,3,Loch,2671,655,31,18,49,63.3%,26m
13531,1,albo,2671,436,17,15,32,53.1%,1h
13531,1,ZXZXZX,2671,269,10,7,17,58.8%,10m
13531,1,macker,2671,288,10,9,19,52.6%,1h
13531,1,四二带俩王,2671,294,10,12,22,45.5%,11m
13531,1,Jessie,2671,242,7,9,16,43.8%,10m
13531,3,[一股清流]nnnnnnnp,2671,170,6,12,18,33.3%,14m
13531,1,[肉鸡的饲养]小魔女伊蕾娜,2671,146,4,1,5,80.0%,58m
13531,1,名字尽量要取最长,2671,74,3,6,9,33.3%,20m
13531,1,[苦战新手电脑]Aozora,2671,91,2,1,3,66.7%,7m
13531,2,[魔法少女小屋]LonelinesS,2671,44,2,2,4,50.0%,1h
13531,3,shijie,2671,0,2,3,5,40.0%,53m
13531,3,ooooiiiif,2671,0,2,3,5,40.0%,35m
13531,1,[CPT]嘤彡喵班长,2671,88,1,1,2,50.0%,23m
13531,1,吾妻狂三,2671,0,0,1,1,0.0%,1h
13531,1,天地噬魂,2671,0,0,1,1,0.0%,11m
13547,1,yyf,2670,371,14,12,26,53.8%,20m
13547,1,拟态雏虫,2670,315,12,9,21,57.1%,1h
13547,1,[KPG2]李阳彬的克星,2670,282,11,14,25,44.0%,58m
13547,3,周小时,2670,331,10,14,24,41.7%,19m
13547,3,帝王怒喵,2670,121,3,0,3,100.0%,1h
13547,1,[在下菜鸡一只]Haruhi,2670,102,3,4,7,42.9%,24m
13547,1,清梦只是梦,2670,38,2,1,3,66.7%,1h
13547,1,回眸往事丶叮叮,2670,122,2,3,5,40.0%,1h
13547,3,[DMR]insomnia,2670,0,1,1,2,50.0%,1h
13547,3,RedWolf,2670,0,1,2,3,33.3%,1h
13547,1,露娜,2670,36,1,3,4,25.0%,10m
13547,3,竖锯,2670,0,0,1,1,0.0%,35m
13547,1,[审判日号]泯鲲,2670,0,0,1,1,0.0%,7m
13560,3,TIIIT,2669,218,37,46,83,44.6%,7m
13560,3,甲子年的鼠,2669,410,22,21,43,51.2%,9m
13560,1,[不可视战线]时钟之眼倒流,2669,418,16,13,29,55.2%,58m
13560,1,[葱芯]妖白,2669,258,13,7,20,65.0%,59m
13560,1,missdegenban,2669,314,11,14,25,44.0%,29m
13560,1,哇哇哇,2669,263,8,4,12,66.7%,40m
13560,2,[被人绿了]虚空寻觅者,2669,154,6,4,10,60.0%,10m
13560,2,宇宙中的一粒沙,2669,124,6,9,15,40.0%,48m
13560,3,麻辣火锅,2669,0,2,3,5,40.0%,1h
13560,1,[GCL]九汐,2669,66,2,3,5,40.0%,34m
13560,3,gly,2669,0,2,3,5,40.0%,1h
13560,1,[在下菜鸡一只]影月牙,2669,0,1,1,2,50.0%,36m
13572,1,秘制小汉堡,2668,601,97,88,185,52.4%,1h
13572,1,[OTAKU丨]昏君夏夏夏炎,2668,627,27,21,48,56.2%,58m
13572,3,笛行者,2668,208,8,13,21,38.1%,40m
13572,2,[青龙帮]沃基尔邦英,2668,0,4,3,7,57.1%,1h
13572,1,OVO,2668,120,3,1,4,75.0%,1h
13572,1,[小鸡屠宰场9]晓看风云,2668,46,2,1,3,66.7%,1h
13572,1,[miku守护]刮板机,2668,38,2,1,3,66.7%,28m
13572,3,孙桑永远是我大哥,2668,0,2,2,4,50.0%,56m
13572,3,wsc,2668,0,2,3,5,40.0%,1h
13572,1,Nicer,2668,0,1,0,1,100.0%,43m
13572,3,萌萌哒鸡饲料,2668,0,1,0,1,100.0%,1h
13572,1,快樂的大師兄,2668,0,1,1,2,50.0%,48m
13572,1,wwei,2668,30,1,2,3,33.3%,1h
13572,1,frankloved,2668,46,1,6,7,14.3%,34m
13572,1,[8L8]小野做啥都不对,2668,0,0,1,1,0.0%,10m
13572,1,[like12]蚂蚱蹦蹦,2668,0,0,1,1,0.0%,1h
13572,1,fuesjd,2668,0,0,1,1,0.0%,1h
13572,1,[五月花]英雄联盟是辣鸡,2668,0,0,5,5,0.0%,23m
13590,3,斐多悖论,2667,1501,115,103,218,52.8%,33m
13590,1,[妙不可言]坑爹尼玛,2667,333,9,9,18,50.0%,46m
13590,2,player,2667,164,6,4,10,60.0%,1h
13590,3,稚嫩,2667,0,2,3,5,40.0%,39m
13590,3,axio,2667,0,2,3,5,40.0%,40m
13590,1,Silent,2667,36,2,4,6,33.3%,38m
13590,3,双管小怪兽,2667,0,0,1,1,0.0%,9m
13590,1,TheThe,2667,0,0,1,1,0.0%,25m
13590,1,[阳光扫黄大队]棱形毒爆怎么滚,2667,0,0,1,1,0.0%,34m
13599,3,TokyoZerg,2666,1035,109,93,202,54.0%,6m
13599,3,DarkHunter,2666,1266,82,67,149,55.0%,14m
13599,3,NEKO,2666,921,63,62,125,50.4%,17m
13599,3,灵异的虫虫蛋,2666,1219,45,53,98,45.9%,38m
13599,1,空白,2666,352,30,18,48,62.5%,25m
13599,3,[少女的梦]人族正常开,2666,551,21,23,44,47.7%,6m
13599,1,一拳被打死,2666,351,14,9,23,60.9%,6m
13599,1,[社交学教练]落花狼藉,2666,324,12,14,26,46.2%,59m
13599,2,艾米莉亚,2666,169,6,4,10,60.0%,1h
13599,2,[5EU]ScarletAMMO,2666,84,3,1,4,75.0%,15m
13599,2,大神解答撒娇,2666,0,3,4,7,42.9%,28m
13599,1,[比心老子爱你]KILLER,2666,104,3,6,9,33.3%,48m
13599,3,哥特风的琴键,2666,90,3,9,12,25.0%,11m
13599,3,斑木芙兰,2666,88,3,10,13,23.1%,33m
13599,1,kali,2666,42,2,2,4,50.0%,10m
13599,3,zeng,2666,0,2,3,5,40.0%,1h
13599,2,人艰不拆,2666,0,0,1,1,0.0%,5m
13599,2,龙翼,2666,0,0,2,2,0.0%,37m
13599,1,[Suriv]loo,2666,0,0,4,4,0.0%,1h
13618,1,小白白不切鸡,2665,735,26,28,54,48.1%,14m
13618,2,llllllllllll,2665,242,8,2,10,80.0%,58m
13618,3,OGlour,2665,263,8,13,21,38.1%,23m
13618,3,LTbyun,2665,144,5,13,18,27.8%,8m
13618,2,Historia,2665,128,4,6,10,40.0%,1h
13618,1,guardianxp,2665,66,3,2,5,60.0%,1h
13618,1,[虚拟歌手团体]逗比的战舰,2665,72,3,3,6,50.0%,48m
13618,2,圣风,2665,0,1,0,1,100.0%,27m
13618,2,[无欲则刚]折戟沉沙,2665,0,0,1,1,0.0%,58m
13618,1,MINININJA,2665,0,0,2,2,0.0%,2m
13618,1,烤不熟的墨鱼,2665,0,0,2,2,0.0%,27m
13629,1,[Chest]侃爷,2664,1010,37,35,72,51.4%,1h
13629,1,[嘤嘤嘤啊]Face,2664,398,28,13,41,68.3%,1h
13629,1,[东风物流]初号机是工具人,2664,481,16,13,29,55.2%,46m
13629,3,aseqws,2664,371,16,20,36,44.4%,36m
13629,3,GOGOGO,2664,248,8,17,25,32.0%,18m
13629,1,Franklee,2664,138,4,5,9,44.4%,1h
13629,1,[krp]creatorlxd,2664,61,3,3,6,50.0%,1h
13629,1,老赖,2664,151,3,4,7,42.9%,1h
13629,2,llllllllllll,2664,58,2,1,3,66.7%,1h
13629,1,[荣耀丶殿堂]妈妈船,2664,66,2,5,7,28.6%,23m
13629,3,[辣鸡游戏CF]谷子地,2664,0,0,1,1,0.0%,1h
13629,2,胡旋,2664,0,0,1,1,0.0%,36m
13641,2,[CPT]大冲撞,2663,1559,150,145,295,50.8%,33m
13641,1,sadads,2663,1218,90,84,174,51.7%,1h
13641,1,姓已注册,2663,1495,81,79,160,50.6%,30m
13641,1,一贱穿鸡,2663,153,8,8,16,50.0%,1h
13641,1,jihaoran,2663,183,6,2,8,75.0%,5m
13641,3,Alisha,2663,165,5,5,10,50.0%,54m
13641,2,jhjhjhjh,2663,138,4,5,9,44.4%,1h
13641,2,七束一,2663,30,2,0,2,100.0%,1h
13641,1,可哥可妻孙一封,2663,91,2,1,3,66.7%,30m
13641,2,芜湖起飞,2663,137,2,3,5,40.0%,8m
13641,3,燃灯节红色,2663,0,2,3,5,40.0%,1h
13641,1,XQDrone,2663,34,1,2,3,33.3%,29m
13641,1,仙人抚我顶,2663,0,1,2,3,33.3%,1h
13641,3,有强迫症的雷诺,2663,34,1,2,3,33.3%,1h
13641,2,[Chook]MURPHY,2663,0,0,1,1,0.0%,1h
13641,2,[入世禅]酒忤,2663,0,0,1,1,0.0%,1h
13657,2,tom,2662,1287,148,151,299,49.5%,33m
13657,2,庄槿森,2662,671,34,30,64,53.1%,1h
13657,3,[废墟图书館]强袭自由,2662,212,25,27,52,48.1%,38m
13657,1,[幽明异路]yzz,2662,695,24,26,50,48.0%,27m
13657,3,LongSY,2662,591,22,25,47,46.8%,14m
13657,1,[GSXY]Mercurial,2662,632,20,20,40,50.0%,13m
13657,1,老电报员,2662,326,11,11,22,50.0%,1h
13657,2,Stats,2662,272,10,3,13,76.9%,1h
13657,1,总近半,2662,226,9,8,17,52.9%,9m
13657,1,白菜吃萝卜,2662,263,9,9,18,50.0%,38m
13657,1,[北京外事电竞]POWER,2662,257,7,7,14,50.0%,10m
13657,3,Liquor,2662,161,5,1,6,83.3%,1h
13657,3,[小鸡屠宰场7]Faker,2662,0,4,2,6,66.7%,53m
13657,1,游魂,2662,145,4,3,7,57.1%,59m
13657,3,Tarmogoyf,2662,38,3,4,7,42.9%,1h
13657,1,Shmily,2662,114,3,7,10,30.0%,5m
13657,3,[Van样]SHlNY,2662,0,2,2,4,50.0%,57m
13657,3,Kinging,2662,0,2,3,5,40.0%,51m
13657,1,TLgoest,2662,44,1,3,4,25.0%,27m
13657,2,LansloT,2662,0,0,1,1,0.0%,1h
13657,2,[雾切响子]月光下的蒲公英,2662,0,0,1,1,0.0%,8m
13678,2,上杉绘梨衣,2661,488,18,13,31,58.1%,38m
13678,1,和我黑贞贴贴,2661,284,11,6,17,64.7%,20m
13678,3,[狂风暴风雨]MAS,2661,0,5,4,9,55.6%,1h
13678,2,[OUO]你哈嘛批迈,2661,116,4,4,8,50.0%,6m
13678,1,include,2661,103,3,1,4,75.0%,1h
13678,1,[莞东游侠]雄心壮志,2661,78,3,3,6,50.0%,6m
13678,3,狗与骨头灬,2661,0,2,3,5,40.0%,1h
13678,2,Gemini,2661,0,2,5,7,28.6%,1h
13678,2,[地球联邦]LeaF,2661,0,0,1,1,0.0%,58m
13687,2,[KPG2]texousi,2660,1573,132,136,268,49.3%,20m
13687,2,Gemini,2660,373,83,62,145,57.2%,37m
13687,1,隔壁老王小二,2660,674,76,74,150,50.7%,5m
13687,1,[雷蛇]开膛手灬洛萨,2660,1545,56,75,131,42.7%,18m
13687,3,[CPT]时崎狂三,2660,423,20,26,46,43.5%,25m
13687,2,[荣耀归来]yuguo,2660,500,19,14,33,57.6%,1h
13687,1,白岚,2660,365,13,16,29,44.8%,59m
13687,2,jhshs,2660,176,7,2,9,77.8%,27m
13687,2,KIRA,2660,116,5,0,5,100.0%,21m
13687,1,二分之一丝路,2660,118,4,1,5,80.0%,1h
13687,1,月牙之都永恒光辉,2660,88,4,3,7,57.1%,20m
13687,1,撕裂光芒,2660,102,4,6,10,40.0%,1h
13687,1,[星际老屁孩]你甚至不肯叫我,2660,108,3,4,7,42.9%,10m
13687,3,Seven,2660,60,3,7,10,30.0%,14m
13687,3,Tomkoala,2660,0,2,3,5,40.0%,40m
13687,3,托尼,2660,0,2,3,5,40.0%,35m
13687,3,yankende,2660,0,2,3,5,40.0%,1h
13687,2,失格,2660,0,1,0,1,100.0%,1h
13687,2,[小菜逼]xixili,2660,0,1,0,1,100.0%,1h
13687,2,[失去了卡拉]pro,2660,30,1,1,2,50.0%,42m
13687,1,龙的传人,2660,0,0,1,1,0.0%,1h
13708,2,[DMRe]kimiedi,2659,919,106,108,214,49.5%,23m
13708,3,[暴雪二十六队]只玩神族的新人,2659,1477,86,85,171,50.3%,19m
13708,3,seaX,2659,907,57,53,110,51.8%,19m
13708,1,努力努力上砖石,2659,793,36,23,59,61.0%,1h
13708,1,一休不吃素,2659,307,13,13,26,50.0%,35m
13708,3,[OwenSS]凝云未散,2659,316,11,17,28,39.3%,4m
13708,1,charry,2659,268,9,10,19,47.4%,35m
13708,2,Proteiner,2659,217,7,7,14,50.0%,28m
13708,1,冷酷无情,2659,217,7,9,16,43.8%,34m
13708,3,[EOS]新手电脑,2659,97,3,3,6,50.0%,1h
13708,2,siling,2659,68,2,1,3,66.7%,8m
13708,1,[burn]浣纱幼儿园下面陈,2659,123,2,3,5,40.0%,14m
13708,1,共産先驱,2659,103,2,3,5,40.0%,20m
13708,1,[猪猪大家庭]王子涛,2659,119,2,3,5,40.0%,50m
13708,3,[您好]odnvnnoaef,2659,0,2,3,5,40.0%,1h
13708,2,盛世之樱,2659,0,1,0,1,100.0%,60m
13708,3,[GDG]asjfajwafjf,2659,0,0,2,2,0.0%,1h
13725,1,cityhunter,2658,1566,75,70,145,51.7%,54m
13725,2,浮生未歇,2658,175,52,52,104,50.0%,22m
13725,3,[ZSB铁憨憨]yuChen,2658,422,26,22,48,54.2%,14m
13725,3,火爷喷你一脸,2658,314,12,11,23,52.2%,11m
13725,1,只会连连看,2658,290,9,10,19,47.4%,9m
13725,1,暴打阮柯帆,2658,206,8,8,16,50.0%,1h
13725,2,文轩,2658,46,4,6,10,40.0%,47m
13725,3,haaaaa,2658,97,3,3,6,50.0%,1h
13725,2,[YR]BadDog,2658,0,3,4,7,42.9%,1h
13725,1,KISS,2658,88,2,1,3,66.7%,54m
13725,3,[Needle]罗素,2658,0,2,3,5,40.0%,1h
13725,3,杰哥不要啊,2658,0,2,3,5,40.0%,1h
13725,3,啦啦啦,2658,0,2,3,5,40.0%,1h
13725,3,我不是你的父亲啊,2658,0,1,2,3,33.3%,1h
13725,2,kazidoom,2658,0,0,1,1,0.0%,50m
13740,1,塑料多多,2657,557,17,17,34,50.0%,38m
13740,1,[oGss]飒飒秋风,2657,259,8,3,11,72.7%,15m
13740,1,光明的力量,2657,136,6,5,11,54.5%,27m
13740,2,我只会做航母,2657,169,5,8,13,38.5%,13m
13740,1,[XXHZ32]烟雨如花,2657,38,2,3,5,40.0%,48m
13740,3,[琴之森]wqdfs,2657,0,0,1,1,0.0%,1h
13746,1,[大哥奶我]鸡枪兵,2656,1608,113,121,234,48.3%,5m
13746,3,skill,2656,934,34,44,78,43.6%,23m
13746,1,六六,2656,456,17,18,35,48.6%,38m
13746,1,[战争武器]sky,2656,413,15,12,27,55.6%,10m
13746,2,有点夸张,2656,339,14,17,31,45.2%,46m
13746,3,宙斯,2656,272,13,11,24,54.2%,5m
13746,1,[TossSE]ScHolarAGeNt,2656,277,10,7,17,58.8%,1h
13746,1,[亚历山大]pan,2656,192,7,7,14,50.0%,49m
13746,1,rare,2656,191,7,8,15,46.7%,1h
13746,2,[疯月]亡灵灬序曲,2656,178,6,7,13,46.2%,60m
13746,1,向胃冲击,2656,158,5,3,8,62.5%,1h
13746,2,[干磨]Gin,2656,213,5,13,18,27.8%,1h
13746,3,兵多将少,2656,0,4,1,5,80.0%,13m
13746,3,[堂口]沙币神族憋,2656,0,2,3,5,40.0%,11m
13746,2,[超级霸道]黑夜寒流,2656,108,2,3,5,40.0%,55m
13746,2,不破爱花,2656,128,2,4,6,33.3%,1h
13746,1,来战,2656,0,1,1,2,50.0%,46m
13746,2,[纸上的魔法使]烈烈中风,2656,44,1,2,3,33.3%,6m
13746,2,[KKA1]裴婷玉,2656,0,1,4,5,20.0%,1h
13746,3,JInzhiyu,2656,0,0,1,1,0.0%,13m
13746,3,来自士力架的逆袭,2656,0,0,3,3,0.0%,1h
13767,1,AeF,2655,250,43,31,74,58.1%,1h
13767,1,蓝紫色的云,2655,271,8,8,16,50.0%,11m
13767,1,马大师,2655,222,6,8,14,42.9%,1h
13767,2,Tom,2655,58,3,0,3,100.0%,1h
13767,2,心乱了,2655,112,3,1,4,75.0%,1h
13767,3,沈逼逼,2655,0,2,3,5,40.0%,1h
13767,3,黑暗,2655,48,2,10,12,16.7%,38m
13767,2,[魔王的人生]绯弹的亚里亚,2655,0,1,0,1,100.0%,38m
13767,2,情怀丶懂不懂,2655,36,1,1,2,50.0%,1h
13767,2,[玛奇朵]黛仙贝,2655,93,1,2,3,33.3%,1h
13767,2,[柠檬保护协会]老子是傻币,2655,44,1,2,3,33.3%,53m
13767,3,牧雲,2655,0,1,4,5,20.0%,43m
13767,2,[時契]椉汐子,2655,0,0,1,1,0.0%,1h
13767,2,kirito,2655,0,0,1,1,0.0%,1h
13767,1,liazz,2655,0,0,1,1,0.0%,1h
13767,1,火车侠,2655,0,0,3,3,0.0%,1h
13783,2,又菜又爱玩的菜鸡,2654,729,34,15,49,69.4%,58m
13783,2,日了狗了,2654,488,24,17,41,58.5%,38m
13783,1,[小仙女已上线]喜剧之王,2654,410,19,17,36,52.8%,24m
13783,2,[小心我咬死你]岳健,2654,329,13,14,27,48.1%,7m
13783,1,星辰下的我们,2654,298,10,9,19,52.6%,13m
13783,2,一点寒芒,2654,176,7,6,13,53.8%,49m
13783,2,好好向前,2654,284,7,12,19,36.8%,38m
13783,2,暗殇,2654,218,6,4,10,60.0%,36m
13783,1,kirito,2654,89,2,1,3,66.7%,1h
13783,3,[花下]百合花下的剑士,2654,0,2,2,4,50.0%,13m
13783,1,[五月花]IIIIIIIIIII,2654,72,2,4,6,33.3%,1h
13783,3,[丹东男神天团]scv,2654,0,2,4,6,33.3%,59m
13783,3,[222333]有人权的动员兵,2654,0,1,0,1,100.0%,39m
13783,1,凛樱初开,2654,0,0,2,2,0.0%,48m
13797,3,SuperMurloc,2653,902,110,103,213,51.6%,17m
13797,3,[旺旺战士]藤条焖雷兽,2653,1346,76,69,145,52.4%,13m
13797,2,GuAGuA,2653,1492,72,69,141,51.1%,25m
13797,2,Player,2653,624,27,10,37,73.0%,1h
13797,3,[西红柿炒]XJH,2653,549,24,23,47,51.1%,9m
13797,3,[万策皆转换家]IIIIIIIIIIII,2653,383,22,27,49,44.9%,20m
13797,3,zaa,2653,516,19,23,42,45.2%,15m
13797,1,幽月,2653,251,10,4,14,71.4%,11m
13797,3,苏卡布莉娅,2653,55,7,7,14,50.0%,11m
13797,3,Josh,2653,0,3,2,5,60.0%,13m
13797,2,[XXHZ25]战术老王,2653,34,2,0,2,100.0%,1h
13797,1,[狂风暴风雨]llllllllllll,2653,36,2,3,5,40.0%,1h
13797,2,陌离不离,2653,0,1,0,1,100.0%,13m
13797,1,不朽爹,2653,0,1,1,2,50.0%,1h
13797,1,王轩不想当鸡,2653,0,1,1,2,50.0%,7m
13797,2,[小水果]绿皮黑纹大西瓜,2653,0,0,1,1,0.0%,20m
13813,2,[星选组]cnbb,2652,1434,153,187,340,45.0%,39m
13813,1,Alexah,2652,557,22,17,39,56.4%,1h
13813,1,sorry,2652,494,16,17,33,48.5%,59m
13813,1,[随鸡]石头剪刀布,2652,245,9,9,18,50.0%,1h
13813,1,绝望,2652,188,5,5,10,50.0%,49m
13813,1,最期之诗,2652,144,4,3,7,57.1%,48m
13813,1,[兆景埋土大学]灬醉雨丶听风丿,2652,94,3,5,8,37.5%,25m
13813,1,[五月花]茫然之潜行者,2652,114,2,3,5,40.0%,13m
13813,3,[柠檬保护协会]Notears,2652,0,1,0,1,100.0%,32m
13813,2,丧心病狂,2652,30,1,1,2,50.0%,1h
13813,1,石黑英雄,2652,89,1,2,3,33.3%,25m
13813,1,[DAITU]傲神硬霸,2652,0,0,6,6,0.0%,1h
13825,3,痴汉,2651,893,209,199,408,51.2%,5m
13825,2,究极萌新,2651,1065,47,33,80,58.8%,1h
13825,2,[南京工业大学]氘化氢,2651,978,39,32,71,54.9%,1h
13825,1,young,2651,587,26,29,55,47.3%,48m
13825,3,MISS,2651,594,22,25,47,46.8%,6m
13825,1,瞎玩,2651,453,16,22,38,42.1%,1h
13825,1,[中国人民银行]东方白石,2651,374,13,10,23,56.5%,1h
13825,2,如果今生只爱你,2651,257,12,7,19,63.2%,48m
13825,2,[DGL丿茗门]埃尔德尼亚,2651,244,8,2,10,80.0%,55m
13825,3,[晚上吃基]星际玩家都是瞎子,2651,192,7,13,20,35.0%,26m
13825,2,岛田二傻,2651,136,6,7,13,46.2%,60m
13825,2,[SFTRA3]公交公交车,2651,167,5,1,6,83.3%,1h
13825,2,CCY,2651,116,4,2,6,66.7%,37m
13825,2,虚空之遗,2651,112,2,1,3,66.7%,38m
13825,2,娘了个锤的,2651,108,2,1,3,66.7%,51m
13825,2,[燃烧军团之怒]穿过海的尹璇,2651,112,2,4,6,33.3%,17m
13825,3,[KOKOKO]菲尼克斯,2651,0,1,4,5,20.0%,1h
13825,2,newman,2651,0,0,1,1,0.0%,1h
13843,2,HFF,2650,1580,178,175,353,50.4%,38m
13843,1,古洋一号,2650,1648,139,126,265,52.5%,5m
13843,2,[一块晶化瓦斯]IIIIIIIIIIII,2650,1118,45,37,82,54.9%,51m
13843,1,长歌,2650,916,31,33,64,48.4%,1h
13843,2,lxw,2650,780,30,20,50,60.0%,1h
13843,1,幸福一家人,2650,614,24,19,43,55.8%,2m
13843,2,[TAPC]Kingsman,2650,477,18,12,30,60.0%,1h
13843,3,爬爬揪,2650,201,8,15,23,34.8%,2m
13843,1,darkness,2650,221,7,3,10,70.0%,1h
13843,3,[软萌甜小萝莉]观测者,2650,191,6,9,15,40.0%,6m
13843,3,追上我,2650,72,4,5,9,44.4%,12m
13843,1,[哔哩哔哩杯乾]Smilepretend,2650,57,3,7,10,30.0%,48m
13843,3,[仕兰]Gungnir,2650,118,2,2,4,50.0%,1h
13843,3,疯魔凯旋,2650,0,2,2,4,50.0%,59m
13843,1,[哦哦哦耶耶耶]bhan,2650,0,1,2,3,33.3%,10m
13843,2,[MOXU]darkflame,2650,0,0,1,1,0.0%,5m
13859,3,lvzhi,2649,715,144,133,277,52.0%,17m
13859,3,[ILYSK]天雷怒战,2649,1503,110,104,214,51.4%,13m
13859,1,[逗比神教]赣南孙一峰,2649,933,42,36,78,53.8%,1h
13859,3,哄着自己玩,2649,257,29,26,55,52.7%,2m
13859,1,[萌新保护协议]玄冥苍宇,2649,581,20,23,43,46.5%,48m
13859,2,wpyxxx,2649,138,5,4,9,55.6%,1h
13859,1,[Sfae]DuskVerdict,2649,165,5,6,11,45.5%,56m
13859,2,[不知]xingchen,2649,116,4,2,6,66.7%,1h
13859,3,掌中老虎,2649,30,4,3,7,57.1%,1h
13859,1,ruby,2649,173,4,5,9,44.4%,5m
13859,1,我真的不会虫族呀,2649,102,3,1,4,75.0%,25m
13859,3,hhq,2649,90,3,11,14,21.4%,14m
13859,2,山养奥特曼,2649,0,1,0,1,100.0%,40m
13859,2,[火焰雷兽]梦魇灬华尔兹,2649,0,0,2,2,0.0%,27m
13873,1,[CUMT]暗影微光,2648,1439,106,118,224,47.3%,11m
13873,3,孙焕佳,2648,540,22,29,51,43.1%,13m
13873,1,beststart,2648,497,19,22,41,46.3%,20m
13873,1,BlueA,2648,511,17,23,40,42.5%,30m
13873,3,[五月花]千年之蝶,2648,464,16,21,37,43.2%,26m
13873,3,luoluo,2648,244,9,3,12,75.0%,1h
13873,1,Curtain,2648,184,8,9,17,47.1%,13m
13873,1,[4399]夏炎,2648,338,8,13,21,38.1%,50m
13873,3,包谷米米,2648,252,8,16,24,33.3%,14m
13873,2,[西伯利亚土豆]Probe,2648,160,5,0,5,100.0%,1h
13873,2,大叔太可恶,2648,38,2,0,2,100.0%,1h
13873,1,[求老仙奶我啊]FenixM,2648,42,2,3,5,40.0%,35m
13873,2,爆锤狗头,2648,86,2,4,6,33.3%,21m
13873,2,小菜鸡,2648,0,1,0,1,100.0%,5m
13873,2,IIllllIIII,2648,0,1,0,1,100.0%,1h
13873,1,[鸡家军]喵帕斯,2648,0,1,1,2,50.0%,1h
13873,1,wisdory,2648,0,0,2,2,0.0%,30m
13873,1,尘埃,2648,0,0,3,3,0.0%,1h
13891,2,[秋毫七队]香烟没毒,2647,1544,267,253,520,51.3%,31m
13891,3,杜甫,2647,791,74,66,140,52.9%,6m
13891,3,[琉璃]warrior,2647,236,9,11,20,45.0%,17m
13891,1,Edward,2647,240,8,11,19,42.1%,1h
13891,2,[渣男团体]极地武士,2647,210,7,6,13,53.8%,1h
13891,1,[蒙蔽梦游团]小白小黑,2647,168,6,7,13,46.2%,27m
13891,3,兜八,2647,121,5,2,7,71.4%,56m
13891,2,[啵啵沙]悟也,2647,90,4,1,5,80.0%,51m
13891,3,小憨憨,2647,97,3,3,6,50.0%,1h
13891,2,[星际情侣]宇宙第一帅,2647,18,1,2,3,33.3%,1h
13891,2,高阶食堂武士,2647,30,1,2,3,33.3%,7m
13891,1,安康,2647,38,1,3,4,25.0%,10m
13891,1,skybear,2647,0,0,2,2,0.0%,48m
13904,1,[白门楼拆迁组]好奇,2646,1548,66,57,123,53.7%,1h
13904,3,[NLHR]小四,2646,1255,54,53,107,50.5%,14m
13904,3,工业党人,2646,867,37,43,80,46.2%,9m
13904,2,[敌人正在]撕碎我的部队,2646,656,25,21,46,54.3%,1h
13904,2,[Ogier]OGNotailFANs,2646,418,17,16,33,51.5%,48m
13904,1,白发三千丈,2646,295,9,6,15,60.0%,59m
13904,1,wdnmd,2646,325,9,11,20,45.0%,1h
13904,3,[热血兔子团]宫园薰,2646,0,4,2,6,66.7%,1h
13904,2,匿名玩家,2646,160,4,3,7,57.1%,13m
13904,3,phh,2646,90,4,9,13,30.8%,13m
13904,3,[大疯狗]Ccccc,2646,62,2,9,11,18.2%,8m
13904,3,丶香菇蓝瘦,2646,0,1,1,2,50.0%,1h
13904,3,[利维亚打桩机]HST,2646,0,1,1,2,50.0%,60m
13904,3,[NekoQw]FanTa,2646,0,0,1,1,0.0%,25m
13918,3,为了部落,2645,1569,68,74,142,47.9%,16m
13918,1,Devil,2645,1425,53,53,106,50.0%,6m
13918,2,zjc,2645,342,15,3,18,83.3%,52m
13918,1,mog,2645,216,12,19,31,38.7%,13m
13918,1,[香蕉派]蕉泥座人,2645,298,10,12,22,45.5%,1h
13918,2,Yuki,2645,335,9,18,27,33.3%,1h
13918,1,[天地會总舵]四方茉莉,2645,174,6,10,16,37.5%,1h
13918,2,小刀爸爸,2645,62,3,1,4,75.0%,1h
13918,2,[超级哈皮]Devil,2645,58,3,2,5,60.0%,35m
13918,2,[神之救赎]博哥,2645,0,1,0,1,100.0%,29m
13918,2,[CPT]我是长颈鹿,2645,0,0,1,1,0.0%,7m
13918,2,benn,2645,0,0,1,1,0.0%,9m
13918,2,[智乃超可爱w]我躺了,2645,0,0,1,1,0.0%,1h
13918,2,[废物乐园]OkayDK,2645,0,0,1,1,0.0%,37m
13918,1,众神归来,2645,0,0,3,3,0.0%,13m
13918,1,请打别人吧,2645,0,0,3,3,0.0%,1h
13934,3,FaFx,2644,1352,83,84,167,49.7%,39m
13934,2,宇宙炮王孟照国,2644,1227,56,52,108,51.9%,31m
13934,1,博物馆,2644,324,29,14,43,67.4%,20m
13934,3,[SHNU]凤雏,2644,497,18,26,44,40.9%,26m
13934,1,kiro,2644,375,16,10,26,61.5%,38m
13934,2,WarPigs,2644,390,15,7,22,68.2%,1h
13934,1,ssw,2644,391,15,11,26,57.7%,6m
13934,2,青铜滴神,2644,276,10,3,13,76.9%,1h
13934,2,[暴雪二十二队]鸦之羽,2644,256,10,4,14,71.4%,35m
13934,1,llllllllllll,2644,202,10,21,31,32.3%,36m
13934,1,[符华天下第一]Cynic,2644,143,8,2,10,80.0%,26m
13934,1,[电竞人贩子]哭哭哭哭泣,2644,250,8,7,15,53.3%,1h
13934,3,我知心恨谁,2644,151,5,5,10,50.0%,57m
13934,3,DYS,2644,97,2,2,4,50.0%,53m
13934,3,QAQ,2644,0,2,3,5,40.0%,39m
13934,1,Magicterran,2644,40,2,5,7,28.6%,25m
13934,3,Anonymous,2644,0,1,1,2,50.0%,1h
13951,3,[火焰雷兽]淑二,2643,1006,68,72,140,48.6%,39m
13951,1,孔哥,2643,650,27,16,43,62.8%,59m
13951,1,打的太菜,2643,417,14,12,26,53.8%,24m
13951,1,逍遥游子,2643,299,9,8,17,52.9%,54m
13951,1,IIIIIIIkkk,2643,197,8,10,18,44.4%,20m
13951,2,少林功夫好真滴好,2643,206,7,8,15,46.7%,55m
13951,2,Harry,2643,205,6,12,18,33.3%,18m
13951,2,诺诺,2643,0,3,4,7,42.9%,3m
13951,3,安纳金,2643,0,2,1,3,66.7%,1h
13951,3,[神子]机械之狼,2643,97,2,1,3,66.7%,60m
13951,1,乱拳挥死老师傅,2643,89,2,2,4,50.0%,44m
13951,3,SCV,2643,0,2,2,4,50.0%,56m
13951,3,[gansin]llllllllllll,2643,0,2,3,5,40.0%,43m
13951,2,[平安京]fripside,2643,0,1,0,1,100.0%,13m
13951,2,天上月丶,2643,0,1,0,1,100.0%,1h
13951,2,茅野爱衣,2643,0,1,1,2,50.0%,1h
13951,2,vector,2643,0,0,1,1,0.0%,58m
13951,3,点点,2643,0,0,6,6,0.0%,15m
13969,1,四角吞金兽,2642,1608,98,90,188,52.1%,1h
13969,3,[小鸡屠宰场a]丁铁军,2642,1045,46,47,93,49.5%,36m
13969,1,[大漢]粉毛小兔兔,2642,895,37,36,73,50.7%,13m
13969,3,nidie,2642,750,32,32,64,50.0%,24m
13969,3,阿卡卡,2642,261,10,12,22,45.5%,4m
13969,1,[C63872]吊着瓜子打,2642,254,8,11,19,42.1%,7m
13969,2,夜太狂,2642,0,1,0,1,100.0%,50m
13969,2,memories,2642,0,1,0,1,100.0%,20m
13969,1,夜雨声烦,2642,44,1,4,5,20.0%,1h
13969,2,WHX,2642,0,0,1,1,0.0%,1h
13969,2,[禁语草]绅士喵,2642,0,0,1,1,0.0%,35m
13969,2,[月夜贵族]小妖显灵,2642,0,0,1,1,0.0%,13m
13969,2,布雷西亚的谢拉,2642,0,0,1,1,0.0%,28m
13969,2,AdamREK,2642,0,0,2,2,0.0%,28m
13969,1,唐昩,2642,0,0,4,4,0.0%,36m
13984,2,那打不过能咋办嘛,2641,1028,158,133,291,54.3%,35m
13984,2,[你有遗憾么]落樱不及姑娘你,2641,324,13,3,16,81.2%,37m
13984,2,Freidrich,2641,316,10,7,17,58.8%,1h
13984,2,李咏浩,2641,242,8,9,17,47.1%,1h
13984,2,IIIIIIIII,2641,115,5,4,9,55.6%,38m
13984,3,雷励风行,2641,0,2,3,5,40.0%,1h
13984,3,llllllllllll,2641,0,2,3,5,40.0%,1h
13984,2,[浑元形意门]reality,2641,0,1,0,1,100.0%,1h
13984,3,凉着,2641,0,1,3,4,25.0%,1h
13984,1,[芽衣最可爱了]风间净琉璃,2641,0,1,4,5,20.0%,28m
13984,2,[miku守护]Asds,2641,0,0,1,1,0.0%,5m
13984,2,年迈的主宰,2641,0,0,1,1,0.0%,5m
13984,3,[盲人选手]威猛先生有点甜,2641,0,0,2,2,0.0%,18m
13984,1,Rinbow,2641,0,0,5,5,0.0%,1h
13998,3,[查尔传火队]JoelBirch,2640,396,77,78,155,49.7%,34m
13998,2,[正经企鹅]back,2640,738,29,20,49,59.2%,1h
13998,3,Supertom,2640,495,18,19,37,48.6%,18m
13998,1,豆子杀手,2640,399,17,11,28,60.7%,36m
13998,1,[TGDD]安静,2640,267,8,7,15,53.3%,1h
13998,1,旅客,2640,284,8,9,17,47.1%,38m
13998,2,阳聪,2640,190,7,0,7,100.0%,1h
13998,2,[第七駆逐鑑隊]小菜喵,2640,114,4,6,10,40.0%,5m
13998,1,木鱼大忽悠,2640,0,3,5,8,37.5%,1h
13998,2,[Cinder]此地可是白门楼,2640,36,2,0,2,100.0%,37m
13998,2,快乐,2640,30,2,0,2,100.0%,48m
13998,2,顾翊庭,2640,0,2,3,5,40.0%,28m
13998,2,[DMR]一只胖子,2640,0,1,0,1,100.0%,1h
13998,2,easy,2640,30,1,2,3,33.3%,1h
14012,3,[EL骑士二团]IIIIIIIIII,2639,778,27,33,60,45.0%,6m
14012,1,[我们是无敌的]兽人永不为奴,2639,616,20,21,41,48.8%,48m
14012,2,rrrwt,2639,438,19,7,26,73.1%,52m
14012,1,handsome,2639,301,12,11,23,52.2%,19m
14012,3,漆黑烈焰使,2639,220,6,9,15,40.0%,20m
14012,1,wba,2639,140,4,1,5,80.0%,22m
14012,2,小发,2639,108,4,7,11,36.4%,55m
14012,2,Untitled,2639,86,3,1,4,75.0%,46m
14012,2,空简集白,2639,129,2,1,3,66.7%,1h
14012,3,Lurker,2639,0,2,3,5,40.0%,1h
14012,3,[千叶之王]五更萝莉,2639,0,0,1,1,0.0%,1h
14012,3,VeniVediVici,2639,0,0,4,4,0.0%,40m
14024,1,小肚兜娃娃,2638,1320,761,739,1500,50.7%,24m
14024,2,Shine,2638,718,118,118,236,50.0%,41m
14024,2,追后天十,2638,406,53,60,113,46.9%,39m
14024,3,kurisu,2638,692,29,32,61,47.5%,18m
14024,2,[暴雪家族]橙子,2638,516,19,15,34,55.9%,1h
14024,3,vivilove,2638,418,15,23,38,39.5%,40m
14024,1,日月天,2638,155,4,3,7,57.1%,11m
14024,3,咕咕咕,2638,119,4,3,7,57.1%,1h
14024,3,千寻,2638,127,4,4,8,50.0%,1h
14024,1,我已颓废感觉良好,2638,207,4,6,10,40.0%,22m
14024,1,李宁无敌,2638,74,3,4,7,42.9%,20m
14024,1,星风尘舞,2638,61,2,5,7,28.6%,48m
14024,3,Chelsea,2638,0,1,0,1,100.0%,60m
14024,1,[达拉姆查卡拉]Hunter,2638,0,1,2,3,33.3%,48m
14024,2,Lilpoike,2638,30,1,3,4,25.0%,58m
14024,3,[换家引领世界]夜空中最亮的星,2638,97,1,5,6,16.7%,1h
14024,2,弃疗型熊猫,2638,0,0,1,1,0.0%,8m
14041,2,IMBADBAI,2637,1265,149,134,283,52.7%,21m
14041,1,[HQU战队]IIIIIIIIIIII,2637,1436,61,46,107,57.0%,59m
14041,1,urimoo,2637,739,37,39,76,48.7%,36m
14041,1,你的剪影,2637,173,13,15,28,46.4%,1h
14041,2,[腥基佬男骸]我的女王叫王月,2637,114,3,1,4,75.0%,1h
14041,2,杰哥,2637,60,3,3,6,50.0%,1h
14041,2,Clawn,2637,0,3,5,8,37.5%,10m
14041,1,神族无毒,2637,94,3,7,10,30.0%,6m
14041,2,苍云古齿,2637,115,2,2,4,50.0%,40m
14041,3,[121312]奇怪的人类,2637,0,1,1,2,50.0%,1h
14041,3,迈克老狼,2637,0,1,3,4,25.0%,1h
14041,2,[为了二五仔]天罡星呼保义宋江,2637,36,1,3,4,25.0%,1h
14041,2,[黑白条神教]亚顿,2637,0,0,1,1,0.0%,42m
14041,2,Splder,2637,0,0,1,1,0.0%,1h
14041,2,[飞云之上]mechashu,2637,0,0,1,1,0.0%,24m
14041,3,Temperance,2637,0,0,2,2,0.0%,1h
14057,1,亢奋的蛆宝宝,2636,1150,153,143,296,51.7%,30m
14057,3,[SNShna]孤冥,2636,1518,82,79,161,50.9%,19m
14057,3,恋蝶无邪,2636,974,38,38,76,50.0%,13m
14057,3,Sun,2636,798,30,34,64,46.9%,13m
14057,2,Coilrain,2636,674,25,20,45,55.6%,1h
14057,2,Psychiatric,2636,370,14,12,26,53.8%,1h
14057,1,Sorcamus,2636,200,12,7,19,63.2%,1h
14057,1,晴栀,2636,314,11,10,21,52.4%,15m
14057,1,Atomic,2636,242,9,8,17,52.9%,33m
14057,1,简单活,2636,136,6,6,12,50.0%,1h
14057,2,[镜花水月]独步,2636,132,5,4,9,55.6%,1h
14057,1,[哦卡哇伊阔多]imbasun,2636,163,4,10,14,28.6%,1h
14057,1,serral,2636,36,2,3,5,40.0%,43m
14057,3,我曾触碰星辰,2636,97,2,4,6,33.3%,1h
14057,1,[合作共济会]Vita,2636,0,0,1,1,0.0%,1h
14072,3,药水哥,2635,924,112,92,204,54.9%,20m
14072,3,zling,2635,1044,44,42,86,51.2%,15m
14072,2,魔兽争霸,2635,627,27,16,43,62.8%,1h
14072,2,Ring,2635,185,7,5,12,58.3%,1h
14072,1,HTeOolK,2635,187,5,12,17,29.4%,22m
14072,3,[EILEN]ARI,2635,142,5,14,19,26.3%,36m
14072,2,Vincent,2635,129,4,1,5,80.0%,28m
14072,1,LISY,2635,0,2,3,5,40.0%,13m
14072,1,多糖芒果冰丶,2635,0,1,0,1,100.0%,1h
14072,3,[北洋水军]杨柳轻扬,2635,0,1,0,1,100.0%,4m
14072,2,呵呵,2635,0,1,1,2,50.0%,38m
14072,3,技术不够缘份来凑,2635,0,0,1,1,0.0%,12m
14072,2,[斧头帮OL]封魔,2635,0,0,2,2,0.0%,1h
14085,1,GameOfThrone,2634,435,18,16,34,52.9%,54m
14085,3,LJDEXB,2634,403,17,20,37,45.9%,7m
14085,1,尼德霍格,2634,414,16,13,29,55.2%,1h
14085,2,混元太极,2634,369,16,14,30,53.3%,1h
14085,2,女孩为什么穿内内,2634,257,8,7,15,53.3%,1h
14085,2,camille,2634,240,8,8,16,50.0%,18m
14085,2,哀冬之伤,2634,180,7,4,11,63.6%,27m
14085,2,知足常乐贴近生活,2634,166,5,7,12,41.7%,17m
14085,2,joker,2634,60,3,2,5,60.0%,1h
14085,2,[天地會总舵]fsdfs,2634,30,1,1,2,50.0%,1h
14085,2,[AF]耶稣,2634,0,0,1,1,0.0%,1h
14085,2,MISS,2634,0,0,1,1,0.0%,42m
14097,2,XdpNB,2633,928,39,32,71,54.9%,7m
14097,1,鹿野良,2633,614,27,22,49,55.1%,1h
14097,2,[江南暮雪]执政官吉姆雷诺,2633,343,13,7,20,65.0%,42m
14097,1,kka,2633,148,13,16,29,44.8%,34m
14097,1,Rachel,2633,303,12,10,22,54.5%,44m
14097,1,tingyang,2633,171,8,12,20,40.0%,48m
14097,3,你在干什么,2633,159,6,5,11,54.5%,1h
14097,1,[燕大SC]Dirty,2633,135,4,3,7,57.1%,40m
14097,1,[教父遇刺]BISU,2633,147,4,4,8,50.0%,1h
14097,3,朝云暮倦,2633,97,3,3,6,50.0%,1h
14097,1,[四叶草]布丁味的咖啡,2633,117,3,4,7,42.9%,50m
14097,1,[曾经一群兔子]破晓,2633,0,3,6,9,33.3%,1h
14097,2,Chuck,2633,0,1,0,1,100.0%,1h
14097,3,jinhao,2633,0,1,0,1,100.0%,25m
14097,1,陌路同行,2633,0,1,2,3,33.3%,59m
14112,2,Troesy,2632,1414,114,115,229,49.8%,14m
14112,2,成凮,2632,444,16,11,27,59.3%,1h
14112,3,[萌妹集团]LGDSWSG,2632,150,5,17,22,22.7%,14m
14112,2,SCorPio,2632,138,3,2,5,60.0%,56m
14112,1,KaneTang,2632,0,3,5,8,37.5%,1h
14112,1,[荷兰小红花]恩比德,2632,88,3,6,9,33.3%,1h
14112,2,gloomylight,2632,0,1,0,1,100.0%,1h
14112,1,HardWalnut,2632,42,1,2,3,33.3%,1h
14112,2,[scuob]Dablon,2632,0,0,1,1,0.0%,1h
14112,3,围巾,2632,0,0,1,1,0.0%,51m
14112,1,[入侵地球]niColeTnT,2632,0,0,1,1,0.0%,19m
14112,1,[暴雪我是你爹]古明地盆,2632,0,0,3,3,0.0%,1h
14124,1,YearsTwelve,2631,1691,422,412,834,50.6%,1h
14124,2,Maple,2631,1008,86,72,158,54.4%,1h
14124,3,DNA,2631,683,38,45,83,45.8%,9m
14124,1,小魍魉丶,2631,345,15,17,32,46.9%,28m
14124,2,离歌,2631,213,14,8,22,63.6%,50m
14124,3,[镜花水月]OhmaZio,2631,367,14,17,31,45.2%,11m
14124,1,寒月,2631,198,9,5,14,64.3%,33m
14124,2,影之哀伤,2631,42,4,6,10,40.0%,1h
14124,2,Chase,2631,122,4,6,10,40.0%,1h
14124,2,DannyRay,2631,91,3,3,6,50.0%,21m
14124,1,[凉了]水天,2631,102,3,3,6,50.0%,1h
14124,3,Firebergs,2631,34,2,1,3,66.7%,1h
14124,1,甜甜的小糖丸,2631,34,2,4,6,33.3%,20m
14124,2,桐人,2631,0,1,1,2,50.0%,35m
14124,1,[超会玩]别打我,2631,0,1,2,3,33.3%,29m
14124,2,[天府成都]预言,2631,0,0,1,1,0.0%,48m
14124,2,天涯一家,2631,0,0,1,1,0.0%,1h
14141,2,愤怒的打卤面,2630,1524,110,118,228,48.2%,13m
14141,3,[Eglory]行云流水,2630,1493,85,84,169,50.3%,19m
14141,1,自由之翼,2630,634,36,33,69,52.2%,11m
14141,2,[贪得无厌]爱喝冰峰,2630,807,35,22,57,61.4%,1h
14141,1,Chow,2630,564,21,19,40,52.5%,20m
14141,1,阿尔,2630,290,9,9,18,50.0%,1h
14141,2,Live,2630,118,5,5,10,50.0%,7m
14141,1,深海鲨,2630,48,4,7,11,36.4%,1h
14141,1,炸鱼妈早死,2630,89,2,2,4,50.0%,7m
14141,2,[等打完仗娶你]卡尔达利斯,2630,0,1,0,1,100.0%,1h
14141,3,[由我们重回]温柔撩人醉,2630,0,1,0,1,100.0%,41m
14141,1,[龙腾九天]Casper,2630,0,1,4,5,20.0%,1h
14141,2,[zmsdmm]微澜之间,2630,0,1,8,9,11.1%,50m
14141,2,您的矿物储量不足,2630,0,0,1,1,0.0%,46m
14141,2,胡萝卜与面包,2630,0,0,2,2,0.0%,1h
14141,1,忠诚的背叛,2630,0,0,7,7,0.0%,2m
14157,3,Ejune,2629,918,36,41,77,46.8%,18m
14157,1,朱五四,2629,728,25,30,55,45.5%,1h
14157,3,图腾传说,2629,599,20,26,46,43.5%,17m
14157,2,太极丨八卦丨搬拦,2629,347,13,7,20,65.0%,1h
14157,2,[嘤遍全球]Magic,2629,374,13,14,27,48.1%,52m
14157,2,[幽冥之狼]dreambreak,2629,306,9,17,26,34.6%,1h
14157,1,[思君便安心]Mgou,2629,183,8,7,15,53.3%,1h
14157,2,温柔且将军,2629,182,6,6,12,50.0%,21m
14157,2,张三,2629,193,5,6,11,45.5%,1h
14157,2,我太想进步了,2629,130,5,8,13,38.5%,1h
14157,3,singingwood,2629,126,4,14,18,22.2%,26m
14157,2,玄瞑,2629,134,3,2,5,60.0%,1h
14157,2,[306]MAXINGER,2629,0,1,0,1,100.0%,1h
14157,2,llllllllllll,2629,91,1,2,3,33.3%,47m
14157,3,[萨尔那加议会]墨染流觞,2629,40,1,2,3,33.3%,9m
14157,1,[晋升者]Serral,2629,0,1,2,3,33.3%,1h
14157,2,TadisG,2629,0,0,1,1,0.0%,17m
14157,1,[LUY]July,2629,0,0,5,5,0.0%,1h
14175,2,yzt,2628,1208,66,52,118,55.9%,1h
14175,2,晓风残月,2628,702,28,19,47,59.6%,27m
14175,1,dxbsd,2628,645,26,15,41,63.4%,1h
14175,2,一夜奈良山,2628,554,23,16,39,59.0%,1h
14175,3,北冥子一一匿,2628,549,23,28,51,45.1%,18m
14175,1,pzjll,2628,488,20,20,40,50.0%,6m
14175,1,[魔法少女小屋]魔法少女软芳酱,2628,304,9,12,21,42.9%,34m
14175,3,[田中姬铃木雏]金木研,2628,222,9,20,29,31.0%,15m
14175,2,XiBisu,2628,242,7,10,17,41.2%,1h
14175,2,[魔导国]上官冷月,2628,168,6,4,10,60.0%,52m
14175,1,希夫,2628,96,4,5,9,44.4%,1h
14175,2,星际指挥官,2628,94,3,5,8,37.5%,24m
14175,3,[新手玩家]被打的小兔,2628,97,2,0,2,100.0%,9m
14175,1,Tike,2628,0,2,3,5,40.0%,1h
14175,2,KIKO,2628,0,1,0,1,100.0%,1h
14175,2,这也在你计划中吗,2628,32,1,2,3,33.3%,18m
14175,1,傻瓜来笑你,2628,34,1,6,7,14.3%,24m
14192,1,大亮哥,2627,775,39,39,78,50.0%,48m
14192,2,狂热陆战队员,2627,769,36,21,57,63.2%,18m
14192,1,Turing,2627,417,15,15,30,50.0%,5m
14192,1,金人还是宋人,2627,319,11,11,22,50.0%,1h
14192,2,clima,2627,114,8,11,19,42.1%,1h
14192,1,[Globus]TYTY,2627,250,7,8,15,46.7%,44m
14192,2,president,2627,130,6,4,10,60.0%,6m
14192,2,同化完成,2627,58,3,2,5,60.0%,48m
14192,1,tension,2627,0,3,2,5,60.0%,1h
14192,2,南歌,2627,62,3,3,6,50.0%,23m
14192,2,[社交学导练]quyifan,2627,30,2,1,3,66.7%,1h
14192,3,turris,2627,0,2,4,6,33.3%,1h
14192,2,毕方神鸟,2627,0,1,0,1,100.0%,48m
14192,2,[虚空守望]子曰非日,2627,32,1,2,3,33.3%,60m
14192,2,[艾尔之巅]RainKing,2627,46,1,3,4,25.0%,31m
14207,3,vinyl,2626,1252,69,64,133,51.9%,17m
14207,3,[100T7]CCJOY,2626,1058,45,38,83,54.2%,33m
14207,2,戏十六,2626,564,20,32,52,38.5%,34m
14207,2,[首都义勇军]Velpro,2626,279,11,2,13,84.6%,1h
14207,1,一叶七刺郎,2626,210,8,7,15,53.3%,13m
14207,1,hopfffffffff,2626,91,3,2,5,60.0%,33m
14207,2,Eilsh,2626,90,3,5,8,37.5%,21m
14207,1,Antonio,2626,38,2,3,5,40.0%,13m
14207,1,[SDSVSZ]红心主宰,2626,121,2,4,6,33.3%,24m
14207,3,Leyser,2626,97,1,2,3,33.3%,1h
14207,1,[FYXZ]TANK,2626,0,0,1,1,0.0%,27m
14207,2,sis,2626,0,0,1,1,0.0%,38m
14207,2,[黑森峰卐学院]弃坑菜鸟,2626,0,0,3,3,0.0%,1h
14220,3,小川,2625,1592,201,208,409,49.1%,39m
14220,2,IIIIIIIIIIII,2625,252,8,14,22,36.4%,1h
14220,1,MZDW,2625,221,7,4,11,63.6%,7m
14220,2,joker,2625,160,7,9,16,43.8%,1h
14220,2,YTYT,2625,92,4,3,7,57.1%,1h
14220,1,[剑与舞的奏曲]夕听风雨,2625,188,4,6,10,40.0%,1h
14220,2,[白丝黑丝萝莉]诺娃是我姐姐,2625,133,3,0,3,100.0%,48m
14220,2,小同学,2625,49,3,2,5,60.0%,26m
14220,1,爱笑的王浩浩,2625,70,3,4,7,42.9%,44m
14220,2,Ghost,2625,0,3,4,7,42.9%,59m
14220,1,小凡凡,2625,0,2,3,5,40.0%,1h
14220,1,StarMoonRNA,2625,0,1,1,2,50.0%,1h
14220,1,[莽夫与匹夫]传说是猫头,2625,38,1,4,5,20.0%,10m
14220,3,[雷本]INnoVation,2625,30,1,10,11,9.1%,13m
14220,2,[SCP姬金会]格林巴氏,2625,0,0,1,1,0.0%,4m
14235,3,cigocigo,2624,1036,119,117,236,50.4%,7m
14235,1,[异度黑核侵蚀]布洛妮娅,2624,346,11,15,26,42.3%,43m
14235,1,嗨呀,2624,329,10,14,24,41.7%,1h
14235,2,ling,2624,171,6,5,11,54.5%,59m
14235,1,[五年目放課後]机械员,2624,143,6,8,14,42.9%,57m
14235,1,DInana,2624,153,5,3,8,62.5%,1h
14235,1,拿破仑,2624,129,4,1,5,80.0%,57m
14235,1,[ESKT]雷神,2624,117,3,1,4,75.0%,26m
14235,2,你的背影遥不可及,2624,32,2,1,3,66.7%,5m
14235,2,神王剑神,2624,30,2,2,4,50.0%,48m
14235,2,[襄铃]绝世可爱刘人语,2624,0,1,0,1,100.0%,1h
14235,2,被感染的探姬,2624,0,1,1,2,50.0%,50m
14235,1,[雅阁]虚空灬回忆,2624,0,0,5,5,0.0%,48m
14248,1,Whisky,2623,1279,173,151,324,53.4%,2m
14248,1,嗷嗷嗷嗷警告,2623,1368,133,128,261,51.0%,59m
14248,3,[此用户已成仙]晓之车,2623,1179,74,74,148,50.0%,6m
14248,1,[肆季]斯卡洛尔,2623,514,20,22,42,47.6%,28m
14248,2,工口新一,2623,330,10,9,19,52.6%,1h
14248,1,MagicTerran,2623,234,6,9,15,40.0%,1h
14248,2,FATHER,2623,86,4,4,8,50.0%,1h
14248,2,ChenXingBiao,2623,96,2,1,3,66.7%,60m
14248,2,最期之诗,2623,66,2,2,4,50.0%,13m
14248,2,[大翼卍议会]AfellayMr,2623,0,1,0,1,100.0%,25m
14248,3,[被虐的小狗和]黄黄的小木瓜,2623,0,0,5,5,0.0%,36m
14259,2,残裤,2622,783,33,23,56,58.9%,27m
14259,2,leathersofa,2622,484,17,18,35,48.6%,1h
14259,2,[OB丶]Sirius,2622,152,5,4,9,55.6%,4m
14259,2,[QAQ]德拉克斯,2622,0,1,0,1,100.0%,4m
14259,1,[红尘v如梦]未命名,2622,0,1,2,3,33.3%,22m
14259,2,夏夜银辉,2622,94,1,2,3,33.3%,49m
14265,2,[暴雪二十八队]dunima,2621,692,32,19,51,62.7%,38m
14265,1,欲望的漏斗,2621,518,20,20,40,50.0%,46m
14265,3,有丶怠惰,2621,560,20,24,44,45.5%,27m
14265,2,mmmmk,2621,440,15,15,30,50.0%,1h
14265,3,蒋猫跃华,2621,268,10,12,22,45.5%,1h
14265,2,拉萨拉拉,2621,215,9,1,10,90.0%,60m
14265,2,[半个菜鸟II]玫瑰巷的乞者,2621,188,7,2,9,77.8%,1h
14265,2,坏人,2621,0,4,1,5,80.0%,13m
14265,3,FirstCute,2621,144,4,4,8,50.0%,1h
14265,2,[Rhusky]黑皮豆奶,2621,143,3,2,5,60.0%,13m
14265,1,hehe,2621,112,3,7,10,30.0%,48m
14265,2,永远的十七岁,2621,0,1,1,2,50.0%,9m
14265,2,[21CM]llllllllllll,2621,0,1,1,2,50.0%,50m
14265,3,BULIAK,2621,97,1,2,3,33.3%,12m
14265,1,月小羊,2621,0,1,4,5,20.0%,22m
14265,2,[龙猫]我爱虫虫,2621,0,0,1,1,0.0%,50m
14265,2,[薛定谔的跳虫]MAXPXM,2621,0,0,1,1,0.0%,1h
14265,2,[Sc养老]怪自己选错族,2621,0,0,1,1,0.0%,40m
14265,1,[刺客兄弟会]雅阁布,2621,0,0,1,1,0.0%,9m
14284,1,含泪甩飞龙,2620,1553,444,435,879,50.5%,38m
14284,2,提携玉龙为卿死,2620,959,43,32,75,57.3%,20m
14284,2,桜泠雪汐,2620,525,23,16,39,59.0%,1h
14284,1,[以德传人]武仙马保国,2620,546,22,17,39,56.4%,54m
14284,1,黑爸爸,2620,310,14,18,32,43.8%,20m
14284,2,[二科天下第一]御坂美琴,2620,130,7,8,15,46.7%,24m
14284,2,黑毛黑死你,2620,160,4,2,6,66.7%,4m
14284,2,[专业曹波]sinReviAr,2620,60,3,2,5,60.0%,1h
14284,2,一叶知秋,2620,62,3,2,5,60.0%,20m
14284,2,[星之所在RI]永夜,2620,78,3,5,8,37.5%,26m
14284,2,SEED,2620,0,1,0,1,100.0%,21m
14284,1,就硬冲,2620,0,0,5,5,0.0%,26m
14296,2,Yamadie,2619,972,40,35,75,53.3%,38m
14296,2,wmzwmz,2619,327,14,5,19,73.7%,26m
14296,1,[花花fans]Louis,2619,346,11,13,24,45.8%,24m
14296,3,[ljk]爱的魔力转圈圈,2619,303,11,13,24,45.8%,1h
14296,1,bcoodjk,2619,268,10,9,19,52.6%,1h
14296,2,Hairdryer,2619,214,7,3,10,70.0%,1h
14296,2,分段的发顺嘿嘿,2619,168,4,2,6,66.7%,1h
14296,3,[北京大学鸡协]vinsmoksanji,2619,99,4,5,9,44.4%,14m
14296,2,[XOPNS]GeneralCY,2619,90,3,3,6,50.0%,8m
14296,2,Hqsz,2619,144,2,5,7,28.6%,37m
14296,2,神奇的胖丁,2619,119,2,6,8,25.0%,26m
14296,2,[黎明航向]开舒克的贝塔,2619,0,1,0,1,100.0%,1h
14296,2,EmptyCity,2619,30,1,2,3,33.3%,1h
14296,2,Luhai,2619,0,0,1,1,0.0%,59m
14310,3,葬花吟魂,2618,590,35,41,76,46.1%,2m
14310,2,[股市何平]屁屁波比,2618,298,7,14,21,33.3%,1h
14310,2,SkyGemini,2618,118,4,4,8,50.0%,23m
14310,2,[LOHv]感觉瞬间,2618,46,4,6,10,40.0%,1h
14310,2,IIIIIIIIII,2618,30,2,1,3,66.7%,26m
14310,2,焯子,2618,0,1,0,1,100.0%,9m
14310,2,[谐星x]笔下生花,2618,30,1,3,4,25.0%,1h
14310,2,害怕,2618,0,0,3,3,0.0%,1h
14310,2,SERK,2618,0,0,4,4,0.0%,18m
14319,3,snake,2617,501,120,117,237,50.6%,8m
14319,2,红叶,2617,1363,102,90,192,53.1%,26m
14319,2,[不如改行玩P]Cloche,2617,1342,98,92,190,51.6%,1h
14319,1,[Anonym]lex,2617,696,39,36,75,52.0%,44m
14319,2,[欢迎加入]Artemis,2617,270,21,12,33,63.6%,5m
14319,1,贪吃兽,2617,329,13,10,23,56.5%,2m
14319,3,MVP,2617,276,8,13,21,38.1%,20m
14319,3,小小菜,2617,157,4,5,9,44.4%,39m
14319,3,xyz,2617,153,4,6,10,40.0%,13m
14319,3,辰夕,2617,97,3,3,6,50.0%,58m
14319,2,轻狂书生,2617,30,2,0,2,100.0%,22m
14319,1,起个什么名子,2617,0,2,3,5,40.0%,1h
14319,3,Srooo,2617,0,1,0,1,100.0%,15m
14319,2,需要重新集结部队,2617,0,1,0,1,100.0%,50m
14319,2,[雪胖神教]Endor,2617,30,1,1,2,50.0%,35m
14319,1,心随风动,2617,0,1,1,2,50.0%,34m
14319,2,梦烛艳,2617,0,0,1,1,0.0%,18m
14336,3,bony,2616,819,65,71,136,47.8%,25m
14336,2,Eteernity,2616,1205,49,45,94,52.1%,1h
14336,1,星际争霸真好玩,2616,531,21,17,38,55.3%,48m
14336,1,[仙女的云朵喵]忧伤的落樱,2616,350,12,15,27,44.4%,48m
14336,1,allover,2616,314,9,13,22,40.9%,48m
14336,2,摸金校尉,2616,212,8,6,14,57.1%,22m
14336,3,[魔灵圣域]ZONS,2616,173,6,4,10,60.0%,1h
14336,2,小咖,2616,154,6,5,11,54.5%,1h
14336,1,Musketeer,2616,168,5,9,14,35.7%,14m
14336,3,MasterRex,2616,0,2,3,5,40.0%,1h
14336,3,pycdexiaohao,2616,60,2,10,12,16.7%,16m
14336,2,焦傲,2616,0,1,0,1,100.0%,1h
14336,1,ATD,2616,46,1,2,3,33.3%,41m
14336,2,[男人毁在右手]Hammer,2616,96,1,3,4,25.0%,1h
14336,1,[就是坑爹]SCPLAYER,2616,36,1,5,6,16.7%,7m
14351,1,hurricane,2615,1650,195,188,383,50.9%,24m
14351,2,小桃吃不饱,2615,1010,47,27,74,63.5%,1h
14351,2,[永恒之环]惊鸿,2615,564,21,16,37,56.8%,1h
14351,1,[谁在呼叫舰队]大和炮正在干蠢狼,2615,366,15,9,24,62.5%,59m
14351,1,奇点,2615,218,12,12,24,50.0%,7m
14351,1,Zeus,2615,197,7,7,14,50.0%,7m
14351,2,轻薄的假象,2615,144,5,4,9,55.6%,1h
14351,1,[Ta不萌]停在我怀里,2615,159,5,4,9,55.6%,24m
14351,2,Luckyzerg,2615,98,4,4,8,50.0%,37m
14351,3,[886]一毛钱硬币,2615,0,3,4,7,42.9%,1h
14351,1,fighting,2615,76,3,5,8,37.5%,10m
14351,1,鲍勃的大舅,2615,96,2,0,2,100.0%,11m
14351,2,[Sc养老]soured,2615,30,2,1,3,66.7%,5m
14351,1,STARFALL,2615,102,2,4,6,33.3%,30m
14351,2,[单马尾赛高]marasaki,2615,0,0,1,1,0.0%,1h
14351,2,cooledmode,2615,0,0,1,1,0.0%,4m
14351,3,[NBU]希尔薇,2615,0,0,1,1,0.0%,1h
14368,1,[CPT]凤牙,2614,1407,290,290,580,50.0%,35m
14368,2,金黄枫叶,2614,1197,57,50,107,53.3%,38m
14368,1,那年春江花月夜,2614,1295,49,44,93,52.7%,14m
14368,1,卑微小跳虫,2614,787,32,28,60,53.3%,30m
14368,1,你可真是个鬼才,2614,724,24,26,50,48.0%,59m
14368,2,暮烟,2614,156,5,3,8,62.5%,40m
14368,2,lolicon,2614,42,4,6,10,40.0%,16m
14368,2,Neo,2614,0,3,5,8,37.5%,6m
14368,1,Cloyn,2614,34,2,4,6,33.3%,1h
14377,3,IlIIIIIIllll,2613,1018,99,97,196,50.5%,2m
14377,1,没有名字不能玩,2613,1432,55,61,116,47.4%,59m
14377,1,电中做自己,2613,566,29,24,53,54.7%,60m
14377,1,霸气的胸毛,2613,347,29,32,61,47.5%,36m
14377,3,cmzfb,2613,406,15,17,32,46.9%,15m
14377,1,华仔咧,2613,225,8,7,15,53.3%,2m
14377,3,[MUL]浮觞百夜珅,2613,151,7,2,9,77.8%,1h
14377,2,方得始终,2613,116,7,5,12,58.3%,1h
14377,2,[哀伤]千羽稚生,2613,144,3,2,5,60.0%,5m
14377,1,秋目,2613,0,2,3,5,40.0%,1h
14377,2,IORI,2613,99,1,3,4,25.0%,4m
14377,2,[暴雪五队]GOGODOG,2613,34,1,3,4,25.0%,18m
14377,2,拆迁办强拆队队长,2613,0,0,1,1,0.0%,1h
14377,2,[败给小队]丑拒所有撩,2613,0,0,2,2,0.0%,28m
14391,1,[高智商小队]豆芽小哥,2612,718,43,41,84,51.2%,13m
14391,1,阿路,2612,465,16,15,31,51.6%,5m
14391,1,堀未央奈,2612,300,11,6,17,64.7%,2m
14391,1,[情谊至上]九月中,2612,134,5,9,14,35.7%,59m
14391,2,Sean,2612,142,4,5,9,44.4%,37m
14391,1,溺光,2612,166,4,5,9,44.4%,2m
14391,2,bear,2612,60,3,1,4,75.0%,40m
14391,1,woshibbc,2612,0,2,1,3,66.7%,1h
14391,1,不想和谁做伴呢,2612,88,2,3,5,40.0%,36m
14391,1,北极熊,2612,0,2,3,5,40.0%,1h
14401,1,Jusuto,2611,949,37,39,76,48.7%,59m
14401,1,[慢手e族]多多丸,2611,673,26,28,54,48.1%,2m
14401,1,[一剑倾国]本条二亚,2611,510,24,26,50,48.0%,28m
14401,2,log,2611,213,8,4,12,66.7%,1h
14401,1,[极限菜鸟]黑暗之的舞,2611,139,5,6,11,45.5%,1h
14401,3,小熊摇摇车,2611,163,4,2,6,66.7%,41m
14401,2,[此花亭]星河,2611,142,3,1,4,75.0%,1h
14401,2,[CPT]呵呵博士,2611,0,3,5,8,37.5%,59m
14401,1,QDxun,2611,149,3,6,9,33.3%,59m
14401,3,[哇哇哇啊啊]asdfffh,2611,124,3,8,11,27.3%,9m
14401,2,凌鹰,2611,30,2,0,2,100.0%,22m
14401,1,[川北电竞]水水大王,2611,102,2,3,5,40.0%,10m
14401,1,ACDC,2611,0,2,3,5,40.0%,1h
14401,2,[搞大事]跳虫军师,2611,60,2,5,7,28.6%,1h
14415,1,ChristopherM,2610,1338,59,51,110,53.6%,1h
14415,1,[SD636]苏杭南,2610,1598,59,64,123,48.0%,1h
14415,1,llllllllllll,2610,410,24,23,47,51.1%,25m
14415,2,Rogue,2610,209,12,15,27,44.4%,25m
14415,2,[败人品者sm]IIIIIIIIIIII,2610,215,6,5,11,54.5%,1h
14415,2,[艾尔之主]树叶,2610,116,5,4,9,55.6%,18m
14415,2,Phenix,2610,42,4,5,9,44.4%,48m
14415,2,[瞬发奶]涪州丶三太子,2610,0,1,0,1,100.0%,38m
14415,2,[Trust]戒烟的神,2610,38,1,1,2,50.0%,1h
14415,2,世界级退堂鼓手,2610,0,0,1,1,0.0%,27m
14415,2,IIIIIIIIIIII,2610,0,0,1,1,0.0%,1h
14415,2,[我滴个龟龟]嘀咕隆冬起抢起,2610,0,0,2,2,0.0%,1h
14427,2,[清澄高校]Saki,2609,1372,69,58,127,54.3%,13m
14427,3,泰伯尔同族体,2609,440,29,29,58,50.0%,14m
14427,2,沐瞳,2609,382,13,15,28,46.4%,8m
14427,1,学习学疯了,2609,340,11,11,22,50.0%,24m
14427,3,神奇的小二,2609,299,10,15,25,40.0%,9m
14427,2,子午线,2609,182,6,7,13,46.2%,31m
14427,3,紫夜无光,2609,168,4,1,5,80.0%,1h
14427,1,[一起犯罪]强盗,2609,114,3,1,4,75.0%,1h
14427,3,[OgiNA]Lemon,2609,97,3,4,7,42.9%,1h
14427,2,刺客辣条,2609,0,0,1,1,0.0%,1h
14427,2,我是痞子,2609,0,0,2,2,0.0%,13m
14438,2,我是菜鸡,2608,1194,66,40,106,62.3%,1h
14438,2,菜的一批,2608,1036,44,35,79,55.7%,1h
14438,2,中等的电脑,2608,945,40,44,84,47.6%,1h
14438,1,风味餐,2608,486,37,41,78,47.4%,7m
14438,2,基根,2608,339,13,7,20,65.0%,35m
14438,1,阿克苏次,2608,241,9,9,18,50.0%,59m
14438,2,[中二疯人院]刷叉就完事了,2608,86,3,3,6,50.0%,1h
14438,1,Reese,2608,0,2,3,5,40.0%,14m
14438,1,抛弃一切冲,2608,0,2,3,5,40.0%,1h
14438,2,桑相,2608,30,1,2,3,33.3%,1h
14438,1,Beagle,2608,0,1,4,5,20.0%,4m
14449,1,枯木逢春,2607,973,59,53,112,52.7%,1h
14449,2,酸菜鱼在线挨打,2607,526,25,18,43,58.1%,58m
14449,1,THooo,2607,606,25,21,46,54.3%,1h
14449,2,[金盾男科医院]杨医生,2607,313,24,14,38,63.2%,58m
14449,2,brown,2607,409,17,11,28,60.7%,48m
14449,1,Kirin,2607,327,11,8,19,57.9%,1h
14449,2,牛宝宝,2607,281,10,10,20,50.0%,1h
14449,2,冷相惜丶,2607,199,9,5,14,64.3%,25m
14449,2,罡罡子,2607,215,8,3,11,72.7%,58m
14449,1,提叉叉,2607,169,7,5,12,58.3%,1h
14449,2,睡觉,2607,134,6,4,10,60.0%,1h
14449,2,[听山雨欲来]诸葛村夫,2607,101,6,4,10,60.0%,56m
14449,2,朱笔利酷,2607,50,3,2,5,60.0%,1h
14449,2,[半个菜鸟]TARKIN,2607,66,3,3,6,50.0%,23m
14449,2,[RNavy]Belfast,2607,30,2,0,2,100.0%,38m
14449,2,炸鱼没妈,2607,30,1,2,3,33.3%,42m
14465,3,[汉堡FANS]常德郭富城,2606,655,30,32,62,48.4%,18m
14465,3,[菜的没人带]大佬带带我啊,2606,457,17,34,51,33.3%,15m
14465,2,November,2606,289,12,13,25,48.0%,52m
14465,2,[崩溃大队]fffd,2606,194,8,2,10,80.0%,1h
14465,2,小萌新,2606,112,3,0,3,100.0%,40m
14465,2,[经常一起玩的]名字好难取啊,2606,95,3,4,7,42.9%,11m
14465,1,阿天哥,2606,0,2,3,5,40.0%,1h
14465,3,车头,2606,0,2,4,6,33.3%,25m
14465,2,八云金,2606,0,1,1,2,50.0%,48m
14465,1,阿童和木木,2606,96,1,4,5,20.0%,12m
14465,2,lmh,2606,0,0,1,1,0.0%,26m
14465,2,一条蛇,2606,0,0,1,1,0.0%,37m
14465,2,冰镇大西瓜,2606,0,0,1,1,0.0%,9m
14465,3,hhh,2606,0,0,2,2,0.0%,1h
14465,1,战歌破秦殇,2606,0,0,3,3,0.0%,37m
14480,3,小木,2605,341,102,100,202,50.5%,9m
14480,2,IIIIIIIIIIII,2605,416,16,14,30,53.3%,28m
14480,2,heheda,2605,414,14,15,29,48.3%,1h
14480,2,[爆杀]紫荆茶天,2605,319,13,9,22,59.1%,1h
14480,2,[Mentor]白上吹雪,2605,322,11,10,21,52.4%,9m
14480,2,不朽亡灵,2605,188,5,4,9,55.6%,5m
14480,2,DEMO,2605,126,4,1,5,80.0%,28m
14480,2,IZNine,2605,46,4,6,10,40.0%,1h
14480,2,eafewadw,2605,0,1,0,1,100.0%,40m
14489,2,灰常神奇,2604,1596,180,169,349,51.6%,1h
14489,3,[火焰雷兽]StrBro,2604,578,22,25,47,46.8%,20m
14489,3,吮吸我的脚趾,2604,250,14,15,29,48.3%,15m
14489,2,[究极哈批]纸上画魅,2604,114,5,2,7,71.4%,40m
14489,2,Samsara,2604,103,5,4,9,55.6%,1h
14489,2,OverLoad,2604,177,4,5,9,44.4%,1h
14489,2,[星际联盟军团]有本事打死我啊,2604,131,3,1,4,75.0%,21m
14489,1,[卡巴内酷]半仙,2604,0,2,2,4,50.0%,55m
14489,1,疯修林,2604,0,2,3,5,40.0%,53m
14489,1,Bigboos,2604,0,2,3,5,40.0%,53m
14489,2,[自创]zzx,2604,30,1,1,2,50.0%,23m
14489,2,[汉堡FANS]wuliang,2604,0,0,1,1,0.0%,1h
14489,2,OptiMissTake,2604,0,0,3,3,0.0%,1h
14502,2,Boogiepop,2603,1357,59,40,99,59.6%,1h
14502,3,[我菜请打队友]chenkacheng,2603,1157,56,58,114,49.1%,7m
14502,1,[Galet]gosh,2603,1098,54,44,98,55.1%,10m
14502,3,一切战术转为换家,2603,287,25,32,57,43.9%,34m
14502,3,[ZZYZSC]神秘博士,2603,630,24,30,54,44.4%,26m
14502,1,[鬓已星星也]Rffu,2603,169,14,15,29,48.3%,48m
14502,3,天边的一朵云,2603,342,14,17,31,45.2%,17m
14502,2,BIGBOSSSSSSS,2603,237,7,9,16,43.8%,1h
14502,2,在城,2603,92,4,2,6,66.7%,1h
14502,2,久城,2603,64,3,2,5,60.0%,1h
14502,2,XYQ,2603,0,1,0,1,100.0%,55m
14502,2,[YA]AFcstats,2603,0,1,0,1,100.0%,1h
14502,2,wen,2603,30,1,1,2,50.0%,29m
14502,2,wyj,2603,0,0,1,1,0.0%,27m
14516,2,小迪大小姐,2602,144,4,3,7,57.1%,35m
14516,3,[超牛]好牛的牛,2602,97,3,3,6,50.0%,13m
14516,3,[艾卫道特联盟]莱宁锡特,2602,38,2,2,4,50.0%,1h
14516,1,封心之恋,2602,94,1,1,2,50.0%,1h
14516,3,Ancestor,2602,30,1,2,3,33.3%,29m
14516,2,上杉绘梨依,2602,30,1,4,5,20.0%,38m
14516,1,人族死法示范,2602,88,1,6,7,14.3%,14m
14516,1,[旺旺战士]sickly,2602,42,1,8,9,11.1%,24m
14524,2,三十七摄氏度,2601,1543,73,66,139,52.5%,1h
14524,1,[小仙女上线啦]NOLF,2601,372,29,27,56,51.8%,1h
14524,1,流觞,2601,541,25,24,49,51.0%,48m
14524,2,老仙奶我人生不顺,2601,540,20,20,40,50.0%,22m
14524,1,Ares,2601,300,9,9,18,50.0%,39m
14524,2,杰森,2601,220,7,8,15,46.7%,1h
14524,1,一梦千年,2601,48,4,2,6,66.7%,11m
14524,1,安德鲁,2601,0,3,2,5,60.0%,1h
14524,1,邓林,2601,86,3,3,6,50.0%,1h
14524,2,孤狼,2601,94,3,5,8,37.5%,1h
14524,2,么子洲,2601,0,1,0,1,100.0%,60m
14524,2,Eric,2601,0,1,1,2,50.0%,1h
14524,2,虚空行者,2601,0,1,1,2,50.0%,1h
14524,3,独立者号,2601,0,1,5,6,16.7%,10m
14524,2,蓝疾,2601,0,0,2,2,0.0%,4m
14524,2,zipper,2601,0,0,3,3,0.0%,23m
14540,1,脑虫在世输本酱,2600,922,34,29,63,54.0%,60m
14540,1,侍魂,2600,432,19,17,36,52.8%,37m
14540,2,oooooo,2600,96,16,23,39,41.0%,31m
14540,2,suv,2600,316,14,12,26,53.8%,48m
14540,2,蒹葭苍茫猪猪侠,2600,272,10,3,13,76.9%,1h
14540,2,[浴火银河]取颅者,2600,210,7,3,10,70.0%,13m
14540,2,[黑暗在翻騰]MISSxiaodi,2600,184,6,7,13,46.2%,60m
14540,1,Leiurus,2600,201,6,9,15,40.0%,57m
14540,2,影者,2600,190,5,4,9,55.6%,40m
14540,2,丨信丶息丶人,2600,122,5,5,10,50.0%,22m
14540,3,[舰队训练营]孙逸枫,2600,151,5,6,11,45.5%,1h
14540,2,Locust,2600,176,4,12,16,25.0%,29m
14540,2,一分钱,2600,138,3,2,5,60.0%,1h
14540,2,[NPCS]朝晴玖,2600,90,2,0,2,100.0%,31m
14540,1,fff,2600,0,2,3,5,40.0%,1h
14540,3,[崑焅]怀言者,2600,0,2,4,6,33.3%,1h
14540,2,[狂想曲]尼玛,2600,0,1,0,1,100.0%,35m
14540,1,[5624]戊烷,2600,0,1,1,2,50.0%,1h
14540,2,LoveLuLU,2600,0,0,1,1,0.0%,1h
14540,2,[xhwya]你吗嫁人啦,2600,0,0,1,1,0.0%,26m
14540,2,萌新小虫子,2600,0,0,1,1,0.0%,29m
14540,2,liu,2600,0,0,2,2,0.0%,1h
14562,3,[CPT]开心无敌,2599,537,154,151,305,50.5%,36m
14562,1,人间不值得,2599,358,15,9,24,62.5%,46m
14562,2,[你已经死啦]可怜孩子在线虐人,2599,295,14,10,24,58.3%,40m
14562,1,[KPG2]lybbbbb,2599,270,8,8,16,50.0%,1h
14562,1,[缪丨葵]Sunshine,2599,264,7,10,17,41.2%,44m
14562,2,xzx,2599,146,6,5,11,54.5%,1h
14562,2,韶华,2599,94,5,3,8,62.5%,48m
14562,2,GreenXN,2599,126,3,1,4,75.0%,35m
14562,2,[Fisker]Layzhang,2599,102,2,1,3,66.7%,1h
14562,2,[自由的气息]刺蛇说的都对,2599,32,2,4,6,33.3%,40m
14562,1,[ZLR]Zimba,2599,0,1,4,5,20.0%,38m
14562,1,[暗影之怒]塔萨达地狱咆哮,2599,0,0,1,1,0.0%,1h
14562,1,我爱黄沙飞,2599,0,0,1,1,0.0%,51m
14562,2,[暴雪我是你爹]天凌殇丶,2599,0,0,3,3,0.0%,38m
14576,1,[JNFLS]CHaRMING,2598,748,35,19,54,64.8%,34m
14576,2,爱的黎明,2598,772,33,32,65,50.8%,52m
14576,2,boki,2598,571,23,24,47,48.9%,13m
14576,1,[GSL联赛]Dimension,2598,666,23,26,49,46.9%,10m
14576,2,药师帆,2598,357,13,13,26,50.0%,58m
14576,2,小拉基姐姐,2598,200,7,8,15,46.7%,1h
14576,2,学艺使人长胖,2598,190,6,3,9,66.7%,20m
14576,2,[星际真的好难]星际好难,2598,128,4,0,4,100.0%,1h
14576,1,黑色长城,2598,167,4,7,11,36.4%,22m
14576,1,卡比兽的蛋,2598,146,4,8,12,33.3%,20m
14576,2,思想落后的人,2598,64,3,2,5,60.0%,22m
14576,2,[秋毫七队]thebusy,2598,0,0,1,1,0.0%,1h
14576,3,瞎玩,2598,0,0,2,2,0.0%,59m
14576,1,火遁凤仙火,2598,0,0,3,3,0.0%,1h
14590,3,[Rooter]JediMaster,2597,1494,77,82,159,48.4%,13m
14590,1,魔法少女文森特,2597,1177,45,46,91,49.5%,1h
14590,1,林诺诺,2597,446,39,54,93,41.9%,25m
14590,3,[式神]卖萌的魔方,2597,821,32,37,69,46.4%,2m
14590,3,Chickabiddy,2597,799,30,33,63,47.6%,15m
14590,2,触怒,2597,441,17,13,30,56.7%,25m
14590,2,仅取折扇入虹晨,2597,204,8,3,11,72.7%,38m
14590,1,[英俊谐会]梦魇,2597,139,5,7,12,41.7%,1h
14590,2,砰砰乎,2597,114,3,1,4,75.0%,35m
14590,1,KING,2597,0,2,2,4,50.0%,45m
14590,1,[你好抱歉]cerry,2597,0,2,3,5,40.0%,4m
14590,2,[黎明前线]苯上人,2597,60,2,3,5,40.0%,51m
14590,3,Punch,2597,0,2,4,6,33.3%,41m
14590,2,kikozhu,2597,0,1,1,2,50.0%,37m
14590,1,Jinjun,2597,0,1,1,2,50.0%,11m
14590,2,Architext,2597,0,1,1,2,50.0%,1h
14590,1,十七岁乞丐当歌手,2597,97,1,1,2,50.0%,41m
14590,2,[孙海U换礁]番荔枝,2597,0,0,1,1,0.0%,25m
14608,3,Vincent,2596,1326,75,58,133,56.4%,23m
14608,1,苹果原子弹,2596,1005,39,35,74,52.7%,13m
14608,1,[胖虎稽查队]Zerg,2596,838,30,30,60,50.0%,48m
14608,1,[暴雪二十队]茸茸,2596,489,18,16,34,52.9%,48m
14608,1,[旺旺战士]Light,2596,424,17,17,34,50.0%,1h
14608,1,[乌拉龟龟]凤舞九天,2596,361,16,12,28,57.1%,20m
14608,1,zongjingbo,2596,282,9,12,21,42.9%,1h
14608,1,dvakxy,2596,242,7,13,20,35.0%,27m
14608,3,徐大人,2596,220,6,5,11,54.5%,58m
14608,2,MLNB,2596,182,6,6,12,50.0%,21m
14608,2,[我只会大招]凌厉,2596,140,4,1,5,80.0%,37m
14608,2,buster,2596,112,3,0,3,100.0%,8m
14608,1,KINGKONG,2596,0,3,2,5,60.0%,9m
14608,2,一个滑稽,2596,30,2,1,3,66.7%,29m
14608,1,[落魄山]manman,2596,0,1,4,5,20.0%,37m
14608,2,DNAkendrick,2596,0,0,2,2,0.0%,23m
14608,2,[天地會分舵]VOICE,2596,0,0,2,2,0.0%,52m
14625,2,redmoon,2595,325,39,24,63,61.9%,20m
14625,2,Migi,2595,694,26,27,53,49.1%,1h
14625,2,炫真龙,2595,298,20,27,47,42.6%,17m
14625,2,[巴楚文化广场]小史有毒,2595,285,12,8,20,60.0%,42m
14625,2,[盲眼钟表匠]shy,2595,243,10,7,17,58.8%,1h
14625,3,小胖的朋友阿文,2595,30,5,3,8,62.5%,54m
14625,1,termanary,2595,72,3,6,9,33.3%,60m
14625,2,[神明]噢噢噢噢,2595,102,2,1,3,66.7%,1h
14625,2,Spider,2595,93,2,2,4,50.0%,38m
14625,1,[小鸡爱啄米丶]金十淮九,2595,0,0,2,2,0.0%,1h
14635,1,Blackmagic,2594,1570,116,115,231,50.2%,28m
14635,2,敢叫日月换新天,2594,1578,68,52,120,56.7%,1h
14635,2,真空快递员,2594,762,36,16,52,69.2%,1h
14635,1,梅哥,2594,449,18,15,33,54.5%,20m
14635,1,[幽灵闪现wo]饿饿饿,2594,290,9,15,24,37.5%,1h
14635,2,沉默之剑,2594,226,8,9,17,47.1%,1h
14635,2,清醒独到,2594,165,4,2,6,66.7%,40m
14635,2,[壹拉捌]fvck,2594,0,3,2,5,60.0%,40m
14635,1,ZuoZhu,2594,0,3,2,5,60.0%,55m
14635,2,蓝天白菜,2594,88,2,0,2,100.0%,42m
14635,1,hakunamatata,2594,66,2,9,11,18.2%,27m
14635,2,[坦克36D]MagicTeddy,2594,0,1,0,1,100.0%,1h
14635,2,[幻想舰队]炎丨虎,2594,30,1,3,4,25.0%,4m
14635,2,ArroganceMrY,2594,0,0,1,1,0.0%,40m
14635,2,[开菊怪]夜雨升凡,2594,0,0,1,1,0.0%,1h
14650,1,[在下菜鸡一只]mountc,2593,1538,104,89,193,53.9%,20m
14650,2,wie,2593,1537,62,67,129,48.1%,25m
14650,3,濛江鸡蛋先生,2593,1102,47,46,93,50.5%,14m
14650,2,彭立辉,2593,829,38,21,59,64.4%,29m
14650,2,[无魂之鸭]齐峰大帅比,2593,858,38,28,66,57.6%,1h
14650,3,[Yn1]RushRer,2593,162,6,4,10,60.0%,44m
14650,2,海东今,2593,216,6,4,10,60.0%,29m
14650,2,[起源]agang,2593,138,3,2,5,60.0%,4m
14650,2,himan,2593,30,1,4,5,20.0%,35m
14650,2,[为了Amon]利姆露老爷,2593,0,0,1,1,0.0%,37m
14650,2,[曾经一群兔兔]曾经有两只兔子,2593,0,0,1,1,0.0%,1h
14650,2,lonewolf,2593,0,0,1,1,0.0%,1h
14662,2,KEVIN,2592,1524,183,186,369,49.6%,40m
14662,2,新手电脑,2592,294,26,28,54,48.1%,1h
14662,2,他马的,2592,404,13,13,26,50.0%,4m
14662,2,真理之云,2592,336,12,9,21,57.1%,8m
14662,3,BFF,2592,227,9,3,12,75.0%,1h
14662,1,瑞神,2592,212,5,6,11,45.5%,44m
14662,3,虚空之遗,2592,121,3,5,8,37.5%,29m
14662,3,不要干就是怂,2592,30,3,5,8,37.5%,1h
14662,1,猴子训练师,2592,0,3,6,9,33.3%,12m
14662,3,ASP,2592,131,2,3,5,40.0%,1h
14662,2,[CPT]啥啊你们在哪,2592,66,2,3,5,40.0%,1h
14662,3,黑伽,2592,0,2,4,6,33.3%,9m
14662,2,[星歌]智勇双全秋风瑟,2592,0,1,0,1,100.0%,38m
14662,2,[长征小白]沙加在世,2592,0,1,0,1,100.0%,40m
14662,2,郎中,2592,0,1,1,2,50.0%,1h
14662,3,[手残80後]TankSir,2592,32,1,2,3,33.3%,9m
14662,2,[ddf战甲]先杀暴民,2592,0,0,1,1,0.0%,28m
14662,2,千夜,2592,0,0,1,1,0.0%,42m
14662,2,editor,2592,0,0,2,2,0.0%,8m
14662,2,张澈凯,2592,0,0,3,3,0.0%,58m
14682,3,南乡,2591,1474,67,63,130,51.5%,19m
14682,2,涵爷爷,2591,877,31,33,64,48.4%,1h
14682,2,痴呆诅咒,2591,663,25,20,45,55.6%,1h
14682,1,我选择死亡,2591,444,17,18,35,48.6%,54m
14682,1,JiaHuan,2591,427,14,15,29,48.3%,39m
14682,1,莫非,2591,307,9,12,21,42.9%,7m
14682,2,OrcPlus,2591,170,7,9,16,43.8%,1h
14682,3,Dysun,2591,36,2,1,3,66.7%,60m
14682,1,[小仙女上线啦]不能一错再错,2591,0,2,3,5,40.0%,29m
14682,2,无从下手,2591,0,0,1,1,0.0%,1h
14682,2,Boomfire,2591,0,0,1,1,0.0%,38m
14682,2,人族永不言弃,2591,0,0,1,1,0.0%,1h
14682,3,风华绝代的悍匪,2591,0,0,1,1,0.0%,1h
14682,2,手持杀猪刀,2591,0,0,1,1,0.0%,35m
14696,1,球球,2590,1072,89,92,181,49.2%,14m
14696,1,铭楼,2590,686,69,57,126,54.8%,6m
14696,1,mangchong,2590,794,49,39,88,55.7%,1h
14696,2,rules,2590,299,16,12,28,57.1%,1h
14696,1,雅儿贝德,2590,313,13,9,22,59.1%,37m
14696,2,环彩羽,2590,245,8,6,14,57.1%,25m
14696,2,蕾姆是我老婆,2590,0,0,1,1,0.0%,1h
14696,2,[很菜弹药丸]fengshi,2590,0,0,1,1,0.0%,42m
14704,2,jerry,2589,1199,75,64,139,54.0%,29m
14704,2,[幽灵闪现wo]laofang,2589,1460,60,61,121,49.6%,52m
14704,1,[不打GG]Lovecraft,2589,671,50,46,96,52.1%,60m
14704,3,翌日,2589,147,4,5,9,44.4%,1h
14704,2,人族怎么打嘛,2589,142,4,11,15,26.7%,35m
14704,3,星际争霸,2589,121,3,5,8,37.5%,1h
14704,1,[本子画师]对月亮讲晚安,2589,124,2,5,7,28.6%,37m
14704,2,厂狗叶,2589,0,1,0,1,100.0%,52m
14704,2,[汝负]celestial,2589,0,1,0,1,100.0%,1h
14704,1,[晋升者]santenlow,2589,0,1,4,5,20.0%,53m
14704,2,[童话小镇]没兴奋剂的枪兵,2589,0,0,3,3,0.0%,1h
14715,2,JAJ,2588,469,24,16,40,60.0%,8m
14715,2,老滚零四特区,2588,340,12,15,27,44.4%,1h
14715,2,[科普鲁区分部]Kyrie,2588,228,9,5,14,64.3%,25m
14715,2,ExCALer,2588,115,4,5,9,44.4%,1h
14715,2,Sora,2588,30,2,1,3,66.7%,28m
14715,3,[迷宫丨极限组]十一,2588,97,2,1,3,66.7%,1h
14715,1,[胡杨]星星小欢,2588,0,1,4,5,20.0%,1h
14715,2,暴力鹿,2588,0,0,1,1,0.0%,1h
14715,3,[LDP]她说放不下他,2588,0,0,1,1,0.0%,1h
14715,1,CHINaSKyGT,2588,0,0,1,1,0.0%,1h
14725,2,晚上吃啥,2587,1580,145,136,281,51.6%,23m
14725,2,铁男,2587,1334,95,99,194,49.0%,22m
14725,1,胖头鱼,2587,717,38,33,71,53.5%,44m
14725,1,丛可人,2587,256,9,12,21,42.9%,1h
14725,2,[葛温王下骑士]月夜,2587,221,7,4,11,63.6%,31m
14725,1,Titans,2587,165,7,7,14,50.0%,44m
14725,1,ZSK,2587,219,5,6,11,45.5%,2m
14725,2,[GSZCX]JJJJJJJJJosh,2587,114,3,1,4,75.0%,8m
14725,3,量子丶波函数坍缩,2587,0,2,5,7,28.6%,1h
14725,3,束默心,2587,0,0,1,1,0.0%,29m
14725,1,[五月花]空指针异虫,2587,0,0,1,1,0.0%,42m
14725,2,我是大神不怕你耶,2587,0,0,4,4,0.0%,1h
14737,2,神哥,2586,586,38,27,65,58.5%,1h
14737,2,最强吃鸡特种兵,2586,141,10,13,23,43.5%,48m
14737,2,可乃的小萝莉,2586,195,9,5,14,64.3%,7m
14737,1,西哥,2586,231,7,10,17,41.2%,8m
14737,3,[菜有菜的道理]JzyParadise,2586,68,6,10,16,37.5%,1h
14737,3,[星舰与太阳x]小小号,2586,153,4,0,4,100.0%,16m
14737,2,[藤原书记]手残党啊,2586,128,3,3,6,50.0%,27m
14737,2,闷哥,2586,93,3,5,8,37.5%,9m
14737,2,[HJ灬GD]赤子,2586,91,3,5,8,37.5%,55m
14737,2,LAG,2586,92,3,5,8,37.5%,1h
14737,2,[一群谐星]Abelard,2586,34,2,2,4,50.0%,1h
14737,1,Seaser,2586,0,2,3,5,40.0%,1h
14737,2,好兄弟无穷无尽,2586,60,2,5,7,28.6%,38m
14737,2,青瓷酒,2586,0,1,0,1,100.0%,18m
14737,2,海深时浪涌,2586,0,1,0,1,100.0%,1h
14737,2,误点的闹钟,2586,0,0,3,3,0.0%,1h
14753,1,Ender,2585,1596,394,400,794,49.6%,24m
14753,1,如若梦似彩虹,2585,1287,81,78,159,50.9%,7m
14753,1,[活着为了爆菊]掉分的快乐,2585,1183,54,37,91,59.3%,2m
14753,1,SuPRe,2585,522,17,25,42,40.5%,1h
14753,1,ZergSwarm,2585,255,10,9,19,52.6%,41m
14753,2,tesla,2585,206,8,4,12,66.7%,35m
14753,1,BOLSHEVIK,2585,196,6,5,11,54.5%,15m
14753,2,lin,2585,97,5,3,8,62.5%,1h
14753,2,[8999ms]Nero,2585,188,5,5,10,50.0%,52m
14753,2,jytjtyutjtyy,2585,118,4,6,10,40.0%,18m
14753,3,[深邃黑色幻想]刹那又何必永恒,2585,0,3,3,6,50.0%,57m
14753,2,双子,2585,138,3,3,6,50.0%,8m
14753,1,[镜花水月]向我开炮,2585,66,2,9,11,18.2%,1h
14753,2,邢主,2585,30,1,3,4,25.0%,1h
14753,2,在黑夜中,2585,0,0,1,1,0.0%,38m
14753,1,vksir,2585,0,0,1,1,0.0%,26m
14769,3,米二狗,2584,666,58,49,107,54.2%,2m
14769,3,zzzzz,2584,1314,52,57,109,47.7%,5m
14769,2,[透一下清酒]永远喜欢着鹿乃,2584,860,42,21,63,66.7%,1h
14769,2,饼干,2584,371,14,14,28,50.0%,35m
14769,2,多弗朗冥歌,2584,247,9,5,14,64.3%,1h
14769,3,全知全能的树,2584,136,9,9,18,50.0%,1h
14769,2,二五仔,2584,228,6,6,12,50.0%,1h
14769,2,萌萌哒的小熊猫,2584,125,3,2,5,60.0%,1h
14769,3,TIOSAME,2584,44,2,2,4,50.0%,4m
14769,3,苏打水,2584,0,2,4,6,33.3%,1h
14769,3,[SABER丶]霂凨,2584,0,2,5,7,28.6%,1h
14769,2,枫妍,2584,35,2,8,10,20.0%,38m
14769,1,[44折磨星际]鲁班七号,2584,0,1,0,1,100.0%,22m
14769,2,聪明小猪,2584,0,1,2,3,33.3%,1h
14769,3,神般暴走,2584,0,0,1,1,0.0%,1h
14784,1,snowysummer,2583,1449,244,230,474,51.5%,1h
14784,1,流泪的铁罐,2583,1582,119,112,231,51.5%,13m
14784,2,Prophet,2583,1062,74,63,137,54.0%,23m
14784,2,星空之星,2583,549,20,31,51,39.2%,8m
14784,2,[Sc养老]erlengdie,2583,204,8,2,10,80.0%,25m
14784,1,Rockfeller,2583,132,3,5,8,37.5%,1h
14784,2,王玉的王,2583,58,2,3,5,40.0%,1h
14784,2,[Globus]无敌的骚一,2583,0,1,0,1,100.0%,1h
14784,2,路明飞,2583,0,1,2,3,33.3%,7m
14784,2,[幽森恐怖]羟基乙二醇,2583,30,1,4,5,20.0%,1h
14784,2,最爱西瓜汁,2583,0,0,1,1,0.0%,6m
14784,2,小杯普洱茶,2583,0,0,1,1,0.0%,29m
14784,2,NerazimLaika,2583,0,0,1,1,0.0%,1h
14797,2,MrsAng,2582,1588,74,60,134,55.2%,1h
14797,3,[艾尔之巅]IIIIIIIIIIII,2582,776,30,37,67,44.8%,34m
14797,2,分裂,2582,592,28,37,65,43.1%,41m
14797,1,[全院的希望]我走位风骚,2582,188,7,9,16,43.8%,1h
14797,2,BuringArice,2582,112,3,1,4,75.0%,4m
14797,3,[我虽无力逐鹿]同化完成,2582,121,3,2,5,60.0%,1h
14797,1,[鸡唧唧叽乐团]magicNOVA,2582,121,3,3,6,50.0%,1h
14797,1,一勾兴,2582,0,2,3,5,40.0%,1h
14797,3,小家伙,2582,0,1,0,1,100.0%,1h
14797,2,百鬼丸多多,2582,0,0,1,1,0.0%,1h
14797,2,[花花幼儿园]我要狙击一束七,2582,0,0,2,2,0.0%,8m
14808,2,pimbaisuck,2581,805,51,48,99,51.5%,1h
14808,3,小猫不淘气,2581,1095,42,45,87,48.3%,15m
14808,1,可怜的人,2581,333,25,20,45,55.6%,1h
14808,2,Rays,2581,404,19,18,37,51.4%,48m
14808,1,抽刀断水水更流,2581,410,18,20,38,47.4%,46m
14808,3,BXNMB,2581,192,6,6,12,50.0%,1h
14808,1,Latiaoqaq,2581,209,6,10,16,37.5%,44m
14808,1,牧人普罗透斯,2581,0,2,3,5,40.0%,26m
14808,3,[船舶人]镰仓先生,2581,0,1,0,1,100.0%,1h
14808,2,地保怪八零三,2581,90,1,1,2,50.0%,6m
14808,2,JIANG,2581,32,1,2,3,33.3%,6m
14808,1,阿拉纳克,2581,81,1,4,5,20.0%,28m
14808,2,萌新夫特曼,2581,0,0,3,3,0.0%,26m
14821,3,祈求者,2580,932,42,41,83,50.6%,39m
14821,2,Adele,2580,666,28,27,55,50.9%,13m
14821,2,李少,2580,355,17,21,38,44.7%,1h
14821,1,可恶的忍者,2580,327,14,10,24,58.3%,1h
14821,1,RENDERS,2580,351,12,5,17,70.6%,39m
14821,2,若风,2580,256,9,9,18,50.0%,6m
14821,3,居然琴瑟起,2580,239,9,13,22,40.9%,1h
14821,2,朱纳尔多,2580,256,8,7,15,53.3%,1h
14821,2,mylifefaiur,2580,198,8,10,18,44.4%,1h
14821,2,[配合是王道]欣欣西瓜汁,2580,158,6,7,13,46.2%,1h
14821,1,沁淇,2580,0,3,2,5,60.0%,1h
14821,2,Byron,2580,116,2,2,4,50.0%,26m
14821,1,你不会懂我,2580,48,2,2,4,50.0%,53m
14821,2,错过,2580,64,2,3,5,40.0%,1h
14821,3,night,2580,0,2,4,6,33.3%,1h
14821,3,hxj,2580,97,2,5,7,28.6%,35m
14821,2,[萝协会]贤者,2580,0,1,0,1,100.0%,47m
14821,3,人生若只如初见,2580,0,1,0,1,100.0%,1h
14821,2,[北极光小组]七殇无言,2580,0,0,2,2,0.0%,37m
14821,2,[Fe3o4]她和月亮一样温柔,2580,0,0,3,3,0.0%,23m
14841,1,明明阿明,2579,864,62,62,124,50.0%,7m
14841,1,[打铁自身硬]Destory,2579,466,18,18,36,50.0%,1h
14841,1,[小仙女上线啦]次级子个体,2579,247,13,16,29,44.8%,44m
14841,2,lllllllll,2579,321,11,20,31,35.5%,52m
14841,2,游埠流浪汉,2579,266,9,7,16,56.2%,1h
14841,2,啊这,2579,270,9,10,19,47.4%,38m
14841,2,Sunephone,2579,196,7,9,16,43.8%,1h
14841,1,继明栖身,2579,143,5,4,9,55.6%,12m
14841,1,iiiiiiii,2579,209,4,9,13,30.8%,44m
14841,2,wtf,2579,94,3,2,5,60.0%,1h
14841,2,云天自在,2579,30,2,1,3,66.7%,22m
14841,2,[综合酯法]人人有功练,2579,0,1,0,1,100.0%,1h
14841,3,[Mentor]队友呢快救我,2579,36,1,1,2,50.0%,35m
14841,2,菜鸟,2579,42,1,2,3,33.3%,50m
14841,2,[哇哦]wqwq,2579,0,0,1,1,0.0%,23m
14841,2,[二中星际男孩]苍龙不屈意,2579,0,0,3,3,0.0%,1h
14857,2,澜哥哲沧江,2578,1585,164,148,312,52.6%,28m
14857,3,ZJC,2578,1381,83,81,164,50.6%,14m
14857,1,彡彡爱,2578,665,24,32,56,42.9%,7m
14857,2,[HHHH]IlIlIlIlIlIl,2578,211,6,9,15,40.0%,38m
14857,2,电竞未来,2578,165,5,4,9,55.6%,36m
14857,1,[48K纯帅]电脑玩家普通,2578,225,4,5,9,44.4%,9m
14857,3,starliu,2578,97,3,4,7,42.9%,1h
14857,2,Olivvver,2578,44,2,3,5,40.0%,7m
14857,2,世界好大,2578,58,2,3,5,40.0%,1h
14857,1,NomadPlanet,2578,0,2,3,5,40.0%,1h
14857,3,大器晚成,2578,0,1,1,2,50.0%,14m
14857,1,[逸仙谐星]Corleone,2578,0,1,4,5,20.0%,1h
14857,2,爞憧痋衝,2578,0,0,1,1,0.0%,1h
14870,2,新手,2577,1535,125,131,256,48.8%,1h
14870,2,BloodSky,2577,1518,113,95,208,54.3%,1h
14870,2,五木,2577,1144,73,56,129,56.6%,1h
14870,2,小明,2577,667,27,19,46,58.7%,1h
14870,2,飞花逐月,2577,637,26,23,49,53.1%,1h
14870,3,风中凌乱,2577,167,5,4,9,55.6%,1h
14870,2,[五十块好兄弟]燃烧,2577,154,4,4,8,50.0%,1h
14870,2,姓曹名备字仲谋,2577,120,4,6,10,40.0%,1h
14870,2,llllllllllll,2577,112,3,1,4,75.0%,8m
14870,2,欧西里斯的天空龙,2577,58,3,2,5,60.0%,9m
14870,2,[星际小女孩]edison,2577,88,1,1,2,50.0%,22m
14870,2,逍遥天境,2577,88,1,1,2,50.0%,1h
14870,3,TOLEIED,2577,0,1,1,2,50.0%,56m
14870,2,Rage,2577,0,0,1,1,0.0%,1h
14870,1,[极限菜鸟]东东东东东丶,2577,0,0,1,1,0.0%,44m
14885,2,木叶的柱间,2576,352,15,6,21,71.4%,29m
14885,2,网下,2576,294,11,9,20,55.0%,1h
14885,1,[Nostop]傲娇小姐姐,2576,233,8,11,19,42.1%,59m
14885,3,真的大丈夫,2576,211,8,11,19,42.1%,18m
14885,2,[fanche]科洛桑的霓虹,2576,246,8,12,20,40.0%,8m
14885,2,梦违科学世纪,2576,235,6,8,14,42.9%,1h
14885,2,[奶农]爷创造神话嗯,2576,182,5,10,15,33.3%,1h
14885,1,holymosquito,2576,48,2,4,6,33.3%,1h
14885,3,老班,2576,0,2,4,6,33.3%,1h
14885,1,云雨浩瀚,2576,0,1,4,5,20.0%,1h
14885,2,一默一,2576,0,0,1,1,0.0%,42m
14885,3,国服第一白给,2576,0,0,1,1,0.0%,1h
14885,2,FUNZZY,2576,0,0,1,1,0.0%,1h
14885,2,[DMRc]cry,2576,0,0,1,1,0.0%,1h
14885,1,永暗无尽,2576,0,0,1,1,0.0%,1h
14885,2,骚太阳,2576,0,0,3,3,0.0%,1h
14901,2,徐州王强,2575,1071,186,188,374,49.7%,6m
14901,2,扎克,2575,1047,46,41,87,52.9%,18m
14901,2,[吼吼吼]sonny,2575,663,28,17,45,62.2%,1h
14901,1,goldenseed,2575,223,10,10,20,50.0%,54m
14901,2,cyc,2575,154,5,2,7,71.4%,20m
14901,3,[TAK]syd,2575,157,4,3,7,57.1%,1h
14901,3,RMKL,2575,121,4,5,9,44.4%,1h
14901,1,[天使微笑]骚是骚猪的骚,2575,0,3,2,5,60.0%,1h
14901,2,坠花湮蝉戏,2575,102,2,2,4,50.0%,37m
14901,3,PSIzzZ,2575,0,2,4,6,33.3%,30m
14901,3,巴西龟,2575,0,2,4,6,33.3%,1h
14901,2,闪亮之翼,2575,0,1,0,1,100.0%,27m
14901,2,[绝世高手]丿爆小七,2575,88,1,1,2,50.0%,1h
14901,2,不不不不,2575,0,1,2,3,33.3%,1h
14901,2,[113]达文西,2575,0,1,3,4,25.0%,14m
14916,1,[Miku骑士]Snowdrop,2574,1000,83,77,160,51.9%,48m
14916,3,PIAODD,2574,937,34,42,76,44.7%,18m
14916,2,[飞雷神]超越神一般的存在,2574,542,28,21,49,57.1%,1h
14916,1,ALTerNatIVe,2574,774,26,33,59,44.1%,8m
14916,1,[丨SLT丨]lllllllllill,2574,629,25,24,49,51.0%,27m
14916,3,panic,2574,717,23,31,54,42.6%,41m
14916,1,小丑竟是我自己,2574,572,21,24,45,46.7%,29m
14916,2,[曾经一群兔子]曾经一只兔兔,2574,433,20,13,33,60.6%,52m
14916,3,SWORD,2574,397,16,25,41,39.0%,19m
14916,2,[半夏]KKblood,2574,232,10,7,17,58.8%,1h
14916,1,冰阔落,2574,186,9,11,20,45.0%,14m
14916,2,Tim,2574,218,8,10,18,44.4%,7m
14916,3,阿卡四十七,2574,167,7,2,9,77.8%,33m
14916,1,[求战队呀]Mayuri,2574,181,4,3,7,57.1%,1h
14916,2,BayernMuller,2574,0,3,6,9,33.3%,60m
14916,1,[Beasty]冷冷的笑,2574,129,2,7,9,22.2%,6m
14916,1,[爱星际丨风暴]aizomi,2574,0,1,0,1,100.0%,26m
14916,3,[天府禁军]我不想取名,2574,0,1,1,2,50.0%,18m
14916,2,[MFX]NestleMilk,2574,30,1,4,5,20.0%,22m
14916,1,hfh,2574,0,1,4,5,20.0%,14m
14916,2,Tsunami,2574,0,0,1,1,0.0%,1h
14916,2,[紫槿]volunteer,2574,0,0,1,1,0.0%,1h
14916,2,[gans]Clog,2574,0,0,1,1,0.0%,1h
14916,3,北府宰相,2574,0,0,1,1,0.0%,1h
14916,1,[Tov]燕北飞,2574,0,0,5,5,0.0%,1h
14941,1,蜂衣,2573,1208,188,191,379,49.6%,8m
14941,1,青宇,2573,1499,106,110,216,49.1%,13m
14941,3,[领导先走]梦一场,2573,1170,58,55,113,51.3%,41m
14941,3,我不打星际,2573,247,14,14,28,50.0%,39m
14941,2,[我是萌新Q]小智,2573,250,10,10,20,50.0%,26m
14941,2,大理石急哦,2573,116,3,2,5,60.0%,1h
14941,2,MagicLing,2573,0,1,0,1,100.0%,6m
14941,2,[圆环之理教会]慢慢打不急,2573,0,1,1,2,50.0%,58m
14941,2,[我即正义]小可爱你们好,2573,0,1,1,2,50.0%,37m
14941,2,zhous,2573,0,1,4,5,20.0%,26m
14941,1,Vector,2573,0,0,1,1,0.0%,33m
14941,3,[HK丶S]最终鸟倦归林,2573,0,0,1,1,0.0%,35m
14953,2,[人族最强近战]小红帽的大镰刀,2572,585,26,16,42,61.9%,1h
14953,1,倒走,2572,577,25,18,43,58.1%,11m
14953,3,比那名居多多良,2572,591,23,32,55,41.8%,41m
14953,2,[我们是瞎子]我不是二五仔,2572,407,17,8,25,68.0%,8m
14953,2,旅店老板,2572,143,17,15,32,53.1%,48m
14953,2,百人长,2572,198,10,10,20,50.0%,1h
14953,2,GoroHonda,2572,132,7,7,14,50.0%,1h
14953,1,heta,2572,0,3,2,5,60.0%,49m
14953,3,别被游戏玩了,2572,97,2,1,3,66.7%,1h
14953,3,[菜有菜的道理]星际杀手,2572,0,2,4,6,33.3%,33m
14953,3,Michael,2572,0,2,4,6,33.3%,1h
14953,1,戳戳,2572,116,2,7,9,22.2%,39m
14953,3,智障队友才投降,2572,0,1,0,1,100.0%,28m
14966,3,影子,2571,1393,191,179,370,51.6%,41m
14966,1,忆久弗哀,2571,413,16,19,35,45.7%,35m
14966,2,[萌新酒吧]小雇佣兵,2571,398,13,13,26,50.0%,1h
14966,1,SwainZ,2571,328,13,22,35,37.1%,60m
14966,2,funeral,2571,280,10,9,19,52.6%,1h
14966,2,女王陛下,2571,245,8,12,20,40.0%,4m
14966,1,高档豆腐,2571,192,6,3,9,66.7%,1h
14966,3,[浦大]派大吐星沫子,2571,0,4,1,5,80.0%,1h
14966,1,[星际丨猎妈人]指挥官,2571,133,4,6,10,40.0%,1h
14966,2,Feier,2571,60,3,3,6,50.0%,1h
14966,1,[基金会]弑神,2571,94,3,5,8,37.5%,2m
14966,3,飞叶子的文叔,2571,34,3,5,8,37.5%,9m
14966,2,起床干饭了,2571,46,3,7,10,30.0%,37m
14966,3,hhhh,2571,30,2,0,2,100.0%,41m
14966,1,[317]快乐建筑师,2571,0,2,3,5,40.0%,1h
14966,3,路人,2571,30,2,5,7,28.6%,5m
14966,1,hhhhhhhhhhhh,2571,58,2,10,12,16.7%,13m
14966,2,马保国,2571,0,1,1,2,50.0%,29m
14966,2,[Gaole]躁动的胖子,2571,88,1,2,3,33.3%,1h
14966,2,裁决,2571,95,1,4,5,20.0%,50m
14966,1,[ANNEX]重粹,2571,48,1,6,7,14.3%,38m
14966,2,[秋毫]Delight,2571,0,0,1,1,0.0%,1h
14966,3,你需要更多的跳虫,2571,0,0,1,1,0.0%,1h
14966,2,[糖果屋]QRWITU,2571,0,0,2,2,0.0%,1h
14966,3,一意孤行,2571,0,0,2,2,0.0%,1h
14966,1,innovation,2571,0,0,3,3,0.0%,1h
14992,1,小德德儿,2570,505,19,19,38,50.0%,44m
14992,2,livepool,2570,318,12,15,27,44.4%,47m
14992,3,TCTG,2570,144,6,4,10,60.0%,35m
14992,3,LXF,2570,152,3,2,5,60.0%,1h
14992,3,[鸡姆雷日天]大忽悠,2570,38,3,4,7,42.9%,51m
14992,2,敖神,2570,30,2,2,4,50.0%,36m
14992,3,[开心战队]泪了嚄刀,2570,0,1,0,1,100.0%,1h
14992,1,落雨如花,2570,48,1,1,2,50.0%,53m
14992,3,XyMyOnlyOne,2570,30,1,2,3,33.3%,1h
14992,3,[HUC兄弟]LXC,2570,38,1,3,4,25.0%,54m
14992,2,llllllll,2570,30,1,3,4,25.0%,1h
14992,2,ren,2570,0,1,3,4,25.0%,51m
14992,3,[FKers]PatLethal,2570,36,1,3,4,25.0%,1h
14992,1,[嗜魂舰队]卡尔哦皮,2570,0,1,5,6,16.7%,1h
14992,3,新手小杨,2570,0,0,1,1,0.0%,1h
15007,1,SadAngel,2569,1557,88,79,167,52.7%,60m
15007,2,大佬求轻虐,2569,1473,87,84,171,50.9%,1h
15007,3,OSlaozhao,2569,735,61,50,111,55.0%,41m
15007,3,苦力怕,2569,296,44,31,75,58.7%,34m
15007,1,韭菜哥,2569,582,21,25,46,45.7%,30m
15007,2,摔烂的西瓜,2569,141,6,4,10,60.0%,1h
15007,1,傻咸鸭,2569,136,5,9,14,35.7%,10m
15007,1,张小言,2569,0,2,3,5,40.0%,30m
15007,3,寂静的拂晓,2569,0,1,0,1,100.0%,5m
15007,3,[白银联盟]Zeratul,2569,30,1,1,2,50.0%,10m
15007,3,DAhall,2569,0,0,1,1,0.0%,1h
15007,3,[星之所在RI]黯琉汐,2569,0,0,1,1,0.0%,4m
15007,3,川啊,2569,0,0,1,1,0.0%,1h
15020,1,magee,2568,1230,62,48,110,56.4%,37m
15020,1,fast,2568,856,38,32,70,54.3%,30m
15020,1,夜雨蔚蓝,2568,616,21,28,49,42.9%,28m
15020,3,手慢的笨比,2568,152,15,4,19,78.9%,20m
15020,2,iab,2568,316,12,8,20,60.0%,29m
15020,2,ZGMFImpulse,2568,281,10,8,18,55.6%,1h
15020,2,吾爱,2568,259,9,1,10,90.0%,1h
15020,3,菜鸡,2568,256,8,3,11,72.7%,20m
15020,1,二号特工,2568,191,7,17,24,29.2%,1h
15020,3,老肥,2568,166,6,3,9,66.7%,1h
15020,1,抠脚大叔,2568,211,6,9,15,40.0%,1h
15020,3,四五是块钢板,2568,0,2,3,5,40.0%,18m
15020,2,[天羽不榖]淇侍,2568,32,1,5,6,16.7%,1h
15020,1,wqza,2568,0,0,1,1,0.0%,13m
15034,1,爱丽丝狗王,2567,1622,179,167,346,51.7%,1h
15034,1,zaihuishou,2567,1341,113,129,242,46.7%,20m
15034,1,绯弹的奈亚子,2567,1033,112,111,223,50.2%,13m
15034,3,丶上善,2567,897,50,52,102,49.0%,9m
15034,2,[VCT]Ryta,2567,641,30,31,61,49.2%,6m
15034,2,CCUP,2567,262,11,6,17,64.7%,1h
15034,3,JHonlyone,2567,272,11,13,24,45.8%,34m
15034,2,CelestialBe,2567,166,7,2,9,77.8%,36m
15034,2,MarK,2567,142,5,2,7,71.4%,1h
15034,2,[SteEng]最恨萌新,2567,130,2,2,4,50.0%,38m
15034,2,erictt,2567,0,1,2,3,33.3%,18m
15034,2,[SC2战队]昆阿圭罗,2567,0,1,2,3,33.3%,40m
15034,3,贪玩蓝月,2567,0,0,1,1,0.0%,1h
15034,1,寂寞的小贤,2567,0,0,1,1,0.0%,1h
15048,1,[新的蜜蜂]SOS,2566,698,27,30,57,47.4%,1h
15048,1,痛苦之源,2566,115,7,9,16,43.8%,48m
15048,2,迷离流泪,2566,48,2,2,4,50.0%,22m
15048,3,[M8]雷电芽衣,2566,66,2,3,5,40.0%,14m
15048,2,鄙人是个文化人,2566,0,1,0,1,100.0%,1h
15048,2,[DDOS傲世]魅影,2566,0,1,1,2,50.0%,1h
15048,1,RookieWAng,2566,0,1,5,6,16.7%,11m
15048,3,[JTO]maxiao,2566,0,0,1,1,0.0%,18m
15048,3,star,2566,0,0,1,1,0.0%,58m
15057,3,Asinlcy,2565,951,54,61,115,47.0%,18m
15057,2,[嗑药小分队]肥波,2565,1077,50,35,85,58.8%,18m
15057,3,橘话,2565,675,30,15,45,66.7%,1h
15057,3,诺娃上过黄金,2565,390,16,6,22,72.7%,1h
15057,2,白猫海賊船,2565,254,10,20,30,33.3%,27m
15057,2,太虚剑意,2565,194,6,8,14,42.9%,1h
15057,2,史前咸鱼王,2565,183,6,8,14,42.9%,55m
15057,2,我很菜但我喜爱,2565,159,5,7,12,41.7%,55m
15057,3,[丶幸存丶]Justice,2565,0,2,3,5,40.0%,41m
15057,1,是你唇边夜雨清荷,2565,89,2,6,8,25.0%,24m
15057,3,共和国之辉,2565,36,1,1,2,50.0%,1h
15057,3,星际云玩家,2565,36,1,1,2,50.0%,10m
15057,2,[暴雪十八队]我爸刚弄死他,2565,0,0,1,1,0.0%,1h
15057,2,失明云玩家,2565,73,0,3,3,0.0%,1h
15071,2,DJJ,2564,1208,55,43,98,56.1%,1h
15071,1,[花月]诺晨奶奶,2564,854,38,26,64,59.4%,59m
15071,2,豆豆天蝎座,2564,773,31,29,60,51.7%,51m
15071,2,大地堡小地堡,2564,623,26,21,47,55.3%,18m
15071,1,[7BR]Ploenaz,2564,410,15,18,33,45.5%,7m
15071,1,疯子在扭秧歌,2564,236,8,12,20,40.0%,6m
15071,1,[YAU]ChargeYau,2564,202,7,12,19,36.8%,2m
15071,2,向巴多吉,2564,192,5,7,12,41.7%,1h
15071,2,lancer,2564,138,4,3,7,57.1%,8m
15071,1,克里夫反抗军,2564,0,3,2,5,60.0%,5m
15071,1,安塞荡,2564,0,3,2,5,60.0%,1h
15071,2,现世妄执,2564,46,3,8,11,27.3%,1h
15071,1,气吞万里如虎,2564,145,2,5,7,28.6%,1h
15071,3,[檞寄生下]天天都被零贰骑,2564,0,1,0,1,100.0%,1h
15071,1,lee,2564,0,1,0,1,100.0%,38m
15071,3,althershadow,2564,0,0,1,1,0.0%,10m
15071,2,ypaaaaaa,2564,0,0,2,2,0.0%,9m
15088,1,SOo,2563,299,12,15,27,44.4%,24m
15088,3,[Porsch]回家,2563,332,12,20,32,37.5%,16m
15088,3,[萌萌的探机]喵喵喵,2563,314,11,6,17,64.7%,11m
15088,1,braid,2563,114,11,18,29,37.9%,44m
15088,1,[0710]Lollipop,2563,226,9,18,27,33.3%,1h
15088,2,[皇族丶]虹信追猎,2563,31,6,7,13,46.2%,1h
15088,3,[SUPSC]sadiest,2563,114,4,2,6,66.7%,1h
15088,2,[皇室联盟]凉介,2563,94,4,4,8,50.0%,37m
15088,2,WYHWYH,2563,60,3,5,8,37.5%,1h
15088,2,[EC]黑猫,2563,90,3,7,10,30.0%,38m
15088,3,我很乖,2563,40,2,8,10,20.0%,55m
15088,3,IIIIIIIIII,2563,0,1,0,1,100.0%,27m
15088,2,INnoSerral,2563,0,1,2,3,33.3%,1h
15088,3,[太微玉清宫]JHFDUF,2563,0,0,1,1,0.0%,1h
15088,1,我假装看不见,2563,0,0,1,1,0.0%,26m
15088,2,[老6]IIIIIIIIIIII,2563,0,0,2,2,0.0%,1h
15104,2,IMMVP,2562,1590,135,129,264,51.1%,51m
15104,2,[哔翻天梯鸡]YangYang,2562,1389,125,108,233,53.6%,1h
15104,2,[Deep]任重道远,2562,172,7,9,16,43.8%,14m
15104,2,PartinG,2562,96,6,6,12,50.0%,1h
15104,3,Antony,2562,122,5,8,13,38.5%,16m
15104,2,fyq,2562,88,2,1,3,66.7%,47m
15104,2,[Rhusky]Enory,2562,112,2,3,5,40.0%,48m
15104,3,Regression,2562,36,2,5,7,28.6%,1h
15104,3,一只白狐狸,2562,0,1,0,1,100.0%,4m
15104,3,[最强琪露诺]cirno,2562,30,1,1,2,50.0%,1h
15104,2,[KPG]春风拂兰露华浓,2562,0,1,3,4,25.0%,1h
15104,2,[斯大林保卫战]指挥官战刃,2562,30,1,4,5,20.0%,38m
15104,3,雪瓜,2562,0,0,1,1,0.0%,1h
15104,3,Sirius,2562,0,0,1,1,0.0%,16m
15104,1,您的瓦斯储量不足,2562,0,0,1,1,0.0%,12m
15104,2,[SAX]zerobibib,2562,0,0,2,2,0.0%,1h
15104,3,[奶嘟嘟]ManGo,2562,0,0,2,2,0.0%,12m
15121,3,[宝贝趴好]吻吻我的小舌头,2561,1159,82,74,156,52.6%,21m
15121,2,我是神,2561,1279,72,79,151,47.7%,37m
15121,2,littlez,2561,180,17,13,30,56.7%,1h
15121,2,如意娃娃,2561,386,14,15,29,48.3%,26m
15121,3,aabbcc,2561,144,5,5,10,50.0%,1h
15121,3,不计后果,2561,117,3,0,3,100.0%,39m
15121,1,粪坑之王,2561,48,3,3,6,50.0%,1h
15121,3,nbftd,2561,36,3,5,8,37.5%,1h
15121,2,星际王子,2561,62,3,6,9,33.3%,23m
15121,1,星际杀手,2561,0,2,3,5,40.0%,45m
15121,2,王不留行,2561,0,1,0,1,100.0%,4m
15121,2,[空虚门下]逆羽幻翎,2561,0,1,1,2,50.0%,48m
15121,3,[面包房行动]神楽七奈,2561,0,0,1,1,0.0%,6m
15134,1,[珍珠奶茶]长草的田,2560,800,215,205,420,51.2%,24m
15134,1,TaeJa,2560,1527,80,81,161,49.7%,20m
15134,2,伊蕾娜,2560,993,52,45,97,53.6%,28m
15134,2,WhiteSkull,2560,817,38,31,69,55.1%,1h
15134,1,可爱想日,2560,859,33,33,66,50.0%,59m
15134,1,tange,2560,542,23,26,49,46.9%,1h
15134,2,OrzJerry,2560,521,22,19,41,53.7%,26m
15134,1,IIIIIIIIIIII,2560,415,14,20,34,41.2%,54m
15134,2,赵宁,2560,263,10,6,16,62.5%,1h
15134,2,是耿良辰呐,2560,226,8,9,17,47.1%,55m
15134,2,丁岩,2560,197,5,5,10,50.0%,1h
15134,3,HAPPY,2560,0,4,2,6,66.7%,9m
15134,3,一人行者逆风行,2560,97,3,4,7,42.9%,1h
15134,3,LaYs,2560,97,3,5,8,37.5%,1h
15134,2,ydjhhhhhh,2560,96,3,5,8,37.5%,22m
15134,3,苑沧桑,2560,0,1,0,1,100.0%,1h
15134,2,[19CM]呵呵哒,2560,0,0,4,4,0.0%,1h
15151,2,硬币,2559,1535,149,140,289,51.6%,29m
15151,2,SONGWEI,2559,897,41,35,76,53.9%,29m
15151,3,[听雨轩]duola,2559,864,31,34,65,47.7%,7m
15151,2,[提莫1234]Queeniorz,2559,210,19,19,38,50.0%,48m
15151,2,[武圣]light,2559,252,10,6,16,62.5%,9m
15151,3,大帅哥,2559,146,4,2,6,66.7%,1h
15151,2,Chost,2559,130,4,3,7,57.1%,26m
15151,2,IIIIIIIIIIII,2559,0,1,2,3,33.3%,1h
15151,3,[山海经]持服之手拖去喂狗,2559,0,0,1,1,0.0%,10m
15160,2,[西雅图咖啡店]surfing,2558,1572,157,151,308,51.0%,8m
15160,1,[Wesker]我要当省长,2558,1392,92,98,190,48.4%,44m
15160,3,knight,2558,550,23,13,36,63.9%,1h
15160,2,天尊杨戬,2558,391,21,17,38,55.3%,20m
15160,2,菜的真实,2558,393,20,2,22,90.9%,9m
15160,1,我要杀腻嘛,2558,422,12,21,33,36.4%,60m
15160,2,[菜有菜的道理]理查德伊卡洛斯,2558,315,11,6,17,64.7%,1h
15160,1,Lasting,2558,175,5,2,7,71.4%,1h
15160,3,innovation,2558,151,5,6,11,45.5%,1h
15160,3,hamburgerKO,2558,114,4,2,6,66.7%,12m
15160,3,[惊不惊喜]老衲不乱来,2558,143,4,5,9,44.4%,1h
15160,2,News,2558,62,3,3,6,50.0%,29m
15160,2,[C53421]扒了猛干,2558,0,1,0,1,100.0%,1h
15160,2,[埃蒙好可爱]超级鱼,2558,0,1,1,2,50.0%,8m
15160,3,星际霸主一奥特曼,2558,0,0,1,1,0.0%,1h
15160,3,[神子]路明非,2558,0,0,2,2,0.0%,1h
15176,2,狗了不防,2557,648,26,19,45,57.8%,1h
15176,2,[索尔特雷吉]KiraHilo,2557,327,26,28,54,48.1%,1h
15176,1,妲你小己己,2557,453,18,19,37,48.6%,1h
15176,3,躺赢少年,2557,268,10,8,18,55.6%,1h
15176,3,风吹斜雨,2557,72,5,5,10,50.0%,59m
15176,3,Cloudz,2557,153,4,3,7,57.1%,10m
15176,3,HANHAOHAO,2557,38,4,5,9,44.4%,58m
15176,2,[剑桥斧头帮]电子越共,2557,120,4,8,12,33.3%,22m
15176,1,黑袍,2557,46,4,8,12,33.3%,6m
15176,2,超级课程表,2557,114,3,2,5,60.0%,23m
15176,2,[菜有菜的道理]CRIMSON,2557,58,3,4,7,42.9%,4m
15176,3,SNRI,2557,0,2,3,5,40.0%,12m
15176,3,北海没有猫,2557,66,2,10,12,16.7%,1h
15176,3,[初心者]八楼先生,2557,0,0,1,1,0.0%,1h
15176,3,GXUE,2557,0,0,1,1,0.0%,12m
15191,2,caxiya,2556,1416,137,130,267,51.3%,14m
15191,1,BlackPinkJ,2556,1220,47,50,97,48.5%,11m
15191,3,[安蠢蛋]星奈子,2556,788,33,29,62,53.2%,1h
15191,3,卑鄙的泰伦人,2556,686,25,30,55,45.5%,23m
15191,1,Kimgy,2556,593,22,24,46,47.8%,54m
15191,3,时光待我如旅人,2556,129,5,9,14,35.7%,18m
15191,2,[保护萌友]DarkMoon,2556,92,3,6,9,33.3%,37m
15191,2,飞天狗狗,2556,30,2,4,6,33.3%,37m
15191,1,暴雪游戏休闲玩家,2556,0,1,4,5,20.0%,1h
15191,1,switch,2556,0,0,1,1,0.0%,10m
15191,1,[白给白给白给]炮姐手中的硬币,2556,0,0,1,1,0.0%,33m
15202,1,[瑞兽]瑞兽小熊,2555,1566,242,256,498,48.6%,54m
15202,2,[要得]AAfrdOy,2555,261,16,13,29,55.2%,1h
15202,3,偏爱小单,2555,280,10,22,32,31.2%,19m
15202,2,[秋毫]梦与叶樱,2555,150,8,6,14,57.1%,6m
15202,3,TopOne,2555,212,8,15,23,34.8%,1h
15202,2,奥野田美咲,2555,217,7,7,14,50.0%,1h
15202,2,无敌蔡,2555,96,5,4,9,55.6%,40m
15202,2,[天雪]有地丛雨,2555,156,5,7,12,41.7%,1h
15202,1,雪走,2555,128,5,10,15,33.3%,1h
15202,1,暗恋地狱,2555,184,4,5,9,44.4%,2m
15202,3,sjue,2555,58,3,1,4,75.0%,39m
15202,2,老逗到此一游,2555,95,3,5,8,37.5%,1h
15202,2,马尔科罗伊斯,2555,30,1,3,4,25.0%,4m
15215,2,星空虫族,2554,647,28,25,53,52.8%,29m
15215,2,wwwwwwwwwwww,2554,565,24,22,46,52.2%,1h
15215,3,小达,2554,517,18,31,49,36.7%,4m
15215,2,[神羽]秋神紫羽,2554,428,16,20,36,44.4%,9m
15215,2,重炮流星铁闸门,2554,281,12,6,18,66.7%,23m
15215,2,Mortal,2554,148,8,7,15,53.3%,48m
15215,2,圆焰终恋,2554,218,8,7,15,53.3%,13m
15215,2,[阿迪特]澪星,2554,278,8,9,17,47.1%,1h
15215,3,[咸鱼谐会]HUCSummer,2554,174,6,3,9,66.7%,1h
15215,3,无人,2554,166,4,1,5,80.0%,34m
15215,3,又菜又爱玩,2554,0,3,4,7,42.9%,1h
15215,3,faker,2554,30,2,0,2,100.0%,1h
15215,3,泽格一败涂地,2554,0,2,4,6,33.3%,44m
15215,3,积木,2554,0,2,4,6,33.3%,1h
15215,1,swd,2554,36,2,7,9,22.2%,54m
15215,3,[Marry]德拉柯斯,2554,0,0,1,1,0.0%,1h
15231,1,类地行星外星人,2553,1505,153,161,314,48.7%,11m
15231,3,小白,2553,875,88,98,186,47.3%,13m
15231,2,tommao,2553,823,57,49,106,53.8%,36m
15231,2,[Mentor]龙骨,2553,1234,51,42,93,54.8%,26m
15231,2,见血封喉,2553,1025,42,43,85,49.4%,13m
15231,1,一季恋歌,2553,995,36,37,73,49.3%,1h
15231,2,[黑鲨]苏子莫邪,2553,685,32,32,64,50.0%,1h
15231,2,SPROK,2553,643,23,25,48,47.9%,26m
15231,3,dadadaxue,2553,399,14,15,29,48.3%,18m
15231,3,北冥有牛,2553,291,12,14,26,46.2%,1h
15231,3,虫爱虫网,2553,212,7,3,10,70.0%,9m
15231,3,希望,2553,190,6,1,7,85.7%,1h
15231,3,独战苍狼,2553,34,3,5,8,37.5%,4m
15231,3,[社交学大可爱]不会飞的翅膀,2553,0,1,0,1,100.0%,34m
15231,3,经纬大帝,2553,30,1,1,2,50.0%,20m
15231,1,[谁都打不过I]迅捷祖尔文的缰绳,2553,73,1,5,6,16.7%,29m
15231,3,晨枫,2553,0,0,1,1,0.0%,1h
15248,2,请叫我爸爸丶,2552,886,36,33,69,52.2%,1h
15248,3,为了部落,2552,788,30,28,58,51.7%,45m
15248,3,藕依踏,2552,568,25,21,46,54.3%,45m
15248,1,[一杆枪定天下]战争与天下,2552,450,18,22,40,45.0%,49m
15248,2,[AKC]deltagogogo,2552,234,11,9,20,55.0%,1h
15248,3,[清华野大学]宰我,2552,178,4,3,7,57.1%,1h
15248,3,jack,2552,97,4,4,8,50.0%,1h
15248,3,[KZFANS]Wolfkisser,2552,0,3,5,8,37.5%,58m
15248,2,Knight,2552,62,2,5,7,28.6%,1h
15248,3,手打,2552,0,2,5,7,28.6%,1h
15248,3,[随峰飘]苏格拉圆脸咕咕鸡,2552,0,1,0,1,100.0%,1h
15248,2,[Faith]拉粑粑武三岁,2552,0,1,2,3,33.3%,47m
15248,1,谜一样的男人,2552,46,1,7,8,12.5%,1h
15248,3,LOST,2552,0,0,2,2,0.0%,1h
15262,3,姐脱,2551,1009,57,44,101,56.4%,34m
15262,2,利弗莫尔,2551,677,53,49,102,52.0%,28m
15262,3,[KPG2]GZEZHANGLP,2551,451,23,20,43,53.5%,20m
15262,3,CrossEvery,2551,369,15,15,30,50.0%,1h
15262,1,帅怪我咯,2551,361,13,19,32,40.6%,35m
15262,3,空白,2551,368,13,24,37,35.1%,5m
15262,2,钻石的剑,2551,248,11,2,13,84.6%,1h
15262,2,千里烟波,2551,142,5,3,8,62.5%,51m
15262,1,[萌妹子来一发]心情乱了,2551,117,3,0,3,100.0%,30m
15262,3,killerqueen,2551,58,2,1,3,66.7%,7m
15262,3,[中华何平]少帅,2551,0,1,0,1,100.0%,1h
15262,3,樱合丶星落,2551,30,1,1,2,50.0%,42m
15262,3,[扫黄]AcE,2551,0,0,1,1,0.0%,27m
15262,3,鹏彭砰,2551,0,0,2,2,0.0%,1h
15276,3,锦鸡舞,2550,360,16,12,28,57.1%,10m
15276,1,LoveTT,2550,410,15,15,30,50.0%,1h
15276,1,[兴中会]欲治,2550,277,14,13,27,51.9%,14m
15276,1,拆迁大队长,2550,294,11,13,24,45.8%,1h
15276,2,青铜连胜王,2550,140,5,3,8,62.5%,1h
15276,2,蛮力之裤,2550,114,4,6,10,40.0%,23m
15276,3,陌黑色,2550,31,3,2,5,60.0%,11m
15276,1,[沙雕]大宝宝,2550,112,2,1,3,66.7%,24m
15276,3,[llIlll]llllllllllll,2550,0,1,0,1,100.0%,29m
15276,3,青山有妖风,2550,0,1,1,2,50.0%,1h
15276,1,llllllllllll,2550,0,1,1,2,50.0%,1h
15276,2,放狗招的是坏蛋猪,2550,0,1,3,4,25.0%,22m
15276,3,Demon,2550,0,0,1,1,0.0%,1h
15276,2,带投大鸽,2550,0,0,1,1,0.0%,16m
15290,3,[小鸡屠宰场a]阿磊,2549,1569,133,144,277,48.0%,11m
15290,2,Smile,2549,1175,69,66,135,51.1%,1h
15290,3,jmdmke,2549,335,12,7,19,63.2%,1h
15290,2,[TLGD]Bomb,2549,118,4,9,13,30.8%,39m
15290,2,[大秦万世]小鱼儿你来吗,2549,60,3,4,7,42.9%,13m
15290,2,匚匚君子,2549,62,3,7,10,30.0%,47m
15290,3,铭泽,2549,0,2,4,6,33.3%,1h
15290,2,塔兰托之夜,2549,60,2,5,7,28.6%,1h
15290,2,BlueSteel,2549,0,1,0,1,100.0%,1h
15290,3,[首席玩家]十诺,2549,30,1,2,3,33.3%,1h
15290,1,pangou,2549,0,1,5,6,16.7%,10m
15290,3,[CUGer]爷爷就是爷爷,2549,0,0,1,1,0.0%,1h
15302,2,[励志第一]香脆杏仁饼,2548,1241,62,70,132,47.0%,8m
15302,2,茨科,2548,950,58,48,106,54.7%,13m
15302,3,不是但是算了我的,2548,449,57,58,115,49.6%,12m
15302,2,东鹏特饮一元畅享,2548,714,26,25,51,51.0%,37m
15302,2,plusplus,2548,229,23,23,46,50.0%,51m
15302,3,xiaoyao,2548,501,23,36,59,39.0%,39m
15302,2,SpurtyBOOM,2548,480,18,14,32,56.2%,1h
15302,3,胤禛,2548,315,17,23,40,42.5%,27m
15302,2,灰灰,2548,314,15,13,28,53.6%,36m
15302,1,龙与地下城,2548,164,5,8,13,38.5%,44m
15302,2,[武林败类]Hamster,2548,160,5,9,14,35.7%,1h
15302,1,IKD,2548,0,4,2,6,66.7%,1h
15302,3,[秋毫七队]已为星海,2548,0,3,3,6,50.0%,58m
15302,3,老吴,2548,58,2,1,3,66.7%,18m
15302,3,[真就白给呗]LYNN,2548,58,2,1,3,66.7%,34m
15302,2,鱼市巨子孙半城,2548,93,2,2,4,50.0%,1h
15302,2,HoLLoWSTRING,2548,30,2,2,4,50.0%,1h
15302,1,Johnson,2548,0,2,3,5,40.0%,1h
15302,3,孙一楠,2548,60,2,4,6,33.3%,52m
15302,3,Killer,2548,0,1,0,1,100.0%,1h
15302,3,weiFAR,2548,0,1,0,1,100.0%,34m
15302,3,班班班,2548,0,1,0,1,100.0%,16m
15302,3,[入侵地球]唯快不破,2548,0,1,0,1,100.0%,39m
15302,3,羲哥不要,2548,0,1,0,1,100.0%,28m
15302,3,重新集结部队,2548,0,1,1,2,50.0%,30m
15302,3,谶言,2548,0,1,1,2,50.0%,1h
15302,3,[miku守护]我要练多线,2548,30,1,1,2,50.0%,45m
15302,2,[打啊]萌王殿下,2548,30,1,3,4,25.0%,47m
15302,3,沉积物,2548,0,0,1,1,0.0%,1h
15331,2,tassder,2547,1415,63,56,119,52.9%,26m
15331,1,元代一曲离歌,2547,1433,57,57,114,50.0%,20m
15331,1,[Quark]茶仙,2547,1119,40,44,84,47.6%,60m
15331,2,泡椒楠楠,2547,721,30,25,55,54.5%,29m
15331,2,[NVKR]郝仁,2547,582,23,23,46,50.0%,1h
15331,2,[XTE]Linux,2547,436,17,14,31,54.8%,51m
15331,3,两块五,2547,428,15,23,38,39.5%,14m
15331,2,显卡之怒,2547,249,9,9,18,50.0%,1h
15331,2,喜阳阳,2547,256,9,14,23,39.1%,29m
15331,3,seoccc,2547,235,8,6,14,57.1%,34m
15331,2,taste,2547,114,3,2,5,60.0%,1h
15331,3,我是大坑我不坑,2547,46,2,2,4,50.0%,59m
15331,3,[MMOPhD]TcK,2547,30,2,2,4,50.0%,10m
15331,2,佛眼看天,2547,30,2,3,5,40.0%,1h
15331,1,[大爱EMT]森下下士,2547,46,2,6,8,25.0%,55m
15331,3,暗夜骑士,2547,0,1,0,1,100.0%,14m
15331,2,[孙宁FANS]MARU,2547,0,1,1,2,50.0%,1h
15331,2,霸气浩浩,2547,92,1,2,3,33.3%,1h
15331,3,[哔哩哔哩乾杯]NaIve,2547,0,0,1,1,0.0%,1h
15331,3,[墨氏孤朝]墨天寒,2547,0,0,2,2,0.0%,10m
15331,2,[不知不觉天亮]海鸥,2547,0,0,5,5,0.0%,9m
15352,3,Antonidas,2546,114,5,1,6,83.3%,30m
15352,1,谁是我,2546,197,5,6,11,45.5%,1h
15352,3,排红,2546,148,5,7,12,41.7%,27m
15352,2,iiiiiiiiii,2546,84,4,4,8,50.0%,26m
15352,1,stormfire,2546,158,3,4,7,42.9%,1h
15352,3,嫂子我是老王,2546,0,1,0,1,100.0%,1h
15352,2,[四叶草]树人,2546,0,1,0,1,100.0%,1h
15352,3,钩子疼的很,2546,0,0,1,1,0.0%,41m
15352,2,郑二万,2546,0,0,3,3,0.0%,1h
15352,1,[深空骑士]tpz,2546,0,0,5,5,0.0%,45m
15362,2,科洛特斯,2545,1606,176,160,336,52.4%,4m
15362,1,[田中姬铃木雏]艾尔吴彦祖,2545,862,90,63,153,58.8%,13m
15362,2,[Mentor]黑暗天际,2545,467,45,36,81,55.6%,48m
15362,2,Gladiator,2545,360,15,19,34,44.1%,1h
15362,2,冰恋,2545,209,8,9,17,47.1%,1h
15362,3,[维也纳]sixxamalex,2545,176,7,7,14,50.0%,18m
15362,3,[星云]卡布达,2545,86,4,3,7,57.1%,1h
15362,2,DRAVEN,2545,142,4,4,8,50.0%,1h
15362,2,[小扎的火车侠]公寓之狼,2545,92,4,6,10,40.0%,13m
15362,3,Mirage,2545,86,3,2,5,60.0%,1h
15362,2,蓝带子,2545,141,3,6,9,33.3%,1h
15362,3,JackBright,2545,60,2,3,5,40.0%,1h
15362,3,[SCMIW]我打不赢就投诉,2545,30,1,2,3,33.3%,27m
15362,3,袋鼠,2545,93,1,2,3,33.3%,1h
15362,3,[快乐白给]慕斯,2545,30,1,3,4,25.0%,21m
15362,3,shuyi,2545,0,0,1,1,0.0%,39m
15362,1,苓溟寒钰,2545,0,0,1,1,0.0%,1h
15362,3,怪诞丶,2545,0,0,2,2,0.0%,12m
15362,2,打酱油,2545,0,0,3,3,0.0%,40m
15381,1,[丨G一G丨]OLLYC,2544,733,56,54,110,50.9%,37m
15381,2,XYBB,2544,442,18,18,36,50.0%,1h
15381,1,GKind,2544,281,11,8,19,57.9%,33m
15381,3,[EnTorn]非正常人类研究所,2544,331,11,8,19,57.9%,34m
15381,3,战灵,2544,196,7,5,12,58.3%,34m
15381,2,彼岸狼,2544,242,7,9,16,43.8%,18m
15381,1,逗比小分队,2544,228,7,14,21,33.3%,49m
15381,3,KINGofSC,2544,165,6,5,11,54.5%,1h
15381,3,暴怒的奶茶,2544,114,4,3,7,57.1%,4m
15381,3,爱夜夜夜夜,2544,60,4,6,10,40.0%,33m
15381,2,我欲封天,2544,104,3,1,4,75.0%,16m
15381,1,那晚她很狼狈,2544,30,3,6,9,33.3%,1h
15381,3,耀灵,2544,0,2,4,6,33.3%,14m
15381,3,无铭,2544,0,1,0,1,100.0%,12m
15381,3,joe,2544,0,1,1,2,50.0%,41m
15381,1,龙魔爱,2544,0,0,1,1,0.0%,45m
15397,2,[怕个虫子]加藤惠,2543,616,21,28,49,42.9%,28m
15397,3,尘曦,2543,552,20,18,38,52.6%,18m
15397,2,领衔灬小付,2543,302,11,15,26,42.3%,48m
15397,2,南球站立于大地,2543,224,7,11,18,38.9%,52m
15397,2,石头头,2543,190,6,3,9,66.7%,1h
15397,3,[T阴吧]maru,2543,36,3,4,7,42.9%,35m
15397,3,ouyan,2543,30,2,0,2,100.0%,34m
15397,3,[情深天涯]火麒麟,2543,121,2,1,3,66.7%,41m
15397,1,[DFC]星川绘未,2543,0,2,3,5,40.0%,1h
15397,3,旦那,2543,0,2,4,6,33.3%,25m
15397,3,[萌萌虫部落]白泽,2543,0,1,0,1,100.0%,18m
15397,3,[Evolos]九黎夜殇,2543,0,1,0,1,100.0%,4m
15397,2,[JPY]vivalavida,2543,0,1,1,2,50.0%,1h
15397,1,mihotel,2543,46,1,5,6,16.7%,41m
15397,3,[疯家军]乔碧萝殿下,2543,0,0,1,1,0.0%,4m
15397,3,qmdh,2543,0,0,2,2,0.0%,1h
15397,1,[虐菜小能手]刘稷赶紧下星际,2543,0,0,6,6,0.0%,1h
15414,1,北冥一只鲲,2542,1178,65,54,119,54.6%,3m
15414,1,卖鱼强蕉太郎,2542,724,30,32,62,48.4%,14m
15414,2,逢考必过,2542,750,29,29,58,50.0%,1h
15414,3,eTernity,2542,622,26,33,59,44.1%,41m
15414,2,[要啥没啥爱咋]driverxdw,2542,543,24,21,45,53.3%,1h
15414,2,[恶劣玩家]哈皮麸子,2542,190,7,10,17,41.2%,1h
15414,3,MagicTragic,2542,121,3,6,9,33.3%,33m
15414,3,[HTW]海蓝鲸,2542,58,2,3,5,40.0%,1h
15414,1,MrLion,2542,0,2,3,5,40.0%,1h
15414,2,戏子,2542,0,1,0,1,100.0%,14m
15414,1,NexuS,2542,0,1,0,1,100.0%,1h
15414,3,Djun,2542,0,1,0,1,100.0%,50m
15414,1,[卡琴司机传人]珍惜灬时光,2542,97,1,1,2,50.0%,46m
15414,2,[纯净的]tomato,2542,38,1,2,3,33.3%,22m
15414,3,[Aqou]高海千歌,2542,0,0,1,1,0.0%,1h
15429,3,Ropivacaine,2541,1468,168,175,343,49.0%,41m
15429,3,超级小鳴,2541,1629,75,72,147,51.0%,1h
15429,1,[CPT]ALTER,2541,1166,62,76,138,44.9%,10m
15429,1,不要狗打运营,2541,1016,38,39,77,49.4%,47m
15429,2,[YMSX]hacker,2541,713,28,28,56,50.0%,28m
15429,3,冰镇锦鲤,2541,481,23,19,42,54.8%,57m
15429,2,cccccm,2541,536,18,19,37,48.6%,1h
15429,3,CMOON,2541,417,17,8,25,68.0%,1h
15429,2,路过的耀耀,2541,154,16,10,26,61.5%,8m
15429,2,[桜公馆]Swarm,2541,344,12,16,28,42.9%,1h
15429,3,DeadGame,2541,236,8,8,16,50.0%,1h
15429,2,[探索]teo,2541,158,6,6,12,50.0%,22m
15429,2,thinker,2541,173,6,6,12,50.0%,6m
15429,1,[演员z]拉姆店员,2541,219,5,6,11,45.5%,27m
15429,3,[TCP]四季覚,2541,117,4,6,10,40.0%,41m
15429,3,聪明的蓝胖,2541,58,3,1,4,75.0%,1h
15429,2,[战鸽巢群]咕咕,2541,90,3,6,9,33.3%,23m
15429,2,flynife,2541,132,3,7,10,30.0%,1h
15429,3,康康,2541,36,2,1,3,66.7%,41m
15429,2,面朝大海春暖花开,2541,58,2,5,7,28.6%,26m
15429,2,Adma,2541,0,0,1,1,0.0%,16m
15429,1,Ares,2541,0,0,2,2,0.0%,27m
15429,3,DrLWBT,2541,0,0,2,2,0.0%,10m
15429,2,夜夜做莽夫,2541,0,0,3,3,0.0%,60m
15453,3,歌本哈根的星球,2540,342,13,13,26,50.0%,1h
15453,2,[逗比神教]逗比,2540,248,7,7,14,50.0%,1h
15453,2,剑心,2540,174,5,4,9,55.6%,1h
15453,3,[Foehn焚]秘制小汉堡,2540,60,3,2,5,60.0%,6m
15453,3,稚名真白,2540,0,2,5,7,28.6%,1h
15453,3,[电脑黑屏]普通的王虫,2540,30,1,2,3,33.3%,1h
15453,1,sadasdas,2540,0,0,1,1,0.0%,1h
15453,2,缱绻,2540,0,0,4,4,0.0%,52m
15461,1,[NvORC]拓别夕哲,2539,305,14,21,35,40.0%,36m
15461,1,[面具老流氓]戴面具的老流氓,2539,272,9,13,22,40.9%,13m
15461,3,战神丨势不可挡,2539,172,7,4,11,63.6%,27m
15461,3,幽魂霸王龙,2539,215,5,8,13,38.5%,1h
15461,3,[芜湖难铜]难铜贰号,2539,120,4,5,9,44.4%,14m
15461,3,我是的菜鸟,2539,58,3,0,3,100.0%,1h
15461,3,[天邪]佩尔奎兹,2539,121,3,0,3,100.0%,1h
15461,3,小菜鸟,2539,30,3,5,8,37.5%,1h
15461,3,indexsss,2539,0,2,4,6,33.3%,1h
15461,1,黑八,2539,0,1,0,1,100.0%,1h
15461,2,但愿人长久,2539,0,1,2,3,33.3%,1h
15461,2,罪孽,2539,0,1,2,3,33.3%,1h
15461,1,goose,2539,0,1,4,5,20.0%,10m
15461,1,[同济大学]huodeheshiqu,2539,48,1,6,7,14.3%,9m
15461,1,小飞,2539,0,0,1,1,0.0%,1h
15476,3,香蕉面,2538,794,33,22,55,60.0%,1h
15476,2,你需要哲学,2538,780,32,27,59,54.2%,6m
15476,2,养狗流,2538,365,14,15,29,48.3%,8m
15476,2,[CPT]NASA,2538,383,14,15,29,48.3%,1h
15476,1,zhanshen,2538,169,6,8,14,42.9%,1h
15476,3,Maru,2538,88,4,1,5,80.0%,1h
15476,1,独孤求胜,2538,0,3,2,5,60.0%,30m
15476,1,Loveisgone,2538,48,2,0,2,100.0%,4m
15476,3,[我会怕输]上将钩,2538,0,1,0,1,100.0%,1h
15476,1,[西伯利亚土豆]鬼怪,2538,0,1,1,2,50.0%,1h
15476,3,[KNAT]炙热苹果派,2538,0,1,2,3,33.3%,40m
15476,2,[我高贵的族人]霸气乐怀冉,2538,30,1,4,5,20.0%,1h
15476,1,RayGardner,2538,0,0,1,1,0.0%,1h
15489,2,不老神话,2537,328,20,17,37,54.1%,26m
15489,2,[星际穿梭]小橘子,2537,432,16,15,31,51.6%,1h
15489,2,[暴雪家族]lastbus,2537,120,4,6,10,40.0%,47m
15489,1,虫族杀手,2537,0,2,3,5,40.0%,1h
15489,3,[Sc养老]IIIIIIIIIIII,2537,0,0,1,1,0.0%,59m
15494,1,上官灬冷风,2536,644,35,37,72,48.6%,1h
15494,3,[DMRe]爱商熙欣晴,2536,209,19,13,32,59.4%,30m
15494,2,[多个老年人]蛋中如治麟,2536,296,10,5,15,66.7%,18m
15494,2,聊表心意,2536,208,9,6,15,60.0%,1h
15494,3,有种轰趴我,2536,196,9,7,16,56.2%,1h
15494,2,孤独的狼,2536,216,8,8,16,50.0%,40m
15494,2,赢无翳,2536,256,8,10,18,44.4%,22m
15494,3,llllllllllll,2536,195,7,4,11,63.6%,25m
15494,2,黄塞肉,2536,152,6,7,13,46.2%,1h
15494,3,玉衡,2536,0,4,3,7,57.1%,1h
15494,1,雪血学,2536,97,2,2,4,50.0%,38m
15494,3,总有萝莉想害朕,2536,41,2,3,5,40.0%,20m
15494,3,羽翼,2536,0,1,1,2,50.0%,45m
15494,3,[萌萌哒鸡]乐善色,2536,0,0,2,2,0.0%,1h
15494,2,扣扣大有,2536,0,0,3,3,0.0%,1h
15509,1,[璀璨群星之刃]风语者,2535,341,24,28,52,46.2%,1h
15509,2,爱多爱多爱多爱多,2535,355,14,12,26,53.8%,49m
15509,3,[凯露天下第一]高性能亚托莉,2535,289,10,7,17,58.8%,10m
15509,2,king,2535,209,6,7,13,46.2%,1h
15509,3,[坎星宇航局]Proxima,2535,60,2,2,4,50.0%,1h
15509,3,Dchen,2535,0,2,4,6,33.3%,1h
15509,3,[七咕咕]源爱黑大姐,2535,97,2,5,7,28.6%,35m
15509,2,[Rush丿]天丶才,2535,46,1,2,3,33.3%,1h
15509,3,DKnight,2535,30,1,3,4,25.0%,1h
15509,1,一只萌新,2535,97,1,3,4,25.0%,1h
15509,2,[XXG]jameshhy,2535,0,0,1,1,0.0%,1h
15520,1,Qies,2534,1132,68,63,131,51.9%,35m
15520,2,MrainGee,2534,377,15,11,26,57.7%,1h
15520,2,心恋沢尚酒,2534,331,13,10,23,56.5%,28m
15520,3,上杉绘梨衣,2534,206,8,5,13,61.5%,10m
15520,2,尹太祖,2534,232,7,5,12,58.3%,55m
15520,1,Deacrer,2534,178,6,13,19,31.6%,1h
15520,1,兰戈,2534,48,3,4,7,42.9%,1h
15520,3,歪比吧卜,2534,40,3,5,8,37.5%,1h
15520,3,踏莎行,2534,38,3,6,9,33.3%,1h
15520,3,[FRG]巨狐狸卡,2534,97,2,5,7,28.6%,1h
15520,3,暴雪不得好死,2534,0,0,1,1,0.0%,1h
15531,3,肾不亏,2533,693,46,33,79,58.2%,36m
15531,3,来偷袭,2533,592,26,25,51,51.0%,1h
15531,3,[SPMBIN]加冰的红茶,2533,343,14,14,28,50.0%,1h
15531,2,清欢,2533,264,10,10,20,50.0%,1h
15531,2,刻薄的守卫者,2533,116,6,7,13,46.2%,49m
15531,2,[夙愿天下]簋爷,2533,133,5,2,7,71.4%,42m
15531,2,这一刀叫两断,2533,30,2,3,5,40.0%,51m
15531,1,星皇,2533,0,2,4,6,33.3%,4m
15531,3,大老粗,2533,0,1,0,1,100.0%,55m
15531,3,[GAC]Notenough,2533,30,1,1,2,50.0%,39m
15531,3,只是蝴蝶不愿意,2533,30,1,3,4,25.0%,34m
15531,2,[一起冲]威少,2533,0,0,3,3,0.0%,1h
15543,3,ZergLordH,2532,1498,108,111,219,49.3%,34m
15543,2,悍戈,2532,386,13,14,27,48.1%,20m
15543,2,婕妤,2532,321,11,10,21,52.4%,40m
15543,2,[Riders]Terrorblade,2532,218,7,7,14,50.0%,1h
15543,1,[DFL]Durrinkun,2532,0,3,2,5,60.0%,26m
15543,2,[专业收尸队]貔貅王爵,2532,126,3,2,5,60.0%,1h
15543,2,日立,2532,50,3,7,10,30.0%,1h
15543,2,[纸鸢i]同性才是真爱,2532,0,0,1,1,0.0%,1h
15543,1,恩奇都,2532,0,0,1,1,0.0%,1h
15552,1,明日之子,2531,651,39,43,82,47.6%,13m
15552,1,暴力牛牛,2531,689,36,34,70,51.4%,1h
15552,3,我叫李俊英,2531,325,12,10,22,54.5%,1h
15552,2,[艾尔之名]IIIIIIIIIIII,2531,227,7,6,13,53.8%,6m
15552,3,wddks,2531,30,2,0,2,100.0%,1h
15552,3,渐渐再也不见,2531,0,1,0,1,100.0%,1h
15552,3,[草滩帝国大学]陈晖洁天下第一,2531,0,0,1,1,0.0%,18m
15552,1,MrRen,2531,0,0,1,1,0.0%,55m
15552,1,AlphaMoMO,2531,0,0,1,1,0.0%,10m
15552,1,[彼方剑语]深泽辰哉,2531,0,0,2,2,0.0%,33m
15562,2,Perfect,2530,1188,109,104,213,51.2%,1h
15562,1,萧兮客,2530,178,16,13,29,55.2%,1h
15562,1,风落有时,2530,282,14,9,23,60.9%,1h
15562,3,冷风吹,2530,352,12,13,25,48.0%,1h
15562,3,我爱范思哲,2530,218,8,7,15,53.3%,1h
15562,1,[联防队谐警]alafmeister,2530,144,6,1,7,85.7%,1h
15562,3,MMQ,2530,121,3,3,6,50.0%,1h
15562,3,[亚特兰蒂斯]黑白红,2530,76,3,4,7,42.9%,16m
15562,3,无能狂怒,2530,38,3,5,8,37.5%,58m
15562,2,苍茫也晴天,2530,88,2,1,3,66.7%,48m
15562,3,亚特鲁,2530,0,1,0,1,100.0%,27m
15562,3,fanfan,2530,0,1,0,1,100.0%,1h
15562,1,[SoloAs]思然,2530,48,1,1,2,50.0%,46m
15562,3,Joker,2530,0,1,1,2,50.0%,16m
15562,3,[爱星际丨风暴]qazwsxedc,2530,0,1,3,4,25.0%,14m
15562,3,绯村丶剑心,2530,0,0,1,1,0.0%,30m
15562,3,黄三二,2530,0,0,1,1,0.0%,42m
15562,2,舞挽歌,2530,0,0,1,1,0.0%,50m
15562,1,[五月花]暗影卫队,2530,0,0,1,1,0.0%,13m
15581,3,zhu,2529,680,28,26,54,51.9%,1h
15581,3,[HYsc]SHTossBoy,2529,58,3,1,4,75.0%,16m
15581,3,[翔安小分队]oGsMC,2529,58,3,2,5,60.0%,30m
15581,1,盟重,2529,124,3,2,5,60.0%,1h
15581,3,pureblack,2529,122,2,2,4,50.0%,1h
15581,3,[乳主头子]薇风见月,2529,0,1,0,1,100.0%,1h
15581,3,闪电五连鞭,2529,0,1,2,3,33.3%,1h
15581,3,[星际传销组织]遣遗家的魔法帽,2529,30,1,3,4,25.0%,28m
15581,3,来吃脱氧核糖,2529,0,0,1,1,0.0%,1h
15590,3,[6G芯片研發]TonyStark,2528,721,25,34,59,42.4%,11m
15590,3,NANAmi,2528,364,12,15,27,44.4%,45m
15590,1,[咪神咪神]薛定谔的咪咪,2528,316,10,17,27,37.0%,21m
15590,2,[憨憨成群]翔中翔,2528,191,6,8,14,42.9%,29m
15590,2,流浪泰伦,2528,230,6,22,28,21.4%,35m
15590,3,懒赖虫虫,2528,155,4,4,8,50.0%,58m
15590,3,丶沐丨承,2528,60,3,1,4,75.0%,1h
15590,2,hggh,2528,119,3,5,8,37.5%,9m
15590,3,[GOTAL]soviet,2528,0,3,5,8,37.5%,1h
15590,2,高数干离散,2528,92,3,7,10,30.0%,1h
15590,2,[拯救凯瑞甘]灵之龙玄,2528,126,2,2,4,50.0%,1h
15590,3,这个游戏好难啊,2528,0,1,0,1,100.0%,1h
15590,3,[独立團]DDDDTao,2528,0,0,2,2,0.0%,1h
15590,3,[半个菜鸟II]miaowumiao,2528,0,0,3,3,0.0%,18m
15604,3,生生,2527,1015,141,159,300,47.0%,6m
15604,1,ghost,2527,650,24,32,56,42.9%,11m
15604,3,曾经感染,2527,422,18,11,29,62.1%,39m
15604,3,驴毛,2527,473,18,11,29,62.1%,1h
15604,1,[GAS丶]Ghost,2527,96,3,7,10,30.0%,58m
15604,3,鸽王,2527,30,2,0,2,100.0%,1h
15604,1,斯蒂芬,2527,46,2,2,4,50.0%,12m
15604,2,[彼岸之花]Leo,2527,60,2,6,8,25.0%,26m
15604,3,lzx,2527,0,1,1,2,50.0%,6m
15604,1,忠诚,2527,0,1,3,4,25.0%,1h
15604,3,吹梦到西洲,2527,0,0,2,2,0.0%,14m
15615,1,有丶东西,2526,616,43,69,112,38.4%,20m
15615,2,糖糖巫,2526,1056,38,42,80,47.5%,1h
15615,1,[将军刽子手]放牛娃,2526,172,6,15,21,28.6%,12m
15615,1,lazttty,2526,0,3,2,5,60.0%,26m
15615,1,[塔兰达尔]她牵了他,2526,48,3,4,7,42.9%,1h
15615,1,薛鹏程,2526,48,3,5,8,37.5%,1h
15615,3,胖子先生,2526,0,1,0,1,100.0%,1h
15615,3,王大河,2526,0,1,1,2,50.0%,11m
15615,3,[点到为止]DeadlyBloom,2526,30,1,3,4,25.0%,1h
15615,3,[SA破晓]FansticLIN,2526,0,0,1,1,0.0%,30m
15615,3,小虎杀疯啦,2526,0,0,1,1,0.0%,11m
15615,3,diclsc,2526,0,0,2,2,0.0%,1h
15627,3,风火连城,2525,797,45,30,75,60.0%,42m
15627,2,君临天下唯我独尊,2525,716,38,36,74,51.4%,6m
15627,1,孙一峰我老婆,2525,1038,35,42,77,45.5%,1h
15627,3,admin,2525,630,28,21,49,57.1%,18m
15627,3,茉莉的小棉袄,2525,625,26,24,50,52.0%,18m
15627,2,lntianxiunl,2525,460,18,12,30,60.0%,18m
15627,2,[东大电竞]Saber,2525,264,9,15,24,37.5%,51m
15627,2,Leslie,2525,234,8,7,15,53.3%,1h
15627,1,二狗爸,2525,232,7,11,18,38.9%,35m
15627,1,[SCI一区]暴雪沙比,2525,192,6,16,22,27.3%,15m
15627,3,[DHuman]蛇死在瓦上,2525,133,4,6,10,40.0%,19m
15627,1,[FORSCV]Christinayo,2525,111,3,2,5,60.0%,24m
15627,1,你的老父亲,2525,0,3,2,5,60.0%,26m
15627,3,chunyu,2525,60,3,3,6,50.0%,30m
15627,3,[月见]虞姬,2525,92,3,5,8,37.5%,1h
15627,3,被小学生殴打一号,2525,121,3,5,8,37.5%,1h
15627,3,深蓝纯白,2525,122,3,6,9,33.3%,1h
15627,1,[梁佳河抗麦队]SlumberPeng,2525,0,2,1,3,66.7%,3m
15627,3,KZsecret,2525,30,1,2,3,33.3%,1h
15627,3,王狗子,2525,0,0,1,1,0.0%,50m
15627,3,[朵朵]九幽雪狐,2525,0,0,2,2,0.0%,58m
15648,3,TKcoco,2524,757,30,26,56,53.6%,20m
15648,3,你是不是个沙雕,2524,429,18,18,36,50.0%,4m
15648,3,安提加星港,2524,326,12,12,24,50.0%,6m
15648,3,[为了娱乐]XIXIHAHADADA,2524,314,10,10,20,50.0%,1h
15648,2,陌七,2524,252,10,10,20,50.0%,1h
15648,2,黄金脆皮虫,2524,198,7,12,19,36.8%,37m
15648,1,[专业欺负萌新]月洛褚天遥,2524,97,2,4,6,33.3%,1h
15648,3,[洛水天依]冬眠的鱼,2524,0,1,0,1,100.0%,30m
15648,3,daemon,2524,0,1,2,3,33.3%,1h
15648,1,[只会xx一波]只会光子炮台一波,2524,0,1,6,7,14.3%,23m
15648,3,奶牛骑士,2524,0,0,3,3,0.0%,7m
15659,2,springroll,2523,1460,345,335,680,50.7%,14m
15659,2,矿就是一切,2523,980,36,41,77,46.8%,6m
15659,2,FLY,2523,90,4,6,10,40.0%,1h
15659,3,[虚空圣堂议会]生者之棺,2523,60,3,3,6,50.0%,20m
15659,2,[纯净的]BIGFIOWER,2523,144,3,6,9,33.3%,6m
15659,1,比美团还能送,2523,0,2,4,6,33.3%,4m
15659,1,雪风,2523,0,2,4,6,33.3%,33m
15659,3,阎鹏的父亲,2523,0,1,0,1,100.0%,21m
15659,2,莫语,2523,0,1,3,4,25.0%,1h
15659,3,[公主联盟]本公主不菜,2523,0,0,1,1,0.0%,6m
15659,3,风城烟雨,2523,0,0,1,1,0.0%,6m
15659,1,故事很短皆是遗憾,2523,0,0,1,1,0.0%,1h
15671,3,[天朝施工队]山外青山楼外楼,2522,1484,187,181,368,50.8%,38m
15671,2,含义,2522,1051,82,54,136,60.3%,1h
15671,2,[hddys]远杂技,2522,833,34,28,62,54.8%,9m
15671,3,掠影,2522,191,6,2,8,75.0%,30m
15671,1,djv,2522,172,6,12,18,33.3%,1h
15671,1,fanhua,2522,182,6,13,19,31.6%,44m
15671,3,马斯克,2522,177,5,4,9,55.6%,1h
15671,2,Vvvvv,2522,190,5,11,16,31.2%,1h
15671,3,ZQYzqy,2522,141,4,0,4,100.0%,1h
15671,3,[秋毫七队]酒仙,2522,0,1,0,1,100.0%,1h
15671,3,越狱,2522,0,1,1,2,50.0%,50m
15671,3,铁血丶英魂,2522,0,0,1,1,0.0%,39m
15683,2,无上至尊,2521,1137,46,43,89,51.7%,28m
15683,2,[SME]aligobright,2521,652,28,29,57,49.1%,1h
15683,3,[星歌]Koloo,2521,657,25,18,43,58.1%,18m
15683,3,[天意不可违]穆雅,2521,502,20,11,31,64.5%,1h
15683,2,大本,2521,247,13,16,29,44.8%,1h
15683,3,绝世灬银河,2521,148,5,6,11,45.5%,1h
15683,2,Paraesthesia,2521,150,5,9,14,35.7%,8m
15683,3,[道友你先死]我只是想上船,2521,30,2,0,2,100.0%,20m
15683,1,大意失亲哥,2521,48,2,3,5,40.0%,54m
15683,1,Saroman,2521,0,2,4,6,33.3%,1h
15683,2,fair,2521,0,1,2,3,33.3%,26m
15683,3,[可爱小萝莉]香风智乃,2521,32,1,4,5,20.0%,14m
15683,3,[世界的另一头]黄天宇,2521,0,0,1,1,0.0%,1h
15696,1,[获胜的小蝌蚪]蓝轩辕,2520,1526,223,226,449,49.7%,60m
15696,1,Bill,2520,138,6,10,16,37.5%,1h
15696,3,IIIIIIIIIIII,2520,0,1,0,1,100.0%,1h
15696,3,[猛将]狂热者,2520,0,1,0,1,100.0%,57m
15696,3,[24CM]Ves,2520,30,1,2,3,33.3%,10m
15696,3,萌新,2520,0,0,1,1,0.0%,33m
15696,3,[超合金战队]死神,2520,0,0,2,2,0.0%,52m
15703,3,[大白护卫队]开小号必没妈,2519,1363,58,51,109,53.2%,18m
15703,3,[浙大学府]星河,2519,817,34,30,64,53.1%,34m
15703,3,辉之环,2519,381,15,8,23,65.2%,20m
15703,3,[大JJ]CAROL,2519,359,13,19,32,40.6%,17m
15703,2,TILYOS,2519,232,8,8,16,50.0%,47m
15703,3,熊熊铁拳,2519,235,8,9,17,47.1%,57m
15703,3,DailySC,2519,241,7,6,13,53.8%,1h
15703,3,[H1st]Kerrigan,2519,174,6,6,12,50.0%,34m
15703,2,比奇打金去喝茶,2519,45,6,8,14,42.9%,1h
15703,2,jun,2519,138,4,8,12,33.3%,32m
15703,2,[SFeng]KDCKED,2519,0,1,0,1,100.0%,38m
15703,2,拽丶小浪,2519,88,1,1,2,50.0%,1h
15703,1,[嘿民]Relaggl,2519,0,1,1,2,50.0%,10m
15703,3,[西雅图咖啡店]bbx,2519,0,0,1,1,0.0%,1h
15717,2,暗夜黑弓,2518,133,7,5,12,58.3%,47m
15717,3,[CRSC2]Vegeta,2518,68,3,3,6,50.0%,1h
15717,1,海椿,2518,145,3,5,8,37.5%,1h
15717,3,星水,2518,30,2,1,3,66.7%,1h
15717,3,Rakujitsu,2518,30,2,1,3,66.7%,41m
15717,3,我心凄凉不悲伤,2518,129,2,1,3,66.7%,1h
15717,3,hzk,2518,0,2,5,7,28.6%,1h
15717,1,立华奏,2518,0,1,5,6,16.7%,1h
15725,3,向前看,2517,964,38,32,70,54.3%,45m
15725,2,Recur,2517,338,22,25,47,46.8%,36m
15725,2,[大一最强]反知识分子,2517,456,17,16,33,51.5%,28m
15725,1,老范,2517,423,17,23,40,42.5%,39m
15725,3,打酱油的,2517,171,7,3,10,70.0%,30m
15725,1,GOLD,2517,99,7,8,15,46.7%,27m
15725,1,[明帝国]kranbst,2517,113,3,7,10,30.0%,3m
15725,1,浪客,2517,0,2,6,8,25.0%,7m
15725,2,我只会乱跑,2517,0,1,0,1,100.0%,1h
15725,3,[暴雪二十九队]沙怒,2517,0,1,1,2,50.0%,7m
15725,3,IORI,2517,0,1,1,2,50.0%,7m
15725,1,Trinity,2517,0,1,4,5,20.0%,26m
15725,3,[YMSB]三角队,2517,0,0,1,1,0.0%,41m
15738,3,xiaoming,2516,305,15,13,28,53.6%,11m
15738,3,BigDaddy,2516,411,14,11,25,56.0%,18m
15738,2,[電脑难度]新手,2516,114,12,17,29,41.4%,22m
15738,3,好大熊,2516,306,11,10,21,52.4%,10m
15738,3,Aaron,2516,259,9,5,14,64.3%,12m
15738,3,wuge,2516,172,6,7,13,46.2%,1h
15738,3,cccvvv,2516,97,2,2,4,50.0%,1h
15738,1,[好基友手拉手]雷神,2516,0,2,3,5,40.0%,38m
15738,1,哇塞,2516,0,2,3,5,40.0%,1h
15738,1,吃胖的卡比兽,2516,0,2,3,5,40.0%,46m
15738,3,丘山日辰,2516,0,1,0,1,100.0%,7m
15749,2,史莱姆,2515,1405,59,58,117,50.4%,52m
15749,3,阳阳,2515,368,13,15,28,46.4%,1h
15749,2,米兰,2515,292,10,14,24,41.7%,51m
15749,3,芊芊每天都要,2515,145,4,1,5,80.0%,1h
15749,3,MarkNine,2515,60,3,4,7,42.9%,1h
15749,1,是你的六六呀,2515,0,2,4,6,33.3%,1h
15749,3,[一个死肥宅]重生之我是川建国,2515,0,1,0,1,100.0%,4m
15749,2,费尔南多,2515,30,1,5,6,16.7%,25m
15749,2,[暴雪二十队]直死魔眼根源式,2515,0,0,1,1,0.0%,1h
15749,3,刀锋女王,2515,0,0,2,2,0.0%,41m
15749,3,Invisible,2515,0,0,2,2,0.0%,27m
15760,2,爆裂恒星,2514,284,33,32,65,50.8%,1h
15760,3,机枢,2514,376,14,11,25,56.0%,1h
15760,2,AndreHsu,2514,390,14,14,28,50.0%,1h
15760,3,[CAy]DXK,2514,305,12,15,27,44.4%,57m
15760,3,明璐式推进,2514,158,8,2,10,80.0%,42m
15760,3,fatswallow,2514,92,5,6,11,45.5%,20m
15760,1,EzioAuditore,2514,188,5,6,11,45.5%,12m
15760,1,我要做有素质的人,2514,0,3,3,6,50.0%,1h
15760,1,岁月如歌,2514,0,2,4,6,33.3%,1h
15760,3,[ZLR]Bargon,2514,0,1,0,1,100.0%,1h
15760,1,你我开心哦,2514,0,1,0,1,100.0%,1h
15760,3,[红莲骑士团]小哥哥,2514,0,1,1,2,50.0%,1h
15760,3,MIsaya,2514,34,1,3,4,25.0%,40m
15760,3,不送兵不舒服斯基,2514,0,0,1,1,0.0%,1h
15760,3,Marauder,2514,0,0,2,2,0.0%,1h
15775,1,[HUC铭心]你站好,2513,1594,91,93,184,49.5%,59m
15775,1,[基金会]可爱的小轩轩,2513,1468,69,68,137,50.4%,39m
15775,1,[二蛋带你飞]独白,2513,586,48,56,104,46.2%,24m
15775,3,atong,2513,863,35,24,59,59.3%,1h
15775,3,菜鸟鸟,2513,366,29,22,51,56.9%,30m
15775,2,云端鲲鹏,2513,515,21,20,41,51.2%,1h
15775,3,华尔街,2513,389,17,14,31,54.8%,11m
15775,3,[明教]爸爸,2513,200,8,7,15,53.3%,1h
15775,3,pcchen,2513,179,7,5,12,58.3%,60m
15775,2,吕晓是狗,2513,114,5,4,9,55.6%,1h
15775,1,Sugarsmell,2513,0,1,0,1,100.0%,46m
15775,2,梦终将会醒,2513,0,0,1,1,0.0%,55m
15775,3,[你好世界]wxt,2513,0,0,2,2,0.0%,1h
15775,3,connor,2513,0,0,3,3,0.0%,60m
15775,2,[小浪FANS]Cookie,2513,0,0,11,11,0.0%,1h
15790,3,矿骡王子,2512,1528,68,48,116,58.6%,1h
15790,3,[乱世夕阳红]没毛的兔子,2512,465,51,44,95,53.7%,1h
15790,2,zuofeng,2512,423,21,41,62,33.9%,9m
15790,2,[帅贯穿一身]段离羽,2512,297,11,13,24,45.8%,58m
15790,3,樱花落,2512,197,6,7,13,46.2%,18m
15790,3,[皇室联盟]SworDarTon,2512,165,5,1,6,83.3%,12m
15790,3,猛驴赛跑车,2512,30,2,2,4,50.0%,1h
15790,1,Xiapopo,2512,0,2,3,5,40.0%,26m
15790,3,[FOT]风沐烟苏,2512,0,1,0,1,100.0%,1h
15790,3,[ESKT]小仔,2512,0,1,0,1,100.0%,1h
15790,3,ACG,2512,0,1,0,1,100.0%,1h
15790,3,秃头汤姆,2512,0,0,1,1,0.0%,21m
15790,3,大虫天下,2512,0,0,1,1,0.0%,18m
15803,2,[斜星连萌]拆迁队长寸草不生,2511,939,39,34,73,53.4%,40m
15803,3,寒菁,2511,392,14,12,26,53.8%,50m
15803,1,[Hdl]风衅,2511,356,10,19,29,34.5%,1h
15803,2,[杰哥不要]FireCJ,2511,220,8,11,19,42.1%,41m
15803,3,voos,2511,148,5,6,11,45.5%,1h
15803,3,无招胜有招,2511,159,4,3,7,57.1%,1h
15803,3,没有星星的猩猩,2511,62,2,4,6,33.3%,1h
15803,2,我爱昵,2511,0,1,1,2,50.0%,7m
15803,3,kevin,2511,0,1,1,2,50.0%,1h
15803,3,[大爱EMT]小白不只是小白,2511,30,1,1,2,50.0%,36m
15803,3,[龙帝星云]巴巴罗萨,2511,97,1,3,4,25.0%,1h
15803,3,[ESKT]darling,2511,30,1,4,5,20.0%,1h
15803,3,[眼瞎盲人]花譜,2511,0,0,2,2,0.0%,12m
15803,1,PDIAAJ,2511,0,0,2,2,0.0%,46m
15817,2,tonystark,2510,1527,234,232,466,50.2%,49m
15817,3,花生芽,2510,1134,65,65,130,50.0%,4m
15817,3,雪漫,2510,363,12,12,24,50.0%,1h
15817,2,IIIIIIIIIIII,2510,258,11,11,22,50.0%,1h
15817,3,海之泪,2510,204,8,7,15,53.3%,1h
15817,1,沙迦,2510,270,8,20,28,28.6%,1h
15817,3,二五仔星际,2510,140,7,8,15,46.7%,1h
15817,2,汤达人,2510,126,4,5,9,44.4%,1h
15817,3,moon,2510,171,4,5,9,44.4%,14m
15817,3,[DSE]IIIIIIIIiI,2510,118,3,0,3,100.0%,1m
15817,3,[暴雪养鸡场]流氓,2510,60,3,2,5,60.0%,1m
15817,2,影末,2510,0,3,6,9,33.3%,48m
15817,1,[91谐会]六神,2510,48,2,5,7,28.6%,26m
15817,2,草船借东风,2510,64,2,9,11,18.2%,8m
15817,3,我叫李奶奶,2510,0,0,2,2,0.0%,1h
15817,2,[此用户已成仙]Yoshino,2510,0,0,4,4,0.0%,1h
15833,3,洛燨,2509,974,86,81,167,51.5%,1h
15833,3,wear,2509,1551,81,92,173,46.8%,18m
15833,3,[KPG2]化身邪恶富婆杀手,2509,787,27,36,63,42.9%,27m
15833,3,泡影,2509,461,17,19,36,47.2%,1h
15833,3,努力上白银,2509,406,16,13,29,55.2%,1h
15833,3,[菜鸟降落区]Michael,2509,371,15,12,27,55.6%,1h
15833,3,[圣夜学院]星际传说,2509,281,10,8,18,55.6%,20m
15833,3,Loudes,2509,172,5,4,9,55.6%,20m
15833,3,[琴筝]DARKPEACH,2509,58,3,1,4,75.0%,1h
15833,3,背影控,2509,0,1,2,3,33.3%,1h
15833,3,[泯灭快车]Winseven,2509,30,1,2,3,33.3%,50m
15833,2,panJIM,2509,0,1,3,4,25.0%,1h
15845,3,小小指挥官,2508,1497,170,166,336,50.6%,15m
15845,2,神武冰锋,2508,307,12,20,32,37.5%,1h
15845,3,[KIT6]skywings,2508,256,10,9,19,52.6%,1h
15845,3,丶苍白誓言灬,2508,319,10,11,21,47.6%,1h
15845,1,卡德罗为其,2508,324,9,15,24,37.5%,41m
15845,2,zimba,2508,240,8,9,17,47.1%,1h
15845,2,独行狼,2508,170,6,8,14,42.9%,1h
15845,3,坑爹的人族,2508,144,4,0,4,100.0%,14m
15845,3,[你已经死啦]wyb,2508,147,4,3,7,57.1%,1h
15845,3,[暴雪养鸡场]毛衣,2508,88,4,3,7,57.1%,12m
15845,3,[DSSQD]iloy,2508,88,3,3,6,50.0%,29m
15845,3,LEMON,2508,86,3,3,6,50.0%,1h
15845,3,尼古拉斯郭德纲,2508,30,2,2,4,50.0%,1h
15845,3,仰望星空的少年,2508,50,2,3,5,40.0%,1h
15845,3,bigfish,2508,88,2,6,8,25.0%,1h
15845,3,[堂口好兄弟]尤吉欧,2508,0,1,0,1,100.0%,20m
15845,3,狠驴,2508,30,1,1,2,50.0%,1h
15845,1,许你青丝白发,2508,44,1,4,5,20.0%,1h
15845,1,飞哥,2508,0,1,4,5,20.0%,54m
15845,3,怪兽乱干,2508,0,0,1,1,0.0%,1h
15845,3,夜魔,2508,0,0,1,1,0.0%,58m
15866,3,codyvon,2507,963,42,32,74,56.8%,52m
15866,1,Demon,2507,271,10,13,23,43.5%,1h
15866,3,小九,2507,159,6,3,9,66.7%,21m
15866,3,opooopooo,2507,144,5,5,10,50.0%,10m
15866,3,[镜花水月丨]qqq,2507,143,3,3,6,50.0%,1h
15866,2,风之子,2507,140,3,6,9,33.3%,1h
15866,3,[loOoOL]你贱得太过耀眼了,2507,36,2,5,7,28.6%,4m
15866,2,[RPS]AWdwa,2507,80,2,10,12,16.7%,1m
15866,1,Bootstrap,2507,96,1,2,3,33.3%,1h
15866,2,呋喃,2507,30,1,5,6,16.7%,1h
15866,3,梦蝶,2507,0,0,1,1,0.0%,7m
15866,1,ipanne,2507,0,0,1,1,0.0%,1h
15866,2,微笑心灵,2507,0,0,2,2,0.0%,55m
15879,3,老吴,2506,1636,144,135,279,51.6%,1h
15879,2,SmileMilo,2506,1401,80,85,165,48.5%,1h
15879,3,风筝,2506,1088,47,44,91,51.6%,20m
15879,3,风潇雨落,2506,413,15,17,32,46.9%,57m
15879,3,Volcano,2506,95,2,0,2,100.0%,36m
15879,1,[乳主头子]星际小子,2506,48,2,1,3,66.7%,1h
15879,3,手拿菜刀向天笑,2506,0,1,2,3,33.3%,1h
15879,2,雾洒南殿,2506,0,0,2,2,0.0%,1h
15887,1,都随风,2505,525,76,68,144,52.8%,37m
15887,3,手机没电了,2505,1026,40,41,81,49.4%,39m
15887,2,[小鸡屠宰场b]really,2505,364,15,15,30,50.0%,21m
15887,3,[黑丝小幼女]诗妙音,2505,204,7,8,15,46.7%,1h
15887,3,[慢手e族]小艾尔,2505,171,6,3,9,66.7%,29m
15887,3,焚香的道士,2505,122,6,8,14,42.9%,30m
15887,3,Versuchen,2505,95,4,2,6,66.7%,52m
15887,1,荣光照耀艾尔,2505,0,3,1,4,75.0%,46m
15887,3,cookieBro,2505,60,3,4,7,42.9%,1h
15887,3,Dust,2505,62,3,4,7,42.9%,1h
15887,3,moonwimd,2505,0,1,0,1,100.0%,11m
15887,3,Marshall,2505,30,1,3,4,25.0%,1h
15887,2,[DMUNB]豪哥,2505,30,1,7,8,12.5%,1h
15900,3,wwwwwwwwwwww,2504,1101,47,33,80,58.8%,1h
15900,1,SOS,2504,755,31,34,65,47.7%,60m
15900,3,[死鹿特小公主]Onemy,2504,545,20,16,36,55.6%,1h
15900,2,[死亡降临]火星骑士,2504,422,15,17,32,46.9%,37m
15900,3,丨余生丿小啊然丨,2504,305,11,7,18,61.1%,1h
15900,3,颖颖要坚强,2504,58,3,2,5,60.0%,28m
15900,1,六號中神通週勃通,2504,48,3,4,7,42.9%,1h
15900,1,[XXHZN3]工具人,2504,0,2,4,6,33.3%,1h
15900,1,伪天使冷魅,2504,97,2,4,6,33.3%,1h
15900,3,将来,2504,0,2,5,7,28.6%,1h
15900,1,[温柔兔公主]暮扬思雪,2504,118,2,10,12,16.7%,24m
15900,3,[战争结束了]麻薯,2504,0,0,6,6,0.0%,1h
15912,2,马歇尔参谋长,2503,785,37,35,72,51.4%,22m
15912,2,LJF,2503,528,20,24,44,45.5%,1h
15912,3,[DTOC]LxVotre,2503,384,14,16,30,46.7%,1h
15912,1,ewfij,2503,248,8,7,15,53.3%,30m
15912,3,优雅的南瓜,2503,144,5,4,9,55.6%,1h
15912,3,亲爱的啊,2503,108,3,1,4,75.0%,1h
15912,1,天池乄狂,2503,144,3,5,8,37.5%,1h
15912,3,贝塔,2503,0,1,1,2,50.0%,30m
15912,3,爱吃鼻涕的北极熊,2503,30,1,3,4,25.0%,1h
15921,1,这怎么玩啊,2502,503,21,24,45,46.7%,14m
15921,3,Darkchief,2502,539,20,16,36,55.6%,1h
15921,1,与门,2502,295,11,13,24,45.8%,1h
15921,2,Rivendell,2502,256,8,8,16,50.0%,1h
15921,3,简单男孩,2502,170,6,5,11,54.5%,1h
15921,3,[小骚骚]蛮地的巫师,2502,0,3,4,7,42.9%,58m
15921,3,jorray,2502,97,2,1,3,66.7%,2m
15921,1,浴血荣耀,2502,48,1,2,3,33.3%,1h
15929,2,呵呵呵呵,2501,366,16,19,35,45.7%,5m
15929,3,你知我爱,2501,88,4,3,7,57.1%,30m
15929,3,[萌新集结地]金色萌新啊喵,2501,0,2,5,7,28.6%,1h
15929,1,醉丶清风灬,2501,0,0,1,1,0.0%,1h
15929,2,我只想你开心,2501,0,0,1,1,0.0%,1h
15934,2,Antediluvian,2500,1539,94,71,165,57.0%,6m
15934,3,大王让我来巡山,2500,912,38,32,70,54.3%,52m
15934,1,HeidiQ,2500,356,13,19,32,40.6%,3m
15934,3,新手上路,2500,322,10,10,20,50.0%,21m
15934,2,[猫神]剑随风,2500,162,6,7,13,46.2%,6m
15934,3,白特帅,2500,157,4,2,6,66.7%,1h
15934,3,[人类保卫队]死神之子,2500,0,1,0,1,100.0%,6m
15934,3,飞翔的蜻蜓,2500,30,1,4,5,20.0%,50m
15934,3,[OrzMM]baizer,2500,0,0,1,1,0.0%,1m
15934,3,[XXHZ1]小啊李,2500,0,0,1,1,0.0%,28m
15944,3,player,2499,647,67,65,132,50.8%,18m
15944,2,艾尔的城管,2499,450,21,25,46,45.7%,22m
15944,3,爱情,2499,453,19,16,35,54.3%,10m
15944,3,Armin,2499,209,18,28,46,39.1%,19m
15944,1,义乌山鸡姬,2499,214,8,11,19,42.1%,13m
15944,3,Kurumi,2499,214,7,3,10,70.0%,1h
15944,3,[黄金海舰队]江南狗王孙哈娜,2499,180,7,7,14,50.0%,1h
15944,2,Ender,2499,195,5,8,13,38.5%,6m
15944,3,[麻瓜鸡]予怀,2499,121,4,3,7,57.1%,5m
15944,3,[大姐酒家]心中只有爱萌,2499,90,4,4,8,50.0%,1h
15944,3,[失眠者同好会]爱皮斯坦,2499,119,3,1,4,75.0%,16m
15944,3,Decade,2499,121,3,2,5,60.0%,5m
15944,1,ZZbzghost,2499,0,2,3,5,40.0%,1h
15944,3,[CPT]ZHUJIAO,2499,70,2,3,5,40.0%,1h
15944,3,Alex,2499,0,1,0,1,100.0%,1h
15944,3,lllllllll,2499,30,1,1,2,50.0%,11m
15944,3,Dragon,2499,0,0,1,1,0.0%,30m
15961,2,特种兵兔,2498,919,614,610,1224,50.2%,8m
15961,3,[女帝1号]全球包邮,2498,1137,47,45,92,51.1%,18m
15961,3,火雨,2498,952,42,28,70,60.0%,20m
15961,2,停电了怎么办,2498,1038,37,39,76,48.7%,1h
15961,3,观阴大湿,2498,590,26,25,51,51.0%,1h
15961,2,神银月,2498,253,10,7,17,58.8%,40m
15961,1,三色米饭,2498,209,8,9,17,47.1%,1h
15961,1,vincent,2498,247,8,11,19,42.1%,59m
15961,3,[暗00星]奔四的男人,2498,232,7,8,15,46.7%,30m
15961,1,我也不会玩,2498,81,7,25,32,21.9%,27m
15961,3,[暴赱总司令]虚空结晶,2498,158,5,1,6,83.3%,1h
15961,2,luckche,2498,125,3,4,7,42.9%,16m
15961,1,laizi,2498,48,3,5,8,37.5%,1h
15961,3,[科普卢老车队]罗斯柴尔德,2498,66,3,9,12,25.0%,52m
15961,1,[半个菜鸟ll]青竹小轩,2498,0,2,1,3,66.7%,1h
15961,2,帝国影子,2498,30,2,5,7,28.6%,1h
15961,2,[TwSG]鸦羽,2498,89,1,2,3,33.3%,54m
15961,3,Thr,2498,0,0,1,1,0.0%,1h
15961,3,Andres,2498,0,0,1,1,0.0%,1h
15961,3,[暴雪二十二队]挤一挤,2498,0,0,2,2,0.0%,1h
15981,1,priority,2497,1543,84,84,168,50.0%,39m
15981,3,[红茶会]专业星际八一零年,2497,678,25,24,49,51.0%,29m
15981,1,爱紫薇真是太好了,2497,304,10,19,29,34.5%,39m
15981,3,[是我赢了]季淼,2497,263,8,9,17,47.1%,30m
15981,2,suika,2497,174,8,11,19,42.1%,8m
15981,2,谁在乱叫舰队,2497,152,5,11,16,31.2%,1h
15981,3,TIT,2497,166,5,23,28,17.9%,19m
15981,3,[卐二五仔]小帅,2497,97,4,3,7,57.1%,58m
15981,3,寇可往吾亦可往,2497,115,3,0,3,100.0%,1h
15981,1,无敌的我,2497,48,3,4,7,42.9%,1h
15981,2,雇佣兵,2497,136,3,7,10,30.0%,1h
15981,1,TheWaylen,2497,0,2,2,4,50.0%,30m
15981,1,[禽禽禽]INnoVated,2497,48,2,4,6,33.3%,1h
15981,1,妈个鸡遭重了,2497,0,1,2,3,33.3%,46m
15981,1,超级指挥官,2497,0,1,4,5,20.0%,26m
15981,1,Fenix,2497,0,0,6,6,0.0%,30m
15997,3,sai,2496,925,109,123,232,47.0%,15m
15997,3,有点,2496,1328,56,50,106,52.8%,18m
15997,3,Shirin,2496,479,22,23,45,48.9%,41m
15997,3,[LDP]summer,2496,471,20,21,41,48.8%,10m
15997,3,[时令]零时雨,2496,443,16,13,29,55.2%,1h
15997,3,haosijia,2496,289,10,9,19,52.6%,1h
15997,3,never,2496,281,9,8,17,52.9%,29m
15997,3,[新宿三丁目]佩恩,2496,189,6,11,17,35.3%,40m
15997,3,[埃蒙调教团]rose,2496,160,4,3,7,57.1%,1h
15997,3,[阿迪特]异虫,2496,97,2,0,2,100.0%,1h
15997,1,为所欲为异灵术,2496,0,2,4,6,33.3%,1h
15997,3,让我独自漂流,2496,0,1,0,1,100.0%,40m
15997,3,[SDE]Mos,2496,0,0,1,1,0.0%,1h
15997,1,knight,2496,0,0,1,1,0.0%,3m
16011,2,MDDsmile,2495,1551,95,100,195,48.7%,22m
16011,1,流行单身,2495,869,63,48,111,56.8%,6m
16011,2,点撒打算,2495,542,21,19,40,52.5%,18m
16011,3,leonidas,2495,187,18,19,37,48.6%,30m
16011,3,Taj,2495,377,16,10,26,61.5%,1h
16011,3,[西湖雅座]古地明恋,2495,417,14,12,26,53.8%,39m
16011,3,dummy,2495,148,6,8,14,42.9%,10m
16011,1,SturmKrieger,2495,198,6,10,16,37.5%,3m
16011,2,MKSTON,2495,195,5,5,10,50.0%,1m
16011,3,蓦然天下,2495,121,4,5,9,44.4%,1h
16011,3,Matida,2495,155,4,7,11,36.4%,52m
16011,1,清纯玉女苍井空,2495,97,2,1,3,66.7%,27m
16011,3,小李黑子前来报到,2495,116,2,2,4,50.0%,1h
16011,3,tassadar,2495,0,0,1,1,0.0%,21m
16011,3,[夕阳红车队]Knight,2495,0,0,1,1,0.0%,10m
16011,1,[小小分分头]不发芽的土豆,2495,0,0,1,1,0.0%,13m
16011,3,chuyin,2495,0,0,3,3,0.0%,20m
16011,3,[五月花]魔法少女金月月,2495,0,0,5,5,0.0%,1h
16029,1,杨蛤蜊,2494,1430,78,79,157,49.7%,1h
16029,3,喊硬霸的都是菜,2494,948,39,30,69,56.5%,1h
16029,3,Patrick,2494,774,32,23,55,58.2%,39m
16029,2,[北有吾王2队]你好帅,2494,691,29,31,60,48.3%,14m
16029,3,Terran,2494,497,22,12,34,64.7%,1h
16029,1,[在下萌新一只]有星际好玩吗,2494,246,9,12,21,42.9%,30m
16029,3,KnightRL,2494,206,9,13,22,40.9%,25m
16029,3,LargeD,2494,165,4,4,8,50.0%,21m
16029,2,[Booldy]今天真热啊,2494,112,3,5,8,37.5%,9m
16029,3,霜降,2494,121,2,2,4,50.0%,1h
16029,3,zzzzx,2494,30,1,2,3,33.3%,42m
16029,3,[北极光小组]KingCrimson,2494,30,1,2,3,33.3%,41m
16029,3,在刨你家祖坟,2494,0,1,2,3,33.3%,10m
16029,3,GHNUT,2494,0,0,2,2,0.0%,1h
16043,2,[软柿子]kingzea,2493,766,106,102,208,51.0%,22m
16043,1,mgjprotoss,2493,934,39,34,73,53.4%,54m
16043,3,朝花夕拾,2493,453,18,15,33,54.5%,18m
16043,2,HANDHOME,2493,334,13,10,23,56.5%,30m
16043,1,[其徐如风]体温三十八度,2493,279,11,14,25,44.0%,21m
16043,3,十八岁头号,2493,243,7,7,14,50.0%,10m
16043,2,撒撒撒,2493,206,7,14,21,33.3%,1h
16043,3,[青风堂]DDR,2493,206,6,4,10,60.0%,34m
16043,2,[噩梦降临]goal,2493,162,6,12,18,33.3%,26m
16043,2,笙箫昭玖,2493,92,4,11,15,26.7%,1h
16043,3,黑骑士,2493,123,3,1,4,75.0%,2m
16043,3,兪神,2493,60,2,5,7,28.6%,20m
16043,3,酷拉小皮卡,2493,0,1,1,2,50.0%,1h
16043,3,[贪婪]战國,2493,0,0,1,1,0.0%,1h
16043,3,嗯嗯,2493,0,0,1,1,0.0%,36m
16043,2,胖即是胖,2493,0,0,1,1,0.0%,1h
16043,3,我要攻击之爪,2493,0,0,2,2,0.0%,41m
16043,3,[自由的气息]天蓝青,2493,0,0,4,4,0.0%,21m
16061,1,霍金宇宙之神,2492,1610,187,184,371,50.4%,25m
16061,3,我是你坝坝,2492,504,24,22,46,52.2%,5m
16061,3,艺术光明毁灭,2492,146,6,5,11,54.5%,35m
16061,3,[暴雪二队]无敌金刚,2492,169,4,3,7,57.1%,14m
16061,3,[浙大战队]失去单身的幽忧,2492,60,3,3,6,50.0%,35m
16061,3,人面狐狸,2492,30,2,1,3,66.7%,1h
16061,3,shadow,2492,30,2,3,5,40.0%,1h
16061,3,[是我赢了]BuryTheLight,2492,95,1,1,2,50.0%,1h
16061,3,正义黎明,2492,0,0,1,1,0.0%,28m
16061,1,[残雪映月]小聂,2492,0,0,2,2,0.0%,33m
16061,3,mxz,2492,0,0,2,2,0.0%,1h
16072,3,小白,2491,1027,195,208,403,48.4%,1m
16072,2,RBQ,2491,815,41,51,92,44.6%,5m
16072,3,伊藤诚,2491,383,24,22,46,52.2%,35m
16072,3,sadfdsdfasfg,2491,585,24,27,51,47.1%,28m
16072,2,CaOiNGeR,2491,534,21,22,43,48.8%,1h
16072,3,游人散客生,2491,311,13,17,30,43.3%,1h
16072,2,[星辰之海]巴御前超可爱,2491,294,10,12,22,45.5%,26m
16072,1,黄有哟,2491,97,4,7,11,36.4%,35m
16072,3,[抽爷]wwqlove,2491,30,2,4,6,33.3%,12m
16072,3,llk,2491,0,1,0,1,100.0%,29m
16072,3,gdmoo,2491,0,1,0,1,100.0%,1h
16072,3,[战神天下第一]捞逼大虫子,2491,0,1,1,2,50.0%,1h
16072,3,我叫紫妈怎么了嘛,2491,0,1,1,2,50.0%,1h
16072,1,星际好难玩,2491,0,0,1,1,0.0%,54m
16072,3,ittcce,2491,0,0,1,1,0.0%,1h
16072,3,Mango,2491,0,0,1,1,0.0%,1h
16072,3,AniviaLiu,2491,0,0,2,2,0.0%,30m
16089,1,SCV,2490,1324,106,101,207,51.2%,11m
16089,2,小超,2490,1322,88,82,170,51.8%,1h
16089,3,大混混,2490,1439,53,55,108,49.1%,1h
16089,2,lllilllillil,2490,439,15,16,31,48.4%,1h
16089,3,Flyshadow,2490,331,13,17,30,43.3%,1h
16089,3,[荣耀归来]吃人萝莉,2490,302,11,6,17,64.7%,1h
16089,3,娜酱,2490,211,6,6,12,50.0%,35m
16089,1,tiank,2490,96,4,6,10,40.0%,10m
16089,3,魔羽,2490,0,1,0,1,100.0%,20m
16098,1,[综合酯法]KasuganoSora,2489,1024,44,57,101,43.6%,60m
16098,3,zarc,2489,605,25,20,45,55.6%,11m
16098,2,[浙大战队]摇曳的快乐,2489,589,25,28,53,47.2%,1h
16098,3,[tiandi]HiddenPents,2489,163,5,2,7,71.4%,1h
16098,3,[Strike]一旦设定将无法更,2489,196,5,6,11,45.5%,12m
16098,3,请问请问,2489,167,4,3,7,57.1%,1h
16098,3,[五月花]骚啊马飞啊,2489,138,3,2,5,60.0%,1h
16098,3,青铜水平请多包涵,2489,0,1,0,1,100.0%,10m
16098,3,哀的笑笑,2489,95,1,1,2,50.0%,1h
16098,3,大肥蛇,2489,30,1,3,4,25.0%,58m
16098,1,Shino,2489,0,1,4,5,20.0%,1h
16098,3,wjh,2489,0,0,1,1,0.0%,35m
16110,2,[在下菜鸡一只]吉姆丶雷诺,2488,1590,110,99,209,52.6%,23m
16110,3,麻子酱,2488,1270,52,49,101,51.5%,39m
16110,3,Zachariah,2488,472,19,16,35,54.3%,16m
16110,2,zhoushunqin,2488,196,6,8,14,42.9%,59m
16110,1,[小奶狼]我就叫夏洛啊,2488,0,4,0,4,100.0%,13m
16110,1,你的菜需捆吗,2488,46,4,8,12,33.3%,1h
16110,3,[XXHZN1]方十里,2488,121,3,4,7,42.9%,1h
16110,3,[NanTeS]IIIIIIIIII,2488,95,2,0,2,100.0%,34m
16110,3,asdasd,2488,95,2,0,2,100.0%,20m
16110,3,bearblack,2488,92,2,0,2,100.0%,52m
16110,2,[黑萝卜后援队]YellowCarrot,2488,92,2,2,4,50.0%,32m
16110,3,[黄金海舰队]丨雨泽丨,2488,0,2,5,7,28.6%,5m
16110,3,究极抗韩,2488,30,1,2,3,33.3%,41m
16110,1,IIIIIIIIIIII,2488,30,1,11,12,8.3%,28m
16110,3,[暴雪零队]旗鼓相当的对手,2488,0,0,1,1,0.0%,1h
16110,3,yourppboom,2488,0,0,2,2,0.0%,29m
16126,1,[WLLWX]qwerezio,2487,1007,42,39,81,51.9%,49m
16126,3,雪狼小飞,2487,540,19,23,42,45.2%,1h
16126,3,神族,2487,406,14,28,42,33.3%,34m
16126,3,MicSama,2487,351,13,10,23,56.5%,1h
16126,3,[很强]律政先锋,2487,270,9,11,20,45.0%,1h
16126,3,liudon,2487,162,8,8,16,50.0%,1h
16126,2,空之境界,2487,117,7,12,19,36.8%,6m
16126,1,茗锦,2487,205,7,12,19,36.8%,43m
16126,3,三体联邦,2487,120,4,7,11,36.4%,5m
16126,3,pierre,2487,119,3,0,3,100.0%,11m
16126,1,福音,2487,48,3,5,8,37.5%,1h
16126,1,YapzOr,2487,48,2,0,2,100.0%,1h
16126,2,罪痕之翼,2487,60,2,8,10,20.0%,1h
16126,1,小强,2487,0,1,0,1,100.0%,1h
16126,3,sdy,2487,0,0,1,1,0.0%,42m
16141,2,CrazyWizard,2486,1558,119,109,228,52.2%,9m
16141,3,女中豪杰,2486,570,25,18,43,58.1%,1h
16141,3,[泉姐美如画]菌毯肿瘤,2486,181,12,10,22,54.5%,1h
16141,2,[NVKR]OWENWTY,2486,165,5,7,12,41.7%,48m
16141,2,你带来了希望,2486,138,5,9,14,35.7%,7m
16141,3,[绝对零度sc]我是大逗逼,2486,60,3,2,5,60.0%,7m
16141,3,[东大电竞]Ishmael,2486,145,3,3,6,50.0%,1h
16141,3,[星海争霸二]zhuang,2486,93,2,0,2,100.0%,7m
16141,3,Cinlink,2486,118,2,1,3,66.7%,1h
16141,2,[美少女萬華鏡]久遠寺有珠,2486,30,2,5,7,28.6%,1h
16141,3,苏王,2486,0,2,5,7,28.6%,1h
16141,3,天启战士,2486,0,1,0,1,100.0%,1h
16141,3,为彦而生,2486,0,0,1,1,0.0%,12m
16154,3,花开三千界,2485,1608,145,140,285,50.9%,21m
16154,2,僭越,2485,632,26,26,52,50.0%,1h
16154,3,[欢迎来蓝月城]ziyou,2485,434,19,11,30,63.3%,1h
16154,3,困难电脑,2485,374,15,18,33,45.5%,1h
16154,3,破碎的小明,2485,336,12,10,22,54.5%,18m
16154,3,[列克星顿]overlord,2485,267,10,3,13,76.9%,19m
16154,3,Immortanbird,2485,148,6,5,11,54.5%,20m
16154,3,斯卡蒂,2485,173,4,4,8,50.0%,10m
16154,1,星空下的少年,2485,48,3,2,5,60.0%,2m
16154,3,[谐星手册]超高校级的中二病,2485,122,2,2,4,50.0%,1h
16154,3,microSHlT,2485,0,2,3,5,40.0%,1h
16154,1,死亡如风,2485,0,2,3,5,40.0%,30m
16154,3,周杰伦,2485,0,2,5,7,28.6%,57m
16154,3,Flare,2485,95,1,1,2,50.0%,1h
16154,3,jokness,2485,0,1,2,3,33.3%,1h
16154,3,不菲的孤独,2485,0,0,1,1,0.0%,1h
16154,1,路西斐尔,2485,0,0,1,1,0.0%,1h
16154,1,探机说的对,2485,0,0,1,1,0.0%,50m
16172,2,Donquixote,2484,1259,72,48,120,60.0%,1h
16172,3,jack,2484,854,71,64,135,52.6%,16m
16172,3,武破天,2484,624,36,33,69,52.2%,36m
16172,2,wznddb,2484,568,23,22,45,51.1%,29m
16172,3,[HTW]whs,2484,259,9,3,12,75.0%,52m
16172,3,白门楼施工队,2484,119,9,9,18,50.0%,41m
16172,3,朽木乱花,2484,203,6,4,10,60.0%,1h
16172,3,OvO,2484,161,5,1,6,83.3%,36m
16172,1,悲伤的猪大肠,2484,48,4,9,13,30.8%,40m
16172,3,沃森和克里克,2484,161,4,12,16,25.0%,57m
16172,1,[星战分部]llllllllllll,2484,145,3,3,6,50.0%,38m
16172,1,有饭吃,2484,0,1,4,5,20.0%,46m
16172,1,ATfield,2484,40,1,6,7,14.3%,1h
16185,1,豪的精彩,2483,1383,481,493,974,49.4%,25m
16185,3,开普勒斯,2483,765,33,24,57,57.9%,1h
16185,2,牛子哥,2483,461,17,17,34,50.0%,1h
16185,2,天赐,2483,430,16,20,36,44.4%,30m
16185,3,[小仙女上线啦]阿基米德的澡盆,2483,280,13,17,30,43.3%,10m
16185,3,Katana,2483,216,7,8,15,46.7%,21m
16185,2,[羊羊快跑]zww,2483,186,7,12,19,36.8%,26m
16185,3,地狱之眼,2483,157,5,2,7,71.4%,10m
16185,3,[武道专家]名字不是七个字,2483,140,4,1,5,80.0%,45m
16185,1,Romanbanker,2483,0,2,3,5,40.0%,1h
16185,1,城市化天下无双,2483,0,2,4,6,33.3%,1h
16185,1,风中追风,2483,0,1,0,1,100.0%,4m
16185,3,派大星抓水母,2483,30,1,2,3,33.3%,18m
16185,3,zorro,2483,30,1,6,7,14.3%,10m
16185,3,SUNFLOWERS,2483,0,0,1,1,0.0%,1h
16185,3,[花妈天下第一]顾平临,2483,0,0,2,2,0.0%,20m
16201,2,霸王丸,2482,1230,327,332,659,49.6%,36m
16201,2,德一甲师医疗兵,2482,1510,154,150,304,50.7%,5m
16201,1,一天一夜,2482,945,63,65,128,49.2%,1h
16201,3,[海湾特殊队]发拉利嗨,2482,1184,53,44,97,54.6%,1h
16201,2,[龙湾]二马,2482,370,25,33,58,43.1%,6m
16201,3,橙子半夏,2482,126,12,6,18,66.7%,30m
16201,3,banana,2482,94,9,11,20,45.0%,1h
16201,3,vincent,2482,0,3,5,8,37.5%,41m
16201,3,[燕大SC]人活着就为伊莉雅,2482,0,1,0,1,100.0%,21m
16201,1,OTXKing,2482,0,1,4,5,20.0%,48m
16201,1,不知火殇,2482,0,0,1,1,0.0%,10m
16212,1,我很温柔的,2481,1286,117,138,255,45.9%,19m
16212,3,MAPLE,2481,1587,94,91,185,50.8%,6m
16212,3,[苍翼王座]公输铅,2481,1257,62,52,114,54.4%,57m
16212,3,JackieChan,2481,365,17,22,39,43.6%,7m
16212,3,[哲学研究谐会]Amkie,2481,242,8,8,16,50.0%,1h
16212,3,pianobear,2481,118,3,0,3,100.0%,1h
16212,1,小明,2481,193,3,3,6,50.0%,1h
16212,3,城中村摩的佬,2481,0,2,3,5,40.0%,52m
16212,1,康斯坦丁,2481,48,2,5,7,28.6%,38m
16212,3,skyzo,2481,0,1,0,1,100.0%,36m
16212,3,[1萌新大军1]希绪费斯,2481,0,1,0,1,100.0%,1h
16212,1,[歪比歪卜]反清复明泽拉图,2481,0,1,0,1,100.0%,3m
16212,2,走资派,2481,0,1,1,2,50.0%,60m
16212,3,[712下北泽]桂花糊骑士,2481,0,1,1,2,50.0%,19m
16212,3,[射手大射手]随二紫柔,2481,0,0,1,1,0.0%,21m
16212,1,aiaiai,2481,0,0,1,1,0.0%,1h
16228,3,艾萨克,2480,401,14,12,26,53.8%,1h
16228,1,老崔天下无敌,2480,39,5,11,16,31.2%,29m
16228,2,soloRushing,2480,48,4,8,12,33.3%,1h
16228,3,[MOMIMO]昆虫,2480,118,2,2,4,50.0%,45m
16228,2,童话,2480,0,1,0,1,100.0%,51m
16228,1,Eeason,2480,0,0,1,1,0.0%,1h
16228,3,fkoh,2480,0,0,1,1,0.0%,1h
16235,1,子非鱼网,2479,687,60,46,106,56.6%,45m
16235,1,shoWTIMe,2479,1331,56,62,118,47.5%,14m
16235,2,[KSAR]一枝花,2479,412,23,23,46,50.0%,1h
16235,3,暗黑函,2479,443,16,13,29,55.2%,1h
16235,2,二哈的世界你不懂,2479,304,13,8,21,61.9%,1h
16235,3,澐氺氷蘫,2479,221,12,11,23,52.2%,1h
16235,3,蜡笔没有小新,2479,324,11,12,23,47.8%,1h
16235,3,[尤丝蒂亚娜]Asunamgf,2479,223,8,5,13,61.5%,10m
16235,3,[崔之公司超市]崔之,2479,134,4,1,5,80.0%,1h
16235,3,[SDEt]Symmetric,2479,125,4,6,10,40.0%,41m
16235,3,专杀小贼,2479,60,3,3,6,50.0%,1h
16235,1,坟墓,2479,0,1,0,1,100.0%,1h
16235,1,哈恰玛恰玛心,2479,0,1,3,4,25.0%,2m
16235,1,淡漠雨眸,2479,0,1,4,5,20.0%,1h
16249,1,男子单打型选手,2478,1447,362,351,713,50.8%,24m
16249,3,NAPOLIYELLOW,2478,1423,102,89,191,53.4%,1h
16249,3,李的腿毛,2478,1293,61,47,108,56.5%,16m
16249,3,幻梦,2478,577,23,19,42,54.8%,52m
16249,3,口水,2478,260,12,16,28,42.9%,1h
16249,1,三缸,2478,262,9,15,24,37.5%,1h
16249,1,[浙江大学战队]南大元帅,2478,122,4,0,4,100.0%,8m
16249,1,DDE,2478,96,4,3,7,57.1%,1h
16249,3,于总,2478,90,3,5,8,37.5%,1h
16249,1,名花解语,2478,0,0,1,1,0.0%,57m
16259,3,老狗,2477,1512,226,221,447,50.6%,18m
16259,2,INNOVATION,2477,1418,60,54,114,52.6%,37m
16259,1,[无敌之师]清净瑜伽,2477,1429,51,60,111,45.9%,39m
16259,2,JloveL,2477,592,20,27,47,42.6%,10m
16259,1,nihao,2477,141,5,2,7,71.4%,1h
16259,2,qdhwdhsufe,2477,74,3,1,4,75.0%,48m
16259,1,简单电脑,2477,145,3,4,7,42.9%,1h
16259,3,[京城特务]lalala,2477,18,2,3,5,40.0%,1h
16259,2,你的萌友,2477,122,2,4,6,33.3%,1h
16259,1,武侯,2477,0,2,4,6,33.3%,27m
16259,1,余文差,2477,48,1,9,10,10.0%,57m
16259,3,香独秀,2477,0,0,2,2,0.0%,16m
16259,3,[暴tou]Lukatin,2477,0,0,3,3,0.0%,1h
16272,3,清水明山,2476,579,37,36,73,50.7%,36m
16272,3,ICboom,2476,571,23,25,48,47.9%,57m
16272,3,你看起来很好好吃,2476,465,21,21,42,50.0%,1h
16272,3,深夜丶孤行,2476,304,12,15,27,44.4%,1h
16272,2,篮坛权志龙,2476,301,11,10,21,52.4%,10m
16272,3,[南城北海]早春的雨伞,2476,97,3,6,9,33.3%,1h
16272,1,IIIIIIIII,2476,48,3,6,9,33.3%,30m
16272,3,[宜宾兄弟伙]赫莫克利特斯,2476,97,1,2,3,33.3%,1h
16272,1,禁锢之灵,2476,0,0,1,1,0.0%,1h
16281,3,白首卧,2475,1019,53,56,109,48.6%,1h
16281,1,rain,2475,525,25,25,50,50.0%,28m
16281,1,ppayl,2475,527,19,26,45,42.2%,21m
16281,3,POPNEW,2475,195,5,8,13,38.5%,1h
16281,1,waris,2475,44,2,0,2,100.0%,1h
16281,3,渡鸦一二三四五,2475,94,2,1,3,66.7%,36m
16281,3,花开为谁开,2475,0,0,5,5,0.0%,21m
16288,3,小天,2474,390,27,25,52,51.9%,1h
16288,3,BigJJCaptain,2474,466,24,15,39,61.5%,11m
16288,1,枫叶浮生残雪,2474,572,17,9,26,65.4%,40m
16288,1,llllllllllll,2474,241,12,3,15,80.0%,1h
16288,1,花园小霸王,2474,230,12,5,17,70.6%,27m
16288,1,红茶,2474,289,8,12,20,40.0%,1h
16288,3,COLOFUR,2474,182,5,4,9,55.6%,50m
16288,1,峰回军师,2474,172,4,2,6,66.7%,1h
16288,2,麦克斯韦妖,2474,120,4,11,15,26.7%,18m
16288,3,Kntwd,2474,60,2,5,7,28.6%,36m
16288,1,[社交学教官]biubiubiu,2474,0,1,0,1,100.0%,2m
16288,3,[16CM]甲方据卡机,2474,0,1,1,2,50.0%,1h
16288,1,[相爱一家亲]上善若水,2474,44,1,1,2,50.0%,35m
16288,1,大野爹,2474,0,1,4,5,20.0%,30m
16288,3,[友利奈绪丿]八云紫,2474,0,0,1,1,0.0%,10m
16288,3,飘逸的字体,2474,0,0,3,3,0.0%,19m
16288,3,[蒙蔽梦游团]stardust,2474,0,0,4,4,0.0%,41m
16305,2,星灵狂战士,2473,704,43,38,81,53.1%,39m
16305,1,[托非入欧]超次元海王星,2473,219,8,4,12,66.7%,1h
16305,2,[一等星]小猪佩奇,2473,74,5,8,13,38.5%,1h
16305,1,kinmyu,2473,0,3,8,11,27.3%,42m
16305,3,无敌的子湮,2473,30,2,2,4,50.0%,1h
16305,3,[与虫共舞]FightGaming,2473,30,2,2,4,50.0%,16m
16305,1,不放弃,2473,0,2,4,6,33.3%,6m
16305,1,[sc协会]慕周,2473,0,1,0,1,100.0%,1h
16305,3,罗杰,2473,94,1,2,3,33.3%,11m
16305,1,[DMRc]TdosXZ,2473,0,0,2,2,0.0%,1h
16305,3,SHtossfnione,2473,0,0,2,2,0.0%,1h
16316,3,Ahri,2472,615,26,28,54,48.1%,6m
16316,3,SaveME,2472,346,12,10,22,54.5%,18m
16316,2,太子贱,2472,278,11,10,21,52.4%,1h
16316,3,[幻海奇妙夜]星海之爵,2472,230,10,10,20,50.0%,21m
16316,3,[美丽的风景线]死点,2472,288,10,11,21,47.6%,10m
16316,1,中华老咸鱼,2472,204,6,4,10,60.0%,1h
16316,3,那時年少,2472,94,5,8,13,38.5%,1h
16316,3,无聊一生,2472,159,5,8,13,38.5%,1h
16316,1,[艾尔之主]指挥官,2472,124,3,1,4,75.0%,1h
16316,1,EVE,2472,0,3,4,7,42.9%,1h
16316,1,Kirito,2472,0,1,1,2,50.0%,1h
16316,1,Cloudtopwalk,2472,0,0,1,1,0.0%,42m
16316,1,简单的电脑,2472,0,0,1,1,0.0%,1h
16316,3,冰淳,2472,0,0,2,2,0.0%,1h
16316,3,xiaowangzi,2472,0,0,3,3,0.0%,21m
16331,3,TitorJ,2471,1358,138,143,281,49.1%,41m
16331,3,月殇,2471,400,65,53,118,55.1%,1h
16331,3,莫言,2471,619,25,21,46,54.3%,6m
16331,2,[古明地嗪]鸣月狐,2471,139,5,6,11,45.5%,1h
16331,3,Oww,2471,167,5,7,12,41.7%,10m
16331,1,HYFANS,2471,137,5,9,14,35.7%,3m
16331,3,mikilab,2471,123,4,5,9,44.4%,1h
16331,2,午时怎么还没到啊,2471,105,4,7,11,36.4%,9m
16331,3,醉墨游黎,2471,124,4,8,12,33.3%,1h
16331,1,[为冰雪而战]zio,2471,91,2,1,3,66.7%,34m
16331,1,甜甜的花生米,2471,0,1,0,1,100.0%,23m
16331,1,我既迷茫还懵批,2471,0,1,0,1,100.0%,1h
16331,1,comster,2471,0,1,1,2,50.0%,50m
16344,3,vmv,2470,1571,185,183,368,50.3%,39m
16344,3,神秘人,2470,1134,44,48,92,47.8%,35m
16344,2,感性的大压腿,2470,486,18,22,40,45.0%,47m
16344,3,[红尘滚滚]断牙,2470,418,15,17,32,46.9%,1h
16344,2,[秋毫]llllllllllll,2470,327,13,12,25,52.0%,39m
16344,3,[大洋彼岸团队]Giotto,2470,261,11,3,14,78.6%,42m
16344,3,[韩宗谐会]IIllIIllII,2470,324,11,9,20,55.0%,12m
16344,1,天帝,2470,276,7,5,12,58.3%,10m
16344,2,[TheUED]克哈炮王,2470,215,7,7,14,50.0%,52m
16344,3,鹰鸟小鸟,2470,192,6,7,13,46.2%,1h
16344,1,哈洗拉马,2470,159,5,2,7,71.4%,34m
16344,2,[YMSX]尼采,2470,158,5,15,20,25.0%,21m
16344,1,lIlIlIlIlIlI,2470,48,4,4,8,50.0%,15m
16344,1,游龙当归海,2470,0,3,3,6,50.0%,26m
16344,1,[WilleN]Mashiro,2470,97,2,4,6,33.3%,6m
16344,2,我寻思着我很帅,2470,88,1,2,3,33.3%,1h
16344,3,硬骨头部队,2470,0,0,3,3,0.0%,29m
16361,1,张煲皮,2469,726,48,45,93,51.6%,35m
16361,3,hhhh,2469,686,30,18,48,62.5%,12m
16361,2,[DSE]mao,2469,709,27,26,53,50.9%,1h
16361,2,[Mono]耶梦加得,2469,211,22,24,46,47.8%,1h
16361,3,RookiEee,2469,242,7,17,24,29.2%,1h
16361,3,[新手打专家]ferwtgsdrsns,2469,0,4,3,7,57.1%,1h
16361,1,丿幻丶梦姬,2469,0,3,2,5,60.0%,1h
16361,1,小杯薄荷奶绿,2469,0,3,2,5,60.0%,30m
16361,3,ShutOut,2469,97,3,3,6,50.0%,13m
16361,3,Jerry,2469,125,3,8,11,27.3%,1h
16361,3,[阿里巴巴战队]SktHeibai,2469,30,2,3,5,40.0%,1h
16361,2,伊莉雅酱,2469,128,2,4,6,33.3%,39m
16361,3,[光明正大]神崎辄识,2469,120,2,5,7,28.6%,10m
16361,3,IzayoiKazuya,2469,0,2,5,7,28.6%,1h
16361,1,[Fisker]Drake,2469,0,1,0,1,100.0%,1h
16361,3,king,2469,30,1,3,4,25.0%,54m
16361,1,不知道,2469,0,1,4,5,20.0%,1h
16361,1,不乖橙,2469,0,0,3,3,0.0%,1h
16361,1,九天一,2469,0,0,4,4,0.0%,10m
16380,3,不讲武德,2468,502,19,23,42,45.2%,21m
16380,3,[诺克萨斯]fchbvg,2468,234,9,8,17,52.9%,21m
16380,1,菜是这样的,2468,270,9,18,27,33.3%,6m
16380,3,[运大星际系]明帝,2468,145,4,6,10,40.0%,1h
16380,1,cross,2468,0,0,1,1,0.0%,35m
16380,1,[四叶草]People,2468,0,0,1,1,0.0%,27m
16380,1,会犯之敌,2468,0,0,1,1,0.0%,1h
16380,1,津官少司,2468,0,0,1,1,0.0%,54m
16388,1,丶大迷糊,2467,1123,100,107,207,48.3%,12m
16388,2,[玛戈几泰伦]有本事打正面,2467,1045,42,45,87,48.3%,19m
16388,3,[17go]迷你炸弹,2467,264,12,9,21,57.1%,1h
16388,3,嘎嘎嘎,2467,190,6,3,9,66.7%,1h
16388,2,chen,2467,201,6,4,10,60.0%,57m
16388,1,心急大神,2467,204,6,14,20,30.0%,26m
16388,3,SAKILI,2467,68,4,7,11,36.4%,16m
16388,2,真不会迷宫啊,2467,0,2,7,9,22.2%,1h
16388,2,yyfhyy,2467,58,2,8,10,20.0%,51m
16388,1,tangmen,2467,42,1,1,2,50.0%,23m
16388,1,[暗月之剑]hgc,2467,0,0,1,1,0.0%,1h
16388,1,永夜,2467,0,0,1,1,0.0%,1h
16388,3,[DMRc]浅梦丿漓,2467,0,0,2,2,0.0%,7m
16401,2,惠葱先生,2466,1538,107,108,215,49.8%,26m
16401,2,[给婉儿洗澡]午夜,2466,1532,95,91,186,51.1%,1h
16401,2,健康的性福生活,2466,1374,63,60,123,51.2%,28m
16401,1,[DX战队]神经科主任凯瑞甘,2466,594,20,31,51,39.2%,21m
16401,1,[联合动物园]哥伦比亚老树懒,2466,430,15,7,22,68.2%,7m
16401,3,简单电脑,2466,333,13,7,20,65.0%,21m
16401,1,绫罗秀衣,2466,210,6,2,8,75.0%,1h
16401,2,Pluto,2466,166,4,5,9,44.4%,1h
16401,1,slayer,2466,48,3,6,9,33.3%,1h
16401,3,萌萌哒的鸡蛋饼,2466,97,2,1,3,66.7%,1h
16401,3,亚哥,2466,60,2,6,8,25.0%,1h
16401,3,skyNine,2466,0,1,1,2,50.0%,36m
16413,2,Needle,2465,971,54,61,115,47.0%,26m
16413,2,PegasusBS,2465,252,10,10,20,50.0%,1h
16413,2,[ERO]残酷的白骨,2465,158,8,10,18,44.4%,1h
16413,1,AAOC,2465,171,5,4,9,55.6%,33m
16413,1,纯洁可爱的小饼干,2465,84,5,5,10,50.0%,1h
16413,1,半城残雪,2465,128,4,3,7,57.1%,1h
16413,3,他需要一把刀,2465,118,4,6,10,40.0%,36m
16413,3,Mihawk,2465,171,4,8,12,33.3%,1h
16413,3,[丨SLT丨]藤原卫星,2465,97,2,1,3,66.7%,1h
16413,1,核动力小蜗牛,2465,97,2,4,6,33.3%,1h
16413,1,油炸土豆泥,2465,0,2,5,7,28.6%,1h
16413,1,regicide,2465,0,1,0,1,100.0%,25m
16413,2,LHY,2465,0,1,1,2,50.0%,50m
16413,1,流星,2465,0,1,4,5,20.0%,1h
16427,2,喵喵岩,2464,1537,147,142,289,50.9%,1h
16427,3,功宝宝,2464,968,82,81,163,50.3%,15m
16427,3,[小阿giao]Shidifu,2464,1577,80,80,160,50.0%,57m
16427,3,广开兮天门,2464,749,33,29,62,53.2%,7m
16427,3,[CIE]雷娃子啊,2464,365,13,12,25,52.0%,1h
16427,2,[冲就完了]一航,2464,304,9,13,22,40.9%,1h
16427,2,Shingamm,2464,277,8,11,19,42.1%,1h
16427,1,想取骚名不知取啥,2464,154,4,2,6,66.7%,58m
16427,1,冰樱之雪,2464,168,4,6,10,40.0%,15m
16427,1,tossgirl,2464,0,3,3,6,50.0%,55m
16427,2,[VKR]唯心难却,2464,0,0,1,1,0.0%,1h
16427,1,[wmtql]scytql,2464,0,0,1,1,0.0%,1h
16427,3,[入侵地球]埃蒙,2464,0,0,2,2,0.0%,2m
16427,1,备胎哥,2464,0,0,2,2,0.0%,39m
16427,3,MVPCHINA,2464,0,0,3,3,0.0%,1h
16442,2,用土埋葬,2463,1599,190,198,388,49.0%,29m
16442,2,[我的世界]SCggbook,2463,1114,40,46,86,46.5%,1h
16442,3,爱福了友,2463,476,19,13,32,59.4%,6m
16442,3,[XXHZN1]就是无脑干,2463,491,19,22,41,46.3%,42m
16442,3,CLANNAD,2463,151,16,16,32,50.0%,35m
16442,3,[Fe3o4]吾妻蕾姆美如画,2463,430,15,14,29,51.7%,1h
16442,1,[情谊至上]大雄的哆啦梦,2463,432,14,23,37,37.8%,14m
16442,2,地球无敌舰队,2463,240,9,16,25,36.0%,22m
16442,1,卢悲欢,2463,160,5,1,6,83.3%,52m
16442,3,[小淦上天队]Dolly,2463,145,4,4,8,50.0%,28m
16442,2,czz,2463,114,4,5,9,44.4%,51m
16442,1,micha,2463,97,3,2,5,60.0%,6m
16442,3,芹菜,2463,97,2,1,3,66.7%,21m
16442,1,[路过]路过的老丁头,2463,0,2,3,5,40.0%,1h
16442,3,白猫吃橘子,2463,97,1,1,2,50.0%,1h
16442,1,[七星]迷糊的跳虫,2463,30,1,14,15,6.7%,21m
16442,1,DKfeng,2463,0,0,2,2,0.0%,1h
16442,2,greenle,2463,0,0,5,5,0.0%,49m
16460,2,黄掰掰,2462,1502,147,154,301,48.8%,6m
16460,2,[BTBU]qyh,2462,734,28,31,59,47.5%,1h
16460,3,你想集结部队吗,2462,255,21,14,35,60.0%,29m
16460,3,何某航,2462,468,17,20,37,45.9%,1h
16460,3,yugo,2462,60,3,4,7,42.9%,1h
16460,3,[白楼门]INNOVATION,2462,88,3,7,10,30.0%,40m
16460,2,ydchenyj,2462,95,2,0,2,100.0%,7m
16460,1,零度一下,2462,0,2,3,5,40.0%,1h
16460,3,红烧牛肉,2462,0,2,5,7,28.6%,58m
16460,1,瓦西西,2462,44,1,1,2,50.0%,60m
16460,3,[柏林功德殿]不肯过江东,2462,0,1,1,2,50.0%,1h
16460,2,爱苏苏,2462,88,1,1,2,50.0%,4m
16460,3,小追,2462,94,1,2,3,33.3%,42m
16460,1,涂爷的爆怒,2462,0,1,2,3,33.3%,50m
16460,1,疾风帅无止境,2462,0,1,4,5,20.0%,1h
16475,1,Arika,2461,1602,123,128,251,49.0%,25m
16475,3,老徐在不在,2461,270,12,10,22,54.5%,12m
16475,3,Flutter,2461,132,8,3,11,72.7%,5m
16475,3,爱乐姬乐团唧唧叽,2461,214,5,10,15,33.3%,26m
16475,3,佳義,2461,32,3,7,10,30.0%,1h
16475,1,Eioch,2461,0,1,0,1,100.0%,51m
16475,3,west,2461,0,0,3,3,0.0%,42m
16482,1,[YMSX]黑尾白猫,2460,233,68,72,140,48.6%,15m
16482,2,大地的海洋,2460,889,46,45,91,50.5%,1h
16482,1,温酒师,2460,310,17,15,32,53.1%,34m
16482,3,砍人就对了,2460,372,12,13,25,48.0%,1h
16482,1,青铜濤,2460,342,11,10,21,52.4%,7m
16482,3,榴莲奶糖,2460,157,7,5,12,58.3%,58m
16482,1,yeyeyesi,2460,168,5,5,10,50.0%,15m
16482,1,lcb,2460,168,4,3,7,57.1%,28m
16482,3,hasagei,2460,42,3,6,9,33.3%,26m
16482,3,国服第一骚的人,2460,121,2,2,4,50.0%,14m
16482,1,魔兽阿狂,2460,0,2,4,6,33.3%,30m
16482,3,大松哥,2460,0,2,5,7,28.6%,13m
16482,1,Doinb,2460,48,1,2,3,33.3%,1h
16482,3,灰太狼,2460,30,1,3,4,25.0%,1h
16482,1,[小鸡子娃]Leovain,2460,0,0,5,5,0.0%,1h
16497,3,[星灵王]明资,2459,805,31,28,59,52.5%,1h
16497,3,火弦,2459,350,13,14,27,48.1%,1h
16497,2,[不怂]你们只配闻我的屁,2459,319,11,10,21,52.4%,39m
16497,1,Marlboroo,2459,208,5,6,11,45.5%,1h
16497,1,YukoOgur,2459,82,2,1,3,66.7%,12m
16497,1,完了一直初始化,2459,80,2,1,3,66.7%,13m
16497,1,[整个活]蒙斯克,2459,42,2,1,3,66.7%,1h
16497,3,创圣,2459,94,2,1,3,66.7%,1h
16497,3,Smile,2459,121,2,3,5,40.0%,1h
16497,3,先鋒之痕,2459,58,2,4,6,33.3%,7m
16497,3,Thanatos,2459,0,2,5,7,28.6%,1h
16497,1,卑微男孩,2459,0,1,0,1,100.0%,1h
16497,3,夕阳零,2459,0,1,1,2,50.0%,16m
16497,3,春虫虫,2459,30,1,5,6,16.7%,42m
16497,3,贾中好,2459,0,0,1,1,0.0%,1h
16512,3,简单电脑,2458,692,72,68,140,51.4%,5m
16512,3,半朵肖雅,2458,345,11,12,23,47.8%,2m
16512,3,kaikaikai,2458,180,6,10,16,37.5%,1h
16512,1,[阿瓦隆之斩]星际蔡旭坤,2458,170,5,4,9,55.6%,1h
16512,3,不过科三不谈恋爱,2458,88,4,6,10,40.0%,21m
16512,3,狂魔,2458,30,3,6,9,33.3%,55m
16512,2,kuna,2458,30,2,1,3,66.7%,1h
16512,1,[暗黑星球]呵呵的坑,2458,44,2,2,4,50.0%,14m
16512,1,overdose,2458,0,1,4,5,20.0%,1h
16521,3,[浙大战队]铜锣湾话事人,2457,1082,55,51,106,51.9%,1h
16521,1,meekiller,2457,760,29,15,44,65.9%,1h
16521,1,[最牛的菜鸟队]LOVEXZYY,2457,638,22,28,50,44.0%,25m
16521,3,随便玩会,2457,291,11,7,18,61.1%,19m
16521,2,lgmArios,2457,288,11,10,21,52.4%,1h
16521,3,datou,2457,208,7,4,11,63.6%,57m
16521,3,灞涉霞姬,2457,189,5,6,11,45.5%,1h
16521,3,BAEBAE,2457,146,5,8,13,38.5%,1h
16521,3,多吉,2457,70,4,4,8,50.0%,1h
16521,1,[哲学光影谐会]小妞别跑,2457,135,3,9,12,25.0%,1h
16521,1,[月见]项羽,2457,0,2,3,5,40.0%,35m
16521,1,[最后的呼吸]風神,2457,42,1,2,3,33.3%,1h
16521,3,烟鬼,2457,36,1,4,5,20.0%,1h
16521,1,CXK,2457,0,1,4,5,20.0%,1h
16521,3,[火箭联盟]无天,2457,0,0,3,3,0.0%,1h
16536,3,无双,2456,1388,53,55,108,49.1%,1h
16536,1,Birozhki,2456,762,27,23,50,54.0%,35m
16536,3,[仓鼠党]Ciar,2456,584,22,22,44,50.0%,1h
16536,3,[异度黑核侵蚀]工口烧酒一伊莉雅,2456,454,17,11,28,60.7%,1h
16536,3,姐夫别这样,2456,280,11,15,26,42.3%,30m
16536,2,黑色梦魇,2456,152,8,5,13,61.5%,11m
16536,3,Bagwell,2456,222,7,7,14,50.0%,18m
16536,1,战场原荡漾,2456,44,2,0,2,100.0%,30m
16536,1,[纸巾是毒奶]菊花格格,2456,44,2,1,3,66.7%,1h
16536,1,[miku守护]打到铥,2456,80,2,4,6,33.3%,1h
16536,1,谢尔比亚瑟,2456,0,2,4,6,33.3%,6m
16536,1,sans,2456,0,1,0,1,100.0%,1h
16536,1,[KPG]凯莎女王赛高,2456,38,1,3,4,25.0%,1h
16536,3,一切战术皆换家,2456,0,0,2,2,0.0%,11m
16550,3,trek,2455,1538,124,114,238,52.1%,19m
16550,2,[幼儿园W]暗黑破坏大神,2455,1096,36,60,96,37.5%,39m
16550,3,tianhuoguosu,2455,355,15,10,25,60.0%,1h
16550,3,zest,2455,433,15,15,30,50.0%,1h
16550,2,[薄暮之光]萌哒哒的尤迪安,2455,260,11,8,19,57.9%,1h
16550,3,真好,2455,193,9,5,14,64.3%,19m
16550,1,浮影孤鸿,2455,82,3,2,5,60.0%,1h
16550,3,上条当麻,2455,34,2,2,4,50.0%,1h
16550,1,小嘴凉飕飕,2455,0,2,4,6,33.3%,1h
16550,1,红花山,2455,0,1,3,4,25.0%,15m
16550,1,DesiWim,2455,0,1,4,5,20.0%,1h
16550,3,[为了教父]疯猫,2455,97,1,4,5,20.0%,1h
16550,1,我真不会仙术,2455,0,1,4,5,20.0%,1h
16550,1,众生皆蝼蚁,2455,0,0,1,1,0.0%,41m
16550,1,夏姬八跳,2455,0,0,2,2,0.0%,34m
16565,3,AAA,2454,170,4,5,9,44.4%,44m
16565,3,[一起搞颜色啊]天下群雄莫能挡,2454,121,3,4,7,42.9%,45m
16565,3,wtf,2454,29,3,8,11,27.3%,10m
16565,1,LoveGTY,2454,44,2,1,3,66.7%,23m
16565,3,[鬼X家族]鬼浪,2454,30,2,4,6,33.3%,1h
16565,1,ligang,2454,0,0,1,1,0.0%,35m
16565,1,IIIIIIIIIIII,2454,0,0,1,1,0.0%,1h
16565,1,[洋葱骑士]失忆蝴蝶,2454,0,0,1,1,0.0%,48m
16565,1,星空咸鱼,2454,0,0,1,1,0.0%,4m
16574,1,[青风堂]又长又诡异,2453,1668,64,67,131,48.9%,35m
16574,3,[鸡饲料加工厂]滥青年,2453,317,10,12,22,45.5%,50m
16574,1,清清馨,2453,156,5,3,8,62.5%,43m
16574,2,悠扬,2453,161,5,10,15,33.3%,22m
16574,2,[我们都是传说]影之哀伤,2453,118,3,4,7,42.9%,17m
16574,3,IIIIIIIIIIII,2453,60,2,5,7,28.6%,1h
16574,3,轰炸肌,2453,0,2,5,7,28.6%,5m
16574,3,[TOSSes]Amon,2453,0,0,2,2,0.0%,19m
16574,3,[大宇恩]支持正版,2453,0,0,4,4,0.0%,18m
16583,3,机关枪哒哒哒哒哒,2452,797,129,118,247,52.2%,1h
16583,3,悠然繎,2452,330,24,8,32,75.0%,1h
16583,1,szq,2452,572,15,11,26,57.7%,28m
16583,3,LOS,2452,115,14,11,25,56.0%,29m
16583,3,[NVKR]电竞老化石,2452,134,6,9,15,40.0%,1h
16583,2,Quinlan,2452,168,6,13,19,31.6%,1h
16583,1,[柠檬保护协会]国宝熊猫,2452,160,5,3,8,62.5%,23m
16583,1,Sammind,2452,145,4,5,9,44.4%,1h
16583,3,DGVDSV,2452,90,4,6,10,40.0%,57m
16583,3,[温柔兔公主]曲无忆,2452,123,3,1,4,75.0%,14m
16583,1,铭睇似,2452,118,3,4,7,42.9%,54m
16583,1,菜鸡请不要喷,2452,88,2,4,6,33.3%,40m
16583,3,Bjergsen,2452,0,1,3,4,25.0%,1h
16583,1,耀星,2452,0,1,3,4,25.0%,6m
16583,1,BBOYCHen,2452,0,0,3,3,0.0%,10m
16598,2,大虾饶命,2451,1094,68,68,136,50.0%,1h
16598,3,FluidFire,2451,1031,49,43,92,53.3%,11m
16598,3,找个班上吧,2451,564,21,20,41,51.2%,1h
16598,2,海绵宝宝电棍,2451,291,10,9,19,52.6%,7m
16598,2,AGhbut,2451,198,9,8,17,52.9%,1h
16598,1,请叫我乖神,2451,80,5,4,9,55.6%,1h
16598,1,Mark,2451,90,2,1,3,66.7%,1h
16598,3,[我菜请打队友]chouachou,2451,30,2,3,5,40.0%,45m
16598,1,[小小怪怪]Antonio,2451,0,1,0,1,100.0%,1h
16598,1,AGAPE,2451,0,1,1,2,50.0%,1h
16598,1,[艾尔之名]变色狗,2451,0,1,1,2,50.0%,1h
16598,3,[自创]小粉狗,2451,0,1,3,4,25.0%,10m
16610,2,EricChen,2450,925,122,131,253,48.2%,1h
16610,3,山风,2450,192,6,5,11,54.5%,18m
16610,1,Corsa,2450,204,5,8,13,38.5%,41m
16610,1,Aoki,2450,124,4,2,6,66.7%,60m
16610,2,[跳虫神教]已死亡,2450,103,3,1,4,75.0%,60m
16610,1,五河琴理,2450,42,2,0,2,100.0%,25m
16610,3,关天天天,2450,0,2,7,9,22.2%,1h
16610,1,Galahad,2450,0,1,0,1,100.0%,1h
16610,1,阿斯塔罗特,2450,40,1,3,4,25.0%,1h
16610,3,[loveMM]魂魄妖梦,2450,0,1,3,4,25.0%,1h
16610,3,LJsquirrel,2450,0,0,2,2,0.0%,58m
16621,3,我是新手,2449,1236,61,57,118,51.7%,1h
16621,1,[萌新在下挨打]小鳌,2449,207,10,10,20,50.0%,29m
16621,1,[对战之队]星际争霸,2449,254,9,14,23,39.1%,1h
16621,1,day,2449,296,7,4,11,63.6%,40m
16621,3,floatdream,2449,195,6,8,14,42.9%,1h
16621,2,梦醒落花雨,2449,160,5,3,8,62.5%,1h
16621,1,[泰伦城说晚安]IIIIIIIII,2449,98,5,11,16,31.2%,21m
16621,1,[盲人协会]李雨桐,2449,124,4,0,4,100.0%,1h
16621,3,灵某啥也不会,2449,97,4,5,9,44.4%,52m
16621,1,[灵猫]鲸梦,2449,42,1,1,2,50.0%,16m
16621,1,[吸氧羊]欧派,2449,40,1,3,4,25.0%,1h
16621,1,清风析雨,2449,0,0,1,1,0.0%,1h
16621,1,浅笑且过,2449,0,0,1,1,0.0%,1h
16621,2,一咲不爱笑,2449,0,0,2,2,0.0%,1h
16621,2,小巛巛,2449,0,0,2,2,0.0%,39m
16636,3,lise,2448,1422,75,73,148,50.7%,29m
16636,2,烦恼的成长,2448,408,28,21,49,57.1%,38m
16636,2,[本子娜]爱丽丝丶卡斯兰娜,2448,402,12,20,32,37.5%,1h
16636,3,[小鸡屠宰场b]柠檬红茶,2448,273,10,6,16,62.5%,1h
16636,2,[SC2近卫军]一念花开,2448,293,10,10,20,50.0%,50m
16636,1,[科普卢老车队]你的机枪兵死光啦,2448,384,10,11,21,47.6%,1h
16636,3,[铭刻於红魂丶]本居小铃,2448,239,9,8,17,52.9%,12m
16636,3,[X英雄圣域X]有人吗,2448,168,8,6,14,57.1%,30m
16636,2,人渣,2448,30,4,5,9,44.4%,19m
16636,1,你蝶,2448,0,3,2,5,60.0%,1h
16636,3,WDWDWD,2448,88,3,6,9,33.3%,28m
16636,1,[不灭青铜]波粒二,2448,42,2,0,2,100.0%,1h
16636,1,羽兮,2448,92,2,2,4,50.0%,1h
16636,3,[CPT]从前那个少年,2448,121,2,3,5,40.0%,6m
16636,3,小小食人魔,2448,0,2,3,5,40.0%,58m
16636,3,ErrorP,2448,0,1,3,4,25.0%,5m
16636,1,[暴雪十九队]夜影枫,2448,0,0,1,1,0.0%,1h
16636,1,nigheman,2448,0,0,1,1,0.0%,54m
16654,3,skylueise,2447,1539,103,100,203,50.7%,1h
16654,3,[四佑]打不死的电工,2447,1282,54,58,112,48.2%,16m
16654,3,[LOHv]传奇浪客丶终焉,2447,1170,48,49,97,49.5%,1h
16654,1,我和婷婷,2447,1020,32,30,62,51.6%,16m
16654,3,这小伙子很帅,2447,268,9,11,20,45.0%,19m
16654,3,[是我赢了]香蕉君来搞我,2447,40,3,6,9,33.3%,5m
16654,1,[紫罗兰之都]bai,2447,42,2,1,3,66.7%,30m
16654,3,堕落血天使,2447,30,2,5,7,28.6%,30m
16654,3,[妹控万岁]逐影,2447,0,2,5,7,28.6%,1h
16654,1,SORRY,2447,0,1,0,1,100.0%,30m
16654,1,tossboy,2447,0,1,0,1,100.0%,1h
16654,3,克莱曼婷哥,2447,30,1,4,5,20.0%,1h
16654,1,dragon,2447,0,0,1,1,0.0%,3m
16654,1,月夜见,2447,0,0,1,1,0.0%,4m
16668,3,一叶子面膜,2446,759,39,41,80,48.8%,1h
16668,1,Kneio,2446,896,30,23,53,56.6%,1h
16668,2,FIRE,2446,454,18,20,38,47.4%,1h
16668,2,faiz,2446,280,9,6,15,60.0%,56m
16668,2,liyuezhao,2446,211,7,10,17,41.2%,1h
16668,3,王者无敌,2446,0,4,3,7,57.1%,14m
16668,3,瑞克的莫蒂,2446,121,3,0,3,100.0%,10m
16668,1,[落樱似梦]点点滴滴,2446,97,2,4,6,33.3%,1h
16668,3,天牙,2446,30,2,5,7,28.6%,19m
16668,1,[山西晋绥军]天宇,2446,0,1,0,1,100.0%,50m
16668,1,Vincent,2446,0,1,0,1,100.0%,1h
16668,1,粉粉滴猪,2446,0,1,4,5,20.0%,6m
16668,3,ZRQ,2446,0,0,1,1,0.0%,1h
16681,2,笙梦,2445,1568,77,75,152,50.7%,1h
16681,1,[孙岱玹]蟑螂舞姬,2445,922,55,11,66,83.3%,27m
16681,3,lovelove,2445,853,50,42,92,54.3%,10m
16681,1,[镜花水月]瞎几把乱打,2445,559,26,0,26,100.0%,1h
16681,3,[混元体我女仆]hunter,2445,572,19,31,50,38.0%,40m
16681,1,[CPT]星爵,2445,646,18,17,35,51.4%,1h
16681,1,[一起9]红尘灬落日,2445,319,14,12,26,53.8%,55m
16681,3,[Solo]对人虫使用炎拳,2445,173,9,5,14,64.3%,35m
16681,3,MIKU,2445,249,8,6,14,57.1%,57m
16681,3,WATA,2445,146,6,10,16,37.5%,1h
16681,3,[TTZ]lddeck,2445,121,3,2,5,60.0%,1h
16681,1,wxx,2445,0,1,0,1,100.0%,27m
16681,3,dasaw,2445,0,1,0,1,100.0%,1h
16681,1,小星星,2445,0,0,1,1,0.0%,29m
16681,1,phantomyrq,2445,0,0,2,2,0.0%,1h
16696,2,我要瓦斯,2444,1533,147,144,291,50.5%,1h
16696,3,朱警官,2444,464,17,15,32,53.1%,1h
16696,3,[猛禽第二舰队]Scorpio,2444,266,13,14,27,48.1%,1h
16696,3,Ctttt,2444,285,11,11,22,50.0%,1h
16696,3,GQZ,2444,234,8,8,16,50.0%,1h
16696,1,没有战术直接莽,2444,279,7,6,13,53.8%,1h
16696,1,飞机王,2444,200,5,3,8,62.5%,1h
16696,3,[萌新集结地]呼啦家的远坂凛,2444,127,4,1,5,80.0%,18m
16696,1,不是你的宝贝,2444,119,4,3,7,57.1%,30m
16696,3,[远坂世家]和泉纱雾,2444,120,4,8,12,33.3%,28m
16696,1,缘来是你,2444,48,3,6,9,33.3%,1h
16696,1,Ramstein,2444,42,2,0,2,100.0%,34m
16696,1,LENBO,2444,0,0,1,1,0.0%,58m
16696,1,雨是坠入凡间的云,2444,0,0,1,1,0.0%,23m
16696,1,[要恰大肥兔]Recluse,2444,0,0,1,1,0.0%,1h
16696,1,TXC,2444,0,0,2,2,0.0%,5m
16712,2,acrosol,2443,1466,170,177,347,49.0%,27m
16712,3,sen,2443,991,40,37,77,51.9%,45m
16712,1,PiMba,2443,358,11,9,20,55.0%,13m
16712,1,Anojk,2443,343,11,16,27,40.7%,1h
16712,2,YuiHatano,2443,266,9,11,20,45.0%,1h
16712,1,我不想好好玩游戏,2443,292,8,2,10,80.0%,1h
16712,3,[神子]wdw,2443,131,4,2,6,66.7%,11m
16712,3,死亡天幕,2443,60,4,6,10,40.0%,1h
16712,3,weard,2443,124,4,7,11,36.4%,1h
16712,3,Cary,2443,148,3,4,7,42.9%,44m
16712,2,风云飞,2443,95,2,5,7,28.6%,38m
16712,1,[棱角分明]ZzzQlzzzzql,2443,0,1,0,1,100.0%,1h
16712,1,Storm,2443,0,0,1,1,0.0%,1h
16712,1,[瀚海无双]wangce,2443,0,0,1,1,0.0%,14m
16712,2,绝对是只鸡,2443,0,0,3,3,0.0%,4m
16727,3,[暴雪三十一队]要你命三千,2442,941,361,371,732,49.3%,12m
16727,1,巴啦啦小魔仙,2442,1283,180,190,370,48.6%,37m
16727,2,迷茫的烨熠,2442,403,32,44,76,42.1%,1h
16727,3,Lucifer,2442,528,21,20,41,51.2%,42m
16727,3,萨博,2442,390,13,17,30,43.3%,1h
16727,3,伊甸园的春天,2442,278,11,12,23,47.8%,29m
16727,3,等等,2442,148,6,8,14,42.9%,11m
16727,3,MarkVier,2442,143,4,7,11,36.4%,13m
16727,3,白泽加奈惠的饼干,2442,97,2,0,2,100.0%,53m
16727,1,[weilai]冷斌,2442,0,0,1,1,0.0%,1h
16727,1,衣带渐宽终不悔,2442,0,0,1,1,0.0%,35m
16727,1,小沙鸥,2442,0,0,2,2,0.0%,1h
16739,3,Master,2441,640,23,24,47,48.9%,1h
16739,2,Cjnicolas,2441,332,14,17,31,45.2%,1h
16739,1,名字太长,2441,293,8,5,13,61.5%,1h
16739,1,黄哥的小飞机,2441,97,4,1,5,80.0%,48m
16739,1,[C47021]寒冰暗炎使,2441,82,3,3,6,50.0%,1h
16739,2,[TDB]颂太祖,2441,88,1,6,7,14.3%,1h
16745,2,[智商杯233]actfav,2440,1456,191,201,392,48.7%,28m
16745,3,ftwoA,2440,435,16,15,31,51.6%,12m
16745,1,[星际爱好者队]别再揍我了,2440,370,11,18,29,37.9%,35m
16745,2,白浮尘,2440,200,7,3,10,70.0%,1h
16745,1,刘艺控,2440,48,3,4,7,42.9%,46m
16745,1,美食博主老八,2440,0,1,0,1,100.0%,1h
16745,1,混元太马保国,2440,0,0,5,5,0.0%,1h
16752,1,sheep,2439,766,88,89,177,49.7%,1h
16752,2,红尘有你,2439,1152,42,42,84,50.0%,1h
16752,3,[铁血蓝军]直隶总督,2439,380,13,19,32,40.6%,1h
16752,2,[独立团钢炮]战逆丶,2439,346,11,20,31,35.5%,1h
16752,2,久昀,2439,228,7,11,18,38.9%,1h
16752,1,MengDetong,2439,208,6,0,6,100.0%,52m
16752,1,[不灭青铜]萧萧,2439,124,4,1,5,80.0%,1h
16752,1,拾柒丨钟情一生,2439,38,4,2,6,66.7%,20m
16752,3,Kin,2439,147,3,4,7,42.9%,1h
16752,3,斯巴拉西,2439,60,3,4,7,42.9%,12m
16752,3,为宁静而守护,2439,38,3,6,9,33.3%,1h
16752,1,siri,2439,145,3,7,10,30.0%,46m
16752,3,Acre,2439,0,2,5,7,28.6%,1h
16752,1,[六芒星]好小子,2439,0,1,0,1,100.0%,12m
16752,1,cqcqcq,2439,0,0,2,2,0.0%,50m
16752,1,www,2439,0,0,2,2,0.0%,1h
16768,3,这游戏还真没玩呢,2438,1143,164,165,329,49.8%,29m
16768,1,Rdyle,2438,1443,147,152,299,49.2%,21m
16768,1,深田咏美,2438,1110,39,51,90,43.3%,31m
16768,3,[美少女萬華鏡]软泥熊,2438,508,30,20,50,60.0%,21m
16768,2,[csuDMO]EllaDaiSuki,2438,479,21,22,43,48.8%,1h
16768,3,阿鲁方索,2438,356,13,16,29,44.8%,10m
16768,3,ILXI,2438,318,11,9,20,55.0%,1h
16768,3,zhrmghgwswsw,2438,118,7,8,15,46.7%,44m
16768,3,爱国者导弹,2438,173,4,6,10,40.0%,14m
16768,3,[曲终人散]wlxcy,2438,97,2,0,2,100.0%,1h
16768,1,Badwoman,2438,42,1,1,2,50.0%,25m
16768,1,卑微的单推人,2438,42,1,3,4,25.0%,57m
16768,3,任吗,2438,0,0,1,1,0.0%,14m
16768,3,小探机,2438,0,0,1,1,0.0%,19m
16768,1,没卵用,2438,0,0,2,2,0.0%,26m
16768,1,运营带师,2438,0,0,2,2,0.0%,1h
16768,1,争霸战场,2438,0,0,3,3,0.0%,12m
16785,2,玫瑰公子,2437,911,36,40,76,47.4%,30m
16785,3,亚伯兰,2437,306,12,16,28,42.9%,12m
16785,3,[XYG]无敌小鸡仔,2437,140,6,5,11,54.5%,39m
16785,2,[HFS]HarrisNavy,2437,116,6,8,14,42.9%,6m
16785,1,[Arctic]春宵丶美景,2437,144,4,2,6,66.7%,30m
16785,3,GuoL,2437,0,3,3,6,50.0%,1h
16785,3,[风暴领主]Colossus,2437,120,3,3,6,50.0%,16m
16785,3,[审判右翼]艾尔利刃,2437,27,2,4,6,33.3%,1h
16785,2,药饭的,2437,0,1,4,5,20.0%,20m
16785,1,无名,2437,0,0,1,1,0.0%,3m
16785,3,半九灵,2437,0,0,1,1,0.0%,1h
16796,1,不要修我地堡,2436,1454,334,349,683,48.9%,49m
16796,3,剑灭苍穹,2436,1347,56,58,114,49.1%,1h
16796,1,你还真是个天才,2436,193,4,5,9,44.4%,46m
16796,3,天仙配,2436,62,3,6,9,33.3%,12m
16796,1,难道九折吗,2436,0,1,0,1,100.0%,57m
16796,1,她也曾是我的破绽,2436,0,1,1,2,50.0%,1h
16796,1,生灵灭,2436,44,1,1,2,50.0%,29m
16796,1,[兔兔与文文]万人退吾往矣,2436,0,1,1,2,50.0%,54m
16796,1,無念,2436,0,0,1,1,0.0%,1h
16796,3,白白胖胖,2436,0,0,4,4,0.0%,21m
16806,1,背水,2435,1524,99,113,212,46.7%,1h
16806,3,moshen,2435,482,16,16,32,50.0%,12m
16806,1,空城双子,2435,48,2,1,3,66.7%,50m
16806,3,cyxgentleman,2435,60,2,6,8,25.0%,2m
16806,1,[IG丶]禁锢,2435,0,1,0,1,100.0%,1h
16806,1,总司小姐大胜利,2435,0,1,1,2,50.0%,28m
16806,1,[别看了就你了]你必定会输,2435,0,1,1,2,50.0%,1h
16806,1,xiaoya,2435,0,0,2,2,0.0%,12m
16814,1,发胶过多,2434,1091,40,24,64,62.5%,1h
16814,2,[Onceme]竹林飘雨,2434,1028,36,42,78,46.2%,48m
16814,1,[loveMM]HONGBIN,2434,538,28,26,54,51.9%,1h
16814,3,superstart,2434,637,25,31,56,44.6%,11m
16814,1,ihdcdream,2434,513,16,9,25,64.0%,34m
16814,3,小熊宝,2434,395,16,19,35,45.7%,16m
16814,1,VirusTAO,2434,554,16,44,60,26.7%,37m
16814,2,待你如初恋,2434,344,12,20,32,37.5%,1h
16814,1,[女武神的餐厅]在下御四使,2434,48,2,0,2,100.0%,1h
16814,1,[最菜战队]Maybe,2434,78,2,1,3,66.7%,29m
16814,1,沐神,2434,48,2,6,8,25.0%,1h
16814,3,猫叔,2434,0,2,6,8,25.0%,1h
16814,1,胜利,2434,0,0,1,1,0.0%,25m
16814,2,coffeego,2434,0,0,5,5,0.0%,15m
16828,1,[306NB]风萝空,2433,1310,73,82,155,47.1%,37m
16828,2,[北有唔王]星际菜鸟,2433,998,73,86,159,45.9%,48m
16828,1,狙击手仍在,2433,1686,72,70,142,50.7%,1h
16828,3,Charles,2433,1300,72,93,165,43.6%,1h
16828,1,[复活吧勇士]埋地兵种大作战,2433,945,30,30,60,50.0%,57m
16828,3,[CHNova]嬲嬲嬲嬲嬲,2433,344,16,18,34,47.1%,1h
16828,1,燃烧介质,2433,414,14,18,32,43.8%,1h
16828,3,菜鸟之路,2433,408,14,18,32,43.8%,45m
16828,2,回归平凡,2433,147,5,4,9,55.6%,7m
16828,1,如诗如畵,2433,120,3,4,7,42.9%,15m
16828,2,叶哥哥,2433,91,2,2,4,50.0%,18m
16839,1,SCBOY,2432,1733,165,168,333,49.5%,58m
16839,1,秀智呀秀智,2432,1300,86,89,175,49.1%,13m
16839,3,[黑桃Ace]陆垚仲玄,2432,588,79,77,156,50.6%,35m
16839,1,[文韬武略]sdhftuwy,2432,1306,42,44,86,48.8%,1h
16839,3,[NHSD]DavidGin,2432,872,38,34,72,52.8%,1h
16839,3,幻夜浮屠,2432,515,17,19,36,47.2%,1h
16839,3,[埃琉德尼尔]IcyAxe,2432,186,11,9,20,55.0%,7m
16839,1,longwang,2432,310,9,3,12,75.0%,3m
16839,1,[hct]埃蒙的部队,2432,188,6,12,18,33.3%,1h
16839,2,[谐字当头一个]倒悬的王朗,2432,0,1,1,2,50.0%,54m
16839,1,胆怯的泽法,2432,0,0,3,3,0.0%,40m
16850,2,骑猪猪打酱油,2431,471,17,23,40,42.5%,38m
16850,1,呆呆哒,2431,96,4,1,5,80.0%,1h
16850,3,IIIIIIIIIII,2431,88,4,7,11,36.4%,1h
16850,1,xnono,2431,0,3,2,5,60.0%,1h
16850,3,MUA,2431,48,2,3,5,40.0%,36m
16850,3,净化大师,2431,0,1,2,3,33.3%,1h
16850,1,[哔哩哔哩乾杯]咸鱼君,2431,48,1,2,3,33.3%,54m
16850,1,blackfat,2431,0,0,1,1,0.0%,2m
16850,1,紫极冰恋,2431,0,0,1,1,0.0%,43m
16859,1,YYgege,2430,613,21,21,42,50.0%,23m
16859,1,[盲眼钟表匠]TBkanade,2430,410,19,22,41,46.3%,1h
16859,2,痴呆,2430,356,13,20,33,39.4%,53m
16859,1,寂寞的杰杰,2430,226,7,6,13,53.8%,44m
16859,1,Danny,2430,112,4,0,4,100.0%,1h
16859,1,爱护,2430,97,2,3,5,40.0%,4m
16859,3,[428NB]襄阳洪世贤,2430,0,1,1,2,50.0%,1h
16859,3,杜渝成,2430,38,1,4,5,20.0%,1h
16867,3,帅气的钻石,2429,681,28,21,49,57.1%,1h
16867,3,时光机阿斗,2429,557,22,19,41,53.7%,12m
16867,3,萌新,2429,236,8,9,17,47.1%,12m
16867,1,铁血老牛,2429,222,7,3,10,70.0%,1h
16867,2,[死瓜密哈]哈密瓜死,2429,181,3,8,11,27.3%,4m
16867,3,Thunder,2429,39,2,7,9,22.2%,2m
16867,1,雨点,2429,0,1,4,5,20.0%,1h
16867,1,嘉文,2429,0,0,1,1,0.0%,7m
16867,2,孔明孔亮,2429,0,0,1,1,0.0%,1h
16876,3,Laoyuuuuu,2428,610,131,129,260,50.4%,1h
16876,1,沐浴龙血,2428,1778,69,71,140,49.3%,28m
16876,1,blanksound,2428,958,42,38,80,52.5%,57m
16876,1,[SC2战队]Endterminal,2428,1047,36,33,69,52.2%,1h
16876,1,梅卡德尔,2428,641,21,21,42,50.0%,14m
16876,1,[第一戦門舰隊]阿巴,2428,543,18,17,35,51.4%,1h
16876,3,Luc,2428,214,16,9,25,64.0%,21m
16876,3,我好菜啊,2428,300,11,12,23,47.8%,28m
16876,2,[人人人]SRay,2428,260,10,10,20,50.0%,25m
16876,2,青疫,2428,308,9,12,21,42.9%,12m
16876,2,萌新,2428,0,4,1,5,80.0%,1h
16876,1,猪子帮,2428,48,1,2,3,33.3%,1h
16876,1,酒冷烛跋,2428,44,1,2,3,33.3%,3m
16876,2,蜡笔小酸,2428,0,0,1,1,0.0%,7m
16876,1,南京小马哥,2428,0,0,1,1,0.0%,1h
16876,2,从零开始玩天梯,2428,0,0,2,2,0.0%,1h
16892,3,[肉鸡的饲养]仙筝,2427,641,28,18,46,60.9%,39m
16892,2,ATsDaytime,2427,439,19,17,36,52.8%,24m
16892,2,一个人玩游戏,2427,238,16,24,40,40.0%,1h
16892,3,千莫水水水,2427,173,3,6,9,33.3%,55m
16892,3,星梦丿凡,2427,30,2,3,5,40.0%,10m
16892,1,没有键盘打星际,2427,0,2,5,7,28.6%,1h
16892,1,[小鸡屠宰场3]安泰孙一峰,2427,97,1,1,2,50.0%,1h
16892,1,凯喵,2427,0,1,5,6,16.7%,15m
16892,3,[童话]梦中,2427,0,0,3,3,0.0%,54m
16901,2,liying,2426,779,32,41,73,43.8%,1h
16901,1,icewing,2426,515,27,21,48,56.2%,35m
16901,1,Lambert,2426,813,25,33,58,43.1%,1h
16901,2,[幼女萝莉同好]phantasma,2426,272,8,10,18,44.4%,18m
16901,3,随心所欲,2426,216,7,9,16,43.8%,1h
16901,1,超级值坑,2426,196,6,2,8,75.0%,20m
16901,1,亦可玩世不恭,2426,223,6,7,13,46.2%,1h
16901,3,出久生,2426,146,4,7,11,36.4%,26m
16901,1,[亀山社中]缺舟一帆渡,2426,84,3,4,7,42.9%,1h
16901,3,妈个鸡,2426,0,2,5,7,28.6%,1h
16901,1,[长生鹤]Trure,2426,44,1,1,2,50.0%,3m
16901,2,浅梦克星,2426,88,1,1,2,50.0%,1h
16901,1,放马子过来,2426,40,1,2,3,33.3%,1h
16901,1,星际争霸权哥,2426,0,0,1,1,0.0%,1h
16901,1,神乐七奈,2426,0,0,4,4,0.0%,5m
16916,2,花零之心,2425,973,238,242,480,49.6%,1h
16916,2,资深牛犊,2425,1520,96,85,181,53.0%,53m
16916,3,Mayvac,2425,1436,63,63,126,50.0%,1h
16916,3,清酒染白衣,2425,848,30,34,64,46.9%,11m
16916,3,虫族小弟弟,2425,497,18,16,34,52.9%,18m
16916,1,[虚空守望]夜差,2425,480,15,8,23,65.2%,60m
16916,3,英胸,2425,248,9,14,23,39.1%,21m
16916,1,荣耀指引我,2425,208,7,8,15,46.7%,16m
16916,1,[星战分部]thewolfwolf,2425,192,5,6,11,45.5%,35m
16916,2,我只想守护你,2425,121,5,13,18,27.8%,27m
16916,2,张贤,2425,0,2,2,4,50.0%,43m
16916,3,神庄,2425,0,2,6,8,25.0%,5m
16916,3,LebeWohl,2425,0,2,6,8,25.0%,13m
16916,1,PartinG,2425,0,1,0,1,100.0%,35m
16930,2,[为了虫群zz]qiaomm,2424,1166,87,80,167,52.1%,2m
16930,3,小知了,2424,866,65,61,126,51.6%,39m
16930,3,平凡的世界,2424,1507,56,60,116,48.3%,21m
16930,3,低聚果糖,2424,758,41,42,83,49.4%,2m
16930,3,骑猫过海的鱼,2424,662,29,25,54,53.7%,1h
16930,1,SHOWTIME,2424,416,20,27,47,42.6%,37m
16930,3,长桥猎人,2424,592,20,34,54,37.0%,1h
16930,3,chage,2424,187,6,3,9,66.7%,1h
16930,3,黑猫,2424,161,4,2,6,66.7%,1h
16930,1,望湖楼醉虾,2424,86,3,3,6,50.0%,40m
16930,1,梦魇,2424,96,3,5,8,37.5%,40m
16930,3,[阿迪特]凉沉君,2424,123,2,3,5,40.0%,1h
16930,1,[落魄山]夸浮,2424,46,2,6,8,25.0%,12m
16943,3,撸到天荒地老,2423,1006,66,58,124,53.2%,5m
16943,1,[大连民大]CPPmonk,2423,719,28,23,51,54.9%,40m
16943,1,陌城,2423,736,25,25,50,50.0%,1h
16943,2,Sky,2423,605,22,29,51,43.1%,1h
16943,1,这不是有手就行,2423,493,17,27,44,38.6%,31m
16943,1,Liquid,2423,446,16,6,22,72.7%,36m
16943,3,亚特兰蒂斯,2423,199,6,9,15,40.0%,19m
16943,1,[VIC]shunshun,2423,0,1,0,1,100.0%,1h
16943,1,[99ms]QTboom,2423,40,1,3,4,25.0%,9m
16943,3,[蚂蚁护卫队]聚光镜,2423,30,1,5,6,16.7%,1h
16943,1,浮华之世界,2423,0,0,1,1,0.0%,14m
16943,1,[南京工业大学]二五仔尸沉西湖,2423,0,0,2,2,0.0%,54m
16955,2,tyyuyh,2422,903,39,35,74,52.7%,14m
16955,1,孤村,2422,486,15,7,22,68.2%,9m
16955,1,wire,2422,387,13,8,21,61.9%,23m
16955,1,楠枫流沐,2422,346,10,8,18,55.6%,3m
16955,2,Minger,2422,201,7,11,18,38.9%,51m
16955,2,[残雪映月]Newplayer,2422,208,6,4,10,60.0%,1h
16955,3,killer,2422,30,2,3,5,40.0%,1h
16955,3,[OB丶]神之久夜,2422,0,1,2,3,33.3%,35m
16955,1,[不知不觉天亮]小白书生,2422,48,1,4,5,20.0%,2m
16955,2,Ender,2422,0,1,4,5,20.0%,41m
16955,2,wangling,2422,0,0,1,1,0.0%,41m
16955,1,夕阳的刻痕,2422,0,0,2,2,0.0%,14m
16955,1,ORChailly,2422,0,0,4,4,0.0%,1h
16968,3,毒爆大队长,2421,696,79,72,151,52.3%,1h
16968,2,[第四駆逐鑑隊]Another,2421,1374,53,54,107,49.5%,41m
16968,3,句酷还以,2421,667,32,28,60,53.3%,5m
16968,3,为国战蛮夷,2421,399,14,16,30,46.7%,1h
16968,1,gaoyuanhaha,2421,480,13,14,27,48.1%,1h
16968,3,NOR,2421,157,8,6,14,57.1%,42m
16968,3,SCPLAYER,2421,239,8,9,17,47.1%,1h
16968,2,沙丁鱼的爱,2421,111,5,8,13,38.5%,1h
16968,1,陆云天,2421,122,3,3,6,50.0%,1h
16968,1,驾鹤望浮云,2421,132,3,5,8,37.5%,1h
16968,1,[王师北定]秋桐,2421,128,3,6,9,33.3%,57m
16968,1,[鬼谷]人族就输不了,2421,84,2,3,5,40.0%,3m
16968,1,不肝居士,2421,96,2,5,7,28.6%,5m
16968,2,龙鸣熏,2421,88,1,2,3,33.3%,56m
16968,3,jsjznz,2421,0,1,2,3,33.3%,1h
16968,2,耳东陈,2421,0,1,4,5,20.0%,1h
16968,3,神田太宇,2421,30,1,6,7,14.3%,30m
16968,1,勤奋者,2421,0,0,1,1,0.0%,54m
16968,1,[我们超级勇敢]勇敢的肝,2421,0,0,1,1,0.0%,1h
16987,2,gsfxxupeng,2420,1392,245,238,483,50.7%,9m
16987,3,[NVKR]欢颜,2420,1399,55,55,110,50.0%,12m
16987,3,deathmagic,2420,342,12,18,30,40.0%,1h
16987,2,进击的巫妖王,2420,282,10,12,22,45.5%,25m
16987,2,IIIIIIIIIIII,2420,172,6,12,18,33.3%,28m
16987,1,ZEROCOOL,2420,120,2,1,3,66.7%,39m
16987,3,Loadluomo,2420,60,2,6,8,25.0%,1h
16987,1,狂野男孩苏大强,2420,0,1,0,1,100.0%,1h
16987,1,机械之鱼人,2420,0,1,0,1,100.0%,34m
16987,1,[东方众]Drsfjo,2420,0,1,1,2,50.0%,1h
16987,2,HUIHUI,2420,0,1,4,5,20.0%,1h
16987,1,渣渣张很努力啊,2420,0,0,2,2,0.0%,1h
16999,2,[樱丘]神利苏,2419,1129,57,57,114,50.0%,5m
16999,3,skytemple,2419,208,8,11,19,42.1%,28m
16999,2,彭小帅,2419,214,7,3,10,70.0%,17m
16999,1,上白泽慧音,2419,211,5,6,11,45.5%,1h
16999,3,QueenSea,2419,151,5,8,13,38.5%,1h
16999,1,法规汇,2419,192,4,5,9,44.4%,54m
16999,3,暗影之龙,2419,127,4,7,11,36.4%,1h
16999,2,fire,2419,152,4,8,12,33.3%,1h
16999,1,向华为磕头,2419,76,3,0,3,100.0%,1h
16999,1,milk,2419,40,1,2,3,33.3%,23m
16999,1,SCV,2419,0,1,3,4,25.0%,1h
16999,1,[大佬手下留情]泽叔天下第一,2419,0,0,1,1,0.0%,1h
16999,1,MoriyaSuwako,2419,0,0,1,1,0.0%,1h
16999,1,[鲲之大]Naive,2419,0,0,1,1,0.0%,1h
17013,1,临淄勇士区的孙亮,2418,1624,196,208,404,48.5%,44m
17013,1,鬼武灬欲血,2418,1108,43,36,79,54.4%,1h
17013,1,章大仙,2418,607,27,31,58,46.6%,1h
17013,2,尔冬,2418,502,18,27,45,40.0%,1h
17013,1,王不留行,2418,532,16,15,31,51.6%,31m
17013,1,ddaihong,2418,477,15,13,28,53.6%,14m
17013,1,铸子弟受到攻击,2418,262,8,9,17,47.1%,1h
17013,3,[最强战神]阿巴阿巴,2418,90,5,8,13,38.5%,10m
17013,1,diachristo,2418,92,2,4,6,33.3%,14m
17013,1,自觉地永行,2418,0,2,4,6,33.3%,27m
17013,1,社会,2418,40,1,1,2,50.0%,58m
17013,1,弱音,2418,0,0,1,1,0.0%,14m
17025,2,[48K纯帅]幻之命,2417,1313,62,70,132,47.0%,24m
17025,3,发胶手,2417,553,19,21,40,47.5%,1h
17025,3,[西安交通大学]fungi,2417,287,10,12,22,45.5%,1h
17025,1,Bogus,2417,230,7,6,13,53.8%,35m
17025,2,BMWruina,2417,117,7,16,23,30.4%,49m
17025,1,[征服之海]恩生平晓,2417,247,6,1,7,85.7%,1h
17025,2,软饭硬吃曹达华,2417,179,5,7,12,41.7%,12m
17025,2,Silicon,2417,0,1,0,1,100.0%,23m
17025,2,力量,2417,0,1,4,5,20.0%,1h
17034,2,[飞翔的蔬菜]飞翔的蔬菜,2416,199,35,37,72,48.6%,1h
17034,3,柏树林,2416,382,14,21,35,40.0%,1h
17034,3,新娘,2416,315,13,12,25,52.0%,2m
17034,1,[花之暴君]风见幽香,2416,404,11,11,22,50.0%,1h
17034,3,橘子汁,2416,210,8,11,19,42.1%,1h
17034,3,LightningW,2416,220,8,12,20,40.0%,28m
17034,2,[LYC]SATSAR,2416,38,5,5,10,50.0%,1h
17034,1,SoLo,2416,192,4,7,11,36.4%,1h
17034,1,sdfhfdghrj,2416,108,3,2,5,60.0%,1h
17034,1,[全杨最佳]猪肉大葱叫,2416,169,3,6,9,33.3%,1h
17034,1,银斧头,2416,80,2,1,3,66.7%,36m
17034,1,倰思,2416,0,2,4,6,33.3%,49m
17034,1,[极限菜鸟]llx,2416,97,2,5,7,28.6%,30m
17034,1,mrsukuralu,2416,0,0,1,1,0.0%,1h
17048,2,伊斯利,2415,1274,136,139,275,49.5%,19m
17048,2,llllllllllll,2415,1430,123,122,245,50.2%,39m
17048,1,阿狸是我妹妹,2415,1405,97,102,199,48.7%,1h
17048,3,星星,2415,1066,60,68,128,46.9%,27m
17048,1,Pimba,2415,810,33,18,51,64.7%,1h
17048,3,槐雪,2415,556,21,24,45,46.7%,1h
17048,1,超神菜鸟,2415,280,12,13,25,48.0%,58m
17048,1,诺亚方舟,2415,356,9,5,14,64.3%,1h
17048,2,Garbage,2415,198,8,12,20,40.0%,1h
17048,1,黄东文,2415,121,3,6,9,33.3%,1h
17048,1,Sukare,2415,40,2,0,2,100.0%,1h
17048,1,[WDK]中关村孙一峰,2415,97,2,5,7,28.6%,1h
17048,1,[七宫智音]冬瓜你个茄子,2415,48,1,4,5,20.0%,41m
17048,1,IDarkMoon,2415,0,0,1,1,0.0%,1h
17048,1,万物皆虚,2415,0,0,1,1,0.0%,1h
17048,2,撒库拉斯,2415,0,0,23,23,0.0%,18m
17064,1,那个仙人,2414,343,83,86,169,49.1%,1h
17064,1,椿生,2414,668,22,20,42,52.4%,1h
17064,2,瞐柒,2414,226,7,9,16,43.8%,17m
17064,1,iwooo,2414,138,5,6,11,45.5%,1h
17064,1,Apmon,2414,144,5,7,12,41.7%,33m
17064,1,孙哥起峰了,2414,162,5,8,13,38.5%,1h
17064,3,Logic,2414,122,5,11,16,31.2%,29m
17064,1,天下人,2414,144,4,5,9,44.4%,1h
17064,1,LIUSEQINGYI,2414,106,3,3,6,50.0%,1h
17064,1,斯奈菲尔,2414,116,3,3,6,50.0%,16m
17064,3,死神收割来了,2414,60,3,5,8,37.5%,30m
17064,1,[长街听风雨]JUGLUCKLY,2414,40,2,0,2,100.0%,1h
17064,1,[请先打我隊友]旌旗十万斩阎罗,2414,86,2,4,6,33.3%,42m
17064,2,CryWind,2414,86,2,7,9,22.2%,1h
17064,1,白门楼上全是吕布,2414,42,1,3,4,25.0%,29m
17064,2,War,2414,0,1,3,4,25.0%,6m
17064,2,小毒狼,2414,0,1,4,5,20.0%,49m
17064,3,大白,2414,32,1,5,6,16.7%,5m
17082,1,bat,2413,1587,154,155,309,49.8%,44m
17082,1,打不过是你自己菜,2413,1554,63,71,134,47.0%,7m
17082,3,北极光,2413,833,50,48,98,51.0%,19m
17082,1,Tom,2413,1221,45,53,98,45.9%,60m
17082,1,[visher]segarp,2413,617,21,13,34,61.8%,60m
17082,1,Lcrab,2413,575,21,25,46,45.7%,31m
17082,3,电竞毒瘤柯震东,2413,156,7,11,18,38.9%,36m
17082,3,[KK开]筱明,2413,122,3,1,4,75.0%,10m
17082,2,Ecris,2413,46,2,4,6,33.3%,41m
17082,1,RubberPig,2413,0,1,0,1,100.0%,1h
17082,1,Sue,2413,0,1,2,3,33.3%,52m
17082,2,Telanx,2413,0,1,4,5,20.0%,15m
17082,2,IDWLL,2413,0,1,4,5,20.0%,20m
17082,2,haha,2413,0,1,4,5,20.0%,54m
17082,2,匙锁无双,2413,0,1,4,5,20.0%,1h
17082,1,刘刘,2413,0,0,1,1,0.0%,51m
17082,1,床单当斗篷,2413,0,0,1,1,0.0%,1h
17082,1,智商堪忧锐萌萌,2413,0,0,2,2,0.0%,2m
17100,1,[黑光虫族]刀锋主宰,2412,271,19,19,38,50.0%,1h
17100,3,赫赫呵呵喝喝,2412,476,18,16,34,52.9%,6m
17100,3,第五晓杰,2412,198,10,3,13,76.9%,1h
17100,3,轩岚,2412,217,7,11,18,38.9%,1h
17100,1,幽幽,2412,143,5,4,9,55.6%,6m
17100,3,菜到飞起,2412,152,5,10,15,33.3%,7m
17100,1,qqxu,2412,92,3,3,6,50.0%,24m
17100,2,我真的不是条码人,2412,46,2,1,3,66.7%,1h
17100,1,first,2412,0,0,1,1,0.0%,1h
17100,1,NightWind,2412,0,0,2,2,0.0%,1h
17110,1,醒醒吧大清亡了,2411,1518,172,176,348,49.4%,25m
17110,2,AICmeng,2411,1299,125,128,253,49.4%,21m
17110,1,於樱枝同学,2411,461,15,18,33,45.5%,13m
17110,1,寒阳雪,2411,290,9,2,11,81.8%,43m
17110,1,silik,2411,144,5,3,8,62.5%,1h
17110,3,妖艳儿,2411,177,5,8,13,38.5%,1h
17110,2,小羊肖恩的救赎,2411,137,4,3,7,57.1%,32m
17110,3,轩宇,2411,170,4,6,10,40.0%,1h
17110,3,熊熊,2411,123,4,7,11,36.4%,42m
17110,1,阿呆,2411,0,3,4,7,42.9%,1h
17110,1,紫色的翠花,2411,0,2,5,7,28.6%,6m
17110,2,kgbnrmtui,2411,0,2,12,14,14.3%,1h
17110,1,[上学威龙]帝国每月最佳劳工,2411,0,0,2,2,0.0%,1h
17123,3,Tanke,2410,478,16,22,38,42.1%,1h
17123,1,tic,2410,336,9,10,19,47.4%,28m
17123,1,KSSK,2410,226,6,9,15,40.0%,3m
17123,2,king,2410,30,2,3,5,40.0%,55m
17123,1,腹肌除皱资深专家,2410,0,1,4,5,20.0%,14m
17123,1,[探姬同萌会]嫌疑喵,2410,92,1,5,6,16.7%,14m
17123,1,[RDFZsc]是盒盒盒子啊,2410,0,0,1,1,0.0%,54m
17123,1,紫川南,2410,0,0,2,2,0.0%,1h
17131,1,赵昱江,2409,881,36,43,79,45.6%,1h
17131,3,致命的爱,2409,709,27,38,65,41.5%,40m
17131,1,神经中枢,2409,651,21,24,45,46.7%,3m
17131,1,[万象天引]蛋壳,2409,236,16,8,24,66.7%,28m
17131,3,[最菜战队]名字,2409,309,13,8,21,61.9%,1h
17131,3,[哦哟喂呀]路虎揽胜,2409,348,12,17,29,41.4%,11m
17131,2,没有人可以不死,2409,254,7,13,20,35.0%,7m
17131,1,妙妙海里的鸡,2409,168,4,5,9,44.4%,34m
17131,2,阴阳剪刀,2409,118,4,7,11,36.4%,17m
17131,1,爱笑怎么了,2409,165,4,10,14,28.6%,1h
17131,3,[DARKS]DarK,2409,120,4,12,16,25.0%,12m
17131,1,虫族真滴太阴间了,2409,48,2,6,8,25.0%,2m
17131,1,[萌新总队]打死你个小瓜皮,2409,0,1,0,1,100.0%,57m
17131,3,rushB,2409,30,1,2,3,33.3%,1h
17131,2,杨汶锜,2409,0,1,4,5,20.0%,4m
17131,3,guguEnoch,2409,30,1,7,8,12.5%,11m
17147,3,传染给别人,2408,1476,126,123,249,50.6%,22m
17147,1,波罗提木叉,2408,1533,117,120,237,49.4%,8m
17147,3,[Aalis]沙耶,2408,581,24,30,54,44.4%,18m
17147,1,FIyboat,2408,568,18,16,34,52.9%,1h
17147,3,[I我是你爹I]IIIIIIIIIIII,2408,156,5,2,7,71.4%,58m
17147,3,[为星光而战]唯我独尊,2408,159,5,8,13,38.5%,1h
17147,1,[XXHZ31]丢钱小楠,2408,0,1,2,3,33.3%,1h
17147,2,新手承让,2408,0,1,4,5,20.0%,56m
17147,1,[猫神]嘿嘿你猜,2408,0,1,5,6,16.7%,1h
17147,2,学种田,2408,0,0,5,5,0.0%,1h
17157,2,YZT,2407,1583,283,301,584,48.5%,23m
17157,3,华实,2407,643,24,27,51,47.1%,45m
17157,1,[阿里巴巴战队]血虐丧尸围城,2407,603,23,21,44,52.3%,7m
17157,3,[AOT]LHooM,2407,534,18,20,38,47.4%,1h
17157,2,hedgehog,2407,276,9,8,17,52.9%,7m
17157,1,二狗子,2407,219,9,9,18,50.0%,51m
17157,1,[CPT]Magicterrani,2407,276,7,10,17,41.2%,31m
17157,1,Shadow,2407,248,6,10,16,37.5%,16m
17157,3,时罅,2407,94,5,9,14,35.7%,1h
17157,1,lwbnb,2407,38,4,10,14,28.6%,52m
17157,1,[剑所指心所向]秋夏,2407,0,1,0,1,100.0%,46m
17157,2,来干我呀,2407,0,1,4,5,20.0%,1h
17157,2,漂泊天涯,2407,0,1,4,5,20.0%,41m
17157,1,初春飾利,2407,0,0,2,2,0.0%,16m
17157,2,[专业de团队]群星,2407,0,0,3,3,0.0%,44m
17157,3,HSS,2407,0,0,5,5,0.0%,1h
17173,2,为爱而生,2406,1498,87,98,185,47.0%,39m
17173,2,妈个鸡,2406,681,62,65,127,48.8%,52m
17173,1,XIN,2406,1396,50,51,101,49.5%,40m
17173,3,年少轻灬狂,2406,311,16,14,30,53.3%,1h
17173,1,梦千秋,2406,344,11,5,16,68.8%,1h
17173,1,战无不败,2406,390,11,14,25,44.0%,1h
17173,1,[LOHv]我叫哀木涕,2406,317,10,17,27,37.0%,34m
17173,3,小宝贝,2406,146,4,1,5,80.0%,1h
17173,1,魂祭一雪舞,2406,78,2,2,4,50.0%,1h
17173,1,simple,2406,96,2,5,7,28.6%,46m
17173,1,[秦时明月]不爱董小姐,2406,0,1,0,1,100.0%,58m
17173,1,贵州普华制药,2406,0,1,2,3,33.3%,1h
17173,2,祖安大师,2406,0,1,4,5,20.0%,44m
17173,1,[小埋]阿曼达,2406,0,0,1,1,0.0%,1h
17173,1,[嘤嘤嘤呜呜]時崎,2406,0,0,2,2,0.0%,60m
17173,3,[33CM]我的兵哪去了,2406,0,0,3,3,0.0%,1h
17189,3,[中华何平]夜行者,2405,1518,152,151,303,50.2%,45m
17189,1,[野蛮猫骑士]依然,2405,612,42,46,88,47.7%,28m
17189,1,huza,2405,765,26,25,51,51.0%,10m
17189,3,sincejuly,2405,449,17,17,34,50.0%,1h
17189,3,miracle,2405,249,7,10,17,41.2%,5m
17189,3,深井冰,2405,163,5,7,12,41.7%,17m
17189,1,我是个新人,2405,126,4,5,9,44.4%,1h
17189,3,amethyst,2405,0,3,5,8,37.5%,1h
17189,1,[要素黎明]零号菜鸡,2405,78,2,2,4,50.0%,28m
17189,2,番茄,2405,0,1,4,5,20.0%,1h
17189,1,[世风第三帝国]汗水宝宝,2405,0,0,1,1,0.0%,1h
17189,1,梦魇,2405,0,0,1,1,0.0%,1h
17201,1,黎莫,2404,1316,57,54,111,51.4%,9m
17201,3,妾未散,2404,191,11,13,24,45.8%,30m
17201,3,[天下布武丶]君莫笑,2404,260,9,9,18,50.0%,1h
17201,3,单子阳,2404,34,2,2,4,50.0%,15m
17201,1,倾城,2404,86,2,2,4,50.0%,1h
17201,2,天依公主,2404,0,1,4,5,20.0%,1h
17201,3,sdadaohi,2404,14,1,5,6,16.7%,1h
17208,1,[王者家族]ypjqqq,2403,210,5,2,7,71.4%,24m
17208,2,qwad,2403,0,4,1,5,80.0%,22m
17208,1,狗拿耗子,2403,156,4,6,10,40.0%,34m
17208,3,郎月疏怀,2403,58,2,6,8,25.0%,1h
17208,1,狂风中相拥,2403,0,1,0,1,100.0%,40m
17208,2,[FsA]Meego,2403,0,1,4,5,20.0%,1h
17208,2,扫仙,2403,0,1,4,5,20.0%,1h
17208,1,[暗夜王牌]Rocket,2403,0,0,1,1,0.0%,51m
17208,1,[灬丨十戒]菊花朵朵开,2403,0,0,1,1,0.0%,34m
17217,1,[Aegean]Quincy,2402,1709,121,109,230,52.6%,23m
17217,1,[猫神]无尽怒气合计,2402,428,14,17,31,45.2%,1h
17217,1,表面兄弟,2402,442,12,13,25,48.0%,1h
17217,1,[天际线]老年战神,2402,208,6,9,15,40.0%,35m
17217,2,衰神,2402,154,6,12,18,33.3%,1h
17217,1,ParaXD,2402,164,5,7,12,41.7%,7m
17217,1,王动,2402,121,4,2,6,66.7%,4m
17217,2,hhtiancai,2402,149,4,7,11,36.4%,1h
17217,1,科普卢星区的狛爵,2402,126,3,6,9,33.3%,1h
17217,1,浩然是最帅的,2402,0,1,0,1,100.0%,1h
17217,1,Star,2402,0,1,1,2,50.0%,50m
17217,2,一呗,2402,0,1,4,5,20.0%,4m
17217,1,自在逍遥,2402,0,1,5,6,16.7%,46m
17217,1,江水月丶,2402,0,0,2,2,0.0%,4m
17217,1,戏命师,2402,0,0,2,2,0.0%,3m
17232,3,yikai,2401,1535,178,178,356,50.0%,58m
17232,3,Ray,2401,1192,53,51,104,51.0%,1h
17232,1,[玄門]Chins,2401,884,29,28,57,50.9%,23m
17232,3,华零零七,2401,367,23,22,45,51.1%,13m
17232,2,[爱国]wangshi,2401,380,14,22,36,38.9%,1h
17232,3,yukito,2401,186,7,10,17,41.2%,1h
17232,3,原始酋长,2401,192,7,12,19,36.8%,1h
17232,1,Loveandpiece,2401,198,5,5,10,50.0%,1h
17232,1,[HustSC]Otin,2401,144,2,2,4,50.0%,15m
17232,1,冷风氏,2401,137,2,7,9,22.2%,28m
17232,2,梅川苦茶,2401,0,1,4,5,20.0%,1h
17232,1,[SCLR]NearNight,2401,0,1,6,7,14.3%,1h
17232,1,Predator,2401,0,0,1,1,0.0%,1h
17245,2,[梦瑾空人心]天使之翼,2400,1133,46,46,92,50.0%,26m
17245,3,[绘梨依]路明非,2400,200,6,10,16,37.5%,1h
17245,3,快叫爸爸,2400,171,4,9,13,30.8%,58m
17245,2,爺灬傲奈我何,2400,0,2,3,5,40.0%,1h
17245,1,XZero,2400,0,2,5,7,28.6%,1h
17245,1,[今天你快乐吗]快乐的酒席,2400,0,1,0,1,100.0%,1h
17245,2,Joker,2400,0,1,4,5,20.0%,1h
17245,1,臭鞋子蜀黍,2400,0,0,1,1,0.0%,58m
17253,1,天空之城,2399,1116,48,35,83,57.8%,1h
17253,1,[慢手e族]吕布屹立于虎牢关,2399,854,45,43,88,51.1%,1h
17253,1,迅猛,2399,1095,42,38,80,52.5%,35m
17253,1,我是你花,2399,812,33,32,65,50.8%,9m
17253,3,Valkyrie,2399,268,11,18,29,37.9%,1h
17253,1,zzzzzz,2399,166,5,4,9,55.6%,12m
17253,1,[Chaos6]Intothepower,2399,184,5,6,11,45.5%,1h
17253,1,valor,2399,119,3,2,5,60.0%,1h
17253,1,鲲鹏万里,2399,122,3,3,6,50.0%,1h
17253,1,李狗蛋,2399,146,3,5,8,37.5%,14m
17253,1,你的机枪兵,2399,0,0,1,1,0.0%,27m
17253,1,噬魂夜的幽灵,2399,0,0,2,2,0.0%,7m
17265,2,无情小魔仙,2398,676,30,27,57,52.6%,5m
17265,2,[萨尔那加议会]RKD,2398,243,7,9,16,43.8%,32m
17265,2,tizzy,2398,134,6,11,17,35.3%,17m
17265,3,DeaceGrace,2398,116,5,6,11,45.5%,1h
17265,1,[慢手e族]战神,2398,0,4,4,8,50.0%,31m
17265,2,冰冻菠萝油,2398,147,3,5,8,37.5%,1h
17265,1,piano,2398,40,2,1,3,66.7%,1h
17265,2,薄言,2398,0,2,3,5,40.0%,1h
17265,1,[YoungD]CraneLFish,2398,96,2,5,7,28.6%,1h
17265,1,[诺娃小姐姐]海伦娜,2398,0,1,0,1,100.0%,1h
17265,1,[一般赢不了]克劳泽,2398,0,1,0,1,100.0%,54m
17265,3,[死亡的空隙]星际魔龙,2398,0,0,1,1,0.0%,26m
17265,1,九霄云下月阳关,2398,0,0,1,1,0.0%,28m
17265,1,旅店老板,2398,0,0,1,1,0.0%,1h
17279,2,小板砖,2397,668,51,52,103,49.5%,49m
17279,3,BiliLake,2397,255,10,8,18,55.6%,35m
17279,1,ETO,2397,286,9,6,15,60.0%,1h
17279,1,生如夏花,2397,270,8,9,17,47.1%,1h
17279,1,SCIKlLLER,2397,198,5,4,9,55.6%,35m
17279,3,孙焕家,2397,146,4,1,5,80.0%,1h
17279,3,櫻庭楓,2397,30,3,6,9,33.3%,1h
17279,3,煜小天,2397,30,3,7,10,30.0%,1h
17279,3,[JUVE]无敌的小邓,2397,95,2,4,6,33.3%,1h
17279,1,狂战雄霸,2397,0,2,5,7,28.6%,14m
17279,1,TinTin,2397,48,1,3,4,25.0%,10m
17279,1,暗红星辰,2397,0,0,1,1,0.0%,1h
17291,3,我爱加藤惠,2396,1503,59,55,114,51.8%,1h
17291,3,[半夏]黑翼路西法,2396,421,38,39,77,49.4%,1h
17291,1,xiaochen,2396,283,6,9,15,40.0%,1h
17291,2,黑色咏叹,2396,88,2,0,2,100.0%,51m
17291,3,[衡水中学]飞氘,2396,123,2,3,5,40.0%,60m
17291,2,[亲爱的队友]潇枫哥哥,2396,0,2,3,5,40.0%,15m
17291,1,Aimee,2396,0,0,2,2,0.0%,1h
17298,3,嗑个药,2395,807,88,90,178,49.4%,11m
17298,1,leisusu,2395,1212,57,58,115,49.6%,26m
17298,1,[NVKR]十二年秋,2395,850,26,26,52,50.0%,1h
17298,1,龙裔,2395,509,18,12,30,60.0%,58m
17298,1,HELL,2395,160,4,0,4,100.0%,3m
17298,1,赛因,2395,121,4,1,5,80.0%,1h
17298,1,无心叛逃,2395,38,1,1,2,50.0%,1h
17298,1,胡椒肌肉加可乐,2395,0,0,1,1,0.0%,1h
17298,1,DarkParrot,2395,0,0,1,1,0.0%,2m
17307,2,Ggggggg,2394,848,78,75,153,51.0%,59m
17307,1,米饭突击队,2394,711,29,25,54,53.7%,7m
17307,1,吃猫鼠,2394,452,19,16,35,54.3%,1h
17307,2,兵臨城丅,2394,274,9,13,22,40.9%,1h
17307,2,John,2394,209,7,12,19,36.8%,17m
17307,1,打我队友别打我,2394,240,6,7,13,46.2%,1h
17307,3,lllllllllll,2394,231,6,10,16,37.5%,36m
17307,3,Waitforlove,2394,183,5,10,15,33.3%,1h
17307,1,zzl,2394,122,4,3,7,57.1%,1h
17307,1,[火焰雷兽]IIIIIIIIIIII,2394,124,4,4,8,50.0%,1h
17307,2,mrq,2394,150,4,5,9,44.4%,6m
17307,1,飞龙在天,2394,46,3,6,9,33.3%,1h
17307,1,猪猪兰,2394,142,3,6,9,33.3%,39m
17307,1,THEFOOL,2394,89,2,4,6,33.3%,1h
17321,3,娟娟,2393,923,35,36,71,49.3%,39m
17321,1,晓予,2393,561,17,16,33,51.5%,1h
17321,1,人畜无害的月奏弦,2393,270,8,16,24,33.3%,34m
17321,3,风愿影尘,2393,200,5,6,11,45.5%,5m
17321,1,AMD,2393,161,3,1,4,75.0%,13m
17321,1,SAI,2393,122,3,2,5,60.0%,3m
17321,1,简单电脑,2393,0,1,0,1,100.0%,1h
17321,1,Golden,2393,0,1,1,2,50.0%,20m
17321,1,饿的福瑞迪,2393,0,1,3,4,25.0%,29m
17321,3,EmperorTFR,2393,30,1,8,9,11.1%,1h
17321,1,失控的疯子祥子,2393,0,0,1,1,0.0%,1h
17321,1,墨匪,2393,0,0,6,6,0.0%,34m
17333,1,lIIIIl,2392,1067,37,31,68,54.4%,28m
17333,2,你是真的很让我烦,2392,471,24,31,55,43.6%,27m
17333,1,舜生,2392,362,10,14,24,41.7%,24m
17333,1,采臣,2392,298,9,10,19,47.4%,1h
17333,3,梧桐影,2392,138,5,10,15,33.3%,10m
17333,2,无敌铲子嘴,2392,0,3,9,12,25.0%,39m
17333,1,HEHE,2392,42,2,1,3,66.7%,1h
17333,1,[HSCG]Serral,2392,78,2,3,5,40.0%,1h
17333,1,菜鸟,2392,0,1,2,3,33.3%,1h
17342,2,serral,2391,1382,87,82,169,51.5%,39m
17342,1,白庚辰,2391,838,28,24,52,53.8%,1h
17342,3,NoProblem,2391,665,27,29,56,48.2%,1h
17342,1,[暴雪我是你爹]神龙大侠,2391,702,23,42,65,35.4%,1h
17342,1,gggd,2391,358,10,5,15,66.7%,45m
17342,2,[表哥]雷诺是我表哥,2391,120,3,2,5,60.0%,22m
17342,2,伊莉雅,2391,150,3,6,9,33.3%,1h
17342,1,流放的摩西,2391,0,2,4,6,33.3%,27m
17342,1,角落,2391,97,2,5,7,28.6%,10m
17342,1,Mikko,2391,86,2,6,8,25.0%,7m
17342,2,[XXHZ16]仇花徒花,2391,0,1,0,1,100.0%,17m
17342,1,打工戦士,2391,42,1,2,3,33.3%,1h
17342,1,卡尔萨斯,2391,40,1,5,6,16.7%,1h
17342,3,兜兜,2391,0,1,8,9,11.1%,1h
17342,1,訾璇,2391,0,0,1,1,0.0%,58m
17342,1,woshigaoshou,2391,0,0,1,1,0.0%,36m
17358,1,[鼻子好酸]户山香澄,2390,1521,256,264,520,49.2%,1h
17358,3,blue,2390,1482,124,124,248,50.0%,13m
17358,3,[黑暗]小孩丿有自尊,2390,282,11,18,29,37.9%,1h
17358,2,lost,2390,157,5,12,17,29.4%,7m
17358,1,Frank,2390,0,1,1,2,50.0%,1h
17358,1,一颗菠菜,2390,40,1,1,2,50.0%,1h
17364,3,净空,2389,1450,135,131,266,50.8%,17m
17364,3,扶我起来我还能送,2389,947,52,54,106,49.1%,1h
17364,1,[瞧本FANS]瞧治,2389,436,14,17,31,45.2%,1h
17364,3,鱼二子,2389,72,4,8,12,33.3%,59m
17364,3,whiteking,2389,121,3,0,3,100.0%,1h
17364,1,[中华兄弟会]李永浩,2389,90,3,1,4,75.0%,1h
17364,1,吃人中学,2389,0,3,4,7,42.9%,1h
17364,3,末白丶,2389,0,2,5,7,28.6%,34m
17364,2,开心,2389,0,1,4,5,20.0%,16m
17364,1,冉晓晓,2389,0,0,1,1,0.0%,50m
17364,3,ddddd,2389,0,0,3,3,0.0%,10m
17375,1,[星际丶老男孩]星际狂热,2388,935,38,42,80,47.5%,45m
17375,1,[ICHYI]风云崛起,2388,310,11,9,20,55.0%,1h
17375,1,木子曦,2388,298,8,6,14,57.1%,1h
17375,3,菌毯铺啊铺,2388,154,7,12,19,36.8%,45m
17375,1,[老年特战队]幸福中学狗批校长,2388,235,6,9,15,40.0%,1h
17375,1,曹流弊,2388,189,5,9,14,35.7%,24m
17375,1,只是神而已,2388,0,3,3,6,50.0%,31m
17375,3,西瓜,2388,0,2,5,7,28.6%,1h
17383,2,[慢手e族]我有点困了,2387,761,118,113,231,51.1%,27m
17383,2,不会玩,2387,1509,100,98,198,50.5%,9m
17383,1,WarriorZKB,2387,1078,48,59,107,44.9%,28m
17383,1,[嘤遍全球]大女乃,2387,953,27,33,60,45.0%,20m
17383,1,king,2387,482,14,15,29,48.3%,41m
17383,3,潮水,2387,243,11,13,24,45.8%,5m
17383,1,咖喱给给,2387,144,4,5,9,44.4%,1h
17383,3,宝贝可欣,2387,58,4,7,11,36.4%,1h
17383,1,咕噜咕噜鸡,2387,124,3,6,9,33.3%,10m
17383,3,[纸鸢i]猪儿虫,2387,0,2,6,8,25.0%,1h
17383,1,[暴打假萌新]lovef,2387,0,0,1,1,0.0%,3m
17394,2,冲锋的牛牛,2386,1392,54,56,110,49.1%,1h
17394,1,power,2386,400,13,7,20,65.0%,16m
17394,1,一生一式一起走,2386,154,6,2,8,75.0%,1h
17394,3,ZHOU,2386,189,5,2,7,71.4%,14m
17394,3,cuijc,2386,145,4,7,11,36.4%,1h
17394,1,这个名不简单,2386,0,2,2,4,50.0%,31m
17394,1,通天,2386,44,2,3,5,40.0%,1h
17394,1,Milkpudding,2386,0,1,0,1,100.0%,10m
17394,1,klero,2386,0,1,0,1,100.0%,24m
17394,1,CHANG,2386,0,1,1,2,50.0%,1h
17394,2,licc,2386,0,1,4,5,20.0%,5m
17394,1,艾斯奥特曼,2386,0,0,1,1,0.0%,1h
17394,1,小小沈,2386,0,0,1,1,0.0%,51m
17394,1,科技大师,2386,0,0,2,2,0.0%,1h
17408,3,安迪叶龙,2385,1288,155,153,308,50.3%,28m
17408,1,[腥基佬男骸]子午夜梦,2385,262,7,8,15,46.7%,1h
17408,1,[给力嗷]zydbb,2385,82,3,0,3,100.0%,42m
17408,1,只争朝夕,2385,59,3,1,4,75.0%,28m
17408,1,风之吟唱,2385,193,3,4,7,42.9%,12m
17408,2,欧阳信雪,2385,0,2,3,5,40.0%,53m
17408,2,美食家老八,2385,0,1,4,5,20.0%,5m
17415,3,星际特工,2384,932,36,40,76,47.4%,17m
17415,1,民众,2384,666,21,20,41,51.2%,1h
17415,3,嘟嘟嘟了,2384,282,11,9,20,55.0%,1h
17415,1,白上吹雪,2384,207,9,8,17,52.9%,57m
17415,2,追风少年,2384,202,8,13,21,38.1%,1h
17415,1,你于总啊,2384,196,5,8,13,38.5%,1h
17415,3,将粪坑进行到底,2384,136,5,12,17,29.4%,1h
17415,1,fdasfsf,2384,0,1,0,1,100.0%,30m
17415,1,我是琛琛,2384,0,1,1,2,50.0%,31m
17415,1,孤之逆天,2384,0,1,1,2,50.0%,5m
17415,1,[酒池肉林]zbcsb,2384,40,1,3,4,25.0%,1h
17415,2,[为了核平]巅峰时刻让啊,2384,0,1,3,4,25.0%,22m
17415,3,Zly,2384,36,1,4,5,20.0%,42m
17415,2,刻于新月之铭,2384,0,1,4,5,20.0%,53m
17415,1,凰帝,2384,0,0,1,1,0.0%,3m
17415,1,showserral,2384,0,0,1,1,0.0%,12m
17431,3,Mrgodlele,2383,514,20,24,44,45.5%,1h
17431,1,令狐巷雨,2383,266,11,7,18,61.1%,1h
17431,1,[极限菜鸟]dawn,2383,404,11,17,28,39.3%,1h
17431,1,不想取名,2383,48,4,4,8,50.0%,27m
17431,3,梦魇之都,2383,144,3,2,5,60.0%,1h
17431,3,[艾蒙是弟弟]冰封,2383,153,3,6,9,33.3%,1h
17431,2,LOO,2383,110,3,7,10,30.0%,2m
17431,1,[出兵大战T馆]卢本伟在此,2383,88,2,3,5,40.0%,42m
17431,1,Monk,2383,86,2,6,8,25.0%,31m
17431,2,EXprprpr,2383,0,1,4,5,20.0%,1h
17431,2,[BGD]残阳,2383,0,0,1,1,0.0%,20m
17431,1,GGMM,2383,0,0,1,1,0.0%,42m
17431,1,虫朱执信,2383,0,0,2,2,0.0%,28m
17444,2,唐古拉斯,2382,535,53,67,120,44.2%,39m
17444,3,[anbish]孤狼晓布,2382,1182,48,50,98,49.0%,1h
17444,3,手残还想玩虫族,2382,417,14,21,35,40.0%,53m
17444,1,麦兜响当当,2382,329,9,16,25,36.0%,1h
17444,3,萌新的二次元之旅,2382,169,5,1,6,83.3%,58m
17444,1,寂寞渣渣,2382,48,2,1,3,66.7%,15m
17444,1,liu,2382,0,1,1,2,50.0%,60m
17444,1,一枪难搞,2382,96,1,1,2,50.0%,56m
17444,2,木鸣,2382,0,1,4,5,20.0%,15m
17444,3,Smilence,2382,30,1,5,6,16.7%,1h
17444,3,[落魄山]落叶,2382,0,0,2,2,0.0%,1h
17455,1,[我怎么没兵了]死神爱吃苹果,2381,743,34,15,49,69.4%,42m
17455,1,issenven,2381,286,9,8,17,52.9%,1h
17455,2,[血的味道]伊莉雅,2381,178,6,10,16,37.5%,51m
17455,1,虎背熊腰萝莉心,2381,94,5,2,7,71.4%,5m
17455,1,战神依旧,2381,82,3,2,5,60.0%,42m
17455,3,叫我女本大人,2381,121,3,7,10,30.0%,1h
17455,1,[Deepdk]你说浚爷啊,2381,124,3,9,12,25.0%,60m
17455,1,我就是个菜鸡,2381,48,1,3,4,25.0%,2m
17455,2,JIKOFGJ,2381,0,1,4,5,20.0%,1h
17455,1,登峰造极,2381,0,0,6,6,0.0%,57m
17465,1,tank,2380,921,33,34,67,49.3%,1h
17465,1,哈哈没想到吧,2380,346,15,5,20,75.0%,43m
17465,1,TTTjd,2380,324,10,18,28,35.7%,1h
17465,1,lecxington,2380,86,5,5,10,50.0%,1h
17465,1,[阿米娅是驴]今日绫波明日香,2380,160,4,4,8,50.0%,1h
17465,1,绝杀迷人阵,2380,80,2,4,6,33.3%,1h
17465,3,阿鹤,2380,97,1,2,3,33.3%,10m
17472,3,ghhbh,2379,1166,48,51,99,48.5%,35m
17472,3,输了也爱,2379,972,35,36,71,49.3%,7m
17472,1,[违章建筑多多]燎原号,2379,212,7,4,11,63.6%,1h
17472,1,colowahaha,2379,184,6,6,12,50.0%,1h
17472,1,JJQQ,2379,206,5,9,14,35.7%,1h
17472,1,[快星际乐]Taburiss,2379,155,4,8,12,33.3%,1h
17472,1,菜鸟,2379,74,3,1,4,75.0%,31m
17472,1,[干就完啦]纵横,2379,96,2,5,7,28.6%,31m
17472,2,[红发海贼团]枪炮与玫瑰,2379,0,1,4,5,20.0%,54m
17472,2,[菜的没人带]四败女人孙一峰,2379,0,1,4,5,20.0%,1h
17472,1,[博学者]好名字都被狗取了,2379,0,0,1,1,0.0%,1h
17472,1,乔乔的奇妙战斗,2379,0,0,3,3,0.0%,25m
17484,3,YFfinger,2378,1012,54,58,112,48.2%,27m
17484,1,IIIIIIIII,2378,550,20,34,54,37.0%,8m
17484,1,[FKA]jkl,2378,560,16,17,33,48.5%,1h
17484,1,[A死你]小虾米,2378,540,15,19,34,44.1%,1h
17484,3,可哥可妻孙一峰,2378,366,14,0,14,100.0%,1h
17484,1,邻家的熊孩,2378,186,7,2,9,77.8%,1h
17484,1,扯脱裤儿,2378,147,4,5,9,44.4%,1h
17484,1,Layoomiety,2378,104,3,2,5,60.0%,1h
17484,1,吉迈器楽行,2378,72,2,2,4,50.0%,1h
17484,1,satellite,2378,40,2,3,5,40.0%,43m
17484,2,Kabuto,2378,0,1,2,3,33.3%,49m
17484,1,楴玹,2378,0,0,1,1,0.0%,14m
17484,1,[萌丶即是正义]简单的电脑,2378,0,0,1,1,0.0%,1h
17484,1,狂奔的跳虫,2378,0,0,2,2,0.0%,1h
17498,3,洪家铁线拳,2377,1576,112,102,214,52.3%,1h
17498,1,总有刁民放大招,2377,524,19,21,40,47.5%,1h
17498,1,[生吃个人]晚秋呀,2377,318,11,5,16,68.8%,1h
17498,3,iuhiuhuhuiih,2377,311,11,9,20,55.0%,19m
17498,3,[背刺中队]幼苗的幼苗,2377,226,11,12,23,47.8%,1h
17498,3,GIAO,2377,323,10,10,20,50.0%,19m
17498,2,sswwwssd,2377,124,7,11,18,38.9%,25m
17498,1,冲量羊,2377,199,5,2,7,71.4%,1h
17498,1,Sanas,2377,78,3,1,4,75.0%,1h
17498,1,倒下的白门楼,2377,124,3,4,7,42.9%,16m
17498,1,伞兵一号卢本伟,2377,38,1,3,4,25.0%,1h
17498,2,[Le拉克丝]XingHum,2377,0,1,4,5,20.0%,28m
17498,2,Radioactive,2377,0,1,5,6,16.7%,17m
17498,1,IIIIIIIIIII,2377,0,0,1,1,0.0%,28m
17498,3,IIIIIIIIIIII,2377,0,0,3,3,0.0%,55m
17513,2,小泥鳅硬邦邦,2376,1283,62,70,132,47.0%,1h
17513,2,leizhouxi,2376,863,33,38,71,46.5%,41m
17513,1,Taoist,2376,588,22,23,45,48.9%,1h
17513,2,风折残灵,2376,216,9,9,18,50.0%,53m
17513,2,我爱打狗,2376,0,4,1,5,80.0%,16m
17513,1,jysting,2376,196,4,3,7,57.1%,9m
17513,1,我系阿良,2376,0,1,3,4,25.0%,58m
17513,1,你大爷,2376,0,0,1,1,0.0%,1h
17513,1,[三大队三人行]黑暗顾问,2376,0,0,1,1,0.0%,1h
17513,1,YORk,2376,0,0,1,1,0.0%,1h
17523,1,雏菊,2375,903,41,25,66,62.1%,20m
17523,1,爱詩诗詩诗,2375,1024,35,29,64,54.7%,40m
17523,2,Qzone,2375,625,19,28,47,40.4%,30m
17523,1,[南林笑笑生]镰刀,2375,44,4,9,13,30.8%,52m
17523,2,风之幻想,2375,48,3,4,7,42.9%,1h
17523,1,金的虎,2375,0,0,1,1,0.0%,9m
17523,2,[仙女与猫]暗神与琮鸢酱,2375,0,0,2,2,0.0%,1h
17523,1,郭表哥,2375,0,0,2,2,0.0%,1h
17531,2,sssnnnn,2374,546,25,29,54,46.3%,2m
17531,3,[上官秋月]Kangvins,2374,689,24,27,51,47.1%,10m
17531,3,sonofykq,2374,308,10,13,23,43.5%,2m
17531,3,爱慕百特曼,2374,34,6,11,17,35.3%,42m
17531,1,快乐白给,2374,140,4,1,5,80.0%,27m
17531,1,渡影,2374,117,3,0,3,100.0%,1h
17531,1,星辰,2374,80,3,2,5,60.0%,52m
17531,2,礼品卡为阿见,2374,0,2,2,4,50.0%,56m
17531,1,henizaiyiqi,2374,0,2,4,6,33.3%,14m
17531,1,[地堡砸脸]Alexandra,2374,0,1,2,3,33.3%,7m
17531,2,[战场之舞]二四得八,2374,0,0,1,1,0.0%,28m
17542,3,[加州室内装修]才鸡,2373,520,56,58,114,49.1%,1h
17542,3,手残在线康复训练,2373,965,44,40,84,52.4%,1h
17542,1,UMR,2373,528,16,21,37,43.2%,52m
17542,1,主不在乎,2373,476,14,12,26,53.8%,1h
17542,1,Person,2373,274,10,20,30,33.3%,45m
17542,1,AIGAION,2373,278,7,9,16,43.8%,28m
17542,2,[LED]qwas,2373,0,5,1,6,83.3%,1h
17542,1,czg,2373,110,4,5,9,44.4%,1h
17542,1,刺客信条,2373,167,4,6,10,40.0%,1h
17542,2,年轻人不讲武德,2373,0,3,2,5,60.0%,1h
17542,1,WAH,2373,78,3,2,5,60.0%,36m
17542,2,[YINGJI]白泽,2373,0,3,2,5,60.0%,54m
17542,3,杨先生生生生,2373,118,3,6,9,33.3%,1h
17542,1,[TAK]疯子,2373,78,2,6,8,25.0%,51m
17542,3,冷月的八云深琴,2373,0,1,0,1,100.0%,1h
17542,1,[基金会]NegoreRouse,2373,73,1,1,2,50.0%,35m
17542,1,[沉沦]阿尔零,2373,0,1,2,3,33.3%,59m
17559,2,[LOHs]daniel,2372,819,110,102,212,51.9%,1h
17559,1,神明不诉疾苦,2372,229,10,8,18,55.6%,7m
17559,3,假装笨,2372,184,6,8,14,42.9%,28m
17559,1,芭比污,2372,140,4,0,4,100.0%,1h
17559,1,[C51026]麦田,2372,88,3,4,7,42.9%,13m
17559,1,[南开202]menshenkl,2372,140,3,6,9,33.3%,1h
17559,3,菜鸡,2372,66,3,9,12,25.0%,28m
17559,1,[荣耀指引我]萌王赛高,2372,96,2,1,3,66.7%,31m
17559,1,星灵陈主教,2372,0,2,5,7,28.6%,15m
17559,2,[TAPC]龙迪,2372,0,1,0,1,100.0%,2m
17559,1,我谁也打不过,2372,0,0,1,1,0.0%,1h
17559,1,汤家豪,2372,0,0,1,1,0.0%,31m
17571,1,您的电竞孙红雷,2371,442,14,15,29,48.3%,35m
17571,1,北冥有鱼其名为咸,2371,149,4,1,5,80.0%,1h
17571,1,Stibium,2371,145,2,5,7,28.6%,47m
17571,1,[谁能教我做人]洗心革面重新做人,2371,0,1,0,1,100.0%,1h
17571,1,行者,2371,0,0,1,1,0.0%,1h
17571,1,星辰代谢,2371,0,0,3,3,0.0%,10m
17571,1,killer,2371,0,0,4,4,0.0%,1h
17578,3,[银翼之光]好人难当,2370,799,121,129,250,48.4%,21m
17578,1,嘻嘻,2370,1007,35,39,74,47.3%,45m
17578,1,天空極緻,2370,664,23,19,42,54.8%,13m
17578,1,[TNH]chengqinxi,2370,268,12,1,13,92.3%,42m
17578,2,无人操控,2370,319,11,13,24,45.8%,6m
17578,1,晚安,2370,269,10,8,18,55.6%,36m
17578,1,狄拉克之海,2370,269,8,0,8,100.0%,4m
17578,2,花下斩雨,2370,235,8,14,22,36.4%,2m
17578,2,喜欢吃橘子的汤汤,2370,0,4,1,5,80.0%,1h
17578,1,[夕林]Darkcookue,2370,0,3,4,7,42.9%,34m
17578,1,擒只羊开飞机,2370,38,3,5,8,37.5%,51m
17578,1,[xjc吃屁]Dyensd,2370,38,2,0,2,100.0%,1h
17578,3,[战场之舞]MrAMC,2370,97,2,3,5,40.0%,1h
17578,1,[32CM]对着阿巴瑟冲一发,2370,0,2,5,7,28.6%,27m
17578,2,[RvA]Bigblack,2370,0,1,0,1,100.0%,1h
17578,1,云端,2370,0,1,1,2,50.0%,1h
17578,2,YANyous,2370,0,1,2,3,33.3%,53m
17578,2,这是中文,2370,0,1,4,5,20.0%,1h
17578,2,神之长子接班人,2370,0,1,4,5,20.0%,1h
17578,3,无情商的自恋狂,2370,0,1,5,6,16.7%,1h
17578,1,乱世小熊,2370,0,0,1,1,0.0%,1h
17599,2,神经不是病,2369,868,30,38,68,44.1%,1h
17599,1,[萌萌哒鸡]血骑,2369,698,24,26,50,48.0%,31m
17599,3,电脑玩家,2369,158,13,19,32,40.6%,12m
17599,3,[F2ANB]墨茗天悸,2369,290,13,21,34,38.2%,21m
17599,1,XieRongHua,2369,160,5,7,12,41.7%,1h
17599,1,半夏,2369,126,4,2,6,66.7%,1h
17599,1,春天花花赵铁锤,2369,72,3,3,6,50.0%,1h
17599,1,[呦反手掏]萨克友,2369,0,3,3,6,50.0%,1h
17599,3,答禄所罗,2369,30,3,7,10,30.0%,31m
17599,1,灭团之星火车王,2369,120,2,2,4,50.0%,1h
17599,1,aaa,2369,78,2,4,6,33.3%,35m
17599,1,青丝绕手,2369,0,0,1,1,0.0%,49m
17599,1,皓阳,2369,0,0,1,1,0.0%,1h
17612,3,良先生,2368,833,47,52,99,47.5%,35m
17612,1,[KNAT]zhegufly,2368,424,12,15,27,44.4%,10m
17612,2,[贼tm硬]Hualan,2368,218,10,12,22,45.5%,1h
17612,3,[入手萌新]下手轻点我很菜,2368,269,10,12,22,45.5%,21m
17612,3,邹琛,2368,0,4,3,7,57.1%,42m
17612,3,Romantic,2368,64,2,9,11,18.2%,1h
17612,1,鸡扒一甩名扬四海,2368,40,1,1,2,50.0%,1h
17612,3,独饮半生,2368,30,1,1,2,50.0%,1h
17612,2,菲利波夫,2368,0,1,4,5,20.0%,44m
17612,1,赫赫战神,2368,0,0,1,1,0.0%,1h
17622,3,TIAL,2367,622,51,45,96,53.1%,2m
17622,3,Sumail,2367,1091,44,48,92,47.8%,51m
17622,3,[破落的灵魂]画中梦生花,2367,942,39,35,74,52.7%,53m
17622,1,[快乐就完事儿]阿克图洛斯蒙斯克,2367,907,32,26,58,55.2%,58m
17622,3,哦啊拉拉,2367,793,30,34,64,46.9%,1h
17622,1,[马家沟白给王]枪兵滚毒爆大师,2367,610,22,22,44,50.0%,1h
17622,1,允许计划,2367,398,13,10,23,56.5%,13m
17622,3,瞙駺,2367,322,12,9,21,57.1%,1h
17622,1,[XXHZ1]留下遗产,2367,331,10,8,18,55.6%,7m
17622,2,[dgxfd]赵中义,2367,312,10,14,24,41.7%,6m
17622,3,萌新乀,2367,218,7,9,16,43.8%,1h
17622,1,小屁屁虫,2367,217,5,9,14,35.7%,1h
17622,1,zzhhht,2367,186,5,10,15,33.3%,13m
17622,2,莣煜,2367,0,2,3,5,40.0%,22m
17622,1,清酒余欢,2367,0,0,1,1,0.0%,31m
17622,1,九槑,2367,0,0,2,2,0.0%,1h
17622,1,任飞,2367,0,0,2,2,0.0%,50m
17639,1,悠悠水冷,2366,190,7,5,12,58.3%,47m
17639,3,飞狐大神,2366,226,7,12,19,36.8%,53m
17639,1,qqgeshiwo,2366,162,5,3,8,62.5%,1h
17639,1,[萌大喵的日常]笑丿神箜,2366,146,4,6,10,40.0%,1h
17639,1,新手刚玩,2366,145,3,6,9,33.3%,5m
17639,3,DarLing,2366,121,3,6,9,33.3%,1h
17639,1,[大宇恩]Eucliwood,2366,42,2,0,2,100.0%,1h
17639,3,逍遥小孙,2366,121,2,3,5,40.0%,1h
17639,1,天青,2366,0,1,0,1,100.0%,4m
17639,1,[第三脑壳医院]超重装中二病,2366,0,1,0,1,100.0%,24m
17639,1,[风雪]日夕,2366,0,1,1,2,50.0%,1h
17639,2,mfq,2366,0,1,4,5,20.0%,56m
17639,1,龙虾,2366,0,1,5,6,16.7%,1h
17639,3,飞翔的柯基汪号,2366,0,1,6,7,14.3%,1h
17653,2,有梦无剑,2365,285,15,8,23,65.2%,19m
17653,1,dark,2365,219,9,10,19,47.4%,1h
17653,3,[花田纵火犯]hxd,2365,145,3,4,7,42.9%,11m
17653,1,红莲,2365,0,3,4,7,42.9%,6m
17653,3,[我们是瞎子]Conner,2365,97,2,1,3,66.7%,3m
17653,3,[时光与酒oc]被太子虐的人机,2365,30,1,2,3,33.3%,20m
17653,1,[南京何平]Rainnie,2365,0,0,1,1,0.0%,55m
17653,1,shower,2365,0,0,1,1,0.0%,28m
17661,1,吃橙子,2364,592,22,25,47,46.8%,1h
17661,3,阿拉刚,2364,534,21,26,47,44.7%,46m
17661,1,无聊与无言,2364,248,11,8,19,57.9%,1h
17661,1,新手放过我,2364,76,3,2,5,60.0%,42m
17661,3,我不是云玩家,2364,0,2,6,8,25.0%,59m
17661,3,我的,2364,0,0,1,1,0.0%,1h
17661,1,yuanban,2364,0,0,1,1,0.0%,14m
17661,1,[gost]celestial,2364,0,0,2,2,0.0%,1h
17669,1,[VLK]怡乐汽水,2363,1166,49,44,93,52.7%,1h
17669,3,愤怒者,2363,827,35,34,69,50.7%,19m
17669,1,我大哥就爱喵喵喵,2363,276,8,6,14,57.1%,1h
17669,1,我今天三岁了,2363,205,5,9,14,35.7%,1h
17669,1,灰暗童话,2363,0,1,1,2,50.0%,1h
17669,1,OneKey,2363,0,0,1,1,0.0%,1h
17669,1,[萝莉之芯]雨燕,2363,0,0,4,4,0.0%,1h
17676,2,JOJOFANSEN,2362,1506,71,85,156,45.5%,24m
17676,1,[青龙帮]晨晨啊啊啊,2362,768,31,24,55,56.4%,13m
17676,1,[青龙帮]小贱,2362,854,30,33,63,47.6%,16m
17676,1,[KPG2]半糖彡冰茶,2362,500,21,18,39,53.8%,1h
17676,1,没名,2362,152,4,4,8,50.0%,34m
17676,2,FAFAFA,2362,46,3,4,7,42.9%,56m
17676,3,瞎子不配打星际,2362,97,1,2,3,33.3%,1h
17676,2,回荡山谷,2362,0,1,4,5,20.0%,20m
17676,2,菲尼克斯,2362,0,1,4,5,20.0%,1h
17685,3,[传说萌娘团]小姚抱炸酥肉,2361,1460,61,81,142,43.0%,22m
17685,3,扑街,2361,338,18,24,42,42.9%,51m
17685,1,意义不明的沙雕,2361,365,16,8,24,66.7%,1h
17685,1,龙狗,2361,359,14,18,32,43.8%,31m
17685,3,[社交学超可爱]星际最亮的仔,2361,352,12,18,30,40.0%,1h
17685,1,Marine,2361,142,6,4,10,60.0%,1h
17685,1,sugarhe,2361,208,5,8,13,38.5%,1h
17685,1,巧克力灭世者同盟,2361,116,3,4,7,42.9%,1h
17685,3,不如归,2361,30,3,7,10,30.0%,5m
17685,2,stay,2361,0,1,4,5,20.0%,45m
17685,2,千羽,2361,0,1,5,6,16.7%,1h
17685,1,Doppo,2361,0,0,1,1,0.0%,1h
17685,1,莎拉雷诺,2361,0,0,2,2,0.0%,1h
17698,3,IIIIIIIIIIII,2360,952,33,39,72,45.8%,1h
17698,1,你杨嗲嗲,2360,876,27,25,52,51.9%,52m
17698,1,月落风华引,2360,257,8,8,16,50.0%,1h
17698,3,nick,2360,240,8,15,23,34.8%,1h
17698,1,Number,2360,110,4,2,6,66.7%,1h
17698,1,BackPacker,2360,102,3,4,7,42.9%,35m
17698,1,天梦,2360,40,2,1,3,66.7%,1h
17698,2,[蓝鲸何平]buai,2360,0,1,0,1,100.0%,6m
17698,1,斗鱼丶痴情而落花,2360,0,1,5,6,16.7%,39m
17698,1,喧哗上等,2360,0,0,1,1,0.0%,52m
17698,1,丿殇灬魅影,2360,0,0,2,2,0.0%,1h
17698,1,云太白,2360,0,0,4,4,0.0%,52m
17710,3,天晓,2359,821,35,38,73,47.9%,53m
17710,1,[江南虫王]咸鱼,2359,990,31,33,64,48.4%,34m
17710,1,魏光,2359,668,24,24,48,50.0%,14m
17710,1,HeIsHero,2359,418,19,11,30,63.3%,1h
17710,1,[暴雪五队]Dawn,2359,325,11,11,22,50.0%,52m
17710,2,万古霉素,2359,291,11,12,23,47.8%,56m
17710,3,whosyourdad,2359,245,8,11,19,42.1%,1h
17710,3,[专打嘤嘤怪]南云,2359,142,5,2,7,71.4%,45m
17710,3,跳虫速攻,2359,168,5,4,9,55.6%,1h
17710,1,AllenLi,2359,240,5,9,14,35.7%,49m
17710,1,Kblink,2359,139,3,1,4,75.0%,1h
17710,1,铁豆腐,2359,0,2,4,6,33.3%,31m
17710,2,[黑暗幻想]NERO,2359,139,2,5,7,28.6%,1h
17710,1,joke,2359,0,1,0,1,100.0%,1h
17710,1,[社交学教授]wdnmd,2359,0,1,0,1,100.0%,28m
17710,1,諸位的萌王,2359,0,1,0,1,100.0%,1h
17726,1,RockZombie,2358,944,37,37,74,50.0%,1h
17726,2,竖锯,2358,858,32,38,70,45.7%,14m
17726,2,Vivavivo,2358,486,18,26,44,40.9%,2m
17726,1,Ash,2358,224,7,6,13,53.8%,1h
17726,3,alwaysfully,2358,185,6,11,17,35.3%,3m
17726,1,幻梦,2358,202,5,7,12,41.7%,42m
17726,1,bbc,2358,0,4,5,9,44.4%,1h
17726,1,[卡尔达利斯]诫躤,2358,0,1,0,1,100.0%,28m
17726,1,Sapporo,2358,40,1,4,5,20.0%,7m
17726,1,stc,2358,38,1,6,7,14.3%,59m
17726,1,丨大包乾丨,2358,46,1,6,7,14.3%,1h
17726,1,Almee,2358,0,0,1,1,0.0%,2m
17738,1,月明暗鸦,2357,1122,102,99,201,50.7%,52m
17738,3,kiser,2357,569,23,26,49,46.9%,18m
17738,1,跃进,2357,617,21,21,42,50.0%,1h
17738,2,史迪威万岁圣诞袜,2357,269,9,15,24,37.5%,55m
17738,3,[GGWW]破灭的希望,2357,216,8,13,21,38.1%,12m
17738,1,衔尾蛇,2357,230,7,7,14,50.0%,35m
17738,3,[RPD神教]leo,2357,202,7,12,19,36.8%,21m
17738,2,Asuka,2357,126,3,6,9,33.3%,5m
17738,1,[芭芭拉冲压]苍山雪,2357,148,3,7,10,30.0%,20m
17738,2,西洒街吴彦祖,2357,0,1,4,5,20.0%,53m
17738,2,Thooo,2357,0,1,4,5,20.0%,1h
17738,1,[旋风游骑兵]桃华月惮,2357,0,1,5,6,16.7%,31m
17750,3,[世风第三帝国]风剑雪,2356,988,43,34,77,55.8%,19m
17750,1,最冷的昨天,2356,287,28,24,52,53.8%,28m
17750,1,Mayflower,2356,224,9,5,14,64.3%,42m
17750,1,[Kiloli]鸽屿,2356,207,8,1,9,88.9%,28m
17750,3,银镞,2356,218,8,9,17,47.1%,1h
17750,1,jerry,2356,178,7,4,11,63.6%,1h
17750,2,超神康,2356,210,5,8,13,38.5%,7m
17750,3,XKQBT,2356,184,5,9,14,35.7%,1h
17750,2,[ZFGMQ]熙饭鱼子酱,2356,136,3,0,3,100.0%,1h
17750,2,蓝蓝路,2356,0,3,2,5,60.0%,54m
17750,1,舒小魅,2356,74,3,3,6,50.0%,1h
17750,1,一个传说中的帅哥,2356,97,2,1,3,66.7%,46m
17750,1,[秋毫七队]抹茶雪域,2356,36,2,2,4,50.0%,1h
17750,1,繁夜丶星语,2356,96,2,2,4,50.0%,46m
17750,3,醉鬼炎,2356,0,2,7,9,22.2%,36m
17750,2,[老吴天下第一]波多野结衣,2356,0,1,0,1,100.0%,44m
17750,2,[地图大咖]蓝天白云,2356,0,1,5,6,16.7%,42m
17750,1,[hed]下一格,2356,0,0,1,1,0.0%,60m
17768,1,cloudddds,2355,935,33,31,64,51.6%,20m
17768,1,FABchen,2355,906,30,30,60,50.0%,1h
17768,1,fanys,2355,264,10,6,16,62.5%,1h
17768,1,yws,2355,326,10,8,18,55.6%,59m
17768,3,[北有吾王]jessie,2355,244,9,17,26,34.6%,21m
17768,1,[秋毫第五分队]虐暴傻必狗队友,2355,121,3,0,3,100.0%,4m
17768,2,wolf,2355,0,3,2,5,60.0%,6m
17768,1,[EDR]佳果果,2355,42,2,3,5,40.0%,1h
17768,1,战个痛快,2355,0,1,1,2,50.0%,1h
17768,1,risingup,2355,0,1,1,2,50.0%,30m
17768,3,Horizon,2355,97,1,4,5,20.0%,1h
17768,1,[混吃混喝]BOSS,2355,0,0,2,2,0.0%,1h
17780,3,你是不是傻,2354,331,19,25,44,43.2%,12m
17780,3,YUE,2354,428,15,19,34,44.1%,1h
17780,3,星界游神,2354,337,12,8,20,60.0%,1h
17780,1,流云辰,2354,132,6,7,13,46.2%,42m
17780,1,FINAL,2354,142,5,12,17,29.4%,14m
17780,3,[0D]bestfvcker,2354,96,3,2,5,60.0%,41m
17780,1,北冥有鱼,2354,0,2,4,6,33.3%,4m
17780,3,[吃饭不吃菜]KotchiaSanae,2354,0,0,1,1,0.0%,11m
17788,1,[潸然丶那些年]Pimba,2353,775,439,473,912,48.1%,9m
17788,1,天然卷,2353,253,8,4,12,66.7%,1h
17788,1,Robin,2353,249,8,6,14,57.1%,1h
17788,1,[达拉姆内务部]hanyu,2353,249,7,4,11,63.6%,1h
17788,1,周博森,2353,222,6,4,10,60.0%,1h
17788,2,sekai,2353,0,2,4,6,33.3%,1h
17788,1,flash,2353,42,1,7,8,12.5%,1h
17788,1,前期,2353,0,0,1,1,0.0%,50m
17796,1,Aolos,2352,1558,62,52,114,54.4%,36m
17796,1,上帝之鞭,2352,347,19,12,31,61.3%,1h
17796,1,鲸琼,2352,398,13,9,22,59.1%,36m
17796,1,苏九,2352,235,12,1,13,92.3%,1h
17796,1,工蜂会飞,2352,162,5,8,13,38.5%,43m
17796,1,豺狼,2352,168,3,8,11,27.3%,5m
17796,2,Aierbotuo,2352,96,3,8,11,27.3%,56m
17796,1,恨繁霜鬓,2352,42,2,1,3,66.7%,34m
17796,1,qqq,2352,106,2,7,9,22.2%,20m
17796,2,[Sterk]ChuanJay,2352,0,1,4,5,20.0%,45m
17796,1,紫色黎明,2352,0,0,1,1,0.0%,36m
17796,1,Balbngcer,2352,0,0,1,1,0.0%,13m
17808,1,屡败屡战,2351,706,36,28,64,56.2%,45m
17808,3,薄荷,2351,286,11,12,23,47.8%,1h
17808,3,心不血刃,2351,287,10,10,20,50.0%,1h
17808,1,专踹大贱那条好腿,2351,300,8,12,20,40.0%,42m
17808,1,[TOD死神]贪狼星君,2351,97,4,3,7,57.1%,1h
17808,2,Eternal,2351,44,3,3,6,50.0%,1h
17808,3,ElecTricKiss,2351,145,3,3,6,50.0%,1h
17808,1,Mmmilor,2351,96,2,0,2,100.0%,1h
17808,1,[让让孩子吧]莱德林,2351,0,1,0,1,100.0%,24m
17808,2,天涯,2351,0,1,2,3,33.3%,1h
17808,1,战恶灬善,2351,48,1,5,6,16.7%,31m
17808,1,风殇,2351,0,0,1,1,0.0%,46m
17820,3,草原最美的狒,2350,1497,185,180,365,50.7%,40m
17820,1,星灵之遗,2350,1287,107,100,207,51.7%,1h
17820,1,酷毙了我的俊丿,2350,302,8,16,24,33.3%,1h
17820,3,[西湖底安保队]雷电法王,2350,97,2,0,2,100.0%,1h
17820,2,别打人坐下谈,2350,0,1,0,1,100.0%,1h
17820,1,风过叶落,2350,97,1,2,3,33.3%,5m
17820,2,探女骑脸怎么输,2350,0,1,4,5,20.0%,1h
17820,1,[暴雪二十二队]缥缈丶神迹,2350,0,0,1,1,0.0%,58m
17828,1,花开如梦,2349,1650,68,70,138,49.3%,14m
17828,1,awei,2349,834,32,21,53,60.4%,3m
17828,1,WEYSAD,2349,890,31,31,62,50.0%,1h
17828,2,[群英]套利达人,2349,115,16,25,41,39.0%,7m
17828,1,[月之所在RI]AWM,2349,274,6,13,19,31.6%,1h
17828,1,[宀窝斗宀]马浩僮,2349,170,5,3,8,62.5%,52m
17828,3,CWY,2349,97,2,3,5,40.0%,1h
17828,2,JUEhe,2349,136,2,3,5,40.0%,6m
17828,1,阿阿阿阿澈,2349,0,0,1,1,0.0%,27m
17828,1,吕玲琦,2349,0,0,1,1,0.0%,2m
17838,1,[闷声发大财]打完去睡觉,2348,548,33,18,51,64.7%,1h
17838,1,[DMR]亚里士没有德,2348,407,21,8,29,72.4%,3m
17838,1,[雪碧]鬼火,2348,104,3,0,3,100.0%,1h
17838,2,石硕,2348,107,3,3,6,50.0%,7m
17838,2,[TDF]Phoenix,2348,46,3,4,7,42.9%,1h
17838,1,killerQueen,2348,36,2,1,3,66.7%,1h
17838,2,JOJO,2348,0,2,1,3,66.7%,49m
17845,2,lilllil,2347,598,50,45,95,52.6%,1h
17845,3,月行,2347,558,34,23,57,59.6%,19m
17845,1,黑剑三,2347,627,19,18,37,51.4%,1h
17845,1,[暴雪二十二队]小佳哥们,2347,437,14,23,37,37.8%,34m
17845,1,zergling,2347,187,6,3,9,66.7%,1h
17845,1,Lucifer,2347,0,4,3,7,57.1%,27m
17845,1,别射嘴里面,2347,120,4,4,8,50.0%,6m
17845,1,bcjzssz,2347,40,2,3,5,40.0%,13m
17845,2,whishaw,2347,0,2,4,6,33.3%,45m
17845,1,带我我贼菜丷,2347,0,0,1,1,0.0%,27m
17855,1,月玄,2346,855,34,28,62,54.8%,55m
17855,3,龙心,2346,617,20,27,47,42.6%,1h
17855,1,ShowTime,2346,580,18,14,32,56.2%,1h
17855,3,[一刀屠天下]一只菜狗,2346,450,15,27,42,35.7%,11m
17855,1,理想国,2346,304,11,8,19,57.9%,1h
17855,3,绝园的暴风雨,2346,224,8,8,16,50.0%,1h
17855,1,[天雪]血蛰,2346,290,8,9,17,47.1%,1h
17855,1,[萝莉球]一看就是萌新,2346,212,7,6,13,53.8%,27m
17855,1,Pisces,2346,104,4,2,6,66.7%,13m
17855,1,LizhengyUu,2346,0,4,4,8,50.0%,1h
17855,1,TYOYT,2346,118,3,0,3,100.0%,34m
17855,1,吉川春代,2346,80,3,4,7,42.9%,1h
17855,1,[菜有菜的道理]幻虚无,2346,97,1,3,4,25.0%,46m
17855,1,[鱼人永不败]AIZDV,2346,0,0,1,1,0.0%,41m
17869,3,HHHHHHHHHHHH,2345,1369,60,67,127,47.2%,17m
17869,1,踏马玩就玩别笑我,2345,570,23,16,39,59.0%,13m
17869,1,叛逆者,2345,167,6,2,8,75.0%,20m
17869,1,水飒举,2345,97,4,3,7,57.1%,1h
17869,3,[高维使徒]坑坑有我的,2345,30,2,0,2,100.0%,1h
17869,3,施暴者,2345,0,1,0,1,100.0%,15m
17869,1,胭脂似水,2345,48,1,3,4,25.0%,1h
17869,1,雨孤影,2345,0,1,5,6,16.7%,1h
17869,1,[彼方剑语]llllllllllll,2345,0,0,2,2,0.0%,34m
17878,1,哒哒哒哒哒哒哒,2344,342,31,27,58,53.4%,59m
17878,2,未闻狐,2344,484,19,23,42,45.2%,38m
17878,2,三只眼,2344,246,8,13,21,38.1%,1h
17878,3,fseklojusreo,2344,168,7,13,20,35.0%,10m
17878,1,茨木华扇,2344,143,3,6,9,33.3%,6m
17878,3,[脉脉不得语]呆呆,2344,97,3,7,10,30.0%,1h
17878,1,[艾尔必将停电]炖鱼,2344,0,1,0,1,100.0%,1h
17878,2,昊穹,2344,0,1,0,1,100.0%,44m
17878,1,xiao,2344,0,1,0,1,100.0%,52m
17878,2,[Sc老年组]苏念儿,2344,93,1,1,2,50.0%,1h
17888,2,无倌,2343,1314,69,71,140,49.3%,39m
17888,1,风一般的熊孩子,2343,1046,62,65,127,48.8%,11m
17888,1,Gangster,2343,236,7,10,17,41.2%,60m
17888,1,苏联政委,2343,177,6,4,10,60.0%,31m
17888,3,[HsSo0]呆呆神了,2343,182,6,15,21,28.6%,21m
17888,3,难堪,2343,147,5,8,13,38.5%,1h
17888,1,Destroy,2343,48,2,3,5,40.0%,54m
17888,2,[Herald]塞尔瓦托丶小晓,2343,0,1,4,5,20.0%,1h
17888,1,随风如雨,2343,0,0,1,1,0.0%,36m
17888,1,收到,2343,0,0,1,1,0.0%,1h
17888,1,SOLO,2343,0,0,1,1,0.0%,4m
17888,1,布尔什维克,2343,0,0,2,2,0.0%,13m
17900,1,xiaoz,2342,312,24,23,47,51.1%,30m
17900,1,srfes,2342,467,24,25,49,49.0%,1h
17900,3,[堂口好兄弟]wjzzb,2342,638,22,28,50,44.0%,1h
17900,1,意大利炮,2342,114,4,6,10,40.0%,1h
17900,1,亦似花洛亦似霞,2342,120,3,1,4,75.0%,46m
17900,2,abc,2342,0,3,2,5,60.0%,5m
17900,3,Kig,2342,46,3,8,11,27.3%,36m
17900,1,[Rhusky]刻晴,2342,97,2,3,5,40.0%,34m
17900,1,凯瑞甘,2342,105,2,4,6,33.3%,1h
17900,2,[飞云之上]ilovefrozen,2342,0,1,0,1,100.0%,1h
17900,1,[欣宝大家庭]夜影,2342,0,1,1,2,50.0%,31m
17911,2,[XXHZN2]斯巴达奎爷,2341,1546,169,167,336,50.3%,48m
17911,1,无双天道,2341,863,54,65,119,45.4%,59m
17911,2,我爱玛琪玛,2341,530,38,43,81,46.9%,37m
17911,1,网老腻,2341,984,32,32,64,50.0%,1h
17911,1,Corby,2341,723,28,29,57,49.1%,28m
17911,1,骑士魔王,2341,809,26,24,50,52.0%,1h
17911,1,TOTATM,2341,705,26,24,50,52.0%,24m
17911,1,[铃兰男子高校]StarMalison,2341,623,20,20,40,50.0%,60m
17911,1,[F2ANB]上杉绘梨衣,2341,291,15,15,30,50.0%,1h
17911,3,邪神蚩尤,2341,60,4,8,12,33.3%,1h
17911,1,王者小爱,2341,48,2,2,4,50.0%,1h
17911,2,Bryuner,2341,0,2,3,5,40.0%,16m
17911,2,TiMe,2341,0,1,0,1,100.0%,1h
17911,3,我说了我是瑪维,2341,0,0,1,1,0.0%,34m
17911,2,机械化就输不了,2341,0,0,1,1,0.0%,1h
17926,1,[极寒之冰]菜鸡神教代理教主,2340,539,19,15,34,55.9%,1h
17926,1,Puma,2340,297,12,7,19,63.2%,11m
17926,1,种树人,2340,224,7,6,13,53.8%,24m
17926,1,zha,2340,184,6,6,12,50.0%,1h
17926,1,Herotkw,2340,143,3,7,10,30.0%,6m
17926,1,小玥的妹控哥哥,2340,38,2,5,7,28.6%,1h
17926,2,[爱国]反馈图,2340,0,1,0,1,100.0%,1h
17926,1,xxyxxyxxy,2340,0,1,1,2,50.0%,12m
17926,2,oLOVEo,2340,0,1,4,5,20.0%,1h
17926,1,Jormungandr,2340,0,0,1,1,0.0%,25m
17926,2,[哏谐星]Youah,2340,0,0,1,1,0.0%,1h
17926,2,妹纸是什么纸,2340,0,0,5,5,0.0%,49m
17938,3,血战,2339,817,35,38,73,47.9%,6m
17938,1,宣凰,2339,940,33,31,64,51.6%,58m
17938,1,[SLZ]死侍,2339,541,20,17,37,54.1%,1h
17938,1,sdsd,2339,264,7,8,15,46.7%,56m
17938,1,[艾尔之主]IIIIIIII,2339,242,6,7,13,46.2%,1h
17938,1,stanan,2339,189,4,2,6,66.7%,1h
17938,1,[对面太强了]达纳苏斯的月光,2339,193,4,8,12,33.3%,1h
17938,3,阿尔萨斯,2339,0,3,10,13,23.1%,1h
17938,1,CJZX,2339,78,2,5,7,28.6%,13m
17938,1,梅天王,2339,0,2,5,7,28.6%,27m
17938,1,STARXF,2339,0,1,0,1,100.0%,1h
17938,2,[鹌鹑带星]喔系小百兔,2339,0,1,0,1,100.0%,15m
17938,1,yEliNGdao,2339,97,1,2,3,33.3%,1h
17938,1,[萝莉航线]exhh,2339,42,1,2,3,33.3%,30m
17938,2,[小花]桑墨丶柳月,2339,46,1,4,5,20.0%,1h
17938,3,wjc,2339,0,0,1,1,0.0%,1h
17938,3,沧笙遗梦,2339,0,0,1,1,0.0%,1h
17938,1,Nameless,2339,0,0,3,3,0.0%,1h
17956,3,win,2338,1039,78,91,169,46.2%,11m
17956,1,Yehutan,2338,1556,54,52,106,50.9%,24m
17956,1,爆三样,2338,655,39,24,63,61.9%,1h
17956,1,love,2338,400,24,19,43,55.8%,1h
17956,3,牵着蜗牛去旅行,2338,471,16,21,37,43.2%,1h
17956,1,云云落,2338,353,11,12,23,47.8%,1h
17956,3,起点,2338,279,9,10,19,47.4%,17m
17956,3,[萌的一笔]憨憨,2338,212,7,2,9,77.8%,59m
17956,2,[DMR]expelliomos,2338,138,4,6,10,40.0%,55m
17956,1,再见小强,2338,103,3,0,3,100.0%,1h
17956,1,STRAWARLORD,2338,88,3,4,7,42.9%,1h
17956,1,[温柔兔公主]闲云野鹤,2338,116,2,3,5,40.0%,1h
17956,1,白白白白银,2338,0,2,5,7,28.6%,1h
17956,1,liumo,2338,0,1,1,2,50.0%,13m
17956,2,rainsalt,2338,0,1,2,3,33.3%,45m
17956,2,石孟江,2338,0,1,4,5,20.0%,56m
17956,1,玛丽亚,2338,0,0,1,1,0.0%,1h
17956,1,QBZ,2338,0,0,2,2,0.0%,28m
17974,3,黑客,2337,1439,88,91,179,49.2%,1h
17974,1,爱吃七岁的三岁,2337,1012,37,34,71,52.1%,1h
17974,3,[暗黑破坏神3]冷枫花,2337,681,36,33,69,52.2%,1h
17974,1,yczmax,2337,224,7,6,13,53.8%,42m
17974,2,犹如一扶风,2337,48,2,5,7,28.6%,1h
17979,2,奈落之花,2336,1305,211,214,425,49.6%,30m
17979,1,我要吃兔兔,2336,750,52,52,104,50.0%,24m
17979,1,周周不是周周,2336,1188,49,39,88,55.7%,1h
17979,1,鱼玄机,2336,365,15,8,23,65.2%,1h
17979,1,igtheshy,2336,247,8,8,16,50.0%,1h
17979,2,pimaxvr,2336,94,3,5,8,37.5%,16m
17979,1,[你失马]塞翁你马死了,2336,88,2,0,2,100.0%,1h
17979,2,为我尊前笑不成,2336,46,2,0,2,100.0%,45m
17979,1,HSSSS,2336,48,2,6,8,25.0%,1h
17979,1,LRJYYR,2336,0,1,1,2,50.0%,6m
17979,2,环球黑米,2336,0,1,4,5,20.0%,1h
17979,2,[游戏风云OL]sdfasda,2336,0,0,1,1,0.0%,42m
17991,3,饕餮,2335,1394,155,163,318,48.7%,6m
17991,1,short,2335,584,17,20,37,45.9%,34m
17991,1,[大佬请把鞋给]小骷髅,2335,348,9,15,24,37.5%,31m
17991,2,NihaihuiLaiM,2335,248,8,13,21,38.1%,1h
17991,1,行星,2335,0,1,1,2,50.0%,14m
17991,1,[奔驰何平]战无不胜,2335,76,1,2,3,33.3%,45m
17991,1,gjst,2335,0,1,5,6,16.7%,1h
17991,1,战火纷飞,2335,0,0,1,1,0.0%,27m
17991,2,[XXHZ20]逍遥快枪手,2335,0,0,1,1,0.0%,56m
17991,1,阿修,2335,0,0,3,3,0.0%,1h
18001,1,万里云,2334,548,27,17,44,61.4%,52m
18001,1,Arthur,2334,487,17,19,36,47.2%,52m
18001,1,不羡仙,2334,234,7,7,14,50.0%,1h
18001,3,冰河世界,2334,124,6,11,17,35.3%,57m
18001,1,煞煞煞,2334,146,4,5,9,44.4%,1h
18001,2,[ssaw12]wdasd,2334,0,1,1,2,50.0%,1h
18001,2,糖醋排骨,2334,0,1,5,6,16.7%,1h
18008,1,[老as联盟]Matrix,2333,861,29,28,57,50.9%,1h
18008,2,Gaizi,2333,458,17,11,28,60.7%,1h
18008,1,[CPT]泰晤斯古梅特,2333,262,13,18,31,41.9%,28m
18008,1,Milky,2333,308,8,10,18,44.4%,34m
18008,1,[在下菜鸡一只]DSADSADA,2333,178,6,6,12,50.0%,43m
18008,2,阿银灬,2333,0,1,4,5,20.0%,49m
18008,1,瓦杜海阁,2333,0,1,5,6,16.7%,1h
18008,2,soy,2333,0,0,3,3,0.0%,28m
18008,3,开始进行折磨,2333,0,0,10,10,0.0%,1h
18017,1,烈焰,2332,278,11,7,18,61.1%,60m
18017,3,Mrsluo,2332,217,7,6,13,53.8%,5m
18017,1,打一下算三下,2332,193,6,8,14,42.9%,51m
18017,3,ghost,2332,68,5,8,13,38.5%,1h
18017,1,nexus,2332,120,2,1,3,66.7%,1h
18017,2,茫然,2332,0,1,1,2,50.0%,1h
18017,1,[菜有菜的道理]与正,2332,0,0,2,2,0.0%,1h
18024,1,作曲家,2331,401,13,21,34,38.2%,58m
18024,1,[夕日坂]艾莉希尔,2331,188,6,5,11,54.5%,43m
18024,1,小志,2331,88,2,1,3,66.7%,14m
18024,2,逸方,2331,116,2,1,3,66.7%,30m
18024,1,[乌拉拉啦啦啦]Gayfish,2331,36,1,3,4,25.0%,57m
18029,3,天空中的彩虹,2330,517,22,26,48,45.8%,8m
18029,1,镜花缘,2330,321,11,17,28,39.3%,24m
18029,1,云天之翼,2330,116,3,6,9,33.3%,9m
18029,2,niuluoguo,2330,32,2,1,3,66.7%,55m
18029,1,枫歪歪,2330,0,2,4,6,33.3%,1h
18029,2,zbw,2330,0,0,1,1,0.0%,58m
18029,2,雷弱,2330,0,0,1,1,0.0%,1h
18036,2,sellfood,2329,755,172,187,359,47.9%,43m
18036,1,小九九,2329,1630,82,76,158,51.9%,1h
18036,1,愤怒的小老虎,2329,1555,76,69,145,52.4%,1h
18036,3,[邪恶的郁金香]SkyKing,2329,1278,56,59,115,48.7%,53m
18036,2,琪丶江,2329,774,27,22,49,55.1%,1h
18036,1,donfangjun,2329,484,26,26,52,50.0%,1h
18036,1,yourgrace,2329,664,22,21,43,51.2%,1h
18036,1,梦殇,2329,362,14,12,26,53.8%,1h
18036,1,亦庄,2329,369,11,9,20,55.0%,34m
18036,1,魏向风,2329,354,10,12,22,45.5%,1h
18036,2,jjh,2329,305,10,16,26,38.5%,1h
18036,2,高等数学,2329,0,3,2,5,60.0%,5m
18036,1,edwardyyy,2329,48,2,1,3,66.7%,1h
18036,1,闻香识包子,2329,0,1,0,1,100.0%,5m
18036,2,蜂蜜水微甜,2329,0,1,0,1,100.0%,2m
18036,1,风尘,2329,0,1,0,1,100.0%,1h
18036,1,[FHFH之父]是你吗,2329,0,0,3,3,0.0%,11m
18053,1,[风空理雷冰]风之律者,2328,622,21,19,40,52.5%,11m
18053,1,MOERBEN,2328,612,20,17,37,54.1%,24m
18053,1,[虐杀琉森]Copper,2328,364,10,12,22,45.5%,51m
18053,1,好吧搏命,2328,315,9,7,16,56.2%,1h
18053,1,一二三四五六起,2328,48,2,2,4,50.0%,1h
18053,1,GreenGreen,2328,0,0,2,2,0.0%,31m
18053,2,从小就皮,2328,0,0,4,4,0.0%,1h
18060,1,QSHAN,2327,1150,48,50,98,49.0%,4m
18060,1,嘿嘿优秀,2327,491,19,19,38,50.0%,35m
18060,1,工程传教士,2327,421,15,13,28,53.6%,1h
18060,3,荦荦,2327,258,10,9,19,52.6%,20m
18060,1,老魔杖,2327,241,8,13,21,38.1%,1h
18060,1,dream,2327,142,4,4,8,50.0%,1h
18060,3,[浴火银河]RamBo,2327,113,4,6,10,40.0%,1h
18060,1,XINGGE,2327,96,4,8,12,33.3%,4m
18060,2,[国际空间站]保时捷,2327,46,2,6,8,25.0%,15m
18060,2,烦死了看比赛,2327,36,1,1,2,50.0%,1h
18060,2,blblbl,2327,0,1,4,5,20.0%,16m
18060,2,肆玖,2327,0,1,5,6,16.7%,1h
18060,2,[入侵地球]飞龙骑脸怎么输,2327,0,0,1,1,0.0%,2m
18060,2,[在下菜鸡一只]西卡奈拉,2327,0,0,1,1,0.0%,1h
18060,1,ssccc,2327,0,0,4,4,0.0%,1h
18075,2,yyrao,2326,1030,120,124,244,49.2%,9m
18075,1,我是虫族,2326,1450,60,46,106,56.6%,55m
18075,1,牙三,2326,1027,41,42,83,49.4%,1h
18075,3,aleeshan,2326,315,14,18,32,43.8%,2m
18075,2,SchalkeZYY,2326,66,2,2,4,50.0%,1h
18075,3,更衣室的亡者,2326,0,1,0,1,100.0%,1h
18075,2,澹澹潺潺,2326,30,1,1,2,50.0%,23m
18075,1,酱香猪头肉,2326,0,1,1,2,50.0%,1h
18083,2,puretest,2325,1712,97,91,188,51.6%,1h
18083,2,夜星辰,2325,630,21,34,55,38.2%,9m
18083,1,寒舞,2325,216,9,9,18,50.0%,1h
18083,2,[菜鸡喵]森木下士,2325,134,5,1,6,83.3%,23m
18083,1,[loveMM]陈紫莹,2325,184,5,9,14,35.7%,1h
18083,2,boss,2325,0,1,0,1,100.0%,30m
18083,2,love,2325,30,1,2,3,33.3%,1h
18083,2,说啥我都是最帅,2325,0,0,1,1,0.0%,1h
18083,2,[only丶]Scofield,2325,0,0,1,1,0.0%,56m
18092,1,leo,2324,1547,79,81,160,49.4%,24m
18092,3,llllllllllll,2324,267,16,25,41,39.0%,29m
18092,3,全村人的希望,2324,180,13,17,30,43.3%,1h
18092,2,coliver,2324,234,8,6,14,57.1%,1h
18092,1,女宿楼下卖瓜致富,2324,190,4,7,11,36.4%,1h
18092,3,黄金舰队,2324,97,2,0,2,100.0%,57m
18092,2,景景,2324,34,2,1,3,66.7%,1h
18092,1,[上分全靠送]万物逆旅,2324,0,2,5,7,28.6%,1h
18092,2,游戏毁灭者,2324,0,1,0,1,100.0%,54m
18092,2,[高坚果护卫团]普莱斯中尉,2324,0,0,1,1,0.0%,23m
18092,2,anshi,2324,0,0,1,1,0.0%,1h
18092,1,jimochelun,2324,0,0,2,2,0.0%,6m
18092,1,[杯莫停]凡人终死,2324,0,0,3,3,0.0%,1h
18105,1,三月初三,2323,638,22,22,44,50.0%,1h
18105,1,星际菜鸟,2323,220,7,6,13,53.8%,1h
18105,1,GhostMaker,2323,66,3,4,7,42.9%,1h
18105,1,[KPG2]LoveDYX,2323,0,3,8,11,27.3%,15m
18105,2,[极限菜鸟]梦无形心相伴,2323,0,0,1,1,0.0%,1h
18105,2,君莫笑,2323,0,0,1,1,0.0%,16m
18111,2,[极限菜鸟]神奇的,2322,356,46,28,74,62.2%,1h
18111,1,日起火,2322,898,29,33,62,46.8%,1h
18111,3,你家石头爸爸,2322,449,14,32,46,30.4%,42m
18111,3,zhaowenbosb,2322,315,12,11,23,52.2%,1h
18111,3,一心一祎,2322,313,12,12,24,50.0%,55m
18111,3,PalmehrNath,2322,227,7,13,20,35.0%,1h
18111,3,遗言,2322,146,4,8,12,33.3%,1h
18111,1,Flame,2322,97,2,6,8,25.0%,1h
18111,2,点点提,2322,34,1,2,3,33.3%,41m
18111,2,毛线,2322,0,1,5,6,16.7%,1h
18111,1,[SFF]pig,2322,0,0,2,2,0.0%,7m
18122,1,[你已经死啦]黄子钰,2321,1419,51,45,96,53.1%,20m
18122,1,拾遗者,2321,942,36,32,68,52.9%,1h
18122,3,[科学养猪]llllllllllll,2321,1054,36,46,82,43.9%,1h
18122,3,憨憨阿冷,2321,263,9,13,22,40.9%,1h
18122,1,[野良爱57]刺蛇狂人吔梁,2321,177,5,8,13,38.5%,51m
18122,1,[舰队已抵达]小小害,2321,156,5,9,14,35.7%,31m
18122,1,Ghoust,2321,0,3,3,6,50.0%,1h
18122,2,小雪糕,2321,0,1,0,1,100.0%,1h
18122,1,[响当当水友]iiiiiiinnova,2321,96,1,1,2,50.0%,1h
18122,2,[琴筝]笛卡尔,2321,32,1,3,4,25.0%,1h
18132,3,ZELAIODASC,2320,254,41,47,88,46.6%,28m
18132,1,落寞达人,2320,1138,39,42,81,48.1%,1h
18132,3,Siri,2320,403,20,22,42,47.6%,21m
18132,1,艾尔之盾,2320,252,8,6,14,57.1%,13m
18132,2,美食大战老鼠,2320,160,6,3,9,66.7%,49m
18132,1,凉凝,2320,142,4,7,11,36.4%,1h
18132,3,[东十字军]万匹斯巴鲁,2320,140,3,6,9,33.3%,1h
18132,1,iiiiiiiiiiii,2320,96,2,1,3,66.7%,12m
18132,3,MARKSMAN,2320,0,1,3,4,25.0%,1h
18132,2,MagejiZerg,2320,0,0,1,1,0.0%,16m
18132,3,[虚空光辉舰]姐姐要用力干哥哥,2320,0,0,1,1,0.0%,1h
18143,1,水果沙拉勇士,2319,603,18,18,36,50.0%,9m
18143,2,mlfs,2319,348,12,10,22,54.5%,2m
18143,3,契约风雪,2319,395,12,20,32,37.5%,1h
18143,3,也无风雨也无晴,2319,17,4,14,18,22.2%,29m
18143,1,[暴雪十四队]白色样品,2319,48,3,7,10,30.0%,5m
18143,1,龙挚剑,2319,48,2,2,4,50.0%,1h
18143,1,[CcDd]Macarthur,2319,131,2,3,5,40.0%,1h
18143,2,孤岛,2319,0,0,1,1,0.0%,1h
18143,2,蜡笔小新,2319,0,0,1,1,0.0%,1h
18152,1,RiddleJoker,2318,1738,295,303,598,49.3%,31m
18152,1,[CPT]左岸右转,2318,1469,109,118,227,48.0%,38m
18152,1,bigdickman,2318,1493,85,76,161,52.8%,57m
18152,1,comflict,2318,908,33,32,65,50.8%,1h
18152,1,[水墨丹青]WhiteZero,2318,493,18,19,37,48.6%,1h
18152,2,[丨SLT丨]列克星敦,2318,256,9,6,15,60.0%,1h
18152,1,老班长,2318,120,2,3,5,40.0%,1h
18152,2,zqyNB,2318,0,1,3,4,25.0%,20m
18152,2,[QWQa]初音未来,2318,0,0,1,1,0.0%,20m
18152,2,奥利给,2318,0,0,1,1,0.0%,16m
18152,1,叁月丶初四,2318,0,0,2,2,0.0%,1h
18163,3,流浪汉,2317,1336,136,139,275,49.5%,1h
18163,3,Merry,2317,470,19,24,43,44.2%,46m
18163,1,[世界树]优衣对不起,2317,390,12,11,23,52.2%,1h
18163,1,承教于诺偌,2317,284,11,9,20,55.0%,1h
18163,1,大佬请教我玩星际,2317,267,6,8,14,42.9%,1h
18163,3,Lynn,2317,171,5,5,10,50.0%,57m
18163,1,sunbin,2317,146,4,6,10,40.0%,42m
18163,2,魅影凶灵,2317,44,3,4,7,42.9%,20m
18163,1,innovation,2317,122,2,3,5,40.0%,1h
18163,2,BlueUP,2317,0,1,5,6,16.7%,54m
18173,1,弄月公子,2316,555,158,162,320,49.4%,1h
18173,1,甜橙,2316,781,34,34,68,50.0%,24m
18173,3,影魔站中,2316,794,30,42,72,41.7%,28m
18173,1,[Icycry]amida,2316,658,18,20,38,47.4%,52m
18173,1,蔡碧一只,2316,493,17,15,32,53.1%,1h
18173,3,salazals,2316,247,11,10,21,52.4%,11m
18173,3,lllllllllll,2316,258,9,5,14,64.3%,36m
18173,1,jack,2316,130,3,3,6,50.0%,1h
18173,2,[GNMS]单手鼠标玩家,2316,84,3,6,9,33.3%,6m
18173,1,浅拂霜,2316,0,2,4,6,33.3%,6m
18173,3,小枫,2316,0,1,0,1,100.0%,1h
18173,1,Demon,2316,0,0,3,3,0.0%,1h
18185,1,efew,2315,263,8,15,23,34.8%,14m
18185,3,TNTB,2315,190,6,2,8,75.0%,1h
18185,3,Niko,2315,60,5,9,14,35.7%,26m
18185,2,xjmxhh,2315,46,2,4,6,33.3%,20m
18185,3,andnald,2315,0,2,7,9,22.2%,20m
18185,2,[暴雪十七队]丢蜗牛的白鼠,2315,0,1,0,1,100.0%,23m
18185,2,残年榊羽,2315,0,1,5,6,16.7%,5m
18185,1,[科普鲁苏维埃]往事如烟,2315,0,0,1,1,0.0%,1h
18185,1,[星灵充电宝]浑身腐男,2315,0,0,1,1,0.0%,1h
18185,1,KOO,2315,0,0,1,1,0.0%,10m
18185,2,落心有痕,2315,0,0,1,1,0.0%,49m
18196,2,万虫之潮,2314,590,21,16,37,56.8%,1h
18196,1,llllllllllll,2314,94,2,1,3,66.7%,55m
18196,2,星际跳跳,2314,0,1,4,5,20.0%,53m
18196,2,bloodyhreo,2314,0,0,1,1,0.0%,5m
18196,2,白纸剩女,2314,0,0,3,3,0.0%,45m
18201,1,[入侵地球]我的世界,2313,1713,186,190,376,49.5%,1h
18201,1,Campfire,2313,637,34,30,64,53.1%,1h
18201,1,山竹有间,2313,651,27,18,45,60.0%,1h
18201,1,[在下萌新一只]piaopiao,2313,774,25,25,50,50.0%,1h
18201,3,FSLBN,2313,225,6,7,13,46.2%,42m
18201,1,孟买,2313,145,3,7,10,30.0%,11m
18201,1,丶花花,2313,0,1,1,2,50.0%,58m
18208,1,kiva,2312,209,5,8,13,38.5%,1h
18208,3,[亡命之魂]lllllllllll,2312,146,4,7,11,36.4%,20m
18208,1,cool,2312,144,3,6,9,33.3%,55m
18208,2,llllllllllll,2312,44,2,5,7,28.6%,49m
18208,2,培根煎蛋,2312,32,1,3,4,25.0%,1h
18208,2,一战,2312,0,0,1,1,0.0%,1h
18208,2,Adrian,2312,0,0,1,1,0.0%,1h
18208,2,Dog,2312,0,0,1,1,0.0%,39m
18208,1,zzz,2312,0,0,2,2,0.0%,1h
18217,3,风飞过得地方,2311,998,42,49,91,46.2%,42m
18217,2,同一个服,2311,525,16,19,35,45.7%,1h
18217,1,别野兵营了,2311,343,11,11,22,50.0%,36m
18217,1,佛挡杀佛,2311,225,7,6,13,53.8%,1h
18217,1,我能,2311,162,5,3,8,62.5%,52m
18217,1,桃花醉梨花殇,2311,96,5,8,13,38.5%,1h
18217,1,RedMasion,2311,118,3,7,10,30.0%,1h
18217,1,颛顼,2311,120,3,7,10,30.0%,59m
18217,2,haha,2311,0,3,8,11,27.3%,1h
18217,2,[RyH键谈坊]蛆虫型玩家,2311,92,2,2,4,50.0%,1h
18217,2,MrMao,2311,0,2,3,5,40.0%,42m
18217,1,[龙血]GeekAllianc,2311,0,1,1,2,50.0%,52m
18217,2,ooo,2311,0,0,1,1,0.0%,2m
18217,2,[纳兰皇族]BestDanger,2311,0,0,3,3,0.0%,1h
18231,1,JanJan,2310,1300,50,54,104,48.1%,60m
18231,2,[艾杀星]小艾艾,2310,737,30,15,45,66.7%,1h
18231,1,晴天水清,2310,147,14,3,17,82.4%,42m
18231,1,CharityVance,2310,165,6,8,14,42.9%,56m
18231,3,迷路的麋鹿,2310,172,4,7,11,36.4%,45m
18231,2,XBBBBBBB,2310,48,3,6,9,33.3%,49m
18231,1,缘之空,2310,0,1,1,2,50.0%,1h
18231,1,三阳,2310,0,0,1,1,0.0%,1h
18231,3,对面泰伦帝国饶命,2310,0,0,1,1,0.0%,55m
18231,1,AskrNidBedRK,2310,0,0,3,3,0.0%,1h
18231,2,终焉时刻,2310,0,0,4,4,0.0%,44m
18231,3,再见,2310,0,0,10,10,0.0%,51m
18243,2,[极限菜鸟]南木哥,2309,883,156,151,307,50.8%,10m
18243,1,ZAKAQ,2309,1464,55,53,108,50.9%,1h
18243,2,Chateau,2309,483,34,26,60,56.7%,49m
18243,2,[斯巴达血战团]魔法少女林北酱,2309,321,20,4,24,83.3%,23m
18243,2,happy,2309,493,17,7,24,70.8%,8m
18243,3,[SCVsr]奇迹,2309,338,17,23,40,42.5%,1h
18243,2,口腔的溃疡,2309,184,7,6,13,53.8%,1h
18243,2,Kiyan,2309,140,6,1,7,85.7%,8m
18243,1,chongling,2309,0,3,3,6,50.0%,47m
18243,1,[菜鸡的天堂]神至丶空,2309,96,2,2,4,50.0%,27m
18243,1,[中华何平]EASY,2309,0,1,1,2,50.0%,28m
18243,2,大宇,2309,0,1,4,5,20.0%,6m
18243,2,诸子诸侯王,2309,0,1,6,7,14.3%,20m
18243,2,lilith,2309,0,0,1,1,0.0%,10m
18243,2,baofushehui,2309,0,0,1,1,0.0%,1h
18243,1,[奥术之光]吸血鬼伯爵小白鼠,2309,0,0,2,2,0.0%,1h
18243,2,[星痕]大喵,2309,0,0,6,6,0.0%,16m
18243,1,工作的羊,2309,0,0,6,6,0.0%,28m
18261,1,[内急]Twistzz,2308,374,11,14,25,44.0%,1h
18261,2,MaryJ,2308,254,9,15,24,37.5%,1h
18261,1,[牛奶蘑菇汤]王小咘,2308,187,4,6,10,40.0%,7m
18261,3,cylvielly,2308,121,4,8,12,33.3%,20m
18261,2,[鲜血蔷薇]人深,2308,52,3,1,4,75.0%,17m
18261,2,yeswan,2308,44,2,1,3,66.7%,1h
18261,3,[Dcboy]PartinG,2308,58,2,12,14,14.3%,1h
18261,2,阿勒呼和,2308,0,1,0,1,100.0%,1h
18261,2,吾乃传说,2308,0,1,0,1,100.0%,44m
18261,3,GCL,2308,0,1,1,2,50.0%,1h
18261,2,敲不死,2308,0,0,1,1,0.0%,8m
18261,2,酷酷酷的汶,2308,0,0,1,1,0.0%,51m
18261,2,头号玩家,2308,0,0,1,1,0.0%,28m
18261,2,溟色貂夜,2308,0,0,5,5,0.0%,1h
18275,1,zhayumeima,2307,1119,65,62,127,51.2%,59m
18275,2,愚鱼,2307,633,25,20,45,55.6%,1h
18275,1,hcxixi,2307,321,12,7,19,63.2%,24m
18275,2,杀康星人,2307,176,8,15,23,34.8%,15m
18275,2,二零二零脱单成功,2307,138,4,4,8,50.0%,1h
18275,1,瞎子,2307,118,3,10,13,23.1%,30m
18275,2,哈哈哈,2307,0,1,0,1,100.0%,1h
18275,2,一只羊小咩,2307,0,1,1,2,50.0%,1h
18275,1,[塔达林军团]拉不起的仇恨,2307,0,0,5,5,0.0%,1h
18284,1,vincentan,2306,487,19,19,38,50.0%,20m
18284,3,果仁小黑,2306,311,14,5,19,73.7%,1h
18284,1,空投挖掘机,2306,402,13,19,32,40.6%,1h
18284,2,IIIIIIIIIII,2306,166,6,17,23,26.1%,1h
18284,1,fox,2306,74,3,4,7,42.9%,30m
18284,2,龙少,2306,0,1,4,5,20.0%,16m
18290,2,[犀利颤抖机]比比啾,2305,1315,65,73,138,47.1%,52m
18290,1,坑爹的小蚂蚁,2305,751,37,37,74,50.0%,24m
18290,2,埋头玩自己的,2305,839,32,25,57,56.1%,23m
18290,1,成都故事大王,2305,586,22,23,45,48.9%,1h
18290,2,不要玩诚哥梗,2305,358,13,15,28,46.4%,1h
18290,2,[我是萌新Q]罪人,2305,250,10,4,14,71.4%,55m
18290,1,caiiix,2305,138,4,6,10,40.0%,1h
18290,1,俗人,2305,192,4,8,12,33.3%,31m
18290,2,[嗯哼嗯啊啊啊]Glazy,2305,66,2,9,11,18.2%,1h
18290,2,[式神]战争雷霆,2305,0,1,0,1,100.0%,1h
18290,2,我服气,2305,0,0,1,1,0.0%,1h
18290,2,KKKKKKK,2305,0,0,1,1,0.0%,1h
18290,2,军力,2305,0,0,2,2,0.0%,39m
18303,1,呼啸战神,2304,939,66,72,138,47.8%,15m
18303,2,最强男人黎力,2304,348,12,10,22,54.5%,1h
18303,1,Pluto,2304,216,6,9,15,40.0%,1h
18303,1,朝歌晚酒,2304,211,5,11,16,31.2%,13m
18303,2,老鸟一号,2304,48,2,5,7,28.6%,44m
18303,3,[DSE]横刀立马向天笑,2304,0,2,7,9,22.2%,57m
18303,2,水夭,2304,0,1,1,2,50.0%,19m
18303,2,aaaaaa,2304,0,0,1,1,0.0%,1h
18303,2,小萌新,2304,0,0,1,1,0.0%,1h
18303,2,[糸色]BUTER,2304,0,0,1,1,0.0%,1h
18303,2,Protomss,2304,0,0,1,1,0.0%,16m
18314,1,魔王,2303,1089,63,63,126,50.0%,7m
18314,1,Otho,2303,466,22,17,39,56.4%,44m
18314,1,xiaozhu,2303,447,13,13,26,50.0%,1h
18314,2,king,2303,312,12,7,19,63.2%,26m
18314,1,人劫,2303,301,11,9,20,55.0%,59m
18314,1,矢量数据入手,2303,301,9,10,19,47.4%,1h
18314,1,乱竹疏影,2303,166,4,7,11,36.4%,1h
18314,1,[啾啾啾啾啾啾]二杠,2303,142,4,8,12,33.3%,1h
18314,1,我整你嘴,2303,0,2,5,7,28.6%,1h
18314,1,LBY,2303,0,2,5,7,28.6%,1h
18314,2,人工合成多巴胺,2303,0,1,1,2,50.0%,1h
18314,1,[埃蒙好可爱]芬兰人民血战毛子,2303,0,0,3,3,0.0%,1h
18326,1,[CPT]般若,2302,1139,37,41,78,47.4%,45m
18326,1,[DX战队]奶油少女丶萌妹子,2302,342,11,17,28,39.3%,1h
18326,3,[血鸦旅馆]RyamonD,2302,226,10,14,24,41.7%,11m
18326,1,[银翼之光]灵魂流转,2302,216,6,11,17,35.3%,1h
18326,1,红色长裙,2302,140,4,9,13,30.8%,1h
18326,1,丨灰鸽丨,2302,0,2,5,7,28.6%,1h
18326,1,绒球,2302,93,1,3,4,25.0%,59m
18326,2,凯欧布里鹏,2302,0,1,5,6,16.7%,1h
18326,2,孤帝寂晨,2302,0,0,2,2,0.0%,1h
18335,2,水卜樱,2301,418,31,22,53,58.5%,1h
18335,1,你怎么这么棒,2301,404,19,14,33,57.6%,1h
18335,1,异虫,2301,324,8,16,24,33.3%,1h
18335,3,[亚历山大]奕剑听雨阁七师弟,2301,231,7,12,19,36.8%,1h
18335,2,战狼出击,2301,139,3,0,3,100.0%,53m
18335,1,星际王,2301,145,3,4,7,42.9%,1h
18335,2,emperor,2301,93,1,1,2,50.0%,1h
18335,2,SANGVISFERR,2301,0,0,1,1,0.0%,17m
18335,2,宪哥,2301,0,0,6,6,0.0%,28m
18344,1,Bing,2300,33,25,34,59,42.4%,45m
18344,1,clownking,2300,664,23,30,53,43.4%,1h
18344,1,霸气,2300,337,12,15,27,44.4%,59m
18344,2,沙格莱斯,2300,238,8,14,22,36.4%,17m
18344,2,[浪啊浪]PAIPAIYUE,2300,148,5,5,10,50.0%,49m
18344,1,TheSwarm,2300,140,4,3,7,57.1%,1h
18344,1,湫水,2300,0,3,5,8,37.5%,1h
18344,2,[你好抱歉]前尘封心,2300,0,1,0,1,100.0%,51m
18344,2,Ambition,2300,30,1,2,3,33.3%,23m
18344,2,长腿东启,2300,0,0,1,1,0.0%,1h
18354,1,伏羲,2299,494,23,17,40,57.5%,1h
18354,3,赫萝的黄金龙爪,2299,230,9,13,22,40.9%,52m
18354,1,[银翼之光]墨攻,2299,304,9,15,24,37.5%,1h
18354,2,BANANAMAN,2299,144,6,2,8,75.0%,55m
18354,1,玄苍,2299,228,6,10,16,37.5%,13m
18354,2,胡卡里欧,2299,42,2,5,7,28.6%,6m
18354,3,天空小汤圆,2299,0,1,1,2,50.0%,27m
18354,3,thinl,2299,0,1,3,4,25.0%,1h
18354,2,星际神坤,2299,0,1,4,5,20.0%,1h
18354,2,[面纱祭祀]PALLADINO,2299,0,1,4,5,20.0%,1h
18354,2,miracle,2299,0,1,5,6,16.7%,6m
18354,2,囧阳阳,2299,0,0,1,1,0.0%,1h
18354,2,XIAO,2299,0,0,1,1,0.0%,33m
18354,1,落叶飞翔,2299,0,0,1,1,0.0%,1h
18354,3,MayBeLi,2299,0,0,1,1,0.0%,27m
18369,1,极品渣男,2298,1667,142,148,290,49.0%,52m
18369,1,阮步兵,2298,354,11,16,27,40.7%,51m
18369,1,次了个瓜,2298,169,5,4,9,55.6%,1h
18369,1,炸鸡人柱力,2298,140,4,8,12,33.3%,1h
18369,2,hhhhhh,2298,88,2,2,4,50.0%,1h
18369,2,无名,2298,30,1,1,2,50.0%,1h
18369,2,nozomi,2298,97,1,5,6,16.7%,1h
18369,3,八条是瑶瑶,2298,0,0,1,1,0.0%,1h
18377,1,粉碎者,2297,328,8,10,18,44.4%,1h
18377,2,黄乙笑,2297,65,7,5,12,58.3%,15m
18377,3,狗哥哥,2297,224,6,14,20,30.0%,58m
18377,1,月瞳,2297,88,2,2,4,50.0%,1h
18377,2,伪战士,2297,0,1,0,1,100.0%,12m
18377,2,血色天魔,2297,0,1,0,1,100.0%,17m
18377,1,[Shawk]dark,2297,0,0,1,1,0.0%,12m
18377,1,神恩造物,2297,0,0,1,1,0.0%,1h
18377,1,皓月,2297,0,0,1,1,0.0%,2m
18386,1,aaaaee,2296,1604,80,73,153,52.3%,1h
18386,2,偏爱小单,2296,520,17,22,39,43.6%,23m
18386,1,cary,2296,479,14,16,30,46.7%,11m
18386,2,武陵艾佛,2296,307,9,16,25,36.0%,12m
18386,3,帝君,2296,30,3,7,10,30.0%,34m
18386,2,Addict,2296,46,2,2,4,50.0%,20m
18386,1,fff,2296,0,1,0,1,100.0%,27m
18386,2,[终极蛇皮队]考拉,2296,0,0,1,1,0.0%,30m
18394,1,雨见虹,2295,461,15,15,30,50.0%,45m
18394,3,赫大赫,2295,284,11,11,22,50.0%,1h
18394,1,helamos,2295,300,11,16,27,40.7%,36m
18394,3,真心玩不动了,2295,220,7,11,18,38.9%,1h
18394,2,kuang,2295,0,2,4,6,33.3%,5m
18394,2,[COMBN]萝卜,2295,30,1,1,2,50.0%,1h
18394,2,Kerrigan,2295,32,1,3,4,25.0%,1h
18394,1,星星电灯,2295,0,1,3,4,25.0%,1h
18394,2,巨蟹之钳,2295,0,0,1,1,0.0%,17m
18394,2,甜橙味的猫,2295,0,0,1,1,0.0%,1h
18404,1,竞赛答卷亏损较,2294,944,40,31,71,56.3%,1h
18404,2,[扫黄]IIIIIIIIIIII,2294,389,32,24,56,57.1%,17m
18404,3,Melt,2294,562,17,41,58,29.3%,12m
18404,2,用脚打就够了,2294,300,11,12,23,47.8%,51m
18404,3,永夜,2294,272,9,13,22,40.9%,15m
18404,2,[CARMYS]劫凌殇,2294,102,3,6,9,33.3%,1h
18404,2,Ibelieve,2294,40,2,2,4,50.0%,39m
18404,2,mind,2294,34,1,2,3,33.3%,17m
18404,1,[别杀我农民]一木,2294,0,1,3,4,25.0%,1h
18404,3,[社交学大可爱]探姬遭到公鸡,2294,0,1,4,5,20.0%,37m
18404,1,灰太狼,2294,0,1,6,7,14.3%,1h
18404,1,Jason,2294,0,1,6,7,14.3%,31m
18416,1,亚加拉达,2293,1597,173,187,360,48.1%,58m
18416,2,[QF清风阁]SKTfaker,2293,369,15,15,30,50.0%,1h
18416,2,[cdylps]cnm,2293,0,1,0,1,100.0%,41m
18416,1,冬拾,2293,0,1,0,1,100.0%,55m
18416,2,一个小塞图,2293,0,1,4,5,20.0%,53m
18421,2,高深,2292,874,32,34,66,48.5%,7m
18421,2,雷雷域烈,2292,418,15,9,24,62.5%,1h
18421,1,erww,2292,500,15,15,30,50.0%,4m
18421,2,十月初八,2292,418,14,18,32,43.8%,57m
18421,1,纵横彡,2292,274,9,7,16,56.2%,1h
18421,3,飞天的拉拉,2292,223,8,13,21,38.1%,27m
18421,3,爱在西元前,2292,226,6,8,14,42.9%,36m
18421,1,EASYpeazzzyy,2292,230,6,10,16,37.5%,1h
18421,1,DarkTemplar,2292,97,2,6,8,25.0%,27m
18421,3,ALonelyOne,2292,97,2,7,9,22.2%,1h
18421,2,[鹌鹑带星]憨鸭鸭家的喵呜,2292,121,2,7,9,22.2%,45m
18421,1,[大乔无惨]gunima,2292,0,1,0,1,100.0%,47m
18421,2,跳跳骑士,2292,0,1,4,5,20.0%,1h
18421,1,魂念,2292,40,1,7,8,12.5%,16m
18421,2,mastdw,2292,0,0,1,1,0.0%,1h
18436,1,避雷针达达,2291,1489,56,66,122,45.9%,1h
18436,2,Tist,2291,608,21,17,38,55.3%,30m
18436,1,皇恪,2291,405,16,21,37,43.2%,7m
18436,3,NEAUTY,2291,227,8,14,22,36.4%,1h
18436,3,好的里哈撒,2291,228,8,19,27,29.6%,21m
18436,2,[星际大镖客]Nobody,2291,211,7,13,20,35.0%,12m
18436,1,[喵帕斯喵]AstroPU,2291,222,6,10,16,37.5%,42m
18436,2,夏韭菜,2291,92,4,2,6,66.7%,5m
18436,2,[I苏维埃I]夏末有点甜,2291,0,1,0,1,100.0%,1h
18445,2,Luska,2290,234,23,17,40,57.5%,16m
18445,1,[混吃混喝]无法选择,2290,453,15,13,28,53.6%,14m
18445,2,[星际黑铁前线]Origami,2290,235,11,6,17,64.7%,16m
18445,1,[高街村]下水道里的老鼠人,2290,188,5,1,6,83.3%,1h
18445,1,[为了阿米娅]高坚果,2290,48,4,6,10,40.0%,31m
18445,2,DJhuang,2290,0,1,1,2,50.0%,16m
18445,2,宝树,2290,0,1,1,2,50.0%,56m
18445,2,Acme,2290,0,1,4,5,20.0%,46m
18445,2,MAXOPG,2290,0,0,1,1,0.0%,26m
18445,2,[疾风E有归途]归期,2290,0,0,2,2,0.0%,42m
18455,1,xuNLu,2289,1558,123,119,242,50.8%,28m
18455,3,Yosky,2289,380,56,63,119,47.1%,51m
18455,2,Lamar,2289,722,40,31,71,56.3%,1h
18455,2,[Artrs]LONGLONG,2289,991,40,36,76,52.6%,49m
18455,2,还记的夏弥吗,2289,128,5,3,8,62.5%,16m
18455,1,乐乐公举,2289,126,4,6,10,40.0%,1h
18455,2,真田信林,2289,136,2,2,4,50.0%,1h
18455,1,[华师大二附中]Noleft,2289,0,1,0,1,100.0%,5m
18455,1,闪灵小侠,2289,0,0,6,6,0.0%,28m
18464,3,[慕灬小冷]烂分大师,2288,1091,57,44,101,56.4%,40m
18464,2,狡诈妖怪,2288,840,34,21,55,61.8%,1h
18464,1,一言难尽,2288,718,24,26,50,48.0%,28m
18464,1,[NLHR]艾尔,2288,395,17,8,25,68.0%,1h
18464,1,靠骗靠噢偷袭,2288,190,5,6,11,45.5%,58m
18464,2,PLUM,2288,58,3,1,4,75.0%,1h
18464,1,[战旗娱乐圈]小刃,2288,104,2,3,5,40.0%,1h
18464,1,长安十三朝,2288,78,2,5,7,28.6%,36m
18464,2,圣光忽悠着余,2288,0,1,0,1,100.0%,1h
18464,3,机灵鬼,2288,0,1,0,1,100.0%,13m
18464,2,无知无畏,2288,0,1,4,5,20.0%,45m
18464,2,SacredLight,2288,0,0,1,1,0.0%,1h
18464,2,zzz,2288,0,0,1,1,0.0%,1h
18464,1,[雾雨魔法森林]qwe,2288,0,0,2,2,0.0%,10m
18464,2,rose,2288,0,0,3,3,0.0%,16m
18479,2,duck,2287,439,17,14,31,54.8%,55m
18479,1,战略防御,2287,481,17,15,32,53.1%,24m
18479,1,Flood,2287,286,10,9,19,52.6%,27m
18479,1,[旺旺战士]龖靁魈,2287,355,9,11,20,45.0%,13m
18479,2,等等,2287,102,3,2,5,60.0%,16m
18479,2,sdfs,2287,0,1,5,6,16.7%,44m
18479,2,当夜晚拥有星星,2287,0,0,5,5,0.0%,1h
18486,3,巴黎梧桐雨,2286,1545,335,339,674,49.7%,21m
18486,3,[D3D]小月,2286,1561,100,121,221,45.2%,58m
18486,2,FMbudan,2286,678,32,25,57,56.1%,26m
18486,3,战皇,2286,214,9,10,19,47.4%,20m
18486,1,[上海大学]欢迎报考上海大学,2286,284,8,8,16,50.0%,34m
18486,2,IIIIIIIIIIII,2286,146,4,2,6,66.7%,56m
18486,1,吟瘾怪,2286,103,4,4,8,50.0%,28m
18486,2,[Sc养老]垂死卧病惊坐起,2286,86,3,2,5,60.0%,1h
18486,2,咔咔咔,2286,131,3,7,10,30.0%,41m
18486,1,blackland,2286,0,2,7,9,22.2%,1h
18486,2,神兽镜,2286,0,1,1,2,50.0%,56m
18486,2,知白守黑,2286,0,1,1,2,50.0%,1h
18486,2,oooo,2286,0,1,4,5,20.0%,1h
18486,1,[嗑药小分队]一小远一,2286,0,0,1,1,0.0%,1h
18486,2,[MGnb]LIAOYUAN,2286,0,0,1,1,0.0%,1h
18501,1,海底有针,2285,575,23,16,39,59.0%,1h
18501,2,sasaas,2285,332,11,7,18,61.1%,23m
18501,2,霸主,2285,300,10,11,21,47.6%,5m
18501,1,xinmu,2285,231,9,6,15,60.0%,52m
18501,1,[嘤嘤嘤呜呜]DAN,2285,158,6,9,15,40.0%,1h
18501,3,恋凡伴逸仙,2285,143,4,1,5,80.0%,1h
18501,2,迈阿密韩,2285,30,2,0,2,100.0%,49m
18501,2,张韩子轩,2285,0,1,1,2,50.0%,1h
18501,2,[哔翻天梯鸡]我的人族像孙哥,2285,30,1,2,3,33.3%,8m
18510,1,IdraFan,2284,591,30,29,59,50.8%,1h
18510,2,[游戏风云OL]猪是念来过到,2284,353,13,16,29,44.8%,39m
18510,2,[萌萌哒鸡]维羽杰,2284,252,10,6,16,62.5%,30m
18510,1,[无花也浪漫]鬼子,2284,252,9,8,17,52.9%,51m
18510,1,丨丨丨,2284,262,6,4,10,60.0%,1h
18510,1,ndfghdfg,2284,161,4,9,13,30.8%,1h
18510,2,醉烟痴,2284,117,2,6,8,25.0%,1h
18510,1,[天气]廉价旅行者,2284,0,0,1,1,0.0%,1h
18510,1,gqk,2284,0,0,1,1,0.0%,47m
18510,3,宁静致远,2284,0,0,2,2,0.0%,3m
18510,1,Float,2284,0,0,3,3,0.0%,1h
18510,2,Second,2284,0,0,3,3,0.0%,1h
18522,2,Bozsen,2283,1062,43,35,78,55.1%,57m
18522,2,土豆泥冰沙,2283,546,19,18,37,51.4%,1h
18522,1,[艾尔核电站]death,2283,559,16,18,34,47.1%,52m
18522,3,IIIIIIIIIIII,2283,334,13,9,22,59.1%,55m
18522,2,虫神,2283,141,3,2,5,60.0%,1h
18522,1,[荀彧喵]在神皇面前跪下,2283,117,2,2,4,50.0%,1h
18522,2,[暴雪家族]幻痛,2283,0,1,1,2,50.0%,1h
18522,2,葆尘,2283,0,1,4,5,20.0%,1h
18530,2,[大熊猫]路灯下萌一萌,2282,1424,60,61,121,49.6%,39m
18530,3,硫代硫酸钠,2282,1039,38,52,90,42.2%,1h
18530,1,向我开炮,2282,394,13,21,34,38.2%,21m
18530,2,eslks,2282,48,3,4,7,42.9%,1h
18530,2,银河领主,2282,160,3,5,8,37.5%,1h
18530,2,风间琉璃,2282,0,2,3,5,40.0%,1h
18530,1,蛏子影胤,2282,0,1,0,1,100.0%,1h
18530,2,我是真的不想赢啊,2282,0,1,1,2,50.0%,45m
18530,2,[FEILIA]绯灬,2282,0,0,1,1,0.0%,1h
18530,1,妈个鸡泰伦,2282,0,0,3,3,0.0%,47m
18540,2,IIIIIIIIIIII,2281,385,17,11,28,60.7%,5m
18540,1,哥的风骚你不懂,2281,208,7,6,13,53.8%,4m
18540,2,[DMRe]火云邪神,2281,164,6,20,26,23.1%,1h
18540,2,天翼之影,2281,148,3,9,12,25.0%,2m
18540,2,[FCKP]Slayer,2281,92,2,6,8,25.0%,7m
18540,2,CzarTech,2281,0,1,0,1,100.0%,1h
18540,2,第三十三,2281,0,1,4,5,20.0%,1h
18540,2,MRchen,2281,0,1,4,5,20.0%,7m
18540,1,[太玄]勇士不灭,2281,0,1,6,7,14.3%,27m
18540,2,彼岸留芳,2281,0,0,1,1,0.0%,23m
18540,1,MQX,2281,0,0,2,2,0.0%,1h
18540,2,天狗,2281,0,0,4,4,0.0%,44m
18552,1,变能骑士,2280,446,16,14,30,53.3%,43m
18552,2,BOSS,2280,368,15,17,32,46.9%,23m
18552,2,零下,2280,348,13,12,25,52.0%,10m
18552,1,唐门小贤,2280,232,11,6,17,64.7%,28m
18552,1,驻卵小肥羊,2280,217,7,6,13,53.8%,1h
18552,2,樱落,2280,102,3,0,3,100.0%,8m
18552,2,[BOC]IIIIIIIIIIII,2280,0,1,2,3,33.3%,1h
18552,1,哈哈你猜我是吹,2280,0,0,5,5,0.0%,1h
18560,1,Gerry,2279,942,43,48,91,47.3%,1h
18560,1,暴雪公司,2279,875,30,35,65,46.2%,30m
18560,1,faker,2279,383,22,25,47,46.8%,1h
18560,1,paperpaper,2279,342,9,18,27,33.3%,36m
18560,1,JoeLivey,2279,0,3,9,12,25.0%,9m
18560,3,怒吼天尊,2279,0,1,0,1,100.0%,1h
18560,2,人渣大大,2279,0,1,0,1,100.0%,51m
18560,2,imbalance,2279,0,1,4,5,20.0%,42m
18560,2,Wbibo,2279,0,0,2,2,0.0%,26m
18560,1,梅山宋仲基,2279,0,0,4,4,0.0%,4m
18570,3,妄人,2278,1460,213,222,435,49.0%,53m
18570,2,末夜,2278,607,24,16,40,60.0%,49m
18570,1,孙天我能让你,2278,416,15,14,29,51.7%,1h
18570,1,猴子,2278,300,11,11,22,50.0%,43m
18570,1,名字好难起,2278,213,6,4,10,60.0%,1h
18570,2,小胖子,2278,160,5,5,10,50.0%,1h
18570,2,查尔的爪牙,2278,61,4,3,7,57.1%,16m
18570,1,DITF,2278,168,3,2,5,60.0%,7m
18570,2,哥哥是神,2278,0,1,0,1,100.0%,1h
18570,2,AKQ,2278,0,0,1,1,0.0%,1h
18570,1,流浪者之诗,2278,0,0,3,3,0.0%,1h
18581,1,华丽凯歌,2277,482,14,22,36,38.9%,1h
18581,1,九资河一哥,2277,309,12,10,22,54.5%,1h
18581,2,Clown,2277,307,11,14,25,44.0%,30m
18581,1,狂甩大鸡芭,2277,158,5,12,17,29.4%,59m
18581,1,王大头,2277,96,2,6,8,25.0%,1h
18581,1,xxxx,2277,0,1,0,1,100.0%,1h
18581,1,[XXHZ20]一目意山河,2277,0,1,3,4,25.0%,14m
18581,2,[塔达林高坚果]mvt,2277,0,1,4,5,20.0%,1h
18581,2,刘艾薇,2277,0,1,5,6,16.7%,56m
18581,2,初音未来,2277,0,0,2,2,0.0%,1h
18581,2,我是将军你是姬,2277,0,0,3,3,0.0%,1h
18592,2,小龙,2276,1346,54,66,120,45.0%,52m
18592,2,[南京的星空]货郎先生,2276,560,41,38,79,51.9%,8m
18592,1,大禹,2276,552,18,18,36,50.0%,13m
18592,1,家人健康最重要,2276,386,12,16,28,42.9%,1h
18592,2,[佳宏]bseryseuysrn,2276,312,11,8,19,57.9%,30m
18592,2,zzt,2276,0,1,0,1,100.0%,1h
18592,2,混合体巨兽,2276,0,1,1,2,50.0%,23m
18592,2,gfhshfjg,2276,0,1,2,3,33.3%,53m
18592,2,Bin,2276,0,1,5,6,16.7%,16m
18592,2,厦门李钟硕,2276,0,0,1,1,0.0%,1h
18602,3,鱼蝶梦,2275,269,10,8,18,55.6%,1h
18602,3,[EP]雨落情深,2275,60,3,6,9,33.3%,1h
18602,1,我热爱学习,2275,0,1,2,3,33.3%,1h
18602,1,楽之庄,2275,0,1,2,3,33.3%,1h
18602,2,SHTOT,2275,0,0,1,1,0.0%,49m
18602,2,樱高三年二班,2275,0,0,2,2,0.0%,1h
18608,3,圣者不朽,2274,654,33,50,83,39.8%,28m
18608,1,骑士包子,2274,96,2,5,7,28.6%,28m
18608,1,天恒,2274,0,2,6,8,25.0%,10m
18608,2,毁三观,2274,0,1,0,1,100.0%,1h
18608,2,[歌者II]茗翎之媛,2274,0,0,1,1,0.0%,1h
18613,2,[老色批联盟]宇宙无敌虫族王,2273,1416,76,69,145,52.4%,1h
18613,2,根据规划机构,2273,746,53,44,97,54.6%,16m
18613,2,[琴筝]虫妖亚里莎,2273,635,24,22,46,52.2%,1h
18613,1,[隐忍]尼德霍格,2273,733,24,25,49,49.0%,13m
18613,2,[我们都是幼女]可爱即是正义,2273,0,3,3,6,50.0%,28m
18613,3,六尘不改,2273,0,1,0,1,100.0%,11m
18613,2,[瘾大眼瞎]小徐,2273,32,1,2,3,33.3%,39m
18613,1,[神圣的F2加]晓風,2273,91,1,3,4,25.0%,1h
18621,1,[scbaby]CSCEC,2272,527,20,29,49,40.8%,51m
18621,1,小坏蛋,2272,70,3,7,10,30.0%,45m
18621,1,RYcooper,2272,0,2,4,6,33.3%,7m
18621,2,[你好抱歉]MingSir,2272,0,0,1,1,0.0%,1h
18621,2,chuck,2272,0,0,1,1,0.0%,20m
18626,2,[Thpj]PrinzEugen,2271,673,34,44,78,43.6%,1h
18626,2,冷枫,2271,425,15,19,34,44.1%,1h
18626,2,孙一峰永是我大哥,2271,62,3,3,6,50.0%,1h
18626,2,[萌新启发会]洛基山狼,2271,30,1,4,5,20.0%,1h
18626,2,iFBxxx,2271,0,0,2,2,0.0%,2m
18631,1,[DSE]江湖夜雨十年灯,2270,1088,85,80,165,51.5%,1h
18631,1,宇智波宇,2270,635,44,48,92,47.8%,17m
18631,2,南苏,2270,138,5,2,7,71.4%,57m
18631,1,[屯溪]孤战,2270,136,5,4,9,55.6%,47m
18631,2,花水月,2270,60,2,2,4,50.0%,30m
18631,2,Gujo,2270,0,0,3,3,0.0%,1h
18637,1,芝麻果子,2269,97,3,5,8,37.5%,34m
18637,1,死柒,2269,94,3,6,9,33.3%,1h
18637,2,深渊,2269,30,1,3,4,25.0%,33m
18637,2,[ZGA]LionelKay,2269,30,1,3,4,25.0%,23m
18637,2,统筹计划,2269,0,1,5,6,16.7%,23m
18637,2,LiZhi,2269,0,1,5,6,16.7%,42m
18637,2,[快乐风男]樱花亦落心亦凉,2269,0,0,1,1,0.0%,1h
18637,2,[世界何平]迷彩旅,2269,0,0,1,1,0.0%,1h
18637,1,新人求带,2269,0,0,1,1,0.0%,27m
18646,2,[二斋]牢城营丁二,2268,1395,380,396,776,49.0%,44m
18646,1,路李嘉图,2268,864,28,34,62,45.2%,15m
18646,2,天天,2268,48,5,2,7,71.4%,28m
18646,1,人间大炮,2268,145,3,7,10,30.0%,1h
18646,2,SuperJustice,2268,30,2,2,4,50.0%,1h
18646,2,Qualony,2268,97,1,5,6,16.7%,44m
18652,1,GIGI,2267,1599,157,165,322,48.8%,52m
18652,2,insight,2267,837,83,73,156,53.2%,1h
18652,2,黄金之旅,2267,381,21,12,33,63.6%,49m
18652,1,立心,2267,550,16,21,37,43.2%,1h
18652,1,筱灬炒肉,2267,395,13,17,30,43.3%,1h
18652,1,[战旗彡月无双]狱粮,2267,318,9,17,26,34.6%,11m
18652,2,Kboss,2267,0,2,3,5,40.0%,50m
18652,1,Jack,2267,97,2,6,8,25.0%,1h
18652,1,starlight,2267,0,1,0,1,100.0%,1h
18652,2,未晨,2267,0,1,0,1,100.0%,33m
18652,2,ttyttty,2267,30,1,2,3,33.3%,17m
18652,2,艾尔熙德,2267,0,1,4,5,20.0%,1h
18652,2,烟花,2267,0,0,1,1,0.0%,1h
18652,2,jam,2267,0,0,6,6,0.0%,23m
18666,1,冰雪狂神,2266,1606,56,59,115,48.7%,1h
18666,1,暗杀者马雷达,2266,626,30,36,66,45.5%,36m
18666,2,药丸,2266,560,22,17,39,56.4%,1h
18666,2,Lucifer,2266,467,18,14,32,56.2%,17m
18666,2,[丨贱圣丨]忆汐,2266,336,14,13,27,51.9%,1h
18666,2,枪炮龙,2266,118,4,4,8,50.0%,1h
18666,2,反反复复,2266,96,3,3,6,50.0%,16m
18666,1,Ghost,2266,97,3,4,7,42.9%,56m
18666,2,[单人行动对吧]chen,2266,80,3,5,8,37.5%,10m
18666,2,凤仙,2266,58,2,2,4,50.0%,23m
18666,2,ProphetZ,2266,0,1,0,1,100.0%,56m
18666,2,NIGHTMARE,2266,0,1,2,3,33.3%,1h
18666,1,明月出天山,2266,0,1,6,7,14.3%,60m
18666,1,谐一点不好吗,2266,0,0,1,1,0.0%,1h
18666,2,十二丶门狂,2266,0,0,2,2,0.0%,1h
18666,2,Borst,2266,0,0,2,2,0.0%,1h
18682,1,虫潮,2265,1603,159,165,324,49.1%,1h
18682,1,WDNMD,2265,820,32,27,59,54.2%,1h
18682,2,术士司马懿,2265,615,24,15,39,61.5%,12m
18682,1,投煮祝猪珠祝诛,2265,298,10,13,23,43.5%,1h
18682,1,怀特苏,2265,207,5,6,11,45.5%,39m
18682,1,rei,2265,236,5,9,14,35.7%,1h
18682,2,柠檬水放糖,2265,0,1,4,5,20.0%,45m
18682,2,流年与你同行,2265,0,0,1,1,0.0%,1h
18682,2,[镜花水月丶]Sparow,2265,0,0,2,2,0.0%,1h
18691,1,浪漫一阵风,2264,1598,115,101,216,53.2%,1h
18691,3,梧言,2264,1142,57,57,114,50.0%,1h
18691,1,[久美子足浴城]破界神尊,2264,390,13,14,27,48.1%,1h
18691,2,上天入地,2264,306,11,10,21,52.4%,1h
18691,1,低调的虫族,2264,241,8,10,18,44.4%,13m
18691,2,[CPT]约束,2264,208,7,8,15,46.7%,23m
18691,2,llrabbit,2264,90,4,2,6,66.7%,38m
18691,1,wildwolf,2264,48,4,7,11,36.4%,1h
18691,2,随风而散,2264,90,3,2,5,60.0%,49m
18691,1,eeeeeriic,2264,80,3,6,9,33.3%,28m
18691,2,武曌八荒,2264,66,2,2,4,50.0%,51m
18691,1,PROTOSS,2264,96,2,6,8,25.0%,31m
18691,2,程哥,2264,93,1,5,6,16.7%,1h
18704,1,[CPT]不雷斯,2263,1494,53,64,117,45.3%,1h
18704,2,RooPanes,2263,1090,49,38,87,56.3%,23m
18704,1,CandLes,2263,48,2,1,3,66.7%,47m
18704,3,GreatMaster,2263,120,2,2,4,50.0%,53m
18704,1,米卢猫,2263,118,2,3,5,40.0%,27m
18704,1,sponsor,2263,48,1,3,4,25.0%,1h
18704,2,梅川内依,2263,0,1,5,6,16.7%,1h
18704,2,安因兹乌尔贡,2263,0,1,5,6,16.7%,1h
18704,2,[刺蛇互助社团]LeesFeng,2263,0,0,2,2,0.0%,1h
18713,2,ThezGAgayY,2262,677,27,25,52,51.9%,55m
18713,1,[CRRC]不务正业,2262,665,18,25,43,41.9%,1h
18713,2,FIRE,2262,187,13,8,21,61.9%,1h
18713,2,gggg,2262,130,4,6,10,40.0%,1h
18713,2,超级无敌魔鬼帆,2262,46,2,5,7,28.6%,42m
18713,2,扫地焚香,2262,0,1,5,6,16.7%,7m
18713,2,独角鲸,2262,0,0,3,3,0.0%,7m
18720,2,天旭,2261,678,26,21,47,55.3%,1h
18720,1,[21CM]玫瑰公子,2261,753,24,30,54,44.4%,1h
18720,2,无限单通,2261,284,10,22,32,31.2%,39m
18720,3,Altmam,2261,246,8,13,21,38.1%,1h
18720,2,[GalArC]永远的巫女,2261,182,6,7,13,46.2%,2m
18720,2,巍仔,2261,184,6,8,14,42.9%,57m
18720,1,WSTLYTT,2261,235,6,9,15,40.0%,1h
18720,2,火鸡味锅巴,2261,104,4,1,5,80.0%,10m
18720,1,遗物,2261,88,2,5,7,28.6%,1h
18720,3,我即是怂人,2261,30,2,7,9,22.2%,1h
18720,2,Pressure,2261,40,1,3,4,25.0%,1h
18720,1,新手,2261,0,0,2,2,0.0%,14m
18732,1,doOs,2260,1512,243,252,495,49.1%,17m
18732,1,鲁丽,2260,300,8,15,23,34.8%,59m
18732,3,这人有亿点下饭,2260,198,6,10,16,37.5%,11m
18732,1,留意,2260,132,4,5,9,44.4%,1h
18732,1,夏目大人,2260,164,4,5,9,44.4%,11m
18732,2,博哥,2260,131,4,12,16,25.0%,55m
18732,1,吃糖,2260,120,2,4,6,33.3%,36m
18739,1,山木兮,2259,1703,165,166,331,49.8%,44m
18739,2,[贰伍仔集中营]多读读书,2259,674,28,29,57,49.1%,1h
18739,1,凤雏,2259,506,18,26,44,40.9%,40m
18739,2,深海听风,2259,471,17,14,31,54.8%,52m
18739,1,虚空行走,2259,337,12,20,32,37.5%,1h
18739,2,这么远那么近,2259,92,4,2,6,66.7%,30m
18739,1,[Dameng]末日承欢,2259,114,3,8,11,27.3%,1h
18739,2,[跑山鸡]世界青年,2259,30,2,0,2,100.0%,30m
18739,2,[西北]小铭同学,2259,0,0,2,2,0.0%,1h
18748,2,Group,2258,280,26,23,49,53.1%,30m
18748,1,星际迷雾,2258,534,15,22,37,40.5%,1h
18748,2,OLIJE,2258,213,8,5,13,61.5%,2m
18748,2,虫鸣,2258,208,8,8,16,50.0%,1h
18748,1,Erebus,2258,233,4,6,10,40.0%,1h
18748,1,azzxzz,2258,94,2,3,5,40.0%,39m
18748,2,[i5]别打我的脸,2258,0,1,0,1,100.0%,1h
18748,1,TwinShadows,2258,0,1,0,1,100.0%,1h
18748,2,瀚星之歌,2258,0,0,3,3,0.0%,50m
18748,2,郭尔摩斯,2258,0,0,5,5,0.0%,1h
18758,2,[五月花]slddddddddd,2257,1073,42,46,88,47.7%,1h
18758,1,[8v1玩泥巴]香风智乃,2257,211,5,4,9,55.6%,1h
18758,2,[DSE]醉梦前尘,2257,58,3,5,8,37.5%,23m
18758,1,CrazyDiamond,2257,78,3,8,11,27.3%,9m
18758,2,虫群速度虫群规模,2257,70,2,2,4,50.0%,7m
18758,2,havebeercome,2257,92,2,2,4,50.0%,23m
18758,2,[璀璨群星之刃]八级大狂风,2257,58,2,3,5,40.0%,1h
18758,2,[你们都是渣]TYTY,2257,93,1,5,6,16.7%,16m
18758,2,leifeng,2257,0,0,1,1,0.0%,17m
18758,2,[TZJ]LaoYang,2257,0,0,1,1,0.0%,1h
18768,2,小奶狗,2256,767,31,31,62,50.0%,57m
18768,2,[达拉姆督察]Juggernaut,2256,518,21,18,39,53.8%,1h
18768,1,死神来临,2256,312,15,28,43,34.9%,35m
18768,3,平行世界,2256,146,4,2,6,66.7%,1h
18768,1,小虎妖,2256,198,4,3,7,57.1%,1h
18768,2,小小杰尼,2256,163,3,7,10,30.0%,28m
18768,2,医疗兵贩卖商人,2256,0,1,1,2,50.0%,1h
18768,2,leolian,2256,0,1,4,5,20.0%,28m
18776,3,thirty,2255,834,127,129,256,49.6%,12m
18776,2,DEIUXTHEMAX,2255,1123,76,76,152,50.0%,1h
18776,1,来根华子,2255,381,12,20,32,37.5%,13m
18776,2,虫群,2255,202,8,7,15,53.3%,17m
18776,1,生日,2255,184,4,8,12,33.3%,47m
18776,2,llllllllllll,2255,68,2,6,8,25.0%,30m
18776,2,[极限菜鸟]铁憨憨,2255,30,1,1,2,50.0%,49m
18776,2,[Sfae]皇族清风,2255,0,1,2,3,33.3%,1h
18776,2,夹得很紧紧的一逼,2255,0,1,2,3,33.3%,16m
18776,1,[SFTRA3]youlingqwq,2255,89,1,2,3,33.3%,1h
18776,2,[黄一峰]NIgHT,2255,0,0,1,1,0.0%,52m
18776,2,孙一喵是我大哥喵,2255,0,0,1,1,0.0%,1h
18788,2,Queen,2254,797,49,34,83,59.0%,1h
18788,1,电车君,2254,1129,38,50,88,43.2%,36m
18788,2,[勇士的信仰]无聊的人类,2254,390,15,8,23,65.2%,8m
18788,2,enic,2254,227,9,7,16,56.2%,1h
18788,2,ASUNA,2254,197,6,3,9,66.7%,38m
18788,1,[怪盗军团]至尊盗亡拉法姆,2254,134,4,6,10,40.0%,28m
18788,2,NOTHINGTOALL,2254,0,3,2,5,60.0%,44m
18788,2,可乐不加冰,2254,138,2,7,9,22.2%,55m
18788,2,MARALST,2254,0,1,1,2,50.0%,20m
18788,2,JimSvk,2254,0,0,2,2,0.0%,1h
18798,1,[馬家溝]宇宙霸主,2253,869,41,47,88,46.6%,43m
18798,2,TheShy,2253,653,25,24,49,51.0%,1h
18798,2,啦啦啦啦啦,2253,427,12,14,26,46.2%,10m
18798,2,dsr,2253,118,6,3,9,66.7%,58m
18798,3,信仰,2253,151,6,8,14,42.9%,1h
18798,1,大云,2253,0,2,7,9,22.2%,11m
18798,2,GeoLLy,2253,0,1,0,1,100.0%,1h
18798,2,[DMRc]qqw,2253,0,1,1,2,50.0%,1h
18798,2,Xhuazosi,2253,0,1,3,4,25.0%,1h
18798,2,萌新威望肝出血,2253,0,0,1,1,0.0%,1h
18798,2,三刀,2253,0,0,1,1,0.0%,1h
18798,1,星海虫影,2253,0,0,1,1,0.0%,13m
18810,3,tklbp,2252,1234,49,52,101,48.5%,17m
18810,3,过马路的蚂蚁,2252,569,21,32,53,39.6%,2m
18810,1,HMY,2252,336,9,12,21,42.9%,1h
18810,2,FoRtiSimO,2252,220,5,0,5,100.0%,16m
18810,2,jerk,2252,90,3,7,10,30.0%,45m
18810,2,慢点慢点,2252,0,1,3,4,25.0%,1h
18810,2,[NewV]foyes,2252,0,0,1,1,0.0%,1h
18810,2,IIIIIIIIIII,2252,0,0,1,1,0.0%,23m
18810,2,廖斯基,2252,0,0,1,1,0.0%,21m
18810,2,江门古天乐,2252,0,0,4,4,0.0%,1h
18820,1,[QWQa]小雏菊,2251,625,44,44,88,50.0%,1h
18820,1,hoveyxu,2251,911,33,34,67,49.3%,1h
18820,2,lolxxs,2251,318,14,12,26,53.8%,39m
18820,2,自由之翼,2251,158,3,4,7,42.9%,58m
18820,2,lastorder,2251,110,3,7,10,30.0%,1h
18820,1,haohaochi,2251,120,3,7,10,30.0%,1h
18820,2,blackrose,2251,30,2,4,6,33.3%,1h
18820,2,[ldp6]弟中弟,2251,0,1,2,3,33.3%,1h
18820,2,叔叔半夜劫个色,2251,0,0,1,1,0.0%,1h
18820,2,呵呵,2251,0,0,1,1,0.0%,1h
18830,1,Canaan,2250,325,7,12,19,36.8%,49m
18830,3,传说哥,2250,130,5,21,26,19.2%,1h
18830,2,蓝色火焰,2250,95,2,1,3,66.7%,21m
18830,2,闩鉴,2250,0,1,0,1,100.0%,39m
18830,2,摄魄丶小胖,2250,0,1,4,5,20.0%,16m
18830,2,跳跳龙,2250,0,0,1,1,0.0%,12m
18836,2,bbbbbb,2249,344,49,43,92,53.3%,1h
18836,2,[马润万岁]boy,2249,325,14,17,31,45.2%,17m
18836,1,自个的牛牛,2249,240,6,7,13,46.2%,10m
18836,2,[热能]www,2249,114,5,2,7,71.4%,38m
18836,2,宝宝,2249,58,2,3,5,40.0%,1h
18836,2,Zzz,2249,30,1,1,2,50.0%,49m
18836,2,HAKuLAma,2249,0,0,1,1,0.0%,23m
18843,1,Neve,2248,1655,67,66,133,50.4%,1h
18843,2,wound,2248,629,27,25,52,51.9%,58m
18843,1,空对空露露对路,2248,215,7,9,16,43.8%,36m
18843,2,SHI,2248,0,1,1,2,50.0%,1h
18843,2,派星星,2248,0,1,2,3,33.3%,56m
18843,2,Cryingknight,2248,0,1,4,5,20.0%,46m
18843,2,大佬,2248,44,1,4,5,20.0%,16m
18843,2,夏一可我老婆,2248,0,0,1,1,0.0%,50m
18843,2,AAAAAAAAA,2248,0,0,1,1,0.0%,1h
18852,1,和酥,2247,784,30,33,63,47.6%,1h
18852,1,boxer,2247,515,18,16,34,52.9%,1h
18852,1,团子股,2247,475,15,25,40,37.5%,24m
18852,2,[星灵最棒]凉笙萧,2247,333,12,13,25,48.0%,1h
18852,2,炮火芝兰,2247,202,8,16,24,33.3%,19m
18852,2,[纵丨横]SKY,2247,86,5,7,12,41.7%,46m
18852,2,开智同学,2247,126,4,12,16,25.0%,8m
18852,3,我打星际像售太姆,2247,147,3,4,7,42.9%,55m
18852,2,徐影随枫,2247,0,0,1,1,0.0%,46m
18852,1,[开心玩]一四级公共账号,2247,0,0,2,2,0.0%,1h
18862,1,程雪,2246,1100,37,43,80,46.2%,1h
18862,2,[喜欢香香]冰尊帝影,2246,339,18,14,32,56.2%,1h
18862,1,流水,2246,514,17,23,40,42.5%,1h
18862,2,backgwy,2246,256,9,16,25,36.0%,8m
18862,1,MMMAAAAAA,2246,129,3,2,5,60.0%,1h
18862,2,MIN,2246,66,3,6,9,33.3%,26m
18862,2,天下,2246,30,2,1,3,66.7%,58m
18862,2,灰色的世界,2246,30,2,1,3,66.7%,52m
18862,1,InfiniteZero,2246,48,2,2,4,50.0%,55m
18862,2,微微一笑,2246,0,0,1,1,0.0%,8m
18862,2,MoYu,2246,0,0,1,1,0.0%,1h
18862,2,[探姬真可爱啊]EASN,2246,0,0,3,3,0.0%,1h
18874,1,[我笑]夜雨声烦,2245,707,42,48,90,46.7%,1h
18874,1,阿无驴,2245,422,13,14,27,48.1%,31m
18874,2,隔壁老王在线求虐,2245,223,9,1,10,90.0%,23m
18874,1,虫潮来了,2245,183,6,14,20,30.0%,55m
18874,2,pimba,2245,118,5,3,8,62.5%,1h
18874,2,小明,2245,112,2,1,3,66.7%,7m
18874,2,铁一神教,2245,94,2,5,7,28.6%,1h
18874,2,燕笑语兮,2245,30,1,3,4,25.0%,30m
18874,2,南湘灬,2245,0,0,5,5,0.0%,8m
18883,1,只会苟,2244,531,15,21,36,41.7%,1h
18883,1,[联合指挥区]Ares,2244,450,14,15,29,48.3%,24m
18883,2,老鹰,2244,86,4,2,6,66.7%,1h
18883,1,[花里胡哨]孤影,2244,0,1,0,1,100.0%,7m
18883,2,米津玄师,2244,30,1,3,4,25.0%,7m
18883,2,军军,2244,30,1,6,7,14.3%,1h
18883,2,asdfg,2244,0,0,1,1,0.0%,46m
18883,2,黑暗咪咪,2244,0,0,2,2,0.0%,1h
18891,1,军师,2243,386,31,33,64,48.4%,36m
18891,2,[XXHZ28]鱼之乐,2243,175,4,4,8,50.0%,8m
18891,2,[绝世之神帝]傲世丶霸皇之剑圣,2243,136,3,1,4,75.0%,30m
18891,2,[特工]繁简繁,2243,108,3,9,12,25.0%,23m
18891,2,结城梨斗,2243,30,2,2,4,50.0%,8m
18891,2,Bruce,2243,38,2,6,8,25.0%,23m
18891,3,[比心老子爱你]疯狂摸鱼,2243,30,1,5,6,16.7%,41m
18891,2,塞拉菲姆,2243,0,0,1,1,0.0%,1h
18899,3,老婆,2242,147,4,2,6,66.7%,1h
18899,1,哒哒哒,2242,48,2,5,7,28.6%,1h
18899,1,[思乡]zyz,2242,0,0,1,1,0.0%,1h
18902,2,MrLG,2241,126,5,4,9,55.6%,57m
18902,2,电脑监控安防办公,2241,0,4,4,8,50.0%,1h
18902,2,时俞,2241,235,4,9,13,30.8%,23m
18902,2,狌先生,2241,88,3,2,5,60.0%,1h
18902,1,凉一丶,2241,0,2,5,7,28.6%,5m
18902,1,[東方幻月舞會]我的手速真的很慢,2241,0,0,2,2,0.0%,47m
18908,2,我也只会这一招,2240,679,25,27,52,48.1%,1h
18908,2,零五二四,2240,332,16,10,26,61.5%,1h
18908,1,银狼王,2240,484,16,16,32,50.0%,24m
18908,2,神之不和,2240,244,7,5,12,58.3%,1h
18908,2,sadadsadasds,2240,0,1,5,6,16.7%,16m
18908,2,夺命双熊,2240,0,0,1,1,0.0%,11m
18908,2,qzx,2240,0,0,1,1,0.0%,2m
18915,2,ShawyuS,2239,629,26,20,46,56.5%,23m
18915,1,[坦克36D]usadapekora,2239,336,11,11,22,50.0%,14m
18915,2,[Dryzzz]安吉丨尼雅,2239,233,8,4,12,66.7%,1h
18915,2,下雨,2239,146,6,5,11,54.5%,38m
18915,1,不会玩别来贰打贰,2239,96,2,1,3,66.7%,1h
18915,3,BONESGGG,2239,0,2,2,4,50.0%,42m
18915,2,摸仙小王,2239,46,2,5,7,28.6%,1h
18915,2,ulrezal,2239,30,1,3,4,25.0%,18m
18915,2,[BL干杯]fireksl,2239,30,1,3,4,25.0%,1h
18915,2,你猜是谁,2239,91,1,5,6,16.7%,1h
18925,2,Layer,2238,1411,75,71,146,51.4%,1h
18925,1,半个菜鸡,2238,588,29,35,64,45.3%,1h
18925,2,山沟小师傅,2238,286,15,9,24,62.5%,11m
18925,2,wangnamu,2238,226,8,8,16,50.0%,1h
18925,2,[NLYH]冰封王兽,2238,30,2,3,5,40.0%,1h
18925,2,风剑,2238,30,2,3,5,40.0%,26m
18925,1,dasdws,2238,0,1,0,1,100.0%,1h
18925,2,[SC2战队]强森,2238,0,1,3,4,25.0%,21m
18925,2,diujil,2238,0,0,1,1,0.0%,1h
18925,3,FOX,2238,0,0,3,3,0.0%,26m
18935,1,乐言神族很菜,2237,1389,114,120,234,48.7%,4m
18935,2,灰灰,2237,124,4,7,11,36.4%,1h
18935,1,llvorite,2237,48,2,1,3,66.7%,1h
18935,1,STDD,2237,0,2,7,9,22.2%,31m
18935,2,[来1223]大结局,2237,0,0,1,1,0.0%,57m
18935,3,[突变攻略小租]无敌的我,2237,0,0,1,1,0.0%,11m
18941,1,mucike,2236,710,79,80,159,49.7%,1h
18941,1,会飞的猪噜噜,2236,1023,39,38,77,50.6%,28m
18941,1,AOI,2236,953,34,40,74,45.9%,1h
18941,1,jericho,2236,637,21,32,53,39.6%,14m
18941,1,片甲不留,2236,498,17,19,36,47.2%,1h
18941,2,ncnbboy,2236,46,3,3,6,50.0%,21m
18941,1,梁梁,2236,34,1,5,6,16.7%,1h
18941,1,STY,2236,0,0,1,1,0.0%,16m
18949,3,verygood,2235,1350,73,76,149,49.0%,19m
18949,1,westlife,2235,734,54,56,110,49.1%,1h
18949,1,不傲,2235,853,35,41,76,46.1%,1h
18949,1,gou,2235,466,32,31,63,50.8%,29m
18949,2,doge,2235,485,17,15,32,53.1%,1h
18949,1,夕阳下的刻痕,2235,526,16,42,58,27.6%,1h
18949,2,ShadowWalker,2235,225,7,5,12,58.3%,12m
18949,2,锴锴锴,2235,62,3,5,8,37.5%,1h
18949,2,sss,2235,0,1,0,1,100.0%,1h
18949,2,赌东道,2235,0,0,1,1,0.0%,40m
18949,2,宁菜神,2235,0,0,1,1,0.0%,1h
18949,2,[浙大战队]德玛西亚,2235,0,0,3,3,0.0%,1h
18949,1,辽宁舰,2235,0,0,7,7,0.0%,31m
18962,2,[肉鸡的饲养]dannyman,2234,1082,55,58,113,48.7%,1h
18962,1,[浦大]KeeLimoon,2234,679,26,26,52,50.0%,1h
18962,2,jsrTBB,2234,491,22,35,57,38.6%,60m
18962,1,blackapple,2234,153,4,4,8,50.0%,51m
18962,2,yibo,2234,0,1,1,2,50.0%,1h
18962,2,冰之羽翼,2234,0,1,5,6,16.7%,16m
18962,1,flag,2234,0,0,1,1,0.0%,51m
18962,2,[一个军的兵力]无埃,2234,0,0,1,1,0.0%,11m
18962,2,LVEW,2234,0,0,1,1,0.0%,1h
18962,2,克哈,2234,0,0,2,2,0.0%,23m
18972,2,SPIKE,2233,498,19,15,34,55.9%,1h
18972,2,SugaRZ,2233,480,18,17,35,51.4%,33m
18972,2,条西,2233,448,17,21,38,44.7%,33m
18972,2,fjgfjh,2233,312,12,6,18,66.7%,8m
18972,2,Kleman,2233,303,10,13,23,43.5%,51m
18972,1,jack,2233,186,4,12,16,25.0%,1h
18972,2,[雷霆半月斩]天天,2233,66,3,2,5,60.0%,46m
18972,2,[INC]Phoenix,2233,95,3,3,6,50.0%,23m
18972,1,[对面四秒射]樱岛麻衣,2233,138,3,7,10,30.0%,1h
18972,2,dfsfsfsf,2233,38,2,3,5,40.0%,23m
18972,2,公羽佥刃,2233,123,2,4,6,33.3%,1h
18972,3,天楚皇朝,2233,0,1,4,5,20.0%,42m
18972,2,Seliver,2233,0,0,2,2,0.0%,40m
18985,2,沦落,2232,716,27,32,59,45.8%,1h
18985,1,[VLK]幽灵,2232,416,13,18,31,41.9%,1h
18985,2,五组组长,2232,137,3,5,8,37.5%,16m
18985,2,不用怀疑不会,2232,135,2,2,4,50.0%,54m
18985,2,Drrey,2232,89,2,4,6,33.3%,7m
18985,2,[112909]赵某某,2232,78,2,7,9,22.2%,1h
18985,1,阿尔道夫斯基,2232,48,2,10,12,16.7%,1h
18985,2,xiaoleishou,2232,0,1,0,1,100.0%,49m
18985,3,[小菜逼]争霸一方,2232,0,1,4,5,20.0%,1h
18994,2,[歌者II]烟火,2231,766,28,25,53,52.8%,1h
18994,1,[X英雄圣域X]蝈虫儿,2231,462,17,25,42,40.5%,1h
18994,2,[黄金海舰队]tyrande,2231,374,14,13,27,51.9%,16m
18994,1,寂静如雨,2231,317,10,14,24,41.7%,42m
18994,1,[最菜战队]wsglu,2231,114,5,11,16,31.2%,1h
18994,3,Elysium,2231,0,4,1,5,80.0%,1h
18994,1,服戍,2231,0,0,1,1,0.0%,1h
19001,2,希斯灬莱杰,2230,459,17,20,37,45.9%,52m
19001,2,看说明好累懒得取,2230,246,9,8,17,52.9%,23m
19001,1,CIAGRAY,2230,118,3,0,3,100.0%,28m
19001,2,痴心范,2230,30,2,0,2,100.0%,19m
19001,2,[这是个陷阱啊]凉凉了,2230,0,1,0,1,100.0%,1h
19001,2,艾蒙,2230,48,1,7,8,12.5%,28m
19001,1,[皇子]LuciferHeart,2230,0,0,1,1,0.0%,1h
19001,2,deepcry,2230,0,0,2,2,0.0%,33m
19009,3,topgun,2229,1595,315,344,659,47.8%,1h
19009,3,金盆洗铁手,2229,643,123,122,245,50.2%,1h
19009,2,星空,2229,652,23,21,44,52.3%,1h
19009,1,[麻痹的青年]瘾大技术差,2229,532,16,23,39,41.0%,14m
19009,1,[我觉得不行]我觉得我行,2229,394,14,15,29,48.3%,11m
19009,3,[嘤雄联盟]Acisod,2229,222,6,8,14,42.9%,1h
19009,3,夜半,2229,123,6,9,15,40.0%,1h
19009,2,[我太帅]bzsyjks,2229,143,3,1,4,75.0%,1h
19009,2,[久美子足浴城]星际霸王,2229,90,3,6,9,33.3%,1h
19009,2,[菜有菜的道理]plum,2229,0,1,0,1,100.0%,1h
19009,2,zsc,2229,0,1,5,6,16.7%,54m
19020,2,南浦,2228,1444,70,71,141,49.6%,1h
19020,1,[鼠人共和国]大地之鼠,2228,774,31,31,62,50.0%,1h
19020,2,Obama,2228,551,24,19,43,55.8%,1h
19020,2,宝可梦大师阿巴瑟,2228,204,7,4,11,63.6%,30m
19020,1,山的那边,2228,243,6,10,16,37.5%,1h
19020,2,mrquin,2228,188,6,12,18,33.3%,1h
19020,2,XHLhhhh,2228,137,3,5,8,37.5%,42m
19020,2,风萧萧兮易水寒,2228,66,2,6,8,25.0%,1h
19020,2,少时诵诗书所,2228,0,1,0,1,100.0%,30m
19020,1,CLOWN,2228,0,1,0,1,100.0%,28m
19020,2,[清华大学战队]垃圾星际毁我青春,2228,0,1,0,1,100.0%,5m
19031,3,[CPT]仙师完败,2227,321,13,21,34,38.2%,1h
19031,2,[浴火银河]众神之光,2227,301,11,6,17,64.7%,51m
19031,1,塞缪尔白白,2227,158,4,7,11,36.4%,1h
19031,2,banishedimmo,2227,46,2,6,8,25.0%,28m
19031,1,[天羽不榖]ASHDAS,2227,0,1,0,1,100.0%,1h
19031,2,精神领袖,2227,0,1,5,6,16.7%,50m
19031,2,九泉,2227,0,1,5,6,16.7%,55m
19031,2,妖刀,2227,0,1,5,6,16.7%,54m
19031,2,hhhhh,2227,97,1,6,7,14.3%,54m
19040,1,dias,2226,169,4,12,16,25.0%,26m
19040,2,贪郎,2226,92,3,3,6,50.0%,8m
19040,1,[全国修车]潜龙行空,2226,96,1,1,2,50.0%,1h
19040,2,落霞孤鹜,2226,0,1,3,4,25.0%,1h
19040,2,child,2226,30,1,4,5,20.0%,1h
19040,3,胡涂仙,2226,0,1,4,5,20.0%,1h
19040,2,无心丿星星,2226,0,0,1,1,0.0%,1h
19047,2,司夜,2225,766,28,32,60,46.7%,1h
19047,2,小球弟弟,2225,388,14,12,26,53.8%,1h
19047,2,IIIIIIIIIIII,2225,182,7,4,11,63.6%,1h
19047,2,ZXKD,2225,0,1,2,3,33.3%,52m
19051,2,[TLFKR]东野青皮龟,2224,711,31,24,55,56.4%,1h
19051,1,狡黠的西瓜,2224,595,23,20,43,53.5%,1h
19051,2,[公子世无双]浅幕之年我定逆天,2224,246,8,9,17,47.1%,1h
19051,2,suppersy,2224,0,1,2,3,33.3%,56m
19051,2,健康的吴先生,2224,0,0,2,2,0.0%,8m
19056,1,青年,2223,313,11,15,26,42.3%,13m
19056,1,自心为息,2223,271,8,10,18,44.4%,27m
19056,2,无名书生,2223,169,7,5,12,58.3%,8m
19056,1,qianxun,2223,111,3,4,7,42.9%,1h
19056,2,tcrrect,2223,93,2,3,5,40.0%,46m
19056,1,算无遗策,2223,96,2,10,12,16.7%,3m
19056,2,ZDZ,2223,0,1,1,2,50.0%,1h
19056,2,夕阳下的贪吃蛇,2223,0,1,1,2,50.0%,30m
19056,3,蒙圈猛犬,2223,0,1,4,5,20.0%,12m
19056,2,老鬼,2223,0,0,1,1,0.0%,51m
19066,2,抹茶飞起来一鞋底,2222,910,33,35,68,48.5%,12m
19066,2,罗卍空,2222,524,19,23,42,45.2%,1h
19066,3,再也不用集结了,2222,5,5,97,102,4.9%,24m
19066,2,[艾尔之名]Holyelves,2222,0,2,2,4,50.0%,1h
19066,3,[为了胜利为了]风卷寒曦,2222,97,2,6,8,25.0%,1h
19071,2,白色死神,2221,285,12,15,27,44.4%,1h
19071,1,IIIIIIIIIIII,2221,341,9,4,13,69.2%,13m
19071,1,DEICIDE,2221,169,4,6,10,40.0%,1h
19071,1,lbwnb,2221,115,3,0,3,100.0%,1h
19071,2,information,2221,0,3,2,5,60.0%,2m
19071,1,月孤夜昏,2221,0,2,6,8,25.0%,1h
19071,2,[小鸡屠宰场3]saiwen,2221,0,1,0,1,100.0%,1h
19071,2,指挥官,2221,0,0,1,1,0.0%,1h
19079,2,橘子指挥官,2220,1367,47,60,107,43.9%,15m
19079,2,多情应笑我,2220,620,21,34,55,38.2%,10m
19079,3,清风浩存,2220,301,11,5,16,68.8%,1h
19079,2,TNEX,2220,289,10,11,21,47.6%,1h
19079,3,[非一般的帅]vagary,2220,233,9,7,16,56.2%,1h
19079,2,[银河喵波隆]fasdf,2220,224,7,11,18,38.9%,1h
19079,2,[养驼大师]承德孙一峰,2220,93,4,2,6,66.7%,44m
19079,2,[TG1]RED,2220,90,4,4,8,50.0%,52m
19079,2,西班牙,2220,90,3,5,8,37.5%,33m
19079,1,往后小鲍相伴,2220,0,1,0,1,100.0%,27m
19079,3,又是一个小宝贝,2220,0,1,4,5,20.0%,41m
19079,1,[禽禽禽]冰霜之犬,2220,0,0,1,1,0.0%,1h
19079,3,[极限菜鸟]活死人,2220,0,0,2,2,0.0%,26m
19079,3,秋沐苏,2220,0,0,5,5,0.0%,1h
19093,2,疯狂阿行,2219,475,13,26,39,33.3%,1h
19093,2,满背关公丶杀,2219,140,5,9,14,35.7%,21m
19093,3,huaji,2219,0,2,3,5,40.0%,60m
19093,1,[青城烧麦]War,2219,0,1,0,1,100.0%,11m
19093,2,ImProVise,2219,30,1,3,4,25.0%,39m
19093,2,我中单贼六,2219,0,1,5,6,16.7%,16m
19099,1,RedMap,2218,950,33,38,71,46.5%,1h
19099,2,初代,2218,477,15,16,31,48.4%,1h
19099,2,vold,2218,146,6,5,11,54.5%,23m
19099,2,伟强在线送分,2218,58,2,2,4,50.0%,57m
19099,1,基尼太美,2218,0,1,1,2,50.0%,28m
19099,2,Gone,2218,92,1,1,2,50.0%,1h
19099,3,我最帅了,2218,0,1,4,5,20.0%,60m
19099,2,[社交学导教]幻琪,2218,0,0,1,1,0.0%,18m
19099,2,UltronZero,2218,0,0,2,2,0.0%,46m
19108,2,混元太极爱偷袭,2217,878,31,30,61,50.8%,23m
19108,1,夜雨声繁,2217,711,24,32,56,42.9%,36m
19108,1,泪亭之吻,2217,110,4,5,9,44.4%,13m
19108,2,叭叽丶,2217,0,3,3,6,50.0%,28m
19108,2,辛辰,2217,73,3,4,7,42.9%,1h
19108,2,笛卡尔,2217,0,1,1,2,50.0%,54m
19108,1,逗者无疆,2217,0,1,1,2,50.0%,1h
19108,3,文文文文,2217,0,1,4,5,20.0%,49m
19108,2,soap,2217,0,0,1,1,0.0%,2m
19117,1,想不出来好名字,2216,601,26,37,63,41.3%,17m
19117,2,神樂七奈,2216,394,15,16,31,48.4%,1h
19117,2,白给,2216,128,4,10,14,28.6%,1h
19117,2,Luckystar,2216,30,2,1,3,66.7%,1h
19117,2,卿曦,2216,30,2,3,5,40.0%,1h
19117,2,rinima,2216,0,1,7,8,12.5%,54m
19117,3,言和,2216,0,0,1,1,0.0%,1h
19124,2,几何,2215,429,17,14,31,54.8%,1h
19124,1,渣渣,2215,311,9,11,20,45.0%,49m
19124,2,潇湘魂,2215,236,8,9,17,47.1%,30m
19124,1,[SXR]SKT,2215,117,3,2,5,60.0%,49m
19124,3,一年肆忌,2215,0,2,2,4,50.0%,1h
19124,2,爱茹,2215,0,1,6,7,14.3%,16m
19124,2,追风少年,2215,0,0,1,1,0.0%,58m
19131,1,[APoX]poixees,2214,366,15,22,37,40.5%,1h
19131,2,必捷,2214,46,3,7,10,30.0%,1h
19131,2,[猪猪猪]大水龙,2214,42,2,7,9,22.2%,16m
19131,2,黑衣剑士,2214,0,1,1,2,50.0%,1h
19135,3,坚韧不拔,2213,1487,132,153,285,46.3%,16m
19135,2,丁妮格菲儿,2213,214,6,5,11,54.5%,1h
19135,3,SLKING,2213,0,4,1,5,80.0%,48m
19135,3,gcup,2213,0,3,2,5,60.0%,41m
19135,2,[Atiers]凯瑞,2213,0,1,0,1,100.0%,1h
19135,3,win,2213,0,1,2,3,33.3%,1h
19135,2,你女良,2213,44,1,3,4,25.0%,1h
19135,2,[战忽局总部]五乐泉,2213,0,1,5,6,16.7%,46m
19135,3,[广寒宫]狂傲丶空洞,2213,44,1,6,7,14.3%,1h
19135,2,[DMRc]瓦尔基里之约,2213,0,0,1,1,0.0%,33m
19135,2,[SKTVEC]DNA,2213,0,0,1,1,0.0%,5m
19135,2,[极限菜鸟]国产级菜狗,2213,0,0,1,1,0.0%,56m
19147,1,黑夜骑士,2212,1137,131,136,267,49.1%,1h
19147,2,[南京工业大学]玳瑁,2212,1144,64,60,124,51.6%,16m
19147,2,[NLHR]我的她在他身下,2212,749,27,36,63,42.9%,31m
19147,1,牛霸,2212,444,16,22,38,42.1%,1h
19147,2,ZERO,2212,338,12,9,21,57.1%,23m
19147,2,Leopard,2212,242,8,6,14,57.1%,30m
19147,1,[113]电脑,2212,216,8,7,15,53.3%,49m
19147,1,[雪松]盲人玩家,2212,217,7,10,17,41.2%,27m
19147,2,Leview,2212,114,4,4,8,50.0%,1h
19147,2,谶语,2212,147,4,7,11,36.4%,57m
19147,2,jesse,2212,114,3,1,4,75.0%,56m
19147,1,jia,2212,94,3,3,6,50.0%,1h
19147,2,STUOY,2212,0,3,3,6,50.0%,50m
19147,3,[u1s1]马赛回旋,2212,38,1,2,3,33.3%,1h
19161,2,橘子橘子皮,2211,877,45,38,83,54.2%,39m
19161,1,NEVERLAND,2211,1035,41,49,90,45.6%,21m
19161,2,进化之主,2211,128,4,2,6,66.7%,8m
19161,2,SiborAnju,2211,126,3,3,6,50.0%,1h
19161,2,[萌妹cute]忆雨,2211,30,1,2,3,33.3%,16m
19161,2,我代替我投降,2211,0,1,2,3,33.3%,26m
19167,1,换世门生,2210,1615,108,125,233,46.4%,1h
19167,2,彩虹,2210,827,28,35,63,44.4%,23m
19167,2,方明大傻纸,2210,571,24,27,51,47.1%,1h
19167,1,敌不犯我我不当人,2210,141,5,6,11,45.5%,1h
19167,1,老子就是菜怎么了,2210,170,4,9,13,30.8%,31m
19167,3,llllllllllll,2210,0,1,0,1,100.0%,1h
19167,2,[黑暗葬送者]黑冥魂一幽灵魅,2210,92,1,1,2,50.0%,16m
19167,3,死亡,2210,38,1,3,4,25.0%,1h
19167,2,西瓜君,2210,0,0,1,1,0.0%,51m
19167,2,李氏家族,2210,0,0,1,1,0.0%,23m
19167,1,[北京]直逼勾勾,2210,0,0,2,2,0.0%,1h
19178,3,天柚柚,2209,1533,133,125,258,51.6%,1h
19178,2,AZTZA,2209,1263,110,118,228,48.2%,25m
19178,1,战火风飞,2209,856,42,47,89,47.2%,1h
19178,3,[风起云涌0]skjason,2209,182,7,13,20,35.0%,1h
19178,2,[清华大学战队]七九,2209,148,5,6,11,45.5%,1h
19178,1,无情,2209,193,5,6,11,45.5%,13m
19178,2,[犹豫就会败北]bigboss,2209,128,4,1,5,80.0%,12m
19178,1,yangcheng,2209,143,4,8,12,33.3%,31m
19178,2,阿库娅女神,2209,58,3,3,6,50.0%,17m
19178,1,相思入骨,2209,98,3,5,8,37.5%,35m
19188,2,hismoon,2208,487,19,17,36,52.8%,2m
19188,2,[暴雪零队]霖霄,2208,294,12,12,24,50.0%,57m
19188,3,丿神谕,2208,242,7,10,17,41.2%,1h
19188,2,[兴欣网吧]一叶之秋,2208,154,6,7,13,46.2%,1h
19188,2,[慢手e族]bang,2208,126,4,10,14,28.6%,1h
19188,2,Achilles,2208,97,2,5,7,28.6%,1h
19188,2,ssssssssssss,2208,0,1,0,1,100.0%,1h
19188,2,Hikki,2208,0,1,1,2,50.0%,8m
19188,2,奶布不吃瓜,2208,30,1,1,2,50.0%,42m
19188,2,[DMR]夜雨的黑曜石,2208,46,1,3,4,25.0%,45m
19188,2,牛牛果,2208,0,1,5,6,16.7%,16m
19199,2,铜锣烧,2207,572,24,30,54,44.4%,12m
19199,2,hfchengxx,2207,510,17,23,40,42.5%,23m
19199,2,哈尔希洛,2207,430,15,13,28,53.6%,26m
19199,1,元首大人,2207,247,8,12,20,40.0%,41m
19199,3,[NightL]板凳,2207,209,5,18,23,21.7%,17m
19199,2,Sickle,2207,119,3,1,4,75.0%,13m
19199,1,[专治格种不服]一晚一个东北妞,2207,109,2,5,7,28.6%,15m
19199,1,[菜鸡球带]DSASDADA,2207,0,1,1,2,50.0%,55m
19199,2,队长哈哈哈,2207,46,1,3,4,25.0%,46m
19208,1,[专业单一小组]南瓜,2206,539,20,33,53,37.7%,1h
19208,1,[悬溺堕星河]夜竹星夕,2206,411,9,14,23,39.1%,57m
19208,2,一叶之秋,2206,216,7,5,12,58.3%,46m
19208,1,[透一下清酒]IIIIIIIII,2206,167,4,4,8,50.0%,1h
19208,1,FFFsate,2206,144,3,3,6,50.0%,13m
19208,2,江城我最棒,2206,88,2,0,2,100.0%,39m
19208,2,IMA,2206,0,1,0,1,100.0%,42m
19208,2,阿斯达,2206,30,1,3,4,25.0%,1h
19216,2,虫族专业户,2205,1062,72,64,136,52.9%,2m
19216,3,[NLHR]落日余晖,2205,1407,70,79,149,47.0%,40m
19216,2,[滴滴打人集团]蚩尤大人,2205,608,25,22,47,53.2%,1h
19216,2,叶落枫林,2205,236,10,17,27,37.0%,40m
19216,2,Moment,2205,135,6,5,11,54.5%,54m
19216,3,诠释灬那段情,2205,114,5,15,20,25.0%,20m
19216,1,我是野人王儿子,2205,164,4,0,4,100.0%,16m
19216,2,消逝的锋芒,2205,44,2,7,9,22.2%,1h
19216,3,孤胆剑客,2205,0,2,9,11,18.2%,1h
19225,2,[六骑]黄金猛犸,2204,894,71,80,151,47.0%,42m
19225,2,夜宴,2204,555,25,18,43,58.1%,1h
19225,2,ISE,2204,432,18,23,41,43.9%,1h
19225,2,戴帽子的猫,2204,198,7,5,12,58.3%,42m
19225,1,我是大神,2204,191,5,5,10,50.0%,28m
19225,2,虫群大军永生不息,2204,160,4,9,13,30.8%,7m
19225,2,百里火照,2204,102,2,1,3,66.7%,1h
19225,2,阿飞上校,2204,0,0,1,1,0.0%,1h
19233,1,哈雷克火葬之魔咒,2203,663,56,62,118,47.5%,28m
19233,2,易泪,2203,865,37,34,71,52.1%,26m
19233,2,青灯锁禁天下魂,2203,636,24,31,55,43.6%,57m
19233,2,酱油酱,2203,301,10,9,19,52.6%,1h
19233,1,yhf,2203,203,5,10,15,33.3%,57m
19233,2,ARSO,2203,30,2,0,2,100.0%,23m
19233,2,虎纹鲨鱼,2203,0,1,0,1,100.0%,56m
19233,3,孙博父,2203,0,1,4,5,20.0%,1h
19233,2,[不骄不躁]不放地堡,2203,0,0,1,1,0.0%,1h
19233,2,倒掉,2203,0,0,2,2,0.0%,1h
19243,2,stdio,2202,474,17,17,34,50.0%,24m
19243,2,狡猾,2202,331,12,8,20,60.0%,52m
19243,3,黑翼,2202,232,8,13,21,38.1%,1h
19243,1,飘零半生,2202,0,4,4,8,50.0%,11m
19243,1,[社交学巨可爱]只有影子,2202,189,4,9,13,30.8%,7m
19243,2,Icclin,2202,30,2,1,3,66.7%,8m
19243,1,撷君一缕,2202,0,1,0,1,100.0%,1h
19243,3,[温柔兔公主]llllllllllll,2202,97,1,4,5,20.0%,1h
19243,2,[初音守护二队]花爷,2202,0,0,1,1,0.0%,50m
19243,1,鸟抛花语丸丸落,2202,0,0,3,3,0.0%,55m
19253,2,我得天啊啊啊,2201,454,18,13,31,58.1%,40m
19253,2,灬清风灬,2201,362,13,18,31,41.9%,1h
19253,2,[非洲人民自强]XXXXXX,2201,120,5,6,11,45.5%,1h
19253,1,乱世人魔,2201,191,4,3,7,57.1%,1h
19253,3,[瑞兽]Anonymous,2201,0,3,2,5,60.0%,48m
19253,2,骚扰我必诛之,2201,130,3,3,6,50.0%,57m
19253,2,[最初的星光]谱尼,2201,90,3,6,9,33.3%,24m
19253,1,天使落凡尘,2201,96,3,11,14,21.4%,34m
19253,2,浩哥,2201,30,2,2,4,50.0%,1h
19253,2,天漠系居居,2201,0,1,5,6,16.7%,21m
19253,2,屠杀仙女姐姐,2201,0,0,1,1,0.0%,18m
19253,2,哥哥带我飞,2201,0,0,2,2,0.0%,57m
19265,2,Luciferre,2200,337,14,13,27,51.9%,1h
19265,1,寂渊,2200,286,7,10,17,41.2%,55m
19265,2,MMYW,2200,109,2,1,3,66.7%,50m
19265,2,joker,2200,60,2,4,6,33.3%,5m
19265,2,Christopher,2200,0,1,1,2,50.0%,1h
19265,2,甘之若饴,2200,0,0,1,1,0.0%,1h
19271,2,河南因脑为什,2199,306,11,8,19,57.9%,1h
19271,2,[第三駆逐鑑隊]孤独,2199,318,11,11,22,50.0%,17m
19271,2,[神龍鬥士]九九天,2199,218,7,16,23,30.4%,57m
19271,1,HJZ,2199,197,4,6,10,40.0%,3m
19271,2,方舟,2199,60,3,3,6,50.0%,42m
19271,2,爬虫,2199,0,1,0,1,100.0%,1h
19271,3,蛇皮,2199,0,1,0,1,100.0%,1h
19271,2,[帝都战神]Jimleinuo,2199,0,1,6,7,14.3%,5m
19271,2,殺習金,2199,90,1,6,7,14.3%,21m
19271,1,tnight,2199,0,0,1,1,0.0%,31m
19271,2,戈壁狼,2199,0,0,1,1,0.0%,45m
19282,2,开花麻酱,2198,243,7,12,19,36.8%,51m
19282,1,LKMKM,2198,136,5,10,15,33.3%,51m
19282,1,黄铀猫,2198,143,4,3,7,57.1%,1h
19282,2,Death,2198,102,2,1,3,66.7%,1h
19282,2,酷酷的小禹哥哥,2198,60,2,3,5,40.0%,23m
19282,2,奇迹,2198,0,1,3,4,25.0%,1h
19288,2,桐谷和人,2197,1379,68,79,147,46.3%,1h
19288,2,开开,2197,156,4,4,8,50.0%,1h
19288,2,AugustinusBB,2197,108,2,3,5,40.0%,1h
19288,1,雪姬,2197,105,2,4,6,33.3%,3m
19288,2,来我白给,2197,74,2,5,7,28.6%,8m
19288,2,van,2197,0,1,0,1,100.0%,1h
19288,2,艾尔永恒,2197,0,1,2,3,33.3%,1h
19288,1,[完了卡人口了]那咋整啊,2197,0,1,7,8,12.5%,1h
19296,3,猥琐不玩,2196,1562,390,414,804,48.5%,31m
19296,2,冠状病毒,2196,1042,64,56,120,53.3%,23m
19296,3,[小黄人]满村就我不会玩,2196,384,13,31,44,29.5%,1h
19296,3,二爷,2196,238,8,16,24,33.3%,11m
19296,2,Temptation,2196,178,6,5,11,54.5%,1h
19296,2,lmx,2196,160,4,6,10,40.0%,54m
19296,2,兽医,2196,93,3,3,6,50.0%,2m
19296,2,寒流,2196,93,3,4,7,42.9%,44m
19296,2,黎明之刃,2196,44,2,1,3,66.7%,1h
19296,3,llllllllllll,2196,30,2,14,16,12.5%,9m
19296,1,九天风湖,2196,95,1,4,5,20.0%,1h
19307,1,傲世鬼才,2195,921,79,91,170,46.5%,1h
19307,1,大芳香脚,2195,1129,53,49,102,52.0%,24m
19307,2,cainingluan,2195,626,22,21,43,51.2%,13m
19307,2,kojhsiuq,2195,453,15,15,30,50.0%,1h
19307,1,阴影,2195,384,13,14,27,48.1%,58m
19307,2,欢迎来到祖安,2195,300,11,15,26,42.3%,56m
19307,2,聚羽为花,2195,155,5,2,7,71.4%,42m
19307,1,[尤摩扬护国队]Alarak,2195,137,3,4,7,42.9%,1h
19307,2,小刀女王,2195,0,1,1,2,50.0%,1h
19307,2,[C17079]PluKevin,2195,0,0,1,1,0.0%,1h
19307,2,MIANSSE,2195,0,0,2,2,0.0%,1h
19307,2,ahuan,2195,0,0,2,2,0.0%,50m
19307,1,吊炸天了你知道吗,2195,0,0,4,4,0.0%,11m
19320,1,[混元体我女仆]笨笨喂你吃糖糖,2194,294,11,20,31,35.5%,11m
19320,2,地藏,2194,242,10,13,23,43.5%,50m
19320,2,necoarc,2194,260,7,8,15,46.7%,1h
19320,2,[鲲之大]宇之可恋,2194,0,1,5,6,16.7%,1h
19320,2,[Dameng]仲夏夜的梦,2194,0,0,4,4,0.0%,30m
19325,2,MojiaLzy,2193,587,37,34,71,52.1%,3m
19325,2,剑皇道一,2193,549,20,23,43,46.5%,1h
19325,2,重返星际,2193,200,15,15,30,50.0%,1h
19325,1,INnoVation,2193,242,5,8,13,38.5%,1h
19329,2,雷霆嘎巴,2192,567,25,25,50,50.0%,1h
19329,1,随鸡硬变,2192,527,19,25,44,43.2%,1h
19329,3,海拉鲁老流氓,2192,302,12,11,23,52.2%,53m
19329,1,[麻酱罐]未完木偶,2192,247,7,10,17,41.2%,13m
19329,2,[梨花与浅月]浅月落幽,2192,163,4,2,6,66.7%,1h
19329,1,[企鹅物流]多来,2192,144,4,11,15,26.7%,27m
19329,2,凯爷快乐星际,2192,0,1,4,5,20.0%,1h
19329,3,aaa,2192,0,0,5,5,0.0%,49m
19337,2,无影,2191,975,88,101,189,46.6%,1h
19337,2,[柠檬保护协会]斗鱼狼轩,2191,540,22,20,42,52.4%,57m
19337,1,yjmassey,2191,259,7,7,14,50.0%,1h
19337,2,[我笑你阿巴阿]帅哥来了,2191,86,3,4,7,42.9%,8m
19337,3,天际浮云,2191,0,1,1,2,50.0%,7m
19337,2,NANAN,2191,0,1,2,3,33.3%,1h
19337,1,bluesculptur,2191,0,1,4,5,20.0%,51m
19337,2,攻势级战裂舰,2191,0,1,5,6,16.7%,16m
19337,2,一坨黄皮耗子,2191,0,0,1,1,0.0%,1h
19346,2,四代邦尼,2190,1572,58,65,123,47.2%,1h
19346,2,snoppy,2190,684,26,29,55,47.3%,51m
19346,1,[欧巴亚希]最爱学姐,2190,0,4,6,10,40.0%,11m
19346,3,西风狂诗曲,2190,73,3,4,7,42.9%,1h
19346,2,[和平发育行不]moonquakes,2190,0,0,1,1,0.0%,1h
19351,2,[NLHR]战任,2189,1366,96,98,194,49.5%,1h
19351,1,fdstged,2189,197,5,8,13,38.5%,1h
19351,2,[镜花水月]徐大爷,2189,0,4,2,6,66.7%,56m
19351,2,暮光,2189,88,2,0,2,100.0%,57m
19351,1,Mose,2189,48,1,9,10,10.0%,1h
19351,2,llllllllllll,2189,0,0,1,1,0.0%,30m
19357,1,Miraculum,2188,1096,135,142,277,48.7%,1h
19357,3,UstudentZ,2188,307,12,26,38,31.6%,1h
19357,1,山东舰,2188,304,8,14,22,36.4%,1h
19357,2,[十月]楚木,2188,170,5,6,11,45.5%,24m
19357,2,xiaoyao,2188,88,1,1,2,50.0%,1h
19357,2,冬瓜酋长,2188,46,1,4,5,20.0%,1h
19357,2,[镜花水月丨]VOX,2188,0,0,1,1,0.0%,5m
19357,2,shy,2188,0,0,1,1,0.0%,57m
19365,2,[KCCO]搞事情的小周,2187,792,32,32,64,50.0%,7m
19365,2,神主殿下,2187,442,16,18,34,47.1%,1h
19365,2,抵制星际,2187,388,14,15,29,48.3%,11m
19365,1,[LNC]ZEEK,2187,468,14,23,37,37.8%,1h
19365,1,[Mikon]没人气的咕哒夫,2187,268,12,2,14,85.7%,16m
19365,2,[PinkS]PinkSCV,2187,116,4,6,10,40.0%,1h
19365,2,jack,2187,0,1,1,2,50.0%,1h
19365,2,[蔷薇之石]dfggh,2187,88,1,1,2,50.0%,40m
19365,2,精灵龙,2187,93,1,2,3,33.3%,1h
19365,3,照烧酱,2187,0,1,6,7,14.3%,14m
19365,3,FullTKJacket,2187,0,0,1,1,0.0%,1h
19365,2,斗圣强者,2187,0,0,1,1,0.0%,5m
19365,2,[Chiken]也曾痴笑流泪惊醒,2187,0,0,2,2,0.0%,18m
19378,2,[TAPC]TITANS,2186,606,33,35,68,48.5%,18m
19378,2,FINGER,2186,196,7,18,25,28.0%,1h
19378,3,寒朝,2186,62,4,11,15,26.7%,1h
19378,3,[诡诈]诡诈,2186,0,2,8,10,20.0%,1h
19382,2,九月的风,2185,1305,47,52,99,47.5%,1h
19382,3,我来咬你了哈哈哈,2185,290,11,8,19,57.9%,1h
19382,3,Please,2185,219,9,1,10,90.0%,1h
19382,2,qinzhi,2185,171,6,5,11,54.5%,7m
19382,1,[TSR]紫林枫,2185,140,4,4,8,50.0%,28m
19382,3,超可爱的虫族,2185,0,4,8,12,33.3%,1h
19382,3,[花店]神王,2185,48,3,3,6,50.0%,42m
19382,2,yellowsmoke,2185,36,3,5,8,37.5%,16m
19382,1,阿巴瑟,2185,46,1,1,2,50.0%,15m
19382,3,BTCtotheMoon,2185,0,0,1,1,0.0%,1h
19392,1,[神圣纪元]皮特洛,2184,305,27,34,61,44.3%,14m
19392,2,执政,2184,396,14,21,35,40.0%,33m
19392,1,[织田家的]Anyway,2184,278,6,5,11,54.5%,1h
19392,2,Bishop,2184,114,2,3,5,40.0%,16m
19392,3,[loOoOL]StevenG,2184,36,2,3,5,40.0%,1h
19392,2,潜行之鲷,2184,0,1,0,1,100.0%,1h
19392,2,陨落星辰,2184,0,0,2,2,0.0%,23m
19392,3,铁甲骑士,2184,0,0,3,3,0.0%,42m
19400,3,IIIIIIIIIIII,2183,352,12,7,19,63.2%,31m
19400,2,老年选手玩情怀,2183,312,12,9,21,57.1%,31m
19400,3,Ironman,2183,34,1,1,2,50.0%,7m
19400,3,青鸟火星,2183,0,0,1,1,0.0%,7m
19400,2,雷姆丿酱,2183,0,0,3,3,0.0%,1h
19405,2,彡陌路离殇彡,2182,134,6,9,15,40.0%,31m
19405,3,星际穿越,2182,86,3,1,4,75.0%,55m
19405,3,[社交学超可爱]是非慈悲,2182,34,1,1,2,50.0%,1h
19405,2,JunDi,2182,0,0,3,3,0.0%,16m
19405,3,[底特律KAR]Scalpel,2182,0,0,4,4,0.0%,1h
19410,2,慕容紫宸,2181,1312,53,58,111,47.7%,1h
19410,1,星宇,2181,0,3,12,15,20.0%,1h
19410,2,尽梨了,2181,18,2,7,9,22.2%,11m
19410,1,舔下霸娼,2181,0,1,1,2,50.0%,1h
19414,1,[鸡家军]CatalChao,2180,1283,157,165,322,48.8%,29m
19414,3,比戈蒙斯特,2180,0,4,1,5,80.0%,1h
19414,2,久远,2180,46,2,6,8,25.0%,1h
19417,1,king,2179,483,24,28,52,46.2%,1h
19417,2,乌金,2179,365,14,11,25,56.0%,1h
19417,1,ZooNrSClavie,2179,256,10,8,18,55.6%,27m
19417,2,古怪之裤子,2179,139,3,7,10,30.0%,28m
19417,3,情书,2179,30,1,1,2,50.0%,1h
19417,3,南柯一梦丶,2179,0,1,4,5,20.0%,26m
19417,3,猩猩爵士,2179,0,0,1,1,0.0%,11m
19417,3,IIIIIIIIIIII,2179,0,0,1,1,0.0%,42m
19417,3,MOM,2179,0,0,4,4,0.0%,1h
19426,2,暴风之龙,2178,858,48,54,102,47.1%,1h
19426,3,[云师三骚]被绿了吗,2178,809,42,40,82,51.2%,42m
19426,1,胜者为王,2178,893,31,40,71,43.7%,1h
19426,2,[高数的关爱]nbsw,2178,547,21,21,42,50.0%,3m
19426,2,随心而动,2178,276,10,11,21,47.6%,1h
19426,2,ilili,2178,109,2,6,8,25.0%,1h
19426,2,djaslkjd,2178,0,1,1,2,50.0%,50m
19426,3,QWBB,2178,0,1,4,5,20.0%,1h
19426,3,dnmajhjdh,2178,0,0,1,1,0.0%,1h
19435,2,赤情已是修念,2177,1190,52,42,94,55.3%,1h
19435,1,您别急来打后期,2177,819,34,36,70,48.6%,1h
19435,2,[2233娘]figo,2177,114,3,2,5,60.0%,1h
19435,2,[超电磁炉]绘梨衣,2177,0,3,4,7,42.9%,1h
19435,2,[追猎人]hhxj,2177,30,2,2,4,50.0%,1h
19435,3,[DMR]candy,2177,30,1,1,2,50.0%,15m
19435,2,小白菜,2177,30,1,3,4,25.0%,1h
19442,2,aeio,2176,1146,44,44,88,50.0%,1h
19442,2,穆溪,2176,833,33,26,59,55.9%,57m
19442,1,beckylee,2176,630,26,30,56,46.4%,53m
19442,1,zichen,2176,598,21,35,56,37.5%,28m
19442,1,天之河,2176,167,6,7,13,46.2%,11m
19442,2,农夫山泉有点甜,2176,208,5,8,13,38.5%,44m
19442,2,jia,2176,135,3,2,5,60.0%,1h
19442,1,[白银联盟]王的力量,2176,0,1,0,1,100.0%,28m
19442,2,全都给爷爬,2176,97,1,4,5,20.0%,1h
19442,3,[OB丶]上海萌兔,2176,0,0,1,1,0.0%,1h
19442,3,[CcW]她眼中深藏温柔,2176,0,0,1,1,0.0%,1h
19453,2,死神霍安安,2175,314,50,51,101,49.5%,3m
19453,1,神楽七奈,2175,119,3,9,12,25.0%,1h
19453,3,Lucas,2175,30,2,0,2,100.0%,56m
19453,3,柳絮,2175,34,1,5,6,16.7%,60m
19453,3,[Months]花花公子,2175,0,0,1,1,0.0%,27m
19453,2,苍白,2175,0,0,2,2,0.0%,24m
19459,2,此生虚度年华,2174,271,19,19,38,50.0%,1h
19459,1,苍澜星寒,2174,153,5,1,6,83.3%,1h
19459,2,龙城狂霸拽少,2174,160,5,7,12,41.7%,8m
19459,3,是你的可爱多,2174,122,4,5,9,44.4%,11m
19459,2,狱丶火,2174,139,3,7,10,30.0%,1h
19459,2,imbalance,2174,44,2,1,3,66.7%,1h
19459,2,Gary,2174,60,2,10,12,16.7%,1h
19459,3,[呼叫舰队按2]隐的不是身是寂寞,2174,30,1,1,2,50.0%,1h
19467,2,[CUGer]uwyuwdqy,2173,1240,46,53,99,46.5%,1h
19467,1,与之爽爽,2173,245,7,11,18,38.9%,31m
19467,2,黯灭焰,2173,178,6,12,18,33.3%,1h
19467,3,剑来,2173,0,2,3,5,40.0%,1h
19467,1,中国的玩家的未来,2173,0,1,1,2,50.0%,51m
19467,3,那一瞬间,2173,0,0,1,1,0.0%,1h
19467,3,阿东,2173,0,0,1,1,0.0%,1h
19474,2,若月,2172,814,36,41,77,46.8%,31m
19474,2,Fredrica,2172,332,14,16,30,46.7%,1h
19474,1,Kenxzn,2172,152,7,7,14,50.0%,1h
19474,1,此生绝非打工人,2172,239,7,11,18,38.9%,57m
19474,1,[慢手e族]TUT,2172,139,3,2,5,60.0%,1h
19474,3,Flug,2172,38,3,10,13,23.1%,14m
19474,2,[好爷爷]跟兄弟打星际,2172,0,1,0,1,100.0%,44m
19474,2,宗师之鹰,2172,0,0,1,1,0.0%,1h
19482,2,白音白音白,2171,607,22,20,42,52.4%,9m
19482,2,小反弹,2171,227,9,6,15,60.0%,16m
19482,2,Manifesto,2171,126,4,2,6,66.7%,13m
19482,3,新年好可爱小迷妹,2171,30,2,0,2,100.0%,1h
19482,3,[温柔兔公主]小雨子,2171,0,0,1,1,0.0%,58m
19482,2,Poppy,2171,0,0,4,4,0.0%,1h
19488,2,aiscoke,2170,737,36,34,70,51.4%,11m
19488,2,dawn,2170,313,12,12,24,50.0%,23m
19488,1,aaaaaaaa,2170,324,12,16,28,42.9%,1h
19488,1,六把尺子,2170,284,10,13,23,43.5%,1h
19488,2,Zoeforheart,2170,0,1,6,7,14.3%,50m
19488,3,restp,2170,0,0,5,5,0.0%,1h
19494,2,ertw,2169,1540,109,119,228,47.8%,1h
19494,2,Ysb,2169,602,26,22,48,54.2%,56m
19494,1,habbby,2169,173,5,4,9,55.6%,57m
19494,2,胡汉三,2169,91,4,2,6,66.7%,23m
19494,2,张小花,2169,74,3,1,4,75.0%,1h
19494,2,TSG,2169,40,2,4,6,33.3%,5m
19494,3,躺见鲲,2169,0,1,0,1,100.0%,42m
19494,2,[YM]SprinG,2169,30,1,5,6,16.7%,16m
19494,2,[泰伦征兵中心]不明伯爵,2169,96,1,6,7,14.3%,16m
19494,2,[PTR]Mht,2169,0,0,2,2,0.0%,33m
19504,1,洛梵天丶,2168,224,5,6,11,45.5%,1h
19504,2,nightmare,2168,188,5,8,13,38.5%,1h
19504,2,[猫狗大队]藜藜姬,2168,102,3,3,6,50.0%,1h
19504,2,费奇默,2168,30,1,5,6,16.7%,18m
19508,2,innovation,2167,411,16,16,32,50.0%,24m
19508,1,小魔王,2167,285,8,12,20,40.0%,1h
19508,3,入戏太深,2167,0,1,0,1,100.0%,1h
19508,2,咸鱼王,2167,46,1,4,5,20.0%,55m
19508,3,苏维埃联邦,2167,0,0,1,1,0.0%,1h
19508,3,[菜有菜的道理]农夫一拳,2167,0,0,1,1,0.0%,1h
19514,3,King,2166,262,10,6,16,62.5%,56m
19514,2,[孫红雷]卡卡罗特,2166,218,6,16,22,27.3%,1h
19514,2,劲夫劲夫,2166,118,3,3,6,50.0%,1h
19514,2,无限,2166,112,3,7,10,30.0%,1h
19514,2,维克多雨果,2166,0,1,2,3,33.3%,39m
19514,2,梵蒂冈的雕像,2166,0,1,6,7,14.3%,1h
19514,1,[为了天下核平]SCV,2166,0,0,1,1,0.0%,28m
19514,2,[1VA]MagicProtoss,2166,0,0,2,2,0.0%,5m
19522,2,Ehud,2165,1048,41,40,81,50.6%,1h
19522,3,[瑞兽]WSLSP,2165,118,4,4,8,50.0%,1h
19522,2,秀起来呐,2165,42,4,5,9,44.4%,1h
19522,1,miku,2165,117,2,4,6,33.3%,5m
19522,2,[国际巨星]天赐,2165,0,1,6,7,14.3%,23m
19522,2,何贱贱,2165,0,0,2,2,0.0%,1h
19522,2,ZGNB,2165,0,0,2,2,0.0%,1h
19529,2,[薄暮之光]我爱一波流,2164,367,33,59,92,35.9%,10m
19529,2,LYB,2164,120,6,8,14,42.9%,1h
19529,2,Mrs,2164,88,3,4,7,42.9%,7m
19529,3,[爱哭一把泪]Fenchnotes,2164,30,2,2,4,50.0%,11m
19529,2,我的虫虫不打前期,2164,0,1,4,5,20.0%,1h
19529,3,墨染之樱,2164,36,1,4,5,20.0%,13m
19529,1,空想,2164,0,1,7,8,12.5%,1h
19529,3,风中少年,2164,0,0,1,1,0.0%,42m
19537,2,Sam,2163,520,18,17,35,51.4%,26m
19537,1,波林高手,2163,97,4,7,11,36.4%,1h
19537,1,[wryyy]fvjes,2163,115,3,8,11,27.3%,3m
19537,1,SAS,2163,0,1,7,8,12.5%,1h
19541,2,涂山苏苏,2162,42,4,5,9,44.4%,54m
19541,1,隐存,2162,96,2,5,7,28.6%,3m
19541,2,fdad,2162,36,1,4,5,20.0%,1h
19541,2,ZHIQIN,2162,94,1,4,5,20.0%,1h
19541,3,[干就完事]没落丶瞄,2162,0,0,1,1,0.0%,1h
19541,3,枳景,2162,0,0,1,1,0.0%,1h
19541,3,[低调骑士团]我好像叫宫方,2162,0,0,1,1,0.0%,1h
19541,3,superkennyXD,2162,0,0,2,2,0.0%,11m
19541,2,烈冰玄武,2162,0,0,5,5,0.0%,1h
19550,3,llllllllllll,2161,738,38,49,87,43.7%,1h
19550,3,烟雨,2161,146,6,3,9,66.7%,15m
19550,3,Jat,2161,40,1,2,3,33.3%,1h
19550,3,jiangguangyi,2161,30,1,3,4,25.0%,1h
19554,2,yfdterhrg,2160,800,36,27,63,57.1%,1h
19554,1,老爱,2160,328,19,21,40,47.5%,1h
19554,1,歪歪,2160,264,7,8,15,46.7%,40m
19554,2,blaze,2160,44,4,3,7,57.1%,21m
19554,3,黄指导,2160,86,3,2,5,60.0%,1h
19554,2,狂怒,2160,30,2,4,6,33.3%,18m
19554,2,lwffksj,2160,40,1,1,2,50.0%,50m
19554,3,Rex,2160,0,0,1,1,0.0%,42m
19554,3,GAM,2160,0,0,1,1,0.0%,56m
19554,3,让你先冲,2160,0,0,5,5,0.0%,43m
19564,2,稻道盗,2159,1267,98,97,195,50.3%,13m
19564,2,Silence,2159,1498,57,62,119,47.9%,1h
19564,1,大头董董,2159,1435,53,64,117,45.3%,1h
19564,3,[沙皇政权]erwe,2159,769,30,30,60,50.0%,37m
19564,2,ZiHomeIIIIII,2159,407,15,19,34,44.1%,1h
19564,2,ETgame,2159,0,3,4,7,42.9%,54m
19564,1,瑾丶凉,2159,0,1,0,1,100.0%,1h
19564,3,[四斋蒸蚝片]Hologram,2159,34,1,5,6,16.7%,43m
19564,3,躺着混,2159,0,0,2,2,0.0%,42m
19564,2,柠檬芦荟,2159,0,0,2,2,0.0%,50m
19564,2,卡死我了,2159,0,0,2,2,0.0%,16m
19564,2,HansKatze,2159,0,0,5,5,0.0%,1h
19576,3,winstonwang,2158,318,11,15,26,42.3%,1h
19576,1,恰逢山诉闲,2158,244,6,6,12,50.0%,31m
19576,1,深海鲨鱼王,2158,133,3,7,10,30.0%,5m
19576,1,田小鸡,2158,48,3,9,12,25.0%,1h
19576,3,DJKK,2158,0,1,1,2,50.0%,48m
19576,2,[美国黑人的命]白银之鹰,2158,0,1,1,2,50.0%,57m
19576,2,dad,2158,0,1,6,7,14.3%,1h
19576,2,战魂星焰,2158,0,0,2,2,0.0%,40m
19576,2,阿拉蕾,2158,0,0,3,3,0.0%,1h
19585,2,来辆劳斯莱斯,2157,440,16,21,37,43.2%,58m
19585,2,trhuqq,2157,400,14,19,33,42.4%,6m
19585,2,[灰玖]玖狸,2157,106,2,2,4,50.0%,55m
19585,1,tianling,2157,44,2,4,6,33.3%,1h
19585,2,执政官,2157,118,2,6,8,25.0%,54m
19585,3,一朵相似的花,2157,0,0,2,2,0.0%,58m
19591,2,浅川尘,2156,1083,45,47,92,48.9%,52m
19591,2,星呈,2156,134,4,11,15,26.7%,56m
19591,3,guxi,2156,0,3,3,6,50.0%,13m
19591,1,卡拉森,2156,145,3,10,13,23.1%,1h
19591,2,幻灵雪,2156,86,2,3,5,40.0%,44m
19591,3,cissylol,2156,0,0,2,2,0.0%,1h
19597,2,奇葩文学,2155,1494,89,100,189,47.1%,57m
19597,2,电脑一简单难度,2155,265,29,32,61,47.5%,1h
19597,2,狂少时光,2155,688,25,27,52,48.1%,40m
19597,3,Dracula,2155,324,11,9,20,55.0%,1h
19597,3,疯狂的芒果,2155,298,11,10,21,52.4%,1h
19597,3,[Rhusky]Shino,2155,265,10,11,21,47.6%,1h
19597,2,Innovation,2155,160,5,10,15,33.3%,1h
19597,2,[透一下清酒]不能的许愿机,2155,114,4,5,9,44.4%,1h
19597,2,虫群之心,2155,46,2,7,9,22.2%,1h
19597,2,小河兔,2155,0,1,2,3,33.3%,55m
19597,3,小老虎,2155,30,1,3,4,25.0%,1h
19597,2,勇气人族,2155,93,1,5,6,16.7%,1h
19597,3,拗不过时光的荏苒,2155,0,0,1,1,0.0%,58m
19610,3,忧丶零少,2154,519,20,22,42,47.6%,1h
19610,2,拜金瓦莎克,2154,581,20,28,48,41.7%,18m
19610,3,AlohaII,2154,162,7,18,25,28.0%,11m
19610,2,炽天使,2154,212,6,8,14,42.9%,7m
19610,2,观察者,2154,95,3,5,8,37.5%,54m
19610,3,[埃蒙帝国]雷诺指挥官,2154,60,2,4,6,33.3%,53m
19610,3,派大蒙,2154,58,2,4,6,33.3%,1h
19610,2,奇迹,2154,0,1,6,7,14.3%,16m
19610,3,[迅哥儿]cdp,2154,0,0,1,1,0.0%,13m
19610,3,祈祷她被温柔所爱,2154,0,0,3,3,0.0%,1h
19620,2,为你扫天下,2153,1034,50,43,93,53.8%,39m
19620,3,[极限菜鸟]杀破天,2153,273,10,16,26,38.5%,1h
19620,2,Rey,2153,143,7,8,15,46.7%,1h
19620,2,nothing,2153,136,3,7,10,30.0%,57m
19620,3,[KPG2]电竞蔡徐坤,2153,0,1,4,5,20.0%,1h
19620,2,Nidhogg,2153,0,0,1,1,0.0%,16m
19626,2,[Micer]Daguanren,2152,569,37,37,74,50.0%,1h
19626,2,医生姐姐,2152,430,19,25,44,43.2%,1h
19626,3,炸鱼狗素质真差,2152,0,5,0,5,100.0%,1h
19626,3,Eason,2152,120,5,4,9,55.6%,58m
19626,2,AWM,2152,0,1,0,1,100.0%,28m
19626,2,[XXHZ35]Jones,2152,44,1,3,4,25.0%,55m
19626,2,nssdyx,2152,0,1,6,7,14.3%,50m
19626,1,[基金会]轻狂书生,2152,0,0,3,3,0.0%,1h
19634,2,dragoonzheng,2151,315,12,14,26,46.2%,39m
19634,2,让心灵去旅行,2151,151,7,6,13,53.8%,1h
19634,2,Greenday,2151,90,4,5,9,44.4%,1h
19634,3,Lovetf,2151,86,3,2,5,60.0%,1h
19634,1,[听雨轩]西风瘦马,2151,0,3,5,8,37.5%,47m
19634,2,树街猫,2151,112,2,6,8,25.0%,1h
19634,3,[破灭]siopr,2151,0,0,2,2,0.0%,1h
19641,1,[XXHZN3]遥远的桥,2150,633,49,63,112,43.8%,41m
19641,3,LPDAL,2150,456,16,15,31,51.6%,54m
19641,2,玄苍觞,2150,298,10,14,24,41.7%,1h
19641,2,hhhh,2150,30,2,4,6,33.3%,1h
19641,3,[XXHZ30]艾雪,2150,0,1,1,2,50.0%,42m
19641,1,[训练模式电脑]二号飞车酱,2150,48,1,7,8,12.5%,15m
19641,1,[峰吹起了过去]星际启示者,2150,0,0,2,2,0.0%,5m
19648,2,六角螺钉小扳手,2149,996,69,58,127,54.3%,50m
19648,1,泷十八,2149,280,7,10,17,41.2%,11m
19648,1,嗯哼,2149,136,5,11,16,31.2%,10m
19648,3,效原,2149,80,3,5,8,37.5%,60m
19648,3,你比书好看,2149,30,2,0,2,100.0%,42m
19648,3,RiderStr,2149,0,1,1,2,50.0%,1h
19654,3,羽毛,2148,273,22,25,47,46.8%,22m
19654,3,耶稣都救不了,2148,295,9,5,14,64.3%,53m
19654,2,ease,2148,152,6,8,14,42.9%,1h
19654,2,[镜花水月丶]人族天下第一,2148,92,1,6,7,14.3%,1h
19654,3,zxh,2148,0,0,1,1,0.0%,1h
19654,3,我知道我们不合适,2148,0,0,5,5,0.0%,1h
19660,2,[小鸡屠宰场3]天方墟,2147,46,3,3,6,50.0%,1h
19660,1,[六道]ENT,2147,104,3,16,19,15.8%,1h
19660,3,leon,2147,0,0,1,1,0.0%,1h
19660,3,[日月神教]clearlove,2147,0,0,1,1,0.0%,27m
19664,2,卡萨落,2146,850,31,42,73,42.5%,1h
19664,3,贱骨头,2146,375,12,16,28,42.9%,1h
19664,2,天上的声名,2146,303,10,18,28,35.7%,50m
19664,2,敬汝一壶酒,2146,119,2,7,9,22.2%,23m
19664,3,敷衍,2146,0,1,0,1,100.0%,54m
19664,3,vincenta,2146,0,1,4,5,20.0%,41m
19664,3,咕叽咕叽,2146,0,0,2,2,0.0%,1h
19671,2,菜啊,2145,322,34,33,67,50.7%,58m
19671,2,战狼飞翔的提伯斯,2145,581,19,21,40,47.5%,1h
19671,2,银角大王,2145,338,11,19,30,36.7%,1h
19671,1,[琴筝]Shidi,2145,261,6,8,14,42.9%,3m
19671,3,上官静儿,2145,86,4,3,7,57.1%,1h
19671,2,燃烧我的卡路里,2145,152,4,5,9,44.4%,45m
19671,1,呼啦啦小樱桃,2145,144,4,13,17,23.5%,6m
19671,2,无知,2145,120,2,7,9,22.2%,17m
19671,2,兔子的豆子,2145,62,2,9,11,18.2%,40m
19671,3,记忆昨天,2145,30,1,4,5,20.0%,58m
19671,2,不讲五德,2145,0,1,6,7,14.3%,16m
19682,2,衣带沾花,2144,1531,60,57,117,51.3%,1h
19682,2,箫声桀,2144,527,34,34,68,50.0%,1h
19682,1,xDusty,2144,283,8,15,23,34.8%,1h
19682,3,[底特律KAR]香蕉君,2144,36,3,11,14,21.4%,46m
19682,2,[1年3班]Alexmercer,2144,77,2,2,4,50.0%,3m
19682,2,灰色的猫,2144,0,1,6,7,14.3%,50m
19682,3,[自由的气息]瘪四,2144,0,0,1,1,0.0%,1h
19682,3,迷失光谱,2144,0,0,2,2,0.0%,1h
19682,3,Byboy,2144,0,0,5,5,0.0%,1h
19691,3,站在我后面,2143,696,41,34,75,54.7%,43m
19691,3,冥嗜,2143,154,19,30,49,38.8%,43m
19691,1,RRxh,2143,193,4,11,15,26.7%,16m
19691,3,epicevent,2143,111,3,0,3,100.0%,1h
19691,3,Gaspanic,2143,0,1,0,1,100.0%,14m
19696,2,吾问无为谓,2142,455,15,22,37,40.5%,7m
19696,2,九尾凶猫,2142,214,7,16,23,30.4%,1h
19696,1,温州舞王,2142,97,2,8,10,20.0%,32m
19696,3,MOLE,2142,0,0,1,1,0.0%,11m
19696,3,MBOMBE,2142,0,0,1,1,0.0%,14m
19701,1,可乐粑粑,2141,354,16,28,44,36.4%,59m
19701,2,[滴滴打人集团]风林火山,2141,126,5,8,13,38.5%,1h
19701,3,一个瞎子,2141,86,4,0,4,100.0%,37m
19701,2,Nod,2141,145,3,6,9,33.3%,57m
19701,3,爸爸,2141,0,0,1,1,0.0%,55m
19701,3,源之侍,2141,0,0,1,1,0.0%,1h
19701,2,沐白苏,2141,0,0,2,2,0.0%,21m
19708,2,DIE,2140,667,25,24,49,51.0%,1h
19708,1,littlebead,2140,199,6,4,10,60.0%,1h
19708,2,空虚者,2140,206,5,14,19,26.3%,8m
19708,3,[我队伍很强大]冥天,2140,66,3,1,4,75.0%,18m
19708,3,晚安记得早睡,2140,30,2,0,2,100.0%,1h
19708,3,艾达,2140,0,0,2,2,0.0%,1h
19708,2,ghjdfjdj,2140,0,0,2,2,0.0%,46m
19715,2,三五八团楚云飞,2139,625,25,19,44,56.8%,3m
19715,2,[天门]你将如闪电般归来,2139,81,4,5,9,44.4%,1h
19715,3,柳然,2139,0,1,0,1,100.0%,54m
19715,2,世界,2139,94,1,2,3,33.3%,1h
19715,1,Dreamdead,2139,42,1,9,10,10.0%,29m
19720,2,落月,2138,970,30,42,72,41.7%,7m
19720,3,八级大狂风,2138,60,3,1,4,75.0%,1h
19720,3,oven,2138,74,2,7,9,22.2%,1h
19720,1,xibo,2138,0,1,0,1,100.0%,28m
19720,3,[萝莉保护会]陌璃,2138,0,1,0,1,100.0%,1h
19720,3,Jimmy,2138,0,1,0,1,100.0%,1h
19720,3,喝辣哥,2138,34,1,1,2,50.0%,1h
19720,2,琪实我爱你,2138,0,1,2,3,33.3%,1h
19720,3,[暴雪零队]SuperHero,2138,0,0,1,1,0.0%,1h
19720,3,随心,2138,0,0,5,5,0.0%,41m
19730,1,福星小陈,2137,1046,136,136,272,50.0%,1h
19730,2,一只树奈奈,2137,319,13,19,32,40.6%,1h
19730,2,秋米,2137,74,4,9,13,30.8%,1h
19730,2,夺命白给怪,2137,160,3,1,4,75.0%,44m
19730,3,[亲本回头]时影,2137,30,2,0,2,100.0%,11m
19730,3,逐鹿云梦丿,2137,0,0,1,1,0.0%,1h
19730,3,YAN,2137,0,0,3,3,0.0%,43m
19737,3,Gabrielawe,2136,0,1,1,2,50.0%,1h
19737,2,桃奈一,2136,44,1,5,6,16.7%,1h
19737,3,BiancaSofia,2136,0,0,2,2,0.0%,16m
19737,2,打死小强,2136,0,0,3,3,0.0%,1h
19741,2,[瑶瑶公主]MAXFury,2135,1178,53,51,104,51.0%,8m
19741,3,[优信]优信集团优信集团,2135,30,2,3,5,40.0%,3m
19741,3,[琴筝]骚哥,2135,0,1,0,1,100.0%,3m
19741,3,[INS48]卑鄙的老母鸡,2135,0,0,1,1,0.0%,1h
19741,3,[一起犯罪]究极炼铜之王,2135,0,0,1,1,0.0%,1h
19746,3,勿忘,2134,438,16,16,32,50.0%,1h
19746,3,小飞鼠,2134,86,4,2,6,66.7%,42m
19746,3,[镜花水月丶]阿塔尼斯,2134,30,1,4,5,20.0%,42m
19749,3,叶凌风,2133,774,29,36,65,44.6%,1h
19749,1,DIEU,2133,525,25,34,59,42.4%,58m
19749,2,ppsuc,2133,74,5,6,11,45.5%,1h
19749,3,dhp,2133,98,4,1,5,80.0%,35m
19749,3,Snake,2133,116,4,5,9,44.4%,37m
19749,3,不造防空死全家,2133,0,0,1,1,0.0%,12m
19755,3,柒轩,2132,609,23,18,41,56.1%,1h
19755,2,已经变异的蝉,2132,260,19,24,43,44.2%,50m
19755,2,[星际拓荒者]我是猪队友多包涵,2132,447,17,20,37,45.9%,52m
19755,2,高手父亲,2132,334,12,20,32,37.5%,1h
19755,2,在上庞某人,2132,385,12,20,32,37.5%,20m
19755,2,[极限菜鸟]大老师,2132,292,10,10,20,50.0%,9m
19755,3,随想,2132,90,4,2,6,66.7%,1h
19755,2,时方知,2132,82,2,1,3,66.7%,16m
19755,3,[啾啾啾啾啾啾]喜欢吃卤蛋,2132,0,0,1,1,0.0%,1h
19764,2,WID,2131,516,19,25,44,43.2%,1h
19764,2,余大人,2131,434,18,14,32,56.2%,1h
19764,3,樱岛麻衣,2131,406,13,33,46,28.3%,20m
19764,1,JaceBeleren,2131,228,10,9,19,52.6%,35m
19764,3,[流氓黄基贱队]起来王归来,2131,58,3,0,3,100.0%,1h
19764,3,汉口江汉关,2131,0,0,3,3,0.0%,42m
19764,3,LuckyEB,2131,0,0,4,4,0.0%,1h
19764,3,不可名状的喵咪,2131,0,0,6,6,0.0%,1h
19772,1,[NVKR]双峰贯耳搬拦捶,2130,1486,133,138,271,49.1%,59m
19772,2,[gaints]LLZ,2130,323,13,12,25,52.0%,24m
19772,2,[0D]张氏浪子,2130,212,7,10,17,41.2%,1h
19772,2,PatrickStar,2130,147,3,6,9,33.3%,57m
19772,2,此生必睡蔡萝莉,2130,42,2,2,4,50.0%,1h
19772,3,silent,2130,36,2,3,5,40.0%,60m
19778,2,[乱世]萌呆二哈,2129,529,31,27,58,53.4%,23m
19778,2,[THRONE]killer,2129,646,27,28,55,49.1%,7m
19778,3,给霸霸趴下,2129,335,11,18,29,37.9%,1h
19778,2,威末,2129,225,7,3,10,70.0%,28m
19778,2,fcrq,2129,130,4,7,11,36.4%,1h
19778,2,dark,2129,120,4,8,12,33.3%,18m
19778,3,原谅犬,2129,0,0,1,1,0.0%,1h
19785,3,Monstours,2128,695,41,39,80,51.2%,53m
19785,2,木鱼儿,2128,368,11,22,33,33.3%,56m
19785,2,FallenScars,2128,278,11,23,34,32.4%,1h
19785,1,[烽夜长歌]清水之源,2128,219,8,10,18,44.4%,1h
19785,1,李子豪,2128,88,2,4,6,33.3%,1h
19785,1,涛倪,2128,119,2,7,9,22.2%,40m
19785,1,[Sc养老]Imp,2128,0,1,4,5,20.0%,1h
19785,2,[爱国]等别走,2128,0,0,2,2,0.0%,44m
19793,2,[miku守护]殇之恋,2127,580,51,50,101,50.5%,1h
19793,1,DFEFE,2127,512,49,58,107,45.8%,10m
19793,3,[CPT]爱虫大作战,2127,153,15,14,29,51.7%,56m
19793,2,Emilia,2127,17,10,26,36,27.8%,49m
19793,2,优雅的沙丁鱼,2127,189,6,3,9,66.7%,1h
19793,3,Skersh,2127,30,2,1,3,66.7%,1h
19793,3,[影之光]月之效力,2127,0,2,3,5,40.0%,1h
19793,2,随缘,2127,62,2,8,10,20.0%,9m
19793,3,[笙风]柠檬橘子说拜拜,2127,0,0,2,2,0.0%,56m
19802,3,[混吃混喝]为了部落,2126,0,1,0,1,100.0%,1h
19802,2,科比,2126,0,1,6,7,14.3%,1h
19802,1,少齐,2126,0,1,7,8,12.5%,57m
19802,3,十七,2126,0,0,5,5,0.0%,1h
19802,3,gig,2126,0,0,5,5,0.0%,1h
19802,3,那些很冒险的梦,2126,0,0,5,5,0.0%,1h
19808,2,路过的酱油党,2125,481,18,23,41,43.9%,1h
19808,3,兰胖子丶,2125,286,11,22,33,33.3%,58m
19808,3,顾不上壕,2125,102,4,8,12,33.3%,1h
19808,1,[反克复联]我叫黑斧阿胡,2125,142,4,9,13,30.8%,1h
19808,2,虫虫争爹,2125,125,3,2,5,60.0%,21m
19808,3,wds,2125,36,3,3,6,50.0%,1h
19808,2,默笙,2125,124,3,7,10,30.0%,50m
19808,3,人类冒出来了,2125,0,2,3,5,40.0%,7m
19808,2,AMDyes,2125,0,1,1,2,50.0%,28m
19808,2,莫湫,2125,0,1,1,2,50.0%,1h
19808,3,神威,2125,0,0,1,1,0.0%,1h
19819,2,四眼,2124,532,19,22,41,46.3%,9m
19819,1,[我们都是宝宝]ferragamo,2124,0,0,2,2,0.0%,1h
19821,2,star,2123,1315,49,51,100,49.0%,52m
19821,3,真央,2123,806,29,35,64,45.3%,1h
19821,2,AICE,2123,178,7,11,18,38.9%,50m
19821,2,名称未定,2123,96,4,11,15,26.7%,31m
19821,1,saber,2123,88,3,1,4,75.0%,1h
19821,3,世界小好星,2123,0,1,0,1,100.0%,1h
19821,2,虫神略,2123,0,1,0,1,100.0%,16m
19828,3,可食用型咸鱼菌,2122,30,2,2,4,50.0%,1h
19828,2,[血鸦旅馆]何冬夜,2122,0,1,6,7,14.3%,44m
19830,2,北峰吹海,2121,220,9,7,16,56.2%,1h
19830,1,SHNNG,2121,156,5,2,7,71.4%,48m
19830,1,space,2121,88,2,7,9,22.2%,1h
19830,3,[sc谐盟]CHON,2121,0,1,2,3,33.3%,1h
19830,2,[50块好狗子]小黑,2121,0,1,3,4,25.0%,1h
19830,2,[以君之名]刺蛇喜欢喷盐汽水,2121,0,0,1,1,0.0%,7m
19836,3,Allander,2120,250,10,6,16,62.5%,1h
19836,3,逗你玩,2120,193,7,15,22,31.8%,43m
19836,1,狐狸渔鸥,2120,0,2,7,9,22.2%,13m
19839,2,[圣龙之翼]济南吃饭王,2119,873,33,35,68,48.5%,24m
19839,3,言传,2119,442,24,20,44,54.5%,1h
19839,2,[DMRe]李教授,2119,580,20,24,44,45.5%,33m
19839,2,三个点,2119,361,15,17,32,46.9%,1h
19839,2,[谐星争霸2]拉莱倻之主,2119,86,3,9,12,25.0%,44m
19839,3,[无魂之鸭]物理老师,2119,0,1,0,1,100.0%,1h
19839,3,BLUE,2119,0,0,2,2,0.0%,1h
19839,3,DJYHX,2119,0,0,2,2,0.0%,56m
19847,2,夜礼服假面,2118,1575,261,303,564,46.3%,1h
19847,2,boy,2118,999,122,127,249,49.0%,1h
19847,3,风吹鸡儿一边倒,2118,652,26,18,44,59.1%,1h
19847,3,精灵王子,2118,190,6,1,7,85.7%,1h
19847,3,瞎姬霸玩,2118,168,4,2,6,66.7%,1h
19847,3,[万事俱来香]SCV,2118,104,4,6,10,40.0%,1h
19847,3,Eagle,2118,0,1,0,1,100.0%,1h
19847,2,Lion,2118,0,0,1,1,0.0%,28m
19855,2,紫竹琳,2117,726,35,41,76,46.1%,1h
19855,2,扎扎,2117,88,2,3,5,40.0%,1h
19855,3,[天降虫海]ecaaa,2117,0,1,6,7,14.3%,41m
19855,3,CaesarKing,2117,0,0,1,1,0.0%,48m
19855,3,萬世極樂,2117,0,0,1,1,0.0%,1h
19855,3,今天上数学课,2117,0,0,6,6,0.0%,41m
19861,1,ZSUCK,2116,1398,120,117,237,50.6%,53m
19861,3,[星舰与太阳x]法艰苦艰苦,2116,431,13,14,27,48.1%,59m
19861,1,终期故梦,2116,293,9,22,31,29.0%,60m
19861,3,玩腻,2116,0,2,4,6,33.3%,1h
19861,3,Angelll,2116,30,1,1,2,50.0%,42m
19861,3,[剑锋所至]死亡天降,2116,0,0,2,2,0.0%,46m
19867,2,每期,2115,284,22,28,50,44.0%,24m
19867,3,林夕河畔,2115,0,2,4,6,33.3%,13m
19867,2,天焰,2115,46,2,8,10,20.0%,1h
19867,3,king,2115,0,1,0,1,100.0%,1h
19867,2,[看我朵蜜你]芝华士里有芝士,2115,0,0,1,1,0.0%,1h
19867,3,[宠爱]麦兜,2115,0,0,1,1,0.0%,1h
19867,2,奔跑的滋水枪,2115,0,0,2,2,0.0%,44m
19874,2,天天,2114,201,15,21,36,41.7%,31m
19874,3,[追猎者]mystaa,2114,128,5,4,9,55.6%,32m
19874,3,星际之遗,2114,90,4,2,6,66.7%,14m
19874,2,[K2]凌炙,2114,122,4,10,14,28.6%,16m
19874,3,该用户不存在的,2114,58,2,1,3,66.7%,1h
19874,3,ycbqqcui,2114,0,1,0,1,100.0%,15m
19874,3,懿訫爱妳,2114,0,1,1,2,50.0%,6m
19874,3,韩信再生,2114,0,0,1,1,0.0%,6m
19882,2,壹贰,2113,405,16,18,34,47.1%,1h
19882,1,笑颜行方,2113,235,6,12,18,33.3%,16m
19882,3,花前月下,2113,0,3,2,5,60.0%,1h
19882,3,[o唔姆o]MaGeJiTerran,2113,30,2,0,2,100.0%,1h
19882,3,胡哈哈,2113,0,1,0,1,100.0%,53m
19882,2,jiji,2113,0,1,6,7,14.3%,7m
19888,2,[成电鸡协]行不得也呵呵,2112,80,3,8,11,27.3%,1h
19888,2,消失的梦,2112,0,1,3,4,25.0%,1h
19890,2,Kscal,2111,784,31,32,63,49.2%,24m
19890,2,TGak,2111,326,12,21,33,36.4%,9m
19890,2,Sybrorg,2111,125,6,7,13,46.2%,1h
19890,3,[KENNEL]狗苟招专用教学号,2111,168,5,1,6,83.3%,53m
19890,2,[20205]教皇,2111,107,2,2,4,50.0%,1h
19890,3,小田,2111,0,1,0,1,100.0%,1h
19896,2,[华夏何平]木头人,2110,238,13,14,27,48.1%,11m
19896,1,乐观王,2110,110,2,3,5,40.0%,1h
19896,3,冷沫,2110,30,1,1,2,50.0%,1h
19899,2,她说万幸得以相识,2109,779,33,35,68,48.5%,18m
19899,3,死亡脑细胞,2109,94,4,6,10,40.0%,1h
19899,1,吾皇,2109,138,4,10,14,28.6%,50m
19899,3,离人,2109,0,1,1,2,50.0%,1h
19899,1,自由之子,2109,0,1,1,2,50.0%,1h
19899,3,cccc,2109,0,0,3,3,0.0%,1h
19905,2,橘子,2108,892,33,41,74,44.6%,13m
19905,3,虚空之影,2108,506,17,24,41,41.5%,1h
19905,3,我叼尼玛的名,2108,34,2,0,2,100.0%,1h
19905,3,jajsd,2108,0,0,1,1,0.0%,1h
19909,3,Runru,2107,235,9,10,19,47.4%,1h
19909,1,zero,2107,0,3,9,12,25.0%,1h
19909,3,haniiii,2107,90,2,5,7,28.6%,1h
19909,3,左音,2107,0,1,0,1,100.0%,27m
19913,2,max,2106,444,17,17,34,50.0%,40m
19913,3,[极限菜鸟]dawn,2106,380,16,7,23,69.6%,1h
19913,2,攻主,2106,300,11,18,29,37.9%,1h
19913,2,TsuNoMaKiIKa,2106,0,1,0,1,100.0%,54m
19913,3,本人素质极差,2106,0,1,4,5,20.0%,43m
19913,2,[萌萌鸡小队]小小西柚,2106,0,0,1,1,0.0%,1h
19919,3,肾虚且不行,2105,194,5,4,9,55.6%,54m
19919,3,Ricardo,2105,100,4,2,6,66.7%,1h
19919,1,[CPT]恶魔之王,2105,230,4,7,11,36.4%,1h
19922,2,慕天泽,2104,934,60,67,127,47.2%,34m
19922,2,QND,2104,1133,58,66,124,46.8%,11m
19922,3,[兵长军团]Mdbiu,2104,559,21,18,39,53.8%,37m
19922,3,新人求虐待,2104,502,20,24,44,45.5%,16m
19922,3,海淀孙一峰,2104,224,8,10,18,44.4%,1h
19922,1,nilion,2104,234,8,12,20,40.0%,1h
19922,3,[卍卍卍]莯瑶,2104,58,2,2,4,50.0%,16m
19922,3,安东尼大木,2104,46,2,6,8,25.0%,1h
19922,2,殇神,2104,0,1,2,3,33.3%,1h
19922,3,黑白,2104,32,1,6,7,14.3%,1h
19922,2,狗撵摩托,2104,0,1,7,8,12.5%,1h
19922,3,單丶索伦,2104,0,0,1,1,0.0%,1h
19922,3,张顺飞,2104,0,0,5,5,0.0%,43m
19935,1,[葫芦娃救艾尔]WRNDG,2103,296,9,7,16,56.2%,51m
19935,1,daheti,2103,364,9,16,25,36.0%,40m
19935,3,风到,2103,0,3,4,7,42.9%,43m
19935,3,德哈卡是本名,2103,60,2,3,5,40.0%,1h
19935,3,stdent,2103,0,0,2,2,0.0%,1h
19935,2,死亡魅魔夜魇,2103,0,0,4,4,0.0%,1h
19935,3,游龙当归海,2103,0,0,5,5,0.0%,43m
19942,3,战斗弱鸡,2102,194,6,4,10,60.0%,43m
19942,2,[四系乃啦啦啦]卓亦逊,2102,130,5,9,14,35.7%,1h
19942,1,fanmoumo,2102,136,5,11,16,31.2%,1h
19942,1,zby,2102,167,4,11,15,26.7%,1h
19942,1,千门,2102,96,2,4,6,33.3%,13m
19942,3,卿防物议,2102,121,2,5,7,28.6%,1h
19942,3,打装机,2102,30,1,2,3,33.3%,3m
19942,3,欧阳咳咳,2102,0,0,2,2,0.0%,6m
19942,2,DKS,2102,0,0,3,3,0.0%,55m
19951,3,吸氧的吸氧羊,2101,188,7,7,14,50.0%,56m
19951,2,[收正常人]GIXA,2101,84,3,8,11,27.3%,6m
19951,2,小气的呆头,2101,30,2,4,6,33.3%,1h
19951,3,天文鬼球,2101,38,1,1,2,50.0%,1h
19951,3,可乐曲奇,2101,30,1,2,3,33.3%,1h
19951,3,友利奈绪,2101,97,1,2,3,33.3%,27m
19951,3,hoop,2101,40,1,4,5,20.0%,7m
19958,3,sidBeFool,2100,834,42,56,98,42.9%,18m
19958,3,obelisk,2100,181,9,11,20,45.0%,1h
19958,1,铁马冰河古人,2100,150,3,5,8,37.5%,28m
19958,3,刺蛇真的很溜,2100,0,1,0,1,100.0%,1h
19958,2,老罗杰,2100,0,0,1,1,0.0%,46m
19958,2,彼岸,2100,0,0,1,1,0.0%,1h
19958,2,仙人板板,2100,0,0,1,1,0.0%,21m
19965,3,君莫笑,2099,672,25,26,51,49.0%,1h
19965,3,[争锋]大雪天舞剑,2099,0,1,4,5,20.0%,43m
19967,3,兲坣髳缘,2098,1621,150,200,350,42.9%,1h
19967,2,JElkcip,2098,363,13,24,37,35.1%,1h
19967,3,iiiiiiiiiiii,2098,250,9,10,19,47.4%,18m
19967,3,自然大地板,2098,0,2,4,6,33.3%,1h
19967,3,[魂祀]清风,2098,0,1,0,1,100.0%,1h
19967,3,[wdnmd茄]笑晨,2098,0,0,1,1,0.0%,1h
19967,3,WSF,2098,0,0,1,1,0.0%,18m
19967,2,[暴雪三十队]星旭,2098,0,0,2,2,0.0%,1h
19967,2,speakman,2098,0,0,2,2,0.0%,57m
19967,3,[这是什么玩意]老王是真的帅,2098,0,0,3,3,0.0%,1h
19977,2,[ETSK]乱海,2097,224,36,30,66,54.5%,50m
19977,3,淘气之金龟子,2097,433,16,13,29,55.2%,1h
19977,3,wwww,2097,417,15,10,25,60.0%,20m
19977,2,[CPT]齐齐啪啪,2097,295,10,15,25,40.0%,1h
19977,3,九个太阳,2097,178,6,6,12,50.0%,1h
19977,3,最好的疯疯,2097,40,2,3,5,40.0%,1h
19977,3,阿萨大雪糕,2097,0,1,0,1,100.0%,1h
19977,3,[吉良吉影]空条仗世文,2097,30,1,2,3,33.3%,53m
19977,2,[闪电5连鞭]西园寺世界,2097,46,1,3,4,25.0%,1h
19986,2,日火,2096,902,35,77,112,31.2%,24m
19986,2,bingtian,2096,614,23,24,47,48.9%,1h
19986,3,swing,2096,446,17,16,33,51.5%,1h
19986,3,[高阶萌新]ERTJN,2096,235,8,5,13,61.5%,37m
19986,3,星际游侠,2096,238,8,12,20,40.0%,12m
19986,2,战神色打,2096,195,6,10,16,37.5%,1h
19986,3,骚人就是我,2096,0,1,0,1,100.0%,1h
19986,3,[斗鱼大纲]feng,2096,30,1,2,3,33.3%,1h
19986,3,xbd,2096,0,0,1,1,0.0%,1h
19986,3,Jack,2096,0,0,1,1,0.0%,16m
19996,2,free,2095,345,21,30,51,41.2%,1h
19996,3,[刺蛇保护协会]Pendragon,2095,289,10,5,15,66.7%,1h
19996,3,[联合动物园]窃格瓦拉本人,2095,98,4,2,6,66.7%,60m
19996,2,明月笑红尘,2095,125,3,8,11,27.3%,1h
19996,3,SHENGLZJ,2095,38,1,2,3,33.3%,49m
19996,2,[Fe3o4]项少龙,2095,30,1,6,7,14.3%,34m
19996,3,[WILLE]小灬千,2095,0,0,1,1,0.0%,1h
19996,3,镇天笑,2095,0,0,2,2,0.0%,1h
20004,3,qaqaqa,2094,505,19,16,35,54.3%,1h
20004,2,你的坏哥哥,2094,323,19,27,46,41.3%,18m
20004,3,Demo,2094,0,0,1,1,0.0%,1h
20004,3,Nninesun,2094,0,0,1,1,0.0%,1h
20008,2,masterOfCat,2093,772,70,77,147,47.6%,40m
20008,3,砍大山,2093,132,3,1,4,75.0%,56m
20008,3,千本樱丶翔月,2093,0,2,5,7,28.6%,43m
20011,3,月色撩人,2092,727,27,34,61,44.3%,16m
20011,3,我爱物理,2092,380,14,12,26,53.8%,1h
20011,1,创世大麦哥,2092,226,6,13,19,31.6%,6m
20011,3,[鬼谷]阿峰,2092,114,5,3,8,62.5%,1h
20011,3,LUO,2092,86,3,2,5,60.0%,6m
20011,3,不见长安见晨雾,2092,0,0,1,1,0.0%,1h
20011,3,llllllllllll,2092,0,0,5,5,0.0%,1h
20011,3,神坑小学生,2092,0,0,5,5,0.0%,7m
20019,3,Baochong,2091,381,16,17,33,48.5%,1h
20019,2,[神魔降临]薯条,2091,433,16,21,37,43.2%,1h
20019,2,孙一峰你吗炸了啊,2091,378,13,20,33,39.4%,20m
20019,3,YYDawn,2091,162,5,12,17,29.4%,58m
20019,3,JACK,2091,58,3,1,4,75.0%,6m
20019,3,七夜,2091,38,2,5,7,28.6%,60m
20019,3,轩辕绝心,2091,0,0,1,1,0.0%,1h
20019,3,振中时时赔,2091,0,0,5,5,0.0%,1h
20027,3,无名法老王,2090,798,50,59,109,45.9%,1h
20027,3,天空与风之王,2090,30,3,3,6,50.0%,1h
20027,3,[是我赢了]和呈,2090,0,1,2,3,33.3%,1h
20027,1,[DDOS心跳]开心小秦,2090,0,0,3,3,0.0%,1h
20031,2,liget,2089,150,7,9,16,43.8%,1h
20031,2,赤小兔,2089,46,2,8,10,20.0%,1h
20031,1,润滑泥鳅,2089,94,1,2,3,33.3%,12m
20031,2,[橘子的]龙影刃,2089,0,0,1,1,0.0%,21m
20035,2,Nocti,2088,490,14,20,34,41.2%,13m
20035,2,GoguoBor,2088,206,5,10,15,33.3%,50m
20035,2,如年渡日,2088,95,2,0,2,100.0%,1h
20035,3,敌敌畏,2088,0,1,1,2,50.0%,27m
20035,3,萌萌哒等风来,2088,0,1,2,3,33.3%,16m
20035,3,孙龘,2088,0,1,4,5,20.0%,60m
20035,3,不会写开题,2088,0,0,5,5,0.0%,1h
20042,2,foreverMY,2087,0,1,1,2,50.0%,17m
20042,3,路人甲,2087,0,1,3,4,25.0%,1h
20044,1,多萨达,2086,822,30,38,68,44.1%,44m
20044,3,阿斯巴甜,2086,161,8,13,21,38.1%,11m
20044,3,Scarlett,2086,40,2,3,5,40.0%,1h
20044,2,LOL,2086,0,0,1,1,0.0%,1h
20044,3,寺子屋的乌鸦,2086,0,0,1,1,0.0%,42m
20044,2,[幻海奇妙夜]Lexington,2086,0,0,2,2,0.0%,1h
20050,2,Xavier,2085,363,14,19,33,42.4%,1h
20050,2,echo,2085,325,10,19,29,34.5%,1h
20050,1,爱越,2085,319,7,16,23,30.4%,56m
20050,2,[王者重现]康乾盛世,2085,105,3,1,4,75.0%,16m
20050,2,AnthonyJhon,2085,0,1,0,1,100.0%,55m
20050,2,[正义灬必胜]死亡老留氓,2085,95,1,3,4,25.0%,44m
20050,3,Onland,2085,38,1,6,7,14.3%,1h
20050,3,Scarlett,2085,0,0,1,1,0.0%,1h
20050,3,[旺旺战士]长门战列舰,2085,0,0,1,1,0.0%,1h
20059,2,angelxing,2084,806,37,43,80,46.2%,1h
20059,2,卡洛斯,2084,325,10,15,25,40.0%,57m
20059,3,MRKAML,2084,193,6,3,9,66.7%,1h
20059,3,二月阳一,2084,30,2,1,3,66.7%,11m
20059,3,zzs,2084,0,0,1,1,0.0%,27m
20059,3,宿黑哥,2084,0,0,3,3,0.0%,13m
20065,2,产品合格证,2083,1075,87,106,193,45.1%,1h
20065,2,[菜有菜的道理]星空,2083,1102,45,48,93,48.4%,1h
20065,3,[白丝黑丝萝莉]风吹雪,2083,383,12,11,23,52.2%,35m
20065,2,天真,2083,88,2,0,2,100.0%,50m
20065,3,雨屋红胡子,2083,0,1,0,1,100.0%,12m
20065,3,歪嘴战神赵老四,2083,0,1,4,5,20.0%,43m
20065,3,无耻狗逼,2083,0,0,2,2,0.0%,1h
20065,3,Jack,2083,0,0,3,3,0.0%,1h
20073,2,小西瓜,2082,284,9,17,26,34.6%,1h
20073,3,[你嘤尼玛呢]二狗子,2082,146,6,7,13,46.2%,35m
20073,1,致死的哥特黑猫,2082,139,3,1,4,75.0%,7m
20073,3,[Shawk]Keter,2082,0,1,0,1,100.0%,56m
20073,3,柠檬鲨,2082,0,0,4,4,0.0%,1h
20078,1,泰山,2081,229,7,11,18,38.9%,15m
20078,2,狐狗,2081,42,2,0,2,100.0%,1h
20078,2,GEIWO,2081,44,1,1,2,50.0%,46m
20078,2,ZHANG,2081,0,1,9,10,10.0%,1h
20082,1,长风,2080,558,19,38,57,33.3%,11m
20082,3,我的战争,2080,394,14,18,32,43.8%,54m
20082,3,求奶我事业不顺,2080,86,4,4,8,50.0%,6m
20082,3,[我为何这么谐]流星丿半醉巴黎,2080,0,2,3,5,40.0%,49m
20082,2,无名之铭,2080,46,2,7,9,22.2%,7m
20082,3,[皮卡球]最后的御主,2080,0,0,1,1,0.0%,1h
20088,3,我女神叫夏小小,2079,517,31,34,65,47.7%,12m
20088,1,Skura,2079,761,27,45,72,37.5%,14m
20088,2,guccialessio,2079,440,23,29,52,44.2%,1h
20088,3,你啊你,2079,416,16,12,28,57.1%,1h
20088,1,SmallStrong,2079,278,7,19,26,26.9%,12m
20088,2,石头君丶,2079,154,5,13,18,27.8%,16m
20088,2,浪迹天涯,2079,102,3,7,10,30.0%,1h
20088,2,[鲁德欢]梁凉,2079,142,2,1,3,66.7%,1h
20088,2,罗布次仁,2079,0,0,1,1,0.0%,1h
20088,1,xyqqj,2079,0,0,1,1,0.0%,28m
20098,2,谭谭,2078,105,5,9,14,35.7%,3m
20098,2,魔法少女郭德纲,2078,108,4,7,11,36.4%,58m
20098,3,allen,2078,30,2,5,7,28.6%,1h
20098,2,xlm,2078,127,2,7,9,22.2%,1h
20098,2,[荒唐社]Grye,2078,0,1,1,2,50.0%,1h
20098,2,刘莉莉的哈士奇,2078,0,0,2,2,0.0%,55m
20104,3,喵呜,2077,625,27,24,51,52.9%,46m
20104,3,腾皇,2077,434,25,21,46,54.3%,46m
20104,3,始皇蒙毅,2077,305,10,16,26,38.5%,1h
20104,3,演员,2077,38,4,2,6,66.7%,1h
20108,2,[JFW]骑乘位,2076,541,21,33,54,38.9%,13m
20108,3,Hardess,2076,38,2,3,5,40.0%,1h
20108,3,Bilispace,2076,30,1,1,2,50.0%,21m
20108,2,幻影迈尔斯,2076,30,1,7,8,12.5%,1h
20108,3,[电脑樱花神社]星界之怨,2076,0,0,1,1,0.0%,1h
20108,3,黑曼巴威震天,2076,0,0,5,5,0.0%,60m
20114,2,pantao,2075,844,34,45,79,43.0%,16m
20114,2,中二少年,2075,296,16,23,39,41.0%,24m
20114,3,Lavie,2075,283,12,16,28,42.9%,1h
20114,1,星际菜鸡,2075,244,10,4,14,71.4%,28m
20114,3,Annihilan,2075,237,7,6,13,53.8%,14m
20114,1,彼岸丶雪华,2075,124,2,3,5,40.0%,48m
20114,2,骷髅凯撒,2075,91,1,2,3,33.3%,1h
20121,3,拿破里奥尼,2074,0,3,2,5,60.0%,1h
20121,1,古有佳茗名为颖,2074,152,3,3,6,50.0%,1h
20121,3,SDG,2074,74,2,7,9,22.2%,43m
20124,2,璧驷,2073,959,105,107,212,49.5%,40m
20124,3,艾尔明灯大主教,2073,398,16,16,32,50.0%,1h
20124,3,兵哥妙妙屋,2073,258,9,16,25,36.0%,43m
20124,1,谨言慎行,2073,171,7,8,15,46.7%,6m
20124,2,金鱼花,2073,136,5,5,10,50.0%,46m
20124,3,qwe,2073,58,4,3,7,57.1%,42m
20124,3,Cicada,2073,58,2,3,5,40.0%,18m
20124,2,CMCCX,2073,94,1,8,9,11.1%,43m
20124,3,枫叶,2073,0,0,1,1,0.0%,60m
20124,3,[ss德棍党]Archer,2073,0,0,3,3,0.0%,13m
20124,3,蜗牛,2073,0,0,4,4,0.0%,13m
20124,3,树苗,2073,0,0,5,5,0.0%,7m
20136,2,[慢手e族]JABARI,2072,1411,66,71,137,48.2%,1h
20136,3,[CPT]啦啦啦拉拉阿拉,2072,120,5,1,6,83.3%,49m
20136,3,IIIllIIllllI,2072,0,1,5,6,16.7%,7m
20136,3,灬苏我,2072,0,0,2,2,0.0%,1h
20136,3,混元掌门马师傅,2072,0,0,5,5,0.0%,1h
20141,2,漂流王,2071,854,98,117,215,45.6%,52m
20141,1,[第三国际]守护琅,2071,430,16,25,41,39.0%,1h
20141,3,sbk,2071,243,9,17,26,34.6%,1h
20141,2,ufo,2071,44,4,6,10,40.0%,8m
20141,3,BNDFJ,2071,60,2,2,4,50.0%,1h
20141,2,暮云流水似华年,2071,48,2,3,5,40.0%,17m
20141,3,恋爱日动漫,2071,0,0,5,5,0.0%,13m
20148,2,[DMRe]Laughing,2070,583,22,27,49,44.9%,11m
20148,3,小米糕,2070,302,10,8,18,55.6%,60m
20148,3,lugg,2070,117,6,7,13,46.2%,1h
20148,3,无处流浪,2070,139,5,5,10,50.0%,11m
20148,1,老狼大盘鸡,2070,141,2,5,7,28.6%,1h
20153,2,未来任性,2069,132,6,11,17,35.3%,1h
20153,3,TonyQwQ,2069,0,0,3,3,0.0%,43m
20153,3,你杰哥,2069,0,0,5,5,0.0%,1h
20156,3,Kerrigan,2068,42,2,3,5,40.0%,1h
20156,3,[虚空闪烁]萤火虫满天,2068,0,0,2,2,0.0%,1h
20156,3,sRzerO,2068,0,0,3,3,0.0%,1h
20159,3,按兵不动,2067,1262,44,54,98,44.9%,1h
20159,3,anizerf,2067,253,12,19,31,38.7%,58m
20159,3,王者必秃,2067,250,8,7,15,53.3%,1h
20159,2,扫比阿量,2067,173,4,9,13,30.8%,1h
20159,3,羁旅猎刃,2067,0,1,0,1,100.0%,1h
20159,1,[兄弟和朋友]蛮力之枭,2067,0,1,2,3,33.3%,28m
20159,3,KANNON,2067,0,0,1,1,0.0%,4m
20159,3,地主老豺,2067,0,0,1,1,0.0%,6m
20159,3,MFRctA,2067,0,0,1,1,0.0%,1h
20168,3,小无悔,2066,979,40,41,81,49.4%,1h
20168,3,温卿,2066,449,17,13,30,56.7%,1h
20168,1,金晨星,2066,333,11,15,26,42.3%,1h
20168,3,ATV,2066,120,10,10,20,50.0%,6m
20168,2,胡较瘦,2066,222,5,13,18,27.8%,1h
20168,3,请勿理解,2066,34,3,3,6,50.0%,49m
20168,3,我真的不会玩诺娃,2066,60,2,3,5,40.0%,1h
20168,3,mengli,2066,0,1,0,1,100.0%,42m
20168,3,此生不悔,2066,0,0,1,1,0.0%,1h
20168,3,Aellose,2066,0,0,5,5,0.0%,42m
20178,3,灭绝,2065,664,23,29,52,44.2%,1h
20178,3,llllllllllll,2065,98,5,5,10,50.0%,1h
20178,1,[Sc丨VG]发条橙,2065,0,3,7,10,30.0%,1h
20178,3,同福,2065,46,2,7,9,22.2%,43m
20178,2,XRay,2065,0,0,2,2,0.0%,1h
20178,3,小女巫没吃饭,2065,0,0,5,5,0.0%,1h
20184,2,[白给不要钱]仙人棒棒,2064,234,9,11,20,45.0%,1h
20184,3,老子就是心软,2064,72,3,4,7,42.9%,1h
20184,2,一念山河成,2064,82,2,5,7,28.6%,1h
20184,3,asdasdasafl,2064,40,1,2,3,33.3%,1h
20188,2,林夜秋,2063,0,1,0,1,100.0%,1h
20188,3,迷糊娃,2063,0,1,0,1,100.0%,1h
20188,3,xxxxxx,2063,30,1,1,2,50.0%,1h
20188,3,低功耗他,2063,0,1,6,7,14.3%,1h
20192,3,John,2062,1424,207,218,425,48.7%,1h
20192,2,尼古拉杰克,2062,58,3,8,11,27.3%,1h
20192,3,疯子李,2062,32,2,4,6,33.3%,27m
20192,3,[凛风]creeper,2062,0,1,0,1,100.0%,11m
20192,3,故国有明,2062,0,0,1,1,0.0%,7m
20197,3,啊欢卖萌,2061,444,19,18,37,51.4%,1h
20197,3,[栗子栗子栗]栗子,2061,299,12,15,27,44.4%,56m
20197,3,[tyyt]天依,2061,311,10,18,28,35.7%,11m
20197,3,魔鬼的守护,2061,104,4,1,5,80.0%,1h
20197,2,星际菜鸟来了,2061,108,3,2,5,60.0%,1h
20197,2,Fraud,2061,132,2,3,5,40.0%,21m
20197,1,empty,2061,44,2,7,9,22.2%,32m
20197,3,[ICHYI]司空馨漠,2061,0,1,0,1,100.0%,1h
20205,2,deathjoker,2060,279,11,7,18,61.1%,54m
20205,1,致残打击,2060,256,6,12,18,33.3%,6m
20205,3,黑色星期天,2060,72,2,2,4,50.0%,1h
20208,3,时空,2059,706,26,25,51,51.0%,14m
20208,1,全民祸害,2059,180,8,11,19,42.1%,47m
20208,1,贼无敌,2059,141,3,2,5,60.0%,35m
20208,3,bowlin,2059,0,0,1,1,0.0%,18m
20208,3,九幺,2059,0,0,2,2,0.0%,49m
20208,3,颠笑痴狂,2059,0,0,5,5,0.0%,1h
20214,2,pamge,2058,294,29,30,59,49.2%,1h
20214,3,星辉,2058,0,0,1,1,0.0%,1h
20216,2,Animation,2057,802,41,37,78,52.6%,24m
20216,3,踏雪无痕,2057,459,15,27,42,35.7%,1h
20216,3,gaoziteng,2057,204,13,11,24,54.2%,42m
20216,3,[云南开放大学]跳房顶的猫,2057,388,12,11,23,52.2%,1h
20216,1,MOSKVA,2057,285,11,14,25,44.0%,48m
20216,2,第五屠皇,2057,126,4,11,15,26.7%,1h
20216,1,[拨云见日]凤雏,2057,138,4,13,17,23.5%,35m
20216,3,异虫,2057,96,2,4,6,33.3%,1h
20216,1,asfargsergs,2057,97,1,6,7,14.3%,1h
20225,2,快乐星际,2056,616,22,25,47,46.8%,40m
20225,1,星海,2056,211,7,13,20,35.0%,1h
20225,3,冰封之星,2056,221,6,5,11,54.5%,60m
20225,3,[C21605]Mousko,2056,116,5,5,10,50.0%,27m
20225,3,[键盘冒毒奶]三毛找托尼,2056,0,1,4,5,20.0%,42m
20225,3,奈奈奈奈子,2056,0,1,4,5,20.0%,8m
20225,3,Auotman,2056,0,0,1,1,0.0%,53m
20232,3,军傲,2055,117,6,8,14,42.9%,1h
20232,1,一介逃兵,2055,109,6,11,17,35.3%,1h
20232,3,逝风,2055,0,2,3,5,40.0%,1h
20232,2,钱穆父,2055,0,0,3,3,0.0%,50m
20236,3,硝晏暮雨,2054,54,2,4,6,33.3%,1h
20236,2,奥克兰小霸王,2054,88,2,6,8,25.0%,1h
20236,3,general,2054,0,0,1,1,0.0%,1h
20236,2,Ouking,2054,0,0,5,5,0.0%,55m
20240,3,[大元师]可以不可以,2053,86,4,5,9,44.4%,11m
20240,2,starhello,2053,105,4,7,11,36.4%,46m
20240,2,永黯,2053,125,3,1,4,75.0%,1h
20240,1,[陀螺丶小分队]龙的后代,2053,113,2,2,4,50.0%,1h
20240,2,[火焰雷兽]HopeLess,2053,90,2,9,11,18.2%,1h
20240,3,狗男女不会丶暴兵,2053,0,0,1,1,0.0%,49m
20240,3,爱莹莹,2053,0,0,5,5,0.0%,1h
20247,2,huiCN,2052,598,23,26,49,46.9%,1h
20247,3,是但求其爱,2052,0,2,3,5,40.0%,1h
20249,3,[神罚]小星星,2051,261,10,17,27,37.0%,1h
20249,3,目渺渺兮愁予,2051,170,5,10,15,33.3%,1h
20249,3,专打不服,2051,86,3,5,8,37.5%,1h
20249,3,阿鼠桑,2051,30,2,3,5,40.0%,42m
20249,3,birdy,2051,0,1,3,4,25.0%,60m
20249,3,小阿善,2051,0,0,1,1,0.0%,1h
20255,3,空白格,2050,86,4,3,7,57.1%,1h
20255,3,Mediowes,2050,58,3,2,5,60.0%,1h
20255,3,[吕布保护集团]magejiterran,2050,122,2,2,4,50.0%,1h
20255,3,[御阿礼之子丶]蕾拉普莉兹姆利巴,2050,29,1,3,4,25.0%,56m
20255,3,MagicTerran,2050,0,0,1,1,0.0%,1h
20260,3,星际神之神,2049,973,34,36,70,48.6%,43m
20260,3,[净化互联]QAQAQAQ,2049,123,3,2,5,60.0%,1h
20260,3,修罗,2049,0,0,5,5,0.0%,42m
20263,1,正在输入,2048,216,8,13,21,38.1%,57m
20263,2,漫天飞舞,2048,127,7,15,22,31.8%,18m
20263,3,Hennessy,2048,150,5,10,15,33.3%,1h
20263,2,风雨者,2048,216,5,12,17,29.4%,17m
20263,2,黑暗之主,2048,177,4,5,9,44.4%,21m
20263,2,ETGH,2048,82,3,10,13,23.1%,1h
20263,1,弹痕,2048,0,0,1,1,0.0%,1h
20270,2,贪狼星,2047,94,11,21,32,34.4%,40m
20270,1,NEZseven,2047,188,5,7,12,41.7%,1h
20270,2,peko,2047,164,5,9,14,35.7%,1h
20270,3,YKHD,2047,74,2,4,6,33.3%,43m
20270,3,Zeratul,2047,0,1,1,2,50.0%,53m
20270,3,梦生丿醉死,2047,0,0,1,1,0.0%,27m
20276,3,各安天命,2046,166,5,3,8,62.5%,58m
20276,1,次元战士,2046,190,5,5,10,50.0%,28m
20276,1,名字真难起,2046,191,5,11,16,31.2%,57m
20276,2,加多宝凉茶,2046,176,5,13,18,27.8%,1h
20276,3,御坂之光,2046,0,0,2,2,0.0%,1h
20281,3,luo,2045,0,0,1,1,0.0%,43m
20282,3,Evilvector,2044,272,8,10,18,44.4%,1h
20282,3,nzk,2044,246,7,8,15,46.7%,18m
20282,3,[萌新求带]永恒守护者,2044,92,3,6,9,33.3%,1h
20282,2,GDXJ,2044,40,1,2,3,33.3%,1h
20282,2,枯荣,2044,0,0,1,1,0.0%,17m
20282,3,[Iowa]宇宙战舰衣阿华,2044,0,0,7,7,0.0%,13m
20288,3,王宝贵,2043,180,6,12,18,33.3%,1h
20288,2,生死看淡不服就干,2043,128,3,8,11,27.3%,45m
20288,1,aklu,2043,92,2,0,2,100.0%,1h
20288,3,[帅比大队]Drking,2043,30,2,2,4,50.0%,1h
20288,3,唯有墨花,2043,0,1,4,5,20.0%,1h
20293,3,superstar,2042,613,23,28,51,45.1%,57m
20293,2,Strawberry,2042,632,20,30,50,40.0%,1h
20293,3,阿韦没死,2042,0,1,0,1,100.0%,42m
20293,3,王大人,2042,0,0,5,5,0.0%,1h
20297,3,[风之灵]小龙,2041,90,3,8,11,27.3%,27m
20297,3,EASYgoing,2041,118,2,1,3,66.7%,1h
20297,3,[F2ANB]雪月,2041,0,1,4,5,20.0%,1h
20297,3,虫王重生,2041,0,0,5,5,0.0%,1h
20297,3,DEMON,2041,0,0,6,6,0.0%,60m
20302,3,xcdhtxzs,2040,442,16,22,38,42.1%,18m
20302,2,[琴筝]xiongjiyang,2040,46,2,4,6,33.3%,55m
20302,1,lalala,2040,0,0,1,1,0.0%,1h
20305,1,弦乐小夜曲,2039,588,18,14,32,56.2%,1h
20305,3,[灵猫]小百事,2039,186,7,4,11,63.6%,1h
20305,1,DreanmSzs,2039,303,7,8,15,46.7%,1h
20305,2,阿萨德,2039,44,2,9,11,18.2%,43m
20305,2,致命之裤,2039,0,0,1,1,0.0%,17m
20305,1,轩轩轩,2039,0,0,1,1,0.0%,3m
20311,3,wang,2038,118,4,7,11,36.4%,46m
20312,1,uxkz,2037,0,0,1,1,0.0%,13m
20313,2,沫丶颜夕,2036,873,31,45,76,40.8%,57m
20313,3,新手屠夫,2036,118,5,5,10,50.0%,1h
20315,3,表情大师,2035,470,32,35,67,47.8%,54m
20315,2,KID,2035,234,7,14,21,33.3%,1h
20315,3,夫子,2035,0,0,1,1,0.0%,1h
20315,3,翩诺惊鸿,2035,0,0,2,2,0.0%,1h
20315,3,hmy,2035,0,0,3,3,0.0%,1h
20320,3,璃茉,2034,0,0,3,3,0.0%,6m
20320,3,FASD,2034,0,0,3,3,0.0%,1h
20320,3,其实我是中国人,2034,0,0,6,6,0.0%,1h
20323,2,云底飞,2033,0,5,5,10,50.0%,1h
20323,3,冰雪,2033,184,4,5,9,44.4%,1h
20323,1,HYx,2033,94,2,7,9,22.2%,1h
20326,2,TWOandALASKA,2032,1246,45,59,104,43.3%,56m
20326,3,玉面飞龙,2032,760,29,31,60,48.3%,1h
20326,1,牛人世界回归,2032,0,0,1,1,0.0%,1h
20329,3,琴弦上的指尖,2031,644,22,35,57,38.6%,16m
20329,3,地霸,2031,517,20,23,43,46.5%,57m
20329,3,小贾超凶哒,2031,481,18,17,35,51.4%,1h
20329,2,星翰灿烂,2031,133,3,9,12,25.0%,1h
20329,1,wang,2031,0,2,3,5,40.0%,1h
20329,3,花落情未断,2031,0,1,4,5,20.0%,1h
20329,3,小白一个,2031,0,0,2,2,0.0%,1h
20329,3,羽落,2031,0,0,6,6,0.0%,8m
20337,3,qiqiyoung,2030,441,37,47,84,44.0%,46m
20337,3,靓仔,2030,266,8,9,17,47.1%,53m
20337,1,殇年忆,2030,94,3,12,15,20.0%,13m
20337,3,赶死黄旭东,2030,30,2,7,9,22.2%,1h
20337,3,北慕,2030,0,1,1,2,50.0%,13m
20337,2,一个新的时代,2030,0,0,1,1,0.0%,1h
20343,1,狼人,2029,140,5,14,19,26.3%,1h
20343,3,奥特曼,2029,0,0,4,4,0.0%,1h
20343,3,樱花罒李,2029,0,0,5,5,0.0%,49m
20346,2,Tony,2028,291,21,27,48,43.8%,24m
20346,1,[神子]lbwnb,2028,293,12,24,36,33.3%,1h
20346,2,[樱丘]srlre,2028,234,9,14,23,39.1%,31m
20346,2,lalamiao,2028,0,1,6,7,14.3%,16m
20346,3,[极限菜鸟]消灭消灭,2028,36,1,7,8,12.5%,1h
20346,3,星际虎,2028,0,0,1,1,0.0%,1h
20346,3,yuyutfy,2028,0,0,2,2,0.0%,1h
20353,3,倾酒笑苍天,2026,370,11,17,28,39.3%,1h
20353,1,Piporuakeiso,2026,90,3,0,3,100.0%,6m
20353,1,今天礼拜七,2026,94,2,1,3,66.7%,28m
20353,3,[星际老嘎嘎]虚空老嘎嘎,2026,0,1,4,5,20.0%,60m
20353,3,给你猫来两拳,2026,44,1,7,8,12.5%,1h
20358,1,上杉绘梨衣,2025,219,6,11,17,35.3%,1h
20358,3,和纱的愚忠分子,2025,58,2,5,7,28.6%,1h
20358,2,wangcheng,2025,44,2,9,11,18.2%,46m
20358,2,阿苏卡到啦,2025,0,0,2,2,0.0%,50m
20362,3,huanBB,2024,268,8,19,27,29.6%,6m
20362,2,你携秋水揽星河,2024,167,3,6,9,33.3%,29m
20362,3,开心的小傻瓜,2024,91,2,4,6,33.3%,1h
20362,3,黎明的银狼,2024,0,0,2,2,0.0%,43m
20366,2,pzx,2023,203,5,13,18,27.8%,16m
20366,3,talkll,2023,30,2,1,3,66.7%,1h
20366,2,无畏要塞,2023,0,1,8,9,11.1%,17m
20366,1,杀伐之心,2023,0,0,6,6,0.0%,55m
20370,3,VENNLIZST,2022,286,13,15,28,46.4%,1h
20370,3,帅气的小伙,2022,0,1,1,2,50.0%,56m
20370,1,走在刀颠上,2022,0,0,1,1,0.0%,1h
20373,3,Char,2021,297,15,13,28,53.6%,1h
20373,2,Fox,2021,84,3,6,9,33.3%,29m
20373,3,色法记者,2021,62,2,3,5,40.0%,13m
20373,1,别跟我捣鬼,2021,92,2,7,9,22.2%,1h
20373,1,正在加载,2021,0,0,1,1,0.0%,50m
20378,2,神仙,2020,254,7,10,17,41.2%,1h
20378,2,[TAPC]Rain,2020,0,1,0,1,100.0%,1h
20378,3,假斯文,2020,0,0,5,5,0.0%,60m
20381,1,守望星际联盟,2019,525,144,180,324,44.4%,29m
20381,3,长沙人,2019,30,2,8,10,20.0%,1h
20381,3,[神砥]kabuqinuo,2019,0,1,5,6,16.7%,27m
20381,2,源氏,2019,0,0,1,1,0.0%,1h
20385,2,电脑非常困难,2018,842,29,37,66,43.9%,1h
20385,3,[DDOS水军]TANGIJU,2018,714,29,38,67,43.3%,1h
20385,1,ScaretCarson,2018,370,9,6,15,60.0%,28m
20385,3,[爱国]绝望吧,2018,48,1,5,6,16.7%,1h
20385,3,hzy,2018,32,1,7,8,12.5%,1h
20390,1,睡梦轻轻,2017,259,7,16,23,30.4%,32m
20390,1,[海鲜男孩]爷灬傲奈我何,2017,46,2,1,3,66.7%,1h
20390,3,[寒绯樱]隐刀,2017,48,2,1,3,66.7%,1h
20390,1,机智昊,2017,0,0,1,1,0.0%,7m
20390,1,[星塵联萌]凌云,2017,0,0,1,1,0.0%,1h
20395,1,虔诚寒冰,2016,132,7,11,18,38.9%,28m
20395,1,Shakespeare,2016,48,1,1,2,50.0%,56m
20397,3,今晚打老虎,2015,0,0,5,5,0.0%,1h
20398,3,山东鼓王,2013,407,16,19,35,45.7%,27m
20398,3,黑色玄衣,2013,288,10,14,24,41.7%,60m
20398,1,清城子,2013,46,3,11,14,21.4%,32m
20398,1,不灭之神,2013,0,1,1,2,50.0%,28m
20398,3,sunrays,2013,0,0,2,2,0.0%,1h
20398,3,sjj,2013,0,0,3,3,0.0%,1h
20404,3,[66668]逆光,2012,0,1,0,1,100.0%,13m
20404,3,我是火车王,2012,0,1,3,4,25.0%,16m
20404,3,铁桶公牛,2012,0,0,5,5,0.0%,49m
20407,3,playerliang,2011,187,9,8,17,52.9%,1h
20407,2,[DSE]RHTRU,2011,93,3,1,4,75.0%,1h
20409,1,繁星春水,2010,381,10,17,27,37.0%,6m
20409,2,三生一意,2010,106,2,3,5,40.0%,29m
20409,2,雨叶,2010,0,1,0,1,100.0%,29m
20409,3,电竞埃里希,2010,0,0,5,5,0.0%,27m
20413,2,匿名,2009,289,9,12,21,42.9%,21m
20413,2,fdrgdfgfthth,2009,60,4,9,13,30.8%,1h
20413,1,匣于橘,2009,44,1,2,3,33.3%,1h
20413,3,voida,2009,30,1,4,5,20.0%,1h
20413,3,继国缘一,2009,0,0,6,6,0.0%,1h
20418,3,xjpfyc,2008,560,21,21,42,50.0%,56m
20418,1,东海戴鱼,2008,342,8,6,14,57.1%,1h
20418,1,寒九泉,2008,188,7,25,32,21.9%,58m
20418,3,鱼人领军,2008,118,3,2,5,60.0%,1h
20418,1,向问天,2008,46,1,3,4,25.0%,1h
20423,1,甄不错,2007,1142,35,63,98,35.7%,26m
20423,2,CAY,2007,285,7,10,17,41.2%,55m
20423,3,icecream,2007,62,2,6,8,25.0%,42m
20423,3,[瘾大眼瞎]我也曾拥过她,2007,0,1,0,1,100.0%,1h
20423,2,[冒险者谐会]长沙孙一峰,2007,40,1,5,6,16.7%,1h
20428,1,星际伯爵,2006,90,3,2,5,60.0%,1h
20428,3,谁说你不胖,2006,0,1,5,6,16.7%,1h
20430,2,红色文化,2005,1397,58,76,134,43.3%,1h
20430,3,哮嚣,2005,0,0,4,4,0.0%,58m
20432,1,[X4v4]飞鼠,2004,209,13,32,45,28.9%,36m
20432,3,lzr,2004,290,10,9,19,52.6%,6m
20432,3,小电脑同学,2004,163,5,3,8,62.5%,16m
20432,3,莱茵哈特,2004,90,4,7,11,36.4%,1h
20432,3,Lagrage,2004,76,2,8,10,20.0%,27m
20432,1,基佬密汤,2004,0,0,1,1,0.0%,1h
20432,3,半夜不睡觉,2004,0,0,6,6,0.0%,1h
20439,2,SHYMF,2003,119,6,8,14,42.9%,57m
20439,1,NPCjunyu,2003,46,2,0,2,100.0%,1h
20439,3,好好学习多种树,2003,0,1,5,6,16.7%,13m
20442,2,黑翼舞者,2002,678,23,32,55,41.8%,1h
20442,1,[29CM]午夜暴走哥,2002,0,0,1,1,0.0%,28m
20444,3,[万神归一]耶稣与玛丽锁,2001,189,5,5,10,50.0%,1h
20444,3,好男人,2001,74,3,5,8,37.5%,13m
20444,2,快楽的三哥,2001,97,2,10,12,16.7%,1h
20444,1,怎么赢,2001,46,1,3,4,25.0%,50m
20444,3,一个大炮,2001,0,1,7,8,12.5%,42m
20444,3,stoP,2001,0,0,3,3,0.0%,49m
20450,2,[长征小白]难兄难弟,2000,730,25,30,55,45.5%,59m
20451,1,坚持就是胜利,1999,972,26,33,59,44.1%,1h
20451,1,WEWe,1999,46,2,10,12,16.7%,1h
20453,1,二分之一,1997,404,10,12,22,45.5%,47m
20453,1,[520nan]撒币被我虐,1997,188,5,0,5,100.0%,1h
20455,2,[CPT]帅帅的我,1996,1431,71,92,163,43.6%,18m
20455,3,[SoloAs]python,1996,60,3,6,9,33.3%,1h
20455,2,[火焰雷兽]豫竹方便面,1996,0,1,2,3,33.3%,16m
20455,3,暗夜之鸭,1996,0,1,4,5,20.0%,1h
20459,2,[RPS]野狗,1995,207,9,16,25,36.0%,59m
20459,1,赵龙空,1995,136,4,1,5,80.0%,1h
20459,3,fine,1995,60,2,8,10,20.0%,43m
20459,3,开门暗影卫队,1995,0,0,1,1,0.0%,42m
20463,1,CNM,1994,282,10,14,24,41.7%,12m
20463,2,iStitch,1994,310,10,18,28,35.7%,1h
20463,1,月夜,1994,367,9,13,22,40.9%,1h
20466,3,第五篇,1993,0,2,5,7,28.6%,42m
20466,2,[XKA]拉莱耶,1993,0,0,6,6,0.0%,1h
20468,1,Ricardo,1992,210,6,6,12,50.0%,28m
20468,3,东方月初,1992,0,0,2,2,0.0%,1h
20470,1,南寒,1991,48,2,2,4,50.0%,56m
20470,3,雪狼,1991,30,2,6,8,25.0%,1h
20470,1,凯瑞拉,1991,0,0,1,1,0.0%,1h
20470,1,烟尘荼縻,1991,0,0,9,9,0.0%,13m
20474,2,[886]kingwwww,1990,334,12,17,29,41.4%,24m
20474,3,[SCL]吉吉国王,1990,145,4,5,9,44.4%,60m
20474,1,Windy,1990,121,3,1,4,75.0%,48m
20474,1,呆到深处自然萌,1990,0,1,0,1,100.0%,1h
20474,3,是土豆呀,1990,0,1,0,1,100.0%,1h
20474,3,sssa,1990,0,1,0,1,100.0%,8m
20474,1,杀鸡取卵,1990,0,0,1,1,0.0%,28m
20474,1,[天地會总舵]夺命版本补丁,1990,0,0,2,2,0.0%,1h
20474,2,matthew,1990,0,0,4,4,0.0%,46m
20474,3,北方雪,1990,0,0,6,6,0.0%,1h
20484,3,花生糖,1989,330,12,19,31,38.7%,1h
20484,3,sha,1989,30,3,0,3,100.0%,27m
20484,3,奏律,1989,96,2,2,4,50.0%,46m
20484,3,dhgjmlm,1989,48,1,8,9,11.1%,1h
20484,1,黑羽,1989,0,1,10,11,9.1%,32m
20484,2,马也,1989,0,0,1,1,0.0%,29m
20484,1,[Neeb]wanglei,1989,0,0,2,2,0.0%,28m
20491,3,[荣耀归来]帝皇侠,1988,62,2,1,3,66.7%,1h
20492,1,[KORSC2]CvMAX,1987,581,21,7,28,75.0%,56m
20492,1,这是名字,1987,136,3,4,7,42.9%,1h
20492,1,DragonFire,1987,42,2,0,2,100.0%,1h
20495,1,Thomasaa,1986,142,3,7,10,30.0%,15m
20495,2,啸平,1986,119,2,3,5,40.0%,1h
20495,3,toobemore,1986,0,0,5,5,0.0%,1h
20498,3,失引论,1985,224,7,20,27,25.9%,1h
20498,3,[可爱的你们]我无敌,1985,38,1,8,9,11.1%,1h
20500,3,咆哮的小花鸡,1984,0,0,1,1,0.0%,1h
20501,3,ShrekForever,1983,38,1,2,3,33.3%,49m
20502,3,Dingdang,1982,751,34,45,79,43.0%,1h
20502,2,金刚大头娃,1982,356,11,23,34,32.4%,1h
20502,1,SHE,1982,0,1,0,1,100.0%,1h
20502,3,老板你好黄,1982,0,0,1,1,0.0%,60m
20506,1,iwerjosldkie,1981,94,9,15,24,37.5%,1h
20506,2,[破晓黎明]泉声猪猪,1981,171,6,9,15,40.0%,50m
20506,1,[辣个大主机]LeFTIME,1981,135,4,3,7,57.1%,15m
20506,3,jume,1981,60,3,7,10,30.0%,56m
20510,1,兔妞色,1980,1593,51,58,109,46.8%,13m
20510,1,金装大洋根,1980,46,2,3,5,40.0%,17m
20510,1,戒之在斗,1980,48,1,4,5,20.0%,1h
20510,3,demon,1980,0,1,6,7,14.3%,27m
20510,3,神小白,1980,0,0,3,3,0.0%,27m
20515,3,这姑娘真好看,1979,1247,76,50,126,60.3%,6m
20515,1,AAAA,1979,1100,33,50,83,39.8%,1h
20515,2,rkhh,1979,106,3,8,11,27.3%,1h
20515,2,[DSE]阿尔托莉雅是我妻,1979,0,1,0,1,100.0%,1h
20515,3,应急食品,1979,0,0,4,4,0.0%,1h
20520,3,[Micer]surprised,1978,538,19,22,41,46.3%,1h
20520,1,机长,1978,270,8,13,21,38.1%,11m
20520,2,corpse,1978,0,0,1,1,0.0%,50m
20523,3,江湖乘舟,1977,290,10,14,24,41.7%,1h
20523,1,山上有樱桃,1977,48,1,1,2,50.0%,56m
20523,3,[无情突变王]守护,1977,0,0,2,2,0.0%,8m
20523,3,llllll,1977,0,0,3,3,0.0%,1h
20523,3,我也很中二在一起,1977,0,0,6,6,0.0%,1h
20523,3,猎魔人,1977,0,0,7,7,0.0%,1h
20529,1,STinKsOuL,1976,340,10,11,21,47.6%,40m
20529,2,remember,1976,0,1,8,9,11.1%,1h
20531,3,guyuejj,1975,62,2,11,13,15.4%,1h
20531,1,吾问无为谓,1975,46,1,2,3,33.3%,6m
20531,3,[MeLo]MentalSick,1975,0,1,4,5,20.0%,49m
20531,1,[黑暗幻想]闪亮之翼,1975,0,0,1,1,0.0%,1h
20535,3,RED,1974,0,0,6,6,0.0%,1h
20536,3,任和君,1973,443,58,63,121,47.9%,18m
20537,1,龙空,1972,557,13,12,25,52.0%,28m
20537,1,IGgshxd,1972,90,3,1,4,75.0%,28m
20537,2,deg,1972,179,3,6,9,33.3%,50m
20537,2,[喜欢就是干]aaaa,1972,0,0,1,1,0.0%,1h
20541,1,星际争霸主站部队,1971,850,24,27,51,47.1%,1h
20541,3,[哭笑脸]李现明,1971,92,3,8,11,27.3%,1h
20541,2,老过,1971,48,2,3,5,40.0%,45m
20541,3,[哭笑脸]继续丶沉默,1971,60,2,7,9,22.2%,49m
20541,3,雨墨筱诺,1971,30,1,8,9,11.1%,42m
20546,3,[大洋彼岸团队]jkljlj,1970,1520,62,64,126,49.2%,1h
20546,3,你是谁,1970,607,25,30,55,45.5%,58m
20546,1,Estel,1970,294,11,21,32,34.4%,1h
20546,1,清雪,1970,96,2,2,4,50.0%,1h
20546,2,你在第几层,1970,48,2,9,11,18.2%,17m
20546,3,鬼与归期,1970,30,1,1,2,50.0%,1h
20546,3,[紫罗兰之都]工口爱丽丝,1970,0,0,1,1,0.0%,13m
20553,3,[CPT]yanghu,1969,511,18,20,38,47.4%,43m
20553,1,小菜鸟,1969,288,7,7,14,50.0%,28m
20553,3,DEIOG,1969,162,6,8,14,42.9%,1h
20553,3,阿卡,1969,0,1,7,8,12.5%,43m
20553,3,菜菜小菲菲,1969,0,0,6,6,0.0%,1h
20558,3,豪风破魔虫,1968,0,0,6,6,0.0%,43m
20559,3,youwillgoal,1967,1279,82,67,149,55.0%,1h
20560,1,[尔虞我诈]没设么事,1966,400,10,11,21,47.6%,1h
20560,2,eros,1966,233,5,5,10,50.0%,1h
20560,3,学徒,1966,0,0,3,3,0.0%,43m
20563,1,红唇烈酒,1965,312,7,11,18,38.9%,6m
20563,3,啊这,1965,36,4,5,9,44.4%,42m
20563,2,孤城,1965,103,3,1,4,75.0%,1h
20563,1,[底特律KAR]你的时间归我了,1965,0,1,0,1,100.0%,1h
20567,2,梵懿,1964,123,2,9,11,18.2%,50m
20567,2,IIIIIIIIIIII,1964,108,2,10,12,16.7%,1h
20567,3,sdfdsfas,1964,40,1,6,7,14.3%,11m
20570,1,阿卜杜拉阿巴斯,1963,225,11,3,14,78.6%,51m
20570,3,我逆天,1963,178,7,7,14,50.0%,1h
20570,1,觉得很创建和删除,1963,0,0,1,1,0.0%,1h
20570,3,nnggg,1963,0,0,1,1,0.0%,49m
20574,1,宋国的江山,1962,90,2,2,4,50.0%,13m
20574,3,ABAMP,1962,0,0,1,1,0.0%,49m
20574,3,爸爸,1962,0,0,2,2,0.0%,1h
20577,2,酱紫无情,1961,94,4,17,21,19.0%,1h
20577,3,SKY,1961,0,2,3,5,40.0%,1h
20577,2,黑夜之深,1961,30,2,11,13,15.4%,1h
20577,3,ADSE,1961,0,1,5,6,16.7%,43m
20577,3,soO,1961,30,1,7,8,12.5%,1h
20582,1,DCWSKT,1960,856,21,24,45,46.7%,35m
20582,1,暮色秋叶,1960,334,8,9,17,47.1%,32m
20582,1,舞清风,1960,251,5,4,9,55.6%,48m
20582,2,Smile,1960,48,2,11,13,15.4%,1h
20582,3,朝思暮想冰,1960,0,0,7,7,0.0%,1h
20587,2,哈啥,1959,506,16,29,45,35.6%,1h
20587,1,高达,1959,122,4,14,18,22.2%,1h
20587,1,云书雾廖,1959,48,2,2,4,50.0%,1h
20590,3,休闲,1958,367,12,21,33,36.4%,1h
20590,3,静默小铁匠,1958,36,3,7,10,30.0%,60m
20590,1,夏川一田,1958,0,0,2,2,0.0%,3m
20593,2,永恒天幕,1957,138,3,10,13,23.1%,1h
20593,3,ThomasT,1957,0,1,1,2,50.0%,1h
20595,1,[邪然]星际乒乓,1956,1527,108,155,263,41.1%,42m
20595,1,我爱偷家,1956,315,14,13,27,51.9%,1h
20595,1,萌新,1956,416,10,10,20,50.0%,11m
20595,2,言生语,1956,158,6,6,12,50.0%,1h
20595,3,秋水镜明月,1956,30,1,8,9,11.1%,1h
20595,3,xinglian,1956,0,0,6,6,0.0%,1h
20601,3,yxiaowai,1955,0,2,5,7,28.6%,43m
20601,3,湖边树,1955,58,2,6,8,25.0%,1h
20603,1,颓废与堕落,1954,426,13,13,26,50.0%,28m
20603,3,[M8]晁宇昕,1954,58,2,2,4,50.0%,1h
20603,1,HappyLee,1954,0,0,1,1,0.0%,12m
20606,1,子系,1953,274,7,12,19,36.8%,15m
20606,2,lost,1953,40,2,9,11,18.2%,50m
20606,3,SJHJDH,1953,0,0,1,1,0.0%,1h
20609,3,大地图,1952,1021,44,55,99,44.4%,6m
20609,1,神密森林,1952,595,17,26,43,39.5%,1h
20609,3,Timba,1952,329,10,21,31,32.3%,1h
20609,3,winner,1952,0,0,5,5,0.0%,60m
20609,3,[XXHZ31]镜之瞳,1952,0,0,7,7,0.0%,1h
20614,2,baike,1951,148,5,11,16,31.2%,1h
20614,2,焊接工伟哥,1951,172,4,12,16,25.0%,46m
20614,2,坎坎坷坷,1951,134,3,12,15,20.0%,1h
20614,1,[第三帝國]RangerTazear,1951,0,1,0,1,100.0%,1h
20614,2,血鹰小昊昊,1951,0,1,0,1,100.0%,21m
20614,2,沉默,1951,0,0,9,9,0.0%,50m
20620,3,Albert,1950,195,12,27,39,30.8%,6m
20620,2,天启,1950,166,3,11,14,21.4%,24m
20620,3,sky,1950,60,2,6,8,25.0%,1h
20620,3,不敢,1950,0,0,2,2,0.0%,49m
20620,1,世事难有,1950,0,0,3,3,0.0%,1h
20625,3,zjh,1949,532,17,31,48,35.4%,12m
20625,2,达令晚安,1949,96,7,24,31,22.6%,1h
20625,1,梦与现实,1949,92,2,3,5,40.0%,50m
20625,3,韩东飞,1949,0,0,5,5,0.0%,60m
20629,3,末世残魂,1947,30,1,2,3,33.3%,1h
20630,3,[空中劈叉]伏特加红毛,1946,0,0,1,1,0.0%,1h
20630,3,老陈的铁憨憨,1946,0,0,5,5,0.0%,1h
20632,2,受打击了,1945,110,2,9,11,18.2%,46m
20633,1,kino,1944,475,16,18,34,47.1%,1h
20633,1,言葉,1944,529,15,27,42,35.7%,1h
20633,1,乳此可怕,1944,108,5,15,20,25.0%,4m
20633,1,eazy,1944,134,3,1,4,75.0%,5m
20633,1,[新手保护协会]IlluSioN,1944,44,1,1,2,50.0%,52m
20638,1,[欢迎新手]北岸初晴养老团,1942,294,8,19,27,29.6%,48m
20638,3,午夜幽冥,1942,84,3,11,14,21.4%,1h
20638,2,岸萤战死疑太子,1942,0,0,1,1,0.0%,1h
20638,3,死亡倒计时,1942,0,0,7,7,0.0%,49m
20642,3,战神可拉斯,1941,985,44,59,103,42.7%,32m
20642,3,天涯路远望卿珍重,1941,220,8,21,29,27.6%,1h
20642,2,重影,1941,170,5,13,18,27.8%,1h
20642,3,敲钟人,1941,0,0,1,1,0.0%,43m
20646,1,[看我朵蜜你]luoaotian,1940,202,7,7,14,50.0%,12m
20646,3,谁家的那小谁,1940,30,1,3,4,25.0%,27m
20648,3,星空伏地魔,1939,0,1,4,5,20.0%,49m
20648,3,LRH,1939,0,0,2,2,0.0%,1h
20650,1,一只探姬,1938,216,5,6,11,45.5%,13m
20650,3,Sueter,1938,88,3,11,14,21.4%,49m
20650,3,[少女的梦]小强,1938,44,2,5,7,28.6%,60m
20650,3,暴力公熊,1938,0,1,0,1,100.0%,27m
20650,1,暗影之龙,1938,0,1,0,1,100.0%,1h
20650,3,Alitalia,1938,0,0,6,6,0.0%,1h
20656,3,一堆虫子,1937,102,4,1,5,80.0%,1h
20656,3,执念,1937,36,3,6,9,33.3%,1h
20656,1,[TCronu]lvmyyang,1937,0,2,10,12,16.7%,1h
20656,1,Nick,1937,0,0,1,1,0.0%,1h
20660,2,人间不值得,1936,0,1,4,5,20.0%,1h
20661,1,凌战陛下,1935,84,2,2,4,50.0%,11m
20661,3,顾筠南歌,1935,0,1,0,1,100.0%,1h
20663,1,不会,1934,320,10,23,33,30.3%,1h
20663,1,globle,1934,0,1,4,5,20.0%,1h
20663,3,千尺渊海,1934,0,0,2,2,0.0%,13m
20663,1,[最菜战队]笑问苍天,1934,0,0,2,2,0.0%,12m
20667,2,[CPT]sky,1933,148,7,16,23,30.4%,1h
20667,3,Rogue,1933,92,3,10,13,23.1%,1h
20667,1,琼羽,1933,0,0,5,5,0.0%,1h
20670,2,OchiaiHatsu,1932,1334,59,80,139,42.4%,24m
20670,3,安徽小辣鸡,1932,90,4,11,15,26.7%,1h
20670,1,像风一样,1932,78,3,6,9,33.3%,1h
20673,3,落叶一随风,1931,653,25,42,67,37.3%,1h
20673,3,没事等得起,1931,254,11,19,30,36.7%,1h
20673,1,KOSKERS,1931,48,1,5,6,16.7%,50m
20676,1,千虫纵横,1929,560,16,25,41,39.0%,1h
20676,3,dkJAZK,1929,68,2,9,11,18.2%,1h
20676,1,比较宽容,1929,0,1,0,1,100.0%,1h
20676,3,[NtS媚娘队]阿斯塔的震怒,1929,0,0,1,1,0.0%,1h
20680,3,PGuanW,1928,409,17,17,34,50.0%,16m
20680,3,[星际萌妹纸]萌兔,1928,0,2,3,5,40.0%,49m
20680,3,怼烎,1928,0,0,2,2,0.0%,1h
20683,1,[荣光在等待着]Pandora,1927,92,3,4,7,42.9%,1h
20683,2,人类最强毒奶,1927,118,3,7,10,30.0%,1h
20683,1,[情谊至上]清道夫,1927,0,0,1,1,0.0%,3m
20686,3,杰洛斯,1926,133,4,8,12,33.3%,1h
20686,3,尛夵,1926,172,4,14,18,22.2%,1h
20686,3,随缘,1926,0,0,1,1,0.0%,43m
20689,3,尘以,1925,1327,68,97,165,41.2%,18m
20689,3,[KK开]晚沐,1925,284,10,24,34,29.4%,1h
20689,1,[张三忏悔录]狂妄张三,1925,174,8,19,27,29.6%,28m
20689,1,wait,1925,186,5,7,12,41.7%,48m
20689,3,等风,1925,0,2,5,7,28.6%,1h
20689,3,Stelatin,1925,46,1,7,8,12.5%,1h
20695,1,[无欲则刚]武媚,1924,185,6,11,17,35.3%,1h
20696,3,[LOHv]钢铁元,1923,1256,150,190,340,44.1%,1h
20696,3,[三国志群雄]大嘟嘟,1923,414,17,26,43,39.5%,1h
20696,1,有你什么事,1923,418,14,17,31,45.2%,1h
20696,2,天叶丶,1923,144,7,22,29,24.1%,1h
20700,1,心之逆鳞,1921,186,5,14,19,26.3%,32m
20700,3,[xyjxyc]芜铭,1921,68,3,9,12,25.0%,1h
20700,3,三斤,1921,84,2,5,7,28.6%,1h
20700,1,姓吴字三桂,1921,42,1,1,2,50.0%,57m
20704,1,战天下,1920,1890,79,106,185,42.7%,52m
20704,3,悟道,1920,525,51,68,119,42.9%,46m
20704,1,李鑫璐,1920,258,7,5,12,58.3%,1h
20704,2,夜晓鸿雁,1920,76,2,6,8,25.0%,46m
20704,3,setmefree,1920,0,0,3,3,0.0%,49m
20709,3,打爆你,1918,0,0,5,5,0.0%,1h
20710,1,[CnNami]菜鸟,1917,1751,53,64,117,45.3%,1h
20710,3,Wumx,1917,102,4,10,14,28.6%,1h
20712,1,永远喜欢坂井泉水,1915,338,11,15,26,42.3%,35m
20712,1,李宇炫,1915,178,6,16,22,27.3%,56m
20712,3,许三世暖阳,1915,30,2,4,6,33.3%,1h
20712,3,永言堂,1915,0,0,6,6,0.0%,1h
20716,3,[达拉姆督察]Accelerator,1914,1205,59,83,142,41.5%,1h
20716,1,[Rapier]schumidry,1914,426,11,12,23,47.8%,1h
20716,1,GRAY,1914,325,11,17,28,39.3%,1h
20716,3,KFC,1914,30,2,1,3,66.7%,49m
20716,3,念你初心不负,1914,0,0,2,2,0.0%,8m
20721,1,[全国修车]CyrusYU,1913,92,2,3,5,40.0%,1h
20721,1,削肾克,1913,42,1,3,4,25.0%,52m
20723,3,[LSH]辛赖滴丶,1911,0,0,6,6,0.0%,1h
20724,2,BigStone,1910,166,6,14,20,30.0%,54m
20724,2,开局退死妈,1910,136,4,12,16,25.0%,46m
20726,1,[以君之名]zhoushijie,1909,86,3,4,7,42.9%,1h
20727,3,DarkBoy,1907,62,2,5,7,28.6%,1h
20728,1,MikiSayaka,1906,682,20,41,61,32.8%,36m
20728,1,[YINGJI]沐渊,1906,477,12,24,36,33.3%,1h
20728,3,DEVIL,1906,0,3,2,5,60.0%,60m
20728,3,天翔龙闪,1906,106,3,11,14,21.4%,1h
20732,1,叶恋禅,1905,372,9,12,21,42.9%,1h
20732,3,灵梦,1905,0,0,1,1,0.0%,8m
20732,2,怡和,1905,0,0,1,1,0.0%,29m
20732,1,凌护,1905,0,0,2,2,0.0%,1h
20736,1,nmtg,1904,170,5,7,12,41.7%,1h
20737,1,余生,1903,380,11,10,21,52.4%,3m
20738,1,敖德萨,1902,892,27,34,61,44.3%,5m
20738,1,nslfdege,1902,0,1,0,1,100.0%,28m
20740,1,Cynicism,1901,88,2,4,6,33.3%,1h
20741,3,Bogus,1900,412,27,31,58,46.6%,12m
20741,1,伍拾贰赫兹,1900,508,12,16,28,42.9%,1h
20741,2,sasori,1900,150,8,21,29,27.6%,24m
20741,1,大风起兮云飞扬,1900,164,2,8,10,20.0%,1h
20741,1,虚空与流浪,1900,0,0,1,1,0.0%,3m
20746,2,太空找手,1899,299,10,8,18,55.6%,43m
20746,2,彭城祝公子,1899,88,2,4,6,33.3%,1h
20748,2,爱笑的张先生,1897,92,1,1,2,50.0%,1h
20748,3,END,1897,0,1,5,6,16.7%,42m
20748,2,西城秀,1897,0,0,1,1,0.0%,1h
20751,1,欧阳荀宇,1896,838,25,27,52,48.1%,1h
20751,3,大魔王,1896,116,5,9,14,35.7%,1h
20751,3,雷诺的爷爷,1896,136,4,3,7,57.1%,13m
20754,3,张某人,1895,0,1,0,1,100.0%,49m
20755,3,无敌的鲨鱼鲨鱼,1894,175,4,10,14,28.6%,1h
20755,3,[幽灵闪现wo]sdfdsf,1894,0,0,4,4,0.0%,1h
20757,1,争霸星际,1893,0,1,0,1,100.0%,1h
20758,1,YOURDADDY,1892,278,7,6,13,53.8%,1h
20758,1,万渊,1892,121,1,8,9,11.1%,1h
20758,3,[你瞧不起我吗]暗墓,1892,0,0,3,3,0.0%,1h
20761,2,QAQ,1891,150,4,12,16,25.0%,29m
20761,2,jiulets,1891,0,0,2,2,0.0%,21m
20763,1,一大坨坨坨,1890,170,5,2,7,71.4%,1h
20763,1,沉默的洒脱,1890,115,4,4,8,50.0%,1h
20763,3,SunFk,1890,30,1,8,9,11.1%,27m
20763,1,战春秋,1890,0,0,1,1,0.0%,1h
20763,1,盖茨比,1890,0,0,3,3,0.0%,50m
20768,1,东海大大,1889,0,0,1,1,0.0%,1h
20769,1,GHGG,1888,184,7,17,24,29.2%,13m
20769,3,赵大仙,1888,30,3,2,5,60.0%,13m
20769,3,蜡笔小辰,1888,0,2,4,6,33.3%,60m
20772,1,long,1886,140,3,4,7,42.9%,12m
20772,3,暗影牧师,1886,0,0,8,8,0.0%,1h
20774,1,曜日天使,1885,0,0,1,1,0.0%,1h
20775,1,hechenx,1884,200,8,8,16,50.0%,15m
20775,3,不会,1884,241,8,20,28,28.6%,1h
20775,3,甜甜咸咸,1884,30,1,10,11,9.1%,1h
20778,1,狗子不说唱,1883,95,2,5,7,28.6%,5m
20779,3,[科普卢星系]屈斌爱玩星际争霸,1882,1406,65,81,146,44.5%,37m
20780,1,美凌格,1881,0,0,4,4,0.0%,1h
20781,1,来吧,1880,295,12,14,26,46.2%,40m
20781,1,青鲨君,1880,265,7,18,25,28.0%,1h
20781,1,自由之羽,1880,0,1,4,5,20.0%,50m
20784,3,Jacques,1879,1456,113,141,254,44.5%,1h
20784,1,探索者,1879,96,4,16,20,20.0%,7m
20784,3,soline,1879,0,3,5,8,37.5%,1h
20784,3,宗依,1879,0,0,5,5,0.0%,1h
20788,3,上帅,1878,1164,84,109,193,43.5%,1h
20788,1,战神刑天,1878,132,4,6,10,40.0%,6m
20788,3,蜂巢传说,1878,124,4,10,14,28.6%,1h
20791,3,吉良吉影,1877,0,0,1,1,0.0%,1h
20792,1,wing,1876,0,0,1,1,0.0%,6m
20793,1,wyplgy,1875,286,7,7,14,50.0%,6m
20793,3,NJRR,1875,0,0,3,3,0.0%,43m
20795,1,Afei,1874,375,13,19,32,40.6%,13m
20796,1,ShiLing,1873,910,29,36,65,44.6%,1h
20796,2,daixiao,1873,88,1,1,2,50.0%,1h
20796,1,李一条,1873,73,0,2,2,0.0%,1h
20799,2,梦食,1872,264,10,14,24,41.7%,7m
20799,1,三只松鼠,1872,30,1,4,5,20.0%,32m
20799,2,狗狗,1872,0,1,10,11,9.1%,1h
20802,3,dashabi,1870,0,1,3,4,25.0%,27m
20803,2,无心静侍,1869,32,2,12,14,14.3%,45m
20803,3,李梓涵,1869,0,1,0,1,100.0%,1h
20805,1,root,1868,332,9,13,22,40.9%,7m
20805,3,Careerism,1868,0,0,2,2,0.0%,1h
20807,3,BAIYING,1867,0,0,1,1,0.0%,1h
20807,3,咸味豆腐脑,1867,0,0,4,4,0.0%,1h
20809,1,白袍丶小鬼,1866,692,18,29,47,38.3%,1h
20809,1,夜雨声烦,1866,30,2,1,3,66.7%,56m
20809,2,不死星灵,1866,95,1,10,11,9.1%,1h
20812,1,Sakura,1863,980,37,47,84,44.0%,1h
20812,1,hansdhs,1863,987,32,35,67,47.8%,1h
20812,1,ChenXs,1863,272,7,6,13,53.8%,1h
20812,2,埃蒙的追随者,1863,132,3,9,12,25.0%,1h
20816,1,BlackJoke,1862,161,4,2,6,66.7%,57m
20816,3,在此之间,1862,58,3,0,3,100.0%,1h
20816,1,血棱主,1862,0,0,1,1,0.0%,17m
20819,1,阿斯,1861,350,12,11,23,52.2%,1h
20819,3,Sun,1861,0,0,1,1,0.0%,13m
20821,2,daigo,1860,150,5,15,20,25.0%,1h
20822,1,[QF清风阁]小小莫得感情,1859,266,9,9,18,50.0%,28m
20822,3,yhy,1859,0,0,1,1,0.0%,1h
20824,3,主题,1858,0,2,7,9,22.2%,1h
20824,1,[废墟图书館]皮埃尔的带肉派,1858,0,1,0,1,100.0%,1h
20824,3,小丑,1858,0,0,8,8,0.0%,43m
20827,1,维爱,1857,418,11,24,35,31.4%,1h
20827,3,决定,1857,168,8,8,16,50.0%,42m
20829,2,为什么逼汗,1856,30,2,5,7,28.6%,17m
20830,1,杀戮之影,1854,694,20,39,59,33.9%,56m
20830,3,Alxer,1854,78,2,8,10,20.0%,1h
20830,2,昭临苏子,1854,0,1,5,6,16.7%,1h
20833,3,sreuw,1852,538,17,32,49,34.7%,1h
20833,3,大漠孤烟,1852,157,6,4,10,60.0%,1h
20833,3,JTR,1852,0,1,4,5,20.0%,1h
20833,3,猥琐达人,1852,0,0,1,1,0.0%,1h
20837,2,[ZVP打后期]MrSupCNMBCNM,1851,511,126,118,244,51.6%,28m
20838,3,[秋毫七队]老表白给,1849,0,0,1,1,0.0%,49m
20839,2,Henry,1848,115,2,12,14,14.3%,1h
20840,3,不落之翼,1847,0,0,1,1,0.0%,1h
20840,3,怕死的毒爆,1847,0,0,5,5,0.0%,1h
20842,2,哥就是浪,1846,224,5,15,20,25.0%,1h
20843,3,yasinjan,1844,959,36,52,88,40.9%,1h
20843,1,狼行者,1844,984,28,37,65,43.1%,52m
20843,3,Silence,1844,0,0,1,1,0.0%,49m
20843,3,jdsjdh,1844,0,0,3,3,0.0%,1h
20847,3,[F2ANB]允执厥中,1843,829,52,68,120,43.3%,1h
20847,1,Azathoth,1843,232,9,16,25,36.0%,1h
20847,2,TokyoVice,1843,94,2,4,6,33.3%,7m
20850,1,学医救不了暴雪,1842,279,13,1,14,92.9%,1h
20850,3,bujue,1842,0,1,2,3,33.3%,1h
20850,3,naichachaa,1842,0,0,8,8,0.0%,13m
20853,2,[Decemb]老子天下第一,1841,30,2,12,14,14.3%,17m
20853,3,[G868G]wryl,1841,0,0,1,1,0.0%,49m
20853,3,农夫,1841,0,0,1,1,0.0%,1h
20856,1,王不留行,1839,0,0,2,2,0.0%,1h
20857,1,快乐奶牛,1838,326,12,16,28,42.9%,7m
20857,3,孤独的九爷,1838,0,0,5,5,0.0%,27m
20859,2,坦克,1836,0,0,2,2,0.0%,1h
20860,1,夜晚一起看太阳,1835,88,2,2,4,50.0%,12m
20860,3,麦当,1835,30,2,7,9,22.2%,1h
20862,3,麦快玩麦块,1834,0,1,0,1,100.0%,42m
20863,2,风行者,1833,46,2,12,14,14.3%,17m
20863,3,[HAOREN]千年蟲,1833,0,0,4,4,0.0%,27m
20865,3,别无忈,1831,0,0,1,1,0.0%,1h
20866,1,Artaher,1830,784,45,69,114,39.5%,1h
20867,3,我是新手,1829,0,1,4,5,20.0%,60m
20868,2,名字真难取,1828,0,0,1,1,0.0%,24m
20869,1,黄瓜炒鸡蛋,1826,118,4,15,19,21.1%,48m
20870,2,挚爱韩菱纱,1817,0,1,0,1,100.0%,1h
20871,2,酸萝卜别吃,1815,238,7,19,26,26.9%,45m
20871,3,Firmiana,1815,0,0,1,1,0.0%,1h
20871,3,狂战风暴,1815,0,0,5,5,0.0%,1h
20874,1,terrenking,1814,240,5,16,21,23.8%,1h
20875,1,则野瞪破夜黯,1813,336,10,26,36,27.8%,1h
20876,2,泡泡茶壶,1812,164,5,14,19,26.3%,7m
20876,1,tom,1812,44,1,5,6,16.7%,3m
20878,3,小俊,1810,0,0,2,2,0.0%,1h
20879,1,无畏冲锋,1809,1591,56,71,127,44.1%,32m
20880,3,Aries,1808,0,0,1,1,0.0%,1h
20881,1,HOHOHOHO,1807,365,16,22,38,42.1%,1h
20881,3,jack,1807,0,3,3,6,50.0%,1h
20883,3,[伢伢乐]龙旭,1806,0,0,2,2,0.0%,1h
20883,3,星辰与你,1806,0,0,7,7,0.0%,1h
20885,2,战影,1804,218,5,18,23,21.7%,6m
20886,2,古老的旋律,1803,144,4,9,13,30.8%,51m
20887,2,华夏联盟南宮塗山,1802,44,1,3,4,25.0%,55m
20888,1,天天向上,1800,368,13,18,31,41.9%,1h
20888,1,罪孽深重,1800,360,9,18,27,33.3%,56m
20888,3,feile,1800,0,2,4,6,33.3%,1h
20891,2,同往独归,1799,44,2,13,15,13.3%,45m
20892,1,IIIIIIIII,1797,1402,41,61,102,40.2%,1h
20893,1,风影我是,1794,227,5,7,12,41.7%,28m
20893,1,三玖天下第一,1794,173,4,9,13,30.8%,28m
20895,2,龙与僵尸和骑士,1792,32,1,3,4,25.0%,57m
20896,3,御坂美琴我的我的,1791,30,2,1,3,66.7%,1h
20897,2,asdas,1790,1365,162,203,365,44.4%,28m
20897,3,叉子保护协会,1790,0,0,1,1,0.0%,49m
20899,3,张领导,1789,30,2,2,4,50.0%,49m
20900,1,此生不娶,1788,315,36,44,80,45.0%,15m
20900,3,Moonlight,1788,0,1,0,1,100.0%,1h
20902,2,战神大兜虫,1786,260,8,8,16,50.0%,21m
20903,3,iiiiii,1785,73,6,13,19,31.6%,1h
20904,2,白晓既,1783,0,0,1,1,0.0%,43m
20904,3,[完了卡人口了]法苏天女月磁光,1783,0,0,6,6,0.0%,13m
20906,3,long,1781,86,3,5,8,37.5%,1h
20907,3,水水水水,1780,337,10,27,37,27.0%,1h
20908,3,我为欣欣上王者,1777,246,9,8,17,52.9%,1h
20909,1,阿尔卡中尉,1775,204,5,11,16,31.2%,1h
20910,2,阿巴,1773,359,11,15,26,42.3%,1h
20910,3,wuukyuy,1773,138,6,4,10,60.0%,1h
20910,3,龙狼,1773,30,1,2,3,33.3%,1h
20913,3,moonlight,1772,0,0,6,6,0.0%,1h
20914,3,暴火冰雷,1771,170,6,14,20,30.0%,4m
20914,3,起初的相遇,1771,0,0,9,9,0.0%,1h
20916,2,Dash,1768,598,17,32,49,34.7%,1h
20916,3,泡泡茶壶,1768,0,0,1,1,0.0%,43m
20918,1,随缘,1765,461,12,22,34,35.3%,32m
20919,1,[M8]微恋之风,1764,1534,49,78,127,38.6%,6m
20919,2,戮世魔罗,1764,134,4,16,20,20.0%,54m
20919,3,漏斗蛋糕,1764,0,0,3,3,0.0%,1h
20922,2,[慢手e族]战神,1762,500,19,15,34,55.9%,1h
20922,2,TimE,1762,422,16,19,35,45.7%,46m
20924,3,逍遥自在,1761,0,1,6,7,14.3%,13m
20925,3,净化者探姬,1757,0,0,2,2,0.0%,49m
20926,3,破灭,1755,30,2,6,8,25.0%,60m
20926,2,旌旗十万斩阎罗,1755,0,1,0,1,100.0%,45m
20928,3,[玖天揽玥]hyc,1754,30,1,5,6,16.7%,1h
20929,3,lbwnb,1752,58,2,2,4,50.0%,1h
20930,3,befall,1750,0,0,1,1,0.0%,49m
20931,1,dajiabagege,1745,1074,33,64,97,34.0%,40m
20932,3,半角,1744,0,0,1,1,0.0%,1h
20932,3,喜欢二年六班赵文,1744,0,0,9,9,0.0%,1h
20934,2,xjw,1743,0,1,1,2,50.0%,46m
20935,1,为我活,1741,0,0,7,7,0.0%,56m
20936,1,岚银,1737,427,14,19,33,42.4%,5m
20936,2,TISSOT,1737,0,0,2,2,0.0%,56m
20938,3,darkness,1736,0,0,2,2,0.0%,1h
20939,3,烽烟,1731,0,1,5,6,16.7%,1h
20939,2,zhanghehe,1731,0,0,1,1,0.0%,1h
20941,2,LAY,1730,312,9,29,38,23.7%,45m
20942,1,大干蒸,1728,410,10,30,40,25.0%,1h
20943,3,无药之竞,1727,192,8,7,15,53.3%,8m
20943,3,JOKER,1727,0,0,8,8,0.0%,1h
20945,3,胜利红石,1726,0,0,6,6,0.0%,42m
20946,1,月亮不睡我不睡,1724,440,12,32,44,27.3%,8m
20947,3,iamlsp,1722,164,5,16,21,23.8%,1h
20947,2,霹雳神州战神,1722,167,4,6,10,40.0%,17m
20949,2,千两狂死郎,1721,399,20,41,61,32.8%,31m
20949,3,mon,1721,0,0,1,1,0.0%,13m
20951,2,白衣凰,1719,0,0,1,1,0.0%,51m
20952,2,chani,1717,86,4,7,11,36.4%,1h
20952,3,UZL,1717,46,1,6,7,14.3%,1h
20954,2,寂寞的小乐,1716,242,7,19,26,26.9%,17m
20955,2,天之涯海之南,1715,0,0,1,1,0.0%,45m
20956,2,Metaco,1714,394,11,22,33,33.3%,29m
20956,1,御临,1714,74,2,8,10,20.0%,4m
20958,1,[菜鸟战队]万物风化,1712,534,15,37,52,28.8%,35m
20958,3,龙皇,1712,0,0,2,2,0.0%,27m
20960,3,老二次元了,1711,60,6,4,10,60.0%,1h
20961,3,见青山,1707,114,3,13,16,18.8%,42m
20962,1,tian,1703,134,3,12,15,20.0%,56m
20962,3,ghost,1703,0,0,2,2,0.0%,1h
20964,1,海底的菠萝屋,1699,162,6,15,21,28.6%,28m
20965,2,Genie,1698,0,0,2,2,0.0%,1h
20966,2,星际练习生,1696,232,9,0,9,100.0%,1h
20966,3,诺斯,1696,0,0,5,5,0.0%,1h
20968,2,第九号,1694,0,0,1,1,0.0%,46m
20969,3,[暴风雨]布死甜汤,1690,132,4,11,15,26.7%,27m
20970,3,sqska,1687,0,0,1,1,0.0%,1h
20970,3,kenzhou,1687,0,0,7,7,0.0%,43m
20972,2,ssj,1683,66,3,2,5,60.0%,1h
20973,3,hkjhg,1680,30,1,2,3,33.3%,49m
20974,2,冷星月光,1678,40,1,3,4,25.0%,1h
20975,2,挽楓,1674,0,0,5,5,0.0%,46m
20976,1,蒋晓炜,1673,204,5,20,25,20.0%,56m
20977,2,刀问今生,1671,308,7,22,29,24.1%,1h
20978,2,whao,1665,360,12,25,37,32.4%,17m
20979,3,GCU,1664,1260,108,175,283,38.2%,42m
20980,3,德鲁大叔,1656,156,8,16,24,33.3%,1h
20981,3,[太阳与野花]不是假发是桂,1650,0,0,5,5,0.0%,49m
20982,3,Cherry,1645,0,0,4,4,0.0%,1h
20983,3,山茶花爿元宵,1641,0,0,1,1,0.0%,8m
20984,2,大虾,1634,336,7,25,32,21.9%,17m
20985,3,drem,1631,30,2,7,9,22.2%,1h
20986,2,[ENB]EmmyNicole,1624,0,0,5,5,0.0%,17m
20987,3,外号非对称选手,1618,938,103,100,203,50.7%,1h
20988,3,我就爱吃喵喵丶,1617,108,3,16,19,15.8%,49m
20989,3,DESTRUCTION,1614,64,2,11,13,15.4%,1h
20990,3,你的手速真快啊,1610,30,3,6,9,33.3%,1h
20991,3,洗手间风暴,1609,0,2,3,5,40.0%,1h
20992,3,tmr,1606,128,5,2,7,71.4%,1h
20993,3,战翼,1605,60,2,4,6,33.3%,49m
20994,3,曙鸦,1604,108,3,6,9,33.3%,1h
20995,3,TiMi,1598,0,0,1,1,0.0%,8m
20996,3,歪比巴布,1595,98,4,19,23,17.4%,1h
20997,2,打死你个龟儿子,1594,253,5,22,27,18.5%,7m
20998,2,HelloStar,1593,192,6,21,27,22.2%,43m
20999,3,长城,1580,30,2,1,3,66.7%,1h
21000,1,TIMBA,1577,405,10,72,82,12.2%,1h
21001,3,[新手保护协会]发现世界,1574,30,1,11,12,8.3%,49m
21002,3,Axis,1573,92,4,17,21,19.0%,42m
21003,3,中二领主高建国,1567,0,0,9,9,0.0%,13m
21004,3,三无先生,1559,58,3,1,4,75.0%,1h
21005,2,沧海一声,1549,761,22,60,82,26.8%,17m
21006,3,别骂了别骂了我菜,1500,0,0,1,1,0.0%,13m
21007,3,天下羽化尘,1494,0,0,5,5,0.0%,27m
21008,2,shui,1493,771,39,67,106,36.8%,1h
21009,3,[莫扎特]茜茜公主,1477,0,1,0,1,100.0%,27m
21010,3,IIIIIIIIIII,1465,0,0,1,1,0.0%,1h
21011,3,ApmJustThree,1458,30,2,0,2,100.0%,42m
21012,3,xryv,1402,0,0,2,2,0.0%,1h
21013,3,[小小兔]小小兔,1389,0,0,1,1,0.0%,1h
21014,3,[黄旭东的父亲]南京水男,1347,0,0,1,1,0.0%,1h
21015,3,艹丶仩沵滿嬑,1309,0,0,1,1,0.0%,49m
21016,3,madfrogfov,1231,0,0,1,1,0.0%,49m
21017,3,痛苦的温暖,1225,0,0,1,1,0.0%,1h
21018,3,[大元师]starcratt,1157,0,0,2,2,0.0%,1h
21019,3,Leo,1081,0,0,1,1,0.0%,1h
21020,3,HRC,1023,316,9,72,81,11.1%,60m
21021,3,黄旭东,935,0,0,1,1,0.0%,1h
21022,3,[镜花水月]天狼星,872,0,1,0,1,100.0%,27m
21023,3,IIIIIIIIIIII,671,0,1,0,1,100.0%,42m
21024,3,IIIIIIIIIIII,594,30,1,32,33,3.0%,1h
21025,3,[这把打快攻]阿吧阿吧,256,0,1,0,1,100.0%,1h
