rank,tier,name,mmr,points,wins,losses,played,winrate,age
1,1,DieMauer,7172,0,1,0,1,100.0%,11m
2,1,IlIlIlIlIlIl,7165,0,1,0,1,100.0%,15m
3,1,DieMauer,6986,4357,546,177,723,75.5%,2m
4,1,[Ex0n]MaxPax,6908,1465,61,26,87,70.1%,11m
5,1,llIllIllIllI,6849,4264,199,98,297,67.0%,2m
6,1,[сSсǃ]GunGFuBanDa,6844,2388,121,72,193,62.7%,11m
7,1,[TlNG]Neeblet,6788,1871,272,129,401,67.8%,10m
8,1,[Blacer]Krystianer,6715,2151,240,116,356,67.4%,2m
9,1,[сSсǃ]SKillous,6688,288,7,0,7,100.0%,2m
10,1,IlIlIlIlIlIl,6667,4115,419,268,687,61.0%,2m
11,1,TheCowboy,6666,4133,356,192,548,65.0%,2m
12,1,SheriffGuana,6658,4122,166,115,281,59.1%,2m
13,1,TLHarstem,6650,2411,56,23,79,70.9%,4m
14,1,[ArGGEU]ShaDoWn,6635,2218,126,76,202,62.4%,11m
15,1,llIlIlIllIIl,6629,73,0,1,1,0.0%,4m
16,1,IIIIIIIIIIII,6627,410,9,1,10,90.0%,2m
17,1,[QLASH]HellraiseR,6610,1744,51,20,71,71.8%,2m
18,1,LiquidMaNa,6554,4058,274,144,418,65.6%,2m
19,1,llllllllllll,6553,835,37,19,56,66.1%,15m
20,1,DrogoTalks,6543,1869,100,55,155,64.5%,9m
21,1,lIlIlIlIlIlI,6522,4036,134,85,219,61.2%,2m
22,1,IlIlIlIlIlIl,6504,497,18,16,34,52.9%,2m
23,1,[сSсǃ]SKILLOUS,6490,3976,244,131,375,65.1%,2m
24,1,[TRotti]goblin,6485,2747,105,93,198,53.0%,2m
25,1,llIlIllIlIll,6463,432,9,5,14,64.3%,35m
26,1,[Ex0n]Geralt,6459,3770,325,220,545,59.6%,2m
27,1,IIIIIIIIIIII,6458,336,8,3,11,72.7%,4m
28,1,LiquidClem,6454,3753,152,87,239,63.6%,2m
29,1,llllllllllll,6430,0,1,0,1,100.0%,15m
30,1,IIIIIIIIIIII,6429,0,1,0,1,100.0%,18m
31,1,[AvrilT]AvrilLavigne,6390,48,2,0,2,100.0%,17m
32,1,llllllllllll,6387,1159,33,13,46,71.7%,2m
33,1,llllllllllll,6374,624,13,4,17,76.5%,11m
34,1,[αX]Astrea,6353,3065,87,67,154,56.5%,2m
35,1,[ROOT]DisK,6325,551,11,2,13,84.6%,2m
36,1,Tassadary,6322,0,0,1,1,0.0%,13m
37,1,lllIlllIllIl,6300,672,15,7,22,68.2%,12m
38,1,BKW,6281,1083,44,9,53,83.0%,13m
39,1,[WinX]Progamer,6275,146,22,9,31,71.0%,12m
40,1,lllllllllll,6247,348,80,57,137,58.4%,34m
41,1,[ArGGEU]Spatz,6242,3848,324,235,559,58.0%,2m
42,1,ScottSpark,6238,1616,53,15,68,77.9%,2m
43,1,[Ex0n]Adonminus,6222,1868,75,59,134,56.0%,2m
43,1,[ZGKA]IMBAPI,6222,0,1,0,1,100.0%,15m
45,1,[Нasu]Nicoract,6218,0,0,1,1,0.0%,35m
46,1,IIIIIIIIIIII,6217,0,1,0,1,100.0%,8m
47,1,KanyeWest,6213,1642,70,48,118,59.3%,4m
48,1,[BeSC]HolyHit,6183,480,11,12,23,47.8%,11m
49,1,[Hаsu]MindelVK,6173,1680,66,52,118,55.9%,14m
50,1,llllllllllll,6172,192,5,0,5,100.0%,32m
51,1,[ArGGEU]Marsman,6166,1351,110,86,196,56.1%,18m
52,1,[EZ4XY]iGMacSed,6161,964,41,21,62,66.1%,11m
53,1,llllllllllll,6155,3560,141,95,236,59.7%,2m
54,1,IIIIIIIIIIII,6144,528,11,8,19,57.9%,12m
55,1,IIIIIIIIII,6137,1042,23,9,32,71.9%,17m
56,1,HeckinHecker,6126,456,23,10,33,69.7%,10m
57,1,[Blacer]PAPI,6120,2969,92,72,164,56.1%,2m
58,1,Rail,6119,294,5,12,17,29.4%,13m
58,1,llllllllllll,6119,0,1,0,1,100.0%,11m
60,1,Lambo,6116,0,1,0,1,100.0%,14m
61,1,EterNaL,6115,808,63,46,109,57.8%,4m
62,1,Arjael,6112,480,11,7,18,61.1%,14m
63,1,Grimmy,6111,96,2,2,4,50.0%,14m
64,1,[Ex0n]Krr,6109,983,136,110,246,55.3%,10m
65,1,IIIIIIIIIIII,6105,192,5,9,14,35.7%,17m
66,1,IIIIIIIIIIII,6094,3685,177,137,314,56.4%,2m
67,1,[αX]ArT,6090,3419,128,81,209,61.2%,2m
68,1,llllllllllll,6077,96,2,2,4,50.0%,35m
69,1,oliM,6061,3055,110,84,194,56.7%,2m
70,1,[Sarmat]Indy,6058,48,2,3,5,40.0%,15m
71,1,IIIIIIIIIIII,6055,48,1,1,2,50.0%,10m
72,1,[ArGGEU]EnigmA,6053,2880,95,77,172,55.2%,2m
73,1,lIlIlIlIlIlI,6046,586,56,9,65,86.2%,10m
74,1,llllllllllll,6043,0,0,1,1,0.0%,13m
75,1,IlIlIlIlIlIl,6024,2882,121,112,233,51.9%,2m
75,1,llllllllllll,6024,672,17,11,28,60.7%,35m
77,1,sumargadA,6020,48,1,4,5,20.0%,11m
78,1,[RеG]GeNieS,6016,1747,44,37,81,54.3%,2m
78,1,[BRSKR]Fallenger,6016,0,0,3,3,0.0%,9m
80,1,[ArGGEU]FrisK,6015,0,0,1,1,0.0%,6m
81,1,[n33b]PeterPan,6011,0,1,0,1,100.0%,15m
82,1,[αX]Rodzyn,6009,3282,176,133,309,57.0%,2m
83,1,[TRotti]TheEagle,6008,240,5,6,11,45.5%,11m
84,1,Layt,5998,144,4,1,5,80.0%,10m
85,1,IIIIIIIIIIII,5996,1184,26,13,39,66.7%,8m
86,1,Hawk,5995,3644,271,182,453,59.8%,2m
87,1,[3Dǃ]Couguar,5993,1964,99,85,184,53.8%,2m
88,1,[ZELA]NewPatchToss,5992,574,14,14,28,50.0%,15m
89,1,[αX]Arrogfire,5989,1952,135,105,240,56.2%,4m
90,1,[TRotti]TheNotorious,5983,0,1,0,1,100.0%,11m
91,1,llllllllllll,5982,96,2,5,7,28.6%,15m
92,1,GrapeWizard,5967,1311,162,93,255,63.5%,3m
93,1,[XYFANN]Mage,5960,499,42,29,71,59.2%,17m
94,1,WhiteNight,5958,1053,41,29,70,58.6%,13m
95,1,IIIIIllIIIII,5957,2329,66,50,116,56.9%,2m
96,1,IIIIIIIIIII,5953,0,0,1,1,0.0%,10m
97,1,[TRotti]PacMaN,5948,48,1,2,3,33.3%,11m
98,1,[200png]PattyMac,5945,48,2,0,2,100.0%,35m
99,1,[QTcIub]Beastyqt,5923,2169,84,66,150,56.0%,9m
100,1,ABomB,5917,785,30,20,50,60.0%,4m
101,1,[HBGS]SickNess,5908,618,24,9,33,72.7%,2m
102,1,IIIIIIIIIIII,5904,2050,59,56,115,51.3%,2m
103,1,[TheDOH]FightingFrog,5902,3571,387,327,714,54.2%,2m
104,1,MrDecember,5900,1515,179,81,260,68.8%,32m
105,1,[TheDOH]ZAiN,5899,0,0,2,2,0.0%,13m
106,1,Keanu,5891,3562,333,290,623,53.5%,2m
106,1,[Огурец]SlyCrab,5891,2149,138,103,241,57.3%,9m
106,1,Reynor,5891,48,1,3,4,25.0%,18m
109,1,[ArGGEU]Ladabaz,5885,1663,130,98,228,57.0%,11m
109,1,llllllllllll,5885,960,21,10,31,67.7%,4m
111,1,CarstenStahl,5880,0,3,2,5,60.0%,35m
112,1,Ace,5873,48,2,0,2,100.0%,8m
113,1,[HBGS]Irbis,5869,585,21,14,35,60.0%,9m
113,1,[SubTo]Nina,5869,0,0,7,7,0.0%,8m
115,1,TheMusZero,5866,888,37,29,66,56.1%,2m
116,1,Ĺĩťčĥ,5862,914,34,35,69,49.3%,2m
117,1,arboCgniK,5859,432,9,10,19,47.4%,32m
118,1,[TRotti]OpTiMiStC,5850,1336,49,29,78,62.8%,9m
119,1,[QLASH]RotterdaM,5845,3459,297,252,549,54.1%,2m
120,1,[TSO1]TheSilentOne,5844,440,26,11,37,70.3%,4m
121,1,Lilbow,5841,3540,334,232,566,59.0%,2m
122,1,[Ex0n]ForJumY,5839,2258,77,63,140,55.0%,2m
123,1,Eightman,5834,1146,75,63,138,54.3%,34m
124,1,Квакич,5831,884,49,40,89,55.1%,34m
125,1,SolarFan,5830,3462,147,94,241,61.0%,2m
126,1,[БУБУБ]ФАНАТБУБУБА,5828,2911,99,80,179,55.3%,2m
126,1,[ArGGEU]SlyCrab,5828,0,1,0,1,100.0%,8m
128,1,magarrok,5824,2500,200,173,373,53.6%,9m
129,1,LeAfterParty,5816,3164,171,116,287,59.6%,2m
129,1,[DemuCl]demuLarva,5816,870,30,21,51,58.8%,2m
131,1,Flounder,5811,2658,84,61,145,57.9%,2m
132,1,[ОБЗМ]WannaBeVan,5807,2623,114,28,142,80.3%,2m
132,1,[TRotti]Rondaaaaaa,5807,1989,111,97,208,53.4%,2m
134,1,[сSсǃ]soul,5803,48,2,3,5,40.0%,8m
135,1,[НТТ]HellraiseR,5800,624,14,9,23,60.9%,15m
136,1,JoeDevlin,5796,1473,54,18,72,75.0%,2m
137,1,[ePunks]SpaceMarine,5795,937,64,56,120,53.3%,8m
138,1,[NVY]MiserySignal,5790,688,27,13,40,67.5%,14m
139,1,[Ex0n]Ruiyichi,5784,3432,166,134,300,55.3%,2m
140,1,llllllllllll,5781,330,19,12,31,61.3%,6m
140,1,IIIIIIIIIIII,5781,0,1,1,2,50.0%,13m
142,1,llllllllllll,5778,151,3,9,12,25.0%,10m
143,1,[mup]ForJimmy,5777,535,20,14,34,58.8%,2m
143,1,[РUNK]lemonka,5777,144,3,10,13,23.1%,8m
145,1,Ronaldinho,5775,240,6,1,7,85.7%,4m
146,1,lIlIlIlIlIlI,5771,48,1,1,2,50.0%,6m
147,1,IIIIIIIIIIII,5765,3437,167,148,315,53.0%,2m
148,1,[HBGS]Grimmy,5759,521,27,35,62,43.5%,3m
148,1,llllllllllll,5759,96,3,2,5,60.0%,4m
150,1,IIIIIIIIIIII,5755,3475,294,249,543,54.1%,2m
151,1,[PMǂ]freizy,5747,3426,138,110,248,55.6%,2m
152,1,[PMǂ]JustLikeFire,5742,3257,209,170,379,55.1%,2m
153,1,Alluton,5733,3363,401,347,748,53.6%,2m
154,1,[DHiWe]MightyThor,5730,754,105,92,197,53.3%,8m
155,1,[BRSKR]HydrA,5727,510,18,13,31,58.1%,11m
155,1,[n33b]Phil,5727,0,1,0,1,100.0%,15m
157,1,MyGRAiN,5726,3042,296,270,566,52.3%,2m
158,1,HânTattoo,5720,616,38,33,71,53.5%,34m
159,1,llllllllllll,5718,722,16,13,29,55.2%,11m
160,1,[Li3]MrMiyagi,5713,2704,92,76,168,54.8%,2m
160,1,[GdAT]GyulzzinG,5713,0,1,0,1,100.0%,4m
162,1,llllllllllll,5711,956,32,25,57,56.1%,6m
163,1,llIllIllIlll,5710,3131,260,232,492,52.8%,2m
164,1,[БУБУБ]БУБИБ,5707,48,1,1,2,50.0%,4m
165,1,llllllllllll,5705,1169,28,27,55,50.9%,2m
166,1,IIIIIIIIIIII,5704,48,1,2,3,33.3%,11m
167,1,[150png]Marshall,5703,430,9,2,11,81.8%,34m
168,1,FrenсhSlayer,5700,787,32,15,47,68.1%,15m
169,1,[ArGGEU]JaCkal,5694,1456,33,37,70,47.1%,4m
170,1,[PRОTОS]OPERATOR,5691,1611,76,62,138,55.1%,13m
171,1,[aAa]PsiOniC,5690,0,0,1,1,0.0%,14m
172,1,[Фаталя]GachiMan,5687,3359,430,360,790,54.4%,2m
173,1,IIIIIIIIIIII,5682,1091,38,33,71,53.5%,32m
173,1,llllllllllll,5682,1122,36,36,72,50.0%,15m
175,1,[ROOT]Robbie,5681,431,9,3,12,75.0%,2m
176,1,HsiaoKang,5674,334,7,6,13,53.8%,14m
177,1,[HBGS]FroZy,5673,977,31,34,65,47.7%,11m
178,1,Claptrap,5672,478,11,13,24,45.8%,10m
179,1,Panspérmia,5670,670,14,10,24,58.3%,3m
180,1,Grimmus,5664,1689,88,28,116,75.9%,2m
181,1,Playa,5663,508,12,5,17,70.6%,18m
182,1,IlIlIlIlIlIl,5659,1888,287,245,532,53.9%,8m
183,1,[IBeAŚI]Rhoust,5658,3218,213,173,386,55.2%,2m
184,1,printf,5653,1338,53,58,111,47.7%,18m
185,1,UedSoldier,5651,2204,77,65,142,54.2%,2m
186,1,llllllllllll,5646,73,1,2,3,33.3%,13m
187,1,IIIIIIIIIIII,5644,0,1,0,1,100.0%,11m
188,1,[ArGGEU]CripSeil,5643,2173,65,57,122,53.3%,2m
189,1,[MeRa]AIWWAPEPSI,5642,0,1,0,1,100.0%,34m
190,1,[XYFAN]INcuBo,5640,1975,56,45,101,55.4%,2m
191,1,[ArGGEU]MoonBeam,5639,431,33,24,57,57.9%,6m
191,1,Nerazim,5639,96,2,1,3,66.7%,11m
193,1,Daniel,5637,0,1,0,1,100.0%,6m
194,1,[PÂRłAH]uniQFazer,5636,2324,194,167,361,53.7%,2m
195,1,[IceHus]АЛКОГОЛИК,5634,0,0,1,1,0.0%,11m
196,1,ДiдПанас,5633,293,53,20,73,72.6%,34m
197,1,IIIIIIIIIIII,5628,3178,602,570,1172,51.4%,2m
197,1,[Trulli]ItzYumy,5628,3380,521,484,1005,51.8%,2m
199,1,ДжохниПрогей,5624,437,15,6,21,71.4%,10m
200,1,[MSUSC2]ShiFu,5612,48,1,2,3,33.3%,32m
201,1,IIIIIIIIIII,5610,240,6,2,8,75.0%,13m
202,1,Hardwell,5608,529,20,18,38,52.6%,2m
203,1,[CS0]EastToss,5605,632,14,13,27,51.9%,2m
204,1,IGotRejected,5604,1053,29,24,53,54.7%,17m
205,1,[Ex0n]Ryan,5601,1610,67,49,116,57.8%,35m
206,1,[RеG]PPower,5600,144,3,8,11,27.3%,4m
207,1,[Ex0n]ReSpOnSe,5599,1801,100,81,181,55.2%,9m
208,1,XyOn,5598,0,0,1,1,0.0%,11m
209,1,[НТТ]ART,5593,2145,148,93,241,61.4%,4m
210,1,IIIIIIIIIIII,5592,1705,182,167,349,52.1%,9m
210,1,Bruges,5592,1469,60,53,113,53.1%,13m
212,1,llllllllllll,5588,2055,209,172,381,54.9%,14m
213,1,[RøckeT]ElClochar,5584,1037,51,20,71,71.8%,32m
214,1,GetAnalysed,5578,48,1,2,3,33.3%,11m
215,1,[Blacer]Ziomek,5574,1836,99,89,188,52.7%,32m
215,1,[OFFpro]Milka,5574,286,6,15,21,28.6%,8m
217,1,Arima,5564,0,0,1,1,0.0%,32m
217,1,ZiziChibrant,5564,0,0,5,5,0.0%,34m
219,1,IIIIIIIIIIII,5562,94,2,6,8,25.0%,4m
220,1,ColonelK,5547,0,0,1,1,0.0%,4m
221,1,FunK,5546,790,32,34,66,48.5%,2m
222,1,Komorebi,5545,706,16,13,29,55.2%,11m
223,1,[MASTЕR]шифу,5544,2532,97,81,178,54.5%,2m
224,1,[0Team]RiSky,5543,412,10,8,18,55.6%,18m
225,1,RinKokonoe,5542,0,0,2,2,0.0%,4m
226,1,[RеG]papastreck,5541,2664,376,329,705,53.3%,2m
226,1,[IBeAŚI]MariK,5541,2637,371,340,711,52.2%,2m
226,1,[b100sc]Vanya,5541,186,5,2,7,71.4%,32m
229,1,Kaldwin,5539,1874,563,497,1060,53.1%,11m
229,1,JeanMarineRC,5539,0,0,1,1,0.0%,8m
231,1,[HBGS]Overpass,5538,0,1,0,1,100.0%,12m
232,1,TcUltimate,5533,2715,388,377,765,50.7%,2m
232,1,IIIIIIIIIIII,5533,2384,118,97,215,54.9%,2m
232,1,IIIIIIIIIIII,5533,1100,40,40,80,50.0%,2m
235,1,Bubbas,5529,2504,285,270,555,51.4%,2m
236,1,[ENCE]Welmu,5528,790,156,138,294,53.1%,11m
236,1,IIIIIIIIIIII,5528,1576,94,35,129,72.9%,2m
238,1,YoungRonin,5526,720,29,11,40,72.5%,14m
239,1,[SТАR]Kas,5525,857,30,25,55,54.5%,2m
240,1,[EBIG]Eiger,5522,1905,52,52,104,50.0%,2m
241,1,[Oath]Seracis,5520,2307,173,158,331,52.3%,2m
242,1,[αX]Asuna,5519,1965,125,116,241,51.9%,6m
242,1,Zeth,5519,48,1,1,2,50.0%,13m
244,1,IcKmore,5515,386,15,14,29,51.7%,14m
245,1,[GoldM]Bumbz,5514,2100,540,453,993,54.4%,13m
245,1,Firemoon,5514,0,0,1,1,0.0%,35m
247,1,[αX]DojoGamer,5513,2234,73,61,134,54.5%,2m
248,1,PlayLikeTrap,5512,1316,59,38,97,60.8%,4m
249,1,hedislimane,5510,336,8,2,10,80.0%,12m
250,1,MagicPT,5507,2618,266,212,478,55.6%,2m
251,1,FlatEarther,5505,840,45,4,49,91.8%,34m
251,1,IIIIIIIIIIII,5505,0,1,0,1,100.0%,4m
253,1,[RеG]removeprotos,5503,0,0,3,3,0.0%,15m
254,1,PÜSSYHUNTER,5500,2280,124,118,242,51.2%,2m
254,1,zzHey,5500,655,26,9,35,74.3%,3m
256,1,[ArGGEU]Ricus,5499,1638,78,55,133,58.6%,2m
257,1,Jin,5498,2521,212,182,394,53.8%,2m
258,1,llllllllllll,5494,1819,189,112,301,62.8%,15m
259,1,[IBeAŚI]jumanjii,5493,144,4,9,13,30.8%,12m
260,1,[DOJO]KarateKid,5492,2786,355,333,688,51.6%,35m
261,1,[Li3]Btmn,5484,682,16,10,26,61.5%,13m
262,1,[ArGGEU]Célia,5482,1959,183,168,351,52.1%,8m
263,1,lllllllllll,5481,596,22,20,42,52.4%,3m
264,1,[KEKWW]ProToSEZRace,5477,2213,121,78,199,60.8%,32m
265,1,[7x]KpeHgeJIb,5474,1392,48,41,89,53.9%,2m
266,1,[NetGG]Lightman,5472,0,0,1,1,0.0%,2m
267,1,[Hаsu]Tiger,5470,2330,383,321,704,54.4%,2m
268,1,Kumiko,5469,2204,127,82,209,60.8%,32m
269,1,lIlIlIlIlIlI,5467,0,1,2,3,33.3%,6m
270,1,Warbringer,5466,2295,192,167,359,53.5%,9m
270,1,[Oath]eagle,5466,0,0,1,1,0.0%,11m
272,1,IIIlllIIIlll,5465,282,7,9,16,43.8%,15m
273,1,[PLA2N]Solarian,5463,0,0,1,1,0.0%,3m
274,1,IIIIIIIIIIII,5461,48,2,3,5,40.0%,8m
275,1,Farelowsnu,5456,1463,72,54,126,57.1%,8m
276,1,[3Dǃ]ƎDǃBee,5455,1087,32,28,60,53.3%,35m
277,1,Okimuk,5454,2112,80,46,126,63.5%,35m
278,1,Inzane,5453,0,0,1,1,0.0%,4m
279,1,[aW]Yuhmo,5449,2184,72,52,124,58.1%,13m
279,1,[n33b]Sorpresa,5449,46,1,3,4,25.0%,8m
281,1,[PaniC]ДжохниПрогей,5447,0,1,0,1,100.0%,4m
282,1,EinfacheKI,5443,48,2,0,2,100.0%,9m
283,1,PeaceDeath,5439,94,2,2,4,50.0%,18m
284,1,самыйпотный,5437,0,2,4,6,33.3%,9m
285,1,llllllllllll,5436,97,3,0,3,100.0%,4m
286,1,[RеG]Bobon,5434,2125,123,114,237,51.9%,12m
287,1,RabbieBurns,5433,2999,328,310,638,51.4%,4m
288,1,[vgdunk]BEEGYOSHI,5432,0,0,1,1,0.0%,34m
289,1,flow,5430,1292,52,49,101,51.5%,11m
290,1,Mute,5429,792,49,43,92,53.3%,4m
291,1,[Draigo]Coucoute,5427,0,1,0,1,100.0%,11m
292,1,RedFactor,5426,0,1,0,1,100.0%,35m
293,1,wenez,5423,48,2,2,4,50.0%,32m
294,1,[FATDEB]WolloB,5422,464,10,10,20,50.0%,11m
295,1,[αX]Exostriker,5421,1377,64,62,126,50.8%,4m
296,1,[Li3]WhiskeyJack,5418,0,0,6,6,0.0%,8m
297,1,[PLA2N]RazvaZAR,5415,2897,137,113,250,54.8%,34m
297,1,[RevoGG]FeaR,5415,636,14,13,27,51.9%,15m
299,1,[GSL69]FiteSumCrime,5414,246,6,6,12,50.0%,34m
300,1,Havoc,5407,1856,79,76,155,51.0%,10m
301,1,IIIIIIIIIIII,5404,607,22,31,53,41.5%,34m
302,1,[НТТ]slshrz,5403,424,10,10,20,50.0%,6m
303,1,IIIIIIIIIIII,5401,3206,252,207,459,54.9%,13m
304,1,[SƬǂ]ƝotMirtiƪƪo,5398,96,3,4,7,42.9%,34m
305,1,Denver,5397,621,20,27,47,42.6%,34m
306,1,PayToWin,5396,980,48,47,95,50.5%,17m
306,1,[АNIMЕ]Reiki,5396,1430,36,30,66,54.5%,5m
308,1,IIIIIIIIIIII,5393,0,1,0,1,100.0%,14m
309,1,IIIIIIIIIIII,5388,2073,75,32,107,70.1%,11m
310,1,Numi,5387,240,6,4,10,60.0%,17m
311,1,ZerOFeniX,5386,1114,29,8,37,78.4%,3m
312,1,[ЯD]RosscO,5385,1196,44,36,80,55.0%,15m
313,1,BooL,5384,0,0,3,3,0.0%,35m
314,1,[3Dǃ]YoungStar,5382,1094,26,19,45,57.8%,2m
315,1,Rhizer,5376,190,5,9,14,35.7%,13m
316,1,llIIIlllIlll,5374,1272,88,78,166,53.0%,5m
316,1,[HsDL]Sheva,5374,598,13,13,26,50.0%,34m
318,1,nanO,5373,142,4,1,5,80.0%,4m
319,1,Khan,5372,0,0,1,1,0.0%,4m
320,1,ProtossOPbro,5370,1644,57,53,110,51.8%,6m
321,1,IIIIIIIIIIII,5368,757,116,54,170,68.2%,6m
322,2,RobarOnFire,5356,177,6,1,7,85.7%,4m
323,1,[iX]TralaBoB,5353,3348,314,302,616,51.0%,15m
324,1,[ǂnG]GateWayDrugg,5350,564,13,7,20,65.0%,9m
325,1,[ArGGEU]Phoenix,5346,2883,116,111,227,51.1%,17m
326,1,ZipperTheFly,5341,414,9,15,24,37.5%,4m
327,1,[RGn]FeniX,5339,3293,233,180,413,56.4%,34m
327,1,IIIIIlIIlIII,5339,534,12,12,24,50.0%,8m
327,1,Kripto,5339,48,2,0,2,100.0%,13m
330,1,llllllllllll,5335,403,8,11,19,42.1%,18m
331,1,[GОVNО]DOBROED,5333,1436,39,35,74,52.7%,11m
331,1,PlayerName,5333,862,22,20,42,52.4%,13m
333,1,Hupsaiya,5332,694,16,13,29,55.2%,11m
333,1,ShadowMarine,5332,48,1,1,2,50.0%,10m
335,1,[АDV]Executor,5331,0,1,0,1,100.0%,8m
336,1,AdAstra,5330,2315,84,71,155,54.2%,15m
337,1,UFFIE,5329,2946,186,169,355,52.4%,6m
337,1,[ØD]DragonLove,5329,1018,26,18,44,59.1%,6m
337,2,[αX]Vindicta,5329,0,0,3,3,0.0%,11m
340,1,[ArGGEU]mOsTeN,5328,3177,165,140,305,54.1%,3m
341,1,YokoKanno,5326,370,9,6,15,60.0%,34m
342,1,[PLA2N]Lisara,5324,1329,40,27,67,59.7%,4m
342,1,BinaryNinja,5324,1304,34,25,59,57.6%,11m
344,1,ArabEmirate,5322,1802,53,47,100,53.0%,18m
344,1,BoNeS,5322,182,5,0,5,100.0%,4m
346,1,Bischu,5321,1558,165,138,303,54.5%,6m
347,1,llllllllllll,5319,1974,115,113,228,50.4%,3m
348,1,Maffe,5315,834,21,11,32,65.6%,14m
349,1,[Xa]Nisho,5312,2385,102,98,200,51.0%,11m
350,1,[ponу]Fluttershy,5311,94,2,2,4,50.0%,14m
351,1,YourMother,5309,1941,64,55,119,53.8%,9m
352,1,[K0mpis]Daimai,5308,506,44,37,81,54.3%,15m
353,1,[StalkZ]Cheesus,5306,0,0,1,1,0.0%,6m
354,1,[ArGGEU]Tozis,5300,1890,76,88,164,46.3%,15m
355,1,SCARLXRD,5296,2010,61,59,120,50.8%,6m
355,1,[RеG]Hitka,5296,1473,45,50,95,47.4%,11m
357,1,[Sarmat]SaoriKimura,5294,3038,203,194,397,51.1%,35m
358,1,Veyling,5290,1616,43,44,87,49.4%,5m
358,1,YongStASS,5290,890,23,7,30,76.7%,13m
358,1,[ArGGEU]BaRaGooD,5290,142,3,1,4,75.0%,13m
361,1,DiscoProtoss,5287,30,1,1,2,50.0%,14m
362,1,[PaniC]sail,5286,3298,161,150,311,51.8%,18m
363,1,lllllllllll,5285,286,7,8,15,46.7%,6m
364,1,[НТТ]nukelar,5284,2412,140,143,283,49.5%,4m
365,1,Cooltea,5283,1084,26,34,60,43.3%,6m
365,1,NeebFan,5283,818,21,22,43,48.8%,4m
367,1,[TSVB]Nesquik,5282,1890,62,46,108,57.4%,15m
368,1,IIIIIIIII,5278,3062,119,117,236,50.4%,17m
368,1,IlIlIlIlIlIl,5278,2232,89,82,171,52.0%,17m
370,1,[MBC]Grothendieck,5273,96,2,6,8,25.0%,8m
371,1,IIIIIIIIIIII,5268,174,5,5,10,50.0%,35m
372,1,Mekar,5267,2062,67,57,124,54.0%,14m
372,1,[isIMBA]wisp,5267,192,5,1,6,83.3%,11m
374,1,Revolver,5258,2921,127,112,239,53.1%,13m
375,1,[3R]LearnToSwim,5256,2380,360,340,700,51.4%,6m
376,1,[nB]XeNo,5255,348,18,18,36,50.0%,34m
377,1,Protossed,5253,0,0,1,1,0.0%,2m
378,1,[Sarmat]HaPe,5251,3031,147,134,281,52.3%,8m
379,1,[αX]Light,5248,310,7,10,17,41.2%,10m
379,1,Ashron,5248,0,0,1,1,0.0%,32m
381,1,[maƒia]Devilz,5243,0,0,1,1,0.0%,12m
382,1,kauP,5242,1862,58,50,108,53.7%,13m
382,1,SonOfBob,5242,480,15,13,28,53.6%,3m
384,1,llllllllllll,5241,1530,41,40,81,50.6%,6m
385,1,IIIIIIIIIIII,5240,430,15,12,27,55.6%,2m
385,1,[aW]LeMorse,5240,543,14,22,36,38.9%,11m
387,1,NonY,5239,238,6,11,17,35.3%,13m
388,1,KonekoNoHasu,5238,879,78,17,95,82.1%,6m
389,1,[αX]ThiasHP,5237,933,44,41,85,51.8%,11m
389,1,[Oath]Mantaza,5237,229,6,12,18,33.3%,6m
391,1,Dragonite,5236,1318,38,29,67,56.7%,2m
392,1,IIIIIIIIIIII,5235,1627,60,22,82,73.2%,14m
392,1,Player,5235,48,1,2,3,33.3%,34m
394,1,Couchpotato,5234,3227,210,166,376,55.9%,18m
394,1,[WBO]Exited,5234,842,21,22,43,48.8%,12m
396,1,Multi,5231,1034,39,39,78,50.0%,4m
396,1,[DRGno1]LobsterBrain,5231,0,0,1,1,0.0%,6m
398,1,AnDreJOO,5229,3005,115,101,216,53.2%,11m
399,1,llllllllllll,5227,3090,202,136,338,59.8%,14m
400,1,[OPMM]Coftea,5223,236,5,10,15,33.3%,4m
401,1,[K0mpis]TheDounat,5222,3037,133,134,267,49.8%,12m
402,1,[Hаsu]TopSpecnaz,5221,2937,499,428,927,53.8%,9m
402,1,PotaToss,5221,358,9,4,13,69.2%,15m
404,1,[Aof2]Fire,5220,536,13,7,20,65.0%,5m
405,1,llllllllllll,5217,1170,63,25,88,71.6%,5m
406,1,[ArGGEU]VeNTuRe,5216,3227,205,177,382,53.7%,3m
406,1,[KELA]twitchFuzer,5216,44,2,1,3,66.7%,32m
408,1,[HBGS]Hushy,5215,684,16,14,30,53.3%,9m
409,1,[3Dǃ]Basset,5214,280,6,18,24,25.0%,11m
410,1,[mCon]Genix,5211,522,12,14,26,46.2%,5m
411,1,[DFgs]MasterMind,5210,3176,181,130,311,58.2%,35m
411,1,llllllllllll,5210,996,25,18,43,58.1%,11m
413,1,[Cannоn]LebRaKaeSe,5207,3206,289,283,572,50.5%,11m
413,1,[ArGGEU]Mangokopf,5207,322,7,17,24,29.2%,11m
415,1,IIIIIIIIIIII,5205,142,4,3,7,57.1%,8m
416,1,[Картош]IIIIIIIIIIII,5204,1343,126,96,222,56.8%,4m
417,1,[duсks]upakowka,5203,2059,136,127,263,51.7%,34m
418,1,IIIIIIIIIIII,5202,836,20,23,43,46.5%,17m
418,1,[AoBDE]ZeeloT,5202,514,14,1,15,93.3%,8m
420,1,[Dobro]Dobro,5200,1099,35,28,63,55.6%,15m
421,1,блярусские,5196,3014,111,101,212,52.4%,3m
421,1,[PaniC]Kronaz,5196,84,2,3,5,40.0%,11m
423,1,[lOoKer]Werewolf,5195,1971,88,27,115,76.5%,8m
424,1,llllllllllll,5192,1673,121,89,210,57.6%,11m
425,1,INcuBo,5189,142,3,3,6,50.0%,13m
426,1,[КОНЧА]ШуткаПрикол,5186,1984,91,20,111,82.0%,35m
427,1,[НТТ]ShameLess,5185,3221,314,300,614,51.1%,11m
427,1,[ÆR]Nihed,5185,832,21,11,32,65.6%,2m
427,1,Artstyle,5185,48,1,1,2,50.0%,17m
430,1,MechOuilles,5183,644,15,9,24,62.5%,11m
431,1,[PÂRłAH]Robar,5182,2031,357,302,659,54.2%,11m
432,1,JobCenter,5180,666,16,17,33,48.5%,2m
433,1,[PLA2N]Bekzhan,5179,3036,214,191,405,52.8%,6m
433,1,Reklats,5179,1283,85,76,161,52.8%,2m
435,1,почтиМС,5178,1318,39,26,65,60.0%,34m
436,1,Turtle,5176,3215,416,392,808,51.5%,2m
436,1,Xistl,5176,2890,127,102,229,55.5%,17m
438,1,gehemon,5175,992,28,24,52,53.8%,4m
438,1,ДжудНаЧиле,5175,913,25,29,54,46.3%,13m
440,1,xelar,5174,0,1,0,1,100.0%,5m
441,1,IIIIIIIIIIII,5173,1322,53,16,69,76.8%,8m
441,1,[Xa]Weltall,5173,0,0,1,1,0.0%,13m
443,1,IIIIIIIIIIII,5172,1288,38,25,63,60.3%,6m
444,1,[Li3]Elbbar,5171,2158,84,65,149,56.4%,4m
445,1,Boar,5170,872,59,61,120,49.2%,11m
445,1,llllllllllll,5170,390,16,7,23,69.6%,4m
447,1,[ЯD]NEEK,5168,2502,87,78,165,52.7%,6m
448,1,WingZero,5167,96,2,3,5,40.0%,2m
449,1,[Spec]SKAÐI,5166,3015,454,438,892,50.9%,8m
449,1,[GdAT]Unhealthy,5166,2555,205,167,372,55.1%,34m
449,1,[PLA2N]ZeroTV,5166,46,1,8,9,11.1%,11m
452,1,putnik,5165,466,15,15,30,50.0%,2m
453,1,Rudolf,5162,854,73,55,128,57.0%,15m
453,1,captainhook,5162,885,36,5,41,87.8%,35m
455,1,IIIIIIIIIIII,5160,694,18,8,26,69.2%,5m
455,1,[Dystoo]Zargrash,5160,94,2,1,3,66.7%,19m
457,1,Benni,5159,2936,494,457,951,51.9%,15m
457,1,Unsainted,5159,2594,168,179,347,48.4%,6m
457,1,IIIIIIIIIIII,5159,48,2,0,2,100.0%,4m
457,1,[Oath]LogiC,5159,0,1,0,1,100.0%,4m
461,1,IIlIlIlIlIlI,5158,216,5,3,8,62.5%,17m
462,1,IntuitioN,5157,48,2,1,3,66.7%,34m
462,1,SunSet,5157,0,1,0,1,100.0%,8m
462,1,[PŖïMĄŁ]Mantis,5157,0,1,0,1,100.0%,3m
465,1,Sky,5154,190,6,8,14,42.9%,15m
466,1,[A11]MisterABC,5152,1032,30,15,45,66.7%,2m
467,1,[сSсǃ]anioki,5150,506,13,10,23,56.5%,6m
467,1,Ragnar,5150,320,8,10,18,44.4%,5m
467,1,[ЯD]Florujin,5150,0,0,2,2,0.0%,11m
470,1,[Heroes]MegaStar,5149,1479,61,21,82,74.4%,3m
471,1,IIIIIIIIIIII,5148,1310,37,33,70,52.9%,8m
471,1,Gnome,5148,274,7,0,7,100.0%,4m
473,1,[EXPANT]BFKat,5146,1538,52,38,90,57.8%,2m
474,1,[αXi]eXiled,5138,1826,82,37,119,68.9%,34m
475,1,[ponу]PinkiePie,5137,868,22,24,46,47.8%,13m
476,1,Allegro,5135,922,27,21,48,56.2%,32m
477,1,[ArGGEU]Utopi,5134,3010,186,160,346,53.8%,8m
478,1,OldBenoni,5133,510,14,9,23,60.9%,5m
479,1,xzidez,5129,3099,286,260,546,52.4%,12m
480,1,IIIIIIIIIIII,5128,46,1,3,4,25.0%,17m
481,1,llllllllllll,5127,3137,192,187,379,50.7%,19m
481,1,[OoE]BigChief,5127,0,0,1,1,0.0%,15m
483,1,[lMl]MǂAdel,5126,3160,844,774,1618,52.2%,8m
484,1,[IBeAŚI]Lycid,5124,1472,70,75,145,48.3%,12m
485,1,Хлебушек,5123,286,7,13,20,35.0%,4m
486,1,Icarus,5120,2023,106,87,193,54.9%,15m
486,1,[PŖïMĄŁ]gab,5120,1064,29,28,57,50.9%,11m
486,1,[boomer]Ovix,5120,216,6,2,8,75.0%,13m
489,1,Kino,5117,679,16,17,33,48.5%,11m
490,1,Seismic,5116,174,4,4,8,50.0%,34m
491,1,Boatman,5114,1153,46,16,62,74.2%,11m
491,1,Dream,5114,752,37,29,66,56.1%,4m
493,1,TwinkleToSS,5111,2121,175,155,330,53.0%,15m
493,1,GoldenPants,5111,0,0,1,1,0.0%,11m
495,1,Beowulf,5110,1805,76,51,127,59.8%,9m
495,1,Roman,5110,900,27,13,40,67.5%,34m
495,1,Tymli,5110,0,0,1,1,0.0%,15m
498,1,Raiden,5109,1674,55,56,111,49.5%,17m
499,1,Cake,5107,556,13,11,24,54.2%,11m
500,1,[PiGPan]Nopret,5106,280,7,8,15,46.7%,17m
500,1,RareBoi,5106,174,4,3,7,57.1%,13m
500,1,lllll,5106,0,0,3,3,0.0%,15m
503,1,Faith,5105,761,34,3,37,91.9%,14m
504,1,Stronge,5101,743,23,33,56,41.1%,7m
504,1,llllllllllll,5101,829,22,23,45,48.9%,15m
506,1,Yesteryear,5100,1999,121,118,239,50.6%,15m
506,1,Milamber,5100,314,11,2,13,84.6%,11m
506,1,IIIIIIIIIIII,5100,0,1,1,2,50.0%,11m
509,1,FckTeran,5093,3142,246,198,444,55.4%,5m
510,1,BlackGoku,5092,136,4,4,8,50.0%,8m
511,1,ProxyDT,5091,126,4,6,10,40.0%,11m
511,1,[3DE]StatiC,5091,40,1,2,3,33.3%,8m
511,1,NerfZerg,5091,46,1,9,10,10.0%,35m
514,1,ProbeScout,5089,722,19,15,34,55.9%,2m
515,1,Lalo,5087,590,16,9,25,64.0%,8m
516,1,Neuling,5086,44,1,1,2,50.0%,9m
517,1,Jeżozwierz,5085,2746,232,219,451,51.4%,11m
517,1,DarkMenGen,5085,302,8,11,19,42.1%,11m
517,3,Xelan,5085,0,1,4,5,20.0%,16m
520,1,AMoveNoSkill,5084,1167,38,19,57,66.7%,8m
520,1,Laydown,5084,632,17,9,26,65.4%,9m
522,1,llIlIIlllIIl,5083,0,2,3,5,40.0%,11m
523,1,KEKW,5079,2085,123,116,239,51.5%,34m
523,1,Joe,5079,88,2,1,3,66.7%,34m
525,1,NeOAnGeL,5077,44,2,1,3,66.7%,15m
525,1,[c9]FrashQ,5077,0,0,1,1,0.0%,14m
527,1,IIIIIIIIIIII,5076,911,28,22,50,56.0%,5m
527,1,Pajarote,5076,172,5,2,7,71.4%,17m
527,1,IIIIIIIIIII,5076,134,4,15,19,21.1%,35m
530,1,CrabSly,5074,1296,83,82,165,50.3%,7m
531,1,OmegaStar,5071,651,23,19,42,54.8%,15m
531,1,Quantel,5071,384,10,5,15,66.7%,11m
533,1,FrostMage,5070,1902,93,49,142,65.5%,5m
534,1,[GdAT]PaRoOby,5069,1176,36,39,75,48.0%,11m
535,1,[HsDL]MiaNonna,5067,2602,99,92,191,51.8%,15m
536,1,DiaBoLuS,5066,1422,57,20,77,74.0%,14m
537,1,[XYFAN5]DRINK,5065,472,13,4,17,76.5%,5m
537,1,hrrrufrr,5065,0,0,1,1,0.0%,34m
539,1,[Cannоn]Timo,5062,525,16,4,20,80.0%,11m
539,1,Lipski,5062,290,7,2,9,77.8%,5m
541,1,DaNang,5061,132,4,3,7,57.1%,35m
541,1,ThetaStar,5061,42,2,0,2,100.0%,9m
543,1,[WBO]Atais,5060,1546,53,50,103,51.5%,5m
543,1,SenseiKanye,5060,40,2,0,2,100.0%,4m
543,1,Spartan,5060,0,0,24,24,0.0%,4m
546,1,IIIIIIIIIIII,5059,3066,160,146,306,52.3%,8m
546,1,boanaan,5059,2527,109,108,217,50.2%,12m
546,1,[xGenGx]WoodedMicrob,5059,2570,97,94,191,50.8%,12m
549,1,[bbYoda]Skyline,5058,1400,48,32,80,60.0%,19m
550,1,Benti,5057,3016,137,126,263,52.1%,2m
551,1,IIIIIIIIIIII,5054,0,2,3,5,40.0%,35m
552,1,[Hаsu]VoldmarRich,5053,0,1,0,1,100.0%,32m
553,1,RandomGame,5051,2877,163,143,306,53.3%,5m
554,1,[PŖïMĄŁ]PlokoPloko,5050,978,25,29,54,46.3%,12m
555,1,Fortuna,5049,1685,59,57,116,50.9%,7m
555,1,[SCiE]TinToon,5049,1062,35,32,67,52.2%,15m
557,1,MysticMuse,5048,744,20,45,65,30.8%,9m
558,1,REDSON,5046,0,1,0,1,100.0%,35m
559,1,[ІDDQD]BFG,5045,0,0,1,1,0.0%,34m
560,1,[TactX]Primal,5043,458,12,12,24,50.0%,8m
560,1,[CRUX]Lancel,5043,376,10,5,15,66.7%,9m
562,1,[PŖïMĄŁ]Alfonsoking,5042,1455,59,31,90,65.6%,14m
563,1,WinterinG,5040,734,19,19,38,50.0%,11m
563,1,PrettySkin,5040,0,1,1,2,50.0%,8m
563,2,[RTO]IIIIIIIIIIII,5040,0,0,1,1,0.0%,7m
566,1,IIIIIIIIIIII,5039,745,33,35,68,48.5%,12m
566,1,[eW0lfz]AmovicAmovic,5039,48,2,1,3,66.7%,11m
566,1,DoctorWho,5039,0,1,0,1,100.0%,32m
569,1,[NWGD]Hippotamus,5038,1548,51,39,90,56.7%,11m
570,1,GrumpyPants,5037,0,2,3,5,40.0%,35m
570,3,[boredx]NoobHunter,5037,0,0,1,1,0.0%,13m
570,1,llllllllllll,5037,0,0,1,1,0.0%,15m
573,1,ДОБРО,5036,304,7,4,11,63.6%,12m
574,1,robotikov,5035,959,67,39,106,63.2%,17m
574,1,[НТТ]Matvey,5035,1025,34,48,82,41.5%,11m
576,1,[αX]Sane,5034,2531,177,180,357,49.6%,8m
576,1,[iX]pressure,5034,2076,88,78,166,53.0%,15m
578,1,Ricelia,5031,3074,659,652,1311,50.3%,11m
578,1,ItzYumy,5031,0,0,1,1,0.0%,17m
580,1,[SqAUT]MeisterEder,5029,0,1,0,1,100.0%,11m
581,1,IIIIIIIIIIII,5026,2115,170,167,337,50.4%,34m
581,1,[UATeam]Governor,5026,1192,33,43,76,43.4%,11m
581,1,NaniKawaii,5026,42,1,4,5,20.0%,8m
584,1,[Draigo]Percebeiro,5024,270,7,4,11,63.6%,6m
585,1,Instigator,5022,1009,80,76,156,51.3%,15m
585,1,llllllllllll,5022,92,3,0,3,100.0%,5m
587,1,[SH9]FatalBoy,5021,2242,101,88,189,53.4%,15m
587,1,[PÂRłAH]Argon,5021,1378,40,44,84,47.6%,15m
587,1,redpilled,5021,1202,36,31,67,53.7%,5m
590,1,llllllllllll,5020,887,47,12,59,79.7%,5m
590,1,Valkyrie,5020,572,23,11,34,67.6%,7m
590,1,Masterok,5020,70,2,2,4,50.0%,7m
593,1,IIIIIIIIIIII,5019,276,8,0,8,100.0%,9m
593,1,Nephilim,5019,216,5,4,9,55.6%,11m
595,1,[lLiTl]Failure,5018,1229,110,96,206,53.4%,12m
595,1,[Axi]CranK,5018,0,1,0,1,100.0%,4m
597,1,[C0VlD]Patient,5017,182,5,5,10,50.0%,11m
598,1,[Cannоn]Timo,5015,829,27,11,38,71.1%,34m
598,2,[ArGGEU]vmgNarra,5015,174,5,5,10,50.0%,4m
600,1,[6k]ДобрыйДобряк,5013,386,15,7,22,68.2%,9m
600,1,[ÆR]WiNtER,5013,438,12,4,16,75.0%,17m
602,1,IIIIIIIIIIII,5011,0,0,2,2,0.0%,11m
603,1,Merlin,5010,2326,112,85,197,56.9%,8m
603,1,[αX]Azura,5010,2804,106,87,193,54.9%,11m
605,1,LTZLitmus,5009,374,15,7,22,68.2%,11m
606,1,[ǃcScǃ]ŴhýŠoŠéríouŚ,5008,92,3,0,3,100.0%,35m
606,1,uwu,5008,0,1,0,1,100.0%,9m
608,1,IIIIIIIIIIII,5007,734,22,14,36,61.1%,11m
609,1,Hurricane,5006,677,36,5,41,87.8%,35m
610,1,[iX]Prime,5004,1579,53,53,106,50.0%,2m
610,1,[xRtG]MacUseR,5004,836,25,31,56,44.6%,2m
612,1,[NNK]Kabanos,5003,428,10,16,26,38.5%,8m
612,1,[lMMl]Enpo,5003,184,5,7,12,41.7%,33m
614,1,LoveNotWar,5002,514,13,7,20,65.0%,11m
615,1,fcukzerg,5001,457,25,7,32,78.1%,15m
615,1,[HBGS]Licemer,5001,680,18,13,31,58.1%,11m
615,1,Cumlord,5001,506,12,14,26,46.2%,4m
615,1,FaithHilling,5001,216,6,0,6,100.0%,9m
619,1,[Kicx]weeRA,5000,1535,68,48,116,58.6%,34m
619,1,Elyona,5000,266,7,6,13,53.8%,11m
619,3,llllllllllll,5000,181,4,4,8,50.0%,33m
619,1,nubnax,5000,48,1,1,2,50.0%,8m
623,1,[EZ4XY]Yang,4999,409,12,3,15,80.0%,15m
624,1,[SLAAAP]Paragon,4998,48,2,0,2,100.0%,19m
625,1,Barcode,4997,1810,75,51,126,59.5%,14m
626,1,[HsDL]TheCrow,4995,2617,117,110,227,51.5%,17m
626,1,[iX]Aerocool,4995,2746,109,100,209,52.2%,7m
626,1,IIIIIIIIIIII,4995,128,3,3,6,50.0%,8m
629,1,[EmŦ]Rik,4991,664,18,19,37,48.6%,5m
630,1,NotVoid,4988,1116,50,20,70,71.4%,9m
630,1,[ØC]yukimurahhh,4988,140,3,8,11,27.3%,5m
632,1,Pony,4986,754,20,27,47,42.6%,4m
632,1,[lMMl]Taavi,4986,588,15,34,49,30.6%,4m
634,1,[IBeAŚI]theFlasH,4985,1117,74,75,149,49.7%,4m
635,1,llllllllllll,4981,1584,62,42,104,59.6%,6m
635,1,IIIIIIIIIIII,4981,114,3,1,4,75.0%,8m
637,1,[КОНЧА]Loboque,4980,1627,81,35,116,69.8%,9m
638,1,[ƮesXG]llllllllllll,4979,0,0,1,1,0.0%,34m
639,1,FanOfHitman,4977,0,0,1,1,0.0%,12m
640,1,esreveR,4975,942,33,22,55,60.0%,15m
640,1,[ЯD]RazerBlader,4975,648,18,10,28,64.3%,14m
640,1,[Oath]SantaSam,4975,0,1,0,1,100.0%,13m
643,1,IIIIIIIIIIII,4974,2447,297,271,568,52.3%,11m
643,1,[DyWmP]MSIMakouni,4974,488,13,17,30,43.3%,11m
645,1,nxcharisma,4972,0,1,0,1,100.0%,15m
645,1,[UATeam]Night,4972,0,0,1,1,0.0%,35m
647,1,[STАR]PlatOK,4971,205,9,4,13,69.2%,11m
648,1,[EESC]Raku,4970,44,1,2,3,33.3%,5m
649,1,Protoss,4969,1404,40,57,97,41.2%,33m
650,1,[ArGGEU]DarknessK,4968,1120,60,68,128,46.9%,4m
650,1,Haidar,4968,46,2,3,5,40.0%,14m
652,1,Reaver,4966,0,0,1,1,0.0%,9m
653,1,[Oath]zokkerIƎ,4965,886,28,22,50,56.0%,14m
653,1,lIlIlIlIlIlI,4965,44,1,1,2,50.0%,8m
653,1,NoCti,4965,0,0,1,1,0.0%,12m
656,1,ILoveDrogo,4964,550,16,7,23,69.6%,5m
657,1,llllllllll,4962,3009,127,112,239,53.1%,13m
657,1,BumBleBee,4962,442,14,18,32,43.8%,8m
659,1,IwillAmoveU,4961,92,3,5,8,37.5%,11m
660,1,[PaniC]Losting,4960,2438,397,375,772,51.4%,7m
660,1,HyperNova,4960,44,1,2,3,33.3%,15m
662,1,IIIIIIIIIIII,4959,1842,92,97,189,48.7%,11m
663,1,[GoldM]Molten,4957,3034,237,237,474,50.0%,4m
664,1,YongRamen,4955,0,0,1,1,0.0%,5m
664,1,DrNimbus,4955,0,0,1,1,0.0%,8m
666,3,RIPToss,4954,14,1,2,3,33.3%,6m
667,1,IIIIIIIIIIII,4953,667,19,16,35,54.3%,35m
668,1,[CULTE]TKL,4949,3061,741,726,1467,50.5%,2m
668,1,llllllllllll,4949,368,10,7,17,58.8%,13m
668,1,Exottic,4949,44,2,1,3,66.7%,14m
671,1,[Нasu]upakowka,4948,2267,178,178,356,50.0%,2m
672,1,[zukaCo]zuka,4947,2781,211,217,428,49.3%,12m
673,1,[ReRise]JaKeN,4944,1538,53,51,104,51.0%,13m
674,1,Snake,4943,2025,162,165,327,49.5%,34m
674,1,TheoRy,4943,0,1,0,1,100.0%,4m
674,1,SweetPotato,4943,0,1,6,7,14.3%,13m
677,1,[IBeAŚI]DeepThought,4941,761,22,22,44,50.0%,13m
677,1,[PSISTM]Ryosis,4941,40,1,4,5,20.0%,15m
679,1,IIIIIIIIIIII,4940,2960,142,122,264,53.8%,9m
680,1,[GUANA]Masupolami,4938,1725,76,56,132,57.6%,11m
681,1,Regba,4937,1479,98,93,191,51.3%,2m
682,1,AviciiFan,4933,0,1,0,1,100.0%,4m
683,1,EstebanOcon,4932,48,1,2,3,33.3%,15m
684,1,JustMonika,4930,324,9,13,22,40.9%,5m
685,1,Nanaki,4928,3021,396,361,757,52.3%,8m
685,1,Wanderer,4928,92,2,2,4,50.0%,12m
685,1,Dobro,4928,0,0,1,1,0.0%,12m
688,1,Ourk,4927,2358,98,64,162,60.5%,4m
688,1,[SaneGG]Roodaka,4927,0,3,2,5,60.0%,14m
688,1,Terran,4927,0,3,2,5,60.0%,12m
688,1,soundcooler,4927,0,1,0,1,100.0%,17m
692,1,ElVymou,4926,42,2,2,4,50.0%,8m
693,1,llllllllllll,4925,938,30,24,54,55.6%,7m
693,1,DaZmeister,4925,562,15,17,32,46.9%,9m
695,1,Kirilalul,4923,2944,135,92,227,59.5%,13m
696,1,Predators,4922,132,4,5,9,44.4%,15m
696,1,IIIIIIIIIIII,4922,0,0,1,1,0.0%,19m
698,1,[LoCarb]Microroni,4921,1415,124,83,207,59.9%,17m
698,1,PerroCagando,4921,316,13,7,20,65.0%,33m
700,1,[YHWH]Trust,4919,3023,330,319,649,50.8%,4m
700,1,KTJest,4919,170,4,7,11,36.4%,12m
700,1,FekalosFun,4919,34,2,2,4,50.0%,13m
703,1,llllllllllll,4918,1016,28,36,64,43.8%,5m
704,1,[Dogez]KingKong,4916,132,4,1,5,80.0%,33m
705,1,GildedStaple,4915,818,32,21,53,60.4%,13m
706,1,Marrascaud,4914,3010,374,349,723,51.7%,4m
706,1,[Sarmat]Aristori,4914,82,2,10,12,16.7%,4m
708,1,Exehn,4913,1631,59,68,127,46.5%,34m
709,1,[LifeS]CmeTanKa,4912,1666,67,61,128,52.3%,12m
709,1,GISH,4912,236,7,7,14,50.0%,14m
709,1,ThumbAround,4912,0,0,1,1,0.0%,13m
712,1,[ncotic]Käsekuchen,4911,1517,194,190,384,50.5%,12m
712,1,[NMSQ]ADR,4911,90,3,1,4,75.0%,5m
712,1,IrishLad,4911,0,0,5,5,0.0%,3m
715,1,[ШОУМЕН]StereoClub,4910,2943,251,234,485,51.8%,11m
715,1,[PaniC]HoneyBee,4910,713,69,59,128,53.9%,5m
717,1,ByuN,4909,2279,189,186,375,50.4%,13m
718,1,PotatoBlast,4908,388,11,16,27,40.7%,14m
718,1,[CocoCo]Djorjx,4908,0,0,1,1,0.0%,11m
720,1,[WBO]ZESTisBEST,4906,1564,56,62,118,47.5%,11m
720,1,llllllllllll,4906,1022,32,31,63,50.8%,11m
722,1,capitaL,4905,380,10,13,23,43.5%,13m
723,1,WALLE,4904,1539,63,39,102,61.8%,13m
723,1,BeepBoop,4904,828,34,18,52,65.4%,34m
725,1,[Blacer]STALKER,4903,693,41,3,44,93.2%,19m
726,1,Dobro,4902,222,6,5,11,54.5%,15m
726,1,IIIIIIIIII,4902,0,1,0,1,100.0%,5m
728,1,Alice,4900,2615,177,158,335,52.8%,11m
729,1,Flick,4899,106,4,1,5,80.0%,13m
729,1,llllllllllll,4899,44,2,2,4,50.0%,11m
729,1,PaRoOby,4899,94,2,4,6,33.3%,33m
732,1,trabecula,4898,268,7,4,11,63.6%,33m
733,1,Smile,4897,0,0,1,1,0.0%,11m
734,1,IIIIIIIIIIII,4895,523,33,2,35,94.3%,4m
735,1,space,4893,2634,392,390,782,50.1%,7m
735,1,IIIIIIIIIIII,4893,1694,67,66,133,50.4%,12m
737,1,Gort,4892,1959,203,184,387,52.5%,11m
737,1,[PÂRłAH]Heli,4892,1949,83,72,155,53.5%,11m
737,1,Poxon,4892,154,5,4,9,55.6%,19m
740,1,HasuuCrAfT,4890,730,34,21,55,61.8%,11m
741,1,IIIIlllIlIlI,4888,1778,74,52,126,58.7%,34m
741,1,[TopKek]BronzePlayer,4888,254,6,7,13,46.2%,34m
743,1,[IceHus]TerranUser,4886,118,3,1,4,75.0%,9m
744,1,Galle,4885,2502,302,287,589,51.3%,15m
745,1,[PaniC]Xлебушек,4884,0,0,1,1,0.0%,15m
746,1,Rinka,4883,0,1,0,1,100.0%,34m
747,1,Katana,4881,128,4,10,14,28.6%,5m
748,1,[ArGGEU]MonstR,4880,2946,139,126,265,52.5%,4m
749,1,[7x]Uroba,4878,2984,293,295,588,49.8%,7m
749,1,Impostor,4878,96,4,2,6,66.7%,8m
749,1,Flowerboy,4878,0,0,1,1,0.0%,13m
752,1,Wenden,4877,0,1,4,5,20.0%,35m
753,1,[lLiTl]ommmm,4876,282,8,6,14,57.1%,19m
754,1,[Kicx]Guerrero,4875,68,3,0,3,100.0%,12m
755,1,Antimasque,4873,0,0,1,1,0.0%,34m
756,1,IlIlIlIlIlIl,4872,2642,117,121,238,49.2%,7m
756,1,Loumpus,4872,0,0,1,1,0.0%,11m
758,1,MaesioW,4871,935,105,104,209,50.2%,7m
758,1,IIIIIIIIIIII,4871,397,17,5,22,77.3%,35m
760,1,[HBGSJR]Hayasaka,4870,305,15,3,18,83.3%,33m
760,1,[RGAN]Railgan,4870,0,1,0,1,100.0%,5m
762,1,Pradaz,4868,1192,37,49,86,43.0%,11m
763,1,[Ɛï3]ƅĩǥпợŋşҭƹг,4867,2774,160,142,302,53.0%,15m
763,1,[GoldM]WindmillMan,4867,904,27,28,55,49.1%,6m
763,1,RectumRavage,4867,419,15,6,21,71.4%,6m
766,1,[DFgs]yNOT,4866,1749,62,58,120,51.7%,5m
767,1,[сSсǃ]BabyProbe,4863,1695,67,60,127,52.8%,19m
767,1,[PALS]Rush,4863,866,31,26,57,54.4%,17m
767,1,[Hаsu]Darkest,4863,36,1,1,2,50.0%,9m
770,1,[сSсǃ]CuteTempest,4861,0,0,1,1,0.0%,4m
771,1,IIIIIIIIIIII,4859,2905,512,488,1000,51.2%,34m
772,1,[lLiTl]ieLLiMo,4858,0,1,0,1,100.0%,11m
772,1,Zasa,4858,0,1,1,2,50.0%,33m
772,1,WESTWOOD,4858,0,0,1,1,0.0%,11m
775,1,IIIIIIII,4857,2763,128,104,232,55.2%,12m
775,1,MȃrieJǿhȃƞƞȃ,4857,1385,90,14,104,86.5%,9m
777,1,IIIIIIIIIIII,4856,0,1,0,1,100.0%,7m
777,1,[EESC]LuIsBoR,4856,96,1,1,2,50.0%,35m
777,1,MonkeyDragon,4856,0,0,3,3,0.0%,13m
780,1,SWPro,4855,2936,465,422,887,52.4%,4m
780,1,[PŖïMĄŁ]Killa,4855,2405,211,206,417,50.6%,12m
780,1,[PŖïMĄŁ]InTotheSky,4855,1361,50,45,95,52.6%,34m
783,1,[ValidG]SoChi,4853,342,20,7,27,74.1%,4m
784,1,[HBGS]miha,4852,0,1,0,1,100.0%,13m
784,1,Mican,4852,0,0,3,3,0.0%,34m
786,1,DirDevil,4851,0,0,1,1,0.0%,11m
787,1,CannotRush,4850,378,26,1,27,96.3%,35m
787,1,[R0FL]Hinzipinzi,4850,0,1,0,1,100.0%,9m
789,1,[EESC]Killermonjas,4849,844,24,26,50,48.0%,33m
790,1,[WBO]Suidam,4848,193,4,4,8,50.0%,34m
791,1,ȎlȎ,4847,2944,596,589,1185,50.3%,5m
791,1,[K0mpis]WeRiano,4847,1405,111,112,223,49.8%,8m
791,1,[OrDan]Samurai,4847,289,14,8,22,63.6%,11m
794,1,[RBP3]kOliO,4846,2063,155,157,312,49.7%,4m
795,1,IIIIIIIIIIII,4845,0,0,1,1,0.0%,3m
796,1,[Cannоn]saVer,4843,2943,737,755,1492,49.4%,17m
796,1,[NMSQ]Patrykus,4843,0,1,0,1,100.0%,34m
798,1,supernoob,4842,1439,69,59,128,53.9%,19m
799,1,[HBGSJR]Magicall,4841,1277,67,54,121,55.4%,5m
799,1,Nastya,4841,0,0,1,1,0.0%,34m
801,1,FachoCercle,4839,1316,49,39,88,55.7%,12m
802,1,[aW]LIGHT,4837,746,38,23,61,62.3%,15m
802,1,[сSсǃ]August,4837,624,18,26,44,40.9%,8m
802,1,[НТТ]NeGaN,4837,48,2,1,3,66.7%,8m
802,1,EFzet,4837,48,1,3,4,25.0%,9m
806,1,[GGGød]CastLentury,4836,2176,149,121,270,55.2%,5m
806,1,[TSCÐ]Sassazin,4836,647,30,19,49,61.2%,34m
806,1,[ØC]Dicet,4836,501,28,15,43,65.1%,12m
809,1,PandaTank,4835,2771,193,150,343,56.3%,9m
809,1,[αX]Stay,4835,1113,80,54,134,59.7%,4m
809,1,FeaR,4835,0,0,2,2,0.0%,7m
812,1,libidas,4834,1524,54,47,101,53.5%,17m
812,1,[сSсǃ]NaJi,4834,1101,52,31,83,62.7%,34m
814,1,[unƊeaƊ]jeanjean,4832,2018,144,129,273,52.7%,9m
814,1,[BFeS]TOTOPOTATO,4832,1309,55,53,108,50.9%,9m
814,1,ommmmmmmmmmm,4832,906,53,34,87,60.9%,17m
814,1,pedick,4832,1000,46,38,84,54.8%,35m
814,1,LoCo,4832,190,14,5,19,73.7%,15m
814,1,Noise,4832,0,1,0,1,100.0%,7m
814,1,[RAUDER]taktic,4832,0,1,1,2,50.0%,15m
821,1,Trifax,4831,1317,53,42,95,55.8%,11m
821,1,Crimp,4831,90,1,1,2,50.0%,4m
823,1,[Hаsu]Totovich,4830,2844,645,617,1262,51.1%,6m
823,1,Coxta,4830,2079,118,93,211,55.9%,9m
823,1,shining,4830,326,24,0,24,100.0%,5m
823,1,[f2af2a]Ezekiel,4830,134,5,1,6,83.3%,9m
827,1,[Nzth]Xrestos,4829,94,1,1,2,50.0%,33m
828,1,Sloth,4828,182,30,5,35,85.7%,5m
828,1,Ready,4828,364,9,15,24,37.5%,11m
828,1,Solliden,4828,82,2,0,2,100.0%,33m
831,1,[7x]Evgen,4827,905,39,32,71,54.9%,35m
831,1,[НТТ]Antarsys,4827,839,36,31,67,53.7%,4m
833,1,[PŖïMĄŁ]FØЯxÀíÜЯ,4826,1754,66,65,131,50.4%,33m
833,1,Constitution,4826,511,34,5,39,87.2%,35m
833,1,trash,4826,416,26,12,38,68.4%,11m
833,1,[PLA2N]skillraiser,4826,474,15,12,27,55.6%,7m
837,1,midori,4824,2899,700,718,1418,49.4%,3m
837,1,llllllllllll,4824,874,34,43,77,44.2%,15m
837,1,[EBIG]Duncan,4824,395,19,10,29,65.5%,13m
837,1,КорОчкаГлЭба,4824,0,1,1,2,50.0%,4m
841,1,JakeForsey,4822,2094,114,112,226,50.4%,5m
841,1,[мапхак]Jokkushka,4822,578,22,16,38,57.9%,15m
843,1,StimAddict,4821,1696,56,67,123,45.5%,12m
843,2,MisO,4821,0,0,1,1,0.0%,6m
845,1,llllllllllll,4820,103,2,2,4,50.0%,34m
846,1,[TCD]Twachs,4818,1501,67,61,128,52.3%,13m
846,1,SolKing,4818,408,14,12,26,53.8%,15m
848,1,Snickers,4817,826,24,26,50,48.0%,11m
848,2,ColiN,4817,0,0,1,1,0.0%,7m
850,2,CookieMonsta,4816,0,0,1,1,0.0%,11m
851,3,Fiorano,4815,143,3,1,4,75.0%,16m
851,2,Rippeh,4815,0,0,1,1,0.0%,4m
853,1,[TheDOH]Daniello,4814,2881,253,251,504,50.2%,3m
853,1,DieMyDarling,4814,1359,109,103,212,51.4%,34m
855,2,[eXøde]powerspike,4813,1242,53,50,103,51.5%,9m
856,1,[BeSC]Mayne,4811,345,11,9,20,55.0%,12m
857,2,MorDka,4810,0,0,1,1,0.0%,19m
858,1,IIIIIIIIIIII,4809,518,22,23,45,48.9%,15m
859,2,sentiNeL,4808,42,2,1,3,66.7%,7m
859,2,[IF1l]Fёanaro,4808,0,0,1,1,0.0%,11m
861,1,llllllllllll,4807,950,28,32,60,46.7%,12m
861,1,[IBeAŚI]ChloneCraft,4807,128,4,7,11,36.4%,34m
863,1,[Vоr]HautQuetsche,4806,2916,187,182,369,50.7%,12m
863,1,Whinelord,4806,159,8,4,12,66.7%,15m
865,1,roken,4805,2935,342,326,668,51.2%,17m
865,1,СынШоутайма,4805,1012,41,42,83,49.4%,4m
867,1,NoPasarán,4804,2876,624,606,1230,50.7%,34m
867,2,[DerBär]StargateBär,4804,54,4,4,8,50.0%,9m
869,1,[ArGGEZ]PoggyBee,4803,422,14,20,34,41.2%,9m
870,2,OldYogurt,4801,54,2,2,4,50.0%,9m
871,1,[593]guyinthechat,4800,2914,674,671,1345,50.1%,11m
871,1,[LESeV]UnderNexus,4800,949,45,38,83,54.2%,4m
871,3,CatZ,4800,200,6,8,14,42.9%,6m
874,1,[7x]MoneyAEW,4799,722,31,20,51,60.8%,13m
875,2,Sucibob,4798,168,6,1,7,85.7%,16m
876,2,Бракоша,4797,857,59,16,75,78.7%,11m
877,1,[AiRǂ]Gialluca,4796,1847,141,135,276,51.1%,13m
877,2,Serapis,4796,0,0,1,1,0.0%,6m
877,2,[SQUÍK]Solid,4796,0,0,1,1,0.0%,19m
877,1,IIIIIllllIII,4796,0,0,1,1,0.0%,34m
881,1,[Dooty]AxelTL,4794,1559,72,76,148,48.6%,15m
882,2,[Хобот]Hellion,4793,431,25,7,32,78.1%,9m
882,2,ByunJovi,4793,0,1,0,1,100.0%,16m
884,1,KEKW,4789,2352,204,211,415,49.2%,12m
884,2,BetaStar,4789,120,5,1,6,83.3%,19m
886,2,GPF,4787,30,2,1,3,66.7%,11m
887,1,SKYTOSS,4786,2476,99,104,203,48.8%,4m
887,2,[НТТ]San,4786,0,1,0,1,100.0%,6m
889,1,IIIIIIIIIIII,4785,1931,84,66,150,56.0%,13m
890,1,Strange,4783,1212,62,31,93,66.7%,13m
890,2,PizeriaZorba,4783,0,5,0,5,100.0%,19m
892,2,[HBGSJR]WannaBeZest,4782,0,0,1,1,0.0%,10m
893,1,[IEM21]Clemwillwin,4781,478,23,13,36,63.9%,19m
894,2,[PLA2N]rom,4779,196,7,8,15,46.7%,19m
895,2,[UATeam]Land,4778,2700,262,248,510,51.4%,10m
896,2,IIIIIIIIIIII,4776,630,35,9,44,79.5%,13m
896,1,Amca,4776,1034,33,41,74,44.6%,9m
896,2,[Izrod]SharkyIzrod,4776,0,0,1,1,0.0%,9m
899,1,[PŖïMĄŁ]Primal,4774,1787,79,53,132,59.8%,15m
899,2,[KeWa]Makarios,4774,1341,60,43,103,58.3%,7m
899,1,PeaKnuckles,4774,1122,57,32,89,64.0%,15m
899,1,ГеройТамбова,4774,203,7,7,14,50.0%,33m
903,1,[Heroes]Stou,4773,1130,39,50,89,43.8%,15m
903,2,[OPMM]AngryƬits,4773,0,1,0,1,100.0%,12m
905,1,[PŖïMĄŁ]SuperSilver,4772,2294,97,87,184,52.7%,34m
905,2,NewEyes,4772,0,0,1,1,0.0%,4m
905,1,SKillous,4772,0,0,6,6,0.0%,9m
908,2,Jieaell,4771,635,25,20,45,55.6%,7m
908,2,IIIIIIIIllll,4771,0,1,0,1,100.0%,13m
910,1,llllllllllll,4770,295,8,10,18,44.4%,19m
911,2,dozer,4769,763,46,42,88,52.3%,11m
912,1,[αX]PatgaData,4768,853,40,35,75,53.3%,5m
913,2,marius,4767,48,3,3,6,50.0%,10m
914,2,llllllllllII,4766,0,1,0,1,100.0%,19m
915,2,Terran,4765,1052,42,44,86,48.8%,11m
915,2,Leorio,4765,646,27,24,51,52.9%,10m
915,2,[INAE]TAUREN,4765,0,0,1,1,0.0%,16m
918,1,[PiGPan]JonBom,4764,438,18,18,36,50.0%,33m
918,2,IlllIIllII,4764,221,9,3,12,75.0%,16m
920,2,Velox,4763,0,0,1,1,0.0%,9m
921,1,OuTSIdeR,4762,224,7,11,18,38.9%,35m
922,1,LFagarax,4761,2547,217,223,440,49.3%,15m
922,1,IIIIIIIIIIII,4761,819,39,39,78,50.0%,7m
922,2,[TRotti]Valkyrae,4761,0,0,1,1,0.0%,19m
925,2,[ØC]Cynical,4760,2559,124,118,242,51.2%,7m
926,1,IlIlIlIlIlIl,4758,2629,109,99,208,52.4%,11m
926,1,[36484]ŔRRŘÕÒÖØÓØØƠ,4758,1478,68,54,122,55.7%,4m
928,1,KLÜFT,4757,2357,131,112,243,53.9%,19m
928,2,[OSgZ]Euweb,4757,913,42,30,72,58.3%,6m
930,2,Pütschern,4756,1024,43,42,85,50.6%,7m
931,1,[mYi]KnowMe,4755,902,31,30,61,50.8%,6m
931,2,[GoldM]Pain,4755,288,12,7,19,63.2%,4m
931,3,[AnD]MessiaH,4755,0,0,1,1,0.0%,33m
934,1,PKBoy,4754,60,3,9,12,25.0%,11m
935,2,[ICGl]BeatFlitz,4751,1660,72,66,138,52.2%,11m
935,2,IIIIIIIIIIII,4751,544,31,1,32,96.9%,9m
935,2,[R3ASON]Frezzie,4751,0,0,1,1,0.0%,19m
938,2,[HFXX]Humfluxx,4750,0,0,1,1,0.0%,11m
938,3,GinKurosawa,4750,0,0,1,1,0.0%,16m
940,1,[aW]IronGold,4749,949,32,29,61,52.5%,13m
940,2,[TheDOH]Operator,4749,198,9,8,17,52.9%,19m
940,2,JacobGayCop,4749,0,1,0,1,100.0%,19m
943,1,[PaniC]Ctrl,4748,1886,297,293,590,50.3%,5m
944,1,baayii,4746,2837,570,568,1138,50.1%,4m
944,2,[Ричард]GooD,4746,108,3,5,8,37.5%,4m
946,2,HinternWelp,4745,269,10,5,15,66.7%,4m
946,2,copa,4745,18,1,3,4,25.0%,7m
948,1,Zmey,4743,2881,397,389,786,50.5%,12m
948,1,Juggernaut,4743,2876,325,309,634,51.3%,19m
948,2,trigger,4743,467,30,4,34,88.2%,13m
951,1,MagicProtoss,4740,1348,79,76,155,51.0%,12m
951,2,silvercrow,4740,0,4,1,5,80.0%,9m
953,1,[Hаsu]DarkWolf,4738,40,1,6,7,14.3%,34m
954,1,[RеG]Rostok,4737,2863,325,312,637,51.0%,13m
955,1,llllllllllll,4736,2432,109,78,187,58.3%,9m
955,2,deokling,4736,367,23,0,23,100.0%,9m
955,1,taylor,4736,48,3,7,10,30.0%,34m
955,2,HeelHooker,4736,24,1,4,5,20.0%,11m
959,2,[APeC]Snail,4733,807,114,94,208,54.8%,13m
959,1,LOKI,4733,1512,112,106,218,51.4%,7m
959,1,Subutai,4733,974,31,36,67,46.3%,6m
962,2,OGAna,4732,2064,324,269,593,54.6%,16m
963,2,TortueRigide,4731,696,28,31,59,47.5%,16m
964,2,[Adlscø]fitaaa,4730,154,8,3,11,72.7%,9m
964,2,IIIIIIIII,4730,104,5,3,8,62.5%,7m
966,2,[IndyK]CaesarTymon,4729,472,35,36,71,49.3%,13m
966,2,LifeIVs,4729,38,4,1,5,80.0%,6m
968,2,Golstein,4728,212,8,8,16,50.0%,19m
968,2,[ESErl]Anextacy,4728,94,4,2,6,66.7%,7m
970,1,[IndyK]Mordrago,4726,1352,46,67,113,40.7%,7m
970,1,Sweps,4726,1066,37,48,85,43.5%,34m
972,2,CompleteMyNa,4724,1470,84,69,153,54.9%,4m
972,2,lil,4724,862,35,36,71,49.3%,12m
972,2,[M4Game]Mahgo,4724,330,14,12,26,53.8%,10m
972,2,[HBGSJR]deaded,4724,290,12,10,22,54.5%,9m
972,2,[BriT]Zeuhl,4724,0,1,0,1,100.0%,9m
977,2,Miai,4723,0,1,0,1,100.0%,9m
977,1,[K0mpis]Groet,4723,38,1,8,9,11.1%,15m
977,2,Loko,4723,0,0,1,1,0.0%,4m
980,1,[Graps]Gimme,4722,488,28,30,58,48.3%,11m
981,1,Čaujakje,4721,1028,56,41,97,57.7%,12m
981,2,[Holden]Holden,4721,482,29,4,33,87.9%,9m
981,2,Pferdle,4721,211,7,4,11,63.6%,13m
981,2,[TSVB]BaumesBaum,4721,148,5,6,11,45.5%,10m
985,1,[ЯD]Bobicus,4719,2636,102,101,203,50.2%,9m
985,2,[SZ]DolanSama,4719,30,6,1,7,85.7%,11m
985,2,Bloemkool,4719,30,1,2,3,33.3%,12m
988,2,DirDevil,4718,727,61,29,90,67.8%,11m
988,2,[KDV]Gauss,4718,0,1,0,1,100.0%,13m
988,2,[xINYMx]StOrm,4718,0,1,2,3,33.3%,4m
991,1,PainGamer,4717,2536,136,143,279,48.7%,7m
991,1,UDisgustMe,4717,961,88,93,181,48.6%,12m
993,2,[LifeS]AspireBarcod,4716,204,9,11,20,45.0%,16m
994,2,Zasa,4715,284,11,4,15,73.3%,16m
994,2,llllllllllll,4715,122,6,3,9,66.7%,4m
996,2,IIIIIIIIIIII,4713,1936,81,75,156,51.9%,11m
996,2,Smoothie,4713,0,1,0,1,100.0%,10m
998,2,[GdAT]Blutmilan,4712,2416,233,222,455,51.2%,9m
998,2,Upgrayedd,4712,1023,44,37,81,54.3%,10m
1000,2,Abyliss,4711,2369,230,215,445,51.7%,7m
1001,2,BabouLeFou,4709,30,5,2,7,71.4%,7m
1001,2,[KgNaab]AniaDoruch,4709,98,3,5,8,37.5%,13m
1001,2,[BRO666]ShadoW,4709,22,2,0,2,100.0%,9m
1001,2,RAZUPALTUFF,4709,0,0,1,1,0.0%,12m
1005,2,[KozzY]Zeaschling,4708,2006,94,83,177,53.1%,13m
1005,1,GYMAHOLIC,4708,1809,53,76,129,41.1%,34m
1007,2,[MSUSC2]Judgin,4707,1275,65,45,110,59.1%,19m
1007,2,[ЯD]notAzures,4707,0,0,1,1,0.0%,7m
1009,2,[TheDOH]Miczu,4706,956,70,59,129,54.3%,19m
1009,2,[qwerh]PrinceAdam,4706,234,9,8,17,52.9%,11m
1011,1,[FSid3]IlIlIIII,4705,1204,69,59,128,53.9%,11m
1011,2,Kutoflondra,4705,1142,60,31,91,65.9%,9m
1013,1,[Hаsu]ЧарджНог,4703,2784,174,176,350,49.7%,34m
1013,1,[Heroes]ieLLiMo,4703,2497,153,152,305,50.2%,33m
1013,2,[Hrr]SmarsA,4703,1179,111,71,182,61.0%,9m
1016,2,robotikov,4701,154,6,9,15,40.0%,12m
1016,2,[Ǽ1]ÐěŗĐěůţŝċħę,4701,0,1,0,1,100.0%,19m
1018,2,[αX]TheKyoJin,4700,1654,75,73,148,50.7%,12m
1018,1,[ZeTePr]MicroMelon,4700,1057,48,43,91,52.7%,19m
1018,2,[EAU]ŊƳŋƳ,4700,136,5,6,11,45.5%,10m
1018,2,[EESC]BushiDo,4700,0,0,1,1,0.0%,13m
1022,2,[Peeps]SpiderPig,4696,102,5,1,6,83.3%,11m
1023,2,guapo,4695,16,1,3,4,25.0%,9m
1024,2,IIIIIIIIIII,4694,0,1,0,1,100.0%,4m
1024,2,[RÐ]ElNathador,4694,0,0,1,1,0.0%,7m
1026,2,Feleks,4693,0,0,1,1,0.0%,10m
1027,2,[GoldM]Blackwidow,4692,280,13,12,25,52.0%,11m
1027,2,TheEndForYou,4692,96,4,5,9,44.4%,13m
1029,1,[ArGGEJ]Tossadar,4691,2820,427,424,851,50.2%,34m
1029,2,Revenger,4691,1142,120,90,210,57.1%,12m
1029,2,[PSlSTC]ArChon,4691,705,39,44,83,47.0%,12m
1029,2,lllllIIIIll,4691,597,32,8,40,80.0%,19m
1029,2,[TSATSA]Kinkyy,4691,102,3,1,4,75.0%,12m
1029,2,[Peeps]imbap,4691,0,1,0,1,100.0%,4m
1035,1,omstream,4690,2477,221,230,451,49.0%,11m
1035,2,Misery,4690,1129,80,47,127,63.0%,9m
1035,2,PrObe,4690,0,0,2,2,0.0%,16m
1038,2,Honor,4689,0,0,1,1,0.0%,17m
1039,2,AAAAAAAAAAAA,4688,42,6,0,6,100.0%,13m
1039,2,[niau]Probewarp,4688,0,1,0,1,100.0%,17m
1041,2,[αX]Protiselaos,4687,118,4,8,12,33.3%,7m
1042,1,TonyMontana,4686,2708,570,564,1134,50.3%,11m
1042,2,[PiGPan]Flex,4686,2333,193,198,391,49.4%,12m
1044,2,ErazorZ,4684,26,1,3,4,25.0%,9m
1045,2,Troizza,4683,959,46,43,89,51.7%,17m
1045,2,[DoS98]Larogue,4683,0,0,1,1,0.0%,7m
1045,1,[ArGGEU]alfi,4683,0,0,1,1,0.0%,3m
1048,2,[Peeps]Christiaan,4682,178,8,4,12,66.7%,12m
1048,1,PixelPerfect,4682,0,3,9,12,25.0%,15m
1048,2,[3Dǃ]AntonyZerg,4682,0,0,2,2,0.0%,17m
1051,2,xorb,4681,1177,61,27,88,69.3%,17m
1051,1,[EZBois]Padierfind,4681,1204,44,55,99,44.4%,15m
1053,2,[ZERGTV]CaMCa,4680,2461,352,333,685,51.4%,9m
1053,1,[TEEMOS]galgtonold,4680,2259,89,100,189,47.1%,11m
1053,2,Nick,4680,286,18,18,36,50.0%,11m
1056,2,[NuF]llllllllllll,4679,708,33,28,61,54.1%,7m
1056,2,UkazCas,4679,72,3,1,4,75.0%,16m
1058,1,Countess,4678,2818,720,721,1441,50.0%,3m
1058,2,NoMiS,4678,1487,111,110,221,50.2%,10m
1058,2,AmeliaXO,4678,1587,82,50,132,62.1%,17m
1058,2,[Tučňák]dubkubacz,4678,1111,51,35,86,59.3%,9m
1058,2,[GGxC]Skiblet,4678,64,5,8,13,38.5%,11m
1063,2,StatsIsBest,4677,548,28,18,46,60.9%,7m
1063,1,DURACHOK,4677,182,5,15,20,25.0%,34m
1063,2,[Teor]probeX,4677,66,3,4,7,42.9%,17m
1063,2,CanadianWood,4677,0,0,1,1,0.0%,11m
1067,1,[CocoCo]SradeLife,4675,0,0,1,1,0.0%,33m
1068,2,[SEWP]Герой,4673,488,23,16,39,59.0%,19m
1068,2,lIgHtInG,4673,32,2,0,2,100.0%,13m
1068,2,[AISC]Surge,4673,32,1,1,2,50.0%,19m
1071,2,anubis,4672,1741,79,72,151,52.3%,9m
1072,2,MacroKing,4671,856,33,28,61,54.1%,12m
1073,2,[FxL]DrDragon,4670,0,0,2,2,0.0%,7m
1074,2,[Pw]Zanubis,4669,663,27,29,56,48.2%,11m
1075,2,Jamesvin,4668,514,27,26,53,50.9%,13m
1075,1,Imposter,4668,379,16,17,33,48.5%,35m
1075,2,[INYA]HeroSalat,4668,26,2,0,2,100.0%,4m
1078,2,[ВИЗГЕР]славик,4667,472,19,19,38,50.0%,7m
1078,2,IIIIIIIIIIII,4667,28,2,0,2,100.0%,17m
1080,1,[FxL]Tom,4666,1046,45,39,84,53.6%,11m
1080,2,[KoyBee]Koy,4666,26,2,2,4,50.0%,9m
1080,2,Sergium,4666,0,0,1,1,0.0%,7m
1083,2,IlIlIlIlIlII,4664,62,3,4,7,42.9%,10m
1083,2,БогДюны,4664,0,1,0,1,100.0%,7m
1085,1,Fuz,4663,726,31,37,68,45.6%,15m
1085,2,SashaGrey,4663,62,2,4,6,33.3%,7m
1087,2,SacredCocos,4662,0,0,1,1,0.0%,9m
1088,1,Charlotte,4661,1569,109,79,188,58.0%,13m
1088,2,Incomplete,4661,0,0,1,1,0.0%,9m
1090,2,[Cannоn]Ingus,4660,1644,105,89,194,54.1%,7m
1090,2,[Blacer]MarineKing,4660,272,11,9,20,55.0%,11m
1092,1,[Unclе]themoOsician,4659,1414,54,57,111,48.6%,11m
1092,2,[ЯD]Exo,4659,808,34,37,71,47.9%,10m
1092,2,IIIIIIIIIIII,4659,0,1,0,1,100.0%,12m
1095,2,[TKAP]Koka,4658,1004,48,42,90,53.3%,13m
1096,2,Therg,4657,0,1,0,1,100.0%,12m
1097,2,[3Dǃ]waidmannshei,4655,303,15,10,25,60.0%,12m
1097,2,DoraDExplora,4655,62,2,2,4,50.0%,13m
1097,2,[PiGPan]Akoo,4655,0,1,0,1,100.0%,7m
1100,1,Simon,4653,1772,90,88,178,50.6%,34m
1100,2,[DaAm]Spotlight,4653,0,0,1,1,0.0%,4m
1102,1,sLivko,4652,1823,112,101,213,52.6%,12m
1102,2,[Petrus]gaga,4652,0,0,1,1,0.0%,12m
1104,1,[Wø]Aicha,4651,1792,221,223,444,49.8%,12m
1104,2,LaserDagger,4651,558,39,12,51,76.5%,12m
1106,2,[TROPBG]ZBelin,4650,0,0,1,1,0.0%,12m
1107,2,[XYFAN]Liverpool,4649,413,20,14,34,58.8%,16m
1107,2,[EmŦ]MagnuM,4649,0,0,1,1,0.0%,12m
1109,2,[RAAAWR]Robotikov,4648,18,1,7,8,12.5%,9m
1110,2,[УТочка]SeregaELCAMX,4647,2144,288,278,566,50.9%,9m
1110,2,IIIIIIIIIIII,4647,1828,117,111,228,51.3%,7m
1112,1,[НТТ]LichKing,4646,1248,43,44,87,49.4%,5m
1113,1,Shampoo,4644,1393,120,123,243,49.4%,12m
1113,1,[Hаsu]fjfalcon,4644,1898,85,104,189,45.0%,12m
1115,1,Strawhat,4643,919,30,34,64,46.9%,12m
1115,2,lana,4643,230,11,15,26,42.3%,9m
1117,2,ZeerSkill,4642,600,29,21,50,58.0%,12m
1117,2,Omega,4642,234,11,7,18,61.1%,10m
1117,2,[GWWB]CarlyRaeJope,4642,84,3,0,3,100.0%,9m
1120,2,hulis,4641,0,0,1,1,0.0%,14m
1121,2,Jonathan,4639,1831,77,69,146,52.7%,17m
1121,1,[GoldM]Bromaria,4639,564,17,26,43,39.5%,12m
1121,2,Neo,4639,0,0,1,1,0.0%,7m
1124,3,[Cannоn]Tenchirion,4638,127,10,6,16,62.5%,4m
1125,2,IIIIIIIIIIII,4637,685,31,28,59,52.5%,9m
1126,2,IIIIIIIIIIII,4636,176,13,9,22,59.1%,12m
1126,2,Gavibear,4636,0,1,4,5,20.0%,13m
1128,2,KSxSavi,4635,542,34,9,43,79.1%,7m
1128,2,[Heroes]Magnath,4635,611,30,25,55,54.5%,13m
1130,2,BrokenGlass,4634,36,3,3,6,50.0%,19m
1130,2,СmeTanKa,4634,0,0,1,1,0.0%,7m
1132,1,thecore,4633,86,3,10,13,23.1%,10m
1132,2,[Wø]SQR,4633,0,1,0,1,100.0%,14m
1134,2,[Дядя]BARRISTA,4632,1023,45,34,79,57.0%,9m
1135,1,Ivan,4631,2782,277,268,545,50.8%,6m
1135,2,[VFish]sebesdes,4631,299,14,17,31,45.2%,12m
1135,2,JesusChrist,4631,252,10,8,18,55.6%,17m
1135,2,[TGCrew]KCal,4631,48,3,5,8,37.5%,14m
1135,2,[Brotoz]Nex,4631,0,1,0,1,100.0%,7m
1140,1,AntikilleR,4630,357,12,16,28,42.9%,4m
1140,2,[ArGGEU]CoachGranas,4630,28,1,1,2,50.0%,10m
1142,2,matiö,4629,0,0,1,1,0.0%,16m
1142,2,Flashover,4629,0,0,1,1,0.0%,6m
1144,2,idk,4628,1327,72,47,119,60.5%,4m
1144,2,HerpDerp,4628,377,18,7,25,72.0%,16m
1144,2,Equus,4628,112,5,4,9,55.6%,12m
1147,2,[αX]June,4627,910,39,34,73,53.4%,4m
1147,2,[xGenGx]Galaxy,4627,364,15,15,30,50.0%,12m
1147,2,gropheR,4627,92,5,4,9,55.6%,7m
1150,2,TommyShelby,4626,948,54,27,81,66.7%,17m
1150,2,ieatzergs,4626,107,5,1,6,83.3%,7m
1152,2,[ØC]Halienator,4625,1143,51,46,97,52.6%,7m
1152,2,IIIIIIIIIIII,4625,0,0,1,1,0.0%,14m
1152,2,[Xanz]Steepsmove,4625,0,0,1,1,0.0%,10m
1152,2,[Docha]Anna,4625,0,0,1,1,0.0%,10m
1156,2,Saiz,4624,235,7,7,14,50.0%,7m
1156,2,[ØC]Phyrsos,4624,62,2,5,7,28.6%,12m
1156,2,[GoldM]ZKay,4624,18,1,1,2,50.0%,13m
1159,2,RenHöek,4620,2580,153,158,311,49.2%,16m
1159,2,ToadSage,4620,1339,99,85,184,53.8%,9m
1159,2,[lMMl]Fagballs,4620,628,36,25,61,59.0%,16m
1159,1,[FSeS]Barry,4620,556,18,27,45,40.0%,7m
1159,2,[Oath]Varys,4620,175,5,5,10,50.0%,17m
1159,2,CPU,4620,0,1,1,2,50.0%,14m
1159,2,[diгty]heba,4620,0,0,1,1,0.0%,9m
1166,2,WaYne,4619,50,2,5,7,28.6%,17m
1167,1,Beastyqt,4618,377,13,0,13,100.0%,8m
1167,1,[SquafN]PaCTom,4618,256,9,19,28,32.1%,8m
1169,2,Owen,4617,626,25,27,52,48.1%,12m
1169,2,ǂTenshiǂ,4617,0,0,2,2,0.0%,12m
1171,2,Riverstone,4616,18,1,6,7,14.3%,12m
1172,2,[Тренир]Тринерую,4614,190,110,91,201,54.7%,7m
1172,2,[ĦRZ]Defaced,4614,331,15,10,25,60.0%,12m
1174,2,[Фаталя]MassVoidRay,4613,1016,47,31,78,60.3%,12m
1175,2,Newbi,4612,725,42,20,62,67.7%,16m
1175,2,STellaR,4612,0,0,1,1,0.0%,9m
1175,2,[ThreeK]SeñorDravo,4612,0,0,1,1,0.0%,12m
1178,2,ArtOfMeme,4611,1329,66,57,123,53.7%,16m
1178,1,Flamby,4611,376,13,7,20,65.0%,34m
1180,2,IIIIIIIIIIII,4609,765,48,39,87,55.2%,4m
1180,2,Dragon,4609,0,0,1,1,0.0%,9m
1182,2,IIIIIIIIIIII,4608,1221,141,144,285,49.5%,12m
1182,2,Obfuscation,4608,433,74,52,126,58.7%,10m
1182,2,youhavelost,4608,1629,74,61,135,54.8%,7m
1182,2,[BX3]fubb,4608,555,29,14,43,67.4%,12m
1182,2,[TosIsA]NoSkillRace,4608,103,3,1,4,75.0%,13m
1187,2,Leto,4607,327,20,10,30,66.7%,17m
1187,2,MrWinWon,4607,0,0,1,1,0.0%,12m
1187,2,[apeiro]ALow,4607,0,0,2,2,0.0%,7m
1190,2,[LandP]LordFekalos,4606,1461,98,104,202,48.5%,12m
1190,2,[сSсǃ]Labsick,4606,995,51,44,95,53.7%,19m
1190,2,BestTuga,4606,285,14,2,16,87.5%,9m
1190,2,[isIMBA]Philippe,4606,0,0,1,1,0.0%,12m
1194,2,[котята]Enkrl,4605,2518,477,463,940,50.7%,14m
1194,2,[PÂRłAH]Eladen,4605,2539,223,222,445,50.1%,17m
1194,2,BoBy,4605,1352,152,134,286,53.1%,4m
1194,2,llllllllllll,4605,380,21,23,44,47.7%,13m
1194,1,[Ex0n]Srade,4605,0,1,0,1,100.0%,20m
1194,2,IIIIIIIIIIII,4605,0,0,1,1,0.0%,12m
1194,2,[RBlood]ChenZen,4605,0,0,1,1,0.0%,9m
1201,2,iLoVeStaLkeR,4604,164,10,4,14,71.4%,12m
1201,2,[Arrows]Salty,4604,0,0,1,1,0.0%,4m
1203,2,[HBeS]Zabura,4603,563,82,75,157,52.2%,7m
1203,2,[HBGS]JEROS,4603,578,29,26,55,52.7%,12m
1203,2,[WØLF]Parzival,4603,0,0,1,1,0.0%,10m
1206,2,[BornG]AsheN,4602,774,41,29,70,58.6%,9m
1206,2,IIIIIIIIIIII,4602,476,24,28,52,46.2%,19m
1206,2,[GAMI]Wejdene,4602,99,5,4,9,55.6%,7m
1206,1,IlllIIIIllll,4602,74,4,11,15,26.7%,15m
1210,2,GoblinMaster,4601,1674,104,73,177,58.8%,17m
1210,2,[1Tank]Panzerfahrer,4601,1276,68,52,120,56.7%,19m
1210,2,[PŖïMĄŁ]Euron,4601,808,49,24,73,67.1%,12m
1210,2,IIIIIIIIIIII,4601,146,5,0,5,100.0%,17m
1210,2,ZergKnight,4601,0,1,0,1,100.0%,8m
1215,2,[TAW]deSchwarz,4600,965,37,39,76,48.7%,17m
1215,2,[Ex0n]StekepaNNe,4600,242,11,10,21,52.4%,19m
1217,2,[RSK]Chocolatine,4599,2064,308,300,608,50.7%,14m
1217,2,Ewanda,4599,2490,152,130,282,53.9%,9m
1217,2,lIlIIlllIlI,4599,777,114,111,225,50.7%,13m
1217,2,Bucephalus,4599,714,36,28,64,56.2%,8m
1217,2,BaKady,4599,92,5,6,11,45.5%,7m
1217,2,[ENV]Mefisto,4599,56,2,3,5,40.0%,8m
1217,2,[UATeam]Yamaga,4599,0,0,1,1,0.0%,9m
1217,2,QuickBiT,4599,0,0,1,1,0.0%,17m
1225,2,[KoyBee]McButtFace,4598,2584,631,567,1198,52.7%,12m
1226,2,veysiii,4597,337,18,7,25,72.0%,9m
1226,2,[IceHus]Vlad,4597,56,3,4,7,42.9%,10m
1228,2,CheeserGirl,4596,1906,137,133,270,50.7%,8m
1228,2,NeO,4596,1399,67,63,130,51.5%,9m
1230,2,SayonaraSckr,4595,0,0,1,1,0.0%,19m
1231,2,Quad,4594,603,70,71,141,49.6%,8m
1231,2,[TAW]Baker,4594,1522,61,56,117,52.1%,9m
1231,2,[BRSKR]Viroos,4594,672,41,13,54,75.9%,9m
1231,2,Oblivion,4594,91,4,0,4,100.0%,17m
1231,2,[PŖïMĄŁ]Virtual,4594,96,4,6,10,40.0%,13m
1236,2,Mastermind,4593,2250,136,133,269,50.6%,14m
1237,2,Khmel,4592,147,5,3,8,62.5%,17m
1237,2,gethigh,4592,16,1,2,3,33.3%,10m
1239,2,StatsIsBest,4591,723,31,29,60,51.7%,17m
1239,2,archon,4591,242,14,14,28,50.0%,14m
1239,2,PROtoss,4591,138,6,13,19,31.6%,4m
1242,2,LazyTaldarim,4590,1915,180,174,354,50.8%,7m
1243,2,[PÂRłAH]Ryuzakhi,4589,1569,76,61,137,55.5%,13m
1244,2,RiSK,4587,527,29,17,46,63.0%,7m
1245,2,IIIIIIIIIIII,4586,64,3,4,7,42.9%,7m
1246,1,Tarhum,4585,2750,455,453,908,50.1%,19m
1246,2,VKing,4585,2353,127,129,256,49.6%,12m
1248,2,killer,4584,2629,257,227,484,53.1%,17m
1248,2,[iX]Dystopia,4584,1369,67,55,122,54.9%,17m
1248,2,IllIIIIllIll,4584,292,12,18,30,40.0%,9m
1248,2,[iX]Meditail,4584,36,2,4,6,33.3%,9m
1252,2,[MkersA]PetrusV,4583,874,38,40,78,48.7%,12m
1252,3,hypnotoad,4583,238,24,22,46,52.2%,6m
1254,2,Kalysm,4582,2020,96,87,183,52.5%,17m
1254,3,Tactyw,4582,1087,57,41,98,58.2%,16m
1254,2,trytowin,4582,0,1,3,4,25.0%,10m
1257,3,justAcasual,4581,58,6,7,13,46.2%,32m
1258,2,Test,4580,862,35,40,75,46.7%,17m
1258,2,AsHuRa,4580,130,10,10,20,50.0%,17m
1260,2,howtoplay,4579,99,3,2,5,60.0%,10m
1260,2,IIIIIIIIIIII,4579,80,3,3,6,50.0%,4m
1260,3,debaz,4579,0,1,0,1,100.0%,14m
1260,3,MacroMaru,4579,0,1,0,1,100.0%,15m
1260,2,[TAW]Zgredek,4579,0,0,1,1,0.0%,11m
1265,3,yukoSefZ,4578,570,33,31,64,51.6%,32m
1266,1,Nameless,4577,2402,95,107,202,47.0%,17m
1266,2,[PaniC]BlackEagle,4577,84,4,6,10,40.0%,13m
1266,3,[DøA]Gorendre,4577,0,0,1,1,0.0%,16m
1269,2,Gambeulin,4576,2399,153,140,293,52.2%,12m
1269,3,DrFreud,4576,1681,81,68,149,54.4%,18m
1269,2,[VuV]Teage,4576,80,4,9,13,30.8%,13m
1272,3,haddenlos,4575,0,0,1,1,0.0%,11m
1273,1,[ǂMWRǂ]Guillemot,4574,2420,274,297,571,48.0%,13m
1273,2,[AiRǂ]SuperNova,4574,265,16,11,27,59.3%,17m
1275,2,[HBGSJR]KrisFeeD,4573,286,17,10,27,63.0%,17m
1275,3,Bear,4573,0,0,1,1,0.0%,19m
1277,1,SoulSmith,4572,2113,307,275,582,52.7%,12m
1277,3,[Cannоn]HotGirl,4572,241,12,6,18,66.7%,16m
1279,2,Alpha,4570,485,23,25,48,47.9%,9m
1279,3,[NVY]Abakus,4570,12,1,1,2,50.0%,10m
1281,2,[GdAT]Vavin,4569,2016,109,92,201,54.2%,4m
1281,2,duke,4569,1101,91,78,169,53.8%,9m
1281,2,Barcode,4569,370,21,21,42,50.0%,10m
1284,3,IIIIIIIIIIII,4568,16,2,3,5,40.0%,16m
1285,2,[H0C]ForGlory,4567,2530,306,308,614,49.8%,14m
1286,2,DatO,4566,328,12,22,34,35.3%,9m
1286,3,Thenix,4566,0,0,1,1,0.0%,33m
1288,2,Onixzet,4565,2123,244,243,487,50.1%,9m
1288,2,Darwin,4565,274,13,17,30,43.3%,12m
1288,2,[Картош]Oldwizard,4565,12,3,5,8,37.5%,9m
1288,3,[MkersA]BLACKDOG,4565,10,1,1,2,50.0%,11m
1292,3,Chubz,4564,311,22,10,32,68.8%,18m
1292,3,Leo,4564,10,2,3,5,40.0%,16m
1294,1,[ICPC]MIB,4563,2734,611,590,1201,50.9%,5m
1294,2,Flamer,4563,864,89,86,175,50.9%,7m
1294,2,IlIIllllllII,4563,214,9,14,23,39.1%,9m
1297,2,outpls,4561,417,64,55,119,53.8%,10m
1297,3,KiwiTaco,4561,354,20,6,26,76.9%,3m
1297,3,sqwent,4561,28,5,3,8,62.5%,6m
1300,3,Versus,4560,350,26,14,40,65.0%,18m
1300,3,[RBlood]biboui,4560,0,1,1,2,50.0%,3m
1300,3,YHWH,4560,0,0,1,1,0.0%,19m
1303,2,Bush,4559,2539,229,229,458,50.0%,4m
1303,1,[ĦRZ]ejozl,4559,1448,52,67,119,43.7%,12m
1303,1,IIIIIIIIIII,4559,48,1,5,6,16.7%,5m
1306,1,[SIayer]KiRa,4558,2067,85,86,171,49.7%,34m
1307,2,Cichlid,4557,1783,80,92,172,46.5%,19m
1307,3,lllIlIlIIIll,4557,56,3,4,7,42.9%,16m
1309,3,[GoldM]Axios,4556,354,24,27,51,47.1%,16m
1309,3,[ЯD]ScIIWoL,4556,0,0,1,1,0.0%,11m
1311,3,lllllllllll,4555,18,3,2,5,60.0%,16m
1312,2,theglml,4554,1351,94,85,179,52.5%,14m
1312,2,[НТТ]TrustInMe,4554,12,2,4,6,33.3%,12m
1314,3,[NumbAc]Rasco,4553,0,1,0,1,100.0%,16m
1315,3,[JAREK]Gumkomen,4552,969,58,55,113,51.3%,16m
1315,3,HappyFiit,4552,493,45,18,63,71.4%,2m
1315,3,Caedus,4552,24,43,35,78,55.1%,19m
1315,3,[TIMPPA]Pioni,4552,10,2,1,3,66.7%,20m
1319,2,[αX]Blisk,4551,233,16,12,28,57.1%,7m
1320,2,[aW]Novo,4549,2167,119,127,246,48.4%,8m
1320,3,ProtoZZavr,4549,0,0,2,2,0.0%,4m
1322,3,[QreskT]SOVA,4548,26,3,1,4,75.0%,12m
1323,2,[D0N3]VoiDNesS,4547,1486,73,68,141,51.8%,12m
1323,2,[CpL]KrOk,4547,122,5,6,11,45.5%,7m
1323,2,[PŖïMĄŁ]Desive,4547,18,2,6,8,25.0%,9m
1326,2,Ihateprotoss,4546,334,15,19,34,44.1%,19m
1327,2,[H0C]ForGlory,4545,2321,140,138,278,50.4%,12m
1327,3,Haluc,4545,1202,58,46,104,55.8%,18m
1327,3,[eW0lfz]XxMetalxX,4545,124,15,13,28,53.6%,16m
1327,2,[VFish]VoiceOfFall,4545,162,8,12,20,40.0%,8m
1327,3,[EXPANT]Eclipse,4545,0,1,1,2,50.0%,15m
1332,3,Veles,4544,613,39,15,54,72.2%,16m
1332,2,Lauchzelot,4544,274,8,13,21,38.1%,9m
1332,3,[DFgs]Earil,4544,0,0,2,2,0.0%,5m
1335,2,Kaspar,4543,2562,146,138,284,51.4%,9m
1335,3,FleXi,4543,434,139,119,258,53.9%,19m
1335,2,[Rndom]Zerg,4543,175,9,20,29,31.0%,12m
1338,3,[GoldM]Sparkyy,4542,1543,80,83,163,49.1%,19m
1338,2,[HBGSJR]vladozerg,4542,158,6,6,12,50.0%,9m
1338,2,[Hambbe]SCBoy,4542,0,1,3,4,25.0%,7m
1338,3,Loy,4542,0,0,1,1,0.0%,19m
1338,2,[BBS123]FyrA,4542,0,0,5,5,0.0%,8m
1343,2,[ƮesXG]Kronos,4541,0,1,0,1,100.0%,8m
1343,3,[ExCS]XoRanger,4541,0,0,1,1,0.0%,5m
1345,3,RuToss,4540,552,29,18,47,61.7%,16m
1345,3,FrostyFeet,4540,0,1,0,1,100.0%,3m
1345,3,StarKer,4540,0,0,1,1,0.0%,16m
1348,2,tOmas,4539,137,7,6,13,53.8%,7m
1348,3,FFFFFFFFFFFF,4539,48,5,3,8,62.5%,18m
1350,3,FoQueYou,4538,387,26,17,43,60.5%,16m
1350,3,FailArazul,4538,156,7,4,11,63.6%,5m
1350,1,Goncourt,4538,142,5,12,17,29.4%,6m
1350,3,llllIlllllll,4538,18,4,3,7,57.1%,3m
1350,3,Max,4538,0,1,0,1,100.0%,32m
1350,3,doubleking,4538,0,0,1,1,0.0%,20m
1356,2,llllllllllll,4537,384,17,27,44,38.6%,17m
1356,3,[Mkers]IIIIIIIIIIII,4537,0,1,0,1,100.0%,7m
1358,1,GoldenArmada,4536,1063,178,174,352,50.6%,34m
1358,1,[OSgZ]MyMojo,4536,144,6,4,10,60.0%,2m
1358,2,IIIIIIIIIIII,4536,0,2,4,6,33.3%,4m
1361,3,[nBreed]Saas,4535,0,0,1,1,0.0%,19m
1361,3,Dumblescroc,4535,0,0,1,1,0.0%,6m
1361,3,Shadow,4535,0,0,2,2,0.0%,2m
1364,1,[НТТ]ƎDESU,4534,2683,269,273,542,49.6%,17m
1365,2,[voff]Slow,4533,2502,351,359,710,49.4%,17m
1365,2,Ghoulie,4533,2448,317,274,591,53.6%,9m
1365,1,[αX]NeWHoriZonS,4533,812,22,38,60,36.7%,3m
1365,3,[EBIG]sikurutra,4533,22,4,0,4,100.0%,19m
1369,3,[VBM]Frammer,4532,34,4,2,6,66.7%,34m
1370,3,[PŖïMĄŁ]Magno,4531,6,1,1,2,50.0%,5m
1371,3,[lDPXl]iRoNaRRoW,4530,0,1,0,1,100.0%,16m
1371,3,lVlagic,4530,0,0,1,1,0.0%,5m
1373,2,[IndyK]Flexy,4529,2499,148,148,296,50.0%,12m
1373,3,Crazy,4529,661,36,19,55,65.5%,16m
1373,2,[aW]Deuxcentonze,4529,20,2,4,6,33.3%,7m
1373,3,[THI]ProfessorZ,4529,0,1,2,3,33.3%,7m
1377,2,Sachaligator,4528,672,36,31,67,53.7%,4m
1377,3,Cage,4528,4,1,2,3,33.3%,3m
1379,2,[PLA2N]MoyaPrelest,4527,2514,125,108,233,53.6%,12m
1379,2,Daloze,4527,260,10,18,28,35.7%,13m
1381,3,Ultron,4526,1250,64,55,119,53.8%,34m
1381,3,[fam1ly]DeepTemplar,4526,48,8,0,8,100.0%,16m
1383,1,[Фаталя]SHABASH,4525,2672,526,514,1040,50.6%,19m
1383,2,[SolidM]Spiderattack,4525,1209,58,60,118,49.2%,4m
1385,3,Vamp,4524,0,1,0,1,100.0%,11m
1385,3,[BRSKR]GipsyDanger,4524,6,1,5,6,16.7%,3m
1387,2,[GEGT]Awesomesauce,4523,101,13,23,36,36.1%,14m
1388,3,MineralRGood,4522,1937,240,207,447,53.7%,3m
1388,2,[PLA2N]Torasaki,4522,1140,109,98,207,52.7%,13m
1388,3,Lasttray,4522,301,21,7,28,75.0%,3m
1388,2,[CpL]TqM,4522,276,13,12,25,52.0%,9m
1388,3,[IEeST]Convulsion,4522,0,0,1,1,0.0%,14m
1388,3,IIIIIIIIIIII,4522,0,0,1,1,0.0%,6m
1388,3,Shinycarrier,4522,0,0,1,1,0.0%,2m
1395,2,Kosmotaur,4521,2500,205,216,421,48.7%,12m
1396,3,IraFunesta,4520,0,0,3,3,0.0%,6m
1397,3,[αX]Doudou,4519,2285,117,118,235,49.8%,16m
1397,3,Protosex,4519,1354,99,47,146,67.8%,12m
1397,2,[7x]Motörhead,4519,330,14,21,35,40.0%,12m
1400,2,[TaNt3]Passman,4518,2425,160,159,319,50.2%,17m
1400,1,llllllllllll,4518,2044,115,126,241,47.7%,5m
1400,1,IIIIIIIIIIII,4518,804,26,46,72,36.1%,12m
1400,1,LoveNotWar,4518,217,5,0,5,100.0%,12m
1400,3,[TGCrew]Shyrshadi,4518,16,2,4,6,33.3%,7m
1400,3,Nine,4518,0,1,2,3,33.3%,16m
1400,3,Hidra,4518,0,0,3,3,0.0%,32m
1407,2,[GanYa]ZjonPater,4517,129,8,6,14,57.1%,12m
1407,2,[CS0]TeaAge,4517,143,6,9,15,40.0%,4m
1409,3,llllllllllll,4516,68,9,4,13,69.2%,3m
1409,3,DiZzyFingErs,4516,10,2,3,5,40.0%,32m
1409,3,[EWSS]Cephale,4516,0,0,1,1,0.0%,34m
1412,2,[genre]kickyA,4515,618,25,30,55,45.5%,19m
1412,3,ImmortanJoe,4515,86,12,4,16,75.0%,33m
1412,3,[IMGMM]NotYou,4515,0,1,0,1,100.0%,7m
1415,3,LustForLife,4514,713,40,18,58,69.0%,16m
1416,2,[aW]TortueAgile,4513,2479,295,290,585,50.4%,8m
1416,2,[MSUSC2]mibig,4513,348,93,101,194,47.9%,12m
1416,3,Reign,4513,303,48,43,91,52.7%,15m
1416,3,JonSnow,4513,110,12,10,22,54.5%,19m
1416,3,majk,4513,128,10,10,20,50.0%,33m
1416,3,[ОБЗМ]Leatherman,4513,10,2,1,3,66.7%,12m
1422,3,HappyZerg,4512,457,23,2,25,92.0%,2m
1422,3,Dumbledore,4512,0,1,0,1,100.0%,16m
1422,3,[ECV]Legion,4512,0,0,1,1,0.0%,3m
1425,2,Pacer,4511,486,50,49,99,50.5%,12m
1425,3,BowelMovemnt,4511,44,7,2,9,77.8%,16m
1425,3,[EESC]Faith,4511,24,3,0,3,100.0%,12m
1428,2,[EzPez]CurlyHead,4510,1032,48,59,107,44.9%,17m
1428,3,[W4nker]Sentry,4510,0,0,1,1,0.0%,10m
1430,2,Nort,4509,1023,48,44,92,52.2%,7m
1430,3,Jules,4509,56,6,5,11,54.5%,2m
1432,3,[ØC5]dad,4508,0,0,1,1,0.0%,18m
1433,2,Prebs,4507,413,18,23,41,43.9%,9m
1433,3,RoobPay,4507,116,12,7,19,63.2%,3m
1435,3,Raven,4506,333,19,6,25,76.0%,16m
1436,2,[GangPL]Kosit,4505,502,27,29,56,48.2%,7m
1437,2,FireFly,4504,2272,239,210,449,53.2%,17m
1437,3,Sorcha,4504,126,10,12,22,45.5%,16m
1437,1,AstroNeger,4504,48,2,0,2,100.0%,4m
1440,2,TheViper,4503,491,34,44,78,43.6%,12m
1440,3,llllllll,4503,0,1,0,1,100.0%,11m
1442,2,dunkelheit,4502,939,60,65,125,48.0%,8m
1442,3,ZeeK,4502,682,46,39,85,54.1%,19m
1442,3,[HBGS]BravO,4502,32,4,4,8,50.0%,18m
1442,3,[ƮesXG]Shield,4502,0,1,0,1,100.0%,15m
1442,3,[OoE]SirLevAlot,4502,0,0,1,1,0.0%,18m
1442,2,[VHSEK]MackTheKnife,4502,0,0,1,1,0.0%,16m
1448,2,[PiGPan]Diglett,4501,2416,168,167,335,50.1%,7m
1448,3,[Animе]XelNaga,4501,269,13,9,22,59.1%,3m
1448,3,llllllllllll,4501,218,10,5,15,66.7%,15m
1448,3,AsTeR,4501,82,5,7,12,41.7%,16m
1448,3,[Kontz]Leviathan,4501,0,0,1,1,0.0%,18m
1453,3,IIIIIIIIIIII,4500,0,0,2,2,0.0%,20m
1454,3,[RеG]ZOOOM,4499,1572,90,73,163,55.2%,6m
1454,3,GhostTemplar,4499,1426,73,65,138,52.9%,16m
1454,3,robotikov,4499,916,58,63,121,47.9%,15m
1454,2,[isIMBA]Storm,4499,462,22,36,58,37.9%,13m
1454,3,Azaghal,4499,201,12,5,17,70.6%,3m
1454,3,Florian,4499,26,4,0,4,100.0%,6m
1454,3,BattleMage,4499,14,3,0,3,100.0%,16m
1454,3,Funny,4499,0,1,0,1,100.0%,18m
1454,3,Jonny,4499,0,0,1,1,0.0%,20m
1463,1,[ЯD]Azures,4498,1268,42,59,101,41.6%,6m
1463,2,[EESC]DUFO,4498,0,2,2,4,50.0%,15m
1463,2,Immortal,4498,77,2,5,7,28.6%,14m
1466,3,[Hаsu]Farbros,4497,0,1,0,1,100.0%,4m
1466,3,[CocoCo]DansGame,4497,0,1,1,2,50.0%,11m
1468,3,MetHiX,4496,804,52,26,78,66.7%,5m
1468,3,CooLio,4496,22,2,0,2,100.0%,18m
1470,2,[КАТЯ]АСМР,4495,282,16,13,29,55.2%,8m
1470,3,[eXøde]imData,4495,20,3,5,8,37.5%,18m
1470,3,[PaniC]SAINT,4495,0,0,1,1,0.0%,19m
1473,3,ErnstRiedler,4494,399,41,27,68,60.3%,10m
1473,3,[UlaS]WannaBeZEST,4494,348,32,26,58,55.2%,11m
1473,3,Bobbbbbbbbbb,4494,0,3,2,5,60.0%,11m
1476,2,[Mars69]Penetrator,4493,728,125,140,265,47.2%,7m
1476,2,[ÆR]Pobcorn,4493,802,66,70,136,48.5%,19m
1478,2,[Jedi]Markov,4492,1121,157,158,315,49.8%,13m
1478,3,PerL,4492,0,0,1,1,0.0%,7m
1480,2,[nKnown]Schizophren,4491,137,5,11,16,31.2%,10m
1480,3,FishStickz,4491,20,4,5,9,44.4%,12m
1480,3,[GRNSKN]Flare,4491,0,0,1,1,0.0%,2m
1480,3,Crowley,4491,0,0,1,1,0.0%,11m
1484,2,[bitoQ2]charlix,4490,1926,289,291,580,49.8%,17m
1484,3,short,4490,954,44,38,82,53.7%,11m
1484,3,Labio,4490,246,18,17,35,51.4%,12m
1484,2,[BornG]Steffan,4490,257,11,17,28,39.3%,12m
1484,2,meow,4490,137,6,9,15,40.0%,12m
1484,1,[ITMA]Linxydor,4490,48,3,7,10,30.0%,16m
1484,3,[BGuard]CardBoxMan,4490,10,2,5,7,28.6%,19m
1491,3,[ЯD]Phobus,4489,306,22,25,47,46.8%,14m
1491,3,[Mkers]ÐęąÐŞĦąÐoŴ,4489,0,0,1,1,0.0%,16m
1491,3,[ICGl]MuDVaGe,4489,0,0,1,1,0.0%,16m
1494,3,[FRMSTR]FloWency,4488,1945,180,168,348,51.7%,3m
1494,2,Sam,4488,321,13,19,32,40.6%,17m
1494,3,[R4D]ZhinGarello,4488,0,0,1,1,0.0%,6m
1497,3,[pooooo]GrosSacASac,4487,2266,378,382,760,49.7%,10m
1498,3,braeburn,4486,1102,63,59,122,51.6%,7m
1498,3,IIIIIIIIIIII,4486,425,24,4,28,85.7%,5m
1498,3,[EZBois]WaWu,4486,102,16,9,25,64.0%,15m
1501,2,NeZloben,4485,242,11,19,30,36.7%,14m
1501,3,VelttoJuusto,4485,0,0,4,4,0.0%,5m
1503,1,MindsOfXCIX,4484,2673,284,299,583,48.7%,7m
1503,2,Okeydoke,4484,2422,163,172,335,48.7%,14m
1503,3,Kat,4484,567,28,6,34,82.4%,11m
1503,3,ErmineRanger,4484,30,4,2,6,66.7%,17m
1503,3,[SqAUT]OneYearOld,4484,24,2,7,9,22.2%,2m
1508,3,Smash,4483,110,15,11,26,57.7%,11m
1509,2,BananaStand,4482,2371,229,247,476,48.1%,12m
1509,3,Mike,4482,2020,113,112,225,50.2%,16m
1509,3,Shohei,4482,883,53,51,104,51.0%,11m
1509,3,[Dobro]FARD,4482,0,0,1,1,0.0%,7m
1513,2,[сSсǃ]Мороженко,4481,1168,112,98,210,53.3%,12m
1513,3,DeepOnes,4481,441,45,21,66,68.2%,17m
1513,3,AshKore,4481,342,21,25,46,45.7%,18m
1513,1,[PÂRłAH]Microbot,4481,0,1,0,1,100.0%,34m
1517,3,Noreaga,4480,0,1,0,1,100.0%,19m
1517,3,[TAW]FizzyElf,4480,0,0,1,1,0.0%,19m
1517,3,llllllllllll,4480,0,0,1,1,0.0%,16m
1520,3,[ArGGEJ]GuitarKing,4479,2288,207,196,403,51.4%,16m
1520,3,Trandon,4479,765,59,42,101,58.4%,16m
1520,3,FirstTry,4479,426,22,3,25,88.0%,16m
1520,3,BattleMage,4479,203,14,5,19,73.7%,7m
1520,2,[TSFU]HDZOMBIEKILL,4479,0,2,4,6,33.3%,33m
1525,3,IIIIIIIIII,4478,698,44,48,92,47.8%,2m
1525,3,Tatarin,4478,778,43,45,88,48.9%,19m
1525,3,CheeseOr,4478,10,2,5,7,28.6%,2m
1528,3,Dobek,4477,2186,401,387,788,50.9%,3m
1528,3,[SidO]Anpanman,4477,1469,79,73,152,52.0%,18m
1528,3,Artanior,4477,72,19,22,41,46.3%,33m
1528,2,SLOWERkirchi,4477,173,8,15,23,34.8%,10m
1532,2,Shammythefox,4476,2118,185,154,339,54.6%,9m
1532,3,YouAreNoob,4476,76,8,5,13,61.5%,33m
1532,3,[TMNTz]Zizou,4476,0,0,1,1,0.0%,7m
1535,3,[QTp2T]Zoxx,4475,20,3,1,4,75.0%,33m
1536,3,[BNest]LoneWolf,4474,468,35,32,67,52.2%,6m
1536,3,[SaneGG]SilverFang,4474,0,0,1,1,0.0%,33m
1538,2,[Blacer]canabuz,4473,2314,149,159,308,48.4%,12m
1538,1,[TheDOH]Dain,4473,1901,122,127,249,49.0%,3m
1538,2,Klein,4473,550,26,25,51,51.0%,4m
1541,1,[TheDOH]BaumesBaum,4472,2379,139,151,290,47.9%,8m
1541,3,[GdAT]KageMaru,4472,588,33,39,72,45.8%,34m
1541,3,CRY,4472,106,12,10,22,54.5%,33m
1541,3,[Kabo0M]ZolunariaEU,4472,0,1,5,6,16.7%,33m
1541,3,[BLNJ]lynix,4472,0,0,1,1,0.0%,4m
1546,2,CriminalScum,4471,1728,149,148,297,50.2%,19m
1546,1,[Forell]Masterchif,4471,1082,58,61,119,48.7%,5m
1546,3,[ASGǂ]Speedy,4471,0,1,0,1,100.0%,20m
1549,2,[Blacer]Cobra,4470,847,92,84,176,52.3%,13m
1549,3,Nizahe,4470,0,0,1,1,0.0%,33m
1549,3,lkkkkk,4470,0,0,2,2,0.0%,3m
1552,1,bumacles,4469,2550,420,419,839,50.1%,12m
1552,3,IlIlIlIlIlIl,4469,331,19,1,20,95.0%,3m
1554,2,Ezzored,4468,2367,298,283,581,51.3%,12m
1554,3,AlbOoZ,4468,264,18,10,28,64.3%,20m
1554,3,GoodLuck,4468,182,17,15,32,53.1%,16m
1554,3,YoLOSWaGGiNS,4468,141,7,6,13,53.8%,7m
1558,3,[VFish]Abyss,4467,14,2,2,4,50.0%,4m
1558,3,Mason,4467,20,2,4,6,33.3%,16m
1558,3,[Heroes]Xylophone,4467,0,0,5,5,0.0%,3m
1561,3,[TheDOH]Mathis,4466,364,27,25,52,51.9%,33m
1561,3,[MAFIAA]Kfry,4466,26,5,3,8,62.5%,3m
1561,3,[SpicY]Dumpfbacke,4466,0,0,1,1,0.0%,11m
1561,3,ulc,4466,0,0,1,1,0.0%,3m
1565,3,Fantomas,4465,2261,904,903,1807,50.0%,10m
1565,2,MassReaper,4465,1166,88,84,172,51.2%,10m
1565,3,ZealotMarine,4465,46,6,10,16,37.5%,16m
1565,3,ligist,4465,38,5,6,11,45.5%,15m
1565,2,Nanowi,4465,94,3,1,4,75.0%,9m
1565,3,[Tanкy]DrVanNostren,4465,0,1,0,1,100.0%,19m
1565,3,[MWorld]DonCarleone,4465,4,1,2,3,33.3%,17m
1572,2,[HBGSJR]Тescatlipoka,4464,2457,211,207,418,50.5%,10m
1572,2,Smart,4464,2337,126,115,241,52.3%,12m
1572,3,Cognite,4464,1760,95,99,194,49.0%,34m
1572,3,[ŦHeS]FÅTÐåddy,4464,20,3,1,4,75.0%,33m
1572,3,[5minGG]Riven,4464,0,1,5,6,16.7%,11m
1577,3,[AIice]Alicization,4463,1573,114,71,185,61.6%,20m
1577,3,rtegfdq,4463,203,39,21,60,65.0%,34m
1577,3,[KDV]MCU,4463,48,6,7,13,46.2%,7m
1580,3,[iX]Kuhmelker,4462,2099,141,143,284,49.6%,7m
1580,2,lllllllllll,4462,1123,57,63,120,47.5%,10m
1580,3,Jusseppe,4462,814,43,18,61,70.5%,20m
1580,3,Rapdis,4462,4,2,1,3,66.7%,18m
1584,3,BarBeQ,4461,517,26,8,34,76.5%,33m
1585,3,Driftoss,4459,2199,137,127,264,51.9%,3m
1585,2,Nars,4459,640,61,63,124,49.2%,10m
1587,2,[mCon]TOPshooter,4458,2244,130,123,253,51.4%,10m
1587,3,[Kicx]ƔiƦus,4458,619,55,9,64,85.9%,2m
1587,3,ПриветОтОпти,4458,0,0,3,3,0.0%,19m
1590,3,Vlad,4457,349,20,3,23,87.0%,34m
1590,3,LNXT,4457,0,1,0,1,100.0%,33m
1590,3,[title]LadderHero,4457,0,1,3,4,25.0%,33m
1593,3,[FRZS]Troizza,4456,229,22,11,33,66.7%,11m
1593,3,[BxFǂ]Draebae,4456,18,2,3,5,40.0%,16m
1595,3,[CeƧ]Holly,4455,176,20,20,40,50.0%,19m
1595,2,[SaneGG]Rednax,4455,207,12,8,20,60.0%,10m
1595,3,IIllIIlIlIll,4455,42,4,1,5,80.0%,10m
1595,3,Humpen,4455,0,0,1,1,0.0%,16m
1599,3,[DWMM]UnReal,4454,1044,94,93,187,50.3%,10m
1599,3,[TSVB]JCGamer,4454,0,0,1,1,0.0%,11m
1599,3,Luke,4454,0,0,1,1,0.0%,18m
1602,3,[HEIßE]Bratwurst,4453,32,4,8,12,33.3%,18m
1602,3,[eXøde]FerouCyril,4453,22,3,5,8,37.5%,15m
1604,2,[CОS]SeV,4452,2458,228,241,469,48.6%,19m
1605,2,[SSC2]Aleksandr,4450,1306,95,107,202,47.0%,12m
1605,2,helloRJ,4450,319,19,20,39,48.7%,8m
1605,3,[WoLA]Käsebrot,4450,2,2,2,4,50.0%,20m
1605,3,[CARCAS]danaheir,4450,0,1,0,1,100.0%,18m
1605,3,TerranUApart,4450,0,1,0,1,100.0%,6m
1610,3,GrafHomer,4449,0,1,0,1,100.0%,19m
1611,3,ZylslyZ,4448,18,4,0,4,100.0%,3m
1612,3,[BBSC2]ADAV,4447,0,1,0,1,100.0%,19m
1612,3,Cuckold,4447,0,1,0,1,100.0%,18m
1612,1,[TAGGX]SlammerPower,4447,0,0,2,2,0.0%,4m
1612,3,Cicero,4447,0,0,2,2,0.0%,16m
1616,3,ReFleXioN,4446,694,45,47,92,48.9%,16m
1616,3,DreamState,4446,234,44,32,76,57.9%,11m
1616,3,lexad,4446,466,23,15,38,60.5%,12m
1616,2,[aW]Oripe,4446,0,2,7,9,22.2%,4m
1616,3,DrDerekSmart,4446,0,0,1,1,0.0%,33m
1621,3,[Heroes]Moes,4445,1496,335,291,626,53.5%,7m
1621,3,[Hаsu]CreATIve,4445,792,54,45,99,54.5%,18m
1621,3,[DarkAG]Dro,4445,718,42,29,71,59.2%,12m
1621,3,Emilia,4445,534,34,33,67,50.7%,18m
1621,3,[сSсǃ]icygeo,4445,201,16,10,26,61.5%,11m
1621,3,Snape,4445,0,0,1,1,0.0%,16m
1621,3,Blade,4445,0,0,1,1,0.0%,16m
1621,3,IIIIIZIIIII,4445,0,0,2,2,0.0%,11m
1629,3,[GoldM]Amberdrake,4444,52,6,9,15,40.0%,5m
1629,3,[EESC]Supersonic,4444,44,4,5,9,44.4%,3m
1631,1,langesMESSER,4443,252,11,0,11,100.0%,4m
1631,3,[SCiE]Timasty,4443,0,0,1,1,0.0%,15m
1633,3,[LiFe]makkkes,4442,34,3,1,4,75.0%,16m
1633,3,FonikosGypas,4442,16,2,1,3,66.7%,17m
1635,3,Pvtbryan,4441,94,9,10,19,47.4%,10m
1635,3,[BOONK]llllllllllll,4441,0,1,0,1,100.0%,17m
1637,3,esc,4440,438,33,39,72,45.8%,6m
1637,3,Kingdom,4440,36,6,6,12,50.0%,2m
1637,3,[NuF]Braunbär,4440,12,3,1,4,75.0%,2m
1637,3,SetoKaiba,4440,0,0,1,1,0.0%,18m
1641,3,ChristineEVE,4439,479,29,10,39,74.4%,14m
1641,3,PoLex,4439,106,13,13,26,50.0%,10m
1641,3,Mirmikita,4439,0,0,1,1,0.0%,7m
1641,3,IIiiIIIIIIII,4439,0,0,1,1,0.0%,6m
1645,3,Aryster,4438,2149,160,135,295,54.2%,18m
1645,3,[hBǂ]Sheeno,4438,1155,152,138,290,52.4%,12m
1645,3,WindSteel,4438,941,68,66,134,50.7%,19m
1645,3,Gear,4438,18,4,6,10,40.0%,18m
1645,3,Blink,4438,16,1,2,3,33.3%,3m
1650,3,[isIMBA]Parathix,4437,12,3,4,7,42.9%,20m
1650,3,[DaFF]gotmilk,4437,0,1,0,1,100.0%,16m
1652,2,[Arrows]Dmitry,4436,2446,427,442,869,49.1%,7m
1652,3,[SKYBRS]CLASSIC,4436,322,56,52,108,51.9%,18m
1652,3,nomatch,4436,42,4,6,10,40.0%,7m
1652,3,[Wolven]GuardianWisp,4436,6,2,0,2,100.0%,14m
1656,3,mosmat,4435,1381,90,96,186,48.4%,33m
1656,3,[VFN]LEoNiDAs,4435,14,3,3,6,50.0%,3m
1656,3,Aryl,4435,0,1,0,1,100.0%,19m
1656,3,MADVILLAIN,4435,0,0,2,2,0.0%,16m
1660,1,[Тетере]IIIIIIIIIIII,4433,2655,440,445,885,49.7%,13m
1660,3,Pikle,4433,561,28,8,36,77.8%,11m
1660,3,[LdYGuY]FrikiSama,4433,28,5,2,7,71.4%,18m
1660,3,[aW]MoOkaShade,4433,20,2,2,4,50.0%,18m
1664,2,llllllllllll,4432,618,28,38,66,42.4%,19m
1664,3,[TSI]Aicy,4432,367,17,22,39,43.6%,11m
1664,3,kabal,4432,4,2,6,8,25.0%,7m
1664,3,Optics,4432,0,0,1,1,0.0%,34m
1668,3,robotikov,4431,38,7,5,12,58.3%,4m
1668,3,[PSlSTC]Reborn,4431,16,1,3,4,25.0%,34m
1670,3,mozgj,4430,2240,195,193,388,50.3%,6m
1670,3,Behaemmerter,4430,32,5,3,8,62.5%,33m
1672,3,[PLA2N]limboid,4427,2214,329,325,654,50.3%,19m
1672,3,[SaCult]Healta,4427,1030,71,63,134,53.0%,12m
1672,2,luana,4427,142,4,0,4,100.0%,10m
1672,3,UnSummoner,4427,0,0,1,1,0.0%,16m
1676,2,Argren,4426,448,62,60,122,50.8%,4m
1676,3,Kay,4426,131,10,7,17,58.8%,16m
1678,3,Malikou,4425,1579,341,320,661,51.6%,3m
1678,3,[BFeS]Tachyon,4425,0,0,1,1,0.0%,19m
1680,3,[NPCǂ]SadFace,4423,499,26,0,26,100.0%,20m
1680,3,WooX,4423,220,8,4,12,66.7%,18m
1682,3,[BRSKR]Illustrated,4422,322,28,26,54,51.9%,15m
1682,3,[VFish]Heggy,4422,282,20,23,43,46.5%,16m
1682,3,Lila,4422,18,2,0,2,100.0%,3m
1685,2,Apathy,4421,2360,353,366,719,49.1%,17m
1685,3,imbaGriffith,4421,785,114,82,196,58.2%,5m
1685,3,Troizza,4421,112,12,5,17,70.6%,33m
1685,3,JaSønGG,4421,117,6,3,9,66.7%,16m
1685,3,[IWDRI]Domian,4421,127,3,1,4,75.0%,16m
1685,3,kkthxbye,4421,4,2,0,2,100.0%,33m
1685,3,morg,4421,8,2,1,3,66.7%,19m
1692,3,[LFVoid]Zagara,4420,107,28,26,54,51.9%,19m
1692,3,PanŻuk,4420,180,26,25,51,51.0%,16m
1692,3,Tezu,4420,180,15,21,36,41.7%,10m
1692,1,[AFRSC2]Stats,4420,0,0,1,1,0.0%,8m
1696,2,Stewie,4419,1376,203,208,411,49.4%,12m
1696,3,HallaG,4419,22,5,2,7,71.4%,19m
1696,2,IIIIIIIIIIII,4419,0,3,6,9,33.3%,10m
1696,3,NoobMaster,4419,10,1,1,2,50.0%,34m
1696,3,[sikCty]Magen,4419,0,0,1,1,0.0%,20m
1696,3,lamer,4419,0,0,2,2,0.0%,3m
1702,3,DarkTech,4418,235,14,10,24,58.3%,33m
1702,1,llllllllllll,4418,206,8,6,14,57.1%,8m
1702,3,LegitBMW,4418,0,0,1,1,0.0%,11m
1702,3,[LSPs]Adarthyo,4418,0,0,1,1,0.0%,11m
1706,3,IIIIIIIIIIII,4417,560,70,46,116,60.3%,19m
1706,3,ENRICOLETTA,4417,20,5,2,7,71.4%,15m
1706,3,SANITAR,4417,0,1,1,2,50.0%,10m
1709,3,[Rol3kg]SemVaus,4416,2250,380,369,749,50.7%,17m
1709,1,[DFgs]GuMihu,4416,195,5,3,8,62.5%,15m
1709,3,LifeIsPain,4416,0,1,0,1,100.0%,20m
1709,3,[GoldM]TimeLord,4416,0,1,0,1,100.0%,10m
1709,3,[NVY]QuanTa,4416,0,1,0,1,100.0%,10m
1709,3,Trap,4416,0,0,1,1,0.0%,16m
1715,3,[IBeAŚI]Bliss,4415,881,178,151,329,54.1%,16m
1715,3,Sneakyfrog,4415,1370,172,129,301,57.1%,20m
1715,2,MarineRu,4415,48,3,3,6,50.0%,3m
1715,3,Charoisaur,4415,8,1,1,2,50.0%,16m
1719,2,Nightmare,4414,1884,95,91,186,51.1%,7m
1719,3,Rednax,4414,20,4,5,9,44.4%,12m
1721,2,LaCruz,4413,2032,190,195,385,49.4%,17m
1721,3,cookie,4413,513,42,16,58,72.4%,33m
1723,2,Mimi,4412,581,85,65,150,56.7%,13m
1723,3,Megz,4412,1158,55,46,101,54.5%,33m
1723,3,[6MP]Zeo,4412,424,30,33,63,47.6%,7m
1723,2,[LuuZ]YnooZ,4412,652,29,43,72,40.3%,17m
1723,3,CopyThat,4412,159,18,18,36,50.0%,4m
1723,3,Pobble,4412,8,4,3,7,57.1%,20m
1723,3,Яемзадницу,4412,0,1,1,2,50.0%,7m
1723,3,[MkersA]Nomisking,4412,6,1,1,2,50.0%,18m
1731,2,Undead,4411,1984,131,129,260,50.4%,17m
1731,3,dfg,4411,660,119,130,249,47.8%,19m
1731,3,[dAce]Sockisen,4411,560,39,32,71,54.9%,34m
1731,3,Willy,4411,180,19,16,35,54.3%,12m
1731,3,[EseEse]EseEseEse,4411,248,16,10,26,61.5%,7m
1731,3,[Draigo]Pretorian,4411,0,1,1,2,50.0%,18m
1731,3,[BlaDia]granitor,4411,0,0,1,1,0.0%,16m
1731,3,Slashman,4411,0,0,1,1,0.0%,16m
1739,2,[ArGGEJ]Bas,4410,2427,315,314,629,50.1%,14m
1739,3,TEDstrateg,4410,270,11,2,13,84.6%,15m
1741,3,Hanku,4409,1716,88,88,176,50.0%,12m
1741,2,ShadowLight,4409,92,3,1,4,75.0%,3m
1741,3,ẕѧұø,4409,0,1,0,1,100.0%,18m
1744,2,NutellaHoden,4408,2453,671,678,1349,49.7%,4m
1744,1,faton,4408,2639,268,270,538,49.8%,13m
1744,3,[Z3RGML]Baldman,4408,1509,93,90,183,50.8%,18m
1744,2,[3Д]SpeCial,4408,1672,84,67,151,55.6%,8m
1744,3,[IBeAŚI]Forescene,4408,32,5,5,10,50.0%,7m
1744,3,Taurin,4408,40,4,4,8,50.0%,5m
1744,3,[EESC]Kellermann,4408,0,2,2,4,50.0%,7m
1744,3,Bunny,4408,0,1,0,1,100.0%,34m
1744,3,Beili,4408,0,0,1,1,0.0%,33m
1753,3,[MVPkr]llllllllllll,4407,6,2,0,2,100.0%,7m
1754,2,Archaleon,4406,2390,679,699,1378,49.3%,10m
1754,3,Potato,4406,604,33,41,74,44.6%,4m
1754,3,Nox,4406,336,21,4,25,84.0%,20m
1754,3,[AnD]Alpina,4406,0,1,0,1,100.0%,7m
1754,3,СилаАниме,4406,0,1,1,2,50.0%,16m
1759,3,Caracarn,4405,1472,157,102,259,60.6%,7m
1759,3,[nB]DreinarK,4405,857,48,48,96,50.0%,10m
1759,3,Mae,4405,146,4,2,6,66.7%,33m
1759,3,[SZ]Fairespiter,4405,10,4,4,8,50.0%,2m
1759,3,Adomas,4405,0,0,2,2,0.0%,16m
1764,2,Ownards,4404,2170,191,211,402,47.5%,4m
1764,3,[CLFEF]weebLORD,4404,646,30,13,43,69.8%,4m
1764,3,Nuclear,4404,0,1,0,1,100.0%,7m
1767,3,kurwox,4403,682,54,58,112,48.2%,18m
1767,3,DemonHeart,4403,425,45,24,69,65.2%,17m
1767,2,FredTiffo,4403,512,34,46,80,42.5%,8m
1767,3,Caesar,4403,401,23,20,43,53.5%,33m
1767,3,Rowey,4403,26,2,6,8,25.0%,11m
1772,3,[НТТ]Debaff,4402,2240,249,246,495,50.3%,33m
1773,3,llllllllllll,4401,518,40,13,53,75.5%,4m
1774,3,SnakeDoctor,4400,2080,209,199,408,51.2%,12m
1774,3,NOD,4400,1108,85,79,164,51.8%,16m
1774,2,Plaisi,4400,48,4,8,12,33.3%,10m
1774,3,magic,4400,0,0,3,3,0.0%,17m
1778,3,KANE,4399,1948,206,176,382,53.9%,18m
1778,3,[PiGPan]Qazl,4399,752,73,64,137,53.3%,34m
1778,3,[LLFF]Hydroxi,4399,0,1,0,1,100.0%,17m
1778,3,Littlemaxy,4399,4,1,2,3,33.3%,19m
1778,3,Axion,4399,0,0,1,1,0.0%,12m
1783,3,[AISC]PacWac,4398,182,22,20,42,52.4%,19m
1783,3,[QTcIub]GreG,4398,24,5,4,9,55.6%,19m
1783,3,[BATG]SnipeFive,4398,0,1,0,1,100.0%,34m
1786,3,[iX]Immortal,4397,2194,300,295,595,50.4%,14m
1786,1,IlIlIlIlIlIl,4397,250,12,5,17,70.6%,11m
1786,3,GeneralSkarm,4397,6,2,1,3,66.7%,11m
1789,3,Artvel,4396,1319,146,130,276,52.9%,19m
1789,3,[MCat]DrOrk,4396,1063,90,25,115,78.3%,16m
1789,2,Xado,4396,1605,89,91,180,49.4%,8m
1789,1,[Peeps]BUFOR,4396,2236,89,102,191,46.6%,12m
1789,3,[LMBD]Bwonsamdi,4396,562,40,43,83,48.2%,16m
1789,3,[GXalpH]IIIIIIIIIIII,4396,90,1,1,2,50.0%,14m
1789,3,tcKane,4396,0,0,1,1,0.0%,14m
1796,3,[FWin]XupinatoR,4395,1377,141,129,270,52.2%,16m
1796,3,root,4395,620,26,9,35,74.3%,20m
1796,3,Cusu,4395,14,2,10,12,16.7%,33m
1796,3,Angesandet,4395,6,1,2,3,33.3%,10m
1800,3,Vincent,4394,2237,312,290,602,51.8%,7m
1800,3,Heisenberg,4394,164,13,8,21,61.9%,16m
1800,3,[NuF]Zaphragor,4394,279,11,4,15,73.3%,17m
1800,3,Reverse,4394,221,8,1,9,88.9%,2m
1804,3,[Cannоn]TypVomAldi,4393,0,0,1,1,0.0%,16m
1805,3,Liusun,4392,1621,159,111,270,58.9%,3m
1805,3,[RstE]NicoStar,4392,12,3,6,9,33.3%,17m
1805,3,Lorus,4392,0,1,0,1,100.0%,16m
1805,3,[q3d]GWS,4392,0,0,1,1,0.0%,11m
1805,3,Jart,4392,0,0,1,1,0.0%,15m
1810,2,TheDarkOne,4391,1258,163,147,310,52.6%,10m
1810,3,TurnoFF,4391,12,3,1,4,75.0%,14m
1812,3,Eäril,4390,1391,223,212,435,51.3%,34m
1812,3,Garvock,4390,488,66,34,100,66.0%,17m
1812,3,NERFTERRAN,4390,962,66,63,129,51.2%,16m
1812,3,[LoCarb]Macroroni,4390,720,32,13,45,71.1%,3m
1812,3,Stalker,4390,280,26,21,47,55.3%,16m
1812,3,ZalOs,4390,149,10,5,15,66.7%,18m
1812,3,IIIIIIIIIIII,4390,8,3,11,14,21.4%,7m
1812,3,MyFox,4390,0,1,0,1,100.0%,18m
1820,2,[Cannоn]Onliner,4389,2142,203,205,408,49.8%,4m
1820,3,[K0mpis]SkalmaN,4389,1412,72,79,151,47.7%,11m
1820,3,xBow,4389,420,51,10,61,83.6%,17m
1820,3,lllllllllll,4389,456,39,28,67,58.2%,7m
1820,3,[ORRO]jul,4389,0,0,1,1,0.0%,34m
1825,2,[EESC]JoaN,4388,2328,211,207,418,50.5%,10m
1825,3,Testa,4388,1229,92,49,141,65.2%,12m
1825,3,Ausländer,4388,161,31,20,51,60.8%,16m
1825,3,EaGLe,4388,382,27,34,61,44.3%,7m
1825,3,[котята]IrSJekSoull,4388,422,24,6,30,80.0%,33m
1825,3,[cFADDA]KoloSSaL,4388,318,23,19,42,54.8%,19m
1831,2,ment,4387,1303,104,115,219,47.5%,19m
1832,3,[IBeAŚI]Epiku,4386,2138,354,357,711,49.8%,18m
1832,3,TerenceSkill,4386,1746,204,190,394,51.8%,7m
1832,3,charf,4386,1510,110,106,216,50.9%,7m
1832,3,[lMMl]Lithian,4386,0,0,1,1,0.0%,3m
1832,3,[WysH]crazymanT,4386,0,0,1,1,0.0%,34m
1837,2,[TheDOH]wolfsha,4385,1789,81,88,169,47.9%,4m
1837,3,[HQ31er]NoWay,4385,152,21,7,28,75.0%,11m
1837,3,[ISWAGl]sQuare,4385,32,5,9,14,35.7%,19m
1837,3,[LSPs]JôJô,4385,105,3,2,5,60.0%,20m
1837,3,Practiser,4385,10,2,1,3,66.7%,5m
1837,3,[BoBa]Elite,4385,0,0,1,1,0.0%,34m
1843,3,lllllIIlIllI,4384,1083,427,388,815,52.4%,3m
1843,3,Sitael,4384,2185,189,192,381,49.6%,4m
1843,3,Krodin,4384,1463,101,110,211,47.9%,7m
1843,3,SpruceMoose,4384,1031,47,40,87,54.0%,20m
1843,3,[Heroes]Tassad,4384,281,32,28,60,53.3%,4m
1843,3,Kiwi,4384,14,4,5,9,44.4%,11m
1843,3,[ImKing]Jools,4384,90,2,4,6,33.3%,20m
1843,3,[HUJA]GUESH,4384,0,0,1,1,0.0%,19m
1843,3,BALU,4384,0,0,1,1,0.0%,16m
1852,3,[Lambro]bunghole,4383,857,59,15,74,79.7%,16m
1852,3,Ollowain,4383,302,16,2,18,88.9%,7m
1852,2,[SSeiya]Kanon,4383,7,16,33,49,32.7%,8m
1852,2,JPCarCanGG,4383,126,5,4,9,55.6%,8m
1856,3,[ICGl]elfleischo,4382,1154,130,103,233,55.8%,11m
1856,3,[GET]pANDE,4382,1176,111,101,212,52.4%,12m
1856,3,YdOOm,4382,875,72,21,93,77.4%,5m
1856,3,KirillVolkov,4382,546,37,39,76,48.7%,11m
1856,3,Akup,4382,0,1,1,2,50.0%,7m
1856,3,[TKMERD]TKL,4382,0,1,1,2,50.0%,33m
1856,3,[PLA2N]Quark,4382,10,1,2,3,33.3%,7m
1863,2,[Dicboy]Pudgey,4381,1004,53,60,113,46.9%,14m
1863,3,LTE,4381,676,44,29,73,60.3%,16m
1863,3,Kanon,4381,473,25,3,28,89.3%,12m
1863,3,mOOdY,4381,277,11,6,17,64.7%,16m
1863,3,MacroMan,4381,159,6,5,11,54.5%,18m
1863,3,[Heroes]Don,4381,0,1,0,1,100.0%,16m
1863,3,ЭхоУнитаза,4381,0,1,1,2,50.0%,19m
1870,3,Tropic,4380,586,37,48,85,43.5%,11m
1870,3,max,4380,450,29,27,56,51.8%,19m
1870,3,PiNkUniCORN,4380,0,0,2,2,0.0%,14m
1873,3,[RBlood]Fotylex,4379,295,77,71,148,52.0%,18m
1873,3,Starkiller,4379,74,10,13,23,43.5%,18m
1873,3,DeepWater,4379,32,6,6,12,50.0%,20m
1876,3,[HBGSJR]qwaqsha,4378,743,72,22,94,76.6%,11m
1876,3,CheeseZealot,4378,419,19,5,24,79.2%,11m
1876,3,[ExpdtD]Aragnath,4378,3,11,11,22,50.0%,14m
1876,3,shtopr,4378,0,1,0,1,100.0%,34m
1880,3,[Hаsu]Bublic,4377,366,27,29,56,48.2%,16m
1880,3,Darkshogun,4377,525,19,8,27,70.4%,2m
1880,3,GummiSan,4377,422,16,9,25,64.0%,11m
1880,3,[ØC]Hoshi,4377,54,8,8,16,50.0%,16m
1884,2,FANATICK,4376,1674,72,84,156,46.2%,12m
1884,3,OKai,4376,337,22,7,29,75.9%,19m
1884,3,[nElf]xiaomaomi,4376,390,14,8,22,63.6%,16m
1884,3,[1ndica]StOnEd,4376,96,13,10,23,56.5%,19m
1884,3,[Русдрk]SirShiFt,4376,34,9,8,17,52.9%,15m
1884,3,SpiritSun,4376,121,3,1,4,75.0%,16m
1884,3,Ryoma,4376,28,2,10,12,16.7%,16m
1891,3,BarelyAlive,4375,1292,236,236,472,50.0%,20m
1891,3,[TedB]TEDyoutube,4375,1381,86,8,94,91.5%,3m
1891,3,dananoob,4375,818,43,19,62,69.4%,16m
1891,3,[HEROV]HeroMandarin,4375,776,33,16,49,67.3%,7m
1891,3,zumpy,4375,142,19,17,36,52.8%,34m
1891,3,FergusBolter,4375,42,9,9,18,50.0%,19m
1891,3,DireStraits,4375,169,4,2,6,66.7%,16m
1891,3,BoRsAlinO,4375,0,2,9,11,18.2%,18m
1891,3,Pylo,4375,0,0,1,1,0.0%,7m
1900,3,yuaimatme,4374,1021,235,232,467,50.3%,16m
1900,3,IIIIIIIIIIII,4374,1668,117,94,211,55.5%,19m
1900,3,[SRC]VitafreshUA,4374,1634,100,79,179,55.9%,7m
1900,3,FrozenPizza,4374,531,36,22,58,62.1%,33m
1900,3,SarsSan,4374,273,14,0,14,100.0%,3m
1900,3,BilboZeRabit,4374,98,5,2,7,71.4%,34m
1900,3,Deimos,4374,195,5,3,8,62.5%,3m
1900,3,[SLDZ]SolidZKlant,4374,145,4,2,6,66.7%,17m
1900,3,[CIMICE]jhonnybravo,4374,4,2,1,3,66.7%,19m
1909,3,[MISIS]SlavaZA,4373,1518,314,305,619,50.7%,16m
1909,3,Pathos,4373,715,71,67,138,51.4%,4m
1909,3,[NEETS]maq,4373,238,51,41,92,55.4%,34m
1909,3,[KDV]VampireS,4373,0,0,2,2,0.0%,14m
1913,3,BlackSilver,4372,1477,256,192,448,57.1%,15m
1913,3,ChuckNorris,4372,1222,162,96,258,62.8%,3m
1913,3,Faras,4372,1249,53,46,99,53.5%,7m
1913,3,FeuzG,4372,716,38,25,63,60.3%,11m
1913,3,Gaard,4372,146,13,14,27,48.1%,14m
1913,3,[RÐ]CuréCalin,4372,268,10,4,14,71.4%,19m
1913,3,IIIIIIIIIIII,4372,66,8,11,19,42.1%,20m
1913,3,Aivengo,4372,0,0,1,1,0.0%,19m
1913,3,NorDerot,4372,0,0,1,1,0.0%,16m
1913,3,[MkersA]OblIVIoN,4372,0,0,3,3,0.0%,7m
1923,3,[BrKe]Picho,4371,381,92,63,155,59.4%,4m
1923,3,[lMMl]Mirzo,4371,846,45,22,67,67.2%,16m
1923,3,[RAHRAH]Riegel,4371,591,40,30,70,57.1%,2m
1923,3,[WetInd]SoakinWett,4371,272,8,9,17,47.1%,3m
1923,3,[PÂRłAH]robotikov,4371,14,3,4,7,42.9%,34m
1923,3,[CYC]StimToWin,4371,0,1,0,1,100.0%,5m
1923,3,[Yame]YvesMatrak,4371,0,0,1,1,0.0%,18m
1923,3,[aW]AToM,4371,0,0,5,5,0.0%,33m
1931,3,[CEV]TheDustyOne,4370,917,148,146,294,50.3%,34m
1931,3,absiNt,4370,1832,148,147,295,50.2%,7m
1931,3,TerraRuler,4370,1385,112,95,207,54.1%,5m
1931,3,[BEV]Doppelkeks,4370,1299,109,89,198,55.1%,2m
1931,3,StormHead,4370,962,109,110,219,49.8%,11m
1931,3,Sheamus,4370,1210,65,60,125,52.0%,7m
1931,3,TrashCanMan,4370,594,37,40,77,48.1%,11m
1931,3,vonHanS,4370,18,3,3,6,50.0%,34m
1931,3,[WBO]Quezacoalt,4370,4,2,1,3,66.7%,34m
1940,3,BringBackWoL,4369,1788,165,161,326,50.6%,18m
1940,3,[PTLc]iMolter,4369,830,110,99,209,52.6%,16m
1940,3,[Xa]RageKraker,4369,703,26,17,43,60.5%,20m
1940,3,GentleSoul,4369,130,5,5,10,50.0%,3m
1940,3,HoTo,4369,145,3,2,5,60.0%,18m
1940,3,[ЯD]eXit,4369,0,0,1,1,0.0%,11m
1946,3,[EmŦ]Sirio,4368,1442,139,101,240,57.9%,7m
1946,2,PSMASH,4368,1396,121,116,237,51.1%,7m
1946,3,[DSEA]MiauwMiauws,4368,1373,112,109,221,50.7%,20m
1946,3,[сSсǃ]SoFcKingBaD,4368,772,77,53,130,59.2%,5m
1946,3,[BigDad]RyoNarushima,4368,997,71,56,127,55.9%,3m
1946,3,fjfalcon,4368,547,64,18,82,78.0%,7m
1946,3,[AnD]BroChovscopa,4368,235,14,1,15,93.3%,34m
1946,3,[IBeAŚI]GUMGUMRuFFy,4368,104,10,15,25,40.0%,16m
1946,3,Yamazaki,4368,204,7,6,13,53.8%,34m
1946,3,[FrostG]Xayad,4368,12,3,3,6,50.0%,11m
1956,3,kasm,4367,1422,377,370,747,50.5%,7m
1956,3,MrBarcode,4367,604,123,84,207,59.4%,7m
1956,3,[JLN19]Heat,4367,1009,42,36,78,53.8%,4m
1956,3,Swimming,4367,480,30,22,52,57.7%,15m
1956,3,ivangnom,4367,311,13,9,22,59.1%,12m
1956,3,[WestP]mophra,4367,293,10,3,13,76.9%,33m
1956,3,[AnD]llllllllllll,4367,296,10,8,18,55.6%,11m
1956,3,Zubex,4367,56,7,9,16,43.8%,34m
1956,3,Return,4367,112,6,1,7,85.7%,16m
1956,3,DarKSauron,4367,0,1,0,1,100.0%,18m
1966,3,Raze,4366,1043,70,56,126,55.6%,16m
1966,3,[CCAV]Usubeni,4366,112,23,7,30,76.7%,16m
1968,3,[Dae]mareik,4365,1530,121,106,227,53.3%,3m
1968,3,æææ,4365,1171,73,58,131,55.7%,11m
1968,3,kolakot,4365,891,54,38,92,58.7%,16m
1968,3,[KDV]kiesiew,4365,465,25,21,46,54.3%,11m
1968,3,Barboss,4365,189,22,13,35,62.9%,11m
1968,2,PentaLuL,4365,0,5,0,5,100.0%,33m
1974,3,[SNHonk]Bauernopfer,4364,1247,180,173,353,51.0%,18m
1974,3,llllllllllll,4364,1002,50,39,89,56.2%,17m
1974,3,MuadDib,4364,459,37,30,67,55.2%,7m
1974,1,Cute,4364,420,24,41,65,36.9%,12m
1974,3,Phive,4364,338,16,9,25,64.0%,19m
1974,3,Bodeye,4364,10,3,7,10,30.0%,33m
1974,2,[foad]foad,4364,0,0,3,3,0.0%,18m
1981,3,Plusmacher,4363,872,149,125,274,54.4%,11m
1981,3,[HOA]SPQR,4363,1059,58,39,97,59.8%,3m
1981,3,GehBierHolen,4363,379,42,18,60,70.0%,16m
1981,3,Mezzo,4363,577,38,17,55,69.1%,2m
1981,3,[PLA2N]SlyBeetle,4363,754,30,25,55,54.5%,3m
1981,3,Kolyanchik,4363,352,19,2,21,90.5%,7m
1981,3,[RevoGG]iSy,4363,104,10,18,28,35.7%,34m
1981,3,buffy,4363,0,1,0,1,100.0%,11m
1989,3,ProtossOTP,4362,845,122,112,234,52.1%,7m
1989,3,AngryBird,4362,729,28,18,46,60.9%,3m
1989,3,Splitter,4362,520,21,9,30,70.0%,20m
1989,3,[FRLT]sKy,4362,465,17,11,28,60.7%,7m
1989,3,[2II5]FootAbuser,4362,352,14,11,25,56.0%,19m
1989,3,[FUNS]Drizzt,4362,295,10,6,16,62.5%,19m
1989,3,[LBCR]MogA,4362,220,7,3,10,70.0%,34m
1989,3,[BNest]RedKing,4362,46,6,7,13,46.2%,19m
1989,3,vovamneploho,4362,97,1,2,3,33.3%,11m
1989,3,Droopy,4362,0,0,1,1,0.0%,7m
1999,3,gbouille,4361,1328,89,79,168,53.0%,3m
1999,3,[EAU]Shure,4361,1042,74,66,140,52.9%,3m
1999,3,BossOfTheGym,4361,307,64,50,114,56.1%,18m
1999,3,llllllllllll,4361,753,43,26,69,62.3%,11m
1999,3,[РhD]rom,4361,789,33,14,47,70.2%,3m
1999,3,[WaSl]Tafelwasser,4361,145,3,4,7,42.9%,11m
1999,3,[ISWAGl]Uber,4361,0,1,0,1,100.0%,12m
2006,3,[sGeeks]zettick,4360,1356,211,203,414,51.0%,4m
2006,3,darkluster,4360,1571,104,104,208,50.0%,3m
2006,3,Ace,4360,1367,64,54,118,54.2%,3m
2006,3,droku,4360,480,37,36,73,50.7%,11m
2006,3,[Lambro]NovaH,4360,758,29,23,52,55.8%,3m
2006,3,[Kompis]Riksosten,4360,4,1,2,3,33.3%,15m
2006,3,Slaislom,4360,0,0,2,2,0.0%,11m
2013,3,[HBGS]leon,4359,363,13,6,19,68.4%,16m
2013,3,[CircuZ]NalrA,4359,26,6,7,13,46.2%,16m
2015,2,[Sarmat]OsaXNymloth,4358,931,44,54,98,44.9%,9m
2016,3,Susanoo,4357,314,14,11,25,56.0%,18m
2017,3,JpSsy,4356,1558,324,324,648,50.0%,3m
2017,3,LNext,4356,125,7,7,14,50.0%,33m
2019,3,[NUMBIE]OToole,4355,97,2,1,3,66.7%,17m
2020,3,Impact,4354,517,205,182,387,53.0%,33m
2020,3,[7x]Ravengg,4354,1869,104,82,186,55.9%,3m
2020,3,XellOs,4354,293,16,12,28,57.1%,18m
2020,3,[PTLc]Keiga,4354,281,15,6,21,71.4%,18m
2024,3,[RBP3]WaRaX,4353,1467,193,167,360,53.6%,21m
2024,3,[TTSD]Marre,4353,616,64,52,116,55.2%,19m
2026,1,[AP5]AkilDitu,4351,48,2,0,2,100.0%,11m
2026,1,[Kicx]SymraynoR,4351,0,0,1,1,0.0%,33m
2028,2,funstekg,4350,1542,288,275,563,51.2%,4m
2028,3,[Freaks]Schuh,4350,1773,151,163,314,48.1%,34m
2028,3,Mankatsu,4350,1881,149,155,304,49.0%,19m
2028,3,OKUSA,4350,880,39,24,63,61.9%,16m
2028,3,alanmortier,4350,623,39,30,69,56.5%,3m
2028,3,Ronny,4350,152,14,16,30,46.7%,4m
2034,3,[RGH]Maffay,4349,2192,165,158,323,51.1%,7m
2034,3,Hunta,4349,839,60,43,103,58.3%,5m
2034,3,IMYURI,4349,516,35,37,72,48.6%,14m
2034,3,Darkseall,4349,101,2,3,5,40.0%,3m
2034,3,drunk,4349,6,2,4,6,33.3%,15m
2039,3,[APeC]Serenade,4348,1994,128,117,245,52.2%,19m
2039,1,Omega,4348,286,7,6,13,53.8%,4m
2039,1,[aW]IIIIIIIIIIII,4348,0,1,1,2,50.0%,15m
2039,3,[PŖïMĄŁ]PaLLo,4348,97,1,3,4,25.0%,7m
2043,3,XiondrapoS,4347,2135,286,283,569,50.3%,34m
2043,3,[DthCon]McBlanc,4347,1505,88,22,110,80.0%,3m
2043,3,[RBlood]Jiki,4347,756,45,53,98,45.9%,5m
2043,2,FifTyHouRs,4347,146,7,1,8,87.5%,18m
2043,1,Thunderkiss,4347,0,1,0,1,100.0%,12m
2043,3,[ICGl]React,4347,0,0,5,5,0.0%,16m
2049,3,PowerOfHabit,4346,1053,110,109,219,50.2%,14m
2049,3,Noisym,4346,258,62,67,129,48.1%,11m
2049,3,[HSCC]Tecc,4346,329,30,23,53,56.6%,18m
2049,3,bNd,4346,0,18,20,38,47.4%,16m
2053,2,Ponta,4345,1134,78,60,138,56.5%,4m
2053,2,ForAiur,4345,1285,74,91,165,44.8%,19m
2055,3,SpaceCowboy,4344,1911,180,187,367,49.0%,34m
2055,1,Jiraiya,4344,708,16,10,26,61.5%,12m
2057,2,Helios,4343,46,3,5,8,37.5%,4m
2058,3,Cezar,4342,1858,109,117,226,48.2%,34m
2058,3,BiSa,4342,1055,88,89,177,49.7%,34m
2060,1,Liss,4341,1002,24,9,33,72.7%,9m
2060,1,dribbel,4341,0,1,0,1,100.0%,16m
2062,3,[GoldM]Carbine,4340,1205,73,80,153,47.7%,34m
2062,3,IIIIIIIIIIII,4340,648,40,48,88,45.5%,7m
2062,3,Jörg,4340,103,4,3,7,57.1%,19m
2062,2,SmoNKa,4340,137,3,3,6,50.0%,20m
2062,3,[ArGGEU]Dennery,4340,0,1,1,2,50.0%,16m
2067,3,JaCkCraCk,4339,198,6,4,10,60.0%,18m
2067,3,Magnanik,4339,8,3,3,6,50.0%,4m
2067,3,[MHACKS]BtoTheEWARE,4339,121,2,3,5,40.0%,18m
2067,1,Betalands,4339,0,1,0,1,100.0%,20m
2071,3,Bolo,4337,1416,106,88,194,54.6%,4m
2071,2,Alexander,4337,1743,77,92,169,45.6%,11m
2071,3,[bitoQ2]Sazzaro,4337,748,44,49,93,47.3%,19m
2071,3,Whirros,4337,160,17,20,37,45.9%,19m
2071,1,[Dobro]Cactus,4337,288,6,7,13,46.2%,18m
2071,1,INvasion,4337,76,2,2,4,50.0%,4m
2077,3,Dronefart,4336,4,2,5,7,28.6%,7m
2078,1,BloOdSquad,4335,705,29,13,42,69.0%,33m
2078,3,PSF,4335,6,2,5,7,28.6%,3m
2080,3,[BGThot]MiQ,4334,1468,59,57,116,50.9%,3m
2080,1,Probepower,4334,523,23,5,28,82.1%,9m
2080,1,Yuki,4334,274,7,8,15,46.7%,3m
2080,3,Omega,4334,6,4,5,9,44.4%,12m
2084,1,Enigma,4333,378,8,1,9,88.9%,17m
2084,3,[MeIina]UndeadGirl,4333,26,4,8,12,33.3%,15m
2084,1,SnipeFive,4333,0,0,1,1,0.0%,15m
2084,1,Worm,4333,0,0,1,1,0.0%,3m
2084,1,[illGG]NjordSkall,4333,0,0,2,2,0.0%,19m
2089,3,ArkonoM,4331,14,3,4,7,42.9%,3m
2089,1,Fapstation,4331,0,1,0,1,100.0%,15m
2089,3,[RPG2]Lumine,4331,97,1,2,3,33.3%,19m
2089,1,[FrNiCl]Retsof,4331,0,0,2,2,0.0%,15m
2093,3,[ḾǂḰ]Mikifor,4330,342,85,69,154,55.2%,19m
2094,2,Fastrond,4329,2383,308,323,631,48.8%,11m
2094,2,Marshmallow,4329,2388,305,315,620,49.2%,14m
2094,2,[InFy]Dod,4329,1999,92,101,193,47.7%,7m
2094,1,yNeris,4329,1529,80,75,155,51.6%,15m
2094,2,FiftyAPMonly,4329,970,40,64,104,38.5%,19m
2094,1,TiKoz,4329,48,2,5,7,28.6%,8m
2100,2,Argentum,4328,2391,199,209,408,48.8%,17m
2100,3,[RGSC2]DeadSky,4328,1395,152,142,294,51.7%,3m
2100,3,[Kompis]Enoughtoast,4328,2100,146,135,281,52.0%,18m
2100,1,youtoonoob,4328,0,1,0,1,100.0%,4m
2100,1,[VFish]yellow,4328,0,0,1,1,0.0%,11m
2100,1,IIIlllllIIII,4328,0,0,3,3,0.0%,10m
2106,3,[K0mpis]Mojster,4327,1964,149,153,302,49.3%,19m
2106,3,[сSсǃ]GooDCat,4327,837,83,49,132,62.9%,34m
2106,3,[AiRǂ]AirstrikeITA,4327,126,8,10,18,44.4%,7m
2109,1,Odin,4326,48,2,1,3,66.7%,16m
2110,3,[PÂRłAH]SolusRex,4325,1207,59,56,115,51.3%,16m
2110,1,Martin,4325,928,20,18,38,52.6%,15m
2110,3,illusiveman,4325,4,1,4,5,20.0%,7m
2113,3,Airlord,4324,464,18,12,30,60.0%,16m
2113,1,dOMi,4324,96,3,0,3,100.0%,9m
2113,1,[ENV]NeHe,4324,96,2,2,4,50.0%,15m
2113,1,JuliaJessi,4324,0,0,2,2,0.0%,8m
2117,1,Joo,4323,2189,103,71,174,59.2%,17m
2117,2,WilK,4323,863,65,72,137,47.4%,14m
2117,1,Grimlot,4323,1490,48,25,73,65.8%,20m
2117,1,Drongo,4323,408,12,11,23,52.2%,18m
2117,1,[SJSr]Paragon,4323,215,9,5,14,64.3%,3m
2122,3,PartitionF,4322,92,79,81,160,49.4%,19m
2122,2,UnderMiner,4322,1151,76,100,176,43.2%,13m
2122,1,iiiiiiiiiiii,4322,837,29,13,42,69.0%,33m
2122,1,Homelander,4322,264,21,4,25,84.0%,36m
2126,3,[HBGSJR]Taruviel,4321,1077,141,112,253,55.7%,5m
2126,3,ǁAlbØoZǁ,4321,1502,72,46,118,61.0%,3m
2126,3,minstein,4321,442,19,15,34,55.9%,34m
2126,1,[SCBoys]Tegla,4321,96,2,1,3,66.7%,9m
2130,3,lousa,4319,3,10,16,26,38.5%,14m
2131,1,goldenvirus,4318,2243,146,131,277,52.7%,5m
2131,3,Inex,4318,732,61,49,110,55.5%,3m
2133,3,Oopla,4317,1071,92,68,160,57.5%,16m
2134,3,Storm,4316,3,16,18,34,47.1%,34m
2134,1,Figmar,4316,0,1,0,1,100.0%,9m
2134,1,æøå,4316,0,0,1,1,0.0%,20m
2137,1,raychuna,4315,1356,48,28,76,63.2%,8m
2137,3,AryaStark,4315,491,31,27,58,53.4%,33m
2137,3,GEGTturbo,4315,20,11,9,20,55.0%,16m
2137,3,FNCdennis,4315,105,6,7,13,46.2%,11m
2137,2,[SLD]Pixelbuddha,4315,48,3,6,9,33.3%,6m
2142,3,AntiFa,4314,2167,199,206,405,49.1%,19m
2142,1,[WBO]iloveyou,4314,1769,89,94,183,48.6%,34m
2142,2,IIIIIIIIIIII,4314,130,6,24,30,20.0%,12m
2142,1,MethodMan,4314,96,3,1,4,75.0%,4m
2142,3,[BøZø]LtDan,4314,97,3,4,7,42.9%,3m
2142,1,[Dae]Strade,4314,0,1,0,1,100.0%,15m
2148,1,llllllllllll,4313,48,6,0,6,100.0%,10m
2148,1,SugarX,4313,96,2,1,3,66.7%,8m
2150,3,[GdAT]Napolcochon,4312,1759,199,205,404,49.3%,4m
2151,1,Intel,4310,2279,201,206,407,49.4%,33m
2151,1,LeComplete,4310,1318,31,31,62,50.0%,4m
2151,1,iZikk,4310,0,0,1,1,0.0%,4m
2151,1,[ZERBO]Zerbo,4310,0,0,1,1,0.0%,6m
2155,1,Hannibal,4309,517,12,8,20,60.0%,11m
2156,3,Wavelength,4308,1374,93,89,182,51.1%,11m
2157,2,BuffProtoss,4307,2127,166,180,346,48.0%,19m
2157,1,llllllllllll,4307,2118,78,37,115,67.8%,8m
2157,3,Paddington,4307,1258,67,74,141,47.5%,14m
2157,3,[ExpdtD]DiabloFeTo,4307,431,54,56,110,49.1%,11m
2157,2,[SALTYY]Muori,4307,1104,49,61,110,44.5%,5m
2157,3,Bilf,4307,0,1,3,4,25.0%,16m
2163,3,HKcow,4306,2049,445,476,921,48.3%,11m
2163,1,Bug,4306,2099,276,224,500,55.2%,12m
2163,3,IIIIIIIIIIII,4306,1003,112,105,217,51.6%,16m
2163,3,Yrashka,4306,194,14,26,40,35.0%,5m
2163,1,Crackling,4306,239,4,9,13,30.8%,12m
2163,1,coolBreeze,4306,0,0,2,2,0.0%,33m
2169,3,akmal,4305,1369,111,104,215,51.6%,3m
2169,1,[RеG]PrinzEugen,4305,2035,68,58,126,54.0%,33m
2169,1,[АMOVE]ELENTOS,4305,48,2,2,4,50.0%,12m
2169,1,MrWillyarms,4305,45,1,4,5,20.0%,33m
2169,1,[HBGS]Wisper,4305,0,0,1,1,0.0%,10m
2174,1,Yunkar,4304,2206,107,107,214,50.0%,36m
2174,1,Cot,4304,840,18,18,36,50.0%,4m
2176,1,Hydrenoire,4303,1014,27,16,43,62.8%,9m
2177,3,TheHitman,4302,2174,211,219,430,49.1%,4m
2177,2,EnJoY,4302,2307,172,180,352,48.9%,5m
2177,2,Addict,4302,2367,123,128,251,49.0%,12m
2180,1,[laVsl]IIIGGGxIII,4300,0,1,1,2,50.0%,12m
2181,2,yikes,4299,0,5,0,5,100.0%,3m
2182,2,msR,4298,1337,82,78,160,51.2%,14m
2182,1,[Heroes]Chris,4298,1162,28,27,55,50.9%,21m
2182,3,[DGteam]Jeromo,4298,6,2,12,14,14.3%,15m
2182,1,Seki,4298,0,0,1,1,0.0%,17m
2186,3,Intebarasnyg,4297,1794,101,95,196,51.5%,14m
2186,1,ArionG,4297,2154,78,83,161,48.4%,19m
2186,3,jimi,4297,0,16,16,32,50.0%,16m
2186,1,[GG117]GothicGhost,4297,334,8,4,12,66.7%,18m
2186,1,[DF]GrosPapa,4297,144,3,2,5,60.0%,18m
2186,1,Duggi,4297,144,3,4,7,42.9%,15m
2186,3,Agrajag,4297,4,2,5,7,28.6%,19m
2193,1,Emyox,4296,1787,255,250,505,50.5%,3m
2193,1,freDDy,4296,2267,244,238,482,50.6%,33m
2193,1,[iX]MoFuJones,4296,1434,41,31,72,56.9%,15m
2193,1,PrayForRay,4296,861,30,7,37,81.1%,9m
2193,3,[αX]Victor,4296,394,24,21,45,53.3%,5m
2193,3,Guinness,4296,106,13,20,33,39.4%,3m
2193,1,KachaBaneen,4296,0,0,1,1,0.0%,8m
2200,3,[TSC2C]MrCannons,4295,1136,63,61,124,50.8%,11m
2200,3,[SpagLo]Asheir,4295,673,59,56,115,51.3%,34m
2200,3,NIO,4295,82,10,16,26,38.5%,20m
2200,3,ReAP,4295,143,4,6,10,40.0%,11m
2200,3,Retard,4295,0,0,4,4,0.0%,18m
2205,3,xprtN,4294,1375,115,91,206,55.8%,12m
2205,3,[GRNSKN]Sadist,4294,893,53,45,98,54.1%,34m
2205,1,[GoldM]ZeN,4294,558,17,16,33,51.5%,18m
2205,1,IIIIIIIIIIII,4294,458,12,8,20,60.0%,18m
2205,2,nonono,4294,146,8,1,9,88.9%,20m
2205,1,AcQ,4294,0,1,0,1,100.0%,16m
2205,1,[Wø]Equinox,4294,0,0,1,1,0.0%,34m
2212,1,[DMI]BlinkFloyd,4293,2254,461,441,902,51.1%,12m
2212,1,Dude,4293,48,2,0,2,100.0%,8m
2212,1,robeng,4293,0,1,0,1,100.0%,8m
2212,1,Autonigerrr,4293,0,1,1,2,50.0%,5m
2216,3,TinTin,4292,424,27,35,62,43.5%,21m
2216,1,[LVPN]Zazar,4292,796,18,15,33,54.5%,9m
2216,1,[EESC]Torru,4292,0,0,1,1,0.0%,9m
2219,1,[Dae]CybranLord,4291,664,14,11,25,56.0%,15m
2219,3,[НТТ]Unwished,4291,30,3,9,12,25.0%,20m
2221,1,[mlem]TheBotanist,4290,1876,79,106,185,42.7%,9m
2221,3,llllllllllll,4290,1110,68,71,139,48.9%,21m
2221,3,[FLOTOZ]TopFivHotKys,4290,34,7,14,21,33.3%,14m
2224,2,DonMatro,4289,1777,223,233,456,48.9%,14m
2224,3,[ObG1]Lunde,4289,306,25,30,55,45.5%,20m
2224,3,[SmB]casshernD,4289,0,0,8,8,0.0%,16m
2227,3,[SNHonk]Fluffy,4288,1227,83,64,147,56.5%,3m
2227,3,jump,4288,175,5,8,13,38.5%,33m
2227,1,melC,4288,0,2,3,5,40.0%,3m
2227,2,LoveYourLife,4288,0,0,1,1,0.0%,33m
2227,1,ADTank,4288,0,0,2,2,0.0%,16m
2232,1,[VuV]Jidduu,4287,1364,32,26,58,55.2%,12m
2232,3,Koibomlin,4287,187,17,21,38,44.7%,34m
2232,1,[gronk]CAVEMAN,4287,238,5,2,7,71.4%,11m
2235,3,[NONAMЕ]Glacier,4286,1096,154,118,272,56.6%,11m
2235,1,KazoO,4286,0,3,2,5,60.0%,3m
2237,3,[T0WEL]Rdrums,4285,2134,180,181,361,49.9%,34m
2237,1,[GTD]xyCz,4285,288,7,4,11,63.6%,17m
2239,3,Sam,4284,2105,221,216,437,50.6%,7m
2239,3,[eSubaI]Veriol,4284,396,22,25,47,46.8%,17m
2239,1,Amnesia,4284,454,21,6,27,77.8%,20m
2242,3,Cybernight,4282,968,51,48,99,51.5%,19m
2242,1,[PaniC]Bukhgalter,4282,1380,34,22,56,60.7%,8m
2242,1,llllllllllll,4282,0,3,2,5,60.0%,8m
2242,1,VladmirPutin,4282,0,0,1,1,0.0%,15m
2242,2,Scylzahr,4282,0,0,5,5,0.0%,10m
2247,3,[RIZY]Artvel,4280,1936,95,92,187,50.8%,7m
2247,3,[DisKCo]Cann,4280,722,48,33,81,59.3%,16m
2247,1,[PÂRłAH]Satik,4280,832,19,13,32,59.4%,15m
2247,1,MMA,4280,0,0,1,1,0.0%,9m
2251,3,Bax,4279,541,64,59,123,52.0%,11m
2251,3,WINNERatLIFE,4279,826,53,59,112,47.3%,16m
2251,3,lllllllllll,4279,693,35,20,55,63.6%,5m
2251,2,BOBAN,4279,470,28,35,63,44.4%,10m
2255,2,Adi,4278,1800,158,177,335,47.2%,7m
2255,3,MIXRISH,4278,1512,128,116,244,52.5%,16m
2255,3,[BitS]esow,4278,6,2,6,8,25.0%,7m
2258,3,[AiRǂ]Blooddrop,4277,412,32,41,73,43.8%,7m
2258,1,Gobber,4277,911,24,16,40,60.0%,34m
2258,3,[lMMl]Ike,4277,82,10,18,28,35.7%,20m
2258,2,[OCG]mairaki,4277,0,4,2,6,66.7%,6m
2258,1,[RеГ]РуслоДобран,4277,144,3,5,8,37.5%,6m
2263,3,[Tenchu]HandyDandy,4276,987,203,189,392,51.8%,16m
2263,3,MisterEvely,4276,92,10,16,26,38.5%,16m
2263,1,exsis,4276,48,1,4,5,20.0%,8m
2266,3,Viracocha,4275,1419,306,295,601,50.9%,16m
2266,1,Tweak,4275,757,35,26,61,57.4%,9m
2266,1,[GROF]zakalos,4275,192,4,3,7,57.1%,7m
2266,1,llllllllllll,4275,48,1,5,6,16.7%,33m
2270,3,[eloelo]Shakur,4274,365,42,29,71,59.2%,20m
2270,1,[CDLB]TIMBA,4274,0,0,5,5,0.0%,20m
2272,3,[iksD]OzjaszGoldbe,4273,2098,193,201,394,49.0%,17m
2272,3,[Hiii]Umami,4273,1920,131,120,251,52.2%,17m
2272,3,[BRSKR]Restform,4273,1246,83,67,150,55.3%,16m
2272,1,phiL,4273,744,26,6,32,81.2%,33m
2272,2,[MWAF]Hidalgo,4273,0,0,1,1,0.0%,11m
2277,3,Mitchowyn,4272,1636,83,86,169,49.1%,4m
2277,1,RyanRyanRyan,4272,142,3,5,8,37.5%,9m
2279,1,[IceHus]Lelik,4271,2039,323,284,607,53.2%,11m
2279,1,Taeyeon,4271,476,10,12,22,45.5%,6m
2279,1,DingAutomat,4271,48,2,0,2,100.0%,8m
2279,1,dova,4271,0,1,0,1,100.0%,9m
2283,3,Darling,4270,1016,85,84,169,50.3%,11m
2283,1,ZEST,4270,144,4,1,5,80.0%,18m
2283,1,[prYde]SaberRider,4270,0,0,1,1,0.0%,4m
2286,1,DALLAS,4269,2007,70,50,120,58.3%,17m
2286,1,NezukoChan,4269,1478,45,19,64,70.3%,34m
2286,1,Majordark,4269,334,8,8,16,50.0%,9m
2286,1,[POMO]jacazxc,4269,0,0,1,1,0.0%,17m
2286,1,Reys,4269,0,0,3,3,0.0%,18m
2286,1,[EHH]Omop,4269,0,0,5,5,0.0%,3m
2292,1,NoBody,4268,1843,70,26,96,72.9%,20m
2292,1,tcKane,4268,88,2,2,4,50.0%,15m
2292,1,Kaivu,4268,0,1,0,1,100.0%,19m
2295,1,dumè,4267,1696,57,38,95,60.0%,15m
2296,1,MrElusive,4266,2251,126,117,243,51.9%,4m
2297,2,[PiGPan]Barkas,4265,1386,198,220,418,47.4%,7m
2297,3,[PÂRłAH]Wiarnot,4265,327,14,15,29,48.3%,11m
2297,1,Firefly,4265,0,0,1,1,0.0%,9m
2300,1,Ethereum,4264,1683,118,103,221,53.4%,9m
2300,1,[IICPSL]BruceYi,4264,1179,29,26,55,52.7%,34m
2300,1,Intoxicated,4264,0,1,11,12,8.3%,33m
2300,1,[pSi]Svil,4264,0,0,1,1,0.0%,20m
2300,1,[HBGS]MasterVasya,4264,0,0,5,5,0.0%,17m
2305,1,[SMORC]GalaxyGuard,4263,2235,217,186,403,53.8%,7m
2305,1,[EmŦ]eusoc,4263,1170,27,20,47,57.4%,16m
2305,1,FreestyloKZ,4263,0,1,0,1,100.0%,9m
2308,3,[RBP3]WiZdOm,4262,1378,75,88,163,46.0%,33m
2308,1,[Ǽ1]hajprut,4262,1292,32,22,54,59.3%,11m
2308,3,kerokero,4262,688,29,28,57,50.9%,7m
2308,3,Swing,4262,150,14,23,37,37.8%,14m
2312,1,[ggBDC]ThePatriot,4261,424,10,9,19,52.6%,11m
2312,1,llllllllllll,4261,288,7,5,12,58.3%,7m
2312,1,Tempest,4261,192,4,5,9,44.4%,15m
2312,1,thousand,4261,0,1,0,1,100.0%,15m
2312,1,The,4261,48,1,1,2,50.0%,13m
2317,3,[TheDOH]loeblix,4260,1050,61,71,132,46.2%,15m
2317,3,SHOSHO,4260,705,41,32,73,56.2%,16m
2317,1,[HBGSJR]Smiley,4260,0,0,1,1,0.0%,18m
2317,1,Nimlod,4260,0,0,4,4,0.0%,21m
2321,1,Montolovich,4259,152,6,10,16,37.5%,9m
2321,3,[Kicx]simtom,4259,0,3,2,5,60.0%,14m
2321,1,Alice,4259,48,2,0,2,100.0%,9m
2324,1,[N3O]huGGy,4258,2234,141,140,281,50.2%,12m
2324,3,GoPlayTetris,4258,876,42,43,85,49.4%,5m
2324,1,InnKeepeR,4258,1388,41,25,66,62.1%,11m
2324,1,[aW]Emer,4258,288,6,9,15,40.0%,11m
2324,1,[TCOMP]Ballrok,4258,0,0,1,1,0.0%,11m
2329,3,BarCode,4257,1387,77,73,150,51.3%,34m
2329,1,Nergorix,4257,1639,43,47,90,47.8%,9m
2329,1,Marid,4257,1338,33,30,63,52.4%,3m
2329,2,CoinCidenCe,4257,88,5,7,12,41.7%,6m
2329,1,[LOIS]OrisOnFire,4257,0,1,1,2,50.0%,17m
2329,1,[13g12p]TheRex,4257,48,1,2,3,33.3%,9m
2329,3,[PŖïMĄŁ]ŞҚцŁŁўĢдИ,4257,0,1,4,5,20.0%,13m
2336,3,[Bricky]Crocky,4256,1410,224,212,436,51.4%,16m
2337,3,TrapMan,4255,6,3,6,9,33.3%,3m
2338,1,Vilma,4254,562,13,11,24,54.2%,4m
2338,1,Paschulke,4254,288,7,10,17,41.2%,8m
2338,1,[Peeps]DrBBQmcPrism,4254,167,6,6,12,50.0%,4m
2341,3,[bod]Mrkao,4253,58,10,21,31,32.3%,14m
2341,1,[EXEED]DiViNe,4253,0,0,3,3,0.0%,33m
2343,1,suicideisez,4252,2213,334,343,677,49.3%,9m
2343,3,IlIlllIIIllI,4252,1378,99,77,176,56.2%,21m
2343,1,IIIIIIIIIIII,4252,265,10,1,11,90.9%,5m
2343,1,CrabiTTo,4252,382,9,4,13,69.2%,9m
2347,3,Mercury,4251,1910,110,116,226,48.7%,20m
2347,1,Notausername,4251,2216,105,87,192,54.7%,5m
2347,1,YouAnimal,4251,1704,55,35,90,61.1%,7m
2347,1,[FrF]Creed,4251,96,2,6,8,25.0%,11m
2351,2,cucumber,4250,2343,259,279,538,48.1%,12m
2351,1,ZebouTabon,4250,48,2,1,3,66.7%,9m
2351,1,robotter,4250,96,2,3,5,40.0%,6m
2351,1,Achillez,4250,0,1,0,1,100.0%,11m
2351,1,Linus,4250,0,1,0,1,100.0%,4m
2351,1,[tMnrd]mrDarcy,4250,0,0,1,1,0.0%,9m
2351,1,Performance,4250,0,0,1,1,0.0%,17m
2358,1,[ICGl]BananenBaum,4249,0,0,1,1,0.0%,9m
2359,3,Laplada,4248,1977,309,277,586,52.7%,16m
2359,1,[HypC]TheSun,4248,229,5,9,14,35.7%,36m
2359,1,[NMSQ]Kazaro,4248,48,1,1,2,50.0%,34m
2359,1,XIII,4248,48,1,2,3,33.3%,16m
2359,1,eXCALIBUR,4248,0,0,1,1,0.0%,8m
2364,3,JellyB,4247,1989,112,110,222,50.5%,11m
2364,1,[Pyloss]Pyloss,4247,598,34,11,45,75.6%,12m
2364,1,YorGaL,4247,1358,32,31,63,50.8%,12m
2364,3,ЛапаВиниПуха,4247,4,1,8,9,11.1%,4m
2364,1,[GEGT]gaulzi,4247,0,0,6,6,0.0%,20m
2369,3,[BWArmy]Lefrancais,4246,1926,181,179,360,50.3%,20m
2369,1,gag,4246,0,1,0,1,100.0%,33m
2371,1,peculiar,4245,2222,203,194,397,51.1%,16m
2371,3,Spada,4245,1689,124,122,246,50.4%,18m
2371,1,[sCion]Zeratul,4245,48,1,4,5,20.0%,33m
2374,1,Othinus,4244,48,1,2,3,33.3%,12m
2375,3,DrAxelWitsel,4243,2079,182,174,356,51.1%,3m
2376,1,Raspberry,4242,493,17,19,36,47.2%,33m
2376,1,SuperMeatBoy,4242,435,14,14,28,50.0%,4m
2376,1,[MHACKS]Gizmo,4242,48,1,2,3,33.3%,14m
2379,3,UGOlivander,4241,88,11,18,29,37.9%,11m
2379,1,[НТТ]DonLingo,4241,0,0,1,1,0.0%,18m
2381,3,[QTcIub]FrostyFeet,4240,689,57,41,98,58.2%,17m
2381,1,[PSlSTC]MyLifeFrAiur,4240,144,3,2,5,60.0%,9m
2381,1,[TheDOH]Executioner,4240,46,2,0,2,100.0%,11m
2384,1,[PLA2N]warmmachine,4239,1881,111,90,201,55.2%,3m
2384,1,[ArGGEU]Areff,4239,370,11,12,23,47.8%,14m
2384,1,[Zrtl]Ghost,4239,0,0,1,1,0.0%,18m
2387,3,[NBBS]pasen,4238,533,27,20,47,57.4%,11m
2387,1,Joe,4238,751,21,19,40,52.5%,12m
2387,1,[TheDOH]Aztrack,4238,514,12,7,19,63.2%,18m
2387,3,[AmW1]NeonRa,4238,166,11,14,25,44.0%,17m
2391,1,quiz,4237,1918,61,50,111,55.0%,33m
2391,1,bab,4237,1514,37,42,79,46.8%,33m
2391,1,HePhaStiaN,4237,728,17,6,23,73.9%,8m
2394,1,CARRIERS,4236,1403,36,29,65,55.4%,3m
2394,1,xenon,4236,1014,24,20,44,54.5%,11m
2394,1,UKDaza,4236,0,2,3,5,40.0%,4m
2394,1,[GEGT]Merlin,4236,0,0,1,1,0.0%,36m
2394,1,[0BO]Eyepod,4236,0,0,5,5,0.0%,4m
2399,1,cygnus,4235,1795,219,209,428,51.2%,15m
2399,3,IIIIIIIIIIII,4235,1856,165,160,325,50.8%,18m
2399,3,[iX]dreign,4235,1591,110,81,191,57.6%,15m
2399,1,[INAE]Kronos,4235,1272,31,23,54,57.4%,9m
2399,3,KpopIsGay,4235,0,0,2,2,0.0%,3m
2404,1,[mBooze]grKiNred,4234,1134,27,21,48,56.2%,11m
2405,1,[Ǽ1]NePasToucheR,4233,1075,44,32,76,57.9%,5m
2405,3,[BornG]Spoonmaster,4233,386,25,36,61,41.0%,11m
2407,1,[BornG]arT,4232,2240,130,131,261,49.8%,5m
2407,1,slatten,4232,2105,82,74,156,52.6%,3m
2407,1,regandeR,4232,1010,50,39,89,56.2%,15m
2407,3,[НТТ]TefteL,4232,234,17,31,48,35.4%,16m
2407,2,SetoKaiba,4232,172,3,2,5,60.0%,10m
2407,3,[VuV]ElGarno,4232,0,2,2,4,50.0%,8m
2407,3,MrPörfekt,4232,10,2,13,15,13.3%,7m
2414,1,[PÂRłAH]robotikov,4231,1302,31,24,55,56.4%,19m
2415,1,FabzG,4230,1300,35,19,54,64.8%,9m
2415,1,Coffey,4230,484,12,11,23,52.2%,21m
2415,3,[lMMl]Haspe,4230,2,1,8,9,11.1%,12m
2415,1,Artöm,4230,0,0,1,1,0.0%,9m
2415,1,[tvESP]Smonokum,4230,0,0,1,1,0.0%,11m
2420,1,СосискаЛюбви,4229,1462,40,43,83,48.2%,5m
2420,1,Hyrot,4229,144,4,5,9,44.4%,8m
2420,1,[Hplts]Silver,4229,192,4,9,13,30.8%,20m
2423,2,VadeRetro,4228,2287,1405,1452,2857,49.2%,17m
2423,1,Jim,4228,570,13,9,22,59.1%,5m
2423,3,MMA,4228,125,7,6,13,53.8%,3m
2423,1,[eAnoze]Templar,4228,0,0,1,1,0.0%,14m
2427,1,[SGTA]Eclipse,4226,780,39,19,58,67.2%,9m
2427,1,[InBri]Vega,4226,288,6,12,18,33.3%,12m
2427,1,DENb,4226,0,1,1,2,50.0%,19m
2430,3,Sssky,4225,1749,166,171,337,49.3%,5m
2430,1,[Hаsu]Loafer,4225,1867,90,71,161,55.9%,21m
2430,3,Lazzi,4225,1180,55,64,119,46.2%,3m
2430,1,[TerBHD]Aclickterran,4225,0,0,1,1,0.0%,8m
2434,3,NeEdLe,4224,272,27,35,62,43.5%,34m
2434,1,[TkeFiv]Kundera,4224,1064,25,16,41,61.0%,7m
2434,1,TheMentalist,4224,665,16,20,36,44.4%,4m
2434,1,[AHT]Saturos,4224,0,1,2,3,33.3%,3m
2438,1,NaxZ,4223,1074,156,144,300,52.0%,15m
2438,1,[Heroes]CobbleStone,4223,2022,57,59,116,49.1%,3m
2438,1,puLse,4223,798,38,33,71,53.5%,12m
2438,2,TristanI,4223,300,15,34,49,30.6%,7m
2442,3,[Zguege]Quentinous,4222,1637,138,134,272,50.7%,11m
2442,2,[DoS98]Flamm,4222,170,10,29,39,25.6%,8m
2442,1,[FxL]Drannach,4222,144,4,6,10,40.0%,14m
2442,1,ClashWater,4222,96,3,3,6,50.0%,7m
2442,1,Yang,4222,0,0,1,1,0.0%,3m
2442,1,BBBBBBBbbbbb,4222,0,0,4,4,0.0%,11m
2448,1,[2vs2]Tommynaiter,4221,996,22,27,49,44.9%,33m
2448,1,Eclipse,4221,524,12,10,22,54.5%,4m
2448,1,Zeus,4221,238,6,5,11,54.5%,4m
2451,1,Glitch,4220,2091,76,63,139,54.7%,20m
2451,1,KinkyTemplar,4220,977,30,24,54,55.6%,3m
2451,1,[DSSQRT]SeaInside,4220,0,0,1,1,0.0%,33m
2454,3,Bizork,4218,1708,254,263,517,49.1%,7m
2454,2,[сSсǃ]PrinzOnFire,4218,935,46,58,104,44.2%,13m
2454,1,Farghz,4218,437,11,5,16,68.8%,6m
2457,1,IIIIIIIIIIII,4217,1018,23,27,50,46.0%,16m
2457,1,alien,4217,284,8,8,16,50.0%,4m
2457,1,[MooooN]THiiS,4217,0,0,1,1,0.0%,17m
2460,3,Dubblestep,4216,2109,231,236,467,49.5%,3m
2460,3,[Wø]grunts,4216,1657,115,113,228,50.4%,3m
2460,1,IIIIIIIIIIII,4216,598,13,7,20,65.0%,11m
2460,1,ReeeeeFlux,4216,0,0,1,1,0.0%,15m
2464,1,MUODY,4215,537,18,2,20,90.0%,3m
2464,1,[HBGSJR]SenseiTapok,4215,238,5,8,13,38.5%,11m
2464,2,IlIlIlIlIlIl,4215,90,2,8,10,20.0%,13m
2464,1,[TedB]LazyRusBear,4215,0,0,2,2,0.0%,34m
2468,1,[GFN]Krymming,4214,413,11,8,19,57.9%,6m
2468,1,llbatteryll,4214,332,9,12,21,42.9%,33m
2468,1,Atoms,4214,288,7,14,21,33.3%,4m
2468,2,[ZERGML]Seva,4214,94,5,8,13,38.5%,19m
2468,1,[соffeе]InTunDra,4214,144,4,2,6,66.7%,13m
2468,1,Ulz,4214,48,1,4,5,20.0%,33m
2474,1,GreyFox,4213,716,17,6,23,73.9%,33m
2474,1,MozartIRL,4213,382,9,10,19,47.4%,5m
2474,1,[aW]Papaours,4213,144,4,5,9,44.4%,4m
2474,1,[46and2]Mota,4213,0,0,1,1,0.0%,11m
2474,2,Efes,4213,0,0,1,1,0.0%,34m
2479,3,Keria,4212,1336,148,160,308,48.1%,34m
2479,3,[Lobdok]Driminicus,4212,1570,99,93,192,51.6%,3m
2479,1,luke,4212,2138,69,59,128,53.9%,18m
2479,1,BILICH,4212,1637,65,54,119,54.6%,15m
2479,1,[HBGSJR]ace,4212,1453,44,41,85,51.8%,17m
2479,1,IIIIIIIIIIII,4212,870,20,20,40,50.0%,13m
2479,1,[DisES]Squall,4212,450,9,9,18,50.0%,9m
2479,1,[НТТ]dEspAiR,4212,0,4,1,5,80.0%,20m
2479,1,[MFS123]ItcheR,4212,144,3,10,13,23.1%,7m
2479,1,wolfpl,4212,0,0,1,1,0.0%,16m
2489,1,DCAltair,4211,491,16,15,31,51.6%,21m
2489,1,[TINion]Батя,4211,180,4,10,14,28.6%,9m
2489,1,Jungleman,4211,0,1,0,1,100.0%,33m
2489,1,[Heet]SirNoggisI,4211,48,1,7,8,12.5%,13m
2493,1,[RioF]fraat,4210,2199,117,104,221,52.9%,4m
2493,1,Cromm,4210,1416,36,37,73,49.3%,11m
2493,1,[Unosz]Vizza,4210,1017,28,34,62,45.2%,13m
2493,1,[DFgs]sanyi,4210,563,16,18,34,47.1%,9m
2493,3,iGod,4210,165,11,18,29,37.9%,14m
2493,1,Mandalorian,4210,144,4,0,4,100.0%,9m
2493,1,[SoSaTb]CryPony,4210,0,0,1,1,0.0%,5m
2500,1,oIITiMicT,4209,1842,61,57,118,51.7%,33m
2500,1,YourHighLord,4209,919,31,8,39,79.5%,11m
2500,1,[TWIM]Mangomati,4209,742,17,11,28,60.7%,9m
2500,1,[Hаsu]Lopatqa,4209,432,10,8,18,55.6%,8m
2500,1,Haruka,4209,96,3,2,5,60.0%,3m
2500,1,Bauer,4209,0,0,1,1,0.0%,20m
2500,1,Dream,4209,0,0,5,5,0.0%,13m
2507,1,WithiN,4208,2199,90,85,175,51.4%,11m
2507,1,EmilioZapata,4208,528,21,11,32,65.6%,9m
2509,1,Dri,4207,1776,77,81,158,48.7%,4m
2509,1,[PiGPan]emctwo,4207,144,3,3,6,50.0%,8m
2509,1,Magnus,4207,0,1,0,1,100.0%,13m
2509,1,[MN8]NextRim,4207,0,0,1,1,0.0%,10m
2509,1,genghiswolf,4207,0,0,1,1,0.0%,10m
2514,1,Lonkero,4206,1891,73,36,109,67.0%,19m
2514,3,Teypo,4206,225,20,27,47,42.6%,11m
2514,2,UgandaChoppa,4206,0,1,0,1,100.0%,17m
2517,1,pieluch,4205,1905,172,122,294,58.5%,20m
2517,1,[TheDOH]Megatron,4205,1672,74,60,134,55.2%,13m
2517,2,Species,4205,196,9,0,9,100.0%,16m
2520,1,[NagirU]Urigan,4204,1800,138,128,266,51.9%,33m
2520,2,IIIIIIIIIIII,4204,310,11,2,13,84.6%,21m
2520,1,LULU,4204,96,3,0,3,100.0%,19m
2520,1,[1984]BearBeard,4204,48,1,9,10,10.0%,16m
2520,1,knurrp,4204,0,0,3,3,0.0%,4m
2520,1,Bespoke,4204,0,0,3,3,0.0%,6m
2526,1,Heisenberg,4203,2176,71,75,146,48.6%,13m
2526,3,Phantøm,4203,634,40,52,92,43.5%,17m
2526,1,zapromant,4203,394,22,1,23,95.7%,8m
2526,1,SmoothGoof,4203,531,14,16,30,46.7%,36m
2526,1,[EZedSv]WildThing,4203,0,1,1,2,50.0%,3m
2531,1,SantaClaus,4202,2134,233,238,471,49.5%,15m
2531,1,Paralizzka,4202,378,8,8,16,50.0%,34m
2531,1,kkkkkkkkkkkk,4202,209,4,3,7,57.1%,34m
2531,1,Dexter,4202,0,0,1,1,0.0%,8m
2535,1,Nüschel,4201,84,3,7,10,30.0%,12m
2535,1,[AuroN]StellaR,4201,0,1,0,1,100.0%,6m
2537,3,Nikitos,4200,2025,298,311,609,48.9%,34m
2537,1,[Petrus]гогоо,4200,2194,178,175,353,50.4%,16m
2537,1,Sam,4200,570,13,16,29,44.8%,4m
2537,1,[TheDOH]Jefflenious,4200,472,10,12,22,45.5%,13m
2537,1,[PaniC]Johnnie,4200,48,1,9,10,10.0%,21m
2542,1,[aW]swardnight,4199,2220,108,105,213,50.7%,18m
2542,1,Daniel,4199,48,2,4,6,33.3%,5m
2544,1,ChristopherR,4198,1114,97,83,180,53.9%,16m
2544,1,zzWade,4198,1642,40,45,85,47.1%,10m
2544,1,ROG,4198,1066,25,25,50,50.0%,34m
2544,1,zmd,4198,533,21,23,44,47.7%,33m
2544,1,[EYteam]CHiLLuMiNaTi,4198,0,0,1,1,0.0%,3m
2544,1,[eXøde]Crysing,4198,0,0,4,4,0.0%,5m
2550,2,PsyChol,4197,189,12,0,12,100.0%,6m
2550,1,Flibidi,4197,48,1,2,3,33.3%,20m
2550,1,[Kompis]WAWWSamet,4197,0,1,4,5,20.0%,8m
2550,1,EZForWeezy,4197,0,0,1,1,0.0%,36m
2554,3,[aW]Whitelinker,4196,1540,345,319,664,52.0%,18m
2554,3,[pSi]martishon,4196,998,149,132,281,53.0%,19m
2554,3,Darkside,4196,1302,147,134,281,52.3%,15m
2554,3,sgemodd,4196,1196,82,85,167,49.1%,20m
2554,1,FlanDee,4196,0,1,0,1,100.0%,11m
2554,2,Pobifeg,4196,46,1,2,3,33.3%,11m
2554,1,[Wolven]sehriyar,4196,0,0,1,1,0.0%,18m
2561,1,MickeyONeiL,4195,288,7,3,10,70.0%,21m
2561,1,[BHESS]LeBregognon,4195,96,2,1,3,66.7%,20m
2561,1,[FxL]Climate,4195,92,1,1,2,50.0%,10m
2561,1,sBfMarklar,4195,0,0,1,1,0.0%,5m
2565,3,[mfixed]UwUxZosia,4194,1349,75,80,155,48.4%,17m
2565,2,Probetoss,4194,236,13,0,13,100.0%,17m
2565,1,DrowRanger,4194,96,2,9,11,18.2%,15m
2568,1,[TAW]SpaceMarine,4193,1839,68,51,119,57.1%,13m
2568,1,Blaze,4193,964,23,22,45,51.1%,13m
2568,1,[SEХ]Waucan,4193,380,9,8,17,52.9%,8m
2568,1,classic,4193,0,0,1,1,0.0%,8m
2572,1,Arkhan,4192,2216,672,654,1326,50.7%,12m
2572,3,NevadaKid,4192,1253,145,138,283,51.2%,3m
2572,1,JustinBridou,4192,1132,106,82,188,56.4%,4m
2572,1,RainbowJeZ,4192,0,1,0,1,100.0%,15m
2572,2,[KELA]Flash,4192,0,0,1,1,0.0%,19m
2577,1,[icbajs]COCК,4191,848,19,21,40,47.5%,14m
2577,1,Vaillac,4191,424,9,9,18,50.0%,8m
2577,1,Thinn,4191,0,0,1,1,0.0%,19m
2577,2,robotikov,4191,0,0,1,1,0.0%,7m
2577,1,Save,4191,0,0,1,1,0.0%,11m
2582,2,[PŖïMĄŁ]DeepMind,4190,2199,349,368,717,48.7%,5m
2582,1,Joke,4190,1490,47,25,72,65.3%,4m
2582,1,Heinblöd,4190,48,2,0,2,100.0%,9m
2582,1,Nazghull,4190,0,0,1,1,0.0%,9m
2582,1,KEKW,4190,0,0,1,1,0.0%,5m
2587,3,MilkCowabang,4188,1583,149,135,284,52.5%,11m
2587,2,lDunkaNl,4188,284,14,1,15,93.3%,13m
2587,1,[Funky]BluEpRisMe,4188,334,7,10,17,41.2%,11m
2587,1,DarkKnight,4188,236,5,5,10,50.0%,5m
2591,1,Cabb,4187,1630,258,244,502,51.4%,20m
2591,1,VBHustler,4187,566,13,18,31,41.9%,9m
2591,1,Toto,4187,142,3,3,6,50.0%,19m
2594,3,[lWHl]Destro,4186,697,51,44,95,53.7%,18m
2594,1,George,4186,0,1,1,2,50.0%,9m
2594,1,[s182]Varax,4186,0,0,1,1,0.0%,6m
2597,3,[Heroes]BreaDy,4185,1909,105,115,220,47.7%,33m
2597,1,JustMormegil,4185,2060,100,90,190,52.6%,13m
2597,1,[PÂRłAH]SmokedSloth,4185,1690,60,34,94,63.8%,34m
2597,1,Bodeye,4185,1412,35,35,70,50.0%,11m
2597,1,EngineOFlesh,4185,568,22,6,28,78.6%,9m
2602,3,[CMM]ValaOwnzALL,4184,2078,136,151,287,47.4%,20m
2602,1,[PaniC]Kuci,4184,791,21,11,32,65.6%,3m
2602,1,[BluS]Mraptor,4184,368,8,6,14,57.1%,11m
2602,1,DaFaGuaN,4184,94,2,1,3,66.7%,3m
2606,1,[MBK]Mikami,4183,1848,52,46,98,53.1%,9m
2606,3,zavix,4183,335,23,31,54,42.6%,19m
2606,1,AbsolvoTe,4183,289,8,10,18,44.4%,9m
2606,1,[uT]Flaiker,4183,96,3,4,7,42.9%,21m
2610,1,NoLa,4182,382,8,7,15,53.3%,8m
2610,1,IIIIIIIIIIII,4182,48,2,0,2,100.0%,15m
2610,1,Sava,4182,0,1,0,1,100.0%,16m
2610,1,Imbalex,4182,48,1,1,2,50.0%,6m
2610,1,CarrierRush,4182,0,0,1,1,0.0%,19m
2615,1,[2be]True,4181,926,32,32,64,50.0%,5m
2615,1,ScaryWolf,4181,520,12,15,27,44.4%,15m
2615,1,IKSDE,4181,0,0,1,1,0.0%,10m
2618,3,Acxenlupang,4180,1232,60,62,122,49.2%,3m
2618,1,[DisES]Sylfaen,4180,738,20,9,29,69.0%,34m
2618,1,LOKI,4180,48,2,7,9,22.2%,9m
2621,1,PhilDunphy,4179,48,1,2,3,33.3%,9m
2621,3,llllllllllll,4179,0,0,1,1,0.0%,19m
2623,3,Billy,4178,2084,304,327,631,48.2%,12m
2623,1,morettomo,4178,2173,186,186,372,50.0%,35m
2623,1,ByPiligrim,4178,1950,52,56,108,48.1%,20m
2623,1,NaSodium,4178,557,23,8,31,74.2%,20m
2623,1,KìììÂ,4178,935,23,20,43,53.5%,6m
2623,1,Omedeus,4178,0,0,2,2,0.0%,11m
2629,1,cYclopYze,4177,1448,44,41,85,51.8%,14m
2630,1,[HsDL]stichtom,4176,2129,284,253,537,52.9%,8m
2630,1,Vladers,4176,1961,170,144,314,54.1%,4m
2630,1,[ØC]Bekoj,4176,1866,63,62,125,50.4%,34m
2630,1,Ganjhaman,4176,286,6,8,14,42.9%,13m
2630,1,[Мордор]Marty,4176,0,1,0,1,100.0%,34m
2635,1,WizZy,4175,2116,285,288,573,49.7%,15m
2635,3,Sora,4175,0,72,52,124,58.1%,11m
2635,1,[UATeam]NtStreamline,4175,1468,44,45,89,49.4%,13m
2635,3,[TAW]storakles,4175,0,0,1,1,0.0%,20m
2639,3,[AppSha]TAS,4174,2065,226,242,468,48.3%,14m
2639,1,Zellan,4174,1156,34,31,65,52.3%,14m
2639,1,[AI1]VeeRust,4174,986,24,20,44,54.5%,21m
2639,2,IIIIIIIIIIII,4174,167,6,5,11,54.5%,3m
2639,1,preczZkomuna,4174,0,5,0,5,100.0%,3m
2639,2,MarcellDavis,4174,42,2,0,2,100.0%,8m
2639,1,[АNIME]Agumon,4174,0,1,0,1,100.0%,10m
2639,1,[Hplts]HarDDD,4174,0,1,1,2,50.0%,9m
2647,3,[Oath]Columbo,4173,1404,103,110,213,48.4%,17m
2647,1,SpaceUA,4173,1472,54,34,88,61.4%,16m
2647,1,[IBeAŚI]Bene,4173,868,20,19,39,51.3%,15m
2647,1,Kanadan,4173,286,6,17,23,26.1%,8m
2651,3,Mystfade,4172,2089,235,244,479,49.1%,3m
2651,1,LearnToScout,4172,2043,74,61,135,54.8%,10m
2651,1,[HBGSJR]Maxvel,4172,1593,53,57,110,48.2%,13m
2651,1,llllllllllll,4172,0,1,0,1,100.0%,35m
2651,1,[Cannоn]Saitama,4172,48,1,3,4,25.0%,15m
2651,1,SirAspiC,4172,0,1,4,5,20.0%,35m
2657,1,IIIIIIIIIIII,4171,976,23,20,43,53.5%,18m
2657,1,Nickoz,4171,608,19,22,41,46.3%,4m
2657,1,Impulse,4171,48,2,2,4,50.0%,9m
2657,1,Mangue,4171,0,0,2,2,0.0%,13m
2661,1,Bajeczny,4170,1256,83,79,162,51.2%,9m
2661,1,[IndyK]Fly,4170,1539,82,71,153,53.6%,36m
2661,1,ZorroW,4170,2116,67,61,128,52.3%,15m
2661,1,Sondaljan,4170,896,20,17,37,54.1%,20m
2661,1,[uCHAD]SiegeSamolio,4170,0,0,1,1,0.0%,13m
2666,1,TriBBleX,4169,1945,277,260,537,51.6%,36m
2666,3,MasterZERG,4169,1914,166,161,327,50.8%,3m
2666,1,LEBONCARLOS,4169,2051,97,106,203,47.8%,15m
2666,1,[яєѕ]rouninieau,4169,1157,46,36,82,56.1%,17m
2666,1,Maix,4169,1334,31,43,74,41.9%,14m
2666,1,[BeSC]Dante,4169,884,19,23,42,45.2%,5m
2666,1,[3Dǃ]SmoKeShEEp,4169,838,18,9,27,66.7%,8m
2666,1,Taquacman,4169,73,0,10,10,0.0%,20m
2674,1,Mucke,4168,2193,107,104,211,50.7%,3m
2674,1,[NerCC]Nerzgul,4168,2063,66,67,133,49.6%,18m
2674,1,[EHET]mAdmOte,4168,1962,58,65,123,47.2%,10m
2674,1,Ceddel,4168,196,7,7,14,50.0%,36m
2674,1,[ØC]Inkisiteur,4168,282,6,6,12,50.0%,13m
2674,1,llllllllllll,4168,0,0,2,2,0.0%,34m
2680,1,[ENGNS]Mechanics,4167,1550,40,34,74,54.1%,9m
2680,1,[OpIba]IlIlIlIlIlIl,4167,185,4,0,4,100.0%,9m
2680,2,[KS]GuaRDiaN,4167,0,0,1,1,0.0%,20m
2683,1,Drogo,4166,942,32,15,47,68.1%,9m
2683,1,Bison,4166,1148,27,26,53,50.9%,19m
2683,1,KellogZ,4166,976,23,18,41,56.1%,15m
2683,1,DizzyGnome,4166,439,10,13,23,43.5%,15m
2683,1,FrogOfWar,4166,414,9,3,12,75.0%,19m
2683,1,[RGn]Pwnika,4166,0,3,2,5,60.0%,3m
2683,1,[HBGS]Starfish,4166,0,1,1,2,50.0%,9m
2690,1,AzeRat,4165,2102,346,343,689,50.2%,11m
2690,3,IrareAstrum,4165,2023,246,247,493,49.9%,5m
2690,1,Lazare,4165,1348,37,32,69,53.6%,20m
2690,1,Nuffy,4165,329,14,2,16,87.5%,17m
2690,1,oeconomicus,4165,478,10,16,26,38.5%,13m
2695,1,WarLord,4164,2193,187,179,366,51.1%,10m
2695,3,Oleg,4164,2060,147,160,307,47.9%,33m
2695,1,Omni,4164,1260,39,32,71,54.9%,9m
2695,1,Dreadlord,4164,224,6,0,6,100.0%,3m
2699,1,EasyRayd,4163,2157,125,114,239,52.3%,8m
2699,1,[MERKL]AtilaHiltman,4163,1102,35,20,55,63.6%,34m
2699,1,[Heroes]Cheoklate,4163,1302,32,35,67,47.8%,8m
2699,3,llllllllllll,4163,512,31,49,80,38.8%,33m
2699,1,IIIIIIIIIIII,4163,534,23,6,29,79.3%,19m
2699,2,mauer,4163,0,1,0,1,100.0%,10m
2699,1,ZeroBrain,4163,0,1,4,5,20.0%,16m
2699,1,[lMBA]GGInsAnItY,4163,0,0,3,3,0.0%,11m
2707,1,RussianDad,4162,1714,112,100,212,52.8%,8m
2707,1,MannerUp,4162,1660,101,81,182,55.5%,16m
2707,1,[НТТ]ImmunitY,4162,1851,82,51,133,61.7%,9m
2707,1,Gnomister,4162,1409,76,71,147,51.7%,9m
2707,1,[BSK88]Felicious,4162,1844,50,44,94,53.2%,15m
2707,1,[PŖïMĄŁ]LiGhtNiNG,4162,1224,33,28,61,54.1%,3m
2707,1,[Dae]Daestra,4162,924,30,25,55,54.5%,18m
2707,1,[ǂMWRǂ]Bumburnyak,4162,190,4,4,8,50.0%,9m
2707,1,[TirolA]Urono,4162,0,1,0,1,100.0%,16m
2707,1,[SKYBRS]FakeTaxi,4162,0,0,1,1,0.0%,15m
2717,2,CerO,4161,2230,435,442,877,49.6%,8m
2717,1,Fresh,4161,764,25,13,38,65.8%,35m
2717,1,[TooBig]SeSam,4161,828,19,21,40,47.5%,13m
2717,1,[XYFAN]Wanderer,4161,500,11,5,16,68.8%,35m
2721,1,[1A2857]Tio,4160,887,25,26,51,49.0%,34m
2721,1,[ZoDiep]Raijingeki,4160,96,3,1,4,75.0%,11m
2721,1,Fireman,4160,0,1,5,6,16.7%,9m
2724,1,[TedB]LastDina,4159,2159,320,312,632,50.6%,11m
2724,1,llllllllllll,4159,692,18,4,22,81.8%,11m
2724,1,Acidstorm,4159,699,16,17,33,48.5%,9m
2724,1,oTrolly,4159,0,0,1,1,0.0%,10m
2728,2,DemOne,4158,2281,311,308,619,50.2%,10m
2728,1,hqbrutal,4158,0,1,0,1,100.0%,34m
2730,2,NewBie,4157,322,15,3,18,83.3%,12m
2730,1,Ruben,4157,0,0,1,1,0.0%,17m
2730,3,[КХЕ]ComradeArtem,4157,0,0,1,1,0.0%,6m
2733,1,sva,4156,1620,50,54,104,48.1%,34m
2733,1,llllllllllll,4156,560,16,11,27,59.3%,3m
2735,1,[Dae]Tebiv,4155,434,11,18,29,37.9%,10m
2736,1,RushedUrMom,4154,1470,85,64,149,57.0%,34m
2736,3,InstaMuted,4154,673,56,65,121,46.3%,11m
2736,3,Petro,4154,626,39,54,93,41.9%,4m
2736,1,Doc,4154,328,8,5,13,61.5%,10m
2736,1,[1984]TheBigPeaT,4154,94,3,4,7,42.9%,8m
2736,1,CLANNAD,4154,0,1,0,1,100.0%,17m
2736,1,Beagle,4154,0,0,1,1,0.0%,6m
2736,1,tontondubled,4154,0,0,1,1,0.0%,16m
2736,1,Mode,4154,0,0,2,2,0.0%,3m
2745,1,TheFatKid,4153,332,7,6,13,53.8%,6m
2745,2,[sCion]AiRboRnE,4153,0,0,1,1,0.0%,34m
2745,1,Fighter,4153,0,0,1,1,0.0%,4m
2748,1,[ZERGML]Joard,4152,2085,236,194,430,54.9%,8m
2748,1,BerthaG,4152,2185,200,212,412,48.5%,4m
2748,1,IIIIIIIIIIII,4152,2141,146,154,300,48.7%,4m
2748,3,iliya,4152,241,79,86,165,47.9%,12m
2748,1,IIIIIIIIII,4152,1977,54,67,121,44.6%,11m
2748,1,Bethowen,4152,144,3,4,7,42.9%,19m
2748,1,[Zx1]Zenmed,4152,0,1,0,1,100.0%,16m
2755,1,[Hаsu]Asturias,4151,2128,572,562,1134,50.4%,3m
2755,2,[HeFi]MonkeyBallz,4151,1232,85,81,166,51.2%,10m
2755,1,WhiteRa,4151,479,12,5,17,70.6%,17m
2755,2,[Ahegаo]ElonMaks,4151,268,8,0,8,100.0%,17m
2755,1,[SC2FF]meteores,4151,0,1,0,1,100.0%,3m
2760,1,Funk,4150,1562,55,34,89,61.8%,9m
2760,1,MellowNoc,4150,1286,32,27,59,54.2%,4m
2760,1,TelosPacman,4150,0,0,3,3,0.0%,10m
2763,1,Steven,4149,2131,158,156,314,50.3%,5m
2763,1,[Litty]StackedGamer,4149,1029,28,26,54,51.9%,4m
2763,1,IIIIIIIIIIII,4149,424,10,10,20,50.0%,15m
2766,1,KahunaBurger,4148,2125,348,336,684,50.9%,10m
2766,1,[PLA2N]Nontar,4148,1915,62,45,107,57.9%,11m
2766,1,[ARK88]Eman,4148,1409,50,52,102,49.0%,15m
2766,2,IlIlIIIIllll,4148,134,18,27,45,40.0%,17m
2770,1,IIIIIIIIII,4147,1648,86,88,174,49.4%,13m
2770,1,[JINX]FvD,4147,726,22,13,35,62.9%,18m
2770,1,Marcel,4147,628,15,10,25,60.0%,17m
2770,1,robotikov,4147,646,14,19,33,42.4%,11m
2770,1,IIIIIIIIIIII,4147,282,7,1,8,87.5%,4m
2770,1,Solidmore,4147,234,6,3,9,66.7%,11m
2776,1,[Sløth]FlensigesCuy,4146,1324,34,27,61,55.7%,10m
2776,3,[aW]Sminse,4146,402,28,34,62,45.2%,3m
2776,1,llllllllllll,4146,374,9,6,15,60.0%,16m
2779,1,chicago,4145,2149,96,92,188,51.1%,15m
2779,2,Peter,4145,201,12,0,12,100.0%,17m
2779,1,[RÐ]Mazrok,4145,236,5,5,10,50.0%,10m
2779,3,TerranOPrace,4145,0,3,2,5,60.0%,14m
2783,1,[PŖïMĄŁ]DarkGhost,4144,1906,58,54,112,51.8%,17m
2783,2,Smurky,4144,405,25,56,81,30.9%,11m
2783,1,[Hаsu]Encelad,4144,844,19,18,37,51.4%,8m
2783,1,Soujiro,4144,240,6,9,15,40.0%,34m
2787,1,[UAŦeam]Corrz,4143,1562,109,107,216,50.5%,3m
2787,1,[sfc]CodiFly,4143,192,5,5,10,50.0%,4m
2789,1,fourtwenty,4142,2056,89,61,150,59.3%,9m
2789,1,Quick,4142,1230,35,41,76,46.1%,33m
2789,1,Aesculap,4142,772,29,17,46,63.0%,4m
2789,1,necedakrene,4142,805,29,26,55,52.7%,9m
2789,1,Senku,4142,520,21,7,28,75.0%,34m
2789,1,MidOrFeed,4142,254,10,3,13,76.9%,9m
2789,1,[pSi]MGǂJedi,4142,48,2,1,3,66.7%,9m
2789,1,Chillypill,4142,0,0,1,1,0.0%,17m
2797,1,Bubba,4141,2149,164,165,329,49.8%,3m
2797,1,NotD,4141,1004,26,19,45,57.8%,16m
2797,1,[ЕНОТ]Try,4141,514,12,17,29,41.4%,11m
2797,1,[B3est]sirPlayALot,4141,48,2,6,8,25.0%,15m
2797,1,AerO,4141,0,0,2,2,0.0%,20m
2802,1,[LV]zichus,4140,1255,38,44,82,46.3%,16m
2802,1,Heradrass,4140,778,17,18,35,48.6%,6m
2802,1,ProtossTears,4140,328,14,3,17,82.4%,20m
2802,1,Fzweiaez,4140,192,6,3,9,66.7%,19m
2802,1,Skytoss,4140,48,1,6,7,14.3%,13m
2802,1,free,4140,0,0,1,1,0.0%,13m
2808,1,[SwgBoi]DeadGame,4139,1473,84,60,144,58.3%,9m
2808,1,Coudest,4139,2067,62,57,119,52.1%,33m
2808,3,Erik,4139,453,36,36,72,50.0%,3m
2808,3,thD,4139,471,25,34,59,42.4%,34m
2808,1,ScaЯRneR,4139,144,3,6,9,33.3%,34m
2808,1,Laplace,4139,0,1,0,1,100.0%,33m
2808,1,OneBaseNydus,4139,0,1,0,1,100.0%,19m
2815,1,WhiZerg,4138,1858,62,66,128,48.4%,10m
2815,1,Kagrenac,4138,1355,49,43,92,53.3%,34m
2815,1,TheHeaTisOn,4138,416,19,12,31,61.3%,19m
2815,1,EMx,4138,382,9,14,23,39.1%,20m
2815,1,BeHappy,4138,0,0,4,4,0.0%,14m
2820,1,Fathra,4137,336,10,8,18,55.6%,3m
2820,1,[IBeAŚI]Terxel,4137,144,4,1,5,80.0%,3m
2820,3,Aska,4137,0,0,1,1,0.0%,13m
2823,1,[PLA2N]чahka,4135,1067,37,15,52,71.2%,3m
2823,1,dOMi,4135,462,20,5,25,80.0%,4m
2823,1,Arcticus,4135,190,4,14,18,22.2%,35m
2823,1,[xFUD]Araken,4135,48,2,1,3,66.7%,3m
2827,3,ZORG,4134,2072,161,170,331,48.6%,17m
2827,1,Artemus,4134,94,2,1,3,66.7%,17m
2829,1,ElFleischo,4133,1979,161,137,298,54.0%,13m
2829,3,TylerDurden,4133,372,34,38,72,47.2%,3m
2829,1,damoscha,4133,228,13,3,16,81.2%,17m
2829,1,Dariusp,4133,520,11,13,24,45.8%,9m
2829,1,IIIIIIIIIIII,4133,231,10,8,18,55.6%,35m
2829,1,LuNe,4133,424,9,7,16,56.2%,34m
2835,1,[Futile]Hoa,4132,1168,26,35,61,42.6%,11m
2835,1,[Invǂ]DXM,4132,316,19,18,37,51.4%,10m
2837,1,IIIllIIlIII,4131,2114,267,255,522,51.1%,3m
2837,3,TwentyTwenty,4131,0,2,3,5,40.0%,7m
2837,1,[Aptero]Licoze,4131,0,1,0,1,100.0%,21m
2840,1,Lyakusha,4130,142,4,3,7,57.1%,4m
2841,3,boss,4129,849,140,151,291,48.1%,19m
2841,1,[IceHus]Hopexs,4129,2153,78,67,145,53.8%,17m
2841,1,kACPI,4129,1130,26,34,60,43.3%,21m
2841,2,Hekaton,4129,400,17,4,21,81.0%,5m
2845,1,yule,4128,1139,114,115,229,49.8%,16m
2845,1,[CS0]XPA,4128,280,7,6,13,53.8%,2m
2845,1,[SY2G]xZeiiden,4128,144,4,5,9,44.4%,13m
2845,1,[NPB1]Algengeburt,4128,96,2,3,5,40.0%,9m
2845,1,Laddergoat,4128,0,0,1,1,0.0%,3m
2845,1,ElstEverto,4128,0,0,2,2,0.0%,3m
2851,1,Zaax,4127,2144,276,219,495,55.8%,20m
2851,1,[WaCKi]krzychacz,4127,1980,196,172,368,53.3%,35m
2851,1,[Hаsu]Knazovv,4127,1972,175,165,340,51.5%,15m
2851,1,IIIIIIIIIIII,4127,374,8,8,16,50.0%,21m
2855,1,Ulrezaj,4125,2152,217,177,394,55.1%,19m
2855,1,Teecon,4125,1042,33,29,62,53.2%,3m
2855,1,Zeus,4125,221,10,1,11,90.9%,4m
2855,3,Nuguri,4125,0,0,1,1,0.0%,11m
2859,1,GeneticJuice,4124,2125,469,438,907,51.7%,20m
2859,1,[Dicboy]zerxam,4124,1982,71,54,125,56.8%,3m
2861,1,DeadRa,4123,0,1,0,1,100.0%,3m
2861,2,[MeDuS]attas,4123,0,0,1,1,0.0%,18m
2863,1,RadekDaNa,4122,1081,33,32,65,50.8%,10m
2864,1,galena,4121,2119,108,91,199,54.3%,4m
2864,1,[BROSER]Kurgan,4121,297,8,5,13,61.5%,20m
2866,1,Alpha,4120,1870,455,423,878,51.8%,10m
2866,1,IIIIIIIIIIII,4120,2076,92,76,168,54.8%,9m
2866,3,IIIIIIIIIIII,4120,753,43,48,91,47.3%,5m
2866,1,snezhok,4120,1191,35,27,62,56.5%,10m
2866,1,[K0mpis]Gyllenegeten,4120,965,30,34,64,46.9%,33m
2866,1,[HZeS]FARI,4120,1066,25,27,52,48.1%,3m
2866,1,BigUp,4120,556,13,11,24,54.2%,11m
2866,1,Starlight,4120,139,3,3,6,50.0%,17m
2874,1,[RøckeT]ElKassos,4119,1890,54,51,105,51.4%,2m
2874,1,[FaDr]BURNIE,4119,322,8,12,20,40.0%,18m
2874,1,BadFrog,4119,0,2,3,5,40.0%,8m
2877,1,Malodorous,4117,1053,141,135,276,51.1%,34m
2878,1,Vallen,4116,910,46,20,66,69.7%,35m
2878,1,[TheDOH]drkovorkian,4116,1250,30,30,60,50.0%,20m
2878,1,[Sarmat]NataszPL,4116,370,9,9,18,50.0%,33m
2878,3,Raxxes,4116,6,2,16,18,11.1%,15m
2882,1,bash,4115,1987,184,186,370,49.7%,15m
2882,1,Cookie,4115,142,4,0,4,100.0%,10m
2884,1,Relaxo,4114,96,3,1,4,75.0%,9m
2884,1,TiGaGa,4114,48,1,3,4,25.0%,20m
2886,1,Pettish,4113,1572,215,204,419,51.3%,15m
2886,1,NaLmeS,4113,2129,71,69,140,50.7%,16m
2886,1,[Ex0n]Cellsidus,4113,1287,55,65,120,45.8%,15m
2886,1,grim,4113,1006,51,44,95,53.7%,10m
2886,1,LinxX,4113,1114,48,48,96,50.0%,17m
2886,2,[HFI]pookie,4113,154,4,4,8,50.0%,20m
2886,1,RATIX,4113,96,3,1,4,75.0%,20m
2893,1,LUCADESUPPLY,4112,561,28,28,56,50.0%,33m
2893,1,Threadripper,4112,403,18,5,23,78.3%,4m
2893,1,Monscream,4112,0,0,1,1,0.0%,10m
2893,1,[Wееb]DIMIDROL,4112,0,0,2,2,0.0%,4m
2897,1,[KAOTx]Smilingblade,4111,2143,89,95,184,48.4%,35m
2898,1,Owlrazum,4110,2124,132,129,261,50.6%,9m
2898,1,Iluvatar,4110,2020,81,80,161,50.3%,15m
2898,1,[Z3b1]Terj,4110,1053,37,28,65,56.9%,3m
2898,1,[Лoльки]Спелый,4110,288,9,8,17,52.9%,15m
2902,1,Yharnam,4109,1262,36,22,58,62.1%,4m
2902,1,VeSnA,4109,1200,33,23,56,58.9%,34m
2902,1,[7BINKS]Honey,4109,96,3,1,4,75.0%,11m
2905,1,[ĦĦ]Elonmusk,4108,1792,103,85,188,54.8%,4m
2905,1,[lIllI]TheRooster,4108,1519,84,78,162,51.9%,33m
2905,1,bosswoss,4108,1138,58,33,91,63.7%,11m
2905,1,[Blacer]Malik,4108,763,23,12,35,65.7%,5m
2905,2,Hermiod,4108,233,13,2,15,86.7%,34m
2905,1,[Cruxis]headcrusher,4108,514,11,14,25,44.0%,9m
2911,1,[HFR]Tharkun,4107,2130,284,281,565,50.3%,3m
2911,1,Denkisuperi,4107,1995,152,137,289,52.6%,15m
2911,1,PlusUltra,4107,1493,87,72,159,54.7%,21m
2911,1,Zaeccis,4107,1094,26,26,52,50.0%,4m
2911,3,METEORA,4107,0,3,2,5,60.0%,21m
2916,1,Next,4106,1839,332,306,638,52.0%,13m
2916,1,LazyProbe,4106,1298,39,24,63,61.9%,13m
2916,2,[PŖïMĄŁ]iNveiN,4106,0,0,1,1,0.0%,17m
2919,1,BigNickDigg,4105,1772,75,44,119,63.0%,19m
2919,1,Guardian,4105,333,10,18,28,35.7%,3m
2919,1,CremePuff,4105,0,1,0,1,100.0%,13m
2922,1,Xephos,4104,458,17,5,22,77.3%,4m
2922,1,[Acte]Xtreme,4104,708,17,13,30,56.7%,6m
2922,1,BaseUnit,4104,459,11,5,16,68.8%,10m
2922,1,Limba,4104,190,5,2,7,71.4%,8m
2926,3,[TVÐ]mumming,4103,1464,104,109,213,48.8%,12m
2926,1,TWiace,4103,1885,94,66,160,58.8%,3m
2926,1,[SY2G]Guts,4103,1902,53,63,116,45.7%,4m
2926,1,[IG20]IIIIIIIIIIII,4103,1251,46,48,94,48.9%,15m
2926,3,Killborne,4103,280,24,37,61,39.3%,19m
2926,2,Kastle,4103,42,1,4,5,20.0%,7m
2932,1,[НТТ]shadowranger,4102,1456,37,39,76,48.7%,15m
2932,1,jester,4102,464,11,6,17,64.7%,14m
2932,1,[TAW]Ares,4102,142,4,1,5,80.0%,15m
2935,3,Cptred,4101,2016,639,645,1284,49.8%,11m
2935,1,[PAV]Kerdinand,4101,1361,77,77,154,50.0%,6m
2935,1,GartenZerg,4101,1030,36,21,57,63.2%,10m
2935,1,aQua,4101,1254,31,33,64,48.4%,9m
2935,1,SuperBurno,4101,142,3,1,4,75.0%,9m
2935,1,Penetrator,4101,96,2,3,5,40.0%,35m
2935,1,[RBlood]DVNWeak,4101,0,1,0,1,100.0%,19m
2935,1,[ZERGML]Anton,4101,0,1,1,2,50.0%,9m
2943,1,headcracked,4100,1413,66,25,91,72.5%,8m
2943,1,MystiK,4100,918,23,17,40,57.5%,17m
2943,1,[Hаsu]Ajax,4100,422,10,14,24,41.7%,4m
2946,1,[0BO]imbaHorst,4099,1807,164,146,310,52.9%,20m
2946,1,[nFnaK]zisar,4099,507,13,8,21,61.9%,21m
2946,1,Elite,4099,370,9,7,16,56.2%,9m
2946,3,Oink,4099,30,4,2,6,66.7%,9m
2950,1,[KRAKOT]Wiztek,4098,468,11,12,23,47.8%,15m
2951,1,Gadz,4097,980,78,68,146,53.4%,6m
2951,1,[F15T]CattlBruisah,4097,891,52,28,80,65.0%,35m
2951,1,ShowKhan,4097,96,2,4,6,33.3%,4m
2951,3,aylmao,4097,0,1,0,1,100.0%,6m
2955,1,[arpnet]IPvSix,4096,1750,152,155,307,49.5%,21m
2955,1,[Hаsu]wickedgopher,4096,1948,97,107,204,47.5%,34m
2955,1,BananKing,4096,1636,56,43,99,56.6%,21m
2955,1,[tXs]TheBloke,4096,0,0,1,1,0.0%,18m
2959,1,Стомский,4095,817,22,24,46,47.8%,3m
2959,1,moki,4095,296,16,4,20,80.0%,5m
2959,1,[lMMl]Belgarath,4095,0,2,5,7,28.6%,20m
2962,1,Delaam,4094,1364,43,33,76,56.6%,9m
2962,1,[Noman]Xlarz,4094,231,9,5,14,64.3%,10m
2962,2,DIOR,4094,0,1,3,4,25.0%,4m
2965,1,[iX]Fenix,4093,1979,92,81,173,53.2%,10m
2965,1,Tob,4093,282,13,2,15,86.7%,15m
2965,1,dicdix,4093,235,8,3,11,72.7%,10m
2965,1,[FXs]PoolAcademy,4093,48,1,3,4,25.0%,8m
2965,1,[Lort]MonkeyMan,4093,0,1,4,5,20.0%,35m
2970,3,Trines,4092,417,135,131,266,50.8%,35m
2970,1,[SGEY]Асхат,4092,1983,125,100,225,55.6%,9m
2970,1,Shibal,4092,1071,53,50,103,51.5%,10m
2970,1,dahtroop,4092,0,1,0,1,100.0%,10m
2970,1,bioDestroyer,4092,0,1,1,2,50.0%,33m
2970,1,[MAKinG]EchO,4092,0,0,1,1,0.0%,19m
2976,1,Fonox,4091,1976,189,167,356,53.1%,3m
2976,3,[UATeam]Cronos,4091,1631,160,170,330,48.5%,11m
2976,1,Dekazzy,4091,1875,116,112,228,50.9%,6m
2976,3,llllllllllll,4091,650,109,107,216,50.5%,3m
2976,1,Zergerking,4091,48,2,3,5,40.0%,21m
2981,1,sniperBG,4090,792,38,10,48,79.2%,19m
2981,1,POTATO,4090,222,13,1,14,92.9%,13m
2981,1,[Blacer]Delvier,4090,238,5,12,17,29.4%,11m
2981,2,[ffddfd]IIIIIIIIIIII,4090,0,0,1,1,0.0%,34m
2985,1,avilo,4089,2063,354,349,703,50.4%,11m
2985,1,Gtoss,4089,512,12,11,23,52.2%,8m
2985,1,[romni]Gouranga,4089,228,8,4,12,66.7%,34m
2985,1,Knista,4089,0,0,1,1,0.0%,4m
2985,2,Trap,4089,0,0,1,1,0.0%,17m
2990,1,[OsD]SteveRogers,4088,400,13,6,19,68.4%,10m
2991,1,Tsabo,4087,1641,70,63,133,52.6%,15m
2991,1,[CivW]Willsoon,4087,284,6,13,19,31.6%,11m
2993,1,[Dobro]KINE,4086,1503,129,132,261,49.4%,16m
2993,1,RectalAmbush,4086,1154,39,24,63,61.9%,5m
2993,1,[SWWT]Papa,4086,961,37,28,65,56.9%,9m
2993,1,[TAW]WaRzOnE,4086,238,6,10,16,37.5%,4m
2997,1,ZERGisAMOVE,4085,1831,58,68,126,46.0%,13m
2997,1,WannaBeAce,4085,1096,44,24,68,64.7%,11m
2997,1,Rockstar,4085,292,11,13,24,45.8%,4m
3000,3,Ben,4084,1975,502,491,993,50.6%,12m
3000,1,[sc2eu]Arkimond,4084,528,12,7,19,63.2%,14m
3000,3,[slayn]Rainbowdream,4084,0,2,3,5,40.0%,19m
3000,1,[srekaH]TyderDE,4084,0,0,1,1,0.0%,4m
3000,1,Demaxo,4084,0,0,4,4,0.0%,3m
3005,3,[keke]Gilthalas,4083,1081,136,146,282,48.2%,11m
3005,1,weirdo,4083,0,1,3,4,25.0%,8m
3007,1,Jidai,4082,1204,92,87,179,51.4%,15m
3007,1,ThePariah,4082,487,72,63,135,53.3%,20m
3007,1,[fam1ly]kaan,4082,481,17,7,24,70.8%,10m
3007,1,[Еnmity]Zebron,4082,0,1,0,1,100.0%,10m
3007,1,[k1raen]vingos,4082,0,1,5,6,16.7%,19m
3007,1,[DFgs]TreaT,4082,0,0,3,3,0.0%,15m
3013,1,OrpuS,4081,2115,199,201,400,49.8%,15m
3013,1,[I6s]Rob,4081,2080,154,143,297,51.9%,9m
3013,1,Doomweed,4081,48,1,2,3,33.3%,33m
3016,1,Vincent,4080,1852,132,125,257,51.4%,3m
3016,1,BrenMcBash,4080,1982,82,64,146,56.2%,3m
3016,1,[Erynie]Matix,4080,399,13,3,16,81.2%,13m
3016,1,Ber,4080,142,8,0,8,100.0%,20m
3016,1,xplode,4080,0,0,1,1,0.0%,33m
3021,1,[aW]Jeatall,4079,1797,60,60,120,50.0%,2m
3021,1,DarkRaven,4079,374,8,11,19,42.1%,10m
3023,3,[CocoCo]ugly,4078,1774,428,461,889,48.1%,15m
3023,1,Stirlitz,4078,1229,221,219,440,50.2%,15m
3023,1,BigBlock,4078,2129,121,132,253,47.8%,15m
3023,1,santa,4078,2098,101,94,195,51.8%,16m
3023,1,Yogapang,4078,421,21,6,27,77.8%,9m
3023,1,Dodo,4078,148,7,3,10,70.0%,20m
3023,1,GooFFy,4078,236,6,11,17,35.3%,16m
3030,1,[TACVPN]deletek,4077,1693,219,219,438,50.0%,4m
3031,1,fissureX,4076,2080,227,216,443,51.2%,15m
3031,3,Rhapsody,4076,1021,112,93,205,54.6%,33m
3031,1,Cringer,4076,874,28,17,45,62.2%,9m
3031,2,SomeGuy,4076,116,5,4,9,55.6%,20m
3031,1,[PDRA]Monamah,4076,48,1,1,2,50.0%,4m
3031,1,IIIIIIIIIIII,4076,48,1,5,6,16.7%,19m
3037,1,iLLuSia,4075,381,9,16,25,36.0%,13m
3037,1,TeriyakiBoyz,4075,46,6,0,6,100.0%,9m
3039,3,[Maddox]raiN,4074,1310,108,112,220,49.1%,33m
3039,1,Terrabyte,4074,1030,28,35,63,44.4%,34m
3039,1,IIIIIIIIIIII,4074,759,27,13,40,67.5%,3m
3039,1,Hooman,4074,188,5,4,9,55.6%,9m
3039,1,MEDIV,4074,0,0,3,3,0.0%,8m
3039,1,[nB]Addon,4074,0,0,8,8,0.0%,8m
3045,1,helldenn,4073,1507,107,99,206,51.9%,11m
3045,1,Bond,4073,1708,105,35,140,75.0%,9m
3045,1,Strapi,4073,954,23,24,47,48.9%,10m
3045,1,NuclearPasta,4073,687,17,12,29,58.6%,13m
3045,1,Dante,4073,142,3,11,14,21.4%,21m
3045,3,[ImrA]Imrahil,4073,0,1,4,5,20.0%,9m
3051,1,Fedmahn,4072,2068,246,249,495,49.7%,9m
3051,1,auxermen,4072,1432,72,34,106,67.9%,3m
3051,1,[mCon]VeNi,4072,1494,40,48,88,45.5%,6m
3051,1,khronosz,4072,580,38,21,59,64.4%,11m
3051,1,[TheDOH]LoKlok,4072,462,11,9,20,55.0%,34m
3051,1,[Ðucky]Pie,4072,142,3,2,5,60.0%,8m
3051,1,Nihil,4072,0,0,1,1,0.0%,16m
3058,1,Kryukov,4071,2016,202,187,389,51.9%,9m
3058,1,Warlord,4071,1422,45,32,77,58.4%,35m
3058,2,williams,4071,274,7,6,13,53.8%,11m
3058,1,ELPASTA,4071,142,4,2,6,66.7%,13m
3062,1,Sashko,4070,314,8,2,10,80.0%,11m
3062,1,jean,4070,138,6,5,11,54.5%,15m
3064,1,[FrBz]Didi,4069,624,21,26,47,44.7%,4m
3065,1,[PLA2N]Medvedev,4068,2100,304,308,612,49.7%,35m
3065,3,[neuroW]Avatron,4068,977,69,74,143,48.3%,6m
3065,1,[TAW]FrameSticker,4068,609,24,13,37,64.9%,10m
3065,1,Vex,4068,372,8,7,15,53.3%,4m
3065,1,LastCell,4068,280,7,4,11,63.6%,15m
3065,1,[NVY]Wonderthings,4068,282,7,8,15,46.7%,9m
3065,1,Huhn,4068,236,6,12,18,33.3%,4m
3065,1,CutSyOzZy,4068,0,0,1,1,0.0%,35m
3073,1,llllllllllll,4067,1188,32,28,60,53.3%,35m
3073,1,Blåbær,4067,530,23,9,32,71.9%,9m
3073,3,IIIIIIIIIIII,4067,0,3,2,5,60.0%,20m
3073,1,[ZЕRGТV]SPARTA,4067,128,3,5,8,37.5%,13m
3073,1,[LgMstr]llllll,4067,46,2,1,3,66.7%,10m
3078,1,[FIHDVI]Lukas,4066,2078,315,297,612,51.5%,21m
3078,1,Scrubb,4066,1935,88,71,159,55.3%,9m
3078,1,Ziiim,4066,882,28,40,68,41.2%,10m
3078,1,Aleke,4066,450,20,4,24,83.3%,35m
3078,1,[0BO]Mogat,4066,0,0,1,1,0.0%,15m
3078,1,FreeMan,4066,0,0,1,1,0.0%,3m
3084,1,Tesselhoff,4065,2097,77,93,170,45.3%,19m
3084,1,AfterLife,4065,1402,66,49,115,57.4%,4m
3084,1,[FUBRAN]Hodor,4065,541,43,25,68,63.2%,15m
3084,1,[INAE]KOVI,4065,142,3,8,11,27.3%,9m
3088,1,[duсks]maniachillo,4064,2101,86,83,169,50.9%,3m
3088,1,[ArGGEU]VanHelsingLQ,4064,1479,66,47,113,58.4%,34m
3088,1,PierreBzrd,4064,333,16,3,19,84.2%,20m
3088,2,PunchingTree,4064,369,15,9,24,62.5%,14m
3088,1,Steve,4064,94,2,4,6,33.3%,11m
3093,1,[LEVARP]MrDragon,4063,2088,96,93,189,50.8%,4m
3093,1,ZLATAN,4063,753,19,26,45,42.2%,35m
3093,1,Mustafa,4063,297,14,3,17,82.4%,3m
3093,1,SlothApm,4063,278,7,3,10,70.0%,13m
3093,1,SpicyBoy,4063,268,6,5,11,54.5%,34m
3093,1,QQQQQQQQQQQQ,4063,186,4,1,5,80.0%,2m
3099,3,[PŖïMĄŁ]Dav,4062,1953,334,354,688,48.5%,19m
3099,3,Willem,4062,1441,78,84,162,48.1%,20m
3099,1,SPICA,4062,674,27,20,47,57.4%,4m
3099,1,roka,4062,974,23,22,45,51.1%,9m
3099,1,Galeforce,4062,215,11,0,11,100.0%,8m
3099,1,Virou,4062,311,11,3,14,78.6%,20m
3099,1,uvco,4062,0,1,0,1,100.0%,9m
3099,1,llllllllllll,4062,0,1,5,6,16.7%,13m
3099,1,Mernoxos,4062,0,0,1,1,0.0%,15m
3108,1,[ChXx]JakRam,4061,2109,382,372,754,50.7%,5m
3108,3,[GGGød]Esaris,4061,497,158,161,319,49.5%,35m
3108,1,Letmode,4061,2056,137,114,251,54.6%,18m
3108,1,VinniThePooh,4061,1279,66,66,132,50.0%,15m
3108,1,Molu,4061,658,34,27,61,55.7%,6m
3108,1,IIIIIIIIIIII,4061,609,17,24,41,41.5%,35m
3108,1,Gin,4061,0,1,0,1,100.0%,9m
3108,1,BaNaNa,4061,0,0,7,7,0.0%,15m
3116,1,trollingking,4060,604,17,8,25,68.0%,3m
3116,1,[mfixed]PsyChol,4060,276,7,6,13,53.8%,10m
3116,1,BBBBBBbbbbbb,4060,284,6,10,16,37.5%,11m
3119,1,rafalzdw,4059,1782,104,96,200,52.0%,9m
3119,1,NoName,4059,1114,30,34,64,46.9%,13m
3119,1,hihihihihihi,4059,283,12,9,21,57.1%,8m
3119,1,nangaybiss,4059,192,6,1,7,85.7%,35m
3123,1,metaknight,4058,2048,202,182,384,52.6%,19m
3123,1,ImpuLse,4058,2076,119,116,235,50.6%,5m
3123,1,zlrka,4058,955,72,44,116,62.1%,10m
3123,1,[ECFeV]Havior,4058,604,18,15,33,54.5%,11m
3123,1,HaviLing,4058,0,1,4,5,20.0%,15m
3128,1,[75рус]Мастер,4057,869,112,89,201,55.7%,35m
3128,1,DomovoiGL,4057,1846,70,64,134,52.2%,10m
3128,3,OksanaSex,4057,90,45,61,106,42.5%,12m
3128,1,Knuut,4057,190,4,6,10,40.0%,17m
3128,3,siBeling,4057,0,0,2,2,0.0%,20m
3133,1,[aW]mingo,4056,594,14,13,27,51.9%,10m
3133,1,Freeman,4056,186,5,10,15,33.3%,5m
3133,1,[FMG]mmWeez,4056,142,4,5,9,44.4%,9m
3133,1,Haravant,4056,48,1,2,3,33.3%,4m
3137,1,[XDLIFE]Dębu,4055,771,25,12,37,67.6%,16m
3137,1,Kiki,4055,812,19,25,44,43.2%,16m
3137,1,[JOKER]Schubidu,4055,496,11,18,29,37.9%,8m
3137,1,[Z3RGML]archik,4055,46,1,3,4,25.0%,34m
3137,1,Tortuga,4055,48,1,4,5,20.0%,20m
3142,1,[CWL]PetitMouton,4054,1334,121,93,214,56.5%,15m
3142,1,Ironleague,4054,706,16,14,30,53.3%,9m
3142,1,FUN,4054,408,14,14,28,50.0%,5m
3142,1,serg,4054,498,11,13,24,45.8%,33m
3142,1,CarloV,4054,0,1,6,7,14.3%,9m
3142,2,HooIsHoo,4054,0,0,1,1,0.0%,34m
3142,1,[ZERGSC]Vattghern,4054,0,0,4,4,0.0%,13m
3149,1,[LDPW]Philipp,4053,2080,416,421,837,49.7%,2m
3149,1,Masacre,4053,672,20,22,42,47.6%,33m
3149,1,Megatron,4053,142,3,3,6,50.0%,5m
3149,1,Jessica,4053,46,2,1,3,66.7%,15m
3149,1,HideRDK,4053,0,1,7,8,12.5%,3m
3154,1,[PŖïMĄŁ]MalbertoM,4052,2036,177,176,353,50.1%,6m
3154,1,GHOST,4052,1003,44,53,97,45.4%,33m
3154,1,[αX]LilZlot,4052,542,21,22,43,48.8%,2m
3154,1,[DBr]HyneK,4052,437,12,16,28,42.9%,15m
3158,1,Syntoren,4051,544,25,26,51,49.0%,6m
3158,1,qqq,4051,435,19,6,25,76.0%,19m
3158,1,[WEEDfr]scizoFoxY,4051,360,8,11,19,42.1%,9m
3161,1,Alexisonfire,4050,880,44,29,73,60.3%,15m
3161,1,Yeetti,4050,475,23,9,32,71.9%,35m
3161,1,Mike,4050,818,19,23,42,45.2%,15m
3161,1,Lucky,4050,343,18,4,22,81.8%,8m
3161,1,[EmŦ]Tarantula,4050,144,3,13,16,18.8%,3m
3161,1,[EXPANT]Capac,4050,96,2,5,7,28.6%,16m
3161,1,[ERaven]Florian,4050,0,0,1,1,0.0%,6m
3168,1,Belvedere,4049,1759,187,165,352,53.1%,5m
3168,1,Aries,4049,1603,54,35,89,60.7%,11m
3168,1,peepoCry,4049,192,4,13,17,23.5%,34m
3168,1,[KAY5]blitzkrieg,4049,0,1,4,5,20.0%,9m
3172,1,[Burla]Kutarion,4048,2049,281,263,544,51.7%,11m
3172,1,[NoMind]Tentoin,4048,48,2,0,2,100.0%,13m
3174,1,[OdT]Pat,4047,2046,401,392,793,50.6%,21m
3174,1,[MaZ]AnT,4047,1669,70,70,140,50.0%,33m
3174,1,Edgeless,4047,327,14,6,20,70.0%,33m
3174,1,[HBGS]Neowolf,4047,48,1,1,2,50.0%,15m
3174,1,OldStar,4047,48,1,1,2,50.0%,10m
3174,1,Mareikulu,4047,0,1,2,3,33.3%,35m
3180,1,Valsoray,4046,980,139,143,282,49.3%,4m
3180,1,[Frass]Fråppe,4046,2064,60,63,123,48.8%,13m
3180,1,[ØÐ]Atomic,4046,1047,37,19,56,66.1%,20m
3180,1,Style,4046,328,7,11,18,38.9%,10m
3180,1,[NMSQ]RubiX,4046,48,2,1,3,66.7%,9m
3180,1,[Moskva]Рома,4046,0,0,1,1,0.0%,5m
3180,1,[RSyn]RobCXCVIII,4046,0,0,2,2,0.0%,11m
3187,1,[EZPTS]ВованТерран,4045,875,69,61,130,53.1%,21m
3187,1,[PLA2N]GuilleVGX,4045,1351,65,56,121,53.7%,15m
3187,1,[DIRAC]DiracDelta,4045,48,1,9,10,10.0%,21m
3190,1,Freekill,4044,580,15,15,30,50.0%,4m
3190,1,Flower,4044,179,4,1,5,80.0%,16m
3190,1,Piff,4044,44,2,0,2,100.0%,17m
3193,1,BobToss,4043,403,20,7,27,74.1%,19m
3193,1,[LeUcHt]TheDarkNight,4043,610,14,12,26,53.8%,3m
3193,2,[ØC]GatsbY,4043,112,4,6,10,40.0%,2m
3196,1,bmxerpro,4042,1834,64,57,121,52.9%,11m
3196,3,Storm,4042,498,37,56,93,39.8%,17m
3196,1,Driiich,4042,46,2,1,3,66.7%,13m
3196,1,ЧерныйТолчок,4042,134,2,4,6,33.3%,19m
3200,1,Юляша,4041,2085,117,119,236,49.6%,4m
3200,1,[Cannоn]jonasimo,4041,1070,39,27,66,59.1%,9m
3200,1,[Tabu]Mond,4041,516,28,19,47,59.6%,20m
3203,1,Ridian,4040,1403,54,29,83,65.1%,35m
3203,1,SirAnneau,4040,694,17,11,28,60.7%,3m
3203,1,Barabbas,4040,142,3,3,6,50.0%,9m
3203,3,HanZo,4040,0,1,1,2,50.0%,6m
3207,1,[NoGy]IMBarabba,4039,1899,59,51,110,53.6%,9m
3207,1,SergomozG,4039,1747,53,49,102,52.0%,16m
3207,1,[AnD]STATS,4039,1076,47,26,73,64.4%,20m
3207,1,XsReD,4039,1456,39,39,78,50.0%,3m
3207,1,[БУБУБ]rusZealot,4039,596,13,19,32,40.6%,21m
3207,1,Lelouch,4039,326,8,6,14,57.1%,13m
3207,1,[RBlood]hotTemplar,4039,48,2,1,3,66.7%,18m
3214,1,[CFeS]Specter,4038,1646,50,59,109,45.9%,35m
3214,2,Qyodin,4038,756,31,61,92,33.7%,13m
3214,1,[ZBL]BiZhou,4038,470,10,15,25,40.0%,13m
3214,1,Slowriding,4038,0,1,0,1,100.0%,18m
3218,1,[SBeZ]Teufel,4037,889,42,18,60,70.0%,35m
3218,1,Perfi,4037,1326,36,43,79,45.6%,4m
3218,1,SlimShady,4037,600,20,19,39,51.3%,15m
3218,1,MoreGG,4037,798,20,26,46,43.5%,16m
3218,1,tiga,4037,709,19,16,35,54.3%,11m
3218,1,[SFine]Mancilla,4037,455,14,14,28,50.0%,4m
3218,1,Yoyo,4037,206,5,1,6,83.3%,18m
3218,1,[ǂNoMǂ]Domezi,4037,0,0,1,1,0.0%,18m
3226,3,ZNEEL,4036,1620,178,196,374,47.6%,11m
3226,1,ElNiNos,4036,791,19,17,36,52.8%,15m
3226,1,[Kompis]Tohatzu,4036,678,16,20,36,44.4%,16m
3226,1,KingArthur,4036,366,9,8,17,52.9%,9m
3226,1,[NwK]LePibertson,4036,0,1,0,1,100.0%,4m
3226,1,Bagost,4036,0,1,0,1,100.0%,10m
3226,1,[TEIF]Keype,4036,0,1,0,1,100.0%,11m
3226,1,Vaycanina,4036,0,0,3,3,0.0%,9m
3234,1,mgh,4035,1470,120,106,226,53.1%,16m
3234,1,Piff,4035,210,7,5,12,58.3%,9m
3234,1,[Xa]EnDgaMe,4035,0,1,2,3,33.3%,21m
3234,1,Johnney,4035,0,1,6,7,14.3%,19m
3238,1,trolezomb,4034,766,33,20,53,62.3%,19m
3238,1,KorZo,4034,1056,25,26,51,49.0%,18m
3238,1,Timoxn,4034,192,5,7,12,41.7%,20m
3238,1,SmgSwagger,4034,48,1,5,6,16.7%,4m
3242,1,Gumbercules,4033,2097,493,493,986,50.0%,15m
3242,1,[TExGG]AtomicShot,4033,2067,443,415,858,51.6%,18m
3242,1,ToYs,4033,2030,185,151,336,55.1%,8m
3242,1,[PŖïMĄŁ]MannYPacman,4033,1516,48,41,89,53.9%,9m
3242,1,Buster,4033,1629,41,47,88,46.6%,11m
3242,1,prodi,4033,595,19,15,34,55.9%,35m
3242,1,DeadlyMouse,4033,186,5,6,11,45.5%,16m
3242,1,[GUI1]bóngvann,4033,190,5,7,12,41.7%,15m
3242,1,[ĦRZ]mindjames,4033,94,3,2,5,60.0%,16m
3242,1,[y0ur]attention,4033,48,2,6,8,25.0%,13m
3242,1,[opFaiL]danischu,4033,0,1,0,1,100.0%,2m
3242,1,Night,4033,0,0,5,5,0.0%,16m
3254,3,[PaniC]xxMVGNUMxx,4032,1307,87,102,189,46.0%,20m
3254,1,ferari,4032,758,47,36,83,56.6%,9m
3254,1,Rawwk,4032,1306,47,50,97,48.5%,16m
3254,3,[Wolven]Jhiaxus,4032,0,2,3,5,40.0%,5m
3254,1,EctoPlasm,4032,0,0,2,2,0.0%,20m
3254,1,[Cannоn]Bam,4032,0,0,2,2,0.0%,9m
3260,1,Grandias,4031,1108,44,36,80,55.0%,20m
3260,1,zizyx,4031,894,20,27,47,42.6%,13m
3260,1,FlacidFAP,4031,237,9,2,11,81.8%,20m
3260,1,MatisS,4031,92,2,2,4,50.0%,35m
3260,3,LudwigVan,4031,0,1,1,2,50.0%,33m
3265,1,PacRAT,4030,1864,83,85,168,49.4%,2m
3265,1,[OOTD]HoTDog,4030,1862,71,76,147,48.3%,10m
3265,1,bug,4030,1672,46,51,97,47.4%,9m
3265,1,Combain,4030,780,29,13,42,69.0%,9m
3269,1,Job,4029,1634,71,79,150,47.3%,13m
3269,1,FarMoR,4029,425,15,6,21,71.4%,18m
3269,1,Céréalkileur,4029,508,12,13,25,48.0%,10m
3269,1,Tassadar,4029,0,0,2,2,0.0%,20m
3273,3,[EmŦ]Dart,4028,1943,181,182,363,49.9%,16m
3273,1,PeterPan,4028,2041,69,67,136,50.7%,4m
3273,1,ElNino,4028,860,60,53,113,53.1%,9m
3273,1,[Hrr]narundo,4028,1809,57,56,113,50.4%,6m
3273,1,SteigenReich,4028,626,53,42,95,55.8%,9m
3273,2,Törttö,4028,0,1,1,2,50.0%,8m
3273,1,Teo,4028,48,1,1,2,50.0%,16m
3280,1,[BiBAP]Gorean,4027,1581,448,388,836,53.6%,3m
3280,1,BsCMBANerd,4027,1242,30,37,67,44.8%,9m
3280,2,studio,4027,170,14,3,17,82.4%,17m
3280,2,Bumsdrache,4027,70,4,0,4,100.0%,7m
3284,3,junius,4026,1387,73,92,165,44.2%,8m
3284,1,IceDalek,4026,554,14,13,27,51.9%,15m
3284,1,ErOs,4026,146,10,0,10,100.0%,10m
3284,1,Jpd,4026,48,2,1,3,66.7%,33m
3288,1,[NTP]NoTerran,4025,1611,287,258,545,52.7%,35m
3288,1,ZZtopGun,4025,1136,68,67,135,50.4%,6m
3288,1,Banse,4025,1082,40,22,62,64.5%,20m
3288,1,[Zoldyk]Killua,4025,232,5,10,15,33.3%,15m
3288,1,[LMBD]ByuNJr,4025,187,3,6,9,33.3%,2m
3288,1,Austera,4025,48,2,0,2,100.0%,20m
3288,1,Berny,4025,0,0,2,2,0.0%,13m
3295,1,[БУБУБ]Hellbatking,4024,1082,31,37,68,45.6%,15m
3295,1,Makki,4024,458,11,14,25,44.0%,35m
3297,1,[Сlеvеr]Swarm,4023,1665,64,52,116,55.2%,11m
3297,1,[сSсǃ]Fansaf,4023,1127,49,31,80,61.2%,19m
3297,1,[сSсǃ]pluggglacior,4023,705,17,21,38,44.7%,4m
3297,1,[SLB]ScReaM,4023,0,2,4,6,33.3%,4m
3301,1,[Нope]Nerzan,4022,1906,261,261,522,50.0%,33m
3301,3,[AppSha]NeoWave,4022,193,195,180,375,52.0%,7m
3301,1,TdgNosferatu,4022,752,23,11,34,67.6%,20m
3301,2,[3ЕRGTV]Zireael,4022,298,12,4,16,75.0%,17m
3301,1,BlueDevil,4022,0,0,1,1,0.0%,9m
3301,1,[malone]bugzY,4022,0,0,1,1,0.0%,15m
3307,1,hJk,4021,1808,165,135,300,55.0%,20m
3307,1,[DMøøn]DOOM,4021,1929,115,122,237,48.5%,16m
3307,1,[BornG]DusK,4021,1450,37,48,85,43.5%,4m
3307,2,FingerMeDady,4021,209,14,2,16,87.5%,11m
3307,1,ZurbaTopova,4021,159,10,0,10,100.0%,5m
3307,1,[PŖïMĄŁ]BlueS,4021,138,4,8,12,33.3%,11m
3307,1,Leopard,4021,46,1,2,3,33.3%,9m
3307,1,BlackCoffee,4021,48,1,2,3,33.3%,4m
3307,3,Claxxika,4021,0,0,2,2,0.0%,10m
3316,1,HolyJoseph,4020,1220,140,132,272,51.5%,9m
3316,1,[CLICKk]SweetDave,4020,1287,66,54,120,55.0%,21m
3316,1,Marbet,4020,1700,49,46,95,51.6%,6m
3316,1,ZhúŁdEaR,4020,92,3,2,5,60.0%,9m
3316,3,[HOTFIR]AIphaStar,4020,0,2,3,5,40.0%,13m
3316,1,[ECV]Chaotic,4020,48,1,6,7,14.3%,13m
3316,1,LikeApROtosS,4020,0,0,1,1,0.0%,4m
3323,1,Scale,4019,2073,216,221,437,49.4%,21m
3323,1,[ZЕRGML]BALAMUT,4019,1201,52,54,106,49.1%,5m
3323,1,Juzpen,4019,388,19,5,24,79.2%,13m
3323,1,tidusff,4019,694,18,21,39,46.2%,11m
3323,1,Erik,4019,561,18,25,43,41.9%,18m
3323,1,Babayaga,4019,656,16,22,38,42.1%,34m
3323,1,[ƮesXG]Milleus,4019,94,3,5,8,37.5%,11m
3323,1,CalmMKD,4019,0,0,1,1,0.0%,16m
3323,1,[SY2G]Nath,4019,0,0,1,1,0.0%,20m
3332,1,LuckyStrike,4018,1203,85,76,161,52.8%,3m
3332,1,dudeTWOFIFTp,4018,1576,76,73,149,51.0%,20m
3332,1,Cripo,4018,616,40,18,58,69.0%,17m
3332,1,ChaiNer,4018,932,34,21,55,61.8%,11m
3332,1,Zockerbabba,4018,173,4,1,5,80.0%,8m
3337,1,[PHØMUI]Eran,4017,1349,39,31,70,55.7%,11m
3337,1,[LMBD]SerianAsef,4017,958,23,22,45,51.1%,13m
3337,1,[EESC]Kakashi,4017,754,17,24,41,41.5%,4m
3337,1,stumbot,4017,142,4,4,8,50.0%,19m
3337,1,BossMarine,4017,176,4,12,16,25.0%,9m
3337,1,[Roger]ArseniK,4017,140,3,0,3,100.0%,11m
3337,1,Zargothrax,4017,0,2,3,5,40.0%,11m
3337,1,reklemhuk,4017,46,1,1,2,50.0%,13m
3345,1,HellandGore,4016,829,40,30,70,57.1%,21m
3345,1,IIIIIIIIIIII,4016,408,10,12,22,45.5%,9m
3345,1,reyk,4016,190,4,16,20,20.0%,6m
3345,1,PeterLustig,4016,0,0,1,1,0.0%,11m
3349,1,[Heroes]Agge,4015,1915,91,83,174,52.3%,8m
3349,1,Cotillion,4015,792,58,24,82,70.7%,11m
3349,1,[LESeV]MilLoRd,4015,1200,35,34,69,50.7%,3m
3349,1,Kyezer,4015,874,21,27,48,43.8%,15m
3349,1,[lWHl]KloMeister,4015,0,1,0,1,100.0%,15m
3354,1,Napster,4014,2078,170,165,335,50.7%,11m
3354,1,michary,4014,625,23,19,42,54.8%,6m
3354,1,IIIIIIIIIIII,4014,187,5,1,6,83.3%,35m
3354,2,[kkkkjr]llllllllll,4014,172,4,1,5,80.0%,14m
3354,1,[TGABP]Mars,4014,140,3,3,6,50.0%,6m
3354,1,juri,4014,48,1,4,5,20.0%,34m
3354,1,Smix,4014,0,0,3,3,0.0%,20m
3361,1,IIIIIIIIIIII,4013,1289,58,37,95,61.1%,13m
3361,1,[Lambro]Jeremy,4013,1245,56,59,115,48.7%,9m
3361,1,[RSK]GrumpyRoach,4013,247,5,4,9,55.6%,4m
3361,1,Newbie,4013,137,3,0,3,100.0%,20m
3361,1,Slowstupid,4013,46,1,5,6,16.7%,2m
3366,1,[MSUSC2]Khadgar,4012,1723,185,190,375,49.3%,5m
3366,1,[пепега]kabyraGe,4012,1469,104,95,199,52.3%,35m
3366,1,Sepfor,4012,246,37,24,61,60.7%,9m
3366,1,[Li3]Samur,4012,522,21,21,42,50.0%,16m
3366,1,lllllllll,4012,864,21,36,57,36.8%,15m
3366,1,[RSPCT]Foooxxx,4012,312,7,8,15,46.7%,10m
3366,1,HmHoozMilo,4012,212,5,6,11,45.5%,15m
3366,1,ThËÐÛÐÈ,4012,236,5,11,16,31.2%,9m
3366,1,Freeman,4012,140,3,8,11,27.3%,17m
3366,1,[GdAT]Zod,4012,0,0,1,1,0.0%,9m
3366,3,[IÐŠI]snadge,4012,0,0,1,1,0.0%,13m
3377,1,CRIBINHO,4011,1980,262,208,470,55.7%,9m
3377,1,[iTecHi]Ahead,4011,2074,255,236,491,51.9%,35m
3377,1,Firefou,4011,1027,190,137,327,58.1%,3m
3377,1,PsyChODad,4011,2036,86,73,159,54.1%,5m
3377,1,[сSсǃ]SpektoR,4011,1523,77,75,152,50.7%,18m
3377,3,BbylngsMacro,4011,169,9,1,10,90.0%,13m
3377,1,Pecueca,4011,0,1,1,2,50.0%,16m
3384,1,[HDIUB]Moombaex,4010,831,31,17,48,64.6%,16m
3384,1,BabinHood,4010,368,9,13,22,40.9%,11m
3384,1,TED,4010,137,6,1,7,85.7%,11m
3384,1,[1Tank]leonardo,4010,0,1,0,1,100.0%,3m
3384,1,[Pozor]Experior,4010,0,0,1,1,0.0%,20m
3389,1,Saitama,4009,303,41,26,67,61.2%,13m
3389,1,RuegenWalder,4009,278,16,5,21,76.2%,13m
3389,1,Val,4009,460,10,14,24,41.7%,33m
3389,1,Xclusive,4009,140,4,4,8,50.0%,21m
3393,1,Eirene,4008,1730,212,197,409,51.8%,3m
3393,1,arhu,4008,1773,83,83,166,50.0%,20m
3393,1,Dippo,4008,995,37,28,65,56.9%,5m
3393,1,sOggYBisCuiT,4008,911,30,22,52,57.7%,20m
3393,1,Burst,4008,412,9,9,18,50.0%,9m
3393,1,[Angus]History,4008,225,7,7,14,50.0%,33m
3393,3,Byun,4008,30,3,3,6,50.0%,13m
3393,1,STRUCTURE,4008,46,1,1,2,50.0%,11m
3401,1,[Hаsu]Quasar,4007,96,2,4,6,33.3%,18m
3401,1,[JOHNNY]OurSon,4007,0,0,2,2,0.0%,17m
3403,1,[ValidG]StarRider,4006,913,181,170,351,51.6%,4m
3403,1,Mati,4006,1192,31,31,62,50.0%,6m
3403,1,epikfaal,4006,46,1,2,3,33.3%,8m
3406,1,Paz,4005,1491,143,141,284,50.4%,12m
3406,1,grimalk,4005,1649,130,85,215,60.5%,4m
3406,1,[iksD]SeptimusReyt,4005,370,14,14,28,50.0%,4m
3406,1,[Zsquad]Ostik,4005,520,13,12,25,52.0%,20m
3406,1,[TheDOH]syD,4005,0,0,1,1,0.0%,3m
3406,1,Hansinaquak,4005,0,0,3,3,0.0%,11m
3412,1,Bonkey,4004,1109,53,31,84,63.1%,9m
3412,1,Zagato,4004,0,1,0,1,100.0%,19m
3414,1,basıbozuk,4003,2034,201,203,404,49.8%,35m
3414,1,Terminal,4003,1745,112,121,233,48.1%,11m
3414,1,Burgeratora,4003,1976,68,70,138,49.3%,19m
3414,1,Primecluster,4003,1001,23,24,47,48.9%,9m
3414,1,WhiteHawk,4003,534,22,14,36,61.1%,20m
3414,1,[NewLR]GrishaHit,4003,456,12,17,29,41.4%,13m
3414,1,Pumpkin,4003,348,11,4,15,73.3%,20m
3414,1,KKonaW,4003,46,2,0,2,100.0%,20m
3414,1,Vinuel,4003,48,2,1,3,66.7%,15m
3423,1,TrixXxa,4002,1947,95,102,197,48.2%,16m
3423,1,iga,4002,1474,40,47,87,46.0%,35m
3423,1,Dreamer,4002,718,18,16,34,52.9%,4m
3426,1,Paralelotoss,4001,1657,208,204,412,50.5%,18m
3426,1,AllMightyG,4001,1959,181,187,368,49.2%,16m
3426,1,Nelson,4001,2030,169,132,301,56.1%,19m
3426,1,[nB]Elie,4001,1800,103,92,195,52.8%,20m
3426,1,[eXǂ]NeoW,4001,1562,85,65,150,56.7%,20m
3426,1,DarKhan,4001,0,2,3,5,40.0%,9m
3426,1,Eredin,4001,0,1,0,1,100.0%,35m
3433,1,vilandre,4000,535,31,1,32,96.9%,16m
3433,1,[GET]krastone,4000,545,17,19,36,47.2%,11m
3433,1,[НТТ]Mangaka,4000,460,10,12,22,45.5%,16m
3433,2,maVerick,4000,193,8,2,10,80.0%,21m
3433,1,xiaOt,4000,0,0,3,3,0.0%,21m
3438,1,Stratos,3999,2038,205,192,397,51.6%,11m
3438,1,SaberLight,3999,642,26,11,37,70.3%,18m
3438,1,Dutes,3999,806,19,26,45,42.2%,9m
3438,1,SnookieZ,3999,690,15,25,40,37.5%,16m
3438,1,[HTY]LOL,3999,229,5,5,10,50.0%,4m
3438,1,[Sarmat]Tomstar,3999,154,4,1,5,80.0%,16m
3438,1,[CocoCo]Oelewapeur,3999,92,3,2,5,60.0%,11m
3438,1,NextBrother,3999,134,3,4,7,42.9%,20m
3438,1,IceFluffy,3999,0,0,2,2,0.0%,4m
3447,1,Muhan,3998,736,139,128,267,52.1%,11m
3447,1,Liquid,3998,1165,60,66,126,47.6%,13m
3447,1,[Dae]Skoll,3998,683,15,14,29,51.7%,17m
3447,1,WonderJ,3998,48,2,3,5,40.0%,9m
3447,1,[ǂRƎacT]Nobody,3998,0,1,0,1,100.0%,17m
3452,1,zteam,3997,2030,155,156,311,49.8%,4m
3452,1,[BauB]Progresser,3997,1533,85,68,153,55.6%,9m
3452,1,Shazam,3997,411,8,8,16,50.0%,12m
3452,1,BadHuman,3997,92,2,4,6,33.3%,17m
3452,1,BATMAN,3997,46,1,2,3,33.3%,11m
3452,1,ArdesT,3997,46,1,5,6,16.7%,13m
3458,1,[NetGG]Antlko,3996,680,25,14,39,64.1%,9m
3458,1,[TAW]FreeZ,3996,329,10,6,16,62.5%,11m
3458,1,DarK,3996,136,4,3,7,57.1%,18m
3458,1,PaNiC,3996,0,1,2,3,33.3%,17m
3458,1,MuadDib,3996,0,0,2,2,0.0%,5m
3463,1,chobubustah,3995,564,18,14,32,56.2%,9m
3463,1,[hBǂ]Orion,3995,188,4,5,9,44.4%,19m
3463,3,[IceHus]IIIIIIIIIII,3995,88,3,3,6,50.0%,9m
3463,1,TaNaToS,3995,92,2,4,6,33.3%,15m
3463,1,Maosu,3995,0,1,0,1,100.0%,9m
3463,1,[Fabels]KaXoN,3995,0,1,3,4,25.0%,34m
3469,1,Grinden,3994,658,35,41,76,46.1%,34m
3469,1,NeverCheese,3994,974,23,27,50,46.0%,16m
3469,2,[DzFan]daRe,3994,128,2,1,3,66.7%,11m
3469,1,[CSM]CosmicGus,3994,0,1,0,1,100.0%,3m
3469,1,[PAM]Loulobione,3994,0,1,0,1,100.0%,18m
3469,1,BAXTUKLOX,3994,0,0,3,3,0.0%,35m
3475,1,Thorin,3993,2000,160,161,321,49.8%,34m
3475,1,insect,3993,1102,145,29,174,83.3%,11m
3475,1,FckOPzerg,3993,711,74,62,136,54.4%,21m
3475,1,Poxi,3993,1400,41,41,82,50.0%,11m
3475,1,Pacini,3993,395,21,13,34,61.8%,16m
3475,1,Twentyfour,3993,306,20,2,22,90.9%,19m
3475,2,Kuckuck,3993,315,15,5,20,75.0%,11m
3475,1,HughMungus,3993,244,13,0,13,100.0%,20m
3475,1,Dranik,3993,360,9,18,27,33.3%,21m
3475,2,[FD]JustChillin,3993,250,7,5,12,58.3%,21m
3475,1,[НТТ]pazhiloy,3993,182,6,2,8,75.0%,21m
3475,1,EzForMe,3993,177,5,1,6,83.3%,9m
3475,1,Hankster,3993,112,2,2,4,50.0%,13m
3475,1,[EBF]Fake,3993,0,1,0,1,100.0%,17m
3475,1,Шайгу,3993,94,1,1,2,50.0%,15m
3490,1,ysanafa,3992,1610,149,140,289,51.6%,11m
3490,1,IIIIIIIIIIII,3992,1587,135,114,249,54.2%,20m
3490,1,Agnizar,3992,136,4,4,8,50.0%,10m
3490,1,[KDV]RetoR,3992,0,1,0,1,100.0%,5m
3494,1,JohnSmith,3991,1887,73,55,128,57.0%,19m
3494,1,tarekp,3991,460,18,11,29,62.1%,11m
3494,1,[Zguege]TortueALeo,3991,347,12,6,18,66.7%,9m
3494,1,TheBabyPixel,3991,410,9,11,20,45.0%,3m
3494,1,Farce,3991,94,3,7,10,30.0%,19m
3494,2,DeepsYug,3991,38,1,4,5,20.0%,17m
3500,1,Ascalon,3990,1956,91,100,191,47.6%,17m
3500,1,MSKgreen,3990,1111,80,71,151,53.0%,16m
3500,1,Enki,3990,926,21,26,47,44.7%,16m
3500,1,[FSeS]Rebellion,3990,276,6,10,16,37.5%,6m
3500,1,kReSt,3990,0,1,1,2,50.0%,20m
3505,1,IIIIIIII,3989,2084,406,411,817,49.7%,34m
3505,1,[GEGT]Nobtozz,3989,1776,356,325,681,52.3%,9m
3505,1,cukata,3989,1576,221,193,414,53.4%,11m
3505,1,Maquat,3989,1934,136,136,272,50.0%,13m
3505,1,[GOLVAD]GinToniC,3989,1532,53,35,88,60.2%,12m
3505,3,Ewells,3989,444,48,62,110,43.6%,19m
3505,1,Garka,3989,476,26,9,35,74.3%,4m
3505,1,[FDP]François,3989,494,26,12,38,68.4%,20m
3505,1,Rasto,3989,592,24,13,37,64.9%,12m
3505,1,Seventh,3989,324,8,12,20,40.0%,20m
3505,1,[tH]Himmelhund,3989,142,4,4,8,50.0%,9m
3505,1,[rEU]Bad,3989,155,3,2,5,60.0%,16m
3505,1,[ĦRZ]Xplode,3989,92,1,1,2,50.0%,34m
3518,1,GoHard,3988,1439,61,44,105,58.1%,11m
3518,1,Boo,3988,776,44,10,54,81.5%,35m
3518,1,Swanky,3988,212,20,12,32,62.5%,21m
3518,1,[PŖïMĄŁ]CristoDorado,3988,530,17,12,29,58.6%,18m
3518,1,TwizZer,3988,46,2,4,6,33.3%,20m
3523,1,Shegin,3987,1521,181,166,347,52.2%,20m
3523,1,Andy,3987,2035,128,118,246,52.0%,35m
3523,1,Newone,3987,1217,66,56,122,54.1%,13m
3523,1,Sebbe,3987,1493,57,50,107,53.3%,9m
3523,1,MatS,3987,409,16,7,23,69.6%,17m
3523,1,[BELSCF]mehere,3987,420,10,13,23,43.5%,6m
3523,1,TossSendDead,3987,110,2,2,4,50.0%,16m
3530,1,Sunborn,3986,653,45,22,67,67.2%,4m
3530,1,[PTSL]Starscream,3986,1484,38,39,77,49.4%,16m
3530,1,EasyAI,3986,1132,38,43,81,46.9%,8m
3530,1,llllllllllll,3986,166,20,14,34,58.8%,5m
3530,1,Thrug,3986,48,1,2,3,33.3%,20m
3530,1,BobRoss,3986,0,0,1,1,0.0%,15m
3536,1,Stockfish,3985,2055,555,557,1112,49.9%,34m
3536,3,[FSIN]MacroPlayer,3985,1883,326,334,660,49.4%,16m
3536,1,[743]WaRCrY,3985,1231,83,62,145,57.2%,9m
3536,1,Greenthumb,3985,1256,48,31,79,60.8%,20m
3536,1,[ZestCP]INnVocation,3985,1469,43,47,90,47.8%,34m
3536,1,Touch,3985,538,20,12,32,62.5%,18m
3536,1,Hostis,3985,92,2,0,2,100.0%,10m
3536,1,Megz,3985,110,2,2,4,50.0%,9m
3536,1,syntheze,3985,0,1,3,4,25.0%,10m
3545,1,HappyLook,3984,1822,57,48,105,54.3%,4m
3545,1,Zhenksta,3984,1412,45,37,82,54.9%,15m
3545,1,[SEWP]Farlengar,3984,531,32,11,43,74.4%,17m
3545,1,ADAMBOS,3984,1028,25,30,55,45.5%,21m
3545,2,YaBoginaKale,3984,46,2,7,9,22.2%,35m
3550,1,Mcbomber,3983,1986,79,77,156,50.6%,4m
3550,1,Dash,3983,1242,77,75,152,50.7%,15m
3550,1,Mardoo,3983,1038,65,57,122,53.3%,9m
3550,1,mORE,3983,710,45,31,76,59.2%,15m
3550,1,SirWhite,3983,763,37,18,55,67.3%,5m
3550,1,MadeInUA,3983,687,33,32,65,50.8%,10m
3550,1,Rum,3983,229,10,4,14,71.4%,35m
3550,1,Hidden,3983,161,8,4,12,66.7%,6m
3550,1,llllllllllll,3983,140,4,3,7,57.1%,9m
3550,1,[EESC]Aramos,3983,48,1,7,8,12.5%,6m
3550,1,SuShi,3983,0,0,2,2,0.0%,11m
3561,1,[mfixed]drJellyfish,3982,1741,195,178,373,52.3%,11m
3561,1,[Pw]PwEroX,3982,1978,75,57,132,56.8%,19m
3561,1,Хайван,3982,2056,66,68,134,49.3%,16m
3561,1,[ĽşĐ]LegiT,3982,475,59,16,75,78.7%,9m
3561,1,PizdeNahoBla,3982,642,26,15,41,63.4%,35m
3561,1,Gruba,3982,164,6,1,7,85.7%,5m
3561,1,[ligma]bXa,3982,0,0,1,1,0.0%,20m
3568,1,Chadry,3981,883,95,71,166,57.2%,11m
3568,1,Death,3981,1014,72,59,131,55.0%,11m
3568,1,[ValidG]Kenshin,3981,478,47,48,95,49.5%,10m
3568,1,[Paaaaa]Luka,3981,1123,33,33,66,50.0%,10m
3568,1,[MiNeR]PoLdek,3981,881,26,21,47,55.3%,3m
3568,1,Awesomic,3981,178,17,6,23,73.9%,13m
3568,1,OOOOOOOOOOOO,3981,698,16,19,35,45.7%,16m
3568,1,Fifth,3981,231,11,1,12,91.7%,20m
3568,1,egg,3981,201,5,9,14,35.7%,15m
3568,1,[QQ]Pitch,3981,94,3,7,10,30.0%,35m
3568,1,KiceK,3981,94,2,3,5,40.0%,6m
3568,1,Gerald,3981,0,1,0,1,100.0%,4m
3568,1,liquid,3981,0,1,1,2,50.0%,3m
3568,1,UpsAper,3981,73,0,4,4,0.0%,20m
3582,1,NighTSorroW,3980,1890,322,304,626,51.4%,10m
3582,1,[Olеg]ddMegaDooDoo,3980,2076,219,243,462,47.4%,3m
3582,1,Gron,3980,628,31,17,48,64.6%,4m
3582,1,NoFate,3980,833,28,24,52,53.8%,5m
3582,1,aceBatKinG,3980,111,2,2,4,50.0%,16m
3587,1,Dampth,3979,1538,54,44,98,55.1%,21m
3587,1,OrteGa,3979,1061,49,32,81,60.5%,4m
3587,1,zmd,3979,416,12,10,22,54.5%,15m
3587,1,HoTkEyS,3979,91,4,2,6,66.7%,9m
3591,1,Eol,3978,976,97,67,164,59.1%,3m
3591,1,Фларис,3978,992,65,60,125,52.0%,6m
3591,1,[Serral]deep,3978,660,19,17,36,52.8%,5m
3591,1,[ZpLG]Asthrane,3978,348,18,6,24,75.0%,4m
3591,1,Chronos,3978,348,13,7,20,65.0%,20m
3591,1,[KoyBee]TROTSKY,3978,274,7,7,14,50.0%,35m
3591,1,[UATeam]HighHopes,3978,322,7,9,16,43.8%,35m
3591,1,[MiA]Evuser,3978,0,4,2,6,66.7%,11m
3599,1,Tyras,3977,1472,62,45,107,57.9%,9m
3599,1,[uclan]mrmirror,3977,544,45,36,81,55.6%,21m
3599,1,[EBU]Habibi,3977,742,44,29,73,60.3%,12m
3599,1,[NotSuR]Kipyatosh,3977,775,29,20,49,59.2%,11m
3599,1,miked,3977,232,6,14,20,30.0%,16m
3599,3,Stormstormer,3977,169,5,3,8,62.5%,17m
3599,1,[M4nAAA]aNaRChiSt,3977,0,0,6,6,0.0%,13m
3606,1,GoEasy,3976,483,27,15,42,64.3%,4m
3606,1,[LawB]Adik,3976,683,20,19,39,51.3%,9m
3606,1,BMorge,3976,419,11,11,22,50.0%,20m
3606,1,[ZERGSC]llllllllllll,3976,368,8,14,22,36.4%,35m
3606,1,[Oudill]WesC,3976,144,3,8,11,27.3%,6m
3606,1,BNDS,3976,0,1,0,1,100.0%,5m
3606,1,zuka,3976,0,0,1,1,0.0%,10m
3613,1,NeoHeretic,3975,360,21,16,37,56.8%,9m
3613,1,[MBC]Arvediu,3975,520,20,10,30,66.7%,11m
3613,1,ifeelikepoop,3975,232,11,1,12,91.7%,16m
3613,1,baz,3975,132,3,1,4,75.0%,9m
3613,1,Erazium,3975,0,1,0,1,100.0%,35m
3618,1,[IF1l]Raven,3974,1893,218,217,435,50.1%,18m
3618,1,[CL3]Ares,3974,915,68,61,129,52.7%,18m
3618,1,Vulvator,3974,484,54,35,89,60.7%,9m
3618,1,Kaifat,3974,916,42,26,68,61.8%,18m
3618,1,Zwonka,3974,400,33,20,53,62.3%,9m
3618,1,SantyaGa,3974,501,27,10,37,73.0%,13m
3618,1,[Adlscø]Morpheam,3974,356,24,3,27,88.9%,9m
3618,1,Альберт,3974,470,11,16,27,40.7%,16m
3618,1,Havox,3974,248,6,5,11,54.5%,9m
3627,1,KorbenDallas,3973,1566,143,117,260,55.0%,4m
3627,1,HansOlo,3973,918,41,29,70,58.6%,9m
3627,1,SoaD,3973,548,13,10,23,56.5%,6m
3627,1,Fireball,3973,46,1,4,5,20.0%,35m
3627,3,IlIlIlIlIlIl,3973,0,1,5,6,16.7%,34m
3632,2,[Ex0n]Hønsking,3972,688,32,16,48,66.7%,34m
3632,2,Justforfun,3972,186,5,6,11,45.5%,2m
3632,2,Jombo,3972,0,0,1,1,0.0%,2m
3632,1,thessj,3972,0,0,2,2,0.0%,9m
3636,3,llllllllllll,3971,197,8,5,13,61.5%,19m
3636,1,[0BO]jaCE,3971,48,2,1,3,66.7%,9m
3636,2,Gold,3971,0,1,0,1,100.0%,34m
3636,1,PohLi,3971,91,1,2,3,33.3%,10m
3636,2,Ström,3971,105,1,2,3,33.3%,34m
3641,1,Agone,3970,1803,461,421,882,52.3%,13m
3641,1,FéeDartifiX,3970,1369,94,77,171,55.0%,4m
3641,1,[ncotic]Machete,3970,1536,45,52,97,46.4%,18m
3641,1,[nWss]nemdragon,3970,762,32,20,52,61.5%,4m
3641,1,[ОВOЩ]Player,3970,639,19,15,34,55.9%,10m
3641,3,IIIIIIIII,3970,193,6,5,11,54.5%,5m
3641,1,[trible]kennsenich,3970,140,4,4,8,50.0%,8m
3641,1,EPB,3970,0,0,2,2,0.0%,3m
3649,3,[PLA2N]Crabushek,3969,145,8,0,8,100.0%,20m
3649,1,[UATeam]SuperSkunk,3969,48,1,4,5,20.0%,5m
3651,1,Slrtbartfast,3968,1329,49,37,86,57.0%,12m
3651,2,[TBst]SiaBBo,3968,206,6,3,9,66.7%,12m
3651,1,[BotN]AdmiralPanda,3968,150,5,5,10,50.0%,4m
3651,1,[Arrows]chiter,3968,46,2,3,5,40.0%,4m
3651,3,QtAnimeGirl,3968,0,1,0,1,100.0%,2m
3651,3,Leaf,3968,0,0,1,1,0.0%,6m
3651,2,IIIIIIIIIIII,3968,0,0,1,1,0.0%,34m
3658,1,LorTirius,3967,1600,65,57,122,53.3%,9m
3658,1,[сSсǃ]SunFace,3967,635,15,14,29,51.7%,4m
3660,3,scIIStudent,3966,1600,404,398,802,50.4%,17m
3660,1,Yago,3966,276,6,8,14,42.9%,16m
3660,1,[myLT]Avalon,3966,0,0,3,3,0.0%,35m
3663,1,Merlin,3965,1947,207,201,408,50.7%,11m
3663,1,Snurskalle,3965,1558,93,65,158,58.9%,18m
3663,1,PEPEGA,3965,1517,64,37,101,63.4%,9m
3666,1,[RGSC2]LifeForAiur,3964,624,44,27,71,62.0%,20m
3666,1,[TheRPW]Arkenstone,3964,273,6,5,11,54.5%,35m
3666,1,[MvN]Maxfab,3964,0,0,2,2,0.0%,4m
3669,1,Zanpakutō,3963,1750,189,172,361,52.4%,11m
3669,2,StarHunter,3963,926,39,20,59,66.1%,8m
3669,1,Frost,3963,1381,39,48,87,44.8%,9m
3669,1,[lOoOl]TGNP,3963,375,9,9,18,50.0%,4m
3669,1,Grimm,3963,370,8,15,23,34.8%,9m
3669,2,[UATeam]Николай,3963,192,7,2,9,77.8%,20m
3669,2,[Sleazy]Aeryn,3963,86,2,1,3,66.7%,4m
3669,2,Kamito,3963,38,2,1,3,66.7%,3m
3669,2,Learningnoob,3963,34,1,1,2,50.0%,14m
3669,2,[Аdk]Audeka,3963,0,0,1,1,0.0%,10m
3669,3,PoilAuMenton,3963,0,0,6,6,0.0%,12m
3680,1,Albus,3962,2023,458,481,939,48.8%,5m
3680,1,[GoldM]sulzbard,3962,700,18,26,44,40.9%,34m
3680,2,NekoChan,3962,72,3,0,3,100.0%,14m
3680,2,Williamallas,3962,0,1,0,1,100.0%,17m
3680,2,Mirajje,3962,0,0,1,1,0.0%,17m
3680,1,TossIsGone,3962,0,0,3,3,0.0%,9m
3686,3,[BUAA]scboy,3961,518,37,58,95,38.9%,15m
3686,1,HKreporter,3961,555,22,12,34,64.7%,20m
3686,1,[ESSEL]DeeDan,3961,46,1,3,4,25.0%,20m
3689,1,LIFE,3960,1596,564,525,1089,51.8%,9m
3689,2,[PlAr]Shadowmeld,3960,1043,106,80,186,57.0%,34m
3689,1,Tom,3960,463,39,25,64,60.9%,16m
3689,2,SmuserKadser,3960,224,10,1,11,90.9%,12m
3689,1,Soita,3960,370,10,14,24,41.7%,5m
3689,2,[THRLLA]MicroJackson,3960,40,2,0,2,100.0%,14m
3689,1,[dziova]IIIIIIIIIIII,3960,0,1,1,2,50.0%,16m
3689,1,[valars]iluvatar,3960,0,0,2,2,0.0%,16m
3689,1,[IBeAŚI]Sittingbull,3960,0,0,5,5,0.0%,16m
3698,1,[lOoOl]MAXI,3959,2034,458,459,917,49.9%,16m
3698,1,[WCKYLN]DrunkenProbe,3959,1237,157,148,305,51.5%,9m
3698,1,[MoopyS]Eternity,3959,755,28,17,45,62.2%,15m
3698,1,Filosofen,3959,785,26,20,46,56.5%,8m
3698,1,SerraAngelDK,3959,93,2,1,3,66.7%,5m
3698,1,evrey,3959,0,0,2,2,0.0%,12m
3704,1,[PÂRłAH]Majrostyle,3958,1981,169,161,330,51.2%,35m
3704,1,NBS,3958,921,38,24,62,61.3%,5m
3704,1,Eledion,3958,1390,38,43,81,46.9%,4m
3704,1,[DumpD]MTS,3958,839,33,35,68,48.5%,9m
3704,1,[HtTK]TarTur,3958,877,25,28,53,47.2%,3m
3704,1,IIIIIIIIIIII,3958,746,19,18,37,51.4%,18m
3704,2,Jacklenious,3958,199,9,3,12,75.0%,34m
3704,1,[AofK]LuckyPhoenix,3958,0,1,1,2,50.0%,18m
3704,1,KrazyKariia,3958,0,0,2,2,0.0%,20m
3713,1,[Xa]Drator,3957,861,29,24,53,54.7%,34m
3713,1,MrPatate,3957,1017,26,26,52,50.0%,5m
3713,2,[eXøde]Saphir,3957,0,1,0,1,100.0%,11m
3713,2,[KAOTx]Piff,3957,0,1,0,1,100.0%,16m
3713,2,MadDog,3957,0,0,1,1,0.0%,34m
3718,1,SleepOnMic,3956,606,33,25,58,56.9%,35m
3718,2,Magephil,3956,508,18,10,28,64.3%,34m
3718,2,Sixth,3956,222,8,0,8,100.0%,34m
3718,1,lytiy,3956,282,7,8,15,46.7%,35m
3718,1,LInok,3956,184,5,8,13,38.5%,9m
3718,2,DarkPriest,3956,38,2,1,3,66.7%,4m
3718,1,Caracalla,3956,0,0,2,2,0.0%,13m
3725,1,straightup,3955,2015,451,448,899,50.2%,35m
3725,2,Hectic,3955,1678,370,346,716,51.7%,10m
3725,1,MiOh,3955,2029,229,237,466,49.1%,15m
3725,1,[ZERGML]WhiteSpirit,3955,1996,183,174,357,51.3%,5m
3725,1,Kys,3955,1820,95,77,172,55.2%,5m
3725,1,ZguhZer,3955,805,84,76,160,52.5%,11m
3725,1,[Pзrsia]behzzzad,3955,1428,69,72,141,48.9%,9m
3725,2,salaheddine,3955,655,31,12,43,72.1%,15m
3725,1,Tomeus,3955,670,22,19,41,53.7%,21m
3725,1,[MAJSTY]Dezibell,3955,119,1,5,6,16.7%,9m
3735,1,[tepia]tepia,3954,1784,185,172,357,51.8%,9m
3735,1,KiwiThief,3954,136,4,9,13,30.8%,19m
3737,1,Phyrokar,3953,673,32,22,54,59.3%,17m
3737,1,[SSCT]ChipsTERROR,3953,96,3,5,8,37.5%,4m
3737,2,Addict,3953,38,2,1,3,66.7%,17m
3737,2,DruMMonD,3953,0,1,0,1,100.0%,12m
3737,2,[яєѕ]astro,3953,0,0,1,1,0.0%,20m
3742,1,yriel,3952,1603,282,273,555,50.8%,8m
3742,3,deadgame,3952,301,14,1,15,93.3%,20m
3742,1,[CPSLCK]Eule,3952,0,0,4,4,0.0%,9m
3745,1,[Pw]YuMi,3951,1883,134,127,261,51.3%,19m
3745,1,Darkmatter,3951,94,2,6,8,25.0%,11m
3745,2,[NvP]TrAssiD,3951,0,1,0,1,100.0%,8m
3748,3,[SkyF]Atreides,3950,1903,222,249,471,47.1%,20m
3748,2,TheKondzio,3950,634,32,3,35,91.4%,13m
3748,2,[TheDOH]TheLilith,3950,40,1,3,4,25.0%,34m
3748,1,[NWGD]IIIIIIIIIIII,3950,48,1,4,5,20.0%,5m
3752,1,Wandfliese,3949,1585,108,106,214,50.5%,9m
3752,2,DogMonthly,3949,384,18,5,23,78.3%,18m
3752,1,pinya,3949,327,14,21,35,40.0%,15m
3752,2,[ǂHD]Aura,3949,360,12,7,19,63.2%,11m
3752,1,Demokrata,3949,265,6,5,11,54.5%,6m
3752,2,[TFLA]Vedor,3949,0,1,0,1,100.0%,21m
3758,1,oggbonaian,3948,1708,271,247,518,52.3%,18m
3759,2,Charlie,3947,1429,56,50,106,52.8%,14m
3759,2,KiNGOfBaTs,3947,700,30,13,43,69.8%,34m
3759,1,[DigBik]AnalChugs,3947,198,6,9,15,40.0%,15m
3759,2,troitatam,3947,110,4,2,6,66.7%,11m
3759,2,Baneblade,3947,76,2,1,3,66.7%,9m
3759,1,Deckard,3947,0,1,2,3,33.3%,5m
3759,2,TriSeven,3947,0,0,1,1,0.0%,10m
3766,2,[IceHus]IIIIIIIIIIII,3946,1420,115,91,206,55.8%,21m
3766,3,[GoldM]sLaiz,3946,291,14,3,17,82.4%,19m
3766,3,BatKinG,3946,239,12,1,13,92.3%,16m
3769,1,[AiRǂ]SwaiX,3945,1776,223,213,436,51.1%,17m
3769,1,Oberyn,3945,1008,85,75,160,53.1%,35m
3769,1,aMgOeL,3945,159,29,18,47,61.7%,16m
3769,2,[Anbu]YarikoKun,3945,637,26,24,50,52.0%,7m
3769,3,[ØC]Pandalord,3945,0,1,3,4,25.0%,19m
3774,2,DragonToss,3944,0,1,0,1,100.0%,19m
3774,3,[RoBotS]lNnoVation,3944,0,0,1,1,0.0%,21m
3776,1,Shahun,3943,1942,130,120,250,52.0%,34m
3776,1,Naserox,3943,1853,74,73,147,50.3%,10m
3776,2,Честныйтосс,3943,254,10,10,20,50.0%,34m
3776,1,[3M1]Yannik,3943,181,6,2,8,75.0%,12m
3776,1,Syalo,3943,92,3,9,12,25.0%,17m
3776,2,[69420]Juggernug,3943,36,1,1,2,50.0%,18m
3782,1,[NetGG]Lelouche,3942,987,32,30,62,51.6%,10m
3782,2,[BjC]Yetawa,3942,290,9,8,17,52.9%,5m
3782,2,[ADVIA]DizzyDwarf,3942,0,0,1,1,0.0%,7m
3785,2,Piff,3941,208,6,1,7,85.7%,8m
3786,2,UncleRuckus,3940,330,22,7,29,75.9%,4m
3786,2,Kavito,3940,462,21,7,28,75.0%,21m
3786,1,MrCämpBell,3940,454,13,13,26,50.0%,5m
3786,1,[DN3N]Ardn,3940,316,10,15,25,40.0%,4m
3786,2,Hospak,3940,40,2,0,2,100.0%,34m
3786,1,[Lirka]Lirka,3940,0,1,2,3,33.3%,21m
3786,1,Zindigard,3940,0,1,3,4,25.0%,20m
3786,3,[IPW]NiceBiT,3940,30,1,4,5,20.0%,15m
3794,3,Constantine,3939,114,8,5,13,61.5%,8m
3794,2,Antoha,3939,0,1,1,2,50.0%,19m
3796,1,Hordaphos,3938,1089,156,148,304,51.3%,34m
3796,1,vEndEttA,3938,736,22,25,47,46.8%,21m
3796,2,Bob,3938,38,1,2,3,33.3%,10m
3796,2,Hooman,3938,0,0,1,1,0.0%,34m
3796,2,Magicwit,3938,0,0,2,2,0.0%,2m
3801,1,Relaxo,3937,1230,53,55,108,49.1%,3m
3801,2,[TSFF]Alphon,3937,720,25,21,46,54.3%,12m
3801,2,IIIIIIIIIIII,3937,234,8,6,14,57.1%,9m
3801,1,Freeeeeze,3937,313,7,14,21,33.3%,16m
3801,3,mydirtyhobby,3937,97,5,1,6,83.3%,20m
3806,2,[aW]DonDada,3936,751,41,9,50,82.0%,14m
3806,1,[BornG]NoWis,3936,0,1,2,3,33.3%,6m
3806,2,[iOwnU]ImbaLJ,3936,0,0,1,1,0.0%,4m
3809,1,voinsveta,3935,1923,378,313,691,54.7%,19m
3809,1,[PiGPan]TimesChange,3935,635,15,16,31,48.4%,13m
3809,2,Broketoss,3935,264,14,2,16,87.5%,11m
3809,3,VodkaSelodka,3935,171,7,3,10,70.0%,19m
3809,2,[CxCx]Froenk,3935,68,3,0,3,100.0%,20m
3809,2,[wedown]Maru,3935,0,3,2,5,60.0%,14m
3815,2,Guru,3934,1603,263,249,512,51.4%,2m
3815,2,ChatGarou,3934,372,17,4,21,81.0%,34m
3815,2,[BRSKR]OneCoolDude,3934,0,1,0,1,100.0%,11m
3815,2,[Kaput]lejneb,3934,0,1,0,1,100.0%,11m
3815,3,[Mysa]Zulco,3934,0,1,0,1,100.0%,13m
3820,1,RealBigHindi,3933,924,31,33,64,48.4%,10m
3820,1,IIIIIIIIIIII,3933,256,11,5,16,68.8%,18m
3820,1,Micton,3933,92,3,5,8,37.5%,9m
3820,2,Baba,3933,0,1,1,2,50.0%,34m
3824,1,Reaper,3932,1437,52,51,103,50.5%,4m
3824,1,Stefan,3932,1046,27,31,58,46.6%,13m
3824,1,BigBang,3932,649,17,28,45,37.8%,21m
3824,1,liDH,3932,129,6,6,12,50.0%,21m
3824,2,Azle,3932,100,3,2,5,60.0%,34m
3829,1,[75рус]Patriot,3931,1605,198,198,396,50.0%,15m
3829,1,Hagareno,3931,979,48,47,95,50.5%,13m
3829,1,Bayash,3931,1187,38,39,77,49.4%,20m
3829,2,TheRatMan,3931,292,11,5,16,68.8%,2m
3833,1,IIIIIIIIIIII,3930,917,45,43,88,51.1%,5m
3833,2,CrappyCoco,3930,174,10,7,17,58.8%,5m
3833,2,[сSсǃ]DjeKi,3930,72,3,1,4,75.0%,18m
3836,1,Erichsen,3929,442,11,16,27,40.7%,4m
3836,2,Survival,3929,106,3,2,5,60.0%,13m
3836,2,[Li3]Manny,3929,0,0,5,5,0.0%,12m
3839,1,[Uchi]HanniibaL,3928,142,4,9,13,30.8%,21m
3840,1,PowerMonkey,3927,1977,280,294,574,48.8%,3m
3840,1,intercenam,3927,1898,83,89,172,48.3%,5m
3840,2,[RSPCT]NarFi,3927,634,20,22,42,47.6%,6m
3840,1,[illGG]Jin,3927,588,14,21,35,40.0%,8m
3840,1,[HBGSJR]Singler,3927,452,11,11,22,50.0%,16m
3840,1,[G0UDA]Tarascan,3927,129,6,7,13,46.2%,13m
3840,2,[FlexIN]Yamato,3927,160,5,4,9,55.6%,34m
3840,2,FaceLessMan,3927,0,1,0,1,100.0%,9m
3840,2,lolx,3927,38,1,2,3,33.3%,10m
3849,2,Khao,3926,1692,165,140,305,54.1%,11m
3849,2,[SPCGL]Ovaron,3926,34,2,2,4,50.0%,16m
3849,3,Zera,3926,0,1,0,1,100.0%,15m
3852,1,Archonel,3925,981,57,49,106,53.8%,9m
3852,1,llllllllllll,3925,452,15,21,36,41.7%,12m
3852,1,EvolPenguin,3925,0,0,4,4,0.0%,12m
3855,1,[яєѕ]BlackStones,3924,1268,84,70,154,54.5%,4m
3855,2,[SpeshT]Monte,3924,891,63,41,104,60.6%,5m
3855,2,[Gospel]Catalina,3924,474,24,9,33,72.7%,21m
3855,1,Predator,3924,257,9,8,17,52.9%,9m
3855,2,IIIIllllII,3924,134,4,2,6,66.7%,14m
3855,3,Covid,3924,60,3,3,6,50.0%,35m
3855,2,[Jenn]iferLawrence,3924,34,1,3,4,25.0%,34m
3855,2,[TIBER]James,3924,0,0,1,1,0.0%,7m
3863,1,Hypérion,3923,1389,110,116,226,48.7%,16m
3863,1,YaoFace,3923,1934,63,64,127,49.6%,4m
3863,1,[DSWT]RVS,3923,422,42,40,82,51.2%,13m
3863,1,[MAKinG]daisydaisyxo,3923,485,20,17,37,54.1%,19m
3863,3,ommmmmmmmmmm,3923,190,10,1,11,90.9%,17m
3863,2,[MinESP]FusE,3923,176,5,8,13,38.5%,17m
3869,1,[Stront]ManyMistakes,3922,2037,378,392,770,49.1%,16m
3869,1,[AWESUM]Initiator,3922,1880,131,127,258,50.8%,9m
3869,1,Nitron,3922,975,55,44,99,55.6%,10m
3869,2,YippeeKiYay,3922,606,22,17,39,56.4%,17m
3869,2,Mapusan,3922,542,18,16,34,52.9%,10m
3869,2,[ZERGML]nvvc,3922,166,5,2,7,71.4%,18m
3869,3,IIIIIIIIIIII,3922,97,2,1,3,66.7%,12m
3876,2,fark,3921,82,2,1,3,66.7%,7m
3876,2,[ProRax]AmaN,3921,42,2,1,3,66.7%,15m
3876,2,[Hаsu]crew,3921,0,0,1,1,0.0%,17m
3876,2,Kassadin,3921,0,0,2,2,0.0%,34m
3880,2,[flpm]rhanos,3920,404,24,14,38,63.2%,16m
3880,2,genesis,3920,243,11,7,18,61.1%,9m
3880,2,[EPK]SlowStyLe,3920,0,4,1,5,80.0%,2m
3880,3,SoleSurvivor,3920,0,2,1,3,66.7%,11m
3880,1,[CrøkeT]EIkeutard,3920,48,2,5,7,28.6%,19m
3885,1,Bobrakon,3919,2001,177,184,361,49.0%,6m
3885,1,SirGhost,3919,2016,87,89,176,49.4%,5m
3885,2,sexySamurai,3919,1510,61,47,108,56.5%,3m
3885,2,shadowfox,3919,526,23,18,41,56.1%,9m
3885,2,JaceKaoS,3919,466,16,10,26,61.5%,8m
3885,1,[Wolven]Tempest,3919,384,9,18,27,33.3%,11m
3885,2,[Derpt]Bojko,3919,0,1,1,2,50.0%,10m
3885,2,[crabz]WhiteNights,3919,0,0,2,2,0.0%,4m
3885,1,[GC]Purzenigele,3919,0,0,4,4,0.0%,5m
3894,2,Hatebreeder,3918,656,23,19,42,54.8%,12m
3894,2,[F4RM]DonKarnage,3918,436,20,12,32,62.5%,8m
3894,2,MyThOs,3918,313,10,6,16,62.5%,5m
3894,1,random,3918,140,3,7,10,30.0%,19m
3894,2,[Voyeur]BanKiMoon,3918,0,1,0,1,100.0%,14m
3899,1,[iN7]CHAOSKEKS,3917,452,21,12,33,63.6%,13m
3899,1,[TheDOH]secretspace,3917,222,6,16,22,27.3%,6m
3901,2,DarkVoice,3916,560,21,15,36,58.3%,14m
3901,3,[FalPal]Marbuel,3916,0,3,2,5,60.0%,9m
3903,2,Angmar,3915,274,9,7,16,56.2%,13m
3904,2,Gans,3914,1218,355,339,694,51.2%,3m
3904,2,[Heroes]Giaphage,3914,1497,105,91,196,53.6%,2m
3904,2,lIIIIlllllIl,3914,464,33,20,53,62.3%,7m
3904,2,Jonas,3914,312,12,10,22,54.5%,2m
3904,3,Gigasoija,3914,0,1,0,1,100.0%,16m
3904,2,[HLT]Kami,3914,0,0,1,1,0.0%,2m
3910,1,Midgard,3913,1616,45,56,101,44.6%,9m
3910,2,[PsiVan]SlyOstrich,3913,202,7,6,13,53.8%,16m
3910,2,[mfixed]slav,3913,0,0,1,1,0.0%,2m
3913,1,[AchrK9]GenWilkins,3912,754,31,39,70,44.3%,3m
3913,2,Grixx,3912,238,9,1,10,90.0%,7m
3913,2,Vision,3912,160,4,3,7,57.1%,11m
3913,2,llllllllllll,3912,32,2,0,2,100.0%,9m
3913,2,KimJongNuke,3912,0,0,1,1,0.0%,4m
3918,1,Venturi,3911,1164,44,43,87,50.6%,4m
3918,1,StrOng,3911,352,9,9,18,50.0%,19m
3918,2,HeLt,3911,208,7,18,25,28.0%,7m
3918,1,Dandrene,3911,76,3,14,17,17.6%,15m
3922,2,[x01]ghalghan,3910,1682,234,224,458,51.1%,7m
3922,2,Jdiez,3910,1592,161,160,321,50.2%,10m
3922,2,Sacatar,3910,677,72,66,138,52.2%,11m
3922,2,[ExCo]Eandro,3910,564,20,17,37,54.1%,14m
3922,1,Cuervo,3910,761,20,21,41,48.8%,3m
3922,3,[dDb]Halalkött,3910,0,0,1,1,0.0%,7m
3922,2,lumi,3910,0,0,1,1,0.0%,34m
3922,1,Macrowave,3910,0,0,2,2,0.0%,4m
3930,2,Karma,3909,1622,204,154,358,57.0%,21m
3930,2,[ЛĐT]Draf,3909,1653,86,62,148,58.1%,20m
3930,2,Despotar,3909,562,21,14,35,60.0%,17m
3930,1,[iX]DERASTAT,3909,613,13,25,38,34.2%,18m
3930,2,MrLingo,3909,70,2,3,5,40.0%,5m
3930,2,[NsuP]HoboStank,3909,0,0,1,1,0.0%,34m
3930,2,[ioStuN]Eddy,3909,0,0,1,1,0.0%,2m
3937,2,[HACHLI]Ignis,3908,791,89,81,170,52.4%,14m
3937,1,[SEBULA]pagan,3908,1158,70,63,133,52.6%,16m
3937,1,Kleidoven,3908,998,43,41,84,51.2%,8m
3937,1,[BBQZ]Husky,3908,480,12,17,29,41.4%,4m
3937,2,IIIIIIIIIIII,3908,174,10,0,10,100.0%,12m
3937,2,[ĦRZ]Algorithm,3908,38,1,2,3,33.3%,5m
3937,2,[Peeps]Gilgamesh,3908,32,1,2,3,33.3%,9m
3937,2,nTla,3908,0,0,2,2,0.0%,34m
3945,2,nel,3907,1207,194,161,355,54.6%,10m
3945,1,[FodZ]Blacktrust,3907,1228,45,49,94,47.9%,13m
3945,2,Longos,3907,601,36,0,36,100.0%,4m
3945,2,IlIlIlIlIlIl,3907,448,20,9,29,69.0%,14m
3945,2,Romanticide,3907,282,13,7,20,65.0%,34m
3945,2,[Hаsu]MAKE,3907,112,4,6,10,40.0%,11m
3945,2,[RIPIP]Crumbelade,3907,0,0,3,3,0.0%,8m
3952,2,Piff,3906,410,16,4,20,80.0%,10m
3952,2,Twentysix,3906,174,7,2,9,77.8%,17m
3952,2,IIIIIIIIIIII,3906,0,0,2,2,0.0%,7m
3955,1,Blinchik,3905,1891,190,185,375,50.7%,9m
3955,2,BlobbyColoss,3905,1666,131,118,249,52.6%,10m
3955,2,ArtemFNG,3905,678,30,19,49,61.2%,12m
3955,1,HeteroHero,3905,549,22,29,51,43.1%,34m
3955,2,Sweetling,3905,386,16,3,19,84.2%,21m
3955,2,Queela,3905,104,3,6,9,33.3%,21m
3955,1,[JAFFE]tonnis,3905,0,2,5,7,28.6%,35m
3955,2,Hitchhiker,3905,0,1,1,2,50.0%,11m
3955,3,Religion,3905,0,0,2,2,0.0%,4m
3964,2,InsAnE,3904,1656,481,445,926,51.9%,21m
3964,2,TheBatman,3904,1613,132,112,244,54.1%,10m
3964,1,IliaGmn,3904,1352,126,129,255,49.4%,19m
3964,1,[TITTIT]ILuvZilina,3904,1028,27,30,57,47.4%,19m
3964,2,thelordC,3904,302,10,11,21,47.6%,12m
3964,2,[PŖïMĄŁ]PhilSpenceR,3904,200,7,5,12,58.3%,13m
3964,2,[STRLAD]Harrizard,3904,38,1,2,3,33.3%,3m
3964,2,Spacefox,3904,0,0,1,1,0.0%,21m
3972,1,SecretName,3903,841,41,24,65,63.1%,16m
3972,1,[hufter]Luxus,3903,677,16,19,35,45.7%,10m
3972,1,JauneD,3903,496,11,15,26,42.3%,12m
3972,3,[Worms]Yellowman,3903,127,4,0,4,100.0%,5m
3972,2,Geo,3903,32,2,1,3,66.7%,20m
3977,1,[Ǽ1]Ferdia,3902,1180,231,226,457,50.5%,13m
3977,2,Triss,3902,435,68,24,92,73.9%,5m
3977,2,Goshater,3902,471,42,28,70,60.0%,34m
3977,1,[NMSQ]Serafit,3902,1262,35,40,75,46.7%,16m
3977,2,Víðarr,3902,514,17,15,32,53.1%,18m
3977,3,IIIIIIIIIIII,3902,0,4,3,7,57.1%,13m
3977,3,MystiH,3902,58,2,10,12,16.7%,9m
3977,2,TMT,3902,0,1,0,1,100.0%,14m
3977,2,bbqsauce,3902,30,1,4,5,20.0%,2m
3986,2,[ÆR]Shiro,3901,1668,85,71,156,54.5%,21m
3986,2,[lOoKer]DrAxelroose,3901,928,76,68,144,52.8%,12m
3986,2,Mellgren,3901,322,10,9,19,52.6%,17m
3986,1,[IceHus]IceRai,3901,184,5,8,13,38.5%,16m
3986,2,[GDA]Yoyomec,3901,0,0,1,1,0.0%,10m
3991,1,Soothsayer,3900,1896,115,107,222,51.8%,19m
3991,2,DuTuMirNix,3900,1341,58,36,94,61.7%,13m
3991,2,FergusBolter,3900,919,55,9,64,85.9%,21m
3991,1,stormwingz,3900,1672,54,48,102,52.9%,12m
3991,2,[DgPx]WoXii,3900,1226,53,37,90,58.9%,12m
3991,1,Musan,3900,661,19,24,43,44.2%,3m
3991,1,Toastbrot,3900,666,17,16,33,51.5%,10m
3991,2,Blackflash,3900,134,5,7,12,41.7%,8m
3991,2,[HBGS]OliVer,3900,34,2,0,2,100.0%,21m
3991,1,yomaan,3900,46,2,6,8,25.0%,16m
3991,2,[GL]GLNoticimus,3900,0,1,0,1,100.0%,18m
3991,2,[TGCrew]Evilkruemel,3900,38,1,4,5,20.0%,10m
4003,2,GreenWolf,3899,769,58,56,114,50.9%,14m
4003,1,[II]PixieDust,3899,1011,37,39,76,48.7%,12m
4005,1,KenKaneki,3898,1983,203,215,418,48.6%,34m
4005,1,Bittersweet,3898,1971,160,138,298,53.7%,16m
4005,1,IIIIIIIIIIII,3898,1654,120,98,218,55.0%,9m
4005,1,[AoTu]ZerO,3898,182,5,11,16,31.2%,16m
4005,2,[mGET]sHun,3898,0,0,3,3,0.0%,2m
4010,1,Prinf,3897,1886,352,320,672,52.4%,4m
4010,2,Tetra,3897,705,62,60,122,50.8%,11m
4012,2,VasMik,3896,1673,340,315,655,51.9%,10m
4012,1,[osHero]ØutøfÇôntrôl,3896,1960,96,98,194,49.5%,12m
4012,1,höllenforsch,3896,1053,27,42,69,39.1%,21m
4012,2,Qoo,3896,346,21,16,37,56.8%,10m
4012,2,[Hаsu]Chipcilinkaa,3896,430,15,8,23,65.2%,4m
4012,3,MipZero,3896,0,3,2,5,60.0%,7m
4012,2,xGMTx,3896,0,0,5,5,0.0%,8m
4019,1,Waffen,3895,1960,216,190,406,53.2%,19m
4019,1,Rix,3895,1891,98,93,191,51.3%,5m
4019,2,Cheedhead,3895,721,63,51,114,55.3%,9m
4019,1,sammuelmumm,3895,374,9,21,30,30.0%,15m
4019,2,Rumshack,3895,166,6,4,10,60.0%,34m
4019,3,ANGEL,3895,121,5,2,7,71.4%,13m
4019,2,luxovac,3895,0,0,4,4,0.0%,11m
4026,1,yondai,3894,1945,201,193,394,51.0%,12m
4026,1,Ben,3894,1947,131,128,259,50.6%,12m
4026,2,SleepyLappy,3894,172,8,6,14,57.1%,20m
4026,2,[MACLUL]Papayapapst,3894,40,2,0,2,100.0%,17m
4026,2,GatewayMan,3894,39,2,4,6,33.3%,8m
4026,2,[sbNDR]sim,3894,0,1,1,2,50.0%,14m
4032,3,[SeBa]ClaytonBixbi,3893,1854,264,291,555,47.6%,20m
4032,2,SpravnakDan,3893,1642,235,231,466,50.4%,12m
4032,1,[BBFH]PinTo,3893,934,33,38,71,46.5%,7m
4032,3,Shogun,3893,97,2,0,2,100.0%,13m
4032,3,[Flammy]IceWorLd,3893,0,0,1,1,0.0%,17m
4037,2,[Arrows]DarKKnightSC,3892,402,13,12,25,52.0%,11m
4037,2,Brummund,3892,68,3,4,7,42.9%,10m
4037,2,[PaniC]Cyberdemon,3892,40,2,0,2,100.0%,14m
4037,1,[isMVP]sergyo,3892,94,2,8,10,20.0%,11m
4037,2,[FGnius]toyoy,3892,0,1,0,1,100.0%,2m
4042,2,MrTwiISTeR,3891,144,4,6,10,40.0%,9m
4042,1,Vortex,3891,0,0,5,5,0.0%,15m
4044,1,Jerr,3890,1234,33,37,70,47.1%,34m
4044,2,Gvenivar,3890,449,16,9,25,64.0%,20m
4044,2,deama,3890,106,3,5,8,37.5%,7m
4044,2,Awesometa,3890,0,1,0,1,100.0%,18m
4048,2,LeNNoN,3889,590,22,16,38,57.9%,9m
4048,2,[CØG]skyter,3889,304,9,11,20,45.0%,12m
4048,2,[GP]Terric,3889,196,7,8,15,46.7%,18m
4048,2,[zzzzup]ChaosMind,3889,66,2,6,8,25.0%,18m
4052,2,KillingSpree,3888,1619,104,105,209,49.8%,8m
4052,2,[ba5ic]IIIbarCODEII,3888,1289,56,41,97,57.7%,17m
4052,1,Kotvič,3888,890,34,33,67,50.7%,5m
4052,2,olbas,3888,733,31,19,50,62.0%,5m
4052,2,Fredde,3888,302,11,7,18,61.1%,14m
4052,2,AboryM,3888,310,10,11,21,47.6%,4m
4052,2,VaultOne,3888,144,4,0,4,100.0%,11m
4052,2,[ISSGI]TheDarkneSS,3888,108,3,3,6,50.0%,12m
4052,2,Zaxon,3888,0,0,1,1,0.0%,2m
4061,1,LiptonMobile,3887,943,148,133,281,52.7%,10m
4061,1,Sparayr,3887,786,32,29,61,52.5%,21m
4061,2,Twentyfive,3887,462,18,6,24,75.0%,11m
4061,3,JeesusLoves,3887,218,11,2,13,84.6%,35m
4061,1,[ArGGEU]AnySoSex,3887,472,11,14,25,44.0%,13m
4061,2,[DMøøn]AZTEX,3887,34,2,0,2,100.0%,14m
4061,2,Timeout,3887,38,2,3,5,40.0%,12m
4061,2,ChillmA,3887,0,0,1,1,0.0%,16m
4061,2,samurai,3887,0,0,1,1,0.0%,34m
4061,2,[ZelO]iro,3887,0,0,1,1,0.0%,34m
4071,2,Sun,3886,1094,125,107,232,53.9%,18m
4071,1,[B3AST]ALIEN,3886,1550,45,52,97,46.4%,5m
4071,1,[lMMl]anttsi,3886,838,22,28,50,44.0%,16m
4071,1,sneiz,3886,642,16,21,37,43.2%,13m
4071,2,IIIIIIIIIIII,3886,246,10,3,13,76.9%,2m
4071,2,DPX,3886,252,9,5,14,64.3%,34m
4071,2,[5623]skystar,3886,232,9,6,15,60.0%,5m
4071,2,Sylthar,3886,138,8,0,8,100.0%,20m
4071,1,[Oursbl]Kubera,3886,0,5,2,7,71.4%,5m
4071,2,Arblash,3886,130,4,6,10,40.0%,2m
4081,1,[BBOY]Kvarc,3885,619,21,23,44,47.7%,11m
4081,2,MrBeck,3885,244,7,11,18,38.9%,13m
4081,2,dasdwas,3885,0,1,0,1,100.0%,11m
4081,2,[zadek]Morleg,3885,0,0,1,1,0.0%,18m
4085,1,[IceHus]Ivashization,3884,1484,216,193,409,52.8%,16m
4085,1,defouy,3884,1764,206,186,392,52.6%,35m
4085,2,UniT,3884,1672,166,159,325,51.1%,34m
4085,2,MrSasha,3884,254,9,6,15,60.0%,34m
4085,1,GeparDinho,3884,282,9,10,19,47.4%,12m
4085,2,KoTeYkA,3884,0,0,1,1,0.0%,10m
4091,1,[lCXl]JoyBoy,3883,1374,67,52,119,56.3%,5m
4091,2,DirkGently,3883,468,21,9,30,70.0%,4m
4091,1,[Wolven]EmirKaon,3883,718,19,22,41,46.3%,21m
4091,1,Edelscott,3883,276,7,13,20,35.0%,16m
4091,2,[ZЕRGML]HobBit,3883,0,0,1,1,0.0%,16m
4096,1,DeathAndPain,3882,1942,280,280,560,50.0%,20m
4096,1,DJAY,3882,1581,128,119,247,51.8%,12m
4096,2,Zeddzzz,3882,834,39,38,77,50.6%,2m
4096,3,Bartholomaus,3882,0,1,0,1,100.0%,34m
4096,2,[BHC]Killbone,3882,0,0,1,1,0.0%,5m
4101,1,Quirinus,3881,1611,100,77,177,56.5%,5m
4101,2,IIIIIIIIIIII,3881,0,1,0,1,100.0%,14m
4101,2,[Pзrsia]RwinAli,3881,0,0,4,4,0.0%,13m
4104,2,[CBTH]dream,3880,1611,71,57,128,55.5%,12m
4104,2,Deneb,3880,633,64,41,105,61.0%,15m
4104,2,Sobota,3880,517,30,15,45,66.7%,34m
4104,2,NewbRevenge,3880,264,8,15,23,34.8%,16m
4104,2,ЛордКиберПес,3880,102,3,5,8,37.5%,12m
4104,2,Pantenol,3880,36,2,0,2,100.0%,9m
4104,2,SnFeeK,3880,36,1,1,2,50.0%,9m
4111,1,Pablo,3879,1006,63,50,113,55.8%,21m
4111,2,JinJaeJeong,3879,342,11,3,14,78.6%,11m
4111,2,Serral,3879,102,4,1,5,80.0%,10m
4111,2,reaper,3879,64,3,3,6,50.0%,2m
4111,3,[3KFC]DrMasl,3879,0,0,4,4,0.0%,20m
4116,2,Leor,3878,730,27,24,51,52.9%,16m
4116,2,Ksyper,3878,334,22,10,32,68.8%,34m
4116,1,quietMADman,3878,532,16,20,36,44.4%,16m
4116,2,aceBatKinG,3878,246,12,3,15,80.0%,13m
4116,2,Textonic,3878,168,6,9,15,40.0%,22m
4116,1,Euridyce,3878,0,4,1,5,80.0%,11m
4116,2,Cielo,3878,32,1,1,2,50.0%,11m
4116,2,IMC,3878,0,1,1,2,50.0%,12m
4116,2,Pablos,3878,0,0,3,3,0.0%,34m
4125,2,[PUDDI]Durstel,3877,1559,134,124,258,51.9%,20m
4125,1,PhAnTøm,3877,1446,112,77,189,59.3%,19m
4125,2,Lililililili,3877,344,16,7,23,69.6%,13m
4125,2,[4Kappa]Yeskis,3877,150,5,3,8,62.5%,21m
4125,2,Czarodziej,3877,108,4,4,8,50.0%,20m
4125,2,IlIlIllI,3877,0,1,1,2,50.0%,9m
4131,1,[ÏnOuY]Spenouh,3876,1053,60,64,124,48.4%,10m
4131,1,byfrost,3876,1319,45,43,88,51.1%,12m
4131,2,boud,3876,316,10,11,21,47.6%,7m
4131,2,Dikower,3876,190,6,5,11,54.5%,5m
4135,1,Doctor,3875,1590,51,72,123,41.5%,13m
4135,1,[2oCG]aGue,3875,413,45,28,73,61.6%,35m
4135,2,KimJongKool,3875,220,11,2,13,84.6%,11m
4135,2,Kiltro,3875,0,0,2,2,0.0%,11m
4139,1,[1qp]AmrAFive,3874,1787,157,119,276,56.9%,9m
4139,3,Dav,3874,1580,148,156,304,48.7%,15m
4139,3,Eternal,3874,209,12,2,14,85.7%,18m
4139,2,[PÂRłAH]robotikov,3874,170,6,7,13,46.2%,12m
4143,2,puresoul,3873,1496,92,74,166,55.4%,12m
4143,1,Brotoss,3873,1345,65,73,138,47.1%,7m
4143,2,[Dzag]Doublepéné,3873,986,37,31,68,54.4%,34m
4143,1,Daniel,3873,671,16,19,35,45.7%,7m
4143,1,[Invǂ]Simple,3873,318,8,16,24,33.3%,12m
4143,2,[OvZeTo]POUTINOSS,3873,0,0,1,1,0.0%,18m
4143,2,OffRizer,3873,0,0,2,2,0.0%,11m
4150,2,Ipe,3872,1624,146,134,280,52.1%,20m
4150,1,PaaT,3872,1833,129,144,273,47.3%,5m
4150,1,[lMMl]Cenfict,3872,1900,101,99,200,50.5%,11m
4150,1,SugMadic,3872,934,23,29,52,44.2%,20m
4150,2,[Qutas]Ekier,3872,326,20,18,38,52.6%,10m
4150,1,twojstara,3872,314,13,7,20,65.0%,19m
4150,1,SentryKing,3872,358,7,13,20,35.0%,12m
4150,2,[Hаsu]Hutt,3872,0,0,5,5,0.0%,6m
4158,2,ChAngaChOice,3871,1656,225,206,431,52.2%,4m
4158,2,[Heroes]Konioo,3871,1402,106,75,181,58.6%,11m
4158,1,Vorck,3871,1521,69,81,150,46.0%,3m
4158,1,[PLA2N]Zerash,3871,1080,50,51,101,49.5%,16m
4158,1,PrimeMarine,3871,1458,48,49,97,49.5%,15m
4158,1,[Cannоn]RoadToDako,3871,1166,32,34,66,48.5%,13m
4158,2,Tugge,3871,620,21,22,43,48.8%,12m
4158,2,[P2T]PapaDavII,3871,0,0,1,1,0.0%,34m
4166,2,orckage,3870,1530,101,95,196,51.5%,35m
4166,1,[GP]Cyanide,3870,645,23,24,47,48.9%,18m
4166,2,OZero,3870,578,20,19,39,51.3%,34m
4166,2,vvg,3870,170,5,7,12,41.7%,12m
4166,3,[сSсǃ]skymaybe,3870,0,0,2,2,0.0%,6m
4171,2,Muhanchik,3869,1604,110,110,220,50.0%,10m
4171,2,Olive,3869,34,2,2,4,50.0%,19m
4171,2,Awero,3869,36,1,2,3,33.3%,12m
4174,2,[ValidG]snusmumriken,3868,1397,160,138,298,53.7%,15m
4174,1,[BeSC]wignode,3868,1437,117,110,227,51.5%,13m
4174,2,[LifeS]ÐÎÁßØŁÎČÀ,3868,1015,114,4,118,96.6%,4m
4174,2,KipyaLarva,3868,273,14,3,17,82.4%,19m
4174,1,Farnoér,3868,230,6,9,15,40.0%,16m
4174,3,KuroMage,3868,94,4,3,7,57.1%,4m
4174,3,[SCTR]BobToss,3868,0,1,0,1,100.0%,12m
4181,2,Mihalich,3867,326,14,5,19,73.7%,20m
4181,2,[Hаsu]Karaks,3867,396,14,17,31,45.2%,34m
4181,2,Byaka,3867,122,5,5,10,50.0%,12m
4181,2,Shizanu,3867,58,2,4,6,33.3%,34m
4181,3,Saint,3867,0,1,0,1,100.0%,3m
4186,2,TimeLord,3866,1674,187,159,346,54.0%,17m
4186,2,wasabi,3866,1573,129,115,244,52.9%,22m
4186,2,[0Head]SmurfGranate,3866,1400,63,41,104,60.6%,3m
4186,1,Rocky,3866,1654,60,67,127,47.2%,5m
4186,2,Misato,3866,340,12,7,19,63.2%,15m
4186,2,Gratraf,3866,192,7,4,11,63.6%,3m
4186,2,Summer,3866,0,0,2,2,0.0%,12m
4193,2,[Hybr1d]ADG,3865,336,12,10,22,54.5%,20m
4193,2,[InitRu]Artanis,3865,97,9,10,19,47.4%,34m
4193,2,[GCeva]Firestorm,3865,0,0,1,1,0.0%,12m
4193,2,Holykolya,3865,0,0,2,2,0.0%,12m
4197,2,[FGSFDW]Rimak,3864,469,77,64,141,54.6%,2m
4197,2,Maseltov,3864,361,25,13,38,65.8%,35m
4197,2,VeRvE,3864,514,24,12,36,66.7%,9m
4197,1,[aW]Ƨmurƒ,3864,744,17,26,43,39.5%,35m
4197,2,Matys,3864,348,11,15,26,42.3%,12m
4197,2,[TWO]Quant,3864,34,2,2,4,50.0%,12m
4197,2,Zetter,3864,32,1,2,3,33.3%,22m
4197,2,SunRise,3864,0,0,1,1,0.0%,20m
4205,1,[XiSPoo]Lockdown,3863,1864,145,140,285,50.9%,16m
4205,2,[tMnrd]Toffee,3863,1290,120,115,235,51.1%,18m
4205,1,Myta,3863,1703,83,78,161,51.6%,21m
4205,1,Andrius,3863,1019,58,59,117,49.6%,17m
4205,2,Quicktum,3863,499,18,15,33,54.5%,35m
4205,2,WhatDoUWant,3863,90,4,2,6,66.7%,10m
4205,2,YourHope,3863,0,0,1,1,0.0%,12m
4212,1,[DonaId]Trump,3862,1441,117,107,224,52.2%,18m
4212,2,KrusTDisharg,3862,803,40,16,56,71.4%,18m
4212,2,Demosthenes,3862,506,19,15,34,55.9%,21m
4212,1,[IceHus]Anihilation,3862,513,16,14,30,53.3%,5m
4212,2,TheAcordeon,3862,226,9,3,12,75.0%,13m
4212,2,PINatA,3862,30,2,1,3,66.7%,20m
4212,2,Hop,3862,30,2,4,6,33.3%,19m
4212,2,Crawshayi,3862,0,0,2,2,0.0%,8m
4220,2,PaTiTePaNey,3861,1089,47,25,72,65.3%,18m
4220,2,ACUSTIC,3861,356,12,11,23,52.2%,9m
4220,1,Westopoli,3861,382,10,11,21,47.6%,5m
4220,2,[axis]Veracja,3861,66,2,2,4,50.0%,18m
4220,2,yukiteru,3861,34,2,3,5,40.0%,2m
4220,2,[MOTF]KyMaH,3861,0,0,2,2,0.0%,20m
4220,2,leonako,3861,0,0,2,2,0.0%,3m
4227,1,[SoloGG]SCDUDE,3860,1937,342,328,670,51.0%,20m
4227,1,HErMi,3860,1828,322,309,631,51.0%,5m
4227,1,IAmSoNoo,3860,1185,61,34,95,64.2%,19m
4227,2,[aW]ZphiR,3860,1262,53,37,90,58.9%,20m
4227,2,Elorasa,3860,1164,49,30,79,62.0%,22m
4227,1,ZeeLow,3860,1001,28,31,59,47.5%,17m
4227,3,Oleg,3860,4,27,52,79,34.2%,12m
4227,2,IIIIIIIIIIII,3860,348,13,9,22,59.1%,6m
4227,2,Louisss,3860,250,9,9,18,50.0%,14m
4227,2,[αX]Onigami,3860,32,2,0,2,100.0%,6m
4227,2,Nukular,3860,36,2,3,5,40.0%,12m
4238,1,OBITEN,3859,1641,72,77,149,48.3%,10m
4238,2,[BotN]CptPolarBear,3859,196,7,9,16,43.8%,8m
4238,2,Tryptamine,3859,96,3,6,9,33.3%,34m
4238,2,salah,3859,32,2,2,4,50.0%,11m
4238,3,IIIIIIIIIIII,3859,0,2,5,7,28.6%,12m
4238,2,Mikhail,3859,34,1,3,4,25.0%,9m
4244,2,OhRIP,3858,928,69,35,104,66.3%,18m
4244,1,Rizzoli,3858,962,25,31,56,44.6%,5m
4244,2,Potet,3858,178,6,4,10,60.0%,35m
4244,3,DeeL,3858,0,0,8,8,0.0%,8m
4248,2,[Niavir]maskmarat,3857,1666,171,152,323,52.9%,18m
4248,2,[VFN]TrialTerror,3857,282,21,18,39,53.8%,8m
4248,1,[MuE]Creepy,3857,302,7,15,22,31.8%,34m
4248,1,[cl0udM]TOXiCiTY,3857,274,6,14,20,30.0%,5m
4248,2,[biglol]marvel,3857,144,5,6,11,45.5%,12m
4248,2,Xafire,3857,0,0,1,1,0.0%,18m
4254,2,[MSUSC2]Belgan,3856,376,13,11,24,54.2%,10m
4254,2,JAZZY,3856,382,13,13,26,50.0%,15m
4254,2,[Heet]assnibbler,3856,166,6,1,7,85.7%,34m
4254,1,Venturo,3856,46,4,5,9,44.4%,9m
4254,2,JSK,3856,96,3,5,8,37.5%,5m
4254,2,[ZЕRGML]Slava,3856,62,2,2,4,50.0%,2m
4260,1,Moufle,3855,1934,224,212,436,51.4%,5m
4260,1,Defunt,3855,1530,94,77,171,55.0%,9m
4260,2,SBreach,3855,1491,81,78,159,50.9%,12m
4260,2,[MSII]IronMaik,3855,83,4,3,7,57.1%,7m
4260,2,Rasi,3855,102,4,5,9,44.4%,7m
4260,2,FallnServant,3855,32,1,2,3,33.3%,19m
4266,1,blackalfa,3854,1920,368,369,737,49.9%,12m
4266,2,Pingvinyashk,3854,432,16,9,25,64.0%,18m
4266,2,єМагвітер,3854,134,4,7,11,36.4%,12m
4266,2,[teamZP]ULTRA,3854,0,1,0,1,100.0%,13m
4266,1,Noctali,3854,0,1,0,1,100.0%,13m
4271,1,[ExTr1m]ERRORЗOЗ,3853,1911,300,284,584,51.4%,4m
4271,1,Valgard,3853,1916,168,178,346,48.6%,13m
4271,2,leberkasPepe,3853,1359,64,66,130,49.2%,10m
4271,2,[ZERGML]QWERTY,3853,920,33,33,66,50.0%,8m
4271,2,[PAUKI]poher,3853,306,12,6,18,66.7%,34m
4271,1,TeddyBear,3853,419,12,15,27,44.4%,16m
4271,3,NoReason,3853,60,2,9,11,18.2%,15m
4278,1,Stefan,3852,1965,103,127,230,44.8%,9m
4278,2,KaLLaSH,3852,1002,36,36,72,50.0%,10m
4278,2,[AKCK]WannaFly,3852,230,8,7,15,53.3%,20m
4278,2,[0Dfeat]Probe,3852,98,3,6,9,33.3%,35m
4278,1,[Deezer]SpK,3852,90,2,9,11,18.2%,20m
4278,1,Bear,3852,48,1,5,6,16.7%,19m
4278,3,[nB]MekTypro,3852,0,0,1,1,0.0%,17m
4285,1,Niamor,3851,1862,387,398,785,49.3%,10m
4285,2,Rin,3851,362,15,10,25,60.0%,34m
4285,2,GgMachineSC,3851,180,6,3,9,66.7%,10m
4285,2,EpicBattle,3851,0,1,0,1,100.0%,19m
4285,2,CannonRushxx,3851,0,0,2,2,0.0%,9m
4290,1,WilDFiRe,3850,1637,53,61,114,46.5%,20m
4290,1,Ithor,3850,377,13,14,27,48.1%,9m
4290,3,DrKobra,3850,195,6,3,9,66.7%,18m
4290,2,[Youth]Hyperstorm,3850,0,0,3,3,0.0%,35m
4294,2,Doug,3849,328,16,7,23,69.6%,21m
4294,2,BLEE,3849,116,5,2,7,71.4%,9m
4294,2,Misanthrope,3849,82,4,4,8,50.0%,12m
4297,1,MySTiK,3848,1194,52,46,98,53.1%,21m
4297,2,УЭБиПК,3848,272,10,8,18,55.6%,13m
4297,2,[ƔƟƪƟ]illmatic,3848,92,4,0,4,100.0%,12m
4297,1,[QMnewb]FiveSZ,3848,48,2,2,4,50.0%,9m
4297,3,YFC,3848,0,0,1,1,0.0%,19m
4302,2,FIIAClick,3847,1340,170,167,337,50.4%,12m
4302,2,[WBO]Parabelitano,3847,408,16,5,21,76.2%,12m
4302,2,Xaaros,3847,164,6,4,10,60.0%,35m
4305,2,Zéphir,3846,1274,73,48,121,60.3%,18m
4305,1,[MSUSC2]SeresHotes,3846,1239,47,40,87,54.0%,21m
4305,2,ПихалМихалы,3846,445,32,21,53,60.4%,35m
4305,2,Ethereal,3846,511,18,15,33,54.5%,18m
4305,2,Toku,3846,150,6,5,11,54.5%,12m
4305,2,llllllllllll,3846,73,1,6,7,14.3%,19m
4305,2,maffia,3846,0,0,2,2,0.0%,10m
4312,2,[XNTC]net,3845,1476,60,57,117,51.3%,9m
4312,1,[LeUcHt]InvaderZ,3845,1165,45,41,86,52.3%,17m
4312,2,[WBO]iLu,3845,846,32,30,62,51.6%,34m
4312,2,Svirus,3845,864,31,31,62,50.0%,35m
4312,2,[InBri]AlGor,3845,264,8,11,19,42.1%,34m
4312,2,TerranOP,3845,172,6,8,14,42.9%,17m
4312,2,[3Dǃ]ƎDǃBee,3845,116,5,0,5,100.0%,10m
4312,2,Balduran,3845,60,2,1,3,66.7%,34m
4312,2,[4KROOT]misery,3845,40,2,5,7,28.6%,34m
4312,2,[Colony]MacGyver,3845,0,0,1,1,0.0%,20m
4312,2,[MkersA]warchief,3845,0,0,1,1,0.0%,18m
4323,1,Bingo,3844,1676,312,317,629,49.6%,34m
4323,2,[HBGSJR]aDago,3844,1212,233,221,454,51.3%,7m
4323,2,[ITrick]Ghaylord,3844,1569,165,167,332,49.7%,2m
4323,1,[xTNGx]Madhouze,3844,660,75,64,139,54.0%,10m
4323,1,TryFather,3844,1781,57,64,121,47.1%,35m
4323,2,SeverusSimp,3844,877,40,19,59,67.8%,14m
4323,2,Mediocretes,3844,132,4,5,9,44.4%,12m
4323,2,[CYC]SooThSayeR,3844,0,0,1,1,0.0%,34m
4331,3,WaitWhat,3843,1411,216,232,448,48.2%,8m
4331,1,FLOSAN,3843,1911,193,180,373,51.7%,4m
4331,1,arvak,3843,1944,135,139,274,49.3%,18m
4331,1,ProdzaaH,3843,880,37,39,76,48.7%,13m
4331,2,Snuffels,3843,722,28,21,49,57.1%,21m
4331,2,Grabbo,3843,66,2,2,4,50.0%,9m
4331,2,dem,3843,0,1,0,1,100.0%,34m
4331,2,TheRealOne,3843,0,1,2,3,33.3%,9m
4331,2,[Ǽ1]Terminator,3843,0,0,1,1,0.0%,21m
4340,2,zup,3842,290,10,13,23,43.5%,21m
4340,2,[PaniC]MarineKing,3842,98,3,7,10,30.0%,10m
4340,2,[NZT48]Tvorets,3842,0,1,0,1,100.0%,20m
4340,2,[DeBobz]DarkZephyro,3842,0,1,3,4,25.0%,2m
4340,3,thisServerEz,3842,0,1,7,8,12.5%,21m
4340,2,[CRAIC]Penta,3842,0,0,1,1,0.0%,5m
4346,2,TRASHfromASH,3841,1625,73,70,143,51.0%,2m
4346,2,[IvD]warbio,3841,1219,57,32,89,64.0%,15m
4346,2,[Heroes]Newton,3841,766,30,20,50,60.0%,15m
4346,2,Carnby,3841,30,1,2,3,33.3%,11m
4346,2,soniCSysteM,3841,0,0,5,5,0.0%,8m
4351,2,[NOKOFF]OldYogurt,3840,1324,127,95,222,57.2%,9m
4351,2,[forceX]lion,3840,1565,98,85,183,53.6%,34m
4351,2,FunkyPants,3840,1571,69,43,112,61.6%,20m
4351,2,Sintelaris,3840,1252,57,51,108,52.8%,12m
4351,2,[BRSKR]Snowy,3840,468,16,15,31,51.6%,35m
4351,2,SolarLair,3840,94,3,2,5,60.0%,9m
4357,1,Randomizer,3839,1891,165,176,341,48.4%,9m
4357,2,Dosia,3839,488,30,16,46,65.2%,10m
4357,2,Mulli,3839,274,18,4,22,81.8%,8m
4357,2,[VB]Sauce,3839,226,8,8,16,50.0%,8m
4357,2,EconDude,3839,128,4,6,10,40.0%,34m
4357,2,[DaAm]balle,3839,143,3,5,8,37.5%,19m
4357,2,Admin,3839,32,2,0,2,100.0%,2m
4357,2,imtoonoob,3839,0,0,2,2,0.0%,17m
4357,2,[Maegis]SherKhan,3839,0,0,3,3,0.0%,4m
4366,2,[улей55]Steelwar,3838,406,15,11,26,57.7%,21m
4366,2,[OoE]JonSnow,3838,0,1,0,1,100.0%,21m
4368,2,[RIIP]Airea,3837,1627,142,137,279,50.9%,34m
4368,2,Ogi,3837,1398,115,102,217,53.0%,16m
4368,2,[FR1]Hurricane,3837,732,26,26,52,50.0%,14m
4368,2,[LOU69]Skywatcher,3837,275,18,11,29,62.1%,10m
4368,1,Bomzj,3837,498,13,15,28,46.4%,8m
4368,2,[Galois]DocSnyder,3837,220,9,6,15,60.0%,12m
4368,1,stormy,3837,97,3,0,3,100.0%,3m
4368,2,Hemosu,3837,0,2,2,4,50.0%,18m
4368,2,heavyiron,3837,0,0,1,1,0.0%,3m
4377,1,GGWellplayed,3836,720,45,50,95,47.4%,16m
4377,2,[skh]DownForce,3836,1038,40,35,75,53.3%,20m
4377,2,[H0M0S]waltheri,3836,482,16,20,36,44.4%,8m
4377,2,Pyroman,3836,34,1,1,2,50.0%,6m
4381,1,vasea,3835,1897,342,341,683,50.1%,15m
4381,1,[rаGe]Lynxovat,3835,1811,157,151,308,51.0%,17m
4381,1,ELCID,3835,1933,117,125,242,48.3%,16m
4381,2,MagicPancake,3835,735,34,17,51,66.7%,11m
4381,2,BuildtheWall,3835,30,6,0,6,100.0%,13m
4386,2,Klawer,3834,1475,181,184,365,49.6%,34m
4386,2,Stickeyd,3834,571,98,82,180,54.4%,16m
4386,1,Serla,3834,622,29,18,47,61.7%,12m
4386,2,llllllllllll,3834,426,14,12,26,53.8%,35m
4386,2,Barristan,3834,210,11,2,13,84.6%,34m
4386,2,[ÖRRR]Whaittis,3834,0,1,0,1,100.0%,20m
4386,2,[BBSC2]extremboy,3834,0,1,0,1,100.0%,5m
4386,3,[UATeam]kwaigon,3834,0,0,1,1,0.0%,8m
4394,2,Deex,3833,1596,117,114,231,50.6%,5m
4394,2,Romio,3833,1163,47,40,87,54.0%,34m
4394,2,[WАSD]MadMax,3833,410,13,17,30,43.3%,34m
4394,2,WhiteRabbit,3833,208,7,13,20,35.0%,20m
4394,2,Valderan,3833,0,0,2,2,0.0%,9m
4399,2,maro,3832,1621,326,278,604,54.0%,22m
4399,2,WilliamLPns,3832,1632,173,166,339,51.0%,11m
4399,1,iGGyRush,3832,1796,89,91,180,49.4%,35m
4399,2,Thugsta,3832,1038,72,68,140,51.4%,17m
4399,2,eeevnsun,3832,584,36,29,65,55.4%,35m
4399,2,[59APM]Djaube,3832,572,23,13,36,63.9%,35m
4399,2,rekt,3832,142,8,0,8,100.0%,34m
4399,2,Xabibulin,3832,162,5,3,8,62.5%,12m
4399,2,Guinness,3832,0,1,2,3,33.3%,9m
4399,2,[Petrus]BAKI,3832,0,0,1,1,0.0%,34m
4409,2,[SaviOr]GhostMaster,3831,988,46,30,76,60.5%,8m
4409,2,Scatrex,3831,600,22,19,41,53.7%,22m
4409,2,[BaneOP]onesectoaiur,3831,406,14,13,27,51.9%,8m
4409,3,xela,3831,144,8,0,8,100.0%,4m
4409,2,[HGay]Dnopy,3831,72,2,6,8,25.0%,7m
4409,2,[T4E]hope,3831,0,0,1,1,0.0%,34m
4415,2,[Khala]ChuckNorris,3830,1617,107,102,209,51.2%,34m
4415,2,naniHug,3830,652,33,9,42,78.6%,12m
4415,2,[AciNoN]TwilightZeRR,3830,420,14,15,29,48.3%,18m
4415,2,VoidRay,3830,335,13,16,29,44.8%,34m
4415,1,BlackAnubis,3830,224,5,17,22,22.7%,35m
4415,3,QWERTYUIOP,3830,121,4,4,8,50.0%,7m
4415,2,Prometheus,3830,84,3,1,4,75.0%,4m
4422,2,Nikrosk,3829,1354,74,65,139,53.2%,6m
4422,1,TheDuke,3829,1453,46,70,116,39.7%,19m
4422,2,[НОД17]Offside,3829,784,34,24,58,58.6%,21m
4422,2,THEKraSH,3829,718,26,25,51,51.0%,4m
4422,2,[NMSQ]FaJeReDDDDDD,3829,176,7,3,10,70.0%,13m
4422,2,ShaggyKiwi,3829,60,3,1,4,75.0%,11m
4422,2,JimmyRecard,3829,0,1,0,1,100.0%,2m
4422,2,Jascaw,3829,0,1,1,2,50.0%,18m
4422,3,ArtPlay,3829,0,1,1,2,50.0%,20m
4422,2,easyAI,3829,36,1,2,3,33.3%,2m
4432,1,[H0C]SCSrbija,3828,993,25,30,55,45.5%,21m
4432,1,pizzaYOLO,3828,605,20,27,47,42.6%,12m
4432,2,[CJFF]Jasper,3828,0,0,1,1,0.0%,21m
4435,1,RageKing,3827,1873,262,249,511,51.3%,11m
4435,2,llllllllllll,3827,894,35,35,70,50.0%,17m
4435,2,uberluberl,3827,812,28,33,61,45.9%,13m
4435,2,Esquire,3827,310,15,6,21,71.4%,15m
4435,2,Chimp,3827,291,13,6,19,68.4%,21m
4435,3,EmpireKas,3827,0,1,0,1,100.0%,35m
4435,2,sDanTheMan,3827,30,1,2,3,33.3%,19m
4435,2,PtiCornichon,3827,34,1,2,3,33.3%,10m
4435,2,Skrinki,3827,30,1,2,3,33.3%,4m
4435,1,Immortal,3827,44,1,10,11,9.1%,19m
4445,2,BoBiNoU,3826,553,126,122,248,50.8%,8m
4445,1,EllenPage,3826,1823,101,113,214,47.2%,5m
4445,2,IIIIIIIIIIII,3826,136,8,0,8,100.0%,13m
4445,1,NanoW,3826,358,8,18,26,30.8%,15m
4445,2,[BxFǂ]Harròck,3826,30,2,1,3,66.7%,10m
4450,2,zeratul,3825,1009,36,40,76,47.4%,18m
4450,3,IIIIIIIIIIII,3825,142,8,0,8,100.0%,10m
4450,2,Remspoor,3825,32,1,1,2,50.0%,17m
4450,2,RabbitSpirit,3825,30,1,4,5,20.0%,11m
4450,1,[KewanK]sayka,3825,0,0,1,1,0.0%,20m
4450,2,Hydra,3825,0,0,1,1,0.0%,10m
4450,2,PoZu,3825,0,0,1,1,0.0%,34m
4450,3,VeniVidiVici,3825,0,0,2,2,0.0%,4m
4458,2,MightyMoon,3824,794,77,57,134,57.5%,6m
4458,1,Merrox,3824,1902,73,83,156,46.8%,34m
4458,3,Kusoge,3824,191,7,1,8,87.5%,5m
4458,2,[pEYn1s]TheWalkingD,3824,0,0,1,1,0.0%,19m
4462,2,ButterBalls,3823,1635,140,99,239,58.6%,34m
4462,2,Random,3823,706,31,18,49,63.3%,2m
4462,2,lWorstGodl,3823,562,25,9,34,73.5%,34m
4462,2,Quib,3823,456,16,17,33,48.5%,20m
4462,2,THERIPPER,3823,118,4,5,9,44.4%,34m
4462,3,ProstyProtos,3823,58,3,1,4,75.0%,13m
4462,2,[ZЕRG7V]SlayFen,3823,36,2,1,3,66.7%,34m
4462,2,Goplit,3823,0,0,1,1,0.0%,14m
4470,1,Vencundo,3822,1906,232,226,458,50.7%,13m
4470,2,FlowerCat,3822,616,40,26,66,60.6%,12m
4470,2,KiteU,3822,920,38,26,64,59.4%,18m
4470,2,kuris,3822,32,2,3,5,40.0%,13m
4470,2,AKIMITSU,3822,0,0,1,1,0.0%,4m
4470,2,[TkeFiv]Darkfix,3822,0,0,2,2,0.0%,35m
4476,2,ReeeaaL,3821,1581,171,161,332,51.5%,11m
4476,2,Emma,3821,1048,41,30,71,57.7%,12m
4476,2,privacyAnnul,3821,890,34,33,67,50.7%,22m
4476,2,Helpmebbq,3821,380,14,10,24,58.3%,18m
4476,3,llllllllllll,3821,210,10,1,11,90.9%,18m
4481,1,ascgert,3820,1838,559,518,1077,51.9%,21m
4481,1,[4EM]adermake,3820,1102,36,50,86,41.9%,13m
4481,2,[Lambro]IBA,3820,713,29,17,46,63.0%,12m
4481,3,[SxOxM]iLoveVicky,3820,291,11,8,19,57.9%,4m
4481,2,[LMBD]llllllllllll,3820,229,8,13,21,38.1%,4m
4481,3,WolfSazen,3820,86,4,0,4,100.0%,16m
4481,3,dolan,3820,0,1,0,1,100.0%,15m
4481,3,Fedak,3820,0,0,4,4,0.0%,8m
4489,1,[Th3l]wylke,3819,1588,87,79,166,52.4%,16m
4489,1,[TaNt3]Patinator,3819,1504,72,79,151,47.7%,21m
4489,2,Mosaïk,3819,410,33,27,60,55.0%,8m
4489,2,rostoshka,3819,254,8,17,25,32.0%,13m
4489,2,spireet,3819,124,5,6,11,45.5%,17m
4489,2,ImNoOb,3819,0,0,1,1,0.0%,9m
4489,2,[ODGW]FaithlessZ,3819,0,0,1,1,0.0%,34m
4489,1,Appelschrapp,3819,0,0,1,1,0.0%,12m
4497,2,Carcajadas,3818,1091,45,38,83,54.2%,8m
4497,2,[PiGPan]Vaeryu,3818,630,32,29,61,52.5%,8m
4497,1,[Zasshu]Viole,3818,119,7,0,7,100.0%,5m
4497,2,[Hrr]ProtoTeranoz,3818,150,6,4,10,60.0%,9m
4497,2,[YoKai]Innocence,3818,99,5,1,6,83.3%,3m
4497,2,Cute,3818,0,1,3,4,25.0%,7m
4503,1,КОРИЦА,3817,1601,171,181,352,48.6%,19m
4503,2,Gouda,3817,1186,43,45,88,48.9%,21m
4503,2,Grivious,3817,128,4,6,10,40.0%,34m
4506,2,Nukular,3816,1250,54,38,92,58.7%,22m
4506,2,Lokirz,3816,728,29,22,51,56.9%,11m
4506,2,[Tren]Naccer,3816,705,27,21,48,56.2%,9m
4506,1,[Lambro]edominator,3816,182,5,12,17,29.4%,10m
4510,2,MoonLightETA,3815,769,129,132,261,49.4%,6m
4510,1,RuPanther,3815,956,38,26,64,59.4%,19m
4510,2,pingEling,3815,273,22,26,48,45.8%,18m
4510,2,PeterPanda,3815,116,4,4,8,50.0%,13m
4510,3,Penguiner,3815,122,3,4,7,42.9%,11m
4510,1,Hody,3815,138,3,14,17,17.6%,34m
4516,2,deser,3814,1458,240,221,461,52.1%,9m
4516,1,Crayola,3814,1263,85,80,165,51.5%,15m
4516,2,VavanST,3814,1420,61,46,107,57.0%,34m
4516,2,[EWW]ZeoMaxReaL,3814,382,50,48,98,51.0%,12m
4516,2,WaMuu,3814,480,20,12,32,62.5%,19m
4516,2,[Uprise]AaGaM,3814,406,18,14,32,56.2%,10m
4516,2,Lightpro,3814,62,3,3,6,50.0%,5m
4523,1,IIIIIIIIIIII,3813,1925,158,171,329,48.0%,9m
4523,2,calculation,3813,653,25,15,40,62.5%,4m
4523,2,zatic,3813,666,25,20,45,55.6%,12m
4523,3,chrząszcz,3813,174,11,2,13,84.6%,11m
4523,2,CeriSe,3813,230,7,10,17,41.2%,15m
4523,2,[VFN]ZealotGoon,3813,0,1,1,2,50.0%,12m
4523,2,Altair,3813,0,0,1,1,0.0%,11m
4530,2,[HBGSJR]Bayash,3812,1341,68,66,134,50.7%,35m
4530,2,[Gloves]AlexIG,3812,478,22,17,39,56.4%,35m
4530,2,Kojkoloo,3812,346,14,6,20,70.0%,15m
4530,2,meleebuster,3812,167,11,7,18,61.1%,34m
4530,2,Hyoma,3812,248,9,6,15,60.0%,13m
4530,2,KonoDioDa,3812,86,4,1,5,80.0%,13m
4530,2,Xenon,3812,116,4,5,9,44.4%,18m
4530,2,TheGalbenDuc,3812,64,2,6,8,25.0%,12m
4538,1,Pace,3811,918,97,94,191,50.8%,13m
4538,2,IIIIIIIIIIII,3811,246,10,3,13,76.9%,10m
4538,2,BOB,3811,194,6,10,16,37.5%,7m
4538,2,[VSC2]Elegacy,3811,58,3,0,3,100.0%,22m
4538,1,JerryYu,3811,0,3,2,5,60.0%,19m
4543,2,tkillasunris,3810,1574,143,117,260,55.0%,34m
4543,2,[ZERG7V]ЛягушкаЛяга,3810,658,35,18,53,66.0%,12m
4543,2,Евгений,3810,121,5,6,11,45.5%,14m
4543,2,[ĦRZ]Cavemen,3810,30,2,0,2,100.0%,15m
4543,2,[EUDUNK]ByuNoGenic,3810,0,0,1,1,0.0%,35m
4543,2,[AciNoN]Dimon,3810,0,0,1,1,0.0%,9m
4549,2,Gonza,3809,1533,199,171,370,53.8%,18m
4549,2,OptimusDerp,3809,387,65,61,126,51.6%,35m
4549,2,GSXRider,3809,885,39,26,65,60.0%,19m
4549,2,MrNew,3809,566,19,25,44,43.2%,12m
4549,2,[EBEMZ]WarFare,3809,500,18,15,33,54.5%,35m
4549,2,MilkyAlien,3809,456,16,15,31,51.6%,19m
4549,2,[Кyсь]NoSkiLL,3809,368,13,11,24,54.2%,9m
4549,2,Vadim,3809,288,11,4,15,73.3%,4m
4549,2,AbbaOCTO,3809,226,6,8,14,42.9%,13m
4549,2,[HBGSJR]MishaDavay,3809,104,3,11,14,21.4%,18m
4549,1,Interesting,3809,0,2,2,4,50.0%,11m
4549,2,[oniz]Timws,3809,0,1,0,1,100.0%,34m
4549,2,Jaro,3809,34,1,3,4,25.0%,2m
4549,2,[Cuack]SneakyCuack,3809,0,0,1,1,0.0%,14m
4549,2,Medoed,3809,0,0,1,1,0.0%,6m
4549,3,Balrok,3809,0,0,1,1,0.0%,12m
4565,2,mglo,3808,1620,202,166,368,54.9%,2m
4565,2,[PÂRłAH]Tomaso,3808,416,28,24,52,53.8%,14m
4565,2,TheRacha,3808,320,12,7,19,63.2%,8m
4565,3,Fiskmat,3808,97,6,2,8,75.0%,4m
4565,2,DinDjarin,3808,32,2,0,2,100.0%,4m
4565,2,[AISC]Dunmer,3808,0,0,1,1,0.0%,19m
4571,1,[VVing]Name,3807,1931,131,129,260,50.4%,21m
4571,1,[ḾŞ7]Artur,3807,940,48,45,93,51.6%,9m
4571,2,Jan,3807,422,17,10,27,63.0%,13m
4571,3,Stevano,3807,242,12,4,16,75.0%,10m
4571,2,FadMaggot,3807,344,12,5,17,70.6%,19m
4571,2,[iBBQ]MrFluffles,3807,148,6,5,11,54.5%,19m
4571,2,Stig,3807,86,4,0,4,100.0%,9m
4578,1,[DePro]Mackchap,3806,1903,698,725,1423,49.1%,34m
4578,1,Haker,3806,1881,303,306,609,49.8%,10m
4578,1,[nopvp]nopvp,3806,1898,302,286,588,51.4%,9m
4578,2,Claire,3806,938,44,19,63,69.8%,21m
4578,2,[ncotic]Doctor,3806,268,9,9,18,50.0%,12m
4578,2,kikivakrozla,3806,234,8,10,18,44.4%,5m
4578,3,Lucky,3806,209,7,0,7,100.0%,14m
4578,2,Anomaly,3806,142,5,2,7,71.4%,13m
4578,3,Fletch,3806,121,2,1,3,66.7%,34m
4578,3,lIlIlIlIlIlI,3806,121,2,2,4,50.0%,11m
4578,2,JustinBieber,3806,36,1,2,3,33.3%,9m
4578,2,[TheDOH]CombatAnt,3806,0,0,1,1,0.0%,35m
4590,2,[NOW]Colt,3805,534,19,18,37,51.4%,12m
4590,3,Albert,3805,171,4,5,9,44.4%,12m
4590,2,Goubix,3805,60,3,1,4,75.0%,12m
4590,2,Thyrren,3805,0,1,7,8,12.5%,6m
4590,2,BlackRa,3805,30,1,8,9,11.1%,5m
4590,2,Kyle,3805,0,0,1,1,0.0%,18m
4596,2,[Li3]tut,3804,639,45,36,81,55.6%,17m
4596,2,Rafavr,3804,120,4,6,10,40.0%,2m
4596,2,[HP4Fun]Clementine,3804,30,2,0,2,100.0%,34m
4596,2,питбуль,3804,0,1,1,2,50.0%,34m
4596,2,[simon]Simon,3804,0,0,2,2,0.0%,17m
4601,2,pedro,3803,1308,97,100,197,49.2%,3m
4601,2,Patryk,3803,959,50,48,98,51.0%,3m
4601,3,Zekiah,3803,198,21,49,70,30.0%,17m
4601,2,Atlas,3803,452,17,14,31,54.8%,34m
4601,3,Mint,3803,252,12,1,13,92.3%,35m
4601,2,[dumbfu]cheesus,3803,242,8,7,15,53.3%,19m
4601,2,[MD86]AlexeiMD,3803,114,5,2,7,71.4%,18m
4601,2,rzoiFlaming,3803,148,5,4,9,55.6%,20m
4601,3,Ronald,3803,121,4,4,8,50.0%,3m
4610,2,MasterSpark,3802,814,40,23,63,63.5%,18m
4610,2,Fermion,3802,525,22,16,38,57.9%,4m
4610,2,Rio,3802,34,1,2,3,33.3%,11m
4613,1,Zerg,3801,1886,295,304,599,49.2%,18m
4613,2,LeVkO,3801,415,114,115,229,49.8%,10m
4613,2,[aW]Benjalou,3801,1168,74,57,131,56.5%,18m
4613,2,lIllIlIIlIIl,3801,967,57,23,80,71.2%,12m
4613,2,Algous,3801,778,34,18,52,65.4%,13m
4613,2,DinDomino,3801,660,21,26,47,44.7%,34m
4613,1,[PnP]boyboyluV,3801,260,6,16,22,27.3%,12m
4613,2,agExxit,3801,126,5,5,10,50.0%,15m
4613,2,shøker,3801,86,4,0,4,100.0%,34m
4613,3,[EESC]Sego,3801,30,2,6,8,25.0%,35m
4613,2,[PiGPan]FissKael,3801,0,1,0,1,100.0%,4m
4613,2,[PLA2N]Reycer,3801,32,1,1,2,50.0%,13m
4613,1,Manderda,3801,0,0,1,1,0.0%,16m
4626,2,[HBGSJR]Isten,3800,845,36,29,65,55.4%,11m
4626,2,Дымоходец,3800,638,33,34,67,49.3%,21m
4626,2,llllllllllll,3800,718,29,20,49,59.2%,35m
4626,2,[alahak]angelpro,3800,268,9,9,18,50.0%,18m
4626,2,[ICGl]Darkcrosh,3800,208,7,6,13,53.8%,13m
4626,2,Megawayne,3800,58,3,1,4,75.0%,8m
4626,2,IIIIIIIIIIII,3800,92,3,4,7,42.9%,34m
4626,2,[EXC]Devotee,3800,0,1,3,4,25.0%,9m
4626,1,Alivan,3800,0,0,6,6,0.0%,5m
4635,1,FateZero,3799,1720,131,125,256,51.2%,5m
4635,2,Dijkkie,3799,802,30,29,59,50.8%,20m
4635,2,Exoskeleton,3799,406,15,9,24,62.5%,7m
4635,1,kivan,3799,381,12,16,28,42.9%,12m
4635,2,[BMD]Galaxy,3799,170,5,11,16,31.2%,19m
4635,2,pipi,3799,0,1,0,1,100.0%,35m
4641,2,[SPAINs]hzheng,3798,1574,197,185,382,51.6%,3m
4641,2,[сSсǃ]MacroLee,3798,1411,168,148,316,53.2%,4m
4641,2,invictum,3798,897,73,57,130,56.2%,12m
4641,2,speedghOst,3798,462,25,10,35,71.4%,6m
4641,2,lillaDH,3798,60,3,0,3,100.0%,19m
4641,2,Thirst,3798,102,3,2,5,60.0%,34m
4647,2,[UNlTY]SpiriT,3797,792,61,42,103,59.2%,34m
4647,2,[SCBoys]CiRkuS,3797,116,4,2,6,66.7%,34m
4649,2,Nedd,3796,1645,90,80,170,52.9%,17m
4649,2,[RmyA]FsCrooks,3796,1496,58,55,113,51.3%,34m
4649,2,IIIIIIIIIIII,3796,506,23,14,37,62.2%,9m
4649,2,dddmel,3796,380,19,9,28,67.9%,9m
4649,2,[BRUSHT]Aquafresh,3796,210,8,4,12,66.7%,4m
4649,2,[Wø]AǂMitch,3796,97,1,3,4,25.0%,19m
4649,2,Blemo,3796,23,1,4,5,20.0%,13m
4656,1,Edwin,3795,1859,126,127,253,49.8%,21m
4656,1,[FR1]Nicomouk,3795,1605,111,83,194,57.2%,20m
4656,2,[PMMM]Elitar,3795,1005,81,63,144,56.2%,10m
4656,2,CatKat,3795,1012,45,18,63,71.4%,5m
4656,2,[InFy]XRater,3795,648,25,21,46,54.3%,19m
4656,3,Creation,3795,216,11,3,14,78.6%,34m
4656,2,[Bars]FIZik,3795,30,1,1,2,50.0%,34m
4656,2,Nightsorrow,3795,0,1,2,3,33.3%,8m
4656,2,[DN]futternapf,3795,0,0,1,1,0.0%,6m
4665,2,Pyro,3794,1615,405,395,800,50.6%,13m
4665,2,Noobgam,3794,1030,76,54,130,58.5%,35m
4665,2,MonstR,3794,654,24,26,50,48.0%,9m
4665,2,[Lappen]harryharry,3794,308,12,6,18,66.7%,20m
4665,3,[CJKB]kapitanbomba,3794,168,9,1,10,90.0%,12m
4665,2,MattThePie,3794,88,4,1,5,80.0%,4m
4665,2,bonta,3794,0,1,0,1,100.0%,7m
4672,1,Reistry,3793,1483,150,144,294,51.0%,4m
4672,2,KGD,3793,1391,78,45,123,63.4%,35m
4672,2,Nero,3793,90,3,5,8,37.5%,7m
4672,3,BotBeepBeep,3793,30,2,0,2,100.0%,9m
4672,2,MaNnEr,3793,62,2,1,3,66.7%,6m
4672,2,ОЧЕРЕДНЯРА,3793,32,1,1,2,50.0%,21m
4678,2,[EUww1]serega,3792,1563,152,131,283,53.7%,3m
4678,1,[Kelev]Penelope,3792,1746,129,121,250,51.6%,12m
4678,2,AdevodE,3792,667,48,46,94,51.1%,13m
4678,2,Seat,3792,34,1,6,7,14.3%,12m
4682,2,JiMmY,3791,284,9,18,27,33.3%,17m
4682,2,Kakashi,3791,58,7,1,8,87.5%,19m
4682,2,Regis,3791,130,5,4,9,55.6%,5m
4682,2,[Buurmn]Goosebumps,3791,0,1,0,1,100.0%,6m
4686,2,Kagukuk,3790,1631,210,204,414,50.7%,12m
4686,2,November,3790,1615,72,61,133,54.1%,8m
4686,2,Kepp,3790,340,11,14,25,44.0%,9m
4686,2,Zelnaga,3790,30,1,2,3,33.3%,12m
4686,2,SpringBoot,3790,0,0,1,1,0.0%,18m
4691,2,StifleR,3789,1462,56,53,109,51.4%,34m
4691,2,[HsDL]JamZ,3789,230,8,9,17,47.1%,11m
4691,2,Odin,3789,88,4,4,8,50.0%,2m
4694,2,Moon,3788,30,2,0,2,100.0%,14m
4694,2,SchlumpF,3788,0,0,2,2,0.0%,8m
4696,1,[THANOS]IIIBarCodIII,3787,1751,732,726,1458,50.2%,13m
4696,2,[Ttræn]CoolJuhl,3787,1628,186,191,377,49.3%,14m
4696,1,[H0C]Kasapin,3787,752,31,42,73,42.5%,13m
4696,3,Viriato,3787,267,13,5,18,72.2%,20m
4696,2,DaKilah,3787,240,8,13,21,38.1%,12m
4696,2,Bugg,3787,30,2,5,7,28.6%,13m
4696,1,[PÂRłAH]robotikov,3787,0,0,3,3,0.0%,13m
4703,1,[PiGPan]Garethax,3786,1863,168,175,343,49.0%,4m
4703,1,[DutchG]Deliciata,3786,1565,82,94,176,46.6%,5m
4703,2,Gryfox,3786,638,33,32,65,50.8%,13m
4703,1,[0BO]Thaweed,3786,888,22,42,64,34.4%,9m
4703,2,Hiro,3786,310,12,7,19,63.2%,9m
4703,2,Metis,3786,124,5,4,9,55.6%,8m
4703,2,Chickenman,3786,0,1,0,1,100.0%,35m
4703,2,Globby,3786,0,1,1,2,50.0%,4m
4703,2,kndra,3786,0,0,1,1,0.0%,21m
4712,1,OlekStark,3785,1430,58,54,112,51.8%,21m
4712,3,Piff,3785,288,13,5,18,72.2%,15m
4712,2,Atlas,3785,242,9,5,14,64.3%,35m
4712,2,Visiocraft,3785,128,4,5,9,44.4%,14m
4712,2,[UATeam]Athena,3785,0,0,2,2,0.0%,17m
4717,2,[GSSCRY]ХитрыйКраб,3784,1611,170,139,309,55.0%,5m
4717,2,WhiteTiger,3784,1609,101,89,190,53.2%,9m
4717,2,Squirrely,3784,1296,54,41,95,56.8%,21m
4717,2,[Cakes]vestnik,3784,494,20,10,30,66.7%,12m
4717,2,Zerg,3784,0,1,0,1,100.0%,11m
4717,2,ReStartZerg,3784,0,0,1,1,0.0%,8m
4723,1,Shout,3783,1836,94,95,189,49.7%,35m
4723,2,PwningnQQbs,3783,1647,85,65,150,56.7%,20m
4723,2,Thanatos,3783,172,6,3,9,66.7%,9m
4723,2,WassupMan,3783,174,6,5,11,54.5%,19m
4727,3,Exactlyfail,3782,58,3,0,3,100.0%,9m
4727,2,[Castpl]michus,3782,0,1,0,1,100.0%,34m
4727,2,WhereKyfat,3782,0,0,2,2,0.0%,19m
4730,2,Smaug,3781,1616,125,119,244,51.2%,12m
4730,2,[TedB]MisterFicus,3781,1533,96,70,166,57.8%,2m
4730,2,LosLobos,3781,983,69,57,126,54.8%,2m
4730,2,IIIIIIIIII,3781,1256,63,56,119,52.9%,4m
4730,2,KINGKONG,3781,834,31,31,62,50.0%,4m
4730,2,Martin,3781,224,12,13,25,48.0%,12m
4730,2,FALLIN,3781,0,0,1,1,0.0%,34m
4730,2,IIIIIIIIIIII,3781,0,0,1,1,0.0%,4m
4730,2,UltraViolet,3781,0,0,2,2,0.0%,20m
4739,2,Mihail,3780,1610,303,295,598,50.7%,17m
4739,1,irnbro,3780,1878,246,243,489,50.3%,5m
4739,2,[BRSKR]FaiR,3780,1606,229,206,435,52.6%,2m
4739,1,[xCRO]NexuS,3780,1713,131,136,267,49.1%,35m
4739,2,IIIIIIIIIIII,3780,590,28,16,44,63.6%,35m
4739,1,thedamn,3780,934,23,43,66,34.8%,13m
4739,2,RedOctober,3780,254,12,3,15,80.0%,35m
4739,3,HairlineBoss,3780,189,9,1,10,90.0%,7m
4739,2,Elmo,3780,86,4,0,4,100.0%,15m
4739,2,[IceHus]teryagov,3780,94,3,4,7,42.9%,14m
4739,2,[ESWA]MacThanatos,3780,62,2,6,8,25.0%,17m
4750,1,skileet,3779,1461,68,68,136,50.0%,9m
4750,2,[696]Ammelon,3779,817,50,48,98,51.0%,14m
4750,2,[Rüfos]celphy,3779,324,15,7,22,68.2%,12m
4750,2,Twentythree,3779,64,3,0,3,100.0%,35m
4750,2,[MechT]Mason,3779,30,2,0,2,100.0%,19m
4750,2,[PiGPan]erikmaster,3779,30,2,2,4,50.0%,8m
4750,2,Kristofr,3779,0,0,1,1,0.0%,12m
4750,2,Gergi,3779,0,0,1,1,0.0%,10m
4758,2,MrWels,3778,1393,130,102,232,56.0%,4m
4758,2,Etharis,3778,1235,118,105,223,52.9%,5m
4758,2,[NVY]Chips,3778,1581,105,87,192,54.7%,12m
4758,1,aLL,3778,1834,94,94,188,50.0%,35m
4758,1,Elysian,3778,1553,85,78,163,52.1%,16m
4758,2,[Dobro]RubRub,3778,424,17,9,26,65.4%,2m
4758,2,[EV0C]Stefchy,3778,32,2,2,4,50.0%,13m
4758,2,[SOAGA]McTrixy,3778,0,0,1,1,0.0%,19m
4758,2,[PŖïMĄŁ]jabonlagarto,3778,0,0,10,10,0.0%,20m
4767,1,[NIKA]Indiana,3777,1666,286,286,572,50.0%,5m
4767,2,[TAW]DigitZ,3777,953,58,58,116,50.0%,10m
4767,2,Wersi,3777,647,47,42,89,52.8%,11m
4767,1,[EESC]MediamanoEZ,3777,1308,35,53,88,39.8%,16m
4767,2,MiNdReAdEr,3777,337,14,6,20,70.0%,22m
4767,2,RaphaelGonza,3777,88,2,1,3,66.7%,12m
4767,2,[ZERGML]mixsy,3777,32,1,2,3,33.3%,6m
4767,2,AoDöner,3777,0,1,3,4,25.0%,34m
4775,1,[SCSAU]RedEvening,3776,1853,101,121,222,45.5%,14m
4775,2,Guerteltier,3776,1478,69,64,133,51.9%,17m
4775,1,ToTheTop,3776,768,18,29,47,38.3%,5m
4775,2,SixPoolFun,3776,150,9,1,10,90.0%,22m
4775,2,MarineKing,3776,0,1,1,2,50.0%,15m
4775,2,Sołdat,3776,0,1,4,5,20.0%,12m
4775,2,WhiteStone,3776,0,0,5,5,0.0%,22m
4782,2,[ULT1MA]Vandrad,3775,752,30,21,51,58.8%,19m
4782,3,[4EM]Zubr,3775,217,11,3,14,78.6%,5m
4782,3,PorcoPioCane,3775,335,11,8,19,57.9%,8m
4782,3,YUHaveToBMad,3775,0,1,0,1,100.0%,8m
4782,2,[DFgs]ShadowDragon,3775,0,0,1,1,0.0%,35m
4787,1,Sduiliams,3774,1792,186,190,376,49.5%,4m
4787,1,Antoha,3774,1809,167,173,340,49.1%,19m
4787,2,pOpO,3774,1511,107,113,220,48.6%,17m
4787,2,[FYBF]eulerO,3774,744,26,32,58,44.8%,5m
4787,2,Salad,3774,202,11,10,21,52.4%,7m
4787,2,Noname,3774,98,8,5,13,61.5%,35m
4787,2,jeahrait,3774,142,5,2,7,71.4%,9m
4787,2,[Chariz]Oxxus,3774,86,4,0,4,100.0%,6m
4787,2,[boomer]TBone,3774,48,2,2,4,50.0%,19m
4787,2,[EEBÄR]Lichking,3774,30,2,3,5,40.0%,12m
4787,2,[Split]Musa,3774,30,1,2,3,33.3%,8m
4798,2,Bofdunix,3773,860,38,32,70,54.3%,15m
4798,2,UnGemm,3773,452,16,17,33,48.5%,34m
4798,1,[GRUYER]TorShando,3773,398,10,24,34,29.4%,35m
4801,2,Dirkster,3772,1590,207,211,418,49.5%,34m
4801,1,AFA,3772,1743,179,182,361,49.6%,11m
4801,2,OlviC,3772,1286,51,49,100,51.0%,4m
4801,2,Benchmark,3772,755,48,3,51,94.1%,9m
4801,1,Vodkaccount,3772,915,33,36,69,47.8%,14m
4801,2,[BornG]Vlad,3772,322,11,14,25,44.0%,8m
4801,3,[B4D4ss]Arty,3772,30,2,0,2,100.0%,7m
4801,2,[NepXD]CriveN,3772,0,1,0,1,100.0%,5m
4809,2,Howl,3771,1626,97,90,187,51.9%,9m
4809,1,Lemmer,3771,1782,75,82,157,47.8%,12m
4809,2,Dragon,3771,945,48,20,68,70.6%,22m
4809,2,BroNumberOne,3771,459,19,7,26,73.1%,35m
4809,2,[TAW]HenpeT,3771,209,8,5,13,61.5%,14m
4809,2,Dormio,3771,60,3,5,8,37.5%,2m
4809,2,LDH,3771,30,1,4,5,20.0%,11m
4816,2,[ZgEgZ]Starius,3770,996,39,34,73,53.4%,10m
4816,2,RitzenBersi,3770,294,13,10,23,56.5%,4m
4816,2,EndiveCuite,3770,186,10,2,12,83.3%,11m
4816,2,[TeamUR]Ransack,3770,286,10,14,24,41.7%,17m
4816,2,[LawB]maitiky,3770,170,7,5,12,58.3%,34m
4816,2,[BRSKR]Lucasdart,3770,0,5,0,5,100.0%,35m
4816,2,[Coward]Rohan,3770,114,4,2,6,66.7%,14m
4816,2,Argaz,3770,0,3,4,7,42.9%,4m
4816,2,[AiRǂ]PiccoloConte,3770,30,1,3,4,25.0%,35m
4816,2,[VSC]Vespucci,3770,0,0,2,2,0.0%,22m
4826,1,[Arrows]Abaddon,3769,642,37,50,87,42.5%,6m
4826,2,lWorstGodl,3769,530,22,16,38,57.9%,34m
4826,1,HyperNEAT,3769,119,7,0,7,100.0%,5m
4826,2,Rigged,3769,130,5,6,11,45.5%,19m
4826,2,Delawere,3769,30,2,1,3,66.7%,9m
4826,2,Space,3769,0,0,2,2,0.0%,8m
4832,2,[Hybr1d]MasterGhost,3768,1547,177,172,349,50.7%,18m
4832,2,[PŖïMĄŁ]ITPIACENZA,3768,1014,52,24,76,68.4%,15m
4832,2,twarenik,3768,670,27,24,51,52.9%,4m
4832,2,BlackQuartz,3768,152,5,5,10,50.0%,17m
4832,2,SwEetTooTh,3768,30,1,1,2,50.0%,19m
4832,2,[ƮesXG]MästareN,3768,0,0,1,1,0.0%,12m
4838,2,[ShNice]IIIIIIIIIIII,3767,1034,38,39,77,49.4%,10m
4838,2,TrutY,3767,646,31,26,57,54.4%,34m
4838,3,[EZY]ToastAlone,3767,197,10,4,14,71.4%,36m
4838,2,[DandA]Monami,3767,252,9,15,24,37.5%,35m
4838,2,DesChoux,3767,0,1,0,1,100.0%,5m
4838,2,[NikVI]KAPA,3767,0,0,1,1,0.0%,14m
4844,2,mBass,3766,498,121,119,240,50.4%,11m
4844,2,Alien,3766,1430,68,51,119,57.1%,22m
4844,1,Apendix,3766,1487,67,77,144,46.5%,6m
4844,2,ssgta,3766,524,23,17,40,57.5%,19m
4844,2,МаминХулиган,3766,276,14,4,18,77.8%,2m
4844,2,IIIIIIIIIIII,3766,222,9,3,12,75.0%,21m
4844,2,[BACHIR]LieKolchin,3766,60,2,3,5,40.0%,18m
4844,2,Nameless,3766,0,1,0,1,100.0%,18m
4844,2,[Craft]PlayerCraft,3766,0,0,2,2,0.0%,19m
4844,2,Vex,3766,0,0,5,5,0.0%,20m
4854,2,WarDog,3765,1257,146,140,286,51.0%,8m
4854,2,KalergiPlan,3765,1552,109,105,214,50.9%,4m
4854,2,[SCMate]AlexeyZ,3765,919,58,63,121,47.9%,6m
4854,2,burp,3765,116,8,3,11,72.7%,35m
4854,2,Mackensen,3765,60,2,2,4,50.0%,21m
4854,1,BAAAAAAAAANG,3765,0,0,6,6,0.0%,15m
4860,1,[MHACKS]SiliconSlick,3764,1894,216,215,431,50.1%,34m
4860,2,ignispwnz,3764,833,73,67,140,52.1%,2m
4860,2,alexRF,3764,882,36,34,70,51.4%,9m
4860,2,[aslick]Pytmackan,3764,464,23,25,48,47.9%,3m
4860,1,Gothic,3764,546,18,20,38,47.4%,4m
4860,3,WattsPerKilo,3764,231,9,1,10,90.0%,14m
4860,3,XiLo,3764,171,9,3,12,75.0%,21m
4860,2,Aaytowi,3764,216,8,4,12,66.7%,8m
4860,2,[KDV]darnoK,3764,88,4,2,6,66.7%,8m
4860,2,KnegarN,3764,58,2,1,3,66.7%,35m
4870,1,KupaTrupa,3763,1828,70,77,147,47.6%,4m
4870,2,Amerkan,3763,1052,42,35,77,54.5%,20m
4870,2,donRumata,3763,598,34,32,66,51.5%,20m
4870,2,CAOCAO,3763,250,11,5,16,68.8%,13m
4870,2,Clem,3763,252,9,8,17,52.9%,18m
4870,2,ZiHiO,3763,58,5,5,10,50.0%,12m
4870,2,Lucki,3763,0,4,0,4,100.0%,13m
4870,1,SmokeDope,3763,0,1,1,2,50.0%,4m
4870,1,[gaiboi]Nero,3763,0,0,1,1,0.0%,35m
4879,1,[TENRIX]nerz,3762,1786,161,155,316,50.9%,5m
4879,2,[BJÖRN]Peltz,3762,1597,95,86,181,52.5%,18m
4879,1,[JWG]Skigur,3762,1145,95,111,206,46.1%,34m
4879,2,WaLiaN,3762,534,24,7,31,77.4%,35m
4879,2,WngsOfLbrty,3762,221,11,4,15,73.3%,21m
4884,2,FeelThePower,3761,340,13,9,22,59.1%,19m
4884,2,NightDragon,3761,318,13,9,22,59.1%,10m
4884,1,[BL00DY]ТерранСталин,3761,360,8,22,30,26.7%,10m
4884,3,[YOBAs]sacolnat,3761,0,1,1,2,50.0%,14m
4884,2,[isIMBA]LiquidSun,3761,0,0,1,1,0.0%,9m
4889,1,Nova,3760,1838,280,269,549,51.0%,20m
4889,1,SPACERabbit,3760,1627,132,131,263,50.2%,15m
4889,2,BilyBobBaker,3760,770,27,33,60,45.0%,35m
4889,2,[RBlood]Stef,3760,465,19,7,26,73.1%,13m
4889,2,[Pönös]Archernar,3760,379,14,10,24,58.3%,2m
4889,2,Decreed,3760,144,10,4,14,71.4%,15m
4889,2,FriendlyRat,3760,208,7,7,14,50.0%,7m
4889,3,llllllllllll,3760,172,5,5,10,50.0%,10m
4889,2,HornOfGondor,3760,90,3,4,7,42.9%,4m
4889,3,OneTwoPotato,3760,30,2,1,3,66.7%,15m
4889,2,Annihilator,3760,0,0,1,1,0.0%,11m
4900,2,[NLTN]Gelmir,3759,1596,182,166,348,52.3%,13m
4900,2,ViceVersa,3759,462,18,9,27,66.7%,12m
4900,2,insertprntsc,3759,270,13,4,17,76.5%,7m
4900,1,Convict,3759,48,4,4,8,50.0%,16m
4900,3,[EuroS]Roygbiv,3759,122,2,2,4,50.0%,18m
4900,2,[DrGNT]DRAGONPIOU,3759,0,1,0,1,100.0%,6m
4900,1,Nemlec,3759,48,1,1,2,50.0%,7m
4907,2,Destructo,3758,1475,404,379,783,51.6%,11m
4907,1,kykyna,3758,1871,368,349,717,51.3%,19m
4907,2,[SEXi]Ravelans,3758,1071,92,93,185,49.7%,17m
4907,2,Prayer,3758,790,30,32,62,48.4%,19m
4907,2,TagirMajulov,3758,470,22,14,36,61.1%,18m
4907,2,lazy,3758,338,17,7,24,70.8%,35m
4907,2,Fantom,3758,170,7,1,8,87.5%,9m
4907,2,[BrKi]Forsaken,3758,58,3,1,4,75.0%,35m
4907,2,Mal,3758,30,1,2,3,33.3%,7m
4916,2,Artalis,3757,412,15,14,29,51.7%,17m
4916,2,Lozya,3757,214,12,15,27,44.4%,7m
4916,3,Alicc,3757,232,11,2,13,84.6%,18m
4916,2,IIIIIIIIIIII,3757,176,6,8,14,42.9%,12m
4916,2,YELLOWCAR,3757,0,1,1,2,50.0%,18m
4916,2,Loxias,3757,38,1,9,10,10.0%,7m
4922,2,glhfgg,3756,456,16,17,33,48.5%,4m
4922,3,Fiend,3756,212,11,2,13,84.6%,10m
4922,2,BronzeStyle,3756,208,8,5,13,61.5%,12m
4922,2,[BATG]CrisuBobonet,3756,32,1,5,6,16.7%,2m
4926,2,Jerus,3755,618,219,203,422,51.9%,14m
4926,2,DESMX,3755,1444,122,115,237,51.5%,35m
4926,2,VasterMasya,3755,1006,95,78,173,54.9%,12m
4926,2,PotatoDerp,3755,164,9,1,10,90.0%,11m
4926,2,gickal,3755,116,4,7,11,36.4%,4m
4926,2,Uniq,3755,0,0,1,1,0.0%,19m
4932,1,[FxL]Manbearpig,3754,1884,315,332,647,48.7%,35m
4932,2,Sekiro,3754,494,19,15,34,55.9%,19m
4932,1,KingFelix,3754,191,9,1,10,90.0%,19m
4932,2,MindBender,3754,30,2,2,4,50.0%,7m
4932,2,yety,3754,30,1,1,2,50.0%,5m
4937,2,Jack,3753,1605,248,245,493,50.3%,11m
4937,2,NaysayeR,3753,380,17,6,23,73.9%,14m
4937,2,optics,3753,0,1,0,1,100.0%,5m
4937,2,Dracarys,3753,34,1,4,5,20.0%,13m
4941,2,[Heroes]NoControl,3752,1533,293,268,561,52.2%,18m
4941,2,prowess,3752,1011,120,99,219,54.8%,12m
4941,1,WildWolf,3752,1815,62,60,122,50.8%,5m
4941,1,[BMDR]ArEsǂDragon,3752,664,49,51,100,49.0%,14m
4941,2,Trump,3752,528,27,28,55,49.1%,13m
4941,3,Giratina,3752,383,16,3,19,84.2%,8m
4941,3,GöKHaN,3752,166,9,2,11,81.8%,9m
4941,2,[D0N3]tiakun,3752,212,7,9,16,43.8%,10m
4941,2,[aW]Spunk,3752,0,1,0,1,100.0%,34m
4950,2,Печенька,3751,1461,127,117,244,52.0%,20m
4950,2,[unlR]xLanaii,3751,634,25,20,45,55.6%,12m
4950,2,Zerg,3751,694,25,32,57,43.9%,12m
4950,1,Solken,3751,330,13,12,25,52.0%,10m
4950,2,[BRSKR]GhostCrypt,3751,58,2,1,3,66.7%,19m
4950,3,[MSUSC2]Nickless,3751,0,2,5,7,28.6%,14m
4950,2,[QreskT]Arevalz,3751,64,2,5,7,28.6%,22m
4950,2,Mahtisonni,3751,0,1,0,1,100.0%,4m
4958,2,newbie,3750,485,120,118,238,50.4%,10m
4958,1,Ioavas,3750,1444,106,101,207,51.2%,16m
4958,2,sqrset,3750,461,42,21,63,66.7%,2m
4958,1,Stabvil,3750,804,35,48,83,42.2%,13m
4958,3,[EAU]Foxsuze,3750,0,0,1,1,0.0%,21m
4958,2,sweetyHD,3750,0,0,1,1,0.0%,12m
4964,2,Grunt,3749,843,106,75,181,58.6%,17m
4964,2,jwe,3749,620,21,27,48,43.8%,4m
4964,2,TokOwa,3749,384,15,11,26,57.7%,34m
4964,2,[EAG]Kontrast,3749,147,14,10,24,58.3%,35m
4964,2,Похоронный,3749,246,10,5,15,66.7%,15m
4964,2,[ЕХАLT]Kruosan,3749,37,5,2,7,71.4%,8m
4964,1,[Jail]Agressive,3749,162,5,15,20,25.0%,12m
4964,2,[ArGGEJ]Fjant,3749,86,3,2,5,60.0%,22m
4964,2,[Cabage]Raptor,3749,30,2,0,2,100.0%,11m
4964,2,[АDMIN]root,3749,0,1,0,1,100.0%,20m
4974,2,speezil,3748,1427,158,140,298,53.0%,11m
4974,2,NOOBEATER,3748,1417,102,96,198,51.5%,7m
4974,2,Warember,3748,1000,39,35,74,52.7%,12m
4974,2,Twentynine,3748,0,1,0,1,100.0%,18m
4974,2,Parksman,3748,0,0,1,1,0.0%,21m
4979,2,[Spiidi]Xandathar,3747,1562,81,71,152,53.3%,14m
4979,1,CastaDiv,3747,1079,30,40,70,42.9%,14m
4979,2,[PŖïMĄŁ]BØØØØØØØØØØM,3747,190,8,4,12,66.7%,35m
4979,2,exeNagib,3747,68,3,7,10,30.0%,35m
4979,3,snac,3747,0,1,0,1,100.0%,18m
4979,2,Pouki,3747,30,1,2,3,33.3%,11m
4985,2,Habibi,3746,1374,78,72,150,52.0%,8m
4985,2,[xp]BagRa,3746,854,33,29,62,53.2%,10m
4985,2,llllllllllll,3746,593,30,14,44,68.2%,17m
4985,2,[NetGG]Gwun,3746,734,26,30,56,46.4%,14m
4985,2,Natsu,3746,160,24,11,35,68.6%,12m
4985,2,[NotEM]Fenix,3746,0,1,0,1,100.0%,17m
4985,2,[spbila]Adama,3746,0,0,2,2,0.0%,3m
4992,1,Bebop,3745,1830,216,199,415,52.0%,4m
4992,2,tdarovsky,3745,206,9,5,14,64.3%,2m
4992,2,eDo,3745,250,9,10,19,47.4%,17m
4992,2,shuggles,3745,30,2,1,3,66.7%,35m
4992,2,darkrubeni,3745,30,2,1,3,66.7%,15m
4992,2,[LSPs]Bloody,3745,0,1,0,1,100.0%,2m
4992,2,[TerBHD]Heartquake,3745,0,1,0,1,100.0%,4m
4999,2,Kyogen,3744,1515,75,61,136,55.1%,11m
4999,2,simpson,3744,1028,58,41,99,58.6%,17m
4999,3,BtotheK,3744,261,12,3,15,80.0%,11m
4999,2,[0VI]SicJack,3744,0,0,1,1,0.0%,5m
4999,2,[3Dǃ]Blissful,3744,0,0,1,1,0.0%,9m
5004,2,[Wø]Darcklaw,3743,1628,107,87,194,55.2%,9m
5004,2,[CYC]NerO,3743,1324,49,54,103,47.6%,9m
5004,2,[MYG]ZedeK,3743,828,34,34,68,50.0%,3m
5004,2,Rush,3743,422,18,7,25,72.0%,19m
5004,2,DogeStorm,3743,349,17,7,24,70.8%,4m
5004,2,SparKy,3743,374,16,5,21,76.2%,4m
5004,2,DrTheBoss,3743,60,3,2,5,60.0%,15m
5004,2,[STASFR]Djulberg,3743,64,3,8,11,27.3%,22m
5004,2,Muli,3743,30,2,4,6,33.3%,34m
5004,3,AMJS,3743,0,0,3,3,0.0%,35m
5014,2,LuYi,3742,1062,47,45,92,51.1%,34m
5014,1,mek,3742,1181,47,46,93,50.5%,12m
5014,2,[HACKZ]KungFuPanda,3742,485,23,14,37,62.2%,14m
5014,2,GGTsue,3742,362,14,5,19,73.7%,22m
5014,2,Bucn,3742,364,14,9,23,60.9%,17m
5014,2,IIIIIIIIIIII,3742,207,7,2,9,77.8%,4m
5014,2,NotSoGood,3742,0,2,4,6,33.3%,22m
5014,2,Reverence,3742,0,1,1,2,50.0%,21m
5014,2,SaltySusan,3742,0,1,1,2,50.0%,17m
5014,2,IIIIIIIIIIII,3742,0,1,3,4,25.0%,35m
5014,2,Brzuza,3742,0,0,1,1,0.0%,8m
5025,2,Hordika,3741,653,88,86,174,50.6%,11m
5025,2,Orion,3741,1519,81,79,160,50.6%,20m
5025,2,[сSсǃ]SiriuS,3741,522,34,24,58,58.6%,13m
5025,2,[LesGP]FunkyFerdi,3741,694,28,21,49,57.1%,11m
5025,2,Unx,3741,246,10,3,13,76.9%,4m
5025,2,[WCKYLN]Abrissbirne,3741,72,2,5,7,28.6%,18m
5025,2,Robokops,3741,30,1,7,8,12.5%,15m
5025,2,[GC]KingOfQueenS,3741,0,0,1,1,0.0%,19m
5033,2,[TEKU]guarana,3740,1595,197,215,412,47.8%,34m
5033,2,Mengsk,3740,735,30,30,60,50.0%,13m
5033,2,HowDoYouRead,3740,511,22,15,37,59.5%,18m
5033,2,abbou,3740,389,20,7,27,74.1%,35m
5033,2,[αX]XenoDactyl,3740,542,20,16,36,55.6%,34m
5033,2,[SHOSH]simon,3740,448,16,20,36,44.4%,19m
5033,2,FiNiTioN,3740,193,11,2,13,84.6%,9m
5033,2,Staskesensei,3740,252,10,4,14,71.4%,8m
5033,2,MORG,3740,123,4,12,16,25.0%,14m
5033,2,[ЯD]Weskimo,3740,0,1,0,1,100.0%,18m
5033,2,Olma,3740,0,0,3,3,0.0%,35m
5044,1,[GdAT]Galini,3739,1770,201,220,421,47.7%,35m
5044,3,aceBatKinG,3739,404,18,4,22,81.8%,8m
5044,2,IIIIIIIIIIII,3739,287,13,6,19,68.4%,15m
5044,3,[aW]Holorin,3739,168,4,1,5,80.0%,12m
5044,2,Geronimo,3739,30,1,4,5,20.0%,22m
5049,2,DiZaGear,3738,722,56,17,73,76.7%,18m
5049,2,Apotheosis,3738,1051,55,35,90,61.1%,34m
5049,2,DignitasLD,3738,1248,49,41,90,54.4%,11m
5049,2,[StrKlr]Ken,3738,416,37,16,53,69.8%,14m
5049,2,[SKRRR]devinpro,3738,321,21,20,41,51.2%,14m
5049,2,[HBGSJR]mchoma,3738,290,11,6,17,64.7%,15m
5049,2,miomaMo,3738,30,4,5,9,44.4%,18m
5049,2,Flanders,3738,30,3,3,6,50.0%,20m
5049,2,IIIIIIIIIIII,3738,0,1,1,2,50.0%,19m
5049,2,ДжохниПрогей,3738,0,1,2,3,33.3%,7m
5059,2,TheAbyss,3737,1191,52,51,103,50.5%,22m
5059,2,Rafalolej,3737,496,44,52,96,45.8%,12m
5059,2,StepO,3737,390,14,23,37,37.8%,13m
5059,2,[isIMBA]DarkJoker,3737,192,8,2,10,80.0%,2m
5059,2,[JDМ]SlotH,3737,60,3,2,5,60.0%,4m
5059,2,Zebra,3737,0,1,1,2,50.0%,9m
5059,2,[WYG]Bersebius,3737,0,0,1,1,0.0%,15m
5066,2,LIGHT,3736,1148,127,131,258,49.2%,9m
5066,2,Unavailable,3736,798,54,43,97,55.7%,19m
5066,2,noobIOII,3736,520,20,18,38,52.6%,4m
5066,2,Conventer,3736,396,19,6,25,76.0%,2m
5066,2,susvara,3736,408,16,9,25,64.0%,35m
5066,2,Zelkonar,3736,126,8,1,9,88.9%,14m
5066,2,Atreides,3736,138,8,1,9,88.9%,18m
5066,2,CuervoTroll,3736,192,7,4,11,63.6%,11m
5066,2,[WÖLFE]haebreus,3736,150,5,7,12,41.7%,19m
5066,2,[CCAV]FredFortuna,3736,58,2,5,7,28.6%,7m
5066,2,[aW]Dext,3736,30,1,1,2,50.0%,7m
5066,2,[HERP]tHeReaveR,3736,0,0,1,1,0.0%,35m
5066,2,PoDpyGuN,3736,0,0,1,1,0.0%,19m
5066,2,даня,3736,0,0,3,3,0.0%,18m
5066,2,Whyther,3736,0,0,4,4,0.0%,35m
5081,2,[GLHFGL]KäsekuchenA,3735,1585,228,237,465,49.0%,11m
5081,2,[Dobro]Shepard,3735,576,58,36,94,61.7%,9m
5081,2,kuanysh,3735,394,16,10,26,61.5%,8m
5081,3,Dewd,3735,236,8,1,9,88.9%,15m
5081,2,IIIIIIIIIIII,3735,0,0,1,1,0.0%,2m
5086,2,Mechas,3734,1650,241,222,463,52.1%,8m
5086,2,TixTix,3734,1619,134,119,253,53.0%,35m
5086,2,[khoans]vjsr,3734,1242,131,98,229,57.2%,19m
5086,2,[aW]darox,3734,973,96,89,185,51.9%,13m
5086,2,racistprobe,3734,559,81,78,159,50.9%,8m
5086,2,krwawyzenon,3734,970,58,61,119,48.7%,4m
5086,2,kylos,3734,1102,45,38,83,54.2%,20m
5086,2,Gorigori,3734,136,8,1,9,88.9%,15m
5086,2,WeakMe,3734,0,1,0,1,100.0%,35m
5095,2,Jileanu,3733,1473,102,97,199,51.3%,9m
5095,2,Alow,3733,866,34,28,62,54.8%,3m
5095,2,classic,3733,665,27,18,45,60.0%,12m
5095,3,Tickles,3733,196,9,5,14,64.3%,3m
5095,2,[NuF]Cyclopes,3733,142,6,2,8,75.0%,12m
5095,3,[KSix]Thunder,3733,114,5,0,5,100.0%,19m
5095,2,[UnBeul]LiquidVessel,3733,58,2,1,3,66.7%,14m
5095,2,[Sauna]TimmeyOne,3733,0,0,1,1,0.0%,22m
5095,2,TIToss,3733,0,0,1,1,0.0%,9m
5104,2,Gramozavr,3732,899,118,113,231,51.1%,7m
5104,2,[K0mpis]Gejben,3732,604,24,21,45,53.3%,14m
5104,2,[BarRO]Macheji,3732,254,9,8,17,52.9%,14m
5104,2,[Presss]IIIFIII,3732,58,3,2,5,60.0%,7m
5104,2,Artânïs,3732,30,2,2,4,50.0%,13m
5104,2,[INAE]Danatic,3732,0,1,0,1,100.0%,4m
5110,2,[ĦRZ]loser,3731,196,6,16,22,27.3%,15m
5110,2,Atlas,3731,122,5,5,10,50.0%,15m
5110,2,ogogo,3731,28,5,23,28,17.9%,15m
5110,2,JeorMormont,3731,94,4,8,12,33.3%,9m
5110,2,[AUTAJ]crapo,3731,0,1,3,4,25.0%,11m
5115,2,tomxg,3730,1602,206,205,411,50.1%,8m
5115,2,ASOTforever,3730,1439,59,46,105,56.2%,22m
5115,2,[PiGPan]Bulya,3730,910,39,34,73,53.4%,14m
5115,2,[iX]maGG,3730,873,36,23,59,61.0%,21m
5115,2,Suliløl,3730,58,2,2,4,50.0%,4m
5120,2,Positive,3729,1602,282,260,542,52.0%,22m
5120,2,[NLLO]EvA,3729,1593,72,58,130,55.4%,19m
5120,2,Pete,3729,960,38,34,72,52.8%,17m
5120,2,IIIIIIIIII,3729,280,10,2,12,83.3%,20m
5120,2,upinsmoke,3729,112,7,0,7,100.0%,21m
5120,2,justme,3729,109,6,3,9,66.7%,8m
5120,3,[WBO]RokietFjueL,3729,194,6,5,11,54.5%,10m
5120,2,[BTYGF]Tonberry,3729,146,5,4,9,55.6%,35m
5120,2,Duch,3729,114,4,4,8,50.0%,5m
5120,2,[OYH]Vassili,3729,0,1,0,1,100.0%,12m
5120,2,[TFSC]CitronVert,3729,0,0,1,1,0.0%,6m
5120,2,KozaDereza,3729,0,0,1,1,0.0%,19m
5132,1,[MiFiS]Elemdanum,3728,824,93,99,192,48.4%,7m
5132,2,Freedomflyer,3728,1118,51,37,88,58.0%,4m
5132,2,[aW]MrTrixouille,3728,1096,40,44,84,47.6%,14m
5132,2,[btroll]Trololo,3728,748,29,22,51,56.9%,13m
5132,2,Lagoonie,3728,521,23,28,51,45.1%,4m
5132,2,VaultBoy,3728,377,17,8,25,68.0%,21m
5132,2,[PiGPan]Leonius,3728,0,1,0,1,100.0%,7m
5132,2,HoesMad,3728,32,1,1,2,50.0%,19m
5132,2,[dAKiNG]Spark,3728,0,0,1,1,0.0%,4m
5141,2,GreatMaster,3727,1628,326,324,650,50.2%,7m
5141,2,[EXPANT]Livradianth,3727,1445,59,55,114,51.8%,20m
5141,2,IIIIIIIIIIII,3727,798,32,25,57,56.1%,2m
5141,2,LoupErrant,3727,270,15,3,18,83.3%,15m
5141,3,Eza,3727,306,13,3,16,81.2%,14m
5141,2,Jezzular,3727,30,1,3,4,25.0%,11m
5141,2,[RGAN]CaptainFaybs,3727,0,0,1,1,0.0%,12m
5141,2,[WOODYS]Korzan,3727,0,0,2,2,0.0%,35m
5149,2,NinemanVGX,3726,1569,117,80,197,59.4%,4m
5149,2,FLIMBLI,3726,879,44,24,68,64.7%,9m
5149,2,gurcore,3726,310,15,9,24,62.5%,11m
5149,2,Bendin,3726,360,14,10,24,58.3%,34m
5149,2,hydrerouge,3726,302,11,8,19,57.9%,13m
5149,2,Pugilist,3726,298,11,10,21,52.4%,35m
5149,3,Bubulucu,3726,145,6,4,10,60.0%,5m
5149,2,shark,3726,30,1,1,2,50.0%,18m
5149,2,Daloso,3726,30,1,9,10,10.0%,15m
5158,1,CABB,3725,903,195,193,388,50.3%,11m
5158,2,SBSxDeepDown,3725,307,13,18,31,41.9%,35m
5158,2,Shadehealer,3725,318,11,11,22,50.0%,4m
5158,2,RpR,3725,0,1,1,2,50.0%,35m
5158,3,Yarson,3725,0,0,2,2,0.0%,34m
5163,2,Rastamaniac,3724,341,15,14,29,51.7%,13m
5163,2,[SpCI]Remol,3724,274,11,5,16,68.8%,8m
5163,2,Stig,3724,204,8,6,14,57.1%,8m
5163,1,FeaR,3724,136,3,16,19,15.8%,14m
5163,2,[Yi]mescon,3724,34,2,7,9,22.2%,4m
5163,2,Kenji,3724,0,1,0,1,100.0%,20m
5163,2,failzor,3724,0,0,1,1,0.0%,22m
5170,2,KendreeamTV,3723,556,21,17,38,55.3%,18m
5170,2,Eco,3723,164,6,1,7,85.7%,34m
5170,2,[PSISTM]poizon,3723,94,3,2,5,60.0%,17m
5170,2,Arialkz,3723,0,0,1,1,0.0%,3m
5170,2,[Noyce]Swatyo,3723,0,0,3,3,0.0%,12m
5175,2,louiseflbdv,3722,1575,137,125,262,52.3%,14m
5175,1,[E1X]ExTenZ,3722,1398,94,90,184,51.1%,5m
5175,2,Mellow,3722,1132,50,50,100,50.0%,7m
5175,2,[CoFi]Robco,3722,737,31,18,49,63.3%,9m
5175,2,[IceHus]Krep,3722,515,24,4,28,85.7%,11m
5175,2,AigleChauve,3722,88,4,5,9,44.4%,11m
5175,2,Dreams,3722,60,2,7,9,22.2%,17m
5182,2,kurkove,3721,905,98,94,192,51.0%,4m
5182,2,Challenger,3721,1509,76,70,146,52.1%,11m
5182,2,[pTa]ShiQuRas,3721,833,61,45,106,57.5%,35m
5182,2,[BigDad]WarTC,3721,1400,54,51,105,51.4%,12m
5182,2,Funky,3721,1160,52,42,94,55.3%,11m
5182,2,ToTeK,3721,506,20,29,49,40.8%,19m
5182,2,Grant,3721,254,9,7,16,56.2%,17m
5182,3,Arabacha,3721,171,4,3,7,57.1%,10m
5182,2,SnapeS,3721,0,0,1,1,0.0%,11m
5191,1,Yousef,3720,1851,408,400,808,50.5%,18m
5191,2,Layth,3720,1367,260,257,517,50.3%,17m
5191,2,RealJuice,3720,1600,179,174,353,50.7%,35m
5191,2,Nufi,3720,1025,119,89,208,57.2%,34m
5191,1,noldo,3720,782,21,35,56,37.5%,14m
5191,2,Tuscan,3720,456,17,11,28,60.7%,34m
5191,2,InSoLenT,3720,140,6,5,11,54.5%,8m
5191,2,[PR1SM]BAAAKA,3720,30,2,0,2,100.0%,2m
5191,2,TGofhu,3720,30,2,6,8,25.0%,9m
5191,2,Aliy,3720,0,1,0,1,100.0%,8m
5201,2,[xFRSx]Sherlock,3719,1605,218,173,391,55.8%,35m
5201,2,llllllllllll,3719,980,37,36,73,50.7%,4m
5201,2,[TGB]Kuschelbunny,3719,539,22,22,44,50.0%,3m
5201,2,[ICL]frugs,3719,115,12,15,27,44.4%,13m
5201,2,aMATTeur,3719,224,9,5,14,64.3%,9m
5201,2,Kakugyō,3719,200,9,9,18,50.0%,18m
5201,2,OliverTwist,3719,112,7,0,7,100.0%,4m
5208,2,segaMD,3718,1615,217,208,425,51.1%,17m
5208,2,netnika,3718,1586,172,175,347,49.6%,15m
5208,2,raelag,3718,1453,63,67,130,48.5%,35m
5208,2,Iamdude,3718,636,24,29,53,45.3%,34m
5208,2,ekko,3718,120,4,4,8,50.0%,11m
5208,3,[xMiCx]RoNKolA,3718,0,0,1,1,0.0%,10m
5208,2,[TopSK]Rane,3718,0,0,3,3,0.0%,14m
5215,2,djiff,3717,1600,191,173,364,52.5%,13m
5215,2,Garbaggio,3717,832,46,25,71,64.8%,18m
5215,2,Nagato,3717,316,19,15,34,55.9%,35m
5215,2,[1BORN]AFZYY,3717,288,10,9,19,52.6%,14m
5215,3,FreeHongKong,3717,86,3,3,6,50.0%,4m
5220,1,[FlyPy]joonTerror,3716,1273,90,83,173,52.0%,21m
5220,2,[HayCe]Mazicho,3716,727,34,30,64,53.1%,35m
5220,2,Stereophobia,3716,425,20,10,30,66.7%,18m
5223,2,LeoLeo,3715,1630,193,184,377,51.2%,13m
5223,2,LinhSco,3715,766,61,38,99,61.6%,35m
5223,2,[NRushi]Kira,3715,638,25,18,43,58.1%,2m
5223,2,[TMLT]LateNuke,3715,358,13,15,28,46.4%,12m
5223,2,[OFocus]Gamme,3715,172,7,4,11,63.6%,17m
5223,2,Celenos,3715,0,0,1,1,0.0%,12m
5229,2,Monster,3714,1119,48,34,82,58.5%,9m
5229,2,Axis,3714,533,27,17,44,61.4%,18m
5229,2,Btoom,3714,432,23,8,31,74.2%,4m
5229,2,Hrölnich,3714,30,1,4,5,20.0%,7m
5233,2,Paranoia,3713,1555,177,162,339,52.2%,4m
5233,2,Marek,3713,1526,54,63,117,46.2%,2m
5233,2,Seub,3713,1318,53,42,95,55.8%,19m
5233,3,[ABGB]SuBuRbiA,3713,745,45,64,109,41.3%,18m
5233,2,[DRE4MS]Landrew,3713,988,36,41,77,46.8%,12m
5233,2,[SPAINs]SOYTUCULO,3713,771,33,17,50,66.0%,18m
5233,2,IIIIIIIIIIII,3713,140,5,2,7,71.4%,2m
5233,2,[LPeeeG]lFgCreaper,3713,118,5,4,9,55.6%,12m
5233,2,Kimi,3713,88,4,2,6,66.7%,15m
5233,2,[Gnomed]Oxygenboy,3713,58,3,3,6,50.0%,18m
5233,2,Ghato,3713,0,1,2,3,33.3%,18m
5233,2,romas,3713,0,0,1,1,0.0%,34m
5233,2,Оладушек,3713,0,0,1,1,0.0%,4m
5246,2,[Drachw]Baddabing,3712,538,37,38,75,49.3%,13m
5246,2,[BIIC]Cpt,3712,200,20,17,37,54.1%,35m
5246,2,Captain,3712,224,8,13,21,38.1%,8m
5246,2,Saigon,3712,30,2,2,4,50.0%,15m
5246,2,[L1533]stepanOZO,3712,0,0,1,1,0.0%,35m
5251,2,Fjoppe,3711,1417,112,113,225,49.8%,13m
5251,2,[Mƒ]RaiderschoKO,3711,1106,42,45,87,48.3%,2m
5251,2,Seryyyyy,3711,355,25,14,39,64.1%,13m
5251,2,Argyle,3711,378,14,11,25,56.0%,18m
5251,2,[Arrows]InsomniA,3711,230,8,10,18,44.4%,15m
5251,1,[wAi]Merlint,3711,0,3,6,9,33.3%,5m
5251,2,SpaceX,3711,0,1,0,1,100.0%,21m
5251,2,Choko,3711,0,0,1,1,0.0%,9m
5259,2,Meruem,3710,549,22,14,36,61.1%,21m
5259,2,yoren,3710,0,5,0,5,100.0%,15m
5259,2,Krmenadla,3710,88,4,2,6,66.7%,11m
5259,3,Weskimo,3710,0,1,0,1,100.0%,4m
5259,2,BitGhost,3710,0,0,1,1,0.0%,21m
5264,2,MUNIEZANATOR,3709,1242,121,122,243,49.8%,14m
5264,2,[PiGPan]Djentleman,3709,1555,120,125,245,49.0%,21m
5264,2,Yharon,3709,659,33,11,44,75.0%,18m
5264,2,Norxon,3709,152,11,2,13,84.6%,11m
5264,2,[BjwA]Thorogmar,3709,202,7,10,17,41.2%,12m
5264,2,Neowise,3709,133,5,7,12,41.7%,4m
5264,2,[MGTSC2]Voidreaper,3709,0,0,1,1,0.0%,13m
5271,2,Mistgun,3708,1592,298,263,561,53.1%,34m
5271,2,Kampfgurke,3708,1629,175,159,334,52.4%,17m
5271,1,[Cannоn]Raa,3708,1844,128,141,269,47.6%,20m
5271,2,KolikMi,3708,1064,86,85,171,50.3%,4m
5271,2,sha,3708,861,35,30,65,53.8%,11m
5271,2,Baki,3708,491,34,26,60,56.7%,13m
5271,2,Hellcat,3708,598,23,22,45,51.1%,4m
5271,2,crazypants,3708,247,12,5,17,70.6%,21m
5271,2,Kes,3708,181,11,10,21,52.4%,8m
5271,2,yoda,3708,132,5,11,16,31.2%,35m
5271,3,Greebling,3708,122,2,2,4,50.0%,3m
5271,2,szeweningen,3708,0,2,3,5,40.0%,2m
5271,2,[ƮHǤ]MøstWântêÐ,3708,0,0,1,1,0.0%,35m
5271,2,[ESErl]Devastating,3708,0,0,5,5,0.0%,12m
5285,2,[ArGGEJ]River,3707,475,34,19,53,64.2%,17m
5285,2,muscae,3707,477,23,25,48,47.9%,7m
5285,1,Nugias,3707,331,13,13,26,50.0%,21m
5285,2,Darker,3707,90,8,3,11,72.7%,3m
5285,3,[MCat]Alex,3707,214,6,3,9,66.7%,5m
5285,2,boppers,3707,166,6,6,12,50.0%,8m
5285,2,[αXi]Hyren,3707,10,4,26,30,13.3%,6m
5285,2,Invictus,3707,30,2,1,3,66.7%,15m
5285,2,[Wolven]DevilMarine,3707,36,2,3,5,40.0%,15m
5294,2,[PLA2N]saccharose,3706,1635,143,119,262,54.6%,2m
5294,2,Heval,3706,1390,135,118,253,53.4%,34m
5294,2,CaelmBleidd,3706,1450,63,74,137,46.0%,15m
5294,2,IIIIIIIIIIII,3706,690,29,20,49,59.2%,2m
5294,2,Macroplayer,3706,90,7,6,13,53.8%,11m
5294,2,Misiek,3706,0,0,1,1,0.0%,11m
5294,3,notgood,3706,0,0,2,2,0.0%,35m
5301,2,[ǂPKTǂ]Humots,3705,1594,162,152,314,51.6%,34m
5301,2,Kdude,3705,577,58,33,91,63.7%,6m
5301,2,[S8]Wurstbrei,3705,657,56,57,113,49.6%,4m
5301,1,[INOE]IIIIIIIIIIII,3705,837,28,28,56,50.0%,20m
5301,2,[DHCP]AntiDog,3705,502,19,15,34,55.9%,15m
5301,2,zonic,3705,256,10,9,19,52.6%,21m
5301,2,[NetJ]BoBo,3705,320,10,13,23,43.5%,21m
5301,2,[BANAN3]mooolt,3705,0,0,1,1,0.0%,22m
5301,2,[3M1]Schlaff,3705,0,0,1,1,0.0%,13m
5310,2,[KAOTx]Reach,3704,616,82,66,148,55.4%,12m
5310,2,Azamantes,3704,1437,59,58,117,50.4%,15m
5310,2,Aspicherie,3704,468,25,9,34,73.5%,35m
5310,2,Plodiumshree,3704,476,18,19,37,48.6%,8m
5310,3,ItsDebugTime,3704,253,12,8,20,60.0%,8m
5310,2,Vegas,3704,264,11,7,18,61.1%,2m
5316,2,[AiRǂ]rIpSatomi,3703,1595,202,203,405,49.9%,12m
5316,2,[PiGPan]DAniilcola,3703,1325,110,89,199,55.3%,10m
5316,2,Dreamscape,3703,460,79,76,155,51.0%,8m
5316,2,renren,3703,1376,65,63,128,50.8%,35m
5316,2,[ExTr1m]HidingIron,3703,1171,47,43,90,52.2%,9m
5316,2,Rova,3703,86,4,4,8,50.0%,18m
5316,1,[OSgZ]Hednar,3703,48,4,5,9,44.4%,5m
5316,2,Narisia,3703,0,3,2,5,60.0%,21m
5316,2,NoGPU,3703,30,1,6,7,14.3%,18m
5325,2,dorald,3702,967,83,53,136,61.0%,34m
5325,2,[Hrr]Пупсеныш,3702,140,7,0,7,100.0%,13m
5325,2,[VHGC]ClouD,3702,60,3,7,10,30.0%,11m
5325,2,SchwarmLover,3702,30,2,0,2,100.0%,22m
5329,2,RuSh,3701,1588,84,70,154,54.5%,4m
5329,2,ЗлойКошарик,3701,1401,65,46,111,58.6%,9m
5329,2,EtamiN,3701,482,49,45,94,52.1%,11m
5329,2,bvdcent,3701,224,9,5,14,64.3%,6m
5329,2,InBloom,3701,30,1,1,2,50.0%,19m
5329,2,Shinjaehyun,3701,0,0,1,1,0.0%,18m
5335,2,Prizrak,3700,1238,71,62,133,53.4%,17m
5335,2,Arttaaz,3700,1030,59,61,120,49.2%,8m
5335,2,[RSK]GantDeToilet,3700,870,40,33,73,54.8%,35m
5335,2,GeitStar,3700,334,12,5,17,70.6%,18m
5335,2,[0BO]Desaster,3700,0,1,2,3,33.3%,6m
5335,2,[Didim]Meglomaniac,3700,32,1,3,4,25.0%,4m
5341,2,[CGNAN]Manu,3699,452,23,18,41,56.1%,34m
5341,2,Necro,3699,484,19,11,30,63.3%,9m
5341,2,[InitRu]HelLioS,3699,360,18,17,35,51.4%,35m
5341,2,BabyMarine,3699,166,7,2,9,77.8%,35m
5341,2,Epixaa,3699,30,4,3,7,57.1%,18m
5341,2,Abrissbirne,3699,62,3,4,7,42.9%,12m
5341,2,Cho,3699,100,3,9,12,25.0%,2m
5341,2,[яєѕ]Lurkas,3699,30,2,0,2,100.0%,35m
5341,2,[B3est]Tive,3699,30,2,3,5,40.0%,12m
5341,2,[K0mpis]GruGloG,3699,0,0,2,2,0.0%,18m
5351,2,[888888]НаглыйТос,3698,1618,207,197,404,51.2%,21m
5351,2,ReCoN,3698,684,65,63,128,50.8%,13m
5351,2,Mullemeck,3698,1302,51,46,97,52.6%,7m
5351,2,[Skunks]Stinktier,3698,180,11,13,24,45.8%,13m
5351,2,ybro,3698,206,8,6,14,57.1%,35m
5351,2,gargantua,3698,0,1,0,1,100.0%,21m
5351,2,herO,3698,30,1,2,3,33.3%,13m
5358,2,Boonya,3697,1613,153,138,291,52.6%,18m
5358,2,CuirAnus,3697,629,65,71,136,47.8%,35m
5358,2,wolfreaper,3697,248,9,9,18,50.0%,35m
5358,2,simon,3697,212,8,12,20,40.0%,6m
5358,2,[Fridge]Salvato,3697,0,0,7,7,0.0%,22m
5363,2,DrNoob,3696,116,4,4,8,50.0%,13m
5363,2,tachibana,3696,116,4,7,11,36.4%,11m
5363,2,[mfxed]Essu,3696,114,4,13,17,23.5%,12m
5363,2,Aypee,3696,30,2,0,2,100.0%,8m
5363,2,[S0SAT]Меир,3696,0,0,1,1,0.0%,18m
5368,2,Egorik,3695,1175,127,103,230,55.2%,12m
5368,2,[LinEs]sebastein,3695,646,23,27,50,46.0%,18m
5368,2,poTOSSyntess,3695,233,9,11,20,45.0%,13m
5368,3,Apodarilli,3695,241,7,3,10,70.0%,19m
5368,2,[BadTvT]viag,3695,86,4,8,12,33.3%,4m
5368,2,IIIIIIIIII,3695,0,1,0,1,100.0%,12m
5374,2,CORE,3694,1565,666,652,1318,50.5%,4m
5374,2,sayhello,3694,1172,131,113,244,53.7%,3m
5374,2,DrKhorne,3694,364,14,13,27,51.9%,3m
5374,3,Holmes,3694,170,9,9,18,50.0%,9m
5374,2,[FFaaN]INFRASOLAR,3694,114,7,1,8,87.5%,12m
5374,2,[boomer]Bleed,3694,0,1,0,1,100.0%,22m
5374,2,[Daxppl]HoXY,3694,0,0,1,1,0.0%,21m
5381,2,sweetZerg,3693,1546,117,91,208,56.2%,16m
5381,2,Idqutious,3693,631,42,32,74,56.8%,8m
5381,2,[MrKing]Mryarking,3693,771,39,16,55,70.9%,19m
5381,2,Life,3693,203,18,16,34,52.9%,6m
5381,3,[ncotic]Voyager,3693,245,12,6,18,66.7%,4m
5381,2,Zmelly,3693,91,3,8,11,27.3%,21m
5381,2,Zietek,3693,30,2,2,4,50.0%,35m
5381,2,YourMotherXD,3693,30,2,3,5,40.0%,35m
5389,2,[Run974]Mordoress,3692,998,155,125,280,55.4%,21m
5389,1,nKarje,3692,1724,69,81,150,46.0%,5m
5389,2,[Brotoz]Gramoke,3692,72,9,13,22,40.9%,4m
5389,2,[EESC]TripleS,3692,260,8,19,27,29.6%,4m
5389,2,[СRAZY]Михеюшка,3692,160,6,6,12,50.0%,15m
5389,2,[NerCC]Reran,3692,112,5,0,5,100.0%,11m
5389,2,Burbn,3692,0,1,0,1,100.0%,18m
5389,2,TossMahSalad,3692,0,0,1,1,0.0%,22m
5397,1,Wiseman,3691,1230,156,155,311,50.2%,22m
5397,2,[LożaP]AlexMacedon,3691,204,7,8,15,46.7%,13m
5397,2,FaYe,3691,106,3,9,12,25.0%,18m
5397,1,aYeti,3691,48,2,2,4,50.0%,19m
5397,2,Square,3691,0,0,1,1,0.0%,19m
5402,1,DemiZe,3690,1635,247,240,487,50.7%,5m
5402,2,Toruk,3690,672,138,109,247,55.9%,11m
5402,2,[SLD]GeneralBlack,3690,906,34,34,68,50.0%,11m
5402,2,[Y26]Hit,3690,966,34,39,73,46.6%,3m
5402,2,EnTaroAdun,3690,769,32,19,51,62.7%,35m
5402,2,Geno,3690,169,10,8,18,55.6%,13m
5402,2,[TxPIOL]Georges,3690,144,6,4,10,60.0%,3m
5402,2,CASHFORHASH,3690,142,6,4,10,60.0%,4m
5402,2,ClydeTheFrog,3690,0,0,1,1,0.0%,15m
5402,2,Blue,3690,0,0,1,1,0.0%,2m
5412,2,[PiCrab]Evgen,3689,1561,93,79,172,54.1%,4m
5412,2,JOHNBOY,3689,1597,88,81,169,52.1%,19m
5412,2,Zagreus,3689,1469,70,68,138,50.7%,21m
5412,2,[eSpB]Nep,3689,470,23,19,42,54.8%,3m
5412,2,Bioman,3689,554,19,24,43,44.2%,7m
5412,2,[jEbAC]żabek,3689,495,18,18,36,50.0%,8m
5412,2,TeamRocket,3689,389,17,12,29,58.6%,8m
5412,2,UMB,3689,180,13,2,15,86.7%,17m
5412,2,[DDestr]Dallarian,3689,318,11,15,26,42.3%,21m
5412,2,NotABarcode,3689,148,5,11,16,31.2%,5m
5412,2,GTA,3689,128,4,9,13,30.8%,18m
5412,2,RedBlustery,3689,0,3,2,5,60.0%,6m
5412,3,AstheFriend,3689,30,1,1,2,50.0%,18m
5412,2,Roger,3689,0,1,1,2,50.0%,2m
5412,2,[OÐ]Flixse,3689,0,1,5,6,16.7%,4m
5412,2,[KRice]nWaDemo,3689,0,0,3,3,0.0%,14m
5428,2,[SaiYaN]OuB,3688,1054,39,39,78,50.0%,3m
5428,2,GÁBOR,3688,551,23,14,37,62.2%,3m
5428,2,DaSnIpEr,3688,116,5,1,6,83.3%,15m
5428,2,[Peeps]Kobold,3688,60,2,2,4,50.0%,18m
5428,2,Provieh,3688,0,1,2,3,33.3%,34m
5433,2,eXceS,3687,1308,131,130,261,50.2%,11m
5433,2,[lMMl]salama,3687,588,21,23,44,47.7%,15m
5433,2,Baffron,3687,498,19,18,37,51.4%,12m
5433,2,IIIIIIIIIIII,3687,444,16,20,36,44.4%,19m
5433,2,ZealoT,3687,40,4,2,6,66.7%,11m
5433,2,Change,3687,0,1,4,5,20.0%,22m
5433,2,[SLD]Eisdieler,3687,0,0,1,1,0.0%,6m
5433,2,[ЯD]Mudkipz,3687,0,0,2,2,0.0%,5m
5441,2,Tirael,3686,804,27,33,60,45.0%,22m
5441,2,NDNO,3686,30,1,3,4,25.0%,8m
5443,2,FedeX,3685,1638,185,180,365,50.7%,17m
5443,2,Supaplex,3685,1574,93,82,175,53.1%,22m
5443,2,papidipupi,3685,897,81,83,164,49.4%,9m
5443,2,[Z3RGTV]SERG,3685,343,14,5,19,73.7%,15m
5443,2,Savoir,3685,286,11,7,18,61.1%,6m
5443,2,natanan,3685,174,6,7,13,46.2%,4m
5443,2,Woozoor,3685,120,5,4,9,55.6%,18m
5443,2,MMOrrissette,3685,0,0,1,1,0.0%,17m
5443,2,poichiche,3685,0,0,3,3,0.0%,3m
5452,2,Nein,3684,1608,270,258,528,51.1%,9m
5452,2,Daedalus,3684,1193,125,117,242,51.7%,18m
5452,2,QuadIQ,3684,1546,87,96,183,47.5%,18m
5452,2,[Cannоn]Granate,3684,1156,57,31,88,64.8%,2m
5452,2,[JGT]NoN,3684,1023,42,32,74,56.8%,11m
5452,2,AVAllAC,3684,621,41,28,69,59.4%,5m
5452,2,[Cannоn]imagenjonas,3684,140,6,1,7,85.7%,13m
5452,2,[Toulou]SnOw,3684,88,3,4,7,42.9%,16m
5452,2,flapiyo,3684,30,2,1,3,66.7%,35m
5452,2,[lOoOl]Vader,3684,0,1,3,4,25.0%,35m
5452,2,[ZERGML]HolySatan,3684,30,1,4,5,20.0%,13m
5452,3,LennartNL,3684,0,0,1,1,0.0%,16m
5464,2,haaleamunkki,3683,1584,309,279,588,52.6%,2m
5464,2,[ØC]iceman,3683,1504,59,60,119,49.6%,19m
5464,2,[dEbE]LilStats,3683,376,15,12,27,55.6%,11m
5464,2,LightRain,3683,0,1,0,1,100.0%,15m
5464,2,Shapeshifter,3683,0,0,9,9,0.0%,5m
5469,2,Dogma,3682,400,102,91,193,52.8%,2m
5469,1,[NerCC]pascaldsm,3682,1753,84,83,167,50.3%,9m
5469,2,Jamie,3682,1141,84,86,170,49.4%,7m
5469,2,[EnTгpY]Screamer,3682,425,77,77,154,50.0%,11m
5469,2,bloodnator,3682,782,70,80,150,46.7%,4m
5469,2,[FxL]TiMaZe,3682,786,26,37,63,41.3%,18m
5469,2,[UATeam]SHOCK,3682,672,24,28,52,46.2%,35m
5469,2,kirtapk,3682,409,18,10,28,64.3%,7m
5469,2,Dominix,3682,478,17,17,34,50.0%,35m
5469,2,Stimmur,3682,400,14,11,25,56.0%,21m
5469,2,[5HC]TheChosenOne,3682,60,3,3,6,50.0%,4m
5469,2,hgku,3682,86,3,3,6,50.0%,17m
5469,2,TeZetHa,3682,30,2,0,2,100.0%,21m
5469,2,[CRFT]DranoR,3682,30,1,1,2,50.0%,8m
5469,2,[Wø]MoonIsReal,3682,0,0,1,1,0.0%,21m
5469,2,Banks,3682,0,0,1,1,0.0%,10m
5469,2,[SY2G]Antotoxic,3682,0,0,1,1,0.0%,35m
5469,2,[ARTRD]wookie,3682,0,0,4,4,0.0%,8m
5469,2,IIIIIIIIIIII,3682,0,0,5,5,0.0%,13m
5488,2,TickTock,3681,1278,127,123,250,50.8%,15m
5488,2,[FR1]BadBorz,3681,124,5,10,15,33.3%,35m
5488,2,CroOI,3681,90,4,3,7,57.1%,12m
5488,2,ThepacmaN,3681,0,0,1,1,0.0%,35m
5492,2,[XCL]Xoleq,3680,1589,133,126,259,51.4%,8m
5492,2,[IReStI]Klimor,3680,501,25,10,35,71.4%,3m
5492,2,ARCMAN,3680,164,7,7,14,50.0%,13m
5492,2,[RøckeT]ElTwingo,3680,140,6,1,7,85.7%,9m
5492,2,Darkmutroux,3680,58,3,3,6,50.0%,18m
5492,3,[PrStar]Illogic,3680,0,1,0,1,100.0%,18m
5492,3,[BRSKR]goodluckhave,3680,0,1,0,1,100.0%,4m
5492,2,donuts,3680,6,1,1,2,50.0%,6m
5492,2,Wolfhanter,3680,30,1,1,2,50.0%,3m
5492,2,Brasida,3680,30,1,2,3,33.3%,18m
5492,2,Isi,3680,0,0,2,2,0.0%,13m
5503,2,[HAYTER]Pete,3679,1601,253,237,490,51.6%,35m
5503,2,Rondoudou,3679,587,67,51,118,56.8%,19m
5503,2,Stilgar,3679,953,49,39,88,55.7%,35m
5503,2,Lutscha,3679,470,21,16,37,56.8%,4m
5503,2,higgi,3679,30,2,0,2,100.0%,9m
5503,3,mathew,3679,30,2,1,3,66.7%,14m
5503,3,Niconicopoi,3679,0,1,0,1,100.0%,15m
5503,2,[IceHus]Zero,3679,0,0,8,8,0.0%,18m
5511,1,[VFN]DerNibelung,3678,1805,293,291,584,50.2%,11m
5511,2,Джон,3678,1013,98,90,188,52.1%,13m
5511,2,prime,3678,1296,59,47,106,55.7%,35m
5511,2,[EWW]Bleks,3678,321,27,22,49,55.1%,15m
5511,3,Troggenir,3678,231,11,3,14,78.6%,6m
5511,2,[CYC]hansi,3678,148,6,4,10,60.0%,21m
5511,2,FUismyGG,3678,58,2,2,4,50.0%,35m
5511,2,Matthias,3678,96,2,4,6,33.3%,11m
5511,3,[Sc2Owl]mEtil,3678,0,1,1,2,50.0%,7m
5511,2,temo,3678,0,0,1,1,0.0%,18m
5521,2,DarkWave,3677,1292,191,181,372,51.3%,17m
5521,2,BoatMormon,3677,1436,96,79,175,54.9%,18m
5521,2,Karras,3677,702,31,23,54,57.4%,35m
5521,2,Zutzut,3677,738,26,33,59,44.1%,10m
5521,2,Octopus,3677,538,25,14,39,64.1%,35m
5521,2,TBob,3677,702,25,29,54,46.3%,11m
5521,2,dajmi,3677,598,20,25,45,44.4%,19m
5521,2,[Pyrric]blackmacros,3677,312,12,7,19,63.2%,8m
5521,3,Normanton,3677,195,10,4,14,71.4%,22m
5521,2,PacquiaO,3677,30,1,3,4,25.0%,11m
5521,2,[ManB]surculus,3677,0,0,5,5,0.0%,4m
5532,2,llllllllllll,3676,1516,74,64,138,53.6%,12m
5532,2,[3GBY]NikoNikoNi,3676,1103,49,38,87,56.3%,35m
5532,2,Gugi,3676,454,26,10,36,72.2%,15m
5532,2,Calçot,3676,491,20,22,42,47.6%,9m
5532,2,[МД86]Moldovanin,3676,258,10,11,21,47.6%,18m
5532,2,[Hаsu]Makunouchi,3676,159,4,5,9,44.4%,22m
5532,3,Asoernipal,3676,113,3,2,5,60.0%,35m
5532,2,Tassadar,3676,30,1,4,5,20.0%,15m
5532,2,PowerPee,3676,0,0,1,1,0.0%,4m
5541,2,ZzzLotzzZ,3675,1582,336,325,661,50.8%,35m
5541,2,Kharathos,3675,1218,270,265,535,50.5%,6m
5541,2,Vinator,3675,1003,115,92,207,55.6%,11m
5541,2,GrootNRoll,3675,596,23,16,39,59.0%,21m
5541,2,Alkash,3675,409,16,8,24,66.7%,14m
5541,2,[MNGGTV]MaNNaGGia,3675,170,6,5,11,54.5%,14m
5541,2,shked,3675,144,5,7,12,41.7%,11m
5541,2,[PRLS]Ozaro,3675,121,2,2,4,50.0%,22m
5541,2,[HIYYYA]WASSUP,3675,0,0,2,2,0.0%,12m
5550,2,[KKTI]Monkezzz,3674,1623,431,426,857,50.3%,15m
5550,2,Portass,3674,655,62,39,101,61.4%,3m
5550,2,[Blacer]BarCode,3674,543,25,29,54,46.3%,10m
5550,1,rtp,3674,501,18,29,47,38.3%,16m
5550,2,[TUBBY]Dipsy,3674,178,10,2,12,83.3%,9m
5550,2,Kirtruhro,3674,204,6,20,26,23.1%,11m
5550,2,[Juliet]Wakaranai,3674,148,5,6,11,45.5%,6m
5550,2,[NyaEC]Mandi,3674,114,4,5,9,44.4%,11m
5550,2,TittyTwister,3674,30,3,5,8,37.5%,11m
5550,2,QuiGonJay,3674,0,1,0,1,100.0%,8m
5550,2,[Draigo]Dinma,3674,0,1,0,1,100.0%,9m
5561,2,Isy,3673,1556,186,181,367,50.7%,13m
5561,1,Voldemort,3673,1788,109,117,226,48.2%,35m
5561,2,sennt,3673,551,34,29,63,54.0%,7m
5561,2,Shadow,3673,558,21,23,44,47.7%,12m
5561,2,VLADIUSLAV,3673,172,6,6,12,50.0%,11m
5561,2,[GoldM]sLaiz,3673,116,4,5,9,44.4%,19m
5561,2,[8TaO8]Avalon,3673,30,2,3,5,40.0%,19m
5568,2,PestoKinti,3672,1633,982,928,1910,51.4%,16m
5568,2,Robby,3672,351,17,7,24,70.8%,5m
5568,2,lasticot,3672,444,15,20,35,42.9%,12m
5568,3,misery,3672,294,10,7,17,58.8%,20m
5568,2,[EXORT]Seneka,3672,0,1,0,1,100.0%,21m
5568,2,Ali,3672,0,0,1,1,0.0%,13m
5568,2,zhgunapalmom,3672,0,0,1,1,0.0%,6m
5568,2,[DBr]Nùméréction,3672,0,0,3,3,0.0%,11m
5568,2,DataRacer,3672,0,0,3,3,0.0%,7m
5577,2,pAmNikola,3671,915,94,73,167,56.3%,11m
5577,2,BelRiose,3671,915,35,40,75,46.7%,17m
5577,2,SafariRider,3671,570,21,17,38,55.3%,18m
5577,2,[L0WS]TheRioo,3671,400,14,23,37,37.8%,6m
5577,2,[013NL]Riffdoctor,3671,232,9,8,17,52.9%,14m
5577,2,Gortar,3671,166,7,5,12,58.3%,15m
5577,2,ramleren,3671,198,7,8,15,46.7%,17m
5577,2,Bambi,3671,0,4,1,5,80.0%,35m
5577,2,IlllIIllIlll,3671,86,3,4,7,42.9%,14m
5577,3,SeptemberXYC,3671,0,1,0,1,100.0%,36m
5587,2,Rational,3670,1243,95,93,188,50.5%,8m
5587,2,Draf,3670,759,37,29,66,56.1%,36m
5587,2,[DFgsA]Nite,3670,114,4,10,14,28.6%,4m
5587,2,Quazimodem,3670,30,2,6,8,25.0%,19m
5587,2,Remy,3670,0,1,0,1,100.0%,18m
5587,2,schooled,3670,0,1,0,1,100.0%,11m
5587,2,microchelick,3670,0,1,0,1,100.0%,35m
5587,2,[Heroes]SivPax,3670,30,1,3,4,25.0%,11m
5587,2,amiral,3670,0,0,1,1,0.0%,18m
5587,2,[HZeS]ThroughTime,3670,0,0,5,5,0.0%,17m
5597,2,[MWAF]DuelKJ,3669,1371,93,92,185,50.3%,12m
5597,2,mytashki,3669,1176,65,56,121,53.7%,13m
5597,2,[DEDAL]Glutek,3669,866,31,37,68,45.6%,35m
5597,2,phenix,3669,568,20,17,37,54.1%,13m
5597,2,Stdioh,3669,186,10,4,14,71.4%,3m
5597,2,Moonlight,3669,276,10,10,20,50.0%,8m
5597,2,Cyborg,3669,174,6,6,12,50.0%,35m
5597,2,Jetix,3669,58,3,4,7,42.9%,13m
5597,2,AkaK,3669,58,2,4,6,33.3%,8m
5597,2,Atonement,3669,0,1,0,1,100.0%,4m
5597,2,[WoPe]Torumon,3669,0,0,1,1,0.0%,4m
5608,2,xen,3668,1419,68,68,136,50.0%,8m
5608,2,[BRSKR]Morghan,3668,1096,52,52,104,50.0%,17m
5608,2,[IceHus]LiquidWoo,3668,971,49,34,83,59.0%,13m
5608,2,CaAndaR,3668,999,48,26,74,64.9%,14m
5608,2,Thumbs,3668,1080,40,46,86,46.5%,22m
5608,2,[iGD2D]ReachLT,3668,382,12,26,38,31.6%,9m
5608,2,Tbag,3668,149,4,5,9,44.4%,18m
5608,2,[KAOTx]xpinkyxx,3668,0,1,0,1,100.0%,4m
5608,2,mTZ,3668,0,0,1,1,0.0%,10m
5617,2,Criptex,3667,1490,156,130,286,54.5%,21m
5617,1,IIIIIIIIIIII,3667,896,37,55,92,40.2%,11m
5617,2,[zZDL]DiStiLLeRy,3667,721,32,24,56,57.1%,22m
5617,2,[LawB]Shadow,3667,237,7,10,17,41.2%,18m
5617,2,Laroi,3667,144,6,7,13,46.2%,21m
5617,2,Courteous,3667,114,4,3,7,57.1%,9m
5617,2,JeanRoger,3667,68,4,5,9,44.4%,35m
5617,2,Qwizzyx,3667,0,1,0,1,100.0%,3m
5617,1,unbelievable,3667,0,1,0,1,100.0%,9m
5617,2,[Dobro]ZaKoNaL,3667,0,0,1,1,0.0%,19m
5627,2,Learand,3666,1621,109,98,207,52.7%,3m
5627,2,YLsIntoTanks,3666,862,58,27,85,68.2%,3m
5627,2,bernamorillo,3666,347,56,68,124,45.2%,14m
5627,2,[Goouda]Mojoe,3666,881,53,47,100,53.0%,14m
5627,2,Galiadus,3666,924,38,33,71,53.5%,11m
5627,2,[F2ACLK]Misstress,3666,882,32,37,69,46.4%,21m
5627,2,Dead,3666,372,13,21,34,38.2%,35m
5627,2,[Animoo]Dannie,3666,212,8,2,10,80.0%,4m
5627,2,schwayn,3666,0,4,1,5,80.0%,2m
5627,2,edoc,3666,30,4,2,6,66.7%,11m
5627,2,WarrioR,3666,30,2,0,2,100.0%,8m
5627,2,KubusMaximus,3666,26,2,3,5,40.0%,6m
5627,2,Yorkie,3666,0,0,3,3,0.0%,35m
5640,2,РядовойРудге,3665,1218,238,213,451,52.8%,21m
5640,2,CornHoliO,3665,137,11,1,12,91.7%,35m
5640,2,dudebro,3665,266,9,22,31,29.0%,18m
5640,2,[SRoB]Robin,3665,224,6,11,17,35.3%,36m
5640,2,Kamala,3665,90,3,5,8,37.5%,3m
5640,2,[MaW]sLOwLy,3665,0,0,1,1,0.0%,5m
5646,2,KYSMAYBE,3664,926,104,75,179,58.1%,4m
5646,2,[IamCpt]DERBESTE,3664,1237,46,48,94,48.9%,11m
5646,2,Mango,3664,870,42,50,92,45.7%,35m
5646,2,Kappa,3664,854,33,28,61,54.1%,18m
5646,2,[TSmash]Deus,3664,396,27,19,46,58.7%,35m
5646,2,SnowCrash,3664,130,8,1,9,88.9%,21m
5646,2,VAPEX,3664,252,8,2,10,80.0%,11m
5653,2,RedCat,3663,1520,499,485,984,50.7%,3m
5653,2,ShinsoBankai,3663,514,47,43,90,52.2%,17m
5653,2,[malm]Alex,3663,404,19,19,38,50.0%,11m
5653,2,MeNoBrain,3663,398,16,12,28,57.1%,19m
5653,2,Overmind,3663,294,11,8,19,57.9%,19m
5653,2,RichSmith,3663,198,8,5,13,61.5%,35m
5653,2,IronMaiden,3663,140,8,15,23,34.8%,13m
5653,2,[RoyF]Methraton,3663,114,7,1,8,87.5%,14m
5653,2,FishyFetus,3663,167,5,1,6,83.3%,11m
5653,2,[RbF]Neon,3663,114,4,6,10,40.0%,5m
5653,2,[ƮesXG]Huski,3663,0,0,1,1,0.0%,21m
5664,2,Dridri,3662,1392,337,299,636,53.0%,35m
5664,2,neltharion,3662,1174,110,92,202,54.5%,35m
5664,2,Serral,3662,335,47,32,79,59.5%,21m
5664,2,Illife,3662,850,32,33,65,49.2%,11m
5664,2,Bertie,3662,732,29,24,53,54.7%,22m
5664,2,[ggGGwp]VoidRay,3662,461,22,10,32,68.8%,5m
5664,2,Lunar,3662,196,8,4,12,66.7%,4m
5664,2,Ivanger,3662,118,4,6,10,40.0%,22m
5664,2,BuDz,3662,0,1,0,1,100.0%,21m
5664,3,[Ptyc]CryptacToune,3662,0,1,2,3,33.3%,14m
5664,2,[PlAr]Darkdoom,3662,0,0,1,1,0.0%,35m
5675,2,maciek,3661,956,130,108,238,54.6%,18m
5675,2,Giga,3661,1437,79,68,147,53.7%,10m
5675,2,Fettoni,3661,566,23,20,43,53.5%,21m
5675,2,[ANTl]Matter,3661,366,14,12,26,53.8%,22m
5675,2,Alhambic,3661,0,2,1,3,66.7%,4m
5675,2,nicholincho,3661,60,2,3,5,40.0%,13m
5681,2,TiMson,3660,1147,148,140,288,51.4%,35m
5681,2,Goku,3660,503,51,39,90,56.7%,35m
5681,2,[PÂRłAH]Veeky,3660,860,50,52,102,49.0%,35m
5681,2,[JINX]AlexZz,3660,497,21,15,36,58.3%,11m
5681,2,Barcode,3660,336,12,11,23,52.2%,8m
5681,2,camaka,3660,142,6,6,12,50.0%,13m
5681,2,[IACTI]ACTbOris,3660,30,2,0,2,100.0%,15m
5681,2,Drego,3660,60,2,8,10,20.0%,17m
5681,2,[lMMl]Tempoe,3660,0,0,1,1,0.0%,11m
5681,2,[BeSC]Stormsurger,3660,0,0,3,3,0.0%,6m
5691,2,over,3659,1616,372,385,757,49.1%,35m
5691,2,Pcixo,3659,1512,236,200,436,54.1%,14m
5691,2,JiMBO,3659,221,23,15,38,60.5%,13m
5691,2,[QTclub]stoffe,3659,522,18,24,42,42.9%,35m
5691,2,PieceDuke,3659,96,6,0,6,100.0%,13m
5691,2,Jonas,3659,198,6,2,8,75.0%,4m
5691,2,superhero,3659,42,4,4,8,50.0%,3m
5691,2,Ultimat,3659,30,2,4,6,33.3%,14m
5691,2,[X17Eu]IntoTheTraP,3659,0,1,0,1,100.0%,36m
5691,2,Loirid,3659,30,1,7,8,12.5%,9m
5691,2,AyoH,3659,0,0,5,5,0.0%,19m
5702,2,[НОД17]Odin,3658,846,33,28,61,54.1%,17m
5702,3,[Z3RGML]Сомбреро,3658,229,11,3,14,78.6%,11m
5702,2,Twentytwo,3658,0,0,1,1,0.0%,16m
5705,2,slimgod,3657,1080,531,543,1074,49.4%,9m
5705,2,LazyGuyIII,3657,625,28,18,46,60.9%,9m
5705,2,IIIIIIIIIIII,3657,112,7,0,7,100.0%,18m
5705,2,Jaraxus,3657,0,1,0,1,100.0%,12m
5705,3,Sensiskunk,3657,0,0,2,2,0.0%,11m
5710,2,Nagrad,3656,963,67,78,145,46.2%,7m
5710,2,RobertDindon,3656,696,24,29,53,45.3%,6m
5710,2,rainman,3656,488,18,19,37,48.6%,5m
5710,2,xXNoScOpeXx,3656,197,7,8,15,46.7%,13m
5710,2,[WxN]NuTCrAcK,3656,88,4,3,7,57.1%,17m
5710,2,[KELA]LoLisAmazing,3656,116,4,3,7,57.1%,9m
5710,2,[ĦĦ]iCeMan,3656,30,1,2,3,33.3%,11m
5710,2,[GELSEN]Masaru,3656,30,1,5,6,16.7%,4m
5710,2,[SLD]kraytos,3656,30,1,5,6,16.7%,13m
5710,2,fqsfqsdfqzef,3656,101,1,9,10,10.0%,19m
5710,2,Tito,3656,0,0,1,1,0.0%,8m
5721,2,HOWLINGALPHA,3655,828,147,136,283,51.9%,15m
5721,2,Red,3655,1605,90,67,157,57.3%,11m
5721,2,CatchaBreath,3655,786,79,79,158,50.0%,8m
5721,2,CheeseGrater,3655,1474,78,61,139,56.1%,35m
5721,2,miEye,3655,1000,41,35,76,53.9%,3m
5721,2,[FxL]mmTOOshae,3655,866,37,39,76,48.7%,36m
5721,2,Kachu,3655,718,27,29,56,48.2%,5m
5721,3,Trucik,3655,316,14,7,21,66.7%,18m
5721,2,AOskipta,3655,343,12,8,20,60.0%,5m
5721,2,SuperSCBOY,3655,141,9,1,10,90.0%,7m
5721,2,[Novus]CiphroN,3655,95,6,0,6,100.0%,13m
5721,2,[МУЛ]IceKing,3655,146,5,4,9,55.6%,13m
5721,2,Baam,3655,140,4,3,7,57.1%,14m
5721,2,nerfzergs,3655,114,4,5,9,44.4%,22m
5721,2,[08I5]SlAvY,3655,0,1,2,3,33.3%,35m
5736,1,[CivW]HouseVibeZ,3654,1306,198,192,390,50.8%,17m
5736,2,svampbob,3654,782,33,24,57,57.9%,9m
5736,2,[ZNARK]Lucas,3654,186,5,2,7,71.4%,6m
5736,1,Metho,3654,184,5,21,26,19.2%,16m
5736,2,Honorius,3654,142,4,4,8,50.0%,10m
5736,2,supernoob,3654,86,4,5,9,44.4%,35m
5736,2,IwearNoPants,3654,30,2,3,5,40.0%,9m
5736,2,Solmyr,3654,0,1,1,2,50.0%,13m
5736,2,RefoH,3654,0,0,1,1,0.0%,3m
5745,2,lllIllllIlll,3653,1559,99,43,142,69.7%,35m
5745,2,[NWGD]Destroyer,3653,199,42,13,55,76.4%,14m
5745,2,Pollux,3653,473,19,13,32,59.4%,15m
5745,2,[TAW]Pote,3653,170,8,10,18,44.4%,12m
5745,2,[sGeeks]Skogshuggarn,3653,60,2,3,5,40.0%,22m
5745,2,Homelander,3653,0,1,1,2,50.0%,16m
5745,1,BILICH,3653,48,1,3,4,25.0%,11m
5752,2,OncleCrabby,3652,1407,62,43,105,59.0%,13m
5752,2,Taxa,3652,688,34,28,62,54.8%,12m
5752,2,MAX,3652,454,17,14,31,54.8%,10m
5752,2,[Z3RGTV]CREATIV,3652,224,8,10,18,44.4%,12m
5752,2,[VetM]KimboSlice,3652,132,5,12,17,29.4%,11m
5752,2,DoggoDerp,3652,0,4,1,5,80.0%,15m
5752,2,[CuWoǂ]Waffel,3652,60,3,3,6,50.0%,11m
5752,2,Stayback,3652,30,2,1,3,66.7%,8m
5752,2,siaukia,3652,30,2,3,5,40.0%,12m
5752,2,kev,3652,0,1,0,1,100.0%,36m
5752,2,[glhfun]Lúkémàkèr,3652,0,1,0,1,100.0%,21m
5752,2,[KörSa]Neiko,3652,0,1,1,2,50.0%,18m
5752,3,[Chrys]Sharen,3652,0,0,1,1,0.0%,15m
5765,2,pixel,3651,1451,283,277,560,50.5%,13m
5765,2,Thunder,3651,704,56,59,115,48.7%,14m
5765,2,Roman,3651,997,39,36,75,52.0%,35m
5765,3,[EMASC]Zeratum,3651,242,8,5,13,61.5%,36m
5765,2,[TÆR]Raku,3651,0,0,1,1,0.0%,21m
5765,3,Achilles,3651,0,0,5,5,0.0%,10m
5771,2,LeGenD,3650,1599,121,111,232,52.2%,11m
5771,2,Tosh,3650,506,24,23,47,51.1%,12m
5771,2,shpetska,3650,487,22,11,33,66.7%,8m
5771,2,Chiffa,3650,373,14,9,23,60.9%,8m
5771,2,[LDAD]Kugelburger,3650,372,14,13,27,51.9%,19m
5771,2,Sadistic,3650,30,1,1,2,50.0%,13m
5777,2,gangsta,3649,1590,150,130,280,53.6%,11m
5777,2,Drakonidoss,3649,1495,77,88,165,46.7%,10m
5777,2,[HsDL]Trebo,3649,1122,62,48,110,56.4%,13m
5777,2,[Hrr]zag,3649,644,34,13,47,72.3%,4m
5777,2,CaptaiN,3649,320,12,14,26,46.2%,35m
5777,2,[aW]erra,3649,137,12,14,26,46.2%,8m
5777,2,Reito,3649,95,4,2,6,66.7%,14m
5777,2,KernelPanic,3649,30,2,0,2,100.0%,21m
5777,2,[AlIin]EUez,3649,95,1,4,5,20.0%,10m
5777,2,[CCHP]erfoint,3649,0,0,1,1,0.0%,11m
5787,2,Shabby,3648,1430,69,73,142,48.6%,35m
5787,2,Uiblar,3648,717,38,14,52,73.1%,11m
5787,2,epicvoid,3648,443,23,6,29,79.3%,12m
5787,2,Player,3648,206,7,10,17,41.2%,8m
5791,2,[ArGGEU]BeNeFiT,3647,1515,97,79,176,55.1%,35m
5791,2,Tessaiga,3647,884,37,30,67,55.2%,35m
5791,2,[Scam]CarimJamal,3647,527,24,14,38,63.2%,11m
5791,2,[BbLanD]Isku,3647,535,23,15,38,60.5%,18m
5791,2,Gilgamesh,3647,520,22,21,43,51.2%,9m
5791,2,Donek,3647,370,15,7,22,68.2%,4m
5791,2,SpecialNoOne,3647,312,12,14,26,46.2%,22m
5791,2,[RFAM]PuupyButhole,3647,162,5,1,6,83.3%,21m
5791,2,Booker,3647,102,3,5,8,37.5%,14m
5791,2,KRGMToss,3647,0,0,1,1,0.0%,14m
5801,2,ЛомаюЛица,3646,869,45,18,63,71.4%,35m
5801,2,FrankDrebin,3646,1051,43,46,89,48.3%,13m
5801,2,[ĞǂĐ]Warlord,3646,634,25,20,45,55.6%,10m
5801,2,BrigittaB,3646,153,7,0,7,100.0%,11m
5801,2,Fartosis,3646,131,7,5,12,58.3%,7m
5801,2,JAckie,3646,154,6,5,11,54.5%,10m
5801,2,[LAMPA]ValertinG,3646,174,6,8,14,42.9%,11m
5801,2,NFloN,3646,0,1,0,1,100.0%,17m
5801,3,CvsforyoU,3646,0,1,0,1,100.0%,8m
5801,2,stroier,3646,30,1,5,6,16.7%,13m
5801,2,[UAONE]shadowstorm,3646,0,0,1,1,0.0%,9m
5801,2,[Spec0p]uvd,3646,0,0,1,1,0.0%,21m
5813,2,Nikoxlas,3645,1573,163,147,310,52.6%,12m
5813,2,[EGi]Fenrir,3645,630,85,93,178,47.8%,8m
5813,3,RAT,3645,281,13,5,18,72.2%,13m
5813,2,Neroc,3645,146,6,4,10,60.0%,15m
5813,2,Rokys,3645,97,5,13,18,27.8%,8m
5813,3,[Fridge]Shiro,3645,97,2,2,4,50.0%,36m
5813,1,Dragon,3645,0,1,0,1,100.0%,21m
5813,3,[SRC]MooDuck,3645,0,1,1,2,50.0%,36m
5821,2,[MCLAU]Pamchichi,3644,1604,173,174,347,49.9%,35m
5821,2,Vlad,3644,825,69,47,116,59.5%,20m
5821,2,Turambarchik,3644,519,48,48,96,50.0%,6m
5821,2,kuK,3644,479,23,24,47,48.9%,21m
5821,2,[EAU]BalsaMiKe,3644,30,2,0,2,100.0%,21m
5821,2,[X3S]Ankou,3644,30,2,2,4,50.0%,6m
5821,2,Diuen,3644,0,1,0,1,100.0%,11m
5821,2,Quest,3644,0,1,0,1,100.0%,22m
5821,2,Fifteen,3644,0,1,0,1,100.0%,10m
5821,3,sophy,3644,0,1,0,1,100.0%,10m
5831,2,[RealEG]fabfab,3643,1315,141,128,269,52.4%,35m
5831,2,[FRAG]Faraday,3643,817,58,56,114,50.9%,19m
5831,2,[BoJeuu]aDiBoO,3643,623,24,23,47,51.1%,11m
5831,2,styx,3643,272,11,5,16,68.8%,20m
5831,2,Romance,3643,148,6,4,10,60.0%,13m
5831,2,littleINno,3643,0,1,0,1,100.0%,10m
5831,1,[TRLM]Amazing,3643,0,0,2,2,0.0%,20m
5838,2,SunLight,3642,582,33,18,51,64.7%,3m
5838,1,[TonT0n]Tonstor,3642,871,29,39,68,42.6%,18m
5838,2,KiteYou,3642,106,4,0,4,100.0%,19m
5838,2,[AiRǂ]DemoN,3642,58,2,2,4,50.0%,18m
5838,2,[Ǽ1]AiacoS,3642,30,1,2,3,33.3%,11m
5838,2,SKiiLlerZ,3642,0,0,1,1,0.0%,11m
5844,2,Génésis,3641,839,35,28,63,55.6%,35m
5844,3,Egg,3641,295,13,3,16,81.2%,12m
5844,2,[TFSC]Wormms,3641,176,7,4,11,63.6%,22m
5844,2,FlorianV,3641,0,1,1,2,50.0%,15m
5848,2,Bluelight,3640,736,47,44,91,51.6%,12m
5848,2,strem,3640,794,44,16,60,73.3%,9m
5848,2,[mfixed]Ablaze,3640,831,34,44,78,43.6%,14m
5848,2,Schlumpf,3640,336,12,16,28,42.9%,16m
5848,2,Cassedi,3640,102,4,4,8,50.0%,11m
5848,2,BattleOoze,3640,136,3,1,4,75.0%,10m
5848,2,[Kingz]fuminhos,3640,30,1,5,6,16.7%,14m
5848,2,BlackWiDow,3640,0,0,1,1,0.0%,22m
5848,2,rustek,3640,0,0,1,1,0.0%,12m
5848,2,Containment,3640,0,0,2,2,0.0%,35m
5858,2,[MAKinG]xTrIckKsHotx,3639,1298,77,20,97,79.4%,16m
5858,2,cloudoff,3639,436,30,31,61,49.2%,3m
5858,2,[RÐ]daresse,3639,479,25,8,33,75.8%,18m
5858,2,DioR,3639,568,21,30,51,41.2%,15m
5858,2,EnderWiggin,3639,456,17,15,32,53.1%,11m
5858,2,CCCR,3639,522,17,27,44,38.6%,12m
5858,2,Haley,3639,168,14,9,23,60.9%,3m
5858,2,[Turb0o]ShizZ,3639,146,5,4,9,55.6%,21m
5858,2,WhiteFeather,3639,116,5,8,13,38.5%,22m
5858,2,Sloth,3639,62,2,6,8,25.0%,11m
5858,2,Vozark,3639,0,1,0,1,100.0%,16m
5858,2,[GZerO]Classic,3639,30,1,4,5,20.0%,18m
5858,3,[dGAz]sLadE,3639,0,0,1,1,0.0%,6m
5871,2,[Chariz]Alto,3638,1341,229,231,460,49.8%,7m
5871,2,Akillerduck,3638,483,96,96,192,50.0%,13m
5871,2,PurpleStuff,3638,142,7,6,13,53.8%,7m
5871,1,[llBGll]INvinCiBLe,3638,90,2,6,8,25.0%,21m
5871,2,[ƮesXG]cLoaK,3638,0,1,0,1,100.0%,10m
5871,2,prototype,3638,30,1,1,2,50.0%,18m
5877,2,Justacheeser,3637,1603,118,115,233,50.6%,20m
5877,2,[Sky22]ANAS,3637,1420,68,63,131,51.9%,35m
5877,2,Optimist,3637,1186,44,44,88,50.0%,14m
5877,2,RetorieS,3637,254,9,12,21,42.9%,21m
5877,2,Genadi,3637,58,2,2,4,50.0%,20m
5877,3,GmTBigCohiba,3637,0,0,1,1,0.0%,13m
5877,2,Lewwawurscht,3637,0,0,1,1,0.0%,21m
5884,2,magnnumpaul,3636,1638,341,334,675,50.5%,17m
5884,2,[UTGEU]BeefJerke,3636,695,43,40,83,51.8%,21m
5884,2,Bodo,3636,565,24,13,37,64.9%,11m
5884,2,OniKratos,3636,502,17,20,37,45.9%,18m
5884,2,Саша,3636,266,10,11,21,47.6%,19m
5884,2,[SxS]IlllIIlllllI,3636,274,9,14,23,39.1%,3m
5884,2,IDINAHUY,3636,114,7,1,8,87.5%,14m
5884,2,noodlewalger,3636,88,6,0,6,100.0%,4m
5884,1,Veganmeister,3636,97,2,1,3,66.7%,21m
5893,2,[NetGG]PrettyFly,3635,1011,53,49,102,52.0%,21m
5893,2,blrpapa,3635,599,40,21,61,65.6%,19m
5893,2,[Slaƴer]Extreme,3635,620,26,19,45,57.8%,12m
5893,2,RXM,3635,530,21,17,38,55.3%,18m
5893,2,[BjwA]Garrus,3635,276,11,11,22,50.0%,14m
5893,2,MoLineRo,3635,120,4,7,11,36.4%,12m
5893,2,javiorpas,3635,30,1,2,3,33.3%,17m
5893,3,[Negas]GoliasCZ,3635,0,1,3,4,25.0%,12m
5893,2,[fаl]dreadlord,3635,0,0,1,1,0.0%,7m
5893,2,[GWGpp]Dzej,3635,0,0,3,3,0.0%,8m
5903,2,[FoBro]Phish,3634,1604,349,347,696,50.1%,4m
5903,2,[IceHus]PonzaLite,3634,1514,165,153,318,51.9%,13m
5903,1,Puls,3634,1749,133,149,282,47.2%,35m
5903,2,Lukas,3634,1546,117,98,215,54.4%,35m
5903,2,[Sarmat]Mewa,3634,1288,59,40,99,59.6%,18m
5903,3,NightKnight,3634,310,14,8,22,63.6%,4m
5903,2,paknrozerg,3634,260,9,5,14,64.3%,4m
5903,3,Czech,3634,232,8,0,8,100.0%,21m
5903,2,SWEEPER,3634,86,4,1,5,80.0%,3m
5903,2,[TirolA]bodia,3634,86,4,1,5,80.0%,11m
5903,2,miki,3634,118,4,9,13,30.8%,35m
5914,2,Rottmayr,3633,232,30,23,53,56.6%,10m
5914,2,SKliveevil,3633,522,21,20,41,51.2%,8m
5914,3,[JTDC]Kirika,3633,203,6,6,12,50.0%,12m
5914,2,Xamine,3633,124,5,8,13,38.5%,14m
5914,2,[DNKСFТ]BenDover,3633,52,4,4,8,50.0%,15m
5914,2,[ZHxWM]jadun,3633,0,2,3,5,40.0%,16m
5914,2,[PSlSTC]Minimoog,3633,0,2,3,5,40.0%,21m
5914,2,Georg,3633,97,1,3,4,25.0%,4m
5914,2,Qyinki,3633,30,1,5,6,16.7%,20m
5914,2,[LSPs]VitoCorLeonE,3633,0,0,1,1,0.0%,14m
5924,2,Huckey,3632,1546,400,402,802,49.9%,11m
5924,2,llllllllllll,3632,1546,101,81,182,55.5%,3m
5924,2,[PBZ]BlackMamba,3632,1288,66,49,115,57.4%,4m
5924,2,Lexia,3632,1067,59,57,116,50.9%,9m
5924,2,Виктор,3632,1144,56,44,100,56.0%,35m
5924,2,kazer,3632,388,15,15,30,50.0%,35m
5924,2,Kratos,3632,272,9,7,16,56.2%,20m
5924,2,[BN]Pirouli,3632,0,1,2,3,33.3%,6m
5924,2,Jonny,3632,0,0,1,1,0.0%,8m
5933,2,volanis,3631,535,76,73,149,51.0%,15m
5933,2,AllThumbs,3631,1189,64,31,95,67.4%,4m
5933,2,Robato,3631,718,48,45,93,51.6%,11m
5933,2,Jacke,3631,668,26,24,50,52.0%,11m
5933,2,FuseZut,3631,221,16,5,21,76.2%,21m
5933,2,FaKeR,3631,182,7,6,13,53.8%,12m
5933,2,[evi1]evilwasp,3631,236,7,9,16,43.8%,4m
5933,2,Hyperus,3631,216,5,5,10,50.0%,14m
5933,2,[NL]DeadKid,3631,0,0,1,1,0.0%,20m
5933,2,Chimera,3631,0,0,1,1,0.0%,18m
5943,2,[Ohje]kleNo,3630,701,238,236,474,50.2%,14m
5943,2,GoodWin,3630,1158,57,33,90,63.3%,8m
5943,2,Michalaa,3630,414,40,24,64,62.5%,5m
5943,2,Shapechange,3630,436,25,23,48,52.1%,19m
5943,2,Tsogi,3630,369,21,5,26,80.8%,9m
5943,2,opo,3630,263,11,3,14,78.6%,22m
5943,2,[SC2TIM]Tricks,3630,180,9,4,13,69.2%,22m
5943,3,LilGranny,3630,249,8,14,22,36.4%,18m
5943,2,зерг,3630,116,5,3,8,62.5%,35m
5943,2,[LoLa]Tudar,3630,168,5,7,12,41.7%,6m
5943,2,lohgff,3630,0,3,6,9,33.3%,18m
5954,2,гриха,3629,1458,96,74,170,56.5%,18m
5954,2,Griffon,3629,977,42,35,77,54.5%,22m
5954,3,[Togata]Mirio,3629,285,13,5,18,72.2%,3m
5954,3,Javeroth,3629,244,7,5,12,58.3%,14m
5954,2,[HOA]dvh,3629,58,3,1,4,75.0%,18m
5954,2,Freedom,3629,0,1,0,1,100.0%,15m
5954,2,[GGxC]TheGREYBUSH,3629,0,1,0,1,100.0%,11m
5954,2,[Arisa]Crystal,3629,0,1,0,1,100.0%,22m
5954,2,GoFGohegdeH,3629,0,1,3,4,25.0%,35m
5954,2,[AdHx]Hotzenplotz,3629,0,1,4,5,20.0%,14m
5954,2,George,3629,0,0,1,1,0.0%,35m
5954,2,[CLD9]DwiGHTY,3629,0,0,1,1,0.0%,18m
5954,2,[IndyK]ZaGGara,3629,0,0,1,1,0.0%,11m
5954,2,JoeBiden,3629,0,0,2,2,0.0%,11m
5968,2,PreD,3628,1531,123,127,250,49.2%,7m
5968,1,Secret,3628,1612,72,81,153,47.1%,7m
5968,2,[embsys]embsysICE,3628,654,35,21,56,62.5%,35m
5968,2,Tychitius,3628,581,28,7,35,80.0%,9m
5968,2,[BLFL]Torvald,3628,379,15,8,23,65.2%,18m
5968,2,alex,3628,243,11,9,20,55.0%,21m
5968,2,yaki,3628,212,8,14,22,36.4%,18m
5968,2,RuntimeError,3628,60,5,6,11,45.5%,21m
5968,1,[Kompis]KALLINZOOOR,3628,187,4,3,7,57.1%,35m
5968,2,[SGZARM]Arthur,3628,30,2,0,2,100.0%,11m
5968,2,[evi1]fulgertuney,3628,30,2,2,4,50.0%,5m
5968,2,[CocoCo]BlackHawk,3628,0,1,0,1,100.0%,10m
5968,2,BabyPartinG,3628,30,1,3,4,25.0%,35m
5968,2,Rayder,3628,0,1,4,5,20.0%,17m
5982,2,[PhC]Shinja,3627,1182,58,39,97,59.8%,5m
5982,2,illumiNation,3627,698,30,21,51,58.8%,10m
5982,2,[Heroes]Beacon,3627,316,23,18,41,56.1%,13m
5982,2,EpicBEER,3627,220,8,6,14,57.1%,19m
5982,2,MarineMenace,3627,163,7,5,12,58.3%,11m
5982,2,seppukuban,3627,189,6,2,8,75.0%,22m
5982,2,BVE,3627,106,5,4,9,55.6%,13m
5982,2,llllllllllll,3627,88,3,0,3,100.0%,9m
5982,2,[IX9TH]Deidara,3627,58,3,1,4,75.0%,35m
5982,2,[ЦЭ]RESISTE,3627,30,2,0,2,100.0%,11m
5982,2,Judeau,3627,30,1,1,2,50.0%,3m
5982,2,Valdemar,3627,0,0,1,1,0.0%,7m
5982,2,[4SVs]Alan,3627,0,0,1,1,0.0%,35m
5982,2,[MkersA]ClusterFCUK,3627,0,0,1,1,0.0%,10m
5996,2,Vision,3626,1475,152,120,272,55.9%,35m
5996,2,[aW]Sins,3626,1546,119,102,221,53.8%,18m
5996,2,Seldon,3626,917,59,42,101,58.4%,17m
5996,1,futurclassic,3626,1333,43,59,102,42.2%,21m
5996,2,RechteSocke,3626,925,42,20,62,67.7%,14m
5996,2,Vamskie,3626,671,36,25,61,59.0%,22m
5996,2,Digiaunt,3626,553,23,15,38,60.5%,17m
5996,2,Greedy,3626,158,21,21,42,50.0%,4m
5996,2,stubborn,3626,350,13,11,24,54.2%,14m
5996,3,KERIMOVICH,3626,114,5,0,5,100.0%,21m
5996,2,[SJSr]ChainBurn,3626,0,1,0,1,100.0%,3m
5996,2,[Forev]ascetic,3626,88,1,1,2,50.0%,11m
5996,2,TCh,3626,0,0,1,1,0.0%,20m
5996,2,[ÆR]Cerkof,3626,73,0,2,2,0.0%,21m
5996,2,[4EYES]DasAuto,3626,0,0,4,4,0.0%,4m
6011,1,IIIIIIIIIIII,3625,1489,139,136,275,50.5%,19m
6011,2,[Xa]Nash,3625,1538,101,106,207,48.8%,35m
6011,2,[LezLox]WanBeParting,3625,467,21,13,34,61.8%,19m
6011,2,[DSTARI]Nedved,3625,282,10,18,28,35.7%,11m
6011,2,FKKLord,3625,166,5,2,7,71.4%,13m
6011,2,[TTDK]Maque,3625,156,5,14,19,26.3%,11m
6011,2,Alprazolam,3625,136,3,2,5,60.0%,6m
6018,2,Timmsh,3624,1525,124,127,251,49.4%,13m
6018,2,[ƮesXG]Endo,3624,634,110,112,222,49.5%,3m
6018,2,iTERRAN,3624,1004,91,76,167,54.5%,20m
6018,2,[Looser]GoodOldZK,3624,398,31,23,54,57.4%,11m
6018,2,[oDTCo]Salmaj,3624,200,8,7,15,53.3%,35m
6018,2,VILL,3624,104,7,1,8,87.5%,11m
6018,2,[FZTW]Trycatchme,3624,41,7,8,15,46.7%,14m
6018,2,Hølm,3624,95,5,2,7,71.4%,6m
6018,2,IllIlIIlIIIl,3624,150,5,10,15,33.3%,15m
6018,2,[GRUYER]Matliv,3624,88,3,9,12,25.0%,19m
6018,2,[rikard]Shawn,3624,0,0,1,1,0.0%,16m
6029,2,[HlvtG]RKnightxX,3623,1464,361,325,686,52.6%,10m
6029,2,GhOst,3623,939,81,76,157,51.6%,15m
6029,2,[lLegit]Smurfy,3623,1233,56,48,104,53.8%,19m
6029,2,FalconPawnch,3623,756,28,30,58,48.3%,8m
6029,2,BCNHumanoid,3623,469,19,15,34,55.9%,4m
6029,2,eXcaLibur,3623,366,16,8,24,66.7%,4m
6029,2,[PiTi]Анунаки,3623,186,6,3,9,66.7%,11m
6029,2,HanoverLappy,3623,30,2,0,2,100.0%,11m
6029,1,[EESC]ShaDow,3623,0,0,1,1,0.0%,16m
6029,2,[Hаsu]MEDVED,3623,0,0,2,2,0.0%,16m
6039,2,Mordegard,3622,842,295,269,564,52.3%,20m
6039,1,Benno,3622,1432,181,177,358,50.6%,9m
6039,2,StarLight,3622,1598,153,147,300,51.0%,10m
6039,2,Anetor,3622,814,136,131,267,50.9%,5m
6039,2,Anzen,3622,1231,71,49,120,59.2%,15m
6039,2,[Yame]GEEK,3622,590,24,22,46,52.2%,35m
6039,2,LittleStorm,3622,540,20,24,44,45.5%,14m
6039,2,Granate,3622,62,5,6,11,45.5%,7m
6039,2,[CsT]Kharnos,3622,286,5,20,25,20.0%,3m
6039,1,IIIIIIIIIIII,3622,0,3,4,7,42.9%,3m
6039,2,[Pümmel]BlackArrow,3622,114,2,2,4,50.0%,11m
6039,2,IIIIIIIIIIII,3622,0,1,4,5,20.0%,11m
6039,1,[Dobro]ProStyMe,3622,0,0,2,2,0.0%,11m
6052,2,Bart,3621,820,66,57,123,53.7%,36m
6052,2,[Peeps]TGO,3621,748,52,55,107,48.6%,21m
6052,2,[BED]Pulse,3621,866,30,37,67,44.8%,21m
6052,2,OnlySP,3621,502,20,19,39,51.3%,14m
6052,2,Magikarp,3621,275,15,4,19,78.9%,35m
6052,1,HBoy,3621,167,9,3,12,75.0%,13m
6052,1,CANNONRUSH,3621,205,6,2,8,75.0%,19m
6052,2,PiggieSmalls,3621,58,4,5,9,44.4%,35m
6052,2,[AiRǂ]OnePatchMan,3621,141,3,5,8,37.5%,21m
6052,2,Mayhem,3621,0,1,0,1,100.0%,11m
6052,2,Kelthuzda,3621,0,0,1,1,0.0%,35m
6063,2,Анастасия,3620,1597,188,157,345,54.5%,9m
6063,2,FCA,3620,1071,137,135,272,50.4%,35m
6063,2,[ZERGML]multiman,3620,363,94,80,174,54.0%,3m
6063,2,IlIllIIllIII,3620,901,76,68,144,52.8%,11m
6063,2,XAN,3620,570,36,28,64,56.2%,21m
6063,2,hlemyzd,3620,730,31,28,59,52.5%,3m
6063,2,[StalkZ]Grrrr,3620,279,11,5,16,68.8%,21m
6063,2,Damon,3620,120,4,5,9,44.4%,21m
6063,2,[GrandT]SnoolP,3620,0,1,0,1,100.0%,19m
6072,2,ReaDer,3619,1450,220,201,421,52.3%,11m
6072,2,Talandar,3619,1629,202,195,397,50.9%,35m
6072,2,Blossom,3619,1471,199,179,378,52.6%,13m
6072,2,Rendom,3619,1574,140,122,262,53.4%,36m
6072,2,[echo]Duende,3619,1250,87,85,172,50.6%,18m
6072,2,BERBERECHOS,3619,167,10,2,12,83.3%,16m
6072,2,Pallekan,3619,114,5,4,9,55.6%,3m
6072,2,Random,3619,88,1,2,3,33.3%,11m
6072,2,[KMNO]kavitXD,3619,0,0,2,2,0.0%,3m
6081,2,Zergatul,3618,1589,278,276,554,50.2%,8m
6081,2,Molybdenum,3618,150,15,4,19,78.9%,21m
6081,2,[CLICKk]Draco,3618,265,12,6,18,66.7%,35m
6081,2,[Dz]DzJeth,3618,326,11,18,29,37.9%,9m
6081,2,TeddyB,3618,292,10,11,21,47.6%,13m
6081,2,kokochA,3618,232,9,9,18,50.0%,13m
6081,2,IIIIIIIIIIII,3618,0,2,3,5,40.0%,15m
6081,2,[SaMco]MrMushroom,3618,0,1,0,1,100.0%,12m
6081,2,ElunMosk,3618,0,0,1,1,0.0%,35m
6081,3,CanIWatch,3618,0,0,5,5,0.0%,17m
6091,2,[RToTD]Nergal,3617,1465,194,173,367,52.9%,35m
6091,2,[MacG]MathiasSucks,3617,807,150,113,263,57.0%,4m
6091,2,[NLTN]niko,3617,1121,95,95,190,50.0%,3m
6091,2,HerMarenko,3617,965,53,46,99,53.5%,9m
6091,2,[loxi]Oroch,3617,681,43,27,70,61.4%,20m
6091,2,[FR1]AstRaxx,3617,460,22,13,35,62.9%,18m
6091,2,Edouard,3617,137,9,10,19,47.4%,11m
6091,3,Pruhtoisium,3617,149,4,3,7,57.1%,17m
6091,2,Backdraft,3617,0,0,1,1,0.0%,10m
6100,2,Mura,3616,1566,145,120,265,54.7%,14m
6100,2,[IceHus]СТИМПАК,3616,1109,100,105,205,48.8%,35m
6100,2,Else,3616,461,51,51,102,50.0%,11m
6100,2,[ANUUS]Yahmacka,3616,424,15,21,36,41.7%,35m
6100,2,[ChTe]TTurRedSheEp,3616,58,3,1,4,75.0%,6m
6100,2,Tio,3616,0,3,2,5,60.0%,14m
6100,2,ChipSuey,3616,30,2,5,7,28.6%,35m
6100,2,Coldeye,3616,58,2,6,8,25.0%,11m
6100,2,FRY,3616,0,1,0,1,100.0%,13m
6100,2,Simon,3616,0,1,0,1,100.0%,7m
6100,2,[Kh4os]Shurath,3616,0,1,1,2,50.0%,3m
6100,2,Cherminator,3616,30,1,1,2,50.0%,13m
6100,2,MowingMonkey,3616,30,1,2,3,33.3%,11m
6100,2,Crumpet,3616,0,0,1,1,0.0%,6m
6100,2,Raikon,3616,0,0,2,2,0.0%,12m
6115,2,Tilo,3615,1552,199,177,376,52.9%,3m
6115,2,Gizmo,3615,1545,139,108,247,56.3%,18m
6115,2,[IMORTp]KairosVI,3615,896,123,115,238,51.7%,18m
6115,2,DANGER,3615,1356,115,107,222,51.8%,14m
6115,2,dAroPL,3615,1580,105,85,190,55.3%,12m
6115,2,[AFed]Bodach,3615,778,78,57,135,57.8%,14m
6115,2,Romance,3615,1392,75,63,138,54.3%,21m
6115,2,Skendau,3615,1297,67,64,131,51.1%,6m
6115,2,korslash,3615,584,35,44,79,44.3%,11m
6115,2,[yubm]Eyþór,3615,60,3,1,4,75.0%,6m
6115,2,OldYoghurt,3615,88,1,1,2,50.0%,3m
6115,2,гидрочка,3615,0,1,2,3,33.3%,35m
6127,2,betongapa,3614,1525,144,145,289,49.8%,13m
6127,2,lllllllllll,3614,449,26,9,35,74.3%,9m
6127,2,Pikapikachu,3614,443,23,9,32,71.9%,35m
6127,2,[Viva]Rubalom,3614,319,21,23,44,47.7%,35m
6127,2,func,3614,506,17,26,43,39.5%,11m
6127,2,[OCTANE]Shemet,3614,340,11,10,21,52.4%,8m
6127,2,dionisius,3614,288,10,7,17,58.8%,13m
6127,2,[7ee]KrOnUs,3614,194,8,7,15,53.3%,19m
6127,2,Marco,3614,30,2,2,4,50.0%,22m
6127,2,[2H]Aleksandr,3614,30,2,4,6,33.3%,4m
6127,2,LittleChino,3614,30,1,6,7,14.3%,20m
6127,2,[SpCI]RAMZESPL,3614,0,0,1,1,0.0%,35m
6139,2,Palladium,3613,905,124,115,239,51.9%,11m
6139,2,Executor,3613,1432,60,50,110,54.5%,14m
6139,2,Sandkink,3613,594,51,47,98,52.0%,6m
6139,2,Desmond,3613,979,48,33,81,59.3%,22m
6139,1,Ден,3613,165,7,4,11,63.6%,11m
6139,2,Cropon,3613,152,4,3,7,57.1%,15m
6139,2,Tony,3613,58,3,1,4,75.0%,3m
6139,2,[eXøde]Tadashe,3613,126,3,2,5,60.0%,11m
6139,2,Sova,3613,58,2,3,5,40.0%,3m
6139,2,[HsDL]MavericK,3613,30,1,1,2,50.0%,13m
6139,2,InfinitY,3613,0,0,1,1,0.0%,13m
6139,2,Meika,3613,0,0,4,4,0.0%,11m
6151,2,[JnduGG]winkzzzzzzzz,3612,725,46,37,83,55.4%,5m
6151,2,Vamis,3612,543,22,28,50,44.0%,21m
6151,2,[CIique]WetLettuce,3612,114,11,9,20,55.0%,35m
6151,2,[SO0S]Roxxas,3612,254,10,6,16,62.5%,11m
6151,2,MrKuroNeko,3612,50,4,5,9,44.4%,3m
6151,2,[RBlood]Zéké,3612,140,3,3,6,50.0%,8m
6151,2,Lyuganok,3612,97,2,0,2,100.0%,5m
6151,2,FleSh,3612,30,2,2,4,50.0%,6m
6151,2,NolaN,3612,0,0,1,1,0.0%,22m
6151,2,NaQa,3612,0,0,1,1,0.0%,19m
6151,2,[GZerO]tainy,3612,0,0,1,1,0.0%,16m
6162,2,[Heroes]Knails,3611,1187,162,155,317,51.1%,3m
6162,2,LightCoffee,3611,1638,115,115,230,50.0%,10m
6162,2,Phoenix,3611,803,63,2,65,96.9%,6m
6162,2,mihayloff,3611,1037,49,57,106,46.2%,3m
6162,2,[SEWP]Arthur,3611,758,33,24,57,57.9%,3m
6162,2,Starboy,3611,314,14,6,20,70.0%,20m
6162,2,Hydra,3611,392,14,15,29,48.3%,22m
6162,2,[0BO]threepio,3611,340,12,10,22,54.5%,3m
6162,2,NIKITOS,3611,270,9,14,23,39.1%,21m
6162,2,[EGi]MichZor,3611,226,7,5,12,58.3%,12m
6162,2,waughmonger,3611,58,2,4,6,33.3%,7m
6162,2,[Hrr]Безразличие,3611,0,1,1,2,50.0%,3m
6174,2,Enarior,3610,1012,62,49,111,55.9%,6m
6174,2,MoDnUyYrOk,3610,773,50,46,96,52.1%,14m
6174,3,[Kipu4]eXoValdo,3610,302,11,3,14,78.6%,6m
6174,2,electricity,3610,180,9,7,16,56.2%,14m
6174,2,[SpaceB]LoneStar,3610,167,7,2,9,77.8%,19m
6174,2,HaWK,3610,114,4,8,12,33.3%,3m
6174,2,[UnWp]nWpLawliet,3610,58,3,2,5,60.0%,13m
6174,3,Retarded,3610,121,3,2,5,60.0%,20m
6174,2,CaptainTruel,3610,0,0,1,1,0.0%,18m
6174,1,hunterkiller,3610,0,0,1,1,0.0%,4m
6184,2,Hans,3609,871,104,96,200,52.0%,22m
6184,2,[RSPCT]Ariken,3609,588,69,36,105,65.7%,5m
6184,2,zumBerg,3609,249,21,27,48,43.8%,35m
6184,2,[2G1M]Mime,3609,416,15,13,28,53.6%,18m
6184,2,Mamedkonfet,3609,194,8,12,20,40.0%,14m
6184,2,[xTQc]Soulkey,3609,88,6,0,6,100.0%,18m
6184,2,TheNonschi,3609,0,1,0,1,100.0%,3m
6184,2,Reizor,3609,0,0,1,1,0.0%,5m
6184,2,[MHACKS]Fenris,3609,0,0,1,1,0.0%,13m
6193,2,IJVH,3608,1585,182,144,326,55.8%,3m
6193,2,[RTrain]Maix,3608,920,74,70,144,51.4%,11m
6193,2,Ozymandias,3608,1190,44,47,91,48.4%,11m
6193,2,DogTor,3608,446,15,19,34,44.1%,14m
6193,2,[BuO]LULkAKTUS,3608,365,14,9,23,60.9%,35m
6193,2,[mfixed]drzungla,3608,191,10,0,10,100.0%,12m
6193,2,Hoola,3608,260,9,7,16,56.2%,22m
6193,2,NaRuD,3608,112,3,1,4,75.0%,6m
6193,2,OhmInpw,3608,60,2,3,5,40.0%,4m
6193,2,Odenetheus,3608,58,2,4,6,33.3%,17m
6193,2,NoName,3608,0,1,0,1,100.0%,19m
6204,2,Bear,3607,1279,68,50,118,57.6%,18m
6204,2,[RIPNA]riperino,3607,681,45,16,61,73.8%,11m
6204,2,Zeratul,3607,465,21,15,36,58.3%,20m
6204,2,Cloverfield,3607,154,9,2,11,81.8%,11m
6204,2,mobo,3607,145,8,4,12,66.7%,14m
6204,2,[TedB]Anahoret,3607,178,6,9,15,40.0%,12m
6204,2,Eldrassan,3607,128,3,3,6,50.0%,5m
6204,1,Salo,3607,173,3,6,9,33.3%,5m
6204,2,SkIoASarkan,3607,30,2,6,8,25.0%,11m
6204,2,Lohikäärme,3607,0,1,0,1,100.0%,18m
6204,2,GodLiKe,3607,0,1,0,1,100.0%,5m
6204,2,Planck,3607,0,1,4,5,20.0%,4m
6204,2,BrendaSesel,3607,0,1,5,6,16.7%,14m
6217,2,[LYBITE]leonidas,3606,1579,77,57,134,57.5%,3m
6217,2,[Hentaі]WhinersTears,3606,197,16,6,22,72.7%,13m
6217,2,[1239]Xenon,3606,338,11,27,38,28.9%,10m
6217,2,GoodLuckHave,3606,141,4,3,7,57.1%,18m
6217,2,Fitz,3606,0,1,0,1,100.0%,5m
6217,2,Aegis,3606,0,0,1,1,0.0%,16m
6217,2,XDXD,3606,0,0,1,1,0.0%,35m
6224,2,Melancholy,3605,887,65,62,127,51.2%,22m
6224,2,[elCrab]Gazmyas,3605,1217,57,37,94,60.6%,21m
6224,2,[Alpka]Nordy,3605,370,45,8,53,84.9%,6m
6224,2,Tedski,3605,372,15,13,28,53.6%,15m
6224,2,[BRSKR]Aghanim,3605,400,14,15,29,48.3%,5m
6224,3,GeNtLeMaN,3605,262,12,7,19,63.2%,14m
6224,2,Song,3605,200,12,8,20,60.0%,22m
6224,2,Daimos,3605,238,10,4,14,71.4%,14m
6224,2,ToyecaX,3605,156,7,0,7,100.0%,22m
6224,2,[BATG]DarKPoTaTO,3605,102,3,0,3,100.0%,11m
6224,2,[lMMl]Moreal,3605,60,3,2,5,60.0%,11m
6224,2,Sol,3605,102,2,2,4,50.0%,6m
6236,2,caineurs,3604,1615,289,289,578,50.0%,21m
6236,2,zerg,3604,1216,160,135,295,54.2%,19m
6236,2,ThatGuy,3604,748,77,66,143,53.8%,15m
6236,2,[ЗИБиАГ]DiamondDog,3604,1162,65,52,117,55.6%,5m
6236,2,[ExTr1m]Lite,3604,488,26,9,35,74.3%,10m
6236,3,Brainwrd,3604,291,14,10,24,58.3%,20m
6236,2,Snowdrop,3604,264,11,3,14,78.6%,21m
6236,2,[4GATE]wAIJDAN,3604,190,6,4,10,60.0%,11m
6236,2,Pekkakahva,3604,141,4,3,7,57.1%,3m
6236,2,[Take]pilzkopf,3604,126,3,3,6,50.0%,35m
6236,2,[Prinz]imperial,3604,0,1,0,1,100.0%,20m
6236,2,dada,3604,0,0,3,3,0.0%,14m
6248,2,Rexus,3603,1566,217,220,437,49.7%,7m
6248,2,Suxxorz,3603,1527,209,201,410,51.0%,35m
6248,2,Petitbiscuit,3603,580,145,133,278,52.2%,19m
6248,2,[994]Bananashell,3603,832,34,31,65,52.3%,15m
6248,2,[FoXReS]Meru,3603,414,15,13,28,53.6%,14m
6248,2,[Traxen]Mihalich,3603,238,9,10,19,47.4%,9m
6248,2,IIIIIIIIIIII,3603,168,7,11,18,38.9%,6m
6248,2,[crabz]IronMax,3603,142,5,1,6,83.3%,15m
6248,2,Dekernet,3603,88,3,4,7,42.9%,20m
6248,2,AiurDentist,3603,102,2,2,4,50.0%,35m
6248,3,MacroJackson,3603,97,1,16,17,5.9%,17m
6259,2,VnTm,3602,876,61,62,123,49.6%,17m
6259,2,NagibatorIMB,3602,274,22,13,35,62.9%,11m
6259,2,PomfÉtude,3602,405,19,10,29,65.5%,19m
6259,3,[75784]NESCAFFE,3602,371,16,6,22,72.7%,7m
6259,3,[TUPL]McDoudles,3602,339,15,4,19,78.9%,36m
6259,2,[axis]KeakDaSneak,3602,266,10,10,20,50.0%,22m
6259,2,Chee,3602,234,8,8,16,50.0%,5m
6259,2,[dmcorp]DMCORP,3602,142,7,1,8,87.5%,7m
6259,2,OmaDesala,3602,114,4,8,12,33.3%,5m
6259,2,[HBGSJR]HoldTight,3602,0,0,1,1,0.0%,15m
6259,2,[THP]Arnold,3602,0,0,3,3,0.0%,13m
6270,2,MagicPylon,3601,1337,187,156,343,54.5%,18m
6270,2,dragonball,3601,1412,155,155,310,50.0%,10m
6270,2,Krag,3601,1248,100,82,182,54.9%,19m
6270,2,Maxpro,3601,1193,49,46,95,51.6%,12m
6270,2,TehCube,3601,835,44,21,65,67.7%,35m
6270,2,[зерно]rrRamilka,3601,1058,42,43,85,49.4%,8m
6270,2,Outridairt,3601,633,40,26,66,60.6%,3m
6270,2,GloomyHill,3601,609,32,22,54,59.3%,20m
6270,2,Atori,3601,142,6,5,11,54.5%,35m
6270,2,GreedyGambit,3601,88,2,0,2,100.0%,10m
6270,2,Desire,3601,41,2,4,6,33.3%,9m
6270,2,[NevA]Fortuna,3601,0,1,0,1,100.0%,9m
6270,2,[R0D]WeiYan,3601,0,1,5,6,16.7%,14m
6283,2,Jiraiya,3600,1530,110,92,202,54.5%,21m
6283,2,KoMMyHuCT,3600,993,64,69,133,48.1%,19m
6283,2,qwerty,3600,1281,60,67,127,47.2%,15m
6283,2,zhimzhim,3600,547,57,31,88,64.8%,22m
6283,2,[KrnBrs]mik,3600,718,36,18,54,66.7%,12m
6283,2,[EseEse]Ese,3600,344,28,13,41,68.3%,11m
6283,2,prausti,3600,467,25,20,45,55.6%,6m
6283,2,Moonlight,3600,278,18,1,19,94.7%,15m
6283,2,aaron,3600,444,15,27,42,35.7%,8m
6283,2,[RE2]Comander,3600,378,11,26,37,29.7%,36m
6283,2,[12844]Lillmackan,3600,116,3,2,5,60.0%,15m
6283,2,Oranos,3600,30,1,2,3,33.3%,9m
6283,2,[ICGl]KrackIsBack,3600,0,0,1,1,0.0%,21m
6283,2,Mikc,3600,0,0,5,5,0.0%,35m
6297,2,msckson,3599,1118,94,86,180,52.2%,18m
6297,2,Matrixx,3599,1116,50,61,111,45.0%,12m
6297,2,Noah,3599,562,38,34,72,52.8%,3m
6297,2,[FlyFkr]Zhorliz,3599,634,24,23,47,51.1%,18m
6297,2,WellWisher,3599,464,19,20,39,48.7%,3m
6297,2,husky,3599,251,12,2,14,85.7%,15m
6297,2,shogi,3599,289,11,7,18,61.1%,35m
6297,2,[AISC]Xeero,3599,0,1,0,1,100.0%,9m
6297,2,[VSC2]KorshalaAdun,3599,88,1,1,2,50.0%,5m
6306,2,yayagrou,3598,1591,388,377,765,50.7%,18m
6306,2,Eagleorn,3598,1655,290,275,565,51.3%,18m
6306,2,Arctus,3598,680,47,44,91,51.6%,3m
6306,2,ProfChaos,3598,471,27,34,61,44.3%,14m
6306,2,Ghost,3598,689,26,25,51,51.0%,4m
6306,2,EvilWhitePPl,3598,698,26,26,52,50.0%,8m
6306,2,Narwhale,3598,444,15,20,35,42.9%,20m
6306,2,bastinou,3598,88,6,0,6,100.0%,12m
6306,2,[Fussel]Fiboniker,3598,142,5,1,6,83.3%,35m
6306,2,[JLooze]Aisora,3598,140,4,2,6,66.7%,19m
6306,2,Todar,3598,0,1,0,1,100.0%,5m
6306,2,[DNKСFТ]RaePiste,3598,0,1,0,1,100.0%,21m
6306,2,EdvanSchleck,3598,97,1,1,2,50.0%,10m
6306,2,[GAMI]Veyux,3598,0,0,1,1,0.0%,6m
6306,2,Feminist,3598,0,0,1,1,0.0%,3m
6306,2,Vamis,3598,0,0,1,1,0.0%,12m
6322,2,Gamblesock,3597,1530,93,69,162,57.4%,35m
6322,2,Apex,3597,736,60,60,120,50.0%,20m
6322,2,[Slakin]SslackSton,3597,1130,53,34,87,60.9%,18m
6322,2,bugster,3597,318,13,7,20,65.0%,14m
6322,2,pEz,3597,206,9,2,11,81.8%,11m
6322,2,Ralph,3597,180,6,8,14,42.9%,6m
6322,1,MyAmaranth,3597,145,5,5,10,50.0%,13m
6322,2,Askar,3597,88,1,1,2,50.0%,35m
6322,2,Rokz,3597,30,1,2,3,33.3%,35m
6331,2,azouldir,3596,1566,635,615,1250,50.8%,14m
6331,2,ISanych,3596,1407,101,69,170,59.4%,18m
6331,2,Leminos,3596,1212,80,75,155,51.6%,22m
6331,2,Hebbes,3596,1264,79,60,139,56.8%,22m
6331,2,Alex,3596,794,51,52,103,49.5%,13m
6331,2,Wingent,3596,837,50,28,78,64.1%,17m
6331,2,[Peeps]KuomiPasztor,3596,814,39,22,61,63.9%,9m
6331,2,Maverick,3596,832,32,27,59,54.2%,9m
6331,2,Nicolas,3596,514,31,2,33,93.9%,11m
6331,2,OneTwo,3596,534,25,12,37,67.6%,4m
6331,3,Шиза,3596,228,13,4,17,76.5%,14m
6331,3,MultiBall,3596,253,12,5,17,70.6%,17m
6331,2,llllllllllll,3596,180,6,6,12,50.0%,35m
6331,2,Izmir,3596,58,3,2,5,60.0%,15m
6331,2,Zerocarbon,3596,0,1,0,1,100.0%,9m
6331,2,[NZT48]Robot,3596,0,0,1,1,0.0%,12m
6347,2,Sweety,3595,1573,256,244,500,51.2%,13m
6347,2,Donchimabak,3595,1498,86,75,161,53.4%,21m
6347,2,[IndyK]Magiszonek,3595,727,64,52,116,55.2%,35m
6347,2,[CocoCo]SlastyNasty,3595,1508,56,66,122,45.9%,6m
6347,2,[TLpsE]IloveYeony,3595,1372,55,46,101,54.5%,35m
6347,2,DBko,3595,701,38,31,69,55.1%,35m
6347,2,[TAW]Arno,3595,599,25,18,43,58.1%,18m
6347,2,majic,3595,364,12,17,29,41.4%,22m
6347,1,daling,3595,274,7,25,32,21.9%,14m
6347,2,[SUFU]HaLLeY,3595,60,2,4,6,33.3%,22m
6347,2,RUBASINA,3595,30,1,3,4,25.0%,4m
6358,2,RocknRoLL,3594,1473,107,107,214,50.0%,36m
6358,2,Cheetje,3594,1273,72,71,143,50.3%,16m
6358,2,foodstamps,3594,479,35,22,57,61.4%,9m
6358,2,[PiGPan]Augustin,3594,0,1,0,1,100.0%,35m
6358,2,Ilay,3594,0,0,1,1,0.0%,10m
6358,2,DGJIBS,3594,0,0,1,1,0.0%,11m
6364,2,[HaC]AFǂPaljas,3593,1044,47,36,83,56.6%,35m
6364,2,LAN,3593,204,35,32,67,52.2%,13m
6364,2,[DT11]BoBo,3593,469,26,11,37,70.3%,6m
6364,2,Darkshade,3593,382,21,4,25,84.0%,21m
6364,2,Kabooom,3593,325,11,14,25,44.0%,13m
6364,2,Golo,3593,192,6,16,22,27.3%,22m
6364,3,Felix,3593,0,3,0,3,100.0%,16m
6364,2,Ishimura,3593,88,3,5,8,37.5%,35m
6364,2,Kuriboh,3593,30,1,2,3,33.3%,14m
6364,2,[Kerma]Ose,3593,30,1,7,8,12.5%,3m
6364,2,SadhGuru,3593,0,0,1,1,0.0%,35m
6364,2,Yurets,3593,0,0,1,1,0.0%,15m
6364,2,SunShine,3593,0,0,2,2,0.0%,7m
6377,2,red,3592,1548,98,95,193,50.8%,12m
6377,2,Destroyer,3592,1246,63,39,102,61.8%,12m
6377,2,Razi,3592,679,59,56,115,51.3%,35m
6377,2,zifan,3592,403,45,37,82,54.9%,19m
6377,2,Willileliram,3592,912,35,32,67,52.2%,18m
6377,2,zabinson,3592,306,32,15,47,68.1%,11m
6377,2,Birk,3592,782,27,33,60,45.0%,13m
6377,2,Farnsworth,3592,656,26,23,49,53.1%,10m
6377,2,SoloPL,3592,326,10,20,30,33.3%,15m
6377,2,[iX]IlluMiNatioN,3592,60,3,5,8,37.5%,3m
6377,2,Cyon,3592,102,2,1,3,66.7%,21m
6377,2,DEATHSTAR,3592,30,2,3,5,40.0%,35m
6377,2,Gyron,3592,88,1,1,2,50.0%,14m
6377,2,NotAFreeName,3592,88,1,1,2,50.0%,8m
6377,2,[AD]ResTinPeace,3592,30,1,4,5,20.0%,3m
6392,2,ЕвгенДЖИ,3591,422,62,35,97,63.9%,6m
6392,2,IlIlIlIlIlIl,3591,403,28,11,39,71.8%,36m
6392,2,Dodjyz,3591,444,20,18,38,52.6%,7m
6392,2,Meridian,3591,357,18,8,26,69.2%,3m
6392,2,Uvo,3591,201,9,7,16,56.2%,22m
6392,2,TopQuak,3591,213,9,12,21,42.9%,13m
6392,2,AbdulAkbar,3591,92,4,4,8,50.0%,19m
6392,2,Computer,3591,30,2,4,6,33.3%,12m
6392,2,StimToWin,3591,0,1,0,1,100.0%,17m
6401,2,[Supplo]Moonshield,3590,1631,274,258,532,51.5%,19m
6401,2,MeSzeS,3590,1615,83,65,148,56.1%,21m
6401,2,Hephaestus,3590,392,17,4,21,81.0%,6m
6401,2,MJHolland,3590,332,17,9,26,65.4%,21m
6401,2,Thyge,3590,331,14,7,21,66.7%,35m
6401,2,[1NFEC7]Ashley,3590,174,13,3,16,81.2%,11m
6401,2,XxGoaTxX,3590,168,7,7,14,50.0%,13m
6401,1,JustYan,3590,200,7,16,23,30.4%,21m
6401,2,[V1]QuickStep,3590,150,5,14,19,26.3%,19m
6401,2,Camperamico,3590,116,4,0,4,100.0%,5m
6401,2,[DTBMII]Kyu,3590,88,2,0,2,100.0%,6m
6401,2,BabySteps,3590,88,2,1,3,66.7%,21m
6401,2,[LDTT]Doddi,3590,58,2,3,5,40.0%,21m
6401,2,[UAŦeam]SheVAsixnine,3590,0,1,0,1,100.0%,19m
6401,2,wake,3590,0,0,1,1,0.0%,13m
6416,2,[ĦĦ]Nanuk,3589,1266,109,116,225,48.4%,5m
6416,2,[CH1337]Wolf,3589,485,20,14,34,58.8%,20m
6416,2,[NWGD]ClaireRouge,3589,352,17,9,26,65.4%,9m
6416,2,Dune,3589,202,15,17,32,46.9%,9m
6416,2,Ninoslayer,3589,350,14,19,33,42.4%,13m
6416,2,Magnus,3589,253,10,7,17,58.8%,10m
6416,2,PeaceMaker,3589,213,9,5,14,64.3%,10m
6416,2,Cheyen,3589,142,4,3,7,57.1%,35m
6416,2,[slayn]vef,3589,0,3,2,5,60.0%,17m
6416,2,Airs,3589,62,2,4,6,33.3%,11m
6416,2,[HBGSJR]llllllllllll,3589,60,2,4,6,33.3%,35m
6416,2,Droesj,3589,0,0,1,1,0.0%,36m
6416,2,[DaTal]Exellent,3589,0,0,3,3,0.0%,5m
6429,2,Mokazer,3588,1460,131,127,258,50.8%,19m
6429,2,Sheed,3588,419,19,13,32,59.4%,19m
6429,3,frewko,3588,344,15,4,19,78.9%,4m
6429,2,devastator,3588,177,13,6,19,68.4%,11m
6429,2,Stargazer,3588,96,3,2,5,60.0%,36m
6429,2,[NoBugs]NerfZerg,3588,30,2,4,6,33.3%,5m
6435,1,Reki,3587,1723,229,237,466,49.1%,6m
6435,1,Pilotari,3587,1443,133,134,267,49.8%,10m
6435,2,Kurt,3587,1453,67,60,127,52.8%,10m
6435,2,GoussLegend,3587,863,39,28,67,58.2%,35m
6435,2,[Zombie]RubyNinja,3587,713,34,19,53,64.2%,14m
6435,2,Kande,3587,642,24,25,49,49.0%,5m
6435,2,Derpy,3587,163,8,1,9,88.9%,7m
6435,2,Ran,3587,122,5,8,13,38.5%,21m
6435,1,Cypher,3587,48,4,6,10,40.0%,9m
6435,2,[WWTG]AwildPikachu,3587,115,3,1,4,75.0%,6m
6435,2,[WeGr]McFeast,3587,0,3,2,5,60.0%,35m
6435,2,[CCAV]JAcoZzzz,3587,58,2,6,8,25.0%,19m
6435,2,Dfuzzer,3587,30,1,2,3,33.3%,21m
6448,2,Dutchman,3586,1504,290,297,587,49.4%,12m
6448,2,[ziMMes]Kamikadze,3586,1591,124,127,251,49.4%,11m
6448,2,HAHAHA,3586,803,42,24,66,63.6%,5m
6448,2,VargVikernes,3586,864,40,29,69,58.0%,22m
6448,3,dothon,3586,462,18,10,28,64.3%,6m
6448,2,[Bambi2]Waul,3586,424,14,20,34,41.2%,6m
6448,3,[EliteX]Kubaxin,3586,168,7,1,8,87.5%,17m
6448,2,Vojtas,3586,114,5,6,11,45.5%,4m
6448,2,[AiRǂ]Skikky,3586,88,1,2,3,33.3%,14m
6448,3,HANSKANNS,3586,0,0,1,1,0.0%,14m
6448,2,ShïNo,3586,0,0,3,3,0.0%,20m
6448,2,Horong,3586,0,0,3,3,0.0%,5m
6460,2,Dreamer,3585,1163,235,217,452,52.0%,20m
6460,2,Duchu,3585,1200,60,42,102,58.8%,18m
6460,2,ChicCo,3585,1212,49,47,96,51.0%,10m
6460,2,[MkersA]slide,3585,493,21,16,37,56.8%,10m
6460,2,[lOgTl]Nanaki,3585,350,13,18,31,41.9%,12m
6460,2,Dejaner,3585,140,3,1,4,75.0%,22m
6460,3,[TmNVDA]DJaX,3585,30,2,0,2,100.0%,10m
6460,3,[iX]DerPasi,3585,0,0,1,1,0.0%,36m
6460,2,FautonKenons,3585,0,0,2,2,0.0%,35m
6460,2,mjwFoG,3585,0,0,17,17,0.0%,17m
6470,3,[GAUF]Tinuviel,3584,216,11,5,16,68.8%,4m
6470,2,Mage,3584,243,10,5,15,66.7%,35m
6470,2,lllllllll,3584,226,9,10,19,47.4%,4m
6470,2,Snow,3584,140,4,2,6,66.7%,10m
6470,2,Meson,3584,90,3,9,12,25.0%,16m
6470,2,mamastiffler,3584,88,2,1,3,66.7%,5m
6470,2,JustZyriak,3584,0,0,2,2,0.0%,3m
6477,2,OdorTime,3583,1573,483,481,964,50.1%,11m
6477,2,[ШОУМЕН]Mambo,3583,244,10,5,15,66.7%,4m
6477,2,[LiFe]MettEagle,3583,244,7,7,14,50.0%,19m
6477,3,Gerbariu,3583,0,1,0,1,100.0%,19m
6477,3,nocheesepls,3583,0,1,4,5,20.0%,11m
6477,3,[GROSSE]Ervann,3583,0,0,1,1,0.0%,36m
6477,2,Radzio,3583,0,0,2,2,0.0%,22m
6477,2,fastr,3583,0,0,2,2,0.0%,3m
6485,2,Smile,3582,1313,102,89,191,53.4%,5m
6485,2,GGGLHF,3582,776,38,23,61,62.3%,4m
6485,2,[Tuki]Lance,3582,415,33,31,64,51.6%,6m
6485,2,HorstLocal,3582,512,19,19,38,50.0%,12m
6485,3,[hiddle]Snowfox,3582,427,18,10,28,64.3%,19m
6485,2,SiD,3582,331,17,9,26,65.4%,10m
6485,2,Maxbook,3582,402,15,15,30,50.0%,11m
6485,2,Druss,3582,237,11,14,25,44.0%,7m
6485,2,[ENVOL]boTUIHok,3582,283,10,10,20,50.0%,21m
6485,3,[12CB12]Drakam,3582,0,0,1,1,0.0%,22m
6495,2,PticaDoDo,3581,1574,201,195,396,50.8%,11m
6495,2,dolmio,3581,1590,71,74,145,49.0%,21m
6495,2,[BRSKR]Hexe,3581,749,46,51,97,47.4%,15m
6495,2,arno,3581,746,26,30,56,46.4%,11m
6495,2,Jav,3581,122,4,8,12,33.3%,20m
6495,3,IIIIIIIIIII,3581,0,1,0,1,100.0%,17m
6495,3,whonoobtheme,3581,0,1,0,1,100.0%,19m
6502,2,TheHound,3580,1601,377,360,737,51.2%,35m
6502,2,Skadi,3580,1092,160,166,326,49.1%,9m
6502,2,[AVSb]DawsonRyder,3580,712,56,57,113,49.6%,3m
6502,3,theFelix,3580,292,15,7,22,68.2%,36m
6502,2,[ConFed]Tarapkin,3580,188,5,5,10,50.0%,21m
6502,2,liQid,3580,30,2,3,5,40.0%,35m
6502,3,Urzai,3580,0,1,0,1,100.0%,19m
6502,3,Ambush,3580,0,0,1,1,0.0%,15m
6502,3,[ƮesXG]BlueIce,3580,0,0,1,1,0.0%,20m
6502,2,[ENVOL]Krieg,3580,0,0,2,2,0.0%,4m
6502,2,[TheDOH]Epsilon,3580,0,0,4,4,0.0%,35m
6513,2,RoManiaC,3579,1586,179,178,357,50.1%,35m
6513,2,[NТB]BudBa,3579,1350,64,60,124,51.6%,21m
6513,2,ElTortuga,3579,1398,58,55,113,51.3%,10m
6513,2,[Kbanus]aurel,3579,498,24,13,37,64.9%,19m
6513,2,Haiden,3579,304,10,21,31,32.3%,35m
6513,2,Flamboyant,3579,250,9,8,17,52.9%,10m
6513,2,Bane,3579,193,8,4,12,66.7%,15m
6513,3,Грандмастер,3579,114,5,2,7,71.4%,15m
6513,2,Guni,3579,98,3,4,7,42.9%,35m
6513,2,Deathstar,3579,86,3,8,11,27.3%,13m
6513,3,[CKi]pOweR,3579,0,0,1,1,0.0%,21m
6513,3,[REGGE]Greencurry,3579,0,0,1,1,0.0%,21m
6513,3,nykeN,3579,0,0,1,1,0.0%,6m
6526,2,deadlocks,3578,1587,229,216,445,51.5%,15m
6526,2,Agradar,3578,1234,72,54,126,57.1%,13m
6526,2,[CYC]Gramz,3578,298,10,9,19,52.6%,19m
6526,2,Хемингуэй,3578,192,10,13,23,43.5%,11m
6526,2,[J4E]Epicnoob,3578,0,1,1,2,50.0%,9m
6526,3,[MiMs]DJSK,3578,0,0,1,1,0.0%,18m
6532,2,WaStEd,3577,1597,254,228,482,52.7%,21m
6532,2,BusDriver,3577,1574,105,88,193,54.4%,16m
6532,2,SalfetKa,3577,526,56,22,78,71.8%,14m
6532,3,xyzxyz,3577,1128,43,38,81,53.1%,17m
6532,3,SemiNeX,3577,446,21,12,33,63.6%,11m
6532,3,Rusviets,3577,414,16,11,27,59.3%,19m
6532,2,[SSeiya]CamuS,3577,90,10,8,18,55.6%,35m
6532,2,[PŖïMĄŁ]BruceLee,3577,58,2,4,6,33.3%,18m
6532,3,[PiGPan]ImpriGG,3577,0,0,1,1,0.0%,4m
6541,2,Lert,3576,1530,196,194,390,50.3%,19m
6541,2,Eparcyl,3576,1222,85,87,172,49.4%,35m
6541,2,[ValidG]loganpaul,3576,402,71,22,93,76.3%,5m
6541,2,[Rakii]Zeratulo,3576,165,24,18,42,57.1%,15m
6541,1,BruceBanner,3576,277,11,4,15,73.3%,35m
6541,2,[T3]rustyisback,3576,268,9,10,19,47.4%,22m
6541,2,[Arrows]Revers,3576,116,4,7,11,36.4%,5m
6541,3,[KAOTx]capslock,3576,0,3,2,5,60.0%,22m
6541,3,[ZadiRa]SuperRanger,3576,30,1,1,2,50.0%,11m
6541,1,OverKikooLoL,3576,96,1,2,3,33.3%,35m
6541,2,[Kicx]WhiteMAMBA,3576,0,1,12,13,7.7%,18m
6541,2,Nice,3576,0,0,1,1,0.0%,21m
6541,2,[IVJI]Makrotello,3576,0,0,3,3,0.0%,35m
6554,3,AgentM,3575,1408,70,58,128,54.7%,6m
6554,2,BábovkaI,3575,178,14,9,23,60.9%,6m
6554,2,pimadoka,3575,166,9,3,12,75.0%,13m
6554,2,KavidDim,3575,118,7,2,9,77.8%,21m
6554,3,kekboi,3575,58,2,1,3,66.7%,9m
6554,3,Snow,3575,30,1,5,6,16.7%,18m
6560,2,Skysork,3574,274,74,76,150,49.3%,9m
6560,3,Biancagamba,3574,509,67,50,117,57.3%,13m
6560,1,[W4nker]SoGoOd,3574,1107,58,74,132,43.9%,7m
6560,3,[EMST]slonofanya,3574,854,35,24,59,59.3%,20m
6560,2,llllllllllll,3574,541,25,9,34,73.5%,4m
6560,2,DrunkAccount,3574,465,19,13,32,59.4%,5m
6560,3,Ferentino,3574,202,8,5,13,61.5%,12m
6560,3,Dumb,3574,232,8,5,13,61.5%,11m
6560,2,Nighthawk,3574,117,2,3,5,40.0%,21m
6560,3,Ronni,3574,0,0,1,1,0.0%,4m
6570,2,GoodEvening,3573,1551,103,96,199,51.8%,10m
6570,2,[IOZI]Sabra,3573,1288,70,65,135,51.9%,17m
6570,2,friendly,3573,574,37,20,57,64.9%,20m
6570,2,Månegarm,3573,69,8,15,23,34.8%,35m
6570,2,rhumkraken,3573,0,3,3,6,50.0%,3m
6570,3,JoTenMike,3573,0,1,0,1,100.0%,14m
6570,3,BayLifeGG,3573,0,0,1,1,0.0%,6m
6570,2,[Brenji]Phanton,3573,0,0,2,2,0.0%,6m
6578,2,KAjebe,3572,1623,252,252,504,50.0%,9m
6578,2,cenko,3572,575,35,21,56,62.5%,35m
6578,2,Damocles,3572,700,30,26,56,53.6%,12m
6578,2,Heimdall,3572,404,16,21,37,43.2%,35m
6578,2,[TermiT]Firework,3572,292,11,8,19,57.9%,11m
6578,2,fzmr,3572,254,11,15,26,42.3%,3m
6578,2,Azira,3572,232,9,7,16,56.2%,35m
6578,3,Daydee,3572,169,5,2,7,71.4%,35m
6578,2,[YPS]Cyborg,3572,88,1,2,3,33.3%,9m
6578,3,Jacky,3572,0,1,4,5,20.0%,13m
6588,2,Beasten,3571,1585,573,569,1142,50.2%,6m
6588,2,DzombaDino,3571,1579,164,164,328,50.0%,5m
6588,2,akisser,3571,1600,133,132,265,50.2%,13m
6588,3,EMISAR,3571,1190,47,39,86,54.7%,18m
6588,2,[BRSKR]Nomcrus,3571,298,11,13,24,45.8%,19m
6588,2,[PLA2N]tommygun,3571,116,5,6,11,45.5%,35m
6588,1,Scarecrow,3571,239,5,7,12,41.7%,12m
6588,2,TiltWizard,3571,60,3,11,14,21.4%,15m
6588,3,DogFo,3571,0,1,0,1,100.0%,35m
6588,3,Donowitz,3571,0,1,0,1,100.0%,6m
6598,2,Schnitzer,3570,1504,109,118,227,48.0%,10m
6598,2,[eXøde]faiza,3570,1252,93,70,163,57.1%,5m
6598,2,[ESOT]SuperIorni,3570,973,53,22,75,70.7%,5m
6598,2,[Kicx]NawaL,3570,958,38,37,75,50.7%,15m
6598,2,[INSAT]NyuB,3570,310,34,32,66,51.5%,3m
6598,2,TeppaH,3570,696,30,21,51,58.8%,16m
6598,2,nitro,3570,660,22,33,55,40.0%,8m
6598,3,DefNotJam,3570,0,1,0,1,100.0%,18m
6598,3,riCottaja,3570,0,0,1,1,0.0%,20m
6598,2,Spoby,3570,0,0,2,2,0.0%,22m
6598,2,Guerter,3570,0,0,3,3,0.0%,12m
6609,2,KOS,3569,1581,127,132,259,49.0%,13m
6609,2,[CHOPAA]Argonavt,3569,1387,97,87,184,52.7%,21m
6609,2,[DarKsS]fernandillo,3569,320,13,8,21,61.9%,9m
6609,2,Steppenwolf,3569,366,12,23,35,34.3%,8m
6609,3,[øVø]Ishimura,3569,144,6,3,9,66.7%,16m
6609,3,[VFǂ]Jeff,3569,30,1,1,2,50.0%,11m
6609,2,cedric,3569,88,1,2,3,33.3%,18m
6609,2,Footprints,3569,30,1,4,5,20.0%,15m
6617,2,SHARAMBO,3568,1547,293,272,565,51.9%,19m
6617,3,[RBlood]ArKHYUS,3568,1567,234,225,459,51.0%,13m
6617,3,ihajames,3568,611,49,36,85,57.6%,14m
6617,3,Simp,3568,144,3,7,10,30.0%,9m
6617,2,ShinyRay,3568,30,2,3,5,40.0%,20m
6617,2,llllllllllll,3568,30,2,3,5,40.0%,13m
6623,2,KilledDebtor,3567,1555,162,144,306,52.9%,16m
6623,2,abishell,3567,1565,126,91,217,58.1%,13m
6623,2,[MLPRar]NeNECron,3567,1154,122,94,216,56.5%,22m
6623,2,[ZZoo]szabrownik,3567,954,114,106,220,51.8%,9m
6623,2,Awegasm,3567,1514,71,78,149,47.7%,21m
6623,2,[Old]Jimmy,3567,710,30,27,57,52.6%,13m
6623,2,Darksolo,3567,447,16,17,33,48.5%,11m
6623,3,Anserax,3567,286,11,9,20,55.0%,9m
6631,2,Duljek,3566,911,125,116,241,51.9%,18m
6631,2,[5up]FolkMetaller,3566,1384,50,55,105,47.6%,35m
6631,2,Yoshi,3566,379,15,16,31,48.4%,35m
6631,2,Voicer,3566,245,10,9,19,52.6%,3m
6631,3,[ArShrk]SharKMouZ,3566,220,9,8,17,52.9%,36m
6631,1,MikeHawk,3566,97,2,2,4,50.0%,21m
6631,2,Archimonde,3566,30,2,3,5,40.0%,15m
6631,2,Jindujun,3566,76,2,4,6,33.3%,5m
6631,3,Hanchek,3566,0,0,1,1,0.0%,18m
6631,2,FairEnough,3566,0,0,8,8,0.0%,13m
6641,2,Winstorm,3565,1415,69,54,123,56.1%,5m
6641,2,Tehelka,3565,729,68,42,110,61.8%,35m
6641,2,zeratul,3565,686,61,63,124,49.2%,21m
6641,3,privetpivz,3565,695,51,43,94,54.3%,35m
6641,3,BlueR,3565,928,41,31,72,56.9%,36m
6641,2,[S4V4GE]LastKeczup,3565,375,25,18,43,58.1%,4m
6641,2,Danmirans,3565,603,24,31,55,43.6%,10m
6641,2,IlIlIlIlIlIl,3565,324,14,11,25,56.0%,9m
6641,2,[WOTBL]laba,3565,259,9,9,18,50.0%,35m
6641,2,Swarm,3565,197,8,3,11,72.7%,16m
6641,2,llllllllllll,3565,223,6,16,22,27.3%,20m
6641,2,seamon,3565,140,5,9,14,35.7%,13m
6641,3,SameOldName,3565,0,3,2,5,60.0%,21m
6641,3,[GiDi]Kras,3565,0,0,5,5,0.0%,4m
6655,2,NuclearK,3564,1456,117,105,222,52.7%,13m
6655,2,[SK1LL]Darvu,3564,1232,98,99,197,49.7%,13m
6655,3,Lappen,3564,385,19,14,33,57.6%,9m
6655,2,ChimaY,3564,230,18,15,33,54.5%,13m
6655,3,[D0N3]cicciobar,3564,118,4,3,7,57.1%,20m
6655,2,DieSterne,3564,134,3,3,6,50.0%,12m
6655,3,DeluSiON,3564,0,1,0,1,100.0%,9m
6655,3,Longneko,3564,30,1,2,3,33.3%,36m
6655,3,DasH,3564,30,1,2,3,33.3%,19m
6655,3,[R3IGN]SkyBoiii,3564,0,0,1,1,0.0%,16m
6655,3,Slayer,3564,0,0,1,1,0.0%,22m
6655,3,Softisch,3564,0,0,2,2,0.0%,18m
6667,2,Gordon,3563,1208,187,138,325,57.5%,11m
6667,2,TuoR,3563,1550,155,131,286,54.2%,12m
6667,2,Umbra,3563,1260,130,112,242,53.7%,21m
6667,2,Piiras,3563,1284,50,51,101,49.5%,20m
6667,3,[nB]nBǂBouh,3563,734,45,29,74,60.8%,5m
6667,3,Yzaron,3563,439,25,16,41,61.0%,5m
6667,2,Merckxism,3563,266,22,22,44,50.0%,10m
6667,2,Hamsterling,3563,595,22,26,48,45.8%,35m
6667,3,[KStyle]sitry,3563,294,11,7,18,61.1%,17m
6667,3,lllllllllll,3563,86,3,1,4,75.0%,3m
6667,3,Roro,3563,30,2,0,2,100.0%,9m
6667,3,Deflow,3563,0,1,4,5,20.0%,35m
6667,3,KpTainZurg,3563,0,0,1,1,0.0%,36m
6680,2,IIIIIIIIIIII,3562,1420,200,193,393,50.9%,15m
6680,2,EllieFingers,3562,1461,163,164,327,49.8%,36m
6680,2,WawaCool,3562,1093,89,90,179,49.7%,35m
6680,3,[NoLair]Lords,3562,1243,81,54,135,60.0%,10m
6680,2,Aloura,3562,916,38,38,76,50.0%,3m
6680,2,[сSсǃ]Fluke,3562,1002,38,40,78,48.7%,11m
6680,2,[ØC]AzZix,3562,30,2,3,5,40.0%,5m
6680,2,NeoThird,3562,58,2,5,7,28.6%,23m
6680,3,YanJke,3562,0,0,1,1,0.0%,16m
6689,2,[KD103]CallMeCreamy,3561,401,14,12,26,53.8%,15m
6689,2,Magic,3561,282,11,15,26,42.3%,14m
6689,3,IllIlII,3561,220,8,5,13,61.5%,20m
6689,2,[FxL]Lapin,3561,131,5,4,9,55.6%,35m
6689,3,Ozen,3561,70,5,5,10,50.0%,5m
6689,2,Vompidoo,3561,30,2,3,5,40.0%,3m
6689,3,[РRОxy]WannaBeMaru,3561,30,1,1,2,50.0%,10m
6696,2,[212P]GoNnaGeTyOu,3560,1584,276,278,554,49.8%,13m
6696,2,WaWa,3560,1398,269,244,513,52.4%,3m
6696,2,[Xa]oScǂNice,3560,886,33,38,71,46.5%,35m
6696,3,HiChew,3560,492,22,9,31,71.0%,36m
6696,2,MrManta,3560,431,22,17,39,56.4%,9m
6696,3,Basusay,3560,282,18,10,28,64.3%,7m
6696,3,testtest,3560,202,7,5,12,58.3%,13m
6696,3,Interloper,3560,114,5,3,8,62.5%,35m
6696,2,[NG0ld]CarryPotter,3560,0,3,3,6,50.0%,35m
6696,3,PandeMonium,3560,146,3,4,7,42.9%,19m
6696,2,[JW]Jaesonian,3560,151,3,5,8,37.5%,35m
6707,2,[RE]rio,3559,1564,99,83,182,54.4%,35m
6707,2,sshole,3559,930,35,32,67,52.2%,35m
6707,2,Karanelus,3559,531,33,48,81,40.7%,36m
6707,2,mysteryH,3559,230,13,6,19,68.4%,19m
6707,3,CloseOff,3559,265,9,10,19,47.4%,35m
6707,1,[DМG]GanzVlad,3559,0,1,2,3,33.3%,21m
6707,3,Mambol,3559,30,1,3,4,25.0%,5m
6707,2,[АNIME]CAHEK,3559,0,1,17,18,5.6%,20m
6707,3,Kosmatesny,3559,0,0,1,1,0.0%,4m
6707,3,Bone,3559,0,0,1,1,0.0%,18m
6707,3,boom,3559,0,0,2,2,0.0%,35m
6707,1,partizan,3559,0,0,4,4,0.0%,22m
6719,2,Indra,3558,1620,195,196,391,49.9%,14m
6719,2,Виталий,3558,1461,60,73,133,45.1%,7m
6719,2,[giBik]BScythe,3558,405,20,33,53,37.7%,10m
6719,3,Pirdiens,3558,494,19,15,34,55.9%,9m
6719,2,[Bias]piml,3558,141,6,4,10,60.0%,7m
6719,3,[IceHus]Oxsirion,3558,86,4,2,6,66.7%,16m
6719,2,[Rylst]Jolly,3558,141,4,5,9,44.4%,4m
6719,3,AreYou,3558,30,1,1,2,50.0%,4m
6719,3,[ЭЩКЕРЕ]TsCoX,3558,0,0,1,1,0.0%,4m
6719,2,[MST]Baldur,3558,0,0,2,2,0.0%,6m
6729,3,[qDDSp]Phillie,3557,1633,90,89,179,50.3%,19m
6729,2,[Oath]Ceasar,3557,1441,54,56,110,49.1%,35m
6729,3,[6PhD]ghost,3557,195,8,8,16,50.0%,10m
6729,3,Looper,3557,97,2,0,2,100.0%,15m
6729,3,exePriMe,3557,30,1,3,4,25.0%,5m
6729,3,HyperPro,3557,0,0,1,1,0.0%,16m
6735,2,Regnator,3556,1167,348,360,708,49.2%,15m
6735,2,TOSSADAR,3556,1485,133,126,259,51.4%,3m
6735,2,[AcSx]Titibandit,3556,1443,92,86,178,51.7%,6m
6735,2,[RBlood]Galactus,3556,1479,61,54,115,53.0%,12m
6735,2,Fluttershy,3556,641,35,29,64,54.7%,15m
6735,2,[LIQUID]Sectorr,3556,252,12,8,20,60.0%,13m
6735,2,[LTCS]ХитрыйГном,3556,129,4,1,5,80.0%,16m
6735,3,MozGi,3556,116,4,2,6,66.7%,15m
6735,2,[TEPCO]kokainrausch,3556,30,1,5,6,16.7%,9m
6735,3,[ImbaSC]Engineer,3556,0,0,2,2,0.0%,13m
6745,2,[CJFF]BoonBaron,3555,1634,176,172,348,50.6%,13m
6745,2,[HsDL]veterans,3555,720,51,58,109,46.8%,7m
6745,3,NanatoScop,3555,524,27,9,36,75.0%,35m
6745,2,Happy,3555,245,10,7,17,58.8%,21m
6745,2,Furi,3555,217,8,7,15,53.3%,22m
6745,2,Snippsnapp,3555,182,5,6,11,45.5%,20m
6745,3,Dragunova,3555,58,2,3,5,40.0%,18m
6745,3,[VFish]Nimzo,3555,0,1,1,2,50.0%,9m
6745,3,[IceFel]StarVader,3555,0,0,1,1,0.0%,35m
6745,3,quietMADman,3555,0,0,1,1,0.0%,3m
6755,2,[CocoCo]Sillenoz,3554,994,72,65,137,52.6%,23m
6755,2,Cybaer,3554,1564,60,70,130,46.2%,6m
6755,2,[1QYU]PzYÇZzH,3554,1386,51,59,110,46.4%,8m
6755,3,MantasMM,3554,882,35,26,61,57.4%,3m
6755,2,[NerfZg]Aguero,3554,503,23,14,37,62.2%,35m
6755,3,sawyer,3554,170,7,3,10,70.0%,17m
6755,2,hite,3554,144,5,8,13,38.5%,17m
6755,2,[NMSQ]Barkas,3554,38,4,8,12,33.3%,5m
6755,2,[Ревыч]AXEL,3554,90,3,6,9,33.3%,9m
6755,2,Zepa,3554,102,2,3,5,40.0%,6m
6755,3,Saint,3554,0,1,0,1,100.0%,20m
6755,3,Guje,3554,0,1,3,4,25.0%,22m
6755,3,NoMoreSkyTos,3554,0,1,4,5,20.0%,5m
6768,2,[BRSKR]PRIME,3553,1030,40,46,86,46.5%,18m
6768,3,CwanDer,3553,398,15,11,26,57.7%,20m
6768,2,[henD]Cerberi,3553,92,4,11,15,26.7%,22m
6768,3,Azalima,3553,60,3,3,6,50.0%,10m
6768,2,IIIlllIIIlll,3553,112,3,3,6,50.0%,9m
6768,2,pax,3553,58,3,4,7,42.9%,35m
6768,3,Filo,3553,0,0,1,1,0.0%,6m
6768,3,IIIIIIIIIIII,3553,0,0,1,1,0.0%,15m
6776,2,Enigma,3552,1545,68,71,139,48.9%,15m
6776,2,Sargas,3552,209,21,10,31,67.7%,6m
6776,2,[SCOTS]LargeToad,3552,408,16,14,30,53.3%,22m
6776,3,Velkor,3552,287,13,6,19,68.4%,4m
6776,2,[bugPP]SMURFIN,3552,168,10,3,13,76.9%,35m
6776,3,[Cannоn]BelaM,3552,218,9,4,13,69.2%,3m
6776,3,Toshik,3552,0,5,0,5,100.0%,16m
6776,3,[afk247]Marineplay,3552,85,3,2,5,60.0%,35m
6776,2,[SRDRG]XIX,3552,46,3,6,9,33.3%,3m
6776,3,Ibbi,3552,0,1,0,1,100.0%,19m
6786,3,Celtigare,3551,1628,260,249,509,51.1%,22m
6786,2,[GdAT]ScarlettUK,3551,1237,188,183,371,50.7%,20m
6786,2,edea,3551,1216,46,45,91,50.5%,15m
6786,3,[FetT]FetTerRaven,3551,114,8,3,11,72.7%,20m
6786,2,[PvZAS]Shazzle,3551,195,6,6,12,50.0%,36m
6786,2,[FxL]Atty,3551,96,3,5,8,37.5%,35m
6786,2,[VOTTAK]Angelss,3551,30,2,4,6,33.3%,13m
6786,3,[LoGiN]Amadeus,3551,0,0,2,2,0.0%,14m
6794,2,[UNM]PaiN,3550,1052,136,102,238,57.1%,35m
6794,2,wooka,3550,1417,100,84,184,54.3%,12m
6794,2,Elvilas,3550,1513,80,54,134,59.7%,16m
6794,2,KraZyGryphon,3550,819,34,26,60,56.7%,3m
6794,2,[LøL]JiKu,3550,336,13,11,24,54.2%,12m
6794,2,Robertino,3550,297,10,10,20,50.0%,35m
6794,2,shaon,3550,328,10,12,22,45.5%,23m
6794,3,daekian,3550,194,8,4,12,66.7%,17m
6794,3,[xPr]Jah,3550,0,3,3,6,50.0%,20m
6803,2,Wertyn,3549,1562,564,533,1097,51.4%,4m
6803,2,Unkind,3549,1516,398,397,795,50.1%,36m
6803,2,[HBGSJR]Darkwolf,3549,60,2,5,7,28.6%,6m
6803,3,Gamjar,3549,97,1,2,3,33.3%,13m
6803,3,[NargH]DawKing,3549,0,0,1,1,0.0%,9m
6803,3,Razdva,3549,0,0,1,1,0.0%,7m
6803,3,[Умоджа]TEPPAH,3549,0,0,1,1,0.0%,20m
6803,3,iSK,3549,0,0,2,2,0.0%,35m
6811,3,Вершитель,3548,1648,975,955,1930,50.5%,20m
6811,3,[EmŦ]ArchangelLaw,3548,1632,131,104,235,55.7%,15m
6811,2,Parse,3548,468,18,21,39,46.2%,20m
6811,3,SewerMermaid,3548,338,13,6,19,68.4%,5m
6811,3,[IRKPRO]keeper,3548,247,11,3,14,78.6%,4m
6811,2,LOST,3548,230,9,6,15,60.0%,35m
6811,2,[Arabia]CaZ,3548,244,9,8,17,52.9%,21m
6811,2,[ValidG]ArcbostsSimp,3548,116,5,7,12,41.7%,5m
6811,3,[1POL]BaKsORO,3548,0,1,1,2,50.0%,14m
6811,3,robIIbo,3548,0,0,1,1,0.0%,15m
6821,2,tresdin,3547,1585,72,68,140,51.4%,19m
6821,3,[GoBot]Eruudy,3547,412,17,10,27,63.0%,5m
6821,2,[Wø]Skizorager,3547,178,7,10,17,41.2%,15m
6821,3,[Камрад]rimerzerg,3547,88,3,3,6,50.0%,13m
6821,3,Raziel,3547,0,1,0,1,100.0%,19m
6821,3,[No0bz]Frazzer,3547,0,0,2,2,0.0%,7m
6827,2,BruTaL,3546,1534,258,230,488,52.9%,5m
6827,3,[ZERG7V]Sharkman,3546,1620,152,142,294,51.7%,5m
6827,2,TheRatMage,3546,798,39,26,65,60.0%,35m
6827,3,[LGBTm]nhGraf,3546,434,18,8,26,69.2%,17m
6827,2,[GROF]Karro,3546,250,12,13,25,48.0%,13m
6827,2,[ØC]Sparrow,3546,217,11,4,15,73.3%,35m
6827,2,[ZERGML]ViPTonari,3546,276,10,16,26,38.5%,14m
6827,2,oЗЕРГoЛЁХАo,3546,290,10,21,31,32.3%,19m
6827,2,Violet,3546,248,9,17,26,34.6%,12m
6827,2,FireFly,3546,208,8,5,13,61.5%,13m
6827,3,Meta,3546,114,4,2,6,66.7%,15m
6827,3,Sony,3546,30,2,1,3,66.7%,16m
6827,3,[NOGGFY]Montu,3546,0,1,0,1,100.0%,12m
6827,2,marvin,3546,30,1,4,5,20.0%,21m
6827,2,[ADDlCT]FlynUp,3546,30,1,11,12,8.3%,9m
6827,3,DMercy,3546,0,0,1,1,0.0%,7m
6827,3,[Iria]TonnoVeloce,3546,0,0,1,1,0.0%,11m
6827,3,IIIIIIIIIIII,3546,0,0,2,2,0.0%,21m
6845,3,QZR,3545,1602,344,330,674,51.0%,10m
6845,2,SlinkySlinky,3545,1531,169,152,321,52.6%,5m
6845,3,КоГтеточка,3545,665,29,10,39,74.4%,7m
6845,3,gerax,3545,328,12,8,20,60.0%,11m
6845,2,liljafae,3545,95,6,1,7,85.7%,15m
6845,3,[CuWoǂ]Zurt,3545,0,5,0,5,100.0%,22m
6845,3,LORDGG,3545,88,3,3,6,50.0%,13m
6845,2,hatcher,3545,46,2,1,3,66.7%,23m
6845,2,Felix,3545,0,1,2,3,33.3%,19m
6845,3,Geo,3545,30,1,3,4,25.0%,22m
6845,3,CPAIGIS,3545,0,0,1,1,0.0%,19m
6845,3,[EESC]Donday,3545,0,0,2,2,0.0%,12m
6845,3,[tMnrd]Exercitus,3545,0,0,5,5,0.0%,21m
6858,2,Tobi,3544,1259,374,350,724,51.7%,5m
6858,3,[ICFI]Carsac,3544,1390,85,72,157,54.1%,10m
6858,2,Rikitikitavi,3544,624,52,45,97,53.6%,10m
6858,3,[LPFG]CCCР,3544,709,30,22,52,57.7%,7m
6858,3,[TnG]Zyshn,3544,271,13,5,18,72.2%,12m
6858,3,MakiMix,3544,0,5,0,5,100.0%,20m
6858,2,meChobo,3544,126,4,5,9,44.4%,10m
6865,2,EldHöken,3543,1467,110,97,207,53.1%,15m
6865,2,FiL,3543,1542,86,84,170,50.6%,10m
6865,2,kurica,3543,636,76,56,132,57.6%,35m
6865,3,TheDestroyer,3543,742,34,23,57,59.6%,5m
6865,3,Blam,3543,790,30,22,52,57.7%,8m
6865,2,SayCheese,3543,494,20,18,38,52.6%,15m
6865,2,[EAU]OgAgAl,3543,532,19,23,42,45.2%,6m
6865,3,[NKQ]Zorus,3543,478,18,11,29,62.1%,21m
6865,3,enchy,3543,283,13,6,19,68.4%,21m
6865,3,TrIGuN,3543,218,12,5,17,70.6%,22m
6865,3,ZaraBiceps,3543,264,9,12,21,42.9%,11m
6865,3,Konni,3543,197,7,4,11,63.6%,16m
6865,2,[oTCo]LTJ,3543,120,5,10,15,33.3%,13m
6865,3,[HBGS]GladiaThor,3543,145,4,2,6,66.7%,4m
6865,3,Hissigskau,3543,58,3,1,4,75.0%,20m
6865,3,[JDUNEZ]StarKing,3543,30,2,1,3,66.7%,7m
6865,3,[EHeS]Larry,3543,0,1,0,1,100.0%,13m
6865,3,[Number]Toulou,3543,0,0,2,2,0.0%,12m
6883,2,Illuminati,3542,1599,430,434,864,49.8%,9m
6883,2,voidray,3542,1594,408,385,793,51.5%,22m
6883,2,Graviphoton,3542,1607,148,138,286,51.7%,5m
6883,3,PenspinningG,3542,625,80,55,135,59.3%,10m
6883,2,Scott,3542,1342,74,81,155,47.7%,15m
6883,3,SCommander,3542,701,71,49,120,59.2%,5m
6883,2,Стараюсь,3542,617,39,28,67,58.2%,6m
6883,2,[MiFiS]Persephal,3542,344,13,11,24,54.2%,17m
6883,2,ChrisJ,3542,217,12,3,15,80.0%,23m
6883,2,TommyShelby,3542,147,4,5,9,44.4%,13m
6883,3,Bimboslaff,3542,60,3,2,5,60.0%,8m
6883,2,[Føcus]Crystoval,3542,58,3,4,7,42.9%,7m
6883,3,Midgard,3542,0,1,0,1,100.0%,9m
6883,3,[BRSKR]Xnaga,3542,0,0,1,1,0.0%,20m
6897,2,[Säch]Jimi,3541,1599,230,244,474,48.5%,13m
6897,3,Push,3541,1393,172,165,337,51.0%,21m
6897,3,Wanja,3541,1663,98,81,179,54.7%,14m
6897,2,Marduk,3541,1305,71,55,126,56.3%,20m
6897,2,Aehnn,3541,1042,38,42,80,47.5%,17m
6897,3,Пограничник,3541,756,29,23,52,55.8%,22m
6897,2,[Dobro]ninofabula,3541,454,21,16,37,56.8%,20m
6897,2,Tiberain,3541,175,9,13,22,40.9%,6m
6897,3,[DrkSn]Gwyndolin,3541,86,5,4,9,55.6%,18m
6897,3,leaving,3541,0,0,1,1,0.0%,16m
6897,1,Mutastak,3541,0,0,2,2,0.0%,12m
6908,2,Strzalka,3540,582,79,81,160,49.4%,36m
6908,1,Win,3540,549,60,65,125,48.0%,14m
6908,3,DieCesar,3540,690,30,15,45,66.7%,9m
6908,3,[Cracot]xXKiKooLoLXx,3540,655,29,18,47,61.7%,8m
6908,2,Yahooleu,3540,512,23,15,38,60.5%,19m
6908,2,KaeptnArrr,3540,249,15,14,29,51.7%,19m
6908,3,MaxPower,3540,114,5,1,6,83.3%,11m
6908,3,IIIIIIIIIIII,3540,60,3,1,4,75.0%,7m
6908,3,[nSK]Nightmare,3540,0,2,0,2,100.0%,6m
6908,3,[QDoSai]Chrlie,3540,30,2,3,5,40.0%,11m
6908,3,Emzeror,3540,0,2,3,5,40.0%,22m
6908,3,[PaS8]Boblinux,3540,0,0,1,1,0.0%,6m
6908,3,[PLA2N]NOVA,3540,0,0,1,1,0.0%,9m
6908,3,Jani,3540,0,0,1,1,0.0%,21m
6908,3,vila,3540,0,0,1,1,0.0%,22m
6923,2,Cobalt,3539,1051,131,124,255,51.4%,8m
6923,3,KRYSTAL,3539,559,126,113,239,52.7%,12m
6923,3,Flox,3539,716,28,19,47,59.6%,36m
6923,3,Jamp,3539,594,27,19,46,58.7%,35m
6923,2,Richardesu,3539,563,25,18,43,58.1%,19m
6923,3,Farhali,3539,574,24,16,40,60.0%,36m
6923,2,Jugei,3539,487,18,19,37,48.6%,22m
6923,2,SeiN,3539,282,15,8,23,65.2%,13m
6923,3,Shahmatist,3539,356,14,10,24,58.3%,15m
6923,2,taxfree,3539,374,14,18,32,43.8%,8m
6923,3,[AoTu]happydrops,3539,217,10,3,13,76.9%,8m
6923,2,[OSgZ]DonDondellos,3539,203,7,9,16,43.8%,10m
6923,2,Taitaiwoo,3539,146,6,9,15,40.0%,5m
6923,3,Razor,3539,58,3,2,5,60.0%,17m
6923,3,[KeXHUN]Vendi,3539,90,3,4,7,42.9%,20m
6923,3,[MLBA]asdfasdf,3539,58,2,2,4,50.0%,15m
6923,3,Whistler,3539,0,1,0,1,100.0%,20m
6923,3,HappyJack,3539,0,0,1,1,0.0%,13m
6941,2,MicroJordann,3538,1544,398,379,777,51.2%,16m
6941,2,makrofag,3538,1524,383,402,785,48.8%,12m
6941,2,Dave,3538,1512,329,329,658,50.0%,14m
6941,2,FLintz,3538,1048,127,106,233,54.5%,8m
6941,3,Elfelipes,3538,1660,127,128,255,49.8%,17m
6941,2,[PRAIM]Geschan,3538,821,115,100,215,53.5%,20m
6941,2,shadow,3538,1162,108,90,198,54.5%,15m
6941,2,[BeSC]AshOP,3538,1449,98,72,170,57.6%,36m
6941,3,[MosWar]ZenoS,3538,1637,97,78,175,55.4%,17m
6941,3,benjatoooo,3538,401,23,14,37,62.2%,13m
6941,3,Limbus,3538,522,22,15,37,59.5%,9m
6941,2,LegioNomen,3538,105,4,10,14,28.6%,14m
6941,2,[NoObS]SyKo,3538,30,2,4,6,33.3%,8m
6941,3,CHAAAARGE,3538,30,1,1,2,50.0%,10m
6941,3,[Turb0o]peWpeW,3538,30,1,2,3,33.3%,6m
6941,3,[CS0]Samwise,3538,0,1,2,3,33.3%,19m
6941,3,PoWeR,3538,30,1,4,5,20.0%,20m
6958,2,AceOne,3537,811,39,27,66,59.1%,10m
6958,3,Nyarlathotep,3537,601,30,3,33,90.9%,13m
6958,3,[TIKIS]CrisiX,3537,523,22,16,38,57.9%,15m
6958,2,ZhouYu,3537,556,21,19,40,52.5%,23m
6958,2,Snikers,3537,288,10,15,25,40.0%,35m
6958,2,Martabaff,3537,282,10,23,33,30.3%,18m
6958,2,koma,3537,176,7,13,20,35.0%,17m
6958,3,ImNotVasiliy,3537,58,2,2,4,50.0%,4m
6958,3,ArkGrendl,3537,30,2,2,4,50.0%,5m
6958,3,[Kicx]IcanFLY,3537,0,1,1,2,50.0%,9m
6958,3,Macias,3537,0,1,3,4,25.0%,18m
6958,3,JJH,3537,0,0,1,1,0.0%,11m
6958,3,Rennick,3537,0,0,1,1,0.0%,13m
6958,3,ATAraXia,3537,0,0,2,2,0.0%,23m
6972,2,Starball,3536,1254,264,242,506,52.2%,13m
6972,2,Dmik,3536,1488,134,129,263,51.0%,5m
6972,2,Akroe,3536,1080,40,42,82,48.8%,4m
6972,3,guts,3536,776,31,22,53,58.5%,11m
6972,2,Masepoes,3536,632,28,21,49,57.1%,35m
6972,3,[Viggo]Lalan,3536,114,4,6,10,40.0%,15m
6972,3,Orange,3536,30,2,2,4,50.0%,5m
6972,3,[B4S4R4]Relentless,3536,0,0,1,1,0.0%,20m
6972,3,SoulMg,3536,0,0,1,1,0.0%,4m
6981,3,Athosamigos,3535,1218,82,78,160,51.2%,35m
6981,2,[JANEZI]Xeon,3535,1122,74,73,147,50.3%,6m
6981,2,[QTcIub]Robotopia,3535,1350,58,49,107,54.2%,19m
6981,2,Prometheus,3535,760,33,33,66,50.0%,36m
6981,2,[13NRV]valithor,3535,615,30,24,54,55.6%,13m
6981,3,[Desire]Cyberspase,3535,267,10,2,12,83.3%,11m
6981,1,Protolisk,3535,113,9,3,12,75.0%,22m
6981,3,GaPoRaXIII,3535,256,7,7,14,50.0%,35m
6981,3,Eylradius,3535,212,6,4,10,60.0%,9m
6981,3,Hush,3535,144,4,1,5,80.0%,15m
6981,2,Andreas,3535,96,4,3,7,57.1%,20m
6981,2,[WolfGs]Roger,3535,114,3,4,7,42.9%,10m
6981,3,[aW]Jazz,3535,30,2,1,3,66.7%,22m
6981,1,trololo,3535,119,2,4,6,33.3%,14m
6981,3,[ReVoSC]Shy,3535,0,0,2,2,0.0%,15m
6981,3,Vio,3535,0,0,2,2,0.0%,16m
6997,3,CDCARVER,3534,861,37,21,58,63.8%,12m
6997,3,Fondue,3534,642,29,12,41,70.7%,35m
6997,2,Taraxacum,3534,333,24,26,50,48.0%,6m
6997,2,[Moped]SirConfused,3534,566,23,28,51,45.1%,3m
6997,3,Francuz,3534,311,17,14,31,54.8%,13m
6997,2,ikar,3534,240,9,11,20,45.0%,5m
6997,3,buzz,3534,196,8,5,13,61.5%,3m
6997,3,RedVelvetCke,3534,103,5,5,10,50.0%,12m
6997,3,Vedi,3534,90,3,7,10,30.0%,9m
6997,3,[MoNoM]Kadzan,3534,96,2,0,2,100.0%,16m
6997,3,AdziaN,3534,0,1,0,1,100.0%,9m
6997,2,bcrmz,3534,0,1,5,6,16.7%,12m
6997,3,Pigeons,3534,0,0,1,1,0.0%,14m
7010,2,Alvear,3533,859,103,90,193,53.4%,9m
7010,2,kaka,3533,1489,83,83,166,50.0%,22m
7010,2,DevilsFire,3533,940,35,40,75,46.7%,12m
7010,2,Jbernhard,3533,546,24,20,44,54.5%,16m
7010,2,LAG,3533,294,13,16,29,44.8%,5m
7010,1,KILLERCHAMP,3533,236,10,5,15,66.7%,3m
7010,3,TRIL,3533,88,6,5,11,54.5%,15m
7010,3,[соv19]GrenaderKA,3533,114,5,6,11,45.5%,8m
7010,1,kanal,3533,111,2,1,3,66.7%,18m
7010,3,BSBB,3533,30,1,3,4,25.0%,8m
7020,2,[RPTRMX]Andris,3532,1175,258,248,506,51.0%,36m
7020,2,ZealotLegs,3532,673,140,134,274,51.1%,13m
7020,3,Junior,3532,1651,127,125,252,50.4%,15m
7020,2,ORAF,3532,1543,124,118,242,51.2%,35m
7020,2,Praetorian,3532,207,18,22,40,45.0%,11m
7020,3,food,3532,114,8,2,10,80.0%,7m
7020,3,dumpzilla,3532,30,5,1,6,83.3%,21m
7020,3,Ensiiferum,3532,0,2,3,5,40.0%,13m
7020,3,Маэрс,3532,58,2,3,5,40.0%,4m
7020,2,[ЯD]Magico,3532,58,2,6,8,25.0%,12m
7020,3,Pitou,3532,0,1,0,1,100.0%,12m
7020,3,SoralARaison,3532,0,1,0,1,100.0%,19m
7020,3,[Heroes]Kahre,3532,0,1,1,2,50.0%,5m
7020,3,RaPaX,3532,0,0,1,1,0.0%,7m
7020,2,[Blacer]BlacerLordTV,3532,0,0,5,5,0.0%,5m
7035,2,tank,3531,1377,137,129,266,51.5%,13m
7035,2,TheChosenOne,3531,1041,101,86,187,54.0%,18m
7035,2,zifan,3531,1579,89,82,171,52.0%,10m
7035,2,[WL706]WOLF,3531,1541,74,75,149,49.7%,17m
7035,2,vtec,3531,873,69,76,145,47.6%,18m
7035,2,[ВSL]Exalted,3531,818,66,59,125,52.8%,20m
7035,2,StuntGirl,3531,491,34,30,64,53.1%,12m
7035,3,[GeWapo]Darklight,3531,426,17,10,27,63.0%,20m
7035,3,Isaac,3531,262,11,1,12,91.7%,9m
7035,2,[OSTEN]Kimftw,3531,290,9,12,21,42.9%,5m
7035,2,[upLink]villy,3531,244,8,9,17,47.1%,36m
7035,2,[EEKSC]LUIGI,3531,88,6,1,7,85.7%,12m
7035,3,piertzale,3531,146,5,4,9,55.6%,22m
7035,2,[APES]CaptainAPE,3531,162,5,12,17,29.4%,23m
7035,3,IIlIlIllIIll,3531,0,1,0,1,100.0%,12m
7035,3,Emey,3531,0,0,1,1,0.0%,13m
7051,2,Izvas,3530,1511,220,224,444,49.5%,4m
7051,2,[TSKTM]Grecha,3530,743,77,82,159,48.4%,15m
7051,2,pizu,3530,1416,56,65,121,46.3%,18m
7051,3,Tripolar,3530,1020,39,37,76,51.3%,11m
7051,3,ProbeProcess,3530,446,21,10,31,67.7%,10m
7051,2,SlideOfFists,3530,612,20,31,51,39.2%,36m
7051,3,OHOOUO,3530,391,17,6,23,73.9%,12m
7051,3,RIVERDALE,3530,346,15,6,21,71.4%,21m
7051,2,zumBerg,3530,244,11,11,22,50.0%,35m
7051,3,Poupoulpe,3530,272,10,5,15,66.7%,18m
7051,3,[Ahegаo]Frakish,3530,214,9,2,11,81.8%,36m
7051,3,Erlin,3530,120,5,3,8,62.5%,14m
7051,3,Stephan,3530,86,4,4,8,50.0%,7m
7051,2,dottt,3530,30,2,6,8,25.0%,14m
7051,3,PandaMarine,3530,0,1,0,1,100.0%,4m
7051,3,DAG,3530,30,1,1,2,50.0%,13m
7051,3,[lEvTl]FooFighter,3530,0,0,1,1,0.0%,13m
7051,2,[BornG]Shask,3530,0,0,4,4,0.0%,13m
7069,2,[CMOA]CmoaJobs,3529,1610,544,543,1087,50.0%,13m
7069,2,Quasar,3529,1301,288,296,584,49.3%,8m
7069,2,ChaoSLogiC,3529,891,41,29,70,58.6%,35m
7069,2,Traviktox,3529,903,36,33,69,52.2%,14m
7069,2,[lmGl]Anglahr,3529,880,32,38,70,45.7%,5m
7069,3,Pohusaxi,3529,119,3,0,3,100.0%,36m
7069,3,lllllllllllI,3529,0,3,2,5,60.0%,9m
7069,3,krish,3529,0,1,1,2,50.0%,36m
7069,3,DeathKick,3529,0,0,1,1,0.0%,9m
7078,3,PerfectGreen,3528,1693,85,80,165,51.5%,36m
7078,2,[MiB]Cae,3528,876,51,47,98,52.0%,35m
7078,2,JustInSane,3528,693,28,29,57,49.1%,9m
7078,2,BaobaB,3528,330,13,17,30,43.3%,35m
7078,2,SonOfMalice,3528,312,10,12,22,45.5%,5m
7078,2,[RA08]gelous,3528,264,9,9,18,50.0%,5m
7078,2,[MPTUS]FisTeR,3528,250,8,13,21,38.1%,3m
7078,3,Bamboo,3528,176,6,9,15,40.0%,9m
7078,3,eXquiZite,3528,0,2,0,2,100.0%,19m
7078,3,[LESeV]NotEnoughSpd,3528,30,2,1,3,66.7%,8m
7078,2,[Ǽ1]Superhero,3528,30,2,4,6,33.3%,14m
7078,3,MadArto,3528,0,1,0,1,100.0%,13m
7078,3,[PHØMUI]Winchester,3528,0,1,1,2,50.0%,36m
7078,3,KastorCornn,3528,30,1,4,5,20.0%,19m
7078,3,[Goliat]TarmaRovins,3528,0,0,3,3,0.0%,21m
7093,2,Iskatel,3527,929,41,35,76,53.9%,36m
7093,3,[BFG3K]Arek,3527,716,27,23,50,54.0%,7m
7093,2,[B1G]Slacker,3527,328,12,14,26,46.2%,9m
7093,2,[BTEU]Trionega,3527,158,6,14,20,30.0%,17m
7093,3,Consultant,3527,0,5,0,5,100.0%,6m
7093,3,[IPARTY]RageKit,3527,97,4,2,6,66.7%,6m
7093,3,GLHF,3527,30,2,2,4,50.0%,12m
7093,2,Megazoid,3527,30,2,4,6,33.3%,35m
7093,3,Mook,3527,0,0,1,1,0.0%,19m
7102,2,DRunkenTZH,3526,1542,280,271,551,50.8%,35m
7102,2,[SKALEN]DENISQA,3526,620,35,26,61,57.4%,23m
7102,3,[НТТ]Fargus,3526,310,11,12,23,47.8%,4m
7102,3,iTisEz,3526,90,4,4,8,50.0%,7m
7102,3,[crabz]AlphaOmega,3526,61,3,3,6,50.0%,7m
7102,3,[UAŦeam]Nimus,3526,0,1,0,1,100.0%,12m
7102,2,[FPM]HAX,3526,0,0,18,18,0.0%,19m
7109,2,Haru,3525,1619,90,94,184,48.9%,14m
7109,3,DrunkMaster,3525,814,38,20,58,65.5%,21m
7109,2,NaiJi,3525,690,30,22,52,57.7%,23m
7109,3,Asmund,3525,516,20,17,37,54.1%,7m
7109,3,mrluiaard,3525,166,6,4,10,60.0%,15m
7109,2,[MP1]Cole,3525,190,5,8,13,38.5%,13m
7109,3,Kanok,3525,97,2,0,2,100.0%,35m
7109,3,Scipio,3525,60,2,3,5,40.0%,9m
7109,2,[OTLG]GabbaGandalf,3525,30,2,5,7,28.6%,36m
7109,3,AIphaStar,3525,0,1,0,1,100.0%,17m
7109,3,[ICoCP]xdaijirox,3525,30,1,1,2,50.0%,17m
7109,3,FireFly,3525,30,1,3,4,25.0%,21m
7109,3,Janush,3525,0,0,1,1,0.0%,36m
7109,3,[ICFI]Xid,3525,0,0,2,2,0.0%,20m
7123,2,Porka,3524,1604,163,166,329,49.5%,23m
7123,2,Feanor,3524,1070,110,81,191,57.6%,19m
7123,2,Paul,3524,287,55,50,105,52.4%,10m
7123,2,Saph,3524,492,23,16,39,59.0%,10m
7123,3,nuclear,3524,372,13,13,26,50.0%,12m
7123,3,[MONKE]Alexius,3524,167,5,0,5,100.0%,20m
7123,3,NightStalker,3524,60,3,2,5,60.0%,22m
7123,3,[Omegon]Alpharius,3524,30,1,1,2,50.0%,19m
7123,2,DoctorNinja,3524,30,1,5,6,16.7%,14m
7123,2,Diviner,3524,88,1,5,6,16.7%,23m
7123,2,arturian,3524,0,0,1,1,0.0%,8m
7123,3,Hammer,3524,0,0,3,3,0.0%,35m
7135,2,[BPX]Lutrax,3523,671,28,23,51,54.9%,36m
7135,2,SicKJameS,3523,646,23,28,51,45.1%,13m
7135,2,Basilios,3523,580,21,24,45,46.7%,35m
7135,3,Devastator,3523,354,14,10,24,58.3%,19m
7135,3,Dierex,3523,200,7,7,14,50.0%,15m
7135,2,PlayerOne,3523,220,7,20,27,25.9%,19m
7135,2,[FxL]OverRainbow,3523,30,1,7,8,12.5%,19m
7135,3,qqq,3523,0,0,1,1,0.0%,4m
7143,2,Amr,3522,1516,671,663,1334,50.3%,11m
7143,2,Fesser,3522,1566,245,217,462,53.0%,5m
7143,2,DrTwerkMiley,3522,909,135,136,271,49.8%,13m
7143,3,Inferno,3522,1272,51,43,94,54.3%,35m
7143,3,DWARFRama,3522,976,36,35,71,50.7%,13m
7143,2,DarkShiado,3522,848,34,31,65,52.3%,10m
7143,3,Patrycjusz,3522,550,23,13,36,63.9%,15m
7143,3,Thruth,3522,430,19,10,29,65.5%,5m
7143,2,Рукожопище,3522,337,13,12,25,52.0%,7m
7143,3,ghydsg,3522,58,3,1,4,75.0%,19m
7143,3,[RFL]Fluo,3522,0,0,1,1,0.0%,35m
7143,3,[Ordu]Xander,3522,0,0,2,2,0.0%,9m
7155,3,abadeer,3521,176,14,11,25,56.0%,19m
7155,2,Bluntbread,3521,218,12,6,18,66.7%,36m
7155,3,Montagnik,3521,221,12,7,19,63.2%,21m
7155,3,[Amelie]Lacroix,3521,234,9,7,16,56.2%,20m
7155,2,[TSFG]Énrico,3521,270,9,14,23,39.1%,19m
7155,2,Thunderbird,3521,88,6,9,15,40.0%,5m
7155,3,PeaceIPaper,3521,114,4,6,10,40.0%,6m
7155,3,[Mijn]SirPanda,3521,74,3,2,5,60.0%,35m
7155,3,[MSII]Radon,3521,92,3,6,9,33.3%,15m
7155,3,[UAŦeam]Niklaus,3521,0,1,0,1,100.0%,9m
7155,2,[GaYmär]pGh,3521,0,1,1,2,50.0%,3m
7155,3,[WCGtop]SenFx,3521,0,0,1,1,0.0%,5m
7155,1,Solana,3521,0,0,3,3,0.0%,6m
7168,2,Deliciouzzz,3520,294,35,31,66,53.0%,6m
7168,3,[snOr]MoL,3520,114,4,2,6,66.7%,36m
7168,2,Gordon,3520,62,3,6,9,33.3%,10m
7168,2,Stimulator,3520,93,2,0,2,100.0%,21m
7168,3,Kelpfarmer,3520,0,1,0,1,100.0%,12m
7168,3,[MNGGTV]Matsca,3520,0,0,1,1,0.0%,6m
7168,3,[PiGPan]AssumedSite,3520,0,0,1,1,0.0%,22m
7175,2,wowvaqa,3519,1154,71,74,145,49.0%,35m
7175,3,Whsprs,3519,740,41,28,69,59.4%,11m
7175,2,Insane,3519,496,20,32,52,38.5%,13m
7175,3,LeungWing,3519,402,17,10,27,63.0%,13m
7175,3,reactive,3519,326,12,7,19,63.2%,8m
7175,1,EUkiller,3519,238,10,6,16,62.5%,18m
7175,3,Chocov,3519,0,5,0,5,100.0%,21m
7175,3,KalamMekhar,3519,86,3,1,4,75.0%,7m
7175,2,[BiOdrO]TemplarGBA,3519,60,3,6,9,33.3%,19m
7175,2,SRMUERTE,3519,92,3,8,11,27.3%,14m
7175,2,Immortal,3519,117,2,1,3,66.7%,13m
7175,3,EnTaroAdun,3519,30,2,2,4,50.0%,21m
7175,2,[Mkers]Raven,3519,30,1,10,11,9.1%,35m
7175,3,NocteDeum,3519,0,0,1,1,0.0%,4m
7175,3,Valorfist,3519,0,0,1,1,0.0%,14m
7190,2,ZubZaZub,3518,1609,205,205,410,50.0%,13m
7190,1,MadProbe,3518,1670,122,148,270,45.2%,5m
7190,3,borzoy,3518,628,86,71,157,54.8%,5m
7190,2,kipisheos,3518,770,55,53,108,50.9%,35m
7190,2,[DPYT]tsepesh,3518,553,34,28,62,54.8%,11m
7190,2,NoMatter,3518,504,23,15,38,60.5%,11m
7190,3,Swylex,3518,244,9,5,14,64.3%,10m
7190,2,CannonRusher,3518,137,7,8,15,46.7%,35m
7190,2,llIIIlIlIlll,3518,209,6,9,15,40.0%,21m
7190,3,DarKraii,3518,86,4,0,4,100.0%,4m
7190,3,[PandS]Skelel,3518,0,0,1,1,0.0%,4m
7190,3,slap,3518,0,0,1,1,0.0%,9m
7190,3,[CurryW]Praetor,3518,0,0,2,2,0.0%,36m
7190,3,[CBRL]Elfispy,3518,0,0,2,2,0.0%,13m
7190,3,Stingz,3518,0,0,5,5,0.0%,5m
7190,2,Doomer,3518,0,0,5,5,0.0%,8m
7206,2,Quarq,3517,808,405,366,771,52.5%,5m
7206,2,JoeElCoco,3517,1509,222,204,426,52.1%,19m
7206,2,MurlocHolmes,3517,1047,142,108,250,56.8%,23m
7206,3,[ZeDe20]Fara,3517,546,28,7,35,80.0%,21m
7206,1,[sfc]Qwaky,3517,638,22,37,59,37.3%,12m
7206,3,[GGMS]BlackAdder,3517,464,17,16,33,51.5%,5m
7206,3,rendo,3517,174,11,3,14,78.6%,18m
7206,2,TracyJ,3517,204,7,15,22,31.8%,22m
7206,3,SChlafi,3517,58,3,0,3,100.0%,14m
7206,3,Altaires,3517,0,3,2,5,60.0%,16m
7206,3,[TheDOH]Sledgar,3517,0,1,0,1,100.0%,4m
7217,2,Misix,3516,1246,144,147,291,49.5%,3m
7217,2,[BWArmy]TRC,3516,964,57,47,104,54.8%,18m
7217,3,ZLOgva,3516,989,43,25,68,63.2%,17m
7217,2,BruceTwarze,3516,1006,35,52,87,40.2%,13m
7217,3,[RеG]MASTERPUPPET,3516,550,22,15,37,59.5%,22m
7217,3,kyle,3516,420,17,11,28,60.7%,9m
7217,3,LianDonoban,3516,192,12,1,13,92.3%,4m
7217,2,lucifer,3516,88,5,3,8,62.5%,22m
7217,3,[ЯD]Unknown,3516,58,3,0,3,100.0%,23m
7217,3,[JOJPA]CrazyDiamond,3516,60,3,1,4,75.0%,4m
7217,3,[DLM12]Belardo,3516,0,2,0,2,100.0%,15m
7217,3,KatyPerry,3516,60,2,2,4,50.0%,5m
7217,3,wanted,3516,30,1,3,4,25.0%,37m
7230,1,[MGBNom]Hobo,3515,1682,187,212,399,46.9%,23m
7230,3,Biohazard,3515,535,26,20,46,56.5%,6m
7230,2,Answer,3515,513,22,19,41,53.7%,22m
7230,3,Wisi,3515,142,10,8,18,55.6%,35m
7230,3,Dmitiusz,3515,174,6,5,11,54.5%,5m
7230,3,[OYY]Peclesh,3515,58,3,1,4,75.0%,7m
7230,3,Pexlu,3515,30,1,2,3,33.3%,17m
7230,3,[NSBM]AntisaDød,3515,0,0,1,1,0.0%,13m
7230,3,[beebo]LaCucaracha,3515,0,0,1,1,0.0%,37m
7239,3,ItsLLGoodMan,3514,1600,207,195,402,51.5%,21m
7239,2,[MicroK]Fuling,3514,1537,100,95,195,51.3%,5m
7239,3,Øbscuritas,3514,1089,60,54,114,52.6%,4m
7239,3,SiaNoob,3514,1156,53,32,85,62.4%,9m
7239,3,PapstBuk,3514,720,30,20,50,60.0%,5m
7239,3,EndJoyPain,3514,628,26,14,40,65.0%,10m
7239,3,AtheneWins,3514,392,15,14,29,51.7%,35m
7239,2,TimeOut,3514,338,13,17,30,43.3%,23m
7239,2,UGlennylee,3514,158,5,18,23,21.7%,12m
7239,3,[ICG]Brute,3514,44,2,2,4,50.0%,9m
7249,2,justmyluck,3513,1503,316,310,626,50.5%,16m
7249,2,SoriN,3513,1251,157,135,292,53.8%,3m
7249,2,supervit,3513,1538,112,93,205,54.6%,16m
7249,2,[PogC]Omni,3513,721,81,72,153,52.9%,35m
7249,3,llllllllllll,3513,979,54,31,85,63.5%,10m
7249,3,ART,3513,358,13,11,24,54.2%,7m
7249,2,GrandMister,3513,262,12,14,26,46.2%,22m
7249,3,TheHomeR,3513,30,1,2,3,33.3%,23m
7249,3,NaSa,3513,0,0,1,1,0.0%,17m
7249,3,HypnotiX,3513,0,0,1,1,0.0%,21m
7249,3,[nKITs]Philbort,3513,0,0,2,2,0.0%,13m
7260,2,KarlSberg,3512,1145,106,100,206,51.5%,3m
7260,2,glhf,3512,1265,49,51,100,49.0%,12m
7260,2,[oTETAo]Jonisora,3512,901,41,45,86,47.7%,35m
7260,2,Lycian,3512,958,37,33,70,52.9%,19m
7260,3,[TedB]legoshpego,3512,604,31,26,57,54.4%,21m
7260,3,[XDM]Natou,3512,344,15,5,20,75.0%,20m
7260,3,[Glatt]Juddy,3512,295,14,5,19,73.7%,9m
7260,3,Aqualink,3512,192,8,1,9,88.9%,21m
7260,2,Flandrond,3512,115,7,2,9,77.8%,35m
7260,3,Neron,3512,168,7,4,11,63.6%,12m
7260,3,Varvar,3512,114,5,2,7,71.4%,17m
7260,2,[Code52]DarkAlphaAPM,3512,159,4,6,10,40.0%,3m
7260,3,Hermelien,3512,0,1,0,1,100.0%,7m
7260,3,[MME]Johnny,3512,0,1,3,4,25.0%,10m
7260,2,ELLe,3512,30,1,6,7,14.3%,14m
7275,2,PantokratoR,3511,1478,147,142,289,50.9%,3m
7275,2,Ulysse,3511,1427,105,102,207,50.7%,18m
7275,3,slazy,3511,975,57,34,91,62.6%,20m
7275,2,Lenin,3511,258,11,9,20,55.0%,14m
7275,3,soyCowboy,3511,212,10,3,13,76.9%,16m
7275,3,TriangleTom,3511,220,8,7,15,53.3%,11m
7275,2,Ayor,3511,238,8,15,23,34.8%,15m
7275,2,zerp,3511,158,7,3,10,70.0%,21m
7275,3,[K0ZAKI]DenKakai,3511,0,5,0,5,100.0%,16m
7275,2,XMOL,3511,142,4,6,10,40.0%,7m
7275,3,[LAMPA]ShinoaLovers,3511,86,3,2,5,60.0%,22m
7275,3,JBthefirst,3511,30,2,0,2,100.0%,13m
7275,3,IIIIIIIIIIII,3511,0,0,2,2,0.0%,21m
7288,3,Wachowsky,3510,624,96,99,195,49.2%,35m
7288,3,IIIIIII,3510,1015,47,26,73,64.4%,11m
7288,3,Dare,3510,582,37,34,71,52.1%,20m
7288,3,[0BO]ExCeed,3510,524,21,18,39,53.8%,11m
7288,2,boubou,3510,418,18,18,36,50.0%,12m
7288,2,gangsta,3510,142,8,3,11,72.7%,6m
7288,3,AlbertSt,3510,0,5,0,5,100.0%,18m
7288,3,darkyaourt,3510,146,5,5,10,50.0%,35m
7288,3,fOrTyFoUrMaN,3510,92,4,4,8,50.0%,21m
7288,2,Bethell,3510,30,4,5,9,44.4%,16m
7288,2,Oxygene,3510,125,2,5,7,28.6%,36m
7288,3,[KDV]KerivePL,3510,0,1,4,5,20.0%,4m
7288,3,[BjwA]NiTreXxX,3510,0,0,1,1,0.0%,14m
7288,3,Ragey,3510,0,0,3,3,0.0%,21m
7302,2,Daemon,3509,1618,267,270,537,49.7%,5m
7302,3,Tenoke,3509,923,222,204,426,52.1%,13m
7302,2,[TAW]Senbean,3509,1411,114,118,232,49.1%,8m
7302,3,[Leolan]LonelySpirit,3509,968,39,27,66,59.1%,9m
7302,2,Raggamuffin,3509,924,34,40,74,45.9%,3m
7302,3,Potato,3509,678,33,19,52,63.5%,35m
7302,2,ArtaNis,3509,535,30,17,47,63.8%,22m
7302,3,maleo,3509,202,8,6,14,57.1%,10m
7302,3,klinok,3509,0,5,0,5,100.0%,16m
7302,3,[SY2G]ßcMc,3509,60,3,3,6,50.0%,12m
7302,2,[DeadDe]Madson,3509,30,1,6,7,14.3%,20m
7302,3,LastNight,3509,0,0,1,1,0.0%,17m
7302,3,MeltyButter,3509,0,0,3,3,0.0%,10m
7315,2,Adlerjunge,3508,1375,138,134,272,50.7%,5m
7315,3,CoCoKyJIuTKu,3508,1609,112,85,197,56.9%,6m
7315,2,Weytley,3508,468,18,19,37,48.6%,16m
7315,3,JimBoogie,3508,0,5,0,5,100.0%,9m
7315,3,Smile,3508,139,4,0,4,100.0%,16m
7315,3,AngelVonyos,3508,0,0,1,1,0.0%,22m
7321,3,Noire,3507,1145,123,104,227,54.2%,11m
7321,2,RoronoaZoro,3507,856,54,54,108,50.0%,5m
7321,2,[KBLNZ]jackhightech,3507,727,33,26,59,55.9%,23m
7321,2,nymphen,3507,912,33,34,67,49.3%,36m
7321,2,Pazuzu,3507,802,29,38,67,43.3%,5m
7321,3,Devotion,3507,337,15,9,24,62.5%,19m
7321,2,[LofE]Asakura,3507,194,9,10,19,47.4%,20m
7321,3,IIIIIIIIIIII,3507,206,8,11,19,42.1%,4m
7321,2,[ĦĦ]Kerzz,3507,154,6,7,13,46.2%,20m
7321,3,SoVeReiGN,3507,0,4,1,5,80.0%,22m
7321,3,cHnUrf,3507,0,1,0,1,100.0%,12m
7321,3,basbed,3507,0,0,1,1,0.0%,7m
7333,2,Dams,3506,1396,190,183,373,50.9%,20m
7333,2,Simon,3506,1202,101,92,193,52.3%,23m
7333,2,HOHO,3506,687,33,22,55,60.0%,36m
7333,3,IIIIIIIIIIII,3506,376,14,8,22,63.6%,17m
7333,3,DragomerXT,3506,0,4,0,4,100.0%,21m
7333,2,[Ǽ1]spid,3506,124,4,14,18,22.2%,35m
7333,3,Flod,3506,0,0,1,1,0.0%,4m
7333,3,badPlayer,3506,0,0,1,1,0.0%,13m
7333,3,[DfF]xStarkillerx,3506,0,0,1,1,0.0%,37m
7342,3,Troye,3505,409,28,20,48,58.3%,15m
7342,3,Zahr,3505,394,17,9,26,65.4%,15m
7342,3,BuDa,3505,168,9,5,14,64.3%,17m
7342,1,Akoc,3505,253,8,2,10,80.0%,17m
7342,3,Shrader,3505,97,2,4,6,33.3%,36m
7342,3,DrMobius,3505,0,0,1,1,0.0%,21m
7342,3,Twice,3505,0,0,1,1,0.0%,14m
7349,2,Takmorn,3504,761,162,143,305,53.1%,36m
7349,2,[DarkAG]BeautLicker,3504,458,20,21,41,48.8%,16m
7349,3,TzarOK,3504,166,9,5,14,64.3%,21m
7349,3,Оливия,3504,121,6,1,7,85.7%,5m
7349,3,[Algo]Silverwolf,3504,0,1,0,1,100.0%,8m
7349,1,[ĦĦ]nullPointer,3504,0,1,2,3,33.3%,9m
7349,3,[NSSR]Cyberhippi,3504,0,0,1,1,0.0%,15m
7349,2,KernelPanic,3504,0,0,1,1,0.0%,16m
7357,2,[smEttY]CZExecFG,3503,1553,185,191,376,49.2%,15m
7357,2,[cArB0t]FlorinKratos,3503,1171,76,58,134,56.7%,13m
7357,3,Mag,3503,1090,45,38,83,54.2%,5m
7357,2,ЖАк,3503,402,17,12,29,58.6%,5m
7357,2,Porty,3503,88,6,1,7,85.7%,22m
7357,3,IIIIIIIIIIII,3503,97,5,1,6,83.3%,5m
7357,1,[xFRSx]NameX,3503,118,2,3,5,40.0%,23m
7357,3,llllllllllll,3503,30,2,4,6,33.3%,5m
7357,3,HyperioN,3503,30,1,2,3,33.3%,20m
7357,3,DollarsCZ,3503,0,0,1,1,0.0%,15m
7367,2,tom,3502,1369,181,185,366,49.5%,5m
7367,2,Emanuel,3502,1357,132,124,256,51.6%,12m
7367,2,Fox,3502,1261,52,47,99,52.5%,19m
7367,3,Rendodo,3502,1082,43,34,77,55.8%,13m
7367,3,[VFN]Sonny,3502,582,26,16,42,61.9%,13m
7367,3,JanosMlotos,3502,656,26,23,49,53.1%,10m
7367,3,[Salsig]Bigfoot,3502,218,9,2,11,81.8%,23m
7367,3,[Cannоn]Stromberg,3502,151,7,4,11,63.6%,11m
7367,2,BodYaNdSouL,3502,62,2,9,11,18.2%,5m
7367,3,yukee,3502,0,1,0,1,100.0%,10m
7367,3,MoJo,3502,0,1,1,2,50.0%,35m
7367,3,Delece,3502,0,1,5,6,16.7%,5m
7367,3,TranceFuZion,3502,0,0,1,1,0.0%,5m
7380,3,[MSUSC2]Kirber,3501,1447,149,126,275,54.2%,15m
7380,2,SirAelic,3501,816,147,142,289,50.9%,8m
7380,3,ROPredaTOR,3501,1204,128,124,252,50.8%,22m
7380,2,skdaniel,3501,1484,108,115,223,48.4%,36m
7380,2,[ƔĘƝ]Valerian,3501,1000,96,94,190,50.5%,9m
7380,3,cruiseship,3501,465,76,77,153,49.7%,19m
7380,3,[AgK]stroyer,3501,822,39,18,57,68.4%,36m
7380,2,Vulcinodin,3501,948,32,40,72,44.4%,36m
7380,3,[QTcIub]jackie,3501,122,5,4,9,55.6%,5m
7380,3,ROCKSTAR,3501,30,2,1,3,66.7%,5m
7380,3,[Hunt3r]PIF,3501,30,1,3,4,25.0%,6m
7380,3,borsh,3501,0,0,2,2,0.0%,16m
7392,2,Paowie,3500,1544,293,270,563,52.0%,22m
7392,3,chizhik,3500,369,56,48,104,53.8%,13m
7392,3,[SxS]Radio,3500,754,29,27,56,51.8%,16m
7392,2,Perfy,3500,289,16,8,24,66.7%,36m
7392,2,Gambos,3500,210,9,2,11,81.8%,18m
7392,3,NavidHulk,3500,0,5,0,5,100.0%,22m
7392,3,[NISHOD]SkiLongLion,3500,114,5,1,6,83.3%,9m
7392,3,ITZY,3500,120,4,9,13,30.8%,17m
7392,3,JlEBIIIA,3500,60,3,2,5,60.0%,9m
7392,3,frankimahri,3500,30,2,0,2,100.0%,35m
7392,3,[OtES]cronos,3500,30,2,0,2,100.0%,19m
7392,3,Tranzendel,3500,58,2,3,5,40.0%,13m
7392,3,[NotD]ThunderStorm,3500,0,0,1,1,0.0%,8m
7405,3,[ADVIA]InterNeto,3499,1243,82,71,153,53.6%,12m
7405,2,HappySwarm,3499,771,31,41,72,43.1%,16m
7405,3,[Hаsu]Brightfuture,3499,571,22,17,39,56.4%,4m
7405,3,Eroune,3499,514,20,14,34,58.8%,11m
7405,2,[Moisty]Ilyen,3499,279,14,16,30,46.7%,35m
7405,1,[CCG]Kadamudi,3499,218,9,7,16,56.2%,10m
7405,3,Lamkin,3499,253,8,6,14,57.1%,16m
7405,2,anathos,3499,190,7,7,14,50.0%,10m
7405,2,Miéle,3499,216,7,18,25,28.0%,10m
7405,3,BoFF,3499,0,5,0,5,100.0%,19m
7405,3,Razeal,3499,30,2,4,6,33.3%,15m
7405,3,[justS]Gheorghe,3499,30,1,2,3,33.3%,20m
7417,2,[RеG]Hunblee,3498,1524,137,119,256,53.5%,3m
7417,2,HardRock,3498,609,136,111,247,55.1%,19m
7417,3,[TedB]ZZZeRg,3498,1471,121,95,216,56.0%,8m
7417,3,MalXantholos,3498,140,21,20,41,51.2%,15m
7417,3,[RandFT]JUDAS,3498,302,11,9,20,55.0%,35m
7417,2,[Dae]Mandrakel,3498,229,8,5,13,61.5%,3m
7417,3,[ZЕRGTV]Qwan,3498,88,3,3,6,50.0%,6m
7417,3,MING,3498,60,3,5,8,37.5%,9m
7417,2,[Ascend]NeoNet,3498,48,3,6,9,33.3%,4m
7417,2,[HämSec]LightTrack,3498,0,1,0,1,100.0%,6m
7417,3,[LSPs]Mochuelo,3498,0,0,2,2,0.0%,10m
7417,3,legoshpego,3498,0,0,2,2,0.0%,23m
7429,3,[VoiDTS]SCPXelborn,3497,907,67,48,115,58.3%,23m
7429,3,MPmp,3497,980,41,26,67,61.2%,17m
7429,2,Zerger,3497,449,32,32,64,50.0%,36m
7429,2,DrPoon,3497,433,31,32,63,49.2%,14m
7429,3,OKAMI,3497,98,5,0,5,100.0%,35m
7429,3,WhiteWolf,3497,146,5,7,12,41.7%,5m
7429,3,Zorro,3497,0,2,3,5,40.0%,5m
7429,3,IngeniusSoul,3497,60,2,6,8,25.0%,19m
7429,3,IIIIIIIIIIII,3497,0,0,1,1,0.0%,6m
7438,2,[Bloopz]StormBlooper,3496,1280,407,390,797,51.1%,7m
7438,2,DirtyBadgers,3496,1625,106,111,217,48.8%,13m
7438,2,JaxO,3496,1503,78,86,164,47.6%,8m
7438,3,[KORI]Haruka,3496,562,45,36,81,55.6%,6m
7438,3,dcare,3496,860,33,28,61,54.1%,7m
7438,3,Rickoshet,3496,478,29,20,49,59.2%,4m
7438,3,MHJ,3496,422,17,11,28,60.7%,6m
7438,3,[сSсǃ]KailoR,3496,324,13,7,20,65.0%,6m
7438,2,pEz,3496,410,13,18,31,41.9%,15m
7438,3,Juliuus,3496,0,1,0,1,100.0%,22m
7448,2,GreeNMaN,3495,1519,317,310,627,50.6%,8m
7448,2,[CClank]discordia,3495,765,99,109,208,47.6%,20m
7448,2,YouTubTigron,3495,537,97,85,182,53.3%,6m
7448,3,FistBruh,3495,494,49,41,90,54.4%,4m
7448,2,[GoldM]Hyouka,3495,946,38,46,84,45.2%,15m
7448,3,Kharyb,3495,338,12,8,20,60.0%,36m
7454,3,TMay,3494,1238,115,84,199,57.8%,8m
7454,3,[PLA2N]Shinobi,3494,140,6,2,8,75.0%,6m
7454,3,MiNTBalistiC,3494,60,2,2,4,50.0%,10m
7454,3,WhoAmI,3494,30,2,2,4,50.0%,35m
7454,3,[TFSC]CaZo,3494,0,1,4,5,20.0%,16m
7459,2,CallMeMaybe,3493,461,31,26,57,54.4%,21m
7459,2,ZPablo,3493,750,30,29,59,50.8%,35m
7459,3,avraL,3493,542,20,14,34,58.8%,13m
7459,2,Sandoran,3493,524,19,20,39,48.7%,19m
7459,2,ClayMan,3493,456,17,26,43,39.5%,13m
7459,2,llllllllll,3493,156,9,4,13,69.2%,22m
7459,3,[BRSKR]Paloma,3493,214,7,12,19,36.8%,4m
7459,3,PMW,3493,180,6,9,15,40.0%,9m
7459,3,martiros,3493,114,4,3,7,57.1%,12m
7459,3,[FuqhU]DReffects,3493,58,3,0,3,100.0%,5m
7459,3,[YlKES]Kotbert,3493,60,3,3,6,50.0%,22m
7459,3,[BaföG]Turbocat,3493,0,0,1,1,0.0%,9m
7459,3,AdamMidler,3493,0,0,1,1,0.0%,37m
7459,3,[TSC2C]Qlimax,3493,0,0,2,2,0.0%,6m
7473,3,MiTKiNG,3492,1336,149,145,294,50.7%,11m
7473,2,James,3492,1425,69,76,145,47.6%,13m
7473,1,[EESC]Pingüi,3492,950,30,53,83,36.1%,6m
7473,3,skazy,3492,316,11,14,25,44.0%,15m
7473,2,[GFN]Ubba,3492,282,9,16,25,36.0%,8m
7473,2,Droco,3492,266,9,23,32,28.1%,20m
7473,3,ABO,3492,166,7,1,8,87.5%,22m
7473,3,TritoX,3492,60,6,3,9,66.7%,21m
7473,2,[PuuZ]AtomTom,3492,194,6,9,15,40.0%,19m
7473,3,Zak,3492,150,5,8,13,38.5%,35m
7473,3,KEKEUGIVESOJ,3492,114,4,2,6,66.7%,22m
7473,3,BlackJack,3492,0,0,1,1,0.0%,16m
7473,2,Fenrack,3492,0,0,1,1,0.0%,14m
7473,3,Grimsqueaker,3492,0,0,1,1,0.0%,16m
7473,3,[Blacer]Fentera,3492,0,0,1,1,0.0%,9m
7473,3,[DeCr]Wockes,3492,0,0,3,3,0.0%,20m
7489,2,ShadowHunter,3491,1610,297,293,590,50.3%,35m
7489,2,Lektan,3491,1408,248,217,465,53.3%,19m
7489,1,Sisteur,3491,1598,129,139,268,48.1%,11m
7489,3,Ksardius,3491,1168,45,44,89,50.6%,23m
7489,3,GreatPeople,3491,772,32,21,53,60.4%,9m
7489,3,[Gloves]WSW,3491,591,24,21,45,53.3%,16m
7489,3,RiskyBusines,3491,544,23,12,35,65.7%,16m
7489,3,Shirrak,3491,294,11,5,16,68.8%,36m
7489,3,Croax,3491,268,11,6,17,64.7%,10m
7489,3,DigitalWaves,3491,166,7,6,13,53.8%,4m
7489,3,[T4E]TFEnos,3491,30,2,2,4,50.0%,15m
7489,3,[Take]Kiigass,3491,60,2,3,5,40.0%,6m
7489,3,[PTZS]Xeon,3491,0,1,0,1,100.0%,9m
7489,3,PROTEY,3491,0,1,1,2,50.0%,7m
7489,2,dawned,3491,0,0,1,1,0.0%,16m
7489,3,Conn,3491,0,0,1,1,0.0%,11m
7489,3,[QTclub]Sentinel,3491,0,0,1,1,0.0%,13m
7506,2,Masiko,3490,1382,325,317,642,50.6%,5m
7506,3,Alex,3490,1391,128,109,237,54.0%,22m
7506,2,KaMaLiNeGYPT,3490,328,78,66,144,54.2%,8m
7506,2,AresNyx,3490,1318,59,59,118,50.0%,13m
7506,3,StrikerOne,3490,918,40,31,71,56.3%,17m
7506,2,Cinek,3490,494,18,22,40,45.0%,20m
7506,3,[yлeй55]ПечальныйТОС,3490,30,5,1,6,83.3%,21m
7506,3,[Jail]Enzed,3490,88,3,4,7,42.9%,6m
7506,3,Gungnir,3490,30,2,2,4,50.0%,9m
7506,3,[50CM]Tarask,3490,0,1,0,1,100.0%,16m
7506,3,[ĦĦ]JamesWade,3490,0,1,0,1,100.0%,12m
7506,2,Snickery,3490,0,1,0,1,100.0%,4m
7506,3,toR,3490,0,0,1,1,0.0%,15m
7519,2,Maulw,3489,1453,58,66,124,46.8%,20m
7519,2,Maks,3489,536,19,22,41,46.3%,5m
7519,2,Kranon,3489,240,9,15,24,37.5%,10m
7519,3,Léo,3489,244,8,10,18,44.4%,4m
7519,3,IrishDragoon,3489,40,6,1,7,85.7%,21m
7519,3,BlackBread,3489,144,6,5,11,54.5%,15m
7519,3,Cronodynamic,3489,122,4,5,9,44.4%,15m
7519,1,[Biu]Noir,3489,0,3,2,5,60.0%,5m
7519,3,MamusiuRatuj,3489,0,0,1,1,0.0%,7m
7528,2,Guti,3488,1547,241,242,483,49.9%,14m
7528,3,gogogo,3488,1554,217,209,426,50.9%,8m
7528,2,Maloja,3488,1500,140,134,274,51.1%,9m
7528,3,[sledna]RealQuizM,3488,454,16,17,33,48.5%,4m
7528,3,[NSLP]elmaster,3488,30,1,2,3,33.3%,21m
7528,3,LUCHOK,3488,0,0,1,1,0.0%,9m
7528,3,Tobi,3488,0,0,2,2,0.0%,15m
7528,1,[SPO0KY]HunteR,3488,0,0,4,4,0.0%,1h
7536,2,[MAYEK]gabtro,3487,1173,65,58,123,52.8%,19m
7536,3,ftwo,3487,413,26,20,46,56.5%,22m
7536,3,[Vetal]Agrobot,3487,314,11,12,23,47.8%,7m
7536,3,Margret,3487,38,6,1,7,85.7%,16m
7536,2,[LDLV]Poun,3487,146,5,11,16,31.2%,10m
7536,3,WoutVanAert,3487,30,4,2,6,66.7%,4m
7536,2,Marranelo,3487,0,0,3,3,0.0%,21m
7543,3,Thracian,3486,377,35,27,62,56.5%,12m
7543,2,mrmoo,3486,395,25,30,55,45.5%,9m
7543,2,coni,3486,596,20,24,44,45.5%,16m
7543,3,BeastyQT,3486,436,19,6,25,76.0%,4m
7543,3,Vito,3486,488,19,16,35,54.3%,4m
7543,2,Sagara,3486,422,14,29,43,32.6%,8m
7543,3,ENEMYY,3486,221,12,7,19,63.2%,5m
7543,3,Spawn,3486,90,4,6,10,40.0%,15m
7543,3,[MST]Heliogabal,3486,60,2,4,6,33.3%,11m
7543,3,[NetGG]Elsi,3486,30,2,5,7,28.6%,7m
7543,3,Danpler,3486,30,1,2,3,33.3%,15m
7543,3,[Frass]TigeRFurY,3486,0,0,1,1,0.0%,15m
7543,3,DevilOP,3486,0,0,1,1,0.0%,6m
7556,3,[CZSC]TomAceCZ,3485,1592,127,121,248,51.2%,11m
7556,2,[PLA2N]ReversOnFire,3485,986,82,80,162,50.6%,16m
7556,3,ШеФутинский,3485,1407,72,59,131,55.0%,20m
7556,2,[iANGEL]Legate,3485,1456,70,77,147,47.6%,36m
7556,3,latote,3485,1030,44,25,69,63.8%,11m
7556,3,TitLe,3485,870,35,22,57,61.4%,11m
7556,3,Arcturus,3485,656,25,22,47,53.2%,14m
7556,2,Sam,3485,556,22,23,45,48.9%,12m
7556,3,Shooter,3485,330,16,7,23,69.6%,15m
7556,3,IgorGulyaev,3485,170,7,6,13,53.8%,21m
7556,3,Bezerger,3485,0,2,4,6,33.3%,20m
7556,3,franco,3485,30,1,5,6,16.7%,10m
7556,1,Laurent,3485,0,0,1,1,0.0%,12m
7556,3,Kshaqua,3485,0,0,1,1,0.0%,23m
7556,3,vatiba,3485,0,0,3,3,0.0%,5m
7571,2,[3Gmod]DemonHunter,3484,1510,366,355,721,50.8%,19m
7571,3,Veretragna,3484,1647,97,69,166,58.4%,11m
7571,3,Nonshlen,3484,1572,75,73,148,50.7%,10m
7571,2,KEYARIN,3484,305,62,48,110,56.4%,20m
7571,3,Alexandr,3484,1175,60,44,104,57.7%,6m
7571,3,Nop,3484,663,46,45,91,50.5%,7m
7571,2,SAN,3484,714,27,31,58,46.6%,14m
7571,3,[aW]clockmaster,3484,278,10,9,19,52.6%,22m
7571,3,Eatme,3484,192,8,6,14,57.1%,10m
7571,3,[MHD683]Proteus,3484,0,5,0,5,100.0%,9m
7571,3,Veclada,3484,114,5,3,8,62.5%,10m
7571,2,toon,3484,88,4,10,14,28.6%,9m
7571,3,[BTwins]Croword,3484,0,1,0,1,100.0%,20m
7571,3,Nextgenx,3484,0,1,2,3,33.3%,13m
7571,3,Noob,3484,30,1,3,4,25.0%,6m
7571,3,[RZPI]Adam,3484,0,0,1,1,0.0%,15m
7571,3,[DFYIII]noddy,3484,0,0,1,1,0.0%,20m
7588,2,ggrachRU,3483,1576,163,158,321,50.8%,18m
7588,3,[iX]Würmchen,3483,1240,132,111,243,54.3%,5m
7588,2,ShadowFury,3483,1398,77,92,169,45.6%,14m
7588,2,BigBadMama,3483,498,19,17,36,52.8%,14m
7588,2,[Dobro]GovorS,3483,199,7,9,16,43.8%,10m
7588,3,Ferret,3483,0,5,0,5,100.0%,19m
7588,3,TeriyakiBoyz,3483,0,5,0,5,100.0%,21m
7588,1,[MGTSC2]Feltini,3483,0,3,2,5,60.0%,1h
7588,2,PersonOnline,3483,0,1,5,6,16.7%,9m
7588,3,[MgSt]DonRasspe,3483,0,0,2,2,0.0%,8m
7598,2,Sooriuken,3482,1325,54,49,103,52.4%,21m
7598,3,Валантис,3482,580,39,27,66,59.1%,15m
7598,3,Berd,3482,824,31,31,62,50.0%,12m
7598,3,Zwoggy,3482,419,28,21,49,57.1%,22m
7598,3,loveandmusic,3482,606,26,16,42,61.9%,5m
7598,3,astro,3482,468,18,11,29,62.1%,21m
7598,2,Tolpak,3482,408,14,17,31,45.2%,10m
7598,3,Krutoy,3482,86,4,0,4,100.0%,15m
7598,2,[GLD]FrapKunKù,3482,92,3,10,13,23.1%,19m
7598,3,AshlynRae,3482,0,0,1,1,0.0%,5m
7608,3,player,3481,1582,62,57,119,52.1%,4m
7608,3,[Violat]WhineRa,3481,616,23,22,45,51.1%,8m
7608,3,Murmel,3481,433,22,10,32,68.8%,15m
7608,3,LiquidFlem,3481,494,20,6,26,76.9%,15m
7608,3,Côôky,3481,146,6,8,14,42.9%,10m
7608,3,[TLT1]Sarnek,3481,114,4,4,8,50.0%,17m
7608,3,Ion,3481,58,3,2,5,60.0%,15m
7608,3,[QTclub]JackDeRipper,3481,0,1,0,1,100.0%,35m
7608,3,BigJim,3481,0,1,0,1,100.0%,3m
7617,2,Alexoid,3480,1539,157,164,321,48.9%,10m
7617,2,[KrnBrs]Zombe,3480,1566,136,124,260,52.3%,16m
7617,2,[BRSKR]Ratfizz,3480,494,29,23,52,55.8%,23m
7617,3,MysteryL,3480,430,18,12,30,60.0%,13m
7617,3,Dova,3480,298,11,2,13,84.6%,14m
7617,3,NPGCMadGuy,3480,306,11,10,21,52.4%,19m
7617,1,Yahweh,3480,0,5,0,5,100.0%,17m
7617,3,Itoniumek,3480,0,1,0,1,100.0%,12m
7617,3,[Frzen]Lanaya,3480,0,0,1,1,0.0%,15m
7617,3,[PÂRłAH]IdefixCZ,3480,0,0,2,2,0.0%,15m
7627,2,xDAVx,3479,1479,207,186,393,52.7%,9m
7627,3,Conejo,3479,1566,177,176,353,50.1%,6m
7627,1,Vladivostok,3479,962,83,105,188,44.1%,15m
7627,3,RoseCheese,3479,731,58,48,106,54.7%,37m
7627,2,[OseF]Boomshaka,3479,737,32,46,78,41.0%,14m
7627,2,DBFlux,3479,516,22,16,38,57.9%,23m
7627,3,[Cracot]BattlingPolo,3479,423,18,11,29,62.1%,22m
7627,3,[SLD]mogoh,3479,338,13,13,26,50.0%,11m
7627,2,ArnoldRimmer,3479,165,9,3,12,75.0%,6m
7627,3,wojtek,3479,142,5,5,10,50.0%,17m
7627,3,DuncanDalas,3479,64,5,14,19,26.3%,20m
7627,3,VALUCO,3479,0,0,1,1,0.0%,18m
7627,1,MrPink,3479,0,0,1,1,0.0%,22m
7627,3,MGuDiM,3479,0,0,3,3,0.0%,9m
7641,3,Melenya,3478,1580,111,87,198,56.1%,8m
7641,2,ForgottenThe,3478,984,108,102,210,51.4%,10m
7641,2,System,3478,509,39,47,86,45.3%,13m
7641,3,IIIIIIIIIIII,3478,334,14,16,30,46.7%,19m
7641,2,[Zizou]SolidDuke,3478,406,13,22,35,37.1%,35m
7641,2,Dolce,3478,114,8,6,14,57.1%,8m
7641,3,TANOS,3478,178,6,0,6,100.0%,13m
7641,3,[GC]RygelXVI,3478,30,1,1,2,50.0%,19m
7641,3,Valeriksan,3478,0,0,1,1,0.0%,19m
7641,3,[lLiTl]Yes,3478,0,0,2,2,0.0%,7m
7651,3,Merlinius,3477,1565,282,261,543,51.9%,21m
7651,3,Mendeley,3477,1626,189,170,359,52.6%,10m
7651,3,[яєѕ]owenose,3477,541,64,46,110,58.2%,4m
7651,3,Aclick,3477,452,16,17,33,48.5%,9m
7651,3,RSC,3477,140,9,3,12,75.0%,22m
7651,2,AzoG,3477,188,7,14,21,33.3%,20m
7651,3,[D0N3]KwADwO,3477,0,1,0,1,100.0%,35m
7658,3,iMPreSSiVE,3476,1033,45,34,79,57.0%,16m
7658,3,Sergio,3476,954,41,27,68,60.3%,10m
7658,3,millionar,3476,349,16,8,24,66.7%,22m
7658,3,[onon]OVERLORD,3476,76,10,9,19,52.6%,35m
7658,3,CptObvious,3476,234,8,11,19,42.1%,19m
7658,3,[Notag]Protoss,3476,60,3,2,5,60.0%,19m
7658,3,DaNoM,3476,30,2,2,4,50.0%,7m
7658,3,Maestro,3476,0,1,0,1,100.0%,5m
7658,3,[Xa]Fantatratto,3476,0,1,0,1,100.0%,19m
7658,3,LaoTzu,3476,30,1,1,2,50.0%,11m
7658,3,RoachyRoach,3476,0,1,4,5,20.0%,21m
7669,2,LesBop,3475,1550,426,420,846,50.4%,16m
7669,3,beschijeboxt,3475,1355,249,230,479,52.0%,9m
7669,2,happytoss,3475,1515,132,133,265,49.8%,36m
7669,3,TakeOnMe,3475,376,15,10,25,60.0%,5m
7669,3,SuperMarine,3475,316,13,5,18,72.2%,15m
7669,3,[Acte]Ladidum,3475,226,8,5,13,61.5%,10m
7669,3,Chucklez,3475,150,6,10,16,37.5%,5m
7669,1,Odin,3475,165,3,8,11,27.3%,9m
7669,3,IIIIIIIIIIII,3475,30,1,3,4,25.0%,23m
7669,1,[BuxBux]Stahl,3475,0,0,5,5,0.0%,1h
7669,3,[Cboo]Darkspine,3475,0,0,5,5,0.0%,21m
7680,2,CraftStarNL,3474,1568,362,355,717,50.5%,14m
7680,2,GSM,3474,1473,189,187,376,50.3%,15m
7680,3,Зелень,3474,1432,67,62,129,51.9%,5m
7680,3,Morrolan,3474,575,35,30,65,53.8%,23m
7680,3,[D2SA]MrFerlane,3474,776,32,21,53,60.4%,7m
7680,3,[BWArmy]yaze,3474,548,21,16,37,56.8%,35m
7680,3,Goldfish,3474,78,3,5,8,37.5%,15m
7680,3,WillyWonka,3474,58,2,1,3,66.7%,11m
7680,3,bllndman,3474,30,1,1,2,50.0%,8m
7680,3,[Clеvеr]RogGaming,3474,0,1,2,3,33.3%,9m
7680,3,улыбастик,3474,0,0,1,1,0.0%,13m
7680,3,[cLn]ReTrY,3474,0,0,2,2,0.0%,9m
7692,2,keries,3473,1532,274,273,547,50.1%,14m
7692,2,Gamergaard,3473,1583,167,167,334,50.0%,13m
7692,2,AndrU,3473,1555,105,114,219,47.9%,12m
7692,3,Opa,3473,1086,81,79,160,50.6%,4m
7692,2,[яєѕ]Zurc,3473,1469,65,74,139,46.8%,35m
7692,2,Szudemer,3473,1510,64,77,141,45.4%,23m
7692,3,ÅpoliscreeÐ,3473,585,49,33,82,59.8%,23m
7692,2,[OРДА]батя,3473,571,27,21,48,56.2%,13m
7692,3,Spartan,3473,346,14,6,20,70.0%,16m
7692,2,KnowingTree,3473,378,14,19,33,42.4%,9m
7692,3,LaTro,3473,259,12,8,20,60.0%,8m
7692,1,StarTouf,3473,253,11,5,16,68.8%,22m
7692,3,imotical,3473,203,10,2,12,83.3%,5m
7692,3,NOONE,3473,114,4,3,7,57.1%,37m
7692,2,Fullbringer,3473,181,4,9,13,30.8%,18m
7692,3,[FakJU]jazda,3473,118,3,1,4,75.0%,5m
7692,2,LIKTORred,3473,88,3,14,17,17.6%,23m
7692,3,Lunseeker,3473,0,1,0,1,100.0%,13m
7692,3,zeke,3473,30,1,1,2,50.0%,4m
7692,3,[αX]Boulanger,3473,0,1,4,5,20.0%,35m
7712,3,Nowliei,3472,1348,106,87,193,54.9%,15m
7712,2,megAdept,3472,1341,103,97,200,51.5%,7m
7712,3,GeneralJules,3472,1589,82,63,145,56.6%,9m
7712,3,Alucard,3472,710,27,21,48,56.2%,11m
7712,3,[Titti]eNma,3472,529,25,17,42,59.5%,22m
7712,2,Nji,3472,336,16,12,28,57.1%,22m
7712,3,[HämSec]sciencedwarf,3472,382,13,16,29,44.8%,23m
7712,1,Montanelle,3472,0,5,0,5,100.0%,1h
7712,3,xliqhtbeatz,3472,162,5,3,8,62.5%,6m
7712,3,ruzik,3472,0,1,0,1,100.0%,8m
7712,2,Zakabara,3472,0,0,1,1,0.0%,6m
7712,3,ChriZ,3472,0,0,2,2,0.0%,9m
7724,3,Alwar,3471,1654,191,173,364,52.5%,17m
7724,3,Sven,3471,1629,92,87,179,51.4%,12m
7724,3,theconker,3471,958,73,49,122,59.8%,5m
7724,2,[ICGl]Madness,3471,717,62,69,131,47.3%,15m
7724,3,ThirtySixYO,3471,730,37,26,63,58.7%,15m
7724,2,petuh,3471,466,29,21,50,58.0%,19m
7724,2,gevilde,3471,503,24,19,43,55.8%,20m
7724,3,tyrael,3471,534,23,15,38,60.5%,6m
7724,2,SeyLerT,3471,405,17,16,33,51.5%,13m
7724,2,Tempbond,3471,430,14,21,35,40.0%,16m
7724,3,[CFEL]Venom,3471,231,12,8,20,60.0%,13m
7724,2,[BozToz]RoBicepz,3471,190,6,14,20,30.0%,12m
7724,3,Bexd,3471,116,4,4,8,50.0%,7m
7724,3,MCGollum,3471,0,1,0,1,100.0%,20m
7738,2,[KievUA]kollob,3470,1558,249,237,486,51.2%,16m
7738,2,[696]nipo,3470,1609,144,138,282,51.1%,15m
7738,2,insolol,3470,1414,52,61,113,46.0%,10m
7738,2,[PÂRłAH]Diego,3470,404,46,53,99,46.5%,10m
7738,3,Vizzord,3470,970,41,27,68,60.3%,12m
7738,3,[AON100]Mati,3470,602,24,17,41,58.5%,12m
7738,2,Shlex,3470,351,14,13,27,51.9%,9m
7738,3,[EGJD]LCW,3470,366,13,13,26,50.0%,13m
7738,3,[Kingz]Mondragon,3470,142,6,9,15,40.0%,5m
7738,1,AkVAgRIM,3470,0,5,0,5,100.0%,33m
7738,3,[UAŦeam]Paspartoo,3470,118,4,7,11,36.4%,7m
7738,3,[TAW]MarsBar,3470,60,3,2,5,60.0%,12m
7738,3,theswarm,3470,60,3,3,6,50.0%,11m
7738,2,RobespierEvo,3470,0,1,1,2,50.0%,9m
7738,2,Warhunter,3470,93,1,1,2,50.0%,16m
7738,2,[Charm]Mabbes,3470,0,0,1,1,0.0%,3m
7738,3,Cube,3470,0,0,2,2,0.0%,36m
7755,3,Nigel,3469,1173,48,34,82,58.5%,15m
7755,3,mainman,3469,532,30,24,54,55.6%,10m
7755,3,IlIlIlIlIlIl,3469,624,25,20,45,55.6%,15m
7755,2,Filthius,3469,312,15,12,27,55.6%,12m
7755,3,Franck,3469,144,5,5,10,50.0%,10m
7755,2,IvanRos,3469,154,5,12,17,29.4%,14m
7755,3,afh,3469,92,3,5,8,37.5%,9m
7755,3,[wiGGa]DemiGodlv,3469,0,2,2,4,50.0%,13m
7755,3,LabCoatLarry,3469,58,2,3,5,40.0%,20m
7755,3,[OOWW]RMziom,3469,62,2,4,6,33.3%,7m
7755,3,Dobby,3469,0,0,2,2,0.0%,35m
7766,2,TeilobRUN,3468,974,120,97,217,55.3%,35m
7766,3,dontQ,3468,1317,56,39,95,58.9%,13m
7766,3,DeadMonster,3468,1214,52,38,90,57.8%,21m
7766,3,Damkani,3468,1050,41,34,75,54.7%,10m
7766,2,Deq,3468,1025,39,42,81,48.1%,6m
7766,3,Blackshade,3468,380,14,14,28,50.0%,19m
7766,3,Sevas,3468,198,8,5,13,61.5%,13m
7766,2,sTeF,3468,215,6,13,19,31.6%,15m
7766,3,Prinny,3468,159,4,5,9,44.4%,36m
7766,2,BLyOrDie,3468,140,4,5,9,44.4%,3m
7766,3,[PPojk]Rascarcapac,3468,90,4,6,10,40.0%,20m
7766,3,WindBlade,3468,58,3,0,3,100.0%,16m
7766,3,[EUww1]Chel,3468,88,3,3,6,50.0%,4m
7766,3,udii,3468,60,2,4,6,33.3%,36m
7766,3,LBMR,3468,0,0,1,1,0.0%,21m
7766,3,[Toxicc]simon,3468,0,0,2,2,0.0%,5m
7782,2,Keyli,3467,1202,44,49,93,47.3%,10m
7782,3,LuckyOwl,3467,1202,43,46,89,48.3%,10m
7782,2,BIIuX,3467,889,41,40,81,50.6%,36m
7782,2,BUBU,3467,344,26,26,52,50.0%,7m
7782,3,WARTANK,3467,569,25,14,39,64.1%,16m
7782,3,[DDR10]daflowjoe,3467,395,17,12,29,58.6%,4m
7782,3,[Aggri]Aggressor,3467,149,4,4,8,50.0%,37m
7782,3,Popops,3467,104,4,7,11,36.4%,9m
7782,3,[44IQ]FourHead,3467,30,2,3,5,40.0%,15m
7782,3,[ERaven]GiGathese,3467,0,1,0,1,100.0%,11m
7782,3,[ARMED]roggier,3467,30,1,1,2,50.0%,17m
7793,3,[PÂRłAH]lukySlovakia,3466,966,39,32,71,54.9%,13m
7793,3,[LPbass]Novikov,3466,364,12,6,18,66.7%,4m
7793,3,Evolution,3466,258,10,9,19,52.6%,12m
7793,3,Сумрак,3466,168,9,8,17,52.9%,16m
7793,3,Shatzy,3466,0,3,2,5,60.0%,9m
7793,3,[H0C]softmax,3466,0,1,0,1,100.0%,6m
7793,3,Badack,3466,0,1,0,1,100.0%,22m
7793,3,ObviousNerd,3466,30,1,1,2,50.0%,6m
7793,3,PULO,3466,30,1,4,5,20.0%,8m
7793,3,Jockel,3466,30,1,4,5,20.0%,10m
7793,3,Fearish,3466,0,0,1,1,0.0%,16m
7793,3,RevaN,3466,0,0,5,5,0.0%,22m
7805,2,NeMo,3465,1599,312,304,616,50.6%,22m
7805,3,[OmDi]LIQUIDDOER,3465,718,32,20,52,61.5%,4m
7805,3,Waynetrain,3465,362,16,7,23,69.6%,15m
7805,1,Rumo,3465,236,8,4,12,66.7%,22m
7805,3,stalker,3465,150,6,10,16,37.5%,16m
7805,3,Волшебник,3465,114,5,5,10,50.0%,16m
7805,3,[uKu]Klesh,3465,124,4,9,13,30.8%,11m
7805,3,[QTclub]Viewtiful,3465,30,2,1,3,66.7%,7m
7805,3,[Batia]Марик,3465,0,1,0,1,100.0%,13m
7805,3,[Arrows]Samer,3465,0,0,1,1,0.0%,22m
7815,2,ANTHERWIN,3464,1618,585,576,1161,50.4%,14m
7815,3,matvid,3464,1520,59,57,116,50.9%,37m
7815,2,[AoTu]Andyone,3464,1246,54,60,114,47.4%,7m
7815,3,[WAAAR]LED,3464,1056,45,33,78,57.7%,7m
7815,3,barcode,3464,968,40,26,66,60.6%,36m
7815,3,halfquake,3464,364,16,7,23,69.6%,13m
7815,3,XIPNOSIS,3464,290,11,10,21,52.4%,12m
7815,3,[PulS]Akamu,3464,333,10,17,27,37.0%,13m
7815,2,llllllllllll,3464,138,6,6,12,50.0%,4m
7815,3,Bherliooz,3464,114,4,4,8,50.0%,6m
7815,3,Atlas,3464,30,1,2,3,33.3%,9m
7815,3,[Regret]Arachnid,3464,0,0,1,1,0.0%,19m
7815,3,Donjon,3464,0,0,1,1,0.0%,8m
7828,2,STALINgRAd,3463,1561,782,772,1554,50.3%,36m
7828,2,promo,3463,1553,189,190,379,49.9%,23m
7828,2,FonsDeSpons,3463,735,46,49,95,48.4%,9m
7828,3,[AciNoN]AngryFrog,3463,1044,40,43,83,48.2%,8m
7828,3,Yeet,3463,834,34,29,63,54.0%,4m
7828,3,WranglerBG,3463,593,26,15,41,63.4%,9m
7828,3,UnfOrGiVeN,3463,684,26,19,45,57.8%,8m
7828,3,palooaloo,3463,514,21,5,26,80.8%,37m
7828,2,[ESMC]NotFound,3463,189,9,4,13,69.2%,12m
7828,3,Neydark,3463,234,8,12,20,40.0%,22m
7828,3,SunnyDay,3463,237,7,10,17,41.2%,5m
7828,3,Wooteq,3463,121,6,1,7,85.7%,19m
7828,3,[AMIGOO]mordaszes,3463,144,6,3,9,66.7%,16m
7828,3,Geradon,3463,62,3,4,7,42.9%,19m
7828,3,[duсks]Mimicrid,3463,62,3,6,9,33.3%,11m
7828,3,IMPERION,3463,58,2,4,6,33.3%,9m
7828,3,superProbe,3463,58,2,6,8,25.0%,23m
7828,3,Supernoob,3463,0,0,1,1,0.0%,14m
7846,3,vrnigor,3462,1476,386,375,761,50.7%,18m
7846,2,ĿŬƇƘ,3462,1564,115,119,234,49.1%,19m
7846,2,[IybDS]UndisputeD,3462,1051,74,61,135,54.8%,5m
7846,3,MastrOfOrion,3462,162,42,30,72,58.3%,8m
7846,3,ratchet,3462,429,19,7,26,73.1%,6m
7846,3,VisseG,3462,381,18,7,25,72.0%,19m
7846,3,LazyGuy,3462,86,3,1,4,75.0%,35m
7846,3,[RoRagE]PGeo,3462,60,2,2,4,50.0%,7m
7846,3,Kerios,3462,30,2,2,4,50.0%,13m
7846,3,Shoterstrike,3462,30,2,6,8,25.0%,7m
7846,3,Buch,3462,0,1,0,1,100.0%,7m
7857,3,[TYC3E]FReaK,3461,1577,138,116,254,54.3%,17m
7857,3,[Dobro]Kulinar,3461,535,75,72,147,51.0%,4m
7857,3,[GdAT]Ciclyde,3461,740,32,12,44,72.7%,9m
7857,3,[IMoosI]Moostick,3461,415,26,22,48,54.2%,36m
7857,3,[lOoOl]foREVer,3461,426,19,9,28,67.9%,20m
7857,3,Diagoni,3461,318,15,6,21,71.4%,19m
7857,3,Baldamir,3461,254,9,9,18,50.0%,5m
7857,3,[Kozaky]Nifler,3461,220,8,9,17,47.1%,12m
7857,3,[Norður]Arkesilas,3461,176,7,6,13,53.8%,20m
7857,3,[aW]Destro,3461,30,2,2,4,50.0%,17m
7857,3,FiFoAurél,3461,0,2,5,7,28.6%,17m
7857,3,SixeS,3461,0,1,0,1,100.0%,16m
7857,3,Serenity,3461,0,1,0,1,100.0%,37m
7857,3,[0BO]Sparky,3461,0,0,1,1,0.0%,4m
7857,3,Oli,3461,0,0,1,1,0.0%,12m
7857,3,Sеrrаl,3461,0,0,1,1,0.0%,10m
7873,2,Daedalus,3460,1558,145,148,293,49.5%,16m
7873,3,IIIIIIIIIIII,3460,1181,83,55,138,60.1%,8m
7873,3,Mithrandir,3460,718,31,13,44,70.5%,18m
7873,3,CottonSock,3460,569,28,8,36,77.8%,19m
7873,3,OmasArche,3460,262,8,7,15,53.3%,12m
7873,3,Hubixb,3460,86,3,6,9,33.3%,37m
7873,3,[SCWEED]TMarchev,3460,0,0,2,2,0.0%,12m
7880,2,Crypto,3459,1551,170,174,344,49.4%,16m
7880,3,Rabitibike,3459,1571,138,108,246,56.1%,9m
7880,3,DarkneZZ,3459,1505,129,101,230,56.1%,10m
7880,2,[666999]IknownothinG,3459,1485,103,98,201,51.2%,16m
7880,2,ogayvs,3459,88,39,48,87,44.8%,4m
7880,2,Tsuki,3459,755,30,26,56,53.6%,10m
7880,2,Hellscreen,3459,420,19,14,33,57.6%,21m
7880,3,[SLoZ]kimarne,3459,408,16,16,32,50.0%,9m
7880,3,Ziran,3459,366,14,13,27,51.9%,13m
7880,3,[omnce]NazmoX,3459,292,12,2,14,85.7%,4m
7880,2,xStahl,3459,348,12,16,28,42.9%,15m
7880,3,sYnc,3459,242,9,7,16,56.2%,19m
7880,3,IsleInRum,3459,180,8,2,10,80.0%,9m
7880,1,hope,3459,140,4,2,6,66.7%,5m
7880,3,RushB,3459,58,3,4,7,42.9%,17m
7880,2,DOMINATOr,3459,95,2,1,3,66.7%,18m
7880,3,[Sunray]CoalApple,3459,30,1,1,2,50.0%,23m
7880,3,SteveBrown,3459,0,0,1,1,0.0%,4m
7880,3,AnzA,3459,0,0,2,2,0.0%,35m
7899,2,Lakewood,3458,1551,140,140,280,50.0%,13m
7899,3,Kukas,3458,1225,119,101,220,54.1%,15m
7899,2,Ryzen,3458,1477,105,106,211,49.8%,12m
7899,2,goira,3458,915,37,38,75,49.3%,13m
7899,3,HydrØPøNeY,3458,365,14,8,22,63.6%,9m
7899,3,Artos,3458,304,12,11,23,52.2%,35m
7899,3,[Goouda]Shadowsheza,3458,117,5,1,6,83.3%,6m
7899,3,Barcode,3458,30,2,0,2,100.0%,16m
7899,3,[KDV]DrZerg,3458,0,1,0,1,100.0%,37m
7899,3,[80Mayo]puebloman,3458,0,1,0,1,100.0%,6m
7899,3,deadpool,3458,0,1,0,1,100.0%,20m
7899,3,[6RD4]admr,3458,30,1,4,5,20.0%,19m
7899,3,burton,3458,0,0,1,1,0.0%,16m
7899,3,KurtBlock,3458,0,0,1,1,0.0%,15m
7899,3,HanZaiSha,3458,0,0,1,1,0.0%,10m
7899,3,Gommorrah,3458,0,0,1,1,0.0%,22m
7899,2,Fadezzzx,3458,0,0,8,8,0.0%,4m
7916,2,ITSECURE,3457,1530,150,140,290,51.7%,23m
7916,3,NoScared,3457,248,22,8,30,73.3%,15m
7916,2,[PrPr]JimRaynor,3457,592,21,27,48,43.8%,9m
7916,3,Brillenbär,3457,141,6,2,8,75.0%,35m
7916,3,[Peeps]GFG,3457,58,3,4,7,42.9%,12m
7916,3,Ivack,3457,0,0,1,1,0.0%,21m
7916,3,[БАНДА]ZIBR,3457,0,0,1,1,0.0%,11m
7916,3,Stagsted,3457,0,0,3,3,0.0%,36m
7916,3,Feedtha,3457,0,0,5,5,0.0%,6m
7925,3,IIIIIIIIIIII,3456,1594,231,229,460,50.2%,15m
7925,3,Kakein,3456,197,49,43,92,53.3%,10m
7925,3,YowOnee,3456,532,19,22,41,46.3%,21m
7925,3,[TheDOH]NeraDraed,3456,380,14,14,28,50.0%,11m
7925,3,Elnirath,3456,30,5,2,7,71.4%,19m
7925,3,Aiur,3456,30,2,1,3,66.7%,12m
7925,3,Iaotle,3456,119,2,2,4,50.0%,4m
7925,3,Wrecker,3456,58,2,4,6,33.3%,5m
7925,3,VembersSimp,3456,62,2,6,8,25.0%,19m
7925,3,Florian,3456,0,1,0,1,100.0%,7m
7925,1,starfox,3456,96,1,3,4,25.0%,4m
7925,3,lebus,3456,0,0,1,1,0.0%,5m
7937,3,[NerCC]Benster,3455,1556,114,111,225,50.7%,10m
7937,2,Faustrecht,3455,1570,105,107,212,49.5%,5m
7937,2,Kryper,3455,287,99,73,172,57.6%,13m
7937,3,LImE,3455,587,95,69,164,57.9%,15m
7937,3,[VädA]dAJokA,3455,1528,63,53,116,54.3%,23m
7937,2,Horong,3455,185,37,49,86,43.0%,14m
7937,3,CrTL,3455,611,30,33,63,47.6%,22m
7937,2,[fumv]MrFister,3455,607,29,24,53,54.7%,36m
7937,3,[SonAsg]Alpha,3455,544,20,23,43,46.5%,10m
7937,3,[PÂRłAH]DARK,3455,412,14,16,30,46.7%,12m
7937,3,AdAstra,3455,299,12,12,24,50.0%,15m
7937,2,Kasatka,3455,212,7,11,18,38.9%,13m
7937,3,[GONZO]ELConejO,3455,118,5,9,14,35.7%,4m
7937,2,DarkNothingZ,3455,117,4,7,11,36.4%,21m
7937,3,[STED]DrReed,3455,86,3,1,4,75.0%,23m
7937,3,[PiGPan]Susanoo,3455,58,3,4,7,42.9%,19m
7937,3,SenorTaisho,3455,30,2,0,2,100.0%,13m
7937,3,DareTex,3455,60,2,4,6,33.3%,19m
7937,3,JeanMax,3455,0,0,5,5,0.0%,10m
7956,3,[Komada]Eskimo,3454,1167,50,32,82,61.0%,11m
7956,3,Cindy,3454,943,46,28,74,62.2%,21m
7956,3,[2P2a]Yokonisos,3454,410,39,24,63,61.9%,20m
7956,3,vilbrii,3454,234,10,3,13,76.9%,13m
7956,2,Harry,3454,216,7,11,18,38.9%,7m
7956,3,Mixalich,3454,170,5,8,13,38.5%,22m
7956,3,mrkaio,3454,94,3,8,11,27.3%,9m
7956,3,refrigeratus,3454,30,2,4,6,33.3%,15m
7956,3,necro,3454,0,1,0,1,100.0%,4m
7956,3,[Peeps]Neko,3454,30,1,2,3,33.3%,9m
7956,3,ЛжеДмитрий,3454,0,0,2,2,0.0%,12m
7967,3,Reki,3453,1677,71,67,138,51.4%,11m
7967,3,paradox,3453,590,39,27,66,59.1%,36m
7967,3,[E6ix]Yusa,3453,856,35,28,63,55.6%,4m
7967,3,Aphlax,3453,678,25,23,48,52.1%,18m
7967,3,SerralPatchZ,3453,256,11,1,12,91.7%,8m
7967,2,AmyChant,3453,213,9,5,14,64.3%,4m
7967,1,[SqAUT]Pluu,3453,261,8,8,16,50.0%,3m
7967,2,Minoterrius,3453,208,7,16,23,30.4%,5m
7967,3,Lur,3453,125,3,3,6,50.0%,20m
7967,3,Libero,3453,90,3,3,6,50.0%,22m
7967,3,LeaguePlayer,3453,30,2,3,5,40.0%,7m
7978,3,BlackSmith,3452,1554,317,279,596,53.2%,6m
7978,3,Just,3452,1588,143,124,267,53.6%,15m
7978,2,RedComrade,3452,1241,130,110,240,54.2%,13m
7978,3,[rtpc]RIP,3452,1018,89,79,168,53.0%,15m
7978,2,stringfellow,3452,585,87,89,176,49.4%,18m
7978,3,Zairan,3452,467,79,74,153,51.6%,19m
7978,3,pepetupapi,3452,1424,56,47,103,54.4%,8m
7978,3,[d77s]nOscouting,3452,1110,53,30,83,63.9%,13m
7978,3,TomaszH,3452,1152,44,47,91,48.4%,36m
7978,3,[Ǽ1]Maniacks,3452,1056,39,39,78,50.0%,9m
7978,3,GraD,3452,658,28,18,46,60.9%,4m
7978,3,LostMage,3452,176,16,10,26,61.5%,10m
7978,2,WhyIsThatMF,3452,191,9,4,13,69.2%,9m
7978,2,[PTZMuc]Darkness,3452,128,4,4,8,50.0%,20m
7978,3,[Pullis]Pumi,3452,86,3,10,13,23.1%,16m
7978,3,Darkness,3452,30,2,1,3,66.7%,6m
7978,3,SirSucksAlot,3452,0,0,1,1,0.0%,16m
7978,2,hurdler,3452,0,0,3,3,0.0%,22m
7996,2,XuN,3451,1178,258,268,526,49.0%,14m
7996,2,SpaceHammer,3451,1540,206,194,400,51.5%,7m
7996,2,[CBD420]tzutzu,3451,1058,134,139,273,49.1%,14m
7996,3,[Dharma]Heregellas,3451,767,34,24,58,58.6%,21m
7996,3,Heuner,3451,364,22,17,39,56.4%,10m
7996,2,Lajnus,3451,526,20,25,45,44.4%,13m
7996,2,phornix,3451,426,15,23,38,39.5%,7m
7996,3,[STKZ]hlAkkarin,3451,157,13,6,19,68.4%,16m
7996,2,Deftey,3451,374,13,23,36,36.1%,4m
7996,3,[lMMl]ShadowRoCk,3451,330,12,14,26,46.2%,6m
7996,3,kolov,3451,266,10,12,22,45.5%,15m
7996,2,Jade,3451,137,7,3,10,70.0%,15m
7996,3,Joo,3451,120,6,1,7,85.7%,21m
7996,3,[SESHWB]RussianBoy,3451,0,4,1,5,80.0%,13m
7996,3,ANAZAPTA,3451,60,3,1,4,75.0%,19m
7996,3,[Blacer]BleakLord,3451,60,2,6,8,25.0%,9m
7996,3,Минск,3451,57,2,7,9,22.2%,21m
7996,2,GgoodByye,3451,30,2,8,10,20.0%,8m
7996,3,IIIIIIIIII,3451,0,1,4,5,20.0%,16m
8015,2,SCIPIO,3450,1613,302,295,597,50.6%,5m
8015,2,Player,3450,1437,97,82,179,54.2%,11m
8015,3,poolsp,3450,1616,96,82,178,53.9%,8m
8015,3,GULLER,3450,1154,68,63,131,51.9%,14m
8015,2,[Zhig]TossTerR,3450,865,50,46,96,52.1%,7m
8015,3,[IDF48]BeliarFoX,3450,1046,40,37,77,51.9%,13m
8015,2,[DUX]Khaƴsaril,3450,946,34,36,70,48.6%,23m
8015,3,Jessie,3450,347,22,14,36,61.1%,5m
8015,3,[OcК]Saturnus,3450,355,15,13,28,53.6%,18m
8015,3,mart,3450,120,6,1,7,85.7%,36m
8015,3,NumA,3450,58,3,0,3,100.0%,22m
8026,2,Filemon,3449,1404,74,92,166,44.6%,7m
8026,3,KitaFleX,3449,620,28,15,43,65.1%,13m
8026,3,[sYkm]sYkum,3449,194,8,2,10,80.0%,37m
8026,3,[Fuarkk]Zyzz,3449,86,4,0,4,100.0%,11m
8026,3,[IIARII]HanSolo,3449,62,3,3,6,50.0%,23m
8026,2,SUper,3449,0,3,5,8,37.5%,20m
8026,3,MadScientist,3449,58,2,3,5,40.0%,12m
8026,3,ElektricKONE,3449,0,1,2,3,33.3%,16m
8026,2,Dolfik,3449,0,0,2,2,0.0%,11m
8035,3,ColT,3448,1600,135,132,267,50.6%,6m
8035,2,[ODGW]TheZealot,3448,1516,110,90,200,55.0%,36m
8035,3,IIIIIIIIIIII,3448,852,104,69,173,60.1%,20m
8035,3,jalaibi,3448,383,59,42,101,58.4%,22m
8035,3,POL,3448,1033,42,28,70,60.0%,5m
8035,3,Error,3448,925,40,25,65,61.5%,21m
8035,3,YeppJebrilo,3448,632,26,18,44,59.1%,10m
8035,2,Jack,3448,708,23,31,54,42.6%,16m
8035,3,[RuVoid]ilurius,3448,405,15,7,22,68.2%,19m
8035,3,Pavel,3448,302,10,17,27,37.0%,22m
8035,3,Kojiro,3448,224,9,4,13,69.2%,15m
8035,3,Tomathor,3448,114,5,4,9,55.6%,12m
8035,2,Tamplier,3448,116,3,8,11,27.3%,16m
8035,3,sasso,3448,0,1,0,1,100.0%,21m
8035,3,Chaos,3448,0,1,0,1,100.0%,16m
8035,3,whocowaka,3448,0,1,0,1,100.0%,8m
8035,3,[TaTe]SpryToss,3448,30,1,1,2,50.0%,19m
8035,3,SHZ,3448,0,0,1,1,0.0%,22m
8035,3,[QTclub]BreffXX,3448,0,0,1,1,0.0%,13m
8035,3,decho,3448,0,0,1,1,0.0%,7m
8055,3,Mea,3447,901,73,53,126,57.9%,37m
8055,3,OggVorbis,3447,1056,41,39,80,51.2%,23m
8055,2,Zaner,3447,657,40,47,87,46.0%,36m
8055,3,JTY,3447,1024,36,39,75,48.0%,4m
8055,2,Genezis,3447,700,33,28,61,54.1%,20m
8055,2,yyc,3447,398,20,14,34,58.8%,23m
8055,3,[AgentC]RedSpy,3447,382,19,14,33,57.6%,5m
8055,3,competizione,3447,344,15,2,17,88.2%,5m
8055,2,[ЯD]Arc,3447,299,10,19,29,34.5%,12m
8055,3,Evoke,3447,170,6,11,17,35.3%,12m
8055,3,[NeMoKi]DarKside,3447,121,5,4,9,55.6%,9m
8055,3,[CОS]trigubJkeee,3447,58,3,1,4,75.0%,8m
8055,3,FiletOFish,3447,30,1,1,2,50.0%,16m
8055,3,Danicela,3447,0,0,1,1,0.0%,20m
8069,3,DonWurmillo,3446,1630,157,141,298,52.7%,22m
8069,2,[SPAINs]Jomasteur,3446,1509,89,87,176,50.6%,13m
8069,3,Stuff,3446,1498,67,71,138,48.6%,10m
8069,3,Phaeril,3446,603,29,13,42,69.0%,9m
8069,3,[eva02]sinay,3446,632,21,24,45,46.7%,6m
8069,3,[Oath]NoMercy,3446,218,12,3,15,80.0%,35m
8069,3,Hobbes,3446,0,1,0,1,100.0%,21m
8069,3,valza,3446,30,1,1,2,50.0%,11m
8069,3,seb,3446,30,1,2,3,33.3%,7m
8069,3,MajorR,3446,0,0,1,1,0.0%,4m
8079,2,DubbelO,3445,1540,296,272,568,52.1%,36m
8079,3,Toinou,3445,1555,185,176,361,51.2%,13m
8079,2,Rikitikitavi,3445,1583,100,104,204,49.0%,22m
8079,3,Mücke,3445,915,54,51,105,51.4%,9m
8079,3,[UATeam]qiip,3445,991,39,39,78,50.0%,5m
8079,3,BlackMamba,3445,773,32,25,57,56.1%,11m
8079,3,Vestral,3445,844,32,30,62,51.6%,11m
8079,3,Ugie,3445,224,17,12,29,58.6%,5m
8079,3,Sulong,3445,284,11,5,16,68.8%,9m
8079,3,[cLn]cLnRaiden,3445,0,5,0,5,100.0%,5m
8079,3,[ябог]КожаныйМешок,3445,152,5,10,15,33.3%,5m
8079,3,Sygard,3445,146,4,4,8,50.0%,19m
8079,3,Raiminho,3445,62,3,3,6,50.0%,8m
8079,3,sone,3445,30,1,5,6,16.7%,22m
8093,2,Hawk,3444,1167,625,635,1260,49.6%,22m
8093,2,[EXPANT]MicMac,3444,1491,134,149,283,47.3%,18m
8093,2,MightyToss,3444,1165,98,96,194,50.5%,4m
8093,3,RADON,3444,1040,93,78,171,54.4%,11m
8093,3,Zephyr,3444,691,72,55,127,56.7%,19m
8093,2,ChosenOne,3444,576,31,35,66,47.0%,15m
8093,3,[BFRIII]Piwit,3444,538,20,18,38,52.6%,7m
8093,3,simone,3444,386,15,13,28,53.6%,5m
8093,2,modis,3444,211,11,6,17,64.7%,10m
8093,3,sid,3444,234,9,7,16,56.2%,19m
8093,3,kSokSo,3444,118,7,6,13,53.8%,7m
8093,3,Roxy,3444,16,5,15,20,25.0%,11m
8093,3,LeChocapic,3444,0,4,1,5,80.0%,37m
8093,3,[Ulmaga]Stormtruppe,3444,0,1,0,1,100.0%,21m
8093,3,Default,3444,0,1,2,3,33.3%,21m
8093,3,Ker,3444,0,0,1,1,0.0%,22m
8093,3,Boris,3444,0,0,2,2,0.0%,4m
8110,3,[HAMPEL]miracle,3443,1638,349,351,700,49.9%,7m
8110,3,SugarRush,3443,1600,219,201,420,52.1%,10m
8110,2,Mrrt,3443,1478,163,174,337,48.4%,36m
8110,2,Seryy,3443,1520,129,123,252,51.2%,13m
8110,3,Benama,3443,1164,93,93,186,50.0%,12m
8110,3,SONDA,3443,1053,74,62,136,54.4%,4m
8110,3,KFanatic,3443,768,33,31,64,51.6%,20m
8110,3,[FeTu5]Orpine,3443,544,20,27,47,42.6%,9m
8110,3,[TAW]Jeddrix,3443,490,19,18,37,51.4%,14m
8110,2,eSTee,3443,381,18,14,32,56.2%,12m
8110,3,[OXXXY]Phenomen,3443,352,15,3,18,83.3%,19m
8110,3,ThuleD,3443,120,6,1,7,85.7%,16m
8110,3,[KREU]KimKunhee,3443,212,6,9,15,40.0%,11m
8110,3,nikihaku,3443,90,3,10,13,23.1%,16m
8110,3,BiPolarBear,3443,30,2,3,5,40.0%,19m
8110,3,BondageChair,3443,0,1,0,1,100.0%,15m
8126,3,NYdiesel,3442,1467,195,184,379,51.5%,19m
8126,2,Jossi,3442,1564,140,138,278,50.4%,16m
8126,2,Freekl,3442,1395,75,75,150,50.0%,5m
8126,3,Ayals,3442,348,39,25,64,60.9%,12m
8126,3,[аймой]chichovuna,3442,830,31,30,61,50.8%,5m
8126,3,youkibear,3442,453,20,12,32,62.5%,21m
8126,3,Zero,3442,413,15,6,21,71.4%,19m
8126,3,Bee,3442,340,13,13,26,50.0%,6m
8126,3,djbomba,3442,114,7,5,12,58.3%,5m
8126,3,shjOoR,3442,196,6,7,13,46.2%,16m
8126,3,MrEasy,3442,114,5,3,8,62.5%,6m
8126,3,LieB,3442,46,3,6,9,33.3%,19m
8126,3,[1qp]Tuwer,3442,0,1,0,1,100.0%,22m
8126,3,Kantaiso,3442,0,1,1,2,50.0%,21m
8126,3,Джентельмен,3442,0,0,1,1,0.0%,13m
8126,3,Yokato,3442,0,0,1,1,0.0%,4m
8142,2,Genkidama,3441,1203,167,153,320,52.2%,36m
8142,3,[KUKA]VeniVidiVici,3441,1252,124,127,251,49.4%,11m
8142,3,REDENTOR,3441,1030,44,32,76,57.9%,15m
8142,2,Nimrook,3441,200,9,5,14,64.3%,8m
8142,3,LordOfUrMind,3441,142,6,3,9,66.7%,8m
8142,2,UrMuddA,3441,182,6,16,22,27.3%,22m
8142,1,PaCJlaboHeC,3441,0,5,0,5,100.0%,15m
8142,3,Hazel,3441,86,4,4,8,50.0%,19m
8142,3,[THRLLA]Cookeie,3441,0,3,2,5,60.0%,5m
8142,3,Diego,3441,30,2,4,6,33.3%,21m
8142,3,[RøS]DarthYok,3441,44,2,6,8,25.0%,16m
8142,3,RIDICK,3441,0,1,0,1,100.0%,15m
8142,3,[PhBh]КнязРазврата,3441,0,0,1,1,0.0%,15m
8142,3,Cheesy,3441,0,0,1,1,0.0%,18m
8142,3,Huansohn,3441,0,0,1,1,0.0%,37m
8142,3,[FiIthy]BigPlays,3441,0,0,2,2,0.0%,5m
8158,2,forester,3440,1351,521,504,1025,50.8%,12m
8158,1,zerg,3440,1631,224,255,479,46.8%,20m
8158,1,HellBoy,3440,1453,97,122,219,44.3%,5m
8158,3,[ZERG7V]Vifesia,3440,1135,69,63,132,52.3%,9m
8158,3,sereetz,3440,398,15,14,29,51.7%,12m
8158,1,krater,3440,352,14,5,19,73.7%,10m
8158,3,[EZPZǂ]Yindera,3440,428,14,19,33,42.4%,8m
8158,3,ShiznGiggz,3440,123,6,0,6,100.0%,11m
8158,3,GayBarMania,3440,143,5,3,8,62.5%,5m
8158,3,Nouille,3440,48,2,5,7,28.6%,19m
8158,3,[HDCN]Spectre,3440,50,2,9,11,18.2%,13m
8158,3,[FxL]Bojan,3440,0,0,3,3,0.0%,4m
8170,3,Fidelis,3439,1648,301,282,583,51.6%,9m
8170,2,Leckatall,3439,1375,269,262,531,50.7%,19m
8170,3,[БезGG]ipv,3439,1637,168,160,328,51.2%,9m
8170,3,CaptainSalt,3439,1568,159,155,314,50.6%,20m
8170,2,[Kicx]DrXia,3439,1479,115,106,221,52.0%,5m
8170,3,Ralf,3439,1276,93,81,174,53.4%,13m
8170,3,Melon,3439,940,37,25,62,59.7%,22m
8170,3,ILM,3439,767,29,23,52,55.8%,37m
8170,3,DrJhonnySins,3439,448,20,11,31,64.5%,20m
8170,3,[QTclub]Sprite,3439,524,19,18,37,51.4%,13m
8170,3,PsychicAnt,3439,196,8,7,15,53.3%,22m
8170,3,CaNut,3439,166,6,1,7,85.7%,9m
8170,3,duxa,3439,88,3,6,9,33.3%,15m
8170,3,veteris,3439,30,2,2,4,50.0%,13m
8170,3,Victor,3439,0,2,3,5,40.0%,16m
8170,3,SaMyDe,3439,30,2,5,7,28.6%,16m
8170,3,[bod]Projectile,3439,0,1,0,1,100.0%,12m
8170,1,Lighters,3439,0,1,1,2,50.0%,4m
8170,3,ZIZOO,3439,30,1,2,3,33.3%,6m
8170,3,Xenocide,3439,97,1,7,8,12.5%,10m
8170,3,[Climb]Kalisto,3439,0,0,1,1,0.0%,16m
8170,3,DarKzoNe,3439,0,0,1,1,0.0%,5m
8192,3,bing,3438,1467,183,150,333,55.0%,15m
8192,2,NGneer,3438,1409,125,104,229,54.6%,15m
8192,3,Sknnymalinky,3438,488,45,45,90,50.0%,19m
8192,3,[FG2NS]DiViniTas,3438,676,25,24,49,51.0%,8m
8192,3,Shadow,3438,550,23,19,42,54.8%,18m
8192,3,[BCBB]Nummy,3438,528,22,9,31,71.0%,9m
8192,2,EvoLvE,3438,612,20,37,57,35.1%,23m
8192,3,Bidouloux,3438,406,17,8,25,68.0%,6m
8192,3,Oevlen,3438,146,7,2,9,77.8%,4m
8192,1,Bokes,3438,97,5,1,6,83.3%,20m
8192,3,Filips,3438,120,4,6,10,40.0%,7m
8192,3,[harzn]PeterSuppe,3438,60,3,6,9,33.3%,16m
8192,3,Freud,3438,0,0,1,1,0.0%,5m
8192,1,[RuW]JustDoIt,3438,0,0,1,1,0.0%,20m
8192,3,SFJ,3438,0,0,1,1,0.0%,19m
8192,3,Gojira,3438,0,0,2,2,0.0%,11m
8192,3,[PŖïMĄŁ]Follaor,3438,0,0,3,3,0.0%,12m
8209,3,[2ndAGE]Engineer,3437,559,22,11,33,66.7%,19m
8209,3,Legion,3437,476,21,11,32,65.6%,11m
8209,3,PlayingSC,3437,412,17,7,24,70.8%,37m
8209,3,Destol,3437,226,8,12,20,40.0%,18m
8209,3,MeiRyu,3437,195,5,5,10,50.0%,37m
8209,2,[allay2]SICKofLOSING,3437,128,5,15,20,25.0%,12m
8209,3,[PaniC]Mark,3437,94,3,12,15,20.0%,11m
8209,2,Virtue,3437,95,2,4,6,33.3%,12m
8209,3,[КНР]ForAiur,3437,0,1,2,3,33.3%,18m
8218,3,Padishar,3436,1631,169,172,341,49.6%,22m
8218,3,NoSkiLL,3436,324,14,2,16,87.5%,21m
8218,3,Johnny,3436,280,12,2,14,85.7%,14m
8218,2,Sleeky,3436,143,7,5,12,58.3%,23m
8218,3,Lightbringer,3436,172,7,9,16,43.8%,20m
8218,3,[IceHus]LeGend,3436,118,5,3,8,62.5%,10m
8218,3,[InitRu]SameOldName,3436,30,2,0,2,100.0%,36m
8218,1,Liquid,3436,141,2,2,4,50.0%,6m
8218,3,golum,3436,0,1,1,2,50.0%,5m
8227,3,[LotHoL]Tea,3435,1350,165,152,317,52.1%,7m
8227,3,Mikki,3435,1344,92,85,177,52.0%,4m
8227,2,casualxx,3435,825,75,73,148,50.7%,13m
8227,2,Garysmatique,3435,951,48,44,92,52.2%,6m
8227,3,VuDoYou,3435,400,19,9,28,67.9%,5m
8227,3,NeferPitou,3435,363,14,12,26,53.8%,18m
8227,3,Liquid,3435,416,14,18,32,43.8%,13m
8227,3,[DZ16]kakoki,3435,192,8,3,11,72.7%,20m
8227,2,Insideme,3435,140,3,6,9,33.3%,11m
8227,3,Night,3435,30,2,2,4,50.0%,16m
8227,3,max,3435,0,0,1,1,0.0%,9m
8238,2,SirLanzealot,3434,1040,321,302,623,51.5%,36m
8238,3,[vlast]MickeyMouse,3434,1654,159,111,270,58.9%,15m
8238,3,Naoy,3434,1519,99,101,200,49.5%,22m
8238,3,Bizon,3434,1258,65,74,139,46.8%,20m
8238,3,Tuzaak,3434,1154,48,45,93,51.6%,21m
8238,3,Shadow,3434,558,29,27,56,51.8%,19m
8238,3,[ARISS3]koke,3434,438,19,12,31,61.3%,21m
8238,3,[SMRMD]hAvInGoOdTyM,3434,146,9,4,13,69.2%,4m
8238,3,Schrödinger,3434,149,3,6,9,33.3%,19m
8238,3,[lDZPl]AndiAbseits,3434,97,2,0,2,100.0%,36m
8238,3,Beast,3434,30,1,1,2,50.0%,11m
8238,3,[HeNe]Immanence,3434,0,0,1,1,0.0%,18m
8250,3,MufasaPrime,3433,652,80,69,149,53.7%,19m
8250,3,Algeroth,3433,1180,50,35,85,58.8%,19m
8250,3,MrJEJUS,3433,397,24,20,44,54.5%,37m
8250,3,StarPlatinum,3433,556,22,18,40,55.0%,7m
8250,3,[K3P]Sutriya,3433,300,11,9,20,55.0%,10m
8250,3,IIIIIIIIIIII,3433,190,8,1,9,88.9%,21m
8250,3,HolyInfant,3433,0,3,2,5,60.0%,6m
8250,3,Error,3433,58,3,3,6,50.0%,8m
8250,3,[RYDA]aLx,3433,0,0,1,1,0.0%,6m
8259,3,[Hаsu]vitekes,3432,1613,239,231,470,50.9%,10m
8259,3,QtoWE,3432,776,37,14,51,72.5%,22m
8259,3,ZealotRunbys,3432,599,30,3,33,90.9%,15m
8259,3,[WBO]Epekto,3432,566,21,19,40,52.5%,9m
8259,3,ExiStenCe,3432,336,18,4,22,81.8%,21m
8259,1,LittleBytch,3432,354,15,4,19,78.9%,6m
8259,3,Eikasang,3432,58,3,2,5,60.0%,9m
8259,2,InFlames,3432,94,3,12,15,20.0%,10m
8259,3,Kaukatsu,3432,62,2,5,7,28.6%,22m
8259,3,[GACНI]Hexade,3432,0,0,3,3,0.0%,12m
8269,3,[LaU]JoeCoco,3431,1506,140,131,271,51.7%,13m
8269,3,svartahästen,3431,1548,105,91,196,53.6%,19m
8269,3,PINATA,3431,769,36,18,54,66.7%,37m
8269,3,Pagans,3431,225,22,17,39,56.4%,13m
8269,3,LastEngineer,3431,368,17,15,32,53.1%,15m
8269,3,ManofOneway,3431,272,10,13,23,43.5%,22m
8269,3,[DONKEY]Hastati,3431,58,6,1,7,85.7%,11m
8269,3,Dvak,3431,30,2,4,6,33.3%,37m
8269,3,Pamanos,3431,0,1,4,5,20.0%,18m
8278,3,ERROR,3430,1554,444,413,857,51.8%,15m
8278,3,[EpiT]OttoPsy,3430,1566,200,182,382,52.4%,16m
8278,3,[FEMA]Hypnøs,3430,1543,63,51,114,55.3%,15m
8278,3,[SlayAP]Iceri,3430,859,55,32,87,63.2%,11m
8278,3,Stiegl,3430,479,19,9,28,67.9%,5m
8278,3,[NCKT]Deafbok,3430,374,15,10,25,60.0%,6m
8278,3,Пипирка,3430,185,8,4,12,66.7%,21m
8278,3,Darazo,3430,60,6,2,8,75.0%,37m
8278,3,IAMTNT,3430,122,5,9,14,35.7%,21m
8278,3,HIERARCH,3430,114,4,2,6,66.7%,13m
8278,2,[BWArmy]ninjaprobe,3430,112,3,0,3,100.0%,8m
8278,3,Cree,3430,58,2,2,4,50.0%,15m
8278,3,[4H]Monolith,3430,30,2,3,5,40.0%,16m
8278,3,Judge,3430,0,1,0,1,100.0%,22m
8278,3,YourMother,3430,0,1,0,1,100.0%,13m
8278,3,[Oggy]Nifel,3430,30,1,1,2,50.0%,21m
8278,3,Dudi,3430,0,0,1,1,0.0%,10m
8295,3,RobPiton,3429,912,92,61,153,60.1%,15m
8295,3,vasylysk,3429,1588,71,50,121,58.7%,12m
8295,3,Mxl,3429,712,51,44,95,53.7%,6m
8295,2,Eul,3429,647,31,31,62,50.0%,12m
8295,3,[ENQ]HEROSHE,3429,630,29,22,51,56.9%,7m
8295,3,[Ahoy]maxpower,3429,142,5,5,10,50.0%,7m
8295,3,Sensibleness,3429,0,1,0,1,100.0%,36m
8295,3,connerly,3429,30,1,4,5,20.0%,8m
8295,3,[PAFLKA]TrueJeffo,3429,0,0,1,1,0.0%,20m
8295,2,[DeVu]IMoGsPrime,3429,0,0,2,2,0.0%,7m
8295,3,AnatolyMP,3429,0,0,3,3,0.0%,19m
8306,3,Orwen,3428,1386,263,239,502,52.4%,13m
8306,3,[Bruuuu]Krunkies,3428,1541,130,115,245,53.1%,5m
8306,2,JohnWayne,3428,835,68,64,132,51.5%,23m
8306,3,[ErR]StroKe,3428,778,32,23,55,58.2%,7m
8306,3,GoSuAti,3428,584,23,19,42,54.8%,8m
8306,3,Civilian,3428,391,18,8,26,69.2%,9m
8306,3,WannaBeЯкЯк,3428,326,12,15,27,44.4%,13m
8306,2,Pain,3428,246,11,4,15,73.3%,22m
8306,3,[ØC2]Kellidan,3428,298,10,14,24,41.7%,10m
8306,3,Jeemix,3428,30,2,3,5,40.0%,4m
8306,3,Plugawy,3428,0,1,0,1,100.0%,15m
8306,3,Brazko,3428,0,0,1,1,0.0%,12m
8306,3,EnigmA,3428,0,0,2,2,0.0%,4m
8306,3,OnkelBob,3428,0,0,3,3,0.0%,23m
8320,3,woodapple,3427,1062,131,114,245,53.5%,11m
8320,3,Zetsu,3427,517,71,57,128,55.5%,6m
8320,3,PrZrStalky,3427,1362,60,57,117,51.3%,15m
8320,2,Felcon,3427,807,58,51,109,53.2%,36m
8320,3,Bamboleo,3427,1248,52,37,89,58.4%,5m
8320,3,DosSiDos,3427,1018,46,30,76,60.5%,4m
8320,3,anuscleaner,3427,1026,45,34,79,57.0%,22m
8320,2,[GrMp]gonner,3427,284,9,21,30,30.0%,4m
8320,1,[FOSAK]jeroen,3427,209,8,7,15,53.3%,21m
8320,3,Fikimiki,3427,58,3,1,4,75.0%,17m
8320,3,Tengan,3427,90,3,6,9,33.3%,36m
8320,3,[NerCC]JayJay,3427,0,1,0,1,100.0%,37m
8320,3,ErebusQ,3427,30,1,1,2,50.0%,22m
8320,3,НоваяПапка,3427,30,1,3,4,25.0%,14m
8320,3,[HBGSJR]llllllllllll,3427,30,1,7,8,12.5%,6m
8335,2,[ValidG]Valyrion,3426,759,214,207,421,50.8%,36m
8335,3,WolfSmilebg,3426,1287,85,56,141,60.3%,17m
8335,3,Snaky,3426,502,74,77,151,49.0%,23m
8335,3,toxas,3426,947,68,52,120,56.7%,37m
8335,3,Marona,3426,952,35,37,72,48.6%,20m
8335,2,Brocklyn,3426,482,35,39,74,47.3%,12m
8335,3,Sootha,3426,413,28,29,57,49.1%,12m
8335,3,[CYT]Snake,3426,413,17,20,37,45.9%,8m
8335,2,Gugi,3426,374,14,17,31,45.2%,5m
8335,3,Shadow,3426,86,7,2,9,77.8%,9m
8335,3,microbit,3426,0,4,1,5,80.0%,6m
8335,3,Metayrox,3426,97,2,1,3,66.7%,13m
8335,3,InkiToss,3426,58,2,5,7,28.6%,22m
8335,3,[Gryère]DuRaiN,3426,0,1,2,3,33.3%,23m
8335,3,Øæx,3426,0,0,2,2,0.0%,12m
8350,3,TheArchitect,3425,1557,185,177,362,51.1%,22m
8350,3,[GAMI]santiego,3425,1239,163,137,300,54.3%,22m
8350,2,GordonRamsay,3425,1434,151,138,289,52.2%,9m
8350,2,[HQ31er]FENIX,3425,922,71,59,130,54.6%,4m
8350,3,Frosty,3425,714,28,20,48,58.3%,11m
8350,3,[TachIT]haRa,3425,318,12,13,25,48.0%,8m
8350,3,IIIIIII,3425,296,11,7,18,61.1%,14m
8350,3,[AliJan]AlirezaNag,3425,90,4,5,9,44.4%,15m
8350,3,Ætheling,3425,0,1,0,1,100.0%,10m
8350,3,[Smek85]Smek,3425,0,1,0,1,100.0%,19m
8350,3,spectris,3425,0,1,0,1,100.0%,16m
8350,3,[RstE]Témelios,3425,0,1,0,1,100.0%,13m
8350,3,DarckWaacku,3425,0,0,1,1,0.0%,11m
8350,1,[Dobro]Arontong,3425,0,0,1,1,0.0%,21m
8350,3,[INDC]CHECKFIDER,3425,0,0,2,2,0.0%,10m
8350,3,[ImbaIS]Kakuzu,3425,0,0,3,3,0.0%,15m
8366,3,OPAMALA,3424,1164,45,46,91,49.5%,37m
8366,3,GOTTA,3424,826,43,20,63,68.3%,22m
8366,3,Dom,3424,926,34,36,70,48.6%,23m
8366,3,Kimftw,3424,458,17,13,30,56.7%,14m
8366,3,IIIIIIIIIIII,3424,226,10,3,13,76.9%,5m
8366,2,IIIIIIIIIIII,3424,169,7,8,15,46.7%,35m
8366,3,[leOS]WLASSTELINE,3424,179,6,2,8,75.0%,11m
8366,3,[IceHus]mladenez,3424,92,6,10,16,37.5%,11m
8366,3,Sideburns,3424,60,3,1,4,75.0%,15m
8366,3,[W4N]GaeLife,3424,58,2,2,4,50.0%,12m
8366,3,Donkrawallo,3424,0,2,3,5,40.0%,17m
8366,3,Mastard,3424,60,2,3,5,40.0%,4m
8366,3,[kinkel]Shiruue,3424,0,0,2,2,0.0%,5m
8379,3,neosporimiy,3423,1560,220,213,433,50.8%,22m
8379,3,Cube,3423,1354,151,129,280,53.9%,8m
8379,3,PsiBlade,3423,1469,138,132,270,51.1%,37m
8379,3,[RеG]Tsoi,3423,990,69,65,134,51.5%,37m
8379,3,Steler,3423,864,32,29,61,52.5%,18m
8379,3,Clone,3423,473,30,21,51,58.8%,22m
8379,2,sztatty,3423,804,29,33,62,46.8%,36m
8379,3,[ZERG7V]IAmWhiteBear,3423,690,27,23,50,54.0%,7m
8379,3,[SSQ]Buster,3423,372,16,8,24,66.7%,11m
8379,3,CasualGaming,3423,0,5,0,5,100.0%,5m
8379,3,PissMonkey,3423,86,4,0,4,100.0%,4m
8379,3,[КПCC]TVtos,3423,60,3,4,7,42.9%,15m
8391,2,CEBO,3422,1295,221,227,448,49.3%,8m
8391,3,nikolayglhf,3422,1146,104,82,186,55.9%,4m
8391,3,flipke,3422,1268,51,44,95,53.7%,9m
8391,3,Zufallsgott,3422,480,22,12,34,64.7%,7m
8391,3,Poséidon,3422,354,14,8,22,63.6%,16m
8391,3,DHK,3422,114,8,3,11,72.7%,22m
8391,3,Muhx,3422,202,7,7,14,50.0%,13m
8391,1,Kali,3422,0,3,2,5,60.0%,32m
8391,3,Ben,3422,62,3,8,11,27.3%,6m
8391,3,EST,3422,58,2,1,3,66.7%,11m
8391,3,Awine,3422,0,2,3,5,40.0%,37m
8391,3,Charles,3422,58,2,5,7,28.6%,4m
8391,3,[Aw3]XraYY,3422,0,1,0,1,100.0%,22m
8391,3,squirrle,3422,0,1,0,1,100.0%,37m
8391,1,[CodeB]PikaCry,3422,95,1,1,2,50.0%,21m
8391,3,Arius,3422,30,1,1,2,50.0%,4m
8391,3,aliens,3422,30,1,2,3,33.3%,37m
8391,3,[ColoC]pOp,3422,0,0,1,1,0.0%,17m
8409,3,HeaSteN,3421,545,46,39,85,54.1%,13m
8409,3,[1830]ren,3421,882,35,25,60,58.3%,6m
8409,2,[TGNE]rubberGamer,3421,306,10,22,32,31.2%,36m
8409,3,lotus,3421,116,4,4,8,50.0%,8m
8409,3,[TedB]ChaosTei,3421,30,2,0,2,100.0%,7m
8409,3,[TZCrew]Proodz,3421,30,2,1,3,66.7%,9m
8409,3,Kapsu,3421,30,1,1,2,50.0%,4m
8409,3,[Toons]YourMoms,3421,0,0,1,1,0.0%,37m
8417,3,panhello,3420,1592,148,139,287,51.6%,8m
8417,3,[BigElt]GorkutAta,3420,1578,120,108,228,52.6%,17m
8417,3,Corwew,3420,1055,56,64,120,46.7%,4m
8417,3,[DWTeam]Wolfstalker,3420,1170,45,42,87,51.7%,9m
8417,3,Jartignon,3420,1198,44,44,88,50.0%,13m
8417,3,Poupoulpe,3420,552,20,19,39,51.3%,9m
8417,3,[PaniC]Winter,3420,88,3,4,7,42.9%,11m
8417,3,[Ris3n]HomeTownCrib,3420,58,2,1,3,66.7%,20m
8417,3,[LAGY]Societ,3420,0,1,0,1,100.0%,14m
8417,3,Stressling,3420,30,1,1,2,50.0%,8m
8417,3,[ValidG]MysterEWisp,3420,30,1,2,3,33.3%,15m
8417,3,[ERQ]MawlinsTV,3420,0,0,1,1,0.0%,8m
8417,3,Rapophie,3420,0,0,1,1,0.0%,7m
8430,3,Strat,3419,1408,65,58,123,52.8%,10m
8430,2,IIIIIIIIIIII,3419,570,21,30,51,41.2%,21m
8430,3,[SAPIN]TrD,3419,220,20,17,37,54.1%,11m
8430,2,Leviathan,3419,624,19,35,54,35.2%,21m
8430,3,gosha,3419,326,13,7,20,65.0%,16m
8430,3,Cooskoo,3419,370,12,19,31,38.7%,37m
8430,3,LEO,3419,232,8,12,20,40.0%,23m
8430,3,[PuFu]Ninoss,3419,214,6,6,12,50.0%,8m
8430,3,llllllllllll,3419,0,5,1,6,83.3%,11m
8430,3,CeProTY,3419,0,1,0,1,100.0%,14m
8430,3,[Bread]Blondie,3419,30,1,1,2,50.0%,22m
8430,3,didado,3419,0,0,1,1,0.0%,19m
8430,3,Misterer,3419,0,0,1,1,0.0%,11m
8430,3,Archinoob,3419,0,0,2,2,0.0%,21m
8430,3,[InBri]GurJA,3419,0,0,3,3,0.0%,6m
8445,3,GamerSC,3418,1624,159,153,312,51.0%,12m
8445,2,KKroer,3418,1482,116,125,241,48.1%,9m
8445,3,Antigone,3418,601,44,44,88,50.0%,5m
8445,3,Mezeke,3418,471,21,6,27,77.8%,7m
8445,3,[TSNM]Thyraya,3418,294,10,8,18,55.6%,5m
8445,2,Tevzy,3418,168,5,15,20,25.0%,13m
8445,2,morefocuspls,3418,134,3,0,3,100.0%,36m
8445,3,Deuteriumm,3418,30,2,4,6,33.3%,36m
8445,3,[KaLLi]Kanudson,3418,0,0,3,3,0.0%,20m
8454,3,Japi,3417,1119,79,82,161,49.1%,23m
8454,3,Mutax,3417,904,68,50,118,57.6%,22m
8454,3,Derand,3417,1172,68,65,133,51.1%,4m
8454,3,AIRKOS,3417,1398,56,50,106,52.8%,11m
8454,3,[OPPM]Anski,3417,1062,38,43,81,46.9%,17m
8454,3,Mamoru,3417,834,31,30,61,50.8%,15m
8454,3,HYDRAK,3417,480,18,19,37,48.6%,12m
8454,3,silence,3417,284,12,2,14,85.7%,7m
8454,2,Baboulinax,3417,290,12,12,24,50.0%,6m
8454,2,Raion,3417,276,11,20,31,35.5%,11m
8454,1,Shadow,3417,0,5,0,5,100.0%,18m
8454,3,[pSi]chukolna,3417,0,5,1,6,83.3%,18m
8454,3,[HIYYYA]wildez,3417,122,5,6,11,45.5%,10m
8454,3,[prxspr]Moriz,3417,0,0,1,1,0.0%,20m
8454,3,NaMeY,3417,0,0,1,1,0.0%,9m
8454,3,IIIIIIIIIIII,3417,0,0,1,1,0.0%,37m
8470,3,Kornisey,3416,1596,162,152,314,51.6%,6m
8470,3,CRAPOUILLOU,3416,1182,158,151,309,51.1%,37m
8470,3,morph,3416,1562,109,113,222,49.1%,19m
8470,2,[VAP]Jinzo,3416,1448,55,58,113,48.7%,22m
8470,3,Michnek,3416,1076,53,22,75,70.7%,4m
8470,3,Scales,3416,1071,49,42,91,53.8%,36m
8470,2,Punisher,3416,478,21,21,42,50.0%,12m
8470,3,[УТочка]JustAFreak,3416,377,19,13,32,59.4%,15m
8470,3,Octoplus,3416,301,15,9,24,62.5%,7m
8470,3,[SCiE]Ghost,3416,240,10,3,13,76.9%,36m
8470,1,[ProBC]ddrake,3416,277,9,5,14,64.3%,7m
8470,3,Eaty,3416,30,1,5,6,16.7%,19m
8470,3,ISAK,3416,0,0,3,3,0.0%,15m
8470,1,RageQuit,3416,0,0,5,5,0.0%,8m
8484,2,MUSEXE,3415,1570,485,484,969,50.1%,16m
8484,3,Virruss,3415,1650,235,233,468,50.2%,21m
8484,2,[ArTeam]Akilius,3415,1520,191,198,389,49.1%,12m
8484,3,Nich,3415,1266,56,52,108,51.9%,13m
8484,3,mightySky,3415,744,32,24,56,57.1%,7m
8484,2,[vHr]niiBeR,3415,30,4,5,9,44.4%,4m
8484,3,[fam1ly]KseniaBrain,3415,86,3,4,7,42.9%,5m
8484,3,Rasyl,3415,30,1,1,2,50.0%,21m
8484,3,Sandibell,3415,0,0,1,1,0.0%,4m
8484,3,Alexander,3415,0,0,1,1,0.0%,16m
8484,3,Tartalacreme,3415,0,0,2,2,0.0%,7m
8484,3,Lacktjo,3415,0,0,3,3,0.0%,37m
8496,2,oldkiper,3414,1572,680,671,1351,50.3%,18m
8496,3,Wiskas,3414,1090,43,39,82,52.4%,7m
8496,3,[ncotic]Destroyer,3414,226,9,11,20,45.0%,14m
8496,2,[ENV]Mamba,3414,296,9,31,40,22.5%,16m
8496,3,Nemesis,3414,142,6,3,9,66.7%,9m
8496,3,[TZCrew]Spiro,3414,74,5,5,10,50.0%,12m
8496,3,MyNameJeff,3414,30,4,2,6,66.7%,5m
8496,1,SlaYeR,3414,48,4,3,7,57.1%,27m
8496,3,CMPUNK,3414,118,3,3,6,50.0%,11m
8496,1,Ice,3414,46,1,1,2,50.0%,18m
8506,2,Starboy,3413,1502,123,128,251,49.0%,15m
8506,3,zuki,3413,1408,87,88,175,49.7%,7m
8506,3,kakusu,3413,328,13,6,19,68.4%,22m
8506,3,[5Packs]Cwippo,3413,216,12,7,19,63.2%,9m
8506,3,[Bizou]Xhilbert,3413,176,7,4,11,63.6%,22m
8506,3,IIIIIIIIIIII,3413,0,1,0,1,100.0%,4m
8506,3,Qwas,3413,0,1,1,2,50.0%,22m
8506,3,Storky,3413,0,0,1,1,0.0%,15m
8506,3,[FKTS]TheDoctor,3413,0,0,2,2,0.0%,16m
8515,2,[NLTN]StoneColdIKE,3412,1604,347,338,685,50.7%,13m
8515,3,Flix,3412,1642,92,78,170,54.1%,17m
8515,2,Schluppi,3412,853,37,46,83,44.6%,11m
8515,2,[Heroes]CharactR,3412,451,30,23,53,56.6%,6m
8515,3,AfganUA,3412,261,24,16,40,60.0%,18m
8515,3,Piopiotte,3412,522,20,18,38,52.6%,7m
8515,3,hilarious,3412,290,10,11,21,47.6%,5m
8515,3,[GFXM]JackDaniel,3412,166,7,3,10,70.0%,11m
8515,2,Fallken,3412,205,6,6,12,50.0%,11m
8515,3,[7x]smith,3412,164,4,1,5,80.0%,36m
8515,3,[ShaCh]iGrbik,3412,30,2,0,2,100.0%,12m
8515,3,IIIIIIIIIIII,3412,119,2,1,3,66.7%,21m
8515,3,GrubwormCoco,3412,46,2,2,4,50.0%,20m
8515,3,[APCRPH]WillBe,3412,30,1,1,2,50.0%,17m
8529,3,[InitRu]Artist,3411,1594,179,158,337,53.1%,5m
8529,2,[WRK]ShootMeAgain,3411,1429,92,90,182,50.5%,12m
8529,3,River,3411,1349,56,56,112,50.0%,7m
8529,3,[TJU]GSFstalker,3411,1080,50,33,83,60.2%,11m
8529,3,Taptap,3411,1026,45,35,80,56.2%,15m
8529,3,mole,3411,778,32,26,58,55.2%,10m
8529,3,Snouf,3411,370,14,10,24,58.3%,11m
8529,3,flare,3411,306,13,3,16,81.2%,9m
8529,3,nullStress,3411,159,7,3,10,70.0%,14m
8529,3,ProbeiusCorp,3411,58,6,1,7,85.7%,6m
8529,3,Megatron,3411,86,4,2,6,66.7%,22m
8529,3,LennyDean,3411,0,0,1,1,0.0%,12m
8541,3,[kutuz]mokusatsu,3410,1398,108,103,211,51.2%,12m
8541,3,IIIIIIIIIIII,3410,1354,59,43,102,57.8%,9m
8541,3,pseudonyk,3410,980,36,43,79,45.6%,20m
8541,3,Andarno,3410,421,18,13,31,58.1%,14m
8541,3,Cobra,3410,362,17,16,33,51.5%,36m
8541,3,FallMist,3410,414,16,11,27,59.3%,15m
8541,1,IIIIIIIIIIII,3410,316,15,4,19,78.9%,18m
8541,3,Octobussy,3410,269,12,16,28,42.9%,4m
8541,3,Frodefrodig,3410,226,9,11,20,45.0%,12m
8541,3,JungleFever,3410,206,8,14,22,36.4%,8m
8541,3,[SNKN]PhoneticsPro,3410,60,3,1,4,75.0%,14m
8541,3,Rimool,3410,0,1,0,1,100.0%,12m
8541,3,[JTBETM]CrèmeAuChoco,3410,0,1,1,2,50.0%,13m
8541,3,DraGoN,3410,30,1,2,3,33.3%,21m
8541,3,[Innit]Anlorian,3410,0,0,1,1,0.0%,11m
8541,3,[TheDOH]Hondak,3410,0,0,3,3,0.0%,22m
8557,3,chex,3409,1522,209,175,384,54.4%,16m
8557,3,[VuV]VamPIX,3409,1267,76,69,145,52.4%,15m
8557,3,[DvX]RuggiFuma,3409,669,26,17,43,60.5%,8m
8557,3,ablaze,3409,476,20,14,34,58.8%,13m
8557,2,Ashley,3409,226,7,25,32,21.9%,19m
8557,3,Poiy,3409,144,6,7,13,46.2%,10m
8557,3,noname,3409,0,5,1,6,83.3%,5m
8557,3,Royal,3409,0,1,0,1,100.0%,12m
8557,3,Baileys,3409,0,0,5,5,0.0%,21m
8566,2,MrDracula,3408,1500,419,428,847,49.5%,9m
8566,3,[FR1]Gregoose,3408,1587,147,125,272,54.0%,18m
8566,3,[НОД17]SuMmeR,3408,1631,84,77,161,52.2%,12m
8566,3,Hechi,3408,429,71,58,129,55.0%,37m
8566,3,[InfTy]reptile,3408,1204,70,47,117,59.8%,18m
8566,3,[gut]redLich,3408,998,37,36,73,50.7%,23m
8566,3,Duke,3408,346,27,8,35,77.1%,19m
8566,3,[TExGG]Granate,3408,515,21,9,30,70.0%,5m
8566,3,Nias,3408,276,10,13,23,43.5%,19m
8566,3,Ecstasy,3408,178,7,8,15,46.7%,16m
8566,3,[lOoOl]josito,3408,90,3,3,6,50.0%,22m
8566,3,[IG20]Sentiar,3408,30,2,5,7,28.6%,12m
8566,3,JAB,3408,0,1,2,3,33.3%,14m
8566,3,Araloia,3408,30,1,4,5,20.0%,8m
8566,3,[Bigold]Fefer,3408,0,0,1,1,0.0%,21m
8566,3,Apolinario,3408,0,0,2,2,0.0%,13m
8582,3,RubenOs,3407,1095,128,104,232,55.2%,14m
8582,2,FotonGGimba,3407,704,32,40,72,44.4%,18m
8582,3,Rasterfant,3407,656,26,21,47,55.3%,8m
8582,3,[MTTT]Commander,3407,696,26,25,51,51.0%,16m
8582,3,Timurian,3407,312,13,4,17,76.5%,37m
8582,1,MyFreedom,3407,121,7,1,8,87.5%,12m
8582,3,[IWBK]Tom,3407,114,4,7,11,36.4%,15m
8582,1,dirtyturk,3407,93,1,2,3,33.3%,37m
8582,3,[RGQT]Façonnable,3407,0,1,4,5,20.0%,8m
8582,3,RedAlert,3407,30,1,4,5,20.0%,21m
8582,2,MnMsRathian,3407,0,1,9,10,10.0%,11m
8582,1,Haarhus,3407,0,0,1,1,0.0%,13m
8582,3,Mojagy,3407,0,0,3,3,0.0%,17m
8595,2,[salvo]Marfor,3406,1628,126,125,251,50.2%,22m
8595,3,AllSilentSky,3406,1033,80,63,143,55.9%,17m
8595,3,RazMarin,3406,756,55,50,105,52.4%,5m
8595,3,[lolw0t]Vegan,3406,705,44,34,78,56.4%,20m
8595,3,Linuel,3406,528,21,19,40,52.5%,4m
8595,2,[GoldM]Berndi,3406,468,15,27,42,35.7%,13m
8595,2,[D5Gs]MaxD,3406,319,14,22,36,38.9%,12m
8595,3,SuccSucc,3406,274,9,2,11,81.8%,19m
8595,3,Natriumarm,3406,179,5,2,7,71.4%,5m
8595,3,kingofhearts,3406,114,5,2,7,71.4%,11m
8595,2,[ESS]Eekez,3406,130,5,9,14,35.7%,13m
8595,3,Martinnicko,3406,114,4,4,8,50.0%,13m
8595,3,Veni,3406,147,3,4,7,42.9%,17m
8595,3,Bosain,3406,90,3,7,10,30.0%,15m
8595,3,[TFS1]PizzAce,3406,30,1,2,3,33.3%,6m
8595,3,[УСС]GlebKaroch,3406,0,1,2,3,33.3%,17m
8595,3,BerlinSports,3406,97,1,4,5,20.0%,20m
8595,3,iTzLogan,3406,30,1,6,7,14.3%,22m
8595,1,Vectron,3406,0,0,1,1,0.0%,21m
8614,2,firstoption,3405,1611,233,234,467,49.9%,9m
8614,2,[SStarz]Necromancer,3405,1544,212,205,417,50.8%,19m
8614,3,Ayoran,3405,750,56,39,95,58.9%,22m
8614,2,Markvart,3405,846,30,37,67,44.8%,18m
8614,3,ChukNorris,3405,416,19,9,28,67.9%,13m
8614,2,Sickangel,3405,134,6,8,14,42.9%,37m
8620,3,[7wonde]impact,3404,1120,146,125,271,53.9%,21m
8620,3,eviltedy,3404,1327,140,111,251,55.8%,11m
8620,3,Adam,3404,1325,69,64,133,51.9%,23m
8620,3,zuka,3404,739,39,7,46,84.8%,19m
8620,3,ImAustistic,3404,734,33,23,56,58.9%,7m
8620,3,[FMmkay]telkamp,3404,723,27,30,57,47.4%,21m
8620,2,[696]idfgot,3404,436,14,29,43,32.6%,18m
8620,3,Morganfreema,3404,190,11,6,17,64.7%,13m
8620,3,MisterT,3404,194,7,4,11,63.6%,19m
8620,3,[КПCC]ZeraKing,3404,184,6,11,17,35.3%,6m
8620,3,Daohachi,3404,148,5,9,14,35.7%,37m
8620,3,[ƬC]Nukewizard,3404,60,2,3,5,40.0%,14m
8620,3,[PLA2N]Tokyo,3404,0,0,6,6,0.0%,9m
8633,2,JohnBird,3403,1064,98,96,194,50.5%,14m
8633,3,[Oursbl]Kuberaz,3403,901,34,29,63,54.0%,16m
8633,3,[nWss]Mercilos,3403,754,33,36,69,47.8%,4m
8633,3,OrdanBest,3403,284,14,17,31,45.2%,11m
8633,3,[WAAAR]NIK,3403,310,12,4,16,75.0%,19m
8633,3,[HAHAH]Khyane,3403,172,7,3,10,70.0%,14m
8633,2,Lemmings,3403,232,6,10,16,37.5%,36m
8633,3,nagand,3403,0,5,0,5,100.0%,4m
8633,3,BarCode,3403,125,3,8,11,27.3%,21m
8633,3,[75рус]IZRA,3403,58,2,7,9,22.2%,11m
8633,3,[opFaiL]DevilHaze,3403,0,1,0,1,100.0%,12m
8644,3,HyungMin,3402,1429,159,144,303,52.5%,15m
8644,3,[PÂRłAH]RaThak,3402,702,82,84,166,49.4%,10m
8644,3,XLNT,3402,1069,53,24,77,68.8%,8m
8644,3,[Hrr]КапитанAlex,3402,779,32,30,62,51.6%,17m
8644,3,Overed,3402,684,28,16,44,63.6%,21m
8644,3,[ЯйкиGo]Patron,3402,502,18,24,42,42.9%,23m
8644,3,Player,3402,0,5,1,6,83.3%,9m
8644,3,ZurAzzt,3402,114,5,2,7,71.4%,10m
8644,3,[Esply]EsplyEd,3402,114,5,3,8,62.5%,12m
8644,3,Chinro,3402,86,4,1,5,80.0%,4m
8644,3,KimJungAdun,3402,30,2,0,2,100.0%,19m
8644,3,KoTe,3402,30,1,5,6,16.7%,10m
8644,3,Vanitas,3402,0,0,2,2,0.0%,37m
8644,3,[CuWoǂ]BoBBy,3402,0,0,2,2,0.0%,4m
8658,3,BARCODE,3401,869,36,24,60,60.0%,6m
8658,3,busybuddy,3401,591,30,18,48,62.5%,17m
8658,3,[R4ZR]Kelenas,3401,786,29,25,54,53.7%,18m
8658,3,Grimi,3401,147,6,14,20,30.0%,9m
8658,3,Supeц,3401,148,5,4,9,55.6%,4m
8658,1,SummerWind,3401,0,4,1,5,80.0%,1h
8658,3,Xltredos,3401,60,3,2,5,60.0%,11m
8658,3,Hurricane,3401,58,2,1,3,66.7%,19m
8658,1,[xAngry]IIIIIIIIIIII,3401,0,0,2,2,0.0%,20m
8667,2,PFSade,3400,1500,162,170,332,48.8%,15m
8667,2,[AciNoN]WERTEX,3400,1527,143,125,268,53.4%,21m
8667,2,[HiDu]Chummtoad,3400,1414,62,74,136,45.6%,10m
8667,3,[wedown]SeppiaPigra,3400,1132,48,33,81,59.3%,8m
8667,2,[Pr0xу]MozG,3400,998,35,44,79,44.3%,5m
8667,3,[epiXX]Ezai,3400,399,26,18,44,59.1%,11m
8667,3,[ŋǤ]HorMi,3400,142,6,6,12,50.0%,22m
8667,3,maxQ,3400,146,5,3,8,62.5%,23m
8667,3,aleandr,3400,0,3,2,5,60.0%,8m
8667,3,KROMWELL,3400,88,3,3,6,50.0%,15m
8667,1,Sobber,3400,0,3,3,6,50.0%,1h
8667,3,[708906]indigo,3400,30,3,5,8,37.5%,19m
8667,3,[CCAV]PTW,3400,30,2,1,3,66.7%,6m
8667,3,meti,3400,121,2,6,8,25.0%,5m
8667,3,Kruger,3400,0,1,4,5,20.0%,15m
8667,3,Snapshot,3400,0,0,1,1,0.0%,4m
8667,3,[QNQ]Duffster,3400,0,0,1,1,0.0%,11m
8667,3,Borderchik,3400,0,0,1,1,0.0%,17m
8685,2,[PHØMUI]Kento,3399,1448,152,155,307,49.5%,4m
8685,2,[StarNS]NickSoft,3399,1479,81,87,168,48.2%,18m
8685,3,Flusskind,3399,738,31,26,57,54.4%,5m
8685,3,Legion,3399,304,20,11,31,64.5%,10m
8685,3,mdwild,3399,259,10,13,23,43.5%,15m
8685,2,[TKRs]houser,3399,206,8,11,19,42.1%,36m
8685,3,[ŊƓƇ]Aranar,3399,121,6,2,8,75.0%,19m
8685,3,[LiFe]Zeracyb,3399,0,3,2,5,60.0%,13m
8685,3,dlsgkaos,3399,121,3,2,5,60.0%,6m
8685,3,Yakain,3399,30,2,3,5,40.0%,11m
8685,3,Itzibitzi,3399,30,1,2,3,33.3%,21m
8685,3,[neuroW]Comlock,3399,0,1,3,4,25.0%,13m
8685,3,llllllllllll,3399,0,0,1,1,0.0%,12m
8685,3,Iven,3399,0,0,5,5,0.0%,22m
8699,3,Val,3398,879,162,128,290,55.9%,11m
8699,3,Cordador,3398,540,162,134,296,54.7%,23m
8699,2,[PÂRłAH]majti,3398,1565,110,109,219,50.2%,12m
8699,3,FatVikingNrd,3398,1595,108,97,205,52.7%,9m
8699,3,Housetier,3398,417,36,39,75,48.0%,22m
8699,3,[Miszcz]kaktanternak,3398,833,34,28,62,54.8%,7m
8699,3,Massive,3398,557,27,20,47,57.4%,14m
8699,3,[XØXØ]ÐǂProdigyOne,3398,510,25,13,38,65.8%,6m
8699,3,AlphaZero,3398,494,18,17,35,51.4%,14m
8699,3,[PÂRłAH]robotikov,3398,416,16,9,25,64.0%,15m
8699,3,Lionello,3398,272,11,9,20,55.0%,22m
8699,3,Asparagus,3398,265,11,9,20,55.0%,21m
8699,3,FRG,3398,128,10,11,21,47.6%,7m
8699,3,[IsImBO]liquidLoleK,3398,145,7,3,10,70.0%,22m
8699,2,[WIGE]Nerova,3398,95,6,2,8,75.0%,5m
8699,3,[MiA]treach,3398,30,5,2,7,71.4%,9m
8699,3,zwift,3398,60,3,1,4,75.0%,5m
8699,3,Anatoliy,3398,30,2,2,4,50.0%,36m
8699,2,chocsam,3398,0,1,8,9,11.1%,18m
8699,3,Sobolinko,3398,0,0,3,3,0.0%,7m
8699,3,[cFADDA]WetPiricoccu,3398,0,0,3,3,0.0%,23m
8699,1,Batlan,3398,0,0,4,4,0.0%,18m
8721,3,Toph,3397,1589,206,195,401,51.4%,18m
8721,3,[ArDoC]onelastkiss,3397,1238,100,85,185,54.1%,21m
8721,3,Marauder,3397,1598,92,88,180,51.1%,11m
8721,3,Eyron,3397,1092,41,44,85,48.2%,17m
8721,2,[lMMl]Macmed,3397,578,20,30,50,40.0%,16m
8721,3,Aweresis,3397,414,15,11,26,57.7%,7m
8721,3,shytech,3397,97,6,1,7,85.7%,18m
8721,1,[SoBG]Blossom,3397,0,4,1,5,80.0%,8m
8721,1,GenjisAss,3397,0,2,2,4,50.0%,18m
8721,3,[NoRick]crushThoZ,3397,30,2,3,5,40.0%,36m
8721,1,Dragon,3397,0,2,5,7,28.6%,15m
8721,3,[llIlkI]WarRieR,3397,97,1,7,8,12.5%,12m
8721,3,RainbowCat,3397,0,0,1,1,0.0%,37m
8721,3,llllllllllll,3397,0,0,2,2,0.0%,11m
8721,3,Shigeru,3397,0,0,4,4,0.0%,7m
8736,2,[RBP3]KOVALSKI,3396,1506,218,189,407,53.6%,19m
8736,3,elprimito,3396,1648,188,156,344,54.7%,7m
8736,2,fattou,3396,1237,136,147,283,48.1%,9m
8736,3,llllllllllll,3396,1213,67,51,118,56.8%,9m
8736,3,[snowBY]kiberbylling,3396,908,44,32,76,57.9%,20m
8736,3,Rowannn,3396,472,19,15,34,55.9%,18m
8736,3,unazko,3396,178,12,5,17,70.6%,7m
8736,3,DrAcula,3396,30,5,3,8,62.5%,6m
8736,3,[NemID]Ucar,3396,60,2,2,4,50.0%,22m
8736,3,[LEB]Happy,3396,30,2,4,6,33.3%,22m
8746,3,[S06R]kiwiarmand,3395,1590,238,214,452,52.7%,10m
8746,2,[SixPac]GameOfProbes,3395,1495,222,215,437,50.8%,6m
8746,3,Plop,3395,857,40,46,86,46.5%,21m
8746,3,Epsilon,3395,344,34,29,63,54.0%,12m
8746,3,Nord,3395,763,32,26,58,55.2%,11m
8746,3,DeathL,3395,790,30,27,57,52.6%,19m
8746,3,Equalizer,3395,475,19,18,37,51.4%,4m
8746,1,Pinhão,3395,252,12,8,20,60.0%,5m
8746,3,Sonic,3395,0,1,0,1,100.0%,9m
8746,3,[NeStar]ОЯШ,3395,0,1,0,1,100.0%,22m
8746,3,Булка,3395,0,1,0,1,100.0%,7m
8746,3,CptnMarcus,3395,30,1,1,2,50.0%,12m
8746,3,executor,3395,30,1,2,3,33.3%,19m
8759,2,Capybara,3394,1537,227,215,442,51.4%,17m
8759,3,Nothecent,3394,914,108,88,196,55.1%,21m
8759,2,[KDV]PanTarZan,3394,1540,74,89,163,45.4%,8m
8759,3,MrGambit,3394,845,35,26,61,57.4%,13m
8759,3,LEIT,3394,800,33,28,61,54.1%,18m
8759,3,ApFurio,3394,684,27,26,53,50.9%,10m
8759,3,Supreme,3394,387,21,11,32,65.6%,9m
8759,3,dxdy,3394,521,21,20,41,51.2%,7m
8759,3,Xigma,3394,462,17,20,37,45.9%,7m
8759,3,xeldoros,3394,181,8,3,11,72.7%,13m
8759,1,Cogg,3394,235,8,10,18,44.4%,18m
8759,3,Блай,3394,60,7,3,10,70.0%,4m
8759,3,mæma,3394,116,5,7,12,41.7%,17m
8759,3,[KOPOBA]Wonder,3394,0,1,4,5,20.0%,37m
8773,2,[FlFi]ZvezdaSevera,3393,1487,304,310,614,49.5%,11m
8773,3,jakub,3393,470,99,88,187,52.9%,36m
8773,2,[xslsx]lagmil,3393,1172,41,49,90,45.6%,10m
8773,3,VValfram,3393,700,26,24,50,52.0%,7m
8773,3,Adon,3393,591,24,14,38,63.2%,12m
8773,3,CarrotJam,3393,616,24,15,39,61.5%,16m
8773,1,Byaka,3393,352,12,6,18,66.7%,10m
8773,3,PAPU,3393,296,11,9,20,55.0%,7m
8773,3,blinblin,3393,116,4,3,7,57.1%,37m
8773,3,Brickwall,3393,0,1,0,1,100.0%,10m
8773,3,[VuV]DJDeepT,3393,0,1,1,2,50.0%,19m
8773,3,MrWednesday,3393,30,1,1,2,50.0%,13m
8773,3,Polio,3393,0,0,2,2,0.0%,22m
8773,3,[MLKSTK]ares,3393,0,0,2,2,0.0%,4m
8787,3,Lorthiras,3392,1559,102,103,205,49.8%,37m
8787,3,GSSgeneral,3392,1253,51,42,93,54.8%,15m
8787,3,ExalT,3392,985,49,44,93,52.7%,12m
8787,3,Metrics,3392,891,36,23,59,61.0%,8m
8787,3,NewLeafJones,3392,434,17,7,24,70.8%,21m
8787,3,KingOfBlades,3392,257,15,4,19,78.9%,7m
8787,3,[MG2K]awelase,3392,192,8,1,9,88.9%,8m
8787,2,LehtineN,3392,220,8,3,11,72.7%,7m
8787,3,[illGG]Reaver,3392,172,7,4,11,63.6%,9m
8787,3,[NaCls]PegasusGreen,3392,58,3,0,3,100.0%,36m
8787,3,Zed,3392,86,3,3,6,50.0%,18m
8787,3,Bobiet,3392,0,1,0,1,100.0%,7m
8787,3,[ZHxPro]DeltaFirst,3392,0,1,0,1,100.0%,4m
8787,3,[GenD]Deathvenom,3392,0,0,1,1,0.0%,12m
8787,3,Nuathor,3392,0,0,1,1,0.0%,14m
8787,3,Ziserman,3392,0,0,2,2,0.0%,36m
8803,3,yukecen,3391,496,20,9,29,69.0%,17m
8803,3,[ESHD]Master,3391,360,14,11,25,56.0%,9m
8803,3,HolyZoly,3391,86,4,0,4,100.0%,37m
8803,1,Jaesung,3391,97,3,5,8,37.5%,21m
8803,3,[SCSh1t]Vortexx,3391,86,3,6,9,33.3%,12m
8803,3,[ExPB]smile,3391,0,0,1,1,0.0%,22m
8803,3,water,3391,0,0,2,2,0.0%,8m
8810,2,llllllllllll,3390,1522,99,105,204,48.5%,5m
8810,3,[Mighty]Sandman,3390,1265,65,68,133,48.9%,7m
8810,3,zealotuajzf,3390,118,6,6,12,50.0%,11m
8810,3,Galneryus,3390,0,5,1,6,83.3%,19m
8810,3,MooreTim,3390,0,5,1,6,83.3%,23m
8810,3,[SWN]Erébus,3390,142,4,0,4,100.0%,6m
8810,3,[LAMPA]ТоксичныйТеР,3390,60,3,2,5,60.0%,36m
8810,3,[Jooooo]PitON,3390,30,1,1,2,50.0%,5m
8810,3,[TExGG]Metray,3390,0,0,1,1,0.0%,18m
8810,3,[AjA]Chaga,3390,0,0,2,2,0.0%,11m
8820,2,[RеG]arhi,3389,1142,103,89,192,53.6%,19m
8820,3,[Sw0rm]DRsloper,3389,1370,63,40,103,61.2%,15m
8820,3,Qwan,3389,826,40,21,61,65.6%,20m
8820,3,MiguelPérez,3389,511,20,16,36,55.6%,23m
8820,3,AEG,3389,470,18,15,33,54.5%,8m
8820,1,Kosmo,3389,195,13,9,22,59.1%,15m
8820,3,MarshGeology,3389,67,6,5,11,54.5%,4m
8820,3,MATHEMATIK,3389,137,4,1,5,80.0%,11m
8820,3,lIlIlIlIlIlI,3389,50,4,9,13,30.8%,7m
8820,3,[PÂRłAH]MatriX,3389,30,1,1,2,50.0%,13m
8820,3,[SEDFQE]Loking,3389,0,1,6,7,14.3%,20m
8820,3,[BTSR]BrOlav,3389,0,0,2,2,0.0%,21m
8832,2,[ZERGTV]IvanGP,3388,1483,211,206,417,50.6%,11m
8832,3,Domain,3388,1452,127,120,247,51.4%,7m
8832,3,RastaTotophe,3388,1578,103,94,197,52.3%,17m
8832,2,[1FU2]Had,3388,1446,93,91,184,50.5%,13m
8832,3,[ZGlot]Mirrorer,3388,645,41,30,71,57.7%,7m
8832,3,Himera,3388,978,37,44,81,45.7%,13m
8832,3,Hbntchrwelpe,3388,300,10,15,25,40.0%,8m
8832,2,Adons,3388,215,9,6,15,60.0%,11m
8832,3,[Elli]Левиафан,3388,146,6,4,10,60.0%,5m
8832,3,ULTRAKILL,3388,30,2,4,6,33.3%,21m
8832,3,BagelBringer,3388,0,1,0,1,100.0%,15m
8832,3,[DePro]ForeMosT,3388,0,0,4,4,0.0%,9m
8844,3,sneg,3387,1180,109,86,195,55.9%,4m
8844,3,Origami,3387,936,38,28,66,57.6%,10m
8844,3,[BxN]piertxo,3387,429,30,24,54,55.6%,14m
8844,3,Blast,3387,298,12,13,25,48.0%,5m
8844,3,[ThAc]Gaettwo,3387,200,8,7,15,53.3%,7m
8844,3,StoRyTime,3387,30,5,1,6,83.3%,21m
8844,1,[Animе]Phan,3387,130,3,2,5,60.0%,22m
8844,3,JianYang,3387,60,3,3,6,50.0%,4m
8844,3,[LINGON]Souler,3387,30,2,1,3,66.7%,15m
8844,3,alex,3387,58,2,1,3,66.7%,11m
8844,1,[Юнион]дмитрий,3387,0,2,3,5,40.0%,1h
8844,3,WardenBeZy,3387,0,1,0,1,100.0%,23m
8844,3,[BWArmy]LiGhtNinG,3387,0,1,1,2,50.0%,16m
8857,3,Oldchild,3386,1569,172,174,346,49.7%,5m
8857,3,Casic,3386,899,33,40,73,45.2%,18m
8857,3,zeratul,3386,432,17,12,29,58.6%,10m
8857,3,[HBGSJR]Dranikon,3386,334,17,20,37,45.9%,17m
8857,3,Warbringer,3386,292,12,5,17,70.6%,7m
8857,3,Amadeus,3386,322,12,16,28,42.9%,22m
8857,3,[JKRUA]TnT,3386,280,10,9,19,52.6%,6m
8857,1,Lilly,3386,97,5,1,6,83.3%,9m
8857,3,Deadaluss,3386,0,0,1,1,0.0%,14m
8857,3,Akulich,3386,0,0,1,1,0.0%,20m
8867,2,Gillerboy,3385,1589,306,288,594,51.5%,14m
8867,3,Burgerkill,3385,1584,212,198,410,51.7%,14m
8867,2,[ElBag]Dertia,3385,1415,132,130,262,50.4%,11m
8867,3,Labach,3385,1223,53,49,102,52.0%,13m
8867,3,WheresMyCar,3385,850,34,29,63,54.0%,4m
8867,3,MrDiarrhea,3385,432,18,14,32,56.2%,22m
8867,3,set,3385,397,17,8,25,68.0%,9m
8867,3,[CFEL]JFK,3385,369,16,15,31,51.6%,11m
8867,3,[PhAFr]Papuche,3385,286,11,12,23,47.8%,18m
8867,3,Hotfender,3385,256,9,10,19,47.4%,37m
8867,3,Stelios,3385,230,8,12,20,40.0%,36m
8867,3,[SunGmr]BadDayRDK,3385,196,5,9,14,35.7%,23m
8867,3,Popcorn,3385,170,4,4,8,50.0%,23m
8867,3,leezzang,3385,0,3,3,6,50.0%,20m
8867,3,Volberg,3385,0,1,0,1,100.0%,9m
8867,3,Buggy,3385,0,0,5,5,0.0%,12m
8883,1,IQlab,3384,777,183,180,363,50.4%,15m
8883,3,[Jøhn]Hokan,3384,1528,165,135,300,55.0%,5m
8883,2,Leggo,3384,1029,117,107,224,52.2%,36m
8883,3,xlPaRaNoiiDz,3384,988,49,18,67,73.1%,18m
8883,3,Metanoia,3384,561,34,22,56,60.7%,6m
8883,3,skazy,3384,844,34,24,58,58.6%,21m
8883,3,glhf,3384,554,20,26,46,43.5%,13m
8883,3,[1GH1]Alfastigma,3384,354,18,8,26,69.2%,4m
8883,3,Granham,3384,316,15,10,25,60.0%,10m
8883,3,[Salvi]Pouyana,3384,367,14,12,26,53.8%,5m
8883,3,MiSix,3384,302,11,16,27,40.7%,9m
8883,3,GrrrMaker,3384,118,6,2,8,75.0%,16m
8883,3,Skorpo,3384,60,3,6,9,33.3%,9m
8883,2,Yuri,3384,90,3,13,16,18.8%,5m
8883,3,funkyJunky,3384,0,0,1,1,0.0%,15m
8883,3,ptz,3384,0,0,1,1,0.0%,16m
8883,2,Nibbs,3384,0,0,1,1,0.0%,14m
8883,3,Mapsi,3384,0,0,4,4,0.0%,7m
8901,3,Durza,3383,1589,73,64,137,53.3%,13m
8901,3,Maverick,3383,759,55,51,106,51.9%,21m
8901,3,eQThib,3383,952,41,28,69,59.4%,9m
8901,3,[LCRF]Macpro,3383,620,26,19,45,57.8%,7m
8901,3,[TAW]cruelrichard,3383,684,25,22,47,53.2%,8m
8901,3,Delf,3383,286,10,14,24,41.7%,21m
8901,3,Arkanis,3383,202,7,7,14,50.0%,23m
8901,3,[ЯD]Sync,3383,86,4,0,4,100.0%,15m
8901,3,LikeABoss,3383,50,4,5,9,44.4%,36m
8901,3,Greger,3383,30,2,0,2,100.0%,4m
8901,3,Terho,3383,58,2,2,4,50.0%,5m
8901,3,[FMDRS]Kraki,3383,0,1,0,1,100.0%,6m
8901,3,adepT,3383,30,1,4,5,20.0%,36m
8901,3,llllllllllll,3383,0,0,2,2,0.0%,6m
8901,3,[Fridge]Freezer,3383,0,0,3,3,0.0%,36m
8916,3,Prophet,3382,1148,86,74,160,53.8%,8m
8916,3,GhostDog,3382,1041,80,51,131,61.1%,21m
8916,3,CapPopaye,3382,1188,49,49,98,50.0%,13m
8916,3,TossTerr,3382,1022,40,40,80,50.0%,17m
8916,2,Cheid,3382,297,12,6,18,66.7%,21m
8916,3,Mobius,3382,264,9,10,19,47.4%,37m
8916,3,[DFgsA]FKrisz,3382,165,8,4,12,66.7%,7m
8916,3,SlayersMMA,3382,228,8,11,19,42.1%,14m
8916,3,CVDДиссидeнт,3382,148,6,8,14,42.9%,21m
8916,3,Shon,3382,30,2,2,4,50.0%,11m
8916,3,kronk,3382,30,2,3,5,40.0%,23m
8916,3,[ODGW]Faithless,3382,0,1,0,1,100.0%,16m
8916,2,nnnnn,3382,0,1,0,1,100.0%,7m
8916,3,Anton,3382,0,1,0,1,100.0%,11m
8916,3,[MYG]Marvel,3382,0,0,1,1,0.0%,10m
8916,3,[HONX]Treterpeter,3382,0,0,1,1,0.0%,21m
8916,3,fedorSLD,3382,0,0,2,2,0.0%,37m
8933,3,GrandpaToss,3381,850,169,159,328,51.5%,23m
8933,3,VanTroff,3381,1506,99,84,183,54.1%,15m
8933,3,Yegorka,3381,1534,63,54,117,53.8%,16m
8933,3,[Bloro]Lestaron,3381,1108,48,52,100,48.0%,12m
8933,3,llllllllllll,3381,533,33,31,64,51.6%,15m
8933,3,Idletime,3381,600,21,27,48,43.8%,13m
8933,1,sterne,3381,250,10,9,19,52.6%,36m
8933,3,[B0xers]KingMacron,3381,90,4,8,12,33.3%,10m
8933,3,sword,3381,97,2,4,6,33.3%,19m
8933,3,[GZerO]Thomas,3381,0,1,0,1,100.0%,8m
8933,3,kamaziaka,3381,0,1,0,1,100.0%,20m
8933,3,Dawnerz,3381,0,0,1,1,0.0%,7m
8945,3,PREDATOR,3380,1603,90,63,153,58.8%,7m
8945,3,BlackTea,3380,543,23,17,40,57.5%,21m
8945,3,[3Dcla]mrPUTIIN,3380,586,21,21,42,50.0%,16m
8945,3,OKAY,3380,194,7,9,16,43.8%,17m
8945,3,[aQQmbR]FmPony,3380,92,3,7,10,30.0%,11m
8945,3,TripleBum,3380,60,2,4,6,33.3%,7m
8945,3,Lucky,3380,0,0,1,1,0.0%,11m
8945,3,[ZERGML]caster,3380,0,0,1,1,0.0%,10m
8945,3,[BRSKR]Sedator,3380,0,0,2,2,0.0%,14m
8945,3,[GWuH]GosuGoich,3380,0,0,3,3,0.0%,17m
8945,3,Rached,3380,0,0,5,5,0.0%,9m
8956,3,ioshimi,3379,1508,314,301,615,51.1%,36m
8956,3,Voin,3379,1672,216,204,420,51.4%,36m
8956,3,[Bruk]TTk,3379,829,110,96,206,53.4%,6m
8956,3,Hamslam,3379,1036,69,49,118,58.5%,16m
8956,3,Mithic,3379,623,25,13,38,65.8%,14m
8956,3,Jarruraita,3379,312,17,20,37,45.9%,10m
8956,3,[Narnia]JustinReaper,3379,181,16,15,31,51.6%,7m
8956,3,[Hаsu]OZZY,3379,237,10,6,16,62.5%,36m
8956,1,Fancy,3379,145,6,2,8,75.0%,30m
8956,1,Croissant,3379,97,5,1,6,83.3%,1h
8956,3,Muminpappa,3379,110,5,6,11,45.5%,10m
8956,3,starstream,3379,30,2,0,2,100.0%,13m
8956,3,Fenix,3379,30,1,2,3,33.3%,8m
8969,3,emerge,3378,1591,110,102,212,51.9%,8m
8969,3,ZyReX,3378,1391,74,69,143,51.7%,19m
8969,3,Mass,3378,1588,72,68,140,51.4%,8m
8969,2,[TheDOH]Dimaria,3378,880,56,60,116,48.3%,10m
8969,2,itona,3378,661,27,29,56,48.2%,24m
8969,3,Practy,3378,357,17,11,28,60.7%,15m
8969,3,Ardenit,3378,144,5,6,11,45.5%,17m
8969,3,[NiN]Nimbus,3378,86,3,2,5,60.0%,21m
8969,3,[Arrows]MrDezgus,3378,58,2,2,4,50.0%,22m
8969,3,[Hrr]TPAXO,3378,30,1,3,4,25.0%,11m
8969,3,Popa,3378,0,1,4,5,20.0%,8m
8980,3,Dgees,3377,1518,124,125,249,49.8%,4m
8980,3,Tot,3377,760,106,100,206,51.5%,21m
8980,3,[STr6]Gloomitel,3377,1526,91,93,184,49.5%,23m
8980,3,LowAPM,3377,542,47,4,51,92.2%,17m
8980,3,TheHooK,3377,1104,45,34,79,57.0%,14m
8980,3,БоеваяБорода,3377,824,29,31,60,48.3%,5m
8980,3,Artyr,3377,600,24,13,37,64.9%,16m
8980,3,Grimous,3377,242,10,3,13,76.9%,17m
8980,3,Pantal,3377,164,8,3,11,72.7%,10m
8980,3,Dahll,3377,118,5,5,10,50.0%,22m
8980,3,Lemon,3377,157,3,5,8,37.5%,11m
8980,3,JLP,3377,70,3,7,10,30.0%,10m
8980,3,[BATAY]komizen,3377,0,1,0,1,100.0%,36m
8980,3,ARAti,3377,0,1,0,1,100.0%,22m
8980,3,[JEBLA]kikondo,3377,0,0,1,1,0.0%,7m
8995,3,[lvl69]Eviltrick,3376,1595,277,247,524,52.9%,23m
8995,3,IIIIIIIIIIII,3376,1635,212,188,400,53.0%,13m
8995,2,gambit,3376,672,83,88,171,48.5%,6m
8995,3,newbe,3376,1220,56,28,84,66.7%,15m
8995,3,[nopvp]sirBlue,3376,852,36,15,51,70.6%,6m
8995,3,LiMaK,3376,203,9,4,13,69.2%,14m
8995,2,[PaniC]Gedeon,3376,172,7,17,24,29.2%,36m
8995,3,Sidney,3376,148,6,7,13,46.2%,20m
8995,3,GreatToss,3376,114,4,3,7,57.1%,11m
8995,3,RobBot,3376,0,1,0,1,100.0%,36m
8995,3,Alucarth,3376,30,1,3,4,25.0%,14m
8995,3,Squasher,3376,0,0,1,1,0.0%,6m
9007,2,[DarKwi]mksprite,3375,1312,84,72,156,53.8%,36m
9007,3,[XØXØ]ÐǂMayBe,3375,1591,66,56,122,54.1%,18m
9007,3,ChronoCube,3375,1258,47,48,95,49.5%,22m
9007,3,Akmanah,3375,1053,45,31,76,59.2%,11m
9007,3,KillerQueen,3375,740,28,26,54,51.9%,14m
9007,3,[HBGSJR]magic,3375,416,15,13,28,53.6%,16m
9007,3,[SPAINs]zeratul,3375,376,14,18,32,43.8%,22m
9007,3,PatchRace,3375,264,9,12,21,42.9%,10m
9007,3,Murash,3375,202,8,8,16,50.0%,5m
9007,3,ATOMRUSH,3375,216,8,13,21,38.1%,18m
9007,3,Ale,3375,114,5,0,5,100.0%,14m
9007,3,jonasmedz,3375,30,1,3,4,25.0%,21m
9007,1,ZeRgLiNG,3375,0,0,1,1,0.0%,32m
9007,3,martin,3375,0,0,6,6,0.0%,21m
9021,3,Świchodrąg,3374,441,68,46,114,59.6%,22m
9021,3,bratishka,3374,1434,56,61,117,47.9%,13m
9021,3,DarthVaid,3374,908,33,40,73,45.2%,36m
9021,3,[SEXi]relax,3374,350,13,10,23,56.5%,10m
9021,3,[HdO]GIVIA,3374,278,12,6,18,66.7%,11m
9021,3,[GCorps]BlizzOmega,3374,172,7,4,11,63.6%,15m
9021,2,ShineON,3374,0,5,0,5,100.0%,33m
9021,3,DrunkedSmurf,3374,190,5,6,11,45.5%,21m
9021,3,Unfug,3374,30,4,3,7,57.1%,18m
9021,3,[1FU2]FourTwenty,3374,68,4,5,9,44.4%,5m
9021,3,Flaschenpost,3374,113,4,6,10,40.0%,7m
9021,3,Dimascarabas,3374,126,4,12,16,25.0%,19m
9021,1,Neylem,3374,97,2,5,7,28.6%,7m
9021,3,DarthStellar,3374,0,1,0,1,100.0%,15m
9021,3,CanardSansTT,3374,0,1,0,1,100.0%,11m
9021,3,Psychrolutes,3374,0,0,1,1,0.0%,23m
9037,3,[IceHus]outbid,3373,1222,119,104,223,53.4%,5m
9037,3,Ganon,3373,617,28,19,47,59.6%,7m
9037,3,[InBri]PolarBeeANG,3373,644,25,21,46,54.3%,5m
9037,3,Hamster,3373,490,17,20,37,45.9%,15m
9037,3,[RckS]KSK,3373,510,17,21,38,44.7%,19m
9037,3,Morgoth,3373,518,17,25,42,40.5%,37m
9037,3,[CoD2]CptCleese,3373,122,6,2,8,75.0%,6m
9037,3,TraiT,3373,166,6,2,8,75.0%,15m
9037,3,Kwriss,3373,168,6,5,11,54.5%,9m
9037,3,[JLT]Guardian,3373,118,4,4,8,50.0%,37m
9037,3,Obibi,3373,0,3,2,5,60.0%,6m
9037,3,[Камрад]Kukaracha,3373,112,2,3,5,40.0%,21m
9037,3,Olch,3373,0,1,0,1,100.0%,20m
9037,3,[NТB]ZergsPaPa,3373,0,1,0,1,100.0%,21m
9037,3,BaiLLiE,3373,0,1,0,1,100.0%,15m
9037,3,[ØC]Beurp,3373,0,0,5,5,0.0%,20m
9037,3,BabouLeFou,3373,0,0,8,8,0.0%,14m
9054,3,mQp,3372,1226,57,43,100,57.0%,11m
9054,3,[ZERG7V]Nuclear,3372,1099,52,45,97,53.6%,21m
9054,2,[Rstc]znxR,3372,739,31,26,57,54.4%,36m
9054,3,etxeberro,3372,369,24,16,40,60.0%,11m
9054,3,Cash,3372,526,20,15,35,57.1%,18m
9054,3,lllllll,3372,494,19,16,35,54.3%,23m
9054,3,Benzy,3372,508,18,19,37,48.6%,36m
9054,3,[WCFAN]Schlitzer,3372,510,18,21,39,46.2%,23m
9054,3,huitza,3372,380,13,6,19,68.4%,16m
9054,3,[FlFi]Nereon,3372,233,10,6,16,62.5%,10m
9054,1,iLiLLLiLiiii,3372,97,5,1,6,83.3%,34m
9054,1,NTRU,3372,0,5,1,6,83.3%,1h
9054,3,Olymp,3372,60,3,3,6,50.0%,8m
9054,3,YoshikiKano,3372,30,2,0,2,100.0%,11m
9054,3,Mysteltainn,3372,30,2,2,4,50.0%,10m
9054,3,SeCrET,3372,0,1,0,1,100.0%,37m
9054,2,[BPX]FettmannBrot,3372,0,0,1,1,0.0%,18m
9054,3,Fitchy,3372,0,0,2,2,0.0%,18m
9054,3,Dragon,3372,0,0,4,4,0.0%,23m
9073,2,Lasileuka,3371,838,158,157,315,50.2%,10m
9073,3,MrMobile,3371,1306,157,163,320,49.1%,21m
9073,2,[FR1]LiquidCurage,3371,1008,43,41,84,51.2%,23m
9073,2,intrepretato,3371,1036,36,51,87,41.4%,6m
9073,2,Haughtgernon,3371,281,14,11,25,56.0%,4m
9073,3,[TONGJI]Major,3371,283,13,6,19,68.4%,23m
9073,3,kraken,3371,320,13,8,21,61.9%,7m
9073,2,Falcon,3371,221,9,5,14,64.3%,14m
9073,1,[BornG]MCauthon,3371,176,5,3,8,62.5%,13m
9073,3,Peril,3371,86,4,3,7,57.1%,7m
9073,3,vanHoden,3371,118,4,7,11,36.4%,10m
9073,3,[IndyK]Pure,3371,0,1,0,1,100.0%,9m
9073,3,Hachiman,3371,0,1,0,1,100.0%,23m
9073,3,DraXter,3371,30,1,1,2,50.0%,11m
9073,3,Madarnann,3371,30,1,6,7,14.3%,16m
9073,3,[ZERGTV]DaniilSuper,3371,0,0,1,1,0.0%,5m
9089,3,Alex,3370,776,144,122,266,54.1%,11m
9089,3,[RеG]CiZzyX,3370,1433,113,86,199,56.8%,7m
9089,3,Limej,3370,1406,98,93,191,51.3%,18m
9089,3,Bax,3370,1086,60,58,118,50.8%,13m
9089,3,LiquidnOob,3370,744,29,25,54,53.7%,10m
9089,3,RgPRox,3370,279,28,19,47,59.6%,21m
9089,3,[OotSW]gagman,3370,478,19,12,31,61.3%,19m
9089,3,Near,3370,168,9,6,15,60.0%,36m
9089,3,SILENCE,3370,30,6,0,6,100.0%,15m
9089,3,[tutuut]Buggis,3370,231,6,13,19,31.6%,23m
9089,3,jodl,3370,88,5,4,9,55.6%,21m
9089,3,RandoMStar,3370,116,5,7,12,41.7%,15m
9089,3,NotYou,3370,92,4,7,11,36.4%,23m
9089,3,IIIIIIIIIIII,3370,30,2,3,5,40.0%,14m
9089,3,SunLight,3370,0,0,1,1,0.0%,7m
9104,2,DamBatHai,3369,1478,176,172,348,50.6%,14m
9104,3,AimoLohkare,3369,681,134,137,271,49.4%,11m
9104,3,[Sarmat]Majkelrooshi,3369,1482,86,88,174,49.4%,7m
9104,3,DeadDuck,3369,1612,75,49,124,60.5%,20m
9104,2,[Sacred]iiiiiiiiiiii,3369,592,22,27,49,44.9%,14m
9104,3,MightBeDrunk,3369,394,18,6,24,75.0%,10m
9104,3,DReeNo,3369,304,14,12,26,53.8%,6m
9104,3,akira,3369,280,11,5,16,68.8%,20m
9104,2,[R4p3Rs]HESKEY,3369,238,10,11,21,47.6%,24m
9104,1,Longus,3369,266,8,5,13,61.5%,7m
9104,3,[T4E]Cabbage,3369,264,8,10,18,44.4%,8m
9104,3,OneBeerDeep,3369,60,5,5,10,50.0%,21m
9104,3,kenny,3369,60,2,2,4,50.0%,18m
9104,3,bronko,3369,30,2,5,7,28.6%,10m
9118,3,Ssinxdy,3368,1517,209,184,393,53.2%,15m
9118,3,SEREP,3368,1456,199,181,380,52.4%,14m
9118,3,blik,3368,1557,165,155,320,51.6%,23m
9118,3,Splinter,3368,1377,64,63,127,50.4%,5m
9118,2,[lOoOl]Maula,3368,1011,52,63,115,45.2%,14m
9118,3,[betaAL]Yuno,3368,566,33,28,61,54.1%,8m
9118,3,Ukko,3368,306,10,13,23,43.5%,18m
9118,3,[VVing]raindidaied,3368,196,7,6,13,53.8%,9m
9118,1,Lucifer,3368,97,5,1,6,83.3%,1h
9118,3,[ǂǂǂǂǂ]Ustavson,3368,88,4,2,6,66.7%,6m
9118,3,[GoGoL]Stup,3368,30,2,2,4,50.0%,17m
9118,3,Mimo,3368,0,1,1,2,50.0%,15m
9118,3,[BN]seb,3368,0,0,1,1,0.0%,21m
9118,3,[ARIER]Redshark,3368,0,0,1,1,0.0%,13m
9118,3,VALFAR,3368,0,0,2,2,0.0%,13m
9133,2,DucaL,3367,1559,677,691,1368,49.5%,14m
9133,2,serval,3367,1451,228,231,459,49.7%,15m
9133,2,yogman,3367,1488,175,173,348,50.3%,16m
9133,3,qwerty,3367,1135,94,94,188,50.0%,20m
9133,3,MrGambit,3367,782,33,27,60,55.0%,37m
9133,3,[hf4X4]ProfKahre,3367,751,29,20,49,59.2%,13m
9133,3,[Фаталя]Фаталя,3367,280,12,4,16,75.0%,7m
9133,1,BustAMove,3367,189,10,6,16,62.5%,16m
9133,3,[SucS]Hyliks,3367,0,1,0,1,100.0%,14m
9133,3,ТёмТёмыч,3367,0,1,0,1,100.0%,36m
9133,3,[VlomGG]Hulumulu,3367,0,1,2,3,33.3%,8m
9133,3,HeavyMetal,3367,0,1,2,3,33.3%,22m
9133,3,[Rakia]StarKiller,3367,30,1,5,6,16.7%,7m
9133,3,[tDKe]MazWeiga,3367,0,0,1,1,0.0%,7m
9147,3,Moonlight,3366,1447,135,126,261,51.7%,20m
9147,3,goaulD,3366,1541,124,119,243,51.0%,7m
9147,3,Vanquish,3366,546,21,23,44,47.7%,20m
9147,3,Regis,3366,529,20,11,31,64.5%,12m
9147,3,Kosiachechek,3366,190,14,5,19,73.7%,13m
9147,3,[SSeiya]Ikki,3366,209,10,0,10,100.0%,16m
9147,3,[WarAnt]Geko,3366,214,10,12,22,45.5%,19m
9147,1,THAlLAND,3366,141,7,1,8,87.5%,38m
9147,3,PeBblwyNhapp,3366,30,5,1,6,83.3%,17m
9147,3,Thunder,3366,86,4,3,7,57.1%,37m
9147,3,llllllllllll,3366,177,4,5,9,44.4%,20m
9147,3,Игон,3366,0,0,1,1,0.0%,20m
9147,3,MouFou,3366,0,0,1,1,0.0%,7m
9147,3,RXX,3366,0,0,2,2,0.0%,5m
9161,3,Pipoli,3365,1551,734,730,1464,50.1%,6m
9161,3,HoldTheDoor,3365,1608,261,252,513,50.9%,18m
9161,3,Taldarim,3365,1546,241,211,452,53.3%,6m
9161,3,[HSTQ]Thor,3365,1613,199,194,393,50.6%,17m
9161,3,Rain,3365,1573,101,88,189,53.4%,10m
9161,2,Elendil,3365,1393,84,84,168,50.0%,23m
9161,3,[Steamy]TinJuice,3365,1051,57,43,100,57.0%,16m
9161,3,[MystG]lewy,3365,1195,46,46,92,50.0%,15m
9161,3,[flyrev]flyrev,3365,911,40,23,63,63.5%,5m
9161,3,Trollator,3365,696,40,33,73,54.8%,17m
9161,3,PROTOSRETARD,3365,439,29,9,38,76.3%,7m
9161,3,Zynk,3365,122,5,9,14,35.7%,12m
9161,3,Subbeef,3365,0,1,0,1,100.0%,13m
9161,3,[elCrab]ЯaТaмahaтТa,3365,0,1,0,1,100.0%,22m
9161,3,[wedown]Nasky,3365,0,1,4,5,20.0%,11m
9161,3,[Kompis]Soren,3365,0,0,1,1,0.0%,21m
9177,3,Diamant,3364,698,88,57,145,60.7%,4m
9177,3,KAFAO,3364,508,30,27,57,52.6%,14m
9177,3,voooky,3364,312,13,6,19,68.4%,6m
9177,3,[lancon]ARITHON,3364,194,7,5,12,58.3%,23m
9177,3,CupCake,3364,174,6,6,12,50.0%,10m
9177,3,MuChe,3364,30,2,2,4,50.0%,37m
9177,3,Likan,3364,0,1,0,1,100.0%,22m
9177,3,IRNoob,3364,0,1,0,1,100.0%,14m
9177,3,YungAfterNyt,3364,30,1,7,8,12.5%,10m
9177,3,whatever,3364,0,0,1,1,0.0%,6m
9187,3,ExodusPrime,3363,1618,225,204,429,52.4%,16m
9187,3,zippy,3363,1572,200,192,392,51.0%,17m
9187,3,ButtonPresse,3363,1533,83,72,155,53.5%,11m
9187,3,Protox,3363,1093,71,56,127,55.9%,21m
9187,2,Magnus,3363,713,62,69,131,47.3%,20m
9187,3,azha,3363,324,12,14,26,46.2%,14m
9187,2,BLIBLUBLOB,3363,217,8,13,21,38.1%,16m
9187,3,EarlGrey,3363,180,6,11,17,35.3%,37m
9187,3,EFEX,3363,142,5,5,10,50.0%,17m
9187,3,Djent,3363,0,3,2,5,60.0%,10m
9187,3,desman,3363,30,2,2,4,50.0%,6m
9187,3,[RZEB]Kalopsia,3363,0,1,0,1,100.0%,36m
9199,2,Karatel,3362,1216,82,65,147,55.8%,23m
9199,3,llllllllllll,3362,1446,67,73,140,47.9%,7m
9199,3,[kAesE]pYrO,3362,1317,63,60,123,51.2%,5m
9199,3,[PKTS]heizi,3362,1047,56,51,107,52.3%,11m
9199,3,DDmonkey,3362,706,28,24,52,53.8%,5m
9199,3,FourTwentyLE,3362,525,26,17,43,60.5%,22m
9199,3,PowerCitron,3362,464,26,31,57,45.6%,12m
9199,3,Aladinsane,3362,132,20,14,34,58.8%,19m
9199,3,[H0C]iDrone,3362,478,19,10,29,65.5%,21m
9199,3,[voff]BigBoyRandy,3362,312,12,10,22,54.5%,16m
9199,3,[WCKYLN]BOSSHOORE,3362,248,10,11,21,47.6%,15m
9199,3,Bingobongo,3362,58,3,0,3,100.0%,10m
9199,3,[PŖïMĄŁ]Divadius,3362,30,2,1,3,66.7%,19m
9199,3,JustScout,3362,0,0,1,1,0.0%,5m
9213,3,Einherjaren,3361,1420,98,89,187,52.4%,6m
9213,3,Megapan,3361,1523,97,88,185,52.4%,6m
9213,3,[ExTr1m]valax,3361,1382,57,49,106,53.8%,5m
9213,3,Noname,3361,1160,49,36,85,57.6%,16m
9213,3,[Arrows]IvanKoghedub,3361,1012,40,38,78,51.3%,8m
9213,3,Gantrithor,3361,771,39,28,67,58.2%,13m
9213,3,Flesh,3361,374,17,14,31,54.8%,5m
9213,3,[xFRSx]aNarCHy,3361,386,15,9,24,62.5%,21m
9213,3,Eobard,3361,314,12,19,31,38.7%,10m
9213,3,LuckyKaloyan,3361,294,11,15,26,42.3%,23m
9213,3,Naerea,3361,58,6,2,8,75.0%,21m
9213,2,EliteTryHard,3361,192,6,3,9,66.7%,17m
9213,3,starcode,3361,172,6,9,15,40.0%,36m
9213,3,[DIY]poppzie,3361,0,1,0,1,100.0%,10m
9213,3,ImTheFaker,3361,0,1,0,1,100.0%,6m
9213,3,TomatoHate,3361,0,0,5,5,0.0%,4m
9229,2,Remo,3360,1483,403,393,796,50.6%,11m
9229,2,УБЕЖдённый,3360,1552,255,252,507,50.3%,15m
9229,3,[HACK3R]óóóJuiceWRLD,3360,895,111,84,195,56.9%,10m
9229,3,Stationary,3360,1631,78,59,137,56.9%,10m
9229,3,Bassman,3360,1203,60,53,113,53.1%,9m
9229,3,KaVa,3360,1228,49,52,101,48.5%,11m
9229,3,[glhf20]Nicolas,3360,889,41,26,67,61.2%,10m
9229,3,Philistine,3360,399,33,36,69,47.8%,10m
9229,3,Bzzzik,3360,294,20,19,39,51.3%,14m
9229,3,Dagorlad,3360,468,18,20,38,47.4%,13m
9229,3,ANxDEVON,3360,345,15,10,25,60.0%,7m
9229,3,pwn,3360,270,11,5,16,68.8%,12m
9229,3,[LlCc]tomqwe,3360,234,8,9,17,47.1%,37m
9229,2,andrey,3360,0,5,0,5,100.0%,1h
9229,1,Warlock,3360,97,5,1,6,83.3%,1h
9229,3,UnevenOdds,3360,122,4,6,10,40.0%,16m
9229,3,[PLA2N]NelrOp,3360,62,2,6,8,25.0%,8m
9229,3,[JIH]Johny,3360,0,1,0,1,100.0%,16m
9229,3,glhf,3360,0,1,0,1,100.0%,12m
9229,3,IIIIIIIIII,3360,0,1,0,1,100.0%,12m
9229,3,WhiteRabbit,3360,30,1,2,3,33.3%,10m
9229,3,Desertod,3360,30,1,5,6,16.7%,21m
9251,3,IIIIIIIIIIII,3359,1472,91,69,160,56.9%,37m
9251,3,[tlHope]panika,3359,768,72,55,127,56.7%,9m
9251,3,[cLn]Iceamo,3359,769,46,47,93,49.5%,37m
9251,3,[Ф2]ИмбаТерран,3359,752,44,42,86,51.2%,11m
9251,3,Kenes,3359,1039,43,41,84,51.2%,10m
9251,3,BussiBärchen,3359,919,37,27,64,57.8%,16m
9251,3,abubakir,3359,528,23,7,30,76.7%,17m
9251,3,Liamus,3359,114,10,8,18,55.6%,11m
9251,3,Tyrion,3359,62,3,6,9,33.3%,4m
9260,3,[R1917]JohnBrown,3358,597,170,165,335,50.7%,9m
9260,3,Rödahästen,3358,1597,86,81,167,51.5%,37m
9260,2,Zver,3358,1237,65,78,143,45.5%,10m
9260,3,CoinRT,3358,698,26,28,54,48.1%,17m
9260,3,ZergiuS,3358,466,23,10,33,69.7%,23m
9260,3,plonti,3358,360,15,16,31,48.4%,6m
9260,1,[ApLab]Naaru,3358,188,14,7,21,66.7%,24m
9260,3,RunGen,3358,272,10,11,21,47.6%,6m
9260,3,Ice,3358,58,5,3,8,62.5%,7m
9260,3,Maximus,3358,90,3,9,12,25.0%,13m
9260,3,null,3358,60,2,4,6,33.3%,19m
9260,3,ChronoZz,3358,0,0,1,1,0.0%,17m
9260,3,Skywalker,3358,0,0,1,1,0.0%,7m
9260,2,noob,3358,0,0,5,5,0.0%,14m
9260,3,damOOs,3358,0,0,8,8,0.0%,4m
9275,3,Psh,3357,1563,426,421,847,50.3%,5m
9275,2,ouki,3357,1496,189,172,361,52.4%,16m
9275,3,Petryshka,3357,1526,132,117,249,53.0%,19m
9275,3,Demi,3357,1309,64,51,115,55.7%,20m
9275,3,RamenKage,3357,1073,62,40,102,60.8%,7m
9275,3,GrandPas,3357,1277,56,46,102,54.9%,10m
9275,3,xRay,3357,1093,47,31,78,60.3%,19m
9275,3,Woodfish,3357,1007,40,36,76,52.6%,7m
9275,3,Migui,3357,922,36,26,62,58.1%,18m
9275,3,[BHR]Khlint,3357,889,35,27,62,56.5%,37m
9275,3,Qwerty,3357,519,21,10,31,67.7%,5m
9275,3,Solo,3357,381,14,8,22,63.6%,13m
9275,2,TylerDurden,3357,241,11,5,16,68.8%,5m
9275,3,Poseidon,3357,30,2,1,3,66.7%,11m
9275,3,KroN,3357,0,1,0,1,100.0%,7m
9275,3,NewPlayer,3357,0,1,0,1,100.0%,37m
9275,3,[DoPorn]Sayux,3357,0,1,4,5,20.0%,10m
9275,3,froghunter,3357,0,1,6,7,14.3%,17m
9275,3,MrMustasch,3357,0,0,5,5,0.0%,8m
9294,3,Fab,3356,1622,368,357,725,50.8%,36m
9294,3,Reamonn,3356,1097,50,24,74,67.6%,12m
9294,3,Ryux,3356,1056,38,40,78,48.7%,12m
9294,3,DirtyCheeser,3356,541,26,12,38,68.4%,37m
9294,3,ßaha,3356,402,16,8,24,66.7%,23m
9294,3,[PŖïMĄŁ]GgMaChine,3356,284,10,17,27,37.0%,7m
9294,3,Walter,3356,97,5,2,7,71.4%,21m
9294,3,bangkock,3356,58,2,3,5,40.0%,19m
9294,3,Mish,3356,132,2,4,6,33.3%,6m
9294,3,ALI,3356,0,1,0,1,100.0%,13m
9294,3,slothdemon,3356,30,1,2,3,33.3%,36m
9294,3,[xBABAx]UnderCtrl,3356,0,0,1,1,0.0%,23m
9306,3,Gambit,3355,1550,156,151,307,50.8%,16m
9306,3,DEATH,3355,1094,111,92,203,54.7%,18m
9306,2,Hatuna,3355,958,42,47,89,47.2%,14m
9306,3,RGA,3355,847,36,27,63,57.1%,6m
9306,3,Oekel,3355,384,15,11,26,57.7%,23m
9306,3,Nawaro,3355,208,7,8,15,46.7%,9m
9306,3,ComebackKid,3355,201,6,3,9,66.7%,37m
9306,3,SunWu,3355,116,4,10,14,28.6%,12m
9306,3,iamsama,3355,30,2,1,3,66.7%,4m
9306,3,laksonen,3355,30,2,4,6,33.3%,22m
9306,3,SoYaMin,3355,0,1,0,1,100.0%,21m
9306,3,terminator,3355,0,1,1,2,50.0%,36m
9306,3,MarineHunter,3355,0,0,1,1,0.0%,10m
9306,2,NaRa,3355,0,0,9,9,0.0%,19m
9320,3,Iridium,3354,1557,198,195,393,50.4%,12m
9320,3,Lucy,3354,1447,57,61,118,48.3%,6m
9320,3,murdoc,3354,1055,47,35,82,57.3%,10m
9320,3,JazzMan,3354,914,37,30,67,55.2%,5m
9320,3,AseroPh,3354,480,23,8,31,74.2%,5m
9320,3,ICE,3354,403,18,10,28,64.3%,20m
9320,3,[WCKYLN]Mootek,3354,430,17,7,24,70.8%,22m
9320,3,Wurfyt,3354,333,17,19,36,47.2%,9m
9320,2,Orion,3354,360,15,21,36,41.7%,36m
9320,3,[xSICKx]Entedieente,3354,234,7,9,16,43.8%,11m
9320,3,AryaStark,3354,178,6,7,13,46.2%,7m
9320,3,YoUkNoWwHo,3354,112,4,8,12,33.3%,8m
9320,3,[HaT]Jaguar,3354,0,1,4,5,20.0%,21m
9320,3,EntityBlack,3354,30,1,4,5,20.0%,19m
9320,3,[MogaDa]Raisolution,3354,0,0,5,5,0.0%,11m
9335,2,Tailwind,3353,1215,345,344,689,50.1%,5m
9335,3,Cocycle,3353,1045,95,89,184,51.6%,19m
9335,3,[LdLT]Tartus,3353,1487,67,47,114,58.8%,20m
9335,3,Piratuga,3353,705,30,21,51,58.8%,7m
9335,3,IIIIIIIIIIII,3353,484,20,10,30,66.7%,12m
9335,2,reran,3353,336,11,19,30,36.7%,37m
9335,3,Đorđe,3353,0,1,0,1,100.0%,12m
9335,3,iVanhoe,3353,0,1,1,2,50.0%,10m
9335,3,CeCi,3353,30,1,3,4,25.0%,15m
9335,3,StewieGrifin,3353,30,1,9,10,10.0%,9m
9335,3,STalliN,3353,0,0,1,1,0.0%,19m
9335,3,[Pqn]AgentK,3353,0,0,2,2,0.0%,19m
9347,3,TIMES,3352,1446,89,96,185,48.1%,36m
9347,2,wwwSEOtaxi,3352,887,69,72,141,48.9%,11m
9347,2,[EBAШIM]Dark,3352,248,13,9,22,59.1%,37m
9347,1,Sardoche,3352,261,12,8,20,60.0%,6m
9347,3,[OРДА]CHUVACHOK,3352,195,11,11,22,50.0%,11m
9347,3,[сSсǃ]james,3352,114,5,0,5,100.0%,17m
9347,3,[LESBE]Bulfango,3352,114,5,0,5,100.0%,21m
9347,3,Nariako,3352,114,4,3,7,57.1%,5m
9347,3,duckspeaker,3352,62,3,4,7,42.9%,6m
9356,2,YuDeNkRicKeT,3351,1508,385,360,745,51.7%,36m
9356,3,Wuk,3351,1204,98,97,195,50.3%,7m
9356,3,Hinley,3351,1664,70,61,131,53.4%,18m
9356,3,Antaeus,3351,874,69,66,135,51.1%,18m
9356,2,Norman,3351,1173,45,50,95,47.4%,37m
9356,3,BarKot,3351,1055,44,32,76,57.9%,17m
9356,3,[0BO]Stiefe,3351,784,31,26,57,54.4%,14m
9356,3,BaNaNa,3351,498,20,24,44,45.5%,22m
9356,3,Syber,3351,504,19,19,38,50.0%,4m
9356,3,Nikitiiy,3351,378,17,7,24,70.8%,24m
9356,3,eizzii,3351,356,16,7,23,69.6%,36m
9356,2,Thur,3351,97,2,1,3,66.7%,23m
9356,3,TheOnlySimen,3351,0,1,0,1,100.0%,16m
9356,3,[B4B4]Flekx,3351,0,1,0,1,100.0%,5m
9356,3,[Deejay]TaSoeur,3351,30,1,5,6,16.7%,11m
9356,3,NikitaSmall,3351,0,1,6,7,14.3%,19m
9356,2,[Wolven]Wigge,3351,0,0,2,2,0.0%,17m
9373,2,BadBadNotGoo,3350,1601,342,340,682,50.1%,16m
9373,3,NoMore,3350,766,107,91,198,54.0%,6m
9373,3,Sarminator,3350,1026,106,91,197,53.8%,23m
9373,3,Gebex,3350,1640,86,72,158,54.4%,13m
9373,3,Milky,3350,1158,56,32,88,63.6%,5m
9373,3,FourthGate,3350,938,36,34,70,51.4%,10m
9373,3,Moridin,3350,482,19,11,30,63.3%,20m
9373,3,[Desire]ZutuZ,3350,382,17,1,18,94.4%,9m
9373,3,Fraktal,3350,328,16,7,23,69.6%,15m
9373,3,Maxy,3350,340,15,10,25,60.0%,17m
9373,1,[2MS]Nyalab,3350,96,5,1,6,83.3%,27m
9373,3,maingantée,3350,120,4,7,11,36.4%,12m
9373,3,[Cerv]Lies,3350,145,3,3,6,50.0%,9m
9373,1,KekseBaron,3350,138,2,2,4,50.0%,9m
9373,2,[МLР]AppleJack,3350,131,2,2,4,50.0%,16m
9373,3,BubbleAttack,3350,60,2,3,5,40.0%,10m
9373,3,Alucard,3350,0,2,3,5,40.0%,10m
9373,3,Power,3350,0,1,0,1,100.0%,22m
9373,3,[MkerIT]Michelino,3350,0,1,0,1,100.0%,22m
9373,3,FedosFF,3350,0,0,3,3,0.0%,5m
9393,3,[OTW6]McEvoy,3349,1607,281,230,511,55.0%,22m
9393,3,norris,3349,1492,188,178,366,51.4%,18m
9393,3,[HSofS]Xeo,3349,1456,144,123,267,53.9%,36m
9393,3,OshuGun,3349,1302,55,54,109,50.5%,36m
9393,3,Zac,3349,819,45,38,83,54.2%,36m
9393,3,Whirlm,3349,760,30,24,54,55.6%,9m
9393,3,Tassadar,3349,428,17,14,31,54.8%,37m
9393,3,Atoli,3349,282,9,3,12,75.0%,21m
9393,3,[FCSInc]JohnnyB,3349,270,9,9,18,50.0%,7m
9393,2,[Siggi]Doncabrio,3349,203,6,7,13,46.2%,15m
9393,1,Dikoi,3349,0,5,1,6,83.3%,8m
9393,3,KliP,3349,60,2,3,5,40.0%,23m
9393,3,[НОД17]chef,3349,62,2,5,7,28.6%,36m
9393,3,Chien,3349,0,1,0,1,100.0%,20m
9393,3,ElDelPLEIN,3349,0,1,0,1,100.0%,6m
9393,3,[CJFF]Laslorgen,3349,0,1,0,1,100.0%,18m
9393,3,llllllllllll,3349,30,1,2,3,33.3%,18m
9393,3,alfahsed,3349,0,1,4,5,20.0%,11m
9393,3,fAtbOyNooB,3349,0,1,7,8,12.5%,20m
9393,3,[CTP]bebe,3349,0,0,1,1,0.0%,7m
9413,3,[KDV]Adamin,3348,1476,161,149,310,51.9%,36m
9413,3,dffct,3348,1488,156,151,307,50.8%,9m
9413,3,HyperFlex,3348,1606,128,120,248,51.6%,12m
9413,3,luk,3348,751,51,49,100,51.0%,20m
9413,3,Alantreyd,3348,632,24,23,47,51.1%,37m
9413,3,[LIQUID]SheeBa,3348,299,17,6,23,73.9%,12m
9413,3,[PLDRK]combat,3348,426,16,11,27,59.3%,37m
9413,3,[POTEAU]jeipy,3348,259,9,4,13,69.2%,16m
9413,3,[SZM]DerDim,3348,192,8,6,14,57.1%,23m
9413,1,KelBalST,3348,0,1,3,4,25.0%,13m
9413,3,Dolores,3348,0,0,1,1,0.0%,22m
9424,3,[ULTX]Shadowflame,3347,1637,695,673,1368,50.8%,7m
9424,3,Tidziam,3347,974,37,42,79,46.8%,10m
9424,2,Sandro,3347,250,8,11,19,42.1%,12m
9424,3,Loli,3347,170,6,7,13,46.2%,8m
9424,3,[RTO]MannImBad,3347,120,4,6,10,40.0%,17m
9424,3,pojaba,3347,49,3,3,6,50.0%,11m
9424,3,[vincis]Ares,3347,62,2,8,10,20.0%,4m
9424,3,Mega,3347,0,1,0,1,100.0%,20m
9424,1,Query,3347,0,1,0,1,100.0%,38m
9424,3,Janis,3347,0,1,1,2,50.0%,5m
9424,3,Scroumface,3347,0,0,10,10,0.0%,7m
9435,3,lLoadl,3346,1554,156,142,298,52.3%,13m
9435,3,BliZz,3346,1536,140,133,273,51.3%,6m
9435,3,MoreauCamus,3346,678,77,73,150,51.3%,5m
9435,3,PinZar,3346,336,26,21,47,55.3%,12m
9435,3,[RanMon]Sensei,3346,363,15,10,25,60.0%,12m
9435,3,Broodmann,3346,286,12,14,26,46.2%,20m
9435,3,[BRSKR]Fishy,3346,310,12,18,30,40.0%,6m
9435,3,john,3346,176,7,4,11,63.6%,37m
9435,3,Jazzor,3346,30,2,0,2,100.0%,6m
9444,3,Sonicphi,3345,1612,191,185,376,50.8%,11m
9444,3,Sorim,3345,1193,150,131,281,53.4%,16m
9444,3,[ULTX]FeuerDrache,3345,1451,56,65,121,46.3%,6m
9444,2,hobo,3345,808,55,54,109,50.5%,19m
9444,2,RisØVaŁsHiK,3345,831,33,35,68,48.5%,15m
9444,2,Feuerwehrman,3345,367,33,43,76,43.4%,20m
9444,3,[TeamJ]moratim,3345,696,26,28,54,48.1%,14m
9444,3,Kimchijjigae,3345,537,22,12,34,64.7%,16m
9444,1,uNkind,3345,369,14,8,22,63.6%,9m
9444,3,[NODA]MarineManne,3345,228,11,6,17,64.7%,22m
9444,3,[АDV]CraZyPinGuiN,3345,274,11,6,17,64.7%,10m
9444,3,SmokeFast,3345,298,11,8,19,57.9%,36m
9444,3,tomawake,3345,334,11,17,28,39.3%,6m
9444,3,[B00M4]frosty,3345,210,8,10,18,44.4%,37m
9444,3,ELMoppo,3345,160,7,3,10,70.0%,19m
9444,1,Weezy,3345,210,7,10,17,41.2%,21m
9444,3,BigD,3345,54,2,2,4,50.0%,9m
9444,3,youthCrisis,3345,30,2,2,4,50.0%,5m
9444,3,[Iconic]PROTOE,3345,0,1,0,1,100.0%,11m
9444,3,HEBE,3345,0,0,1,1,0.0%,9m
9464,3,[Эхехе]Svintoo,3344,1495,205,195,400,51.2%,16m
9464,3,Diradas,3344,1555,108,83,191,56.5%,13m
9464,3,dirtycleric,3344,828,55,34,89,61.8%,12m
9464,3,[PLA2N]KOT,3344,344,19,12,31,61.3%,7m
9464,3,ENCEaEMIK,3344,232,17,5,22,77.3%,14m
9464,3,Sandkink,3344,272,11,6,17,64.7%,36m
9464,3,[BRSKR]Blade,3344,114,4,7,11,36.4%,6m
9464,3,zyle,3344,0,1,0,1,100.0%,19m
9464,3,Kujata,3344,0,1,1,2,50.0%,17m
9464,3,[T1TANS]Rutgervonapa,3344,0,0,5,5,0.0%,10m
9474,3,archibald,3343,1405,200,183,383,52.2%,17m
9474,3,isodor,3343,1056,160,144,304,52.6%,15m
9474,3,Serfess,3343,1619,88,78,166,53.0%,17m
9474,3,Aftershock,3343,381,58,47,105,55.2%,5m
9474,3,ShizoFF,3343,625,24,18,42,57.1%,17m
9474,3,Mallélol,3343,270,13,4,17,76.5%,5m
9474,3,Elladan,3343,234,8,12,20,40.0%,5m
9474,3,[DaFF]IIIIIIIIIIII,3343,145,4,2,6,66.7%,16m
9474,3,StOnedas,3343,86,4,4,8,50.0%,11m
9474,3,[IBCMI]DankselleR,3343,0,2,0,2,100.0%,11m
9474,1,[VKitty]ItsOkToFall,3343,85,2,0,2,100.0%,1h
9474,1,[HACKZ]Harv,3343,119,2,2,4,50.0%,18m
9474,3,Thomas,3343,0,1,0,1,100.0%,15m
9474,3,[Kicx]dale,3343,0,1,2,3,33.3%,5m
9474,3,[sfc]PsychQ,3343,0,0,1,1,0.0%,19m
9474,3,HCGSA,3343,0,0,1,1,0.0%,11m
9474,2,ReV,3343,0,0,1,1,0.0%,10m
9474,3,Malle,3343,0,0,1,1,0.0%,10m
9492,3,Мячик,3342,1593,143,127,270,53.0%,13m
9492,3,BabaUB,3342,816,40,35,75,53.3%,5m
9492,3,hadoukeeen,3342,731,32,20,52,61.5%,11m
9492,3,[PePmD]Doomdart,3342,459,26,25,51,51.0%,10m
9492,3,Taranis,3342,206,13,9,22,59.1%,36m
9492,3,[NSFWI]ElBuckez,3342,176,9,8,17,52.9%,6m
9492,2,Mpeta,3342,270,9,20,29,31.0%,22m
9492,3,[RAFVGA]Vile,3342,150,6,5,11,54.5%,7m
9492,3,SiLLY,3342,148,6,7,13,46.2%,5m
9492,3,REDalwaysHER,3342,0,3,2,5,60.0%,22m
9492,3,Halfblood,3342,60,3,2,5,60.0%,16m
9492,3,[f0rtt5]BusæÑorose,3342,97,1,2,3,33.3%,16m
9492,3,Benaab,3342,30,1,3,4,25.0%,13m
9492,3,[H3]OverDeath,3342,30,1,9,10,10.0%,17m
9492,3,Legioner,3342,0,0,2,2,0.0%,14m
9507,2,Xerxes,3341,1498,222,221,443,50.1%,16m
9507,3,Silvan,3341,1379,62,56,118,52.5%,20m
9507,3,Khaolin,3341,771,58,56,114,50.9%,3m
9507,3,Mephystofel,3341,650,24,17,41,58.5%,21m
9507,3,Solli,3341,511,20,12,32,62.5%,5m
9507,3,NoName,3341,459,20,16,36,55.6%,15m
9507,3,[RodS]Squirrel,3341,293,14,11,25,56.0%,3m
9507,3,[GTMNG]FroZeN,3341,242,9,9,18,50.0%,17m
9507,3,[PUPSIK]IsifLife,3341,30,2,1,3,66.7%,12m
9507,3,[DOKA2]Цицерон,3341,30,2,2,4,50.0%,10m
9507,3,[Z3RGML]Стас,3341,0,1,0,1,100.0%,10m
9507,3,SiteTech,3341,0,0,1,1,0.0%,5m
9519,3,SignX,3340,1502,376,371,747,50.3%,6m
9519,3,Kanter,3340,1452,135,132,267,50.6%,21m
9519,2,wekzzz,3340,792,110,94,204,53.9%,11m
9519,3,KdxE,3340,1416,62,68,130,47.7%,18m
9519,2,[HoZ]Destreza,3340,748,38,47,85,44.7%,10m
9519,3,Abbendis,3340,792,29,34,63,46.0%,10m
9519,3,chestnutcc,3340,608,24,22,46,52.2%,10m
9519,3,MacroLangelo,3340,376,15,10,25,60.0%,22m
9519,3,phforpatrick,3340,284,12,6,18,66.7%,5m
9519,3,llllllllllll,3340,272,12,8,20,60.0%,10m
9519,2,Deviant,3340,251,10,4,14,71.4%,17m
9519,3,[ePunks]LadyAzylis,3340,256,9,11,20,45.0%,6m
9519,3,[FFoHM]Footstomp,3340,0,1,0,1,100.0%,21m
9519,3,MSelfdestruc,3340,0,1,2,3,33.3%,19m
9519,3,Ryan,3340,0,0,1,1,0.0%,23m
9519,3,[ZSFF]Onnane,3340,0,0,1,1,0.0%,20m
9519,3,Light,3340,0,0,1,1,0.0%,20m
9519,3,Rafcio,3340,0,0,1,1,0.0%,14m
9537,3,Miraxle,3339,1206,235,187,422,55.7%,12m
9537,2,Abar,3339,1561,217,222,439,49.4%,3m
9537,3,Racheengel,3339,1583,93,88,181,51.4%,8m
9537,3,Itachi,3339,628,88,77,165,53.3%,14m
9537,3,Moneytalkz,3339,758,29,26,55,52.7%,23m
9537,3,Milczek,3339,502,21,18,39,53.8%,7m
9537,3,[GGB]McFlyhigh,3339,228,14,6,20,70.0%,20m
9537,3,[LFDSS]RafiX,3339,198,8,15,23,34.8%,2m
9537,3,Dmitryb,3339,248,7,14,21,33.3%,10m
9537,3,BPog,3339,30,4,3,7,57.1%,3m
9537,3,JoKer,3339,90,3,5,8,37.5%,17m
9537,3,[Soil]madOne,3339,58,2,8,10,20.0%,17m
9537,3,FruitVendor,3339,0,1,0,1,100.0%,8m
9537,3,[Poutre]Robb,3339,30,1,1,2,50.0%,8m
9537,3,[SDCB]Pilgore,3339,30,1,1,2,50.0%,3m
9537,2,Skeeter,3339,0,1,1,2,50.0%,11m
9537,3,[PhnxØp]SuperPeon,3339,0,0,1,1,0.0%,12m
9554,3,ChB,3338,1578,108,88,196,55.1%,5m
9554,3,furybass,3338,1335,81,66,147,55.1%,9m
9554,3,Maniac,3338,1266,50,46,96,52.1%,17m
9554,3,Probe,3338,564,25,17,42,59.5%,3m
9554,3,Reborn,3338,324,12,8,20,60.0%,21m
9554,3,TheMadnessOn,3338,230,9,8,17,52.9%,16m
9554,3,IIIIIIIIII,3338,298,9,10,19,47.4%,11m
9554,3,Mihawk,3338,196,8,4,12,66.7%,14m
9554,3,Mutal,3338,58,3,1,4,75.0%,10m
9554,3,[EAU]ArKu,3338,60,3,6,9,33.3%,7m
9554,3,[Anlav]Uolupukkie,3338,60,2,2,4,50.0%,10m
9554,3,[OCL2]TimoerIII,3338,0,1,0,1,100.0%,2m
9554,3,Nymoon,3338,0,1,0,1,100.0%,2m
9554,3,[NLTN]thedude,3338,30,1,1,2,50.0%,17m
9568,3,MisterBorux,3337,1553,109,102,211,51.7%,12m
9568,3,[ǂIBMǂ]Keeper,3337,1592,101,90,191,52.9%,17m
9568,3,Живчик,3337,691,36,31,67,53.7%,23m
9568,3,kumiho,3337,705,31,13,44,70.5%,21m
9568,3,Angrybird,3337,844,31,34,65,47.7%,20m
9568,3,[Cannоn]Lukas,3337,373,15,5,20,75.0%,8m
9568,3,Damandred,3337,325,12,6,18,66.7%,12m
9568,3,Electer,3337,318,11,5,16,68.8%,7m
9568,3,Lolkek,3337,238,8,12,20,40.0%,3m
9568,3,[OXF]Richielol,3337,115,7,8,15,46.7%,10m
9568,3,[Rol3kg]Jopa,3337,86,4,1,5,80.0%,23m
9568,3,Fero,3337,86,3,1,4,75.0%,22m
9568,3,iMoSBy,3337,0,1,0,1,100.0%,19m
9568,3,AragonOfWrld,3337,0,1,0,1,100.0%,18m
9568,3,Aneurysm,3337,0,1,0,1,100.0%,13m
9568,3,knecht,3337,0,1,0,1,100.0%,12m
9568,3,[C1KK]Golgoth,3337,30,1,9,10,10.0%,13m
9568,3,[forceX]Nightmare,3337,0,0,1,1,0.0%,13m
9586,3,IlIlIlIIllII,3336,1627,119,86,205,58.0%,20m
9586,3,Marvin,3336,582,74,71,145,51.0%,8m
9586,3,Dreadangel,3336,790,30,26,56,53.6%,7m
9586,3,wasted,3336,336,16,13,29,55.2%,22m
9586,3,kostyaaaaaaa,3336,340,12,9,21,57.1%,17m
9586,3,ccrazy,3336,314,12,10,22,54.5%,12m
9586,3,[Arrows]Soundwave,3336,213,7,1,8,87.5%,19m
9586,3,MAPElites,3336,58,6,2,8,75.0%,10m
9586,3,Guldan,3336,86,4,2,6,66.7%,16m
9586,3,Jimify,3336,94,4,5,9,44.4%,6m
9586,3,imBATman,3336,30,2,1,3,66.7%,16m
9586,3,Endurance,3336,60,2,5,7,28.6%,6m
9586,3,Pinzon,3336,0,1,0,1,100.0%,23m
9586,3,Kryp,3336,0,1,0,1,100.0%,17m
9586,3,Kladenx,3336,30,1,2,3,33.3%,8m
9601,3,ImbaAdepts,3335,1562,88,91,179,49.2%,22m
9601,3,izibanana,3335,853,51,45,96,53.1%,14m
9601,3,dindontetu,3335,582,40,30,70,57.1%,1m
9601,3,Legion,3335,719,32,34,66,48.5%,3m
9601,3,Pacific,3335,189,8,4,12,66.7%,5m
9601,1,[OРДА]FriendlyRUS,3335,223,7,4,11,63.6%,5m
9601,3,[Teror]DarkPrince,3335,150,6,5,11,54.5%,12m
9601,3,Pegu,3335,92,4,12,16,25.0%,10m
9601,3,[VFN]NinJa,3335,0,1,0,1,100.0%,5m
9601,3,SvArTaJuMp,3335,30,1,1,2,50.0%,13m
9601,3,Ber,3335,0,0,1,1,0.0%,22m
9601,3,[SEWP]FrostLight,3335,0,0,3,3,0.0%,13m
9613,3,IIIIIIIIIIII,3334,674,124,116,240,51.7%,2m
9613,3,III,3334,570,24,24,48,50.0%,12m
9613,3,Sunn,3334,654,23,35,58,39.7%,12m
9613,3,Ave,3334,298,12,8,20,60.0%,5m
9613,3,ProCoW,3334,254,9,10,19,47.4%,13m
9613,3,[TQUILA]AvocadoSlyer,3334,178,7,10,17,41.2%,22m
9613,3,july,3334,118,4,5,9,44.4%,16m
9613,3,TRZN,3334,0,1,0,1,100.0%,7m
9613,3,[TheLH]BurtMacklin,3334,30,1,1,2,50.0%,1m
9613,3,pengul,3334,30,1,2,3,33.3%,23m
9613,3,SliQster,3334,30,1,3,4,25.0%,1m
9613,3,[BOIZz]OneManArmy,3334,0,0,1,1,0.0%,12m
9613,3,[m3mez]Katz,3334,0,0,5,5,0.0%,10m
9626,3,kim,3333,1624,119,100,219,54.3%,17m
9626,3,[BCNE]Monter,3333,360,16,9,25,64.0%,22m
9626,3,[HBGSJR]tea,3333,388,15,15,30,50.0%,7m
9626,3,[Sin5]ASgodude,3333,264,10,14,24,41.7%,5m
9626,3,pro,3333,211,9,6,15,60.0%,10m
9626,3,PhOne,3333,0,4,1,5,80.0%,4m
9626,3,[HLORDS]LardHelmchen,3333,62,2,5,7,28.6%,3m
9626,3,Patryk,3333,0,0,1,1,0.0%,6m
9626,3,SAP,3333,0,0,1,1,0.0%,20m
9635,3,IIIIIIIIIIII,3332,1540,239,241,480,49.8%,6m
9635,2,Dragon,3332,1312,195,195,390,50.0%,10m
9635,3,Sticky,3332,1361,129,121,250,51.6%,15m
9635,3,[ThCORE]ItRainsSmile,3332,1194,80,66,146,54.8%,13m
9635,3,Speedlink,3332,935,66,61,127,52.0%,10m
9635,3,shinigami,3332,641,24,17,41,58.5%,6m
9635,3,Heartless,3332,408,19,0,19,100.0%,12m
9635,3,[ÄoB]SpiceIT,3332,388,15,18,33,45.5%,7m
9635,1,RageSkill,3332,213,8,10,18,44.4%,6m
9635,3,xiele,3332,0,3,2,5,60.0%,5m
9635,3,Gerrero,3332,60,3,2,5,60.0%,14m
9635,1,[iF]Darshu,3332,147,3,3,6,50.0%,16m
9635,3,[BoxerS]Slayer,3332,92,3,6,9,33.3%,14m
9635,3,[EZDUNK]ChthoniC,3332,30,3,6,9,33.3%,6m
9635,3,[MAS]ZWECK,3332,30,2,7,9,22.2%,23m
9635,3,lavplublankb,3332,0,1,1,2,50.0%,5m
9635,3,[PeEff]wizn,3332,0,0,3,3,0.0%,17m
9652,3,Anhedonia,3331,1578,295,282,577,51.1%,13m
9652,3,[xDOOBx]Fallope,3331,1437,59,53,112,52.7%,17m
9652,3,Darkrababa,3331,476,19,14,33,57.6%,3m
9652,1,DEFOUY,3331,304,16,5,21,76.2%,21m
9652,3,Shout,3331,500,16,29,45,35.6%,12m
9652,1,Swen,3331,309,14,8,22,63.6%,4m
9652,3,AdunSon,3331,274,10,7,17,58.8%,22m
9652,3,[SaysGG]Spark,3331,260,10,9,19,52.6%,9m
9652,3,Somoka,3331,148,7,2,9,77.8%,5m
9652,3,[FYBF]Wander,3331,220,6,10,16,37.5%,20m
9652,3,Shinluu,3331,146,5,4,9,55.6%,16m
9652,3,MrBaneling,3331,90,4,2,6,66.7%,12m
9652,1,Fyodor,3331,97,2,0,2,100.0%,9m
9652,3,[Repeat]BrokenArrow,3331,58,2,1,3,66.7%,10m
9652,3,NIHONIUM,3331,62,2,10,12,16.7%,2m
9652,3,[FKSD]Yogakinosifu,3331,0,1,0,1,100.0%,14m
9652,3,[LNGg]Netsuai,3331,0,0,5,5,0.0%,8m
9669,3,ChevChelios,3330,1528,126,121,247,51.0%,17m
9669,3,Cancel,3330,1164,113,89,202,55.9%,11m
9669,3,Ulf,3330,1104,96,73,169,56.8%,10m
9669,3,VOODOO,3330,768,86,60,146,58.9%,7m
9669,3,overlord,3330,1257,83,88,171,48.5%,13m
9669,3,Antimirus,3330,917,59,49,108,54.6%,14m
9669,3,Released,3330,960,36,35,71,50.7%,7m
9669,3,Aurenen,3330,645,33,24,57,57.9%,21m
9669,3,moxilo,3330,637,29,16,45,64.4%,5m
9669,3,[RedFmm]Zilord,3330,620,26,17,43,60.5%,6m
9669,3,Probius,3330,601,25,15,40,62.5%,22m
9669,3,ingain,3330,498,18,15,33,54.5%,5m
9669,3,Reiko,3330,331,15,7,22,68.2%,21m
9669,3,ScIIAvenger,3330,332,13,11,24,54.2%,5m
9669,3,llllllllllll,3330,322,12,14,26,46.2%,10m
9669,3,SenseiSidon,3330,90,4,2,6,66.7%,8m
9669,3,WudiByFang,3330,30,1,1,2,50.0%,16m
9669,3,Smallies,3330,0,1,5,6,16.7%,15m
9669,3,[ZelF]Wolfik,3330,0,0,3,3,0.0%,1m
9688,3,NirvanaFox,3329,1556,298,299,597,49.9%,2m
9688,2,Voivoda,3329,1499,206,207,413,49.9%,19m
9688,3,Dema,3329,958,41,32,73,56.2%,6m
9688,3,Dumbledore,3329,574,23,18,41,56.1%,3m
9688,3,IIIIIIIIII,3329,509,22,7,29,75.9%,21m
9688,3,NautiLus,3329,614,20,29,49,40.8%,3m
9688,3,Grinya,3329,464,19,22,41,46.3%,6m
9688,3,harbinger,3329,384,15,10,25,60.0%,18m
9688,3,KenAdams,3329,264,15,10,25,60.0%,9m
9688,3,DarrowCZ,3329,242,8,12,20,40.0%,10m
9688,3,Charlotje,3329,154,7,3,10,70.0%,14m
9688,3,Copinou,3329,183,6,6,12,50.0%,22m
9688,3,Artanis,3329,0,4,1,5,80.0%,10m
9688,3,IIIIIIIIIIII,3329,0,1,0,1,100.0%,2m
9702,3,MacroPolo,3328,1555,127,133,260,48.8%,8m
9702,2,[ioStuN]Ricor,3328,1473,108,119,227,47.6%,4m
9702,3,NoMad,3328,1363,62,61,123,50.4%,5m
9702,3,APMeighty,3328,734,56,45,101,55.4%,8m
9702,3,Kazael,3328,746,37,39,76,48.7%,21m
9702,3,Matrix,3328,491,18,12,30,60.0%,20m
9702,3,Masterok,3328,314,15,5,20,75.0%,11m
9702,3,ALEX,3328,221,9,4,13,69.2%,21m
9702,3,jagdsaison,3328,184,9,4,13,69.2%,17m
9702,3,Xaldrion,3328,199,7,7,14,50.0%,6m
9702,3,Troligt,3328,60,4,6,10,40.0%,17m
9702,3,[NaCl6]BBB,3328,94,4,7,11,36.4%,1m
9702,3,Drullen,3328,0,1,0,1,100.0%,19m
9702,1,niu,3328,0,1,0,1,100.0%,2m
9702,3,[AoTu]Yellowio,3328,0,1,3,4,25.0%,21m
9702,3,Basipooh,3328,0,0,1,1,0.0%,20m
9718,3,Rafa,3327,481,94,83,177,53.1%,17m
9718,3,Joda,3327,1376,58,42,100,58.0%,18m
9718,3,Melrion,3327,956,53,53,106,50.0%,12m
9718,2,[A11]SkillLesS,3327,839,31,38,69,44.9%,1m
9718,3,[Hydrа]Kaspiec,3327,669,25,18,43,58.1%,8m
9718,3,starman,3327,648,23,25,48,47.9%,17m
9718,3,KamIdZu,3327,276,11,8,19,57.9%,16m
9718,3,RAYITO,3327,294,11,11,22,50.0%,5m
9718,3,Chimera,3327,312,11,13,24,45.8%,12m
9718,3,KtrE,3327,338,11,24,35,31.4%,20m
9718,3,[LSPs]peKe,3327,120,5,7,12,41.7%,3m
9718,3,[eWoKs]Shivan,3327,94,3,7,10,30.0%,20m
9718,3,Apostol,3327,43,2,2,4,50.0%,9m
9718,3,Cvoky,3327,72,2,5,7,28.6%,12m
9718,3,Amrab,3327,0,0,1,1,0.0%,6m
9718,3,Zallat,3327,0,0,2,2,0.0%,5m
9734,3,[ZeBu]Leon,3326,1476,125,130,255,49.0%,20m
9734,2,Murazul,3326,398,125,131,256,48.8%,20m
9734,3,Deico,3326,1507,103,106,209,49.3%,23m
9734,2,Räminator,3326,1254,81,77,158,51.3%,20m
9734,3,[fam1ly]KinpachLordX,3326,790,45,23,68,66.2%,6m
9734,3,mäx,3326,366,18,7,25,72.0%,1m
9734,3,GruenGut,3326,382,14,5,19,73.7%,21m
9734,3,Blueone,3326,356,12,14,26,46.2%,14m
9734,3,Cotovich,3326,286,10,8,18,55.6%,16m
9734,1,Europa,3326,250,9,6,15,60.0%,4m
9734,3,[RSyn]Simdawg,3326,147,8,3,11,72.7%,21m
9734,3,WTF,3326,171,8,4,12,66.7%,3m
9734,3,[IceHus]Global,3326,167,5,1,6,83.3%,10m
9734,2,Malo,3326,133,2,2,4,50.0%,23m
9734,3,[Sc2SG]predator,3326,0,0,1,1,0.0%,17m
9734,3,FrAnTiC,3326,0,0,2,2,0.0%,10m
9750,3,Argonauta,3325,1320,105,97,202,52.0%,5m
9750,3,[BHA]nVy,3325,924,61,53,114,53.5%,20m
9750,3,IIIIIIIIII,3325,960,38,36,74,51.4%,19m
9750,3,Gandilaf,3325,756,30,22,52,57.7%,10m
9750,3,SoulStranger,3325,579,23,19,42,54.8%,23m
9750,3,GawrGura,3325,572,22,21,43,51.2%,7m
9750,3,Chemenem,3325,343,17,9,26,65.4%,3m
9750,3,Arkor,3325,400,15,19,34,44.1%,3m
9750,1,Rocky,3325,192,8,3,11,72.7%,15m
9750,3,Deroco,3325,154,6,6,12,50.0%,8m
9750,3,[LALKI]kochevnik,3325,92,4,8,12,33.3%,10m
9750,1,SICK,3325,162,3,5,8,37.5%,15m
9750,3,JAJA,3325,30,2,1,3,66.7%,9m
9750,3,[3rm5]RebornJedi,3325,30,1,3,4,25.0%,8m
9750,3,Kikounousse,3325,0,0,3,3,0.0%,17m
9765,3,Lightofday,3324,1560,259,238,497,52.1%,10m
9765,2,julio,3324,1463,214,208,422,50.7%,16m
9765,3,Deadwood,3324,1030,166,126,292,56.8%,23m
9765,3,hastrubal,3324,1540,130,126,256,50.8%,4m
9765,3,Ilmenite,3324,191,18,16,34,52.9%,13m
9765,3,[Fthfl]Tennoio,3324,168,17,23,40,42.5%,12m
9765,3,[uCHAD]denalekis,3324,376,15,13,28,53.6%,16m
9765,3,fatishmatish,3324,174,10,5,15,66.7%,9m
9765,3,trotsky,3324,206,7,8,15,46.7%,1m
9765,3,[oGDo]IIIIIIIIIIII,3324,36,2,0,2,100.0%,9m
9765,3,[420THC]Jesper,3324,58,2,1,3,66.7%,14m
9765,3,Evgeni,3324,0,0,1,1,0.0%,10m
9765,3,[WiWoBl]oOVaDeROo,3324,0,0,5,5,0.0%,23m
9778,3,[ReSw]Muronordan,3323,1359,70,67,137,51.1%,13m
9778,3,VoidWanderer,3323,1385,57,46,103,55.3%,17m
9778,3,[0G]Xyusin,3323,974,44,29,73,60.3%,22m
9778,3,Coriis,3323,701,31,14,45,68.9%,15m
9778,3,Donkey,3323,488,23,14,37,62.2%,6m
9778,3,[HOMIS]Dododream,3323,246,20,20,40,50.0%,14m
9778,3,StahanFX,3323,570,20,27,47,42.6%,15m
9778,3,[ENQ]Yarxxxnov,3323,483,18,13,31,58.1%,17m
9778,3,RSyfer,3323,200,7,6,13,53.8%,20m
9778,3,FaKer,3323,30,6,3,9,66.7%,14m
9778,3,[GTHQ]kaidzi,3323,148,5,11,16,31.2%,17m
9778,3,IIIIIIIIIIII,3323,86,4,9,13,30.8%,6m
9778,3,Damuros,3323,86,3,3,6,50.0%,3m
9778,3,Dhjon,3323,58,3,4,7,42.9%,17m
9778,3,any,3323,121,2,8,10,20.0%,5m
9778,3,[8000ms]XiaoY,3323,0,0,1,1,0.0%,7m
9794,3,Omnisailor,3322,1422,130,108,238,54.6%,21m
9794,3,Doppelganger,3322,1203,81,68,149,54.4%,1m
9794,3,Mimistra,3322,463,21,25,46,45.7%,10m
9794,3,Gaston,3322,504,20,16,36,55.6%,14m
9794,3,Zzenith,3322,532,20,17,37,54.1%,5m
9794,3,formatC,3322,296,15,5,20,75.0%,10m
9794,3,Innozenz,3322,221,11,7,18,61.1%,13m
9794,3,[Rebеls]vpmail,3322,198,8,4,12,66.7%,6m
9794,3,Conquistador,3322,222,8,6,14,57.1%,14m
9794,3,[Kicx]Cimiur,3322,70,6,10,16,37.5%,14m
9794,3,Shagrim,3322,186,6,14,20,30.0%,3m
9794,2,Apex,3322,0,4,1,5,80.0%,1h
9794,3,[nWss]Sugardispens,3322,58,3,7,10,30.0%,1m
9794,3,[Picior]ProtossAlinn,3322,60,2,3,5,40.0%,18m
9794,3,[DutchG]Zazop,3322,0,0,1,1,0.0%,10m
9794,3,llllllllllll,3322,0,0,1,1,0.0%,18m
9794,3,[ЕМPIRE]IIIIIIIIIIII,3322,0,0,1,1,0.0%,13m
9811,2,Devil,3321,1591,416,426,842,49.4%,10m
9811,2,Persias,3321,1135,184,187,371,49.6%,6m
9811,3,Nicks,3321,1630,131,124,255,51.4%,23m
9811,3,gal,3321,1524,119,127,246,48.4%,13m
9811,3,INOX,3321,685,49,49,98,50.0%,1m
9811,3,[DМG]BerryBee,3321,901,36,42,78,46.2%,5m
9811,3,[DIRSTK]JaySin,3321,786,32,24,56,57.1%,3m
9811,3,[mTx]Sipa,3321,373,15,13,28,53.6%,12m
9811,1,[SWJTU]KZGamingXY,3321,168,7,3,10,70.0%,30m
9811,3,XelNaga,3321,204,7,11,18,38.9%,14m
9811,3,EdemaRuh,3321,178,7,12,19,36.8%,6m
9811,3,maj,3321,182,6,16,22,27.3%,15m
9811,1,ShadowEagle,3321,184,5,1,6,83.3%,16m
9811,2,Roobi,3321,128,2,1,3,66.7%,11m
9811,3,Mentor,3321,18,2,2,4,50.0%,7m
9811,3,firgli,3321,30,2,4,6,33.3%,10m
9811,3,[TokeB]Daffe,3321,0,1,0,1,100.0%,18m
9828,3,albinxnaruto,3320,1545,225,217,442,50.9%,3m
9828,3,Fate,3320,1086,161,146,307,52.4%,20m
9828,3,[BO55]Simbarto,3320,1609,102,76,178,57.3%,5m
9828,3,redline,3320,1433,65,59,124,52.4%,2m
9828,3,[Fast43]BUUUUNT,3320,925,36,28,64,56.2%,6m
9828,3,BBQmaker,3320,323,35,38,73,47.9%,10m
9828,3,KEVtheBRAVE,3320,776,27,35,62,43.5%,9m
9828,3,[Zelos]Aegir,3320,466,20,14,34,58.8%,10m
9828,3,[CD1998]ConZec,3320,300,18,15,33,54.5%,1m
9828,3,Orphelin,3320,129,17,12,29,58.6%,18m
9828,3,EnerVation,3320,348,12,13,25,48.0%,18m
9828,3,Relapse,3320,0,0,4,4,0.0%,19m
9840,2,Evstifei,3319,1458,222,215,437,50.8%,14m
9840,2,VanNostrand,3319,1426,190,191,381,49.9%,8m
9840,3,mellonSan,3319,1397,176,173,349,50.4%,5m
9840,3,Lexa,3319,1592,156,157,313,49.8%,5m
9840,3,noti,3319,1235,109,106,215,50.7%,6m
9840,3,GoFMido,3319,933,56,31,87,64.4%,23m
9840,3,Gladiator,3319,1178,43,47,90,47.8%,21m
9840,3,Edelweiss,3319,1080,41,40,81,50.6%,20m
9840,3,Number,3319,946,34,39,73,46.6%,17m
9840,3,Kata,3319,329,14,8,22,63.6%,13m
9840,1,DraKoN,3319,118,6,2,8,75.0%,5m
9840,2,lhogI,3319,88,6,3,9,66.7%,13m
9840,3,[ClubR]Pet,3319,60,3,3,6,50.0%,12m
9840,3,Crokou,3319,42,3,7,10,30.0%,4m
9840,3,SadLobster,3319,30,2,0,2,100.0%,5m
9840,3,ProZiemniak,3319,97,2,0,2,100.0%,16m
9840,3,[BRSKR]firendted,3319,30,2,4,6,33.3%,23m
9840,3,apex,3319,0,1,0,1,100.0%,16m
9840,3,[SÐ]Poulpator,3319,0,1,0,1,100.0%,14m
9840,3,Niobros,3319,0,1,0,1,100.0%,13m
9840,3,æon,3319,0,1,0,1,100.0%,12m
9840,3,[DarS]Fourtwo,3319,30,1,1,2,50.0%,7m
9840,1,MrPink,3319,96,1,1,2,50.0%,15m
9840,3,[skate]helpy,3319,30,1,2,3,33.3%,22m
9840,3,DABO,3319,0,1,4,5,20.0%,22m
9840,3,NeoBlade,3319,0,0,1,1,0.0%,10m
9866,3,LLuisYK,3318,1655,209,199,408,51.2%,14m
9866,3,captainsepp,3318,1260,104,89,193,53.9%,10m
9866,3,Faid,3318,1325,85,81,166,51.2%,5m
9866,3,Neepko,3318,986,70,46,116,60.3%,18m
9866,3,[RSPD]denchik,3318,1364,70,51,121,57.9%,13m
9866,3,[Heroes]pavele,3318,1402,67,68,135,49.6%,1m
9866,3,[Dragen]STERBANS,3318,728,29,26,55,52.7%,10m
9866,3,[PulS]kéké,3318,531,27,26,53,50.9%,20m
9866,3,Nakata,3318,560,26,25,51,51.0%,10m
9866,3,[HZeS]LordTaldarim,3318,228,9,4,13,69.2%,16m
9866,2,BunkerBuster,3318,96,5,1,6,83.3%,28m
9866,3,Vasec,3318,30,1,8,9,11.1%,6m
9866,3,Shjno,3318,0,0,1,1,0.0%,12m
9879,3,[GoldM]Cemzx,3317,1505,172,162,334,51.5%,2m
9879,3,IsleOfManTT,3317,1526,150,162,312,48.1%,3m
9879,3,NevrHadUrCar,3317,766,68,59,127,53.5%,23m
9879,3,StrYga,3317,798,48,49,97,49.5%,2m
9879,3,Beijos,3317,1092,40,41,81,49.4%,18m
9879,3,kiselewspb,3317,1119,40,49,89,44.9%,6m
9879,3,Nobody,3317,678,23,30,53,43.4%,5m
9879,3,Ultramarine,3317,464,19,14,33,57.6%,18m
9879,3,Luckynick,3317,478,18,15,33,54.5%,6m
9879,3,ClownFiesta,3317,368,11,16,27,40.7%,18m
9879,3,glandosaure,3317,240,8,12,20,40.0%,21m
9879,3,[Heroes]Rubedo,3317,118,5,4,9,55.6%,7m
9879,3,Kinnicoun,3317,120,5,6,11,45.5%,7m
9879,3,dimaga,3317,0,1,1,2,50.0%,10m
9879,3,[Z3RG7V]VoidX,3317,0,0,2,2,0.0%,23m
9894,3,[TSC2C]KlimovRI,3316,1594,144,104,248,58.1%,15m
9894,3,RaptorII,3316,871,65,55,120,54.2%,5m
9894,3,[ЯD]Prospect,3316,757,29,31,60,48.3%,9m
9894,3,AeonOfStrife,3316,579,21,15,36,58.3%,16m
9894,3,MenTosS,3316,308,11,19,30,36.7%,20m
9894,3,qoi,3316,184,7,4,11,63.6%,19m
9894,3,celdomnec,3316,30,2,1,3,66.7%,6m
9894,3,MadaraMc,3316,0,1,2,3,33.3%,2m
9894,1,Mindblaster,3316,0,0,1,1,0.0%,42m
9894,3,[IceHus]Vadu,3316,0,0,1,1,0.0%,6m
9904,2,[ЖопоАд]weststorm,3315,1542,313,288,601,52.1%,6m
9904,3,Erhard,3315,1561,228,226,454,50.2%,21m
9904,3,Select,3315,1641,142,133,275,51.6%,8m
9904,3,[IceHus]mihaha,3315,1433,100,85,185,54.1%,6m
9904,3,Hirich,3315,1618,81,61,142,57.0%,23m
9904,3,RitUga,3315,1512,61,48,109,56.0%,6m
9904,3,Kaillas,3315,1051,60,45,105,57.1%,3m
9904,2,XaPyZaTnik,3315,1380,48,59,107,44.9%,11m
9904,3,inlieben,3315,697,29,22,51,56.9%,3m
9904,3,hariseldon,3315,542,21,14,35,60.0%,17m
9904,3,louiz,3315,316,12,9,21,57.1%,3m
9904,3,Numinor,3315,114,5,1,6,83.3%,12m
9904,3,[Klawo]Ver,3315,58,3,0,3,100.0%,20m
9904,3,[EZPTS]Rizo,3315,58,3,3,6,50.0%,13m
9904,3,[DML]Atombombe,3315,88,3,3,6,50.0%,13m
9904,3,BEETLEHORSE,3315,30,2,0,2,100.0%,9m
9904,3,[12SKT1]HERO,3315,30,2,2,4,50.0%,20m
9904,3,[666999]zwitfires,3315,0,1,0,1,100.0%,13m
9904,3,[Sparky]Atlantic,3315,0,1,0,1,100.0%,17m
9904,3,TheBrat,3315,0,1,0,1,100.0%,8m
9904,3,betrayal,3315,0,1,5,6,16.7%,17m
9904,2,Skillszero,3315,94,1,6,7,14.3%,5m
9904,3,Freeman,3315,0,0,2,2,0.0%,18m
9927,2,Adri,3314,1337,144,151,295,48.8%,13m
9927,3,[KIEL]PillowLava,3314,954,138,139,277,49.8%,13m
9927,3,[ZN]Manwe,3314,908,86,78,164,52.4%,12m
9927,3,navistone,3314,1495,80,75,155,51.6%,12m
9927,3,Nuada,3314,1152,47,43,90,52.2%,10m
9927,3,[TWGs]Rainbowdash,3314,1016,39,38,77,50.6%,16m
9927,3,Nightylion,3314,1006,39,43,82,47.6%,6m
9927,3,NeverRush,3314,405,17,10,27,63.0%,21m
9927,3,NioZ,3314,265,14,3,17,82.4%,12m
9927,3,[30cm]Annubis,3314,312,10,13,23,43.5%,3m
9927,3,Wave,3314,198,7,11,18,38.9%,20m
9927,3,azz,3314,189,6,8,14,42.9%,7m
9927,3,Spekkio,3314,90,3,4,7,42.9%,22m
9927,1,blackbear,3314,0,1,0,1,100.0%,1h
9927,3,JustCasual,3314,0,1,0,1,100.0%,13m
9927,2,TwistedHyo,3314,0,1,1,2,50.0%,33m
9927,3,[G4C]TemarOP,3314,0,0,1,1,0.0%,15m
9927,3,llllll,3314,0,0,4,4,0.0%,13m
9927,2,OMA,3314,0,0,5,5,0.0%,1h
9946,3,ITишник,3313,305,24,10,34,70.6%,23m
9946,3,Alan,3313,483,21,23,44,47.7%,1m
9946,3,Fistalk,3313,430,18,5,23,78.3%,10m
9946,3,[NaNii]Balrog,3313,455,18,18,36,50.0%,10m
9946,3,Liken,3313,458,16,11,27,59.3%,7m
9946,3,Striker,3313,168,8,4,12,66.7%,18m
9946,3,Mystogan,3313,128,6,2,8,75.0%,9m
9946,3,Spring,3313,146,6,5,11,54.5%,6m
9946,2,[øiø]BloodWings,3313,172,6,7,13,46.2%,3m
9946,3,[Kingz]Dream,3313,86,3,3,6,50.0%,15m
9946,1,FeorgeGloyd,3313,0,2,5,7,28.6%,42m
9946,3,[CloudR]Syoerlman,3313,0,1,0,1,100.0%,5m
9946,3,Drinki,3313,0,0,1,1,0.0%,13m
9946,3,Cibernetic,3313,0,0,1,1,0.0%,2m
9946,3,DarHaz,3313,0,0,1,1,0.0%,23m
9946,3,XSC,3313,0,0,1,1,0.0%,10m
9946,3,SouLEateR,3313,0,0,2,2,0.0%,14m
9946,3,Quacko,3313,0,0,2,2,0.0%,8m
9964,2,nerazzurribg,3312,1003,259,256,515,50.3%,8m
9964,3,mrRed,3312,1416,250,253,503,49.7%,3m
9964,3,XERXES,3312,1534,241,239,480,50.2%,22m
9964,3,Kirov,3312,600,119,107,226,52.7%,3m
9964,3,OstrichO,3312,1047,56,58,114,49.1%,9m
9964,3,Panda,3312,1298,48,51,99,48.5%,13m
9964,3,Liatis,3312,362,13,18,31,41.9%,16m
9964,3,heat,3312,334,12,12,24,50.0%,10m
9964,3,Ogukuo,3312,336,12,23,35,34.3%,23m
9964,3,Strategy,3312,245,11,6,17,64.7%,9m
9964,3,Admik,3312,209,10,11,21,47.6%,10m
9964,3,Fadroma,3312,196,7,5,12,58.3%,6m
9964,3,lIIlIIlIlllI,3312,182,6,8,14,42.9%,9m
9964,3,Anakin,3312,60,2,7,9,22.2%,13m
9964,3,[ZERGTV]STALKER,3312,0,1,0,1,100.0%,17m
9964,3,Fork,3312,0,1,1,2,50.0%,3m
9964,3,Zyiann,3312,0,1,1,2,50.0%,11m
9981,2,rin,3311,1526,223,212,435,51.3%,11m
9981,3,Holodreampt,3311,1143,103,86,189,54.5%,22m
9981,3,[ARBY]Technobabble,3311,1174,78,61,139,56.1%,2m
9981,3,llllllllllll,3311,1063,43,40,83,51.8%,3m
9981,3,[Ba2c]Zitoine,3311,187,12,8,20,60.0%,20m
9981,3,[MulTi]Ytabil,3311,175,10,6,16,62.5%,12m
9981,3,jokerSG,3311,192,7,5,12,58.3%,16m
9981,3,Bubu,3311,114,5,1,6,83.3%,3m
9981,3,[ДИЧЬ]LVOkiller,3311,0,1,0,1,100.0%,20m
9981,3,qqas,3311,0,1,0,1,100.0%,22m
9981,3,Yoda,3311,0,0,1,1,0.0%,3m
9981,3,jffun,3311,0,0,1,1,0.0%,3m
9993,2,serendir,3310,601,105,106,211,49.8%,13m
9993,3,Armageddom,3310,479,69,70,139,49.6%,1m
9993,3,Troublemaker,3310,1299,50,62,112,44.6%,23m
9993,3,Tekkers,3310,188,22,11,33,66.7%,7m
9993,3,Nibku,3310,372,13,15,28,46.4%,3m
9993,3,Laurus,3310,326,12,10,22,54.5%,3m
9993,3,valithor,3310,233,10,3,13,76.9%,13m
9993,3,[gSub]Dem,3310,169,9,3,12,75.0%,22m
9993,3,zNEUSz,3310,198,8,9,17,47.1%,15m
9993,3,[JustFF]Itarossa,3310,86,4,0,4,100.0%,16m
9993,3,Tinuviel,3310,0,4,1,5,80.0%,17m
9993,3,TVister,3310,81,4,5,9,44.4%,10m
9993,3,[Floren]Zape,3310,0,3,2,5,60.0%,12m
9993,3,Breb,3310,86,3,5,8,37.5%,9m
9993,3,Cemar,3310,30,2,1,3,66.7%,10m
9993,3,[LОLI]tabletochka,3310,0,1,0,1,100.0%,10m
9993,3,[CNC3]Motorrunner,3310,0,1,4,5,20.0%,21m
9993,2,[ÆR]sephistoeu,3310,44,1,6,7,14.3%,21m
9993,2,[MSUSC2]eferalgan,3310,0,0,1,1,0.0%,13m
9993,3,Hellscream,3310,0,0,1,1,0.0%,5m
9993,3,Redness,3310,0,0,1,1,0.0%,14m
10014,3,nOOdles,3309,1307,149,119,268,55.6%,1m
10014,3,Mickey,3309,752,147,139,286,51.4%,15m
10014,3,Nevertheless,3309,1309,83,72,155,53.5%,18m
10014,2,Reshi,3309,1465,74,71,145,51.0%,1m
10014,2,[HTR57]Bölzer,3309,1552,73,74,147,49.7%,13m
10014,3,Noxm,3309,787,55,41,96,57.3%,17m
10014,3,Stalin,3309,290,50,32,82,61.0%,1m
10014,3,wiki,3309,836,37,24,61,60.7%,9m
10014,3,[skltn]xamdunord,3309,944,36,37,73,49.3%,14m
10014,3,Rvach,3309,874,34,27,61,55.7%,16m
10014,3,Zolano,3309,379,16,15,31,51.6%,22m
10014,3,[Овощи]Cyrax,3309,315,12,17,29,41.4%,9m
10014,3,[NKSR]Niran,3309,202,7,6,13,53.8%,3m
10014,3,ТоссNotImba,3309,174,7,11,18,38.9%,10m
10014,3,Ichigo,3309,0,2,3,5,40.0%,17m
10014,3,Exontrios,3309,0,0,1,1,0.0%,10m
10014,3,[EмŦS]word,3309,0,0,1,1,0.0%,16m
10031,3,[2vs2v3]Blagovest,3308,1576,100,90,190,52.6%,22m
10031,2,bunshichi,3308,730,86,95,181,47.5%,12m
10031,3,[Tusky]mexorcist,3308,862,77,51,128,60.2%,23m
10031,3,Plaetean,3308,901,76,60,136,55.9%,17m
10031,3,Mnsk,3308,723,33,24,57,57.9%,13m
10031,3,[Пчелки]ГоловaчЛенa,3308,547,22,12,34,64.7%,2m
10031,3,[FOKU]vulture,3308,468,18,14,32,56.2%,9m
10031,3,BlumBlum,3308,440,16,15,31,51.6%,21m
10031,3,Krtos,3308,348,14,16,30,46.7%,6m
10031,3,[PaniC]BeMole,3308,192,7,4,11,63.6%,22m
10031,3,PandaJ,3308,114,5,1,6,83.3%,6m
10031,3,[NepNep]Planeptune,3308,0,3,2,5,60.0%,6m
10031,3,IIIIIIIIIIII,3308,60,3,2,5,60.0%,18m
10031,3,Luyi,3308,58,2,2,4,50.0%,8m
10031,3,sceid,3308,0,1,0,1,100.0%,22m
10031,3,Dingleberrie,3308,0,1,1,2,50.0%,3m
10031,3,BIGMAK,3308,0,0,4,4,0.0%,21m
10048,3,[TEDF]Tagazox,3307,1342,199,185,384,51.8%,9m
10048,3,Sam,3307,1465,192,184,376,51.1%,8m
10048,3,[Exis]Кастиил,3307,724,54,39,93,58.1%,7m
10048,3,[EVOLVE]Erlendo,3307,378,20,15,35,57.1%,5m
10048,3,Nevith,3307,172,16,19,35,45.7%,5m
10048,3,ErrorFix,3307,438,15,19,34,44.1%,13m
10048,3,[NerCC]gewinner,3307,86,3,4,7,42.9%,12m
10048,3,costin,3307,118,2,1,3,66.7%,22m
10048,3,FADIMUH,3307,58,2,2,4,50.0%,7m
10048,3,[ІDDQD]BFG,3307,58,2,3,5,40.0%,7m
10048,3,Sothoth,3307,58,2,4,6,33.3%,20m
10048,3,grrr,3307,0,1,1,2,50.0%,20m
10048,3,[LaPaCa]Shyl,3307,30,1,2,3,33.3%,13m
10048,3,bloss,3307,0,0,1,1,0.0%,15m
10048,1,Leech,3307,0,0,5,5,0.0%,1m
10063,2,[GTD]GTDbaLLer,3306,985,320,323,643,49.8%,19m
10063,3,[5Packs]NeoHermes,3306,1297,164,153,317,51.7%,8m
10063,3,HappyMaumau,3306,872,57,40,97,58.8%,22m
10063,3,Vipo,3306,337,36,27,63,57.1%,22m
10063,3,[Golum]Vourgade,3306,790,31,27,58,53.4%,10m
10063,3,DrillLing,3306,322,12,8,20,60.0%,17m
10063,2,Leonard,3306,257,11,6,17,64.7%,17m
10063,3,Phoenix,3306,314,11,8,19,57.9%,2m
10063,2,Ganya,3306,212,7,4,11,63.6%,22m
10063,3,SkyLie,3306,86,4,1,5,80.0%,6m
10063,3,AlejandroXXI,3306,116,4,5,9,44.4%,6m
10063,3,[PANPR]Kohlrabi,3306,30,2,0,2,100.0%,10m
10063,3,[Laim]DavyJones,3306,0,1,0,1,100.0%,8m
10063,3,[MLFCG]Blasti,3306,0,0,1,1,0.0%,22m
10063,3,DuMIIJIc,3306,0,0,1,1,0.0%,20m
10063,3,iFuTeysson,3306,0,0,1,1,0.0%,16m
10079,3,PERAL,3305,1565,173,162,335,51.6%,7m
10079,3,None,3305,1629,157,150,307,51.1%,8m
10079,3,Предвестик,3305,1280,109,103,212,51.4%,3m
10079,2,[Dobro]OneHandor,3305,934,33,48,81,40.7%,16m
10079,3,Skriming,3305,400,17,13,30,56.7%,21m
10079,3,[2M1B]ZIBAR,3305,249,11,5,16,68.8%,4m
10079,3,[Z3RGML]Crush,3305,290,11,6,17,64.7%,13m
10079,3,[ICYFAR]Blodzil,3305,109,3,1,4,75.0%,23m
10079,3,[RBP3]Zli,3305,58,3,2,5,60.0%,2m
10079,3,Ramuk,3305,58,2,1,3,66.7%,16m
10079,3,[BARJO]Maximus,3305,0,1,5,6,16.7%,18m
10090,3,[Донный]Elf,3304,1613,351,327,678,51.8%,10m
10090,3,Behavioriste,3304,1508,199,193,392,50.8%,17m
10090,3,Roggenmehl,3304,1456,112,105,217,51.6%,18m
10090,3,[EFA]pRo,3304,830,105,90,195,53.8%,5m
10090,3,bater,3304,1086,49,36,85,57.6%,12m
10090,3,Eridanus,3304,815,36,31,67,53.7%,12m
10090,3,Kizzu,3304,316,12,18,30,40.0%,6m
10090,3,Doruta,3304,243,10,5,15,66.7%,6m
10090,3,btee,3304,58,2,2,4,50.0%,18m
10090,3,[dEbE]LilNeeb,3304,0,1,0,1,100.0%,16m
10090,2,[ialm]adelante,3304,0,1,0,1,100.0%,2m
10090,3,[SC2ERZ]McMuff,3304,0,0,1,1,0.0%,23m
10090,3,Einsteinium,3304,0,0,1,1,0.0%,3m
10090,2,Nameless,3304,0,0,1,1,0.0%,19m
10090,3,Asgard,3304,0,0,3,3,0.0%,12m
10105,3,Goderin,3303,1583,252,243,495,50.9%,6m
10105,3,vld,3303,1191,67,37,104,64.4%,10m
10105,1,GForceFusion,3303,359,13,7,20,65.0%,17m
10105,3,ARKUDA,3303,279,11,10,21,52.4%,2m
10105,3,PankoLucky,3303,173,8,3,11,72.7%,6m
10105,3,Senik,3303,133,7,4,11,63.6%,20m
10105,3,Tarantula,3303,196,7,6,13,53.8%,21m
10105,3,[McTosh]RalleB,3303,118,6,2,8,75.0%,22m
10105,3,Jhd,3303,138,6,19,25,24.0%,3m
10105,3,epX,3303,88,4,1,5,80.0%,10m
10105,3,TickTockGod,3303,58,2,6,8,25.0%,3m
10105,3,HolyPenguin,3303,0,1,1,2,50.0%,3m
10105,3,Taonos,3303,30,1,2,3,33.3%,12m
10105,3,Qwan,3303,0,0,1,1,0.0%,13m
10105,3,[ØC]Legend,3303,0,0,2,2,0.0%,18m
10105,3,EldorR,3303,0,0,2,2,0.0%,20m
10105,3,[CrBees]Fighter,3303,0,0,2,2,0.0%,16m
10105,3,ВГлазДать,3303,0,0,2,2,0.0%,23m
10123,3,[M2]Rascal,3302,959,207,200,407,50.9%,13m
10123,3,Salvage,3302,1625,149,136,285,52.3%,3m
10123,3,marain,3302,1582,80,79,159,50.3%,8m
10123,3,SyphoniX,3302,1425,79,67,146,54.1%,14m
10123,3,[lightt]light,3302,848,51,42,93,54.8%,23m
10123,3,NazareT,3302,1011,45,26,71,63.4%,10m
10123,3,[NL1337]TZCTIFX,3302,735,38,35,73,52.1%,8m
10123,3,Kinker,3302,828,32,29,61,52.5%,6m
10123,3,[TOPZIK]Kinson,3302,651,25,19,44,56.8%,6m
10123,3,[HFR]MiKaKa,3302,490,20,16,36,55.6%,15m
10123,3,[DayJ]Fozzy,3302,354,16,15,31,51.6%,9m
10123,3,IIIIIIIIIIII,3302,155,14,7,21,66.7%,12m
10123,3,Cherry,3302,258,11,6,17,64.7%,12m
10123,3,[RBP3]Dakata,3302,210,8,8,16,50.0%,20m
10123,3,Joe,3302,156,7,3,10,70.0%,23m
10123,3,SneakyTurtle,3302,126,4,16,20,20.0%,16m
10123,1,[TheM]GreveGruva,3302,0,2,4,6,33.3%,2m
10123,3,[ICGl]Aven,3302,0,0,1,1,0.0%,23m
10141,3,Fesse,3301,1582,172,168,340,50.6%,3m
10141,3,Merely,3301,1474,121,123,244,49.6%,3m
10141,3,Валуев,3301,1445,95,90,185,51.4%,4m
10141,3,[SSFС]SFJake,3301,1539,64,61,125,51.2%,14m
10141,3,[CJFF]mooOOOjtiw,3301,1279,57,53,110,51.8%,10m
10141,3,kvv,3301,416,19,16,35,54.3%,5m
10141,3,iLLum,3301,458,18,14,32,56.2%,16m
10141,3,Baalous,3301,372,14,10,24,58.3%,23m
10141,3,Oxbow,3301,221,11,6,17,64.7%,5m
10141,2,[SCor]Tyrano,3301,232,10,5,15,66.7%,11m
10141,2,Asternius,3301,0,4,1,5,80.0%,1h
10141,1,[TIse]Stasiss,3301,144,3,3,6,50.0%,5m
10141,3,ClimateZone,3301,60,3,3,6,50.0%,10m
10141,3,JustInTime,3301,58,2,6,8,25.0%,1m
10141,3,[D0N3]MANU,3301,0,1,1,2,50.0%,16m
10141,2,Alcx,3301,30,1,13,14,7.1%,23m
10157,3,SameLameName,3300,1463,120,115,235,51.1%,21m
10157,3,Bacon,3300,952,106,106,212,50.0%,14m
10157,3,[Lowko]rextor,3300,1495,94,88,182,51.6%,6m
10157,3,ZERG,3300,1577,79,55,134,59.0%,23m
10157,3,vitahästen,3300,1246,58,54,112,51.8%,3m
10157,3,add,3300,1159,43,44,87,49.4%,16m
10157,3,Yoann,3300,963,40,28,68,58.8%,23m
10157,3,NerdChill,3300,1046,38,44,82,46.3%,23m
10157,3,[InFy]Crane,3300,962,35,35,70,50.0%,11m
10157,3,IllIllIlIIlI,3300,692,31,26,57,54.4%,21m
10157,3,Suji,3300,665,29,24,53,54.7%,10m
10157,3,FourEightNin,3300,376,20,14,34,58.8%,5m
10157,3,AlbertCouenn,3300,282,13,15,28,46.4%,13m
10157,3,LunatikGG,3300,140,6,1,7,85.7%,12m
10157,3,Mancee,3300,30,5,2,7,71.4%,14m
10157,3,KGN,3300,114,5,2,7,71.4%,17m
10157,3,Teebeutel,3300,90,4,10,14,28.6%,1m
10157,3,Viktor,3300,0,1,4,5,20.0%,16m
10157,3,[PaniC]Gongilimb,3300,0,0,1,1,0.0%,20m
10157,3,Kaz,3300,0,0,1,1,0.0%,9m
10157,3,[JBosh]Диомед,3300,0,0,1,1,0.0%,14m
10178,3,Dektral,3299,840,33,28,61,54.1%,17m
10178,3,DrewShow,3299,284,18,11,29,62.1%,2m
10178,3,Kinglui,3299,356,13,7,20,65.0%,22m
10178,3,BRO,3299,280,9,8,17,52.9%,17m
10178,3,Loiosh,3299,146,7,4,11,63.6%,14m
10178,3,arthann,3299,170,7,6,13,53.8%,3m
10178,3,[FGStar]SealOil,3299,190,6,2,8,75.0%,9m
10178,3,[INAE]Rayzen,3299,58,2,2,4,50.0%,20m
10178,3,[SPF]GodofShadow,3299,0,2,3,5,40.0%,6m
10178,3,[2ndLaw]SuperTable,3299,0,0,2,2,0.0%,10m
10188,3,Arnolin,3298,1569,112,98,210,53.3%,18m
10188,3,[MgSt]Kampfkarotte,3298,1048,62,54,116,53.4%,15m
10188,3,BERNARDsky,3298,1412,60,66,126,47.6%,9m
10188,3,GRey,3298,793,56,36,92,60.9%,10m
10188,3,Iados,3298,576,32,26,58,55.2%,17m
10188,3,Skittlez,3298,576,28,13,41,68.3%,20m
10188,3,[lMMl]nunununununu,3298,688,27,25,52,51.9%,5m
10188,3,Thaenthor,3298,657,23,33,56,41.1%,5m
10188,3,Ferox,3298,230,9,12,21,42.9%,12m
10188,3,BuRneR,3298,144,6,3,9,66.7%,2m
10188,3,meisterpan,3298,192,5,3,8,62.5%,4m
10188,3,[V1]laktoz,3298,86,4,0,4,100.0%,3m
10188,3,ramzan,3298,0,4,1,5,80.0%,23m
10188,3,PauloMF,3298,0,4,1,5,80.0%,23m
10188,3,moebius,3298,0,1,0,1,100.0%,6m
10188,3,ЗлойКошара,3298,0,0,1,1,0.0%,8m
10188,3,Disharmonist,3298,0,0,2,2,0.0%,6m
10188,3,NoxWorld,3298,0,0,2,2,0.0%,22m
10188,3,ivicibli,3298,0,0,3,3,0.0%,21m
10188,3,ArtiCuNo,3298,0,0,3,3,0.0%,10m
10188,3,Arthanis,3298,0,0,3,3,0.0%,6m
10188,3,Äffle,3298,0,0,5,5,0.0%,7m
10210,3,BlUeTeE,3297,1506,77,79,156,49.4%,6m
10210,3,asik,3297,1286,56,41,97,57.7%,15m
10210,3,[13g12p]SnaKe,3297,1199,52,40,92,56.5%,12m
10210,3,[AbraG]Abraholep,3297,371,16,10,26,61.5%,17m
10210,3,Marth,3297,287,11,0,11,100.0%,12m
10210,3,[AMG42]ItsMax,3297,282,11,10,21,52.4%,3m
10210,2,[DYPKA]Askilad,3297,0,4,1,5,80.0%,11m
10210,3,Gomboc,3297,116,4,6,10,40.0%,19m
10210,3,[TAW]Zyndra,3297,95,2,2,4,50.0%,13m
10210,3,perfion,3297,60,2,4,6,33.3%,9m
10210,3,[SPHTRS]Drogon,3297,0,1,5,6,16.7%,17m
10210,2,[Miiik]Roscopique,3297,0,0,1,1,0.0%,23m
10210,3,Tcowp,3297,0,0,1,1,0.0%,22m
10210,2,Fer,3297,0,0,1,1,0.0%,21m
10210,3,Levi,3297,0,0,1,1,0.0%,17m
10225,3,Barahlush,3296,1380,240,200,440,54.5%,6m
10225,3,[Hrr]powerofchaos,3296,1266,132,126,258,51.2%,22m
10225,3,UNknown,3296,1537,84,79,163,51.5%,22m
10225,3,eulzef,3296,868,33,33,66,50.0%,16m
10225,3,[ArGGEJ]Bismarck,3296,738,28,26,54,51.9%,7m
10225,3,[NoSepi]Antihero,3296,645,27,19,46,58.7%,7m
10225,3,Sita,3296,630,23,17,40,57.5%,12m
10225,3,QuaeZZ,3296,526,19,19,38,50.0%,14m
10225,3,WheelKing,3296,338,15,12,27,55.6%,16m
10225,3,MrFancyPants,3296,348,12,20,32,37.5%,8m
10225,3,Zaeten,3296,217,7,7,14,50.0%,16m
10225,3,deyimd,3296,140,5,4,9,55.6%,17m
10225,3,bobjr,3296,0,4,1,5,80.0%,15m
10225,3,umopaplsdn,3296,60,2,2,4,50.0%,8m
10225,3,Manabu,3296,0,1,0,1,100.0%,16m
10225,3,magnifico,3296,0,1,0,1,100.0%,4m
10225,1,[EUxAcc]XXIIVIII,3296,0,1,0,1,100.0%,22m
10225,3,[RBP3]Ahil,3296,30,1,10,11,9.1%,11m
10225,3,DodiAlphaYet,3296,0,0,1,1,0.0%,5m
10225,3,[Pxyool]ItRainsSmile,3296,0,0,1,1,0.0%,23m
10225,3,[USOF]KlauzS,3296,0,0,1,1,0.0%,13m
10246,3,[TeHaCe]luQ,3295,1272,184,173,357,51.5%,1m
10246,3,BlackEmperor,3295,1551,173,169,342,50.6%,9m
10246,3,eastvvood,3295,1574,137,136,273,50.2%,16m
10246,3,IcemaN,3295,1596,135,124,259,52.1%,11m
10246,3,UgoSeven,3295,1427,114,114,228,50.0%,9m
10246,3,ZenFire,3295,1487,89,98,187,47.6%,12m
10246,3,Tor,3295,364,14,8,22,63.6%,20m
10246,3,DNEPR,3295,260,9,10,19,47.4%,7m
10246,3,[TlTTIE]FatalSausage,3295,220,8,5,13,61.5%,16m
10246,3,[HPI]Vassillie,3295,90,7,4,11,63.6%,17m
10246,3,[LLG]Hystereak,3295,148,5,9,14,35.7%,20m
10246,3,Vegas,3295,142,4,1,5,80.0%,22m
10246,2,brrrrrrr,3295,89,2,2,4,50.0%,7m
10246,3,Ppok,3295,30,1,1,2,50.0%,15m
10246,3,TEMDH,3295,0,0,1,1,0.0%,17m
10261,3,Bossmode,3294,1155,102,104,206,49.5%,9m
10261,3,Blazzer,3294,1302,81,66,147,55.1%,20m
10261,3,spy,3294,1506,73,65,138,52.9%,5m
10261,3,[EUisOK]WEEBRATOR,3294,1343,70,69,139,50.4%,8m
10261,3,Citru,3294,1279,58,54,112,51.8%,10m
10261,3,FunkyRobot,3294,801,33,25,58,56.9%,20m
10261,3,MKA,3294,291,20,13,33,60.6%,12m
10261,3,AntonSlavik,3294,437,17,8,25,68.0%,6m
10261,3,BingoWolf,3294,207,15,11,26,57.7%,18m
10261,3,FiAND,3294,275,10,1,11,90.9%,22m
10261,3,Paco,3294,182,6,12,18,33.3%,13m
10261,3,[59APM]Kits,3294,114,4,6,10,40.0%,23m
10261,3,[pbss]LingKing,3294,30,2,0,2,100.0%,17m
10261,3,RZuna,3294,95,1,1,2,50.0%,5m
10261,3,Argual,3294,0,1,2,3,33.3%,13m
10261,3,KENZU,3294,0,0,1,1,0.0%,3m
10277,3,Tjibbe,3293,1626,142,132,274,51.8%,3m
10277,3,MiguelPérez,3293,698,27,23,50,54.0%,9m
10277,3,Segurega,3293,317,26,16,42,61.9%,5m
10277,3,Serenity,3293,374,17,21,38,44.7%,16m
10277,3,Rage,3293,314,12,17,29,41.4%,10m
10277,3,Architect,3293,266,11,8,19,57.9%,10m
10277,3,Izzard,3293,145,8,5,13,61.5%,17m
10277,3,Kyaro,3293,147,7,4,11,63.6%,16m
10277,1,[Torby]Eclipse,3293,189,5,1,6,83.3%,8m
10277,1,LOLandMCFBG,3293,120,4,2,6,66.7%,15m
10277,3,[MSUSC2]Guardian,3293,0,1,0,1,100.0%,14m
10277,3,Starlight,3293,0,1,2,3,33.3%,16m
10277,3,[PIMM3L]Ironic,3293,30,1,4,5,20.0%,22m
10277,3,BRuAbsolute,3293,0,1,4,5,20.0%,5m
10277,3,Isens,3293,0,0,1,1,0.0%,13m
10277,3,[FxL]draconis,3293,0,0,2,2,0.0%,17m
10293,3,NoMorePants,3292,1536,101,90,191,52.9%,16m
10293,3,[RBP3]TheCoyote,3292,1425,95,85,180,52.8%,10m
10293,3,SirOk,3292,1420,87,71,158,55.1%,16m
10293,3,rozimbabwe,3292,988,73,75,148,49.3%,13m
10293,3,Leckatall,3292,578,57,55,112,50.9%,5m
10293,3,Twisted,3292,279,29,25,54,53.7%,14m
10293,3,[SCF]BrainDrained,3292,454,16,20,36,44.4%,23m
10293,3,Bulbasaur,3292,341,12,11,23,52.2%,6m
10293,3,[Sosite]cat,3292,316,11,10,21,52.4%,23m
10293,3,[FMG]WhiteEagle,3292,204,6,3,9,66.7%,12m
10293,3,[6m30]SwX,3292,0,4,1,5,80.0%,13m
10293,3,[Jooooo]Djent,3292,114,4,2,6,66.7%,23m
10293,3,Jont,3292,0,3,2,5,60.0%,6m
10293,3,Mars,3292,58,2,3,5,40.0%,15m
10293,2,[ärhoo]syila,3292,0,1,0,1,100.0%,4m
10293,3,Zmecy,3292,0,1,0,1,100.0%,12m
10293,2,Androide,3292,0,0,1,1,0.0%,5m
10293,3,Drapek,3292,0,0,2,2,0.0%,9m
10293,3,Kubarek,3292,0,0,2,2,0.0%,10m
10312,3,Gosuy,3291,1291,223,210,433,51.5%,3m
10312,3,bary,3291,366,91,81,172,52.9%,23m
10312,3,alexfoxdave,3291,1358,77,74,151,51.0%,22m
10312,3,Beuleu,3291,402,58,38,96,60.4%,16m
10312,3,creative,3291,475,23,14,37,62.2%,5m
10312,3,Serralvnl,3291,340,13,11,24,54.2%,16m
10312,3,[oSsOP]Morciera,3291,262,11,3,14,78.6%,8m
10312,3,[VuV]Cool,3291,114,5,1,6,83.3%,13m
10312,3,GreenHerb,3291,189,5,1,6,83.3%,20m
10312,3,[ЛаЛ]Tigger,3291,0,1,0,1,100.0%,12m
10312,3,[DМG]Hades,3291,0,1,0,1,100.0%,16m
10312,3,XxYOURMUMxX,3291,30,1,1,2,50.0%,20m
10324,3,[ЕШКИ]BOB,3290,1503,327,303,630,51.9%,9m
10324,3,Soulreaver,3290,1559,131,140,271,48.3%,3m
10324,3,ChargeBruhhh,3290,1416,60,50,110,54.5%,23m
10324,3,Ranglefanten,3290,1055,49,21,70,70.0%,22m
10324,3,[TSmash]Kicerius,3290,785,49,42,91,53.8%,15m
10324,3,raskolnikov,3290,826,49,49,98,50.0%,13m
10324,3,[Byczki]Lukasz,3290,647,28,22,50,56.0%,22m
10324,3,Spacegoat,3290,252,10,7,17,58.8%,6m
10324,3,[Psyc]Naz,3290,146,6,3,9,66.7%,6m
10324,3,ElPueblo,3290,0,5,0,5,100.0%,6m
10324,1,[SPI]Fbondo,3290,154,5,3,8,62.5%,13m
10324,3,IIIIIIIIIIII,3290,30,5,3,8,62.5%,17m
10324,3,HighPlayers,3290,30,2,0,2,100.0%,22m
10324,3,[OXs]Hyppox,3290,0,1,0,1,100.0%,16m
10324,3,[Чмок]BatyaMahno,3290,0,1,1,2,50.0%,8m
10324,3,[GAZ]Kippi,3290,0,1,4,5,20.0%,5m
10324,3,[unƊeaƊ]danzelot,3290,0,0,1,1,0.0%,21m
10324,3,Mellon,3290,0,0,1,1,0.0%,8m
10342,3,Rugrud,3289,876,135,130,265,50.9%,10m
10342,2,Borussia,3289,1418,122,138,260,46.9%,1m
10342,3,[MANGE]IHateProtoss,3289,1606,79,78,157,50.3%,14m
10342,3,AhtunG,3289,484,18,18,36,50.0%,1m
10342,3,wilks,3289,214,9,4,13,69.2%,16m
10342,3,GeileJenny,3289,184,8,3,11,72.7%,7m
10342,3,ReZylAzzir,3289,30,5,1,6,83.3%,23m
10342,3,[CrøkeT]ElGropor,3289,114,5,5,10,50.0%,7m
10342,3,DaBro,3289,92,4,4,8,50.0%,5m
10342,3,Novarix,3289,0,3,1,4,75.0%,11m
10342,2,Kabooom,3289,0,3,3,6,50.0%,34m
10342,3,SerosDale,3289,30,2,1,3,66.7%,17m
10342,3,[viz]Lost,3289,0,1,0,1,100.0%,8m
10342,3,Gambrinus,3289,0,1,0,1,100.0%,12m
10342,3,Narud,3289,0,0,1,1,0.0%,14m
10342,1,Paddo,3289,0,0,1,1,0.0%,21m
10342,3,[PLA2N]classikby,3289,0,0,1,1,0.0%,22m
10342,3,Dartti,3289,0,0,5,5,0.0%,17m
10360,2,Мухосранск,3288,1446,85,91,176,48.3%,20m
10360,3,Rogermomo,3288,1240,67,55,122,54.9%,3m
10360,3,[Magpie]LuukDeok,3288,1046,42,34,76,55.3%,23m
10360,3,HellOne,3288,681,33,18,51,64.7%,14m
10360,3,xinterp,3288,527,26,22,48,54.2%,11m
10360,3,[lLiTl]WackoAssassi,3288,197,14,12,26,53.8%,19m
10360,3,Lennart,3288,350,12,16,28,42.9%,7m
10360,3,[GranK]Kelpie,3288,114,7,4,11,63.6%,13m
10360,1,MRgoatman,3288,120,5,5,10,50.0%,1h
10360,1,GhostCommand,3288,168,5,7,12,41.7%,1h
10360,2,Marschmellow,3288,0,4,1,5,80.0%,26m
10360,2,Radnaatseren,3288,0,3,2,5,60.0%,3m
10360,3,Bubbakush,3288,115,2,4,6,33.3%,10m
10360,2,ivanpeque,3288,0,0,1,1,0.0%,40m
10374,3,erkek,3287,1109,118,112,230,51.3%,23m
10374,3,Toilet,3287,1045,110,102,212,51.9%,13m
10374,3,Elephantos,3287,1572,61,63,124,49.2%,7m
10374,3,[J4tS]Bakka,3287,714,31,19,50,62.0%,17m
10374,3,SoulArisen,3287,569,23,13,36,63.9%,18m
10374,3,BYUN,3287,268,13,15,28,46.4%,6m
10374,3,Danlin,3287,255,8,3,11,72.7%,5m
10374,3,TonyD,3287,221,8,6,14,57.1%,16m
10374,3,Miggy,3287,216,7,16,23,30.4%,6m
10374,3,BBK,3287,170,6,4,10,60.0%,22m
10374,3,[Jiggel]VibeScholar,3287,174,6,8,14,42.9%,7m
10374,3,Entropy,3287,0,4,0,4,100.0%,14m
10374,3,dimarus,3287,58,3,0,3,100.0%,19m
10374,3,[200]Magnetron,3287,0,1,0,1,100.0%,18m
10374,3,TonyStark,3287,0,1,0,1,100.0%,1m
10389,3,tatsumiko,3286,1495,195,198,393,49.6%,5m
10389,2,Mystic,3286,1215,156,163,319,48.9%,3m
10389,3,Ghasty,3286,1383,61,46,107,57.0%,3m
10389,3,[Sativa]SNEG,3286,988,39,32,71,54.9%,3m
10389,3,Ebbon,3286,493,23,15,38,60.5%,5m
10389,3,[PHØMUI]Jihau,3286,518,19,17,36,52.8%,11m
10389,3,Balder,3286,144,8,3,11,72.7%,10m
10389,3,Ctronic,3286,226,8,6,14,57.1%,14m
10389,3,[SEWP]Артурииик,3286,216,8,7,15,53.3%,8m
10389,3,czajna,3286,216,7,13,20,35.0%,14m
10389,3,olabola,3286,58,5,2,7,71.4%,11m
10389,3,FreshGordon,3286,175,5,9,14,35.7%,3m
10389,3,pretender,3286,0,4,1,5,80.0%,16m
10389,1,[PLOPI]Aston,3286,132,4,14,18,22.2%,15m
10389,3,ggByron,3286,80,3,7,10,30.0%,13m
10389,3,Pariah,3286,121,2,1,3,66.7%,15m
10389,3,Anasazi,3286,30,2,1,3,66.7%,1m
10389,3,[ZЕRGТV]Silence,3286,0,1,0,1,100.0%,8m
10389,2,WhiteWolf,3286,48,1,6,7,14.3%,1h
10408,2,[fam1ly]ArtiDo,3285,1443,60,80,140,42.9%,19m
10408,3,ghosty,3285,1032,41,39,80,51.2%,20m
10408,3,ArisenCobra,3285,790,36,38,74,48.6%,22m
10408,3,Jekenius,3285,569,25,20,45,55.6%,10m
10408,3,[xEHECx]Perdix,3285,430,17,15,32,53.1%,16m
10408,3,IvanDurak,3285,220,12,9,21,57.1%,14m
10408,3,viper,3285,274,11,7,18,61.1%,20m
10408,3,FlyyTime,3285,159,9,8,17,52.9%,8m
10408,3,Extremis,3285,118,5,12,17,29.4%,20m
10408,3,MontereyJack,3285,114,4,3,7,57.1%,16m
10408,3,StormMKD,3285,0,0,1,1,0.0%,18m
10408,3,[C70560]leo,3285,0,0,1,1,0.0%,12m
10408,2,[Blacer]InnosGothic,3285,0,0,1,1,0.0%,13m
10408,3,[wait]RazorScale,3285,0,0,2,2,0.0%,6m
10408,3,arkéo,3285,0,0,2,2,0.0%,17m
10423,3,geenue,3284,757,37,27,64,57.8%,22m
10423,3,knedlík,3284,569,22,18,40,55.0%,23m
10423,3,rccbc,3284,406,14,20,34,41.2%,1m
10423,3,[LgnEU]Iron,3284,219,10,7,17,58.8%,18m
10423,2,imsodiabolik,3284,95,6,0,6,100.0%,22m
10423,2,ZealotKing,3284,96,5,0,5,100.0%,1h
10423,2,[Zboubz]Titisnake,3284,46,5,2,7,71.4%,1h
10423,3,IntrA,3284,94,5,16,21,23.8%,2m
10423,3,[MADGa]lexendo,3284,55,4,5,9,44.4%,2m
10423,3,Danceacy,3284,30,2,1,3,66.7%,4m
10423,3,BraZersLarsy,3284,0,1,2,3,33.3%,12m
10423,3,skjoldan,3284,0,0,1,1,0.0%,22m
10423,3,Maltese,3284,0,0,2,2,0.0%,12m
10436,3,[VIIDCS]Yolo,3283,1542,271,269,540,50.2%,17m
10436,3,Sean,3283,1572,197,156,353,55.8%,17m
10436,3,Luyan,3283,1590,90,82,172,52.3%,16m
10436,3,Koczer,3283,1327,78,73,151,51.7%,16m
10436,3,Crazy,3283,1437,58,50,108,53.7%,14m
10436,3,Normas,3283,754,32,20,52,61.5%,3m
10436,3,fozzy,3283,454,18,10,28,64.3%,7m
10436,3,Chen,3283,468,18,13,31,58.1%,23m
10436,3,Monochrome,3283,323,14,13,27,51.9%,14m
10436,2,TPxSpAnZo,3283,283,12,9,21,57.1%,3m
10436,3,BoneSButcheR,3283,260,11,7,18,61.1%,14m
10436,3,Enfuego,3283,60,6,3,9,66.7%,7m
10436,2,IlIllIllIllI,3283,0,4,1,5,80.0%,11m
10436,3,clausewitz,3283,0,4,1,5,80.0%,6m
10436,3,[СКОН]AZS,3283,58,2,4,6,33.3%,2m
10436,3,PepKeck,3283,0,1,0,1,100.0%,22m
10436,3,SnarkyGoblin,3283,18,1,3,4,25.0%,13m
10453,3,Yrk,3282,1547,350,344,694,50.4%,16m
10453,3,[SPHTRS]carpini,3282,1579,170,173,343,49.6%,6m
10453,3,[SHMLK]PlanetOfWar,3282,525,29,18,47,61.7%,5m
10453,3,GoWjehnova,3282,273,26,16,42,61.9%,9m
10453,3,Winchester,3282,686,26,23,49,53.1%,14m
10453,3,[J4E]apfelsaft,3282,408,24,22,46,52.2%,12m
10453,3,CrazyIvan,3282,592,22,22,44,50.0%,3m
10453,3,[lol0l]Zulkylol,3282,256,21,16,37,56.8%,5m
10453,3,SpaceDragon,3282,472,16,17,33,48.5%,9m
10453,2,GuardianApe,3282,310,12,9,21,57.1%,21m
10453,3,Bonus,3282,170,5,3,8,62.5%,17m
10453,3,Eneru,3282,0,4,1,5,80.0%,9m
10453,3,UsIChivas,3282,118,4,10,14,28.6%,22m
10453,3,Dameon,3282,0,3,1,4,75.0%,6m
10453,3,[oLAMAo]Dunga,3282,76,3,2,5,60.0%,19m
10453,3,[KMNDX]RectalProbe,3282,58,2,1,3,66.7%,22m
10453,3,Moree,3282,30,1,5,6,16.7%,8m
10453,3,[123abc]stowgood,3282,0,0,1,1,0.0%,19m
10453,3,[S1MPLE]Mrnousak,3282,0,0,1,1,0.0%,5m
10472,3,CoreX,3281,1195,57,37,94,60.6%,11m
10472,3,millivoje,3281,1374,55,53,108,50.9%,6m
10472,3,[EAU]Flou,3281,1039,43,36,79,54.4%,13m
10472,3,SHOCK,3281,198,12,17,29,41.4%,10m
10472,3,[PLA2N]Robovoen,3281,114,4,5,9,44.4%,2m
10472,3,[TAW]RSN,3281,0,1,1,2,50.0%,20m
10472,1,starrrrlight,3281,94,1,2,3,33.3%,2m
10472,3,[Prisma]Mauldaeschle,3281,0,0,1,1,0.0%,16m
10472,3,lëni,3281,0,0,1,1,0.0%,12m
10472,3,scripter,3281,0,0,1,1,0.0%,6m
10482,3,SkillReX,3280,1499,209,207,416,50.2%,15m
10482,3,QEInfinity,3280,1173,183,177,360,50.8%,22m
10482,3,Bizu,3280,920,51,44,95,53.7%,12m
10482,3,Clabin,3280,773,33,19,52,63.5%,10m
10482,2,TrojaN,3280,837,31,50,81,38.3%,14m
10482,3,BlueSide,3280,508,18,19,37,48.6%,22m
10482,3,Plikis,3280,360,13,13,26,50.0%,10m
10482,3,Seeting,3280,254,10,3,13,76.9%,10m
10482,3,GakTakLakPak,3280,245,9,1,10,90.0%,6m
10482,3,Protoss,3280,167,8,4,12,66.7%,10m
10482,3,Rostov,3280,170,7,8,15,46.7%,2m
10482,2,Kraelog,3280,128,7,16,23,30.4%,18m
10482,3,[GRiM]Sonny,3280,86,4,3,7,57.1%,3m
10482,3,ManVSWild,3280,86,3,4,7,42.9%,14m
10482,3,Sharovf,3280,0,1,1,2,50.0%,16m
10482,3,Mad,3280,30,1,1,2,50.0%,13m
10482,3,Remuko,3280,97,1,3,4,25.0%,8m
10482,2,[PŖïMĄŁ]수상자 작품,3280,30,1,20,21,4.8%,6m
10482,3,flapjack,3280,0,0,1,1,0.0%,23m
10501,3,[WCKYLN]CHESHKA,3279,1395,139,140,279,49.8%,9m
10501,3,[DrDrDr]medIgel,3279,1553,76,85,161,47.2%,14m
10501,3,Shield,3279,1054,38,41,79,48.1%,17m
10501,3,bodzo,3279,422,33,39,72,45.8%,3m
10501,3,RainTeller,3279,602,25,22,47,53.2%,14m
10501,3,TheEviL,3279,586,22,14,36,61.1%,12m
10501,3,KFJ,3279,346,20,15,35,57.1%,5m
10501,3,Always,3279,301,15,8,23,65.2%,7m
10501,3,TripleO,3279,334,13,6,19,68.4%,9m
10501,3,[SPCs]RightProfit,3279,65,4,8,12,33.3%,19m
10501,1,[FQP]Fiwel,3279,113,2,1,3,66.7%,10m
10501,3,NeBomjik,3279,0,2,4,6,33.3%,10m
10501,3,[ZrgZer]Roman,3279,30,1,1,2,50.0%,16m
10501,3,Bargosh,3279,30,1,2,3,33.3%,23m
10501,3,mayden,3279,30,1,9,10,10.0%,7m
10501,3,Rewind,3279,0,0,1,1,0.0%,8m
10501,3,[GGGLHF]fxprochess,3279,0,0,1,1,0.0%,5m
10518,3,Святой,3278,1401,85,84,169,50.3%,2m
10518,3,lstar,3278,624,63,60,123,51.2%,15m
10518,3,Enigma,3278,708,53,57,110,48.2%,22m
10518,3,Waylander,3278,1262,52,47,99,52.5%,18m
10518,3,Predalien,3278,689,33,23,56,58.9%,12m
10518,3,dimchik,3278,777,31,27,58,53.4%,17m
10518,3,cyberstorm,3278,744,29,34,63,46.0%,12m
10518,3,nika,3278,510,28,26,54,51.9%,16m
10518,3,Xanax,3278,114,5,2,7,71.4%,5m
10518,3,ALXN,3278,0,4,1,5,80.0%,5m
10518,3,Chuff,3278,0,4,1,5,80.0%,5m
10518,3,arka,3278,120,4,4,8,50.0%,13m
10518,3,[Kuchen]Roqskillz,3278,30,2,0,2,100.0%,3m
10518,3,Nanatzuja,3278,0,2,3,5,40.0%,11m
10518,3,[HpT]termosCZ,3278,0,0,1,1,0.0%,10m
10518,3,Gume,3278,0,0,1,1,0.0%,12m
10518,3,[DragoM]GolD,3278,0,0,1,1,0.0%,12m
10518,3,gutyganjha,3278,0,0,2,2,0.0%,10m
10536,2,Kelpie,3277,1547,171,179,350,48.9%,8m
10536,3,[halik]TyTus,3277,1514,109,112,221,49.3%,3m
10536,3,[1FU2]Shinobi,3277,1050,43,33,76,56.6%,16m
10536,3,unicorn,3277,548,36,28,64,56.2%,12m
10536,3,Curlviv,3277,657,30,16,46,65.2%,21m
10536,3,ValorTime,3277,574,23,21,44,52.3%,18m
10536,3,[ZaG]Brez,3277,325,15,10,25,60.0%,23m
10536,3,Silano,3277,310,14,14,28,50.0%,7m
10536,3,Cocaines,3277,148,11,7,18,61.1%,13m
10536,2,[WeGr]JIDEKO,3277,159,8,4,12,66.7%,8m
10536,3,LacSpore,3277,172,6,8,14,42.9%,8m
10536,3,flyrev,3277,92,5,1,6,83.3%,13m
10536,3,Jonsey,3277,114,5,1,6,83.3%,6m
10536,3,SpicyTofu,3277,114,5,1,6,83.3%,23m
10536,3,[НОД17]Overmind,3277,144,5,7,12,41.7%,23m
10536,2,llllllllllll,3277,0,4,1,5,80.0%,31m
10536,3,UltraM,3277,58,3,1,4,75.0%,15m
10536,2,[EZPTS]rizo,3277,44,2,4,6,33.3%,13m
10554,3,Sva,3276,1038,86,82,168,51.2%,23m
10554,3,[PORO3]Pinkrock,3276,1025,80,67,147,54.4%,17m
10554,3,MrBind,3276,1024,39,38,77,50.6%,15m
10554,3,hawi,3276,624,30,31,61,49.2%,13m
10554,3,Linden,3276,654,28,15,43,65.1%,12m
10554,3,Advocate,3276,587,25,18,43,58.1%,23m
10554,3,[z0g0]Kee,3276,645,23,33,56,41.1%,14m
10554,3,Shansur,3276,354,15,6,21,71.4%,3m
10554,3,Starscream,3276,300,11,6,17,64.7%,2m
10554,3,Cyclops,3276,223,10,12,22,45.5%,14m
10554,1,[morrow]gOJV,3276,144,7,3,10,70.0%,30m
10554,3,[TSC2C]Gesetz,3276,124,4,6,10,40.0%,19m
10554,3,Rybak,3276,128,4,14,18,22.2%,20m
10554,3,RIPerRush,3276,30,3,4,7,42.9%,17m
10554,2,Xertan,3276,0,0,1,1,0.0%,10m
10554,3,[EESC]TRiNiGhT,3276,0,0,1,1,0.0%,17m
10554,3,Tychrus,3276,0,0,2,2,0.0%,13m
10571,3,PavliK,3275,1589,144,145,289,49.8%,11m
10571,2,Sirukal,3275,1538,97,105,202,48.0%,23m
10571,3,[LeWät]Thebuli,3275,942,76,51,127,59.8%,17m
10571,3,[WHM]CoupDeGrace,3275,1325,59,63,122,48.4%,17m
10571,3,[αX]Shohei,3275,738,39,38,77,50.6%,22m
10571,3,oLoLo,3275,580,37,36,73,50.7%,16m
10571,3,crusher,3275,184,16,15,31,51.6%,2m
10571,3,Usama,3275,284,13,7,20,65.0%,16m
10571,3,Pounds,3275,170,7,8,15,46.7%,3m
10571,3,MajOrDanGeR,3275,170,7,11,18,38.9%,12m
10571,3,pachanja,3275,191,5,2,7,71.4%,17m
10571,2,Jata,3275,0,4,1,5,80.0%,1h
10571,1,Meta,3275,97,2,4,6,33.3%,21m
10571,3,RiViWill,3275,58,2,5,7,28.6%,7m
10571,3,fearless,3275,58,2,5,7,28.6%,2m
10571,2,[RKZ]mÆnSter,3275,0,0,1,1,0.0%,1h
10571,3,TummeUpp,3275,0,0,1,1,0.0%,16m
10588,3,shhhchizo,3274,1551,269,253,522,51.5%,15m
10588,3,Kolotrol,3274,1555,262,260,522,50.2%,8m
10588,3,psi,3274,940,130,100,230,56.5%,17m
10588,3,rapines,3274,591,46,31,77,59.7%,14m
10588,3,tsaga,3274,869,35,26,61,57.4%,18m
10588,3,WoletarHeri,3274,816,30,30,60,50.0%,10m
10588,3,cAALY,3274,623,28,16,44,63.6%,10m
10588,3,themamamatay,3274,211,14,6,20,70.0%,23m
10588,3,globalundo,3274,298,13,5,18,72.2%,6m
10588,2,ČiribuČiba,3274,119,6,1,7,85.7%,1h
10588,1,Passchendael,3274,118,3,4,7,42.9%,1h
10588,3,MaldazarIV,3274,60,2,3,5,40.0%,3m
10588,3,spydaMayn,3274,0,1,0,1,100.0%,23m
10588,3,Razingbal,3274,0,0,1,1,0.0%,8m
10602,3,Swuulst,3273,1516,221,218,439,50.3%,13m
10602,3,Sind,3273,1601,202,174,376,53.7%,9m
10602,3,[Hammer]llllllllllll,3273,1540,198,201,399,49.6%,22m
10602,3,grinderconny,3273,616,82,77,159,51.6%,8m
10602,3,LaForge,3273,631,44,51,95,46.3%,10m
10602,3,[8mylez]MagicN,3273,854,35,29,64,54.7%,6m
10602,3,[BWArmy]Corentin,3273,755,34,21,55,61.8%,17m
10602,3,Miya,3273,536,26,13,39,66.7%,13m
10602,3,Shadowblate,3273,469,24,3,27,88.9%,18m
10602,3,Piotrek,3273,444,16,15,31,51.6%,6m
10602,3,Partizancheg,3273,412,15,13,28,53.6%,4m
10602,3,Blu,3273,265,14,13,27,51.9%,7m
10602,1,bycraft,3273,167,7,2,9,77.8%,4m
10602,2,magnaaegwynn,3273,229,7,4,11,63.6%,16m
10602,3,tatsu,3273,166,6,7,13,46.2%,13m
10602,3,IIIIIIIIIIII,3273,0,4,1,5,80.0%,6m
10602,3,biba,3273,94,4,1,5,80.0%,5m
10602,3,KARNAVAL,3273,0,4,1,5,80.0%,7m
10602,2,lightbringer,3273,60,4,12,16,25.0%,15m
10602,3,uNDeaDZERG,3273,0,1,0,1,100.0%,14m
10602,2,IlIllIlllIlI,3273,0,1,1,2,50.0%,1h
10602,3,Gorgorito,3273,30,1,5,6,16.7%,3m
10602,3,Batman,3273,0,0,2,2,0.0%,9m
10625,3,[КПCC]анскилл,3272,1480,136,102,238,57.1%,6m
10625,3,[NLM]Olivier,3272,1294,78,75,153,51.0%,2m
10625,3,Pikaboo,3272,313,14,11,25,56.0%,7m
10625,3,[lIIlI]Numiro,3272,216,9,5,14,64.3%,20m
10625,3,Computer,3272,218,8,6,14,57.1%,2m
10625,3,XandroSancho,3272,137,7,13,20,35.0%,16m
10625,3,OBELIX,3272,215,6,7,13,46.2%,17m
10625,3,[ODhc]oDa,3272,116,5,2,7,71.4%,16m
10625,1,SCPlusPlus,3272,211,5,5,10,50.0%,34m
10625,3,[JeeEmm]Ripsy,3272,90,3,3,6,50.0%,7m
10625,3,ADVISOR,3272,30,2,0,2,100.0%,2m
10625,3,[DIVOC]Wodjee,3272,0,0,1,1,0.0%,7m
10625,3,[NSFG0D]zerstoerertc,3272,0,0,1,1,0.0%,5m
10638,3,[fastgg]BrainBug,3271,911,122,104,226,54.0%,2m
10638,3,[Sarmat]MatiKlok,3271,1398,89,81,170,52.4%,8m
10638,3,[ШиШаНы]Nyashka,3271,806,43,17,60,71.7%,7m
10638,3,Hittsu,3271,696,27,34,61,44.3%,6m
10638,3,[BBSC]Sequency,3271,330,12,16,28,42.9%,19m
10638,3,kahite,3271,204,9,8,17,52.9%,20m
10638,3,SpeedyRogue,3271,188,7,15,22,31.8%,3m
10638,3,[3KFC]Fliewatüüt,3271,118,4,4,8,50.0%,5m
10638,3,[FFoHM]Denali,3271,30,2,1,3,66.7%,8m
10638,3,Roverlos,3271,30,1,3,4,25.0%,7m
10648,3,krelin,3270,1355,260,227,487,53.4%,8m
10648,3,[666999]Almit,3270,1578,140,139,279,50.2%,8m
10648,3,Luxior,3270,481,20,10,30,66.7%,23m
10648,3,BajsMannen,3270,346,15,11,26,57.7%,17m
10648,3,DrRudi,3270,262,12,12,24,50.0%,5m
10648,2,Chokapiko,3270,216,6,7,13,46.2%,17m
10648,3,KIss,3270,185,5,1,6,83.3%,12m
10648,2,[Tripin]SiCKO,3270,0,1,0,1,100.0%,13m
10648,3,Nagel,3270,0,1,0,1,100.0%,20m
10648,3,ForresT,3270,30,1,1,2,50.0%,16m
10648,3,[LGM]Evlex,3270,30,1,1,2,50.0%,8m
10648,3,Zergling,3270,0,0,1,1,0.0%,6m
10648,3,[αX]Serpagel,3270,0,0,1,1,0.0%,19m
10648,3,moffe,3270,0,0,1,1,0.0%,8m
10662,3,VAIDER,3269,1494,134,122,256,52.3%,12m
10662,2,mandrakss,3269,1463,90,91,181,49.7%,6m
10662,3,Caltu,3269,392,40,26,66,60.6%,16m
10662,3,bartas,3269,910,33,41,74,44.6%,13m
10662,3,Belazhur,3269,558,23,13,36,63.9%,6m
10662,3,[RekTzW]Szlachecki,3269,460,17,16,33,51.5%,2m
10662,3,[NOBHED]TheDocToss,3269,482,16,28,44,36.4%,22m
10662,3,Knarr,3269,349,14,11,25,56.0%,22m
10662,3,Mojo,3269,381,13,10,23,56.5%,23m
10662,3,Mellroth,3269,226,8,18,26,30.8%,4m
10662,3,RobotWorgen,3269,116,5,3,8,62.5%,13m
10662,2,[fghtfr]Freefighter,3269,0,4,1,5,80.0%,33m
10662,3,[Razzle]Elkeezy,3269,60,3,3,6,50.0%,11m
10662,3,[MRCW]Alphonsekarr,3269,30,2,1,3,66.7%,3m
10662,3,[rRRRr6]RRR,3269,0,1,1,2,50.0%,22m
10662,3,ALPINUS,3269,30,1,2,3,33.3%,14m
10662,3,[KTQ]Raynor,3269,0,0,1,1,0.0%,8m
10662,3,NonServiam,3269,0,0,2,2,0.0%,12m
10680,3,KycokMRCA,3268,798,93,82,175,53.1%,9m
10680,3,[IndyK]Nazim,3268,514,38,47,85,44.7%,3m
10680,3,Squall,3268,371,19,17,36,52.8%,3m
10680,3,platzeins,3268,454,18,14,32,56.2%,9m
10680,3,Thirteenth,3268,376,13,10,23,56.5%,21m
10680,2,zeroKelvin,3268,227,11,7,18,61.1%,23m
10680,3,FlossToss,3268,148,8,3,11,72.7%,10m
10680,3,kiskiri,3268,143,7,3,10,70.0%,19m
10680,3,Simba,3268,194,6,5,11,54.5%,9m
10680,3,BLEST,3268,196,5,4,9,55.6%,16m
10680,3,[VFN]julian,3268,0,4,1,5,80.0%,17m
10680,2,Detsky,3268,0,4,1,5,80.0%,42m
10680,3,Slash,3268,0,3,2,5,60.0%,5m
10680,2,[DxTY]JimRaynor,3268,92,2,1,3,66.7%,13m
10680,2,failure,3268,0,2,3,5,40.0%,25m
10680,3,[NONIST]JagaJaga,3268,0,1,0,1,100.0%,17m
10680,3,[oWnly]KushOj,3268,30,1,1,2,50.0%,12m
10680,3,Ramon,3268,30,1,1,2,50.0%,17m
10680,3,[INFTS]Nayjot,3268,30,1,2,3,33.3%,5m
10680,3,Vesparion,3268,0,0,1,1,0.0%,10m
10680,3,Crepgio,3268,0,0,1,1,0.0%,9m
10680,3,Spawn,3268,0,0,1,1,0.0%,21m
10680,3,[ClanRu]Санёк,3268,0,0,2,2,0.0%,9m
10703,3,ChickeN,3267,1589,590,558,1148,51.4%,4m
10703,3,ItIsFine,3267,484,194,183,377,51.5%,22m
10703,3,Guils,3267,1137,147,132,279,52.7%,11m
10703,3,DUB,3267,1490,136,130,266,51.1%,22m
10703,3,Battledroid,3267,1151,80,74,154,51.9%,10m
10703,3,Happyfeet,3267,1418,58,49,107,54.2%,10m
10703,3,tEkMO,3267,772,29,30,59,49.2%,12m
10703,3,[3Macro]Бонапарт,3267,516,26,8,34,76.5%,8m
10703,3,[BCFW]datrandomguy,3267,434,23,21,44,52.3%,17m
10703,3,AmigoOpossum,3267,568,21,15,36,58.3%,2m
10703,3,[Miz]Kajmera,3267,490,21,16,37,56.8%,7m
10703,3,[SEXi]Adee,3267,332,11,13,24,45.8%,5m
10703,3,Moldy,3267,224,10,5,15,66.7%,7m
10703,3,bluefyre,3267,103,10,12,22,45.5%,14m
10703,3,[DNvL]KillerQualle,3267,202,7,10,17,41.2%,4m
10703,3,hellbryt,3267,30,5,2,7,71.4%,11m
10703,3,[Крух]ПeLMeNb,3267,114,4,2,6,66.7%,16m
10703,3,[ioStuN]Пощёлкивани,3267,116,4,5,9,44.4%,13m
10703,3,Trollkemada,3267,90,4,7,11,36.4%,16m
10703,3,[Hrr]Leatherman,3267,60,3,3,6,50.0%,2m
10703,3,PhoeniX,3267,0,0,1,1,0.0%,16m
10703,3,hochupokakat,3267,0,0,1,1,0.0%,9m
10725,2,darkstark,3266,1468,531,535,1066,49.8%,4m
10725,3,[ProbKA]Сахас,3266,1576,239,230,469,51.0%,9m
10725,3,Barcode,3266,1583,91,75,166,54.8%,4m
10725,3,[BGS]SumerskiBog,3266,1122,51,42,93,54.8%,14m
10725,3,Diggahs,3266,707,32,21,53,60.4%,18m
10725,3,Yinut,3266,513,31,22,53,58.5%,19m
10725,3,macro,3266,677,26,19,45,57.8%,17m
10725,3,DrGoenka,3266,622,24,18,42,57.1%,9m
10725,3,finzi,3266,374,14,16,30,46.7%,12m
10725,3,[theDH]Singo,3266,310,12,14,26,46.2%,4m
10725,3,Siegfried,3266,133,8,0,8,100.0%,7m
10725,3,[CIMICE]AZOG,3266,230,8,3,11,72.7%,23m
10725,2,eLFix,3266,198,8,27,35,22.9%,7m
10725,3,[ImbaNB]Veren,3266,210,7,11,18,38.9%,7m
10725,3,Machmol,3266,115,6,2,8,75.0%,17m
10725,3,bobToss,3266,114,4,4,8,50.0%,16m
10725,2,[SGCxx]YouSeeMee,3266,119,3,2,5,60.0%,40m
10725,1,[EnTгpY]GrassEater,3266,158,3,4,7,42.9%,2m
10725,1,Arno,3266,118,2,2,4,50.0%,39m
10725,3,[Hrr]TaLiB,3266,47,2,2,4,50.0%,5m
10725,1,[ToXIK]LeMarquis,3266,96,2,4,6,33.3%,9m
10725,3,[PuSl]BaGGeRTeaM,3266,0,1,0,1,100.0%,20m
10725,3,[Хобот]Roros,3266,30,1,1,2,50.0%,15m
10725,3,Rethnael,3266,0,1,1,2,50.0%,17m
10725,3,[ZЕRGML]Strangerxxx,3266,0,0,1,1,0.0%,15m
10725,2,TossBoy,3266,0,0,1,1,0.0%,35m
10751,3,sokolxxl,3265,1569,224,227,451,49.7%,14m
10751,3,Befe,3265,930,96,91,187,51.3%,4m
10751,3,Skills,3265,1078,64,44,108,59.3%,18m
10751,3,[Z1L]Inquisition,3265,858,44,34,78,56.4%,16m
10751,3,ImBaneling,3265,0,5,0,5,100.0%,6m
10751,3,Reign,3265,0,4,1,5,80.0%,17m
10751,3,XLerate,3265,0,3,2,5,60.0%,5m
10751,3,kesstarwars,3265,86,3,6,9,33.3%,20m
10751,3,Xiaky,3265,0,1,1,2,50.0%,13m
10751,3,Tehhell,3265,30,1,2,3,33.3%,16m
10751,3,[CCHP]MicroChelik,3265,30,1,4,5,20.0%,9m
10751,3,ChiZerg,3265,0,0,1,1,0.0%,18m
10751,3,[TAW]Tompann,3265,0,0,2,2,0.0%,4m
10764,3,[GUSIAD]avatarion,3264,1345,248,236,484,51.2%,23m
10764,3,jasta,3264,1602,99,89,188,52.7%,3m
10764,3,[MOLDVA]Dima,3264,1438,93,82,175,53.1%,10m
10764,3,SithStijndee,3264,1542,75,70,145,51.7%,19m
10764,3,TheUnclePot,3264,658,69,61,130,53.1%,8m
10764,3,NoScared,3264,498,39,8,47,83.0%,10m
10764,3,Uragan,3264,466,33,26,59,55.9%,12m
10764,3,MargariN,3264,650,23,28,51,45.1%,12m
10764,1,AlexTop,3264,145,6,3,9,66.7%,19m
10764,3,CatInBox,3264,174,6,8,14,42.9%,23m
10764,3,Lokiju,3264,0,5,3,8,62.5%,15m
10764,2,Krorry,3264,0,3,1,4,75.0%,1h
10764,3,[ZeDe20]Samos,3264,142,3,4,7,42.9%,11m
10764,3,[TheER]UxorialRook,3264,0,2,3,5,40.0%,20m
10764,3,Cornhulio,3264,30,2,3,5,40.0%,23m
10764,2,[RavenZ]TheRedX,3264,0,0,1,1,0.0%,9m
10764,3,Rorscha,3264,0,0,5,5,0.0%,16m
10781,3,DRIAN,3263,1383,208,199,407,51.1%,16m
10781,3,MRFATFINGER,3263,1439,202,192,394,51.3%,5m
10781,3,NOSFERATU,3263,838,33,31,64,51.6%,21m
10781,3,[Kans]Умник,3263,449,17,12,29,58.6%,23m
10781,3,[VdK]DeadUncle,3263,269,16,13,29,55.2%,12m
10781,3,BarCode,3263,400,16,22,38,42.1%,20m
10781,3,ASvool,3263,378,14,16,30,46.7%,24m
10781,3,[OYY]Koltess,3263,254,9,11,20,45.0%,13m
10781,3,[RBP3]zeverynth,3263,238,8,4,12,66.7%,17m
10781,3,cjk,3263,189,6,4,10,60.0%,3m
10781,2,Halerik,3263,161,5,2,7,71.4%,3m
10781,3,vizualiza,3263,140,5,4,9,55.6%,12m
10781,3,[AiPo]ArchonHoppis,3263,0,4,1,5,80.0%,23m
10781,3,Rostov,3263,86,4,5,9,44.4%,15m
10781,3,SunLightKing,3263,90,3,4,7,42.9%,14m
10781,3,Shino,3263,0,1,0,1,100.0%,20m
10781,2,Askevich,3263,0,1,0,1,100.0%,4m
10781,3,vio,3263,0,1,1,2,50.0%,8m
10781,2,ǂKJ,3263,0,1,4,5,20.0%,15m
10781,3,[Hazeee]Tommy,3263,0,0,1,1,0.0%,10m
10781,3,[repsru]Zealot,3263,0,0,1,1,0.0%,8m
10781,3,KblCa,3263,0,0,1,1,0.0%,2m
10781,3,Fatamorgana,3263,0,0,1,1,0.0%,20m
10781,3,Lzast,3263,0,0,3,3,0.0%,13m
10781,3,Veqas,3263,0,0,5,5,0.0%,13m
10806,3,[MAOLTE]Tungsten,3262,998,37,36,73,50.7%,10m
10806,3,spektr,3262,240,18,16,34,52.9%,19m
10806,1,[Gachi7]Bloodborn,3262,357,14,6,20,70.0%,2m
10806,3,vOidRayrUsH,3262,362,14,11,25,56.0%,8m
10806,3,[BornG]Bleesk,3262,232,13,15,28,46.4%,7m
10806,3,[Gr3]maxs,3262,267,12,3,15,80.0%,15m
10806,3,[LDS]NattleBat,3262,225,10,11,21,47.6%,10m
10806,3,RomOne,3262,200,7,0,7,100.0%,17m
10806,3,borrze,3262,0,5,3,8,62.5%,5m
10806,3,QuakeII,3262,145,5,6,11,45.5%,24m
10806,3,Chucky,3262,0,4,1,5,80.0%,18m
10806,3,BearLeG,3262,78,4,8,12,33.3%,7m
10806,3,[BBOW]MouThieR,3262,86,3,2,5,60.0%,14m
10806,3,WhiteRa,3262,86,3,6,9,33.3%,6m
10806,3,Krisstad,3262,0,1,0,1,100.0%,7m
10806,3,[Poire]BlopPcT,3262,0,1,1,2,50.0%,17m
10806,3,isak,3262,30,1,1,2,50.0%,17m
10806,3,[Wø]Ptynat,3262,0,1,2,3,33.3%,21m
10806,3,ЛовкийЗерг,3262,30,1,2,3,33.3%,21m
10806,3,Bishop,3262,0,0,1,1,0.0%,19m
10806,3,Aheron,3262,0,0,1,1,0.0%,6m
10827,3,[WАSD]scandium,3261,1429,198,176,374,52.9%,2m
10827,3,BeZOOM,3261,1498,169,159,328,51.5%,10m
10827,3,Tipsy,3261,1543,108,101,209,51.7%,3m
10827,3,Mithrandir,3261,1454,75,76,151,49.7%,7m
10827,3,Big,3261,656,28,15,43,65.1%,16m
10827,3,[AoT]gray,3261,174,15,20,35,42.9%,12m
10827,3,BUDDIST,3261,209,10,9,19,52.6%,6m
10827,2,RaulSpn,3261,257,8,4,12,66.7%,23m
10827,3,[PEEPE]MarcoD,3261,232,8,10,18,44.4%,21m
10827,3,Foreiro,3261,116,5,13,18,27.8%,10m
10827,2,Ghorde,3261,0,4,1,5,80.0%,26m
10827,3,[Hаsu]Airi,3261,151,4,5,9,44.4%,12m
10827,3,[LaB]RoseCodex,3261,157,4,7,11,36.4%,6m
10827,3,[Lambro]redflashBG,3261,30,2,2,4,50.0%,7m
10827,3,HellTos,3261,0,1,0,1,100.0%,7m
10827,3,[swann]eltaiger,3261,30,1,6,7,14.3%,23m
10827,3,[AiRǂ]Dyprax,3261,0,0,1,1,0.0%,5m
10827,3,[NiGL]Deontay,3261,0,0,1,1,0.0%,10m
10827,3,Dithmarscher,3261,0,0,1,1,0.0%,2m
10827,3,romchikk,3261,0,0,4,4,0.0%,15m
10847,3,[IceHus]Kantara,3260,1235,121,118,239,50.6%,17m
10847,3,HyperXCubeOS,3260,1531,81,87,168,48.2%,5m
10847,3,Volkodav,3260,1470,71,78,149,47.7%,5m
10847,3,WildGuy,3260,335,70,60,130,53.8%,3m
10847,3,Conguer,3260,778,30,27,57,52.6%,23m
10847,3,[JaPP]LeTLe,3260,726,27,24,51,52.9%,2m
10847,3,[H2OKT]focation,3260,456,17,16,33,51.5%,5m
10847,3,[SCDHun]Zesedar,3260,255,11,8,19,57.9%,9m
10847,3,MML,3260,294,10,4,14,71.4%,14m
10847,3,[4Lords]SunTzu,3260,0,5,0,5,100.0%,23m
10847,1,CutieBST,3260,96,5,2,7,71.4%,23m
10847,3,[TCSL]Shloops,3260,122,5,11,16,31.2%,4m
10847,3,Battleprobe,3260,0,4,1,5,80.0%,5m
10847,3,[Arrows]FishOnFire,3260,58,3,0,3,100.0%,16m
10847,3,[1FU2]FELASAF,3260,60,3,3,6,50.0%,5m
10847,3,[ReDo]RaZZOOM,3260,30,2,1,3,66.7%,2m
10847,3,[GАYSS]БИБА,3260,0,1,0,1,100.0%,18m
10847,3,SPLASH,3260,30,1,2,3,33.3%,15m
10847,3,Europa,3260,0,0,1,1,0.0%,2m
10847,3,Xenigma,3260,0,0,1,1,0.0%,8m
10847,3,[ReWall]FunnY,3260,0,0,1,1,0.0%,20m
10847,3,[ZERGML]JermainD,3260,0,0,1,1,0.0%,18m
10869,3,LightStorm,3259,1589,186,190,376,49.5%,14m
10869,3,Olden,3259,1479,122,106,228,53.5%,18m
10869,3,CheesePlayer,3259,1265,114,92,206,55.3%,21m
10869,3,MindBlues,3259,1442,65,61,126,51.6%,4m
10869,3,bGd,3259,1236,46,49,95,48.4%,20m
10869,3,[LMBD]SirD,3259,326,12,19,31,38.7%,4m
10869,3,WeiGO,3259,232,10,5,15,66.7%,7m
10869,3,Lurtz,3259,238,9,9,18,50.0%,16m
10869,3,Xrust,3259,94,5,1,6,83.3%,4m
10869,1,Nevermore,3259,0,5,2,7,71.4%,17m
10869,3,GripGni,3259,88,3,6,9,33.3%,22m
10869,1,[8000ms]fenfenzhong,3259,97,2,0,2,100.0%,9m
10869,3,[PLA2N]AmoralDed,3259,30,2,2,4,50.0%,16m
10869,3,BeastyFlw,3259,0,1,4,5,20.0%,20m
10869,3,IsmaTime,3259,0,0,1,1,0.0%,6m
10869,3,llllllllllll,3259,0,0,1,1,0.0%,18m
10869,3,Flu,3259,0,0,3,3,0.0%,9m
10886,3,VOVAN,3258,1564,279,278,557,50.1%,19m
10886,3,bluecraker,3258,809,165,124,289,57.1%,22m
10886,3,Dom,3258,1554,83,92,175,47.4%,15m
10886,3,voices,3258,1004,49,38,87,56.3%,11m
10886,2,Krenton,3258,701,35,40,75,46.7%,3m
10886,3,BartekM,3258,488,19,16,35,54.3%,14m
10886,3,theconkerer,3258,454,17,18,35,48.6%,18m
10886,3,MMA,3258,377,14,10,24,58.3%,23m
10886,3,[NWGD]Warrior,3258,260,10,12,22,45.5%,4m
10886,2,[NotEM]Edpayasugo,3258,0,4,1,5,80.0%,30m
10886,2,SurlierCLOUD,3258,0,4,1,5,80.0%,28m
10886,3,Siddhartha,3258,94,4,2,6,66.7%,22m
10886,3,Starfury,3258,20,1,3,4,25.0%,23m
10886,3,BlAckImPAcT,3258,0,1,4,5,20.0%,16m
10900,3,Rastafarai,3257,1576,157,156,313,50.2%,17m
10900,3,[PEKLO]inferno,3257,1573,110,104,214,51.4%,15m
10900,3,decel,3257,1619,98,89,187,52.4%,14m
10900,3,[696]PraDraGoN,3257,573,36,33,69,52.2%,6m
10900,3,[CocSac]вкусняшка,3257,830,35,21,56,62.5%,7m
10900,3,BoingBoing,3257,593,25,19,44,56.8%,22m
10900,3,[QTcIub]eVoLuTiOn,3257,560,22,19,41,53.7%,12m
10900,3,asd,3257,481,17,15,32,53.1%,11m
10900,3,MasterMind,3257,219,8,7,15,53.3%,14m
10900,3,sOs,3257,125,6,2,8,75.0%,6m
10900,3,HandofDeath,3257,161,5,0,5,100.0%,5m
10900,3,MMRtaxman,3257,120,5,4,9,55.6%,6m
10900,2,[RVT]FXDisRuptor,3257,0,4,1,5,80.0%,34m
10900,3,Alekshka,3257,124,4,12,16,25.0%,14m
10900,3,Ignacio,3257,92,3,4,7,42.9%,20m
10900,3,limak,3257,0,1,0,1,100.0%,23m
10900,3,gioele,3257,0,1,1,2,50.0%,20m
10900,3,[LinEs]YuNIK,3257,0,1,7,8,12.5%,20m
10900,3,[Hrr]BOEHKOM,3257,0,0,1,1,0.0%,10m
10900,3,[CivW]kjartan,3257,0,0,2,2,0.0%,23m
10920,3,[eXsO]AssKicker,3256,1111,208,201,409,50.9%,16m
10920,3,Spokoman,3256,1054,144,138,282,51.1%,21m
10920,3,WhatEver,3256,1432,71,52,123,57.7%,12m
10920,3,Afterthought,3256,1474,67,49,116,57.8%,5m
10920,3,Revorm,3256,1407,61,47,108,56.5%,8m
10920,3,[KPot]wizmer,3256,800,40,46,86,46.5%,8m
10920,3,[MiA]ëLëphäNt,3256,505,25,11,36,69.4%,9m
10920,3,Kalimor,3256,339,18,19,37,48.6%,13m
10920,3,RolexTheKing,3256,206,8,5,13,61.5%,16m
10920,3,Brucewillis,3256,157,7,2,9,77.8%,19m
10920,3,[ZERGTV]Nishod,3256,184,7,9,16,43.8%,5m
10920,3,Renaissance,3256,142,4,0,4,100.0%,16m
10920,3,MagicSoul,3256,0,4,1,5,80.0%,10m
10920,3,dio,3256,116,4,4,8,50.0%,23m
10920,3,[GoldM]GREMLIN,3256,88,4,5,9,44.4%,12m
10920,3,Arkyon,3256,30,2,1,3,66.7%,17m
10920,3,[Ǽ1]Trex,3256,0,1,0,1,100.0%,19m
10920,3,[SkyCok]Phantom,3256,0,1,1,2,50.0%,15m
10920,3,[ḆŽǤ]grishman,3256,0,0,1,1,0.0%,20m
10920,3,HellraiZR,3256,0,0,1,1,0.0%,12m
10920,3,[4SALE]VodkaForAll,3256,0,0,1,1,0.0%,16m
10920,3,stephan,3256,0,0,2,2,0.0%,12m
10920,3,[scp3]Spirulina,3256,0,0,7,7,0.0%,22m
10943,3,kermeni,3255,1547,156,153,309,50.5%,14m
10943,3,BeBoP,3255,1441,58,53,111,52.3%,7m
10943,3,[FEMA]MiRo,3255,1173,50,35,85,58.8%,9m
10943,3,[ЗЕRGТV]Sabitik,3255,1196,45,53,98,45.9%,14m
10943,3,MadZealot,3255,1070,40,38,78,51.3%,12m
10943,3,Pērkons,3255,466,30,22,52,57.7%,6m
10943,3,Пупырка,3255,429,16,10,26,61.5%,14m
10943,3,Darkflip,3255,262,12,5,17,70.6%,10m
10943,1,[IsNot]BlinkStalker,3255,144,6,3,9,66.7%,1h
10943,3,Mediocre,3255,58,3,0,3,100.0%,5m
10943,3,GoSuGhOsT,3255,60,3,4,7,42.9%,14m
10943,3,Highmage,3255,30,2,1,3,66.7%,14m
10943,3,Strannik,3255,0,1,1,2,50.0%,22m
10943,3,Przemson,3255,0,0,1,1,0.0%,11m
10957,3,AngmarKing,3254,1559,165,155,320,51.6%,10m
10957,3,PhysoTronic,3254,997,125,108,233,53.6%,20m
10957,3,Lukas,3254,1028,81,93,174,46.6%,2m
10957,3,Cosmi,3254,1569,79,91,170,46.5%,17m
10957,3,Tosis,3254,1237,69,54,123,56.1%,8m
10957,3,Negod,3254,1582,69,56,125,55.2%,19m
10957,3,VoidRays,3254,1470,64,57,121,52.9%,23m
10957,3,[SТAR]LoganRU,3254,295,15,13,28,53.6%,12m
10957,3,[GROSEX]Snakiss,3254,368,13,14,27,48.1%,20m
10957,2,Core,3254,96,5,2,7,71.4%,20m
10957,3,LarsMorten,3254,0,4,1,5,80.0%,20m
10957,2,WhenYou,3254,0,4,1,5,80.0%,33m
10957,3,[ISCF]Gizzi,3254,159,4,3,7,57.1%,16m
10957,3,Napoléon,3254,58,2,9,11,18.2%,6m
10957,2,IIIIIIIIIIII,3254,0,1,0,1,100.0%,1h
10957,3,LeRollier,3254,0,1,1,2,50.0%,15m
10957,3,Padoman,3254,0,0,2,2,0.0%,20m
10974,3,Trakas,3253,1017,164,148,312,52.6%,9m
10974,3,Izzaqui,3253,874,164,154,318,51.6%,2m
10974,3,arxz,3253,1592,103,94,197,52.3%,23m
10974,3,BillyBibbit,3253,667,40,23,63,63.5%,23m
10974,3,Rezkin,3253,648,35,22,57,61.4%,4m
10974,3,shaco,3253,555,21,19,40,52.5%,19m
10974,2,[xISOx]IsoHEXan,3253,372,17,15,32,53.1%,18m
10974,3,[Yoga]Kundalini,3253,0,4,1,5,80.0%,23m
10974,3,Mephisto,3253,58,2,1,3,66.7%,16m
10974,3,Flex,3253,30,2,2,4,50.0%,5m
10974,3,[DERMID]DERICTOR,3253,0,1,2,3,33.3%,10m
10974,2,Rippon,3253,0,0,1,1,0.0%,1h
10986,3,[JaneK]TSJ,3252,433,79,74,153,51.6%,2m
10986,3,Daedlypuppy,3252,1090,77,59,136,56.6%,9m
10986,2,[BWArmy]Slazy,3252,992,72,56,128,56.2%,3m
10986,2,StockySteak,3252,98,16,35,51,31.4%,19m
10986,3,llllllllllll,3252,407,15,23,38,39.5%,20m
10986,3,evykhait,3252,360,13,12,25,52.0%,8m
10986,3,Orcoz,3252,241,12,6,18,66.7%,10m
10986,2,Corru,3252,277,12,8,20,60.0%,21m
10986,3,togostyrael,3252,256,11,9,20,55.0%,10m
10986,3,IIIIIIIIIIII,3252,266,11,10,21,52.4%,6m
10986,3,Reuq,3252,162,8,3,11,72.7%,16m
10986,2,Java,3252,92,6,3,9,66.7%,26m
10986,3,fikumiku,3252,143,4,0,4,100.0%,14m
10986,3,LXST,3252,58,3,1,4,75.0%,20m
10986,3,LonelyOrenot,3252,143,3,1,4,75.0%,4m
10986,3,[Cheats]MasterMind,3252,58,3,2,5,60.0%,12m
10986,3,[Alicor]bourpif,3252,61,3,2,5,60.0%,9m
10986,3,Lovorko,3252,30,1,1,2,50.0%,17m
10986,3,Max,3252,30,1,4,5,20.0%,5m
10986,3,tesszero,3252,0,0,1,1,0.0%,4m
10986,3,[Vørtëx]Hakon,3252,0,0,3,3,0.0%,4m
11007,3,qiita,3251,1563,189,187,376,50.3%,8m
11007,3,Funkjoker,3251,1626,157,154,311,50.5%,3m
11007,3,aal,3251,742,123,126,249,49.4%,19m
11007,3,TERrOR,3251,1584,111,117,228,48.7%,19m
11007,3,[ZERGТV]VICTOR,3251,713,46,32,78,59.0%,13m
11007,3,Naupilus,3251,526,23,17,40,57.5%,21m
11007,3,crypton,3251,409,15,13,28,53.6%,2m
11007,3,firestarter,3251,370,13,20,33,39.4%,5m
11007,3,Kserany,3251,0,5,0,5,100.0%,1h
11007,2,SuperFeeder,3251,95,4,2,6,66.7%,1h
11007,3,Milcheis,3251,88,3,3,6,50.0%,22m
11007,3,[DF5]BudSpenzer,3251,30,2,0,2,100.0%,5m
11007,3,Zuko,3251,0,1,3,4,25.0%,22m
11007,3,[ePro]Clipstar,3251,30,1,7,8,12.5%,8m
11007,3,Fellows,3251,0,0,1,1,0.0%,17m
11007,3,[Z3RG7V]FlashORC,3251,0,0,1,1,0.0%,21m
11007,3,ProbeProbius,3251,0,0,1,1,0.0%,6m
11024,3,ARGYS,3250,1556,194,182,376,51.6%,11m
11024,3,serdjao,3250,1475,97,72,169,57.4%,20m
11024,3,Heresy,3250,1606,95,89,184,51.6%,16m
11024,3,Japszii,3250,1091,45,38,83,54.2%,22m
11024,3,Azazel,3250,458,43,35,78,55.1%,19m
11024,3,[AusGam]Governorth,3250,957,40,35,75,53.3%,6m
11024,3,AnungUnRama,3250,751,35,42,77,45.5%,16m
11024,3,[mfixed]Gafaran,3250,818,32,24,56,57.1%,20m
11024,3,[J4E]iReve,3250,578,23,21,44,52.3%,5m
11024,3,[РЛП]Ofect,3250,286,9,7,16,56.2%,3m
11024,3,[ZЕRGML]РаГнАрОс,3250,152,6,9,15,40.0%,2m
11024,3,dAnger,3250,166,5,1,6,83.3%,23m
11024,3,qwersiK,3250,0,4,1,5,80.0%,10m
11024,3,[INNOVA]MrDeath,3250,0,1,0,1,100.0%,20m
11024,3,[SSC2]DeDMaZaY,3250,0,1,0,1,100.0%,24m
11024,1,Spudnik,3250,0,1,1,2,50.0%,22m
11024,3,PinZaaar,3250,0,1,4,5,20.0%,2m
11041,3,Raijii,3249,1093,251,253,504,49.8%,5m
11041,2,[GSSCRY]phndron,3249,1365,225,262,487,46.2%,5m
11041,3,Pyszczak,3249,918,101,104,205,49.3%,3m
11041,3,AltTab,3249,1494,91,78,169,53.8%,6m
11041,3,TYRevelation,3249,1280,75,71,146,51.4%,8m
11041,3,[lMMl]SepiSepi,3249,378,52,11,63,82.5%,13m
11041,2,Babayaga,3249,1289,46,58,104,44.2%,16m
11041,3,[HBGSJR]HackErIsTop,3249,238,38,18,56,67.9%,22m
11041,3,TronJavolta,3249,605,27,22,49,55.1%,5m
11041,3,SwEetTooTh,3249,464,20,8,28,71.4%,2m
11041,3,[KOTC]Feliks,3249,221,10,4,14,71.4%,6m
11041,2,[F42]Nuklearwurst,3249,270,10,20,30,33.3%,15m
11041,3,Ulrezaj,3249,268,9,5,14,64.3%,10m
11041,3,[НТТ]Machpella,3249,213,7,2,9,77.8%,8m
11041,3,TheFlow,3249,86,4,5,9,44.4%,12m
11041,3,[GGZERG]Bane,3249,0,1,0,1,100.0%,4m
11041,3,Atinium,3249,0,1,0,1,100.0%,2m
11041,3,IWIking,3249,0,1,0,1,100.0%,2m
11041,3,AlphaJoe,3249,0,1,4,5,20.0%,10m
11041,3,SchurupIK,3249,0,0,2,2,0.0%,20m
11061,3,Scribller,3248,1588,379,353,732,51.8%,19m
11061,3,[XMAN]JefeK,3248,1588,372,369,741,50.2%,11m
11061,3,Fly,3248,1543,84,79,163,51.5%,14m
11061,3,[FB3]emiltheman,3248,925,38,32,70,54.3%,14m
11061,3,[PVDG]Psycho,3248,612,28,15,43,65.1%,21m
11061,3,[SSC2]DarkRepear,3248,257,16,13,29,55.2%,8m
11061,3,Kachechka,3248,430,15,19,34,44.1%,24m
11061,3,Excrucio,3248,218,7,4,11,63.6%,11m
11061,3,Bierboot,3248,176,6,15,21,28.6%,10m
11061,3,llllllllllll,3248,0,4,1,5,80.0%,2m
11061,3,SuDerk,3248,0,4,1,5,80.0%,17m
11061,3,[KoyBee]DjSwagbat,3248,119,4,4,8,50.0%,6m
11061,3,Polarized,3248,122,4,12,16,25.0%,8m
11061,3,mumnum,3248,88,3,5,8,37.5%,12m
11061,3,Zankage,3248,88,3,5,8,37.5%,16m
11061,1,BarrettRTS,3248,96,2,2,4,50.0%,31m
11061,3,[Anim4l]DrFatch,3248,30,2,3,5,40.0%,23m
11061,3,[МLР]PrCelestia,3248,30,1,1,2,50.0%,11m
11061,3,alaise,3248,0,0,1,1,0.0%,16m
11080,3,tankre,3247,1640,202,189,391,51.7%,2m
11080,3,Badboy,3247,1571,129,122,251,51.4%,17m
11080,3,xNile,3247,1567,127,102,229,55.5%,14m
11080,3,[ZUBS]Falcon,3247,1272,88,73,161,54.7%,16m
11080,3,kingrral,3247,1590,86,85,171,50.3%,12m
11080,3,Exefantom,3247,1382,58,49,107,54.2%,6m
11080,3,Zibbang,3247,1146,57,67,124,46.0%,9m
11080,3,[пепега]Katharsis,3247,436,14,27,41,34.1%,22m
11080,3,[ZCrew]turtle,3247,343,11,10,21,52.4%,23m
11080,3,IIIIIIIIllII,3247,215,10,5,15,66.7%,12m
11080,2,KevinCostner,3247,252,10,7,17,58.8%,12m
11080,3,dodoodle,3247,211,10,9,19,52.6%,13m
11080,3,chupao,3247,218,8,7,15,53.3%,5m
11080,3,IIIIIIIIIIII,3247,86,5,8,13,38.5%,22m
11080,3,Gstar,3247,128,4,2,6,66.7%,20m
11080,3,magejiTerran,3247,70,4,6,10,40.0%,8m
11080,3,[M00S3]Cerebrol,3247,60,3,8,11,27.3%,16m
11080,3,Endless,3247,94,2,0,2,100.0%,23m
11080,3,Berg,3247,58,2,2,4,50.0%,19m
11080,3,[BTNB]Barbarry,3247,30,1,2,3,33.3%,9m
11080,3,ZёrgImba,3247,30,1,3,4,25.0%,12m
11080,3,ChibaCityblu,3247,0,0,1,1,0.0%,9m
11080,3,Dramblys,3247,0,0,1,1,0.0%,3m
11080,3,[mTm]Aghost,3247,0,0,1,1,0.0%,8m
11080,3,Gramps,3247,0,0,1,1,0.0%,22m
11080,3,[Витязи]SPENT,3247,0,0,3,3,0.0%,22m
11106,3,[3DE]badseed,3246,847,115,124,239,48.1%,3m
11106,3,VidHartt,3246,1506,80,75,155,51.6%,7m
11106,3,[WPru]DTC,3246,828,73,63,136,53.7%,17m
11106,3,[Oops]Randsan,3246,1105,49,49,98,50.0%,15m
11106,3,[NiN]sofie,3246,574,27,38,65,41.5%,13m
11106,3,EzRA,3246,530,22,21,43,51.2%,5m
11106,3,[C02133]phil,3246,420,20,11,31,64.5%,6m
11106,3,ZeroAPM,3246,213,10,6,16,62.5%,14m
11106,2,bukuwhy,3246,158,8,6,14,57.1%,22m
11106,3,SkillShooteR,3246,210,8,8,16,50.0%,17m
11106,3,TommyStone,3246,210,8,10,18,44.4%,7m
11106,3,Rotnacum,3246,232,8,12,20,40.0%,12m
11106,3,llllllllllll,3246,148,7,3,10,70.0%,5m
11106,3,[PLA2N]ZoraLetnij,3246,237,7,5,12,58.3%,23m
11106,3,HEASAGER,3246,156,6,5,11,54.5%,5m
11106,3,Handragor,3246,60,2,2,4,50.0%,19m
11106,2,[GZerO]Luther,3246,40,2,5,7,28.6%,3m
11106,3,Vell,3246,0,0,2,2,0.0%,12m
11106,3,[ARTROZ]Funky,3246,0,0,5,5,0.0%,19m
11106,2,[JS]bubiyascha,3246,0,0,11,11,0.0%,20m
11126,2,[RGSC2]MrLEzOffFire,3245,1426,268,217,485,55.3%,6m
11126,3,armax,3245,1160,153,135,288,53.1%,10m
11126,3,Lukas,3245,766,106,75,181,58.6%,4m
11126,3,[klanix]mamhinsyhn,3245,1452,103,104,207,49.8%,15m
11126,3,Quantum,3245,1555,102,91,193,52.8%,7m
11126,3,Kaiser,3245,1020,54,41,95,56.8%,12m
11126,3,Kera,3245,782,47,29,76,61.8%,17m
11126,3,Nostrus,3245,269,44,42,86,51.2%,3m
11126,3,Асасин,3245,997,40,37,77,51.9%,10m
11126,3,Guska,3245,709,29,25,54,53.7%,21m
11126,3,Phil,3245,313,20,22,42,47.6%,10m
11126,3,JustPlayer,3245,317,11,8,19,57.9%,22m
11126,3,Iowa,3245,150,8,1,9,88.9%,8m
11126,3,Havest,3245,0,5,0,5,100.0%,33m
11126,3,[CSM]CosmicSim,3245,178,5,4,9,55.6%,4m
11126,3,[ULTX]Apolcalpyse,3245,86,4,2,6,66.7%,5m
11126,3,Specialiste,3245,88,3,5,8,37.5%,20m
11126,3,Ich,3245,58,2,1,3,66.7%,2m
11126,3,[JCLM]Shirp,3245,58,2,4,6,33.3%,22m
11126,3,KayKay,3245,0,0,1,1,0.0%,10m
11126,3,nibbler,3245,0,0,1,1,0.0%,23m
11126,3,[THANOS]satanja,3245,0,0,1,1,0.0%,9m
11148,3,glaukoma,3244,927,74,52,126,58.7%,18m
11148,3,MeThraTon,3244,831,34,38,72,47.2%,13m
11148,3,Kryp,3244,304,25,15,40,62.5%,23m
11148,3,FavoOa,3244,276,11,7,18,61.1%,21m
11148,3,Maykoto,3244,145,5,0,5,100.0%,22m
11148,3,jisungpark,3244,148,5,6,11,45.5%,14m
11148,3,[FD69]Kindersoldat,3244,0,4,1,5,80.0%,4m
11148,3,JubaR,3244,65,4,3,7,57.1%,7m
11148,3,[NMSQ]Sareth,3244,165,4,5,9,44.4%,21m
11148,3,Niram,3244,0,1,0,1,100.0%,24m
11148,3,galdomir,3244,0,1,1,2,50.0%,14m
11148,3,[tospid]хелмистер,3244,0,0,4,4,0.0%,2m
11160,3,Saturnus,3243,584,147,125,272,54.0%,4m
11160,3,StarLorD,3243,556,20,23,43,46.5%,19m
11160,3,Tamme,3243,402,15,18,33,45.5%,19m
11160,3,[TZGswe]Perra,3243,378,14,18,32,43.8%,10m
11160,3,[PC75]Superbikee,3243,281,13,10,23,56.5%,6m
11160,3,arbok,3243,191,10,5,15,66.7%,23m
11160,2,[Drachw]ponken,3243,236,9,4,13,69.2%,18m
11160,3,ferdi,3243,0,4,1,5,80.0%,4m
11160,3,CestHonteux,3243,0,4,1,5,80.0%,5m
11160,3,LittleAksMax,3243,114,4,7,11,36.4%,11m
11160,3,Rusmag,3243,120,3,1,4,75.0%,21m
11160,3,folloburg,3243,0,1,0,1,100.0%,14m
11160,3,[1DLE]Random,3243,0,1,0,1,100.0%,12m
11160,3,Kitchentable,3243,0,1,1,2,50.0%,2m
11160,3,[IXXI]Rod,3243,0,0,1,1,0.0%,14m
11160,3,yuratim,3243,0,0,1,1,0.0%,2m
11176,3,dooznet,3242,1492,117,93,210,55.7%,16m
11176,3,Tendo,3242,911,84,86,170,49.4%,3m
11176,3,[FENIKS]Imbech,3242,1296,54,48,102,52.9%,5m
11176,3,Phaser,3242,1166,50,37,87,57.5%,23m
11176,3,Stemir,3242,931,48,53,101,47.5%,13m
11176,3,CrazyT,3242,792,40,20,60,66.7%,10m
11176,3,Robbog,3242,911,36,33,69,52.2%,20m
11176,3,[Izrod]MegaIzrod,3242,354,27,26,53,50.9%,10m
11176,3,megapapa,3242,712,27,29,56,48.2%,6m
11176,3,Jason,3242,514,20,14,34,58.8%,5m
11176,1,Mutal,3242,387,15,11,26,57.7%,5m
11176,1,Rooster,3242,273,14,9,23,60.9%,22m
11176,3,[TAW]Sulkosaurus,3242,390,13,20,33,39.4%,2m
11176,3,MagicTerran,3242,216,11,5,16,68.8%,8m
11176,3,Kovalsky,3242,226,11,9,20,55.0%,20m
11176,3,backdoordan,3242,218,10,6,16,62.5%,20m
11176,3,WarchieFF,3242,230,8,10,18,44.4%,9m
11176,3,[Uaks]Stenforcer,3242,200,7,10,17,41.2%,23m
11176,3,Quasar,3242,219,7,10,17,41.2%,9m
11176,3,[TDOW]Trimer,3242,213,6,3,9,66.7%,22m
11176,2,Nazerot,3242,165,5,2,7,71.4%,25m
11176,3,[voff]Yeezus,3242,0,4,1,5,80.0%,11m
11176,3,GRELLIGUNN,3242,58,3,2,5,60.0%,6m
11176,3,avpauleu,3242,145,3,5,8,37.5%,9m
11176,3,Axamitny,3242,30,2,4,6,33.3%,12m
11176,3,GwnMartijn,3242,0,1,1,2,50.0%,12m
11176,3,RedDevil,3242,30,1,1,2,50.0%,18m
11176,3,[NoSepi]TheMarcklar,3242,0,0,1,1,0.0%,6m
11176,3,Unforgiven,3242,0,0,1,1,0.0%,19m
11176,3,grom,3242,0,0,2,2,0.0%,8m
11206,3,[THINK]Eska,3241,1043,133,87,220,60.5%,19m
11206,3,khodosss,3241,1239,123,120,243,50.6%,11m
11206,3,sajinprince,3241,1563,118,127,245,48.2%,22m
11206,3,aczf,3241,1569,105,102,207,50.7%,16m
11206,3,Obiwan,3241,1586,78,54,132,59.1%,4m
11206,3,teoden,3241,990,64,48,112,57.1%,18m
11206,3,jblx,3241,350,22,11,33,66.7%,15m
11206,3,[G4VR]TOREMPP,3241,442,21,16,37,56.8%,3m
11206,3,Woddy,3241,241,15,12,27,55.6%,17m
11206,3,[HDTV]USax,3241,310,12,9,21,57.1%,6m
11206,3,sdu,3241,296,10,12,22,45.5%,8m
11206,3,[DøA]Altair,3241,287,9,10,19,47.4%,11m
11206,3,[Jinho]brahms,3241,228,8,7,15,53.3%,24m
11206,3,Bravenator,3241,144,7,3,10,70.0%,14m
11206,3,lllllllll,3241,58,3,0,3,100.0%,6m
11206,3,[Yame]Matisse,3241,118,2,1,3,66.7%,7m
11206,3,SPECTRUS,3241,58,2,2,4,50.0%,12m
11206,3,[MTBB]Norbert,3241,0,0,1,1,0.0%,20m
11206,3,JOHNBOY,3241,0,0,2,2,0.0%,17m
11206,3,LuckyStar,3241,0,0,5,5,0.0%,22m
11226,3,NEOLIBERATE,3240,1514,75,85,160,46.9%,7m
11226,2,BattleBot,3240,1566,73,94,167,43.7%,16m
11226,3,[Tостер]KzFantomKz,3240,1551,71,52,123,57.7%,22m
11226,3,VechnoOdinok,3240,1260,71,68,139,51.1%,17m
11226,3,Mush,3240,471,23,18,41,56.1%,2m
11226,3,[Донный]kill,3240,484,20,8,28,71.4%,7m
11226,3,Bejebas,3240,249,15,10,25,60.0%,6m
11226,3,Denisined,3240,312,11,5,16,68.8%,20m
11226,3,[synTWD]Roach,3240,258,10,8,18,55.6%,3m
11226,3,[LESeV]iceclaw,3240,267,8,10,18,44.4%,19m
11226,3,Elektroman,3240,95,5,1,6,83.3%,9m
11226,2,[shenan]Rabbit,3240,30,2,9,11,18.2%,15m
11226,3,[Silv3r]sQuirel,3240,0,1,0,1,100.0%,6m
11226,3,Alicc,3240,0,1,0,1,100.0%,11m
11226,3,Burrito,3240,0,1,4,5,20.0%,10m
11241,3,McToad,3239,442,83,73,156,53.2%,16m
11241,3,DiuDiuOR,3239,1537,72,63,135,53.3%,18m
11241,3,badidea,3239,1343,71,74,145,49.0%,11m
11241,3,Lym,3239,1172,51,43,94,54.3%,17m
11241,3,Kioal,3239,444,19,7,26,73.1%,11m
11241,3,[Silvеr]Hack,3239,304,14,7,21,66.7%,20m
11241,2,Vozel,3239,317,13,8,21,61.9%,17m
11241,3,AubeZero,3239,306,13,13,26,50.0%,6m
11241,3,Leeroy,3239,298,10,5,15,66.7%,23m
11241,3,HardGamer,3239,186,6,2,8,75.0%,16m
11241,3,[sfc]Ares,3239,58,4,7,11,36.4%,11m
11241,3,Sweetroll,3239,117,2,1,3,66.7%,16m
11241,3,[BElad]Entropy,3239,0,1,0,1,100.0%,2m
11241,3,RecurseMask,3239,0,0,3,3,0.0%,20m
11255,3,Walternate,3238,1562,142,125,267,53.2%,9m
11255,3,LIfeLover,3238,1095,129,105,234,55.1%,4m
11255,3,XHunterX,3238,1340,98,68,166,59.0%,7m
11255,3,Kiarna,3238,893,86,77,163,52.8%,22m
11255,3,[Årtik]Pingu,3238,706,50,47,97,51.5%,10m
11255,3,Bubbles,3238,337,36,30,66,54.5%,10m
11255,3,[TDOW]Kikimora,3238,220,22,22,44,50.0%,10m
11255,3,[leOS]Civolt,3238,398,17,8,25,68.0%,6m
11255,3,[L2CM]MyKi,3238,410,15,14,29,51.7%,4m
11255,3,[WNTR]CryVI,3238,332,12,11,23,52.2%,15m
11255,3,antisatsuma,3238,185,11,4,15,73.3%,18m
11255,3,XFooLoR,3238,296,10,8,18,55.6%,17m
11255,3,[ZZW]Radiscus,3238,122,6,2,8,75.0%,14m
11255,3,télowmdr,3238,114,5,4,9,55.6%,10m
11255,3,Celeste,3238,130,5,5,10,50.0%,22m
11255,3,llllllllllll,3238,0,4,1,5,80.0%,11m
11255,3,[nK]Anubis,3238,94,4,2,6,66.7%,22m
11255,3,ferefar,3238,114,4,3,7,57.1%,19m
11255,3,Tempest,3238,114,4,5,9,44.4%,24m
11255,3,enRaGe,3238,119,3,0,3,100.0%,13m
11255,3,padda,3238,44,3,1,4,75.0%,2m
11255,2,[Kemi]Siska,3238,127,3,3,6,50.0%,18m
11255,3,Nowarich,3238,93,3,3,6,50.0%,21m
11255,3,[Girlie]JenniFear,3238,114,2,2,4,50.0%,15m
11255,3,Wolfyx,3238,60,2,10,12,16.7%,19m
11255,2,[APs]Fitz,3238,0,1,0,1,100.0%,5m
11255,3,[Bouzeu]Dramir,3238,0,1,0,1,100.0%,17m
11255,3,IIIIIIIIIIII,3238,0,0,1,1,0.0%,24m
11255,3,BlizZarcl,3238,0,0,1,1,0.0%,9m
11255,3,Shakira,3238,0,0,3,3,0.0%,23m
11285,3,SERGO,3237,1460,205,207,412,49.8%,2m
11285,3,beautifulman,3237,1590,194,160,354,54.8%,20m
11285,3,TheEnigmaTNG,3237,1481,125,88,213,58.7%,23m
11285,3,llllllllllll,3237,1049,55,51,106,51.9%,22m
11285,3,Sedativ,3237,920,35,33,68,51.5%,3m
11285,3,PoPoY,3237,605,34,25,59,57.6%,16m
11285,3,[ONLAN]Kalexx,3237,887,33,43,76,43.4%,6m
11285,3,[TMGM]Shadow,3237,598,32,41,73,43.8%,15m
11285,3,NotoriouHeky,3237,709,29,24,53,54.7%,12m
11285,3,Sanczezz,3237,428,21,16,37,56.8%,22m
11285,3,SHOOTNIK,3237,462,19,8,27,70.4%,9m
11285,3,GBA,3237,324,12,15,27,44.4%,8m
11285,3,Traficjam,3237,250,9,20,29,31.0%,2m
11285,3,[ǂMWRǂ]GoOn,3237,148,6,8,14,42.9%,9m
11285,3,kBen,3237,119,3,0,3,100.0%,16m
11285,3,Phantom,3237,58,3,3,6,50.0%,14m
11285,2,[Mohala]Såsbaronen,3237,123,2,2,4,50.0%,5m
11285,3,[SEKN]SecondTry,3237,0,1,0,1,100.0%,10m
11285,1,[piknes]WyRmiE,3237,97,1,1,2,50.0%,1h
11285,3,[iX]Dyrdek,3237,0,1,6,7,14.3%,12m
11285,3,aenygma,3237,0,0,1,1,0.0%,23m
11306,2,wonfeeling,3236,1009,451,478,929,48.5%,16m
11306,3,Jack,3236,1204,74,54,128,57.8%,14m
11306,3,[FreeN]Shaka,3236,1112,69,77,146,47.3%,8m
11306,3,daywalkerdv,3236,1495,59,66,125,47.2%,2m
11306,3,[LusorS]Goauld,3236,879,40,38,78,51.3%,3m
11306,3,AltcGameR,3236,924,37,28,65,56.9%,11m
11306,3,Strahu,3236,915,37,35,72,51.4%,8m
11306,3,IkillMALL,3236,661,35,40,75,46.7%,19m
11306,3,Iordaness,3236,775,30,24,54,55.6%,2m
11306,3,Dentrts,3236,366,29,18,47,61.7%,6m
11306,3,[ZERGML]KennyOK,3236,570,29,27,56,51.8%,14m
11306,3,[C0LG]xWomenbeater,3236,579,24,15,39,61.5%,14m
11306,3,HeyHoLetsGo,3236,642,24,29,53,45.3%,9m
11306,3,Makc,3236,345,12,8,20,60.0%,19m
11306,3,Saucisse,3236,207,10,6,16,62.5%,21m
11306,3,Chernomor,3236,146,6,4,10,60.0%,19m
11306,3,HeyKappa,3236,148,5,7,12,41.7%,5m
11306,3,Lovespirit,3236,182,4,8,12,33.3%,20m
11306,3,Skiwasser,3236,30,2,1,3,66.7%,13m
11306,3,Scrubby,3236,58,2,3,5,40.0%,19m
11306,3,[HAIGH]Haighstrom,3236,0,1,0,1,100.0%,7m
11306,2,[SAAALZ]Omega,3236,0,1,0,1,100.0%,1h
11306,3,Cleavin,3236,32,1,3,4,25.0%,8m
11306,3,ShaDoW,3236,30,1,4,5,20.0%,6m
11306,3,lrt,3236,0,1,4,5,20.0%,5m
11306,3,[GSTAR]Pain,3236,0,0,1,1,0.0%,11m
11306,3,[VCs]Resboul,3236,0,0,1,1,0.0%,19m
11306,3,DrumAndBass,3236,0,0,1,1,0.0%,23m
11334,2,Focus,3235,1533,280,285,565,49.6%,6m
11334,3,ViRuL,3235,1604,188,158,346,54.3%,11m
11334,3,BezMleka,3235,1570,125,125,250,50.0%,11m
11334,3,IIIIIIIIII,3235,1628,101,84,185,54.6%,6m
11334,3,Hellfire,3235,1267,64,63,127,50.4%,20m
11334,3,Caponetti,3235,980,62,55,117,53.0%,5m
11334,3,tRex,3235,604,22,23,45,48.9%,14m
11334,3,Sky,3235,556,21,19,40,52.5%,3m
11334,3,Frættestær,3235,199,20,19,39,51.3%,3m
11334,3,MbM,3235,370,14,13,27,51.9%,23m
11334,3,Darkthor,3235,310,12,14,26,46.2%,8m
11334,3,[KerriS]Sireals,3235,310,11,6,17,64.7%,6m
11334,2,OneBasePony,3235,191,8,2,10,80.0%,18m
11334,3,[NINJ88]Scorpion,3235,215,7,3,10,70.0%,20m
11334,3,Wiewiór,3235,140,7,4,11,63.6%,17m
11334,3,[MJSTC]NiC,3235,0,4,1,5,80.0%,20m
11334,1,Moose,3235,140,4,3,7,57.1%,31m
11334,3,[P3rsé]Leondor,3235,122,4,5,9,44.4%,16m
11334,3,OnlyMatt,3235,0,1,0,1,100.0%,3m
11334,2,[ZERGML]Svist,3235,0,1,5,6,16.7%,5m
11334,3,DemOolidor,3235,0,0,1,1,0.0%,21m
11334,3,zOrg,3235,0,0,1,1,0.0%,20m
11334,1,Max,3235,0,0,1,1,0.0%,1h
11334,3,Haldir,3235,0,0,2,2,0.0%,11m
11334,1,starfall,3235,0,0,3,3,0.0%,42m
11359,3,Dragonio,3234,1589,328,305,633,51.8%,17m
11359,3,Quad,3234,1541,81,75,156,51.9%,6m
11359,3,[LLTeam]Briac,3234,1287,66,57,123,53.7%,13m
11359,3,FagerTager,3234,386,16,11,27,59.3%,16m
11359,3,Ronan,3234,278,11,5,16,68.8%,21m
11359,3,[1DLE]hoppelchen,3234,118,8,6,14,57.1%,16m
11359,3,DanielSan,3234,120,5,6,11,45.5%,6m
11359,3,Keemstar,3234,114,3,0,3,100.0%,3m
11359,3,Tyranek,3234,30,2,3,5,40.0%,6m
11359,3,zeradun,3234,94,2,4,6,33.3%,8m
11359,3,[KuNi]yurka,3234,0,1,0,1,100.0%,23m
11359,3,Atlas,3234,30,1,2,3,33.3%,11m
11359,3,[NWGD]ksisovec,3234,30,1,6,7,14.3%,9m
11359,3,[AlexYA]MaNaDrEiN,3234,0,0,1,1,0.0%,17m
11359,3,Allisrem,3234,0,0,2,2,0.0%,16m
11374,3,crazysheep,3233,1547,247,236,483,51.1%,6m
11374,3,gogometria,3233,1521,201,182,383,52.5%,16m
11374,3,Steel,3233,797,174,150,324,53.7%,22m
11374,3,ZuKi,3233,1560,130,110,240,54.2%,3m
11374,3,eXtreme,3233,1414,80,86,166,48.2%,2m
11374,2,FlintsCrew,3233,1350,55,80,135,40.7%,8m
11374,3,BICHO,3233,1108,45,45,90,50.0%,23m
11374,3,Predator,3233,975,40,37,77,51.9%,5m
11374,3,[ØC]PRAQ,3233,1040,39,44,83,47.0%,17m
11374,3,Cybersnake,3233,134,9,7,16,56.2%,23m
11374,3,deathcuddler,3233,30,5,2,7,71.4%,17m
11374,3,[HTPSC2]JuPix,3233,142,3,2,5,60.0%,11m
11374,3,[VBros]DalaiLammah,3233,58,3,3,6,50.0%,2m
11374,3,awesomesocks,3233,30,2,1,3,66.7%,5m
11374,3,[dæD]InFeCTedLinG,3233,30,2,5,7,28.6%,9m
11374,3,MindStorm,3233,30,2,8,10,20.0%,15m
11374,3,Dofenschmirz,3233,0,1,0,1,100.0%,18m
11374,3,[WH2D]Fantafil,3233,0,1,0,1,100.0%,16m
11374,3,Lilith,3233,0,1,0,1,100.0%,14m
11374,2,[NOT1ME]soragons,3233,0,0,2,2,0.0%,34m
11374,3,OleksandrXV,3233,0,0,2,2,0.0%,10m
11374,3,[MGL]Zashibuka,3233,0,0,3,3,0.0%,20m
11396,3,[LOGS]SUN,3232,1523,598,560,1158,51.6%,9m
11396,2,MJM,3232,1541,292,308,600,48.7%,13m
11396,3,gameinn,3232,684,111,86,197,56.3%,20m
11396,3,[ExTr1m]Vehadimik,3232,1455,70,55,125,56.0%,18m
11396,3,BigAssMonkey,3232,1532,65,67,132,49.2%,17m
11396,3,Yinlad,3232,846,59,47,106,55.7%,8m
11396,3,[Kompi]Exedo,3232,898,36,28,64,56.2%,7m
11396,3,JouBliksem,3232,571,31,19,50,62.0%,11m
11396,3,llllllllllll,3232,642,26,20,46,56.5%,11m
11396,3,BurmMS,3232,545,21,30,51,41.2%,22m
11396,3,[MАSTER]aleks,3232,235,8,3,11,72.7%,5m
11396,3,pmr,3232,208,7,10,17,41.2%,22m
11396,3,Majestic,3232,114,4,9,13,30.8%,10m
11396,2,[GHFZ]KekeN,3232,120,4,15,19,21.1%,21m
11396,3,[SFight]NoobMaster,3232,138,3,4,7,42.9%,16m
11396,3,Mad,3232,145,3,6,9,33.3%,3m
11396,3,[YEP4VR]Fire,3232,0,1,0,1,100.0%,12m
11396,3,Riptide,3232,0,1,0,1,100.0%,10m
11396,3,крюк,3232,30,1,2,3,33.3%,18m
11396,3,IIIIIIII,3232,0,0,1,1,0.0%,8m
11416,3,[BG45]Zarathoustra,3231,850,34,30,64,53.1%,8m
11416,3,Marf,3231,660,23,32,55,41.8%,24m
11416,3,[wedown]joan,3231,416,16,12,28,57.1%,23m
11416,3,PeCk,3231,129,8,5,13,61.5%,20m
11416,3,Cloud,3231,58,5,4,9,55.6%,14m
11416,2,theXerathor,3231,161,3,1,4,75.0%,4m
11416,3,From,3231,30,2,1,3,66.7%,12m
11416,3,springsong,3231,30,2,5,7,28.6%,22m
11416,3,BlanCo,3231,0,1,4,5,20.0%,21m
11416,3,Doving,3231,0,0,1,1,0.0%,21m
11416,3,Факульминат,3231,0,0,1,1,0.0%,6m
11416,3,PERCHO,3231,0,0,2,2,0.0%,16m
11416,3,[BornG]rafcio,3231,0,0,3,3,0.0%,11m
11429,3,Yougloups,3230,1345,184,157,341,54.0%,10m
11429,3,Mde,3230,1472,145,146,291,49.8%,6m
11429,3,[HBGSJR]snotr,3230,1060,45,34,79,57.0%,21m
11429,3,Foggy,3230,809,34,29,63,54.0%,4m
11429,3,Amiorfin,3230,374,31,39,70,44.3%,8m
11429,3,[EZ4XY]gshxd,3230,263,18,6,24,75.0%,15m
11429,3,Læj,3230,317,14,15,29,48.3%,11m
11429,3,[D0N3]Tehdemonic,3230,314,12,7,19,63.2%,20m
11429,1,brian,3230,188,10,2,12,83.3%,1h
11429,3,[PŖïMĄŁ]Agricultor,3230,110,8,2,10,80.0%,8m
11429,3,gunofbulshlt,3230,165,5,1,6,83.3%,24m
11429,3,max,3230,112,5,4,9,55.6%,8m
11429,3,[InitRu]ozrKeLL,3230,144,5,5,10,50.0%,12m
11429,3,FromAsh,3230,30,5,5,10,50.0%,10m
11429,3,[InƑeS]Hairbear,3230,0,4,1,5,80.0%,14m
11429,3,[ENGNS]RandomGüffel,3230,88,4,3,7,57.1%,6m
11429,3,ThoRN,3230,118,2,1,3,66.7%,22m
11429,3,Limbo,3230,0,1,1,2,50.0%,10m
11429,3,JIegeon,3230,0,1,3,4,25.0%,5m
11429,3,Javisoft,3230,0,1,4,5,20.0%,24m
11429,3,SpaceFREEZER,3230,0,0,1,1,0.0%,7m
11429,3,[IndyK]ManiekD,3230,0,0,1,1,0.0%,22m
11429,3,RiotSlug,3230,0,0,2,2,0.0%,2m
11429,3,[PLA2N]Zarem,3230,0,0,4,4,0.0%,8m
11453,3,bluesky,3229,1540,250,260,510,49.0%,7m
11453,3,Yourdeath,3229,1538,167,171,338,49.4%,10m
11453,3,TyIIIKa,3229,1394,138,138,276,50.0%,10m
11453,3,[Muhaha]San,3229,1490,105,92,197,53.3%,11m
11453,3,Strinkan,3229,1322,92,87,179,51.4%,9m
11453,3,Maksiklax,3229,1155,84,77,161,52.2%,19m
11453,3,Tvard,3229,1117,52,54,106,49.1%,2m
11453,3,avengerone,3229,1173,49,39,88,55.7%,24m
11453,3,[RaLaKn]ToMoKrOwA,3229,930,40,29,69,58.0%,19m
11453,3,Valenok,3229,734,32,22,54,59.3%,22m
11453,3,NestorMakhno,3229,148,7,3,10,70.0%,11m
11453,3,KickAss,3229,90,4,4,8,50.0%,8m
11453,3,LKR,3229,158,3,8,11,27.3%,14m
11453,3,[ILDOIT]Later,3229,0,1,0,1,100.0%,23m
11453,3,[bHumbL]Wildfire,3229,0,1,0,1,100.0%,8m
11453,3,Sunflower,3229,0,1,0,1,100.0%,11m
11453,3,DionJnD,3229,0,1,2,3,33.3%,8m
11453,2,[Моника]Hunter,3229,0,0,1,1,0.0%,10m
11453,3,badpsy,3229,0,0,1,1,0.0%,11m
11453,3,[NAHUY]Karolis,3229,0,0,1,1,0.0%,21m
11473,3,[LBVftw]Oemann,3228,1431,196,196,392,50.0%,6m
11473,3,Brinziberfer,3228,967,41,34,75,54.7%,8m
11473,3,magician,3228,742,38,33,71,53.5%,11m
11473,3,Aronakss,3228,798,37,27,64,57.8%,8m
11473,3,KING,3228,854,32,34,66,48.5%,22m
11473,3,TheLastSam,3228,698,29,23,52,55.8%,16m
11473,3,Istota,3228,483,24,22,46,52.2%,19m
11473,3,GoblinWojny,3228,356,17,9,26,65.4%,12m
11473,3,daveAUT,3228,314,12,12,24,50.0%,18m
11473,3,[LBGTQ]Assblaster,3228,271,11,5,16,68.8%,6m
11473,3,[ezpz]Erdbeerblau,3228,339,11,16,27,40.7%,4m
11473,3,Lox,3228,232,8,1,9,88.9%,17m
11473,3,ToToO,3228,227,8,7,15,53.3%,20m
11473,3,Zannick,3228,94,5,1,6,83.3%,6m
11473,3,Maraton,3228,146,5,10,15,33.3%,11m
11473,3,Doromi,3228,86,4,2,6,66.7%,14m
11473,3,[KnbZ]BrThome,3228,92,4,5,9,44.4%,12m
11473,3,EZRax,3228,90,3,3,6,50.0%,13m
11473,3,Lausbua,3228,30,2,0,2,100.0%,20m
11473,3,ChikoSATAN,3228,60,2,7,9,22.2%,18m
11473,3,Elennor,3228,0,1,0,1,100.0%,4m
11473,3,WidowCruiser,3228,0,1,0,1,100.0%,8m
11473,3,Maxazac,3228,0,0,1,1,0.0%,16m
11496,3,Baton,3227,868,74,57,131,56.5%,14m
11496,3,Kartu,3227,1014,64,53,117,54.7%,8m
11496,3,DarkBerkut,3227,799,38,19,57,66.7%,9m
11496,3,Turtle,3227,356,23,15,38,60.5%,10m
11496,3,OJay,3227,421,23,20,43,53.5%,6m
11496,3,[VDKN]Zeratul,3227,420,18,15,33,54.5%,21m
11496,3,Strache,3227,348,15,13,28,53.6%,12m
11496,3,[DG5500]Sacatop,3227,185,9,4,13,69.2%,6m
11496,1,Wilpat,3227,169,7,4,11,63.6%,33m
11496,3,Lord,3227,58,6,2,8,75.0%,9m
11496,3,Sugar,3227,34,6,4,10,60.0%,17m
11496,3,[QTclub]Leifur,3227,146,5,5,10,50.0%,3m
11496,3,gza,3227,140,3,2,5,60.0%,7m
11496,3,[АDMIN]ZergLing,3227,94,3,9,12,25.0%,6m
11496,3,Realist,3227,96,2,0,2,100.0%,21m
11496,2,gooogenot,3227,117,2,1,3,66.7%,34m
11496,3,PWFD,3227,18,2,1,3,66.7%,6m
11496,3,Korago,3227,97,2,9,11,18.2%,16m
11496,3,[ØN]KIIIIN,3227,0,1,0,1,100.0%,7m
11515,3,Lightcore,3226,1187,239,221,460,52.0%,23m
11515,3,eduarxo,3226,1623,213,185,398,53.5%,14m
11515,3,Rickerik,3226,1500,181,181,362,50.0%,11m
11515,2,Maximus,3226,1462,159,178,337,47.2%,8m
11515,3,Jarkoof,3226,1546,107,102,209,51.2%,10m
11515,3,MonkeyDDrago,3226,1533,100,108,208,48.1%,6m
11515,3,[НОД17]Eagle,3226,512,73,53,126,57.9%,11m
11515,3,Biblo,3226,1099,70,51,121,57.9%,14m
11515,3,PanDa,3226,1013,51,38,89,57.3%,16m
11515,3,SanzeroBG,3226,950,40,31,71,56.3%,9m
11515,3,[RSOF1]LSBOSSES,3226,629,37,42,79,46.8%,17m
11515,3,DeadApolon,3226,703,27,24,51,52.9%,18m
11515,3,llllllllllll,3226,466,22,8,30,73.3%,11m
11515,3,Like,3226,500,20,13,33,60.6%,4m
11515,3,Necromorf,3226,422,14,28,42,33.3%,21m
11515,3,Alpenglow,3226,182,10,7,17,58.8%,17m
11515,3,[ExTr1m]goodbaker,3226,233,9,2,11,81.8%,9m
11515,3,SimonFakePla,3226,154,8,4,12,66.7%,6m
11515,3,[HZeS]Zasada,3226,168,7,6,13,53.8%,15m
11515,3,[IurA]Ghoneth,3226,0,5,0,5,100.0%,22m
11515,3,[Zhig]KiRICH,3226,176,5,2,7,71.4%,8m
11515,3,Trudi,3226,168,5,4,9,55.6%,5m
11515,3,oempa,3226,0,1,0,1,100.0%,5m
11515,3,Ehomer,3226,30,1,5,6,16.7%,3m
11515,2,MrRoach,3226,0,0,1,1,0.0%,10m
11540,3,MioMind,3225,1507,463,463,926,50.0%,8m
11540,3,[ODR]Spirit,3225,432,16,19,35,45.7%,11m
11540,3,pottytrained,3225,320,12,10,22,54.5%,11m
11540,3,[SC2L]Victoria,3225,142,7,3,10,70.0%,5m
11540,1,[DisES]Fristophe,3225,191,7,5,12,58.3%,3m
11540,3,kekeke,3225,135,6,3,9,66.7%,6m
11540,3,Basme,3225,167,5,4,9,55.6%,22m
11540,3,Bamboocha,3225,0,4,1,5,80.0%,1h
11540,2,KarateKyle,3225,118,4,2,6,66.7%,3m
11540,3,mishash,3225,30,3,5,8,37.5%,4m
11540,3,readme,3225,0,1,0,1,100.0%,14m
11540,3,[Pr0t0]Gater,3225,0,1,0,1,100.0%,14m
11540,3,BestAtMe,3225,0,1,0,1,100.0%,9m
11540,1,[tPBC]Bohdan,3225,0,1,0,1,100.0%,6m
11540,3,ciceron,3225,30,1,1,2,50.0%,22m
11540,3,FGAlvaro,3225,0,1,4,5,20.0%,12m
11540,3,[WeSLB]GreeN,3225,0,0,1,1,0.0%,17m
11540,3,Shotl,3225,0,0,1,1,0.0%,16m
11558,3,[zäty]Reno,3224,1330,292,291,583,50.1%,16m
11558,3,Loki,3224,1629,281,266,547,51.4%,13m
11558,3,Elmerll,3224,1483,260,245,505,51.5%,22m
11558,3,Alkadia,3224,1027,109,96,205,53.2%,21m
11558,3,poputu,3224,1403,74,71,145,51.0%,14m
11558,3,ebick,3224,844,66,45,111,59.5%,10m
11558,3,[CM4R]bakermir,3224,1248,53,48,101,52.5%,20m
11558,3,[lOoOl]JackPhantom,3224,397,18,9,27,66.7%,10m
11558,3,[CCake]Kiruma,3224,420,17,9,26,65.4%,10m
11558,3,IMMORTAL,3224,325,16,9,25,64.0%,18m
11558,3,[BURIZA]mercurio,3224,382,15,10,25,60.0%,4m
11558,3,Edmait,3224,219,12,4,16,75.0%,11m
11558,3,JNspatten,3224,292,11,14,25,44.0%,5m
11558,3,oxymoron,3224,288,10,10,20,50.0%,6m
11558,3,RaPh,3224,191,8,5,13,61.5%,18m
11558,3,Asgardian,3224,174,6,9,15,40.0%,5m
11558,3,[r52]AnDz,3224,89,5,4,9,55.6%,15m
11558,3,Itryi,3224,120,4,8,12,33.3%,15m
11558,3,Denчik,3224,0,1,0,1,100.0%,21m
11558,2,nbran,3224,0,1,0,1,100.0%,19m
11558,3,atomas,3224,0,0,5,5,0.0%,20m
11579,3,[Xa]Light,3223,1574,61,64,125,48.8%,14m
11579,3,[beggas]Nyx,3223,608,49,30,79,62.0%,4m
11579,3,SpYcY,3223,1040,46,31,77,59.7%,3m
11579,3,Tywka,3223,782,35,24,59,59.3%,24m
11579,3,Colorless,3223,499,34,17,51,66.7%,16m
11579,3,Humos,3223,356,16,9,25,64.0%,21m
11579,3,Korol,3223,274,12,3,15,80.0%,11m
11579,3,alastor,3223,146,10,5,15,66.7%,24m
11579,3,Gencho,3223,260,10,11,21,47.6%,12m
11579,3,Ultimate,3223,176,7,9,16,43.8%,10m
11579,3,Elvis,3223,210,7,9,16,43.8%,3m
11579,3,SREnigma,3223,97,5,4,9,55.6%,17m
11579,3,[FDK]Eriatolc,3223,0,4,1,5,80.0%,22m
11579,3,srac,3223,0,2,3,5,40.0%,33m
11579,3,Man,3223,0,1,0,1,100.0%,12m
11579,3,blackpapper,3223,94,1,1,2,50.0%,6m
11579,3,LVRos,3223,0,0,1,1,0.0%,15m
11596,3,leonidos,3222,1413,343,320,663,51.7%,14m
11596,3,govnojed,3222,764,205,189,394,52.0%,14m
11596,3,[биотех]WhoIsRem,3222,1415,92,64,156,59.0%,21m
11596,3,Dio,3222,519,81,67,148,54.7%,13m
11596,3,Vesser,3222,759,56,42,98,57.1%,7m
11596,3,Bobi,3222,842,47,45,92,51.1%,2m
11596,3,[PLA2N]barcode,3222,983,41,31,72,56.9%,11m
11596,3,Strider,3222,982,36,35,71,50.7%,4m
11596,3,Justkidding,3222,620,32,28,60,53.3%,18m
11596,3,Fosvihar,3222,871,32,36,68,47.1%,7m
11596,3,Azazello,3222,674,31,33,64,48.4%,19m
11596,3,[Islay]PeatyZzz,3222,472,21,10,31,67.7%,11m
11596,3,juliette,3222,306,19,15,34,55.9%,24m
11596,3,NaNou,3222,447,16,15,31,51.6%,18m
11596,3,[RHood]Slaight,3222,373,15,10,25,60.0%,17m
11596,3,[Yakuza]JuZdOiT,3222,338,12,17,29,41.4%,11m
11596,3,Pantera,3222,116,9,6,15,60.0%,8m
11596,2,immortalsho,3222,140,6,3,9,66.7%,9m
11596,3,[загадк]путьрафа,3222,135,4,0,4,100.0%,22m
11596,3,[siN]Sco,3222,94,4,5,9,44.4%,20m
11596,3,[lOoOl]Jonaka,3222,88,3,11,14,21.4%,16m
11596,3,Pahvinkeitin,3222,30,2,0,2,100.0%,2m
11596,3,Rinzler,3222,30,1,1,2,50.0%,6m
11596,3,[basdp]Mora,3222,92,1,2,3,33.3%,23m
11596,3,dido,3222,30,1,4,5,20.0%,10m
11596,3,Djcomf,3222,0,0,1,1,0.0%,8m
11596,3,[ZERGTV]Mirack,3222,0,0,1,1,0.0%,14m
11596,3,Icu,3222,0,0,1,1,0.0%,11m
11624,3,ProtossAnt,3221,1457,198,184,382,51.8%,24m
11624,3,spacelord,3221,759,78,81,159,49.1%,21m
11624,3,[BR4VE]ShadowFox,3221,1213,54,38,92,58.7%,9m
11624,3,BlzBub,3221,815,54,50,104,51.9%,16m
11624,3,FleetCommand,3221,1188,53,48,101,52.5%,9m
11624,3,Yann,3221,1192,49,39,88,55.7%,7m
11624,3,Gewendron,3221,1082,41,44,85,48.2%,7m
11624,3,[TheDOH]Maxos,3221,935,39,29,68,57.4%,17m
11624,3,[Dobro]PontyPilat,3221,573,27,17,44,61.4%,4m
11624,3,[RPHG]Køllejonny,3221,321,12,18,30,40.0%,8m
11624,2,maverick,3221,222,11,13,24,45.8%,8m
11624,3,Mazi,3221,267,10,8,18,55.6%,11m
11624,3,IIIIIIIIIIII,3221,246,9,8,17,52.9%,20m
11624,3,PainKiller,3221,228,8,3,11,72.7%,12m
11624,3,Vardaine,3221,162,8,4,12,66.7%,18m
11624,3,Ormos,3221,202,7,3,10,70.0%,6m
11624,3,Dirtus,3221,148,5,5,10,50.0%,8m
11624,3,[ClCN]Colorin,3221,175,4,5,9,44.4%,18m
11624,3,Rha,3221,124,4,17,21,19.0%,6m
11624,3,neptun,3221,135,3,2,5,60.0%,11m
11624,3,[3400]fützgu,3221,0,3,2,5,60.0%,1h
11624,3,[Heroes]voidpointer,3221,95,2,0,2,100.0%,21m
11624,3,TAR,3221,58,2,2,4,50.0%,14m
11624,3,[NoInAc]LimeGreen,3221,0,2,4,6,33.3%,9m
11624,3,TimGold,3221,95,1,1,2,50.0%,2m
11649,2,Provocateur,3220,1271,335,340,675,49.6%,4m
11649,3,[ŁATWO]Skipper,3220,1528,157,138,295,53.2%,10m
11649,3,LAPLACE,3220,934,155,157,312,49.7%,21m
11649,3,Dmutro,3220,1313,133,105,238,55.9%,17m
11649,3,CarlsVerg,3220,641,130,114,244,53.3%,11m
11649,3,Banan,3220,1372,64,40,104,61.5%,21m
11649,3,Onti,3220,821,59,62,121,48.8%,11m
11649,3,lIlIlIlIlIlI,3220,557,54,36,90,60.0%,23m
11649,3,milton,3220,988,52,52,104,50.0%,15m
11649,3,Cuthbert,3220,940,38,30,68,55.9%,13m
11649,3,Noose,3220,586,26,18,44,59.1%,14m
11649,3,FunkY,3220,458,21,10,31,67.7%,23m
11649,3,ManDoL,3220,226,9,1,10,90.0%,11m
11649,3,[IFAI]AnFalslh,3220,198,9,13,22,40.9%,18m
11649,3,[PŖïMĄŁ]LUKITREK,3220,260,8,6,14,57.1%,9m
11649,2,SADIST,3220,220,8,6,14,57.1%,12m
11649,3,Shooter,3220,0,4,1,5,80.0%,29m
11649,3,Sectumsempra,3220,0,4,1,5,80.0%,14m
11649,3,herOS,3220,134,3,2,5,60.0%,5m
11649,3,[Ximic]ХитрыйКот,3220,142,3,3,6,50.0%,3m
11649,3,PaLu,3220,92,3,9,12,25.0%,17m
11649,2,[GSCV]khol,3220,0,2,4,6,33.3%,35m
11649,3,NettoCity,3220,60,2,4,6,33.3%,24m
11649,3,Svoychelovek,3220,0,1,0,1,100.0%,13m
11649,3,TalDarim,3220,0,1,0,1,100.0%,6m
11649,3,wiQed,3220,30,1,2,3,33.3%,8m
11649,3,[T1T4NS]Manticore,3220,0,1,2,3,33.3%,7m
11649,3,[ĦĦ]xmiio,3220,0,0,1,1,0.0%,9m
11677,3,TaclegoTT,3219,771,164,133,297,55.2%,3m
11677,3,GGz,3219,1201,73,76,149,49.0%,15m
11677,3,GNS,3219,692,28,19,47,59.6%,6m
11677,3,Parallax,3219,126,28,33,61,45.9%,10m
11677,3,[elCrab]Kris,3219,365,23,7,30,76.7%,16m
11677,3,Stardu,3219,588,20,33,53,37.7%,2m
11677,3,Blackfire,3219,440,17,12,29,58.6%,17m
11677,2,ReCoN,3219,261,13,8,21,61.9%,23m
11677,3,[xCCCPx]Light,3219,262,10,6,16,62.5%,23m
11677,3,EventHorizon,3219,252,9,3,12,75.0%,10m
11677,1,Harkey,3219,244,8,14,22,36.4%,15m
11677,3,SeriousSam,3219,159,4,4,8,50.0%,22m
11677,3,toofusion,3219,88,3,4,7,42.9%,14m
11677,3,[VetM]Morvalax,3219,58,2,4,6,33.3%,6m
11677,3,Kentrum,3219,0,1,0,1,100.0%,17m
11677,3,Koolk,3219,0,1,1,2,50.0%,13m
11677,3,Tank,3219,0,0,1,1,0.0%,15m
11677,3,GetShwifty,3219,0,0,1,1,0.0%,22m
11695,3,Пакувыцо,3218,1421,219,206,425,51.5%,16m
11695,3,Marlito,3218,1484,131,122,253,51.8%,4m
11695,3,PaniQue,3218,989,92,75,167,55.1%,21m
11695,3,GeroPsycho,3218,1125,90,103,193,46.6%,19m
11695,3,[SFight]Loki,3218,1435,89,49,138,64.5%,5m
11695,3,HoneyBadger,3218,1049,86,86,172,50.0%,15m
11695,3,LEOKA,3218,808,73,60,133,54.9%,4m
11695,3,[oíÎìo]qoíÎìop,3218,266,58,47,105,55.2%,18m
11695,3,koxe,3218,528,57,51,108,52.8%,5m
11695,3,[k1raen]ALISHER,3218,1063,45,34,79,57.0%,15m
11695,3,[SSQ]TyJark,3218,630,30,21,51,58.8%,22m
11695,3,tolstij,3218,511,18,15,33,54.5%,19m
11695,3,NoNameNeeded,3218,372,16,13,29,55.2%,9m
11695,3,Limp,3218,234,10,5,15,66.7%,17m
11695,3,Majorpoli,3218,73,9,5,14,64.3%,5m
11695,3,[TiH]DrunkenRhino,3218,237,8,5,13,61.5%,17m
11695,2,Derogatory,3218,184,7,3,10,70.0%,1h
11695,3,Prometheus,3218,215,7,3,10,70.0%,12m
11695,2,[sc2tm]KEEPER,3218,119,5,2,7,71.4%,11m
11695,3,Dlen,3218,143,3,2,5,60.0%,17m
11695,3,Gregosss,3218,95,2,0,2,100.0%,21m
11695,3,LoleMonster,3218,117,2,2,4,50.0%,23m
11695,3,Horus,3218,94,1,1,2,50.0%,4m
11695,3,lllllllllll,3218,30,1,3,4,25.0%,18m
11695,3,Mirage,3218,0,0,1,1,0.0%,1h
11695,3,demonus,3218,0,0,2,2,0.0%,17m
11721,3,Garp,3217,1121,144,139,283,50.9%,4m
11721,3,Trex,3217,1644,128,114,242,52.9%,14m
11721,2,Alen,3217,1526,124,141,265,46.8%,4m
11721,3,[LGNxEU]Axxellerate,3217,1270,96,97,193,49.7%,2m
11721,3,Cornygun,3217,1249,83,87,170,48.8%,11m
11721,3,Romchester,3217,547,79,66,145,54.5%,14m
11721,3,TrusyEnota,3217,922,41,27,68,60.3%,24m
11721,3,Adorall,3217,785,32,25,57,56.1%,19m
11721,3,Паранид,3217,588,28,15,43,65.1%,12m
11721,3,RIIBOONIIU,3217,648,28,18,46,60.9%,22m
11721,3,[JaPP]Dubrovskijj,3217,698,28,24,52,53.8%,11m
11721,3,Instalooter,3217,475,23,14,37,62.2%,14m
11721,3,NicoB,3217,527,22,16,38,57.9%,9m
11721,3,chartzono,3217,433,19,16,35,54.3%,11m
11721,3,[CrøkeT]ElPijon,3217,292,10,11,21,47.6%,3m
11721,1,BlackWolf,3217,216,9,5,14,64.3%,20m
11721,3,Flux,3217,222,7,4,11,63.6%,18m
11721,3,MuMu,3217,0,4,1,5,80.0%,6m
11721,3,[RеG]Babulenok,3217,92,4,6,10,40.0%,23m
11721,3,rangleklods,3217,145,3,3,6,50.0%,6m
11721,3,Szaky,3217,116,2,2,4,50.0%,8m
11721,3,bRoNzElEaGuE,3217,120,2,2,4,50.0%,8m
11721,2,[TǂH]Wentals,3217,0,2,5,7,28.6%,4m
11721,3,Osci,3217,62,2,9,11,18.2%,7m
11721,3,COLDOFSKY,3217,0,1,0,1,100.0%,20m
11721,3,[Hrr]Ethanolos,3217,30,1,2,3,33.3%,13m
11721,3,TheDark,3217,0,0,1,1,0.0%,5m
11721,3,blue,3217,0,0,1,1,0.0%,17m
11721,3,Mike,3217,0,0,2,2,0.0%,9m
11721,3,[MistEU]sawn,3217,0,0,3,3,0.0%,22m
11751,3,[nCrew]dirtydog,3216,1083,103,106,209,49.3%,11m
11751,3,fefe,3216,1474,89,67,156,57.1%,6m
11751,3,Alesk,3216,1543,87,89,176,49.4%,8m
11751,3,Nathuram,3216,625,71,55,126,56.3%,23m
11751,3,Strumpf,3216,653,58,45,103,56.3%,2m
11751,3,Starless,3216,337,47,39,86,54.7%,24m
11751,3,[DrPlat]Paer,3216,1020,45,34,79,57.0%,14m
11751,3,WhiteFangmsi,3216,940,41,27,68,60.3%,11m
11751,3,Sandro,3216,775,33,23,56,58.9%,10m
11751,3,Adebisi,3216,522,28,30,58,48.3%,5m
11751,3,borghur,3216,380,25,21,46,54.3%,7m
11751,3,[Caver]Gameras,3216,507,24,14,38,63.2%,11m
11751,3,AngryProbes,3216,537,24,15,39,61.5%,3m
11751,3,[PÂRłAH]DropDead,3216,467,20,11,31,64.5%,12m
11751,3,[KAMAZ]ObitO,3216,556,20,23,43,46.5%,6m
11751,3,IlIlIlIlIlIl,3216,417,18,10,28,64.3%,5m
11751,3,[Dobro]Durga,3216,285,18,13,31,58.1%,20m
11751,3,Myxomor,3216,214,11,7,18,61.1%,13m
11751,3,BAZZA,3216,140,6,5,11,54.5%,14m
11751,3,IcEdrAgOn,3216,185,5,3,8,62.5%,23m
11751,3,qwe,3216,120,4,4,8,50.0%,7m
11751,3,[iMv]Tappsi,3216,90,4,9,13,30.8%,17m
11751,2,Inbreddesu,3216,128,3,4,7,42.9%,18m
11751,3,[UATeam]LFRSergey,3216,88,3,5,8,37.5%,11m
11751,3,SupaDupa,3216,91,2,0,2,100.0%,15m
11751,3,TheTrueMans,3216,0,2,3,5,40.0%,18m
11751,3,[NoHоmо]Danya,3216,30,2,8,10,20.0%,20m
11751,3,[aHsK]Felix,3216,0,1,0,1,100.0%,15m
11751,3,nazarpunk,3216,0,1,1,2,50.0%,24m
11780,3,[Perm]protosek,3215,1473,193,188,381,50.7%,13m
11780,3,Hummingbird,3215,1136,174,155,329,52.9%,24m
11780,3,[z666z]Damoklus,3215,1033,134,116,250,53.6%,22m
11780,3,Yarin,3215,678,115,100,215,53.5%,21m
11780,3,Sem,3215,1518,97,88,185,52.4%,17m
11780,3,Gucky,3215,1550,64,76,140,45.7%,19m
11780,3,[oooo89]TheCiuLi,3215,909,40,31,71,56.3%,14m
11780,3,[fam1ly]Steha,3215,754,36,18,54,66.7%,21m
11780,3,Lollikr,3215,886,33,41,74,44.6%,8m
11780,3,flawi,3215,520,22,21,43,51.2%,17m
11780,3,[khalas]Radovan,3215,403,16,10,26,61.5%,23m
11780,3,[HPSB]TheCrunkyOne,3215,396,14,19,33,42.4%,6m
11780,3,leo,3215,161,13,2,15,86.7%,19m
11780,3,doud,3215,359,13,16,29,44.8%,11m
11780,3,Zipo,3215,241,12,12,24,50.0%,17m
11780,3,Staya,3215,151,9,3,12,75.0%,17m
11780,3,[ClDlN]Hinundweg,3215,245,9,5,14,64.3%,17m
11780,3,SyrrelSnir,3215,0,4,1,5,80.0%,6m
11780,3,Leves,3215,88,4,5,9,44.4%,13m
11780,3,Atticus,3215,116,3,1,4,75.0%,7m
11780,3,[h0w]Sounding,3215,156,3,7,10,30.0%,17m
11780,3,Akarophobie,3215,0,2,3,5,40.0%,1h
11780,1,[VETS]ImaG,3215,0,1,0,1,100.0%,28m
11780,3,IIIIIIIIIIII,3215,0,1,0,1,100.0%,18m
11780,2,Flower,3215,96,1,1,2,50.0%,1h
11780,3,[TedB]denlok,3215,94,1,1,2,50.0%,2m
11780,2,Nano,3215,0,1,9,10,10.0%,20m
11780,3,IIIIIIIIII,3215,0,0,1,1,0.0%,6m
11780,3,[MaMkin]KillerMaga,3215,0,0,2,2,0.0%,18m
11780,3,[eWRS]WinRouS,3215,0,0,2,2,0.0%,15m
11810,2,NexYY,3214,1479,88,96,184,47.8%,10m
11810,3,Artemis,3214,1446,67,71,138,48.6%,22m
11810,3,[MERCA]MateobigBoy,3214,851,62,45,107,57.9%,8m
11810,3,NoWontTell,3214,1146,53,38,91,58.2%,18m
11810,3,Andcol,3214,887,48,37,85,56.5%,6m
11810,3,OsmosLF,3214,750,45,28,73,61.6%,4m
11810,3,matyatya,3214,350,20,15,35,57.1%,7m
11810,3,Tabris,3214,530,20,21,41,48.8%,12m
11810,3,[IndyK]Lieutenant,3214,353,19,12,31,61.3%,12m
11810,3,Hung,3214,338,13,6,19,68.4%,17m
11810,3,Nerotoxin,3214,345,11,11,22,50.0%,21m
11810,3,Hectorion,3214,194,6,2,8,75.0%,3m
11810,2,meat,3214,96,5,2,7,71.4%,36m
11810,3,Ingrimch,3214,0,4,1,5,80.0%,5m
11810,3,Landauer,3214,0,4,1,5,80.0%,16m
11810,3,NipeL,3214,154,4,1,5,80.0%,21m
11810,3,terminator,3214,165,4,4,8,50.0%,5m
11810,3,[HZeS]gollor,3214,92,2,0,2,100.0%,7m
11810,1,zergtryhard,3214,46,2,2,4,50.0%,6m
11810,3,[AceX]gruk,3214,60,2,3,5,40.0%,6m
11810,3,[BELSCF]Ruben,3214,0,1,0,1,100.0%,24m
11810,3,[PLANgg]ProTo,3214,0,0,1,1,0.0%,12m
11810,3,БелыеНоги,3214,0,0,3,3,0.0%,16m
11833,3,[ERaven]Yang,3213,1475,166,143,309,53.7%,18m
11833,3,cloudspace,3213,1367,92,56,148,62.2%,5m
11833,3,NoobasovGG,3213,1619,84,77,161,52.2%,18m
11833,3,[SKR]Aarbaal,3213,1563,83,85,168,49.4%,7m
11833,3,[VFN]Helios,3213,795,75,72,147,51.0%,10m
11833,3,Tobi,3213,865,58,50,108,53.7%,23m
11833,3,[BoiyZz]YoloKing,3213,366,51,50,101,50.5%,2m
11833,3,tecasse,3213,797,42,37,79,53.2%,22m
11833,3,Bufftin,3213,603,31,24,55,56.4%,13m
11833,3,gkgkgk,3213,585,24,20,44,54.5%,18m
11833,3,[BornG]levver,3213,413,23,13,36,63.9%,16m
11833,3,Agarvaen,3213,424,18,11,29,62.1%,7m
11833,3,twitchchatgm,3213,460,16,21,37,43.2%,11m
11833,3,Kwis,3213,400,15,18,33,45.5%,9m
11833,2,[FunM]Noki,3213,315,14,9,23,60.9%,19m
11833,3,[RеG]дядяСаня,3213,285,11,5,16,68.8%,24m
11833,3,[FRGSP]Chavi,3213,240,8,4,12,66.7%,9m
11833,3,Farts,3213,195,5,15,20,25.0%,10m
11833,3,Kasavir,3213,0,4,1,5,80.0%,1h
11833,3,Payne,3213,102,4,8,12,33.3%,3m
11833,3,[HMB]Tydirius,3213,99,2,2,4,50.0%,3m
11833,3,Englin,3213,0,1,0,1,100.0%,10m
11833,3,zzzond,3213,0,1,0,1,100.0%,24m
11833,3,treeone,3213,0,1,0,1,100.0%,18m
11833,3,Callahan,3213,0,1,0,1,100.0%,1h
11833,3,[Lilla]Evillo,3213,0,0,1,1,0.0%,17m
11833,3,[MasNub]JonGunsmoke,3213,0,0,1,1,0.0%,19m
11833,2,Risen,3213,0,0,2,2,0.0%,23m
11833,3,[ZТ]Huzi,3213,0,0,2,2,0.0%,23m
11862,3,Degusyi,3212,1355,168,143,311,54.0%,17m
11862,3,Masa,3212,1382,155,134,289,53.6%,19m
11862,3,[OoE]Spithas,3212,695,45,30,75,60.0%,24m
11862,3,Skyfyre,3212,1123,42,41,83,50.6%,20m
11862,3,Awe,3212,667,37,11,48,77.1%,18m
11862,3,Deicide,3212,652,36,24,60,60.0%,20m
11862,3,Marine,3212,629,31,13,44,70.5%,15m
11862,3,[TedB]IIIDEHAKAIII,3212,559,28,8,36,77.8%,4m
11862,3,[hruska]thonic,3212,404,17,13,30,56.7%,4m
11862,3,[MACLUL]Nemors,3212,406,16,9,25,64.0%,7m
11862,3,[J4E]Golddragon,3212,326,12,6,18,66.7%,14m
11862,3,[w2h]SynjXyjVchaj,3212,254,12,10,22,54.5%,6m
11862,3,Daloo,3212,259,12,19,31,38.7%,3m
11862,3,ZigzagMcRyak,3212,204,11,7,18,61.1%,23m
11862,3,BlkSeptember,3212,186,10,5,15,66.7%,7m
11862,3,GriefSong,3212,210,7,11,18,38.9%,9m
11862,3,renegadx,3212,220,7,15,22,31.8%,8m
11862,3,Lazar,3212,150,6,7,13,46.2%,10m
11862,3,[MLFCG]fran,3212,198,5,6,11,45.5%,9m
11862,3,[EмŦS]Historia,3212,94,4,2,6,66.7%,17m
11862,3,Nyki,3212,163,4,4,8,50.0%,18m
11862,3,errorlevel,3212,115,3,0,3,100.0%,24m
11862,3,Hapster,3212,45,3,7,10,30.0%,22m
11862,3,[XEUS]qbert,3212,95,2,0,2,100.0%,11m
11862,3,balarfed,3212,58,2,3,5,40.0%,18m
11862,2,[PandaC]GRX,3212,0,1,0,1,100.0%,8m
11862,3,[GhFr]iGIVcz,3212,0,1,0,1,100.0%,4m
11862,3,Tagger,3212,93,1,1,2,50.0%,8m
11862,3,[QaDo]GeloPerk,3212,95,1,1,2,50.0%,17m
11862,3,Wulu,3212,30,1,3,4,25.0%,11m
11892,3,tufflax,3211,735,111,96,207,53.6%,18m
11892,3,ölnö,3211,1116,93,86,179,52.0%,18m
11892,3,BlueOcean,3211,1437,78,50,128,60.9%,23m
11892,3,unfunfunt,3211,1521,74,76,150,49.3%,7m
11892,3,frimen,3211,1397,67,51,118,56.8%,23m
11892,3,Perpendiculo,3211,827,36,30,66,54.5%,16m
11892,3,ccAnthrax,3211,445,34,28,62,54.8%,7m
11892,3,[Br4ümu]Arkanny,3211,452,22,14,36,61.1%,15m
11892,3,juuzeppe,3211,364,15,6,21,71.4%,17m
11892,3,CrackHouse,3211,269,13,7,20,65.0%,18m
11892,3,Aky,3211,336,12,10,22,54.5%,10m
11892,3,Function,3211,316,12,10,22,54.5%,16m
11892,3,Phiniix,3211,130,10,6,16,62.5%,15m
11892,3,[EP4E]TobiPlay,3211,243,9,5,14,64.3%,18m
11892,3,Yuki,3211,198,8,1,9,88.9%,11m
11892,3,mikk,3211,146,7,3,10,70.0%,24m
11892,3,KlOlRlElA,3211,144,7,3,10,70.0%,11m
11892,3,UunderAtack,3211,204,7,12,19,36.8%,6m
11892,3,[DSY]kalast,3211,137,3,1,4,75.0%,17m
11892,3,[eXXXe]EBORYAN,3211,93,2,0,2,100.0%,16m
11892,3,KikiRikiMiki,3211,0,1,0,1,100.0%,14m
11892,3,Presto,3211,0,1,2,3,33.3%,12m
11892,3,Sok,3211,0,0,1,1,0.0%,15m
11892,3,Mzerø,3211,0,0,1,1,0.0%,10m
11916,3,Rafizz,3210,1571,318,282,600,53.0%,8m
11916,3,[sctrap]KarlMarxxx,3210,1658,220,207,427,51.5%,2m
11916,3,[vlast]FrodoBaggins,3210,1567,179,165,344,52.0%,12m
11916,3,SCV,3210,1267,95,86,181,52.5%,18m
11916,3,VIPTankz,3210,294,90,66,156,57.7%,10m
11916,3,XayAxiA,3210,1521,87,81,168,51.8%,17m
11916,3,[1FU2]deathquasar,3210,895,36,28,64,56.2%,7m
11916,3,imNOOBsorry,3210,888,34,38,72,47.2%,18m
11916,3,[Sa2]aleks,3210,626,30,12,42,71.4%,17m
11916,3,[klanix]JoeChip,3210,782,30,29,59,50.8%,21m
11916,3,MonsieurC,3210,670,26,25,51,51.0%,18m
11916,3,Petrucci,3210,419,21,8,29,72.4%,21m
11916,3,ivrus,3210,560,18,31,49,36.7%,15m
11916,3,NxTǂexN,3210,256,11,7,18,61.1%,10m
11916,3,Eliptic,3210,295,11,14,25,44.0%,6m
11916,3,ƒormule,3210,94,6,1,7,85.7%,6m
11916,2,[TlGd]golock,3210,238,6,8,14,42.9%,20m
11916,3,DarkDiest,3210,202,5,6,11,45.5%,15m
11916,3,SuperBod,3210,93,2,0,2,100.0%,15m
11916,3,[0123]pavelo,3210,120,2,2,4,50.0%,13m
11916,3,Shakira,3210,95,2,4,6,33.3%,6m
11916,3,PapaMisty,3210,0,1,0,1,100.0%,13m
11916,3,[FANATS]HunterJOIS,3210,30,1,2,3,33.3%,17m
11916,1,Gundersen,3210,0,0,1,1,0.0%,6m
11916,3,[ZЕRG7V]ALFA,3210,0,0,1,1,0.0%,19m
11916,3,Boppel,3210,0,0,2,2,0.0%,2m
11916,3,Aether,3210,0,0,3,3,0.0%,14m
11943,3,Kirai,3209,1017,242,204,446,54.3%,18m
11943,3,science,3209,1548,173,148,321,53.9%,11m
11943,3,[Донный]GRIF,3209,1476,123,83,206,59.7%,11m
11943,3,Herodays,3209,1563,83,64,147,56.5%,7m
11943,3,WipeR,3209,1497,72,46,118,61.0%,22m
11943,3,[PhC]Nucleus,3209,896,63,54,117,53.8%,22m
11943,3,[Бaтьки]jokirev,3209,653,57,38,95,60.0%,18m
11943,3,Dima,3209,515,54,43,97,55.7%,4m
11943,3,nicetry,3209,925,40,29,69,58.0%,19m
11943,3,NipeL,3209,651,37,14,51,72.5%,20m
11943,3,Ztaft,3209,842,34,33,67,50.7%,4m
11943,3,Schutz,3209,640,26,19,45,57.8%,18m
11943,3,BuzaLisk,3209,686,26,26,52,50.0%,14m
11943,3,Chad,3209,550,25,9,34,73.5%,18m
11943,3,[IceHus]typicalplayr,3209,639,22,22,44,50.0%,21m
11943,1,panedfrogg,3209,232,11,10,21,52.4%,14m
11943,3,CarCarlo,3209,264,10,4,14,71.4%,16m
11943,3,Loxodon,3209,303,10,8,18,55.6%,13m
11943,3,DokTor,3209,177,8,7,15,53.3%,2m
11943,3,Funkydrummer,3209,118,5,2,7,71.4%,7m
11943,3,PuTTing,3209,120,5,6,11,45.5%,4m
11943,3,Egorich,3209,0,4,3,7,57.1%,4m
11943,3,[DZTK]aiur,3209,90,3,4,7,42.9%,14m
11943,3,Drako,3209,0,1,1,2,50.0%,13m
11943,3,donkeyshot,3209,0,1,1,2,50.0%,4m
11943,3,[ValidG]Mirko,3209,0,1,1,2,50.0%,14m
11943,3,jappi,3209,0,0,1,1,0.0%,24m
11943,3,Pain,3209,0,0,4,4,0.0%,17m
11971,3,Jambalaya,3208,602,128,132,260,49.2%,2m
11971,3,[JINX]SokoOne,3208,1485,94,13,107,87.9%,7m
11971,3,BIgBean,3208,855,50,39,89,56.2%,19m
11971,3,Hurtone,3208,1200,49,53,102,48.0%,3m
11971,3,gorgfan,3208,640,39,35,74,52.7%,8m
11971,3,Eiger,3208,846,34,32,66,51.5%,15m
11971,3,[MP2015]soul,3208,621,26,28,54,48.1%,11m
11971,3,KingChris,3208,481,19,13,32,59.4%,7m
11971,2,Swordelf,3208,327,13,41,54,24.1%,4m
11971,3,Harald,3208,288,11,10,21,52.4%,19m
11971,3,Tron,3208,182,9,4,13,69.2%,12m
11971,3,[DR4ST1]lejlot,3208,277,9,9,18,50.0%,21m
11971,3,serafal,3208,230,8,4,12,66.7%,22m
11971,3,[Ǽ1]OttoSpritz,3208,201,8,7,15,53.3%,19m
11971,3,SwHy,3208,220,8,14,22,36.4%,19m
11971,3,Madbanshee,3208,148,6,7,13,46.2%,18m
11971,3,Anonymous,3208,60,5,4,9,55.6%,6m
11971,3,Arlesko,3208,97,4,2,6,66.7%,12m
11971,3,Kulkoth,3208,159,4,4,8,50.0%,10m
11971,3,[iX]BKBStorMCroW,3208,141,3,2,5,60.0%,8m
11971,3,Frezzyy,3208,0,3,2,5,60.0%,21m
11971,3,nardex,3208,60,3,3,6,50.0%,24m
11971,3,Passage,3208,103,2,1,3,66.7%,19m
11971,1,GoldenShowR,3208,48,2,1,3,66.7%,34m
11971,3,Wodan,3208,0,2,3,5,40.0%,1h
11971,3,MackieMesser,3208,58,2,5,7,28.6%,24m
11971,3,Skazochnik,3208,0,1,3,4,25.0%,12m
11971,3,Donkanaille,3208,0,0,3,3,0.0%,17m
11999,3,Prosumer,3207,1341,332,320,652,50.9%,6m
11999,3,immortalking,3207,994,151,122,273,55.3%,6m
11999,3,ViandoX,3207,1262,71,57,128,55.5%,17m
11999,3,Ranajay,3207,665,63,42,105,60.0%,18m
11999,3,Etupelas,3207,911,47,14,61,77.0%,11m
11999,3,ZergisCovid,3207,743,39,32,71,54.9%,6m
11999,3,Fiery,3207,779,38,33,71,53.5%,8m
11999,3,CheeseTown,3207,712,27,27,54,50.0%,17m
11999,3,LingLing,3207,564,23,15,38,60.5%,8m
11999,3,TeaZiing,3207,562,23,19,42,54.8%,3m
11999,3,[NLTHB]ReFruity,3207,604,22,23,45,48.9%,15m
11999,3,[Hrѓ]Акулка,3207,548,20,16,36,55.6%,22m
11999,3,Korlim,3207,256,16,12,28,57.1%,14m
11999,3,diREKT,3207,360,13,9,22,59.1%,11m
11999,3,chips,3207,336,12,14,26,46.2%,21m
11999,3,Michem,3207,364,11,26,37,29.7%,15m
11999,3,DoCLeoPoLd,3207,275,9,7,16,56.2%,4m
11999,3,Danken,3207,228,9,8,17,52.9%,4m
11999,1,Smake,3207,190,8,4,12,66.7%,1h
11999,3,SHOWMENIY,3207,238,8,5,13,61.5%,17m
11999,3,StarKRE,3207,179,6,3,9,66.7%,18m
11999,3,Klakier,3207,58,3,2,5,60.0%,14m
11999,3,Artorias,3207,142,3,3,6,50.0%,3m
11999,3,Lexus,3207,62,2,8,10,20.0%,19m
11999,3,Erios,3207,0,1,0,1,100.0%,21m
11999,3,tensoon,3207,0,1,1,2,50.0%,23m
11999,3,Bullepower,3207,0,1,1,2,50.0%,18m
11999,3,SheepMind,3207,0,1,1,2,50.0%,11m
11999,3,[BICHES]Furys,3207,0,0,1,1,0.0%,16m
11999,3,Romio,3207,0,0,1,1,0.0%,19m
12029,3,Shocky,3206,622,71,75,146,48.6%,13m
12029,3,Coffee,3206,1401,62,46,108,57.4%,14m
12029,3,[SLIM]Rainbow,3206,1314,52,46,98,53.1%,17m
12029,3,AcahCruv,3206,1340,50,52,102,49.0%,6m
12029,3,Frezdébwoa,3206,861,39,39,78,50.0%,6m
12029,3,[VBros]wunder,3206,653,26,18,44,59.1%,21m
12029,3,iamchets,3206,612,26,19,45,57.8%,17m
12029,3,ǂKaraxǂ,3206,404,24,5,29,82.8%,13m
12029,3,STORM,3206,474,23,19,42,54.8%,6m
12029,3,djark,3206,528,21,14,35,60.0%,17m
12029,3,NeiNeon,3206,236,9,2,11,81.8%,17m
12029,1,Wheemix,3206,233,9,5,14,64.3%,8m
12029,3,[SLK333]STARLOLZ,3206,199,5,6,11,45.5%,22m
12029,3,CuddleBunny,3206,115,3,0,3,100.0%,6m
12029,3,Safcio,3206,140,3,2,5,60.0%,14m
12029,3,Засада,3206,95,1,1,2,50.0%,24m
12029,3,bakinsky,3206,30,1,3,4,25.0%,19m
12029,2,Anomick,3206,0,0,1,1,0.0%,9m
12047,3,Strawberry,3205,1246,167,166,333,50.2%,10m
12047,3,cosh,3205,454,166,145,311,53.4%,24m
12047,3,duda,3205,710,160,161,321,49.8%,19m
12047,3,Example,3205,714,96,50,146,65.8%,23m
12047,3,nLk,3205,1539,80,67,147,54.4%,20m
12047,3,Psy,3205,1123,79,68,147,53.7%,12m
12047,3,Noul,3205,1545,76,77,153,49.7%,3m
12047,3,[TheDOH]Grubson,3205,448,70,58,128,54.7%,2m
12047,3,josiassl,3205,1161,68,48,116,58.6%,18m
12047,3,zorkqz,3205,908,63,51,114,55.3%,8m
12047,3,aceofspades,3205,706,51,47,98,52.0%,21m
12047,3,SRS,3205,1316,47,60,107,43.9%,22m
12047,3,Revan,3205,947,43,33,76,56.6%,19m
12047,2,llllllllllll,3205,1053,35,53,88,39.8%,24m
12047,3,aaiun,3205,680,32,25,57,56.1%,4m
12047,3,ichich,3205,664,28,18,46,60.9%,8m
12047,3,BOSIK,3205,634,24,19,43,55.8%,18m
12047,3,data,3205,550,21,23,44,47.7%,11m
12047,3,[LOlol]gandul,3205,401,15,10,25,60.0%,8m
12047,3,[fraggl]EchtFett,3205,247,12,6,18,66.7%,23m
12047,3,IIIIIIIIIIII,3205,235,10,7,17,58.8%,22m
12047,3,[SH1TY]DaWitchDokta,3205,146,6,9,15,40.0%,21m
12047,3,NaughtyDevil,3205,0,5,0,5,100.0%,18m
12047,3,NinjaCookie,3205,114,3,0,3,100.0%,3m
12047,3,ZedKiller,3205,113,3,1,4,75.0%,7m
12047,3,azimus,3205,117,2,2,4,50.0%,14m
12047,3,ponal,3205,0,1,0,1,100.0%,17m
12047,3,IIIIIIIIIIII,3205,0,1,0,1,100.0%,7m
12047,3,ohman,3205,0,1,0,1,100.0%,11m
12047,3,Yelisey,3205,30,1,2,3,33.3%,17m
12047,3,Galiaf,3205,30,1,4,5,20.0%,9m
12047,3,[ZeBa]BaronM,3205,0,0,1,1,0.0%,6m
12047,3,Pinakolada,3205,0,0,1,1,0.0%,24m
12047,1,pitkerij,3205,0,0,3,3,0.0%,2m
12081,3,Vladimir,3204,1513,536,508,1044,51.3%,6m
12081,3,[Batia]AlexMaster,3204,1549,371,341,712,52.1%,11m
12081,3,AntoniuD,3204,1528,245,226,471,52.0%,6m
12081,3,MisterT,3204,1132,84,70,154,54.5%,6m
12081,3,[DZTK]zergbräter,3204,882,60,48,108,55.6%,21m
12081,3,MandM,3204,1217,51,42,93,54.8%,9m
12081,3,MrBearmouse,3204,605,33,38,71,46.5%,14m
12081,3,[GapSis]Zisaku,3204,346,22,15,37,59.5%,9m
12081,3,NightKnight,3204,458,19,13,32,59.4%,12m
12081,3,МОРОЖЕНКО,3204,289,12,9,21,57.1%,11m
12081,3,MCM,3204,320,12,14,26,46.2%,3m
12081,2,Fire,3204,90,6,3,9,66.7%,1h
12081,3,ALARAK,3204,146,6,6,12,50.0%,4m
12081,3,Willy,3204,190,6,15,21,28.6%,3m
12081,3,[ToSC]Fragz,3204,152,5,2,7,71.4%,11m
12081,3,Jaycus,3204,146,5,6,11,45.5%,7m
12081,3,KLK,3204,0,4,1,5,80.0%,38m
12081,2,MondayKiz,3204,150,4,4,8,50.0%,14m
12081,3,[PSidee]fed,3204,114,3,0,3,100.0%,7m
12081,3,mamby,3204,142,3,3,6,50.0%,17m
12081,3,Kharnis,3204,94,2,0,2,100.0%,24m
12081,3,[ACP]BreizhZion,3204,115,2,1,3,66.7%,7m
12081,3,Nerox,3204,0,2,3,5,40.0%,1h
12081,3,ARealCoolGuy,3204,0,1,0,1,100.0%,15m
12081,3,[Hаsu]GorogonA,3204,94,1,1,2,50.0%,2m
12081,3,favilagg,3204,0,0,1,1,0.0%,14m
12081,3,iskar,3204,0,0,1,1,0.0%,21m
12108,3,ARTANIS,3203,1406,188,172,360,52.2%,18m
12108,3,[ArKD3]danielo,3203,928,144,126,270,53.3%,19m
12108,3,[DТ]BeelzeBul,3203,1293,91,54,145,62.8%,24m
12108,3,[IceHus]ProdamGaraz,3203,676,39,28,67,58.2%,17m
12108,3,[gSub]HunteR,3203,913,38,32,70,54.3%,4m
12108,3,brazorfajeje,3203,519,27,9,36,75.0%,15m
12108,3,Zeba,3203,590,23,16,39,59.0%,10m
12108,3,[HFR]GeRRaR,3203,333,13,8,21,61.9%,10m
12108,3,[dd33nt]DigitalDave,3203,329,11,11,22,50.0%,23m
12108,3,IIIIIIIIIIII,3203,232,9,4,13,69.2%,18m
12108,3,Warlord,3203,187,9,6,15,60.0%,24m
12108,3,JKnightmare,3203,178,8,4,12,66.7%,16m
12108,3,Olga,3203,183,8,5,13,61.5%,11m
12108,3,Shutman,3203,270,8,8,16,50.0%,3m
12108,3,[ZЕRGТV]Tetsuro,3203,255,8,9,17,47.1%,11m
12108,3,[ZERGSC]EgorPomidor,3203,174,7,8,15,46.7%,9m
12108,3,[GucciG]RapingAMK,3203,196,6,5,11,54.5%,22m
12108,3,Flake,3203,114,5,5,10,50.0%,8m
12108,3,Foggsi,3203,97,4,2,6,66.7%,12m
12108,3,hlebushek,3203,90,3,4,7,42.9%,6m
12108,3,AngryPenguin,3203,30,2,1,3,66.7%,7m
12108,3,oviman,3203,111,2,2,4,50.0%,18m
12108,3,Midnight,3203,60,2,4,6,33.3%,24m
12108,3,[KPride]adrien,3203,30,2,6,8,25.0%,24m
12108,3,[TheSha]Messier,3203,0,1,0,1,100.0%,17m
12108,3,Percival,3203,0,1,0,1,100.0%,14m
12108,3,SealClubber,3203,94,1,1,2,50.0%,19m
12108,3,lem,3203,30,1,2,3,33.3%,21m
12108,3,immortalibus,3203,0,0,1,1,0.0%,2m
12108,3,BadackIsBack,3203,0,0,1,1,0.0%,20m
12108,3,Toast,3203,0,0,2,2,0.0%,21m
12108,3,drunkcraft,3203,0,0,2,2,0.0%,10m
12108,3,rofl,3203,0,0,4,4,0.0%,17m
12141,3,lewAshby,3202,1223,118,110,228,51.8%,9m
12141,3,Spaceman,3202,476,108,94,202,53.5%,12m
12141,3,TheCrash,3202,1319,85,60,145,58.6%,8m
12141,3,Iceman,3202,1081,84,74,158,53.2%,17m
12141,3,madeon,3202,680,80,71,151,53.0%,4m
12141,3,[SicK]LowTone,3202,684,73,67,140,52.1%,13m
12141,3,Ibanezz,3202,845,43,34,77,55.8%,24m
12141,3,[BWArmy]Oxwaa,3202,986,41,34,75,54.7%,14m
12141,3,jamesvilla,3202,296,31,19,50,62.0%,7m
12141,3,Predicate,3202,520,22,13,35,62.9%,16m
12141,3,Golem,3202,507,20,15,35,57.1%,17m
12141,3,sumu,3202,323,19,9,28,67.9%,16m
12141,3,[KTQ]Unpunishable,3202,180,7,11,18,38.9%,4m
12141,3,Resko,3202,107,4,3,7,57.1%,10m
12141,2,Nyze,3202,48,4,4,8,50.0%,10m
12141,3,ArthurC,3202,163,4,4,8,50.0%,14m
12141,3,Zarock,3202,0,3,2,5,60.0%,15m
12141,3,Bobbee,3202,0,1,4,5,20.0%,6m
12141,3,FeldJäger,3202,0,0,1,1,0.0%,3m
12141,3,DiamondQuant,3202,0,0,1,1,0.0%,7m
12161,3,Hartigan,3201,638,218,203,421,51.8%,17m
12161,3,[Mastr]killers,3201,1486,212,206,418,50.7%,6m
12161,3,[N1NJ4Z]WildPekineS,3201,1567,181,164,345,52.5%,17m
12161,3,[EMRS]Graps,3201,742,120,102,222,54.1%,2m
12161,3,[TaMort]DontCryBaby,3201,847,65,44,109,59.6%,22m
12161,3,[DvX]SaSiker,3201,882,48,34,82,58.5%,11m
12161,3,Tomas,3201,1098,47,44,91,51.6%,19m
12161,3,FangVik,3201,664,41,27,68,60.3%,20m
12161,3,[BMANG]TheFilth,3201,920,39,31,70,55.7%,18m
12161,3,Bounty,3201,302,24,12,36,66.7%,2m
12161,3,[TSTG]Michl,3201,624,23,21,44,52.3%,8m
12161,3,panshin,3201,488,22,14,36,61.1%,8m
12161,3,[AciNoN]Ambrella,3201,420,21,5,26,80.8%,11m
12161,3,[10110]Eiikø,3201,291,20,20,40,50.0%,11m
12161,3,Tessio,3201,411,18,16,34,52.9%,3m
12161,3,Rick,3201,506,17,16,33,51.5%,21m
12161,3,ElDhoine,3201,428,16,17,33,48.5%,7m
12161,3,Rykers,3201,355,12,10,22,54.5%,19m
12161,1,Sam,3201,254,9,5,14,64.3%,1h
12161,3,HalliGalli,3201,116,5,4,9,55.6%,7m
12161,3,Nissa,3201,154,4,1,5,80.0%,17m
12161,3,[WSJ]Xiana,3201,94,2,0,2,100.0%,17m
12161,3,[Funcy]GgoodByye,3201,116,2,1,3,66.7%,17m
12161,3,HITMANdarin,3201,112,2,1,3,66.7%,14m
12161,2,[Mavis]MoonLy,3201,0,1,0,1,100.0%,40m
12161,3,timi,3201,30,1,2,3,33.3%,3m
12161,3,AsaLiaH,3201,0,0,1,1,0.0%,6m
12161,3,[SFine]Granis,3201,0,0,1,1,0.0%,7m
12161,3,[FLU5H]ArchonToilet,3201,0,0,1,1,0.0%,7m
12161,3,Unity,3201,0,0,1,1,0.0%,19m
12161,3,Rascal,3201,0,0,1,1,0.0%,17m
12192,3,tkekahese,3200,1416,111,102,213,52.1%,9m
12192,3,Bluesman,3200,1465,76,79,155,49.0%,6m
12192,3,[ЗИБиАГ]DimirSpybug,3200,1395,73,43,116,62.9%,4m
12192,3,[WSU]exquisite,3200,1231,54,40,94,57.4%,18m
12192,3,[MFall]Rytern,3200,931,47,21,68,69.1%,21m
12192,3,shaman,3200,749,42,12,54,77.8%,23m
12192,3,[TgK]CubeCow,3200,410,31,17,48,64.6%,2m
12192,3,EvL,3200,348,28,19,47,59.6%,12m
12192,3,tyrgus,3200,691,28,21,49,57.1%,14m
12192,3,waynewatson,3200,596,21,29,50,42.0%,15m
12192,3,Halet,3200,437,20,8,28,71.4%,22m
12192,3,bnage,3200,386,18,9,27,66.7%,9m
12192,3,Eldritch,3200,290,10,8,18,55.6%,24m
12192,2,[klan]JOKER,3200,185,7,3,10,70.0%,30m
12192,3,Escholat,3200,0,5,0,5,100.0%,23m
12192,3,Brice,3200,124,4,9,13,30.8%,11m
12192,3,[EmpG]Tukutuk,3200,0,3,2,5,60.0%,17m
12192,3,Teva,3200,62,3,3,6,50.0%,3m
12192,3,julien,3200,90,3,4,7,42.9%,15m
12192,3,[FiStar]JohnMcClane,3200,62,3,4,7,42.9%,20m
12192,3,Bladar,3200,90,3,5,8,37.5%,16m
12192,1,Favorit,3200,0,1,0,1,100.0%,1h
12214,3,Warbringer,3199,1484,156,148,304,51.3%,10m
12214,3,Archonhaz,3199,1204,85,76,161,52.8%,18m
12214,3,Noname,3199,1425,76,68,144,52.8%,7m
12214,3,deefert,3199,768,47,34,81,58.0%,23m
12214,3,Airborne,3199,686,42,40,82,51.2%,8m
12214,3,CooLWeB,3199,848,32,34,66,48.5%,4m
12214,1,SupPaillette,3199,775,31,17,48,64.6%,13m
12214,3,[SGEY]Torgrim,3199,712,30,22,52,57.7%,4m
12214,3,KEN,3199,746,30,26,56,53.6%,11m
12214,3,Night,3199,748,28,33,61,45.9%,7m
12214,3,argeitqu,3199,547,22,16,38,57.9%,9m
12214,1,Paxanb,3199,516,15,11,26,57.7%,14m
12214,1,Favorite,3199,383,14,9,23,60.9%,20m
12214,3,[ЛДПР]FloreGame,3199,311,11,10,21,52.4%,13m
12214,2,[ſŧłǂƻ]DrBerst,3199,46,5,4,9,55.6%,33m
12214,3,Misiur,3199,105,5,6,11,45.5%,17m
12214,1,STORM,3199,0,4,1,5,80.0%,13m
12214,2,Oniontears,3199,117,3,0,3,100.0%,42m
12214,2,Krul,3199,0,1,0,1,100.0%,7m
12214,1,FireStrike,3199,42,1,1,2,50.0%,3m
12234,3,RoyBamboo,3198,1051,113,96,209,54.1%,17m
12234,1,XCalibur,3198,1182,67,59,126,53.2%,4m
12234,3,vnmZor,3198,825,52,43,95,54.7%,14m
12234,3,fUnZilla,3198,1048,40,37,77,51.9%,3m
12234,3,[MGALS]MirandasMom,3198,461,24,21,45,53.3%,6m
12234,3,[Knäck]nOtime,3198,474,20,21,41,48.8%,10m
12234,3,Молганус,3198,474,17,21,38,44.7%,4m
12234,3,Burli,3198,204,8,6,14,57.1%,12m
12234,2,[1UpBHV]Mikrolisk,3198,141,7,1,8,87.5%,34m
12234,1,IIIIIIIIIIII,3198,0,4,1,5,80.0%,24m
12234,2,Speedy,3198,126,3,0,3,100.0%,5m
12234,1,Gegis,3198,0,1,0,1,100.0%,18m
12234,1,Grummelbär,3198,0,1,0,1,100.0%,14m
12234,1,SpireGG,3198,0,1,0,1,100.0%,43m
12234,1,ThaDeka,3198,0,0,1,1,0.0%,22m
12234,1,dajanto,3198,0,0,3,3,0.0%,28m
12250,3,miridius,3197,690,124,122,246,50.4%,16m
12250,3,MrZ,3197,753,36,31,67,53.7%,13m
12250,1,JohnnyGroove,3197,838,31,15,46,67.4%,24m
12250,3,Neopl,3197,753,29,26,55,52.7%,9m
12250,3,SevenT,3197,472,16,17,33,48.5%,10m
12250,3,Icyteck,3197,120,8,8,16,50.0%,6m
12250,3,[K0mpis]Henrik,3197,155,5,2,7,71.4%,13m
12250,1,Ternence,3197,142,5,2,7,71.4%,17m
12250,3,Alatier,3197,144,5,3,8,62.5%,3m
12250,3,Nirvash,3197,0,4,1,5,80.0%,1h
12250,1,nvasion,3197,80,2,1,3,66.7%,3m
12250,3,KingSombra,3197,30,2,2,4,50.0%,11m
12250,3,IIIIIIIIIIII,3197,0,1,0,1,100.0%,18m
12250,1,[1FU2]IvMSaoSin,3197,0,1,0,1,100.0%,9m
12250,3,tholori,3197,30,1,4,5,20.0%,21m
12250,3,ket,3197,30,1,4,5,20.0%,9m
12250,1,[Ugg]JCreepers,3197,0,0,1,1,0.0%,14m
12267,3,randomhacker,3196,1298,78,80,158,49.4%,23m
12267,3,миша,3196,1358,76,58,134,56.7%,17m
12267,3,Guster,3196,834,44,37,81,54.3%,4m
12267,1,Rain,3196,146,6,5,11,54.5%,22m
12267,3,Thurlogus,3196,97,4,2,6,66.7%,35m
12267,3,[AiRǂ]Biscibasci,3196,97,3,2,5,60.0%,10m
12267,3,ISOLATE,3196,30,2,3,5,40.0%,21m
12267,1,[F0B]psystorm,3196,40,1,2,3,33.3%,10m
12267,1,[N2]LALE,3196,0,0,1,1,0.0%,17m
12276,3,Kolokolchi,3195,1351,142,125,267,53.2%,8m
12276,3,StarLord,3195,1082,115,101,216,53.2%,11m
12276,3,seiken,3195,1402,75,66,141,53.2%,12m
12276,3,Litavik,3195,522,19,20,39,48.7%,19m
12276,3,KucenahradCZ,3195,311,16,12,28,57.1%,18m
12276,3,SziDschey,3195,224,13,8,21,61.9%,14m
12276,2,EkWo,3195,164,9,5,14,64.3%,11m
12276,1,Mexxxus,3195,185,7,4,11,63.6%,19m
12276,3,xfree,3195,204,6,12,18,33.3%,13m
12276,3,IIIIIIIIIII,3195,0,4,1,5,80.0%,7m
12276,3,Rohkar,3195,170,4,5,9,44.4%,15m
12276,1,[BSPP]Zorrk,3195,116,3,2,5,60.0%,2m
12276,1,[AISC]Mackin,3195,130,3,3,6,50.0%,8m
12276,3,[W33]Apollo,3195,30,2,2,4,50.0%,3m
12276,1,[Sents]EliteOma,3195,42,2,5,7,28.6%,7m
12276,3,[HsDL]plaz,3195,30,2,6,8,25.0%,24m
12276,2,Lightman,3195,0,1,0,1,100.0%,1h
12276,3,[GLGLG]Максимус,3195,94,1,2,3,33.3%,24m
12276,1,MARKUS,3195,0,0,1,1,0.0%,14m
12276,1,Dudyaka,3195,0,0,1,1,0.0%,24m
12296,3,TakT,3194,1574,144,134,278,51.8%,16m
12296,3,eogertrud,3194,599,98,98,196,50.0%,18m
12296,3,[xFSRx]Erich,3194,1542,82,51,133,61.7%,24m
12296,3,[Fruz]Striker,3194,1160,67,58,125,53.6%,19m
12296,1,Niko,3194,1573,59,49,108,54.6%,17m
12296,3,Waffi,3194,336,15,18,33,45.5%,12m
12296,3,[DIDLIN]ountzountz,3194,240,8,12,20,40.0%,11m
12296,1,[2eaZy]pETRU,3194,118,6,3,9,66.7%,1h
12296,2,Ozzy,3194,142,4,4,8,50.0%,1h
12296,1,sQuirrel,3194,0,1,0,1,100.0%,6m
12296,3,Case,3194,30,1,3,4,25.0%,24m
12307,3,Didiou,3193,1568,310,304,614,50.5%,15m
12307,3,Strife,3193,1556,180,169,349,51.6%,15m
12307,3,[D0N3]jobiz,3193,1105,79,68,147,53.7%,11m
12307,3,MrNoseman,3193,1591,68,57,125,54.4%,11m
12307,3,MrLemon,3193,551,52,60,112,46.4%,12m
12307,3,Goldfish,3193,1012,47,39,86,54.7%,19m
12307,3,ppark,3193,715,47,49,96,49.0%,21m
12307,3,[Mester]Contingente,3193,539,21,18,39,53.8%,4m
12307,3,Gorthaur,3193,293,19,16,35,54.3%,14m
12307,3,xlon,3193,421,18,14,32,56.2%,24m
12307,3,qooqoo,3193,466,17,20,37,45.9%,2m
12307,3,AHTOXA,3193,444,16,19,35,45.7%,9m
12307,3,BadMoonz,3193,356,13,18,31,41.9%,18m
12307,3,ZeratuL,3193,260,11,5,16,68.8%,18m
12307,3,ARRRRRRP,3193,296,11,10,21,52.4%,6m
12307,1,lel,3193,208,6,5,11,54.5%,23m
12307,1,GucciPoochie,3193,124,5,2,7,71.4%,24m
12307,1,Bonjed,3193,97,5,3,8,62.5%,7m
12307,3,[ПОПА]PIskaSTroy,3193,30,3,5,8,37.5%,6m
12307,3,Nokiteck,3193,88,3,10,13,23.1%,6m
12307,3,Proberto,3193,93,2,1,3,66.7%,11m
12307,1,rITZY,3193,0,0,1,1,0.0%,17m
12307,3,che,3193,0,0,1,1,0.0%,20m
12307,3,YannickTamR,3193,0,0,2,2,0.0%,2m
12331,3,[GET]TheCaptain,3192,1475,128,119,247,51.8%,6m
12331,1,Higgs,3192,1639,116,83,199,58.3%,21m
12331,3,ParkSodam,3192,1390,56,57,113,49.6%,8m
12331,3,Schneeble,3192,863,33,33,66,50.0%,21m
12331,3,[0VI]Spike,3192,446,17,16,33,51.5%,6m
12331,3,razormaul,3192,395,14,15,29,48.3%,13m
12331,3,Kai,3192,382,13,14,27,48.1%,7m
12331,3,Swip,3192,260,11,5,16,68.8%,5m
12331,1,[биотех]hfafoq,3192,343,8,6,14,57.1%,20m
12331,2,Dorn,3192,0,2,4,6,33.3%,11m
12331,1,nybkorak,3192,0,1,0,1,100.0%,14m
12331,3,[TBMF]Lukas,3192,0,1,2,3,33.3%,10m
12331,3,[ÖMO]Jules,3192,0,0,1,1,0.0%,1h
12344,3,[OРДА]answer,3191,916,54,55,109,49.5%,3m
12344,3,[XGKS]PeCoRiNo,3191,1115,53,47,100,53.0%,23m
12344,3,[Torby]STINGER,3191,1076,40,48,88,45.5%,19m
12344,1,[КПCC]FireZerg,3191,605,32,12,44,72.7%,14m
12344,3,MarcoPolo,3191,583,32,27,59,54.2%,8m
12344,3,Toppy,3191,745,31,31,62,50.0%,20m
12344,3,sTalkeR,3191,758,30,26,56,53.6%,21m
12344,3,[InitRu]wispEr,3191,591,28,27,55,50.9%,21m
12344,3,Semmler,3191,590,23,31,54,42.6%,21m
12344,3,MATIX,3191,420,18,14,32,56.2%,6m
12344,3,soulyx,3191,472,16,23,39,41.0%,13m
12344,3,[dLife]Destroyed,3191,167,13,3,16,81.2%,6m
12344,3,[StrHon]MonstR,3191,212,7,16,23,30.4%,22m
12344,3,[RoAST]TeddyBagwell,3191,173,5,7,12,41.7%,9m
12344,3,newtosctwo,3191,142,5,8,13,38.5%,18m
12344,3,[WRush]terendul,3191,0,4,1,5,80.0%,1h
12344,1,[FrRacl]Anuviel,3191,84,3,1,4,75.0%,10m
12344,3,SnarkyGoblin,3191,30,1,5,6,16.7%,20m
12344,2,[PИD]ClockWise,3191,0,1,6,7,14.3%,35m
12363,3,[RedFmm]REDDEVIL,3190,1449,116,116,232,50.0%,14m
12363,3,ELpedios,3190,1265,81,76,157,51.6%,11m
12363,3,Martinator,3190,1113,43,51,94,45.7%,13m
12363,3,belOk,3190,782,42,43,85,49.4%,22m
12363,3,Deverio,3190,658,27,20,47,57.4%,19m
12363,3,Zitroni,3190,347,21,18,39,53.8%,3m
12363,3,elKato,3190,516,20,14,34,58.8%,19m
12363,3,Miwka,3190,500,20,17,37,54.1%,9m
12363,2,KiwiNini,3190,325,15,7,22,68.2%,11m
12363,3,Spyder,3190,319,13,11,24,54.2%,21m
12363,3,XenoGear,3190,142,6,9,15,40.0%,13m
12363,1,GameZsoocube,3190,158,5,3,8,62.5%,18m
12363,1,Funnyway,3190,202,5,6,11,45.5%,14m
12363,3,Complex,3190,0,4,1,5,80.0%,22m
12363,2,Jefe,3190,0,4,2,6,66.7%,33m
12363,1,Holyor,3190,117,3,0,3,100.0%,22m
12363,3,[ZCUP]GoodGameFil,3190,58,3,3,6,50.0%,21m
12363,1,Vudurlak,3190,40,3,3,6,50.0%,14m
12363,3,time,3190,90,3,6,9,33.3%,7m
12363,3,Alzapúa,3190,94,3,11,14,21.4%,11m
12363,3,[QRWA]Grissek,3190,95,2,1,3,66.7%,11m
12363,3,[WBO]TentacleChad,3190,120,2,3,5,40.0%,15m
12363,2,VanKri,3190,0,1,0,1,100.0%,18m
12363,2,Kitty,3190,88,1,1,2,50.0%,8m
12363,3,mrRom,3190,30,1,3,4,25.0%,7m
12363,1,briznokovic,3190,40,1,5,6,16.7%,24m
12363,1,Parzival,3190,0,0,1,1,0.0%,16m
12363,3,Niwri,3190,0,0,2,2,0.0%,9m
12363,3,TwitchChat,3190,0,0,3,3,0.0%,17m
12392,3,twentyfour,3189,1541,206,183,389,53.0%,6m
12392,3,crc,3189,1233,136,127,263,51.7%,12m
12392,3,[TxM]Reason,3189,1153,49,42,91,53.8%,8m
12392,3,[Suomii]Earthling,3189,429,30,22,52,57.7%,7m
12392,1,Rhohelix,3189,376,18,11,29,62.1%,7m
12392,3,Fiif,3189,405,18,11,29,62.1%,12m
12392,3,Scipion,3189,487,18,16,34,52.9%,14m
12392,1,Holgerrr,3189,395,12,10,22,54.5%,16m
12392,3,Zizu,3189,274,9,7,16,56.2%,22m
12392,1,rinGO,3189,232,7,1,8,87.5%,3m
12392,1,[TBPZDA]Borodality,3189,276,7,5,12,58.3%,21m
12392,3,GTYovkov,3189,220,6,6,12,50.0%,15m
12392,3,oskar,3189,154,5,12,17,29.4%,21m
12392,3,EvilDwarf,3189,92,3,5,8,37.5%,24m
12392,1,saver,3189,44,2,0,2,100.0%,14m
12392,1,[F4NES]FeTa,3189,84,2,1,3,66.7%,17m
12392,3,[RBadB]Smaug,3189,58,2,4,6,33.3%,15m
12392,1,Gulain,3189,42,1,1,2,50.0%,21m
12392,3,[LADD3R]pigeOn,3189,94,1,2,3,33.3%,11m
12392,3,Zultan,3189,30,1,4,5,20.0%,14m
12392,1,Serral,3189,42,1,6,7,14.3%,3m
12392,1,Epicmous,3189,0,0,1,1,0.0%,10m
12392,1,DanTe,3189,0,0,1,1,0.0%,2m
12392,1,ProtoSlayer,3189,0,0,1,1,0.0%,11m
12392,1,VIVAAMLO,3189,0,0,1,1,0.0%,3m
12417,3,Stringer,3188,1528,163,152,315,51.7%,17m
12417,3,DAWickeD,3188,1537,93,73,166,56.0%,7m
12417,3,Fil,3188,915,39,27,66,59.1%,15m
12417,3,[lloll]DadSkil,3188,782,37,38,75,49.3%,23m
12417,3,[EUww1]CorvetteCorp,3188,853,35,28,63,55.6%,13m
12417,1,[tvESP]maralekos,3188,939,32,25,57,56.1%,11m
12417,3,Human,3188,503,29,34,63,46.0%,13m
12417,3,Klimo,3188,273,9,7,16,56.2%,23m
12417,1,Ferkl,3188,120,4,3,7,57.1%,14m
12417,3,Yaleo,3188,90,4,8,12,33.3%,24m
12417,3,[HappyN]zedidous,3188,30,2,3,5,40.0%,17m
12417,1,DePhoenix,3188,0,0,1,1,0.0%,13m
12417,3,FusRoDah,3188,0,0,2,2,0.0%,8m
12430,3,ЮрийДонецк,3187,1677,371,360,731,50.8%,2m
12430,3,SlowHandsOiq,3187,1340,235,222,457,51.4%,9m
12430,1,Krys,3187,1469,75,65,140,53.6%,6m
12430,3,RinGO,3187,915,50,42,92,54.3%,23m
12430,3,[DZTK]hoppla,3187,674,28,23,51,54.9%,11m
12430,3,Tkitwa,3187,514,24,11,35,68.6%,18m
12430,3,[Sents]Terrormango,3187,489,22,16,38,57.9%,11m
12430,3,[ITGC]Alex,3187,512,18,23,41,43.9%,4m
12430,3,[TeamLB]YsatyiNindja,3187,413,17,14,31,54.8%,19m
12430,2,Jordanwheel,3187,351,13,5,18,72.2%,8m
12430,3,zalupich,3187,265,9,7,16,56.2%,21m
12430,1,[Penza]regar,3187,222,6,2,8,75.0%,24m
12430,3,HappyTimes,3187,182,6,13,19,31.6%,8m
12430,1,BoBjoKR,3187,120,5,2,7,71.4%,16m
12430,3,[HunF]Relanc,3187,0,4,1,5,80.0%,4m
12430,3,Rusello,3187,86,4,5,9,44.4%,17m
12430,3,IIIIIIIIII,3187,0,2,0,2,100.0%,22m
12430,1,Isle,3187,0,1,0,1,100.0%,24m
12430,3,Axios,3187,0,1,2,3,33.3%,16m
12430,1,[НТТ]SwitcheR,3187,0,0,1,1,0.0%,4m
12450,3,ruaol,3186,1490,165,170,335,49.3%,3m
12450,3,[ChTe]LaKuz,3186,558,46,47,93,49.5%,21m
12450,3,[Sativa]acid,3186,850,38,29,67,56.7%,11m
12450,3,Coldamp,3186,380,27,22,49,55.1%,6m
12450,3,Zulla,3186,414,15,18,33,45.5%,11m
12450,3,Arx,3186,410,14,20,34,41.2%,13m
12450,1,NoNamesLeft,3186,482,13,13,26,50.0%,6m
12450,3,[sc2vid]Cryo,3186,86,7,5,12,58.3%,6m
12450,3,KruT,3186,197,6,5,11,54.5%,18m
12450,3,HunterDeath,3186,0,5,0,5,100.0%,1h
12450,3,Norczii,3186,97,5,1,6,83.3%,43m
12450,3,Lawliet,3186,176,5,3,8,62.5%,20m
12450,3,Yandex,3186,146,3,4,7,42.9%,10m
12450,3,Bux,3186,94,1,2,3,33.3%,14m
12450,3,[ExJack]VanDoom,3186,94,1,2,3,33.3%,9m
12450,3,[Defeat]Svenling,3186,0,1,2,3,33.3%,7m
12450,1,GaneSh,3186,0,0,1,1,0.0%,14m
12450,1,Elleg,3186,0,0,1,1,0.0%,23m
12468,3,Perseus,3185,1593,317,317,634,50.0%,11m
12468,3,[VaNa]DeeCeeCee,3185,1204,99,98,197,50.3%,11m
12468,3,[EYSAT]Wielebny,3185,433,56,48,104,53.8%,9m
12468,1,[CeRviD]Титан,3185,825,30,16,46,65.2%,5m
12468,1,[CHCH]scvonfire,3185,810,27,19,46,58.7%,17m
12468,3,Taladas,3185,642,26,23,49,53.1%,7m
12468,3,pLEITE,3185,678,26,31,57,45.6%,21m
12468,3,AlexOpenAI,3185,501,25,15,40,62.5%,4m
12468,1,blessRNG,3185,294,9,5,14,64.3%,24m
12468,2,fjjotizz,3185,182,8,19,27,29.6%,24m
12468,1,GrumpyDwarf,3185,238,6,5,11,54.5%,16m
12468,1,Joker,3185,212,6,6,12,50.0%,2m
12468,3,[UATeam]Neyv,3185,176,5,3,8,62.5%,10m
12468,1,Fabian,3185,0,4,1,5,80.0%,6m
12468,3,Neo,3185,139,2,5,7,28.6%,7m
12468,1,MarineKing,3185,95,2,7,9,22.2%,19m
12468,1,КРИСТИАН,3185,0,0,1,1,0.0%,24m
12468,3,[R1X]Minto,3185,0,0,2,2,0.0%,4m
12486,3,NiTroX,3184,1623,242,233,475,50.9%,14m
12486,3,Obelix,3184,1234,164,154,318,51.6%,8m
12486,3,NikeR,3184,1340,97,84,181,53.6%,15m
12486,3,ClinLoy,3184,838,41,22,63,65.1%,11m
12486,3,[Dniw3]StoneSculpt,3184,685,41,43,84,48.8%,10m
12486,3,Louka,3184,503,30,33,63,47.6%,13m
12486,3,Tchayen,3184,381,28,18,46,60.9%,24m
12486,3,Donald,3184,304,12,13,25,48.0%,7m
12486,3,RudiBrudi,3184,92,7,5,12,58.3%,21m
12486,3,[lIIlII]ĆùċķŇøŕŗîş,3184,179,6,3,9,66.7%,4m
12486,1,JeanMichelOP,3184,204,6,5,11,54.5%,11m
12486,3,HaveANiceDay,3184,186,6,21,27,22.2%,24m
12486,3,lewfen,3184,88,5,11,16,31.2%,8m
12486,1,Xenuxus,3184,0,4,1,5,80.0%,3m
12486,3,[DeGame]LostHope,3184,172,4,5,9,44.4%,7m
12486,1,newel,3184,112,3,3,6,50.0%,19m
12486,3,Nir,3184,60,3,4,7,42.9%,8m
12486,3,Sachgor,3184,30,2,4,6,33.3%,11m
12486,3,summerjuice,3184,0,1,0,1,100.0%,23m
12486,3,Goldbowser,3184,30,1,3,4,25.0%,22m
12506,3,Yossarian,3183,1206,154,136,290,53.1%,8m
12506,3,[INBASE]wardog,3183,789,32,46,78,41.0%,21m
12506,3,jakaba,3183,660,26,22,48,54.2%,14m
12506,2,[C11410]PaxGordon,3183,314,12,11,23,52.2%,11m
12506,3,Monax,3183,288,11,12,23,47.8%,24m
12506,3,OladismFREE,3183,282,9,8,17,52.9%,18m
12506,3,[LXH]Xiong,3183,222,9,9,18,50.0%,20m
12506,3,Sirgomir,3183,184,6,13,19,31.6%,24m
12506,3,[1830]Mainzerg,3183,152,6,14,20,30.0%,6m
12506,1,[noHoc]YORIKvp,3183,74,3,1,4,75.0%,21m
12506,3,demich,3183,0,3,2,5,60.0%,1h
12506,3,[Arrows]Metvix,3183,0,1,1,2,50.0%,7m
12506,1,Astrologue,3183,0,0,1,1,0.0%,14m
12506,1,IIIIIIIIIIII,3183,0,0,1,1,0.0%,16m
12506,3,Tsirkon,3183,0,0,6,6,0.0%,13m
12521,3,[SPbRu]daradevil,3182,673,45,40,85,52.9%,7m
12521,3,[KBY]Tyrrannical,3182,871,35,37,72,48.6%,12m
12521,3,[ЭЩКЕPЕ]Элджей,3182,952,35,43,78,44.9%,18m
12521,3,Arcail,3182,766,34,26,60,56.7%,9m
12521,1,[Swaagy]MelchChue,3182,652,23,17,40,57.5%,17m
12521,3,Sergant,3182,419,21,7,28,75.0%,12m
12521,1,BeyBichey,3182,618,17,13,30,56.7%,14m
12521,3,[PiMoK]STONEDzealot,3182,416,15,16,31,48.4%,9m
12521,1,Wernoff,3182,322,12,7,19,63.2%,22m
12521,2,[PiGPan]RageQuitter,3182,118,6,2,8,75.0%,20m
12521,3,Vortex,3182,182,6,3,9,66.7%,24m
12521,3,RusKnight,3182,134,6,3,9,66.7%,7m
12521,3,MiF,3182,182,6,10,16,37.5%,18m
12521,3,[eSRT]Gespenst,3182,104,5,5,10,50.0%,11m
12521,3,Totoshka,3182,0,4,1,5,80.0%,1h
12521,2,Kekse,3182,0,4,2,6,66.7%,7m
12521,3,[mfixed]TheProbius,3182,86,4,5,9,44.4%,5m
12521,1,zsoma,3182,80,3,0,3,100.0%,11m
12521,3,PasQ,3182,120,2,1,3,66.7%,23m
12521,3,Letto,3182,60,2,4,6,33.3%,4m
12521,3,[T4WL]JožinBažin,3182,0,1,1,2,50.0%,11m
12521,2,Kirk,3182,0,0,2,2,0.0%,18m
12521,3,[OSgZ]Darkside,3182,0,0,3,3,0.0%,17m
12544,3,xЗmIL,3181,1540,466,465,931,50.1%,23m
12544,3,SnowMan,3181,1155,246,243,489,50.3%,5m
12544,3,Wizart,3181,1364,155,145,300,51.7%,6m
12544,3,[GOCCM]IIIIIIIIIIII,3181,1269,58,44,102,56.9%,7m
12544,3,Backkiss,3181,641,40,39,79,50.6%,6m
12544,3,[PLA2N]ProtoseGG,3181,776,39,37,76,51.3%,21m
12544,3,[Krabы]titanik,3181,534,35,22,57,61.4%,21m
12544,3,[GosuB]Yavoul,3181,958,33,42,75,44.0%,11m
12544,3,Kronos,3181,503,18,28,46,39.1%,4m
12544,3,Sane,3181,367,17,9,26,65.4%,7m
12544,1,[AiRǂ]AirBass,3181,356,14,4,18,77.8%,16m
12544,3,NOOBER,3181,232,8,16,24,33.3%,4m
12544,1,imnoob,3181,38,5,2,7,71.4%,21m
12544,3,[LE4VE]anorganic,3181,144,5,10,15,33.3%,21m
12544,1,[xBR0x]kiwixy,3181,158,4,2,6,66.7%,17m
12544,1,[ULTX]Moritz,3181,84,2,3,5,40.0%,16m
12544,3,ANDUXIII,3181,94,1,2,3,33.3%,4m
12544,3,[impro]Natasat,3181,30,1,5,6,16.7%,13m
12544,3,[PaniC]ProRockSpiro,3181,0,0,2,2,0.0%,4m
12544,1,[FisssT]Zorro,3181,0,0,4,4,0.0%,1h
12564,3,RockYou,3180,507,93,77,170,54.7%,18m
12564,3,Weak,3180,701,61,69,130,46.9%,13m
12564,3,DanMadrid,3180,634,28,25,53,52.8%,4m
12564,3,[TDCHK]Croustigrou,3180,528,22,16,38,57.9%,7m
12564,3,HansFasching,3180,465,15,17,32,46.9%,2m
12564,2,[D0N3]UndaPressure,3180,288,14,6,20,70.0%,10m
12564,3,RadL,3180,380,12,20,32,37.5%,10m
12564,1,FastP,3180,316,10,1,11,90.9%,14m
12564,1,jokker,3180,212,9,5,14,64.3%,1h
12564,3,[SlavSC]Axels,3180,152,7,5,12,58.3%,21m
12564,3,[hrdcor]Abr,3180,173,5,4,9,55.6%,14m
12564,3,[lnvoke]MicMaN,3180,60,3,3,6,50.0%,11m
12564,1,NiKiTa,3180,36,2,0,2,100.0%,3m
12564,3,Shakewell,3180,30,2,5,7,28.6%,8m
12564,1,[UAŦeam]Levoki,3180,0,1,0,1,100.0%,6m
12564,1,[SproL]Sheik,3180,0,0,1,1,0.0%,10m
12580,3,alwajeh,3179,1555,150,144,294,51.0%,17m
12580,3,Lolkopf,3179,1526,136,127,263,51.7%,11m
12580,1,sid,3179,1788,135,132,267,50.6%,14m
12580,3,[antkr]Holshok,3179,1577,132,130,262,50.4%,6m
12580,3,Phaedrus,3179,998,83,87,170,48.8%,14m
12580,3,Volo,3179,900,39,31,70,55.7%,21m
12580,1,[PLA2N]ILYA,3179,701,32,20,52,61.5%,21m
12580,3,Polipastman,3179,537,28,12,40,70.0%,9m
12580,3,[PaniC]NotMe,3179,491,21,17,38,55.3%,14m
12580,3,Edge,3179,286,18,7,25,72.0%,23m
12580,1,DrPhilGood,3179,393,16,2,18,88.9%,18m
12580,3,köttar,3179,280,10,16,26,38.5%,10m
12580,3,Rickmouth,3179,267,9,7,16,56.2%,7m
12580,3,[CHustl]Unrider,3179,203,6,4,10,60.0%,23m
12580,3,[voff]FoxNews,3179,207,6,5,11,54.5%,17m
12580,3,[SSeiya]Hyoga,3179,44,4,0,4,100.0%,11m
12580,1,Laziale,3179,0,4,1,5,80.0%,10m
12580,2,[FOREX]dima,3179,48,4,4,8,50.0%,11m
12580,3,[Albani]UKIofAlbania,3179,120,3,2,5,60.0%,19m
12580,1,КАПКАН,3179,38,2,5,7,28.6%,22m
12580,3,SteDim,3179,30,2,7,9,22.2%,20m
12580,3,ПапинТапок,3179,30,1,5,6,16.7%,14m
12580,1,Andiodr,3179,0,0,1,1,0.0%,9m
12580,1,Torres,3179,0,0,1,1,0.0%,1h
12580,1,DrStrudel,3179,0,0,1,1,0.0%,10m
12580,3,[Herz]Isengrim,3179,0,0,2,2,0.0%,22m
12606,3,Nacho,3178,1615,230,217,447,51.5%,14m
12606,1,Slama,3178,1559,75,62,137,54.7%,7m
12606,3,[НТТ]DarkDay,3178,780,70,64,134,52.2%,12m
12606,3,[WFGER]Francmen,3178,1398,66,61,127,52.0%,23m
12606,3,Marinauder,3178,1070,48,33,81,59.3%,17m
12606,3,ololo,3178,805,34,36,70,48.6%,2m
12606,3,Hyperion,3178,824,31,35,66,47.0%,4m
12606,3,Dragorify,3178,471,26,24,50,52.0%,6m
12606,3,busybeaver,3178,463,25,18,43,58.1%,15m
12606,3,Meliodas,3178,396,17,12,29,58.6%,14m
12606,3,[3raza]Cazagames,3178,447,17,14,31,54.8%,7m
12606,3,adrian,3178,440,15,26,41,36.6%,23m
12606,3,TIME,3178,185,9,6,15,60.0%,7m
12606,3,[TmDOG]oppozitPro,3178,299,9,9,18,50.0%,10m
12606,1,[D0N3]IoPinco,3178,278,7,8,15,46.7%,20m
12606,1,SHEnin,3178,151,6,6,12,50.0%,19m
12606,1,hunter,3178,158,5,4,9,55.6%,8m
12606,3,Hellden,3178,198,5,7,12,41.7%,19m
12606,3,Nosu,3178,0,4,1,5,80.0%,6m
12606,1,FatherDrift,3178,42,2,0,2,100.0%,4m
12606,1,Aqvaspillwe,3178,82,2,2,4,50.0%,23m
12606,3,Hola,3178,30,2,5,7,28.6%,9m
12606,1,[T11]Guiltless,3178,0,1,0,1,100.0%,6m
12606,3,Tbroco,3178,0,1,3,4,25.0%,17m
12606,1,boratsagdiev,3178,0,0,1,1,0.0%,6m
12606,3,[сSсǃ]vehugo,3178,0,0,4,4,0.0%,7m
12632,3,[PPHD]Pädl,3177,1544,65,65,130,50.0%,19m
12632,3,Commander,3177,1102,42,39,81,51.9%,19m
12632,3,Pilot,3177,606,33,42,75,44.0%,6m
12632,3,marcos,3177,451,17,16,33,51.5%,23m
12632,1,Coffee,3177,358,13,12,25,52.0%,8m
12632,1,ScottyBoom,3177,281,12,8,20,60.0%,21m
12632,3,uvccv,3177,332,12,11,23,52.2%,9m
12632,1,naikEn,3177,278,9,7,16,56.2%,2m
12632,1,SmurfnTurf,3177,267,8,0,8,100.0%,23m
12632,2,IsifLiferu,3177,225,8,11,19,42.1%,2m
12632,2,Torn,3177,182,7,3,10,70.0%,30m
12632,3,TheKies,3177,111,7,5,12,58.3%,3m
12632,3,Zoakin,3177,58,3,4,7,42.9%,19m
12632,1,Krastanis,3177,78,2,1,3,66.7%,10m
12632,1,Wiche,3177,42,2,1,3,66.7%,10m
12632,1,[ICG]Raynorlulu,3177,139,2,5,7,28.6%,22m
12632,1,Bro,3177,40,1,1,2,50.0%,4m
12632,2,Rick,3177,48,1,2,3,33.3%,3m
12632,1,ZoniDruid,3177,42,1,2,3,33.3%,24m
12632,3,Grosdam,3177,0,1,6,7,14.3%,24m
12632,1,Nooby,3177,0,0,1,1,0.0%,22m
12632,1,DeX,3177,0,0,1,1,0.0%,17m
12632,1,HeMan,3177,0,0,1,1,0.0%,5m
12632,1,Zloikloun,3177,0,0,2,2,0.0%,21m
12656,3,Propagandalf,3176,1563,307,300,607,50.6%,2m
12656,3,[TAW]Gustav,3176,1287,158,144,302,52.3%,22m
12656,3,Blindsaplol,3176,589,61,42,103,59.2%,16m
12656,3,thorfin,3176,1324,51,63,114,44.7%,11m
12656,3,nrKst,3176,386,25,19,44,56.8%,18m
12656,1,Tomako,3176,660,23,12,35,65.7%,17m
12656,3,talarbad,3176,478,18,15,33,54.5%,19m
12656,1,Boyington,3176,568,16,16,32,50.0%,2m
12656,3,Pappuz,3176,443,15,15,30,50.0%,6m
12656,3,[Oupss]HeK,3176,264,14,13,27,51.9%,18m
12656,1,Ardantis,3176,464,13,14,27,48.1%,14m
12656,3,[C3R0]Eden,3176,100,9,7,16,56.2%,10m
12656,3,[Spec0p]Siggy,3176,267,9,8,17,52.9%,18m
12656,3,Montaigne,3176,171,8,7,15,53.3%,7m
12656,1,Illlllllllll,3176,0,1,0,1,100.0%,10m
12656,3,Sampi,3176,0,1,0,1,100.0%,1h
12656,1,kontur,3176,42,1,1,2,50.0%,6m
12656,1,klapper,3176,42,1,1,2,50.0%,22m
12656,1,Plague,3176,0,0,2,2,0.0%,22m
12675,3,llllllllllll,3175,1601,259,248,507,51.1%,6m
12675,3,DrMANo,3175,1602,83,78,161,51.6%,17m
12675,1,YEEHAW,3175,741,31,8,39,79.5%,14m
12675,3,PERESTRELKA,3175,632,29,23,52,55.8%,8m
12675,3,VeloceRa,3175,308,11,13,24,45.8%,24m
12675,3,[VuV]Lavo,3175,268,9,17,26,34.6%,4m
12675,3,niokr,3175,0,4,1,5,80.0%,18m
12675,3,[Psys]Psychodane,3175,97,4,2,6,66.7%,6m
12675,1,[PUDDI]YanYan,3175,42,2,0,2,100.0%,19m
12675,1,Cyra,3175,0,1,0,1,100.0%,19m
12675,1,llllllllllll,3175,42,1,1,2,50.0%,17m
12675,3,EEE,3175,0,1,4,5,20.0%,6m
12675,1,[TOWEA]TobyfleX,3175,0,0,1,1,0.0%,20m
12675,1,[KisSMy]AsSLover,3175,0,0,1,1,0.0%,12m
12689,3,MtenB,3174,871,259,250,509,50.9%,24m
12689,3,zuukCZ,3174,1363,82,66,148,55.4%,8m
12689,3,Kyzia,3174,1001,46,31,77,59.7%,24m
12689,1,kaskavel,3174,592,17,16,33,51.5%,22m
12689,3,[ZЕRGТV]Vladimir,3174,372,12,19,31,38.7%,10m
12689,1,[fubb]Krunch,3174,294,9,3,12,75.0%,4m
12689,3,Corzan,3174,120,4,12,16,25.0%,18m
12689,1,[KTK]Dino,3174,0,2,3,5,40.0%,23m
12689,3,Cerion,3174,0,2,4,6,33.3%,21m
12689,1,XPEHCMAKOM,3174,40,1,2,3,33.3%,2m
12699,3,Oxygen,3173,1480,216,204,420,51.4%,18m
12699,2,llllllllllll,3173,1517,211,244,455,46.4%,17m
12699,1,[Heroes]OrcoTMM,3173,1594,91,79,170,53.5%,18m
12699,1,Lehdari,3173,1276,43,41,84,51.2%,11m
12699,3,ohaz,3173,784,29,34,63,46.0%,11m
12699,1,Rookie,3173,633,27,12,39,69.2%,24m
12699,3,ultral,3173,407,18,10,28,64.3%,11m
12699,3,[Zelos]MirandaKerry,3173,286,11,7,18,61.1%,13m
12699,3,[ЯD]Rinogg,3173,308,11,17,28,39.3%,6m
12699,1,Schokobär,3173,266,10,6,16,62.5%,8m
12699,3,NebuLa,3173,302,10,11,21,47.6%,21m
12699,3,[SPHTRS]Monty,3173,240,9,12,21,42.9%,17m
12699,1,August,3173,30,2,1,3,66.7%,7m
12699,1,[BIGPL]Dantrox,3173,0,1,0,1,100.0%,10m
12699,1,RAYN,3173,0,1,0,1,100.0%,24m
12699,1,Zerglingonly,3173,0,1,0,1,100.0%,4m
12699,1,hardware,3173,42,1,1,2,50.0%,19m
12699,1,LDMA,3173,34,1,4,5,20.0%,14m
12699,1,DGARCIA,3173,0,0,1,1,0.0%,18m
12699,1,vita,3173,0,0,1,1,0.0%,23m
12699,1,[ZЕRGТV]Blade,3173,0,0,1,1,0.0%,14m
12720,3,Арториас,3172,1445,96,84,180,53.3%,24m
12720,3,drimacus,3172,1579,84,74,158,53.2%,7m
12720,1,Madadh,3172,1130,81,65,146,55.5%,11m
12720,3,DreamX,3172,1088,39,41,80,48.8%,8m
12720,3,diamondthrow,3172,713,30,27,57,52.6%,17m
12720,3,[DzL]urGrandpa,3172,846,29,37,66,43.9%,13m
12720,3,Nast,3172,616,28,19,47,59.6%,17m
12720,3,PingorochO,3172,495,18,32,50,36.0%,21m
12720,3,Tahugava,3172,426,16,11,27,59.3%,22m
12720,3,INQTV,3172,146,13,18,31,41.9%,22m
12720,3,Venom,3172,278,9,15,24,37.5%,14m
12720,3,rezac,3172,186,5,6,11,45.5%,21m
12720,3,[MSK5]Dastmodest,3172,146,5,8,13,38.5%,17m
12720,3,nobelhyperio,3172,0,4,2,6,66.7%,17m
12720,3,[Вика]Darkwiliurus,3172,114,4,11,15,26.7%,10m
12720,1,ChromeSteed,3172,120,3,2,5,60.0%,3m
12720,2,Zappenduster,3172,95,1,1,2,50.0%,31m
12720,1,Gspro,3172,44,1,1,2,50.0%,24m
12720,3,VetoVHS,3172,30,1,4,5,20.0%,19m
12720,1,Kalle,3172,0,0,1,1,0.0%,6m
12720,1,AnatolyM,3172,0,0,1,1,0.0%,14m
12720,3,Jarzabek,3172,0,0,4,4,0.0%,3m
12742,3,Xohoo,3171,1341,125,119,244,51.2%,17m
12742,3,BlackOrange,3171,1208,56,37,93,60.2%,12m
12742,3,[DIIF]Dillimaster,3171,700,38,32,70,54.3%,9m
12742,3,сасика,3171,923,38,32,70,54.3%,9m
12742,3,[sH33px]TheDeadSheep,3171,411,15,17,32,46.9%,21m
12742,1,GRIMM,3171,321,14,9,23,60.9%,24m
12742,3,Huanito,3171,299,13,9,22,59.1%,17m
12742,1,[RAKETA]Stikk,3171,434,12,10,22,54.5%,11m
12742,3,ProSnake,3171,254,9,12,21,42.9%,10m
12742,1,[Herz]HerzKuoni,3171,96,5,3,8,62.5%,32m
12742,1,ewerloct,3171,0,4,1,5,80.0%,4m
12742,3,qwnick,3171,148,3,5,8,37.5%,6m
12742,1,llllllllllll,3171,42,2,0,2,100.0%,23m
12742,3,Zaszz,3171,93,2,1,3,66.7%,5m
12742,1,[voff]IAmANoop,3171,0,1,0,1,100.0%,9m
12742,3,[ĦĦ]Dubu,3171,0,1,10,11,9.1%,14m
12742,1,Baggio,3171,0,0,1,1,0.0%,4m
12742,1,[PlantZ]SqTdRAZoR,3171,0,0,2,2,0.0%,10m
12742,3,Ворон,3171,0,0,2,2,0.0%,15m
12761,1,AngelS,3170,1355,217,198,415,52.3%,6m
12761,3,[Pxyool]MSK,3170,742,170,164,334,50.9%,12m
12761,3,SamSam,3170,471,67,56,123,54.5%,6m
12761,3,Azure,3170,889,42,42,84,50.0%,14m
12761,3,DrJCruncher,3170,858,42,55,97,43.3%,8m
12761,3,Serega,3170,1266,42,57,99,42.4%,12m
12761,3,[1WCG]Blackman,3170,748,35,37,72,48.6%,6m
12761,3,[pBNRq]MasterSuprem,3170,957,33,35,68,48.5%,15m
12761,3,Kira,3170,840,29,31,60,48.3%,17m
12761,3,Lex,3170,530,20,27,47,42.6%,15m
12761,3,vasilig,3170,385,11,25,36,30.6%,12m
12761,3,Daedalos,3170,207,9,7,16,56.2%,23m
12761,1,asic,3170,276,7,5,12,58.3%,3m
12761,3,Serpentor,3170,150,6,8,14,42.9%,16m
12761,3,Volodymyr,3170,64,3,9,12,25.0%,23m
12761,1,[SerraI]ZAWGURN,3170,95,2,0,2,100.0%,17m
12761,3,Caecae,3170,30,2,4,6,33.3%,11m
12761,1,Lamelisk,3170,0,1,0,1,100.0%,14m
12761,3,Soàh,3170,32,1,3,4,25.0%,18m
12761,1,[HBRG]ForAiur,3170,44,1,3,4,25.0%,23m
12761,3,Batlecruiser,3170,30,1,4,5,20.0%,21m
12761,3,MozgoloM,3170,0,0,1,1,0.0%,14m
12761,1,[MW2G]DRON,3170,0,0,2,2,0.0%,8m
12784,3,dax,3169,1532,99,101,200,49.5%,24m
12784,3,[DWTeam]Agent,3169,1210,65,68,133,48.9%,3m
12784,3,Heinrich,3169,1504,64,60,124,51.6%,20m
12784,1,Kocim,3169,1614,58,50,108,53.7%,3m
12784,3,Raizenator,3169,1308,56,64,120,46.7%,4m
12784,3,Draren,3169,1077,42,48,90,46.7%,4m
12784,1,AsSeenOnTV,3169,648,26,16,42,61.9%,24m
12784,3,Pagaille,3169,418,16,20,36,44.4%,11m
12784,3,Fenicx,3169,296,10,9,19,52.6%,15m
12784,3,CaptainStive,3169,230,9,13,22,40.9%,8m
12784,2,Salvu,3169,200,8,4,12,66.7%,1h
12784,1,IIIIIIIIIIII,3169,278,7,7,14,50.0%,16m
12784,3,ProxyOps,3169,0,4,1,5,80.0%,4m
12784,3,Froze,3169,90,4,5,9,44.4%,17m
12784,1,guhurak,3169,82,2,1,3,66.7%,17m
12784,3,Scorpion,3169,0,2,1,3,66.7%,7m
12784,1,[Swarm6]madness,3169,80,2,2,4,50.0%,24m
12784,3,[IceHus]shiper,3169,95,2,2,4,50.0%,7m
12784,3,[Hаsu]SaraNYA,3169,60,2,8,10,20.0%,6m
12784,1,Zergasm,3169,42,1,2,3,33.3%,19m
12784,3,Pichu,3169,0,1,2,3,33.3%,14m
12805,3,GLHF,3168,580,70,65,135,51.9%,5m
12805,3,Maza,3168,612,23,21,44,52.3%,8m
12805,3,[XIØI]DOMPTOR,3168,332,14,19,33,42.4%,3m
12805,1,Barryl,3168,349,12,3,15,80.0%,19m
12805,3,Slaygon,3168,343,11,10,21,52.4%,14m
12805,3,HellYeah,3168,86,7,4,11,63.6%,16m
12805,1,[696]nilsragnar,3168,158,5,4,9,55.6%,6m
12805,1,MediumAI,3168,0,4,1,5,80.0%,19m
12805,1,ARMATA,3168,164,4,6,10,40.0%,14m
12805,3,Kas,3168,0,3,2,5,60.0%,1h
12805,2,IIIIIIIIIIII,3168,88,2,0,2,100.0%,6m
12805,1,doodoo,3168,0,1,1,2,50.0%,12m
12805,1,[lOoOl]Doniak,3168,42,1,1,2,50.0%,12m
12805,3,[RedHS]NotEvenSpark,3168,0,1,2,3,33.3%,18m
12805,3,Sttrelok,3168,30,1,9,10,10.0%,20m
12820,3,Jooe,3167,1579,307,279,586,52.4%,4m
12820,3,JarJarWinks,3167,1518,222,214,436,50.9%,21m
12820,3,Kaotiques,3167,1368,126,98,224,56.2%,17m
12820,3,jjoeri,3167,1191,59,55,114,51.8%,9m
12820,3,Kamui,3167,1094,55,37,92,59.8%,7m
12820,3,Idolatracier,3167,1329,54,46,100,54.0%,19m
12820,3,krik,3167,1203,50,47,97,51.5%,14m
12820,3,zanca,3167,826,49,47,96,51.0%,8m
12820,1,[Craft]Hybert,3167,619,24,17,41,58.5%,11m
12820,1,Xenox,3167,500,21,10,31,67.7%,3m
12820,1,[PO1A1O]Bardude,3167,500,18,6,24,75.0%,17m
12820,3,volfram,3167,418,16,12,28,57.1%,11m
12820,3,[IaSl]Exoye,3167,300,14,11,25,56.0%,17m
12820,1,[LQV]Neb,3167,288,8,8,16,50.0%,17m
12820,3,[CS0]Tarwe,3167,188,6,4,10,60.0%,21m
12820,3,Rudde,3167,30,5,3,8,62.5%,11m
12820,3,IIIIIIIIII,3167,0,4,1,5,80.0%,27m
12820,3,Spirit,3167,0,4,2,6,66.7%,18m
12820,1,[EXPANT]Moon,3167,120,3,3,6,50.0%,24m
12820,3,NiCeViBeZZ,3167,97,2,0,2,100.0%,30m
12820,3,[Xy9lce]Ksv,3167,30,2,3,5,40.0%,15m
12820,1,TarS,3167,42,1,1,2,50.0%,17m
12820,1,[Kanga]ReioS,3167,0,0,1,1,0.0%,4m
12820,1,[NucPus]PussуРusher,3167,0,0,1,1,0.0%,7m
12844,3,Budyn,3166,1479,155,155,310,50.0%,8m
12844,3,Koulx,3166,1103,129,102,231,55.8%,11m
12844,3,[Gordi]Necromonger,3166,1349,83,88,171,48.5%,3m
12844,3,Djédys,3166,1164,79,86,165,47.9%,8m
12844,3,Ace,3166,1202,76,63,139,54.7%,10m
12844,3,aza,3166,622,76,67,143,53.1%,3m
12844,1,[VBNTM]KKJ,3166,1073,39,30,69,56.5%,3m
12844,1,ArkKnight,3166,967,35,29,64,54.7%,8m
12844,3,McLovIn,3166,576,22,23,45,48.9%,19m
12844,3,Nukular,3166,405,18,6,24,75.0%,4m
12844,3,Kalika,3166,370,14,11,25,56.0%,3m
12844,1,[75рус]НАГИБАТОР,3166,392,13,6,19,68.4%,3m
12844,3,BLUNT,3166,260,9,8,17,52.9%,21m
12844,1,[aW]Weedababzz,3166,343,9,9,18,50.0%,24m
12844,1,SeaW,3166,247,8,5,13,61.5%,39m
12844,3,FaZa,3166,217,7,4,11,63.6%,15m
12844,1,Shadowforce,3166,230,6,4,10,60.0%,17m
12844,3,[DUTEAM]Twan,3166,119,6,4,10,60.0%,18m
12844,3,DeaTHRaceR,3166,180,5,4,9,55.6%,6m
12844,3,JimmyHendrix,3166,187,5,7,12,41.7%,6m
12844,1,maroghk,3166,0,4,1,5,80.0%,13m
12844,1,[ArZs]Sahozen,3166,154,4,4,8,50.0%,10m
12844,1,xCrsHeR,3166,78,3,0,3,100.0%,17m
12844,1,DrAlexNone,3166,0,3,2,5,60.0%,24m
12844,1,Edmond,3166,0,1,0,1,100.0%,24m
12844,2,Fishlobs,3166,0,1,0,1,100.0%,9m
12844,1,AbbyHatcher,3166,0,1,0,1,100.0%,20m
12844,1,flapy,3166,42,1,1,2,50.0%,4m
12844,1,jon,3166,0,0,1,1,0.0%,4m
12844,1,Robczan,3166,0,0,2,2,0.0%,21m
12874,3,Nex,3165,1537,147,139,286,51.4%,12m
12874,2,[qip]xxxBONDxxx,3165,1354,134,152,286,46.9%,4m
12874,3,Terratosozer,3165,1548,99,74,173,57.2%,23m
12874,3,павилитель,3165,1380,52,51,103,50.5%,6m
12874,3,[SPAINs]NoScriptDude,3165,1133,50,46,96,52.1%,24m
12874,3,[Xa]niko,3165,1301,50,50,100,50.0%,20m
12874,3,locb,3165,915,42,40,82,51.2%,18m
12874,3,Serg,3165,939,37,33,70,52.9%,9m
12874,3,[ThClan]dlwhite,3165,329,27,33,60,45.0%,21m
12874,3,xxxNARUTOxxx,3165,388,14,17,31,45.2%,3m
12874,1,[TaDb]Stormwind,3165,274,8,3,11,72.7%,17m
12874,3,[DAGW]greenloar,3165,221,8,6,14,57.1%,8m
12874,2,Ninjamike,3165,165,6,3,9,66.7%,21m
12874,3,DenchikSpr,3165,0,5,0,5,100.0%,15m
12874,3,[PeGr]PÊÐØBÆR,3165,30,5,3,8,62.5%,7m
12874,1,[LPPH]Campigo,3165,102,4,7,11,36.4%,14m
12874,1,QuickFit,3165,0,3,0,3,100.0%,17m
12874,3,[Heyy]PowerPoint,3165,44,3,1,4,75.0%,4m
12892,1,azottoaz,3164,1798,489,461,950,51.5%,7m
12892,1,Marat,3164,1404,69,40,109,63.3%,24m
12892,3,isma,3164,1504,56,62,118,47.5%,4m
12892,3,[Dinky]Halloikama,3164,1102,45,39,84,53.6%,17m
12892,3,Tormentor,3164,947,43,41,84,51.2%,18m
12892,3,Linaslp,3164,884,33,35,68,48.5%,14m
12892,3,Shtirlitz,3164,746,27,28,55,49.1%,3m
12892,3,Bari,3164,449,26,21,47,55.3%,18m
12892,3,FilthyCasual,3164,655,26,24,50,52.0%,23m
12892,3,cienias,3164,626,26,30,56,46.4%,6m
12892,3,[EmŦ]Taru,3164,446,12,25,37,32.4%,24m
12892,3,NightAngel,3164,312,11,16,27,40.7%,24m
12892,1,BFGX,3164,322,8,8,16,50.0%,24m
12892,3,Nazgul,3164,150,8,11,19,42.1%,4m
12892,2,NovemberAnna,3164,187,6,6,12,50.0%,13m
12892,3,StarTUM,3164,200,6,17,23,26.1%,8m
12892,1,Gimmicking,3164,97,5,3,8,62.5%,1h
12892,3,Elysiian,3164,0,4,2,6,66.7%,22m
12892,1,MKZToten,3164,118,3,3,6,50.0%,17m
12892,3,balkall,3164,148,3,5,8,37.5%,3m
12892,1,Boots,3164,46,2,1,3,66.7%,16m
12892,3,UpsYouFail,3164,120,2,4,6,33.3%,4m
12892,1,Freedie,3164,0,1,0,1,100.0%,17m
12892,1,[ZЕRGТV]КоШаК,3164,0,1,1,2,50.0%,23m
12892,1,DarkMater,3164,0,0,1,1,0.0%,5m
12892,1,Sovjet,3164,0,0,2,2,0.0%,11m
12892,1,mouse,3164,0,0,2,2,0.0%,4m
12919,3,ShadyPope,3163,1154,156,156,312,50.0%,12m
12919,3,PrivateTiger,3163,1541,85,98,183,46.4%,6m
12919,1,[DCO]Moul,3163,1709,72,54,126,57.1%,12m
12919,3,habeo,3163,647,43,44,87,49.4%,6m
12919,3,[PiGPan]Emberck,3163,756,27,37,64,42.2%,3m
12919,1,Komics,3163,542,21,14,35,60.0%,6m
12919,1,[Trran]aea,3163,585,19,15,34,55.9%,20m
12919,3,HerojaK,3163,471,18,15,33,54.5%,17m
12919,3,[TirolA]Sloubi,3163,450,17,18,35,48.6%,9m
12919,3,[ON1ON]Serans,3163,458,17,22,39,43.6%,7m
12919,3,RobinR,3163,236,10,13,23,43.5%,7m
12919,1,AnttiAnttila,3163,255,8,8,16,50.0%,24m
12919,1,[Kutje]HammersField,3163,116,4,0,4,100.0%,20m
12919,3,[1v1ez]Frolt,3163,120,4,10,14,28.6%,17m
12919,1,[8021q]Alejandor,3163,78,3,2,5,60.0%,12m
12919,3,[H4P]green,3163,125,3,3,6,50.0%,22m
12919,1,[696]ArchitecT,3163,89,3,3,6,50.0%,24m
12919,3,[αX]rafikiminaj,3163,140,3,5,8,37.5%,10m
12919,1,[AClick]Krusnik,3163,42,2,0,2,100.0%,20m
12919,3,[696]Billy,3163,94,2,5,7,28.6%,12m
12919,2,[Petrиs]Ravvager,3163,0,1,0,1,100.0%,13m
12919,3,[CASTR]smj,3163,0,1,1,2,50.0%,15m
12941,3,smx,3162,1550,132,114,246,53.7%,18m
12941,3,Ormando,3162,574,126,118,244,51.6%,10m
12941,3,Karramba,3162,1484,123,108,231,53.2%,21m
12941,3,FABZ,3162,1116,83,77,160,51.9%,4m
12941,3,idd,3162,1489,72,72,144,50.0%,15m
12941,3,Doszpi,3162,1100,67,65,132,50.8%,4m
12941,3,Valdemar,3162,1094,44,42,86,51.2%,14m
12941,1,ThanosSnap,3162,544,23,12,35,65.7%,17m
12941,1,TheRedBert,3162,445,15,6,21,71.4%,14m
12941,1,Albatrosul,3162,374,11,8,19,57.9%,7m
12941,3,[TacoB]ЧудоПес,3162,218,11,19,30,36.7%,3m
12941,3,[prrr]AlphaPrawn,3162,289,10,8,18,55.6%,21m
12941,3,третийрейх,3162,198,9,6,15,60.0%,8m
12941,1,[FIXi]Мася,3162,198,6,2,8,75.0%,11m
12941,3,Butteye,3162,184,6,11,17,35.3%,21m
12941,3,[SYRNI]QhtenZiBotch,3162,107,5,5,10,50.0%,7m
12941,1,[RuPro]Ryzen,3162,82,3,2,5,60.0%,7m
12941,1,[Chelia]iBookScore,3162,42,1,2,3,33.3%,2m
12959,3,pinats,3161,1505,266,267,533,49.9%,24m
12959,1,naid,3161,1754,125,106,231,54.1%,9m
12959,3,[W0N]BaX,3161,1476,70,66,136,51.5%,17m
12959,1,HiddenPants,3161,1251,51,35,86,59.3%,4m
12959,3,SwIft,3161,822,49,42,91,53.8%,11m
12959,1,lIlllIlllIll,3161,1015,40,22,62,64.5%,22m
12959,3,Tantalum,3161,724,35,25,60,58.3%,6m
12959,3,Trill,3161,347,23,31,54,42.6%,4m
12959,1,lIlIlIlIlI,3161,390,22,5,27,81.5%,19m
12959,1,Shadow,3161,714,22,23,45,48.9%,17m
12959,3,FlakeyBanana,3161,514,19,17,36,52.8%,13m
12959,1,[Löfven]Gonum,3161,354,16,10,26,61.5%,19m
12959,1,[LV]lolsteamroll,3161,421,14,6,20,70.0%,11m
12959,1,[SpB83]GodFather,3161,365,11,3,14,78.6%,18m
12959,1,[GrPt]Пупырка,3161,319,11,8,19,57.9%,21m
12959,1,Peandor,3161,400,11,10,21,52.4%,5m
12959,3,[FrF]fabmedal,3161,150,6,10,16,37.5%,21m
12959,3,Stokes,3161,0,4,1,5,80.0%,4m
12959,3,[OLDbad]deesh,3161,19,2,4,6,33.3%,10m
12959,1,[GEGT]Majesty,3161,0,1,0,1,100.0%,11m
12959,1,Paolo,3161,0,1,0,1,100.0%,11m
12959,1,[EPIX]Kalime,3161,0,1,1,2,50.0%,11m
12959,1,wooka,3161,34,1,3,4,25.0%,19m
12959,1,TilyX,3161,0,0,1,1,0.0%,17m
12959,1,[EXPANT]Kami,3161,0,0,2,2,0.0%,17m
12959,1,[K0mpis]Draco,3161,0,0,2,2,0.0%,22m
12959,3,[Pmns]Ajax,3161,0,0,6,6,0.0%,12m
12986,3,Louvrissa,3160,1258,236,235,471,50.1%,2m
12986,3,Starley,3160,1529,158,155,313,50.5%,23m
12986,3,dizzi,3160,1408,147,153,300,49.0%,9m
12986,1,keyzero,3160,635,22,12,34,64.7%,6m
12986,3,Pichonek,3160,160,22,18,40,55.0%,9m
12986,3,cоndomring,3160,492,17,27,44,38.6%,11m
12986,3,[Floren]Cakisco,3160,121,5,3,8,62.5%,8m
12986,3,Röbelfröbel,3160,0,4,1,5,80.0%,6m
12986,1,MCPlayer,3160,198,4,1,5,80.0%,7m
12986,3,[xp]Buzz,3160,143,3,5,8,37.5%,18m
12986,1,[Urupin]FeniksFouks,3160,0,1,0,1,100.0%,21m
12986,1,FireKing,3160,0,1,1,2,50.0%,5m
12986,1,DreXzor,3160,0,0,2,2,0.0%,16m
12986,1,xHumanox,3160,0,0,3,3,0.0%,14m
12986,3,Kaškavala,3160,0,0,4,4,0.0%,13m
12986,3,Artyom,3160,0,0,11,11,0.0%,10m
13002,3,StevePS,3159,627,90,78,168,53.6%,6m
13002,1,[R33]DemoN,3159,812,39,4,43,90.7%,2m
13002,3,LiliumAtratm,3159,210,7,11,18,38.9%,19m
13002,1,Капитошка,3159,179,6,5,11,54.5%,20m
13002,3,Ramp,3159,0,5,0,5,100.0%,30m
13002,1,BegemS,3159,118,4,3,7,57.1%,20m
13002,2,[59APM]kalashnikov,3159,169,4,4,8,50.0%,6m
13002,3,[Toshko]Amadeaus,3159,165,4,6,10,40.0%,11m
13002,1,[XClayX]roman,3159,119,2,3,5,40.0%,1h
13002,1,Emufarmer,3159,142,2,3,5,40.0%,10m
13002,3,LikeSmoke,3159,58,2,5,7,28.6%,21m
13002,1,saigo,3159,0,1,1,2,50.0%,3m
13002,3,[NaNii]ChatDowz,3159,97,1,6,7,14.3%,7m
13002,1,Honesty,3159,0,0,2,2,0.0%,12m
13016,1,Sillic,3158,1147,102,87,189,54.0%,22m
13016,3,[Gоld]JEKA,3158,1163,71,73,144,49.3%,7m
13016,3,Nergath,3158,1461,61,48,109,56.0%,2m
13016,3,[DLM12]Kenshin,3158,796,31,34,65,47.7%,13m
13016,1,TheCosplayer,3158,428,29,13,42,69.0%,20m
13016,1,stranger,3158,551,25,7,32,78.1%,15m
13016,1,Kremon,3158,424,21,14,35,60.0%,7m
13016,3,Foxrobot,3158,506,21,16,37,56.8%,14m
13016,3,Comrad,3158,295,9,11,20,45.0%,14m
13016,1,[Blacer]Deminz,3158,235,6,9,15,40.0%,34m
13016,1,Toperhein,3158,96,5,3,8,62.5%,14m
13016,1,Regamium,3158,42,1,2,3,33.3%,22m
13016,1,[OldBG]NoamChomsky,3158,0,0,1,1,0.0%,17m
13016,1,[0BO]Slowmotion,3158,0,0,1,1,0.0%,3m
13030,3,[Hаsu]Style,3157,1132,115,110,225,51.1%,4m
13030,1,NightFox,3157,796,86,75,161,53.4%,17m
13030,1,FrostyFeet,3157,948,85,82,167,50.9%,7m
13030,3,anbecha,3157,570,81,62,143,56.6%,17m
13030,3,Suff,3157,1577,66,76,142,46.5%,3m
13030,3,[FxL]TheGeneral,3157,401,47,52,99,47.5%,9m
13030,1,desarter,3157,875,30,20,50,60.0%,7m
13030,1,[NotSuR]Destro,3157,879,29,23,52,55.8%,17m
13030,1,Michelada,3157,622,20,16,36,55.6%,14m
13030,3,HedronCrab,3157,575,20,20,40,50.0%,6m
13030,3,Inthoxx,3157,427,15,15,30,50.0%,14m
13030,3,Tasadar,3157,388,14,14,28,50.0%,24m
13030,1,Curtisio,3157,468,13,8,21,61.9%,2m
13030,1,Archs,3157,440,13,10,23,56.5%,4m
13030,3,Tiof,3157,392,13,24,37,35.1%,1m
13030,3,zosch,3157,287,10,10,20,50.0%,19m
13030,3,Muffin,3157,176,5,8,13,38.5%,11m
13030,1,[leOS]Ветер,3157,124,4,2,6,66.7%,8m
13030,1,Isabis,3157,84,2,3,5,40.0%,3m
13030,1,[aBk]Intok,3157,0,1,0,1,100.0%,9m
13030,1,llllllllllll,3157,40,1,3,4,25.0%,11m
13030,3,[FrostG]factoryman,3157,0,1,4,5,20.0%,1h
13030,2,[LeDude]FunGeneraL,3157,0,0,2,2,0.0%,13m
13053,3,Fampirus,3156,1565,253,242,495,51.1%,22m
13053,3,SebDollar,3156,1508,216,179,395,54.7%,10m
13053,3,Siffi,3156,625,189,173,362,52.2%,10m
13053,3,Cinesino,3156,1018,79,70,149,53.0%,11m
13053,3,RobertoBohm,3156,1044,65,59,124,52.4%,5m
13053,1,[UAŦeam]Юрец,3156,1693,64,52,116,55.2%,17m
13053,1,Kahlos,3156,1373,57,44,101,56.4%,11m
13053,1,Biohazard,3156,1229,42,38,80,52.5%,9m
13053,3,AlexisLionel,3156,922,33,39,72,45.8%,2m
13053,1,neverfailed,3156,739,23,22,45,51.1%,6m
13053,3,[Ug4y]Dogsbark,3156,407,15,10,25,60.0%,15m
13053,1,PeterGalaxy,3156,486,14,11,25,56.0%,11m
13053,2,Mistake,3156,300,13,11,24,54.2%,22m
13053,3,ImbaRageQuit,3156,290,10,24,34,29.4%,7m
13053,2,SarXon,3156,274,9,13,22,40.9%,13m
13053,1,Nitro,3156,90,5,1,6,83.3%,24m
13053,1,CaLiguLa,3156,152,5,2,7,71.4%,22m
13053,3,[DQI]Vaelve,3156,198,5,7,12,41.7%,5m
13053,1,JosephStalin,3156,120,3,6,9,33.3%,21m
13053,2,[TIBB]Halaloszto,3156,0,1,0,1,100.0%,17m
13053,1,TikANDTak,3156,0,1,1,2,50.0%,19m
13053,1,dragonslick,3156,0,1,1,2,50.0%,4m
13053,1,DeMassena,3156,42,1,2,3,33.3%,18m
13053,1,[PLEBZZ]Shiny,3156,40,1,3,4,25.0%,3m
13053,3,Syocto,3156,30,1,10,11,9.1%,5m
13078,3,[TAW]cantouchthis,3155,903,118,111,229,51.5%,17m
13078,3,IIIIIIIIIIII,3155,1523,97,84,181,53.6%,6m
13078,3,Zhed,3155,1470,89,78,167,53.3%,8m
13078,3,MageAJ,3155,923,60,57,117,51.3%,17m
13078,2,[HERP]Fourleaf,3155,654,29,48,77,37.7%,4m
13078,1,DeepEnds,3155,732,28,19,47,59.6%,22m
13078,1,fckProtoss,3155,402,12,6,18,66.7%,9m
13078,3,Antonshatt,3155,148,7,5,12,58.3%,8m
13078,3,Stribog,3155,121,5,2,7,71.4%,43m
13078,1,Красивая,3155,96,5,3,8,62.5%,10m
13078,1,bonk,3155,200,5,7,12,41.7%,1m
13078,1,Gorty,3155,158,4,5,9,44.4%,20m
13078,3,azanta,3155,142,3,5,8,37.5%,18m
13078,1,Jkornet,3155,40,2,1,3,66.7%,17m
13078,1,[BadMen]SupremeBeing,3155,42,2,2,4,50.0%,24m
13078,1,[Frogy]GringoLoco,3155,0,2,2,4,50.0%,22m
13078,1,Leto,3155,0,1,0,1,100.0%,22m
13078,1,ProTéoss,3155,42,1,2,3,33.3%,2m
13078,1,[IndyK]HerOuLiT,3155,42,1,3,4,25.0%,23m
13078,1,[Övis]Overlord,3155,0,1,4,5,20.0%,14m
13078,3,BooM,3155,30,1,6,7,14.3%,6m
13078,1,GacekDC,3155,0,0,1,1,0.0%,3m
13100,3,GGEasy,3154,1626,168,157,325,51.7%,21m
13100,3,MalaxovDuke,3154,1124,94,85,179,52.5%,4m
13100,3,BioRNN,3154,1277,46,63,109,42.2%,6m
13100,1,[FuCd]Mallyx,3154,659,42,36,78,53.8%,14m
13100,1,llllllllllll,3154,969,38,33,71,53.5%,8m
13100,3,[ZЕRGTV]дыдыдыр,3154,645,31,31,62,50.0%,9m
13100,3,ikkete,3154,470,28,30,58,48.3%,2m
13100,3,[EpICi]zomba,3154,357,11,12,23,47.8%,9m
13100,1,WooTzZ,3154,164,9,5,14,64.3%,9m
13100,1,[xoxxoo]llllllllllll,3154,256,7,3,10,70.0%,8m
13100,1,Dez,3154,86,4,6,10,40.0%,3m
13100,1,Fluttershy,3154,78,3,0,3,100.0%,15m
13100,1,math,3154,0,3,2,5,60.0%,1m
13100,1,[3GBY]GentleMan,3154,80,3,3,6,50.0%,6m
13100,1,[InSIG]Liom,3154,82,2,1,3,66.7%,2m
13100,1,Streamer,3154,80,2,1,3,66.7%,16m
13100,1,Hugejiji,3154,0,1,0,1,100.0%,17m
13100,1,Voose,3154,48,1,1,2,50.0%,15m
13100,3,[Камрад]Muchacho,3154,32,1,2,3,33.3%,17m
13100,3,RUINICALE,3154,0,1,4,5,20.0%,13m
13100,1,Adolic,3154,0,0,1,1,0.0%,17m
13100,1,Kudaku,3154,0,0,1,1,0.0%,19m
13100,1,Yof,3154,0,0,2,2,0.0%,10m
13123,3,OLiX,3153,1531,104,107,211,49.3%,16m
13123,1,ALE,3153,1715,71,58,129,55.0%,22m
13123,3,Svytoy,3153,872,70,72,142,49.3%,13m
13123,3,Merser,3153,1255,55,59,114,48.2%,3m
13123,1,Bateman,3153,902,45,38,83,54.2%,3m
13123,3,Cherra,3153,571,40,36,76,52.6%,14m
13123,3,PumpeLaGarde,3153,522,34,32,66,51.5%,20m
13123,3,darkfenix,3153,634,27,21,48,56.2%,13m
13123,1,Ago,3153,673,24,20,44,54.5%,1m
13123,3,[LOGS]Dodo,3153,598,22,24,46,47.8%,10m
13123,1,jEsioN,3153,537,18,13,31,58.1%,2m
13123,3,Shentoza,3153,416,17,23,40,42.5%,13m
13123,1,NewToTheGame,3153,386,13,11,24,54.2%,7m
13123,1,[MonT]stupaC,3153,176,8,7,15,53.3%,3m
13123,3,BigFatDonkey,3153,208,8,15,23,34.8%,4m
13123,1,[IBFA]Garedd,3153,240,6,9,15,40.0%,18m
13123,1,rinaks,3153,198,5,7,12,41.7%,1m
13123,1,elifonok,3153,80,3,1,4,75.0%,16m
13123,1,[SvsFl]Gurran,3153,82,2,5,7,28.6%,21m
13123,1,KingPaploo,3153,0,1,0,1,100.0%,1m
13123,2,Osghiliath,3153,95,1,3,4,25.0%,11m
13123,3,[VT11]ExXxE,3153,30,1,4,5,20.0%,2m
13123,3,Yozhik,3153,0,0,1,1,0.0%,13m
13146,1,IcedEarth,3152,1736,194,185,379,51.2%,20m
13146,3,deeew,3152,902,72,61,133,54.1%,18m
13146,3,noobAta,3152,1522,59,61,120,49.2%,18m
13146,1,DiamondSutra,3152,1080,48,43,91,52.7%,6m
13146,1,Rangleklods,3152,926,37,27,64,57.8%,5m
13146,3,XREBWAM,3152,667,28,22,50,56.0%,20m
13146,3,ApfelSchnize,3152,564,22,18,40,55.0%,21m
13146,1,GoGotz,3152,684,21,21,42,50.0%,8m
13146,3,[MRZz]Snac,3152,334,13,10,23,56.5%,3m
13146,3,[YMB]Ortenn,3152,139,13,11,24,54.2%,24m
13146,1,SiSu,3152,352,10,6,16,62.5%,3m
13146,3,SugarFly,3152,237,8,6,14,57.1%,6m
13146,3,eXten,3152,118,4,10,14,28.6%,4m
13146,1,namez,3152,126,3,5,8,37.5%,10m
13146,2,Zames,3152,118,2,2,4,50.0%,3m
13146,1,Goku,3152,42,2,2,4,50.0%,15m
13146,1,Qencels,3152,82,2,3,5,40.0%,3m
13146,1,Ethereum,3152,0,1,0,1,100.0%,17m
13146,1,[DAG1]BlackTears,3152,42,1,2,3,33.3%,1m
13146,3,TomBombadil,3152,0,1,3,4,25.0%,4m
13146,3,Rick,3152,0,1,5,6,16.7%,6m
13146,2,WhiteWidoe,3152,0,0,1,1,0.0%,14m
13168,1,[TedB]Veseluxa,3151,1340,110,87,197,55.8%,17m
13168,3,hrepderp,3151,1266,76,67,143,53.1%,18m
13168,1,CanelaMolida,3151,1080,51,29,80,63.8%,20m
13168,3,Raven,3151,1080,47,41,88,53.4%,16m
13168,3,rhythem,3151,974,40,32,72,55.6%,18m
13168,1,NoName,3151,664,21,16,37,56.8%,15m
13168,3,Deathsong,3151,570,20,32,52,38.5%,10m
13168,3,[13pool]JRaynor,3151,300,14,9,23,60.9%,22m
13168,1,super,3151,266,7,5,12,58.3%,20m
13168,3,SancheL,3151,217,7,5,12,58.3%,20m
13168,1,SadMarine,3151,194,6,2,8,75.0%,15m
13168,1,Jeff,3151,162,5,1,6,83.3%,9m
13168,2,LigaL,3151,118,5,3,8,62.5%,20m
13168,1,jimmy,3151,168,5,4,9,55.6%,20m
13168,1,FalseLyra,3151,0,1,0,1,100.0%,19m
13168,1,MiRi,3151,42,1,2,3,33.3%,10m
13168,1,damage,3151,0,0,1,1,0.0%,19m
13168,3,MCMech,3151,0,0,5,5,0.0%,6m
13186,3,maybe,3150,1393,128,128,256,50.0%,24m
13186,3,Maestria,3150,671,94,56,150,62.7%,5m
13186,3,Litavik,3150,1265,85,79,164,51.8%,1m
13186,3,sYnDeReN,3150,1288,68,69,137,49.6%,19m
13186,3,AltRighteous,3150,996,41,43,84,48.8%,19m
13186,1,baaka,3150,688,27,19,46,58.7%,24m
13186,3,Dontrushme,3150,267,24,23,47,51.1%,8m
13186,1,TheGrappler,3150,480,20,6,26,76.9%,3m
13186,1,Major,3150,519,17,16,33,51.5%,6m
13186,1,Maverick,3150,552,16,16,32,50.0%,7m
13186,3,ZinG,3150,396,15,16,31,48.4%,4m
13186,1,[CelG]Ranietslrak,3150,144,8,2,10,80.0%,24m
13186,3,[ConFed]Seneas,3150,70,6,12,18,33.3%,8m
13186,1,Hope,3150,162,5,4,9,55.6%,23m
13186,1,Nisha,3150,119,3,7,10,30.0%,18m
13186,3,Scran,3150,40,2,5,7,28.6%,13m
13186,1,Buster,3150,0,1,0,1,100.0%,17m
13186,1,ZBx,3150,0,1,1,2,50.0%,9m
13186,1,ElDoctore,3150,44,1,3,4,25.0%,17m
13186,1,[BANSHE]Hope,3150,0,0,1,1,0.0%,3m
13186,3,[TAW]Alexandria,3150,0,0,1,1,0.0%,16m
13186,1,Dans,3150,0,0,2,2,0.0%,17m
13186,3,[Petrus]Харакирыч,3150,0,0,4,4,0.0%,23m
13209,1,[AGRUM]pamplemousse,3149,1776,324,322,646,50.2%,1m
13209,3,GoatPuncher,3149,1428,165,161,326,50.6%,5m
13209,1,[TedB]Festemor,3149,1766,134,102,236,56.8%,14m
13209,3,[hf4X4]Fix,3149,779,112,103,215,52.1%,3m
13209,3,TigrMan,3149,406,95,93,188,50.5%,1m
13209,1,EraseR,3149,1160,75,72,147,51.0%,21m
13209,3,[SALAMI]XanTos,3149,896,53,55,108,49.1%,24m
13209,3,[EAU]Reverie,3149,497,25,17,42,59.5%,10m
13209,3,[glhf20]Sok,3149,515,22,18,40,55.0%,22m
13209,1,Syzygy,3149,410,11,8,19,57.9%,6m
13209,1,Troldepus,3149,234,10,7,17,58.8%,10m
13209,1,CitronBaBa,3149,299,8,3,11,72.7%,17m
13209,3,ignite,3149,211,6,7,13,46.2%,17m
13209,3,boian,3149,109,5,3,8,62.5%,19m
13209,3,Zorg,3149,169,5,8,13,38.5%,6m
13209,3,popp,3149,0,4,2,6,66.7%,7m
13209,1,pascal,3149,118,3,3,6,50.0%,14m
13209,1,sesdasdw,3149,120,3,5,8,37.5%,1m
13209,1,dreaded,3149,82,2,2,4,50.0%,12m
13209,1,Spyro,3149,0,1,0,1,100.0%,1m
13209,1,Remebe,3149,40,1,1,2,50.0%,14m
13209,1,bamsic,3149,0,1,4,5,20.0%,5m
13209,1,TeRaLiSK,3149,0,0,2,2,0.0%,9m
13209,1,Gnoba,3149,0,0,2,2,0.0%,23m
13209,1,Roma,3149,0,0,5,5,0.0%,14m
13234,3,PogChimp,3148,1567,256,255,511,50.1%,17m
13234,3,[IndyK]Mariolek,3148,1555,111,115,226,49.1%,8m
13234,3,Chris,3148,1551,109,91,200,54.5%,5m
13234,3,[Z3RG7V]Garret,3148,1557,107,105,212,50.5%,2m
13234,3,[l2poca]ltwopoca,3148,910,97,66,163,59.5%,5m
13234,3,Slayer,3148,1272,88,85,173,50.9%,11m
13234,1,ShutUp,3148,753,59,43,102,57.8%,24m
13234,1,Dopejexx,3148,556,44,17,61,72.1%,6m
13234,1,[ncotic]SaD,3148,965,32,26,58,55.2%,7m
13234,1,killer,3148,886,30,23,53,56.6%,17m
13234,3,[Tyзик]УкусБомжа,3148,303,29,9,38,76.3%,15m
13234,1,Kvitek,3148,618,27,12,39,69.2%,20m
13234,3,IronicNic,3148,616,24,35,59,40.7%,15m
13234,1,Excitle,3148,674,20,20,40,50.0%,2m
13234,1,Friedolin,3148,421,16,5,21,76.2%,22m
13234,1,gaaaaaaaaaaa,3148,556,16,17,33,48.5%,14m
13234,3,[HBGSJR]Smasher,3148,254,14,16,30,46.7%,2m
13234,3,[ValidG]AmandaGoats,3148,369,13,12,25,52.0%,14m
13234,3,[RvlD]Pramuk,3148,358,13,16,29,44.8%,7m
13234,1,tkirtkAPI,3148,260,10,6,16,62.5%,22m
13234,1,MacroBanana,3148,298,8,7,15,53.3%,4m
13234,1,Fox,3148,285,6,5,11,54.5%,3m
13234,3,[ClDlN]ChopperChuck,3148,216,6,8,14,42.9%,7m
13234,3,[OK238]HeartcorE,3148,148,6,11,17,35.3%,5m
13234,1,[Krasty]NAkiddo,3148,134,4,2,6,66.7%,17m
13234,1,Mahatmaganja,3148,108,4,3,7,57.1%,20m
13234,2,Mattsy,3148,0,0,1,1,0.0%,21m
13234,1,[BabG]Arkisto,3148,0,0,1,1,0.0%,21m
13234,1,Clément,3148,0,0,2,2,0.0%,9m
13234,1,[OZERIS]Tullaris,3148,0,0,2,2,0.0%,20m
13234,1,[IaGMI]Arkamendyss,3148,0,0,2,2,0.0%,7m
13265,1,Azazel,3147,1755,291,261,552,52.7%,1m
13265,3,Pelinore,3147,1561,233,213,446,52.2%,15m
13265,1,TylooTaeja,3147,1465,89,75,164,54.3%,4m
13265,3,[Czakon]VoidArchon,3147,1455,89,89,178,50.0%,24m
13265,3,Jake,3147,1619,78,79,157,49.7%,17m
13265,3,[RBP3]FaNtasTicBG,3147,1596,65,74,139,46.8%,11m
13265,3,[hi5]geiLeN,3147,1295,61,66,127,48.0%,4m
13265,3,plomba,3147,618,55,48,103,53.4%,1m
13265,1,higgsBoson,3147,394,13,13,26,50.0%,3m
13265,1,[RGSC2]StraTov,3147,320,11,3,14,78.6%,10m
13265,1,YosisoY,3147,241,11,9,20,55.0%,1m
13265,3,Athoshiro,3147,254,10,12,22,45.5%,19m
13265,3,[GFLG]Vavar,3147,238,8,12,20,40.0%,9m
13265,3,[THESCV]WorstPlayer,3147,234,7,8,15,46.7%,14m
13265,1,[DYE]Notibox,3147,206,6,6,12,50.0%,17m
13265,3,Orwell,3147,92,3,11,14,21.4%,10m
13265,3,Locapeople,3147,97,2,2,4,50.0%,8m
13265,3,Snake,3147,0,0,1,1,0.0%,1h
13283,3,мегафон,3146,1595,153,156,309,49.5%,9m
13283,1,BarCode,3146,1703,78,70,148,52.7%,19m
13283,3,FatCat,3146,1408,74,79,153,48.4%,8m
13283,1,DKdh,3146,950,37,26,63,58.7%,13m
13283,3,subMETPOH,3146,494,25,32,57,43.9%,25m
13283,3,SordoTyga,3146,469,21,16,37,56.8%,6m
13283,3,Agyon,3146,484,17,24,41,41.5%,10m
13283,1,Slawsh,3146,276,11,8,19,57.9%,3m
13283,1,Rattenkind,3146,326,9,12,21,42.9%,4m
13283,1,Mcfly,3146,196,6,4,10,60.0%,10m
13283,3,TwoFingers,3146,124,4,11,15,26.7%,21m
13283,1,tryHard,3146,80,3,0,3,100.0%,21m
13283,1,penisua,3146,112,3,2,5,60.0%,6m
13283,1,Tanguychoux,3146,113,2,3,5,40.0%,6m
13283,3,MysT,3146,30,2,5,7,28.6%,9m
13283,1,[EMAA]EqusVoidRici,3146,0,1,0,1,100.0%,10m
13283,1,ICEBEAT,3146,0,0,1,1,0.0%,7m
13283,3,Riesho,3146,0,0,2,2,0.0%,6m
13301,3,Piotrek,3145,1286,153,151,304,50.3%,15m
13301,1,Tbone,3145,1573,78,71,149,52.3%,17m
13301,1,[PvZEU]Arany,3145,1645,76,61,137,55.5%,14m
13301,3,[JiK]AnTiMoNiO,3145,1137,47,41,88,53.4%,21m
13301,3,GeoGodley,3145,1212,44,50,94,46.8%,17m
13301,3,Arikson,3145,558,37,47,84,44.0%,14m
13301,1,firewhite,3145,897,32,26,58,55.2%,20m
13301,3,Rayden,3145,862,30,40,70,42.9%,5m
13301,3,Rioverde,3145,639,26,29,55,47.3%,19m
13301,3,[NGJ]OverNice,3145,436,19,15,34,55.9%,8m
13301,1,Madboy,3145,553,16,11,27,59.3%,3m
13301,1,IIIIIIIIIIII,3145,392,15,4,19,78.9%,24m
13301,3,[Prima]Majoren,3145,416,15,21,36,41.7%,2m
13301,1,MatchMakingg,3145,318,9,7,16,56.2%,4m
13301,1,BetterPlayz,3145,211,8,6,14,57.1%,15m
13301,3,Tumba,3145,145,6,2,8,75.0%,35m
13301,1,Inkarzero,3145,200,6,4,10,60.0%,24m
13301,3,ХаРиЗМА,3145,121,5,2,7,71.4%,12m
13301,2,MucaMeow,3145,136,5,2,7,71.4%,38m
13301,1,Harkor,3145,158,5,4,9,55.6%,24m
13301,1,[TTL]MjauVoff,3145,0,4,1,5,80.0%,20m
13301,2,Antijuk,3145,0,4,2,6,66.7%,14m
13301,1,[Pietre]Euisroman,3145,120,4,3,7,57.1%,23m
13301,1,traper,3145,122,3,4,7,42.9%,17m
13301,3,JDizzle,3145,0,3,4,7,42.9%,10m
13301,1,ЧудоПёс,3145,0,1,2,3,33.3%,6m
13301,3,mikeynoob,3145,0,1,5,6,16.7%,43m
13301,1,[BTT]VIPMinor,3145,0,0,1,1,0.0%,7m
13301,1,[IcMoon]llllllllllll,3145,0,0,1,1,0.0%,14m
13301,1,PanMyśliwy,3145,0,0,2,2,0.0%,3m
13301,3,CarryPotter,3145,0,0,3,3,0.0%,1h
13332,3,[Ro2]Butcher,3144,1494,204,208,412,49.5%,11m
13332,3,[RvdS]Thorin,3144,1493,104,81,185,56.2%,21m
13332,3,Crow,3144,1345,82,70,152,53.9%,1m
13332,3,Shugara,3144,1533,74,71,145,51.0%,22m
13332,1,chewe,3144,1189,42,40,82,51.2%,3m
13332,3,Moscovitz,3144,820,29,29,58,50.0%,9m
13332,1,[NumbAc]wEEtoZ,3144,489,23,19,42,54.8%,9m
13332,3,MagisterLudi,3144,282,9,11,20,45.0%,20m
13332,1,SherifOfAiur,3144,89,6,0,6,100.0%,17m
13332,3,Cariboo,3144,179,6,1,7,85.7%,8m
13332,3,RainerZufall,3144,110,5,10,15,33.3%,22m
13332,1,Kenneth,3144,120,3,5,8,37.5%,7m
13332,1,BloodStar,3144,89,2,4,6,33.3%,17m
13332,1,lIIlIlIIlIlI,3144,0,1,0,1,100.0%,20m
13332,1,wodkaisgood,3144,0,1,0,1,100.0%,6m
13332,3,NoZaYtopia,3144,0,1,0,1,100.0%,39m
13332,1,mbrowning,3144,0,1,0,1,100.0%,2m
13332,1,ZERO,3144,0,1,0,1,100.0%,4m
13332,1,[SLASH]IIIIIIIIIIII,3144,0,1,1,2,50.0%,11m
13332,3,CattleBruisR,3144,94,1,4,5,20.0%,13m
13332,1,NazToxic,3144,0,0,1,1,0.0%,3m
13353,3,goofy,3143,1547,191,186,377,50.7%,10m
13353,1,WickedChild,3143,1706,154,149,303,50.8%,11m
13353,3,Serose,3143,1415,123,99,222,55.4%,17m
13353,3,[GMSC]MasterBruce,3143,966,58,41,99,58.6%,19m
13353,3,Shroediger,3143,1345,56,67,123,45.5%,14m
13353,1,[Freeze]SchizoNL,3143,740,35,23,58,60.3%,24m
13353,3,InSidE,3143,619,24,23,47,51.1%,7m
13353,1,[PrimeC]AKpRo,3143,566,23,18,41,56.1%,1m
13353,3,dok,3143,380,15,11,26,57.7%,6m
13353,1,IIIIIIIIIIII,3143,392,12,10,22,54.5%,7m
13353,3,[mfxed]Zildan,3143,304,11,21,32,34.4%,17m
13353,3,[Оми]Аккерман,3143,266,9,11,20,45.0%,21m
13353,1,BlueStar,3143,192,8,0,8,100.0%,1m
13353,3,CryFisch,3143,129,5,9,14,35.7%,18m
13353,1,deadpool,3143,110,4,6,10,40.0%,24m
13353,3,higlhf,3143,120,4,7,11,36.4%,21m
13353,3,[Rebеls]кеша,3143,92,4,7,11,36.4%,6m
13353,1,RussianBear,3143,113,3,9,12,25.0%,1m
13353,2,[DisG]Blitz,3143,139,2,2,4,50.0%,36m
13353,1,Baron,3143,0,1,0,1,100.0%,9m
13353,1,[k1raen]Sergius,3143,40,1,2,3,33.3%,17m
13353,3,GLADIATOR,3143,30,1,5,6,16.7%,6m
13353,3,[DEDAL]sirDariusz,3143,0,1,5,6,16.7%,9m
13353,2,ZeuBy,3143,0,0,1,1,0.0%,21m
13353,1,Grosskek,3143,0,0,1,1,0.0%,18m
13378,3,IIIIIIII,3142,1102,131,133,264,49.6%,16m
13378,1,DAN,3142,1718,101,70,171,59.1%,21m
13378,1,Stargazer,3142,1481,60,47,107,56.1%,16m
13378,3,fIrestoRm,3142,1187,54,61,115,47.0%,16m
13378,3,byc,3142,1042,49,40,89,55.1%,21m
13378,3,slowpilgrim,3142,351,14,10,24,58.3%,13m
13378,1,Dezaxe,3142,392,10,9,19,52.6%,14m
13378,3,TimeSplit,3142,237,8,4,12,66.7%,7m
13378,1,Mulder,3142,268,7,10,17,41.2%,3m
13378,1,GOOFYGOOBER,3142,152,6,7,13,46.2%,10m
13378,1,[EliteX]Avenger,3142,96,2,0,2,100.0%,24m
13378,2,[SOoOo]XtincT,3142,95,2,1,3,66.7%,29m
13378,3,Daffy,3142,30,2,5,7,28.6%,18m
13378,3,[NINJ88]Квадратный,3142,60,2,6,8,25.0%,17m
13378,1,EDRSON,3142,0,1,0,1,100.0%,3m
13378,1,[Abs]Zelfurax,3142,40,1,1,2,50.0%,15m
13378,1,[oooboy]werser,3142,0,1,1,2,50.0%,24m
13378,3,Clement,3142,0,1,5,6,16.7%,1m
13378,3,Ragschas,3142,0,0,1,1,0.0%,8m
13378,1,Eragon,3142,0,0,1,1,0.0%,7m
13378,1,[SStarz]CovekotX,3142,0,0,3,3,0.0%,10m
13399,3,[2097]Gary,3141,1535,235,238,473,49.7%,6m
13399,3,goffarna,3141,1516,118,119,237,49.8%,18m
13399,3,Ree,3141,1416,84,85,169,49.7%,1m
13399,3,SALCHICHÓN,3141,914,47,45,92,51.1%,10m
13399,1,Naero,3141,839,27,23,50,54.0%,9m
13399,1,[SPAINs]kevinukooo,3141,370,15,11,26,57.7%,14m
13399,1,vvench,3141,246,7,5,12,58.3%,7m
13399,3,aRchAnGeL,3141,216,7,7,14,50.0%,5m
13399,3,[IceHus]законМерфи,3141,126,7,9,16,43.8%,11m
13399,3,Maja,3141,30,5,3,8,62.5%,1m
13399,1,[ЯD]EmTee,3141,108,4,4,8,50.0%,1m
13399,1,svyat,3141,74,3,0,3,100.0%,1m
13399,3,Arcsinger,3141,0,3,3,6,50.0%,28m
13399,1,[EAU]KICKI,3141,44,2,1,3,66.7%,6m
13399,1,Seifer,3141,72,2,5,7,28.6%,9m
13399,3,AviatioN,3141,0,1,3,4,25.0%,16m
13399,1,Murdock,3141,0,0,2,2,0.0%,20m
13416,3,ASAPHockey,3140,1443,87,74,161,54.0%,18m
13416,3,mercenairee,3140,1035,70,66,136,51.5%,24m
13416,3,FreddolF,3140,821,46,53,99,46.5%,21m
13416,3,Adore,3140,382,16,15,31,51.6%,21m
13416,1,Medeni,3140,432,13,6,19,68.4%,24m
13416,1,Itachi,3140,372,10,9,19,52.6%,2m
13416,1,[NWAro]Tavi,3140,254,8,4,12,66.7%,17m
13416,1,[Эмо228]USBKOT,3140,82,3,0,3,100.0%,12m
13416,1,eskab,3140,80,3,1,4,75.0%,20m
13416,3,Zwiback,3140,97,2,0,2,100.0%,22m
13416,2,[Yame]Christophe,3140,0,1,0,1,100.0%,27m
13416,1,[COTDA]BelFigor,3140,0,0,1,1,0.0%,3m
13416,1,Mumu,3140,0,0,1,1,0.0%,7m
13429,3,[JEBAKI]PuMeX,3139,1583,400,377,777,51.5%,2m
13429,3,[xFRSx]kartofel,3139,1368,130,133,263,49.4%,3m
13429,3,Bomboni,3139,1550,92,77,169,54.4%,24m
13429,3,Daan,3139,1155,74,71,145,51.0%,3m
13429,3,iksdede,3139,1132,44,42,86,51.2%,8m
13429,1,CannonCoward,3139,949,43,20,63,68.3%,17m
13429,1,LouisKing,3139,1059,43,38,81,53.1%,5m
13429,3,HotTime,3139,1027,42,44,86,48.8%,20m
13429,3,[MADIG]Daratra,3139,411,17,11,28,60.7%,19m
13429,3,Slava,3139,490,17,20,37,45.9%,7m
13429,3,Vuk,3139,238,12,7,19,63.2%,16m
13429,1,[fam1ly]PapaCountry,3139,209,5,7,12,41.7%,35m
13429,1,[1202]LucaRamon,3139,181,4,6,10,40.0%,17m
13429,1,[P3T]CptAwesome,3139,140,3,3,6,50.0%,14m
13429,1,Chrthegreat,3139,76,2,3,5,40.0%,19m
13429,1,[IIE]Lux,3139,0,1,4,5,20.0%,8m
13445,3,misstol,3138,1118,122,102,224,54.5%,19m
13445,3,Callum,3138,1515,98,85,183,53.6%,21m
13445,3,[ArtOf]proxity,3138,1213,96,77,173,55.5%,18m
13445,3,Razur,3138,1406,72,61,133,54.1%,15m
13445,3,Yarmaul,3138,732,32,24,56,57.1%,17m
13445,3,sadji,3138,535,31,33,64,48.4%,1m
13445,3,[profit]Addictive,3138,569,22,25,47,46.8%,2m
13445,1,[НТТ]Kaiser,3138,664,21,16,37,56.8%,6m
13445,3,просто,3138,446,20,15,35,57.1%,16m
13445,3,CBField,3138,469,18,21,39,46.2%,15m
13445,1,DrunkMeister,3138,344,10,13,23,43.5%,18m
13445,1,Player,3138,240,6,3,9,66.7%,23m
13445,3,[1830]GeperTrast,3138,152,5,10,15,33.3%,24m
13445,1,WildPants,3138,105,4,4,8,50.0%,6m
13445,1,Octopus,3138,105,3,1,4,75.0%,24m
13445,1,KatariTari,3138,40,2,0,2,100.0%,9m
13445,1,Sovereign,3138,78,2,3,5,40.0%,7m
13445,1,[WaCKi]Theus,3138,0,1,1,2,50.0%,9m
13445,1,[SEWP]Geser,3138,0,0,2,2,0.0%,4m
13464,3,[SAUI]JizzusChrist,3137,1581,132,134,266,49.6%,2m
13464,3,Kasablanca,3137,1556,76,74,150,50.7%,9m
13464,1,RaakaNipa,3137,1136,50,30,80,62.5%,21m
13464,3,GornorPo,3137,847,36,31,67,53.7%,5m
13464,1,[ORLCY]NickAce,3137,909,33,26,59,55.9%,14m
13464,1,Soulseeker,3137,764,31,20,51,60.8%,7m
13464,3,HawkyHawk,3137,613,27,18,45,60.0%,24m
13464,3,SpaceTurtle,3137,536,22,18,40,55.0%,2m
13464,3,Stolpskottet,3137,306,19,13,32,59.4%,4m
13464,3,Alestraz,3137,424,15,16,31,48.4%,2m
13464,1,Tamriel,3137,434,14,7,21,66.7%,11m
13464,1,Антошка,3137,464,14,11,25,56.0%,6m
13464,3,Stok,3137,320,12,15,27,44.4%,13m
13464,3,MadDur,3137,236,8,3,11,72.7%,8m
13464,1,wozuiji,3137,298,8,4,12,66.7%,11m
13464,1,CartoonHero,3137,118,4,3,7,57.1%,24m
13464,1,ShellShock,3137,80,3,2,5,60.0%,8m
13464,3,[Mulluc]qwatschel,3137,60,3,6,9,33.3%,18m
13464,2,Aaz,3137,0,1,0,1,100.0%,1h
13464,1,dimir,3137,0,1,0,1,100.0%,15m
13464,1,[GoForA]BurntNorton,3137,0,1,2,3,33.3%,24m
13464,1,[GBoys]Mars,3137,0,0,1,1,0.0%,18m
13464,1,liquidator,3137,0,0,1,1,0.0%,2m
13464,1,EvilLOSb,3137,0,0,1,1,0.0%,6m
13464,3,MaDBaKS,3137,0,0,3,3,0.0%,2m
13464,3,Knotas,3137,0,0,4,4,0.0%,13m
13490,1,yongcho,3136,1494,143,139,282,50.7%,12m
13490,3,JYL,3136,1123,83,74,157,52.9%,21m
13490,3,Djenster,3136,1247,69,47,116,59.5%,20m
13490,1,Correct,3136,1432,58,46,104,55.8%,22m
13490,1,[D0N3]DonMucca,3136,1342,51,46,97,52.6%,8m
13490,1,[W4SP]jberkani,3136,1168,44,31,75,58.7%,14m
13490,3,ExTZeiKo,3136,465,20,14,34,58.8%,19m
13490,1,zergislife,3136,373,17,10,27,63.0%,15m
13490,1,Муландир,3136,518,15,12,27,55.6%,12m
13490,3,[Trals]whApaddy,3136,400,15,16,31,48.4%,2m
13490,3,Arkantos,3136,402,14,18,32,43.8%,18m
13490,1,iDelUSional,3136,278,9,3,12,75.0%,12m
13490,2,allgoodsky,3136,165,6,5,11,54.5%,24m
13490,1,[nSl]nSlZik,3136,105,5,2,7,71.4%,11m
13490,1,kastet,3136,106,5,3,8,62.5%,17m
13490,1,Sonic,3136,80,3,1,4,75.0%,4m
13490,1,Aberone,3136,86,3,4,7,42.9%,4m
13490,1,[bQuirk]Dofamin,3136,0,1,0,1,100.0%,15m
13490,1,Fia,3136,73,1,3,4,25.0%,20m
13490,1,[ZЕRGТV]Tozz,3136,0,0,1,1,0.0%,15m
13490,1,[SSgF]Wildjäger,3136,73,0,4,4,0.0%,14m
13511,1,Toor,3135,1761,182,167,349,52.1%,3m
13511,1,pysaok,3135,1767,128,120,248,51.6%,17m
13511,3,Zeuron,3135,1242,121,123,244,49.6%,22m
13511,3,yellowElepha,3135,904,102,91,193,52.8%,9m
13511,1,Sky,3135,1784,95,82,177,53.7%,2m
13511,1,sevro,3135,925,45,38,83,54.2%,24m
13511,1,[TThe]KalljuMarju,3135,906,31,33,64,48.4%,4m
13511,3,ZANOZA,3135,564,24,23,47,51.1%,1m
13511,3,[HuNcsI]Jani,3135,318,11,8,19,57.9%,10m
13511,1,[BSK88]Skiizz,3135,412,11,14,25,44.0%,4m
13511,3,[SILeSp]AzeriX,3135,214,9,8,17,52.9%,22m
13511,3,Spagheet,3135,206,7,15,22,31.8%,13m
13511,3,Sergiiik,3135,131,6,3,9,66.7%,21m
13511,3,[BCNE]MadMike,3135,152,6,6,12,50.0%,7m
13511,1,Evines,3135,116,4,1,5,80.0%,7m
13511,3,МастерКоля,3135,0,4,2,6,66.7%,18m
13511,1,BELUNI,3135,118,4,6,10,40.0%,23m
13511,3,[xDniwe]Ether,3135,0,3,2,5,60.0%,27m
13511,1,[Z3RG7V]Mitrofan,3135,0,0,1,1,0.0%,23m
13530,1,ricardo,3134,1375,114,101,215,53.0%,23m
13530,3,Igniter,3134,1563,83,66,149,55.7%,18m
13530,1,[LNGBRR]jibbmn,3134,1040,56,45,101,55.4%,10m
13530,3,Kenza,3134,765,30,29,59,50.8%,21m
13530,1,[K0ZAKI]Bluerec,3134,626,25,16,41,61.0%,5m
13530,1,artgs,3134,509,21,12,33,63.6%,21m
13530,3,HelShuru,3134,426,18,12,30,60.0%,24m
13530,3,[aTw]Ash,3134,288,15,12,27,55.6%,9m
13530,3,[NATI0N]Mikkolo,3134,466,15,30,45,33.3%,16m
13530,1,Mars,3134,378,12,8,20,60.0%,12m
13530,1,[NGA]fulowa,3134,260,10,7,17,58.8%,18m
13530,1,[LEVARP]ДевочкаМошер,3134,256,8,3,11,72.7%,4m
13530,1,[PŖïMĄŁ]Exit,3134,276,8,3,11,72.7%,21m
13530,1,Virus,3134,249,8,5,13,61.5%,1h
13530,1,[RU71]ГОРЫНЫЧ,3134,121,5,2,7,71.4%,7m
13530,1,Barkas,3134,0,5,5,10,50.0%,15m
13530,3,Timwac,3134,144,3,5,8,37.5%,7m
13530,1,HAWAIIFIVEO,3134,122,2,3,5,40.0%,9m
13530,3,[ZЕRGTV]Keryb,3134,60,2,6,8,25.0%,2m
13530,3,VertigO,3134,30,2,7,9,22.2%,24m
13550,1,Макаров,3133,1756,240,221,461,52.1%,16m
13550,1,DiamondJane,3133,1160,161,146,307,52.4%,15m
13550,3,Гай,3133,1584,116,107,223,52.0%,14m
13550,1,PeacefulSC,3133,1407,65,45,110,59.1%,1m
13550,2,Untitled,3133,275,13,10,23,56.5%,18m
13550,1,[ШОУМЕН]пакойнеки,3133,204,5,2,7,71.4%,17m
13550,3,Hornyman,3133,44,5,3,8,62.5%,1h
13550,3,ROOM,3133,133,4,6,10,40.0%,16m
13550,1,Heisenzerg,3133,0,2,3,5,40.0%,20m
13550,1,[DWTeam]Andragon,3133,0,1,0,1,100.0%,3m
13550,1,Puffy,3133,0,1,0,1,100.0%,2m
13550,1,[LMBD]Mcsawyer,3133,0,1,4,5,20.0%,1h
13550,1,dDrunkenLord,3133,0,0,1,1,0.0%,9m
13550,1,llllllllllll,3133,0,0,1,1,0.0%,18m
13564,3,[Br0k3n]Wingz,3132,1320,112,91,203,55.2%,17m
13564,3,AKINCIBEYi,3132,1091,47,41,88,53.4%,20m
13564,3,kurva,3132,1045,43,43,86,50.0%,25m
13564,3,[PaniC]xam,3132,595,41,41,82,50.0%,6m
13564,1,SilverToss,3132,622,32,9,41,78.0%,7m
13564,1,[F1ve]PhoenixJoe,3132,524,18,15,33,54.5%,20m
13564,3,Sever,3132,252,12,18,30,40.0%,14m
13564,3,[AiRǂ]DRAKEN,3132,332,11,12,23,47.8%,23m
13564,1,guly,3132,222,8,9,17,47.1%,9m
13564,1,Exeqtor,3132,127,6,3,9,66.7%,14m
13564,1,Dummy,3132,152,4,4,8,50.0%,24m
13564,1,Kotofey,3132,0,3,2,5,60.0%,1h
13564,1,[DgF2]Malzbier,3132,80,3,3,6,50.0%,20m
13564,3,llllllllllll,3132,122,3,4,7,42.9%,7m
13564,1,Krat,3132,0,1,0,1,100.0%,9m
13564,3,Fonzo,3132,0,1,1,2,50.0%,16m
13564,1,Nachti,3132,0,0,1,1,0.0%,15m
13564,1,Spitfire,3132,0,0,1,1,0.0%,14m
13564,1,hRob,3132,0,0,3,3,0.0%,6m
13583,3,NOescape,3131,823,233,228,461,50.5%,3m
13583,3,[BeB]Marsyan,3131,1584,193,179,372,51.9%,7m
13583,3,[BWArmy]GABY,3131,1224,56,59,115,48.7%,11m
13583,1,ИКОНА,3131,865,33,30,63,52.4%,3m
13583,3,[HateZ]Puccio,3131,797,32,33,65,49.2%,18m
13583,1,MsWho,3131,436,15,15,30,50.0%,20m
13583,3,benzer,3131,415,14,16,30,46.7%,21m
13583,1,KarisVenner,3131,288,13,1,14,92.9%,24m
13583,1,Kolargolo,3131,255,6,3,9,66.7%,4m
13583,3,kElEvrA,3131,133,5,3,8,62.5%,15m
13583,1,MusliM,3131,80,2,3,5,40.0%,9m
13583,3,Michael,3131,114,2,5,7,28.6%,18m
13583,1,[COOPM]TeppichLuigi,3131,0,1,0,1,100.0%,18m
13583,1,РАСTAMAH,3131,0,1,0,1,100.0%,18m
13583,1,[IRPLE]dukratchic,3131,0,0,1,1,0.0%,24m
13583,1,[PLA2N]Leeroy,3131,0,0,1,1,0.0%,9m
13599,3,Mojin,3130,1568,134,121,255,52.5%,16m
13599,1,xyz,3130,1337,80,73,153,52.3%,20m
13599,3,Alex,3130,514,71,66,137,51.8%,18m
13599,3,[Ogz]spectre,3130,908,67,62,129,51.9%,12m
13599,3,[3ЕRGTV]xxxFuSiOnxxx,3130,647,55,44,99,55.6%,7m
13599,3,[OVX]Drakulaj,3130,595,29,21,50,58.0%,21m
13599,1,ElRaymond,3130,542,22,15,37,59.5%,6m
13599,1,pee,3130,503,18,13,31,58.1%,6m
13599,1,idol,3130,296,8,8,16,50.0%,9m
13599,3,Mars,3130,263,8,10,18,44.4%,9m
13599,3,zerg,3130,220,8,14,22,36.4%,2m
13599,1,HeX,3130,254,7,3,10,70.0%,8m
13599,3,[AClic]Ununhexium,3130,86,6,5,11,54.5%,10m
13599,3,Slowpoke,3130,176,5,6,11,45.5%,4m
13599,3,Wnuk,3130,0,4,2,6,66.7%,16m
13599,1,[zukaCo]MaMu,3130,80,3,0,3,100.0%,7m
13599,1,TakoBurito,3130,40,2,0,2,100.0%,6m
13599,1,[LOTAL]Glef,3130,0,1,0,1,100.0%,1m
13599,1,bloozx,3130,0,1,0,1,100.0%,1m
13599,1,[DumpD]Apokalyptik,3130,40,1,3,4,25.0%,11m
13599,1,lazy,3130,0,0,1,1,0.0%,23m
13599,1,Szarpełe,3130,0,0,1,1,0.0%,23m
13599,1,IIIIIIIIIIII,3130,0,0,2,2,0.0%,17m
13622,3,Cosmodesant,3129,1515,197,203,400,49.2%,14m
13622,3,Janus,3129,1492,113,109,222,50.9%,10m
13622,1,anaD,3129,1210,40,40,80,50.0%,15m
13622,1,Archonia,3129,978,32,28,60,53.3%,17m
13622,3,KikiOG,3129,802,32,30,62,51.6%,24m
13622,3,BlackVinny,3129,782,30,35,65,46.2%,21m
13622,3,[SSC2]Radren,3129,590,20,29,49,40.8%,5m
13622,1,Ultuan,3129,246,15,13,28,53.6%,14m
13622,3,Casaki,3129,418,15,17,32,46.9%,6m
13622,1,[Lames]Robot,3129,283,9,4,13,69.2%,11m
13622,3,[ioStuN]IIIIIIIIIIII,3129,276,9,9,18,50.0%,18m
13622,2,Candalistic,3129,196,8,4,12,66.7%,35m
13622,1,LewsTherin,3129,164,5,2,7,71.4%,6m
13622,1,Aimbert,3129,125,5,3,8,62.5%,24m
13622,1,[AiRǂ]Samus,3129,144,5,5,10,50.0%,18m
13622,1,Delta,3129,118,4,1,5,80.0%,17m
13622,1,Incandenza,3129,122,4,4,8,50.0%,15m
13622,1,[WpG]Gimli,3129,0,1,0,1,100.0%,15m
13622,1,happystick,3129,0,1,0,1,100.0%,2m
13622,1,Sweetoos,3129,40,1,3,4,25.0%,18m
13622,1,Reaper,3129,96,1,3,4,25.0%,22m
13622,3,LiMeCH,3129,0,0,2,2,0.0%,11m
13644,3,CaptainKasch,3128,608,49,40,89,55.1%,4m
13644,1,[Jail]TuJefe,3128,609,23,17,40,57.5%,20m
13644,1,Michu,3128,466,17,8,25,68.0%,15m
13644,1,FleetFink,3128,574,16,16,32,50.0%,12m
13644,3,Jamalam,3128,193,15,6,21,71.4%,11m
13644,3,Envy,3128,411,15,17,32,46.9%,9m
13644,1,woshinidie,3128,133,7,1,8,87.5%,2m
13644,2,skyrider,3128,186,7,4,11,63.6%,38m
13644,2,BlinkTK,3128,139,6,4,10,60.0%,27m
13644,3,DelWin,3128,94,5,2,7,71.4%,20m
13644,1,vodka,3128,0,4,1,5,80.0%,20m
13644,3,Deuce,3128,97,4,2,6,66.7%,15m
13644,3,LEXA,3128,0,4,2,6,66.7%,2m
13644,1,Anna,3128,80,3,0,3,100.0%,9m
13644,1,Invinceble,3128,113,3,2,5,60.0%,9m
13644,3,TSwift,3128,97,3,2,5,60.0%,1h
13644,1,[GNN]TheVikWithin,3128,40,2,0,2,100.0%,11m
13644,1,CodeBlue,3128,0,2,3,5,40.0%,1h
13644,3,[IGvI]GrootPower,3128,30,1,11,12,8.3%,17m
13644,1,[aDGa]Paladin,3128,0,0,1,1,0.0%,24m
13644,1,Alhimik,3128,0,0,1,1,0.0%,7m
13644,1,[DisES]Pedrolito,3128,0,0,2,2,0.0%,1h
13666,3,Skadivan,3127,955,72,56,128,56.2%,6m
13666,1,Savinov,3127,792,37,33,70,52.9%,19m
13666,1,neroxLz,3127,331,18,15,33,54.5%,2m
13666,1,Nagatawa,3127,247,7,10,17,41.2%,23m
13666,1,esyr,3127,118,6,2,8,75.0%,21m
13666,2,PassionPlaya,3127,97,5,2,7,71.4%,21m
13666,1,[BBLS]eZxSievi,3127,190,4,4,8,50.0%,26m
13666,1,GroundZero,3127,116,4,7,11,36.4%,23m
13666,1,[uCHAD]Gadzila,3127,42,2,0,2,100.0%,1m
13666,3,[ThUdLu]JustlDead,3127,97,2,4,6,33.3%,13m
13666,1,[МИГ]denistit,3127,0,1,0,1,100.0%,3m
13666,1,Repek,3127,42,1,2,3,33.3%,3m
13666,3,[AWolve]LetMePlay,3127,97,1,6,7,14.3%,43m
13666,1,[TILAM]PaPercUP,3127,0,0,1,1,0.0%,1h
13666,1,ArisGodOfWar,3127,0,0,1,1,0.0%,12m
13681,3,Maisdad,3126,1446,85,83,168,50.6%,7m
13681,1,Essar,3126,398,25,19,44,56.8%,17m
13681,3,Makowiec,3126,276,13,9,22,59.1%,7m
13681,3,DARK,3126,278,11,5,16,68.8%,22m
13681,3,stoltz,3126,289,11,10,21,52.4%,11m
13681,1,Jim,3126,235,8,4,12,66.7%,11m
13681,3,HammeR,3126,145,3,6,9,33.3%,16m
13681,1,[SC2UA]Mistick,3126,0,1,0,1,100.0%,22m
13681,2,PacMan,3126,0,1,6,7,14.3%,13m
13690,3,DeathWizard,3125,1178,148,129,277,53.4%,7m
13690,3,Trouble,3125,1066,72,78,150,48.0%,10m
13690,1,KINGDOPAH,3125,1191,62,34,96,64.6%,15m
13690,1,DOC,3125,412,16,13,29,55.2%,11m
13690,1,[RIPERY]Lasic,3125,349,15,5,20,75.0%,11m
13690,1,[DaMacs]MyJoker,3125,291,8,4,12,66.7%,24m
13690,3,delvur,3125,97,5,1,6,83.3%,1h
13690,3,DrunkBender,3125,146,5,9,14,35.7%,17m
13690,1,LittleB,3125,72,2,6,8,25.0%,2m
13690,1,[MaRicC]DrinkyCrow,3125,46,1,1,2,50.0%,22m
13690,1,besubik,3125,0,1,2,3,33.3%,18m
13690,1,Sonic,3125,0,0,1,1,0.0%,18m
13690,1,[iaMsK]LeGioN,3125,0,0,2,2,0.0%,20m
13690,1,TripleZ,3125,0,0,2,2,0.0%,12m
13704,3,Starzinger,3124,1530,221,218,439,50.3%,23m
13704,3,Erynnis,3124,1153,187,175,362,51.7%,22m
13704,3,[GTDK]Drocky,3124,1000,89,84,173,51.4%,8m
13704,3,Easypeople,3124,1373,69,62,131,52.7%,13m
13704,3,[PSIGH]Penitente,3124,1371,68,54,122,55.7%,3m
13704,1,CoffeeTime,3124,1039,61,50,111,55.0%,20m
13704,1,EsplyEd,3124,806,57,33,90,63.3%,9m
13704,1,tobe,3124,833,46,38,84,54.8%,6m
13704,1,JuicyZerg,3124,531,23,7,30,76.7%,3m
13704,1,Meranae,3124,263,11,3,14,78.6%,7m
13704,3,Нирама,3124,131,8,5,13,61.5%,11m
13704,1,Visp,3124,290,8,7,15,53.3%,14m
13704,3,[YSwag]Dennerwotter,3124,165,7,6,13,53.8%,2m
13704,2,INWY,3124,167,6,5,11,54.5%,1h
13704,3,[TacoB]Squid,3124,97,5,1,6,83.3%,16m
13704,1,PAPA,3124,0,4,1,5,80.0%,29m
13704,3,defterus,3124,0,4,2,6,66.7%,22m
13704,3,[ACT1]fofafi,3124,123,3,4,7,42.9%,9m
13704,1,Cypresstree,3124,0,1,0,1,100.0%,5m
13704,1,Ourouk,3124,42,1,4,5,20.0%,20m
13704,1,[FreeDS]mathiasaki,3124,0,0,1,1,0.0%,9m
13704,1,NateRiver,3124,0,0,1,1,0.0%,14m
13704,1,MaV,3124,0,0,2,2,0.0%,15m
13704,1,[TaReFr]doudou,3124,0,0,2,2,0.0%,9m
13728,1,Ryusaki,3123,1779,273,234,507,53.8%,3m
13728,1,Castelo,3123,1314,151,131,282,53.5%,9m
13728,1,Monk,3123,1350,85,82,167,50.9%,9m
13728,3,Odasity,3123,581,42,38,80,52.5%,2m
13728,3,PROdoom,3123,1085,40,39,79,50.6%,15m
13728,1,[ıEzı]Norgeth,3123,396,34,25,59,57.6%,22m
13728,3,NexuS,3123,596,28,31,59,47.5%,22m
13728,3,[Alboz]FeNix,3123,476,19,19,38,50.0%,2m
13728,1,[b00s]einsteinIQ,3123,359,15,10,25,60.0%,20m
13728,1,Wombat,3123,372,11,11,22,50.0%,14m
13728,1,[PBlack]BrracksObama,3123,263,10,6,16,62.5%,24m
13728,3,Alleusia,3123,206,7,4,11,63.6%,16m
13728,1,Conq,3123,184,7,5,12,58.3%,14m
13728,3,Tamas,3123,217,6,9,15,40.0%,21m
13728,3,LeonTheTree,3123,107,5,3,8,62.5%,10m
13728,1,Ragmon,3123,160,4,3,7,57.1%,5m
13728,1,Batman,3123,78,3,3,6,50.0%,2m
13728,1,llllllllllll,3123,82,2,3,5,40.0%,20m
13746,3,Dartag,3122,1584,199,192,391,50.9%,15m
13746,3,tady,3122,976,146,125,271,53.9%,9m
13746,3,ant,3122,1577,113,101,214,52.8%,13m
13746,3,janesz,3122,1335,79,78,157,50.3%,21m
13746,1,Fold,3122,591,64,47,111,57.7%,6m
13746,1,[uscore]asPredicted,3122,705,30,30,60,50.0%,21m
13746,3,Saifaw,3122,561,23,22,45,51.1%,19m
13746,1,ViRUS,3122,703,22,19,41,53.7%,24m
13746,1,[SDTL]Veritas,3122,648,19,19,38,50.0%,3m
13746,3,[MWAF]fanzuu,3122,310,10,7,17,58.8%,22m
13746,1,[DisES]Kamenashi,3122,284,9,6,15,60.0%,18m
13746,3,Brizzy,3122,234,8,12,20,40.0%,5m
13746,1,Peter,3122,132,6,2,8,75.0%,14m
13746,1,Keith,3122,213,5,3,8,62.5%,22m
13746,1,[HOODOR]YourManager,3122,97,5,4,9,55.6%,9m
13746,1,Citizen,3122,174,4,1,5,80.0%,23m
13746,3,[xLGx]TonyStark,3122,90,4,8,12,33.3%,25m
13746,1,DeadWakEx,3122,88,2,0,2,100.0%,18m
13746,1,sushi,3122,0,1,4,5,20.0%,22m
13746,1,Panse,3122,0,0,4,4,0.0%,3m
13766,3,SPY,3121,1561,402,392,794,50.6%,21m
13766,3,TobiOne,3121,1493,229,237,466,49.1%,14m
13766,3,Galaiada,3121,1444,119,115,234,50.9%,14m
13766,3,[WАSD]SimulacraTos,3121,1233,58,46,104,55.8%,8m
13766,3,[Sieral]SunshineBean,3121,787,57,41,98,58.2%,23m
13766,3,Burjuman,3121,1068,42,55,97,43.3%,14m
13766,3,DerKopfSalat,3121,996,37,52,89,41.6%,12m
13766,1,Nikrator,3121,700,31,10,41,75.6%,1m
13766,1,Needspeed,3121,811,28,26,54,51.9%,6m
13766,1,Paradisum,3121,543,16,13,29,55.2%,7m
13766,1,Gos,3121,348,10,10,20,50.0%,3m
13766,2,countryroad,3121,191,7,5,12,58.3%,1h
13766,1,Deezy,3121,118,4,2,6,66.7%,21m
13766,1,[FGger]LexuSS,3121,106,4,4,8,50.0%,15m
13766,3,[crisp]INTOtheSTORM,3121,90,3,10,13,23.1%,2m
13766,1,Nanika,3121,78,2,2,4,50.0%,17m
13766,3,WoodNerd,3121,58,2,7,9,22.2%,14m
13766,3,[dellll]Cibothegreat,3121,0,1,0,1,100.0%,13m
13766,1,[PÂRłAH]Epiphonester,3121,0,1,0,1,100.0%,17m
13766,1,[slayn]aragorn,3121,42,1,4,5,20.0%,25m
13766,1,FluffyToss,3121,38,1,5,6,16.7%,23m
13766,1,[Sarmat]RisingSun,3121,0,0,1,1,0.0%,5m
13788,3,EvMastermind,3120,819,78,84,162,48.1%,16m
13788,1,nSlPindle,3120,635,60,53,113,53.1%,6m
13788,1,dima,3120,486,20,11,31,64.5%,12m
13788,3,Kit,3120,528,18,24,42,42.9%,9m
13788,3,Atomik,3120,202,8,12,20,40.0%,9m
13788,2,[Bx2]Djaneezy,3120,139,5,5,10,50.0%,1h
13788,3,MarioJ,3120,97,4,2,6,66.7%,1h
13788,1,BALLERN,3120,122,3,3,6,50.0%,14m
13788,1,[Z3RG7V]Андрей,3120,58,2,3,5,40.0%,20m
13788,3,Gorzym,3120,58,2,13,15,13.3%,3m
13788,3,Noldus,3120,0,1,0,1,100.0%,8m
13788,3,[iOwnU]Ezort,3120,0,1,0,1,100.0%,27m
13788,1,Ygg,3120,36,1,1,2,50.0%,11m
13788,1,Tassartanis,3120,0,0,1,1,0.0%,4m
13788,1,MaistroMads,3120,0,0,2,2,0.0%,2m
13803,1,GameOfDrones,3119,1762,158,147,305,51.8%,15m
13803,3,Leogp,3119,1564,61,83,144,42.4%,18m
13803,3,Tamnor,3119,1196,56,40,96,58.3%,16m
13803,3,[НОД17]VOLK,3119,929,46,46,92,50.0%,9m
13803,1,xXxDuuqzxXx,3119,572,35,28,63,55.6%,8m
13803,1,[8TaO8]shadow,3119,880,30,25,55,54.5%,22m
13803,3,Liza,3119,428,16,15,31,51.6%,16m
13803,3,[PÂRłAH]DemoDemon,3119,286,13,10,23,56.5%,24m
13803,2,Sauce,3119,178,12,12,24,50.0%,11m
13803,1,[ÆVT]TosSisImbA,3119,360,10,12,22,45.5%,2m
13803,1,HEPBO,3119,292,9,6,15,60.0%,15m
13803,3,DizzyKnight,3119,30,6,2,8,75.0%,18m
13803,1,[Deleam]WarLord,3119,150,4,4,8,50.0%,7m
13803,1,Fernando,3119,80,3,1,4,75.0%,12m
13803,1,[FDS4]virtuxa,3119,118,3,2,5,60.0%,1m
13803,3,[HMSTR]Habañero,3119,151,3,6,9,33.3%,5m
13803,1,jojozocker,3119,113,2,1,3,66.7%,25m
13803,1,[Kicx]ZWLO,3119,80,2,5,7,28.6%,2m
13803,1,ZenoGamer,3119,0,1,0,1,100.0%,22m
13803,1,XIII,3119,0,0,1,1,0.0%,9m
13803,1,Evildness,3119,0,0,1,1,0.0%,17m
13803,1,Mofozor,3119,0,0,4,4,0.0%,3m
13825,1,Draddy,3118,1390,92,32,124,74.2%,23m
13825,1,ItsBehindYou,3118,1121,61,50,111,55.0%,3m
13825,3,dinnyesbacsi,3118,331,58,67,125,46.4%,13m
13825,3,kimen,3118,763,57,46,103,55.3%,15m
13825,3,[PRLS]Johnny,3118,910,31,46,77,40.3%,2m
13825,1,BamBam,3118,885,30,24,54,55.6%,2m
13825,1,[TheShy]Galoschinio,3118,616,27,13,40,67.5%,24m
13825,3,Brox,3118,299,26,24,50,52.0%,17m
13825,1,Makmerdo,3118,627,18,21,39,46.2%,9m
13825,3,Karamba,3118,462,18,21,39,46.2%,2m
13825,1,dio,3118,301,13,10,23,56.5%,11m
13825,1,Snide,3118,355,12,6,18,66.7%,5m
13825,1,Juice,3118,299,10,7,17,58.8%,1h
13825,1,[CYG]Günterin,3118,177,8,0,8,100.0%,14m
13825,1,PapaGarryk,3118,0,5,0,5,100.0%,38m
13825,3,Barbur,3118,97,5,2,7,71.4%,23m
13825,2,MrMaroilles,3118,95,5,3,8,62.5%,24m
13825,1,ZateOG,3118,0,4,1,5,80.0%,32m
13825,1,kaltos,3118,118,4,1,5,80.0%,6m
13825,1,knocKOut,3118,114,4,2,6,66.7%,8m
13825,3,Jandegrote,3118,0,4,2,6,66.7%,28m
13825,3,Antarian,3118,0,4,2,6,66.7%,2m
13825,3,LLLLLLLLLLLL,3118,0,4,2,6,66.7%,16m
13825,1,[БОДУН]Nekrosoon,3118,118,4,3,7,57.1%,3m
13825,1,Galadohon,3118,78,3,1,4,75.0%,15m
13825,1,marc,3118,116,3,5,8,37.5%,15m
13825,3,Sham,3118,97,2,0,2,100.0%,39m
13825,2,Sogarth,3118,0,1,0,1,100.0%,1h
13825,1,Shiner,3118,40,1,1,2,50.0%,9m
13825,3,[lNN]MrHoney,3118,0,1,12,13,7.7%,16m
13825,1,Pixar,3118,0,0,1,1,0.0%,25m
13856,3,[RoBtl]Kratoss,3117,1534,272,265,537,50.7%,15m
13856,1,qusk,3117,1410,73,60,133,54.9%,18m
13856,1,dykschwanz,3117,1493,67,48,115,58.3%,20m
13856,3,IIIIIIIIIIII,3117,1129,62,56,118,52.5%,7m
13856,3,[Aplus]Almost,3117,426,61,55,116,52.6%,25m
13856,1,VivaIlDuce,3117,943,48,11,59,81.4%,24m
13856,3,[IceHus]Дурашка,3117,1203,45,54,99,45.5%,3m
13856,3,NUNAMNIR,3117,955,38,45,83,45.8%,14m
13856,3,[GruG]eks,3117,411,30,37,67,44.8%,15m
13856,1,Master,3117,742,27,20,47,57.4%,23m
13856,3,[Lambro]Lucid,3117,365,23,22,45,51.1%,17m
13856,3,monte,3117,522,20,18,38,52.6%,17m
13856,3,Nikita,3117,144,8,5,13,61.5%,13m
13856,3,Invalid,3117,146,4,8,12,33.3%,18m
13856,1,GeneraKenobi,3117,89,3,3,6,50.0%,9m
13856,1,dimmers,3117,0,1,0,1,100.0%,20m
13856,1,Brothers,3117,40,1,2,3,33.3%,14m
13856,1,TimoCore,3117,0,0,1,1,0.0%,3m
13874,3,Znamenosec,3116,1593,526,509,1035,50.8%,19m
13874,3,[1stGG]JacDraco,3116,1118,114,112,226,50.4%,5m
13874,3,Paradise,3116,1410,48,63,111,43.2%,9m
13874,1,IMWI,3116,1095,44,36,80,55.0%,20m
13874,1,MrBubblee,3116,472,41,34,75,54.7%,6m
13874,1,[Y2AeoN]Anno,3116,829,26,25,51,51.0%,20m
13874,3,PiotrekS,3116,718,26,29,55,47.3%,5m
13874,1,[SpCI]sylwekPL,3116,547,18,14,32,56.2%,12m
13874,1,[KoKz]Castro,3116,240,7,2,9,77.8%,7m
13874,1,Andrey,3116,226,7,6,13,53.8%,12m
13874,1,minotoro,3116,95,5,3,8,62.5%,22m
13874,1,[1DLE]Thial,3116,104,4,4,8,50.0%,14m
13874,1,crazySocket,3116,84,2,5,7,28.6%,18m
13874,1,Rain,3116,0,1,0,1,100.0%,25m
13874,1,seko,3116,0,1,1,2,50.0%,1h
13874,1,CaHgokaHa,3116,40,1,5,6,16.7%,2m
13874,3,ronpopopom,3116,0,1,5,6,16.7%,24m
13874,1,Prinzmetall,3116,0,0,1,1,0.0%,20m
13892,3,OnyX,3115,1478,171,172,343,49.9%,16m
13892,3,Maximus,3115,754,99,102,201,49.3%,7m
13892,1,[NumbAc]Puigs,3115,711,78,64,142,54.9%,15m
13892,1,Geroz,3115,730,28,21,49,57.1%,6m
13892,1,Solaire,3115,645,24,18,42,57.1%,11m
13892,3,[phys]HolYRiDeR,3115,240,10,8,18,55.6%,20m
13892,3,DroitWar,3115,222,8,15,23,34.8%,16m
13892,1,Ataral,3115,156,5,4,9,55.6%,6m
13892,1,FluteKing,3115,82,3,2,5,60.0%,9m
13892,1,MrToad,3115,118,3,4,7,42.9%,7m
13892,1,EUsucks,3115,40,2,0,2,100.0%,22m
13892,1,alphaNoFear,3115,84,2,4,6,33.3%,20m
13892,1,[ЕNСE]DezGun,3115,0,1,0,1,100.0%,3m
13892,1,LuckyTiger,3115,0,1,1,2,50.0%,8m
13892,1,pingi,3115,0,0,1,1,0.0%,23m
13892,1,anakiouss,3115,0,0,2,2,0.0%,23m
13908,1,[DDaD]Adrian,3114,1699,96,84,180,53.3%,1m
13908,1,sould,3114,1289,62,53,115,53.9%,15m
13908,3,Whynot,3114,795,31,33,64,48.4%,16m
13908,1,Foxy,3114,575,21,18,39,53.8%,3m
13908,2,[GURKI]Homunculus,3114,271,11,2,13,84.6%,1h
13908,3,[0860]Broxi,3114,322,11,12,23,47.8%,20m
13908,3,[GawAt]DerSchluppke,3114,222,11,15,26,42.3%,4m
13908,1,CaptainRARAA,3114,292,8,17,25,32.0%,12m
13908,3,[Łegend]GeshHoliday,3114,184,6,11,17,35.3%,16m
13908,1,hdmark,3114,0,4,1,5,80.0%,22m
13908,3,Syro,3114,97,4,2,6,66.7%,7m
13908,1,RedDragon,3114,0,3,2,5,60.0%,23m
13908,1,[DutchG]dragoon,3114,0,2,3,5,40.0%,25m
13908,3,KoScHmArChE,3114,30,2,4,6,33.3%,3m
13908,1,Michael,3114,0,1,0,1,100.0%,12m
13908,3,Trallifant,3114,0,1,1,2,50.0%,24m
13908,1,DeadWolf,3114,0,1,2,3,33.3%,23m
13908,1,Mitropanos,3114,0,0,1,1,0.0%,9m
13908,1,DanTisT,3114,0,0,4,4,0.0%,11m
13927,3,[4iW]Birdienumnum,3113,1124,162,148,310,52.3%,23m
13927,3,FRIK,3113,1398,139,132,271,51.3%,17m
13927,1,frigox,3113,1512,79,63,142,55.6%,3m
13927,1,[B420B]ArctcMunchiz,3113,1588,63,52,115,54.8%,24m
13927,3,Diamorotic,3113,536,23,19,42,54.8%,22m
13927,3,Cha,3113,644,23,27,50,46.0%,14m
13927,1,Coffeeman,3113,536,20,13,33,60.6%,21m
13927,3,Koda,3113,208,11,10,21,52.4%,24m
13927,1,[Nvtrnt]Kllians,3113,372,11,12,23,47.8%,10m
13927,3,TsarZ,3113,324,11,19,30,36.7%,8m
13927,3,Shaiatan,3113,170,10,9,19,52.6%,10m
13927,1,samurai,3113,306,9,8,17,52.9%,2m
13927,2,[WАSD]fyrgood,3113,203,7,4,11,63.6%,13m
13927,3,Bleuelephant,3113,188,6,13,19,31.6%,7m
13927,3,Deyshan,3113,124,6,13,19,31.6%,7m
13927,1,NESS,3113,0,5,0,5,100.0%,42m
13927,1,Tilter,3113,116,4,2,6,66.7%,3m
13927,1,Snoopy,3113,0,3,1,4,75.0%,11m
13927,1,BlessedG,3113,0,3,2,5,60.0%,20m
13927,3,SHWEPS,3113,94,3,9,12,25.0%,12m
13927,1,Nightwiing,3113,38,2,3,5,40.0%,12m
13927,1,SuJi,3113,0,2,3,5,40.0%,2m
13927,1,Chapman,3113,0,1,0,1,100.0%,4m
13927,1,ExoticSphere,3113,0,1,0,1,100.0%,12m
13927,1,Ovi,3113,40,1,1,2,50.0%,23m
13927,1,hollabrrack,3113,0,0,2,2,0.0%,1h
13927,1,Ksardas,3113,0,0,3,3,0.0%,4m
13954,3,Mastablasta,3112,1574,283,274,557,50.8%,14m
13954,1,GoSSuG,3112,1677,160,146,306,52.3%,24m
13954,1,TenLetters,3112,1484,98,84,182,53.8%,1m
13954,3,Test,3112,1582,85,78,163,52.1%,20m
13954,1,Inferno,3112,1549,58,49,107,54.2%,20m
13954,3,[UNS]OmuVerde,3112,668,40,30,70,57.1%,10m
13954,3,heyhomie,3112,571,39,26,65,60.0%,2m
13954,1,[Agape]Thunder,3112,769,26,20,46,56.5%,25m
13954,1,DANNY,3112,455,18,10,28,64.3%,17m
13954,3,[ClSq]Greg,3112,139,6,6,12,50.0%,21m
13954,1,MicroMachine,3112,192,5,6,11,45.5%,2m
13954,1,kyletak,3112,88,4,2,6,66.7%,9m
13954,1,Timber,3112,142,4,9,13,30.8%,15m
13954,1,[RVodka]Sygma,3112,0,1,0,1,100.0%,21m
13954,1,Critter,3112,88,1,1,2,50.0%,20m
13954,3,DrunkGamer,3112,30,1,9,10,10.0%,11m
13954,1,[TSC2C]SMtech,3112,0,0,1,1,0.0%,15m
13954,3,DeadInside,3112,0,0,1,1,0.0%,2m
13954,1,[Wolven]Ottoman,3112,0,0,2,2,0.0%,2m
13954,1,Sjittie,3112,0,0,2,2,0.0%,7m
13974,3,benet,3111,1472,179,159,338,53.0%,22m
13974,1,Luckyman,3111,1761,88,84,172,51.2%,21m
13974,1,[xOuOx]Königstiger,3111,1742,70,59,129,54.3%,22m
13974,1,[FFTeam]Luffy,3111,1468,69,67,136,50.7%,22m
13974,3,nika,3111,1102,53,41,94,56.4%,23m
13974,3,Zee,3111,495,40,34,74,54.1%,8m
13974,3,Shostak,3111,1012,35,41,76,46.1%,2m
13974,1,Avalis,3111,686,29,24,53,54.7%,24m
13974,3,omega,3111,557,26,24,50,52.0%,13m
13974,1,ERPNWhYTeX,3111,592,20,13,33,60.6%,5m
13974,3,[ÐR]eXoǂStafre,3111,477,20,15,35,57.1%,24m
13974,1,Ikarus,3111,193,10,3,13,76.9%,5m
13974,2,djglatnakke,3111,150,8,4,12,66.7%,29m
13974,1,papeuss,3111,188,8,7,15,53.3%,38m
13974,1,[Animе]Aten,3111,164,5,6,11,45.5%,9m
13974,1,Cambronne,3111,120,3,3,6,50.0%,20m
13974,1,Doggi,3111,0,1,0,1,100.0%,25m
13974,1,[CRL]ShaFaX,3111,0,1,0,1,100.0%,4m
13974,1,Van,3111,0,1,0,1,100.0%,25m
13974,1,Aoi,3111,0,1,0,1,100.0%,1m
13974,1,Darkfeever,3111,0,0,1,1,0.0%,10m
13974,3,[MUPD]Hestehvisker,3111,0,0,2,2,0.0%,16m
13996,3,zwoom,3110,1287,101,90,191,52.9%,7m
13996,1,JaYeti,3110,926,41,29,70,58.6%,4m
13996,1,ArLeg,3110,881,37,24,61,60.7%,18m
13996,1,[BornG]Hiroi,3110,667,33,26,59,55.9%,19m
13996,1,Nibbler,3110,373,17,6,23,73.9%,7m
13996,2,zabik,3110,305,13,10,23,56.5%,12m
13996,3,[Dralag]Archangel,3110,284,13,11,24,54.2%,3m
13996,3,Starzinger,3110,192,13,14,27,48.1%,16m
13996,1,TimmkE,3110,318,12,16,28,42.9%,21m
13996,3,ALEM,3110,242,9,14,23,39.1%,15m
13996,1,КотУбийца,3110,264,8,7,15,53.3%,16m
13996,1,Sandalik,3110,192,5,5,10,50.0%,7m
13996,1,IceCreamMan,3110,88,4,2,6,66.7%,24m
13996,3,nesanot,3110,121,4,3,7,57.1%,24m
13996,1,Assguard,3110,141,4,4,8,50.0%,4m
13996,1,norbo,3110,0,1,0,1,100.0%,17m
13996,1,Pitbull,3110,48,1,9,10,10.0%,19m
13996,1,Proza,3110,0,0,1,1,0.0%,20m
14014,3,TpaXyXoJIb,3109,1084,133,133,266,50.0%,20m
14014,1,MassDonfel,3109,1666,96,96,192,50.0%,22m
14014,3,Rivz,3109,1327,94,86,180,52.2%,14m
14014,1,[6P00L]TazDingo,3109,837,32,26,58,55.2%,12m
14014,3,patator,3109,820,31,35,66,47.0%,16m
14014,3,GLUK,3109,696,26,28,54,48.1%,8m
14014,1,[JLT]Yegres,3109,553,23,15,38,60.5%,17m
14014,1,abrigal,3109,536,18,15,33,54.5%,22m
14014,1,[Svin4]KISSARMY,3109,496,14,14,28,50.0%,15m
14014,1,Carlito,3109,360,11,11,22,50.0%,18m
14014,1,[XDD]Nyaaa,3109,304,8,10,18,44.4%,17m
14014,2,[BjwA]Sqeeze,3109,167,6,5,11,54.5%,1h
14014,3,elfif,3109,216,6,10,16,37.5%,16m
14014,3,bon,3109,121,5,2,7,71.4%,36m
14014,1,[GŁ]HUNTY,3109,114,5,3,8,62.5%,24m
14014,3,IIIIIIIIIIII,3109,30,5,3,8,62.5%,20m
14014,1,[SKULLA]Axeti,3109,180,5,4,9,55.6%,7m
14014,3,Iron,3109,165,5,5,10,50.0%,16m
14014,3,maxim,3109,0,4,2,6,66.7%,5m
14014,1,[TrUTr]Watanabe,3109,78,3,0,3,100.0%,17m
14014,1,[G00BY]JHeppers,3109,40,2,4,6,33.3%,2m
14014,1,omgvi,3109,80,2,5,7,28.6%,15m
14014,1,iceface,3109,0,1,1,2,50.0%,3m
14014,1,ShawLin,3109,0,1,1,2,50.0%,7m
14014,1,[LCF1]Caesar,3109,0,0,1,1,0.0%,11m
14014,1,BlazerMan,3109,0,0,1,1,0.0%,15m
14014,3,[dd33nt]daJonas,3109,0,0,1,1,0.0%,5m
14041,3,iLoveProtoss,3108,1154,138,113,251,55.0%,12m
14041,1,Packs,3108,1305,65,53,118,55.1%,15m
14041,1,LEON,3108,1030,39,32,71,54.9%,18m
14041,1,OoO,3108,666,24,15,39,61.5%,15m
14041,3,spitfyre,3108,332,16,10,26,61.5%,2m
14041,1,HsDjHs,3108,340,15,11,26,57.7%,17m
14041,1,[WOSCHD]Wizzo,3108,437,14,20,34,41.2%,16m
14041,1,[MaNc0s]Koldit,3108,396,12,10,22,54.5%,1m
14041,1,Feanor,3108,432,12,16,28,42.9%,21m
14041,1,[BaföG]Terminator,3108,165,8,3,11,72.7%,14m
14041,1,Zoydberg,3108,270,8,11,19,42.1%,7m
14041,1,[Alpka]Noodles,3108,308,8,12,20,40.0%,23m
14041,1,iFBeast,3108,304,8,12,20,40.0%,15m
14041,3,Burrito,3108,58,7,4,11,63.6%,24m
14041,3,Platdays,3108,60,5,8,13,38.5%,8m
14041,3,SnitteLittle,3108,140,4,1,5,80.0%,3m
14041,1,Tram,3108,166,4,5,9,44.4%,5m
14041,1,Choeloli,3108,134,3,3,6,50.0%,23m
14041,3,Auralen,3108,84,2,3,5,40.0%,2m
14041,1,[КАМ]DeRd,3108,0,2,3,5,40.0%,20m
14041,1,unskilled,3108,74,2,3,5,40.0%,12m
14041,1,Lyan,3108,0,1,1,2,50.0%,1m
14041,1,Heterotroph,3108,40,1,3,4,25.0%,11m
14041,3,[Cysorz]Kusok,3108,94,1,5,6,16.7%,19m
14041,1,Muhi,3108,0,0,1,1,0.0%,7m
14041,1,Ray,3108,0,0,2,2,0.0%,12m
14067,3,[DTpro]Drago,3107,678,201,206,407,49.4%,7m
14067,1,Niegz,3107,1541,182,153,335,54.3%,18m
14067,1,[Dupie]Neo,3107,1576,165,147,312,52.9%,18m
14067,1,BoomerBTI,3107,1399,137,121,258,53.1%,5m
14067,1,Jasoooon,3107,1471,91,85,176,51.7%,7m
14067,3,Nite,3107,1480,74,70,144,51.4%,16m
14067,1,berkistayn,3107,1024,37,31,68,54.4%,2m
14067,1,dioops,3107,513,30,23,53,56.6%,15m
14067,3,publicNME,3107,774,27,34,61,44.3%,2m
14067,3,iamzeus,3107,544,19,19,38,50.0%,13m
14067,1,Royal,3107,528,15,14,29,51.7%,1m
14067,3,[НТТ]Heresiarch,3107,111,9,18,27,33.3%,15m
14067,2,Carebear,3107,118,7,4,11,63.6%,1h
14067,1,Weltgeist,3107,38,3,3,6,50.0%,23m
14067,1,Lortsa,3107,47,3,5,8,37.5%,21m
14067,3,RimruTempset,3107,0,1,0,1,100.0%,9m
14067,2,[GGZERG]StarDefender,3107,0,1,0,1,100.0%,15m
14067,3,Solent,3107,0,1,0,1,100.0%,1h
14067,3,[Kompis]SagasPappa,3107,0,1,4,5,20.0%,18m
14067,3,[ABRUTI]Max,3107,0,0,1,1,0.0%,19m
14067,1,[ICEPAG]Gullmoli,3107,0,0,1,1,0.0%,11m
14067,1,ImyourQueen,3107,0,0,1,1,0.0%,17m
14067,1,Eldinoooo,3107,0,0,3,3,0.0%,1h
14090,1,Nimfar,3106,834,168,146,314,53.5%,6m
14090,3,BimBamBude,3106,1579,147,138,285,51.6%,18m
14090,1,Altway,3106,1481,139,127,266,52.3%,15m
14090,1,kyo,3106,1634,134,127,261,51.3%,22m
14090,2,Ranik,3106,1389,59,77,136,43.4%,19m
14090,1,Mslnmf,3106,1209,55,39,94,58.5%,20m
14090,1,Proquiv,3106,1221,44,44,88,50.0%,20m
14090,3,[АDMIN]shvedov,3106,935,43,20,63,68.3%,16m
14090,3,NonMetaL,3106,498,37,38,75,49.3%,18m
14090,3,Hich,3106,868,34,47,81,42.0%,7m
14090,1,Yamn,3106,604,29,8,37,78.4%,12m
14090,1,[WNTR]sTERNI,3106,690,24,22,46,52.2%,9m
14090,1,Yeldoow,3106,732,23,23,46,50.0%,12m
14090,1,[anse]axiom,3106,286,12,8,20,60.0%,11m
14090,3,Paxan,3106,199,9,7,16,56.2%,19m
14090,1,[PRAWN]BigKahuna,3106,310,8,9,17,47.1%,3m
14090,3,Aster,3106,261,8,10,18,44.4%,2m
14090,1,PawelPower,3106,184,5,2,7,71.4%,23m
14090,3,magnum,3106,30,5,3,8,62.5%,12m
14090,1,OneTwo,3106,124,5,5,10,50.0%,2m
14090,3,[DN0]bigT,3106,0,4,2,6,66.7%,1h
14090,2,[Gerts]Bug,3106,121,3,2,5,60.0%,41m
14090,1,Human,3106,74,3,4,7,42.9%,17m
14090,3,Bananas,3106,147,3,8,11,27.3%,16m
14090,1,IAMFUNNYBOT,3106,74,2,4,6,33.3%,20m
14090,1,Laksen,3106,0,1,0,1,100.0%,19m
14090,1,[LDSC2]SoolMay,3106,0,1,0,1,100.0%,11m
14090,1,[125]Chobo,3106,0,1,1,2,50.0%,21m
14090,1,Eastone,3106,0,1,1,2,50.0%,3m
14090,1,[ZERG7V]Pexel,3106,38,1,3,4,25.0%,23m
14090,1,Drus,3106,0,1,3,4,25.0%,4m
14090,1,Vegetto,3106,0,0,2,2,0.0%,6m
14122,1,AllDayTicket,3105,1399,305,269,574,53.1%,22m
14122,3,Sanity,3105,1482,141,122,263,53.6%,21m
14122,1,Kaito,3105,1597,127,102,229,55.5%,25m
14122,3,[UR1N]Jesper,3105,1488,76,71,147,51.7%,12m
14122,1,axsc,3105,915,41,31,72,56.9%,4m
14122,1,SeanDeFegan,3105,668,22,17,39,56.4%,17m
14122,3,ultahd,3105,613,22,27,49,44.9%,23m
14122,3,marcin,3105,374,16,16,32,50.0%,5m
14122,1,GrumpyPants,3105,296,12,8,20,60.0%,23m
14122,1,Zmajmun,3105,254,8,4,12,66.7%,3m
14122,1,icks,3105,180,6,5,11,54.5%,7m
14122,3,Blitzkrieg,3105,30,5,3,8,62.5%,20m
14122,1,Sephmk,3105,76,3,3,6,50.0%,23m
14122,3,Surtur,3105,121,3,4,7,42.9%,30m
14122,1,Yerbi,3105,40,1,2,3,33.3%,15m
14122,3,[Dralag]FerimOn,3105,0,0,6,6,0.0%,22m
14138,1,sudoVoid,3104,1755,488,463,951,51.3%,17m
14138,1,[SGQuad]Rüdiger,3104,1577,216,213,429,50.3%,4m
14138,3,[stulj]Chabar,3104,1340,123,100,223,55.2%,13m
14138,1,stupid,3104,1381,72,69,141,51.1%,10m
14138,3,[WNB]Dionis,3104,685,54,43,97,55.7%,2m
14138,3,kres,3104,466,17,24,41,41.5%,15m
14138,1,lightman,3104,478,13,14,27,48.1%,15m
14138,1,StepSeven,3104,434,12,12,24,50.0%,17m
14138,1,slash,3104,300,9,8,17,52.9%,15m
14138,1,[Petrus]Скребкокрыл,3104,0,4,1,5,80.0%,1h
14138,1,Rayaxir,3104,141,4,5,9,44.4%,12m
14138,1,Noxuris,3104,92,3,2,5,60.0%,1h
14138,1,gonuHr,3104,0,1,0,1,100.0%,15m
14138,1,Meester,3104,32,1,1,2,50.0%,11m
14138,3,[DS1]WhiteHawk,3104,42,1,2,3,33.3%,36m
14138,1,[Мaстер]Князь,3104,0,0,1,1,0.0%,5m
14154,3,Refactor,3103,782,208,222,430,48.4%,7m
14154,3,Spancheg,3103,1113,182,162,344,52.9%,2m
14154,3,spaan,3103,1205,174,176,350,49.7%,15m
14154,1,josh,3103,1743,138,114,252,54.8%,16m
14154,3,Strider,3103,1592,128,123,251,51.0%,2m
14154,1,mingo,3103,1500,111,97,208,53.4%,4m
14154,1,Newplaya,3103,1441,110,84,194,56.7%,18m
14154,3,Batya,3103,1545,102,100,202,50.5%,18m
14154,1,[FGStar]StianRode,3103,863,41,35,76,53.9%,18m
14154,3,Maanu,3103,436,39,48,87,44.8%,7m
14154,1,NoChanceForU,3103,824,31,24,55,56.4%,20m
14154,3,Marian,3103,570,24,28,52,46.2%,19m
14154,1,[XF71]GhoZty,3103,693,22,18,40,55.0%,18m
14154,1,Deaz,3103,419,13,14,27,48.1%,2m
14154,3,[Panas]Konkordus,3103,324,11,16,27,40.7%,7m
14154,1,Itachi,3103,192,9,6,15,60.0%,34m
14154,1,[OphiG]Jokezz,3103,336,9,6,15,60.0%,20m
14154,1,Luchkox,3103,324,9,11,20,45.0%,2m
14154,3,llllllllllll,3103,245,8,6,14,57.1%,25m
14154,1,[FPA]Mecki,3103,264,7,9,16,43.8%,15m
14154,3,Tasadar,3103,58,6,5,11,54.5%,17m
14154,1,[173]bricktrone,3103,231,5,4,9,55.6%,15m
14154,3,swibberman,3103,0,4,2,6,66.7%,1h
14154,2,LifeFoNerzul,3103,160,4,4,8,50.0%,1h
14154,1,[IIGDTD]Plibby,3103,156,4,5,9,44.4%,21m
14154,1,[Nеzukо]OniUbiliKeni,3103,130,3,5,8,37.5%,15m
14154,1,Entenvogel,3103,38,1,5,6,16.7%,4m
14154,3,[ККП]LikeVoid,3103,0,1,5,6,16.7%,11m
14154,1,SiKe,3103,0,0,2,2,0.0%,2m
14183,3,Waddle,3102,1614,258,237,495,52.1%,19m
14183,1,Oniichan,3102,1337,60,40,100,60.0%,2m
14183,3,BaBaFinGO,3102,1116,49,45,94,52.1%,9m
14183,3,Jesu,3102,1149,48,50,98,49.0%,19m
14183,3,FappyToad,3102,1089,46,40,86,53.5%,18m
14183,1,PinkiePie,3102,422,43,29,72,59.7%,6m
14183,1,Ost,3102,393,15,9,24,62.5%,18m
14183,2,network,3102,163,7,4,11,63.6%,5m
14183,1,Armut,3102,210,7,7,14,50.0%,3m
14183,1,StorM,3102,198,4,3,7,57.1%,22m
14183,1,Harper,3102,153,4,4,8,50.0%,17m
14183,3,[PSuger]major,3102,0,3,1,4,75.0%,24m
14183,1,CountTossula,3102,102,3,4,7,42.9%,22m
14183,1,DOC,3102,40,2,0,2,100.0%,4m
14183,3,Jack,3102,121,2,2,4,50.0%,7m
14183,3,[ArĮnĒn]ØḼĐђŲÑŦĒŘ,3102,60,2,9,11,18.2%,21m
14183,1,Nitram,3102,0,1,3,4,25.0%,20m
14183,2,[Кусь]нуненадо,3102,0,0,1,1,0.0%,1h
14201,1,Metov,3101,1745,140,132,272,51.5%,20m
14201,1,[ЕПРСТ]JuGGler,3101,652,72,70,142,50.7%,9m
14201,3,Math,3101,866,53,59,112,47.3%,25m
14201,1,Sycorax,3101,1135,49,42,91,53.8%,18m
14201,3,Loynis,3101,1252,43,54,97,44.3%,5m
14201,1,Allbeerate,3101,592,33,23,56,58.9%,6m
14201,1,Lasaqus,3101,684,23,18,41,56.1%,25m
14201,1,Cakething,3101,486,22,10,32,68.8%,24m
14201,1,hawk,3101,482,18,15,33,54.5%,20m
14201,3,Halatlan,3101,320,14,8,22,63.6%,15m
14201,1,Dedmazai,3101,222,6,9,15,40.0%,25m
14201,1,hanbing,3101,176,5,6,11,45.5%,3m
14201,3,TwixHappy,3101,195,5,9,14,35.7%,22m
14201,3,pride,3101,0,4,2,6,66.7%,12m
14201,1,Lucky,3101,36,2,0,2,100.0%,5m
14201,1,Sankari,3101,40,2,1,3,66.7%,15m
14201,2,Saxo,3101,46,2,7,9,22.2%,5m
14201,2,Awin,3101,0,1,2,3,33.3%,1h
14201,3,[WBGA]Teekhay,3101,0,0,6,6,0.0%,3m
14220,3,Eragonball,3100,1378,120,104,224,53.6%,2m
14220,3,Wuksh,3100,1284,73,85,158,46.2%,25m
14220,3,Egregor,3100,1079,49,44,93,52.7%,9m
14220,3,[HBGS]Borbet,3100,1287,47,58,105,44.8%,16m
14220,1,[Dogmin]Sabreal,3100,679,30,19,49,61.2%,4m
14220,1,[YSB]MrAnderson,3100,588,17,19,36,47.2%,6m
14220,1,Insuspect,3100,508,15,17,32,46.9%,3m
14220,3,twardy,3100,361,13,12,25,52.0%,3m
14220,1,[eLegaL]Shiva,3100,255,12,7,19,63.2%,18m
14220,1,Esarel,3100,224,9,7,16,56.2%,20m
14220,3,Poual,3100,216,8,9,17,47.1%,22m
14220,2,BrilleHankat,3100,189,7,4,11,63.6%,27m
14220,1,[100001]IceDee,3100,114,3,8,11,27.3%,18m
14220,1,[CBFPL]bialo,3100,120,3,8,11,27.3%,21m
14220,1,Knackwurst,3100,0,1,0,1,100.0%,22m
14220,1,dorxter,3100,38,1,1,2,50.0%,21m
14220,1,TigIDigI,3100,38,1,2,3,33.3%,3m
14220,3,[PNZ]Plague,3100,0,0,1,1,0.0%,13m
14220,1,Pendragon,3100,0,0,2,2,0.0%,11m
14220,1,popol,3100,0,0,2,2,0.0%,6m
14220,1,Aurinik,3100,0,0,4,4,0.0%,12m
14241,3,Snore,3099,1436,92,98,190,48.4%,19m
14241,1,other,3099,1705,84,77,161,52.2%,22m
14241,1,Schubiduuhh,3099,387,40,31,71,56.3%,17m
14241,1,RainbowDash,3099,968,37,40,77,48.1%,15m
14241,1,[сSсǃ]Александр,3099,719,28,20,48,58.3%,5m
14241,1,AndOneKN,3099,640,27,21,48,56.2%,18m
14241,3,skrytyżubr,3099,558,21,19,40,52.5%,16m
14241,1,Apocalypsis,3099,598,17,19,36,47.2%,7m
14241,3,PaVooLoN,3099,397,14,18,32,43.8%,19m
14241,3,[KoyBee]Jerome,3099,276,12,8,20,60.0%,11m
14241,1,[C37224]GranPedrito,3099,364,11,12,23,47.8%,2m
14241,3,benadam,3099,366,11,15,26,42.3%,22m
14241,3,anklan,3099,118,9,3,12,75.0%,14m
14241,3,Koi,3099,220,7,1,8,87.5%,2m
14241,1,Vismeister,3099,293,7,6,13,53.8%,15m
14241,1,[BLCrow]AlexGodfree,3099,168,5,4,9,55.6%,32m
14241,3,Kirasempai,3099,160,5,5,10,50.0%,16m
14241,1,Fidanxaos,3099,158,4,1,5,80.0%,9m
14241,1,[JDx]chapi,3099,0,3,2,5,60.0%,14m
14241,1,llllllllllll,3099,42,2,3,5,40.0%,24m
14241,1,[NiN]NiNjadO,3099,0,1,1,2,50.0%,2m
14241,1,ScSpaghetti,3099,40,1,2,3,33.3%,4m
14241,1,[rus88]Mavruks,3099,97,1,4,5,20.0%,23m
14241,1,JusTDoiTpLs,3099,0,0,1,1,0.0%,7m
14241,1,illyasviel,3099,0,0,1,1,0.0%,11m
14241,1,stingeR,3099,0,0,3,3,0.0%,1h
14267,3,Banksysc,3098,1546,249,248,497,50.1%,7m
14267,1,Fullliare,3098,1389,151,142,293,51.5%,25m
14267,3,hellacrazy,3098,1511,151,144,295,51.2%,19m
14267,1,[IDGaGa]BaKBaK,3098,444,40,8,48,83.3%,5m
14267,1,ffii,3098,445,36,7,43,83.7%,20m
14267,3,FatBasterd,3098,820,31,40,71,43.7%,16m
14267,1,Teg,3098,459,23,14,37,62.2%,2m
14267,1,nowhereMan,3098,443,17,15,32,53.1%,4m
14267,1,Parzival,3098,283,11,8,19,57.9%,23m
14267,1,SANcontrol,3098,228,7,7,14,50.0%,2m
14267,1,[LaLooz]HotBlooded,3098,88,3,3,6,50.0%,23m
14267,1,DarkAdino,3098,74,3,4,7,42.9%,8m
14267,1,ShiningLazer,3098,42,3,4,7,42.9%,8m
14267,1,Funtik,3098,138,3,7,10,30.0%,5m
14267,3,[LevFun]Timur,3098,98,3,13,16,18.8%,15m
14267,1,AveSwarmWLM,3098,34,2,0,2,100.0%,24m
14267,1,Tomé,3098,74,2,2,4,50.0%,3m
14267,1,[DT974]Malo,3098,0,1,0,1,100.0%,14m
14267,1,Guber,3098,0,1,0,1,100.0%,22m
14267,1,[PR0uT]MartyMcFight,3098,0,1,1,2,50.0%,15m
14267,1,DOCG,3098,0,0,1,1,0.0%,12m
14267,1,FlashLoad,3098,0,0,3,3,0.0%,22m
14267,1,Frostyk,3098,73,0,4,4,0.0%,18m
14290,1,[DABM]Deratwil,3097,1346,125,98,223,56.1%,2m
14290,1,[mfxed]PanKasztanPL,3097,1303,98,64,162,60.5%,22m
14290,1,[LMBD]marulovetea,3097,1409,62,39,101,61.4%,11m
14290,3,xluciferx,3097,517,56,53,109,51.4%,3m
14290,1,[SPAINs]LeNCorN,3097,1138,39,38,77,50.6%,17m
14290,1,[WoTT]Alai,3097,994,38,33,71,53.5%,18m
14290,3,Tengil,3097,379,19,25,44,43.2%,17m
14290,1,EZFHO,3097,444,16,8,24,66.7%,2m
14290,1,noOne,3097,334,11,12,23,47.8%,17m
14290,1,Gural,3097,266,7,7,14,50.0%,18m
14290,3,Kantor,3097,121,5,2,7,71.4%,15m
14290,3,Khazrorkh,3097,97,5,2,7,71.4%,17m
14290,1,Pochtalon,3097,48,4,2,6,66.7%,22m
14290,1,fuzi,3097,161,4,3,7,57.1%,15m
14290,1,[GrandT]hypocrites,3097,120,4,6,10,40.0%,4m
14290,1,[Latin]simba,3097,116,3,7,10,30.0%,17m
14290,3,DerNachbar,3097,0,1,0,1,100.0%,3m
14290,1,shadow,3097,0,1,0,1,100.0%,4m
14290,1,[NvBa]Jackawaka,3097,40,1,2,3,33.3%,3m
14290,1,Rendor,3097,96,1,2,3,33.3%,44m
14290,1,[PdGI]YoSh,3097,40,1,3,4,25.0%,6m
14290,1,[Юнион]Фаэтон,3097,0,0,1,1,0.0%,19m
14290,1,profi,3097,0,0,2,2,0.0%,2m
14290,1,MartyMcFly,3097,0,0,2,2,0.0%,12m
14290,3,Arturoh,3097,0,0,7,7,0.0%,20m
14315,1,DrOne,3096,1481,115,108,223,51.6%,18m
14315,1,beachtonio,3096,1751,74,64,138,53.6%,11m
14315,3,Pims,3096,1056,69,73,142,48.6%,9m
14315,1,[KRUNK]Grandma,3096,803,36,29,65,55.4%,11m
14315,3,[Arrows]LoMaster,3096,745,29,27,56,51.8%,19m
14315,1,[Yukos]Execluzive,3096,594,25,18,43,58.1%,12m
14315,1,Wolfius,3096,596,22,18,40,55.0%,25m
14315,1,barcode,3096,510,14,15,29,48.3%,22m
14315,3,[IIIllI]SunStar,3096,402,14,25,39,35.9%,4m
14315,1,QRDEGRABARZ,3096,258,9,8,17,52.9%,3m
14315,1,IIIIIIIIIIII,3096,184,8,9,17,47.1%,44m
14315,1,Nistelbog,3096,188,5,8,13,38.5%,20m
14315,1,ShadowEye,3096,38,2,2,4,50.0%,25m
14315,1,Ramo,3096,0,1,1,2,50.0%,15m
14315,1,ana,3096,40,1,3,4,25.0%,18m
14315,1,paulin,3096,0,1,3,4,25.0%,20m
14315,1,Xpomocoma,3096,0,0,1,1,0.0%,4m
14315,1,[ELSN]san,3096,0,0,1,1,0.0%,15m
14315,3,[EBU]Princ,3096,0,0,1,1,0.0%,8m
14315,1,Lesik,3096,0,0,1,1,0.0%,5m
14315,3,[ЗЕRGТV]ACWar,3096,0,0,1,1,0.0%,34m
14315,1,Zarakalus,3096,0,0,1,1,0.0%,6m
14315,3,[vi2018]luplau,3096,0,0,1,1,0.0%,22m
14315,3,TheBoss,3096,0,0,1,1,0.0%,13m
14315,3,Django,3096,0,0,5,5,0.0%,16m
14340,3,Parkeis,3095,1272,74,69,143,51.7%,22m
14340,1,SunCanRock,3095,1300,62,33,95,65.3%,25m
14340,3,[ZЕRGТV]Monstr,3095,936,36,42,78,46.2%,16m
14340,1,DeMHioS,3095,507,18,17,35,51.4%,15m
14340,1,TouchpadHero,3095,330,10,8,18,55.6%,15m
14340,1,MudavuKa,3095,268,7,9,16,43.8%,20m
14340,3,Kihn,3095,152,5,10,15,33.3%,17m
14340,3,llFreedoMll,3095,90,3,7,10,30.0%,14m
14340,1,Sideswiper,3095,97,2,0,2,100.0%,19m
14340,1,[Moskva]DropProbes,3095,72,2,3,5,40.0%,14m
14340,1,DefenseMode,3095,0,0,1,1,0.0%,20m
14340,1,Protector,3095,0,0,2,2,0.0%,18m
14352,3,SARGE,3094,1480,125,118,243,51.4%,18m
14352,3,[DOKA2]Enturill,3094,1559,109,92,201,54.2%,12m
14352,1,CabTheCat,3094,1413,92,81,173,53.2%,5m
14352,3,HRM,3094,963,39,36,75,52.0%,8m
14352,3,[QZC]Falamir,3094,776,36,28,64,56.2%,2m
14352,3,Qwan,3094,654,28,27,55,50.9%,10m
14352,1,Will,3094,473,26,23,49,53.1%,6m
14352,3,Владыка,3094,738,26,34,60,43.3%,15m
14352,1,Loki,3094,413,19,12,31,61.3%,2m
14352,3,[MBRT]ZeroEpsilon,3094,480,18,27,45,40.0%,20m
14352,1,Krabikoo,3094,403,17,11,28,60.7%,7m
14352,1,Zordon,3094,262,15,11,26,57.7%,8m
14352,1,Corny,3094,310,13,7,20,65.0%,20m
14352,1,Filous,3094,288,10,5,15,66.7%,4m
14352,3,[Ǽ1]Cricri,3094,331,10,14,24,41.7%,10m
14352,1,DalekSec,3094,260,9,12,21,42.9%,5m
14352,1,[RÆNDØM]Tainan,3094,0,5,0,5,100.0%,46m
14352,1,BanterBoy,3094,127,3,0,3,100.0%,11m
14352,1,oachkatzel,3094,82,3,5,8,37.5%,15m
14352,1,doppelgänger,3094,0,1,0,1,100.0%,11m
14352,1,Funmaster,3094,0,1,0,1,100.0%,4m
14352,1,Winters,3094,38,1,1,2,50.0%,25m
14352,2,SparTa,3094,0,1,2,3,33.3%,34m
14352,1,[ZЕRGТV]OraCuLe,3094,0,0,1,1,0.0%,7m
14352,1,Flakey,3094,0,0,1,1,0.0%,2m
14377,1,yajo,3093,1693,210,177,387,54.3%,25m
14377,3,ParryHotter,3093,593,78,76,154,50.6%,25m
14377,3,[H0C]SandStorm,3093,1442,71,62,133,53.4%,3m
14377,1,[hades]Lapsus,3093,956,30,35,65,46.2%,2m
14377,1,NoxAeterna,3093,631,20,19,39,51.3%,9m
14377,1,Annatar,3093,339,11,6,17,64.7%,25m
14377,1,Helios,3093,167,6,1,7,85.7%,20m
14377,1,SneakyGerri,3093,138,4,3,7,57.1%,11m
14377,3,DerehamPride,3093,120,3,0,3,100.0%,8m
14377,1,[SHigh]Hekup,3093,76,2,2,4,50.0%,21m
14377,1,IncendiuM,3093,78,2,4,6,33.3%,18m
14377,1,[NotSuR]xtkbr,3093,82,2,5,7,28.6%,5m
14377,3,Lamapaluzah,3093,124,2,6,8,25.0%,15m
14377,1,Lubert,3093,36,1,6,7,14.3%,24m
14377,1,Memo,3093,0,0,1,1,0.0%,18m
14392,1,Legacy,3092,1487,264,224,488,54.1%,12m
14392,3,Remedy,3092,1546,240,231,471,51.0%,13m
14392,3,ОтецИосиф,3092,785,128,123,251,51.0%,3m
14392,1,[GGasap]andChill,3092,1727,108,104,212,50.9%,23m
14392,3,NewB,3092,1491,81,87,168,48.2%,7m
14392,1,[RBTV3]DAWǂAlcatraz,3092,673,71,63,134,53.0%,12m
14392,1,Ryuk,3092,1426,57,45,102,55.9%,22m
14392,1,Noble,3092,791,38,39,77,49.4%,9m
14392,1,[BRST]Cloak,3092,714,29,21,50,58.0%,25m
14392,3,debe,3092,333,14,14,28,50.0%,8m
14392,1,angiox,3092,235,10,6,16,62.5%,15m
14392,2,[Klick]Makkelele,3092,210,8,5,13,61.5%,1h
14392,1,SayFaveSong,3092,175,5,2,7,71.4%,25m
14392,1,StarKiller,3092,88,4,2,6,66.7%,14m
14392,1,MrPuff,3092,125,2,1,3,66.7%,23m
14392,1,[SeTeH]dksiazek,3092,0,1,0,1,100.0%,5m
14392,3,Sluthusky,3092,0,1,2,3,33.3%,15m
14392,1,Lucky,3092,42,1,4,5,20.0%,21m
14410,1,[SPAINs]LaFUenTe,3091,1088,64,37,101,63.4%,21m
14410,1,[ATOM]Zeppo,3091,933,40,25,65,61.5%,4m
14410,1,Leo,3091,873,39,26,65,60.0%,22m
14410,3,Rithulme,3091,872,29,39,68,42.6%,2m
14410,1,[Kapра]BarCode,3091,575,27,18,45,60.0%,25m
14410,1,TomBomHDYT,3091,510,24,15,39,61.5%,18m
14410,1,Maxblue,3091,516,18,12,30,60.0%,25m
14410,3,Kita,3091,328,15,13,28,53.6%,8m
14410,1,[RIML]ГеройГероев,3091,338,10,10,20,50.0%,15m
14410,1,[AotUB]Voinik,3091,125,5,3,8,62.5%,19m
14410,1,ddoogg,3091,176,5,5,10,50.0%,8m
14410,1,MaZen,3091,154,5,6,11,45.5%,15m
14410,3,Maru,3091,0,3,3,6,50.0%,7m
14410,1,Alpha,3091,107,2,1,3,66.7%,18m
14410,1,Falcon,3091,82,2,8,10,20.0%,20m
14410,1,Wippie,3091,38,1,1,2,50.0%,17m
14410,1,Pequet,3091,0,0,1,1,0.0%,8m
14410,3,AnomBomj,3091,0,0,1,1,0.0%,22m
14428,3,HCAN,3090,1544,429,422,851,50.4%,16m
14428,3,Semmi,3090,1438,207,204,411,50.4%,18m
14428,3,Pashhar,3090,853,80,75,155,51.6%,16m
14428,1,player,3090,280,73,19,92,79.3%,15m
14428,3,[Heroes]Arcon,3090,635,60,57,117,51.3%,4m
14428,1,Xtremum,3090,800,50,41,91,54.9%,12m
14428,1,LeGrandJojo,3090,1295,50,52,102,49.0%,2m
14428,3,Livy,3090,1021,40,40,80,50.0%,22m
14428,3,Psychokilla,3090,781,30,28,58,51.7%,18m
14428,3,[B3ard]Dontyr,3090,482,21,14,35,60.0%,22m
14428,3,Шериф,3090,528,21,21,42,50.0%,10m
14428,3,EatKimchiPlz,3090,433,17,7,24,70.8%,16m
14428,2,zell,3090,223,9,4,13,69.2%,37m
14428,1,TessaBliss,3090,193,7,3,10,70.0%,25m
14428,1,Dustbane,3090,192,6,7,13,46.2%,25m
14428,2,draikos,3090,116,5,5,10,50.0%,17m
14428,1,[drain]captaincuck,3090,48,4,2,6,66.7%,30m
14428,3,INNNNoVatioN,3090,162,4,3,7,57.1%,16m
14428,1,AndKis,3090,114,3,4,7,42.9%,6m
14428,1,[WWBIER]CashiusClay,3090,88,2,1,3,66.7%,5m
14428,1,[LEOTAL]MrWhitewhite,3090,127,2,1,3,66.7%,7m
14428,1,Mikiya,3090,40,2,1,3,66.7%,9m
14428,1,[UJ]JIMMYJOKER,3090,80,2,7,9,22.2%,5m
14428,3,[MaNuss]papnum,3090,0,1,1,2,50.0%,5m
14428,1,[HBGSJR]megadimon,3090,90,1,1,2,50.0%,3m
14428,1,Magicadam,3090,40,1,3,4,25.0%,15m
14428,1,Panzzaro,3090,0,0,1,1,0.0%,18m
14428,1,AlvaroLayon,3090,0,0,1,1,0.0%,41m
14428,3,Fighter,3090,0,0,8,8,0.0%,22m
14457,3,[XDN]bang,3089,1489,277,269,546,50.7%,7m
14457,3,[KozaŚn]Paradoxy,3089,1187,134,118,252,53.2%,22m
14457,1,Kuks,3089,1651,104,98,202,51.5%,18m
14457,3,WhiteShadow,3089,1502,96,97,193,49.7%,12m
14457,1,[ClandM]FILIPPICLE,3089,1724,63,63,126,50.0%,15m
14457,3,[lOoOl]lobook,3089,979,38,39,77,49.4%,22m
14457,1,MisiAQ,3089,444,22,11,33,66.7%,12m
14457,1,Pero,3089,436,14,14,28,50.0%,12m
14457,1,Metalsous,3089,262,8,5,13,61.5%,11m
14457,1,rNix,3089,110,7,5,12,58.3%,20m
14457,1,[420ZA]StatsZA,3089,184,6,4,10,60.0%,5m
14457,1,ZiRaX,3089,215,6,6,12,50.0%,8m
14457,1,kepKolbaskin,3089,119,5,6,11,45.5%,21m
14457,1,[MarING]BaronOwSky,3089,0,4,1,5,80.0%,11m
14457,1,OldSchool,3089,48,4,2,6,66.7%,39m
14457,1,eVoeXon,3089,80,3,2,5,60.0%,18m
14457,1,alexander,3089,82,3,5,8,37.5%,14m
14457,3,[G4VR]Zanna,3089,97,2,1,3,66.7%,43m
14457,3,[BMNPs]nitsud,3089,32,2,2,4,50.0%,3m
14457,1,Ebanumbaaa,3089,80,2,3,5,40.0%,7m
14457,1,Berzerker,3089,0,2,3,5,40.0%,23m
14457,3,BengaminVDV,3089,30,2,8,10,20.0%,6m
14457,1,DarkWarrior,3089,0,1,0,1,100.0%,15m
14457,1,Hools,3089,0,0,2,2,0.0%,11m
14457,1,Izo,3089,0,0,2,2,0.0%,2m
14457,3,[BURIZA]Jerichololo,3089,0,0,2,2,0.0%,34m
14483,3,Miro,3088,1542,129,130,259,49.8%,3m
14483,3,[DLTED]AnarQ,3088,966,74,72,146,50.7%,15m
14483,3,Feencreg,3088,594,29,34,63,46.0%,11m
14483,1,Starzinger,3088,353,27,17,44,61.4%,17m
14483,1,ChessMan,3088,433,18,13,31,58.1%,2m
14483,3,[OSgZ]Ricotchet,3088,486,16,23,39,41.0%,16m
14483,1,[SnSh]Yob,3088,372,15,11,26,57.7%,18m
14483,1,[MSUSC2]krirller,3088,480,13,15,28,46.4%,3m
14483,1,metric,3088,171,9,3,12,75.0%,23m
14483,1,buscettn,3088,254,9,7,16,56.2%,21m
14483,1,Dmcc,3088,200,8,2,10,80.0%,10m
14483,1,[ESAL]Templar,3088,107,6,1,7,85.7%,7m
14483,1,gevolushn,3088,74,5,4,9,55.6%,23m
14483,1,pksc,3088,48,4,2,6,66.7%,17m
14483,1,Rotter,3088,116,3,7,10,30.0%,23m
14483,3,DARKDESIGN,3088,62,3,9,12,25.0%,4m
14483,1,[MogaDa]nyxz,3088,38,2,1,3,66.7%,2m
14483,1,Heralt,3088,0,1,0,1,100.0%,3m
14483,1,[TLANDA]Lukkemannen,3088,30,1,1,2,50.0%,11m
14483,3,Maximus,3088,0,1,2,3,33.3%,6m
14483,1,AnyKey,3088,0,0,1,1,0.0%,3m
14483,1,MRI,3088,0,0,1,1,0.0%,20m
14483,1,[KVV]STAVR,3088,0,0,2,2,0.0%,17m
14506,1,[Mañas]Burrupezones,3087,1671,81,61,142,57.0%,19m
14506,3,SayReks,3087,529,60,54,114,52.6%,16m
14506,1,loluś,3087,941,47,35,82,57.3%,14m
14506,1,LiquidZerg,3087,795,36,22,58,62.1%,15m
14506,1,LePombaer,3087,603,23,13,36,63.9%,8m
14506,1,alphomega,3087,468,16,12,28,57.1%,3m
14506,3,[WCKYLN]katzbalger,3087,272,12,10,22,54.5%,2m
14506,1,Maras,3087,334,10,10,20,50.0%,2m
14506,1,[Heroes]PaxAeterna,3087,171,6,2,8,75.0%,11m
14506,3,eco,3087,160,6,15,21,28.6%,5m
14506,3,Zico,3087,186,4,2,6,66.7%,1h
14506,1,RadiusVector,3087,106,3,0,3,100.0%,15m
14506,1,[Amant]Kofurea,3087,161,3,3,6,50.0%,25m
14506,1,DrHauws,3087,78,2,5,7,28.6%,2m
14506,1,Arakant,3087,40,1,2,3,33.3%,25m
14506,3,venatiC,3087,30,1,5,6,16.7%,16m
14506,1,[Colic]Kronik,3087,0,0,1,1,0.0%,4m
14506,1,[Heroes]immOrTaL,3087,0,0,1,1,0.0%,12m
14506,1,AlexHideg,3087,0,0,2,2,0.0%,9m
14525,1,Fereniousis,3086,1501,62,50,112,55.4%,18m
14525,1,Mentat,3086,1115,61,47,108,56.5%,20m
14525,1,UberMarginal,3086,434,33,24,57,57.9%,25m
14525,3,mythos,3086,472,19,19,38,50.0%,9m
14525,1,grushan,3086,374,16,9,25,64.0%,3m
14525,1,[SuNaWa]Wega,3086,341,16,10,26,61.5%,18m
14525,1,PereNoël,3086,326,14,6,20,70.0%,3m
14525,2,AppleShampoo,3086,225,10,4,14,71.4%,15m
14525,1,Yxo,3086,238,7,9,16,43.8%,11m
14525,1,[Azimut]Morgoth,3086,211,6,5,11,54.5%,43m
14525,1,Jizzapadoo,3086,154,5,4,9,55.6%,21m
14525,1,KALAD,3086,112,3,0,3,100.0%,19m
14525,1,[Bruv]PickleRick,3086,0,1,0,1,100.0%,2m
14525,1,gbrp,3086,89,1,1,2,50.0%,25m
14525,1,[GRAM4]Fastest,3086,0,0,1,1,0.0%,8m
14525,1,patachoux,3086,0,0,4,4,0.0%,23m
14541,1,МаминМодник,3085,1688,188,170,358,52.5%,15m
14541,3,LovePeople,3085,1603,169,169,338,50.0%,12m
14541,1,[Draft]Метрокот,3085,1402,111,96,207,53.6%,15m
14541,3,Hebbe,3085,700,50,41,91,54.9%,2m
14541,3,MaxPower,3085,537,40,48,88,45.5%,10m
14541,3,Kenobi,3085,342,35,47,82,42.7%,3m
14541,3,Doom,3085,547,25,19,44,56.8%,3m
14541,1,[Peeps]Noitcereon,3085,686,23,20,43,53.5%,19m
14541,3,Mort,3085,280,16,14,30,53.3%,15m
14541,1,[InitRu]DeDyshka,3085,187,15,14,29,51.7%,7m
14541,1,Didi,3085,442,14,11,25,56.0%,20m
14541,3,ZakBay,3085,327,13,8,21,61.9%,22m
14541,1,Moralex,3085,453,13,12,25,52.0%,14m
14541,1,[PFrusH]Jacke,3085,217,11,2,13,84.6%,9m
14541,1,sudo,3085,264,10,3,13,76.9%,20m
14541,1,[PUSSY1]Penetrator,3085,120,7,3,10,70.0%,22m
14541,1,anuch,3085,294,7,7,14,50.0%,15m
14541,1,MrBRABUS,3085,196,6,7,13,46.2%,2m
14541,1,VxD,3085,226,6,10,16,37.5%,5m
14541,3,NinjaKeks,3085,165,5,2,7,71.4%,9m
14541,1,Tarasini,3085,0,3,1,4,75.0%,1h
14541,1,[Kingz]Drake,3085,0,3,2,5,60.0%,1h
14541,1,[KDV]Raindbow,3085,126,2,2,4,50.0%,9m
14541,1,[Peeps]Cluius,3085,0,0,1,1,0.0%,12m
14541,1,GeneralDuke,3085,0,0,1,1,0.0%,17m
14541,3,Uzmanoy,3085,0,0,1,1,0.0%,5m
14541,1,katz,3085,0,0,2,2,0.0%,3m
14541,1,Argentum,3085,0,0,3,3,0.0%,25m
14569,1,tarek,3084,1510,256,232,488,52.5%,20m
14569,1,MiniMaus,3084,1578,224,222,446,50.2%,25m
14569,3,[NANE]Ortsyd,3084,1270,117,113,230,50.9%,3m
14569,1,DaftJoker,3084,1578,104,91,195,53.3%,25m
14569,3,slowSilver,3084,785,77,59,136,56.6%,2m
14569,1,Yoxs,3084,1284,66,54,120,55.0%,25m
14569,1,chaOs,3084,1535,59,48,107,55.1%,8m
14569,1,HiddenUser,3084,953,40,37,77,51.9%,17m
14569,1,[decoy]dib,3084,695,29,22,51,56.9%,14m
14569,1,ZoomeR,3084,430,20,22,42,47.6%,25m
14569,1,cognizant,3084,325,14,13,27,51.9%,15m
14569,1,GogaTsar,3084,271,12,4,16,75.0%,18m
14569,3,Gelicide,3084,163,11,11,22,50.0%,23m
14569,3,Vers,3084,173,10,10,20,50.0%,5m
14569,1,Sofitza,3084,192,9,2,11,81.8%,5m
14569,3,Linteros,3084,74,9,15,24,37.5%,7m
14569,1,BlueT,3084,192,6,7,13,46.2%,17m
14569,1,[EmŦ]blackpearl,3084,141,5,4,9,55.6%,2m
14569,1,blysandleon,3084,160,4,3,7,57.1%,23m
14569,2,llllllll,3084,88,3,0,3,100.0%,37m
14569,1,lIlIlIlIlIlI,3084,137,3,2,5,60.0%,3m
14569,1,[ENV]Infi,3084,116,3,5,8,37.5%,18m
14569,1,Ukushu,3084,139,3,8,11,27.3%,21m
14569,2,Xyen,3084,42,2,1,3,66.7%,1h
14569,1,JerrySAN,3084,0,1,0,1,100.0%,2m
14569,1,[BTCS]Pepy,3084,0,1,0,1,100.0%,12m
14569,2,ManukinGG,3084,0,1,1,2,50.0%,1h
14569,1,ruslanbest,3084,40,1,2,3,33.3%,6m
14569,1,[R4Time]Wizard,3084,46,1,4,5,20.0%,15m
14569,1,TRIFON,3084,0,0,1,1,0.0%,9m
14569,3,kecar,3084,0,0,1,1,0.0%,7m
14569,1,[SURR]elHuron,3084,0,0,1,1,0.0%,17m
14569,1,tuziko,3084,0,0,2,2,0.0%,8m
14569,1,ventel,3084,0,0,2,2,0.0%,8m
14569,1,Alchoo,3084,0,0,3,3,0.0%,21m
14604,1,KMH,3083,1542,61,50,111,55.0%,4m
14604,1,[PackrS]Philipozz,3083,1008,44,31,75,58.7%,11m
14604,1,[42069]RagnarDOOM,3083,756,30,27,57,52.6%,18m
14604,3,Kakashi,3083,290,13,7,20,65.0%,20m
14604,1,AspenCat,3083,341,12,8,20,60.0%,5m
14604,1,Darkness,3083,320,12,8,20,60.0%,22m
14604,1,Sokoma,3083,304,10,9,19,52.6%,17m
14604,1,[PИD]Clydefrog,3083,201,6,4,10,60.0%,15m
14604,1,Asava,3083,200,6,6,12,50.0%,25m
14604,1,EarnsTurns,3083,192,5,10,15,33.3%,12m
14604,1,tihon,3083,135,4,1,5,80.0%,15m
14604,1,VgetA,3083,0,4,1,5,80.0%,18m
14604,1,PyloN,3083,125,4,3,7,57.1%,5m
14604,1,dugi,3083,128,3,1,4,75.0%,7m
14604,1,dani,3083,82,2,3,5,40.0%,15m
14604,1,Misanthrope,3083,38,1,3,4,25.0%,20m
14604,3,Reydum,3083,30,1,8,9,11.1%,3m
14604,1,Marso,3083,0,0,5,5,0.0%,4m
14604,1,herrhallay,3083,0,0,5,5,0.0%,2m
14623,1,soza,3082,1701,270,257,527,51.2%,3m
14623,3,Jey,3082,1541,220,204,424,51.9%,7m
14623,1,ExileTrooper,3082,1530,187,154,341,54.8%,14m
14623,1,[GdAT]Righteousnes,3082,1573,106,86,192,55.2%,20m
14623,1,[ClDlN]TotalBWord,3082,1170,51,36,87,58.6%,2m
14623,1,RAILGUN,3082,494,18,13,31,58.1%,20m
14623,3,Chesterito,3082,346,15,12,27,55.6%,8m
14623,1,[UstPRo]Hemoglobina,3082,163,4,4,8,50.0%,11m
14623,1,Lord,3082,112,4,7,11,36.4%,2m
14623,2,ProtoBieber,3082,118,3,2,5,60.0%,1h
14623,1,BTBT,3082,0,3,2,5,60.0%,1h
14623,3,SiMkE,3082,0,3,3,6,50.0%,1h
14623,1,MuaDib,3082,0,1,2,3,33.3%,2m
14623,1,rightTWIX,3082,0,1,3,4,25.0%,12m
14623,1,lazarius,3082,0,0,1,1,0.0%,23m
14638,1,bcluster,3081,1751,404,386,790,51.1%,5m
14638,1,LightVader,3081,617,33,14,47,70.2%,18m
14638,1,WallSky,3081,392,21,4,25,84.0%,20m
14638,1,eduardolobre,3081,372,11,10,21,52.4%,25m
14638,1,SlizZeR,3081,258,10,6,16,62.5%,33m
14638,1,Jodine,3081,245,9,8,17,52.9%,18m
14638,1,CyTeHePMambI,3081,218,9,8,17,52.9%,2m
14638,3,biverVs,3081,255,9,11,20,45.0%,10m
14638,3,Kumbaz,3081,229,7,9,16,43.8%,12m
14638,1,Loss,3081,48,3,3,6,50.0%,46m
14638,1,[Specii]MegaBiteHUN,3081,86,2,5,7,28.6%,2m
14638,3,EMV,3081,97,2,5,7,28.6%,30m
14638,1,ichyron,3081,0,1,0,1,100.0%,2m
14638,3,[SAW50]ApelsinchiK,3081,0,1,2,3,33.3%,2m
14638,1,Glipchik,3081,0,0,1,1,0.0%,15m
14638,1,Gideon,3081,0,0,1,1,0.0%,21m
14638,1,SuMu,3081,0,0,1,1,0.0%,23m
14638,1,BlackMichel,3081,0,0,3,3,0.0%,14m
14656,3,BendDown,3080,1429,356,361,717,49.7%,7m
14656,1,DaKar,3080,1647,152,142,294,51.7%,4m
14656,3,[13g12p]Thor,3080,1062,120,121,241,49.8%,2m
14656,1,rubbishskata,3080,1279,64,50,114,56.1%,14m
14656,1,Jowkasta,3080,606,27,15,42,64.3%,3m
14656,1,DimidTos,3080,370,17,9,26,65.4%,22m
14656,1,ArtemBublik,3080,341,11,7,18,61.1%,2m
14656,1,[CaCS]Laetot,3080,231,11,9,20,55.0%,25m
14656,3,Leer,3080,212,7,21,28,25.0%,8m
14656,3,potato,3080,146,6,3,9,66.7%,2m
14656,1,TaRKuS,3080,222,6,7,13,46.2%,17m
14656,1,KEk,3080,160,6,8,14,42.9%,8m
14656,1,[WzD]CFAJAuPOLSKA,3080,218,6,10,16,37.5%,21m
14656,1,[EandK]Frimen,3080,148,4,5,9,44.4%,9m
14656,1,sibko,3080,89,2,0,2,100.0%,10m
14656,1,Basic,3080,0,1,0,1,100.0%,16m
14656,1,Fenix,3080,0,1,0,1,100.0%,25m
14656,1,IIIIIIIIIIII,3080,0,1,0,1,100.0%,8m
14656,1,[FiDrag]mercedon,3080,38,1,3,4,25.0%,17m
14656,1,soso,3080,88,1,5,6,16.7%,4m
14656,1,NqqNqq,3080,0,0,1,1,0.0%,18m
14656,1,[RBP3]Revrend,3080,0,0,1,1,0.0%,22m
14656,3,DrEvil,3080,0,0,1,1,0.0%,22m
14656,1,Woz,3080,0,0,2,2,0.0%,18m
14656,1,mookitz,3080,0,0,2,2,0.0%,21m
14681,1,Saúl,3079,1648,181,168,349,51.9%,23m
14681,1,Dobro,3079,1727,151,137,288,52.4%,18m
14681,1,Wubi,3079,1727,122,108,230,53.0%,12m
14681,1,Avade,3079,1514,69,61,130,53.1%,14m
14681,3,Regina,3079,916,38,40,78,48.7%,10m
14681,1,Glenn,3079,538,16,17,33,48.5%,10m
14681,3,dyesub,3079,416,15,21,36,41.7%,16m
14681,3,[TeVoid]gforce,3079,294,11,17,28,39.3%,22m
14681,1,benji,3079,298,9,10,19,47.4%,15m
14681,1,[69x69]krasi,3079,207,7,4,11,63.6%,10m
14681,2,КтоТам,3079,150,7,6,13,53.8%,36m
14681,3,Sjoof,3079,210,6,4,10,60.0%,8m
14681,1,Kodie,3079,234,6,9,15,40.0%,11m
14681,1,KROKSYMAN,3079,0,5,0,5,100.0%,39m
14681,1,Perian,3079,154,5,1,6,83.3%,8m
14681,1,FEAR,3079,202,5,3,8,62.5%,15m
14681,1,[HОW]Slaan,3079,152,5,4,9,55.6%,25m
14681,1,WayTeh,3079,148,4,10,14,28.6%,21m
14681,1,VerseUni,3079,131,2,4,6,33.3%,2m
14681,1,Serenthys,3079,0,1,0,1,100.0%,1h
14681,1,JuzTosS,3079,0,1,3,4,25.0%,7m
14681,2,Stallion,3079,0,0,1,1,0.0%,32m
14681,1,dasda,3079,0,0,1,1,0.0%,5m
14681,1,villegas,3079,0,0,2,2,0.0%,8m
14705,2,Terranova,3078,1546,496,510,1006,49.3%,17m
14705,3,Kalmarian,3078,1379,146,144,290,50.3%,19m
14705,1,[NLTN]PELOLACEO,3078,795,44,43,87,50.6%,17m
14705,3,Newnew,3078,620,40,38,78,51.3%,2m
14705,1,WarMachine,3078,702,38,21,59,64.4%,6m
14705,1,[PandaQ]mobmob,3078,311,25,15,40,62.5%,2m
14705,3,Brainshack,3078,335,20,21,41,48.8%,13m
14705,3,[TaqT]Aadera,3078,482,17,26,43,39.5%,8m
14705,1,cedlabalbis,3078,313,11,7,18,61.1%,3m
14705,3,Chebyrec,3078,280,10,16,26,38.5%,12m
14705,1,[13NRV]Fear,3078,275,9,4,13,69.2%,2m
14705,1,Guzi,3078,216,8,8,16,50.0%,10m
14705,1,[Ирбис]TROLLZZZZZZ,3078,119,4,0,4,100.0%,4m
14705,1,[КПІ]Dragon,3078,176,4,3,7,57.1%,20m
14705,1,[DemuCl]rhoeb,3078,109,3,0,3,100.0%,21m
14705,1,Koc,3078,0,3,1,4,75.0%,1h
14705,1,Defstrouk,3078,80,3,5,8,37.5%,4m
14705,1,[CNNB]Throne,3078,89,2,0,2,100.0%,20m
14705,1,ExCellRaD,3078,0,2,3,5,40.0%,18m
14705,1,Shatterer,3078,0,1,0,1,100.0%,19m
14705,3,amityIGismo,3078,30,1,14,15,6.7%,7m
14705,1,SkeleCore,3078,0,0,1,1,0.0%,20m
14705,1,NOXON,3078,0,0,2,2,0.0%,22m
14728,3,Nikolay,3077,1358,306,285,591,51.8%,9m
14728,3,zwzxs,3077,725,286,284,570,50.2%,12m
14728,1,[RIZY]ЗлойПингвин,3077,1662,217,202,419,51.8%,5m
14728,1,rabbied,3077,647,146,132,278,52.5%,5m
14728,1,hhhhh,3077,1347,55,53,108,50.9%,22m
14728,3,Arktischer,3077,791,46,47,93,49.5%,5m
14728,3,nursak,3077,1106,44,49,93,47.3%,8m
14728,3,Fantom,3077,519,23,21,44,52.3%,5m
14728,1,[Inval]Hisk,3077,390,15,11,26,57.7%,20m
14728,1,Hagbard,3077,455,15,13,28,53.6%,11m
14728,1,[Waste]spucky,3077,388,14,8,22,63.6%,15m
14728,1,Helloween,3077,464,14,13,27,51.9%,18m
14728,1,TacoTruck,3077,126,6,4,10,60.0%,25m
14728,1,Immazi,3077,0,4,1,5,80.0%,5m
14728,1,Koт,3077,48,4,2,6,66.7%,16m
14728,2,Stang,3077,116,3,0,3,100.0%,11m
14728,1,Starfighter,3077,0,3,1,4,75.0%,1h
14728,1,[ToSSer]akakasei,3077,76,3,2,5,60.0%,17m
14728,1,[2KY]Keer,3077,88,3,2,5,60.0%,11m
14728,1,[BetAlf]BlackSheep,3077,0,2,3,5,40.0%,1h
14728,1,[GAMI]Trix,3077,68,2,7,9,22.2%,17m
14728,1,Timmeh,3077,0,0,1,1,0.0%,7m
14750,3,[Zeggg]Mojo,3076,1378,136,141,277,49.1%,20m
14750,1,[BAAR]bare,3076,1578,130,104,234,55.6%,25m
14750,3,triggertoo,3076,1419,66,61,127,52.0%,15m
14750,1,JoeChip,3076,1071,45,32,77,58.4%,20m
14750,1,DigitalEnemy,3076,1034,38,29,67,56.7%,20m
14750,1,[Xa]SoupLie,3076,797,36,19,55,65.5%,2m
14750,1,mutaxe,3076,671,25,19,44,56.8%,21m
14750,1,Ayatsuru,3076,290,10,8,18,55.6%,2m
14750,1,[JBPs]saneb,3076,245,8,5,13,61.5%,22m
14750,1,psy,3076,152,5,1,6,83.3%,12m
14750,3,Tomaster,3076,97,5,2,7,71.4%,24m
14750,1,EtiquetteMan,3076,122,5,3,8,62.5%,40m
14750,1,[N1NJ4Z]MrKey,3076,154,5,6,11,45.5%,19m
14750,1,said,3076,110,4,3,7,57.1%,21m
14750,1,pansit,3076,124,4,9,13,30.8%,10m
14750,1,Krak,3076,76,2,4,6,33.3%,15m
14750,1,Foulplay,3076,97,2,9,11,18.2%,4m
14750,1,Ubertuba,3076,42,1,2,3,33.3%,3m
14750,1,[AkBars]Chipmunk,3076,0,0,1,1,0.0%,23m
14769,1,DartVader,3075,1577,360,321,681,52.9%,25m
14769,1,MooseChild,3075,1392,141,135,276,51.1%,8m
14769,3,MonkeY,3075,1387,94,90,184,51.1%,5m
14769,3,Itachi,3075,838,61,60,121,50.4%,25m
14769,1,GroNourS,3075,1296,45,45,90,50.0%,15m
14769,1,Gamaraf,3075,305,29,18,47,61.7%,18m
14769,1,[profit]barabaka,3075,609,22,16,38,57.9%,19m
14769,1,Asand,3075,624,21,19,40,52.5%,22m
14769,1,KingCROmson,3075,281,12,4,16,75.0%,25m
14769,1,SweatyNick,3075,310,11,10,21,52.4%,7m
14769,1,[OGCt]Tecondrus,3075,406,11,15,26,42.3%,12m
14769,1,[JMCM]nicoLeffe,3075,189,9,5,14,64.3%,22m
14769,3,[ValidG]Leo,3075,58,5,6,11,45.5%,9m
14769,1,VespineOil,3075,40,2,1,3,66.7%,15m
14769,1,[tVal]OctoValkyrie,3075,40,2,1,3,66.7%,4m
14769,1,PJB,3075,42,2,4,6,33.3%,3m
14769,1,[MST]Prometheus,3075,0,1,0,1,100.0%,8m
14769,1,[ICGl]xTreame,3075,38,1,2,3,33.3%,15m
14769,1,[Moisty]Latah,3075,0,1,3,4,25.0%,10m
14788,3,CptRetard,3074,572,168,179,347,48.4%,19m
14788,3,Toughn,3074,1513,118,114,232,50.9%,2m
14788,3,PlayerTwo,3074,1055,96,99,195,49.2%,15m
14788,1,KROKO,3074,1501,90,84,174,51.7%,12m
14788,3,knallentin,3074,644,35,44,79,44.3%,12m
14788,3,Rossi,3074,329,13,9,22,59.1%,15m
14788,1,[OwOOwO]Krishn,3074,307,9,6,15,60.0%,11m
14788,3,Миша,3074,208,9,8,17,52.9%,11m
14788,3,[naxer]Kan,3074,280,9,16,25,36.0%,10m
14788,1,СССP,3074,106,2,1,3,66.7%,22m
14788,1,[ZЕRGТV]MadE,3074,88,1,1,2,50.0%,9m
14788,1,[AiRǂ]Warf,3074,0,1,2,3,33.3%,5m
14788,1,Rock,3074,0,1,5,6,16.7%,15m
14788,3,Hyperion,3074,0,0,1,1,0.0%,26m
14788,1,Бывалый,3074,0,0,1,1,0.0%,22m
14788,1,Moogiwar,3074,0,0,1,1,0.0%,4m
14788,3,Christoph,3074,0,0,6,6,0.0%,22m
14805,1,[DEDAL]darxx,3073,1529,150,106,256,58.6%,11m
14805,1,LarryMcfly,3073,1342,63,41,104,60.6%,11m
14805,3,[Rakii]upoltned,3073,391,45,43,88,51.1%,10m
14805,3,[XIØI]Filgaite,3073,1176,44,51,95,46.3%,3m
14805,3,[WBever]Jelljel,3073,559,31,24,55,56.4%,5m
14805,3,SuperMichel,3073,221,31,36,67,46.3%,25m
14805,1,Googulag,3073,493,19,16,35,54.3%,11m
14805,1,Vildhjarta,3073,416,14,20,34,41.2%,17m
14805,1,zZz,3073,372,11,13,24,45.8%,25m
14805,1,TeamHoneyBee,3073,314,10,5,15,66.7%,11m
14805,1,[BrDz]AsetRadol,3073,223,10,7,17,58.8%,22m
14805,1,Trak,3073,194,8,5,13,61.5%,11m
14805,3,GrekSJ,3073,170,7,4,11,63.6%,10m
14805,1,japoniukas,3073,48,5,1,6,83.3%,41m
14805,1,conclusus,3073,120,5,3,8,62.5%,12m
14805,1,Lulo,3073,106,5,6,11,45.5%,15m
14805,1,[FyH]SrOnO,3073,0,4,1,5,80.0%,29m
14805,1,keepitroyal,3073,48,3,3,6,50.0%,1h
14805,1,llllllllllll,3073,0,1,0,1,100.0%,15m
14805,3,[ĦRZ]FrOzTrAl,3073,30,1,1,2,50.0%,19m
14805,1,Sibe,3073,0,1,2,3,33.3%,15m
14805,1,[Z3RG7V]ROVVIT,3073,42,1,2,3,33.3%,14m
14805,3,[ais]Mantra,3073,30,1,8,9,11.1%,16m
14805,1,Toast,3073,0,0,1,1,0.0%,15m
14805,1,[ter0R]AnimalRights,3073,0,0,3,3,0.0%,9m
14830,1,StrawberryJu,3072,1650,198,192,390,50.8%,6m
14830,3,HDH,3072,1295,172,161,333,51.7%,15m
14830,1,DunkanZmey,3072,1376,96,86,182,52.7%,5m
14830,3,Fluffy,3072,1446,60,65,125,48.0%,13m
14830,3,Ignis,3072,1092,59,54,113,52.2%,22m
14830,1,Nerot,3072,619,23,16,39,59.0%,22m
14830,1,Asti,3072,592,22,19,41,53.7%,5m
14830,3,tehpwnrer,3072,463,21,16,37,56.8%,12m
14830,1,[Rofled]Adahmar,3072,532,19,13,32,59.4%,12m
14830,1,HelioStormx,3072,509,16,21,37,43.2%,11m
14830,3,[Sarmat]MissCaVeiRa,3072,446,15,21,36,41.7%,9m
14830,1,Eunar,3072,327,14,7,21,66.7%,12m
14830,1,KoshNaranek,3072,404,14,16,30,46.7%,9m
14830,3,[DFYIII]Tta,3072,297,13,12,25,52.0%,19m
14830,1,[HBGSJR]ReMinDeR,3072,122,4,1,5,80.0%,18m
14830,1,Hufflepuff,3072,160,4,6,10,40.0%,2m
14830,1,[Yedaz]grumpyelf,3072,0,2,2,4,50.0%,18m
14830,1,[BMDR]HoeBag,3072,40,2,3,5,40.0%,7m
14830,1,Malvin,3072,90,1,1,2,50.0%,7m
14830,3,IsaacClarke,3072,0,0,1,1,0.0%,17m
14830,1,Samiimov,3072,0,0,6,6,0.0%,20m
14851,3,[McCh]Elk,3071,1582,191,189,380,50.3%,20m
14851,1,AgentSmith,3071,1494,78,37,115,67.8%,25m
14851,1,Pechka,3071,1589,78,71,149,52.3%,19m
14851,1,ANARCHY,3071,1037,44,43,87,50.6%,5m
14851,1,gambit,3071,833,43,41,84,51.2%,4m
14851,1,andy,3071,804,38,33,71,53.5%,15m
14851,3,Itilorin,3071,254,35,42,77,45.5%,5m
14851,3,Cybersnake,3071,98,29,29,58,50.0%,16m
14851,3,MrRedder,3071,798,29,37,66,43.9%,7m
14851,1,DooM,3071,725,28,23,51,54.9%,15m
14851,1,KrekeN,3071,700,24,19,43,55.8%,2m
14851,3,Nattvasen,3071,639,24,23,47,51.1%,25m
14851,3,[RUSMÜL]FONGUY,3071,249,20,28,48,41.7%,16m
14851,1,WOSHIXIEXING,3071,274,14,5,19,73.7%,9m
14851,1,Malak,3071,356,14,10,24,58.3%,5m
14851,1,theBEAN,3071,420,12,12,24,50.0%,19m
14851,1,slycooler,3071,250,9,6,15,60.0%,15m
14851,1,siner,3071,214,7,3,10,70.0%,15m
14851,2,Alex,3071,145,6,4,10,60.0%,35m
14851,1,Byun,3071,148,6,4,10,60.0%,3m
14851,1,[сSсǃ]ToxicTerran,3071,222,6,6,12,50.0%,8m
14851,3,[Gurken]Primagen,3071,232,6,12,18,33.3%,11m
14851,1,[NWGD]illia,3071,236,6,13,19,31.6%,23m
14851,1,Beeblebrox,3071,194,5,9,14,35.7%,21m
14851,1,[lOY]JcNOvA,3071,140,4,2,6,66.7%,19m
14851,1,BloodAngel,3071,88,4,2,6,66.7%,11m
14851,1,LarsSloth,3071,105,3,0,3,100.0%,22m
14851,1,Mobacca,3071,0,3,0,3,100.0%,19m
14851,1,[LОLI]DOSOCHKA,3071,0,3,2,5,60.0%,15m
14851,1,Хануман,3071,91,2,0,2,100.0%,9m
14851,1,Dar,3071,90,2,0,2,100.0%,18m
14851,1,Odysseus,3071,78,2,5,7,28.6%,20m
14851,1,ictleader,3071,0,1,0,1,100.0%,23m
14851,1,Lunatic,3071,0,1,0,1,100.0%,21m
14851,1,Chaudevant,3071,89,1,1,2,50.0%,17m
14851,1,Lundström,3071,0,1,2,3,33.3%,12m
14851,1,[tH]Takushin,3071,0,0,1,1,0.0%,3m
14888,3,BannedSCV,3070,732,185,174,359,51.5%,9m
14888,1,SonicBoom,3070,1245,151,148,299,50.5%,2m
14888,1,[IRFM]Aizen,3070,624,27,18,45,60.0%,12m
14888,1,[ITINF]Drunkenfish,3070,702,25,23,48,52.1%,8m
14888,3,[ГРУЗИН]Tassadar,3070,441,18,16,34,52.9%,2m
14888,1,BlackNeedle,3070,531,18,20,38,47.4%,25m
14888,1,TheBasketwin,3070,346,15,11,26,57.7%,18m
14888,1,[Ultrа]aquarius,3070,386,15,11,26,57.7%,21m
14888,1,[lOoOl]TEPPOPUCT,3070,350,10,8,18,55.6%,20m
14888,3,IIIIIIIIIIII,3070,155,7,7,14,50.0%,21m
14888,3,[ICGl]IceColdBear,3070,170,4,6,10,40.0%,5m
14888,2,[Neewbe]Boxer,3070,42,2,3,5,40.0%,40m
14888,3,yeti,3070,0,1,1,2,50.0%,5m
14888,2,iPood,3070,0,1,2,3,33.3%,44m
14888,1,Senpai,3070,38,1,2,3,33.3%,23m
14903,3,[Bwolfs]Advokatessa,3069,1454,131,126,257,51.0%,9m
14903,1,Frede,3069,681,119,102,221,53.8%,23m
14903,1,lolLizard,3069,1393,100,70,170,58.8%,11m
14903,1,Ellumination,3069,1088,82,58,140,58.6%,12m
14903,1,RadioForce,3069,1429,70,60,130,53.8%,15m
14903,1,ChrzCTZ,3069,1573,65,56,121,53.7%,23m
14903,1,JulyanBro,3069,600,56,54,110,50.9%,21m
14903,1,[THP]PLGaMo,3069,746,34,19,53,64.2%,22m
14903,1,lusifer,3069,877,34,24,58,58.6%,3m
14903,3,[GBrM]NoZaLiTh,3069,584,25,24,49,51.0%,19m
14903,1,Lofty,3069,812,25,25,50,50.0%,18m
14903,3,BruceLee,3069,562,21,25,46,45.7%,20m
14903,3,Huchira,3069,411,17,20,37,45.9%,14m
14903,1,[Aggri]TheExile,3069,446,14,12,26,53.8%,21m
14903,3,Haxdelete,3069,97,4,3,7,57.1%,18m
14903,1,Reynor,3069,105,3,1,4,75.0%,17m
14903,1,[bdcm]Japko,3069,34,2,3,5,40.0%,15m
14903,1,Gets,3069,0,0,1,1,0.0%,15m
14903,1,HenryB,3069,0,0,1,1,0.0%,3m
14903,1,Machrix,3069,0,0,1,1,0.0%,15m
14903,1,CrazyZ,3069,0,0,1,1,0.0%,20m
14903,2,Nejdanchik,3069,0,0,1,1,0.0%,1h
14925,1,DitroX,3068,1066,92,73,165,55.8%,23m
14925,3,Zivian,3068,804,60,59,119,50.4%,8m
14925,1,RukPro,3068,1182,50,40,90,55.6%,21m
14925,3,KUBES,3068,1356,48,56,104,46.2%,16m
14925,1,Deadmike,3068,1146,47,36,83,56.6%,23m
14925,1,[TRPZ]Rip,3068,602,25,21,46,54.3%,23m
14925,1,Aries,3068,636,22,17,39,56.4%,25m
14925,1,Отлетаешь,3068,308,20,3,23,87.0%,15m
14925,1,okkokk,3068,296,19,15,34,55.9%,11m
14925,1,Remus,3068,216,7,8,15,46.7%,5m
14925,1,kenthtus,3068,225,7,9,16,43.8%,23m
14925,1,[NaCl6]DrZoidberg,3068,185,5,4,9,55.6%,15m
14925,3,myZei,3068,184,4,2,6,66.7%,23m
14925,2,DeepSnow,3068,140,3,8,11,27.3%,43m
14925,1,zeta,3068,88,2,4,6,33.3%,4m
14925,1,lookaround,3068,0,1,0,1,100.0%,11m
14925,3,VioletStorm,3068,0,1,0,1,100.0%,15m
14925,1,Satellizer,3068,0,0,1,1,0.0%,46m
14925,1,tazadar,3068,73,0,2,2,0.0%,4m
14944,3,[ABOMB]FatMan,3067,1391,124,119,243,51.0%,10m
14944,1,ARzR,3067,863,114,98,212,53.8%,25m
14944,1,Ignat,3067,1012,45,32,77,58.4%,23m
14944,1,[KhSo]Pierre,3067,1113,38,36,74,51.4%,15m
14944,1,[LEZZO]parafinìco,3067,879,32,24,56,57.1%,20m
14944,1,stsmrnv,3067,825,30,25,55,54.5%,9m
14944,2,[ZMP]Frezy,3067,507,19,15,34,55.9%,4m
14944,1,Mishka,3067,422,12,16,28,42.9%,5m
14944,1,JoniKanoni,3067,328,9,11,20,45.0%,8m
14944,2,Atos,3067,182,6,5,11,54.5%,21m
14944,1,Kamalalala,3067,134,4,1,5,80.0%,11m
14944,2,TLA,3067,30,4,2,6,66.7%,22m
14944,2,Hunter,3067,0,4,3,7,57.1%,1h
14944,1,RektByDirt,3067,95,4,4,8,50.0%,23m
14944,1,ReD,3067,126,3,1,4,75.0%,7m
14944,1,Crom,3067,36,2,2,4,50.0%,3m
14944,1,WitPxl,3067,0,1,0,1,100.0%,15m
14944,2,BEbnataGDeep,3067,32,1,1,2,50.0%,15m
14944,1,Ønłce,3067,0,0,1,1,0.0%,5m
14944,3,Dspio,3067,0,0,1,1,0.0%,22m
14944,1,Ados,3067,0,0,3,3,0.0%,11m
14965,3,[PÂRłAH]VLKadlok,3066,1511,159,166,325,48.9%,9m
14965,3,YLibelluleG,3066,876,101,99,200,50.5%,4m
14965,1,llllllllllll,3066,1033,50,25,75,66.7%,2m
14965,1,ClayWaifu,3066,1138,49,36,85,57.6%,8m
14965,3,Ilskog,3066,862,30,36,66,45.5%,7m
14965,1,FroggyClyde,3066,264,22,23,45,48.9%,8m
14965,1,Antho,3066,405,18,9,27,66.7%,10m
14965,2,[oreo]foolyjay,3066,405,17,6,23,73.9%,8m
14965,1,[CieNT]BotEllis,3066,359,17,7,24,70.8%,22m
14965,1,Nerzhul,3066,322,15,11,26,57.7%,8m
14965,1,newby,3066,195,14,7,21,66.7%,15m
14965,1,[Jeth]Raptor,3066,351,13,10,23,56.5%,2m
14965,1,Cortex,3066,272,11,8,19,57.9%,12m
14965,1,ZikaKenobi,3066,228,10,7,17,58.8%,1h
14965,2,ozankozak,3066,200,7,4,11,63.6%,20m
14965,1,Fogs,3066,263,7,6,13,53.8%,11m
14965,1,gerwulf,3066,150,5,7,12,41.7%,19m
14965,1,[D0N3]Pacselly,3066,100,3,4,7,42.9%,23m
14965,1,[VETAN]baga,3066,40,2,3,5,40.0%,2m
14965,1,Radi,3066,70,2,6,8,25.0%,4m
14965,2,Lukisha,3066,0,1,0,1,100.0%,17m
14965,2,Антоний,3066,36,1,1,2,50.0%,22m
14965,1,Thunder,3066,40,1,4,5,20.0%,6m
14965,2,artofwar,3066,0,0,1,1,0.0%,17m
14965,2,[Mergel]Wigglos,3066,0,0,1,1,0.0%,5m
14990,3,MGUPCHIEN,3065,1462,182,169,351,51.9%,2m
14990,1,DmRune,3065,1374,140,120,260,53.8%,18m
14990,1,IsoMurmeli,3065,1712,113,99,212,53.3%,23m
14990,3,Vice,3065,785,99,93,192,51.6%,14m
14990,2,[JOPAKK]HgAg,3065,1076,47,63,110,42.7%,23m
14990,3,[yedi]DirkDiggler,3065,782,27,38,65,41.5%,19m
14990,1,IIIIIIIII,3065,335,12,8,20,60.0%,7m
14990,2,Cohomology,3065,310,11,3,14,78.6%,11m
14990,1,LTA,3065,259,9,8,17,52.9%,7m
14990,2,BARCODE,3065,126,7,5,12,58.3%,5m
14990,3,[UHSF]Egorische,3065,97,6,1,7,85.7%,31m
14990,1,Memsen,3065,90,5,2,7,71.4%,3m
14990,2,MMSmith,3065,112,4,1,5,80.0%,7m
14990,1,Pepperoni,3065,91,4,4,8,50.0%,10m
14990,2,Pizza,3065,111,3,2,5,60.0%,32m
14990,1,JAXX,3065,89,2,1,3,66.7%,10m
14990,1,EnkiVritra,3065,38,2,3,5,40.0%,15m
14990,2,Strong,3065,46,2,6,8,25.0%,44m
14990,2,TJbehemoth,3065,0,1,0,1,100.0%,1h
14990,1,[ЗЕRGТV]Исус,3065,0,1,1,2,50.0%,5m
14990,2,tcgort,3065,88,1,4,5,20.0%,17m
14990,2,[D0N]Dømïñâtœr,3065,30,1,5,6,16.7%,11m
15012,1,SuperSNA,3064,1256,195,188,383,50.9%,5m
15012,3,SCOUSER,3064,1444,152,151,303,50.2%,20m
15012,1,[WhoDa]evilme,3064,1515,120,114,234,51.3%,12m
15012,3,[F3N]Dragoon,3064,1483,81,66,147,55.1%,22m
15012,1,[Gøsu]ĐiamondĐrop,3064,433,33,9,42,78.6%,21m
15012,1,MarineKing,3064,356,11,15,26,42.3%,20m
15012,1,LaKalaSH,3064,306,9,12,21,42.9%,8m
15012,2,elmono,3064,136,7,1,8,87.5%,23m
15012,1,[5Z]Katakras,3064,225,5,6,11,45.5%,7m
15012,1,Breem,3064,146,4,2,6,66.7%,7m
15012,1,BajszosSzar,3064,0,4,2,6,66.7%,15m
15012,1,Enik,3064,160,4,3,7,57.1%,25m
15012,1,DaPertl,3064,116,4,4,8,50.0%,10m
15012,1,[doggge]Peshko,3064,154,4,8,12,33.3%,21m
15012,3,[Noyce]ecruos,3064,62,3,9,12,25.0%,9m
15012,3,[MvN]Hugo,3064,0,0,1,1,0.0%,8m
15012,2,BerengoFF,3064,0,0,1,1,0.0%,2m
15012,1,AspireGlobal,3064,0,0,3,3,0.0%,8m
15030,2,SPQRCaesar,3063,1672,240,213,453,53.0%,4m
15030,3,[InitRu]Magvaer,3063,1484,184,170,354,52.0%,15m
15030,1,Pinerrone,3063,1150,173,151,324,53.4%,12m
15030,3,nastyBee,3063,1045,169,163,332,50.9%,22m
15030,1,Scar,3063,1556,104,99,203,51.2%,12m
15030,3,debussy,3063,1375,86,90,176,48.9%,5m
15030,1,Naviester,3063,1672,72,55,127,56.7%,4m
15030,1,Asrei,3063,757,32,24,56,57.1%,2m
15030,1,HOTdog,3063,361,14,12,26,53.8%,23m
15030,1,Braudel,3063,290,11,9,20,55.0%,21m
15030,1,Rahvin,3063,334,10,11,21,47.6%,15m
15030,2,[TPcs]SETTO,3063,116,7,4,11,63.6%,43m
15030,1,LeatherFace,3063,270,7,13,20,35.0%,4m
15030,3,Esso,3063,145,6,2,8,75.0%,1h
15030,1,[MIÉRT]VengirPlays,3063,182,5,7,12,41.7%,17m
15030,1,[PRBJC]Gerkogan,3063,141,4,4,8,50.0%,29m
15030,2,FLIMBLI,3063,0,3,2,5,60.0%,17m
15030,2,MACO,3063,95,3,4,7,42.9%,1h
15030,1,Pucha,3063,0,1,4,5,20.0%,1h
15030,2,[DAÖ]SpeEdOr,3063,0,0,1,1,0.0%,14m
15050,3,ТФК,3062,944,233,191,424,55.0%,14m
15050,1,Overview,3062,1654,170,158,328,51.8%,20m
15050,3,[SPAINs]Romu,3062,814,107,99,206,51.9%,18m
15050,1,sensei,3062,1379,82,76,158,51.9%,8m
15050,2,[Z3R9]Näx,3062,1649,65,62,127,51.2%,15m
15050,3,SpiderCochon,3062,1092,45,40,85,52.9%,9m
15050,3,Pellegri,3062,742,25,38,63,39.7%,21m
15050,2,Jetelgeuse,3062,492,19,12,31,61.3%,20m
15050,3,PHiL,3062,472,18,24,42,42.9%,17m
15050,1,Furexus,3062,488,14,13,27,51.9%,20m
15050,1,Szatki,3062,317,13,7,20,65.0%,15m
15050,1,[NS2019]Alariy,3062,386,12,15,27,44.4%,2m
15050,2,AndreySt,3062,312,11,4,15,73.3%,7m
15050,1,Pushnoi,3062,198,7,3,10,70.0%,6m
15050,3,[VLDLOX]JackCollins,3062,44,5,3,8,62.5%,5m
15050,1,Avery,3062,82,3,3,6,50.0%,15m
15050,1,DougSluggins,3062,162,3,5,8,37.5%,25m
15050,1,Funny,3062,106,2,2,4,50.0%,22m
15050,3,Jalexo,3062,0,2,3,5,40.0%,1h
15050,2,[G52]DEDMazdaj,3062,0,2,4,6,33.3%,37m
15050,2,[KaPD]sittich,3062,0,0,1,1,0.0%,14m
15050,2,Advanced,3062,0,0,1,1,0.0%,7m
15050,2,Mathcain,3062,0,0,1,1,0.0%,14m
15050,2,zeRa,3062,0,0,1,1,0.0%,7m
15050,2,bre,3062,0,0,1,1,0.0%,1h
15050,1,Jupyter,3062,0,0,2,2,0.0%,8m
15076,1,Teutomar,3061,1732,664,665,1329,50.0%,12m
15076,1,[AiRǂ]texh,3061,1446,249,222,471,52.9%,3m
15076,3,npyt,3061,1497,169,156,325,52.0%,17m
15076,1,Yanuko,3061,1127,49,43,92,53.3%,25m
15076,2,Billy,3061,574,24,17,41,58.5%,25m
15076,3,[MeDuS]xjaponiukas,3061,565,23,21,44,52.3%,3m
15076,1,PooopTroper,3061,405,17,14,31,54.8%,18m
15076,3,TossIsZeroIQ,3061,422,14,31,45,31.1%,14m
15076,1,[GaMToX]TaKMashido,3061,420,13,15,28,46.4%,18m
15076,1,[TedB]Sirogaval,3061,432,13,16,29,44.8%,5m
15076,1,IIIIIIIIIIII,3061,0,4,1,5,80.0%,10m
15076,2,[BAC0N]TerrorPrime,3061,32,1,1,2,50.0%,19m
15076,2,Rilneph,3061,34,1,1,2,50.0%,7m
15076,1,krakanhakan,3061,0,1,3,4,25.0%,11m
15076,1,Mark,3061,0,1,3,4,25.0%,22m
15076,1,Dremered,3061,73,0,4,4,0.0%,4m
15092,3,RAOUL,3060,1625,281,274,555,50.6%,23m
15092,2,Ocin,3060,1656,86,69,155,55.5%,4m
15092,3,DeadInside,3060,815,65,48,113,57.5%,25m
15092,2,Bolo,3060,1111,64,13,77,83.1%,18m
15092,1,Steve,3060,787,64,50,114,56.1%,15m
15092,2,TheQ,3060,964,57,46,103,55.3%,23m
15092,2,Asnofyx,3060,1109,44,35,79,55.7%,19m
15092,1,[CAMW]Sandr,3060,661,24,19,43,55.8%,25m
15092,2,EazyE,3060,253,10,0,10,100.0%,25m
15092,1,kostyashka,3060,258,8,8,16,50.0%,20m
15092,2,Camper,3060,58,5,3,8,62.5%,22m
15092,3,[BSAU]OBeLisk,3060,121,5,3,8,62.5%,1h
15092,1,AbRAjOn,3060,74,3,3,6,50.0%,20m
15092,2,Iposnitus,3060,32,1,1,2,50.0%,3m
15092,1,[БУБУБ]mmrGendarme,3060,97,1,2,3,33.3%,40m
15092,1,Sham,3060,48,1,5,6,16.7%,1h
15108,3,BOLIS,3059,1553,541,547,1088,49.7%,21m
15108,1,chrisugru,3059,1601,244,237,481,50.7%,25m
15108,1,Kish,3059,1726,180,168,348,51.7%,23m
15108,1,Giovan,3059,1578,65,48,113,57.5%,11m
15108,1,Viggen,3059,420,50,49,99,50.5%,21m
15108,1,[Arrows]cyberlink,3059,954,35,32,67,52.2%,3m
15108,3,Belarus,3059,655,31,39,70,44.3%,22m
15108,1,wIxXoR,3059,808,29,27,56,51.8%,15m
15108,3,Ycuju,3059,534,22,21,43,51.2%,25m
15108,1,[GrPt]Рак,3059,532,20,15,35,57.1%,8m
15108,1,HiotV,3059,383,18,10,28,64.3%,3m
15108,1,wsbvn,3059,580,18,21,39,46.2%,20m
15108,1,[VuV]Lichtkrieger,3059,185,14,8,22,63.6%,7m
15108,1,Rimskiy,3059,320,10,10,20,50.0%,18m
15108,1,Yukinep,3059,210,9,5,14,64.3%,15m
15108,2,Xanthous,3059,96,5,3,8,62.5%,1h
15108,1,Eiker,3059,134,4,2,6,66.7%,15m
15108,1,[Ihanri]Егор,3059,97,4,2,6,66.7%,1h
15108,2,DieMFDie,3059,112,3,0,3,100.0%,17m
15108,3,Blade,3059,122,3,2,5,60.0%,12m
15108,1,CartoO,3059,0,3,2,5,60.0%,1h
15108,2,[KiKr]kieselbursch,3059,0,1,0,1,100.0%,12m
15108,2,Aristocrat,3059,0,1,0,1,100.0%,14m
15108,1,qba,3059,0,1,1,2,50.0%,18m
15108,1,BioMotor,3059,0,0,3,3,0.0%,4m
15133,2,Hamedtj,3058,1503,296,268,564,52.5%,15m
15133,1,[ProbKA]LeksBakr,3058,1715,171,161,332,51.5%,12m
15133,1,Kenetiz,3058,1246,142,124,266,53.4%,25m
15133,1,Wimpy,3058,993,67,55,122,54.9%,25m
15133,2,Spookie,3058,613,26,16,42,61.9%,10m
15133,2,SouldreamXe,3058,496,19,16,35,54.3%,3m
15133,3,[Pitw]Megamaou,3058,406,15,16,31,48.4%,22m
15133,2,[PÂRłAH]Adun,3058,194,7,4,11,63.6%,10m
15133,2,DaSwarm,3058,205,7,6,13,53.8%,9m
15133,3,[AsJRHD]Tutterbobs,3058,170,5,6,11,45.5%,2m
15133,2,[GGWPEZ]Wertual,3058,100,4,1,5,80.0%,22m
15133,3,[CoDeGG]TikTak,3058,120,3,3,6,50.0%,19m
15133,1,[OnNa]RaMu,3058,138,2,3,5,40.0%,36m
15133,3,[OXXXY]chvek,3058,97,2,3,5,40.0%,6m
15133,1,[GKR]Joker,3058,0,1,1,2,50.0%,17m
15133,2,Rufixme,3058,0,0,1,1,0.0%,3m
15133,2,ElArZaS,3058,0,0,1,1,0.0%,22m
15150,1,[aslick]KingMeistro,3057,1700,171,149,320,53.4%,9m
15150,1,[pukalk]Fargus,3057,1596,75,65,140,53.6%,3m
15150,1,Dragster,3057,628,20,19,39,51.3%,12m
15150,1,ARzR,3057,354,12,17,29,41.4%,18m
15150,1,SanguisAter,3057,286,11,9,20,55.0%,10m
15150,1,pemo,3057,184,8,2,10,80.0%,23m
15150,3,Вован,3057,202,7,17,24,29.2%,11m
15150,1,[КПCC]BrutaliskFan,3057,104,3,2,5,60.0%,23m
15150,2,[IHHI]SDX,3057,30,2,0,2,100.0%,2m
15150,1,Kritoforos,3057,38,2,5,7,28.6%,18m
15150,2,Mettigel,3057,0,1,0,1,100.0%,14m
15150,1,[Glor]Caesar,3057,0,1,1,2,50.0%,11m
15150,1,Dirindon,3057,34,1,3,4,25.0%,2m
15150,1,SuperGhost,3057,0,1,3,4,25.0%,19m
15150,3,Alex,3057,0,0,1,1,0.0%,8m
15150,2,snapperlure,3057,0,0,1,1,0.0%,4m
15150,1,ChaosAD,3057,0,0,2,2,0.0%,10m
15167,3,FoX,3056,694,31,28,59,52.5%,22m
15167,2,vAs,3056,470,17,11,28,60.7%,14m
15167,1,Ярослав,3056,523,16,17,33,48.5%,25m
15167,3,HobbyNerd,3056,274,10,16,26,38.5%,21m
15167,3,Feelgood,3056,217,8,8,16,50.0%,16m
15167,1,Yikes,3056,220,6,8,14,42.9%,15m
15167,1,[OFRO]Punishment,3056,66,5,2,7,71.4%,15m
15167,1,Piims,3056,139,5,2,7,71.4%,18m
15167,2,BlackFlame,3056,142,4,3,7,57.1%,4m
15167,3,Moromete,3056,0,3,2,5,60.0%,1h
15167,1,Hierarch,3056,74,3,3,6,50.0%,25m
15167,2,Gompli,3056,30,1,2,3,33.3%,22m
15179,3,PAOG,3055,1622,183,167,350,52.3%,15m
15179,3,mix,3055,1570,121,105,226,53.5%,18m
15179,2,[SPAINs]Kerberos,3055,1346,116,88,204,56.9%,23m
15179,2,Liu,3055,629,105,97,202,52.0%,15m
15179,3,Drovosek,3055,1160,103,75,178,57.9%,25m
15179,1,Karnax,3055,785,68,59,127,53.5%,4m
15179,2,Panicki,3055,1001,42,39,81,51.9%,17m
15179,1,vOlk,3055,733,32,21,53,60.4%,15m
15179,1,Tobsen,3055,332,31,20,51,60.8%,20m
15179,3,Riaz,3055,659,27,28,55,49.1%,22m
15179,3,[Kompis]PlatinumYoda,3055,428,18,25,43,41.9%,19m
15179,1,Enigma,3055,359,14,11,25,56.0%,23m
15179,1,[lLiTl]DREDGE,3055,348,14,14,28,50.0%,2m
15179,1,hooah,3055,364,13,11,24,54.2%,23m
15179,2,METHUSALEM,3055,260,10,4,14,71.4%,22m
15179,3,Kiliboon,3055,261,10,9,19,52.6%,25m
15179,1,Dizzy,3055,278,8,12,20,40.0%,2m
15179,1,DreamFire,3055,184,7,5,12,58.3%,7m
15179,1,Malak,3055,153,6,8,14,42.9%,12m
15179,1,Tigris,3055,0,4,1,5,80.0%,1h
15179,3,Jurassik,3055,0,4,2,6,66.7%,1h
15179,1,[ЕБАННЫ]SuperGamer,3055,104,4,4,8,50.0%,20m
15179,1,XTERRANX,3055,142,3,4,7,42.9%,29m
15179,2,[DRGN]QCFlamexzz,3055,0,1,0,1,100.0%,11m
15179,2,win,3055,0,1,0,1,100.0%,12m
15179,2,JhonnyCash,3055,0,0,1,1,0.0%,23m
15179,2,Boyo,3055,0,0,1,1,0.0%,21m
15179,1,ledzep,3055,0,0,2,2,0.0%,25m
15179,1,BlackBear,3055,0,0,5,5,0.0%,20m
15208,3,gamerww,3054,1569,110,113,223,49.3%,3m
15208,2,Tonyblahe,3054,709,30,17,47,63.8%,7m
15208,3,[wYmwYm]wYmBurning,3054,594,26,23,49,53.1%,16m
15208,1,Maxprime,3054,433,14,14,28,50.0%,7m
15208,3,Leopard,3054,256,11,11,22,50.0%,2m
15208,1,Protothrope,3054,334,10,15,25,40.0%,21m
15208,2,Benares,3054,150,9,6,15,60.0%,19m
15208,1,[RеG]LeYsi,3054,309,9,8,17,52.9%,4m
15208,3,Topimo,3054,236,7,13,20,35.0%,22m
15208,2,Principal,3054,118,5,2,7,71.4%,7m
15208,2,DocShades,3054,0,3,2,5,60.0%,19m
15208,1,Terry,3054,0,3,2,5,60.0%,37m
15208,2,[GNEP]NXValiant,3054,30,2,0,2,100.0%,12m
15208,1,[necron]Chuck,3054,90,2,1,3,66.7%,11m
15208,1,[ATArmy]zhupelL,3054,78,2,4,6,33.3%,7m
15208,3,Markeep,3054,0,1,0,1,100.0%,16m
15208,1,Rekooo,3054,48,1,1,2,50.0%,42m
15208,2,YouNext,3054,30,1,2,3,33.3%,9m
15208,1,DukeSeeD,3054,0,1,3,4,25.0%,4m
15208,1,Neon,3054,32,1,3,4,25.0%,18m
15208,1,WhitekMenace,3054,38,1,3,4,25.0%,12m
15208,2,indy,3054,0,0,1,1,0.0%,9m
15230,1,NUSSUN,3053,1704,151,157,308,49.0%,10m
15230,3,[INFiRe]Troi,3053,1466,147,138,285,51.6%,12m
15230,1,[IndyK]EVOLET,3053,1693,89,83,172,51.7%,21m
15230,1,zhora,3053,1126,67,36,103,65.0%,21m
15230,1,Ludegr,3053,1118,63,37,100,63.0%,2m
15230,1,zero,3053,1355,51,46,97,52.6%,2m
15230,1,[mfixed]Craft,3053,1191,40,40,80,50.0%,5m
15230,3,[S1NS]BarCodeKilla,3053,1078,38,45,83,45.8%,16m
15230,3,Smoky,3053,731,29,29,58,50.0%,19m
15230,1,NOchatting,3053,351,27,15,42,64.3%,11m
15230,1,DesertFox,3053,491,18,15,33,54.5%,11m
15230,1,[CLV]Bloomberg,3053,396,17,15,32,53.1%,25m
15230,1,Cracknut,3053,482,14,17,31,45.2%,8m
15230,1,partial,3053,215,13,5,18,72.2%,4m
15230,3,IoiLOS,3053,281,10,6,16,62.5%,7m
15230,1,ErzaScarlet,3053,235,10,7,17,58.8%,1h
15230,2,AoWmietu,3053,201,9,6,15,60.0%,1h
15230,1,Nidsson,3053,170,8,5,13,61.5%,15m
15230,3,birambam,3053,39,5,16,21,23.8%,23m
15230,1,calamiTy,3053,122,4,6,10,40.0%,5m
15230,3,Kepler,3053,97,2,1,3,66.7%,3m
15230,2,Rodrigorok,3053,46,2,3,5,40.0%,43m
15230,3,KannaKamui,3053,0,1,1,2,50.0%,9m
15230,2,DCrion,3053,38,1,1,2,50.0%,2m
15230,1,SgtWuddel,3053,40,1,5,6,16.7%,2m
15230,1,Curse,3053,0,0,3,3,0.0%,20m
15256,1,[INCNSS]HainKoala,3052,1561,66,57,123,53.7%,11m
15256,1,[DzL]LowAPM,3052,800,57,55,112,50.9%,8m
15256,1,[TAW]equiNoxSC,3052,1477,56,52,108,51.9%,21m
15256,2,Complexity,3052,964,43,34,77,55.8%,10m
15256,1,Omen,3052,479,18,17,35,51.4%,15m
15256,1,Manwë,3052,336,16,11,27,59.3%,11m
15256,2,HydrQ,3052,363,14,7,21,66.7%,7m
15256,1,Starscream,3052,414,12,19,31,38.7%,15m
15256,1,[ODGW]ASPNETCore,3052,296,9,9,18,50.0%,8m
15256,1,[ValidG]Mac,3052,285,7,8,15,46.7%,22m
15256,1,[G4VR]LUGOZZI,3052,48,6,0,6,100.0%,20m
15256,2,Sparta,3052,150,6,4,10,60.0%,19m
15256,1,[stulj]Light,3052,196,6,8,14,42.9%,25m
15256,2,Shial,3052,120,4,2,6,66.7%,19m
15256,2,Frosty,3052,0,4,3,7,57.1%,39m
15256,2,Tertriss,3052,86,4,6,10,40.0%,14m
15256,3,Seantf,3052,0,3,5,8,37.5%,8m
15256,2,MrDeityZenit,3052,58,2,2,4,50.0%,19m
15256,2,UxorialBack,3052,0,2,3,5,40.0%,7m
15256,1,krusty,3052,0,1,2,3,33.3%,2m
15256,1,Yosoku,3052,0,1,2,3,33.3%,4m
15256,3,[l7cT]ШТИРЛИЦ,3052,97,1,6,7,14.3%,1h
15278,3,DawnPatrol,3051,1065,169,166,335,50.4%,6m
15278,3,[laugh]WildTeimur,3051,1394,148,157,305,48.5%,16m
15278,1,Sightlyfan,3051,1550,102,91,193,52.8%,8m
15278,1,LAMAO,3051,930,29,36,65,44.6%,8m
15278,2,DrunkMunk,3051,579,27,17,44,61.4%,17m
15278,1,Raymon,3051,716,23,24,47,48.9%,4m
15278,1,Aquro,3051,494,19,21,40,47.5%,2m
15278,1,Gubbins,3051,526,17,22,39,43.6%,20m
15278,2,Erratus,3051,272,13,9,22,59.1%,20m
15278,2,[TheDOH]NemesisBoY,3051,198,8,2,10,80.0%,5m
15278,2,SirBlack,3051,187,8,5,13,61.5%,2m
15278,2,Roffe,3051,112,7,0,7,100.0%,3m
15278,2,Furiosa,3051,154,7,3,10,70.0%,15m
15278,1,Bug,3051,255,6,7,13,46.2%,11m
15278,2,aggressor,3051,148,5,2,7,71.4%,5m
15278,1,[TOCIO]TOCIO,3051,204,5,5,10,50.0%,15m
15278,1,Beevackgg,3051,0,4,1,5,80.0%,1h
15278,1,[SCiE]TheNewTos,3051,118,4,2,6,66.7%,12m
15278,1,[JOSEVI]Pereza,3051,116,4,8,12,33.3%,20m
15278,1,[IUFOI]DeTrosty,3051,142,3,3,6,50.0%,8m
15278,1,BooMBorG,3051,137,3,5,8,37.5%,20m
15278,3,[HebT]JiTiBO,3051,146,3,7,10,30.0%,1h
15278,1,van,3051,38,2,4,6,33.3%,25m
15278,1,akprocent,3051,84,2,9,11,18.2%,15m
15278,2,BlackDuckin,3051,0,1,0,1,100.0%,23m
15278,1,[Gehakt]Furby,3051,0,1,1,2,50.0%,7m
15304,2,[pugio]byxapukl,3050,1605,87,78,165,52.7%,10m
15304,1,Goronok,3050,514,20,16,36,55.6%,2m
15304,3,[BWArmy]ArrowCombo,3050,522,20,34,54,37.0%,16m
15304,1,Picsou,3050,541,19,21,40,47.5%,15m
15304,1,Zinloos,3050,324,14,8,22,63.6%,25m
15304,1,[nWss]BiKi,3050,467,14,12,26,53.8%,7m
15304,3,[PARCE]Niloc,3050,349,12,16,28,42.9%,11m
15304,1,NoApm,3050,321,11,8,19,57.9%,19m
15304,1,petusa,3050,190,9,3,12,75.0%,4m
15304,1,YukikazeU,3050,126,7,4,11,63.6%,25m
15304,1,[VuV]Paka,3050,256,7,11,18,38.9%,25m
15304,3,[PrStar]TheArchitect,3050,200,7,18,25,28.0%,20m
15304,1,halbekiste,3050,38,2,7,9,22.2%,11m
15304,2,Spookyd,3050,0,1,0,1,100.0%,22m
15304,2,Anubis,3050,0,1,0,1,100.0%,23m
15304,2,ThomasTor,3050,30,1,1,2,50.0%,23m
15304,1,lENarrd,3050,91,1,2,3,33.3%,16m
15304,2,Blumentopf,3050,0,0,1,1,0.0%,19m
15304,1,Blackhole,3050,0,0,3,3,0.0%,10m
15304,1,LetsLearn,3050,0,0,5,5,0.0%,24m
15324,3,happyskunze,3049,1541,172,175,347,49.6%,19m
15324,1,KrimiX,3049,1376,116,96,212,54.7%,15m
15324,1,Agatov,3049,1034,93,86,179,52.0%,7m
15324,2,SuperManer,3049,880,40,23,63,63.5%,19m
15324,1,IrAǂNvok,3049,1092,36,40,76,47.4%,15m
15324,3,TheKraken,3049,898,36,40,76,47.4%,8m
15324,2,apartment,3049,640,24,21,45,53.3%,9m
15324,1,[PaniC]ДжохниПрогей,3049,576,21,13,34,61.8%,25m
15324,1,BlueTurtle,3049,521,20,23,43,46.5%,4m
15324,1,Debonair,3049,402,13,12,25,52.0%,3m
15324,1,Neofitik,3049,116,7,3,10,70.0%,22m
15324,1,CrusaderPLnd,3049,144,4,6,10,40.0%,8m
15324,1,AKaPULKO,3049,76,2,7,9,22.2%,18m
15324,2,Delianis,3049,0,1,0,1,100.0%,7m
15324,2,[PuNcyN]Maćko,3049,0,1,0,1,100.0%,23m
15324,1,[УВЦ]Doc,3049,38,1,8,9,11.1%,7m
15324,2,xAntiViruZx,3049,0,0,1,1,0.0%,3m
15324,1,[NerCC]Eloy,3049,0,0,2,2,0.0%,20m
15324,1,Rafa,3049,0,0,2,2,0.0%,21m
15343,1,Cazzone,3048,1727,418,402,820,51.0%,21m
15343,1,PTSDM,3048,1393,86,81,167,51.5%,8m
15343,1,[NaOH]Térorus,3048,418,22,18,40,55.0%,21m
15343,3,guillaume,3048,144,21,23,44,47.7%,11m
15343,3,ThunderShock,3048,588,21,24,45,46.7%,25m
15343,1,Blind,3048,468,17,13,30,56.7%,5m
15343,3,MCLK,3048,318,14,16,30,46.7%,21m
15343,1,[VTRS]Salvatore,3048,468,13,17,30,43.3%,8m
15343,3,samÆl,3048,306,11,23,34,32.4%,5m
15343,1,Tarquinique,3048,326,10,13,23,43.5%,18m
15343,1,RaphyNova,3048,280,8,14,22,36.4%,23m
15343,3,Stepll,3048,230,7,4,11,63.6%,17m
15343,1,EquaL,3048,180,5,8,13,38.5%,7m
15343,1,[NwK]Raffiness,3048,119,3,2,5,60.0%,23m
15343,2,[369]BakedBeans,3048,0,3,2,5,60.0%,19m
15343,1,[35BZH]jojo,3048,0,3,3,6,50.0%,21m
15343,3,Carnage,3048,117,3,3,6,50.0%,20m
15343,1,[RAFVGA]GigaChad,3048,38,2,3,5,40.0%,9m
15343,2,[OK238]HeadcorE,3048,0,0,1,1,0.0%,2m
15343,2,Aaz,3048,0,0,1,1,0.0%,12m
15343,2,xhang,3048,0,0,1,1,0.0%,8m
15364,1,Mewsicluvah,3047,1563,98,94,192,51.0%,9m
15364,3,VinylRaider,3047,1433,79,78,157,50.3%,12m
15364,3,Osendi,3047,1187,52,56,108,48.1%,16m
15364,1,HaveFun,3047,689,43,37,80,53.8%,15m
15364,1,Hydra,3047,887,35,34,69,50.7%,18m
15364,2,yodaogkush,3047,703,27,20,47,57.4%,20m
15364,1,RoadKiLL,3047,424,18,25,43,41.9%,22m
15364,1,storm,3047,352,16,6,22,72.7%,14m
15364,3,[PIWN]Milord,3047,409,15,15,30,50.0%,22m
15364,1,[Dobro]Amoeba,3047,264,7,13,20,35.0%,18m
15364,2,GuNii,3047,124,5,2,7,71.4%,19m
15364,2,Yoshiki,3047,112,5,2,7,71.4%,17m
15364,1,[LifeAD]dekril,3047,114,4,5,9,44.4%,2m
15364,2,[vi2018]Shenby,3047,62,2,2,4,50.0%,12m
15364,1,Drain,3047,36,2,3,5,40.0%,4m
15364,2,Khan,3047,0,1,0,1,100.0%,2m
15364,2,HyPeTommaa,3047,0,1,0,1,100.0%,15m
15364,1,Somer,3047,48,1,1,2,50.0%,9m
15364,2,David,3047,30,1,1,2,50.0%,4m
15364,2,[ncotic]StarRain,3047,32,1,2,3,33.3%,17m
15364,1,TERRAN,3047,0,1,4,5,20.0%,7m
15364,2,Interra,3047,0,0,1,1,0.0%,7m
15364,1,[BV]nikishok,3047,0,0,2,2,0.0%,22m
15387,3,[696]MishRqt,3046,1624,353,349,702,50.3%,7m
15387,3,TwilightRo,3046,575,254,244,498,51.0%,10m
15387,3,[gVLd]LETitBURN,3046,1472,158,156,314,50.3%,21m
15387,3,reverite,3046,452,83,88,171,48.5%,18m
15387,1,Krederus,3046,1109,58,50,108,53.7%,21m
15387,2,Zanzibara,3046,1464,56,53,109,51.4%,25m
15387,1,Jast,3046,1035,44,33,77,57.1%,15m
15387,1,Tonimon,3046,1119,40,38,78,51.3%,8m
15387,2,[AiRǂ]UnicoTerran,3046,586,25,15,40,62.5%,9m
15387,1,BiGPants,3046,451,20,19,39,51.3%,15m
15387,1,ÄlNair,3046,559,19,20,39,48.7%,3m
15387,1,[DET54]DimonLimON,3046,470,18,13,31,58.1%,23m
15387,1,[HGame]Ghazgh,3046,411,16,12,28,57.1%,7m
15387,1,[HRDS]ZeroCooL,3046,362,12,12,24,50.0%,2m
15387,2,oDiNe,3046,265,9,8,17,52.9%,21m
15387,1,MrCrackFox,3046,220,7,14,21,33.3%,12m
15387,1,[GZerO]KingenLiam,3046,0,4,1,5,80.0%,32m
15387,2,[Qurwa]Vextor,3046,92,4,1,5,80.0%,3m
15387,1,MechGodAvilo,3046,120,4,5,9,44.4%,18m
15387,1,[Froze]Elsa,3046,112,3,10,13,23.1%,13m
15387,2,Борщ,3046,0,1,0,1,100.0%,12m
15387,2,Saint,3046,30,1,1,2,50.0%,7m
15409,1,[3ЕRGTV]Vlad,3045,1586,156,128,284,54.9%,11m
15409,1,Soup,3045,1601,113,96,209,54.1%,9m
15409,3,[R0]DragosIonut,3045,1337,88,91,179,49.2%,6m
15409,1,Skalgamix,3045,1103,41,37,78,52.6%,12m
15409,2,прилив,3045,806,36,23,59,61.0%,10m
15409,1,bokcvok,3045,612,27,18,45,60.0%,13m
15409,1,[xASFx]FatihSultan,3045,696,22,21,43,51.2%,20m
15409,1,llllllllll,3045,581,21,24,45,46.7%,7m
15409,2,[EBIG]Haggis,3045,385,20,8,28,71.4%,11m
15409,2,PongLenis,3045,368,18,14,32,56.2%,7m
15409,1,Kirigiri,3045,498,18,15,33,54.5%,22m
15409,3,jITO,3045,246,12,17,29,41.4%,4m
15409,2,Forever,3045,290,11,11,22,50.0%,3m
15409,2,[GGWPEZ]Koim,3045,284,10,6,16,62.5%,3m
15409,2,Artanis,3045,206,8,8,16,50.0%,8m
15409,2,Varis,3045,169,7,5,12,58.3%,1h
15409,3,[1MoD]Joker,3045,145,6,3,9,66.7%,9m
15409,1,FreshD,3045,287,6,28,34,17.6%,15m
15409,1,Sniko,3045,145,5,2,7,71.4%,1h
15409,2,Trinkelix,3045,76,4,1,5,80.0%,7m
15409,2,flappysj,3045,62,3,0,3,100.0%,18m
15409,2,[PSBoyz]Feanor,3045,92,3,1,4,75.0%,4m
15409,2,Uchenikkk,3045,0,3,2,5,60.0%,23m
15409,2,[TBSTV]AngelLP,3045,0,3,2,5,60.0%,17m
15409,1,Nova,3045,95,2,1,3,66.7%,1h
15409,2,IIIIIIIIIIII,3045,0,1,0,1,100.0%,12m
15409,3,sfPetru,3045,0,0,1,1,0.0%,17m
15409,2,Dobie,3045,0,0,1,1,0.0%,10m
15409,2,Lum,3045,0,0,2,2,0.0%,2m
15409,1,MurZuk,3045,0,0,6,6,0.0%,18m
15439,1,[BOSSY]gus,3044,1228,125,117,242,51.7%,24m
15439,1,chody,3044,1610,82,69,151,54.3%,2m
15439,2,OMGWTF,3044,963,68,53,121,56.2%,10m
15439,1,[EVZK]Microbob,3044,1028,50,40,90,55.6%,15m
15439,1,Flophead,3044,842,43,46,89,48.3%,25m
15439,1,MIX,3044,324,21,10,31,67.7%,8m
15439,3,[heXnab]Avion,3044,514,16,26,42,38.1%,11m
15439,2,Rorschach,3044,318,10,11,21,47.6%,19m
15439,1,Resolve,3044,286,8,12,20,40.0%,18m
15439,1,Jaffro,3044,272,8,14,22,36.4%,21m
15439,2,Enair,3044,169,6,5,11,54.5%,10m
15439,1,Leszu,3044,144,5,6,11,45.5%,18m
15439,3,[RekLaW]DTempler,3044,137,4,1,5,80.0%,10m
15439,2,llllllllllll,3044,0,1,0,1,100.0%,20m
15439,2,[RiT]Danny,3044,30,1,6,7,14.3%,25m
15439,1,putopelatudo,3044,0,0,4,4,0.0%,12m
15455,1,Surreal,3043,1464,86,71,157,54.8%,15m
15455,1,Panoramix,3043,1541,83,79,162,51.2%,25m
15455,1,Tywka,3043,939,75,64,139,54.0%,15m
15455,3,Rafix,3043,618,20,27,47,42.6%,21m
15455,1,Kurve,3043,417,16,12,28,57.1%,11m
15455,1,hedGehog,3043,305,10,7,17,58.8%,13m
15455,1,Menkar,3043,332,10,14,24,41.7%,16m
15455,1,Merkabach,3043,250,8,6,14,57.1%,18m
15455,1,[Degab]DEFEHUN,3043,215,5,6,11,45.5%,4m
15455,2,JimLeslie,3043,122,4,5,9,44.4%,19m
15455,1,[AlDS]Skipper,3043,0,3,2,5,60.0%,1h
15455,2,[vlast]mARIO,3043,32,2,0,2,100.0%,7m
15455,2,[NoSa]Metanoia,3043,113,2,1,3,66.7%,1h
15455,1,[DWF]Nightfighter,3043,72,2,4,6,33.3%,2m
15455,2,JoeCamel,3043,0,1,0,1,100.0%,23m
15455,3,desert,3043,0,1,1,2,50.0%,32m
15455,2,llllllllllll,3043,30,1,2,3,33.3%,15m
15472,3,Minerve,3042,1593,628,597,1225,51.3%,19m
15472,3,PolyEbnytiy,3042,1498,137,124,261,52.5%,3m
15472,1,CrimsonKing,3042,1587,121,104,225,53.8%,15m
15472,1,Maxxxxxxxxxx,3042,1217,98,91,189,51.9%,3m
15472,1,Gook,3042,1585,71,74,145,49.0%,15m
15472,3,gwaboss,3042,305,68,75,143,47.6%,10m
15472,1,[EXPANT]BigBadVoodoo,3042,1087,39,38,77,50.6%,18m
15472,3,chucknorris,3042,579,32,42,74,43.2%,19m
15472,1,[JEsux]JusTice,3042,631,25,19,44,56.8%,4m
15472,1,Abskur,3042,574,24,21,45,53.3%,7m
15472,1,[ЕST]TaHku,3042,466,24,22,46,52.2%,19m
15472,1,epoK,3042,466,15,17,32,46.9%,4m
15472,2,[mrcoh]Deeew,3042,182,8,7,15,53.3%,17m
15472,2,Bothanical,3042,167,7,3,10,70.0%,12m
15472,2,Brisingr,3042,44,6,4,10,60.0%,22m
15472,2,[NWGD]Aqua,3042,138,6,5,11,54.5%,1h
15472,2,multy,3042,30,5,2,7,71.4%,17m
15472,1,[ZERG7V]LoomY,3042,148,5,6,11,45.5%,17m
15472,1,DönerKnight,3042,174,5,9,14,35.7%,10m
15472,2,Dirtypeanuts,3042,0,3,2,5,60.0%,20m
15472,2,[LTPX]gregwoow,3042,0,3,2,5,60.0%,9m
15472,2,NRNF,3042,32,2,1,3,66.7%,17m
15472,1,Makeshik,3042,76,2,5,7,28.6%,21m
15472,1,ProXy,3042,88,1,3,4,25.0%,15m
15472,2,HufferPuffer,3042,0,0,1,1,0.0%,23m
15472,1,IAMKOREAN,3042,0,0,2,2,0.0%,5m
15498,1,VerisonV,3041,1094,119,113,232,51.3%,20m
15498,1,Enthusiasmus,3041,1176,46,39,85,54.1%,10m
15498,2,FMNSBarrier,3041,759,28,22,50,56.0%,10m
15498,1,MoaTailandkz,3041,589,25,21,46,54.3%,8m
15498,2,xaverseltsam,3041,445,20,13,33,60.6%,7m
15498,2,Murdoch,3041,524,20,16,36,55.6%,3m
15498,2,LazyVictory,3041,434,17,11,28,60.7%,15m
15498,1,MaRiO,3041,311,14,11,25,56.0%,17m
15498,2,[ELTM]Dussa,3041,326,12,11,23,52.2%,21m
15498,1,[GIS9]Ichigo,3041,392,11,13,24,45.8%,12m
15498,2,NiFox,3041,210,7,0,7,100.0%,10m
15498,3,Bluntus,3041,60,5,15,20,25.0%,14m
15498,1,nepyou,3041,0,3,2,5,60.0%,13m
15498,1,[EESC]haskichawa,3041,76,3,9,12,25.0%,6m
15498,2,Novax,3041,34,2,2,4,50.0%,6m
15498,1,bspace,3041,125,2,4,6,33.3%,24m
15498,2,[TFLA]MiniKodo,3041,0,1,0,1,100.0%,2m
15498,2,Khankki,3041,0,0,1,1,0.0%,3m
15516,3,Tiger,3040,1484,161,174,335,48.1%,4m
15516,1,Chames,3040,1517,102,87,189,54.0%,23m
15516,1,Rain,3040,819,39,38,77,50.6%,4m
15516,1,[MPTS]axelrod,3040,751,28,28,56,50.0%,15m
15516,1,BytheWay,3040,514,16,19,35,45.7%,8m
15516,1,bogshuter,3040,265,12,9,21,57.1%,4m
15516,2,[Sativa]MikhailS,3040,147,4,1,5,80.0%,30m
15516,3,xim,3040,163,4,3,7,57.1%,20m
15516,2,[KSN]DyxectoR,3040,66,4,5,9,44.4%,4m
15516,3,NotMercyLess,3040,118,4,16,20,20.0%,15m
15516,2,DieBorg,3040,0,3,2,5,60.0%,4m
15516,2,Cordinal,3040,62,3,2,5,60.0%,14m
15516,1,GOUUUDENZ,3040,0,3,2,5,60.0%,1h
15516,2,NINJA,3040,93,2,0,2,100.0%,44m
15516,2,Bohr,3040,32,2,2,4,50.0%,10m
15516,1,TOGA,3040,38,2,2,4,50.0%,23m
15516,2,CoinTOSS,3040,0,0,1,1,0.0%,3m
15533,1,Joris,3039,687,31,21,52,59.6%,25m
15533,1,PausePeco,3039,368,13,16,29,44.8%,15m
15533,1,IIIIIIIII,3039,300,9,11,20,45.0%,25m
15533,1,musashi,3039,131,5,1,6,83.3%,19m
15533,3,[Draigo]wouinny,3039,97,4,3,7,57.1%,44m
15533,2,FallenOne,3039,64,3,1,4,75.0%,4m
15533,2,Lßaz,3039,60,3,3,6,50.0%,8m
15533,3,Iruler,3039,0,3,5,8,37.5%,12m
15533,2,[TedB]LATAR,3039,0,1,0,1,100.0%,25m
15533,2,[Ascd]Benäneli,3039,0,1,1,2,50.0%,19m
15533,2,spawn,3039,0,1,1,2,50.0%,23m
15533,1,IIIIIIIIIIII,3039,0,1,3,4,25.0%,15m
15533,2,AgentSmith,3039,46,1,6,7,14.3%,40m
15533,1,TurisaZ,3039,0,0,1,1,0.0%,1h
15533,3,SepH,3039,0,0,1,1,0.0%,17m
15533,2,Orrr,3039,0,0,2,2,0.0%,22m
15549,3,[ENU]DarthMikey,3038,1524,170,159,329,51.7%,14m
15549,3,NLJosh,3038,1566,132,134,266,49.6%,19m
15549,1,Ondest,3038,1042,131,125,256,51.2%,11m
15549,1,Kromatom,3038,1698,79,71,150,52.7%,18m
15549,2,ExisT,3038,1458,66,62,128,51.6%,3m
15549,2,LurKer,3038,1234,50,41,91,54.9%,2m
15549,1,[m333m]ProTivNik,3038,1247,49,49,98,50.0%,20m
15549,1,fredophil,3038,546,48,54,102,47.1%,7m
15549,1,glhf,3038,907,44,33,77,57.1%,6m
15549,2,cannonrusher,3038,674,32,12,44,72.7%,20m
15549,1,[GTT]Feanor,3038,558,27,19,46,58.7%,11m
15549,2,OneTwoSwim,3038,275,14,7,21,66.7%,22m
15549,1,Makatou,3038,329,14,12,26,53.8%,7m
15549,3,[PIZIKS]RIPer,3038,355,13,5,18,72.2%,17m
15549,1,Flitter,3038,184,11,8,19,57.9%,10m
15549,2,Vortsok,3038,206,6,3,9,66.7%,23m
15549,3,IIIIIIII,3038,148,6,14,20,30.0%,14m
15549,2,kaiser,3038,145,4,3,7,57.1%,19m
15549,2,[DV]Biscornus,3038,88,3,4,7,42.9%,10m
15549,2,upreal,3038,0,1,0,1,100.0%,14m
15549,2,[TuttiG]Yuurina,3038,0,1,1,2,50.0%,20m
15549,2,Chip,3038,0,0,1,1,0.0%,14m
15549,3,Zillah,3038,0,0,7,7,0.0%,7m
15572,3,MEISTER,3037,1602,172,179,351,49.0%,7m
15572,3,komyna,3037,1439,115,109,224,51.3%,11m
15572,1,Steelhammer,3037,969,77,72,149,51.7%,17m
15572,1,TBourhis,3037,1321,75,68,143,52.4%,7m
15572,3,Robodude,3037,504,70,71,141,49.6%,8m
15572,1,Bulbasaur,3037,1094,60,58,118,50.8%,5m
15572,1,micubisi,3037,823,31,25,56,55.4%,21m
15572,1,SirAaerious,3037,872,31,32,63,49.2%,7m
15572,1,Timmybuik,3037,725,28,27,55,50.9%,25m
15572,1,[TSC2C]Инквизиция,3037,372,20,8,28,71.4%,7m
15572,1,[LURS]kOrNeliuzz,3037,394,14,10,24,58.3%,8m
15572,1,trivio,3037,253,12,8,20,60.0%,25m
15572,2,[keki]kakatun,3037,312,11,6,17,64.7%,19m
15572,1,AgentSmith,3037,254,8,6,14,57.1%,19m
15572,2,Kaisvap,3037,196,7,4,11,63.6%,3m
15572,2,boulevard,3037,122,5,2,7,71.4%,23m
15572,2,[MeDuS]SPARTA,3037,143,4,1,5,80.0%,15m
15572,1,RosenEf,3037,143,4,4,8,50.0%,8m
15572,2,Qnugg,3037,120,4,4,8,50.0%,20m
15572,2,Gravix,3037,58,3,1,4,75.0%,15m
15572,2,[SCiE]LEOKA,3037,0,3,2,5,60.0%,9m
15572,2,[BAPEN]Peadix,3037,30,2,0,2,100.0%,3m
15572,2,[PiMoK]HornYprobE,3037,0,1,0,1,100.0%,10m
15572,2,PiKiTrOn,3037,0,1,0,1,100.0%,10m
15572,2,GbR,3037,0,1,0,1,100.0%,17m
15572,2,legalasca,3037,0,1,0,1,100.0%,5m
15572,3,[Jürgen]dani,3037,30,1,10,11,9.1%,10m
15572,2,JenKO,3037,0,0,1,1,0.0%,22m
15572,2,[Sahut]néo,3037,0,0,1,1,0.0%,23m
15572,1,EasyAI,3037,0,0,2,2,0.0%,2m
15572,1,cydemon,3037,0,0,5,5,0.0%,7m
15603,1,Xss,3036,1409,102,81,183,55.7%,21m
15603,2,FLInT,3036,1635,99,77,176,56.2%,3m
15603,2,Terius,3036,1503,88,76,164,53.7%,7m
15603,1,marmorix,3036,1166,75,70,145,51.7%,6m
15603,1,badarty,3036,1328,54,52,106,50.9%,5m
15603,1,Zarattul,3036,817,31,24,55,56.4%,7m
15603,3,BooN,3036,872,27,50,77,35.1%,25m
15603,2,Dracool,3036,463,18,11,29,62.1%,17m
15603,3,zzvbm,3036,450,17,17,34,50.0%,6m
15603,1,Markus,3036,275,13,6,19,68.4%,15m
15603,3,igor,3036,291,13,9,22,59.1%,7m
15603,2,[HGeezy]HaraldGucci,3036,302,11,10,21,52.4%,23m
15603,1,[SLW]NainPro,3036,330,10,14,24,41.7%,3m
15603,1,[ERaSim]IamTheSwarm,3036,202,7,4,11,63.6%,8m
15603,2,FlamerCT,3036,196,7,6,13,53.8%,15m
15603,3,MaxShmax,3036,146,6,3,9,66.7%,13m
15603,2,Špekov,3036,164,5,1,6,83.3%,7m
15603,2,[mmh]Freshbunny,3036,0,4,1,5,80.0%,14m
15603,2,[DSNet]enCrypt,3036,88,4,2,6,66.7%,7m
15603,1,eyalk,3036,0,4,2,6,66.7%,25m
15603,1,[Ri17]RinKiller,3036,123,4,5,9,44.4%,14m
15603,2,notbnk,3036,0,3,2,5,60.0%,17m
15603,2,Kulak,3036,36,2,0,2,100.0%,14m
15603,2,Synthetic,3036,30,2,1,3,66.7%,21m
15603,2,KUSANAGI,3036,60,2,2,4,50.0%,14m
15603,3,tpfx,3036,0,2,5,7,28.6%,6m
15603,2,CuddleProby,3036,0,1,0,1,100.0%,9m
15603,2,[4YLiFe]SPiriT,3036,0,0,1,1,0.0%,14m
15631,1,LynVingen,3035,1684,162,147,309,52.4%,4m
15631,2,IamDoduuu,3035,900,125,99,224,55.8%,14m
15631,1,Manu,3035,1297,118,91,209,56.5%,4m
15631,3,TAIMEZ,3035,1511,103,94,197,52.3%,4m
15631,1,[SiHr]HoloPriest,3035,1138,69,62,131,52.7%,11m
15631,2,adder,3035,748,28,24,52,53.8%,20m
15631,3,miNeraL,3035,397,27,33,60,45.0%,3m
15631,2,[SSFo]Voidprime,3035,399,22,12,34,64.7%,4m
15631,2,JohnnyVile,3035,393,18,15,33,54.5%,25m
15631,3,llllllllllll,3035,367,17,5,22,77.3%,16m
15631,2,Слава,3035,414,16,11,27,59.3%,11m
15631,2,LeMmiT,3035,178,10,6,16,62.5%,23m
15631,1,ZergAteYou,3035,130,8,2,10,80.0%,13m
15631,1,JenniferRush,3035,256,8,6,14,57.1%,21m
15631,1,Terprozer,3035,260,8,11,19,42.1%,18m
15631,1,MegaDeath,3035,302,8,13,21,38.1%,10m
15631,1,[Kripta]САФАРИ,3035,258,7,10,17,41.2%,2m
15631,2,[UGAY]Lovnag,3035,86,3,4,7,42.9%,14m
15631,1,[meeow]MÓKUS,3035,74,3,5,8,37.5%,25m
15631,2,[Ximic]Mitrofan,3035,34,1,3,4,25.0%,6m
15631,1,Zgura,3035,73,1,3,4,25.0%,7m
15631,3,[xBPx]Darkfenix,3035,0,0,1,1,0.0%,40m
15653,1,lllllllll,3034,1677,267,246,513,52.0%,16m
15653,1,Mutant,3034,1712,194,194,388,50.0%,18m
15653,1,[DBGS]hgg,3034,1662,136,126,262,51.9%,25m
15653,1,[DMøøn]Vericsnake,3034,1480,119,113,232,51.3%,8m
15653,3,Dominator,3034,911,111,115,226,49.1%,15m
15653,2,Bunty,3034,751,68,63,131,51.9%,20m
15653,1,DrNo,3034,773,30,27,57,52.6%,11m
15653,1,CollinCobra,3034,646,26,18,44,59.1%,3m
15653,1,IIIIIIIIIIII,3034,561,23,18,41,56.1%,18m
15653,1,Rincewind,3034,534,22,17,39,56.4%,3m
15653,1,Titan,3034,654,22,19,41,53.7%,8m
15653,1,fourbeur,3034,427,19,15,34,55.9%,15m
15653,1,Johnyu,3034,254,18,8,26,69.2%,19m
15653,3,IIIIIIIIIIII,3034,409,18,18,36,50.0%,9m
15653,1,Rafoboy,3034,558,17,22,39,43.6%,7m
15653,2,[DRЕAM]Frogs,3034,364,13,10,23,56.5%,14m
15653,2,topgir,3034,265,11,1,12,91.7%,11m
15653,1,stSergiy,3034,208,9,3,12,75.0%,25m
15653,3,ICrazyFool,3034,238,9,8,17,52.9%,7m
15653,1,feight,3034,330,9,13,22,40.9%,8m
15653,2,[ZnaS]Nightra,3034,30,4,2,6,66.7%,10m
15653,1,[6a60z3]axid,3034,0,4,2,6,66.7%,8m
15653,2,Lefimaister,3034,88,3,2,5,60.0%,14m
15653,2,DrZogg,3034,0,3,2,5,60.0%,22m
15653,1,[MacG]Mattlinn,3034,76,3,6,9,33.3%,15m
15653,2,Barm,3034,58,2,1,3,66.7%,3m
15653,1,Doragon,3034,90,2,2,4,50.0%,17m
15653,2,[Hrr]bybyinfo,3034,0,1,0,1,100.0%,8m
15653,1,[DJs]misto,3034,0,1,1,2,50.0%,1h
15653,2,Choco,3034,32,1,3,4,25.0%,23m
15683,1,Shotmaker,3033,1089,95,84,179,53.1%,21m
15683,1,Psyduck,3033,1504,94,94,188,50.0%,20m
15683,2,Guigez,3033,1103,82,48,130,63.1%,12m
15683,1,dreamx,3033,1013,44,43,87,50.6%,4m
15683,1,Degenerał,3033,900,43,39,82,52.4%,18m
15683,3,Faust,3033,1124,43,43,86,50.0%,21m
15683,1,Nickname,3033,860,35,27,62,56.5%,2m
15683,3,[THEHUB]Timppis,3033,460,16,26,42,38.1%,10m
15683,1,[ohSL]HeyHou,3033,271,9,4,13,69.2%,10m
15683,1,WhoRlyCares,3033,285,9,6,15,60.0%,1h
15683,1,[Rom01]dieg,3033,232,9,6,15,60.0%,19m
15683,1,ANDROCK,3033,167,6,3,9,66.7%,18m
15683,1,Tehnor,3033,97,4,1,5,80.0%,46m
15683,1,BroodjeWorst,3033,169,4,5,9,44.4%,23m
15683,1,LifeisDance,3033,80,2,5,7,28.6%,9m
15683,2,Deskariot,3033,0,1,0,1,100.0%,22m
15683,2,[AFTSc]Claddus,3033,0,0,1,1,0.0%,3m
15683,3,[LuZe]Medusa,3033,0,0,1,1,0.0%,4m
15683,1,olsandan,3033,0,0,4,4,0.0%,17m
15702,1,[HZeS]IRomaRioL,3032,1463,108,82,190,56.8%,4m
15702,2,Manticore,3032,1247,91,70,161,56.5%,17m
15702,1,Megadeath,3032,1634,86,80,166,51.8%,22m
15702,1,JeckiChan,3032,1171,48,41,89,53.9%,4m
15702,1,[SRTS]schrecken,3032,1158,42,38,80,52.5%,24m
15702,3,StarlooZ,3032,459,42,44,86,48.8%,5m
15702,1,AvDominusNox,3032,936,40,31,71,56.3%,7m
15702,2,DoDo,3032,935,37,28,65,56.9%,3m
15702,2,Bugrahan,3032,778,34,18,52,65.4%,7m
15702,1,Reaper,3032,790,34,25,59,57.6%,3m
15702,2,Karasu,3032,446,19,11,30,63.3%,14m
15702,2,Spooh,3032,320,17,17,34,50.0%,12m
15702,3,[br0t]Gevster,3032,121,15,17,32,46.9%,22m
15702,2,Postal,3032,212,8,6,14,57.1%,36m
15702,2,Ian,3032,165,6,5,11,54.5%,22m
15717,1,Guardian,3031,786,65,42,107,60.7%,6m
15717,2,[OGXIII]Darkhell,3031,749,39,10,49,79.6%,20m
15717,1,Naruto,3031,732,26,26,52,50.0%,7m
15717,1,vadimusan,3031,425,20,11,31,64.5%,10m
15717,1,CobraLin,3031,433,16,15,31,51.6%,8m
15717,2,Rastamon,3031,217,12,11,23,52.2%,20m
15717,2,ipxZerg,3031,173,6,0,6,100.0%,6m
15717,1,Rui,3031,182,5,5,10,50.0%,19m
15717,1,[KHV1]EduardKHV,3031,121,4,3,7,57.1%,15m
15717,3,Blat,3031,97,2,0,2,100.0%,3m
15717,2,[PUSS]Сосруко,3031,30,2,1,3,66.7%,12m
15717,2,Gladiator,3031,0,1,0,1,100.0%,11m
15717,2,[TheMG]Entropy,3031,0,1,0,1,100.0%,28m
15717,2,Grifex,3031,30,1,1,2,50.0%,10m
15717,2,[PSidee]DaEtoJeSmile,3031,0,1,3,4,25.0%,11m
15717,1,[LOoTeX]BSG,3031,0,0,1,1,0.0%,32m
15717,2,KnuckleOhs,3031,0,0,2,2,0.0%,12m
15734,1,[696]Cannon,3030,1696,270,255,525,51.4%,23m
15734,1,MrWhippy,3030,404,103,82,185,55.7%,22m
15734,1,pewyrtu,3030,547,86,92,178,48.3%,7m
15734,1,MoKaTé,3030,1612,82,73,155,52.9%,3m
15734,1,Akkon,3030,819,67,58,125,53.6%,8m
15734,1,wanou,3030,664,29,24,53,54.7%,11m
15734,3,Sapozhnik,3030,606,26,24,50,52.0%,14m
15734,2,[Nvalny]Neksis,3030,574,25,13,38,65.8%,20m
15734,3,Spork,3030,660,24,34,58,41.4%,15m
15734,1,Норберт,3030,269,11,6,17,64.7%,11m
15734,1,[SC22SC]Ptik,3030,402,11,18,29,37.9%,10m
15734,2,CptPrice,3030,172,7,5,12,58.3%,11m
15734,3,[SmackB]PekЗl,3030,38,6,2,8,75.0%,24m
15734,2,Noski,3030,0,4,1,5,80.0%,4m
15734,2,[NigTer]AlexdjEP,3030,96,4,3,7,57.1%,25m
15734,1,HabboThis,3030,40,4,4,8,50.0%,18m
15734,1,[UnDo]EpidemIcLash,3030,42,4,4,8,50.0%,25m
15734,1,MajorLazer,3030,141,3,6,9,33.3%,4m
15734,2,Fjhjsre,3030,34,2,0,2,100.0%,15m
15734,2,anusbis,3030,40,2,3,5,40.0%,1h
15734,2,[4ita]thompson,3030,0,1,0,1,100.0%,17m
15734,2,daquar,3030,0,1,0,1,100.0%,12m
15734,2,УбивцаТоссов,3030,0,1,0,1,100.0%,7m
15734,2,whosyp,3030,0,1,0,1,100.0%,23m
15734,2,EndIsNear,3030,30,1,2,3,33.3%,10m
15734,1,Ultrainst,3030,0,1,4,5,20.0%,16m
15734,1,[10110]Bestasttung,3030,0,1,6,7,14.3%,16m
15734,3,Bobychon,3030,30,1,9,10,10.0%,22m
15762,3,dgz,3029,1124,72,80,152,47.4%,4m
15762,3,DaveyJones,3029,1217,57,59,116,49.1%,7m
15762,1,Alterschwede,3029,973,37,33,70,52.9%,2m
15762,1,[Molise]BeningDread,3029,623,28,22,50,56.0%,4m
15762,1,IlanDobrik,3029,657,24,22,46,52.2%,11m
15762,1,[RzBn]LeGardien,3029,394,12,17,29,41.4%,18m
15762,1,Larhar,3029,180,9,6,15,60.0%,4m
15762,2,Drakan,3029,154,8,2,10,80.0%,11m
15762,3,FMarineKing,3029,248,8,12,20,40.0%,7m
15762,2,[NiN]snuifduif,3029,170,6,3,9,66.7%,23m
15762,3,DABO,3029,169,6,4,10,60.0%,13m
15762,3,[Alfred]Jing,3029,121,5,3,8,62.5%,12m
15762,3,Duchess,3029,0,4,2,6,66.7%,1h
15762,2,Wana,3029,122,4,4,8,50.0%,11m
15762,1,Fess,3029,141,4,4,8,50.0%,22m
15762,1,QQQ,3029,112,4,5,9,44.4%,4m
15762,2,George,3029,58,3,0,3,100.0%,7m
15762,3,BuBu,3029,122,3,2,5,60.0%,27m
15762,2,dio,3029,0,1,0,1,100.0%,20m
15762,2,DarkTheSwarm,3029,0,1,0,1,100.0%,14m
15762,2,sanchez,3029,30,1,2,3,33.3%,7m
15762,1,Yōkai,3029,36,1,4,5,20.0%,2m
15762,2,DOOM,3029,0,0,1,1,0.0%,4m
15762,2,Slonopotam,3029,0,0,1,1,0.0%,3m
15762,2,Strixx,3029,0,0,2,2,0.0%,14m
15762,1,zing,3029,0,0,3,3,0.0%,7m
15788,2,IIIIIIIIIIII,3028,860,103,95,198,52.0%,14m
15788,1,[Noob98]BadYar,3028,1151,73,63,136,53.7%,21m
15788,1,ZeroPlay,3028,1152,53,41,94,56.4%,21m
15788,3,halflings,3028,790,42,44,86,48.8%,14m
15788,1,fafa,3028,580,37,30,67,55.2%,22m
15788,1,Nightmare,3028,381,32,19,51,62.7%,5m
15788,2,[Dek]AdVictoriam,3028,318,13,8,21,61.9%,12m
15788,2,chatomic,3028,310,11,8,19,57.9%,7m
15788,2,[80er]Ravensdark,3028,140,7,4,11,63.6%,36m
15788,2,[ialm]Kefaem,3028,32,2,0,2,100.0%,3m
15788,2,HunterDi,3028,32,2,0,2,100.0%,7m
15788,3,TheDon,3028,121,2,1,3,66.7%,32m
15788,2,Krakodeel,3028,30,2,2,4,50.0%,3m
15788,2,[инж]RaDy,3028,30,1,1,2,50.0%,7m
15788,2,[GNORKX]Darkstorm,3028,32,1,2,3,33.3%,20m
15788,2,CONTI,3028,0,0,1,1,0.0%,4m
15788,2,Илья,3028,0,0,1,1,0.0%,5m
15788,2,Jeez,3028,0,0,2,2,0.0%,17m
15806,1,[BBO]Martins,3027,937,88,79,167,52.7%,5m
15806,1,LAGERT,3027,1359,53,49,102,52.0%,4m
15806,2,Greywolf,3027,852,32,28,60,53.3%,10m
15806,3,Zhumamurat,3027,782,28,36,64,43.8%,4m
15806,1,[ЯD]Mono,3027,438,14,17,31,45.2%,13m
15806,1,enzo,3027,299,10,5,15,66.7%,21m
15806,1,[ToXin]SternJumper,3027,272,8,13,21,38.1%,17m
15806,2,PuwPuwTea,3027,192,6,2,8,75.0%,12m
15806,3,BIO,3027,158,4,1,5,80.0%,28m
15806,2,[BotN]FunkyBear,3027,88,3,1,4,75.0%,17m
15806,1,StahlTotal,3027,0,3,2,5,60.0%,33m
15806,2,Muvakasu,3027,90,3,3,6,50.0%,3m
15806,2,zed,3027,30,2,0,2,100.0%,20m
15806,2,Phoenix,3027,30,2,1,3,66.7%,4m
15806,1,[IFC]Aioria,3027,0,0,5,5,0.0%,11m
15821,3,Callboy,3026,879,34,35,69,49.3%,9m
15821,2,[SAoN]Solidtune,3026,574,21,21,42,50.0%,12m
15821,1,[OMGHAM]OMGJAMBON,3026,682,21,23,44,47.7%,21m
15821,2,YeZealver,3026,366,18,7,25,72.0%,3m
15821,2,Void,3026,448,16,16,32,50.0%,22m
15821,1,aiya,3026,287,11,10,21,52.4%,5m
15821,1,[theDH]SayNoToStim,3026,303,11,11,22,50.0%,15m
15821,1,DeepBlue,3026,265,10,11,21,47.6%,4m
15821,1,[50kT]MuzafAs,3026,334,10,15,25,40.0%,18m
15821,1,ToGato,3026,48,5,2,7,71.4%,1h
15821,2,[HBGSJR]BananOnFire,3026,126,4,2,6,66.7%,20m
15821,2,Maleb,3026,118,4,3,7,57.1%,21m
15821,2,FlipBack,3026,158,3,2,5,60.0%,1h
15821,2,kolyuchy,3026,125,3,3,6,50.0%,7m
15821,2,ZaZa,3026,30,2,2,4,50.0%,26m
15821,2,[CTLNG]Puffs,3026,0,0,1,1,0.0%,3m
15821,3,[AcoGF]Kinderrusik,3026,0,0,3,3,0.0%,44m
15838,1,Ratezzy,3025,1655,274,268,542,50.6%,4m
15838,1,[SMTeam]ALVARIS,3025,1654,199,187,386,51.6%,24m
15838,2,Omega,3025,1609,156,145,301,51.8%,10m
15838,2,[SCZA]YsterVuis,3025,1248,65,52,117,55.6%,14m
15838,1,LEX,3025,1046,61,67,128,47.7%,19m
15838,2,[ValidG]koluch,3025,744,60,34,94,63.8%,21m
15838,1,DEMON,3025,1541,55,55,110,50.0%,2m
15838,1,[ICECS]Deadward,3025,900,28,35,63,44.4%,19m
15838,1,KillemAll,3025,632,24,20,44,54.5%,23m
15838,1,tornis,3025,661,22,21,43,51.2%,9m
15838,2,BARTE,3025,566,22,21,43,51.2%,20m
15838,2,[Hehe]jcjs,3025,422,16,6,22,72.7%,3m
15838,2,Behnrow,3025,394,15,11,26,57.7%,20m
15838,2,FrozenBlood,3025,355,14,6,20,70.0%,10m
15838,1,[EPK]aky,3025,321,11,9,20,55.0%,15m
15838,1,bobo,3025,214,9,10,19,47.4%,15m
15838,3,XAM,3025,38,6,2,8,75.0%,17m
15838,2,Ragner,3025,150,5,0,5,100.0%,10m
15838,2,Sojerro,3025,0,4,1,5,80.0%,15m
15838,2,hoplita,3025,88,4,2,6,66.7%,24m
15838,3,Shriiimpy,3025,0,4,3,7,57.1%,1h
15838,2,Lastbreath,3025,92,4,4,8,50.0%,3m
15838,2,Daviar,3025,0,3,2,5,60.0%,10m
15838,1,Haaans,3025,68,2,5,7,28.6%,15m
15838,2,lightnid,3025,0,1,1,2,50.0%,3m
15838,2,Liet,3025,30,1,3,4,25.0%,7m
15838,2,Quasar,3025,30,1,4,5,20.0%,3m
15838,2,Silentium,3025,0,0,1,1,0.0%,8m
15838,1,NicolasCage,3025,0,0,5,5,0.0%,38m
15867,3,Necros,3024,1108,203,194,397,51.1%,19m
15867,3,ArtiomR,3024,934,186,197,383,48.6%,21m
15867,3,xukxuk,3024,1150,93,96,189,49.2%,14m
15867,1,[Torito]Punisher,3024,1187,43,41,84,51.2%,9m
15867,2,[TTIS]PoppZg,3024,681,28,22,50,56.0%,21m
15867,1,[ZERGSC]MrZerg,3024,570,27,15,42,64.3%,7m
15867,2,FILIN,3024,556,24,16,40,60.0%,7m
15867,2,Poseidon,3024,346,16,8,24,66.7%,7m
15867,2,BlackShark,3024,225,8,6,14,57.1%,1h
15867,2,[canZeg]oscaridley,3024,36,5,2,7,71.4%,11m
15867,1,Symolk,3024,97,4,2,6,66.7%,27m
15867,1,[OBSCFR]Yokorichi,3024,142,4,6,10,40.0%,23m
15867,2,Baoba,3024,60,3,2,5,60.0%,24m
15867,2,Theo,3024,0,3,2,5,60.0%,14m
15867,2,Fahr,3024,60,3,2,5,60.0%,20m
15867,1,Citramone,3024,0,3,2,5,60.0%,15m
15867,2,Samnya,3024,30,2,0,2,100.0%,14m
15867,1,misc,3024,95,2,3,5,40.0%,7m
15867,1,Gabriel,3024,38,2,3,5,40.0%,7m
15867,1,Adentalis,3024,40,2,7,9,22.2%,4m
15867,2,Hemetle,3024,0,1,0,1,100.0%,3m
15867,1,Gamechance,3024,0,1,1,2,50.0%,23m
15867,2,[РSISТМ]SoulScream,3024,30,1,1,2,50.0%,10m
15867,1,[AiRǂ]Mick,3024,0,1,8,9,11.1%,19m
15891,3,[Petrиs]serlamp,3023,1524,227,223,450,50.4%,3m
15891,3,Budinho,3023,1466,183,167,350,52.3%,9m
15891,3,ydear,3023,1572,160,154,314,51.0%,21m
15891,1,Dizzy,3023,1528,140,136,276,50.7%,18m
15891,1,mATz,3023,1658,72,66,138,52.2%,9m
15891,3,Drölf,3023,376,65,55,120,54.2%,26m
15891,1,Blackion,3023,1405,54,46,100,54.0%,4m
15891,1,corbata,3023,1482,51,56,107,47.7%,17m
15891,2,Redox,3023,534,21,12,33,63.6%,10m
15891,3,AsseyMcGhee,3023,340,12,16,28,42.9%,18m
15891,2,Бамбульба,3023,283,11,4,15,73.3%,10m
15891,2,gatorok,3023,194,7,0,7,100.0%,26m
15891,1,Wonderdream,3023,258,7,13,20,35.0%,23m
15891,1,Smidi,3023,186,6,0,6,100.0%,1h
15891,1,[theoz]Milanor,3023,97,4,2,6,66.7%,28m
15891,2,Hethron,3023,124,4,4,8,50.0%,12m
15891,2,toine,3023,60,3,2,5,60.0%,14m
15891,2,Mark,3023,62,3,2,5,60.0%,17m
15891,1,[HeMK]ÁnKH,3023,70,2,6,8,25.0%,21m
15891,3,Strider,3023,58,2,13,15,13.3%,26m
15891,2,montri,3023,30,1,4,5,20.0%,10m
15891,2,Neksus,3023,0,0,2,2,0.0%,20m
15913,1,[ToWaSt]Assazhi,3022,1011,179,167,346,51.7%,25m
15913,2,[QTcIub]TrollingPoo,3022,1469,92,84,176,52.3%,3m
15913,2,BAMBOOZLE,3022,1067,90,86,176,51.1%,7m
15913,1,[meiste]KarmraK,3022,888,62,67,129,48.1%,22m
15913,2,ReVan,3022,1509,61,51,112,54.5%,11m
15913,1,[ZERGTB]Fimnesorz,3022,753,29,26,55,52.7%,8m
15913,2,Raven,3022,778,28,31,59,47.5%,19m
15913,2,Matz,3022,662,26,22,48,54.2%,12m
15913,2,Imissmycat,3022,246,10,6,16,62.5%,12m
15913,1,Saoky,3022,257,7,11,18,38.9%,21m
15913,2,NastyFarts,3022,184,6,6,12,50.0%,4m
15913,1,Wackd,3022,222,6,8,14,42.9%,8m
15913,1,LynX,3022,142,5,3,8,62.5%,17m
15913,2,[PænAm]fidzysss,3022,150,5,5,10,50.0%,8m
15913,2,OnionKing,3022,88,4,2,6,66.7%,10m
15913,3,[TRYHD]Osroni,3022,0,4,3,7,57.1%,20m
15913,2,ArkMan,3022,0,3,1,4,75.0%,19m
15913,1,[WRYH]LUFEN,3022,119,3,2,5,60.0%,25m
15913,2,korail,3022,141,3,2,5,60.0%,4m
15913,2,xiaojian,3022,0,3,2,5,60.0%,4m
15913,2,gesgincy,3022,30,2,0,2,100.0%,3m
15913,1,PymS,3022,70,2,9,11,18.2%,18m
15913,2,Warfield,3022,0,1,0,1,100.0%,22m
15913,3,[idntcr]Ameron,3022,0,1,0,1,100.0%,14m
15913,2,TitusPullo,3022,0,1,0,1,100.0%,3m
15913,2,HEKPOMAHT,3022,0,0,1,1,0.0%,14m
15913,3,Jediknight,3022,0,0,2,2,0.0%,35m
15913,1,[KAOTx]Morlag,3022,0,0,6,6,0.0%,24m
15941,1,BlackRabbit,3021,1205,301,278,579,52.0%,4m
15941,1,[SHAME]Mats,3021,1625,126,114,240,52.5%,5m
15941,1,Troddler,3021,773,53,51,104,51.0%,7m
15941,3,Raven,3021,1286,48,59,107,44.9%,10m
15941,1,MuShu,3021,618,22,23,45,48.9%,8m
15941,2,LUREKER,3021,458,19,11,30,63.3%,2m
15941,2,GAMBIT,3021,492,19,18,37,51.4%,23m
15941,2,[Z3RGTV]MrPanda,3021,446,17,11,28,60.7%,20m
15941,3,Morpheus,3021,373,15,17,32,46.9%,9m
15941,1,TimmyPo,3021,384,13,15,28,46.4%,4m
15941,1,jurgen,3021,289,12,9,21,57.1%,18m
15941,2,Ven,3021,109,11,11,22,50.0%,9m
15941,3,Змей,3021,208,9,4,13,69.2%,1h
15941,3,[FLTY]Bubble,3021,124,7,4,11,63.6%,8m
15941,2,Quakeman,3021,94,4,0,4,100.0%,21m
15941,3,Cabinlake,3021,155,4,1,5,80.0%,20m
15941,1,Hyrum,3021,82,4,6,10,40.0%,13m
15941,2,HybRiDDark,3021,58,2,1,3,66.7%,6m
15941,2,NightMare,3021,32,2,2,4,50.0%,4m
15941,2,Andrzej,3021,64,2,3,5,40.0%,10m
15941,1,Freddy,3021,48,1,1,2,50.0%,32m
15941,1,Lamerluzo,3021,48,1,1,2,50.0%,1h
15941,2,Pox,3021,0,0,1,1,0.0%,14m
15964,3,Legendor,3020,1528,293,280,573,51.1%,7m
15964,1,PythonCoder,3020,739,96,74,170,56.5%,19m
15964,2,[БГТ]Rider,3020,1546,92,62,154,59.7%,5m
15964,1,SpaceDragon,3020,801,36,26,62,58.1%,15m
15964,2,[RUMEN]NightSpirit,3020,410,23,9,32,71.9%,24m
15964,1,[КПCC]Busia,3020,435,20,11,31,64.5%,16m
15964,1,Nihayo,3020,608,19,21,40,47.5%,5m
15964,1,malo,3020,539,18,17,35,51.4%,9m
15964,1,ramirez,3020,486,18,17,35,51.4%,3m
15964,2,JigSAW,3020,438,17,10,27,63.0%,14m
15964,1,llllllllllll,3020,393,16,4,20,80.0%,33m
15964,1,Galileo,3020,291,15,18,33,45.5%,7m
15964,2,beginner,3020,298,13,9,22,59.1%,17m
15964,2,Karamazad,3020,258,10,12,22,45.5%,11m
15964,1,lovemyson,3020,372,10,12,22,45.5%,2m
15964,3,iPlayMuted,3020,250,9,3,12,75.0%,26m
15964,2,Ghurdhyll,3020,197,9,6,15,60.0%,22m
15964,1,Khuul,3020,221,9,8,17,52.9%,7m
15964,2,[RDDN]Tsyuko,3020,193,8,5,13,61.5%,35m
15964,2,Mazel,3020,192,7,7,14,50.0%,21m
15964,2,Night,3020,178,5,2,7,71.4%,2m
15964,1,Slenderjohn,3020,145,5,3,8,62.5%,13m
15964,1,[Nissan]Mikkelkriz,3020,150,5,7,12,41.7%,18m
15964,2,zamanafg,3020,0,4,1,5,80.0%,14m
15964,2,QuB,3020,88,4,2,6,66.7%,5m
15964,3,Frantastic,3020,118,3,2,5,60.0%,25m
15964,1,StupidGuy,3020,0,3,2,5,60.0%,13m
15964,2,shaMash,3020,30,3,3,6,50.0%,24m
15964,2,Draywer,3020,58,2,3,5,40.0%,2m
15964,1,[eli]MrSnibbles,3020,40,2,6,8,25.0%,23m
15964,2,Karambol,3020,30,1,2,3,33.3%,7m
15964,2,line,3020,0,1,2,3,33.3%,3m
15964,2,blackrain,3020,0,0,1,1,0.0%,23m
15964,2,IIIIIIIIIIII,3020,0,0,1,1,0.0%,9m
15964,2,Mateidin,3020,0,0,1,1,0.0%,7m
15999,1,Yxios,3019,1706,116,104,220,52.7%,19m
15999,2,[Petrиs]JusttheKeL,3019,1417,113,92,205,55.1%,7m
15999,1,LoLiKoN,3019,899,62,55,117,53.0%,4m
15999,1,Echo,3019,1572,60,58,118,50.8%,23m
15999,1,[rush77]CannonRush,3019,1197,51,45,96,53.1%,10m
15999,2,Hose,3019,1163,48,38,86,55.8%,12m
15999,3,Caamos,3019,1212,47,47,94,50.0%,21m
15999,2,Moffe,3019,1182,46,38,84,54.8%,25m
15999,1,Houden,3019,703,34,33,67,50.7%,7m
15999,2,Echocorp,3019,430,25,16,41,61.0%,14m
15999,1,SpaceRU,3019,551,25,18,43,58.1%,15m
15999,2,Testi,3019,426,17,15,32,53.1%,17m
15999,2,[DOKA2]ButterflyMuM,3019,331,14,13,27,51.9%,21m
15999,1,Malrick,3019,428,13,19,32,40.6%,18m
15999,2,bestlover,3019,340,12,11,23,52.2%,20m
15999,2,Raymond,3019,272,11,11,22,50.0%,21m
15999,2,torvaldd,3019,286,10,10,20,50.0%,10m
15999,2,[NerCC]juice,3019,172,6,5,11,54.5%,12m
15999,1,Spald,3019,186,5,10,15,33.3%,21m
15999,1,JimboYOYO,3019,150,4,8,12,33.3%,21m
15999,1,General,3019,148,4,9,13,30.8%,10m
15999,1,Comendent,3019,0,3,2,5,60.0%,39m
15999,1,Dallacost,3019,72,3,7,10,30.0%,18m
15999,2,[BGDK]Viking,3019,32,2,3,5,40.0%,22m
15999,3,MrMiddleTv,3019,0,1,1,2,50.0%,25m
15999,3,Garet,3019,40,1,2,3,33.3%,17m
15999,2,TheDexter,3019,0,0,1,1,0.0%,3m
15999,1,Zerginator,3019,0,0,1,1,0.0%,3m
15999,2,bustarythmic,3019,0,0,1,1,0.0%,3m
15999,2,HavanaBanana,3019,0,0,1,1,0.0%,26m
15999,1,Ragecry,3019,0,0,1,1,0.0%,15m
15999,2,PrApricot,3019,0,0,3,3,0.0%,4m
16031,3,gepeka,3018,1513,404,403,807,50.1%,12m
16031,2,[Berode]Volcan,3018,1374,198,189,387,51.2%,11m
16031,2,DonRicardo,3018,1198,98,96,194,50.5%,4m
16031,1,Muchaillon,3018,1629,86,72,158,54.4%,6m
16031,1,Batesh,3018,931,79,73,152,52.0%,2m
16031,2,Fon,3018,1399,69,55,124,55.6%,17m
16031,1,Saint,3018,1165,69,58,127,54.3%,8m
16031,2,gaz,3018,798,68,59,127,53.5%,14m
16031,2,miniBARIGA,3018,1077,44,37,81,54.3%,11m
16031,2,Abies,3018,526,22,13,35,62.9%,18m
16031,3,McWolf,3018,626,22,33,55,40.0%,3m
16031,3,[GROF]NonServiamGR,3018,584,19,31,50,38.0%,8m
16031,2,Ramgoroht,3018,302,13,12,25,52.0%,4m
16031,3,[FurRev]Bit,3018,223,13,20,33,39.4%,10m
16031,1,[DOKA2]СтарыйВолк,3018,216,7,9,16,43.8%,25m
16031,1,[DZ16]PREDATOR,3018,246,7,10,17,41.2%,19m
16031,2,Rares,3018,116,5,2,7,71.4%,4m
16031,2,FreeZeeS,3018,193,5,6,11,45.5%,19m
16031,1,Tesla,3018,142,4,9,13,30.8%,4m
16031,2,sergio,3018,58,3,0,3,100.0%,23m
16031,2,[BBT]Acheloo,3018,0,3,2,5,60.0%,6m
16031,1,Rexar,3018,0,3,2,5,60.0%,7m
16031,2,NewbConsumeR,3018,0,2,3,5,40.0%,8m
16031,1,[Zelts]bbbloodmaker,3018,120,2,7,9,22.2%,2m
16031,2,Hyuk,3018,0,0,1,1,0.0%,10m
16031,2,Derian,3018,0,0,1,1,0.0%,10m
16031,3,Herodotus,3018,0,0,2,2,0.0%,1h
16058,1,MafusalemRex,3017,1686,365,356,721,50.6%,8m
16058,2,firefox,3017,1633,123,118,241,51.0%,7m
16058,3,Maugli,3017,1436,114,113,227,50.2%,24m
16058,1,aliocha,3017,1161,79,55,134,59.0%,23m
16058,3,SmadnyM,3017,1394,77,83,160,48.1%,12m
16058,1,Mxchael,3017,1068,44,39,83,53.0%,13m
16058,1,[ExTr1m]HeadCrabe,3017,856,37,29,66,56.1%,24m
16058,1,[ǺŁǻşłđ]DEVOSTATOR,3017,551,26,11,37,70.3%,21m
16058,2,Magic,3017,276,18,12,30,60.0%,12m
16058,2,TentAcle,3017,473,18,14,32,56.2%,4m
16058,1,nklzwei,3017,312,13,9,22,59.1%,18m
16058,1,MrPink,3017,348,10,15,25,40.0%,10m
16058,1,Licht,3017,229,9,9,18,50.0%,16m
16058,1,[Sabat]Baikotesla,3017,222,7,3,10,70.0%,10m
16058,1,[H2OKT]Hydroïde,3017,233,7,7,14,50.0%,13m
16058,2,ilcac,3017,142,6,3,9,66.7%,20m
16058,1,Fruityloop,3017,181,6,5,11,54.5%,21m
16058,1,[pfdsva]fabian,3017,97,3,0,3,100.0%,26m
16058,1,[KDV]DemonUther,3017,40,2,4,6,33.3%,16m
16058,2,[BMDR]ItsLaura,3017,0,1,1,2,50.0%,4m
16058,2,daracorne,3017,0,0,2,2,0.0%,21m
16079,3,Elrond,3016,678,238,245,483,49.3%,18m
16079,2,[HBAR1]Blackbear,3016,1170,117,105,222,52.7%,4m
16079,2,kazuma,3016,1626,76,64,140,54.3%,12m
16079,3,PsychoHD,3016,704,59,62,121,48.8%,15m
16079,2,StiflersMoM,3016,717,34,23,57,59.6%,19m
16079,1,IIIIIIIIIIII,3016,581,22,23,45,48.9%,19m
16079,1,[RBTV4]mildesign,3016,518,18,15,33,54.5%,15m
16079,1,Fruityloop,3016,514,17,18,35,48.6%,21m
16079,1,BanglaDezu,3016,431,14,13,27,51.9%,19m
16079,1,RedEye,3016,255,13,12,25,52.0%,18m
16079,3,Stig,3016,270,12,10,22,54.5%,18m
16079,1,SKINNYMANDAN,3016,238,11,6,17,64.7%,15m
16079,2,DimonLimon,3016,244,10,9,19,52.6%,17m
16079,3,abracula,3016,205,9,9,18,50.0%,21m
16079,1,Beatso,3016,188,5,11,16,31.2%,18m
16079,1,Glith,3016,0,4,1,5,80.0%,1h
16079,1,[iPie]Tucson,3016,0,4,1,5,80.0%,1h
16079,3,llirik,3016,174,4,12,16,25.0%,20m
16079,1,[Cancro]Schipper,3016,0,3,2,5,60.0%,23m
16079,3,Chibbn,3016,137,3,3,6,50.0%,1h
16079,2,[BIllIG]JoeBlack,3016,30,1,1,2,50.0%,26m
16079,1,FuzzyDezzy,3016,0,1,1,2,50.0%,8m
16079,1,[Tr0led]Tibi,3016,48,1,2,3,33.3%,29m
16079,2,[JSC]MightyBeast,3016,0,0,1,1,0.0%,10m
16079,2,[SGlina]Annoobis,3016,0,0,1,1,0.0%,3m
16104,1,AtomBurger,3015,1686,171,171,342,50.0%,25m
16104,1,Rainbow,3015,1318,87,79,166,52.4%,21m
16104,1,rtfleg,3015,1597,86,92,178,48.3%,3m
16104,1,JackRackham,3015,1050,69,68,137,50.4%,18m
16104,2,Nicoleon,3015,1558,63,51,114,55.3%,3m
16104,2,Mimean,3015,1231,54,44,98,55.1%,23m
16104,2,kimmaks,3015,475,44,28,72,61.1%,7m
16104,2,Jarken,3015,786,33,27,60,55.0%,3m
16104,2,[KBLNZ]Commander,3015,679,29,18,47,61.7%,21m
16104,2,ITACHI,3015,306,22,16,38,57.9%,7m
16104,2,Tyrant,3015,535,20,16,36,55.6%,4m
16104,2,[SeeLaw]Jordan,3015,468,18,12,30,60.0%,7m
16104,1,Leeroooy,3015,556,18,17,35,51.4%,5m
16104,2,Nemesis,3015,329,13,5,18,72.2%,7m
16104,2,[Clocks]Euphoria,3015,354,12,13,25,48.0%,3m
16104,2,Clef,3015,283,11,9,20,55.0%,9m
16104,1,Zärdaar,3015,277,10,9,19,52.6%,1h
16104,3,pirinqui,3015,131,6,5,11,54.5%,23m
16104,2,onkelmichael,3015,30,5,2,7,71.4%,23m
16104,3,TVOUMATIBAL,3015,0,4,3,7,57.1%,31m
16104,2,Feebleminded,3015,60,2,1,3,66.7%,4m
16104,2,[zQ]EpileptiCz,3015,58,2,2,4,50.0%,4m
16104,2,Pain,3015,46,1,4,5,20.0%,32m
16104,3,GolemXIV,3015,0,0,1,1,0.0%,2m
16104,3,Dalevi,3015,0,0,2,2,0.0%,7m
16104,1,saldoms,3015,0,0,7,7,0.0%,7m
16130,1,Psihos,3014,1676,161,149,310,51.9%,16m
16130,1,Lucas,3014,1349,113,107,220,51.4%,16m
16130,1,Ari,3014,1621,95,85,180,52.8%,6m
16130,2,djN,3014,956,79,67,146,54.1%,14m
16130,1,Dave,3014,796,60,54,114,52.6%,9m
16130,1,[CMBO]eOliAs,3014,518,19,25,44,43.2%,4m
16130,1,[MƟV]arrasulov,3014,346,16,8,24,66.7%,12m
16130,2,[Axolot]Fantasy,3014,408,16,13,29,55.2%,7m
16130,2,Jhax,3014,363,14,12,26,53.8%,7m
16130,3,Nightmare,3014,244,13,15,28,46.4%,22m
16130,2,[RIPERY]cezar,3014,286,10,5,15,66.7%,22m
16130,3,AweNaaiers,3014,167,8,2,10,80.0%,1h
16130,2,Tatara,3014,208,8,5,13,61.5%,7m
16130,2,iado,3014,193,7,3,10,70.0%,7m
16130,2,[Brink]RoyalPudding,3014,162,5,1,6,83.3%,10m
16130,2,Looz,3014,88,4,2,6,66.7%,3m
16130,2,SLAM,3014,60,3,1,4,75.0%,15m
16130,2,VupsMeM,3014,86,3,2,5,60.0%,10m
16130,2,Reddhuth,3014,32,2,2,4,50.0%,11m
16130,3,[T1LT]nALLIA,3014,119,2,3,5,40.0%,6m
16130,2,Wong,3014,0,1,0,1,100.0%,7m
16130,1,VersaLife,3014,40,1,4,5,20.0%,26m
16130,2,Archangel,3014,0,0,1,1,0.0%,36m
16130,2,Wardead,3014,0,0,2,2,0.0%,9m
16154,3,trent,3013,1602,205,196,401,51.1%,14m
16154,1,Belisar,3013,1658,157,142,299,52.5%,6m
16154,1,niwder,3013,1361,108,87,195,55.4%,12m
16154,3,giuseppe,3013,1148,103,97,200,51.5%,18m
16154,3,Nefeew,3013,1509,102,93,195,52.3%,8m
16154,3,NEL,3013,527,98,98,196,50.0%,6m
16154,1,[Blatzs]Morpheus,3013,1486,62,49,111,55.9%,19m
16154,3,Jasperera,3013,1275,57,52,109,52.3%,6m
16154,1,[300IQ]AverDroz,3013,756,34,26,60,56.7%,21m
16154,1,Bonjour,3013,843,32,30,62,51.6%,21m
16154,2,toly,3013,646,29,14,43,67.4%,23m
16154,2,mingus,3013,780,28,28,56,50.0%,7m
16154,1,Doose,3013,662,24,24,48,50.0%,25m
16154,1,[FLBAR]BaRmaleY,3013,485,17,15,32,53.1%,25m
16154,2,VITgames,3013,390,16,13,29,55.2%,14m
16154,2,AllPlay,3013,352,13,9,22,59.1%,3m
16154,3,whatt,3013,227,13,10,23,56.5%,20m
16154,1,ich,3013,437,13,15,28,46.4%,3m
16154,1,iLikeCake,3013,190,7,6,13,53.8%,16m
16154,1,Tritol,3013,220,7,7,14,50.0%,11m
16154,2,Кейхен,3013,185,6,2,8,75.0%,14m
16154,1,Blaablaablaa,3013,138,5,8,13,38.5%,24m
16154,1,MakkO,3013,190,5,9,14,35.7%,17m
16154,2,WoKoOne,3013,58,3,0,3,100.0%,20m
16154,2,ProFFeSSoR,3013,0,3,2,5,60.0%,3m
16154,2,NorboS,3013,0,3,2,5,60.0%,10m
16154,1,[UNoS]JackLawless,3013,140,3,4,7,42.9%,1h
16154,1,[ZERGML]Gabriel,3013,97,3,8,11,27.3%,2m
16154,2,jbraav,3013,0,1,1,2,50.0%,6m
16154,2,Safrax,3013,0,1,1,2,50.0%,8m
16154,2,KKolloboKK,3013,30,1,1,2,50.0%,20m
16154,2,[HTOWN]CREHZ,3013,0,0,2,2,0.0%,8m
16186,1,ARIOCH,3012,1509,95,89,184,51.6%,21m
16186,2,Comète,3012,1507,70,63,133,52.6%,21m
16186,3,llllllll,3012,458,19,22,41,46.3%,8m
16186,2,PinkGuy,3012,264,12,1,13,92.3%,17m
16186,2,Aquaman,3012,339,12,11,23,52.2%,21m
16186,2,[ZaG]LTrain,3012,252,10,6,16,62.5%,16m
16186,2,Direxus,3012,260,9,10,19,47.4%,21m
16186,2,Mousca,3012,179,8,5,13,61.5%,9m
16186,3,dde,3012,183,7,4,11,63.6%,1h
16186,2,[profit]HellothereXD,3012,114,5,1,6,83.3%,14m
16186,1,[JPF]Tordehole,3012,100,4,1,5,80.0%,25m
16186,2,WINDTRAS,3012,118,3,0,3,100.0%,17m
16186,1,Agetheman,3012,0,3,2,5,60.0%,1h
16186,2,Terminus,3012,0,3,2,5,60.0%,17m
16186,2,KaZiel,3012,0,3,2,5,60.0%,23m
16186,3,PrX,3012,58,3,9,12,25.0%,3m
16186,3,Kutuzoff,3012,38,2,3,5,40.0%,7m
16186,1,zGerGou,3012,48,2,5,7,28.6%,31m
16186,2,[ATRS]Supaserrin,3012,0,1,0,1,100.0%,2m
16186,2,[Nipps]SITTner,3012,0,1,0,1,100.0%,26m
16186,2,JoSecret,3012,30,1,2,3,33.3%,23m
16186,2,[lLiTl]Raviens,3012,0,0,1,1,0.0%,23m
16186,2,[UAŦeam]SMILE,3012,0,0,1,1,0.0%,8m
16186,2,MIRUKY,3012,0,0,2,2,0.0%,11m
16186,1,Lassa,3012,0,0,10,10,0.0%,25m
16211,1,Mahzun,3011,1648,133,129,262,50.8%,22m
16211,2,HvnShallBurn,3011,744,102,54,156,65.4%,7m
16211,3,BigRod,3011,924,100,71,171,58.5%,21m
16211,1,TheFinder,3011,1629,88,84,172,51.2%,16m
16211,1,Taco,3011,695,65,55,120,54.2%,4m
16211,1,[BO0bs]Marko,3011,416,52,37,89,58.4%,4m
16211,2,[W2L]emperLex,3011,444,43,28,71,60.6%,20m
16211,2,Shyama,3011,967,42,29,71,59.2%,3m
16211,1,CHRAND,3011,535,34,28,62,54.8%,26m
16211,1,ndn,3011,692,28,35,63,44.4%,21m
16211,2,Daemos,3011,728,27,23,50,54.0%,4m
16211,2,Treadstoun,3011,606,24,16,40,60.0%,23m
16211,3,Ostkaka,3011,588,23,24,47,48.9%,6m
16211,2,Redfild,3011,290,13,11,24,54.2%,7m
16211,2,Drobovik,3011,312,11,11,22,50.0%,11m
16211,2,[EZKBM]Dildozer,3011,267,9,7,16,56.2%,3m
16211,2,[дгд]Eddie,3011,196,7,0,7,100.0%,11m
16211,1,[RCDG]APCL,3011,30,6,2,8,75.0%,12m
16211,2,[RBlood]poketoss,3011,189,6,2,8,75.0%,12m
16211,2,[0BO]Leo,3011,114,6,6,12,50.0%,11m
16211,2,LKNR,3011,136,4,0,4,100.0%,12m
16211,2,Spooky,3011,30,4,3,7,57.1%,9m
16211,1,Average,3011,30,4,4,8,50.0%,24m
16211,2,Xador,3011,169,4,8,12,33.3%,1h
16211,2,RedRosa,3011,86,3,2,5,60.0%,10m
16211,2,Nemesis,3011,92,3,3,6,50.0%,17m
16211,2,NoWhale,3011,94,3,6,9,33.3%,20m
16211,1,Halfies,3011,82,2,8,10,20.0%,5m
16211,2,Jester,3011,0,1,0,1,100.0%,3m
16211,2,Comeback,3011,0,1,0,1,100.0%,21m
16211,2,[wedown]MrQ,3011,0,1,1,2,50.0%,18m
16211,3,[aW]darkpouet,3011,0,1,3,4,25.0%,25m
16211,2,HolzPirat,3011,0,0,1,1,0.0%,26m
16211,2,mishocii,3011,0,0,1,1,0.0%,14m
16211,2,[Lowko]Snek,3011,0,0,1,1,0.0%,19m
16211,2,popacremnem,3011,0,0,3,3,0.0%,5m
16247,2,pooh,3010,1614,360,321,681,52.9%,3m
16247,3,Fejm,3010,1597,274,263,537,51.0%,16m
16247,1,Lis,3010,1588,136,131,267,50.9%,16m
16247,2,[GSRbe]Tenebris,3010,1296,52,43,95,54.7%,4m
16247,2,[WАSD]Esirai,3010,1313,52,45,97,53.6%,20m
16247,1,[RomaJL]Luckerok,3010,734,46,48,94,48.9%,9m
16247,2,Tsunami,3010,626,44,41,85,51.8%,18m
16247,1,Razvan,3010,585,40,46,86,46.5%,18m
16247,1,Bnkyo,3010,1042,35,38,73,47.9%,9m
16247,2,[BRSKR]Berzerker,3010,497,22,9,31,71.0%,4m
16247,2,Interior,3010,319,13,9,22,59.1%,23m
16247,1,Space,3010,299,12,8,20,60.0%,18m
16247,2,SweetRamekin,3010,288,10,11,21,47.6%,23m
16247,2,daniel,3010,174,7,6,13,53.8%,3m
16247,1,StasOda,3010,0,4,2,6,66.7%,1h
16247,1,[PFLM1N]VIT,3010,97,4,2,6,66.7%,1h
16247,2,Zethros,3010,86,3,2,5,60.0%,18m
16247,2,Kyrito,3010,58,3,2,5,60.0%,4m
16247,2,RobinMaster,3010,70,3,4,7,42.9%,12m
16247,2,[GGL1]ossir,3010,30,2,2,4,50.0%,20m
16247,1,vova,3010,0,2,3,5,40.0%,18m
16247,2,[Horst]RolfDieter,3010,30,1,1,2,50.0%,3m
16247,2,[Evins]Shalomandra,3010,36,1,3,4,25.0%,12m
16247,2,Masturbp,3010,32,1,3,4,25.0%,11m
16247,2,NumberTh,3010,0,0,2,2,0.0%,41m
16247,2,[ǺŁǻşłđ]Комбайнер,3010,0,0,2,2,0.0%,23m
16247,2,Tétonus,3010,0,0,3,3,0.0%,3m
16274,1,goblin,3009,1251,64,67,131,48.9%,22m
16274,1,VacuumDecay,3009,902,42,43,85,49.4%,4m
16274,1,Cnsbmkpsr,3009,674,36,32,68,52.9%,10m
16274,2,ПапаХома,3009,182,21,21,42,50.0%,21m
16274,3,Trygan,3009,472,20,16,36,55.6%,7m
16274,2,daniel,3009,379,15,9,24,62.5%,9m
16274,1,Zerratul,3009,256,11,8,19,57.9%,26m
16274,1,DIVERSANT,3009,237,8,7,15,53.3%,16m
16274,2,WizardCZ,3009,210,7,3,10,70.0%,16m
16274,1,Bacilianus,3009,162,6,9,15,40.0%,19m
16274,1,Nasekomoe,3009,0,4,1,5,80.0%,18m
16274,3,schlachter,3009,121,4,2,6,66.7%,24m
16274,2,voneol,3009,58,3,1,4,75.0%,12m
16274,2,[5SG]Sakreton,3009,0,3,2,5,60.0%,17m
16274,1,[L3F]aguibast,3009,34,3,5,8,37.5%,21m
16274,2,[wtw]WEITNOW,3009,32,2,2,4,50.0%,10m
16274,2,[AI0N]ZeN,3009,62,2,5,7,28.6%,19m
16274,2,MosDefinite,3009,60,2,5,7,28.6%,26m
16274,2,Minifutzi,3009,0,1,0,1,100.0%,23m
16274,1,[LDAD]Octopusy,3009,0,1,2,3,33.3%,35m
16274,2,[Ðicey]chuckles,3009,0,0,1,1,0.0%,16m
16295,1,Mnauk,3008,1596,188,178,366,51.4%,19m
16295,1,[voff]lighter,3008,1137,82,67,149,55.0%,6m
16295,1,AlphaLegion,3008,1268,71,56,127,55.9%,7m
16295,2,Rekrul,3008,951,44,32,76,57.9%,9m
16295,2,Tikovka,3008,894,39,28,67,58.2%,6m
16295,1,Danil,3008,938,31,36,67,46.3%,25m
16295,2,reckoner,3008,560,28,26,54,51.9%,26m
16295,2,Zilmer,3008,586,25,16,41,61.0%,21m
16295,2,Hanurik,3008,558,21,18,39,53.8%,10m
16295,1,Philosopher,3008,511,19,21,40,47.5%,4m
16295,1,[Arrows]AID,3008,451,18,14,32,56.2%,16m
16295,2,[lOoOl]microjackson,3008,425,18,18,36,50.0%,12m
16295,1,idaniel,3008,490,14,22,36,38.9%,16m
16295,1,VoiD,3008,432,13,17,30,43.3%,24m
16295,2,Kampen,3008,336,11,9,20,55.0%,20m
16295,1,[TNTeam]titipieds,3008,285,11,10,21,52.4%,21m
16295,2,[ЗЛО]catbert,3008,278,10,8,18,55.6%,9m
16295,1,Nori,3008,319,10,11,21,47.6%,9m
16295,2,Febio,3008,266,9,9,18,50.0%,1h
16295,1,GranPapino,3008,209,8,7,15,53.3%,12m
16295,2,Miracle,3008,156,6,5,11,54.5%,14m
16295,1,LetaL,3008,237,6,8,14,42.9%,6m
16295,1,modmoto,3008,222,6,10,16,37.5%,20m
16295,2,baroni,3008,88,5,1,6,83.3%,13m
16295,1,DawnStar,3008,110,4,11,15,26.7%,10m
16295,1,hony,3008,0,3,2,5,60.0%,36m
16295,3,Panda,3008,97,3,3,6,50.0%,27m
16295,1,adione,3008,120,2,5,7,28.6%,4m
16295,2,Keller,3008,0,1,0,1,100.0%,6m
16295,2,[1ami1]elEnd,3008,0,0,1,1,0.0%,4m
16295,1,Drake,3008,0,0,1,1,0.0%,1h
16295,2,Smops,3008,0,0,2,2,0.0%,22m
16295,1,sOme,3008,0,0,4,4,0.0%,13m
16295,1,xPaulAvocatx,3008,0,0,4,4,0.0%,15m
16329,2,Maneken,3007,1619,278,260,538,51.7%,16m
16329,1,[UWDIE]Khimi,3007,1448,55,50,105,52.4%,9m
16329,2,[Ob8G]IconicKnight,3007,1259,52,46,98,53.1%,14m
16329,2,rabbagast,3007,910,49,33,82,59.8%,24m
16329,1,Flaku,3007,865,38,30,68,55.9%,15m
16329,1,[FiDePu]PikaPika,3007,970,37,43,80,46.2%,13m
16329,1,[K2A]Lliks,3007,498,18,17,35,51.4%,13m
16329,1,[AgnG]LightRider,3007,475,17,19,36,47.2%,21m
16329,3,[SeeDes]DONrebe,3007,300,13,13,26,50.0%,9m
16329,2,Saryrn,3007,314,11,6,17,64.7%,12m
16329,3,starlord,3007,314,11,21,32,34.4%,16m
16329,1,MrQuintle,3007,232,7,12,19,36.8%,22m
16329,1,[SAKZ]deleirei,3007,198,6,7,13,46.2%,7m
16329,1,Evilz,3007,218,6,11,17,35.3%,5m
16329,2,gelbeskY,3007,225,5,6,11,45.5%,1h
16329,3,Henrik,3007,130,5,18,23,21.7%,8m
16329,2,[Heel]derBimbo,3007,112,3,0,3,100.0%,3m
16329,1,[SupPup]lolololdi,3007,0,2,3,5,40.0%,1h
16329,2,GrUvi,3007,58,2,3,5,40.0%,9m
16329,2,Kalan,3007,0,1,0,1,100.0%,6m
16329,3,TheDarkVoice,3007,0,1,0,1,100.0%,20m
16329,2,[Daelam]Nikaelam,3007,0,1,0,1,100.0%,17m
16329,2,Niourk,3007,0,1,2,3,33.3%,33m
16329,2,TinTin,3007,0,1,3,4,25.0%,17m
16329,1,Erex,3007,46,1,5,6,16.7%,24m
16329,1,[Mastrs]Zipper,3007,0,0,2,2,0.0%,15m
16329,1,You,3007,0,0,4,4,0.0%,23m
16356,3,[DVCE]PurpleHaze,3006,1062,217,208,425,51.1%,21m
16356,1,lirostin,3006,1471,189,179,368,51.4%,4m
16356,2,HavilandTuf,3006,1602,136,135,271,50.2%,26m
16356,1,[Dread]MackWinston,3006,1681,119,113,232,51.3%,26m
16356,2,Walhy,3006,1648,89,72,161,55.3%,3m
16356,1,[AIRfgt]theDESTROYER,3006,1636,62,67,129,48.1%,6m
16356,3,Moglaw,3006,1395,58,67,125,46.4%,10m
16356,1,DragonEagle,3006,997,43,41,84,51.2%,16m
16356,1,CanadianZerg,3006,977,38,37,75,50.7%,10m
16356,1,Mandrake,3006,416,15,12,27,55.6%,10m
16356,1,[cookie]VgetA,3006,401,12,12,24,50.0%,9m
16356,2,Sectoid,3006,260,9,4,13,69.2%,1h
16356,1,JoeBlack,3006,191,8,7,15,53.3%,23m
16356,1,[PTM]Azulkan,3006,302,8,15,23,34.8%,9m
16356,2,Roten,3006,142,6,3,9,66.7%,8m
16356,1,Adrian,3006,190,6,3,9,66.7%,3m
16356,2,ItAx,3006,0,4,1,5,80.0%,20m
16356,1,Crow,3006,97,4,2,6,66.7%,31m
16356,2,corazz,3006,115,4,2,6,66.7%,9m
16356,2,Hervé,3006,88,4,4,8,50.0%,23m
16356,1,[DLB]Sympa,3006,0,3,2,5,60.0%,14m
16356,2,SerGoTo,3006,30,2,0,2,100.0%,14m
16356,1,Egor,3006,0,2,3,5,40.0%,15m
16356,1,[ZЕRGТV]Хлебушек,3006,68,2,6,8,25.0%,22m
16356,1,Protos,3006,0,1,1,2,50.0%,18m
16356,2,Bins,3006,0,0,1,1,0.0%,6m
16356,2,roberry,3006,0,0,1,1,0.0%,10m
16356,2,[HSofS]Algorithm,3006,0,0,3,3,0.0%,22m
16356,1,[TdFd]margorior,3006,0,0,5,5,0.0%,8m
16385,1,ДядяЖеня,3005,1474,99,90,189,52.4%,12m
16385,1,raven,3005,1556,78,68,146,53.4%,15m
16385,2,IIIRAZORIII,3005,505,29,22,51,56.9%,11m
16385,1,ARMENIYA,3005,622,25,31,56,44.6%,10m
16385,2,MAloy,3005,499,21,20,41,51.2%,20m
16385,2,Voollien,3005,397,18,14,32,56.2%,26m
16385,2,Mars,3005,406,17,11,28,60.7%,20m
16385,2,[Nosda]Kiwi,3005,319,15,8,23,65.2%,11m
16385,1,[BiDC]Gizmoo,3005,352,15,15,30,50.0%,13m
16385,3,[BioMec]ThoFly,3005,263,13,9,22,59.1%,18m
16385,1,Challenger,3005,232,11,9,20,55.0%,23m
16385,2,MarineMan,3005,182,8,5,13,61.5%,3m
16385,2,Stefanitoss,3005,181,7,6,13,53.8%,32m
16385,2,IIIIIIII,3005,214,7,10,17,41.2%,18m
16385,2,[HMarch]Rook,3005,112,6,1,7,85.7%,2m
16385,1,Iceyupi,3005,0,4,1,5,80.0%,1h
16385,2,[Mozart]DirTyMoOnKeY,3005,124,4,18,22,18.2%,4m
16385,2,makeaveli,3005,30,2,0,2,100.0%,7m
16385,1,Mandarin,3005,88,2,1,3,66.7%,15m
16385,2,Black,3005,32,2,3,5,40.0%,7m
16385,1,Takinardi,3005,0,1,5,6,16.7%,8m
16385,2,uran,3005,0,0,1,1,0.0%,4m
16385,2,beccam,3005,0,0,3,3,0.0%,7m
16408,1,kakabomba,3004,651,107,105,212,50.5%,6m
16408,1,kastamer,3004,1004,79,68,147,53.7%,8m
16408,2,Zhuk,3004,1405,67,54,121,55.4%,8m
16408,1,City,3004,1409,62,50,112,55.4%,9m
16408,2,Jan,3004,1165,48,42,90,53.3%,7m
16408,2,[vincis]Boknici,3004,1042,41,37,78,52.6%,3m
16408,1,CLXIX,3004,958,37,32,69,53.6%,9m
16408,1,proglot,3004,728,30,34,64,46.9%,7m
16408,2,SeaSharp,3004,696,28,20,48,58.3%,7m
16408,1,[Furya]Ziorko,3004,503,15,19,34,44.1%,19m
16408,2,SWARM,3004,347,14,9,23,60.9%,3m
16408,3,Amun,3004,211,12,10,22,54.5%,17m
16408,1,Foodmaker,3004,369,11,11,22,50.0%,22m
16408,2,AvarakSul,3004,242,8,9,17,47.1%,3m
16408,3,Venegrad,3004,60,7,4,11,63.6%,8m
16408,3,SmartSputnik,3004,191,6,6,12,50.0%,9m
16408,2,Hussinator,3004,70,3,1,4,75.0%,13m
16408,2,Sibastian,3004,0,3,2,5,60.0%,17m
16408,2,BigLupu,3004,30,2,2,4,50.0%,6m
16408,1,Altair,3004,140,2,4,6,33.3%,44m
16408,2,[NVY]IIIIIIIIIIII,3004,0,1,0,1,100.0%,6m
16408,1,stressor,3004,38,1,5,6,16.7%,8m
16408,2,zxR,3004,0,0,3,3,0.0%,27m
16431,3,Perhalik,3003,1496,232,238,470,49.4%,6m
16431,2,[NuF]Grubenhubert,3003,1610,108,82,190,56.8%,10m
16431,1,Beliytigr,3003,588,26,19,45,57.8%,19m
16431,2,Sardukar,3003,508,25,18,43,58.1%,14m
16431,2,Elrendar,3003,416,23,18,41,56.1%,22m
16431,2,[fackme]turbo,3003,297,15,11,26,57.7%,7m
16431,2,[ungh]MrLlew,3003,319,13,4,17,76.5%,11m
16431,2,brianxxx,3003,228,9,8,17,52.9%,3m
16431,1,Kestal,3003,178,8,5,13,61.5%,12m
16431,2,ПвпТренер,3003,162,5,1,6,83.3%,7m
16431,1,KasperLSK,3003,0,4,1,5,80.0%,12m
16431,3,Slip,3003,0,4,2,6,66.7%,25m
16431,1,PlumpBear,3003,38,4,5,9,44.4%,16m
16431,1,Alexis,3003,116,4,10,14,28.6%,4m
16431,2,TrapToss,3003,60,3,0,3,100.0%,10m
16431,1,aiur,3003,120,2,4,6,33.3%,25m
16431,2,DrSeedon,3003,0,1,1,2,50.0%,12m
16431,2,Winbar,3003,0,0,1,1,0.0%,14m
16431,2,TRENER,3003,0,0,3,3,0.0%,3m
16450,2,spider,3002,1627,234,221,455,51.4%,13m
16450,2,Relentless,3002,1479,131,112,243,53.9%,10m
16450,1,DrMuller,3002,1549,84,79,163,51.5%,21m
16450,3,[Xa]isirider,3002,921,79,89,168,47.0%,14m
16450,1,Snuggles,3002,1041,40,34,74,54.1%,12m
16450,3,Entita,3002,805,32,34,66,48.5%,23m
16450,2,Nefalim,3002,681,25,22,47,53.2%,10m
16450,2,Captain,3002,554,20,19,39,51.3%,21m
16450,2,Coacher,3002,400,15,13,28,53.6%,3m
16450,1,[RHG]CHONGD,3002,247,13,12,25,52.0%,23m
16450,2,[CLo07]Mithrandir,3002,282,12,3,15,80.0%,7m
16450,2,BioTiK,3002,164,8,4,12,66.7%,12m
16450,2,Skapidea,3002,226,8,6,14,57.1%,24m
16450,2,[brzzer]sergioandia,3002,236,7,5,12,58.3%,6m
16450,2,Corsair,3002,138,6,3,9,66.7%,3m
16450,2,Tysd,3002,128,6,4,10,60.0%,9m
16450,1,[CGC]Indigo,3002,157,4,2,6,66.7%,23m
16450,2,Divider,3002,166,4,4,8,50.0%,5m
16450,2,Kratos,3002,66,3,4,7,42.9%,10m
16450,2,LiS,3002,88,2,0,2,100.0%,11m
16450,2,[NRGts]Snapcaster,3002,32,2,1,3,66.7%,19m
16450,2,Infinity,3002,8,2,2,4,50.0%,23m
16450,3,KhaBeleth,3002,0,1,0,1,100.0%,3m
16450,2,[DТ]Topa,3002,0,1,0,1,100.0%,17m
16450,2,RekSaiyajin,3002,0,1,0,1,100.0%,24m
16450,1,[ReBrG]LeMolusque,3002,0,1,2,3,33.3%,5m
16450,1,ihavetheorb,3002,34,1,5,6,16.7%,10m
16450,2,Короновирус,3002,0,0,1,1,0.0%,14m
16450,2,Savior,3002,0,0,1,1,0.0%,14m
16450,2,KuDoS,3002,0,0,1,1,0.0%,23m
16450,2,KPATOH,3002,0,0,2,2,0.0%,7m
16481,1,Serkan,3001,1617,96,76,172,55.8%,12m
16481,1,KaKolaK,3001,1631,81,72,153,52.9%,24m
16481,2,Dark,3001,1295,62,54,116,53.4%,4m
16481,1,SwasoW,3001,1211,57,54,111,51.4%,5m
16481,2,Korp,3001,1008,41,33,74,55.4%,14m
16481,2,MarcLB,3001,289,30,28,58,51.7%,7m
16481,2,[YèLads]Johndenkloke,3001,616,25,16,41,61.0%,10m
16481,2,Nick,3001,332,13,5,18,72.2%,15m
16481,2,Altaran,3001,286,10,5,15,66.7%,26m
16481,2,luckygirl,3001,161,9,5,14,64.3%,13m
16481,2,DarkfeuBis,3001,92,4,5,9,44.4%,20m
16481,2,[Petrus]Shonko,3001,58,3,1,4,75.0%,24m
16481,1,Fakepeke,3001,144,3,4,7,42.9%,1h
16481,1,ilikebananas,3001,74,3,8,11,27.3%,7m
16481,2,Буратино,3001,30,2,2,4,50.0%,21m
16481,2,iNhale,3001,64,2,5,7,28.6%,12m
16481,1,Original,3001,0,0,1,1,0.0%,1h
16481,1,Jasper,3001,0,0,1,1,0.0%,12m
16481,2,[Kobras]jadecabbage,3001,0,0,2,2,0.0%,9m
16481,2,DennisVT,3001,0,0,3,3,0.0%,13m
16501,1,DarthRobin,3000,1652,87,77,164,53.0%,21m
16501,1,[ZB]fRaNtWo,3000,1312,86,89,175,49.1%,25m
16501,2,Irexia,3000,1379,58,48,106,54.7%,4m
16501,1,[VetM]FloW,3000,1190,58,53,111,52.3%,5m
16501,3,Konsti,3000,803,39,36,75,52.0%,3m
16501,2,[ZERGTV]Alexander,3000,496,19,14,33,57.6%,24m
16501,2,[KDSCII]simoorg,3000,431,19,17,36,52.8%,12m
16501,2,Quebec,3000,396,17,15,32,53.1%,12m
16501,2,[ÆVT]Naesle,3000,319,10,16,26,38.5%,14m
16501,3,[Sw1tch]Switch,3000,207,9,4,13,69.2%,1h
16501,2,albertt,3000,266,9,6,15,60.0%,5m
16501,2,[BAPP]Squidite,3000,188,7,2,9,77.8%,15m
16501,2,Oldrich,3000,186,6,4,10,60.0%,3m
16501,3,HonkyMonky,3000,147,6,5,11,54.5%,17m
16501,1,BruNet,3000,178,5,12,17,29.4%,9m
16501,1,[WCME]Wasaren,3000,0,4,2,6,66.7%,8m
16501,1,[TWCE]Whodis,3000,150,4,6,10,40.0%,18m
16501,2,Alec,3000,86,3,1,4,75.0%,14m
16501,2,Race,3000,60,3,1,4,75.0%,10m
16501,1,[WVVW]CaptainEagle,3000,0,3,2,5,60.0%,1h
16501,2,Prismatic,3000,60,2,3,5,40.0%,11m
16501,2,Popek,3000,62,2,3,5,40.0%,7m
16501,2,[Elimin]patalisk,3000,62,2,5,7,28.6%,8m
16501,2,GuiLermeTell,3000,0,1,0,1,100.0%,7m
16501,2,Excellis,3000,0,1,0,1,100.0%,17m
16501,2,Khing,3000,30,1,1,2,50.0%,24m
16501,1,LiquidOcelot,3000,89,1,3,4,25.0%,26m
16501,2,[TrshTm]Rijou,3000,0,0,1,1,0.0%,4m
16501,1,SlateFace,3000,0,0,1,1,0.0%,1h
16501,2,[SkCzM]Yogregator,3000,0,0,2,2,0.0%,10m
16531,2,pixolated,2999,794,152,121,273,55.7%,19m
16531,3,[Arrows]kooverkalo,2999,1200,110,111,221,49.8%,10m
16531,2,Смехоног,2999,803,67,25,92,72.8%,19m
16531,1,Tagada,2999,1103,51,35,86,59.3%,12m
16531,1,Hydra,2999,1265,50,50,100,50.0%,5m
16531,3,Itachi,2999,1052,45,50,95,47.4%,3m
16531,2,llllllllllll,2999,576,28,8,36,77.8%,14m
16531,2,SkLopee,2999,648,25,20,45,55.6%,23m
16531,1,Alphalight,2999,518,21,23,44,47.7%,13m
16531,2,Negrozerling,2999,272,10,4,14,71.4%,14m
16531,2,Herman,2999,220,8,7,15,53.3%,37m
16531,3,Romera,2999,210,7,3,10,70.0%,21m
16531,2,Saunt,2999,206,7,7,14,50.0%,3m
16531,2,[VuV]Zeratul,2999,174,6,7,13,46.2%,3m
16531,2,[MSK77]Greyfox,2999,0,4,1,5,80.0%,12m
16531,2,[Stimen]Laksen,2999,58,3,1,4,75.0%,24m
16531,1,brax,2999,0,3,2,5,60.0%,1h
16531,2,Yann,2999,0,1,0,1,100.0%,24m
16531,1,APOCAL,2999,0,1,0,1,100.0%,1h
16531,2,Cherny,2999,0,0,1,1,0.0%,20m
16531,2,MorroLord,2999,0,0,1,1,0.0%,10m
16531,2,Zedryx,2999,0,0,2,2,0.0%,17m
16553,2,gabriel,2998,1638,250,235,485,51.5%,5m
16553,3,RospoCattivo,2998,955,158,161,319,49.5%,17m
16553,2,[wpwpwp]Positron,2998,1435,79,71,150,52.7%,4m
16553,2,[Koent]Boffert,2998,1378,76,56,132,57.6%,5m
16553,1,[Bambi2]SCField,2998,1677,72,65,137,52.6%,6m
16553,2,RmaStik,2998,1516,58,53,111,52.3%,20m
16553,2,Erro,2998,462,45,36,81,55.6%,12m
16553,2,portoslemac,2998,1093,44,41,85,51.8%,21m
16553,1,[MIELUL]Tudor,2998,947,35,36,71,49.3%,25m
16553,2,LimitLesS,2998,194,8,6,14,57.1%,17m
16553,2,RonLaFlamme,2998,138,7,2,9,77.8%,13m
16553,2,erunky,2998,150,6,3,9,66.7%,14m
16553,2,Torino,2998,116,6,6,12,50.0%,10m
16553,2,Gronosaure,2998,160,5,0,5,100.0%,3m
16553,2,ChillNGrill,2998,0,2,0,2,100.0%,21m
16553,2,[αX]Tystic,2998,58,2,2,4,50.0%,7m
16553,2,YellowLeader,2998,60,2,5,7,28.6%,14m
16553,2,IIIIIIIIIIII,2998,30,2,5,7,28.6%,7m
16553,2,ZarObNido,2998,0,1,0,1,100.0%,10m
16553,1,HeroZergling,2998,0,1,0,1,100.0%,1h
16553,2,WintermelonT,2998,0,1,0,1,100.0%,9m
16553,2,człowiekryba,2998,0,1,2,3,33.3%,23m
16553,3,Reuenthal,2998,0,0,1,1,0.0%,19m
16553,2,Петька,2998,0,0,2,2,0.0%,10m
16553,2,SUPERDAWIDO,2998,0,0,2,2,0.0%,15m
16553,2,aTable,2998,0,0,2,2,0.0%,7m
16579,1,Golem,2997,1669,171,154,325,52.6%,12m
16579,2,Archon,2997,741,63,62,125,50.4%,24m
16579,1,Reckvus,2997,1488,58,56,114,50.9%,6m
16579,2,farmadude,2997,588,56,49,105,53.3%,26m
16579,1,wolf,2997,416,17,12,29,58.6%,3m
16579,3,ПАЦАНЧИК,2997,434,17,20,37,45.9%,12m
16579,1,ostreech,2997,450,14,24,38,36.8%,26m
16579,2,toobadtowin,2997,247,11,10,21,52.4%,17m
16579,2,Himal,2997,178,7,5,12,58.3%,18m
16579,3,FazZ,2997,204,7,5,12,58.3%,13m
16579,2,[DSUF]gachibas,2997,200,7,6,13,53.8%,8m
16579,1,llllllolnope,2997,97,6,0,6,100.0%,43m
16579,1,Stein,2997,230,6,5,11,54.5%,3m
16579,2,mikey,2997,158,6,7,13,46.2%,20m
16579,1,CordinAL,2997,178,6,8,14,42.9%,10m
16579,1,Ymiril,2997,48,3,5,8,37.5%,1h
16579,1,Dadou,2997,46,2,2,4,50.0%,18m
16579,1,Hig,2997,48,2,2,4,50.0%,1h
16579,1,Infamis,2997,118,2,5,7,28.6%,30m
16579,2,iKILLEROK,2997,32,1,2,3,33.3%,24m
16579,1,DecidЗe,2997,38,1,7,8,12.5%,8m
16579,2,Stranger,2997,0,0,1,1,0.0%,4m
16601,1,StarklySansa,2996,1404,176,150,326,54.0%,4m
16601,2,[Ǽ1]Impostor,2996,1410,159,128,287,55.4%,9m
16601,1,LifteX,2996,1173,89,81,170,52.4%,6m
16601,2,[LegioV]ZenMan,2996,1258,79,77,156,50.6%,18m
16601,3,CodeZ,2996,870,74,83,157,47.1%,8m
16601,1,anaujiraM,2996,1228,67,52,119,56.3%,25m
16601,1,[PRAIM]ApeKing,2996,512,57,54,111,51.4%,16m
16601,1,StefTheGreat,2996,1313,51,41,92,55.4%,8m
16601,2,[wedown]BloodySmoker,2996,576,24,11,35,68.6%,9m
16601,1,Janko,2996,540,24,17,41,58.5%,12m
16601,1,ilikeladies,2996,315,13,11,24,54.2%,3m
16601,1,[IceHus]Element,2996,358,10,12,22,45.5%,9m
16601,1,Ree,2996,198,7,10,17,41.2%,8m
16601,1,[FTC]Florg,2996,246,7,14,21,33.3%,39m
16601,3,AliasHunter,2996,118,6,10,16,37.5%,9m
16601,1,GrUshQ,2996,48,5,4,9,55.6%,1h
16601,3,Bluekiller,2996,0,1,1,2,50.0%,27m
16601,2,pashtet,2996,30,1,3,4,25.0%,10m
16601,2,RedZerg,2996,73,1,3,4,25.0%,7m
16601,2,Smouak,2996,0,0,1,1,0.0%,8m
16601,2,[dtk2]Augo,2996,0,0,2,2,0.0%,14m
16601,2,BaadnewZ,2996,0,0,2,2,0.0%,3m
16623,2,Petrishka,2995,1631,142,137,279,50.9%,21m
16623,1,Masher,2995,795,51,55,106,48.1%,7m
16623,1,White,2995,718,41,48,89,46.1%,3m
16623,1,firefly,2995,942,31,38,69,44.9%,23m
16623,2,Sarge,2995,592,25,16,41,61.0%,20m
16623,2,[Harley]Nelate,2995,670,25,25,50,50.0%,13m
16623,1,[Cybro]bogar,2995,598,22,16,38,57.9%,18m
16623,1,Tessa,2995,644,22,26,48,45.8%,19m
16623,2,TAENORN,2995,425,17,11,28,60.7%,3m
16623,2,[XLAG]king,2995,400,14,13,27,51.9%,3m
16623,2,[SSGUK]DalyLaCow,2995,282,10,7,17,58.8%,5m
16623,1,wasaaaaa,2995,0,5,0,5,100.0%,24m
16623,1,ZaЯц,2995,0,3,2,5,60.0%,1h
16623,1,TBapb,2995,0,3,5,8,37.5%,23m
16623,2,Kenny,2995,127,2,5,7,28.6%,8m
16623,2,drykerbeng,2995,30,1,2,3,33.3%,5m
16623,1,romaric,2995,0,1,4,5,20.0%,3m
16623,1,Zero,2995,0,0,1,1,0.0%,1h
16623,2,George,2995,0,0,1,1,0.0%,12m
16623,1,[CS0]keretapir,2995,0,0,2,2,0.0%,10m
16623,1,[Zufall]Aikons,2995,0,0,6,6,0.0%,3m
16644,2,Alcibiades,2994,1613,178,160,338,52.7%,6m
16644,1,asisisco,2994,1256,48,45,93,51.6%,19m
16644,2,[PÂRłAH]Deiv,2994,932,37,31,68,54.4%,9m
16644,1,Selven,2994,294,13,11,24,54.2%,24m
16644,2,Vönz,2994,314,12,10,22,54.5%,3m
16644,1,[GАYSS]ГлазСлона,2994,337,12,12,24,50.0%,16m
16644,2,[Chariz]Orkmetzler,2994,344,12,13,25,48.0%,7m
16644,2,[59APM]Зефирка,2994,282,10,5,15,66.7%,6m
16644,1,[solo]MadeInUSSR,2994,0,4,1,5,80.0%,27m
16644,2,itsnotLucas,2994,0,3,3,6,50.0%,6m
16644,2,kostyan,2994,30,2,2,4,50.0%,24m
16644,1,[AoS]IronMario,2994,97,2,4,6,33.3%,19m
16644,2,[EHET]LeChatVentru,2994,32,2,4,6,33.3%,21m
16644,1,wicked,2994,0,0,5,5,0.0%,6m
16658,2,borealis,2993,1394,72,62,134,53.7%,15m
16658,2,BadHabbits,2993,1124,62,51,113,54.9%,23m
16658,2,Shamsudin,2993,1003,54,84,138,39.1%,17m
16658,1,ntl,2993,741,32,27,59,54.2%,3m
16658,2,Anostra,2993,549,22,17,39,56.4%,13m
16658,2,[DFgsA]Protisz,2993,526,20,18,38,52.6%,3m
16658,1,TutaManaHon,2993,134,16,10,26,61.5%,8m
16658,3,[NCH]Floxblah,2993,350,16,16,32,50.0%,23m
16658,2,[Alеx07]KacTuEJlb,2993,400,15,9,24,62.5%,12m
16658,1,DonPorolon,2993,457,13,16,29,44.8%,13m
16658,1,[Hrr]Verniy,2993,325,12,10,22,54.5%,3m
16658,1,[DSRTN]andrei,2993,328,11,11,22,50.0%,21m
16658,1,[Lowko]Shadowhunter,2993,386,11,18,29,37.9%,9m
16658,2,[druPa]Bro,2993,224,9,4,13,69.2%,21m
16658,2,WhiteWind,2993,204,7,7,14,50.0%,8m
16658,2,SilverLeague,2993,196,6,3,9,66.7%,17m
16658,1,DivPetel,2993,184,5,12,17,29.4%,9m
16658,1,[T3ars]JuppiJuppsen,2993,175,4,8,12,33.3%,24m
16658,2,Aericura,2993,62,3,0,3,100.0%,4m
16658,1,Izu,2993,0,2,2,4,50.0%,34m
16658,2,[Cannоn]LiquidClum,2993,0,1,0,1,100.0%,4m
16658,1,Larloch,2993,0,1,5,6,16.7%,1h
16658,2,DedFura,2993,0,0,1,1,0.0%,12m
16658,1,Roxell,2993,0,0,2,2,0.0%,19m
16658,1,[TSky]Kniven,2993,0,0,6,6,0.0%,1h
16683,3,Raynor,2992,1511,215,211,426,50.5%,9m
16683,3,Naraia,2992,1408,159,134,293,54.3%,13m
16683,1,[ligma]DarthVader,2992,1631,109,89,198,55.1%,16m
16683,2,alexliyov,2992,1456,82,70,152,53.9%,4m
16683,3,DitarKnyaz,2992,519,80,79,159,50.3%,16m
16683,3,[SAKZ]Ossan,2992,1210,52,62,114,45.6%,19m
16683,2,kordez,2992,1051,42,35,77,54.5%,3m
16683,2,GameOfDrones,2992,875,39,25,64,60.9%,22m
16683,2,Foxxy,2992,878,35,30,65,53.8%,14m
16683,1,pârșu,2992,990,35,34,69,50.7%,16m
16683,1,[CHBszb]Kakimaki,2992,705,29,26,55,52.7%,19m
16683,1,Fenominous,2992,241,11,10,21,52.4%,13m
16683,2,[ФОКС]Pafurd,2992,154,7,4,11,63.6%,14m
16683,2,MamaMia,2992,164,6,0,6,100.0%,3m
16683,2,[RGSC2]RARKA,2992,142,6,3,9,66.7%,10m
16683,2,MarlboroO,2992,114,5,3,8,62.5%,10m
16683,2,[ggEZI]Uneha,2992,86,5,5,10,50.0%,18m
16683,2,mihelherbííí,2992,160,4,2,6,66.7%,26m
16683,1,[BIAE]frääääänk,2992,145,4,3,7,57.1%,27m
16683,2,WellDone,2992,86,3,2,5,60.0%,24m
16683,1,MrMade,2992,98,3,8,11,27.3%,9m
16683,2,[Sparky]Sparky,2992,58,2,2,4,50.0%,21m
16683,2,Optfx,2992,30,2,2,4,50.0%,23m
16683,1,baida,2992,34,2,5,7,28.6%,4m
16683,1,[Stacho]Overus,2992,0,1,0,1,100.0%,38m
16683,2,Dorian,2992,30,1,1,2,50.0%,3m
16683,2,[UBDH]Pop,2992,30,1,3,4,25.0%,10m
16683,2,zif,2992,30,1,4,5,20.0%,8m
16683,1,gimilzor,2992,0,0,1,1,0.0%,34m
16683,2,[ETYM]skrop,2992,0,0,3,3,0.0%,22m
16713,1,Jasper,2991,1379,92,71,163,56.4%,19m
16713,1,Niro,2991,970,38,44,82,46.3%,18m
16713,2,[ǂTpGǂ]Waloche,2991,586,29,27,56,51.8%,16m
16713,2,[Clsix]LoneRanger,2991,661,27,21,48,56.2%,10m
16713,2,Biggus,2991,596,24,17,41,58.5%,6m
16713,1,zerg,2991,328,10,16,26,38.5%,19m
16713,2,[B00bz]juju,2991,222,9,7,16,56.2%,16m
16713,2,[Prøxy]Blackspell,2991,239,8,8,16,50.0%,22m
16713,1,[ERATA]Lutarus,2991,226,7,13,20,35.0%,22m
16713,1,xxlForeskin,2991,97,4,1,5,80.0%,35m
16713,1,MarineBand,2991,0,4,1,5,80.0%,6m
16713,2,PKappa,2991,86,4,3,7,57.1%,21m
16713,3,Affenboi,2991,88,4,12,16,25.0%,3m
16713,1,Light,2991,0,3,2,5,60.0%,37m
16713,2,Dens,2991,0,3,2,5,60.0%,17m
16713,2,Anubis,2991,145,3,3,6,50.0%,6m
16713,2,[ENFO]fabiaville,2991,30,2,0,2,100.0%,23m
16713,1,Atesz,2991,121,2,1,3,66.7%,26m
16713,2,StickyCandy,2991,0,1,0,1,100.0%,9m
16713,2,[SaCult]DeDa,2991,0,0,1,1,0.0%,4m
16733,1,Shadowtonny,2990,1506,170,162,332,51.2%,21m
16733,3,redwhite,2990,873,102,107,209,48.8%,3m
16733,3,alexix,2990,1397,92,97,189,48.7%,26m
16733,1,LeCoyOtte,2990,1484,88,93,181,48.6%,18m
16733,1,[WITCHs]KiWi,2990,1668,78,79,157,49.7%,3m
16733,3,Bathman,2990,1040,37,51,88,42.0%,8m
16733,2,SmegHeadCZE,2990,436,20,12,32,62.5%,22m
16733,2,Sixset,2990,489,19,14,33,57.6%,25m
16733,3,llllllllllll,2990,388,14,7,21,66.7%,11m
16733,2,SNV,2990,356,13,12,25,52.0%,3m
16733,1,llllllllllll,2990,121,7,0,7,100.0%,1h
16733,2,[OaSa]Styxx,2990,122,5,3,8,62.5%,20m
16733,1,DemonCyborg,2990,119,4,3,7,57.1%,1h
16733,2,FLOYD,2990,114,4,4,8,50.0%,12m
16733,2,[BxFǂ]Jolli,2990,122,4,6,10,40.0%,24m
16733,1,[cun7]GreatWhiteSi,2990,137,3,0,3,100.0%,19m
16733,2,CrazyCat,2990,58,3,4,7,42.9%,8m
16733,2,[SRPR]DOND,2990,30,2,0,2,100.0%,23m
16733,2,[3MD]Disk,2990,30,2,2,4,50.0%,9m
16733,2,TasTic,2990,0,1,0,1,100.0%,18m
16733,1,[8307]GoVoR,2990,0,1,1,2,50.0%,9m
16733,1,TyFooN,2990,48,1,3,4,25.0%,4m
16733,2,[DL2006]Kratos,2990,0,0,1,1,0.0%,22m
16733,2,JeReX,2990,0,0,2,2,0.0%,5m
16733,2,[NuRe]Ragnar,2990,0,0,3,3,0.0%,7m
16758,3,MilkPerson,2989,1538,191,199,390,49.0%,16m
16758,1,Ant,2989,1390,82,81,163,50.3%,21m
16758,1,Igniter,2989,1361,68,57,125,54.4%,7m
16758,2,Robek,2989,1357,61,51,112,54.5%,16m
16758,1,Vojtik,2989,1271,61,54,115,53.0%,8m
16758,1,[Ming]EColiBacteri,2989,931,57,54,111,51.4%,4m
16758,1,Galth,2989,1274,48,51,99,48.5%,25m
16758,2,rizukuu,2989,913,38,29,67,56.7%,12m
16758,2,Falleky,2989,565,24,19,43,55.8%,20m
16758,3,Pepamso,2989,638,21,33,54,38.9%,23m
16758,2,YIGIT,2989,462,20,13,33,60.6%,15m
16758,2,[BoLLeK]oLLeK,2989,524,20,16,36,55.6%,7m
16758,3,Beleive,2989,143,7,8,15,46.7%,3m
16758,2,llllllllllll,2989,163,6,3,9,66.7%,10m
16758,1,andrewzha,2989,0,5,1,6,83.3%,40m
16758,1,Barrowman,2989,121,5,3,8,62.5%,13m
16758,2,Tessellator,2989,138,5,4,9,55.6%,13m
16758,2,[AFLG]ELMAYA,2989,118,5,7,12,41.7%,7m
16758,3,[LLG]Rney,2989,0,4,3,7,57.1%,24m
16758,2,Adamas,2989,58,3,0,3,100.0%,20m
16758,2,FTwoToWin,2989,88,3,3,6,50.0%,8m
16758,1,BeerMan,2989,0,2,3,5,40.0%,10m
16758,2,[FkDyMw]Ðryft,2989,0,0,1,1,0.0%,10m
16758,2,Pentarh,2989,0,0,1,1,0.0%,3m
16758,1,Oli,2989,0,0,1,1,0.0%,1h
16758,2,Herakles,2989,0,0,2,2,0.0%,3m
16758,2,ColdRain,2989,0,0,2,2,0.0%,7m
16758,1,Toxity,2989,0,0,6,6,0.0%,9m
16786,1,steifler,2988,1690,93,95,188,49.5%,21m
16786,3,Mendo,2988,1598,81,78,159,50.9%,20m
16786,1,Savko,2988,1102,67,63,130,51.5%,16m
16786,2,KION,2988,1326,63,45,108,58.3%,11m
16786,1,Krato,2988,1504,62,57,119,52.1%,12m
16786,1,NecroPheonix,2988,570,54,55,109,49.5%,21m
16786,1,XxMOBABOxX,2988,1116,47,47,94,50.0%,8m
16786,1,CDTNXO,2988,1088,46,47,93,49.5%,10m
16786,1,Kuka,2988,845,45,18,63,71.4%,19m
16786,1,Sinan,2988,924,41,40,81,50.6%,15m
16786,1,Forsaken,2988,1004,34,37,71,47.9%,13m
16786,1,[TeamUR]Hanne,2988,495,19,18,37,51.4%,19m
16786,2,[Dirdż]FatPharaoh,2988,477,18,16,34,52.9%,13m
16786,3,Harciog,2988,134,14,10,24,58.3%,25m
16786,1,Daniel,2988,415,13,17,30,43.3%,9m
16786,2,[CHA]Libina,2988,331,12,7,19,63.2%,15m
16786,2,[AJJB]AlfaJampa,2988,268,11,11,22,50.0%,24m
16786,1,Bald,2988,328,10,9,19,52.6%,31m
16786,2,Ascention,2988,240,9,12,21,42.9%,24m
16786,2,[Ghost2]costindia,2988,146,6,7,13,46.2%,18m
16786,1,Melon,2988,224,6,12,18,33.3%,18m
16786,2,Slike,2988,0,4,1,5,80.0%,24m
16786,2,Vishtya,2988,0,3,2,5,60.0%,3m
16786,2,Nikon,2988,66,3,2,5,60.0%,8m
16786,2,angelplay,2988,0,1,0,1,100.0%,11m
16786,2,[Surb]kipelovets,2988,0,1,0,1,100.0%,24m
16786,2,[NLTN]BigBadWolf,2988,34,1,1,2,50.0%,5m
16786,2,Mat,2988,0,1,3,4,25.0%,20m
16786,2,Arkat,2988,30,1,3,4,25.0%,23m
16786,2,NOOBS,2988,0,0,1,1,0.0%,8m
16786,2,SfmLP,2988,0,0,1,1,0.0%,3m
16786,2,Wildlife,2988,0,0,1,1,0.0%,4m
16786,2,onionthought,2988,0,0,1,1,0.0%,15m
16786,2,TOTO,2988,0,0,1,1,0.0%,17m
16786,2,Zergling,2988,0,0,1,1,0.0%,14m
16786,1,Angus,2988,0,0,1,1,0.0%,28m
16786,2,ShuniaTheOp,2988,0,0,2,2,0.0%,3m
16823,2,Heavy,2987,565,39,33,72,54.2%,19m
16823,1,AronOslo,2987,699,28,22,50,56.0%,4m
16823,2,Wsen,2987,650,24,22,46,52.2%,3m
16823,2,bombim,2987,565,22,13,35,62.9%,20m
16823,1,sly,2987,467,20,17,37,54.1%,12m
16823,2,KroNax,2987,310,11,11,22,50.0%,10m
16823,1,BlecMajik,2987,232,9,16,25,36.0%,18m
16823,3,[HSSN]HentropyH,2987,193,7,5,12,58.3%,16m
16823,1,Евгеха,2987,155,6,5,11,54.5%,24m
16823,3,LittleCheese,2987,0,4,3,7,57.1%,33m
16823,1,Andres,2987,0,3,2,5,60.0%,14m
16823,2,tatarana,2987,0,3,2,5,60.0%,21m
16823,3,[UATeam]Maelnor,2987,66,3,17,20,15.0%,15m
16823,3,[lLiTl]Arnas,2987,0,1,0,1,100.0%,17m
16823,1,DDDDDDD,2987,38,1,4,5,20.0%,12m
16823,2,BareKnuckle,2987,0,0,1,1,0.0%,1h
16823,2,[Sizzle]RisingFenix,2987,0,0,2,2,0.0%,13m
16840,1,emperor,2986,1543,321,285,606,53.0%,23m
16840,1,[JaPP]FanatNaPaLm,2986,1626,316,307,623,50.7%,4m
16840,3,Thoroni,2986,1302,125,123,248,50.4%,16m
16840,3,teroon,2986,566,110,109,219,50.2%,5m
16840,2,VeeONeGee,2986,1581,91,91,182,50.0%,11m
16840,2,GoDKaRaKaN,2986,1143,91,95,186,48.9%,13m
16840,3,flux,2986,1480,75,76,151,49.7%,17m
16840,2,JagerFlash,2986,1604,73,69,142,51.4%,4m
16840,2,Malajka,2986,1392,71,65,136,52.2%,24m
16840,2,Drake,2986,906,48,23,71,67.6%,12m
16840,1,[5gb]iMoCKinGBirD,2986,1289,47,46,93,50.5%,22m
16840,2,FuNdaMentaL,2986,722,29,23,52,55.8%,13m
16840,2,Epibaterios,2986,545,23,19,42,54.8%,20m
16840,1,[BriT]Silver,2986,638,23,24,47,48.9%,23m
16840,2,Blopak,2986,508,21,13,34,61.8%,18m
16840,1,[GUGE]AjjKillJuu,2986,576,20,23,43,46.5%,3m
16840,2,nicolaï,2986,402,19,14,33,57.6%,18m
16840,2,Kamikaze,2986,532,19,17,36,52.8%,7m
16840,2,smiley,2986,305,11,6,17,64.7%,10m
16840,2,Zilo,2986,276,9,7,16,56.2%,9m
16840,1,[isIMBА]Protosex,2986,284,9,14,23,39.1%,16m
16840,2,gewt,2986,256,8,6,14,57.1%,20m
16840,1,[MAGA20]DonaldTrump,2986,48,5,2,7,71.4%,1h
16840,2,PEVCHANSKI,2986,0,4,1,5,80.0%,11m
16840,2,IceCream,2986,0,3,2,5,60.0%,13m
16840,2,Luckets,2986,0,3,2,5,60.0%,21m
16840,2,Ivan,2986,0,1,0,1,100.0%,8m
16840,2,[Marvil]Elita,2986,0,0,1,1,0.0%,6m
16840,2,[рейд]Arch,2986,0,0,3,3,0.0%,12m
16869,1,MaxSel,2985,1690,297,303,600,49.5%,22m
16869,1,trev,2985,1639,222,212,434,51.2%,9m
16869,1,AMBERLAMPS,2985,1629,84,75,159,52.8%,15m
16869,1,Leggy,2985,806,60,45,105,57.1%,21m
16869,2,Mefisto,2985,840,36,26,62,58.1%,10m
16869,1,Pertti,2985,832,32,37,69,46.4%,5m
16869,2,Darklight,2985,609,29,10,39,74.4%,9m
16869,1,DeYurikk,2985,886,29,37,66,43.9%,9m
16869,2,Billiboyed,2985,469,27,23,50,54.0%,12m
16869,1,walabiz,2985,627,27,24,51,52.9%,3m
16869,2,[Kjerne]Steps,2985,410,23,13,36,63.9%,24m
16869,1,Dovhakiin,2985,542,19,24,43,44.2%,11m
16869,1,Nkl,2985,516,18,20,38,47.4%,12m
16869,2,liusi,2985,396,14,13,27,51.9%,3m
16869,3,[ENV]eddi,2985,254,8,24,32,25.0%,3m
16869,3,Deviance,2985,166,6,4,10,60.0%,3m
16869,1,CannotRush,2985,130,6,4,10,60.0%,16m
16869,2,[CS1rus]Quasar,2985,178,6,9,15,40.0%,13m
16869,1,Highlander,2985,158,5,0,5,100.0%,1h
16869,2,bettlescabc,2985,158,5,1,6,83.3%,13m
16869,3,[Sulphr]Anteneos,2985,97,5,3,8,62.5%,31m
16869,1,mechturtle,2985,143,5,3,8,62.5%,3m
16869,1,Wurstbrot,2985,136,5,10,15,33.3%,16m
16869,2,[JaPP]Komisar,2985,58,2,1,3,66.7%,10m
16869,2,[Lowko]Dinouu,2985,30,2,3,5,40.0%,17m
16869,2,Blindigo,2985,60,2,5,7,28.6%,6m
16869,2,[DTBM]UhrU,2985,0,1,0,1,100.0%,8m
16869,2,Emptiness,2985,0,1,0,1,100.0%,14m
16869,2,Coiless,2985,30,1,1,2,50.0%,17m
16869,2,neslhab,2985,0,1,1,2,50.0%,20m
16869,1,Specaye,2985,0,1,1,2,50.0%,41m
16869,1,Midirov,2985,92,1,4,5,20.0%,19m
16869,1,Gewürzgurke,2985,0,0,1,1,0.0%,28m
16869,2,[LOGS]Chewchilla,2985,0,0,1,1,0.0%,15m
16903,1,Tobi,2984,1665,340,304,644,52.8%,3m
16903,1,[FAV1]MYSTADERRA,2984,1332,67,73,140,47.9%,25m
16903,2,Oxer,2984,1377,60,45,105,57.1%,12m
16903,2,ZigZach,2984,733,30,21,51,58.8%,20m
16903,2,Mistelle,2984,601,23,19,42,54.8%,20m
16903,3,Kazar,2984,230,11,10,21,52.4%,21m
16903,2,TheMaxFun,2984,170,8,4,12,66.7%,23m
16903,2,BraveToaster,2984,167,7,5,12,58.3%,17m
16903,1,evenreven,2984,96,6,4,10,60.0%,26m
16903,2,Zeccha,2984,141,4,5,9,44.4%,8m
16903,2,EvilSoda,2984,0,3,2,5,60.0%,8m
16903,2,zandR,2984,0,3,2,5,60.0%,20m
16903,2,WEB,2984,0,3,3,6,50.0%,12m
16903,2,[CZMA]LukinosCZ,2984,32,1,4,5,20.0%,7m
16903,2,Finwych,2984,0,0,1,1,0.0%,4m
16903,2,Lifepath,2984,0,0,4,4,0.0%,8m
16919,1,Dlyg,2983,1518,105,99,204,51.5%,21m
16919,2,enmuriau,2983,1263,63,48,111,56.8%,9m
16919,1,[NøT]Kirby,2983,1262,55,61,116,47.4%,9m
16919,2,CanonicDuck,2983,795,37,17,54,68.5%,26m
16919,1,Jorak,2983,484,30,34,64,46.9%,18m
16919,2,Bligh,2983,638,28,23,51,54.9%,26m
16919,1,GenghisTT,2983,500,18,22,40,45.0%,16m
16919,1,[8SWED8]Fierce,2983,441,14,15,29,48.3%,13m
16919,2,[FoDuPo]DonBalloche,2983,330,11,9,20,55.0%,7m
16919,1,JamesNewman,2983,267,10,10,20,50.0%,5m
16919,2,Qweerty,2983,146,9,6,15,60.0%,21m
16919,3,Bahiyaa,2983,124,6,11,17,35.3%,16m
16919,2,Choosje,2983,88,5,1,6,83.3%,20m
16919,1,Logan,2983,105,5,4,9,55.6%,12m
16919,1,Rcvtheninja,2983,174,5,11,16,31.2%,23m
16919,2,[Sehyo]scƻskWhoTe,2983,182,4,5,9,44.4%,24m
16919,2,bzzz,2983,98,4,6,10,40.0%,21m
16919,2,pavipollo,2983,0,3,2,5,60.0%,12m
16919,2,Silver,2983,60,3,3,6,50.0%,12m
16919,1,Saken,2983,104,2,4,6,33.3%,7m
16919,2,[QTclub]Ромашка,2983,30,2,4,6,33.3%,15m
16919,2,HarryGateaux,2983,0,1,0,1,100.0%,16m
16919,2,Brink,2983,30,1,1,2,50.0%,9m
16919,1,OxZEB,2983,0,1,1,2,50.0%,3m
16919,2,[EXPANT]Mormegil,2983,32,1,2,3,33.3%,20m
16919,1,kerasin,2983,0,0,1,1,0.0%,44m
16919,2,[Heroes]swagman,2983,0,0,1,1,0.0%,10m
16946,1,jack,2982,1660,186,181,367,50.7%,12m
16946,1,Camphausen,2982,1466,138,128,266,51.9%,23m
16946,3,Cycloheximid,2982,741,86,89,175,49.1%,6m
16946,3,gerem,2982,1289,51,65,116,44.0%,5m
16946,2,Optimizer,2982,1148,49,42,91,53.8%,3m
16946,3,lubiiik,2982,1011,40,40,80,50.0%,23m
16946,1,maelic,2982,861,30,33,63,47.6%,24m
16946,2,leSt,2982,526,21,13,34,61.8%,10m
16946,3,simsalabim,2982,378,15,9,24,62.5%,24m
16946,1,[SAFS]Drojan,2982,306,12,10,22,54.5%,10m
16946,2,[Sp1rit]ObÐZen,2982,232,9,9,18,50.0%,18m
16946,2,DangerZone,2982,228,8,7,15,53.3%,3m
16946,1,Lvcian,2982,288,8,13,21,38.1%,11m
16946,2,[HLFLMN]balka,2982,170,7,5,12,58.3%,24m
16946,2,ThisSpring,2982,121,5,4,9,55.6%,12m
16946,2,Akhtyamov,2982,146,5,6,11,45.5%,15m
16946,3,Baattl,2982,0,4,2,6,66.7%,37m
16946,2,[dlgc]Venom,2982,58,3,1,4,75.0%,8m
16946,1,Feimen,2982,0,3,2,5,60.0%,6m
16946,1,Ятупой,2982,0,3,2,5,60.0%,1h
16946,1,Oggje,2982,0,3,2,5,60.0%,36m
16946,2,[2021]Tuchka,2982,30,2,1,3,66.7%,21m
16946,1,DaMs,2982,80,2,6,8,25.0%,15m
16946,2,Akai,2982,0,1,0,1,100.0%,20m
16946,3,MasterYoda,2982,0,1,2,3,33.3%,21m
16946,2,sibZzKMSzZ,2982,0,0,1,1,0.0%,14m
16946,3,[696]llllllllllll,2982,0,0,1,1,0.0%,1h
16946,2,RazoR,2982,0,0,3,3,0.0%,4m
16974,3,sifak,2981,1576,231,231,462,50.0%,5m
16974,1,prdx,2981,1668,183,180,363,50.4%,26m
16974,1,GreenLord,2981,581,38,33,71,53.5%,9m
16974,2,[MRSM]szabolcs,2981,883,36,33,69,52.2%,8m
16974,2,CheesePolice,2981,833,31,30,61,50.8%,3m
16974,3,Strepsils,2981,457,20,19,39,51.3%,17m
16974,1,SPINNE,2981,655,20,27,47,42.6%,19m
16974,1,[TkcS]Cheater,2981,393,18,13,31,58.1%,19m
16974,1,PapyTony,2981,326,11,13,24,45.8%,12m
16974,1,Zest,2981,292,8,13,21,38.1%,21m
16974,1,InSInC,2981,162,7,5,12,58.3%,15m
16974,2,Inikoyi,2981,167,7,6,13,53.8%,24m
16974,3,Kryel,2981,205,6,6,12,50.0%,1h
16974,2,ligion,2981,161,5,3,8,62.5%,23m
16974,2,MrLocke,2981,186,5,3,8,62.5%,23m
16974,2,lundanto,2981,128,5,4,9,55.6%,23m
16974,2,Azure,2981,128,5,7,12,41.7%,23m
16974,1,Polar,2981,97,4,9,13,30.8%,34m
16974,2,kiyiy,2981,30,2,0,2,100.0%,26m
16974,2,HappyRaccoon,2981,58,2,1,3,66.7%,10m
16974,1,bas,2981,96,2,2,4,50.0%,20m
16974,2,Thor,2981,0,1,0,1,100.0%,10m
16974,2,Haldadrin,2981,30,1,1,2,50.0%,17m
16974,1,mobius,2981,0,1,2,3,33.3%,38m
16974,2,Frim,2981,0,0,1,1,0.0%,13m
16999,1,Maciejleszno,2980,1276,175,160,335,52.2%,16m
16999,1,[0eN0]Katzenkoenig,2980,1644,146,134,280,52.1%,5m
16999,1,Bazsa,2980,1359,109,101,210,51.9%,8m
16999,1,[ЕМPIRE]Ranger,2980,1522,78,70,148,52.7%,5m
16999,2,loupstylé,2980,1607,69,57,126,54.8%,22m
16999,2,Avgustin,2980,753,49,33,82,59.8%,23m
16999,1,Necrolyte,2980,571,45,28,73,61.6%,5m
16999,2,GroMoBoy,2980,923,44,33,77,57.1%,8m
16999,1,Cobaneros,2980,725,35,38,73,47.9%,16m
16999,2,Bioloco,2980,582,24,15,39,61.5%,12m
16999,1,[xUKPx]Koki,2980,657,24,30,54,44.4%,5m
16999,2,[iSS]athomeiss,2980,441,18,10,28,64.3%,6m
16999,1,GGman,2980,518,16,20,36,44.4%,3m
16999,1,[Zyrànn]Matschi,2980,313,15,10,25,60.0%,5m
16999,2,Vestnik,2980,394,13,12,25,52.0%,13m
16999,2,RIPHarambe,2980,252,10,3,13,76.9%,8m
16999,3,MRG,2980,136,10,8,18,55.6%,17m
16999,1,Krull,2980,301,9,8,17,52.9%,12m
16999,2,[HDPL]Chronus,2980,339,9,11,20,45.0%,8m
16999,1,BusI,2980,260,8,15,23,34.8%,24m
16999,2,ZeroGravity,2980,145,7,4,11,63.6%,5m
16999,1,Enceladus,2980,90,5,3,8,62.5%,21m
16999,2,[Heroes]McMuffin,2980,120,5,4,9,55.6%,14m
16999,2,IIIIIIIIIII,2980,118,5,5,10,50.0%,26m
16999,3,Zephyr,2980,111,4,2,6,66.7%,14m
16999,2,Bast,2980,60,3,1,4,75.0%,9m
16999,2,[TFoxy]Thor,2980,30,2,1,3,66.7%,10m
16999,2,TorresK,2980,58,2,2,4,50.0%,11m
16999,2,AitorElTanga,2980,0,1,0,1,100.0%,12m
16999,2,[Wrex]seriosblack,2980,32,1,1,2,50.0%,17m
16999,2,Игнезис,2980,0,1,1,2,50.0%,20m
16999,2,GriwMF,2980,0,0,1,1,0.0%,3m
16999,2,Pancake,2980,0,0,2,2,0.0%,24m
16999,2,FengTimo,2980,0,0,3,3,0.0%,9m
17033,3,[GNORI]Oguretrix,2979,715,120,112,232,51.7%,13m
17033,1,RiJiK,2979,1314,108,104,212,50.9%,26m
17033,3,ЕдкийГоблин,2979,1164,106,93,199,53.3%,21m
17033,2,Graflordalot,2979,975,72,65,137,52.6%,22m
17033,1,SaturaX,2979,1193,52,52,104,50.0%,6m
17033,1,[PLANgg]Venator,2979,750,46,44,90,51.1%,20m
17033,2,Timur,2979,506,20,22,42,47.6%,3m
17033,2,[NBDS]PumpFake,2979,368,13,9,22,59.1%,11m
17033,1,[RearGG]Helios,2979,288,12,13,25,48.0%,16m
17033,2,[Dobro]PunisherJ,2979,360,12,14,26,46.2%,18m
17033,2,BALANCANET,2979,254,10,4,14,71.4%,3m
17033,2,Nando,2979,176,7,2,9,77.8%,10m
17033,1,[N8Wrst]Makak,2979,120,6,2,8,75.0%,23m
17033,2,ZorPit,2979,150,6,6,12,50.0%,26m
17033,1,Maximus,2979,48,4,3,7,57.1%,23m
17033,2,[HZeS]ТеньМонолита,2979,30,2,0,2,100.0%,20m
17033,2,[SALKAN]SuperSheep,2979,30,2,0,2,100.0%,3m
17033,2,[CS02]Atomup,2979,92,2,1,3,66.7%,24m
17033,1,IIIIIIIIIII,2979,0,2,5,7,28.6%,16m
17033,1,Pukiente,2979,139,2,13,15,13.3%,34m
17033,2,[DemuCl]Jazzz,2979,32,1,4,5,20.0%,15m
17033,2,Lyurax,2979,0,0,1,1,0.0%,3m
17033,2,[BHN]sergoRU,2979,0,0,1,1,0.0%,24m
17033,2,Terran,2979,0,0,1,1,0.0%,17m
17033,2,dirtygreg,2979,0,0,2,2,0.0%,22m
17033,1,IIIIIIIIIIII,2979,0,0,7,7,0.0%,16m
17059,1,[Ronins]Virus,2978,1665,298,288,586,50.9%,19m
17059,2,llllllllllll,2978,1603,259,240,499,51.9%,4m
17059,2,nanuh,2978,1612,201,173,374,53.7%,7m
17059,1,ooonick,2978,1650,193,181,374,51.6%,4m
17059,3,direstraits,2978,1505,186,184,370,50.3%,9m
17059,3,[HQ31er]kottero,2978,505,91,99,190,47.9%,8m
17059,3,SkyRunner,2978,971,75,82,157,47.8%,15m
17059,2,[IGRTWI]GlobalRak,2978,1033,59,26,85,69.4%,16m
17059,2,Ico,2978,1395,57,52,109,52.3%,20m
17059,1,Kuiper,2978,1368,53,49,102,52.0%,26m
17059,2,LosTime,2978,1196,48,44,92,52.2%,3m
17059,2,Panasratic,2978,447,31,26,57,54.4%,4m
17059,2,Smasher,2978,646,27,20,47,57.4%,18m
17059,2,[Zhig]Fulbaster,2978,534,20,18,38,52.6%,23m
17059,1,[WNTR]Hydrogenium,2978,308,11,15,26,42.3%,6m
17059,1,Sol,2978,144,7,6,13,53.8%,24m
17059,1,Helix,2978,246,7,11,18,38.9%,23m
17059,2,TobSucht,2978,178,6,3,9,66.7%,3m
17059,2,SaltySalad,2978,170,6,5,11,54.5%,20m
17059,2,king,2978,140,4,2,6,66.7%,40m
17059,2,[IBeAŚI]Herold,2978,86,3,3,6,50.0%,17m
17059,1,Strixling,2978,89,3,3,6,50.0%,19m
17059,1,baboushka,2978,118,3,13,16,18.8%,23m
17059,1,Niñiah,2978,0,1,0,1,100.0%,23m
17059,2,[RTNP]getwidowmine,2978,30,1,1,2,50.0%,20m
17059,1,Caetharsis,2978,36,1,8,9,11.1%,3m
17059,2,[PRAIM]TemplarKing,2978,0,0,1,1,0.0%,14m
17059,2,RubbinMaNips,2978,0,0,1,1,0.0%,20m
17059,2,Stickman,2978,0,0,1,1,0.0%,4m
17059,2,Nicinavi,2978,0,0,2,2,0.0%,14m
17089,3,[PiGPan]JackTheFunk,2977,1476,330,329,659,50.1%,23m
17089,1,XantiXae,2977,1139,99,83,182,54.4%,16m
17089,2,Stasis,2977,834,44,39,83,53.0%,4m
17089,2,[ARBY]abricot,2977,746,30,25,55,54.5%,3m
17089,2,[Vortx]Zurile,2977,666,21,45,66,31.8%,26m
17089,2,SandR,2977,385,17,16,33,51.5%,18m
17089,1,ridikjuluz,2977,546,17,25,42,40.5%,8m
17089,2,boozzee,2977,345,14,12,26,53.8%,12m
17089,2,BShield,2977,380,14,13,27,51.9%,8m
17089,2,Sufferu,2977,162,8,3,11,72.7%,3m
17089,2,[VARP]PUSTOTA,2977,234,8,5,13,61.5%,16m
17089,2,Tetsu,2977,204,8,6,14,57.1%,16m
17089,2,MikeOxLong,2977,214,7,8,15,46.7%,6m
17089,2,grrr,2977,180,6,3,9,66.7%,24m
17089,2,KhalaiONE,2977,156,6,4,10,60.0%,8m
17089,1,HuluMulu,2977,104,5,4,9,55.6%,12m
17089,2,dadilium,2977,102,4,3,7,57.1%,3m
17089,1,Jupiter,2977,97,4,3,7,57.1%,18m
17089,1,[P2F]Baltor,2977,0,3,2,5,60.0%,20m
17089,2,Hungry,2977,86,3,2,5,60.0%,10m
17089,2,[BULD0G]KalmeCavia,2977,88,3,2,5,60.0%,5m
17089,2,Fochis,2977,0,3,2,5,60.0%,11m
17089,2,HeckinHecks,2977,0,3,2,5,60.0%,5m
17089,2,Nilosaur,2977,0,3,2,5,60.0%,20m
17089,2,[UF2AC]Rick,2977,30,2,1,3,66.7%,20m
17089,2,Mael,2977,112,2,1,3,66.7%,22m
17089,1,Corleozo,2977,97,2,5,7,28.6%,22m
17089,2,who,2977,30,1,1,2,50.0%,21m
17089,1,RoTeMk,2977,0,1,2,3,33.3%,43m
17089,2,milmundos,2977,0,0,1,1,0.0%,7m
17089,2,demoncomm,2977,0,0,1,1,0.0%,9m
17089,2,FlowerKiller,2977,0,0,2,2,0.0%,24m
17121,3,[WITCHs]DarkCCII,2976,1419,214,206,420,51.0%,26m
17121,1,SLAY,2976,1647,166,153,319,52.0%,16m
17121,1,ECAMstar,2976,1213,144,135,279,51.6%,9m
17121,1,Llion,2976,1580,96,90,186,51.6%,23m
17121,2,Xakari,2976,1591,79,72,151,52.3%,23m
17121,2,Frunk,2976,839,53,42,95,55.8%,7m
17121,2,[FUJKA]Bober,2976,872,35,29,64,54.7%,18m
17121,2,[YLLUMA]Abominus,2976,543,27,11,38,71.1%,8m
17121,2,IcyGoblin,2976,495,26,11,37,70.3%,6m
17121,2,ghaneee,2976,575,23,22,45,51.1%,8m
17121,2,ZxHoly,2976,494,20,16,36,55.6%,4m
17121,1,Pocus,2976,516,20,21,41,48.8%,16m
17121,1,IIIIIIIIIIII,2976,594,20,24,44,45.5%,26m
17121,1,[AISC]Takefear,2976,525,19,17,36,52.8%,12m
17121,2,[DELADO]Dova,2976,405,18,10,28,64.3%,5m
17121,2,[Bangz]Hodini,2976,375,16,9,25,64.0%,14m
17121,1,[TedB]Manzhe,2976,330,11,12,23,47.8%,26m
17121,2,CrabMan,2976,273,10,7,17,58.8%,36m
17121,2,Link,2976,228,8,6,14,57.1%,17m
17121,2,[HakM]ApfelvomBaum,2976,145,7,6,13,53.8%,20m
17121,1,[1DELTA]Titus,2976,285,7,12,19,36.8%,16m
17121,1,[VEGE]LevaNik,2976,156,6,4,10,60.0%,3m
17121,2,OXO,2976,90,6,5,11,54.5%,12m
17121,1,[IQ27]LtPrime,2976,97,5,1,6,83.3%,1h
17121,1,Jon,2976,174,5,2,7,71.4%,1h
17121,2,Morose,2976,0,3,2,5,60.0%,9m
17121,2,[SZ]NeMo,2976,92,3,4,7,42.9%,8m
17121,2,[FalPal]elithedon,2976,62,3,5,8,37.5%,4m
17121,1,Evangelion,2976,70,3,6,9,33.3%,4m
17121,2,Hexenkönie,2976,86,2,3,5,40.0%,28m
17121,1,Simps,2976,74,2,7,9,22.2%,6m
17121,1,Braintrap,2976,40,2,9,11,18.2%,21m
17121,1,[CZUMPI]Grodek,2976,0,1,0,1,100.0%,9m
17121,1,Gaunt,2976,0,1,1,2,50.0%,22m
17121,2,[Larry]Anaxagore,2976,0,1,4,5,20.0%,9m
17121,1,[WTSO]klafdis,2976,0,1,6,7,14.3%,21m
17121,2,[MeXI]mexanica,2976,0,0,1,1,0.0%,22m
17121,2,[Gobe]Caldwell,2976,0,0,2,2,0.0%,12m
17121,2,Vitafit,2976,0,0,2,2,0.0%,24m
17121,2,GRANDMASTER,2976,0,0,5,5,0.0%,12m
17161,2,Jim,2975,1257,173,148,321,53.9%,20m
17161,1,Vonix,2975,1524,60,52,112,53.6%,18m
17161,2,nhabine,2975,1359,59,46,105,56.2%,4m
17161,1,HigH,2975,565,25,20,45,55.6%,21m
17161,2,cannamusic,2975,574,23,20,43,53.5%,24m
17161,2,[Shr3Kd]MeNeSbatto,2975,479,22,10,32,68.8%,17m
17161,1,Tossi,2975,370,15,17,32,46.9%,23m
17161,2,JonStolt,2975,178,14,8,22,63.6%,4m
17161,3,IIIIIIIIIIII,2975,284,12,11,23,52.2%,4m
17161,1,Jeleoo,2975,235,11,9,20,55.0%,1h
17161,2,[NLTN]VasiliyGQ,2975,236,11,13,24,45.8%,15m
17161,2,StarInfestor,2975,60,6,3,9,66.7%,23m
17161,1,Styx,2975,48,5,3,8,62.5%,1h
17161,2,jesterret,2975,122,5,5,10,50.0%,23m
17161,2,Prototype,2975,58,5,8,13,38.5%,3m
17161,1,Meanmashine,2975,0,3,2,5,60.0%,1h
17161,1,[STMF]Calcifer,2975,92,3,5,8,37.5%,1h
17161,2,elmerFudd,2975,0,2,3,5,40.0%,8m
17161,1,Makkemias,2975,0,1,0,1,100.0%,1h
17161,1,[play45]RaiFas,2975,0,1,2,3,33.3%,26m
17161,2,hazzling,2975,0,1,2,3,33.3%,10m
17161,2,Jabper,2975,0,0,1,1,0.0%,5m
17161,2,Rainy,2975,0,0,2,2,0.0%,3m
17161,2,[64GROT]Ruiner,2975,0,0,3,3,0.0%,12m
17185,1,SERG,2974,1642,196,182,378,51.9%,21m
17185,2,Bob,2974,873,163,146,309,52.8%,6m
17185,3,smeke,2974,1404,133,138,271,49.1%,24m
17185,1,aaaaaaaaaa,2974,1020,44,34,78,56.4%,3m
17185,2,Asukurra,2974,797,39,24,63,61.9%,7m
17185,1,Jolte,2974,816,30,38,68,44.1%,8m
17185,2,Nikopol,2974,631,27,21,48,56.2%,12m
17185,2,HangMAN,2974,486,17,16,33,51.5%,15m
17185,2,LELUK,2974,363,14,11,25,56.0%,22m
17185,1,PaRaDoX,2974,414,12,18,30,40.0%,19m
17185,1,[GOD]ronyx,2974,283,8,10,18,44.4%,26m
17185,1,wojtastychy,2974,145,7,7,14,50.0%,12m
17185,2,Adonais,2974,116,6,4,10,60.0%,5m
17185,2,Proof,2974,30,4,3,7,57.1%,12m
17185,2,[PPIG]Mleden,2974,0,3,2,5,60.0%,15m
17185,1,[UREU]Vilder,2974,0,3,2,5,60.0%,10m
17185,1,Nighte,2974,136,3,3,6,50.0%,1h
17185,2,[NWAro]FelineFrog,2974,60,3,3,6,50.0%,13m
17185,2,Kiter,2974,66,2,7,9,22.2%,12m
17185,3,Washburn,2974,0,1,0,1,100.0%,19m
17185,1,namaste,2974,0,1,0,1,100.0%,44m
17185,2,DRACO,2974,91,1,1,2,50.0%,12m
17185,2,Tapzi,2974,30,1,3,4,25.0%,10m
17185,1,[AMCque]MoNsTeR,2974,40,1,8,9,11.1%,24m
17185,1,cryer,2974,0,0,1,1,0.0%,28m
17185,2,SirBob,2974,0,0,2,2,0.0%,28m
17211,1,Relu,2973,1189,138,122,260,53.1%,20m
17211,1,[love2D]Light,2973,1092,136,118,254,53.5%,16m
17211,2,Kaszanka,2973,1281,92,69,161,57.1%,9m
17211,2,Kesko,2973,877,85,81,166,51.2%,18m
17211,1,TankBG,2973,476,70,59,129,54.3%,19m
17211,2,BastiAKA,2973,950,37,33,70,52.9%,6m
17211,2,[Hammer]JakeTheEX,2973,714,30,20,50,60.0%,9m
17211,2,Chamber,2973,692,30,20,50,60.0%,4m
17211,1,iblztrobert,2973,378,20,29,49,40.8%,18m
17211,2,[CosCom]SnazeR,2973,456,17,13,30,56.7%,20m
17211,1,[ÆR]ReVeHUN,2973,356,16,15,31,51.6%,24m
17211,2,[FARLIG]Terminator,2973,392,15,12,27,55.6%,19m
17211,2,[HomikZ]merefnebef,2973,360,13,13,26,50.0%,20m
17211,2,[Xa]CloudyZerO,2973,270,10,6,16,62.5%,12m
17211,2,Frosty,2973,236,10,8,18,55.6%,22m
17211,2,WolkadaW,2973,149,7,4,11,63.6%,10m
17211,1,XXXXXXXXXXXX,2973,231,5,9,14,35.7%,4m
17211,2,[Fatty]Beignet,2973,30,4,3,7,57.1%,3m
17211,2,GrekNec,2973,118,4,5,9,44.4%,4m
17211,1,Smile,2973,120,4,6,10,40.0%,21m
17211,1,XELLOSSYNC,2973,0,2,4,6,33.3%,15m
17211,3,RavenFrost,2973,38,1,1,2,50.0%,6m
17211,2,HedantTV,2973,30,1,1,2,50.0%,24m
17211,2,[QTclub]YoAnSingSong,2973,30,1,3,4,25.0%,10m
17211,2,Gilgamesh,2973,0,0,1,1,0.0%,1h
17211,2,[DLN]Prskanjagoda,2973,0,0,1,1,0.0%,24m
17211,2,[Faith1]BENSHEE,2973,0,0,2,2,0.0%,22m
17211,1,HelioGracie,2973,0,0,7,7,0.0%,16m
17239,3,Sundowner,2972,1582,560,543,1103,50.8%,23m
17239,3,Ray,2972,1499,151,141,292,51.7%,23m
17239,2,Glores,2972,1546,113,89,202,55.9%,10m
17239,1,BANANA,2972,1593,80,62,142,56.3%,16m
17239,2,[NLTN]Kulka,2972,1287,74,59,133,55.6%,8m
17239,3,tomcher,2972,432,17,18,35,48.6%,20m
17239,2,genius,2972,334,12,12,24,50.0%,8m
17239,2,[2D2Д]Chan,2972,308,11,7,18,61.1%,12m
17239,2,Middo,2972,258,10,6,16,62.5%,4m
17239,2,Wasiu,2972,256,8,7,15,53.3%,8m
17239,2,[CataC]alexander,2972,190,6,5,11,54.5%,4m
17239,1,Snow,2972,96,4,2,6,66.7%,26m
17239,3,[xTQc]Two,2972,107,4,6,10,40.0%,9m
17239,2,GVVBernado,2972,0,3,2,5,60.0%,22m
17239,2,Fredrik,2972,0,3,2,5,60.0%,8m
17239,2,TheGrat,2972,0,3,2,5,60.0%,14m
17239,2,xDontxCryx,2972,30,1,1,2,50.0%,7m
17239,2,DECADE,2972,0,1,1,2,50.0%,10m
17239,2,Soma,2972,0,0,1,1,0.0%,3m
17239,2,Rust,2972,0,0,1,1,0.0%,13m
17239,2,Aordin,2972,0,0,2,2,0.0%,24m
17239,2,Getic,2972,0,0,2,2,0.0%,3m
17261,1,Vijel,2971,797,59,55,114,51.8%,20m
17261,2,Max,2971,520,55,48,103,53.4%,8m
17261,1,ELIMINATOR,2971,1395,52,56,108,48.1%,18m
17261,3,Mejor,2971,373,49,42,91,53.8%,17m
17261,1,tpj,2971,921,47,42,89,52.8%,7m
17261,1,[Marqis]DeGuenerat,2971,1062,43,37,80,53.8%,3m
17261,2,OverDosZ,2971,346,11,9,20,55.0%,21m
17261,2,[улей55]сергей,2971,167,9,7,16,56.2%,31m
17261,2,Raczo,2971,177,7,7,14,50.0%,10m
17261,2,Ragnarson,2971,186,5,4,9,55.6%,22m
17261,1,fatman,2971,95,5,5,10,50.0%,5m
17261,1,[VLDLOX]Bezbalkonnay,2971,97,4,3,7,57.1%,26m
17261,2,DoDo,2971,30,4,3,7,57.1%,9m
17261,1,[VMZ]beQuiet,2971,0,3,2,5,60.0%,1h
17261,2,seratul,2971,30,2,1,3,66.7%,14m
17261,2,[Rakii]tosun,2971,0,1,0,1,100.0%,8m
17261,2,AlphaJuliet,2971,0,1,1,2,50.0%,22m
17261,2,kesha,2971,0,1,3,4,25.0%,12m
17261,2,Rikardth,2971,34,1,5,6,16.7%,10m
17261,1,totonium,2971,0,0,2,2,0.0%,1h
17261,2,llllllllllll,2971,0,0,2,2,0.0%,14m
17261,2,[GSCOC]Noco,2971,0,0,3,3,0.0%,20m
17261,1,eVoZ,2971,0,0,6,6,0.0%,8m
17284,2,TaSeAn,2970,1201,113,109,222,50.9%,12m
17284,1,[mgaLIT]Speed,2970,1266,52,47,99,52.5%,4m
17284,2,DARKDEVIL,2970,1026,49,28,77,63.6%,20m
17284,2,[LuBa]Zeifen,2970,570,25,20,45,55.6%,9m
17284,2,bapclap,2970,436,19,10,29,65.5%,5m
17284,1,Kokusz,2970,355,14,14,28,50.0%,6m
17284,1,ValeX,2970,150,14,16,30,46.7%,10m
17284,2,PechalkOo,2970,290,11,8,19,57.9%,28m
17284,3,Peleandrin,2970,294,11,17,28,39.3%,9m
17284,1,[Rofler]Enigma,2970,252,7,5,12,58.3%,30m
17284,2,Gladiator,2970,108,5,1,6,83.3%,13m
17284,1,LonelyWolf,2970,0,5,1,6,83.3%,18m
17284,1,Amaranthe,2970,0,4,2,6,66.7%,28m
17284,1,[PŖïMĄŁ]Licalo,2970,169,4,3,7,57.1%,1h
17284,1,Gargamel,2970,0,4,3,7,57.1%,21m
17284,1,IceCrusher,2970,0,3,2,5,60.0%,16m
17284,2,WinstonNC,2970,0,3,2,5,60.0%,12m
17284,2,Jerolol,2970,90,3,5,8,37.5%,18m
17284,2,[oooboy]makfek,2970,30,2,0,2,100.0%,15m
17284,2,[dlgc]WhiteRa,2970,112,2,1,3,66.7%,12m
17284,2,BigDickStyle,2970,0,1,0,1,100.0%,8m
17284,3,Ranann,2970,97,1,1,2,50.0%,47m
17284,1,Kreuzritter,2970,0,1,1,2,50.0%,1h
17284,2,CheesingNoob,2970,0,1,3,4,25.0%,15m
17284,2,Sketa,2970,0,0,1,1,0.0%,20m
17284,2,Makar,2970,0,0,1,1,0.0%,9m
17284,2,NeeLi,2970,0,0,1,1,0.0%,8m
17284,2,Vespasien,2970,0,0,2,2,0.0%,8m
17284,1,soslothslow,2970,0,0,8,8,0.0%,1h
17313,2,Benzincioo,2969,1303,116,101,217,53.5%,8m
17313,2,joonTheGoon,2969,1476,83,71,154,53.9%,5m
17313,2,brullikk,2969,1608,76,73,149,51.0%,8m
17313,2,alvaroqp,2969,1545,65,51,116,56.0%,4m
17313,2,[Wick]dingoo,2969,1359,56,57,113,49.6%,4m
17313,2,Manrom,2969,637,27,18,45,60.0%,5m
17313,2,Monkeh,2969,631,27,22,49,55.1%,20m
17313,2,Danan,2969,206,8,8,16,50.0%,16m
17313,2,Desgan,2969,164,7,5,12,58.3%,6m
17313,1,Lykawy,2969,195,7,7,14,50.0%,16m
17313,2,[LGNxEU]howtobarcode,2969,176,5,3,8,62.5%,8m
17313,2,Danisaur,2969,0,4,1,5,80.0%,24m
17313,2,Kinion,2969,90,4,3,7,57.1%,12m
17313,2,[N0H1]CHACHA,2969,114,4,5,9,44.4%,20m
17313,1,badass,2969,0,2,4,6,33.3%,14m
17313,2,[InBri]Fedor,2969,0,1,0,1,100.0%,8m
17313,2,[ShaCh]MurcoDomini,2969,0,1,0,1,100.0%,18m
17313,2,[T2sc2]Tima,2969,0,1,0,1,100.0%,7m
17313,2,[Kicx]krys,2969,0,0,1,1,0.0%,12m
17313,2,[QTcIub]Gimlouis,2969,0,0,1,1,0.0%,9m
17313,2,vladimislav,2969,0,0,1,1,0.0%,13m
17334,3,[WOO]Tittania,2968,1555,363,367,730,49.7%,6m
17334,1,OverlordUA,2968,1649,221,189,410,53.9%,19m
17334,2,[BR4VE]Doomsday,2968,1584,181,172,353,51.3%,20m
17334,3,DeWyze,2968,1478,123,113,236,52.1%,13m
17334,2,Gonzo,2968,1139,91,85,176,51.7%,9m
17334,1,NFprobe,2968,1083,46,38,84,54.8%,19m
17334,2,Phenom,2968,670,33,20,53,62.3%,20m
17334,2,Modscore,2968,295,32,33,65,49.2%,8m
17334,3,[BGpk]packo,2968,664,28,29,57,49.1%,10m
17334,2,bewhy,2968,621,26,16,42,61.9%,22m
17334,2,ThisIsASteak,2968,408,16,11,27,59.3%,10m
17334,2,Nik,2968,344,15,6,21,71.4%,6m
17334,2,Ares,2968,409,15,12,27,55.6%,14m
17334,2,sava,2968,353,13,10,23,56.5%,13m
17334,2,lordsd,2968,360,13,10,23,56.5%,8m
17334,1,HertzBR,2968,376,10,17,27,37.0%,12m
17334,2,Garna,2968,242,9,9,18,50.0%,4m
17334,3,Androkles,2968,150,9,13,22,40.9%,9m
17334,2,[IRTG]Futorius,2968,195,8,6,14,57.1%,13m
17334,2,[SCHD]Riverse,2968,192,7,2,9,77.8%,26m
17334,2,Beloyar,2968,90,4,3,7,57.1%,5m
17334,2,[BLkSa]NarkotiKa,2968,92,4,5,9,44.4%,4m
17334,2,ront,2968,112,4,7,11,36.4%,10m
17334,2,TACTiX,2968,0,3,2,5,60.0%,22m
17334,1,AaroN,2968,0,3,2,5,60.0%,8m
17334,2,BimHitNooB,2968,30,2,1,3,66.7%,5m
17334,2,Rexis,2968,30,2,2,4,50.0%,22m
17334,2,Algon,2968,0,1,0,1,100.0%,10m
17334,2,Gosya,2968,0,1,1,2,50.0%,22m
17334,2,[CanFod]ALK,2968,30,1,2,3,33.3%,24m
17364,1,[Chariz]Valyyz,2967,518,168,157,325,51.7%,5m
17364,1,[Wudang]MASTER,2967,1626,105,110,215,48.8%,18m
17364,2,KoalaStrike,2967,788,91,86,177,51.4%,18m
17364,1,Hardy,2967,584,54,57,111,48.6%,23m
17364,2,JohnMerrick,2967,1257,53,42,95,55.8%,22m
17364,2,Janzeer,2967,1271,52,47,99,52.5%,23m
17364,1,BriVicShadow,2967,1374,51,51,102,50.0%,6m
17364,1,OldLeper,2967,1068,48,46,94,51.1%,3m
17364,2,Hvarfdýr,2967,997,43,32,75,57.3%,3m
17364,1,FrostPAIN,2967,1197,43,48,91,47.3%,26m
17364,3,KnufflPuffl,2967,917,33,42,75,44.0%,3m
17364,1,[DéKá]Chose,2967,759,27,27,54,50.0%,5m
17364,2,[TheDW1]fetsre,2967,602,25,16,41,61.0%,5m
17364,1,[ICXC]FominVL,2967,729,25,24,49,51.0%,20m
17364,2,HotCoffeeDog,2967,566,20,23,43,46.5%,10m
17364,2,Xiphias,2967,417,16,11,27,59.3%,24m
17364,2,LittleProbe,2967,359,15,10,25,60.0%,4m
17364,2,AppeL,2967,273,14,7,21,66.7%,19m
17364,2,Lauscher,2967,166,12,12,24,50.0%,18m
17364,2,kemenchik,2967,298,11,12,23,47.8%,15m
17364,2,nikson,2967,165,10,10,20,50.0%,7m
17364,1,Wab,2967,260,10,10,20,50.0%,33m
17364,3,Riko,2967,174,10,10,20,50.0%,23m
17364,2,KokOSs,2967,244,8,5,13,61.5%,21m
17364,1,abc,2967,311,8,13,21,38.1%,21m
17364,3,SuspiRia,2967,122,6,5,11,54.5%,9m
17364,1,ChanChan,2967,0,4,2,6,66.7%,28m
17364,1,hiMelnikov,2967,121,2,2,4,50.0%,1h
17364,2,[ifsc]Duderino,2967,30,2,4,6,33.3%,20m
17364,2,BravoRagazzo,2967,0,1,0,1,100.0%,8m
17364,2,Kimshi,2967,0,1,0,1,100.0%,8m
17364,2,ImpERROR,2967,30,1,1,2,50.0%,24m
17364,2,Qauz,2967,30,1,2,3,33.3%,14m
17364,2,HexepHaxep,2967,30,1,3,4,25.0%,24m
17364,2,BERLINcrime,2967,0,0,1,1,0.0%,5m
17364,2,[Wø]Skayn,2967,0,0,2,2,0.0%,13m
17400,1,YegorB,2966,1652,118,107,225,52.4%,9m
17400,1,Mara,2966,1436,76,64,140,54.3%,22m
17400,2,Rajotah,2966,1442,60,60,120,50.0%,13m
17400,2,Crystalize,2966,1197,59,52,111,53.2%,22m
17400,2,BlueBanana,2966,1111,52,39,91,57.1%,12m
17400,2,[K0mpis]Challenger,2966,1039,41,36,77,53.2%,4m
17400,1,TheNavy,2966,931,32,38,70,45.7%,16m
17400,2,DrJacek,2966,328,17,8,25,68.0%,15m
17400,2,Otstavnik,2966,440,16,13,29,55.2%,5m
17400,3,[Orval]OrangeBudd,2966,214,7,16,23,30.4%,3m
17400,1,IIIIIIIIIIII,2966,36,5,4,9,55.6%,6m
17400,1,Heateli,2966,89,4,2,6,66.7%,1h
17400,1,eragon,2966,144,4,7,11,36.4%,1h
17400,1,Hobson,2966,96,3,1,4,75.0%,1h
17400,1,Grishap,2966,0,3,2,5,60.0%,28m
17400,2,YoshiYo,2966,88,3,3,6,50.0%,4m
17400,2,PCH,2966,30,2,0,2,100.0%,12m
17400,3,zzDONzz,2966,42,2,1,3,66.7%,41m
17400,1,RADIOHEAD,2966,0,1,0,1,100.0%,12m
17400,2,Feanor,2966,0,1,0,1,100.0%,22m
17400,2,Anodyne,2966,0,0,1,1,0.0%,24m
17400,1,Stepchik,2966,0,0,1,1,0.0%,31m
17400,1,SchminguS,2966,0,0,6,6,0.0%,26m
17423,1,kiwi,2965,1591,226,228,454,49.8%,16m
17423,1,NsǂBbflo,2965,1631,149,126,275,54.2%,26m
17423,2,[HAWNE]Launam,2965,1664,128,130,258,49.6%,21m
17423,2,Roedie,2965,1182,111,98,209,53.1%,3m
17423,1,ORZ,2965,772,81,80,161,50.3%,6m
17423,1,EndlessDream,2965,548,42,46,88,47.7%,13m
17423,1,Mewys,2965,357,23,20,43,53.5%,10m
17423,2,Pain,2965,574,22,20,42,52.4%,8m
17423,2,Gades,2965,362,18,10,28,64.3%,5m
17423,2,[BSkyT]LuKrO,2965,488,18,14,32,56.2%,15m
17423,3,[15ANS]TikiBoom,2965,196,16,21,37,43.2%,9m
17423,3,Eman,2965,430,14,28,42,33.3%,9m
17423,2,Iisus,2965,254,10,8,18,55.6%,24m
17423,2,[1ndica]ZerO,2965,246,10,8,18,55.6%,20m
17423,2,DeathTouch,2965,192,9,6,15,60.0%,12m
17423,2,balabala,2965,208,8,2,10,80.0%,8m
17423,2,Haro,2965,171,8,5,13,61.5%,11m
17423,2,Libik,2965,240,8,12,20,40.0%,8m
17423,1,gundyev,2965,284,8,14,22,36.4%,26m
17423,3,StarFighter,2965,82,7,4,11,63.6%,27m
17423,3,PinGponGnE,2965,122,7,10,17,41.2%,4m
17423,2,[SMSM]FrMarmotte,2965,154,6,0,6,100.0%,12m
17423,1,[SRPRZ]Mars,2965,146,6,6,12,50.0%,20m
17423,1,Radeski,2965,242,6,6,12,50.0%,30m
17423,2,Kerlon,2965,116,5,5,10,50.0%,5m
17423,2,inquisitor,2965,118,4,9,13,30.8%,4m
17423,1,vbifqwe,2965,72,3,8,11,27.3%,9m
17423,2,[1NFEC7]BiZarKiD,2965,0,2,3,5,40.0%,6m
17423,2,PcB,2965,60,2,4,6,33.3%,5m
17423,1,[HoMM]revesvans,2965,64,2,8,10,20.0%,18m
17423,2,GoSWBay,2965,88,1,1,2,50.0%,12m
17423,2,Luplus,2965,0,1,1,2,50.0%,12m
17423,2,[TgAg]MaxThePigeon,2965,30,1,3,4,25.0%,12m
17423,2,Genji,2965,0,0,1,1,0.0%,20m
17423,2,phaze,2965,0,0,1,1,0.0%,24m
17423,2,koment,2965,0,0,1,1,0.0%,12m
17459,1,LAFAUCHEUSE,2964,825,137,117,254,53.9%,9m
17459,2,[TEF]Lutzio,2964,1260,90,64,154,58.4%,23m
17459,2,[Mokkä]Curse,2964,824,49,40,89,55.1%,21m
17459,1,jihadxdeath,2964,531,40,41,81,49.4%,18m
17459,2,Rasslabuha,2964,199,24,9,33,72.7%,20m
17459,2,apl,2964,583,23,18,41,56.1%,7m
17459,2,[Hrr]Kado,2964,426,20,13,33,60.6%,13m
17459,2,Mako,2964,414,18,12,30,60.0%,5m
17459,2,Uber,2964,400,18,14,32,56.2%,11m
17459,2,Rioss,2964,254,9,10,19,47.4%,20m
17459,1,MoNsTeReT,2964,96,5,4,9,55.6%,1h
17459,2,Ronaldenci,2964,138,4,1,5,80.0%,23m
17459,2,FontaD,2964,138,3,2,5,60.0%,19m
17459,2,NNN,2964,0,3,2,5,60.0%,23m
17459,2,Numinex,2964,84,3,4,7,42.9%,31m
17459,2,[Prvrs]phophy,2964,96,3,8,11,27.3%,20m
17459,2,cykalord,2964,30,2,4,6,33.3%,24m
17459,1,lolologh,2964,0,1,0,1,100.0%,42m
17459,1,Tavise,2964,0,1,1,2,50.0%,4m
17459,2,moro,2964,0,0,1,1,0.0%,8m
17459,2,Creuvard,2964,0,0,2,2,0.0%,18m
17480,1,DrSceern,2963,1134,131,127,258,50.8%,26m
17480,1,adrian,2963,1186,96,76,172,55.8%,8m
17480,2,[Kazi]ZapaN,2963,1563,84,70,154,54.5%,8m
17480,3,Prime,2963,1544,80,89,169,47.3%,23m
17480,2,Elathalion,2963,746,65,64,129,50.4%,12m
17480,2,MaruSucks,2963,1171,52,36,88,59.1%,3m
17480,1,Astrix,2963,1094,44,41,85,51.8%,16m
17480,2,WaRda,2963,402,30,27,57,52.6%,20m
17480,3,sincostan,2963,474,17,29,46,37.0%,8m
17480,2,InLove,2963,384,16,16,32,50.0%,8m
17480,2,Gumi,2963,340,15,10,25,60.0%,5m
17480,2,[DJ3]KoningMorp,2963,310,12,9,21,57.1%,13m
17480,2,Terraniser,2963,266,12,10,22,54.5%,24m
17480,2,[DTDK]cusio,2963,381,12,12,24,50.0%,8m
17480,2,Klomoton,2963,227,10,7,17,58.8%,4m
17480,2,[PcT]canard,2963,288,10,13,23,43.5%,16m
17480,2,[tetguy]higgs,2963,218,9,6,15,60.0%,20m
17480,2,[SGSA]Fierce,2963,178,6,6,12,50.0%,20m
17480,1,[čus]SedeX,2963,0,5,1,6,83.3%,1h
17480,3,NeoCisab,2963,0,5,2,7,71.4%,1h
17480,2,[BamBum]David,2963,30,2,0,2,100.0%,24m
17480,1,Blickopa,2963,0,2,3,5,40.0%,26m
17480,2,CavKvasovar,2963,0,1,0,1,100.0%,11m
17480,2,Wisp,2963,30,1,3,4,25.0%,3m
17480,2,[INSO]Horroreyes,2963,30,1,5,6,16.7%,20m
17480,2,[TOCC]Vendetta,2963,0,0,1,1,0.0%,13m
17506,2,FoozyWoozy,2962,1333,108,92,200,54.0%,11m
17506,2,[PAPAS]Nico,2962,1132,94,85,179,52.5%,20m
17506,2,bbbb,2962,1098,77,73,150,51.3%,8m
17506,2,[StarLg]Moonlight,2962,902,58,33,91,63.7%,20m
17506,2,LanSung,2962,858,39,29,68,57.4%,19m
17506,2,Proven,2962,802,35,30,65,53.8%,10m
17506,1,SiberiaS,2962,531,21,20,41,51.2%,8m
17506,1,[TheER]Thune,2962,465,18,18,36,50.0%,24m
17506,2,Shaepe,2962,425,17,13,30,56.7%,18m
17506,2,BloodyDancer,2962,273,12,5,17,70.6%,15m
17506,2,Merkur,2962,343,12,10,22,54.5%,15m
17506,3,[DayJ]Fuzzy,2962,211,8,7,15,53.3%,26m
17506,2,Snoopy,2962,210,8,10,18,44.4%,3m
17506,2,Bradis,2962,242,8,10,18,44.4%,24m
17506,2,Levty,2962,86,4,4,8,50.0%,24m
17506,2,Stirrer,2962,86,3,5,8,37.5%,12m
17506,2,servion,2962,60,2,2,4,50.0%,10m
17506,2,BossyJelly,2962,0,1,0,1,100.0%,11m
17506,2,Varandragon,2962,30,1,1,2,50.0%,4m
17506,2,[RYMDEN]daaH,2962,0,1,1,2,50.0%,13m
17506,1,Калмык,2962,0,1,3,4,25.0%,1h
17506,2,talicd,2962,32,1,4,5,20.0%,5m
17506,3,Cameron,2962,44,1,5,6,16.7%,3m
17506,2,SHWAVE,2962,0,0,1,1,0.0%,42m
17506,2,bozz,2962,0,0,1,1,0.0%,6m
17506,2,[maximu]Player,2962,0,0,1,1,0.0%,22m
17532,3,Cheetah,2961,1537,235,238,473,49.7%,19m
17532,2,[fffs]Kerrah,2961,1353,71,63,134,53.0%,8m
17532,1,[SyD]BigO,2961,896,39,36,75,52.0%,8m
17532,2,[Skaro]LuLu,2961,618,31,17,48,64.6%,11m
17532,1,Мразота,2961,550,24,19,43,55.8%,24m
17532,2,Henry,2961,293,11,6,17,64.7%,24m
17532,2,Terran,2961,181,11,12,23,47.8%,20m
17532,2,SIKN,2961,192,8,6,14,57.1%,11m
17532,2,LichtProtoss,2961,188,7,7,14,50.0%,5m
17532,1,[xUKPx]Szaller,2961,0,4,1,5,80.0%,25m
17532,1,[KEKC]WaDe,2961,0,4,2,6,66.7%,24m
17532,3,barcode,2961,0,4,3,7,57.1%,10m
17532,3,oldschool,2961,97,4,4,8,50.0%,1h
17532,2,[o8o]Rushboy,2961,112,3,1,4,75.0%,6m
17532,1,nTsFusiOn,2961,0,3,2,5,60.0%,1h
17532,2,Peiper,2961,30,2,0,2,100.0%,18m
17532,2,Crucian,2961,30,2,1,3,66.7%,12m
17532,2,[crabz]Vladimir,2961,60,2,3,5,40.0%,20m
17532,2,nept,2961,30,2,5,7,28.6%,22m
17532,2,Darkzealot,2961,0,1,0,1,100.0%,4m
17532,2,SimpleJack,2961,32,1,1,2,50.0%,23m
17532,2,Storm,2961,30,1,1,2,50.0%,18m
17532,2,IINirvSpinIl,2961,0,1,5,6,16.7%,3m
17532,2,Halloumi,2961,0,0,1,1,0.0%,21m
17532,2,Teflonhead,2961,0,0,1,1,0.0%,23m
17532,3,Tsydypov,2961,0,0,1,1,0.0%,4m
17532,2,GerryWan,2961,0,0,4,4,0.0%,11m
17559,3,Wingen,2960,1449,186,179,365,51.0%,6m
17559,1,[xPCSx]IronHeart,2960,1474,132,115,247,53.4%,4m
17559,1,Max,2960,1566,126,116,242,52.1%,17m
17559,2,Kriks,2960,1009,94,86,180,52.2%,11m
17559,2,DJON,2960,649,69,55,124,55.6%,20m
17559,1,Daylight,2960,598,44,44,88,50.0%,5m
17559,2,Tathamet,2960,899,36,33,69,52.2%,15m
17559,2,[NÛL]Kratoslezerg,2960,780,32,23,55,58.2%,23m
17559,2,[Aie]MORO,2960,621,25,20,45,55.6%,22m
17559,2,Ragnar,2960,564,20,23,43,46.5%,11m
17559,2,South,2960,384,18,15,33,54.5%,8m
17559,2,Beef,2960,369,15,13,28,53.6%,15m
17559,2,AkihitoNari,2960,332,13,12,25,52.0%,4m
17559,2,haikers,2960,314,11,11,22,50.0%,4m
17559,2,Versus,2960,251,9,5,14,64.3%,18m
17559,1,[L4DYS]MissTake,2960,232,7,4,11,63.6%,1h
17559,2,[BEUW]Voltuxx,2960,150,6,5,11,54.5%,5m
17559,2,Toxich,2960,114,5,3,8,62.5%,12m
17559,2,[ArGGEU]ElectroEagle,2960,169,5,6,11,45.5%,8m
17559,2,[TRVMP]dobispr,2960,102,3,0,3,100.0%,18m
17559,2,Mercury,2960,0,3,2,5,60.0%,22m
17559,2,Hoek,2960,0,3,2,5,60.0%,12m
17559,2,JustRelax,2960,0,3,2,5,60.0%,5m
17559,2,Enemy,2960,90,3,6,9,33.3%,4m
17559,2,Foundation,2960,58,2,2,4,50.0%,5m
17559,2,lktrbl,2960,0,2,3,5,40.0%,39m
17559,2,fofful,2960,0,1,1,2,50.0%,23m
17559,1,ДикаяСосиска,2960,48,1,2,3,33.3%,1h
17559,2,[ODGI]Browntown,2960,30,1,3,4,25.0%,22m
17559,2,Kevin,2960,0,0,1,1,0.0%,13m
17589,1,dropounet,2959,1576,200,197,397,50.4%,16m
17589,1,WartenLKW,2959,1629,141,130,271,52.0%,5m
17589,1,Maat,2959,1616,95,88,183,51.9%,21m
17589,2,Astorias,2959,1252,54,50,104,51.9%,4m
17589,1,Sven,2959,1059,53,49,102,52.0%,16m
17589,2,[LTLWNG]GreyAfrican,2959,1340,52,50,102,51.0%,5m
17589,2,xxArenaMxx,2959,1113,48,34,82,58.5%,3m
17589,2,Demonic,2959,1310,48,50,98,49.0%,12m
17589,2,moid,2959,689,30,19,49,61.2%,10m
17589,2,even,2959,581,22,21,43,51.2%,6m
17589,2,Grot,2959,560,20,20,40,50.0%,15m
17589,2,MakisG,2959,387,17,9,26,65.4%,8m
17589,2,MrFluffy,2959,455,17,12,29,58.6%,7m
17589,2,WitchyMiku,2959,428,17,14,31,54.8%,3m
17589,2,[Wild99]ToniEric,2959,371,15,10,25,60.0%,11m
17589,3,outlandeR,2959,226,9,6,15,60.0%,47m
17589,2,Andreus,2959,268,9,11,20,45.0%,16m
17589,2,BottomQuak,2959,152,6,7,13,46.2%,21m
17589,3,johndeere,2959,30,5,6,11,45.5%,23m
17589,1,Azula,2959,203,5,10,15,33.3%,6m
17589,1,Shadow,2959,97,4,2,6,66.7%,37m
17589,1,Trofim,2959,48,4,3,7,57.1%,1h
17589,3,Blitz,2959,146,4,8,12,33.3%,17m
17589,2,[Пчелки]Soap,2959,96,3,1,4,75.0%,41m
17589,2,[ŚS6]PiraMID,2959,126,3,1,4,75.0%,8m
17589,2,shaitan,2959,30,2,1,3,66.7%,24m
17589,2,JimmyNeutron,2959,0,1,0,1,100.0%,21m
17589,3,Culexius,2959,0,1,1,2,50.0%,17m
17589,2,[spbila]Kirk,2959,0,1,2,3,33.3%,9m
17589,2,Neruos,2959,0,0,1,1,0.0%,8m
17589,3,[K0mpis]Kromat,2959,0,0,2,2,0.0%,16m
17589,2,Psilimit,2959,0,0,2,2,0.0%,4m
17589,2,Ethan,2959,0,0,2,2,0.0%,16m
17622,1,Dino,2958,974,64,58,122,52.5%,22m
17622,1,PathOfNewbie,2958,549,58,21,79,73.4%,10m
17622,2,eScalation,2958,808,55,39,94,58.5%,15m
17622,3,Androck,2958,781,49,55,104,47.1%,26m
17622,2,[DIRSTK]Endorama,2958,654,41,34,75,54.7%,12m
17622,2,[JotC]Calamitavia,2958,829,38,23,61,62.3%,6m
17622,2,[LI69]StormBringer,2958,355,35,22,57,61.4%,10m
17622,2,SmauG,2958,845,33,27,60,55.0%,8m
17622,2,Houston,2958,632,26,18,44,59.1%,3m
17622,2,Terranium,2958,478,19,12,31,61.3%,3m
17622,2,ROACH,2958,316,13,8,21,61.9%,4m
17622,2,ZERATUL,2958,222,9,9,18,50.0%,22m
17622,2,NotSaitama,2958,241,8,5,13,61.5%,22m
17622,2,ReunioN,2958,167,7,1,8,87.5%,16m
17622,2,[NCtk]Bartimaeus,2958,198,7,3,10,70.0%,24m
17622,1,IlIlIlIlI,2958,168,5,4,9,55.6%,19m
17622,2,[subj]triploy,2958,137,4,6,10,40.0%,37m
17622,2,SPoT,2958,60,3,2,5,60.0%,8m
17622,2,Computer,2958,0,3,2,5,60.0%,42m
17622,2,[SwE200]CalleponkeN,2958,30,2,2,4,50.0%,18m
17622,2,[JERK7V]STITCH,2958,0,1,0,1,100.0%,6m
17622,2,[UAŦeam]Faeton,2958,0,0,1,1,0.0%,6m
17622,2,Petrovech,2958,0,0,1,1,0.0%,24m
17622,3,[DutchG]YellowPanthe,2958,0,0,4,4,0.0%,8m
17646,2,Jaime,2957,1626,347,349,696,49.9%,22m
17646,3,[XSpace]Asgard,2957,1575,311,312,623,49.9%,13m
17646,1,Pumba,2957,880,58,51,109,53.2%,10m
17646,2,Cepera,2957,1128,48,34,82,58.5%,12m
17646,2,fedor,2957,1066,47,38,85,55.3%,15m
17646,2,HeHefgrt,2957,869,39,24,63,61.9%,18m
17646,1,[fam1ly]NOOBDekA,2957,913,35,40,75,46.7%,21m
17646,2,Enigma,2957,751,32,21,53,60.4%,22m
17646,1,CraXshot,2957,448,22,25,47,46.8%,19m
17646,3,[xDiamx]javelo,2957,598,22,29,51,43.1%,20m
17646,2,strech,2957,336,12,13,25,48.0%,10m
17646,2,NeoSecond,2957,240,10,12,22,45.5%,8m
17646,1,HossT,2957,169,9,9,18,50.0%,9m
17646,2,bigmanIsak,2957,245,8,6,14,57.1%,12m
17646,1,IFELSE,2957,273,8,12,20,40.0%,18m
17646,2,[Fansaf]Skyre,2957,220,7,4,11,63.6%,15m
17646,2,OozzE,2957,168,7,5,12,58.3%,20m
17646,2,Gourang,2957,155,7,6,13,53.8%,10m
17646,2,Stringset,2957,140,5,0,5,100.0%,15m
17646,2,[eXGE]cabris,2957,122,5,4,9,55.6%,4m
17646,2,[Hooli]ПенисМоржа,2957,0,4,1,5,80.0%,30m
17646,2,Thoridal,2957,126,4,1,5,80.0%,16m
17646,1,[RPGen]HardCorePlay,2957,145,4,4,8,50.0%,1h
17646,2,Enzyme,2957,120,4,7,11,36.4%,9m
17646,2,Cake,2957,0,3,2,5,60.0%,8m
17646,2,Alban,2957,138,3,2,5,60.0%,11m
17646,2,CrazyNik,2957,60,3,5,8,37.5%,18m
17646,2,SypnijZwirem,2957,62,2,6,8,25.0%,24m
17646,3,[Koent]UchihaMadara,2957,0,1,0,1,100.0%,6m
17646,2,KMK,2957,30,1,1,2,50.0%,6m
17646,2,[BlZEPS]iMarik,2957,32,1,2,3,33.3%,7m
17646,1,MrFer,2957,0,1,2,3,33.3%,1h
17646,2,PallaDium,2957,0,0,1,1,0.0%,3m
17646,2,SapiXjGood,2957,0,0,1,1,0.0%,9m
17680,2,FiendRus,2956,1420,321,339,660,48.6%,6m
17680,2,Awakened,2956,1374,79,62,141,56.0%,12m
17680,2,BlackSparki,2956,424,17,14,31,54.8%,23m
17680,2,Purrri,2956,424,15,12,27,55.6%,13m
17680,1,[PŖïMĄŁ]Tekerthnx,2956,478,15,18,33,45.5%,13m
17680,2,[RioF]Seedor,2956,260,13,8,21,61.9%,10m
17680,2,[C12760]Jawbreaker,2956,246,9,5,14,64.3%,4m
17680,3,killerman,2956,159,8,5,13,61.5%,6m
17680,2,Manioll,2956,90,7,4,11,63.6%,3m
17680,3,[Brah]Supergoon,2956,198,6,7,13,46.2%,47m
17680,2,deyeplz,2956,148,5,3,8,62.5%,16m
17680,2,Borg,2956,0,4,2,6,66.7%,24m
17680,2,[NGJ]KimuKun,2956,0,3,2,5,60.0%,11m
17680,2,PilulkaSobak,2956,0,3,2,5,60.0%,1h
17680,2,RaslNick,2956,0,3,2,5,60.0%,1h
17680,1,Mondmensch,2956,108,3,12,15,20.0%,3m
17680,2,[Grund]WiredRail,2956,121,2,2,4,50.0%,47m
17680,2,Ilich,2956,0,1,0,1,100.0%,8m
17680,2,ThePaleBear,2956,0,1,0,1,100.0%,16m
17680,2,Popper,2956,30,1,2,3,33.3%,3m
17680,2,[Reano]ManBane,2956,0,0,1,1,0.0%,24m
17680,2,Morran,2956,0,0,1,1,0.0%,24m
17680,2,[AIESJH]Tame,2956,0,0,2,2,0.0%,4m
17703,1,[FR1]Vlayd,2955,1405,263,248,511,51.5%,16m
17703,2,lukaplusx,2955,1347,203,190,393,51.7%,20m
17703,1,Копченый,2955,1027,81,69,150,54.0%,6m
17703,1,Niels,2955,1397,59,55,114,51.8%,19m
17703,2,bibop,2955,550,26,20,46,56.5%,4m
17703,2,ManP,2955,487,20,13,33,60.6%,24m
17703,2,FoxKarcher,2955,394,15,13,28,53.6%,15m
17703,1,Automaton,2955,403,13,15,28,46.4%,23m
17703,2,Zennig,2955,290,12,6,18,66.7%,10m
17703,2,[RearGG]LostInSpace,2955,266,11,10,21,52.4%,15m
17703,1,[Valu3]mgmoop,2955,334,11,12,23,47.8%,9m
17703,2,Scrabex,2955,253,10,7,17,58.8%,6m
17703,1,SandwichLord,2955,205,10,9,19,52.6%,23m
17703,2,[Negoid]YPeRiET,2955,172,7,8,15,46.7%,8m
17703,2,Skinner,2955,210,7,12,19,36.8%,24m
17703,3,[яєѕ]omgbambi,2955,146,6,5,11,54.5%,3m
17703,2,Hellfish,2955,88,5,1,6,83.3%,18m
17703,2,Sauron,2955,0,3,2,5,60.0%,27m
17703,2,[StOuHa]Flusooo,2955,0,3,2,5,60.0%,1h
17703,2,Василёчек,2955,144,3,3,6,50.0%,21m
17703,2,Boondog,2955,60,3,5,8,37.5%,18m
17703,2,gooby,2955,90,3,5,8,37.5%,5m
17703,2,MLGrusGamer,2955,112,2,1,3,66.7%,23m
17703,2,Protypes,2955,0,1,0,1,100.0%,21m
17703,2,[SSC2]VELAM,2955,0,1,0,1,100.0%,4m
17703,2,[TTpom]Curare,2955,0,1,0,1,100.0%,7m
17703,2,Katari,2955,0,1,3,4,25.0%,21m
17703,2,LaMKa,2955,0,0,1,1,0.0%,24m
17703,2,[PiGPan]kovic,2955,0,0,1,1,0.0%,13m
17703,2,Nik,2955,0,0,2,2,0.0%,26m
17733,3,[DL2006]MONRROG,2954,1431,567,559,1126,50.4%,19m
17733,1,BIBOP,2954,1629,541,529,1070,50.6%,12m
17733,3,Felenous,2954,916,207,207,414,50.0%,26m
17733,2,Butkus,2954,541,100,72,172,58.1%,7m
17733,2,Sakroface,2954,975,50,38,88,56.8%,10m
17733,2,Fenrir,2954,1060,47,32,79,59.5%,12m
17733,2,Zergusha,2954,773,37,25,62,59.7%,15m
17733,1,SaGe,2954,761,33,26,59,55.9%,24m
17733,2,MEGAPASH,2954,550,23,20,43,53.5%,18m
17733,2,Thradas,2954,507,21,17,38,55.3%,18m
17733,2,Henrylol,2954,557,20,20,40,50.0%,8m
17733,2,Belchir,2954,508,19,16,35,54.3%,12m
17733,1,Curunir,2954,395,13,13,26,50.0%,9m
17733,2,Batriel,2954,207,9,6,15,60.0%,3m
17733,2,[Дядя]illownQ,2954,198,9,7,16,56.2%,8m
17733,3,DarkMatter,2954,217,7,7,14,50.0%,27m
17733,3,[WINTEX]SAIMANP,2954,224,6,4,10,60.0%,13m
17733,2,CoOons,2954,198,6,4,10,60.0%,5m
17733,1,[PASH]RaoulDuke,2954,97,5,2,7,71.4%,1h
17733,2,[гусини]бот,2954,128,4,2,6,66.7%,10m
17733,2,Noskill,2954,140,4,2,6,66.7%,8m
17733,1,LAWSONNZ,2954,97,4,3,7,57.1%,25m
17733,1,olix,2954,97,4,3,7,57.1%,1h
17733,1,PetrKK,2954,118,4,3,7,57.1%,26m
17733,3,thec,2954,144,3,2,5,60.0%,26m
17733,2,Marhmut,2954,60,3,2,5,60.0%,19m
17733,2,Dux,2954,90,3,4,7,42.9%,23m
17733,2,CrAzYBoY,2954,90,3,5,8,37.5%,22m
17733,2,[ZЕRGТV]STILER,2954,90,3,6,9,33.3%,24m
17733,2,Kotoffey,2954,94,3,7,10,30.0%,18m
17733,2,CandyThief,2954,88,2,0,2,100.0%,4m
17733,2,sasha,2954,30,1,2,3,33.3%,16m
17733,2,neverever,2954,0,1,2,3,33.3%,21m
17733,2,[Gerts]Gert,2954,40,1,5,6,16.7%,1h
17733,2,Madafaka,2954,0,0,4,4,0.0%,20m
17768,1,Furyo,2953,1525,128,122,250,51.2%,3m
17768,2,[FloPo]Estler,2953,1357,63,36,99,63.6%,3m
17768,1,[SAKZ]Polidrap,2953,1375,63,59,122,51.6%,26m
17768,2,[piknes]Floydy,2953,1373,56,48,104,53.8%,21m
17768,2,BadMazaFaka,2953,929,37,31,68,54.4%,4m
17768,1,Vollbot,2953,773,27,33,60,45.0%,26m
17768,1,Serenkiy,2953,407,26,22,48,54.2%,4m
17768,1,Gunsmas,2953,513,26,24,50,52.0%,5m
17768,1,KoLco,2953,623,23,21,44,52.3%,5m
17768,1,[RUxZet]данил,2953,194,7,5,12,58.3%,16m
17768,2,loskan,2953,0,4,1,5,80.0%,3m
17768,2,Odysseus,2953,138,4,1,5,80.0%,10m
17768,1,fourDaysRave,2953,97,4,1,5,80.0%,8m
17768,2,SIYAHBEYAZ,2953,0,3,2,5,60.0%,44m
17768,2,Hecc,2953,88,2,0,2,100.0%,18m
17768,2,[F1N]Barracuda,2953,30,2,1,3,66.7%,26m
17768,2,[WITCHs]Talen,2953,60,2,7,9,22.2%,4m
17768,2,Kiocyden,2953,0,1,2,3,33.3%,40m
17768,2,[DTRUMP]Marenei,2953,0,1,3,4,25.0%,19m
17768,2,[Cuth]CaveMan,2953,0,0,1,1,0.0%,26m
17768,2,[КПCC]OurVictoury,2953,0,0,2,2,0.0%,11m
17789,2,Hedgehog,2952,1412,118,103,221,53.4%,4m
17789,2,Notus,2952,1367,94,86,180,52.2%,21m
17789,2,explain,2952,1326,87,54,141,61.7%,16m
17789,2,Ikeran,2952,1156,57,37,94,60.6%,7m
17789,2,Integro,2952,1174,55,50,105,52.4%,18m
17789,2,AveTsezar,2952,1033,51,34,85,60.0%,8m
17789,2,Hermejs,2952,492,29,22,51,56.9%,15m
17789,2,chichibuchka,2952,748,29,28,57,50.9%,11m
17789,2,Strannik,2952,444,24,19,43,55.8%,16m
17789,1,Gillesberg,2952,566,21,28,49,42.9%,26m
17789,1,Munon,2952,367,13,16,29,44.8%,11m
17789,2,ХрякЕда,2952,300,11,8,19,57.9%,24m
17789,2,Luciferka,2952,348,10,13,23,43.5%,15m
17789,1,Bloodline,2952,238,9,13,22,40.9%,19m
17789,2,finster,2952,256,8,8,16,50.0%,18m
17789,2,DarkAvalon,2952,224,7,8,15,46.7%,16m
17789,2,Sebs,2952,150,6,5,11,54.5%,10m
17789,2,LightReaper,2952,144,6,5,11,54.5%,22m
17789,2,Invoker,2952,0,5,0,5,100.0%,11m
17789,2,Excelle,2952,105,4,3,7,57.1%,20m
17789,1,Marat,2952,154,4,5,9,44.4%,12m
17789,2,[theVN]Raptor,2952,96,4,7,11,36.4%,24m
17789,2,tenno,2952,0,3,2,5,60.0%,9m
17789,2,Salader,2952,0,3,2,5,60.0%,12m
17789,2,Duffenzag,2952,0,3,2,5,60.0%,20m
17789,2,Algemorge,2952,0,3,2,5,60.0%,1h
17789,2,Pravuy,2952,97,2,3,5,40.0%,11m
17789,2,Bigbutt,2952,0,1,0,1,100.0%,3m
17789,1,Cstalone,2952,0,1,0,1,100.0%,1h
17789,1,oma,2952,0,1,0,1,100.0%,18m
17789,2,BananaGun,2952,30,1,3,4,25.0%,8m
17789,2,GoGoAndy,2952,30,1,3,4,25.0%,5m
17789,2,SkipLegDay,2952,0,0,1,1,0.0%,16m
17789,2,[Sekaii]KitsuneChan,2952,0,0,1,1,0.0%,13m
17789,2,Viepex,2952,0,0,2,2,0.0%,26m
17789,1,Nelidof,2952,0,0,3,3,0.0%,19m
17825,1,[mfxed]owner,2951,1409,53,56,109,48.6%,22m
17825,2,aScDeadcam,2951,461,48,46,94,51.1%,20m
17825,2,Gaster,2951,739,38,15,53,71.7%,6m
17825,2,FlexXx,2951,775,32,25,57,56.1%,10m
17825,2,Георгий,2951,568,23,20,43,53.5%,5m
17825,2,Manuel,2951,538,21,18,39,53.8%,13m
17825,2,Svava,2951,471,19,14,33,57.6%,8m
17825,2,Shinnybeast,2951,474,17,14,31,54.8%,12m
17825,2,LomOff,2951,404,14,17,31,45.2%,9m
17825,2,[OorloG]Kruisie,2951,291,11,7,18,61.1%,4m
17825,1,ZITEK,2951,277,11,9,20,55.0%,33m
17825,3,[Sayron]димаста,2951,224,9,6,15,60.0%,1h
17825,2,GoliaTH,2951,227,9,7,16,56.2%,18m
17825,3,ASH,2951,228,8,2,10,80.0%,37m
17825,2,Strange,2951,204,8,7,15,53.3%,8m
17825,1,FaNtik,2951,192,7,8,15,46.7%,9m
17825,1,Mahai,2951,241,6,6,12,50.0%,25m
17825,2,Garnett,2951,178,6,11,17,35.3%,24m
17825,1,MauntZ,2951,185,5,6,11,45.5%,12m
17825,2,MrMayem,2951,140,4,3,7,57.1%,5m
17825,2,Master,2951,30,4,3,7,57.1%,8m
17825,3,Zaraken,2951,92,4,12,16,25.0%,8m
17825,2,pryme,2951,102,3,0,3,100.0%,22m
17825,2,IIIIIIIIIIII,2951,102,3,0,3,100.0%,15m
17825,2,[Arrows]ЛовкийЗерг,2951,114,3,1,4,75.0%,11m
17825,2,Randoom,2951,114,3,1,4,75.0%,15m
17825,2,Deagle,2951,0,3,2,5,60.0%,1h
17825,2,TANEdos,2951,0,3,2,5,60.0%,24m
17825,2,fOxViktoR,2951,0,3,2,5,60.0%,4m
17825,2,LikerGames,2951,139,3,5,8,37.5%,10m
17825,2,steve,2951,62,2,6,8,25.0%,18m
17825,2,Cronus,2951,0,1,0,1,100.0%,3m
17825,2,Zetski,2951,0,1,0,1,100.0%,9m
17825,2,[Batia]moloko,2951,0,1,1,2,50.0%,15m
17825,1,CCAA,2951,48,1,4,5,20.0%,31m
17825,2,[MGTSC2]xranger,2951,0,0,1,1,0.0%,15m
17825,2,HepHaistos,2951,0,0,2,2,0.0%,10m
17825,2,EnacNano,2951,0,0,2,2,0.0%,4m
17863,2,Otstoy,2950,1419,311,297,608,51.2%,18m
17863,1,rohezal,2950,1630,222,216,438,50.7%,5m
17863,3,[Tosses]Dexter,2950,1540,115,118,233,49.4%,6m
17863,2,Asterius,2950,1579,83,73,156,53.2%,12m
17863,3,Dancore,2950,925,68,56,124,54.8%,20m
17863,2,ХЁН,2950,1026,54,28,82,65.9%,3m
17863,1,FǂAbo,2950,406,48,68,116,41.4%,10m
17863,2,[OSgZ]Kendo,2950,375,35,31,66,53.0%,11m
17863,1,[SOECES]BridoKiLLeR,2950,954,34,40,74,45.9%,5m
17863,2,[L0L]Rigel,2950,747,32,20,52,61.5%,11m
17863,2,boutch,2950,532,20,20,40,50.0%,20m
17863,1,Amon,2950,256,13,25,38,34.2%,13m
17863,1,chewy,2950,192,9,9,18,50.0%,24m
17863,2,WarBuffett,2950,246,9,10,19,47.4%,11m
17863,1,Tawerdef,2950,120,6,1,7,85.7%,3m
17863,1,Claude,2950,170,6,5,11,54.5%,1h
17863,1,Costel,2950,212,6,9,15,40.0%,11m
17863,2,Skillz,2950,130,4,1,5,80.0%,18m
17863,3,Coyc,2950,0,4,4,8,50.0%,41m
17863,2,Face,2950,102,3,1,4,75.0%,20m
17863,2,jeanjolecroc,2950,0,3,2,5,60.0%,15m
17863,3,ЗверяЗмейПРо,2950,133,3,4,7,42.9%,1h
17863,1,RiseofLambs,2950,108,3,5,8,37.5%,16m
17863,1,BakaSan,2950,92,3,10,13,23.1%,23m
17863,2,StaryTygrys,2950,0,2,3,5,40.0%,12m
17863,2,Jjero,2950,0,1,0,1,100.0%,3m
17863,2,Laky,2950,88,1,1,2,50.0%,24m
17863,2,BarackPyjama,2950,88,1,1,2,50.0%,26m
17863,2,Flint,2950,30,1,3,4,25.0%,3m
17863,2,[moumou]thor,2950,0,0,1,1,0.0%,11m
17863,2,Kuivanen,2950,0,0,1,1,0.0%,11m
17863,2,[WBGA]danielzar,2950,0,0,1,1,0.0%,16m
17863,1,Loota,2950,0,0,1,1,0.0%,41m
17863,2,[sfc]crosolid,2950,0,0,2,2,0.0%,18m
17863,2,[LegioV]Thor,2950,0,0,3,3,0.0%,11m
17863,3,[КодБи]goldkreateav,2950,0,0,3,3,0.0%,16m
17899,3,Protoss,2949,1320,172,180,352,48.9%,9m
17899,1,woo,2949,1318,154,147,301,51.2%,3m
17899,2,Yan,2949,936,137,121,258,53.1%,11m
17899,2,mycephei,2949,1563,94,86,180,52.2%,4m
17899,1,школьник,2949,606,85,78,163,52.1%,19m
17899,1,Pahomath,2949,1265,69,57,126,54.8%,16m
17899,2,Naapukka,2949,999,53,39,92,57.6%,12m
17899,2,NuclearSWINE,2949,638,40,38,78,51.3%,5m
17899,2,Camouflage,2949,572,27,15,42,64.3%,8m
17899,2,Asparagus,2949,394,18,17,35,51.4%,5m
17899,2,[ALTrG]Angelikus,2949,452,16,17,33,48.5%,21m
17899,2,[SAG]speeder,2949,408,15,17,32,46.9%,20m
17899,1,Ido,2949,411,14,16,30,46.7%,23m
17899,2,vonder,2949,342,12,9,21,57.1%,3m
17899,2,MASSUKKAMURA,2949,262,11,6,17,64.7%,5m
17899,2,Kronus,2949,333,11,10,21,52.4%,8m
17899,1,DeDonderDodo,2949,190,9,6,15,60.0%,24m
17899,2,roquefort,2949,205,8,7,15,53.3%,21m
17899,3,OPturtle,2949,205,7,0,7,100.0%,14m
17899,1,Paka,2949,139,5,3,8,62.5%,13m
17899,1,fish,2949,96,5,4,9,55.6%,1h
17899,2,enesercin,2949,140,4,2,6,66.7%,8m
17899,2,[aGio]FreDy,2949,30,4,3,7,57.1%,23m
17899,1,Sunwoo,2949,145,3,1,4,75.0%,26m
17899,2,[1Xp1]MongoHelgson,2949,126,3,2,5,60.0%,26m
17899,2,Regisowsky,2949,0,3,2,5,60.0%,25m
17899,2,bodryachock,2949,88,3,3,6,50.0%,12m
17899,2,ASTRE,2949,30,2,1,3,66.7%,10m
17899,2,CaptNewbie,2949,60,2,3,5,40.0%,13m
17899,2,[SciFx]FoxOne,2949,0,1,0,1,100.0%,20m
17899,2,IIIIIIIIIIII,2949,0,1,1,2,50.0%,20m
17899,1,[PuFu]jumper,2949,93,1,1,2,50.0%,22m
17899,1,Baffreux,2949,0,1,8,9,11.1%,11m
17899,1,kerdead,2949,0,0,1,1,0.0%,41m
17899,2,PolderPloer,2949,0,0,1,1,0.0%,18m
17899,3,[SFight]Smaavri,2949,0,0,1,1,0.0%,9m
17899,2,[SРID]HappySlave,2949,0,0,2,2,0.0%,10m
17899,2,Kilo,2949,0,0,5,5,0.0%,18m
17937,1,ИСКРАИВЕТЕР,2948,1291,108,101,209,51.7%,22m
17937,2,[Tостер]Бирсиаль,2948,1456,78,59,137,56.9%,12m
17937,2,XXEpheneAXX,2948,674,42,1,43,97.7%,10m
17937,2,[Nudist]Golgotai,2948,941,42,26,68,61.8%,8m
17937,2,VoltiZ,2948,755,38,21,59,64.4%,10m
17937,2,Kahe,2948,863,38,23,61,62.3%,18m
17937,2,[brzzer]Alvaro,2948,817,32,28,60,53.3%,18m
17937,2,PZh,2948,310,29,27,56,51.8%,13m
17937,2,[DTEK]Evranus,2948,481,26,17,43,60.5%,18m
17937,2,Lebedoks,2948,560,21,15,36,58.3%,5m
17937,2,Arciryas,2948,440,20,13,33,60.6%,8m
17937,2,[YABAY]Kash,2948,474,19,17,36,52.8%,11m
17937,2,dieTomorrow,2948,504,18,17,35,51.4%,24m
17937,1,Azrael,2948,297,11,10,21,52.4%,5m
17937,2,Numan,2948,304,11,11,22,50.0%,8m
17937,1,roman,2948,371,11,15,26,42.3%,9m
17937,1,Imperial,2948,278,9,11,20,45.0%,26m
17937,3,martonw,2948,172,6,6,12,50.0%,15m
17937,2,Mistpilz,2948,114,5,3,8,62.5%,18m
17937,2,LiaChan,2948,30,4,3,7,57.1%,12m
17937,3,kaholi,2948,0,4,3,7,57.1%,1h
17937,2,MagusAdptus,2948,90,4,4,8,50.0%,20m
17937,1,Galaxiors,2948,74,4,7,11,36.4%,22m
17937,2,Gluttony,2948,0,3,2,5,60.0%,27m
17937,2,orangesomnom,2948,88,2,0,2,100.0%,15m
17937,2,Brutaly,2948,30,2,1,3,66.7%,24m
17937,2,[CUB]Zeratyl,2948,30,2,2,4,50.0%,23m
17937,2,[OPALA]NikiElektorn,2948,60,2,3,5,40.0%,15m
17937,1,Thrax,2948,0,1,3,4,25.0%,19m
17937,2,JeeGoLo,2948,30,1,3,4,25.0%,8m
17937,2,Kyoshiro,2948,0,0,1,1,0.0%,21m
17937,2,PowerHitz,2948,0,0,1,1,0.0%,12m
17969,2,geologg,2947,1498,58,58,116,50.0%,18m
17969,2,[WUAN]faker,2947,829,35,28,63,55.6%,8m
17969,1,Sulya,2947,345,26,24,50,52.0%,13m
17969,2,[Serral]lefterisyolo,2947,569,25,14,39,64.1%,4m
17969,1,[4SALE]Netruner,2947,642,20,27,47,42.6%,5m
17969,2,[IceHus]DashYarik,2947,354,16,10,26,61.5%,10m
17969,2,Gordian,2947,341,15,13,28,53.6%,8m
17969,2,Jevelin,2947,256,11,5,16,68.8%,8m
17969,2,Tsalykval,2947,288,10,11,21,47.6%,23m
17969,2,[AiRǂ]Bonsai,2947,269,8,11,19,42.1%,10m
17969,2,Kriptonian,2947,223,7,5,12,58.3%,41m
17969,2,Yewualb,2947,190,7,28,35,20.0%,26m
17969,2,[TAW]Xaz,2947,154,6,3,9,66.7%,15m
17969,2,AngryJaguar,2947,192,6,4,10,60.0%,11m
17969,2,Cartunga,2947,194,6,5,11,54.5%,8m
17969,2,CARTMAN,2947,178,6,9,15,40.0%,24m
17969,2,Rico,2947,130,5,0,5,100.0%,13m
17969,1,barkley,2947,140,5,3,8,62.5%,1h
17969,2,VocxoD,2947,86,4,3,7,57.1%,6m
17969,3,FreddolF,2947,121,4,4,8,50.0%,30m
17969,2,Fallen,2947,0,3,2,5,60.0%,24m
17969,2,Hushpuppie,2947,0,3,2,5,60.0%,40m
17969,2,rensong,2947,0,3,2,5,60.0%,38m
17969,1,[KatHal]DEJV,2947,88,3,5,8,37.5%,22m
17969,2,[CCAV]Enro,2947,116,2,2,4,50.0%,3m
17969,2,[eXe]Sobek,2947,30,2,4,6,33.3%,8m
17969,2,[FKSD]sss,2947,0,1,0,1,100.0%,21m
17969,2,Warbringer,2947,0,1,0,1,100.0%,16m
17969,2,JerryKan,2947,0,1,0,1,100.0%,6m
17969,2,[TDFR]shadowxone,2947,0,1,0,1,100.0%,18m
17969,2,[TedB]Matrix,2947,88,1,1,2,50.0%,5m
17969,2,TossBrutalos,2947,88,1,1,2,50.0%,5m
17969,1,[Avgus]Beggon,2947,0,1,3,4,25.0%,23m
17969,2,[1FU2]Kizzmaul,2947,91,1,3,4,25.0%,12m
18003,1,YerAulWan,2946,1583,473,461,934,50.6%,14m
18003,2,Storm,2946,1180,181,168,349,51.9%,13m
18003,2,mattj,2946,595,76,51,127,59.8%,20m
18003,2,atreyu,2946,921,62,44,106,58.5%,11m
18003,2,[TExGG]Akkarin,2946,881,58,58,116,50.0%,12m
18003,2,DrHoernchen,2946,698,54,40,94,57.4%,21m
18003,2,Stringduck,2946,1187,49,39,88,55.7%,20m
18003,2,FINTIPLUSHKA,2946,279,36,29,65,55.4%,20m
18003,2,Selephodron,2946,732,31,28,59,52.5%,24m
18003,1,ChasmFace,2946,234,30,32,62,48.4%,22m
18003,1,Maioo,2946,878,28,35,63,44.4%,13m
18003,2,Akeem,2946,456,25,23,48,52.1%,12m
18003,2,FlowR,2946,421,24,19,43,55.8%,8m
18003,2,Stan,2946,494,19,16,35,54.3%,24m
18003,3,Shelby,2946,411,19,27,46,41.3%,8m
18003,2,[RicReg]Regative,2946,215,17,9,26,65.4%,8m
18003,1,LEX,2946,456,15,23,38,39.5%,5m
18003,2,Bozzy,2946,332,13,8,21,61.9%,24m
18003,2,[WАSD]Celv,2946,244,10,6,16,62.5%,18m
18003,1,BeBeCuiCui,2946,357,10,21,31,32.3%,23m
18003,2,[NopEr]Tomáš,2946,222,9,7,16,56.2%,20m
18003,2,Tema,2946,240,8,13,21,38.1%,13m
18003,1,Adema,2946,139,8,16,24,33.3%,8m
18003,3,Diversity,2946,146,6,4,10,60.0%,7m
18003,2,Mursitoss,2946,60,6,4,10,60.0%,8m
18003,2,[CS0]niven,2946,176,6,10,16,37.5%,12m
18003,2,Flash,2946,148,5,5,10,50.0%,24m
18003,1,SomaCruz,2946,97,4,2,6,66.7%,1h
18003,2,max,2946,124,4,9,13,30.8%,8m
18003,2,Senfman,2946,0,3,2,5,60.0%,47m
18003,2,[5259]goji,2946,88,2,0,2,100.0%,13m
18003,2,[KS007]AvP,2946,0,1,1,2,50.0%,13m
18003,1,ShuTz,2946,0,1,1,2,50.0%,19m
18003,2,[SBluez]Human,2946,0,0,1,1,0.0%,4m
18003,2,[SCF]DemonHunter,2946,0,0,2,2,0.0%,21m
18003,2,[ÆGlS]Knight,2946,0,0,2,2,0.0%,13m
18039,2,NestorMaxno,2945,1532,195,170,365,53.4%,3m
18039,2,FinalDegree,2945,1164,121,89,210,57.6%,5m
18039,2,Soichiro,2945,1581,103,83,186,55.4%,10m
18039,2,Fab,2945,848,93,88,181,51.4%,21m
18039,2,Nasty,2945,1328,60,50,110,54.5%,4m
18039,2,PisnotNP,2945,323,44,29,73,60.3%,11m
18039,2,[TheDOH]miko,2945,671,30,15,45,66.7%,11m
18039,2,[RoXY]Magik,2945,669,27,25,52,51.9%,11m
18039,2,TryHard,2945,677,25,23,48,52.1%,24m
18039,2,Kornilie,2945,519,22,13,35,62.9%,22m
18039,2,biolgarisos,2945,335,13,9,22,59.1%,11m
18039,2,Executioner,2945,240,10,7,17,58.8%,1h
18039,2,Adelinchi,2945,254,10,7,17,58.8%,10m
18039,1,MedicsUp,2945,193,9,7,16,56.2%,19m
18039,2,UncleBogdan,2945,230,8,6,14,57.1%,21m
18039,2,Natymer,2945,254,8,7,15,53.3%,10m
18039,3,Marafettiq,2945,195,7,6,13,53.8%,4m
18039,2,[Sp3TAK]Melly,2945,120,6,3,9,66.7%,21m
18039,2,DirtyPanties,2945,193,6,4,10,60.0%,10m
18039,2,XueHaTa,2945,224,6,8,14,42.9%,33m
18039,2,Chris,2945,244,5,12,17,29.4%,10m
18039,2,atjoh,2945,88,4,2,6,66.7%,4m
18039,2,Mxx,2945,142,4,2,6,66.7%,9m
18039,1,ZeusGames,2945,0,4,3,7,57.1%,19m
18039,2,soc,2945,152,4,4,8,50.0%,21m
18039,3,[Dоbrо]AgentOF,2945,129,3,1,4,75.0%,6m
18039,2,Stere,2945,0,3,2,5,60.0%,15m
18039,2,Pelican,2945,0,3,2,5,60.0%,1h
18039,2,orthank,2945,60,3,2,5,60.0%,8m
18039,2,bretonpoilu,2945,88,3,3,6,50.0%,8m
18039,2,Thawedmind,2945,114,2,2,4,50.0%,23m
18039,2,bibis,2945,32,2,4,6,33.3%,3m
18039,2,[ZPCS]DimonDych,2945,60,2,4,6,33.3%,10m
18039,2,NikolaLoza,2945,62,2,4,6,33.3%,12m
18039,2,LemonenJäger,2945,0,1,0,1,100.0%,24m
18039,2,RATMRYAN,2945,30,1,4,5,20.0%,9m
18039,2,[MOLLAR]VynChe,2945,0,0,1,1,0.0%,8m
18039,1,Sensenmann,2945,0,0,1,1,0.0%,5m
18039,2,SaltyMan,2945,0,0,1,1,0.0%,13m
18039,2,SlowZerg,2945,0,0,2,2,0.0%,24m
18079,2,SebRi,2944,1593,136,134,270,50.4%,3m
18079,1,[sc2st]Palablink,2944,1016,79,61,140,56.4%,22m
18079,1,IIGrasiekII,2944,1183,69,65,134,51.5%,8m
18079,2,ThaMagician,2944,1574,60,63,123,48.8%,16m
18079,2,Puffin,2944,632,54,46,100,54.0%,15m
18079,1,Demoniacko,2944,539,39,38,77,50.6%,26m
18079,2,Tomja,2944,569,25,19,44,56.8%,24m
18079,2,misekemitoko,2944,468,16,20,36,44.4%,4m
18079,2,Cheetoss,2944,418,15,18,33,45.5%,6m
18079,2,Winger,2944,397,14,11,25,56.0%,10m
18079,2,SleKKiT,2944,356,13,11,24,54.2%,3m
18079,3,wiiiiiu,2944,232,10,11,21,47.6%,3m
18079,2,[NVRFGT]kingSYROhacf,2944,252,9,7,16,56.2%,5m
18079,2,Falstaff,2944,214,7,9,16,43.8%,21m
18079,2,LordGod,2944,176,7,10,17,41.2%,10m
18079,1,SourisChauve,2944,202,6,14,20,30.0%,3m
18079,2,[TSC2C]Тирион,2944,140,5,1,6,83.3%,11m
18079,2,Hulimulin,2944,154,5,2,7,71.4%,6m
18079,2,[48]Kratoss,2944,116,5,6,11,45.5%,13m
18079,2,[Dzag]Sanktu,2944,0,3,2,5,60.0%,26m
18079,2,Olipeon,2944,30,3,4,7,42.9%,8m
18079,1,Cenator,2944,0,3,4,7,42.9%,3m
18079,2,SharpDOTSWE,2944,90,3,7,10,30.0%,16m
18079,2,BboybeatX,2944,94,3,9,12,25.0%,8m
18079,3,PlayerEins,2944,94,3,23,26,11.5%,17m
18079,2,Pranko,2944,30,2,2,4,50.0%,8m
18079,2,Tomoprof,2944,36,2,4,6,33.3%,15m
18079,1,[Li3]KosioOOSeven,2944,0,2,6,8,25.0%,8m
18079,2,xXMeepXx,2944,0,1,0,1,100.0%,11m
18079,2,slRP,2944,0,1,0,1,100.0%,10m
18079,2,MariaCurie,2944,30,1,2,3,33.3%,10m
18079,2,[TENRIX]EresHDP,2944,0,0,2,2,0.0%,11m
18111,3,bobbe,2943,1529,236,238,474,49.8%,22m
18111,2,guillaumezur,2943,1579,142,124,266,53.4%,3m
18111,1,shirunai,2943,1402,84,87,171,49.1%,17m
18111,2,Wosapnin,2943,1533,83,80,163,50.9%,4m
18111,1,[theDH]Bamse,2943,1572,78,84,162,48.1%,22m
18111,2,Dannerg,2943,964,64,65,129,49.6%,8m
18111,1,Pippeli,2943,1554,55,61,116,47.4%,26m
18111,2,blaze,2943,729,29,28,57,50.9%,9m
18111,2,[ZERGТV]FanVof,2943,640,27,24,51,52.9%,6m
18111,2,IIIIIIIIIII,2943,404,19,10,29,65.5%,8m
18111,2,Elmaxo,2943,358,14,14,28,50.0%,8m
18111,2,Pavenkotv,2943,267,9,9,18,50.0%,21m
18111,3,Arttik,2943,204,8,6,14,57.1%,1h
18111,1,[7wonde]Lithium,2943,215,7,10,17,41.2%,16m
18111,2,broukmoute,2943,143,6,6,12,50.0%,16m
18111,2,Максимус,2943,154,5,2,7,71.4%,24m
18111,2,davil,2943,152,5,9,14,35.7%,24m
18111,2,MiKHOiD,2943,154,5,10,15,33.3%,8m
18111,3,Кварк,2943,145,4,5,9,44.4%,13m
18111,2,[YTMT]LegendMax,2943,0,3,2,5,60.0%,6m
18111,2,AhAr,2943,0,3,2,5,60.0%,15m
18111,2,Magnes,2943,0,3,2,5,60.0%,20m
18111,2,Aiz,2943,0,3,3,6,50.0%,8m
18111,2,Cap,2943,140,3,3,6,50.0%,24m
18111,2,Solaris,2943,76,3,4,7,42.9%,21m
18111,2,[PLCM]Kohlhaas,2943,102,2,1,3,66.7%,26m
18111,2,killkat,2943,30,2,2,4,50.0%,15m
18111,2,Barmin,2943,112,2,2,4,50.0%,8m
18111,2,arbidol,2943,0,2,3,5,40.0%,34m
18111,2,Aiur,2943,0,1,1,2,50.0%,24m
18111,2,[bjQ]zEROS,2943,0,1,2,3,33.3%,22m
18111,2,Vvesley,2943,30,1,4,5,20.0%,3m
18111,2,Chaffinch,2943,0,0,1,1,0.0%,8m
18111,2,[TedB]INVAIDER,2943,0,0,1,1,0.0%,13m
18111,2,cRYZ,2943,0,0,2,2,0.0%,21m
18111,2,Roedhip,2943,0,0,2,2,0.0%,18m
18111,2,[HateZ]Giallone,2943,0,0,3,3,0.0%,18m
18111,2,[vPaM]Wolle,2943,0,0,3,3,0.0%,24m
18149,1,PhD,2942,1329,332,327,659,50.4%,16m
18149,3,BigDaddy,2942,1550,289,297,586,49.3%,26m
18149,3,JimSteel,2942,1496,233,244,477,48.8%,18m
18149,1,moulk,2942,1568,122,127,249,49.0%,15m
18149,2,[J0KER]edu,2942,194,91,77,168,54.2%,4m
18149,2,baconpancake,2942,1192,85,64,149,57.0%,11m
18149,2,Kartoonn,2942,1563,82,57,139,59.0%,8m
18149,2,nonnonanni,2942,533,80,67,147,54.4%,16m
18149,2,Robotwizard,2942,1441,66,43,109,60.6%,8m
18149,2,псиналысая,2942,1323,65,59,124,52.4%,24m
18149,2,[KFy]DuXeNON,2942,833,50,52,102,49.0%,11m
18149,2,[BEL]Barabossa,2942,983,44,36,80,55.0%,6m
18149,2,Hatrun,2942,1017,43,32,75,57.3%,13m
18149,2,[lancon]ELCID,2942,650,34,31,65,52.3%,12m
18149,2,Nath,2942,698,30,20,50,60.0%,23m
18149,1,DieMaschine,2942,647,23,25,48,47.9%,24m
18149,1,Leo,2942,712,23,30,53,43.4%,21m
18149,2,[FLAX]DnBWicked,2942,499,21,17,38,55.3%,24m
18149,2,Crive,2942,584,21,21,42,50.0%,18m
18149,2,[GrfES]sparkles,2942,387,17,7,24,70.8%,20m
18149,2,[SLW]Titans,2942,414,16,9,25,64.0%,5m
18149,2,Infinity,2942,391,16,10,26,61.5%,18m
18149,2,Rickety,2942,337,14,12,26,53.8%,26m
18149,2,[DOBE]Recondite,2942,368,13,11,24,54.2%,3m
18149,1,Viggz,2942,193,10,8,18,55.6%,1h
18149,2,[Top8]Madengang,2942,195,9,7,16,56.2%,18m
18149,2,[HoNu]monkeyXEEE,2942,266,9,8,17,52.9%,4m
18149,2,OnlyMusic,2942,262,8,8,16,50.0%,24m
18149,1,Brushok,2942,166,7,2,9,77.8%,6m
18149,3,GehirnVirus,2942,156,7,5,12,58.3%,15m
18149,1,Jacka,2942,170,7,6,13,53.8%,25m
18149,1,NeuYa,2942,240,7,10,17,41.2%,19m
18149,2,Rhaegar,2942,148,6,5,11,54.5%,4m
18149,2,Daergoth,2942,154,6,6,12,50.0%,8m
18149,2,[ĦĦ]galen,2942,0,4,1,5,80.0%,13m
18149,2,FunnyFredii,2942,0,4,1,5,80.0%,9m
18149,2,[OMGITS]Stefan,2942,86,4,4,8,50.0%,11m
18149,2,GabbaGandalf,2942,59,4,4,8,50.0%,15m
18149,2,[DMTRY]RedShift,2942,116,3,3,6,50.0%,8m
18149,1,Indevarit,2942,142,3,4,7,42.9%,13m
18149,2,Гексамедьон,2942,0,1,0,1,100.0%,10m
18149,2,PokerFist,2942,0,1,3,4,25.0%,11m
18149,2,[МŴŚ]Toto,2942,0,0,1,1,0.0%,7m
18149,2,Angel,2942,0,0,1,1,0.0%,15m
18149,2,IIIIIIIIIIII,2942,0,0,1,1,0.0%,5m
18149,2,Mev,2942,0,0,1,1,0.0%,12m
18149,2,Flower,2942,0,0,2,2,0.0%,4m
18149,3,historia,2942,0,0,2,2,0.0%,9m
18149,2,Teodor,2942,0,0,2,2,0.0%,11m
18149,2,[SomSob]Séodoa,2942,0,0,4,4,0.0%,21m
18199,1,eee,2941,1588,415,406,821,50.5%,24m
18199,3,saber,2941,770,313,321,634,49.4%,7m
18199,2,[Heroes]CapnCrunch,2941,1572,143,123,266,53.8%,8m
18199,1,vojta,2941,1501,128,108,236,54.2%,17m
18199,1,Takatsuki,2941,858,81,64,145,55.9%,8m
18199,2,ElwynAce,2941,981,54,42,96,56.2%,8m
18199,2,[CovPar]Cyrialkiller,2941,901,44,32,76,57.9%,8m
18199,1,IlIlIlllIlIl,2941,635,25,23,48,52.1%,22m
18199,2,CloWN,2941,280,12,5,17,70.6%,18m
18199,2,Draknar,2941,270,11,10,21,52.4%,19m
18199,2,[InvKit]SFoxner,2941,266,8,6,14,57.1%,4m
18199,2,HardBot,2941,240,8,11,19,42.1%,18m
18199,2,voolli,2941,162,7,4,11,63.6%,13m
18199,3,[LiJA]freaknflow,2941,58,7,6,13,53.8%,19m
18199,2,[F6]Garfield,2941,0,3,2,5,60.0%,15m
18199,2,Alindior,2941,0,3,2,5,60.0%,6m
18199,2,SzuflA,2941,138,3,3,6,50.0%,1h
18199,2,Weatherman,2941,0,1,0,1,100.0%,18m
18199,2,Saezman,2941,0,1,0,1,100.0%,21m
18199,2,Bumi,2941,0,1,1,2,50.0%,19m
18199,2,Jkyet,2941,0,1,5,6,16.7%,27m
18199,2,Nasai,2941,0,0,1,1,0.0%,8m
18221,1,Crow,2940,1581,188,160,348,54.0%,19m
18221,2,Mako,2940,595,138,125,263,52.5%,18m
18221,1,Racer,2940,1641,118,119,237,49.8%,5m
18221,3,NoDiplomacy,2940,1510,100,111,211,47.4%,20m
18221,1,boultan,2940,1591,82,82,164,50.0%,25m
18221,1,monkeY,2940,1070,69,72,141,48.9%,26m
18221,2,Gyppokrat,2940,1375,54,49,103,52.4%,4m
18221,2,[GLNMS]QbQb,2940,1249,50,49,99,50.5%,10m
18221,2,SGoodman,2940,827,36,25,61,59.0%,5m
18221,2,Peepeesker,2940,549,31,9,40,77.5%,4m
18221,2,Hades,2940,494,30,17,47,63.8%,11m
18221,2,shagi,2940,588,26,15,41,63.4%,11m
18221,2,CodingEgg,2940,510,24,13,37,64.9%,20m
18221,2,[G3lb]Noah,2940,275,11,11,22,50.0%,25m
18221,1,[WeiK]Balerion,2940,312,10,17,27,37.0%,4m
18221,2,[obi1k]THEDOCTOR,2940,262,8,9,17,47.1%,8m
18221,2,Artair,2940,88,7,5,12,58.3%,18m
18221,2,MaCaBrOs,2940,172,7,7,14,50.0%,4m
18221,1,dirtycheeser,2940,242,7,12,19,36.8%,3m
18221,2,[LKR]BlueStorm,2940,218,6,7,13,46.2%,22m
18221,2,Laurita,2940,180,6,8,14,42.9%,24m
18221,1,[Doul]cortana,2940,189,5,5,10,50.0%,30m
18221,2,[meowz]JbossSenpai,2940,166,4,4,8,50.0%,11m
18221,2,АРТЁМ,2940,116,4,5,9,44.4%,6m
18221,2,Baronyx,2940,90,4,6,10,40.0%,13m
18221,2,[MinDes]modASSASSIN,2940,58,3,2,5,60.0%,20m
18221,2,ShadowSword,2940,0,3,2,5,60.0%,18m
18221,2,ato,2940,0,3,2,5,60.0%,9m
18221,2,mav,2940,30,2,2,4,50.0%,15m
18221,2,spOOk,2940,0,1,1,2,50.0%,1h
18221,1,asad,2940,0,1,1,2,50.0%,1h
18221,2,Zubr,2940,30,1,2,3,33.3%,22m
18221,2,[gpat]amonra,2940,30,1,4,5,20.0%,21m
18221,2,[expld]Iffofe,2940,0,0,1,1,0.0%,9m
18221,2,Medif,2940,0,0,3,3,0.0%,21m
18221,2,lotos,2940,0,0,4,4,0.0%,18m
18257,1,BBRICKY,2939,1640,766,758,1524,50.3%,25m
18257,1,Ramon,2939,1626,91,77,168,54.2%,10m
18257,2,[RuVoid]FriskCerber,2939,571,63,40,103,61.2%,15m
18257,2,Matos,2939,883,37,36,73,50.7%,22m
18257,2,Zacke,2939,613,35,27,62,56.5%,5m
18257,2,[THANOS]mayonez,2939,712,27,25,52,51.9%,5m
18257,2,Adeptman,2939,503,19,17,36,52.8%,10m
18257,2,[Pasty]TIJ,2939,435,16,13,29,55.2%,21m
18257,2,[aslick]Vito,2939,290,15,6,21,71.4%,3m
18257,2,[CCTV1]BeNice,2939,427,15,14,29,51.7%,20m
18257,2,[SevRud]Sevan,2939,271,15,16,31,48.4%,21m
18257,2,HoplaGeiss,2939,232,10,12,22,45.5%,13m
18257,2,Lennex,2939,208,8,7,15,53.3%,29m
18257,2,GOShiK,2939,246,8,7,15,53.3%,4m
18257,2,Causes,2939,90,8,11,19,42.1%,15m
18257,2,lnx,2939,250,8,12,20,40.0%,5m
18257,2,[TwSwag]Reah,2939,234,8,13,21,38.1%,11m
18257,2,[BURIZA]poesh,2939,196,7,3,10,70.0%,22m
18257,2,Trigger,2939,148,5,8,13,38.5%,8m
18257,2,[TRPs]aru,2939,128,4,1,5,80.0%,3m
18257,2,MaLaRaZa,2939,0,4,2,6,66.7%,15m
18257,2,MakeUsWhole,2939,95,4,7,11,36.4%,9m
18257,1,maebs,2939,167,3,1,4,75.0%,37m
18257,2,[FS0]Galados,2939,0,3,2,5,60.0%,47m
18257,2,[AlDS]Odalv,2939,128,3,3,6,50.0%,13m
18257,2,[THINK]NXT,2939,0,2,3,5,40.0%,33m
18257,2,DankTemplar,2939,0,1,0,1,100.0%,20m
18257,2,СосКSuсКer,2939,0,1,0,1,100.0%,6m
18257,2,[KRAKOT]tassadar,2939,0,0,1,1,0.0%,8m
18257,3,Dartrem,2939,0,0,1,1,0.0%,1h
18257,1,[MOLDVA]mxat,2939,0,0,1,1,0.0%,22m
18257,2,Nexonus,2939,0,0,2,2,0.0%,20m
18257,3,HattMourner,2939,0,0,4,4,0.0%,1h
18290,1,Maia,2938,1304,182,174,356,51.1%,8m
18290,1,Bifrost,2938,920,119,114,233,51.1%,12m
18290,2,Fitto,2938,981,76,68,144,52.8%,21m
18290,1,scherwilol,2938,1623,76,81,157,48.4%,5m
18290,1,CptKock,2938,1057,73,70,143,51.0%,11m
18290,2,Tem,2938,768,63,47,110,57.3%,15m
18290,3,vEns,2938,853,46,53,99,46.5%,21m
18290,1,Barping,2938,732,40,35,75,53.3%,9m
18290,3,[SOUPEX]DrCapote,2938,800,37,50,87,42.5%,26m
18290,2,JAPEMUS,2938,777,33,32,65,50.8%,4m
18290,2,Gommel,2938,463,32,27,59,54.2%,4m
18290,1,Raven,2938,727,31,31,62,50.0%,19m
18290,2,[ƕe]Minh,2938,510,20,17,37,54.1%,9m
18290,2,[MSUSC2]SatelliteX,2938,333,14,14,28,50.0%,15m
18290,2,jjhipv,2938,297,12,7,19,63.2%,13m
18290,3,LDMA,2938,262,9,15,24,37.5%,25m
18290,1,Lipus,2938,282,8,16,24,33.3%,23m
18290,2,EndIsNear,2938,202,7,10,17,41.2%,8m
18290,1,[turtle]pallekuling,2938,200,6,8,14,42.9%,7m
18290,1,[ZЕRGТV]Tardis,2938,119,5,2,7,71.4%,45m
18290,2,ИванХохол,2938,141,4,2,6,66.7%,23m
18290,1,Sekker,2938,192,4,5,9,44.4%,23m
18290,2,[IndyK]SadFtwo,2938,88,4,6,10,40.0%,19m
18290,2,[Färsk]Zatadannis,2938,144,3,6,9,33.3%,27m
18290,2,xDel,2938,0,2,2,4,50.0%,1h
18290,2,[run]serways,2938,0,1,0,1,100.0%,18m
18290,2,[237wl]hasse,2938,0,1,0,1,100.0%,8m
18290,2,Nemefis,2938,0,1,0,1,100.0%,21m
18290,1,Eisman,2938,44,1,3,4,25.0%,44m
18290,2,[IPNSS]Protossamus,2938,0,0,1,1,0.0%,13m
18290,2,[Lumen]Vipsern,2938,0,0,5,5,0.0%,13m
18321,2,orpangandaro,2937,1570,196,175,371,52.8%,12m
18321,1,MadMan,2937,1588,131,116,247,53.0%,13m
18321,2,Sorinelu,2937,1488,79,72,151,52.3%,4m
18321,2,[ClubR]clau,2937,1233,65,66,131,49.6%,24m
18321,2,Andrea,2937,1257,63,63,126,50.0%,17m
18321,2,Tore,2937,909,47,44,91,51.6%,19m
18321,3,Steve,2937,935,38,38,76,50.0%,23m
18321,2,[Kripta]Зомби,2937,539,22,16,38,57.9%,11m
18321,2,Xiteld,2937,331,15,13,28,53.6%,15m
18321,2,[RahLuk]dorido,2937,264,8,8,16,50.0%,8m
18321,2,Olmage,2937,143,6,4,10,60.0%,23m
18321,1,archY,2937,97,4,2,6,66.7%,1h
18321,2,Marbod,2937,102,3,1,4,75.0%,3m
18321,2,SeNniS,2937,88,2,0,2,100.0%,12m
18321,1,HarryJJones,2937,97,2,0,2,100.0%,1h
18321,2,[Fridge]OZN,2937,0,2,3,5,40.0%,1h
18321,2,Naburo,2937,88,1,1,2,50.0%,10m
18321,2,Akkord,2937,30,1,2,3,33.3%,13m
18321,2,[LVswat]DemonRomSin,2937,0,0,1,1,0.0%,13m
18340,2,LLK,2936,770,94,87,181,51.9%,13m
18340,2,herbstkind,2936,980,65,64,129,50.4%,8m
18340,1,Amigo,2936,1144,46,44,90,51.1%,17m
18340,1,ZhukeZZlay,2936,965,43,46,89,48.3%,13m
18340,2,PuPsik,2936,769,34,22,56,60.7%,24m
18340,1,clji,2936,715,26,27,53,49.1%,3m
18340,1,Sad,2936,404,15,9,24,62.5%,13m
18340,2,Mădălin,2936,424,15,18,33,45.5%,5m
18340,2,zeraf,2936,280,11,6,17,64.7%,14m
18340,1,hWceo,2936,160,9,5,14,64.3%,24m
18340,2,Dalogadro,2936,236,8,6,14,57.1%,5m
18340,2,WakyzoneP,2936,228,8,12,20,40.0%,8m
18340,1,[CNC3]LurikFalurik,2936,220,7,3,10,70.0%,11m
18340,2,[HaoS]Alduin,2936,156,6,3,9,66.7%,21m
18340,2,[dolbo9]GameOver,2936,148,6,8,14,42.9%,12m
18340,1,ENOTwhynot,2936,96,5,5,10,50.0%,4m
18340,2,YourCat,2936,0,4,1,5,80.0%,4m
18340,3,BIGBOSS,2936,0,4,3,7,57.1%,4m
18340,2,[RoxtaR]megavit,2936,98,4,6,10,40.0%,19m
18340,2,[SDRS]xMetix,2936,0,3,2,5,60.0%,22m
18340,2,Cloudy,2936,60,3,2,5,60.0%,24m
18340,2,kekc,2936,88,2,1,3,66.7%,15m
18340,2,MarkyMcFly,2936,62,2,7,9,22.2%,19m
18340,1,[GŏDawn]Frinkle,2936,32,2,8,10,20.0%,4m
18340,2,[maxdan]ObiWanKenobi,2936,0,1,1,2,50.0%,8m
18340,2,Sadek,2936,0,0,1,1,0.0%,13m
18340,1,charlotte,2936,0,0,2,2,0.0%,36m
18340,2,[Tanky]JasonTecson,2936,0,0,2,2,0.0%,8m
18340,2,CallMeDerp,2936,0,0,5,5,0.0%,4m
18340,2,[k1raen]ZergHunter,2936,0,0,6,6,0.0%,6m
18340,2,Nide,2936,0,0,6,6,0.0%,8m
18371,1,DrPin,2935,1319,193,185,378,51.1%,13m
18371,2,[VzT]desmfr,2935,1077,146,116,262,55.7%,26m
18371,2,Ouch,2935,441,64,48,112,57.1%,21m
18371,2,EasyBot,2935,479,57,41,98,58.2%,18m
18371,2,Melonmurder,2935,1137,55,38,93,59.1%,15m
18371,2,[ЗЕRGТV]Rnnah,2935,431,29,20,49,59.2%,17m
18371,2,SuperRambo,2935,272,25,22,47,53.2%,20m
18371,2,LeoRev,2935,268,18,5,23,78.3%,4m
18371,1,IIIIIIIIIIII,2935,467,18,18,36,50.0%,16m
18371,2,[PR0uT]poupoule,2935,262,9,12,21,42.9%,12m
18371,2,OkMcNumOnEbR,2935,98,8,11,19,42.1%,8m
18371,2,[Mellow]MellowKuo,2935,224,7,8,15,46.7%,23m
18371,3,akRonnyk,2935,163,6,4,10,60.0%,11m
18371,2,AlexSib,2935,150,5,7,12,41.7%,4m
18371,2,[SРID]ПеЧеНьКа,2935,150,5,8,13,38.5%,19m
18371,2,[LSPs]Adarthya,2935,118,4,9,13,30.8%,15m
18371,2,[BroG]Mojo,2935,102,3,0,3,100.0%,18m
18371,1,Pitiku,2935,144,3,0,3,100.0%,14m
18371,3,SoeR,2935,0,3,5,8,37.5%,7m
18371,2,[Kingz]Triceratops,2935,58,3,6,9,33.3%,21m
18371,2,DoS,2935,0,1,0,1,100.0%,15m
18371,2,Wabarax,2935,0,1,0,1,100.0%,5m
18371,2,pilgrimoth,2935,0,1,0,1,100.0%,8m
18371,2,МастерЛу,2935,30,1,3,4,25.0%,7m
18371,2,[Heroes]Fele,2935,30,1,4,5,20.0%,16m
18371,2,Klivi,2935,30,1,5,6,16.7%,8m
18371,2,Enge,2935,0,0,3,3,0.0%,8m
18398,1,Pashabuhov,2934,1634,319,304,623,51.2%,12m
18398,1,Chemical,2934,947,110,106,216,50.9%,14m
18398,3,lolcake,2934,1600,74,90,164,45.1%,6m
18398,2,[3Macro]MOT,2934,1366,60,53,113,53.1%,4m
18398,2,Luxik,2934,1238,55,48,103,53.4%,15m
18398,2,Pav,2934,867,55,52,107,51.4%,5m
18398,2,[3DE]HeckobA,2934,624,45,41,86,52.3%,21m
18398,2,skyknight,2934,1140,45,43,88,51.1%,11m
18398,3,YoWtF,2934,948,42,54,96,43.8%,23m
18398,2,CuteBlondie,2934,247,41,26,67,61.2%,6m
18398,1,Rwin,2934,283,39,38,77,50.6%,14m
18398,2,FoxTrot,2934,712,28,24,52,53.8%,12m
18398,2,[XSpace]FireDrake,2934,506,27,26,53,50.9%,8m
18398,1,DenisKabal,2934,718,27,27,54,50.0%,13m
18398,1,Darkmer,2934,641,26,24,50,52.0%,20m
18398,2,Ages,2934,268,11,6,17,64.7%,4m
18398,2,Forbidden,2934,226,8,9,17,47.1%,7m
18398,2,[TTEA]RouR,2934,289,8,15,23,34.8%,5m
18398,2,Erling,2934,181,7,3,10,70.0%,7m
18398,1,Uraysis,2934,206,6,6,12,50.0%,12m
18398,2,EndNool,2934,214,6,6,12,50.0%,15m
18398,2,ShadowScythe,2934,154,5,2,7,71.4%,24m
18398,1,Khalilson,2934,144,3,0,3,100.0%,1h
18398,2,Makc,2934,0,3,2,5,60.0%,31m
18398,2,sdk,2934,0,3,2,5,60.0%,4m
18398,2,[StarTw]NaxDu,2934,88,2,0,2,100.0%,19m
18398,2,DarkaAa,2934,102,2,2,4,50.0%,13m
18398,2,FishNett,2934,114,2,3,5,40.0%,15m
18398,2,Challme,2934,114,2,3,5,40.0%,7m
18398,3,NashTAG,2934,0,1,0,1,100.0%,1h
18398,2,DaveGo,2934,0,1,1,2,50.0%,6m
18398,2,[PolSku]DaveBearserk,2934,88,1,1,2,50.0%,5m
18398,2,Cuthbert,2934,88,1,1,2,50.0%,24m
18398,1,WhiskyPower,2934,0,0,1,1,0.0%,19m
18398,2,[ryx13]RYXTER,2934,0,0,2,2,0.0%,21m
18398,2,Maras,2934,0,0,5,5,0.0%,7m
18434,2,StormD,2933,1572,100,92,192,52.1%,6m
18434,2,Ray,2933,1420,90,79,169,53.3%,22m
18434,3,[TIGER5]Chris,2933,971,73,73,146,50.0%,22m
18434,2,GSK,2933,641,69,51,120,57.5%,18m
18434,2,Wisefull,2933,1069,41,43,84,48.8%,4m
18434,2,KingOfDeath,2933,904,36,31,67,53.7%,3m
18434,2,snacher,2933,669,32,24,56,57.1%,24m
18434,2,StuntS,2933,324,31,18,49,63.3%,13m
18434,2,[TedB]RoadToTopOne,2933,604,26,23,49,53.1%,26m
18434,2,Prometheus,2933,249,12,5,17,70.6%,11m
18434,2,Stygi,2933,269,11,7,18,61.1%,17m
18434,2,Tesla,2933,294,10,10,20,50.0%,13m
18434,1,chaosInside,2933,303,10,14,24,41.7%,17m
18434,3,[uloser]Coldwar,2933,252,9,7,16,56.2%,20m
18434,3,ZaR,2933,161,7,4,11,63.6%,1h
18434,3,retroCZ,2933,218,7,6,13,53.8%,22m
18434,1,Akella,2933,92,7,6,13,53.8%,12m
18434,3,Hhiruma,2933,169,6,5,11,54.5%,1h
18434,2,[C05]Asketic,2933,146,6,7,13,46.2%,7m
18434,2,[FreshD]Leuchtfix,2933,168,5,4,9,55.6%,8m
18434,3,[BRSKR]CrimsonKing,2933,58,3,1,4,75.0%,10m
18434,3,funney,2933,0,3,2,5,60.0%,18m
18434,3,TheHummus,2933,58,2,1,3,66.7%,24m
18434,2,[B1C]Artwenki,2933,30,2,4,6,33.3%,20m
18434,1,Freesia,2933,0,1,5,6,16.7%,26m
18434,3,[isIMBA]Sinnaah,2933,0,0,1,1,0.0%,16m
18434,2,Hotmail,2933,0,0,2,2,0.0%,4m
18434,3,ZERGIIIRUSH,2933,0,0,2,2,0.0%,15m
18462,2,WesCoriginal,2932,529,51,39,90,56.7%,8m
18462,1,[BjwA]Puco,2932,770,25,34,59,42.4%,8m
18462,2,zompin,2932,431,17,14,31,54.8%,8m
18462,2,Lops,2932,378,16,10,26,61.5%,20m
18462,3,Peroksit,2932,386,16,11,27,59.3%,21m
18462,2,Garf,2932,418,15,18,33,45.5%,26m
18462,1,nOskiL,2932,470,15,22,37,40.5%,19m
18462,1,JInzhiyu,2932,340,13,23,36,36.1%,13m
18462,2,Hamelion,2932,296,10,13,23,43.5%,11m
18462,2,TRIBUNAL,2932,244,8,8,16,50.0%,12m
18462,2,Unhealthy,2932,232,8,11,19,42.1%,21m
18462,3,Sputnik,2932,166,7,0,7,100.0%,13m
18462,2,RomanWin,2932,180,7,7,14,50.0%,19m
18462,1,HelloKitty,2932,123,4,0,4,100.0%,24m
18462,3,[KIMM]Summer,2932,0,4,3,7,57.1%,1h
18462,2,unknown,2932,0,3,2,5,60.0%,37m
18462,2,Jackson,2932,0,3,2,5,60.0%,23m
18462,2,Patrik,2932,0,3,2,5,60.0%,15m
18462,3,[Tubu]bouncer,2932,0,3,2,5,60.0%,22m
18462,3,iceyeti,2932,0,3,2,5,60.0%,21m
18462,2,Jean,2932,0,3,3,6,50.0%,24m
18462,2,[PLA2N]BrainDeadNoo,2932,122,3,4,7,42.9%,1h
18462,2,Morningstar,2932,90,3,7,10,30.0%,25m
18462,3,imgaytoday,2932,0,1,0,1,100.0%,18m
18462,3,[369MBS]DaKorona,2932,0,1,0,1,100.0%,15m
18462,2,stomatolog,2932,0,1,2,3,33.3%,37m
18462,3,Kaippari,2932,0,0,1,1,0.0%,15m
18462,3,Mercurian,2932,0,0,1,1,0.0%,26m
18462,3,waldymarxtnf,2932,0,0,1,1,0.0%,15m
18462,3,[SKSS]ringo,2932,0,0,5,5,0.0%,24m
18492,2,HAZDRUBAL,2931,1579,197,191,388,50.8%,10m
18492,1,slon,2931,1622,138,135,273,50.5%,22m
18492,2,OldRye,2931,1244,111,103,214,51.9%,8m
18492,2,Gogogo,2931,1598,100,84,184,54.3%,12m
18492,2,VoltD,2931,1559,95,89,184,51.6%,7m
18492,1,Odrael,2931,1439,69,70,139,49.6%,24m
18492,2,Luckу,2931,1047,44,41,85,51.8%,4m
18492,2,Sorry,2931,547,37,21,58,63.8%,21m
18492,2,ness,2931,726,27,27,54,50.0%,18m
18492,2,[WWP]melyf,2931,444,21,13,34,61.8%,12m
18492,2,tms,2931,552,20,26,46,43.5%,8m
18492,2,picko,2931,382,16,16,32,50.0%,16m
18492,2,[NOYPI]GERARD,2931,306,12,7,19,63.2%,15m
18492,1,Heydrick,2931,298,12,10,22,54.5%,16m
18492,3,Danilka,2931,276,11,5,16,68.8%,9m
18492,2,GROKA,2931,294,11,12,23,47.8%,19m
18492,2,MVA,2931,193,8,2,10,80.0%,11m
18492,2,BenZaka,2931,230,8,6,14,57.1%,20m
18492,3,Hécatombe,2931,130,7,6,13,53.8%,44m
18492,1,Bucifer,2931,48,6,2,8,75.0%,45m
18492,2,monkey,2931,168,6,3,9,66.7%,13m
18492,2,NHP,2931,174,6,4,10,60.0%,24m
18492,3,Trasig,2931,0,5,0,5,100.0%,22m
18492,3,Ironclaw,2931,88,5,5,10,50.0%,7m
18492,2,[TRIO3]SiN,2931,0,4,2,6,66.7%,11m
18492,2,[4qq]BitchBotBoi,2931,90,4,6,10,40.0%,20m
18492,3,OstOstMeraOs,2931,129,2,1,3,66.7%,7m
18492,2,GranCapitán,2931,30,2,2,4,50.0%,21m
18492,3,[LeBrz]Merdiorian,2931,0,2,3,5,40.0%,18m
18492,3,raffael,2931,0,2,3,5,40.0%,18m
18492,3,[Aмун]MrWest,2931,0,1,1,2,50.0%,1h
18492,2,Tlaloc,2931,0,1,1,2,50.0%,20m
18492,1,Xtream,2931,0,1,2,3,33.3%,30m
18492,3,GOLden,2931,0,1,4,5,20.0%,18m
18492,3,XtremeMan,2931,0,0,1,1,0.0%,10m
18492,2,Fayfull,2931,0,0,2,2,0.0%,19m
18492,3,Разэнганс,2931,0,0,2,2,0.0%,1h
18529,1,Carbon,2930,1097,194,185,379,51.2%,16m
18529,2,OldSchoolBoy,2930,1563,126,110,236,53.4%,8m
18529,3,robertnevill,2930,1625,99,83,182,54.4%,22m
18529,2,Safe,2930,443,49,49,98,50.0%,4m
18529,2,Timurkin,2930,1131,48,38,86,55.8%,5m
18529,2,ENJOY,2930,1231,46,46,92,50.0%,21m
18529,1,Solar,2930,1210,43,47,90,47.8%,8m
18529,2,Evergreen,2930,819,37,34,71,52.1%,13m
18529,2,HydralicH,2930,770,30,29,59,50.8%,21m
18529,2,Vlado,2930,346,13,15,28,46.4%,4m
18529,3,[БУТЕР1]Ribolov,2930,346,12,9,21,57.1%,18m
18529,2,Véktørs,2930,352,12,13,25,48.0%,21m
18529,2,[laugh]SASHA,2930,232,8,12,20,40.0%,15m
18529,1,bart,2930,191,7,3,10,70.0%,1h
18529,2,Glenfiddich,2930,212,7,4,11,63.6%,11m
18529,2,Cassadian,2930,116,5,7,12,41.7%,17m
18529,2,[GLAaND]bernardmenez,2930,0,4,1,5,80.0%,39m
18529,3,Recycling,2930,0,4,1,5,80.0%,4m
18529,2,FlyingHorse,2930,120,4,5,9,44.4%,15m
18529,3,[WCKYLN]Lonestar,2930,86,3,1,4,75.0%,20m
18529,3,[AiRǂ]Rictal,2930,144,3,1,4,75.0%,4m
18529,2,Vaelstraz,2930,0,3,2,5,60.0%,28m
18529,2,[TheM]Datanf,2930,0,3,2,5,60.0%,17m
18529,2,battlepants,2930,60,3,3,6,50.0%,7m
18529,3,KingOfNoob,2930,30,2,0,2,100.0%,19m
18529,2,Dowie,2930,0,1,1,2,50.0%,24m
18529,2,MrTock,2930,0,1,1,2,50.0%,21m
18529,2,[IYOLOI]Cythraul,2930,88,1,2,3,33.3%,24m
18529,2,Homyachiy,2930,30,1,4,5,20.0%,15m
18529,3,PURIFIED,2930,0,0,1,1,0.0%,21m
18529,3,[Batia]IIIIIIII,2930,0,0,1,1,0.0%,22m
18529,3,[Tiznao]Kirsath,2930,0,0,1,1,0.0%,18m
18561,2,Nototo,2929,1624,657,631,1288,51.0%,4m
18561,2,VladTImpaler,2929,1617,164,161,325,50.5%,16m
18561,2,Picos,2929,1570,133,127,260,51.2%,13m
18561,2,SilentStorm,2929,1284,99,58,157,63.1%,22m
18561,3,Swift,2929,1200,52,50,102,51.0%,8m
18561,2,[Focan]Necrid,2929,671,40,32,72,55.6%,19m
18561,2,[Cheel]oler,2929,681,39,45,84,46.4%,12m
18561,3,Rafael,2929,836,35,24,59,59.3%,23m
18561,2,[TheDOH]RSPOL,2929,297,30,17,47,63.8%,7m
18561,1,TheRock,2929,750,25,32,57,43.9%,5m
18561,2,[day10]ThirdAngel,2929,467,20,16,36,55.6%,19m
18561,2,utrator,2929,503,19,19,38,50.0%,15m
18561,2,[Levit]Levitas,2929,479,18,16,34,52.9%,4m
18561,2,[JoK]Mango,2929,422,17,14,31,54.8%,5m
18561,2,Hede,2929,348,16,16,32,50.0%,4m
18561,2,TheKraken,2929,416,14,19,33,42.4%,25m
18561,2,Chicken,2929,302,11,7,18,61.1%,13m
18561,1,Evgded,2929,249,10,11,21,47.6%,8m
18561,2,jari,2929,300,8,14,22,36.4%,22m
18561,3,CybMcloud,2929,159,7,4,11,63.6%,21m
18561,1,Chelo,2929,97,5,2,7,71.4%,44m
18561,3,Chia,2929,0,4,1,5,80.0%,23m
18561,3,Trauma,2929,170,4,9,13,30.8%,21m
18561,3,[4CB]GAMERSTAR,2929,112,3,1,4,75.0%,24m
18561,3,Katniss,2929,0,3,2,5,60.0%,17m
18561,2,MørrigaN,2929,30,2,4,6,33.3%,23m
18561,2,Dowel,2929,60,2,5,7,28.6%,15m
18561,3,ГенералАУЕ,2929,0,1,0,1,100.0%,19m
18561,2,[cScǃ]Fresh,2929,30,1,4,5,20.0%,4m
18561,2,[DМG]Gaiety,2929,0,0,1,1,0.0%,37m
18561,3,katamorphism,2929,0,0,1,1,0.0%,25m
18561,3,[GSLs]BioS,2929,0,0,1,1,0.0%,10m
18561,2,btester,2929,0,0,3,3,0.0%,18m
18594,1,Nimbuus,2928,1608,287,261,548,52.4%,16m
18594,3,LEGUEU,2928,522,129,118,247,52.2%,23m
18594,1,pizhon,2928,1190,123,122,245,50.2%,20m
18594,1,Donhaka,2928,952,115,115,230,50.0%,9m
18594,2,Surikat,2928,1097,100,99,199,50.3%,16m
18594,1,Adriel,2928,971,66,67,133,49.6%,10m
18594,2,virus,2928,697,36,24,60,60.0%,22m
18594,2,Keasium,2928,815,33,37,70,47.1%,23m
18594,2,zairax,2928,823,31,28,59,52.5%,12m
18594,3,Sanekus,2928,563,28,20,48,58.3%,15m
18594,2,[КЕКS]CptKEK,2928,634,27,18,45,60.0%,5m
18594,3,mrbeanling,2928,424,16,16,32,50.0%,10m
18594,2,MrBLee,2928,366,15,12,27,55.6%,20m
18594,2,pivanov,2928,324,12,11,23,52.2%,12m
18594,2,GDim,2928,298,11,12,23,47.8%,21m
18594,2,madamepipi,2928,306,11,13,24,45.8%,26m
18594,2,Dabdab,2928,302,10,11,21,47.6%,4m
18594,2,Andartis,2928,232,8,10,18,44.4%,24m
18594,2,[NOOBpl]Hitoru,2928,236,8,12,20,40.0%,4m
18594,2,supergrobi,2928,180,7,4,11,63.6%,24m
18594,3,llllllllllll,2928,148,6,5,11,54.5%,12m
18594,2,Жекичан,2928,216,6,7,13,46.2%,20m
18594,1,[Waseda]IIIIIIIIIIII,2928,193,5,4,9,55.6%,1h
18594,3,BatTheKing,2928,144,5,5,10,50.0%,11m
18594,2,Insight,2928,140,4,4,8,50.0%,4m
18594,3,[REDFOX]Faneco,2928,0,3,2,5,60.0%,22m
18594,3,Kniebolo,2928,0,3,2,5,60.0%,8m
18594,2,Drunk,2928,0,3,2,5,60.0%,43m
18594,3,GladHeAteHer,2928,0,3,2,5,60.0%,16m
18594,2,[GeOr]RechterHoden,2928,0,3,3,6,50.0%,4m
18594,2,IBAN,2928,100,3,7,10,30.0%,24m
18594,1,Patrox,2928,97,2,1,3,66.7%,39m
18594,3,WaRW,2928,94,2,3,5,40.0%,22m
18594,2,eMaL,2928,30,1,3,4,25.0%,9m
18594,3,AutoGen,2928,0,0,1,1,0.0%,10m
18594,2,Auri,2928,0,0,1,1,0.0%,33m
18594,1,Lockdown,2928,0,0,1,1,0.0%,28m
18594,3,Ladord,2928,0,0,5,5,0.0%,10m
18632,1,[ZЕRGТV]Raditoit,2927,1321,174,156,330,52.7%,20m
18632,2,diggawhat,2927,1572,162,152,314,51.6%,9m
18632,1,Crochian,2927,1157,56,47,103,54.4%,16m
18632,1,[PlantZ]Maedhros,2927,723,29,31,60,48.3%,5m
18632,3,CommanderE,2927,512,23,10,33,69.7%,12m
18632,2,Argonot,2927,534,21,20,41,51.2%,11m
18632,2,AzRaEl,2927,448,17,20,37,45.9%,4m
18632,2,cartman,2927,355,13,10,23,56.5%,9m
18632,2,tyron,2927,142,8,7,15,53.3%,5m
18632,1,tomylv,2927,215,7,3,10,70.0%,34m
18632,2,[SanFam]Loken,2927,214,7,8,15,46.7%,8m
18632,3,Kotik,2927,86,4,1,5,80.0%,22m
18632,3,Bertalanffy,2927,158,4,3,7,57.1%,15m
18632,2,NaSHx,2927,116,4,6,10,40.0%,25m
18632,3,HorstKevin,2927,84,3,2,5,60.0%,16m
18632,3,Sky,2927,0,3,2,5,60.0%,5m
18632,3,Lauz,2927,0,2,1,3,66.7%,16m
18632,2,Leny,2927,30,2,3,5,40.0%,5m
18632,3,Asolden,2927,0,1,0,1,100.0%,24m
18632,3,Damio,2927,0,1,0,1,100.0%,19m
18632,3,Khgou,2927,0,1,0,1,100.0%,9m
18632,3,cheville,2927,0,1,0,1,100.0%,22m
18632,2,LemfGently,2927,0,1,1,2,50.0%,13m
18632,3,[Рачелы]Seesker,2927,0,0,1,1,0.0%,10m
18632,2,[127ORT]поездболи,2927,0,0,4,4,0.0%,24m
18657,3,Lelemur,2926,1545,75,82,157,47.8%,26m
18657,3,deepixel,2926,539,64,50,114,56.1%,8m
18657,2,MrCheese,2926,715,32,19,51,62.7%,13m
18657,2,Driox,2926,404,15,16,31,48.4%,10m
18657,2,Kelio,2926,335,14,14,28,50.0%,4m
18657,2,williamgar,2926,180,13,7,20,65.0%,25m
18657,3,DonVino,2926,213,8,5,13,61.5%,15m
18657,2,[CL0wnZ]VOLODIAGARAJ,2926,172,5,3,8,62.5%,1h
18657,2,LUKE,2926,120,5,6,11,45.5%,23m
18657,3,NiKiPaj,2926,0,4,1,5,80.0%,21m
18657,2,LilleVolD,2926,0,3,2,5,60.0%,20m
18657,3,Dreier,2926,97,2,1,3,66.7%,36m
18657,3,[SpBF]MrHier,2926,97,2,3,5,40.0%,9m
18657,3,PikPok,2926,0,1,0,1,100.0%,15m
18657,3,Spiff,2926,30,1,1,2,50.0%,18m
18657,2,[RZF]EzWin,2926,0,1,2,3,33.3%,7m
18657,2,CAMAC,2926,30,1,3,4,25.0%,4m
18657,2,Armadillo,2926,0,1,10,11,9.1%,1h
18657,3,[PLA2N]Titanych,2926,0,0,1,1,0.0%,21m
18657,2,mouz,2926,0,0,2,2,0.0%,4m
18677,2,[xFRSx]Derbki,2925,1345,102,103,205,49.8%,20m
18677,2,[hf4X4]Havchik,2925,1559,83,54,137,60.6%,22m
18677,1,PanKapsel,2925,887,31,35,66,47.0%,14m
18677,2,ady,2925,597,29,13,42,69.0%,20m
18677,2,Kiroin,2925,399,17,13,30,56.7%,5m
18677,1,OmaeWaMou,2925,218,10,9,19,52.6%,11m
18677,2,Dogland,2925,278,10,11,21,47.6%,13m
18677,2,Masret,2925,251,8,12,20,40.0%,13m
18677,2,Latlante,2925,180,7,8,15,46.7%,8m
18677,3,TrustMe,2925,142,6,2,8,75.0%,25m
18677,2,ZuuR,2925,124,5,4,9,55.6%,22m
18677,2,ForZion,2925,0,3,2,5,60.0%,1h
18677,3,Fmann,2925,60,2,2,4,50.0%,15m
18677,2,Xenser,2925,102,2,3,5,40.0%,27m
18677,2,Ginger,2925,30,2,6,8,25.0%,23m
18677,3,[StipcT]Laxxo,2925,0,1,0,1,100.0%,5m
18677,3,KeMpYXzZz,2925,0,1,0,1,100.0%,8m
18677,3,llllllllllll,2925,30,1,1,2,50.0%,9m
18677,3,carnage,2925,0,1,2,3,33.3%,8m
18677,3,slipnote,2925,0,0,1,1,0.0%,21m
18677,3,Arthor,2925,0,0,1,1,0.0%,21m
18677,2,[HsDL]Ciro,2925,0,0,2,2,0.0%,22m
18677,2,lightsha,2925,0,0,2,2,0.0%,21m
18677,2,Tseng,2925,0,0,2,2,0.0%,13m
18677,2,Linkin,2925,0,0,3,3,0.0%,4m
18702,2,[tchü]sephiroth,2924,1533,77,60,137,56.2%,12m
18702,1,Slayn,2924,543,75,71,146,51.4%,5m
18702,2,[2RVLV]Rambo,2924,959,44,28,72,61.1%,21m
18702,2,Kris,2924,648,26,22,48,54.2%,25m
18702,2,TmG,2924,352,12,10,22,54.5%,13m
18702,2,[IndyK]rNs,2924,270,11,6,17,64.7%,9m
18702,3,Biiru,2924,302,10,4,14,71.4%,24m
18702,2,Borgrdr,2924,239,9,7,16,56.2%,4m
18702,1,AIW,2924,227,9,18,27,33.3%,7m
18702,1,Geodin,2924,185,8,7,15,53.3%,3m
18702,2,[PLA2N]Cruiser,2924,219,8,8,16,50.0%,4m
18702,1,eeleel,2924,190,7,13,20,35.0%,19m
18702,3,RadukGor,2924,210,6,10,16,37.5%,29m
18702,3,EXTRA,2924,30,5,1,6,83.3%,6m
18702,2,TheJuice,2924,166,5,4,9,55.6%,4m
18702,1,Stinker,2924,148,5,13,18,27.8%,5m
18702,3,AidenR,2924,0,4,3,7,57.1%,25m
18702,3,[LAP]Stratega,2924,38,2,2,4,50.0%,4m
18702,2,Gore,2924,48,2,4,6,33.3%,43m
18702,2,Dennis,2924,0,1,3,4,25.0%,13m
18702,2,[ROFG]AnatoliyNoha,2924,30,1,3,4,25.0%,20m
18702,3,Timon,2924,0,0,1,1,0.0%,24m
18702,3,Mosya,2924,0,0,1,1,0.0%,27m
18725,2,AlleyCat,2923,1580,164,166,330,49.7%,24m
18725,2,NeverStar,2923,1089,74,68,142,52.1%,15m
18725,2,McWrap,2923,599,71,56,127,55.9%,21m
18725,2,Дмитрий,2923,534,29,13,42,69.0%,3m
18725,2,Joachim,2923,756,29,28,57,50.9%,11m
18725,2,OqopO,2923,565,21,20,41,51.2%,15m
18725,2,IMakeLings,2923,402,14,17,31,45.2%,12m
18725,3,Silker,2923,332,13,8,21,61.9%,18m
18725,2,saifo,2923,341,12,10,22,54.5%,11m
18725,2,TrashPanda,2923,328,11,11,22,50.0%,21m
18725,1,Bukvátor,2923,320,11,12,23,47.8%,1h
18725,2,pika,2923,286,11,18,29,37.9%,27m
18725,3,martis,2923,238,9,6,15,60.0%,12m
18725,3,Murphy,2923,240,9,6,15,60.0%,16m
18725,3,Gutti,2923,210,8,7,15,53.3%,34m
18725,3,TooLazy,2923,142,5,3,8,62.5%,8m
18725,2,llllllllllll,2923,60,5,5,10,50.0%,3m
18725,2,[ABRX]twistednose,2923,198,5,6,11,45.5%,24m
18725,2,DPDOOM,2923,128,3,1,4,75.0%,8m
18725,3,[Arrows]Limbo,2923,30,3,1,4,75.0%,22m
18725,3,BoogieMan,2923,0,3,2,5,60.0%,11m
18725,2,[Cens]axelteo,2923,58,3,3,6,50.0%,24m
18725,1,Вираж,2923,0,3,4,7,42.9%,11m
18725,3,Goat,2923,0,2,1,3,66.7%,22m
18725,2,Dixienormous,2923,30,2,3,5,40.0%,21m
18725,2,[Kicx]Guizzo,2923,60,2,6,8,25.0%,18m
18725,3,[TedB]NewWayTeh,2923,0,1,0,1,100.0%,21m
18725,3,ПутинРулит,2923,0,1,0,1,100.0%,22m
18725,3,Cyril,2923,0,1,0,1,100.0%,26m
18725,2,Halloween,2923,0,1,0,1,100.0%,34m
18725,2,Yosen,2923,0,1,2,3,33.3%,8m
18725,2,[VISIK]DarckLORD,2923,0,1,2,3,33.3%,12m
18725,3,SeNSei,2923,30,1,2,3,33.3%,18m
18725,2,DonGrayGoose,2923,88,1,2,3,33.3%,15m
18725,2,Oreeo,2923,0,0,3,3,0.0%,14m
18760,2,KILLSTAR,2922,621,215,213,428,50.2%,10m
18760,1,DarkSide,2922,1335,205,205,410,50.0%,23m
18760,2,[H0C]BesnoPile,2922,1229,149,131,280,53.2%,13m
18760,1,groar,2922,1560,114,107,221,51.6%,8m
18760,2,кирпич,2922,1082,106,96,202,52.5%,19m
18760,2,darkOI,2922,647,86,69,155,55.5%,27m
18760,2,Jasont,2922,1059,43,40,83,51.8%,8m
18760,3,XPECT,2922,388,16,13,29,55.2%,11m
18760,3,Caracas,2922,386,15,12,27,55.6%,21m
18760,2,[DТ]geerzak,2922,296,11,10,21,52.4%,26m
18760,3,MaTthIas,2922,280,10,4,14,71.4%,9m
18760,2,Nervenzelle,2922,241,10,8,18,55.6%,1h
18760,2,REDDEATH,2922,266,9,8,17,52.9%,18m
18760,2,Adlerklinge,2922,167,6,3,9,66.7%,4m
18760,2,[120mm]oBLakDim,2922,180,6,5,11,54.5%,21m
18760,1,OverLord,2922,145,5,4,9,55.6%,29m
18760,2,jaimenak,2922,48,3,3,6,50.0%,1h
18760,2,[TTWE]alexandre,2922,128,3,4,7,42.9%,4m
18760,2,Motionless,2922,183,3,11,14,21.4%,1h
18760,1,ILLUMINATY,2922,97,2,1,3,66.7%,6m
18760,3,Regis,2922,58,2,1,3,66.7%,20m
18760,2,Duc,2922,0,2,1,3,66.7%,1h
18760,2,[AOTW]Blooddy,2922,30,2,2,4,50.0%,11m
18760,2,Porkchop,2922,30,2,2,4,50.0%,6m
18760,3,duduispig,2922,0,1,0,1,100.0%,24m
18760,3,aiur,2922,0,1,0,1,100.0%,21m
18760,3,IceRus,2922,30,1,1,2,50.0%,18m
18760,2,Dewedi,2922,30,1,3,4,25.0%,12m
18760,2,[CØG]bouclier,2922,30,1,4,5,20.0%,8m
18760,2,MrNice,2922,30,1,6,7,14.3%,11m
18760,3,FURYCH,2922,0,0,1,1,0.0%,15m
18760,2,BirNedFeniXx,2922,0,0,4,4,0.0%,24m
18792,2,Schweder,2921,747,126,122,248,50.8%,7m
18792,1,Erenler,2921,1452,122,123,245,49.8%,4m
18792,1,artem,2921,1267,96,104,200,48.0%,3m
18792,1,Sabian,2921,1201,84,82,166,50.6%,20m
18792,2,JanZai,2921,1588,79,69,148,53.4%,9m
18792,2,whocutcheese,2921,207,49,33,82,59.8%,21m
18792,3,DuDValerka,2921,571,25,10,35,71.4%,22m
18792,2,Neeme,2921,400,18,13,31,58.1%,20m
18792,2,Otzelot,2921,400,14,20,34,41.2%,12m
18792,2,gola,2921,230,11,5,16,68.8%,8m
18792,1,savionok,2921,314,10,12,22,45.5%,26m
18792,2,ReadySKP,2921,264,9,11,20,45.0%,9m
18792,2,meuge,2921,200,8,9,17,47.1%,8m
18792,3,EnOtIk,2921,120,5,4,9,55.6%,13m
18792,2,LuckyRaynor,2921,200,4,5,9,44.4%,17m
18792,1,Hellraven,2921,172,4,7,11,36.4%,42m
18792,3,[TTL]Xpoon,2921,0,3,2,5,60.0%,25m
18792,2,[kolins]OraculGiga,2921,0,3,2,5,60.0%,37m
18792,3,Sharp,2921,0,3,2,5,60.0%,20m
18792,3,Requiem,2921,58,2,2,4,50.0%,22m
18792,2,blooble,2921,30,2,2,4,50.0%,8m
18792,2,Imeral,2921,60,2,4,6,33.3%,22m
18792,3,[Onami]VkaiF,2921,30,1,1,2,50.0%,22m
18792,2,DMJ,2921,0,1,1,2,50.0%,20m
18792,2,[FCSInc]CommanderAxe,2921,0,1,2,3,33.3%,5m
18792,3,[Sepper]chronos,2921,0,0,1,1,0.0%,22m
18792,3,Gnaeus,2921,0,0,1,1,0.0%,19m
18792,1,ulkenauer,2921,0,0,4,4,0.0%,36m
18820,2,HenrykKwinto,2920,1530,227,216,443,51.2%,12m
18820,1,SON,2920,1633,188,190,378,49.7%,7m
18820,2,[ChTe]DarkAvisse,2920,1588,163,153,316,51.6%,18m
18820,2,sergeant,2920,1465,86,72,158,54.4%,6m
18820,3,Autophagy,2920,1163,70,60,130,53.8%,18m
18820,2,Bumblebee,2920,614,67,40,107,62.6%,21m
18820,2,Atist,2920,1481,62,53,115,53.9%,15m
18820,1,Imperious,2920,849,37,32,69,53.6%,23m
18820,2,Сергей,2920,576,36,29,65,55.4%,21m
18820,3,velbloud,2920,638,24,20,44,54.5%,19m
18820,2,Mac,2920,650,23,23,46,50.0%,11m
18820,1,[TSC]KipikK,2920,454,15,20,35,42.9%,16m
18820,2,Lyto,2920,318,12,11,23,52.2%,22m
18820,1,barcode,2920,329,10,14,24,41.7%,8m
18820,2,Gordon,2920,232,8,11,19,42.1%,11m
18820,3,DrHeinzKlaus,2920,170,7,4,11,63.6%,15m
18820,2,[FraRis]lucas,2920,114,7,5,12,58.3%,25m
18820,3,[ExTr1m]LUX,2920,191,6,5,11,54.5%,7m
18820,2,Zigzagzog,2920,154,5,3,8,62.5%,6m
18820,2,Kroll,2920,97,5,4,9,55.6%,26m
18820,3,[BLMSTR]romanskij,2920,30,4,2,6,66.7%,24m
18820,3,Kadabra,2920,30,4,2,6,66.7%,4m
18820,3,Zato,2920,114,4,2,6,66.7%,21m
18820,1,jiguner,2920,97,4,3,7,57.1%,29m
18820,3,Maple,2920,86,3,1,4,75.0%,16m
18820,1,[NOGod]donab,2920,111,3,1,4,75.0%,11m
18820,3,Centauri,2920,0,3,2,5,60.0%,27m
18820,2,[Nidus]xxwinzzxx,2920,114,3,2,5,60.0%,11m
18820,2,OutPlayed,2920,30,2,3,5,40.0%,17m
18820,3,armek,2920,119,2,4,6,33.3%,10m
18820,2,[Brra]Chachou,2920,0,1,1,2,50.0%,28m
18820,2,MCScenaRiO,2920,0,1,4,5,20.0%,21m
18820,3,Maestro,2920,0,0,1,1,0.0%,22m
18820,2,Niconico,2920,0,0,3,3,0.0%,13m
18854,1,AllArmyAMove,2919,1625,317,297,614,51.6%,22m
18854,1,grep,2919,1332,245,227,472,51.9%,22m
18854,1,CHerOBukXpeH,2919,1609,152,131,283,53.7%,4m
18854,2,Alex,2919,1511,120,122,242,49.6%,24m
18854,1,DGR,2919,1589,94,90,184,51.1%,8m
18854,2,[SEBULA]Papiq,2919,1390,83,70,153,54.2%,21m
18854,2,Snoop,2919,660,73,62,135,54.1%,5m
18854,2,Rynot,2919,1064,56,51,107,52.3%,11m
18854,2,[INCTS]QuillZel,2919,585,22,21,43,51.2%,8m
18854,2,Abyss,2919,534,20,19,39,51.3%,13m
18854,2,Punkero,2919,428,16,16,32,50.0%,18m
18854,2,StarKing,2919,284,12,6,18,66.7%,11m
18854,2,Kaegan,2919,302,12,10,22,54.5%,4m
18854,2,[GgWall]fetknol,2919,280,11,11,22,50.0%,10m
18854,2,JustOne,2919,198,10,11,21,47.6%,12m
18854,3,CapLapca,2919,165,9,2,11,81.8%,19m
18854,2,Tomiris,2919,164,7,5,12,58.3%,4m
18854,2,PanSowa,2919,206,7,10,17,41.2%,6m
18854,3,Spinnock,2919,58,4,1,5,80.0%,18m
18854,2,PrinceAslan,2919,124,4,9,13,30.8%,13m
18854,3,Scholle,2919,114,3,1,4,75.0%,11m
18854,3,Ollowain,2919,97,2,3,5,40.0%,34m
18854,3,Pika,2919,0,1,0,1,100.0%,11m
18854,1,Zugzwang,2919,0,1,2,3,33.3%,33m
18854,2,[NsA]Sheppard,2919,0,1,2,3,33.3%,5m
18854,3,Lyraion,2919,0,0,1,1,0.0%,24m
18880,2,IllIIllIIllI,2918,1695,464,462,926,50.1%,24m
18880,2,[fFlags]barthem,2918,1495,114,102,216,52.8%,10m
18880,2,Jezuskrol,2918,1072,46,37,83,55.4%,11m
18880,3,IronY,2918,485,44,33,77,57.1%,21m
18880,2,ImRentable,2918,339,42,28,70,60.0%,9m
18880,2,Cookie,2918,778,32,29,61,52.5%,4m
18880,3,Sensei,2918,501,28,22,50,56.0%,15m
18880,2,OneGraund,2918,166,24,21,45,53.3%,24m
18880,3,[lOoOl]KatyaAngel,2918,309,11,2,13,84.6%,4m
18880,2,Garfield,2918,290,11,8,19,57.9%,5m
18880,2,[TPoT]TeaPotBruh,2918,299,11,11,22,50.0%,22m
18880,2,Pandarama,2918,263,10,8,18,55.6%,1h
18880,3,WildPants,2918,220,8,4,12,66.7%,6m
18880,1,iPax,2918,171,7,7,14,50.0%,25m
18880,3,SpiritWolf,2918,196,6,1,7,85.7%,1h
18880,3,rassvet,2918,30,5,1,6,83.3%,23m
18880,2,Гусь,2918,0,3,2,5,60.0%,1h
18880,1,ArtyomPraim,2918,0,3,3,6,50.0%,1h
18880,2,Frehïr,2918,88,2,1,3,66.7%,4m
18880,2,AlloToi,2918,88,2,1,3,66.7%,5m
18880,3,Holidayfreak,2918,0,1,0,1,100.0%,11m
18880,3,Leonid,2918,0,1,0,1,100.0%,19m
18880,2,Grom,2918,0,0,2,2,0.0%,4m
18903,1,wurmvati,2917,1385,120,128,248,48.4%,8m
18903,2,Aleks,2917,657,46,35,81,56.8%,21m
18903,2,necher,2917,293,32,25,57,56.1%,18m
18903,2,Arima,2917,547,24,15,39,61.5%,5m
18903,2,Diobrin,2917,539,21,18,39,53.8%,9m
18903,2,[davy17]Davy,2917,257,17,16,33,51.5%,21m
18903,2,Kator,2917,352,16,12,28,57.1%,12m
18903,1,Revo,2917,354,12,18,30,40.0%,13m
18903,2,Fortune,2917,272,11,9,20,55.0%,39m
18903,1,[ESENCE]BERZERKER,2917,97,4,3,7,57.1%,32m
18903,3,TheKing,2917,0,3,2,5,60.0%,17m
18903,2,Lucky,2917,0,3,2,5,60.0%,9m
18903,3,dukratchic,2917,116,3,4,7,42.9%,25m
18903,3,DeeX,2917,42,2,2,4,50.0%,11m
18903,2,Pandarroganz,2917,0,1,1,2,50.0%,8m
18903,2,Strn,2917,0,1,1,2,50.0%,21m
18903,2,Shkolonik,2917,40,1,1,2,50.0%,19m
18903,3,Ronin,2917,0,0,1,1,0.0%,21m
18903,3,imnub,2917,0,0,1,1,0.0%,18m
18903,2,[Brak]horticulteur,2917,0,0,5,5,0.0%,15m
18923,3,Glühdraht,2916,886,388,380,768,50.5%,22m
18923,3,naP,2916,1632,180,188,368,48.9%,13m
18923,3,Saigonara,2916,1574,72,53,125,57.6%,18m
18923,3,[PowOw]BeatMeGoPLat,2916,1017,72,68,140,51.4%,25m
18923,2,BonBon,2916,1456,70,48,118,59.3%,22m
18923,2,DarkTRade,2916,1136,60,33,93,64.5%,12m
18923,2,Lightning,2916,825,46,40,86,53.5%,11m
18923,2,[R4Time]Del,2916,803,33,25,58,56.9%,8m
18923,2,AlarAk,2916,386,32,28,60,53.3%,5m
18923,2,Alarion,2916,442,19,12,31,61.3%,16m
18923,2,[Pollas]FiveSeven,2916,483,18,18,36,50.0%,22m
18923,2,ЗлойФотончик,2916,279,11,7,18,61.1%,8m
18923,2,WertigoTO,2916,248,10,8,18,55.6%,22m
18923,2,HoBs,2916,185,8,7,15,53.3%,8m
18923,1,Sigom,2916,259,8,15,23,34.8%,19m
18923,1,Septimus,2916,194,7,5,12,58.3%,22m
18923,1,[ULIH]cSm,2916,48,6,4,10,60.0%,1h
18923,3,Aze,2916,192,6,7,13,46.2%,1h
18923,1,Рус,2916,0,5,2,7,71.4%,44m
18923,3,Shaa,2916,0,3,2,5,60.0%,21m
18923,3,Apocalipser,2916,88,3,4,7,42.9%,26m
18923,3,Viper,2916,30,2,0,2,100.0%,21m
18923,2,[3ky]Puffcio,2916,114,2,3,5,40.0%,23m
18923,1,EmciD,2916,64,2,10,12,16.7%,20m
18923,3,[TFS1]Googleplex,2916,0,1,0,1,100.0%,25m
18923,3,xxAdioSxx,2916,0,1,0,1,100.0%,13m
18923,2,xFlake,2916,0,1,3,4,25.0%,15m
18923,3,Alone,2916,0,0,1,1,0.0%,13m
18923,3,[Gruzim]trollhacker,2916,0,0,1,1,0.0%,9m
18923,3,[SKRRR]CaptainVane,2916,0,0,1,1,0.0%,19m
18953,1,dor,2915,818,31,36,67,46.3%,24m
18953,2,[DarkMM]shorbock,2915,515,23,14,37,62.2%,10m
18953,2,[TORI]TORIKING,2915,351,14,13,27,51.9%,20m
18953,2,GGZiiStreams,2915,128,6,5,11,54.5%,22m
18953,1,Syence,2915,134,5,9,14,35.7%,27m
18953,3,Ariel,2915,0,4,1,5,80.0%,21m
18953,2,ShhsEhd,2915,128,4,2,6,66.7%,8m
18953,2,[ДУРКА]kykymbanet,2915,118,4,2,6,66.7%,8m
18953,1,Benkal,2915,117,4,3,7,57.1%,1h
18953,3,[KDV]Katedra,2915,114,4,4,8,50.0%,16m
18953,3,sxmaster,2915,60,4,4,8,50.0%,8m
18953,3,LucifersVi,2915,0,3,2,5,60.0%,21m
18953,2,Вадим,2915,60,3,3,6,50.0%,25m
18953,2,СусликУбийца,2915,90,3,5,8,37.5%,18m
18953,3,[xP4Px]Suiba,2915,30,2,0,2,100.0%,20m
18953,2,hamouche,2915,58,2,5,7,28.6%,8m
18953,2,PerAspera,2915,62,2,6,8,25.0%,13m
18953,3,[HISSSS]Leafmeisterr,2915,0,1,1,2,50.0%,7m
18953,2,Iskhiaro,2915,0,1,2,3,33.3%,8m
18953,3,frozenhaert,2915,0,0,1,1,0.0%,25m
18953,3,[XGBX]XCVQY,2915,0,0,1,1,0.0%,16m
18953,3,Kyznec,2915,0,0,1,1,0.0%,22m
18953,2,Solar,2915,0,0,2,2,0.0%,4m
18953,2,Barm,2915,0,0,3,3,0.0%,24m
18977,3,[LEVATI]Maestral,2914,1526,473,454,927,51.0%,11m
18977,3,Bugalter,2914,1210,108,95,203,53.2%,8m
18977,1,[C0cks]harakiri,2914,1604,99,91,190,52.1%,11m
18977,2,[GG2020]Dragora,2914,1278,93,88,181,51.4%,16m
18977,2,[Cheems]yandere,2914,424,92,72,164,56.1%,26m
18977,2,Kelsier,2914,690,41,10,51,80.4%,11m
18977,2,Öööö,2914,996,41,32,73,56.2%,8m
18977,2,scahr,2914,831,38,31,69,55.1%,24m
18977,2,[GOPLS]laio,2914,822,33,32,65,50.8%,23m
18977,1,katalanu,2914,630,21,26,47,44.7%,4m
18977,3,[IIG]Armageddon,2914,431,20,8,28,71.4%,27m
18977,2,acernine,2914,426,16,17,33,48.5%,13m
18977,3,ElSe,2914,374,14,11,25,56.0%,21m
18977,2,Matej,2914,207,10,3,13,76.9%,4m
18977,3,BeatMeGoGold,2914,268,10,4,14,71.4%,4m
18977,3,[yayo]zhorikluv,2914,238,8,3,11,72.7%,21m
18977,2,[THMU]Colorise,2914,182,6,9,15,40.0%,11m
18977,3,kemars,2914,30,5,6,11,45.5%,9m
18977,3,IlGrandeBaka,2914,0,3,2,5,60.0%,25m
18977,3,nyan,2914,0,3,2,5,60.0%,7m
18977,2,[JINX]BiGBaDaBooM,2914,32,3,6,9,33.3%,13m
18977,1,[SMFC]StiflersMoM,2914,154,3,9,12,25.0%,25m
18977,2,YukaNomura,2914,48,2,3,5,40.0%,1h
18977,1,Gritch,2914,70,2,13,15,13.3%,4m
18977,3,AleXKross,2914,0,1,0,1,100.0%,22m
18977,3,BriO,2914,0,1,0,1,100.0%,21m
18977,3,trickyhunter,2914,0,1,0,1,100.0%,4m
18977,2,Executor,2914,30,1,4,5,20.0%,22m
18977,2,SaxaVolk,2914,30,1,4,5,20.0%,21m
18977,3,Wakabajaszi,2914,0,0,1,1,0.0%,11m
18977,3,BloodCloud,2914,0,0,1,1,0.0%,20m
18977,3,tuetenfrog,2914,0,0,1,1,0.0%,1h
18977,3,Snachter,2914,0,0,2,2,0.0%,17m
18977,2,Toxic,2914,0,0,2,2,0.0%,13m
19011,1,[Tigrus]Arcadeous,2913,1612,376,383,759,49.5%,8m
19011,2,[SPAINs]Thanan,2913,1489,105,99,204,51.5%,5m
19011,2,[Heroes]CrashDragon,2913,1366,95,70,165,57.6%,22m
19011,1,Patoche,2913,1066,54,57,111,48.6%,4m
19011,1,Energiy,2913,1066,41,45,86,47.7%,16m
19011,3,Agatha,2913,757,34,24,58,58.6%,11m
19011,2,Prophet,2913,700,30,22,52,57.7%,21m
19011,3,Opal,2913,736,28,20,48,58.3%,20m
19011,1,NQlto,2913,654,22,25,47,46.8%,13m
19011,2,teli,2913,512,18,21,39,46.2%,25m
19011,3,Primus,2913,291,14,12,26,53.8%,21m
19011,3,[SURR]Peachy,2913,296,14,15,29,48.3%,11m
19011,2,[GOCCM]IIIIIIIIIIII,2913,310,12,13,25,48.0%,11m
19011,3,[UF2AC]Falcram,2913,0,5,2,7,71.4%,45m
19011,3,SpursFan,2913,180,5,8,13,38.5%,4m
19011,1,[Zgeeg]JoeleBikou,2913,167,3,3,6,50.0%,8m
19011,1,Ace,2913,97,3,3,6,50.0%,22m
19011,1,SpaceRanger,2913,121,3,5,8,37.5%,11m
19011,1,DorianOne,2913,93,2,1,3,66.7%,1h
19011,2,john,2913,60,2,4,6,33.3%,8m
19011,3,[BaSpIn]DeusEx,2913,0,1,0,1,100.0%,24m
19011,1,mYself,2913,0,1,1,2,50.0%,39m
19011,1,Contumelia,2913,0,0,1,1,0.0%,22m
19011,2,jowl,2913,0,0,4,4,0.0%,13m
19035,1,[DINGS]YYZ,2912,1045,104,109,213,48.8%,5m
19035,1,thepicpowner,2912,924,90,92,182,49.5%,19m
19035,3,dumdum,2912,1382,83,61,144,57.6%,11m
19035,3,Shaggy,2912,1228,51,42,93,54.8%,21m
19035,2,hankdatank,2912,546,42,40,82,51.2%,21m
19035,2,Rhedone,2912,333,31,28,59,52.5%,15m
19035,2,Notaruseton,2912,719,30,26,56,53.6%,15m
19035,2,Van,2912,261,25,14,39,64.1%,4m
19035,2,[IDGaGa]CoWbOyBeEbOp,2912,695,24,27,51,47.1%,22m
19035,2,LiquidAdri,2912,666,24,28,52,46.2%,27m
19035,2,Tomasberkut,2912,551,22,17,39,56.4%,18m
19035,2,Cape,2912,564,20,22,42,47.6%,7m
19035,2,Womble,2912,427,18,10,28,64.3%,18m
19035,3,PinkiePie,2912,430,16,10,26,61.5%,10m
19035,3,[Ирбис]Цербер,2912,381,15,7,22,68.2%,24m
19035,2,MorpheusH,2912,391,15,18,33,45.5%,8m
19035,3,[NSJLM]Smidarok,2912,307,12,4,16,75.0%,27m
19035,1,lemon,2912,142,7,3,10,70.0%,1h
19035,3,Emmerson,2912,185,7,5,12,58.3%,25m
19035,1,Whiplash,2912,188,7,7,14,50.0%,14m
19035,2,slv,2912,169,6,4,10,60.0%,23m
19035,3,Stringset,2912,154,5,1,6,83.3%,4m
19035,3,ZyskuZM,2912,77,5,5,10,50.0%,15m
19035,1,ЛысыйBRAZERS,2912,97,4,2,6,66.7%,25m
19035,1,PotestNucis,2912,0,4,2,6,66.7%,4m
19035,2,Feras,2912,0,3,2,5,60.0%,1h
19035,1,vlad,2912,0,3,3,6,50.0%,1h
19035,3,[NAZBRO]EdY,2912,0,1,0,1,100.0%,22m
19035,3,[scspc]Logos,2912,0,1,0,1,100.0%,24m
19035,2,Plyrp,2912,0,1,0,1,100.0%,43m
19035,2,didntwakeup,2912,88,1,3,4,25.0%,18m
19035,2,[TheSwE]Bogs,2912,30,1,3,4,25.0%,22m
19035,1,HDjoffa,2912,0,1,5,6,16.7%,1h
19035,3,sphere,2912,0,0,1,1,0.0%,19m
19035,3,[MRCW]himsir,2912,0,0,1,1,0.0%,20m
19035,3,aiur,2912,0,0,1,1,0.0%,21m
19071,2,BezDnB,2911,767,154,143,297,51.9%,7m
19071,1,Dogi,2911,1579,104,100,204,51.0%,22m
19071,2,TOM,2911,1108,83,85,168,49.4%,13m
19071,2,Lifaen,2911,917,49,47,96,51.0%,25m
19071,2,Callum,2911,994,40,39,79,50.6%,13m
19071,2,[SLGH]IIIIIIIIIIII,2911,988,36,39,75,48.0%,12m
19071,2,DimaK,2911,583,23,20,43,53.5%,7m
19071,2,[OBY]shigeryu,2911,626,21,28,49,42.9%,12m
19071,3,[snowBY]Vosminojka,2911,469,19,15,34,55.9%,19m
19071,2,молли,2911,476,17,20,37,45.9%,23m
19071,3,RubiSIO,2911,332,11,6,17,64.7%,7m
19071,3,[LVswat]Faktorfak,2911,228,8,8,16,50.0%,9m
19071,2,Ilyadun,2911,249,8,8,16,50.0%,9m
19071,2,[Draft]aZZtec,2911,212,7,7,14,50.0%,25m
19071,3,rumax,2911,58,6,2,8,75.0%,22m
19071,2,Bazinga,2911,182,6,7,13,46.2%,4m
19071,3,KeuperMarlue,2911,117,5,2,7,71.4%,26m
19071,2,IIIIIIIIIIII,2911,143,5,3,8,62.5%,13m
19071,2,Danik,2911,166,5,4,9,55.6%,24m
19071,2,MUPOTBOP,2911,186,5,7,12,41.7%,7m
19071,1,Tobi,2911,97,4,2,6,66.7%,1h
19071,2,[MSUSC2]Tabiary,2911,154,4,3,7,57.1%,33m
19071,2,TupiTown,2911,0,3,2,5,60.0%,1h
19071,3,PinksCZ,2911,58,2,2,4,50.0%,21m
19071,2,[Bruk]МЕГАЛОК,2911,64,2,8,10,20.0%,9m
19071,2,HellBlazeR,2911,0,0,4,4,0.0%,27m
19097,2,Holyschism,2910,1326,242,227,469,51.6%,21m
19097,2,[CWGG]Dorkox,2910,701,39,33,72,54.2%,9m
19097,1,Adesman,2910,858,37,34,71,52.1%,27m
19097,2,Leandros,2910,308,27,19,46,58.7%,11m
19097,2,HunterKiller,2910,480,18,21,39,46.2%,8m
19097,2,[Navvy]Egon,2910,315,12,9,21,57.1%,1h
19097,1,Mattitrevi,2910,372,12,16,28,42.9%,20m
19097,3,Mikrosoft,2910,298,11,3,14,78.6%,13m
19097,1,Deniska,2910,267,10,6,16,62.5%,1h
19097,3,Horus,2910,283,9,4,13,69.2%,8m
19097,2,Han,2910,196,8,7,15,53.3%,7m
19097,2,Lolikuh,2910,204,7,5,12,58.3%,15m
19097,2,dOmInAtE,2910,154,5,2,7,71.4%,26m
19097,1,Nightmare,2910,116,4,3,7,57.1%,1h
19097,3,Vear,2910,0,3,1,4,75.0%,13m
19097,2,squideyboy,2910,0,3,2,5,60.0%,39m
19097,3,ohrmuzd,2910,30,2,0,2,100.0%,22m
19097,3,[яєѕ]JesuKristus,2910,60,2,3,5,40.0%,12m
19097,2,Puffball,2910,0,1,6,7,14.3%,38m
19097,2,HyppoX,2910,30,1,7,8,12.5%,8m
19097,3,DENTIS,2910,0,0,2,2,0.0%,17m
19118,1,EEEFDD,2909,859,676,674,1350,50.1%,18m
19118,1,sumduhee,2909,1631,148,153,301,49.2%,11m
19118,2,glhf,2909,1591,101,95,196,51.5%,25m
19118,1,JuJuUuBeEe,2909,1275,51,52,103,49.5%,16m
19118,2,Rabbit,2909,1140,41,47,88,46.6%,23m
19118,2,Yohxne,2909,950,40,34,74,54.1%,22m
19118,2,CBD,2909,782,32,28,60,53.3%,6m
19118,2,neadekva,2909,601,26,24,50,52.0%,5m
19118,3,MasterLordi,2909,443,16,9,25,64.0%,9m
19118,2,[N1TDA]erbol,2909,414,15,14,29,51.7%,4m
19118,2,HeinzGustaV,2909,374,15,16,31,48.4%,18m
19118,2,llllllllllll,2909,496,15,20,35,42.9%,4m
19118,3,TheFighter,2909,300,11,9,20,55.0%,14m
19118,3,Смертомышь,2909,264,9,10,19,47.4%,5m
19118,2,RBG,2909,220,9,11,20,45.0%,22m
19118,2,[GdAT]Legendk,2909,260,9,13,22,40.9%,8m
19118,3,roda,2909,149,7,3,10,70.0%,25m
19118,2,Toperz,2909,164,7,8,15,46.7%,13m
19118,1,Lunár,2909,166,7,9,16,43.8%,13m
19118,3,EugenE,2909,114,5,1,6,83.3%,19m
19118,2,СheeseMaster,2909,170,5,4,9,55.6%,4m
19118,1,Mrxray,2909,141,5,4,9,55.6%,1h
19118,1,Ilya,2909,0,3,3,6,50.0%,1h
19118,2,[HASME]DildoBeggins,2909,0,3,3,6,50.0%,18m
19118,1,МруКакМуха,2909,144,3,6,9,33.3%,1h
19118,2,Nicknamed,2909,66,3,7,10,30.0%,7m
19118,3,ThufirHawat,2909,0,1,1,2,50.0%,11m
19118,2,Caudate,2909,48,1,5,6,16.7%,43m
19118,2,Zephyrum,2909,30,1,6,7,14.3%,8m
19118,3,ScriptorisVI,2909,0,0,1,1,0.0%,18m
19118,3,Ktyz,2909,0,0,1,1,0.0%,10m
19118,3,[BoH]Kalzaar,2909,0,0,2,2,0.0%,4m
19150,2,Jim,2908,1515,274,266,540,50.7%,20m
19150,2,petr,2908,1389,179,172,351,51.0%,13m
19150,3,Leadership,2908,1615,108,99,207,52.2%,25m
19150,3,PlayForSalt,2908,941,69,46,115,60.0%,19m
19150,2,terminator,2908,657,67,60,127,52.8%,15m
19150,2,EntityZero,2908,1324,52,55,107,48.6%,11m
19150,2,Liod,2908,462,42,45,87,48.3%,17m
19150,2,lupinglui,2908,268,40,35,75,53.3%,12m
19150,2,ProTo,2908,360,25,22,47,53.2%,22m
19150,3,[Gionny]Kesh,2908,606,23,15,38,60.5%,14m
19150,3,edenett,2908,476,17,15,32,53.1%,13m
19150,3,Weave,2908,269,13,8,21,61.9%,21m
19150,3,DanDGT,2908,276,13,16,29,44.8%,4m
19150,2,MasterKWM,2908,264,12,5,17,70.6%,26m
19150,1,DEADREAM,2908,416,12,20,32,37.5%,4m
19150,1,Myreek,2908,97,4,3,7,57.1%,37m
19150,3,[Cruse]GodsFail,2908,30,4,3,7,57.1%,6m
19150,3,[ZERGTV]AndreyRork,2908,101,4,3,7,57.1%,19m
19150,2,[PDRFCE]WhiteSky,2908,164,4,5,9,44.4%,8m
19150,2,Mint,2908,0,3,2,5,60.0%,36m
19150,3,ucantouchme,2908,0,3,2,5,60.0%,23m
19150,2,[qip]БогМикро,2908,58,3,4,7,42.9%,24m
19150,3,[NoiS]EcII,2908,0,1,0,1,100.0%,9m
19150,3,Elektrolar,2908,0,1,0,1,100.0%,5m
19150,3,StepToSpace,2908,0,1,1,2,50.0%,10m
19150,2,[TaKeUL]Hirnspalter,2908,88,1,2,3,33.3%,12m
19150,3,craftwars,2908,0,0,1,1,0.0%,9m
19177,1,Spartacus,2907,1507,101,101,202,50.0%,26m
19177,2,ZaN,2907,712,46,39,85,54.1%,13m
19177,2,MasterBardo,2907,1144,45,40,85,52.9%,22m
19177,3,precisionist,2907,808,34,22,56,60.7%,8m
19177,3,Buro,2907,786,33,20,53,62.3%,13m
19177,2,Sabotage,2907,650,33,36,69,47.8%,25m
19177,3,Nize,2907,739,27,22,49,55.1%,18m
19177,1,laoczi,2907,749,27,27,54,50.0%,8m
19177,2,WorkoutSila,2907,423,18,16,34,52.9%,23m
19177,2,SOOOOHAPPY,2907,284,12,6,18,66.7%,15m
19177,1,Fudge,2907,420,12,18,30,40.0%,6m
19177,3,КуТуЗОВ,2907,324,11,5,16,68.8%,9m
19177,3,Sekz,2907,256,9,6,15,60.0%,20m
19177,2,Bullet,2907,244,9,12,21,42.9%,8m
19177,3,[DMTPN]BarakAfrites,2907,193,7,5,12,58.3%,24m
19177,3,SCSI,2907,177,6,1,7,85.7%,7m
19177,3,zeus,2907,158,6,6,12,50.0%,1h
19177,2,cherepaha,2907,158,6,10,16,37.5%,4m
19177,1,ArturMengsk,2907,48,4,4,8,50.0%,7m
19177,2,NanaKay,2907,120,4,8,12,33.3%,25m
19177,3,[Losyag]Kugel,2907,0,3,2,5,60.0%,6m
19177,2,ElestraGOD,2907,126,3,2,5,60.0%,46m
19177,2,Jolifleur,2907,0,3,2,5,60.0%,1h
19177,2,NaiLKrsK,2907,0,3,2,5,60.0%,19m
19177,2,[Pylo]RnRoger,2907,120,2,4,6,33.3%,13m
19177,3,WilliamX,2907,30,1,2,3,33.3%,18m
19177,3,Abra,2907,0,0,2,2,0.0%,22m
19177,2,Pharao,2907,0,0,3,3,0.0%,4m
19205,1,[POCCNR]Ceridan,2906,1423,156,155,311,50.2%,6m
19205,2,LaSaK,2906,1243,135,110,245,55.1%,16m
19205,1,AdunToridas,2906,1162,116,104,220,52.7%,25m
19205,1,[GROF]arxangellos,2906,1243,110,114,224,49.1%,19m
19205,1,Pstv,2906,927,100,91,191,52.4%,19m
19205,2,vezo,2906,772,98,94,192,51.0%,26m
19205,3,abce,2906,1628,97,68,165,58.8%,4m
19205,2,bioxzard,2906,1389,89,78,167,53.3%,3m
19205,2,SpaceCommand,2906,1187,52,50,102,51.0%,4m
19205,2,[Waknda]Delicious,2906,1033,46,37,83,55.4%,18m
19205,2,MiniNinja,2906,740,33,29,62,53.2%,11m
19205,1,deKoning,2906,619,33,44,77,42.9%,12m
19205,2,BillyTK,2906,477,23,16,39,59.0%,10m
19205,2,Schneider,2906,476,20,17,37,54.1%,27m
19205,1,KnightMares,2906,460,17,20,37,45.9%,13m
19205,2,Giannino,2906,410,14,15,29,48.3%,6m
19205,2,GagamelsRage,2906,297,12,6,18,66.7%,1h
19205,2,[FPu]PrikoL,2906,331,12,12,24,50.0%,14m
19205,3,HarryFader,2906,86,4,0,4,100.0%,19m
19205,3,metzo,2906,88,4,2,6,66.7%,17m
19205,2,sadasdasdasd,2906,0,3,2,5,60.0%,4m
19205,2,Amedrentar,2906,58,3,4,7,42.9%,15m
19205,3,IrinaBruno,2906,147,3,4,7,42.9%,17m
19205,3,gaintrain,2906,30,2,0,2,100.0%,9m
19205,3,Saber,2906,30,2,1,3,66.7%,18m
19205,2,LittleLion,2906,0,2,1,3,66.7%,40m
19205,2,[F4RM]Bastrupm,2906,102,2,3,5,40.0%,13m
19205,3,NannyState,2906,0,1,0,1,100.0%,26m
19205,3,[FAZE69]WøŁf,2906,0,1,0,1,100.0%,26m
19205,3,Lagger,2906,0,1,1,2,50.0%,20m
19205,3,SERAFIM,2906,0,1,2,3,33.3%,46m
19205,2,Spykeri,2906,0,1,4,5,20.0%,11m
19205,3,[HotL]Merluche,2906,0,0,1,1,0.0%,5m
19205,3,shadowStorm,2906,0,0,1,1,0.0%,27m
19205,3,Nemesis,2906,0,0,1,1,0.0%,8m
19205,3,Sharpe,2906,0,0,1,1,0.0%,9m
19205,3,Future,2906,0,0,1,1,0.0%,21m
19205,3,Kosmo,2906,0,0,2,2,0.0%,17m
19205,3,alf,2906,0,0,2,2,0.0%,21m
19205,2,[DEDOC]vzlomblch,2906,0,0,5,5,0.0%,25m
19245,3,Ivan,2905,1412,168,184,352,47.7%,8m
19245,1,llllllllll,2905,461,49,43,92,53.3%,19m
19245,2,Malus,2905,639,37,36,73,50.7%,8m
19245,2,out,2905,674,30,25,55,54.5%,27m
19245,2,Cyprien,2905,623,30,28,58,51.7%,11m
19245,2,ElPoutros,2905,560,21,21,42,50.0%,20m
19245,1,BKG,2905,257,16,16,32,50.0%,14m
19245,2,Alvy,2905,344,15,14,29,51.7%,9m
19245,3,[Terraz]KojotGT,2905,290,12,13,25,48.0%,8m
19245,1,Eljy,2905,150,7,7,14,50.0%,22m
19245,2,Sarkozy,2905,132,7,14,21,33.3%,47m
19245,2,Mirthas,2905,60,6,4,10,60.0%,8m
19245,2,DoctorWho,2905,184,6,5,11,54.5%,9m
19245,2,Raoth,2905,152,6,8,14,42.9%,13m
19245,1,Ashiroftw,2905,96,5,5,10,50.0%,18m
19245,3,RamzesXIII,2905,124,5,5,10,50.0%,13m
19245,3,[CocoCo]ProxyEbay,2905,60,3,1,4,75.0%,14m
19245,2,[ThDaLe]Dravos,2905,0,3,2,5,60.0%,21m
19245,3,[YRU]Cephei,2905,0,3,2,5,60.0%,22m
19245,3,zyma,2905,0,3,2,5,60.0%,16m
19245,1,[Silvеr]packman,2905,119,3,4,7,42.9%,19m
19245,2,IslanderJohn,2905,80,3,11,14,21.4%,18m
19245,3,giannis,2905,58,2,2,4,50.0%,17m
19245,3,Jacob,2905,58,2,2,4,50.0%,21m
19245,3,ounielcz,2905,0,2,3,5,40.0%,22m
19245,3,SmirnOFF,2905,0,1,0,1,100.0%,18m
19245,3,[Negas]leesyCZ,2905,0,1,1,2,50.0%,14m
19245,3,Lineker,2905,0,1,1,2,50.0%,23m
19245,2,Demetrio,2905,40,1,4,5,20.0%,7m
19245,3,[PNH]Yamateh,2905,0,0,1,1,0.0%,27m
19245,3,Shalopay,2905,0,0,1,1,0.0%,22m
19245,2,Berkay,2905,0,0,4,4,0.0%,8m
19277,3,Michavangaal,2904,1625,217,208,425,51.1%,10m
19277,3,Miho,2904,950,117,106,223,52.5%,10m
19277,2,Yama,2904,1285,67,61,128,52.3%,8m
19277,2,Naktul,2904,1505,62,58,120,51.7%,8m
19277,2,[CREPES]Guideuz,2904,1244,61,57,118,51.7%,19m
19277,2,Tomoe,2904,461,54,49,103,52.4%,5m
19277,3,[VoxX]VoxMorituri,2904,1205,49,38,87,56.3%,23m
19277,3,[RTW]FedeLama,2904,513,42,22,64,65.6%,21m
19277,1,DanDare,2904,716,41,40,81,50.6%,19m
19277,2,HotLULU,2904,794,32,35,67,47.8%,15m
19277,2,inoxia,2904,662,29,25,54,53.7%,5m
19277,2,FuriousDuck,2904,642,28,30,58,48.3%,26m
19277,2,[Encule]elgropadbras,2904,508,23,19,42,54.8%,11m
19277,2,[TaMort]IIIIIIIIIIII,2904,473,19,15,34,55.9%,11m
19277,1,Seb,2904,453,18,18,36,50.0%,13m
19277,3,Spawn,2904,432,15,16,31,48.4%,18m
19277,3,Rocinante,2904,166,7,1,8,87.5%,24m
19277,3,Liara,2904,142,5,4,9,55.6%,18m
19277,1,electroninja,2904,88,4,4,8,50.0%,10m
19277,3,[Fxnadu]Harfang,2904,112,3,0,3,100.0%,18m
19277,3,Tik,2904,58,3,0,3,100.0%,22m
19277,2,HagenSmL,2904,0,3,2,5,60.0%,1h
19277,2,[ISSOVA]sokarage,2904,0,3,2,5,60.0%,37m
19277,2,SONOFGODS,2904,0,3,2,5,60.0%,13m
19277,1,[BAGETE]killeraxx,2904,97,3,3,6,50.0%,11m
19277,2,darki,2904,0,3,3,6,50.0%,11m
19277,3,letmeplay,2904,0,3,5,8,37.5%,4m
19277,2,RizeN,2904,96,3,9,12,25.0%,22m
19277,3,nels,2904,30,2,0,2,100.0%,22m
19277,3,Ralos,2904,0,2,2,4,50.0%,23m
19277,2,[spaks]hoops,2904,48,1,1,2,50.0%,1h
19277,3,Secretrois,2904,97,1,2,3,33.3%,4m
19277,2,Noob,2904,30,1,5,6,16.7%,16m
19277,3,TusensDUDU,2904,0,0,1,1,0.0%,24m
19277,3,[Askvar]LordSocar,2904,0,0,1,1,0.0%,4m
19277,3,CroEtnA,2904,0,0,1,1,0.0%,27m
19277,2,LeDouche,2904,0,0,3,3,0.0%,22m
19314,2,blabla,2903,1555,170,145,315,54.0%,5m
19314,2,Lemyrka,2903,1142,147,131,278,52.9%,15m
19314,2,powwow,2903,1536,104,95,199,52.3%,19m
19314,2,eKen,2903,793,55,57,112,49.1%,7m
19314,2,Sulfuriun,2903,840,50,39,89,56.2%,24m
19314,2,FumbleDaffoe,2903,1133,47,42,89,52.8%,24m
19314,2,QuickAnice,2903,814,35,31,66,53.0%,18m
19314,2,JLG,2903,655,28,20,48,58.3%,4m
19314,2,titanix,2903,612,25,21,46,54.3%,15m
19314,2,[daktnt]mrtnt,2903,539,23,17,40,57.5%,18m
19314,2,Rex,2903,533,22,21,43,51.2%,4m
19314,3,Archerz,2903,540,20,17,37,54.1%,24m
19314,2,meDOWN,2903,482,16,17,33,48.5%,11m
19314,2,sQoooop,2903,347,13,17,30,43.3%,14m
19314,1,deMirt,2903,233,8,3,11,72.7%,35m
19314,2,Stakerrt,2903,195,7,5,12,58.3%,10m
19314,2,ARXONT,2903,196,7,6,13,53.8%,4m
19314,1,Stark,2903,119,5,4,9,55.6%,37m
19314,3,Hoody,2903,86,3,4,7,42.9%,27m
19314,2,[mfxed]Mitico,2903,0,2,3,5,40.0%,25m
19314,2,Raziel,2903,30,2,3,5,40.0%,19m
19314,2,Latrommi,2903,30,2,8,10,20.0%,10m
19314,3,DeDmopoЗ,2903,0,1,0,1,100.0%,21m
19314,3,lwieserce,2903,0,1,0,1,100.0%,13m
19314,3,YeetoBandito,2903,0,1,0,1,100.0%,20m
19314,3,LIDO,2903,30,1,1,2,50.0%,24m
19314,3,[Cykabl]CarM,2903,30,1,2,3,33.3%,13m
19314,2,Yaya,2903,0,1,6,7,14.3%,13m
19314,3,Arelop,2903,0,0,1,1,0.0%,12m
19314,2,ZealotZac,2903,0,0,3,3,0.0%,15m
19344,2,[PowOw]Julik,2902,1574,221,192,413,53.5%,4m
19344,3,GhostUA,2902,1528,79,65,144,54.9%,14m
19344,1,Rymygo,2902,1027,40,40,80,50.0%,7m
19344,2,DaDDy,2902,840,39,37,76,51.3%,6m
19344,3,[NWGD]Dopy,2902,214,33,28,61,54.1%,20m
19344,2,PromeTheus,2902,263,19,18,37,51.4%,8m
19344,2,spacechinees,2902,398,14,15,29,48.3%,21m
19344,2,SexxyLove,2902,302,11,9,20,55.0%,19m
19344,3,Lautstark,2902,233,9,8,17,52.9%,33m
19344,1,Maverik,2902,260,8,5,13,61.5%,1h
19344,2,HrSpEgEpØlSe,2902,276,8,10,18,44.4%,4m
19344,2,Niels,2902,240,8,10,18,44.4%,19m
19344,3,glhfTWOall,2902,170,7,3,10,70.0%,21m
19344,3,EvolutioN,2902,72,6,7,13,46.2%,14m
19344,2,SDS,2902,88,5,2,7,71.4%,21m
19344,1,Eugene,2902,97,5,3,8,62.5%,19m
19344,2,Isbergaren,2902,48,4,3,7,57.1%,19m
19344,2,rimon,2902,114,3,2,5,60.0%,14m
19344,2,TerranUnit,2902,0,3,2,5,60.0%,1h
19344,2,Нагибатор,2902,58,3,5,8,37.5%,21m
19344,3,LastChance,2902,58,2,2,4,50.0%,21m
19344,3,RandomWeirdo,2902,30,2,2,4,50.0%,15m
19344,2,ttdffhbb,2902,90,2,2,4,50.0%,1h
19344,3,XorisOnoma,2902,0,2,3,5,40.0%,4m
19344,3,Omega,2902,0,2,3,5,40.0%,15m
19344,2,kWarta,2902,112,2,4,6,33.3%,13m
19344,3,qwoiqwa,2902,0,1,0,1,100.0%,10m
19344,1,Ktulhe,2902,0,1,0,1,100.0%,1h
19344,2,[Prox]Óptimus,2902,30,1,5,6,16.7%,26m
19344,2,Daemone,2902,0,0,1,1,0.0%,4m
19344,3,Alex,2902,0,0,1,1,0.0%,22m
19344,3,DrDestroyer,2902,0,0,1,1,0.0%,22m
19344,1,ZAK,2902,0,0,1,1,0.0%,1h
19344,3,changhav,2902,0,0,2,2,0.0%,11m
19378,2,brans,2901,1259,218,207,425,51.3%,18m
19378,2,[SPAINs]Agnos,2901,1556,205,168,373,55.0%,9m
19378,2,flowthi,2901,1489,203,185,388,52.3%,25m
19378,2,Tal,2901,1118,78,80,158,49.4%,9m
19378,2,Ambiguously,2901,635,76,68,144,52.8%,9m
19378,3,mishmish,2901,1298,71,56,127,55.9%,22m
19378,2,Eljot,2901,971,58,51,109,53.2%,6m
19378,2,Holzken,2901,666,25,27,52,48.1%,9m
19378,3,NikoN,2901,616,24,17,41,58.5%,20m
19378,3,BlackEgg,2901,503,21,9,30,70.0%,9m
19378,2,goose,2901,236,20,15,35,57.1%,7m
19378,2,IoIoIoI,2901,341,15,11,26,57.7%,4m
19378,2,Woltube,2901,305,13,10,23,56.5%,4m
19378,2,[ZERGTV]qzmitch,2901,343,11,12,23,47.8%,9m
19378,2,[QMnewb]Gringotseru,2901,240,9,13,22,40.9%,4m
19378,3,Carma,2901,215,8,2,10,80.0%,1h
19378,1,TheSUN,2901,239,7,4,11,63.6%,34m
19378,1,Papalamus,2901,244,7,8,15,46.7%,23m
19378,3,[ZhMi]Rostik,2901,204,6,5,11,54.5%,20m
19378,3,SodianRay,2901,163,5,3,8,62.5%,11m
19378,2,Dantessss,2901,128,4,3,7,57.1%,9m
19378,2,aavado,2901,120,4,11,15,26.7%,13m
19378,3,kohli,2901,0,3,2,5,60.0%,27m
19378,3,Raicus,2901,60,3,2,5,60.0%,9m
19378,2,Timbi,2901,0,3,2,5,60.0%,1h
19378,3,vShvartz,2901,30,3,3,6,50.0%,10m
19378,1,SSgtGrimes,2901,0,3,3,6,50.0%,14m
19378,2,Penguin,2901,62,3,6,9,33.3%,9m
19378,1,Shareni,2901,95,2,1,3,66.7%,1h
19378,2,Расколбас,2901,70,2,37,39,5.1%,7m
19378,3,ъкхь,2901,0,1,0,1,100.0%,10m
19378,2,Twinsane,2901,0,1,1,2,50.0%,28m
19378,3,DoDo,2901,0,0,1,1,0.0%,11m
19378,3,Johan,2901,0,0,1,1,0.0%,9m
19378,3,IIIIIIIIIIII,2901,0,0,1,1,0.0%,21m
19378,2,Acheron,2901,0,0,1,1,0.0%,1h
19414,2,[ZЕRGТV]heave,2900,1391,115,99,214,53.7%,18m
19414,2,Kietai,2900,1621,69,70,139,49.6%,16m
19414,3,Illusion,2900,516,48,42,90,53.3%,7m
19414,3,[BUNZ]Drenicite,2900,760,36,30,66,54.5%,18m
19414,3,TheLord,2900,331,34,30,64,53.1%,10m
19414,3,DelArco,2900,699,31,19,50,62.0%,6m
19414,2,[wiGGa]DmyTraG,2900,656,28,27,55,50.9%,4m
19414,2,Felix,2900,346,21,20,41,51.2%,21m
19414,2,GeorgievK,2900,499,19,20,39,48.7%,24m
19414,3,etcfish,2900,376,17,10,27,63.0%,18m
19414,3,Norman,2900,363,15,13,28,53.6%,11m
19414,1,[QTclub]Rey,2900,437,14,17,31,45.2%,9m
19414,2,Lum,2900,314,12,14,26,46.2%,27m
19414,2,[Hrr]Singer,2900,312,11,10,21,52.4%,5m
19414,2,NoliP,2900,249,10,8,18,55.6%,13m
19414,3,[TeamBL]Monari,2900,223,9,6,15,60.0%,1h
19414,3,standvic,2900,254,9,7,16,56.2%,4m
19414,3,Kiko,2900,148,6,4,10,60.0%,27m
19414,1,[THfS]Micelna,2900,144,6,6,12,50.0%,25m
19414,1,Kolas,2900,191,6,10,16,37.5%,24m
19414,2,[Medaed]Wiseacre,2900,91,2,1,3,66.7%,44m
19414,2,OFYA,2900,30,2,3,5,40.0%,17m
19414,2,Sogora,2900,0,1,0,1,100.0%,39m
19414,3,gautgoth,2900,30,1,2,3,33.3%,24m
19414,2,Salamander,2900,30,1,3,4,25.0%,24m
19414,3,feDOs,2900,0,1,4,5,20.0%,21m
19414,3,Gamsu,2900,0,0,1,1,0.0%,13m
19414,1,Flo,2900,0,0,1,1,0.0%,9m
19414,1,SuedO,2900,0,0,4,4,0.0%,25m
19443,1,Thedirtycat,2899,775,56,61,117,47.9%,22m
19443,3,CarolusRex,2899,984,38,34,72,52.8%,15m
19443,2,AlleXz,2899,846,37,33,70,52.9%,18m
19443,1,IntrinsiCat,2899,615,28,28,56,50.0%,9m
19443,3,Starklim,2899,600,23,16,39,59.0%,8m
19443,3,[uCHAD]dvsealwasl,2899,543,22,13,35,62.9%,21m
19443,2,Thoth,2899,406,15,18,33,45.5%,7m
19443,3,[Hybrid]WWSativa,2899,294,11,8,19,57.9%,11m
19443,3,BOOMcap,2899,256,9,8,17,52.9%,18m
19443,2,AmiGO,2899,162,8,5,13,61.5%,14m
19443,3,Shinrei,2899,183,7,5,12,58.3%,16m
19443,3,Nikitka,2899,118,5,2,7,71.4%,25m
19443,2,MapleJoe,2899,118,5,8,13,38.5%,27m
19443,3,easy,2899,0,4,4,8,50.0%,9m
19443,3,Hippo,2899,0,3,2,5,60.0%,22m
19443,2,Chess,2899,0,3,3,6,50.0%,11m
19443,2,Weeret,2899,90,3,8,11,27.3%,22m
19443,3,SeriousVin,2899,30,2,0,2,100.0%,22m
19443,2,pixi,2899,46,2,2,4,50.0%,43m
19443,2,PaKe,2899,107,2,4,6,33.3%,8m
19443,3,smm,2899,0,1,0,1,100.0%,22m
19443,2,Coooooo,2899,0,1,1,2,50.0%,19m
19443,3,Lizergin,2899,30,1,1,2,50.0%,15m
19443,3,AHS,2899,0,0,1,1,0.0%,21m
19443,3,Mallons,2899,0,0,1,1,0.0%,22m
19443,3,MAX,2899,0,0,2,2,0.0%,24m
19469,3,dirtyoetker,2898,1448,173,165,338,51.2%,17m
19469,3,macan,2898,1474,141,134,275,51.3%,4m
19469,3,MéDé,2898,722,49,43,92,53.3%,11m
19469,2,haggz,2898,1202,47,46,93,50.5%,24m
19469,2,Reayman,2898,893,46,33,79,58.2%,11m
19469,1,WhiteRaven,2898,782,44,51,95,46.3%,8m
19469,1,Lentus,2898,893,36,42,78,46.2%,5m
19469,3,AlexEgiI,2898,574,26,10,36,72.2%,21m
19469,2,Loki,2898,338,24,25,49,49.0%,15m
19469,3,[4SID]Respekt,2898,488,20,8,28,71.4%,18m
19469,2,[OBT]YANN,2898,387,18,10,28,64.3%,11m
19469,2,Skatik,2898,428,18,13,31,58.1%,8m
19469,2,rinner,2898,474,16,23,39,41.0%,21m
19469,2,[TOUCAN]FunkyDrood,2898,355,13,14,27,48.1%,15m
19469,2,MCfermentpik,2898,237,9,6,15,60.0%,47m
19469,1,Василарос,2898,207,9,7,16,56.2%,10m
19469,3,[Stary]Novan,2898,165,7,4,11,63.6%,32m
19469,2,mtoom,2898,252,7,11,18,38.9%,9m
19469,3,FinderSL,2898,90,4,4,8,50.0%,17m
19469,3,HenryFloof,2898,30,2,0,2,100.0%,19m
19469,2,Nirrot,2898,30,2,4,6,33.3%,9m
19469,3,[DarS]Ashka,2898,0,1,0,1,100.0%,9m
19469,1,totalbanal,2898,97,1,2,3,33.3%,46m
19469,1,kesha,2898,0,1,4,5,20.0%,22m
19469,2,[SEC31]Cryscha,2898,30,1,5,6,16.7%,6m
19469,3,Borres,2898,0,0,1,1,0.0%,11m
19469,3,PaxRoft,2898,0,0,1,1,0.0%,13m
19469,1,Orbitalforce,2898,0,0,1,1,0.0%,41m
19469,2,[EliteX]Milan,2898,0,0,7,7,0.0%,6m
19498,1,[S3ise]Sorin,2897,1622,419,401,820,51.1%,4m
19498,2,[1NFEC7]Guyver,2897,1609,279,285,564,49.5%,18m
19498,3,ElendX,2897,1582,155,139,294,52.7%,11m
19498,2,pussyeater,2897,1003,106,93,199,53.3%,21m
19498,3,[SakAtk]Hypercondor,2897,529,38,30,68,55.9%,18m
19498,2,Webghost,2897,708,31,24,55,56.4%,9m
19498,2,DrahCir,2897,427,20,21,41,48.8%,21m
19498,2,Semmelbrot,2897,299,16,19,35,45.7%,21m
19498,2,Ansvider,2897,303,14,12,26,53.8%,16m
19498,2,Ranzbock,2897,255,13,9,22,59.1%,9m
19498,1,Roel,2897,246,10,9,19,52.6%,16m
19498,3,bumbar,2897,282,9,4,13,69.2%,9m
19498,3,[sunz]xXsunzXx,2897,261,8,4,12,66.7%,11m
19498,2,Vendetta,2897,197,8,9,17,47.1%,29m
19498,3,NeZoX,2897,120,5,3,8,62.5%,22m
19498,2,scifighter,2897,146,5,7,12,41.7%,22m
19498,3,XcoZonX,2897,0,4,1,5,80.0%,5m
19498,3,[FYBF]Archstefesis,2897,120,3,1,4,75.0%,21m
19498,3,Maniolo,2897,146,3,2,5,60.0%,28m
19498,2,Cyberpunko,2897,78,3,6,9,33.3%,13m
19498,3,Banavar,2897,30,2,0,2,100.0%,25m
19498,3,Aspanovich,2897,30,2,0,2,100.0%,17m
19498,3,eXi,2897,58,2,1,3,66.7%,20m
19498,3,Sagtur,2897,118,2,1,3,66.7%,27m
19498,2,Нил,2897,88,2,1,3,66.7%,9m
19498,3,VitaZerg,2897,60,2,3,5,40.0%,24m
19498,3,Nduja,2897,0,0,1,1,0.0%,5m
19498,1,Gavin,2897,0,0,1,1,0.0%,11m
19498,3,[SCDX]skorpy,2897,0,0,2,2,0.0%,25m
19498,1,Kranas,2897,0,0,6,6,0.0%,28m
19528,1,Gonewal,2896,1566,427,413,840,50.8%,19m
19528,1,jude,2896,1598,192,192,384,50.0%,16m
19528,1,Wynand,2896,1603,161,148,309,52.1%,24m
19528,2,lilas,2896,1610,154,150,304,50.7%,18m
19528,2,johnakis,2896,419,77,52,129,59.7%,9m
19528,3,XAMCTEP,2896,671,49,39,88,55.7%,21m
19528,2,Arna,2896,596,41,29,70,58.6%,9m
19528,2,[4Hacks]xXTechnisXx,2896,805,34,34,68,50.0%,6m
19528,3,[iSport]Kwaśny,2896,557,26,10,36,72.2%,24m
19528,2,Megalomania,2896,578,23,22,45,51.1%,17m
19528,3,eKata,2896,493,19,13,32,59.4%,7m
19528,3,igetthebag,2896,156,17,14,31,54.8%,11m
19528,3,[NLTN]Berserker,2896,432,16,13,29,55.2%,7m
19528,2,cLeric,2896,233,10,9,19,52.6%,25m
19528,3,Spider,2896,206,8,4,12,66.7%,13m
19528,2,[SBV]Athtors,2896,186,7,7,14,50.0%,38m
19528,2,RaGe,2896,164,7,7,14,50.0%,14m
19528,2,[ÄoB]drofus,2896,118,5,6,11,45.5%,7m
19528,2,[STG10]Tapeforlami,2896,0,4,2,6,66.7%,6m
19528,2,[аyе]yaloxx,2896,0,3,2,5,60.0%,36m
19528,1,CoRtEZz,2896,0,3,3,6,50.0%,29m
19528,2,Comet,2896,0,2,0,2,100.0%,7m
19528,1,[P0P0]ShinZun,2896,110,2,2,4,50.0%,1h
19528,2,[R4Time]Sly,2896,102,2,2,4,50.0%,9m
19528,2,ManTotters,2896,30,2,3,5,40.0%,5m
19528,1,Mogg,2896,0,1,1,2,50.0%,1h
19528,3,[Y8U]Jogarcg,2896,30,1,2,3,33.3%,24m
19528,3,MyMom,2896,30,1,3,4,25.0%,22m
19528,3,danik,2896,0,0,1,1,0.0%,17m
19528,3,[HngKng]SAAB,2896,0,0,1,1,0.0%,16m
19528,1,panich,2896,0,0,1,1,0.0%,7m
19528,3,thirteen,2896,0,0,2,2,0.0%,11m
19528,2,[Clnm]Faaron,2896,0,0,3,3,0.0%,12m
19528,2,Mortal,2896,0,0,5,5,0.0%,41m
19562,3,veto,2895,1520,223,224,447,49.9%,24m
19562,2,Broze,2895,1437,126,118,244,51.6%,6m
19562,3,Lakal,2895,1615,123,106,229,53.7%,4m
19562,2,CORONAVR,2895,1532,103,91,194,53.1%,8m
19562,2,Wolf,2895,1545,82,77,159,51.6%,5m
19562,2,Conundrumz,2895,1363,55,51,106,51.9%,17m
19562,2,Nojokster,2895,663,39,38,77,50.6%,18m
19562,1,Rais,2895,643,35,38,73,47.9%,22m
19562,3,[tMnrd]SevenEfFive,2895,691,33,14,47,70.2%,7m
19562,3,Barracuda,2895,176,23,24,47,48.9%,20m
19562,3,Underbot,2895,528,21,18,39,53.8%,22m
19562,3,[S0Y]MalaNeve,2895,445,18,12,30,60.0%,21m
19562,2,LurryFan,2895,425,17,10,27,63.0%,15m
19562,3,Dom,2895,211,17,13,30,56.7%,12m
19562,1,[RBadB]Thieum,2895,382,11,20,31,35.5%,21m
19562,1,Aquitainus,2895,186,8,12,20,40.0%,24m
19562,2,Crucible,2895,192,8,21,29,27.6%,10m
19562,2,Winner,2895,179,7,4,11,63.6%,13m
19562,1,polakziomek,2895,237,7,5,12,58.3%,38m
19562,2,badarty,2895,128,5,9,14,35.7%,8m
19562,3,Psychopath,2895,116,4,4,8,50.0%,17m
19562,3,[Ewaldi]Dico,2895,144,4,4,8,50.0%,25m
19562,3,KoViSaK,2895,58,3,0,3,100.0%,10m
19562,2,BaZinga,2895,86,3,8,11,27.3%,7m
19562,2,Breezy,2895,30,2,3,5,40.0%,14m
19562,3,ketoumymy,2895,30,2,5,7,28.6%,11m
19562,2,Otzako,2895,60,2,6,8,25.0%,13m
19562,1,Dielindan,2895,40,2,9,11,18.2%,27m
19562,3,Bati,2895,0,1,0,1,100.0%,6m
19562,2,HgKiLL,2895,0,1,3,4,25.0%,10m
19562,3,RacoD,2895,0,0,1,1,0.0%,23m
19593,2,EmuOcelot,2894,1388,109,106,215,50.7%,11m
19593,1,MarineChien,2894,622,78,71,149,52.3%,17m
19593,2,DAVINY,2894,767,40,41,81,49.4%,19m
19593,2,[DADDYS]MineralMaker,2894,937,37,40,77,48.1%,5m
19593,2,Pitfall,2894,409,35,19,54,64.8%,4m
19593,3,cdecl,2894,858,34,34,68,50.0%,14m
19593,2,[Petrus]louma,2894,320,21,17,38,55.3%,12m
19593,3,[HighP]KingdomPower,2894,503,20,16,36,55.6%,24m
19593,3,DVN,2894,464,17,16,33,51.5%,13m
19593,2,Majord,2894,328,14,13,27,51.9%,15m
19593,3,CromONE,2894,336,12,10,22,54.5%,12m
19593,2,WeebDesigner,2894,156,12,15,27,44.4%,14m
19593,1,yogosuma,2894,240,8,15,23,34.8%,21m
19593,3,[2001xD]Dreack,2894,168,7,3,10,70.0%,8m
19593,2,AGenericUser,2894,154,6,11,17,35.3%,5m
19593,2,MassCI,2894,48,5,2,7,71.4%,46m
19593,3,fonKurs,2894,86,4,0,4,100.0%,18m
19593,3,[BaSs]blackhole,2894,0,4,1,5,80.0%,13m
19593,3,Chobanin,2894,0,3,2,5,60.0%,27m
19593,3,haKsio,2894,0,3,2,5,60.0%,22m
19593,3,Jolie,2894,0,3,2,5,60.0%,21m
19593,1,Chimerde,2894,0,3,3,6,50.0%,28m
19593,2,[ElegoS]SkyKeeper,2894,126,3,4,7,42.9%,11m
19593,2,whiterabbit,2894,126,3,5,8,37.5%,14m
19593,2,AndiTOP,2894,58,3,5,8,37.5%,19m
19593,3,[JuPavu]Perdoon,2894,0,1,0,1,100.0%,21m
19593,3,Timur,2894,0,1,0,1,100.0%,4m
19593,2,ovi,2894,30,1,6,7,14.3%,10m
19593,3,LetsDoItQuik,2894,0,0,1,1,0.0%,18m
19593,2,[MAKinG]Swift,2894,0,0,4,4,0.0%,13m
19623,1,[BVE]Eater,2893,1590,242,228,470,51.5%,20m
19623,1,zorb,2893,1105,94,95,189,49.7%,5m
19623,3,HammerPAE,2893,1343,61,51,112,54.5%,12m
19623,2,SuperPower,2893,972,44,31,75,58.7%,10m
19623,3,Orix,2893,705,35,27,62,56.5%,16m
19623,2,Prusias,2893,769,32,25,57,56.1%,21m
19623,3,BulletMagnet,2893,524,20,12,32,62.5%,14m
19623,3,[FIXi]Папус,2893,404,18,13,31,58.1%,11m
19623,2,INFEST,2893,449,18,18,36,50.0%,8m
19623,3,DSh,2893,304,16,11,27,59.3%,22m
19623,2,qoobic,2893,402,15,14,29,51.7%,22m
19623,3,aabby,2893,343,12,8,20,60.0%,2m
19623,1,DAgo,2893,247,12,11,23,52.2%,1h
19623,2,LeSteak,2893,362,11,20,31,35.5%,4m
19623,3,ZIF,2893,228,9,1,10,90.0%,11m
19623,3,Roarshark,2893,247,9,6,15,60.0%,1h
19623,3,NoWafflz,2893,189,8,6,14,57.1%,29m
19623,2,Makai,2893,206,7,11,18,38.9%,4m
19623,1,Runich,2893,202,6,9,15,40.0%,37m
19623,1,Rocket,2893,120,4,3,7,57.1%,1h
19623,2,Erkelyoss,2893,0,3,2,5,60.0%,19m
19623,1,Asteroid,2893,0,3,3,6,50.0%,34m
19623,2,salivan,2893,117,3,5,8,37.5%,39m
19623,3,[THANOS]Johnry,2893,30,2,0,2,100.0%,16m
19623,3,[RSPCT3]Spring,2893,30,2,0,2,100.0%,2m
19623,2,chedel,2893,30,2,4,6,33.3%,14m
19623,3,AnthonyGrey,2893,0,1,0,1,100.0%,9m
19623,3,Stormblood,2893,0,0,1,1,0.0%,13m
19623,3,XvaT,2893,0,0,1,1,0.0%,6m
19623,3,AeRious,2893,0,0,2,2,0.0%,7m
19623,2,Twinsen,2893,0,0,3,3,0.0%,17m
19654,1,aaa,2892,1556,206,198,404,51.0%,6m
19654,3,sheinweng,2892,1621,184,162,346,53.2%,1m
19654,1,HeYYo,2892,1339,125,106,231,54.1%,1m
19654,2,voidray,2892,1492,67,73,140,47.9%,21m
19654,1,NBdestorm,2892,692,55,57,112,49.1%,6m
19654,2,TerlKabot,2892,884,42,34,76,55.3%,20m
19654,2,NYO,2892,865,34,34,68,50.0%,19m
19654,3,Folken,2892,635,33,16,49,67.3%,20m
19654,2,ЛилЧича,2892,582,27,18,45,60.0%,3m
19654,2,Efire,2892,604,23,26,49,46.9%,5m
19654,3,[eli]Adam,2892,466,17,13,30,56.7%,12m
19654,1,Hipikay,2892,410,17,18,35,48.6%,10m
19654,2,Orionstar,2892,419,17,23,40,42.5%,2m
19654,2,[Dawrye]roudolphm,2892,412,14,19,33,42.4%,6m
19654,2,sin,2892,346,12,16,28,42.9%,8m
19654,3,NoobSCII,2892,344,11,12,23,47.8%,21m
19654,3,TotalCreep,2892,263,9,2,11,81.8%,13m
19654,2,[STAFI]Nekokolen,2892,172,6,6,12,50.0%,3m
19654,3,[TиCo]RedDotOnMap,2892,90,4,3,7,57.1%,10m
19654,3,[SUCELA]Neuran,2892,58,4,3,7,57.1%,4m
19654,2,Нубас,2892,46,3,1,4,75.0%,16m
19654,3,JeRm,2892,0,3,2,5,60.0%,1m
19654,1,RageDemons,2892,0,3,3,6,50.0%,1h
19654,1,Kyokushin,2892,0,3,5,8,37.5%,21m
19654,2,woody,2892,62,3,9,12,25.0%,17m
19654,3,Coach,2892,95,2,1,3,66.7%,13m
19654,3,[HudraD]Omegon,2892,30,2,1,3,66.7%,1m
19654,2,OVERLORDIK,2892,48,2,4,6,33.3%,28m
19654,3,Kermit,2892,30,1,2,3,33.3%,10m
19654,2,[CLMOB]Archijevny,2892,0,1,3,4,25.0%,1h
19654,2,Alocer,2892,30,1,5,6,16.7%,20m
19654,3,Shirogane,2892,0,0,1,1,0.0%,6m
19654,3,Zyctra,2892,0,0,2,2,0.0%,19m
19654,3,[ioStuN]Chronicles,2892,0,0,2,2,0.0%,21m
19654,3,willbill,2892,0,0,2,2,0.0%,10m
19689,3,Nini,2891,1606,206,174,380,54.2%,27m
19689,1,Azim,2891,1618,161,167,328,49.1%,22m
19689,1,Chyn,2891,842,113,109,222,50.9%,19m
19689,2,RadioPower,2891,1301,53,60,113,46.9%,9m
19689,2,Bufus,2891,688,26,26,52,50.0%,15m
19689,2,Hehehehehehe,2891,584,23,24,47,48.9%,15m
19689,2,HughDoongus,2891,447,19,18,37,51.4%,9m
19689,3,ZEUSya,2891,305,15,15,30,50.0%,22m
19689,3,Rikzel,2891,192,8,3,11,72.7%,21m
19689,3,[EKORN]Inkognitower,2891,166,7,3,10,70.0%,1m
19689,3,JadranKrt,2891,129,6,6,12,50.0%,10m
19689,1,Darklymoon,2891,88,5,3,8,62.5%,17m
19689,3,Perturbator,2891,140,5,3,8,62.5%,6m
19689,3,KnowKnight,2891,118,5,4,9,55.6%,19m
19689,3,Asio,2891,44,5,5,10,50.0%,28m
19689,2,Rocaboy,2891,48,4,3,7,57.1%,10m
19689,2,JOAQUIN,2891,136,4,4,8,50.0%,27m
19689,2,FireFlame,2891,96,4,5,9,44.4%,1h
19689,3,Mindziasin,2891,90,3,4,7,42.9%,2m
19689,3,Darki,2891,0,3,6,9,33.3%,7m
19689,1,Киборг,2891,120,3,7,10,30.0%,4m
19689,3,[NLTN]Tri,2891,30,1,1,2,50.0%,10m
19689,1,[Yig]Drake,2891,0,0,1,1,0.0%,28m
19689,3,SMOKeeNG,2891,0,0,1,1,0.0%,4m
19689,3,Floppi,2891,0,0,1,1,0.0%,12m
19714,2,QuantumBeast,2890,1557,170,158,328,51.8%,11m
19714,2,[MMRis]ArchonDrops,2890,1267,105,89,194,54.1%,2m
19714,1,EncOre,2890,870,80,80,160,50.0%,11m
19714,1,[BWArmy]Iricommi,2890,1184,59,56,115,51.3%,6m
19714,3,thunder,2890,921,41,25,66,62.1%,22m
19714,2,[Harley]Liberty,2890,869,34,32,66,51.5%,9m
19714,2,[FYBF]ASAP,2890,864,32,36,68,47.1%,18m
19714,2,[loxi]Kurad,2890,591,24,19,43,55.8%,9m
19714,2,[tpt06]Guillaume,2890,492,20,20,40,50.0%,5m
19714,1,Legioner,2890,450,20,31,51,39.2%,7m
19714,3,Morget,2890,325,13,15,28,46.4%,27m
19714,2,ImNoGood,2890,227,12,9,21,57.1%,8m
19714,3,[8DJ8]mhY,2890,270,11,12,23,47.8%,11m
19714,3,leulmark,2890,325,10,10,20,50.0%,1m
19714,1,[Smthc]drFurryballs,2890,233,8,15,23,34.8%,46m
19714,3,IIiIIiilllI,2890,58,6,2,8,75.0%,1m
19714,1,Lethal,2890,193,5,6,11,45.5%,41m
19714,2,[GBGB]Joroe,2890,160,4,2,6,66.7%,23m
19714,1,Romeo,2890,0,3,4,7,42.9%,4m
19714,3,[EOF2]titi,2890,30,2,0,2,100.0%,9m
19714,1,llllllllllll,2890,44,2,2,4,50.0%,1h
19714,3,[WHIM74]KenKiller,2890,0,1,0,1,100.0%,12m
19714,3,Zero,2890,0,1,0,1,100.0%,6m
19714,2,MousTifa,2890,30,1,6,7,14.3%,19m
19714,2,Vil,2890,0,0,4,4,0.0%,11m
19714,3,NoNamedPl,2890,0,0,5,5,0.0%,12m
19740,3,SimpleDove,2889,1493,113,105,218,51.8%,6m
19740,2,[KKZE]Cbrox,2889,1547,94,95,189,49.7%,4m
19740,2,Meru,2889,691,68,57,125,54.4%,12m
19740,2,[SCGGA]Paul,2889,1408,65,46,111,58.6%,19m
19740,2,NSwarrrior,2889,1480,60,55,115,52.2%,18m
19740,2,Rakkon,2889,1004,50,30,80,62.5%,11m
19740,2,Fonar,2889,665,43,31,74,58.1%,12m
19740,2,AlenkaStar,2889,912,36,37,73,49.3%,6m
19740,3,[BigRat]qZilot,2889,723,35,17,52,67.3%,8m
19740,3,LuckyShot,2889,708,30,17,47,63.8%,17m
19740,2,Kuroko,2889,581,24,25,49,49.0%,21m
19740,3,Indigo,2889,444,17,11,28,60.7%,27m
19740,2,Winner,2889,317,15,16,31,48.4%,8m
19740,2,Naspix,2889,280,14,11,25,56.0%,19m
19740,3,Maxmager,2889,350,13,12,25,52.0%,3m
19740,3,Saddy,2889,298,10,4,14,71.4%,16m
19740,2,Djhinn,2889,193,9,7,16,56.2%,13m
19740,3,[GGBF]Johndave,2889,274,9,8,17,52.9%,4m
19740,2,Jarlax,2889,226,9,9,18,50.0%,42m
19740,2,[Noxsis]NoxMen,2889,146,7,10,17,41.2%,12m
19740,3,AshlengCZ,2889,162,6,4,10,60.0%,9m
19740,3,DAO,2889,116,5,5,10,50.0%,3m
19740,3,[ProRax]WhiteGhost,2889,74,4,0,4,100.0%,20m
19740,1,Galaxygazer,2889,97,4,3,7,57.1%,15m
19740,3,Glorback,2889,88,4,12,16,25.0%,10m
19740,3,TheEngineer,2889,0,3,2,5,60.0%,18m
19740,3,winniepooh,2889,0,3,2,5,60.0%,21m
19740,3,[P0W3RD]SuperTeej,2889,60,3,2,5,60.0%,21m
19740,3,[Lowko]XSSP,2889,92,3,5,8,37.5%,13m
19740,3,ALX,2889,30,2,2,4,50.0%,18m
19740,3,[CHIGG]Jurius,2889,30,2,2,4,50.0%,4m
19740,3,Rjkz,2889,0,1,0,1,100.0%,27m
19740,3,Sytams,2889,30,1,1,2,50.0%,21m
19740,3,[KfeniX]bmarchli,2889,30,1,2,3,33.3%,14m
19740,1,[ZhEba]Jarel,2889,48,1,2,3,33.3%,7m
19740,1,Melik,2889,0,0,1,1,0.0%,34m
19776,1,MalyGuN,2888,1289,120,113,233,51.5%,11m
19776,2,Leming,2888,564,29,22,51,56.9%,11m
19776,3,Mandos,2888,696,25,21,46,54.3%,13m
19776,3,PIT,2888,586,23,14,37,62.2%,11m
19776,3,Alshedow,2888,639,23,20,43,53.5%,16m
19776,3,Abaddon,2888,382,14,10,24,58.3%,3m
19776,3,[SandTm]STCobra,2888,470,14,41,55,25.5%,2m
19776,3,Kein,2888,343,12,6,18,66.7%,1m
19776,2,ArCHo,2888,324,10,11,21,47.6%,8m
19776,2,scøørn,2888,286,10,12,22,45.5%,13m
19776,2,HEAT,2888,282,10,13,23,43.5%,9m
19776,3,blecho,2888,226,9,8,17,52.9%,2m
19776,1,Player,2888,258,8,5,13,61.5%,1h
19776,3,[TeRo]Mewtwo,2888,226,8,6,14,57.1%,18m
19776,3,sirgalahad,2888,172,7,3,10,70.0%,10m
19776,3,Blackrubber,2888,216,7,3,10,70.0%,10m
19776,3,кабанча,2888,129,7,6,13,53.8%,18m
19776,3,ScrappyCoco,2888,190,7,9,16,43.8%,7m
19776,2,dearg,2888,194,6,7,13,46.2%,7m
19776,3,[RRT]Roly,2888,174,6,7,13,46.2%,17m
19776,3,masloboyka,2888,169,6,8,14,42.9%,4m
19776,1,Zaknafien,2888,118,5,4,9,55.6%,28m
19776,1,SamuiDobrui,2888,88,5,4,9,55.6%,22m
19776,3,[FD030]Megatron,2888,171,5,8,13,38.5%,12m
19776,3,SemKo,2888,136,5,8,13,38.5%,32m
19776,2,MORPHINE,2888,144,5,9,14,35.7%,10m
19776,3,NeedMore,2888,116,4,3,7,57.1%,7m
19776,3,VollkornKeks,2888,120,4,6,10,40.0%,21m
19776,3,Voynoy,2888,0,3,2,5,60.0%,19m
19776,1,Solido,2888,0,3,3,6,50.0%,10m
19776,3,Darkside,2888,58,2,1,3,66.7%,11m
19776,2,Vertical,2888,48,2,5,7,28.6%,44m
19776,1,Pupsik,2888,97,1,2,3,33.3%,45m
19776,3,Lyde,2888,95,1,4,5,20.0%,4m
19776,2,Vortex,2888,30,1,4,5,20.0%,14m
19776,2,[JediK]Yurros,2888,30,1,6,7,14.3%,7m
19776,3,MrDoomer,2888,0,0,1,1,0.0%,8m
19776,1,[RoXY]hYtAkYtE,2888,0,0,2,2,0.0%,43m
19776,3,[AnTm]Alsanpe,2888,0,0,2,2,0.0%,21m
19815,2,PENCIL,2887,1137,184,167,351,52.4%,3m
19815,3,Miracles,2887,1407,97,79,176,55.1%,19m
19815,2,oktopuy,2887,1548,86,66,152,56.6%,11m
19815,2,[BWArmy]Tchipe,2887,1422,72,60,132,54.5%,3m
19815,2,kim,2887,1563,72,71,143,50.3%,13m
19815,3,[FGYT]Wiviiides,2887,1498,61,54,115,53.0%,4m
19815,3,Night,2887,1215,60,57,117,51.3%,8m
19815,3,eliias,2887,234,43,41,84,51.2%,2m
19815,2,[BeerFi]Stanke,2887,589,42,35,77,54.5%,27m
19815,3,farloks,2887,781,36,25,61,59.0%,15m
19815,3,Arnold,2887,560,23,12,35,65.7%,14m
19815,2,Shamee,2887,287,22,19,41,53.7%,21m
19815,1,Зверь,2887,457,20,19,39,51.3%,17m
19815,1,Hoggerita,2887,488,20,23,43,46.5%,7m
19815,3,Wintermute,2887,267,12,14,26,46.2%,2m
19815,1,Rock,2887,416,12,27,39,30.8%,22m
19815,3,Microwave,2887,322,11,10,21,52.4%,18m
19815,3,Jamba,2887,209,10,6,16,62.5%,20m
19815,3,[KLANI]Thing,2887,188,10,7,17,58.8%,1h
19815,2,ScudnoX,2887,326,10,12,22,45.5%,2m
19815,3,[1NFEC7]lovecMC,2887,258,9,4,13,69.2%,21m
19815,1,рэпернотми,2887,264,8,17,25,32.0%,4m
19815,3,[AMBHXI]Traian,2887,194,7,7,14,50.0%,18m
19815,3,Razorblade,2887,144,6,4,10,60.0%,18m
19815,1,OrtenuS,2887,168,6,5,11,54.5%,32m
19815,2,smorkork,2887,0,3,1,4,75.0%,41m
19815,2,Zerhacker,2887,0,3,2,5,60.0%,1h
19815,2,ADHDGamer,2887,0,3,2,5,60.0%,47m
19815,3,IVVE,2887,119,3,4,7,42.9%,20m
19815,1,Bloo,2887,97,2,2,4,50.0%,32m
19815,2,Csabesz,2887,30,2,6,8,25.0%,14m
19815,3,[LV]JANS,2887,0,1,0,1,100.0%,1m
19815,3,slesh,2887,0,1,0,1,100.0%,1m
19815,1,IIIIIIII,2887,0,1,0,1,100.0%,3m
19815,3,phantom,2887,0,1,0,1,100.0%,21m
19815,3,JanekŁDZ,2887,0,1,1,2,50.0%,2m
19815,3,Alexy,2887,0,1,2,3,33.3%,9m
19815,2,[RuVoid]ЧереЧпоЧек,2887,30,1,6,7,14.3%,9m
19853,3,RobertRallex,2886,1460,443,413,856,51.8%,10m
19853,3,Blitz,2886,1638,202,183,385,52.5%,9m
19853,2,[NoHоmо]Kisho,2886,546,93,65,158,58.9%,19m
19853,2,MeeDVed,2886,1573,90,83,173,52.0%,16m
19853,1,[N0IP]Elander,2886,1342,80,93,173,46.2%,6m
19853,3,[RnBw]GeForce,2886,607,72,54,126,57.1%,18m
19853,2,Ketchup,2886,952,37,37,74,50.0%,16m
19853,2,Superbeere,2886,796,33,30,63,52.4%,21m
19853,2,Alientos,2886,497,20,18,38,52.6%,10m
19853,2,[SaMz]ElGringo,2886,530,18,25,43,41.9%,11m
19853,3,Borgking,2886,424,16,8,24,66.7%,8m
19853,3,[OnaCHe]Delly,2886,353,16,13,29,55.2%,17m
19853,3,Frobenius,2886,393,15,7,22,68.2%,3m
19853,3,[BIGGHK]Suppachmuzg,2886,451,15,19,34,44.1%,14m
19853,2,Asathor,2886,364,13,13,26,50.0%,5m
19853,1,BarathBathum,2886,298,12,11,23,52.2%,35m
19853,2,[WNTRpg]annekarin,2886,140,11,9,20,55.0%,9m
19853,1,Russgrad,2886,258,9,11,20,45.0%,1h
19853,2,IZHBAL,2886,222,8,9,17,47.1%,21m
19853,1,Michael,2886,97,5,3,8,62.5%,1h
19853,1,[hades]SirLongnose,2886,185,5,4,9,55.6%,32m
19853,3,AmOk,2886,0,4,1,5,80.0%,16m
19853,2,Rodrigo,2886,0,4,1,5,80.0%,45m
19853,3,STEN,2886,163,4,4,8,50.0%,1m
19853,2,SJK,2886,0,3,2,5,60.0%,35m
19853,2,Blackmore,2886,0,3,2,5,60.0%,39m
19853,3,Dace,2886,97,2,2,4,50.0%,16m
19853,2,McOnyx,2886,30,2,3,5,40.0%,11m
19853,3,[СТРАТ]ODeN,2886,0,1,0,1,100.0%,22m
19853,3,LunaticFool,2886,0,1,0,1,100.0%,22m
19853,3,Амун,2886,38,1,3,4,25.0%,1h
19853,1,Bandorku,2886,38,1,11,12,8.3%,10m
19853,3,[WL706]Taldarim,2886,0,0,2,2,0.0%,13m
19853,3,BornToLose,2886,0,0,3,3,0.0%,18m
19853,3,Wusa,2886,0,0,5,5,0.0%,4m
19888,3,TekDeka,2885,1530,415,412,827,50.2%,15m
19888,3,PKortbek,2885,1514,67,53,120,55.8%,22m
19888,3,drajz,2885,592,34,28,62,54.8%,7m
19888,3,[VädA]elorion,2885,732,32,18,50,64.0%,18m
19888,2,Neidhardt,2885,560,23,24,47,48.9%,1m
19888,3,LUCAS,2885,457,19,17,36,52.8%,5m
19888,2,Graf,2885,383,18,9,27,66.7%,4m
19888,2,[AiRǂ]SaveAz,2885,388,13,13,26,50.0%,19m
19888,3,[GODSSS]Fuzileiro,2885,322,12,9,21,57.1%,12m
19888,1,[НОД17]Lain,2885,286,12,12,24,50.0%,31m
19888,3,Sjakieownz,2885,272,10,3,13,76.9%,21m
19888,3,[xSABx]TheHunterZA,2885,318,10,11,21,47.6%,15m
19888,3,denchus,2885,269,9,4,13,69.2%,21m
19888,3,Teflon,2885,72,6,7,13,46.2%,21m
19888,2,aasddf,2885,60,5,4,9,55.6%,9m
19888,1,[Yking]Outplayed,2885,58,5,6,11,45.5%,1m
19888,1,SnickerS,2885,97,4,3,7,57.1%,27m
19888,3,[HALWAN]Lucky,2885,0,3,2,5,60.0%,1m
19888,3,TheTriGGer,2885,0,3,2,5,60.0%,1m
19888,2,sirmillion,2885,0,3,2,5,60.0%,16m
19888,3,NoClue,2885,86,3,2,5,60.0%,5m
19888,1,DisneyKiller,2885,0,3,3,6,50.0%,25m
19888,2,SophieDee,2885,106,3,5,8,37.5%,13m
19888,2,RadTaba,2885,30,2,4,6,33.3%,9m
19888,3,puCKBoi,2885,0,1,0,1,100.0%,16m
19888,3,[Mffins]Sharingan,2885,0,0,1,1,0.0%,12m
19888,1,Axilos,2885,0,0,3,3,0.0%,14m
19915,2,LemonTea,2884,1621,479,458,937,51.1%,1m
19915,3,Lebowski,2884,1475,372,356,728,51.1%,17m
19915,1,chris,2884,1135,215,202,417,51.6%,7m
19915,2,Инокентий,2884,1029,67,59,126,53.2%,1m
19915,1,IIIIllllIlIl,2884,1274,58,67,125,46.4%,1m
19915,2,Knocknock,2884,978,36,39,75,48.0%,5m
19915,3,Mercury,2884,699,34,9,43,79.1%,21m
19915,3,TonyStark,2884,752,32,22,54,59.3%,27m
19915,3,CaptianFox,2884,788,32,25,57,56.1%,21m
19915,3,[THRLLA]Reactormonk,2884,688,28,21,49,57.1%,9m
19915,2,Nik,2884,631,28,23,51,54.9%,8m
19915,3,Majin,2884,752,28,26,54,51.9%,27m
19915,2,Monochrome,2884,562,23,20,43,53.5%,6m
19915,3,Miroslav,2884,342,16,16,32,50.0%,3m
19915,3,Ward,2884,451,16,16,32,50.0%,6m
19915,3,BlackUnit,2884,244,9,8,17,52.9%,18m
19915,2,[SSC2]Mrkiller,2884,226,8,1,9,88.9%,2m
19915,3,VozGy,2884,90,6,5,11,54.5%,4m
19915,1,akssoon,2884,191,6,5,11,54.5%,14m
19915,3,Delly,2884,140,5,7,12,41.7%,4m
19915,3,[lOoOl]DRAGOONSLAIR,2884,86,4,1,5,80.0%,21m
19915,3,Koala,2884,86,4,2,6,66.7%,17m
19915,1,Cyz,2884,44,4,4,8,50.0%,25m
19915,1,llllllllllll,2884,96,4,6,10,40.0%,15m
19915,1,Piro,2884,114,3,0,3,100.0%,31m
19915,3,[DeGame]Trasher,2884,57,3,1,4,75.0%,10m
19915,3,Palm,2884,30,3,2,5,60.0%,12m
19915,2,Cornelius,2884,0,3,2,5,60.0%,24m
19915,1,AtomiCBreeZe,2884,97,3,3,6,50.0%,28m
19915,2,XpycTuK,2884,128,3,3,6,50.0%,5m
19915,3,Makai,2884,62,3,4,7,42.9%,3m
19915,3,[fische]CaptainFisch,2884,0,1,0,1,100.0%,11m
19915,3,Qwister,2884,0,1,0,1,100.0%,10m
19915,3,[BULB]MrDarkTesla,2884,0,1,0,1,100.0%,6m
19915,3,Scrouji,2884,30,1,1,2,50.0%,21m
19915,1,papouch,2884,97,1,1,2,50.0%,20m
19915,2,Vasana,2884,0,1,3,4,25.0%,6m
19915,3,Foosa,2884,0,0,1,1,0.0%,18m
19915,2,Dennisel,2884,0,0,2,2,0.0%,4m
19915,2,duk,2884,0,0,4,4,0.0%,19m
19955,2,Bettastar,2883,1540,196,179,375,52.3%,21m
19955,2,Sahem,2883,1116,175,153,328,53.4%,4m
19955,1,Padawan,2883,1470,91,98,189,48.1%,20m
19955,2,Schorleboy,2883,1194,68,68,136,50.0%,27m
19955,2,Nilz,2883,1080,49,35,84,58.3%,3m
19955,3,[Inval]ПростоPony,2883,827,30,27,57,52.6%,4m
19955,3,Arcji,2883,392,21,10,31,67.7%,20m
19955,3,DemiurgeYF,2883,262,10,9,19,52.6%,18m
19955,2,zZam,2883,266,10,14,24,41.7%,13m
19955,1,sixtus,2883,193,6,5,11,54.5%,22m
19955,2,TheRusher,2883,195,6,7,13,46.2%,2m
19955,3,LiamNox,2883,0,4,1,5,80.0%,4m
19955,3,millemille,2883,58,3,2,5,60.0%,5m
19955,3,LowTech,2883,0,3,2,5,60.0%,17m
19955,1,HCAllAlone,2883,144,3,3,6,50.0%,1h
19955,2,[BAxI]Bence,2883,62,3,6,9,33.3%,16m
19955,3,IlIlIlIlIlIl,2883,60,2,2,4,50.0%,15m
19955,2,easkae,2883,123,2,6,8,25.0%,27m
19955,3,Lexabarbos,2883,0,1,0,1,100.0%,16m
19955,3,[ViaN]Upride,2883,0,1,0,1,100.0%,17m
19955,3,[RuVoid]Draconovus,2883,0,1,0,1,100.0%,9m
19955,3,[SC2uk]roXor,2883,0,1,1,2,50.0%,18m
19955,3,[DMCK]Fireblade,2883,0,1,2,3,33.3%,1h
19955,3,[Restt]BlueManSK,2883,30,1,2,3,33.3%,2m
19955,1,Zergatul,2883,0,1,2,3,33.3%,3m
19955,2,Chog,2883,0,1,5,6,16.7%,25m
19955,3,Whilter,2883,0,0,5,5,0.0%,22m
19982,3,Jivo,2882,1551,585,589,1174,49.8%,20m
19982,1,scatman,2882,1386,228,223,451,50.6%,22m
19982,2,Miami,2882,1516,222,195,417,53.2%,9m
19982,1,[ToLOoZ]civilnic,2882,1605,88,93,181,48.6%,27m
19982,3,StomperX,2882,1504,86,81,167,51.5%,19m
19982,2,Tranduil,2882,792,60,55,115,52.2%,7m
19982,2,Cho,2882,1059,50,39,89,56.2%,10m
19982,2,[OFocus]Alcubierre,2882,661,29,23,52,55.8%,14m
19982,2,briedukas,2882,598,22,25,47,46.8%,21m
19982,3,VLADiK,2882,503,20,11,31,64.5%,7m
19982,3,Kriller,2882,378,13,13,26,50.0%,22m
19982,1,[UNICA]Virtvs,2882,278,9,17,26,34.6%,14m
19982,3,Moreminerals,2882,167,8,5,13,61.5%,18m
19982,1,tree,2882,234,8,15,23,34.8%,5m
19982,2,[EAU]Synti,2882,88,4,3,7,57.1%,10m
19982,3,Executor,2882,30,4,3,7,57.1%,3m
19982,2,TOMag,2882,135,4,3,7,57.1%,1m
19982,3,Komon,2882,60,3,1,4,75.0%,12m
19982,2,[PandS]Geo,2882,48,3,1,4,75.0%,45m
19982,1,Cowtriks,2882,0,3,3,6,50.0%,1m
19982,3,CoreScope,2882,58,2,1,3,66.7%,2m
19982,2,Tazar,2882,114,2,5,7,28.6%,19m
19982,3,andrei,2882,0,1,0,1,100.0%,11m
19982,3,tenrerin,2882,0,1,0,1,100.0%,21m
19982,2,[Buldog]ElcetroWat,2882,0,1,2,3,33.3%,45m
19982,3,Deer,2882,0,0,1,1,0.0%,3m
19982,3,phoenix,2882,0,0,1,1,0.0%,12m
19982,3,RaZa,2882,0,0,1,1,0.0%,17m
19982,3,Silentstrike,2882,0,0,1,1,0.0%,18m
19982,1,ХлебуШек,2882,0,0,3,3,0.0%,29m
19982,2,[S3ise]Catalin,2882,0,0,8,8,0.0%,22m
20013,3,mastermorgan,2881,955,48,44,92,52.2%,21m
20013,2,Smithski,2881,711,35,29,64,54.7%,17m
20013,2,[15ANS]Exodius,2881,856,35,36,71,49.3%,11m
20013,1,[RGSC2]MONSTER,2881,629,35,36,71,49.3%,17m
20013,2,[CDogs]far,2881,660,32,27,59,54.2%,5m
20013,3,BenDover,2881,537,22,14,36,61.1%,17m
20013,3,Denethor,2881,325,12,8,20,60.0%,19m
20013,3,[Panin]RusFreak,2881,298,10,5,15,66.7%,6m
20013,2,zzz,2881,272,9,10,19,47.4%,3m
20013,2,AlexThunder,2881,102,8,13,21,38.1%,19m
20013,1,Erwodak,2881,250,8,20,28,28.6%,14m
20013,2,Den,2881,182,7,12,19,36.8%,6m
20013,3,artanis,2881,148,5,6,11,45.5%,3m
20013,3,[LIQUID]homosapeins,2881,156,4,2,6,66.7%,13m
20013,2,[LaB]Benji,2881,0,3,2,5,60.0%,38m
20013,3,Dini,2881,0,3,2,5,60.0%,19m
20013,2,IIIIIIIIIIII,2881,88,2,1,3,66.7%,7m
20013,1,gizMax,2881,145,2,3,5,40.0%,1h
20013,2,truetobetrue,2881,30,2,4,6,33.3%,3m
20013,3,Netty,2881,0,1,0,1,100.0%,18m
20013,3,baran,2881,0,1,0,1,100.0%,4m
20013,3,Fejbee,2881,0,1,2,3,33.3%,6m
20013,3,[3plus1]monkel,2881,30,1,3,4,25.0%,6m
20013,3,Unable,2881,0,0,1,1,0.0%,7m
20013,3,Iron,2881,0,0,1,1,0.0%,17m
20013,2,[Reano]rePit,2881,0,0,4,4,0.0%,13m
20039,1,Drakar,2880,1618,365,348,713,51.2%,21m
20039,3,FLORIN,2880,1239,99,113,212,46.7%,16m
20039,2,egorka,2880,1260,96,72,168,57.1%,11m
20039,2,Dixu,2880,1272,92,81,173,53.2%,5m
20039,2,PiraT,2880,1187,90,78,168,53.6%,7m
20039,3,zaN,2880,1570,89,73,162,54.9%,22m
20039,3,[skh]flip,2880,1386,82,71,153,53.6%,9m
20039,3,Rico,2880,1202,47,41,88,53.4%,18m
20039,1,[DMBE]Gedally,2880,1058,45,42,87,51.7%,27m
20039,1,[HnsLkn]scholliman,2880,745,44,48,92,47.8%,9m
20039,3,GintareS,2880,937,41,29,70,58.6%,22m
20039,3,LiquidClem,2880,890,31,46,77,40.3%,17m
20039,3,[JelIy]Warzoner,2880,533,24,17,41,58.5%,21m
20039,1,Mistermk,2880,407,16,17,33,48.5%,6m
20039,1,[beebop]pinkmantis,2880,408,15,21,36,41.7%,27m
20039,2,[IvS]SorroW,2880,248,12,8,20,60.0%,5m
20039,3,likonit,2880,292,11,2,13,84.6%,14m
20039,3,Mika,2880,159,8,2,10,80.0%,27m
20039,3,Bigman,2880,261,8,10,18,44.4%,13m
20039,2,Legi,2880,106,6,2,8,75.0%,19m
20039,1,Burnstar,2880,140,5,4,9,55.6%,1h
20039,2,Kecer,2880,60,4,6,10,40.0%,4m
20039,2,Gittax,2880,0,3,2,5,60.0%,46m
20039,3,Impulse,2880,30,2,1,3,66.7%,4m
20039,2,Minder,2880,127,2,3,5,40.0%,43m
20039,3,darkdid,2880,0,1,0,1,100.0%,12m
20039,3,SmurF,2880,0,1,0,1,100.0%,10m
20039,3,[OnDack]MrSmile,2880,0,1,0,1,100.0%,10m
20039,3,[K0RM2]AlbaRisus,2880,0,1,0,1,100.0%,2m
20039,3,BlikBlouk,2880,30,1,1,2,50.0%,4m
20039,3,ArgentSouL,2880,30,1,1,2,50.0%,2m
20039,3,StormingBawl,2880,0,0,1,1,0.0%,16m
20039,2,[BlSn]tze,2880,0,0,1,1,0.0%,1h
20039,3,[ЯD]VoidWarden,2880,0,0,2,2,0.0%,4m
20073,2,HALEX,2879,903,81,68,149,54.4%,11m
20073,2,Foolpicture,2879,691,61,62,123,49.6%,16m
20073,2,Weedindahood,2879,1308,58,59,117,49.6%,13m
20073,2,saluCmoi,2879,506,23,18,41,56.1%,9m
20073,2,Vivi,2879,581,22,22,44,50.0%,17m
20073,2,imkiss,2879,258,12,6,18,66.7%,3m
20073,3,Vante,2879,141,7,3,10,70.0%,19m
20073,2,[Hrr]uNdefined,2879,204,7,11,18,38.9%,27m
20073,3,[DG5500]Maxiste,2879,60,6,3,9,66.7%,3m
20073,2,ShotStorm,2879,210,6,9,15,40.0%,10m
20073,3,Extermo,2879,187,5,1,6,83.3%,13m
20073,2,ubi,2879,124,5,10,15,33.3%,5m
20073,3,Ulthanc,2879,0,4,1,5,80.0%,2m
20073,3,Alexander,2879,60,3,1,4,75.0%,17m
20073,3,bentscho,2879,86,3,3,6,50.0%,27m
20073,3,[SW4GZ]Mobot,2879,30,2,0,2,100.0%,18m
20073,3,kolyanstar,2879,30,2,0,2,100.0%,17m
20073,1,Radical,2879,0,1,5,6,16.7%,11m
20073,2,[J4E]Protosspower,2879,0,1,6,7,14.3%,3m
20073,3,[ExCo]Artanis,2879,0,0,1,1,0.0%,11m
20093,1,NoLogic,2878,1589,109,112,221,49.3%,1m
20093,1,Clouds,2878,1165,102,101,203,50.2%,12m
20093,2,StormThrower,2878,1068,98,89,187,52.4%,14m
20093,3,DoCaCeBaL,2878,758,61,47,108,56.5%,2m
20093,2,Gza,2878,1278,60,53,113,53.1%,21m
20093,2,[GniG]xhartas,2878,1088,44,38,82,53.7%,7m
20093,2,Loupp,2878,608,26,20,46,56.5%,12m
20093,2,Jayminator,2878,493,21,23,44,47.7%,1m
20093,1,saalgandor,2878,221,14,9,23,60.9%,17m
20093,1,[CACCCC]barbaronan,2878,452,14,23,37,37.8%,7m
20093,3,[PNH]Master,2878,346,12,13,25,48.0%,16m
20093,3,[BräU]Ratonus,2878,269,11,9,20,55.0%,19m
20093,3,WeeWeeRNA,2878,277,10,5,15,66.7%,16m
20093,3,PooHolePirat,2878,231,9,6,15,60.0%,12m
20093,3,YersinPestis,2878,181,7,2,9,77.8%,27m
20093,3,Schretze,2878,236,7,4,11,63.6%,3m
20093,3,Lerconte,2878,230,7,5,12,58.3%,3m
20093,2,[LsSsD]eTRIP,2878,205,7,6,13,53.8%,3m
20093,3,DanteJusTesT,2878,198,7,7,14,50.0%,19m
20093,3,[SSC2]Stratocaster,2878,214,7,11,18,38.9%,10m
20093,1,[JoJoa]Kuki,2878,145,6,3,9,66.7%,3m
20093,1,[Olk]Tomek,2878,138,5,14,19,26.3%,4m
20093,3,[Dondon]Florchan,2878,114,4,6,10,40.0%,13m
20093,3,Hype,2878,0,3,2,5,60.0%,1m
20093,3,AgentYamato,2878,0,3,2,5,60.0%,1m
20093,3,uge,2878,88,3,5,8,37.5%,9m
20093,1,[UAŦeam]Inadequate,2878,68,3,10,13,23.1%,7m
20093,3,ccdrik,2878,118,2,1,3,66.7%,3m
20093,3,yaroslav,2878,32,2,3,5,40.0%,27m
20093,3,Arduriki,2878,0,1,0,1,100.0%,20m
20093,3,Karma,2878,30,1,1,2,50.0%,13m
20093,3,Vivify,2878,0,0,1,1,0.0%,17m
20093,3,Eternal,2878,0,0,1,1,0.0%,8m
20093,3,[SZ1337]Storm,2878,0,0,2,2,0.0%,22m
20093,3,Nightless,2878,0,0,2,2,0.0%,18m
20093,2,[GTM]Trakros,2878,0,0,6,6,0.0%,2m
20129,2,ludomtb,2877,1562,144,144,288,50.0%,8m
20129,1,TaiwanGO,2877,1521,137,134,271,50.6%,17m
20129,2,rgp,2877,1334,121,121,242,50.0%,21m
20129,2,KAPEC,2877,1044,112,92,204,54.9%,17m
20129,3,[IceHus]Asargin,2877,1560,81,79,160,50.6%,6m
20129,3,[LogL]rescueranger,2877,1331,77,54,131,58.8%,20m
20129,3,CrazyD,2877,1452,62,46,108,57.4%,19m
20129,3,LoneSurvivor,2877,1552,60,61,121,49.6%,3m
20129,2,[sc2st]DAN,2877,1442,56,56,112,50.0%,1m
20129,2,HARP,2877,633,35,37,72,48.6%,6m
20129,3,CoCos,2877,284,25,31,56,44.6%,13m
20129,3,NoEloNoGirls,2877,571,21,17,38,55.3%,20m
20129,3,[zouave]Niethalf,2877,458,18,18,36,50.0%,9m
20129,3,[RBP3]Poelin,2877,464,17,18,35,48.6%,13m
20129,2,Floris,2877,144,8,5,13,61.5%,4m
20129,3,Raccoon,2877,166,8,7,15,53.3%,16m
20129,3,[O2Ds]Fufel,2877,240,7,4,11,63.6%,16m
20129,3,Мародер,2877,183,7,7,14,50.0%,26m
20129,1,synoptic,2877,119,6,2,8,75.0%,29m
20129,2,[Jus2R]Dovakhiin,2877,152,6,9,15,40.0%,3m
20129,2,Kenshranz,2877,114,4,5,9,44.4%,11m
20129,3,Knursi,2877,0,3,2,5,60.0%,1m
20129,3,CaptnNapalm,2877,0,3,2,5,60.0%,9m
20129,3,HIGHBOT,2877,30,2,0,2,100.0%,10m
20129,3,Cata,2877,30,2,1,3,66.7%,11m
20129,3,RockBest,2877,97,2,2,4,50.0%,10m
20129,2,Quacke,2877,0,1,0,1,100.0%,28m
20129,3,[КЭП]ALI,2877,0,1,0,1,100.0%,3m
20129,3,[MnDp]Sonextc,2877,0,1,2,3,33.3%,27m
20129,3,carlbror,2877,30,1,4,5,20.0%,2m
20129,3,[ETU]Alagar,2877,0,0,1,1,0.0%,15m
20160,2,jns,2876,1001,80,42,122,65.6%,21m
20160,2,Игорь,2876,1269,58,56,114,50.9%,3m
20160,2,LtCheese,2876,807,47,39,86,54.7%,3m
20160,3,[200P]Mike,2876,343,40,11,51,78.4%,11m
20160,3,SpazzyMcGee,2876,1014,38,33,71,53.5%,20m
20160,3,august,2876,652,25,22,47,53.2%,17m
20160,2,Djurosaur,2876,695,25,27,52,48.1%,13m
20160,3,Kvothe,2876,343,20,11,31,64.5%,19m
20160,2,[SunTry]беды,2876,484,19,17,36,52.8%,21m
20160,2,Endoplast,2876,451,18,18,36,50.0%,16m
20160,3,Alltracks,2876,418,17,10,27,63.0%,27m
20160,3,[Animе]maroder,2876,391,15,7,22,68.2%,20m
20160,2,[LickIT]Beobaka,2876,247,9,10,19,47.4%,19m
20160,3,lazerr,2876,195,8,5,13,61.5%,13m
20160,2,Jarvis,2876,264,8,7,15,53.3%,7m
20160,3,TerminaThor,2876,198,7,7,14,50.0%,7m
20160,3,HansLanda,2876,146,5,6,11,45.5%,18m
20160,2,Umoja,2876,118,4,9,13,30.8%,13m
20160,3,[SOL0]Hasie,2876,86,3,2,5,60.0%,16m
20160,3,RaVeR,2876,60,3,3,6,50.0%,3m
20160,1,Romuhlus,2876,0,3,3,6,50.0%,44m
20160,2,Godspeed,2876,142,3,6,9,33.3%,13m
20160,3,szomonos,2876,30,2,0,2,100.0%,27m
20160,2,[35BZH]REVENANTHO,2876,60,2,5,7,28.6%,6m
20160,3,VitroSepia,2876,0,1,0,1,100.0%,10m
20160,3,[mfxed]Kml,2876,0,1,0,1,100.0%,3m
20160,3,[AiRǂ]Panterarossa,2876,0,1,0,1,100.0%,15m
20160,3,Neutrophil,2876,0,1,0,1,100.0%,1m
20160,3,Priz,2876,0,1,1,2,50.0%,11m
20160,3,AquaFortis,2876,30,1,2,3,33.3%,3m
20160,3,[TacSp]ShadowDragon,2876,0,0,1,1,0.0%,22m
20160,3,Midmad,2876,0,0,1,1,0.0%,10m
20160,3,KINGOFBLADES,2876,0,0,1,1,0.0%,20m
20160,3,kail,2876,0,0,1,1,0.0%,8m
20160,3,Jinario,2876,0,0,11,11,0.0%,7m
20195,1,Ginko,2875,1594,222,218,440,50.5%,14m
20195,1,TemplarSeiko,2875,1591,179,172,351,51.0%,10m
20195,3,Dablo,2875,1365,59,38,97,60.8%,16m
20195,3,[PRAIM]LingKing,2875,443,58,43,101,57.4%,13m
20195,2,YouLifeForSC,2875,1024,58,53,111,52.3%,4m
20195,2,MrTacos,2875,1018,41,37,78,52.6%,13m
20195,3,Marex,2875,303,30,17,47,63.8%,13m
20195,2,dayoff,2875,661,28,28,56,50.0%,9m
20195,2,TOMAZI,2875,612,21,24,45,46.7%,13m
20195,3,CbIPOK,2875,504,18,17,35,51.4%,21m
20195,3,Chouli,2875,468,18,26,44,40.9%,5m
20195,3,MaKC,2875,436,16,15,31,51.6%,21m
20195,3,zougoulou,2875,416,15,13,28,53.6%,11m
20195,3,[FsaloT]Erdbeerli,2875,293,12,9,21,57.1%,19m
20195,3,Edlegard,2875,282,10,10,20,50.0%,16m
20195,3,dominonzerg,2875,286,10,11,21,47.6%,15m
20195,3,Daroou,2875,282,8,12,20,40.0%,7m
20195,3,[ZERG7V]Diontep,2875,211,7,1,8,87.5%,22m
20195,3,[NoH]Szaron,2875,208,7,9,16,43.8%,12m
20195,2,adamek,2875,176,7,10,17,41.2%,8m
20195,3,elo,2875,123,7,11,18,38.9%,11m
20195,1,Mosquito,2875,216,5,7,12,41.7%,1h
20195,1,Yazon,2875,188,5,12,17,29.4%,13m
20195,2,HairyPotter,2875,140,4,3,7,57.1%,1h
20195,3,FireBall,2875,30,4,3,7,57.1%,21m
20195,2,CrazyRon,2875,156,4,5,9,44.4%,19m
20195,3,Nattura,2875,58,3,0,3,100.0%,18m
20195,3,Bullseye,2875,0,3,2,5,60.0%,3m
20195,2,[BWArmy]CanonsGoBrrr,2875,38,2,0,2,100.0%,19m
20195,1,Saelf,2875,96,2,1,3,66.7%,40m
20225,3,ZebbzeN,2874,1522,146,133,279,52.3%,20m
20225,3,joker,2874,1208,90,81,171,52.6%,20m
20225,2,Lisra,2874,1568,82,80,162,50.6%,7m
20225,3,ПoTpoWuTeJl,2874,1006,55,43,98,56.1%,4m
20225,2,[UoBCP]CAVOK,2874,1104,52,35,87,59.8%,11m
20225,2,dan,2874,548,47,42,89,52.8%,3m
20225,3,maximalll,2874,331,46,44,90,51.1%,20m
20225,3,DeathCPT,2874,679,33,17,50,66.0%,27m
20225,3,Royaly,2874,808,31,29,60,51.7%,10m
20225,2,Red,2874,687,29,28,57,50.9%,11m
20225,1,TheDC,2874,619,22,28,50,44.0%,13m
20225,3,[PL345]QuBuS,2874,454,21,10,31,67.7%,19m
20225,2,Noise,2874,474,21,15,36,58.3%,5m
20225,2,Shield,2874,342,18,11,29,62.1%,16m
20225,2,Atlas,2874,379,15,15,30,50.0%,16m
20225,2,JoudasPriest,2874,156,10,5,15,66.7%,34m
20225,1,roflcopter,2874,233,10,9,19,52.6%,3m
20225,3,[IceHus]Oleg,2874,174,7,6,13,53.8%,13m
20225,1,EpicPanda,2874,145,6,4,10,60.0%,1h
20225,3,[lkgg]spider,2874,146,6,6,12,50.0%,3m
20225,1,Esthunity,2874,36,5,4,9,55.6%,1h
20225,3,Ulfsaar,2874,146,5,6,11,45.5%,10m
20225,2,zerg,2874,140,4,3,7,57.1%,1h
20225,3,KRYack,2874,114,4,3,7,57.1%,27m
20225,3,[3Mz]Strog,2874,90,4,4,8,50.0%,9m
20225,2,alexander,2874,0,3,2,5,60.0%,1h
20225,3,[ŋǤ]XaToS,2874,90,3,4,7,42.9%,22m
20225,2,[Cnaiu]SgtIntensity,2874,58,3,5,8,37.5%,3m
20225,2,Norwind,2874,144,3,6,9,33.3%,8m
20225,3,[T4E]Esox,2874,30,2,1,3,66.7%,21m
20225,1,Tylone,2874,144,2,2,4,50.0%,24m
20225,3,Pantumaca,2874,58,2,3,5,40.0%,21m
20225,3,[Hells9]Hellskeleton,2874,0,1,0,1,100.0%,12m
20225,3,Chaos,2874,0,1,0,1,100.0%,14m
20225,3,DyRZylG,2874,0,1,0,1,100.0%,19m
20225,3,Einar,2874,30,1,2,3,33.3%,20m
20225,3,NINTEO,2874,0,0,1,1,0.0%,20m
20225,3,Spoderman,2874,0,0,1,1,0.0%,4m
20263,3,[ROMN]mugur,2873,1550,122,99,221,55.2%,12m
20263,3,[Gremli]УшлыйКролик,2873,1576,109,85,194,56.2%,3m
20263,3,[LMBD]DomaSno,2873,1155,58,26,84,69.0%,3m
20263,3,[PIZIKS]DarkVenumMMA,2873,1240,56,44,100,56.0%,5m
20263,3,FireWarrion,2873,767,32,22,54,59.3%,16m
20263,2,Neobhodima,2873,482,31,18,49,63.3%,19m
20263,2,[Böcke]HaraldKrull,2873,388,17,12,29,58.6%,4m
20263,2,sznycel,2873,414,17,17,34,50.0%,12m
20263,3,nazar,2873,399,15,12,27,55.6%,13m
20263,3,LobozBrna,2873,237,9,9,18,50.0%,21m
20263,2,Max,2873,238,8,14,22,36.4%,5m
20263,3,Kimbo,2873,227,7,4,11,63.6%,2m
20263,2,spawn,2873,168,7,7,14,50.0%,14m
20263,2,Lore,2873,142,6,12,18,33.3%,16m
20263,3,[NKSF]TroyanRabbit,2873,120,5,4,9,55.6%,5m
20263,2,велиавар,2873,60,5,5,10,50.0%,13m
20263,2,Hanzy,2873,0,3,3,6,50.0%,13m
20263,3,Kaiju,2873,0,1,0,1,100.0%,21m
20263,3,SUPERROXXOR,2873,0,1,0,1,100.0%,17m
20263,2,[SKYBRS]Nialllll,2873,0,1,4,5,20.0%,38m
20263,3,[OSgZ]EatMyShorts,2873,0,0,1,1,0.0%,23m
20263,3,Dar,2873,0,0,1,1,0.0%,16m
20263,3,Ainu,2873,0,0,1,1,0.0%,6m
20263,3,[ZeDe20]Lacagaste,2873,0,0,1,1,0.0%,22m
20263,3,Smile,2873,0,0,1,1,0.0%,7m
20263,3,Sindri,2873,0,0,2,2,0.0%,10m
20263,3,alexterror,2873,0,0,2,2,0.0%,21m
20263,3,Timsey,2873,0,0,2,2,0.0%,12m
20291,3,Emergy,2872,1414,547,529,1076,50.8%,11m
20291,2,agaulier,2872,1296,135,120,255,52.9%,6m
20291,1,Oxymoron,2872,1255,53,51,104,51.0%,13m
20291,3,LCOD,2872,935,42,24,66,63.6%,9m
20291,2,[mfixed]Tomek,2872,411,37,30,67,55.2%,12m
20291,3,KanNonRushky,2872,684,34,8,42,81.0%,27m
20291,3,[PTLc]DerErzengel,2872,314,34,28,62,54.8%,6m
20291,3,[CBTW]Icybolt,2872,708,27,22,49,55.1%,13m
20291,3,[mfixed]BOJAOS,2872,469,17,11,28,60.7%,14m
20291,3,SnowBeard,2872,144,7,6,13,53.8%,16m
20291,3,Rusifikator,2872,114,5,2,7,71.4%,10m
20291,2,saidooo,2872,114,5,4,9,55.6%,5m
20291,2,Unsita,2872,114,5,4,9,55.6%,9m
20291,3,Shopov,2872,86,5,5,10,50.0%,12m
20291,2,injinero,2872,60,5,5,10,50.0%,7m
20291,3,[MRDR]KopytkO,2872,0,4,4,8,50.0%,28m
20291,2,timehider,2872,124,3,2,5,60.0%,42m
20291,3,sasisa,2872,0,3,2,5,60.0%,3m
20291,3,AngryProbe,2872,0,3,2,5,60.0%,11m
20291,3,ryslick,2872,30,2,0,2,100.0%,13m
20291,3,Protosik,2872,30,2,0,2,100.0%,22m
20291,3,Onichi,2872,116,2,2,4,50.0%,3m
20291,3,Francis,2872,91,2,2,4,50.0%,27m
20291,3,Sparc,2872,58,2,2,4,50.0%,12m
20291,2,[swatx]HasloGasRa,2872,0,1,0,1,100.0%,39m
20291,3,[Etna]Vulturne,2872,0,1,1,2,50.0%,6m
20291,3,Tyrael,2872,30,1,1,2,50.0%,23m
20291,3,[G2I]LonelyProbe,2872,30,1,2,3,33.3%,20m
20291,3,KruchuVerchu,2872,0,0,1,1,0.0%,5m
20291,2,Kiradi,2872,0,0,5,5,0.0%,29m
20321,2,[beaste]Storm,2871,1607,358,327,685,52.3%,6m
20321,2,szmeagoll,2871,712,102,89,191,53.4%,9m
20321,3,EchizoLoviuf,2871,1590,77,68,145,53.1%,9m
20321,2,[UNBR]shveiser,2871,1481,72,59,131,55.0%,7m
20321,3,Maximus,2871,1601,72,61,133,54.1%,9m
20321,2,[31415]zubster,2871,631,61,55,116,52.6%,9m
20321,2,[SPEZUL]Phydra,2871,1317,56,58,114,49.1%,21m
20321,2,dinko,2871,500,28,31,59,47.5%,11m
20321,2,Tzeench,2871,641,23,21,44,52.3%,3m
20321,2,NoFlockin,2871,207,13,4,17,76.5%,3m
20321,3,TuffCustomer,2871,370,13,12,25,52.0%,12m
20321,3,Angelina,2871,256,12,12,24,50.0%,20m
20321,3,JimmyRacheta,2871,268,10,5,15,66.7%,21m
20321,3,Smiler,2871,192,9,7,16,56.2%,3m
20321,3,Pandathy,2871,236,9,7,16,56.2%,1h
20321,2,TanocaCocok,2871,224,9,9,18,50.0%,3m
20321,1,[nWss]Baallord,2871,166,8,4,12,66.7%,1h
20321,2,GraffWolff,2871,168,8,5,13,61.5%,4m
20321,3,[RBP3]Commander,2871,206,8,7,15,53.3%,3m
20321,1,Droppie,2871,211,7,6,13,53.8%,1h
20321,1,Zacckk,2871,202,7,11,18,38.9%,3m
20321,3,БаРкОд,2871,144,6,7,13,46.2%,22m
20321,3,Joel,2871,142,4,0,4,100.0%,11m
20321,1,Ciprian,2871,96,4,3,7,57.1%,23m
20321,2,[MOFFIN]Adamer,2871,30,4,4,8,50.0%,7m
20321,2,Jhule,2871,90,4,5,9,44.4%,9m
20321,3,[UKRdp]MrZigero,2871,58,3,0,3,100.0%,19m
20321,2,[Казах]Bomberman,2871,0,3,2,5,60.0%,1h
20321,3,GooDcAt,2871,144,3,2,5,60.0%,11m
20321,1,Skydiver,2871,30,3,7,10,30.0%,6m
20321,3,[ПВЗ]Бадма,2871,58,2,1,3,66.7%,13m
20321,3,[Zato]SiNnLoS,2871,0,1,0,1,100.0%,21m
20321,1,cavo,2871,0,1,0,1,100.0%,38m
20321,3,[dG]salchwell,2871,97,1,1,2,50.0%,18m
20321,3,Bluh,2871,30,1,1,2,50.0%,12m
20321,3,Ako,2871,0,1,1,2,50.0%,45m
20321,3,Клубничка,2871,30,1,1,2,50.0%,22m
20321,3,[StrdUK]StoredCris,2871,30,1,5,6,16.7%,18m
20321,3,Maxeldr,2871,0,0,1,1,0.0%,18m
20360,2,[H4L4]Zwim,2870,574,100,90,190,52.6%,9m
20360,1,Android,2870,1392,96,86,182,52.7%,4m
20360,3,Kazama,2870,1600,64,58,122,52.5%,5m
20360,1,[NoAPM]Karlito,2870,657,32,36,68,47.1%,17m
20360,3,Kingpin,2870,328,13,9,22,59.1%,11m
20360,3,Goldgoblin,2870,240,11,7,18,61.1%,16m
20360,3,[P1zzAa]Maxph,2870,231,8,1,9,88.9%,21m
20360,2,[DEDAL]Hydra,2870,170,7,7,14,50.0%,3m
20360,1,[PUTING]Ebhalisk,2870,192,4,3,7,57.1%,1h
20360,3,hank,2870,120,4,7,11,36.4%,11m
20360,1,[Pot]Bucóka,2870,97,3,5,8,37.5%,26m
20360,2,Ambresol,2870,64,3,7,10,30.0%,6m
20360,3,print,2870,58,2,3,5,40.0%,2m
20360,2,graworu,2870,80,2,5,7,28.6%,47m
20360,1,LuLu,2870,97,2,6,8,25.0%,1h
20360,3,Wadpig,2870,0,1,0,1,100.0%,4m
20360,3,Rozgonyator,2870,0,1,0,1,100.0%,1m
20360,3,CiNeCKiS,2870,97,1,1,2,50.0%,5m
20360,3,[ProRax]Dekteruk,2870,30,1,1,2,50.0%,19m
20360,3,[oooboy]TalJacob,2870,0,1,2,3,33.3%,16m
20360,3,IlikeU,2870,30,1,3,4,25.0%,16m
20360,3,CheckReality,2870,0,1,4,5,20.0%,3m
20360,2,martinez,2870,30,1,5,6,16.7%,21m
20360,3,XStream,2870,0,0,1,1,0.0%,21m
20360,3,Worker,2870,0,0,1,1,0.0%,22m
20360,2,TheJustinP,2870,0,0,6,6,0.0%,7m
20386,3,Manchego,2869,1462,306,328,634,48.3%,6m
20386,2,TARAS,2869,1556,134,122,256,52.3%,9m
20386,3,AntonGosu,2869,1674,80,78,158,50.6%,4m
20386,1,Martoz,2869,1025,66,61,127,52.0%,22m
20386,3,Sashka,2869,1341,53,47,100,53.0%,3m
20386,2,Kruul,2869,1130,50,44,94,53.2%,19m
20386,2,FreshD,2869,893,42,33,75,56.0%,9m
20386,2,[ULTX]Bavor,2869,478,37,35,72,51.4%,21m
20386,2,JackpoT,2869,915,34,38,72,47.2%,22m
20386,3,And,2869,212,29,14,43,67.4%,10m
20386,2,Rundvogel,2869,678,25,28,53,47.2%,1m
20386,2,[FSO]BaronBrax,2869,356,15,8,23,65.2%,1h
20386,3,Darkan,2869,362,13,11,24,54.2%,6m
20386,3,Egzaltacja,2869,211,11,6,17,64.7%,20m
20386,2,shadow,2869,288,11,14,25,44.0%,11m
20386,1,Alanor,2869,265,9,9,18,50.0%,21m
20386,3,PDoubleU,2869,183,6,11,17,35.3%,5m
20386,3,[galler]Vickop,2869,114,5,3,8,62.5%,6m
20386,3,Painful,2869,114,5,6,11,45.5%,4m
20386,3,MagicDiamond,2869,116,4,1,5,80.0%,11m
20386,2,[LGKBH]RedPhoenix,2869,0,4,1,5,80.0%,39m
20386,3,Mackan,2869,121,4,7,11,36.4%,36m
20386,2,Renan,2869,0,3,2,5,60.0%,1h
20386,3,Dmig,2869,86,3,3,6,50.0%,22m
20386,3,Waylander,2869,90,3,5,8,37.5%,3m
20386,3,Antipko,2869,60,2,3,5,40.0%,12m
20386,3,[mfixed]Konrados,2869,60,2,5,7,28.6%,22m
20386,3,VoxTemporis,2869,0,1,0,1,100.0%,5m
20386,3,Antagonist,2869,0,1,0,1,100.0%,4m
20386,3,DumBFounDeaD,2869,97,1,1,2,50.0%,5m
20386,2,ZoolCarbon,2869,0,1,2,3,33.3%,19m
20386,3,[101101]Kindlund,2869,0,0,1,1,0.0%,3m
20386,3,Blast,2869,0,0,1,1,0.0%,21m
20386,1,[WIch]rodrigo,2869,0,0,2,2,0.0%,1h
20386,3,[SLW]PIGNATA,2869,0,0,2,2,0.0%,22m
20421,3,Ondrmen,2868,973,66,50,116,56.9%,19m
20421,3,osxnop,2868,714,58,46,104,55.8%,20m
20421,3,drislio,2868,1208,46,45,91,50.5%,10m
20421,3,[z666z]MakeMyWeapon,2868,969,44,46,90,48.9%,22m
20421,1,Dima,2868,1151,44,58,102,43.1%,4m
20421,3,BAV,2868,858,39,19,58,67.2%,1m
20421,2,AEundSZ,2868,227,34,29,63,54.0%,6m
20421,2,néo,2868,878,31,38,69,44.9%,8m
20421,2,[971]Corsair,2868,699,28,25,53,52.8%,6m
20421,2,[KlMCHl]Paradise,2868,295,26,27,53,49.1%,9m
20421,3,Requin,2868,368,14,12,26,53.8%,18m
20421,2,Xekman,2868,259,10,9,19,52.6%,11m
20421,2,[FoTR]Attland,2868,227,9,8,17,52.9%,12m
20421,3,Hybrid,2868,220,7,4,11,63.6%,22m
20421,3,Levano,2868,193,7,6,13,53.8%,15m
20421,3,ManLove,2868,201,6,5,11,54.5%,13m
20421,2,IIIIIIIIIIII,2868,116,5,6,11,45.5%,14m
20421,2,CuloTonanTe,2868,140,4,3,7,57.1%,1h
20421,3,Dixi,2868,60,3,1,4,75.0%,19m
20421,3,[CumBoy]Terka,2868,133,3,1,4,75.0%,16m
20421,3,[ICP47]TEVton,2868,0,3,2,5,60.0%,21m
20421,2,Random,2868,60,3,5,8,37.5%,4m
20421,3,Sdrummy,2868,30,2,2,4,50.0%,7m
20421,3,ChromaTron,2868,0,2,3,5,40.0%,22m
20421,3,[Funky]ErisHope,2868,0,2,3,5,40.0%,16m
20421,3,[LeVaV]Borislav,2868,0,1,0,1,100.0%,15m
20421,1,XaReV,2868,0,1,2,3,33.3%,48m
20448,3,EzeJohnny,2867,948,126,114,240,52.5%,20m
20448,3,RuntimeExc,2867,377,64,30,94,68.1%,9m
20448,3,mefoneiro,2867,416,24,10,34,70.6%,11m
20448,2,Romulus,2867,650,23,25,48,47.9%,16m
20448,3,LaCroix,2867,584,21,19,40,52.5%,10m
20448,3,FnkyDnkeyBG,2867,378,14,10,24,58.3%,4m
20448,2,Vasilergus,2867,328,12,19,31,38.7%,4m
20448,2,Alpha,2867,287,11,6,17,64.7%,13m
20448,3,Kayos,2867,201,10,4,14,71.4%,16m
20448,3,[kek34]irbis,2867,231,10,8,18,55.6%,18m
20448,3,jkeyser,2867,120,8,3,11,72.7%,10m
20448,3,ТЭД,2867,201,8,5,13,61.5%,20m
20448,1,Taldarimian,2867,280,7,16,23,30.4%,7m
20448,3,IIIIIIIIIIII,2867,146,6,4,10,60.0%,17m
20448,3,TheRealAnton,2867,0,4,1,5,80.0%,14m
20448,2,Oups,2867,88,4,3,7,57.1%,9m
20448,3,[GАYSS]IIIIIIIIIIII,2867,58,3,0,3,100.0%,8m
20448,3,HawkeyeQT,2867,0,3,2,5,60.0%,21m
20448,1,ignotas,2867,97,2,2,4,50.0%,34m
20448,3,zombiebuster,2867,131,2,3,5,40.0%,26m
20448,3,FatalT,2867,0,2,3,5,40.0%,5m
20448,3,Frecuencio,2867,0,1,0,1,100.0%,20m
20448,3,[6Tray]Dipi,2867,0,1,0,1,100.0%,9m
20448,3,NeverMore,2867,0,1,0,1,100.0%,14m
20448,3,[GanYa]Overmind,2867,0,1,1,2,50.0%,16m
20448,1,Moi,2867,96,1,1,2,50.0%,42m
20448,1,LoWeSt,2867,0,1,1,2,50.0%,44m
20448,3,[Tanky]DrVanNostren,2867,0,1,1,2,50.0%,2m
20448,3,Seboulba,2867,0,0,1,1,0.0%,19m
20448,2,[MAIDAN]Fransua,2867,0,0,1,1,0.0%,1h
20448,3,Rohlik,2867,0,0,1,1,0.0%,22m
20448,3,WooDLee,2867,0,0,1,1,0.0%,6m
20448,3,Athenio,2867,0,0,1,1,0.0%,12m
20448,3,Varray,2867,0,0,2,2,0.0%,3m
20448,1,Lichtgestalt,2867,0,0,3,3,0.0%,1h
20483,2,elbufa,2866,1524,191,177,368,51.9%,21m
20483,3,Darth,2866,1522,64,52,116,55.2%,21m
20483,1,Tesla,2866,1184,54,56,110,49.1%,18m
20483,1,[nCoV]javascript,2866,867,46,55,101,45.5%,12m
20483,3,Hellpepper,2866,994,39,34,73,53.4%,2m
20483,3,Jahh,2866,455,37,49,86,43.0%,6m
20483,2,IIIIIIIIIIII,2866,732,28,30,58,48.3%,7m
20483,2,SapeR,2866,572,27,21,48,56.2%,17m
20483,3,Imperator,2866,568,21,18,39,53.8%,19m
20483,3,LeonRasta,2866,470,17,18,35,48.6%,1m
20483,1,ßlùdgódx,2866,373,16,16,32,50.0%,9m
20483,2,GALADRIEL,2866,321,15,16,31,48.4%,13m
20483,3,MrSnowflake,2866,320,12,12,24,50.0%,5m
20483,3,Flooded,2866,286,11,11,22,50.0%,18m
20483,2,JaxXǁYOUTUBE,2866,257,9,10,19,47.4%,1h
20483,2,frosty,2866,190,7,12,19,36.8%,7m
20483,2,[NoRel]Reality,2866,120,5,13,18,27.8%,20m
20483,2,Jaeyx,2866,128,4,5,9,44.4%,7m
20483,2,Hypogojix,2866,62,3,7,10,30.0%,22m
20483,3,Yarik,2866,30,2,0,2,100.0%,22m
20483,3,[UTGEU]Boss,2866,30,2,1,3,66.7%,11m
20483,3,deseveryday,2866,58,2,1,3,66.7%,21m
20483,3,[CeMo]Kefke,2866,0,1,1,2,50.0%,1h
20483,3,protos,2866,30,1,1,2,50.0%,11m
20483,3,daxakas,2866,0,0,1,1,0.0%,7m
20483,3,simson,2866,0,0,1,1,0.0%,21m
20483,2,Barcode,2866,0,0,3,3,0.0%,1h
20510,2,twotwo,2865,1620,211,201,412,51.2%,16m
20510,2,ingo,2865,1573,135,117,252,53.6%,19m
20510,3,Chain,2865,1589,128,108,236,54.2%,6m
20510,2,[ExTr1m]sashaTopGg,2865,1281,119,100,219,54.3%,6m
20510,3,iceberg,2865,1506,96,73,169,56.8%,9m
20510,3,[Arrows]llllllllllll,2865,703,80,52,132,60.6%,2m
20510,1,OneCent,2865,1355,72,79,151,47.7%,14m
20510,2,Jack,2865,959,47,39,86,54.7%,27m
20510,2,feador,2865,811,32,34,66,48.5%,11m
20510,3,[TZCrew]HuriKN,2865,700,29,22,51,56.9%,20m
20510,3,iñaki,2865,528,26,21,47,55.3%,10m
20510,2,isaew,2865,462,25,23,48,52.1%,5m
20510,2,Макссс,2865,499,19,20,39,48.7%,6m
20510,3,mathi,2865,358,12,11,23,52.2%,10m
20510,3,[PPM]Greenghost,2865,170,7,5,12,58.3%,16m
20510,1,Dawn,2865,178,6,8,14,42.9%,20m
20510,3,Leerroy,2865,118,5,3,8,62.5%,18m
20510,3,Ben,2865,140,5,4,9,55.6%,19m
20510,2,Akashy,2865,46,4,3,7,57.1%,36m
20510,1,Bytyz,2865,167,4,4,8,50.0%,9m
20510,2,Lumpii,2865,30,4,4,8,50.0%,21m
20510,3,Henhauser,2865,122,4,4,8,50.0%,1h
20510,3,bistriii,2865,0,3,2,5,60.0%,1m
20510,3,AMBRZ,2865,60,3,3,6,50.0%,4m
20510,1,JimDiesel,2865,0,3,3,6,50.0%,48m
20510,3,ScaryChiken,2865,58,2,1,3,66.7%,16m
20510,3,[3iL]lala,2865,0,1,0,1,100.0%,13m
20510,3,Chuchxe,2865,0,1,0,1,100.0%,9m
20510,2,Alexander,2865,0,1,1,2,50.0%,41m
20510,3,Corsair,2865,0,1,1,2,50.0%,23m
20510,3,kira,2865,30,1,4,5,20.0%,13m
20510,3,Superinse,2865,0,1,4,5,20.0%,21m
20510,3,MrSmersh,2865,0,0,1,1,0.0%,9m
20510,3,Polaris,2865,0,0,1,1,0.0%,11m
20510,3,Clozer,2865,0,0,1,1,0.0%,22m
20510,3,Hebihime,2865,0,0,1,1,0.0%,21m
20510,3,SokolDV,2865,0,0,3,3,0.0%,5m
20510,3,[MrCl]Camerius,2865,0,0,3,3,0.0%,16m
20548,3,CowarS,2864,1396,84,74,158,53.2%,13m
20548,2,SIMAX,2864,1078,57,44,101,56.4%,3m
20548,3,WildPanda,2864,859,36,24,60,60.0%,22m
20548,2,Dimo,2864,835,36,31,67,53.7%,22m
20548,1,chestarB,2864,759,34,40,74,45.9%,3m
20548,3,Strike,2864,266,12,16,28,42.9%,6m
20548,2,Mark,2864,221,10,10,20,50.0%,1h
20548,2,tWin,2864,262,9,10,19,47.4%,13m
20548,2,UndeadR,2864,262,9,10,19,47.4%,6m
20548,3,[66666]CaesarS,2864,235,8,3,11,72.7%,7m
20548,3,[Чуваши]Юра,2864,270,8,6,14,57.1%,6m
20548,2,[IMPASS]Vince,2864,246,7,10,17,41.2%,22m
20548,3,Rundar,2864,174,6,6,12,50.0%,7m
20548,3,[ValidG]Kers,2864,50,5,9,14,35.7%,22m
20548,3,MaPaX,2864,88,4,6,10,40.0%,11m
20548,1,HIEN,2864,0,3,3,6,50.0%,1h
20548,1,Jamieson,2864,0,3,3,6,50.0%,37m
20548,3,Humongous,2864,32,2,0,2,100.0%,16m
20548,2,[lThEl]ThEJustice,2864,0,2,2,4,50.0%,1h
20548,3,FFormula,2864,58,2,2,4,50.0%,13m
20548,3,Zecathos,2864,0,1,0,1,100.0%,13m
20548,3,Maths,2864,0,1,0,1,100.0%,11m
20548,1,COMMANDER,2864,92,1,1,2,50.0%,26m
20548,3,[JIH]Mařen,2864,30,1,2,3,33.3%,4m
20548,2,[4ekavo]KillerNeZoX,2864,0,1,3,4,25.0%,3m
20548,2,FraGor,2864,0,1,5,6,16.7%,14m
20548,2,[Jöthem]Bergamot,2864,30,1,6,7,14.3%,22m
20548,3,CaptainEvL,2864,0,0,1,1,0.0%,14m
20548,3,GrafSpee,2864,0,0,1,1,0.0%,5m
20548,3,[SK1]sharpcut,2864,0,0,2,2,0.0%,12m
20578,2,kimkool,2863,1587,253,239,492,51.4%,5m
20578,2,Jusifer,2863,915,98,82,180,54.4%,6m
20578,2,Marcel,2863,1566,96,99,195,49.2%,12m
20578,2,Kringon,2863,685,67,62,129,51.9%,19m
20578,2,Enigma,2863,487,59,53,112,52.7%,6m
20578,1,[KS007]Nuke,2863,1072,58,63,121,47.9%,17m
20578,3,arthus,2863,1013,56,40,96,58.3%,12m
20578,3,Letos,2863,644,40,31,71,56.3%,10m
20578,3,[BloTi]barcode,2863,880,39,27,66,59.1%,14m
20578,2,KIKI,2863,896,39,30,69,56.5%,19m
20578,2,magass,2863,610,29,18,47,61.7%,9m
20578,3,pebg,2863,740,28,26,54,51.9%,20m
20578,2,[EEBÄR]Tarkin,2863,449,20,21,41,48.8%,12m
20578,3,Styx,2863,434,17,8,25,68.0%,18m
20578,2,MacroJordan,2863,225,8,6,14,57.1%,21m
20578,2,Nordri,2863,112,6,3,9,66.7%,7m
20578,3,akatsushi,2863,169,6,6,12,50.0%,1m
20578,3,Platon,2863,152,6,7,13,46.2%,20m
20578,3,LightWarrior,2863,118,5,3,8,62.5%,11m
20578,3,stardouf,2863,146,5,6,11,45.5%,21m
20578,3,Impact,2863,90,4,3,7,57.1%,21m
20578,3,Elnubnub,2863,116,4,6,10,40.0%,22m
20578,2,Gereay,2863,128,4,12,16,25.0%,16m
20578,3,Bdlong,2863,0,3,2,5,60.0%,9m
20578,2,Mmeee,2863,73,3,6,9,33.3%,10m
20578,3,Raynor,2863,30,2,0,2,100.0%,3m
20578,3,Haklie,2863,60,2,3,5,40.0%,21m
20578,3,[3Y]Андромедыч,2863,58,2,4,6,33.3%,3m
20578,3,[PDNCVT]SoftBeard,2863,0,1,0,1,100.0%,20m
20578,2,[EV0C]Saberius,2863,48,1,1,2,50.0%,18m
20578,2,NoOne,2863,0,1,2,3,33.3%,3m
20578,3,[ICoCP]Sacantus,2863,30,1,3,4,25.0%,19m
20578,3,milca,2863,0,1,3,4,25.0%,6m
20578,1,[Dinara]staraKrafna,2863,0,0,1,1,0.0%,1h
20578,3,thegreenman,2863,0,0,1,1,0.0%,18m
20578,1,[4GGsc]Soulz,2863,0,0,2,2,0.0%,25m
20578,3,Jasper,2863,0,0,2,2,0.0%,18m
20578,3,Majis,2863,0,0,2,2,0.0%,14m
20578,3,PunchLine,2863,0,0,3,3,0.0%,14m
20617,1,[Heroes]BigBrotoss,2862,1368,390,376,766,50.9%,9m
20617,2,Azazel,2862,1001,65,62,127,51.2%,22m
20617,3,Hampoz,2862,1112,54,37,91,59.3%,12m
20617,2,DimoN,2862,1286,50,49,99,50.5%,2m
20617,2,KimYoungHo,2862,615,29,33,62,46.8%,22m
20617,3,Kucharro,2862,768,28,26,54,51.9%,18m
20617,3,Phirasa,2862,449,16,11,27,59.3%,11m
20617,3,Dasha,2862,456,15,13,28,53.6%,9m
20617,3,YuRaK,2862,193,9,5,14,64.3%,11m
20617,3,KaKaShi,2862,194,8,5,13,61.5%,9m
20617,3,Prometheus,2862,264,8,8,16,50.0%,14m
20617,3,Sinfool,2862,232,8,9,17,47.1%,10m
20617,3,CobolFreak,2862,202,7,7,14,50.0%,6m
20617,3,Einzelnkamf,2862,142,6,5,11,54.5%,3m
20617,3,DemenCiel,2862,170,6,5,11,54.5%,11m
20617,3,PurpleInc,2862,70,6,7,13,46.2%,10m
20617,3,WolloW,2862,172,6,8,14,42.9%,30m
20617,3,PavlaD,2862,147,4,4,8,50.0%,16m
20617,2,[iR3B]Stankezz,2862,119,3,2,5,60.0%,41m
20617,3,ЗapodbIII,2862,0,3,2,5,60.0%,3m
20617,2,[ObG1]Nidal,2862,128,3,3,6,50.0%,41m
20617,2,MonkeyMafia,2862,0,3,3,6,50.0%,40m
20617,3,[NCTP]Elkon,2862,92,3,7,10,30.0%,17m
20617,1,PROteamart,2862,88,2,3,5,40.0%,15m
20617,3,Draze,2862,97,2,6,8,25.0%,27m
20617,3,Fearme,2862,0,1,0,1,100.0%,18m
20617,3,cosma,2862,0,1,0,1,100.0%,6m
20617,3,MaadA,2862,30,1,4,5,20.0%,1m
20617,3,ChrisGamers,2862,30,1,4,5,20.0%,28m
20617,3,Lhuq,2862,0,0,1,1,0.0%,20m
20617,3,Fano,2862,0,0,1,1,0.0%,19m
20617,3,NKI,2862,0,0,1,1,0.0%,1m
20617,1,Reaper,2862,0,0,1,1,0.0%,1h
20617,3,Polak,2862,0,0,1,1,0.0%,3m
20617,3,Akkkke,2862,0,0,1,1,0.0%,9m
20617,3,ARCHG,2862,0,0,1,1,0.0%,22m
20617,3,[ZЕRGТV]Sirius,2862,0,0,3,3,0.0%,3m
20654,2,silentdavid,2861,1407,208,189,397,52.4%,21m
20654,2,Wiz,2861,1416,167,167,334,50.0%,16m
20654,2,Shark,2861,584,153,145,298,51.3%,27m
20654,2,[KEITH]Eikothan,2861,1140,87,90,177,49.2%,22m
20654,1,[Batmen]JayIITheP,2861,1410,72,74,146,49.3%,8m
20654,3,LeninJiv,2861,1264,61,36,97,62.9%,9m
20654,3,[NANNA]NaTuRaL,2861,273,42,30,72,58.3%,6m
20654,3,LobStrokk,2861,574,33,32,65,50.8%,22m
20654,3,blasé,2861,521,21,21,42,50.0%,23m
20654,2,GimLee,2861,515,20,17,37,54.1%,22m
20654,3,Antonsl,2861,530,20,18,38,52.6%,13m
20654,2,LongJohnson,2861,346,15,7,22,68.2%,41m
20654,1,Butterkeks,2861,306,13,14,27,48.1%,20m
20654,2,symestre,2861,192,9,6,15,60.0%,9m
20654,3,MaxBeast,2861,279,9,8,17,52.9%,14m
20654,1,[FFFAST]Keenos,2861,200,9,9,18,50.0%,16m
20654,2,[MEvil]Schwommiii,2861,306,9,13,22,40.9%,8m
20654,2,Skysasuke,2861,251,9,14,23,39.1%,1m
20654,2,[K0mpis]Robzki,2861,198,8,11,19,42.1%,21m
20654,2,KaVie,2861,188,6,15,21,28.6%,5m
20654,2,[kneg]Creepers,2861,190,5,6,11,45.5%,16m
20654,3,Luffien,2861,118,5,7,12,41.7%,19m
20654,3,Maxu,2861,148,5,7,12,41.7%,18m
20654,3,INotPoc,2861,0,4,1,5,80.0%,3m
20654,3,koosz,2861,118,4,4,8,50.0%,16m
20654,2,[SonGa]Soab,2861,156,4,6,10,40.0%,17m
20654,3,Liemustdie,2861,86,3,1,4,75.0%,13m
20654,2,[NADPH]Critter,2861,0,3,3,6,50.0%,9m
20654,3,Avocado,2861,60,3,10,13,23.1%,2m
20654,3,SchoKoPanDa,2861,0,2,3,5,40.0%,5m
20654,2,BlackBird,2861,30,2,5,7,28.6%,5m
20654,1,PippoJedi,2861,0,1,0,1,100.0%,1h
20654,3,Looloobaa,2861,0,1,0,1,100.0%,18m
20654,2,FistingAss,2861,0,1,0,1,100.0%,48m
20654,3,VLAD,2861,30,1,4,5,20.0%,2m
20654,3,[xProx]PeterGriffin,2861,0,0,1,1,0.0%,21m
20654,3,[ZergCo]FANTOM,2861,0,0,3,3,0.0%,16m
20691,2,Alebrant,2860,1556,196,169,365,53.7%,19m
20691,2,trainspăt,2860,1530,156,140,296,52.7%,14m
20691,2,Smart,2860,1413,79,69,148,53.4%,3m
20691,2,[b0O0n]DrLove,2860,1007,48,40,88,54.5%,14m
20691,2,Marmut,2860,756,41,46,87,47.1%,11m
20691,2,magikis,2860,596,25,19,44,56.8%,13m
20691,3,cosmicbaby,2860,520,18,20,38,47.4%,21m
20691,3,[voodtr]XeForcex,2860,332,13,9,22,59.1%,19m
20691,2,Zpeon,2860,368,13,19,32,40.6%,12m
20691,2,KingEdward,2860,334,11,18,29,37.9%,19m
20691,2,Remtech,2860,272,8,12,20,40.0%,20m
20691,3,Maggot,2860,210,6,5,11,54.5%,16m
20691,3,suppedans,2860,86,4,2,6,66.7%,13m
20691,3,[PatPat]Sox,2860,90,4,4,8,50.0%,19m
20691,3,bebel,2860,116,4,4,8,50.0%,19m
20691,3,Saw,2860,120,4,5,9,44.4%,5m
20691,3,DLG,2860,118,3,0,3,100.0%,19m
20691,3,NizioR,2860,60,3,1,4,75.0%,4m
20691,3,snakedude,2860,0,3,2,5,60.0%,4m
20691,2,Deervar,2860,0,3,3,6,50.0%,43m
20691,2,[Traxen]Space,2860,129,3,4,7,42.9%,5m
20691,1,tomic,2860,97,3,4,7,42.9%,11m
20691,3,[holyJ]psst,2860,30,2,0,2,100.0%,9m
20691,3,sirMax,2860,58,2,3,5,40.0%,10m
20691,3,RaptorHavx,2860,0,1,0,1,100.0%,3m
20691,3,[Шта]Xren,2860,0,1,0,1,100.0%,13m
20691,3,[OLDbad]MatejSK,2860,0,1,1,2,50.0%,9m
20691,1,[ExTr1m]Wizardio,2860,0,0,2,2,0.0%,14m
20719,2,uNgeheuer,2859,1297,134,119,253,53.0%,21m
20719,3,General,2859,1538,120,111,231,51.9%,10m
20719,3,Riccio,2859,1545,114,102,216,52.8%,19m
20719,2,Fridge,2859,1329,76,52,128,59.4%,10m
20719,3,Milosovich,2859,637,66,41,107,61.7%,22m
20719,1,CONTAAAAACT,2859,868,46,47,93,49.5%,9m
20719,2,MasoSamurai,2859,906,40,36,76,52.6%,5m
20719,2,Bulves,2859,790,36,34,70,51.4%,28m
20719,3,THEBEST,2859,313,22,22,44,50.0%,7m
20719,3,hefastagon,2859,444,18,13,31,58.1%,9m
20719,2,Piet,2859,430,16,14,30,53.3%,12m
20719,3,[Cigar]TomRipley,2859,354,14,10,24,58.3%,16m
20719,3,[Unfair]NiciciHGK,2859,253,14,10,24,58.3%,20m
20719,3,Uthroy,2859,285,11,9,20,55.0%,5m
20719,2,BeliboOn,2859,250,10,9,19,52.6%,21m
20719,3,argewolen,2859,168,9,8,17,52.9%,3m
20719,2,[WarBG]Michał,2859,120,7,7,14,50.0%,27m
20719,3,[BWArmy]PandaRoux,2859,148,6,4,10,60.0%,16m
20719,2,Humiliater,2859,143,6,5,11,54.5%,9m
20719,1,StrykerLV,2859,97,5,3,8,62.5%,14m
20719,3,Destroyer,2859,150,5,6,11,45.5%,7m
20719,2,[ExTr1m]Killmonger,2859,0,3,2,5,60.0%,27m
20719,3,ChickenBOSS,2859,58,3,3,6,50.0%,19m
20719,2,xazam,2859,48,2,1,3,66.7%,18m
20719,3,Anticancer,2859,30,2,1,3,66.7%,7m
20719,1,[EMAA]martyKK,2859,97,2,2,4,50.0%,1h
20719,3,Farfocel,2859,30,2,2,4,50.0%,14m
20719,3,[ЗЕRGТV]Sunshine,2859,58,2,3,5,40.0%,21m
20719,3,[Admral]DimonZero,2859,0,1,0,1,100.0%,13m
20719,3,CooperUA,2859,0,1,0,1,100.0%,17m
20719,3,kApUtt,2859,0,1,0,1,100.0%,16m
20719,3,Ferdinand,2859,0,1,1,2,50.0%,5m
20719,2,Redfield,2859,0,1,1,2,50.0%,30m
20719,2,vinovi,2859,30,1,7,8,12.5%,13m
20719,3,Emialis,2859,0,0,1,1,0.0%,22m
20719,2,vederko,2859,0,0,1,1,0.0%,12m
20719,3,[LSPs]Stimpack,2859,0,0,2,2,0.0%,23m
20719,3,Encephala,2859,0,0,2,2,0.0%,9m
20757,3,Igorr,2858,1121,129,109,238,54.2%,5m
20757,3,MiQuan,2858,1463,97,98,195,49.7%,10m
20757,3,mrDetroid,2858,1274,71,49,120,59.2%,21m
20757,3,zeALOT,2858,706,71,60,131,54.2%,18m
20757,3,Eddyks,2858,1472,69,61,130,53.1%,18m
20757,3,[ESMC]Пивас,2858,1227,64,34,98,65.3%,17m
20757,2,Nazgul,2858,795,49,54,103,47.6%,9m
20757,2,Rostik,2858,1113,45,43,88,51.1%,5m
20757,3,FoO,2858,906,42,35,77,54.5%,6m
20757,2,Ilyas,2858,326,41,43,84,48.8%,13m
20757,2,Nàzghur,2858,823,34,29,63,54.0%,13m
20757,2,OldGameBoy,2858,689,27,25,52,51.9%,17m
20757,1,jaakkome,2858,590,20,29,49,40.8%,9m
20757,2,Lulubalu,2858,129,18,15,33,54.5%,2m
20757,3,WindWalker,2858,316,14,12,26,53.8%,2m
20757,3,MrGold,2858,429,14,12,26,53.8%,22m
20757,3,[Fnatik]Арсанис,2858,408,14,15,29,48.3%,10m
20757,2,Ultra,2858,258,11,10,21,52.4%,16m
20757,3,Permabanned,2858,218,10,5,15,66.7%,5m
20757,2,Epimetheus,2858,238,9,13,22,40.9%,5m
20757,1,Maple,2858,161,6,4,10,60.0%,12m
20757,3,[ISW]theKING,2858,58,3,2,5,60.0%,20m
20757,3,[Petrиs]Gor,2858,86,3,3,6,50.0%,9m
20757,3,[TOath]Adagio,2858,62,3,4,7,42.9%,12m
20757,1,Jaspman,2858,0,1,0,1,100.0%,45m
20757,3,SyndrØme,2858,0,1,1,2,50.0%,6m
20757,1,KaptnCat,2858,0,0,1,1,0.0%,17m
20757,3,[51RUB]llllllllllll,2858,0,0,2,2,0.0%,18m
20785,3,Soap,2857,1011,176,174,350,50.3%,5m
20785,3,Drop,2857,1281,73,73,146,50.0%,11m
20785,2,alex,2857,1524,61,60,121,50.4%,9m
20785,2,Protosexual,2857,1094,42,42,84,50.0%,1m
20785,3,[XF71]Ich,2857,1102,37,50,87,42.5%,13m
20785,2,Danil,2857,940,33,39,72,45.8%,22m
20785,2,HTRON,2857,693,28,24,52,53.8%,9m
20785,3,shadowwolf,2857,468,20,13,33,60.6%,19m
20785,3,Vulture,2857,411,16,13,29,55.2%,19m
20785,2,[HeiTim]Schokobubi,2857,298,13,11,24,54.2%,13m
20785,2,[Mmkay]Tossen,2857,239,10,10,20,50.0%,2m
20785,1,iveseenbiggr,2857,204,8,8,16,50.0%,10m
20785,3,FAKER,2857,232,8,8,16,50.0%,10m
20785,3,SuperMango,2857,192,7,7,14,50.0%,5m
20785,3,FuzzyWuzzy,2857,210,6,8,14,42.9%,34m
20785,3,Xerolis,2857,142,5,4,9,55.6%,18m
20785,1,Tsu,2857,96,5,5,10,50.0%,1h
20785,3,budapest,2857,0,4,1,5,80.0%,9m
20785,1,Святейший,2857,153,4,12,16,25.0%,21m
20785,3,Sylva,2857,90,3,3,6,50.0%,5m
20785,1,[No06]Xenon,2857,0,1,0,1,100.0%,14m
20785,1,IPxGhost,2857,48,1,1,2,50.0%,1h
20785,2,Gorbatsjof,2857,88,1,3,4,25.0%,2m
20785,1,interest,2857,34,1,4,5,20.0%,31m
20785,3,[gold1]JcShadow,2857,0,0,1,1,0.0%,18m
20785,3,[sgЫ]vanyabasher,2857,0,0,1,1,0.0%,1h
20785,2,RedStrike,2857,0,0,6,6,0.0%,10m
20812,2,Desperado,2856,1573,274,249,523,52.4%,5m
20812,2,EvenLonger,2856,1468,155,148,303,51.2%,9m
20812,3,[zukaCo]Ghost,2856,1543,103,90,193,53.4%,19m
20812,2,Fule,2856,1575,81,77,158,51.3%,9m
20812,2,Ungraceful,2856,590,77,71,148,52.0%,16m
20812,3,СКОТЧ,2856,1239,66,57,123,53.7%,11m
20812,2,Radalon,2856,1430,60,56,116,51.7%,19m
20812,3,SoZ,2856,500,52,44,96,54.2%,5m
20812,3,MamTom,2856,568,32,24,56,57.1%,11m
20812,3,darthcyril,2856,476,22,12,34,64.7%,21m
20812,3,LosTinWooDs,2856,560,22,21,43,51.2%,19m
20812,3,Alexeenka,2856,539,20,16,36,55.6%,19m
20812,3,bogiman,2856,453,18,10,28,64.3%,20m
20812,2,Darzales,2856,174,15,15,30,50.0%,16m
20812,1,Drumhorse,2856,332,12,24,36,33.3%,17m
20812,2,deadlyKiss,2856,256,8,11,19,42.1%,5m
20812,3,HandOfGodz,2856,202,7,7,14,50.0%,23m
20812,2,Warrielord,2856,161,6,1,7,85.7%,6m
20812,3,DarkShadow,2856,60,3,1,4,75.0%,3m
20812,2,Niggh,2856,0,3,2,5,60.0%,27m
20812,3,Michcik,2856,0,3,2,5,60.0%,18m
20812,3,[Silvеr]Izomorf,2856,0,3,2,5,60.0%,5m
20812,3,[RoRSC]JHawKY,2856,86,3,4,7,42.9%,22m
20812,3,Ugnetatel,2856,144,3,4,7,42.9%,10m
20812,2,Kotyara,2856,60,3,6,9,33.3%,3m
20812,2,Spocken,2856,91,2,0,2,100.0%,41m
20812,2,bengbengezpz,2856,88,2,1,3,66.7%,16m
20812,3,Tomatenmark,2856,97,2,3,5,40.0%,1h
20812,3,[SCEUTR]BlueHawk,2856,0,1,0,1,100.0%,19m
20812,3,NoCry,2856,0,1,0,1,100.0%,2m
20812,2,Escobar,2856,0,1,3,4,25.0%,1h
20812,2,Ganton,2856,48,1,5,6,16.7%,46m
20812,2,[K4w4iy]Makeja,2856,30,1,10,11,9.1%,16m
20812,3,[KkzZ]kouzin,2856,0,0,1,1,0.0%,21m
20812,3,Gaston,2856,0,0,1,1,0.0%,21m
20812,3,Joe,2856,0,0,1,1,0.0%,3m
20812,3,[GSAL]Simson,2856,0,0,1,1,0.0%,6m
20812,3,Azimor,2856,0,0,3,3,0.0%,5m
20812,3,Chester,2856,0,0,4,4,0.0%,12m
20851,2,gabro,2855,576,23,24,47,48.9%,13m
20851,3,WoN,2855,532,20,14,34,58.8%,19m
20851,3,Tattletale,2855,458,19,16,35,54.3%,21m
20851,3,[NCtk]Rage,2855,508,19,20,39,48.7%,22m
20851,3,MozgToWoda,2855,356,13,8,21,61.9%,13m
20851,3,[BM0]redecs,2855,354,13,12,25,52.0%,2m
20851,3,[xWOCx]VMox,2855,318,11,9,20,55.0%,2m
20851,3,SuzzyGAMER,2855,188,7,6,13,53.8%,5m
20851,3,Madara,2855,148,7,7,14,50.0%,5m
20851,1,Maliss,2855,114,6,5,11,54.5%,23m
20851,1,Domovoi,2855,167,5,5,10,50.0%,15m
20851,3,Kushtro,2855,88,4,5,9,44.4%,7m
20851,3,DeTrinite,2855,86,3,6,9,33.3%,20m
20851,3,Valdemar,2855,89,2,0,2,100.0%,22m
20851,3,Philiq,2855,30,2,1,3,66.7%,23m
20851,1,Jimbo,2855,123,2,4,6,33.3%,20m
20851,3,Убивец,2855,58,2,6,8,25.0%,4m
20851,3,CHPOKER,2855,30,1,1,2,50.0%,11m
20851,1,[G500]Uveryugly,2855,48,1,2,3,33.3%,30m
20851,1,Denis,2855,0,0,1,1,0.0%,3m
20851,3,Miracle,2855,0,0,1,1,0.0%,2m
20851,3,Aone,2855,0,0,2,2,0.0%,19m
20873,3,Whitekiller,2854,1521,207,207,414,50.0%,10m
20873,2,Master,2854,1531,161,150,311,51.8%,12m
20873,3,Reckoner,2854,1443,122,109,231,52.8%,4m
20873,3,Keter,2854,758,72,50,122,59.0%,2m
20873,2,[galler]bundran,2854,1158,66,61,127,52.0%,5m
20873,2,Scythy,2854,1046,59,56,115,51.3%,16m
20873,3,Neptune,2854,976,59,61,120,49.2%,19m
20873,3,Sorry,2854,1458,54,54,108,50.0%,27m
20873,2,[AOTW]Gaben,2854,720,42,35,77,54.5%,19m
20873,3,bvdtrp,2854,576,22,22,44,50.0%,27m
20873,3,BlitzSteal,2854,548,20,14,34,58.8%,4m
20873,2,Daemon,2854,518,18,25,43,41.9%,6m
20873,2,Vendrus,2854,352,15,13,28,53.6%,19m
20873,3,Chezz,2854,292,11,4,15,73.3%,2m
20873,3,ZOODARK,2854,322,11,6,17,64.7%,12m
20873,1,tole,2854,348,11,19,30,36.7%,21m
20873,2,fubarcookie,2854,204,8,11,19,42.1%,19m
20873,3,Bugstube,2854,234,7,6,13,53.8%,21m
20873,2,Omarjuul,2854,203,7,6,13,53.8%,6m
20873,2,llllllllllll,2854,164,6,7,13,46.2%,21m
20873,3,[PLA2N]GULIVER,2854,164,5,0,5,100.0%,19m
20873,1,SodyBoy,2854,48,4,4,8,50.0%,1h
20873,3,IamWishBan,2854,30,2,0,2,100.0%,22m
20873,3,[FXs]Devitca,2854,30,2,4,6,33.3%,21m
20873,2,Dell,2854,60,2,7,9,22.2%,12m
20873,3,nikilebrave,2854,0,1,0,1,100.0%,7m
20873,1,[ABot]Guidnome,2854,48,1,2,3,33.3%,41m
20873,3,AlexPUA,2854,0,1,2,3,33.3%,6m
20873,3,Acctank,2854,0,0,1,1,0.0%,3m
20873,3,DarkWood,2854,0,0,1,1,0.0%,16m
20873,2,ENDERFOKUS,2854,0,0,1,1,0.0%,30m
20873,3,Voodoo,2854,0,0,2,2,0.0%,14m
20873,2,[CIGC]MrSmi,2854,0,0,3,3,0.0%,10m
20873,3,miguegr,2854,0,0,3,3,0.0%,4m
20873,2,Bonus,2854,0,0,5,5,0.0%,19m
20908,3,Raph,2853,1616,314,296,610,51.5%,2m
20908,3,nacho,2853,1380,208,194,402,51.7%,14m
20908,2,SWorm,2853,1142,190,179,369,51.5%,14m
20908,1,dopyou,2853,1579,137,145,282,48.6%,12m
20908,3,Nashki,2853,1128,91,73,164,55.5%,13m
20908,2,[Dralag]sMall,2853,1306,84,84,168,50.0%,10m
20908,1,Rolando,2853,722,45,48,93,48.4%,3m
20908,3,Rocinante,2853,736,32,23,55,58.2%,13m
20908,2,MrSadness,2853,686,30,28,58,51.7%,5m
20908,3,[sissis]reeetac,2853,670,26,22,48,54.2%,14m
20908,3,rect,2853,487,24,6,30,80.0%,6m
20908,1,youbouyou,2853,696,23,38,61,37.7%,9m
20908,3,Iron,2853,554,20,19,39,51.3%,4m
20908,3,[ENU]Soviarc,2853,466,18,11,29,62.1%,10m
20908,2,HeKTiKTiMeS,2853,432,18,16,34,52.9%,10m
20908,3,Mortened,2853,308,13,8,21,61.9%,2m
20908,2,[Bitfix]Xeno,2853,390,13,22,35,37.1%,2m
20908,2,TEMPLARIO,2853,232,9,12,21,42.9%,3m
20908,1,Baltazar,2853,283,8,7,15,53.3%,46m
20908,2,ShaddamV,2853,266,8,12,20,40.0%,12m
20908,3,Arteezy,2853,162,6,4,10,60.0%,2m
20908,3,[KTFsC]mVmMycenaean,2853,172,6,6,12,50.0%,19m
20908,1,Miguel,2853,116,4,3,7,57.1%,36m
20908,3,Error,2853,30,4,3,7,57.1%,27m
20908,3,Pugwash,2853,133,4,5,9,44.4%,11m
20908,2,qinyme,2853,164,4,8,12,33.3%,7m
20908,3,[FLYTT]IIIIIIIIIIII,2853,58,3,1,4,75.0%,21m
20908,3,DrouidX,2853,137,3,2,5,60.0%,8m
20908,3,dimako,2853,0,3,6,9,33.3%,1h
20908,1,Silverhead,2853,120,2,2,4,50.0%,43m
20908,3,[8SAOM]Pitju,2853,30,2,2,4,50.0%,8m
20908,3,[SunTry]eugenebee,2853,30,2,2,4,50.0%,23m
20908,3,Stop,2853,30,2,2,4,50.0%,9m
20908,2,Shii,2853,0,2,3,5,40.0%,1h
20908,3,bapt,2853,0,1,0,1,100.0%,22m
20908,3,[PAABT]ifjureviczky,2853,0,1,0,1,100.0%,33m
20908,3,[ISIC]STALIN,2853,0,1,0,1,100.0%,19m
20908,3,[Тribe]Lutik,2853,0,1,1,2,50.0%,3m
20908,3,Lokiknight,2853,30,1,1,2,50.0%,4m
20908,3,Cheesecake,2853,30,1,3,4,25.0%,3m
20908,3,Lapserdak,2853,0,0,1,1,0.0%,21m
20908,3,[JORJOS]GekkeGerrit,2853,0,0,2,2,0.0%,19m
20950,1,klaxx,2852,1601,513,506,1019,50.3%,27m
20950,3,[EFD]Nei,2852,1513,131,134,265,49.4%,27m
20950,2,Methusalam,2852,1521,85,79,164,51.8%,12m
20950,2,kalyosik,2852,1518,83,79,162,51.2%,12m
20950,2,Barakuda,2852,494,66,54,120,55.0%,21m
20950,3,SubZero,2852,1508,63,49,112,56.2%,4m
20950,3,Cyberxsgt,2852,1184,62,53,115,53.9%,13m
20950,1,num,2852,768,42,46,88,47.7%,23m
20950,2,Kokant,2852,922,40,39,79,50.6%,16m
20950,2,crazycorn,2852,889,38,29,67,56.7%,7m
20950,2,SailorPorky,2852,607,24,23,47,51.1%,9m
20950,3,[fidži]FestiveOwl,2852,472,19,16,35,54.3%,3m
20950,1,Dorminator,2852,385,17,13,30,56.7%,17m
20950,1,BuzZ,2852,331,10,18,28,35.7%,6m
20950,3,[NТB]Mito,2852,246,8,8,16,50.0%,7m
20950,3,[OmDi]ALShep,2852,179,7,6,13,53.8%,5m
20950,2,Hazi,2852,201,7,9,16,43.8%,9m
20950,2,[Corbi]MEGAKING,2852,58,6,5,11,54.5%,5m
20950,3,therock,2852,176,5,4,9,55.6%,13m
20950,3,[TheDOH]Abandonation,2852,90,4,6,10,40.0%,19m
20950,1,Mark,2852,144,3,0,3,100.0%,1h
20950,3,FearKillsYou,2852,58,3,3,6,50.0%,13m
20950,3,DemaGorgone,2852,58,2,3,5,40.0%,20m
20950,3,Kenzored,2852,0,1,0,1,100.0%,5m
20950,3,MhAuRg,2852,0,1,0,1,100.0%,22m
20950,2,KDE,2852,0,1,0,1,100.0%,48m
20950,3,DeadlyPants,2852,0,1,0,1,100.0%,5m
20950,3,[KTQ]Uskhan,2852,30,1,1,2,50.0%,11m
20950,3,Promil,2852,0,1,2,3,33.3%,4m
20950,2,Envus,2852,0,1,3,4,25.0%,12m
20950,3,[x67x]ROHoZ,2852,0,0,1,1,0.0%,10m
20950,2,Андрей,2852,0,0,1,1,0.0%,26m
20950,3,gogo,2852,0,0,3,3,0.0%,11m
20983,2,Pete,2851,957,269,256,525,51.2%,12m
20983,2,ЗаРаЗа,2851,1540,170,155,325,52.3%,4m
20983,3,[BUNZ]Trare,2851,759,40,31,71,56.3%,9m
20983,3,BiggyNoobie,2851,776,38,10,48,79.2%,14m
20983,3,Mózes,2851,684,30,20,50,60.0%,21m
20983,2,DaimonTNT,2851,374,26,25,51,51.0%,22m
20983,3,Chubaka,2851,244,18,13,31,58.1%,20m
20983,2,Desperado,2851,252,12,7,19,63.2%,22m
20983,3,[LESeV]Savila,2851,212,8,9,17,47.1%,4m
20983,2,Zedou,2851,235,8,11,19,42.1%,42m
20983,3,[Baise]sjonkel,2851,192,7,4,11,63.6%,19m
20983,3,Disrupz,2851,172,7,5,12,58.3%,2m
20983,3,Jaguar,2851,187,5,2,7,71.4%,16m
20983,3,AtzeBrauner,2851,0,3,2,5,60.0%,8m
20983,3,IIIIIIIIIIII,2851,0,3,2,5,60.0%,28m
20983,2,AlmostKiwi,2851,95,3,3,6,50.0%,19m
20983,2,ZEIT,2851,88,3,4,7,42.9%,5m
20983,3,[WADER]BigDiablo,2851,0,1,0,1,100.0%,6m
20983,3,Mekin,2851,30,1,3,4,25.0%,22m
20983,1,Wolfie,2851,0,0,1,1,0.0%,20m
20983,3,Justus,2851,0,0,1,1,0.0%,13m
21004,2,Pardal,2850,1514,155,153,308,50.3%,11m
21004,2,Vasilich,2850,1470,119,121,240,49.6%,22m
21004,1,Арториус,2850,1032,41,46,87,47.1%,15m
21004,2,loom,2850,682,26,24,50,52.0%,9m
21004,1,[LMBD]canbozkurt,2850,542,22,33,55,40.0%,3m
21004,3,КозакШвайка,2850,170,13,13,26,50.0%,7m
21004,2,guilldenante,2850,347,12,13,25,48.0%,6m
21004,1,LIPA,2850,110,8,8,16,50.0%,10m
21004,3,Smile,2850,195,8,10,18,44.4%,26m
21004,2,brik,2850,206,8,16,24,33.3%,16m
21004,3,[NTZ]SlimdeSlim,2850,146,6,4,10,60.0%,19m
21004,2,Chameleon,2850,142,6,9,15,40.0%,14m
21004,3,Luckers,2850,30,5,2,7,71.4%,19m
21004,3,SugarPuff,2850,195,5,4,9,55.6%,28m
21004,2,BlackSmith,2850,148,5,10,15,33.3%,9m
21004,1,[PLMRS]Alex,2850,162,4,1,5,80.0%,27m
21004,2,AleBat,2850,48,4,3,7,57.1%,1h
21004,2,[AirS]RTool,2850,0,3,3,6,50.0%,1h
21004,3,[PLSaD]AmazinG,2850,30,2,1,3,66.7%,23m
21004,1,Rumham,2850,97,2,6,8,25.0%,7m
21004,3,DevilPlague,2850,0,1,0,1,100.0%,19m
21004,3,Someone,2850,30,1,1,2,50.0%,11m
21004,3,[IceCub]lorakan,2850,0,0,1,1,0.0%,2m
21004,3,PMmisi,2850,0,0,3,3,0.0%,13m
21028,2,[ZIN]Epizon,2849,1539,78,70,148,52.7%,6m
21028,2,upin,2849,728,65,65,130,50.0%,6m
21028,3,Zchrtchx,2849,365,57,43,100,57.0%,21m
21028,2,Repton,2849,794,40,38,78,51.3%,11m
21028,2,ANTIGAN,2849,652,25,32,57,43.9%,11m
21028,3,GodsRage,2849,292,22,16,38,57.9%,2m
21028,3,JohnnyB,2849,413,20,8,28,71.4%,19m
21028,3,Momus,2849,246,19,19,38,50.0%,2m
21028,2,Zalupiy,2849,427,18,21,39,46.2%,8m
21028,3,Razihel,2849,416,16,15,31,51.6%,4m
21028,1,Gavr,2849,335,13,13,26,50.0%,23m
21028,2,FWarLord,2849,259,11,7,18,61.1%,38m
21028,3,Рентген,2849,308,11,12,23,47.8%,11m
21028,1,tacocat,2849,286,10,6,16,62.5%,31m
21028,2,Tropiņš,2849,288,10,13,23,43.5%,16m
21028,3,Scorpion,2849,194,6,3,9,66.7%,22m
21028,2,[DSKz]SnowDy,2849,142,6,7,13,46.2%,2m
21028,1,NevadA,2849,130,5,3,8,62.5%,24m
21028,3,[rect]ShadowMurloc,2849,0,4,1,5,80.0%,18m
21028,2,HaXyuNaDa,2849,159,4,2,6,66.7%,37m
21028,3,Octava,2849,117,3,0,3,100.0%,22m
21028,3,BlAcKxSheepy,2849,139,3,1,4,75.0%,8m
21028,3,Steve,2849,58,3,1,4,75.0%,27m
21028,3,[Drachw]Seburzal,2849,58,3,2,5,60.0%,22m
21028,3,SoBoTi,2849,94,3,3,6,50.0%,28m
21028,3,Heretic,2849,105,3,3,6,50.0%,2m
21028,2,[PrAy8T]ChetBaker,2849,88,2,2,4,50.0%,3m
21028,3,[Daos]DaosStyX,2849,58,2,2,4,50.0%,19m
21028,3,FraktoloID,2849,58,2,3,5,40.0%,3m
21028,2,Hannibal,2849,0,2,4,6,33.3%,4m
21028,3,[JDJDJD]Cyklopata,2849,0,1,0,1,100.0%,13m
21028,3,[SPEKTR]Ryrkera,2849,0,1,0,1,100.0%,2m
21028,3,Neal,2849,94,1,1,2,50.0%,2m
21028,3,reptiloid,2849,30,1,3,4,25.0%,6m
21028,3,Oksinus,2849,30,1,3,4,25.0%,4m
21028,3,NOD,2849,30,1,5,6,16.7%,18m
21028,2,Rokatansky,2849,30,1,8,9,11.1%,3m
21028,3,JinS,2849,0,0,1,1,0.0%,6m
21028,3,Erika,2849,0,0,1,1,0.0%,22m
21028,3,CCF,2849,0,0,2,2,0.0%,28m
21028,3,[Србија]LukyS,2849,0,0,2,2,0.0%,21m
21069,1,Armageddon,2848,1215,292,288,580,50.3%,10m
21069,1,[1FU2]Hoba,2848,1552,238,236,474,50.2%,23m
21069,2,xhörnchen,2848,599,100,93,193,51.8%,19m
21069,2,Enymus,2848,1121,77,72,149,51.7%,11m
21069,3,MicroMaschin,2848,1031,71,46,117,60.7%,7m
21069,1,Largon,2848,1357,69,81,150,46.0%,20m
21069,2,Ракефыпамфт,2848,824,32,34,66,48.5%,17m
21069,3,GHOST,2848,698,29,20,49,59.2%,22m
21069,3,MiChAtLLO,2848,506,26,8,34,76.5%,4m
21069,3,MuddaFukka,2848,487,19,11,30,63.3%,6m
21069,3,AGROHIM,2848,504,19,14,33,57.6%,18m
21069,1,karkoss,2848,610,19,32,51,37.3%,6m
21069,3,Doughboy,2848,426,18,19,37,48.6%,10m
21069,3,[EESC]TheFunnyRage,2848,357,16,13,29,55.2%,6m
21069,3,Dreamweaver,2848,492,16,20,36,44.4%,20m
21069,2,Terran,2848,396,15,19,34,44.1%,11m
21069,1,[BYOS]Phobos,2848,345,14,5,19,73.7%,26m
21069,2,RomUluS,2848,308,11,13,24,45.8%,12m
21069,1,troy,2848,98,7,7,14,50.0%,6m
21069,1,[ZLT78]Lyøs,2848,193,6,6,12,50.0%,15m
21069,1,DNHAL,2848,121,5,4,9,55.6%,20m
21069,3,[ALCAs]Troniak,2848,146,5,5,10,50.0%,9m
21069,3,Nederplebs,2848,144,5,10,15,33.3%,13m
21069,3,lucinator,2848,118,4,12,16,25.0%,21m
21069,3,[WOO]StJohannes,2848,58,3,2,5,60.0%,5m
21069,3,NetShadowXX,2848,0,3,2,5,60.0%,20m
21069,1,makson,2848,0,3,3,6,50.0%,39m
21069,1,RusWillis,2848,142,3,5,8,37.5%,39m
21069,1,Lucy,2848,88,3,10,13,23.1%,2m
21069,3,ThunderJønes,2848,30,2,1,3,66.7%,27m
21069,3,NoBrain,2848,94,2,1,3,66.7%,13m
21069,3,[CC4N]Finwecillo,2848,92,2,4,6,33.3%,4m
21069,3,Markinhos,2848,30,1,1,2,50.0%,23m
21069,2,Azazal,2848,0,1,1,2,50.0%,1h
21069,3,WePo,2848,0,0,1,1,0.0%,27m
21069,3,Téod,2848,0,0,2,2,0.0%,19m
21105,1,[IIOGII]Stach,2847,1577,204,200,404,50.5%,11m
21105,2,[eNinj]Jeddie,2847,838,161,157,318,50.6%,14m
21105,2,marcin,2847,1272,140,128,268,52.2%,14m
21105,1,[Waifus]Tekki,2847,1591,99,106,205,48.3%,27m
21105,2,zerginator,2847,1459,93,81,174,53.4%,11m
21105,2,SiMulat,2847,1349,84,62,146,57.5%,14m
21105,3,[GOLVAD]nAME,2847,1344,78,77,155,50.3%,2m
21105,2,Bojacastor,2847,1325,59,65,124,47.6%,12m
21105,3,Zerathun,2847,375,48,41,89,53.9%,4m
21105,1,kcoclemac,2847,1200,47,52,99,47.5%,23m
21105,2,[AciNoN]Viole,2847,761,29,27,56,51.8%,22m
21105,2,Tomás,2847,254,23,26,49,46.9%,22m
21105,3,cidil,2847,592,22,19,41,53.7%,14m
21105,2,Spleanedo,2847,576,21,28,49,42.9%,21m
21105,3,Yugima,2847,219,19,11,30,63.3%,6m
21105,2,Drew,2847,532,19,25,44,43.2%,10m
21105,3,SavinkOff,2847,433,18,9,27,66.7%,21m
21105,2,[MGK]Nicocotier,2847,448,18,18,36,50.0%,18m
21105,3,Glacius,2847,407,16,10,26,61.5%,7m
21105,3,[DNKСFТ]Zorian,2847,387,16,14,30,53.3%,19m
21105,2,[Sylph]ijsisglat,2847,356,13,14,27,48.1%,2m
21105,2,procus,2847,252,10,5,15,66.7%,5m
21105,3,notorix,2847,252,10,8,18,55.6%,19m
21105,3,Igor,2847,224,9,7,16,56.2%,16m
21105,3,Tamecles,2847,243,9,9,18,50.0%,1h
21105,3,[bqobd]nik,2847,224,8,7,15,53.3%,22m
21105,2,xeno,2847,240,8,15,23,34.8%,2m
21105,3,Sven,2847,212,6,6,12,50.0%,20m
21105,2,[WTFAQ]Talis,2847,0,4,1,5,80.0%,19m
21105,1,[ULTX]Orgismenos,2847,0,4,4,8,50.0%,3m
21105,3,[0108]Mathmagician,2847,58,3,2,5,60.0%,18m
21105,1,[MDEv8]XxMARIOxX,2847,48,2,0,2,100.0%,1h
21105,2,[HKmR]Ignaz,2847,0,2,3,5,40.0%,3m
21105,3,[ZЕRG7V]JohnnyBravo,2847,58,2,3,5,40.0%,19m
21105,3,[OPANA]BAURON,2847,58,2,3,5,40.0%,18m
21105,1,Stavr,2847,122,2,6,8,25.0%,11m
21105,3,CoronaVirus,2847,0,1,0,1,100.0%,6m
21105,3,Nergal,2847,0,1,0,1,100.0%,4m
21105,3,[NIK2]Cavman,2847,0,1,1,2,50.0%,18m
21105,3,lovefopotato,2847,30,1,1,2,50.0%,16m
21105,3,DrunkenGhost,2847,0,1,3,4,25.0%,19m
21105,3,Futada,2847,30,1,5,6,16.7%,4m
21105,2,BEN,2847,88,1,6,7,14.3%,19m
21105,2,[LDSC2]MrLechuza,2847,30,1,7,8,12.5%,2m
21105,3,Fragile,2847,0,0,1,1,0.0%,9m
21105,3,[IceCub]Призрак,2847,0,0,1,1,0.0%,12m
21105,3,DreamWeaver,2847,0,0,2,2,0.0%,19m
21105,3,[Xa]Zyklon,2847,0,0,3,3,0.0%,19m
21153,2,UltimateJJ,2846,1112,95,90,185,51.4%,20m
21153,3,Muffin,2846,1569,84,73,157,53.5%,3m
21153,3,Paunov,2846,1104,76,54,130,58.5%,2m
21153,2,DrGonzo,2846,1005,73,69,142,51.4%,5m
21153,2,RaptorKOF,2846,1220,54,54,108,50.0%,7m
21153,3,MrJack,2846,1149,50,41,91,54.9%,5m
21153,3,Djamonkin,2846,1028,49,29,78,62.8%,19m
21153,3,Cheriss,2846,364,38,24,62,61.3%,23m
21153,2,Shinypants,2846,982,35,41,76,46.1%,14m
21153,2,[PVRUS]MKstraiker,2846,802,33,34,67,49.3%,5m
21153,3,huylkabum,2846,731,31,23,54,57.4%,3m
21153,3,Trle,2846,594,31,26,57,54.4%,16m
21153,2,fgvyjmvgbyki,2846,674,29,29,58,50.0%,5m
21153,2,[ЕМPIRE]Mikhail,2846,597,23,23,46,50.0%,6m
21153,3,[Heroes]DrBram,2846,431,16,12,28,57.1%,19m
21153,2,[B7]Eldraim,2846,262,16,22,38,42.1%,19m
21153,3,vanek,2846,395,15,8,23,65.2%,20m
21153,3,Александр,2846,358,13,8,21,61.9%,2m
21153,3,[M1L]OlDCAXAR,2846,294,12,3,15,80.0%,17m
21153,2,Traex,2846,194,9,7,16,56.2%,5m
21153,3,Stav,2846,245,9,9,18,50.0%,19m
21153,3,Nik,2846,147,7,5,12,58.3%,26m
21153,1,EvilivE,2846,214,6,4,10,60.0%,15m
21153,3,TypicalPoc,2846,144,6,5,11,54.5%,10m
21153,2,[BTSM]Öcsike,2846,88,5,2,7,71.4%,5m
21153,3,Arobein,2846,168,5,3,8,62.5%,22m
21153,3,[BMaids]Keyyzer,2846,183,5,3,8,62.5%,6m
21153,2,VACvicent,2846,160,5,4,9,55.6%,29m
21153,2,Wazuup,2846,60,5,5,10,50.0%,5m
21153,3,Ferdi,2846,212,5,10,15,33.3%,3m
21153,3,[EloHel]NickDiaz,2846,58,3,0,3,100.0%,21m
21153,3,Monsterpig,2846,0,3,2,5,60.0%,13m
21153,3,Slayer,2846,0,3,2,5,60.0%,27m
21153,3,[BiR]CaptainPiss,2846,138,3,3,6,50.0%,6m
21153,3,[WpG]Pedipalpe,2846,90,3,8,11,27.3%,6m
21153,2,[3DE]JOSHAN,2846,0,1,0,1,100.0%,27m
21153,3,Teshkul,2846,93,1,1,2,50.0%,11m
21153,3,[ZERGSC]Саша,2846,30,1,1,2,50.0%,18m
21153,3,iliyakrop,2846,0,1,1,2,50.0%,21m
21153,1,LuckyTiger,2846,0,1,1,2,50.0%,41m
21153,1,trolinglife,2846,0,1,2,3,33.3%,1h
21153,3,IIIIIIIIIIII,2846,30,1,4,5,20.0%,14m
21153,1,[GlolD]MarScio,2846,0,0,1,1,0.0%,1h
21153,3,[RoadW]Deadlykiss,2846,0,0,2,2,0.0%,5m
21197,3,Mato,2845,1646,106,93,199,53.3%,23m
21197,3,DTWD,2845,554,84,69,153,54.9%,2m
21197,3,Opener,2845,492,64,48,112,57.1%,3m
21197,3,kjunik,2845,1486,57,56,113,50.4%,21m
21197,3,[SoSaGe]jorrrrris,2845,752,28,24,52,53.8%,20m
21197,3,Vargavaka,2845,288,27,18,45,60.0%,6m
21197,2,Ronhere,2845,730,26,33,59,44.1%,20m
21197,2,[Petrus]Trot,2845,496,18,17,35,51.4%,10m
21197,3,ViNcE,2845,452,16,17,33,48.5%,11m
21197,3,Dan,2845,418,16,18,34,47.1%,11m
21197,1,[LotPP]Loki,2845,265,9,5,14,64.3%,37m
21197,2,[FF88]WhiteBear,2845,95,4,2,6,66.7%,1h
21197,2,[QGC]Liridia,2845,0,3,2,5,60.0%,1h
21197,2,mrfurious,2845,0,3,3,6,50.0%,6m
21197,2,EMPEROR,2845,0,3,3,6,50.0%,36m
21197,2,Buga,2845,0,3,3,6,50.0%,4m
21197,3,Path,2845,94,3,3,6,50.0%,6m
21197,1,Najt,2845,121,3,5,8,37.5%,27m
21197,3,[FBDY]Thelvyn,2845,106,3,7,10,30.0%,28m
21197,3,[ƐRR0R]DanielC,2845,30,2,3,5,40.0%,6m
21197,3,AlexZen,2845,0,2,3,5,40.0%,8m
21197,3,[Bádzsó]nerelf,2845,30,2,4,6,33.3%,19m
21197,3,Nosfer,2845,0,1,1,2,50.0%,9m
21197,3,AHCImode,2845,0,0,1,1,0.0%,45m
21197,3,[KRATZA]TomRipley,2845,0,0,1,1,0.0%,10m
21222,3,PikingSod,2844,1572,177,161,338,52.4%,3m
21222,3,Zoomi,2844,1572,147,135,282,52.1%,18m
21222,3,radurco,2844,1359,70,59,129,54.3%,5m
21222,3,KillFirst,2844,1267,64,49,113,56.6%,11m
21222,3,FUZE,2844,526,58,38,96,60.4%,22m
21222,2,sark,2844,838,58,51,109,53.2%,19m
21222,3,RUSK,2844,1247,50,46,96,52.1%,6m
21222,2,Magic,2844,750,31,27,58,53.4%,9m
21222,1,[SKRRT]Michu,2844,879,31,36,67,46.3%,4m
21222,1,Maui,2844,624,21,31,52,40.4%,5m
21222,3,Icy,2844,375,17,13,30,56.7%,23m
21222,3,Deluxo,2844,422,17,15,32,53.1%,18m
21222,3,Beka,2844,406,17,16,33,51.5%,11m
21222,3,[GRATL]bananananana,2844,411,16,14,30,53.3%,15m
21222,3,Zebralol,2844,291,13,9,22,59.1%,4m
21222,3,Dyamorph,2844,295,11,5,16,68.8%,3m
21222,2,shmrckelzz,2844,205,8,8,16,50.0%,7m
21222,1,ruap,2844,193,7,5,12,58.3%,1h
21222,1,FlameArt,2844,171,7,6,13,53.8%,29m
21222,3,Dreamer,2844,200,7,8,15,46.7%,18m
21222,3,Kinkasun,2844,159,7,8,15,46.7%,13m
21222,3,NinjaBorn,2844,86,3,2,5,60.0%,21m
21222,1,Badgerfc,2844,0,3,3,6,50.0%,1h
21222,3,Curya,2844,117,2,1,3,66.7%,5m
21222,3,DICCBOY,2844,58,2,1,3,66.7%,11m
21222,3,OmarEightTwo,2844,0,1,0,1,100.0%,16m
21222,3,[СЛС]Артемундий,2844,30,1,1,2,50.0%,23m
21222,2,[FUGBM]Pfauen,2844,0,0,1,1,0.0%,8m
21222,2,ArQoNyqn,2844,0,0,1,1,0.0%,16m
21222,3,klotzbob,2844,0,0,1,1,0.0%,22m
21222,3,[UFOP]Link,2844,0,0,2,2,0.0%,16m
21222,3,[OrOfTP]Godzer,2844,0,0,2,2,0.0%,21m
21222,2,Lawrence,2844,0,0,2,2,0.0%,27m
21255,3,TrooperTi,2843,1587,123,105,228,53.9%,19m
21255,3,Stifler,2843,1377,110,88,198,55.6%,7m
21255,2,[4D]Philipp,2843,1492,106,92,198,53.5%,6m
21255,2,Ugion,2843,1602,98,72,170,57.6%,3m
21255,2,[OPStar]lkmcl,2843,741,98,81,179,54.7%,9m
21255,3,Hero,2843,1252,86,55,141,61.0%,18m
21255,2,Mencken,2843,488,72,58,130,55.4%,5m
21255,2,[Kicx]DVN,2843,751,59,69,128,46.1%,17m
21255,3,Kanapinis,2843,961,43,29,72,59.7%,28m
21255,2,Jawor,2843,813,41,33,74,55.4%,3m
21255,1,DelinJa,2843,696,22,35,57,38.6%,6m
21255,3,Hannibal,2843,328,21,12,33,63.6%,19m
21255,3,diidoxd,2843,496,20,14,34,58.8%,28m
21255,3,ниннзяяя,2843,505,20,15,35,57.1%,5m
21255,3,Gazkull,2843,362,13,7,20,65.0%,19m
21255,1,Yarkirs,2843,297,11,7,18,61.1%,47m
21255,3,Raynor,2843,255,11,14,25,44.0%,23m
21255,3,katsumoto,2843,256,9,10,19,47.4%,19m
21255,2,[Kormt]Karmatic,2843,88,6,6,12,50.0%,8m
21255,2,[CHPT]Ackimm,2843,184,6,7,13,46.2%,16m
21255,2,Silent,2843,181,6,10,16,37.5%,10m
21255,3,Naruto,2843,0,5,0,5,100.0%,13m
21255,2,buggang,2843,136,5,8,13,38.5%,9m
21255,3,CheeseKing,2843,143,4,1,5,80.0%,8m
21255,3,RUSnail,2843,0,4,1,5,80.0%,20m
21255,3,slosiss,2843,90,4,3,7,57.1%,27m
21255,2,TheONE,2843,96,3,3,6,50.0%,38m
21255,2,Mikhail,2843,0,3,3,6,50.0%,5m
21255,3,SmallManIsak,2843,90,3,3,6,50.0%,11m
21255,3,[TOMK]MarineKing,2843,0,1,0,1,100.0%,23m
21255,3,Elenfall,2843,0,1,0,1,100.0%,7m
21255,2,Finneguan,2843,0,1,1,2,50.0%,45m
21255,3,[ATLNBS]BattleKlaus,2843,30,1,3,4,25.0%,19m
21255,2,Echo,2843,30,1,7,8,12.5%,28m
21255,3,KaC,2843,0,0,1,1,0.0%,9m
21255,3,[QTcIub]AIphaStar,2843,0,0,1,1,0.0%,16m
21255,3,Salazar,2843,0,0,1,1,0.0%,17m
21255,3,ShockWave,2843,0,0,2,2,0.0%,14m
21255,3,kross,2843,0,0,2,2,0.0%,23m
21294,2,DiSneXia,2842,800,164,148,312,52.6%,8m
21294,2,Kurczak,2842,1436,143,133,276,51.8%,3m
21294,1,DPDV,2842,1586,137,137,274,50.0%,18m
21294,1,GancteR,2842,1420,100,108,208,48.1%,15m
21294,3,Umbra,2842,636,37,20,57,64.9%,9m
21294,3,[Ximic]МрачныйВорон,2842,682,36,34,70,51.4%,14m
21294,3,DeadlyShoe,2842,645,28,21,49,57.1%,22m
21294,3,[rus54]FSpell,2842,593,25,15,40,62.5%,9m
21294,3,[SergAt]SergBas,2842,587,23,20,43,53.5%,28m
21294,3,[R2GrMa]Gaudi,2842,447,18,10,28,64.3%,12m
21294,3,koschey,2842,450,17,17,34,50.0%,23m
21294,2,Skrippel,2842,487,17,17,34,50.0%,17m
21294,3,[PL4NCK]Kartrax,2842,397,16,8,24,66.7%,28m
21294,3,Pinguin,2842,303,10,8,18,55.6%,13m
21294,2,VdartHK,2842,294,10,15,25,40.0%,9m
21294,3,Lighty,2842,205,9,6,15,60.0%,4m
21294,2,[Eagls]Ocula,2842,236,7,7,14,50.0%,15m
21294,3,abandon,2842,92,7,9,16,43.8%,19m
21294,2,[RstE]Gogo,2842,187,6,4,10,60.0%,1h
21294,1,cap,2842,193,6,5,11,54.5%,32m
21294,3,anthy,2842,174,5,5,10,50.0%,17m
21294,3,[SofaB]Elwuudi,2842,108,4,7,11,36.4%,14m
21294,1,TwoStep,2842,0,3,4,7,42.9%,20m
21294,3,Пифф,2842,58,2,3,5,40.0%,23m
21294,2,[SLC01]Кростер,2842,0,1,0,1,100.0%,12m
21294,3,homerjay,2842,0,1,1,2,50.0%,9m
21294,3,[RLZT]BeerMishel,2842,30,1,1,2,50.0%,23m
21294,3,Mycelium,2842,0,1,4,5,20.0%,19m
21294,3,Veto,2842,0,0,1,1,0.0%,12m
21294,3,[αX]Tsuneo,2842,0,0,1,1,0.0%,16m
21324,3,aspokus,2841,1570,200,175,375,53.3%,12m
21324,3,MyraKaru,2841,1521,138,103,241,57.3%,7m
21324,3,[GhOsTh]dodo,2841,1112,113,106,219,51.6%,27m
21324,3,[Wick]IronHand,2841,1494,73,72,145,50.3%,19m
21324,3,OmegaRed,2841,976,67,59,126,53.2%,4m
21324,3,ramon,2841,1425,63,59,122,51.6%,6m
21324,3,[NUL2]LiquidGoofy,2841,870,48,36,84,57.1%,28m
21324,3,[M42]LAMULAGA,2841,587,42,39,81,51.9%,6m
21324,2,Weganian,2841,673,32,26,58,55.2%,19m
21324,2,Brainbug,2841,617,26,28,54,48.1%,12m
21324,3,Бабошин,2841,531,25,13,38,65.8%,28m
21324,2,Immortal,2841,578,24,24,48,50.0%,19m
21324,3,gunner,2841,435,23,7,30,76.7%,22m
21324,3,Erminatrash,2841,331,16,9,25,64.0%,6m
21324,2,[VUST]Spanker,2841,347,11,13,24,45.8%,16m
21324,2,[Arrows]dikkkkkkkkkk,2841,238,8,14,22,36.4%,6m
21324,3,Joystick,2841,176,7,7,14,50.0%,23m
21324,1,Skuld,2841,189,6,6,12,50.0%,1h
21324,1,kosEk,2841,145,5,5,10,50.0%,39m
21324,3,Hundetøcht,2841,90,4,9,13,30.8%,19m
21324,3,Ceder,2841,30,2,0,2,100.0%,22m
21324,3,Zeal,2841,30,2,0,2,100.0%,9m
21324,3,[IRLA]TheFinalBoss,2841,30,2,1,3,66.7%,14m
21324,1,rokkinor,2841,48,2,1,3,66.7%,41m
21324,3,dreamqi,2841,44,2,4,6,33.3%,6m
21324,3,icantwin,2841,0,1,0,1,100.0%,2m
21324,3,KremalıPasta,2841,30,1,1,2,50.0%,16m
21324,3,Toulk,2841,30,1,3,4,25.0%,20m
21324,3,Naturalplan,2841,0,1,4,5,20.0%,21m
21324,2,[L5EMC]MrCowboy,2841,0,0,1,1,0.0%,19m
21324,3,[ibex]Jonath,2841,0,0,1,1,0.0%,6m
21324,3,[ZERGTB]Meliodas,2841,0,0,1,1,0.0%,19m
21324,3,[IsTcI]cascanueces,2841,0,0,1,1,0.0%,11m
21324,3,[oooboy]prizma,2841,0,0,2,2,0.0%,6m
21324,3,DaniDinBanat,2841,0,0,4,4,0.0%,9m
21359,3,czerwik,2840,1604,103,90,193,53.4%,4m
21359,3,Rodolphe,2840,958,57,6,63,90.5%,4m
21359,3,Bongaco,2840,624,27,16,43,62.8%,15m
21359,2,ArtTeam,2840,696,27,29,56,48.2%,8m
21359,3,[hf4X4]Parapoomba,2840,572,22,14,36,61.1%,12m
21359,3,[OPANA]ЗDCAT,2840,514,20,17,37,54.1%,6m
21359,3,xoxol,2840,438,18,17,35,51.4%,21m
21359,3,[KyPe]ApiReb,2840,327,13,8,21,61.9%,22m
21359,3,Virtus,2840,215,7,6,13,53.8%,20m
21359,3,Terradani,2840,166,5,1,6,83.3%,10m
21359,3,setygur,2840,166,5,2,7,71.4%,12m
21359,2,Ramzelot,2840,165,5,4,9,55.6%,28m
21359,3,Restavrator,2840,0,4,1,5,80.0%,12m
21359,2,oleg,2840,0,4,2,6,66.7%,2m
21359,1,Avert,2840,97,4,4,8,50.0%,37m
21359,3,RJomega,2840,120,3,1,4,75.0%,4m
21359,2,Masteryul,2840,0,3,2,5,60.0%,4m
21359,2,Mäfinho,2840,0,3,2,5,60.0%,4m
21359,2,llllllllllll,2840,64,3,8,11,27.3%,23m
21359,3,DVP,2840,30,2,0,2,100.0%,9m
21359,3,Asbjorn,2840,30,2,2,4,50.0%,20m
21359,2,Krabsens,2840,0,2,3,5,40.0%,4m
21359,3,MaxWhite,2840,58,2,3,5,40.0%,13m
21359,3,Eclipse,2840,0,1,0,1,100.0%,17m
21359,1,[IAN]Davfrosk,2840,96,1,2,3,33.3%,7m
21359,2,[TAPG]Saphierus,2840,0,1,2,3,33.3%,9m
21359,3,[Unguad]TheM,2840,30,1,4,5,20.0%,22m
21359,3,Burger,2840,30,1,6,7,14.3%,18m
21359,2,dffjkl,2840,0,0,1,1,0.0%,33m
21359,3,[CCMC]Blbtailazcz,2840,0,0,1,1,0.0%,21m
21359,3,Ravnodushie,2840,0,0,1,1,0.0%,7m
21359,3,Tkach,2840,0,0,1,1,0.0%,16m
21359,3,smoke,2840,0,0,2,2,0.0%,15m
21359,3,SkriLeXX,2840,0,0,3,3,0.0%,7m
21393,2,[FCE]Фоброс,2839,1523,146,133,279,52.3%,12m
21393,3,ErO,2839,1571,107,79,186,57.5%,2m
21393,2,Zatrix,2839,1557,107,110,217,49.3%,13m
21393,2,Gunho,2839,1395,96,84,180,53.3%,4m
21393,3,GukiKOkd,2839,1111,63,55,118,53.4%,22m
21393,3,EarnsTurns,2839,1271,58,36,94,61.7%,10m
21393,3,kastey,2839,1101,51,40,91,56.0%,2m
21393,3,Alastor,2839,768,29,27,56,51.8%,6m
21393,3,buzz,2839,657,26,21,47,55.3%,6m
21393,3,WarChild,2839,557,22,24,46,47.8%,12m
21393,3,Rocket,2839,489,20,20,40,50.0%,22m
21393,3,elka,2839,425,17,13,30,56.7%,15m
21393,3,[AcSx]Bigrob,2839,462,17,15,32,53.1%,9m
21393,3,faulk,2839,375,16,5,21,76.2%,18m
21393,3,IIIIIIIIIIII,2839,374,14,13,27,51.9%,23m
21393,3,YwtDlDrizzt,2839,194,8,5,13,61.5%,17m
21393,3,Ransom,2839,277,8,13,21,38.1%,23m
21393,3,Finishco,2839,158,7,5,12,58.3%,17m
21393,2,gamadril,2839,156,7,9,16,43.8%,42m
21393,2,Vallar,2839,168,7,9,16,43.8%,13m
21393,1,Olaf,2839,145,6,4,10,60.0%,38m
21393,2,[AmW1]MexUp,2839,237,6,7,13,46.2%,1h
21393,2,[gkuk]moneymakerXA,2839,154,6,15,21,28.6%,6m
21393,3,[Lusi]ZigaZaga,2839,167,4,3,7,57.1%,10m
21393,3,sjaakbouw,2839,116,4,4,8,50.0%,14m
21393,2,Миратвора,2839,132,4,6,10,40.0%,5m
21393,1,okami,2839,97,3,1,4,75.0%,34m
21393,1,DemonKing,2839,145,3,2,5,60.0%,37m
21393,3,MonkeyDGobli,2839,30,3,4,7,42.9%,23m
21393,3,[SC2SA]silenceR,2839,30,2,0,2,100.0%,14m
21393,3,nikitarus,2839,30,2,1,3,66.7%,9m
21393,3,[RVGR]Teodorx,2839,58,2,1,3,66.7%,22m
21393,2,BlackSynergy,2839,0,2,3,5,40.0%,36m
21393,2,FunkyMonk,2839,0,1,0,1,100.0%,1h
21393,3,Kallisto,2839,0,1,4,5,20.0%,11m
21393,1,gglauge,2839,0,0,1,1,0.0%,9m
21393,3,Aiur,2839,0,0,1,1,0.0%,16m
21393,3,Basset,2839,0,0,1,1,0.0%,5m
21431,2,MaSeGe,2838,1291,297,292,589,50.4%,12m
21431,3,Knorri,2838,1602,206,196,402,51.2%,14m
21431,2,BloodMoon,2838,1277,90,87,177,50.8%,21m
21431,3,filapka,2838,680,41,27,68,60.3%,6m
21431,3,Skald,2838,794,37,22,59,62.7%,5m
21431,3,xthanathos,2838,802,33,31,64,51.6%,2m
21431,3,SleepyJoe,2838,585,21,18,39,53.8%,28m
21431,3,savier,2838,522,19,21,40,47.5%,4m
21431,3,Saigon,2838,447,18,13,31,58.1%,15m
21431,3,cooldevil,2838,416,17,15,32,53.1%,4m
21431,3,Franjesco,2838,211,12,8,20,60.0%,6m
21431,3,[Hаsu]LittleSerral,2838,292,10,14,24,41.7%,12m
21431,3,Starfighter,2838,225,8,2,10,80.0%,19m
21431,3,Chinmachine,2838,146,6,5,11,54.5%,3m
21431,3,Vedogor,2838,120,5,6,11,45.5%,3m
21431,2,Aqua,2838,180,5,10,15,33.3%,12m
21431,3,[SwiPP]Syrus,2838,147,4,2,6,66.7%,27m
21431,2,Suggetie,2838,0,3,2,5,60.0%,1h
21431,3,[TZD]ethEreal,2838,86,3,3,6,50.0%,16m
21431,3,HaGi,2838,0,3,3,6,50.0%,19m
21431,3,KiTe,2838,90,3,5,8,37.5%,14m
21431,2,[Agara]Astalavista,2838,0,2,2,4,50.0%,34m
21431,3,SombreroPlz,2838,30,1,1,2,50.0%,22m
21431,2,Alex,2838,48,1,2,3,33.3%,32m
21431,3,Lotus,2838,30,1,2,3,33.3%,9m
21431,2,LevenarK,2838,30,1,8,9,11.1%,7m
21431,1,[Darkia]Jinx,2838,0,0,1,1,0.0%,34m
21431,1,Nimboo,2838,0,0,1,1,0.0%,46m
21431,3,NightOwlvQ,2838,0,0,1,1,0.0%,2m
21431,3,TrapZ,2838,0,0,2,2,0.0%,22m
21431,3,Locket,2838,0,0,2,2,0.0%,5m
21462,1,Pedranis,2837,1591,134,144,278,48.2%,2m
21462,3,[U19]Next,2837,1569,93,81,174,53.4%,5m
21462,3,llllllllllll,2837,1435,87,65,152,57.2%,2m
21462,1,vanderov,2837,432,64,55,119,53.8%,9m
21462,2,Marsik,2837,1223,55,55,110,50.0%,6m
21462,3,Garryrage,2837,993,39,33,72,54.2%,4m
21462,3,sandod,2837,884,32,34,66,48.5%,16m
21462,3,SpONgE,2837,437,16,12,28,57.1%,22m
21462,3,Pacalpöri,2837,277,14,15,29,48.3%,20m
21462,2,[run]AnbaFER,2837,237,12,7,19,63.2%,23m
21462,2,zZyZzZz,2837,236,8,13,21,38.1%,16m
21462,2,Cvint,2837,234,8,13,21,38.1%,21m
21462,3,GGreg,2837,230,7,5,12,58.3%,4m
21462,2,[HZeS]GooseLuck,2837,204,6,4,10,60.0%,1h
21462,3,Vandrovec,2837,187,6,5,11,54.5%,27m
21462,3,SmoothDigger,2837,154,5,8,13,38.5%,18m
21462,3,[AHill]Wanze,2837,118,4,4,8,50.0%,5m
21462,3,Sawwww,2837,0,3,2,5,60.0%,13m
21462,3,[pipicl]Loommoks,2837,90,3,7,10,30.0%,18m
21462,3,[Heroes]WarpNate,2837,30,2,2,4,50.0%,10m
21462,3,Yøplait,2837,0,1,0,1,100.0%,19m
21462,3,[TKACK]StorM,2837,0,1,1,2,50.0%,20m
21462,3,ElGordo,2837,30,1,1,2,50.0%,4m
21462,2,DrogbaPower,2837,0,1,7,8,12.5%,5m
21462,2,piepmatz,2837,30,1,11,12,8.3%,14m
21462,3,Ger,2837,0,0,1,1,0.0%,19m
21488,3,Skorpion,2836,1494,124,106,230,53.9%,4m
21488,3,Vano,2836,1208,55,29,84,65.5%,5m
21488,3,lukibalboą,2836,864,36,25,61,59.0%,5m
21488,1,[fam1ly]RokFort,2836,744,30,39,69,43.5%,18m
21488,3,Nythos,2836,521,19,20,39,48.7%,2m
21488,3,phyto,2836,431,17,17,34,50.0%,20m
21488,3,Ivanovich,2836,343,16,9,25,64.0%,19m
21488,3,[IODIS]Broccolo,2836,418,16,9,25,64.0%,13m
21488,1,[DunC]TheRapey,2836,516,16,28,44,36.4%,21m
21488,3,Arbiter,2836,390,15,10,25,60.0%,28m
21488,3,Hkon,2836,368,12,14,26,46.2%,16m
21488,3,Lagfirst,2836,308,10,7,17,58.8%,5m
21488,3,StarMen,2836,285,9,8,17,52.9%,14m
21488,3,[cutcut]zero,2836,155,8,4,12,66.7%,15m
21488,2,DrArtanis,2836,232,8,11,19,42.1%,2m
21488,3,QuirkyToss,2836,209,7,4,11,63.6%,27m
21488,2,IamHungry,2836,216,7,14,21,33.3%,2m
21488,3,BlackStar,2836,188,6,2,8,75.0%,3m
21488,3,[TempPL]Jagniątko,2836,144,6,4,10,60.0%,3m
21488,3,Gilgamesh,2836,214,6,5,11,54.5%,21m
21488,3,[ITMA]talocazo,2836,142,4,1,5,80.0%,21m
21488,3,CrazyFox,2836,0,4,1,5,80.0%,10m
21488,3,CleansinG,2836,143,4,3,7,57.1%,30m
21488,3,Lazarus,2836,106,4,6,10,40.0%,47m
21488,2,SuperSquid,2836,86,4,10,14,28.6%,19m
21488,3,cliffhanger,2836,58,3,1,4,75.0%,12m
21488,3,Zykosis,2836,117,2,1,3,66.7%,21m
21488,3,Solaris,2836,60,2,4,6,33.3%,17m
21488,3,stabwound,2836,0,1,0,1,100.0%,2m
21488,1,Disease,2836,0,1,3,4,25.0%,1h
21488,3,[696]Aiur,2836,0,0,1,1,0.0%,20m
21488,3,kiritos,2836,0,0,1,1,0.0%,7m
21488,3,Callesen,2836,0,0,2,2,0.0%,23m
21488,2,[Rylst]Taincalag,2836,0,0,7,7,0.0%,5m
21522,3,aDastrA,2835,1567,206,184,390,52.8%,9m
21522,3,NazGul,2835,1430,186,156,342,54.4%,23m
21522,3,[4or5t]pWaHn,2835,1596,156,154,310,50.3%,20m
21522,3,[TAW]FearOfDDark,2835,1143,110,92,202,54.5%,12m
21522,1,Spiff,2835,1152,69,64,133,51.9%,9m
21522,3,KATIE,2835,1006,46,34,80,57.5%,19m
21522,3,AniMaLiTy,2835,569,34,34,68,50.0%,3m
21522,3,sterejo,2835,887,33,35,68,48.5%,22m
21522,2,Morso,2835,725,28,26,54,51.9%,11m
21522,3,didi,2835,611,24,22,46,52.2%,10m
21522,3,BigDig,2835,483,21,11,32,65.6%,22m
21522,1,monoid,2835,265,20,17,37,54.1%,3m
21522,3,[Cannоn]meincraft,2835,452,18,11,29,62.1%,19m
21522,2,heyimfabi,2835,228,18,23,41,43.9%,6m
21522,3,mag,2835,401,17,14,31,54.8%,2m
21522,3,Evilart,2835,316,15,2,17,88.2%,11m
21522,2,[WE420]TiSpundu,2835,73,11,17,28,39.3%,28m
21522,3,[SkBG]GetRektNoob,2835,288,10,13,23,43.5%,10m
21522,2,Panglot,2835,278,10,14,24,41.7%,10m
21522,3,Voltage,2835,230,9,7,16,56.2%,3m
21522,1,[ǺŁǻşłđ]Grogu,2835,231,8,5,13,61.5%,30m
21522,3,whataboutjoe,2835,178,8,6,14,57.1%,23m
21522,2,ABYSSKiSS,2835,192,8,7,15,53.3%,9m
21522,2,Cerebrate,2835,150,7,9,16,43.8%,21m
21522,3,[НТТ]Hashirama,2835,194,6,3,9,66.7%,22m
21522,3,POR,2835,150,6,7,13,46.2%,20m
21522,2,Chema,2835,0,4,1,5,80.0%,48m
21522,3,aleks,2835,86,4,2,6,66.7%,17m
21522,3,[EZBois]KoRnY,2835,30,4,4,8,50.0%,5m
21522,3,[J4E]AxBattler,2835,114,4,5,9,44.4%,15m
21522,2,Bonzi,2835,83,4,7,11,36.4%,23m
21522,3,Наука,2835,142,3,2,5,60.0%,13m
21522,2,itheraelmini,2835,0,3,3,6,50.0%,1h
21522,3,Condor,2835,127,3,4,7,42.9%,23m
21522,3,[SEEXXY]DragonFire,2835,58,3,5,8,37.5%,17m
21522,3,Neks,2835,92,3,7,10,30.0%,4m
21522,3,[Petrиs]IIIIIIIIIIII,2835,30,2,0,2,100.0%,19m
21522,3,samkel,2835,30,2,0,2,100.0%,19m
21522,3,Алиса,2835,30,2,1,3,66.7%,22m
21522,2,CommonThief,2835,0,2,3,5,40.0%,1h
21522,3,nool,2835,0,1,0,1,100.0%,3m
21522,3,[FFaaN]aHToHoB,2835,0,1,0,1,100.0%,23m
21522,3,Tevon,2835,0,0,1,1,0.0%,10m
21522,3,Slayr,2835,0,0,1,1,0.0%,5m
21522,3,RukiKruki,2835,0,0,1,1,0.0%,22m
21522,3,Totallimit,2835,0,0,2,2,0.0%,18m
21522,3,[TODOW]ipez,2835,0,0,2,2,0.0%,11m
21522,3,CptZephyr,2835,0,0,3,3,0.0%,6m
21522,3,arkitekten,2835,0,0,4,4,0.0%,11m
21571,3,veleye,2834,1380,219,192,411,53.3%,10m
21571,3,[BRock]kasi,2834,1556,191,187,378,50.5%,5m
21571,2,MaxSlayer,2834,1564,166,150,316,52.5%,5m
21571,3,Kraboss,2834,1595,104,84,188,55.3%,3m
21571,3,Acetate,2834,1600,95,90,185,51.4%,28m
21571,2,Madsos,2834,852,58,60,118,49.2%,12m
21571,3,gman,2834,1127,50,41,91,54.9%,4m
21571,2,[HZeS]ЛексUРэквием,2834,749,41,35,76,53.9%,16m
21571,3,[THST]miken,2834,809,40,14,54,74.1%,14m
21571,1,Galliandor,2834,1148,40,50,90,44.4%,21m
21571,2,[InitRu]Сириус,2834,418,34,40,74,45.9%,4m
21571,3,Gabé,2834,559,22,14,36,61.1%,21m
21571,3,YKV,2834,487,21,13,34,61.8%,28m
21571,3,[OVRBRZ]deUrsa,2834,404,19,17,36,52.8%,3m
21571,3,GOVOG,2834,338,16,14,30,53.3%,2m
21571,3,[SCVL]Kerrigan,2834,407,15,12,27,55.6%,6m
21571,3,Сухой,2834,364,14,10,24,58.3%,8m
21571,2,cawa,2834,189,14,14,28,50.0%,14m
21571,3,Wildfire,2834,290,11,10,21,52.4%,19m
21571,2,gibras,2834,266,11,12,23,47.8%,17m
21571,3,[UF2AC]Svereptopor,2834,178,10,4,14,71.4%,6m
21571,1,puffer,2834,235,10,11,21,47.6%,11m
21571,3,Профсоюз,2834,94,4,2,6,66.7%,10m
21571,3,Nosteam,2834,88,4,4,8,50.0%,22m
21571,1,KubYer,2834,97,4,4,8,50.0%,4m
21571,3,[TePt]Lukas,2834,141,4,4,8,50.0%,20m
21571,1,tommey,2834,145,3,2,5,60.0%,1h
21571,2,VodkaRedbull,2834,95,3,3,6,50.0%,41m
21571,2,[BMFG]BaDHoBBiT,2834,0,3,3,6,50.0%,35m
21571,2,Cromwell,2834,48,3,3,6,50.0%,1h
21571,2,Grawezapa,2834,114,3,4,7,42.9%,5m
21571,3,[ESErl]Pyteax,2834,30,2,0,2,100.0%,3m
21571,1,Parsa,2834,119,2,2,4,50.0%,1h
21571,1,NewKing,2834,97,2,3,5,40.0%,15m
21571,1,[SGEY]TYTY,2834,48,2,4,6,33.3%,5m
21571,3,[FhuckU]ToxicBlast,2834,0,0,1,1,0.0%,4m
21571,3,TheDreamer,2834,0,0,1,1,0.0%,6m
21571,2,ChefEjtebez,2834,0,0,1,1,0.0%,47m
21571,3,[КПCC]pmpkn,2834,0,0,2,2,0.0%,21m
21571,3,GYNKLAS,2834,0,0,3,3,0.0%,18m
21611,2,Vecissitude,2833,1439,238,235,473,50.3%,2m
21611,2,WpLakerOk,2833,1004,192,166,358,53.6%,20m
21611,3,gigo,2833,1593,170,145,315,54.0%,10m
21611,3,grandpa,2833,1556,100,87,187,53.5%,22m
21611,2,Franky,2833,1428,74,71,145,51.0%,3m
21611,2,socialinput,2833,1547,72,68,140,51.4%,17m
21611,3,[RO2020]DonEnzone,2833,1205,63,45,108,58.3%,21m
21611,2,[OPStar]RomanD,2833,1079,52,46,98,53.1%,8m
21611,3,Kutagen,2833,852,35,25,60,58.3%,19m
21611,3,Terranop,2833,594,27,17,44,61.4%,11m
21611,2,Pov,2833,569,22,20,42,52.4%,20m
21611,3,[NGaBZH]strikback,2833,526,21,21,42,50.0%,28m
21611,3,Arowbase,2833,337,20,15,35,57.1%,19m
21611,2,Ssvlad,2833,360,16,14,30,53.3%,3m
21611,2,daop,2833,358,15,4,19,78.9%,1h
21611,3,Yooda,2833,251,10,6,16,62.5%,28m
21611,2,lotosdynamic,2833,252,9,17,26,34.6%,14m
21611,3,HyDrO,2833,305,9,17,26,34.6%,3m
21611,3,llllllllllll,2833,165,8,7,15,53.3%,2m
21611,3,[sSeAa]Oaken,2833,180,7,5,12,58.3%,5m
21611,3,Laker,2833,208,7,9,16,43.8%,3m
21611,3,abba,2833,90,3,5,8,37.5%,28m
21611,3,Ranguin,2833,118,2,1,3,66.7%,14m
21611,2,bogdan,2833,0,2,2,4,50.0%,37m
21611,3,Shokyu,2833,30,2,3,5,40.0%,22m
21611,3,[Mutter]Aristo,2833,30,1,2,3,33.3%,20m
21611,3,happyfeet,2833,30,1,3,4,25.0%,2m
21611,3,Oshikuru,2833,0,0,1,1,0.0%,3m
21611,3,[SkCzM]mičkakingCZ,2833,0,0,1,1,0.0%,19m
21611,3,[eti2]Rayden,2833,0,0,1,1,0.0%,11m
21611,3,Diamond,2833,0,0,1,1,0.0%,4m
21642,3,Senent,2832,1310,149,137,286,52.1%,4m
21642,2,Ashaman,2832,997,98,79,177,55.4%,16m
21642,3,Roxysub,2832,1193,64,52,116,55.2%,4m
21642,2,Accelerator,2832,1080,58,53,111,52.3%,10m
21642,3,НаГиБаТоР,2832,1124,56,49,105,53.3%,7m
21642,3,[BFME2]James,2832,1274,53,53,106,50.0%,12m
21642,3,[SCCZ]MartinTyler,2832,1066,48,48,96,50.0%,19m
21642,3,Demetris,2832,652,35,16,51,68.6%,21m
21642,3,SorrowRambo,2832,549,20,16,36,55.6%,20m
21642,1,KungFu,2832,382,18,23,41,43.9%,3m
21642,3,[lnvoid]SimiPlay,2832,470,17,18,35,48.6%,3m
21642,3,kopatch,2832,484,17,20,37,45.9%,4m
21642,2,Telcontar,2832,394,16,18,34,47.1%,19m
21642,3,ShirOkiyyy,2832,276,14,0,14,100.0%,23m
21642,3,Zoo,2832,367,14,8,22,63.6%,3m
21642,3,Kaiser,2832,211,10,6,16,62.5%,5m
21642,1,Pedrolito,2832,337,10,16,26,38.5%,5m
21642,2,Orvoloson,2832,178,7,13,20,35.0%,22m
21642,2,Elarias,2832,115,6,7,13,46.2%,22m
21642,2,Justdoit,2832,146,6,10,16,37.5%,6m
21642,3,FistParty,2832,163,5,1,6,83.3%,16m
21642,3,Vandet,2832,128,5,2,7,71.4%,2m
21642,1,qwerty,2832,0,4,4,8,50.0%,4m
21642,1,VeryGooD,2832,142,3,1,4,75.0%,10m
21642,3,netras,2832,88,3,3,6,50.0%,11m
21642,3,DeepDark,2832,94,3,3,6,50.0%,20m
21642,3,kyarkov,2832,90,3,5,8,37.5%,6m
21642,1,[Stary]FOSSOYEUR,2832,48,2,3,5,40.0%,11m
21642,3,WarWar,2832,58,2,4,6,33.3%,28m
21642,3,Rstar,2832,58,2,5,7,28.6%,5m
21642,2,Rubberduck,2832,0,1,0,1,100.0%,30m
21642,3,KpacyH,2832,0,1,0,1,100.0%,20m
21642,3,[200]Astoria,2832,89,1,1,2,50.0%,6m
21642,2,[BR3AK]Blade,2832,46,1,1,2,50.0%,1h
21642,3,[aDGa]Aspiring,2832,0,1,2,3,33.3%,6m
21642,3,[Zombiz]Jbon,2832,0,0,1,1,0.0%,19m
21642,3,IceRise,2832,0,0,1,1,0.0%,19m
21642,1,Excalibur,2832,0,0,1,1,0.0%,1h
21642,3,SkyGF,2832,0,0,1,1,0.0%,10m
21642,3,tombi,2832,0,0,1,1,0.0%,28m
21642,3,OldDog,2832,0,0,4,4,0.0%,19m
21642,3,Reaver,2832,0,0,5,5,0.0%,23m
21684,2,Grev,2831,1252,238,235,473,50.3%,19m
21684,1,Mathibx,2831,1051,176,168,344,51.2%,28m
21684,1,Aton,2831,1469,157,157,314,50.0%,5m
21684,2,FromMunich,2831,1506,155,159,314,49.4%,10m
21684,3,KarakoS,2831,1586,129,105,234,55.1%,7m
21684,2,Beckha,2831,1467,70,54,124,56.5%,16m
21684,2,Canuma,2831,1355,56,56,112,50.0%,20m
21684,1,[8bbv]achtBITbiene,2831,799,56,63,119,47.1%,15m
21684,2,Constantine,2831,613,44,44,88,50.0%,22m
21684,3,geka,2831,896,36,31,67,53.7%,18m
21684,3,[ToC]TOXYQ,2831,774,33,24,57,57.9%,20m
21684,3,Kalypsio,2831,557,22,15,37,59.5%,22m
21684,3,Potato,2831,547,22,15,37,59.5%,19m
21684,3,[ČSSR]Mhor,2831,526,21,12,33,63.6%,3m
21684,2,Yetiman,2831,386,14,14,28,50.0%,10m
21684,3,Wally,2831,402,14,14,28,50.0%,11m
21684,3,Ivan,2831,163,14,16,30,46.7%,10m
21684,3,WeepinJester,2831,267,10,3,13,76.9%,9m
21684,3,Deathwatsch,2831,196,9,7,16,56.2%,18m
21684,3,MARTN,2831,235,9,8,17,52.9%,4m
21684,3,Skipper,2831,152,6,8,14,42.9%,23m
21684,3,CloseYou,2831,159,5,1,6,83.3%,12m
21684,3,Furiafelipe,2831,90,4,3,7,57.1%,20m
21684,3,Shemhazai,2831,134,3,3,6,50.0%,8m
21684,3,Petrahovih,2831,122,3,3,6,50.0%,19m
21684,3,Lamq,2831,30,2,1,3,66.7%,27m
21684,3,Гудвин,2831,30,2,1,3,66.7%,3m
21684,3,Nizazel,2831,113,2,2,4,50.0%,2m
21684,3,[СТРАТ]KeNT,2831,58,2,4,6,33.3%,14m
21684,3,RicharParker,2831,0,1,0,1,100.0%,23m
21684,3,ScorpionZol,2831,30,1,1,2,50.0%,22m
21684,3,Plucky,2831,0,0,1,1,0.0%,2m
21684,3,Gregorioo,2831,0,0,1,1,0.0%,21m
21684,3,Mage,2831,0,0,1,1,0.0%,12m
21684,2,Netzo,2831,0,0,1,1,0.0%,41m
21684,3,CrushFull,2831,0,0,2,2,0.0%,17m
21720,2,Rebel,2830,1254,144,140,284,50.7%,2m
21720,3,[IFAI]NAkamA,2830,702,75,71,146,51.4%,5m
21720,3,ZuKomplex,2830,1049,53,36,89,59.6%,23m
21720,3,dajpanspokoj,2830,214,36,26,62,58.1%,22m
21720,2,Noobik,2830,868,31,36,67,46.3%,12m
21720,3,[SVGS]RAPHYIR,2830,701,30,22,52,57.7%,17m
21720,3,Scirro,2830,700,25,27,52,48.1%,28m
21720,3,[Ǽ1]AGoatedPlat,2830,555,21,18,39,53.8%,16m
21720,2,Siol,2830,566,19,23,42,45.2%,12m
21720,3,LizaKhvan,2830,418,18,8,26,69.2%,8m
21720,2,toi,2830,351,13,15,28,46.4%,4m
21720,3,BonoBono,2830,300,12,10,22,54.5%,5m
21720,2,[sp1r1t]GOstVladO,2830,350,12,17,29,41.4%,22m
21720,3,[Ecoli]Dreon,2830,212,6,5,11,54.5%,5m
21720,1,BattleFox,2830,145,5,5,10,50.0%,15m
21720,3,[1s1]ToolTimr,2830,116,5,5,10,50.0%,22m
21720,1,MrZero,2830,97,4,4,8,50.0%,26m
21720,2,PSIH,2830,88,3,3,6,50.0%,12m
21720,1,Demulax,2830,0,3,3,6,50.0%,12m
21720,2,Berserker,2830,0,3,4,7,42.9%,3m
21720,3,Delriver,2830,58,2,4,6,33.3%,14m
21720,1,Naivel,2830,0,2,6,8,25.0%,30m
21720,3,KiborG,2830,18,1,2,3,33.3%,19m
21720,2,[DeVN]Bloodravenn,2830,88,1,4,5,20.0%,5m
21720,1,Sonyman,2830,0,0,1,1,0.0%,33m
21720,2,NikiPaj,2830,0,0,1,1,0.0%,19m
21720,3,DrDre,2830,0,0,1,1,0.0%,4m
21720,3,CONFIRM,2830,0,0,2,2,0.0%,12m
21720,3,JardanoBruno,2830,0,0,2,2,0.0%,3m
21749,2,[Fight1]fizzysaucers,2829,1402,129,123,252,51.2%,5m
21749,2,STORMBRINGER,2829,1577,107,105,212,50.5%,16m
21749,3,[200P]Mattes,2829,1248,88,75,163,54.0%,2m
21749,3,Howel,2829,1409,73,64,137,53.3%,22m
21749,2,Shagaru,2829,944,62,51,113,54.9%,9m
21749,3,SHALFEY,2829,803,57,39,96,59.4%,19m
21749,2,neoclassical,2829,374,30,33,63,47.6%,15m
21749,3,[Avngrs]CapAmerica,2829,426,23,9,32,71.9%,2m
21749,3,[MeXI]LIMB,2829,367,13,8,21,61.9%,10m
21749,3,PijanyLew,2829,302,13,8,21,61.9%,6m
21749,3,vanturak,2829,323,12,7,19,63.2%,21m
21749,3,Timuchin,2829,262,10,3,13,76.9%,2m
21749,3,Mitko,2829,292,10,12,22,45.5%,12m
21749,1,BananaFruit,2829,233,9,12,21,42.9%,6m
21749,1,GoodGirl,2829,166,8,3,11,72.7%,37m
21749,3,AlfredoConti,2829,244,8,13,21,38.1%,7m
21749,3,Lucatus,2829,221,7,4,11,63.6%,18m
21749,3,nightxep,2829,161,7,4,11,63.6%,11m
21749,3,TittyMcSWAG,2829,159,6,5,11,54.5%,17m
21749,2,Stinger,2829,141,5,8,13,38.5%,27m
21749,1,Cepus,2829,168,5,19,24,20.8%,28m
21749,2,Neron,2829,0,3,3,6,50.0%,29m
21749,3,Faikert,2829,94,3,3,6,50.0%,6m
21749,3,IIIXxXIII,2829,43,3,3,6,50.0%,10m
21749,3,RamboDash,2829,88,3,4,7,42.9%,13m
21749,2,PadreWhiskey,2829,48,3,4,7,42.9%,1h
21749,3,MasterVAN,2829,30,3,4,7,42.9%,19m
21749,3,JackFlash,2829,88,3,4,7,42.9%,28m
21749,3,Kreur,2829,92,3,5,8,37.5%,22m
21749,2,oksi,2829,0,2,3,5,40.0%,44m
21749,3,Ellinas,2829,30,2,4,6,33.3%,17m
21749,2,Darkbait,2829,0,1,0,1,100.0%,1h
21749,3,[InitRu]scorpion,2829,30,1,1,2,50.0%,23m
21749,3,maxmaer,2829,0,1,3,4,25.0%,19m
21749,3,Faust,2829,0,1,4,5,20.0%,2m
21749,3,YtekSpouki,2829,0,1,4,5,20.0%,5m
21749,1,Domo,2829,44,1,5,6,16.7%,10m
21749,3,Raijin,2829,0,0,1,1,0.0%,3m
21749,2,[oLFo]GengisKom,2829,0,0,4,4,0.0%,29m
21788,3,AttilaHM,2828,1216,116,100,216,53.7%,2m
21788,2,Lameiro,2828,679,111,114,225,49.3%,4m
21788,3,Genka,2828,1120,90,76,166,54.2%,2m
21788,2,IDiedInDS,2828,1577,69,67,136,50.7%,21m
21788,2,Assassin,2828,1207,61,55,116,52.6%,11m
21788,3,ICA,2828,1452,55,56,111,49.5%,19m
21788,2,digitaldave,2828,1238,51,46,97,52.6%,12m
21788,2,memnonas,2828,1069,44,37,81,54.3%,5m
21788,2,FunkyDonkey,2828,876,35,34,69,50.7%,5m
21788,3,AlexBro,2828,670,27,20,47,57.4%,2m
21788,3,[Konkos]Amirg,2828,621,26,17,43,60.5%,5m
21788,3,RawKitten,2828,302,26,24,50,52.0%,4m
21788,3,brunocznv,2828,698,26,24,50,52.0%,12m
21788,3,Casaní,2828,461,22,15,37,59.5%,6m
21788,2,ZopAgent,2828,434,18,18,36,50.0%,2m
21788,3,Vega,2828,399,17,8,25,68.0%,9m
21788,3,Taygetos,2828,329,15,10,25,60.0%,23m
21788,3,[mMcH]Альбиус,2828,382,14,14,28,50.0%,10m
21788,3,LoDblrb,2828,337,11,9,20,55.0%,5m
21788,3,fassn,2828,208,10,6,16,62.5%,4m
21788,3,FannyFart,2828,276,10,10,20,50.0%,19m
21788,3,Danzo,2828,233,7,5,12,58.3%,11m
21788,1,honiboi,2828,97,4,4,8,50.0%,8m
21788,2,TittenDachs,2828,88,4,4,8,50.0%,6m
21788,3,pasha,2828,126,4,9,13,30.8%,19m
21788,2,[YEBAC]IpwnYouDude,2828,0,3,3,6,50.0%,44m
21788,2,CrazyBanana,2828,0,3,3,6,50.0%,48m
21788,3,GeoGeo,2828,60,3,4,7,42.9%,13m
21788,3,Indianadrone,2828,123,3,5,8,37.5%,17m
21788,3,TrainTerr,2828,30,2,1,3,66.7%,5m
21788,2,[SPGR]coucouniette,2828,0,2,3,5,40.0%,40m
21788,3,[FUSB]Samxtar,2828,60,2,4,6,33.3%,13m
21788,3,jokerhead,2828,60,2,5,7,28.6%,22m
21788,3,[TRÉBO]Allouf,2828,30,1,2,3,33.3%,10m
21788,3,VaRg,2828,30,1,3,4,25.0%,28m
21788,3,[777Bet]TheCoZzYGaMe,2828,0,0,1,1,0.0%,22m
21788,3,Nitrogen,2828,0,0,1,1,0.0%,12m
21788,1,PhrezTagada,2828,0,0,2,2,0.0%,4m
21788,3,[FOG]Bloodplayer,2828,0,0,5,5,0.0%,16m
21827,3,[NRVG]KillerAmy,2827,1611,218,213,431,50.6%,21m
21827,2,[WuDB]WuDB,2827,487,90,85,175,51.4%,5m
21827,3,nightdancer,2827,1594,88,70,158,55.7%,21m
21827,1,SCAUT,2827,1279,84,87,171,49.1%,18m
21827,2,georges,2827,1495,80,74,154,51.9%,19m
21827,3,[ZERGTB]Genuine,2827,1520,65,60,125,52.0%,4m
21827,3,lostone,2827,1352,50,53,103,48.5%,22m
21827,3,[ProZe]Phobos,2827,426,15,19,34,44.1%,18m
21827,3,Rash,2827,225,10,7,17,58.8%,2m
21827,3,HookFinger,2827,262,10,9,19,52.6%,18m
21827,1,[echell]Mathias,2827,239,7,7,14,50.0%,2m
21827,3,Oozi,2827,153,5,1,6,83.3%,15m
21827,2,Chāhār,2827,158,5,4,9,55.6%,22m
21827,3,[RiskY]autodesk,2827,32,5,6,11,45.5%,39m
21827,3,[MrPopo]Danny,2827,120,4,4,8,50.0%,2m
21827,3,NextGen,2827,88,4,5,9,44.4%,11m
21827,3,LaXul,2827,120,4,5,9,44.4%,17m
21827,3,SunnyDee,2827,117,3,2,5,60.0%,7m
21827,3,[YAUTJA]Euronymous,2827,0,2,0,2,100.0%,2m
21827,3,SpecialForce,2827,0,2,4,6,33.3%,19m
21827,3,BogvABW,2827,0,1,0,1,100.0%,16m
21827,1,Eagle,2827,97,1,3,4,25.0%,1h
21827,3,Eddy,2827,0,1,4,5,20.0%,3m
21827,3,Villain,2827,0,0,1,1,0.0%,10m
21827,3,[M1SE]maghea,2827,0,0,1,1,0.0%,14m
21827,3,NeverNude,2827,0,0,1,1,0.0%,16m
21827,3,Nik,2827,0,0,2,2,0.0%,3m
21827,3,[GGames]AntSavva,2827,0,0,2,2,0.0%,21m
21827,3,Requinnico,2827,0,0,4,4,0.0%,10m
21856,2,ByteSize,2826,1334,232,230,462,50.2%,23m
21856,1,[JJBZ]LawnMower,2826,1078,119,117,236,50.4%,9m
21856,2,Hello,2826,1094,62,52,114,54.4%,22m
21856,3,RTS,2826,1036,43,35,78,55.1%,22m
21856,3,Feuerfalter,2826,1101,42,36,78,53.8%,12m
21856,3,goksu,2826,811,33,26,59,55.9%,19m
21856,3,JDDDDDD,2826,744,30,29,59,50.8%,12m
21856,2,[WYG]DEX,2826,560,22,22,44,50.0%,7m
21856,2,PerseuS,2826,502,17,24,41,41.5%,23m
21856,3,bribrisan,2826,377,16,11,27,59.3%,23m
21856,3,[DТ]СержантКусь,2826,363,14,7,21,66.7%,13m
21856,2,Kareful,2826,313,12,10,22,54.5%,16m
21856,3,Gwen,2826,240,9,8,17,52.9%,19m
21856,3,[BCM]Iceman,2826,250,8,4,12,66.7%,22m
21856,1,zeluux,2826,144,8,5,13,61.5%,21m
21856,1,Ollowain,2826,274,7,2,9,77.8%,1h
21856,3,[АDMIN]LFIS,2826,198,7,14,21,33.3%,23m
21856,3,Nerdking,2826,161,5,7,12,41.7%,5m
21856,3,CAYORATE,2826,0,4,1,5,80.0%,19m
21856,2,RussianWolf,2826,142,3,2,5,60.0%,1h
21856,3,[CrossX]VegaStarLine,2826,0,3,2,5,60.0%,11m
21856,2,DarkInoo,2826,48,3,5,8,37.5%,30m
21856,3,Madrox,2826,94,2,0,2,100.0%,3m
21856,3,[EGS]Kolbo,2826,30,2,4,6,33.3%,14m
21856,3,Concord,2826,0,1,0,1,100.0%,16m
21856,3,Dada,2826,0,1,0,1,100.0%,11m
21856,3,Shinigami,2826,94,1,1,2,50.0%,19m
21856,3,aaa,2826,0,1,1,2,50.0%,23m
21856,1,Haizenberg,2826,96,1,2,3,33.3%,14m
21856,2,Radobeast,2826,0,1,3,4,25.0%,5m
21856,3,Human,2826,0,1,4,5,20.0%,2m
21856,3,Jaffa,2826,0,0,1,1,0.0%,4m
21856,3,radu,2826,0,0,1,1,0.0%,11m
21856,3,[superm]maks,2826,0,0,1,1,0.0%,3m
21890,3,mantaslash,2825,1531,260,228,488,53.3%,17m
21890,3,[DAHUS]Jerem,2825,1323,90,72,162,55.6%,7m
21890,2,ElixiR,2825,1345,69,61,130,53.1%,10m
21890,2,[stem]deniska,2825,667,63,55,118,53.4%,8m
21890,1,Vebeldan,2825,1206,47,51,98,48.0%,21m
21890,3,[InCorp]Identity,2825,1074,46,32,78,59.0%,12m
21890,2,Dioraks,2825,523,21,20,41,51.2%,5m
21890,2,Energy,2825,598,21,25,46,45.7%,13m
21890,3,Strange,2825,355,15,10,25,60.0%,3m
21890,3,[2II5]zzzzzzzzzzzz,2825,285,11,4,15,73.3%,2m
21890,2,Saveliy,2825,328,11,17,28,39.3%,28m
21890,2,AdowablBunny,2825,263,9,7,16,56.2%,18m
21890,2,Sorry,2825,232,9,16,25,36.0%,4m
21890,1,[Kbanus]Alex,2825,170,8,4,12,66.7%,12m
21890,3,Endofo,2825,194,8,6,14,57.1%,14m
21890,3,[ImbaG]Vladimir,2825,174,7,5,12,58.3%,12m
21890,1,Pentól,2825,180,7,7,14,50.0%,1h
21890,3,nightykatze,2825,167,6,6,12,50.0%,2m
21890,3,Radon,2825,114,5,3,8,62.5%,13m
21890,3,MrChair,2825,144,5,5,10,50.0%,21m
21890,2,Gainz,2825,92,4,5,9,44.4%,22m
21890,3,titan,2825,139,3,1,4,75.0%,22m
21890,3,greenarrow,2825,58,3,2,5,60.0%,22m
21890,3,Rigobertu,2825,88,3,5,8,37.5%,22m
21890,3,Duka,2825,58,2,4,6,33.3%,17m
21890,3,LiBuX,2825,0,1,0,1,100.0%,10m
21890,3,razrock,2825,0,1,0,1,100.0%,8m
21890,3,Linca,2825,94,1,1,2,50.0%,22m
21890,3,[PFOA]PfoaAndi,2825,0,1,1,2,50.0%,10m
21890,3,[BWArmy]Medianboard,2825,0,0,1,1,0.0%,5m
21890,2,LazyTurtle,2825,0,0,7,7,0.0%,14m
21921,3,Terminator,2824,1569,116,108,224,51.8%,5m
21921,2,mogyivagyok,2824,832,105,98,203,51.7%,22m
21921,1,baskiz,2824,1259,98,98,196,50.0%,4m
21921,3,[LKVRS]убийца,2824,1161,84,61,145,57.9%,8m
21921,2,hiroes,2824,347,63,55,118,53.4%,14m
21921,3,shaggy,2824,1368,50,49,99,50.5%,3m
21921,1,[INSCOM]Skipper,2824,644,42,48,90,46.7%,8m
21921,3,rawwbone,2824,889,37,27,64,57.8%,10m
21921,3,Tim,2824,800,34,23,57,59.6%,4m
21921,3,[eRZR]Harlekin,2824,715,33,23,56,58.9%,12m
21921,3,MacroPurger,2824,595,26,22,48,54.2%,3m
21921,3,[Тоссы]NikitaStepin,2824,518,23,9,32,71.9%,18m
21921,3,[D0N3]Andreasicc,2824,498,22,18,40,55.0%,9m
21921,3,[KotFS]Tedde,2824,474,21,17,38,55.3%,22m
21921,3,Zartafak,2824,411,19,11,30,63.3%,2m
21921,3,subzer,2824,347,18,16,34,52.9%,19m
21921,3,Aeon,2824,278,17,14,31,54.8%,12m
21921,3,SpvceHvze,2824,372,13,15,28,46.4%,28m
21921,3,[bege1]BlackPrince,2824,251,11,2,13,84.6%,12m
21921,3,AUhr,2824,290,11,4,15,73.3%,19m
21921,3,Slayther,2824,247,11,6,17,64.7%,14m
21921,1,[k1A]Salkos,2824,297,11,6,17,64.7%,1h
21921,2,OneNatural,2824,256,10,12,22,45.5%,33m
21921,3,nabhab,2824,212,8,6,14,57.1%,2m
21921,3,PREDATOR,2824,60,6,10,16,37.5%,21m
21921,3,SasaiKudasai,2824,30,5,4,9,55.6%,7m
21921,1,Mjølk,2824,145,5,5,10,50.0%,15m
21921,3,Zenon,2824,94,4,2,6,66.7%,4m
21921,2,Waschmittel,2824,30,4,4,8,50.0%,9m
21921,3,ZelZorgia,2824,116,4,5,9,44.4%,14m
21921,2,Dervish,2824,58,4,8,12,33.3%,10m
21921,3,IIIIIIIIIIII,2824,0,3,3,6,50.0%,20m
21921,3,zoumines,2824,60,3,4,7,42.9%,15m
21921,1,space,2824,0,3,6,9,33.3%,2m
21921,2,[wazzo]Nyu,2824,92,3,9,12,25.0%,7m
21921,3,MacLeod,2824,117,2,2,4,50.0%,11m
21921,2,Dreamshock,2824,0,2,3,5,40.0%,1h
21921,2,DieRemix,2824,0,2,3,5,40.0%,37m
21921,3,MrSuccess,2824,97,2,4,6,33.3%,16m
21921,3,Schmock,2824,36,2,6,8,25.0%,18m
21921,1,Stongolbest,2824,0,1,0,1,100.0%,28m
21921,3,[Candy1]Sanchez,2824,0,1,1,2,50.0%,3m
21921,3,Schnulli,2824,30,1,2,3,33.3%,11m
21921,3,Shaimus,2824,0,0,3,3,0.0%,23m
21965,3,DenKartoffel,2823,1516,194,166,360,53.9%,4m
21965,2,SuperCancel,2823,609,143,114,257,55.6%,6m
21965,3,Дмитрий,2823,1193,134,114,248,54.0%,16m
21965,1,Mastodont,2823,713,116,121,237,48.9%,12m
21965,3,bavlovich,2823,679,29,20,49,59.2%,13m
21965,3,Dyo,2823,648,22,21,43,51.2%,23m
21965,3,PIT,2823,377,18,14,32,56.2%,11m
21965,3,[ardcho]damsdeparis,2823,378,13,14,27,48.1%,22m
21965,3,Starwarrior,2823,217,9,2,11,81.8%,23m
21965,3,[TNGC]CallMeCappy,2823,231,9,9,18,50.0%,4m
21965,3,Vivi,2823,142,8,7,15,53.3%,2m
21965,3,MrMak,2823,208,8,8,16,50.0%,6m
21965,3,kaito,2823,202,8,8,16,50.0%,11m
21965,3,Guillaume,2823,216,8,9,17,47.1%,22m
21965,3,[SURN]Heledorn,2823,164,6,2,8,75.0%,20m
21965,3,veretskii,2823,122,5,3,8,62.5%,23m
21965,2,[U2]Inspired,2823,162,4,0,4,100.0%,1h
21965,3,[PLA2N]чебупеля,2823,156,4,1,5,80.0%,12m
21965,3,Вечный,2823,148,4,2,6,66.7%,2m
21965,2,jarzyl,2823,142,4,4,8,50.0%,10m
21965,3,[STARUA]WJOh,2823,58,3,1,4,75.0%,22m
21965,2,[Squeee]Guilford,2823,0,3,2,5,60.0%,1h
21965,3,Enki,2823,0,3,2,5,60.0%,8m
21965,3,LickerDaPuss,2823,0,3,2,5,60.0%,18m
21965,3,[PowerG]MasterMind,2823,90,3,3,6,50.0%,4m
21965,1,eth,2823,96,3,3,6,50.0%,38m
21965,3,Pain,2823,118,2,2,4,50.0%,11m
21965,3,Darguus,2823,30,2,2,4,50.0%,10m
21965,3,OverNoob,2823,92,2,4,6,33.3%,18m
21965,2,aiur,2823,0,1,0,1,100.0%,40m
21965,3,astrionic,2823,93,1,1,2,50.0%,5m
21965,2,noirzenith,2823,0,1,2,3,33.3%,1h
21965,3,ATOMFox,2823,0,1,3,4,25.0%,12m
21965,3,[Z3RG7V]Злой,2823,0,0,1,1,0.0%,14m
21965,3,[ISRI]ILIKEBOYS,2823,0,0,2,2,0.0%,27m
22000,2,michael,2822,1561,141,146,287,49.1%,6m
22000,3,matr,2822,1460,104,98,202,51.5%,19m
22000,3,Leonso,2822,574,63,47,110,57.3%,22m
22000,3,ArTsOfWaR,2822,1143,48,42,90,53.3%,6m
22000,2,FusilàPompe,2822,721,44,45,89,49.4%,17m
22000,1,Retrosics,2822,816,34,38,72,47.2%,10m
22000,3,[SiPl]Warego,2822,666,33,14,47,70.2%,22m
22000,3,ralokt,2822,565,22,21,43,51.2%,9m
22000,3,Xatec,2822,566,22,25,47,46.8%,12m
22000,3,ErrantKnight,2822,434,18,11,29,62.1%,10m
22000,3,ziyue,2822,417,18,18,36,50.0%,2m
22000,3,Airblade,2822,413,16,15,31,51.6%,4m
22000,3,[SwSII]Meepo,2822,393,14,17,31,45.2%,10m
22000,3,Beast,2822,316,12,12,24,50.0%,8m
22000,3,Donot,2822,253,11,7,18,61.1%,23m
22000,3,[TSmash]NutellaGming,2822,265,11,7,18,61.1%,9m
22000,3,Cece,2822,322,11,8,19,57.9%,3m
22000,2,Janke,2822,206,10,10,20,50.0%,16m
22000,3,[DlNA]DarkThunder,2822,232,9,7,16,56.2%,2m
22000,3,[MIG]Blad,2822,268,9,12,21,42.9%,19m
22000,1,Larissan,2822,234,6,2,8,75.0%,40m
22000,2,КрэйзиУтка,2822,150,5,4,9,55.6%,22m
22000,3,[HLFLMN]Domi,2822,122,5,5,10,50.0%,3m
22000,3,stEVE,2822,118,3,0,3,100.0%,18m
22000,3,MAKSIMUS,2822,60,3,2,5,60.0%,27m
22000,3,[0142]WENGER,2822,60,3,2,5,60.0%,20m
22000,2,zlooo,2822,0,3,2,5,60.0%,12m
22000,3,HavyVetal,2822,92,3,7,10,30.0%,14m
22000,3,MisteR,2822,94,2,0,2,100.0%,23m
22000,3,[DEASY]Bubasetti,2822,114,2,1,3,66.7%,22m
22000,3,devilsproud,2822,58,2,2,4,50.0%,11m
22000,3,Трибанки,2822,0,1,0,1,100.0%,21m
22000,3,Hydromel,2822,30,1,2,3,33.3%,18m
22000,3,VINCHESTER,2822,0,1,2,3,33.3%,17m
22000,3,HEAHTOH,2822,0,1,3,4,25.0%,22m
22000,3,florian,2822,0,0,1,1,0.0%,18m
22000,3,Sagreth,2822,0,0,1,1,0.0%,28m
22000,3,[APIPIS]RushB,2822,0,0,1,1,0.0%,20m
22000,3,[OPLA]Obelous,2822,0,0,1,1,0.0%,28m
22000,3,voltage,2822,0,0,2,2,0.0%,23m
22040,2,МУЖИК,2821,1613,282,272,554,50.9%,5m
22040,3,[Blatzs]Gerrot,2821,1583,72,53,125,57.6%,14m
22040,3,bEarchZz,2821,705,32,25,57,56.1%,22m
22040,2,ButchT,2821,602,23,25,48,47.9%,20m
22040,3,[IceHus]Pandosss,2821,326,15,4,19,78.9%,22m
22040,3,Halk,2821,261,11,11,22,50.0%,23m
22040,3,Nadrak,2821,193,10,3,13,76.9%,22m
22040,3,Irrational,2821,242,10,7,17,58.8%,17m
22040,3,Dudi,2821,215,9,1,10,90.0%,14m
22040,1,Rekin,2821,259,9,5,14,64.3%,1h
22040,1,[0BBF0]DayWalker,2821,159,8,3,11,72.7%,1h
22040,3,[KGSC2]PrimeStar,2821,241,8,4,12,66.7%,4m
22040,3,shagernaut,2821,185,6,2,8,75.0%,21m
22040,3,PoZiTiVCHiK,2821,193,6,4,10,60.0%,19m
22040,3,MagicTurtle,2821,163,6,9,15,40.0%,7m
22040,3,[ffn]Rampage,2821,163,5,2,7,71.4%,22m
22040,1,Threatter,2821,150,5,4,9,55.6%,1h
22040,3,[Beаr]Evgen,2821,86,4,3,7,57.1%,12m
22040,3,[LAVA]Painkiller,2821,170,4,4,8,50.0%,10m
22040,3,pirofany,2821,111,3,0,3,100.0%,21m
22040,3,uakari,2821,58,3,3,6,50.0%,11m
22040,3,[TedB]NEV,2821,30,2,3,5,40.0%,9m
22040,2,BISMARCKII,2821,0,1,0,1,100.0%,1h
22040,3,TRoN,2821,0,1,0,1,100.0%,22m
22040,3,[kupka]KLOTZMAN,2821,30,1,1,2,50.0%,10m
22040,3,HOTLINE,2821,30,1,3,4,25.0%,5m
22040,2,Starscream,2821,88,1,3,4,25.0%,7m
22040,3,timoxa,2821,30,1,4,5,20.0%,11m
22040,3,[ACorV]ZeroCool,2821,0,0,1,1,0.0%,19m
22040,3,reborn,2821,0,0,4,4,0.0%,6m
22070,1,Blueplayer,2820,1564,248,245,493,50.3%,10m
22070,2,Music,2820,1484,209,200,409,51.1%,5m
22070,3,iven,2820,1601,123,106,229,53.7%,2m
22070,3,puchini,2820,1356,103,63,166,62.0%,28m
22070,3,tipsy,2820,1543,73,53,126,57.9%,10m
22070,3,Cabia,2820,1211,63,59,122,51.6%,7m
22070,3,StarLight,2820,687,57,54,111,51.4%,3m
22070,3,[WPru]Click,2820,1115,50,44,94,53.2%,22m
22070,2,Craftausorur,2820,1131,45,45,90,50.0%,15m
22070,3,HzxByOnline,2820,903,35,31,66,53.0%,4m
22070,3,Glaedr,2820,609,26,20,46,56.5%,14m
22070,2,[QUAKE]mdanshin,2820,615,26,28,54,48.1%,9m
22070,3,anakin,2820,526,24,11,35,68.6%,14m
22070,3,Nosferatu,2820,490,23,11,34,67.6%,14m
22070,3,BraiNur,2820,540,23,16,39,59.0%,22m
22070,3,Ledenec,2820,676,23,21,44,52.3%,7m
22070,3,Hayner,2820,290,13,6,19,68.4%,14m
22070,3,Baggier,2820,330,13,6,19,68.4%,22m
22070,3,Csatadze,2820,294,12,9,21,57.1%,18m
22070,2,Scoobydoo,2820,213,10,8,18,55.6%,9m
22070,3,[CRF]Ynnir,2820,216,10,11,21,47.6%,15m
22070,1,Krotik,2820,284,9,9,18,50.0%,1h
22070,3,giantschrimp,2820,232,8,5,13,61.5%,15m
22070,1,Chara,2820,216,8,6,14,57.1%,1h
22070,3,Funkykong,2820,181,7,2,9,77.8%,12m
22070,3,DerStrumpf,2820,165,7,7,14,50.0%,5m
22070,2,Shapezhifter,2820,94,6,3,9,66.7%,38m
22070,1,AREA,2820,190,6,18,24,25.0%,2m
22070,2,XeNo,2820,161,5,4,9,55.6%,4m
22070,3,flitzpiepe,2820,221,5,11,16,31.2%,28m
22070,2,Morznak,2820,0,3,3,6,50.0%,29m
22070,3,Tribulation,2820,0,3,3,6,50.0%,13m
22070,3,Topaon,2820,90,3,6,9,33.3%,18m
22070,3,PUTEN,2820,94,2,0,2,100.0%,3m
22070,3,[sonic1]Ezik,2820,0,1,0,1,100.0%,17m
22070,1,DivaJK,2820,0,1,0,1,100.0%,1h
22070,3,Stefano,2820,0,1,0,1,100.0%,20m
22070,3,[SD420]SnapD,2820,94,1,5,6,16.7%,20m
22070,3,[Dralag]StarCry,2820,0,0,1,1,0.0%,22m
22070,3,Raelag,2820,0,0,1,1,0.0%,5m
22070,3,Relax,2820,0,0,2,2,0.0%,11m
22111,2,daulaus,2819,1544,159,151,310,51.3%,7m
22111,3,SuperJeww,2819,1621,159,154,313,50.8%,22m
22111,3,Zmeu,2819,1331,118,107,225,52.4%,8m
22111,3,Rhagnar,2819,640,91,81,172,52.9%,5m
22111,3,FRITS,2819,771,89,65,154,57.8%,3m
22111,1,[696]salva,2819,1401,73,65,138,52.9%,11m
22111,2,Corvojean,2819,975,59,52,111,53.2%,22m
22111,3,Solorien,2819,303,43,33,76,56.6%,2m
22111,3,ZIOMKRIS,2819,1001,40,32,72,55.6%,2m
22111,2,[NoLF]Brutaller,2819,304,35,29,64,54.7%,8m
22111,2,xavia,2819,666,27,28,55,49.1%,20m
22111,2,Barbarossa,2819,422,27,32,59,45.8%,22m
22111,3,[SCGTR]NaRtEzAs,2819,386,25,16,41,61.0%,19m
22111,3,protos,2819,501,20,12,32,62.5%,19m
22111,3,lbc,2819,412,18,21,39,46.2%,14m
22111,3,Roks,2819,270,10,4,14,71.4%,23m
22111,3,Giertol,2819,208,7,8,15,46.7%,4m
22111,3,OnlyFrans,2819,235,7,14,21,33.3%,23m
22111,3,AngryRaccoon,2819,155,6,7,13,46.2%,1h
22111,3,Kerrigan,2819,104,5,0,5,100.0%,22m
22111,3,Fandilo,2819,185,5,3,8,62.5%,10m
22111,3,[Bhldrs]Atsuma,2819,139,3,2,5,60.0%,22m
22111,2,DuckHunter,2819,0,3,2,5,60.0%,12m
22111,3,niph,2819,60,2,3,5,40.0%,8m
22111,3,[HFR]NoR,2819,58,2,3,5,40.0%,28m
22111,3,BlackRaven,2819,0,1,0,1,100.0%,17m
22111,3,Lángos,2819,0,1,1,2,50.0%,23m
22111,3,PIKIPOKU,2819,30,1,3,4,25.0%,17m
22111,3,Siev,2819,0,0,1,1,0.0%,3m
22111,3,Mirush,2819,0,0,4,4,0.0%,2m
22141,3,CAMBAR,2818,1566,118,115,233,50.6%,23m
22141,2,Ancalagon,2818,1358,95,81,176,54.0%,22m
22141,3,Formanden,2818,1042,51,49,100,51.0%,4m
22141,3,Slower,2818,1099,48,41,89,53.9%,17m
22141,3,creepy,2818,402,40,34,74,54.1%,17m
22141,2,[Grund]Dnk,2818,957,40,38,78,51.3%,9m
22141,3,ScotyHun,2818,722,33,21,54,61.1%,2m
22141,3,hik,2818,740,31,26,57,54.4%,6m
22141,2,Pheni,2818,690,28,26,54,51.9%,5m
22141,3,Zmajo,2818,611,26,24,50,52.0%,11m
22141,3,MpK,2818,532,23,9,32,71.9%,19m
22141,2,MezKo,2818,354,22,24,46,47.8%,28m
22141,3,mrnice,2818,352,15,9,24,62.5%,17m
22141,3,Alexandru,2818,366,15,16,31,48.4%,7m
22141,3,Kreket,2818,398,14,19,33,42.4%,11m
22141,3,Nova,2818,265,12,5,17,70.6%,2m
22141,3,Deloran,2818,332,12,15,27,44.4%,6m
22141,2,zverelos,2818,259,10,12,22,45.5%,35m
22141,2,ParamValue,2818,255,8,7,15,53.3%,38m
22141,3,zinkko,2818,146,6,5,11,54.5%,28m
22141,3,OxY,2818,0,5,3,8,62.5%,3m
22141,3,[Farla]chiwendios,2818,114,5,4,9,55.6%,14m
22141,2,stark,2818,142,5,4,9,55.6%,40m
22141,3,sunkk,2818,194,5,6,11,45.5%,11m
22141,2,Unrealfff,2818,105,5,11,16,31.2%,12m
22141,3,[11010]Muffinmannen,2818,60,3,2,5,60.0%,23m
22141,3,Jonte,2818,93,2,0,2,100.0%,28m
22141,2,Karmondia,2818,24,2,10,12,16.7%,7m
22141,3,Mugivara,2818,0,1,0,1,100.0%,20m
22141,1,[GymB]Баркодович,2818,0,1,0,1,100.0%,46m
22141,3,MacroMind,2818,30,1,2,3,33.3%,22m
22141,3,Drug,2818,0,0,1,1,0.0%,4m
22141,3,Sasay,2818,0,0,1,1,0.0%,22m
22174,1,dani,2817,1582,189,184,373,50.7%,4m
22174,2,guimelo,2817,1504,66,57,123,53.7%,14m
22174,3,kid,2817,961,43,28,71,60.6%,17m
22174,3,Musashi,2817,847,41,34,75,54.7%,10m
22174,3,Philliphus,2817,826,39,24,63,61.9%,2m
22174,3,SoundCheck,2817,584,26,20,46,56.5%,13m
22174,3,Adam,2817,638,24,25,49,49.0%,14m
22174,3,Sztandirr,2817,422,18,15,33,54.5%,22m
22174,2,Brostitute,2817,516,18,27,45,40.0%,18m
22174,3,Flightofbird,2817,379,15,14,29,51.7%,23m
22174,3,nisDe,2817,346,13,14,27,48.1%,14m
22174,3,CashMcSpicy,2817,211,12,11,23,52.2%,22m
22174,2,FAKAS,2817,309,11,15,26,42.3%,13m
22174,2,[iX]FoREIGNeR,2817,332,11,19,30,36.7%,2m
22174,3,[UnRush]HornyRam,2817,218,9,7,16,56.2%,9m
22174,1,Fede,2817,174,8,9,17,47.1%,2m
22174,3,Stark,2817,180,7,7,14,50.0%,21m
22174,3,[evilBa]berti,2817,174,6,9,15,40.0%,28m
22174,3,lunchbox,2817,125,5,5,10,50.0%,19m
22174,3,[HMSTR]AladdinSane,2817,86,4,3,7,57.1%,4m
22174,3,[BrCrft]SkySultan,2817,165,4,4,8,50.0%,4m
22174,3,[HCEZ]Nagaikami,2817,30,4,4,8,50.0%,18m
22174,1,[WfGe]gismo,2817,48,4,5,9,44.4%,38m
22174,2,mikus,2817,0,3,2,5,60.0%,25m
22174,2,AnonimZero,2817,0,3,2,5,60.0%,36m
22174,2,Fugitiv,2817,48,3,2,5,60.0%,37m
22174,1,Skydra,2817,48,2,3,5,40.0%,26m
22174,3,[Shado]Lunica,2817,0,2,3,5,40.0%,21m
22174,3,Apicis,2817,0,2,3,5,40.0%,19m
22174,3,HimeRa,2817,60,2,4,6,33.3%,17m
22174,3,Stars,2817,0,1,0,1,100.0%,19m
22174,3,BUCEFAL,2817,30,1,4,5,20.0%,3m
22174,3,Sunam,2817,30,1,7,8,12.5%,21m
22174,3,FallenProz,2817,0,0,1,1,0.0%,3m
22174,3,[ECU]ecuYaz,2817,0,0,1,1,0.0%,8m
22174,3,[Arrows]Nikita,2817,0,0,1,1,0.0%,14m
22210,1,SVS,2816,1435,228,228,456,50.0%,14m
22210,3,Ian,2816,1619,114,102,216,52.8%,28m
22210,2,Meh,2816,1613,92,90,182,50.5%,10m
22210,3,EliteBowser,2816,343,82,65,147,55.8%,11m
22210,3,[WARHED]WseeDRAGon,2816,1214,79,70,149,53.0%,12m
22210,3,JetFire,2816,1170,53,48,101,52.5%,22m
22210,2,Severin,2816,1165,48,48,96,50.0%,7m
22210,3,rushboxx,2816,849,45,40,85,52.9%,18m
22210,3,StuckPlat,2816,925,37,25,62,59.7%,3m
22210,3,IIIIIIIIIIII,2816,672,28,24,52,53.8%,18m
22210,2,Павел,2816,520,26,22,48,54.2%,20m
22210,2,konfiti,2816,373,20,18,38,52.6%,9m
22210,3,LichTerLoh,2816,267,15,12,27,55.6%,22m
22210,3,Anuar,2816,367,14,14,28,50.0%,3m
22210,2,[TDKpro]Aya,2816,298,12,16,28,42.9%,6m
22210,3,IllIllIllIll,2816,108,11,1,12,91.7%,19m
22210,1,xxVoyage,2816,252,11,14,25,44.0%,12m
22210,3,[Lushe]Farmilus,2816,262,10,11,21,47.6%,2m
22210,3,Haron,2816,196,7,3,10,70.0%,19m
22210,3,evdosius,2816,231,7,7,14,50.0%,11m
22210,3,Dulowec,2816,138,6,6,12,50.0%,8m
22210,3,Tominator,2816,145,6,7,13,46.2%,11m
22210,3,Chipswow,2816,30,5,3,8,62.5%,13m
22210,2,sebidarness,2816,46,4,4,8,50.0%,4m
22210,3,Retribution,2816,133,3,3,6,50.0%,7m
22210,2,Weedz,2816,0,3,3,6,50.0%,14m
22210,3,gimaga,2816,0,3,3,6,50.0%,22m
22210,1,Simon,2816,96,3,4,7,42.9%,34m
22210,2,Potato,2816,94,3,13,16,18.8%,20m
22210,1,Eldar,2816,48,2,2,4,50.0%,16m
22210,3,Gabo,2816,30,2,2,4,50.0%,3m
22210,3,[Pub77]Pub,2816,90,2,3,5,40.0%,13m
22210,3,ЛексеР,2816,30,1,2,3,33.3%,13m
22210,3,Artexe,2816,0,1,2,3,33.3%,14m
22210,1,[Tino]SERINGA,2816,0,0,1,1,0.0%,1h
22210,3,Zoub,2816,0,0,1,1,0.0%,23m
22210,3,MrOgo,2816,0,0,2,2,0.0%,22m
22247,1,NLBTW,2815,1569,218,227,445,49.0%,12m
22247,2,[VFN]inexistend,2815,1403,89,81,170,52.4%,6m
22247,3,Ulrezaj,2815,788,52,40,92,56.5%,3m
22247,3,Lares,2815,693,35,36,71,49.3%,4m
22247,2,Aloskg,2815,794,32,29,61,52.5%,14m
22247,3,[SworD3]ZergANgeL,2815,498,21,16,37,56.8%,9m
22247,3,Shift,2815,391,18,7,25,72.0%,23m
22247,3,[sTarTA]FishyOnMe,2815,423,17,15,32,53.1%,13m
22247,3,Dovi,2815,418,16,15,31,51.6%,7m
22247,3,[HMSC]Mondnacht,2815,400,15,12,27,55.6%,22m
22247,3,divo,2815,290,13,10,23,56.5%,20m
22247,3,[AzZ]Apfelmann,2815,316,11,12,23,47.8%,22m
22247,3,Banan,2815,242,9,11,20,45.0%,3m
22247,3,SunTzu,2815,210,8,9,17,47.1%,11m
22247,3,CallMeTibco,2815,180,7,9,16,43.8%,23m
22247,2,Skywalker,2815,221,7,12,19,36.8%,11m
22247,3,Arnibarb,2815,0,5,0,5,100.0%,23m
22247,3,[CNC3]CTpayC,2815,152,5,1,6,83.3%,28m
22247,3,Boriis,2815,192,5,4,9,55.6%,14m
22247,1,Raven,2815,183,5,5,10,50.0%,21m
22247,2,GruSHA,2815,126,3,3,6,50.0%,42m
22247,3,[J4E]Knochenkopf,2815,60,3,3,6,50.0%,20m
22247,3,Sprlativo,2815,0,3,3,6,50.0%,2m
22247,3,MAT,2815,0,3,3,6,50.0%,14m
22247,3,[dlgc]BeerKiller,2815,30,2,4,6,33.3%,23m
22247,3,DeviousD,2815,0,1,1,2,50.0%,4m
22247,3,[YDD]YouDuda,2815,0,0,1,1,0.0%,19m
22247,3,CptFuture,2815,0,0,1,1,0.0%,4m
22247,2,mixakalah,2815,0,0,1,1,0.0%,42m
22247,2,Werhunter,2815,0,0,2,2,0.0%,1h
22277,2,Niko,2814,1554,75,72,147,51.0%,8m
22277,3,TarronBryce,2814,1386,71,45,116,61.2%,21m
22277,2,SomEhoW,2814,898,65,62,127,51.2%,21m
22277,3,Premolevi,2814,1067,50,29,79,63.3%,17m
22277,3,sserg,2814,790,33,23,56,58.9%,23m
22277,3,kaiNee,2814,386,22,7,29,75.9%,11m
22277,3,[OPMFS]ashakni,2814,436,19,9,28,67.9%,2m
22277,3,einstein,2814,424,18,9,27,66.7%,17m
22277,3,[ASS]Konrad,2814,417,16,12,28,57.1%,2m
22277,3,[C0RE]Scrappy,2814,377,14,17,31,45.2%,14m
22277,3,[BULETX]BlackFlag,2814,359,12,13,25,48.0%,5m
22277,3,Peudanos,2814,312,10,11,21,47.6%,17m
22277,3,[WldCaT]YummyDead,2814,266,9,6,15,60.0%,11m
22277,2,Wolftrack,2814,141,7,0,7,100.0%,1h
22277,3,PORLAT,2814,146,6,6,12,50.0%,19m
22277,1,[MRDRD]MayBe,2814,192,5,10,15,33.3%,1h
22277,3,[oVDMo]Arael,2814,133,3,2,5,60.0%,2m
22277,3,vadvim,2814,58,3,2,5,60.0%,4m
22277,3,caner,2814,60,3,3,6,50.0%,23m
22277,3,teksla,2814,46,2,3,5,40.0%,7m
22277,3,frodo,2814,0,1,0,1,100.0%,23m
22277,2,BlackStorm,2814,0,1,1,2,50.0%,38m
22277,3,Lathspell,2814,0,1,1,2,50.0%,18m
22277,1,bruman,2814,0,1,1,2,50.0%,46m
22277,3,BarBatos,2814,30,1,2,3,33.3%,22m
22277,3,GladHeAteHer,2814,0,0,1,1,0.0%,19m
22277,3,Danil,2814,0,0,1,1,0.0%,2m
22277,3,stick,2814,0,0,1,1,0.0%,11m
22277,2,Tandarul,2814,0,0,1,1,0.0%,1h
22277,3,Klaus,2814,0,0,2,2,0.0%,9m
22307,2,[1961]Rhodie,2813,1566,202,197,399,50.6%,6m
22307,2,Protoss,2813,1379,121,125,246,49.2%,2m
22307,2,MutaBor,2813,1584,116,116,232,50.0%,3m
22307,3,CHEESE,2813,1400,107,88,195,54.9%,10m
22307,2,[xFRSx]Nemesis,2813,1454,84,68,152,55.3%,21m
22307,3,Nobody,2813,747,82,73,155,52.9%,5m
22307,2,DemOk,2813,1057,67,63,130,51.5%,3m
22307,3,Whity,2813,1092,46,37,83,55.4%,22m
22307,3,mathchis,2813,519,37,33,70,52.9%,9m
22307,3,one,2813,696,32,25,57,56.1%,2m
22307,3,Darkened,2813,613,28,22,50,56.0%,23m
22307,3,[3Dǃ]kitsune,2813,568,26,17,43,60.5%,11m
22307,2,[Z3RGTV]Nikolya,2813,528,26,34,60,43.3%,15m
22307,1,ILY,2813,777,26,37,63,41.3%,5m
22307,3,decto,2813,520,23,14,37,62.2%,18m
22307,3,[Ypikaï]Plopix,2813,634,23,23,46,50.0%,14m
22307,2,Kwot,2813,516,17,25,42,40.5%,21m
22307,3,SEBTAINE,2813,262,10,11,21,47.6%,17m
22307,3,[LFTW]XLoRD,2813,260,9,10,19,47.4%,4m
22307,3,DroX,2813,155,8,4,12,66.7%,20m
22307,3,Michavangal,2813,239,8,7,15,53.3%,20m
22307,3,Celta,2813,120,7,1,8,87.5%,4m
22307,3,Medusa,2813,192,7,1,8,87.5%,22m
22307,3,[HDPL]AlainBerset,2813,144,6,2,8,75.0%,5m
22307,3,TheKoner,2813,213,6,8,14,42.9%,22m
22307,2,[НH]Merdrim,2813,48,5,3,8,62.5%,1h
22307,3,Cerodes,2813,121,4,0,4,100.0%,4m
22307,2,Scorpion,2813,139,4,5,9,44.4%,5m
22307,3,Veresk,2813,86,4,5,9,44.4%,3m
22307,3,Venter,2813,0,3,2,5,60.0%,2m
22307,3,GomerKya,2813,0,3,2,5,60.0%,5m
22307,2,Tandow,2813,0,3,2,5,60.0%,40m
22307,2,Gleboncer,2813,0,3,3,6,50.0%,42m
22307,3,Lich,2813,88,2,0,2,100.0%,21m
22307,3,Miracle,2813,30,2,1,3,66.7%,8m
22307,3,[453]EwigerNoob,2813,114,2,1,3,66.7%,8m
22307,3,Phantom,2813,0,1,0,1,100.0%,11m
22307,3,IlluvataR,2813,0,1,0,1,100.0%,8m
22307,3,Arka,2813,30,1,2,3,33.3%,14m
22307,3,Viperon,2813,30,1,3,4,25.0%,5m
22307,3,JohnSkyspar,2813,30,1,3,4,25.0%,14m
22307,3,BlueberryYum,2813,30,1,4,5,20.0%,19m
22307,2,[Hаsu]BiHiTRiLL,2813,0,0,1,1,0.0%,30m
22307,3,Ralph,2813,0,0,1,1,0.0%,7m
22351,3,Potato,2812,1601,224,208,432,51.9%,19m
22351,3,Frenga,2812,1126,125,112,237,52.7%,8m
22351,3,[TlGd]SirConçis,2812,844,80,73,153,52.3%,4m
22351,3,SinT,2812,1427,72,58,130,55.4%,2m
22351,3,HelloWorld,2812,620,69,59,128,53.9%,4m
22351,3,shadowclone,2812,933,56,43,99,56.6%,14m
22351,3,nuTTsik,2812,401,53,41,94,56.4%,11m
22351,3,IREFUSE,2812,618,29,15,44,65.9%,2m
22351,3,Destroyer,2812,582,26,16,42,61.9%,28m
22351,3,Lion,2812,622,24,23,47,51.1%,20m
22351,2,PAIC,2812,640,22,33,55,40.0%,22m
22351,2,Archy,2812,470,20,23,43,46.5%,7m
22351,3,Akotea,2812,332,19,4,23,82.6%,20m
22351,2,[BjwA]prophet,2812,518,18,26,44,40.9%,28m
22351,3,DemonSlayer,2812,422,17,10,27,63.0%,23m
22351,2,[PLBG]KOZAKPL,2812,364,17,19,36,47.2%,17m
22351,3,DarkSoul,2812,246,10,9,19,52.6%,3m
22351,3,[TBKH]iCykaAtZH,2812,290,10,12,22,45.5%,10m
22351,1,Dreznak,2812,268,10,14,24,41.7%,18m
22351,3,Zermingore,2812,205,8,4,12,66.7%,2m
22351,3,Prokop,2812,200,8,7,15,53.3%,21m
22351,3,ЭтотЦарь,2812,194,6,1,7,85.7%,1h
22351,3,Claire,2812,135,6,3,9,66.7%,7m
22351,3,AngryBit,2812,207,6,4,10,60.0%,4m
22351,3,elvesCastle,2812,114,5,8,13,38.5%,2m
22351,3,ZrgXX,2812,94,4,0,4,100.0%,11m
22351,3,Mike,2812,141,4,1,5,80.0%,11m
22351,3,Gylisan,2812,158,4,3,7,57.1%,14m
22351,3,SULCA,2812,121,3,1,4,75.0%,10m
22351,1,[invc]IdrA,2812,121,3,2,5,60.0%,28m
22351,2,Dopeaf,2812,94,3,2,5,60.0%,36m
22351,3,skyclasher,2812,0,3,3,6,50.0%,4m
22351,3,ROA,2812,30,2,1,3,66.7%,22m
22351,3,Diems,2812,118,2,2,4,50.0%,21m
22351,3,popicu,2812,30,1,2,3,33.3%,12m
22351,3,pownzter,2812,0,1,3,4,25.0%,2m
22351,3,SoupCatcher,2812,0,0,1,1,0.0%,19m
22351,3,Berserker,2812,0,0,1,1,0.0%,10m
22351,2,äLgRemslem,2812,0,0,1,1,0.0%,3m
22351,3,Jarinios,2812,0,0,2,2,0.0%,11m
22351,3,AskYani,2812,0,0,6,6,0.0%,2m
22392,2,aheless,2811,1251,235,220,455,51.6%,2m
22392,2,myWayBronze,2811,1572,180,167,347,51.9%,4m
22392,2,KillGodhouse,2811,1136,114,101,215,53.0%,3m
22392,3,Giolitti,2811,801,91,73,164,55.5%,3m
22392,3,vinci,2811,1129,63,53,116,54.3%,19m
22392,3,[InitRu]Lambo,2811,453,55,27,82,67.1%,2m
22392,3,REALbestname,2811,1075,53,31,84,63.1%,23m
22392,3,[PLA2N]Menorik,2811,1000,45,30,75,60.0%,17m
22392,3,Clouddigger,2811,1066,40,43,83,48.2%,12m
22392,3,Paul,2811,986,36,37,73,49.3%,22m
22392,2,eliaz,2811,768,31,31,62,50.0%,22m
22392,3,Pietro,2811,604,27,15,42,64.3%,20m
22392,3,[RBP3]Byshop,2811,641,27,25,52,51.9%,8m
22392,1,mumin,2811,680,26,27,53,49.1%,5m
22392,3,[IFDP]Chemical,2811,251,20,9,29,69.0%,19m
22392,3,[Altair]Reynor,2811,490,20,17,37,54.1%,13m
22392,2,[Hartz]Fexxis,2811,231,17,15,32,53.1%,12m
22392,2,Hazelnut,2811,440,16,23,39,41.0%,15m
22392,3,aigux,2811,191,15,4,19,78.9%,14m
22392,3,Maartappel,2811,374,15,11,26,57.7%,28m
22392,3,DSKerryJ,2811,266,13,5,18,72.2%,16m
22392,1,ApolloRO,2811,327,13,12,25,52.0%,46m
22392,3,iza,2811,261,10,4,14,71.4%,3m
22392,2,karanas,2811,246,10,12,22,45.5%,1h
22392,3,mRk,2811,194,6,4,10,60.0%,19m
22392,3,gianterrazza,2811,30,5,3,8,62.5%,22m
22392,2,imprialHALFe,2811,132,5,6,11,45.5%,6m
22392,3,Morkaratt,2811,86,4,3,7,57.1%,5m
22392,3,Riprdo,2811,163,4,3,7,57.1%,23m
22392,3,tuchkovserg,2811,90,3,1,4,75.0%,17m
22392,2,ElMustachio,2811,0,3,3,6,50.0%,1h
22392,2,Dimon,2811,0,3,3,6,50.0%,1h
22392,1,Restrepo,2811,119,2,2,4,50.0%,1h
22392,3,korkers,2811,58,2,3,5,40.0%,21m
22392,2,Студент,2811,0,0,1,1,0.0%,42m
22392,3,IronTrooper,2811,0,0,2,2,0.0%,20m
22392,3,Eli,2811,0,0,6,6,0.0%,8m
22429,3,Maevius,2810,693,125,116,241,51.9%,22m
22429,3,Zendo,2810,1578,112,106,218,51.4%,4m
22429,2,Perses,2810,1384,83,72,155,53.5%,8m
22429,2,alex,2810,1270,74,72,146,50.7%,21m
22429,3,Omaba,2810,1576,70,56,126,55.6%,17m
22429,3,inexxt,2810,1091,50,45,95,52.6%,20m
22429,3,Andrey,2810,589,45,32,77,58.4%,19m
22429,2,Kaofael,2810,963,37,43,80,46.2%,15m
22429,3,CNM,2810,519,27,17,44,61.4%,17m
22429,3,kababik,2810,534,24,12,36,66.7%,3m
22429,3,MefizZzda,2810,433,22,10,32,68.8%,11m
22429,3,[LMBD]LaZMariNE,2810,541,22,15,37,59.5%,18m
22429,3,Calzador,2810,513,19,18,37,51.4%,15m
22429,3,[ShSq]Randomizer,2810,433,18,18,36,50.0%,15m
22429,3,Robicika,2810,337,14,11,25,56.0%,15m
22429,3,Schepad,2810,331,14,12,26,53.8%,23m
22429,3,Rehsur,2810,295,12,10,22,54.5%,28m
22429,3,caveslider,2810,278,10,8,18,55.6%,3m
22429,3,azor,2810,302,10,16,26,38.5%,13m
22429,2,delord,2810,159,7,6,13,53.8%,41m
22429,3,Hrust,2810,176,7,6,13,53.8%,7m
22429,3,Shev,2810,212,6,6,12,50.0%,12m
22429,3,Santee,2810,30,5,2,7,71.4%,28m
22429,3,Raasst,2810,124,5,5,10,50.0%,28m
22429,3,Wolfprince,2810,0,4,1,5,80.0%,6m
22429,3,Eclips,2810,138,3,2,5,60.0%,4m
22429,3,Cygnus,2810,146,3,3,6,50.0%,19m
22429,1,Kussi,2810,96,3,3,6,50.0%,39m
22429,3,[J4E]Snehulko,2810,136,3,3,6,50.0%,9m
22429,3,Nojaw,2810,94,2,0,2,100.0%,22m
22429,3,[Heroes]Hatsu,2810,94,2,0,2,100.0%,17m
22429,2,snob,2810,0,2,1,3,66.7%,44m
22429,2,Qymaen,2810,30,2,1,3,66.7%,26m
22429,3,[Heroes]BabyZergling,2810,116,2,2,4,50.0%,14m
22429,3,Фотонщик,2810,30,2,2,4,50.0%,19m
22429,3,Javlah,2810,92,2,2,4,50.0%,14m
22429,3,notyou,2810,30,2,5,7,28.6%,15m
22429,3,[Antik]MahesVarra,2810,0,1,0,1,100.0%,9m
22429,1,Хирург,2810,0,1,0,1,100.0%,16m
22429,3,nmsl,2810,0,1,0,1,100.0%,7m
22429,3,ApricotJam,2810,30,1,2,3,33.3%,11m
22429,3,Philty,2810,30,1,7,8,12.5%,21m
22429,3,[BSPD]Valkkyn,2810,0,0,1,1,0.0%,11m
22429,3,KeminSSHKG,2810,0,0,4,4,0.0%,11m
22473,1,Qbs,2809,1142,174,180,354,49.2%,11m
22473,2,killerILLER,2809,1370,92,94,186,49.5%,28m
22473,3,Sebasemen,2809,1361,89,70,159,56.0%,13m
22473,3,[696]Daimiel,2809,1468,88,73,161,54.7%,23m
22473,3,peterpan,2809,1167,48,53,101,47.5%,3m
22473,3,[Blakey]TheFallen,2809,928,46,25,71,64.8%,7m
22473,3,batist,2809,885,42,32,74,56.8%,11m
22473,3,Holidmar,2809,935,39,35,74,52.7%,10m
22473,3,[NINJ88]ImHbrow,2809,645,36,29,65,55.4%,28m
22473,2,TheRiddler,2809,930,33,36,69,47.8%,16m
22473,2,[DEDAL]wojtis,2809,776,28,34,62,45.2%,14m
22473,2,LovkosGirl,2809,824,27,38,65,41.5%,4m
22473,2,Trick,2809,557,22,19,41,53.7%,12m
22473,3,Patamon,2809,274,14,9,23,60.9%,19m
22473,3,[DS24]HABOW,2809,392,14,12,26,53.8%,13m
22473,3,kolya,2809,284,12,11,23,52.2%,22m
22473,1,themaster,2809,184,8,3,11,72.7%,4m
22473,3,Intro,2809,239,8,7,15,53.3%,19m
22473,3,LocO,2809,222,7,6,13,53.8%,12m
22473,3,[aDGa]Reaper,2809,184,7,7,14,50.0%,4m
22473,2,LarsVegas,2809,209,7,12,19,36.8%,23m
22473,2,[WGTro]IVABAWS,2809,48,5,2,7,71.4%,29m
22473,3,[MadKuy]ELkukuy,2809,60,3,2,5,60.0%,17m
22473,3,[TLLSC2]LurdFishHole,2809,94,3,3,6,50.0%,7m
22473,3,GoldLion,2809,147,3,4,7,42.9%,27m
22473,3,Batman,2809,30,2,2,4,50.0%,12m
22473,3,Леонел,2809,30,2,2,4,50.0%,17m
22473,3,Gardboy,2809,0,2,3,5,40.0%,2m
22473,2,AnCiEnT,2809,95,2,4,6,33.3%,8m
22473,3,Rhondrakus,2809,94,1,1,2,50.0%,5m
22473,3,xNinjaFish,2809,30,1,2,3,33.3%,11m
22473,3,ChillWars,2809,0,1,3,4,25.0%,3m
22473,3,Buggy,2809,0,1,4,5,20.0%,5m
22473,3,vgta,2809,0,0,1,1,0.0%,12m
22473,3,EFT,2809,0,0,1,1,0.0%,16m
22473,3,Baconbaby,2809,0,0,1,1,0.0%,28m
22509,2,Nyomdasz,2808,1276,97,89,186,52.2%,12m
22509,3,[FKTS]Templada,2808,1292,81,69,150,54.0%,17m
22509,3,RiderUA,2808,1583,81,76,157,51.6%,5m
22509,2,Denman,2808,969,62,55,117,53.0%,5m
22509,3,Adeptus,2808,1098,59,33,92,64.1%,3m
22509,3,Vikz,2808,698,43,27,70,61.4%,18m
22509,3,PAIN,2808,752,36,25,61,59.0%,5m
22509,2,Rai,2808,915,36,37,73,49.3%,3m
22509,3,[696]NearEdge,2808,582,28,12,40,70.0%,3m
22509,3,[R33]Damnight,2808,132,26,5,31,83.9%,19m
22509,3,Darulio,2808,682,25,26,51,49.0%,12m
22509,2,DariuS,2808,536,20,22,42,47.6%,2m
22509,2,makita,2808,359,19,20,39,48.7%,13m
22509,3,[NWGD]GraphpiTTV,2808,408,15,11,26,57.7%,4m
22509,3,Dok,2808,417,15,12,27,55.6%,14m
22509,3,sebzore,2808,349,13,9,22,59.1%,6m
22509,3,[H0MiE]Vorazim,2808,251,10,9,19,52.6%,26m
22509,3,Leps,2808,217,9,8,17,52.9%,17m
22509,2,Drogenfar,2808,257,9,15,24,37.5%,22m
22509,3,IIIIIIIIIIII,2808,192,7,1,8,87.5%,15m
22509,3,Zmora,2808,174,7,6,13,53.8%,5m
22509,2,[CWCD]вапыапмивчам,2808,186,6,9,15,40.0%,4m
22509,3,Catch,2808,118,5,4,9,55.6%,19m
22509,1,[WpG]NLK,2808,192,5,4,9,55.6%,1h
22509,3,[sgc]swarley,2808,151,5,5,10,50.0%,14m
22509,2,CrossStroke,2808,164,4,0,4,100.0%,46m
22509,3,RaZZoR,2808,133,4,2,6,66.7%,19m
22509,2,DyingDead,2808,48,4,3,7,57.1%,30m
22509,1,Koyo,2808,96,3,3,6,50.0%,4m
22509,3,Deer,2808,58,3,3,6,50.0%,3m
22509,3,Pave,2808,143,3,3,6,50.0%,12m
22509,3,Invictus,2808,142,3,3,6,50.0%,10m
22509,3,Yup,2808,91,3,3,6,50.0%,23m
22509,3,Alvar,2808,62,3,5,8,37.5%,11m
22509,3,Tonito,2808,0,2,0,2,100.0%,22m
22509,2,Ragnar,2808,88,2,2,4,50.0%,5m
22509,3,pixelkrafter,2808,30,2,2,4,50.0%,11m
22509,3,[Ihanri]ThanderKnigh,2808,30,2,6,8,25.0%,22m
22509,3,Gonzo,2808,0,1,0,1,100.0%,19m
22509,3,treegOrc,2808,0,1,0,1,100.0%,12m
22509,3,Korkee,2808,30,1,3,4,25.0%,3m
22509,3,ГИБКИЙВАЛЕРА,2808,30,1,5,6,16.7%,17m
22509,1,Collaps,2808,0,1,6,7,14.3%,15m
22509,3,Neodreamer,2808,0,0,1,1,0.0%,21m
22509,3,Mutur,2808,0,0,1,1,0.0%,18m
22509,1,Karasiu,2808,0,0,3,3,0.0%,25m
22555,3,[LifeTV]MatteoZo,2807,1536,140,112,252,55.6%,2m
22555,2,[1C5]CocainCowboy,2807,1411,128,117,245,52.2%,7m
22555,2,MrH,2807,1593,125,125,250,50.0%,2m
22555,3,AngelFace,2807,438,73,61,134,54.5%,11m
22555,2,Qin,2807,1166,58,58,116,50.0%,14m
22555,3,[Додик]ZeroTwo,2807,1022,54,18,72,75.0%,22m
22555,3,NaNome,2807,819,52,36,88,59.1%,5m
22555,3,Yuino,2807,734,34,24,58,58.6%,20m
22555,1,Exxidae,2807,846,34,36,70,48.6%,15m
22555,3,masterone,2807,475,30,20,50,60.0%,9m
22555,3,Samel,2807,323,28,15,43,65.1%,5m
22555,3,[Rus2]Zombie,2807,382,18,7,25,72.0%,14m
22555,2,[JEBE]Bojan,2807,494,17,25,42,40.5%,20m
22555,3,Ishtar,2807,372,16,9,25,64.0%,4m
22555,3,Noddy,2807,294,12,6,18,66.7%,23m
22555,3,[VoxX]sghjJR,2807,304,12,8,20,60.0%,20m
22555,3,yakrut,2807,268,10,7,17,58.8%,21m
22555,1,ДенАкс,2807,278,9,22,31,29.0%,4m
22555,2,BloodEnergy,2807,154,8,8,16,50.0%,6m
22555,3,[RеG]diablaid,2807,163,5,1,6,83.3%,19m
22555,2,darkarrow,2807,96,5,1,6,83.3%,1h
22555,3,KDJB,2807,90,4,3,7,57.1%,19m
22555,3,PapaLegba,2807,90,4,4,8,50.0%,23m
22555,2,[Ɖŕąĩǵǿ]Ćøũćøũţĕ,2807,162,4,6,10,40.0%,17m
22555,3,[Cancro]Heaconz,2807,0,2,3,5,40.0%,12m
22555,3,oil,2807,62,2,6,8,25.0%,7m
22555,3,Shury,2807,0,1,0,1,100.0%,1h
22555,2,ДаняПерчик,2807,48,1,1,2,50.0%,22m
22555,3,Hrust,2807,0,1,3,4,25.0%,4m
22555,3,[bvbo9]painuser,2807,30,1,4,5,20.0%,11m
22555,3,Mandos,2807,0,0,1,1,0.0%,20m
22555,3,[Fen]Mewtwo,2807,0,0,1,1,0.0%,10m
22555,3,[ATROYA]VIOLEITOR,2807,0,0,1,1,0.0%,23m
22555,3,eyesburn,2807,0,0,2,2,0.0%,18m
22555,3,Phoenix,2807,0,0,2,2,0.0%,23m
22590,3,Jolova,2806,1612,276,255,531,52.0%,14m
22590,3,Rubster,2806,1562,128,107,235,54.5%,4m
22590,3,tokus,2806,1105,94,85,179,52.5%,19m
22590,3,Dzjant,2806,1311,71,60,131,54.2%,28m
22590,1,bibo,2806,1483,59,66,125,47.2%,18m
22590,3,Logbook,2806,1312,55,48,103,53.4%,18m
22590,3,Ouroboros,2806,493,55,48,103,53.4%,23m
22590,3,Цыган,2806,1060,54,27,81,66.7%,17m
22590,2,Tonnant,2806,1229,48,50,98,49.0%,13m
22590,3,Homerun,2806,939,44,35,79,55.7%,17m
22590,3,Tempent,2806,865,43,40,83,51.8%,14m
22590,3,ciupaila,2806,459,36,21,57,63.2%,13m
22590,3,titanmax,2806,801,31,25,56,55.4%,16m
22590,3,Hydrius,2806,599,29,18,47,61.7%,3m
22590,3,xarkov,2806,516,25,26,51,49.0%,11m
22590,3,DarkanghelL,2806,387,18,6,24,75.0%,23m
22590,3,[2iq]MacroLI,2806,323,14,8,22,63.6%,20m
22590,3,[MÄHC]Lemmiwinks,2806,164,14,9,23,60.9%,19m
22590,3,TcL,2806,363,14,16,30,46.7%,3m
22590,3,tuladansleq,2806,310,12,11,23,52.2%,14m
22590,3,ThaClown,2806,292,10,11,21,47.6%,11m
22590,3,[VanSyo]IIIIIIIIIIII,2806,204,9,0,9,100.0%,19m
22590,3,Tigi,2806,172,8,4,12,66.7%,20m
22590,3,Eugene,2806,219,7,6,13,53.8%,28m
22590,3,DeathAngel,2806,142,5,9,14,35.7%,21m
22590,3,zerstoerer,2806,134,4,4,8,50.0%,20m
22590,1,MrFluffed,2806,48,4,5,9,44.4%,22m
22590,3,[OPANA]RoarOfProxy,2806,62,3,5,8,37.5%,21m
22590,2,[iR3B]VeskZ,2806,0,1,0,1,100.0%,1h
22590,2,Texnarel,2806,0,1,0,1,100.0%,25m
22590,1,Gemmer,2806,48,1,2,3,33.3%,26m
22590,3,Vandeta,2806,30,1,2,3,33.3%,17m
22590,3,[GGPRC]Zacexplosion,2806,0,1,5,6,16.7%,28m
22590,3,[DoVV]AndEaD,2806,0,0,1,1,0.0%,5m
22590,3,Gneus,2806,0,0,1,1,0.0%,6m
22590,1,Solaris,2806,0,0,2,2,0.0%,10m
22626,2,Bixi,2805,1556,199,191,390,51.0%,4m
22626,2,napster,2805,1382,180,170,350,51.4%,8m
22626,3,Kos,2805,1557,156,151,307,50.8%,20m
22626,3,Tasher,2805,1194,98,80,178,55.1%,5m
22626,2,[tetguy]Gamygym,2805,1162,58,62,120,48.3%,15m
22626,3,DimonUA,2805,923,54,41,95,56.8%,14m
22626,3,Faust,2805,379,53,25,78,67.9%,22m
22626,3,Trospa,2805,741,51,49,100,51.0%,21m
22626,3,Rumus,2805,799,36,27,63,57.1%,13m
22626,3,[ODISO]igor,2805,811,31,26,57,54.4%,11m
22626,2,[Darlok]Sneft,2805,437,18,16,34,52.9%,2m
22626,3,OppsRepeat,2805,432,17,12,29,58.6%,21m
22626,3,PlanckTime,2805,147,15,10,25,60.0%,22m
22626,3,ivanko,2805,320,14,13,27,51.9%,2m
22626,3,Alex,2805,306,12,4,16,75.0%,2m
22626,3,[PiGPan]xXReaPeRWeeD,2805,269,9,6,15,60.0%,13m
22626,3,Zulgood,2805,220,9,8,17,52.9%,39m
22626,3,BlackDog,2805,141,9,11,20,45.0%,14m
22626,3,Mantis,2805,270,8,8,16,50.0%,22m
22626,3,TuPoReZ,2805,246,7,7,14,50.0%,4m
22626,2,Megapavel,2805,48,5,2,7,71.4%,13m
22626,2,Smog,2805,181,5,15,20,25.0%,12m
22626,3,Djeckson,2805,30,4,4,8,50.0%,24m
22626,3,delsolaris,2805,118,4,5,9,44.4%,6m
22626,3,PSTRQ,2805,30,3,1,4,75.0%,5m
22626,3,Oni,2805,114,3,1,4,75.0%,22m
22626,3,ScottMaison,2805,139,3,2,5,60.0%,19m
22626,3,danger,2805,58,3,4,7,42.9%,21m
22626,3,Arkham,2805,92,3,6,9,33.3%,20m
22626,3,[DEDAL]qizdaTor,2805,30,2,1,3,66.7%,8m
22626,3,Gagloi,2805,0,1,1,2,50.0%,21m
22626,1,Naamar,2805,97,1,2,3,33.3%,47m
22626,3,TogoRot,2805,0,1,4,5,20.0%,19m
22626,3,Stateless,2805,0,0,1,1,0.0%,10m
22626,3,Grimalkin,2805,0,0,1,1,0.0%,14m
22626,3,[INMK]Spadow,2805,0,0,1,1,0.0%,14m
22626,3,krrile,2805,0,0,2,2,0.0%,22m
22626,3,StiflersMom,2805,0,0,3,3,0.0%,11m
22626,1,[TurAg]Турист,2805,0,0,4,4,0.0%,1h
22665,3,[LSsc2]nkrs,2804,1571,136,116,252,54.0%,23m
22665,3,GIVEMEACAGE,2804,1563,110,100,210,52.4%,20m
22665,3,MrJennis,2804,1131,97,73,170,57.1%,28m
22665,3,Smb,2804,1013,71,53,124,57.3%,15m
22665,3,Perroflauta,2804,1086,49,39,88,55.7%,8m
22665,3,DEathkNIghtS,2804,531,39,35,74,52.7%,3m
22665,3,tadiya,2804,592,31,12,43,72.1%,23m
22665,3,NexusGhost,2804,777,30,32,62,48.4%,20m
22665,3,GhsT,2804,518,27,17,44,61.4%,17m
22665,2,[skh]CharlsDarwin,2804,709,26,32,58,44.8%,12m
22665,3,[SiGaMi]Starlord,2804,342,23,4,27,85.2%,19m
22665,2,EVGENFTF,2804,557,23,20,43,53.5%,20m
22665,3,cainiao,2804,597,22,23,45,48.9%,4m
22665,3,[SblS]Nord,2804,490,18,14,32,56.2%,4m
22665,3,Zalia,2804,397,17,9,26,65.4%,22m
22665,3,HeadHunteR,2804,331,14,11,25,56.0%,7m
22665,3,[KZstan]Noger,2804,419,14,15,29,48.3%,18m
22665,3,TheSwan,2804,254,12,2,14,85.7%,23m
22665,2,[sctrap]JungerPadawa,2804,293,12,9,21,57.1%,12m
22665,3,[13NRV]Mookie,2804,290,11,10,21,52.4%,17m
22665,2,[LosPH]Kebeb,2804,208,10,7,17,58.8%,14m
22665,2,PepitoZOZ,2804,94,4,2,6,66.7%,32m
22665,3,Sappn,2804,114,2,2,4,50.0%,7m
22665,3,MassiveBell,2804,0,2,3,5,40.0%,21m
22665,3,SEGREY,2804,62,2,5,7,28.6%,6m
22665,2,OKINYO,2804,114,2,8,10,20.0%,22m
22665,3,[LLAP]Nostromo,2804,0,1,0,1,100.0%,14m
22665,2,Mito,2804,0,1,1,2,50.0%,1h
22665,3,Snipersting,2804,0,1,1,2,50.0%,18m
22665,3,WhiteDemon,2804,0,1,1,2,50.0%,15m
22665,3,zilip,2804,94,1,1,2,50.0%,4m
22665,3,dissectional,2804,0,1,2,3,33.3%,28m
22665,1,GreyFox,2804,48,1,4,5,20.0%,30m
22665,3,[BRock]EmpireZ,2804,0,0,1,1,0.0%,4m
22665,3,[Spls]SpaceCow,2804,0,0,1,1,0.0%,22m
22665,3,МаленькийМук,2804,0,0,1,1,0.0%,11m
22665,3,Priorat,2804,0,0,1,1,0.0%,19m
22702,3,Fisherbek,2803,1072,309,294,603,51.2%,4m
22702,3,Bossov,2803,776,126,125,251,50.2%,11m
22702,3,HexagonSun,2803,1397,119,110,229,52.0%,28m
22702,3,[NINJ88]Aubryknight,2803,1582,115,92,207,55.6%,28m
22702,2,funny,2803,1378,106,94,200,53.0%,5m
22702,3,Katsumoto,2803,1528,106,95,201,52.7%,17m
22702,2,Atoss,2803,859,101,96,197,51.3%,22m
22702,3,Lena,2803,963,83,63,146,56.8%,19m
22702,3,ShinköGane,2803,1422,76,51,127,59.8%,28m
22702,3,illuminated,2803,1429,70,51,121,57.9%,6m
22702,3,Kerrigan,2803,1255,65,48,113,57.5%,20m
22702,3,yang,2803,742,36,21,57,63.2%,17m
22702,3,LuckyNoob,2803,532,35,22,57,61.4%,13m
22702,3,invert,2803,632,27,21,48,56.2%,6m
22702,3,[PompaE]stwr,2803,449,20,11,31,64.5%,20m
22702,2,Duck,2803,485,19,21,40,47.5%,20m
22702,2,NasH,2803,166,17,25,42,40.5%,20m
22702,3,[R0]Ketodar,2803,411,15,12,27,55.6%,21m
22702,3,Stew,2803,349,14,16,30,46.7%,21m
22702,3,DimaBorsch,2803,273,11,6,17,64.7%,10m
22702,3,ViP,2803,333,11,9,20,55.0%,11m
22702,3,RoffeRuff,2803,272,9,8,17,52.9%,21m
22702,3,[pokoik]mpQampQ,2803,254,9,13,22,40.9%,21m
22702,3,[GGeben]Zeratul,2803,139,6,6,12,50.0%,23m
22702,3,IIIIIIIIIIII,2803,106,4,3,7,57.1%,5m
22702,1,mmaaa,2803,97,4,3,7,57.1%,46m
22702,3,jupi,2803,30,4,3,7,57.1%,4m
22702,2,[АNIМЕ]kot,2803,0,4,3,7,57.1%,10m
22702,2,zACz,2803,120,4,10,14,28.6%,20m
22702,3,[Peq]KilledByPing,2803,109,3,0,3,100.0%,7m
22702,3,Nikola,2803,115,3,1,4,75.0%,3m
22702,2,Dopen,2803,0,3,2,5,60.0%,5m
22702,3,Tamkos,2803,91,3,3,6,50.0%,8m
22702,3,momo,2803,95,3,3,6,50.0%,17m
22702,2,RIDLE,2803,46,3,4,7,42.9%,1h
22702,3,[KZADS]Nicolas,2803,60,3,5,8,37.5%,4m
22702,3,Shipy,2803,97,2,2,4,50.0%,1h
22702,3,EATDAOLEPpoo,2803,58,2,3,5,40.0%,20m
22702,3,[BZEZs]SunnyPeps,2803,0,1,0,1,100.0%,20m
22702,3,Mizeri,2803,0,1,0,1,100.0%,8m
22702,3,MIST,2803,0,1,0,1,100.0%,6m
22702,3,[Tirith]Nestor,2803,94,1,1,2,50.0%,13m
22702,3,PapaDave,2803,94,1,1,2,50.0%,28m
22702,3,netfox,2803,30,1,5,6,16.7%,13m
22702,3,[SiTFLY]ryeryerye,2803,0,0,1,1,0.0%,19m
22702,3,Kolupso,2803,0,0,1,1,0.0%,9m
22702,1,TCrunk,2803,0,0,1,1,0.0%,39m
22749,3,MarekRakieta,2802,1600,121,94,215,56.3%,12m
22749,2,KorObaKinari,2802,697,107,97,204,52.5%,10m
22749,3,MagicInc,2802,1161,94,70,164,57.3%,19m
22749,3,FYR,2802,1334,61,44,105,58.1%,2m
22749,3,Bab,2802,713,33,25,58,56.9%,20m
22749,3,матвей,2802,746,28,26,54,51.9%,12m
22749,2,Smlt,2802,729,28,28,56,50.0%,4m
22749,3,[DILIT]MaXiNe,2802,572,27,11,38,71.1%,22m
22749,2,[CuWoǂ]CuWoǂBuTcHeR,2802,565,26,23,49,53.1%,12m
22749,3,[3CHATS]BadPachi,2802,511,20,17,37,54.1%,14m
22749,3,[InitRu]consoleLog,2802,262,19,7,26,73.1%,21m
22749,3,Wamp,2802,411,18,10,28,64.3%,2m
22749,3,Butch,2802,302,11,6,17,64.7%,18m
22749,3,SusakiSir,2802,251,10,10,20,50.0%,27m
22749,3,CobraKai,2802,215,7,5,12,58.3%,4m
22749,1,Klitzipetel,2802,206,6,16,22,27.3%,11m
22749,3,CVDH,2802,201,5,8,13,38.5%,2m
22749,3,Negropasta,2802,139,4,2,6,66.7%,10m
22749,3,Überninja,2802,144,4,2,6,66.7%,23m
22749,2,RazielL,2802,117,4,3,7,57.1%,14m
22749,3,flagg,2802,0,4,5,9,44.4%,15m
22749,3,Zaigetsan,2802,120,4,6,10,40.0%,22m
22749,2,[iTeam]BaronMike,2802,0,3,2,5,60.0%,42m
22749,3,Nextezy,2802,58,3,3,6,50.0%,15m
22749,3,[THANOS]Gancescu,2802,88,3,6,9,33.3%,7m
22749,3,UFO,2802,94,2,1,3,66.7%,19m
22749,3,[CoSmE]princeludo,2802,30,2,2,4,50.0%,17m
22749,3,Django,2802,30,2,3,5,40.0%,23m
22749,1,[ĦĦ]KenKeez,2802,48,2,3,5,40.0%,13m
22749,2,CyberPotato,2802,0,2,4,6,33.3%,40m
22749,3,Nik,2802,0,1,0,1,100.0%,21m
22749,3,JosUA,2802,0,1,1,2,50.0%,17m
22749,2,marinda,2802,46,1,1,2,50.0%,47m
22749,2,pete,2802,0,1,2,3,33.3%,29m
22749,3,[WOLF21]ACE,2802,0,1,2,3,33.3%,19m
22749,3,charl,2802,30,1,3,4,25.0%,15m
22749,2,SchizoNOR,2802,48,1,7,8,12.5%,1h
22749,3,[Hppl]Axezz,2802,0,0,1,1,0.0%,19m
22749,3,noname,2802,0,0,1,1,0.0%,10m
22749,3,Vici,2802,0,0,2,2,0.0%,23m
22749,3,Dakre,2802,0,0,2,2,0.0%,11m
22749,3,PAT,2802,0,0,4,4,0.0%,2m
22791,3,VanQuish,2801,608,157,151,308,51.0%,18m
22791,3,Lizguz,2801,1280,127,146,273,46.5%,5m
22791,2,Sanchez,2801,1558,105,85,190,55.3%,12m
22791,3,Andr,2801,1569,68,57,125,54.4%,23m
22791,3,Intoxikot,2801,601,60,46,106,56.6%,4m
22791,3,Osetrina,2801,1418,58,56,114,50.9%,14m
22791,3,jplgg,2801,339,36,21,57,63.2%,11m
22791,3,LuciferSam,2801,390,35,30,65,53.8%,21m
22791,3,Breed,2801,653,31,13,44,70.5%,16m
22791,3,teran,2801,483,31,30,61,50.8%,4m
22791,3,[BLO0DY]MARS,2801,573,27,13,40,67.5%,23m
22791,1,Skinkryttarn,2801,496,21,27,48,43.8%,10m
22791,3,VeGa,2801,457,16,18,34,47.1%,15m
22791,3,hahat,2801,356,15,16,31,48.4%,22m
22791,1,Mantis,2801,404,14,17,31,45.2%,23m
22791,3,Pinghinizer,2801,140,8,2,10,80.0%,8m
22791,3,[TG]neumde,2801,211,7,5,12,58.3%,4m
22791,3,[Bawsz]ImAGine,2801,249,7,6,13,53.8%,20m
22791,3,[торТВ]Serzhantik,2801,204,7,8,15,46.7%,28m
22791,3,SirPoopins,2801,110,6,2,8,75.0%,18m
22791,3,CoolAndrew,2801,200,6,4,10,60.0%,28m
22791,3,llllll,2801,56,5,6,11,45.5%,19m
22791,2,WhySoSerious,2801,88,4,13,17,23.5%,7m
22791,2,Bonersoup,2801,95,3,3,6,50.0%,1h
22791,2,wRurku,2801,0,3,3,6,50.0%,12m
22791,3,Malezizio,2801,93,2,0,2,100.0%,5m
22791,3,OmgFoxeD,2801,30,2,3,5,40.0%,5m
22791,3,[mfxed]MioFx,2801,50,2,3,5,40.0%,19m
22791,3,Legato,2801,62,2,6,8,25.0%,13m
22791,3,vadimSFru,2801,0,1,0,1,100.0%,13m
22791,3,[BHQLO]Kreenos,2801,30,1,3,4,25.0%,19m
22791,3,DrVRay,2801,30,1,6,7,14.3%,21m
22791,3,wipeOut,2801,0,0,1,1,0.0%,2m
22791,3,TerminatorGt,2801,0,0,1,1,0.0%,14m
22791,3,NicksoN,2801,0,0,1,1,0.0%,26m
22791,2,sln,2801,0,0,1,1,0.0%,41m
22791,3,glitchone,2801,0,0,2,2,0.0%,10m
22791,3,Nexus,2801,0,0,7,7,0.0%,9m
22829,3,Matrixar,2800,901,136,131,267,50.9%,10m
22829,3,brdk,2800,1557,78,61,139,56.1%,22m
22829,3,LandStalker,2800,603,57,43,100,57.0%,11m
22829,1,MahatmaHandy,2800,794,54,59,113,47.8%,7m
22829,3,Papir,2800,1097,45,35,80,56.2%,9m
22829,3,Rolly,2800,730,35,16,51,68.6%,5m
22829,3,IntroSpirit,2800,802,35,27,62,56.5%,10m
22829,3,HappyHour,2800,604,29,25,54,53.7%,10m
22829,3,KingKong,2800,303,25,18,43,58.1%,22m
22829,3,bynature,2800,501,23,21,44,52.3%,12m
22829,3,yolosix,2800,563,22,17,39,56.4%,4m
22829,3,[Bwolfs]Lurcak,2800,532,21,19,40,52.5%,6m
22829,3,Zealoids,2800,432,20,17,37,54.1%,21m
22829,3,DrDlPSHlT,2800,215,8,8,16,50.0%,6m
22829,2,maxBUANGXD,2800,117,7,6,13,53.8%,1h
22829,1,[sOv2]Abacus,2800,217,7,11,18,38.9%,5m
22829,3,Cheesus,2800,134,5,3,8,62.5%,28m
22829,3,KIRILLL,2800,119,5,6,11,45.5%,23m
22829,1,Caradryan,2800,96,4,6,10,40.0%,1h
22829,3,[SPAINs]Avefenix,2800,62,3,3,6,50.0%,18m
22829,3,ChristianF,2800,0,3,3,6,50.0%,10m
22829,3,DuMaCoH,2800,93,2,0,2,100.0%,18m
22829,1,[VdP]Goldorak,2800,80,2,3,5,40.0%,32m
22829,3,TheStickyBun,2800,0,2,3,5,40.0%,20m
22829,2,Werrel,2800,0,2,3,5,40.0%,39m
22829,3,[TeamKy]KryroK,2800,60,2,4,6,33.3%,21m
22829,1,kobra,2800,0,0,1,1,0.0%,1h
22856,3,[lgdjn]Shibumi,2799,1567,279,251,530,52.6%,19m
22856,3,Metoecen,2799,1037,71,56,127,55.9%,8m
22856,2,Fighter,2799,253,41,33,74,55.4%,4m
22856,3,Life,2799,340,31,29,60,51.7%,5m
22856,2,Vino,2799,802,29,37,66,43.9%,6m
22856,2,Nebu,2799,729,27,27,54,50.0%,10m
22856,3,[GGZERG]Quintessence,2799,576,24,17,41,58.5%,5m
22856,3,Flakon,2799,582,21,27,48,43.8%,5m
22856,3,Overmind,2799,500,20,18,38,52.6%,16m
22856,3,Anthony,2799,384,17,8,25,68.0%,12m
22856,3,Grubby,2799,433,17,10,27,63.0%,2m
22856,2,VictoR,2799,257,11,11,22,50.0%,10m
22856,3,DarkWarirror,2799,291,10,12,22,45.5%,23m
22856,1,[CFL]Popsibuksi,2799,192,7,5,12,58.3%,34m
22856,1,Jesus,2799,246,7,6,13,53.8%,32m
22856,3,beHappy,2799,210,6,6,12,50.0%,8m
22856,2,DeathCast,2799,180,5,7,12,41.7%,10m
22856,1,Tales,2799,163,3,1,4,75.0%,16m
22856,2,Sander,2799,0,3,3,6,50.0%,1h
22856,2,[CS0]ProTau,2799,46,3,5,8,37.5%,4m
22856,1,[DEDAL]gwiezdnywilk,2799,42,2,0,2,100.0%,23m
22856,3,Сварожич,2799,120,2,3,5,40.0%,18m
22856,1,MMM,2799,0,1,0,1,100.0%,1h
22856,2,[ONKIE]binloadin,2799,0,1,0,1,100.0%,31m
22856,1,[NTLA]Krzychu,2799,0,1,0,1,100.0%,1h
22856,3,Ulfric,2799,30,1,2,3,33.3%,19m
22856,3,puzan,2799,30,1,3,4,25.0%,3m
22856,2,Dummy,2799,0,1,4,5,20.0%,1h
22856,2,[TAW]TinGodzilla,2799,0,0,1,1,0.0%,41m
22856,2,Víctor,2799,0,0,1,1,0.0%,19m
22856,1,HunterPUV,2799,0,0,1,1,0.0%,27m
22856,1,Evgeniy,2799,0,0,2,2,0.0%,46m
22888,3,[CОS]Vsign,2798,1581,127,125,252,50.4%,6m
22888,2,Zzz,2798,1586,124,122,246,50.4%,14m
22888,2,[DvX]Boroda,2798,1129,81,77,158,51.3%,12m
22888,1,Wuhmech,2798,1412,54,44,98,55.1%,12m
22888,3,Mafloom,2798,1063,47,37,84,56.0%,28m
22888,3,Mutalisk,2798,885,47,46,93,50.5%,11m
22888,3,[Posos]FlashSamolet,2798,1018,45,46,91,49.5%,19m
22888,1,Rychard,2798,1070,35,31,66,53.0%,48m
22888,2,Malzadas,2798,924,35,39,74,47.3%,14m
22888,3,NeKoSeNPAi,2798,620,30,24,54,55.6%,28m
22888,3,DUM,2798,604,29,13,42,69.0%,6m
22888,3,Slepoy,2798,463,19,18,37,51.4%,5m
22888,3,[298K]Okarin,2798,283,11,6,17,64.7%,20m
22888,3,Eschaton,2798,299,11,14,25,44.0%,11m
22888,2,XenZeus,2798,140,6,7,13,46.2%,4m
22888,3,[SkeSS]JensDemens,2798,172,6,11,17,35.3%,1h
22888,1,[31415]skvol,2798,205,5,2,7,71.4%,28m
22888,3,LastEmperor,2798,150,5,8,13,38.5%,4m
22888,2,sultana,2798,150,5,14,19,26.3%,6m
22888,1,dronpoet,2798,130,5,17,22,22.7%,22m
22888,1,Buckelheiner,2798,118,4,3,7,57.1%,24m
22888,1,Camembert,2798,0,3,2,5,60.0%,24m
22888,3,Timo,2798,60,3,6,9,33.3%,7m
22888,2,maxpower,2798,96,3,10,13,23.1%,20m
22888,1,[glhfCZ]Toxin,2798,38,2,0,2,100.0%,1h
22888,3,[RTO]maxiemaa,2798,30,2,2,4,50.0%,22m
22888,3,GGbro,2798,119,2,3,5,40.0%,5m
22888,3,[35BZH]BattleBoy,2798,30,2,4,6,33.3%,23m
22888,1,Vision,2798,0,1,0,1,100.0%,18m
22888,1,snaxy,2798,0,1,0,1,100.0%,22m
22888,1,rserpolakcyc,2798,0,1,0,1,100.0%,4m
22888,2,Tvanok,2798,0,1,0,1,100.0%,40m
22888,1,pogromcajiff,2798,40,1,1,2,50.0%,14m
22888,3,ozergen,2798,94,1,2,3,33.3%,4m
22888,3,[LQV]Mike,2798,0,1,3,4,25.0%,12m
22888,2,YARRYOZZO,2798,0,0,1,1,0.0%,1h
22888,1,Uberdryzz,2798,0,0,1,1,0.0%,1h
22888,3,Mikecall,2798,0,0,3,3,0.0%,5m
22926,2,rrr,2797,1511,106,98,204,52.0%,5m
22926,3,HeavenRaven,2797,1334,63,60,123,51.2%,14m
22926,1,[4vD]WolfBlooded,2797,552,47,28,75,62.7%,14m
22926,3,luckeR,2797,831,32,32,64,50.0%,20m
22926,3,DeLorean,2797,624,23,21,44,52.3%,21m
22926,1,[V1]waf,2797,581,19,12,31,61.3%,1h
22926,3,[1NFEC7]GANMU,2797,362,18,6,24,75.0%,14m
22926,3,RaGnArOk,2797,318,17,17,34,50.0%,12m
22926,3,[Kngsmn]Ryssdani,2797,254,10,4,14,71.4%,14m
22926,2,[DnAX]BiOhaZarD,2797,70,10,11,21,47.6%,10m
22926,1,ConvexusIV,2797,347,9,8,17,52.9%,6m
22926,3,XeqtR,2797,190,7,15,22,31.8%,19m
22926,3,Updoots,2797,202,6,4,10,60.0%,19m
22926,1,PHOBOS,2797,160,6,5,11,54.5%,8m
22926,3,[DTCz]Groot,2797,162,5,8,13,38.5%,11m
22926,1,чинчопападжи,2797,76,3,1,4,75.0%,1h
22926,3,PoliVodKa,2797,131,3,3,6,50.0%,15m
22926,3,[KMNDX]smT,2797,58,3,3,6,50.0%,23m
22926,1,Barbosix,2797,42,2,0,2,100.0%,12m
22926,1,Tungal,2797,42,2,0,2,100.0%,12m
22926,1,Theta,2797,96,2,0,2,100.0%,1h
22926,3,Zike,2797,94,2,1,3,66.7%,20m
22926,3,[sc2rf]vasyok,2797,30,2,4,6,33.3%,19m
22926,2,[NRWPro]Spartacus,2797,0,1,1,2,50.0%,25m
22926,3,Alternativa,2797,0,1,2,3,33.3%,17m
22926,3,[R4Time]Papatuu,2797,93,1,2,3,33.3%,6m
22926,3,Vershi,2797,0,1,3,4,25.0%,22m
22926,3,UwU,2797,30,1,4,5,20.0%,10m
22926,2,Philip,2797,0,1,7,8,12.5%,12m
22926,3,[ZERGSC]ALi,2797,0,0,2,2,0.0%,20m
22926,3,tax,2797,0,0,2,2,0.0%,43m
22957,3,[UnstoP]zhuk,2796,1450,187,162,349,53.6%,23m
22957,2,JohnGalt,2796,1054,64,58,122,52.5%,13m
22957,3,Yirka,2796,1364,63,59,122,51.6%,5m
22957,3,FallenAngel,2796,1076,46,33,79,58.2%,5m
22957,3,CaptainWank,2796,1025,43,37,80,53.8%,4m
22957,2,Unstoppable,2796,886,33,37,70,47.1%,7m
22957,3,Neico,2796,658,30,16,46,65.2%,3m
22957,1,Killra,2796,538,23,21,44,52.3%,24m
22957,3,[BISH]healweed,2796,426,16,14,30,53.3%,20m
22957,3,Starlord,2796,379,15,14,29,51.7%,13m
22957,1,[ExTr1m]TaiHei,2796,308,15,16,31,48.4%,5m
22957,3,[RekTzW]KingArthas,2796,392,14,17,31,45.2%,5m
22957,3,StormCruel,2796,302,12,15,27,44.4%,22m
22957,2,Aleon,2796,250,11,10,21,52.4%,17m
22957,3,Ventriloc,2796,320,10,16,26,38.5%,15m
22957,2,Warhunter,2796,90,8,5,13,61.5%,8m
22957,3,ZuchTieStar,2796,254,8,6,14,57.1%,28m
22957,1,santexnik,2796,190,7,7,14,50.0%,7m
22957,1,Solorkych,2796,168,7,8,15,46.7%,14m
22957,3,Максrus,2796,184,7,9,16,43.8%,14m
22957,1,chunkybaby,2796,149,6,0,6,100.0%,38m
22957,1,Sintel,2796,189,6,5,11,54.5%,1h
22957,3,СпектрСилы,2796,178,6,9,15,40.0%,21m
22957,1,[FZoG]kompani,2796,122,5,5,10,50.0%,1h
22957,3,Van,2796,154,5,5,10,50.0%,19m
22957,3,sergmax,2796,154,5,6,11,45.5%,3m
22957,3,Vukota,2796,142,5,8,13,38.5%,23m
22957,2,OnlyFlans,2796,167,5,10,15,33.3%,14m
22957,1,DarkDreamer,2796,124,4,3,7,57.1%,23m
22957,2,[LV]HET,2796,116,4,4,8,50.0%,40m
22957,3,MegaKukka,2796,60,3,3,6,50.0%,15m
22957,3,JPriest,2796,94,3,4,7,42.9%,5m
22957,1,[sissis]Auresion,2796,44,2,1,3,66.7%,13m
22957,1,MARTATTACK,2796,0,2,3,5,40.0%,38m
22957,3,Xzu,2796,0,0,4,4,0.0%,21m
22992,3,Zecater,2795,1333,119,98,217,54.8%,21m
22992,3,ТРЕНДЕ,2795,1029,78,90,168,46.4%,3m
22992,1,[MH]gabiki,2795,1492,54,48,102,52.9%,38m
22992,3,Raggnars,2795,936,44,27,71,62.0%,17m
22992,3,Serek,2795,559,31,11,42,73.8%,2m
22992,2,[IDF7]nissimtr,2795,507,23,28,51,45.1%,4m
22992,1,[Zhig]baunti,2795,597,22,10,32,68.8%,10m
22992,1,[GLTD]kerrigan,2795,711,22,15,37,59.5%,24m
22992,3,[JML2]heavyhikai,2795,420,20,15,35,57.1%,7m
22992,3,Blaiize,2795,454,19,18,37,51.4%,3m
22992,3,zRkChrizz,2795,233,10,8,18,55.6%,17m
22992,3,Hickmatt,2795,118,8,10,18,44.4%,21m
22992,3,GKmjd,2795,184,6,3,9,66.7%,11m
22992,3,eLodiN,2795,176,6,8,14,42.9%,21m
22992,2,Mudara,2795,46,3,4,7,42.9%,31m
22992,3,marko,2795,93,2,1,3,66.7%,9m
22992,3,[t0raSQ]NarkoMarine,2795,30,2,2,4,50.0%,22m
22992,1,StormzBG,2795,0,1,0,1,100.0%,33m
22992,3,[КХЕ]kukuruzia,2795,0,1,1,2,50.0%,11m
22992,2,MPAK,2795,48,1,1,2,50.0%,1h
22992,1,mjolnir,2795,96,1,2,3,33.3%,21m
22992,1,Draganko,2795,0,1,2,3,33.3%,29m
22992,2,[ADHS]Maiksen,2795,0,0,1,1,0.0%,11m
22992,2,tomfoolery,2795,0,0,1,1,0.0%,4m
22992,3,Style,2795,0,0,5,5,0.0%,20m
23017,2,Greuceanu,2794,1598,478,465,943,50.7%,5m
23017,3,Geniy,2794,1232,180,150,330,54.5%,15m
23017,3,Terrosserg,2794,1550,138,129,267,51.7%,18m
23017,2,Cignus,2794,1170,105,96,201,52.2%,4m
23017,2,valera,2794,1573,97,100,197,49.2%,10m
23017,3,vrtx,2794,1486,63,64,127,49.6%,19m
23017,3,skylord,2794,1259,56,50,106,52.8%,2m
23017,3,hiimsorry,2794,623,39,33,72,54.2%,14m
23017,2,jabushka,2794,684,27,33,60,45.0%,1m
23017,2,IIIIIIIIIIII,2794,123,24,29,53,45.3%,1m
23017,3,Lefiu,2794,593,20,28,48,41.7%,18m
23017,3,GetBack,2794,369,16,11,27,59.3%,3m
23017,1,llllllllllll,2794,262,10,8,18,55.6%,2m
23017,1,UrShak,2794,305,8,3,11,72.7%,1h
23017,1,[LIDAB]Xxpwnstar,2794,218,7,2,9,77.8%,13m
23017,1,[LA63]ChefKoch,2794,168,6,5,11,54.5%,2m
23017,1,TBAPNHA,2794,145,4,2,6,66.7%,35m
23017,1,pygmyhog,2794,127,4,3,7,57.1%,23m
23017,2,Mystic,2794,116,3,0,3,100.0%,1h
23017,3,Braby,2794,0,3,3,6,50.0%,28m
23017,2,LYAGUSH,2794,0,3,3,6,50.0%,1h
23017,3,Marine,2794,0,3,3,6,50.0%,17m
23017,1,Angelovp,2794,122,3,4,7,42.9%,30m
23017,1,Echoes,2794,120,3,4,7,42.9%,1h
23017,3,Вячеслав,2794,58,3,6,9,33.3%,17m
23017,1,dax,2794,42,2,0,2,100.0%,20m
23017,2,[Azimut]Zerckan,2794,0,2,3,5,40.0%,17m
23017,1,[CTPP]Apocalypse,2794,0,2,3,5,40.0%,1h
23017,1,Alex,2794,0,1,0,1,100.0%,44m
23017,2,Kingster,2794,0,1,0,1,100.0%,29m
23017,2,RandomHero,2794,0,1,1,2,50.0%,46m
23017,3,Utszang,2794,94,1,2,3,33.3%,1m
23017,1,Eva,2794,48,1,3,4,25.0%,1h
23017,1,lorakM,2794,0,0,1,1,0.0%,25m
23017,1,[PLA2N]Uroboros,2794,0,0,1,1,0.0%,1h
23017,3,RoseMarine,2794,0,0,1,1,0.0%,1h
23017,1,Henrik,2794,0,0,1,1,0.0%,39m
23017,3,[FxPro]KushHunter,2794,0,0,6,6,0.0%,1m
23055,2,[DOKA2]KillReal,2793,1274,178,167,345,51.6%,6m
23055,2,DejmosX,2793,1291,77,81,158,48.7%,17m
23055,3,Gurrinho,2793,528,57,52,109,52.3%,20m
23055,3,Honeybadger,2793,894,49,43,92,53.3%,4m
23055,3,[DNOser]GeteRo,2793,459,28,20,48,58.3%,11m
23055,3,Phantasma,2793,445,18,16,34,52.9%,19m
23055,3,lolz,2793,462,18,20,38,47.4%,19m
23055,2,THORKJAMSON,2793,492,18,25,43,41.9%,1m
23055,3,LanBordan,2793,431,17,12,29,58.6%,5m
23055,3,ChatonGarou,2793,339,14,13,27,51.9%,4m
23055,2,[PrTons]SpooneyKnify,2793,384,14,17,31,45.2%,3m
23055,2,[CumBoy]Foreyton,2793,279,13,9,22,59.1%,10m
23055,3,TaiwanNBOne,2793,90,8,4,12,66.7%,2m
23055,1,JustLearning,2793,225,7,5,12,58.3%,39m
23055,1,Foxbib,2793,167,6,6,12,50.0%,6m
23055,1,PRAT,2793,0,5,3,8,62.5%,16m
23055,3,[WARP20]TheOneWon,2793,167,5,5,10,50.0%,20m
23055,3,vodolaZzzz,2793,116,5,9,14,35.7%,20m
23055,2,Cerebus,2793,0,4,1,5,80.0%,1h
23055,1,GennGreymane,2793,186,4,3,7,57.1%,39m
23055,3,Apis,2793,166,4,5,9,44.4%,1m
23055,1,[43rus]Bot,2793,169,4,8,12,33.3%,16m
23055,3,Stephanie,2793,121,2,1,3,66.7%,17m
23055,1,JAMBA,2793,42,2,1,3,66.7%,33m
23055,2,Thenorias,2793,0,2,5,7,28.6%,14m
23055,1,Postman,2793,0,1,0,1,100.0%,33m
23055,3,pOtvIskAk,2793,0,1,1,2,50.0%,15m
23055,2,[DAzz]Rakinator,2793,0,0,1,1,0.0%,47m
23055,1,Raft,2793,0,0,1,1,0.0%,15m
23055,1,tomato,2793,0,0,1,1,0.0%,20m
23055,1,LiquidSun,2793,0,0,1,1,0.0%,1h
23055,3,CanisLupus,2793,0,0,2,2,0.0%,3m
23087,2,BlinD,2792,1093,129,131,260,49.6%,6m
23087,3,stalsalwin,2792,1029,83,61,144,57.6%,12m
23087,1,Monsoon,2792,1309,81,81,162,50.0%,5m
23087,3,[WINZ1]GoodMoleman,2792,324,44,30,74,59.5%,7m
23087,3,Fury,2792,846,38,26,64,59.4%,18m
23087,3,[SPAV]Bongo,2792,416,24,15,39,61.5%,17m
23087,3,Babek,2792,584,21,18,39,53.8%,1m
23087,2,HotPinkAnus,2792,458,19,13,32,59.4%,14m
23087,3,HerFriend,2792,547,19,18,37,51.4%,2m
23087,3,Tinkerbell,2792,353,17,17,34,50.0%,15m
23087,3,[Opticz]WUrax,2792,266,14,6,20,70.0%,3m
23087,3,[AsMG]dannyRose,2792,288,10,5,15,66.7%,12m
23087,2,MrJaksha,2792,238,9,10,19,47.4%,20m
23087,3,[ProbKA]LuckySquad,2792,238,8,10,18,44.4%,2m
23087,1,Brutus,2792,245,6,7,13,46.2%,2m
23087,3,Тащер,2792,112,3,2,5,60.0%,3m
23087,2,GordonSemen,2792,96,3,3,6,50.0%,1h
23087,1,gabi,2792,0,1,1,2,50.0%,1h
23087,1,ubiuka,2792,0,1,4,5,20.0%,14m
23087,1,TheOrboy,2792,73,0,2,2,0.0%,42m
23107,2,[WANG]Crookster,2791,1513,124,114,238,52.1%,10m
23107,3,Melperon,2791,698,111,98,209,53.1%,10m
23107,2,MissLaura,2791,961,104,106,210,49.5%,14m
23107,1,ORM,2791,1555,91,99,190,47.9%,12m
23107,3,Guardz,2791,1184,57,44,101,56.4%,2m
23107,1,[Falkon]Scofield,2791,1178,41,56,97,42.3%,21m
23107,1,[Obz]Yéthylique,2791,1116,37,52,89,41.6%,19m
23107,3,[LCRF]bedsam,2791,934,36,34,70,51.4%,21m
23107,1,Black,2791,826,30,34,64,46.9%,19m
23107,1,jcmd,2791,765,29,17,46,63.0%,1h
23107,3,chaosnova,2791,490,26,22,48,54.2%,4m
23107,3,[Matby]Matby,2791,533,21,19,40,52.5%,22m
23107,3,[SeVenV]Tamamo,2791,474,18,15,33,54.5%,5m
23107,2,Alex,2791,314,18,24,42,42.9%,7m
23107,3,vanillah,2791,458,17,17,34,50.0%,4m
23107,3,Muffin,2791,346,14,12,26,53.8%,13m
23107,1,[СКИЛЫ]Aleksmas,2791,345,9,4,13,69.2%,7m
23107,3,GrakThull,2791,144,9,7,16,56.2%,10m
23107,1,CaptainBulu,2791,295,9,13,22,40.9%,10m
23107,1,GarrySnow,2791,283,8,8,16,50.0%,4m
23107,3,Ulveraker,2791,202,8,10,18,44.4%,7m
23107,3,BSticks,2791,170,6,3,9,66.7%,1m
23107,3,Sophia,2791,209,6,4,10,60.0%,1m
23107,3,Tuman,2791,144,6,7,13,46.2%,2m
23107,1,Thastroem,2791,48,5,4,9,55.6%,29m
23107,3,HuNd,2791,169,4,4,8,50.0%,10m
23107,1,[CBot]RoadToElune,2791,124,3,0,3,100.0%,24m
23107,1,[ZERGТV]Sergei,2791,122,3,2,5,60.0%,24m
23107,2,[Gueux]Halex,2791,0,3,3,6,50.0%,4m
23107,3,[TTe]Tenckules,2791,60,3,3,6,50.0%,13m
23107,2,[TSC2C]Bibigon,2791,95,3,3,6,50.0%,35m
23107,1,Onsightfree,2791,0,2,3,5,40.0%,24m
23107,3,FireStarter,2791,58,2,5,7,28.6%,11m
23107,1,Dominus,2791,0,1,0,1,100.0%,13m
23107,3,nero,2791,30,1,5,6,16.7%,13m
23107,3,crusty,2791,0,0,2,2,0.0%,21m
23107,3,Peace,2791,0,0,2,2,0.0%,5m
23107,2,shpet,2791,0,0,3,3,0.0%,10m
23145,2,Pepp,2790,1539,591,573,1164,50.8%,6m
23145,2,machicooo,2790,1561,271,267,538,50.4%,17m
23145,3,Resimilchkuh,2790,1599,124,119,243,51.0%,3m
23145,2,Evospin,2790,1564,95,88,183,51.9%,8m
23145,3,Becky,2790,850,94,73,167,56.3%,20m
23145,3,TheEx,2790,1221,81,77,158,51.3%,20m
23145,2,ArthAs,2790,1326,79,74,153,51.6%,1m
23145,3,[rDogs]MrBrown,2790,1391,78,76,154,50.6%,15m
23145,3,Roberto,2790,970,51,32,83,61.4%,13m
23145,3,shurupkin,2790,1095,49,52,101,48.5%,12m
23145,3,Megapikar,2790,1016,41,38,79,51.9%,5m
23145,3,Rash,2790,784,39,19,58,67.2%,19m
23145,3,HowHardCanZb,2790,1028,37,41,78,47.4%,1m
23145,3,[dæD]Keo,2790,797,32,30,62,51.6%,14m
23145,3,TMP,2790,273,22,16,38,57.9%,10m
23145,3,Mystos,2790,343,18,18,36,50.0%,19m
23145,3,Falcon,2790,355,15,18,33,45.5%,1m
23145,3,Sorry,2790,284,11,7,18,61.1%,5m
23145,1,cheatex,2790,145,6,4,10,60.0%,45m
23145,1,mcgui,2790,138,4,0,4,100.0%,1h
23145,1,[DvX]PhOeNiX,2790,96,4,4,8,50.0%,29m
23145,2,[KDV]Heisenberg,2790,92,4,12,16,25.0%,17m
23145,2,JohnRembo,2790,0,3,2,5,60.0%,1h
23145,2,mshamil,2790,0,3,2,5,60.0%,1h
23145,3,Jeff,2790,62,3,4,7,42.9%,21m
23145,3,Acron,2790,16,3,5,8,37.5%,1h
23145,1,Widowmaker,2790,78,2,2,4,50.0%,10m
23145,1,[TWFN]xXmaXamXx,2790,0,2,3,5,40.0%,47m
23145,3,[frruju]frido,2790,120,2,3,5,40.0%,10m
23145,1,LifesAviOr,2790,0,1,0,1,100.0%,43m
23145,1,bakayaro,2790,97,1,6,7,14.3%,42m
23145,2,Dragon,2790,0,1,6,7,14.3%,1h
23145,1,DavidP,2790,0,0,1,1,0.0%,21m
23145,1,CryJka,2790,0,0,1,1,0.0%,7m
23145,3,[UPV]littlejimmy,2790,0,0,2,2,0.0%,14m
23180,3,Leandrito,2789,1199,163,136,299,54.5%,9m
23180,2,takati,2789,1139,64,68,132,48.5%,6m
23180,3,BraDersim,2789,718,51,38,89,57.3%,18m
23180,2,Sergej,2789,562,35,34,69,50.7%,14m
23180,3,Barbarian,2789,806,33,30,63,52.4%,2m
23180,3,[A0P]Tanatheld,2789,703,28,24,52,53.8%,8m
23180,2,marktulio,2789,716,28,30,58,48.3%,17m
23180,1,Slam,2789,721,27,22,49,55.1%,1h
23180,3,BlaXound,2789,638,25,26,51,49.0%,3m
23180,2,otec,2789,664,22,27,49,44.9%,15m
23180,3,flibalfa,2789,479,20,17,37,54.1%,29m
23180,2,[kolins]OverLord,2789,458,19,17,36,52.8%,17m
23180,3,Credenza,2789,428,15,21,36,41.7%,2m
23180,2,rEd,2789,320,10,24,34,29.4%,6m
23180,1,Aneyro,2789,193,8,6,14,57.1%,12m
23180,1,snowbener,2789,193,7,6,13,53.8%,30m
23180,1,bard,2789,226,6,3,9,66.7%,1h
23180,2,Life,2789,175,6,5,11,54.5%,39m
23180,2,[Watjuu]eWeresT,2789,172,5,4,9,55.6%,15m
23180,1,Klaus,2789,145,5,6,11,45.5%,1h
23180,3,[KUJD]Damianuś,2789,140,5,8,13,38.5%,20m
23180,1,[REGGE]SEAR,2789,167,3,2,5,60.0%,4m
23180,1,iris,2789,42,2,0,2,100.0%,11m
23180,3,Acoma,2789,19,2,4,6,33.3%,21m
23180,1,HamsterJam,2789,0,1,0,1,100.0%,38m
23180,3,Sudertegl,2789,0,1,1,2,50.0%,17m
23180,3,[Honour]Arhotoss,2789,0,1,1,2,50.0%,19m
23180,3,Papagal,2789,97,1,1,2,50.0%,27m
23180,3,[TedB]ИВАНЬКО,2789,0,1,3,4,25.0%,28m
23180,1,Overlord,2789,93,1,4,5,20.0%,7m
23180,1,Sly,2789,0,0,1,1,0.0%,44m
23180,2,James,2789,0,0,1,1,0.0%,1h
23180,2,[TGG]Preyhunter,2789,0,0,1,1,0.0%,1h
23213,1,ArtOfFart,2788,1425,124,107,231,53.7%,1h
23213,3,Knackwurst,2788,1167,78,63,141,55.3%,14m
23213,3,Detonator,2788,651,54,48,102,52.9%,8m
23213,1,miki,2788,1283,53,44,97,54.6%,10m
23213,3,AndreyZ,2788,1213,52,48,100,52.0%,10m
23213,3,[Arenot]ГейБой,2788,787,31,26,57,54.4%,3m
23213,3,tavis,2788,311,25,18,43,58.1%,10m
23213,3,PowerRanger,2788,471,18,16,34,52.9%,3m
23213,3,DarkRonin,2788,326,13,12,25,52.0%,1m
23213,3,Gratz,2788,322,12,17,29,41.4%,22m
23213,3,djinsabel,2788,242,10,10,20,50.0%,2m
23213,1,Dinkelberg,2788,276,9,6,15,60.0%,35m
23213,1,Tidion,2788,216,7,8,15,46.7%,39m
23213,2,erik,2788,0,4,1,5,80.0%,1h
23213,3,Dragonfire,2788,113,4,3,7,57.1%,12m
23213,2,EnteEnteEnte,2788,140,4,4,8,50.0%,38m
23213,1,saxus,2788,126,3,1,4,75.0%,1h
23213,3,[xFDPx]Locksthene,2788,120,3,2,5,60.0%,2m
23213,3,ChoiceGold,2788,58,3,3,6,50.0%,14m
23213,2,Jaleks,2788,0,3,3,6,50.0%,1h
23213,1,stronix,2788,97,2,2,4,50.0%,34m
23213,3,[Users]DuckPower,2788,30,2,2,4,50.0%,7m
23213,1,ohmy,2788,121,2,2,4,50.0%,22m
23213,1,greed,2788,0,1,0,1,100.0%,7m
23213,1,Chuperak,2788,0,1,0,1,100.0%,1h
23213,3,Slavaxaoc,2788,94,1,2,3,33.3%,3m
23213,1,Thehighfly,2788,0,0,1,1,0.0%,42m
23213,3,Myer,2788,0,0,2,2,0.0%,29m
23213,3,Tracker,2788,0,0,3,3,0.0%,11m
23213,3,PinkFloyd,2788,0,0,3,3,0.0%,1m
23213,3,Jack,2788,0,0,4,4,0.0%,17m
23244,3,Behemoth,2787,1583,285,275,560,50.9%,7m
23244,2,Александрит,2787,1505,182,172,354,51.4%,20m
23244,3,izlas,2787,1589,105,97,202,52.0%,20m
23244,2,Vrikkie,2787,945,62,67,129,48.1%,7m
23244,1,[LMBD]Voidrayy,2787,1150,44,32,76,57.9%,30m
23244,3,JaKkals,2787,773,31,25,56,55.4%,22m
23244,3,Envy,2787,612,27,18,45,60.0%,4m
23244,1,IIIIIIIIIIII,2787,571,22,11,33,66.7%,1h
23244,3,[SNE]Wojtek,2787,479,17,18,35,48.6%,14m
23244,3,Timms,2787,381,16,11,27,59.3%,2m
23244,3,Margorg,2787,376,15,9,24,62.5%,17m
23244,3,llllllllllll,2787,362,14,16,30,46.7%,17m
23244,3,Авалон,2787,343,11,10,21,52.4%,11m
23244,1,MPlordmaster,2787,208,9,9,18,50.0%,18m
23244,3,eric,2787,268,9,12,21,42.9%,5m
23244,3,vaniljen,2787,104,8,7,15,53.3%,1h
23244,2,kingwieser,2787,90,7,6,13,53.8%,7m
23244,1,[ЛюдиX]Negan,2787,30,6,4,10,60.0%,9m
23244,1,[Adeln]Spaden,2787,213,6,7,13,46.2%,34m
23244,3,DeathKaY,2787,154,6,11,17,35.3%,4m
23244,1,Obfionn,2787,121,5,5,10,50.0%,40m
23244,3,NICE,2787,121,5,6,11,45.5%,1h
23244,1,Johnny,2787,0,4,1,5,80.0%,30m
23244,1,VVPutin,2787,0,4,1,5,80.0%,11m
23244,1,Kork,2787,48,4,5,9,44.4%,6m
23244,1,sai,2787,145,3,2,5,60.0%,15m
23244,3,Zhuravljov,2787,134,3,4,7,42.9%,4m
23244,2,mih,2787,0,3,4,7,42.9%,32m
23244,1,MiKu,2787,78,2,3,5,40.0%,1h
23244,3,Ketrash,2787,0,2,3,5,40.0%,1h
23244,1,ДядяДаник,2787,0,0,1,1,0.0%,44m
23244,3,[TAW]DuX,2787,0,0,3,3,0.0%,4m
23276,3,Jackmcknife,2786,1560,75,73,148,50.7%,19m
23276,1,[earlyT]theDESTROYER,2786,1549,66,71,137,48.2%,10m
23276,3,[Greyma]Whiteoak,2786,1261,65,62,127,51.2%,8m
23276,3,SorrowShine,2786,875,41,36,77,53.2%,3m
23276,3,kastell,2786,991,39,34,73,53.4%,22m
23276,2,[топ1]SUPERSTARS,2786,1146,39,52,91,42.9%,13m
23276,3,Bender,2786,761,37,36,73,50.7%,10m
23276,3,Segelfourfun,2786,191,30,29,59,50.8%,12m
23276,3,ProxyStriker,2786,300,14,13,27,51.9%,28m
23276,1,Pikachu,2786,413,12,7,19,63.2%,1h
23276,3,VIKING,2786,338,12,10,22,54.5%,14m
23276,1,REDKOW,2786,360,11,7,18,61.1%,1h
23276,3,[EUww1]LABADIENA,2786,278,10,7,17,58.8%,29m
23276,3,Brooky,2786,243,8,5,13,61.5%,7m
23276,3,lDm,2786,183,7,11,18,38.9%,7m
23276,1,clemmrogg,2786,230,6,1,7,85.7%,13m
23276,2,JhonBoss,2786,102,5,4,9,55.6%,11m
23276,3,[Pasol]Paskanus,2786,168,5,5,10,50.0%,2m
23276,1,[NCSR]Androide,2786,116,4,1,5,80.0%,21m
23276,1,Duja,2786,114,4,2,6,66.7%,1h
23276,3,[DMsG]eMPor,2786,176,4,5,9,44.4%,22m
23276,3,[ЕМPIRE]lososik,2786,119,3,2,5,60.0%,19m
23276,2,Bogukai,2786,0,3,3,6,50.0%,46m
23276,1,Man,2786,120,3,4,7,42.9%,26m
23276,1,mięsnyjeż,2786,0,2,1,3,66.7%,11m
23276,3,[SGZARM]Ikkito,2786,30,2,3,5,40.0%,7m
23276,3,HotPiron,2786,30,2,4,6,33.3%,3m
23276,3,xBanana,2786,0,1,1,2,50.0%,22m
23276,3,[xFLF]KaanDaniel,2786,0,1,1,2,50.0%,2m
23276,2,cristi,2786,0,0,1,1,0.0%,37m
23276,3,Sasha,2786,0,0,2,2,0.0%,22m
23276,3,boldxhead,2786,0,0,2,2,0.0%,3m
23308,3,Cosch,2785,1377,136,112,248,54.8%,5m
23308,3,iggy,2785,1564,95,93,188,50.5%,20m
23308,3,BuchP,2785,775,62,48,110,56.4%,10m
23308,2,MrBig,2785,738,32,25,57,56.1%,18m
23308,3,Hades,2785,555,23,17,40,57.5%,13m
23308,3,[H0C]McBaine,2785,545,20,16,36,55.6%,5m
23308,1,[WАSD]lXXXWASDXXXl,2785,386,16,31,47,34.0%,21m
23308,1,zeuhwinner,2785,478,15,9,24,62.5%,47m
23308,3,[H0ly]Хладомир,2785,327,12,10,22,54.5%,10m
23308,3,coLLider,2785,324,12,12,24,50.0%,12m
23308,2,Zulkir,2785,209,11,9,20,55.0%,3m
23308,2,Kukarachi,2785,348,10,18,28,35.7%,12m
23308,1,Khazmodan,2785,239,8,7,15,53.3%,1h
23308,1,Ross,2785,193,8,9,17,47.1%,21m
23308,3,MegaHuhn,2785,60,6,4,10,60.0%,22m
23308,3,[RIZY]attaka,2785,202,6,7,13,46.2%,3m
23308,2,buhacker,2785,183,4,2,6,66.7%,20m
23308,3,Lofvarz,2785,145,4,3,7,57.1%,19m
23308,2,Forat,2785,0,3,3,6,50.0%,6m
23308,3,edulanarf,2785,0,3,3,6,50.0%,5m
23308,1,coriolis,2785,0,1,0,1,100.0%,40m
23308,3,grisiel,2785,94,1,2,3,33.3%,2m
23308,3,Garlic,2785,93,1,2,3,33.3%,11m
23308,3,zeus,2785,30,1,5,6,16.7%,7m
23308,1,Tryhard,2785,0,0,1,1,0.0%,1h
23308,2,[LIQUID]IgorZ,2785,0,0,1,1,0.0%,25m
23334,3,Fatwa,2784,940,110,90,200,55.0%,22m
23334,3,Astrum,2784,577,40,33,73,54.8%,20m
23334,2,[Freya]have,2784,708,31,26,57,54.4%,7m
23334,3,[XKot]XmuriyKot,2784,164,20,10,30,66.7%,4m
23334,2,Odjnone,2784,424,15,14,29,51.7%,10m
23334,3,[SHNOZ]Roscoe,2784,394,14,14,28,50.0%,6m
23334,3,serj,2784,158,14,14,28,50.0%,12m
23334,1,yesbox,2784,384,13,9,22,59.1%,21m
23334,3,Crossraiser,2784,240,11,7,18,61.1%,9m
23334,1,[SNMRTZ]TheDocent,2784,263,10,9,19,52.6%,2m
23334,2,MiLaShKa,2784,273,10,12,22,45.5%,43m
23334,3,odie,2784,187,9,9,18,50.0%,9m
23334,3,[xDiamx]subjugator,2784,144,8,7,15,53.3%,2m
23334,3,Alakir,2784,234,8,12,20,40.0%,17m
23334,3,subserver,2784,120,6,3,9,66.7%,10m
23334,1,[WWP]IvanDrago,2784,122,4,5,9,44.4%,32m
23334,2,GilGelad,2784,30,4,5,9,44.4%,4m
23334,1,Maxxi,2784,90,3,3,6,50.0%,1h
23334,2,Mine,2784,117,3,4,7,42.9%,35m
23334,3,Naaya,2784,58,3,7,10,30.0%,22m
23334,3,sirTimar,2784,62,2,7,9,22.2%,10m
23334,1,[12LG]Ash,2784,0,1,0,1,100.0%,39m
23334,1,[Englis]ТактикУбийца,2784,0,1,0,1,100.0%,39m
23334,2,Azazel,2784,0,1,0,1,100.0%,1h
23334,3,help,2784,94,1,2,3,33.3%,9m
23334,2,[PMMM]Alderonzzzo,2784,0,1,2,3,33.3%,1m
23334,3,[DINANT]SlaatjeBla,2784,30,1,3,4,25.0%,13m
23334,1,[tofury]Grimmjow,2784,0,0,1,1,0.0%,4m
23334,3,dante,2784,0,0,2,2,0.0%,14m
23334,3,BryanFury,2784,0,0,2,2,0.0%,19m
23364,2,starscream,2783,1291,398,399,797,49.9%,12m
23364,2,STINgA,2783,1551,136,139,275,49.5%,13m
23364,3,ToTheStars,2783,842,129,104,233,55.4%,20m
23364,2,Sloren,2783,1369,103,91,194,53.1%,10m
23364,1,MrBotka,2783,1571,78,59,137,56.9%,1h
23364,3,[ExTr1m]BOCHETUNMAY,2783,732,51,31,82,62.2%,8m
23364,3,AZAROTH,2783,1124,49,36,85,57.6%,6m
23364,3,Checkit,2783,808,33,29,62,53.2%,9m
23364,3,xHunter,2783,687,28,28,56,50.0%,3m
23364,3,Cheerio,2783,579,26,18,44,59.1%,17m
23364,1,Tzotopia,2783,224,6,3,9,66.7%,10m
23364,2,[LIQUID]NOOBeERrXD,2783,202,6,7,13,46.2%,33m
23364,1,artolio,2783,145,5,6,11,45.5%,16m
23364,1,TheMLGPotato,2783,130,4,3,7,57.1%,25m
23364,2,[pad39]JERCO,2783,88,4,4,8,50.0%,14m
23364,3,[Актив]serega,2783,120,2,3,5,40.0%,21m
23364,1,badnewzmB,2783,0,1,0,1,100.0%,14m
23364,1,[ЗЕRGТV]xMISAx,2783,40,1,1,2,50.0%,21m
23364,1,Itay,2783,0,0,1,1,0.0%,38m
23364,1,Beobern,2783,0,0,1,1,0.0%,17m
23364,3,Neezone,2783,0,0,2,2,0.0%,3m
23385,2,SheepPalOma,2782,1625,201,183,384,52.3%,7m
23385,3,MacroLi,2782,1680,152,164,316,48.1%,12m
23385,3,[TCC974]MisterVahiné,2782,1464,133,108,241,55.2%,2m
23385,2,[Brotha]StarFace,2782,1262,56,51,107,52.3%,13m
23385,3,[LIQUID]knuddelman,2782,523,39,32,71,54.9%,17m
23385,3,kodzirro,2782,967,35,36,71,49.3%,29m
23385,3,kuzko,2782,378,24,14,38,63.2%,7m
23385,3,[HBGSJR]stepanator,2782,523,22,18,40,55.0%,6m
23385,3,Tarantul,2782,451,19,12,31,61.3%,2m
23385,1,Syco,2782,471,14,8,22,63.6%,30m
23385,3,IchSchnitzel,2782,377,14,15,29,48.3%,20m
23385,2,Vrâth,2782,297,13,11,24,54.2%,9m
23385,3,TranzistorKo,2782,380,13,20,33,39.4%,22m
23385,2,Амадей,2782,281,12,12,24,50.0%,47m
23385,3,JOHNMAN,2782,303,9,10,19,47.4%,22m
23385,3,[RBP3]Bidon,2782,192,7,8,15,46.7%,8m
23385,3,NoSmoking,2782,122,6,5,11,54.5%,21m
23385,1,Priderzkiy,2782,190,5,5,10,50.0%,3m
23385,1,DevilDoll,2782,162,4,0,4,100.0%,2m
23385,3,[plopow]Talyn,2782,142,4,4,8,50.0%,7m
23385,3,PeChenKa,2782,90,4,6,10,40.0%,22m
23385,2,Sanguinius,2782,95,3,3,6,50.0%,37m
23385,1,Malus,2782,121,3,7,10,30.0%,41m
23385,3,Alzaar,2782,30,2,3,5,40.0%,7m
23385,2,Scar,2782,94,2,3,5,40.0%,15m
23385,1,Siilionu,2782,0,1,0,1,100.0%,7m
23385,1,dikij,2782,42,1,1,2,50.0%,7m
23385,1,Fesch,2782,0,1,4,5,20.0%,30m
23385,3,Mexxn,2782,94,1,4,5,20.0%,14m
23385,1,BoJack,2782,0,0,1,1,0.0%,4m
23385,2,MATHBOY,2782,0,0,1,1,0.0%,45m
23385,1,Licadoun,2782,0,0,1,1,0.0%,24m
23385,3,[MeDuS]Maito,2782,0,0,2,2,0.0%,12m
23385,3,[xSupX]chiDraEVE,2782,0,0,2,2,0.0%,18m
23385,3,Hombre,2782,0,0,2,2,0.0%,6m
23420,3,[BrassZ]matlefranc,2781,1548,242,235,477,50.7%,2m
23420,3,Silencioo,2781,1096,208,200,408,51.0%,13m
23420,3,Victorious,2781,1565,74,58,132,56.1%,17m
23420,2,JSpete,2781,1092,62,67,129,48.1%,10m
23420,1,ConstantSin,2781,1334,52,44,96,54.2%,6m
23420,3,[2RK]Luisoeskiso,2781,233,27,28,55,49.1%,18m
23420,3,Kotlin,2781,568,20,21,41,48.8%,22m
23420,3,Sachiel,2781,456,19,18,37,51.4%,14m
23420,3,Grayn,2781,192,15,11,26,57.7%,12m
23420,2,ALFreeze,2781,300,12,12,24,50.0%,9m
23420,1,Grim,2781,296,9,9,18,50.0%,34m
23420,3,LeBigMac,2781,283,9,9,18,50.0%,8m
23420,3,OptiOn,2781,186,7,10,17,41.2%,1m
23420,1,[HBGSJR]Flapper,2781,222,6,1,7,85.7%,40m
23420,1,son,2781,226,6,7,13,46.2%,14m
23420,1,MrKiller,2781,191,6,8,14,42.9%,46m
23420,1,MrDurden,2781,233,6,9,15,40.0%,1h
23420,3,PucioHenZap,2781,167,5,4,9,55.6%,4m
23420,3,yellowblox,2781,111,4,4,8,50.0%,3m
23420,1,Devmode,2781,70,4,4,8,50.0%,24m
23420,2,AaRoN,2781,128,4,10,14,28.6%,17m
23420,2,Yeet,2781,0,3,3,6,50.0%,40m
23420,2,SoWassap,2781,94,3,3,6,50.0%,4m
23420,1,Aeon,2781,36,2,0,2,100.0%,23m
23420,3,RafikosteFun,2781,97,2,3,5,40.0%,1h
23420,3,Epicnoob,2781,58,2,4,6,33.3%,7m
23420,3,Otipas,2781,60,2,6,8,25.0%,2m
23420,2,JACQUESELAIR,2781,46,1,8,9,11.1%,26m
23420,1,KeuRk,2781,0,0,1,1,0.0%,13m
23420,1,Aruad,2781,0,0,1,1,0.0%,26m
23420,3,[STARLO]NoobTeam,2781,0,0,5,5,0.0%,14m
23451,3,boss,2780,1520,175,167,342,51.2%,10m
23451,3,LOPUH,2780,1570,174,163,337,51.6%,6m
23451,1,[DHYD]SalyT,2780,1446,80,64,144,55.6%,34m
23451,3,SoldierD,2780,604,44,35,79,55.7%,10m
23451,3,JamesBond,2780,923,43,31,74,58.1%,20m
23451,1,Bro,2780,945,42,43,85,49.4%,11m
23451,1,Etlay,2780,609,30,14,44,68.2%,1h
23451,1,nairolF,2780,654,20,17,37,54.1%,42m
23451,2,MaxLangley,2780,469,20,22,42,47.6%,10m
23451,2,dustin,2780,397,19,14,33,57.6%,11m
23451,3,TheDuck,2780,412,14,13,27,51.9%,15m
23451,1,Prelex,2780,355,12,11,23,52.2%,48m
23451,3,QuarhodronPL,2780,250,10,11,21,47.6%,38m
23451,3,mastergareen,2780,210,8,12,20,40.0%,6m
23451,2,[M0NKEY]Lolohyhy,2780,222,8,16,24,33.3%,22m
23451,3,ParadoxOn,2780,210,6,7,13,46.2%,35m
23451,2,Gitin,2780,135,5,4,9,55.6%,1h
23451,3,HSVLenny,2780,58,5,4,9,55.6%,22m
23451,3,Kyle,2780,116,5,6,11,45.5%,15m
23451,2,xXetrusXx,2780,58,5,6,11,45.5%,7m
23451,3,DingleBerrry,2780,124,5,7,12,41.7%,4m
23451,3,PAPAHAPA,2780,122,4,6,10,40.0%,7m
23451,2,MrSan,2780,96,4,12,16,25.0%,15m
23451,1,[SoyBoy]zekke,2780,86,2,1,3,66.7%,24m
23451,2,Kain,2780,48,2,1,3,66.7%,41m
23451,3,[EndEmp]ManParuda,2780,120,2,7,9,22.2%,17m
23451,1,NoSkill,2780,0,1,0,1,100.0%,23m
23451,3,Lexx,2780,30,1,1,2,50.0%,47m
23451,1,Flexon,2780,0,0,1,1,0.0%,18m
23480,3,[isIMBА]илья,2779,1546,270,259,529,51.0%,3m
23480,1,JoJoO,2779,1828,160,178,338,47.3%,1h
23480,3,Sebastyan,2779,1474,127,119,246,51.6%,2m
23480,3,Savichev,2779,1614,88,75,163,54.0%,3m
23480,3,Dzhimax,2779,1550,77,64,141,54.6%,7m
23480,3,Vena,2779,898,40,33,73,54.8%,2m
23480,3,[TedB]Ninja,2779,718,33,18,51,64.7%,11m
23480,3,david,2779,422,21,13,34,61.8%,10m
23480,3,Elro,2779,459,19,15,34,55.9%,28m
23480,2,Erratic,2779,441,19,17,36,52.8%,20m
23480,3,KolDunchiK,2779,427,17,26,43,39.5%,1m
23480,3,Soldjah,2779,246,9,14,23,39.1%,2m
23480,1,Ronin,2779,258,8,2,10,80.0%,1h
23480,1,ShemsBond,2779,131,6,7,13,46.2%,9m
23480,1,Zeratul,2779,48,5,5,10,50.0%,1h
23480,1,[dudeki]DJKukky,2779,0,4,1,5,80.0%,1h
23480,1,LOL,2779,166,4,3,7,57.1%,17m
23480,1,Grizzly,2779,70,4,4,8,50.0%,10m
23480,3,RussleHorror,2779,0,3,3,6,50.0%,3m
23480,2,[SAwLER]angelmesty,2779,0,3,4,7,42.9%,44m
23480,1,Partoshisbac,2779,42,2,0,2,100.0%,10m
23480,3,[MGRUS]hormant,2779,58,2,5,7,28.6%,2m
23480,2,Rinsler,2779,58,2,12,14,14.3%,8m
23480,2,[RstE]Bibow,2779,0,1,0,1,100.0%,41m
23480,1,[DelRay]NoiLliM,2779,0,1,0,1,100.0%,3m
23480,3,GURA,2779,97,1,1,2,50.0%,9m
23480,1,dad,2779,42,1,3,4,25.0%,1h
23480,3,Alex,2779,32,1,6,7,14.3%,33m
23480,1,NorthIDS,2779,0,0,1,1,0.0%,1h
23480,2,[XzF]Radix,2779,0,0,1,1,0.0%,7m
23480,1,CerealKiller,2779,0,0,1,1,0.0%,33m
23480,3,Luckschaden,2779,0,0,1,1,0.0%,15m
23480,3,maZya,2779,0,0,3,3,0.0%,12m
23513,2,Thor,2778,1397,310,296,606,51.2%,15m
23513,1,FlowerPot,2778,1775,104,90,194,53.6%,6m
23513,2,[Heroes]Someone,2778,1532,99,96,195,50.8%,12m
23513,3,Drozak,2778,1206,55,43,98,56.1%,15m
23513,3,[Medoed]art,2778,852,45,40,85,52.9%,20m
23513,3,raa,2778,1150,44,43,87,50.6%,3m
23513,2,[Specii]Shadow,2778,733,43,45,88,48.9%,20m
23513,3,[MOHO]Moss,2778,391,32,30,62,51.6%,11m
23513,3,Viszlat,2778,573,28,16,44,63.6%,29m
23513,1,Jaabulani,2778,774,28,21,49,57.1%,12m
23513,3,Thisisboo,2778,631,25,19,44,56.8%,6m
23513,3,Bluff,2778,401,24,10,34,70.6%,1m
23513,1,TruvrTinySun,2778,610,21,13,34,61.8%,1h
23513,3,[MOFFO]Ghost,2778,317,17,9,26,65.4%,2m
23513,3,KRaDeKaDeN,2778,302,11,14,25,44.0%,22m
23513,1,XAXOL,2778,285,9,7,16,56.2%,32m
23513,1,ТяпунДуболом,2778,259,8,4,12,66.7%,1h
23513,1,EML,2778,258,6,2,8,75.0%,42m
23513,3,Kin,2778,140,6,5,11,54.5%,20m
23513,3,iRainbowFish,2778,165,4,1,5,80.0%,4m
23513,2,ArmaQ,2778,117,4,2,6,66.7%,1h
23513,3,Anarion,2778,149,4,12,16,25.0%,7m
23513,2,Xronik,2778,116,4,14,18,22.2%,1m
23513,1,Viktor,2778,80,3,2,5,60.0%,11m
23513,3,[WMCs]Kuro,2778,0,3,2,5,60.0%,21m
23513,3,BlueConga,2778,94,2,1,3,66.7%,3m
23513,3,[DZTK]Köllefornia,2778,30,2,4,6,33.3%,21m
23513,3,Lauerto,2778,30,2,4,6,33.3%,15m
23513,1,Hawk,2778,0,1,0,1,100.0%,24m
23513,1,WarlordWay,2778,0,1,0,1,100.0%,40m
23513,3,sbisasky,2778,0,1,0,1,100.0%,20m
23513,1,AbbaKZ,2778,0,1,1,2,50.0%,13m
23513,3,Alsaj,2778,0,1,1,2,50.0%,4m
23513,3,ChrisPBacon,2778,0,1,2,3,33.3%,3m
23513,1,Ivan,2778,40,1,2,3,33.3%,26m
23513,2,[STATUS]Player,2778,0,0,1,1,0.0%,20m
23513,1,MrK,2778,0,0,1,1,0.0%,39m
23513,1,GoldSkif,2778,0,0,1,1,0.0%,24m
23513,1,improvisator,2778,0,0,1,1,0.0%,17m
23513,1,Fotonchik,2778,0,0,1,1,0.0%,15m
23513,1,Zarral,2778,0,0,2,2,0.0%,46m
23513,2,lackluck,2778,0,0,5,5,0.0%,4m
23555,3,SirBehachis,2777,1103,107,111,218,49.1%,20m
23555,3,WildOwl,2777,1194,48,41,89,53.9%,3m
23555,3,[Forte]InzejN,2777,866,38,29,67,56.7%,20m
23555,3,Jaenis,2777,993,38,34,72,52.8%,28m
23555,3,LonelyDonut,2777,906,37,33,70,52.9%,1m
23555,2,ЛоВеР,2777,550,32,35,67,47.8%,17m
23555,1,Berci,2777,745,25,18,43,58.1%,2m
23555,2,NarThalos,2777,468,21,22,43,48.8%,4m
23555,2,Netrals,2777,458,17,26,43,39.5%,9m
23555,3,Bateman,2777,460,16,21,37,43.2%,21m
23555,3,MatNat,2777,193,13,16,29,44.8%,2m
23555,3,Jukes,2777,203,12,16,28,42.9%,21m
23555,1,Schrinja,2777,240,10,6,16,62.5%,24m
23555,3,Chib,2777,228,9,4,13,69.2%,2m
23555,1,Alasrat,2777,296,9,6,15,60.0%,1h
23555,3,Сахаридзе,2777,221,9,9,18,50.0%,4m
23555,3,[qL]MidoriUchiha,2777,219,7,6,13,53.8%,18m
23555,3,[СИЛА]ingir,2777,186,6,6,12,50.0%,1m
23555,1,Orbostel,2777,193,6,6,12,50.0%,10m
23555,1,волк,2777,116,4,0,4,100.0%,48m
23555,3,[dzv3rg]Ifak,2777,160,4,4,8,50.0%,28m
23555,3,HoF,2777,0,4,6,10,40.0%,1h
23555,2,[Navvy]Tantalos,2777,94,3,3,6,50.0%,38m
23555,3,Muszu,2777,0,3,3,6,50.0%,19m
23555,3,Jax,2777,93,3,4,7,42.9%,19m
23555,3,[OMAB]BiggusD,2777,89,3,5,8,37.5%,2m
23555,1,[PAL66]palkins,2777,143,2,2,4,50.0%,1h
23555,3,[FYT]Fertyn,2777,0,2,3,5,40.0%,14m
23555,1,[Iancu]Moloz,2777,0,2,3,5,40.0%,1h
23555,1,Wolfwood,2777,0,1,0,1,100.0%,29m
23555,1,[neuroW]DroneScout,2777,0,1,0,1,100.0%,40m
23555,1,spbb,2777,0,1,0,1,100.0%,24m
23555,1,[Hrr]TinGol,2777,0,1,3,4,25.0%,1h
23555,1,Funkyshift,2777,48,1,4,5,20.0%,18m
23555,3,Charon,2777,30,1,5,6,16.7%,17m
23555,3,tenoci,2777,30,1,7,8,12.5%,22m
23555,1,yaggo,2777,0,0,1,1,0.0%,1h
23555,1,IIIIIIIIIIII,2777,0,0,1,1,0.0%,48m
23593,1,illumina,2776,738,257,261,518,49.6%,8m
23593,2,beef,2776,1080,77,74,151,51.0%,5m
23593,3,Prospero,2776,1145,68,64,132,51.5%,3m
23593,3,cometa,2776,1035,59,61,120,49.2%,20m
23593,3,[FLAT]Thosh,2776,723,54,51,105,51.4%,4m
23593,2,Imagandi,2776,1230,53,47,100,53.0%,7m
23593,3,FaTaLiTy,2776,1281,47,58,105,44.8%,12m
23593,3,IntoTheAbyss,2776,882,37,30,67,55.2%,11m
23593,3,[SCCCC]KasperNeuzig,2776,928,36,35,71,50.7%,9m
23593,3,HipHopMonkey,2776,495,26,20,46,56.5%,13m
23593,3,sosipisos,2776,562,24,21,45,53.3%,12m
23593,1,Rhodium,2776,702,23,20,43,53.5%,1h
23593,3,Stonefish,2776,632,21,29,50,42.0%,6m
23593,3,WhoCares,2776,434,18,20,38,47.4%,7m
23593,1,CrEatIN,2776,572,17,14,31,54.8%,32m
23593,2,sTora,2776,293,11,13,24,45.8%,8m
23593,3,Phantom,2776,288,9,12,21,42.9%,20m
23593,1,epsonus,2776,246,8,10,18,44.4%,40m
23593,1,Ascam,2776,142,7,3,10,70.0%,40m
23593,1,potap,2776,188,6,11,17,35.3%,1h
23593,1,BlackEdition,2776,163,5,2,7,71.4%,43m
23593,1,Babel,2776,46,4,4,8,50.0%,34m
23593,1,ZORELiT,2776,76,3,1,4,75.0%,2m
23593,3,[GOGOLS]Nanakin,2776,0,3,3,6,50.0%,12m
23593,2,[GDK]VORLOK,2776,129,3,5,8,37.5%,42m
23593,1,Nukleari,2776,82,2,1,3,66.7%,33m
23593,1,[Gandza]Apple,2776,0,1,0,1,100.0%,38m
23593,1,ObiWan,2776,0,1,0,1,100.0%,1h
23593,2,MurderFace,2776,95,1,1,2,50.0%,1h
23593,2,zeax,2776,0,0,1,1,0.0%,13m
23593,1,TopazBlue,2776,0,0,1,1,0.0%,2m
23624,3,лананечеч,2775,1373,207,193,400,51.8%,5m
23624,3,[sTarTA]URInDanger,2775,1493,105,100,205,51.2%,4m
23624,3,Freezz,2775,1219,93,87,180,51.7%,11m
23624,3,Yuriv,2775,1540,91,67,158,57.6%,3m
23624,3,RazerJet,2775,919,50,36,86,58.1%,10m
23624,2,JanneGurken,2775,347,49,59,108,45.4%,2m
23624,1,Pandemon,2775,1135,44,29,73,60.3%,48m
23624,1,mamba,2775,901,33,27,60,55.0%,3m
23624,3,[MCV4SC]Aquila,2775,481,31,28,59,52.5%,20m
23624,1,Ezir,2775,884,29,27,56,51.8%,23m
23624,3,HALK,2775,608,23,21,44,52.3%,16m
23624,3,Seingeschäft,2775,324,12,12,24,50.0%,7m
23624,3,Alex,2775,229,8,5,13,61.5%,1m
23624,3,Izo,2775,112,8,7,15,53.3%,3m
23624,2,[axis]Benthe,2775,192,8,8,16,50.0%,10m
23624,3,Patu,2775,218,7,4,11,63.6%,29m
23624,3,Яша,2775,204,7,5,12,58.3%,8m
23624,3,CombatPilot,2775,225,7,10,17,41.2%,13m
23624,3,Eragon,2775,204,6,5,11,54.5%,17m
23624,1,dabas,2775,190,5,4,9,55.6%,1h
23624,3,[MERBAL]Grunder,2775,152,5,12,17,29.4%,2m
23624,1,blueralph,2775,189,4,4,8,50.0%,34m
23624,1,FluXZerG,2775,82,3,2,5,60.0%,32m
23624,3,Jesus,2775,0,3,2,5,60.0%,36m
23624,2,Maximilian,2775,95,3,3,6,50.0%,1h
23624,2,Нерф,2775,0,3,4,7,42.9%,1m
23624,2,Exile,2775,0,1,0,1,100.0%,26m
23624,1,BCorleone,2775,0,1,0,1,100.0%,7m
23624,3,Elias,2775,0,1,2,3,33.3%,1h
23624,1,Andrei,2775,0,1,2,3,33.3%,33m
23624,1,Rise,2775,38,1,2,3,33.3%,43m
23624,3,sharp,2775,30,1,7,8,12.5%,20m
23624,2,ХитрыйКраб,2775,0,0,1,1,0.0%,2m
23624,3,LifeIsPain,2775,0,0,4,4,0.0%,3m
23658,3,Nitrux,2774,1531,136,123,259,52.5%,2m
23658,2,[TriO]LeonSun,2774,1173,83,85,168,49.4%,20m
23658,1,Lamora,2774,1777,72,70,142,50.7%,15m
23658,3,chad,2774,1281,57,47,104,54.8%,9m
23658,3,Volik,2774,770,28,27,55,50.9%,8m
23658,1,LightBetStrs,2774,572,18,23,41,43.9%,21m
23658,1,[fmgPEW]edihvar,2774,374,14,10,24,58.3%,12m
23658,3,Cosmyn,2774,376,13,16,29,44.8%,11m
23658,1,[ЗИБиАГ]Shazum,2774,334,10,7,17,58.8%,37m
23658,3,[STWARI]IWANOPULUS,2774,239,9,9,18,50.0%,15m
23658,3,KRAUZ,2774,225,8,6,14,57.1%,6m
23658,3,DorKing,2774,227,8,9,17,47.1%,6m
23658,3,[Peeps]Skykress,2774,218,8,9,17,47.1%,1m
23658,3,NICE,2774,207,8,10,18,44.4%,19m
23658,1,xagen,2774,185,7,6,13,53.8%,27m
23658,1,Aramis,2774,167,6,6,12,50.0%,1h
23658,1,Verl,2774,119,5,2,7,71.4%,43m
23658,1,[SCTT]DojoGamer,2774,183,5,4,9,55.6%,4m
23658,2,Decollin,2774,158,4,1,5,80.0%,10m
23658,2,[HATRED]DeD,2774,46,4,4,8,50.0%,1h
23658,1,PitjenalT,2774,160,4,5,9,44.4%,48m
23658,3,Hado,2774,120,3,3,6,50.0%,12m
23658,2,Leon,2774,0,3,3,6,50.0%,9m
23658,3,dosha,2774,119,2,6,8,25.0%,4m
23658,1,[3R]Umazz,2774,0,1,0,1,100.0%,1h
23658,3,Миханпихан,2774,94,1,3,4,25.0%,2m
23658,2,ToTaTy,2774,92,1,6,7,14.3%,17m
23658,1,Autan,2774,0,0,1,1,0.0%,1h
23658,1,JustGoKill,2774,0,0,1,1,0.0%,12m
23658,3,YangSmok,2774,0,0,1,1,0.0%,1h
23658,2,Igromaks,2774,0,0,1,1,0.0%,46m
23658,1,hydralisk,2774,0,0,2,2,0.0%,27m
23658,1,[BCE]ROMAN,2774,0,0,3,3,0.0%,23m
23691,3,EnemyFeeder,2773,1038,194,183,377,51.5%,1m
23691,3,Nikolai,2773,1629,90,88,178,50.6%,12m
23691,3,happyfaceAR,2773,1419,85,77,162,52.5%,3m
23691,3,Macqo,2773,550,64,50,114,56.1%,10m
23691,3,Drifter,2773,1080,56,30,86,65.1%,17m
23691,3,DenzL,2773,218,21,18,39,53.8%,10m
23691,2,Ollowain,2773,372,13,23,36,36.1%,22m
23691,3,Coolguy,2773,242,11,3,14,78.6%,9m
23691,1,Speedy,2773,211,10,14,24,41.7%,29m
23691,3,TODD,2773,234,9,7,16,56.2%,12m
23691,2,[iNCEPT]DougWells,2773,185,7,3,10,70.0%,1h
23691,1,[KrnBrs]Волшебник,2773,212,6,5,11,54.5%,17m
23691,3,Zazuke,2773,119,6,7,13,46.2%,1m
23691,1,[ELBLAG]JAROsqy,2773,107,5,3,8,62.5%,7m
23691,3,EKZY,2773,30,4,5,9,44.4%,2m
23691,3,TomHariless,2773,38,4,6,10,40.0%,17m
23691,3,Krystian,2773,124,4,10,14,28.6%,11m
23691,2,IronMonkey,2773,94,3,3,6,50.0%,28m
23691,1,bdogstar,2773,88,2,2,4,50.0%,43m
23691,1,DeVole,2773,0,1,0,1,100.0%,11m
23691,1,[27s]codytor,2773,42,1,1,2,50.0%,46m
23691,1,Combowack,2773,0,1,1,2,50.0%,5m
23691,1,DeadDad,2773,40,1,2,3,33.3%,1h
23691,1,Internett,2773,0,0,2,2,0.0%,1h
23715,3,Splash,2772,1560,160,153,313,51.1%,18m
23715,3,[R88lol]MilkyWay,2772,457,111,98,209,53.1%,2m
23715,1,Chilch,2772,1368,60,43,103,58.3%,2m
23715,1,PasifiQ,2772,1197,41,35,76,53.9%,1h
23715,3,FriDriH,2772,1043,41,37,78,52.6%,11m
23715,1,[Fen]LLynser,2772,733,32,11,43,74.4%,1h
23715,3,Кыр,2772,394,20,10,30,66.7%,6m
23715,3,Zelay,2772,288,12,8,20,60.0%,47m
23715,2,lvkeat,2772,323,12,15,27,44.4%,13m
23715,3,[THANOS]chemori,2772,280,10,11,21,47.6%,18m
23715,1,[BOSSE]Virren,2772,249,7,9,16,43.8%,25m
23715,3,Light,2772,152,6,11,17,35.3%,3m
23715,3,Arton,2772,140,6,11,17,35.3%,8m
23715,2,JUliusCäsar,2772,172,5,10,15,33.3%,6m
23715,2,Phoenicurus,2772,138,4,5,9,44.4%,33m
23715,1,Frozzy,2772,144,2,3,5,40.0%,5m
23715,3,thebenjifier,2772,0,2,3,5,40.0%,46m
23715,3,MeatLoaf,2772,97,2,5,7,28.6%,1m
23715,1,vamos,2772,40,1,1,2,50.0%,48m
23715,1,Jaden,2772,40,1,1,2,50.0%,15m
23715,3,DarkSenpai,2772,0,1,1,2,50.0%,11m
23715,1,Varrag,2772,38,1,2,3,33.3%,6m
23715,1,vFor,2772,40,1,2,3,33.3%,7m
23715,1,[DL2006]Roithar,2772,0,0,1,1,0.0%,43m
23715,1,GerOfTheStar,2772,0,0,1,1,0.0%,1h
23715,1,Pejs,2772,0,0,2,2,0.0%,32m
23715,1,[TSB]Arjen,2772,0,0,3,3,0.0%,43m
23742,2,zarQeN,2771,1537,117,104,221,52.9%,1m
23742,3,Bledge,2771,1577,107,91,198,54.0%,20m
23742,3,Uno,2771,1251,89,80,169,52.7%,10m
23742,2,[rwsSC2]Iznog,2771,1537,88,84,172,51.2%,6m
23742,3,DugeThor,2771,893,80,79,159,50.3%,5m
23742,2,Jackson,2771,1353,65,64,129,50.4%,9m
23742,1,[WeiK]yxaswe,2771,1471,61,52,113,54.0%,11m
23742,1,[pndjos]Mortal,2771,1257,60,49,109,55.0%,1h
23742,3,FluOw,2771,1239,50,46,96,52.1%,2m
23742,3,Jmeista,2771,687,40,32,72,55.6%,1m
23742,3,[SkBG]eRHamInUs,2771,810,35,27,62,56.5%,2m
23742,2,lIIiiiiiilll,2771,712,33,33,66,50.0%,13m
23742,2,[3ЕRGTV]Toorka,2771,346,26,28,54,48.1%,10m
23742,3,GACHIped,2771,451,17,17,34,50.0%,7m
23742,2,Mro,2771,391,16,16,32,50.0%,13m
23742,3,[Vøid]Viodaey,2771,377,14,12,26,53.8%,1m
23742,2,BroW,2771,294,12,13,25,48.0%,13m
23742,3,BUX,2771,286,11,11,22,50.0%,4m
23742,3,Murre,2771,273,11,13,24,45.8%,5m
23742,1,Rinko,2771,332,10,8,18,55.6%,36m
23742,3,AMATERASU,2771,253,10,10,20,50.0%,3m
23742,3,robertinio,2771,329,10,11,21,47.6%,29m
23742,2,MaEsTrO,2771,270,10,18,28,35.7%,12m
23742,1,gilad,2771,207,8,6,14,57.1%,36m
23742,2,[SISC2]Wraith,2771,194,8,8,16,50.0%,18m
23742,3,Youngcloak,2771,236,8,11,19,42.1%,10m
23742,3,QpTheory,2771,176,7,9,16,43.8%,12m
23742,3,SpartanPI,2771,188,7,12,19,36.8%,20m
23742,3,akaLegman,2771,88,6,6,12,50.0%,29m
23742,1,Styssko,2771,78,3,1,4,75.0%,1h
23742,2,JJVO,2771,0,3,3,6,50.0%,1h
23742,1,[MlLFs]YourMother,2771,0,1,1,2,50.0%,1h
23742,1,PeaceMaker,2771,0,0,1,1,0.0%,32m
23742,1,[BDSME]KiToToo,2771,0,0,1,1,0.0%,1h
23742,1,enslaver,2771,0,0,1,1,0.0%,27m
23742,1,Szymon,2771,0,0,2,2,0.0%,11m
23742,1,Alexandre,2771,0,0,4,4,0.0%,41m
23779,2,[LFF]jteping,2770,1091,75,75,150,50.0%,6m
23779,2,Prototype,2770,1267,51,51,102,50.0%,14m
23779,3,IvanGovnov,2770,332,49,50,99,49.5%,22m
23779,1,SrAǂHgtefr,2770,855,36,25,61,59.0%,1h
23779,1,Nightmare,2770,774,25,20,45,55.6%,1h
23779,3,AlivEMouZ,2770,526,20,25,45,44.4%,8m
23779,3,Yeti,2770,442,15,20,35,42.9%,10m
23779,3,DujekOnearm,2770,387,14,8,22,63.6%,32m
23779,3,IlIlIlIlIlIl,2770,338,13,14,27,48.1%,2m
23779,1,FANDY,2770,276,11,11,22,50.0%,40m
23779,3,Askar,2770,282,11,14,25,44.0%,20m
23779,3,Monkey,2770,259,10,9,19,52.6%,3m
23779,3,Hawok,2770,129,5,5,10,50.0%,22m
23779,3,Theleil,2770,154,5,13,18,27.8%,19m
23779,1,Dobye,2770,104,4,4,8,50.0%,40m
23779,1,HannS,2770,126,4,4,8,50.0%,24m
23779,1,Ariahsis,2770,90,3,3,6,50.0%,29m
23779,3,FireCrow,2770,60,2,3,5,40.0%,8m
23779,1,Semtex,2770,0,2,3,5,40.0%,40m
23779,1,[Flammy]ASSASSIN,2770,0,1,0,1,100.0%,29m
23779,1,XYI,2770,0,1,1,2,50.0%,1h
23779,3,Random,2770,0,1,2,3,33.3%,20m
23779,3,bombarbia,2770,0,0,3,3,0.0%,29m
23779,3,SELECT,2770,0,0,4,4,0.0%,16m
23779,3,VlaDavid,2770,0,0,4,4,0.0%,28m
23804,2,Балмат,2769,1527,316,306,622,50.8%,10m
23804,2,Lama,2769,618,56,55,111,50.5%,17m
23804,3,[xXllXx]oOOlxXxlOOo,2769,841,38,36,74,51.4%,29m
23804,3,koma,2769,668,29,33,62,46.8%,7m
23804,3,SnikerSnikS,2769,365,16,9,25,64.0%,14m
23804,3,Tatyana,2769,416,15,18,33,45.5%,12m
23804,3,[FCGm]Antipaladin,2769,366,14,9,23,60.9%,20m
23804,3,BaLGrAsSs,2769,264,10,10,20,50.0%,29m
23804,2,Tété,2769,258,9,16,25,36.0%,10m
23804,1,imba,2769,190,5,4,9,55.6%,1h
23804,1,Rachewurst,2769,158,4,3,7,57.1%,18m
23804,1,zarak,2769,36,4,8,12,33.3%,18m
23804,1,Pascha,2769,72,3,1,4,75.0%,43m
23804,2,Malganis,2769,0,3,3,6,50.0%,11m
23804,3,pacack,2769,0,3,3,6,50.0%,14m
23804,2,[SBV]Xsar,2769,0,3,4,7,42.9%,6m
23804,1,SerMac,2769,126,3,4,7,42.9%,42m
23804,2,DroneForever,2769,46,2,0,2,100.0%,1h
23804,1,[Moskva]igorvlad,2769,76,2,2,4,50.0%,47m
23804,1,[FuNcp]FuNEcLiPsE,2769,0,2,3,5,40.0%,3m
23804,2,neverpuick,2769,95,2,4,6,33.3%,1h
23804,1,simple,2769,0,1,0,1,100.0%,21m
23804,3,Lodar,2769,95,1,7,8,12.5%,22m
23804,1,somebody,2769,0,0,1,1,0.0%,1h
23804,1,[Regnum]DokwoN,2769,0,0,1,1,0.0%,24m
23829,1,[QonQ]ANTİTROJEN,2768,1467,131,139,270,48.5%,2m
23829,3,goeasy,2768,1121,118,102,220,53.6%,4m
23829,1,user,2768,570,43,36,79,54.4%,11m
23829,3,[SALKAN]Intumo,2768,1059,41,38,79,51.9%,4m
23829,3,sef,2768,869,35,33,68,51.5%,12m
23829,3,[Douz]HukoronA,2768,411,18,9,27,66.7%,1m
23829,1,ShyrQaaa,2768,513,18,12,30,60.0%,1h
23829,3,vickthor,2768,434,18,12,30,60.0%,3m
23829,3,GlebMark,2768,328,17,17,34,50.0%,2m
23829,1,hiimzaki,2768,472,14,13,27,51.9%,1h
23829,3,[Boota]Penge,2768,296,9,11,20,45.0%,13m
23829,1,[h0mos]BeBe,2768,256,8,3,11,72.7%,33m
23829,1,Boudjaby,2768,260,7,3,10,70.0%,1h
23829,1,[hf4X4]anior,2768,78,3,1,4,75.0%,7m
23829,1,IamCRAZYxD,2768,65,3,3,6,50.0%,1h
23829,3,[PIZIKS]uvikay,2768,0,3,3,6,50.0%,9m
23829,3,Szymon,2768,58,3,4,7,42.9%,15m
23829,3,Player,2768,94,3,8,11,27.3%,1m
23829,1,[SWEBK]Tasso,2768,40,2,2,4,50.0%,47m
23829,3,QuardOfVoid,2768,114,2,3,5,40.0%,2m
23829,2,Janeriuz,2768,30,2,5,7,28.6%,13m
23829,2,БатькаТАРАН,2768,0,2,5,7,28.6%,37m
23829,1,CrusherT,2768,88,2,10,12,16.7%,44m
23829,1,JerraXuS,2768,0,1,0,1,100.0%,26m
23829,1,[b8z]Conlon,2768,38,1,1,2,50.0%,11m
23829,2,Lesny,2768,46,1,2,3,33.3%,26m
23829,1,[C0M]Nickelicious,2768,0,1,4,5,20.0%,10m
23829,1,WarPath,2768,0,0,1,1,0.0%,1h
23829,1,klay,2768,0,0,2,2,0.0%,17m
23829,3,[J4E]ACID,2768,0,0,4,4,0.0%,13m
23829,3,Дэнчик,2768,0,0,6,6,0.0%,4m
23860,3,InternetExpl,2767,1577,249,236,485,51.3%,10m
23860,3,[SRKY]alsibiate,2767,1605,144,135,279,51.6%,3m
23860,2,LEV,2767,1557,116,117,233,49.8%,13m
23860,3,AlphaPrey,2767,1432,106,97,203,52.2%,5m
23860,1,DenSun,2767,929,64,56,120,53.3%,1h
23860,1,Daniela,2767,765,59,48,107,55.1%,1h
23860,3,alexprotasov,2767,1141,47,40,87,54.0%,20m
23860,2,Akhu,2767,733,46,40,86,53.5%,17m
23860,1,Phil,2767,702,32,29,61,52.5%,1h
23860,1,rotn,2767,811,30,18,48,62.5%,47m
23860,3,CodeX,2767,193,22,20,42,52.4%,13m
23860,2,[ĦĦ]BaXcoX,2767,416,18,17,35,51.4%,3m
23860,3,Appenzeller,2767,294,10,14,24,41.7%,7m
23860,3,SadPanda,2767,236,9,11,20,45.0%,3m
23860,2,[PGCom]Cyberrevo,2767,264,8,10,18,44.4%,31m
23860,2,FunnyHat,2767,254,8,12,20,40.0%,30m
23860,3,Heskinator,2767,212,7,13,20,35.0%,2m
23860,3,Helysiel,2767,189,5,6,11,45.5%,3m
23860,3,Aron,2767,168,4,2,6,66.7%,17m
23860,1,buch,2767,148,4,6,10,40.0%,18m
23860,1,[TTRaid]MoonSlicer,2767,0,3,2,5,60.0%,12m
23860,3,[w00t]blaine,2767,62,3,6,9,33.3%,2m
23860,3,ODK,2767,94,3,8,11,27.3%,20m
23860,1,AGP,2767,97,2,2,4,50.0%,23m
23860,1,Legnacra,2767,0,2,3,5,40.0%,27m
23860,1,MacariusW,2767,0,1,0,1,100.0%,47m
23860,3,Prinss,2767,0,1,0,1,100.0%,29m
23860,1,ihottuma,2767,42,1,2,3,33.3%,18m
23860,2,[PiGPan]VictORIGINAL,2767,46,1,2,3,33.3%,44m
23860,3,crisss,2767,0,1,3,4,25.0%,12m
23860,3,alexinAtoR,2767,0,1,4,5,20.0%,48m
23860,1,[NBBS]Pokken,2767,0,0,1,1,0.0%,6m
23860,2,Wisi,2767,0,0,1,1,0.0%,1h
23860,2,NeagerPins,2767,0,0,2,2,0.0%,40m
23894,2,OnlyBronz,2766,1418,125,124,249,50.2%,15m
23894,1,Doudou,2766,1547,64,74,138,46.4%,3m
23894,2,TheKing,2766,1170,46,56,102,45.1%,10m
23894,3,Fonyas,2766,465,43,31,74,58.1%,13m
23894,3,fwe,2766,648,34,39,73,46.6%,20m
23894,3,Jambi,2766,765,31,27,58,53.4%,2m
23894,3,ЗлойГном,2766,668,24,24,48,50.0%,20m
23894,3,RIDDICK,2766,476,18,20,38,47.4%,6m
23894,1,[Börks]Tim,2766,520,16,13,29,55.2%,1h
23894,3,Crispin,2766,401,14,14,28,50.0%,6m
23894,3,Gland,2766,340,14,15,29,48.3%,19m
23894,1,Silver,2766,279,12,4,16,75.0%,13m
23894,3,Nephish,2766,332,12,15,27,44.4%,1m
23894,1,[Nеzukо]Stewano,2766,232,9,2,11,81.8%,21m
23894,3,CouchPotato,2766,230,9,9,18,50.0%,14m
23894,1,Goralden,2766,279,8,7,15,53.3%,1h
23894,2,[Cmd]Whiskas,2766,192,8,9,17,47.1%,14m
23894,3,child,2766,146,6,6,12,50.0%,8m
23894,1,Dragaen,2766,214,5,7,12,41.7%,20m
23894,1,ElonaGay,2766,206,5,12,17,29.4%,1h
23894,3,[СЗЗ]Teocron,2766,30,4,4,8,50.0%,5m
23894,3,Arti,2766,0,3,3,6,50.0%,20m
23894,3,Danielus,2766,60,3,4,7,42.9%,2m
23894,3,eagle,2766,120,3,5,8,37.5%,6m
23894,3,[МАR]Сева,2766,94,1,3,4,25.0%,17m
23894,3,KantaMizuno,2766,30,1,9,10,10.0%,19m
23894,3,Birkus,2766,0,0,1,1,0.0%,30m
23894,1,касл,2766,0,0,1,1,0.0%,13m
23922,2,[mfixed]KUBICEq,2765,1568,251,241,492,51.0%,13m
23922,3,[AcSx]Glateur,2765,1551,236,203,439,53.8%,18m
23922,3,frAp,2765,1385,150,133,283,53.0%,20m
23922,3,[Bambi2]MishMish,2765,1612,147,144,291,50.5%,3m
23922,3,done,2765,1474,116,101,217,53.5%,2m
23922,2,Lusankya,2765,672,72,74,146,49.3%,14m
23922,3,OldSquirrel,2765,1127,47,38,85,55.3%,29m
23922,3,Rainy,2765,357,44,31,75,58.7%,11m
23922,3,Ulqka,2765,398,44,33,77,57.1%,2m
23922,3,zdenz,2765,730,29,23,52,55.8%,2m
23922,1,TheRealMagik,2765,775,28,15,43,65.1%,1h
23922,3,Kozi,2765,731,27,31,58,46.6%,18m
23922,3,DRSpartanec,2765,431,26,21,47,55.3%,1m
23922,3,CrazyJOhn,2765,624,26,21,47,55.3%,3m
23922,3,[ÐÆÐ]Endwars,2765,422,16,12,28,57.1%,7m
23922,3,[BRSKR]Tropic,2765,385,14,11,25,56.0%,5m
23922,1,DaviD,2765,416,14,17,31,45.2%,1h
23922,3,MrTwoToes,2765,198,8,10,18,44.4%,11m
23922,3,вшыршыл,2765,218,7,5,12,58.3%,8m
23922,3,MarrowGnawer,2765,94,5,2,7,71.4%,29m
23922,3,Karl,2765,161,5,4,9,55.6%,5m
23922,3,[JGRU]Papamix,2765,124,5,7,12,41.7%,20m
23922,1,Papuchar,2765,118,4,2,6,66.7%,48m
23922,1,Rodster,2765,72,3,0,3,100.0%,27m
23922,2,SoulGhost,2765,0,3,3,6,50.0%,1h
23922,1,[BuGG3R]Geri,2765,192,3,5,8,37.5%,47m
23922,2,[FGger]Ronnyspielt,2765,48,3,6,9,33.3%,33m
23922,3,[LSPs]timocius,2765,60,3,9,12,25.0%,20m
23922,2,[VlKu]PospiMil,2765,86,3,13,16,18.8%,15m
23922,2,shellschock,2765,46,2,0,2,100.0%,29m
23922,1,Paradox,2765,80,2,2,4,50.0%,38m
23922,2,pryaniksex,2765,110,2,2,4,50.0%,19m
23922,3,makakablack,2765,0,2,3,5,40.0%,9m
23922,3,jackyd,2765,0,2,3,5,40.0%,33m
23922,1,Chaps,2765,38,2,4,6,33.3%,32m
23922,3,[пепега]Farmacevt,2765,30,1,3,4,25.0%,20m
23922,1,Spendog,2765,0,0,1,1,0.0%,2m
23922,1,Paralyse,2765,0,0,2,2,0.0%,42m
23922,2,[COOPM]Hazee,2765,0,0,3,3,0.0%,4m
23961,1,mobiasch,2764,1733,131,124,255,51.4%,1h
23961,1,[1STD1]SpikeDrone,2764,1767,128,123,251,51.0%,10m
23961,3,Katya,2764,917,88,82,170,51.8%,9m
23961,3,goshan,2764,795,30,35,65,46.2%,7m
23961,1,[NINJ88]kalio,2764,572,22,18,40,55.0%,1h
23961,3,Kroks,2764,288,13,5,18,72.2%,20m
23961,1,enemy,2764,422,13,7,20,65.0%,1h
23961,3,neo,2764,309,13,12,25,52.0%,4m
23961,1,EatMyPepe,2764,416,13,14,27,48.1%,1h
23961,3,Pyro,2764,422,13,15,28,46.4%,20m
23961,2,Frankoi,2764,303,12,12,24,50.0%,43m
23961,1,[Guidos]CarlO,2764,281,11,7,18,61.1%,27m
23961,3,Demyan,2764,252,11,7,18,61.1%,14m
23961,3,Youruch,2764,301,11,10,21,52.4%,6m
23961,1,playdead,2764,194,7,6,13,53.8%,10m
23961,2,[vandal]Paul,2764,182,7,17,24,29.2%,20m
23961,1,SleepyShaman,2764,135,5,3,8,62.5%,11m
23961,1,[LQV]Engel,2764,138,5,4,9,55.6%,12m
23961,3,CrimsonRye,2764,134,5,5,10,50.0%,20m
23961,1,[UGDC]segach,2764,30,5,6,11,45.5%,18m
23961,1,[ZzErg]Freddis,2764,0,4,1,5,80.0%,1h
23961,1,[MKDK]Gontello,2764,164,4,2,6,66.7%,40m
23961,2,[PsiVan]Вондрак,2764,30,4,4,8,50.0%,6m
23961,1,[Hrѓ]NAIMAN,2764,96,3,4,7,42.9%,11m
23961,2,moooilkshake,2764,119,3,4,7,42.9%,26m
23961,2,ghost,2764,96,3,13,16,18.8%,5m
23961,1,biggercube,2764,40,2,0,2,100.0%,1h
23961,1,LortGravidy,2764,38,2,1,3,66.7%,21m
23961,1,DasDOLP,2764,96,2,2,4,50.0%,21m
23961,3,Jackmen,2764,36,2,3,5,40.0%,23m
23961,1,llllllllllll,2764,0,1,0,1,100.0%,4m
23961,2,FireFaded,2764,0,1,0,1,100.0%,20m
23961,1,eclipse,2764,0,1,2,3,33.3%,34m
23961,2,MPI,2764,46,1,3,4,25.0%,9m
23961,1,Specialagent,2764,0,0,1,1,0.0%,8m
23961,2,SirThuzad,2764,0,0,1,1,0.0%,20m
23997,3,ciberdiller,2763,1580,220,219,439,50.1%,10m
23997,3,superfil,2763,1237,74,77,151,49.0%,21m
23997,3,shatoo,2763,1194,61,53,114,53.5%,20m
23997,1,Kapis,2763,921,57,40,97,58.8%,1h
23997,3,Kaizoku,2763,1200,56,45,101,55.4%,4m
23997,3,sXTONISwt,2763,1266,47,50,97,48.5%,11m
23997,3,oroborus,2763,586,34,21,55,61.8%,12m
23997,3,blingbling,2763,637,32,19,51,62.7%,2m
23997,3,MasterBadack,2763,781,29,29,58,50.0%,2m
23997,2,Vio,2763,806,27,34,61,44.3%,2m
23997,1,Ragnar,2763,804,26,25,51,51.0%,1h
23997,3,[JediK]MajorAl,2763,526,20,19,39,51.3%,5m
23997,1,Razor,2763,357,12,5,17,70.6%,7m
23997,1,[ZGlot]Howaitokira,2763,256,8,4,12,66.7%,33m
23997,2,dervik,2763,141,6,3,9,66.7%,48m
23997,1,[GEB]QuAnTeM,2763,166,6,5,11,54.5%,41m
23997,2,Koruru,2763,219,6,6,12,50.0%,30m
23997,3,[ЕМPIRE]DoorsXP,2763,144,6,11,17,35.3%,3m
23997,2,SargeKlint,2763,92,5,5,10,50.0%,1h
23997,3,CapitãoAtum,2763,196,5,7,12,41.7%,17m
23997,2,Odarich,2763,92,4,3,7,57.1%,11m
23997,1,ReipasPoika,2763,159,3,1,4,75.0%,39m
23997,1,AntonKarton,2763,40,2,0,2,100.0%,43m
23997,1,[Nyde]Loke,2763,42,2,1,3,66.7%,1h
23997,1,Middletown,2763,40,2,1,3,66.7%,25m
23997,3,Jornwer,2763,0,2,3,5,40.0%,23m
23997,3,[AviaN]Berserker,2763,0,2,3,5,40.0%,41m
23997,1,Bobo,2763,0,2,3,5,40.0%,48m
23997,1,vxony,2763,0,1,0,1,100.0%,33m
23997,3,Laconnex,2763,0,1,2,3,33.3%,3m
23997,1,Денюшка,2763,0,0,1,1,0.0%,36m
23997,2,Фортнайтер,2763,0,0,2,2,0.0%,42m
23997,2,[UGHAGH]Ugh,2763,0,0,2,2,0.0%,41m
23997,3,[MnrcK]Mat,2763,0,0,4,4,0.0%,3m
23997,3,[EzClaP]Bioangel,2763,0,0,4,4,0.0%,2m
23997,2,Boerthoys,2763,0,0,7,7,0.0%,4m
24033,1,Ninja,2762,1174,426,428,854,49.9%,12m
24033,2,OSCAR,2762,1608,189,184,373,50.7%,3m
24033,3,Keish,2762,1567,142,131,273,52.0%,13m
24033,2,[8Bytes]Mantis,2762,1557,96,93,189,50.8%,10m
24033,3,[G0UDA]nhutton,2762,556,54,28,82,65.9%,4m
24033,3,twisted,2762,1174,52,44,96,54.2%,2m
24033,3,HolyVomit,2762,837,44,33,77,57.1%,7m
24033,3,[StSta]Budgerigan,2762,677,26,27,53,49.1%,7m
24033,3,hariton,2762,445,25,22,47,53.2%,4m
24033,3,ParaWorld,2762,502,19,17,36,52.8%,17m
24033,1,GuiltYCroWn,2762,432,13,17,30,43.3%,1h
24033,1,[Днепр]Foebos,2762,282,10,3,13,76.9%,1h
24033,1,Subzero,2762,379,10,6,16,62.5%,1h
24033,1,Kamil,2762,292,10,7,17,58.8%,25m
24033,1,Fight,2762,221,8,0,8,100.0%,2m
24033,3,iGermanSoldi,2762,0,4,2,6,66.7%,3m
24033,1,erril,2762,89,3,3,6,50.0%,1h
24033,3,Rejoice,2762,92,3,4,7,42.9%,29m
24033,3,Reedik,2762,48,3,5,8,37.5%,17m
24033,2,arpanet,2762,30,3,7,10,30.0%,22m
24033,1,Dreathan,2762,30,3,10,13,23.1%,22m
24033,1,KvoDosh,2762,85,2,1,3,66.7%,26m
24033,1,[Senil]SparKraft,2762,76,2,2,4,50.0%,42m
24033,3,Kerriganis,2762,0,2,3,5,40.0%,1h
24033,2,Mushu,2762,0,2,4,6,33.3%,29m
24033,1,JegJek,2762,0,1,0,1,100.0%,8m
24033,1,Fightersrus,2762,0,1,0,1,100.0%,21m
24033,1,[Stealt]Chigo,2762,0,0,1,1,0.0%,15m
24033,1,Korgall,2762,0,0,1,1,0.0%,27m
24033,2,[Omegon]Alpharius,2762,0,0,1,1,0.0%,2m
24033,1,oli,2762,0,0,1,1,0.0%,49m
24033,2,ADyH,2762,0,0,1,1,0.0%,23m
24033,3,Apollone,2762,0,0,1,1,0.0%,28m
24033,3,Sickness,2762,0,0,3,3,0.0%,11m
24033,3,SleepS,2762,0,0,4,4,0.0%,19m
24068,2,MillioN,2761,356,89,86,175,50.9%,13m
24068,3,[Lab14]Rhadamanthys,2761,1354,79,67,146,54.1%,17m
24068,3,Bruce,2761,806,54,51,105,51.4%,5m
24068,3,Вестгейр,2761,1128,54,55,109,49.5%,21m
24068,3,FaFaN,2761,971,48,50,98,49.0%,15m
24068,2,CoolCatWoWoW,2761,473,27,30,57,47.4%,2m
24068,3,GGeryx,2761,588,21,22,43,48.8%,21m
24068,1,Mando,2761,511,19,15,34,55.9%,38m
24068,3,Piwusss,2761,408,16,11,27,59.3%,20m
24068,1,[37ers]Biercarsten,2761,347,12,5,17,70.6%,10m
24068,2,Bismarck,2761,206,8,3,11,72.7%,31m
24068,3,[SEWP]Dmitrij,2761,202,8,3,11,72.7%,3m
24068,1,YIVAN,2761,173,7,1,8,87.5%,1h
24068,1,Reverse,2761,264,7,2,9,77.8%,48m
24068,1,Ezaki,2761,144,5,2,7,71.4%,27m
24068,2,[HateZ]ogick,2761,48,5,3,8,62.5%,5m
24068,2,MuchytOo,2761,95,4,3,7,57.1%,1h
24068,3,Feynman,2761,164,4,5,9,44.4%,5m
24068,2,Shaodow,2761,48,4,5,9,44.4%,39m
24068,1,Xunstoppable,2761,0,3,4,7,42.9%,43m
24068,3,Bianchirock,2761,139,3,5,8,37.5%,2m
24068,1,cracked,2761,134,2,2,4,50.0%,1h
24068,1,Ilfirin,2761,0,2,3,5,40.0%,1h
24068,1,IamKoHbDva,2761,0,1,0,1,100.0%,29m
24068,3,CuciFlash,2761,0,1,2,3,33.3%,19m
24068,3,Schraube,2761,30,1,4,5,20.0%,5m
24068,1,PowerNap,2761,102,1,11,12,8.3%,29m
24068,1,FANTOM,2761,0,0,1,1,0.0%,1h
24068,2,[улей55]qwerty,2761,0,0,1,1,0.0%,1h
24068,3,eLm,2761,0,0,2,2,0.0%,19m
24068,3,[bullD]Mishka,2761,0,0,4,4,0.0%,5m
24099,1,vlad,2760,1339,125,113,238,52.5%,21m
24099,1,[1DTOA]ilya,2760,580,62,48,110,56.4%,38m
24099,3,alex,2760,811,51,50,101,50.5%,17m
24099,3,ulmaxy,2760,1204,46,47,93,49.5%,17m
24099,3,[VP4ce]CONTRA,2760,681,33,30,63,52.4%,17m
24099,3,Mitrudat,2760,704,31,27,58,53.4%,2m
24099,3,Uich,2760,625,26,23,49,53.1%,11m
24099,1,BrLeagueHero,2760,482,18,10,28,64.3%,29m
24099,3,SaSSoN,2760,408,15,17,32,46.9%,11m
24099,3,Esprit,2760,306,11,10,21,52.4%,2m
24099,3,Stallone,2760,247,10,9,19,52.6%,23m
24099,1,Alfgrot,2760,207,8,7,15,53.3%,1h
24099,1,oZF,2760,264,6,3,9,66.7%,19m
24099,1,Artum,2760,192,5,7,12,41.7%,41m
24099,1,WTF,2760,91,3,3,6,50.0%,30m
24099,2,галилим,2760,92,3,3,6,50.0%,30m
24099,3,IlIIl,2760,97,2,2,4,50.0%,12m
24099,3,ZaleksiZ,2760,30,2,4,6,33.3%,18m
24099,1,[MrLord]Зератул,2760,0,1,0,1,100.0%,47m
24099,2,Xploziv,2760,0,1,0,1,100.0%,1h
24099,1,[Перцы]Venillo,2760,0,1,0,1,100.0%,11m
24099,2,gotrong,2760,96,1,1,2,50.0%,45m
24099,1,ПсинаШлюхань,2760,0,1,1,2,50.0%,10m
24099,1,Valex,2760,38,1,1,2,50.0%,11m
24099,1,MazeRunner,2760,0,0,1,1,0.0%,23m
24099,1,Lurkerman,2760,0,0,1,1,0.0%,33m
24125,1,Ilyas,2759,1277,52,41,93,55.9%,40m
24125,3,miroCROpena,2759,471,19,21,40,47.5%,11m
24125,3,JohnDoe,2759,461,15,20,35,42.9%,12m
24125,1,NoiCe,2759,364,11,5,16,68.8%,20m
24125,3,[uThing]Tadz,2759,300,11,13,24,45.8%,2m
24125,3,håkon,2759,262,10,10,20,50.0%,5m
24125,1,Gotik,2759,251,8,3,11,72.7%,1h
24125,3,[GRYzOR]leclod,2759,222,8,8,16,50.0%,4m
24125,1,[Змлн]Веталь,2759,281,8,8,16,50.0%,31m
24125,1,Shya,2759,258,7,6,13,53.8%,37m
24125,3,TFVIPER,2759,118,7,6,13,53.8%,22m
24125,1,Mæger,2759,232,7,7,14,50.0%,40m
24125,3,MilkEffect,2759,167,6,7,13,46.2%,6m
24125,3,BlackFace,2759,88,5,5,10,50.0%,3m
24125,3,FOMO,2759,0,4,1,5,80.0%,37m
24125,3,Lon,2759,0,4,1,5,80.0%,12m
24125,1,MajDiscount,2759,118,4,3,7,57.1%,12m
24125,1,DOMINIK,2759,104,4,3,7,57.1%,1h
24125,1,[КВ2]владислав,2759,0,3,2,5,60.0%,21m
24125,1,[IceHus]иван,2759,97,3,6,9,33.3%,8m
24125,1,AlabamaBlues,2759,78,2,1,3,66.7%,13m
24125,1,CrassSral,2759,42,2,1,3,66.7%,21m
24125,3,zetisz,2759,117,2,3,5,40.0%,2m
24125,3,MoeSzyslak,2759,116,2,3,5,40.0%,5m
24125,1,[eRZGEb]rumgetebrt,2759,0,1,0,1,100.0%,11m
24125,2,[TLGC]Bockyy,2759,0,1,1,2,50.0%,41m
24125,1,Bomber,2759,0,0,1,1,0.0%,36m
24125,1,ShadowSonic,2759,0,0,2,2,0.0%,26m
24153,3,Phill,2758,1249,108,107,215,50.2%,8m
24153,3,devianse,2758,712,30,22,52,57.7%,18m
24153,3,Archer,2758,449,29,20,49,59.2%,5m
24153,3,Gafurus,2758,594,25,21,46,54.3%,6m
24153,3,sirius,2758,604,24,23,47,51.1%,6m
24153,2,GRZES,2758,642,22,31,53,41.5%,12m
24153,3,razz,2758,592,20,24,44,45.5%,18m
24153,1,[INOE]martinzmarsu,2758,439,18,22,40,45.0%,4m
24153,2,[DscG]Milekki,2758,172,9,11,20,45.0%,16m
24153,1,[CHALET]SSsydnay,2758,208,8,8,16,50.0%,47m
24153,1,Stark,2758,242,8,8,16,50.0%,1h
24153,2,BøøLet,2758,198,8,10,18,44.4%,18m
24153,1,Zenit,2758,287,7,4,11,63.6%,11m
24153,3,Sky,2758,167,7,8,15,46.7%,12m
24153,3,Grhmj,2758,190,7,8,15,46.7%,1h
24153,1,xAngeLx,2758,125,6,2,8,75.0%,12m
24153,3,PsyDuck,2758,166,6,6,12,50.0%,20m
24153,3,[Arrows]GOLDY,2758,90,4,5,9,44.4%,34m
24153,1,ERA,2758,0,3,2,5,60.0%,12m
24153,1,masso,2758,88,3,3,6,50.0%,48m
24153,1,[БАНДА]Leon,2758,118,3,5,8,37.5%,1h
24153,1,Advenne,2758,42,2,2,4,50.0%,13m
24153,1,[NINDUD]JayHage,2758,40,2,2,4,50.0%,24m
24153,1,MILLAGA,2758,0,2,3,5,40.0%,1h
24153,1,meta,2758,0,1,1,2,50.0%,1h
24153,1,Приливотсто,2758,96,1,2,3,33.3%,1h
24153,1,[l0]Scibork,2758,0,0,2,2,0.0%,1h
24153,1,ARZZAS,2758,0,0,2,2,0.0%,1h
24153,3,[Olеg]Lexus,2758,0,0,5,5,0.0%,3m
24182,3,RoBo,2757,649,68,69,137,49.6%,23m
24182,1,HuuhKante,2757,1421,56,52,108,51.9%,1h
24182,3,bean,2757,1274,55,45,100,55.0%,2m
24182,1,[АРМОР]neAnatoliy,2757,624,28,9,37,75.7%,23m
24182,3,zartarr,2757,674,28,41,69,40.6%,11m
24182,2,[Zraw]CoatHanger,2757,614,24,28,52,46.2%,20m
24182,3,Lazard,2757,178,21,24,45,46.7%,28m
24182,2,Marnick,2757,405,19,17,36,52.8%,7m
24182,3,[TheM]KozwaxD,2757,337,16,20,36,44.4%,15m
24182,2,soulfreak,2757,346,15,26,41,36.6%,22m
24182,3,Patuś,2757,284,13,21,34,38.2%,29m
24182,3,waneksx,2757,282,10,12,22,45.5%,23m
24182,1,Maugz,2757,282,9,6,15,60.0%,1h
24182,3,[DeCr]Neladi,2757,118,5,7,12,41.7%,13m
24182,3,Unforeseen,2757,0,3,3,6,50.0%,14m
24182,1,korsurplus,2757,137,3,3,6,50.0%,32m
24182,3,FREE,2757,30,2,5,7,28.6%,3m
24182,1,verker,2757,0,1,0,1,100.0%,32m
24182,1,deved,2757,0,1,1,2,50.0%,39m
24182,1,SoulLess,2757,0,1,2,3,33.3%,48m
24182,2,[Bü]Arcanis,2757,46,1,3,4,25.0%,5m
24182,3,noskill,2757,30,1,3,4,25.0%,20m
24182,1,HUGO,2757,0,0,1,1,0.0%,1h
24205,3,Comadreja,2756,1562,163,162,325,50.2%,20m
24205,1,Egorka,2756,843,65,45,110,59.1%,30m
24205,1,Woralo,2756,1247,63,60,123,51.2%,33m
24205,3,shroom,2756,1400,59,47,106,55.7%,22m
24205,1,CosmicFlower,2756,450,39,46,85,45.9%,2m
24205,1,bobby,2756,577,26,17,43,60.5%,3m
24205,3,MrFiasco,2756,519,20,20,40,50.0%,10m
24205,1,Twopro,2756,371,14,7,21,66.7%,15m
24205,1,Chel,2756,399,11,6,17,64.7%,8m
24205,3,NewChampion,2756,247,8,3,11,72.7%,12m
24205,3,DarkTJ,2756,232,8,13,21,38.1%,1m
24205,1,[pisos]GoodWalker,2756,222,7,5,12,58.3%,1h
24205,3,SvenE,2756,191,6,5,11,54.5%,8m
24205,3,TheLastOne,2756,168,6,7,13,46.2%,10m
24205,1,[WINT]Baluu,2756,168,6,8,14,42.9%,39m
24205,1,Meko,2756,156,5,4,9,55.6%,1h
24205,1,Pangu,2756,0,4,1,5,80.0%,21m
24205,2,[BBCDad]Brasenose,2756,0,4,3,7,57.1%,5m
24205,1,[Rebеls]Graun,2756,144,3,1,4,75.0%,20m
24205,1,JevatKara,2756,88,3,3,6,50.0%,39m
24205,1,VGsKing,2756,88,3,3,6,50.0%,4m
24205,3,[SP3RME]Papermoon,2756,0,2,3,5,40.0%,26m
24205,3,[Heylol]gokhankaan,2756,0,2,3,5,40.0%,1h
24205,3,Zaita,2756,0,2,3,5,40.0%,5m
24205,1,BRONSON,2756,0,1,0,1,100.0%,12m
24205,1,Ярик,2756,0,1,0,1,100.0%,22m
24205,1,[Inqu]dok,2756,0,1,0,1,100.0%,1h
24205,1,TerranSK,2756,0,1,1,2,50.0%,44m
24205,3,[HaoS]pggprgprggs,2756,0,1,3,4,25.0%,20m
24205,1,[SKI]Astio,2756,0,0,1,1,0.0%,37m
24205,1,DeathStalker,2756,0,0,1,1,0.0%,30m
24205,3,KoViGe,2756,0,0,1,1,0.0%,33m
24205,2,[ADGG]KNUGEN,2756,0,0,1,1,0.0%,2m
24205,1,FrQise,2756,0,0,2,2,0.0%,1h
24205,3,[CОS]Andrewpups,2756,0,0,2,2,0.0%,29m
24240,1,Furaka,2755,1764,130,117,247,52.6%,40m
24240,3,[hf4X4]DrNoob,2755,817,38,32,70,54.3%,1m
24240,1,[TGosuB]halcyonic,2755,875,33,24,57,57.9%,3m
24240,3,pushistik,2755,344,11,16,27,40.7%,22m
24240,1,[ZeDe20]Amadeus,2755,288,10,1,11,90.9%,25m
24240,1,nezumi,2755,310,8,12,20,40.0%,27m
24240,1,Blade,2755,212,7,6,13,53.8%,1h
24240,2,JayK,2755,171,7,8,15,46.7%,6m
24240,1,LoveLife,2755,188,6,7,13,46.2%,18m
24240,3,walleout,2755,176,6,8,14,42.9%,7m
24240,3,AlexeyOmsk,2755,182,6,12,18,33.3%,5m
24240,2,Kalenz,2755,175,6,14,20,30.0%,26m
24240,1,korridor,2755,116,5,4,9,55.6%,12m
24240,2,yoouri,2755,60,5,6,11,45.5%,9m
24240,1,[NADEON]Lucasdsht,2755,195,4,1,5,80.0%,26m
24240,3,[CL0wnZ]Madness,2755,114,4,8,12,33.3%,12m
24240,1,KnackTwoBaby,2755,119,3,0,3,100.0%,12m
24240,1,[GGmc2]ChristFist,2755,70,3,3,6,50.0%,3m
24240,3,Monsen,2755,38,3,3,6,50.0%,9m
24240,2,FullHDPorn,2755,0,3,4,7,42.9%,19m
24240,3,[K0RM2]Abasc,2755,86,3,8,11,27.3%,22m
24240,1,PonJaulTwo,2755,36,2,0,2,100.0%,6m
24240,3,Nameless,2755,0,2,3,5,40.0%,28m
24240,3,[XPLcX]Carlo,2755,94,2,3,5,40.0%,14m
24240,2,GénéralPaton,2755,115,2,7,9,22.2%,1h
24240,1,LeToïToï,2755,0,1,0,1,100.0%,43m
24240,1,Phosa,2755,0,1,1,2,50.0%,4m
24240,1,[MiniC]ctarksed,2755,0,0,1,1,0.0%,43m
24240,1,mishaua,2755,0,0,1,1,0.0%,27m
24240,1,УсатыйКот,2755,0,0,1,1,0.0%,21m
24270,2,[L0ND0N]JogACE,2754,1453,144,146,290,49.7%,7m
24270,2,Theonden,2754,947,132,112,244,54.1%,18m
24270,1,Green,2754,1749,113,95,208,54.3%,21m
24270,1,PhantomII,2754,1668,107,99,206,51.9%,8m
24270,3,pterodaktil,2754,1378,91,87,178,51.1%,3m
24270,2,Anywhere,2754,876,80,83,163,49.1%,10m
24270,3,Thecrow,2754,692,58,56,114,50.9%,11m
24270,1,Len,2754,1287,47,42,89,52.8%,17m
24270,1,Quotennecher,2754,452,14,9,23,60.9%,2m
24270,2,kuznec,2754,159,13,25,38,34.2%,10m
24270,1,Рестаратор,2754,303,12,3,15,80.0%,33m
24270,3,Vishar,2754,208,7,11,18,38.9%,21m
24270,3,serg,2754,177,6,7,13,46.2%,23m
24270,3,Micka,2754,161,5,5,10,50.0%,15m
24270,1,[3ЕRGTV]Dentami,2754,145,4,3,7,57.1%,7m
24270,2,Skorpio,2754,118,3,1,4,75.0%,41m
24270,3,[WoodHd]GhostSR,2754,92,3,10,13,23.1%,22m
24270,1,YooBiByTe,2754,40,2,0,2,100.0%,15m
24270,1,[RBlood]IkuriO,2754,44,2,5,7,28.6%,48m
24270,2,Third,2754,119,2,5,7,28.6%,1h
24270,3,[EsGǂ]Pompom,2754,62,2,6,8,25.0%,4m
24270,2,Zenshi,2754,42,2,6,8,25.0%,25m
24270,3,Raven,2754,0,1,0,1,100.0%,6m
24270,1,[ADMEN]Grean,2754,44,1,3,4,25.0%,8m
24270,3,TragenTod,2754,30,1,4,5,20.0%,6m
24270,3,[NLS4]Guru,2754,0,0,1,1,0.0%,1h
24270,2,[УкрОП]ReNgEnGeR,2754,0,0,1,1,0.0%,9m
24270,1,Healthy,2754,0,0,1,1,0.0%,20m
24270,1,Diable,2754,0,0,1,1,0.0%,1h
24299,1,[Dnmt]goalkeeper,2753,1754,227,209,436,52.1%,23m
24299,3,ToroMonsu,2753,663,27,26,53,50.9%,17m
24299,1,Saï,2753,253,24,17,41,58.5%,6m
24299,1,[isIMBА]Цемчик,2753,332,12,4,16,75.0%,21m
24299,1,Metis,2753,382,10,11,21,47.6%,40m
24299,1,JoeNicitel,2753,263,9,11,20,45.0%,33m
24299,3,JohnSmith,2753,248,9,13,22,40.9%,7m
24299,3,RaccooN,2753,166,8,5,13,61.5%,12m
24299,1,CrazyMag,2753,140,8,11,19,42.1%,8m
24299,3,[THI]Asa,2753,186,7,6,13,53.8%,2m
24299,2,xXPakoTenaXx,2753,116,6,2,8,75.0%,6m
24299,1,RobDaBob,2753,140,6,7,13,46.2%,36m
24299,3,[GPs57]Kzkh,2753,204,6,9,15,40.0%,20m
24299,3,Voodoochilli,2753,150,6,13,19,31.6%,6m
24299,2,MAx,2753,157,5,4,9,55.6%,2m
24299,1,Lulu,2753,117,5,4,9,55.6%,39m
24299,3,SaLaTa,2753,148,5,8,13,38.5%,8m
24299,3,Urzaaf,2753,32,2,0,2,100.0%,12m
24299,1,[TǂBs]BenFlouek,2753,0,2,3,5,40.0%,40m
24299,1,[Koffie]Rubella,2753,0,1,0,1,100.0%,24m
24299,3,[nbalm]Jumo,2753,0,1,0,1,100.0%,12m
24299,1,Pugtato,2753,0,1,0,1,100.0%,33m
24299,3,Quarcs,2753,18,1,6,7,14.3%,19m
24299,3,[USRR]IvanAgresor,2753,0,0,1,1,0.0%,14m
24299,1,LuckyPig,2753,0,0,1,1,0.0%,1h
24299,3,Skiner,2753,0,0,2,2,0.0%,22m
24299,2,Grosol,2753,0,0,2,2,0.0%,17m
24299,3,[Sl0th]marrakesh,2753,0,0,2,2,0.0%,20m
24299,3,[NOKAGE]Destroyer,2753,0,0,3,3,0.0%,35m
24299,1,[WhPd]FunkeyMonkey,2753,0,0,3,3,0.0%,4m
24299,3,Deimos,2753,0,0,7,7,0.0%,5m
24330,1,Blew,2752,1747,233,227,460,50.7%,48m
24330,1,[Hаsu]HazeOne,2752,1512,115,106,221,52.0%,4m
24330,3,Jean,2752,1371,102,100,202,50.5%,9m
24330,1,Apolo,2752,1013,65,46,111,58.6%,1h
24330,3,Zatsep,2752,915,39,32,71,54.9%,9m
24330,3,TheSx,2752,288,19,18,37,51.4%,4m
24330,3,[мрази]Алинадурында,2752,537,19,21,40,47.5%,21m
24330,1,TwóPóíntóh,2752,568,17,14,31,54.8%,27m
24330,3,[fam1ly]Davizeca,2752,266,17,19,36,47.2%,28m
24330,1,fistiShirKe,2752,431,15,10,25,60.0%,14m
24330,3,[EzD]Adek,2752,349,13,14,27,48.1%,21m
24330,1,AzimuthXeno,2752,359,10,9,19,52.6%,25m
24330,3,kramptame,2752,306,10,16,26,38.5%,2m
24330,3,Akyiires,2752,142,8,11,19,42.1%,17m
24330,2,BlackTopo,2752,200,8,15,23,34.8%,14m
24330,1,Dardasa,2752,192,6,4,10,60.0%,38m
24330,2,SaVioR,2752,95,5,2,7,71.4%,1h
24330,2,Dark,2752,157,5,4,9,55.6%,12m
24330,3,DasBrot,2752,0,4,1,5,80.0%,33m
24330,3,[zernic]Gwiwer,2752,30,4,4,8,50.0%,22m
24330,2,FTwoPlayer,2752,137,4,4,8,50.0%,13m
24330,2,[TBGF]Thomas,2752,115,4,4,8,50.0%,38m
24330,1,OverLord,2752,38,2,0,2,100.0%,3m
24330,1,Anxious,2752,0,2,3,5,40.0%,1h
24330,3,Nayzz,2752,0,2,3,5,40.0%,49m
24330,1,LSM,2752,138,2,5,7,28.6%,1h
24330,1,REVAN,2752,42,1,1,2,50.0%,32m
24330,3,Barbariska,2752,30,1,6,7,14.3%,2m
24330,1,Uncensored,2752,0,0,1,1,0.0%,21m
24330,1,Hoobit,2752,0,0,1,1,0.0%,1h
24330,1,Frigost,2752,0,0,5,5,0.0%,38m
24361,2,endfri,2751,1590,281,286,567,49.6%,9m
24361,1,zestdecitron,2751,1449,208,213,421,49.4%,4m
24361,3,Stepsol,2751,1535,204,191,395,51.6%,20m
24361,3,BUH,2751,1592,189,184,373,50.7%,2m
24361,2,Sandman,2751,1224,131,118,249,52.6%,19m
24361,1,Phily,2751,1413,84,77,161,52.2%,12m
24361,3,Madbonya,2751,865,53,53,106,50.0%,7m
24361,2,[MMF]LOCOO,2751,1203,50,51,101,49.5%,3m
24361,3,mati,2751,586,35,26,61,57.4%,12m
24361,2,[Heroes]Minas,2751,719,27,31,58,46.6%,2m
24361,1,TermiT,2751,541,24,15,39,61.5%,22m
24361,2,Ziykuna,2751,628,24,30,54,44.4%,16m
24361,3,NICO,2751,521,21,20,41,51.2%,13m
24361,1,Ebó,2751,200,11,11,22,50.0%,15m
24361,1,Newguy,2751,262,8,7,15,53.3%,1h
24361,3,fisk,2751,196,8,8,16,50.0%,14m
24361,1,Reaper,2751,200,6,5,11,54.5%,1h
24361,3,MrGllory,2751,63,4,7,11,36.4%,20m
24361,3,FireSheep,2751,0,3,2,5,60.0%,36m
24361,1,RedPatrick,2751,38,3,4,7,42.9%,1h
24361,3,BroExembal,2751,88,3,7,10,30.0%,21m
24361,1,Martinii,2751,0,2,3,5,40.0%,34m
24361,1,[Taldar]AuRoRa,2751,76,2,3,5,40.0%,39m
24361,1,Warmann,2751,84,2,4,6,33.3%,1h
24361,1,Марат,2751,0,1,0,1,100.0%,1h
24361,1,KittyFight,2751,40,1,1,2,50.0%,21m
24361,3,oleg,2751,30,1,4,5,20.0%,20m
24361,1,hLeBuShEk,2751,0,0,1,1,0.0%,43m
24361,3,MrTeTRiS,2751,0,0,2,2,0.0%,1h
24361,3,univers,2751,0,0,5,5,0.0%,14m
24391,2,MAD,2750,1552,100,99,199,50.3%,6m
24391,3,csdemons,2750,1397,77,65,142,54.2%,20m
24391,1,Tar,2750,868,70,62,132,53.0%,7m
24391,3,Absølute,2750,1398,56,54,110,50.9%,23m
24391,1,jocprost,2750,1046,48,38,86,55.8%,10m
24391,3,deathNote,2750,586,24,23,47,51.1%,9m
24391,3,HiImOgisa,2750,469,23,22,45,51.1%,29m
24391,3,Zerka,2750,522,18,18,36,50.0%,10m
24391,2,Catchmar,2750,421,16,16,32,50.0%,17m
24391,3,Denico,2750,341,15,13,28,53.6%,17m
24391,3,Muckers,2750,395,13,14,27,48.1%,29m
24391,3,[wN5]Vanan,2750,294,11,9,20,55.0%,7m
24391,1,[nuks]SPARTANA,2750,300,8,9,17,47.1%,1h
24391,3,XerXes,2750,248,8,14,22,36.4%,23m
24391,1,Zest,2750,282,7,5,12,58.3%,21m
24391,2,Auslander,2750,150,5,5,10,50.0%,19m
24391,3,lieten,2750,121,5,6,11,45.5%,28m
24391,1,Quark,2750,168,4,4,8,50.0%,33m
24391,1,AnEpicApple,2750,119,4,4,8,50.0%,1h
24391,1,[5Packs]Polygon,2750,78,3,2,5,60.0%,1h
24391,1,Mahinder,2750,40,2,0,2,100.0%,18m
24391,1,mirik,2750,135,2,2,4,50.0%,30m
24391,3,[GG]Dracorath,2750,0,2,3,5,40.0%,8m
24391,3,Foxtrot,2750,0,2,3,5,40.0%,8m
24391,2,mKw,2750,0,1,0,1,100.0%,20m
24391,1,ParusParidae,2750,0,1,1,2,50.0%,26m
24391,3,boss,2750,0,1,1,2,50.0%,3m
24391,1,[HRDS]Ozelot,2750,40,1,2,3,33.3%,13m
24391,3,Trump,2750,97,1,2,3,33.3%,27m
24391,3,IIIIIIIIIIII,2750,0,1,4,5,20.0%,34m
24391,2,Renatik,2750,48,1,4,5,20.0%,29m
24391,1,Insane,2750,0,0,2,2,0.0%,15m
24391,1,ALCO,2750,0,0,3,3,0.0%,30m
24424,1,[NLTN]chrisborg,2749,1444,180,192,372,48.4%,21m
24424,3,derAddi,2749,1549,128,123,251,51.0%,18m
24424,1,Erico,2749,1580,100,89,189,52.9%,39m
24424,3,eRUha,2749,1468,82,79,161,50.9%,9m
24424,3,EgoriuZ,2749,1090,45,40,85,52.9%,18m
24424,1,SKYFALL,2749,958,39,24,63,61.9%,40m
24424,1,Nero,2749,1152,39,38,77,50.6%,49m
24424,1,jorko,2749,877,35,23,58,60.3%,21m
24424,3,Brightbluebr,2749,447,30,25,55,54.5%,10m
24424,2,KilRahn,2749,584,26,36,62,41.9%,3m
24424,1,[0APMpl]Xeruti,2749,374,23,20,43,53.5%,33m
24424,2,CWarlike,2749,582,23,24,47,48.9%,8m
24424,1,Makun,2749,404,15,21,36,41.7%,15m
24424,1,SanGoo,2749,352,11,6,17,64.7%,19m
24424,1,Zeratul,2749,230,9,3,12,75.0%,24m
24424,3,[PAБ]MCIBibabi,2749,255,9,8,17,52.9%,21m
24424,1,Fanasco,2749,158,6,6,12,50.0%,9m
24424,1,JustAshot,2749,186,5,5,10,50.0%,1h
24424,3,Sneix,2749,101,5,5,10,50.0%,30m
24424,3,NICE,2749,93,4,3,7,57.1%,13m
24424,1,NikiRed,2749,118,4,3,7,57.1%,1h
24424,2,IIIIIIIIIIII,2749,124,4,12,16,25.0%,13m
24424,1,mixer,2749,0,1,0,1,100.0%,12m
24424,1,nurek,2749,38,1,2,3,33.3%,34m
24424,3,Marikkusu,2749,0,1,2,3,33.3%,3m
24424,1,[Schabe]Napoleon,2749,40,1,2,3,33.3%,27m
24424,1,Foboc,2749,0,0,2,2,0.0%,27m
24424,3,BlackNapalm,2749,0,0,6,6,0.0%,2m
24452,1,Poison,2748,1751,166,141,307,54.1%,11m
24452,3,BaBtist,2748,902,75,68,143,52.4%,13m
24452,1,TerraBit,2748,471,51,51,102,50.0%,1h
24452,3,SKip,2748,1037,50,47,97,51.5%,12m
24452,3,theevill,2748,406,29,14,43,67.4%,2m
24452,3,Manstein,2748,618,26,24,50,52.0%,19m
24452,1,Yoda,2748,528,17,13,30,56.7%,1h
24452,3,Pineapple,2748,419,15,14,29,51.7%,10m
24452,3,Fyntik,2748,340,13,10,23,56.5%,29m
24452,3,[WaWRuS]KingBongru,2748,291,10,12,22,45.5%,2m
24452,1,lebonthib,2748,120,6,4,10,60.0%,12m
24452,2,MaGic,2748,178,5,5,10,50.0%,30m
24452,1,Quentin,2748,213,4,4,8,50.0%,19m
24452,3,floppy,2748,60,4,7,11,36.4%,16m
24452,3,[ExoB]LemonLord,2748,93,3,1,4,75.0%,9m
24452,1,avebHyperion,2748,74,3,1,4,75.0%,1h
24452,1,Olvigera,2748,80,3,2,5,60.0%,1h
24452,2,George,2748,95,3,4,7,42.9%,41m
24452,3,Diray,2748,0,2,3,5,40.0%,40m
24452,3,ErikMasa,2748,60,2,8,10,20.0%,2m
24452,1,[00100]Kyklovod,2748,0,0,1,1,0.0%,24m
24452,1,Prate,2748,0,0,1,1,0.0%,1h
24474,2,solaris,2747,1016,216,212,428,50.5%,13m
24474,3,masterbart,2747,998,92,77,169,54.4%,6m
24474,1,Bit,2747,1175,67,63,130,51.5%,25m
24474,1,NarenKat,2747,1499,61,44,105,58.1%,22m
24474,3,[ČBEC]VitekKvitek,2747,772,30,28,58,51.7%,5m
24474,1,TOBCYXOB,2747,511,22,8,30,73.3%,8m
24474,1,[ЗИБиАГ]Talat,2747,363,14,6,20,70.0%,10m
24474,3,[АDorit]LowAPM,2747,388,14,13,27,51.9%,20m
24474,1,SuicidexXx,2747,352,10,10,20,50.0%,25m
24474,1,Rgnrokndroll,2747,216,7,8,15,46.7%,7m
24474,2,demigod,2747,46,5,4,9,55.6%,1h
24474,1,Solek,2747,48,4,4,8,50.0%,43m
24474,2,chery,2747,114,4,4,8,50.0%,35m
24474,3,NotEnough,2747,156,4,5,9,44.4%,7m
24474,3,[SPSes]ivanrsz,2747,114,4,7,11,36.4%,11m
24474,1,Mada,2747,126,3,4,7,42.9%,30m
24474,3,Duglac,2747,144,3,6,9,33.3%,20m
24474,3,Ravenclaws,2747,0,2,3,5,40.0%,41m
24474,2,Naks,2747,88,2,4,6,33.3%,15m
24474,3,DarkTerran,2747,0,2,5,7,28.6%,18m
24474,1,[SVteam]StarVision,2747,0,1,0,1,100.0%,37m
24474,2,AsTreL,2747,0,1,0,1,100.0%,36m
24474,1,Godbrazer,2747,0,1,0,1,100.0%,1h
24474,1,[FSTM]Benji,2747,0,1,0,1,100.0%,11m
24474,1,FisherKing,2747,0,1,1,2,50.0%,6m
24474,1,hgchgchghch,2747,0,0,1,1,0.0%,27m
24474,1,ADUN,2747,0,0,2,2,0.0%,40m
24501,3,SexSexich,2746,738,150,130,280,53.6%,23m
24501,3,MurphysLaw,2746,502,78,65,143,54.5%,4m
24501,2,xFeldMasterQ,2746,1036,41,51,92,44.6%,20m
24501,2,[mfixed]Tyro,2746,774,33,29,62,53.2%,13m
24501,3,Argy,2746,768,28,34,62,45.2%,18m
24501,3,Adsum,2746,308,27,32,59,45.8%,14m
24501,1,[MoopyS]Nubsan,2746,416,18,5,23,78.3%,44m
24501,1,JustFox,2746,380,14,5,19,73.7%,11m
24501,1,GenJerome,2746,424,12,13,25,48.0%,1h
24501,1,Flex,2746,258,8,5,13,61.5%,27m
24501,1,Braxton,2746,231,8,7,15,53.3%,2m
24501,1,silentvoice,2746,180,6,5,11,54.5%,1h
24501,1,flyboy,2746,153,6,7,13,46.2%,48m
24501,1,Megavirus,2746,151,5,4,9,55.6%,47m
24501,1,Psycho,2746,88,3,2,5,60.0%,22m
24501,2,CTEFAN,2746,0,3,3,6,50.0%,47m
24501,3,[LeZOB]KimpanZé,2746,42,2,3,5,40.0%,1h
24501,3,[TagPed]Mat,2746,0,2,3,5,40.0%,45m
24501,3,Alex,2746,0,2,3,5,40.0%,47m
24501,1,[SYMtL]dad,2746,0,1,0,1,100.0%,14m
24501,1,Blorb,2746,0,1,0,1,100.0%,33m
24501,1,Kuplinyaha,2746,38,1,1,2,50.0%,39m
24501,1,TZec,2746,0,1,1,2,50.0%,1h
24501,1,Ademko,2746,0,1,2,3,33.3%,25m
24501,1,[KDV]vipek,2746,42,1,4,5,20.0%,43m
24501,1,[ZERGSC]BRO,2746,0,0,1,1,0.0%,36m
24501,1,Dimentor,2746,0,0,1,1,0.0%,15m
24501,1,Swift,2746,0,0,2,2,0.0%,31m
24501,3,[NHNL]Sinner,2746,0,0,4,4,0.0%,12m
24530,3,Namaste,2745,931,81,81,162,50.0%,8m
24530,3,Ghoust,2745,1337,54,54,108,50.0%,2m
24530,2,SannO,2745,208,44,49,93,47.3%,16m
24530,3,Shrunkai,2745,338,12,13,25,48.0%,15m
24530,3,Sheff,2745,275,11,13,24,45.8%,5m
24530,3,ArKan,2745,340,11,19,30,36.7%,8m
24530,1,[O4FUN]Cyngiel,2745,340,10,9,19,52.6%,7m
24530,1,kilain,2745,336,9,13,22,40.9%,1h
24530,1,[Смешно]Хех,2745,281,8,7,15,53.3%,1h
24530,3,Pathfinder,2745,202,8,9,17,47.1%,6m
24530,3,MAX,2745,120,7,7,14,50.0%,6m
24530,1,LuţăAgresoru,2745,239,7,8,15,46.7%,11m
24530,3,jack,2745,226,7,9,16,43.8%,6m
24530,1,AsH,2745,144,5,6,11,45.5%,43m
24530,1,lilyAnne,2745,158,4,6,10,40.0%,3m
24530,3,TwoCheap,2745,170,4,7,11,36.4%,10m
24530,2,GeRoIN,2745,58,3,4,7,42.9%,6m
24530,3,Czaki,2745,60,3,5,8,37.5%,22m
24530,1,Rappty,2745,125,3,5,8,37.5%,1h
24530,3,RechnovSS,2745,97,2,1,3,66.7%,18m
24530,2,dellu,2745,134,2,2,4,50.0%,39m
24530,1,anti,2745,0,2,3,5,40.0%,1h
24530,3,[FKSD]Fearless,2745,0,1,0,1,100.0%,1h
24530,1,Extreme,2745,0,1,1,2,50.0%,33m
24530,1,AYEBob,2745,40,1,4,5,20.0%,14m
24530,1,xPloit,2745,91,1,4,5,20.0%,3m
24530,3,Dyia,2745,30,1,5,6,16.7%,21m
24530,1,Krot,2745,0,0,1,1,0.0%,1h
24530,1,[AISC]StoneMan,2745,0,0,2,2,0.0%,1h
24530,1,[Z3RGTV]Dezmond,2745,0,0,2,2,0.0%,40m
24560,2,DarkMoli,2744,1548,131,136,267,49.1%,5m
24560,3,Alyur,2744,1484,121,115,236,51.3%,6m
24560,3,Borec,2744,1184,81,75,156,51.9%,6m
24560,3,[nWss]Jakob,2744,334,64,61,125,51.2%,13m
24560,2,Finjaeger,2744,822,62,57,119,52.1%,2m
24560,3,Bliss,2744,1101,45,43,88,51.1%,9m
24560,1,[Wizar]GRifon,2744,881,43,28,71,60.6%,40m
24560,3,josh,2744,697,36,26,62,58.1%,11m
24560,3,Hubek,2744,551,23,23,46,50.0%,2m
24560,1,[skuzi]frinzo,2744,651,22,18,40,55.0%,37m
24560,2,dfgjh,2744,628,21,31,52,40.4%,2m
24560,3,[SGтv]logmist,2744,403,17,12,29,58.6%,2m
24560,3,Peyden,2744,385,16,17,33,48.5%,4m
24560,3,Fubert,2744,378,13,16,29,44.8%,14m
24560,3,Elsydeon,2744,231,12,10,22,54.5%,8m
24560,3,[Goed]Milkman,2744,286,10,10,20,50.0%,21m
24560,1,[4Nordy]GhostHunter,2744,298,9,6,15,60.0%,7m
24560,1,topwar,2744,190,8,11,19,42.1%,6m
24560,2,[troolz]bogsterwheel,2744,221,7,3,10,70.0%,38m
24560,1,Sven,2744,210,7,4,11,63.6%,37m
24560,2,Зереф,2744,133,5,7,12,41.7%,12m
24560,1,Crusher,2744,0,4,1,5,80.0%,48m
24560,1,Sleypner,2744,116,4,2,6,66.7%,14m
24560,1,Jallis,2744,158,4,3,7,57.1%,27m
24560,3,Justebon,2744,159,4,6,10,40.0%,4m
24560,2,SnrSS,2744,0,3,4,7,42.9%,45m
24560,2,[v1tf]Rubelino,2744,94,2,0,2,100.0%,29m
24560,1,Sarrouch,2744,0,2,3,5,40.0%,2m
24560,1,MaxBrawne,2744,0,2,3,5,40.0%,39m
24560,1,Cemashi,2744,0,2,3,5,40.0%,1h
24560,1,YoshkinCat,2744,40,1,1,2,50.0%,1h
24560,1,Madman,2744,97,1,3,4,25.0%,17m
24560,1,jacoba,2744,42,1,4,5,20.0%,1h
24560,1,soakymilk,2744,0,0,1,1,0.0%,13m
24560,1,Nefelim,2744,0,0,1,1,0.0%,1h
24595,3,Mésange,2743,1589,180,172,352,51.1%,13m
24595,3,BASB,2743,1552,136,123,259,52.5%,10m
24595,3,NeoGeek,2743,1037,116,102,218,53.2%,20m
24595,1,BABUSHKA,2743,972,76,67,143,53.1%,20m
24595,1,Eugz,2743,988,70,54,124,56.5%,15m
24595,3,Krasty,2743,1381,63,46,109,57.8%,19m
24595,1,EekaMouse,2743,798,63,70,133,47.4%,7m
24595,1,BossMerinos,2743,646,39,20,59,66.1%,13m
24595,1,Зamай,2743,811,33,21,54,61.1%,1h
24595,1,Raycor,2743,696,24,17,41,58.5%,27m
24595,3,Nanoxid,2743,490,20,19,39,51.3%,2m
24595,2,Ricardo,2743,418,17,19,36,47.2%,9m
24595,1,Icedstoat,2743,435,15,7,22,68.2%,34m
24595,3,llllllllllll,2743,305,12,7,19,63.2%,17m
24595,3,Heomos,2743,200,9,3,12,75.0%,19m
24595,3,KOTENOK,2743,190,6,8,14,42.9%,3m
24595,2,[HINT]BirkosDuJeu,2743,154,5,13,18,27.8%,11m
24595,3,Nico,2743,125,4,6,10,40.0%,11m
24595,1,mgkiller,2743,120,3,3,6,50.0%,48m
24595,1,maheverick,2743,141,3,3,6,50.0%,36m
24595,1,Gothic,2743,121,3,4,7,42.9%,34m
24595,1,Bro,2743,34,2,1,3,66.7%,1h
24595,1,RoJoBa,2743,0,2,3,5,40.0%,1h
24595,1,Rawer,2743,66,2,3,5,40.0%,33m
24595,2,[LI69]LeCamionneur,2743,0,1,0,1,100.0%,1h
24595,1,tiltedhuman,2743,0,1,1,2,50.0%,36m
24595,2,[Foton]безротый,2743,94,1,1,2,50.0%,20m
24595,1,[asuran]dylan,2743,0,1,2,3,33.3%,11m
24595,1,TheCream,2743,40,1,3,4,25.0%,37m
24595,1,Weltall,2743,40,1,4,5,20.0%,44m
24595,1,Stifler,2743,46,1,4,5,20.0%,24m
24595,1,MuadDib,2743,0,0,1,1,0.0%,33m
24595,1,RazieL,2743,0,0,1,1,0.0%,40m
24595,1,Shadow,2743,0,0,1,1,0.0%,33m
24629,3,bober,2742,1527,242,224,466,51.9%,19m
24629,1,[just9E]RaynorZufall,2742,1320,46,40,86,53.5%,19m
24629,1,DVK,2742,896,31,29,60,51.7%,26m
24629,3,Kempus,2742,615,25,25,50,50.0%,5m
24629,1,InOutLake,2742,571,19,18,37,51.4%,43m
24629,1,cooking,2742,437,16,12,28,57.1%,22m
24629,1,[FAZE69]Eltigrethor,2742,307,12,3,15,80.0%,48m
24629,3,ASAPGoto,2742,320,11,16,27,40.7%,2m
24629,3,[dMza]ScHMIDTY,2742,199,10,15,25,40.0%,12m
24629,1,Doctor,2742,271,7,4,11,63.6%,15m
24629,2,skywalker,2742,155,6,4,10,60.0%,48m
24629,1,Yoll,2742,150,4,5,9,44.4%,26m
24629,3,jack,2742,122,4,12,16,25.0%,29m
24629,1,BounceDJ,2742,0,3,2,5,60.0%,23m
24629,1,MoNGoL,2742,103,3,3,6,50.0%,7m
24629,1,noza,2742,152,3,3,6,50.0%,30m
24629,1,koronakaren,2742,129,3,4,7,42.9%,1h
24629,3,WanniX,2742,120,3,5,8,37.5%,9m
24629,2,Дупло,2742,116,2,1,3,66.7%,43m
24629,3,Kamilosak,2742,0,2,3,5,40.0%,5m
24629,1,WhereIsMyQQQ,2742,88,2,4,6,33.3%,25m
24629,1,OSCYPEK,2742,0,1,0,1,100.0%,24m
24629,1,Kenny,2742,88,1,1,2,50.0%,21m
24629,1,IvanTheTiger,2742,0,1,1,2,50.0%,32m
24629,1,flowernt,2742,0,1,1,2,50.0%,39m
24629,1,[iX]Lenja,2742,0,0,1,1,0.0%,20m
24629,1,Nesdrovgni,2742,0,0,1,1,0.0%,45m
24629,3,Spirit,2742,0,0,3,3,0.0%,33m
24657,1,Watts,2741,1681,244,225,469,52.0%,12m
24657,1,[R3ject]LupusRex,2741,1403,66,65,131,50.4%,23m
24657,3,[E2F]Arsenic,2741,704,31,27,58,53.4%,18m
24657,1,Gryphus,2741,778,23,24,47,48.9%,49m
24657,1,HuKKo,2741,339,18,4,22,81.8%,21m
24657,1,FREEzy,2741,510,17,11,28,60.7%,43m
24657,3,asl,2741,453,16,21,37,43.2%,4m
24657,1,[1Pack]Calculon,2741,459,15,11,26,57.7%,1h
24657,1,[slаyеr]konas,2741,327,12,10,22,54.5%,11m
24657,1,[lBBTl]laBRUTE,2741,357,11,9,20,55.0%,27m
24657,1,BaptBatte,2741,334,11,10,21,52.4%,48m
24657,1,Khaos,2741,394,11,10,21,52.4%,15m
24657,1,TATTO,2741,341,11,11,22,50.0%,39m
24657,3,Setririon,2741,223,11,19,30,36.7%,21m
24657,1,Supersoft,2741,164,10,8,18,55.6%,20m
24657,1,Ocedlagolova,2741,248,8,4,12,66.7%,21m
24657,1,PBR,2741,207,7,5,12,58.3%,27m
24657,1,[mfixed]MTI,2741,270,7,5,12,58.3%,38m
24657,1,[GBang]CandyUnicorn,2741,190,6,4,10,60.0%,15m
24657,1,ReciProcity,2741,96,6,5,11,54.5%,41m
24657,1,[Bü]Swissmonster,2741,148,5,3,8,62.5%,27m
24657,3,Fantasma,2741,148,5,6,11,45.5%,23m
24657,1,Majooo,2741,121,4,7,11,36.4%,30m
24657,3,ZdziX,2741,0,3,2,5,60.0%,1h
24657,3,pangge,2741,0,3,2,5,60.0%,36m
24657,1,Lapa,2741,122,3,3,6,50.0%,39m
24657,1,MVRGELJ,2741,90,3,3,6,50.0%,1h
24657,2,WEEDMASTER,2741,0,3,4,7,42.9%,7m
24657,3,Veyer,2741,30,3,5,8,37.5%,17m
24657,3,BFGJaken,2741,0,2,3,5,40.0%,49m
24657,3,Макс,2741,0,2,4,6,33.3%,2m
24657,3,Tayoda,2741,0,2,5,7,28.6%,29m
24657,1,christtlol,2741,0,1,0,1,100.0%,42m
24657,1,IIIIIIIIIIII,2741,0,1,0,1,100.0%,5m
24657,2,[ProveK]MEL,2741,93,1,1,2,50.0%,7m
24657,1,[allesk]OCǂErdbeere,2741,38,1,2,3,33.3%,27m
24657,2,DreAmZyY,2741,96,1,2,3,33.3%,1h
24657,2,[CHââTe]Meriwin,2741,48,1,2,3,33.3%,37m
24657,3,[NoMczZ]KäseKarl,2741,94,1,4,5,20.0%,2m
24657,1,[RBP3]GeScorpion,2741,40,1,4,5,20.0%,1h
24657,3,Coldblitz,2741,0,0,4,4,0.0%,22m
24698,3,sgra,2740,1574,326,315,641,50.9%,18m
24698,3,ric,2740,1551,268,264,532,50.4%,12m
24698,1,Zeus,2740,1299,103,115,218,47.2%,2m
24698,1,Cassius,2740,1537,57,49,106,53.8%,1h
24698,1,broken,2740,1040,49,33,82,59.8%,1h
24698,1,Motylia,2740,1008,47,44,91,51.6%,15m
24698,3,[eRZGEb]CommanderFun,2740,632,40,29,69,58.0%,9m
24698,1,[NWGD]benito,2740,842,37,23,60,61.7%,24m
24698,1,Jonny,2740,691,21,18,39,53.8%,33m
24698,1,[Poher]MrDen,2740,673,20,20,40,50.0%,1h
24698,1,Vash,2740,333,13,10,23,56.5%,12m
24698,3,BELEROFONTE,2740,302,12,10,22,54.5%,12m
24698,1,MaxiBraDa,2740,254,8,8,16,50.0%,25m
24698,1,[DOM]BlackMyst,2740,266,8,10,18,44.4%,49m
24698,1,Woland,2740,216,7,12,19,36.8%,19m
24698,3,guri,2740,212,7,17,24,29.2%,2m
24698,1,Rurouni,2740,205,5,2,7,71.4%,1h
24698,1,KIBERAM,2740,152,5,2,7,71.4%,43m
24698,1,[ABF2]alex,2740,165,4,0,4,100.0%,11m
24698,3,Monia,2740,109,4,3,7,57.1%,6m
24698,3,[KerriS]VirusTotal,2740,130,4,3,7,57.1%,20m
24698,2,PepaPig,2740,92,3,0,3,100.0%,1h
24698,1,feedy,2740,78,3,2,5,60.0%,8m
24698,1,MeedVed,2740,59,3,3,6,50.0%,33m
24698,2,[MASR]Thaklos,2740,0,3,4,7,42.9%,24m
24698,1,Бульба,2740,40,2,0,2,100.0%,34m
24698,1,Darick,2740,80,2,1,3,66.7%,1h
24698,1,[AruFur]Arukanin,2740,34,1,4,5,20.0%,1h
24698,3,Sloth,2740,0,0,4,4,0.0%,20m
24727,3,VOSTOK,2739,1500,194,188,382,50.8%,13m
24727,2,[OVDI]xXSuNXx,2739,1279,161,164,325,49.5%,17m
24727,1,Maden,2739,1753,153,138,291,52.6%,1h
24727,3,FacePuff,2739,865,102,96,198,51.5%,2m
24727,1,Pnuts,2739,1341,101,91,192,52.6%,21m
24727,3,OMEGABOOM,2739,1083,52,37,89,58.4%,18m
24727,3,invizMamulek,2739,1202,46,47,93,49.5%,5m
24727,3,[Aorus]IIStrongerII,2739,1074,42,39,81,51.9%,2m
24727,3,Danikray,2739,688,35,27,62,56.5%,15m
24727,3,[MoTeam]Ratshoot,2739,856,35,29,64,54.7%,3m
24727,3,[PxP]EnTRoY,2739,911,35,38,73,47.9%,14m
24727,1,fwj,2739,935,33,23,56,58.9%,30m
24727,3,[TFSC]Néo,2739,691,33,34,67,49.3%,20m
24727,1,Rodger,2739,217,20,30,50,40.0%,21m
24727,3,ExoShadow,2739,422,18,12,30,60.0%,22m
24727,3,[BloTi]Dreamode,2739,422,18,20,38,47.4%,12m
24727,3,Maarten,2739,528,18,24,42,42.9%,2m
24727,1,[CoBiSi]Padix,2739,596,17,20,37,45.9%,27m
24727,1,[RBlood]Akinetsu,2739,446,13,13,26,50.0%,19m
24727,1,[HOMM3]Fusion,2739,296,9,5,14,64.3%,11m
24727,3,dompiche,2739,236,9,10,19,47.4%,3m
24727,3,Habee,2739,188,7,14,21,33.3%,2m
24727,1,Roshka,2739,155,6,3,9,66.7%,11m
24727,3,OOOOOOOOO,2739,121,4,5,9,44.4%,10m
24727,3,grix,2739,158,4,8,12,33.3%,15m
24727,2,IIIIIIIIIII,2739,0,3,1,4,75.0%,41m
24727,2,Nixonexe,2739,0,3,4,7,42.9%,1h
24727,2,Borshevskiy,2739,0,2,2,4,50.0%,41m
24727,1,[HEGEL]Andrey,2739,78,2,3,5,40.0%,1h
24727,3,Doneklxd,2739,0,2,3,5,40.0%,44m
24727,3,SiekaczEk,2739,0,2,3,5,40.0%,36m
24727,3,uNiT,2739,30,2,5,7,28.6%,5m
24727,1,GachiMaster,2739,0,1,0,1,100.0%,30m
24727,1,[n2745]Kernel,2739,0,1,1,2,50.0%,1h
24727,1,BigWalter,2739,48,1,3,4,25.0%,2m
24727,1,[PUT1]SaMere,2739,48,1,9,10,10.0%,39m
24727,1,[L1F6]NilsTo,2739,0,0,1,1,0.0%,1h
24727,1,FanTik,2739,0,0,1,1,0.0%,27m
24727,1,[SDRV]ALCOLMAN,2739,0,0,1,1,0.0%,2m
24727,2,LasHaSar,2739,0,0,1,1,0.0%,45m
24727,1,zeron,2739,0,0,3,3,0.0%,48m
24727,1,Sweezy,2739,0,0,5,5,0.0%,1h
24727,1,[ČUMPR]GoldenOrc,2739,0,0,6,6,0.0%,1h
24770,3,[aHsK]RuedieboY,2738,1579,114,104,218,52.3%,9m
24770,3,SnakeOdUA,2738,818,29,34,63,46.0%,5m
24770,2,Kenobi,2738,637,25,27,52,48.1%,18m
24770,3,cocico,2738,307,18,18,36,50.0%,11m
24770,1,Corgil,2738,212,7,2,9,77.8%,27m
24770,1,[CHââTe]Imlerith,2738,237,6,9,15,40.0%,5m
24770,3,chelovek,2738,90,5,8,13,38.5%,12m
24770,1,Zerotool,2738,116,4,1,5,80.0%,19m
24770,3,[Mering]Meringa,2738,93,4,3,7,57.1%,20m
24770,2,mihneagrig,2738,114,4,3,7,57.1%,26m
24770,1,Fjun,2738,38,2,1,3,66.7%,11m
24770,1,[Öplex]frogOPS,2738,40,2,1,3,66.7%,11m
24770,3,[TGZP]VanyaZ,2738,40,2,2,4,50.0%,1h
24770,2,Boryamba,2738,111,2,3,5,40.0%,7m
24770,3,Dude,2738,30,2,3,5,40.0%,9m
24770,1,Jarvis,2738,0,2,7,9,22.2%,5m
24770,1,[SHOUPI]Gengiskann,2738,0,1,0,1,100.0%,40m
24770,1,Nurikosha,2738,36,1,1,2,50.0%,27m
24770,1,voice,2738,0,0,1,1,0.0%,7m
24770,1,[ZELNAG]Tigervic,2738,0,0,2,2,0.0%,1h
24790,1,BloodRaven,2737,1345,65,54,119,54.6%,1h
24790,3,PsYchiC,2737,530,32,40,72,44.4%,13m
24790,3,[MLY]Popopopette,2737,563,25,23,48,52.1%,4m
24790,1,Bekele,2737,680,21,19,40,52.5%,24m
24790,3,DrWhyte,2737,461,19,25,44,43.2%,7m
24790,1,Zwiebelsepp,2737,316,14,14,28,50.0%,27m
24790,1,Alex,2737,384,12,12,24,50.0%,2m
24790,3,Vypeer,2737,280,11,10,21,52.4%,6m
24790,1,vlastilin,2737,197,9,7,16,56.2%,15m
24790,3,RomanWarrior,2737,239,8,8,16,50.0%,12m
24790,1,[TIAIA]nagyjan,2737,224,7,9,16,43.8%,38m
24790,3,Achilles,2737,200,7,11,18,38.9%,21m
24790,2,Reactive,2737,188,7,16,23,30.4%,18m
24790,1,Titanfol,2737,218,6,3,9,66.7%,15m
24790,1,Adamanthul,2737,164,5,5,10,50.0%,26m
24790,1,XENOMORPHPL,2737,122,5,5,10,50.0%,35m
24790,1,[mckcor]Jwho,2737,154,5,5,10,50.0%,39m
24790,1,[EpicSr]Lisiqmetodis,2737,122,4,4,8,50.0%,1h
24790,1,[RBlood]Ninjuke,2737,159,3,1,4,75.0%,31m
24790,1,Tintec,2737,116,3,2,5,60.0%,6m
24790,2,Kagadidoe,2737,0,3,4,7,42.9%,45m
24790,3,gepardy,2737,60,3,6,9,33.3%,8m
24790,1,TechnoRocker,2737,38,2,1,3,66.7%,8m
24790,1,Ollly,2737,40,2,1,3,66.7%,44m
24790,1,[YouGay]HarStar,2737,48,2,1,3,66.7%,50m
24790,1,Kentril,2737,97,2,2,4,50.0%,1h
24790,3,ÖoOöÖöOoÖ,2737,0,2,3,5,40.0%,1h
24790,1,Redreom,2737,0,1,0,1,100.0%,1h
24790,1,FruttiK,2737,0,1,1,2,50.0%,33m
24790,1,drapishka,2737,0,1,1,2,50.0%,19m
24790,1,Random,2737,38,1,2,3,33.3%,24m
24790,3,[Kndoy]Gillan,2737,30,1,7,8,12.5%,2m
24790,1,RaniZ,2737,0,0,1,1,0.0%,8m
24790,1,Stormranger,2737,0,0,1,1,0.0%,12m
24790,1,[ZERGML]Even,2737,0,0,1,1,0.0%,39m
24790,1,Max,2737,0,0,1,1,0.0%,37m
24790,1,UglydrOne,2737,73,0,2,2,0.0%,7m
24790,1,[Cacoon]Deluchi,2737,0,0,2,2,0.0%,32m
24790,1,Litago,2737,0,0,3,3,0.0%,38m
24829,2,Smoczek,2736,909,87,95,182,47.8%,15m
24829,3,hamilyon,2736,613,71,52,123,57.7%,6m
24829,3,Exodus,2736,1467,69,62,131,52.7%,9m
24829,1,DeLaVeGa,2736,492,60,35,95,63.2%,43m
24829,1,Yato,2736,870,55,42,97,56.7%,40m
24829,3,Nomak,2736,1069,52,55,107,48.6%,5m
24829,3,[STOBAG]haniball,2736,664,25,26,51,49.0%,23m
24829,3,[MNKTS]Adrianmika,2736,584,20,24,44,45.5%,20m
24829,1,nik,2736,523,18,13,31,58.1%,8m
24829,3,DamnedKing,2736,444,16,20,36,44.4%,5m
24829,1,NIKITA,2736,428,13,11,24,54.2%,40m
24829,1,[RMWP]MrScruff,2736,250,7,7,14,50.0%,31m
24829,3,HacheDeuxOs,2736,249,7,11,18,38.9%,28m
24829,2,Lcdygy,2736,211,6,1,7,85.7%,23m
24829,3,Azoth,2736,146,6,19,25,24.0%,29m
24829,1,Siecinianin,2736,116,4,1,5,80.0%,1h
24829,1,IOWA,2736,173,4,1,5,80.0%,14m
24829,2,Tyzigu,2736,113,4,4,8,50.0%,1h
24829,1,CheSteRVII,2736,80,3,2,5,60.0%,1h
24829,3,IWontCheese,2736,0,3,2,5,60.0%,30m
24829,3,[PiGPan]Zhargon,2736,90,3,8,11,27.3%,22m
24829,1,[THound]CHNO,2736,80,2,1,3,66.7%,14m
24829,2,Timmy,2736,114,2,2,4,50.0%,38m
24829,2,Arty,2736,0,2,4,6,33.3%,1h
24829,1,eLyANCc,2736,0,1,0,1,100.0%,14m
24829,1,Morris,2736,0,1,2,3,33.3%,1h
24829,2,mamba,2736,0,0,1,1,0.0%,44m
24829,1,XYZ,2736,0,0,1,1,0.0%,21m
24829,3,komnotmr,2736,0,0,3,3,0.0%,18m
24829,1,kanelbulle,2736,0,0,3,3,0.0%,22m
24859,1,Celebrimbor,2735,1457,235,212,447,52.6%,4m
24859,3,TioTonio,2735,1588,170,150,320,53.1%,5m
24859,1,Luke,2735,1679,83,69,152,54.6%,25m
24859,1,Shush,2735,1259,57,52,109,52.3%,23m
24859,3,NiceSpirit,2735,1061,40,41,81,49.4%,15m
24859,1,Dede,2735,1051,40,44,84,47.6%,22m
24859,2,legaim,2735,984,35,48,83,42.2%,4m
24859,1,XYZEN,2735,723,31,18,49,63.3%,48m
24859,3,Raspova,2735,768,28,34,62,45.2%,11m
24859,3,SER,2735,804,27,34,61,44.3%,12m
24859,3,[THANOS]Reap,2735,518,21,17,38,55.3%,20m
24859,2,GrünfeldBach,2735,599,21,24,45,46.7%,10m
24859,1,FTFTXH,2735,634,20,15,35,57.1%,24m
24859,3,[wYm]Ingream,2735,394,17,17,34,50.0%,18m
24859,1,Mammut,2735,441,14,8,22,63.6%,40m
24859,1,SanyaJor,2735,278,13,6,19,68.4%,15m
24859,1,FortySecond,2735,383,13,12,25,52.0%,7m
24859,1,AndyRUTiger,2735,235,9,6,15,60.0%,27m
24859,1,Papus,2735,253,8,2,10,80.0%,22m
24859,1,SniperBeamer,2735,240,8,6,14,57.1%,23m
24859,3,CaroleBaskin,2735,122,5,7,12,41.7%,23m
24859,1,cocosik,2735,132,4,3,7,57.1%,12m
24859,1,Mell,2735,119,4,5,9,44.4%,44m
24859,1,AndrewMarks,2735,68,3,1,4,75.0%,1h
24859,3,Edinorog,2735,0,3,2,5,60.0%,20m
24859,3,BadRobot,2735,0,1,3,4,25.0%,16m
24859,1,KAWA,2735,40,1,3,4,25.0%,14m
24859,3,PauLXRocK,2735,30,1,9,10,10.0%,2m
24859,1,Turouk,2735,0,0,1,1,0.0%,33m
24888,3,CapCommander,2734,1525,128,120,248,51.6%,2m
24888,3,[ITmani]SPILLO,2734,1068,81,86,167,48.5%,20m
24888,1,[HACKZ]Replicator,2734,1575,70,74,144,48.6%,12m
24888,3,ShaDowNfav,2734,1343,63,60,123,51.2%,4m
24888,1,[SРID]Abigor,2734,1466,58,49,107,54.2%,24m
24888,3,ОсистенБога,2734,936,46,29,75,61.3%,11m
24888,3,Spaceem,2734,349,40,44,84,47.6%,13m
24888,1,hiKingMargo,2734,860,31,24,55,56.4%,24m
24888,1,BARAR,2734,653,23,17,40,57.5%,31m
24888,1,Degastim,2734,494,19,17,36,52.8%,42m
24888,1,Bell,2734,507,16,14,30,53.3%,49m
24888,1,[Кон]Джорно,2734,317,10,7,17,58.8%,15m
24888,3,RFerdinand,2734,312,10,14,24,41.7%,2m
24888,1,MericanChees,2734,306,9,8,17,52.9%,39m
24888,1,CommanderLeo,2734,256,8,4,12,66.7%,1h
24888,1,[Kovaci]JonSilvers,2734,170,8,9,17,47.1%,15m
24888,1,VIKINGR,2734,304,8,11,19,42.1%,5m
24888,2,IIIllIlIlIlI,2734,122,7,11,18,38.9%,6m
24888,1,[BusS]Boga,2734,186,6,6,12,50.0%,1h
24888,3,CaseL,2734,58,6,6,12,50.0%,17m
24888,1,warcic,2734,146,5,2,7,71.4%,12m
24888,3,DjageR,2734,154,5,9,14,35.7%,10m
24888,3,Deathmot,2734,30,4,5,9,44.4%,3m
24888,3,ДИТМАР,2734,30,4,5,9,44.4%,14m
24888,3,MrAlex,2734,30,4,7,11,36.4%,21m
24888,1,Renny,2734,116,3,2,5,60.0%,36m
24888,3,Visseh,2734,93,3,4,7,42.9%,6m
24888,1,jimbO,2734,142,3,5,8,37.5%,1h
24888,1,ХэлсХэл,2734,0,1,0,1,100.0%,6m
24888,1,DaveBoy,2734,42,1,3,4,25.0%,6m
24888,1,[1stGG]wurzelsepp,2734,0,0,1,1,0.0%,44m
24888,2,Cixy,2734,0,0,1,1,0.0%,37m
24920,2,LilSheep,2733,1583,268,247,515,52.0%,6m
24920,1,Rafalo,2733,1006,91,83,174,52.3%,8m
24920,3,Alduin,2733,702,26,28,54,48.1%,20m
24920,1,Kossuth,2733,565,25,19,44,56.8%,1h
24920,2,[korTel]candybomberz,2733,492,20,21,41,48.8%,15m
24920,1,Uldun,2733,516,17,12,29,58.6%,26m
24920,3,JuiceKeg,2733,392,14,15,29,48.3%,16m
24920,3,[SPAINs]Capri,2733,294,10,12,22,45.5%,2m
24920,1,[Gondon]Imagination,2733,237,8,7,15,53.3%,24m
24920,2,Albathar,2733,191,7,6,13,53.8%,8m
24920,3,Quinton,2733,218,7,14,21,33.3%,10m
24920,2,kingfredi,2733,60,5,6,11,45.5%,9m
24920,3,Alex,2733,0,5,9,14,35.7%,15m
24920,2,Termy,2733,160,4,6,10,40.0%,17m
24920,3,Rage,2733,96,4,11,15,26.7%,20m
24920,3,[SWINE]Sairy,2733,42,3,0,3,100.0%,9m
24920,1,RealBigFish,2733,80,3,3,6,50.0%,1h
24920,3,[ChAuTr]Sanga,2733,104,3,38,41,7.3%,11m
24920,1,GERONIMO,2733,42,2,0,2,100.0%,40m
24920,3,MadScientist,2733,0,2,3,5,40.0%,1h
24920,3,Kotya,2733,0,2,3,5,40.0%,37m
24920,1,TGS,2733,30,2,12,14,14.3%,22m
24920,1,BloodyLMate,2733,0,1,0,1,100.0%,8m
24920,1,Illamir,2733,38,1,1,2,50.0%,1h
24920,1,Knyaz,2733,0,1,1,2,50.0%,42m
24920,2,[соклан]Данила,2733,0,1,5,6,16.7%,31m
24920,1,[ZЕRGТV]Hobbit,2733,0,0,1,1,0.0%,15m
24920,1,wwwww,2733,0,0,1,1,0.0%,49m
24948,3,RicardnniZ,2732,1251,98,99,197,49.7%,5m
24948,2,[MousM]Louie,2732,1328,85,76,161,52.8%,15m
24948,2,BlackBeard,2732,709,27,32,59,45.8%,6m
24948,3,Freezy,2732,572,26,23,49,53.1%,7m
24948,1,[AC]Plinio,2732,597,21,18,39,53.8%,13m
24948,2,Borat,2732,458,20,18,38,52.6%,2m
24948,3,[Heroes]StragaSevera,2732,598,20,28,48,41.7%,29m
24948,1,BriGro,2732,390,18,10,28,64.3%,8m
24948,1,Hazheel,2732,286,9,6,15,60.0%,12m
24948,1,iosa,2732,296,9,10,19,47.4%,1h
24948,1,Omega,2732,268,8,4,12,66.7%,45m
24948,1,KillerMarti,2732,176,6,5,11,54.5%,20m
24948,1,Drakdödaren,2732,187,6,6,12,50.0%,11m
24948,1,morfil,2732,184,6,7,13,46.2%,41m
24948,3,[псина]KeenG,2732,156,6,9,15,40.0%,22m
24948,1,Nova,2732,132,4,0,4,100.0%,1h
24948,2,candycekae,2732,48,4,5,9,44.4%,41m
24948,3,Pokebowl,2732,30,4,5,9,44.4%,23m
24948,2,KEYTALAS,2732,44,3,5,8,37.5%,16m
24948,3,darlf,2732,0,2,3,5,40.0%,26m
24948,3,KarolGustaw,2732,0,2,3,5,40.0%,3m
24948,1,PleaseGoEasy,2732,0,2,3,5,40.0%,1h
24948,1,Rurgale,2732,0,1,1,2,50.0%,7m
24948,1,[BLAT]Camil,2732,38,1,1,2,50.0%,13m
24948,1,[CHOPAA]VIK,2732,0,1,3,4,25.0%,12m
24948,1,itsDani,2732,0,1,4,5,20.0%,12m
24948,1,[Kran]Luo,2732,93,1,5,6,16.7%,40m
24948,1,Tiberium,2732,0,0,1,1,0.0%,1h
24948,1,Parl,2732,0,0,2,2,0.0%,1h
24948,2,Ridigel,2732,0,0,2,2,0.0%,1h
24948,2,hultan,2732,0,0,2,2,0.0%,1h
24948,1,ZZsuperZero,2732,0,0,2,2,0.0%,25m
24948,3,[ShFox]Murr,2732,0,0,3,3,0.0%,30m
24948,3,[BttF]EgorChe,2732,0,0,4,4,0.0%,18m
24982,3,Gungani,2731,1310,70,58,128,54.7%,4m
24982,3,Eye,2731,1041,68,57,125,54.4%,11m
24982,2,Orakel,2731,1233,66,64,130,50.8%,6m
24982,1,Taiipz,2731,1002,48,45,93,51.6%,15m
24982,1,Ice,2731,985,34,29,63,54.0%,25m
24982,1,Lotar,2731,528,17,13,30,56.7%,11m
24982,1,NDC,2731,498,14,17,31,45.2%,33m
24982,1,Vulwsztyn,2731,370,13,9,22,59.1%,40m
24982,1,Iceberg,2731,298,12,14,26,46.2%,1h
24982,1,GeraX,2731,296,10,7,17,58.8%,48m
24982,3,[DevOps]Sake,2731,295,9,12,21,42.9%,18m
24982,1,Extractz,2731,304,8,5,13,61.5%,1h
24982,1,destroer,2731,229,7,3,10,70.0%,24m
24982,3,[Kapt]Fery,2731,249,7,11,18,38.9%,1h
24982,3,thunderbear,2731,154,6,7,13,46.2%,23m
24982,3,[SkSC2]DaakMan,2731,170,6,10,16,37.5%,9m
24982,3,eclipse,2731,92,6,10,16,37.5%,2m
24982,1,Winner,2731,118,4,3,7,57.1%,49m
24982,1,[GiRLgg]CuteKitty,2731,188,4,3,7,57.1%,38m
24982,1,degnet,2731,101,3,0,3,100.0%,30m
24982,1,DntWorry,2731,0,3,2,5,60.0%,44m
24982,1,Mike,2731,0,3,2,5,60.0%,20m
24982,2,Vakinn,2731,0,3,4,7,42.9%,46m
24982,1,Edvins,2731,70,2,1,3,66.7%,15m
24982,3,[AbSSSR]Tyrael,2731,94,2,2,4,50.0%,4m
24982,3,Maxwell,2731,0,2,3,5,40.0%,1h
24982,3,RebelFred,2731,0,2,3,5,40.0%,1h
24982,2,[StTm]quasar,2731,0,2,4,6,33.3%,9m
24982,1,[TCS69]Bluejay,2731,0,1,2,3,33.3%,48m
24982,1,lekkerhammet,2731,0,1,4,5,20.0%,1h
24982,1,ALEX,2731,0,0,1,1,0.0%,44m
24982,1,Jaegita,2731,0,0,1,1,0.0%,2m
24982,1,tIoIxIa,2731,0,0,2,2,0.0%,11m
24982,1,Asassyn,2731,0,0,4,4,0.0%,27m
25016,3,Dusky,2730,1366,151,151,302,50.0%,14m
25016,1,[CHIBRE]Fseven,2730,1489,136,129,265,51.3%,11m
25016,1,AleX,2730,1705,133,108,241,55.2%,11m
25016,3,kimchiramen,2730,832,129,117,246,52.4%,7m
25016,1,eretic,2730,1605,97,85,182,53.3%,1h
25016,1,[GBCSC2]Maggy,2730,1519,93,89,182,51.1%,24m
25016,3,Baldi,2730,1281,79,72,151,52.3%,13m
25016,3,ShadowSeeker,2730,1010,75,74,149,50.3%,17m
25016,3,OOOTTOOO,2730,888,36,32,68,52.9%,15m
25016,1,dePriest,2730,811,31,39,70,44.3%,5m
25016,3,[NGaBZH]Térazil,2730,758,27,35,62,43.5%,14m
25016,3,Pyre,2730,605,26,28,54,48.1%,20m
25016,3,Wrogashz,2730,686,25,37,62,40.3%,10m
25016,3,Bluemoo,2730,353,17,15,32,53.1%,8m
25016,3,[БОДУН]Cemerset,2730,442,15,21,36,41.7%,22m
25016,1,Svarog,2730,502,14,12,26,53.8%,48m
25016,2,Fischbrot,2730,342,13,12,25,52.0%,3m
25016,1,Pfifferling,2730,352,9,7,16,56.2%,19m
25016,3,[oO]Mano,2730,295,9,11,20,45.0%,21m
25016,1,[ULTX]BrooDMasteR,2730,228,8,0,8,100.0%,22m
25016,1,Lou,2730,145,6,6,12,50.0%,29m
25016,3,dsded,2730,86,6,6,12,50.0%,23m
25016,1,Artanis,2730,171,5,2,7,71.4%,1h
25016,1,[HoWaY]Mando,2730,152,5,3,8,62.5%,47m
25016,2,[P4TW]Käsper,2730,152,4,8,12,33.3%,16m
25016,1,[LYBITE]spatule,2730,141,3,0,3,100.0%,12m
25016,1,GoldenPants,2730,40,2,1,3,66.7%,11m
25016,3,Makhambet,2730,0,2,4,6,33.3%,15m
25016,2,[chees0]JellyArmada,2730,44,2,7,9,22.2%,22m
25016,1,[Batia]JIoбoToMuT,2730,0,1,0,1,100.0%,19m
25016,1,Cenjo,2730,0,1,1,2,50.0%,20m
25016,3,Nanuk,2730,30,1,5,6,16.7%,5m
25016,1,morgianosz,2730,0,0,1,1,0.0%,1h
25016,1,Morphic,2730,0,0,2,2,0.0%,40m
25016,2,QuEZz,2730,0,0,2,2,0.0%,45m
25051,3,Sealtiel,2729,1269,183,173,356,51.4%,20m
25051,3,PlayforFun,2729,1328,154,158,312,49.4%,12m
25051,3,MontrealNord,2729,1520,131,128,259,50.6%,15m
25051,3,[APNos]AlbertQ,2729,963,114,102,216,52.8%,13m
25051,3,[DNGR]Jemeul,2729,553,64,44,108,59.3%,22m
25051,2,Malvolio,2729,963,51,52,103,49.5%,4m
25051,3,Ghost,2729,948,49,53,102,48.0%,12m
25051,3,dukratchoc,2729,922,43,28,71,60.6%,14m
25051,1,CryptoMan,2729,1094,41,35,76,53.9%,6m
25051,1,Bloodraven,2729,888,33,32,65,50.8%,12m
25051,2,Jet,2729,673,23,30,53,43.4%,2m
25051,1,Maxman,2729,495,20,11,31,64.5%,8m
25051,3,[QuBuS]QuBuS,2729,365,16,5,21,76.2%,50m
25051,3,Yesterday,2729,295,16,11,27,59.3%,11m
25051,3,Elyjax,2729,348,14,18,32,43.8%,21m
25051,1,VikingQuest,2729,192,6,4,10,60.0%,6m
25051,3,Grell,2729,157,6,6,12,50.0%,21m
25051,1,Ender,2729,179,5,3,8,62.5%,47m
25051,1,[LOGS]Doofy,2729,208,5,6,11,45.5%,1h
25051,3,vohalaber,2729,0,4,1,5,80.0%,14m
25051,2,Illuha,2729,48,4,5,9,44.4%,47m
25051,1,eXstaa,2729,78,3,2,5,60.0%,1h
25051,1,MaxiGor,2729,80,2,2,4,50.0%,1h
25051,3,Lenny,2729,0,2,3,5,40.0%,16m
25051,2,Inger,2729,0,1,0,1,100.0%,41m
25051,3,[PMBR]fransvetspek,2729,0,1,2,3,33.3%,15m
25051,1,[HighP]Федор,2729,40,1,2,3,33.3%,19m
25051,1,[AQR]AQRpogpog,2729,0,0,1,1,0.0%,39m
25051,1,PingWin,2729,0,0,1,1,0.0%,21m
25051,1,DonDave,2729,0,0,1,1,0.0%,14m
25051,1,Sekretik,2729,0,0,1,1,0.0%,25m
25082,3,BeldeN,2728,1560,131,118,249,52.6%,9m
25082,3,gropitza,2728,1046,126,117,243,51.9%,18m
25082,1,MasaX,2728,1244,81,63,144,56.2%,37m
25082,1,Billy,2728,967,59,41,100,59.0%,11m
25082,1,ValhallAKZ,2728,1175,57,43,100,57.0%,21m
25082,2,Ruslan,2728,1581,56,70,126,44.4%,11m
25082,1,emiliano,2728,764,37,25,62,59.7%,30m
25082,1,[ZCrew]Kindness,2728,828,35,25,60,58.3%,30m
25082,3,gin,2728,779,31,32,63,49.2%,3m
25082,1,MagicTurtle,2728,326,30,20,50,60.0%,48m
25082,2,luffy,2728,689,27,29,56,48.2%,11m
25082,1,Djecraft,2728,584,24,16,40,60.0%,1h
25082,1,xlJokeRlx,2728,623,23,17,40,57.5%,13m
25082,1,Жека,2728,488,21,14,35,60.0%,20m
25082,1,MOON,2728,572,18,14,32,56.2%,40m
25082,3,butch,2728,226,18,21,39,46.2%,22m
25082,1,madpro,2728,544,16,19,35,45.7%,27m
25082,1,Аексей,2728,368,14,4,18,77.8%,12m
25082,2,snussi,2728,289,10,14,24,41.7%,21m
25082,1,dawa,2728,220,9,7,16,56.2%,22m
25082,2,brigadis,2728,210,9,11,20,45.0%,13m
25082,1,eazY,2728,262,8,9,17,47.1%,48m
25082,1,[z666z]AFTAXA,2728,210,7,1,8,87.5%,11m
25082,1,Saldex,2728,203,7,5,12,58.3%,35m
25082,1,Eichizen,2728,190,7,5,12,58.3%,1h
25082,1,[Zhig]JOKER,2728,118,7,5,12,58.3%,22m
25082,3,SJBilly,2728,116,6,7,13,46.2%,18m
25082,1,Bisu,2728,218,6,7,13,46.2%,12m
25082,3,ProFin,2728,30,5,3,8,62.5%,11m
25082,1,scythe,2728,162,5,5,10,50.0%,1h
25082,3,[SibSAU]zzmeii,2728,0,4,2,6,66.7%,18m
25082,3,strash,2728,0,4,2,6,66.7%,15m
25082,3,notafish,2728,0,3,4,7,42.9%,11m
25082,2,Udonator,2728,30,3,8,11,27.3%,13m
25082,1,hilhoc,2728,38,2,0,2,100.0%,1h
25082,1,[sgeht]NephewJ,2728,48,2,1,3,66.7%,48m
25082,3,Levingston,2728,0,2,1,3,66.7%,1h
25082,1,kamernyid,2728,0,2,3,5,40.0%,1h
25082,3,DFox,2728,122,2,6,8,25.0%,20m
25082,3,Hitasa,2728,60,2,10,12,16.7%,3m
25082,1,Sokol,2728,0,1,0,1,100.0%,45m
25082,1,SkorIk,2728,0,1,0,1,100.0%,28m
25082,1,Seth,2728,0,1,1,2,50.0%,36m
25082,2,aleksey,2728,88,1,1,2,50.0%,47m
25082,1,[RUS161]АНДРЕЙ,2728,0,1,2,3,33.3%,49m
25082,1,Kronos,2728,40,1,5,6,16.7%,33m
25082,3,Calgarus,2728,30,1,6,7,14.3%,9m
25082,1,iStrikeBlaze,2728,0,0,1,1,0.0%,1h
25082,1,Surdi,2728,0,0,2,2,0.0%,24m
25131,3,wutperson,2727,877,103,72,175,58.9%,7m
25131,3,PuzzleInk,2727,533,69,76,145,47.6%,5m
25131,2,IMinWorking,2727,1058,55,57,112,49.1%,6m
25131,3,Shiansu,2727,1026,41,44,85,48.2%,13m
25131,3,Renegade,2727,1030,37,45,82,45.1%,22m
25131,1,[LTFBF]Maghster,2727,904,31,28,59,52.5%,1h
25131,1,[Витязи]Akbar,2727,598,25,17,42,59.5%,1h
25131,3,Hawkie,2727,221,20,21,41,48.8%,20m
25131,1,Sanya,2727,397,16,7,23,69.6%,43m
25131,1,pinna,2727,438,16,9,25,64.0%,1h
25131,3,[IceHus]KartofunSumy,2727,412,15,21,36,41.7%,5m
25131,3,[ЗЕRGТV]Neocor,2727,282,10,11,21,47.6%,35m
25131,1,[UpMs]creco,2727,188,6,7,13,46.2%,48m
25131,3,Ullezan,2727,145,5,6,11,45.5%,3m
25131,1,DarkVader,2727,122,4,4,8,50.0%,40m
25131,1,Violet,2727,102,4,5,9,44.4%,19m
25131,1,UserA,2727,97,4,5,9,44.4%,11m
25131,3,[GRobot]WERTY,2727,90,4,8,12,33.3%,9m
25131,1,Dendis,2727,124,3,3,6,50.0%,13m
25131,3,[HZeS]CheckLeds,2727,0,2,1,3,66.7%,17m
25131,3,Babilda,2727,135,2,1,3,66.7%,4m
25131,1,sebyca,2727,82,2,3,5,40.0%,1h
25131,1,Tommyzedog,2727,118,2,3,5,40.0%,11m
25131,1,[LRDP]Scrats,2727,89,2,4,6,33.3%,1h
25131,2,xaroshi,2727,48,2,6,8,25.0%,1h
25131,1,frost,2727,0,1,1,2,50.0%,15m
25131,1,DiSBond,2727,36,1,1,2,50.0%,48m
25131,1,Gordo,2727,0,1,1,2,50.0%,48m
25131,3,Archangel,2727,0,1,2,3,33.3%,15m
25131,1,SOiL,2727,48,1,4,5,20.0%,39m
25131,1,[Incm]KrYoxZ,2727,0,0,1,1,0.0%,19m
25131,1,Misaka,2727,0,0,1,1,0.0%,39m
25131,1,Mange,2727,0,0,1,1,0.0%,39m
25131,1,XXXRany,2727,0,0,4,4,0.0%,11m
25165,2,SleviN,2726,1523,136,139,275,49.5%,21m
25165,1,[CJEDI]Ryppin,2726,1243,91,90,181,50.3%,4m
25165,3,CheesyChees,2726,1371,75,46,121,62.0%,9m
25165,1,[C0M]saqqe,2726,1039,59,58,117,50.4%,1h
25165,1,kTQ,2726,756,25,23,48,52.1%,1h
25165,3,elpietro,2726,720,25,32,57,43.9%,22m
25165,1,Gostin,2726,479,19,11,30,63.3%,1h
25165,3,[pERSoW]endemelePL,2726,161,18,13,31,58.1%,20m
25165,1,[NIC]niclucky,2726,233,10,8,18,55.6%,27m
25165,1,sasa,2726,330,10,8,18,55.6%,24m
25165,1,Electronaut,2726,294,8,8,16,50.0%,1h
25165,1,[FAR2]vodius,2726,222,7,3,10,70.0%,1h
25165,1,DarkMag,2726,209,7,6,13,53.8%,48m
25165,1,kingfive,2726,175,7,6,13,53.8%,22m
25165,2,YarmakTV,2726,96,5,3,8,62.5%,26m
25165,1,Curbitec,2726,184,5,6,11,45.5%,19m
25165,3,Kev,2726,0,4,1,5,80.0%,46m
25165,1,[BLPS]Demonikkk,2726,120,4,4,8,50.0%,33m
25165,1,KAIF,2726,158,4,6,10,40.0%,1h
25165,1,Makwein,2726,129,3,0,3,100.0%,33m
25165,3,dendy,2726,42,3,4,7,42.9%,1h
25165,3,kZed,2726,92,2,2,4,50.0%,4m
25165,2,Arivald,2726,0,2,3,5,40.0%,26m
25165,3,SrHidratante,2726,0,2,3,5,40.0%,15m
25165,1,KiLLZoNe,2726,100,2,4,6,33.3%,24m
25165,3,wawrinka,2726,58,2,33,35,5.7%,6m
25165,1,[UFOH]outpost,2726,0,1,0,1,100.0%,19m
25165,1,Natic,2726,0,1,0,1,100.0%,1h
25165,1,Thordran,2726,0,1,1,2,50.0%,7m
25165,1,TriV,2726,40,1,4,5,20.0%,1h
25165,1,montique,2726,0,0,1,1,0.0%,1h
25165,1,Lehark,2726,0,0,1,1,0.0%,45m
25165,3,Tarrasque,2726,0,0,2,2,0.0%,1h
25198,2,AlexTrevor,2725,1546,129,129,258,50.0%,11m
25198,3,лёлик,2725,1463,78,65,143,54.5%,10m
25198,3,[Viva]Geshma,2725,728,57,53,110,51.8%,11m
25198,3,Manse,2725,1460,57,57,114,50.0%,22m
25198,1,Roelof,2725,344,25,20,45,55.6%,7m
25198,3,OneTwo,2725,404,18,12,30,60.0%,11m
25198,1,[FNZ]Yandros,2725,415,13,9,22,59.1%,8m
25198,1,NightDark,2725,196,5,5,10,50.0%,6m
25198,1,folk,2725,118,4,6,10,40.0%,40m
25198,3,KingLoui,2725,156,4,7,11,36.4%,4m
25198,1,MentolUA,2725,110,3,3,6,50.0%,4m
25198,3,[ĦRZcom]Dodoster,2725,145,3,5,8,37.5%,2m
25198,1,Bioschock,2725,38,2,0,2,100.0%,11m
25198,3,Bob,2725,0,2,3,5,40.0%,12m
25198,2,Blitzer,2725,0,1,0,1,100.0%,42m
25198,3,Jawker,2725,0,1,1,2,50.0%,30m
25198,3,BCMAXXV,2725,0,1,2,3,33.3%,12m
25198,1,Darktempest,2725,0,1,2,3,33.3%,15m
25198,2,KingDragon,2725,48,1,3,4,25.0%,1h
25198,3,[ATOMS]gzzz,2725,0,0,1,1,0.0%,1h
25198,3,[NеXT]Zeratul,2725,0,0,2,2,0.0%,47m
25198,3,glhnf,2725,0,0,2,2,0.0%,1h
25220,3,BlackDeath,2724,1580,366,367,733,49.9%,23m
25220,3,Emperorism,2724,610,43,39,82,52.4%,19m
25220,3,SerialKiller,2724,898,40,41,81,49.4%,13m
25220,3,[MOFFO]kPanda,2724,635,35,38,73,47.9%,13m
25220,1,Serjant,2724,915,34,31,65,52.3%,1h
25220,1,Purplehæze,2724,372,28,15,43,65.1%,33m
25220,1,ConarDeVirus,2724,637,21,16,37,56.8%,1h
25220,3,[ChBag]piter,2724,328,11,16,27,40.7%,23m
25220,3,baxtrrrr,2724,249,10,10,20,50.0%,6m
25220,3,[WАSD]RansuTapani,2724,297,10,17,27,37.0%,15m
25220,1,Semels,2724,282,9,14,23,39.1%,40m
25220,1,poker,2724,237,8,3,11,72.7%,1h
25220,3,gumazavrik,2724,188,8,8,16,50.0%,5m
25220,1,Wizard,2724,258,6,4,10,60.0%,34m
25220,3,BOEUF,2724,133,4,3,7,57.1%,26m
25220,3,TTVLeTrac,2724,30,4,4,8,50.0%,23m
25220,1,Rayvord,2724,95,2,0,2,100.0%,16m
25220,1,DrAybolit,2724,121,2,1,3,66.7%,15m
25220,3,Malevih,2724,0,2,3,5,40.0%,41m
25220,1,Fiaker,2724,0,2,3,5,40.0%,2m
25220,1,SenshiPL,2724,116,2,4,6,33.3%,13m
25220,1,Infertility,2724,0,1,0,1,100.0%,1h
25220,1,StarKillers,2724,0,1,0,1,100.0%,11m
25220,1,TheFury,2724,0,1,0,1,100.0%,48m
25220,1,dolmat,2724,0,1,0,1,100.0%,12m
25220,3,ЗлойАрбуз,2724,30,1,1,2,50.0%,14m
25220,3,BrightLord,2724,0,1,4,5,20.0%,22m
25220,1,[IGMRS]XivS,2724,0,0,1,1,0.0%,33m
25220,3,[HenSqd]Alma,2724,0,0,1,1,0.0%,39m
25220,1,[LADD2]Beyraal,2724,0,0,1,1,0.0%,40m
25220,1,[Petrиs]Sammioswe,2724,0,0,2,2,0.0%,1h
25220,1,Bat,2724,0,0,2,2,0.0%,43m
25252,3,HagbergarN,2723,904,58,58,116,50.0%,29m
25252,3,GiaNnA,2723,480,20,25,45,44.4%,5m
25252,1,AciD,2723,456,17,15,32,53.1%,49m
25252,1,Jdawleer,2723,552,17,18,35,48.6%,44m
25252,1,Skroma,2723,347,16,2,18,88.9%,24m
25252,3,NitroZeus,2723,339,15,13,28,53.6%,5m
25252,2,Weresk,2723,41,11,14,25,44.0%,13m
25252,1,[CDS1]Deonid,2723,160,4,1,5,80.0%,27m
25252,2,[lZornG]Alien,2723,140,4,5,9,44.4%,46m
25252,2,[UwB]Brzost,2723,30,4,5,9,44.4%,16m
25252,3,[zhuds]gostik,2723,108,4,5,9,44.4%,7m
25252,1,Arkveeri,2723,150,4,8,12,33.3%,1h
25252,3,ClassicJoe,2723,0,3,1,4,75.0%,20m
25252,1,[DSCPRO]Normandy,2723,0,3,2,5,60.0%,2m
25252,2,Greed,2723,94,3,4,7,42.9%,30m
25252,3,dimanic,2723,91,3,4,7,42.9%,9m
25252,3,HafforS,2723,62,3,8,11,27.3%,12m
25252,1,eVo,2723,68,2,3,5,40.0%,1h
25252,1,Northerni,2723,0,2,3,5,40.0%,1h
25252,2,[Novi]Ice,2723,0,2,4,6,33.3%,30m
25252,1,[DМG]fisheR,2723,0,1,1,2,50.0%,49m
25252,1,[KLPA]ЯсноСолнышко,2723,38,1,3,4,25.0%,11m
25252,3,mars,2723,0,0,1,1,0.0%,30m
25252,1,Macio,2723,0,0,1,1,0.0%,43m
25252,3,HAMLET,2723,0,0,3,3,0.0%,29m
25277,3,[пепега]NuTZzz,2722,1512,128,129,257,49.8%,8m
25277,3,DADA,2722,1612,122,108,230,53.0%,18m
25277,1,[PowOw]SABCJayme,2722,1201,70,35,105,66.7%,1h
25277,3,AirwaveHD,2722,1155,52,44,96,54.2%,3m
25277,1,Sokół,2722,1238,44,43,87,50.6%,13m
25277,3,MegaCHINA,2722,394,37,32,69,53.6%,19m
25277,3,ZeroRaziel,2722,810,30,33,63,47.6%,14m
25277,3,BananKage,2722,531,28,19,47,59.6%,8m
25277,3,ClancyWiggum,2722,368,14,12,26,53.8%,6m
25277,2,[SuDm]Inthehouse,2722,118,4,4,8,50.0%,1h
25277,1,Dizzydi,2722,110,4,4,8,50.0%,12m
25277,1,Strypkeroz,2722,103,4,4,8,50.0%,39m
25277,1,Tiburtius,2722,121,4,5,9,44.4%,1h
25277,1,RoboCop,2722,88,3,3,6,50.0%,40m
25277,3,[турнир]рейнор,2722,128,3,4,7,42.9%,3m
25277,2,makhach,2722,0,3,4,7,42.9%,40m
25277,3,giovan,2722,132,3,6,9,33.3%,14m
25277,3,[xGUZx]AoX,2722,0,2,3,5,40.0%,46m
25277,1,Ripex,2722,30,2,5,7,28.6%,1h
25277,3,PsyCorez,2722,0,1,1,2,50.0%,5m
25277,1,[GiDra]Brodyga,2722,38,1,2,3,33.3%,30m
25277,1,MADCAT,2722,0,0,1,1,0.0%,33m
25277,3,Moriarty,2722,0,0,1,1,0.0%,6m
25277,1,[TNSR]Recuperate,2722,0,0,2,2,0.0%,7m
25301,1,MaxPower,2721,1676,90,84,174,51.7%,27m
25301,1,SOLDHER,2721,1428,50,52,102,49.0%,1h
25301,3,OutoOlio,2721,1266,46,50,96,47.9%,8m
25301,3,IbarutK,2721,368,25,27,52,48.1%,20m
25301,3,[1HUN6]Micsko,2721,688,25,29,54,46.3%,18m
25301,1,Bospano,2721,614,22,16,38,57.9%,40m
25301,3,InnerSanctum,2721,404,15,19,34,44.1%,29m
25301,1,AMT,2721,410,13,13,26,50.0%,1h
25301,2,ElfoBey,2721,302,12,12,24,50.0%,1h
25301,3,YouBig,2721,241,11,7,18,61.1%,21m
25301,3,jacklokki,2721,270,9,18,27,33.3%,13m
25301,3,ElFrancisco,2721,245,8,8,16,50.0%,19m
25301,3,Refsuion,2721,241,8,9,17,47.1%,15m
25301,1,Fog,2721,196,6,6,12,50.0%,21m
25301,1,Paukan,2721,193,5,8,13,38.5%,27m
25301,2,[AK47]HOH,2721,192,5,15,20,25.0%,14m
25301,1,[zfl]Eisaxt,2721,88,4,2,6,66.7%,7m
25301,1,[MaDn]Ranci,2721,48,4,6,10,40.0%,1h
25301,3,aboveall,2721,124,4,9,13,30.8%,2m
25301,1,Kurahk,2721,125,3,0,3,100.0%,33m
25301,1,user,2721,122,3,0,3,100.0%,14m
25301,3,areron,2721,0,2,3,5,40.0%,50m
25301,3,Yemzmey,2721,0,2,3,5,40.0%,41m
25301,1,EarlOfLemon,2721,0,1,0,1,100.0%,28m
25301,1,Razvy,2721,0,1,0,1,100.0%,11m
25301,1,maciej,2721,0,1,0,1,100.0%,23m
25301,1,smigool,2721,0,1,1,2,50.0%,33m
25301,2,Gethvk,2721,0,1,1,2,50.0%,1h
25301,1,Rezyez,2721,38,1,2,3,33.3%,1h
25301,1,Bobart,2721,40,1,2,3,33.3%,25m
25301,1,Kynikoi,2721,0,1,2,3,33.3%,40m
25301,2,darckdestroy,2721,0,1,2,3,33.3%,46m
25301,1,Flux,2721,0,0,1,1,0.0%,40m
25301,2,Daphne,2721,0,0,1,1,0.0%,1h
25301,1,Tientienne,2721,0,0,1,1,0.0%,45m
25301,1,GOOSE,2721,0,0,1,1,0.0%,1h
25301,1,Nekromant,2721,73,0,3,3,0.0%,4m
25338,2,[Ogz]Faramir,2720,1465,126,117,243,51.9%,11m
25338,1,clvb,2720,1197,93,80,173,53.8%,39m
25338,1,Zorgmouth,2720,1521,59,52,111,53.2%,1h
25338,1,[fam1ly]DANKE,2720,883,51,35,86,59.3%,8m
25338,1,[ZDI]NoughtEmotio,2720,1183,50,42,92,54.3%,1h
25338,1,Engeron,2720,1154,39,58,97,40.2%,19m
25338,2,Juda,2720,752,35,39,74,47.3%,6m
25338,1,AcidCraft,2720,739,32,21,53,60.4%,7m
25338,1,Rie,2720,526,32,32,64,50.0%,40m
25338,1,Crowd,2720,401,21,21,42,50.0%,7m
25338,1,Brabus,2720,596,20,21,41,48.8%,22m
25338,1,NTesla,2720,541,17,19,36,47.2%,11m
25338,2,Snaredrum,2720,474,15,29,44,34.1%,14m
25338,3,DrXanax,2720,310,12,14,26,46.2%,19m
25338,3,Agiro,2720,185,11,10,21,52.4%,21m
25338,3,[C405]Jespers,2720,286,10,11,21,47.6%,14m
25338,2,LoKi,2720,285,10,16,26,38.5%,8m
25338,3,PilouPilou,2720,274,10,17,27,37.0%,22m
25338,3,[McCh]EvilKnEmil,2720,181,9,10,19,47.4%,15m
25338,1,Felix,2720,250,7,7,14,50.0%,5m
25338,1,YellowMellow,2720,215,5,7,12,41.7%,28m
25338,1,Xerox,2720,152,4,4,8,50.0%,1h
25338,1,ANT,2720,72,3,2,5,60.0%,8m
25338,3,eXsul,2720,0,3,2,5,60.0%,1h
25338,1,[TBJAA]Lores,2720,122,3,7,10,30.0%,27m
25338,3,Mord,2720,0,2,3,5,40.0%,1h
25338,3,PozerT,2720,0,2,3,5,40.0%,33m
25338,3,aidaxxxoyt,2720,0,2,3,5,40.0%,9m
25338,1,[Arrows]terwen,2720,82,2,4,6,33.3%,25m
25338,1,Zamteg,2720,0,1,0,1,100.0%,11m
25338,1,[PowerG]MatexSK,2720,38,1,1,2,50.0%,12m
25338,3,Vegi,2720,0,0,2,2,0.0%,24m
25338,1,Kleio,2720,0,0,5,5,0.0%,48m
25371,3,Makina,2719,1461,129,118,247,52.2%,10m
25371,1,eEight,2719,1082,68,69,137,49.6%,44m
25371,1,Mainstream,2719,1621,62,50,112,55.4%,14m
25371,1,unity,2719,1201,48,34,82,58.5%,1h
25371,1,Arun,2719,327,34,15,49,69.4%,1h
25371,1,iiiiiiiiiiii,2719,884,30,38,68,44.1%,19m
25371,1,Sanya,2719,809,27,23,50,54.0%,48m
25371,1,[tagbag]georgi,2719,386,16,7,23,69.6%,25m
25371,1,Khazeo,2719,336,14,4,18,77.8%,44m
25371,3,GERG,2719,332,13,15,28,46.4%,11m
25371,1,Lumiel,2719,244,10,8,18,55.6%,12m
25371,1,testdetruc,2719,285,9,8,17,52.9%,1h
25371,1,VoRKo,2719,220,9,8,17,52.9%,30m
25371,1,DIXnCOX,2719,260,8,9,17,47.1%,1h
25371,3,[tCMB]elmolf,2719,202,8,12,20,40.0%,21m
25371,1,ArtiGro,2719,227,7,5,12,58.3%,1h
25371,1,[XVIIII]VoidRayRush,2719,200,6,7,13,46.2%,11m
25371,1,[CUM444]POPA,2719,167,5,1,6,83.3%,25m
25371,1,Loczek,2719,88,5,1,6,83.3%,8m
25371,1,[Pyrric]thejur,2719,196,5,9,14,35.7%,12m
25371,3,[InalPT]TaTaRinBsB,2719,97,3,3,6,50.0%,5m
25371,3,method,2719,97,3,3,6,50.0%,9m
25371,3,Конченный,2719,40,3,3,6,50.0%,1h
25371,1,BULKAZMASLEM,2719,124,3,5,8,37.5%,21m
25371,1,Darkarchon,2719,118,3,5,8,37.5%,1h
25371,1,VivaVilla,2719,120,2,1,3,66.7%,1h
25371,1,MicroondasR,2719,38,2,1,3,66.7%,21m
25371,2,Zero,2719,140,2,5,7,28.6%,12m
25371,1,FreezeTime,2719,84,2,6,8,25.0%,6m
25371,1,[Домик]карлсон,2719,0,1,0,1,100.0%,33m
25371,1,[KFy]tau,2719,0,1,2,3,33.3%,7m
25371,1,Thunder,2719,0,0,1,1,0.0%,1h
25371,1,Supchik,2719,0,0,1,1,0.0%,1h
25371,1,sooreen,2719,0,0,2,2,0.0%,29m
25405,3,Wiruzz,2718,438,52,52,104,50.0%,3m
25405,3,Artp,2718,1129,47,41,88,53.4%,3m
25405,1,Gurglios,2718,1027,42,32,74,56.8%,37m
25405,3,AmonRa,2718,614,34,38,72,47.2%,13m
25405,2,Cookie,2718,764,27,41,68,39.7%,21m
25405,1,Snaipaz,2718,370,25,12,37,67.6%,48m
25405,1,glomo,2718,547,21,14,35,60.0%,4m
25405,2,Vivarium,2718,462,20,18,38,52.6%,13m
25405,3,Лесник,2718,384,14,18,32,43.8%,18m
25405,3,[COSTV]Architect,2718,392,13,22,35,37.1%,18m
25405,3,kikko,2718,220,11,11,22,50.0%,11m
25405,1,PrettyFlacko,2718,173,10,3,13,76.9%,48m
25405,1,Dinosaur,2718,272,7,10,17,41.2%,1h
25405,3,Dinosaur,2718,217,6,6,12,50.0%,3m
25405,3,[aW]Maximus,2718,180,6,11,17,35.3%,6m
25405,2,[RTT]LeSerbe,2718,30,5,5,10,50.0%,15m
25405,1,dist,2718,190,5,8,13,38.5%,6m
25405,1,Аларак,2718,96,4,13,17,23.5%,8m
25405,3,[CGOW]Grimaldus,2718,0,3,2,5,60.0%,18m
25405,1,AlonIII,2718,88,3,3,6,50.0%,22m
25405,1,[HusoS]AnGr,2718,78,3,3,6,50.0%,49m
25405,3,WhyNot,2718,97,3,3,6,50.0%,4m
25405,1,[DICG]DregIron,2718,145,3,4,7,42.9%,1h
25405,3,Jules,2718,117,3,5,8,37.5%,11m
25405,2,Fluffy,2718,48,2,2,4,50.0%,1h
25405,3,[Glenn]GanjáBob,2718,0,2,3,5,40.0%,49m
25405,3,AVDutch,2718,0,2,3,5,40.0%,17m
25405,1,DNISHEebanoe,2718,36,2,3,5,40.0%,19m
25405,3,Google,2718,114,2,6,8,25.0%,22m
25405,2,[BeerDS]Gabbernator,2718,0,1,0,1,100.0%,1h
25405,1,[aDGa]inqisitorgfd,2718,0,1,0,1,100.0%,13m
25405,1,[obi1k]ASWD,2718,44,1,4,5,20.0%,1h
25405,1,[V1]Mania,2718,0,0,1,1,0.0%,25m
25405,1,Forius,2718,0,0,1,1,0.0%,31m
25405,1,БабаБулочник,2718,0,0,1,1,0.0%,19m
25405,3,Dismember,2718,0,0,1,1,0.0%,40m
25405,3,Angon,2718,0,0,1,1,0.0%,47m
25405,1,Darun,2718,0,0,4,4,0.0%,33m
25443,3,[BigBud]SkÛnK,2717,1454,195,185,380,51.3%,20m
25443,3,Sashenka,2717,1566,148,135,283,52.3%,16m
25443,2,Evpoc,2717,1207,103,114,217,47.5%,10m
25443,1,Brucewayn,2717,1411,102,80,182,56.0%,40m
25443,1,aeiu,2717,702,100,93,193,51.8%,14m
25443,1,Mateusz,2717,1143,45,41,86,52.3%,45m
25443,3,Ogosa,2717,990,40,36,76,52.6%,18m
25443,3,LeniwyProtos,2717,568,36,44,80,45.0%,2m
25443,1,kolle,2717,739,24,24,48,50.0%,44m
25443,1,Dionysus,2717,448,18,8,26,69.2%,34m
25443,3,Quixotical,2717,332,14,15,29,48.3%,18m
25443,3,StarDuck,2717,208,11,16,27,40.7%,4m
25443,2,VikinG,2717,201,8,5,13,61.5%,11m
25443,1,LostCrusader,2717,242,8,6,14,57.1%,1h
25443,1,[ValidG]DeathIsAwe,2717,228,7,4,11,63.6%,36m
25443,1,[X10D]arenaq,2717,121,6,4,10,60.0%,1h
25443,1,Semperfi,2717,0,4,1,5,80.0%,7m
25443,1,jack,2717,38,3,4,7,42.9%,7m
25443,1,[KD133]MeanMachine,2717,66,2,5,7,28.6%,19m
25443,2,vally,2717,0,1,0,1,100.0%,23m
25443,1,MagicProtoss,2717,0,1,0,1,100.0%,1h
25443,3,[RGV]vanja,2717,30,1,8,9,11.1%,20m
25443,3,MikeWheeler,2717,0,0,2,2,0.0%,1h
25443,3,alvin,2717,0,0,4,4,0.0%,17m
25467,1,Antichrist,2716,1409,144,126,270,53.3%,25m
25467,2,malaka,2716,1563,107,98,205,52.2%,6m
25467,3,Rhakhschasch,2716,1514,103,108,211,48.8%,2m
25467,1,Snappa,2716,1596,91,83,174,52.3%,22m
25467,1,Jonny,2716,1322,61,41,102,59.8%,39m
25467,1,Reinir,2716,924,35,31,66,53.0%,1h
25467,1,TechnoBoy,2716,585,29,12,41,70.7%,45m
25467,1,Wizard,2716,736,28,23,51,54.9%,7m
25467,1,long,2716,446,15,9,24,62.5%,1h
25467,1,DEbagger,2716,284,13,4,17,76.5%,11m
25467,1,jackistan,2716,367,11,8,19,57.9%,27m
25467,1,motoros,2716,330,10,8,18,55.6%,33m
25467,1,SkyWithStars,2716,186,8,7,15,53.3%,36m
25467,1,скорпион,2716,234,7,3,10,70.0%,1h
25467,1,[GrGr]Kumara,2716,250,7,8,15,46.7%,1h
25467,3,Jules,2716,166,7,8,15,46.7%,16m
25467,1,SinoX,2716,192,6,5,11,54.5%,1h
25467,1,Weteran,2716,229,6,9,15,40.0%,1h
25467,1,AlY,2716,120,4,7,11,36.4%,11m
25467,1,Somehy,2716,80,3,1,4,75.0%,11m
25467,1,Antimoine,2716,0,3,2,5,60.0%,48m
25467,3,[RavenZ]Aightball,2716,58,3,13,16,18.8%,11m
25467,3,Shiv,2716,0,2,3,5,40.0%,37m
25467,3,suxulus,2716,0,2,3,5,40.0%,26m
25467,3,GFDNEVERPOK,2716,0,2,3,5,40.0%,43m
25467,3,StormFang,2716,0,2,3,5,40.0%,33m
25467,1,xous,2716,0,2,3,5,40.0%,1h
25467,1,[INCNSS]HainKostebeK,2716,0,2,3,5,40.0%,1h
25467,1,bobby,2716,60,2,4,6,33.3%,44m
25467,3,[EXPANT]Bratta,2716,62,2,11,13,15.4%,6m
25467,1,everadrone,2716,0,1,0,1,100.0%,39m
25467,1,RoseRosfold,2716,38,1,2,3,33.3%,3m
25467,1,[Frоm]Silver,2716,42,1,3,4,25.0%,30m
25467,3,ubilskap,2716,92,1,5,6,16.7%,4m
25467,3,SINGULARITY,2716,30,1,8,9,11.1%,5m
25467,1,Hellboy,2716,0,0,1,1,0.0%,1h
25467,1,zmathe,2716,0,0,1,1,0.0%,8m
25467,1,Fatish,2716,0,0,1,1,0.0%,27m
25467,1,[NaNii]AloWarrior,2716,0,0,1,1,0.0%,18m
25467,1,[зерно]DREKRASHER,2716,0,0,1,1,0.0%,31m
25467,3,[SryPod]Стул,2716,0,0,1,1,0.0%,1h
25467,1,[xFDPx]Lympho,2716,0,0,1,1,0.0%,33m
25509,3,rekdgom,2715,1547,680,658,1338,50.8%,15m
25509,3,[BudBun]schmock,2715,1440,374,359,733,51.0%,20m
25509,3,RAUL,2715,1040,216,211,427,50.6%,29m
25509,1,ithilieth,2715,1733,210,192,402,52.2%,1h
25509,1,Irung,2715,1548,56,54,110,50.9%,23m
25509,3,GenghisKhan,2715,925,49,47,96,51.0%,12m
25509,3,Drayfus,2715,824,38,34,72,52.8%,2m
25509,1,Krummy,2715,890,34,26,60,56.7%,12m
25509,1,DGGRAF,2715,862,31,25,56,55.4%,39m
25509,3,Shaidy,2715,647,25,29,54,46.3%,11m
25509,1,[GAME33]СТАЛКЕР,2715,631,24,18,42,57.1%,25m
25509,3,[ZERG7V]MadBird,2715,447,20,14,34,58.8%,3m
25509,3,madsjl,2715,550,19,20,39,48.7%,18m
25509,1,xSadDevilx,2715,463,16,9,25,64.0%,3m
25509,1,Divaises,2715,463,15,10,25,60.0%,6m
25509,1,astra,2715,380,11,13,24,45.8%,18m
25509,2,Tarteaupomme,2715,195,10,9,19,52.6%,16m
25509,1,Samurai,2715,301,9,6,15,60.0%,21m
25509,1,Arsikul,2715,237,8,6,14,57.1%,1h
25509,2,StepsAhead,2715,200,7,13,20,35.0%,2m
25509,1,Akzsurtep,2715,224,6,7,13,46.2%,23m
25509,1,Elemei,2715,143,5,4,9,55.6%,13m
25509,1,[WWF]Wicked,2715,139,4,2,6,66.7%,27m
25509,1,Spiritoftime,2715,114,4,3,7,57.1%,44m
25509,3,Derpling,2715,94,3,4,7,42.9%,11m
25509,1,BoRnToKiLl,2715,0,2,3,5,40.0%,39m
25509,2,[GGZERG]Future,2715,30,2,16,18,11.1%,16m
25509,1,tom,2715,0,1,0,1,100.0%,43m
25509,1,CapitanOs,2715,0,1,0,1,100.0%,1h
25509,1,Husky,2715,0,1,1,2,50.0%,1h
25509,3,zlzsheep,2715,0,1,6,7,14.3%,20m
25509,1,BattleRap,2715,0,0,1,1,0.0%,3m
25509,1,Distruttore,2715,0,0,2,2,0.0%,47m
25542,3,MonsterHook,2714,1448,335,317,652,51.4%,3m
25542,3,Andryshok,2714,1614,178,176,354,50.3%,29m
25542,2,NyashMyash,2714,569,66,60,126,52.4%,15m
25542,2,Котофей,2714,1124,58,67,125,46.4%,21m
25542,2,Narh,2714,975,45,37,82,54.9%,11m
25542,3,[BloTi]KinderPingui,2714,691,42,44,86,48.8%,19m
25542,3,Max,2714,998,39,41,80,48.8%,18m
25542,1,Ripcord,2714,866,34,24,58,58.6%,24m
25542,2,BlankSpace,2714,940,33,47,80,41.2%,29m
25542,1,SunSinK,2714,632,19,20,39,48.7%,49m
25542,1,NapalMinFacE,2714,433,18,8,26,69.2%,45m
25542,3,Dimanche,2714,238,11,8,19,57.9%,21m
25542,1,Coheed,2714,320,10,12,22,45.5%,1h
25542,1,Somnorosu,2714,247,6,4,10,60.0%,1h
25542,1,LukePayne,2714,163,6,5,11,54.5%,1h
25542,1,kistix,2714,147,6,7,13,46.2%,1h
25542,1,[IG4]Masame,2714,223,6,11,17,35.3%,44m
25542,1,oma,2714,150,5,3,8,62.5%,40m
25542,1,Terrorkiks,2714,184,5,6,11,45.5%,1h
25542,1,Spree,2714,117,4,1,5,80.0%,36m
25542,1,Rockthat,2714,0,4,4,8,50.0%,29m
25542,1,Ekvovizm,2714,80,3,1,4,75.0%,22m
25542,3,[Chocen]Cronoss,2714,0,3,2,5,60.0%,33m
25542,1,Orik,2714,78,3,2,5,60.0%,24m
25542,3,fran,2714,0,3,4,7,42.9%,11m
25542,1,Lemangrace,2714,78,3,4,7,42.9%,49m
25542,1,Gaius,2714,40,2,0,2,100.0%,25m
25542,1,Emrys,2714,40,2,1,3,66.7%,14m
25542,1,Sharx,2714,0,2,3,5,40.0%,12m
25542,3,EldorasDogar,2714,0,2,3,5,40.0%,12m
25542,1,[XGKS]PeCoRiNa,2714,38,2,3,5,40.0%,48m
25542,1,DoNotLeave,2714,0,1,0,1,100.0%,1h
25542,1,Hexag,2714,0,1,1,2,50.0%,1h
25542,3,Ashenari,2714,32,1,2,3,33.3%,22m
25542,1,Gorfene,2714,0,0,1,1,0.0%,1h
25542,1,RicardoMilos,2714,0,0,1,1,0.0%,11m
25542,2,Mathew,2714,0,0,1,1,0.0%,30m
25542,1,Raus,2714,0,0,1,1,0.0%,1h
25580,3,SirMagic,2713,1535,181,167,348,52.0%,9m
25580,1,Pollock,2713,1726,146,125,271,53.9%,11m
25580,1,[BoEin]Teslon,2713,1742,96,88,184,52.2%,1h
25580,1,Hector,2713,1436,89,68,157,56.7%,22m
25580,3,stefanstev,2713,1576,83,79,162,51.2%,16m
25580,3,Greza,2713,1513,66,65,131,50.4%,6m
25580,1,Huguenciorg,2713,1027,41,32,73,56.2%,40m
25580,3,StanyslassZ,2713,1088,38,54,92,41.3%,2m
25580,1,[Specim]Konstaapeli,2713,544,32,19,51,62.7%,48m
25580,1,Wudycool,2713,871,31,24,55,56.4%,1h
25580,1,[YupAll]YoYo,2713,731,27,17,44,61.4%,1h
25580,1,[FearEU]darkmin,2713,533,20,16,36,55.6%,25m
25580,1,[TILTED]xlx,2713,638,20,20,40,50.0%,36m
25580,3,Magus,2713,470,20,24,44,45.5%,5m
25580,1,PORNOGRAFIA,2713,523,18,13,31,58.1%,28m
25580,1,Halbateur,2713,201,7,10,17,41.2%,12m
25580,3,[696]Jagatha,2713,146,5,8,13,38.5%,15m
25580,3,[WWTG]Desfigurel,2713,0,3,2,5,60.0%,41m
25580,3,lovemengmeng,2713,0,3,2,5,60.0%,1h
25580,1,Volteer,2713,78,3,3,6,50.0%,5m
25580,1,BlackAlert,2713,42,3,5,8,37.5%,18m
25580,3,Loki,2713,0,2,3,5,40.0%,20m
25580,3,ZDaneplaYZ,2713,0,2,3,5,40.0%,16m
25580,3,Tibix,2713,0,2,3,5,40.0%,20m
25580,1,Randemir,2713,76,2,5,7,28.6%,1h
25580,1,Sarge,2713,0,1,0,1,100.0%,1h
25580,1,[LforA]MrNikitoSSS,2713,0,1,1,2,50.0%,40m
25580,1,Greg,2713,0,1,1,2,50.0%,25m
25580,1,Mortek,2713,0,0,1,1,0.0%,31m
25580,1,Zechir,2713,0,0,1,1,0.0%,22m
25580,1,Fortnite,2713,0,0,1,1,0.0%,1h
25580,1,Беркумбаев,2713,0,0,1,1,0.0%,33m
25580,2,bucnasty,2713,0,0,2,2,0.0%,12m
25580,1,tomcox,2713,0,0,3,3,0.0%,4m
25614,2,Zam,2712,1647,298,309,607,49.1%,11m
25614,1,[SРID]KeDbIbI,2712,1489,76,56,132,57.6%,40m
25614,2,[TMK]Schwert,2712,679,35,45,80,43.8%,13m
25614,1,Narrok,2712,770,34,22,56,60.7%,31m
25614,1,jaguartordu,2712,786,33,24,57,57.9%,45m
25614,3,[PMMM]Ender,2712,832,32,29,61,52.5%,3m
25614,1,[SSC2]mszerg,2712,862,27,26,53,50.9%,18m
25614,1,[4Kngz]Achilles,2712,826,27,30,57,47.4%,1h
25614,3,VLM,2712,480,21,20,41,51.2%,5m
25614,1,kost,2712,517,18,21,39,46.2%,1h
25614,3,blacktbh,2712,415,17,13,30,56.7%,11m
25614,1,astana,2712,326,10,9,19,52.6%,7m
25614,1,[PIKMN]UnPrisoned,2712,256,9,3,12,75.0%,1h
25614,1,Equilibrium,2712,311,9,5,14,64.3%,43m
25614,3,[GTERZ]Blueberry,2712,236,8,13,21,38.1%,29m
25614,3,[4GT]hang,2712,195,6,5,11,54.5%,30m
25614,3,Сергей,2712,146,6,10,16,37.5%,16m
25614,3,Fyntik,2712,165,5,3,8,62.5%,20m
25614,3,[TAWT]Psix,2712,0,4,1,5,80.0%,1h
25614,1,[ShaK]PowerPit,2712,131,4,2,6,66.7%,40m
25614,1,[PH4L]Alex,2712,97,4,4,8,50.0%,40m
25614,1,MoNercy,2712,122,3,0,3,100.0%,33m
25614,3,Lilli,2712,0,3,2,5,60.0%,9m
25614,1,mezozou,2712,116,3,3,6,50.0%,7m
25614,1,FreeRealm,2712,108,3,5,8,37.5%,38m
25614,2,Crean,2712,95,2,3,5,40.0%,22m
25614,1,Drtigule,2712,0,2,3,5,40.0%,25m
25614,1,Ежик,2712,0,1,0,1,100.0%,1h
25614,1,Soda,2712,0,1,0,1,100.0%,3m
25614,1,MukolaUA,2712,0,1,1,2,50.0%,45m
25614,3,Humanalisk,2712,0,1,2,3,33.3%,29m
25614,3,Жопка,2712,34,1,5,6,16.7%,1h
25614,1,Aceray,2712,0,1,6,7,14.3%,30m
25614,1,Karakondjol,2712,0,0,2,2,0.0%,40m
25614,1,Кирилл,2712,0,0,2,2,0.0%,12m
25649,1,[FPJfF]Phantom,2711,600,62,64,126,49.2%,16m
25649,1,Ogrim,2711,1014,39,35,74,52.7%,22m
25649,3,AnilKeskin,2711,355,34,31,65,52.3%,12m
25649,1,Turdinson,2711,508,25,16,41,61.0%,8m
25649,3,Neil,2711,210,20,25,45,44.4%,16m
25649,1,Tonik,2711,494,19,17,36,52.8%,1h
25649,1,GoldFibre,2711,370,17,12,29,58.6%,1h
25649,1,Giuseppe,2711,538,17,21,38,44.7%,7m
25649,2,[tagNCT]bruit,2711,238,15,17,32,46.9%,7m
25649,1,Magrus,2711,369,10,9,19,52.6%,1h
25649,1,Rindor,2711,358,10,9,19,52.6%,1h
25649,3,Zerr,2711,270,10,18,28,35.7%,21m
25649,1,GhostMan,2711,208,7,5,12,58.3%,7m
25649,3,[N00I3]QuadDamage,2711,0,3,2,5,60.0%,30m
25649,1,Zedoom,2711,0,3,2,5,60.0%,40m
25649,3,breadfan,2711,97,3,3,6,50.0%,46m
25649,1,[HZeS]Deadanarchit,2711,38,2,0,2,100.0%,1h
25649,3,DavSko,2711,0,2,3,5,40.0%,1h
25649,3,CrazyDoctor,2711,0,2,3,5,40.0%,1h
25649,1,Erobe,2711,0,2,3,5,40.0%,40m
25649,1,Killer,2711,0,0,1,1,0.0%,1h
25649,3,Death,2711,0,0,1,1,0.0%,14m
25649,3,gasoline,2711,0,0,1,1,0.0%,15m
25649,1,[Comore]Devorame,2711,0,0,2,2,0.0%,1h
25649,3,lliat,2711,0,0,2,2,0.0%,6m
25674,2,poduluboq,2710,1481,254,249,503,50.5%,11m
25674,1,[xUfax]Rzhevsky,2710,1126,42,45,87,48.3%,34m
25674,3,Inxe,2710,800,29,33,62,46.8%,23m
25674,1,troll,2710,322,18,6,24,75.0%,45m
25674,3,Irry,2710,186,13,15,28,46.4%,21m
25674,1,ChakSobchak,2710,378,11,13,24,45.8%,1h
25674,2,blannti,2710,240,10,11,21,47.6%,5m
25674,1,[LEZZO]STERBEN,2710,338,9,12,21,42.9%,39m
25674,3,Fenixfallen,2710,88,6,6,12,50.0%,8m
25674,1,[RNBI]NijiMurk,2710,193,5,2,7,71.4%,43m
25674,1,Tagged,2710,234,5,4,9,55.6%,45m
25674,1,Rufi,2710,176,5,7,12,41.7%,1h
25674,3,lIlHaegenlII,2710,122,4,7,11,36.4%,14m
25674,3,Ted,2710,97,3,3,6,50.0%,15m
25674,3,HawK,2710,90,3,12,15,20.0%,4m
25674,1,Andrey,2710,122,2,1,3,66.7%,11m
25674,1,Tuxic,2710,40,2,3,5,40.0%,45m
25674,1,pelle,2710,0,2,3,5,40.0%,30m
25674,3,TMS,2710,0,2,3,5,40.0%,49m
25674,1,Эспумизан,2710,0,2,3,5,40.0%,40m
25674,1,Симпозиум,2710,0,2,3,5,40.0%,48m
25674,1,Granat,2710,0,1,0,1,100.0%,40m
25674,1,CINhd,2710,0,1,0,1,100.0%,1h
25674,1,tbd,2710,0,1,0,1,100.0%,28m
25674,2,[HZeS]VladShaman,2710,0,1,1,2,50.0%,45m
25674,3,Razar,2710,0,1,2,3,33.3%,47m
25674,1,Lelouch,2710,0,0,1,1,0.0%,3m
25674,1,[Фаталя]Daniillee,2710,0,0,1,1,0.0%,40m
25674,1,Gudzz,2710,0,0,2,2,0.0%,1h
25703,2,GOLDLEO,2709,1435,156,161,317,49.2%,8m
25703,1,Marko,2709,1360,120,123,243,49.4%,16m
25703,3,OCTOPUS,2709,1156,103,98,201,51.2%,14m
25703,1,DonPedro,2709,1510,100,68,168,59.5%,35m
25703,3,Lumis,2709,1518,80,88,168,47.6%,20m
25703,3,konik,2709,651,59,54,113,52.2%,6m
25703,2,thekiller,2709,1295,49,55,104,47.1%,5m
25703,3,asetabdr,2709,660,35,29,64,54.7%,12m
25703,1,[SAPIN]Mades,2709,940,35,31,66,53.0%,40m
25703,1,gre,2709,847,34,26,60,56.7%,25m
25703,3,Régis,2709,862,32,35,67,47.8%,16m
25703,1,UpRise,2709,784,27,23,50,54.0%,8m
25703,3,[LIQUID]Dobrij,2709,549,19,19,38,50.0%,5m
25703,1,Marauder,2709,240,13,7,20,65.0%,44m
25703,3,DefRagger,2709,302,10,19,29,34.5%,5m
25703,1,SweatyGroin,2709,333,9,9,18,50.0%,4m
25703,1,Lagerg,2709,128,6,6,12,50.0%,30m
25703,1,Losik,2709,76,3,4,7,42.9%,1h
25703,2,twentycm,2709,0,3,4,7,42.9%,40m
25703,2,Sergunt,2709,0,3,4,7,42.9%,22m
25703,1,[LES]snobz,2709,48,2,3,5,40.0%,17m
25703,3,Deck,2709,0,2,3,5,40.0%,22m
25703,1,meatly,2709,119,2,4,6,33.3%,25m
25703,1,ObIvan,2709,0,1,1,2,50.0%,36m
25703,1,[TIIR]DIkoSZ,2709,38,1,1,2,50.0%,8m
25703,1,REALTRAP,2709,40,1,3,4,25.0%,1h
25703,1,[BRSKR]VonRufiou,2709,0,1,4,5,20.0%,45m
25703,1,Dreamlock,2709,0,0,2,2,0.0%,7m
25703,2,malgat,2709,0,0,2,2,0.0%,45m
25703,1,[UTIL]Epsy,2709,0,0,3,3,0.0%,27m
25703,1,Sam,2709,0,0,3,3,0.0%,27m
25734,1,gremelin,2708,1711,133,122,255,52.2%,1h
25734,3,prometheus,2708,737,111,102,213,52.1%,15m
25734,1,Eevee,2708,1671,67,59,126,53.2%,16m
25734,1,PopaZealota,2708,1617,66,56,122,54.1%,13m
25734,1,[КПCC]sargas,2708,1006,43,36,79,54.4%,1h
25734,3,salemes,2708,682,35,37,72,48.6%,11m
25734,3,[HPBL]simonctnr,2708,765,32,29,61,52.5%,6m
25734,3,Alex,2708,596,20,27,47,42.6%,23m
25734,1,Macharius,2708,500,18,17,35,51.4%,37m
25734,1,Gambinok,2708,440,18,19,37,48.6%,20m
25734,1,Reiner,2708,455,13,16,29,44.8%,40m
25734,1,[ZERGSC]makosin,2708,254,11,10,21,52.4%,16m
25734,1,lii,2708,310,11,11,22,50.0%,8m
25734,2,wowa,2708,268,11,14,25,44.0%,18m
25734,2,Dune,2708,174,8,10,18,44.4%,10m
25734,1,RKsTORM,2708,191,6,7,13,46.2%,36m
25734,1,Syl,2708,160,5,4,9,55.6%,34m
25734,1,[Дуйте]Void,2708,174,5,5,10,50.0%,12m
25734,2,maksibi,2708,158,4,2,6,66.7%,1h
25734,3,BlokkerMC,2708,141,4,6,10,40.0%,23m
25734,3,jiji,2708,96,2,0,2,100.0%,7m
25734,1,Andrei,2708,93,2,0,2,100.0%,14m
25734,3,[ЗИБиАГ]GaNGsTaR,2708,0,2,3,5,40.0%,37m
25734,1,Redez,2708,0,2,3,5,40.0%,1h
25734,1,Nalsur,2708,0,2,3,5,40.0%,44m
25734,1,ZerNargxes,2708,110,2,5,7,28.6%,25m
25734,3,[GGasap]Drewin,2708,30,2,6,8,25.0%,7m
25734,1,Xillls,2708,40,1,2,3,33.3%,1h
25734,3,Drxgo,2708,0,0,1,1,0.0%,46m
25734,1,balamagur,2708,0,0,1,1,0.0%,1h
25734,1,[TAСО]Smile,2708,0,0,6,6,0.0%,40m
25765,1,[КПCC]Roman,2707,847,102,95,197,51.8%,1h
25765,1,Vitok,2707,1378,85,70,155,54.8%,40m
25765,1,Ouassif,2707,1350,57,46,103,55.3%,38m
25765,3,Roccat,2707,531,37,44,81,45.7%,21m
25765,1,mihai,2707,710,29,22,51,56.9%,1h
25765,3,beuman,2707,309,11,10,21,52.4%,14m
25765,1,DireWolf,2707,207,8,7,15,53.3%,11m
25765,1,iProctor,2707,270,8,9,17,47.1%,3m
25765,2,meech,2707,163,7,3,10,70.0%,46m
25765,3,Spaniard,2707,106,5,3,8,62.5%,2m
25765,1,КапитанБаян,2707,169,5,6,11,45.5%,8m
25765,2,[AхС]LockDown,2707,0,4,2,6,66.7%,39m
25765,1,Hasu,2707,110,4,4,8,50.0%,25m
25765,2,SoCiOpAt,2707,132,4,4,8,50.0%,50m
25765,1,salimama,2707,199,4,7,11,36.4%,33m
25765,3,[xDADEx]Prumos,2707,153,3,8,11,27.3%,12m
25765,1,iQNoX,2707,48,2,1,3,66.7%,1h
25765,1,[DR4ST1]myrhev,2707,0,2,3,5,40.0%,44m
25765,1,buka,2707,80,2,5,7,28.6%,12m
25765,3,[mfixed]komarzycho,2707,30,2,5,7,28.6%,29m
25765,1,Phenomene,2707,0,1,0,1,100.0%,45m
25765,1,Robert,2707,38,1,1,2,50.0%,3m
25765,1,Spesh,2707,0,1,1,2,50.0%,49m
25765,1,Destrack,2707,38,1,2,3,33.3%,12m
25765,1,Dodo,2707,0,1,4,5,20.0%,48m
25765,1,[N1TDA]Apceros,2707,0,0,1,1,0.0%,44m
25765,3,Лакрон,2707,0,0,1,1,0.0%,24m
25765,1,Lanttiks,2707,0,0,1,1,0.0%,1h
25765,1,Адамасто,2707,0,0,1,1,0.0%,25m
25765,1,[74RU]Sanches,2707,0,0,1,1,0.0%,43m
25795,1,cfrog,2706,1672,84,75,159,52.8%,7m
25795,1,BroilerBear,2706,870,44,38,82,53.7%,22m
25795,1,artemis,2706,686,37,33,70,52.9%,1h
25795,1,[BornG]Sioux,2706,961,34,37,71,47.9%,12m
25795,1,OpTiixVik,2706,395,19,7,26,73.1%,1h
25795,1,Gabri,2706,518,16,16,32,50.0%,40m
25795,1,Jurgiz,2706,439,16,22,38,42.1%,30m
25795,1,BaldCapDude,2706,336,14,7,21,66.7%,37m
25795,1,ТЕЛЕВИЗОР,2706,287,14,8,22,63.6%,25m
25795,1,[Айур]zix,2706,425,12,9,21,57.1%,8m
25795,1,ButPlug,2706,207,9,3,12,75.0%,43m
25795,1,[ЗЕRGТV]KOMARanezi,2706,289,8,5,13,61.5%,22m
25795,1,YLDOW,2706,245,7,11,18,38.9%,27m
25795,3,[AciNoN]Makentai,2706,83,6,14,20,30.0%,21m
25795,1,Garlic,2706,134,5,5,10,50.0%,1h
25795,1,[Iancu]Urshalak,2706,40,5,7,12,41.7%,19m
25795,1,[Trasch]Pico,2706,116,4,3,7,57.1%,14m
25795,1,RPL,2706,109,4,4,8,50.0%,31m
25795,1,StarkHU,2706,116,4,4,8,50.0%,34m
25795,1,Flamer,2706,138,3,2,5,60.0%,1h
25795,1,[DFgsA]Nokedli,2706,96,3,3,6,50.0%,1h
25795,1,Poulet,2706,145,3,6,9,33.3%,40m
25795,1,Kagayaga,2706,182,3,8,11,27.3%,25m
25795,2,mavo,2706,96,1,2,3,33.3%,26m
25795,1,rasul,2706,0,0,2,2,0.0%,43m
25820,3,hmm,2705,1538,118,75,193,61.1%,4m
25820,1,Najash,2705,1015,41,35,76,53.9%,1h
25820,3,Chromeo,2705,554,36,32,68,52.9%,19m
25820,1,JustNuts,2705,824,32,29,61,52.5%,1h
25820,3,Klotz,2705,643,25,28,53,47.2%,8m
25820,3,PeriZat,2705,436,20,16,36,55.6%,6m
25820,1,Realterm,2705,505,18,14,32,56.2%,1h
25820,3,dimakiller,2705,422,15,19,34,44.1%,8m
25820,1,Cicero,2705,403,13,13,26,50.0%,33m
25820,1,llllllllllll,2705,368,10,14,24,41.7%,41m
25820,3,tltlvr,2705,105,9,8,17,52.9%,20m
25820,1,Klaymer,2705,245,8,5,13,61.5%,22m
25820,1,lElO,2705,172,7,8,15,46.7%,21m
25820,3,Iscreamdeye,2705,144,5,11,16,31.2%,23m
25820,1,Pushkar,2705,0,4,1,5,80.0%,40m
25820,1,[hf4X4]GlitchMaster,2705,194,4,4,8,50.0%,35m
25820,1,Yush,2705,90,3,3,6,50.0%,31m
25820,2,Balageking,2705,0,3,4,7,42.9%,16m
25820,2,Sakul,2705,94,3,4,7,42.9%,40m
25820,1,Alligator,2705,36,2,2,4,50.0%,1h
25820,1,DarKLine,2705,0,2,4,6,33.3%,1h
25820,1,Asimo,2705,80,2,4,6,33.3%,41m
25820,1,bombaestrema,2705,0,1,1,2,50.0%,1h
25820,1,[pdrz]Massa,2705,40,1,1,2,50.0%,1h
25820,3,[GIVL]Igrok,2705,0,1,3,4,25.0%,16m
25820,3,Myn,2705,0,1,4,5,20.0%,1h
25820,1,Nemedin,2705,0,0,2,2,0.0%,40m
25820,1,Tosta,2705,0,0,4,4,0.0%,47m
25848,3,elga,2704,1423,130,122,252,51.6%,11m
25848,2,FIFTIMPACT,2704,1089,103,100,203,50.7%,7m
25848,3,[RBP3]KostoF,2704,1587,77,78,155,49.7%,5m
25848,3,Diego,2704,1292,60,54,114,52.6%,4m
25848,3,TarekVar,2704,1177,54,64,118,45.8%,13m
25848,3,QuelDorei,2704,1378,51,55,106,48.1%,10m
25848,1,Raidfish,2704,547,27,19,46,58.7%,28m
25848,1,Szwab,2704,671,25,16,41,61.0%,16m
25848,1,[HngKng]Boomer,2704,774,25,23,48,52.1%,16m
25848,1,KaCTeT,2704,323,17,8,25,68.0%,1h
25848,3,OBrother,2704,366,13,9,22,59.1%,5m
25848,1,zebreinhold,2704,460,13,18,31,41.9%,1h
25848,1,wotter,2704,361,11,9,20,55.0%,35m
25848,3,[Petrus]ZWAttitude,2704,275,11,13,24,45.8%,20m
25848,1,Tosh,2704,318,9,11,20,45.0%,1h
25848,2,DatSickKid,2704,157,6,5,11,54.5%,1h
25848,1,den,2704,112,4,4,8,50.0%,1h
25848,3,Freanki,2704,30,4,4,8,50.0%,23m
25848,1,SKORPION,2704,120,4,6,10,40.0%,16m
25848,3,Ooniki,2704,120,4,10,14,28.6%,4m
25848,2,RekKek,2704,100,4,15,19,21.1%,7m
25848,3,Grebgar,2704,40,3,4,7,42.9%,49m
25848,1,aquarius,2704,36,2,0,2,100.0%,41m
25848,3,muhadesi,2704,0,2,1,3,66.7%,16m
25848,1,Donyear,2704,0,2,3,5,40.0%,27m
25848,3,Lange,2704,0,2,3,5,40.0%,45m
25848,1,Ctracha,2704,0,1,0,1,100.0%,44m
25848,1,Холодный,2704,0,1,0,1,100.0%,5m
25848,1,jamiekins,2704,48,1,1,2,50.0%,16m
25848,1,Tanker,2704,0,1,1,2,50.0%,1h
25848,2,[SINEVA]CharlieScene,2704,46,1,2,3,33.3%,48m
25848,1,Gamma,2704,0,0,2,2,0.0%,25m
25880,3,Rage,2703,197,79,63,142,55.6%,15m
25880,2,[Pogo]Ecclebert,2703,641,55,63,118,46.6%,2m
25880,3,Киберкатлет,2703,786,32,31,63,50.8%,23m
25880,3,svinsane,2703,613,24,19,43,55.8%,8m
25880,3,Bersk,2703,694,24,31,55,43.6%,14m
25880,1,Sonello,2703,627,23,20,43,53.5%,49m
25880,1,Shango,2703,461,15,11,26,57.7%,11m
25880,1,[Koban]Shisui,2703,401,14,8,22,63.6%,1h
25880,3,Kostya,2703,376,14,22,36,38.9%,20m
25880,3,valiko,2703,289,10,11,21,47.6%,18m
25880,1,Civvic,2703,262,9,10,19,47.4%,31m
25880,1,TothyColonel,2703,163,7,6,13,53.8%,1h
25880,3,Xizor,2703,204,7,15,22,31.8%,4m
25880,1,DarkLotus,2703,175,6,1,7,85.7%,19m
25880,1,[DHlL]Maddix,2703,183,6,4,10,60.0%,49m
25880,3,Vishykc,2703,150,6,10,16,37.5%,16m
25880,1,[glhf20]yann,2703,180,5,2,7,71.4%,24m
25880,1,АНДРЕЙ,2703,164,5,5,10,50.0%,30m
25880,3,Capitano,2703,127,5,6,11,45.5%,23m
25880,2,[tkos]tobi,2703,0,4,2,6,66.7%,50m
25880,1,feelmywrath,2703,155,4,2,6,66.7%,33m
25880,2,PoorKnight,2703,141,4,5,9,44.4%,26m
25880,1,Moulepower,2703,156,4,8,12,33.3%,7m
25880,3,Viska,2703,67,4,11,15,26.7%,15m
25880,1,Cra,2703,137,3,2,5,60.0%,49m
25880,2,AZAROTH,2703,0,3,4,7,42.9%,18m
25880,1,[8D]Муромец,2703,40,2,1,3,66.7%,39m
25880,1,DENINIS,2703,0,2,3,5,40.0%,40m
25880,3,Olej,2703,0,2,3,5,40.0%,10m
25880,3,Hellein,2703,0,2,3,5,40.0%,20m
25880,1,[Zhig]grimhak,2703,0,1,0,1,100.0%,21m
25880,3,[УТочка]ProFixSon,2703,0,1,0,1,100.0%,4m
25880,3,[Catsu]BupSin,2703,0,1,2,3,33.3%,12m
25880,3,AMIAK,2703,0,0,2,2,0.0%,45m
25914,3,DEStreuer,2702,306,103,106,209,49.3%,21m
25914,3,warlords,2702,1542,102,92,194,52.6%,3m
25914,3,Ham,2702,893,50,49,99,50.5%,11m
25914,1,Lapsonen,2702,916,41,29,70,58.6%,22m
25914,1,[CОS]Ailas,2702,855,34,21,55,61.8%,13m
25914,1,Creamich,2702,967,32,49,81,39.5%,13m
25914,1,[YSRY]TerranTaran,2702,111,27,9,36,75.0%,12m
25914,1,Elijah,2702,454,21,9,30,70.0%,23m
25914,1,[Stilll]Andronic,2702,374,18,9,27,66.7%,13m
25914,1,cristiduh,2702,479,18,11,29,62.1%,1h
25914,1,LoH,2702,420,17,10,27,63.0%,1h
25914,1,PolishGamer,2702,367,15,7,22,68.2%,44m
25914,1,[Animе]Mrkvit,2702,352,12,13,25,48.0%,39m
25914,2,tommygun,2702,141,6,3,9,66.7%,24m
25914,1,cholis,2702,192,5,10,15,33.3%,1h
25914,1,GEDGES,2702,176,5,10,15,33.3%,37m
25914,1,bencik,2702,138,4,0,4,100.0%,20m
25914,3,Nivmix,2702,146,4,4,8,50.0%,9m
25914,1,Alexander,2702,110,4,5,9,44.4%,12m
25914,2,Julo,2702,94,3,4,7,42.9%,42m
25914,3,tomaster,2702,0,3,4,7,42.9%,10m
25914,2,Speedmaster,2702,46,3,5,8,37.5%,14m
25914,3,Jvz,2702,60,3,9,12,25.0%,22m
25914,1,[CОS]Jypsy,2702,91,2,0,2,100.0%,28m
25914,3,leionkat,2702,0,2,2,4,50.0%,12m
25914,3,niko,2702,0,2,3,5,40.0%,28m
25914,3,fortuna,2702,0,2,3,5,40.0%,10m
25914,1,valshmel,2702,0,1,0,1,100.0%,1h
25914,1,Tassadar,2702,0,1,2,3,33.3%,1h
25914,1,FaustasLTU,2702,38,1,2,3,33.3%,8m
25914,3,SimplePlaton,2702,0,1,3,4,25.0%,24m
25914,1,Ainkroin,2702,0,0,1,1,0.0%,1h
25914,1,[QR]Piotrel,2702,0,0,3,3,0.0%,4m
25914,3,Duts,2702,0,0,5,5,0.0%,23m
25948,1,TYLERZ,2701,1447,114,97,211,54.0%,23m
25948,1,proBeHeaVy,2701,1006,49,29,78,62.8%,8m
25948,1,LolLetto,2701,818,37,27,64,57.8%,22m
25948,3,Serre,2701,596,22,23,45,48.9%,14m
25948,3,Kolo,2701,610,21,30,51,41.2%,14m
25948,1,JuicyDumper,2701,526,20,18,38,52.6%,45m
25948,1,[Hird]NasiNøff,2701,411,16,8,24,66.7%,1h
25948,1,[roph]Manny,2701,534,16,17,33,48.5%,1h
25948,1,respect,2701,369,13,8,21,61.9%,24m
25948,1,ZerGash,2701,412,12,10,22,54.5%,1h
25948,1,KingBelay,2701,410,12,12,24,50.0%,1h
25948,3,Redskull,2701,324,12,13,25,48.0%,18m
25948,1,MLEET,2701,219,9,2,11,81.8%,1h
25948,3,[HTAED]Eichhörnchen,2701,252,9,9,18,50.0%,22m
25948,1,Killagedon,2701,244,8,4,12,66.7%,8m
25948,1,Zorg,2701,276,7,6,13,53.8%,1h
25948,1,[Büsi]Panis,2701,172,5,6,11,45.5%,1h
25948,1,Gaster,2701,0,4,1,5,80.0%,13m
25948,1,[NoSock]ThekEkest,2701,112,4,2,6,66.7%,49m
25948,1,MaxD,2701,94,3,2,5,60.0%,19m
25948,3,Thorin,2701,0,3,4,7,42.9%,4m
25948,1,tempest,2701,97,2,0,2,100.0%,18m
25948,3,klgeo,2701,0,2,3,5,40.0%,1h
25948,3,FleurdeLys,2701,0,2,3,5,40.0%,33m
25948,1,Alice,2701,0,2,3,5,40.0%,40m
25948,1,STAR,2701,76,2,4,6,33.3%,7m
25948,3,[LSPs]EiGzEiZeLL,2701,30,2,6,8,25.0%,14m
25948,1,[Hardgg]Kaliostro,2701,0,1,0,1,100.0%,27m
25948,1,[IIOGII]Sigfried,2701,73,1,1,2,50.0%,24m
25948,1,[XIIIII]Prochnist,2701,0,1,1,2,50.0%,23m
25948,1,[GLMT]Souv,2701,40,1,2,3,33.3%,12m
25948,1,Frees,2701,88,1,2,3,33.3%,19m
25948,1,MEGaboss,2701,0,0,1,1,0.0%,13m
25948,1,[FreeN]LiiE,2701,0,0,1,1,0.0%,22m
25948,1,ghoUst,2701,0,0,1,1,0.0%,22m
25948,3,albator,2701,0,0,1,1,0.0%,36m
25984,3,ARX,2700,1414,85,73,158,53.8%,21m
25984,1,[LFR]ataifa,2700,936,62,46,108,57.4%,39m
25984,3,rino,2700,1187,50,43,93,53.8%,7m
25984,3,Pluhamorec,2700,1057,41,40,81,50.6%,6m
25984,1,Flo,2700,445,39,27,66,59.1%,1h
25984,1,Olidamaru,2700,293,32,24,56,57.1%,7m
25984,3,Сибирь,2700,482,28,34,62,45.2%,21m
25984,3,Kelvan,2700,468,26,16,42,61.9%,4m
25984,1,Skynet,2700,322,16,12,28,57.1%,30m
25984,3,Carlos,2700,217,9,8,17,52.9%,21m
25984,1,[НH]Paradox,2700,161,5,3,8,62.5%,22m
25984,1,Moby,2700,76,3,2,5,60.0%,39m
25984,1,yoha,2700,90,3,3,6,50.0%,16m
25984,1,Immortan,2700,36,3,4,7,42.9%,37m
25984,1,mindozer,2700,106,3,5,8,37.5%,1h
25984,1,Esuges,2700,95,2,0,2,100.0%,16m
25984,3,SpikeyEye,2700,0,2,2,4,50.0%,32m
25984,3,[NINJ88]Ant,2700,0,2,3,5,40.0%,21m
25984,1,hukumka,2700,0,2,3,5,40.0%,22m
25984,1,[BIFFIG]fungahh,2700,109,2,6,8,25.0%,1h
25984,3,Caykus,2700,121,2,8,10,20.0%,5m
25984,1,[2021]ZHAMANBAY,2700,0,1,0,1,100.0%,9m
25984,3,Whata,2700,0,1,0,1,100.0%,22m
25984,1,Frostmir,2700,0,1,1,2,50.0%,11m
25984,1,Римуру,2700,0,1,2,3,33.3%,28m
25984,1,[NOOBpl]anderido,2700,0,0,1,1,0.0%,1h
26010,3,Rakanishyu,2699,1078,273,260,533,51.2%,29m
26010,3,russiaaa,2699,1561,152,141,293,51.9%,5m
26010,1,DonAndres,2699,1706,123,103,226,54.4%,43m
26010,3,Dobrinsky,2699,1422,123,117,240,51.2%,9m
26010,1,ReardenSteel,2699,1588,111,97,208,53.4%,22m
26010,1,HeadShot,2699,1627,109,104,213,51.2%,13m
26010,3,NGHTRDR,2699,1562,69,68,137,50.4%,6m
26010,1,Pedro,2699,990,49,36,85,57.6%,45m
26010,3,[GGRiP]Xenothorn,2699,896,45,45,90,50.0%,30m
26010,1,younger,2699,1151,42,35,77,54.5%,25m
26010,1,[ZHxPro]RobotWizard,2699,756,31,22,53,58.5%,24m
26010,1,[KARAL]ShareMagno,2699,692,24,20,44,54.5%,1h
26010,1,Mikhail,2699,557,22,17,39,56.4%,11m
26010,3,Жучарапрофи,2699,386,20,26,46,43.5%,24m
26010,1,Ousmoul,2699,528,16,17,33,48.5%,25m
26010,1,[EGcz]GenieCZ,2699,404,15,12,27,55.6%,1h
26010,1,Impact,2699,286,14,15,29,48.3%,37m
26010,1,Namor,2699,382,12,10,22,54.5%,1h
26010,1,MinaMax,2699,303,12,13,25,48.0%,1h
26010,3,Ting,2699,338,12,13,25,48.0%,13m
26010,1,димоооон,2699,374,11,8,19,57.9%,1h
26010,1,[FTMW]rondomedia,2699,335,10,7,17,58.8%,35m
26010,1,atilaTOR,2699,194,8,7,15,53.3%,1h
26010,2,qZAR,2699,140,6,3,9,66.7%,1h
26010,1,[CHUJE]ORZEL,2699,226,6,4,10,60.0%,1h
26010,2,Zaurito,2699,134,3,2,5,60.0%,25m
26010,1,Syky,2699,89,3,3,6,50.0%,25m
26010,1,IIIIIIIIIIII,2699,0,2,0,2,100.0%,1h
26010,2,qwert,2699,96,2,0,2,100.0%,1h
26010,1,Abzal,2699,104,2,1,3,66.7%,44m
26010,1,[An0nym]IlIlIIlIIlI,2699,42,2,2,4,50.0%,1h
26010,1,McLovin,2699,89,1,1,2,50.0%,1h
26010,1,jindavil,2699,38,1,3,4,25.0%,11m
26010,1,Hizashik,2699,0,0,1,1,0.0%,40m
26010,2,Zodiak,2699,0,0,2,2,0.0%,30m
26010,1,[TASBOY]DoC,2699,0,0,2,2,0.0%,34m
26010,1,[TaxiTT]FROL,2699,0,0,3,3,0.0%,3m
26047,1,alex,2698,1576,190,183,373,50.9%,1h
26047,1,[CocoCo]Ashloids,2698,1399,189,148,337,56.1%,1h
26047,3,Pretorian,2698,1619,189,185,374,50.5%,11m
26047,2,[CHOPAA]serega,2698,1514,129,127,256,50.4%,18m
26047,3,GENi,2698,1507,123,120,243,50.6%,9m
26047,1,mnsov,2698,1542,87,78,165,52.7%,1h
26047,1,MURA,2698,1663,83,77,160,51.9%,12m
26047,3,[glhf20]Socrates,2698,733,73,62,135,54.1%,9m
26047,1,Skye,2698,997,43,32,75,57.3%,1h
26047,3,Alpachino,2698,757,39,37,76,51.3%,20m
26047,1,[AngorA]Империй,2698,501,17,13,30,56.7%,1h
26047,1,alvaretet,2698,394,17,14,31,54.8%,3m
26047,1,mozenrad,2698,300,15,4,19,78.9%,39m
26047,1,RandomPlayer,2698,409,14,9,23,60.9%,1h
26047,1,Neo,2698,377,11,12,23,47.8%,24m
26047,1,[Pinyát]Lurch,2698,276,8,10,18,44.4%,27m
26047,1,Katilcho,2698,189,7,3,10,70.0%,25m
26047,2,TheLaw,2698,127,6,4,10,60.0%,30m
26047,1,Raijinshuu,2698,135,5,1,6,83.3%,44m
26047,1,Tit,2698,198,5,5,10,50.0%,12m
26047,1,veter,2698,155,4,1,5,80.0%,1h
26047,2,Swerziee,2698,0,3,4,7,42.9%,1h
26047,2,[NaNii]mouss,2698,117,3,5,8,37.5%,45m
26047,3,InVa,2698,62,3,9,12,25.0%,13m
26047,1,Utopia,2698,76,2,3,5,40.0%,45m
26047,1,[Nouset]Ivan,2698,78,2,3,5,40.0%,19m
26047,1,matrash,2698,0,2,3,5,40.0%,1h
26047,1,Supernovae,2698,0,2,3,5,40.0%,33m
26047,3,[FDA]Mist,2698,30,2,4,6,33.3%,12m
26047,1,Wiz,2698,0,1,0,1,100.0%,41m
26047,1,Currac,2698,0,1,1,2,50.0%,39m
26047,1,Індюк,2698,0,0,1,1,0.0%,7m
26047,1,soare,2698,0,0,2,2,0.0%,34m
26047,1,Rayburst,2698,0,0,4,4,0.0%,40m
26047,1,Wysiwyg,2698,0,0,10,10,0.0%,29m
26082,1,Ithaqua,2697,1690,207,189,396,52.3%,7m
26082,1,Wastland,2697,1643,179,173,352,50.9%,1h
26082,1,HRonik,2697,1710,178,178,356,50.0%,34m
26082,2,daveplanet,2697,1515,146,142,288,50.7%,6m
26082,3,RedBezerk,2697,1249,109,103,212,51.4%,23m
26082,3,Evarist,2697,1478,80,61,141,56.7%,14m
26082,3,mtmtkGO,2697,896,67,73,140,47.9%,5m
26082,3,Darkvedar,2697,862,66,71,137,48.2%,5m
26082,1,verwals,2697,918,65,53,118,55.1%,1h
26082,1,KalAzaar,2697,1401,60,50,110,54.5%,14m
26082,1,[BNest]Jedi,2697,1211,58,44,102,56.9%,8m
26082,2,DieScumDie,2697,377,48,56,104,46.2%,30m
26082,1,[GoTerr]QuirkyTurtle,2697,730,37,24,61,60.7%,1h
26082,1,[NetGG]ChernoAlpha,2697,653,35,19,54,64.8%,25m
26082,1,Rambo,2697,295,29,15,44,65.9%,21m
26082,1,RobKuz,2697,458,29,23,52,55.8%,1h
26082,1,[QTcIub]DarkPrelate,2697,420,19,9,28,67.9%,22m
26082,3,[TopEU]VUZE,2697,392,17,10,27,63.0%,15m
26082,1,Lapique,2697,398,15,9,24,62.5%,22m
26082,1,Stepbystep,2697,158,14,10,24,58.3%,26m
26082,1,Zevs,2697,330,10,14,24,41.7%,35m
26082,2,[ARM34]RvaTeLLL,2697,181,8,4,12,66.7%,39m
26082,1,Scar,2697,326,8,8,16,50.0%,1h
26082,1,tormentor,2697,231,6,5,11,54.5%,49m
26082,1,Hori,2697,197,5,2,7,71.4%,4m
26082,1,Silencerx,2697,154,5,4,9,55.6%,40m
26082,1,[Bähhh]Mothergreen,2697,104,5,6,11,45.5%,3m
26082,2,CANNONRUSH,2697,58,5,7,12,41.7%,7m
26082,1,[SAoN]SAK,2697,146,5,7,12,41.7%,1h
26082,1,enricbr,2697,196,5,7,12,41.7%,1h
26082,1,[WАSD]Kin,2697,88,4,6,10,40.0%,7m
26082,1,haidi,2697,160,4,7,11,36.4%,18m
26082,1,TitusMilo,2697,130,3,3,6,50.0%,8m
26082,1,Marcus,2697,0,3,5,8,37.5%,10m
26082,3,BLACK,2697,42,2,0,2,100.0%,28m
26082,1,vlad,2697,0,0,1,1,0.0%,8m
26082,1,Eaton,2697,0,0,1,1,0.0%,12m
26082,2,charzety,2697,0,0,3,3,0.0%,25m
26082,1,[darkex]Urs,2697,0,0,3,3,0.0%,44m
26121,1,Phaivy,2696,1703,329,321,650,50.6%,12m
26121,3,[Эщкер]deeen,2696,1542,216,196,412,52.4%,20m
26121,1,mamakasame,2696,1588,82,70,152,53.9%,22m
26121,3,Alabama,2696,1125,69,53,122,56.6%,23m
26121,3,anominos,2696,780,29,31,60,48.3%,23m
26121,1,Anvarsky,2696,670,25,24,49,51.0%,16m
26121,3,AldarsKose,2696,316,23,18,41,56.1%,22m
26121,1,[TExGG]ICHNICHTS,2696,388,18,6,24,75.0%,1h
26121,1,KomboXak,2696,464,18,19,37,48.6%,14m
26121,1,[PiGPan]Conzy,2696,353,16,9,25,64.0%,3m
26121,3,ShepUsaD,2696,388,15,20,35,42.9%,12m
26121,1,Calbe,2696,498,14,18,32,43.8%,21m
26121,1,HiTFoRTime,2696,401,13,10,23,56.5%,16m
26121,2,HattedFriend,2696,310,12,14,26,46.2%,10m
26121,1,Daniilpro,2696,316,10,8,18,55.6%,22m
26121,1,YoureDanfo,2696,254,9,8,17,52.9%,1h
26121,3,Automaton,2696,269,9,13,22,40.9%,21m
26121,3,tyz,2696,254,8,12,20,40.0%,5m
26121,1,[Z3RGTV]Likan,2696,140,6,0,6,100.0%,45m
26121,1,Spambot,2696,185,6,6,12,50.0%,40m
26121,2,MysticJelly,2696,178,6,6,12,50.0%,1h
26121,1,AWUTSCHKA,2696,138,5,4,9,55.6%,25m
26121,1,CunningStunt,2696,156,5,5,10,50.0%,44m
26121,1,Artem,2696,187,4,3,7,57.1%,18m
26121,1,[21377]Mojito,2696,192,4,5,9,44.4%,26m
26121,1,GeneralFrost,2696,84,3,4,7,42.9%,16m
26121,1,CoronaTime,2696,122,3,4,7,42.9%,26m
26121,3,CaptainD,2696,62,3,5,8,37.5%,20m
26121,3,iweasel,2696,30,3,7,10,30.0%,9m
26121,1,Dendé,2696,89,2,0,2,100.0%,16m
26121,1,caspo,2696,0,2,3,5,40.0%,1h
26121,1,Necrid,2696,74,2,3,5,40.0%,44m
26121,1,Dragon,2696,32,2,4,6,33.3%,8m
26121,2,SHYTBIRD,2696,0,2,5,7,28.6%,1h
26121,1,Kingslayer,2696,0,1,0,1,100.0%,1h
26121,1,GameOver,2696,90,1,1,2,50.0%,8m
26121,3,NexuzXalo,2696,0,1,2,3,33.3%,30m
26121,2,ведьма,2696,0,1,2,3,33.3%,1h
26121,3,Yank,2696,0,1,6,7,14.3%,14m
26121,1,VeganBurrito,2696,0,0,1,1,0.0%,19m
26121,3,TheDeadDodo,2696,0,0,1,1,0.0%,32m
26121,1,LEWAK,2696,0,0,2,2,0.0%,33m
26121,2,Alexey,2696,0,0,2,2,0.0%,1h
26121,1,Artifem,2696,0,0,3,3,0.0%,22m
26165,1,superNinja,2695,1208,108,100,208,51.9%,16m
26165,2,pain,2695,1516,80,78,158,50.6%,21m
26165,1,[Kompis]KYN,2695,1664,76,76,152,50.0%,1h
26165,3,patapuf,2695,1272,66,79,145,45.5%,22m
26165,1,Bajula,2695,1570,63,61,124,50.8%,4m
26165,2,kanrenjiudui,2695,425,29,38,67,43.3%,14m
26165,1,[IVöVI]MAXHE,2695,700,22,23,45,48.9%,44m
26165,1,KazaK,2695,370,17,13,30,56.7%,1h
26165,1,Pissmypantsu,2695,418,16,16,32,50.0%,12m
26165,3,Ninja,2695,468,16,21,37,43.2%,12m
26165,1,freza,2695,476,15,15,30,50.0%,16m
26165,1,KingCrash,2695,248,14,7,21,66.7%,25m
26165,3,Banderlog,2695,244,11,10,21,52.4%,28m
26165,1,Defeat,2695,255,9,8,17,52.9%,35m
26165,3,LOTIVUK,2695,146,8,9,17,47.1%,16m
26165,1,Caprio,2695,64,6,3,9,66.7%,1h
26165,1,Div,2695,152,6,5,11,54.5%,25m
26165,1,Hellbringer,2695,114,5,7,12,41.7%,47m
26165,1,[HsZ]Weasly,2695,158,4,4,8,50.0%,12m
26165,2,Fumin,2695,88,4,5,9,44.4%,6m
26165,2,tte,2695,0,3,3,6,50.0%,1h
26165,3,Mumenrider,2695,0,3,4,7,42.9%,23m
26165,1,TygrNaStrome,2695,36,2,1,3,66.7%,7m
26165,1,[Molot]Мандаринка,2695,64,2,3,5,40.0%,8m
26165,1,[AMG42]Bronzie,2695,0,1,1,2,50.0%,1h
26165,3,ROKKI,2695,0,1,2,3,33.3%,29m
26165,1,Finaldav,2695,38,1,2,3,33.3%,45m
26165,1,PandA,2695,0,0,1,1,0.0%,1h
26193,3,[usbr]Broformist,2694,1464,168,156,324,51.9%,13m
26193,3,PSYCHO,2694,1364,153,149,302,50.7%,23m
26193,2,nightwolf,2694,1290,110,101,211,52.1%,20m
26193,2,[DNGs]Frontela,2694,1526,107,103,210,51.0%,21m
26193,2,Jestii,2694,1276,79,85,164,48.2%,8m
26193,1,Phoenixgold,2694,592,63,48,111,56.8%,1h
26193,3,Vyrus,2694,1232,55,57,112,49.1%,12m
26193,3,Juster,2694,886,39,39,78,50.0%,3m
26193,1,Skaraotzky,2694,697,33,25,58,56.9%,38m
26193,1,[1ndica]elZablo,2694,758,27,27,54,50.0%,38m
26193,1,[3ЕRGTV]Lakker,2694,281,21,14,35,60.0%,41m
26193,3,[LBZ]ElAhui,2694,345,15,20,35,42.9%,5m
26193,3,Gix,2694,393,14,15,29,48.3%,7m
26193,1,Solomon,2694,213,12,9,21,57.1%,1h
26193,1,[MOFFO]TheOne,2694,415,12,10,22,54.5%,1h
26193,3,LANDRAIDER,2694,367,12,13,25,48.0%,3m
26193,1,Jdem,2694,319,10,9,19,52.6%,1h
26193,1,Losh,2694,188,7,7,14,50.0%,44m
26193,1,SpyglassTF,2694,184,6,5,11,54.5%,25m
26193,1,[tDKe]NeON,2694,218,6,9,15,40.0%,25m
26193,2,Radesch,2694,88,6,9,15,40.0%,8m
26193,2,[Высший]mfert,2694,30,4,5,9,44.4%,16m
26193,3,[SUCELA]DMCE,2694,0,3,3,6,50.0%,3m
26193,1,MAKC,2694,72,3,3,6,50.0%,1h
26193,2,HerDaNoR,2694,96,3,4,7,42.9%,38m
26193,1,[THANOS]Sokol,2694,104,2,1,3,66.7%,1h
26193,1,Atheoss,2694,0,2,3,5,40.0%,1h
26193,3,Ghoul,2694,0,2,3,5,40.0%,1h
26193,3,[Gones]blouclette,2694,0,2,3,5,40.0%,22m
26193,3,hakaki,2694,30,2,4,6,33.3%,7m
26193,1,QuickBen,2694,72,2,7,9,22.2%,48m
26193,1,potap,2694,0,1,0,1,100.0%,33m
26193,1,TheQuaine,2694,0,1,1,2,50.0%,44m
26193,3,Setebos,2694,0,1,1,2,50.0%,50m
26193,1,mrs,2694,0,0,1,1,0.0%,31m
26193,1,Nebula,2694,0,0,3,3,0.0%,13m
26193,1,desctres,2694,0,0,4,4,0.0%,30m
26230,1,ianjoan,2693,1484,159,171,330,48.2%,8m
26230,3,Cowchon,2693,730,62,61,123,50.4%,12m
26230,1,SatoriKomeji,2693,1288,50,42,92,54.3%,35m
26230,1,Tarjan,2693,859,43,35,78,55.1%,40m
26230,3,SpaceKees,2693,1074,41,43,84,48.8%,21m
26230,1,[TMART]Poki,2693,872,36,29,65,55.4%,49m
26230,1,[Rаy]Небосвод,2693,478,21,12,33,63.6%,38m
26230,2,VeroOk,2693,491,19,23,42,45.2%,9m
26230,1,Trickster,2693,378,18,7,25,72.0%,1h
26230,1,Pbhuh,2693,488,15,14,29,51.7%,33m
26230,2,DeSmall,2693,376,12,25,37,32.4%,7m
26230,1,Winds,2693,209,10,13,23,43.5%,26m
26230,3,CheeseOne,2693,224,8,6,14,57.1%,23m
26230,3,[Jiggel]Rocco,2693,271,8,10,18,44.4%,21m
26230,3,ROFLKemPer,2693,145,6,8,14,42.9%,7m
26230,1,SpiraleTribe,2693,169,5,2,7,71.4%,1h
26230,3,farid,2693,138,4,4,8,50.0%,20m
26230,1,LiJaJu,2693,119,4,4,8,50.0%,22m
26230,2,Nox,2693,111,4,5,9,44.4%,21m
26230,1,Durzo,2693,123,3,1,4,75.0%,1h
26230,3,Valtharon,2693,0,3,4,7,42.9%,2m
26230,2,Lover,2693,138,2,3,5,40.0%,42m
26230,3,[warmup]SchlachTi,2693,0,2,3,5,40.0%,1h
26230,1,Dimasick,2693,0,1,0,1,100.0%,21m
26230,1,kickmen,2693,38,1,2,3,33.3%,19m
26230,1,Crom,2693,0,0,1,1,0.0%,13m
26230,1,amondo,2693,0,0,1,1,0.0%,12m
26230,1,CptClaw,2693,0,0,1,1,0.0%,11m
26230,1,Soulery,2693,0,0,3,3,0.0%,1h
26230,1,soldier,2693,0,0,4,4,0.0%,14m
26260,1,MichalPek,2692,1658,126,104,230,54.8%,1h
26260,3,Speleo,2692,1428,107,101,208,51.4%,30m
26260,3,SkewTheWise,2692,1260,94,63,157,59.9%,18m
26260,1,honzaarr,2692,849,75,56,131,57.3%,9m
26260,3,Patates,2692,857,40,27,67,59.7%,18m
26260,1,Craig,2692,911,34,31,65,52.3%,33m
26260,3,Jimmy,2692,672,27,36,63,42.9%,29m
26260,1,dona,2692,607,22,20,42,52.4%,41m
26260,3,IIIIIIIIIII,2692,397,21,25,46,45.7%,21m
26260,1,ApoK,2692,368,16,10,26,61.5%,11m
26260,3,RAVƷN,2692,434,16,17,33,48.5%,8m
26260,1,MrGB,2692,423,14,10,24,58.3%,12m
26260,1,[Щитон]Solpik,2692,370,11,8,19,57.9%,1h
26260,3,Waagh,2692,264,11,12,23,47.8%,24m
26260,1,Omnislash,2692,320,10,7,17,58.8%,37m
26260,3,yoshe,2692,263,10,10,20,50.0%,21m
26260,1,Kolesman,2692,227,8,3,11,72.7%,40m
26260,3,Ronz,2692,232,8,14,22,36.4%,23m
26260,3,apo,2692,150,6,13,19,31.6%,11m
26260,1,[oAOPo]Reblochon,2692,118,4,6,10,40.0%,44m
26260,3,Bixo,2692,30,2,6,8,25.0%,22m
26260,3,Will,2692,0,1,0,1,100.0%,40m
26260,2,RavinBailiff,2692,0,1,0,1,100.0%,27m
26260,1,[N0oBS]Sjefen,2692,34,1,7,8,12.5%,38m
26260,1,[1DELTA]echtlol,2692,0,0,2,2,0.0%,1h
26260,1,[thEnd]DeadEnd,2692,0,0,3,3,0.0%,34m
26260,3,[UNSKLD]Schimmelpit,2692,0,0,5,5,0.0%,18m
26287,3,raiko,2691,1412,152,155,307,49.5%,14m
26287,2,Nevermore,2691,1559,106,101,207,51.2%,11m
26287,3,deomitri,2691,1048,67,54,121,55.4%,7m
26287,3,Blümchen,2691,562,61,48,109,56.0%,23m
26287,1,Schluechti,2691,1518,59,60,119,49.6%,1h
26287,2,Jekan,2691,316,50,52,102,49.0%,11m
26287,3,Dyumedes,2691,1001,40,37,77,51.9%,11m
26287,1,Тайкус,2691,711,38,39,77,49.4%,33m
26287,3,FrozenLord,2691,728,29,23,52,55.8%,17m
26287,1,People,2691,627,27,17,44,61.4%,22m
26287,1,Snowmen,2691,530,21,19,40,52.5%,40m
26287,3,[NGEGNE]PsychoPlow,2691,572,19,24,43,44.2%,5m
26287,1,CalvinHarass,2691,317,14,9,23,60.9%,16m
26287,1,Harlekin,2691,245,11,5,16,68.8%,40m
26287,2,[ATSEV]blux,2691,312,11,25,36,30.6%,6m
26287,1,Marcus,2691,216,10,2,12,83.3%,49m
26287,1,[SCGTR]Ghost,2691,320,9,8,17,52.9%,37m
26287,1,vdoleg,2691,214,7,12,19,36.8%,11m
26287,1,tilapin,2691,211,6,4,10,60.0%,7m
26287,3,[GGHV]palec,2691,62,6,6,12,50.0%,6m
26287,1,[Peeps]RickyTheDoom,2691,179,5,3,8,62.5%,34m
26287,1,FOTONнеимба,2691,107,5,4,9,55.6%,33m
26287,2,Nagato,2691,114,5,7,12,41.7%,18m
26287,2,Mawgly,2691,90,5,19,24,20.8%,30m
26287,3,Killerfridge,2691,139,3,2,5,60.0%,1h
26287,2,Nudelsuppe,2691,116,3,5,8,37.5%,39m
26287,1,Neldar,2691,38,2,2,4,50.0%,1h
26287,3,eligorkoson,2691,0,2,3,5,40.0%,17m
26287,1,Chainsaw,2691,0,2,3,5,40.0%,1h
26287,1,Szajkop,2691,0,2,3,5,40.0%,9m
26287,1,Robert,2691,0,2,3,5,40.0%,25m
26287,3,obeyyomaster,2691,97,2,4,6,33.3%,17m
26287,1,[xMSFx]ClumsyKorean,2691,82,2,4,6,33.3%,1h
26287,3,[FLDI]Sitixallion,2691,0,1,0,1,100.0%,1h
26287,1,MaxiKing,2691,88,1,1,2,50.0%,9m
26287,1,[WAEH]reign,2691,89,1,1,2,50.0%,49m
26287,1,[Stärke]jololol,2691,95,1,1,2,50.0%,3m
26287,1,stepaXgg,2691,0,1,4,5,20.0%,3m
26287,1,[Roq4t]BeerAndVodka,2691,0,1,4,5,20.0%,39m
26287,1,Mazeltoff,2691,0,1,4,5,20.0%,27m
26287,1,Enot,2691,0,0,2,2,0.0%,22m
26328,1,xvtee,2690,1159,131,124,255,51.4%,30m
26328,3,Harmode,2690,1344,127,123,250,50.8%,8m
26328,1,WelcomtoHell,2690,1637,87,82,169,51.5%,1h
26328,1,Mercury,2690,1419,57,54,111,51.4%,20m
26328,1,Loiron,2690,743,39,39,78,50.0%,14m
26328,1,firenest,2690,460,24,19,43,55.8%,13m
26328,1,[tytka]BartekPros,2690,471,15,12,27,55.6%,28m
26328,3,Melkor,2690,365,14,13,27,51.9%,7m
26328,1,Billio,2690,316,10,7,17,58.8%,1h
26328,1,[Floopy]Gezer,2690,302,9,9,18,50.0%,17m
26328,1,xkanecx,2690,318,9,13,22,40.9%,48m
26328,1,wqq,2690,320,9,13,22,40.9%,22m
26328,3,Clerk,2690,260,8,13,21,38.1%,4m
26328,1,Xaserstxr,2690,210,7,8,15,46.7%,25m
26328,3,Andre,2690,174,7,12,19,36.8%,12m
26328,1,DiNaMiTe,2690,160,5,6,11,45.5%,31m
26328,1,febryd,2690,102,4,4,8,50.0%,1h
26328,3,[WvsG]jkoFortyTwo,2690,142,3,1,4,75.0%,15m
26328,3,[TTGL]KingofWeebs,2690,0,3,2,5,60.0%,21m
26328,1,olegthunder,2690,76,3,3,6,50.0%,27m
26328,1,Haldahir,2690,93,3,4,7,42.9%,22m
26328,1,Vlad,2690,78,3,4,7,42.9%,27m
26328,2,Lfa,2690,46,2,1,3,66.7%,46m
26328,1,Disea,2690,0,2,3,5,40.0%,14m
26328,1,Chauncey,2690,72,2,3,5,40.0%,1h
26328,2,Баклажан,2690,0,2,3,5,40.0%,1h
26328,3,Vichotom,2690,0,2,3,5,40.0%,17m
26328,1,[šķūnī]napalmEye,2690,0,1,0,1,100.0%,8m
26328,1,[JaPP]MorozlOX,2690,0,1,0,1,100.0%,28m
26328,3,legendman,2690,0,1,1,2,50.0%,1h
26328,1,[THYRUS]Ludo,2690,34,1,3,4,25.0%,49m
26328,1,jamislamb,2690,0,1,4,5,20.0%,31m
26328,1,OGkush,2690,38,1,7,8,12.5%,28m
26328,1,Weedo,2690,0,0,1,1,0.0%,22m
26328,3,Rugor,2690,0,0,1,1,0.0%,18m
26328,1,[BELING]BrIMoN,2690,0,0,1,1,0.0%,25m
26364,3,Amen,2689,1464,225,203,428,52.6%,4m
26364,1,Ronaldo,2689,1728,203,200,403,50.4%,12m
26364,1,[pushik]kgbkradetsy,2689,1666,131,118,249,52.6%,1h
26364,1,benizakura,2689,1471,113,109,222,50.9%,9m
26364,1,[Dae]Overkill,2689,1244,109,103,212,51.4%,1h
26364,1,[5BC]ZloyTomas,2689,1523,102,90,192,53.1%,14m
26364,1,wztvm,2689,1662,77,67,144,53.5%,40m
26364,1,Bob,2689,755,36,31,67,53.7%,16m
26364,1,Wicket,2689,447,31,21,52,59.6%,1h
26364,1,waltraud,2689,737,30,25,55,54.5%,25m
26364,1,[7I0]Cheesus,2689,658,27,27,54,50.0%,39m
26364,1,[AzraT]Emporio,2689,335,22,17,39,56.4%,16m
26364,2,LoSTaR,2689,388,17,16,33,51.5%,6m
26364,1,McBroody,2689,314,11,8,19,57.9%,38m
26364,1,fucboinugget,2689,310,11,10,21,52.4%,1h
26364,1,Timingsleet,2689,262,9,5,14,64.3%,33m
26364,1,robo,2689,298,9,10,19,47.4%,17m
26364,1,[BWArmy]FreeMmrGiver,2689,228,8,4,12,66.7%,33m
26364,3,[FCxAKW]sfoster,2689,184,6,16,22,27.3%,18m
26364,3,[ICE5]Seligman,2689,131,5,2,7,71.4%,22m
26364,1,Speederlight,2689,134,5,5,10,50.0%,49m
26364,1,Skyler,2689,196,5,10,15,33.3%,44m
26364,2,СаскеАУчиха,2689,0,3,4,7,42.9%,50m
26364,3,DanTan,2689,97,2,0,2,100.0%,1h
26364,1,[AnGaSt]MacZeal,2689,0,2,3,5,40.0%,1h
26364,1,Ætherel,2689,0,2,3,5,40.0%,9m
26364,1,Insane,2689,88,1,1,2,50.0%,34m
26364,1,coco,2689,88,1,1,2,50.0%,39m
26364,1,[PLA2N]LuckyFox,2689,38,1,2,3,33.3%,33m
26364,1,Сталин,2689,0,1,2,3,33.3%,1h
26364,1,butthole,2689,0,1,4,5,20.0%,25m
26364,2,Buryak,2689,0,0,1,1,0.0%,40m
26364,3,[INTROW]Kiznaiver,2689,0,0,1,1,0.0%,21m
26364,1,Yashu,2689,0,0,2,2,0.0%,1h
26364,1,BadPanda,2689,0,0,4,4,0.0%,22m
26364,1,[TTSKY]PercHeval,2689,0,0,5,5,0.0%,1h
26400,3,GhostICE,2688,1620,422,412,834,50.6%,12m
26400,3,AdiumY,2688,1547,188,181,369,50.9%,15m
26400,3,Fugger,2688,1564,124,111,235,52.8%,22m
26400,1,kyrtishman,2688,1630,77,72,149,51.7%,9m
26400,1,Jerome,2688,1051,53,50,103,51.5%,1h
26400,1,kiritoasina,2688,962,39,28,67,58.2%,24m
26400,1,DoctorVenom,2688,734,27,25,52,51.9%,22m
26400,3,rekrut,2688,476,25,23,48,52.1%,24m
26400,1,[WRAON]BlobBob,2688,491,20,18,38,52.6%,1h
26400,1,UniMatriX,2688,420,17,14,31,54.8%,1h
26400,3,ORBpoukah,2688,490,17,25,42,40.5%,29m
26400,1,JebuduBam,2688,441,13,12,25,52.0%,20m
26400,1,[Ar4ont]ItsPENGUIN,2688,214,12,5,17,70.6%,19m
26400,1,DERF,2688,350,11,10,21,52.4%,40m
26400,3,северянин,2688,312,11,17,28,39.3%,15m
26400,1,[THR]kaetano,2688,252,8,5,13,61.5%,1h
26400,1,imumi,2688,228,8,9,17,47.1%,1h
26400,2,Natrocore,2688,218,7,15,22,31.8%,12m
26400,3,Goldek,2688,121,5,2,7,71.4%,1h
26400,1,Andsmv,2688,170,5,7,12,41.7%,49m
26400,1,JustGo,2688,54,4,3,7,57.1%,1h
26400,1,dgo,2688,0,3,2,5,60.0%,13m
26400,1,EnchanterIO,2688,61,3,3,6,50.0%,8m
26400,2,Zoiros,2688,0,3,4,7,42.9%,30m
26400,1,[MƇƆ]Waydru,2688,89,2,1,3,66.7%,3m
26400,3,Dharrak,2688,0,2,3,5,40.0%,1h
26400,3,Snow,2688,97,2,3,5,40.0%,4m
26400,1,CrazyRabbit,2688,0,2,3,5,40.0%,15m
26400,1,[TkcS]ZAGHOST,2688,0,2,3,5,40.0%,13m
26400,1,Nelio,2688,76,2,20,22,9.1%,5m
26400,1,Créatine,2688,0,1,0,1,100.0%,28m
26400,1,[WS5]СудьяАлдарис,2688,0,1,0,1,100.0%,27m
26400,1,CaptainMitt,2688,0,1,1,2,50.0%,49m
26400,1,Drowling,2688,89,1,1,2,50.0%,39m
26400,2,[RUSH69]BANGER,2688,46,1,2,3,33.3%,1h
26400,1,eddekungen,2688,0,1,3,4,25.0%,1h
26400,1,[ArĮnĒn]HappyThought,2688,0,0,1,1,0.0%,11m
26400,2,mmm,2688,0,0,1,1,0.0%,1h
26400,1,[8Сега8]сергей,2688,0,0,2,2,0.0%,1h
26439,2,mat,2687,765,121,102,223,54.3%,14m
26439,3,GhoAlumY,2687,1547,93,96,189,49.2%,12m
26439,1,NAZGUL,2687,1507,72,61,133,54.1%,13m
26439,1,Ronin,2687,1148,53,29,82,64.6%,25m
26439,3,feraiur,2687,627,44,47,91,48.4%,13m
26439,1,Noob,2687,569,31,15,46,67.4%,8m
26439,1,NightLive,2687,341,30,23,53,56.6%,37m
26439,3,STARLEY,2687,618,28,21,49,57.1%,21m
26439,1,Samsam,2687,658,19,22,41,46.3%,16m
26439,3,[SwaV]Leon,2687,436,15,21,36,41.7%,18m
26439,3,[ZIPP]Macrizzz,2687,359,14,16,30,46.7%,10m
26439,3,KiloVatt,2687,372,14,20,34,41.2%,6m
26439,1,[PYHU]Пучахендза,2687,327,12,10,22,54.5%,41m
26439,1,[EFPS]PACCC,2687,392,12,12,24,50.0%,35m
26439,1,Headcutter,2687,300,11,11,22,50.0%,9m
26439,1,Ksavo,2687,206,7,3,10,70.0%,41m
26439,1,SlenderStev,2687,231,7,4,11,63.6%,44m
26439,1,[FMG]DOMINIK,2687,246,7,4,11,63.6%,1h
26439,1,Дракон,2687,191,5,3,8,62.5%,28m
26439,1,Kusti,2687,148,5,5,10,50.0%,1h
26439,1,KACKA,2687,117,4,0,4,100.0%,49m
26439,3,Tax,2687,135,4,2,6,66.7%,37m
26439,1,[BlackT]LightYagami,2687,165,4,7,11,36.4%,25m
26439,1,МиШаНя,2687,104,3,0,3,100.0%,12m
26439,1,habbomatrix,2687,88,3,3,6,50.0%,9m
26439,1,kkrava,2687,38,2,1,3,66.7%,45m
26439,1,ProtokoL,2687,107,2,1,3,66.7%,1h
26439,1,raxle,2687,0,2,3,5,40.0%,31m
26439,1,AoPJoly,2687,0,1,0,1,100.0%,26m
26439,3,MelonMelandR,2687,0,1,0,1,100.0%,23m
26439,1,GRAV,2687,90,1,1,2,50.0%,13m
26439,1,Fry,2687,0,1,3,4,25.0%,13m
26439,1,Psymox,2687,0,0,1,1,0.0%,1h
26439,1,ASHERAT,2687,0,0,1,1,0.0%,24m
26439,2,PsixeaX,2687,0,0,2,2,0.0%,1h
26439,1,antares,2687,0,0,2,2,0.0%,45m
26475,1,Серёга,2686,1706,130,107,237,54.9%,49m
26475,3,Azeo,2686,1331,91,91,182,50.0%,22m
26475,3,[FR1]TRUMP,2686,1486,90,93,183,49.2%,21m
26475,1,eXistenZ,2686,1459,72,66,138,52.2%,1h
26475,3,[696]Dragon,2686,767,43,45,88,48.9%,3m
26475,3,[BERKUT]Dmitry,2686,529,36,38,74,48.6%,3m
26475,1,Fraisou,2686,719,29,19,48,60.4%,1h
26475,1,USUL,2686,629,27,17,44,61.4%,1h
26475,3,Петрушка,2686,581,24,25,49,49.0%,4m
26475,3,Ramzess,2686,618,24,26,50,48.0%,3m
26475,1,Flex,2686,471,19,15,34,55.9%,1h
26475,3,StarSchwarf,2686,526,19,18,37,51.4%,14m
26475,1,morbius,2686,422,15,11,26,57.7%,8m
26475,1,chaser,2686,235,9,7,16,56.2%,11m
26475,3,Vojtesla,2686,147,6,6,12,50.0%,23m
26475,1,Leo,2686,191,6,7,13,46.2%,4m
26475,3,Elmswood,2686,150,6,11,17,35.3%,12m
26475,3,Twisterrr,2686,114,4,5,9,44.4%,7m
26475,3,SzyszonEX,2686,30,4,5,9,44.4%,13m
26475,1,ELJey,2686,124,3,1,4,75.0%,1h
26475,1,[WADER]LittleDiablo,2686,163,3,2,5,60.0%,35m
26475,3,iNkA,2686,135,2,2,4,50.0%,12m
26475,3,Cyto,2686,0,2,3,5,40.0%,12m
26475,3,FLAIVDARKO,2686,0,2,3,5,40.0%,14m
26475,1,[OUBL]Xenophon,2686,0,1,0,1,100.0%,9m
26475,1,[TIREL]Escalibur,2686,0,1,0,1,100.0%,25m
26475,1,[Dobro]AlexV,2686,0,1,0,1,100.0%,1h
26475,1,ladyminya,2686,0,1,0,1,100.0%,1h
26475,1,Segetta,2686,0,1,1,2,50.0%,11m
26475,2,[soGern]DebbieDanger,2686,0,1,1,2,50.0%,38m
26475,1,[IIuBo]KickOFF,2686,40,1,4,5,20.0%,26m
26475,3,Madstico,2686,97,1,4,5,20.0%,10m
26475,1,kalt,2686,0,0,1,1,0.0%,30m
26475,1,Dimitri,2686,0,0,1,1,0.0%,13m
26475,1,Marras,2686,0,0,1,1,0.0%,49m
26475,1,Bell,2686,0,0,1,1,0.0%,1h
26475,1,Gilga,2686,0,0,2,2,0.0%,12m
26512,3,Zorak,2685,1559,249,245,494,50.4%,24m
26512,3,Messias,2685,1233,86,71,157,54.8%,15m
26512,1,[drrsch]dxdy,2685,1503,85,76,161,52.8%,11m
26512,1,BlazejJagge,2685,1666,66,56,122,54.1%,33m
26512,1,BackFire,2685,946,64,66,130,49.2%,16m
26512,1,DarkǂBlast,2685,1492,61,54,115,53.0%,28m
26512,3,[VEFY]gorkius,2685,910,42,54,96,43.8%,12m
26512,1,BigGDani,2685,953,34,33,67,50.7%,14m
26512,1,Vaost,2685,499,24,22,46,52.2%,7m
26512,1,Illidanou,2685,359,16,11,27,59.3%,13m
26512,1,Akisura,2685,564,16,16,32,50.0%,15m
26512,1,[snowBY]ChmokPypsik,2685,314,14,6,20,70.0%,35m
26512,1,nathekiller,2685,353,14,16,30,46.7%,1h
26512,1,[Dzen]konstantinos,2685,432,13,11,24,54.2%,34m
26512,1,DrakeDog,2685,311,12,13,25,48.0%,1h
26512,1,Eldershot,2685,302,8,7,15,53.3%,39m
26512,1,RabbidLesbo,2685,180,7,3,10,70.0%,22m
26512,1,Anihel,2685,249,6,6,12,50.0%,1h
26512,2,Cobaltic,2685,161,5,5,10,50.0%,1h
26512,3,Xalo,2685,0,4,1,5,80.0%,1h
26512,1,nekuJay,2685,106,4,5,9,44.4%,49m
26512,1,sDI,2685,125,3,1,4,75.0%,1h
26512,1,Ghost,2685,30,3,4,7,42.9%,1h
26512,1,ShinShanShun,2685,54,3,23,26,11.5%,16m
26512,1,NumberOne,2685,38,2,1,3,66.7%,30m
26512,3,[DfF]CkFreak,2685,0,2,3,5,40.0%,1h
26512,1,zetobelka,2685,74,2,3,5,40.0%,1h
26512,3,Raft,2685,0,2,3,5,40.0%,50m
26512,2,fornoreason,2685,0,2,5,7,28.6%,47m
26512,1,Avinamor,2685,88,1,1,2,50.0%,13m
26512,2,Dmitrov,2685,44,1,3,4,25.0%,26m
26512,3,GaviS,2685,0,1,4,5,20.0%,42m
26512,2,ModestPixel,2685,96,1,4,5,20.0%,44m
26512,3,Santa,2685,0,0,1,1,0.0%,25m
26512,1,[TrueMe]deNom,2685,0,0,3,3,0.0%,1h
26512,1,[BMF]SID,2685,73,0,3,3,0.0%,12m
26512,3,ITzjosh,2685,0,0,7,7,0.0%,21m
26549,1,Newby,2684,1708,192,174,366,52.5%,40m
26549,1,FuegoN,2684,983,97,79,176,55.1%,30m
26549,1,[CoSmE]boulverine,2684,1625,77,59,136,56.6%,12m
26549,1,Corenbaine,2684,980,49,44,93,52.7%,1h
26549,1,sortara,2684,925,31,30,61,50.8%,12m
26549,2,Ilya,2684,475,19,32,51,37.3%,30m
26549,1,[AAWW]Jaeger,2684,396,17,13,30,56.7%,49m
26549,1,WeltallAlpha,2684,331,16,8,24,66.7%,50m
26549,3,Kymahri,2684,403,16,18,34,47.1%,3m
26549,1,[FLZG]CptFlow,2684,498,15,22,37,40.5%,38m
26549,3,DiabloP,2684,339,13,11,24,54.2%,29m
26549,1,SoSo,2684,360,13,16,29,44.8%,1h
26549,3,LittleJohnII,2684,290,11,12,23,47.8%,30m
26549,1,[ZERGSC]krovyfalcon,2684,325,9,8,17,52.9%,1h
26549,1,TastyTrout,2684,307,9,9,18,50.0%,7m
26549,1,Saphoura,2684,352,9,11,20,45.0%,39m
26549,1,CroProFBoi,2684,224,7,4,11,63.6%,1h
26549,1,PINGALOKA,2684,100,6,1,7,85.7%,34m
26549,1,Ксандр,2684,131,4,1,5,80.0%,13m
26549,1,null,2684,107,3,0,3,100.0%,31m
26549,1,OttoHutt,2684,89,2,0,2,100.0%,34m
26549,3,IIIIIIIIIIII,2684,0,2,3,5,40.0%,6m
26549,3,XRTY,2684,0,2,3,5,40.0%,49m
26549,1,Vort,2684,0,1,0,1,100.0%,22m
26549,1,[mYі]DELLlEBO,2684,89,1,1,2,50.0%,14m
26549,1,Alcatrase,2684,32,1,4,5,20.0%,1h
26549,1,oeufalacoc,2684,73,1,5,6,16.7%,7m
26549,2,BlackBilly,2684,0,0,1,1,0.0%,46m
26549,1,DeathNote,2684,0,0,2,2,0.0%,1h
26549,1,Straton,2684,0,0,4,4,0.0%,1h
26579,3,warch,2683,1574,218,211,429,50.8%,24m
26579,3,Itadakimasu,2683,1087,167,171,338,49.4%,5m
26579,3,Maximus,2683,1524,82,71,153,53.6%,15m
26579,3,MEHTEC,2683,1014,52,59,111,46.8%,13m
26579,3,CarlJohnson,2683,826,33,37,70,47.1%,3m
26579,3,Eterid,2683,596,26,22,48,54.2%,12m
26579,1,[So0]ORANGERANGE,2683,319,25,15,40,62.5%,30m
26579,3,GsGShõckS,2683,674,22,31,53,41.5%,5m
26579,3,Illumiknight,2683,264,10,14,24,41.7%,6m
26579,1,OldSwag,2683,205,9,4,13,69.2%,39m
26579,3,TPmfgZG,2683,204,9,14,23,39.1%,9m
26579,1,Enigma,2683,233,7,4,11,63.6%,1h
26579,1,Ghost,2683,189,6,8,14,42.9%,17m
26579,1,ChickenTikka,2683,220,6,10,16,37.5%,9m
26579,1,BirzhanIM,2683,119,4,1,5,80.0%,4m
26579,1,RimmJob,2683,136,4,1,5,80.0%,39m
26579,1,[gmON]Comic,2683,126,4,2,6,66.7%,45m
26579,1,Патриот,2683,141,4,2,6,66.7%,20m
26579,1,IKUA,2683,76,4,5,9,44.4%,1h
26579,3,cristi,2683,30,4,5,9,44.4%,21m
26579,1,Celestial,2683,108,3,1,4,75.0%,21m
26579,1,Kit,2683,107,2,2,4,50.0%,12m
26579,3,Bosha,2683,0,2,3,5,40.0%,27m
26579,2,[PlayPG]Shooter,2683,0,1,0,1,100.0%,17m
26579,1,[ESP1]Legislador,2683,0,1,1,2,50.0%,38m
26579,1,Gazorezchick,2683,0,1,1,2,50.0%,41m
26579,1,NickolasM,2683,0,1,2,3,33.3%,34m
26579,3,Яхзлол,2683,0,1,2,3,33.3%,41m
26579,1,phylemgame,2683,0,0,1,1,0.0%,28m
26579,2,Aimie,2683,0,0,1,1,0.0%,1h
26579,2,batush,2683,0,0,1,1,0.0%,14m
26579,3,[DeotVo]Ertanus,2683,0,0,1,1,0.0%,47m
26611,1,JuriBoika,2682,1486,333,312,645,51.6%,1h
26611,3,GallAnt,2682,1590,242,227,469,51.6%,3m
26611,1,Zergusha,2682,709,74,63,137,54.0%,26m
26611,2,Mirus,2682,1005,53,59,112,47.3%,10m
26611,1,shura,2682,1060,46,36,82,56.1%,7m
26611,1,Dave,2682,950,32,34,66,48.5%,43m
26611,3,[CP477]AlexLitle,2682,816,31,33,64,48.4%,9m
26611,1,[Tlse]panda,2682,619,25,19,44,56.8%,1h
26611,1,requou,2682,260,22,15,37,59.5%,48m
26611,1,Sycore,2682,450,19,12,31,61.3%,1h
26611,1,Lolicon,2682,360,14,11,25,56.0%,40m
26611,1,[Frass]Luntarn,2682,404,13,13,26,50.0%,11m
26611,3,Andy,2682,282,11,12,23,47.8%,5m
26611,1,TheMarine,2682,149,10,6,16,62.5%,44m
26611,3,Сагрел,2682,231,10,12,22,45.5%,14m
26611,1,SpookyeManRO,2682,313,9,7,16,56.2%,25m
26611,1,[SCraft]TyranidLord,2682,301,9,9,18,50.0%,3m
26611,1,серега,2682,165,7,1,8,87.5%,44m
26611,3,[DМG]DobryyKot,2682,146,6,11,17,35.3%,24m
26611,1,Nekodimss,2682,88,5,1,6,83.3%,22m
26611,3,denis,2682,168,5,6,11,45.5%,9m
26611,1,brtk,2682,124,4,4,8,50.0%,1h
26611,2,SnickerSnips,2682,94,3,4,7,42.9%,38m
26611,1,gekki,2682,120,3,6,9,33.3%,1h
26611,1,Semihunt,2682,0,2,3,5,40.0%,38m
26611,3,Amorim,2682,0,2,3,5,40.0%,1h
26611,1,RATMØ,2682,0,1,0,1,100.0%,22m
26611,1,Anov,2682,0,1,0,1,100.0%,16m
26611,1,[isIMBА]StupidNoob,2682,0,1,0,1,100.0%,33m
26611,1,MunJaeIn,2682,0,0,1,1,0.0%,13m
26611,1,[WurS]samdaskod,2682,0,0,1,1,0.0%,27m
26611,1,Apollo,2682,0,0,1,1,0.0%,27m
26611,1,Yuranoos,2682,0,0,1,1,0.0%,1h
26611,3,IIIIIIIIIIII,2682,0,0,2,2,0.0%,15m
26645,2,KiR,2681,1252,233,223,456,51.1%,10m
26645,3,Devorian,2681,1480,142,140,282,50.4%,8m
26645,1,EryTargaryen,2681,1650,112,111,223,50.2%,19m
26645,2,[QaDo]Dima,2681,1392,51,64,115,44.3%,24m
26645,1,[CMInc]SLs,2681,620,37,32,69,53.6%,28m
26645,3,ZooBestik,2681,790,32,30,62,51.6%,6m
26645,2,IceWind,2681,302,20,29,49,40.8%,14m
26645,1,Frojdy,2681,294,13,12,25,52.0%,26m
26645,1,[LOGS]Chinis,2681,356,12,12,24,50.0%,1h
26645,1,[ADSKY]Sectus,2681,220,8,7,15,53.3%,43m
26645,1,Nibbler,2681,223,8,8,16,50.0%,1h
26645,3,Hurt,2681,111,8,12,20,40.0%,6m
26645,1,Batonka,2681,165,7,1,8,87.5%,7m
26645,2,RLGS,2681,174,7,9,16,43.8%,16m
26645,1,Forego,2681,224,6,5,11,54.5%,1h
26645,1,General,2681,144,5,1,6,83.3%,8m
26645,1,MetaK,2681,186,5,7,12,41.7%,12m
26645,1,[SWARM]zwoom,2681,115,4,0,4,100.0%,33m
26645,1,Patan,2681,110,4,4,8,50.0%,16m
26645,1,comp,2681,88,3,1,4,75.0%,1h
26645,1,blTrOcKz,2681,0,3,2,5,60.0%,1h
26645,3,FlutterGuy,2681,0,3,3,6,50.0%,38m
26645,1,luzz,2681,88,3,3,6,50.0%,1h
26645,2,[Lv18]Ins,2681,115,3,4,7,42.9%,1h
26645,1,Fluke,2681,88,2,0,2,100.0%,4m
26645,3,Godboroos,2681,0,2,3,5,40.0%,25m
26645,1,Spiro,2681,0,1,0,1,100.0%,16m
26645,2,Purifier,2681,0,1,0,1,100.0%,1h
26645,1,DocuMenTarY,2681,0,0,1,1,0.0%,1h
26645,1,LuckyPig,2681,0,0,1,1,0.0%,31m
26645,3,MaksimUs,2681,0,0,1,1,0.0%,44m
26645,2,BioBober,2681,0,0,6,6,0.0%,7m
26677,1,Kinch,2680,1370,187,201,388,48.2%,7m
26677,1,Firestorm,2680,1684,99,85,184,53.8%,24m
26677,3,[SMID]Mikozza,2680,1333,56,55,111,50.5%,9m
26677,3,Gliese,2680,1194,47,48,95,49.5%,13m
26677,1,Rhobat,2680,1022,43,40,83,51.8%,16m
26677,2,[NOXs]Cloud,2680,811,40,46,86,46.5%,20m
26677,3,OCMAK,2680,641,29,26,55,52.7%,16m
26677,1,fans,2680,552,19,16,35,54.3%,31m
26677,3,trollkarl,2680,370,15,15,30,50.0%,6m
26677,1,[HaSKo]Den,2680,247,11,6,17,64.7%,12m
26677,1,Aizen,2680,332,10,12,22,45.5%,1h
26677,1,KubaPro,2680,253,9,5,14,64.3%,44m
26677,1,BobSaget,2680,283,7,7,14,50.0%,1h
26677,3,[eWRS]SovietTankie,2680,208,7,18,25,28.0%,7m
26677,2,Noodles,2680,172,6,0,6,100.0%,47m
26677,1,MRJ,2680,158,6,4,10,60.0%,29m
26677,1,Camembert,2680,183,6,6,12,50.0%,1h
26677,3,CorrptedVnoM,2680,229,6,11,17,35.3%,21m
26677,1,Nitro,2680,196,5,4,9,55.6%,38m
26677,2,Subardan,2680,92,5,4,9,55.6%,17m
26677,1,ЕНОТ,2680,176,5,7,12,41.7%,16m
26677,3,Folk,2680,109,5,8,13,38.5%,12m
26677,1,[SchamR]daGriech,2680,156,4,4,8,50.0%,25m
26677,2,hotANDfluffy,2680,117,4,5,9,44.4%,7m
26677,3,Gatts,2680,123,3,1,4,75.0%,30m
26677,3,Lex,2680,62,3,7,10,30.0%,14m
26677,3,[NevSur]nurFischer,2680,94,3,10,13,23.1%,21m
26677,1,Max,2680,38,2,3,5,40.0%,41m
26677,3,unTq,2680,0,2,3,5,40.0%,47m
26677,2,Sabotage,2680,0,2,3,5,40.0%,48m
26677,3,[Neewbe]esiek,2680,38,2,5,7,28.6%,1h
26677,1,Switchback,2680,0,1,0,1,100.0%,9m
26677,2,[CGeeK]Ennuxio,2680,32,1,2,3,33.3%,4m
26677,1,EUGEN,2680,0,1,2,3,33.3%,28m
26677,1,manokanaka,2680,42,1,3,4,25.0%,44m
26677,1,[FOREX]USDCHFbuy,2680,42,1,3,4,25.0%,21m
26677,2,[place]Ingyen,2680,0,0,1,1,0.0%,40m
26677,2,Antibiotik,2680,0,0,1,1,0.0%,1h
26677,2,motekshelie,2680,0,0,1,1,0.0%,40m
26677,3,nol,2680,0,0,1,1,0.0%,50m
26677,1,[22asw1]BENIS,2680,0,0,2,2,0.0%,1h
26677,1,KrainTheFox,2680,0,0,2,2,0.0%,49m
26677,2,DHassellhoff,2680,0,0,3,3,0.0%,1h
26677,1,gavnoebanoe,2680,0,0,4,4,0.0%,17m
26721,3,[HoboMT]HappyIzrod,2679,1104,89,89,178,50.0%,16m
26721,1,DONSPIDER,2679,1105,49,39,88,55.7%,1h
26721,1,Isildur,2679,1029,49,43,92,53.3%,48m
26721,1,Frederiksen,2679,1191,44,39,83,53.0%,1h
26721,3,alealeks,2679,990,36,38,74,48.6%,12m
26721,3,Fabulous,2679,868,36,38,74,48.6%,21m
26721,1,[ИС]Aien,2679,654,27,21,48,56.2%,11m
26721,1,UltraLazer,2679,782,26,25,51,51.0%,14m
26721,1,oneshot,2679,660,25,23,48,52.1%,22m
26721,2,Kolen,2679,526,21,27,48,43.8%,22m
26721,1,FLO,2679,425,13,12,25,52.0%,30m
26721,1,Darsoitu,2679,392,12,11,23,52.2%,30m
26721,2,romkapazifis,2679,278,11,7,18,61.1%,41m
26721,1,Nilsemeier,2679,347,11,9,20,55.0%,12m
26721,1,[cosset]МнеЧГода,2679,282,9,9,18,50.0%,1h
26721,1,Bananaking,2679,280,9,11,20,45.0%,20m
26721,1,Timay,2679,212,8,9,17,47.1%,1h
26721,2,ЩЩЩЩЩЩЩЩЩЩЩЩ,2679,219,7,5,12,58.3%,46m
26721,1,pinkie,2679,183,7,6,13,53.8%,1h
26721,2,Blumancio,2679,125,5,5,10,50.0%,40m
26721,3,[WАSD]SOFT,2679,96,4,3,7,57.1%,12m
26721,1,Pugo,2679,163,4,4,8,50.0%,17m
26721,1,Szilko,2679,127,3,2,5,60.0%,25m
26721,3,saibo,2679,0,3,4,7,42.9%,3m
26721,2,[CJFF]JustLap,2679,30,2,0,2,100.0%,36m
26721,2,Moumoulax,2679,58,2,1,3,66.7%,32m
26721,3,[InBWT]Vittel,2679,0,2,3,5,40.0%,50m
26721,2,Faceless,2679,0,2,3,5,40.0%,10m
26721,2,Black,2679,0,2,3,5,40.0%,43m
26721,2,kretzsche,2679,30,1,1,2,50.0%,40m
26721,1,[ZERGSC]глеб,2679,0,1,3,4,25.0%,1h
26721,2,TechEpic,2679,0,0,1,1,0.0%,5m
26721,3,SieStein,2679,0,0,2,2,0.0%,47m
26721,1,ben,2679,0,0,2,2,0.0%,27m
26755,3,MrBrown,2678,1430,281,271,552,50.9%,15m
26755,1,Александр,2678,1620,198,197,395,50.1%,1h
26755,1,rattenplan,2678,1474,105,93,198,53.0%,10m
26755,1,Esb,2678,1642,77,50,127,60.6%,33m
26755,1,ChamP,2678,879,63,55,118,53.4%,37m
26755,2,[coors]coorsllte,2678,506,52,67,119,43.7%,3m
26755,1,Aster,2678,347,24,23,47,51.1%,7m
26755,1,[ZЕRGTV]pitip,2678,747,23,22,45,51.1%,44m
26755,1,[CHeZY]AnIMaL,2678,394,15,12,27,55.6%,1h
26755,1,[BLOOD7]Wingwave,2678,221,7,4,11,63.6%,33m
26755,2,CokeDealer,2678,236,6,3,9,66.7%,16m
26755,1,IGWXZ,2678,224,6,8,14,42.9%,49m
26755,1,ZaAiur,2678,88,5,2,7,71.4%,49m
26755,2,Dagato,2678,62,5,3,8,62.5%,12m
26755,1,Mokuton,2678,249,5,9,14,35.7%,7m
26755,2,Amazer,2678,0,4,3,7,57.1%,3m
26755,1,Lofo,2678,74,3,3,6,50.0%,15m
26755,1,MyasnikDI,2678,36,3,4,7,42.9%,40m
26755,3,Chiharcos,2678,0,2,3,5,40.0%,41m
26755,2,Karpyua,2678,0,2,3,5,40.0%,1h
26755,1,espresso,2678,36,2,4,6,33.3%,41m
26755,2,[USSR02]NavalnyLive,2678,0,1,0,1,100.0%,22m
26755,2,Roshah,2678,0,1,4,5,20.0%,1h
26755,2,[KSRF]MaXTnT,2678,0,0,1,1,0.0%,1h
26755,2,[Mimmi]MimmiTheDog,2678,0,0,1,1,0.0%,1h
26755,2,Арсикер,2678,0,0,1,1,0.0%,1h
26755,3,[SBHAWK]SClord,2678,0,0,2,2,0.0%,10m
26755,1,[ƬC]WraithCraft,2678,0,0,2,2,0.0%,8m
26755,1,Leit,2678,0,0,2,2,0.0%,13m
26755,1,Monkeyhead,2678,0,0,2,2,0.0%,41m
26755,1,Wullewupwup,2678,0,0,4,4,0.0%,13m
26786,1,llllllllllll,2677,1578,145,132,277,52.3%,24m
26786,1,TonyStark,2677,1676,124,110,234,53.0%,49m
26786,3,Zel,2677,1402,86,86,172,50.0%,16m
26786,1,darkphoenix,2677,1549,78,73,151,51.7%,22m
26786,2,[TdDm]CptFlashbang,2677,1116,41,46,87,47.1%,18m
26786,3,Ted,2677,850,34,28,62,54.8%,9m
26786,3,Vagabond,2677,938,34,44,78,43.6%,9m
26786,1,Roman,2677,932,31,31,62,50.0%,1h
26786,3,Metais,2677,641,25,23,48,52.1%,15m
26786,2,Sibbotine,2677,470,17,11,28,60.7%,48m
26786,1,SnoozBerry,2677,392,14,14,28,50.0%,16m
26786,1,ЗИНОЧКА,2677,437,12,12,24,50.0%,14m
26786,1,bunny,2677,225,8,2,10,80.0%,1h
26786,2,[TFSC]aaa,2677,126,4,3,7,57.1%,35m
26786,2,Darth,2677,117,4,4,8,50.0%,24m
26786,2,Ghola,2677,0,3,2,5,60.0%,9m
26786,3,Pakowa,2677,0,3,4,7,42.9%,16m
26786,1,[MSUSC2]nJIeCeHb,2677,32,3,4,7,42.9%,20m
26786,2,LizenzFarn,2677,32,2,0,2,100.0%,27m
26786,2,SucreeG,2677,121,2,2,4,50.0%,37m
26786,2,denson,2677,136,2,2,4,50.0%,1h
26786,3,kalkhan,2677,0,2,3,5,40.0%,1h
26786,3,Stormi,2677,0,2,3,5,40.0%,1h
26786,2,JOHAN,2677,0,2,3,5,40.0%,4m
26786,2,sandorlol,2677,30,2,3,5,40.0%,19m
26786,3,Saxnote,2677,0,2,3,5,40.0%,23m
26786,2,Vadim,2677,0,1,0,1,100.0%,31m
26786,2,Gulgorf,2677,46,1,3,4,25.0%,1h
26786,3,[BSTG]biowars,2677,0,1,3,4,25.0%,41m
26786,3,Noa,2677,0,0,1,1,0.0%,44m
26786,2,Fraktisied,2677,0,0,1,1,0.0%,37m
26786,2,brash,2677,0,0,1,1,0.0%,41m
26818,3,Klimcase,2676,1122,224,214,438,51.1%,9m
26818,3,SILKI,2676,1463,138,130,268,51.5%,6m
26818,1,IIIIIIIIII,2676,1042,103,80,183,56.3%,25m
26818,1,[Panicz]Emileq,2676,1582,102,99,201,50.7%,25m
26818,3,[мега]Rotango,2676,1230,84,77,161,52.2%,30m
26818,3,DIO,2676,1180,78,83,161,48.4%,23m
26818,3,Jimmy,2676,1016,65,53,118,55.1%,21m
26818,1,Fahrengate,2676,756,58,75,133,43.6%,9m
26818,3,shansonie,2676,1224,45,51,96,46.9%,16m
26818,1,[Xa]Jack,2676,585,41,28,69,59.4%,20m
26818,1,[Klaz]Isak,2676,785,40,23,63,63.5%,25m
26818,3,GuiltySpark,2676,844,30,33,63,47.6%,17m
26818,2,HeavyMetal,2676,343,20,17,37,54.1%,45m
26818,1,[CROCHI]Доминатор,2676,541,17,17,34,50.0%,1h
26818,2,ааааб,2676,428,16,12,28,57.1%,1h
26818,2,Eratosthenes,2676,344,13,12,25,52.0%,41m
26818,1,AlkoTip,2676,452,13,15,28,46.4%,1h
26818,3,Master,2676,252,12,13,25,48.0%,4m
26818,1,EyeCan,2676,305,11,7,18,61.1%,44m
26818,2,Viteron,2676,278,10,3,13,76.9%,1h
26818,1,Katsuhiko,2676,314,8,8,16,50.0%,7m
26818,1,[литрпг]Ансирал,2676,193,7,4,11,63.6%,1h
26818,1,[MWorld]poligirinos,2676,199,7,7,14,50.0%,40m
26818,3,JadeMemeth,2676,181,6,6,12,50.0%,21m
26818,2,Gargamel,2676,134,5,5,10,50.0%,24m
26818,1,tenshi,2676,127,5,7,12,41.7%,13m
26818,1,barbouse,2676,166,5,11,16,31.2%,1h
26818,2,[FMG]Sturm,2676,0,4,1,5,80.0%,1h
26818,2,UndeadDragon,2676,120,4,3,7,57.1%,19m
26818,3,Holmizz,2676,131,4,4,8,50.0%,34m
26818,1,InterDiu,2676,126,4,5,9,44.4%,23m
26818,3,[ZERGSC]Filin,2676,0,3,4,7,42.9%,16m
26818,3,mimix,2676,62,3,10,13,23.1%,12m
26818,1,mengor,2676,104,2,2,4,50.0%,41m
26818,1,Funkyfingers,2676,35,2,3,5,40.0%,34m
26818,3,Prohor,2676,0,2,3,5,40.0%,1h
26818,3,Davide,2676,0,2,3,5,40.0%,15m
26818,3,Josip,2676,0,2,3,5,40.0%,38m
26818,2,Vian,2676,0,2,3,5,40.0%,20m
26818,2,Marek,2676,0,1,0,1,100.0%,44m
26818,2,sunshine,2676,0,1,0,1,100.0%,1h
26818,1,[Sfi]AquaPhil,2676,40,1,5,6,16.7%,1h
26818,3,[moumou]Bradock,2676,0,0,1,1,0.0%,30m
26818,2,[JaPP]JoKeR,2676,0,0,1,1,0.0%,3m
26818,2,SupiTeuber,2676,0,0,1,1,0.0%,31m
26818,1,Sealer,2676,0,0,2,2,0.0%,12m
26864,1,BassToad,2675,1577,114,104,218,52.3%,25m
26864,3,nMe,2675,446,101,99,200,50.5%,20m
26864,2,DarKFaNToM,2675,1456,69,71,140,49.3%,13m
26864,1,Anris,2675,860,37,35,72,51.4%,50m
26864,3,peterwhie,2675,998,36,42,78,46.2%,6m
26864,3,Moha,2675,544,19,22,41,46.3%,16m
26864,2,Alex,2675,294,11,12,23,47.8%,41m
26864,1,[mfixed]Matino,2675,242,10,6,16,62.5%,31m
26864,3,JAY,2675,270,10,15,25,40.0%,19m
26864,1,[JANEG]DavDev,2675,224,9,4,13,69.2%,11m
26864,1,Soter,2675,191,5,4,9,55.6%,15m
26864,2,KeepUrReaper,2675,156,4,2,6,66.7%,48m
26864,2,Irgen,2675,118,4,3,7,57.1%,32m
26864,2,happy,2675,117,4,5,9,44.4%,1h
26864,3,Blink,2675,109,4,5,9,44.4%,4m
26864,1,[DILIT]GHoST,2675,97,4,6,10,40.0%,40m
26864,2,[Сучкак]DalimBan,2675,60,3,0,3,100.0%,28m
26864,1,zlemrzlemr,2675,0,3,3,6,50.0%,15m
26864,2,JimmyJuicer,2675,112,3,4,7,42.9%,3m
26864,2,FiendRus,2675,102,3,4,7,42.9%,1h
26864,2,bot,2675,32,2,0,2,100.0%,35m
26864,1,Otrice,2675,38,2,2,4,50.0%,25m
26864,2,Шарик,2675,0,2,3,5,40.0%,27m
26864,2,Murphy,2675,0,2,3,5,40.0%,4m
26864,1,Serax,2675,0,2,4,6,33.3%,41m
26864,2,BOPOH,2675,0,1,0,1,100.0%,1h
26864,1,[IDSU]krader,2675,40,1,4,5,20.0%,38m
26864,1,TTstasTT,2675,38,1,6,7,14.3%,49m
26864,2,[ViFo]Yrik,2675,0,0,1,1,0.0%,36m
26864,1,BlackAssasin,2675,0,0,2,2,0.0%,22m
26864,1,[Snаkеs]SaltSnake,2675,0,0,3,3,0.0%,12m
26895,1,[97Crew]Baki,2674,1481,233,227,460,50.7%,38m
26895,3,InSepTioN,2674,1016,153,140,293,52.2%,13m
26895,1,MartianOnIce,2674,918,34,33,67,50.7%,15m
26895,3,HeroNguyen,2674,880,30,38,68,44.1%,23m
26895,2,alexandre,2674,508,22,14,36,61.1%,48m
26895,2,Caru,2674,404,16,22,38,42.1%,14m
26895,1,VladusCri,2674,399,14,10,24,58.3%,1h
26895,2,[HZeS]Sodon,2674,324,12,5,17,70.6%,1h
26895,1,[Phar0h]JoMaC,2674,307,11,11,22,50.0%,1h
26895,3,SongerNya,2674,330,11,17,28,39.3%,14m
26895,3,outsyder,2674,218,8,14,22,36.4%,30m
26895,2,Thingamabob,2674,174,7,2,9,77.8%,36m
26895,1,Bibdibabdibu,2674,193,7,9,16,43.8%,25m
26895,2,SunBro,2674,170,7,9,16,43.8%,12m
26895,3,[HaoS]Exsempld,2674,110,3,2,5,60.0%,6m
26895,1,Artemon,2674,139,3,3,6,50.0%,11m
26895,2,[Olk]HORUS,2674,30,2,0,2,100.0%,22m
26895,2,Storm,2674,62,2,1,3,66.7%,43m
26895,3,keynes,2674,0,2,3,5,40.0%,1h
26895,3,Lynx,2674,0,2,3,5,40.0%,14m
26895,2,[Faith1]DrBanshee,2674,0,1,0,1,100.0%,7m
26895,1,Sbarabard,2674,0,1,3,4,25.0%,41m
26895,2,Chernomor,2674,0,1,4,5,20.0%,1h
26895,2,WyrmZ,2674,0,1,7,8,12.5%,7m
26895,2,BuRgLar,2674,0,0,1,1,0.0%,41m
26895,2,Nogan,2674,0,0,1,1,0.0%,16m
26895,2,gorthaur,2674,0,0,4,4,0.0%,1h
26922,2,LeXuS,2673,1574,309,312,621,49.8%,3m
26922,1,Aatasoy,2673,1208,50,37,87,57.5%,3m
26922,1,[DiRE]petushara,2673,683,37,28,65,56.9%,1h
26922,3,[A2C]Alkyrrion,2673,842,30,33,63,47.6%,4m
26922,1,summer,2673,501,19,15,34,55.9%,13m
26922,1,Krisinox,2673,530,16,16,32,50.0%,1h
26922,1,MrProTest,2673,359,15,14,29,51.7%,41m
26922,1,DirtyD,2673,331,14,14,28,50.0%,12m
26922,3,Bazil,2673,332,14,20,34,41.2%,14m
26922,1,Vladislav,2673,193,9,9,18,50.0%,13m
26922,3,HawkeHun,2673,248,8,4,12,66.7%,18m
26922,1,Alexandr,2673,148,6,5,11,54.5%,25m
26922,2,LOLLOEFEDE,2673,118,5,1,6,83.3%,46m
26922,2,[BBTinc]Busparachute,2673,137,5,6,11,45.5%,31m
26922,1,panos,2673,103,3,1,4,75.0%,22m
26922,3,Anima,2673,40,3,4,7,42.9%,1h
26922,2,Mante,2673,62,2,2,4,50.0%,37m
26922,2,IlIlIlIlIlIl,2673,0,2,3,5,40.0%,1h
26922,1,Razr,2673,142,2,3,5,40.0%,32m
26922,3,Rekhorn,2673,0,2,3,5,40.0%,1h
26922,2,Zloi,2673,0,2,3,5,40.0%,1h
26922,1,Rokas,2673,38,2,5,7,28.6%,13m
26922,2,AlphaSik,2673,0,1,0,1,100.0%,17m
26922,1,NumerusDuo,2673,0,1,1,2,50.0%,1h
26922,2,GrannyPanty,2673,94,1,1,2,50.0%,1h
26922,2,DAneco,2673,32,1,2,3,33.3%,32m
26922,1,Roger,2673,40,1,3,4,25.0%,37m
26922,1,ImNotBadBoy,2673,97,1,5,6,16.7%,3m
26922,2,ChikLaFein,2673,0,0,1,1,0.0%,46m
26922,2,IIIIIIIIIIII,2673,0,0,1,1,0.0%,16m
26922,1,Zerstörer,2673,0,0,3,3,0.0%,48m
26953,3,[MiAzGa]Siarkens,2672,1595,284,280,564,50.4%,6m
26953,1,Fleerb,2672,1526,94,78,172,54.7%,1h
26953,1,KeYka,2672,1417,92,81,173,53.2%,1h
26953,3,InvictusCl,2672,1026,76,76,152,50.0%,17m
26953,3,Maxiej,2672,1504,60,62,122,49.2%,5m
26953,1,Takar,2672,1342,59,42,101,58.4%,24m
26953,1,[TyDud]Lentin,2672,855,36,27,63,57.1%,45m
26953,2,[MIRAJ]KongKubi,2672,824,35,28,63,55.6%,10m
26953,1,Wanderlust,2672,772,27,32,59,45.8%,1h
26953,3,Futurama,2672,433,26,30,56,46.4%,24m
26953,1,Meech,2672,740,24,29,53,45.3%,41m
26953,1,[CEXY]NickP,2672,692,23,24,47,48.9%,4m
26953,1,Emon,2672,602,23,24,47,48.9%,31m
26953,1,Lelouch,2672,650,19,22,41,46.3%,49m
26953,1,gamtrex,2672,363,18,8,26,69.2%,41m
26953,2,GosuAppa,2672,284,9,9,18,50.0%,14m
26953,2,[KAT]Manflik,2672,218,7,3,10,70.0%,1h
26953,2,ptr,2672,184,5,5,10,50.0%,1h
26953,1,Beubeu,2672,190,5,7,12,41.7%,38m
26953,2,Theharvester,2672,60,5,7,12,41.7%,8m
26953,2,ZIRKEL,2672,139,4,0,4,100.0%,46m
26953,2,Fantomstrike,2672,122,4,5,9,44.4%,16m
26953,2,Zatopek,2672,126,4,17,21,19.0%,15m
26953,2,iWooT,2672,0,3,2,5,60.0%,1h
26953,1,Rinzler,2672,115,3,2,5,60.0%,25m
26953,1,Spark,2672,89,3,3,6,50.0%,9m
26953,1,Shockwave,2672,0,3,5,8,37.5%,45m
26953,2,crssleeper,2672,44,3,6,9,33.3%,31m
26953,3,LordVladimir,2672,0,2,3,5,40.0%,44m
26953,3,Ravdrien,2672,0,2,3,5,40.0%,1h
26953,2,Kvasi,2672,0,2,3,5,40.0%,48m
26953,1,[HUIHUI]kdp,2672,48,2,4,6,33.3%,37m
26953,2,[CL4P]Helmchen,2672,0,1,0,1,100.0%,41m
26953,1,Ziev,2672,0,1,1,2,50.0%,14m
26953,2,MaXimum,2672,0,1,4,5,20.0%,1h
26953,2,[ETF]TheDream,2672,0,0,1,1,0.0%,42m
26953,1,VIKONGO,2672,0,0,1,1,0.0%,42m
26953,2,Hurz,2672,0,0,1,1,0.0%,26m
26953,2,[TDUF]SheissEgal,2672,0,0,2,2,0.0%,46m
26992,2,Sprucesoup,2671,1577,135,135,270,50.0%,17m
26992,3,Kaurus,2671,960,122,117,239,51.0%,7m
26992,1,CblP,2671,626,35,11,46,76.1%,1h
26992,2,Beonix,2671,483,20,11,31,64.5%,5m
26992,3,[PLA2N]deathNote,2671,562,20,28,48,41.7%,21m
26992,1,eVkVeDMaK,2671,456,16,16,32,50.0%,1h
26992,2,Elite,2671,268,11,9,20,55.0%,42m
26992,2,[sonic1]art,2671,254,8,2,10,80.0%,1h
26992,1,[TExGG]Vulkanus,2671,148,7,5,12,58.3%,1h
26992,3,[DLOK]Deadly,2671,162,5,3,8,62.5%,49m
26992,2,kptRobi,2671,92,5,6,11,45.5%,11m
26992,2,EliteHunter,2671,90,4,0,4,100.0%,4m
26992,3,FalorRu,2671,141,4,2,6,66.7%,23m
26992,1,Sayanel,2671,120,4,4,8,50.0%,1h
26992,1,Change,2671,118,4,4,8,50.0%,22m
26992,1,HacH,2671,142,4,10,14,28.6%,6m
26992,3,Athlas,2671,97,3,3,6,50.0%,23m
26992,2,[RonBar]Krutoris,2671,94,3,4,7,42.9%,19m
26992,2,GhostStalker,2671,48,3,6,9,33.3%,50m
26992,2,olm,2671,95,3,7,10,30.0%,39m
26992,1,aleksa,2671,88,2,1,3,66.7%,49m
26992,3,Mobilis,2671,0,2,3,5,40.0%,27m
26992,3,TNTN,2671,0,2,3,5,40.0%,30m
26992,2,Shrek,2671,0,2,3,5,40.0%,1h
26992,2,Hadessss,2671,0,1,1,2,50.0%,21m
26992,1,weraplo,2671,89,1,2,3,33.3%,21m
26992,2,YouGonnaWin,2671,93,1,4,5,20.0%,40m
26992,2,Samy,2671,0,0,1,1,0.0%,19m
26992,2,heeranz,2671,0,0,1,1,0.0%,44m
26992,1,NonoW,2671,0,0,2,2,0.0%,26m
26992,1,Dofcio,2671,0,0,2,2,0.0%,13m
26992,1,FuuZz,2671,0,0,5,5,0.0%,1h
27024,2,lIlIlIlIlIlI,2670,1317,121,125,246,49.2%,16m
27024,3,Tapple,2670,1542,94,97,191,49.2%,8m
27024,1,miles,2670,1019,90,83,173,52.0%,38m
27024,2,[PowOw]Spot,2670,287,68,70,138,49.3%,10m
27024,1,norlight,2670,1510,65,62,127,51.2%,1h
27024,3,bouncybear,2670,812,56,63,119,47.1%,9m
27024,2,[3Races]HAWAX,2670,956,49,44,93,52.7%,36m
27024,2,Rabiere,2670,1106,48,64,112,42.9%,14m
27024,3,Mestah,2670,699,40,55,95,42.1%,24m
27024,3,грандмастер,2670,707,28,33,61,45.9%,20m
27024,1,YOUNG,2670,718,24,24,48,50.0%,1h
27024,1,[45silm]tamadCZ,2670,584,21,20,41,51.2%,38m
27024,2,Hitchen,2670,450,16,34,50,32.0%,14m
27024,1,przo,2670,395,13,10,23,56.5%,7m
27024,1,Homyakman,2670,280,13,12,25,52.0%,46m
27024,2,[Catory]Kacpeross,2670,310,12,6,18,66.7%,1h
27024,1,MarkF,2670,290,9,13,22,40.9%,50m
27024,2,kepayo,2670,58,7,6,13,53.8%,16m
27024,1,UstinV,2670,200,6,8,14,42.9%,32m
27024,1,[COMMIE]TheSamMiner,2670,195,5,4,9,55.6%,26m
27024,1,AlexTheGrey,2670,119,5,6,11,45.5%,1h
27024,2,Prince,2670,0,3,2,5,60.0%,32m
27024,3,Giller,2670,0,3,2,5,60.0%,41m
27024,1,DevilBox,2670,0,3,3,6,50.0%,9m
27024,3,[EAE]Zeratul,2670,0,3,4,7,42.9%,24m
27024,2,[Saber]Winter,2670,0,3,4,7,42.9%,30m
27024,1,IIIIIIIIIIII,2670,139,3,4,7,42.9%,40m
27024,1,Palmarin,2670,76,3,6,9,33.3%,12m
27024,3,Tera,2670,97,2,0,2,100.0%,25m
27024,2,[MrReed]Antonio,2670,30,2,5,7,28.6%,47m
27024,3,Kwasak,2670,0,1,0,1,100.0%,1h
27024,1,Lord,2670,0,1,1,2,50.0%,49m
27024,3,[1C5]MaxPayne,2670,0,1,1,2,50.0%,1h
27024,2,Shrud,2670,30,1,1,2,50.0%,3m
27024,2,[Admral]Max,2670,0,0,1,1,0.0%,50m
27024,1,ChatoFacade,2670,0,0,2,2,0.0%,34m
27024,1,PlutoniuM,2670,0,0,2,2,0.0%,13m
27061,3,cykill,2669,1422,163,170,333,48.9%,20m
27061,1,[ERIC]NexNinja,2669,1170,91,73,164,55.5%,1h
27061,2,Firkraag,2669,560,78,79,157,49.7%,16m
27061,3,Killerad,2669,1434,60,58,118,50.8%,15m
27061,2,Maverick,2669,1173,46,37,83,55.4%,41m
27061,2,Orange,2669,753,43,11,54,79.6%,17m
27061,2,ady,2669,914,41,25,66,62.1%,31m
27061,1,NPC,2669,570,33,17,50,66.0%,34m
27061,2,Starcounter,2669,852,32,28,60,53.3%,1h
27061,2,Joe,2669,524,30,29,59,50.8%,16m
27061,1,AcronX,2669,646,30,31,61,49.2%,1h
27061,3,Некромант,2669,517,28,24,52,53.8%,20m
27061,3,AlecGorek,2669,747,28,33,61,45.9%,3m
27061,1,JaS,2669,608,24,16,40,60.0%,3m
27061,1,[BWArmy]RoiDeMars,2669,559,23,12,35,65.7%,25m
27061,1,NoGGNoSKill,2669,445,21,16,37,56.8%,1h
27061,2,Avila,2669,350,16,19,35,45.7%,14m
27061,1,[WOBO]Reaper,2669,421,15,18,33,45.5%,14m
27061,2,Ballzdeep,2669,322,13,12,25,52.0%,1h
27061,2,[SNMRTZ]aspriez,2669,230,9,4,13,69.2%,36m
27061,1,ReEntry,2669,326,9,12,21,42.9%,35m
27061,3,bloodlestat,2669,278,9,15,24,37.5%,19m
27061,3,androx,2669,315,9,17,26,34.6%,3m
27061,1,Mirk,2669,197,7,7,14,50.0%,13m
27061,3,Mayota,2669,116,7,8,15,46.7%,3m
27061,2,[CBD420]Tibonius,2669,130,6,5,11,54.5%,31m
27061,2,Krushtak,2669,36,5,1,6,83.3%,32m
27061,2,LeoZealot,2669,148,5,2,7,71.4%,3m
27061,2,[FrSlip]Panthère,2669,175,5,7,12,41.7%,19m
27061,2,TEG,2669,116,5,7,12,41.7%,24m
27061,2,CFSilver,2669,158,5,19,24,20.8%,15m
27061,2,[RoTe]HappyRoach,2669,94,4,1,5,80.0%,27m
27061,1,Illo,2669,115,4,5,9,44.4%,13m
27061,2,Némésis,2669,32,2,0,2,100.0%,1h
27061,3,BillieJean,2669,0,2,2,4,50.0%,13m
27061,3,Smoker,2669,0,2,3,5,40.0%,35m
27061,3,Riskon,2669,0,2,3,5,40.0%,17m
27061,1,Daarken,2669,128,2,5,7,28.6%,15m
27099,3,hunk,2668,1441,186,181,367,50.7%,3m
27099,2,elgringo,2668,678,26,21,47,55.3%,3m
27099,1,David,2668,459,21,16,37,56.8%,5m
27099,1,lllllllllll,2668,518,20,20,40,50.0%,6m
27099,1,dhl,2668,235,19,15,34,55.9%,34m
27099,1,[LIQUID]Squirtonit,2668,518,17,18,35,48.6%,24m
27099,1,Hicks,2668,420,16,10,26,61.5%,7m
27099,3,MATEUSZ,2668,418,14,18,32,43.8%,4m
27099,1,SPRENGKOPP,2668,271,13,7,20,65.0%,46m
27099,3,Warrior,2668,357,13,15,28,46.4%,18m
27099,1,SvabM,2668,233,8,5,13,61.5%,42m
27099,1,[Solar]AVGAlextheG,2668,225,6,7,13,46.2%,7m
27099,2,Maximality,2668,144,5,4,9,55.6%,45m
27099,1,Rodger,2668,150,5,7,12,41.7%,43m
27099,1,DopingDrone,2668,212,5,8,13,38.5%,32m
27099,2,Popeye,2668,148,4,0,4,100.0%,5m
27099,2,[Tosses]HarryNanoWar,2668,0,4,1,5,80.0%,35m
27099,2,[1FU2]Merenkov,2668,111,4,6,10,40.0%,16m
27099,3,gggggggg,2668,120,4,6,10,40.0%,15m
27099,1,meegyx,2668,122,3,2,5,60.0%,33m
27099,1,SSB,2668,0,3,3,6,50.0%,13m
27099,3,RoughProtoss,2668,95,3,5,8,37.5%,15m
27099,3,[TeamAS]fapapucs,2668,94,3,13,16,18.8%,20m
27099,3,Viaches,2668,0,2,3,5,40.0%,27m
27099,3,Antares,2668,0,2,3,5,40.0%,37m
27099,2,zabor,2668,0,2,3,5,40.0%,32m
27099,2,[NordB]sebbeg,2668,0,1,0,1,100.0%,25m
27099,2,alast,2668,0,1,0,1,100.0%,32m
27099,3,Wairen,2668,0,1,1,2,50.0%,21m
27099,2,РонниКолмэн,2668,0,1,2,3,33.3%,8m
27099,2,CoaxyuM,2668,0,0,1,1,0.0%,20m
27099,2,DeadClubHead,2668,0,0,1,1,0.0%,17m
27099,2,samboets,2668,0,0,1,1,0.0%,18m
27099,1,mangol,2668,0,0,2,2,0.0%,6m
27099,1,Svensk,2668,0,0,5,5,0.0%,1h
27134,3,[MSNTRP]Hexos,2667,1111,331,323,654,50.6%,21m
27134,1,Nick,2667,1680,232,230,462,50.2%,38m
27134,1,tickeditten,2667,1638,154,141,295,52.2%,1h
27134,1,[HWN]Karêdhíumn,2667,1103,52,35,87,59.8%,1h
27134,1,kpectohoceu,2667,1266,46,51,97,47.4%,30m
27134,3,VOO,2667,1188,45,46,91,49.5%,13m
27134,2,Bazzie,2667,910,35,43,78,44.9%,3m
27134,3,hawkan,2667,544,23,30,53,43.4%,23m
27134,1,stewie,2667,671,21,21,42,50.0%,8m
27134,1,Dawra,2667,530,17,15,32,53.1%,15m
27134,1,[MWAF]fulger,2667,393,15,12,27,55.6%,41m
27134,1,KaranD,2667,191,8,9,17,47.1%,1h
27134,2,Gelo,2667,204,7,4,11,63.6%,3m
27134,1,[Malady]lawlaw,2667,223,7,5,12,58.3%,34m
27134,3,[mfixed]LoczekKSC,2667,195,5,10,15,33.3%,9m
27134,1,Garfield,2667,0,4,2,6,66.7%,1h
27134,1,BlackCanary,2667,130,4,3,7,57.1%,41m
27134,2,CelineTEPU,2667,128,4,6,10,40.0%,32m
27134,2,[Gоld]twentYSeven,2667,90,3,1,4,75.0%,20m
27134,3,PenOlz,2667,0,3,2,5,60.0%,45m
27134,1,Bonc,2667,119,3,2,5,60.0%,45m
27134,2,fku,2667,0,3,2,5,60.0%,27m
27134,1,Otec,2667,76,3,3,6,50.0%,16m
27134,1,BeeMaster,2667,112,3,8,11,27.3%,49m
27134,3,kalizimbo,2667,0,2,3,5,40.0%,41m
27134,2,LazyTurtel,2667,0,2,3,5,40.0%,1h
27134,2,WolFeaR,2667,93,1,1,2,50.0%,47m
27134,2,[Krusti]oggzzz,2667,46,1,3,4,25.0%,1h
27134,1,[IBIZA]Frankiefunk,2667,0,1,3,4,25.0%,40m
27134,2,Blackbird,2667,0,0,1,1,0.0%,32m
27134,2,Groot,2667,0,0,1,1,0.0%,10m
27134,2,elcobra,2667,0,0,1,1,0.0%,37m
27134,2,Toroan,2667,0,0,1,1,0.0%,32m
27134,3,DISCARDED,2667,0,0,1,1,0.0%,5m
27134,1,fly,2667,0,0,3,3,0.0%,25m
27169,1,ArquiRaVeN,2666,1443,129,121,250,51.6%,40m
27169,1,zubKevlo,2666,1468,60,50,110,54.5%,1h
27169,1,[mfixed]DrKretes,2666,594,28,16,44,63.6%,38m
27169,3,xxWarlord,2666,501,26,28,54,48.1%,5m
27169,2,ParaDiGm,2666,485,20,12,32,62.5%,14m
27169,2,Ray,2666,459,18,24,42,42.9%,17m
27169,2,[Skaro]XAV,2666,435,17,8,25,68.0%,18m
27169,2,Axamiya,2666,424,16,12,28,57.1%,46m
27169,3,Rainor,2666,422,15,22,37,40.5%,17m
27169,2,CyTaylor,2666,410,14,13,27,51.9%,13m
27169,1,Dalus,2666,290,13,9,22,59.1%,21m
27169,1,Mon,2666,349,13,12,25,52.0%,26m
27169,3,starlord,2666,290,11,10,21,52.4%,4m
27169,2,Raven,2666,328,11,11,22,50.0%,41m
27169,1,PAVEL,2666,78,6,7,13,46.2%,34m
27169,2,LeCorbusier,2666,135,5,5,10,50.0%,14m
27169,1,[Lagoon]LogiC,2666,114,4,4,8,50.0%,34m
27169,1,Андрей,2666,76,4,5,9,44.4%,39m
27169,1,Lamko,2666,171,4,11,15,26.7%,14m
27169,3,ElRey,2666,0,3,5,8,37.5%,13m
27169,3,[WNTR]Light,2666,0,2,3,5,40.0%,50m
27169,1,ExStreamIso,2666,0,2,4,6,33.3%,25m
27169,3,[ƬC]Marys,2666,38,1,7,8,12.5%,29m
27169,2,Ilda,2666,0,0,1,1,0.0%,3m
27169,1,Skint,2666,0,0,2,2,0.0%,1h
27194,3,void,2665,1319,135,121,256,52.7%,22m
27194,3,Jari,2665,1159,113,100,213,53.1%,22m
27194,3,[U19]Soldatich,2665,880,48,46,94,51.1%,19m
27194,1,Dan,2665,642,21,21,42,50.0%,40m
27194,3,[vedV]floddee,2665,565,21,21,42,50.0%,4m
27194,2,[RBlood]bomberman,2665,496,20,22,42,47.6%,9m
27194,1,DogsGang,2665,269,19,19,38,50.0%,50m
27194,2,[Mądry]Goldimaksvel,2665,398,15,13,28,53.6%,42m
27194,1,[Entrop]Heretic,2665,424,15,15,30,50.0%,25m
27194,3,Blackeagle,2665,358,13,15,28,46.4%,7m
27194,3,Doctoss,2665,322,12,12,24,50.0%,10m
27194,1,[Still]MrMagOo,2665,283,10,17,27,37.0%,49m
27194,1,LanCuster,2665,266,9,9,18,50.0%,16m
27194,1,ДжонСмит,2665,216,8,7,15,53.3%,38m
27194,2,[4SALE]SISKIN,2665,139,6,3,9,66.7%,1h
27194,1,Koltira,2665,230,6,10,16,37.5%,1h
27194,3,[Burla]Starvind,2665,182,5,6,11,45.5%,24m
27194,1,[HZeS]vitalii,2665,100,5,6,11,45.5%,1h
27194,2,Max,2665,94,3,3,6,50.0%,14m
27194,2,[lOoOl]Pengsoo,2665,30,2,0,2,100.0%,27m
27194,2,Luciy,2665,58,2,1,3,66.7%,49m
27194,2,[BrothW]SPaiDyR,2665,60,2,3,5,40.0%,27m
27194,2,DDWW,2665,62,2,3,5,40.0%,45m
27194,2,Bullba,2665,0,2,3,5,40.0%,32m
27194,2,BETEPAH,2665,0,1,0,1,100.0%,43m
27194,2,[bBbg7]DerFufuPrinz,2665,0,1,0,1,100.0%,9m
27194,1,xamas,2665,36,1,3,4,25.0%,16m
27194,2,aoletsgo,2665,0,0,1,1,0.0%,27m
27194,1,[StatsF]PashaF,2665,0,0,3,3,0.0%,1h
27223,3,Orkan,2664,647,126,112,238,52.9%,30m
27223,3,Terminator,2664,1476,96,95,191,50.3%,15m
27223,3,killian,2664,1491,95,84,179,53.1%,4m
27223,1,winstrol,2664,1192,50,46,96,52.1%,13m
27223,1,kseroys,2664,1109,48,31,79,60.8%,28m
27223,3,Scat,2664,986,45,42,87,51.7%,6m
27223,3,эпичнаямышь,2664,338,28,30,58,48.3%,7m
27223,1,[SClaws]Asvert,2664,589,18,20,38,47.4%,8m
27223,1,gambit,2664,412,16,15,31,51.6%,9m
27223,1,Dunadan,2664,345,9,9,18,50.0%,28m
27223,3,Farinha,2664,64,6,2,8,75.0%,5m
27223,1,[borito]XcotA,2664,218,6,11,17,35.3%,44m
27223,1,DrProfNo,2664,178,5,9,14,35.7%,9m
27223,1,Cocolisso,2664,153,4,3,7,57.1%,1h
27223,3,QueenOfRoses,2664,0,4,3,7,57.1%,13m
27223,1,nicupeda,2664,64,4,5,9,44.4%,1h
27223,3,Vergil,2664,44,3,4,7,42.9%,30m
27223,3,IIIIIIIIIIII,2664,42,3,4,7,42.9%,36m
27223,1,WooXTeR,2664,94,3,5,8,37.5%,37m
27223,2,Chrisi,2664,96,2,0,2,100.0%,48m
27223,1,Raven,2664,40,2,2,4,50.0%,1h
27223,1,CrownClown,2664,36,2,3,5,40.0%,12m
27223,2,HardMashina,2664,109,2,3,5,40.0%,3m
27223,3,HarmfulLife,2664,0,1,1,2,50.0%,27m
27223,3,Bymbochka,2664,0,1,2,3,33.3%,22m
27223,1,rsh,2664,40,1,5,6,16.7%,1h
27223,2,FlexOOSEMЪ,2664,0,0,1,1,0.0%,41m
27250,1,FOKAT,2663,1603,148,139,287,51.6%,33m
27250,1,[KSMH]DatciK,2663,927,40,42,82,48.8%,38m
27250,3,Happytas,2663,689,27,30,57,47.4%,18m
27250,3,RedDolphiN,2663,377,16,19,35,45.7%,16m
27250,2,lorak,2663,336,13,16,29,44.8%,14m
27250,2,infuzoria,2663,298,10,12,22,45.5%,1h
27250,2,Gauda,2663,163,7,7,14,50.0%,1h
27250,3,Bizon,2663,159,6,4,10,60.0%,23m
27250,1,slapEMup,2663,149,6,9,15,40.0%,13m
27250,3,TadarOne,2663,216,6,11,17,35.3%,13m
27250,3,SKGhost,2663,147,6,13,19,31.6%,16m
27250,1,[SkBG]RajBanek,2663,240,6,13,19,31.6%,24m
27250,1,[KRAMPF]derGott,2663,146,5,3,8,62.5%,45m
27250,3,prankroker,2663,30,5,5,10,50.0%,4m
27250,2,Eric,2663,60,3,0,3,100.0%,5m
27250,1,Gromgt,2663,80,3,5,8,37.5%,35m
27250,2,Pepe,2663,0,2,3,5,40.0%,16m
27250,2,[QTclub]Medix,2663,0,2,3,5,40.0%,27m
27250,2,Lowershadow,2663,0,1,0,1,100.0%,46m
27250,2,Madrolling,2663,44,1,1,2,50.0%,40m
27250,3,Hellfire,2663,42,1,1,2,50.0%,13m
27250,1,OGsugafree,2663,0,1,2,3,33.3%,1h
27250,2,Snow,2663,0,1,4,5,20.0%,50m
27250,1,Shaggy,2663,0,1,4,5,20.0%,24m
27250,3,ChekPoint,2663,0,1,4,5,20.0%,1h
27250,1,zeot,2663,0,1,5,6,16.7%,9m
27250,2,[Kage]Murdock,2663,0,0,1,1,0.0%,47m
27250,2,KaQi,2663,0,0,1,1,0.0%,32m
27250,3,kosmokalli,2663,0,0,1,1,0.0%,24m
27250,2,AlexeiStukov,2663,0,0,1,1,0.0%,43m
27250,1,[TSP420]Leprechaun,2663,0,0,2,2,0.0%,34m
27250,1,bENnyBOi,2663,0,0,3,3,0.0%,1h
27282,1,Juger,2662,1011,141,130,271,52.0%,8m
27282,1,blackroach,2662,1461,111,106,217,51.2%,34m
27282,1,Andreea,2662,994,54,51,105,51.4%,34m
27282,1,[Dev667]Guardian,2662,779,45,43,88,51.1%,25m
27282,2,Scarecrow,2662,442,18,9,27,66.7%,32m
27282,3,Sescenarius,2662,447,15,21,36,41.7%,23m
27282,2,[Apoka1]Sergo,2662,394,14,8,22,63.6%,37m
27282,1,SuperSonics,2662,346,11,8,19,57.9%,35m
27282,1,[REBLSZ]FlashPenguin,2662,317,10,14,24,41.7%,25m
27282,3,stimk,2662,273,10,15,25,40.0%,10m
27282,2,[KUKA]kela,2662,234,9,5,14,64.3%,37m
27282,1,Hüthüt,2662,188,8,9,17,47.1%,32m
27282,2,[FBng]nes,2662,113,6,2,8,75.0%,18m
27282,1,SokolPL,2662,216,6,6,12,50.0%,30m
27282,1,[THANOS]RAYMANKAPEEN,2662,176,6,6,12,50.0%,44m
27282,1,CyberVeteran,2662,200,6,6,12,50.0%,35m
27282,2,Rilexeon,2662,179,5,4,9,55.6%,1h
27282,2,fussy,2662,150,5,5,10,50.0%,14m
27282,1,FellowCitize,2662,144,5,8,13,38.5%,4m
27282,1,Mashiro,2662,88,4,3,7,57.1%,19m
27282,2,[Drunk9]PoppyTheBoss,2662,58,3,0,3,100.0%,10m
27282,1,Cartman,2662,122,3,2,5,60.0%,41m
27282,3,[SZH]fedyanic,2662,38,3,4,7,42.9%,24m
27282,3,canonzoom,2662,38,3,4,7,42.9%,30m
27282,1,legion,2662,0,3,6,9,33.3%,23m
27282,2,Mukpo,2662,30,2,0,2,100.0%,41m
27282,2,[СОСK]АПАСНЫЙ,2662,92,2,1,3,66.7%,31m
27282,3,[VaCa]Azy,2662,0,2,3,5,40.0%,38m
27282,3,[TheBFC]Sers,2662,0,2,3,5,40.0%,24m
27282,3,Acanthite,2662,0,2,3,5,40.0%,50m
27282,3,Gosydarenkov,2662,0,2,3,5,40.0%,34m
27282,2,drakey,2662,30,2,5,7,28.6%,8m
27282,2,[ATMO]MrAlex,2662,0,1,0,1,100.0%,49m
27282,3,Gestor,2662,36,1,1,2,50.0%,1h
27282,2,ilbech,2662,30,1,1,2,50.0%,36m
27282,3,Dogorin,2662,0,1,7,8,12.5%,7m
27282,2,[FHIAT]GodEmperor,2662,0,0,1,1,0.0%,40m
27282,1,[sofas]vinni,2662,0,0,2,2,0.0%,23m
27282,1,Fatboyswim,2662,0,0,2,2,0.0%,37m
27282,3,[Kovaci]Guts,2662,0,0,2,2,0.0%,4m
27322,2,BillyBounce,2661,1296,140,122,262,53.4%,1h
27322,3,Nathair,2661,1530,133,140,273,48.7%,9m
27322,3,[NetGG]Pumbaa,2661,1346,90,74,164,54.9%,4m
27322,3,Tklz,2661,861,86,101,187,46.0%,23m
27322,1,JAZZ,2661,1430,84,71,155,54.2%,15m
27322,3,KptPałkarz,2661,586,59,56,115,51.3%,13m
27322,1,Kafka,2661,473,29,23,52,55.8%,1h
27322,2,Avocadonis,2661,441,26,11,37,70.3%,20m
27322,1,Daka,2661,561,24,14,38,63.2%,37m
27322,1,Heisenzerg,2661,391,21,19,40,52.5%,34m
27322,1,egoq,2661,350,10,9,19,52.6%,27m
27322,2,[MFDP]Thor,2661,226,9,2,11,81.8%,1h
27322,1,llllllllllll,2661,268,9,10,19,47.4%,7m
27322,1,[Bifire]Larviter,2661,110,7,5,12,58.3%,23m
27322,1,mkkolibri,2661,129,6,4,10,60.0%,1h
27322,1,JagHasie,2661,217,5,4,9,55.6%,34m
27322,2,[NOT1ME]IceMan,2661,157,5,6,11,45.5%,1h
27322,1,YKTcas,2661,143,4,4,8,50.0%,41m
27322,1,PixelTrooper,2661,130,3,4,7,42.9%,25m
27322,2,Миша,2661,60,2,1,3,66.7%,4m
27322,1,Gilbertbates,2661,126,2,3,5,40.0%,1h
27322,3,YASb,2661,0,2,3,5,40.0%,1h
27322,3,Steeleague,2661,0,2,3,5,40.0%,38m
27322,3,Senpai,2661,0,1,2,3,33.3%,25m
27322,2,seasonsunny,2661,0,0,1,1,0.0%,46m
27322,2,[TCC]Linus,2661,0,0,2,2,0.0%,25m
27348,1,Elanclar,2660,650,80,72,152,52.6%,20m
27348,1,niemand,2660,1489,68,57,125,54.4%,31m
27348,1,BARBARIAN,2660,1396,67,63,130,51.5%,16m
27348,1,Blauci,2660,641,38,34,72,52.8%,34m
27348,1,[lBSGl]Maksim,2660,797,36,37,73,49.3%,1h
27348,1,pikipanda,2660,616,29,16,45,64.4%,45m
27348,3,PlusUltra,2660,523,25,29,54,46.3%,13m
27348,2,kalti,2660,585,20,17,37,54.1%,28m
27348,1,PayBooM,2660,539,17,17,34,50.0%,1h
27348,1,Fizi,2660,532,17,18,35,48.6%,1h
27348,1,Leron,2660,351,11,10,21,52.4%,28m
27348,2,Pat,2660,262,10,6,16,62.5%,1h
27348,1,EvilMonkey,2660,280,9,10,19,47.4%,34m
27348,1,[VWaile]PlayAgro,2660,250,8,9,17,47.1%,1h
27348,1,[GGOW]Darquess,2660,263,8,10,18,44.4%,32m
27348,2,YEYKO,2660,182,6,4,10,60.0%,28m
27348,1,karamBa,2660,0,4,2,6,66.7%,1h
27348,2,Firarjulen,2660,46,4,6,10,40.0%,24m
27348,2,[TOFG]Galaxy,2660,60,3,1,4,75.0%,16m
27348,2,Nebuar,2660,86,3,1,4,75.0%,10m
27348,1,dimonche,2660,82,3,4,7,42.9%,31m
27348,2,[ANREN]Ivan,2660,32,2,0,2,100.0%,50m
27348,3,BeerZerg,2660,0,2,3,5,40.0%,10m
27348,2,Purplewolf,2660,0,2,3,5,40.0%,41m
27348,2,TommyT,2660,0,2,3,5,40.0%,1h
27348,1,МойГосподин,2660,0,1,0,1,100.0%,1h
27348,1,BlackRider,2660,0,1,1,2,50.0%,32m
27348,3,Naonack,2660,0,1,4,5,20.0%,1h
27348,2,porter,2660,0,0,1,1,0.0%,5m
27377,3,Schua,2659,1015,156,143,299,52.2%,17m
27377,1,Nikon,2659,1304,58,56,114,50.9%,1h
27377,1,NoobRace,2659,497,42,36,78,53.8%,44m
27377,3,aki,2659,406,32,29,61,52.5%,13m
27377,1,[AlDS]Ivarus,2659,943,32,34,66,48.5%,24m
27377,3,Cyberdriver,2659,807,30,41,71,42.3%,6m
27377,1,Denward,2659,586,20,17,37,54.1%,19m
27377,1,[DomPre]https,2659,330,17,14,31,54.8%,34m
27377,1,Squeez,2659,408,13,15,28,46.4%,1h
27377,2,Hydra,2659,318,12,9,21,57.1%,36m
27377,1,SonGoku,2659,32,5,3,8,62.5%,25m
27377,1,skipper,2659,134,5,3,8,62.5%,31m
27377,1,[HASTER]CumLord,2659,171,5,4,9,55.6%,1h
27377,3,Странница,2659,30,5,4,9,55.6%,4m
27377,1,Norenau,2659,176,5,5,10,50.0%,15m
27377,2,Slâve,2659,142,5,6,11,45.5%,32m
27377,2,luckytiger,2659,0,4,1,5,80.0%,17m
27377,1,MareKa,2659,95,3,4,7,42.9%,19m
27377,2,Choy,2659,30,2,0,2,100.0%,48m
27377,2,Mdk,2659,34,2,0,2,100.0%,9m
27377,2,RANDOM,2659,32,2,0,2,100.0%,36m
27377,3,wulf,2659,0,2,3,5,40.0%,1h
27377,2,xiou,2659,0,2,3,5,40.0%,32m
27377,2,[MSVB]Zabironin,2659,0,1,0,1,100.0%,13m
27377,2,ALEXEY,2659,0,1,0,1,100.0%,5m
27377,1,LateTuho,2659,94,1,2,3,33.3%,38m
27377,2,DoKadjit,2659,46,1,2,3,33.3%,38m
27377,2,somsocka,2659,96,1,3,4,25.0%,27m
27377,3,TrashCan,2659,42,1,5,6,16.7%,47m
27377,3,[Igloo]jarsenick,2659,0,0,1,1,0.0%,1h
27377,2,SCIIFool,2659,0,0,1,1,0.0%,22m
27377,2,Azazel,2659,0,0,1,1,0.0%,37m
27377,2,miracl,2659,0,0,1,1,0.0%,1h
27377,2,Firevd,2659,0,0,1,1,0.0%,32m
27377,1,shadow,2659,0,0,2,2,0.0%,8m
27377,1,psychedelic,2659,0,0,4,4,0.0%,12m
27413,3,[DucK]SpaceDucK,2658,1016,48,51,99,48.5%,10m
27413,3,[Rakia]MindStorm,2658,912,47,47,94,50.0%,7m
27413,1,theripper,2658,1132,38,41,79,48.1%,31m
27413,1,Adep,2658,849,33,26,59,55.9%,7m
27413,2,polyforaz,2658,864,32,45,77,41.6%,6m
27413,2,ХитрыйСтраус,2658,604,25,14,39,64.1%,1h
27413,1,Nilsen,2658,603,25,19,44,56.8%,13m
27413,1,Glebchik,2658,688,25,27,52,48.1%,37m
27413,1,Napoleon,2658,427,18,11,29,62.1%,12m
27413,1,InstaLol,2658,366,12,13,25,48.0%,1h
27413,3,Serval,2658,358,12,25,37,32.4%,13m
27413,1,cipochek,2658,204,8,1,9,88.9%,25m
27413,1,MrGrumpy,2658,278,8,7,15,53.3%,25m
27413,3,UltraDen,2658,108,6,3,9,66.7%,15m
27413,3,azherot,2658,60,6,5,11,54.5%,11m
27413,2,MerKnife,2658,195,5,1,6,83.3%,42m
27413,2,Protz,2658,62,3,0,3,100.0%,10m
27413,2,Baituri,2658,131,3,1,4,75.0%,44m
27413,2,[SkeSS]Poomsae,2658,88,3,3,6,50.0%,1h
27413,2,[3SS3NZ]Madara,2658,30,3,4,7,42.9%,37m
27413,2,[ZergsR]СаНчеЛоС,2658,0,3,5,8,37.5%,6m
27413,1,Dava,2658,112,3,7,10,30.0%,28m
27413,3,Zato,2658,0,2,3,5,40.0%,33m
27413,3,urchin,2658,0,2,3,5,40.0%,44m
27413,2,TaNjIrO,2658,0,2,3,5,40.0%,32m
27413,1,[7BEST7]artemmomet,2658,74,2,4,6,33.3%,25m
27413,2,Anarpidor,2658,30,1,2,3,33.3%,4m
27413,2,[PwnC]FoxyWookee,2658,0,0,1,1,0.0%,9m
27413,2,IIIIIIIIIIII,2658,0,0,1,1,0.0%,1h
27413,3,MISHA,2658,0,0,1,1,0.0%,36m
27413,1,Empresslilyy,2658,0,0,4,4,0.0%,8m
27444,3,starlord,2657,1514,158,146,304,52.0%,15m
27444,3,sahgotteshan,2657,1000,153,144,297,51.5%,20m
27444,1,Varifikator,2657,1573,117,102,219,53.4%,46m
27444,2,SpanterX,2657,1558,94,72,166,56.6%,40m
27444,3,Zefir,2657,1531,85,85,170,50.0%,15m
27444,1,Normalt,2657,1517,58,56,114,50.9%,12m
27444,1,Nevermore,2657,896,54,55,109,49.5%,15m
27444,1,Diegochung,2657,928,44,23,67,65.7%,9m
27444,1,darkclay,2657,593,23,18,41,56.1%,34m
27444,1,SAMURAIVAAJA,2657,448,19,13,32,59.4%,41m
27444,1,ObiWKenobi,2657,535,18,16,34,52.9%,20m
27444,3,Redirts,2657,334,12,6,18,66.7%,13m
27444,1,Abermorv,2657,286,11,7,18,61.1%,1h
27444,1,[БУБУБ]Virtuzo,2657,271,9,10,19,47.4%,31m
27444,1,Tepsel,2657,180,6,3,9,66.7%,45m
27444,2,Glaz,2657,179,6,5,11,54.5%,51m
27444,2,Gori,2657,132,6,7,13,46.2%,1h
27444,2,[S70n3D]Kaledzo,2657,90,6,9,15,40.0%,3m
27444,1,Kylar,2657,156,5,2,7,71.4%,42m
27444,3,Linnear,2657,0,3,2,5,60.0%,27m
27444,3,Stalker,2657,0,3,2,5,60.0%,38m
27444,2,Gimago,2657,173,3,6,9,33.3%,42m
27444,1,Greg,2657,76,3,7,10,30.0%,1h
27444,3,Snake,2657,0,2,2,4,50.0%,47m
27444,2,RoscoeDream,2657,60,2,7,9,22.2%,41m
27444,3,Dudelbie,2657,0,1,1,2,50.0%,13m
27444,2,templier,2657,0,1,1,2,50.0%,18m
27444,1,viy,2657,0,1,3,4,25.0%,1h
27444,1,Troptox,2657,40,1,3,4,25.0%,9m
27444,2,Yonas,2657,0,1,3,4,25.0%,47m
27444,2,Jolander,2657,0,0,1,1,0.0%,21m
27444,2,[VoidDr]HangmanЯр,2657,0,0,1,1,0.0%,32m
27444,2,[GRAND]step,2657,0,0,2,2,0.0%,3m
27444,2,MerPanama,2657,0,0,2,2,0.0%,22m
27444,1,Zippy,2657,0,0,2,2,0.0%,32m
27479,2,[SoAp]Myszcz,2656,1392,104,101,205,50.7%,1h
27479,2,plamvisuals,2656,631,53,51,104,51.0%,1h
27479,1,[MaG6i]Visage,2656,1236,50,45,95,52.6%,28m
27479,2,Hristo,2656,812,37,43,80,46.2%,3m
27479,1,Coeurbrave,2656,820,26,30,56,46.4%,28m
27479,2,Hate,2656,532,19,15,34,55.9%,32m
27479,2,Sanya,2656,489,18,16,34,52.9%,35m
27479,2,Set,2656,411,17,7,24,70.8%,1h
27479,1,ANAKO,2656,318,13,8,21,61.9%,45m
27479,2,Sharktail,2656,376,13,13,26,50.0%,3m
27479,1,[TBFr]Rutra,2656,255,10,6,16,62.5%,38m
27479,2,Root,2656,232,9,0,9,100.0%,49m
27479,1,[oooboy]black,2656,329,9,9,18,50.0%,40m
27479,1,[CuriO]CuriosityO,2656,102,4,5,9,44.4%,8m
27479,2,sourc,2656,117,4,5,9,44.4%,27m
27479,1,GuardFace,2656,168,4,6,10,40.0%,1h
27479,2,Hilps,2656,32,2,0,2,100.0%,32m
27479,2,BabaBui,2656,34,2,2,4,50.0%,23m
27479,3,[RATTIG]Uncoro,2656,0,2,3,5,40.0%,38m
27479,3,davveis,2656,0,2,3,5,40.0%,18m
27479,3,Insurg,2656,0,2,3,5,40.0%,24m
27479,1,Krovn,2656,99,2,5,7,28.6%,12m
27479,3,ReDot,2656,38,1,1,2,50.0%,10m
27479,2,[SPFE]FreeDyc,2656,0,1,1,2,50.0%,51m
27479,1,MrLinoyk,2656,91,1,2,3,33.3%,12m
27479,2,[Waiffu]HunterFox,2656,30,1,2,3,33.3%,13m
27479,1,rabosot,2656,38,1,7,8,12.5%,1h
27479,2,Barabulka,2656,0,0,1,1,0.0%,47m
27479,2,Vyvich,2656,0,0,1,1,0.0%,12m
27508,2,SkiLLer,2655,1157,78,93,171,45.6%,8m
27508,2,зорротул,2655,1339,54,49,103,52.4%,27m
27508,2,Baal,2655,573,24,13,37,64.9%,44m
27508,2,Sparrow,2655,477,24,13,37,64.9%,22m
27508,1,[MarING]TheSnabbis,2655,322,15,13,28,53.6%,1h
27508,3,Alch,2655,210,8,18,26,30.8%,20m
27508,2,Eltarax,2655,174,7,3,10,70.0%,40m
27508,1,Dane,2655,212,7,8,15,46.7%,28m
27508,2,Xey,2655,158,6,5,11,54.5%,49m
27508,1,[EXPCOM]Mielpopss,2655,191,5,5,10,50.0%,1h
27508,2,[ViRuSC]Fox,2655,60,3,1,4,75.0%,1h
27508,3,MäkTILT,2655,40,3,4,7,42.9%,15m
27508,1,Ckopn,2655,0,3,5,8,37.5%,7m
27508,2,Kloper,2655,0,2,3,5,40.0%,4m
27508,1,[KSMAST]LaMoUriS,2655,78,2,6,8,25.0%,35m
27508,2,YouNeedLube,2655,34,1,1,2,50.0%,4m
27508,2,Equalizer,2655,30,1,1,2,50.0%,1h
27508,2,Carpediem,2655,32,1,2,3,33.3%,20m
27508,3,Exellia,2655,0,1,2,3,33.3%,25m
27508,3,Ramuh,2655,0,0,1,1,0.0%,36m
27508,2,[ЗЕRGТV]PycckuuBaHek,2655,0,0,1,1,0.0%,33m
27508,2,TAMADA,2655,0,0,1,1,0.0%,4m
27508,2,Dago,2655,0,0,2,2,0.0%,41m
27508,1,Strelock,2655,0,0,3,3,0.0%,45m
27532,1,SAW,2654,1121,438,440,878,49.9%,9m
27532,1,SPECTRE,2654,978,143,123,266,53.8%,25m
27532,1,[NEaG]TomoVeliki,2654,971,131,119,250,52.4%,9m
27532,3,[DTXCL]zietos,2654,1526,81,87,168,48.2%,8m
27532,3,LiquidAiur,2654,1340,52,53,105,49.5%,7m
27532,1,LEONIDAS,2654,891,32,34,66,48.5%,38m
27532,1,Neow,2654,515,26,20,46,56.5%,9m
27532,3,[N1TDA]GravityStilz,2654,467,19,17,36,52.8%,8m
27532,3,Kurushimasu,2654,355,16,16,32,50.0%,15m
27532,1,[FloFan]ferox,2654,416,15,12,27,55.6%,13m
27532,1,gamabunty,2654,296,12,10,22,54.5%,29m
27532,2,west,2654,308,11,10,21,52.4%,37m
27532,1,НИКИТОС,2654,394,11,18,29,37.9%,1h
27532,2,Krestor,2654,202,8,4,12,66.7%,50m
27532,1,Vetinari,2654,256,8,10,18,44.4%,50m
27532,2,[BWArmy]ProxyMomShip,2654,219,7,3,10,70.0%,16m
27532,1,[KAOTx]Tuonela,2654,151,5,6,11,45.5%,26m
27532,2,pgF,2654,156,4,2,6,66.7%,16m
27532,2,[БУБУБ]Daretze,2654,131,4,4,8,50.0%,3m
27532,2,Arahmid,2654,44,4,5,9,44.4%,1h
27532,1,Cargobiker,2654,156,3,3,6,50.0%,1h
27532,1,Dominlexx,2654,191,3,6,9,33.3%,38m
27532,1,Matachi,2654,78,3,7,10,30.0%,34m
27532,2,Hartwigsen,2654,32,2,0,2,100.0%,3m
27532,1,[СК20]cumshot,2654,30,2,2,4,50.0%,15m
27532,2,Xavis,2654,0,2,3,5,40.0%,35m
27532,2,Peacewind,2654,0,2,3,5,40.0%,22m
27532,1,[VL0rds]VoidMax,2654,42,2,4,6,33.3%,38m
27532,1,Tim,2654,70,2,5,7,28.6%,1h
27532,1,Hayken,2654,0,1,0,1,100.0%,51m
27532,2,[ManA]stevy,2654,30,1,2,3,33.3%,22m
27532,2,Botsia,2654,0,0,1,1,0.0%,27m
27532,1,Rockkickass,2654,0,0,1,1,0.0%,1h
27532,3,ShrimpeH,2654,0,0,4,4,0.0%,1h
27566,2,kroll,2653,1233,76,81,157,48.4%,3m
27566,3,[Desire]Skeat,2653,1320,61,54,115,53.0%,3m
27566,1,LingLing,2653,660,53,34,87,60.9%,9m
27566,1,Napoleon,2653,610,52,46,98,53.1%,37m
27566,3,testit,2653,486,37,37,74,50.0%,12m
27566,1,OmniKai,2653,818,30,26,56,53.6%,16m
27566,3,Patrick,2653,652,30,35,65,46.2%,20m
27566,3,[CОS]Hohol,2653,685,24,31,55,43.6%,6m
27566,2,[Gоld]alex,2653,446,16,13,29,55.2%,1h
27566,1,FRIEND,2653,365,14,9,23,60.9%,24m
27566,2,[TeDeGu]moussaillon,2653,330,14,13,27,51.9%,13m
27566,2,GoVbon,2653,395,14,14,28,50.0%,17m
27566,2,mastermaus,2653,175,8,5,13,61.5%,10m
27566,1,[Какуля]Dogeater,2653,220,7,9,16,43.8%,49m
27566,3,ilya,2653,176,7,10,17,41.2%,7m
27566,1,ZłyTed,2653,186,6,5,11,54.5%,34m
27566,1,DaveyBach,2653,170,5,7,12,41.7%,26m
27566,2,Caslav,2653,80,4,1,5,80.0%,10m
27566,1,Katletonchik,2653,92,3,3,6,50.0%,25m
27566,3,Amit,2653,40,3,4,7,42.9%,15m
27566,2,Didjecte,2653,30,3,4,7,42.9%,41m
27566,3,Reizen,2653,0,2,3,5,40.0%,30m
27566,3,Dignus,2653,0,2,3,5,40.0%,49m
27566,3,Kkwulf,2653,42,2,5,7,28.6%,31m
27566,3,Dennis,2653,0,1,1,2,50.0%,50m
27566,1,Yurgen,2653,38,1,4,5,20.0%,7m
27566,3,[Batmen]PongLenis,2653,0,0,1,1,0.0%,13m
27566,2,Sylvanior,2653,0,0,1,1,0.0%,32m
27566,1,Aykut,2653,0,0,2,2,0.0%,26m
27595,1,Jourdonnais,2652,1493,57,51,108,52.8%,49m
27595,1,Fatnub,2652,704,33,25,58,56.9%,14m
27595,3,YoHan,2652,502,30,28,58,51.7%,22m
27595,2,pashatexnik,2652,510,19,16,35,54.3%,1h
27595,2,PencoBG,2652,424,16,9,25,64.0%,18m
27595,2,DeadOK,2652,406,14,12,26,53.8%,11m
27595,2,MadGodEater,2652,392,14,14,28,50.0%,44m
27595,3,[Ebloid]Scilef,2652,409,14,18,32,43.8%,6m
27595,3,snors,2652,338,13,14,27,48.1%,19m
27595,1,dusse,2652,368,12,10,22,54.5%,23m
27595,1,Khad,2652,309,9,10,19,47.4%,1h
27595,2,Intriga,2652,172,7,3,10,70.0%,41m
27595,2,Smith,2652,149,6,8,14,42.9%,20m
27595,1,Cucumber,2652,152,5,6,11,45.5%,35m
27595,3,[WWJIM]Yivo,2652,97,4,2,6,66.7%,28m
27595,3,Nemesis,2652,38,4,3,7,57.1%,16m
27595,1,Omni,2652,142,4,8,12,33.3%,48m
27595,2,neznaika,2652,62,3,3,6,50.0%,38m
27595,2,ТеронRU,2652,0,2,3,5,40.0%,19m
27595,3,SEPTIM,2652,0,2,3,5,40.0%,27m
27595,3,[Connor]Atlantis,2652,0,2,3,5,40.0%,38m
27595,1,Damager,2652,0,2,4,6,33.3%,1h
27595,1,cookie,2652,42,2,5,7,28.6%,50m
27595,3,IIIIIIIIIIII,2652,0,1,0,1,100.0%,13m
27595,2,Onokot,2652,32,1,1,2,50.0%,17m
27595,1,Martin,2652,0,1,3,4,25.0%,20m
27595,1,Venom,2652,0,0,1,1,0.0%,1h
27595,2,Algorithm,2652,0,0,1,1,0.0%,3m
27595,2,Дензл,2652,0,0,1,1,0.0%,28m
27595,2,GrumpyKitten,2652,0,0,2,2,0.0%,40m
27625,1,Boss,2651,1267,153,144,297,51.5%,9m
27625,2,Voo,2651,1418,62,58,120,51.7%,44m
27625,3,EvveJ,2651,1386,53,57,110,48.2%,6m
27625,1,[Deleam]Artem,2651,850,52,40,92,56.5%,20m
27625,2,Halduvafar,2651,318,44,11,55,80.0%,44m
27625,2,Furner,2651,720,41,25,66,62.1%,44m
27625,2,Eran,2651,618,35,4,39,89.7%,44m
27625,1,[SPGU]Drakaris,2651,1025,35,34,69,50.7%,40m
27625,1,Sat,2651,582,20,23,43,46.5%,41m
27625,1,BobRobertson,2651,198,18,11,29,62.1%,28m
27625,1,[grimgr]icedregon,2651,502,14,20,34,41.2%,1h
27625,2,LosLosLos,2651,238,9,6,15,60.0%,1h
27625,2,Hackerjonger,2651,189,8,7,15,53.3%,23m
27625,2,Cherrioes,2651,201,7,7,14,50.0%,42m
27625,1,ПРИЗРАК,2651,174,7,7,14,50.0%,16m
27625,1,[Zakel]Danarion,2651,246,7,8,15,46.7%,6m
27625,3,Beloz,2651,124,7,10,17,41.2%,13m
27625,1,Funzzy,2651,257,7,11,18,38.9%,15m
27625,2,kvas,2651,148,6,2,8,75.0%,41m
27625,2,[nan]Insane,2651,184,6,6,12,50.0%,1h
27625,1,DenDen,2651,187,6,7,13,46.2%,13m
27625,3,Naszer,2651,78,5,3,8,62.5%,34m
27625,1,Yngi,2651,146,5,6,11,45.5%,1h
27625,2,charlie,2651,126,4,1,5,80.0%,19m
27625,2,Iceman,2651,46,4,5,9,44.4%,13m
27625,2,iceFR,2651,94,3,4,7,42.9%,31m
27625,1,[RRQ]SDi,2651,108,3,6,9,33.3%,1h
27625,1,Dukester,2651,118,3,8,11,27.3%,1h
27625,2,Тихо,2651,30,2,0,2,100.0%,13m
27625,2,[EXOS]Kgeri,2651,95,2,2,4,50.0%,14m
27625,2,Immortal,2651,0,2,3,5,40.0%,3m
27625,2,[743]Omgitsyou,2651,0,2,3,5,40.0%,3m
27625,2,bobr,2651,0,2,3,5,40.0%,16m
27625,2,GenJi,2651,46,2,4,6,33.3%,14m
27625,2,frayas,2651,32,1,3,4,25.0%,44m
27625,2,[TCRo]San,2651,0,0,1,1,0.0%,41m
27625,3,[B3N1i]SeanTheGreat,2651,0,0,1,1,0.0%,15m
27625,3,Scarecrow,2651,0,0,1,1,0.0%,7m
27625,2,Fireffin,2651,0,0,1,1,0.0%,27m
27625,2,Prostrat,2651,0,0,1,1,0.0%,45m
27625,3,Woldi,2651,0,0,1,1,0.0%,42m
27666,3,Hesiod,2650,1309,77,85,162,47.5%,8m
27666,1,[xPAPPA]Generalen,2650,1687,66,66,132,50.0%,29m
27666,1,[mfixed]Odlot,2650,1130,56,48,104,53.8%,41m
27666,1,Icchansan,2650,837,56,57,113,49.6%,6m
27666,1,Moska,2650,738,32,37,69,46.4%,16m
27666,2,xobbit,2650,506,20,14,34,58.8%,41m
27666,2,ovigomy,2650,534,20,17,37,54.1%,19m
27666,2,Mikrorul,2650,317,14,7,21,66.7%,32m
27666,1,[RsTb]kid,2650,392,12,17,29,41.4%,13m
27666,2,Yoloska,2650,300,11,7,18,61.1%,17m
27666,2,legertes,2650,226,8,5,13,61.5%,17m
27666,1,unearthyone,2650,232,8,12,20,40.0%,49m
27666,1,Warrior,2650,168,7,3,10,70.0%,1h
27666,1,[FFFAST]Natsou,2650,171,7,7,14,50.0%,1h
27666,2,SeiskaPete,2650,90,6,4,10,60.0%,16m
27666,2,Timka,2650,131,5,6,11,45.5%,27m
27666,1,artem,2650,77,4,8,12,33.3%,34m
27666,1,ZORSTEP,2650,106,3,10,13,23.1%,45m
27666,1,sant,2650,114,2,3,5,40.0%,1h
27666,1,[LV]Omuljs,2650,122,2,4,6,33.3%,38m
27666,1,Насяльника,2650,46,2,5,7,28.6%,16m
27666,2,Ranzdalf,2650,0,1,1,2,50.0%,20m
27666,2,danto,2650,96,1,3,4,25.0%,10m
27666,3,Salo,2650,0,0,1,1,0.0%,1h
27666,1,HomE,2650,0,0,2,2,0.0%,48m
27666,2,KraM,2650,0,0,2,2,0.0%,40m
27692,1,[ZVONCE]vidojKO,2649,1541,107,92,199,53.8%,13m
27692,1,ApolloTitan,2649,1437,94,90,184,51.1%,23m
27692,1,Becool,2649,1368,61,55,116,52.6%,1h
27692,1,HeRo,2649,1217,59,43,102,57.8%,40m
27692,1,Atlasyan,2649,952,42,44,86,48.8%,1h
27692,3,Floki,2649,986,37,43,80,46.2%,8m
27692,2,[IBIF]Pat,2649,615,24,17,41,58.5%,1h
27692,2,crazylass,2649,239,21,14,35,60.0%,50m
27692,1,LVA,2649,451,21,18,39,53.8%,44m
27692,2,chester,2649,393,18,15,33,54.5%,33m
27692,1,Alex,2649,432,15,18,33,45.5%,1h
27692,2,BandonBanshe,2649,359,14,11,25,56.0%,41m
27692,3,Crazinezz,2649,368,13,22,35,37.1%,5m
27692,2,Jakobsc,2649,330,11,12,23,47.8%,48m
27692,1,Серёжа,2649,377,11,14,25,44.0%,26m
27692,1,FalkE,2649,140,5,6,11,45.5%,1h
27692,1,Dönerkebab,2649,84,3,4,7,42.9%,1h
27692,1,Kros,2649,114,3,6,9,33.3%,1h
27692,1,[Swappy]Murmelizer,2649,174,3,7,10,30.0%,7m
27692,2,[EBoI]RogalDorn,2649,30,2,0,2,100.0%,11m
27692,2,[Jail]peakling,2649,46,2,0,2,100.0%,1h
27692,2,Bubba,2649,32,2,0,2,100.0%,51m
27692,3,Robochamp,2649,0,2,3,5,40.0%,44m
27692,1,KaJDeC,2649,102,2,3,5,40.0%,14m
27692,2,Goku,2649,0,2,3,5,40.0%,3m
27692,1,Ruggstar,2649,0,2,4,6,33.3%,1h
27692,2,DaFrostMorn,2649,88,2,4,6,33.3%,14m
27692,1,Aiur,2649,88,1,3,4,25.0%,5m
27692,2,[WITCHs]Muckitos,2649,0,0,1,1,0.0%,20m
27692,2,[BoTu]SLINSON,2649,0,0,1,1,0.0%,11m
27692,1,[nwby]BrowniexSwTs,2649,0,0,3,3,0.0%,1h
27692,1,Drey,2649,0,0,3,3,0.0%,40m
27724,1,JayB,2648,1624,103,102,205,50.2%,40m
27724,1,Zasz,2648,351,29,25,54,53.7%,16m
27724,1,Moepgetier,2648,593,28,24,52,53.8%,28m
27724,1,raiN,2648,359,20,26,46,43.5%,16m
27724,2,Siegfried,2648,572,18,37,55,32.7%,30m
27724,1,ArcticMonkey,2648,427,14,13,27,51.9%,1h
27724,1,[СИЛА]den,2648,470,13,21,34,38.2%,22m
27724,1,[NoMczZ]tontsa,2648,367,12,11,23,52.2%,49m
27724,2,MrsPerchiks,2648,244,10,7,17,58.8%,47m
27724,2,Albertfour,2648,282,9,5,14,64.3%,19m
27724,1,[BZIG]coupe,2648,251,9,5,14,64.3%,26m
27724,2,pRemi,2648,238,8,8,16,50.0%,27m
27724,3,Shumbatron,2648,134,8,13,21,38.1%,22m
27724,1,PowerPleb,2648,176,7,10,17,41.2%,23m
27724,2,SpiritJay,2648,182,6,0,6,100.0%,3m
27724,1,Silicium,2648,182,6,9,15,40.0%,1h
27724,2,Sharkop,2648,156,5,7,12,41.7%,6m
27724,3,[ZaG]CousCous,2648,193,4,6,10,40.0%,1h
27724,2,JWellz,2648,0,3,0,3,100.0%,48m
27724,2,Keranon,2648,113,3,5,8,37.5%,1h
27724,3,RaimakeRrhrh,2648,121,2,2,4,50.0%,21m
27724,2,[WhyNot]Popkoz,2648,0,2,3,5,40.0%,1h
27724,3,XeliX,2648,0,2,3,5,40.0%,42m
27724,2,Zephyr,2648,0,2,3,5,40.0%,22m
27724,1,VanaTallinn,2648,145,2,5,7,28.6%,4m
27724,2,[Tahery]VADIM,2648,0,1,0,1,100.0%,5m
27724,2,ggwpez,2648,0,1,0,1,100.0%,45m
27724,1,[xFire]Tssuki,2648,36,1,3,4,25.0%,34m
27724,2,[RPro]HAV,2648,0,0,1,1,0.0%,44m
27724,2,ZlotyZbik,2648,0,0,1,1,0.0%,33m
27724,3,CruelZ,2648,0,0,1,1,0.0%,13m
27724,3,[OF]Bennizu,2648,0,0,4,4,0.0%,3m
27756,1,DuttyCup,2647,871,135,130,265,50.9%,37m
27756,3,ihih,2647,1519,122,123,245,49.8%,10m
27756,1,Brainwasher,2647,837,117,101,218,53.7%,34m
27756,1,[375785]Ufo,2647,1631,90,78,168,53.6%,1h
27756,3,FHC,2647,1421,76,72,148,51.4%,4m
27756,3,Bordiur,2647,1017,65,69,134,48.5%,18m
27756,3,Yellowst,2647,1147,55,49,104,52.9%,9m
27756,1,Joruus,2647,893,38,35,73,52.1%,38m
27756,2,NooboStar,2647,355,35,9,44,79.5%,16m
27756,1,[PDrunk]Gnarky,2647,754,25,27,52,48.1%,20m
27756,1,Minime,2647,435,18,14,32,56.2%,35m
27756,2,DRAGONVA,2647,376,14,11,25,56.0%,29m
27756,1,Untake,2647,407,14,12,26,53.8%,1h
27756,2,Quark,2647,325,13,5,18,72.2%,19m
27756,2,[IceCub]Homut,2647,203,7,6,13,53.8%,41m
27756,2,[ReproT]ZyrO,2647,202,6,3,9,66.7%,41m
27756,2,POStishka,2647,228,6,8,14,42.9%,18m
27756,3,Heziva,2647,186,6,16,22,27.3%,6m
27756,2,Vepr,2647,67,4,3,7,57.1%,1h
27756,2,MaJIou,2647,90,3,3,6,50.0%,1h
27756,2,[Xenoo]WarnSoo,2647,0,3,4,7,42.9%,24m
27756,3,Predator,2647,149,3,6,9,33.3%,3m
27756,2,maksimus,2647,74,2,1,3,66.7%,48m
27756,1,[0TC]Camiki,2647,32,2,3,5,40.0%,49m
27756,1,[SDDDD]ОдинокийСтар,2647,105,2,5,7,28.6%,26m
27756,2,Faxanadu,2647,0,1,0,1,100.0%,46m
27756,2,TUBERSUSLIK,2647,0,1,0,1,100.0%,37m
27756,2,RoodI,2647,30,1,1,2,50.0%,37m
27756,2,Shorty,2647,32,1,1,2,50.0%,27m
27756,2,SvIstoplas,2647,0,1,1,2,50.0%,23m
27756,3,Wolfak,2647,0,1,2,3,33.3%,45m
27756,3,Drogon,2647,0,1,3,4,25.0%,47m
27756,1,PaiNFuL,2647,48,1,4,5,20.0%,3m
27756,3,Julius,2647,32,1,7,8,12.5%,3m
27756,2,яблоко,2647,0,0,1,1,0.0%,41m
27756,2,Allowman,2647,0,0,1,1,0.0%,45m
27756,2,[P6M]Moshthun,2647,0,0,1,1,0.0%,5m
27756,3,[iPain]Decrepifier,2647,0,0,5,5,0.0%,23m
27794,1,[GiBa]GeeGHAXTELUE,2646,1684,108,96,204,52.9%,1h
27794,1,jeza,2646,1601,100,97,197,50.8%,40m
27794,2,cyrlau,2646,1294,44,61,105,41.9%,15m
27794,2,Hronoz,2646,688,33,10,43,76.7%,30m
27794,1,[Zhig]Казак,2646,725,31,23,54,57.4%,22m
27794,3,Palach,2646,438,17,20,37,45.9%,16m
27794,1,BlackZII,2646,401,16,18,34,47.1%,40m
27794,2,starlord,2646,438,15,10,25,60.0%,41m
27794,2,BishBoy,2646,352,14,17,31,45.2%,7m
27794,1,Kauzoo,2646,340,13,14,27,48.1%,9m
27794,2,Tma,2646,323,12,13,25,48.0%,48m
27794,3,mergy,2646,272,10,11,21,47.6%,7m
27794,2,friedchicken,2646,208,9,4,13,69.2%,22m
27794,1,dadon,2646,183,9,5,14,64.3%,16m
27794,1,LizStir,2646,325,9,12,21,42.9%,1h
27794,3,Solyz,2646,228,8,10,18,44.4%,22m
27794,1,carjacker,2646,191,7,9,16,43.8%,17m
27794,2,Araiis,2646,136,6,5,11,54.5%,51m
27794,2,PeioMax,2646,172,6,5,11,54.5%,35m
27794,2,CASHTAN,2646,60,5,4,9,55.6%,40m
27794,2,Stepych,2646,112,4,3,7,57.1%,21m
27794,1,BrainStudio,2646,104,3,2,5,60.0%,12m
27794,1,EzorrD,2646,100,3,9,12,25.0%,7m
27794,2,user,2646,32,2,1,3,66.7%,11m
27794,2,Bars,2646,30,2,2,4,50.0%,10m
27794,1,Pedro,2646,36,2,2,4,50.0%,32m
27794,3,[JaPP]EikFrost,2646,0,2,4,6,33.3%,1h
27794,2,Chronologia,2646,0,1,0,1,100.0%,41m
27794,2,NEETo,2646,0,1,0,1,100.0%,31m
27794,2,uksus,2646,0,1,0,1,100.0%,27m
27794,2,ogityboogity,2646,0,1,2,3,33.3%,49m
27794,2,Kaladin,2646,38,1,2,3,33.3%,45m
27794,1,[HZeS]Dyllarian,2646,36,1,3,4,25.0%,1h
27794,1,Gladiator,2646,0,0,4,4,0.0%,1h
27828,3,Vasya,2645,1297,131,127,258,50.8%,24m
27828,3,DeVarzha,2645,1142,111,94,205,54.1%,11m
27828,1,BreakPoint,2645,759,88,86,174,50.6%,1h
27828,1,Ghenya,2645,954,69,72,141,48.9%,34m
27828,3,[Motisi]LucaBrasi,2645,1125,59,62,121,48.8%,22m
27828,1,[GhStCo]Gaspypote,2645,1136,39,42,81,48.1%,9m
27828,2,vicjens,2645,834,34,20,54,63.0%,20m
27828,2,Ragnarok,2645,812,34,31,65,52.3%,15m
27828,1,ViiPeR,2645,585,23,28,51,45.1%,13m
27828,1,eduard,2645,607,22,23,45,48.9%,1h
27828,2,TerranMan,2645,327,13,12,25,52.0%,50m
27828,1,LUZORS,2645,289,10,10,20,50.0%,40m
27828,1,Amwas,2645,335,10,12,22,45.5%,21m
27828,1,Phiras,2645,222,8,7,15,53.3%,44m
27828,2,TheBoss,2645,205,8,8,16,50.0%,19m
27828,1,[G2]AmeNoKage,2645,158,6,6,12,50.0%,19m
27828,1,POL,2645,154,6,7,13,46.2%,30m
27828,3,Sød,2645,94,6,8,14,42.9%,16m
27828,1,ParadoxMojo,2645,38,5,3,8,62.5%,26m
27828,2,Lorn,2645,178,5,5,10,50.0%,4m
27828,2,sga,2645,134,4,5,9,44.4%,3m
27828,2,Spearlink,2645,0,3,4,7,42.9%,33m
27828,1,[Kingz]MILF,2645,189,3,10,13,23.1%,31m
27828,2,PAPA,2645,62,2,2,4,50.0%,22m
27828,2,TooSeXy,2645,108,2,3,5,40.0%,1h
27828,1,xtdragon,2645,74,2,5,7,28.6%,26m
27828,2,[eisgä]Snegurotshka,2645,0,1,0,1,100.0%,1h
27828,1,Akuma,2645,34,1,4,5,20.0%,34m
27828,3,[CNDs]CoNd,2645,0,0,1,1,0.0%,10m
27828,2,PHOENIX,2645,0,0,1,1,0.0%,42m
27858,1,PértinaxIII,2644,1132,161,127,288,55.9%,1h
27858,1,Tito,2644,1474,96,91,187,51.3%,23m
27858,1,NeyerStokken,2644,936,34,31,65,52.3%,12m
27858,2,vega,2644,767,33,25,58,56.9%,1h
27858,2,Cosbibi,2644,507,27,18,45,60.0%,1h
27858,2,luchok,2644,586,20,20,40,50.0%,1h
27858,3,Maloon,2644,464,20,20,40,50.0%,5m
27858,1,GREG,2644,446,14,15,29,48.3%,44m
27858,2,ZaEkTaHkucT,2644,294,12,5,17,70.6%,30m
27858,2,[S5RTA]Wissian,2644,281,10,8,18,55.6%,32m
27858,2,Festival,2644,262,9,10,19,47.4%,5m
27858,2,ido,2644,259,9,10,19,47.4%,41m
27858,1,DiGrizz,2644,292,9,14,23,39.1%,8m
27858,3,Jester,2644,243,9,14,23,39.1%,1h
27858,2,Dacalia,2644,166,8,8,16,50.0%,5m
27858,2,[POOL8]Keysar,2644,116,5,1,6,83.3%,10m
27858,1,Macheengun,2644,154,5,8,13,38.5%,40m
27858,2,Vortex,2644,172,4,2,6,66.7%,27m
27858,3,[DFgsA]PaPaPrice,2644,0,4,3,7,57.1%,10m
27858,3,[Larjan]Riday,2644,97,3,3,6,50.0%,38m
27858,1,NOAM,2644,48,2,1,3,66.7%,8m
27858,2,[Sadxx]TACO,2644,46,2,2,4,50.0%,13m
27858,2,bipbip,2644,30,2,2,4,50.0%,1h
27858,2,[GodEmp]ivan,2644,0,2,3,5,40.0%,16m
27858,2,[Sande]Squid,2644,0,2,3,5,40.0%,1h
27858,1,[LgMz]Poutipoid,2644,96,2,5,7,28.6%,25m
27858,2,Moriartik,2644,0,1,0,1,100.0%,51m
27858,2,Merigold,2644,0,1,0,1,100.0%,28m
27858,2,Single,2644,0,1,0,1,100.0%,27m
27858,2,xKOTOVSKYx,2644,30,1,3,4,25.0%,50m
27858,2,[420ZA]ParalaXuS,2644,0,0,1,1,0.0%,3m
27858,2,[Бaтьки]Waletta,2644,0,0,1,1,0.0%,26m
27858,2,gerekton,2644,0,0,1,1,0.0%,1h
27858,1,Dellbone,2644,0,0,3,3,0.0%,35m
27892,1,Angelies,2643,1641,98,93,191,51.3%,37m
27892,1,Norbit,2643,1676,70,60,130,53.8%,1h
27892,1,TotoGlions,2643,461,49,51,100,49.0%,45m
27892,2,Rawen,2643,706,27,24,51,52.9%,1h
27892,1,ChaosTheory,2643,669,25,20,45,55.6%,16m
27892,1,[GIMIK]Buczek,2643,265,10,6,16,62.5%,3m
27892,1,TheDuke,2643,226,9,6,15,60.0%,16m
27892,2,[Brocks]Siwawa,2643,206,7,2,9,77.8%,49m
27892,2,Drovosekpidr,2643,221,7,11,18,38.9%,14m
27892,1,Vei,2643,66,5,4,9,55.6%,23m
27892,1,[Meowts]MeowTV,2643,134,5,8,13,38.5%,12m
27892,3,fleckzN,2643,0,4,2,6,66.7%,48m
27892,1,TiaJZ,2643,165,4,3,7,57.1%,1h
27892,3,ILGAMST,2643,0,3,3,6,50.0%,18m
27892,3,SkrimOfNight,2643,94,3,5,8,37.5%,22m
27892,1,Paton,2643,97,3,6,9,33.3%,40m
27892,2,ThG,2643,0,2,3,5,40.0%,22m
27892,2,[ArTr]exterminador,2643,0,2,3,5,40.0%,44m
27892,2,[Kaizar]RoboYummy,2643,0,1,0,1,100.0%,3m
27892,2,CroProGaming,2643,0,1,0,1,100.0%,30m
27892,1,Ledonial,2643,95,1,1,2,50.0%,1h
27892,2,ParenekGG,2643,0,1,1,2,50.0%,41m
27892,3,Pcifir,2643,0,1,3,4,25.0%,16m
27892,2,DENNZ,2643,0,0,1,1,0.0%,28m
27892,2,[Lucky2]LostDead,2643,0,0,1,1,0.0%,46m
27892,2,ANUBIS,2643,0,0,1,1,0.0%,31m
27892,2,Elyth,2643,0,0,2,2,0.0%,45m
27892,1,[Schade]Gonzo,2643,0,0,4,4,0.0%,1h
27920,1,[Меdоеd]Zeratul,2642,1666,311,307,618,50.3%,6m
27920,2,EZHOWWW,2642,1027,106,89,195,54.4%,20m
27920,3,LiamTheNisa,2642,1062,40,48,88,45.5%,9m
27920,1,nkduc,2642,262,32,24,56,57.1%,34m
27920,1,[TBPZDA]ElDistortion,2642,342,12,12,24,50.0%,12m
27920,1,luisenss,2642,214,10,4,14,71.4%,46m
27920,1,bloody,2642,322,10,14,24,41.7%,30m
27920,1,Imbanessy,2642,287,9,7,16,56.2%,4m
27920,2,Arrie,2642,218,7,4,11,63.6%,27m
27920,2,Erri,2642,224,7,7,14,50.0%,41m
27920,1,Atlantis,2642,183,6,7,13,46.2%,34m
27920,1,zar,2642,229,5,6,11,45.5%,40m
27920,3,Ronin,2642,126,5,8,13,38.5%,5m
27920,1,Hex,2642,213,5,10,15,33.3%,26m
27920,3,Nesis,2642,42,3,4,7,42.9%,31m
27920,1,[KAI300]Prelatkill,2642,42,2,1,3,66.7%,28m
27920,2,Mooncake,2642,0,2,3,5,40.0%,49m
27920,2,[XOL]Zmeevik,2642,0,1,1,2,50.0%,21m
27920,1,degorath,2642,89,1,3,4,25.0%,40m
27920,2,Smirky,2642,0,0,1,1,0.0%,1h
27920,2,wasp,2642,0,0,1,1,0.0%,29m
27920,3,Sauron,2642,0,0,1,1,0.0%,24m
27920,2,Canopus,2642,0,0,2,2,0.0%,1h
27920,2,wcttv,2642,0,0,2,2,0.0%,31m
27944,3,Loosing,2641,1540,215,217,432,49.8%,16m
27944,3,sebster,2641,1534,125,118,243,51.4%,10m
27944,1,[RoPRO]shockux,2641,1207,62,45,107,57.9%,39m
27944,2,Schlammi,2641,1068,43,35,78,55.1%,32m
27944,1,bliksem,2641,497,23,16,39,59.0%,1h
27944,1,Hurricane,2641,366,15,14,29,51.7%,1h
27944,3,tawerka,2641,381,14,14,28,50.0%,6m
27944,1,ChangeCaps,2641,274,11,12,23,47.8%,41m
27944,1,gronichon,2641,380,11,16,27,40.7%,1h
27944,1,shadowbad,2641,206,7,5,12,58.3%,25m
27944,1,[RÖÖV]Junas,2641,171,7,8,15,46.7%,32m
27944,3,VFXCode,2641,203,7,9,16,43.8%,6m
27944,2,[АDMIN]Markoff,2641,166,5,0,5,100.0%,3m
27944,2,arisbattlnet,2641,60,5,3,8,62.5%,4m
27944,1,Myst,2641,0,4,2,6,66.7%,1h
27944,3,Ihsahn,2641,30,4,6,10,40.0%,6m
27944,1,Arled,2641,34,3,7,10,30.0%,1h
27944,2,[RonBar]EezyDude,2641,46,2,2,4,50.0%,31m
27944,3,[TLPT]Jeg,2641,0,2,3,5,40.0%,38m
27944,1,AlexNeumann,2641,36,2,3,5,40.0%,28m
27944,2,Ashakku,2641,0,2,3,5,40.0%,19m
27944,3,PhasedFate,2641,0,2,4,6,33.3%,24m
27944,3,aDenIsa,2641,42,2,5,7,28.6%,27m
27944,2,TwoToes,2641,0,1,0,1,100.0%,23m
27944,2,Nomad,2641,0,1,0,1,100.0%,32m
27944,1,Pyp,2641,0,1,2,3,33.3%,32m
27944,1,Левославный,2641,0,1,2,3,33.3%,26m
27944,2,[DIIF]Schmenky,2641,0,0,1,1,0.0%,1h
27944,1,[SUUCE]OliFer,2641,0,0,2,2,0.0%,41m
27944,1,[ULTX]schorsch,2641,0,0,3,3,0.0%,1h
27974,2,OriginalName,2640,1526,135,111,246,54.9%,41m
27974,1,psychol,2640,556,63,51,114,55.3%,30m
27974,1,easysqueezy,2640,494,59,48,107,55.1%,28m
27974,2,Xeto,2640,1026,48,24,72,66.7%,5m
27974,1,schasi,2640,315,33,31,64,51.6%,40m
27974,1,Spacalpig,2640,788,28,31,59,47.5%,21m
27974,1,DansGruber,2640,437,24,29,53,45.3%,48m
27974,1,Sergion,2640,464,21,13,34,61.8%,36m
27974,2,[NBK]PAPPO,2640,350,12,12,24,50.0%,16m
27974,1,overlord,2640,372,12,12,24,50.0%,1h
27974,3,SoHail,2640,294,10,17,27,37.0%,6m
27974,2,Starverwatch,2640,248,9,6,15,60.0%,41m
27974,1,skynik,2640,272,9,8,17,52.9%,19m
27974,2,Кирилл,2640,258,9,11,20,45.0%,1h
27974,3,WhoDatBoy,2640,146,8,5,13,61.5%,6m
27974,1,Bumbe,2640,198,8,11,19,42.1%,29m
27974,2,BlackSea,2640,134,7,6,13,53.8%,16m
27974,3,IIIIIIIII,2640,216,7,16,23,30.4%,16m
27974,2,Teimceper,2640,150,6,2,8,75.0%,49m
27974,2,GoodDog,2640,114,6,2,8,75.0%,15m
27974,1,LeonTrotsky,2640,36,5,3,8,62.5%,41m
27974,2,[AMFs]AlY,2640,116,4,2,6,66.7%,1h
27974,1,solomon,2640,110,4,4,8,50.0%,30m
27974,3,Mephisto,2640,0,3,2,5,60.0%,16m
27974,3,tikondrus,2640,40,3,4,7,42.9%,39m
27974,3,CaroleBaskin,2640,123,3,8,11,27.3%,16m
27974,3,[DET54]Batlegase,2640,97,2,0,2,100.0%,25m
27974,2,rideez,2640,32,2,1,3,66.7%,33m
27974,2,[YSG]Avenger,2640,30,2,1,3,66.7%,1h
27974,2,[InvKit]Eglantina,2640,108,2,1,3,66.7%,32m
27974,2,burjui,2640,0,2,3,5,40.0%,31m
27974,3,xEbo,2640,0,2,3,5,40.0%,13m
27974,3,[Trkrs]Duke,2640,0,1,0,1,100.0%,37m
27974,2,DaEver,2640,30,1,1,2,50.0%,3m
27974,2,Апкурыш,2640,94,1,3,4,25.0%,1h
27974,2,Blender,2640,94,1,3,4,25.0%,38m
27974,1,Cheezynoodle,2640,34,1,3,4,25.0%,1h
28011,3,[ISSOVA]Jingo,2639,1497,174,157,331,52.6%,6m
28011,3,mseven,2639,1207,113,114,227,49.8%,5m
28011,1,NCK,2639,1591,91,72,163,55.8%,44m
28011,2,ezicik,2639,1558,72,57,129,55.8%,21m
28011,1,Red,2639,1480,62,56,118,52.5%,50m
28011,2,SECTORzzzUA,2639,1052,60,48,108,55.6%,17m
28011,1,karsu,2639,907,37,31,68,54.4%,46m
28011,2,sosin,2639,481,24,17,41,58.5%,1h
28011,1,Rebrovsqij,2639,532,24,18,42,57.1%,4m
28011,1,Cyl,2639,656,21,28,49,42.9%,1h
28011,3,[C2E]Edweed,2639,547,18,25,43,41.9%,12m
28011,1,[Кусь]alisher,2639,452,17,12,29,58.6%,1h
28011,2,Feaz,2639,382,16,4,20,80.0%,33m
28011,2,slava,2639,429,16,12,28,57.1%,1h
28011,2,FOX,2639,397,15,10,25,60.0%,41m
28011,3,ShadowDragon,2639,266,12,15,27,44.4%,24m
28011,2,Immortal,2639,250,9,7,16,56.2%,8m
28011,3,StingraY,2639,225,8,10,18,44.4%,4m
28011,2,Helga,2639,200,7,1,8,87.5%,47m
28011,1,[mfixed]Mello,2639,158,5,6,11,45.5%,1h
28011,2,francesco,2639,92,5,6,11,45.5%,47m
28011,2,Ратимир,2639,60,5,8,13,38.5%,4m
28011,2,[tysa]Jeto,2639,86,4,1,5,80.0%,32m
28011,1,innofear,2639,118,3,9,12,25.0%,1h
28011,2,[Hird]Beisfjord,2639,30,2,0,2,100.0%,11m
28011,2,[2o4t]MABUSE,2639,58,2,3,5,40.0%,48m
28011,1,Bisar,2639,36,2,3,5,40.0%,50m
28011,3,MystixW,2639,0,2,3,5,40.0%,30m
28011,3,[PK1]KimmyKrul,2639,0,2,3,5,40.0%,1h
28011,2,cabinetul,2639,0,2,3,5,40.0%,41m
28011,2,MrMB,2639,0,1,0,1,100.0%,10m
28011,2,GodEmperor,2639,0,1,1,2,50.0%,3m
28011,3,Mike,2639,0,0,1,1,0.0%,38m
28011,2,DestroyerPL,2639,0,0,1,1,0.0%,25m
28045,1,Alesh,2638,1122,78,58,136,57.4%,1h
28045,3,Xanthar,2638,672,67,63,130,51.5%,19m
28045,1,florian,2638,1072,52,34,86,60.5%,32m
28045,1,Getman,2638,665,48,42,90,53.3%,37m
28045,2,[GGBOYZ]puckY,2638,794,38,28,66,57.6%,1h
28045,1,[HZeS]nicci,2638,611,28,19,47,59.6%,9m
28045,2,[TagMe]CookedGoose,2638,710,28,26,54,51.9%,28m
28045,1,Lukas,2638,468,23,44,67,34.3%,23m
28045,2,Dimmex,2638,476,18,12,30,60.0%,38m
28045,2,Annonymouse,2638,338,12,7,19,63.2%,33m
28045,2,Denred,2638,230,10,9,19,52.6%,47m
28045,1,Decros,2638,273,9,6,15,60.0%,12m
28045,2,eSkyde,2638,265,9,7,16,56.2%,37m
28045,2,[MCFire]Stormwar,2638,268,8,5,13,61.5%,28m
28045,2,[LEZZO]black,2638,200,6,7,13,46.2%,33m
28045,2,[nepal]Kellahselai,2638,190,5,3,8,62.5%,32m
28045,2,Gajam,2638,122,5,3,8,62.5%,44m
28045,2,Nuc,2638,118,5,7,12,41.7%,19m
28045,3,Alarak,2638,0,4,2,6,66.7%,18m
28045,3,IIIIIIIIIIII,2638,97,3,3,6,50.0%,50m
28045,3,[NSSC2]NeoSab,2638,30,3,5,8,37.5%,4m
28045,2,AnimusCore,2638,0,3,5,8,37.5%,13m
28045,2,[Щитон]Karatel,2638,60,2,2,4,50.0%,42m
28045,3,agriadeschäp,2638,0,2,3,5,40.0%,10m
28045,3,herousson,2638,30,2,4,6,33.3%,16m
28045,2,adunToridas,2638,94,2,4,6,33.3%,16m
28045,3,Dark,2638,0,1,0,1,100.0%,16m
28045,2,lukeanator,2638,0,1,0,1,100.0%,9m
28045,1,huges,2638,38,1,6,7,14.3%,9m
28045,2,[2SG2]KOT,2638,0,0,1,1,0.0%,43m
28045,2,Sandrinolo,2638,0,0,1,1,0.0%,1h
28045,2,Prefekt,2638,0,0,1,1,0.0%,41m
28045,2,DimON,2638,0,0,1,1,0.0%,20m
28045,2,Ragequit,2638,0,0,2,2,0.0%,16m
28079,3,nibos,2637,1452,218,219,437,49.9%,24m
28079,1,Kosmopolit,2637,1689,136,138,274,49.6%,1h
28079,2,Yiseba,2637,603,37,32,69,53.6%,44m
28079,2,LordW,2637,516,32,42,74,43.2%,22m
28079,3,Corroc,2637,668,28,29,57,49.1%,15m
28079,1,STARrussher,2637,432,20,10,30,66.7%,41m
28079,2,yousef,2637,372,14,7,21,66.7%,16m
28079,2,Lily,2637,231,7,5,12,58.3%,33m
28079,2,[Mulluc]TeladiX,2637,128,5,2,7,71.4%,28m
28079,2,[TPCLAN]SvatusCZ,2637,116,5,3,8,62.5%,16m
28079,1,Spleter,2637,124,5,4,9,55.6%,12m
28079,1,BlackDemons,2637,164,4,4,8,50.0%,32m
28079,1,NetFoXZX,2637,135,3,4,7,42.9%,14m
28079,3,[potG]RattPack,2637,42,3,4,7,42.9%,1h
28079,2,ryleFDA,2637,30,2,1,3,66.7%,1h
28079,3,Maxis,2637,0,2,3,5,40.0%,1h
28079,2,SamuraiJack,2637,0,2,3,5,40.0%,1h
28079,3,Firekeeper,2637,0,2,3,5,40.0%,16m
28079,2,[MBite]aden,2637,0,1,0,1,100.0%,30m
28079,3,Richie,2637,0,1,4,5,20.0%,36m
28079,2,HydraD,2637,0,0,1,1,0.0%,1h
28079,2,Umbrella,2637,0,0,1,1,0.0%,22m
28079,3,twocap,2637,0,0,1,1,0.0%,49m
28079,3,[crtssr]Fhutai,2637,0,0,2,2,0.0%,18m
28103,1,LeonDanger,2636,1634,96,88,184,52.2%,4m
28103,1,rki,2636,1562,81,79,160,50.6%,9m
28103,3,neural,2636,1389,75,65,140,53.6%,5m
28103,1,[Crios]Alex,2636,741,59,49,108,54.6%,28m
28103,1,[SJDB]Felon,2636,893,54,41,95,56.8%,17m
28103,1,ZloyDrish,2636,920,39,35,74,52.7%,1h
28103,2,Влад,2636,734,28,23,51,54.9%,15m
28103,1,HCHellspawn,2636,582,21,18,39,53.8%,13m
28103,1,Spartani,2636,431,16,21,37,43.2%,31m
28103,2,[Витязи]Hopeless,2636,359,13,9,22,59.1%,27m
28103,2,Gelos,2636,343,13,12,25,52.0%,41m
28103,2,HighpE,2636,362,12,8,20,60.0%,13m
28103,1,[boși]Poegan,2636,401,12,12,24,50.0%,16m
28103,2,RuBICoN,2636,218,9,4,13,69.2%,20m
28103,3,[SRAM]sRameJlivKo,2636,248,9,14,23,39.1%,4m
28103,2,waciej,2636,251,8,7,15,53.3%,21m
28103,1,Искатель,2636,185,7,8,15,46.7%,19m
28103,2,JoJo,2636,177,5,4,9,55.6%,33m
28103,3,Czarny,2636,60,5,7,12,41.7%,21m
28103,1,[NOo0BS]Adarnok,2636,97,4,6,10,40.0%,1h
28103,3,[MDLB]lNFERNO,2636,0,3,2,5,60.0%,10m
28103,3,DoomDozer,2636,40,3,3,6,50.0%,34m
28103,1,[SMSP]TShot,2636,185,3,12,15,20.0%,1h
28103,2,MrFish,2636,62,2,2,4,50.0%,1h
28103,2,mausl,2636,0,2,3,5,40.0%,49m
28103,2,arhont,2636,0,2,3,5,40.0%,5m
28103,3,Zylin,2636,0,2,3,5,40.0%,5m
28103,2,Redone,2636,62,2,4,6,33.3%,51m
28103,1,[PÂRłAH]DanielCzech,2636,0,1,2,3,33.3%,9m
28103,1,BooM,2636,0,1,2,3,33.3%,37m
28103,1,Flaelli,2636,0,1,3,4,25.0%,50m
28103,1,westo,2636,36,1,5,6,16.7%,9m
28103,2,[LB420]Maintoss,2636,0,0,1,1,0.0%,47m
28103,2,Viva,2636,0,0,1,1,0.0%,27m
28103,1,Omyx,2636,0,0,1,1,0.0%,33m
28103,2,[ELAL]DestroYer,2636,0,0,2,2,0.0%,3m
28103,1,[shiot]Parcode,2636,0,0,3,3,0.0%,13m
28103,1,Колдун,2636,0,0,3,3,0.0%,19m
28141,3,Luras,2635,1046,41,48,89,46.1%,14m
28141,2,Strelok,2635,729,39,19,58,67.2%,3m
28141,2,Easy,2635,514,36,33,69,52.2%,6m
28141,1,[HyCl]polyglot,2635,563,32,35,67,47.8%,44m
28141,2,MarkoKMG,2635,749,30,25,55,54.5%,42m
28141,2,[Ebalay]llllllllllll,2635,701,26,21,47,55.3%,21m
28141,1,HelGo,2635,198,15,20,35,42.9%,50m
28141,2,OddWarrior,2635,328,14,4,18,77.8%,6m
28141,1,[MPD]TopHat,2635,369,14,14,28,50.0%,41m
28141,2,Fuguang,2635,174,11,5,16,68.8%,30m
28141,2,[45silm]KingCZE,2635,230,8,4,12,66.7%,3m
28141,1,Bleakwinner,2635,224,8,6,14,57.1%,26m
28141,2,Dyno,2635,165,6,6,12,50.0%,44m
28141,2,[StrKlr]schlüppa,2635,204,6,8,14,42.9%,31m
28141,2,Doomhammer,2635,90,4,3,7,57.1%,1h
28141,2,Razvan,2635,180,4,5,9,44.4%,16m
28141,1,Jaynestown,2635,188,4,7,11,36.4%,1h
28141,2,[GOAMPU]BlackViper,2635,133,3,3,6,50.0%,49m
28141,3,Soloro,2635,42,3,4,7,42.9%,5m
28141,2,Nico,2635,30,3,4,7,42.9%,18m
28141,3,Jmhilo,2635,121,3,4,7,42.9%,18m
28141,1,Morgan,2635,161,3,7,10,30.0%,42m
28141,2,VitalAnal,2635,32,2,2,4,50.0%,21m
28141,3,[MokerC]DareTex,2635,0,2,3,5,40.0%,31m
28141,3,xaros,2635,0,2,3,5,40.0%,34m
28141,2,Fireball,2635,46,2,4,6,33.3%,39m
28141,2,limon,2635,0,1,1,2,50.0%,16m
28141,2,[GÄYSSS]Maris,2635,0,1,1,2,50.0%,1h
28141,2,Fafer,2635,94,1,3,4,25.0%,40m
28141,1,Dendi,2635,34,1,3,4,25.0%,12m
28141,2,TomBigCat,2635,30,1,3,4,25.0%,49m
28141,2,[ZЕRG7V]АнтихрисТ,2635,0,0,1,1,0.0%,3m
28141,1,WaRmEaTeR,2635,0,0,5,5,0.0%,8m
28174,1,Moped,2634,733,100,92,192,52.1%,40m
28174,2,HiJenkins,2634,1552,99,95,194,51.0%,32m
28174,1,Attar,2634,1327,54,53,107,50.5%,9m
28174,1,HTLV,2634,898,48,36,84,57.1%,19m
28174,2,lehastyles,2634,1109,43,40,83,51.8%,1h
28174,2,Vershok,2634,772,27,28,55,49.1%,3m
28174,3,[VuV]AiGiL,2634,513,19,19,38,50.0%,12m
28174,1,mrBONNYBOO,2634,526,18,23,41,43.9%,26m
28174,3,Harribert,2634,183,16,20,36,44.4%,30m
28174,3,Bamse,2634,439,16,21,37,43.2%,20m
28174,1,bigbossjosh,2634,506,15,15,30,50.0%,46m
28174,1,MRKSArthY,2634,251,14,4,18,77.8%,9m
28174,2,Avasyan,2634,386,14,13,27,51.9%,33m
28174,1,Cichy,2634,312,14,14,28,50.0%,22m
28174,1,Miralika,2634,291,12,8,20,60.0%,1h
28174,1,Modather,2634,201,12,13,25,48.0%,45m
28174,2,AndyTRAMBLEx,2634,319,11,14,25,44.0%,1h
28174,2,[OPStar]Merciful,2634,212,7,1,8,87.5%,41m
28174,1,[SLIWKA]Lukmatem,2634,231,6,6,12,50.0%,1h
28174,1,WooMan,2634,183,6,9,15,40.0%,3m
28174,2,igorti,2634,185,4,4,8,50.0%,1h
28174,2,Barszun,2634,114,4,4,8,50.0%,19m
28174,2,shadow,2634,132,4,5,9,44.4%,11m
28174,2,Lukeavich,2634,92,3,3,6,50.0%,48m
28174,1,Twiggy,2634,91,2,0,2,100.0%,1h
28174,3,Orum,2634,0,2,1,3,66.7%,19m
28174,3,JackW,2634,0,2,3,5,40.0%,25m
28174,1,[MNI]Nipsild,2634,36,2,4,6,33.3%,31m
28174,3,Taïb,2634,30,2,6,8,25.0%,6m
28174,2,[lMGNl]Besposhadnyi,2634,0,1,0,1,100.0%,35m
28174,2,AzrasZuralix,2634,0,1,0,1,100.0%,21m
28174,2,[Gogole]Tenebrume,2634,0,1,0,1,100.0%,1h
28174,1,[HZeS]Dream,2634,0,1,0,1,100.0%,25m
28174,3,Engocaw,2634,0,1,1,2,50.0%,30m
28174,3,Rozgon,2634,0,1,1,2,50.0%,1h
28174,2,Waxat,2634,30,1,1,2,50.0%,44m
28174,3,Fred,2634,0,1,2,3,33.3%,17m
28174,3,Chivas,2634,0,0,8,8,0.0%,23m
28212,1,Marduk,2633,1691,310,275,585,53.0%,14m
28212,3,Yuri,2633,1612,135,136,271,49.8%,23m
28212,2,[Pédoss]seraphime,2633,346,34,26,60,56.7%,33m
28212,2,venox,2633,378,14,9,23,60.9%,1h
28212,2,Sputnik,2633,286,12,9,21,57.1%,1h
28212,1,Faron,2633,210,9,5,14,64.3%,16m
28212,2,[KFSRus]IIIIIIIIIIII,2633,240,9,5,14,64.3%,1h
28212,3,MyTrouble,2633,222,8,10,18,44.4%,4m
28212,1,CrisMobyland,2633,294,7,5,12,58.3%,36m
28212,1,Stim,2633,216,6,7,13,46.2%,21m
28212,1,wert,2633,248,6,8,14,42.9%,49m
28212,1,[PMTM1]krosand,2633,34,6,9,15,40.0%,24m
28212,2,Mas,2633,0,4,1,5,80.0%,28m
28212,3,Спутник,2633,121,4,3,7,57.1%,51m
28212,1,[basdp]Soldier,2633,152,4,5,9,44.4%,1h
28212,2,Ghoran,2633,0,3,2,5,60.0%,19m
28212,3,Hector,2633,0,3,2,5,60.0%,16m
28212,2,xMacieszYN,2633,86,3,4,7,42.9%,49m
28212,2,[nyst]Tormasan,2633,30,2,1,3,66.7%,1h
28212,3,xKyoRo,2633,0,2,3,5,40.0%,38m
28212,2,Flavio,2633,0,2,3,5,40.0%,28m
28212,2,philles,2633,0,2,3,5,40.0%,10m
28212,1,rose,2633,0,2,4,6,33.3%,1h
28212,1,[AAT]kynka,2633,72,2,5,7,28.6%,15m
28212,2,entardio,2633,92,2,6,8,25.0%,1h
28212,2,[dudeki]FERViborg,2633,0,1,0,1,100.0%,19m
28212,2,Bronto,2633,0,1,0,1,100.0%,44m
28212,2,WINDERR,2633,0,1,0,1,100.0%,41m
28212,2,[СЛС]Cortli,2633,0,1,1,2,50.0%,28m
28212,3,kejac,2633,0,1,2,3,33.3%,48m
28212,1,YukiHyou,2633,89,1,4,5,20.0%,16m
28212,2,Jisuly,2633,0,0,1,1,0.0%,1h
28212,1,[WalMez]SGCJackob,2633,0,0,3,3,0.0%,49m
28245,2,mihas,2632,1179,64,50,114,56.1%,1h
28245,1,Zaslot,2632,986,40,38,78,51.3%,1h
28245,2,iGGotchu,2632,930,36,32,68,52.9%,1h
28245,3,[RxxxD]Xerxes,2632,880,32,44,76,42.1%,16m
28245,2,[mcB0ng]niVoque,2632,539,23,12,35,65.7%,17m
28245,2,Lenni,2632,534,20,16,36,55.6%,48m
28245,3,[Teckno]Mahougnon,2632,466,16,24,40,40.0%,6m
28245,2,HugMePls,2632,371,15,5,20,75.0%,16m
28245,1,[ACC]Gromold,2632,422,15,16,31,48.4%,29m
28245,1,ForesterDK,2632,291,13,15,28,46.4%,26m
28245,2,drunk,2632,248,9,4,13,69.2%,51m
28245,2,Desolator,2632,225,7,3,10,70.0%,21m
28245,2,Luminary,2632,166,5,2,7,71.4%,49m
28245,2,NegatiV,2632,167,5,6,11,45.5%,42m
28245,1,gaming,2632,153,4,8,12,33.3%,38m
28245,2,Легат,2632,60,3,0,3,100.0%,45m
28245,2,[GML]Stalkerus,2632,60,3,1,4,75.0%,1h
28245,2,RUSDDSS,2632,60,3,2,5,60.0%,21m
28245,2,VovaKoch,2632,114,3,5,8,37.5%,35m
28245,1,Demion,2632,116,3,9,12,25.0%,1h
28245,2,SirNomad,2632,58,2,1,3,66.7%,48m
28245,1,[xTDA]Rodon,2632,103,2,3,5,40.0%,14m
28245,2,Maiden,2632,0,2,3,5,40.0%,22m
28245,2,WujekSoko,2632,64,2,4,6,33.3%,41m
28245,2,REVOLUTiON,2632,0,1,0,1,100.0%,1h
28245,1,Sindyr,2632,0,1,2,3,33.3%,50m
28245,2,Insomnia,2632,0,1,2,3,33.3%,6m
28245,2,[BORRA]rocknrolla,2632,0,0,1,1,0.0%,21m
28245,2,KalaKukko,2632,0,0,1,1,0.0%,22m
28245,2,Hunter,2632,0,0,1,1,0.0%,5m
28275,2,alexeich,2631,1613,76,73,149,51.0%,11m
28275,2,Bossman,2631,1144,56,52,108,51.9%,35m
28275,1,[rNSFW]Arct,2631,1123,44,43,87,50.6%,41m
28275,1,Moose,2631,1253,43,47,90,47.8%,32m
28275,3,korween,2631,618,23,26,49,46.9%,23m
28275,1,hello,2631,583,20,17,37,54.1%,9m
28275,3,PhObOs,2631,440,14,24,38,36.8%,21m
28275,1,GLo,2631,251,12,7,19,63.2%,1h
28275,1,supertrashyn,2631,382,12,16,28,42.9%,26m
28275,2,SHAITANblCH,2631,299,10,6,16,62.5%,44m
28275,1,[IlIIII]Khroma,2631,256,10,11,21,47.6%,1h
28275,1,Eldores,2631,330,9,16,25,36.0%,41m
28275,2,[EXORT]GachiMan,2631,242,8,8,16,50.0%,34m
28275,1,pLAiNsAnE,2631,275,8,8,16,50.0%,38m
28275,1,Papoy,2631,200,8,10,18,44.4%,6m
28275,2,Rygel,2631,179,7,8,15,46.7%,16m
28275,1,Marpheus,2631,246,7,11,18,38.9%,1h
28275,2,[EmŦ]Monta,2631,168,6,1,7,85.7%,19m
28275,1,FocuS,2631,204,6,5,11,54.5%,41m
28275,2,Praetor,2631,118,5,3,8,62.5%,1h
28275,1,NIVIAL,2631,68,5,5,10,50.0%,13m
28275,1,[StaTo]Merphidros,2631,116,4,7,11,36.4%,29m
28275,2,ant,2631,0,3,4,7,42.9%,12m
28275,3,ANASTASIA,2631,42,3,4,7,42.9%,24m
28275,1,ReaperT,2631,0,3,6,9,33.3%,15m
28275,3,[GLTR]hodgep,2631,113,3,7,10,30.0%,1h
28275,2,JerkFace,2631,30,2,1,3,66.7%,1h
28275,2,Toblakai,2631,60,2,2,4,50.0%,37m
28275,3,Jolipoli,2631,0,2,3,5,40.0%,30m
28275,2,Eysi,2631,0,1,0,1,100.0%,48m
28275,2,[59APM]Zeratul,2631,0,1,0,1,100.0%,1h
28275,2,[Moobs]Jackinatorz,2631,0,1,0,1,100.0%,5m
28275,3,LePurp,2631,0,1,3,4,25.0%,1h
28275,2,durii,2631,30,1,3,4,25.0%,11m
28275,2,[GOGOLS]Yioss,2631,0,1,4,5,20.0%,1h
28275,2,LER,2631,32,1,4,5,20.0%,11m
28275,2,Koi,2631,0,0,1,1,0.0%,19m
28275,2,Renez,2631,0,0,1,1,0.0%,1h
28275,2,TaldeeR,2631,0,0,1,1,0.0%,33m
28275,2,runduk,2631,0,0,2,2,0.0%,49m
28315,1,Xenos,2630,711,78,79,157,49.7%,28m
28315,3,DarkWolf,2630,643,64,57,121,52.9%,14m
28315,1,BEAST,2630,1081,47,34,81,58.0%,1h
28315,1,Flo,2630,827,30,30,60,50.0%,23m
28315,1,Douwi,2630,695,26,25,51,51.0%,14m
28315,1,[фсо]JONiSEO,2630,600,20,20,40,50.0%,26m
28315,1,karamba,2630,450,19,16,35,54.3%,41m
28315,2,Drago,2630,261,9,4,13,69.2%,28m
28315,1,JonnyTsunami,2630,96,5,7,12,41.7%,40m
28315,2,reptor,2630,0,4,3,7,57.1%,1h
28315,3,IWillCannon,2630,30,4,6,10,40.0%,4m
28315,1,Hernan,2630,188,4,9,13,30.8%,24m
28315,2,awokenbear,2630,119,3,5,8,37.5%,3m
28315,3,xCooom,2630,121,3,8,11,27.3%,22m
28315,2,[PIDORZ]Venomuser,2630,60,2,3,5,40.0%,1h
28315,2,XUAL,2630,0,2,3,5,40.0%,1h
28315,2,Maciejeg,2630,0,2,3,5,40.0%,1h
28315,1,Firesrest,2630,42,2,6,8,25.0%,1h
28315,2,DIV,2630,0,1,0,1,100.0%,48m
28315,2,acekris,2630,0,1,0,1,100.0%,50m
28315,2,NagisaSkrid,2630,0,1,0,1,100.0%,51m
28315,3,[ĦĦ]PositivDeath,2630,0,1,1,2,50.0%,6m
28315,2,Aserothe,2630,0,1,2,3,33.3%,4m
28315,2,Zhenyak,2630,0,1,3,4,25.0%,1h
28315,2,[0ldMen]Barhonov,2630,0,0,1,1,0.0%,47m
28315,2,[ZDI]Vladislav,2630,0,0,1,1,0.0%,3m
28315,3,noxan,2630,0,0,1,1,0.0%,48m
28315,3,DunkelZwei,2630,0,0,2,2,0.0%,44m
28343,1,Velimir,2629,913,40,38,78,51.3%,26m
28343,3,[DGTN]Tom,2629,1052,40,42,82,48.8%,16m
28343,2,BamBook,2629,468,18,16,34,52.9%,48m
28343,3,madMax,2629,502,17,31,48,35.4%,16m
28343,1,Odblask,2629,371,14,12,26,53.8%,23m
28343,2,Fantomas,2629,296,12,4,16,75.0%,1h
28343,2,HUNTER,2629,188,9,11,20,45.0%,12m
28343,2,TesTo,2629,257,9,15,24,37.5%,8m
28343,2,Carls,2629,244,8,8,16,50.0%,41m
28343,2,toineduke,2629,180,7,6,13,53.8%,40m
28343,1,Agit,2629,189,7,10,17,41.2%,1h
28343,1,RumosGrief,2629,254,6,7,13,46.2%,12m
28343,2,[WCITF]Ashley,2629,213,6,9,15,40.0%,40m
28343,2,RoOftOp,2629,162,5,0,5,100.0%,33m
28343,1,izGROMor,2629,191,5,7,12,41.7%,30m
28343,2,Wedra,2629,44,4,5,9,44.4%,19m
28343,2,lapatuk,2629,58,3,0,3,100.0%,1h
28343,2,mamapapa,2629,124,3,4,7,42.9%,1h
28343,3,filthyhero,2629,0,2,0,2,100.0%,5m
28343,2,Drahac,2629,30,2,0,2,100.0%,28m
28343,3,Mendak,2629,0,2,3,5,40.0%,10m
28343,3,MoisesOtaku,2629,0,2,3,5,40.0%,51m
28343,3,KackeKopp,2629,0,2,3,5,40.0%,36m
28343,2,[6mm]GregTheStar,2629,88,2,3,5,40.0%,5m
28343,3,Sino,2629,0,1,0,1,100.0%,51m
28343,3,MaxProTTT,2629,97,1,1,2,50.0%,37m
28343,2,Jano,2629,30,1,2,3,33.3%,32m
28343,1,AlaBalaPorto,2629,36,1,4,5,20.0%,40m
28343,2,Sterling,2629,0,0,1,1,0.0%,1h
28343,2,Eraser,2629,0,0,1,1,0.0%,11m
28343,2,Snusmumrik,2629,0,0,1,1,0.0%,8m
28343,2,Beeline,2629,0,0,1,1,0.0%,16m
28375,2,classic,2628,1596,373,353,726,51.4%,37m
28375,1,Zifo,2628,1647,218,201,419,52.0%,45m
28375,2,Gonbomfonso,2628,1605,111,90,201,55.2%,40m
28375,2,Raven,2628,1592,90,84,174,51.7%,8m
28375,2,Shopska,2628,1510,57,66,123,46.3%,24m
28375,2,karapot,2628,672,27,18,45,60.0%,32m
28375,1,Farkal,2628,590,19,23,42,45.2%,24m
28375,2,Krootkoff,2628,352,15,15,30,50.0%,21m
28375,2,plhacko,2628,172,10,6,16,62.5%,8m
28375,2,Sssilez,2628,220,9,7,16,56.2%,3m
28375,2,GrimReaper,2628,176,7,6,13,53.8%,11m
28375,2,[RTNK]MengHao,2628,148,6,8,14,42.9%,33m
28375,1,SHAZAM,2628,0,4,6,10,40.0%,15m
28375,3,GitoMouche,2628,58,3,5,8,37.5%,16m
28375,2,Anx,2628,30,2,2,4,50.0%,17m
28375,2,Nukemaster,2628,0,2,2,4,50.0%,19m
28375,3,Drillzom,2628,121,2,3,5,40.0%,51m
28375,2,OptimusRhyme,2628,34,1,2,3,33.3%,12m
28375,1,[черепа]ShadowZilot,2628,88,1,3,4,25.0%,13m
28375,2,[BANW]Pablin,2628,0,0,1,1,0.0%,23m
28375,2,STarVation,2628,0,0,1,1,0.0%,22m
28375,1,[ƬƗ]pleX,2628,0,0,4,4,0.0%,4m
28397,1,[II3II]TurboPWNZ,2627,1009,100,85,185,54.1%,23m
28397,1,Rvator,2627,1503,84,83,167,50.3%,50m
28397,2,ZluBurK,2627,384,45,36,81,55.6%,25m
28397,1,erop,2627,1194,43,49,92,46.7%,17m
28397,1,KimLaN,2627,758,27,29,56,48.2%,15m
28397,1,Devilkiss,2627,552,24,13,37,64.9%,1h
28397,1,Helbaal,2627,610,23,19,42,54.8%,9m
28397,1,Gorik,2627,575,20,18,38,52.6%,4m
28397,1,vodyanoy,2627,596,19,24,43,44.2%,1h
28397,3,WMPlayer,2627,376,13,23,36,36.1%,24m
28397,2,[NBLRD]Lapinrusse,2627,202,10,9,19,52.6%,49m
28397,1,Dandie,2627,226,7,10,17,41.2%,28m
28397,1,Dorffen,2627,201,7,11,18,38.9%,40m
28397,2,KILO,2627,165,6,6,12,50.0%,1h
28397,1,Thunderlii,2627,164,6,8,14,42.9%,40m
28397,1,Tirgond,2627,204,5,8,13,38.5%,1h
28397,2,grishman,2627,90,4,3,7,57.1%,5m
28397,2,[II3II]DRLR,2627,92,4,4,8,50.0%,48m
28397,2,crl,2627,118,4,5,9,44.4%,32m
28397,1,Abaddon,2627,140,4,5,9,44.4%,44m
28397,3,CanoRey,2627,120,3,1,4,75.0%,1h
28397,1,[qul1]Danzelot,2627,118,3,2,5,60.0%,9m
28397,2,kagemand,2627,0,3,2,5,60.0%,40m
28397,2,McByJLKa,2627,60,3,4,7,42.9%,1h
28397,3,BLM,2627,40,3,5,8,37.5%,30m
28397,2,erky,2627,94,2,1,3,66.7%,47m
28397,2,[ЗИБиАГ]BeTaL,2627,112,2,1,3,66.7%,48m
28397,3,[Pédoss]Atlantis,2627,0,2,3,5,40.0%,1h
28397,2,Данила,2627,0,2,3,5,40.0%,49m
28397,3,Olollo,2627,0,2,4,6,33.3%,36m
28397,1,Constantine,2627,0,1,0,1,100.0%,1h
28397,2,Quaor,2627,0,1,0,1,100.0%,32m
28397,2,Wargle,2627,0,1,1,2,50.0%,37m
28397,2,anto,2627,0,0,1,1,0.0%,9m
28397,2,Ónidas,2627,0,0,1,1,0.0%,31m
28397,3,High,2627,0,0,5,5,0.0%,51m
28433,2,LuchDobra,2626,1589,78,63,141,55.3%,5m
28433,2,[Chonky]Effigy,2626,1469,71,53,124,57.3%,1h
28433,2,arzack,2626,1578,62,58,120,51.7%,1h
28433,2,Twice,2626,676,60,54,114,52.6%,47m
28433,3,CuNexT,2626,1052,42,44,86,48.8%,16m
28433,2,ParadoX,2626,654,26,22,48,54.2%,51m
28433,2,azuel,2626,482,18,17,35,51.4%,49m
28433,1,Joe,2626,488,14,16,30,46.7%,50m
28433,3,aLTy,2626,315,12,15,27,44.4%,22m
28433,1,[LPDC]Karrrlito,2626,306,10,11,21,47.6%,40m
28433,2,[xKillx]hairdie,2626,260,9,10,19,47.4%,1h
28433,2,фоб,2626,257,8,6,14,57.1%,15m
28433,2,[HZeS]Vasay,2626,214,7,3,10,70.0%,8m
28433,2,Electra,2626,116,5,4,9,55.6%,49m
28433,1,Animatik,2626,155,5,8,13,38.5%,14m
28433,2,Winger,2626,86,3,1,4,75.0%,33m
28433,3,Thunde,2626,121,3,4,7,42.9%,13m
28433,3,blA,2626,30,3,6,9,33.3%,4m
28433,2,greggyMapalm,2626,32,2,1,3,66.7%,1h
28433,3,[SDDDD]Muchahos,2626,91,2,3,5,40.0%,22m
28433,3,[FiDePu]Tanda,2626,0,2,3,5,40.0%,44m
28433,2,Slidd,2626,92,1,2,3,33.3%,49m
28433,2,Победитель,2626,36,1,2,3,33.3%,19m
28433,1,Dude,2626,90,1,4,5,20.0%,1h
28433,1,PIER,2626,0,1,6,7,14.3%,1h
28433,3,[AlzHG]Bats,2626,0,0,1,1,0.0%,24m
28433,3,sweebabby,2626,0,0,1,1,0.0%,49m
28433,2,PipJkezOred,2626,0,0,2,2,0.0%,9m
28433,2,[Kaffee]Schimpanze,2626,0,0,3,3,0.0%,11m
28433,1,SexyCactus,2626,0,0,4,4,0.0%,1h
28463,1,RishardS,2625,1604,140,121,261,53.6%,28m
28463,3,Albu,2625,1577,61,69,130,46.9%,11m
28463,3,pilotkill,2625,1342,50,53,103,48.5%,5m
28463,1,[Pub77]LifeforAyur,2625,182,30,23,53,56.6%,42m
28463,1,[DYPKA]Arhewarious,2625,377,30,25,55,54.5%,13m
28463,1,[ELAL]EuRoBoNd,2625,577,20,20,40,50.0%,38m
28463,1,VeTerran,2625,493,17,18,35,48.6%,1h
28463,2,SBKMafia,2625,167,16,8,24,66.7%,45m
28463,2,strichOr,2625,378,15,13,28,53.6%,16m
28463,1,TheTabMan,2625,306,10,5,15,66.7%,34m
28463,2,MinistrKylit,2625,248,10,9,19,52.6%,10m
28463,2,Program,2625,258,9,11,20,45.0%,37m
28463,2,Cyriel,2625,226,7,3,10,70.0%,41m
28463,1,Zander,2625,180,7,4,11,63.6%,12m
28463,2,Technot,2625,200,7,8,15,46.7%,1h
28463,2,[YSG]YSGcrime,2625,120,7,11,18,38.9%,8m
28463,2,Diffractor,2625,146,5,6,11,45.5%,37m
28463,2,nazrim,2625,90,4,4,8,50.0%,41m
28463,3,[tofury]Xio,2625,82,4,5,9,44.4%,50m
28463,2,crocus,2625,98,3,5,8,37.5%,12m
28463,1,Drozdik,2625,0,3,6,9,33.3%,12m
28463,2,[CIMBEL]Infested,2625,30,2,0,2,100.0%,17m
28463,2,[IFns]MrSokol,2625,68,2,2,4,50.0%,1h
28463,2,shikasd,2625,0,2,3,5,40.0%,19m
28463,1,ZeRen,2625,36,2,4,6,33.3%,40m
28463,2,[Юнион]Gucci,2625,0,1,0,1,100.0%,38m
28463,2,ImSiberian,2625,0,1,4,5,20.0%,33m
28463,2,[FRANZ]Endrox,2625,0,0,1,1,0.0%,36m
28463,2,[HEIM]король,2625,0,0,1,1,0.0%,16m
28463,3,ArcFLAY,2625,0,0,1,1,0.0%,47m
28463,2,[AngorA]MrHang,2625,0,0,2,2,0.0%,11m
28463,2,[DoAII]Soulrazy,2625,0,0,2,2,0.0%,19m
28495,2,DOK,2624,933,207,197,404,51.2%,38m
28495,1,Skywalker,2624,1247,163,149,312,52.2%,1h
28495,2,Strikestar,2624,1613,109,96,205,53.2%,11m
28495,3,Merlin,2624,1382,96,102,198,48.5%,14m
28495,3,Darkwood,2624,861,78,77,155,50.3%,8m
28495,1,Sugarpop,2624,882,37,25,62,59.7%,1h
28495,2,Qbik,2624,634,30,20,50,60.0%,9m
28495,2,[Jotaro]firestargame,2624,615,25,18,43,58.1%,9m
28495,3,shotgun,2624,598,21,28,49,42.9%,15m
28495,3,[tbsL]MatCody,2624,538,19,22,41,46.3%,10m
28495,1,[ExTr1m]CanadianRus,2624,451,15,11,26,57.7%,16m
28495,2,Aleksey,2624,400,14,11,25,56.0%,37m
28495,1,Strelok,2624,294,13,12,25,52.0%,4m
28495,3,KnownameUnde,2624,366,13,24,37,35.1%,23m
28495,2,[GdAT]PoulyCroC,2624,357,12,16,28,42.9%,1h
28495,1,[PARADX]KoraX,2624,267,8,14,22,36.4%,38m
28495,2,DarkRif,2624,164,7,4,11,63.6%,19m
28495,2,Severinochki,2624,60,6,3,9,66.7%,20m
28495,2,wysDR,2624,175,5,7,12,41.7%,49m
28495,3,Askon,2624,0,4,1,5,80.0%,39m
28495,2,sanna,2624,135,4,5,9,44.4%,19m
28495,2,Aivengo,2624,138,3,1,4,75.0%,27m
28495,2,hegerz,2624,60,3,2,5,60.0%,33m
28495,2,Odal,2624,136,3,2,5,60.0%,21m
28495,2,[InFy]Erduyta,2624,88,3,3,6,50.0%,10m
28495,3,Mikhai,2624,34,3,3,6,50.0%,27m
28495,2,dsded,2624,0,3,5,8,37.5%,39m
28495,3,RagaR,2624,94,3,6,9,33.3%,13m
28495,3,[Træf]Trolle,2624,0,2,3,5,40.0%,5m
28495,2,[JGIC]Hamilcar,2624,62,2,3,5,40.0%,43m
28495,1,[ЗЕRGТV]Максим,2624,38,2,4,6,33.3%,40m
28495,2,Mioel,2624,0,1,1,2,50.0%,3m
28495,2,[ANN]Agirre,2624,30,1,2,3,33.3%,1h
28495,2,[TuNa95]BiGxLebowski,2624,48,1,7,8,12.5%,1h
28495,2,Vectorfox,2624,0,0,1,1,0.0%,30m
28495,2,Panish,2624,0,0,1,1,0.0%,19m
28495,2,llllllllllll,2624,0,0,1,1,0.0%,33m
28495,2,ALeksLich,2624,0,0,1,1,0.0%,50m
28495,2,[RNKS]SÄÄTÄJÄ,2624,0,0,2,2,0.0%,45m
28495,2,Impressio,2624,0,0,3,3,0.0%,41m
28535,1,hobbyquaker,2623,1679,141,132,273,51.6%,50m
28535,2,DonPardon,2623,1215,88,67,155,56.8%,48m
28535,2,BadSeed,2623,1031,42,35,77,54.5%,1h
28535,2,Stein,2623,943,41,36,77,53.2%,12m
28535,1,Илюша,2623,620,28,24,52,53.8%,17m
28535,3,Pekka,2623,808,28,32,60,46.7%,17m
28535,2,Assylbek,2623,551,24,16,40,60.0%,20m
28535,3,[CFB]Chillboy,2623,587,23,32,55,41.8%,3m
28535,1,ZeLoTron,2623,500,19,25,44,43.2%,45m
28535,2,[AiRǂ]AngeluS,2623,466,15,19,34,44.1%,18m
28535,1,MacJLeHuLLa,2623,335,13,10,23,56.5%,43m
28535,1,Oameni,2623,380,11,17,28,39.3%,12m
28535,2,Echo,2623,284,10,16,26,38.5%,49m
28535,2,ДевичьиСлезы,2623,226,9,1,10,90.0%,51m
28535,1,Kotyrik,2623,257,9,9,18,50.0%,48m
28535,1,[Radium]DFG,2623,234,8,11,19,42.1%,29m
28535,3,IVANUS,2623,217,8,14,22,36.4%,23m
28535,2,Noobone,2623,187,6,3,9,66.7%,3m
28535,3,trolleybusik,2623,179,5,5,10,50.0%,17m
28535,2,[ZERGSC]eurchik,2623,146,4,1,5,80.0%,47m
28535,2,КОТЯРА,2623,62,3,2,5,60.0%,21m
28535,1,ЯМашина,2623,102,3,2,5,60.0%,40m
28535,2,Swayze,2623,92,3,3,6,50.0%,1h
28535,2,[ThaFz]MadBoy,2623,0,3,5,8,37.5%,1h
28535,2,aech,2623,0,3,5,8,37.5%,27m
28535,3,Qolak,2623,0,2,2,4,50.0%,19m
28535,3,Ngasta,2623,0,1,0,1,100.0%,17m
28535,1,Foksi,2623,0,1,3,4,25.0%,1h
28535,2,[0Head]artur,2623,0,0,1,1,0.0%,35m
28564,1,snarb,2622,1670,136,136,272,50.0%,13m
28564,1,Wild,2622,1523,125,115,240,52.1%,1h
28564,1,DIDIGINOU,2622,1610,102,101,203,50.2%,38m
28564,1,zealots,2622,957,81,78,159,50.9%,17m
28564,1,alpert,2622,644,64,61,125,51.2%,16m
28564,2,Anarchy,2622,1290,58,42,100,58.0%,30m
28564,3,WolFrAhMM,2622,482,27,34,61,44.3%,3m
28564,2,BulumutKa,2622,393,13,18,31,41.9%,37m
28564,1,Cannonfodder,2622,298,9,17,26,34.6%,1h
28564,1,[CaRm]Isenhart,2622,248,8,11,19,42.1%,25m
28564,3,Dobbon,2622,222,7,17,24,29.2%,5m
28564,1,TOnOTyH,2622,201,6,4,10,60.0%,45m
28564,2,mikewas,2622,118,6,7,13,46.2%,1h
28564,2,[Tspiri]SpiritossSE,2622,170,6,8,14,42.9%,33m
28564,2,[TWYST]Momimulle,2622,150,5,5,10,50.0%,16m
28564,3,kirill,2622,0,4,3,7,57.1%,12m
28564,2,Rifferts,2622,30,4,3,7,57.1%,19m
28564,2,[18v25]kvodan,2622,150,3,3,6,50.0%,7m
28564,2,SkyTossOP,2622,46,2,2,4,50.0%,15m
28564,3,Tsero,2622,0,2,3,5,40.0%,27m
28564,2,AndyRedbearD,2622,60,2,3,5,40.0%,41m
28564,2,GERT,2622,0,2,4,6,33.3%,25m
28564,2,SwiFt,2622,0,0,1,1,0.0%,29m
28564,1,SharkiStudio,2622,0,0,2,2,0.0%,36m
28564,2,[FoRst]EmysAndi,2622,0,0,3,3,0.0%,4m
28589,1,NodexGostr,2621,1120,66,69,135,48.9%,6m
28589,1,EGYGamer,2621,726,64,50,114,56.1%,1h
28589,1,Master,2621,1458,58,52,110,52.7%,28m
28589,2,[FROP]Bolchevique,2621,695,40,29,69,58.0%,27m
28589,2,PlayerTwo,2621,518,27,26,53,50.9%,22m
28589,1,Kreparinder,2621,658,24,31,55,43.6%,9m
28589,2,IIIIIIIIIIII,2621,567,22,22,44,50.0%,41m
28589,3,IIIIIIIIIIII,2621,400,16,18,34,47.1%,11m
28589,3,Starplatinum,2621,316,12,20,32,37.5%,16m
28589,2,Theote,2621,278,10,5,15,66.7%,1h
28589,3,[50shds]plevneliefe,2621,214,9,9,18,50.0%,24m
28589,1,[SBTO]Tombstone,2621,282,9,11,20,45.0%,8m
28589,2,[Tyзик]eexx,2621,213,7,5,12,58.3%,51m
28589,2,Artmun,2621,181,6,6,12,50.0%,5m
28589,2,ZLOW,2621,161,5,3,8,62.5%,5m
28589,2,PSYKER,2621,90,4,1,5,80.0%,17m
28589,2,[SLooz]MadMaxX,2621,106,4,3,7,57.1%,32m
28589,3,cocoleboss,2621,123,4,3,7,57.1%,4m
28589,1,BlackGad,2621,110,4,5,9,44.4%,9m
28589,2,bakspace,2621,60,2,2,4,50.0%,1h
28589,2,Carrabian,2621,0,2,3,5,40.0%,36m
28589,2,HopKemChanh,2621,0,1,0,1,100.0%,19m
28589,2,blood,2621,0,1,0,1,100.0%,18m
28589,2,[GIKI]shaghab,2621,30,1,2,3,33.3%,40m
28589,1,Khamus,2621,34,1,5,6,16.7%,8m
28589,2,LAV,2621,0,0,1,1,0.0%,28m
28589,2,[choucc]bodgame,2621,0,0,1,1,0.0%,1h
28589,2,Прочитано,2621,0,0,2,2,0.0%,38m
28617,3,Misquamacus,2620,1595,299,297,596,50.2%,4m
28617,1,MareanHeheXD,2620,612,48,43,91,52.7%,29m
28617,3,Maso,2620,475,45,47,92,48.9%,25m
28617,1,vavl,2620,822,35,26,61,57.4%,15m
28617,2,[DTST]nilz,2620,701,29,17,46,63.0%,41m
28617,2,DRA,2620,369,23,26,49,46.9%,1h
28617,1,Panem,2620,411,14,15,29,48.3%,32m
28617,1,SlotMachine,2620,290,11,6,17,64.7%,45m
28617,1,PowerOID,2620,333,9,13,22,40.9%,21m
28617,2,[A4J]ender,2620,176,7,4,11,63.6%,46m
28617,3,Grina,2620,200,6,5,11,54.5%,39m
28617,2,Bert,2620,174,5,2,7,71.4%,21m
28617,2,Devil,2620,156,5,8,13,38.5%,37m
28617,2,VVMRiper,2620,90,4,2,6,66.7%,1h
28617,2,enotik,2620,114,4,3,7,57.1%,11m
28617,2,FatLenny,2620,30,4,7,11,36.4%,13m
28617,2,Schlumpf,2620,88,3,3,6,50.0%,33m
28617,2,BARcode,2620,96,3,5,8,37.5%,1h
28617,2,[PCAS]LRSAD,2620,30,2,1,3,66.7%,1h
28617,3,Nossnahoj,2620,0,2,3,5,40.0%,1h
28617,2,[PNKS]uberbomba,2620,0,2,3,5,40.0%,28m
28617,2,Zlaiser,2620,0,1,0,1,100.0%,37m
28617,2,Spiruline,2620,0,1,0,1,100.0%,1h
28617,2,EvaNgel,2620,88,1,1,2,50.0%,19m
28617,2,JarJarBlinks,2620,30,1,2,3,33.3%,40m
28617,2,Hikimoura,2620,97,1,3,4,25.0%,16m
28617,3,NÖTEN,2620,0,1,4,5,20.0%,31m
28617,1,[Dz1ady]Thomlyn,2620,0,1,6,7,14.3%,50m
28617,1,MrFox,2620,38,1,7,8,12.5%,13m
28617,1,THaNaToS,2620,0,0,1,1,0.0%,13m
28617,2,[cck]chen,2620,0,0,2,2,0.0%,22m
28648,1,ForestAir,2619,1651,286,279,565,50.6%,23m
28648,1,[RBZ]Duick,2619,1319,65,68,133,48.9%,1h
28648,2,Angel,2619,827,34,25,59,57.6%,19m
28648,1,Mossel,2619,779,34,29,63,54.0%,36m
28648,1,[eSpG]rLz,2619,524,20,22,42,47.6%,50m
28648,2,[HACK3R]MatsuPro,2619,389,17,5,22,77.3%,1h
28648,1,[ECFeV]Czuppy,2619,302,10,13,23,43.5%,36m
28648,3,SeeJah,2619,244,8,21,29,27.6%,4m
28648,1,Bill,2619,204,6,6,12,50.0%,41m
28648,1,antofire,2619,184,5,7,12,41.7%,35m
28648,2,Bmavalente,2619,118,4,5,9,44.4%,44m
28648,2,Alexeyhey,2619,62,3,2,5,60.0%,4m
28648,3,Vixu,2619,40,3,4,7,42.9%,1h
28648,2,[Moskva]донкихотт,2619,114,3,5,8,37.5%,47m
28648,2,[OwMind]SonarPTZ,2619,62,2,2,4,50.0%,48m
28648,3,Coco,2619,0,2,3,5,40.0%,48m
28648,2,hanter,2619,0,2,3,5,40.0%,1h
28648,3,[HGmZ]Bzz,2619,0,2,5,7,28.6%,37m
28648,1,AmiralPascal,2619,48,2,6,8,25.0%,37m
28648,2,Linjo,2619,0,1,0,1,100.0%,1h
28648,3,SkyHack,2619,0,1,0,1,100.0%,1h
28648,1,Maxinuta,2619,46,1,2,3,33.3%,28m
28648,2,Влад,2619,0,0,1,1,0.0%,27m
28648,2,Montvis,2619,0,0,1,1,0.0%,19m
28648,2,[RoMSar]Danimir,2619,0,0,1,1,0.0%,1h
28648,2,[ZAW]Jacko,2619,0,0,2,2,0.0%,42m
28674,2,Probed,2618,1556,196,183,379,51.7%,33m
28674,3,[IceHus]КоролеваРоя,2618,197,79,66,145,54.5%,22m
28674,2,[PParty]Plamenniy,2618,1441,76,69,145,52.4%,44m
28674,1,[Heroes]sempie,2618,891,72,50,122,59.0%,1h
28674,1,Utar,2618,407,46,43,89,51.7%,8m
28674,2,Tamik,2618,936,42,25,67,62.7%,5m
28674,1,Emil,2618,439,17,17,34,50.0%,25m
28674,2,Eraxou,2618,457,17,17,34,50.0%,6m
28674,3,Lothrick,2618,239,12,22,34,35.3%,7m
28674,2,[CSGB]BigWater,2618,256,11,7,18,61.1%,50m
28674,2,[KTcHuP]Mrpinky,2618,104,8,5,13,61.5%,1h
28674,1,Ramzes,2618,288,8,9,17,47.1%,29m
28674,2,Blade,2618,250,6,8,14,42.9%,5m
28674,2,samson,2618,164,5,1,6,83.3%,27m
28674,2,Paradox,2618,198,5,3,8,62.5%,48m
28674,2,Balak,2618,0,4,1,5,80.0%,20m
28674,1,Ущерб,2618,210,4,5,9,44.4%,1h
28674,2,StOs,2618,58,3,1,4,75.0%,37m
28674,3,PsYcHoO,2618,42,3,5,8,37.5%,29m
28674,1,[Маньяк]llllllllllll,2618,32,2,3,5,40.0%,17m
28674,1,NoxJr,2618,0,2,4,6,33.3%,1h
28674,2,Valtuzzur,2618,0,1,0,1,100.0%,33m
28674,1,[TVFV]Bluetoo,2618,0,1,1,2,50.0%,1h
28674,3,[THANOS]Ger,2618,97,1,1,2,50.0%,51m
28674,2,metasystem,2618,30,1,2,3,33.3%,1h
28674,2,Kirushic,2618,32,1,2,3,33.3%,1h
28674,2,korgoth,2618,30,1,3,4,25.0%,37m
28674,3,LazyOrc,2618,0,1,4,5,20.0%,33m
28674,3,Anton,2618,0,0,1,1,0.0%,1h
28674,2,Slavomír,2618,0,0,1,1,0.0%,16m
28674,2,Ghost,2618,0,0,3,3,0.0%,45m
28705,2,[RеG]MaximiliaN,2617,1589,68,57,125,54.4%,41m
28705,2,Billy,2617,1477,62,57,119,52.1%,1h
28705,1,ELKAPO,2617,795,55,48,103,53.4%,17m
28705,1,goonix,2617,1158,54,50,104,51.9%,41m
28705,2,Blito,2617,1080,52,40,92,56.5%,1h
28705,1,Unbinilium,2617,1033,39,40,79,49.4%,39m
28705,2,[SunTry]PylonSlayer,2617,976,36,34,70,51.4%,6m
28705,2,Rockdriga,2617,500,25,12,37,67.6%,27m
28705,1,Swacha,2617,719,25,26,51,49.0%,32m
28705,2,GGFrance,2617,433,16,18,34,47.1%,41m
28705,2,Toumei,2617,159,11,2,13,84.6%,4m
28705,1,Duncan,2617,350,10,13,23,43.5%,31m
28705,1,ŻryjGruz,2617,253,9,8,17,52.9%,1h
28705,2,Yberman,2617,186,7,7,14,50.0%,1h
28705,2,RigilKent,2617,209,7,7,14,50.0%,20m
28705,2,[YouMad]twopaxalive,2617,202,7,9,16,43.8%,41m
28705,1,Bacon,2617,222,6,7,13,46.2%,31m
28705,2,Blakey,2617,120,6,8,14,42.9%,1h
28705,2,xMoDx,2617,126,4,5,9,44.4%,1h
28705,1,Apasni,2617,159,4,7,11,36.4%,29m
28705,1,Bobbi,2617,136,3,4,7,42.9%,32m
28705,2,HolaQueTal,2617,30,3,4,7,42.9%,18m
28705,2,ReYn,2617,102,3,5,8,37.5%,35m
28705,2,Byelu,2617,60,2,4,6,33.3%,5m
28705,3,rosephil,2617,0,2,4,6,33.3%,21m
28705,1,котик,2617,0,2,4,6,33.3%,41m
28705,3,[RUSMÜL]Trump,2617,0,2,7,9,22.2%,20m
28705,2,Vollcod,2617,0,1,1,2,50.0%,11m
28705,2,Nemezis,2617,0,1,2,3,33.3%,1h
28705,2,Shezu,2617,0,1,2,3,33.3%,26m
28705,1,YanYan,2617,0,1,3,4,25.0%,26m
28705,2,Rahl,2617,99,1,3,4,25.0%,26m
28705,2,InspektorKot,2617,44,1,3,4,25.0%,31m
28705,2,LeXX,2617,32,1,3,4,25.0%,4m
28705,3,Kyju,2617,0,0,1,1,0.0%,1h
28705,2,Витя,2617,0,0,1,1,0.0%,1h
28705,2,Nigg,2617,0,0,1,1,0.0%,30m
28705,3,ILYAufa,2617,0,0,2,2,0.0%,24m
28705,3,Eritik,2617,0,0,2,2,0.0%,40m
28744,1,Fred,2616,1528,353,363,716,49.3%,11m
28744,1,Raider,2616,1586,115,104,219,52.5%,1h
28744,1,[Aple]RANDANLY,2616,1436,55,44,99,55.6%,23m
28744,2,HeDoBoDKa,2616,676,28,18,46,60.9%,5m
28744,2,warvimus,2616,463,19,15,34,55.9%,51m
28744,1,NastyDefiler,2616,305,14,14,28,50.0%,34m
28744,1,[Pisdec]Mikki,2616,412,14,15,29,48.3%,32m
28744,1,ElChiChiChan,2616,298,10,11,21,47.6%,1h
28744,2,Zurllyn,2616,216,8,8,16,50.0%,42m
28744,2,[Achtun]vadim,2616,198,7,2,9,77.8%,41m
28744,2,Ænima,2616,211,7,4,11,63.6%,18m
28744,1,DRAGooN,2616,175,7,6,13,53.8%,46m
28744,1,Homelander,2616,182,5,9,14,35.7%,1h
28744,2,[iPain]Marsian,2616,86,4,1,5,80.0%,1h
28744,1,Reqzites,2616,0,4,2,6,66.7%,15m
28744,3,Jolasas,2616,129,4,5,9,44.4%,27m
28744,2,Lamy,2616,0,3,0,3,100.0%,3m
28744,1,kopalych,2616,92,2,1,3,66.7%,41m
28744,2,Michal,2616,0,2,3,5,40.0%,1h
28744,2,boss,2616,0,1,0,1,100.0%,19m
28744,2,Reyne,2616,32,1,3,4,25.0%,1h
28744,3,[UKG]Ellii,2616,0,0,1,1,0.0%,24m
28766,3,никитос,2615,1469,81,78,159,50.9%,5m
28766,3,serjohnny,2615,1431,78,85,163,47.9%,3m
28766,3,[nogang]Doze,2615,1124,64,68,132,48.5%,9m
28766,3,Catswhisker,2615,566,52,59,111,46.8%,24m
28766,1,[NecX]QuBit,2615,996,39,32,71,54.9%,32m
28766,1,AlexL,2615,966,34,36,70,48.6%,50m
28766,2,LUIZ,2615,540,26,17,43,60.5%,1h
28766,2,Mindaugas,2615,602,21,24,45,46.7%,3m
28766,2,Tigerheart,2615,519,20,12,32,62.5%,1h
28766,3,aCiD,2615,558,20,27,47,42.6%,9m
28766,2,RedChekenBur,2615,562,19,14,33,57.6%,1h
28766,2,[WTFSP]WTFork,2615,453,17,12,29,58.6%,28m
28766,2,Zergitop,2615,341,12,10,22,54.5%,10m
28766,1,Vadim,2615,313,9,12,21,42.9%,50m
28766,1,JINGJONG,2615,274,8,10,18,44.4%,48m
28766,1,NumberOne,2615,107,7,4,11,63.6%,45m
28766,3,hsync,2615,159,6,3,9,66.7%,42m
28766,1,DiletantBuch,2615,206,6,11,17,35.3%,1h
28766,2,Gaisariks,2615,160,5,8,13,38.5%,43m
28766,1,[C4F]VaN,2615,48,4,7,11,36.4%,40m
28766,2,Ninja,2615,62,4,12,16,25.0%,22m
28766,1,poik,2615,110,3,9,12,25.0%,32m
28766,2,loci,2615,60,2,3,5,40.0%,32m
28766,2,SiGnUM,2615,94,2,4,6,33.3%,27m
28766,2,винтик,2615,0,1,0,1,100.0%,45m
28766,3,[iRwT]MonsterRax,2615,38,1,1,2,50.0%,1h
28766,2,Busmagnet,2615,0,1,1,2,50.0%,3m
28766,2,kacper,2615,0,1,2,3,33.3%,44m
28766,2,[BLCK]hembbaa,2615,30,1,3,4,25.0%,33m
28766,2,[Lo3]Pornflakes,2615,32,1,4,5,20.0%,3m
28766,2,esLXeqtR,2615,0,0,1,1,0.0%,16m
28766,2,nick,2615,0,0,2,2,0.0%,48m
28798,1,Tyr,2614,1638,88,71,159,55.3%,34m
28798,2,juli,2614,1119,41,41,82,50.0%,46m
28798,2,amberdevil,2614,528,30,19,49,61.2%,49m
28798,1,HiddenTuna,2614,636,24,26,50,48.0%,1h
28798,1,[BDHR]Omegalul,2614,620,20,23,43,46.5%,6m
28798,1,Warmog,2614,391,15,11,26,57.7%,1h
28798,2,[4BRO]Lars,2614,351,14,14,28,50.0%,17m
28798,1,Henchy,2614,200,10,7,17,58.8%,10m
28798,2,stephane,2614,255,8,7,15,53.3%,42m
28798,1,Aezox,2614,215,8,9,17,47.1%,19m
28798,2,Azax,2614,174,6,1,7,85.7%,1h
28798,2,Gurrgeh,2614,180,5,7,12,41.7%,32m
28798,1,Ksuen,2614,0,4,1,5,80.0%,42m
28798,3,Zerg,2614,121,4,3,7,57.1%,42m
28798,3,Snayperat,2614,30,4,5,9,44.4%,20m
28798,1,Flor,2614,97,4,6,10,40.0%,1h
28798,2,Derekus,2614,120,3,2,5,60.0%,43m
28798,2,Brizhswaq,2614,103,3,4,7,42.9%,1h
28798,2,nizza,2614,30,3,4,7,42.9%,4m
28798,1,[Lactor]Misterklick,2614,96,2,0,2,100.0%,1h
28798,1,Morlock,2614,0,2,3,5,40.0%,19m
28798,1,JohnDalton,2614,0,2,3,5,40.0%,35m
28798,1,llllllllllll,2614,78,2,8,10,20.0%,20m
28798,2,[Drunk9]RouSou,2614,0,1,0,1,100.0%,5m
28798,2,PanikaWoW,2614,0,1,0,1,100.0%,46m
28798,2,[HollоW]JohnPhoenix,2614,0,1,4,5,20.0%,42m
28798,2,Neo,2614,0,1,4,5,20.0%,37m
28798,2,Voldro,2614,0,0,2,2,0.0%,41m
28798,2,Thorgrimmnet,2614,0,0,3,3,0.0%,3m
28827,1,MrFindlay,2613,1599,217,217,434,50.0%,1h
28827,1,Ballu,2613,1427,168,178,346,48.6%,15m
28827,3,Zeratay,2613,1148,111,102,213,52.1%,17m
28827,2,KayanaSule,2613,1292,91,83,174,52.3%,49m
28827,1,EnderStim,2613,1345,84,85,169,49.7%,14m
28827,2,OneStepClosr,2613,1592,82,71,153,53.6%,17m
28827,3,[Kingz]PauloCosta,2613,555,45,55,100,45.0%,4m
28827,2,NoiseBringer,2613,929,37,46,83,44.6%,31m
28827,2,Secret,2613,778,36,21,57,63.2%,5m
28827,2,ichik,2613,628,28,14,42,66.7%,33m
28827,2,Azze,2613,505,20,15,35,57.1%,5m
28827,3,dyrek,2613,461,20,24,44,45.5%,4m
28827,1,Timetoshine,2613,383,17,14,31,54.8%,38m
28827,3,byxou,2613,220,15,24,39,38.5%,22m
28827,2,[BaPaBo]DysmO,2613,266,11,4,15,73.3%,1h
28827,1,Finwer,2613,260,9,12,21,42.9%,4m
28827,2,Тарас,2613,198,6,7,13,46.2%,49m
28827,1,EzReal,2613,34,5,3,8,62.5%,15m
28827,3,trashmaster,2613,180,5,6,11,45.5%,17m
28827,3,Uzorpator,2613,121,4,2,6,66.7%,37m
28827,3,ZehanVav,2613,133,4,4,8,50.0%,5m
28827,3,Shar,2613,72,4,5,9,44.4%,33m
28827,1,bogvova,2613,48,4,7,11,36.4%,46m
28827,2,Vision,2613,136,3,1,4,75.0%,49m
28827,1,Baptistebar,2613,76,3,6,9,33.3%,23m
28827,1,[HQ31er]Mistro,2613,48,3,9,12,25.0%,1h
28827,3,STan,2613,97,2,0,2,100.0%,36m
28827,2,XyJIiraH,2613,30,2,0,2,100.0%,44m
28827,3,[PTWTM]Raven,2613,95,2,0,2,100.0%,35m
28827,2,[TENRIX]Innocence,2613,30,2,2,4,50.0%,47m
28827,1,Tchoii,2613,0,2,3,5,40.0%,17m
28827,3,HeartCode,2613,0,2,4,6,33.3%,50m
28827,2,Arethuge,2613,0,1,0,1,100.0%,23m
28827,1,артём,2613,0,1,1,2,50.0%,14m
28827,2,[D0N3]Wargrey,2613,0,0,1,1,0.0%,1h
28827,3,Puppet,2613,0,0,1,1,0.0%,48m
28827,1,[K2K]kenny,2613,0,0,2,2,0.0%,15m
28827,1,Idaho,2613,0,0,2,2,0.0%,41m
28865,2,ClimbatizE,2612,1522,75,53,128,58.6%,42m
28865,1,LeTare,2612,984,61,50,111,55.0%,41m
28865,2,Avantasius,2612,877,59,49,108,54.6%,21m
28865,3,Yothar,2612,818,50,47,97,51.5%,10m
28865,2,SKGhost,2612,1004,40,35,75,53.3%,20m
28865,1,SpiderManIV,2612,1040,36,40,76,47.4%,1h
28865,2,KeyDach,2612,429,32,33,65,49.2%,8m
28865,2,ShaiHulud,2612,723,31,23,54,57.4%,47m
28865,2,QuanDam,2612,499,20,16,36,55.6%,44m
28865,2,lyzyz,2612,192,19,11,30,63.3%,14m
28865,1,Brick,2612,311,12,11,23,52.2%,22m
28865,1,Errortil,2612,353,12,15,27,44.4%,1h
28865,1,Nerley,2612,194,11,13,24,45.8%,14m
28865,1,asfasd,2612,270,9,15,24,37.5%,29m
28865,1,[burrit]dafvid,2612,206,5,5,10,50.0%,33m
28865,1,Balu,2612,158,4,14,18,22.2%,1h
28865,2,OnE,2612,58,3,0,3,100.0%,36m
28865,1,[Petrus]TeCHNIK,2612,88,3,0,3,100.0%,25m
28865,2,Reaper,2612,60,3,3,6,50.0%,23m
28865,1,CrowWhite,2612,0,2,3,5,40.0%,1h
28865,3,Pavel,2612,0,2,5,7,28.6%,7m
28865,2,CosmicMind,2612,0,1,0,1,100.0%,1h
28865,2,[PLFS]Tarkes,2612,30,1,4,5,20.0%,44m
28865,2,Андрей,2612,0,1,5,6,16.7%,43m
28865,2,Yaroslav,2612,0,0,1,1,0.0%,44m
28865,2,GooFace,2612,0,0,4,4,0.0%,48m
28891,2,khaos,2611,1589,253,239,492,51.4%,21m
28891,1,Atzenkeeper,2611,1543,133,114,247,53.8%,23m
28891,3,FlokiSG,2611,1131,64,61,125,51.2%,16m
28891,2,танто,2611,1155,44,40,84,52.4%,41m
28891,1,IBLiS,2611,1092,37,42,79,46.8%,45m
28891,1,Mefisto,2611,833,33,34,67,49.3%,31m
28891,2,Hiob,2611,634,26,24,50,52.0%,21m
28891,1,Roks,2611,590,22,17,39,56.4%,1h
28891,3,Yonndu,2611,561,21,25,46,45.7%,5m
28891,3,[BOAE]Bandit,2611,218,8,17,25,32.0%,3m
28891,2,Greekdriver,2611,179,6,3,9,66.7%,47m
28891,2,MrFlaky,2611,152,6,4,10,60.0%,1h
28891,2,ToTeaTrouT,2611,128,6,4,10,60.0%,21m
28891,2,VladOK,2611,172,6,7,13,46.2%,45m
28891,1,kaczor,2611,97,5,4,9,55.6%,1h
28891,2,CHiBLaST,2611,116,3,1,4,75.0%,4m
28891,2,[YRAGAN]oleg,2611,141,3,3,6,50.0%,5m
28891,2,RedDragon,2611,160,3,4,7,42.9%,17m
28891,2,[Fusio]Krisov,2611,32,2,1,3,66.7%,33m
28891,2,[vlnr]Bjarki,2611,96,2,2,4,50.0%,33m
28891,2,cos,2611,0,1,0,1,100.0%,43m
28891,2,Maxim,2611,0,1,0,1,100.0%,3m
28891,2,Mat,2611,0,1,0,1,100.0%,5m
28891,2,Para,2611,0,1,1,2,50.0%,40m
28891,2,[QaDo]ПростоАндрей,2611,0,1,1,2,50.0%,20m
28916,1,JeanPlisse,2610,1354,181,174,355,51.0%,25m
28916,3,Sverok,2610,845,39,45,84,46.4%,17m
28916,2,Alberthx,2610,398,36,30,66,54.5%,16m
28916,3,Player,2610,746,28,33,61,45.9%,3m
28916,1,MutantMass,2610,554,18,25,43,41.9%,26m
28916,2,HuitSix,2610,267,9,8,17,52.9%,1h
28916,2,[SaviOr]GhostKeeper,2610,198,7,7,14,50.0%,22m
28916,2,[k1raen]боеслизнюк,2610,90,4,2,6,66.7%,33m
28916,3,[BVE]TöbbN,2610,42,4,3,7,57.1%,11m
28916,1,DrohGT,2610,32,4,9,13,30.8%,14m
28916,2,EGO,2610,60,3,3,6,50.0%,27m
28916,1,[Laim]Virtapiuha,2610,0,2,3,5,40.0%,1h
28916,3,AgentFSH,2610,0,2,4,6,33.3%,38m
28916,1,inder,2610,0,2,4,6,33.3%,50m
28916,1,Legolas,2610,145,2,5,7,28.6%,45m
28916,3,AtiQs,2610,0,1,1,2,50.0%,18m
28916,3,SAMUPAL,2610,0,1,2,3,33.3%,1h
28916,1,Rambosz,2610,34,1,6,7,14.3%,5m
28916,2,Greendonkey,2610,0,0,1,1,0.0%,8m
28916,2,[Jeste]ogarniam,2610,0,0,3,3,0.0%,1h
28916,2,JimmyKing,2610,0,0,3,3,0.0%,33m
28937,3,espresso,2609,1371,149,140,289,51.6%,5m
28937,2,[ANCST2]ByMHuK,2609,1296,74,47,121,61.2%,15m
28937,1,Thanatos,2609,993,71,64,135,52.6%,17m
28937,2,Dante,2609,1524,68,53,121,56.2%,47m
28937,2,SerafinStw,2609,1160,46,40,86,53.5%,28m
28937,3,KdM,2609,1277,46,51,97,47.4%,31m
28937,1,Psøøm,2609,618,40,45,85,47.1%,23m
28937,3,pab,2609,949,36,47,83,43.4%,24m
28937,2,DAAS,2609,742,33,17,50,66.0%,30m
28937,2,tarvota,2609,653,32,16,48,66.7%,45m
28937,1,Mamimo,2609,779,27,31,58,46.6%,23m
28937,2,GOLD,2609,404,15,13,28,53.6%,18m
28937,2,[GRY]sarcan,2609,358,15,15,30,50.0%,21m
28937,1,Eguha,2609,214,11,5,16,68.8%,46m
28937,1,MetalGod,2609,340,11,16,27,40.7%,44m
28937,2,ZergAxe,2609,292,10,6,16,62.5%,50m
28937,2,zet,2609,287,10,12,22,45.5%,12m
28937,1,Juanito,2609,291,9,12,21,42.9%,1h
28937,2,[SPAINs]NoobiStar,2609,30,5,1,6,83.3%,28m
28937,2,EvillKiss,2609,120,5,3,8,62.5%,32m
28937,2,fundo,2609,190,5,4,9,55.6%,48m
28937,2,DIBILNYI,2609,146,4,2,6,66.7%,1h
28937,2,HuntGuy,2609,60,3,0,3,100.0%,38m
28937,3,Executor,2609,97,2,0,2,100.0%,1h
28937,1,TkachOK,2609,88,2,2,4,50.0%,15m
28937,2,Fedonator,2609,116,2,3,5,40.0%,21m
28937,2,Darippa,2609,0,0,1,1,0.0%,10m
28937,2,AimmmaN,2609,0,0,1,1,0.0%,18m
28937,2,RaUl,2609,0,0,1,1,0.0%,42m
28937,2,PyqKocheW,2609,0,0,3,3,0.0%,5m
28967,2,Колдырь,2608,1303,113,101,214,52.8%,8m
28967,3,DarkNet,2608,516,47,47,94,50.0%,6m
28967,2,Kobe,2608,888,37,25,62,59.7%,37m
28967,2,NoSKiLL,2608,766,36,21,57,63.2%,49m
28967,1,LBFRAN,2608,553,23,18,41,56.1%,19m
28967,2,Kulminator,2608,502,20,18,38,52.6%,1h
28967,2,Mahmax,2608,275,10,9,19,52.6%,1h
28967,2,HiPPOLOVE,2608,193,8,1,9,88.9%,41m
28967,1,[LxG]Xoneration,2608,260,8,12,20,40.0%,20m
28967,2,Borzel,2608,224,7,7,14,50.0%,26m
28967,2,SixPullRush,2608,48,4,5,9,44.4%,43m
28967,2,Luis,2608,122,4,5,9,44.4%,1h
28967,1,[DIAHN]Sushipus,2608,155,4,7,11,36.4%,29m
28967,2,Newbiestyle,2608,0,3,5,8,37.5%,1h
28967,1,guilletuber,2608,40,3,5,8,37.5%,1h
28967,2,fobos,2608,0,2,3,5,40.0%,4m
28967,1,DeliveryMan,2608,80,2,6,8,25.0%,1h
28967,2,SexParty,2608,0,1,0,1,100.0%,49m
28967,1,TeroM,2608,0,1,1,2,50.0%,1h
28967,1,Chungis,2608,0,1,2,3,33.3%,1h
28967,2,[QHNOD]Aissax,2608,0,1,2,3,33.3%,1h
28967,3,MJtaylor,2608,40,1,2,3,33.3%,1h
28967,2,[ez4klz]lokes,2608,0,0,2,2,0.0%,10m
28967,2,BumbleBEE,2608,0,0,2,2,0.0%,49m
28967,2,Cookie,2608,0,0,2,2,0.0%,1h
28967,2,PanP,2608,0,0,2,2,0.0%,1h
28967,2,SilkyJohnson,2608,0,0,3,3,0.0%,46m
28994,3,SaN,2607,1531,192,181,373,51.5%,22m
28994,1,Skorgior,2607,825,178,173,351,50.7%,15m
28994,2,JIXXSAW,2607,1421,154,143,297,51.9%,4m
28994,1,avarax,2607,1603,90,81,171,52.6%,23m
28994,1,[éSsS]Roland,2607,1282,46,49,95,48.4%,14m
28994,2,Rexortom,2607,1044,42,33,75,56.0%,37m
28994,2,Salazar,2607,1044,42,35,77,54.5%,46m
28994,2,Duque,2607,575,35,32,67,52.2%,1h
28994,2,Tasher,2607,609,32,23,55,58.2%,27m
28994,1,рнк,2607,486,21,20,41,51.2%,1h
28994,2,Virus,2607,449,19,7,26,73.1%,1h
28994,2,Navara,2607,505,19,16,35,54.3%,19m
28994,1,KeyDg,2607,349,14,11,25,56.0%,9m
28994,2,oberststen,2607,365,14,25,39,35.9%,5m
28994,2,brian,2607,376,13,15,28,46.4%,23m
28994,1,chili,2607,256,9,7,16,56.2%,46m
28994,1,Kontures,2607,357,9,16,25,36.0%,20m
28994,2,NathDog,2607,240,8,8,16,50.0%,1h
28994,2,Muxa,2607,188,6,2,8,75.0%,41m
28994,1,The,2607,194,6,11,17,35.3%,1h
28994,2,Pikachu,2607,0,4,2,6,66.7%,1h
28994,1,[Псевдо]ПсевдоРыцарь,2607,118,4,5,9,44.4%,36m
28994,2,GARD,2607,136,3,1,4,75.0%,20m
28994,1,[Балаче]KDK,2607,141,3,1,4,75.0%,39m
28994,2,Roxin,2607,58,3,2,5,60.0%,5m
28994,3,Foxi,2607,97,2,2,4,50.0%,1h
28994,3,Blebu,2607,0,2,4,6,33.3%,10m
28994,3,Ikarus,2607,0,1,0,1,100.0%,26m
28994,3,Jonathan,2607,0,1,3,4,25.0%,22m
28994,1,Shadowkiller,2607,0,1,3,4,25.0%,1h
28994,2,PapinoPL,2607,0,0,1,1,0.0%,12m
28994,2,newhand,2607,0,0,1,1,0.0%,21m
28994,2,Evgi,2607,0,0,1,1,0.0%,1h
28994,2,LiNN,2607,0,0,2,2,0.0%,5m
29028,3,Baws,2606,981,196,170,366,53.6%,8m
29028,1,Liyan,2606,1475,162,151,313,51.8%,46m
29028,2,RedrippeЯ,2606,739,151,139,290,52.1%,22m
29028,3,Maurokun,2606,1146,87,93,180,48.3%,17m
29028,1,PLATUS,2606,1586,86,75,161,53.4%,1h
29028,1,Fjodorson,2606,1370,77,69,146,52.7%,1h
29028,2,Badger,2606,1580,77,73,150,51.3%,5m
29028,1,Fokusnik,2606,971,66,66,132,50.0%,40m
29028,3,terableblade,2606,1398,56,61,117,47.9%,17m
29028,2,Masternight,2606,1153,49,35,84,58.3%,26m
29028,2,[Zhig]List,2606,676,35,27,62,56.5%,27m
29028,3,andnev,2606,928,33,38,71,46.5%,7m
29028,1,Sven,2606,335,23,21,44,52.3%,29m
29028,2,Suddenly,2606,539,22,19,41,53.7%,20m
29028,1,TitoRobert,2606,542,20,16,36,55.6%,26m
29028,1,gys,2606,411,18,12,30,60.0%,1h
29028,1,[bgzona]PlayerSC,2606,362,13,12,25,52.0%,12m
29028,2,OschZar,2606,336,12,20,32,37.5%,22m
29028,2,CptCrab,2606,254,9,4,13,69.2%,1h
29028,1,[MatFac]maksolopus,2606,229,8,10,18,44.4%,10m
29028,2,wertes,2606,213,7,3,10,70.0%,33m
29028,2,[ZHEL]Nabl,2606,178,6,9,15,40.0%,1h
29028,2,SinKz,2606,118,5,4,9,55.6%,38m
29028,2,EliteSoldier,2606,154,5,8,13,38.5%,1h
29028,2,[MD12]sosotrib,2606,90,4,3,7,57.1%,50m
29028,3,[PiGPan]BearHug,2606,129,4,5,9,44.4%,25m
29028,1,Konan,2606,0,3,2,5,60.0%,21m
29028,1,Protain,2606,0,3,3,6,50.0%,51m
29028,2,VooDoo,2606,88,3,3,6,50.0%,16m
29028,2,[ЗХАПЙЦ]wok,2606,96,3,5,8,37.5%,17m
29028,1,[BABYSS]utgard,2606,80,3,5,8,37.5%,50m
29028,2,[MEDIUR]Brainiac,2606,30,2,0,2,100.0%,1h
29028,3,Nowaka,2606,133,2,3,5,40.0%,10m
29028,1,MrMechanist,2606,0,2,3,5,40.0%,4m
29028,2,Antaniar,2606,0,1,0,1,100.0%,33m
29028,3,TubriK,2606,0,1,0,1,100.0%,1h
29028,2,[WPack]JakLou,2606,34,1,2,3,33.3%,1h
29028,2,kionix,2606,0,0,1,1,0.0%,33m
29028,2,Кикита,2606,0,0,1,1,0.0%,1h
29028,2,Mufse,2606,0,0,2,2,0.0%,42m
29068,3,[Xa]wulfang,2605,1136,103,108,211,48.8%,19m
29068,3,EurasianGirl,2605,727,69,79,148,46.6%,14m
29068,2,[DeHi]Pokemaster,2605,944,45,31,76,59.2%,37m
29068,1,stargate,2605,1063,43,44,87,49.4%,22m
29068,1,StarLight,2605,800,32,26,58,55.2%,1h
29068,2,IVLegion,2605,818,29,30,59,49.2%,46m
29068,2,galaxion,2605,418,21,1,22,95.5%,23m
29068,3,DreamVl,2605,332,15,18,33,45.5%,22m
29068,1,BabiboB,2605,470,15,22,37,40.5%,1h
29068,1,Eazy,2605,236,8,11,19,42.1%,10m
29068,2,llllllllllll,2605,188,7,1,8,87.5%,51m
29068,1,Braza,2605,254,7,13,20,35.0%,1h
29068,2,NeedALight,2605,127,6,2,8,75.0%,1h
29068,2,Nerazim,2605,183,6,7,13,46.2%,47m
29068,1,[mznx]PATRIKO,2605,168,6,8,14,42.9%,34m
29068,1,Garzgov,2605,230,6,13,19,31.6%,1h
29068,2,chippR,2605,122,5,6,11,45.5%,25m
29068,1,[ГФ]mikser,2605,111,5,6,11,45.5%,1h
29068,2,ALEXMASON,2605,90,5,6,11,45.5%,32m
29068,1,Hoschi,2605,165,5,8,13,38.5%,1h
29068,2,[TAW]Revelator,2605,92,4,3,7,57.1%,45m
29068,2,Серега,2605,114,4,4,8,50.0%,16m
29068,2,КрєйзиКот,2605,120,4,5,9,44.4%,45m
29068,2,[21377]AwaryK,2605,62,3,2,5,60.0%,48m
29068,1,nosferatu,2605,162,3,3,6,50.0%,15m
29068,3,Reckeris,2605,97,3,3,6,50.0%,38m
29068,2,Michi,2605,30,2,1,3,66.7%,42m
29068,2,Goonie,2605,58,2,3,5,40.0%,10m
29068,1,Grendizer,2605,92,2,4,6,33.3%,11m
29068,2,flyingLOTUS,2605,140,2,4,6,33.3%,21m
29068,1,Azdil,2605,0,2,4,6,33.3%,46m
29068,1,[TFSC]Nayour,2605,72,2,5,7,28.6%,1h
29068,2,Warden,2605,0,1,0,1,100.0%,14m
29068,2,[MSAT]StarChi,2605,0,1,0,1,100.0%,23m
29068,2,[CEHS]Face,2605,0,1,1,2,50.0%,38m
29068,1,[GreenR]mrstrannik,2605,48,1,4,5,20.0%,38m
29068,2,Maxitsu,2605,0,0,1,1,0.0%,27m
29068,2,[SZF94]Skorm,2605,0,0,1,1,0.0%,36m
29068,2,SCARNER,2605,0,0,1,1,0.0%,45m
29068,2,Gabbone,2605,0,0,3,3,0.0%,32m
29108,1,Zek,2604,1517,225,222,447,50.3%,1h
29108,2,Kapetanios,2604,1336,169,157,326,51.8%,40m
29108,2,[SNheta]Xyz,2604,1369,64,63,127,50.4%,33m
29108,2,GAOOs,2604,1261,52,40,92,56.5%,17m
29108,3,Alonso,2604,432,16,19,35,45.7%,6m
29108,1,[БУБУБ]FunnyDeath,2604,358,12,16,28,42.9%,46m
29108,2,Karnaval,2604,318,11,12,23,47.8%,21m
29108,1,[ToXic0]BobLeouff,2604,271,10,10,20,50.0%,32m
29108,2,[12844]Ganskabra,2604,236,9,4,13,69.2%,4m
29108,2,BattleUdown,2604,174,6,5,11,54.5%,40m
29108,2,MrAD,2604,199,5,6,11,45.5%,33m
29108,2,Илларион,2604,86,4,2,6,66.7%,1h
29108,2,Cosmopoly,2604,174,4,6,10,40.0%,42m
29108,2,[ZHxPro]Wricez,2604,94,4,8,12,33.3%,11m
29108,2,нуАвдрух,2604,30,3,4,7,42.9%,50m
29108,2,[mfixed]SaTiP,2604,88,3,4,7,42.9%,1h
29108,2,Ace,2604,0,3,5,8,37.5%,13m
29108,2,Flowcharted,2604,30,2,0,2,100.0%,41m
29108,2,Bananajoe,2604,112,2,1,3,66.7%,32m
29108,2,[RüMBo]JoBro,2604,58,2,1,3,66.7%,51m
29108,2,[Xa]Carloschi,2604,58,2,1,3,66.7%,4m
29108,1,nils,2604,0,2,3,5,40.0%,22m
29108,3,Artur,2604,0,1,0,1,100.0%,22m
29108,2,Tuco,2604,0,1,4,5,20.0%,16m
29108,1,Vast,2604,0,1,5,6,16.7%,46m
29108,2,[DECIMA]Tor,2604,30,1,5,6,16.7%,45m
29108,2,[laxAPM]Ursus,2604,0,0,1,1,0.0%,41m
29108,3,Lotionan,2604,0,0,1,1,0.0%,1h
29108,2,[TLANDA]Manno,2604,0,0,1,1,0.0%,49m
29108,2,Fada,2604,0,0,1,1,0.0%,31m
29108,2,Cancerbarn,2604,0,0,3,3,0.0%,1h
29139,2,KelloxSmaxs,2603,1622,140,133,273,51.3%,20m
29139,1,Defla,2603,1487,119,109,228,52.2%,1h
29139,1,Ryrik,2603,1569,104,90,194,53.6%,13m
29139,3,Alex,2603,381,83,75,158,52.5%,25m
29139,2,NITRO,2603,1430,77,41,118,65.3%,40m
29139,1,Flowmow,2603,1392,58,65,123,47.2%,8m
29139,2,BartMan,2603,1064,47,46,93,50.5%,45m
29139,2,OpixOnFIre,2603,428,18,11,29,62.1%,37m
29139,2,JedesPolar,2603,464,18,13,31,58.1%,1h
29139,2,Athena,2603,445,18,16,34,52.9%,28m
29139,1,DROLER,2603,528,18,18,36,50.0%,36m
29139,1,Flimflamfox,2603,304,14,8,22,63.6%,31m
29139,3,dotdot,2603,324,13,11,24,54.2%,1h
29139,1,mayday,2603,338,9,17,26,34.6%,49m
29139,2,[PsF]Gery,2603,211,8,2,10,80.0%,21m
29139,2,MichaelII,2603,196,8,2,10,80.0%,1h
29139,1,Tolomeo,2603,188,7,13,20,35.0%,41m
29139,2,Ravageur,2603,159,6,7,13,46.2%,1h
29139,1,LogiiK,2603,170,5,7,12,41.7%,1h
29139,1,[Lmnbgl]barcode,2603,157,4,4,8,50.0%,46m
29139,2,RandomPerson,2603,60,4,5,9,44.4%,5m
29139,2,Shinemaru,2603,60,3,2,5,60.0%,44m
29139,2,[SadW]AdventureAl,2603,64,3,3,6,50.0%,8m
29139,2,[3ЕRGTV]unster,2603,60,3,4,7,42.9%,18m
29139,3,Seeds,2603,97,3,4,7,42.9%,11m
29139,2,Dimon,2603,93,2,2,4,50.0%,5m
29139,2,[morts]Parmeneon,2603,58,2,2,4,50.0%,4m
29139,1,waTSyOK,2603,0,2,2,4,50.0%,21m
29139,1,Zertzustr,2603,94,2,3,5,40.0%,36m
29139,2,BigZig,2603,0,2,3,5,40.0%,1h
29139,1,MNS,2603,0,1,0,1,100.0%,13m
29139,1,Storm,2603,95,1,1,2,50.0%,28m
29139,2,[DTSA]Artilleryman,2603,0,1,2,3,33.3%,51m
29139,2,[SBR42]eXtaZzy,2603,32,1,4,5,20.0%,40m
29139,1,[H2OKT]FarSeer,2603,0,1,4,5,20.0%,1h
29139,3,[NGEGNE]OSMaster,2603,0,0,1,1,0.0%,51m
29139,1,scaR,2603,0,0,6,6,0.0%,35m
29176,1,Pushnoyzver,2602,1300,93,76,169,55.0%,8m
29176,2,RustR,2602,1311,77,75,152,50.7%,42m
29176,3,ElTuzo,2602,445,58,58,116,50.0%,25m
29176,2,[GAMI]KIRITO,2602,1016,47,25,72,65.3%,41m
29176,3,EnsElEyici,2602,845,38,44,82,46.3%,20m
29176,2,holtby,2602,704,34,17,51,66.7%,33m
29176,2,skinsid,2602,401,25,13,38,65.8%,36m
29176,2,Сид,2602,393,16,10,26,61.5%,45m
29176,2,CMaster,2602,279,14,6,20,70.0%,13m
29176,1,Rugaru,2602,441,14,16,30,46.7%,6m
29176,2,SnIpEr,2602,254,11,4,15,73.3%,48m
29176,1,Edocsil,2602,302,10,10,20,50.0%,34m
29176,2,BrandNewSCV,2602,302,10,13,23,43.5%,1h
29176,2,llllllllllll,2602,204,9,1,10,90.0%,1h
29176,3,Burtulin,2602,196,8,6,14,57.1%,16m
29176,1,[ASMR]JayyWr,2602,273,8,8,16,50.0%,41m
29176,1,Xrapik,2602,241,7,8,15,46.7%,26m
29176,2,Llayan,2602,199,7,8,15,46.7%,1h
29176,1,Wagnis,2602,181,5,4,9,55.6%,1h
29176,2,Smithmonkey,2602,122,5,5,10,50.0%,32m
29176,1,Batyushka,2602,177,5,8,13,38.5%,1h
29176,1,[ANREN]вельзевул,2602,0,4,2,6,66.7%,41m
29176,2,HappyPants,2602,134,4,6,10,40.0%,35m
29176,2,Yufka,2602,136,3,1,4,75.0%,1h
29176,2,[Woyska]RapVoin,2602,51,3,4,7,42.9%,47m
29176,2,[TeUn]Kai,2602,108,3,4,7,42.9%,21m
29176,2,[ØC]BioFake,2602,58,2,3,5,40.0%,1h
29176,2,Mastere,2602,118,2,4,6,33.3%,21m
29176,1,spartacus,2602,0,2,4,6,33.3%,42m
29176,1,[Böcke]HerbertKrull,2602,144,2,6,8,25.0%,8m
29176,1,Wertrop,2602,119,2,6,8,25.0%,19m
29176,2,BuBLiK,2602,0,1,0,1,100.0%,19m
29176,2,[SupPla]микола,2602,0,1,1,2,50.0%,50m
29176,2,ZEUS,2602,30,1,2,3,33.3%,42m
29176,2,guiso,2602,0,1,3,4,25.0%,41m
29176,3,Shadow,2602,0,1,5,6,16.7%,31m
29176,2,Animka,2602,0,0,1,1,0.0%,44m
29176,2,Grozamir,2602,0,0,2,2,0.0%,27m
29214,1,SeyTey,2601,1656,89,91,180,49.4%,35m
29214,1,Virtual,2601,1496,81,80,161,50.3%,1h
29214,1,FedorS,2601,857,61,50,111,55.0%,8m
29214,2,Чех,2601,770,29,25,54,53.7%,51m
29214,2,Reaper,2601,710,28,25,53,52.8%,1h
29214,3,maxnick,2601,715,28,38,66,42.4%,21m
29214,2,Atomiusz,2601,520,20,15,35,57.1%,18m
29214,1,asuia,2601,478,19,16,35,54.3%,1h
29214,1,Nexus,2601,510,19,23,42,45.2%,21m
29214,3,[CZECHx]Hanes,2601,259,11,11,22,50.0%,26m
29214,1,krik,2601,287,10,8,18,55.6%,35m
29214,2,[Dralag]NeroDeath,2601,181,9,5,14,64.3%,16m
29214,1,LilaEismann,2601,297,9,8,17,52.9%,1h
29214,2,gabrey,2601,172,7,5,12,58.3%,4m
29214,2,HaiQ,2601,159,7,7,14,50.0%,25m
29214,2,[HST7]watsup,2601,174,7,9,16,43.8%,18m
29214,2,RockFort,2601,208,6,4,10,60.0%,45m
29214,1,[H3G]Triumph,2601,134,6,5,11,54.5%,19m
29214,2,[WooD]KillEmAll,2601,148,6,5,11,54.5%,45m
29214,2,Paul,2601,152,6,5,11,54.5%,18m
29214,3,deathbringer,2601,153,6,5,11,54.5%,5m
29214,2,West,2601,194,6,9,15,40.0%,5m
29214,2,zoldbeka,2601,164,5,2,7,71.4%,10m
29214,1,[GBPW]Taszkor,2601,142,5,8,13,38.5%,10m
29214,2,ionalfiri,2601,95,4,6,10,40.0%,49m
29214,2,[MinSur]Malchikman,2601,60,3,2,5,60.0%,17m
29214,3,Squeeeeee,2601,97,3,3,6,50.0%,13m
29214,3,DarkOne,2601,42,3,5,8,37.5%,47m
29214,1,Freddyk,2601,0,1,0,1,100.0%,1h
29214,2,Nerly,2601,0,1,0,1,100.0%,13m
29214,2,[FSTM]FireStar,2601,0,1,0,1,100.0%,20m
29214,1,[LCGmen]joerick,2601,0,1,5,6,16.7%,24m
29214,2,IlIlIlIlIlIl,2601,0,0,1,1,0.0%,51m
29214,3,Ильнур,2601,0,0,2,2,0.0%,5m
29248,3,JHONKRAKOSES,2600,1460,81,86,167,48.5%,30m
29248,1,Thrawn,2600,1383,73,57,130,56.2%,42m
29248,2,[KYSMem]BendulaAUT,2600,1162,56,70,126,44.4%,15m
29248,2,Math,2600,699,42,36,78,53.8%,22m
29248,1,Moendra,2600,888,35,40,75,46.7%,51m
29248,2,Vino,2600,716,30,24,54,55.6%,4m
29248,1,Chris,2600,614,21,26,47,44.7%,1h
29248,2,[TSBS]progamer,2600,517,19,17,36,52.8%,5m
29248,1,[OmDi]zoneman,2600,579,18,22,40,45.0%,13m
29248,2,ЗлаяКурица,2600,412,15,10,25,60.0%,43m
29248,2,jrprojekctor,2600,217,14,8,22,63.6%,45m
29248,2,tamse,2600,300,11,8,19,57.9%,49m
29248,1,Elf,2600,250,9,9,18,50.0%,41m
29248,1,sosybibu,2600,231,9,13,22,40.9%,45m
29248,1,weSlayer,2600,228,7,10,17,41.2%,39m
29248,1,Tasek,2600,199,6,7,13,46.2%,20m
29248,1,Adabapt,2600,178,6,10,16,37.5%,38m
29248,2,xyz,2600,118,5,3,8,62.5%,21m
29248,2,ThePigeon,2600,116,5,7,12,41.7%,13m
29248,2,[Silvеr]MimiCry,2600,128,5,7,12,41.7%,35m
29248,1,Fucus,2600,0,2,2,4,50.0%,33m
29248,3,DlARRHEAcube,2600,0,2,3,5,40.0%,15m
29248,1,PISO,2600,0,2,3,5,40.0%,13m
29248,2,[FMC8]NAVITEM,2600,0,1,0,1,100.0%,17m
29248,2,SPIDERMAN,2600,30,1,2,3,33.3%,42m
29248,2,[RRQ]MrMaxx,2600,0,1,2,3,33.3%,1h
29248,2,[TН]ThreeRaptors,2600,0,1,2,3,33.3%,4m
29248,2,[mfixed]mruczysław,2600,0,0,1,1,0.0%,11m
29248,2,PuMBa,2600,0,0,1,1,0.0%,19m
29248,2,Ilya,2600,0,0,2,2,0.0%,1h
29248,2,MichuX,2600,0,0,5,5,0.0%,18m
29279,3,[013NL]Ketoink,2599,1550,247,247,494,50.0%,4m
29279,1,Akela,2599,704,195,182,377,51.7%,21m
29279,2,ZET,2599,1565,107,93,200,53.5%,33m
29279,2,ElMo,2599,1273,102,89,191,53.4%,5m
29279,2,BobyWouane,2599,1129,72,58,130,55.4%,28m
29279,2,[НОД17]SCII,2599,883,55,39,94,58.5%,19m
29279,2,ZOLTAR,2599,717,35,30,65,53.8%,21m
29279,2,PolskaPany,2599,224,26,26,52,50.0%,23m
29279,1,[1FU2]Steeks,2599,707,21,25,46,45.7%,34m
29279,3,ROVA,2599,352,16,15,31,51.6%,22m
29279,2,Embren,2599,312,13,12,25,52.0%,1h
29279,2,Numitor,2599,156,11,5,16,68.8%,4m
29279,2,DROOJ,2599,294,11,10,21,52.4%,46m
29279,1,Hearalgar,2599,252,8,9,17,47.1%,28m
29279,2,[CaGa]Jojo,2599,172,6,9,15,40.0%,37m
29279,1,[DRTxd]CanRyu,2599,214,6,11,17,35.3%,20m
29279,3,Mios,2599,153,4,5,9,44.4%,1h
29279,2,Träskpaddan,2599,140,4,6,10,40.0%,33m
29279,2,Saimyr,2599,30,3,4,7,42.9%,22m
29279,1,SIgmO,2599,102,3,9,12,25.0%,27m
29279,3,Jurshpurr,2599,0,2,4,6,33.3%,17m
29279,1,[SpStub]schmechty,2599,141,2,4,6,33.3%,48m
29279,2,Lebedun,2599,0,1,0,1,100.0%,44m
29279,3,HarrisonFord,2599,0,1,0,1,100.0%,48m
29279,1,Graphic,2599,0,1,4,5,20.0%,26m
29279,2,Anthony,2599,0,0,1,1,0.0%,1h
29305,3,DerStu,2598,1318,139,136,275,50.5%,22m
29305,3,TnT,2598,1358,133,135,268,49.6%,22m
29305,3,primetel,2598,1432,88,98,186,47.3%,7m
29305,2,Precious,2598,1018,87,74,161,54.0%,48m
29305,3,yof,2598,993,57,56,113,50.4%,4m
29305,2,CarryMaster,2598,792,34,29,63,54.0%,1h
29305,2,CrazyKot,2598,365,21,7,28,75.0%,4m
29305,2,Cashy,2598,484,17,18,35,48.6%,21m
29305,2,Misha,2598,255,13,13,26,50.0%,33m
29305,2,Matotero,2598,275,12,9,21,57.1%,1h
29305,2,RaZzYer,2598,377,12,14,26,46.2%,17m
29305,1,BoOooOm,2598,245,9,10,19,47.4%,10m
29305,2,GreenGenyó,2598,253,8,8,16,50.0%,1h
29305,2,Raiden,2598,178,6,6,12,50.0%,21m
29305,1,Agressive,2598,145,6,7,13,46.2%,4m
29305,2,AgentK,2598,120,5,4,9,55.6%,33m
29305,2,Olympien,2598,148,5,6,11,45.5%,42m
29305,1,Adolf,2598,150,5,10,15,33.3%,21m
29305,1,amidala,2598,100,4,4,8,50.0%,9m
29305,2,[пират]академик,2598,128,4,4,8,50.0%,1h
29305,2,Acandra,2598,144,3,4,7,42.9%,21m
29305,2,[H104]MadeInHeaven,2598,30,3,4,7,42.9%,27m
29305,2,WurzelSepp,2598,96,2,0,2,100.0%,5m
29305,2,aJmbiZi,2598,0,2,3,5,40.0%,33m
29305,2,Santchos,2598,70,2,5,7,28.6%,14m
29305,2,[MCat]Rain,2598,96,2,6,8,25.0%,32m
29305,2,klmseo,2598,0,1,1,2,50.0%,37m
29305,3,Axelius,2598,0,1,4,5,20.0%,24m
29305,2,[Tales]Russltime,2598,0,0,1,1,0.0%,22m
29305,2,EstanNex,2598,0,0,1,1,0.0%,1h
29335,3,[TDAD]Hunter,2597,796,31,33,64,48.4%,8m
29335,1,slAvAtrAvkin,2597,805,27,36,63,42.9%,35m
29335,1,Speck,2597,753,26,30,56,46.4%,10m
29335,2,Dyrdus,2597,445,16,15,31,51.6%,33m
29335,2,[OOT]DeePacK,2597,320,13,14,27,48.1%,4m
29335,1,ErZzu,2597,374,12,12,24,50.0%,15m
29335,2,Macco,2597,226,9,2,11,81.8%,4m
29335,2,ferz,2597,226,8,7,15,53.3%,27m
29335,1,Wohuh,2597,232,8,11,19,42.1%,36m
29335,2,KerRayNis,2597,188,6,2,8,75.0%,27m
29335,3,flycat,2597,97,5,1,6,83.3%,5m
29335,2,[CameO]Dexter,2597,163,5,3,8,62.5%,17m
29335,2,[chaton]dessoudeur,2597,126,4,1,5,80.0%,23m
29335,2,[298K]Barsik,2597,150,4,2,6,66.7%,20m
29335,2,NIKJkE,2597,126,3,1,4,75.0%,45m
29335,2,havoc,2597,126,3,1,4,75.0%,6m
29335,2,SuckMyHuge,2597,60,3,2,5,60.0%,51m
29335,2,[Тетере]Падре,2597,60,3,3,6,50.0%,36m
29335,2,tucholsky,2597,30,3,4,7,42.9%,18m
29335,2,Javier,2597,106,3,4,7,42.9%,1h
29335,2,Hit,2597,94,2,1,3,66.7%,47m
29335,1,[BofUni]NeMeSiS,2597,70,2,11,13,15.4%,50m
29335,2,Дез,2597,0,1,0,1,100.0%,50m
29335,2,MrEgret,2597,0,1,3,4,25.0%,41m
29335,3,Nightmare,2597,80,1,6,7,14.3%,13m
29335,2,[czre]epic,2597,0,0,1,1,0.0%,42m
29335,2,Farja,2597,0,0,1,1,0.0%,1h
29335,2,plusspeed,2597,0,0,2,2,0.0%,18m
29335,2,gabrie,2597,0,0,3,3,0.0%,18m
29335,1,[NOLLER]SuperFly,2597,0,0,3,3,0.0%,26m
29365,3,Randall,2596,1515,279,268,547,51.0%,9m
29365,2,jnoon,2596,1653,196,189,385,50.9%,45m
29365,1,Alexx,2596,1415,152,138,290,52.4%,1h
29365,3,Advizor,2596,1565,105,107,212,49.5%,4m
29365,2,[CHKO]Puncocha,2596,597,29,24,53,54.7%,36m
29365,2,KOZA,2596,537,28,5,33,84.8%,5m
29365,1,Aero,2596,367,20,24,44,45.5%,1h
29365,3,bigburn,2596,523,20,27,47,42.6%,30m
29365,1,Ranger,2596,389,16,19,35,45.7%,24m
29365,2,Buba,2596,376,13,6,19,68.4%,21m
29365,2,NineTails,2596,288,11,11,22,50.0%,36m
29365,2,[BUND]IhorStalker,2596,208,9,5,14,64.3%,20m
29365,2,Hull,2596,285,9,9,18,50.0%,8m
29365,3,Trolíklolík,2596,245,9,11,20,45.0%,25m
29365,1,Flori,2596,190,8,9,17,47.1%,50m
29365,1,AlexDog,2596,160,7,9,16,43.8%,14m
29365,2,Sparten,2596,126,4,0,4,100.0%,1h
29365,2,Russian,2596,0,4,1,5,80.0%,20m
29365,2,vvhisper,2596,92,4,3,7,57.1%,46m
29365,2,[Pro1]Artanis,2596,58,4,5,9,44.4%,48m
29365,3,StormCrow,2596,42,3,5,8,37.5%,1h
29365,3,[ignari]TSPK,2596,108,3,7,10,30.0%,22m
29365,2,Jawas,2596,0,2,3,5,40.0%,42m
29365,2,Sicarius,2596,0,2,3,5,40.0%,41m
29365,1,Humorista,2596,0,2,3,5,40.0%,4m
29365,1,gredll,2596,0,2,4,6,33.3%,1h
29365,2,[OK238]BurnHeart,2596,0,1,0,1,100.0%,5m
29365,2,OSHO,2596,0,1,0,1,100.0%,1h
29365,2,jovis,2596,0,1,0,1,100.0%,18m
29365,2,Kodi,2596,30,1,1,2,50.0%,1h
29365,3,mers,2596,0,1,1,2,50.0%,48m
29365,2,Mortimuz,2596,30,1,2,3,33.3%,33m
29365,2,[DTBPL]LisekUrwisek,2596,0,0,1,1,0.0%,16m
29365,2,MadDogHooper,2596,0,0,1,1,0.0%,42m
29365,2,Greshnik,2596,0,0,1,1,0.0%,49m
29365,2,DotKill,2596,0,0,2,2,0.0%,42m
29365,2,DespoT,2596,0,0,2,2,0.0%,1h
29365,1,Buizerm,2596,0,0,4,4,0.0%,11m
29403,1,Krikrino,2595,1653,236,229,465,50.8%,9m
29403,1,Sandra,2595,1652,120,122,242,49.6%,1h
29403,2,malgry,2595,1200,62,41,103,60.2%,15m
29403,1,[antkr]lynx,2595,928,35,32,67,52.2%,17m
29403,2,Nemesis,2595,615,25,23,48,52.1%,41m
29403,2,feil,2595,469,19,20,39,48.7%,21m
29403,2,NUDEXxX,2595,399,14,11,25,56.0%,6m
29403,2,Braune,2595,269,9,6,15,60.0%,41m
29403,1,mcdukeЗ,2595,270,9,11,20,45.0%,32m
29403,2,avatarDT,2595,210,7,4,11,63.6%,25m
29403,1,BlackPrince,2595,205,7,7,14,50.0%,20m
29403,1,DarkChicken,2595,168,7,9,16,43.8%,1h
29403,3,PalmitoWw,2595,145,6,2,8,75.0%,15m
29403,3,[D4NI5H]SNPer,2595,146,6,3,9,66.7%,19m
29403,1,darkyyy,2595,114,6,4,10,60.0%,26m
29403,2,Andryha,2595,164,5,2,7,71.4%,48m
29403,2,Slog,2595,46,5,5,10,50.0%,1h
29403,2,inscribed,2595,86,4,2,6,66.7%,42m
29403,2,funTime,2595,88,4,2,6,66.7%,6m
29403,2,NEKACAP,2595,88,4,3,7,57.1%,48m
29403,2,[Ultm]TXK,2595,114,4,5,9,44.4%,1h
29403,2,[Kuci]Maydanoz,2595,30,3,4,7,42.9%,5m
29403,2,Panana,2595,32,3,5,8,37.5%,20m
29403,2,AlphaMacak,2595,88,3,7,10,30.0%,1h
29403,3,Alex,2595,30,2,1,3,66.7%,1h
29403,2,MrRadu,2595,0,2,3,5,40.0%,4m
29403,2,[Oarsch]UbootUwe,2595,0,2,3,5,40.0%,20m
29403,1,SirVival,2595,88,2,4,6,33.3%,10m
29403,1,BIGvirus,2595,0,1,1,2,50.0%,41m
29403,2,SmackWitch,2595,0,1,1,2,50.0%,28m
29403,2,[TERIZM]wicic,2595,0,0,2,2,0.0%,28m
29403,1,Boza,2595,0,0,4,4,0.0%,1h
29435,1,Kwézi,2594,1642,134,130,264,50.8%,8m
29435,2,FANTOM,2594,1598,125,117,242,51.7%,37m
29435,1,KHKUZB,2594,1623,94,89,183,51.4%,1h
29435,1,Gym,2594,1677,87,89,176,49.4%,9m
29435,1,vladmoto,2594,1652,76,81,157,48.4%,1h
29435,1,joker,2594,426,42,34,76,55.3%,1h
29435,2,TeeMaker,2594,431,27,18,45,60.0%,49m
29435,1,[PARSE]abc,2594,387,16,13,29,55.2%,39m
29435,1,MetalhaMMer,2594,417,13,16,29,44.8%,13m
29435,2,Observer,2594,295,12,10,22,54.5%,37m
29435,2,BOYNEXTDOOR,2594,264,11,13,24,45.8%,46m
29435,1,DDAN,2594,133,10,12,22,45.5%,1h
29435,1,Potapchups,2594,330,10,16,26,38.5%,35m
29435,3,ArToFZeRg,2594,258,10,19,29,34.5%,11m
29435,2,Monapx,2594,188,7,5,12,58.3%,1h
29435,2,LeGenDarySea,2594,248,7,9,16,43.8%,48m
29435,2,Фродо,2594,142,5,0,5,100.0%,11m
29435,2,Riskown,2594,58,5,4,9,55.6%,5m
29435,2,сладкий,2594,150,5,5,10,50.0%,50m
29435,2,Stargasm,2594,101,4,1,5,80.0%,32m
29435,3,Quaker,2594,70,4,5,9,44.4%,15m
29435,1,Boxxsack,2594,48,4,7,11,36.4%,31m
29435,2,Martinator,2594,78,3,3,6,50.0%,19m
29435,2,Ганстер,2594,0,3,4,7,42.9%,25m
29435,2,Grasiu,2594,120,3,4,7,42.9%,17m
29435,1,puppetz,2594,91,3,5,8,37.5%,1h
29435,1,MetalMania,2594,90,3,5,8,37.5%,21m
29435,1,pikachu,2594,96,2,1,3,66.7%,1h
29435,2,Androns,2594,0,2,3,5,40.0%,41m
29435,1,Ostbullen,2594,0,2,4,6,33.3%,41m
29435,1,CrimsonKodo,2594,48,2,12,14,14.3%,47m
29435,1,[ss5]wojtess,2594,0,1,0,1,100.0%,42m
29435,3,Clarence,2594,0,1,0,1,100.0%,15m
29435,3,Heeman,2594,97,1,1,2,50.0%,1h
29435,3,[Buldog]СЕРЕБРО,2594,36,1,1,2,50.0%,24m
29435,2,sagon,2594,0,1,3,4,25.0%,50m
29435,1,Ryantha,2594,36,1,6,7,14.3%,21m
29435,2,Lexotan,2594,0,0,1,1,0.0%,49m
29435,2,asvra,2594,0,0,1,1,0.0%,1h
29435,2,Leon,2594,0,0,2,2,0.0%,45m
29435,1,Luktim,2594,0,0,5,5,0.0%,1h
29476,2,[GG61]feb,2593,1235,203,214,417,48.7%,13m
29476,1,PlamIX,2593,1679,182,178,360,50.6%,26m
29476,2,[ESMC]jhonyChikens,2593,1302,66,46,112,58.9%,49m
29476,1,Evgeshka,2593,1089,46,39,85,54.1%,13m
29476,2,ELSaMi,2593,1228,45,45,90,50.0%,21m
29476,2,feniksa,2593,996,44,34,78,56.4%,42m
29476,2,MagMa,2593,505,21,14,35,60.0%,9m
29476,2,Kaje,2593,448,16,17,33,48.5%,50m
29476,2,CuRuBa,2593,367,14,14,28,50.0%,1h
29476,2,EnemyKeks,2593,358,13,9,22,59.1%,1h
29476,1,[CGEO]kruchy,2593,238,11,7,18,61.1%,49m
29476,1,Neytiri,2593,303,10,11,21,47.6%,40m
29476,1,SpaceMarine,2593,335,9,7,16,56.2%,49m
29476,1,andyczech,2593,254,9,9,18,50.0%,1h
29476,1,[Whizka]Hellcore,2593,274,9,10,19,47.4%,10m
29476,2,ChatRapide,2593,207,7,8,15,46.7%,42m
29476,1,[Чашка]ZERUS,2593,206,6,7,13,46.2%,38m
29476,1,Arashtoi,2593,126,6,8,14,42.9%,14m
29476,2,Canox,2593,154,5,3,8,62.5%,20m
29476,2,Crafty,2593,0,4,1,5,80.0%,18m
29476,2,[Cuackk]Lobogris,2593,122,4,7,11,36.4%,46m
29476,2,GetaLyfe,2593,102,3,0,3,100.0%,38m
29476,3,[UVB]ChyZma,2593,0,3,4,7,42.9%,1h
29476,2,[Zhig]arturrium,2593,133,3,5,8,37.5%,42m
29476,2,GreyWolf,2593,30,2,1,3,66.7%,18m
29476,2,[NIHED]kekateme,2593,120,2,1,3,66.7%,4m
29476,1,AliseMadness,2593,0,2,3,5,40.0%,33m
29476,2,[GNJ]MoJIeKyJIa,2593,60,2,5,7,28.6%,6m
29476,3,Zappy,2593,42,2,6,8,25.0%,42m
29476,2,Exsorcist,2593,0,1,0,1,100.0%,11m
29476,2,DaddyCool,2593,0,1,0,1,100.0%,1h
29476,3,[BBO]GornyiGigant,2593,48,1,1,2,50.0%,17m
29476,1,[BdPǂ]Giumbolizer,2593,0,1,4,5,20.0%,23m
29476,2,Jade,2593,88,1,5,6,16.7%,31m
29476,3,Freeman,2593,0,1,6,7,14.3%,5m
29476,3,Revenant,2593,42,1,6,7,14.3%,1h
29476,1,Madsinner,2593,38,1,7,8,12.5%,21m
29476,2,LuckyFlower,2593,0,0,1,1,0.0%,41m
29476,2,Smooker,2593,0,0,1,1,0.0%,1h
29476,2,Dimi,2593,0,0,1,1,0.0%,1h
29476,3,Goldglobin,2593,0,0,1,1,0.0%,35m
29476,3,MaSteR,2593,0,0,1,1,0.0%,32m
29476,2,beRka,2593,0,0,2,2,0.0%,1h
29476,2,Papylapeur,2593,0,0,4,4,0.0%,10m
29520,2,Dionisio,2592,1603,351,337,688,51.0%,1h
29520,3,SBI,2592,1208,86,70,156,55.1%,11m
29520,2,LAMER,2592,1357,62,57,119,52.1%,1h
29520,1,AntFromRus,2592,1327,57,49,106,53.8%,4m
29520,2,skaler,2592,996,40,37,77,51.9%,1h
29520,2,Fredde,2592,592,37,39,76,48.7%,45m
29520,2,DarkSeven,2592,498,17,18,35,48.6%,17m
29520,1,Bilbeissi,2592,408,14,17,31,45.2%,35m
29520,2,Misket,2592,312,10,16,26,38.5%,36m
29520,2,[Profix]Unikum,2592,190,6,3,9,66.7%,41m
29520,1,[tifou]pakito,2592,242,6,9,15,40.0%,52m
29520,3,IIIIIIIIIIII,2592,162,6,15,21,28.6%,8m
29520,2,monkeykiran,2592,86,4,2,6,66.7%,6m
29520,1,Deathyx,2592,138,4,7,11,36.4%,8m
29520,2,[DivN]Hetzer,2592,58,3,2,5,60.0%,21m
29520,2,QuBuS,2592,131,3,2,5,60.0%,51m
29520,2,Casanova,2592,0,2,3,5,40.0%,4m
29520,2,[Трутни]RazarRiper,2592,0,1,0,1,100.0%,38m
29520,2,CyniO,2592,0,1,1,2,50.0%,35m
29520,2,[NSH]Demiurge,2592,0,1,1,2,50.0%,48m
29520,3,Karakov,2592,0,1,3,4,25.0%,1h
29520,2,Miszka,2592,88,1,3,4,25.0%,28m
29520,2,DaOOd,2592,0,0,2,2,0.0%,36m
29520,1,Ferkart,2592,0,0,2,2,0.0%,1h
29520,2,Dezzer,2592,0,0,4,4,0.0%,45m
29545,1,SoiBoi,2591,841,165,153,318,51.9%,29m
29545,1,Boudewanus,2591,1056,76,56,132,57.6%,32m
29545,2,[THANOS]Voytech,2591,1559,76,66,142,53.5%,17m
29545,2,Zhabi,2591,1198,57,46,103,55.3%,1h
29545,2,SlowerThanU,2591,1011,44,28,72,61.1%,20m
29545,1,ИЗакацке,2591,746,44,37,81,54.3%,13m
29545,2,dogadaysya,2591,543,29,23,52,55.8%,21m
29545,2,[BiGLoW]pacificateur,2591,599,23,19,42,54.8%,20m
29545,2,maxtm,2591,412,14,12,26,53.8%,17m
29545,3,Sanes,2591,144,10,14,24,41.7%,8m
29545,2,Xazas,2591,163,9,7,16,56.2%,23m
29545,1,[K4w4iy]Milfshake,2591,249,8,10,18,44.4%,32m
29545,1,SirCus,2591,238,7,12,19,36.8%,42m
29545,1,Tanroth,2591,226,6,15,21,28.6%,38m
29545,2,brtjkzl,2591,159,5,5,10,50.0%,32m
29545,2,RiftViking,2591,95,5,10,15,33.3%,32m
29545,2,MinimalFX,2591,126,4,0,4,100.0%,4m
29545,2,[xHUNx]FredAster,2591,88,4,3,7,57.1%,33m
29545,2,Burzok,2591,205,4,4,8,50.0%,22m
29545,3,Macrocephaly,2591,0,4,4,8,50.0%,23m
29545,2,PusT,2591,118,4,7,11,36.4%,9m
29545,2,SAMSON,2591,112,3,1,4,75.0%,1h
29545,3,[Aiur23]Like,2591,0,2,4,6,33.3%,23m
29545,2,[Lappen]thatsSikh,2591,46,2,7,9,22.2%,41m
29545,2,XxDamgexX,2591,0,1,0,1,100.0%,6m
29545,1,Dima,2591,0,1,3,4,25.0%,26m
29545,1,Alex,2591,0,0,1,1,0.0%,43m
29545,2,Ralbi,2591,0,0,1,1,0.0%,49m
29545,2,Valefor,2591,0,0,2,2,0.0%,47m
29574,1,[WIRNIX]Kapaus,2590,1456,187,189,376,49.7%,9m
29574,2,mopi,2590,853,62,50,112,55.4%,46m
29574,1,Frosty,2590,1036,52,29,81,64.2%,39m
29574,2,Константин,2590,428,38,33,71,53.5%,19m
29574,1,Slasher,2590,580,22,22,44,50.0%,42m
29574,1,[mfxed]Bananito,2590,413,15,18,33,45.5%,13m
29574,1,StevenToast,2590,372,14,11,25,56.0%,1h
29574,2,ceix,2590,229,13,18,31,41.9%,38m
29574,2,SeeMeNoMore,2590,276,12,10,22,54.5%,1h
29574,2,llJDll,2590,350,12,16,28,42.9%,1h
29574,2,hglff,2590,322,10,25,35,28.6%,6m
29574,3,Alben,2590,249,8,16,24,33.3%,31m
29574,3,Moonklif,2590,159,7,4,11,63.6%,1h
29574,3,TriStaN,2590,182,7,4,11,63.6%,1h
29574,2,kolya,2590,169,6,4,10,60.0%,20m
29574,2,Влад,2590,84,6,5,11,54.5%,43m
29574,1,Eraser,2590,143,6,9,15,40.0%,14m
29574,1,Sonic,2590,238,6,11,17,35.3%,29m
29574,1,dragonlord,2590,102,4,4,8,50.0%,42m
29574,3,archie,2590,92,4,11,15,26.7%,9m
29574,2,FallenIdeals,2590,123,3,2,5,60.0%,49m
29574,2,Zmienniak,2590,0,3,5,8,37.5%,6m
29574,1,DeadlyGagary,2590,32,3,5,8,37.5%,17m
29574,2,[Soldi]Ziv,2590,30,2,0,2,100.0%,15m
29574,2,ILoNMaks,2590,36,2,0,2,100.0%,38m
29574,2,OrangeJuice,2590,60,2,2,4,50.0%,49m
29574,2,[FACKS]sam,2590,30,2,2,4,50.0%,1h
29574,2,Atlantis,2590,60,2,3,5,40.0%,48m
29574,1,Skylight,2590,0,2,3,5,40.0%,29m
29574,3,habibishisha,2590,0,2,4,6,33.3%,48m
29574,2,ROBSSON,2590,0,2,4,6,33.3%,32m
29574,2,[Cossac]Gross,2590,0,1,0,1,100.0%,13m
29574,3,piv,2590,0,1,0,1,100.0%,32m
29574,3,Zaemid,2590,0,1,0,1,100.0%,38m
29574,1,Paramenom,2590,0,1,1,2,50.0%,52m
29574,1,GreyMonk,2590,46,1,2,3,33.3%,9m
29574,2,[NOW]AgA,2590,0,0,2,2,0.0%,49m
29574,2,IIIIIIIIIIII,2590,0,0,3,3,0.0%,5m
29612,2,Mario,2589,1367,121,96,217,55.8%,32m
29612,2,Huang,2589,615,45,39,84,53.6%,19m
29612,2,BlackDir,2589,1096,44,61,105,41.9%,15m
29612,3,baba,2589,882,34,35,69,49.3%,16m
29612,2,Lluls,2589,696,26,25,51,51.0%,1h
29612,1,Yarkules,2589,566,19,25,44,43.2%,49m
29612,2,Forrest,2589,214,15,7,22,68.2%,50m
29612,2,Mayabe,2589,375,15,13,28,53.6%,11m
29612,1,Volia,2589,318,11,15,26,42.3%,46m
29612,2,[SibSAU]FallenLord,2589,187,8,5,13,61.5%,1h
29612,2,Raskolnikov,2589,204,8,7,15,53.3%,20m
29612,1,iNickX,2589,278,8,11,19,42.1%,1h
29612,2,Andro,2589,183,5,4,9,55.6%,20m
29612,2,PabloPepito,2589,58,2,4,6,33.3%,4m
29612,2,GiantDwarf,2589,30,2,4,6,33.3%,49m
29612,1,NaHell,2589,0,2,6,8,25.0%,14m
29612,2,werty,2589,0,1,0,1,100.0%,1h
29612,1,SlasH,2589,0,1,1,2,50.0%,30m
29612,2,AdasW,2589,30,1,1,2,50.0%,1h
29612,3,Saillor,2589,0,1,3,4,25.0%,23m
29612,2,Valenteen,2589,0,1,4,5,20.0%,42m
29612,3,Bubulinul,2589,0,1,5,6,16.7%,35m
29612,3,Azazerg,2589,0,1,5,6,16.7%,51m
29612,1,MCWALLY,2589,0,0,1,1,0.0%,21m
29612,3,najlepa,2589,0,0,1,1,0.0%,50m
29637,3,dan,2588,1507,323,303,626,51.6%,13m
29637,2,Coimao,2588,1420,209,205,414,50.5%,16m
29637,2,TaraTara,2588,838,35,30,65,53.8%,28m
29637,1,GIGAGustav,2588,324,30,28,58,51.7%,14m
29637,2,Wahnfried,2588,128,18,15,33,54.5%,1h
29637,2,[fFlags]zrn,2588,471,15,14,29,51.7%,21m
29637,2,[CHIGG]Chilex,2588,297,14,10,24,58.3%,6m
29637,2,Tomahawk,2588,220,9,7,16,56.2%,17m
29637,1,NtcSamael,2588,186,9,8,17,52.9%,1h
29637,2,greatmanflex,2588,221,7,8,15,46.7%,11m
29637,2,Fortuna,2588,184,6,3,9,66.7%,1h
29637,1,nbkk,2588,199,6,8,14,42.9%,29m
29637,3,Chimera,2588,202,6,10,16,37.5%,21m
29637,2,Biggy,2588,178,5,3,8,62.5%,49m
29637,2,MSK,2588,0,4,2,6,66.7%,1h
29637,2,Dentistul,2588,114,4,4,8,50.0%,1h
29637,1,Gabee,2588,108,4,8,12,33.3%,1h
29637,2,GorEviN,2588,0,3,2,5,60.0%,10m
29637,2,superariel,2588,88,3,3,6,50.0%,41m
29637,3,LiFyer,2588,42,3,6,9,33.3%,38m
29637,3,jackynouille,2588,62,3,10,13,23.1%,8m
29637,2,[4eTкIe]MonsaterR,2588,0,2,2,4,50.0%,1h
29637,3,Revers,2588,40,2,2,4,50.0%,48m
29637,2,Jeetah,2588,60,2,3,5,40.0%,50m
29637,2,[Burla]DonMario,2588,60,2,3,5,40.0%,17m
29637,2,[шаурм]нотище,2588,0,2,3,5,40.0%,20m
29637,2,Vorhautmade,2588,60,2,5,7,28.6%,44m
29637,2,Misael,2588,0,1,0,1,100.0%,30m
29637,3,[Judg]Opos,2588,0,1,1,2,50.0%,24m
29637,2,Migalhas,2588,0,1,4,5,20.0%,21m
29637,2,vitvit,2588,0,0,1,1,0.0%,19m
29637,2,juju,2588,0,0,1,1,0.0%,44m
29637,2,[SEWP]Starames,2588,0,0,1,1,0.0%,1h
29637,2,Franklin,2588,0,0,1,1,0.0%,37m
29637,2,Zawj,2588,0,0,1,1,0.0%,1h
29637,2,Moxtrox,2588,0,0,2,2,0.0%,4m
29673,1,[NICHE]KingFloyd,2587,1665,159,143,302,52.6%,50m
29673,2,Kopaul,2587,1538,138,133,271,50.9%,10m
29673,1,overdrive,2587,1154,84,70,154,54.5%,17m
29673,1,NightWolf,2587,1522,57,56,113,50.4%,1h
29673,2,Thorvax,2587,837,36,31,67,53.7%,21m
29673,2,SwagBoiiii,2587,754,29,33,62,46.8%,1h
29673,2,PhillyJilly,2587,450,17,17,34,50.0%,18m
29673,3,Bobby,2587,304,13,14,27,48.1%,23m
29673,1,[PLH]Baba,2587,237,9,10,19,47.4%,15m
29673,1,[Dogmin]bohong,2587,278,7,13,20,35.0%,35m
29673,2,andrei,2587,122,5,5,10,50.0%,47m
29673,3,Hallti,2587,135,4,5,9,44.4%,19m
29673,2,TaZEvTaNAZ,2587,66,3,2,5,60.0%,44m
29673,2,Scøøper,2587,30,3,5,8,37.5%,41m
29673,1,meteora,2587,72,3,7,10,30.0%,1h
29673,1,Benefix,2587,0,2,3,5,40.0%,21m
29673,2,[boredx]NASDAQ,2587,0,2,4,6,33.3%,20m
29673,2,[ЕМPIRE]Biothrone,2587,34,2,5,7,28.6%,46m
29673,2,ErhanBurak,2587,30,1,4,5,20.0%,51m
29673,2,Nerull,2587,0,1,9,10,10.0%,10m
29673,3,PsychoSRL,2587,0,0,1,1,0.0%,31m
29673,3,Kuzziv,2587,0,0,1,1,0.0%,1h
29673,1,RedToaster,2587,0,0,2,2,0.0%,49m
29673,2,[STOC]Ciroz,2587,0,0,2,2,0.0%,17m
29697,3,Toljaga,2586,1592,60,68,128,46.9%,12m
29697,2,Aleks,2586,1023,50,50,100,50.0%,4m
29697,1,ЛЕВША,2586,1241,46,48,94,48.9%,21m
29697,2,[BITEME]Adoro,2586,876,42,26,68,61.8%,21m
29697,3,Bomzh,2586,650,26,31,57,45.6%,5m
29697,2,Jekko,2586,293,21,11,32,65.6%,33m
29697,2,Anton,2586,489,19,13,32,59.4%,50m
29697,2,ActiveDK,2586,526,18,21,39,46.2%,33m
29697,1,Srad,2586,512,17,24,41,41.5%,1h
29697,2,[Dralag]CairneBlood,2586,392,16,10,26,61.5%,32m
29697,1,[VARUK]Redmesa,2586,500,15,18,33,45.5%,1h
29697,2,[K0RM2]Domonicant,2586,334,13,9,22,59.1%,1h
29697,2,KarapuZ,2586,306,11,12,23,47.8%,36m
29697,2,Kielnia,2586,212,7,4,11,63.6%,41m
29697,2,[UGAND]CPTCAPSLOCK,2586,136,6,4,10,60.0%,12m
29697,2,Dima,2586,118,5,4,9,55.6%,27m
29697,2,[StRa]Edkinson,2586,92,5,7,12,41.7%,51m
29697,2,TheNorweigan,2586,133,4,6,10,40.0%,1h
29697,2,Bugs,2586,60,3,5,8,37.5%,11m
29697,1,[phKEK]VypR,2586,0,2,3,5,40.0%,1h
29697,2,[AnimeG]Onichan,2586,0,1,2,3,33.3%,10m
29697,2,[ZERGYT]BTCHunter,2586,0,1,2,3,33.3%,28m
29697,2,[Элит7]Макс,2586,30,1,3,4,25.0%,19m
29697,2,DjDaxes,2586,42,1,4,5,20.0%,7m
29697,1,FuTure,2586,0,0,8,8,0.0%,1h
29722,2,spawnnsCZ,2585,1619,317,312,629,50.4%,1h
29722,3,dot,2585,1464,219,217,436,50.2%,6m
29722,3,Yodito,2585,1381,112,113,225,49.8%,31m
29722,3,[ĦĦ]blockzwoa,2585,1480,78,80,158,49.4%,16m
29722,2,Bapt,2585,1358,77,69,146,52.7%,1h
29722,2,Mira,2585,1551,72,57,129,55.8%,21m
29722,2,LukasDMania,2585,1013,63,58,121,52.1%,20m
29722,1,Savage,2585,1286,50,48,98,51.0%,1h
29722,1,[Учиха]Itachi,2585,612,30,25,55,54.5%,27m
29722,1,spacefruit,2585,630,27,22,49,55.1%,1h
29722,1,JammerLammer,2585,490,25,16,41,61.0%,36m
29722,2,Xerces,2585,668,24,23,47,51.1%,33m
29722,2,OstiSuce,2585,606,24,29,53,45.3%,8m
29722,1,Luigi,2585,256,11,10,21,52.4%,1h
29722,2,Dagger,2585,241,10,4,14,71.4%,11m
29722,2,BWArcher,2585,287,10,12,22,45.5%,1h
29722,2,Diomaxer,2585,214,9,7,16,56.2%,1h
29722,2,Янчик,2585,218,9,16,25,36.0%,14m
29722,3,Raven,2585,148,8,12,20,40.0%,7m
29722,2,Gandalf,2585,156,6,8,14,42.9%,29m
29722,2,Atlas,2585,176,6,10,16,37.5%,33m
29722,1,Сашок,2585,143,5,8,13,38.5%,1h
29722,1,[U19]TerranNuke,2585,0,4,1,5,80.0%,24m
29722,2,GuitarGuitar,2585,148,4,7,11,36.4%,49m
29722,2,ZeroQube,2585,96,4,7,11,36.4%,23m
29722,2,Keyster,2585,112,3,2,5,60.0%,41m
29722,2,Shaman,2585,60,3,3,6,50.0%,38m
29722,2,Hektor,2585,90,3,6,9,33.3%,46m
29722,3,SandyJesus,2585,102,3,6,9,33.3%,1h
29722,2,Skoalll,2585,86,3,8,11,27.3%,21m
29722,2,Alkaudon,2585,88,2,0,2,100.0%,38m
29722,3,MaxOverkill,2585,0,2,4,6,33.3%,24m
29722,2,John,2585,0,1,0,1,100.0%,1h
29722,2,[SPTAC]NDcobra,2585,0,1,2,3,33.3%,40m
29722,2,jurasjunior,2585,36,1,2,3,33.3%,27m
29722,2,[SPAINs]TerruñoArido,2585,0,1,4,5,20.0%,28m
29722,2,Nymphe,2585,0,0,1,1,0.0%,25m
29722,2,sivt,2585,0,0,1,1,0.0%,39m
29722,2,ФОЛСАД,2585,0,0,1,1,0.0%,32m
29722,2,chillmaster,2585,0,0,1,1,0.0%,1h
29762,2,thirteenth,2584,1583,229,222,451,50.8%,6m
29762,3,FejkoAjkula,2584,1151,97,99,196,49.5%,4m
29762,2,[buyu]NoCivilWar,2584,1083,55,17,72,76.4%,17m
29762,1,enigma,2584,1287,51,49,100,51.0%,17m
29762,2,[JaBa]Sharkuras,2584,1012,44,31,75,58.7%,20m
29762,2,Roland,2584,175,33,15,48,68.8%,36m
29762,3,Alex,2584,720,33,40,73,45.2%,5m
29762,2,[ZVG]Hellcat,2584,850,31,31,62,50.0%,1h
29762,2,barcode,2584,576,22,24,46,47.8%,1h
29762,1,Peppe,2584,408,16,17,33,48.5%,13m
29762,3,sebass,2584,466,15,27,42,35.7%,14m
29762,1,darkmaster,2584,401,14,16,30,46.7%,31m
29762,2,Titoulight,2584,239,11,9,20,55.0%,43m
29762,2,Danio,2584,279,9,7,16,56.2%,17m
29762,2,Monster,2584,232,8,9,17,47.1%,38m
29762,1,Darota,2584,232,8,10,18,44.4%,10m
29762,2,Cengiz,2584,174,7,8,15,46.7%,14m
29762,1,LarMa,2584,174,6,6,12,50.0%,1h
29762,2,OneHope,2584,96,4,6,10,40.0%,18m
29762,2,Artodoc,2584,122,4,7,11,36.4%,1h
29762,2,GGNOWKISKILL,2584,112,3,0,3,100.0%,1h
29762,1,Sathol,2584,0,3,2,5,60.0%,13m
29762,3,Palantir,2584,38,3,2,5,60.0%,1h
29762,1,[EpicBr]KinGArthuR,2584,48,3,3,6,50.0%,11m
29762,3,[RaynZ]MrWolf,2584,0,2,4,6,33.3%,15m
29762,2,Zagrobowiec,2584,0,1,0,1,100.0%,6m
29762,2,yago,2584,30,1,1,2,50.0%,45m
29762,2,Alex,2584,88,1,1,2,50.0%,1h
29762,2,Resestant,2584,88,1,1,2,50.0%,6m
29762,2,[ISRI]zaEBENIGRAD,2584,0,1,1,2,50.0%,1h
29762,2,liberador,2584,0,1,2,3,33.3%,36m
29762,2,Blame,2584,30,1,3,4,25.0%,49m
29762,1,BondEA,2584,0,1,4,5,20.0%,33m
29762,2,Karnauhov,2584,0,0,1,1,0.0%,18m
29762,2,[YlKES]Moonfang,2584,0,0,1,1,0.0%,1h
29762,2,IlIIIIllllll,2584,0,0,2,2,0.0%,42m
29762,2,Grucha,2584,0,0,2,2,0.0%,4m
29762,2,Maestro,2584,0,0,2,2,0.0%,36m
29800,2,AdyCom,2583,1363,122,117,239,51.0%,14m
29800,3,Murray,2583,1206,117,123,240,48.8%,14m
29800,1,VaNad,2583,903,47,43,90,52.2%,1h
29800,1,DядяШмель,2583,701,32,35,67,47.8%,14m
29800,2,[SIRBIN]XiM,2583,690,29,24,53,54.7%,43m
29800,2,Humanity,2583,706,29,24,53,54.7%,38m
29800,2,VeganWarrior,2583,614,26,17,43,60.5%,20m
29800,2,BLACK,2583,228,25,19,44,56.8%,46m
29800,2,Tron,2583,263,23,13,36,63.9%,46m
29800,2,Nervai,2583,243,18,19,37,48.6%,42m
29800,1,[TFSC]Hulkk,2583,453,17,19,36,47.2%,17m
29800,2,[1FU2]Bisk,2583,400,16,10,26,61.5%,1h
29800,2,[532]Andris,2583,262,14,12,26,53.8%,6m
29800,3,[LKDSC2]Tacata,2583,286,9,10,19,47.4%,21m
29800,1,Ocabeth,2583,318,8,10,18,44.4%,40m
29800,3,MARSALTITO,2583,156,5,7,12,41.7%,23m
29800,3,DaNiL,2583,157,5,9,14,35.7%,5m
29800,2,ToPiK,2583,137,4,7,11,36.4%,22m
29800,1,Dethlord,2583,110,4,10,14,28.6%,24m
29800,2,KoWa,2583,58,3,1,4,75.0%,50m
29800,2,DrZoid,2583,0,3,5,8,37.5%,1h
29800,1,Mjolnir,2583,30,3,5,8,37.5%,1h
29800,2,Bebquid,2583,0,3,6,9,33.3%,25m
29800,2,AleshaRAseya,2583,0,1,0,1,100.0%,33m
29800,2,Zergling,2583,0,1,0,1,100.0%,28m
29800,3,VodkaApple,2583,97,1,2,3,33.3%,6m
29800,1,KingCrevette,2583,38,1,9,10,10.0%,1h
29800,2,[mfixed]GhostPL,2583,0,0,1,1,0.0%,4m
29800,2,suiz,2583,0,0,4,4,0.0%,46m
29829,3,Bambi,2582,1339,213,206,419,50.8%,15m
29829,1,Antonystar,2582,1507,164,158,322,50.9%,9m
29829,2,Чезаре,2582,1086,135,130,265,50.9%,32m
29829,1,PandaBear,2582,883,103,96,199,51.8%,17m
29829,2,CannonRusher,2582,1339,66,50,116,56.9%,1h
29829,2,joebar,2582,827,47,51,98,48.0%,45m
29829,2,[LIQUID]BigFudge,2582,692,26,25,51,51.0%,49m
29829,2,TrykzZ,2582,365,15,10,25,60.0%,21m
29829,2,dmkravch,2582,305,13,10,23,56.5%,21m
29829,2,Nagato,2582,391,13,14,27,48.1%,12m
29829,2,[SPAINs]Kastel,2582,322,12,9,21,57.1%,33m
29829,1,ГрязныйДжони,2582,310,11,12,23,47.8%,18m
29829,2,ZeldOcarina,2582,118,5,8,13,38.5%,17m
29829,2,deniru,2582,90,5,8,13,38.5%,44m
29829,1,Papi,2582,97,4,6,10,40.0%,13m
29829,2,CaisCrew,2582,102,3,0,3,100.0%,17m
29829,2,[6L6]Evoleno,2582,88,2,0,2,100.0%,36m
29829,2,Youlidante,2582,0,2,3,5,40.0%,36m
29829,2,Tambu,2582,48,2,4,6,33.3%,47m
29829,2,[SFight]NeSmaavri,2582,0,1,0,1,100.0%,32m
29829,2,MGL,2582,30,1,1,2,50.0%,1h
29829,2,Harllu,2582,88,1,1,2,50.0%,17m
29829,2,[KOZACK]StasUA,2582,0,1,2,3,33.3%,13m
29829,2,Sohillo,2582,0,1,2,3,33.3%,45m
29829,2,LIMoNcHIk,2582,30,1,4,5,20.0%,9m
29829,2,[VacHr1]zAgr,2582,0,0,1,1,0.0%,43m
29855,2,Prestor,2581,1457,220,216,436,50.5%,15m
29855,2,tomatopotato,2581,955,105,85,190,55.3%,1h
29855,2,RuberOid,2581,1527,66,62,128,51.6%,18m
29855,2,SaulGoodman,2581,1541,64,86,150,42.7%,10m
29855,1,Ali,2581,1265,55,53,108,50.9%,17m
29855,2,Woob,2581,964,40,38,78,51.3%,18m
29855,1,[G4YoU]Christiankir,2581,586,21,25,46,45.7%,22m
29855,2,Stijfhoer,2581,503,20,17,37,54.1%,4m
29855,2,Akvalit,2581,383,19,15,34,55.9%,4m
29855,1,IBT,2581,478,19,18,37,51.4%,42m
29855,2,JhonyGhost,2581,180,8,1,9,88.9%,23m
29855,1,MAS,2581,286,8,17,25,32.0%,1h
29855,2,Strong,2581,146,5,6,11,45.5%,18m
29855,2,Julio,2581,150,5,6,11,45.5%,50m
29855,2,Colli,2581,116,4,7,11,36.4%,47m
29855,3,Infrizzy,2581,121,3,2,5,60.0%,34m
29855,3,Chilling,2581,97,3,4,7,42.9%,6m
29855,3,[DUF]Bllizdy,2581,0,3,5,8,37.5%,7m
29855,3,PanAdam,2581,0,1,0,1,100.0%,25m
29855,2,SerEga,2581,0,1,4,5,20.0%,37m
29855,2,DeniM,2581,0,0,1,1,0.0%,6m
29855,2,Sound,2581,0,0,1,1,0.0%,23m
29855,2,SlothTiger,2581,0,0,3,3,0.0%,42m
29855,2,Caedere,2581,0,0,4,4,0.0%,39m
29879,1,PlanC,2580,1638,105,106,211,49.8%,1h
29879,2,Messiah,2580,1522,66,59,125,52.8%,37m
29879,1,[VRRL]Funnisto,2580,1178,51,40,91,56.0%,16m
29879,2,Ester,2580,496,38,22,60,63.3%,37m
29879,1,[Batia]alariii,2580,868,36,27,63,57.1%,8m
29879,2,Abikutin,2580,365,31,35,66,47.0%,19m
29879,1,[DarKsS]Santi,2580,550,28,26,54,51.9%,46m
29879,2,Liksio,2580,531,24,12,36,66.7%,13m
29879,2,SirSouris,2580,440,20,7,27,74.1%,20m
29879,2,[ZelO]Rikiton,2580,414,16,13,29,55.2%,6m
29879,2,Hextrexer,2580,380,14,10,24,58.3%,17m
29879,2,MicroFon,2580,410,14,14,28,50.0%,9m
29879,1,[jfcs]jules,2580,370,13,16,29,44.8%,42m
29879,3,mokepp,2580,256,9,11,20,45.0%,21m
29879,2,Cookieisalie,2580,154,8,2,10,80.0%,41m
29879,2,DJartie,2580,140,8,7,15,53.3%,21m
29879,2,[Mercy1]Grumbleball,2580,162,5,3,8,62.5%,32m
29879,2,PegasKZ,2580,190,5,5,10,50.0%,1h
29879,2,Eisfluegel,2580,120,5,6,11,45.5%,23m
29879,3,[WHOOY]kallagen,2580,165,4,17,21,19.0%,20m
29879,2,Йости,2580,134,3,2,5,60.0%,13m
29879,1,[KMarks]Tempest,2580,137,3,4,7,42.9%,1h
29879,3,Мощнятский,2580,133,3,5,8,37.5%,34m
29879,2,SebastianeK,2580,0,3,5,8,37.5%,50m
29879,3,SUNSHINE,2580,30,2,6,8,25.0%,1h
29879,2,Phip,2580,88,1,1,2,50.0%,1h
29879,2,Krabic,2580,30,1,3,4,25.0%,20m
29879,2,Arto,2580,30,1,5,6,16.7%,14m
29879,2,Champloo,2580,0,0,1,1,0.0%,4m
29879,2,Hier,2580,0,0,1,1,0.0%,46m
29879,3,Soulhunter,2580,0,0,2,2,0.0%,24m
29879,2,nelumbo,2580,0,0,2,2,0.0%,23m
29879,1,Riel,2580,0,0,8,8,0.0%,35m
29912,2,Blaze,2579,1143,69,62,131,52.7%,4m
29912,1,mik,2579,1576,59,62,121,48.8%,9m
29912,3,Juda,2579,1266,59,68,127,46.5%,7m
29912,2,Gstar,2579,772,39,38,77,50.6%,45m
29912,2,PlayerOne,2579,451,25,23,48,52.1%,33m
29912,2,Swarm,2579,532,23,21,44,52.3%,44m
29912,1,yarin,2579,437,19,14,33,57.6%,25m
29912,1,jivonhi,2579,463,19,18,37,51.4%,36m
29912,2,Akashi,2579,462,17,17,34,50.0%,42m
29912,2,LoNzrEt,2579,369,16,7,23,69.6%,28m
29912,1,aumka,2579,476,15,21,36,41.7%,1h
29912,1,Skeleto,2579,318,12,14,26,46.2%,45m
29912,2,DireWolf,2579,264,9,7,16,56.2%,36m
29912,2,REDDAK,2579,189,8,5,13,61.5%,50m
29912,1,Decoboy,2579,173,7,7,14,50.0%,46m
29912,2,[CLTM]Bebar,2579,184,7,8,15,46.7%,11m
29912,2,Nubhal,2579,257,7,9,16,43.8%,1h
29912,2,dishii,2579,122,5,4,9,55.6%,1h
29912,2,novaky,2579,140,4,6,10,40.0%,47m
29912,2,sitham,2579,133,4,7,11,36.4%,11m
29912,2,[UGZrg]Tundr,2579,112,2,2,4,50.0%,28m
29912,1,Bauhaus,2579,0,2,3,5,40.0%,33m
29912,1,gLOoCk,2579,0,2,5,7,28.6%,1h
29912,3,HostFighter,2579,0,2,5,7,28.6%,39m
29912,1,Femire,2579,0,1,3,4,25.0%,1h
29912,2,Alkado,2579,30,1,3,4,25.0%,46m
29912,2,Neo,2579,0,0,1,1,0.0%,4m
29912,2,seven,2579,0,0,2,2,0.0%,1h
29912,2,NekoMan,2579,0,0,4,4,0.0%,46m
29941,3,moondogvoice,2578,1580,202,217,419,48.2%,22m
29941,1,JornSnow,2578,1517,167,142,309,54.0%,1h
29941,2,sanya,2578,1008,118,99,217,54.4%,1h
29941,1,BretAktaK,2578,1630,117,107,224,52.2%,1h
29941,1,NumeroUno,2578,544,100,116,216,46.3%,4m
29941,1,khodor,2578,1332,80,75,155,51.6%,1h
29941,2,Blink,2578,1534,71,56,127,55.9%,32m
29941,2,[firstb]maorlak,2578,1292,59,55,114,51.8%,49m
29941,2,Veijari,2578,1061,53,51,104,51.0%,1h
29941,2,Caizoe,2578,847,45,35,80,56.2%,1h
29941,2,Uvex,2578,882,37,30,67,55.2%,50m
29941,1,[SC22SC]Kseno,2578,819,28,35,63,44.4%,1h
29941,3,Shadox,2578,501,18,25,43,41.9%,5m
29941,1,elakmink,2578,475,15,17,32,46.9%,29m
29941,2,Equal,2578,297,13,7,20,65.0%,1h
29941,1,validng,2578,326,10,14,24,41.7%,1h
29941,2,Usul,2578,262,9,10,19,47.4%,44m
29941,2,[NoPa]niceone,2578,145,5,5,10,50.0%,28m
29941,1,Cookie,2578,0,2,3,5,40.0%,51m
29941,3,Hathi,2578,0,2,4,6,33.3%,34m
29941,2,[Додик]Mitch,2578,62,2,5,7,28.6%,44m
29941,3,Grimfiend,2578,0,1,0,1,100.0%,19m
29941,2,AlgreN,2578,0,1,1,2,50.0%,9m
29941,2,UnfairDrip,2578,0,0,1,1,0.0%,38m
29941,1,Smerti,2578,0,0,2,2,0.0%,46m
29941,3,Joe,2578,0,0,2,2,0.0%,19m
29941,2,[SaCult]FlameoN,2578,0,0,4,4,0.0%,21m
29968,2,sarus,2577,1268,261,249,510,51.2%,16m
29968,3,DrFranco,2577,1549,250,237,487,51.3%,12m
29968,1,[PANNON]Atheris,2577,1544,142,144,286,49.7%,42m
29968,2,[БУБУБ]fidger,2577,1588,98,97,195,50.3%,38m
29968,2,starscreaM,2577,1315,93,84,177,52.5%,17m
29968,2,milkycabbage,2577,738,61,36,97,62.9%,23m
29968,2,Леденец,2577,1245,54,40,94,57.4%,32m
29968,2,Tonic,2577,706,53,42,95,55.8%,42m
29968,2,Tempest,2577,1053,45,31,76,59.2%,20m
29968,2,Néométrix,2577,819,33,33,66,50.0%,1h
29968,2,kuhulin,2577,397,18,16,34,52.9%,37m
29968,2,[OldBW]Woija,2577,353,18,18,36,50.0%,38m
29968,1,[CSJCSJ]skoddet,2577,547,18,23,41,43.9%,1h
29968,3,Elyvion,2577,460,18,23,41,43.9%,11m
29968,3,Bobo,2577,212,11,14,25,44.0%,15m
29968,2,chu,2577,234,11,17,28,39.3%,9m
29968,2,Geofito,2577,247,10,10,20,50.0%,41m
29968,1,IIIIIIIIIIII,2577,204,10,11,21,47.6%,11m
29968,1,Stunner,2577,156,10,13,23,43.5%,17m
29968,1,[EXPANT]Drukaron,2577,288,9,7,16,56.2%,46m
29968,2,SirPoopins,2577,102,8,7,15,53.3%,49m
29968,1,Gizzle,2577,234,8,9,17,47.1%,1h
29968,2,Sles,2577,200,7,9,16,43.8%,1h
29968,3,Artur,2577,197,7,10,17,41.2%,7m
29968,1,Joker,2577,150,5,11,16,31.2%,1h
29968,1,RedWolf,2577,116,4,6,10,40.0%,14m
29968,2,[СCCР]xXxnikxXx,2577,0,3,2,5,60.0%,48m
29968,1,yoshi,2577,89,3,5,8,37.5%,26m
29968,1,ALHK,2577,148,3,8,11,27.3%,1h
29968,2,Thodi,2577,30,2,1,3,66.7%,4m
29968,2,Romantiks,2577,34,2,2,4,50.0%,4m
29968,2,Listat,2577,44,2,3,5,40.0%,1h
29968,1,AGrumpyPig,2577,36,2,7,9,22.2%,26m
29968,3,ALeX,2577,93,2,8,10,20.0%,4m
29968,1,[EZKBM]HeavensWolf,2577,0,1,0,1,100.0%,9m
29968,2,OldmanAdwai,2577,0,1,0,1,100.0%,48m
29968,2,Rodriguezs,2577,88,1,1,2,50.0%,43m
29968,2,NikSlaughter,2577,88,1,1,2,50.0%,39m
29968,2,Nobody,2577,30,1,2,3,33.3%,3m
29968,3,Slivenor,2577,42,1,2,3,33.3%,17m
29968,2,SQUAnation,2577,30,1,3,4,25.0%,33m
29968,3,Daddy,2577,32,1,3,4,25.0%,3m
29968,1,Petiee,2577,0,1,4,5,20.0%,46m
29968,1,[RusTM]vintik,2577,0,1,4,5,20.0%,42m
29968,1,Merlin,2577,97,1,10,11,9.1%,42m
29968,2,ГрАл,2577,0,0,1,1,0.0%,1h
29968,1,rds,2577,0,0,1,1,0.0%,11m
29968,1,[Albion]imzilot,2577,0,0,1,1,0.0%,22m
29968,2,МЭТР,2577,0,0,3,3,0.0%,41m
30017,1,DarkKnight,2576,1445,193,193,386,50.0%,24m
30017,2,StarComanRU,2576,1020,83,76,159,52.2%,1h
30017,3,mkbix,2576,746,75,69,144,52.1%,15m
30017,2,RAXON,2576,1606,63,61,124,50.8%,4m
30017,2,[OPStar]Vadim,2576,1607,61,59,120,50.8%,3m
30017,2,EmperorGG,2576,938,42,26,68,61.8%,48m
30017,1,[WeDoM]Onja,2576,791,28,32,60,46.7%,35m
30017,2,[K0mpis]Schteen,2576,613,25,19,44,56.8%,42m
30017,1,Marker,2576,804,25,32,57,43.9%,21m
30017,2,[IIII]Maverick,2576,577,23,27,50,46.0%,49m
30017,1,jaspilit,2576,231,22,28,50,44.0%,21m
30017,2,Alshain,2576,301,12,7,19,63.2%,1h
30017,2,AdvreX,2576,279,10,7,17,58.8%,3m
30017,3,Ranger,2576,239,10,12,22,45.5%,1m
30017,1,tomgaming,2576,272,10,13,23,43.5%,48m
30017,2,Mistikal,2576,277,9,10,19,47.4%,46m
30017,2,Polikarpov,2576,182,7,3,10,70.0%,10m
30017,2,Plast,2576,230,7,6,13,53.8%,10m
30017,1,PrinzBobaFat,2576,184,6,9,15,40.0%,39m
30017,2,PBalmer,2576,119,4,6,10,40.0%,50m
30017,1,[PECAN]MarioChippo,2576,186,4,9,13,30.8%,42m
30017,2,[enivay]TWTVenivay,2576,200,4,10,14,28.6%,41m
30017,3,[KVG]VikingVI,2576,36,3,5,8,37.5%,1h
30017,1,RandomF,2576,90,3,12,15,20.0%,46m
30017,2,[CZIISK]sliso,2576,0,2,3,5,40.0%,48m
30017,3,Snyper,2576,0,2,4,6,33.3%,39m
30017,2,Artcher,2576,0,1,0,1,100.0%,33m
30017,2,Heracl,2576,0,1,0,1,100.0%,50m
30017,2,Spread,2576,30,1,4,5,20.0%,43m
30017,2,Cerberus,2576,0,0,1,1,0.0%,23m
30017,2,Mikail,2576,0,0,2,2,0.0%,51m
30017,2,closirr,2576,0,0,3,3,0.0%,17m
30049,1,Rinar,2575,1610,346,332,678,51.0%,23m
30049,1,[Leid]Ymir,2575,552,112,102,214,52.3%,42m
30049,3,Mati,2575,1585,74,78,152,48.7%,4m
30049,2,[Ewaldi]OldMcBen,2575,1027,54,32,86,62.8%,23m
30049,1,AngelDeath,2575,1046,50,48,98,51.0%,1h
30049,2,[ICE5]GretaThunber,2575,939,38,33,71,53.5%,42m
30049,2,[VMPB]SurikN,2575,663,37,32,69,53.6%,34m
30049,2,Neptune,2575,649,25,21,46,54.3%,42m
30049,2,crixel,2575,474,20,16,36,55.6%,7m
30049,1,DIMON,2575,461,14,20,34,41.2%,8m
30049,1,rakso,2575,316,11,15,26,42.3%,1h
30049,2,Farsight,2575,284,9,8,17,52.9%,1h
30049,3,Korvin,2575,170,6,7,13,46.2%,21m
30049,2,DEVON,2575,148,5,8,13,38.5%,48m
30049,2,[PRDIM]AsPhIX,2575,90,4,3,7,57.1%,43m
30049,2,BluePiet,2575,90,4,6,10,40.0%,48m
30049,2,FormulaCZ,2575,123,4,7,11,36.4%,39m
30049,2,ToXeN,2575,102,3,0,3,100.0%,15m
30049,1,TnGeVclmedia,2575,0,3,2,5,60.0%,18m
30049,2,JUVE,2575,102,2,1,3,66.7%,43m
30049,2,Bleys,2575,0,2,3,5,40.0%,36m
30049,2,RuFFF,2575,0,2,3,5,40.0%,42m
30049,2,Afrikaner,2575,0,1,0,1,100.0%,5m
30049,2,Incognito,2575,0,1,0,1,100.0%,43m
30049,1,JODiE,2575,0,1,4,5,20.0%,24m
30049,1,Kayak,2575,38,1,8,9,11.1%,47m
30049,2,ganger,2575,0,0,1,1,0.0%,19m
30049,2,LightElfTank,2575,0,0,1,1,0.0%,36m
30049,3,Ganimede,2575,0,0,1,1,0.0%,39m
30049,2,Tonny,2575,0,0,1,1,0.0%,42m
30049,2,Gamma,2575,0,0,2,2,0.0%,39m
30080,3,[666999]УХО,2574,1199,119,114,233,51.1%,22m
30080,1,BezpredelYT,2574,1442,64,67,131,48.9%,10m
30080,3,[Hammer]Madtrax,2574,938,35,42,77,45.5%,9m
30080,1,DerMeister,2574,741,33,25,58,56.9%,1h
30080,2,Meyem,2574,789,33,31,64,51.6%,42m
30080,1,Nindan,2574,551,31,24,55,56.4%,26m
30080,1,Debellum,2574,793,29,34,63,46.0%,15m
30080,2,Karasik,2574,664,28,19,47,59.6%,33m
30080,1,sts,2574,752,28,26,54,51.9%,1h
30080,2,Bergen,2574,586,24,25,49,49.0%,11m
30080,1,drCeucc,2574,670,24,26,50,48.0%,35m
30080,1,JeanBombeur,2574,619,21,25,46,45.7%,45m
30080,3,MorAnd,2574,502,17,30,47,36.2%,15m
30080,1,Azelbazel,2574,442,16,18,34,47.1%,50m
30080,1,Highlander,2574,301,16,21,37,43.2%,45m
30080,1,Lazyturtle,2574,510,16,22,38,42.1%,14m
30080,3,Rauger,2574,418,15,23,38,39.5%,1m
30080,2,Stary,2574,318,13,13,26,50.0%,20m
30080,2,[FASA]Bonersoup,2574,242,9,9,18,50.0%,1h
30080,2,mafiaro,2574,169,6,5,11,54.5%,22m
30080,1,Barcode,2574,232,6,10,16,37.5%,49m
30080,2,Ilya,2574,107,5,2,7,71.4%,17m
30080,1,Davis,2574,135,4,6,10,40.0%,16m
30080,3,SpeedRacer,2574,111,4,6,10,40.0%,17m
30080,2,Melofmatix,2574,88,2,0,2,100.0%,1h
30080,2,BigSmoke,2574,0,2,1,3,66.7%,39m
30080,2,Ushak,2574,30,2,2,4,50.0%,46m
30080,2,mercǂGuts,2574,0,1,1,2,50.0%,43m
30080,2,Insaneone,2574,44,1,2,3,33.3%,42m
30080,2,stormi,2574,0,1,2,3,33.3%,1h
30080,2,Ananar,2574,34,1,5,6,16.7%,24m
30080,2,frai,2574,0,0,1,1,0.0%,50m
30112,2,Vresto,2573,1048,211,206,417,50.6%,12m
30112,2,[DFgs]Iblisz,2573,984,43,33,76,56.6%,7m
30112,2,Ötschen,2573,1046,42,32,74,56.8%,28m
30112,1,[ISRI]sol,2573,676,26,29,55,47.3%,10m
30112,2,SSq,2573,582,25,16,41,61.0%,21m
30112,1,CEALOT,2573,636,21,28,49,42.9%,29m
30112,2,[AciNoN]happy,2573,364,15,9,24,62.5%,1m
30112,2,NaNo,2573,356,14,12,26,53.8%,46m
30112,2,CybeR,2573,341,14,14,28,50.0%,23m
30112,2,[HZeS]IronIron,2573,351,13,10,23,56.5%,1h
30112,2,SayNoToStim,2573,321,13,12,25,52.0%,23m
30112,1,DigBick,2573,363,10,14,24,41.7%,17m
30112,3,Savage,2573,245,9,12,21,42.9%,6m
30112,2,Ghost,2573,186,8,13,21,38.1%,21m
30112,2,[Intas]Turuko,2573,179,5,7,12,41.7%,14m
30112,2,duke,2573,167,5,7,12,41.7%,50m
30112,3,Jedezejek,2573,58,5,8,13,38.5%,9m
30112,2,[NaOH]kenoby,2573,132,4,5,9,44.4%,17m
30112,3,[ISIC]Hisoka,2573,127,4,5,9,44.4%,3m
30112,3,MBNT,2573,78,4,6,10,40.0%,14m
30112,2,aleyckin,2573,108,3,0,3,100.0%,48m
30112,2,Bason,2573,114,3,1,4,75.0%,48m
30112,2,TSIRLIPIPIS,2573,58,2,2,4,50.0%,42m
30112,2,Ataklos,2573,0,2,4,6,33.3%,21m
30112,1,НЕНАВИСТЬ,2573,0,1,0,1,100.0%,47m
30112,1,ChinoGemiDj,2573,0,1,4,5,20.0%,7m
30112,2,sorixx,2573,30,1,6,7,14.3%,43m
30112,1,cybr,2573,0,0,1,1,0.0%,18m
30112,1,DanilReyner,2573,0,0,2,2,0.0%,28m
30112,1,Nemuray,2573,0,0,3,3,0.0%,42m
30142,3,Drakan,2572,1504,168,172,340,49.4%,7m
30142,2,Hawally,2572,848,92,73,165,55.8%,33m
30142,2,Спасокукоцки,2572,953,70,58,128,54.7%,10m
30142,2,[TheDOH]McLenn,2572,1183,47,42,89,52.8%,1h
30142,2,Bloodwake,2572,1080,45,40,85,52.9%,52m
30142,1,Prophet,2572,693,36,42,78,46.2%,42m
30142,2,Ãмḝṋṓ,2572,866,34,31,65,52.3%,43m
30142,2,[ImWRs]zergio,2572,847,33,30,63,52.4%,33m
30142,3,Fenrir,2572,751,27,31,58,46.6%,7m
30142,3,Peeraneyl,2572,500,20,26,46,43.5%,2m
30142,2,DrSteven,2572,343,14,7,21,66.7%,38m
30142,1,matriktof,2572,402,12,21,33,36.4%,1h
30142,1,crw,2572,294,11,11,22,50.0%,33m
30142,1,Fury,2572,247,10,11,21,47.6%,1h
30142,3,DarkRider,2572,213,9,10,19,47.4%,40m
30142,1,NIPkRÄSCH,2572,236,9,11,20,45.0%,4m
30142,2,Graff,2572,221,7,2,9,77.8%,48m
30142,2,[BeGa]Moppebart,2572,120,4,5,9,44.4%,42m
30142,2,Vancraft,2572,102,3,1,4,75.0%,42m
30142,1,[2iq]THETROOPER,2572,0,3,2,5,60.0%,16m
30142,2,INEDITUM,2572,0,2,1,3,66.7%,4m
30142,2,WatWatInDaBu,2572,102,2,2,4,50.0%,17m
30142,3,Litosh,2572,97,2,2,4,50.0%,1h
30142,1,ДикаяЯрость,2572,0,2,3,5,40.0%,38m
30142,2,LexX,2572,58,2,4,6,33.3%,23m
30142,2,[V1B3]STIMZ,2572,0,1,1,2,50.0%,45m
30142,1,asussega,2572,0,1,4,5,20.0%,13m
30142,2,Mates,2572,0,0,1,1,0.0%,46m
30142,1,nazeru,2572,0,0,2,2,0.0%,1h
30142,1,machoseks,2572,0,0,2,2,0.0%,16m
30172,1,DarkHunterII,2571,1649,335,334,669,50.1%,2m
30172,1,Exosome,2571,890,195,182,377,51.7%,1h
30172,2,Fizzle,2571,1582,149,141,290,51.4%,36m
30172,1,MAS,2571,919,64,66,130,49.2%,3m
30172,1,GraineGivrée,2571,943,63,65,128,49.2%,26m
30172,2,POTE,2571,1521,59,60,119,49.6%,31m
30172,1,Khan,2571,903,56,49,105,53.3%,1h
30172,2,Galeodes,2571,1111,55,53,108,50.9%,28m
30172,1,[PROST]Fregge,2571,1242,50,43,93,53.8%,10m
30172,1,GonoRReaHP,2571,1092,43,42,85,50.6%,35m
30172,2,karasik,2571,717,41,32,73,56.2%,38m
30172,2,[iality]Bergy,2571,838,37,26,63,58.7%,15m
30172,2,Ragnarson,2571,944,37,34,71,52.1%,28m
30172,2,Masupilami,2571,894,37,34,71,52.1%,6m
30172,2,Zebulon,2571,681,29,28,57,50.9%,33m
30172,2,[ZIN]Thella,2571,370,16,12,28,57.1%,1h
30172,2,[XAK]JJRipYourAss,2571,368,14,14,28,50.0%,34m
30172,2,[NWGD]Nimu,2571,303,14,14,28,50.0%,14m
30172,2,Tjompa,2571,333,13,13,26,50.0%,21m
30172,2,Fenix,2571,280,11,11,22,50.0%,5m
30172,2,chromat,2571,351,11,16,27,40.7%,18m
30172,1,kuba,2571,214,8,14,22,36.4%,9m
30172,2,llllllllllll,2571,138,5,6,11,45.5%,40m
30172,3,Spartan,2571,121,3,5,8,37.5%,7m
30172,2,terminator,2571,88,2,0,2,100.0%,21m
30172,1,Phonecall,2571,48,2,1,3,66.7%,20m
30172,1,[OverX]xcashxx,2571,115,2,2,4,50.0%,3m
30172,2,Ziga,2571,0,2,3,5,40.0%,46m
30172,2,[mltdcz]NickMcCloud,2571,0,1,1,2,50.0%,31m
30172,2,prokion,2571,0,1,1,2,50.0%,1h
30172,2,Krzysztofeł,2571,0,1,4,5,20.0%,5m
30172,2,Dzuuix,2571,0,0,1,1,0.0%,39m
30204,3,[SNENS]Bjørn,2570,1041,75,72,147,51.0%,8m
30204,1,DruidaLoco,2570,1066,70,75,145,48.3%,14m
30204,2,Prippzshadow,2570,1611,69,68,137,50.4%,24m
30204,2,Käse,2570,947,37,33,70,52.9%,1h
30204,1,photogrammtr,2570,303,33,37,70,47.1%,3m
30204,2,NicolaeGuta,2570,886,32,34,66,48.5%,1h
30204,2,kalykaa,2570,711,31,27,58,53.4%,38m
30204,2,[SNheta]Zyraxes,2570,580,25,19,44,56.8%,46m
30204,1,PanicMarine,2570,510,18,18,36,50.0%,6m
30204,1,Ратмир,2570,319,9,12,21,42.9%,16m
30204,3,null,2570,122,7,10,17,41.2%,23m
30204,2,vikror,2570,140,6,9,15,40.0%,1h
30204,1,[TGWN]Python,2570,209,6,15,21,28.6%,15m
30204,2,chibi,2570,104,5,4,9,55.6%,32m
30204,1,Tarmi,2570,206,5,13,18,27.8%,1h
30204,2,Rene,2570,136,4,5,9,44.4%,1h
30204,3,CHIDA,2570,30,4,7,11,36.4%,22m
30204,2,[SAX]Jonne,2570,158,4,12,16,25.0%,3m
30204,3,zEN,2570,145,3,1,4,75.0%,17m
30204,2,llllllllllll,2570,64,3,2,5,60.0%,3m
30204,2,RobotNinja,2570,0,2,4,6,33.3%,1h
30204,2,Ray,2570,0,1,0,1,100.0%,30m
30204,2,[blizou]darkAz,2570,0,1,0,1,100.0%,45m
30204,3,Mordrewin,2570,0,1,0,1,100.0%,26m
30204,2,laminibean,2570,0,1,1,2,50.0%,1h
30204,2,[ТХТ]nik,2570,30,1,2,3,33.3%,6m
30204,1,ИванБровко,2570,0,1,4,5,20.0%,36m
30204,3,nobosy,2570,97,1,6,7,14.3%,49m
30204,2,Alexx,2570,0,0,1,1,0.0%,1h
30204,2,bert,2570,0,0,1,1,0.0%,11m
30204,1,[UHRsch]DonnerRex,2570,0,0,5,5,0.0%,24m
30235,1,Eltar,2569,1058,242,228,470,51.5%,21m
30235,1,criminal,2569,1574,206,204,410,50.2%,32m
30235,2,huricane,2569,1501,74,73,147,50.3%,21m
30235,2,MarxNotDead,2569,1071,42,38,80,52.5%,1h
30235,1,GVOZD,2569,377,30,33,63,47.6%,2m
30235,1,DanSport,2569,740,27,33,60,45.0%,50m
30235,2,Hirudora,2569,448,16,20,36,44.4%,41m
30235,2,nicita,2569,335,15,14,29,51.7%,1m
30235,2,Dan,2569,392,14,12,26,53.8%,21m
30235,1,Mark,2569,352,14,18,32,43.8%,21m
30235,2,Klevil,2569,282,13,6,19,68.4%,19m
30235,1,kil,2569,253,10,12,22,45.5%,1m
30235,1,Fallangelpro,2569,163,8,7,15,53.3%,1h
30235,2,[PXLD]Tronzi,2569,267,8,8,16,50.0%,1h
30235,2,Никита,2569,170,7,11,18,38.9%,8m
30235,3,Candle,2569,165,6,9,15,40.0%,20m
30235,2,[OПГ]ArtDark,2569,186,5,7,12,41.7%,48m
30235,2,DARSpead,2569,159,5,8,13,38.5%,41m
30235,2,Gogu,2569,109,3,1,4,75.0%,9m
30235,3,max,2569,97,3,3,6,50.0%,18m
30235,2,TEYMENCX,2569,62,3,5,8,37.5%,7m
30235,2,Roy,2569,88,2,0,2,100.0%,1h
30235,2,DezLum,2569,60,2,4,6,33.3%,28m
30235,3,Abadok,2569,60,2,7,9,22.2%,6m
30235,2,[NWGD]Panir,2569,0,1,0,1,100.0%,1h
30235,2,YourNemesis,2569,0,1,1,2,50.0%,41m
30235,3,Tidon,2569,97,1,2,3,33.3%,51m
30235,2,Huneymunster,2569,42,1,3,4,25.0%,5m
30235,2,misieq,2569,0,1,4,5,20.0%,45m
30235,3,FoxX,2569,0,0,1,1,0.0%,51m
30235,2,Spec,2569,0,0,1,1,0.0%,33m
30235,2,[фсо]aGRo,2569,0,0,1,1,0.0%,23m
30235,3,[Miiik]crobe,2569,0,0,1,1,0.0%,14m
30268,1,[DBUGS]Forkbomb,2568,766,95,103,198,48.0%,3m
30268,2,Ivetka,2568,1154,76,77,153,49.7%,23m
30268,2,DannyT,2568,810,33,37,70,47.1%,19m
30268,2,Kirill,2568,522,26,14,40,65.0%,22m
30268,2,Erixxon,2568,451,18,20,38,47.4%,5m
30268,1,Smarog,2568,411,15,17,32,46.9%,17m
30268,1,[play45]IIIIIIIIIIII,2568,242,8,17,25,32.0%,26m
30268,2,Blain,2568,176,7,7,14,50.0%,1h
30268,2,efoincflcefc,2568,210,7,7,14,50.0%,18m
30268,2,Artanis,2568,176,6,9,15,40.0%,45m
30268,2,[MASTRO]drac,2568,112,4,1,5,80.0%,43m
30268,2,Bambucho,2568,142,4,2,6,66.7%,48m
30268,3,SmithyTed,2568,152,4,4,8,50.0%,6m
30268,3,KhalA,2568,76,2,2,4,50.0%,42m
30268,2,Морпех,2568,82,2,4,6,33.3%,17m
30268,3,Keratardon,2568,0,2,4,6,33.3%,20m
30268,1,MistyMaster,2568,48,2,4,6,33.3%,11m
30268,3,Ospa,2568,0,2,4,6,33.3%,37m
30268,1,LOVUNDKONGEN,2568,48,2,4,6,33.3%,20m
30268,2,ROCK,2568,0,1,0,1,100.0%,52m
30268,2,vicodin,2568,0,1,0,1,100.0%,1h
30268,2,Joker,2568,0,1,0,1,100.0%,1h
30268,3,LitleBeastBG,2568,0,1,2,3,33.3%,49m
30268,1,ASDASDASDASD,2568,38,1,10,11,9.1%,1h
30268,2,JägerMeister,2568,0,0,1,1,0.0%,6m
30268,2,[IceHus]Ratmir,2568,0,0,1,1,0.0%,41m
30268,2,SubaruXXX,2568,0,0,1,1,0.0%,20m
30268,2,Качинский,2568,0,0,1,1,0.0%,13m
30268,2,QfifteeN,2568,0,0,6,6,0.0%,3m
30297,2,[HFR]morpheus,2567,1575,95,89,184,51.6%,5m
30297,2,User,2567,1360,84,66,150,56.0%,32m
30297,1,супернидзя,2567,639,70,52,122,57.4%,3m
30297,2,ManFromEarth,2567,274,51,40,91,56.0%,34m
30297,2,takiinbor,2567,731,38,26,64,59.4%,19m
30297,3,timefroth,2567,694,28,36,64,43.8%,15m
30297,2,Berga,2567,582,21,25,46,45.7%,1m
30297,2,ksbiv,2567,380,20,18,38,52.6%,4m
30297,2,Xyron,2567,310,16,8,24,66.7%,18m
30297,2,Duplo,2567,404,16,11,27,59.3%,26m
30297,2,[HollоW]Hiten,2567,348,13,13,26,50.0%,41m
30297,2,Dratnuh,2567,201,12,15,27,44.4%,38m
30297,2,Lelouche,2567,298,11,8,19,57.9%,6m
30297,2,Mimiska,2567,205,9,7,16,56.2%,1m
30297,2,Metafomus,2567,191,7,3,10,70.0%,18m
30297,2,BUGOR,2567,180,6,4,10,60.0%,28m
30297,2,Trozman,2567,140,5,10,15,33.3%,19m
30297,1,duckduckgo,2567,88,4,3,7,57.1%,32m
30297,1,HummeL,2567,159,4,7,11,36.4%,51m
30297,2,Manogaroff,2567,0,2,1,3,66.7%,2m
30297,2,[Zhig]TолянRu,2567,0,2,2,4,50.0%,29m
30297,2,Kampfkarpfn,2567,114,2,2,4,50.0%,46m
30297,2,xeon,2567,34,2,3,5,40.0%,3m
30297,3,aaa,2567,145,2,3,5,40.0%,22m
30297,3,Runner,2567,40,2,3,5,40.0%,1h
30297,2,[Yame]Battlemage,2567,30,2,4,6,33.3%,17m
30297,1,YungReddi,2567,48,2,4,6,33.3%,34m
30297,3,XEasyGameX,2567,0,1,0,1,100.0%,11m
30297,2,[Nyyuko]Jmotescu,2567,30,1,2,3,33.3%,21m
30297,2,dexter,2567,88,1,2,3,33.3%,33m
30297,2,Sebitasproo,2567,30,1,4,5,20.0%,24m
30297,2,Kali,2567,44,1,6,7,14.3%,41m
30297,2,PaicCitron,2567,0,0,1,1,0.0%,3m
30297,2,MythPL,2567,0,0,1,1,0.0%,21m
30297,2,BotaNeagra,2567,0,0,1,1,0.0%,2m
30297,3,ReallyBadDoc,2567,0,0,1,1,0.0%,1h
30297,2,[xFRSx]PROtoss,2567,0,0,4,4,0.0%,3m
30297,3,vsnik,2567,0,0,4,4,0.0%,32m
30297,2,[DeusSC]axoS,2567,0,0,5,5,0.0%,1h
30336,1,JohnCena,2566,1649,100,109,209,47.8%,15m
30336,2,yorick,2566,1502,56,59,115,48.7%,38m
30336,1,mirko,2566,267,40,39,79,50.6%,45m
30336,2,Snall,2566,652,35,21,56,62.5%,41m
30336,2,[AdRiX]DOBRYS,2566,503,22,11,33,66.7%,1h
30336,2,BAKTOV,2566,310,14,11,25,56.0%,20m
30336,2,Nekroyo,2566,281,13,16,29,44.8%,6m
30336,1,[CLH]Fisherman,2566,277,11,14,25,44.0%,1h
30336,1,TErrorrizEr,2566,168,8,4,12,66.7%,1h
30336,1,DeadEye,2566,241,7,11,18,38.9%,50m
30336,2,[WАSD]Feroom,2566,58,6,3,9,66.7%,17m
30336,3,NoBigE,2566,62,6,6,12,50.0%,13m
30336,1,kakiw,2566,230,6,10,16,37.5%,43m
30336,3,Bingcrusher,2566,182,5,5,10,50.0%,32m
30336,2,Dagon,2566,88,4,2,6,66.7%,20m
30336,2,Resistor,2566,129,4,4,8,50.0%,17m
30336,1,Keona,2566,146,4,10,14,28.6%,50m
30336,1,testerino,2566,132,4,13,17,23.5%,10m
30336,2,Kikilicious,2566,90,3,6,9,33.3%,1h
30336,1,Bjarte,2566,108,3,13,16,18.8%,10m
30336,2,Flizzi,2566,0,2,3,5,40.0%,48m
30336,2,Ven,2566,30,2,6,8,25.0%,28m
30336,1,[StrCo]CheerfulAlex,2566,89,2,8,10,20.0%,1h
30336,2,JustDanil,2566,88,1,1,2,50.0%,14m
30336,3,[TSL9]Pirateado,2566,0,1,1,2,50.0%,1h
30336,3,Insolence,2566,97,1,2,3,33.3%,51m
30336,2,lmaosyka,2566,94,1,4,5,20.0%,18m
30336,2,ZELDOR,2566,0,0,1,1,0.0%,1h
30336,3,Dennis,2566,0,0,2,2,0.0%,3m
30365,3,DedoYotso,2565,788,129,128,257,50.2%,6m
30365,2,bluephoenix,2565,1604,85,80,165,51.5%,37m
30365,1,BloodyHell,2565,1233,83,68,151,55.0%,32m
30365,2,[amk666]JoKeR,2565,1468,69,62,131,52.7%,1m
30365,1,StormTrooper,2565,436,46,49,95,48.4%,41m
30365,1,Underground,2565,1109,44,40,84,52.4%,24m
30365,2,pewy,2565,458,25,3,28,89.3%,1m
30365,2,Maanesyume,2565,505,24,15,39,61.5%,6m
30365,2,Marcel,2565,502,21,14,35,60.0%,2m
30365,2,[BPulse]Karagon,2565,459,17,21,38,44.7%,18m
30365,2,robban,2565,426,16,15,31,51.6%,7m
30365,3,imincharge,2565,262,13,15,28,46.4%,9m
30365,2,Arxont,2565,185,7,1,8,87.5%,21m
30365,1,MrRight,2565,210,7,2,9,77.8%,14m
30365,1,Markeras,2565,208,7,15,22,31.8%,24m
30365,2,Sabaken,2565,217,6,9,15,40.0%,44m
30365,1,Ozymandias,2565,137,5,6,11,45.5%,1h
30365,1,Fire,2565,158,4,4,8,50.0%,15m
30365,3,Alfred,2565,97,3,4,7,42.9%,50m
30365,1,[xTSPx]Afisicos,2565,90,3,7,10,30.0%,1h
30365,2,[STRCPS]DarkPhantom,2565,96,3,8,11,27.3%,1h
30365,2,Ded,2565,60,2,3,5,40.0%,6m
30365,3,Cirkusulla,2565,0,2,4,6,33.3%,45m
30365,3,octOPUS,2565,0,2,4,6,33.3%,11m
30365,2,[DRG]GameIlnazPro,2565,0,1,0,1,100.0%,1h
30365,2,Leprikon,2565,0,1,0,1,100.0%,41m
30365,2,InSanguinum,2565,88,1,1,2,50.0%,1h
30365,2,Molsga,2565,30,1,3,4,25.0%,4m
30365,2,Easyhappy,2565,0,0,2,2,0.0%,3m
30365,2,Kyo,2565,0,0,4,4,0.0%,1h
30395,2,Hallibut,2564,1113,76,69,145,52.4%,42m
30395,2,KeKCuk,2564,379,29,19,48,60.4%,33m
30395,2,NighTy,2564,298,22,17,39,56.4%,48m
30395,2,[Шизоид]xChausesx,2564,184,11,14,25,44.0%,9m
30395,3,Henna,2564,208,10,13,23,43.5%,2m
30395,2,Kitkat,2564,193,7,8,15,46.7%,32m
30395,1,Mihi,2564,166,6,10,16,37.5%,18m
30395,3,Ustas,2564,62,5,8,13,38.5%,11m
30395,2,[TOPZIK]RiskoOne,2564,138,4,2,6,66.7%,7m
30395,2,Hawk,2564,120,4,9,13,30.8%,32m
30395,2,Coyote,2564,60,4,11,15,26.7%,10m
30395,2,Eurotrash,2564,145,3,2,5,60.0%,1h
30395,2,CaptVimes,2564,0,3,3,6,50.0%,38m
30395,2,Gobi,2564,0,2,3,5,40.0%,17m
30395,1,Lobo,2564,0,2,4,6,33.3%,27m
30395,2,Syma,2564,88,1,1,2,50.0%,1h
30395,2,[DARK86]SIGMA,2564,0,1,2,3,33.3%,42m
30395,2,[Elita]SlawkoPL,2564,0,0,1,1,0.0%,33m
30395,2,[QaDo]ВеСтНиКсМеРт,2564,0,0,1,1,0.0%,45m
30395,3,баркод,2564,0,0,1,1,0.0%,16m
30395,2,Kaeiser,2564,0,0,1,1,0.0%,1h
30395,2,[Crews]MrSkiller,2564,0,0,1,1,0.0%,33m
30395,2,[РУИНА]ГȆЛȆТРȌН,2564,0,0,4,4,0.0%,14m
30418,2,Chris,2563,1544,311,315,626,49.7%,16m
30418,1,Crowy,2563,1347,55,55,110,50.0%,33m
30418,2,ArtBitter,2563,1032,43,37,80,53.8%,1h
30418,2,AlfaCentauri,2563,588,41,35,76,53.9%,34m
30418,1,khaos,2563,874,36,36,72,50.0%,33m
30418,2,Hubert,2563,475,24,19,43,55.8%,7m
30418,1,Shadz,2563,295,20,27,47,42.6%,35m
30418,2,eggag,2563,385,18,19,37,48.6%,27m
30418,2,Namour,2563,372,15,13,28,53.6%,42m
30418,2,barisay,2563,338,14,15,29,48.3%,1h
30418,1,[WfGe]Montelus,2563,399,14,18,32,43.8%,42m
30418,2,[lOoOl]andrei,2563,302,13,6,19,68.4%,29m
30418,1,lpsalbus,2563,388,13,19,32,40.6%,30m
30418,2,notabarcode,2563,280,11,15,26,42.3%,19m
30418,2,cetera,2563,238,9,9,18,50.0%,11m
30418,1,Bear,2563,292,9,17,26,34.6%,1h
30418,1,Sosiska,2563,222,8,8,16,50.0%,16m
30418,2,Чупакупа,2563,227,8,12,20,40.0%,4m
30418,2,SanPablo,2563,206,7,10,17,41.2%,1h
30418,2,Raiden,2563,172,6,7,13,46.2%,4m
30418,2,YottaBufer,2563,90,6,9,15,40.0%,17m
30418,2,Nookem,2563,94,5,7,12,41.7%,3m
30418,1,MaybNextTime,2563,48,4,2,6,66.7%,25m
30418,2,Novendar,2563,132,4,7,11,36.4%,41m
30418,1,PackarD,2563,180,4,12,16,25.0%,35m
30418,2,darkosha,2563,102,3,0,3,100.0%,1h
30418,2,[NS2019]PhoenixNS,2563,97,3,6,9,33.3%,29m
30418,1,McFreaK,2563,70,3,9,12,25.0%,35m
30418,2,Romeo,2563,88,2,0,2,100.0%,6m
30418,2,Knuckles,2563,30,2,3,5,40.0%,23m
30418,2,Qyseth,2563,114,2,3,5,40.0%,28m
30418,2,Ewan,2563,0,2,4,6,33.3%,31m
30418,2,DarkStar,2563,0,1,0,1,100.0%,4m
30418,2,[GK27]Darkblade,2563,0,1,1,2,50.0%,17m
30418,1,[GGLose]scWildGhost,2563,0,1,4,5,20.0%,39m
30418,2,Suntra,2563,0,0,1,1,0.0%,23m
30418,2,[Нrr]Ruleezzz,2563,0,0,1,1,0.0%,44m
30418,3,AlkhasovUA,2563,0,0,1,1,0.0%,2m
30418,2,Dnoorime,2563,0,0,1,1,0.0%,1m
30418,1,Rickking,2563,0,0,1,1,0.0%,45m
30418,1,Equital,2563,0,0,2,2,0.0%,31m
30418,3,[axis]Razo,2563,0,0,2,2,0.0%,6m
30418,2,EnTeroZeratu,2563,0,0,5,5,0.0%,17m
30461,2,Ivanchik,2562,1341,121,115,236,51.3%,22m
30461,1,denissava,2562,867,112,105,217,51.6%,25m
30461,2,Talimbie,2562,1405,91,82,173,52.6%,52m
30461,2,Curious,2562,809,37,31,68,54.4%,1h
30461,2,Vaggos,2562,875,34,31,65,52.3%,22m
30461,2,shadow,2562,802,32,25,57,56.1%,20m
30461,2,Jirimir,2562,814,30,34,64,46.9%,6m
30461,1,scoon,2562,490,20,23,43,46.5%,46m
30461,2,newbie,2562,458,19,11,30,63.3%,19m
30461,1,[11121]JimmyJoe,2562,528,17,24,41,41.5%,38m
30461,2,Luras,2562,445,16,14,30,53.3%,28m
30461,2,CHRIS,2562,349,14,16,30,46.7%,6m
30461,2,ohweog,2562,336,11,14,25,44.0%,12m
30461,1,sixsevan,2562,336,11,16,27,40.7%,3m
30461,2,PANIN,2562,227,9,4,13,69.2%,1h
30461,2,[VFN]Ulixes,2562,218,7,6,13,53.8%,42m
30461,2,[monstr]Cenusareasa,2562,165,5,5,10,50.0%,42m
30461,2,ридик,2562,146,5,8,13,38.5%,33m
30461,2,[SrFt]Сардар,2562,30,3,4,7,42.9%,1m
30461,2,Barabba,2562,90,3,5,8,37.5%,52m
30461,2,Jovanizza,2562,30,3,5,8,37.5%,28m
30461,1,[RDZK]Croiss,2562,89,2,3,5,40.0%,27m
30461,3,Gabroth,2562,0,2,3,5,40.0%,1h
30461,2,Kjkalex,2562,60,2,4,6,33.3%,50m
30461,3,xanass,2562,0,2,4,6,33.3%,48m
30461,3,TeRRRkiN,2562,0,2,4,6,33.3%,48m
30461,2,tjimmy,2562,0,1,0,1,100.0%,18m
30461,2,Sky,2562,0,1,2,3,33.3%,38m
30461,2,[OGR232]SkillEnota,2562,88,1,2,3,33.3%,46m
30461,2,ToastKing,2562,0,1,4,5,20.0%,38m
30461,1,Wronkey,2562,89,1,7,8,12.5%,17m
30461,2,[ICMar]Eagletalon,2562,0,0,1,1,0.0%,6m
30461,2,Hyakutake,2562,0,0,1,1,0.0%,50m
30494,3,Giku,2561,885,99,93,192,51.6%,13m
30494,3,[BHN]Razrab,2561,1071,67,69,136,49.3%,18m
30494,1,KAPTEN,2561,1618,61,65,126,48.4%,1h
30494,2,MileyVirus,2561,655,36,24,60,60.0%,32m
30494,2,Synth,2561,593,28,27,55,50.9%,50m
30494,2,TRAMBON,2561,547,22,21,43,51.2%,48m
30494,2,llllllllllll,2561,335,19,5,24,79.2%,1m
30494,2,Lucidation,2561,530,19,20,39,48.7%,45m
30494,2,aratap,2561,550,19,24,43,44.2%,34m
30494,2,Brutalisk,2561,412,15,12,27,55.6%,20m
30494,2,Acoma,2561,238,10,7,17,58.8%,1h
30494,1,[MGT]Srague,2561,334,10,19,29,34.5%,18m
30494,2,[HBGSJR]BILICH,2561,256,8,6,14,57.1%,29m
30494,3,cxcp,2561,115,6,6,12,50.0%,22m
30494,2,[Dae]Alnaée,2561,189,5,1,6,83.3%,40m
30494,3,EGRIL,2561,186,5,5,10,50.0%,19m
30494,2,Guile,2561,114,4,4,8,50.0%,45m
30494,2,Ironman,2561,102,3,1,4,75.0%,32m
30494,3,assasyn,2561,0,3,3,6,50.0%,24m
30494,2,Baryga,2561,0,2,4,6,33.3%,33m
30494,2,Stimul,2561,30,2,6,8,25.0%,42m
30494,2,ExtraChasm,2561,0,1,1,2,50.0%,34m
30494,2,[CIU2]JackTheLord,2561,0,1,2,3,33.3%,2m
30494,2,Данил,2561,0,1,2,3,33.3%,1h
30494,2,SniperSander,2561,0,1,3,4,25.0%,17m
30494,2,danil,2561,88,1,4,5,20.0%,1h
30494,3,Shonzu,2561,0,0,1,1,0.0%,29m
30494,2,Hamely,2561,0,0,2,2,0.0%,6m
30494,2,scaveger,2561,0,0,2,2,0.0%,46m
30494,2,SnailSpeed,2561,0,0,5,5,0.0%,1m
30524,2,MonkeyDToss,2560,1124,107,100,207,51.7%,1m
30524,3,Szilard,2560,1388,81,91,172,47.1%,14m
30524,3,Nway,2560,1633,71,55,126,56.3%,25m
30524,3,Oddish,2560,563,55,52,107,51.4%,18m
30524,2,[BWArmy]Toidak,2560,602,33,33,66,50.0%,6m
30524,2,Akenit,2560,514,32,22,54,59.3%,43m
30524,1,OvidiuA,2560,924,32,37,69,46.4%,14m
30524,1,Nusky,2560,553,22,23,45,48.9%,1h
30524,1,[GdAT]fabus,2560,540,20,21,41,48.8%,1h
30524,2,PastaMan,2560,316,13,12,25,52.0%,6m
30524,3,Cycle,2560,274,11,5,16,68.8%,12m
30524,2,Nightmare,2560,268,11,8,19,57.9%,16m
30524,2,[ModeOn]lub,2560,266,7,11,18,38.9%,34m
30524,3,KTPnb,2560,66,6,10,16,37.5%,1h
30524,2,Lucky,2560,112,4,4,8,50.0%,20m
30524,1,SyntaxError,2560,116,4,12,16,25.0%,9m
30524,3,SnOwDuSt,2560,145,3,2,5,60.0%,1h
30524,3,MaitrCarotte,2560,97,3,4,7,42.9%,25m
30524,2,InVogNia,2560,114,2,2,4,50.0%,5m
30524,2,Taurus,2560,30,2,2,4,50.0%,38m
30524,2,Kagen,2560,0,2,4,6,33.3%,41m
30524,3,БешеныйГлист,2560,121,2,4,6,33.3%,48m
30524,2,Menver,2560,0,1,0,1,100.0%,50m
30524,3,[Herosi]Raymie,2560,0,1,1,2,50.0%,7m
30524,3,BSRV,2560,0,1,3,4,25.0%,25m
30524,2,Shine,2560,0,0,1,1,0.0%,1h
30550,2,ZetsuGG,2559,1606,107,96,203,52.7%,21m
30550,2,scwl,2559,1462,75,87,162,46.3%,31m
30550,1,pLaGuPlay,2559,1073,41,47,88,46.6%,29m
30550,2,CrushLP,2559,621,25,19,44,56.8%,33m
30550,2,kokopop,2559,560,22,22,44,50.0%,1h
30550,2,Tajor,2559,513,20,18,38,52.6%,34m
30550,2,senpai,2559,383,15,19,34,44.1%,22m
30550,2,Glennos,2559,386,14,12,26,53.8%,1h
30550,2,stemer,2559,293,12,10,22,54.5%,48m
30550,2,[SoloSC]Urraca,2559,240,9,10,19,47.4%,45m
30550,2,Budzo,2559,204,8,11,19,42.1%,17m
30550,3,Epsilonis,2559,192,7,4,11,63.6%,46m
30550,2,[thePG]buldos,2559,60,5,8,13,38.5%,9m
30550,1,TaRkEzZ,2559,0,4,2,6,66.7%,15m
30550,3,Vargen,2559,121,4,3,7,57.1%,52m
30550,2,[STZK]Snack,2559,90,4,4,8,50.0%,3m
30550,1,Platon,2559,107,4,8,12,33.3%,14m
30550,2,Kodakka,2559,0,2,2,4,50.0%,1h
30550,3,hunk,2559,0,2,3,5,40.0%,41m
30550,3,AxoneCum,2559,0,2,3,5,40.0%,38m
30550,3,Malariz,2559,0,2,3,5,40.0%,11m
30550,2,Serizawa,2559,0,2,4,6,33.3%,21m
30550,2,Xoco,2559,0,2,4,6,33.3%,22m
30550,3,luis,2559,0,2,4,6,33.3%,40m
30550,3,[ßnDª]Kaptar,2559,0,1,0,1,100.0%,28m
30550,3,WhiteLo,2559,30,1,1,2,50.0%,18m
30550,3,Rassel,2559,30,1,1,2,50.0%,17m
30550,3,noobz,2559,0,1,4,5,20.0%,19m
30550,3,Tselest,2559,0,0,1,1,0.0%,16m
30550,3,tutop,2559,0,0,3,3,0.0%,3m
30580,1,loo,2558,241,115,111,226,50.9%,14m
30580,2,ilya,2558,1472,68,67,135,50.4%,17m
30580,2,Aløne,2558,670,67,60,127,52.8%,46m
30580,1,minesis,2558,904,47,51,98,48.0%,46m
30580,2,[EESC]ViDi,2558,965,39,34,73,53.4%,24m
30580,1,vit,2558,941,38,31,69,55.1%,14m
30580,2,Garuwashi,2558,555,27,24,51,52.9%,39m
30580,3,DurexTrucs,2558,474,22,11,33,66.7%,20m
30580,2,lyra,2558,488,22,12,34,64.7%,41m
30580,2,kabOOm,2558,518,21,16,37,56.8%,29m
30580,1,Druks,2558,504,19,25,44,43.2%,1h
30580,2,DiscoStu,2558,363,13,10,23,56.5%,45m
30580,1,Techno,2558,316,10,11,21,47.6%,16m
30580,1,NightBaker,2558,231,8,11,19,42.1%,50m
30580,2,BatPanda,2558,232,7,9,16,43.8%,42m
30580,2,SouLStealeR,2558,224,7,10,17,41.2%,34m
30580,3,JunSK,2558,181,6,6,12,50.0%,40m
30580,2,LikemyAim,2558,38,5,4,9,55.6%,1h
30580,1,прк,2558,148,5,10,15,33.3%,29m
30580,1,Rolex,2558,166,5,16,21,23.8%,22m
30580,3,SaSsergeich,2558,165,4,7,11,36.4%,5m
30580,2,Gizmo,2558,90,3,7,10,30.0%,34m
30580,3,Wulfy,2558,30,2,0,2,100.0%,1h
30580,3,[W4ifu]CocoNutz,2558,113,2,2,4,50.0%,23m
30580,3,Wildeye,2558,60,2,2,4,50.0%,52m
30580,3,Elster,2558,0,2,3,5,40.0%,29m
30580,3,[Lyoko]LinuxFR,2558,97,2,4,6,33.3%,1h
30580,2,Stargazer,2558,0,2,4,6,33.3%,1h
30580,2,bagdanish,2558,30,1,4,5,20.0%,42m
30580,3,cedoeyxo,2558,0,1,4,5,20.0%,8m
30580,3,Light,2558,0,0,1,1,0.0%,14m
30580,2,[gokuB]Ace,2558,0,0,2,2,0.0%,22m
30612,1,LEGO,2557,1606,149,147,296,50.3%,43m
30612,1,DuoPepsi,2557,1639,138,130,268,51.5%,15m
30612,3,[adultr]kype,2557,1538,131,139,270,48.5%,22m
30612,2,Mokshadie,2557,1573,103,115,218,47.2%,18m
30612,3,Biseptold,2557,834,97,102,199,48.7%,22m
30612,2,zhenxihuaxi,2557,1239,52,46,98,53.1%,33m
30612,2,llllllllllll,2557,787,47,30,77,61.0%,16m
30612,2,SeriousMilk,2557,365,42,43,85,49.4%,46m
30612,2,SwatAustria,2557,1018,40,38,78,51.3%,21m
30612,3,JSA,2557,968,34,42,76,44.7%,15m
30612,3,Dynamitharry,2557,243,24,7,31,77.4%,14m
30612,1,Nikolay,2557,455,17,18,35,48.6%,10m
30612,3,Haron,2557,390,16,6,22,72.7%,17m
30612,2,DarkLord,2557,280,12,7,19,63.2%,6m
30612,2,Diskap,2557,288,11,8,19,57.9%,45m
30612,3,Órói,2557,304,10,8,18,55.6%,12m
30612,2,OneManArmy,2557,260,10,9,19,52.6%,19m
30612,1,ÐNAMegaton,2557,252,10,10,20,50.0%,5m
30612,2,RandomJoker,2557,186,9,1,10,90.0%,17m
30612,3,DarkSector,2557,216,9,5,14,64.3%,41m
30612,1,VityaMAD,2557,236,8,10,18,44.4%,46m
30612,3,DarkDeath,2557,142,6,2,8,75.0%,12m
30612,3,Vik,2557,112,5,7,12,41.7%,11m
30612,2,PokaPoka,2557,62,3,3,6,50.0%,1h
30612,2,hadrassun,2557,116,3,3,6,50.0%,4m
30612,1,kabrian,2557,0,3,4,7,42.9%,46m
30612,3,StefanCalin,2557,30,3,4,7,42.9%,50m
30612,3,AlenBatyi,2557,30,3,5,8,37.5%,39m
30612,2,Докеби,2557,88,2,1,3,66.7%,49m
30612,3,[SG8]Cepter,2557,0,2,3,5,40.0%,32m
30612,3,NageBator,2557,60,2,3,5,40.0%,20m
30612,2,and,2557,62,2,6,8,25.0%,36m
30612,2,Maciek,2557,66,2,7,9,22.2%,1h
30612,2,Tixon,2557,42,1,1,2,50.0%,32m
30612,3,Chiccuz,2557,36,1,3,4,25.0%,11m
30612,3,Ragnarock,2557,30,1,4,5,20.0%,39m
30612,3,NewWave,2557,0,0,1,1,0.0%,30m
30612,3,[XRaySX]Staricaft,2557,0,0,1,1,0.0%,18m
30612,2,[VNI]Defiant,2557,0,0,3,3,0.0%,50m
30612,1,Angel,2557,0,0,3,3,0.0%,51m
30612,3,[RBP3]ScorpionFire,2557,0,0,4,4,0.0%,39m
30653,2,Pacifist,2556,1387,182,176,358,50.8%,9m
30653,1,Tartoru,2556,1385,166,162,328,50.6%,29m
30653,2,KridgiGames,2556,732,73,83,156,46.8%,5m
30653,2,LIrpOON,2556,1140,48,32,80,60.0%,23m
30653,1,ich,2556,860,40,40,80,50.0%,32m
30653,2,Lagunitas,2556,1088,39,60,99,39.4%,9m
30653,3,niXXer,2556,483,18,11,29,62.1%,20m
30653,2,Marat,2556,380,14,15,29,48.3%,5m
30653,2,Zornball,2556,324,14,19,33,42.4%,8m
30653,3,ToughKnight,2556,292,10,10,20,50.0%,4m
30653,1,YEEZYBOY,2556,254,10,11,21,47.6%,35m
30653,2,Magwi,2556,269,8,9,17,47.1%,40m
30653,2,ripper,2556,165,7,1,8,87.5%,48m
30653,2,boboTCLite,2556,90,6,6,12,50.0%,7m
30653,3,ElSargento,2556,167,6,6,12,50.0%,1h
30653,2,Syncx,2556,116,6,7,13,46.2%,11m
30653,2,Hunterok,2556,136,6,9,15,40.0%,50m
30653,3,[FISI]Krypet,2556,58,5,3,8,62.5%,42m
30653,3,[Zhig]Пашель,2556,172,4,3,7,57.1%,38m
30653,2,Lapinot,2556,88,3,5,8,37.5%,1h
30653,2,Рубик,2556,30,2,2,4,50.0%,5m
30653,2,Граф,2556,0,2,4,6,33.3%,17m
30653,2,KorbenDallas,2556,32,1,3,4,25.0%,1h
30653,2,Недр,2556,0,1,4,5,20.0%,6m
30653,2,PapierWc,2556,0,1,5,6,16.7%,2m
30653,3,Bukakulis,2556,0,0,1,1,0.0%,46m
30653,2,Antropoff,2556,0,0,2,2,0.0%,20m
30680,2,[PÂRłAH]Noxmenos,2555,1136,111,106,217,51.2%,19m
30680,2,Siggaard,2555,954,58,48,106,54.7%,49m
30680,2,zjinder,2555,1390,58,52,110,52.7%,42m
30680,1,Allf,2555,1405,56,63,119,47.1%,3m
30680,1,[RusMoo]Vencendor,2555,997,37,43,80,46.2%,1h
30680,1,MegaMan,2555,818,32,33,65,49.2%,3m
30680,2,Gayство,2555,212,16,17,33,48.5%,48m
30680,3,OMEGA,2555,261,9,4,13,69.2%,1h
30680,2,sayand,2555,252,9,7,16,56.2%,6m
30680,2,Criminal,2555,268,9,8,17,52.9%,51m
30680,2,Spetsnaz,2555,236,8,6,14,57.1%,1h
30680,1,Blademaster,2555,186,7,8,15,46.7%,13m
30680,2,nofa,2555,176,5,4,9,55.6%,1h
30680,3,Nalquas,2555,170,5,5,10,50.0%,1h
30680,3,Safari,2555,164,5,5,10,50.0%,3m
30680,1,PashaK,2555,0,3,3,6,50.0%,30m
30680,1,Sspeedgaming,2555,89,3,5,8,37.5%,27m
30680,1,LonelyKnight,2555,0,2,3,5,40.0%,50m
30680,3,ThatGuy,2555,0,1,0,1,100.0%,14m
30680,3,[LSKGS]MasterEC,2555,0,1,0,1,100.0%,18m
30680,2,Bore,2555,91,1,1,2,50.0%,1h
30680,2,Surly,2555,30,1,3,4,25.0%,1h
30680,1,Rafail,2555,0,1,3,4,25.0%,36m
30680,1,Bayek,2555,0,0,1,1,0.0%,21m
30680,3,kid,2555,0,0,2,2,0.0%,24m
30680,2,ByTheBro,2555,0,0,4,4,0.0%,1h
30706,1,BobSnot,2554,1306,117,111,228,51.3%,1h
30706,3,Iamaman,2554,1273,67,63,130,51.5%,50m
30706,1,Ricril,2554,1074,66,64,130,50.8%,1h
30706,2,MiniHusarz,2554,1121,48,37,85,56.5%,38m
30706,2,Elcarnefice,2554,1166,47,46,93,50.5%,4m
30706,3,Drakers,2554,628,38,43,81,46.9%,14m
30706,1,Dim,2554,426,21,27,48,43.8%,7m
30706,2,Aurelius,2554,440,16,17,33,48.5%,41m
30706,3,Psih,2554,320,13,12,25,52.0%,19m
30706,2,tonyJ,2554,367,13,18,31,41.9%,46m
30706,2,StumerBro,2554,303,11,8,19,57.9%,28m
30706,2,[3ЕRGTV]asfW,2554,292,11,11,22,50.0%,1h
30706,1,Räeker,2554,240,10,11,21,47.6%,13m
30706,2,Fumi,2554,202,8,4,12,66.7%,48m
30706,3,nikolas,2554,224,7,9,16,43.8%,8m
30706,3,AmnesiaHaze,2554,30,5,1,6,83.3%,19m
30706,2,[Diktat]saw,2554,71,4,5,9,44.4%,46m
30706,2,Fleurdelys,2554,128,3,3,6,50.0%,12m
30706,2,afendi,2554,60,3,3,6,50.0%,41m
30706,2,kostek,2554,30,3,5,8,37.5%,41m
30706,2,Trazom,2554,30,3,5,8,37.5%,42m
30706,1,BPositive,2554,122,3,6,9,33.3%,10m
30706,2,HowlingMad,2554,46,3,7,10,30.0%,1h
30706,3,Devillion,2554,0,2,3,5,40.0%,8m
30706,1,dimka,2554,46,1,2,3,33.3%,32m
30706,2,Temp,2554,81,1,2,3,33.3%,19m
30706,3,Foundation,2554,0,1,4,5,20.0%,7m
30706,3,Ptaha,2554,0,0,1,1,0.0%,35m
30706,3,moii,2554,0,0,1,1,0.0%,18m
30706,2,Augems,2554,0,0,2,2,0.0%,40m
30706,2,[RSDikk]FeelinIt,2554,0,0,2,2,0.0%,6m
30706,2,Blâtz,2554,0,0,3,3,0.0%,24m
30738,1,LUX,2553,1630,163,157,320,50.9%,39m
30738,1,muhojuck,2553,1289,94,88,182,51.6%,10m
30738,1,ddko,2553,1143,59,63,122,48.4%,33m
30738,2,VasaZaicev,2553,963,40,41,81,49.4%,42m
30738,2,Evergen,2553,896,39,33,72,54.2%,1h
30738,3,AVCToday,2553,266,32,49,81,39.5%,20m
30738,1,[CHOPAA]Blood,2553,619,20,25,45,44.4%,17m
30738,1,bacillus,2553,408,17,16,33,51.5%,24m
30738,1,Антошка,2553,487,17,19,36,47.2%,29m
30738,2,Naoul,2553,412,14,19,33,42.4%,10m
30738,2,MadJohn,2553,382,13,16,29,44.8%,38m
30738,1,Whatev,2553,264,9,10,19,47.4%,1h
30738,3,Madrin,2553,233,7,4,11,63.6%,25m
30738,2,[BzHeRo]AnaixPL,2553,147,7,8,15,46.7%,4m
30738,2,Dyna,2553,244,7,9,16,43.8%,32m
30738,2,HoYaGa,2553,178,6,5,11,54.5%,9m
30738,2,vongola,2553,164,5,4,9,55.6%,1h
30738,1,marijane,2553,150,5,10,15,33.3%,23m
30738,2,Sasen,2553,117,4,7,11,36.4%,47m
30738,2,nekotrap,2553,116,3,2,5,60.0%,45m
30738,3,lolmaster,2553,30,3,4,7,42.9%,1h
30738,3,[RuLi]FonzA,2553,66,3,6,9,33.3%,24m
30738,2,НеБейтеПж,2553,60,3,7,10,30.0%,1h
30738,3,Disciples,2553,58,2,1,3,66.7%,16m
30738,3,FireKing,2553,38,2,2,4,50.0%,34m
30738,2,dots,2553,137,2,5,7,28.6%,7m
30738,3,MECKAJIuHE,2553,0,1,0,1,100.0%,9m
30738,3,nboypiatka,2553,0,1,0,1,100.0%,26m
30738,2,Profjupieter,2553,0,1,1,2,50.0%,52m
30738,3,Ivanan,2553,0,1,2,3,33.3%,34m
30738,3,Guts,2553,30,1,4,5,20.0%,23m
30738,3,Suisei,2553,0,0,1,1,0.0%,26m
30770,3,[OSgZ]ketchupfreak,2552,1641,119,164,283,42.0%,21m
30770,1,[krzys]arcimowicz,2552,1233,92,89,181,50.8%,1h
30770,2,fragalit,2552,1132,74,60,134,55.2%,42m
30770,2,Arev,2552,1220,45,46,91,49.5%,45m
30770,2,reusdeus,2552,603,24,19,43,55.8%,7m
30770,2,beber,2552,421,20,22,42,47.6%,4m
30770,2,Bielski,2552,586,20,24,44,45.5%,4m
30770,2,Kurty,2552,453,19,11,30,63.3%,43m
30770,2,Green,2552,438,18,19,37,48.6%,42m
30770,1,[TLKES]Loganolt,2552,498,16,19,35,45.7%,39m
30770,3,BloodYStaR,2552,224,14,7,21,66.7%,12m
30770,3,CAD,2552,282,11,5,16,68.8%,1h
30770,2,[UndeD]Under,2552,298,11,14,25,44.0%,21m
30770,3,[LKLM]Reeva,2552,237,10,7,17,58.8%,50m
30770,1,Alchem,2552,264,10,11,21,47.6%,1h
30770,3,TheCoon,2552,239,9,7,16,56.2%,41m
30770,2,Fleaxa,2552,230,8,6,14,57.1%,27m
30770,2,Cas,2552,218,8,8,16,50.0%,39m
30770,2,ElGranGaibs,2552,279,8,12,20,40.0%,19m
30770,2,JinRevan,2552,218,7,8,15,46.7%,11m
30770,2,[ARTAS]Eeroladan,2552,144,6,6,12,50.0%,33m
30770,2,Goblin,2552,138,3,4,7,42.9%,27m
30770,3,BlackWatch,2552,30,2,0,2,100.0%,50m
30770,1,zins,2552,0,2,5,7,28.6%,33m
30770,3,Leon,2552,0,1,4,5,20.0%,26m
30770,3,crazycake,2552,0,0,1,1,0.0%,25m
30770,3,[CОS]innoVation,2552,0,0,1,1,0.0%,41m
30770,3,Jetmuse,2552,0,0,1,1,0.0%,22m
30770,2,Jehuu,2552,0,0,2,2,0.0%,1h
30770,2,Teddy,2552,0,0,2,2,0.0%,19m
30770,2,Soldier,2552,0,0,2,2,0.0%,23m
30770,2,angrypanda,2552,0,0,2,2,0.0%,39m
30770,3,VasserMan,2552,0,0,3,3,0.0%,50m
30803,1,adonai,2551,1643,70,74,144,48.6%,24m
30803,2,[KZ1337]Staf,2551,1304,64,57,121,52.9%,1h
30803,2,[r32]Борщевик,2551,923,60,58,118,50.8%,21m
30803,3,Avalak,2551,543,22,13,35,62.9%,1h
30803,2,Grakh,2551,620,22,26,48,45.8%,39m
30803,2,lolmot,2551,471,20,21,41,48.8%,50m
30803,3,[SCRT]RainerDreck,2551,417,17,20,37,45.9%,6m
30803,3,[Héoh]Eltitou,2551,309,13,12,25,52.0%,19m
30803,2,Nofear,2551,251,8,8,16,50.0%,42m
30803,2,Schoki,2551,90,7,7,14,50.0%,3m
30803,3,[memnio]TitoIlRosso,2551,97,3,4,7,42.9%,50m
30803,1,Dima,2551,0,2,1,3,66.7%,22m
30803,2,Garrison,2551,0,2,2,4,50.0%,2m
30803,2,RussianNoob,2551,30,2,3,5,40.0%,7m
30803,3,Varron,2551,0,2,4,6,33.3%,49m
30803,2,[ATCH]Nord,2551,0,1,1,2,50.0%,23m
30803,2,TheDealer,2551,0,1,1,2,50.0%,1h
30803,2,IlyasBP,2551,0,1,3,4,25.0%,38m
30803,3,[NaNii]NeverAlpha,2551,0,0,1,1,0.0%,9m
30803,3,Aliander,2551,0,0,1,1,0.0%,1h
30803,1,Alexanderas,2551,0,0,1,1,0.0%,12m
30803,2,GreenWORLD,2551,0,0,2,2,0.0%,50m
30803,2,BlueYoshy,2551,0,0,4,4,0.0%,20m
30826,2,Legios,2550,1519,77,64,141,54.6%,11m
30826,3,[KERNEL]Холодный,2550,877,57,63,120,47.5%,10m
30826,1,KingSashka,2550,706,35,22,57,61.4%,14m
30826,3,[HRD]Lukotas,2550,922,31,44,75,41.3%,10m
30826,3,Kroll,2550,348,13,11,24,54.2%,1h
30826,2,Ierron,2550,372,13,17,30,43.3%,7m
30826,1,Hadgehog,2550,341,12,10,22,54.5%,50m
30826,1,cokefleet,2550,327,12,11,23,52.2%,24m
30826,1,xdestinyx,2550,174,12,16,28,42.9%,23m
30826,1,xHoschi,2550,359,11,13,24,45.8%,30m
30826,3,[QClan]opahs,2550,264,8,3,11,72.7%,32m
30826,3,[NWGD]Крамбл,2550,216,8,5,13,61.5%,12m
30826,2,vipecco,2550,172,6,8,14,42.9%,1h
30826,2,Derman,2550,120,6,8,14,42.9%,48m
30826,1,Whitenova,2550,161,6,9,15,40.0%,5m
30826,2,MoodSwings,2550,90,4,5,9,44.4%,21m
30826,3,AksMax,2550,0,3,2,5,60.0%,1h
30826,2,PriesTofLove,2550,0,3,6,9,33.3%,31m
30826,3,Eldrad,2550,0,2,3,5,40.0%,26m
30826,1,Alvis,2550,0,2,3,5,40.0%,38m
30826,2,[FrcLn]SzobiPetya,2550,60,2,4,6,33.3%,38m
30826,3,Кемпиль,2550,0,2,4,6,33.3%,26m
30826,2,[gllv]Phoenix,2550,66,2,5,7,28.6%,12m
30826,3,Hyllus,2550,0,1,0,1,100.0%,34m
30826,3,artanis,2550,0,0,1,1,0.0%,11m
30826,2,Nedug,2550,0,0,2,2,0.0%,30m
30826,2,archi,2550,0,0,2,2,0.0%,50m
30853,2,[DaFF]Arbok,2549,1160,121,95,216,56.0%,49m
30853,1,IIreyesII,2549,1276,77,77,154,50.0%,6m
30853,1,Nitrogen,2549,1614,72,71,143,50.3%,1h
30853,2,DerGeraet,2549,1132,55,40,95,57.9%,49m
30853,3,Dragonborn,2549,746,30,30,60,50.0%,5m
30853,2,[Dose]AbdulLachmal,2549,702,28,33,61,45.9%,24m
30853,3,Rampart,2549,582,22,21,43,51.2%,1h
30853,2,Ztyxx,2549,478,19,22,41,46.3%,1h
30853,3,DimonGold,2549,428,16,13,29,55.2%,50m
30853,1,mrzdrva,2549,356,13,16,29,44.8%,33m
30853,3,Misanthrope,2549,312,12,5,17,70.6%,1h
30853,3,Amig,2549,236,11,13,24,45.8%,16m
30853,2,JleLmeshek,2549,240,7,8,15,46.7%,7m
30853,2,[tTDDs]fabi,2549,228,7,10,17,41.2%,40m
30853,3,JeanMiAulas,2549,97,5,3,8,62.5%,45m
30853,1,[EnBois]Cnetom,2549,242,5,11,16,31.2%,41m
30853,2,[13Rätt]Sweadde,2549,176,4,4,8,50.0%,32m
30853,2,Whynot,2549,121,4,4,8,50.0%,21m
30853,3,Schumi,2549,135,4,5,9,44.4%,49m
30853,1,BiniBan,2549,159,3,4,7,42.9%,2m
30853,3,FazaDzika,2549,0,1,0,1,100.0%,15m
30853,3,Michelkooo,2549,0,1,0,1,100.0%,41m
30853,2,[NOwin]HUNter,2549,30,1,4,5,20.0%,29m
30853,1,latinos,2549,0,1,4,5,20.0%,42m
30853,2,SauerKraut,2549,30,1,5,6,16.7%,1h
30853,2,Angakkoq,2549,30,1,5,6,16.7%,30m
30853,3,xxLjxx,2549,0,0,1,1,0.0%,1h
30853,2,[Köfte]LeonLion,2549,0,0,2,2,0.0%,16m
30881,1,Morpheus,2548,1270,351,338,689,50.9%,1h
30881,1,Robby,2548,1555,170,167,337,50.4%,2m
30881,1,Аларак,2548,1602,108,109,217,49.8%,14m
30881,2,SlavaIgonin,2548,1553,89,92,181,49.2%,42m
30881,3,jemjest,2548,1075,42,32,74,56.8%,7m
30881,2,Weaponsb,2548,718,41,35,76,53.9%,5m
30881,2,Kubanoid,2548,309,29,22,51,56.9%,49m
30881,2,Tzarkan,2548,609,23,19,42,54.8%,20m
30881,2,Yarkoni,2548,526,20,20,40,50.0%,1h
30881,1,Frice,2548,486,19,20,39,48.7%,14m
30881,3,[LIQUID]unTonee,2548,467,18,25,43,41.9%,20m
30881,1,swaglord,2548,424,16,21,37,43.2%,13m
30881,2,SilentPork,2548,270,13,7,20,65.0%,3m
30881,1,Tvorobey,2548,338,10,18,28,35.7%,50m
30881,2,Hakles,2548,268,9,11,20,45.0%,42m
30881,3,[SJT]Belly,2548,152,6,9,15,40.0%,7m
30881,1,Barabashka,2548,145,5,8,13,38.5%,36m
30881,3,IvBa,2548,131,3,1,4,75.0%,19m
30881,2,MorTiss,2548,92,3,9,12,25.0%,43m
30881,3,Väinämöinen,2548,96,2,4,6,33.3%,38m
30881,3,[AciNoN]Skill,2548,0,1,0,1,100.0%,30m
30881,1,Trabe,2548,0,1,0,1,100.0%,52m
30881,2,Berilii,2548,0,1,0,1,100.0%,9m
30881,3,Bunnyshoots,2548,0,1,0,1,100.0%,20m
30881,2,Nemo,2548,44,1,3,4,25.0%,39m
30881,2,[132]PHOENIX,2548,0,1,5,6,16.7%,23m
30881,1,Frayt,2548,32,1,7,8,12.5%,1h
30881,3,NuStream,2548,0,0,1,1,0.0%,22m
30881,3,[DL2006]Wirv,2548,0,0,1,1,0.0%,8m
30881,3,Géno,2548,0,0,1,1,0.0%,34m
30881,2,SeTe,2548,0,0,2,2,0.0%,1h
30881,2,kohuro,2548,0,0,3,3,0.0%,42m
30881,2,Gemachter,2548,0,0,3,3,0.0%,1h
30914,3,Paardman,2547,1283,167,148,315,53.0%,20m
30914,2,Taaramae,2547,1648,91,91,182,50.0%,14m
30914,2,Lukin,2547,524,36,27,63,57.1%,38m
30914,3,ribki,2547,400,27,14,41,65.9%,34m
30914,3,Bulwark,2547,494,27,30,57,47.4%,2m
30914,1,Rane,2547,627,23,24,47,48.9%,32m
30914,2,[JaPP]Notorious,2547,455,20,10,30,66.7%,18m
30914,2,OssinatorK,2547,466,16,16,32,50.0%,5m
30914,2,svatyPeter,2547,202,9,7,16,56.2%,50m
30914,2,Twijet,2547,228,8,6,14,57.1%,13m
30914,3,dZine,2547,122,8,9,17,47.1%,8m
30914,2,punkero,2547,191,7,11,18,38.9%,11m
30914,2,[Zeus]Jordi,2547,152,6,9,15,40.0%,50m
30914,1,Brainz,2547,217,6,11,17,35.3%,51m
30914,3,Nikolas,2547,193,5,7,12,41.7%,1h
30914,3,Schwaben,2547,0,3,2,5,60.0%,51m
30914,3,Genji,2547,90,3,3,6,50.0%,1h
30914,2,[ExTr1m]pinkers,2547,58,3,3,6,50.0%,33m
30914,2,XEYTER,2547,128,3,4,7,42.9%,16m
30914,2,[DRЕAM]Khael,2547,0,3,6,9,33.3%,1h
30914,3,[TLT]faKe,2547,60,3,15,18,16.7%,3m
30914,3,[morts]TheFatho,2547,30,2,0,2,100.0%,17m
30914,3,konservbl,2547,0,2,4,6,33.3%,1h
30914,3,GopStop,2547,30,1,1,2,50.0%,9m
30914,2,executor,2547,30,1,3,4,25.0%,5m
30914,3,Vitaliy,2547,0,1,4,5,20.0%,51m
30914,2,erenoix,2547,30,1,4,5,20.0%,42m
30914,1,DaB,2547,0,0,2,2,0.0%,42m
30914,1,AurskogMafia,2547,0,0,2,2,0.0%,14m
30914,3,[1243]SandWarrior,2547,0,0,3,3,0.0%,1h
30944,2,john,2546,1247,64,60,124,51.6%,42m
30944,3,mopastar,2546,1138,48,48,96,50.0%,22m
30944,2,Cryonis,2546,446,17,21,38,44.7%,33m
30944,3,[PowOw]TheDoctor,2546,405,16,3,19,84.2%,22m
30944,2,Biniu,2546,441,16,14,30,53.3%,4m
30944,3,Blader,2546,178,15,8,23,65.2%,12m
30944,1,Kenglezar,2546,388,15,16,31,48.4%,15m
30944,2,KoaK,2546,289,14,2,16,87.5%,28m
30944,2,raminelli,2546,332,13,15,28,46.4%,6m
30944,2,Zettris,2546,360,12,16,28,42.9%,9m
30944,1,Ähnen,2546,228,9,14,23,39.1%,1h
30944,2,Каратель,2546,214,8,6,14,57.1%,27m
30944,1,thorius,2546,307,8,14,22,36.4%,20m
30944,3,Angriff,2546,214,6,6,12,50.0%,35m
30944,2,[SloT]Kocó,2546,92,4,6,10,40.0%,4m
30944,3,PJOZeus,2546,0,3,3,6,50.0%,47m
30944,3,МИША,2546,30,2,0,2,100.0%,1h
30944,1,[HiJYNX]Despian,2546,0,2,3,5,40.0%,52m
30944,2,ChefZealot,2546,30,2,3,5,40.0%,3m
30944,2,Lochnes,2546,60,2,4,6,33.3%,46m
30944,2,Troscian,2546,0,2,4,6,33.3%,29m
30944,3,JimmyPunch,2546,0,2,6,8,25.0%,18m
30944,3,[118Fr]Mancuzz,2546,30,1,1,2,50.0%,19m
30944,2,CptPicard,2546,44,1,3,4,25.0%,11m
30944,1,aye,2546,48,1,3,4,25.0%,1h
30944,3,Ninjaturtle,2546,0,0,1,1,0.0%,1h
30944,3,[ЛНС]люрр,2546,0,0,1,1,0.0%,30m
30944,3,[mcbz]silfin,2546,0,0,1,1,0.0%,1h
30944,2,DDR,2546,0,0,2,2,0.0%,49m
30973,3,Sprudel,2545,1505,116,105,221,52.5%,7m
30973,2,Giverlet,2545,1416,76,73,149,51.0%,45m
30973,2,[uCHAD]KolesławCh,2545,1097,49,29,78,62.8%,48m
30973,2,hearthdragon,2545,865,36,28,64,56.2%,37m
30973,1,Dart,2545,954,34,36,70,48.6%,14m
30973,1,kornikz,2545,587,31,34,65,47.7%,27m
30973,3,Ellorie,2545,409,16,13,29,55.2%,1h
30973,3,Darkblack,2545,332,13,6,19,68.4%,30m
30973,1,[TLD]EricCartman,2545,346,11,20,31,35.5%,22m
30973,2,[KiII]Shata,2545,260,9,6,15,60.0%,5m
30973,2,[Ирбис]alex,2545,122,7,3,10,70.0%,6m
30973,1,marinebig,2545,195,7,4,11,63.6%,22m
30973,2,RaRaRasputin,2545,178,7,7,14,50.0%,45m
30973,2,[ĐoŁ]Masarykt,2545,222,7,8,15,46.7%,1h
30973,1,Ingi,2545,154,7,10,17,41.2%,9m
30973,2,Pyth,2545,154,5,3,8,62.5%,45m
30973,2,Hthcz,2545,168,5,8,13,38.5%,49m
30973,2,[BBr0s]Lucifer,2545,86,4,6,10,40.0%,38m
30973,3,Impulsive,2545,0,3,2,5,60.0%,20m
30973,2,[BWArmy]DarkSwaGG,2545,60,3,4,7,42.9%,52m
30973,2,IIIIIIIIII,2545,94,3,8,11,27.3%,38m
30973,3,DaRKing,2545,30,2,0,2,100.0%,37m
30973,2,danoul,2545,88,2,1,3,66.7%,1h
30973,1,bloom,2545,0,2,3,5,40.0%,16m
30973,2,[SryPod]Стол,2545,0,1,1,2,50.0%,36m
30973,1,[nogang]cassecaillou,2545,0,1,2,3,33.3%,21m
30973,2,DragonVlad,2545,0,1,2,3,33.3%,45m
30973,1,Phillip,2545,0,1,4,5,20.0%,34m
30973,1,SoloLeveling,2545,0,1,4,5,20.0%,30m
30973,1,[Frgs]DerKiller,2545,0,0,1,1,0.0%,13m
30973,3,[WCSCCZ]Fonecta,2545,0,0,1,1,0.0%,32m
30973,3,emperor,2545,0,0,1,1,0.0%,30m
30973,2,kotskot,2545,0,0,6,6,0.0%,13m
31006,3,George,2544,927,99,118,217,45.6%,1m
31006,2,[DPL7]Darkus,2544,1376,54,53,107,50.5%,29m
31006,2,ItzakStern,2544,1194,53,44,97,54.6%,20m
31006,2,GaaRa,2544,1068,47,38,85,55.3%,38m
31006,3,NikolausBog,2544,764,39,32,71,54.9%,2m
31006,2,SuHuitSixDR,2544,460,36,40,76,47.4%,45m
31006,2,koolingro,2544,670,22,24,46,47.8%,1h
31006,3,Sanity,2544,292,10,2,12,83.3%,2m
31006,2,SSSafranek,2544,259,10,6,16,62.5%,49m
31006,1,Emilio,2544,158,7,5,12,58.3%,1h
31006,3,Facepalm,2544,194,7,7,14,50.0%,15m
31006,2,Bagdad,2544,144,7,8,15,46.7%,1h
31006,3,Maul,2544,0,4,3,7,57.1%,20m
31006,2,galaahuukhan,2544,106,3,6,9,33.3%,46m
31006,2,SPOOFomenore,2544,0,3,6,9,33.3%,16m
31006,3,WellBloud,2544,30,2,0,2,100.0%,23m
31006,3,[ПИCYN]MihanySEX,2544,30,2,0,2,100.0%,38m
31006,2,splash,2544,42,2,1,3,66.7%,42m
31006,3,[ЗЕRGТV]Kaz,2544,0,1,0,1,100.0%,4m
31006,1,Mal,2544,48,1,3,4,25.0%,16m
31006,2,[SCSEU]BenBytes,2544,0,1,4,5,20.0%,28m
31006,3,xGHOSTEx,2544,0,0,1,1,0.0%,47m
31006,3,Maximus,2544,0,0,1,1,0.0%,45m
31006,1,BloOdǂSoun,2544,0,0,4,4,0.0%,22m
31006,2,sofroom,2544,0,0,4,4,0.0%,44m
31006,2,Yarikomen,2544,0,0,4,4,0.0%,7m
31032,3,Master,2543,1617,128,132,260,49.2%,1h
31032,1,arkadipeter,2543,1239,109,106,215,50.7%,15m
31032,2,[ExTr1m]DEMON,2543,826,47,33,80,58.8%,1h
31032,3,JeanGens,2543,856,39,28,67,58.2%,19m
31032,1,URAGANO,2543,984,39,38,77,50.6%,11m
31032,2,pookich,2543,820,36,30,66,54.5%,20m
31032,2,PlayerPaule,2543,862,36,35,71,50.7%,15m
31032,2,[LOIX]Lysy,2543,601,26,17,43,60.5%,37m
31032,3,LunarNova,2543,422,15,21,36,41.7%,11m
31032,3,Siddharta,2543,226,11,6,17,64.7%,11m
31032,2,sNowman,2543,260,10,11,21,47.6%,41m
31032,2,YELAIAH,2543,30,5,3,8,62.5%,41m
31032,2,[WT74]pandaroux,2543,178,5,5,10,50.0%,36m
31032,1,Clarkovic,2543,126,4,13,17,23.5%,15m
31032,2,KillerCourse,2543,46,3,6,9,33.3%,33m
31032,3,ВОМП,2543,0,2,3,5,40.0%,47m
31032,2,Frosch,2543,0,2,4,6,33.3%,1h
31032,3,Draki,2543,0,2,4,6,33.3%,49m
31032,1,ksai,2543,0,1,0,1,100.0%,13m
31032,2,DeWo,2543,0,1,1,2,50.0%,9m
31032,1,steypho,2543,0,1,4,5,20.0%,1h
31032,3,hitmanttv,2543,0,1,4,5,20.0%,20m
31032,3,ADHD,2543,0,0,1,1,0.0%,32m
31032,2,Raqzor,2543,0,0,2,2,0.0%,15m
31032,2,LazZ,2543,0,0,2,2,0.0%,42m
31057,3,[LIQUID]LONELYSPIRIT,2542,1561,292,296,588,49.7%,21m
31057,1,Xavier,2542,1617,253,261,514,49.2%,14m
31057,2,PPnaSH,2542,990,140,131,271,51.7%,20m
31057,1,[НОД17]deepinmymind,2542,973,96,98,194,49.5%,1h
31057,2,Snabeldraken,2542,1195,71,68,139,51.1%,44m
31057,2,GetRekt,2542,1493,64,64,128,50.0%,34m
31057,3,Reflex,2542,867,46,40,86,53.5%,31m
31057,2,[Gand]Starfury,2542,988,42,43,85,49.4%,23m
31057,2,SuchY,2542,681,36,35,71,50.7%,38m
31057,1,jaweeeeel,2542,642,25,23,48,52.1%,30m
31057,2,lohkar,2542,504,23,12,35,65.7%,34m
31057,1,[TEZz]slenderstar,2542,636,23,37,60,38.3%,33m
31057,2,KENTAURUS,2542,528,20,19,39,51.3%,6m
31057,2,Kubika,2542,346,18,19,37,48.6%,3m
31057,2,Jazdero,2542,306,11,9,20,55.0%,48m
31057,2,Stels,2542,260,10,11,21,47.6%,3m
31057,1,Vahuhol,2542,210,8,11,19,42.1%,2m
31057,2,Anty,2542,217,7,7,14,50.0%,27m
31057,2,[Debbn]Gamox,2542,152,6,9,15,40.0%,6m
31057,3,DrKisel,2542,177,5,1,6,83.3%,22m
31057,3,lllllllllll,2542,30,4,7,11,36.4%,11m
31057,3,Torygg,2542,0,3,3,6,50.0%,30m
31057,2,replayRTW,2542,96,3,7,10,30.0%,23m
31057,2,Tassadar,2542,0,2,3,5,40.0%,12m
31057,2,BadGone,2542,0,2,4,6,33.3%,11m
31057,1,KoSmoS,2542,104,2,9,11,18.2%,49m
31057,1,Diamand,2542,0,1,0,1,100.0%,1h
31057,3,MedoBan,2542,0,1,0,1,100.0%,51m
31057,2,kirilllol,2542,30,1,4,5,20.0%,1h
31057,2,Leo,2542,32,1,5,6,16.7%,1h
31087,2,Pozitiv,2541,1477,176,165,341,51.6%,37m
31087,3,Karuzo,2541,1552,97,95,192,50.5%,2m
31087,1,Slow,2541,1590,94,94,188,50.0%,1h
31087,3,Gevjan,2541,1396,90,92,182,49.5%,9m
31087,3,Aluveth,2541,651,37,33,70,52.9%,22m
31087,2,[SeeLaw]Axblade,2541,670,25,25,50,50.0%,49m
31087,1,Nikitka,2541,116,24,29,53,45.3%,10m
31087,3,silentmouse,2541,298,12,10,22,54.5%,1h
31087,2,KenY,2541,305,11,7,18,61.1%,1h
31087,2,HighNoon,2541,218,9,4,13,69.2%,38m
31087,2,glitchbitch,2541,225,9,7,16,56.2%,2m
31087,3,[TAW]Celtic,2541,226,8,7,15,53.3%,11m
31087,1,CmdrBastok,2541,234,7,11,18,38.9%,7m
31087,2,Bursa,2541,86,4,3,7,57.1%,5m
31087,3,[InvKit]Stardeimon,2541,86,4,6,10,40.0%,38m
31087,3,Technosouls,2541,40,3,5,8,37.5%,25m
31087,3,[Xa]Asso,2541,58,2,1,3,66.7%,20m
31087,3,AlleBalle,2541,97,2,1,3,66.7%,30m
31087,3,DrAngelicus,2541,96,2,1,3,66.7%,42m
31087,2,LiMoN,2541,30,2,3,5,40.0%,19m
31087,3,KidneycAmper,2541,0,2,3,5,40.0%,11m
31087,3,AgentIZain,2541,0,2,3,5,40.0%,38m
31087,3,kalterapfel,2541,0,2,3,5,40.0%,51m
31087,2,Napleton,2541,30,2,4,6,33.3%,28m
31087,2,wiLLow,2541,0,2,4,6,33.3%,1h
31087,3,BlinkOne,2541,0,2,5,7,28.6%,37m
31087,3,Ranafein,2541,0,1,0,1,100.0%,4m
31087,3,[IIILeg]Ytka,2541,0,1,0,1,100.0%,1h
31087,3,Roman,2541,0,1,0,1,100.0%,24m
31087,3,Andrey,2541,0,1,0,1,100.0%,3m
31087,3,Cammorr,2541,0,1,0,1,100.0%,20m
31087,2,AnimalPrint,2541,0,0,1,1,0.0%,3m
31087,3,Qbamax,2541,0,0,2,2,0.0%,38m
31087,2,Karmion,2541,0,0,3,3,0.0%,1h
31087,2,[PHYSIK]Bluecurry,2541,0,0,5,5,0.0%,17m
31122,2,Mikin,2540,1469,182,166,348,52.3%,45m
31122,2,Icarion,2540,578,29,25,54,53.7%,27m
31122,2,FONDZY,2540,567,23,26,49,46.9%,50m
31122,2,Кайф,2540,522,22,22,44,50.0%,23m
31122,2,Thomas,2540,544,20,21,41,48.8%,51m
31122,1,Tyroler,2540,376,16,8,24,66.7%,6m
31122,3,Saggi,2540,420,16,10,26,61.5%,25m
31122,1,rabar,2540,179,16,14,30,53.3%,29m
31122,2,AndyAndy,2540,444,16,18,34,47.1%,46m
31122,3,neverovvvvvv,2540,329,14,20,34,41.2%,9m
31122,1,[C12760]Nojus,2540,394,13,15,28,46.4%,27m
31122,1,[fam1ly]Kebabnxtdoor,2540,221,11,9,20,55.0%,16m
31122,3,BlackKevinS,2540,279,9,3,12,75.0%,1h
31122,2,[Oapm]Patrick,2540,310,9,11,20,45.0%,1h
31122,2,[C74]Evan,2540,211,7,9,16,43.8%,1h
31122,2,Scar,2540,148,5,10,15,33.3%,6m
31122,3,happyrouge,2540,121,3,0,3,100.0%,45m
31122,2,Opponent,2540,102,3,1,4,75.0%,18m
31122,3,TechnicalBg,2540,30,2,1,3,66.7%,45m
31122,3,boder,2540,119,2,1,3,66.7%,47m
31122,2,pipito,2540,30,2,2,4,50.0%,33m
31122,3,Helox,2540,121,2,2,4,50.0%,1h
31122,1,DarkUnity,2540,97,2,5,7,28.6%,24m
31122,3,[SPAINs]ZEIT,2540,30,1,1,2,50.0%,5m
31122,3,Test,2540,97,1,1,2,50.0%,38m
31122,2,[PIAIC]Wridem,2540,0,1,4,5,20.0%,5m
31122,2,DarKWoOd,2540,30,1,4,5,20.0%,41m
31122,2,[TAW]artnquest,2540,0,0,1,1,0.0%,1h
31122,1,LemmingSK,2540,0,0,1,1,0.0%,46m
31122,2,MercyHentai,2540,0,0,2,2,0.0%,1h
31152,2,Effect,2539,1589,120,92,212,56.6%,38m
31152,2,RedShooterGo,2539,1377,111,103,214,51.9%,1h
31152,3,geesmo,2539,966,51,47,98,52.0%,19m
31152,2,brkxik,2539,528,32,36,68,47.1%,50m
31152,2,[Gоld]Samara,2539,725,30,22,52,57.7%,47m
31152,1,[TheDOH]Frostwolf,2539,470,16,25,41,39.0%,39m
31152,2,Atrivix,2539,454,15,22,37,40.5%,52m
31152,2,TUJE,2539,285,14,10,24,58.3%,49m
31152,1,SiK,2539,265,9,9,18,50.0%,9m
31152,2,Ted,2539,206,9,10,19,47.4%,1h
31152,2,FRANKI,2539,205,8,5,13,61.5%,44m
31152,2,THERIM,2539,157,5,4,9,55.6%,1h
31152,3,NaPlayer,2539,185,5,5,10,50.0%,2m
31152,2,qoop,2539,90,4,5,9,44.4%,34m
31152,2,Maximo,2539,118,4,6,10,40.0%,34m
31152,3,jido,2539,146,4,6,10,40.0%,18m
31152,3,Irkles,2539,60,3,1,4,75.0%,31m
31152,2,silviu,2539,0,3,7,10,30.0%,20m
31152,3,ReptilMagico,2539,30,2,0,2,100.0%,49m
31152,2,[ULTX]lol,2539,88,2,1,3,66.7%,50m
31152,2,Raven,2539,42,2,2,4,50.0%,16m
31152,1,[RoCr]superkaito,2539,0,2,3,5,40.0%,16m
31152,2,[puff]BlackWolf,2539,0,2,4,6,33.3%,41m
31152,2,[Limee]kringe,2539,0,2,4,6,33.3%,33m
31152,2,MİLLER,2539,62,2,7,9,22.2%,29m
31152,3,Magellan,2539,0,1,1,2,50.0%,24m
31152,2,[G4YoU]LingKing,2539,0,1,1,2,50.0%,1h
31152,2,count,2539,0,1,5,6,16.7%,2m
31152,1,santei,2539,30,1,9,10,10.0%,11m
31152,3,[TDA]Micutzu,2539,0,0,1,1,0.0%,34m
31182,2,[SLAY]CHEGEVARA,2538,1638,156,153,309,50.5%,41m
31182,1,ivga,2538,1341,119,105,224,53.1%,3m
31182,2,[COSTV]JeanBon,2538,1221,56,51,107,52.3%,16m
31182,3,Icredd,2538,1046,45,40,85,52.9%,9m
31182,1,babok,2538,468,18,14,32,56.2%,42m
31182,2,Aannoxe,2538,450,18,21,39,46.2%,41m
31182,3,Ernestok,2538,302,11,8,19,57.9%,52m
31182,2,murshroomik,2538,298,10,16,26,38.5%,37m
31182,2,irimir,2538,148,5,8,13,38.5%,38m
31182,2,COCOJR,2538,88,4,5,9,44.4%,1h
31182,2,Nakhttoter,2538,152,4,6,10,40.0%,15m
31182,3,Nemesis,2538,0,3,2,5,60.0%,35m
31182,2,aFox,2538,0,3,4,7,42.9%,32m
31182,2,TKACH,2538,86,3,6,9,33.3%,24m
31182,2,TimLasky,2538,40,2,1,3,66.7%,30m
31182,3,Karrkerras,2538,0,1,0,1,100.0%,1h
31182,3,mrpena,2538,0,1,4,5,20.0%,47m
31182,2,infinity,2538,0,1,4,5,20.0%,34m
31182,1,Kris,2538,96,1,5,6,16.7%,47m
31182,3,SARMAT,2538,0,0,1,1,0.0%,9m
31182,3,[PuSl]Protossex,2538,0,0,1,1,0.0%,34m
31182,3,starcrAYEft,2538,0,0,2,2,0.0%,31m
31182,2,[fpros]MinchiaZio,2538,0,0,4,4,0.0%,46m
31205,1,[DaFF]Delusion,2537,1606,277,275,552,50.2%,47m
31205,1,[Olney]Skeletor,2537,1432,107,101,208,51.4%,41m
31205,3,yesint,2537,808,91,88,179,50.8%,12m
31205,1,Bilal,2537,1130,69,70,139,49.6%,46m
31205,3,Truffolo,2537,1648,66,61,127,52.0%,2m
31205,3,sergei,2537,928,65,61,126,51.6%,1h
31205,2,rbfi,2537,1046,44,44,88,50.0%,50m
31205,2,[ULOST]StarBart,2537,825,38,38,76,50.0%,49m
31205,2,Phoenix,2537,148,24,17,41,58.5%,48m
31205,1,Zutschini,2537,459,20,26,46,43.5%,36m
31205,1,Tugrul,2537,330,11,6,17,64.7%,50m
31205,2,DadOO,2537,287,11,11,22,50.0%,4m
31205,1,ElfeNirokois,2537,284,10,13,23,43.5%,42m
31205,3,Scorn,2537,251,8,2,10,80.0%,1h
31205,2,Dolby,2537,234,7,9,16,43.8%,3m
31205,2,JackHell,2537,119,4,1,5,80.0%,18m
31205,1,ТихоМирно,2537,115,4,6,10,40.0%,42m
31205,2,Amalthea,2537,105,4,10,14,28.6%,50m
31205,2,Karnos,2537,114,3,3,6,50.0%,28m
31205,1,MaphLionXIV,2537,122,3,5,8,37.5%,23m
31205,2,[MynFre]Horsekiller,2537,94,3,9,12,25.0%,21m
31205,3,[MoHd]Didi,2537,0,2,4,6,33.3%,32m
31205,2,НуББик,2537,0,2,4,6,33.3%,41m
31205,3,Konstantin,2537,0,1,0,1,100.0%,1h
31205,3,[krmng]orasept,2537,0,1,1,2,50.0%,17m
31205,2,deadspase,2537,0,1,1,2,50.0%,48m
31205,1,[VATAN]DeadFighter,2537,48,1,2,3,33.3%,14m
31205,3,Berger,2537,30,1,2,3,33.3%,51m
31205,3,alukard,2537,38,1,3,4,25.0%,32m
31205,3,[NForL]Budle,2537,0,1,4,5,20.0%,3m
31205,3,Helinox,2537,0,0,1,1,0.0%,20m
31205,3,Bzyko,2537,0,0,1,1,0.0%,31m
31205,3,cowhunter,2537,0,0,1,1,0.0%,51m
31238,1,SHARP,2536,1300,50,60,110,45.5%,42m
31238,1,blizzzzz,2536,1024,49,50,99,49.5%,1h
31238,3,[OtAg]Manchatz,2536,882,41,35,76,53.9%,20m
31238,3,PlatonLOL,2536,543,31,27,58,53.4%,23m
31238,1,wildfreeze,2536,728,29,30,59,49.2%,42m
31238,2,Voleumek,2536,200,20,18,38,52.6%,49m
31238,3,[SkEpic]XDDDDDDDDDDD,2536,313,16,2,18,88.9%,41m
31238,1,Benzitler,2536,395,16,14,30,53.3%,1h
31238,2,[EPIR]Anthühr,2536,353,14,11,25,56.0%,38m
31238,1,[Schrat]HöhlenSchrat,2536,312,14,15,29,48.3%,24m
31238,3,dronsis,2536,340,13,8,21,61.9%,50m
31238,2,DoK,2536,304,12,15,27,44.4%,12m
31238,2,Ultra,2536,256,11,13,24,45.8%,5m
31238,2,kreaps,2536,206,8,9,17,47.1%,5m
31238,2,[TOMBOS]Higo,2536,178,6,8,14,42.9%,1h
31238,3,Gravitation,2536,88,6,9,15,40.0%,6m
31238,2,moro,2536,160,6,13,19,31.6%,12m
31238,2,DreamZzZ,2536,86,5,7,12,41.7%,47m
31238,2,VladIsLove,2536,186,5,9,14,35.7%,19m
31238,2,Gwiber,2536,118,4,8,12,33.3%,1h
31238,1,Chaptastix,2536,141,3,2,5,60.0%,49m
31238,2,Sunnygirl,2536,88,2,1,3,66.7%,45m
31238,3,romek,2536,60,2,2,4,50.0%,41m
31238,2,[ADVT42]Arsenaal,2536,108,2,3,5,40.0%,1h
31238,3,[VETAN]IFier,2536,60,2,3,5,40.0%,3m
31238,3,wildback,2536,0,2,3,5,40.0%,51m
31238,1,Elekit,2536,48,2,4,6,33.3%,23m
31238,3,nothing,2536,97,2,6,8,25.0%,1h
31238,3,WarRaccoon,2536,0,1,0,1,100.0%,20m
31238,3,elbodenbob,2536,0,1,0,1,100.0%,24m
31238,3,ADVARD,2536,0,1,1,2,50.0%,23m
31238,1,Kuba,2536,0,1,3,4,25.0%,9m
31238,1,[TBRow]PnzrBear,2536,0,1,5,6,16.7%,38m
31238,3,Тандыров,2536,0,0,1,1,0.0%,31m
31238,3,[2C1G1]Keni,2536,0,0,1,1,0.0%,34m
31238,2,alberick,2536,0,0,3,3,0.0%,36m
31274,1,KKM,2535,1625,497,509,1006,49.4%,15m
31274,2,Aage,2535,1435,110,106,216,50.9%,6m
31274,3,MoneyEater,2535,1039,64,46,110,58.2%,30m
31274,2,Miha,2535,794,60,44,104,57.7%,47m
31274,3,kerop,2535,1111,40,46,86,46.5%,14m
31274,3,Robibob,2535,829,37,35,72,51.4%,1h
31274,2,Usbwarrior,2535,268,32,19,51,62.7%,26m
31274,1,[Sepuku]ЯКРУТ,2535,788,28,34,62,45.2%,46m
31274,3,ПростоБог,2535,619,24,21,45,53.3%,19m
31274,1,deathmode,2535,231,9,12,21,42.9%,6m
31274,2,[Salsig]Preacher,2535,152,5,4,9,55.6%,50m
31274,1,[Petrиs]Kiranos,2535,172,5,14,19,26.3%,27m
31274,3,[NMTJ]KQsa,2535,73,3,1,4,75.0%,47m
31274,2,säätösauli,2535,100,3,6,9,33.3%,48m
31274,3,Socison,2535,30,1,1,2,50.0%,49m
31274,2,JTR,2535,42,1,4,5,20.0%,52m
31274,3,[xSuK]géologue,2535,0,0,1,1,0.0%,1h
31274,3,RpgFiftyNine,2535,0,0,1,1,0.0%,2m
31274,2,добрыйЭэх,2535,0,0,2,2,0.0%,6m
31274,3,mauti,2535,0,0,2,2,0.0%,28m
31294,2,Dufrain,2534,1050,68,61,129,52.7%,42m
31294,1,Lomic,2534,605,38,46,84,45.2%,35m
31294,1,lekvedator,2534,850,36,33,69,52.2%,1h
31294,2,Meridian,2534,509,21,16,37,56.8%,1h
31294,1,lamok,2534,567,20,25,45,44.4%,47m
31294,2,[SoothK]Kurt,2534,534,19,20,39,48.7%,24m
31294,2,ZVZisthebest,2534,397,16,16,32,50.0%,5m
31294,2,Zest,2534,507,15,24,39,38.5%,5m
31294,2,AreUserious,2534,343,11,11,22,50.0%,49m
31294,1,Genki,2534,321,10,7,17,58.8%,13m
31294,2,Raminus,2534,176,7,8,15,46.7%,37m
31294,1,[NICHE]PrettyFly,2534,202,6,5,11,54.5%,34m
31294,3,[Listic]Mafydurf,2534,209,6,7,13,46.2%,20m
31294,3,[ADKL]Swich,2534,146,5,6,11,45.5%,25m
31294,2,StevenSeagal,2534,138,4,1,5,80.0%,29m
31294,2,SemiGhoul,2534,95,3,4,7,42.9%,1h
31294,3,[SMRC]MendozA,2534,0,2,4,6,33.3%,32m
31294,2,Saucisseman,2534,0,2,4,6,33.3%,2m
31294,3,Prophet,2534,0,1,0,1,100.0%,14m
31294,3,[Fabbel]DimonDeleron,2534,0,1,1,2,50.0%,17m
31294,3,BASTHORK,2534,30,1,2,3,33.3%,18m
31294,3,Zackelis,2534,0,0,1,1,0.0%,39m
31294,3,BornToKiLL,2534,0,0,1,1,0.0%,34m
31294,2,[тьма]multosss,2534,0,0,3,3,0.0%,4m
31318,2,Robocop,2533,1573,232,224,456,50.9%,1h
31318,2,[bbYoda]Rikku,2533,1521,62,61,123,50.4%,2m
31318,2,[SPAINs]madara,2533,1073,47,34,81,58.0%,47m
31318,1,javibox,2533,403,38,41,79,48.1%,23m
31318,1,[Moskva]Rodnoy,2533,659,37,35,72,51.4%,28m
31318,3,fruit,2533,694,35,6,41,85.4%,19m
31318,2,[ISRI]Titano,2533,432,17,18,35,48.6%,22m
31318,2,[Frntln]Mylor,2533,403,16,14,30,53.3%,33m
31318,2,[Izual]VeryEasy,2533,472,16,22,38,42.1%,43m
31318,2,luka,2533,390,15,19,34,44.1%,50m
31318,2,Tritont,2533,354,14,10,24,58.3%,11m
31318,1,limfostar,2533,242,12,9,21,57.1%,1h
31318,2,LuckyThanos,2533,270,9,10,19,47.4%,19m
31318,3,[ROTR]MarMeLad,2533,237,8,2,10,80.0%,50m
31318,2,Anthraxius,2533,220,8,11,19,42.1%,1h
31318,2,Fear,2533,103,8,13,21,38.1%,5m
31318,1,[TFSC]FenRir,2533,149,7,7,14,50.0%,1h
31318,3,Nibelunge,2533,144,6,5,11,54.5%,30m
31318,2,Silvanest,2533,227,6,9,15,40.0%,19m
31318,3,logorithm,2533,150,5,7,12,41.7%,34m
31318,3,[DirStr]Stahor,2533,86,4,0,4,100.0%,41m
31318,3,Superkiller,2533,155,4,6,10,40.0%,1h
31318,2,CJRS,2533,88,4,6,10,40.0%,10m
31318,3,salazar,2533,88,3,3,6,50.0%,9m
31318,3,Immortal,2533,90,3,5,8,37.5%,34m
31318,3,Dezz,2533,90,3,5,8,37.5%,41m
31318,3,teromit,2533,30,2,0,2,100.0%,30m
31318,3,[13NRV]robingood,2533,58,2,1,3,66.7%,1h
31318,2,Destroyer,2533,30,2,3,5,40.0%,19m
31318,2,Gensei,2533,102,2,3,5,40.0%,29m
31318,2,DaGOAT,2533,0,2,3,5,40.0%,6m
31318,3,ixvil,2533,0,1,0,1,100.0%,49m
31318,1,TimeToDie,2533,0,1,1,2,50.0%,1h
31318,3,[PdTus]Vogul,2533,0,1,4,5,20.0%,17m
31318,3,[jfjggf]demnp,2533,0,1,8,9,11.1%,23m
31318,3,ImL,2533,0,0,1,1,0.0%,16m
31318,3,Бердянец,2533,0,0,2,2,0.0%,32m
31355,1,Badidea,2532,1406,300,306,606,49.5%,43m
31355,2,Crunch,2532,1370,71,69,140,50.7%,42m
31355,2,Magnalux,2532,1342,59,66,125,47.2%,19m
31355,3,Yetey,2532,557,55,31,86,64.0%,32m
31355,2,Silverxx,2532,693,55,52,107,51.4%,20m
31355,2,[NMSQ]Fullar,2532,857,36,26,62,58.1%,4m
31355,2,ALkoNAfT,2532,642,23,24,47,48.9%,9m
31355,1,cakal,2532,213,21,13,34,61.8%,3m
31355,2,[CVK]Livingdeath,2532,440,19,19,38,50.0%,1h
31355,2,Toss,2532,157,14,14,28,50.0%,12m
31355,2,kirilwarlord,2532,232,13,6,19,68.4%,7m
31355,2,ILLaizer,2532,314,13,8,21,61.9%,18m
31355,1,Mich,2532,309,12,13,25,48.0%,46m
31355,3,FerZ,2532,338,11,6,17,64.7%,9m
31355,1,DżiDżiLord,2532,293,10,11,21,47.6%,33m
31355,1,cjey,2532,306,10,14,24,41.7%,11m
31355,3,zoposranchik,2532,197,8,2,10,80.0%,8m
31355,2,[1NFEC7]Soosa,2532,184,6,7,13,46.2%,31m
31355,1,lapinfurtif,2532,140,6,10,16,37.5%,46m
31355,3,karax,2532,120,4,6,10,40.0%,23m
31355,2,Lego,2532,139,4,7,11,36.4%,34m
31355,2,OKS,2532,0,3,6,9,33.3%,36m
31355,2,[ƗNCƗ]CeddeR,2532,88,2,1,3,66.7%,29m
31355,3,ZeroTooL,2532,30,2,1,3,66.7%,9m
31355,3,SecdThought,2532,60,2,2,4,50.0%,15m
31355,3,Solargamp,2532,0,2,3,5,40.0%,24m
31355,1,[R3s]Gorefiend,2532,48,2,5,7,28.6%,28m
31355,1,monsuta,2532,0,2,5,7,28.6%,46m
31355,3,LOLтакНельзя,2532,0,1,0,1,100.0%,1h
31355,3,HAVEFAN,2532,0,1,0,1,100.0%,39m
31355,2,[AOWT]Starlight,2532,30,1,4,5,20.0%,43m
31355,3,maidhros,2532,0,0,1,1,0.0%,9m
31355,3,Pharael,2532,0,0,1,1,0.0%,3m
31355,3,karelzabijak,2532,0,0,2,2,0.0%,18m
31355,2,[J4E]Geronimus,2532,0,0,4,4,0.0%,4m
31390,2,Mombi,2531,1195,51,43,94,54.3%,1h
31390,3,wormstrong,2531,1058,40,36,76,52.6%,22m
31390,1,Sozornast,2531,1104,37,43,80,46.2%,16m
31390,1,Snorky,2531,908,35,36,71,49.3%,26m
31390,2,kolos,2531,706,30,25,55,54.5%,6m
31390,2,Ashenari,2531,649,26,34,60,43.3%,47m
31390,2,weok,2531,638,23,25,48,47.9%,45m
31390,1,xin,2531,541,21,22,43,48.8%,26m
31390,3,hennick,2531,448,18,11,29,62.1%,3m
31390,3,Kropeczka,2531,240,16,12,28,57.1%,33m
31390,2,Bloddyelbow,2531,428,16,19,35,45.7%,12m
31390,3,DestraM,2531,332,11,5,16,68.8%,8m
31390,2,Teufelskreis,2531,279,11,11,22,50.0%,1h
31390,1,SERTEX,2531,293,11,12,23,47.8%,13m
31390,2,[LMBD]hasantur,2531,247,9,10,19,47.4%,41m
31390,2,georiege,2531,216,8,6,14,57.1%,48m
31390,3,DanMars,2531,211,7,0,7,100.0%,3m
31390,2,Netherfrost,2531,178,6,9,15,40.0%,49m
31390,2,MikeAsgard,2531,118,5,8,13,38.5%,26m
31390,3,[LCRF]Hаруто,2531,86,4,0,4,100.0%,23m
31390,1,[YoMamm]Spoiler,2531,0,4,3,7,57.1%,15m
31390,3,Lowen,2531,58,3,1,4,75.0%,34m
31390,1,Wiersbrowsky,2531,48,2,0,2,100.0%,22m
31390,3,LaKArate,2531,0,2,0,2,100.0%,38m
31390,2,reynors,2531,44,2,1,3,66.7%,1h
31390,3,ZSlicer,2531,30,2,2,4,50.0%,1h
31390,3,Brave,2531,0,2,4,6,33.3%,45m
31390,1,Shamisha,2531,48,2,4,6,33.3%,46m
31390,3,[DMOS]Dominik,2531,0,1,0,1,100.0%,7m
31390,2,MasakraNaPol,2531,0,0,2,2,0.0%,1h
31390,3,BotTitLiquid,2531,0,0,2,2,0.0%,12m
31421,1,Conte,2530,1589,238,242,480,49.6%,3m
31421,3,Metamorfo,2530,1187,165,157,322,51.2%,21m
31421,1,RassadnikoV,2530,1384,89,85,174,51.1%,22m
31421,2,Khaldar,2530,1456,89,90,179,49.7%,16m
31421,1,VTjoe,2530,1597,66,78,144,45.8%,52m
31421,2,NewBee,2530,682,31,18,49,63.3%,49m
31421,2,Zaito,2530,270,16,12,28,57.1%,34m
31421,2,undertaker,2530,432,16,16,32,50.0%,6m
31421,2,Silhouette,2530,396,14,15,29,48.3%,49m
31421,2,Desroyer,2530,325,14,17,31,45.2%,46m
31421,3,[GJC]NikitaB,2530,310,10,7,17,58.8%,43m
31421,2,Maestro,2530,236,8,11,19,42.1%,12m
31421,3,pwi,2530,216,6,3,9,66.7%,11m
31421,3,Fosh,2530,116,4,2,6,66.7%,32m
31421,3,julall,2530,86,3,2,5,60.0%,2m
31421,2,Capablanca,2530,94,3,6,9,33.3%,16m
31421,3,Yoann,2530,30,2,0,2,100.0%,45m
31421,1,Endoro,2530,0,2,5,7,28.6%,20m
31421,2,DALLER,2530,88,1,2,3,33.3%,1h
31421,2,TancheG,2530,30,1,3,4,25.0%,1h
31421,3,Funkaps,2530,0,0,1,1,0.0%,1h
31421,3,[кур]ДаркСкръббъл,2530,0,0,2,2,0.0%,23m
31421,1,Steefen,2530,0,0,3,3,0.0%,43m
31421,2,NuBiK,2530,0,0,3,3,0.0%,12m
31445,3,Nardac,2529,1205,299,277,576,51.9%,1h
31445,2,RAPSODY,2529,1541,101,92,193,52.3%,6m
31445,2,Pipito,2529,895,98,79,177,55.4%,1h
31445,2,ReBah,2529,1349,69,61,130,53.1%,22m
31445,2,MOFFTARKIN,2529,1266,63,65,128,49.2%,48m
31445,3,HSZ,2529,1125,52,50,102,51.0%,18m
31445,2,parabellum,2529,682,27,29,56,48.2%,6m
31445,1,Masterpiece,2529,553,22,22,44,50.0%,42m
31445,3,SasNiYMVK,2529,536,20,13,33,60.6%,31m
31445,3,Sebbb,2529,539,20,18,38,52.6%,34m
31445,3,Army,2529,516,19,16,35,54.3%,20m
31445,3,Ronnyrom,2529,399,16,18,34,47.1%,9m
31445,2,Porodok,2529,430,15,18,33,45.5%,46m
31445,1,Dexter,2529,341,12,15,27,44.4%,1h
31445,3,redbird,2529,289,10,15,25,40.0%,21m
31445,3,sayrax,2529,228,9,4,13,69.2%,47m
31445,3,RUM,2529,196,8,4,12,66.7%,31m
31445,2,StaryKomuch,2529,199,7,7,14,50.0%,1h
31445,1,MaîtrJaskier,2529,148,5,8,13,38.5%,26m
31445,2,supernamnam,2529,0,4,2,6,66.7%,20m
31445,3,derek,2529,0,4,2,6,66.7%,52m
31445,1,Biohazzard,2529,38,4,6,10,40.0%,14m
31445,2,Steb,2529,129,3,0,3,100.0%,48m
31445,3,ELKAPO,2529,0,3,2,5,60.0%,12m
31445,2,asfarko,2529,30,3,5,8,37.5%,1h
31445,2,Huyen,2529,60,3,5,8,37.5%,1h
31445,3,Thanos,2529,97,3,5,8,37.5%,51m
31445,2,Kingkong,2529,30,2,2,4,50.0%,45m
31445,1,azlaker,2529,0,1,1,2,50.0%,52m
31445,3,BBZ,2529,30,1,3,4,25.0%,9m
31445,1,[Furer]Pifagor,2529,94,1,3,4,25.0%,32m
31445,3,ARES,2529,0,0,1,1,0.0%,49m
31445,3,[Tuning]Tenwors,2529,0,0,1,1,0.0%,43m
31445,3,Khrono,2529,0,0,2,2,0.0%,18m
31445,3,UnkindledONE,2529,0,0,5,5,0.0%,43m
31480,1,Instinct,2528,1384,125,109,234,53.4%,21m
31480,2,TamalkaN,2528,1555,84,80,164,51.2%,11m
31480,2,julian,2528,1441,58,54,112,51.8%,37m
31480,3,OmegaT,2528,1298,51,51,102,50.0%,31m
31480,2,IpMan,2528,862,35,36,71,49.3%,38m
31480,1,TheBeast,2528,609,30,34,64,46.9%,51m
31480,3,Tsubasa,2528,245,19,9,28,67.9%,47m
31480,1,[iUm]SeraScyllium,2528,483,15,21,36,41.7%,14m
31480,3,Scorpio,2528,336,13,7,20,65.0%,15m
31480,2,DarrMortvs,2528,279,12,10,22,54.5%,22m
31480,1,SannyKrocket,2528,376,11,15,26,42.3%,47m
31480,3,Krabos,2528,282,10,3,13,76.9%,1h
31480,2,Sasidi,2528,278,10,10,20,50.0%,45m
31480,1,[VZON]Frisk,2528,205,8,11,19,42.1%,7m
31480,1,Rodi,2528,223,8,12,20,40.0%,27m
31480,3,diego,2528,200,7,6,13,53.8%,31m
31480,3,brokeboy,2528,114,5,0,5,100.0%,15m
31480,2,dart,2528,183,5,6,11,45.5%,41m
31480,2,JustTerran,2528,180,5,6,11,45.5%,5m
31480,3,minatokai,2528,150,5,7,12,41.7%,12m
31480,2,Spufer,2528,0,3,5,8,37.5%,1h
31480,2,TEZz,2528,58,3,5,8,37.5%,1h
31480,3,Kazarl,2528,121,3,5,8,37.5%,27m
31480,3,timtim,2528,20,3,11,14,21.4%,12m
31480,3,Flux,2528,30,2,1,3,66.7%,23m
31480,2,wrath,2528,30,2,3,5,40.0%,4m
31480,3,Zpapa,2528,0,0,1,1,0.0%,15m
31480,2,VEz,2528,0,0,1,1,0.0%,9m
31480,3,home,2528,0,0,1,1,0.0%,21m
31480,3,Etircopyh,2528,0,0,2,2,0.0%,51m
31510,3,Arno,2527,958,252,252,504,50.0%,22m
31510,2,Biggles,2527,1261,92,75,167,55.1%,39m
31510,3,Gfer,2527,1515,82,87,169,48.5%,17m
31510,2,Hdzsi,2527,1282,47,52,99,47.5%,26m
31510,2,Fluttershy,2527,939,39,34,73,53.4%,1h
31510,1,fardaxo,2527,1124,38,48,86,44.2%,36m
31510,2,Meatpants,2527,679,31,30,61,50.8%,1h
31510,2,lurcal,2527,691,30,31,61,49.2%,11m
31510,3,[BoBF]Mostunique,2527,675,26,33,59,44.1%,8m
31510,2,tangokim,2527,482,20,14,34,58.8%,33m
31510,2,SanyokXD,2527,403,16,15,31,51.6%,49m
31510,2,[EliteX]Romanoos,2527,316,11,13,24,45.8%,41m
31510,2,[3osG]Demon,2527,236,8,15,23,34.8%,4m
31510,1,seraith,2527,164,6,10,16,37.5%,35m
31510,2,[NukeZ]AirToss,2527,90,4,4,8,50.0%,4m
31510,1,Opadelirium,2527,0,3,2,5,60.0%,32m
31510,3,[RankUp]Gromon,2527,121,3,4,7,42.9%,34m
31510,2,[KKFL]KaKi,2527,58,3,7,10,30.0%,9m
31510,1,Aposthle,2527,0,2,3,5,40.0%,46m
31510,3,CaptAnanas,2527,0,2,4,6,33.3%,34m
31510,1,Dimriy,2527,0,2,5,7,28.6%,26m
31510,2,[APFB]Atomary,2527,62,2,6,8,25.0%,29m
31510,3,[UqNa]Milkor,2527,0,1,0,1,100.0%,32m
31510,3,ceko,2527,30,1,1,2,50.0%,47m
31510,3,Ridexplayer,2527,0,1,3,4,25.0%,32m
31510,3,VooDooBY,2527,0,0,1,1,0.0%,37m
31510,3,[perfec]antonio,2527,0,0,1,1,0.0%,42m
31510,2,Neti,2527,0,0,2,2,0.0%,42m
31538,3,DonConsti,2526,1091,92,89,181,50.8%,34m
31538,1,Pasha,2526,1544,86,79,165,52.1%,1h
31538,2,BattleStyle,2526,1093,85,80,165,51.5%,24m
31538,1,[PLA2N]KingConsole,2526,1400,83,66,149,55.7%,6m
31538,1,hawkk,2526,1401,67,74,141,47.5%,18m
31538,2,[lOoOl]NoobyDoo,2526,708,26,27,53,49.1%,5m
31538,2,[Chariz]Ester,2526,608,21,25,46,45.7%,1h
31538,1,SoKoJI,2526,444,16,20,36,44.4%,15m
31538,2,bourdonne,2526,368,12,14,26,46.2%,1h
31538,3,[NdCl]DarkNiles,2526,178,9,2,11,81.8%,22m
31538,3,[WАSD]Starman,2526,291,9,11,20,45.0%,41m
31538,3,Ponchik,2526,186,8,9,17,47.1%,9m
31538,2,Okin,2526,202,7,8,15,46.7%,4m
31538,3,Basis,2526,239,6,8,14,42.9%,40m
31538,2,Demonix,2526,190,6,9,15,40.0%,51m
31538,3,Evgen,2526,196,5,5,10,50.0%,1h
31538,3,KomandoPilon,2526,102,5,7,12,41.7%,17m
31538,3,Feligion,2526,145,5,9,14,35.7%,8m
31538,1,Kroko,2526,0,2,0,2,100.0%,2m
31538,3,SommO,2526,58,2,3,5,40.0%,1h
31538,2,RedisonOOX,2526,0,2,4,6,33.3%,21m
31538,1,MetalSheep,2526,97,2,4,6,33.3%,16m
31538,3,Lambda,2526,0,2,8,10,20.0%,5m
31538,3,AiD,2526,0,1,0,1,100.0%,1h
31538,3,Fenrir,2526,30,1,3,4,25.0%,1h
31538,2,Anuvis,2526,0,1,6,7,14.3%,17m
31538,3,nasum,2526,0,0,1,1,0.0%,11m
31538,3,[kuzi]Necromancer,2526,0,0,2,2,0.0%,12m
31538,1,Kojot,2526,0,0,3,3,0.0%,13m
31567,3,doberman,2525,1086,108,86,194,55.7%,8m
31567,2,gengiskhan,2525,1321,77,83,160,48.1%,5m
31567,2,[PECAN]DarthVader,2525,859,35,32,67,52.2%,37m
31567,1,Havefun,2525,736,25,29,54,46.3%,22m
31567,1,хочусказатаб,2525,619,21,27,48,43.8%,9m
31567,3,[MCLKs]Devres,2525,548,20,16,36,55.6%,1h
31567,3,Earov,2525,360,14,13,27,51.9%,19m
31567,2,Kotlett,2525,364,12,13,25,48.0%,27m
31567,1,Bouzu,2525,262,9,14,23,39.1%,35m
31567,3,RealEGGMAN,2525,241,8,5,13,61.5%,19m
31567,3,Swuder,2525,102,6,7,13,46.2%,1h
31567,3,TBAG,2525,30,2,0,2,100.0%,19m
31567,1,Saimon,2525,95,2,1,3,66.7%,1h
31567,3,[GnnnN]Xnat,2525,60,2,2,4,50.0%,22m
31567,1,[ARBY]Sioban,2525,0,2,3,5,40.0%,5m
31567,2,Txankete,2525,0,2,4,6,33.3%,48m
31567,3,[HCCB]Heimdall,2525,0,1,0,1,100.0%,30m
31567,3,Suus,2525,0,1,0,1,100.0%,1h
31567,3,Klerk,2525,30,1,1,2,50.0%,1h
31567,2,[4EK]ewanleboss,2525,0,1,2,3,33.3%,34m
31567,1,DarkNets,2525,0,1,6,7,14.3%,30m
31567,1,Spectrum,2525,0,1,7,8,12.5%,27m
31567,3,Wtonilveg,2525,0,0,2,2,0.0%,46m
31567,2,alex,2525,0,0,3,3,0.0%,22m
31567,2,Salameche,2525,73,0,4,4,0.0%,2m
31567,2,Bulat,2525,0,0,5,5,0.0%,51m
31593,2,Макар,2524,1562,185,182,367,50.4%,2m
31593,2,[DeathT]DoN,2524,1488,59,56,115,51.3%,21m
31593,2,Stepnov,2524,813,55,45,100,55.0%,52m
31593,2,[BCNE]Borremann,2524,1347,54,56,110,49.1%,34m
31593,2,zizou,2524,1148,47,43,90,52.2%,2m
31593,3,[Aspeus]Talandar,2524,495,17,16,33,51.5%,40m
31593,2,[ЗИБиАГ]QWERTY,2524,370,15,15,30,50.0%,4m
31593,3,off,2524,293,12,12,24,50.0%,2m
31593,3,SoeinZufall,2524,248,7,7,14,50.0%,32m
31593,3,Artorias,2524,121,5,7,12,41.7%,8m
31593,3,lablonde,2524,0,4,2,6,66.7%,38m
31593,2,Fantom,2524,164,4,6,10,40.0%,23m
31593,2,Cablefish,2524,114,4,7,11,36.4%,44m
31593,3,Ulnarix,2524,115,3,5,8,37.5%,1h
31593,2,KnifeToMeetU,2524,0,3,6,9,33.3%,1h
31593,3,[VFN]RazvanBly,2524,30,2,0,2,100.0%,52m
31593,1,Mihai,2524,0,2,0,2,100.0%,20m
31593,3,Morphic,2524,58,2,1,3,66.7%,12m
31593,3,Dirmownik,2524,121,2,2,4,50.0%,1h
31593,3,LaSergius,2524,60,2,3,5,40.0%,47m
31593,1,Andy,2524,115,2,4,6,33.3%,52m
31593,2,ontheroadb,2524,60,2,6,8,25.0%,1h
31593,3,victor,2524,30,1,1,2,50.0%,9m
31593,2,[357mag]benek,2524,0,1,4,5,20.0%,42m
31593,3,Sylva,2524,0,1,4,5,20.0%,51m
31593,3,[ККП]kenseichmp,2524,0,0,1,1,0.0%,8m
31593,2,fatihf,2524,73,0,4,4,0.0%,34m
31593,2,[StarWs]Meegon,2524,0,0,4,4,0.0%,29m
31621,2,TOMAS,2523,552,68,42,110,61.8%,1h
31621,1,kanut,2523,1002,61,64,125,48.8%,18m
31621,3,hellei,2523,410,24,11,35,68.6%,12m
31621,2,jimihendrix,2523,490,19,17,36,52.8%,33m
31621,2,Bunya,2523,332,11,16,27,40.7%,26m
31621,2,Goaway,2523,253,9,9,18,50.0%,1h
31621,2,[Bro007]Lightning,2523,238,9,13,22,40.9%,33m
31621,2,Xaira,2523,173,7,9,16,43.8%,17m
31621,2,CERBERO,2523,166,5,6,11,45.5%,24m
31621,2,[OmDi]JOHNY,2523,128,4,4,8,50.0%,26m
31621,2,Holyss,2523,129,3,3,6,50.0%,48m
31621,3,[D4T]Flow,2523,0,3,6,9,33.3%,5m
31621,2,MrYan,2523,136,3,6,9,33.3%,29m
31621,1,[SHIRI]Gatsu,2523,108,3,15,18,16.7%,14m
31621,1,RaMiiii,2523,48,2,1,3,66.7%,11m
31621,2,llllllllllll,2523,88,2,2,4,50.0%,24m
31621,3,sinobi,2523,0,2,4,6,33.3%,18m
31621,2,ckvbp,2523,30,2,5,7,28.6%,51m
31621,2,[USUs]ILOVESNOW,2523,30,2,6,8,25.0%,15m
31621,3,Defolt,2523,0,1,0,1,100.0%,12m
31621,3,[film]ghosten,2523,97,1,1,2,50.0%,27m
31621,3,Kinkade,2523,30,1,2,3,33.3%,3m
31621,3,Adveturerr,2523,30,1,3,4,25.0%,30m
31621,3,[ExxE]Xaiceph,2523,0,0,1,1,0.0%,37m
31621,3,Finger,2523,0,0,1,1,0.0%,12m
31646,1,Velkro,2522,1411,158,171,329,48.0%,35m
31646,1,weshwesh,2522,1177,99,87,186,53.2%,9m
31646,1,lesnoy,2522,1294,46,54,100,46.0%,36m
31646,3,Domanoid,2522,948,40,28,68,58.8%,21m
31646,3,TheWizard,2522,1040,38,37,75,50.7%,30m
31646,2,Turgon,2522,457,21,14,35,60.0%,33m
31646,2,heinzel,2522,401,16,12,28,57.1%,1h
31646,1,[213123]DejáVu,2522,302,14,15,29,48.3%,42m
31646,1,Grisza,2522,294,11,5,16,68.8%,8m
31646,3,Adjutant,2522,222,10,9,19,52.6%,9m
31646,3,[D0N3]AndyJT,2522,301,10,13,23,43.5%,15m
31646,2,kury,2522,212,9,8,17,52.9%,1h
31646,2,Grunthor,2522,257,7,13,20,35.0%,46m
31646,3,[NFever]Buddy,2522,168,5,0,5,100.0%,22m
31646,3,Weke,2522,142,5,4,9,55.6%,16m
31646,2,QTMAN,2522,169,5,5,10,50.0%,34m
31646,2,Saturn,2522,88,5,7,12,41.7%,1h
31646,2,Saqittel,2522,90,4,7,11,36.4%,1h
31646,2,esqesqq,2522,114,3,3,6,50.0%,22m
31646,2,RUs,2522,30,3,5,8,37.5%,45m
31646,3,ste,2522,0,3,5,8,37.5%,32m
31646,2,Kirill,2522,96,3,6,9,33.3%,42m
31646,3,Guba,2522,30,2,0,2,100.0%,1h
31646,2,[PKBK]ChiracSwag,2522,30,2,3,5,40.0%,15m
31646,1,Kemppi,2522,0,2,3,5,40.0%,29m
31646,2,Haleem,2522,0,2,4,6,33.3%,1h
31646,3,Dangorin,2522,0,1,0,1,100.0%,1h
31646,3,RusVarver,2522,0,1,1,2,50.0%,3m
31646,3,Voidead,2522,0,1,1,2,50.0%,7m
31646,3,capricornio,2522,30,1,2,3,33.3%,1h
31646,1,[ehhh]Beltinho,2522,0,1,2,3,33.3%,39m
31646,3,ЛютоВолк,2522,0,1,3,4,25.0%,19m
31646,2,Moose,2522,0,1,5,6,16.7%,1h
31646,3,[N1TDA]domenech,2522,0,0,1,1,0.0%,1h
31646,3,Mephisto,2522,0,0,1,1,0.0%,8m
31646,3,Kazooa,2522,0,0,1,1,0.0%,3m
31646,3,Ichi,2522,0,0,2,2,0.0%,4m
31683,2,adler,2521,955,214,209,423,50.6%,43m
31683,2,ZAITS,2521,1627,134,126,260,51.5%,52m
31683,2,vedymin,2521,1302,122,110,232,52.6%,47m
31683,3,RamzesIII,2521,1437,91,83,174,52.3%,3m
31683,1,Ayonarendis,2521,842,68,74,142,47.9%,36m
31683,1,Protar,2521,581,66,75,141,46.8%,36m
31683,1,NihilSineEgo,2521,909,30,37,67,44.8%,46m
31683,1,DGF,2521,692,30,40,70,42.9%,35m
31683,3,Terran,2521,735,29,21,50,58.0%,3m
31683,2,Izeborn,2521,690,29,23,52,55.8%,48m
31683,2,vali,2521,630,26,20,46,56.5%,24m
31683,3,jimduyolo,2521,446,17,8,25,68.0%,41m
31683,3,bratwurst,2521,408,15,8,23,65.2%,20m
31683,2,Aston,2521,269,12,9,21,57.1%,2m
31683,2,BLOODMAN,2521,290,11,8,19,57.9%,10m
31683,3,Rovenant,2521,349,11,23,34,32.4%,23m
31683,2,IcyDuck,2521,166,8,5,13,61.5%,19m
31683,3,[FBDY]Panda,2521,189,7,6,13,53.8%,52m
31683,3,Akhenaten,2521,92,6,9,15,40.0%,5m
31683,2,xixi,2521,124,5,8,13,38.5%,42m
31683,2,[Няшкa]HardCode,2521,130,5,10,15,33.3%,9m
31683,3,[PEFEDU]OSCURINATY,2521,86,4,2,6,66.7%,20m
31683,3,[CRLTNS]Magic,2521,58,3,1,4,75.0%,5m
31683,3,[2Ta]Sendokan,2521,30,2,2,4,50.0%,40m
31683,3,Croco,2521,0,2,5,7,28.6%,15m
31683,2,TBOB,2521,62,2,5,7,28.6%,1h
31683,2,Papay,2521,0,1,4,5,20.0%,7m
31683,2,romaAmour,2521,30,1,4,5,20.0%,14m
31683,1,BlackTeranga,2521,0,1,4,5,20.0%,26m
31683,3,[3ЕRGTV]RISH,2521,0,0,1,1,0.0%,9m
31683,3,[Petrus]TemoP,2521,0,0,1,1,0.0%,36m
31683,3,JosephWill,2521,0,0,1,1,0.0%,8m
31683,3,Giordian,2521,0,0,1,1,0.0%,5m
31683,1,Hawk,2521,0,0,3,3,0.0%,9m
31717,2,Rocco,2520,1455,138,127,265,52.1%,1h
31717,1,Heimdallr,2520,1566,63,63,126,50.0%,13m
31717,1,Booger,2520,718,57,49,106,53.8%,1h
31717,3,UglyKidJoe,2520,1482,55,71,126,43.7%,12m
31717,1,Bundla,2520,1295,52,57,109,47.7%,47m
31717,3,MoRk,2520,1157,48,36,84,57.1%,1h
31717,1,Aldebaran,2520,804,35,36,71,49.3%,1h
31717,1,necroix,2520,672,27,25,52,51.9%,46m
31717,3,hehexd,2520,555,21,20,41,51.2%,31m
31717,2,iMahila,2520,462,20,11,31,64.5%,37m
31717,3,[Cannae]Zhukov,2520,495,19,16,35,54.3%,41m
31717,1,Gnidus,2520,388,19,21,40,47.5%,45m
31717,2,KeepCaIm,2520,410,13,17,30,43.3%,39m
31717,3,Heeger,2520,313,12,1,13,92.3%,8m
31717,3,santi,2520,208,10,8,18,55.6%,33m
31717,2,EpicMouse,2520,181,10,8,18,55.6%,30m
31717,2,raelaj,2520,310,10,10,20,50.0%,52m
31717,1,LorTarbos,2520,238,8,12,20,40.0%,19m
31717,2,Eezzy,2520,205,7,7,14,50.0%,23m
31717,1,Lukcjusz,2520,176,7,12,19,36.8%,10m
31717,3,highlife,2520,169,6,6,12,50.0%,37m
31717,2,Низ,2520,82,5,8,13,38.5%,22m
31717,2,kirillko,2520,148,4,4,8,50.0%,49m
31717,2,georgiev,2520,0,3,3,6,50.0%,21m
31717,1,Hjalmar,2520,88,3,5,8,37.5%,27m
31717,3,MotoMoto,2520,30,2,0,2,100.0%,12m
31717,3,Рыжебород,2520,30,2,0,2,100.0%,1h
31717,3,[PÂRłAH]Majkeru,2520,30,2,1,3,66.7%,1h
31717,3,beeLAN,2520,0,2,3,5,40.0%,12m
31717,3,Zstory,2520,62,2,3,5,40.0%,23m
31717,1,CreepTech,2520,0,1,0,1,100.0%,16m
31717,2,Lirik,2520,0,1,3,4,25.0%,47m
31717,2,Platinx,2520,0,1,5,6,16.7%,7m
31717,3,[findus]DjoKO,2520,0,0,1,1,0.0%,37m
31717,3,luftig,2520,0,0,1,1,0.0%,1h
31717,3,vesel,2520,0,0,1,1,0.0%,8m
31717,3,[Blubry]JuliusCheser,2520,0,0,1,1,0.0%,1h
31717,1,Yalos,2520,0,0,1,1,0.0%,52m
31755,2,[Arrows]Vitako,2519,1201,158,154,312,50.6%,1h
31755,1,MuSH,2519,851,97,99,196,49.5%,23m
31755,1,SpaceChetnik,2519,1100,47,41,88,53.4%,11m
31755,3,[FuсkUU]Player,2519,1088,46,31,77,59.7%,14m
31755,1,SunNinja,2519,1041,36,41,77,46.8%,1h
31755,2,[hexOr]чешипузик,2519,882,32,36,68,47.1%,12m
31755,2,Leprosorium,2519,384,23,19,42,54.8%,28m
31755,3,[ReLa]MrGeeSix,2519,460,20,14,34,58.8%,9m
31755,3,Maskalin,2519,462,18,13,31,58.1%,1h
31755,3,aRton,2519,322,12,10,22,54.5%,38m
31755,1,Julius,2519,296,12,13,25,48.0%,27m
31755,2,Julius,2519,315,11,15,26,42.3%,31m
31755,3,manjos,2519,144,6,5,11,54.5%,19m
31755,2,[SPAINs]aasdfggg,2519,131,5,4,9,55.6%,49m
31755,3,Viperon,2519,178,4,2,6,66.7%,30m
31755,3,[ETP]Nokem,2519,60,4,3,7,57.1%,40m
31755,3,[MiPS]PastorDoctor,2519,172,4,6,10,40.0%,45m
31755,2,Kiyojou,2519,58,4,7,11,36.4%,6m
31755,3,IAmStoned,2519,0,3,2,5,60.0%,1h
31755,1,Maestro,2519,36,3,6,9,33.3%,15m
31755,3,[liisks]galacticspy,2519,30,2,0,2,100.0%,11m
31755,3,CauseIamHot,2519,30,2,1,3,66.7%,19m
31755,3,thomashop,2519,58,2,2,4,50.0%,1h
31755,2,Ohshef,2519,94,2,3,5,40.0%,32m
31755,3,Strash,2519,0,2,3,5,40.0%,21m
31755,3,KnarViking,2519,0,2,4,6,33.3%,19m
31755,3,lucas,2519,0,1,0,1,100.0%,1h
31755,3,Marlo,2519,0,1,0,1,100.0%,9m
31755,3,[DanRep]unicorngirl,2519,0,1,2,3,33.3%,52m
31755,1,swop,2519,0,0,1,1,0.0%,26m
31755,3,LuckyOwl,2519,0,0,2,2,0.0%,1h
31755,2,[GvCm]DemonONI,2519,0,0,3,3,0.0%,17m
31787,2,JwishMilkman,2518,696,183,186,369,49.6%,22m
31787,2,ptiden,2518,1598,122,119,241,50.6%,34m
31787,1,InfernalGuy,2518,1617,106,112,218,48.6%,41m
31787,2,AsaP,2518,1525,64,61,125,51.2%,2m
31787,2,Andreyka,2518,558,41,32,73,56.2%,19m
31787,2,Nambona,2518,583,26,27,53,49.1%,50m
31787,3,[B5]Sincler,2518,643,25,27,52,48.1%,9m
31787,2,MagicSfx,2518,495,22,18,40,55.0%,14m
31787,2,Коля,2518,438,17,15,32,53.1%,1h
31787,2,Xygar,2518,316,14,16,30,46.7%,48m
31787,2,Anearion,2518,320,12,13,25,48.0%,19m
31787,2,[ЦарскТ]Antipaladin,2518,360,12,14,26,46.2%,5m
31787,3,JegouGo,2518,282,10,6,16,62.5%,34m
31787,2,XVII,2518,229,9,8,17,52.9%,5m
31787,3,MrKaizi,2518,250,9,9,18,50.0%,12m
31787,3,llordmbce,2518,178,6,2,8,75.0%,12m
31787,3,KissP,2518,142,6,6,12,50.0%,26m
31787,2,Kaiden,2518,153,5,3,8,62.5%,43m
31787,2,[ШиШаНы]BomBersem,2518,130,5,8,13,38.5%,1h
31787,1,Jochemus,2518,190,5,16,21,23.8%,39m
31787,3,Phil,2518,114,4,3,7,57.1%,1h
31787,3,Poldor,2518,0,3,2,5,60.0%,31m
31787,1,[No9]Xorron,2518,153,3,7,10,30.0%,1h
31787,3,BeBeZiaNa,2518,30,2,0,2,100.0%,1h
31787,3,theevilart,2518,30,2,1,3,66.7%,5m
31787,2,Farf,2518,60,2,4,6,33.3%,37m
31787,3,Chiasm,2518,95,1,3,4,25.0%,11m
31787,1,LUXOdotZiP,2518,0,0,1,1,0.0%,33m
31787,2,Krrychu,2518,0,0,4,4,0.0%,1h
31816,3,Alex,2517,1417,246,245,491,50.1%,6m
31816,2,nodelynk,2517,1240,55,58,113,48.7%,38m
31816,1,Antorsom,2517,1205,54,60,114,47.4%,35m
31816,3,Pehol,2517,515,51,39,90,56.7%,5m
31816,2,Fumin,2517,1206,51,40,91,56.0%,1h
31816,3,МАКС,2517,690,39,29,68,57.4%,41m
31816,3,Swordfish,2517,873,38,26,64,59.4%,20m
31816,2,RobotNinja,2517,601,36,35,71,50.7%,46m
31816,2,Della,2517,490,32,31,63,50.8%,15m
31816,2,pyjamashark,2517,520,19,19,38,50.0%,22m
31816,2,Tengu,2517,475,18,22,40,45.0%,12m
31816,3,дИтонатор,2517,263,9,13,22,40.9%,18m
31816,3,mrCannibal,2517,232,8,12,20,40.0%,13m
31816,2,Byteit,2517,159,7,6,13,53.8%,4m
31816,2,[RAFVGA]Calamity,2517,182,7,13,20,35.0%,37m
31816,3,[230ММ]IronKerya,2517,145,4,1,5,80.0%,41m
31816,3,KevinWeel,2517,104,4,3,7,57.1%,1h
31816,2,sharp,2517,96,4,5,9,44.4%,30m
31816,1,Speedster,2517,48,3,1,4,75.0%,26m
31816,3,[Rafi]Lord,2517,119,3,4,7,42.9%,19m
31816,2,Aaaaaaaaaaa,2517,60,3,5,8,37.5%,42m
31816,2,ПодрядчиК,2517,122,3,8,11,27.3%,42m
31816,3,PapiChulo,2517,0,2,2,4,50.0%,40m
31816,3,[RTPK]Razorblade,2517,0,2,4,6,33.3%,44m
31816,1,CRIMBA,2517,48,2,5,7,28.6%,38m
31816,3,Duty,2517,0,1,0,1,100.0%,1h
31816,1,Jakemirror,2517,97,1,1,2,50.0%,14m
31816,3,Czaki,2517,30,1,2,3,33.3%,32m
31816,3,СКАЗОЧНІК,2517,30,1,2,3,33.3%,38m
31816,3,[KNFX]Kecires,2517,0,0,2,2,0.0%,30m
31816,2,Dos,2517,0,0,2,2,0.0%,1h
31847,3,[YpT]sebbix,2516,924,58,46,104,55.8%,8m
31847,2,xyzcharger,2516,687,57,56,113,50.4%,46m
31847,2,Filosoff,2516,401,48,53,101,47.5%,5m
31847,2,infestor,2516,648,44,30,74,59.5%,1h
31847,1,[FL0]Sthouse,2516,485,41,48,89,46.1%,41m
31847,2,[IPSI]Chrischan,2516,832,31,32,63,49.2%,22m
31847,2,Creel,2516,165,19,21,40,47.5%,6m
31847,3,Фантом,2516,448,17,13,30,56.7%,1h
31847,2,[krdo]Soulseeker,2516,346,13,6,19,68.4%,44m
31847,3,KingMike,2516,280,10,19,29,34.5%,17m
31847,2,[RuNOOB]FLAUBER,2516,203,8,11,19,42.1%,52m
31847,2,Hanno,2516,30,5,8,13,38.5%,18m
31847,2,Innova,2516,154,5,9,14,35.7%,52m
31847,3,SNYX,2516,86,4,3,7,57.1%,30m
31847,3,TAV,2516,86,4,3,7,57.1%,41m
31847,3,Valio,2516,68,4,6,10,40.0%,32m
31847,3,Bankemani,2516,58,3,0,3,100.0%,31m
31847,3,killakat,2516,0,3,2,5,60.0%,19m
31847,3,krno,2516,0,2,3,5,40.0%,1h
31847,3,Fuù,2516,97,2,4,6,33.3%,47m
31847,3,Lucy,2516,96,2,4,6,33.3%,43m
31847,3,Pinouz,2516,30,1,2,3,33.3%,9m
31847,3,Tobias,2516,30,1,3,4,25.0%,21m
31847,3,arkisz,2516,97,1,3,4,25.0%,15m
31847,1,jonnamy,2516,0,1,4,5,20.0%,11m
31847,3,SkyFighter,2516,0,0,1,1,0.0%,32m
31847,3,[NcTsT]Nabz,2516,0,0,1,1,0.0%,15m
31847,3,Lokahn,2516,0,0,1,1,0.0%,33m
31847,3,GLhfgg,2516,0,0,1,1,0.0%,51m
31847,2,Colonelul,2516,0,0,3,3,0.0%,1h
31877,1,bikez,2515,1569,938,937,1875,50.0%,10m
31877,1,FunkyMonk,2515,1444,168,171,339,49.6%,11m
31877,3,SAYAN,2515,1459,131,120,251,52.2%,21m
31877,3,[SCCZ]Meny,2515,1522,117,101,218,53.7%,33m
31877,1,madmasei,2515,1533,103,89,192,53.6%,15m
31877,2,theIncideNT,2515,866,85,77,162,52.5%,6m
31877,3,[2M1B]Lezion,2515,517,35,23,58,60.3%,1h
31877,3,CraftsMAn,2515,510,20,13,33,60.6%,41m
31877,2,DINO,2515,419,18,17,35,51.4%,48m
31877,1,Melkor,2515,319,10,13,23,43.5%,1h
31877,2,Catworm,2515,272,9,16,25,36.0%,5m
31877,2,MASP,2515,232,8,3,11,72.7%,12m
31877,3,omodai,2515,221,8,12,20,40.0%,8m
31877,1,Ворг,2515,152,6,10,16,37.5%,33m
31877,3,Tipochek,2515,125,4,7,11,36.4%,41m
31877,3,[xEVOx]robsen,2515,119,3,3,6,50.0%,33m
31877,3,DRLulu,2515,0,2,0,2,100.0%,41m
31877,2,teros,2515,92,2,2,4,50.0%,10m
31877,1,PsY,2515,0,2,5,7,28.6%,16m
31877,2,desT,2515,30,2,5,7,28.6%,1h
31877,3,[MyGaAc]WindBreaker,2515,0,1,2,3,33.3%,32m
31877,3,YLITKA,2515,30,1,2,3,33.3%,12m
31877,2,bananas,2515,0,1,2,3,33.3%,12m
31877,2,Demien,2515,0,0,3,3,0.0%,5m
31901,2,BRIGHT,2514,1145,165,146,311,53.1%,1h
31901,2,Spvolk,2514,1529,96,98,194,49.5%,49m
31901,3,Rambo,2514,1195,51,43,94,54.3%,20m
31901,2,RuskiOkupant,2514,1044,39,38,77,50.6%,29m
31901,3,Pütti,2514,735,29,27,56,51.8%,22m
31901,3,[nWss]riptidezim,2514,679,25,20,45,55.6%,1h
31901,1,ChowChow,2514,412,15,17,32,46.9%,2m
31901,3,Kharisov,2514,357,13,4,17,76.5%,19m
31901,1,Feel,2514,313,12,12,24,50.0%,47m
31901,3,CapitainJupi,2514,266,12,17,29,41.4%,5m
31901,3,Keply,2514,273,10,8,18,55.6%,19m
31901,1,Avalon,2514,175,8,7,15,53.3%,5m
31901,2,StormyGun,2514,242,8,10,18,44.4%,18m
31901,3,MalyKazik,2514,232,8,15,23,34.8%,52m
31901,2,AngelGames,2514,145,6,5,11,54.5%,21m
31901,2,riri,2514,135,6,5,11,54.5%,1h
31901,3,kyru,2514,173,6,6,12,50.0%,12m
31901,2,FrozenKimchi,2514,143,4,4,8,50.0%,49m
31901,2,FiftyBliss,2514,169,4,8,12,33.3%,1h
31901,1,Алмаранд,2514,0,3,2,5,60.0%,5m
31901,3,ЦиКеДо,2514,90,3,4,7,42.9%,3m
31901,1,Chickäään,2514,48,3,4,7,42.9%,33m
31901,3,mcmaquein,2514,30,2,2,4,50.0%,1h
31901,3,SneezyDwarf,2514,30,2,2,4,50.0%,23m
31901,3,Ghost,2514,96,2,4,6,33.3%,26m
31901,3,[m1nted]flavouredmax,2514,0,2,5,7,28.6%,18m
31901,1,Cobra,2514,48,1,1,2,50.0%,5m
31901,3,bryantla,2514,36,1,3,4,25.0%,1h
31901,1,Manthrax,2514,0,1,4,5,20.0%,14m
31901,3,[УТочка]BrawlerMesha,2514,0,0,1,1,0.0%,18m
31901,3,артём,2514,0,0,1,1,0.0%,47m
31901,1,Maxim,2514,0,0,2,2,0.0%,5m
31933,3,Nomadicsoul,2513,750,208,194,402,51.7%,1h
31933,3,PartinGFan,2513,1498,61,99,160,38.1%,9m
31933,3,[wfolks]Electrician,2513,686,29,27,56,51.8%,31m
31933,3,Pompom,2513,590,21,21,42,50.0%,20m
31933,3,CarWin,2513,436,18,13,31,58.1%,22m
31933,3,SneakyMidget,2513,376,18,13,31,58.1%,24m
31933,3,Dori,2513,371,17,21,38,44.7%,12m
31933,2,Bogus,2513,325,13,15,28,46.4%,1h
31933,2,Sleep,2513,302,10,10,20,50.0%,5m
31933,2,Dipomat,2513,298,10,11,21,47.6%,1h
31933,2,timur,2513,248,9,11,20,45.0%,43m
31933,1,Kokon,2513,294,8,16,24,33.3%,1h
31933,3,Matiak,2513,147,6,4,10,60.0%,16m
31933,2,khmuryMonah,2513,218,5,7,12,41.7%,1h
31933,3,Striker,2513,86,4,3,7,57.1%,41m
31933,2,ANAKONDAS,2513,140,4,4,8,50.0%,1h
31933,3,RedJohn,2513,88,3,4,7,42.9%,24m
31933,3,Atafabbro,2513,0,2,2,4,50.0%,32m
31933,3,Iceblade,2513,0,1,0,1,100.0%,15m
31933,3,Silenz,2513,30,1,2,3,33.3%,5m
31933,3,Mimizar,2513,30,1,2,3,33.3%,25m
31933,3,[Tchang]Snoosers,2513,30,1,2,3,33.3%,30m
31933,3,[kaffDK]MortenDK,2513,0,0,1,1,0.0%,3m
31933,3,IllIIlIlllIl,2513,0,0,1,1,0.0%,51m
31957,2,[AQFOBQ]Prime,2512,1002,88,86,174,50.6%,5m
31957,2,Salsax,2512,989,87,73,160,54.4%,22m
31957,3,[ARGUAL]phantonpain,2512,1500,78,71,149,52.3%,17m
31957,1,pridon,2512,878,48,48,96,50.0%,15m
31957,3,MrNoob,2512,960,41,34,75,54.7%,45m
31957,3,Scarecrow,2512,313,12,9,21,57.1%,36m
31957,1,[31Baka]Silver,2512,384,12,21,33,36.4%,30m
31957,3,Tolmavas,2512,228,10,10,20,50.0%,47m
31957,3,Vladimer,2512,88,4,4,8,50.0%,5m
31957,2,Kuula,2512,130,4,6,10,40.0%,47m
31957,3,[Harley]Agate,2512,0,3,2,5,60.0%,17m
31957,3,ШУРИК,2512,0,1,0,1,100.0%,51m
31957,1,[Lapi]ValeraDiller,2512,0,1,0,1,100.0%,47m
31957,3,[Маньяк]llllllllllll,2512,30,1,1,2,50.0%,20m
31957,3,[AkDG]Joschi,2512,0,1,2,3,33.3%,3m
31957,3,Pretinho,2512,0,1,6,7,14.3%,17m
31957,3,virusT,2512,0,0,1,1,0.0%,1h
31957,2,[CОS]name,2512,0,0,1,1,0.0%,20m
31957,3,Zeratool,2512,0,0,2,2,0.0%,18m
31957,3,ВАСЯ,2512,0,0,2,2,0.0%,39m
31977,2,Teisu,2511,1255,84,69,153,54.9%,1h
31977,2,Dakasnik,2511,1321,52,50,102,51.0%,38m
31977,3,ViYs,2511,691,29,16,45,64.4%,19m
31977,3,Superman,2511,660,22,33,55,40.0%,12m
31977,2,[DizC]MentatYasha,2511,188,21,20,41,51.2%,51m
31977,3,kalata,2511,467,18,23,41,43.9%,12m
31977,1,[WWG]Reboot,2511,319,13,15,28,46.4%,14m
31977,2,BMT,2511,317,12,12,24,50.0%,1h
31977,2,ElSergii,2511,277,12,16,28,42.9%,47m
31977,3,[GOONI]Fixxx,2511,293,11,4,15,73.3%,19m
31977,1,[boiko]soldierbg,2511,330,11,17,28,39.3%,42m
31977,2,SMHRMN,2511,273,10,8,18,55.6%,5m
31977,2,[607]НИКИТА,2511,183,5,6,11,45.5%,38m
31977,2,[QWEZXC]FroGGog,2511,60,4,6,10,40.0%,18m
31977,2,Ivex,2511,114,4,7,11,36.4%,52m
31977,1,adiq,2511,0,3,2,5,60.0%,27m
31977,2,[ПOHHИ]Serega,2511,92,3,8,11,27.3%,1h
31977,3,[WT3]KiingenN,2511,0,2,3,5,40.0%,1h
31977,3,Supernonik,2511,0,2,3,5,40.0%,40m
31977,2,[SPRDL]Kiszczok,2511,30,2,4,6,33.3%,5m
31977,2,Kreatuur,2511,55,2,5,7,28.6%,45m
31977,3,[Лапка]DariZz,2511,0,1,0,1,100.0%,47m
31977,3,Franzi,2511,0,1,0,1,100.0%,3m
31977,2,BulgeTickler,2511,0,1,3,4,25.0%,33m
31977,3,[ThReCl]Starkiller,2511,30,1,8,9,11.1%,9m
31977,3,Marttcatt,2511,0,0,2,2,0.0%,1h
32003,1,murs,2510,1554,456,457,913,49.9%,42m
32003,1,SInsalCraft,2510,940,72,75,147,49.0%,1h
32003,2,[1WN1]elconejo,2510,1454,57,55,112,50.9%,34m
32003,1,Larsx,2510,1439,55,59,114,48.2%,1h
32003,2,Egbert,2510,1134,54,51,105,51.4%,37m
32003,1,[пепегa]пепега,2510,358,52,40,92,56.5%,18m
32003,2,[wpwpwp]Const,2510,587,23,19,42,54.8%,1h
32003,2,Battle,2510,131,14,16,30,46.7%,1h
32003,3,TobbiSlobbi,2510,234,12,11,23,52.2%,4m
32003,1,LARGEHADRON,2510,296,12,18,30,40.0%,29m
32003,2,Jktulord,2510,172,6,7,13,46.2%,26m
32003,2,Azairog,2510,227,6,8,14,42.9%,24m
32003,3,[DMPP]Bigaffe,2510,120,5,3,8,62.5%,24m
32003,3,DaKi,2510,146,5,5,10,50.0%,40m
32003,3,Reaper,2510,152,5,7,12,41.7%,3m
32003,3,Laurian,2510,86,3,5,8,37.5%,1h
32003,3,[Gremli]УшлыйОРК,2510,146,3,6,9,33.3%,23m
32003,3,HarryB,2510,30,2,3,5,40.0%,19m
32003,3,[ZIPP]CombatSorken,2510,0,2,3,5,40.0%,12m
32003,3,acurion,2510,0,2,4,6,33.3%,8m
32003,3,[12APM]XOXOXOXOXO,2510,0,1,0,1,100.0%,9m
32003,3,Agarius,2510,0,1,0,1,100.0%,39m
32003,3,MikleOP,2510,30,1,1,2,50.0%,9m
32003,2,AttakaiKaze,2510,0,1,2,3,33.3%,45m
32003,3,piXelchiX,2510,0,1,4,5,20.0%,21m
32003,2,[scp3]Rylavein,2510,30,1,5,6,16.7%,22m
32003,3,Virtex,2510,95,1,5,6,16.7%,3m
32003,3,Razarvater,2510,0,0,1,1,0.0%,47m
32003,3,[ЕМPIRE]PojiloeBize,2510,0,0,1,1,0.0%,31m
32003,2,Xenon,2510,0,0,3,3,0.0%,22m
32033,1,LostKing,2509,1021,57,61,118,48.3%,25m
32033,1,EvilKraM,2509,1157,56,60,116,48.3%,18m
32033,2,Law,2509,1125,48,45,93,51.6%,21m
32033,2,Zerro,2509,351,34,31,65,52.3%,28m
32033,2,ErzBattle,2509,768,32,33,65,49.2%,45m
32033,3,NIghtRaven,2509,527,20,15,35,57.1%,21m
32033,3,PACIFICATOR,2509,468,17,20,37,45.9%,41m
32033,2,ALEOLE,2509,254,8,9,17,47.1%,1h
32033,2,[TLMaN]Marelis,2509,206,8,9,17,47.1%,22m
32033,2,IIIIIIIIIIII,2509,237,7,10,17,41.2%,9m
32033,2,holdeFee,2509,194,6,27,33,18.2%,11m
32033,1,Braindead,2509,0,4,1,5,80.0%,23m
32033,3,smoth,2509,88,4,1,5,80.0%,41m
32033,3,owahab,2509,114,4,2,6,66.7%,26m
32033,3,TitánHadhes,2509,0,4,2,6,66.7%,47m
32033,2,mrscors,2509,106,4,4,8,50.0%,24m
32033,3,krakuseus,2509,58,3,1,4,75.0%,16m
32033,2,[Святой]ПожилойГриша,2509,126,3,3,6,50.0%,1h
32033,3,[GZTV]Tedeous,2509,120,3,5,8,37.5%,9m
32033,3,[i7]FisseFredRa,2509,117,3,5,8,37.5%,33m
32033,2,metty,2509,169,3,7,10,30.0%,29m
32033,2,OTVAGA,2509,58,3,8,11,27.3%,12m
32033,3,XOMOK,2509,30,2,0,2,100.0%,33m
32033,3,KillTheRich,2509,58,2,1,3,66.7%,15m
32033,3,Xin,2509,0,1,0,1,100.0%,16m
32033,3,GACHIMUCHI,2509,0,1,1,2,50.0%,23m
32033,3,Oneofffly,2509,0,1,1,2,50.0%,51m
32033,3,[NargH]RaffKing,2509,0,1,2,3,33.3%,26m
32033,3,NIMROD,2509,0,0,2,2,0.0%,4m
32033,2,Snidex,2509,0,0,4,4,0.0%,39m
32063,3,ChrisTitan,2508,1583,66,63,129,51.2%,1h
32063,2,Fenriswolf,2508,1039,40,43,83,48.2%,22m
32063,3,Tyrega,2508,969,38,30,68,55.9%,31m
32063,2,darknoob,2508,871,38,32,70,54.3%,1h
32063,3,Lev,2508,769,34,22,56,60.7%,51m
32063,1,Gristin,2508,885,32,40,72,44.4%,6m
32063,3,Vprog,2508,798,30,28,58,51.7%,9m
32063,3,popug,2508,874,30,47,77,39.0%,15m
32063,2,CeytNot,2508,352,18,18,36,50.0%,22m
32063,3,Vorador,2508,462,17,15,32,53.1%,1h
32063,3,[AIUR15]FAKE,2508,350,13,11,24,54.2%,7m
32063,1,Tyor,2508,369,12,13,25,48.0%,19m
32063,3,DevilBat,2508,310,10,12,22,45.5%,5m
32063,2,Иван,2508,214,8,8,16,50.0%,6m
32063,3,КрогСис,2508,242,7,15,22,31.8%,8m
32063,2,[3ЕRGTV]KingDracula,2508,143,6,6,12,50.0%,7m
32063,2,Brocken,2508,181,6,6,12,50.0%,49m
32063,3,[StarLg]Plicopin,2508,180,6,7,13,46.2%,50m
32063,2,Headless,2508,194,6,10,16,37.5%,41m
32063,2,[N1TDA]warjlok,2508,205,5,6,11,45.5%,33m
32063,3,[GGWin]RobSnydeR,2508,152,5,7,12,41.7%,33m
32063,1,diamondlors,2508,134,5,17,22,22.7%,51m
32063,3,Zoccer,2508,144,4,5,9,44.4%,12m
32063,1,clac,2508,48,3,3,6,50.0%,1h
32063,2,erbhi,2508,34,3,5,8,37.5%,46m
32063,3,equity,2508,34,3,6,9,33.3%,18m
32063,3,thelastexile,2508,60,2,4,6,33.3%,1h
32063,2,Nero,2508,32,2,4,6,33.3%,44m
32063,3,Frieckz,2508,0,1,0,1,100.0%,38m
32063,3,[THANOS]ArnoldLayne,2508,0,1,2,3,33.3%,1h
32063,3,MachineDuck,2508,0,0,1,1,0.0%,47m
32063,3,maksi,2508,0,0,1,1,0.0%,19m
32095,3,ĐăƦƙŦƐƜƤḼăƦ,2507,1368,56,53,109,51.4%,12m
32095,2,dikichev,2507,940,41,35,76,53.9%,21m
32095,3,BluePanther,2507,393,15,9,24,62.5%,30m
32095,2,Elektron,2507,404,15,17,32,46.9%,37m
32095,3,Hyperlighter,2507,355,14,9,23,60.9%,19m
32095,2,Alkuzar,2507,251,9,11,20,45.0%,33m
32095,1,SkyOll,2507,206,9,15,24,37.5%,1h
32095,3,Zolton,2507,238,8,3,11,72.7%,1h
32095,2,Legatee,2507,159,8,7,15,53.3%,12m
32095,2,lgrs,2507,83,8,12,20,40.0%,24m
32095,3,NORA,2507,200,7,7,14,50.0%,9m
32095,3,DonMimimi,2507,211,6,4,10,60.0%,12m
32095,3,blackisback,2507,120,5,6,11,45.5%,31m
32095,3,DIMI,2507,139,4,1,5,80.0%,24m
32095,3,Astronafs,2507,88,4,4,8,50.0%,31m
32095,3,Azrael,2507,30,2,0,2,100.0%,3m
32095,3,Arigeer,2507,135,2,3,5,40.0%,47m
32095,3,[texas1]oarhigos,2507,0,2,4,6,33.3%,19m
32095,2,[MVV77]MVVRock,2507,0,2,5,7,28.6%,39m
32095,3,Spursy,2507,60,2,5,7,28.6%,47m
32095,2,Yuuns,2507,0,1,0,1,100.0%,12m
32095,3,Necromion,2507,30,1,2,3,33.3%,33m
32095,3,BABAYAGA,2507,0,0,1,1,0.0%,9m
32095,2,[ККК]ГлаваККК,2507,0,0,2,2,0.0%,46m
32095,3,Reptile,2507,0,0,5,5,0.0%,38m
32120,2,Score,2506,1518,159,155,314,50.6%,29m
32120,2,TRINITI,2506,1553,90,88,178,50.6%,6m
32120,2,Broly,2506,946,89,74,163,54.6%,2m
32120,1,[xBWx]HIT,2506,682,31,26,57,54.4%,23m
32120,2,termi,2506,614,24,25,49,49.0%,37m
32120,3,stalker,2506,577,24,33,57,42.1%,15m
32120,1,blerou,2506,631,22,25,47,46.8%,6m
32120,3,Yellow,2506,491,20,17,37,54.1%,33m
32120,3,sunrise,2506,363,14,13,27,51.9%,25m
32120,3,[ZYEBS]wielkichuj,2506,262,12,7,19,63.2%,9m
32120,2,Rafar,2506,371,12,18,30,40.0%,51m
32120,1,ParanOidaL,2506,224,10,12,22,45.5%,28m
32120,1,JoKeR,2506,105,6,5,11,54.5%,51m
32120,3,[scvvcs]nautilus,2506,120,5,3,8,62.5%,47m
32120,3,TaBi,2506,179,5,4,9,55.6%,26m
32120,2,AlexSilver,2506,138,4,3,7,57.1%,16m
32120,3,mirkoba,2506,139,4,6,10,40.0%,36m
32120,3,devil,2506,90,3,5,8,37.5%,41m
32120,3,[K0RM2]RobotGG,2506,30,2,2,4,50.0%,33m
32120,3,POKERGRIG,2506,0,1,0,1,100.0%,26m
32120,3,Crazyk,2506,30,1,2,3,33.3%,31m
32120,3,[N8Wrst]Lennox,2506,30,1,3,4,25.0%,12m
32120,2,[PPGАNG]Monomercapta,2506,88,1,4,5,20.0%,20m
32120,3,[RiskHQ]AXxel,2506,0,0,2,2,0.0%,1h
32144,2,Kisloi,2505,652,143,148,291,49.1%,34m
32144,1,dkguy,2505,1380,71,69,140,50.7%,36m
32144,3,Hetcow,2505,946,70,30,100,70.0%,4m
32144,3,VovaPutin,2505,1495,63,92,155,40.6%,1h
32144,3,LovemyLady,2505,1081,56,44,100,56.0%,20m
32144,2,Chily,2505,599,55,50,105,52.4%,52m
32144,1,Krautkopf,2505,1204,55,67,122,45.1%,18m
32144,3,madmax,2505,1004,42,29,71,59.2%,1h
32144,1,aRJock,2505,844,31,34,65,47.7%,1h
32144,2,MrFremen,2505,536,22,28,50,44.0%,34m
32144,3,[FlyDt]XeON,2505,381,15,5,20,75.0%,9m
32144,3,Smael,2505,436,15,14,29,51.7%,27m
32144,1,[PeOvDs]plaktor,2505,402,14,23,37,37.8%,15m
32144,1,Slippery,2505,368,11,23,34,32.4%,28m
32144,3,Nongrata,2505,270,8,12,20,40.0%,26m
32144,3,Kuwahawaha,2505,236,7,3,10,70.0%,31m
32144,3,[ZLOBOZ]Neo,2505,240,7,3,10,70.0%,38m
32144,2,[WndKnd]ywecur,2505,175,6,9,15,40.0%,48m
32144,3,[POPIK]popik,2505,114,5,3,8,62.5%,4m
32144,3,Mirodasc,2505,0,4,1,5,80.0%,12m
32144,1,Izzi,2505,140,4,2,6,66.7%,46m
32144,3,PeterHUNone,2505,88,4,3,7,57.1%,38m
32144,3,ManniRumpel,2505,30,4,3,7,57.1%,30m
32144,3,Ruso,2505,72,4,6,10,40.0%,20m
32144,2,Somyc,2505,116,4,6,10,40.0%,23m
32144,3,IlIllIlIllII,2505,141,4,6,10,40.0%,1h
32144,1,[Demob]Ghul,2505,48,3,3,6,50.0%,43m
32144,1,[Xenor]DarkStorm,2505,128,3,5,8,37.5%,36m
32144,3,[PBK23R]CheshireCat,2505,129,3,7,10,30.0%,25m
32144,1,NoNstop,2505,126,3,10,13,23.1%,9m
32144,3,Unruh,2505,0,2,4,6,33.3%,18m
32144,3,[3ANGLE]Redundancy,2505,0,1,1,2,50.0%,40m
32144,3,Portoss,2505,30,1,2,3,33.3%,22m
32144,3,Peanut,2505,0,0,1,1,0.0%,47m
32144,3,Alex,2505,0,0,1,1,0.0%,25m
32144,3,Platanov,2505,0,0,2,2,0.0%,2m
32144,2,AngelofDead,2505,0,0,4,4,0.0%,44m
32144,2,[PLOPŁ]Wredter,2505,0,0,4,4,0.0%,32m
32182,2,Thuemper,2504,1462,107,106,213,50.2%,37m
32182,2,pumpel,2504,1512,74,73,147,50.3%,1h
32182,2,putinhuylo,2504,1221,50,49,99,50.5%,45m
32182,2,WAREGG,2504,640,37,32,69,53.6%,33m
32182,1,Niemand,2504,1070,36,48,84,42.9%,51m
32182,3,Skalien,2504,684,34,30,64,53.1%,1h
32182,2,Akamaru,2504,671,33,14,47,70.2%,14m
32182,2,UPYR,2504,837,31,29,60,51.7%,29m
32182,3,letsplayer,2504,551,24,17,41,58.5%,3m
32182,1,KillerEngine,2504,560,22,24,46,47.8%,24m
32182,3,Makaryska,2504,570,21,19,40,52.5%,34m
32182,3,[NWGD]MirayGee,2504,504,19,12,31,61.3%,8m
32182,3,Killsoftly,2504,298,13,9,22,59.1%,9m
32182,3,stasHeaven,2504,283,10,4,14,71.4%,31m
32182,3,JRdeMars,2504,266,9,4,13,69.2%,52m
32182,1,GHOST,2504,312,9,14,23,39.1%,43m
32182,3,Serbin,2504,204,7,6,13,53.8%,1h
32182,3,JUMPYWIZARD,2504,194,7,6,13,53.8%,9m
32182,3,Powerflower,2504,194,7,7,14,50.0%,15m
32182,3,PipandPop,2504,135,6,6,12,50.0%,12m
32182,2,Lemenb,2504,148,6,8,14,42.9%,47m
32182,2,Чешир,2504,192,6,10,16,37.5%,34m
32182,3,jemados,2504,0,3,2,5,60.0%,1h
32182,2,corova,2504,0,3,4,7,42.9%,18m
32182,2,PLAGUEIS,2504,95,3,6,9,33.3%,33m
32182,3,Berraco,2504,122,3,11,14,21.4%,52m
32182,1,[Rebеls]Demotix,2504,48,2,0,2,100.0%,37m
32182,3,EnTaroAdun,2504,30,2,1,3,66.7%,47m
32182,3,[NoAir]SomeCake,2504,58,2,1,3,66.7%,1h
32182,3,SilverRider,2504,30,2,2,4,50.0%,1h
32182,3,[RYKS]ghost,2504,30,1,2,3,33.3%,42m
32182,3,Izikiwi,2504,30,1,2,3,33.3%,12m
32182,3,paaalevo,2504,0,1,4,5,20.0%,47m
32182,3,[XIIIX]Check,2504,0,0,1,1,0.0%,26m
32182,3,Sebix,2504,0,0,2,2,0.0%,19m
32182,3,[PLBG]Kamillobeta,2504,0,0,2,2,0.0%,38m
32218,2,Ole,2503,1579,541,533,1074,50.4%,24m
32218,1,Hicks,2503,1547,332,328,660,50.3%,36m
32218,2,KCK,2503,1580,227,226,453,50.1%,34m
32218,2,rysiek,2503,1573,121,106,227,53.3%,1h
32218,3,ablucian,2503,1588,79,58,137,57.7%,20m
32218,3,Kortik,2503,1482,79,73,152,52.0%,15m
32218,3,[Znaesh]EKaradjov,2503,726,43,33,76,56.6%,19m
32218,2,[панда]zErLONG,2503,796,28,32,60,46.7%,47m
32218,2,SASHA,2503,568,22,23,45,48.9%,7m
32218,2,бyбLik,2503,260,15,17,32,46.9%,34m
32218,1,Bence,2503,388,15,20,35,42.9%,11m
32218,2,Balera,2503,376,15,20,35,42.9%,42m
32218,3,Pasha,2503,302,10,5,15,66.7%,23m
32218,3,Rondo,2503,254,9,9,18,50.0%,17m
32218,2,Jester,2503,259,8,5,13,61.5%,36m
32218,3,Foxits,2503,240,8,5,13,61.5%,9m
32218,3,WhiteAppa,2503,273,8,8,16,50.0%,47m
32218,2,[EasycH]bajanizd,2503,166,5,9,14,35.7%,18m
32218,3,HappyKiler,2503,86,4,3,7,57.1%,20m
32218,3,[Buldog]Pleften,2503,94,4,3,7,57.1%,1h
32218,2,SazukeTakeo,2503,88,3,4,7,42.9%,1h
32218,3,TheBayesian,2503,121,3,5,8,37.5%,30m
32218,3,[isIMBА]PULSAR,2503,30,2,0,2,100.0%,12m
32218,3,[4pro]termit,2503,0,1,0,1,100.0%,10m
32218,3,Fentazito,2503,0,1,0,1,100.0%,9m
32218,3,TEREBON,2503,0,1,1,2,50.0%,19m
32218,1,kaktusAK,2503,0,1,1,2,50.0%,12m
32218,3,LEDD,2503,30,1,3,4,25.0%,27m
32218,3,charlama,2503,30,1,3,4,25.0%,1h
32218,3,sapiyo,2503,30,1,4,5,20.0%,42m
32218,2,BlackToilet,2503,40,1,6,7,14.3%,21m
32218,3,CptVimes,2503,0,0,1,1,0.0%,8m
32218,3,NzUmer,2503,0,0,1,1,0.0%,1h
32218,3,VikiR,2503,0,0,1,1,0.0%,51m
32252,2,SHIVA,2502,1438,132,126,258,51.2%,12m
32252,2,Teoden,2502,1327,110,108,218,50.5%,5m
32252,2,[AITEAM]MakroMarc,2502,1539,85,82,167,50.9%,5m
32252,3,Zeragorn,2502,826,77,71,148,52.0%,33m
32252,1,[TkcS]ZaXXL,2502,1414,65,63,128,50.8%,1h
32252,2,Alex,2502,355,32,18,50,64.0%,34m
32252,2,Dex,2502,648,28,29,57,49.1%,19m
32252,3,[dæD]Imperium,2502,414,18,12,30,60.0%,2m
32252,2,[NorthG]Jodyhateyou,2502,468,16,25,41,39.0%,46m
32252,2,Legion,2502,273,11,9,20,55.0%,1h
32252,3,[290720]ComanderFabi,2502,248,8,1,9,88.9%,8m
32252,3,DustALL,2502,218,7,5,12,58.3%,25m
32252,3,bygui,2502,208,7,8,15,46.7%,2m
32252,3,Kascade,2502,0,4,3,7,57.1%,27m
32252,3,Svoi,2502,58,3,2,5,60.0%,1h
32252,3,BabyShadow,2502,117,3,4,7,42.9%,41m
32252,2,[eMTC]den,2502,125,3,6,9,33.3%,29m
32252,1,lahciMx,2502,94,2,1,3,66.7%,37m
32252,3,Misha,2502,0,1,1,2,50.0%,12m
32252,3,[KLINK]BKBSaSa,2502,0,1,1,2,50.0%,1h
32252,3,[765]RoBot,2502,0,1,1,2,50.0%,20m
32252,3,[StrPep]AllY,2502,0,0,1,1,0.0%,53m
32252,3,sluzz,2502,0,0,1,1,0.0%,15m
32252,1,TheThirdDay,2502,0,0,1,1,0.0%,31m
32252,1,Golden,2502,0,0,1,1,0.0%,43m
32252,3,SotiG,2502,0,0,2,2,0.0%,20m
32278,2,NaTLoZ,2501,1594,286,288,574,49.8%,5m
32278,3,trbnnrter,2501,1561,81,77,158,51.3%,47m
32278,3,[HZeS]JINGLEJANGLE,2501,971,60,54,114,52.6%,42m
32278,3,[PÂRłAH]Vlad,2501,1252,57,52,109,52.3%,3m
32278,2,FedeErik,2501,835,40,31,71,56.3%,1h
32278,3,Lyaer,2501,594,37,19,56,66.1%,9m
32278,2,AmaN,2501,697,32,25,57,56.1%,1h
32278,2,NoObUshiwaka,2501,731,30,27,57,52.6%,47m
32278,3,Cata,2501,550,20,21,41,48.8%,8m
32278,2,Tweety,2501,208,18,18,36,50.0%,34m
32278,2,[BRPD]HitPlicT,2501,454,17,21,38,44.7%,28m
32278,1,Kolyanych,2501,439,17,24,41,41.5%,29m
32278,2,Ilidan,2501,401,16,19,35,45.7%,50m
32278,3,MAMET,2501,380,14,13,27,51.9%,31m
32278,3,Vronsky,2501,254,10,9,19,52.6%,41m
32278,3,turtwig,2501,191,9,2,11,81.8%,1h
32278,3,KenGor,2501,174,7,5,12,58.3%,10m
32278,3,Dica,2501,210,7,8,15,46.7%,8m
32278,3,Tjus,2501,222,7,8,15,46.7%,15m
32278,2,Hammerfaust,2501,156,6,12,18,33.3%,52m
32278,1,cfpa,2501,166,5,17,22,22.7%,18m
32278,3,DooPy,2501,168,4,3,7,57.1%,24m
32278,3,adytzoy,2501,60,3,4,7,42.9%,32m
32278,3,Flakse,2501,30,2,0,2,100.0%,25m
32278,3,Chocobo,2501,58,2,4,6,33.3%,23m
32278,2,Bombenregen,2501,86,2,5,7,28.6%,1h
32278,3,EthanAgger,2501,0,1,0,1,100.0%,24m
32278,3,Medo,2501,0,0,1,1,0.0%,1h
32278,3,[colobo]RADOMIR,2501,0,0,1,1,0.0%,1h
32278,3,SerVych,2501,0,0,1,1,0.0%,12m
32278,3,Rabiat,2501,0,0,2,2,0.0%,19m
32278,1,MrEvgen,2501,0,0,3,3,0.0%,52m
32310,3,Coriandoli,2500,1511,142,135,277,51.3%,19m
32310,1,kwief,2500,227,63,60,123,51.2%,7m
32310,2,palleppesce,2500,1109,45,41,86,52.3%,6m
32310,2,[RABE]Timex,2500,1080,43,40,83,51.8%,18m
32310,2,Kinch,2500,887,34,35,69,49.3%,7m
32310,2,AppleJack,2500,383,17,15,32,53.1%,1h
32310,2,SkyFall,2500,294,15,17,32,46.9%,45m
32310,1,FrostCap,2500,281,10,15,25,40.0%,8m
32310,3,MrMith,2500,202,8,6,14,57.1%,33m
32310,2,YourBestFan,2500,212,8,11,19,42.1%,19m
32310,3,Hannibal,2500,213,7,2,9,77.8%,8m
32310,1,MasterDrreg,2500,190,6,9,15,40.0%,1h
32310,1,[ZePi]Drevotrieska,2500,93,4,4,8,50.0%,1h
32310,1,Gyro,2500,188,4,13,17,23.5%,42m
32310,3,[CuCold]AngryBeard,2500,58,3,1,4,75.0%,16m
32310,1,HELL,2500,96,3,5,8,37.5%,43m
32310,2,Shoran,2500,0,3,6,9,33.3%,33m
32310,1,[Fonta]thepussyman,2500,94,2,0,2,100.0%,33m
32310,3,Tartararam,2500,30,2,1,3,66.7%,24m
32310,3,Olliosborne,2500,60,2,2,4,50.0%,51m
32310,2,aleks,2500,30,2,4,6,33.3%,5m
32310,1,[LMQ]Raphy,2500,0,2,5,7,28.6%,4m
32310,1,Milamber,2500,0,1,0,1,100.0%,25m
32310,3,Alex,2500,0,1,1,2,50.0%,32m
32310,3,Smoke,2500,97,1,1,2,50.0%,10m
32310,2,MaFFin,2500,0,1,2,3,33.3%,5m
32310,3,Treaties,2500,0,1,2,3,33.3%,15m
32310,2,[Sabat]Lazarz,2500,0,1,3,4,25.0%,13m
32310,3,Massy,2500,30,1,4,5,20.0%,19m
32310,3,Zhenya,2500,0,1,4,5,20.0%,45m
32310,2,Pavul,2500,0,0,1,1,0.0%,29m
32310,3,[HiumT]Miilyh,2500,0,0,1,1,0.0%,9m
32310,3,RAGE,2500,0,0,1,1,0.0%,29m
32310,1,[DS24]Alavardov,2500,0,0,1,1,0.0%,5m
32344,1,VanZippen,2499,1495,134,142,276,48.6%,14m
32344,2,Macht,2499,1404,78,79,157,49.7%,21m
32344,1,motomax,2499,1475,76,79,155,49.0%,14m
32344,2,LaPutaMadre,2499,897,41,36,77,53.2%,50m
32344,3,[Gassy]Lubbalou,2499,977,41,51,92,44.6%,21m
32344,1,Kreuzwerfer,2499,504,37,49,86,43.0%,27m
32344,2,dyablobody,2499,645,28,29,57,49.1%,47m
32344,3,saiqasan,2499,442,16,16,32,50.0%,1h
32344,3,ravendark,2499,392,15,17,32,46.9%,20m
32344,1,Jelly,2499,294,13,14,27,48.1%,1h
32344,3,Ultrasonique,2499,254,10,10,20,50.0%,16m
32344,2,Amnam,2499,295,9,11,20,45.0%,40m
32344,2,Sentinel,2499,208,8,10,18,44.4%,1h
32344,1,Bunny,2499,189,7,9,16,43.8%,48m
32344,3,DarkSouL,2499,172,6,5,11,54.5%,24m
32344,3,artgensol,2499,144,6,5,11,54.5%,12m
32344,3,bLUP,2499,191,6,6,12,50.0%,22m
32344,1,[BLMSTR]pfemtire,2499,160,6,10,16,37.5%,16m
32344,3,Brotha,2499,163,5,4,9,55.6%,47m
32344,1,codemaster,2499,169,4,5,9,44.4%,11m
32344,1,oscar,2499,122,4,9,13,30.8%,18m
32344,3,Tarasz,2499,58,3,0,3,100.0%,41m
32344,1,Lumencoeli,2499,97,3,3,6,50.0%,33m
32344,2,SIREX,2499,112,3,4,7,42.9%,34m
32344,2,mazila,2499,0,3,4,7,42.9%,39m
32344,3,Rocko,2499,97,3,5,8,37.5%,30m
32344,3,NightMadness,2499,30,2,0,2,100.0%,24m
32344,3,[CCCPF]doorikCR,2499,0,2,3,5,40.0%,6m
32344,3,Arkadis,2499,96,2,4,6,33.3%,27m
32344,1,LOL,2499,48,2,5,7,28.6%,9m
32344,3,[mAoAm]Neutral,2499,0,1,0,1,100.0%,17m
32344,3,kaprall,2499,0,1,0,1,100.0%,31m
32344,2,Bokinger,2499,0,1,2,3,33.3%,34m
32344,2,Cata,2499,0,1,3,4,25.0%,4m
32344,1,[1DTOA]Den,2499,0,1,5,6,16.7%,1h
32344,3,kSHARK,2499,0,0,1,1,0.0%,3m
32344,3,[mous1c]bavovna,2499,0,0,1,1,0.0%,15m
32344,3,Zamolxes,2499,0,0,1,1,0.0%,27m
32344,1,dodo,2499,0,0,1,1,0.0%,29m
32344,3,Dschingis,2499,0,0,2,2,0.0%,30m
32344,2,Saybork,2499,0,0,4,4,0.0%,5m
32385,1,ManOfMuffins,2498,1613,115,110,225,51.1%,24m
32385,3,Snafu,2498,1229,103,95,198,52.0%,23m
32385,2,Rasti,2498,690,54,51,105,51.4%,43m
32385,1,[IIMMII]RViDXR,2498,1088,45,50,95,47.4%,1h
32385,3,Yko,2498,1020,42,32,74,56.8%,8m
32385,2,Silentstorm,2498,239,30,30,60,50.0%,52m
32385,2,jorgeras,2498,724,25,29,54,46.3%,37m
32385,2,EclectEel,2498,635,24,26,50,48.0%,1h
32385,2,Deadcandance,2498,415,18,20,38,47.4%,38m
32385,2,Asherada,2498,471,18,20,38,47.4%,18m
32385,3,Sovic,2498,340,12,8,20,60.0%,36m
32385,2,JohanRed,2498,276,10,15,25,40.0%,10m
32385,3,Yeonik,2498,226,8,8,16,50.0%,1h
32385,2,Robkari,2498,220,6,6,12,50.0%,31m
32385,2,PeddalToft,2498,162,6,8,14,42.9%,34m
32385,3,Marve,2498,114,5,4,9,55.6%,31m
32385,3,Andro,2498,137,5,4,9,55.6%,31m
32385,3,Emjay,2498,169,5,7,12,41.7%,12m
32385,3,Makica,2498,176,4,3,7,57.1%,29m
32385,2,[PopWiz]Icarus,2498,0,3,3,6,50.0%,51m
32385,3,MamonoSS,2498,97,3,4,7,42.9%,33m
32385,3,Protec,2498,30,2,1,3,66.7%,38m
32385,1,DDoe,2498,48,2,4,6,33.3%,34m
32385,1,Tarent,2498,48,1,1,2,50.0%,37m
32385,1,Erlan,2498,0,1,4,5,20.0%,22m
32385,1,VAF,2498,48,1,4,5,20.0%,26m
32385,1,Lantean,2498,0,1,5,6,16.7%,17m
32385,3,Wolff,2498,0,0,1,1,0.0%,39m
32385,2,Rhyster,2498,0,0,1,1,0.0%,53m
32385,3,Doublejack,2498,0,0,1,1,0.0%,1h
32385,3,Sloventus,2498,0,0,2,2,0.0%,23m
32385,3,[xAngry]angryTobster,2498,0,0,2,2,0.0%,39m
32385,3,uuuuuuuuuuuu,2498,0,0,2,2,0.0%,24m
32385,1,Dog,2498,0,0,6,6,0.0%,50m
32419,1,Uflo,2497,1459,140,145,285,49.1%,47m
32419,2,Froopmania,2497,1014,100,98,198,50.5%,28m
32419,1,VinceLaBrute,2497,1601,93,101,194,47.9%,15m
32419,2,reaper,2497,1512,68,57,125,54.4%,12m
32419,2,Serg,2497,1020,55,55,110,50.0%,29m
32419,2,Notan,2497,997,52,55,107,48.6%,4m
32419,3,DironModys,2497,1077,48,36,84,57.1%,20m
32419,2,Luna,2497,449,29,26,55,52.7%,1h
32419,2,PiPoUBaBaS,2497,562,23,24,47,48.9%,19m
32419,3,Rulezzz,2497,520,20,14,34,58.8%,23m
32419,1,Dzigoro,2497,510,20,20,40,50.0%,8m
32419,1,Джагон,2497,310,19,26,45,42.2%,29m
32419,3,Tor,2497,492,18,15,33,54.5%,16m
32419,2,Dragonforce,2497,251,8,11,19,42.1%,31m
32419,3,[КОНЧА]VitaminC,2497,140,7,4,11,63.6%,25m
32419,1,[lPKTl]OVER,2497,238,7,10,17,41.2%,51m
32419,2,WindMind,2497,158,5,5,10,50.0%,43m
32419,3,alde,2497,138,5,8,13,38.5%,8m
32419,3,[BYTCA]thorN,2497,168,4,2,6,66.7%,16m
32419,1,PewCrew,2497,155,4,2,6,66.7%,1h
32419,3,SDS,2497,146,3,2,5,60.0%,40m
32419,3,SMiLDeWS,2497,96,3,3,6,50.0%,9m
32419,3,Laurin,2497,30,2,1,3,66.7%,30m
32419,3,Пельмень,2497,30,2,2,4,50.0%,21m
32419,2,Darkfuri,2497,30,2,7,9,22.2%,1h
32419,3,Mihai,2497,0,1,2,3,33.3%,17m
32419,2,Nadir,2497,0,1,3,4,25.0%,52m
32419,2,[BUGIA]Raze,2497,30,1,10,11,9.1%,37m
32419,3,[xFRSx]SaLiTer,2497,0,0,1,1,0.0%,20m
32419,3,[Moisty]Cadn,2497,0,0,1,1,0.0%,1h
32419,3,Guitonxyz,2497,0,0,2,2,0.0%,13m
32419,2,lHaZel,2497,0,0,3,3,0.0%,7m
32419,1,Predatorz,2497,0,0,6,6,0.0%,44m
32452,1,Rus,2496,1480,285,280,565,50.4%,1h
32452,1,MARCO,2496,1590,138,143,281,49.1%,8m
32452,3,Jonny,2496,1150,50,37,87,57.5%,1h
32452,2,SCOMPEYROLS,2496,775,44,43,87,50.6%,1h
32452,3,qpax,2496,646,30,17,47,63.8%,27m
32452,3,Aztec,2496,588,22,20,42,52.4%,17m
32452,1,GioeleZ,2496,587,22,24,46,47.8%,1h
32452,2,[GlNYU]Onlineritter,2496,429,18,13,31,58.1%,22m
32452,3,LeonTer,2496,443,18,14,32,56.2%,24m
32452,3,Saintminos,2496,388,15,13,28,53.6%,6m
32452,1,Pouloupoupy,2496,286,9,18,27,33.3%,28m
32452,1,SvarmGost,2496,230,8,14,22,36.4%,4m
32452,2,[NBV]LazyOwl,2496,128,5,5,10,50.0%,12m
32452,3,Kwentein,2496,181,5,6,11,45.5%,12m
32452,3,[EuViP]MiniSTatS,2496,0,4,1,5,80.0%,47m
32452,3,UberPieml,2496,90,4,2,6,66.7%,35m
32452,3,DamnSon,2496,118,4,5,9,44.4%,21m
32452,3,Schweineohre,2496,116,4,6,10,40.0%,25m
32452,1,Viking,2496,118,4,7,11,36.4%,1h
32452,2,CedBenglez,2496,80,4,7,11,36.4%,53m
32452,3,Sarkany,2496,0,3,2,5,60.0%,47m
32452,1,ЖорикМощный,2496,0,3,2,5,60.0%,2m
32452,1,LisAndrew,2496,48,3,3,6,50.0%,37m
32452,1,Dopey,2496,96,3,5,8,37.5%,37m
32452,3,[CocoCo]ScarTheory,2496,40,3,6,9,33.3%,13m
32452,3,Zerga,2496,30,1,1,2,50.0%,25m
32452,3,Alex,2496,30,1,2,3,33.3%,3m
32452,2,[MC2SC2]emilelechat,2496,42,1,2,3,33.3%,34m
32452,3,[EMS2]Mekro,2496,0,1,2,3,33.3%,25m
32452,3,DrivRRR,2496,95,1,5,6,16.7%,46m
32452,3,[STONKS]Evo,2496,0,0,1,1,0.0%,50m
32452,3,tenubre,2496,0,0,2,2,0.0%,1h
32452,2,Cata,2496,0,0,6,6,0.0%,24m
32485,2,Skipping,2495,435,170,161,331,51.4%,44m
32485,3,Yahi,2495,1085,47,30,77,61.0%,1h
32485,3,[T3]Joe,2495,1042,45,28,73,61.6%,1h
32485,3,Frozen,2495,329,19,17,36,52.8%,51m
32485,3,NOxplode,2495,388,14,15,29,48.3%,27m
32485,2,Sirbaam,2495,372,13,17,30,43.3%,29m
32485,2,Smoolijkeee,2495,275,12,12,24,50.0%,1h
32485,3,[PLDM]Immotion,2495,308,12,12,24,50.0%,51m
32485,2,IIIIIIIIII,2495,296,10,14,24,41.7%,44m
32485,3,SZWAGIERS,2495,256,8,13,21,38.1%,8m
32485,2,Boss,2495,170,5,8,13,38.5%,1h
32485,3,ScorpionSMK,2495,145,4,0,4,100.0%,25m
32485,2,OKSERIAN,2495,88,2,4,6,33.3%,3m
32485,3,sten,2495,0,1,0,1,100.0%,12m
32485,2,[fFlags]CosmicGate,2495,0,1,1,2,50.0%,18m
32485,3,Ashel,2495,0,1,4,5,20.0%,18m
32485,3,Волколак,2495,0,0,1,1,0.0%,25m
32485,3,PlankTon,2495,0,0,1,1,0.0%,4m
32485,3,[ÅSNA]HankyP,2495,0,0,1,1,0.0%,9m
32485,3,morda,2495,0,0,2,2,0.0%,19m
32485,3,CIPRIAN,2495,0,0,3,3,0.0%,9m
32506,2,Nivada,2494,1188,48,44,92,52.2%,8m
32506,1,RadonyG,2494,1084,38,45,83,45.8%,11m
32506,2,HePBuK,2494,602,23,21,44,52.3%,22m
32506,3,Max,2494,234,23,25,48,47.9%,3m
32506,3,killer,2494,513,22,10,32,68.8%,19m
32506,2,Edvinab,2494,485,22,22,44,50.0%,50m
32506,2,hazel,2494,604,22,26,48,45.8%,48m
32506,3,Rocket,2494,149,13,1,14,92.9%,13m
32506,3,[mfxed]Diabeloo,2494,308,11,4,15,73.3%,25m
32506,3,SlowMonkey,2494,274,9,12,21,42.9%,3m
32506,3,PoolDoHatu,2494,208,8,6,14,57.1%,3m
32506,3,tupos,2494,266,8,10,18,44.4%,50m
32506,2,Sylo,2494,132,6,10,16,37.5%,33m
32506,2,pancakeling,2494,153,5,6,11,45.5%,21m
32506,3,matys,2494,152,5,7,12,41.7%,9m
32506,3,Emuhunter,2494,102,5,8,13,38.5%,12m
32506,2,PiNoKZeVVsA,2494,141,4,1,5,80.0%,43m
32506,1,Marvell,2494,0,3,2,5,60.0%,17m
32506,2,[PARSE]Belzeebul,2494,88,3,4,7,42.9%,1h
32506,2,BarrelRider,2494,86,3,8,11,27.3%,47m
32506,2,iPlay,2494,0,2,4,6,33.3%,42m
32506,1,CaptJager,2494,0,2,4,6,33.3%,35m
32506,1,Titi,2494,0,2,4,6,33.3%,27m
32506,3,RVIBAYAN,2494,95,2,4,6,33.3%,33m
32506,3,Qurit,2494,38,1,2,3,33.3%,31m
32506,2,[Чайник]AksKolyan,2494,30,1,9,10,10.0%,4m
32506,1,Vladisl,2494,0,0,1,1,0.0%,11m
32506,3,Spiro,2494,0,0,1,1,0.0%,36m
32506,3,Doom,2494,0,0,1,1,0.0%,15m
32506,3,MattPwnYa,2494,0,0,1,1,0.0%,1h
32506,3,Arhail,2494,0,0,1,1,0.0%,33m
32506,3,XDDDDDDDDDDD,2494,0,0,2,2,0.0%,14m
32538,2,Thomas,2493,1545,155,165,320,48.4%,47m
32538,2,[CumA4]fourgeymer,2493,1022,58,47,105,55.2%,43m
32538,2,evectorix,2493,1287,55,48,103,53.4%,40m
32538,2,AntonSerg,2493,1250,49,49,98,50.0%,5m
32538,3,UnlimiteD,2493,1036,38,38,76,50.0%,15m
32538,1,Athmoless,2493,664,21,30,51,41.2%,4m
32538,1,[ROPain]Reason,2493,354,18,29,47,38.3%,27m
32538,3,Lerner,2493,331,11,8,19,57.9%,33m
32538,2,Sebavla,2493,330,9,10,19,47.4%,22m
32538,2,BattleFrog,2493,233,9,12,21,42.9%,49m
32538,3,plutvy,2493,179,7,5,12,58.3%,40m
32538,3,efro,2493,192,7,6,13,53.8%,10m
32538,3,Janq,2493,215,6,4,10,60.0%,35m
32538,3,[BMFG]ProfeZzor,2493,175,6,7,13,46.2%,15m
32538,2,[GaÜ32]KaraMizu,2493,239,6,8,14,42.9%,48m
32538,1,Sonyk,2493,165,5,4,9,55.6%,8m
32538,2,[THANOS]Odin,2493,108,5,4,9,55.6%,45m
32538,2,Irongladden,2493,128,4,4,8,50.0%,26m
32538,3,Dogma,2493,135,4,6,10,40.0%,46m
32538,2,DoctorProbes,2493,88,4,7,11,36.4%,34m
32538,2,Lotusss,2493,88,3,4,7,42.9%,22m
32538,3,Veidar,2493,143,2,1,3,66.7%,25m
32538,1,Домовой,2493,145,2,1,3,66.7%,26m
32538,3,sweetMay,2493,30,2,2,4,50.0%,20m
32538,2,ivacho,2493,0,2,4,6,33.3%,29m
32538,1,BlueOracle,2493,0,2,5,7,28.6%,1h
32538,3,Lostconos,2493,82,2,6,8,25.0%,4m
32538,2,shprqgeli,2493,58,2,6,8,25.0%,29m
32538,1,Dante,2493,0,1,4,5,20.0%,31m
32538,1,Aarn,2493,0,1,4,5,20.0%,34m
32538,3,[GGaaSS]dimongrand,2493,0,0,1,1,0.0%,27m
32538,3,IIIIIIIIIIII,2493,0,0,1,1,0.0%,32m
32538,1,Satanademon,2493,0,0,1,1,0.0%,30m
32538,2,FFD,2493,0,0,3,3,0.0%,51m
32572,3,[PLA2N]gitarist,2492,1451,60,88,148,40.5%,12m
32572,2,Odin,2492,649,45,54,99,45.5%,44m
32572,3,Bramlorn,2492,935,38,34,72,52.8%,42m
32572,1,[ZERGTB]Bahek,2492,726,30,30,60,50.0%,18m
32572,2,[InitRu]uri,2492,166,28,25,53,52.8%,50m
32572,2,Cloudy,2492,680,27,27,54,50.0%,29m
32572,2,kupso,2492,697,27,28,55,49.1%,32m
32572,2,Lazlo,2492,636,24,28,52,46.2%,33m
32572,2,FutrzaQ,2492,505,18,19,37,48.6%,1h
32572,3,dabolo,2492,382,16,10,26,61.5%,20m
32572,3,kubalonek,2492,291,15,15,30,50.0%,13m
32572,3,Zazend,2492,362,14,18,32,43.8%,3m
32572,3,KIR,2492,284,11,8,19,57.9%,15m
32572,2,TERRAN,2492,291,11,12,23,47.8%,29m
32572,2,Radevin,2492,226,7,9,16,43.8%,37m
32572,3,LaFrYp,2492,188,5,8,13,38.5%,16m
32572,3,KillerCat,2492,94,4,6,10,40.0%,7m
32572,3,zenmoment,2492,60,3,3,6,50.0%,43m
32572,3,[TBIRRA]Dave,2492,90,3,3,6,50.0%,5m
32572,3,SalivBrennun,2492,116,3,5,8,37.5%,47m
32572,2,[GAE]zerling,2492,30,3,6,9,33.3%,7m
32572,2,igoska,2492,30,3,6,9,33.3%,21m
32572,2,Krakks,2492,0,2,4,6,33.3%,1h
32572,1,ERSTIM,2492,0,2,4,6,33.3%,27m
32572,3,Valik,2492,0,1,0,1,100.0%,27m
32572,1,ALPHA,2492,0,0,1,1,0.0%,25m
32572,3,Arbit,2492,0,0,1,1,0.0%,42m
32572,3,[Khazar]CanVeeD,2492,0,0,2,2,0.0%,1h
32572,3,Noks,2492,0,0,3,3,0.0%,22m
32601,2,plastick,2491,1581,144,146,290,49.7%,47m
32601,2,[НОД17]TugW,2491,579,40,41,81,49.4%,37m
32601,3,NazmoX,2491,360,15,1,16,93.8%,9m
32601,3,Emre,2491,364,13,14,27,48.1%,23m
32601,2,Pumbaa,2491,241,9,10,19,47.4%,12m
32601,1,Борщ,2491,0,4,1,5,80.0%,34m
32601,3,zitreezy,2491,95,4,2,6,66.7%,12m
32601,2,[HZeS]Dariona,2491,44,4,7,11,36.4%,33m
32601,2,kotmmm,2491,55,3,7,10,30.0%,20m
32601,2,Digital,2491,0,2,1,3,66.7%,37m
32601,3,cindy,2491,0,2,3,5,40.0%,27m
32601,1,CVlad,2491,48,2,4,6,33.3%,52m
32601,3,Limpania,2491,30,2,6,8,25.0%,41m
32601,3,Вячеслав,2491,0,1,0,1,100.0%,46m
32601,2,[TeRo]Mew,2491,0,1,2,3,33.3%,48m
32601,3,SleepyDragon,2491,36,1,4,5,20.0%,4m
32601,3,Dorinush,2491,0,1,4,5,20.0%,21m
32618,3,Neexs,2490,1629,161,146,307,52.4%,38m
32618,2,CommanderLOK,2490,1574,152,148,300,50.7%,12m
32618,3,ISTI,2490,691,26,25,51,51.0%,33m
32618,3,Komi,2490,521,25,4,29,86.2%,1h
32618,3,LorrdPicollo,2490,600,23,17,40,57.5%,9m
32618,1,obschampion,2490,567,22,28,50,44.0%,36m
32618,2,thijs,2490,330,18,22,40,45.0%,20m
32618,3,LOBODEMAR,2490,415,15,14,29,51.7%,4m
32618,2,Gogolinolett,2490,375,14,13,27,51.9%,43m
32618,3,majapakwa,2490,265,14,13,27,51.9%,25m
32618,3,Макуха,2490,348,12,16,28,42.9%,1h
32618,3,Pyrks,2490,106,7,6,13,53.8%,1h
32618,3,RatherBad,2490,212,7,9,16,43.8%,21m
32618,3,Timonus,2490,207,6,3,9,66.7%,9m
32618,3,TuZa,2490,172,6,7,13,46.2%,21m
32618,2,Sky,2490,184,5,7,12,41.7%,18m
32618,1,SCV,2490,100,5,10,15,33.3%,42m
32618,3,[TeamRC]NaCi,2490,167,4,8,12,33.3%,29m
32618,3,[BIELLE]LęÐǂZęP,2490,95,3,3,6,50.0%,33m
32618,3,Koevoet,2490,58,3,5,8,37.5%,47m
32618,2,Noseleap,2490,116,3,5,8,37.5%,39m
32618,2,[russpr]Warvar,2490,116,3,5,8,37.5%,29m
32618,3,JSanchez,2490,60,2,3,5,40.0%,17m
32618,3,Jeborg,2490,0,1,0,1,100.0%,47m
32618,3,ehgaming,2490,96,1,1,2,50.0%,12m
32618,1,Onatolik,2490,0,1,3,4,25.0%,23m
32618,3,[FBUNNY]eatmore,2490,0,1,4,5,20.0%,26m
32618,3,JOPA,2490,0,1,4,5,20.0%,19m
32618,1,Danner,2490,0,0,1,1,0.0%,14m
32618,3,klinik,2490,0,0,2,2,0.0%,1h
32618,2,Somie,2490,0,0,3,3,0.0%,51m
32618,3,Оляпыч,2490,0,0,3,3,0.0%,14m
32650,3,Olivier,2489,928,143,136,279,51.3%,9m
32650,3,TarronBryce,2489,1448,65,54,119,54.6%,12m
32650,1,[PiCa]Manaspawn,2489,964,35,40,75,46.7%,1h
32650,3,[улей55]Сибиряк,2489,773,33,17,50,66.0%,51m
32650,3,davegamer,2489,616,28,18,46,60.9%,23m
32650,2,Lucirn,2489,487,22,14,36,61.1%,20m
32650,3,Reedn,2489,416,16,12,28,57.1%,50m
32650,3,VWEGA,2489,444,16,16,32,50.0%,3m
32650,3,[RioF]oettn,2489,391,13,15,28,46.4%,1h
32650,2,ZicBar,2489,273,12,3,15,80.0%,1h
32650,3,svchost,2489,282,12,7,19,63.2%,51m
32650,3,sabnock,2489,254,10,15,25,40.0%,30m
32650,2,Hummer,2489,250,9,7,16,56.2%,5m
32650,3,Laggg,2489,188,9,14,23,39.1%,12m
32650,3,Mihail,2489,182,7,8,15,46.7%,30m
32650,2,[LeCafé]Arkoura,2489,229,7,10,17,41.2%,33m
32650,2,sabastocrato,2489,212,7,11,18,38.9%,16m
32650,2,Rosen,2489,216,7,13,20,35.0%,20m
32650,3,PLaytOster,2489,100,5,5,10,50.0%,18m
32650,3,CheLovek,2489,111,4,1,5,80.0%,18m
32650,3,Mayxi,2489,0,3,6,9,33.3%,12m
32650,3,[KgM]FollowMie,2489,143,3,6,9,33.3%,46m
32650,2,[FTPQ]Demidroll,2489,94,3,7,10,30.0%,15m
32650,1,IIIIIIII,2489,97,2,4,6,33.3%,2m
32650,3,HanSolo,2489,0,1,0,1,100.0%,50m
32650,3,OykHydra,2489,0,1,0,1,100.0%,9m
32650,3,MunRule,2489,0,1,0,1,100.0%,8m
32650,3,ANT,2489,0,1,1,2,50.0%,9m
32650,3,Moscow,2489,97,1,2,3,33.3%,49m
32650,3,Телимор,2489,30,1,3,4,25.0%,12m
32650,3,Kerrigan,2489,0,0,1,1,0.0%,51m
32650,3,zsfree,2489,0,0,1,1,0.0%,17m
32650,3,birchi,2489,0,0,2,2,0.0%,21m
32650,3,pirou,2489,0,0,3,3,0.0%,21m
32650,2,zmora,2489,0,0,5,5,0.0%,24m
32685,1,Dankfinger,2488,1079,131,125,256,51.2%,51m
32685,2,Wyrm,2488,1213,88,91,179,49.2%,29m
32685,2,[Koban]kotakkozime,2488,623,77,63,140,55.0%,27m
32685,2,[blur]kaiser,2488,1238,51,47,98,52.0%,7m
32685,2,syva,2488,1175,50,64,114,43.9%,10m
32685,3,johan,2488,422,16,9,25,64.0%,9m
32685,3,[VDN]Zorn,2488,387,16,15,31,51.6%,39m
32685,3,[EsOst]Infinity,2488,337,14,11,25,56.0%,21m
32685,2,Marshakk,2488,375,12,16,28,42.9%,34m
32685,2,Serafimzik,2488,308,10,17,27,37.0%,6m
32685,3,Nirrometh,2488,172,7,4,11,63.6%,8m
32685,2,Vasilevs,2488,120,6,7,13,46.2%,1h
32685,3,[eWo]ThunderBird,2488,154,4,6,10,40.0%,20m
32685,3,AgentF,2488,36,3,6,9,33.3%,18m
32685,3,roman,2488,30,2,1,3,66.7%,3m
32685,1,GiPe,2488,0,2,3,5,40.0%,1h
32685,1,Zapupa,2488,0,2,5,7,28.6%,51m
32685,3,Baxter,2488,0,1,1,2,50.0%,47m
32685,3,FALCO,2488,0,1,2,3,33.3%,16m
32685,2,JACKSON,2488,0,1,2,3,33.3%,33m
32685,1,Exodia,2488,0,1,4,5,20.0%,47m
32685,3,WARPIG,2488,0,1,4,5,20.0%,1h
32685,1,CerfDesBois,2488,95,1,5,6,16.7%,27m
32685,2,[Prpl]michail,2488,0,0,3,3,0.0%,49m
32685,1,PerseoSpain,2488,0,0,6,6,0.0%,37m
32710,3,IVLEGION,2487,1575,228,219,447,51.0%,6m
32710,3,Garden,2487,871,33,41,74,44.6%,10m
32710,2,regtemarmot,2487,552,32,36,68,47.1%,1h
32710,3,Kerrigan,2487,677,26,21,47,55.3%,8m
32710,3,Galileo,2487,460,17,13,30,56.7%,47m
32710,3,JohnHennry,2487,439,16,21,37,43.2%,2m
32710,2,golfStream,2487,316,12,13,25,48.0%,42m
32710,1,[MeDuS]barauskas,2487,368,12,16,28,42.9%,3m
32710,2,light,2487,322,10,13,23,43.5%,27m
32710,3,Sensor,2487,176,9,4,13,69.2%,15m
32710,3,BuckNaked,2487,247,9,13,22,40.9%,21m
32710,3,iamSOplastic,2487,175,7,4,11,63.6%,47m
32710,3,FeelsBatman,2487,178,7,8,15,46.7%,51m
32710,3,MADGAKKIN,2487,148,6,4,10,60.0%,51m
32710,3,Strotch,2487,196,6,6,12,50.0%,42m
32710,3,[AciNoN]TASSADAR,2487,165,5,0,5,100.0%,8m
32710,2,[B76]STARFIGHTER,2487,60,5,5,10,50.0%,49m
32710,2,Sutra,2487,120,4,8,12,33.3%,1h
32710,3,Perdition,2487,86,3,4,7,42.9%,9m
32710,3,[UbS]Smoople,2487,58,3,4,7,42.9%,24m
32710,3,[TC58]xLuisitox,2487,92,3,5,8,37.5%,1h
32710,2,SERG,2487,90,3,6,9,33.3%,5m
32710,2,McLovin,2487,42,2,1,3,66.7%,21m
32710,1,NaCly,2487,0,2,3,5,40.0%,1h
32710,3,chooseaname,2487,0,2,5,7,28.6%,17m
32710,2,overkill,2487,42,1,2,3,33.3%,48m
32710,2,Magemanne,2487,0,0,1,1,0.0%,21m
32710,2,Elyzea,2487,0,0,1,1,0.0%,15m
32710,3,Moreduc,2487,0,0,2,2,0.0%,29m
32710,3,habahaba,2487,0,0,2,2,0.0%,46m
32710,3,[SworD3]Leegoo,2487,0,0,2,2,0.0%,8m
32710,3,[ZiCh]Алукард,2487,0,0,3,3,0.0%,25m
32742,1,Xandor,2486,1582,122,125,247,49.4%,17m
32742,3,likimaya,2486,1563,108,107,215,50.2%,42m
32742,3,[laugh]furious,2486,1464,86,82,168,51.2%,34m
32742,3,[WG33]THENIL,2486,1453,60,55,115,52.2%,19m
32742,3,Macelix,2486,1393,53,48,101,52.5%,14m
32742,3,SPQR,2486,814,29,29,58,50.0%,21m
32742,3,BloodHunter,2486,224,27,19,46,58.7%,21m
32742,2,Diasat,2486,541,22,26,48,45.8%,43m
32742,2,мальчишка,2486,545,18,21,39,46.2%,39m
32742,1,Stianaarre,2486,505,17,20,37,45.9%,22m
32742,3,MAR,2486,302,16,15,31,51.6%,21m
32742,3,griJul,2486,355,12,8,20,60.0%,8m
32742,3,ZergMan,2486,296,12,8,20,60.0%,6m
32742,2,[MSTPLS]Delmortis,2486,275,12,16,28,42.9%,44m
32742,1,Jogosh,2486,336,11,23,34,32.4%,24m
32742,3,[ZenDex]JloMaHyTblu,2486,200,8,7,15,53.3%,39m
32742,2,Neurons,2486,250,7,11,18,38.9%,29m
32742,3,Aitken,2486,144,6,4,10,60.0%,25m
32742,2,[MdbS]NeverGind,2486,144,6,12,18,33.3%,39m
32742,3,Vali,2486,164,4,2,6,66.7%,38m
32742,3,Besoeb,2486,90,4,3,7,57.1%,27m
32742,3,rassel,2486,58,3,0,3,100.0%,16m
32742,1,Ragnathul,2486,0,3,3,6,50.0%,29m
32742,3,becquer,2486,0,3,5,8,37.5%,5m
32742,3,Коломбо,2486,121,2,2,4,50.0%,12m
32742,1,Tarasek,2486,97,2,3,5,40.0%,39m
32742,3,Ocdi,2486,95,2,4,6,33.3%,1h
32742,1,lesorub,2486,48,2,5,7,28.6%,26m
32742,2,Emerik,2486,0,2,5,7,28.6%,49m
32742,3,Gordy,2486,0,1,0,1,100.0%,4m
32742,3,Killerparty,2486,0,1,0,1,100.0%,12m
32742,3,xenocombo,2486,0,1,0,1,100.0%,1h
32742,3,Bubasik,2486,30,1,2,3,33.3%,20m
32742,3,ReSoNaNCe,2486,30,1,2,3,33.3%,34m
32742,3,QueQueTos,2486,30,1,3,4,25.0%,51m
32742,3,[RVR]ParusMajor,2486,0,0,1,1,0.0%,12m
32742,3,Максим,2486,0,0,1,1,0.0%,47m
32742,3,eror,2486,0,0,1,1,0.0%,37m
32780,2,stason,2485,1551,140,131,271,51.7%,42m
32780,2,Balu,2485,870,44,35,79,55.7%,1h
32780,3,[ignari]spakkocuoron,2485,892,34,33,67,50.7%,25m
32780,3,Nils,2485,603,22,16,38,57.9%,53m
32780,2,lilconti,2485,382,15,16,31,48.4%,21m
32780,3,Rentgen,2485,374,14,7,21,66.7%,1h
32780,2,herrar,2485,332,12,19,31,38.7%,34m
32780,2,DevitcaZerg,2485,310,9,13,22,40.9%,7m
32780,3,asdf,2485,256,9,13,22,40.9%,32m
32780,2,Servitor,2485,190,9,14,23,39.1%,14m
32780,1,tomeknucek,2485,164,8,9,17,47.1%,20m
32780,1,SupremeKyn,2485,118,7,9,16,43.8%,30m
32780,3,[SPRNS]Winil,2485,140,4,0,4,100.0%,1h
32780,3,gosoub,2485,134,4,5,9,44.4%,26m
32780,3,Andromedroid,2485,120,4,9,13,30.8%,21m
32780,3,Luis,2485,60,3,4,7,42.9%,47m
32780,3,Woland,2485,60,2,4,6,33.3%,14m
32780,2,Distrik,2485,30,2,6,8,25.0%,29m
32780,2,Hasgaliel,2485,0,1,3,4,25.0%,7m
32780,2,lior,2485,0,0,1,1,0.0%,10m
32780,1,Diver,2485,0,0,1,1,0.0%,27m
32780,1,klaatu,2485,0,0,5,5,0.0%,25m
32802,2,LeoNOOB,2484,1461,181,180,361,50.1%,7m
32802,1,GengYsKhan,2484,1323,90,102,192,46.9%,10m
32802,3,[MaSiYa]MasaO,2484,1299,70,55,125,56.0%,51m
32802,3,PurpleBroly,2484,913,67,52,119,56.3%,42m
32802,1,LittleDemon,2484,633,51,48,99,51.5%,24m
32802,2,Mike,2484,575,31,25,56,55.4%,50m
32802,3,SHADOWDRAGON,2484,748,29,26,55,52.7%,38m
32802,2,Alexx,2484,680,28,24,52,53.8%,20m
32802,3,MaskedMonkey,2484,404,19,11,30,63.3%,21m
32802,2,Zörg,2484,280,10,21,31,32.3%,12m
32802,3,krypton,2484,224,8,8,16,50.0%,41m
32802,3,ElitePflanze,2484,213,6,4,10,60.0%,21m
32802,2,Den,2484,196,6,8,14,42.9%,35m
32802,3,Frostkeeper,2484,96,5,10,15,33.3%,1h
32802,1,Niisan,2484,0,4,1,5,80.0%,35m
32802,1,Oznerol,2484,96,4,4,8,50.0%,40m
32802,3,TheSolution,2484,114,3,0,3,100.0%,23m
32802,2,Zleud,2484,30,3,5,8,37.5%,49m
32802,1,[JRMSAL]Cazador,2484,0,1,4,5,20.0%,34m
32802,1,Manthem,2484,0,1,4,5,20.0%,37m
32802,1,SyncroOKW,2484,0,0,1,1,0.0%,27m
32802,3,[HRisk]Maximmuss,2484,0,0,2,2,0.0%,23m
32824,2,JAx,2483,1594,70,68,138,50.7%,18m
32824,3,ExAnd,2483,1160,44,35,79,55.7%,30m
32824,3,noobletess,2483,814,29,27,56,51.8%,32m
32824,1,hydralongre,2483,549,24,27,51,47.1%,15m
32824,3,[sonic1]Archon,2483,561,23,14,37,62.2%,1h
32824,3,LilProbius,2483,608,22,22,44,50.0%,21m
32824,2,[K4RL]ComanderY,2483,540,21,23,44,47.7%,47m
32824,2,kiler,2483,389,18,10,28,64.3%,1h
32824,2,Fek,2483,416,17,21,38,44.7%,39m
32824,3,Zagar,2483,379,13,9,22,59.1%,13m
32824,3,QuBuS,2483,269,11,7,18,61.1%,33m
32824,2,Jorge,2483,200,8,10,18,44.4%,43m
32824,1,oneshot,2483,141,7,8,15,46.7%,22m
32824,2,boundless,2483,221,7,9,16,43.8%,7m
32824,3,Xenos,2483,144,6,9,15,40.0%,27m
32824,3,Sarmkadan,2483,160,5,4,9,55.6%,1h
32824,3,daVincHbKyay,2483,191,5,4,9,55.6%,41m
32824,2,[КУВ]AdminForcah,2483,199,5,9,14,35.7%,45m
32824,3,[tofury]wwow,2483,86,4,1,5,80.0%,19m
32824,1,Nespresso,2483,134,4,14,18,22.2%,4m
32824,3,bongodrums,2483,121,3,5,8,37.5%,29m
32824,3,[Xtreme]Requiem,2483,121,2,3,5,40.0%,50m
32824,1,Sinario,2483,0,2,4,6,33.3%,34m
32824,3,Bulka,2483,97,2,5,7,28.6%,41m
32824,3,Krelian,2483,0,1,0,1,100.0%,10m
32824,2,Mamaju,2483,0,1,3,4,25.0%,39m
32824,3,CEORF,2483,0,1,4,5,20.0%,39m
32824,2,Guigs,2483,46,1,5,6,16.7%,1h
32824,3,ThunderStef,2483,0,0,1,1,0.0%,46m
32824,3,Max,2483,0,0,2,2,0.0%,34m
32824,3,Rok,2483,0,0,4,4,0.0%,39m
32855,2,nente,2482,1547,220,226,446,49.3%,15m
32855,1,ChinoBlack,2482,1175,88,88,176,50.0%,7m
32855,2,tipoune,2482,1448,73,69,142,51.4%,43m
32855,3,Feshy,2482,961,49,47,96,51.0%,15m
32855,2,elena,2482,1087,47,42,89,52.8%,46m
32855,2,David,2482,1024,46,44,90,51.1%,1h
32855,3,Ximik,2482,865,40,40,80,50.0%,2m
32855,3,vitalik,2482,539,23,15,38,60.5%,47m
32855,2,BigPutotoy,2482,541,22,24,46,47.8%,8m
32855,2,Sly,2482,424,19,14,33,57.6%,21m
32855,3,eQuiLStyle,2482,426,16,14,30,53.3%,25m
32855,3,TimeEvil,2482,416,14,31,45,31.1%,17m
32855,2,CZejkob,2482,305,13,12,25,52.0%,7m
32855,3,[ASSe]IPityU,2482,376,13,16,29,44.8%,32m
32855,2,[AlienR]Macromaster,2482,386,13,22,35,37.1%,47m
32855,3,Soprano,2482,320,10,12,22,45.5%,20m
32855,1,Parliament,2482,311,10,13,23,43.5%,1h
32855,3,[Sylyx]Saints,2482,256,9,3,12,75.0%,17m
32855,2,LAJohanson,2482,174,7,12,19,36.8%,16m
32855,2,LaMaGrA,2482,220,6,4,10,60.0%,45m
32855,3,Akame,2482,168,6,7,13,46.2%,15m
32855,2,Sleepy,2482,185,5,3,8,62.5%,36m
32855,1,Raintlex,2482,200,5,6,11,45.5%,34m
32855,2,[Chariz]ШтаныУдачи,2482,199,5,7,12,41.7%,34m
32855,3,ffgas,2482,86,4,2,6,66.7%,32m
32855,3,Salarida,2482,70,4,6,10,40.0%,36m
32855,3,Seiko,2482,60,4,9,13,30.8%,4m
32855,2,Destiny,2482,30,4,9,13,30.8%,11m
32855,1,Auirz,2482,0,3,2,5,60.0%,52m
32855,1,sloffenjager,2482,96,3,3,6,50.0%,21m
32855,3,CnGuN,2482,0,3,3,6,50.0%,21m
32855,1,Arima,2482,96,3,5,8,37.5%,27m
32855,3,Orion,2482,0,2,3,5,40.0%,21m
32855,2,[SaarA]Maldini,2482,0,2,5,7,28.6%,6m
32855,3,[NFGKS]KillingName,2482,30,1,4,5,20.0%,24m
32855,3,Pamnek,2482,0,0,1,1,0.0%,10m
32855,3,[BLHPL]MARO,2482,0,0,1,1,0.0%,1h
32855,3,[0TC]marky,2482,0,0,1,1,0.0%,10m
32855,2,LemanRuss,2482,0,0,1,1,0.0%,1h
32855,3,Obsessed,2482,0,0,1,1,0.0%,21m
32895,2,Rythmic,2481,789,89,80,169,52.7%,43m
32895,2,SAYgg,2481,1176,82,69,151,54.3%,5m
32895,3,meanmachine,2481,1178,71,73,144,49.3%,47m
32895,1,ŚwiatłyKieł,2481,381,65,57,122,53.3%,36m
32895,2,tize,2481,1048,50,48,98,51.0%,31m
32895,3,BigPi,2481,1048,47,37,84,56.0%,1h
32895,2,PoPoLuPo,2481,884,34,34,68,50.0%,7m
32895,3,MAK,2481,400,28,20,48,58.3%,35m
32895,2,Zink,2481,697,27,27,54,50.0%,49m
32895,2,Rfgrabben,2481,581,23,28,51,45.1%,43m
32895,3,DRUNKEDUCK,2481,472,18,14,32,56.2%,1h
32895,3,Nomisarache,2481,400,16,7,23,69.6%,21m
32895,2,[FYBF]NEVEN,2481,336,16,15,31,51.6%,5m
32895,3,[BTown]Persianality,2481,282,10,11,21,47.6%,5m
32895,2,Assasia,2481,190,7,4,11,63.6%,23m
32895,3,Tyrannosaur,2481,196,7,6,13,53.8%,1h
32895,2,Monos,2481,215,7,11,18,38.9%,34m
32895,1,Диоданд,2481,154,7,11,18,38.9%,1h
32895,2,MOLNIA,2481,181,6,7,13,46.2%,18m
32895,3,Zeal,2481,140,5,4,9,55.6%,3m
32895,3,EkremDmrz,2481,144,4,1,5,80.0%,37m
32895,3,[mtl]meteorcrash,2481,92,4,3,7,57.1%,1h
32895,2,Kir,2481,128,4,6,10,40.0%,21m
32895,1,Angers,2481,96,3,6,9,33.3%,23m
32895,3,[WpG]Nurarihyon,2481,30,2,0,2,100.0%,23m
32895,3,Trey,2481,0,2,5,7,28.6%,25m
32895,2,Vladimir,2481,0,2,5,7,28.6%,1h
32895,3,collapsz,2481,30,1,2,3,33.3%,21m
32895,3,LoserCoolYT,2481,30,1,2,3,33.3%,35m
32895,1,Тень,2481,0,1,4,5,20.0%,17m
32895,2,[SuPi]BuaMan,2481,30,1,9,10,10.0%,24m
32895,3,CuiCui,2481,0,0,1,1,0.0%,23m
32895,3,avadon,2481,0,0,1,1,0.0%,33m
32895,3,Real,2481,0,0,1,1,0.0%,41m
32895,3,Selemene,2481,0,0,3,3,0.0%,1h
32930,2,STARpeR,2480,1411,255,253,508,50.2%,20m
32930,1,STAAALIN,2480,1338,59,62,121,48.8%,10m
32930,3,пряня,2480,1481,59,73,132,44.7%,21m
32930,3,Billyboyo,2480,741,58,60,118,49.2%,42m
32930,3,[G4R3N]zero,2480,1252,56,46,102,54.9%,27m
32930,2,[PowOw]FluffyRSA,2480,1078,45,38,83,54.2%,39m
32930,1,asd,2480,976,37,45,82,45.1%,4m
32930,3,Leo,2480,624,27,16,43,62.8%,33m
32930,2,Aragorn,2480,678,26,35,61,42.6%,4m
32930,2,Sanya,2480,650,21,28,49,42.9%,53m
32930,3,West,2480,370,15,23,38,39.5%,19m
32930,2,[ZЕRGТV]Greenkrolik,2480,372,14,14,28,50.0%,34m
32930,2,[Dokii]Axio,2480,226,8,1,9,88.9%,26m
32930,2,voltab,2480,258,8,6,14,57.1%,27m
32930,3,[Zhig]Nova,2480,218,7,3,10,70.0%,8m
32930,2,HenQueen,2480,178,7,4,11,63.6%,14m
32930,2,Scipion,2480,140,7,5,12,58.3%,27m
32930,2,FLASTIK,2480,204,7,17,24,29.2%,1h
32930,1,[teksol]Fearta,2480,102,6,5,11,54.5%,21m
32930,3,sahar,2480,166,5,1,6,83.3%,21m
32930,3,Gunner,2480,189,5,6,11,45.5%,32m
32930,3,Bredd,2480,171,5,6,11,45.5%,1h
32930,3,Lokki,2480,113,4,7,11,36.4%,23m
32930,1,Crash,2480,48,3,3,6,50.0%,11m
32930,3,Koral,2480,60,3,4,7,42.9%,1h
32930,3,bentel,2480,34,3,6,9,33.3%,7m
32930,3,[gliOrc]Fedess,2480,119,2,2,4,50.0%,19m
32930,3,Bapsensei,2480,58,2,2,4,50.0%,12m
32930,3,DeDoK,2480,0,2,3,5,40.0%,16m
32930,1,Mobro,2480,0,2,3,5,40.0%,1h
32930,3,LordCorvin,2480,0,1,0,1,100.0%,9m
32930,3,Shiokann,2480,0,1,0,1,100.0%,33m
32930,3,SamGamesCz,2480,0,1,0,1,100.0%,1h
32930,3,[Elli]Miledi,2480,0,1,1,2,50.0%,42m
32930,1,fluffyDuck,2480,0,1,4,5,20.0%,11m
32930,3,FalseScanian,2480,0,0,1,1,0.0%,41m
32930,2,[AnIM37]BlackFire,2480,0,0,2,2,0.0%,51m
32930,3,Trizet,2480,0,0,5,5,0.0%,1h
32968,2,Shadow,2479,1497,87,85,172,50.6%,1h
32968,1,imposter,2479,1505,83,90,173,48.0%,7m
32968,3,[Pxyool]MMRSanta,2479,944,79,62,141,56.0%,39m
32968,2,никита,2479,908,58,41,99,58.6%,23m
32968,1,[jjkjkv]TurbO,2479,1402,49,63,112,43.8%,46m
32968,1,Warcry,2479,804,43,46,89,48.3%,52m
32968,3,Shrimp,2479,965,40,31,71,56.3%,8m
32968,3,Hatim,2479,715,28,20,48,58.3%,23m
32968,2,MATHIS,2479,389,15,16,31,48.4%,11m
32968,3,Spezza,2479,342,14,11,25,56.0%,26m
32968,3,[BOMBO]BabaDon,2479,333,13,13,26,50.0%,20m
32968,1,KAISERDUST,2479,294,11,13,24,45.8%,51m
32968,1,Qaktus,2479,285,10,14,24,41.7%,32m
32968,3,[QMnewb]ANDERSX,2479,256,8,4,12,66.7%,41m
32968,3,christianoss,2479,182,6,9,15,40.0%,15m
32968,3,zingo,2479,125,5,4,9,55.6%,18m
32968,3,Gratwicke,2479,168,5,5,10,50.0%,40m
32968,3,[hf4X4]jOne,2479,164,4,1,5,80.0%,32m
32968,1,SAdemon,2479,48,4,2,6,66.7%,1h
32968,3,Olam,2479,133,4,6,10,40.0%,46m
32968,2,ZagZig,2479,172,4,9,13,30.8%,3m
32968,3,Uzym,2479,95,3,3,6,50.0%,9m
32968,1,Kabum,2479,126,3,5,8,37.5%,24m
32968,2,SpaceBerry,2479,30,3,6,9,33.3%,21m
32968,3,Weltenfisch,2479,123,2,3,5,40.0%,52m
32968,3,[ROGwar]JENAAL,2479,30,2,4,6,33.3%,25m
32968,3,Blitzkrig,2479,96,2,4,6,33.3%,42m
32968,2,FlipFlop,2479,0,2,4,6,33.3%,39m
32968,1,galaxysol,2479,0,2,5,7,28.6%,27m
32968,1,Demonizer,2479,0,2,7,9,22.2%,43m
32968,3,HelperDen,2479,0,1,0,1,100.0%,23m
32968,1,[YPG]ExoSkyroz,2479,0,1,4,5,20.0%,31m
32968,3,giorgiof,2479,0,0,2,2,0.0%,27m
33001,1,[FXD]elcativo,2478,1595,495,499,994,49.8%,17m
33001,3,Lifebtrippin,2478,1339,123,115,238,51.7%,32m
33001,3,Adrenalinix,2478,666,26,22,48,54.2%,46m
33001,3,MrBananix,2478,510,25,13,38,65.8%,39m
33001,3,DmitriusVII,2478,349,23,19,42,54.8%,23m
33001,3,Jambalaya,2478,303,20,13,33,60.6%,10m
33001,2,DoSs,2478,462,17,22,39,43.6%,43m
33001,3,Ssibal,2478,393,16,11,27,59.3%,35m
33001,3,Chippa,2478,358,12,10,22,54.5%,30m
33001,1,Perec,2478,306,9,21,30,30.0%,4m
33001,3,Plunge,2478,175,7,11,18,38.9%,9m
33001,3,ihtianderson,2478,62,5,9,14,35.7%,14m
33001,3,toàn,2478,141,4,0,4,100.0%,18m
33001,1,Kupsef,2478,96,3,2,5,60.0%,52m
33001,2,KSB,2478,149,3,3,6,50.0%,27m
33001,3,[Hybrid]Mahonry,2478,58,3,4,7,42.9%,14m
33001,3,[KG312]AGENT,2478,97,2,0,2,100.0%,3m
33001,3,Jokvin,2478,30,2,3,5,40.0%,1h
33001,3,[L4rv3r]jiiru,2478,95,2,4,6,33.3%,40m
33001,3,pchavdarov,2478,0,2,5,7,28.6%,1h
33001,3,Mido,2478,0,1,0,1,100.0%,33m
33001,3,znak,2478,30,1,1,2,50.0%,37m
33001,3,wml,2478,89,1,1,2,50.0%,13m
33001,1,PARALLAX,2478,0,1,5,6,16.7%,11m
33001,3,[TExGG]Naka,2478,0,0,1,1,0.0%,4m
33001,3,DuKec,2478,0,0,1,1,0.0%,13m
33001,3,[alu]uvran,2478,0,0,2,2,0.0%,1h
33001,3,WarlorD,2478,0,0,2,2,0.0%,12m
33029,1,Zjic,2477,1454,231,218,449,51.4%,6m
33029,3,Enigma,2477,586,126,125,251,50.2%,5m
33029,2,[ZoZ]Killer,2477,1602,124,123,247,50.2%,3m
33029,2,Moo,2477,1519,105,99,204,51.5%,38m
33029,3,[6level]hotspot,2477,1146,44,42,86,51.2%,8m
33029,3,StarfightrBG,2477,966,41,31,72,56.9%,27m
33029,3,manro,2477,805,36,22,58,62.1%,47m
33029,2,ElectroKing,2477,777,31,25,56,55.4%,19m
33029,1,lucifer,2477,668,27,31,58,46.6%,1h
33029,1,Capdevaila,2477,752,24,33,57,42.1%,19m
33029,3,Dragonguy,2477,496,19,15,34,55.9%,21m
33029,3,[TFABII]MeisterRevan,2477,452,19,18,37,51.4%,39m
33029,1,Jetomance,2477,448,18,21,39,46.2%,15m
33029,3,DeepWeb,2477,351,13,10,23,56.5%,31m
33029,3,kierzkos,2477,211,10,6,16,62.5%,19m
33029,3,[PARADX]OkumaZ,2477,228,10,17,27,37.0%,20m
33029,2,Angel,2477,255,8,12,20,40.0%,50m
33029,3,[IceHus]llllllllll,2477,246,8,18,26,30.8%,14m
33029,3,RageFull,2477,198,7,9,16,43.8%,53m
33029,2,Limbo,2477,230,7,10,17,41.2%,26m
33029,2,PMW,2477,194,6,13,19,31.6%,29m
33029,3,[ZZT]Azeliel,2477,90,5,7,12,41.7%,1h
33029,3,KoHg,2477,144,5,10,15,33.3%,6m
33029,3,[FAR2]Brennus,2477,163,4,2,6,66.7%,13m
33029,3,feX,2477,60,4,7,11,36.4%,1h
33029,2,sypchik,2477,88,3,10,13,23.1%,8m
33029,3,Teodor,2477,30,2,0,2,100.0%,21m
33029,3,orbitus,2477,118,2,2,4,50.0%,17m
33029,3,MariosV,2477,131,2,3,5,40.0%,12m
33029,3,FOOL,2477,94,2,4,6,33.3%,14m
33029,2,Redafalt,2477,0,2,6,8,25.0%,28m
33029,3,[FoRiGr]winer,2477,0,1,0,1,100.0%,1h
33029,3,denrus,2477,0,1,1,2,50.0%,43m
33029,3,Sarius,2477,30,1,2,3,33.3%,6m
33029,1,Mojita,2477,0,1,4,5,20.0%,29m
33029,3,IloveAngel,2477,0,0,1,1,0.0%,47m
33029,3,Shader,2477,0,0,1,1,0.0%,23m
33029,1,Skan,2477,0,0,1,1,0.0%,25m
33067,3,Arnaud,2476,1398,108,111,219,49.3%,1h
33067,1,Fesss,2476,667,99,99,198,50.0%,28m
33067,3,lamaking,2476,874,67,48,115,58.3%,13m
33067,1,Green,2476,647,60,55,115,52.2%,18m
33067,1,Sparkless,2476,951,47,58,105,44.8%,36m
33067,2,Bombel,2476,1136,46,45,91,50.5%,7m
33067,3,Fruitkiller,2476,861,36,28,64,56.2%,1h
33067,1,shired,2476,829,29,36,65,44.6%,36m
33067,3,jonciks,2476,724,28,25,53,52.8%,31m
33067,3,iustin,2476,657,25,20,45,55.6%,33m
33067,3,LeopardDrake,2476,470,20,17,37,54.1%,1h
33067,3,sheog,2476,431,17,11,28,60.7%,33m
33067,3,[10swrm]Callmehenry,2476,280,13,8,21,61.9%,12m
33067,2,Lazert,2476,210,11,10,21,52.4%,1h
33067,3,Weelzevul,2476,289,10,7,17,58.8%,47m
33067,2,Deco,2476,218,8,9,17,47.1%,41m
33067,1,[Нrr]Shepard,2476,117,7,7,14,50.0%,25m
33067,2,kos,2476,184,6,7,13,46.2%,3m
33067,2,Gasim,2476,90,6,11,17,35.3%,16m
33067,3,[SNheta]Goyahkla,2476,121,3,2,5,60.0%,32m
33067,3,Nanoken,2476,121,3,6,9,33.3%,50m
33067,3,ultralisk,2476,46,2,2,4,50.0%,10m
33067,3,Peacemaker,2476,30,2,4,6,33.3%,1h
33067,1,koHA,2476,48,2,4,6,33.3%,34m
33067,3,Gaël,2476,97,2,4,6,33.3%,41m
33067,3,[Maon]Mason,2476,0,1,0,1,100.0%,35m
33067,3,DrOzDzU,2476,0,1,0,1,100.0%,42m
33067,3,Kremalk,2476,0,1,2,3,33.3%,50m
33067,1,DaiTo,2476,0,1,4,5,20.0%,17m
33067,3,tamoo,2476,0,0,1,1,0.0%,13m
33067,3,[Maitri]AryaTara,2476,0,0,1,1,0.0%,20m
33067,3,YoWanSum,2476,0,0,1,1,0.0%,39m
33067,3,Screewm,2476,0,0,3,3,0.0%,16m
33100,3,VneMoraly,2475,904,92,93,185,49.7%,8m
33100,3,mutik,2475,801,34,22,56,60.7%,19m
33100,1,Skrippel,2475,798,30,33,63,47.6%,3m
33100,3,[SSquаd]сhelovek,2475,707,29,28,57,50.9%,33m
33100,3,[fackme]борода,2475,544,22,16,38,57.9%,15m
33100,2,Gnar,2475,458,22,24,46,47.8%,34m
33100,3,[Seek]Getayr,2475,342,19,14,33,57.6%,23m
33100,3,Алекс,2475,438,18,9,27,66.7%,3m
33100,3,HiSpace,2475,315,15,0,15,100.0%,42m
33100,3,Lestat,2475,378,15,19,34,44.1%,4m
33100,3,MrFiregun,2475,338,14,12,26,53.8%,20m
33100,2,[BURIZA]AlexKoks,2475,408,14,19,33,42.4%,13m
33100,3,Vila,2475,194,9,3,12,75.0%,39m
33100,3,[GOBTA]Kraken,2475,214,7,4,11,63.6%,19m
33100,2,[Degro]lel,2475,212,6,7,13,46.2%,29m
33100,3,[TIGER5]joe,2475,147,4,2,6,66.7%,3m
33100,3,CAS,2475,90,4,4,8,50.0%,34m
33100,1,Sinnley,2475,88,4,5,9,44.4%,16m
33100,3,[Z3RG7V]Delbros,2475,135,4,6,10,40.0%,1h
33100,3,WielkiBUM,2475,145,3,2,5,60.0%,33m
33100,3,[CDIgg]Xnre,2475,122,3,4,7,42.9%,40m
33100,2,GustavGhost,2475,58,3,5,8,37.5%,49m
33100,2,[ANREN]Yaross,2475,46,3,8,11,27.3%,48m
33100,3,RabidShrimp,2475,121,2,1,3,66.7%,40m
33100,3,Meldarion,2475,60,2,4,6,33.3%,32m
33100,1,AmigoPlay,2475,0,1,0,1,100.0%,3m
33100,3,nerozar,2475,0,1,2,3,33.3%,1h
33100,3,Mates,2475,0,1,4,5,20.0%,47m
33100,3,Turrican,2475,0,0,1,1,0.0%,47m
33100,3,DEATH,2475,0,0,1,1,0.0%,23m
33100,1,Silly,2475,0,0,4,4,0.0%,1h
33131,3,Naze,2474,1532,209,206,415,50.4%,18m
33131,1,[CHIPO]JohnEBoy,2474,1569,174,170,344,50.6%,48m
33131,2,LeaderUSSR,2474,1370,114,101,215,53.0%,8m
33131,3,Alex,2474,1184,86,71,157,54.8%,32m
33131,1,ThePanda,2474,1500,73,80,153,47.7%,1h
33131,3,SanyaM,2474,1191,54,49,103,52.4%,27m
33131,3,Leon,2474,371,35,32,67,52.2%,4m
33131,3,Gatskopper,2474,850,34,26,60,56.7%,4m
33131,3,LEVSHA,2474,790,32,23,55,58.2%,51m
33131,2,[wdps]CobraEffect,2474,386,30,30,60,50.0%,37m
33131,3,chenandyk,2474,640,28,36,64,43.8%,16m
33131,3,Sam,2474,635,25,19,44,56.8%,1h
33131,3,[Dagon]sath,2474,456,19,18,37,51.4%,19m
33131,2,Kruuuk,2474,449,17,26,43,39.5%,23m
33131,1,Brodyaga,2474,407,14,12,26,53.8%,14m
33131,3,Potato,2474,350,13,14,27,48.1%,47m
33131,3,lis,2474,286,12,5,17,70.6%,50m
33131,3,Nick,2474,336,12,9,21,57.1%,23m
33131,3,Bhaal,2474,184,9,2,11,81.8%,1h
33131,3,iadaci,2474,260,9,12,21,42.9%,34m
33131,3,DeathTheKid,2474,215,8,6,14,57.1%,50m
33131,3,SkyStar,2474,218,6,7,13,46.2%,41m
33131,1,[QaQa]Quasar,2474,145,5,2,7,71.4%,19m
33131,3,[EnLiMy]DamSaï,2474,146,5,5,10,50.0%,1h
33131,2,pieczzarek,2474,171,5,6,11,45.5%,5m
33131,2,Fuzaa,2474,30,4,5,9,44.4%,7m
33131,3,[DeLord]Clemens,2474,127,4,6,10,40.0%,19m
33131,3,WolnyBrovar,2474,60,4,6,10,40.0%,12m
33131,2,Fama,2474,109,3,5,8,37.5%,1h
33131,3,StellaFella,2474,30,2,0,2,100.0%,4m
33131,3,Lerhish,2474,121,2,2,4,50.0%,41m
33131,3,[FBON]Nakami,2474,30,2,3,5,40.0%,1h
33131,1,laulau,2474,0,1,0,1,100.0%,26m
33131,3,Roistapoista,2474,0,1,0,1,100.0%,25m
33131,1,[MbU]MbULegendary,2474,0,1,1,2,50.0%,17m
33131,3,LavaPiranha,2474,30,1,1,2,50.0%,42m
33131,1,drwoswaa,2474,0,0,1,1,0.0%,43m
33131,3,MasterChief,2474,0,0,1,1,0.0%,39m
33131,3,Aserwois,2474,0,0,1,1,0.0%,42m
33131,2,Practic,2474,0,0,5,5,0.0%,19m
33171,3,fafadu,2473,1165,94,81,175,53.7%,21m
33171,3,[DEDAL]aasasas,2473,654,78,90,168,46.4%,2m
33171,3,xrey,2473,1002,68,52,120,56.7%,1h
33171,3,Moonkins,2473,398,34,34,68,50.0%,13m
33171,3,Robin,2473,830,32,31,63,50.8%,42m
33171,3,schnouille,2473,376,14,11,25,56.0%,51m
33171,3,[Ba2c]MisterJoBa,2473,314,12,6,18,66.7%,8m
33171,3,STYKE,2473,330,12,12,24,50.0%,4m
33171,3,[MeoWS]Olivia,2473,275,12,15,27,44.4%,32m
33171,3,Dunthil,2473,338,12,16,28,42.9%,10m
33171,1,spaermiosis,2473,305,9,12,21,42.9%,25m
33171,3,Developer,2473,200,8,7,15,53.3%,8m
33171,2,DraZze,2473,283,8,10,18,44.4%,26m
33171,1,NainMaboule,2473,143,7,9,16,43.8%,25m
33171,3,Zhorikcccp,2473,120,5,3,8,62.5%,3m
33171,3,[K0RM2]Keyt,2473,118,5,5,10,50.0%,25m
33171,1,Prime,2473,32,4,6,10,40.0%,28m
33171,1,[Đodo]Chaïbon,2473,123,4,8,12,33.3%,1h
33171,3,Sneakysquid,2473,177,4,10,14,28.6%,53m
33171,1,Verosa,2473,121,3,4,7,42.9%,35m
33171,3,Janngson,2473,90,3,6,9,33.3%,21m
33171,1,шумахер,2473,0,2,2,4,50.0%,39m
33171,3,Shineze,2473,58,2,4,6,33.3%,26m
33171,1,tomaszek,2473,94,2,8,10,20.0%,31m
33171,1,Tacheki,2473,0,1,0,1,100.0%,19m
33171,2,Shaorrran,2473,0,1,4,5,20.0%,33m
33171,3,ixaakeex,2473,0,0,1,1,0.0%,26m
33171,3,Starh,2473,0,0,1,1,0.0%,1h
33171,3,Priest,2473,0,0,1,1,0.0%,42m
33200,3,[RsTb]Red,2472,1619,175,174,349,50.1%,42m
33200,3,Krasnal,2472,900,34,30,64,53.1%,24m
33200,1,Silent,2472,498,21,27,48,43.8%,48m
33200,3,danibuj,2472,395,15,10,25,60.0%,10m
33200,3,TrioBoss,2472,334,14,19,33,42.4%,15m
33200,1,pansky,2472,401,11,24,35,31.4%,1h
33200,3,KovidXii,2472,312,10,7,17,58.8%,51m
33200,2,RoKo,2472,232,8,15,23,34.8%,7m
33200,2,Simonster,2472,236,8,15,23,34.8%,42m
33200,3,zendelphi,2472,199,7,5,12,58.3%,21m
33200,3,ден,2472,203,6,1,7,85.7%,19m
33200,3,[BZerO]txtsxm,2472,178,6,7,13,46.2%,5m
33200,2,ZarkousxD,2472,136,5,7,12,41.7%,45m
33200,2,Shyness,2472,159,5,8,13,38.5%,2m
33200,3,[PÄR]OpSolarBeam,2472,62,5,9,14,35.7%,6m
33200,1,лол,2472,48,4,4,8,50.0%,53m
33200,2,[Bogart]PAJEN,2472,100,4,10,14,28.6%,44m
33200,2,[NotSuR]Minatych,2472,118,3,1,4,75.0%,9m
33200,1,[3osG]Rebell,2472,96,3,5,8,37.5%,21m
33200,3,Holland,2472,0,2,5,7,28.6%,31m
33200,3,Waffles,2472,0,1,0,1,100.0%,1h
33200,3,SashaMaster,2472,0,1,0,1,100.0%,39m
33200,3,Lisker,2472,0,1,1,2,50.0%,10m
33200,3,[ERIC]Shoes,2472,0,1,4,5,20.0%,26m
33200,3,McTurtle,2472,0,1,4,5,20.0%,10m
33200,2,[NHT]CaptainFOX,2472,30,1,6,7,14.3%,1h
33200,3,[InitRu]gacar,2472,0,0,1,1,0.0%,33m
33200,3,Skald,2472,0,0,1,1,0.0%,18m
33200,3,MrPanda,2472,0,0,1,1,0.0%,1h
33200,1,hpbuba,2472,0,0,2,2,0.0%,43m
33230,1,Tochiro,2471,1460,239,247,486,49.2%,1h
33230,2,Morenito,2471,1546,92,71,163,56.4%,52m
33230,3,[CyTron]LikeyourcutG,2471,950,37,31,68,54.4%,37m
33230,3,Saturas,2471,658,36,21,57,63.2%,12m
33230,3,Hispano,2471,766,31,34,65,47.7%,21m
33230,2,[OMGITS]zenden,2471,570,22,27,49,44.9%,13m
33230,2,phoenix,2471,541,20,18,38,52.6%,1h
33230,3,Taldarin,2471,486,18,11,29,62.1%,53m
33230,1,Medea,2471,343,18,14,32,56.2%,33m
33230,3,SERRALambo,2471,322,15,12,27,55.6%,16m
33230,3,Monteiga,2471,234,11,13,24,45.8%,8m
33230,3,NaMeLeSs,2471,254,10,10,20,50.0%,23m
33230,2,OraOra,2471,233,9,10,19,47.4%,1h
33230,3,[HUNBT]balintmester,2471,178,6,10,16,37.5%,25m
33230,3,ukupnik,2471,162,5,7,12,41.7%,18m
33230,3,[LdLT]Nacho,2471,137,3,2,5,60.0%,9m
33230,3,TengriLetho,2471,30,3,5,8,37.5%,43m
33230,3,TheMagistr,2471,90,3,6,9,33.3%,38m
33230,2,VoidHunter,2471,34,2,1,3,66.7%,6m
33230,3,DedVin,2471,58,2,3,5,40.0%,51m
33230,3,Krychas,2471,30,1,1,2,50.0%,21m
33230,3,Severian,2471,30,1,2,3,33.3%,15m
33230,3,Misha,2471,0,1,3,4,25.0%,15m
33230,1,nikipiki,2471,0,1,4,5,20.0%,2m
33230,3,VeryHotAss,2471,0,0,1,1,0.0%,1h
33230,3,DrJeru,2471,0,0,2,2,0.0%,47m
33230,3,EVØLVE,2471,0,0,2,2,0.0%,31m
33230,2,Banzola,2471,0,0,6,6,0.0%,32m
33258,3,Soldersurfer,2470,1585,232,230,462,50.2%,26m
33258,2,[FGEsc]WhoCares,2470,1521,73,67,140,52.1%,51m
33258,3,Balrok,2470,1490,67,80,147,45.6%,15m
33258,2,Илья,2470,1012,51,50,101,50.5%,47m
33258,3,UnseenShadow,2470,392,15,10,25,60.0%,1h
33258,3,senderal,2470,380,15,13,28,53.6%,27m
33258,2,Gonzo,2470,416,14,22,36,38.9%,27m
33258,3,Rikost,2470,347,12,6,18,66.7%,10m
33258,3,bombeiro,2470,335,12,6,18,66.7%,14m
33258,2,Saul,2470,292,12,11,23,52.2%,5m
33258,3,taytacura,2470,243,10,12,22,45.5%,42m
33258,2,hawk,2470,192,7,8,15,46.7%,24m
33258,3,[RSPD]shadowstorm,2470,211,7,8,15,46.7%,1h
33258,2,Needled,2470,122,6,10,16,37.5%,53m
33258,3,[FteamF]ОлегМонгол,2470,113,4,3,7,57.1%,1h
33258,3,KoMbaTiK,2470,0,3,2,5,60.0%,51m
33258,3,[CDPM]Ghenda,2470,90,3,6,9,33.3%,10m
33258,3,[SC2T4K]Porcinerate,2470,62,3,6,9,33.3%,23m
33258,3,halker,2470,30,2,0,2,100.0%,38m
33258,3,ImmortalWood,2470,30,2,1,3,66.7%,10m
33258,1,idkfa,2470,48,2,2,4,50.0%,22m
33258,1,Benny,2470,0,2,5,7,28.6%,25m
33258,3,philipp,2470,0,1,0,1,100.0%,10m
33258,3,arkish,2470,0,1,2,3,33.3%,10m
33258,3,NayNes,2470,0,1,4,5,20.0%,1h
33258,3,Teroniko,2470,0,0,1,1,0.0%,3m
33258,3,Чувачок,2470,0,0,1,1,0.0%,23m
33258,3,Lettwill,2470,0,0,1,1,0.0%,18m
33258,3,NeCroBox,2470,0,0,2,2,0.0%,10m
33287,3,Кобра,2469,1559,81,74,155,52.3%,33m
33287,3,[AiRǂ]MONTY,2469,710,60,46,106,56.6%,42m
33287,3,[BarKin]Misha,2469,991,58,57,115,50.4%,20m
33287,1,swelf,2469,481,46,58,104,44.2%,11m
33287,3,AphRo,2469,1070,43,40,83,51.8%,33m
33287,2,ТрахерЧечни,2469,692,28,29,57,49.1%,43m
33287,3,IceLoli,2469,687,26,24,50,52.0%,9m
33287,2,[DYNAM]Tndany,2469,504,19,23,42,45.2%,43m
33287,3,Robert,2469,409,17,7,24,70.8%,35m
33287,3,[CruZe]Marian,2469,320,12,13,25,48.0%,23m
33287,2,MihZaaa,2469,118,12,15,27,44.4%,6m
33287,2,Юсуф,2469,304,11,6,17,64.7%,33m
33287,3,Umbri,2469,281,10,10,20,50.0%,47m
33287,2,Dominic,2469,302,10,13,23,43.5%,3m
33287,1,[Juju]OniiBoy,2469,276,10,14,24,41.7%,8m
33287,1,MrPasto,2469,146,8,1,9,88.9%,51m
33287,2,Sebastien,2469,280,8,13,21,38.1%,50m
33287,3,[GamerX]Whanos,2469,206,6,4,10,60.0%,23m
33287,2,[aDGa]Fabian,2469,134,4,7,11,36.4%,21m
33287,3,Trandi,2469,30,2,1,3,66.7%,20m
33287,1,idareder,2469,97,2,2,4,50.0%,35m
33287,3,Nebulous,2469,72,2,4,6,33.3%,16m
33287,3,ZIGMESTER,2469,0,1,0,1,100.0%,33m
33287,1,Madara,2469,48,1,2,3,33.3%,27m
33287,3,Maro,2469,30,1,2,3,33.3%,1h
33287,3,[Rarara]Krisaruga,2469,0,1,4,5,20.0%,27m
33287,1,Hrvat,2469,48,1,6,7,14.3%,21m
33287,3,majkel,2469,0,0,2,2,0.0%,23m
33287,2,Antilope,2469,0,0,3,3,0.0%,35m
33287,3,[Bwkfst]Pikajewz,2469,0,0,4,4,0.0%,17m
33317,2,LeTzFeTz,2468,1344,163,151,314,51.9%,1h
33317,3,[gairt]Gainullin,2468,1370,114,94,208,54.8%,33m
33317,3,[TAKAS]Misiol,2468,502,55,53,108,50.9%,10m
33317,2,Ermn,2468,1278,47,51,98,48.0%,1h
33317,3,Garth,2468,679,30,48,78,38.5%,11m
33317,3,SAKKIE,2468,553,26,23,49,53.1%,32m
33317,1,Felix,2468,634,23,31,54,42.6%,28m
33317,2,LifeTryer,2468,470,18,20,38,47.4%,39m
33317,2,[TPTofS]thepirate,2468,461,17,18,35,48.6%,30m
33317,2,Martron,2468,508,17,22,39,43.6%,52m
33317,2,Simonomis,2468,169,13,21,34,38.2%,29m
33317,3,Allatarious,2468,287,11,11,22,50.0%,23m
33317,3,subliminal,2468,280,10,10,20,50.0%,32m
33317,2,cfyz,2468,258,10,16,26,38.5%,8m
33317,3,Hausemaster,2468,193,6,4,10,60.0%,8m
33317,3,Platinum,2468,154,6,9,15,40.0%,1h
33317,1,Gageris,2468,169,4,6,10,40.0%,53m
33317,2,mahag,2468,60,4,6,10,40.0%,51m
33317,3,lLVl,2468,119,3,0,3,100.0%,1h
33317,3,ГИГАПИГА,2468,144,3,7,10,30.0%,48m
33317,2,ReyStorn,2468,40,2,0,2,100.0%,48m
33317,3,Serahel,2468,58,2,2,4,50.0%,42m
33317,1,erk,2468,48,2,5,7,28.6%,53m
33317,2,ferre,2468,0,2,5,7,28.6%,21m
33317,1,Pausenbrot,2468,0,2,6,8,25.0%,11m
33317,3,arcoswat,2468,0,1,0,1,100.0%,51m
33317,3,[LFDL]gbraptors,2468,30,1,1,2,50.0%,50m
33317,3,saot,2468,30,1,1,2,50.0%,10m
33317,3,Nykzo,2468,30,1,2,3,33.3%,20m
33317,3,Aelita,2468,97,1,2,3,33.3%,40m
33317,2,grpc,2468,0,1,3,4,25.0%,46m
33317,3,Veyron,2468,0,1,4,5,20.0%,39m
33317,2,dyrkolet,2468,0,1,5,6,16.7%,31m
33317,3,TheDecideR,2468,30,1,11,12,8.3%,38m
33317,3,[EzD]ikar,2468,0,0,1,1,0.0%,1h
33317,3,Fruchtfliege,2468,0,0,1,1,0.0%,35m
33317,3,DoReMe,2468,0,0,1,1,0.0%,31m
33317,3,GHK,2468,0,0,3,3,0.0%,17m
33317,3,UDCrew,2468,0,0,4,4,0.0%,38m
33317,3,SupremPizza,2468,0,0,4,4,0.0%,15m
33317,2,Skibby,2468,0,0,6,6,0.0%,13m
33358,3,[DECIMA]Nemo,2467,723,77,76,153,50.3%,20m
33358,3,Blushven,2467,613,45,31,76,59.2%,53m
33358,2,[éire]ProTosser,2467,520,40,38,78,51.3%,25m
33358,3,BBQMaster,2467,955,39,40,79,49.4%,13m
33358,3,JZBlade,2467,794,35,37,72,48.6%,1h
33358,3,Шура,2467,248,30,30,60,50.0%,47m
33358,2,Yaroslav,2467,619,24,32,56,42.9%,31m
33358,2,Solevita,2467,572,20,23,43,46.5%,37m
33358,3,Arren,2467,483,19,16,35,54.3%,35m
33358,2,Plasticity,2467,425,18,15,33,54.5%,7m
33358,3,Bernkastel,2467,427,18,19,37,48.6%,1h
33358,1,Beda,2467,435,17,30,47,36.2%,40m
33358,2,ThePuppeteer,2467,403,14,17,31,45.2%,22m
33358,1,tivoli,2467,428,14,24,38,36.8%,18m
33358,3,Zabor,2467,360,13,14,27,48.1%,30m
33358,3,[MASTRO]Oriun,2467,300,11,10,21,52.4%,51m
33358,3,TheSpeedDuke,2467,227,9,7,16,56.2%,35m
33358,3,MojoJojo,2467,280,9,8,17,52.9%,48m
33358,3,[лунааа]starkiller,2467,274,9,9,18,50.0%,27m
33358,2,OttoDracula,2467,234,9,10,19,47.4%,51m
33358,3,NARUD,2467,183,7,5,12,58.3%,1h
33358,1,zayaz,2467,48,4,4,8,50.0%,21m
33358,1,ArkanDeath,2467,119,4,7,11,36.4%,24m
33358,3,[GIBLA]Nightmare,2467,97,2,0,2,100.0%,13m
33358,3,kisas,2467,121,2,2,4,50.0%,1h
33358,2,Hitohi,2467,109,2,3,5,40.0%,27m
33358,1,Byte,2467,97,2,4,6,33.3%,3m
33358,1,[BCNG]Vanchesko,2467,46,2,4,6,33.3%,6m
33358,2,Aioqu,2467,0,2,5,7,28.6%,21m
33358,3,BORUX,2467,0,1,0,1,100.0%,33m
33358,1,JordanYA,2467,48,1,1,2,50.0%,31m
33358,3,tivire,2467,0,1,5,6,16.7%,6m
33358,2,valad,2467,0,1,5,6,16.7%,32m
33358,3,stranic,2467,0,0,1,1,0.0%,13m
33392,1,[Pdass]caloo,2466,1569,156,168,324,48.1%,42m
33392,3,Ulcrar,2466,993,137,118,255,53.7%,32m
33392,2,GabrielOgres,2466,651,72,66,138,52.2%,5m
33392,2,WujekTomek,2466,546,62,58,120,51.7%,4m
33392,2,Myver,2466,880,48,26,74,64.9%,21m
33392,3,Lunam,2466,289,29,7,36,80.6%,39m
33392,3,MrMarch,2466,677,26,27,53,49.1%,48m
33392,3,Dempsei,2466,281,19,22,41,46.3%,50m
33392,3,Boec,2466,402,15,9,24,62.5%,19m
33392,2,Kekx,2466,384,15,16,31,48.4%,37m
33392,2,ssksk,2466,295,13,9,22,59.1%,1h
33392,3,Yoka,2466,370,13,10,23,56.5%,35m
33392,3,Heznzu,2466,388,13,16,29,44.8%,32m
33392,1,Yosik,2466,342,12,13,25,48.0%,44m
33392,3,MahaCarrier,2466,274,11,10,21,52.4%,10m
33392,2,RANGLER,2466,327,11,10,21,52.4%,1h
33392,3,[EMAs]Kraesar,2466,229,10,10,20,50.0%,33m
33392,3,cosmic,2466,239,8,6,14,57.1%,31m
33392,2,xlnz,2466,192,8,11,19,42.1%,20m
33392,3,[ClandM]Acamone,2466,208,7,12,19,36.8%,4m
33392,3,Maximilian,2466,171,6,7,13,46.2%,6m
33392,1,verrektejj,2466,90,6,8,14,42.9%,1h
33392,3,Kvothe,2466,153,5,7,12,41.7%,10m
33392,3,KronusZero,2466,0,4,3,7,57.1%,49m
33392,3,[NinJs]Fascination,2466,174,4,8,12,33.3%,39m
33392,3,Lazzlo,2466,92,3,8,11,27.3%,33m
33392,3,doom,2466,30,2,3,5,40.0%,19m
33392,1,Kriomorf,2466,0,1,1,2,50.0%,39m
33392,3,[4Len]Melaroll,2466,30,1,2,3,33.3%,47m
33392,3,Zulan,2466,38,1,3,4,25.0%,29m
33392,3,Kirazzz,2466,0,1,4,5,20.0%,35m
33392,1,Googler,2466,36,1,9,10,10.0%,11m
33392,3,[74Rus]ДиКиЙнУбАсИк,2466,0,0,1,1,0.0%,5m
33392,3,[SF13]XxANXxX,2466,0,0,1,1,0.0%,35m
33392,3,mAetti,2466,0,0,1,1,0.0%,13m
33392,3,Xantos,2466,0,0,1,1,0.0%,42m
33392,1,Cemen,2466,0,0,1,1,0.0%,53m
33392,3,[foxi]Trebin,2466,0,0,2,2,0.0%,21m
33392,3,ammelix,2466,0,0,3,3,0.0%,51m
33431,3,Aleaiactaest,2465,1587,116,106,222,52.3%,33m
33431,3,COBRA,2465,1391,111,98,209,53.1%,13m
33431,3,[AofK]saeng,2465,1531,103,89,192,53.6%,12m
33431,1,CpuGpuMaster,2465,1578,80,81,161,49.7%,37m
33431,3,Joelito,2465,1467,79,66,145,54.5%,32m
33431,3,SmallEagle,2465,1034,44,33,77,57.1%,21m
33431,2,Nikita,2465,943,41,44,85,48.2%,4m
33431,3,[CTEHA]Odin,2465,563,41,51,92,44.6%,33m
33431,3,vlad,2465,863,39,25,64,60.9%,41m
33431,2,ghaelen,2465,884,38,31,69,55.1%,50m
33431,3,Jigslol,2465,782,35,32,67,52.2%,30m
33431,3,[SƬǂ]PogoTheClown,2465,469,20,10,30,66.7%,26m
33431,3,UhberPussay,2465,376,19,24,43,44.2%,10m
33431,3,Zaniah,2465,475,17,21,38,44.7%,21m
33431,3,loulou,2465,332,11,9,20,55.0%,4m
33431,3,Skilles,2465,285,11,14,25,44.0%,33m
33431,3,Berndy,2465,284,9,8,17,52.9%,31m
33431,2,SinatrA,2465,286,9,9,18,50.0%,53m
33431,3,GertJan,2465,207,8,7,15,53.3%,46m
33431,1,EDRH,2465,165,6,10,16,37.5%,36m
33431,3,MaDzone,2465,185,5,2,7,71.4%,41m
33431,3,Charlie,2465,116,5,3,8,62.5%,35m
33431,3,[3DE]Heliac,2465,154,5,9,14,35.7%,1h
33431,3,Sasper,2465,143,4,2,6,66.7%,18m
33431,3,PAXeke,2465,141,4,2,6,66.7%,21m
33431,3,Fui,2465,92,4,8,12,33.3%,18m
33431,1,[Plata]Twin,2465,0,3,6,9,33.3%,1h
33431,1,shador,2465,0,2,3,5,40.0%,39m
33431,3,XEXA,2465,0,2,3,5,40.0%,38m
33431,1,piex,2465,97,2,4,6,33.3%,46m
33431,3,SidVicious,2465,0,2,5,7,28.6%,12m
33431,3,[DiGuGu]orenong,2465,0,1,0,1,100.0%,23m
33431,3,[izako]BoarsKratos,2465,0,1,0,1,100.0%,13m
33431,3,Accipiter,2465,0,1,0,1,100.0%,12m
33431,3,Zavodila,2465,30,1,2,3,33.3%,19m
33431,2,Коммандор,2465,0,0,4,4,0.0%,53m
33467,3,Zedd,2464,362,60,58,118,50.8%,16m
33467,3,Oscalot,2464,835,52,39,91,57.1%,38m
33467,3,Violet,2464,656,46,39,85,54.1%,1h
33467,1,Lorim,2464,648,44,50,94,46.8%,44m
33467,3,WolchOK,2464,662,34,35,69,49.3%,19m
33467,3,roastbeef,2464,733,30,24,54,55.6%,41m
33467,3,Niño,2464,723,28,34,62,45.2%,26m
33467,1,Index,2464,626,27,32,59,45.8%,19m
33467,3,snakeAs,2464,564,23,35,58,39.7%,11m
33467,3,DeMarco,2464,220,19,8,27,70.4%,24m
33467,3,[00WW00]MaugLee,2464,327,12,6,18,66.7%,52m
33467,2,[RP1]Ksamilion,2464,288,11,10,21,52.4%,11m
33467,3,Emeraude,2464,265,11,13,24,45.8%,42m
33467,3,Vitboss,2464,260,8,4,12,66.7%,19m
33467,1,Vlados,2464,233,7,4,11,63.6%,1h
33467,3,MeshoK,2464,231,7,6,13,53.8%,42m
33467,3,Ben,2464,178,6,7,13,46.2%,32m
33467,2,AlexSpite,2464,152,5,0,5,100.0%,30m
33467,3,[TeamLB]Folau,2464,90,4,5,9,44.4%,4m
33467,2,[BenBil]benoo,2464,102,3,2,5,60.0%,13m
33467,2,Begalon,2464,116,3,3,6,50.0%,47m
33467,2,Bendi,2464,0,3,7,10,30.0%,10m
33467,1,[PuNcyN]Kaktus,2464,146,3,10,13,23.1%,3m
33467,3,Wolf,2464,0,1,4,5,20.0%,46m
33467,3,[InitRu]Rustatem,2464,30,1,5,6,16.7%,24m
33467,1,ToiletDive,2464,0,1,5,6,16.7%,19m
33467,3,AlmostDivine,2464,0,0,1,1,0.0%,8m
33467,3,[BadPun]Bop,2464,0,0,1,1,0.0%,52m
33467,3,[SoS1]DontTouchMe,2464,0,0,1,1,0.0%,1h
33467,3,michaszek,2464,0,0,1,1,0.0%,1h
33467,3,[LIQUID]Alex,2464,0,0,1,1,0.0%,1h
33467,3,Asturion,2464,0,0,2,2,0.0%,9m
33499,2,GadkiUtionek,2463,1607,147,151,298,49.3%,50m
33499,2,[PARSE]simi,2463,1214,121,107,228,53.1%,7m
33499,3,InoRus,2463,897,61,58,119,51.3%,20m
33499,2,ChriKre,2463,1298,50,56,106,47.2%,20m
33499,3,Врудвар,2463,930,49,42,91,53.8%,28m
33499,3,tucsok,2463,690,28,24,52,53.8%,18m
33499,3,Starwolf,2463,604,24,19,43,55.8%,20m
33499,2,Botvenik,2463,602,23,25,48,47.9%,24m
33499,3,Deleyaman,2463,542,21,22,43,48.8%,50m
33499,3,[London]SlapTrick,2463,434,17,16,33,51.5%,19m
33499,3,[z666z]Бетрезэн,2463,310,11,7,18,61.1%,26m
33499,3,RMF,2463,282,11,10,21,52.4%,32m
33499,2,Hamu,2463,237,8,12,20,40.0%,19m
33499,2,Name,2463,152,7,6,13,53.8%,1m
33499,2,Makarios,2463,92,5,7,12,41.7%,51m
33499,3,Sportsmen,2463,152,5,8,13,38.5%,37m
33499,3,Dark,2463,148,4,7,11,36.4%,48m
33499,3,[DaFF]MOISTLING,2463,118,3,0,3,100.0%,3m
33499,3,KAD,2463,138,3,1,4,75.0%,8m
33499,3,MikeyMike,2463,140,3,2,5,60.0%,24m
33499,1,Dicboy,2463,82,3,12,15,20.0%,1h
33499,2,davistoron,2463,114,2,3,5,40.0%,17m
33499,1,lechetibia,2463,58,2,6,8,25.0%,34m
33499,1,PaBuK,2463,0,1,3,4,25.0%,1h
33499,3,[Monlit]LoLNetKlip,2463,0,0,1,1,0.0%,1h
33499,1,Meshtera,2463,0,0,1,1,0.0%,14m
33499,3,korid,2463,0,0,1,1,0.0%,48m
33499,3,Emixam,2463,0,0,1,1,0.0%,15m
33499,3,[twerps]Darkmaster,2463,0,0,2,2,0.0%,50m
33499,3,Pion,2463,0,0,2,2,0.0%,23m
33529,3,Sadie,2462,1209,62,63,125,49.6%,19m
33529,2,chaotix,2462,1133,46,43,89,51.7%,51m
33529,3,Gierad,2462,804,31,28,59,52.5%,10m
33529,3,Sibiryak,2462,702,25,27,52,48.1%,20m
33529,3,[Hyper1]Rocket,2462,423,23,15,38,60.5%,24m
33529,2,oLin,2462,413,17,15,32,53.1%,53m
33529,3,[IZRSI]Samael,2462,371,14,6,20,70.0%,23m
33529,1,Termidor,2462,409,13,20,33,39.4%,43m
33529,2,Doil,2462,387,12,21,33,36.4%,40m
33529,3,happyfish,2462,122,7,10,17,41.2%,3m
33529,2,FaNtiK,2462,191,6,9,15,40.0%,43m
33529,2,DaniStrm,2462,156,6,12,18,33.3%,13m
33529,3,Akella,2462,116,5,7,12,41.7%,25m
33529,2,Ajin,2462,180,5,9,14,35.7%,48m
33529,3,[адик]Люцифер,2462,86,4,3,7,57.1%,2m
33529,3,WIND,2462,114,4,4,8,50.0%,31m
33529,2,[xZero]Hannibal,2462,156,4,8,12,33.3%,45m
33529,1,hiroshiomy,2462,0,3,3,6,50.0%,21m
33529,3,DrMonster,2462,30,3,5,8,37.5%,1h
33529,3,rthw,2462,121,3,6,9,33.3%,4m
33529,3,ClanTiger,2462,86,3,6,9,33.3%,42m
33529,3,BeerKo,2462,95,2,0,2,100.0%,8m
33529,3,Zellion,2462,58,2,2,4,50.0%,41m
33529,3,lukyan,2462,30,2,2,4,50.0%,21m
33529,3,[NBV]VSTAR,2462,30,2,5,7,28.6%,9m
33529,3,[G2theG]Deerados,2462,30,1,3,4,25.0%,24m
33529,3,Lospow,2462,0,1,4,5,20.0%,28m
33529,3,Danille,2462,0,0,1,1,0.0%,15m
33529,1,ravegambler,2462,0,0,1,1,0.0%,26m
33529,3,nicchenicche,2462,0,0,1,1,0.0%,18m
33559,1,Mahar,2461,1576,141,135,276,51.1%,43m
33559,3,Ender,2461,1110,114,113,227,50.2%,2m
33559,2,Serega,2461,1068,40,46,86,46.5%,23m
33559,2,KappaGandalf,2461,870,34,39,73,46.6%,52m
33559,2,[WiLDPW]MouseDubz,2461,701,28,25,53,52.8%,43m
33559,3,FLYNOID,2461,576,26,16,42,61.9%,53m
33559,3,Kaizy,2461,637,25,29,54,46.3%,40m
33559,3,[nCoV]Redwazer,2461,614,21,31,52,40.4%,33m
33559,3,Syl,2461,420,17,8,25,68.0%,25m
33559,3,[Zhig]Timoha,2461,356,14,6,20,70.0%,42m
33559,3,[Heets]timbik,2461,300,11,13,24,45.8%,28m
33559,2,GhostDragon,2461,315,11,13,24,45.8%,10m
33559,3,buyuan,2461,286,10,12,22,45.5%,13m
33559,2,MarBack,2461,118,7,7,14,50.0%,5m
33559,2,SnowPatrol,2461,220,7,12,19,36.8%,52m
33559,3,щщшш,2461,160,6,7,13,46.2%,15m
33559,3,Shwifty,2461,160,5,1,6,83.3%,16m
33559,3,MiniPeludin,2461,165,4,3,7,57.1%,27m
33559,3,Sartori,2461,111,4,4,8,50.0%,33m
33559,3,[Cybro]bestmatxi,2461,121,4,5,9,44.4%,1m
33559,3,Maksien,2461,117,3,0,3,100.0%,1h
33559,1,Kamizash,2461,144,3,1,4,75.0%,51m
33559,1,[PGMR]Boltec,2461,30,3,7,10,30.0%,1h
33559,3,TITO,2461,60,2,2,4,50.0%,39m
33559,2,[XPA]BROMS,2461,30,2,4,6,33.3%,2m
33559,3,Kremenko,2461,58,2,4,6,33.3%,21m
33559,3,Damisau,2461,0,2,5,7,28.6%,53m
33559,3,SkyWalker,2461,97,2,6,8,25.0%,1h
33559,1,Lenin,2461,48,1,2,3,33.3%,12m
33559,3,Doraty,2461,30,1,3,4,25.0%,16m
33559,3,Fortunehunt,2461,30,1,4,5,20.0%,17m
33559,3,nvantu,2461,0,1,4,5,20.0%,1h
33559,3,[злань]PycckuuZerg,2461,0,0,1,1,0.0%,1h
33559,3,Frosch,2461,0,0,5,5,0.0%,35m
33593,2,debre,2460,1547,167,162,329,50.8%,2m
33593,3,Dugi,2460,1573,132,117,249,53.0%,1h
33593,2,ZergEatYou,2460,1155,48,47,95,50.5%,1h
33593,3,[CubRub]Gymnopedie,2460,763,42,25,67,62.7%,8m
33593,3,Mogyi,2460,975,38,36,74,51.4%,31m
33593,3,Selmo,2460,659,31,40,71,43.7%,16m
33593,3,GodStopMe,2460,643,27,18,45,60.0%,42m
33593,3,brisket,2460,638,27,21,48,56.2%,37m
33593,3,Bbaiovou,2460,542,24,17,41,58.5%,4m
33593,3,Pavlus,2460,594,23,26,49,46.9%,51m
33593,3,[Teor]thebotninja,2460,550,21,16,37,56.8%,19m
33593,3,Battosai,2460,475,19,12,31,61.3%,12m
33593,2,Phoenix,2460,418,15,20,35,42.9%,43m
33593,3,КАРАЧУН,2460,291,14,2,16,87.5%,26m
33593,3,[Karuna]Chibs,2460,341,13,5,18,72.2%,16m
33593,3,KanibalCz,2460,243,10,7,17,58.8%,12m
33593,3,MeTeLuK,2460,207,10,8,18,55.6%,10m
33593,2,Stryker,2460,253,10,10,20,50.0%,43m
33593,3,Hobbit,2460,259,9,15,24,37.5%,2m
33593,3,Azunai,2460,254,8,5,13,61.5%,42m
33593,3,sqrl,2460,145,7,3,10,70.0%,43m
33593,2,Retromen,2460,202,7,6,13,53.8%,7m
33593,3,kaban,2460,238,7,6,13,53.8%,50m
33593,3,IBAK,2460,176,7,7,14,50.0%,33m
33593,3,tudi,2460,114,4,5,9,44.4%,10m
33593,3,[ENFO]Livnod,2460,36,4,7,11,36.4%,26m
33593,3,[ГеРоИИ]Герой,2460,117,3,0,3,100.0%,28m
33593,1,Immsen,2460,121,3,12,15,20.0%,34m
33593,3,ЛЮТЫЙСЕКАЧ,2460,30,2,1,3,66.7%,16m
33593,3,Aquatech,2460,30,2,3,5,40.0%,10m
33593,1,lyckegard,2460,0,2,3,5,40.0%,19m
33593,1,[eGo]eGoStalker,2460,0,2,3,5,40.0%,23m
33593,1,Stale,2460,36,2,10,12,16.7%,36m
33593,3,[IYFC]Taipan,2460,0,0,1,1,0.0%,1h
33593,3,Devlo,2460,0,0,1,1,0.0%,10m
33593,3,VoZSo,2460,0,0,2,2,0.0%,31m
33593,3,[RCGS]Voltaire,2460,0,0,3,3,0.0%,13m
33593,3,Norrock,2460,0,0,5,5,0.0%,9m
33631,1,LiviuDanut,2459,1533,171,165,336,50.9%,28m
33631,1,majk,2459,1418,117,121,238,49.2%,1m
33631,2,Marlow,2459,1392,85,77,162,52.5%,20m
33631,3,EFER,2459,1062,46,41,87,52.9%,10m
33631,3,Distortion,2459,998,38,36,74,51.4%,3m
33631,3,Misiek,2459,622,32,23,55,58.2%,7m
33631,2,RezedaSexual,2459,667,30,22,52,57.7%,43m
33631,3,[PiGPan]CJV,2459,141,18,15,33,54.5%,6m
33631,2,ZealOk,2459,294,12,12,24,50.0%,7m
33631,3,[BobiK]Bobik,2459,303,10,9,19,52.6%,1h
33631,2,Riders,2459,148,9,7,16,56.2%,35m
33631,1,Ath,2459,305,8,19,27,29.6%,19m
33631,3,[Vsecs]DeathBringer,2459,106,5,4,9,55.6%,24m
33631,3,xanix,2459,115,5,7,12,41.7%,40m
33631,2,ZeratustRA,2459,154,3,2,5,60.0%,1m
33631,3,[SPAINs]FeniX,2459,90,3,5,8,37.5%,21m
33631,2,Ilativ,2459,0,2,5,7,28.6%,5m
33631,2,NoFlakes,2459,0,2,5,7,28.6%,1h
33631,3,krabs,2459,0,1,0,1,100.0%,42m
33631,1,MarS,2459,0,1,4,5,20.0%,47m
33651,1,[BZSS]Lazard,2458,1590,207,240,447,46.3%,9m
33651,3,Matthias,2458,333,54,48,102,52.9%,50m
33651,3,Tassadare,2458,875,39,29,68,57.4%,1h
33651,3,patriarch,2458,763,32,27,59,54.2%,10m
33651,2,Михаил,2458,514,31,39,70,44.3%,13m
33651,3,Untamo,2458,759,30,25,55,54.5%,39m
33651,3,[AnReal]deni,2458,734,27,22,49,55.1%,20m
33651,3,stefano,2458,638,22,27,49,44.9%,48m
33651,3,faker,2458,462,16,20,36,44.4%,1h
33651,3,Ovilex,2458,316,13,5,18,72.2%,40m
33651,2,victor,2458,255,12,17,29,41.4%,43m
33651,3,[TRÉBO]Frylia,2458,232,9,10,19,47.4%,48m
33651,3,sasha,2458,198,8,8,16,50.0%,31m
33651,2,Magus,2458,200,7,14,21,33.3%,13m
33651,3,SEvER,2458,185,6,3,9,66.7%,30m
33651,3,Ragno,2458,188,6,3,9,66.7%,12m
33651,3,Irvine,2458,177,6,8,14,42.9%,21m
33651,1,Frogen,2458,110,5,5,10,50.0%,36m
33651,3,Loco,2458,148,3,5,8,37.5%,13m
33651,3,Stacky,2458,30,3,6,9,33.3%,53m
33651,3,Zagri,2458,135,3,7,10,30.0%,25m
33651,3,PartyPancake,2458,118,2,2,4,50.0%,10m
33651,3,Latta,2458,121,2,2,4,50.0%,43m
33651,1,Borjacrak,2458,0,2,3,5,40.0%,35m
33651,3,gabaxoloco,2458,38,2,3,5,40.0%,36m
33651,3,[LQV]Sanguine,2458,60,2,3,5,40.0%,13m
33651,3,Razvanov,2458,60,2,4,6,33.3%,1h
33651,1,CHONILOBO,2458,97,2,4,6,33.3%,43m
33651,1,[DLSCII]DarkStranger,2458,97,2,5,7,28.6%,21m
33651,3,NastyHorse,2458,0,1,0,1,100.0%,13m
33651,3,ElPhantus,2458,0,1,1,2,50.0%,24m
33651,1,[kunte]hasde,2458,0,1,1,2,50.0%,27m
33651,3,StEfZoR,2458,97,1,1,2,50.0%,15m
33651,2,[Рубль]MukaZuka,2458,0,1,2,3,33.3%,22m
33651,3,[BOXING]TySoN,2458,0,0,2,2,0.0%,38m
33686,1,[TedB]DarkSunGwyn,2457,1583,614,584,1198,51.3%,43m
33686,3,Murzilkin,2457,1522,193,186,379,50.9%,13m
33686,2,Radek,2457,1418,118,118,236,50.0%,39m
33686,3,dreya,2457,571,55,44,99,55.6%,7m
33686,2,nHawk,2457,1255,48,49,97,49.5%,43m
33686,3,QuarantinO,2457,910,37,33,70,52.9%,18m
33686,3,Woplex,2457,756,35,31,66,53.0%,40m
33686,3,Zardoz,2457,726,26,27,53,49.1%,38m
33686,3,СЕРАФИМ,2457,580,25,12,37,67.6%,32m
33686,3,ТАЩУМБА,2457,583,23,21,44,52.3%,20m
33686,3,FleX,2457,416,16,15,31,51.6%,42m
33686,3,Alexey,2457,337,14,21,35,40.0%,35m
33686,2,Namiro,2457,346,13,14,27,48.1%,37m
33686,2,IrMa,2457,319,13,15,28,46.4%,1h
33686,2,[WesP]Wishman,2457,300,12,15,27,44.4%,49m
33686,3,[Sw0rm]DarkZergling,2457,166,7,6,13,53.8%,5m
33686,3,Screwspark,2457,171,5,3,8,62.5%,17m
33686,1,sebburone,2457,88,5,4,9,55.6%,17m
33686,3,Yakuchi,2457,169,4,6,10,40.0%,28m
33686,1,kuku,2457,136,4,17,21,19.0%,28m
33686,2,Wasabik,2457,168,3,5,8,37.5%,6m
33686,2,[SCED]ODOL,2457,0,2,4,6,33.3%,1h
33686,3,LoitneR,2457,97,1,2,3,33.3%,49m
33686,2,Nankarai,2457,0,1,2,3,33.3%,29m
33686,1,NAV,2457,0,1,4,5,20.0%,33m
33686,1,Jones,2457,0,1,4,5,20.0%,53m
33686,2,meepmeep,2457,42,1,5,6,16.7%,43m
33686,3,LaDobleC,2457,0,0,1,1,0.0%,19m
33686,3,Инфэстос,2457,0,0,1,1,0.0%,7m
33686,3,zephyr,2457,0,0,1,1,0.0%,17m
33686,3,BahmanB,2457,0,0,2,2,0.0%,25m
33717,3,peace,2456,1497,238,230,468,50.9%,40m
33717,2,Kris,2456,491,157,152,309,50.8%,14m
33717,3,Phenomenon,2456,1509,139,146,285,48.8%,4m
33717,2,ThreeTeil,2456,952,62,62,124,50.0%,20m
33717,2,[ClSq]Ислам,2456,1180,58,52,110,52.7%,1h
33717,3,Mastadoc,2456,1212,57,54,111,51.4%,8m
33717,3,[URANGG]Kunde,2456,767,45,44,89,50.6%,1h
33717,3,[BNLx2]MarcLawrence,2456,1073,44,41,85,51.8%,33m
33717,3,Stian,2456,1042,43,41,84,51.2%,20m
33717,2,[GerAM]KAMI,2456,908,42,28,70,60.0%,30m
33717,2,borshosh,2456,955,42,37,79,53.2%,32m
33717,3,[Nugket]Bonano,2456,963,39,37,76,51.3%,24m
33717,2,mirage,2456,849,35,31,66,53.0%,1h
33717,3,LEKSO,2456,897,34,29,63,54.0%,9m
33717,3,DIMON,2456,749,31,23,54,57.4%,46m
33717,2,andrioso,2456,196,29,30,59,49.2%,5m
33717,2,Unicorn,2456,173,26,21,47,55.3%,47m
33717,3,Jkolo,2456,382,20,6,26,76.9%,26m
33717,3,GunGanVor,2456,524,20,23,43,46.5%,48m
33717,3,SiiG,2456,454,18,18,36,50.0%,1h
33717,3,Tat,2456,346,16,17,33,48.5%,32m
33717,3,Laziz,2456,418,16,18,34,47.1%,1h
33717,3,СТРЭЙК,2456,354,14,8,22,63.6%,1h
33717,3,[страх]JackOfShadow,2456,332,14,16,30,46.7%,17m
33717,2,HoobНУБ,2456,342,12,19,31,38.7%,6m
33717,2,IIIUHAULIII,2456,206,9,6,15,60.0%,17m
33717,3,janiwokosztc,2456,207,8,4,12,66.7%,1h
33717,1,GBosh,2456,266,8,12,20,40.0%,1h
33717,3,stevo,2456,212,7,3,10,70.0%,1h
33717,3,[TSDS]ShadowLink,2456,197,7,8,15,46.7%,52m
33717,3,Prophet,2456,129,6,4,10,60.0%,4m
33717,3,[luxorx]xLUXORx,2456,218,6,9,15,40.0%,48m
33717,3,Cranium,2456,183,5,5,10,50.0%,48m
33717,1,Techies,2456,119,5,10,15,33.3%,50m
33717,3,Beorn,2456,90,4,4,8,50.0%,26m
33717,3,CaptainLippy,2456,118,4,7,11,36.4%,21m
33717,3,Woosch,2456,110,3,1,4,75.0%,1h
33717,3,[ATSX]RebelEagle,2456,0,3,2,5,60.0%,34m
33717,3,ТиТ,2456,0,1,0,1,100.0%,28m
33717,3,daveballant,2456,0,1,0,1,100.0%,38m
33717,1,Hallas,2456,0,1,5,6,16.7%,35m
33717,3,serafim,2456,0,0,1,1,0.0%,36m
33717,3,jeny,2456,0,0,1,1,0.0%,4m
33717,3,Auswahlliste,2456,0,0,1,1,0.0%,23m
33717,3,[baker]Maturin,2456,0,0,1,1,0.0%,33m
33717,3,cacapornXD,2456,0,0,1,1,0.0%,46m
33717,3,HrWeise,2456,0,0,1,1,0.0%,8m
33717,3,John,2456,0,0,3,3,0.0%,19m
33765,2,MMtB,2455,1102,68,59,127,53.5%,5m
33765,2,Charlox,2455,1313,58,50,108,53.7%,7m
33765,2,Honter,2455,1000,42,37,79,53.2%,48m
33765,3,Nobik,2455,719,29,21,50,58.0%,1h
33765,3,Haosit,2455,592,24,20,44,54.5%,12m
33765,1,jichael,2455,556,24,28,52,46.2%,17m
33765,3,AntiQuesno,2455,478,19,24,43,44.2%,32m
33765,2,thusinutz,2455,504,17,27,44,38.6%,14m
33765,3,nejab,2455,437,16,12,28,57.1%,1h
33765,2,Quken,2455,339,14,23,37,37.8%,12m
33765,1,rottenorange,2455,250,9,13,22,40.9%,43m
33765,3,OldTerran,2455,146,6,7,13,46.2%,1h
33765,3,Behlulefendi,2455,184,6,8,14,42.9%,1h
33765,3,[ICCCPI]Dgon,2455,92,6,11,17,35.3%,7m
33765,3,[PrTons]kelesha,2455,182,5,2,7,71.4%,13m
33765,3,Beaubeste,2455,144,4,1,5,80.0%,1m
33765,3,[Floren]ACR,2455,145,4,1,5,80.0%,13m
33765,3,MrT,2455,0,4,1,5,80.0%,17m
33765,3,stardin,2455,145,4,5,9,44.4%,25m
33765,3,Vazec,2455,90,4,6,10,40.0%,48m
33765,3,[Gоld]AlexRaisky,2455,117,3,0,3,100.0%,23m
33765,1,NaDno,2455,97,2,4,6,33.3%,51m
33765,1,Jay,2455,48,2,5,7,28.6%,31m
33765,2,irBus,2455,132,2,6,8,25.0%,19m
33765,3,DICK,2455,0,2,6,8,25.0%,1h
33765,3,IIIIIIIIIIII,2455,0,1,1,2,50.0%,1h
33765,1,Levi,2455,0,1,4,5,20.0%,26m
33765,3,antxon,2455,0,1,4,5,20.0%,42m
33765,1,DImAX,2455,0,0,1,1,0.0%,39m
33765,2,[Shneg]KybOrk,2455,0,0,1,1,0.0%,10m
33765,3,Thursday,2455,0,0,2,2,0.0%,43m
33765,1,jodead,2455,0,0,4,4,0.0%,30m
33797,2,ANTONY,2454,1548,721,705,1426,50.6%,51m
33797,2,AvatarDrew,2454,1555,356,353,709,50.2%,23m
33797,3,[E5X]noobAsRock,2454,984,44,36,80,55.0%,1h
33797,2,Mentalist,2454,143,38,37,75,50.7%,25m
33797,3,[QaDo]predator,2454,754,30,22,52,57.7%,23m
33797,3,[SEWP]STALKER,2454,416,17,17,34,50.0%,32m
33797,3,Reksais,2454,419,16,11,27,59.3%,36m
33797,3,luisito,2454,336,14,17,31,45.2%,10m
33797,1,Irodian,2454,432,14,24,38,36.8%,11m
33797,3,LxBarker,2454,210,8,10,18,44.4%,10m
33797,3,[OverX]Стронг,2454,201,6,3,9,66.7%,39m
33797,3,SiVisPacem,2454,147,6,5,11,54.5%,2m
33797,3,LoSs,2454,152,6,7,13,46.2%,8m
33797,2,[CaLe]Snowkills,2454,107,5,5,10,50.0%,32m
33797,2,THEVECTOR,2454,130,4,8,12,33.3%,41m
33797,3,Boudyiou,2454,116,3,1,4,75.0%,48m
33797,1,pampadores,2454,44,3,8,11,27.3%,13m
33797,2,Peur,2454,144,3,9,12,25.0%,34m
33797,3,webkrilya,2454,30,2,2,4,50.0%,5m
33797,3,Bryn,2454,30,2,4,6,33.3%,15m
33797,3,[Dobro]Trigger,2454,0,2,8,10,20.0%,2m
33797,3,Гдетыбыл,2454,0,1,0,1,100.0%,12m
33797,1,KIERON,2454,46,1,3,4,25.0%,30m
33797,1,[MILOS]Dream,2454,48,1,3,4,25.0%,30m
33797,3,лёха,2454,0,1,4,5,20.0%,6m
33797,3,Сергей,2454,30,1,7,8,12.5%,21m
33797,3,[0MaG0]Alexandros,2454,30,1,9,10,10.0%,33m
33797,3,elderanakain,2454,0,0,1,1,0.0%,31m
33825,2,KPbICOKAH,2453,1583,780,777,1557,50.1%,1m
33825,3,Maryen,2453,1499,95,87,182,52.2%,8m
33825,2,georgebro,2453,600,35,28,63,55.6%,34m
33825,3,MKrash,2453,719,30,33,63,47.6%,23m
33825,3,Dobby,2453,624,26,24,50,52.0%,26m
33825,3,Apocalypse,2453,425,22,4,26,84.6%,26m
33825,3,scooter,2453,506,17,21,38,44.7%,33m
33825,3,[NukeZ]DarkenersNEO,2453,214,7,5,12,58.3%,35m
33825,3,Leopard,2453,183,6,8,14,42.9%,41m
33825,3,[RBcom]Steelpanther,2453,175,5,3,8,62.5%,39m
33825,3,Zerbekes,2453,120,5,4,9,55.6%,15m
33825,3,NueZOnE,2453,92,3,6,9,33.3%,10m
33825,3,Octavius,2453,58,2,3,5,40.0%,20m
33825,3,[S3X3]Taz,2453,96,2,3,5,40.0%,37m
33825,1,KimmyBlack,2453,0,2,3,5,40.0%,6m
33825,3,Vaddi,2453,60,2,4,6,33.3%,1h
33825,1,ГРАФ,2453,0,2,6,8,25.0%,43m
33825,3,Drakon,2453,0,1,1,2,50.0%,1h
33825,3,Sethrottle,2453,0,1,4,5,20.0%,48m
33825,1,[DNGR]ĐăƦķŋƐƺƾ,2453,48,1,6,7,14.3%,19m
33825,2,Shikaren,2453,0,1,10,11,9.1%,1h
33825,3,KimJongBoom,2453,0,0,1,1,0.0%,12m
33825,1,sergivs,2453,0,0,2,2,0.0%,35m
33825,1,semkiert,2453,0,0,2,2,0.0%,44m
33825,3,Dags,2453,0,0,3,3,0.0%,31m
33850,2,globby,2452,1517,175,168,343,51.0%,51m
33850,3,DeepElite,2452,1263,133,123,256,52.0%,28m
33850,3,PhiLLoOne,2452,1519,93,82,175,53.1%,19m
33850,3,TeT,2452,1556,66,58,124,53.2%,4m
33850,2,Barthun,2452,801,44,42,86,51.2%,53m
33850,3,Страшный,2452,529,31,28,59,52.5%,15m
33850,3,Ionus,2452,233,28,24,52,53.8%,17m
33850,1,Cartel,2452,741,26,27,53,49.1%,34m
33850,3,[2DNeko]Artorias,2452,479,20,10,30,66.7%,21m
33850,3,Stevennus,2452,391,20,14,34,58.8%,25m
33850,2,maroiusd,2452,474,17,23,40,42.5%,50m
33850,3,Laponkio,2452,418,15,22,37,40.5%,2m
33850,3,NikerGuns,2452,422,14,11,25,56.0%,52m
33850,2,MiniTitan,2452,317,13,15,28,46.4%,20m
33850,3,[Seek]martin,2452,326,12,14,26,46.2%,20m
33850,2,Tock,2452,246,9,9,18,50.0%,1h
33850,3,Forward,2452,191,8,6,14,57.1%,43m
33850,3,cawa,2452,206,8,7,15,53.3%,35m
33850,3,Daniel,2452,206,7,10,17,41.2%,24m
33850,3,TheSnya,2452,118,5,6,11,45.5%,50m
33850,3,[SPAINs]Fiktorr,2452,169,5,7,12,41.7%,48m
33850,3,Xristi,2452,169,5,8,13,38.5%,40m
33850,2,GrafRucola,2452,144,5,8,13,38.5%,36m
33850,3,Laiko,2452,95,4,2,6,66.7%,20m
33850,1,nYkke,2452,96,4,5,9,44.4%,14m
33850,3,MoloDchiK,2452,60,3,2,5,60.0%,21m
33850,1,dropitdragon,2452,96,3,5,8,37.5%,29m
33850,3,Tsunami,2452,121,2,2,4,50.0%,1h
33850,1,[Sivir]Fipo,2452,0,2,4,6,33.3%,26m
33850,3,mAxlOw,2452,96,2,5,7,28.6%,42m
33850,3,[VSCODE]Begothen,2452,0,1,0,1,100.0%,31m
33850,3,kitkat,2452,0,1,0,1,100.0%,19m
33850,1,[SkBG]BojowyRopuch,2452,0,1,1,2,50.0%,47m
33850,3,ScarneX,2452,0,1,1,2,50.0%,40m
33850,2,Dashling,2452,0,1,2,3,33.3%,15m
33850,3,ToxKayzer,2452,0,1,4,5,20.0%,1h
33850,2,SpartaKook,2452,30,1,8,9,11.1%,51m
33850,3,Hotshot,2452,0,0,1,1,0.0%,48m
33850,3,[ЗЕRGТV]Arhei,2452,0,0,1,1,0.0%,40m
33850,3,bananasplit,2452,0,0,3,3,0.0%,35m
33850,1,Asvan,2452,0,0,4,4,0.0%,19m
33891,1,Kollioid,2451,1412,221,212,433,51.0%,37m
33891,2,Drago,2451,1531,136,123,259,52.5%,21m
33891,2,drics,2451,1128,75,78,153,49.0%,28m
33891,3,EsAnderst,2451,1163,66,53,119,55.5%,31m
33891,2,[niCOno]Nicolas,2451,883,64,56,120,53.3%,13m
33891,3,becalm,2451,694,43,39,82,52.4%,31m
33891,3,NTech,2451,966,40,39,79,50.6%,51m
33891,3,GaEsEx,2451,896,36,34,70,51.4%,1h
33891,3,kwahaha,2451,762,33,32,65,50.8%,32m
33891,3,Lesshii,2451,531,30,37,67,44.8%,48m
33891,3,Krafter,2451,586,22,27,49,44.9%,20m
33891,3,Vlad,2451,527,20,18,38,52.6%,10m
33891,3,elturko,2451,445,16,17,33,48.5%,1h
33891,3,Sergo,2451,394,15,15,30,50.0%,10m
33891,3,Kresen,2451,299,13,7,20,65.0%,28m
33891,2,makenot,2451,307,12,20,32,37.5%,11m
33891,3,Тирано,2451,294,11,12,23,47.8%,37m
33891,3,DIVERHACKER,2451,295,10,12,22,45.5%,23m
33891,1,AlexandrSTG,2451,238,9,15,24,37.5%,51m
33891,3,[DRUГS]Шмалиса,2451,180,7,10,17,41.2%,16m
33891,3,RegularStrat,2451,172,6,8,14,42.9%,13m
33891,2,kaboom,2451,182,6,14,20,30.0%,7m
33891,2,Andrei,2451,144,5,15,20,25.0%,14m
33891,2,[SeVenV]planakin,2451,129,4,1,5,80.0%,33m
33891,1,MATU,2451,97,2,4,6,33.3%,31m
33891,3,warkis,2451,0,2,5,7,28.6%,45m
33891,3,TLP,2451,0,2,5,7,28.6%,7m
33891,3,KHIRUSTEA,2451,30,1,3,4,25.0%,40m
33891,1,Bison,2451,0,1,4,5,20.0%,53m
33891,3,ФедяКарманов,2451,0,0,1,1,0.0%,46m
33921,2,RaptorBUCA,2450,925,111,107,218,50.9%,37m
33921,2,CorolJab,2450,761,28,29,57,49.1%,19m
33921,3,mustahsen,2450,595,24,27,51,47.1%,1h
33921,1,Acidjunky,2450,594,23,26,49,46.9%,19m
33921,3,Techmate,2450,371,15,10,25,60.0%,19m
33921,2,Mars,2450,407,14,20,34,41.2%,1h
33921,3,Deyn,2450,352,12,8,20,60.0%,1h
33921,3,[лунааа]taldarim,2450,187,10,6,16,62.5%,51m
33921,2,Cplnabb,2450,64,10,14,24,41.7%,20m
33921,1,[U9corn]Treble,2450,212,7,11,18,38.9%,1h
33921,3,Kara,2450,142,4,2,6,66.7%,38m
33921,3,Melfalathion,2450,90,4,3,7,57.1%,39m
33921,3,IntWoG,2450,155,3,5,8,37.5%,21m
33921,1,Андрей,2450,48,2,0,2,100.0%,43m
33921,3,Danieli,2450,60,2,1,3,66.7%,33m
33921,3,PAEY,2450,34,2,5,7,28.6%,25m
33921,2,Corowick,2450,0,2,5,7,28.6%,30m
33921,3,ReinaR,2450,0,1,0,1,100.0%,1h
33921,3,DobrO,2450,97,1,2,3,33.3%,32m
33921,3,[WÖLFE]jkerCrusher,2450,0,1,4,5,20.0%,37m
33921,3,vitaliy,2450,30,1,5,6,16.7%,20m
33921,3,killer,2450,0,0,1,1,0.0%,13m
33921,3,Robert,2450,0,0,1,1,0.0%,42m
33944,2,nexus,2449,1609,256,263,519,49.3%,29m
33944,3,Жека,2449,1378,105,116,221,47.5%,19m
33944,3,xXBenja,2449,518,64,56,120,53.3%,15m
33944,3,Robby,2449,1210,52,57,109,47.7%,23m
33944,2,Snigel,2449,358,42,36,78,53.8%,47m
33944,2,Blurlover,2449,908,39,46,85,45.9%,5m
33944,3,Arekku,2449,833,38,21,59,64.4%,1h
33944,3,papaichonok,2449,853,38,24,62,61.3%,52m
33944,2,corvusarpa,2449,643,24,26,50,48.0%,1h
33944,1,kirk,2449,693,23,35,58,39.7%,25m
33944,3,ZibelBobel,2449,288,11,11,22,50.0%,13m
33944,3,Kolaczke,2449,182,10,1,11,90.9%,12m
33944,1,EwokuChan,2449,308,10,15,25,40.0%,36m
33944,2,MrDinamo,2449,229,8,6,14,57.1%,21m
33944,2,[1squad]alexzero,2449,224,8,13,21,38.1%,42m
33944,3,[PUDDI]kevingamer,2449,144,6,5,11,54.5%,1h
33944,3,GAJOS,2449,0,4,4,8,50.0%,24m
33944,3,JustAnOldGuy,2449,119,4,4,8,50.0%,26m
33944,3,Zvereff,2449,111,4,6,10,40.0%,10m
33944,1,pompom,2449,48,3,5,8,37.5%,1h
33944,3,getost,2449,42,3,6,9,33.3%,45m
33944,1,[TRDP]fran,2449,66,3,10,13,23.1%,8m
33944,3,Frisck,2449,89,2,1,3,66.7%,34m
33944,3,Fenders,2449,30,2,5,7,28.6%,32m
33944,3,DoDikKiss,2449,0,1,0,1,100.0%,13m
33944,3,NekiT,2449,96,1,1,2,50.0%,26m
33944,1,YingFan,2449,97,1,5,6,16.7%,19m
33944,3,Luktatsuper,2449,0,1,5,6,16.7%,21m
33944,3,Wind,2449,0,0,1,1,0.0%,10m
33944,3,Templarist,2449,0,0,2,2,0.0%,10m
33944,3,[PÂRłAH]KUMI,2449,0,0,2,2,0.0%,1h
33944,3,Pashtet,2449,0,0,2,2,0.0%,3m
33976,3,Holo,2448,1328,51,45,96,53.1%,20m
33976,3,Fairfis,2448,628,33,30,63,52.4%,32m
33976,3,KuJIJIep,2448,563,23,13,36,63.9%,12m
33976,3,georgij,2448,526,22,16,38,57.9%,6m
33976,3,[SLPRY]HGbeatnik,2448,221,22,17,39,56.4%,51m
33976,2,AnimeN,2448,536,18,24,42,42.9%,16m
33976,2,Петька,2448,291,14,19,33,42.4%,44m
33976,2,Lurkas,2448,302,13,17,30,43.3%,52m
33976,2,hybride,2448,218,8,14,22,36.4%,46m
33976,3,Siwy,2448,206,7,5,12,58.3%,42m
33976,3,IoannSahin,2448,178,7,6,13,53.8%,24m
33976,3,DragoSaD,2448,236,7,9,16,43.8%,13m
33976,3,TenienteDan,2448,224,7,11,18,38.9%,21m
33976,3,Ephe,2448,197,6,1,7,85.7%,28m
33976,3,Naffy,2448,172,6,3,9,66.7%,52m
33976,3,[RBP3]Lynx,2448,118,5,6,11,45.5%,19m
33976,3,Mentos,2448,159,5,7,12,41.7%,35m
33976,3,MiniPouce,2448,0,4,4,8,50.0%,16m
33976,3,ALPJUAN,2448,137,3,2,5,60.0%,13m
33976,1,Torgos,2448,169,3,2,5,60.0%,21m
33976,3,DANTE,2448,70,3,3,6,50.0%,35m
33976,3,Nick,2448,55,3,4,7,42.9%,13m
33976,2,[ELKTRA]Max,2448,0,3,4,7,42.9%,1h
33976,2,Slider,2448,146,3,8,11,27.3%,6m
33976,3,YourEnd,2448,95,2,0,2,100.0%,5m
33976,3,IIIIIIIIIII,2448,30,2,5,7,28.6%,16m
33976,3,Gamanataud,2448,0,2,5,7,28.6%,38m
33976,3,IIIIIIIIIIII,2448,0,1,1,2,50.0%,20m
33976,3,[VPВenQ]Dragon,2448,0,1,2,3,33.3%,13m
33976,3,Jesuke,2448,30,1,3,4,25.0%,6m
33976,3,[KOGR]PnDaMaN,2448,30,1,6,7,14.3%,52m
33976,3,Fantom,2448,0,1,7,8,12.5%,29m
33976,3,Dowakeen,2448,0,0,1,1,0.0%,1h
33976,1,Oxygen,2448,0,0,1,1,0.0%,31m
33976,3,Dischi,2448,0,0,1,1,0.0%,13m
34011,2,ABSCII,2447,848,152,147,299,50.8%,1m
34011,2,Wigen,2447,1357,95,97,192,49.5%,1h
34011,3,Bottrump,2447,1324,72,56,128,56.2%,39m
34011,2,МалышKid,2447,1535,59,58,117,50.4%,44m
34011,2,Kirian,2447,1275,54,58,112,48.2%,40m
34011,3,Slipstream,2447,629,52,47,99,52.5%,42m
34011,2,ZastyHeide,2447,1045,42,46,88,47.7%,23m
34011,3,[KON]HammerFall,2447,637,29,17,46,63.0%,2m
34011,3,[lZornG]Rambazamba,2447,637,23,20,43,53.5%,1h
34011,3,AntJ,2447,612,21,23,44,47.7%,21m
34011,2,EvilSaunaMan,2447,672,21,33,54,38.9%,52m
34011,3,Nikolas,2447,345,12,9,21,57.1%,52m
34011,3,ShadowStorm,2447,148,8,8,16,50.0%,7m
34011,3,SAIRO,2447,204,8,8,16,50.0%,31m
34011,2,[DiRE]ANTITROL,2447,172,7,11,18,38.9%,43m
34011,3,Semlog,2447,232,6,7,13,46.2%,24m
34011,3,[scp3]bertnard,2447,120,5,45,50,10.0%,9m
34011,3,slowreact,2447,172,4,5,9,44.4%,24m
34011,1,Петрович,2447,158,4,6,10,40.0%,16m
34011,3,generalY,2447,159,4,8,12,33.3%,12m
34011,3,ReturnValue,2447,117,3,4,7,42.9%,32m
34011,3,Hunter,2447,62,3,5,8,37.5%,31m
34011,3,[HMarch]CiRkYl,2447,88,3,9,12,25.0%,1h
34011,1,HIko,2447,96,2,2,4,50.0%,21m
34011,3,[CОS]лёха,2447,30,2,2,4,50.0%,26m
34011,1,PastOr,2447,0,2,4,6,33.3%,1h
34011,3,Kitty,2447,0,1,0,1,100.0%,37m
34011,3,kesik,2447,95,1,1,2,50.0%,5m
34011,3,Supermanu,2447,0,1,2,3,33.3%,5m
34011,3,IngvarRai,2447,0,1,3,4,25.0%,17m
34011,1,Ace,2447,0,1,4,5,20.0%,1h
34011,3,fanta,2447,0,0,1,1,0.0%,24m
34011,3,Dolrog,2447,0,0,2,2,0.0%,18m
34011,3,Chaquiflatul,2447,0,0,4,4,0.0%,10m
34045,2,kane,2446,1617,494,493,987,50.1%,45m
34045,2,[BliTau]Octane,2446,1290,54,54,108,50.0%,41m
34045,1,Langred,2446,616,31,37,68,45.6%,1m
34045,3,[ClDlN]Langeweile,2446,682,26,20,46,56.5%,20m
34045,2,[музклу]makckrai,2446,674,26,28,54,48.1%,3m
34045,2,Sai,2446,752,26,35,61,42.6%,35m
34045,3,[Allakh]Sauge,2446,546,23,11,34,67.6%,20m
34045,2,[Starzi]BugleBoy,2446,356,15,18,33,45.5%,38m
34045,3,[INAE]Charon,2446,385,15,19,34,44.1%,39m
34045,1,grion,2446,326,13,17,30,43.3%,48m
34045,3,LicentiA,2446,211,9,7,16,56.2%,4m
34045,3,Lilalaunebär,2446,164,9,17,26,34.6%,34m
34045,3,[842703]Jacek,2446,217,8,3,11,72.7%,48m
34045,3,slonara,2446,138,7,10,17,41.2%,32m
34045,2,nosferatu,2446,254,7,12,19,36.8%,1h
34045,3,Lemon,2446,142,6,3,9,66.7%,26m
34045,3,AllA,2446,172,6,8,14,42.9%,34m
34045,2,Enne,2446,149,5,5,10,50.0%,40m
34045,3,Grondotter,2446,118,5,7,12,41.7%,42m
34045,3,Majkls,2446,148,4,7,11,36.4%,50m
34045,3,Autotret,2446,115,3,0,3,100.0%,32m
34045,3,Lesandr,2446,139,3,2,5,60.0%,31m
34045,3,Gonca,2446,145,3,7,10,30.0%,38m
34045,3,Gasha,2446,96,2,0,2,100.0%,17m
34045,1,Jimtrenor,2446,48,2,0,2,100.0%,30m
34045,3,[ZERGTV]Gans,2446,97,2,1,3,66.7%,33m
34045,3,Fiky,2446,95,2,5,7,28.6%,35m
34045,3,Holmen,2446,96,2,5,7,28.6%,13m
34045,3,XrayDok,2446,97,2,6,8,25.0%,9m
34045,3,LosGorros,2446,0,2,6,8,25.0%,39m
34045,3,Alpha,2446,0,1,0,1,100.0%,48m
34045,3,MasterK,2446,88,1,1,2,50.0%,1h
34045,3,[59APM]Cepera,2446,0,1,2,3,33.3%,2m
34045,3,sdOrange,2446,0,0,1,1,0.0%,8m
34079,3,Twatfink,2445,1337,136,129,265,51.3%,21m
34079,3,Yougooo,2445,1559,106,89,195,54.4%,48m
34079,3,ZanyZealot,2445,1509,64,61,125,51.2%,13m
34079,3,NightLight,2445,958,46,42,88,52.3%,15m
34079,3,ChecPufos,2445,847,38,30,68,55.9%,15m
34079,1,[UTilt]Mercury,2445,960,37,38,75,49.3%,37m
34079,3,[SAoN]nightknight,2445,610,27,18,45,60.0%,31m
34079,2,BOSS,2445,692,26,26,52,50.0%,6m
34079,2,Ferry,2445,554,22,27,49,44.9%,3m
34079,1,QdiFly,2445,534,18,34,52,34.6%,1m
34079,3,marine,2445,267,17,15,32,53.1%,15m
34079,3,Gorgoni,2445,357,12,9,21,57.1%,1h
34079,3,Arkdias,2445,201,6,3,9,66.7%,1h
34079,1,DENDY,2445,144,6,13,19,31.6%,16m
34079,3,PheoniX,2445,185,5,2,7,71.4%,48m
34079,3,Eteist,2445,189,5,6,11,45.5%,42m
34079,3,IlIlIlIlIlIl,2445,189,5,7,12,41.7%,36m
34079,2,[luxdd]Gupu,2445,152,5,7,12,41.7%,44m
34079,3,Sklass,2445,144,5,9,14,35.7%,24m
34079,3,[HRD]Hasherino,2445,144,4,6,10,40.0%,3m
34079,3,Yaniox,2445,152,4,6,10,40.0%,38m
34079,3,MisterJager,2445,145,3,3,6,50.0%,18m
34079,3,IndianaFox,2445,90,2,2,4,50.0%,13m
34079,3,ART,2445,0,2,3,5,40.0%,40m
34079,2,Goryacho,2445,62,2,9,11,18.2%,47m
34079,3,IIIIIIIIIIII,2445,0,1,0,1,100.0%,10m
34079,3,Serega,2445,0,1,0,1,100.0%,8m
34079,1,DooMMen,2445,0,1,4,5,20.0%,10m
34079,3,kradek,2445,0,1,8,9,11.1%,40m
34079,3,dJuarez,2445,0,0,2,2,0.0%,13m
34109,1,stolexa,2444,1478,311,327,638,48.7%,36m
34109,1,Stuart,2444,1177,121,127,248,48.8%,1h
34109,1,Dell,2444,982,102,96,198,51.5%,29m
34109,3,ZUI,2444,1309,101,103,204,49.5%,52m
34109,3,[FilsDe]kitach,2444,1503,90,80,170,52.9%,46m
34109,3,Ciprian,2444,1504,57,55,112,50.9%,10m
34109,2,[CMArmy]PoyZone,2444,786,44,38,82,53.7%,18m
34109,2,furyfeuille,2444,839,37,32,69,53.6%,1m
34109,3,Titouan,2444,395,28,30,58,48.3%,13m
34109,3,[ThFctr]BlackFactor,2444,546,19,18,37,51.4%,53m
34109,3,[LJD]Hägen,2444,393,15,9,24,62.5%,27m
34109,3,GeneralKotic,2444,332,13,6,19,68.4%,1h
34109,3,RusToll,2444,263,13,9,22,59.1%,6m
34109,2,Sodzisan,2444,410,13,24,37,35.1%,53m
34109,3,[CCG420]ShadyBaby,2444,353,12,14,26,46.2%,21m
34109,3,PopCorn,2444,277,10,5,15,66.7%,1h
34109,2,[iX]TornadoVape,2444,273,10,12,22,45.5%,46m
34109,3,svchost,2444,215,7,9,16,43.8%,21m
34109,2,MrR,2444,194,7,10,17,41.2%,5m
34109,3,FetisoFF,2444,124,5,5,10,50.0%,31m
34109,3,GravyTrain,2444,174,5,6,11,45.5%,19m
34109,1,Alex,2444,0,4,4,8,50.0%,11m
34109,3,RageQuitRudi,2444,114,4,5,9,44.4%,42m
34109,3,kastet,2444,66,4,7,11,36.4%,4m
34109,3,AlphаStar,2444,94,4,10,14,28.6%,21m
34109,2,Chu,2444,140,3,9,12,25.0%,49m
34109,3,mazayus,2444,0,2,3,5,40.0%,6m
34109,3,данил,2444,0,1,1,2,50.0%,2m
34109,1,Rheas,2444,0,1,2,3,33.3%,20m
34109,3,Asur,2444,30,1,5,6,16.7%,20m
34109,1,IlIlIlIlIlIl,2444,97,1,5,6,16.7%,10m
34109,3,[xFRSx]XuuL,2444,0,0,1,1,0.0%,20m
34109,3,Raresvoda,2444,0,0,1,1,0.0%,27m
34109,3,temach,2444,0,0,2,2,0.0%,35m
34143,1,Lakila,2443,1577,146,156,302,48.3%,30m
34143,3,Angermonkey,2443,1308,141,151,292,48.3%,6m
34143,2,DLF,2443,847,127,115,242,52.5%,23m
34143,3,[Белшир]PROdoomin,2443,1412,63,53,116,54.3%,17m
34143,3,Pettersony,2443,949,42,27,69,60.9%,27m
34143,2,ХРЕНОТЕНЬ,2443,879,38,34,72,52.8%,51m
34143,1,Karin,2443,948,37,45,82,45.1%,1h
34143,2,Joker,2443,738,36,30,66,54.5%,13m
34143,1,Turner,2443,990,33,46,79,41.8%,41m
34143,3,khale,2443,707,32,26,58,55.2%,12m
34143,3,[J4E]SilverSurfer,2443,487,28,2,30,93.3%,48m
34143,3,Volrath,2443,680,27,22,49,55.1%,43m
34143,2,JustaLifter,2443,616,23,23,46,50.0%,20m
34143,2,[DHYD]Sziki,2443,594,23,24,47,48.9%,38m
34143,2,Blue,2443,410,17,23,40,42.5%,6m
34143,3,Raynor,2443,283,12,2,14,85.7%,1h
34143,1,almadav,2443,292,10,15,25,40.0%,1h
34143,3,Jannick,2443,235,8,2,10,80.0%,31m
34143,1,Lock,2443,279,7,20,27,25.9%,15m
34143,3,Birdy,2443,187,6,4,10,60.0%,12m
34143,3,hozo,2443,150,5,7,12,41.7%,26m
34143,3,darklink,2443,143,4,2,6,66.7%,39m
34143,2,[TBGeV]Bitspyde,2443,133,4,7,11,36.4%,53m
34143,3,CkviLL,2443,181,4,9,13,30.8%,10m
34143,2,Zerg,2443,158,4,10,14,28.6%,3m
34143,1,BerserkerVX,2443,143,4,14,18,22.2%,6m
34143,3,SEǂLussy,2443,121,3,1,4,75.0%,19m
34143,3,Molodoy,2443,119,3,1,4,75.0%,24m
34143,3,merter,2443,58,3,4,7,42.9%,1h
34143,3,[Inze]Lunam,2443,119,3,7,10,30.0%,48m
34143,3,[SkBG]Kaom,2443,30,2,1,3,66.7%,20m
34143,3,boubou,2443,97,2,1,3,66.7%,40m
34143,3,weakling,2443,118,2,2,4,50.0%,38m
34143,1,[SRC]ttiger,2443,97,2,3,5,40.0%,1h
34143,3,VipMaster,2443,95,2,4,6,33.3%,20m
34143,3,Katrey,2443,0,2,5,7,28.6%,13m
34143,2,[R4Time]MARS,2443,32,2,5,7,28.6%,45m
34143,3,IIIIIIIIIIII,2443,0,1,0,1,100.0%,41m
34143,3,Shan,2443,0,1,1,2,50.0%,35m
34143,1,Darkmonk,2443,0,1,4,5,20.0%,31m
34143,3,Zizou,2443,30,1,7,8,12.5%,43m
34143,3,[nr40]gracken,2443,0,0,1,1,0.0%,19m
34185,3,Homlibus,2442,1578,127,119,246,51.6%,20m
34185,3,Whiteyhead,2442,1117,66,57,123,53.7%,20m
34185,3,Dert,2442,975,38,40,78,48.7%,3m
34185,3,gororik,2442,553,35,32,67,52.2%,24m
34185,1,Sleeper,2442,585,19,28,47,40.4%,16m
34185,3,realllko,2442,486,18,19,37,48.6%,28m
34185,3,FANTASTIC,2442,218,13,8,21,61.9%,21m
34185,3,Veldinar,2442,390,13,14,27,48.1%,10m
34185,3,veron,2442,228,9,12,21,42.9%,3m
34185,3,Gray,2442,154,6,4,10,60.0%,9m
34185,2,nijwons,2442,242,6,13,19,31.6%,1h
34185,3,[SovC]Gathering,2442,120,5,6,11,45.5%,32m
34185,3,ClojureDev,2442,95,4,2,6,66.7%,43m
34185,3,Goldmember,2442,90,4,3,7,57.1%,9m
34185,3,CptPerseus,2442,142,4,7,11,36.4%,13m
34185,3,Irfanoros,2442,72,4,8,12,33.3%,53m
34185,2,Dragonslayer,2442,88,3,5,8,37.5%,47m
34185,2,Vegas,2442,30,3,6,9,33.3%,39m
34185,1,Gruyo,2442,58,2,16,18,11.1%,2m
34185,1,DIMESS,2442,0,1,0,1,100.0%,43m
34185,3,Ric,2442,0,1,0,1,100.0%,1h
34185,3,sallad,2442,0,1,1,2,50.0%,20m
34185,1,MaX,2442,97,1,2,3,33.3%,24m
34185,1,Hanna,2442,0,1,4,5,20.0%,26m
34185,1,ZeredeR,2442,48,1,4,5,20.0%,25m
34185,3,[Papito]carlosAAC,2442,30,1,6,7,14.3%,1h
34185,1,redi,2442,0,0,1,1,0.0%,1h
34185,3,MCS,2442,0,0,1,1,0.0%,42m
34185,3,Todbringer,2442,0,0,1,1,0.0%,1h
34185,3,[AciNoN]Женя,2442,0,0,3,3,0.0%,32m
34215,3,blacbac,2441,1401,58,60,118,49.2%,10m
34215,3,Akrobat,2441,1098,43,38,81,53.1%,1h
34215,3,FreemaN,2441,908,32,38,70,45.7%,1h
34215,3,TanHagen,2441,766,27,31,58,46.6%,1h
34215,3,ZNikita,2441,631,25,23,48,52.1%,28m
34215,3,[DZTK]Valos,2441,598,23,16,39,59.0%,31m
34215,1,Patrick,2441,626,23,29,52,44.2%,41m
34215,3,Evg,2441,560,21,16,37,56.8%,32m
34215,1,Limur,2441,588,19,30,49,38.8%,30m
34215,3,kvothe,2441,408,18,14,32,56.2%,10m
34215,2,RedDevil,2441,460,18,22,40,45.0%,44m
34215,3,SyleNs,2441,350,12,9,21,57.1%,15m
34215,3,VIGITAL,2441,310,12,12,24,50.0%,39m
34215,3,[ImbaG]Putin,2441,293,11,5,16,68.8%,42m
34215,3,NerZhul,2441,292,11,11,22,50.0%,48m
34215,2,[DSK15]Feniks,2441,288,10,16,26,38.5%,15m
34215,3,SxualChcolat,2441,193,9,4,13,69.2%,42m
34215,3,elreplicator,2441,287,9,8,17,52.9%,33m
34215,3,[YpT]matafix,2441,162,6,6,12,50.0%,20m
34215,3,DrVaseline,2441,187,5,9,14,35.7%,2m
34215,1,Saurcroc,2441,48,4,3,7,57.1%,48m
34215,3,Mike,2441,90,4,4,8,50.0%,16m
34215,2,[UA92]Zeigar,2441,127,4,6,10,40.0%,8m
34215,3,KillerBee,2441,90,4,6,10,40.0%,10m
34215,3,Andy,2441,116,3,2,5,60.0%,13m
34215,3,Ampithere,2441,142,3,5,8,37.5%,20m
34215,1,Shadowrun,2441,0,2,1,3,66.7%,18m
34215,3,КСЕНОМОРФ,2441,30,2,1,3,66.7%,10m
34215,3,[TeamDJ]DJTDT,2441,30,2,2,4,50.0%,34m
34215,3,Ostmann,2441,30,2,3,5,40.0%,10m
34215,3,Mitchellson,2441,58,2,4,6,33.3%,10m
34215,1,Mellia,2441,121,2,5,7,28.6%,28m
34215,2,BeggarJohn,2441,134,2,6,8,25.0%,49m
34215,3,JGapes,2441,0,1,0,1,100.0%,2m
34215,3,Koteyka,2441,0,1,0,1,100.0%,1h
34215,3,Constantin,2441,30,1,2,3,33.3%,25m
34215,3,[olive]IIII,2441,30,1,3,4,25.0%,15m
34215,3,GeGegeR,2441,30,1,3,4,25.0%,31m
34215,3,[K0RM2]Agrobot,2441,0,0,1,1,0.0%,1h
34215,3,[17pfff]Marcus,2441,0,0,1,1,0.0%,24m
34215,3,kaminsky,2441,0,0,1,1,0.0%,32m
34215,3,starleader,2441,0,0,2,2,0.0%,32m
34215,3,[ToraGG]Glutenin,2441,0,0,3,3,0.0%,7m
34258,3,noobtactics,2440,1556,221,232,453,48.8%,20m
34258,3,[ArNaQu]mathieu,2440,1491,110,116,226,48.7%,19m
34258,1,Ghaazi,2440,968,105,95,200,52.5%,29m
34258,3,MacAndCheese,2440,1423,50,67,117,42.7%,17m
34258,3,sam,2440,1141,48,46,94,51.1%,1h
34258,3,lucOnajs,2440,529,42,40,82,51.2%,39m
34258,2,STIGOR,2440,740,28,34,62,45.2%,38m
34258,3,GROM,2440,651,24,23,47,51.1%,20m
34258,3,dotse,2440,472,20,20,40,50.0%,1h
34258,3,[Aмун]david,2440,495,19,11,30,63.3%,1h
34258,3,TomecK,2440,538,19,15,34,55.9%,27m
34258,3,HISSO,2440,302,13,4,17,76.5%,27m
34258,3,Ariot,2440,404,13,14,27,48.1%,24m
34258,2,[SkBG]RMER,2440,192,7,17,24,29.2%,47m
34258,1,[tWLs]Loeri,2440,48,5,1,6,83.3%,39m
34258,3,[Ritsu]Borek,2440,0,5,3,8,62.5%,28m
34258,1,Titan,2440,136,5,10,15,33.3%,41m
34258,1,[BArCo]Strelok,2440,118,4,2,6,66.7%,3m
34258,3,ZZaGurd,2440,88,4,4,8,50.0%,35m
34258,3,[Meruz]DemoNiki,2440,58,3,3,6,50.0%,18m
34258,1,AlexXxus,2440,48,2,0,2,100.0%,1h
34258,3,Hornet,2440,30,2,5,7,28.6%,32m
34258,1,rapture,2440,131,2,5,7,28.6%,31m
34258,1,Berg,2440,0,2,6,8,25.0%,36m
34258,3,DITIS,2440,0,1,0,1,100.0%,40m
34258,3,Simsolan,2440,97,1,2,3,33.3%,53m
34258,2,Buia,2440,0,1,6,7,14.3%,20m
34258,1,Elite,2440,0,0,1,1,0.0%,31m
34258,1,[ZeCouZ]hellgast,2440,0,0,1,1,0.0%,31m
34258,3,[TOKER]Grongle,2440,0,0,3,3,0.0%,13m
34288,2,LooPfLaSh,2439,1590,109,101,210,51.9%,2m
34288,2,mariLa,2439,1579,86,85,171,50.3%,3m
34288,2,AdrenalineX,2439,1204,69,70,139,49.6%,43m
34288,3,thegodFather,2439,1161,59,52,111,53.2%,10m
34288,3,Pakard,2439,1221,50,53,103,48.5%,15m
34288,3,narkoteq,2439,1064,40,44,84,47.6%,1h
34288,3,Bennn,2439,623,27,25,52,51.9%,12m
34288,2,Shephiró,2439,538,19,21,40,47.5%,18m
34288,3,BorekKB,2439,476,18,12,30,60.0%,17m
34288,3,iskembeburak,2439,400,15,13,28,53.6%,43m
34288,1,Джон,2439,457,15,16,31,48.4%,21m
34288,3,BraBus,2439,350,11,12,23,47.8%,8m
34288,2,AlexGen,2439,133,6,5,11,54.5%,1h
34288,1,Zloboch,2439,192,6,7,13,46.2%,20m
34288,1,AlphaPulsar,2439,160,6,11,17,35.3%,27m
34288,2,Turambar,2439,90,5,8,13,38.5%,46m
34288,3,Narath,2439,74,4,9,13,30.8%,5m
34288,3,Darwin,2439,122,3,2,5,60.0%,48m
34288,1,Younggunz,2439,48,3,6,9,33.3%,38m
34288,3,Insane,2439,97,3,6,9,33.3%,27m
34288,1,SpaceCow,2439,0,2,2,4,50.0%,15m
34288,1,AMAZING,2439,0,2,3,5,40.0%,1h
34288,1,[EliteX]Peti,2439,123,2,4,6,33.3%,49m
34288,3,Clees,2439,30,2,5,7,28.6%,21m
34288,2,Ктулху,2439,62,2,11,13,15.4%,23m
34288,1,BadmanReturn,2439,0,1,0,1,100.0%,2m
34288,1,нытик,2439,0,0,1,1,0.0%,20m
34288,1,Nikita,2439,0,0,1,1,0.0%,1h
34288,3,Arzh,2439,0,0,2,2,0.0%,10m
34288,3,StrausMag,2439,0,0,3,3,0.0%,1h
34318,2,DVlad,2438,1562,197,202,399,49.4%,1m
34318,1,hibou,2438,1157,101,104,205,49.3%,31m
34318,3,DBFJ,2438,807,60,61,121,49.6%,1h
34318,3,chocoAir,2438,1222,48,42,90,53.3%,13m
34318,1,Tamerlan,2438,794,22,21,43,51.2%,38m
34318,3,Supare,2438,372,18,20,38,47.4%,40m
34318,3,Ghost,2438,481,17,16,33,51.5%,1h
34318,3,Thespis,2438,319,14,18,32,43.8%,13m
34318,3,GrimsDottir,2438,294,12,5,17,70.6%,8m
34318,1,lyublyugame,2438,223,10,2,12,83.3%,16m
34318,3,MZperX,2438,280,9,7,16,56.2%,13m
34318,3,mustBEnice,2438,130,8,7,15,53.3%,48m
34318,3,RAFFLEUR,2438,194,8,8,16,50.0%,31m
34318,3,[NoGy]CrazyFrog,2438,243,7,8,15,46.7%,52m
34318,1,Angus,2438,96,4,4,8,50.0%,43m
34318,3,åååååå,2438,169,4,6,10,40.0%,49m
34318,1,SwankY,2438,193,4,7,11,36.4%,53m
34318,3,[RuLi]Euns,2438,122,2,3,5,40.0%,51m
34318,3,[KDV]krystk,2438,121,2,3,5,40.0%,46m
34318,3,Nostromo,2438,30,2,3,5,40.0%,21m
34318,3,Martishow,2438,30,2,4,6,33.3%,4m
34318,3,catad,2438,0,1,0,1,100.0%,5m
34318,3,Dámonische,2438,0,1,2,3,33.3%,23m
34318,1,Rekho,2438,0,1,4,5,20.0%,20m
34318,1,NICK,2438,0,0,3,3,0.0%,25m
34318,1,[pndjos]NukeMan,2438,0,0,3,3,0.0%,6m
34344,3,[BE4ST]Conrad,2437,1556,95,95,190,50.0%,11m
34344,3,Ryu,2437,1094,45,39,84,53.6%,27m
34344,3,Gwisko,2437,1015,43,41,84,51.2%,41m
34344,2,Emfit,2437,917,36,41,77,46.8%,38m
34344,3,alkor,2437,807,31,28,59,52.5%,16m
34344,3,SwarmGost,2437,654,28,17,45,62.2%,10m
34344,2,[Weedoc]CriticalHaze,2437,466,26,25,51,51.0%,23m
34344,2,ЛаО,2437,419,20,17,37,54.1%,2m
34344,1,Naviedzony,2437,653,18,13,31,58.1%,28m
34344,3,just,2437,308,11,8,19,57.9%,48m
34344,3,[Сlеvеr]Olrin,2437,314,10,8,18,55.6%,42m
34344,1,Fadz,2437,206,5,2,7,71.4%,23m
34344,3,TheWitchKing,2437,90,4,3,7,57.1%,48m
34344,3,Suva,2437,134,4,6,10,40.0%,20m
34344,1,Vitaliy,2437,0,3,2,5,60.0%,27m
34344,3,Lauri,2437,118,3,5,8,37.5%,28m
34344,2,PappaPRO,2437,30,3,6,9,33.3%,30m
34344,2,Magicl,2437,112,2,2,4,50.0%,28m
34344,1,[CRAYZE]Кристина,2437,88,2,2,4,50.0%,1h
34344,1,[Лакерс]Рик,2437,84,2,2,4,50.0%,11m
34344,1,niñopasita,2437,97,2,4,6,33.3%,43m
34344,1,Duckem,2437,48,2,5,7,28.6%,39m
34344,3,Imustwin,2437,0,2,5,7,28.6%,12m
34344,1,Vovan,2437,0,2,6,8,25.0%,6m
34344,1,Barabáš,2437,0,1,0,1,100.0%,39m
34344,1,Jexatron,2437,0,1,0,1,100.0%,6m
34344,3,MrRakalDino,2437,97,1,1,2,50.0%,50m
34344,1,Blaze,2437,0,0,1,1,0.0%,28m
34344,1,Zhenyowski,2437,0,0,1,1,0.0%,9m
34344,3,Thurenmyr,2437,0,0,3,3,0.0%,7m
34374,2,Hunter,2436,1578,137,147,284,48.2%,38m
34374,2,[Тянки]Nikollya,2436,1080,108,107,215,50.2%,1h
34374,1,Andronmaghe,2436,949,47,45,92,51.1%,50m
34374,3,[glhf20]Tigredepijam,2436,1094,40,36,76,52.6%,51m
34374,3,Raptor,2436,717,28,25,53,52.8%,31m
34374,3,[killU]Marineder,2436,555,23,21,44,52.3%,9m
34374,2,ПЁС,2436,616,23,24,47,48.9%,1h
34374,2,BuGATtiKZ,2436,182,19,22,41,46.3%,24m
34374,3,Lexa,2436,437,16,23,39,41.0%,31m
34374,3,IllIIIllIIIl,2436,304,11,16,27,40.7%,32m
34374,2,Manio,2436,300,11,17,28,39.3%,48m
34374,3,LALKoO,2436,291,10,6,16,62.5%,17m
34374,3,marsinator,2436,205,9,9,18,50.0%,20m
34374,2,Triacona,2436,180,9,19,28,32.1%,24m
34374,2,Danil,2436,217,7,8,15,46.7%,7m
34374,2,IIIIIIIIIIII,2436,138,6,12,18,33.3%,30m
34374,2,shadow,2436,144,5,9,14,35.7%,1h
34374,1,Hamaczi,2436,0,3,2,5,60.0%,49m
34374,3,eSeS,2436,142,3,3,6,50.0%,1h
34374,1,[XDE12]TheTrj,2436,97,2,4,6,33.3%,25m
34374,3,valorant,2436,0,2,5,7,28.6%,20m
34374,1,Nemesis,2436,0,1,0,1,100.0%,23m
34374,1,JoraKornev,2436,0,1,4,5,20.0%,9m
34374,1,qiwi,2436,0,1,4,5,20.0%,38m
34374,1,DimoNPanishe,2436,0,1,4,5,20.0%,30m
34374,1,jimiarbas,2436,0,1,4,5,20.0%,32m
34374,1,Dex,2436,0,1,4,5,20.0%,1h
34374,1,ImMoRtAl,2436,0,0,1,1,0.0%,48m
34374,1,frikkey,2436,0,0,1,1,0.0%,34m
34374,1,koda,2436,0,0,1,1,0.0%,41m
34374,1,smiou,2436,0,0,3,3,0.0%,1h
34405,3,QUEPUEG,2435,1483,107,104,211,50.7%,10m
34405,3,[BloTi]eli,2435,1577,93,89,182,51.1%,7m
34405,3,Ситран,2435,859,39,22,61,63.9%,9m
34405,3,YHG,2435,680,25,26,51,49.0%,48m
34405,1,DOOM,2435,569,21,25,46,45.7%,12m
34405,3,jaapr,2435,360,16,15,31,51.6%,20m
34405,2,Kampfknulle,2435,396,15,19,34,44.1%,5m
34405,2,Aivengo,2435,222,15,21,36,41.7%,7m
34405,3,Ultima,2435,321,13,13,26,50.0%,6m
34405,1,Sade,2435,368,12,9,21,57.1%,38m
34405,3,Viper,2435,331,12,10,22,54.5%,33m
34405,3,Delta,2435,277,11,4,15,73.3%,4m
34405,1,semetey,2435,358,9,5,14,64.3%,48m
34405,3,[Ro2]COSTiNDOi,2435,240,8,6,14,57.1%,21m
34405,3,DarkCode,2435,224,8,13,21,38.1%,53m
34405,3,Maxlin,2435,142,5,9,14,35.7%,35m
34405,2,StarkKaiser,2435,152,5,10,15,33.3%,16m
34405,3,[RBMK]Fernando,2435,116,4,8,12,33.3%,3m
34405,2,RavenSiberia,2435,120,4,13,17,23.5%,27m
34405,3,Hipo,2435,145,3,4,7,42.9%,52m
34405,3,килер,2435,30,2,2,4,50.0%,20m
34405,3,GegenDenWind,2435,119,2,3,5,40.0%,35m
34405,1,Semmel,2435,48,2,6,8,25.0%,31m
34405,1,BestChampion,2435,0,1,0,1,100.0%,1h
34405,3,spark,2435,40,1,2,3,33.3%,5m
34405,2,[UAFire]Tayz,2435,30,1,4,5,20.0%,1h
34405,3,Gandil,2435,30,1,4,5,20.0%,13m
34405,1,arq,2435,0,1,4,5,20.0%,1h
34405,2,[ZnCeR]AstroLux,2435,30,1,9,10,10.0%,1m
34405,1,temur,2435,0,0,1,1,0.0%,30m
34405,1,ТвояПсихушка,2435,0,0,1,1,0.0%,1h
34436,2,XStrange,2434,1560,196,190,386,50.8%,52m
34436,3,sbs,2434,922,40,28,68,58.8%,3m
34436,3,FrostForst,2434,503,20,15,35,57.1%,22m
34436,3,[holki]Madle,2434,435,16,14,30,53.3%,31m
34436,1,Goyim,2434,471,12,7,19,63.2%,49m
34436,2,khier,2434,295,12,9,21,57.1%,10m
34436,2,PERRITTO,2434,378,12,16,28,42.9%,48m
34436,2,FarraSCII,2434,288,11,9,20,55.0%,27m
34436,2,PetShip,2434,246,8,12,20,40.0%,44m
34436,2,[ULTX]Kargo,2434,220,7,19,26,26.9%,23m
34436,3,mattman,2434,199,6,5,11,54.5%,4m
34436,3,Antar,2434,180,6,11,17,35.3%,13m
34436,1,llucke,2434,214,5,4,9,55.6%,45m
34436,1,Nhektor,2434,162,5,6,11,45.5%,6m
34436,2,ManiacMecki,2434,177,5,10,15,33.3%,5m
34436,3,Bacillus,2434,30,4,3,7,57.1%,40m
34436,2,BIZON,2434,119,3,2,5,60.0%,8m
34436,1,[bisdak]Jackusi,2434,48,3,3,6,50.0%,53m
34436,2,iCamebaCk,2434,132,3,8,11,27.3%,49m
34436,1,CultOfThree,2434,44,2,0,2,100.0%,17m
34436,1,Creeping,2434,48,2,0,2,100.0%,18m
34436,3,Porter,2434,30,2,5,7,28.6%,34m
34436,1,erews,2434,0,1,0,1,100.0%,33m
34436,3,Rhaegar,2434,30,1,3,4,25.0%,11m
34436,1,[MP4L]SgtSuffer,2434,0,1,3,4,25.0%,37m
34436,1,[IntLoc]Snowdrift,2434,0,0,1,1,0.0%,5m
34436,3,TheRedKobra,2434,0,0,2,2,0.0%,38m
34436,2,[SC1SPb]nikc,2434,0,0,6,6,0.0%,47m
34464,1,bessporno,2433,1344,277,271,548,50.5%,16m
34464,3,Royd,2433,695,28,23,51,54.9%,20m
34464,1,wzbear,2433,838,23,26,49,46.9%,5m
34464,1,Astrello,2433,657,20,32,52,38.5%,37m
34464,3,jura,2433,480,17,19,36,47.2%,15m
34464,2,Eric,2433,434,16,20,36,44.4%,19m
34464,3,Koba,2433,308,12,12,24,50.0%,5m
34464,1,gorlash,2433,330,12,15,27,44.4%,28m
34464,3,Ermahgerd,2433,290,10,12,22,45.5%,34m
34464,2,[ЕМPIRE]MEFESTO,2433,306,9,15,24,37.5%,1h
34464,1,kmadhad,2433,263,8,8,16,50.0%,5m
34464,2,Maestro,2433,228,7,9,16,43.8%,51m
34464,2,Lezandar,2433,146,7,10,17,41.2%,19m
34464,1,Hamster,2433,252,6,3,9,66.7%,31m
34464,1,Yurek,2433,252,6,5,11,54.5%,40m
34464,1,Juan,2433,220,6,6,12,50.0%,49m
34464,3,Miranda,2433,149,5,5,10,50.0%,44m
34464,3,III,2433,166,4,4,8,50.0%,1h
34464,1,[aBueLo]chabi,2433,176,4,5,9,44.4%,42m
34464,3,[ГФ]LanOfDark,2433,88,3,6,9,33.3%,6m
34464,1,kabra,2433,88,3,6,9,33.3%,3m
34464,1,Faint,2433,44,2,0,2,100.0%,38m
34464,1,bardosm,2433,84,2,1,3,66.7%,1h
34464,3,DerKaiser,2433,95,2,1,3,66.7%,1h
34464,2,supersag,2433,128,2,2,4,50.0%,30m
34464,3,КостяПольза,2433,34,2,2,4,50.0%,19m
34464,1,zilot,2433,0,1,0,1,100.0%,40m
34464,3,borgius,2433,0,1,1,2,50.0%,9m
34464,2,Solaris,2433,90,1,2,3,33.3%,53m
34464,3,Bysiaczek,2433,30,1,3,4,25.0%,27m
34464,1,ANTO,2433,0,1,4,5,20.0%,50m
34464,1,[RTT]Jojal,2433,0,0,1,1,0.0%,9m
34464,1,[ЧАНОВ8]vitik,2433,0,0,1,1,0.0%,9m
34464,1,Bogus,2433,0,0,1,1,0.0%,24m
34464,1,Dominik,2433,0,0,1,1,0.0%,27m
34464,3,[Naissu]DrOctO,2433,0,0,2,2,0.0%,20m
34500,2,[Ikarоs]Shadows,2432,1574,119,120,239,49.8%,38m
34500,3,PSIH,2432,818,66,68,134,49.3%,10m
34500,3,oleharaldm,2432,1426,55,53,108,50.9%,13m
34500,3,Rixifox,2432,1115,53,37,90,58.9%,22m
34500,3,MARSSON,2432,348,43,33,76,56.6%,25m
34500,3,LOLIKHP,2432,941,40,31,71,56.3%,35m
34500,3,TTPUKOJL,2432,611,27,25,52,51.9%,6m
34500,1,КирюшаБледны,2432,628,22,8,30,73.3%,36m
34500,2,johann,2432,152,20,22,42,47.6%,1h
34500,3,uGod,2432,296,11,5,16,68.8%,25m
34500,3,Trehh,2432,273,11,10,21,52.4%,42m
34500,3,tga,2432,309,10,16,26,38.5%,35m
34500,1,pringle,2432,311,9,8,17,52.9%,1h
34500,3,FleX,2432,224,9,8,17,52.9%,43m
34500,2,Charles,2432,184,7,13,20,35.0%,1h
34500,3,schlafmuetze,2432,58,5,5,10,50.0%,40m
34500,1,xox,2432,171,5,8,13,38.5%,1h
34500,2,lockra,2432,204,5,8,13,38.5%,29m
34500,1,Leonardo,2432,48,3,4,7,42.9%,6m
34500,3,AlesJaM,2432,97,3,5,8,37.5%,50m
34500,3,персифаль,2432,30,2,2,4,50.0%,33m
34500,3,Zeratul,2432,0,1,2,3,33.3%,13m
34500,3,JMR,2432,30,1,3,4,25.0%,42m
34500,2,JinTinKsch,2432,0,1,4,5,20.0%,35m
34500,1,JKG,2432,0,1,4,5,20.0%,20m
34500,1,Scuby,2432,0,0,1,1,0.0%,39m
34500,3,DDFL,2432,0,0,1,1,0.0%,19m
34500,1,lille,2432,0,0,1,1,0.0%,41m
34500,3,LNANCN,2432,0,0,2,2,0.0%,48m
34500,3,Owen,2432,0,0,2,2,0.0%,42m
34500,3,Dende,2432,0,0,3,3,0.0%,21m
34531,2,stfu,2431,1558,103,109,212,48.6%,38m
34531,3,Valentinchik,2431,1044,87,97,184,47.3%,8m
34531,3,Aether,2431,1551,77,78,155,49.7%,1h
34531,2,NIK,2431,1453,61,69,130,46.9%,35m
34531,2,DJMolina,2431,1164,45,47,92,48.9%,1h
34531,3,microjordan,2431,1099,44,41,85,51.8%,51m
34531,1,Litvinov,2431,1211,43,53,96,44.8%,44m
34531,3,Лирой,2431,760,35,27,62,56.5%,24m
34531,3,Beskvit,2431,817,31,33,64,48.4%,31m
34531,3,Hodor,2431,510,18,18,36,50.0%,28m
34531,3,Nidole,2431,460,16,18,34,47.1%,22m
34531,1,DaRkBetrayed,2431,396,15,20,35,42.9%,31m
34531,3,fataморгана,2431,305,12,7,19,63.2%,18m
34531,3,Redwolf,2431,127,12,13,25,48.0%,1h
34531,3,Beth,2431,280,10,6,16,62.5%,39m
34531,3,FakerFox,2431,238,8,11,19,42.1%,23m
34531,3,Ranger,2431,206,6,9,15,40.0%,41m
34531,1,xHAx,2431,82,5,2,7,71.4%,51m
34531,1,Masochist,2431,0,2,3,5,40.0%,25m
34531,1,Rimrod,2431,0,2,4,6,33.3%,1h
34531,1,MrMOON,2431,0,1,0,1,100.0%,45m
34531,1,Aiglederome,2431,0,1,0,1,100.0%,21m
34531,3,[GERGG]koonst,2431,96,1,2,3,33.3%,46m
34531,1,madbat,2431,0,1,4,5,20.0%,41m
34531,1,UberSasha,2431,0,0,1,1,0.0%,34m
34531,2,[DaFF]BlackDragon,2431,0,0,2,2,0.0%,1h
34531,3,[xCCCPx]Сергей,2431,0,0,3,3,0.0%,1h
34531,1,Bager,2431,0,0,5,5,0.0%,15m
34559,3,AMIRALNICOR,2430,885,87,79,166,52.4%,20m
34559,3,AlexOlPo,2430,945,85,87,172,49.4%,42m
34559,3,PoZitiv,2430,1046,72,61,133,54.1%,35m
34559,3,Kev,2430,1196,54,54,108,50.0%,52m
34559,3,nazghoul,2430,562,43,31,74,58.1%,42m
34559,2,Орион,2430,1012,39,42,81,48.1%,50m
34559,1,berryboom,2430,1026,39,46,85,45.9%,22m
34559,3,[SC2CAT]zzCat,2430,923,34,38,72,47.2%,22m
34559,2,Raven,2430,368,32,36,68,47.1%,25m
34559,3,DaN,2430,848,31,27,58,53.4%,10m
34559,3,Yokoo,2430,610,23,22,45,51.1%,13m
34559,3,[DTEK]Azir,2430,370,13,16,29,44.8%,9m
34559,3,Abdi,2430,336,12,14,26,46.2%,20m
34559,3,Brine,2430,261,10,5,15,66.7%,52m
34559,3,Massaraksh,2430,216,8,10,18,44.4%,2m
34559,3,[JCLM]Daweed,2430,194,7,5,12,58.3%,24m
34559,3,Medvvin,2430,194,6,2,8,75.0%,34m
34559,3,WOLF,2430,196,6,8,14,42.9%,40m
34559,3,Delaross,2430,174,6,9,15,40.0%,24m
34559,3,Erythron,2430,124,4,10,14,28.6%,26m
34559,3,fasolabros,2430,147,3,4,7,42.9%,35m
34559,1,[rtn]Energy,2430,0,3,5,8,37.5%,48m
34559,2,Chilla,2430,88,2,2,4,50.0%,1m
34559,3,lord,2430,0,1,1,2,50.0%,34m
34559,1,Dracogus,2430,0,1,4,5,20.0%,1h
34559,1,[ICMT]Meepo,2430,0,0,1,1,0.0%,40m
34559,1,Zarman,2430,0,0,1,1,0.0%,20m
34559,3,Волк,2430,0,0,3,3,0.0%,1h
34559,3,ERIKtheRED,2430,0,0,3,3,0.0%,25m
34588,3,Paul,2429,1567,127,119,246,51.6%,27m
34588,1,ActiveDK,2429,1577,89,98,187,47.6%,16m
34588,2,shadoww,2429,1419,74,75,149,49.7%,6m
34588,1,drlove,2429,1271,45,54,99,45.5%,4m
34588,3,Chefen,2429,1056,44,42,86,51.2%,46m
34588,3,jaanonim,2429,833,35,26,61,57.4%,39m
34588,1,Pyro,2429,877,33,44,77,42.9%,43m
34588,3,Iceman,2429,852,31,34,65,47.7%,35m
34588,3,[mfxed]Adamoz,2429,773,30,29,59,50.8%,1h
34588,3,invalid,2429,630,29,18,47,61.7%,1h
34588,1,Nuadalas,2429,746,21,12,33,63.6%,45m
34588,3,XmuriyNik,2429,533,19,17,36,52.8%,10m
34588,3,NoName,2429,305,16,8,24,66.7%,52m
34588,2,NakaChu,2429,403,15,19,34,44.1%,1h
34588,2,Namele,2429,280,15,25,40,37.5%,47m
34588,3,wern,2429,362,13,17,30,43.3%,21m
34588,2,SuicideFrog,2429,321,10,14,24,41.7%,8m
34588,2,Carlson,2429,124,9,7,16,56.2%,22m
34588,2,BiOacTivE,2429,180,8,12,20,40.0%,1h
34588,1,Ghost,2429,144,7,10,17,41.2%,12m
34588,3,Rulik,2429,188,5,4,9,55.6%,38m
34588,1,ezMMR,2429,122,4,2,6,66.7%,26m
34588,1,Darkskynin,2429,121,4,3,7,57.1%,31m
34588,3,[mineXD]Bumbi,2429,30,2,2,4,50.0%,25m
34588,3,VTdrapla,2429,30,2,2,4,50.0%,1h
34588,3,Juankar,2429,44,2,4,6,33.3%,1h
34588,1,Tziz,2429,97,2,4,6,33.3%,27m
34588,3,Infrael,2429,120,2,5,7,28.6%,1h
34588,1,Raul,2429,0,1,0,1,100.0%,18m
34588,1,hammerHQ,2429,44,1,1,2,50.0%,45m
34588,3,Altfdix,2429,0,1,1,2,50.0%,42m
34588,2,Fish,2429,90,1,2,3,33.3%,47m
34588,1,StormStriker,2429,0,0,1,1,0.0%,23m
34588,1,TheGranTV,2429,0,0,2,2,0.0%,30m
34588,3,[FIXIT]VADIMER,2429,0,0,2,2,0.0%,1h
34588,1,[Frntln]MEARL,2429,0,0,5,5,0.0%,35m
34624,3,largomania,2428,1506,101,92,193,52.3%,1h
34624,3,[StoalK]Gorbs,2428,1365,67,58,125,53.6%,43m
34624,3,Rackot,2428,517,55,58,113,48.7%,28m
34624,3,orujo,2428,612,30,26,56,53.6%,32m
34624,3,Crazycrawler,2428,556,21,19,40,52.5%,16m
34624,3,[FiU]Tschilo,2428,400,15,17,32,46.9%,10m
34624,2,legender,2428,423,15,17,32,46.9%,52m
34624,3,Raggl,2428,384,14,16,30,46.7%,34m
34624,3,ParadoX,2428,287,11,4,15,73.3%,32m
34624,2,Kubu,2428,289,10,11,21,47.6%,37m
34624,1,[MioInc]MioDrank,2428,234,9,5,14,64.3%,1h
34624,3,Nestor,2428,194,6,9,15,40.0%,9m
34624,1,[LifeAD]starkiller,2428,172,5,2,7,71.4%,1h
34624,3,Jonrock,2428,120,5,5,10,50.0%,39m
34624,1,Lexx,2428,206,5,6,11,45.5%,10m
34624,2,[GazeCR]Cumortas,2428,163,5,11,16,31.2%,38m
34624,3,[Kicx]IceFox,2428,95,4,3,7,57.1%,42m
34624,1,Rofo,2428,145,3,1,4,75.0%,26m
34624,3,DarkAssassin,2428,147,3,4,7,42.9%,7m
34624,3,sayurealboi,2428,30,3,5,8,37.5%,17m
34624,1,Nexxiss,2428,145,3,5,8,37.5%,38m
34624,3,[Z3RG7V]Revenant,2428,86,3,8,11,27.3%,33m
34624,1,мфтапрол,2428,0,2,4,6,33.3%,20m
34624,1,Bulldozzah,2428,0,2,5,7,28.6%,20m
34624,3,Arcanidge,2428,95,2,5,7,28.6%,39m
34624,1,hexnet,2428,44,1,1,2,50.0%,6m
34624,2,[XvFe]Sacke,2428,0,1,1,2,50.0%,13m
34624,3,Ausz,2428,0,1,2,3,33.3%,35m
34624,3,Zblonk,2428,0,1,2,3,33.3%,9m
34624,1,[SPARK]Rayleight,2428,0,1,4,5,20.0%,44m
34624,3,[HODL]Noide,2428,30,1,4,5,20.0%,35m
34624,1,fgaxe,2428,0,1,4,5,20.0%,10m
34624,3,GamBOrimBO,2428,30,1,8,9,11.1%,1h
34624,1,Shaman,2428,0,0,1,1,0.0%,20m
34624,1,ULTRAARNE,2428,0,0,1,1,0.0%,9m
34624,3,Equalizer,2428,0,0,1,1,0.0%,1h
34624,2,Xabiux,2428,0,0,1,1,0.0%,47m
34624,3,yoaha,2428,0,0,3,3,0.0%,21m
34662,3,BigmanKAM,2427,1563,147,139,286,51.4%,33m
34662,3,SIcme,2427,1479,94,92,186,50.5%,13m
34662,2,[3m]jaktak,2427,896,51,56,107,47.7%,51m
34662,3,tworuL,2427,590,21,18,39,53.8%,48m
34662,3,Gianni,2427,466,18,26,44,40.9%,5m
34662,1,[admin2]Artred,2427,347,10,12,22,45.5%,11m
34662,3,romanovich,2427,288,10,13,23,43.5%,1h
34662,2,[BÄÄM]Wrexes,2427,220,8,14,22,36.4%,39m
34662,2,Shtani,2427,166,7,8,15,46.7%,21m
34662,3,Миша,2427,146,6,8,14,42.9%,21m
34662,3,DTC,2427,0,5,9,14,35.7%,1h
34662,2,Forgetstad,2427,171,5,10,15,33.3%,22m
34662,3,XDwarningXD,2427,76,4,8,12,33.3%,37m
34662,3,Soareboi,2427,94,3,4,7,42.9%,16m
34662,3,[LIQUID]Goa,2427,62,3,6,9,33.3%,1h
34662,1,GrafVadim,2427,88,3,6,9,33.3%,53m
34662,1,Акселератор,2427,137,3,6,9,33.3%,11m
34662,3,limpdik,2427,0,3,7,10,30.0%,10m
34662,1,[HUNNNN]bLACk,2427,44,2,1,3,66.7%,2m
34662,3,Батон,2427,30,2,2,4,50.0%,21m
34662,3,[Gand]Brassicpark,2427,95,2,2,4,50.0%,27m
34662,3,Harmakhis,2427,62,2,9,11,18.2%,28m
34662,1,Lorras,2427,30,2,9,11,18.2%,28m
34662,2,ColBreakz,2427,0,1,0,1,100.0%,49m
34662,3,[ULTX]Roland,2427,0,1,2,3,33.3%,35m
34662,1,VERZIZI,2427,48,1,7,8,12.5%,52m
34662,1,sembems,2427,0,0,1,1,0.0%,21m
34662,1,[NWGD]OVERMIND,2427,0,0,1,1,0.0%,37m
34662,1,Celestant,2427,0,0,1,1,0.0%,38m
34662,3,ДраконТеней,2427,0,0,2,2,0.0%,48m
34692,2,emcostar,2426,1565,75,82,157,47.8%,45m
34692,3,Thor,2426,1067,63,56,119,52.9%,21m
34692,3,MrMammolius,2426,1270,51,47,98,52.0%,1h
34692,3,Alexeychup,2426,447,40,33,73,54.8%,1h
34692,3,BabaAndante,2426,656,28,23,51,54.9%,1h
34692,3,SterhTG,2426,604,28,26,54,51.9%,25m
34692,1,SoulReaper,2426,690,24,34,58,41.4%,51m
34692,3,ikane,2426,303,20,21,41,48.8%,40m
34692,1,SoldierTriad,2426,362,10,3,13,76.9%,43m
34692,3,VolkodlaK,2426,226,10,7,17,58.8%,26m
34692,3,Scyth,2426,227,8,4,12,66.7%,25m
34692,2,MAMOHT,2426,254,8,14,22,36.4%,45m
34692,1,Perec,2426,262,7,7,14,50.0%,1h
34692,3,ShNAps,2426,148,6,7,13,46.2%,25m
34692,2,Thor,2426,168,6,8,14,42.9%,8m
34692,3,Коражёр,2426,107,5,8,13,38.5%,34m
34692,1,stoneboar,2426,174,4,4,8,50.0%,44m
34692,2,Eleuthor,2426,154,4,7,11,36.4%,29m
34692,1,Stellar,2426,97,3,3,6,50.0%,21m
34692,1,[HeClub]AkashiSei,2426,128,3,13,16,18.8%,31m
34692,1,[GhRa]Silversurfer,2426,82,2,1,3,66.7%,33m
34692,3,JAKEJAMES,2426,96,2,1,3,66.7%,27m
34692,3,Сырок,2426,62,2,5,7,28.6%,35m
34692,3,Sim,2426,0,2,5,7,28.6%,41m
34692,1,david,2426,48,2,7,9,22.2%,1h
34692,1,Kahn,2426,42,1,1,2,50.0%,29m
34692,2,[РУИНА]DramaQueen,2426,32,1,1,2,50.0%,50m
34692,3,[LoL4ik]SeekerGame,2426,0,1,2,3,33.3%,32m
34692,1,Zolphi,2426,0,1,4,5,20.0%,34m
34692,1,ready,2426,0,1,4,5,20.0%,41m
34692,2,exile,2426,0,1,7,8,12.5%,1h
34692,3,ESGARD,2426,30,1,7,8,12.5%,5m
34692,1,Maximus,2426,0,0,1,1,0.0%,38m
34692,3,Anatomic,2426,0,0,2,2,0.0%,50m
34726,1,ВИТАЛИК,2425,700,149,148,297,50.2%,16m
34726,3,Levitate,2425,1161,67,62,129,51.9%,51m
34726,3,haallooo,2425,252,30,23,53,56.6%,13m
34726,1,Niviroth,2425,640,21,32,53,39.6%,1h
34726,3,GangstaNupe,2425,455,16,15,31,51.6%,40m
34726,3,magmatøn,2425,406,15,10,25,60.0%,39m
34726,2,varatron,2425,282,10,17,27,37.0%,49m
34726,3,Varatharg,2425,240,8,4,12,66.7%,48m
34726,1,Malmatiko,2425,262,8,11,19,42.1%,1h
34726,3,[I3W]DonVitto,2425,240,8,11,19,42.1%,6m
34726,2,[guilla]Garfius,2425,231,8,15,23,34.8%,25m
34726,2,Francky,2425,122,5,11,16,31.2%,15m
34726,2,bioMMXX,2425,128,4,6,10,40.0%,1h
34726,1,qwer,2425,96,4,6,10,40.0%,12m
34726,1,ATONY,2425,0,4,8,12,33.3%,9m
34726,1,TiMaks,2425,86,3,1,4,75.0%,42m
34726,3,Happyman,2425,115,3,5,8,37.5%,8m
34726,3,momchil,2425,36,3,6,9,33.3%,50m
34726,3,[PiGPan]DuBs,2425,90,3,8,11,27.3%,1h
34726,3,прозараженый,2425,120,3,8,11,27.3%,10m
34726,1,Sirtomw,2425,44,2,0,2,100.0%,28m
34726,1,[AOIC]Chappejonny,2425,97,2,1,3,66.7%,1h
34726,3,Beornegar,2425,96,2,1,3,66.7%,34m
34726,3,bordel,2425,118,2,3,5,40.0%,20m
34726,3,Promarine,2425,120,2,3,5,40.0%,1h
34726,3,rttn,2425,0,2,4,6,33.3%,46m
34726,1,goko,2425,0,1,0,1,100.0%,21m
34726,1,mrDeo,2425,0,1,4,5,20.0%,12m
34726,1,Username,2425,0,1,4,5,20.0%,18m
34726,1,FankO,2425,0,1,4,5,20.0%,49m
34726,1,Zen,2425,0,1,4,5,20.0%,25m
34726,1,[KDV]Light,2425,105,1,21,22,4.5%,37m
34726,1,korigien,2425,0,0,1,1,0.0%,34m
34726,3,dosfran,2425,0,0,4,4,0.0%,34m
34760,3,Legba,2424,1255,56,42,98,57.1%,52m
34760,1,PREDATOR,2424,964,33,23,56,58.9%,1h
34760,3,[Ptit]Балиас,2424,652,23,26,49,46.9%,1h
34760,3,ruvfen,2424,514,21,18,39,53.8%,41m
34760,2,Timo,2424,382,16,16,32,50.0%,7m
34760,3,[DZTK]CraftKroete,2424,217,9,6,15,60.0%,17m
34760,3,AsPMaSsAkEr,2424,222,9,10,19,47.4%,17m
34760,1,Bury,2424,321,8,2,10,80.0%,30m
34760,1,Grekoss,2424,307,8,6,14,57.1%,51m
34760,3,gengszter,2424,189,6,3,9,66.7%,39m
34760,3,nathanace,2424,193,5,8,13,38.5%,20m
34760,3,[VSTEAM]Cesarion,2424,139,4,4,8,50.0%,51m
34760,3,calendari,2424,145,4,4,8,50.0%,33m
34760,1,Zerodamage,2424,132,3,2,5,60.0%,11m
34760,3,[BN44]nieux,2424,97,2,0,2,100.0%,47m
34760,1,[VRTAN]Matveybu,2424,46,2,0,2,100.0%,9m
34760,1,gigiduru,2424,44,2,1,3,66.7%,31m
34760,3,YaMaL,2424,0,2,5,7,28.6%,1h
34760,3,[ZeIos]Skill,2424,0,2,5,7,28.6%,41m
34760,3,tobello,2424,0,1,2,3,33.3%,8m
34760,1,Agrozel,2424,117,1,2,3,33.3%,1h
34760,3,Adam,2424,30,1,3,4,25.0%,24m
34760,1,Jagter,2424,0,1,4,5,20.0%,31m
34760,1,[RSTM]Rexarll,2424,0,0,1,1,0.0%,26m
34760,3,Kefin,2424,0,0,4,4,0.0%,19m
34785,3,Starfish,2423,1545,285,279,564,50.5%,21m
34785,2,Jag,2423,792,38,42,80,47.5%,49m
34785,3,Bellwoman,2423,845,36,27,63,57.1%,16m
34785,3,James,2423,428,24,23,47,51.1%,25m
34785,1,paphitis,2423,649,21,9,30,70.0%,45m
34785,2,DRAGooN,2423,408,19,18,37,51.4%,2m
34785,1,[AresG]king,2423,539,15,5,20,75.0%,45m
34785,2,Tonspieler,2423,366,14,24,38,36.8%,15m
34785,1,[VoiDTS]Elytra,2423,327,12,5,17,70.6%,42m
34785,2,NRWVERBOT,2423,239,10,11,21,47.6%,46m
34785,2,[MARSS]Modejo,2423,270,9,13,22,40.9%,17m
34785,1,[JediK]QuantumSnake,2423,128,4,1,5,80.0%,23m
34785,1,Vence,2423,168,4,3,7,57.1%,5m
34785,1,Beq,2423,179,4,3,7,57.1%,29m
34785,3,Velnyke,2423,60,4,6,10,40.0%,9m
34785,3,Bratcebe,2423,120,4,8,12,33.3%,23m
34785,1,BROrus,2423,0,3,2,5,60.0%,15m
34785,1,[BiBAP]Madhatter,2423,0,3,2,5,60.0%,33m
34785,3,Sakayami,2423,60,3,5,8,37.5%,18m
34785,1,[TDRUS]PhonkOneLove,2423,97,2,3,5,40.0%,1h
34785,1,Oraçulum,2423,0,1,4,5,20.0%,34m
34785,3,Elodie,2423,30,1,5,6,16.7%,20m
34785,1,[FtLTm]QUASAR,2423,0,0,1,1,0.0%,51m
34785,1,ErjiDeLaRosa,2423,0,0,1,1,0.0%,1h
34785,1,[Bidjo]ZSV,2423,0,0,1,1,0.0%,1h
34785,1,Szakallo,2423,0,0,1,1,0.0%,47m
34785,1,Риул,2423,0,0,1,1,0.0%,33m
34785,1,ProcF,2423,0,0,1,1,0.0%,41m
34785,3,MrPotato,2423,0,0,2,2,0.0%,37m
34785,3,sdentatovic,2423,0,0,2,2,0.0%,22m
34815,1,leleu,2422,1575,192,201,393,48.9%,16m
34815,3,Deadpresiden,2422,989,47,41,88,53.4%,1h
34815,3,wink,2422,1087,45,44,89,50.6%,51m
34815,3,[FCKDHA]Rakius,2422,940,41,41,82,50.0%,10m
34815,2,[TLOTT]FrankySee,2422,930,34,39,73,46.6%,52m
34815,3,Requiem,2422,230,32,27,59,54.2%,31m
34815,3,Alex,2422,590,28,25,53,52.8%,7m
34815,2,omen,2422,729,28,27,55,50.9%,35m
34815,3,Trey,2422,572,23,22,45,51.1%,44m
34815,3,Chasokin,2422,351,14,8,22,63.6%,10m
34815,3,Vlad,2422,244,12,15,27,44.4%,1h
34815,3,Cykron,2422,305,11,11,22,50.0%,48m
34815,1,[RusLv]ЭпичныйОН,2422,368,9,6,15,60.0%,50m
34815,1,AlexWave,2422,247,9,12,21,42.9%,16m
34815,3,IIIIIIIIIIII,2422,234,8,4,12,66.7%,48m
34815,1,Player,2422,300,8,7,15,53.3%,48m
34815,2,coolrd,2422,177,7,9,16,43.8%,49m
34815,3,Zhexon,2422,155,4,2,6,66.7%,37m
34815,1,Sodapop,2422,132,3,2,5,60.0%,21m
34815,3,[076]Kiano,2422,0,3,6,9,33.3%,1h
34815,3,gegedemeur,2422,78,3,7,10,30.0%,17m
34815,1,Zerotul,2422,96,3,7,10,30.0%,3m
34815,1,[TM21]Cepesh,2422,44,2,0,2,100.0%,5m
34815,1,corradolab,2422,84,2,1,3,66.7%,44m
34815,1,Polo,2422,44,2,1,3,66.7%,33m
34815,1,RAZER,2422,145,2,1,3,66.7%,40m
34815,1,KOSTOLOM,2422,0,1,0,1,100.0%,47m
34815,2,Alex,2422,40,1,1,2,50.0%,14m
34815,3,Aléridia,2422,0,1,3,4,25.0%,1h
34815,1,sobolesnuy,2422,0,0,1,1,0.0%,24m
34815,2,Michele,2422,0,0,1,1,0.0%,5m
34846,3,Harmless,2421,1553,71,62,133,53.4%,15m
34846,3,IMkarlo,2421,880,71,66,137,51.8%,17m
34846,2,bob,2421,1299,68,74,142,47.9%,44m
34846,3,темай,2421,863,43,33,76,56.6%,1h
34846,2,Smartyy,2421,428,19,19,38,50.0%,1h
34846,1,shiuk,2421,554,14,11,25,56.0%,38m
34846,1,[Тир]Снэкри,2421,342,9,6,15,60.0%,46m
34846,1,Léon,2421,170,5,1,6,83.3%,1h
34846,2,Bogard,2421,167,5,3,8,62.5%,1h
34846,1,Ybipbip,2421,220,5,6,11,45.5%,6m
34846,1,Heidö,2421,120,4,5,9,44.4%,9m
34846,3,phi,2421,92,4,6,10,40.0%,13m
34846,1,Cientif,2421,130,3,4,7,42.9%,38m
34846,1,DarkCloud,2421,48,3,4,7,42.9%,3m
34846,1,[WLDD]HMDC,2421,44,2,0,2,100.0%,5m
34846,3,krevur,2421,0,2,4,6,33.3%,16m
34846,1,Messala,2421,48,2,5,7,28.6%,19m
34846,1,[Bikok]NeoKms,2421,0,1,4,5,20.0%,3m
34846,3,руслан,2421,0,1,4,5,20.0%,6m
34846,3,YalikeJAZZ,2421,30,1,4,5,20.0%,32m
34846,3,Dimon,2421,30,1,5,6,16.7%,40m
34846,1,Abdullah,2421,0,0,1,1,0.0%,49m
34846,1,Hapide,2421,0,0,1,1,0.0%,49m
34846,1,FanisPapat,2421,0,0,1,1,0.0%,16m
34846,1,AlonsoKihano,2421,0,0,2,2,0.0%,44m
34846,1,SulFuRe,2421,0,0,2,2,0.0%,24m
34872,3,wrxzt,2420,1459,213,216,429,49.7%,9m
34872,2,FotonBaton,2420,1432,108,107,215,50.2%,1m
34872,3,dmdoc,2420,1585,103,85,188,54.8%,21m
34872,1,SANTEY,2420,701,50,39,89,56.2%,37m
34872,3,llllllllll,2420,1042,50,55,105,47.6%,11m
34872,3,Темимурл,2420,1053,48,35,83,57.8%,1h
34872,2,Tal,2420,1278,48,59,107,44.9%,1h
34872,3,[BWArmy]IIIIIIII,2420,1017,42,36,78,53.8%,1h
34872,2,Zilaz,2420,665,32,27,59,54.2%,1h
34872,3,Viktorio,2420,728,27,30,57,47.4%,25m
34872,1,XDSMASHER,2420,586,21,33,54,38.9%,1h
34872,3,Tobi,2420,396,16,21,37,43.2%,1h
34872,1,CyborG,2420,437,12,3,15,80.0%,1h
34872,3,[InitRu]НаглыйКЫС,2420,362,12,12,24,50.0%,8m
34872,3,tiptop,2420,343,12,14,26,46.2%,20m
34872,3,Mihanic,2420,226,8,5,13,61.5%,13m
34872,3,Kowalski,2420,185,5,4,9,55.6%,19m
34872,3,RisenDeath,2420,62,5,8,13,38.5%,11m
34872,1,DrRand,2420,132,4,2,6,66.7%,47m
34872,3,KuduVoodoo,2420,36,4,8,12,33.3%,13m
34872,3,Хомяк,2420,157,4,9,13,30.8%,13m
34872,2,Zeratul,2420,86,4,10,14,28.6%,1h
34872,3,Mandarinka,2420,58,3,3,6,50.0%,11m
34872,2,Oni,2420,30,3,6,9,33.3%,19m
34872,1,Romulus,2420,48,2,0,2,100.0%,1h
34872,1,Milos,2420,0,2,3,5,40.0%,1h
34872,3,AlexNest,2420,96,2,5,7,28.6%,35m
34872,2,[Мульт]smouk,2420,0,1,0,1,100.0%,34m
34872,3,Heimer,2420,91,1,2,3,33.3%,32m
34872,1,FanagoS,2420,0,1,4,5,20.0%,13m
34872,3,[STARRR]SIRTAKI,2420,18,1,7,8,12.5%,52m
34872,2,stuyac,2420,0,0,1,1,0.0%,37m
34872,1,Linkin,2420,0,0,1,1,0.0%,34m
34872,1,Roger,2420,0,0,1,1,0.0%,48m
34872,2,[Shr3Kd]ZinkaZa,2420,0,0,2,2,0.0%,14m
34872,3,[ТОЛЯ]ЗвукУнитаза,2420,0,0,3,3,0.0%,1h
34908,2,preditar,2419,1524,199,202,401,49.6%,1m
34908,1,Larsaa,2419,1888,86,84,170,50.6%,1h
34908,3,Deepblue,2419,1603,73,75,148,49.3%,33m
34908,3,chubyzealot,2419,1500,70,69,139,50.4%,21m
34908,3,Narxes,2419,1032,41,44,85,48.2%,21m
34908,3,[SPGN12]COBRA,2419,974,40,35,75,53.3%,25m
34908,1,onlydisco,2419,608,16,12,28,57.1%,49m
34908,1,Chimere,2419,488,16,18,34,47.1%,1h
34908,1,aurelambroz,2419,369,13,17,30,43.3%,27m
34908,1,pirmin,2419,346,12,11,23,52.2%,24m
34908,2,Tenebrus,2419,273,10,17,27,37.0%,1h
34908,2,sebo,2419,154,6,8,14,42.9%,23m
34908,1,Gorian,2419,96,4,5,9,44.4%,38m
34908,3,faqtr,2419,92,4,8,12,33.3%,25m
34908,1,[FCCO]Leon,2419,84,3,0,3,100.0%,35m
34908,3,DarkDeamonS,2419,0,3,3,6,50.0%,42m
34908,1,[Invǂ]gunship,2419,144,3,5,8,37.5%,16m
34908,1,[FLANC]taamito,2419,145,3,5,8,37.5%,40m
34908,1,StarLeader,2419,40,2,0,2,100.0%,49m
34908,1,[RLing]MaeLSTroM,2419,0,2,3,5,40.0%,44m
34908,1,[BYTCA]pit,2419,44,2,4,6,33.3%,31m
34908,3,calliban,2419,96,2,5,7,28.6%,9m
34908,1,ProFide,2419,111,2,5,7,28.6%,27m
34908,3,[4ekavo]HranitelOka,2419,30,2,5,7,28.6%,34m
34908,3,HAVOC,2419,0,2,5,7,28.6%,16m
34908,3,Thrawn,2419,94,2,5,7,28.6%,1h
34908,1,[SIimy]shahin,2419,42,1,1,2,50.0%,1h
34908,1,BoomSquig,2419,0,1,3,4,25.0%,31m
34908,3,Kombatovich,2419,97,1,3,4,25.0%,2m
34908,1,Tofu,2419,0,1,4,5,20.0%,1h
34908,1,BaBnik,2419,0,1,4,5,20.0%,23m
34908,1,[lZornG]HANTER,2419,0,1,4,5,20.0%,24m
34908,1,[2Pizzа]Polaris,2419,0,0,1,1,0.0%,17m
34908,1,Серёжа,2419,0,0,1,1,0.0%,23m
34908,1,Ahriman,2419,0,0,1,1,0.0%,35m
34908,1,Ihor,2419,0,0,1,1,0.0%,45m
34908,3,[Kompis]Goldenarrow,2419,0,0,5,5,0.0%,54m
34945,2,serpanv,2418,1552,182,180,362,50.3%,6m
34945,2,[1714dc]PeabnutMata,2418,1527,78,84,162,48.1%,39m
34945,3,BARBQ,2418,1459,77,80,157,49.0%,11m
34945,3,[R4Time]KinGCOCkROaC,2418,745,27,25,52,51.9%,31m
34945,3,TonzLeR,2418,673,27,28,55,49.1%,10m
34945,1,WhiteHeart,2418,636,23,27,50,46.0%,1h
34945,3,[LKKRW]Frietmans,2418,234,20,20,40,50.0%,26m
34945,3,RobotWizard,2418,465,17,14,31,54.8%,22m
34945,3,Scorpio,2418,384,15,17,32,46.9%,42m
34945,3,IvaN,2418,213,11,14,25,44.0%,25m
34945,3,UnknownHero,2418,264,10,7,17,58.8%,1h
34945,3,[EGTV]MattRep,2418,276,9,10,19,47.4%,42m
34945,2,Optimistic,2418,211,7,3,10,70.0%,49m
34945,1,DraQlla,2418,200,7,6,13,53.8%,51m
34945,1,OoNnEeSs,2418,335,7,8,15,46.7%,52m
34945,2,Hanumon,2418,242,7,8,15,46.7%,45m
34945,3,loli,2418,202,5,8,13,38.5%,35m
34945,1,[Teror]Fok,2418,170,4,2,6,66.7%,18m
34945,1,pertur,2418,0,4,2,6,66.7%,44m
34945,3,[Kinter]Surodoeth,2418,172,4,5,9,44.4%,1h
34945,3,Coldblood,2418,141,4,5,9,44.4%,21m
34945,1,СНЕГОВИК,2418,203,4,7,11,36.4%,37m
34945,3,Tharsonius,2418,157,4,7,11,36.4%,50m
34945,1,Araelf,2418,0,3,3,6,50.0%,30m
34945,1,uroboros,2418,0,3,3,6,50.0%,19m
34945,1,[LLEDV]Foxtwo,2418,48,2,1,3,66.7%,12m
34945,3,America,2418,30,2,2,4,50.0%,13m
34945,1,Wolf,2418,92,2,3,5,40.0%,48m
34945,2,[KenX]Nekooonya,2418,0,2,5,7,28.6%,3m
34945,3,NURUS,2418,0,2,6,8,25.0%,37m
34945,3,PolderPapi,2418,0,2,6,8,25.0%,33m
34945,1,[mfxed]ProTos,2418,0,1,0,1,100.0%,17m
34945,3,PablitoMan,2418,0,1,2,3,33.3%,20m
34945,1,AlexPo,2418,73,1,2,3,33.3%,33m
34945,3,[Chariz]AlpakaStar,2418,30,1,3,4,25.0%,48m
34945,1,illuvios,2418,0,0,1,1,0.0%,49m
34945,1,ShadOh,2418,0,0,1,1,0.0%,28m
34945,3,Hjalte,2418,0,0,3,3,0.0%,18m
34983,2,SON,2417,1078,96,91,187,51.3%,48m
34983,3,Massaker,2417,1144,52,34,86,60.5%,19m
34983,3,macus,2417,1056,47,35,82,57.3%,28m
34983,2,TheOverlord,2417,283,26,32,58,44.8%,6m
34983,3,Chaqual,2417,601,25,28,53,47.2%,18m
34983,1,TrueSilver,2417,572,19,36,55,34.5%,53m
34983,3,adam,2417,280,12,11,23,52.2%,37m
34983,3,Nicuke,2417,327,12,13,25,48.0%,33m
34983,2,Robbat,2417,178,8,10,18,44.4%,17m
34983,3,vait,2417,246,8,12,20,40.0%,41m
34983,1,Yenkins,2417,148,7,10,17,41.2%,1h
34983,2,[IDER]DarkNova,2417,185,7,11,18,38.9%,4m
34983,3,Theupah,2417,60,6,5,11,54.5%,17m
34983,2,Tharadon,2417,114,5,6,11,45.5%,3m
34983,2,OmenCat,2417,94,4,12,16,25.0%,47m
34983,1,[VENDET]LuisMiguel,2417,90,3,2,5,60.0%,23m
34983,1,Emperor,2417,30,3,8,11,27.3%,16m
34983,1,ЛягухаЖабЖаб,2417,44,2,0,2,100.0%,1h
34983,3,[M2X]LukeSama,2417,121,2,1,3,66.7%,41m
34983,1,superpig,2417,45,2,2,4,50.0%,1h
34983,3,Djskull,2417,60,2,5,7,28.6%,20m
34983,1,lukaas,2417,0,1,0,1,100.0%,13m
34983,3,Tagulalap,2417,0,1,1,2,50.0%,25m
34983,1,Psiara,2417,0,1,2,3,33.3%,13m
34983,1,SHARKNET,2417,0,1,2,3,33.3%,13m
34983,1,Kev,2417,48,1,5,6,16.7%,38m
34983,1,[KoSt44]Давид,2417,0,0,2,2,0.0%,48m
35010,3,[CaRm]lary,2416,1422,97,87,184,52.7%,22m
35010,1,[1FU2]mikado,2416,1570,71,85,156,45.5%,51m
35010,3,YuraEj,2416,1041,59,50,109,54.1%,4m
35010,1,Shanks,2416,1410,46,41,87,52.9%,43m
35010,3,IDen,2416,645,24,27,51,47.1%,48m
35010,3,angryANT,2416,560,21,17,38,55.3%,54m
35010,2,torch,2416,529,21,20,41,51.2%,50m
35010,1,proTobee,2416,551,20,27,47,42.6%,1h
35010,3,GLADIADORvVv,2416,427,16,19,35,45.7%,26m
35010,1,Samplicio,2416,198,9,9,18,50.0%,2m
35010,1,PaBleG,2416,272,6,5,11,54.5%,40m
35010,1,Matei,2416,166,5,7,12,41.7%,5m
35010,2,ThePowerPuff,2416,128,4,4,8,50.0%,23m
35010,3,[Habibs]Dhulqarnain,2416,117,3,1,4,75.0%,47m
35010,3,DarkDruid,2416,139,3,3,6,50.0%,36m
35010,2,stavr,2416,30,3,5,8,37.5%,43m
35010,3,Cxndr,2416,60,3,8,11,27.3%,33m
35010,1,typhoon,2416,44,2,2,4,50.0%,1h
35010,1,Mephiston,2416,0,2,4,6,33.3%,21m
35010,3,Cyteless,2416,68,2,5,7,28.6%,5m
35010,3,[666420]TassoArdente,2416,0,1,1,2,50.0%,25m
35010,1,Thonis,2416,42,1,2,3,33.3%,21m
35010,3,sabkingdz,2416,0,1,5,6,16.7%,42m
35010,1,nishlash,2416,42,1,6,7,14.3%,16m
35010,1,[CruZe]Celante,2416,0,0,1,1,0.0%,41m
35010,1,Neon,2416,0,0,1,1,0.0%,44m
35036,1,LuckY,2415,1641,83,72,155,53.5%,39m
35036,3,Roujizi,2415,588,50,38,88,56.8%,32m
35036,1,Thistle,2415,800,37,30,67,55.2%,15m
35036,1,EGOisbadmkay,2415,535,18,10,28,64.3%,31m
35036,1,BRADY,2415,522,17,6,23,73.9%,51m
35036,3,sdgiks,2415,296,9,17,26,34.6%,36m
35036,1,TamTam,2415,172,6,10,16,37.5%,1h
35036,2,PuppyArmz,2415,242,6,12,18,33.3%,49m
35036,2,Contact,2415,140,5,5,10,50.0%,30m
35036,1,okeangel,2415,145,3,4,7,42.9%,48m
35036,3,Вафелька,2415,0,2,4,6,33.3%,33m
35036,1,insiderVD,2415,0,1,0,1,100.0%,32m
35036,1,Heisenberg,2415,0,1,1,2,50.0%,43m
35036,1,KAKASHI,2415,0,1,3,4,25.0%,24m
35036,1,FRIZua,2415,0,1,4,5,20.0%,15m
35036,1,paark,2415,0,1,4,5,20.0%,16m
35036,3,Priliand,2415,0,1,5,6,16.7%,33m
35036,3,Shrek,2415,30,1,5,6,16.7%,51m
35036,1,[RAYDOR]Eilysium,2415,0,0,1,1,0.0%,22m
35055,1,NushNush,2414,1447,63,76,139,45.3%,1h
35055,3,Laitius,2414,954,37,37,74,50.0%,18m
35055,3,Tomas,2414,879,35,31,66,53.0%,21m
35055,3,hayusunny,2414,443,16,15,31,51.6%,13m
35055,3,DoctorC,2414,396,13,14,27,48.1%,10m
35055,3,MeXaNiK,2414,307,12,15,27,44.4%,20m
35055,1,[G3lb]Nexirall,2414,388,10,6,16,62.5%,31m
35055,1,Yoddha,2414,329,10,11,21,47.6%,52m
35055,1,QShin,2414,179,9,9,18,50.0%,52m
35055,2,[TSFeed]DIEGoPV,2414,286,9,12,21,42.9%,1h
35055,3,[CdNRO]Dane,2414,174,7,9,16,43.8%,1h
35055,1,kowalski,2414,193,6,13,19,31.6%,43m
35055,2,Plague,2414,70,5,6,11,45.5%,13m
35055,2,Neuro,2414,138,4,3,7,57.1%,25m
35055,1,IllllIIIIIII,2414,185,4,5,9,44.4%,23m
35055,3,Rybak,2414,147,4,8,12,33.3%,33m
35055,2,bouge,2414,38,4,8,12,33.3%,1h
35055,3,Endhle,2414,0,2,2,4,50.0%,34m
35055,2,PistolProtos,2414,122,2,3,5,40.0%,1h
35055,2,[MHACKS]kenji,2414,78,2,6,8,25.0%,49m
35055,3,MCLST,2414,0,2,6,8,25.0%,18m
35055,1,Svetovid,2414,0,2,7,9,22.2%,1h
35055,1,Aldo,2414,0,1,0,1,100.0%,43m
35055,2,mamoeb,2414,0,1,0,1,100.0%,41m
35055,3,Diskoooooo,2414,0,1,0,1,100.0%,2m
35055,1,Magthepon,2414,0,1,0,1,100.0%,34m
35055,1,Junater,2414,0,1,1,2,50.0%,22m
35055,3,WERGAME,2414,96,1,3,4,25.0%,13m
35055,3,Lokhir,2414,30,1,4,5,20.0%,17m
35055,1,Luka,2414,0,0,1,1,0.0%,23m
35055,1,hullmees,2414,0,0,1,1,0.0%,38m
35055,3,gera,2414,0,0,2,2,0.0%,48m
35087,2,MeToo,2413,1540,288,280,568,50.7%,8m
35087,3,Chalkarium,2413,1400,144,141,285,50.5%,1h
35087,1,Detheuss,2413,1739,108,100,208,51.9%,31m
35087,3,AnK,2413,1225,82,67,149,55.0%,13m
35087,1,Sawan,2413,1038,55,48,103,53.4%,38m
35087,3,AlkrV,2413,441,28,23,51,54.9%,1h
35087,3,ElSupeee,2413,293,26,17,43,60.5%,9m
35087,3,henge,2413,612,26,24,50,52.0%,48m
35087,3,MarcelONE,2413,307,23,22,45,51.1%,32m
35087,1,Lovpalek,2413,667,23,23,46,50.0%,9m
35087,1,Cedric,2413,533,21,15,36,58.3%,4m
35087,1,Zajebatsu,2413,549,20,18,38,52.6%,34m
35087,3,Unity,2413,461,17,15,32,53.1%,17m
35087,3,[ZeRGPG]Overmind,2413,322,15,16,31,48.4%,26m
35087,3,[AciNoN]ImmUnd,2413,364,14,19,33,42.4%,22m
35087,1,Kyron,2413,338,11,11,22,50.0%,31m
35087,1,Drax,2413,290,10,6,16,62.5%,25m
35087,2,McYarik,2413,244,9,10,19,47.4%,35m
35087,3,[АDV]NesCafe,2413,243,8,7,15,53.3%,28m
35087,3,Tomahawk,2413,177,7,5,12,58.3%,40m
35087,1,[FGger]BerlinrMario,2413,196,6,3,9,66.7%,45m
35087,1,Sfay,2413,44,2,0,2,100.0%,1h
35087,1,Leyfrox,2413,44,2,0,2,100.0%,43m
35087,3,Ckrols,2413,30,2,0,2,100.0%,2m
35087,1,DrozD,2413,46,2,1,3,66.7%,44m
35087,1,IMakeCannons,2413,72,2,2,4,50.0%,30m
35087,1,jason,2413,42,2,2,4,50.0%,33m
35087,3,ReshikRDK,2413,0,2,3,5,40.0%,47m
35087,1,mingnjjue,2413,86,2,3,5,40.0%,49m
35087,3,EmptySPACE,2413,0,1,2,3,33.3%,36m
35087,1,Vladislav,2413,44,1,2,3,33.3%,6m
35087,1,skelter,2413,0,1,3,4,25.0%,13m
35087,1,[OdinJ]gagamel,2413,0,1,4,5,20.0%,37m
35087,1,[ZULUL]FearMe,2413,0,1,4,5,20.0%,12m
35087,1,Bulgogi,2413,0,0,1,1,0.0%,41m
35087,1,blorg,2413,0,0,1,1,0.0%,5m
35087,1,Qvjetak,2413,0,0,1,1,0.0%,31m
35087,1,Spring,2413,0,0,2,2,0.0%,1h
35125,1,Mika,2412,1560,552,563,1115,49.5%,4m
35125,3,Albrecht,2412,1318,59,59,118,50.0%,4m
35125,3,HoBa,2412,1282,56,46,102,54.9%,9m
35125,3,realMurben,2412,664,24,28,52,46.2%,23m
35125,2,[ProbKA]denALM,2412,614,22,29,51,43.1%,1h
35125,2,Technology,2412,497,18,18,36,50.0%,35m
35125,2,Wrothbows,2412,357,17,16,33,51.5%,24m
35125,3,kylgax,2412,371,16,12,28,57.1%,9m
35125,1,[ANREN]АРСЕНИЙ,2412,419,14,5,19,73.7%,1h
35125,2,Walek,2412,381,14,18,32,43.8%,15m
35125,3,[DeePuz]Emperor,2412,322,12,13,25,48.0%,36m
35125,3,Levi,2412,324,11,15,26,42.3%,10m
35125,3,Noname,2412,266,8,12,20,40.0%,19m
35125,3,Spoiler,2412,207,7,6,13,53.8%,42m
35125,3,kocur,2412,208,7,8,15,46.7%,21m
35125,3,clvwfj,2412,240,7,10,17,41.2%,20m
35125,3,vladrus,2412,168,5,4,9,55.6%,26m
35125,1,Chachu,2412,144,4,7,11,36.4%,27m
35125,1,Vnitu,2412,48,2,0,2,100.0%,52m
35125,1,Archer,2412,0,2,4,6,33.3%,24m
35125,1,Павлик,2412,97,2,5,7,28.6%,21m
35125,3,KhatarsyS,2412,30,2,6,8,25.0%,47m
35125,1,Alizéa,2412,0,1,0,1,100.0%,38m
35125,3,superdario,2412,0,1,1,2,50.0%,9m
35125,1,Dstblyat,2412,44,1,1,2,50.0%,9m
35125,3,ARYEN,2412,0,1,2,3,33.3%,6m
35125,3,Hector,2412,95,1,3,4,25.0%,10m
35125,3,sin,2412,30,1,4,5,20.0%,54m
35125,1,STINGER,2412,0,1,4,5,20.0%,16m
35125,1,Hypnotize,2412,0,1,5,6,16.7%,48m
35125,1,Kharma,2412,0,0,1,1,0.0%,18m
35125,1,Tolik,2412,0,0,1,1,0.0%,34m
35125,2,Reoflex,2412,0,0,1,1,0.0%,1h
35125,3,NanoTapok,2412,0,0,2,2,0.0%,19m
35125,1,vaites,2412,0,0,2,2,0.0%,3m
35125,1,Nediog,2412,0,0,2,2,0.0%,1h
35161,2,[NOOBpl]Madfrank,2411,1582,448,446,894,50.1%,9m
35161,1,ASahlin,2411,1858,94,83,177,53.1%,38m
35161,3,Giallo,2411,1303,50,49,99,50.5%,16m
35161,1,Евгений,2411,640,46,45,91,50.5%,26m
35161,2,MasterDi,2411,1259,44,56,100,44.0%,21m
35161,3,roflanebalo,2411,407,40,32,72,55.6%,36m
35161,3,[sCork]cagli,2411,878,35,31,66,53.0%,48m
35161,1,Bragajiini,2411,666,22,12,34,64.7%,33m
35161,3,OmegaOdie,2411,455,20,15,35,57.1%,1h
35161,3,Damplook,2411,303,20,21,41,48.8%,16m
35161,2,HYDRA,2411,482,20,21,41,48.8%,30m
35161,3,asper,2411,406,15,15,30,50.0%,48m
35161,3,[DIS]MarineKingPR,2411,324,12,10,22,54.5%,3m
35161,1,hAte,2411,330,9,3,12,75.0%,38m
35161,2,вад,2411,222,8,11,19,42.1%,1h
35161,3,Novokain,2411,116,7,10,17,41.2%,1h
35161,2,DatPille,2411,130,6,11,17,35.3%,45m
35161,1,Vartemius,2411,170,5,2,7,71.4%,39m
35161,1,Lapse,2411,121,3,4,7,42.9%,19m
35161,1,[6Starz]GreGY,2411,0,2,2,4,50.0%,34m
35161,3,[KARM4]minibob,2411,0,2,5,7,28.6%,1h
35161,3,Langarmlui,2411,30,1,1,2,50.0%,24m
35161,1,Emzaak,2411,0,1,2,3,33.3%,41m
35161,3,animeshnik,2411,0,1,3,4,25.0%,1h
35161,1,Blue,2411,0,1,4,5,20.0%,9m
35161,1,PotAuFeu,2411,0,1,6,7,14.3%,23m
35161,1,deep,2411,0,0,1,1,0.0%,29m
35161,2,DIONIZY,2411,0,0,3,3,0.0%,1h
35189,1,Roko,2410,1358,96,91,187,51.3%,39m
35189,1,TallChalk,2410,1382,85,95,180,47.2%,1h
35189,3,Robotics,2410,1090,42,44,86,48.8%,35m
35189,2,Yanpowers,2410,764,29,31,60,48.3%,19m
35189,3,[z666z]Nevis,2410,683,28,22,50,56.0%,47m
35189,1,[NINJ88]Nameless,2410,942,28,24,52,53.8%,1h
35189,1,Destiny,2410,827,26,22,48,54.2%,28m
35189,1,swupz,2410,697,22,24,46,47.8%,34m
35189,3,Luciniel,2410,550,20,23,43,46.5%,32m
35189,3,[PiGPan]DavisdsonCZ,2410,490,18,18,36,50.0%,27m
35189,3,JinZo,2410,369,14,21,35,40.0%,20m
35189,2,HerO,2410,204,13,14,27,48.1%,48m
35189,3,Milho,2410,358,13,18,31,41.9%,24m
35189,3,FenrirLeFou,2410,246,8,6,14,57.1%,22m
35189,2,Zoxan,2410,245,7,5,12,58.3%,32m
35189,2,Zeus,2410,168,7,12,19,36.8%,4m
35189,1,[KFF]Nemesis,2410,143,5,9,14,35.7%,35m
35189,3,[KPM]Paithan,2410,150,5,11,16,31.2%,14m
35189,1,SyNPhO,2410,145,4,4,8,50.0%,1h
35189,1,Slavik,2410,86,3,1,4,75.0%,30m
35189,1,IIIIIIIIIIII,2410,86,3,1,4,75.0%,21m
35189,1,[F0RTES]Skynet,2410,86,3,3,6,50.0%,23m
35189,1,jongo,2410,48,2,5,7,28.6%,20m
35189,1,Nhosez,2410,73,2,6,8,25.0%,1h
35189,3,wows,2410,0,1,0,1,100.0%,16m
35189,1,Remeee,2410,44,1,2,3,33.3%,18m
35189,1,Swarmy,2410,44,1,2,3,33.3%,9m
35189,1,Egirl,2410,0,1,4,5,20.0%,18m
35189,1,Taldarion,2410,0,0,1,1,0.0%,12m
35189,1,Vershytel,2410,0,0,2,2,0.0%,33m
35219,3,Lauodamus,2409,1544,199,192,391,50.9%,40m
35219,3,радж,2409,1554,68,65,133,51.1%,27m
35219,3,[ELFDM]playerone,2409,1033,47,38,85,55.3%,10m
35219,3,Kelvin,2409,961,39,37,76,51.3%,22m
35219,1,[K0mpis]Angelwhite,2409,984,31,25,56,55.4%,5m
35219,3,leviathan,2409,830,30,28,58,51.7%,1h
35219,1,[RRRRDT]BinaryError,2409,574,20,21,41,48.8%,31m
35219,1,LucasDavid,2409,532,17,7,24,70.8%,1h
35219,1,[dTemp]MaGeBaN,2409,494,14,11,25,56.0%,36m
35219,3,Maurits,2409,228,7,9,16,43.8%,1h
35219,3,IIIIIIIIIIII,2409,232,7,9,16,43.8%,32m
35219,1,Bumblebee,2409,138,5,7,12,41.7%,52m
35219,3,vili,2409,94,4,8,12,33.3%,1h
35219,2,Roggan,2409,124,4,12,16,25.0%,5m
35219,1,Licvin,2409,117,3,3,6,50.0%,34m
35219,3,SiSKOTRON,2409,0,3,3,6,50.0%,5m
35219,1,[Elva]Luna,2409,0,2,1,3,66.7%,1h
35219,1,noname,2409,40,2,2,4,50.0%,1h
35219,1,pineapple,2409,90,2,3,5,40.0%,34m
35219,1,[ZeRgg]Arseniy,2409,0,2,3,5,40.0%,31m
35219,1,Balder,2409,48,2,5,7,28.6%,25m
35219,1,KaptOrtega,2409,44,1,1,2,50.0%,50m
35219,1,LowApmLady,2409,38,1,1,2,50.0%,31m
35219,1,Jaegar,2409,0,1,4,5,20.0%,1h
35219,1,sturmtruppen,2409,0,1,4,5,20.0%,23m
35219,1,PiriaLRUSss,2409,0,0,1,1,0.0%,1h
35219,1,[HDNKBL]sebinger,2409,0,0,1,1,0.0%,20m
35219,1,[VVA]Amalah,2409,0,0,1,1,0.0%,15m
35219,1,[hexOr]насоксудьбы,2409,0,0,1,1,0.0%,38m
35219,1,Yasiu,2409,0,0,2,2,0.0%,31m
35249,1,Ярополкъ,2408,960,148,154,302,49.0%,1h
35249,3,Spoorey,2408,1372,119,116,235,50.6%,21m
35249,3,[ZuZi]Huares,2408,1182,60,55,115,52.2%,9m
35249,3,SilentFart,2408,1327,50,54,104,48.1%,5m
35249,2,robotdeha,2408,378,45,43,88,51.1%,52m
35249,1,Mateo,2408,1032,37,31,68,54.4%,1h
35249,3,Nethog,2408,93,28,27,55,50.9%,26m
35249,1,FaraonAng,2408,544,20,29,49,40.8%,15m
35249,2,[LaP1]Belgarath,2408,430,16,23,39,41.0%,14m
35249,2,Shadows,2408,360,13,19,32,40.6%,6m
35249,3,kosmos,2408,252,8,20,28,28.6%,19m
35249,1,Sherminator,2408,280,7,2,9,77.8%,18m
35249,2,TauntiO,2408,62,5,10,15,33.3%,13m
35249,1,george,2408,137,4,2,6,66.7%,1h
35249,3,adryan,2408,143,4,6,10,40.0%,22m
35249,1,Lupino,2408,181,4,7,11,36.4%,31m
35249,1,Mattcattt,2408,36,4,8,12,33.3%,38m
35249,3,Mikul,2408,171,4,10,14,28.6%,22m
35249,1,SWEETiCHERRY,2408,88,3,0,3,100.0%,13m
35249,3,Pennywise,2408,114,3,4,7,42.9%,14m
35249,1,[ccraft]bipbopman,2408,106,3,6,9,33.3%,49m
35249,3,Equalizer,2408,97,2,2,4,50.0%,1h
35249,1,Lipton,2408,0,1,0,1,100.0%,34m
35249,1,xPATTY,2408,0,1,1,2,50.0%,2m
35249,1,SardiLorant,2408,46,1,1,2,50.0%,23m
35249,1,IIIIIIIIIIII,2408,0,1,4,5,20.0%,20m
35249,1,anax,2408,0,1,8,9,11.1%,27m
35249,1,[YACooL]DarkM,2408,0,0,1,1,0.0%,1h
35277,3,Gregczan,2407,1530,203,197,400,50.8%,28m
35277,2,fross,2407,1545,112,116,228,49.1%,43m
35277,3,haagendazs,2407,1111,87,92,179,48.6%,48m
35277,1,FoCuS,2407,886,47,50,97,48.5%,5m
35277,3,SoulAsS,2407,623,44,46,90,48.9%,11m
35277,3,BORMASHINKA,2407,916,32,37,69,46.4%,11m
35277,2,Zoldon,2407,732,30,33,63,47.6%,7m
35277,3,cansines,2407,688,28,32,60,46.7%,24m
35277,2,BOJIDEMOP,2407,563,22,32,54,40.7%,47m
35277,3,eql,2407,474,17,20,37,45.9%,14m
35277,3,[0BO]Griselbrand,2407,425,14,12,26,53.8%,42m
35277,2,Elayus,2407,318,12,19,31,38.7%,44m
35277,3,Bercheck,2407,281,10,14,24,41.7%,33m
35277,2,IIII,2407,258,9,14,23,39.1%,43m
35277,2,Thorini,2407,211,8,11,19,42.1%,41m
35277,3,Serjezha,2407,188,7,6,13,53.8%,22m
35277,2,SuperKillir,2407,150,6,16,22,27.3%,14m
35277,3,[LosTG]Kingz,2407,193,5,7,12,41.7%,26m
35277,1,Tycyn,2407,189,5,7,12,41.7%,34m
35277,1,LuCKyNoOb,2407,86,3,1,4,75.0%,35m
35277,1,Astropanic,2407,97,2,2,4,50.0%,30m
35277,2,HaryMateulty,2407,0,2,5,7,28.6%,52m
35277,1,[0001]Bredator,2407,84,2,6,8,25.0%,25m
35277,1,BeeARE,2407,0,1,0,1,100.0%,37m
35277,1,Skurt,2407,0,1,1,2,50.0%,1h
35277,1,BraveLord,2407,0,1,3,4,25.0%,13m
35277,1,HeCorJlaCeH,2407,0,0,1,1,0.0%,9m
35277,1,IIIIIIIIII,2407,0,0,1,1,0.0%,26m
35277,1,Aosoth,2407,0,0,1,1,0.0%,1h
35277,3,MoonRise,2407,0,0,2,2,0.0%,28m
35307,2,anfaini,2406,1579,136,130,266,51.1%,40m
35307,3,Odium,2406,1132,79,71,150,52.7%,11m
35307,1,YaldiBA,2406,904,71,53,124,57.3%,45m
35307,2,ProToSS,2406,315,68,62,130,52.3%,29m
35307,3,Goman,2406,866,55,54,109,50.5%,42m
35307,3,[JotC]LilSavage,2406,541,33,22,55,60.0%,19m
35307,1,Eraser,2406,763,22,16,38,57.9%,2m
35307,3,Deymon,2406,600,22,19,41,53.7%,42m
35307,3,NIK,2406,218,14,12,26,53.8%,25m
35307,3,Vollstrecker,2406,341,12,15,27,44.4%,32m
35307,3,[lGGI]Redbeard,2406,334,12,15,27,44.4%,16m
35307,3,Grey,2406,302,11,14,25,44.0%,20m
35307,3,manarok,2406,264,10,17,27,37.0%,1h
35307,1,Nosorog,2406,275,8,4,12,66.7%,1h
35307,1,DenzelCurry,2406,231,7,6,13,53.8%,54m
35307,3,Ironfists,2406,188,7,12,19,36.8%,40m
35307,1,Rafterpl,2406,144,5,3,8,62.5%,9m
35307,1,user,2406,258,5,7,12,41.7%,1h
35307,1,TANKist,2406,130,4,3,7,57.1%,38m
35307,2,Zorg,2406,0,3,4,7,42.9%,1h
35307,1,Hercule,2406,130,3,5,8,37.5%,27m
35307,3,rimon,2406,36,3,7,10,30.0%,1h
35307,3,Flamindm,2406,30,2,4,6,33.3%,10m
35307,3,ProtonM,2406,70,2,7,9,22.2%,13m
35307,1,Wudmaan,2406,0,1,0,1,100.0%,31m
35307,3,SuperO,2406,0,1,1,2,50.0%,40m
35307,1,ZWERG,2406,0,1,2,3,33.3%,38m
35307,1,wurschdsalad,2406,0,1,4,5,20.0%,34m
35307,1,aliF,2406,0,1,4,5,20.0%,54m
35307,1,Venom,2406,0,0,1,1,0.0%,54m
35337,2,iBot,2405,1559,212,218,430,49.3%,29m
35337,3,Kacwil,2405,1330,54,50,104,51.9%,10m
35337,3,[DHCP]wolfman,2405,786,31,30,61,50.8%,54m
35337,3,Gargox,2405,703,28,24,52,53.8%,1h
35337,2,Jdl,2405,386,14,19,33,42.4%,16m
35337,3,Prokiller,2405,314,11,14,25,44.0%,11m
35337,3,Просто,2405,196,9,6,15,60.0%,27m
35337,3,BeautifulRUS,2405,174,5,2,7,71.4%,33m
35337,3,fantom,2405,163,5,5,10,50.0%,9m
35337,3,Bobjohn,2405,154,5,9,14,35.7%,6m
35337,1,Superduke,2405,143,5,10,15,33.3%,26m
35337,3,ChocoSpy,2405,143,4,4,8,50.0%,42m
35337,1,FrEnSeY,2405,133,4,7,11,36.4%,1h
35337,1,JanPeter,2405,116,4,8,12,33.3%,1h
35337,2,VRdog,2405,128,3,1,4,75.0%,20m
35337,3,Hakan,2405,88,3,8,11,27.3%,33m
35337,1,Lapa,2405,88,2,2,4,50.0%,31m
35337,1,Mathiue,2405,0,2,5,7,28.6%,24m
35337,1,Beljuril,2405,48,2,5,7,28.6%,15m
35337,1,[RxCh]AnalnyCherv,2405,0,1,0,1,100.0%,49m
35337,1,Gifrad,2405,0,1,1,2,50.0%,17m
35337,1,Seed,2405,0,0,1,1,0.0%,27m
35337,1,VikLeoM,2405,0,0,1,1,0.0%,48m
35337,1,pazap,2405,0,0,1,1,0.0%,34m
35337,3,SkeletonCrew,2405,0,0,5,5,0.0%,4m
35337,3,LEGEND,2405,0,0,6,6,0.0%,1h
35363,2,GenterReez,2404,1465,113,120,233,48.5%,1h
35363,3,XenO,2404,405,27,23,50,54.0%,24m
35363,1,drunkboy,2404,726,21,15,36,58.3%,38m
35363,3,Nanos,2404,510,18,22,40,45.0%,31m
35363,1,Blackstar,2404,472,13,9,22,59.1%,44m
35363,3,Dred,2404,312,11,10,21,52.4%,47m
35363,1,SirTrixalot,2404,314,9,5,14,64.3%,23m
35363,3,vlad,2404,275,8,9,17,47.1%,9m
35363,1,[MinLav]doisase,2404,270,7,6,13,53.8%,6m
35363,3,[WaCKi]MrMgr,2404,192,6,10,16,37.5%,9m
35363,1,CyklandeHora,2404,0,2,4,6,33.3%,32m
35363,2,Snitchez,2404,0,2,5,7,28.6%,5m
35363,3,Dayaqh,2404,0,2,6,8,25.0%,1h
35363,1,Nabulak,2404,0,0,1,1,0.0%,52m
35363,1,GeeODee,2404,0,0,1,1,0.0%,44m
35363,1,Natsu,2404,0,0,2,2,0.0%,38m
35363,1,SaevusPL,2404,0,0,2,2,0.0%,43m
35380,2,Adriss,2403,1432,60,60,120,50.0%,21m
35380,2,arcziburczi,2403,1567,59,66,125,47.2%,3m
35380,2,Хорадрим,2403,910,35,41,76,46.1%,44m
35380,3,VIVAMOS,2403,372,33,35,68,48.5%,5m
35380,3,[DTBMII]Vivacious,2403,459,28,22,50,56.0%,1h
35380,1,BrainBug,2403,742,25,17,42,59.5%,1h
35380,3,[БОДУН]Дух,2403,543,23,15,38,60.5%,10m
35380,3,Leicha,2403,445,20,13,33,60.6%,34m
35380,3,ArthurDent,2403,548,20,26,46,43.5%,31m
35380,2,[VarPe]Sanggi,2403,348,14,20,34,41.2%,1h
35380,1,III,2403,392,10,9,19,52.6%,7m
35380,3,IFreshP,2403,204,7,11,18,38.9%,14m
35380,2,Joel,2403,250,7,12,19,36.8%,11m
35380,3,Eclipserisp,2403,214,6,6,12,50.0%,48m
35380,3,François,2403,139,5,5,10,50.0%,40m
35380,2,Scouser,2403,94,5,5,10,50.0%,1h
35380,3,MaoTheFirst,2403,157,4,4,8,50.0%,52m
35380,3,Highler,2403,146,4,7,11,36.4%,48m
35380,1,SAINT,2403,0,3,2,5,60.0%,4m
35380,1,TAPAKAH,2403,0,3,2,5,60.0%,35m
35380,3,PingWon,2403,133,3,2,5,60.0%,13m
35380,1,QFalt,2403,0,3,2,5,60.0%,37m
35380,1,[ZЕRG7V]Mephisto,2403,48,3,6,9,33.3%,40m
35380,3,Altrakir,2403,58,2,8,10,20.0%,25m
35380,1,Fulliron,2403,0,1,0,1,100.0%,48m
35380,3,Amid,2403,0,1,4,5,20.0%,3m
35380,1,ThEsuNdIt,2403,0,1,4,5,20.0%,5m
35380,1,Twoflower,2403,0,0,1,1,0.0%,11m
35380,1,WMB,2403,0,0,1,1,0.0%,24m
35380,1,willy,2403,0,0,2,2,0.0%,33m
35410,3,IIIIIIIII,2402,1432,178,184,362,49.2%,31m
35410,2,DANPAN,2402,1530,143,141,284,50.4%,2m
35410,3,[3x3tea]fredparis,2402,1551,84,74,158,53.2%,9m
35410,2,Nallen,2402,1078,77,71,148,52.0%,50m
35410,3,cwZerro,2402,734,63,56,119,52.9%,20m
35410,3,ŴĤĬŦĒđŗå,2402,1497,59,62,121,48.8%,31m
35410,3,Terror,2402,449,35,30,65,53.8%,25m
35410,3,ckowarodka,2402,907,31,34,65,47.7%,38m
35410,1,SandroGames,2402,741,26,16,42,61.9%,42m
35410,3,GBL,2402,222,20,18,38,52.6%,18m
35410,3,[SKORM]AvoSkorm,2402,399,20,20,40,50.0%,27m
35410,3,Surtur,2402,486,18,15,33,54.5%,9m
35410,3,salvation,2402,451,17,18,35,48.6%,31m
35410,3,DeepSpace,2402,454,16,20,36,44.4%,18m
35410,3,Enkidu,2402,255,9,5,14,64.3%,10m
35410,3,[GLS]GéGé,2402,234,9,10,19,47.4%,52m
35410,1,ApeIIIeK,2402,266,8,7,15,53.3%,24m
35410,3,CJxOboectu,2402,133,7,6,13,53.8%,43m
35410,2,Pincho,2402,224,6,5,11,54.5%,2m
35410,3,[ROOLF]PsiStormer,2402,194,6,5,11,54.5%,44m
35410,3,Wizard,2402,173,5,7,12,41.7%,40m
35410,2,pedrucho,2402,113,5,13,18,27.8%,8m
35410,3,Blizerd,2402,0,3,3,6,50.0%,10m
35410,1,HariS,2402,96,3,5,8,37.5%,20m
35410,3,BlackMoore,2402,95,2,1,3,66.7%,10m
35410,1,neasi,2402,44,2,1,3,66.7%,20m
35410,3,dert,2402,62,2,7,9,22.2%,9m
35410,1,NOK,2402,44,1,1,2,50.0%,41m
35410,1,Akuma,2402,0,1,1,2,50.0%,38m
35410,1,bigstalker,2402,40,1,2,3,33.3%,49m
35410,1,Drewienko,2402,0,1,4,5,20.0%,27m
35410,3,cos,2402,0,0,1,1,0.0%,51m
35410,1,xMerkulx,2402,0,0,1,1,0.0%,23m
35410,1,Melligant,2402,0,0,1,1,0.0%,32m
35410,3,kkmmpl,2402,0,0,3,3,0.0%,3m
35445,1,Sultan,2401,1703,171,160,331,51.7%,41m
35445,2,Schnuckel,2401,1520,155,153,308,50.3%,35m
35445,2,Anisrewa,2401,1484,95,78,173,54.9%,6m
35445,1,[1231PH]Doomshoop,2401,1566,93,70,163,57.1%,5m
35445,3,sotesh,2401,1548,88,81,169,52.1%,22m
35445,3,TOtron,2401,607,24,21,45,53.3%,3m
35445,1,Jaux,2401,493,19,31,50,38.0%,52m
35445,3,Hellfyre,2401,384,17,20,37,45.9%,33m
35445,3,[4Nordy]Grrr,2401,394,16,23,39,41.0%,25m
35445,1,Ozarsif,2401,446,15,4,19,78.9%,41m
35445,3,pahipahi,2401,368,13,15,28,46.4%,37m
35445,1,Garibaldini,2401,308,8,5,13,61.5%,35m
35445,1,карізамба,2401,200,6,3,9,66.7%,49m
35445,3,Knollbaer,2401,152,6,8,14,42.9%,20m
35445,3,куркума,2401,152,6,8,14,42.9%,40m
35445,3,[uCHAD]KGXSparks,2401,124,5,6,11,45.5%,22m
35445,3,ASD,2401,72,5,8,13,38.5%,26m
35445,1,Ingeniator,2401,126,4,1,5,80.0%,51m
35445,3,[Svin4]DragonPig,2401,156,4,4,8,50.0%,24m
35445,3,Sasha,2401,137,4,6,10,40.0%,22m
35445,1,[Nz4L]Kwosie,2401,86,3,1,4,75.0%,1h
35445,1,CacheALot,2401,42,2,1,3,66.7%,15m
35445,1,KatopaktA,2401,0,2,3,5,40.0%,20m
35445,1,Spani,2401,0,2,3,5,40.0%,41m
35445,3,[DaFF]PinkyStar,2401,95,2,5,7,28.6%,9m
35445,1,[Белшир]BlackNinja,2401,0,2,7,9,22.2%,2m
35445,1,tomo,2401,0,1,4,5,20.0%,20m
35445,1,PhilSnow,2401,0,1,4,5,20.0%,27m
35445,2,hubert,2401,0,0,1,1,0.0%,5m
35445,3,NikeSuper,2401,0,0,2,2,0.0%,31m
35445,1,Rakmos,2401,0,0,2,2,0.0%,37m
35476,2,raduku,2400,1150,114,108,222,51.4%,20m
35476,1,heuretk,2400,1331,86,62,148,58.1%,17m
35476,1,lib,2400,539,80,82,162,49.4%,51m
35476,2,TaT,2400,1381,75,74,149,50.3%,7m
35476,1,[crabz]MauZeR,2400,1400,43,43,86,50.0%,5m
35476,3,TeraYankee,2400,439,37,30,67,55.2%,1h
35476,1,Kjiflm,2400,559,22,17,39,56.4%,1h
35476,1,Vulpes,2400,739,22,24,46,47.8%,18m
35476,3,[UscHi]Bruce,2400,610,22,25,47,46.8%,32m
35476,3,tecno,2400,424,15,13,28,53.6%,48m
35476,3,UETIX,2400,310,11,15,26,42.3%,21m
35476,2,kwekcreeper,2400,287,10,16,26,38.5%,40m
35476,3,Idicious,2400,253,9,7,16,56.2%,20m
35476,1,[DAHUS]Tom,2400,350,9,8,17,52.9%,1h
35476,3,Furion,2400,193,6,9,15,40.0%,52m
35476,2,Crowye,2400,58,5,14,19,26.3%,5m
35476,3,Bunny,2400,62,4,8,12,33.3%,50m
35476,1,Cimpresovec,2400,145,3,6,9,33.3%,28m
35476,1,pvh,2400,94,3,6,9,33.3%,13m
35476,1,[GTMNG]patadedouce,2400,130,3,7,10,30.0%,21m
35476,1,DAMNED,2400,0,1,0,1,100.0%,11m
35476,1,ProtectedOne,2400,44,1,1,2,50.0%,41m
35476,1,haxabx,2400,44,1,2,3,33.3%,9m
35476,3,[AciNoN]Invader,2400,94,1,2,3,33.3%,26m
35476,3,Karleg,2400,0,1,2,3,33.3%,37m
35476,1,iamfubar,2400,0,1,4,5,20.0%,37m
35476,1,[OVFD]Illidan,2400,0,1,4,5,20.0%,49m
35476,2,Eyzor,2400,30,1,8,9,11.1%,25m
35476,3,SonicLaruth,2400,0,0,1,1,0.0%,34m
35476,3,CHACAL,2400,0,0,5,5,0.0%,9m
35506,2,KissMyBack,2399,818,106,118,224,47.3%,21m
35506,1,Cosya,2399,1162,94,84,178,52.8%,48m
35506,2,VsemPizda,2399,1112,85,94,179,47.5%,35m
35506,1,NotSoGosu,2399,439,23,7,30,76.7%,33m
35506,2,ustyanmurad,2399,218,23,22,45,51.1%,52m
35506,1,Azazel,2399,497,17,6,23,73.9%,5m
35506,3,Pasha,2399,482,17,19,36,47.2%,21m
35506,1,SleepB,2399,536,14,13,27,51.9%,15m
35506,1,DANdeLion,2399,387,11,13,24,45.8%,24m
35506,1,Mateszopsz,2399,344,10,21,31,32.3%,44m
35506,3,[FTEII]FTElite,2399,276,9,16,25,36.0%,48m
35506,1,Dvolkeen,2399,150,8,3,11,72.7%,37m
35506,1,CalexQQwZ,2399,171,8,13,21,38.1%,9m
35506,2,CHILLMILL,2399,86,7,8,15,46.7%,40m
35506,3,SuPeReLoUx,2399,148,6,7,13,46.2%,1h
35506,1,Everon,2399,140,6,8,14,42.9%,35m
35506,3,retartedforu,2399,156,5,12,17,29.4%,25m
35506,1,[JJNB]skyjohn,2399,0,3,2,5,60.0%,32m
35506,1,[Овощи]zed,2399,133,3,3,6,50.0%,5m
35506,3,НямаНяма,2399,115,3,6,9,33.3%,16m
35506,2,Juri,2399,130,3,7,10,30.0%,28m
35506,1,[6House]Dagoth,2399,42,2,1,3,66.7%,6m
35506,1,GoDZz,2399,44,2,2,4,50.0%,1h
35506,1,Placebo,2399,48,2,5,7,28.6%,40m
35506,1,Mizrilsunset,2399,0,1,0,1,100.0%,41m
35506,1,[eAnoze]Nofer,2399,0,1,0,1,100.0%,35m
35506,1,alethomantis,2399,30,1,3,4,25.0%,37m
35506,1,Lance,2399,0,1,4,5,20.0%,52m
35506,1,Perrier,2399,0,1,4,5,20.0%,25m
35506,2,[FXB1]Bosancero,2399,0,1,7,8,12.5%,19m
35506,3,Olegas,2399,0,0,1,1,0.0%,16m
35506,1,ПростоДынька,2399,0,0,2,2,0.0%,32m
35506,1,SMETANA,2399,0,0,2,2,0.0%,37m
35506,3,[MPLC]Alex,2399,0,0,3,3,0.0%,18m
35540,2,MadSCV,2398,974,162,169,331,48.9%,32m
35540,3,Alyaki,2398,677,129,122,251,51.4%,11m
35540,2,Zaza,2398,769,79,72,151,52.3%,26m
35540,3,Louis,2398,1317,56,48,104,53.8%,9m
35540,2,mariovno,2398,324,49,52,101,48.5%,9m
35540,3,[hoh]Relf,2398,601,43,43,86,50.0%,6m
35540,3,Kardoss,2398,677,31,31,62,50.0%,16m
35540,1,litilyt,2398,504,14,12,26,53.8%,44m
35540,3,erutar,2398,236,9,12,21,42.9%,14m
35540,3,Dexter,2398,202,7,11,18,38.9%,43m
35540,2,[UF2AC]Anonimus,2398,166,5,7,12,41.7%,1h
35540,3,[CHLEN]chevengur,2398,148,5,8,13,38.5%,32m
35540,1,Semtex,2398,48,4,3,7,57.1%,1h
35540,1,IGoodLikerI,2398,130,3,2,5,60.0%,41m
35540,3,ZioSav,2398,102,3,2,5,60.0%,34m
35540,3,[AcesDK]Travis,2398,60,3,3,6,50.0%,5m
35540,3,AllenStorm,2398,30,3,5,8,37.5%,22m
35540,3,volc,2398,97,3,6,9,33.3%,8m
35540,2,YNW,2398,38,2,2,4,50.0%,26m
35540,3,[PANDR1]Syfer,2398,60,2,8,10,20.0%,33m
35540,3,[mfxed]Faldhir,2398,70,2,11,13,15.4%,19m
35540,1,Zogark,2398,0,1,1,2,50.0%,41m
35540,1,Barabasz,2398,44,1,1,2,50.0%,20m
35540,1,Artem,2398,0,1,3,4,25.0%,37m
35540,2,[KN0s]alegs,2398,42,1,4,5,20.0%,28m
35540,1,YbY,2398,0,1,4,5,20.0%,14m
35540,1,MaaCeeL,2398,48,1,6,7,14.3%,1h
35540,3,HATO,2398,34,1,10,11,9.1%,41m
35540,1,mark,2398,0,0,1,1,0.0%,20m
35540,3,NeroNex,2398,0,0,2,2,0.0%,34m
35540,1,HenryHuyPham,2398,0,0,2,2,0.0%,22m
35540,3,cungfuzerg,2398,0,0,3,3,0.0%,34m
35572,3,seelemann,2397,1533,133,132,265,50.2%,10m
35572,3,FLASH,2397,1367,93,92,185,50.3%,10m
35572,2,Wyndigo,2397,1449,67,54,121,55.4%,6m
35572,3,[beebop]Bloubi,2397,867,56,53,109,51.4%,41m
35572,1,cookielord,2397,1060,46,31,77,59.7%,33m
35572,2,Panda,2397,1184,44,50,94,46.8%,41m
35572,1,Volper,2397,752,29,18,47,61.7%,2m
35572,3,Vital,2397,659,26,22,48,54.2%,32m
35572,3,Wimbo,2397,625,24,24,48,50.0%,48m
35572,3,[KrSr]Lonkka,2397,563,21,21,42,50.0%,32m
35572,3,Tventinal,2397,342,21,22,43,48.8%,22m
35572,2,[FDJ]Nick,2397,564,18,25,43,41.9%,9m
35572,2,[31zig]Dzoni,2397,490,18,27,45,40.0%,16m
35572,3,Hakii,2397,466,17,22,39,43.6%,22m
35572,1,[Leek]SirKännsch,2397,564,16,10,26,61.5%,32m
35572,2,illewess,2397,206,10,11,21,47.6%,22m
35572,3,[daodao]Geranio,2397,298,10,14,24,41.7%,25m
35572,1,Adrien,2397,128,9,15,24,37.5%,5m
35572,1,MaDMaNssS,2397,245,7,1,8,87.5%,6m
35572,1,llllllllllll,2397,172,7,6,13,53.8%,11m
35572,3,Parabellum,2397,143,7,7,14,50.0%,26m
35572,1,WashUrHands,2397,228,7,10,17,41.2%,22m
35572,1,TobiHerol,2397,162,5,0,5,100.0%,4m
35572,1,[AiRǂ]Giovanni,2397,80,5,3,8,62.5%,25m
35572,3,[VRND]rotemj,2397,0,5,4,9,55.6%,26m
35572,1,IndoGrasaSRB,2397,132,4,1,5,80.0%,40m
35572,2,Arjona,2397,0,4,6,10,40.0%,17m
35572,3,GhstRprtng,2397,80,4,9,13,30.8%,1h
35572,1,vladxxx,2397,154,3,2,5,60.0%,38m
35572,3,Noctem,2397,38,3,7,10,30.0%,13m
35572,2,ALEROCAMPELO,2397,126,2,2,4,50.0%,26m
35572,3,[K1F]FraqFink,2397,0,1,3,4,25.0%,32m
35572,1,[NvMLG]Sixmercury,2397,0,1,4,5,20.0%,33m
35572,1,BASON,2397,0,1,4,5,20.0%,50m
35572,1,[Lidеr]Usual,2397,0,1,4,5,20.0%,38m
35572,3,Eyal,2397,0,1,5,6,16.7%,47m
35608,1,Youssef,2396,1556,276,279,555,49.7%,5m
35608,2,[NOT420]Misty,2396,930,187,198,385,48.6%,12m
35608,2,Udon,2396,1435,86,86,172,50.0%,38m
35608,1,[NOW]nukaza,2396,1195,86,87,173,49.7%,25m
35608,1,мортопл,2396,1617,74,59,133,55.6%,21m
35608,3,Fisken,2396,728,71,59,130,54.6%,17m
35608,1,[FOURRE]Tromax,2396,1035,36,31,67,53.7%,1h
35608,3,Lilcal,2396,659,28,29,57,49.1%,18m
35608,3,DanceJunkie,2396,730,27,31,58,46.6%,1h
35608,2,Gadzinka,2396,429,19,20,39,48.7%,44m
35608,2,Arty,2396,336,15,16,31,48.4%,44m
35608,3,Guest,2396,428,15,18,33,45.5%,24m
35608,3,backinblack,2396,152,14,26,40,35.0%,5m
35608,3,MaxHard,2396,363,13,12,25,52.0%,4m
35608,2,[123212]кирилл,2396,297,12,18,30,40.0%,29m
35608,1,Päron,2396,162,5,4,9,55.6%,36m
35608,1,Hmida,2396,166,4,2,6,66.7%,34m
35608,2,timotharoke,2396,157,4,4,8,50.0%,34m
35608,1,[owcInF]Burich,2396,191,4,6,10,40.0%,1h
35608,2,Kami,2396,60,4,7,11,36.4%,1h
35608,3,PROTOS,2396,143,3,4,7,42.9%,1h
35608,1,kudzo,2396,121,3,6,9,33.3%,1h
35608,2,herald,2396,0,3,8,11,27.3%,7m
35608,3,Xarizmant,2396,97,2,2,4,50.0%,33m
35608,1,[duz]Clakor,2396,88,2,2,4,50.0%,30m
35608,3,[Сold]IIIIIIIIIIII,2396,95,2,3,5,40.0%,36m
35608,3,GeneralDrake,2396,34,2,3,5,40.0%,1h
35608,1,JohnWick,2396,92,2,4,6,33.3%,25m
35608,1,[oOCo]Ozsy,2396,73,2,6,8,25.0%,9m
35608,1,Affero,2396,0,1,0,1,100.0%,50m
35608,1,[AETeam]STURM,2396,0,1,0,1,100.0%,20m
35608,1,[Trasch]SorryBud,2396,0,1,0,1,100.0%,29m
35608,1,crz,2396,0,1,0,1,100.0%,5m
35608,3,CmdFunackis,2396,97,1,1,2,50.0%,34m
35608,1,PulkundEmmie,2396,42,1,2,3,33.3%,16m
35608,1,DarkScythe,2396,0,1,4,5,20.0%,1h
35608,1,Opus,2396,0,1,5,6,16.7%,25m
35608,1,[SQInc]Will,2396,0,0,2,2,0.0%,1h
35608,1,[KievUA]ReezaK,2396,0,0,2,2,0.0%,22m
35647,3,TacoKarl,2395,1484,82,67,149,55.0%,1h
35647,1,[SC22SC]ЗлыеНоски,2395,803,24,17,41,58.5%,20m
35647,1,[DomPre]Garagok,2395,368,17,14,31,54.8%,1h
35647,3,JeAnCuAsEc,2395,467,16,18,34,47.1%,4m
35647,3,pashaytpo,2395,387,13,16,29,44.8%,17m
35647,3,Wolftron,2395,302,10,14,24,41.7%,39m
35647,1,PrinceAli,2395,355,9,5,14,64.3%,36m
35647,1,[iSARS]VarO,2395,257,8,10,18,44.4%,33m
35647,3,InfernoRoyal,2395,156,7,10,17,41.2%,41m
35647,1,[SCROo]SleazyWeazy,2395,247,7,18,25,28.0%,40m
35647,1,Amberman,2395,160,6,5,11,54.5%,32m
35647,2,grampp,2395,198,6,12,18,33.3%,19m
35647,1,[FISI]Fartmas,2395,78,4,4,8,50.0%,27m
35647,1,МНЕМОНИК,2395,130,4,4,8,50.0%,32m
35647,3,Phoenix,2395,64,4,5,9,44.4%,14m
35647,1,Tactician,2395,96,3,1,4,75.0%,20m
35647,1,[OvdM]moejoe,2395,130,3,3,6,50.0%,20m
35647,1,Helios,2395,42,3,4,7,42.9%,40m
35647,3,[BÄÄM]MrPrimeHD,2395,151,3,5,8,37.5%,11m
35647,1,Tamas,2395,145,3,5,8,37.5%,11m
35647,1,cKruk,2395,145,3,6,9,33.3%,22m
35647,1,Snuff,2395,38,3,7,10,30.0%,49m
35647,2,Гладиатор,2395,144,3,10,13,23.1%,1h
35647,1,Сверчок,2395,46,2,0,2,100.0%,43m
35647,1,[Cookes]GarryTonoff,2395,0,2,3,5,40.0%,48m
35647,1,topnoob,2395,88,2,3,5,40.0%,15m
35647,1,vovilonn,2395,0,1,0,1,100.0%,7m
35647,3,Quert,2395,0,1,1,2,50.0%,43m
35647,3,TheNewb,2395,0,1,1,2,50.0%,39m
35647,1,[3GBY]Kyrachkoka,2395,0,1,2,3,33.3%,12m
35647,1,LeBaguette,2395,0,1,6,7,14.3%,32m
35647,1,LucKy,2395,0,0,1,1,0.0%,15m
35647,3,Graf,2395,0,0,3,3,0.0%,11m
35680,1,Boroda,2394,1535,156,166,322,48.4%,1h
35680,2,Мик,2394,1331,138,131,269,51.3%,35m
35680,2,silicoid,2394,578,86,85,171,50.3%,40m
35680,3,mvw,2394,912,38,34,72,52.8%,10m
35680,2,лунь,2394,719,27,28,55,49.1%,1h
35680,1,[PVDG]Polter,2394,567,22,16,38,57.9%,1h
35680,1,Paul,2394,708,20,19,39,51.3%,20m
35680,2,[RuCrew]iloveyourmom,2394,418,15,21,36,41.7%,30m
35680,2,Gromflomite,2394,285,12,11,23,52.2%,48m
35680,3,EvilZerg,2394,308,11,2,13,84.6%,54m
35680,1,[wedown]Pollo,2394,337,8,4,12,66.7%,37m
35680,3,Yacon,2394,247,7,7,14,50.0%,34m
35680,2,Starlite,2394,112,7,8,15,46.7%,6m
35680,1,Wise,2394,208,5,6,11,45.5%,47m
35680,3,Olenevod,2394,0,4,2,6,66.7%,43m
35680,2,Inquisitor,2394,154,4,3,7,57.1%,43m
35680,3,ICE,2394,0,4,5,9,44.4%,33m
35680,1,conkid,2394,144,4,7,11,36.4%,48m
35680,2,Viola,2394,126,3,3,6,50.0%,34m
35680,1,[RiskHQ]aaa,2394,118,3,4,7,42.9%,35m
35680,3,Wolfovsky,2394,86,3,6,9,33.3%,18m
35680,2,Cebollino,2394,98,3,13,16,18.8%,40m
35680,1,Wice,2394,44,2,1,3,66.7%,41m
35680,1,Burzum,2394,0,2,3,5,40.0%,21m
35680,1,SEKİLSİNYA,2394,0,2,4,6,33.3%,33m
35680,3,osman,2394,119,2,6,8,25.0%,18m
35680,1,Wiksa,2394,44,1,2,3,33.3%,40m
35680,3,СЛонотоп,2394,30,1,4,5,20.0%,13m
35680,3,Daymos,2394,0,1,4,5,20.0%,1h
35680,1,GoldeadMage,2394,0,1,4,5,20.0%,20m
35680,3,Athanatos,2394,0,0,1,1,0.0%,22m
35680,1,CountDrugula,2394,0,0,1,1,0.0%,45m
35680,1,Brannstrom,2394,0,0,2,2,0.0%,2m
35713,3,[WarKak]Faggius,2393,1462,101,98,199,50.8%,4m
35713,2,Kaizen,2393,1297,96,92,188,51.1%,1h
35713,1,LLewis,2393,1825,81,76,157,51.6%,25m
35713,1,llllllllll,2393,1863,75,67,142,52.8%,33m
35713,2,ColonelWolf,2393,1100,48,44,92,52.2%,35m
35713,3,theDOT,2393,644,32,37,69,46.4%,11m
35713,1,бэимекс,2393,819,29,24,53,54.7%,18m
35713,3,Achaïos,2393,588,20,21,41,48.8%,28m
35713,3,Legion,2393,498,18,22,40,45.0%,22m
35713,3,Haggard,2393,363,16,22,38,42.1%,52m
35713,2,Minotaure,2393,450,15,23,38,39.5%,51m
35713,1,NoSkyvisible,2393,362,13,11,24,54.2%,21m
35713,3,KeepITcool,2393,360,13,15,28,46.4%,22m
35713,3,Aleksey,2393,298,10,8,18,55.6%,52m
35713,2,Jerkinator,2393,148,9,10,19,47.4%,25m
35713,3,Gebbeth,2393,203,8,13,21,38.1%,19m
35713,1,ggg,2393,284,7,6,13,53.8%,1h
35713,1,sergykTT,2393,212,6,6,12,50.0%,2m
35713,1,Scorpik,2393,40,4,2,6,66.7%,43m
35713,3,Кронос,2393,125,4,7,11,36.4%,5m
35713,3,Jomaro,2393,62,3,4,7,42.9%,15m
35713,2,Boomas,2393,46,3,6,9,33.3%,1h
35713,1,[Repto]SCII,2393,42,2,5,7,28.6%,25m
35713,1,Abrakadabra,2393,0,2,5,7,28.6%,41m
35713,1,ToxicEnginer,2393,97,2,5,7,28.6%,27m
35713,1,[PLG04]nbyv,2393,0,1,0,1,100.0%,41m
35713,1,IIIIIIIIIIII,2393,44,1,2,3,33.3%,21m
35713,1,XyLiGan,2393,48,1,3,4,25.0%,42m
35713,1,фырфырфыр,2393,0,1,4,5,20.0%,35m
35713,1,SeifMohamed,2393,0,1,5,6,16.7%,1h
35713,3,AssasineHell,2393,0,0,5,5,0.0%,22m
35744,1,zaza,2392,1657,155,142,297,52.2%,45m
35744,3,TwixArmy,2392,1050,44,37,81,54.3%,31m
35744,1,Backspace,2392,1096,41,44,85,48.2%,34m
35744,2,Какудзу,2392,858,32,40,72,44.4%,9m
35744,2,Kaiser,2392,808,28,39,67,41.8%,47m
35744,3,[BInArm]jona,2392,706,26,29,55,47.3%,26m
35744,1,Gheorghita,2392,827,24,18,42,57.1%,1h
35744,1,Aubrey,2392,670,23,12,35,65.7%,41m
35744,3,Yolandi,2392,524,21,18,39,53.8%,40m
35744,1,DINON,2392,610,19,18,37,51.4%,1h
35744,2,jmenya,2392,432,17,20,37,45.9%,52m
35744,3,[L3GND]KallumJones,2392,200,14,27,41,34.1%,16m
35744,3,Mexaformio,2392,328,12,8,20,60.0%,41m
35744,1,iceman,2392,381,10,11,21,47.6%,47m
35744,1,EJOA,2392,314,9,2,11,81.8%,32m
35744,2,Marc,2392,195,9,11,20,45.0%,19m
35744,1,timurka,2392,322,8,4,12,66.7%,50m
35744,3,Devis,2392,92,3,6,9,33.3%,48m
35744,1,noname,2392,48,3,6,9,33.3%,41m
35744,3,[Energy]Svenove,2392,88,3,10,13,23.1%,11m
35744,3,Heero,2392,123,2,2,4,50.0%,51m
35744,1,[NiUn]ZernatPL,2392,48,2,5,7,28.6%,41m
35744,1,LAVRON,2392,0,1,0,1,100.0%,17m
35744,1,astroboombo,2392,0,1,1,2,50.0%,44m
35744,1,[BornG]ZilvinasLT,2392,0,1,1,2,50.0%,38m
35744,1,Pupius,2392,44,1,2,3,33.3%,20m
35744,3,Дэвион,2392,0,1,4,5,20.0%,51m
35744,1,[4CB]Hooligan,2392,0,1,4,5,20.0%,24m
35744,3,promo,2392,30,1,8,9,11.1%,4m
35744,3,Logosh,2392,30,1,8,9,11.1%,13m
35744,1,NoRiLL,2392,0,0,1,1,0.0%,50m
35744,1,Alik,2392,0,0,2,2,0.0%,47m
35744,1,xouma,2392,0,0,2,2,0.0%,11m
35744,1,[FSID]Bouriquet,2392,0,0,7,7,0.0%,20m
35778,3,Rampant,2391,1274,98,100,198,49.5%,43m
35778,3,zoid,2391,1429,72,73,145,49.7%,32m
35778,1,Coconut,2391,1546,58,50,108,53.7%,9m
35778,2,Dalidul,2391,456,57,53,110,51.8%,19m
35778,3,rAzankAlt,2391,384,39,40,79,49.4%,11m
35778,3,ChrisZartre,2391,830,32,41,73,43.8%,1h
35778,3,doppleGG,2391,633,30,30,60,50.0%,32m
35778,2,linza,2391,761,30,33,63,47.6%,43m
35778,3,[Сold]Fix,2391,751,29,23,52,55.8%,14m
35778,1,Speedgaming,2391,789,29,30,59,49.2%,31m
35778,1,JuninhO,2391,573,18,12,30,60.0%,9m
35778,2,BlackHawk,2391,281,18,21,39,46.2%,36m
35778,1,bat,2391,405,15,10,25,60.0%,45m
35778,1,TNT,2391,468,14,5,19,73.7%,34m
35778,3,[NOOBpl]PiewcaBurzy,2391,399,14,16,30,46.7%,24m
35778,1,Shadow,2391,445,13,8,21,61.9%,41m
35778,1,OldWarHorse,2391,280,12,15,27,44.4%,54m
35778,1,Etilawin,2391,394,10,8,18,55.6%,44m
35778,3,Pintman,2391,191,9,4,13,69.2%,25m
35778,3,Pinpin,2391,252,9,13,22,40.9%,34m
35778,1,mortarion,2391,163,7,5,12,58.3%,48m
35778,1,SpideyPool,2391,203,6,6,12,50.0%,28m
35778,3,Sdgda,2391,179,5,8,13,38.5%,19m
35778,2,Mariusz,2391,149,5,8,13,38.5%,25m
35778,1,NowyGnat,2391,169,4,6,10,40.0%,22m
35778,1,SoBeIt,2391,122,3,1,4,75.0%,21m
35778,3,DaZerq,2391,95,3,4,7,42.9%,34m
35778,3,Egenskaber,2391,60,3,5,8,37.5%,10m
35778,1,attom,2391,88,2,1,3,66.7%,32m
35778,1,Baas,2391,44,2,2,4,50.0%,7m
35778,1,Ippokanthars,2391,0,2,3,5,40.0%,1h
35778,3,ligmalarva,2391,58,2,5,7,28.6%,26m
35778,1,[IceHus]Auf,2391,0,1,0,1,100.0%,32m
35778,1,alexander,2391,0,1,0,1,100.0%,32m
35778,3,Sek,2391,97,1,1,2,50.0%,18m
35778,1,geoff,2391,42,1,2,3,33.3%,24m
35778,2,Xéus,2391,90,1,3,4,25.0%,5m
35778,1,Ruslan,2391,0,1,4,5,20.0%,30m
35778,1,UncleOwen,2391,0,0,2,2,0.0%,30m
35778,2,saltan,2391,0,0,3,3,0.0%,6m
35778,1,Cvile,2391,0,0,5,5,0.0%,18m
35819,3,[FLZN]Dehran,2390,1341,98,93,191,51.3%,9m
35819,3,Rocu,2390,1245,85,77,162,52.5%,18m
35819,3,Diego,2390,1545,78,78,156,50.0%,52m
35819,3,Barrimor,2390,899,75,69,144,52.1%,1h
35819,3,MagicPants,2390,881,35,37,72,48.6%,51m
35819,1,[Нrr]Aspid,2390,901,30,21,51,58.8%,4m
35819,3,[EZ4XY]ZeuberTerran,2390,775,29,25,54,53.7%,9m
35819,2,Enthraax,2390,668,24,29,53,45.3%,2m
35819,1,xavier,2390,700,23,35,58,39.7%,5m
35819,2,Energizer,2390,583,22,31,53,41.5%,16m
35819,3,DerStier,2390,343,17,20,37,45.9%,17m
35819,1,philoux,2390,312,15,7,22,68.2%,43m
35819,1,Heffaman,2390,405,14,10,24,58.3%,5m
35819,2,DEXTER,2390,238,8,12,20,40.0%,1h
35819,1,Maksoncheg,2390,218,7,9,16,43.8%,5m
35819,3,[ValidG]Oliwhere,2390,198,6,1,7,85.7%,13m
35819,3,HANN,2390,0,4,4,8,50.0%,36m
35819,1,Draz,2390,54,3,2,5,60.0%,9m
35819,1,Victoriuss,2390,90,3,4,7,42.9%,15m
35819,3,DarkEgg,2390,137,3,6,9,33.3%,1h
35819,3,Prigorella,2390,86,3,7,10,30.0%,25m
35819,1,[poskot]StarChaser,2390,44,2,0,2,100.0%,17m
35819,1,Coltmax,2390,42,2,0,2,100.0%,26m
35819,3,PatBalkany,2390,123,2,4,6,33.3%,47m
35819,1,[Khimki]Ильяк,2390,42,1,1,2,50.0%,54m
35819,1,Mario,2390,0,1,1,2,50.0%,7m
35819,1,momommomom,2390,48,1,3,4,25.0%,15m
35819,1,han,2390,97,1,4,5,20.0%,32m
35819,1,Demiguras,2390,0,1,4,5,20.0%,36m
35819,1,Stargazer,2390,0,0,2,2,0.0%,15m
35819,3,Strannik,2390,0,0,2,2,0.0%,16m
35850,1,Darigam,2389,601,44,42,86,51.2%,6m
35850,3,Sagan,2389,446,17,22,39,43.6%,19m
35850,1,comertone,2389,416,13,12,25,52.0%,1h
35850,3,beemo,2389,359,13,15,28,46.4%,21m
35850,1,pol,2389,368,13,16,29,44.8%,31m
35850,2,FatalMix,2389,258,9,5,14,64.3%,44m
35850,3,Forsaken,2389,266,9,13,22,40.9%,13m
35850,1,SKALPEL,2389,193,7,6,13,53.8%,48m
35850,3,[VRND]Vidas,2389,188,5,7,12,41.7%,24m
35850,1,SergeyKiller,2389,218,5,7,12,41.7%,15m
35850,1,МегоДедс,2389,228,5,9,14,35.7%,30m
35850,3,бухряк,2389,93,3,4,7,42.9%,7m
35850,2,[ExTr1m]Gor,2389,88,3,5,8,37.5%,1h
35850,3,Shido,2389,152,3,6,9,33.3%,40m
35850,1,[PESTEL]Deathiel,2389,0,2,5,7,28.6%,27m
35850,1,[Wasp7]amah,2389,121,2,6,8,25.0%,40m
35850,1,Mity,2389,0,2,6,8,25.0%,43m
35850,1,[ЗЕRGТV]MaxManorn,2389,0,1,0,1,100.0%,1h
35850,1,Kassatka,2389,0,1,0,1,100.0%,31m
35850,1,[RGHz]jeremy,2389,0,1,0,1,100.0%,52m
35850,3,[nrkz]Sherbet,2389,30,1,1,2,50.0%,19m
35850,1,jessto,2389,0,1,2,3,33.3%,22m
35850,1,[YTCLYT]Krankster,2389,46,1,4,5,20.0%,35m
35850,1,kriss,2389,0,1,4,5,20.0%,48m
35850,1,Winter,2389,0,1,4,5,20.0%,36m
35850,1,CoffeeOnCat,2389,0,1,4,5,20.0%,20m
35850,3,ExEcRiP,2389,0,0,1,1,0.0%,53m
35850,1,melcor,2389,0,0,1,1,0.0%,26m
35850,1,Ferry,2389,0,0,1,1,0.0%,44m
35850,3,Крусник,2389,0,0,2,2,0.0%,5m
35850,3,призрак,2389,0,0,3,3,0.0%,33m
35850,1,Akatan,2389,0,0,7,7,0.0%,23m
35882,1,[CocoCo]Toby,2388,1414,123,126,249,49.4%,19m
35882,3,DarC,2388,969,39,39,78,50.0%,48m
35882,3,canonmaster,2388,743,38,16,54,70.4%,21m
35882,1,UTIS,2388,983,35,23,58,60.3%,37m
35882,1,stevsie,2388,948,35,25,60,58.3%,31m
35882,1,[DTC789]Joker,2388,510,29,11,40,72.5%,32m
35882,2,texnolog,2388,585,22,29,51,43.1%,36m
35882,1,[PÂRłAH]Fangate,2388,655,18,17,35,51.4%,54m
35882,2,Poleau,2388,361,13,17,30,43.3%,11m
35882,1,Escorial,2388,262,12,14,26,46.2%,44m
35882,2,LoLKicK,2388,249,9,11,20,45.0%,27m
35882,2,Иван,2388,258,8,6,14,57.1%,41m
35882,3,Garvug,2388,220,6,8,14,42.9%,15m
35882,3,szadi,2388,96,5,9,14,35.7%,51m
35882,3,maciejos,2388,0,3,3,6,50.0%,5m
35882,3,Phantomase,2388,123,3,4,7,42.9%,32m
35882,1,Bamford,2388,44,2,1,3,66.7%,18m
35882,1,emre,2388,0,1,2,3,33.3%,27m
35882,1,Starlight,2388,0,1,2,3,33.3%,54m
35882,1,[BMNL]goeij,2388,0,0,1,1,0.0%,48m
35882,1,astrobeglec,2388,0,0,1,1,0.0%,2m
35903,3,lfybkf,2387,1523,238,228,466,51.1%,10m
35903,3,ToniMontana,2387,1517,130,116,246,52.8%,41m
35903,1,CollWarning,2387,1860,97,89,186,52.2%,5m
35903,1,[ALPM]agentCAT,2387,1791,88,85,173,50.9%,1h
35903,3,imja,2387,1525,81,69,150,54.0%,49m
35903,3,Sopan,2387,1172,48,47,95,50.5%,16m
35903,3,Aion,2387,610,24,23,47,51.1%,1h
35903,1,TasteOfLife,2387,562,17,10,27,63.0%,31m
35903,3,[BCNG]Herking,2387,397,15,9,24,62.5%,14m
35903,1,EGORKA,2387,402,10,7,17,58.8%,20m
35903,1,[KoWo]Henning,2387,286,7,3,10,70.0%,32m
35903,3,HAPPYGOOSE,2387,238,7,8,15,46.7%,26m
35903,3,VorpalOnion,2387,159,5,3,8,62.5%,7m
35903,1,Wentrage,2387,144,5,7,12,41.7%,1h
35903,3,hahaha,2387,119,4,8,12,33.3%,36m
35903,2,ZemlyakOFF,2387,90,3,10,13,23.1%,9m
35903,3,BabyShark,2387,95,2,2,4,50.0%,40m
35903,1,Zealot,2387,44,2,2,4,50.0%,26m
35903,1,SchwingdeiDi,2387,86,2,4,6,33.3%,44m
35903,3,[Ark]Dariox,2387,60,2,5,7,28.6%,22m
35903,1,[DcBr]Aidion,2387,97,2,5,7,28.6%,1h
35903,1,Aaron,2387,0,2,6,8,25.0%,1h
35903,3,Msk,2387,60,2,6,8,25.0%,11m
35903,3,Spider,2387,0,2,6,8,25.0%,53m
35903,2,NoFo,2387,30,2,10,12,16.7%,52m
35903,1,[Medoed]Xolod,2387,0,1,0,1,100.0%,18m
35903,1,Rillo,2387,0,1,1,2,50.0%,1h
35903,1,Loktai,2387,48,1,2,3,33.3%,40m
35903,3,Tommi,2387,0,1,4,5,20.0%,53m
35903,1,Totmacher,2387,0,1,4,5,20.0%,24m
35903,1,[LITF]Radagast,2387,0,1,4,5,20.0%,1h
35903,1,Totera,2387,0,1,4,5,20.0%,21m
35903,1,[Fib8]Duster,2387,0,0,1,1,0.0%,5m
35903,1,facepalm,2387,0,0,2,2,0.0%,11m
35903,1,adminko,2387,0,0,2,2,0.0%,28m
35903,1,Valkyria,2387,0,0,5,5,0.0%,51m
35939,1,lamba,2386,1317,58,46,104,55.8%,34m
35939,3,Atar,2386,784,54,44,98,55.1%,18m
35939,2,Hydralisk,2386,1163,47,48,95,49.5%,8m
35939,3,[Z3RGML]AlexSt,2386,682,30,32,62,48.4%,26m
35939,1,Tom,2386,688,21,18,39,53.8%,49m
35939,3,[CYOSK]flöwrilège,2386,576,20,25,45,44.4%,52m
35939,2,rrroooaaa,2386,544,20,27,47,42.6%,40m
35939,1,[LPKT]LPKTFerski,2386,457,16,10,26,61.5%,39m
35939,3,Knurunkulus,2386,226,12,15,27,44.4%,33m
35939,3,Wheresmyjack,2386,219,10,9,19,52.6%,4m
35939,3,[SC12]AlexUAfan,2386,193,8,5,13,61.5%,1h
35939,3,LuckyPlayer,2386,206,8,11,19,42.1%,18m
35939,1,Radikal,2386,242,7,8,15,46.7%,11m
35939,3,ogy,2386,224,7,9,16,43.8%,9m
35939,1,teddy,2386,218,6,3,9,66.7%,15m
35939,2,xXOWNEDXx,2386,186,6,5,11,54.5%,17m
35939,3,Pirotehnik,2386,173,5,6,11,45.5%,16m
35939,3,BERSERG,2386,122,4,9,13,30.8%,8m
35939,1,[ANREN]aspiro,2386,128,3,3,6,50.0%,5m
35939,1,[NRGRX]Reepham,2386,145,3,6,9,33.3%,25m
35939,2,PinkyPanda,2386,0,3,7,10,30.0%,50m
35939,3,Xqwzts,2386,122,2,5,7,28.6%,9m
35939,1,Yans,2386,48,2,5,7,28.6%,32m
35939,1,DronchiG,2386,0,1,0,1,100.0%,1h
35939,1,Peperepipe,2386,0,1,1,2,50.0%,12m
35939,1,BenG,2386,73,1,1,2,50.0%,35m
35939,1,VeTerran,2386,44,1,2,3,33.3%,50m
35939,1,[UASC2]RaiderX,2386,0,0,1,1,0.0%,31m
35939,1,WorkerRush,2386,0,0,1,1,0.0%,44m
35939,1,PepeCosmico,2386,0,0,1,1,0.0%,47m
35939,1,LuckyTiger,2386,0,0,3,3,0.0%,49m
35939,3,[Drsnak]YaNo,2386,0,0,12,12,0.0%,15m
35971,1,tTireAuCoeur,2385,1743,73,65,138,52.9%,44m
35971,1,[chww]Stopka,2385,730,53,53,106,50.0%,24m
35971,1,pipo,2385,1013,44,22,66,66.7%,34m
35971,3,Omega,2385,914,43,44,87,49.4%,16m
35971,2,Kovalexius,2385,971,36,42,78,46.2%,22m
35971,3,Vuxes,2385,527,22,24,46,47.8%,43m
35971,1,MeGaFuN,2385,617,21,16,37,56.8%,20m
35971,3,MrGUnit,2385,528,19,20,39,48.7%,19m
35971,1,NotAGirl,2385,587,18,18,36,50.0%,1h
35971,3,Alex,2385,360,13,19,32,40.6%,43m
35971,1,[Listic]Traktobu,2385,353,11,2,13,84.6%,18m
35971,1,llllllllllll,2385,243,9,16,25,36.0%,17m
35971,1,Vildaris,2385,286,8,6,14,57.1%,43m
35971,1,Khqnado,2385,200,6,4,10,60.0%,18m
35971,1,DIMON,2385,256,6,6,12,50.0%,43m
35971,3,Hellos,2385,192,6,6,12,50.0%,48m
35971,3,Followup,2385,121,6,6,12,50.0%,30m
35971,1,Starkiller,2385,181,5,7,12,41.7%,9m
35971,3,Черепешка,2385,171,4,2,6,66.7%,5m
35971,1,FasBenDeR,2385,124,4,5,9,44.4%,7m
35971,3,[Аоуэйя]amoonRAA,2385,118,4,9,13,30.8%,34m
35971,1,Anacon,2385,48,3,6,9,33.3%,54m
35971,3,alex,2385,34,3,8,11,27.3%,28m
35971,1,Golan,2385,71,2,5,7,28.6%,42m
35971,1,Finnosaurus,2385,0,1,0,1,100.0%,46m
35971,1,[Chaven]Qwi,2385,0,1,0,1,100.0%,28m
35971,1,Fireside,2385,32,1,2,3,33.3%,9m
35971,2,Gena,2385,0,1,3,4,25.0%,45m
35971,3,[Аксис]Nikromka,2385,30,1,6,7,14.3%,43m
35971,1,[Щитон]Star,2385,0,0,1,1,0.0%,7m
35971,1,FireMan,2385,0,0,2,2,0.0%,2m
36002,3,vic,2384,1197,44,42,86,51.2%,52m
36002,3,Ardan,2384,819,39,36,75,52.0%,38m
36002,1,jijikong,2384,724,33,48,81,40.7%,1h
36002,3,[VerG]Vapowriser,2384,452,30,34,64,46.9%,4m
36002,2,Бобби,2384,446,15,25,40,37.5%,19m
36002,3,Merqury,2384,167,14,15,29,48.3%,51m
36002,2,remag,2384,272,11,13,24,45.8%,3m
36002,1,SgtPepper,2384,217,6,5,11,54.5%,45m
36002,1,[LBø]Soulthirsty,2384,170,6,9,15,40.0%,25m
36002,3,Trust,2384,195,6,9,15,40.0%,18m
36002,3,pheoniks,2384,121,3,7,10,30.0%,10m
36002,1,drumcode,2384,0,1,1,2,50.0%,2m
36002,1,noTuesday,2384,0,1,4,5,20.0%,1h
36002,1,WRW,2384,0,1,4,5,20.0%,48m
36002,1,Ares,2384,0,1,5,6,16.7%,25m
36017,3,noob,2383,1049,109,104,213,51.2%,25m
36017,1,Hollow,2383,1198,97,85,182,53.3%,33m
36017,2,Noobasik,2383,1206,80,84,164,48.8%,19m
36017,1,Rafael,2383,1805,75,69,144,52.1%,38m
36017,1,NOFX,2383,1648,56,53,109,51.4%,45m
36017,1,Sensei,2383,1382,53,54,107,49.5%,4m
36017,3,Bricox,2383,836,36,42,78,46.2%,25m
36017,3,BamBa,2383,440,29,31,60,48.3%,19m
36017,3,Tankist,2383,801,28,31,59,47.5%,39m
36017,3,PushOk,2383,541,21,23,44,47.7%,32m
36017,1,GloryHoole,2383,479,14,15,29,48.3%,17m
36017,3,Murison,2383,266,10,6,16,62.5%,13m
36017,1,Poppy,2383,332,10,12,22,45.5%,17m
36017,3,JonnyCoolGuy,2383,218,9,6,15,60.0%,1h
36017,1,dgksp,2383,302,8,12,20,40.0%,49m
36017,2,makaitis,2383,258,8,13,21,38.1%,34m
36017,1,thomaslesage,2383,284,7,9,16,43.8%,14m
36017,3,Holzfalter,2383,195,6,8,14,42.9%,5m
36017,1,dawids,2383,164,5,3,8,62.5%,39m
36017,2,Lucia,2383,132,4,7,11,36.4%,47m
36017,1,neponyal,2383,137,3,1,4,75.0%,1h
36017,2,Langstes,2383,0,3,2,5,60.0%,47m
36017,1,TheMauler,2383,130,3,3,6,50.0%,44m
36017,1,[LOOOOS]RobotVegan,2383,0,3,3,6,50.0%,30m
36017,1,[MFDP]lokias,2383,96,3,6,9,33.3%,54m
36017,3,tdxev,2383,30,2,4,6,33.3%,33m
36017,2,seventyOne,2383,0,1,0,1,100.0%,14m
36017,2,ssssergeyyyy,2383,88,1,2,3,33.3%,1h
36017,2,DerDiamant,2383,0,1,4,5,20.0%,53m
36017,1,Leonidas,2383,0,1,4,5,20.0%,29m
36017,1,Pacman,2383,0,0,2,2,0.0%,39m
36048,1,raduvladimir,2382,1839,150,151,301,49.8%,16m
36048,1,ХакуяСудзуку,2382,1045,38,39,77,49.4%,25m
36048,2,DOOF,2382,1100,37,47,84,44.0%,30m
36048,3,diepocke,2382,684,26,24,50,52.0%,5m
36048,1,Voodo,2382,566,18,12,30,60.0%,9m
36048,1,Conman,2382,364,16,7,23,69.6%,38m
36048,1,thl,2382,256,12,9,21,57.1%,12m
36048,3,Sanepid,2382,361,12,17,29,41.4%,1h
36048,2,[ZERGTV]Windu,2382,364,11,19,30,36.7%,24m
36048,1,SirReggae,2382,355,9,3,12,75.0%,25m
36048,2,Pipoulet,2382,182,9,18,27,33.3%,5m
36048,3,ZIF,2382,195,6,8,14,42.9%,34m
36048,1,cobra,2382,134,4,4,8,50.0%,17m
36048,1,GodKron,2382,96,4,7,11,36.4%,27m
36048,1,[FnGsGs]Egarly,2382,84,3,1,4,75.0%,31m
36048,2,[ZUBS]Freedge,2382,38,2,2,4,50.0%,17m
36048,1,Devilbat,2382,97,2,4,6,33.3%,1h
36048,2,gachiboy,2382,88,2,7,9,22.2%,11m
36048,1,Melkior,2382,0,1,0,1,100.0%,48m
36048,1,ColonelJay,2382,0,1,4,5,20.0%,37m
36048,1,[CCCCP]MaXFZ,2382,46,1,4,5,20.0%,38m
36048,2,VoronVolody,2382,0,1,4,5,20.0%,52m
36048,1,IamDanielV,2382,0,1,4,5,20.0%,31m
36048,2,кирилл,2382,94,1,5,6,16.7%,54m
36048,3,Talalakis,2382,30,1,6,7,14.3%,43m
36048,1,[OMiD]OUBLANK,2382,0,0,1,1,0.0%,35m
36048,3,Chrollo,2382,0,0,1,1,0.0%,1h
36048,1,Lyudmiliks,2382,0,0,1,1,0.0%,25m
36048,1,Antonf,2382,0,0,2,2,0.0%,7m
36048,1,Yokazan,2382,0,0,2,2,0.0%,44m
36048,2,[REGGE]DevilDjinn,2382,0,0,7,7,0.0%,38m
36079,3,Vitalikchu,2381,1409,174,177,351,49.6%,36m
36079,3,[GrGeek]Wrine,2381,1100,69,68,137,50.4%,6m
36079,3,[TTL]vasse,2381,1082,52,28,80,65.0%,49m
36079,1,kenny,2381,1334,48,57,105,45.7%,15m
36079,2,[BM3]BARRACUDAS,2381,468,16,24,40,40.0%,29m
36079,1,srečko,2381,472,13,11,24,54.2%,22m
36079,1,Matris,2381,510,13,13,26,50.0%,1h
36079,2,DREDD,2381,235,7,8,15,46.7%,45m
36079,1,Fixal,2381,214,6,13,19,31.6%,15m
36079,3,SINJU,2381,154,5,9,14,35.7%,40m
36079,3,Hommli,2381,88,4,5,9,44.4%,13m
36079,2,Samotichou,2381,44,4,8,12,33.3%,14m
36079,1,Виша,2381,145,3,3,6,50.0%,24m
36079,1,Nerusa,2381,130,3,3,6,50.0%,48m
36079,1,Hirokumata,2381,132,3,4,7,42.9%,25m
36079,1,DevilMayCry,2381,130,3,6,9,33.3%,45m
36079,1,Whatev,2381,112,2,5,7,28.6%,9m
36079,1,Ted,2381,0,0,1,1,0.0%,24m
36079,1,Warbomb,2381,0,0,1,1,0.0%,34m
36079,3,[BIRB]bluesyfluesy,2381,0,0,6,6,0.0%,4m
36099,3,MorganProtos,2380,1474,146,137,283,51.6%,5m
36099,1,[ZDUPIX]Sikurasaka,2380,1240,38,36,74,51.4%,15m
36099,3,DeadToCrown,2380,631,28,24,52,53.8%,8m
36099,3,Demonizzz,2380,533,23,25,48,47.9%,43m
36099,3,matrosen,2380,556,20,25,45,44.4%,11m
36099,2,STALKER,2380,670,20,30,50,40.0%,36m
36099,3,SweaTizZ,2380,278,11,6,17,64.7%,11m
36099,2,Forsaken,2380,233,8,7,15,53.3%,33m
36099,1,[HZSC2]ADIK,2380,246,7,7,14,50.0%,34m
36099,1,keffir,2380,286,7,8,15,46.7%,50m
36099,1,Adihasz,2380,169,6,4,10,60.0%,20m
36099,1,Halo,2380,252,6,6,12,50.0%,43m
36099,1,[KKUW]Gabor,2380,188,5,0,5,100.0%,26m
36099,3,zabo,2380,40,5,5,10,50.0%,41m
36099,1,[2005]Emixam,2380,0,3,2,5,60.0%,9m
36099,1,Sandor,2380,121,3,7,10,30.0%,22m
36099,1,Hodggins,2380,46,2,3,5,40.0%,40m
36099,3,Briga,2380,97,2,3,5,40.0%,32m
36099,1,Practice,2380,97,2,5,7,28.6%,29m
36099,1,Santiago,2380,48,2,6,8,25.0%,22m
36099,1,UFOjoe,2380,0,1,0,1,100.0%,1h
36099,3,Tyuwags,2380,97,1,1,2,50.0%,38m
36099,1,[MLL]Dunder,2380,0,1,4,5,20.0%,37m
36099,1,Jiff,2380,0,1,4,5,20.0%,1h
36099,1,Artanis,2380,0,1,4,5,20.0%,35m
36099,1,MSZ,2380,0,0,1,1,0.0%,32m
36099,3,[x786x]Kunikloj,2380,0,0,3,3,0.0%,1h
36126,3,TOR,2379,1561,188,170,358,52.5%,1h
36126,1,Altermann,2379,1539,151,161,312,48.4%,49m
36126,3,Kaiser,2379,1547,99,96,195,50.8%,1h
36126,3,MicMay,2379,1501,73,66,139,52.5%,42m
36126,3,Jou,2379,1146,42,47,89,47.2%,16m
36126,3,Grenadier,2379,1167,42,52,94,44.7%,43m
36126,3,ViSla,2379,1000,36,42,78,46.2%,32m
36126,1,Lillebror,2379,623,32,25,57,56.1%,34m
36126,2,SundayNight,2379,190,8,9,17,47.1%,4m
36126,3,[Koffie]DrGertMan,2379,255,8,20,28,28.6%,37m
36126,3,NickeL,2379,179,5,6,11,45.5%,5m
36126,2,wizinator,2379,78,5,10,15,33.3%,37m
36126,1,[3yeeti]TylerSursa,2379,124,4,3,7,57.1%,49m
36126,1,Condor,2379,78,4,5,9,44.4%,26m
36126,2,VeaPhiz,2379,40,2,2,4,50.0%,1h
36126,3,LayruS,2379,30,1,1,2,50.0%,1h
36126,1,Airpro,2379,0,1,1,2,50.0%,32m
36126,1,einer,2379,0,1,2,3,33.3%,39m
36126,1,YAYAP,2379,42,1,3,4,25.0%,9m
36126,1,FTwoAClick,2379,44,1,3,4,25.0%,11m
36126,1,Tenebror,2379,0,1,4,5,20.0%,22m
36126,3,Годограф,2379,0,1,4,5,20.0%,11m
36126,1,MAHO,2379,0,1,5,6,16.7%,1h
36126,1,CowKing,2379,0,0,1,1,0.0%,34m
36126,3,[owsht]Ste,2379,0,0,2,2,0.0%,47m
36126,1,Emmanuel,2379,0,0,3,3,0.0%,32m
36152,3,PNY,2378,1380,127,122,249,51.0%,49m
36152,1,FullMooner,2378,1832,111,99,210,52.9%,24m
36152,1,Ghortogg,2378,1427,78,74,152,51.3%,43m
36152,3,Macao,2378,689,47,47,94,50.0%,1h
36152,3,thelug,2378,322,19,24,43,44.2%,22m
36152,1,rambam,2378,488,15,12,27,55.6%,25m
36152,1,JonGalindo,2378,356,12,11,23,52.2%,32m
36152,1,[CGNCGN]LEONIDAS,2378,219,10,22,32,31.2%,12m
36152,1,pups,2378,206,6,5,11,54.5%,21m
36152,1,Hyoken,2378,214,6,6,12,50.0%,8m
36152,3,Clucker,2378,189,6,9,15,40.0%,51m
36152,3,Benji,2378,0,4,2,6,66.7%,11m
36152,1,DEIVOCE,2378,88,3,3,6,50.0%,11m
36152,1,noks,2378,0,1,0,1,100.0%,7m
36152,1,[КПCC]Skorpion,2378,44,1,1,2,50.0%,46m
36152,2,luku,2378,0,1,4,5,20.0%,13m
36152,2,MarciNeck,2378,0,1,4,5,20.0%,1h
36152,3,FaBbioX,2378,0,1,5,6,16.7%,42m
36152,1,Bolfenk,2378,0,0,1,1,0.0%,17m
36152,3,Sans,2378,0,0,2,2,0.0%,1h
36172,3,Riperko,2377,1555,252,240,492,51.2%,11m
36172,3,Olivcrer,2377,1505,88,89,177,49.7%,43m
36172,1,SouthPants,2377,826,35,29,64,54.7%,44m
36172,1,frei,2377,564,16,12,28,57.1%,32m
36172,1,eltax,2377,456,12,12,24,50.0%,34m
36172,2,Izaak,2377,312,11,12,23,47.8%,35m
36172,1,[228822]Sparky,2377,308,9,4,13,69.2%,47m
36172,1,DIMAS,2377,156,8,11,19,42.1%,32m
36172,3,Lipido,2377,226,7,8,15,46.7%,9m
36172,3,[CS0]FatalBritchs,2377,222,7,8,15,46.7%,25m
36172,1,Crim,2377,212,5,7,12,41.7%,1h
36172,1,[StTm]Svarog,2377,120,5,11,16,31.2%,1h
36172,1,Kharianne,2377,172,4,8,12,33.3%,40m
36172,1,Korzhik,2377,145,3,0,3,100.0%,27m
36172,2,BorMay,2377,138,3,1,4,75.0%,46m
36172,2,Appearance,2377,60,3,8,11,27.3%,38m
36172,1,Rüdiger,2377,112,2,2,4,50.0%,24m
36172,1,Maksim,2377,82,2,4,6,33.3%,5m
36172,1,Jakes,2377,76,2,5,7,28.6%,30m
36172,2,grougang,2377,0,2,6,8,25.0%,25m
36172,1,Zealot,2377,0,1,2,3,33.3%,15m
36172,1,Кузяка,2377,46,1,3,4,25.0%,6m
36172,1,odisea,2377,0,1,4,5,20.0%,29m
36172,1,Martinus,2377,0,1,4,5,20.0%,40m
36172,1,Константин,2377,0,1,4,5,20.0%,35m
36172,3,Lotw,2377,30,1,6,7,14.3%,51m
36172,1,carrera,2377,0,0,1,1,0.0%,50m
36172,1,Arach,2377,0,0,1,1,0.0%,48m
36172,1,[Preyin]Kuraj,2377,0,0,1,1,0.0%,41m
36172,1,bob,2377,0,0,1,1,0.0%,52m
36172,1,Dunder,2377,0,0,2,2,0.0%,54m
36172,2,Bred,2377,0,0,3,3,0.0%,34m
36204,3,iMax,2376,1536,91,80,171,53.2%,47m
36204,1,fafaf,2376,1845,72,71,143,50.3%,1h
36204,1,[FJW]Bedge,2376,879,52,41,93,55.9%,34m
36204,3,marco,2376,760,28,31,59,47.5%,1h
36204,3,Jéso,2376,371,16,21,37,43.2%,25m
36204,3,[COОP]Lexx,2376,446,15,20,35,42.9%,9m
36204,1,[KG312]ARHont,2376,400,10,8,18,55.6%,10m
36204,2,Matacuy,2376,248,9,11,20,45.0%,54m
36204,1,BroStark,2376,291,8,6,14,57.1%,12m
36204,3,React,2376,240,8,7,15,53.3%,32m
36204,1,ZOM,2376,275,8,8,16,50.0%,4m
36204,2,Sanya,2376,196,7,16,23,30.4%,15m
36204,2,DarkKnight,2376,131,6,0,6,100.0%,1h
36204,3,Мяу,2376,149,6,6,12,50.0%,14m
36204,1,[WRZero]Markus,2376,186,6,8,14,42.9%,48m
36204,3,toto,2376,171,6,9,15,40.0%,41m
36204,3,[SPAINs]Selassie,2376,227,6,10,16,37.5%,36m
36204,1,[FR1]ShahKaal,2376,210,5,7,12,41.7%,17m
36204,1,Konstantin,2376,122,4,1,5,80.0%,18m
36204,1,Netnika,2376,170,4,6,10,40.0%,30m
36204,3,Dinosaur,2376,94,4,10,14,28.6%,52m
36204,2,[NepSAO]RenTerkYT,2376,125,3,1,4,75.0%,42m
36204,1,Clemsoth,2376,126,3,3,6,50.0%,32m
36204,1,Maciek,2376,96,3,7,10,30.0%,32m
36204,3,BilliClean,2376,36,3,7,10,30.0%,1h
36204,1,SadnIUss,2376,44,2,0,2,100.0%,52m
36204,1,Moana,2376,86,2,1,3,66.7%,25m
36204,1,Max,2376,46,2,4,6,33.3%,3m
36204,3,[Z0815]McBrinky,2376,0,2,7,9,22.2%,22m
36204,1,Foma,2376,0,1,0,1,100.0%,42m
36204,1,[FDJ]Dos,2376,44,1,1,2,50.0%,29m
36204,1,Kwak,2376,42,1,2,3,33.3%,21m
36204,2,Денис,2376,0,1,4,5,20.0%,25m
36204,2,Realyn,2376,0,1,4,5,20.0%,36m
36204,1,Jak,2376,0,1,4,5,20.0%,33m
36204,1,Hbear,2376,0,0,1,1,0.0%,35m
36204,1,Tankomen,2376,0,0,1,1,0.0%,21m
36204,1,Liic,2376,0,0,1,1,0.0%,11m
36204,1,Holyflame,2376,0,0,3,3,0.0%,1h
36243,1,Ferrox,2375,1837,77,74,151,51.0%,40m
36243,1,REVALANTIS,2375,1096,69,63,132,52.3%,1h
36243,3,Baltar,2375,938,55,47,102,53.9%,4m
36243,2,Horadrim,2375,1215,48,53,101,47.5%,39m
36243,3,[xBaTx]DerDude,2375,817,32,39,71,45.1%,27m
36243,1,KibeRChlen,2375,304,16,27,43,37.2%,37m
36243,3,JunglePanda,2375,313,11,14,25,44.0%,13m
36243,3,Pipo,2375,312,9,19,28,32.1%,13m
36243,3,StAlmen,2375,235,8,8,16,50.0%,20m
36243,2,[HHydra]Geggo,2375,182,8,11,19,42.1%,21m
36243,3,nightwings,2375,170,6,6,12,50.0%,1h
36243,3,Barreto,2375,221,6,6,12,50.0%,4m
36243,1,FishA,2375,166,5,4,9,55.6%,24m
36243,3,[Zhig]VICTOR,2375,124,5,7,12,41.7%,11m
36243,3,LooMiS,2375,186,5,10,15,33.3%,15m
36243,2,[ZЕRG7V]SkiFi,2375,160,5,11,16,31.2%,6m
36243,3,ADANRO,2375,131,4,8,12,33.3%,40m
36243,1,FlyTrox,2375,84,3,0,3,100.0%,41m
36243,1,BagpipeSnipe,2375,44,1,2,3,33.3%,40m
36243,2,Rolfsson,2375,0,1,4,5,20.0%,50m
36243,1,Kirteezy,2375,0,1,4,5,20.0%,1h
36243,2,[APMM]MauserCole,2375,0,1,4,5,20.0%,1h
36265,3,NekroN,2374,912,41,48,89,46.1%,14m
36265,2,tamagochan,2374,292,28,31,59,47.5%,51m
36265,1,Ghost,2374,549,27,29,56,48.2%,1h
36265,3,TheCapybara,2374,321,23,24,47,48.9%,32m
36265,1,Evgenii,2374,478,21,15,36,58.3%,7m
36265,3,Reid,2374,524,21,25,46,45.7%,40m
36265,3,BaoBabNik,2374,588,21,25,46,45.7%,52m
36265,3,MarknütRösti,2374,590,20,24,44,45.5%,25m
36265,3,Xomokok,2374,339,12,14,26,46.2%,19m
36265,3,natrake,2374,335,12,15,27,44.4%,52m
36265,1,[STDES]dondiablo,2374,325,9,4,13,69.2%,30m
36265,2,BellowYou,2374,153,5,3,8,62.5%,53m
36265,1,Alex,2374,73,4,3,7,57.1%,42m
36265,1,[BSK88]Amberjade,2374,96,4,6,10,40.0%,1h
36265,1,Egr,2374,89,3,4,7,42.9%,1h
36265,1,Vidarius,2374,42,2,0,2,100.0%,8m
36265,1,safasasha,2374,82,2,1,3,66.7%,4m
36265,1,DeePhazed,2374,0,2,4,6,33.3%,1h
36265,3,Toxic,2374,0,2,4,6,33.3%,33m
36265,1,Shironai,2374,0,2,5,7,28.6%,11m
36265,1,Pedrox,2374,97,2,5,7,28.6%,18m
36265,3,Kaleostra,2374,96,2,5,7,28.6%,10m
36265,1,sett,2374,0,1,0,1,100.0%,44m
36265,2,toksin,2374,0,1,0,1,100.0%,35m
36265,1,lowIqProtoss,2374,0,1,0,1,100.0%,9m
36265,3,[GCorps]Alltracks,2374,0,1,1,2,50.0%,6m
36265,2,[Titor]Destroyer,2374,0,1,4,5,20.0%,47m
36265,1,Goblin,2374,0,1,4,5,20.0%,3m
36265,1,[PIML]blackpanter,2374,0,0,1,1,0.0%,42m
36265,3,bolshak,2374,0,0,1,1,0.0%,13m
36265,1,kIRa,2374,0,0,1,1,0.0%,25m
36265,2,GoadProTosS,2374,0,0,3,3,0.0%,25m
36297,3,[620pir]blackmamba,2373,1549,348,352,700,49.7%,41m
36297,3,serpik,2373,1420,128,115,243,52.7%,10m
36297,3,biverknight,2373,1393,98,101,199,49.2%,34m
36297,1,Epigen,2373,1359,65,59,124,52.4%,32m
36297,2,zhouyi,2373,803,48,47,95,50.5%,35m
36297,3,vecchiouomo,2373,877,37,30,67,55.2%,19m
36297,2,DrPepper,2373,769,28,39,67,41.8%,36m
36297,1,Povstanets,2373,548,19,11,30,63.3%,1h
36297,3,ERIZO,2373,459,17,16,33,51.5%,1h
36297,3,GHOST,2373,457,17,16,33,51.5%,22m
36297,3,ReSeTer,2373,461,17,21,38,44.7%,21m
36297,3,coasn,2373,411,17,24,41,41.5%,1h
36297,3,Niziur,2373,374,15,25,40,37.5%,39m
36297,1,maniac,2373,236,13,16,29,44.8%,32m
36297,3,[ŽALIA]Ninxee,2373,232,9,11,20,45.0%,4m
36297,1,Alfirionfirs,2373,269,8,11,19,42.1%,22m
36297,1,SirJim,2373,256,6,9,15,40.0%,33m
36297,3,hladnokraven,2373,224,6,9,15,40.0%,13m
36297,1,[TLB]LampoGiallo,2373,120,5,6,11,45.5%,1h
36297,1,Sedrick,2373,192,5,8,13,38.5%,18m
36297,1,Prizrak,2373,80,4,3,7,57.1%,30m
36297,2,Xytos,2373,144,4,6,10,40.0%,1h
36297,1,FACODIEZ,2373,123,3,1,4,75.0%,1h
36297,1,HuHaHanZ,2373,80,3,2,5,60.0%,28m
36297,1,Boemz,2373,91,3,2,5,60.0%,1h
36297,1,[ANREN]deadlader,2373,124,3,4,7,42.9%,34m
36297,3,popman,2373,121,3,6,9,33.3%,47m
36297,1,JimTim,2373,128,3,7,10,30.0%,28m
36297,1,розовыйзайка,2373,73,2,6,8,25.0%,39m
36297,1,[SNHE]LillStinsen,2373,0,1,0,1,100.0%,46m
36297,1,vuk,2373,0,1,0,1,100.0%,26m
36297,1,Diak,2373,42,1,1,2,50.0%,45m
36297,3,JohnGagas,2373,0,1,4,5,20.0%,29m
36297,1,BoyNextDoor,2373,0,1,4,5,20.0%,48m
36297,1,[LCN]BossEscuDero,2373,0,0,1,1,0.0%,1h
36332,1,Lilit,2372,1470,68,81,149,45.6%,16m
36332,3,WOZBUHATEL,2372,1225,61,57,118,51.7%,22m
36332,2,JanSolo,2372,1270,55,71,126,43.7%,45m
36332,1,[lBSGl]KotBegemot,2372,780,24,18,42,57.1%,45m
36332,2,kronos,2372,659,24,34,58,41.4%,47m
36332,1,Orrath,2372,611,23,24,47,48.9%,9m
36332,3,OneWolf,2372,405,15,11,26,57.7%,10m
36332,3,VIRTUS,2372,220,9,7,16,56.2%,41m
36332,1,Cemo,2372,244,7,4,11,63.6%,15m
36332,1,BYuN,2372,269,7,5,12,58.3%,41m
36332,2,[HHydra]Stockschütze,2372,104,7,8,15,46.7%,21m
36332,1,TheLoser,2372,204,6,5,11,54.5%,43m
36332,3,YukioIbuki,2372,180,6,10,16,37.5%,1h
36332,2,картошка,2372,48,4,8,12,33.3%,51m
36332,1,omar,2372,0,3,2,5,60.0%,40m
36332,1,[XDalek]Tsuki,2372,88,3,3,6,50.0%,50m
36332,1,snab,2372,86,3,5,8,37.5%,28m
36332,2,Copperhead,2372,30,3,7,10,30.0%,13m
36332,3,SKD,2372,97,2,2,4,50.0%,2m
36332,1,Hyaena,2372,82,2,3,5,40.0%,40m
36332,3,Butcher,2372,0,2,3,5,40.0%,32m
36332,1,Dozia,2372,40,1,3,4,25.0%,32m
36332,1,Popondos,2372,0,1,3,4,25.0%,1h
36332,2,PTR,2372,0,1,4,5,20.0%,33m
36332,1,VaviMax,2372,0,0,1,1,0.0%,1h
36332,1,[A0V]Isolation,2372,0,0,2,2,0.0%,34m
36332,3,deaDMan,2372,0,0,7,7,0.0%,18m
36359,1,Elessar,2371,1732,249,252,501,49.7%,8m
36359,3,Hardek,2371,946,118,118,236,50.0%,10m
36359,1,VinnyJazz,2371,1115,38,32,70,54.3%,31m
36359,3,[NvBD]Starwings,2371,465,36,38,74,48.6%,33m
36359,1,ExBrain,2371,297,29,41,70,41.4%,43m
36359,3,IIIIIIIIIIII,2371,204,22,22,44,50.0%,43m
36359,1,simon,2371,472,15,13,28,53.6%,1h
36359,1,DiDoK,2371,516,14,8,22,63.6%,5m
36359,2,Chillipepper,2371,379,14,19,33,42.4%,23m
36359,1,zloyBOBER,2371,424,13,15,28,46.4%,21m
36359,2,HueGerection,2371,229,7,13,20,35.0%,36m
36359,1,tupaartem,2371,200,6,6,12,50.0%,48m
36359,1,Rakomkabana,2371,233,6,13,19,31.6%,1h
36359,3,Carlozipopof,2371,30,5,3,8,62.5%,41m
36359,1,Alex,2371,172,5,4,9,55.6%,41m
36359,1,VlaDFoX,2371,150,4,2,6,66.7%,8m
36359,1,[59APM]Operatiwka,2371,38,2,0,2,100.0%,52m
36359,1,RAIMOND,2371,97,2,5,7,28.6%,22m
36359,1,Neteran,2371,0,1,0,1,100.0%,44m
36359,1,Алексей,2371,0,1,2,3,33.3%,31m
36359,2,DarkTao,2371,0,1,4,5,20.0%,47m
36359,1,[Hrѓ]LoliesHunter,2371,0,1,4,5,20.0%,1h
36359,2,Xiaranis,2371,0,1,4,5,20.0%,39m
36359,1,AlaRack,2371,0,1,4,5,20.0%,28m
36359,3,[0110]xelaleo,2371,0,0,1,1,0.0%,14m
36359,1,SirMoLoH,2371,0,0,1,1,0.0%,20m
36359,1,mattitan,2371,0,0,1,1,0.0%,24m
36359,1,ATOMICCOW,2371,0,0,1,1,0.0%,45m
36359,1,Asasin,2371,0,0,1,1,0.0%,32m
36359,2,elserralfake,2371,0,0,8,8,0.0%,30m
36389,3,Dvorf,2370,1576,121,123,244,49.6%,22m
36389,3,[JaPP]Infestorrr,2370,1023,92,90,182,50.5%,21m
36389,1,troufion,2370,1513,77,86,163,47.2%,38m
36389,1,Mips,2370,1687,76,70,146,52.1%,51m
36389,1,Maksimus,2370,827,63,55,118,53.4%,25m
36389,3,Gorgoliano,2370,450,16,16,32,50.0%,41m
36389,3,Den,2370,382,13,15,28,46.4%,25m
36389,3,BadWolf,2370,323,13,19,32,40.6%,11m
36389,1,докторЛешый,2370,429,11,12,23,47.8%,54m
36389,1,Skywood,2370,326,8,5,13,61.5%,34m
36389,3,camper,2370,233,8,6,14,57.1%,25m
36389,1,Terran,2370,152,6,6,12,50.0%,34m
36389,1,DearekMeldon,2370,157,5,3,8,62.5%,32m
36389,3,[MinLav]KikuSan,2370,186,5,7,12,41.7%,1h
36389,3,executioner,2370,124,5,8,13,38.5%,24m
36389,1,Роман,2370,210,5,8,13,38.5%,42m
36389,1,alexdi,2370,36,4,7,11,36.4%,4m
36389,1,ermian,2370,128,4,8,12,33.3%,36m
36389,3,Slava,2370,120,4,9,13,30.8%,11m
36389,1,Luca,2370,82,3,1,4,75.0%,8m
36389,1,Spirit,2370,48,3,5,8,37.5%,22m
36389,3,llllllllllll,2370,62,3,6,9,33.3%,5m
36389,1,IIIIIIIIIIII,2370,144,3,9,12,25.0%,16m
36389,3,[Mafl27]Joell,2370,94,2,2,4,50.0%,23m
36389,1,[Harepa]Krantzo,2370,97,2,3,5,40.0%,29m
36389,2,Vulcan,2370,0,2,3,5,40.0%,8m
36389,3,Mioz,2370,0,2,6,8,25.0%,13m
36389,2,RopedIronG,2370,0,2,6,8,25.0%,31m
36389,1,HellsCream,2370,0,1,1,2,50.0%,30m
36389,1,HAZE,2370,0,1,3,4,25.0%,25m
36389,1,edward,2370,48,1,3,4,25.0%,1h
36389,1,Amayoshin,2370,0,1,4,5,20.0%,44m
36389,2,clacbec,2370,0,1,7,8,12.5%,4m
36389,1,CRuser,2370,0,0,1,1,0.0%,21m
36389,1,Marsala,2370,0,0,1,1,0.0%,2m
36424,1,[VdpV]PloKoon,2369,1369,102,103,205,49.8%,15m
36424,3,[GdAT]TOLAR,2369,1426,93,84,177,52.5%,21m
36424,1,Gottlob,2369,1849,71,74,145,49.0%,1h
36424,1,PartyHard,2369,1496,57,53,110,51.8%,22m
36424,3,skols,2369,608,40,42,82,48.8%,24m
36424,1,Tsymb,2369,644,17,21,38,44.7%,50m
36424,3,Рустам,2369,331,12,14,26,46.2%,22m
36424,3,kengo,2369,274,9,8,17,52.9%,11m
36424,1,Elgreen,2369,219,6,10,16,37.5%,29m
36424,3,Nyuu,2369,180,6,11,17,35.3%,43m
36424,1,[K4M]Kevain,2369,201,5,2,7,71.4%,26m
36424,1,raiziN,2369,86,4,2,6,66.7%,48m
36424,3,[TWGs]RefundGirl,2369,30,4,5,9,44.4%,10m
36424,1,Yamato,2369,46,3,10,13,23.1%,28m
36424,1,Hakuda,2369,42,2,0,2,100.0%,30m
36424,1,instasamka,2369,112,2,2,4,50.0%,24m
36424,1,ZeenDR,2369,44,2,3,5,40.0%,46m
36424,1,Boberg,2369,48,2,6,8,25.0%,29m
36424,2,[OSM40]darthebe,2369,30,2,6,8,25.0%,43m
36424,1,Prototype,2369,0,1,0,1,100.0%,14m
36424,1,макс,2369,0,1,0,1,100.0%,39m
36424,1,KitoNiishima,2369,40,1,1,2,50.0%,1h
36424,1,Crack,2369,97,1,2,3,33.3%,36m
36424,3,[oooboy]Qacezoxy,2369,96,1,3,4,25.0%,20m
36424,1,daangast,2369,0,1,3,4,25.0%,17m
36424,2,metathron,2369,0,1,4,5,20.0%,50m
36424,1,MORYTZ,2369,0,0,1,1,0.0%,39m
36424,1,Kokelikot,2369,0,0,1,1,0.0%,37m
36424,2,[Nbsply]Timotheos,2369,0,0,4,4,0.0%,25m
36424,3,Marekano,2369,0,0,5,5,0.0%,44m
36454,3,Marijo,2368,1294,109,112,221,49.3%,6m
36454,1,Craisedx,2368,1551,92,76,168,54.8%,43m
36454,3,Yagami,2368,1513,59,63,122,48.4%,11m
36454,1,conman,2368,1169,49,45,94,52.1%,39m
36454,1,PsychX,2368,1386,45,47,92,48.9%,10m
36454,3,Topsi,2368,797,38,28,66,57.6%,1h
36454,1,Devilake,2368,672,33,16,49,67.3%,1h
36454,3,Busat,2368,869,31,31,62,50.0%,43m
36454,3,JyrianCJmax,2368,652,24,26,50,48.0%,4m
36454,1,GhostDragon,2368,331,13,8,21,61.9%,6m
36454,2,Kyrberg,2368,233,12,10,22,54.5%,44m
36454,1,[OGiK]AlexAnal,2368,366,9,6,15,60.0%,31m
36454,1,Chubaka,2368,279,8,7,15,53.3%,45m
36454,2,CichyMZKS,2368,228,7,6,13,53.8%,33m
36454,1,Ultrawork,2368,210,5,5,10,50.0%,16m
36454,1,[3AW]IIIIIIIIIIII,2368,159,5,6,11,45.5%,1h
36454,1,Baneling,2368,113,2,3,5,40.0%,10m
36454,1,SPIRT,2368,0,1,0,1,100.0%,36m
36454,1,Sudden,2368,48,1,2,3,33.3%,26m
36454,1,LutiK,2368,0,0,1,1,0.0%,32m
36454,1,Danhack,2368,0,0,1,1,0.0%,31m
36454,1,[Jail]VIctorDestro,2368,0,0,3,3,0.0%,1h
36476,3,Alexandru,2367,1084,55,54,109,50.5%,4m
36476,3,maximepmr,2367,828,38,30,68,55.9%,11m
36476,1,[TuPiZi]Podojdite,2367,697,36,47,83,43.4%,2m
36476,2,[RuinZ]Annihilation,2367,856,34,38,72,47.2%,39m
36476,3,Jamie,2367,746,29,30,59,49.2%,18m
36476,1,Totowipeout,2367,744,25,19,44,56.8%,17m
36476,2,Wipebolb,2367,439,21,25,46,45.7%,49m
36476,3,Hyps,2367,412,15,20,35,42.9%,29m
36476,1,[Sarmat]Suhinho,2367,430,11,10,21,52.4%,22m
36476,1,fanatic,2367,268,11,16,27,40.7%,7m
36476,3,Tomsojer,2367,304,11,17,28,39.3%,3m
36476,3,HiDik,2367,225,9,7,16,56.2%,49m
36476,1,Manra,2367,236,7,6,13,53.8%,1h
36476,3,singh,2367,184,7,10,17,41.2%,33m
36476,1,Ебанутый,2367,140,7,11,18,38.9%,53m
36476,1,Roni,2367,175,6,4,10,60.0%,43m
36476,1,[TLML]MLTROOPER,2367,206,5,6,11,45.5%,23m
36476,1,[K0RM2]hunk,2367,128,4,5,9,44.4%,32m
36476,1,TOWK,2367,132,3,4,7,42.9%,51m
36476,3,Morpheus,2367,121,2,3,5,40.0%,18m
36476,3,LuBu,2367,0,2,4,6,33.3%,43m
36476,1,МегаПицца,2367,0,2,5,7,28.6%,25m
36476,1,[Hassa]patrick,2367,0,1,2,3,33.3%,5m
36476,1,liknenS,2367,42,1,2,3,33.3%,49m
36476,1,[Rus2]Тенемурл,2367,0,1,4,5,20.0%,18m
36476,1,ViktOR,2367,0,1,5,6,16.7%,31m
36476,1,[HEАT]CHE,2367,0,0,1,1,0.0%,1h
36476,3,Tornac,2367,0,0,1,1,0.0%,20m
36476,2,[IRAA]Hurricane,2367,0,0,5,5,0.0%,18m
36505,3,Verme,2366,1535,205,203,408,50.2%,27m
36505,3,Zero,2366,1319,166,156,322,51.6%,16m
36505,3,Jabollo,2366,1059,92,90,182,50.5%,1h
36505,3,schnils,2366,1039,58,71,129,45.0%,8m
36505,3,fringant,2366,967,43,42,85,50.6%,19m
36505,2,Devin,2366,492,40,48,88,45.5%,7m
36505,3,Gidra,2366,883,38,30,68,55.9%,47m
36505,1,Virus,2366,1026,32,39,71,45.1%,37m
36505,1,Vovan,2366,681,22,11,33,66.7%,4m
36505,3,WuTanG,2366,328,11,15,26,42.3%,33m
36505,3,VanG,2366,305,10,9,19,52.6%,25m
36505,2,Dimaski,2366,294,9,17,26,34.6%,14m
36505,3,DjTurkShoot,2366,229,8,6,14,57.1%,14m
36505,3,vtotR,2366,141,6,4,10,60.0%,25m
36505,1,titi,2366,246,6,6,12,50.0%,34m
36505,3,FlashGab,2366,189,5,9,14,35.7%,42m
36505,1,Metalyx,2366,179,5,9,14,35.7%,50m
36505,3,[WoU]Alkaloid,2366,32,4,6,10,40.0%,8m
36505,1,Basil,2366,166,4,6,10,40.0%,7m
36505,3,RONIN,2366,146,4,7,11,36.4%,42m
36505,3,Huzi,2366,78,4,8,12,33.3%,51m
36505,3,jugan,2366,115,3,6,9,33.3%,16m
36505,1,Kawiiis,2366,44,2,0,2,100.0%,1h
36505,2,HEALTH,2366,78,2,14,16,12.5%,35m
36505,1,RAY,2366,0,1,0,1,100.0%,39m
36505,1,smetanka,2366,0,1,0,1,100.0%,7m
36505,2,Аракта,2366,0,1,4,5,20.0%,10m
36505,3,Flatulencio,2366,0,1,4,5,20.0%,14m
36505,1,Eadwulf,2366,0,1,4,5,20.0%,50m
36505,3,[llRFll]premius,2366,0,1,5,6,16.7%,53m
36505,1,Keytlan,2366,0,1,5,6,16.7%,36m
36505,2,[night1]Yarik,2366,88,1,14,15,6.7%,2m
36505,1,lbvf,2366,0,0,1,1,0.0%,32m
36538,2,BuildDebug,2365,1522,93,89,182,51.1%,3m
36538,2,MOLOT,2365,1425,88,91,179,49.2%,45m
36538,1,dumpl,2365,1320,77,65,142,54.2%,48m
36538,1,LeGeNda,2365,680,38,32,70,54.3%,44m
36538,3,Neko,2365,805,35,32,67,52.2%,41m
36538,1,Raava,2365,841,34,18,52,65.4%,28m
36538,3,TerribleFlea,2365,480,19,21,40,47.5%,32m
36538,2,Schinken,2365,435,16,26,42,38.1%,24m
36538,1,SKILL,2365,423,13,8,21,61.9%,40m
36538,1,Prygames,2365,332,12,10,22,54.5%,21m
36538,2,Bonesawed,2365,156,12,11,23,52.2%,7m
36538,1,[PAF31]Piotr,2365,418,11,12,23,47.8%,1h
36538,3,[MASPA]BODRI,2365,304,10,10,20,50.0%,20m
36538,2,Alex,2365,261,9,11,20,45.0%,52m
36538,3,zergling,2365,264,9,18,27,33.3%,43m
36538,1,SmurfachOff,2365,86,7,1,8,87.5%,50m
36538,3,BootyJuice,2365,183,5,9,14,35.7%,32m
36538,2,RuFF,2365,151,4,8,12,33.3%,31m
36538,3,zEx,2365,138,3,3,6,50.0%,1h
36538,3,Marshalucci,2365,97,3,5,8,37.5%,1h
36538,2,Risberg,2365,30,3,7,10,30.0%,44m
36538,3,[K0RM2]AnonimE,2365,123,2,3,5,40.0%,20m
36538,1,Firstnoob,2365,0,2,3,5,40.0%,1h
36538,1,Rush,2365,0,2,4,6,33.3%,11m
36538,1,FPVR,2365,44,1,1,2,50.0%,1h
36538,2,Irick,2365,0,1,4,5,20.0%,4m
36538,3,Nataly,2365,0,1,5,6,16.7%,35m
36538,1,RoY,2365,0,0,1,1,0.0%,42m
36538,3,SolidMPZ,2365,0,0,3,3,0.0%,33m
36567,1,DStei,2364,1853,108,98,206,52.4%,9m
36567,1,Semik,2364,1255,74,58,132,56.1%,52m
36567,3,polimera,2364,1136,42,45,87,48.3%,32m
36567,1,IIIIIIIIIIII,2364,990,36,47,83,43.4%,43m
36567,2,[Virtus]AlonePrince,2364,884,32,39,71,45.1%,45m
36567,3,ArtesFog,2364,729,29,36,65,44.6%,54m
36567,3,rataton,2364,591,23,24,47,48.9%,41m
36567,2,Куражёвый,2364,296,12,12,24,50.0%,1h
36567,1,Kuzco,2364,275,9,4,13,69.2%,28m
36567,1,Wonziu,2364,204,6,7,13,46.2%,32m
36567,1,Timofey,2364,126,4,5,9,44.4%,51m
36567,3,dominio,2364,86,4,6,10,40.0%,24m
36567,3,[LosTG]Took,2364,92,3,7,10,30.0%,9m
36567,3,[MISTO]Beacon,2364,94,3,9,12,25.0%,14m
36567,1,Фантомас,2364,44,2,2,4,50.0%,27m
36567,1,DonSanchos,2364,40,2,4,6,33.3%,25m
36567,1,[SSC2]Nosferatu,2364,97,2,5,7,28.6%,1h
36567,1,[hmitF]Bismikey,2364,48,2,5,7,28.6%,21m
36567,1,WINTER,2364,0,1,0,1,100.0%,51m
36567,1,tema,2364,0,1,0,1,100.0%,11m
36567,1,[VCa]Phantom,2364,0,1,2,3,33.3%,41m
36567,1,Chaico,2364,0,0,1,1,0.0%,1h
36567,1,qwqrwere,2364,0,0,1,1,0.0%,32m
36567,1,Kazeroo,2364,0,0,2,2,0.0%,7m
36567,1,MRTOMATO,2364,0,0,2,2,0.0%,36m
36567,1,[утка]миша,2364,0,0,2,2,0.0%,26m
36593,2,Varcan,2363,1471,112,120,232,48.3%,1h
36593,1,SangReal,2363,1496,85,88,173,49.1%,51m
36593,2,Vlad,2363,702,45,55,100,45.0%,40m
36593,1,Random,2363,1010,33,38,71,46.5%,39m
36593,2,kevswag,2363,222,30,34,64,46.9%,47m
36593,3,НИКОЛАСКРАФТ,2363,563,19,20,39,48.7%,8m
36593,1,OrbitalPerio,2363,538,15,16,31,48.4%,15m
36593,1,[K0mpis]CRuSHeR,2363,396,11,9,20,55.0%,36m
36593,1,[fFlags]Reeve,2363,30,5,7,12,41.7%,42m
36593,1,KillerZone,2363,159,3,4,7,42.9%,37m
36593,1,Tatthwa,2363,0,2,3,5,40.0%,36m
36593,1,[MSQ]Dudule,2363,0,1,0,1,100.0%,21m
36593,1,[GAMAD]Nerul,2363,0,1,2,3,33.3%,52m
36593,1,dBrick,2363,44,1,3,4,25.0%,21m
36593,3,Truan,2363,30,1,7,8,12.5%,22m
36593,1,PineTreeSeed,2363,0,0,1,1,0.0%,17m
36593,1,Heiwan,2363,0,0,1,1,0.0%,1h
36593,1,BigFoot,2363,0,0,1,1,0.0%,25m
36611,3,Holevovka,2362,1336,48,49,97,49.5%,1h
36611,1,shnorkell,2362,734,37,27,64,57.8%,4m
36611,3,GOODVIN,2362,660,28,21,49,57.1%,43m
36611,3,[Minet]Tasavalta,2362,530,24,16,40,60.0%,4m
36611,3,GoRluM,2362,428,17,25,42,40.5%,1h
36611,2,CocaCoala,2362,448,16,28,44,36.4%,1h
36611,1,GoodWin,2362,435,12,6,18,66.7%,15m
36611,1,ClimbingPen,2362,259,6,6,12,50.0%,32m
36611,1,Raven,2362,208,5,6,11,45.5%,40m
36611,1,DKlAcidViper,2362,130,4,3,7,57.1%,10m
36611,2,CrytonV,2362,30,3,7,10,30.0%,1h
36611,1,Anarenen,2362,44,2,2,4,50.0%,34m
36611,1,diddiking,2362,42,2,2,4,50.0%,48m
36611,1,korakchik,2362,44,2,2,4,50.0%,24m
36611,1,Krisi,2362,42,2,5,7,28.6%,50m
36611,2,holderoger,2362,62,2,9,11,18.2%,24m
36611,3,Omni,2362,62,2,12,14,14.3%,25m
36611,2,TheRealFreak,2362,0,1,0,1,100.0%,46m
36611,3,Хомяк,2362,0,1,2,3,33.3%,34m
36611,1,[Sahut]YstOs,2362,0,1,4,5,20.0%,37m
36611,2,fruitloaf,2362,0,1,4,5,20.0%,50m
36611,2,Vercerker,2362,88,1,8,9,11.1%,52m
36611,1,ANDREY,2362,0,0,2,2,0.0%,50m
36611,1,Miandro,2362,0,0,2,2,0.0%,21m
36611,3,EUSIK,2362,0,0,4,4,0.0%,1h
36636,3,StyrianTower,2361,1475,167,155,322,51.9%,33m
36636,2,marios,2361,1542,141,147,288,49.0%,26m
36636,3,Cannibal,2361,1115,82,80,162,50.6%,21m
36636,1,Tatsumasa,2361,1314,50,69,119,42.0%,44m
36636,3,[NWGD]Terrantes,2361,523,41,19,60,68.3%,9m
36636,3,eagle,2361,181,15,13,28,53.6%,6m
36636,3,XoboT,2361,311,14,9,23,60.9%,11m
36636,2,[SkBG]LazyNoob,2361,246,10,15,25,40.0%,36m
36636,3,[KCKNB]llllllllllll,2361,258,8,10,18,44.4%,36m
36636,3,[IIII17]Artefact,2361,206,8,11,19,42.1%,9m
36636,1,[D0N3]Blacktiger,2361,231,5,7,12,41.7%,17m
36636,3,SrRipper,2361,148,5,11,16,31.2%,11m
36636,3,Dursza,2361,0,4,4,8,50.0%,6m
36636,1,[cck]kute,2361,170,4,5,9,44.4%,1h
36636,2,[NiFi]Tom,2361,124,3,1,4,75.0%,14m
36636,1,Slifer,2361,123,3,7,10,30.0%,50m
36636,2,TimboSlice,2361,94,3,8,11,27.3%,38m
36636,1,Dazrale,2361,44,2,1,3,66.7%,1h
36636,3,Rasty,2361,0,1,0,1,100.0%,5m
36636,1,DarkHome,2361,73,1,1,2,50.0%,24m
36636,1,YJKen,2361,48,1,2,3,33.3%,7m
36636,1,[OVESEE]FireSpirit,2361,42,1,2,3,33.3%,32m
36636,2,MaxV,2361,0,1,4,5,20.0%,51m
36636,1,Grolzius,2361,0,1,4,5,20.0%,42m
36636,3,Hook,2361,30,1,5,6,16.7%,33m
36636,1,[ATMTA]kroKitsune,2361,0,0,1,1,0.0%,49m
36636,1,ZerokS,2361,0,0,2,2,0.0%,1h
36636,1,ShevelPover,2361,0,0,2,2,0.0%,1h
36636,3,thieme,2361,0,0,3,3,0.0%,1h
36665,2,morfarspain,2360,1500,210,208,418,50.2%,44m
36665,3,ante,2360,1478,53,61,114,46.5%,1h
36665,3,MARIXYANA,2360,1125,48,41,89,53.9%,53m
36665,1,HEZHitag,2360,892,45,41,86,52.3%,43m
36665,1,[L0L]KrakenPL,2360,1390,45,42,87,51.7%,34m
36665,3,Max,2360,758,31,33,64,48.4%,39m
36665,3,Ruy,2360,558,21,31,52,40.4%,34m
36665,1,DMRG,2360,638,20,20,40,50.0%,29m
36665,1,mikden,2360,483,18,18,36,50.0%,45m
36665,1,ZlODeY,2360,522,15,15,30,50.0%,27m
36665,2,BimBuha,2360,438,15,22,37,40.5%,28m
36665,3,[AiRǂ]matteo,2360,354,11,15,26,42.3%,1h
36665,3,Rine,2360,318,11,16,27,40.7%,3m
36665,1,Napse,2360,310,10,15,25,40.0%,50m
36665,1,LoveRain,2360,294,8,4,12,66.7%,39m
36665,1,[zpn3]JokerCap,2360,292,8,4,12,66.7%,19m
36665,1,Kempachi,2360,308,7,13,20,35.0%,34m
36665,1,pffkmzyc,2360,197,6,4,10,60.0%,51m
36665,1,TYPHOON,2360,172,6,6,12,50.0%,1h
36665,3,Haleem,2360,120,6,9,15,40.0%,43m
36665,1,flight,2360,216,5,7,12,41.7%,25m
36665,3,Goodween,2360,96,5,11,16,31.2%,41m
36665,1,eyal,2360,126,4,2,6,66.7%,5m
36665,1,kava,2360,164,4,2,6,66.7%,5m
36665,1,[DRUГS]Volodko,2360,128,4,4,8,50.0%,11m
36665,1,CIRO,2360,86,4,6,10,40.0%,17m
36665,1,Faker,2360,225,4,6,10,40.0%,36m
36665,1,sawuk,2360,119,4,8,12,33.3%,53m
36665,1,Rajan,2360,141,3,2,5,60.0%,1h
36665,1,Gemini,2360,0,3,3,6,50.0%,36m
36665,1,obs,2360,0,3,7,10,30.0%,1h
36665,1,Praefect,2360,88,2,3,5,40.0%,40m
36665,1,Hexylon,2360,0,1,1,2,50.0%,34m
36665,1,AAT,2360,0,1,1,2,50.0%,18m
36665,1,[antkr]Yarden,2360,0,1,1,2,50.0%,37m
36665,2,Oliver,2360,0,1,4,5,20.0%,1h
36665,1,Gyiki,2360,0,1,4,5,20.0%,1h
36665,1,[K0mpis]Avenger,2360,40,1,11,12,8.3%,17m
36665,1,Houdini,2360,0,0,1,1,0.0%,33m
36665,1,ben,2360,0,0,2,2,0.0%,1h
36705,1,Cepheus,2359,1552,52,52,104,50.0%,1h
36705,1,[Эщкер]FREAKAZOID,2359,987,50,35,85,58.8%,32m
36705,3,[лэнд]Vovkinsun,2359,867,37,43,80,46.2%,22m
36705,1,Onomatopoeia,2359,954,31,28,59,52.5%,16m
36705,1,Novander,2359,847,31,45,76,40.8%,42m
36705,1,Ivanushka,2359,466,21,29,50,42.0%,18m
36705,1,[мики]Владыка,2359,622,18,14,32,56.2%,40m
36705,1,Pun,2359,380,14,14,28,50.0%,34m
36705,3,[WАSD]Rous,2359,445,14,18,32,43.8%,28m
36705,1,[Euter]Cubey,2359,322,9,8,17,52.9%,12m
36705,1,Cadesius,2359,246,7,6,13,53.8%,14m
36705,3,Wipeout,2359,174,5,5,10,50.0%,4m
36705,1,[FLZN]kotx,2359,232,5,9,14,35.7%,35m
36705,3,KOSTY,2359,143,4,7,11,36.4%,49m
36705,1,TerRazit,2359,172,4,8,12,33.3%,25m
36705,1,Latias,2359,82,3,0,3,100.0%,32m
36705,1,CuteRedCat,2359,0,3,3,6,50.0%,27m
36705,1,[P0W3RD]ECHO,2359,128,3,5,8,37.5%,1h
36705,1,[Hacı]udgu,2359,145,3,6,9,33.3%,16m
36705,3,TQFY,2359,36,3,7,10,30.0%,53m
36705,3,Victor,2359,60,3,7,10,30.0%,13m
36705,1,Justician,2359,40,2,1,3,66.7%,34m
36705,1,Little,2359,121,2,4,6,33.3%,16m
36705,3,Greengo,2359,62,2,6,8,25.0%,1h
36705,2,sKafandra,2359,0,2,6,8,25.0%,52m
36705,2,Maersk,2359,0,2,6,8,25.0%,3m
36705,3,GarryOZ,2359,92,2,8,10,20.0%,10m
36705,1,contradanil,2359,0,1,0,1,100.0%,14m
36705,3,Хрустик,2359,0,1,0,1,100.0%,36m
36705,1,[069FFM]moe,2359,42,1,1,2,50.0%,50m
36705,1,[USKL]Альторн,2359,97,1,3,4,25.0%,20m
36705,1,stifler,2359,0,1,4,5,20.0%,49m
36705,1,tumbak,2359,0,0,2,2,0.0%,1h
36705,1,Potato,2359,0,0,4,4,0.0%,34m
36739,2,Gotchaa,2358,1574,154,148,302,51.0%,2m
36739,2,[PND18]Cabal,2358,1515,86,88,174,49.4%,2m
36739,1,Solmyr,2358,1461,49,50,99,49.5%,4m
36739,1,DerBerkator,2358,1081,43,37,80,53.8%,34m
36739,1,Izze,2358,994,37,32,69,53.6%,39m
36739,3,[DILIT]DeLTa,2358,831,35,31,66,53.0%,43m
36739,1,Cepek,2358,622,18,17,35,51.4%,10m
36739,1,Eddy,2358,326,14,11,25,56.0%,43m
36739,2,knowo,2358,282,11,9,20,55.0%,50m
36739,3,Sketch,2358,235,8,12,20,40.0%,36m
36739,1,medalex,2358,227,7,3,10,70.0%,35m
36739,3,KORKYNOV,2358,185,7,10,17,41.2%,39m
36739,1,Dason,2358,97,5,2,7,71.4%,24m
36739,1,КРАБ,2358,124,4,5,9,44.4%,7m
36739,1,Łukasz,2358,106,3,2,5,60.0%,40m
36739,3,babo,2358,0,3,8,11,27.3%,20m
36739,1,Jeronimo,2358,48,2,2,4,50.0%,39m
36739,3,Стручёк,2358,97,2,4,6,33.3%,51m
36739,1,Volt,2358,42,1,2,3,33.3%,40m
36739,3,IIIIIIIII,2358,97,1,4,5,20.0%,25m
36739,1,EVA,2358,0,1,4,5,20.0%,50m
36739,1,[TLGC]NoobRekter,2358,0,0,1,1,0.0%,32m
36739,1,Arben,2358,0,0,2,2,0.0%,7m
36739,1,qwdsa,2358,0,0,3,3,0.0%,48m
36763,2,Barbie,2357,1434,254,268,522,48.7%,15m
36763,1,Hephaestus,2357,1853,151,140,291,51.9%,44m
36763,3,danibkd,2357,1265,63,56,119,52.9%,11m
36763,1,PaKo,2357,1056,33,30,63,52.4%,42m
36763,3,Shathae,2357,613,30,29,59,50.8%,16m
36763,1,DieOnMySight,2357,819,22,25,47,46.8%,18m
36763,1,Ordis,2357,470,14,10,24,58.3%,49m
36763,1,BuckyBarnes,2357,378,10,8,18,55.6%,52m
36763,1,MisterJB,2357,267,10,13,23,43.5%,49m
36763,3,Kaffe,2357,236,9,14,23,39.1%,25m
36763,1,ауе,2357,284,8,8,16,50.0%,52m
36763,3,OJCIEC,2357,104,7,9,16,43.8%,1h
36763,3,Slouter,2357,223,7,10,17,41.2%,6m
36763,1,NotMe,2357,200,6,4,10,60.0%,39m
36763,1,[Fuozza]Zaphod,2357,242,6,6,12,50.0%,41m
36763,3,DrSkengDaddy,2357,169,6,9,15,40.0%,54m
36763,1,Arcantek,2357,152,6,11,17,35.3%,35m
36763,3,[S4G]beito,2357,194,6,15,21,28.6%,34m
36763,1,Bespal,2357,97,5,3,8,62.5%,34m
36763,3,Corrious,2357,171,5,5,10,50.0%,44m
36763,2,greg,2357,180,5,9,14,35.7%,1h
36763,1,Jedi,2357,164,4,3,7,57.1%,1h
36763,3,[DEDAL]kagerberg,2357,30,4,6,10,40.0%,34m
36763,1,IlIlIIIlllII,2357,192,4,8,12,33.3%,28m
36763,2,bozzyk,2357,130,4,8,12,33.3%,33m
36763,1,FearLess,2357,42,2,0,2,100.0%,42m
36763,1,Slap,2357,48,2,0,2,100.0%,36m
36763,1,ReedLau,2357,97,2,4,6,33.3%,20m
36763,1,Loggi,2357,48,2,6,8,25.0%,26m
36763,1,[QaDo]andreyladr,2357,0,1,0,1,100.0%,11m
36763,1,Freaker,2357,0,1,0,1,100.0%,36m
36763,1,[UURan]ZadrotSKieva,2357,0,1,0,1,100.0%,32m
36763,3,Gatrixxx,2357,97,1,1,2,50.0%,36m
36763,1,FANTOM,2357,0,1,1,2,50.0%,25m
36763,2,IronBlyat,2357,0,1,3,4,25.0%,39m
36763,1,[G4YoU]Beckstabber,2357,0,0,1,1,0.0%,18m
36763,2,[xISISx]God,2357,0,0,5,5,0.0%,54m
36800,2,Busel,2356,1004,174,178,352,49.4%,1h
36800,1,Ajiexsia,2356,1411,82,70,152,53.9%,11m
36800,3,Dyb,2356,1089,55,51,106,51.9%,24m
36800,1,Birdyves,2356,896,51,55,106,48.1%,39m
36800,3,ACOSW,2356,928,36,37,73,49.3%,11m
36800,1,armani,2356,905,34,30,64,53.1%,14m
36800,3,eczdervis,2356,565,22,19,41,53.7%,9m
36800,1,ozdemirasaf,2356,784,21,23,44,47.7%,46m
36800,3,KingAchilles,2356,300,10,15,25,40.0%,33m
36800,3,Iman,2356,255,10,18,28,35.7%,33m
36800,3,mono,2356,294,9,11,20,45.0%,32m
36800,3,Warok,2356,254,8,12,20,40.0%,34m
36800,3,tima,2356,200,8,13,21,38.1%,1h
36800,3,[typbIe]vampiruhbif,2356,152,7,6,13,53.8%,49m
36800,1,GLHF,2356,192,7,8,15,46.7%,34m
36800,3,[LEON]david,2356,222,7,10,17,41.2%,22m
36800,1,Antonino,2356,174,5,2,7,71.4%,40m
36800,1,[4orce]Draugar,2356,206,5,3,8,62.5%,11m
36800,1,TemplaR,2356,219,5,7,12,41.7%,22m
36800,1,[NucLea]ExperT,2356,166,4,3,7,57.1%,1h
36800,1,SaXaRok,2356,126,4,3,7,57.1%,22m
36800,1,EKKO,2356,0,3,2,5,60.0%,36m
36800,1,[WhyNot]lažac,2356,97,3,4,7,42.9%,41m
36800,1,SaigoDaito,2356,126,3,5,8,37.5%,34m
36800,1,BeterThatTea,2356,135,3,6,9,33.3%,30m
36800,1,xhi,2356,42,2,1,3,66.7%,42m
36800,1,[YLN]Gokturk,2356,84,2,1,3,66.7%,55m
36800,3,Typhus,2356,125,2,4,6,33.3%,1h
36800,3,MilkoWeBrat,2356,30,2,6,8,25.0%,43m
36800,1,Barmaley,2356,0,1,1,2,50.0%,52m
36800,1,PharAoniC,2356,0,1,2,3,33.3%,42m
36800,1,[Clyd]RotoMif,2356,42,1,3,4,25.0%,7m
36800,2,[QX9650]angel,2356,0,1,4,5,20.0%,33m
36800,1,Samhain,2356,44,1,4,5,20.0%,17m
36800,2,Underdog,2356,0,1,4,5,20.0%,35m
36800,1,Vasdrivas,2356,0,1,4,5,20.0%,24m
36800,3,[1FU2]Grapes,2356,30,1,10,11,9.1%,36m
36800,1,Perec,2356,0,0,2,2,0.0%,26m
36800,1,Svinopres,2356,0,0,2,2,0.0%,1h
36800,1,mishanya,2356,0,0,4,4,0.0%,28m
36840,1,[IllllI]IIlIIllllllI,2355,1851,141,149,290,48.6%,25m
36840,1,parabeumknl,2355,1293,58,50,108,53.7%,43m
36840,1,Smud,2355,1222,41,39,80,51.2%,35m
36840,1,[WMPA]Elronmcbong,2355,661,32,2,34,94.1%,1h
36840,3,Stéphano,2355,294,13,14,27,48.1%,20m
36840,2,Grenth,2355,312,10,12,22,45.5%,6m
36840,1,[proto3]shrek,2355,391,9,6,15,60.0%,24m
36840,1,zerzilot,2355,332,9,8,17,52.9%,12m
36840,1,[KSRF]Dickin,2355,334,9,9,18,50.0%,17m
36840,3,MEFF,2355,282,9,13,22,40.9%,53m
36840,1,lxdvspb,2355,253,9,14,23,39.1%,39m
36840,3,Инквизитор,2355,246,8,8,16,50.0%,34m
36840,1,EAW,2355,229,8,10,18,44.4%,50m
36840,3,Wanidze,2355,198,6,9,15,40.0%,42m
36840,3,Witcher,2355,38,5,5,10,50.0%,8m
36840,1,nickoke,2355,233,5,7,12,41.7%,36m
36840,1,ilnarik,2355,166,4,3,7,57.1%,32m
36840,3,[brzzer]Adiel,2355,184,4,11,15,26.7%,29m
36840,1,fackton,2355,84,3,2,5,60.0%,27m
36840,1,DeathShika,2355,119,3,5,8,37.5%,24m
36840,3,Darkys,2355,0,3,7,10,30.0%,10m
36840,1,[LaggIT]Vidde,2355,48,2,5,7,28.6%,31m
36840,1,Katisha,2355,88,2,5,7,28.6%,37m
36840,1,Elliptic,2355,97,2,5,7,28.6%,36m
36840,1,[STMS]Krosis,2355,0,1,0,1,100.0%,39m
36840,1,pyskopate,2355,0,1,1,2,50.0%,1h
36840,1,[OnEdge]Sparky,2355,42,1,2,3,33.3%,1h
36840,2,SleepyIdiot,2355,0,1,3,4,25.0%,13m
36840,2,kudlik,2355,0,1,4,5,20.0%,50m
36840,3,[HlGH]Mex,2355,97,1,7,8,12.5%,54m
36840,1,Titan,2355,0,0,1,1,0.0%,33m
36840,1,erpe,2355,0,0,1,1,0.0%,26m
36840,1,kresto,2355,0,0,2,2,0.0%,48m
36840,1,teramus,2355,0,0,2,2,0.0%,30m
36840,1,DAJTWEJDER,2355,0,0,2,2,0.0%,49m
36875,3,cccccccccccc,2354,1544,87,86,173,50.3%,24m
36875,2,Sexinant,2354,693,36,46,82,43.9%,25m
36875,1,Subzero,2354,786,29,23,52,55.8%,48m
36875,3,macao,2354,657,28,27,55,50.9%,1h
36875,1,NaUghtydad,2354,677,25,20,45,55.6%,49m
36875,1,JohnRambo,2354,448,23,0,23,100.0%,55m
36875,3,Barkan,2354,482,17,24,41,41.5%,39m
36875,1,fepnatchy,2354,344,16,3,19,84.2%,1h
36875,1,[PR0uT]KiwiKekette,2354,363,13,6,19,68.4%,39m
36875,1,КАМЕНЬ,2354,314,12,2,14,85.7%,16m
36875,1,VeGas,2354,218,9,7,16,56.2%,14m
36875,1,Schnarf,2354,294,9,9,18,50.0%,6m
36875,3,LeBreton,2354,303,9,13,22,40.9%,14m
36875,1,McNinja,2354,227,8,10,18,44.4%,34m
36875,3,EccioHD,2354,244,8,13,21,38.1%,27m
36875,2,Dodo,2354,211,6,12,18,33.3%,34m
36875,1,LilWorld,2354,119,5,1,6,83.3%,10m
36875,1,TeG,2354,196,5,7,12,41.7%,17m
36875,1,Dato,2354,116,4,3,7,57.1%,48m
36875,3,[13NRV]xXJIMBOXx,2354,97,4,4,8,50.0%,5m
36875,1,[RuVoid]Predator,2354,132,3,0,3,100.0%,4m
36875,3,RastaMan,2354,125,3,7,10,30.0%,11m
36875,1,[Españ]aghalberto,2354,38,2,1,3,66.7%,4m
36875,3,[NotBot]БольшойChлен,2354,0,2,4,6,33.3%,50m
36875,2,THEbigO,2354,0,2,5,7,28.6%,36m
36875,3,Frodog,2354,0,2,7,9,22.2%,39m
36875,1,OWLOGY,2354,0,1,4,5,20.0%,34m
36875,2,Vovvvvan,2354,0,1,4,5,20.0%,39m
36875,1,eineAmin,2354,0,1,4,5,20.0%,1h
36875,2,saporema,2354,0,0,2,2,0.0%,39m
36875,1,Juice,2354,0,0,4,4,0.0%,40m
36906,3,[Köfte]xKAZZEx,2353,1563,150,144,294,51.0%,33m
36906,1,Micha,2353,1833,112,94,206,54.4%,34m
36906,3,IlllIIIlIIII,2353,996,75,82,157,47.8%,33m
36906,2,nauard,2353,1535,63,59,122,51.6%,40m
36906,1,Vladweider,2353,1492,61,47,108,56.5%,37m
36906,3,EDY,2353,738,36,35,71,50.7%,3m
36906,1,[Floren]Milogav,2353,795,24,24,48,50.0%,1h
36906,1,AntonSl,2353,768,23,21,44,52.3%,42m
36906,3,Kaoru,2353,296,21,20,41,51.2%,1h
36906,3,[GROF]hellas,2353,566,19,26,45,42.2%,27m
36906,2,Anonymus,2353,417,18,27,45,40.0%,17m
36906,1,[TraxAt]yaseR,2353,584,17,14,31,54.8%,39m
36906,1,FTSwarm,2353,642,17,16,33,51.5%,46m
36906,3,[LSN0]andre,2353,337,13,22,35,37.1%,1h
36906,3,Adrian,2353,245,11,9,20,55.0%,5m
36906,3,Zonk,2353,166,9,16,25,36.0%,12m
36906,3,JeMi,2353,0,3,3,6,50.0%,47m
36906,1,Snowleopard,2353,97,2,6,8,25.0%,34m
36906,1,ПервичныйПиц,2353,0,2,8,10,20.0%,45m
36906,1,drrost,2353,0,1,1,2,50.0%,10m
36906,2,Lotereynik,2353,0,0,1,1,0.0%,28m
36906,1,Grizzly,2353,0,0,1,1,0.0%,19m
36906,1,[WSKY]UnderDark,2353,0,0,2,2,0.0%,1h
36929,1,Teibelo,2352,1648,77,72,149,51.7%,39m
36929,2,finnrodus,2352,1474,59,57,116,50.9%,52m
36929,3,mixas,2352,1058,49,48,97,50.5%,22m
36929,1,[турнир]потеряный,2352,458,15,8,23,65.2%,1h
36929,3,kentjai,2352,299,12,22,34,35.3%,33m
36929,3,Lutarez,2352,182,8,16,24,33.3%,14m
36929,2,[МЕD0ED]Ekranial,2352,168,5,3,8,62.5%,46m
36929,1,Kurvenjoe,2352,150,5,9,14,35.7%,35m
36929,1,Cive,2352,212,5,10,15,33.3%,48m
36929,3,MetalHead,2352,172,4,4,8,50.0%,38m
36929,1,[synTWD]Demian,2352,172,4,6,10,40.0%,40m
36929,2,ZeTIL,2352,60,4,7,11,36.4%,23m
36929,1,Bendera,2352,0,3,2,5,60.0%,54m
36929,3,orkanelf,2352,137,3,4,7,42.9%,11m
36929,1,[CHI777]ShmoukMan,2352,40,2,0,2,100.0%,37m
36929,1,DidjeY,2352,44,2,2,4,50.0%,2m
36929,1,NoHotKeys,2352,0,1,0,1,100.0%,48m
36929,1,[Herosi]Czareski,2352,0,1,0,1,100.0%,49m
36929,1,Viatorem,2352,42,1,1,2,50.0%,34m
36929,2,Targaryen,2352,0,1,3,4,25.0%,25m
36929,1,alvaro,2352,0,1,4,5,20.0%,19m
36929,2,Anim,2352,0,1,4,5,20.0%,36m
36929,3,Slavon,2352,0,1,6,7,14.3%,21m
36929,1,RaVen,2352,0,0,2,2,0.0%,21m
36929,1,TraKeR,2352,0,0,2,2,0.0%,5m
36929,3,[N3VADA]NEON,2352,0,0,2,2,0.0%,34m
36955,1,Ernest,2351,1840,84,74,158,53.2%,50m
36955,2,Wakanda,2351,1102,47,56,103,45.6%,22m
36955,3,Chris,2351,844,44,46,90,48.9%,45m
36955,2,Dennis,2351,497,28,24,52,53.8%,43m
36955,1,[Raa]Palladium,2351,958,28,26,54,51.9%,39m
36955,3,Dkashchenko,2351,497,18,20,38,47.4%,5m
36955,2,riga,2351,536,17,28,45,37.8%,3m
36955,1,Hiso,2351,469,16,17,33,48.5%,27m
36955,1,Magic,2351,390,10,9,19,52.6%,17m
36955,2,shark,2351,210,9,18,27,33.3%,8m
36955,3,[GNOUTU]Exkillnight,2351,218,8,7,15,53.3%,42m
36955,2,YourSenpai,2351,264,8,8,16,50.0%,6m
36955,2,Janmaret,2351,147,8,13,21,38.1%,17m
36955,1,Wandal,2351,256,6,8,14,42.9%,4m
36955,2,mojemantry,2351,167,6,11,17,35.3%,48m
36955,1,DrZed,2351,168,6,11,17,35.3%,35m
36955,1,Кекс,2351,164,5,2,7,71.4%,1h
36955,1,BLACKBELT,2351,214,5,9,14,35.7%,37m
36955,2,Eso,2351,84,5,11,16,31.2%,41m
36955,1,DevilDriver,2351,0,4,3,7,57.1%,14m
36955,1,attila,2351,122,4,4,8,50.0%,43m
36955,1,[khps]Cherembsha,2351,194,4,8,12,33.3%,48m
36955,1,Serg,2351,40,2,0,2,100.0%,39m
36955,1,Boubou,2351,42,2,3,5,40.0%,10m
36955,1,PandaFouuu,2351,44,2,3,5,40.0%,1h
36955,2,tyuop,2351,0,1,0,1,100.0%,10m
36955,1,Wekert,2351,0,1,1,2,50.0%,36m
36955,3,Leventa,2351,0,1,1,2,50.0%,5m
36955,1,Heller,2351,0,1,3,4,25.0%,7m
36955,1,Naglfar,2351,0,1,4,5,20.0%,7m
36955,1,Baybars,2351,0,0,2,2,0.0%,24m
36986,2,mados,2350,1511,107,117,224,47.8%,46m
36986,1,Achilles,2350,1152,53,63,116,45.7%,13m
36986,3,[3ShpE]Warp,2350,744,31,34,65,47.7%,3m
36986,3,rombuzz,2350,399,28,53,81,34.6%,3m
36986,1,Zerg,2350,814,27,25,52,51.9%,4m
36986,3,setarah,2350,611,21,26,47,44.7%,24m
36986,1,mrTimmy,2350,511,18,14,32,56.2%,1h
36986,1,ssoipi,2350,570,18,31,49,36.7%,5m
36986,1,Aron,2350,449,13,11,24,54.2%,31m
36986,1,Blast,2350,258,7,3,10,70.0%,6m
36986,2,JudasPriest,2350,58,6,7,13,46.2%,45m
36986,3,unit,2350,114,5,6,11,45.5%,43m
36986,1,[TonTon]DAHUKILLKILL,2350,128,4,2,6,66.7%,46m
36986,1,Darrelo,2350,194,4,4,8,50.0%,26m
36986,1,Ivan,2350,148,4,8,12,33.3%,4m
36986,1,Maksimioi,2350,86,3,4,7,42.9%,33m
36986,1,Mihailko,2350,121,2,6,8,25.0%,22m
36986,3,Maxwelll,2350,0,2,7,9,22.2%,19m
36986,1,johny,2350,0,1,4,5,20.0%,18m
36986,1,MasterCatII,2350,0,1,4,5,20.0%,10m
36986,1,torlien,2350,0,0,1,1,0.0%,35m
36986,1,[2ПУПСА]GGchat,2350,0,0,1,1,0.0%,7m
36986,2,Aleksey,2350,0,0,1,1,0.0%,33m
36986,2,DiVeR,2350,0,0,5,5,0.0%,34m
37010,3,[lK9l]CaseyRyback,2349,1556,130,133,263,49.4%,6m
37010,3,Zedized,2349,952,55,52,107,51.4%,4m
37010,1,Wessex,2349,1403,53,52,105,50.5%,40m
37010,1,Sikorsky,2349,829,34,30,64,53.1%,37m
37010,1,Unfing,2349,833,30,29,59,50.8%,28m
37010,1,Pascal,2349,620,29,20,49,59.2%,26m
37010,1,Prezident,2349,574,16,14,30,53.3%,35m
37010,3,RiGGzR,2349,303,16,18,34,47.1%,3m
37010,3,RahmatBAE,2349,450,15,22,37,40.5%,13m
37010,3,[Käft]Gawdfather,2349,229,13,16,29,44.8%,41m
37010,2,OBWV,2349,271,10,11,21,47.6%,30m
37010,1,Xenomorph,2349,215,8,5,13,61.5%,16m
37010,1,[Waste]Blume,2349,166,5,5,10,50.0%,34m
37010,1,Obanze,2349,218,5,9,14,35.7%,4m
37010,1,Phantomias,2349,88,3,3,6,50.0%,39m
37010,1,Týr,2349,61,3,3,6,50.0%,10m
37010,3,Seed,2349,117,3,6,9,33.3%,36m
37010,1,SIL,2349,0,1,0,1,100.0%,30m
37010,1,yobagg,2349,0,1,1,2,50.0%,1h
37010,1,Hansmax,2349,0,1,3,4,25.0%,34m
37010,1,logan,2349,0,1,4,5,20.0%,33m
37010,1,leliknov,2349,0,0,1,1,0.0%,14m
37010,1,[BESY]Beny,2349,0,0,1,1,0.0%,28m
37033,1,Neo,2348,1418,170,166,336,50.6%,4m
37033,1,Caprimel,2348,1799,79,74,153,51.6%,46m
37033,1,Jeanne,2348,1040,31,31,62,50.0%,36m
37033,1,WildOstin,2348,766,28,18,46,60.9%,4m
37033,3,Figment,2348,776,28,27,55,50.9%,35m
37033,1,lIlIlIl,2348,356,15,15,30,50.0%,45m
37033,3,Khabra,2348,230,9,10,19,47.4%,13m
37033,2,Walasiek,2348,247,8,9,17,47.1%,25m
37033,2,[Füchse]Ankaladar,2348,288,8,10,18,44.4%,1h
37033,1,ActionK,2348,142,6,5,11,54.5%,52m
37033,1,Viktor,2348,168,5,7,12,41.7%,29m
37033,1,mpi,2348,212,5,9,14,35.7%,1h
37033,2,anoobis,2348,168,5,18,23,21.7%,21m
37033,1,Timerox,2348,189,4,1,5,80.0%,4m
37033,1,Qwfon,2348,162,4,4,8,50.0%,29m
37033,1,[БУБУБ]jokolak,2348,116,4,7,11,36.4%,6m
37033,3,Jack,2348,64,4,8,12,33.3%,6m
37033,1,stonewing,2348,80,3,0,3,100.0%,42m
37033,1,isha,2348,130,3,6,9,33.3%,41m
37033,3,[беш]hellfire,2348,97,3,7,10,30.0%,29m
37033,1,MasterPaco,2348,42,2,1,3,66.7%,1h
37033,1,[zuzia]Sigal,2348,46,2,5,7,28.6%,52m
37033,1,nico,2348,97,2,5,7,28.6%,40m
37033,3,ASASINXD,2348,30,2,9,11,18.2%,41m
37033,1,Stilgarr,2348,0,1,0,1,100.0%,34m
37033,1,Nikol,2348,0,1,0,1,100.0%,5m
37033,1,Golgren,2348,0,1,1,2,50.0%,35m
37033,1,KASS,2348,0,1,1,2,50.0%,22m
37033,2,adik,2348,0,1,4,5,20.0%,40m
37033,1,Monelong,2348,0,1,4,5,20.0%,54m
37033,3,hex,2348,0,1,5,6,16.7%,19m
37033,1,Bla,2348,0,0,1,1,0.0%,14m
37033,1,LikaZ,2348,0,0,2,2,0.0%,21m
37033,1,[CCCCP]Владимир,2348,0,0,5,5,0.0%,40m
37067,1,[Karpa]Sky,2347,1638,120,110,230,52.2%,49m
37067,2,JimmyMcGood,2347,752,106,108,214,49.5%,24m
37067,3,Playlikeme,2347,1614,78,80,158,49.4%,4m
37067,1,Morfin,2347,749,42,33,75,56.0%,11m
37067,3,TomeksNICK,2347,404,40,37,77,51.9%,25m
37067,3,Андрейка,2347,918,38,39,77,49.4%,14m
37067,1,[Sewer]Dynamite,2347,573,15,13,28,53.6%,36m
37067,1,Shaman,2347,326,15,21,36,41.7%,8m
37067,1,RAHITA,2347,425,12,14,26,46.2%,34m
37067,1,SeriousSam,2347,384,11,8,19,57.9%,17m
37067,1,born,2347,344,10,9,19,52.6%,25m
37067,1,StalkerBot,2347,396,10,10,20,50.0%,44m
37067,1,Braun,2347,216,6,2,8,75.0%,1h
37067,1,dezolate,2347,84,3,1,4,75.0%,48m
37067,1,Майки,2347,90,3,3,6,50.0%,54m
37067,3,Lizzard,2347,90,3,5,8,37.5%,49m
37067,3,DIKREATHZ,2347,94,3,11,14,21.4%,35m
37067,1,TheLIghtning,2347,48,2,2,4,50.0%,48m
37067,1,XxBAKELxX,2347,42,2,2,4,50.0%,7m
37067,1,мармаджикал,2347,0,1,0,1,100.0%,6m
37067,2,Serg,2347,0,1,0,1,100.0%,50m
37067,3,mihmax,2347,30,1,4,5,20.0%,1h
37067,2,Leonix,2347,0,1,4,5,20.0%,40m
37067,2,Loxmatii,2347,0,1,4,5,20.0%,10m
37067,1,Pyrrhus,2347,0,0,1,1,0.0%,16m
37067,1,kornolio,2347,0,0,1,1,0.0%,40m
37067,1,[OPMFS]adrian,2347,0,0,2,2,0.0%,6m
37067,1,poiu,2347,0,0,3,3,0.0%,37m
37095,3,Next,2346,1506,99,110,209,47.4%,18m
37095,1,FEITAN,2346,1622,97,87,184,52.7%,27m
37095,3,Sundowner,2346,1358,64,66,130,49.2%,18m
37095,3,bapa,2346,1038,47,57,104,45.2%,14m
37095,3,Michaelbx,2346,686,36,29,65,55.4%,5m
37095,3,Overlord,2346,557,22,22,44,50.0%,43m
37095,1,Jannie,2346,489,18,14,32,56.2%,48m
37095,1,Fnugget,2346,542,15,19,34,44.1%,28m
37095,1,Bltizo,2346,462,14,12,26,53.8%,35m
37095,1,PoorlyDrawn,2346,414,14,12,26,53.8%,1h
37095,3,trot,2346,302,12,8,20,60.0%,19m
37095,1,analcarnaval,2346,316,9,5,14,64.3%,52m
37095,3,RyanCrossbow,2346,234,9,12,21,42.9%,29m
37095,1,LegoFive,2346,234,7,10,17,41.2%,37m
37095,3,RashidJAN,2346,189,6,6,12,50.0%,11m
37095,1,[GBLNS]DaRkLoRd,2346,94,5,12,17,29.4%,35m
37095,1,BeliarMaster,2346,132,4,6,10,40.0%,7m
37095,1,Perdun,2346,188,4,8,12,33.3%,38m
37095,1,кериш,2346,84,3,2,5,60.0%,1h
37095,1,Furbo,2346,0,3,3,6,50.0%,4m
37095,1,Artemiyd,2346,122,3,4,7,42.9%,31m
37095,1,Yakut,2346,82,3,5,8,37.5%,48m
37095,1,Nightmind,2346,42,2,1,3,66.7%,45m
37095,1,Gerry,2346,40,2,1,3,66.7%,1h
37095,3,[NerCC]ArtCrafter,2346,95,2,2,4,50.0%,29m
37095,1,Leonid,2346,44,2,2,4,50.0%,1h
37095,3,rotriton,2346,123,2,3,5,40.0%,14m
37095,1,doHua,2346,88,2,4,6,33.3%,22m
37095,3,QuasarQuasar,2346,0,2,7,9,22.2%,34m
37095,1,Cypher,2346,0,1,0,1,100.0%,54m
37095,1,[YsK]Hutch,2346,0,1,0,1,100.0%,37m
37095,1,onDDASSS,2346,0,1,1,2,50.0%,36m
37095,1,Sabaton,2346,0,1,1,2,50.0%,46m
37095,1,Slaves,2346,42,1,2,3,33.3%,32m
37095,1,Magaruis,2346,0,1,4,5,20.0%,28m
37095,1,Oni,2346,0,1,4,5,20.0%,21m
37095,1,Beza,2346,0,1,4,5,20.0%,37m
37095,1,Xancok,2346,0,0,1,1,0.0%,30m
37095,1,[Arrows]MorpehMaksim,2346,0,0,1,1,0.0%,32m
37095,1,Urm,2346,0,0,1,1,0.0%,32m
37095,1,Smartkill,2346,0,0,2,2,0.0%,46m
37136,2,purgen,2345,826,58,69,127,45.7%,21m
37136,1,[mfxed]DzikaPralka,2345,1199,52,43,95,54.7%,27m
37136,1,Toothless,2345,928,37,23,60,61.7%,4m
37136,3,SilentFear,2345,781,31,29,60,51.7%,35m
37136,1,Arek,2345,968,28,26,54,51.9%,50m
37136,3,azzy,2345,546,21,26,47,44.7%,53m
37136,3,Danken,2345,525,20,23,43,46.5%,18m
37136,3,[Terraz]marcus,2345,538,19,27,46,41.3%,52m
37136,1,Dzumi,2345,500,17,13,30,56.7%,52m
37136,1,VLAD,2345,514,16,14,30,53.3%,42m
37136,3,MatThomSA,2345,443,16,18,34,47.1%,14m
37136,3,TwiiStreaM,2345,437,16,21,37,43.2%,1h
37136,1,[NoMIC]Loki,2345,460,13,10,23,56.5%,48m
37136,3,Atex,2345,338,13,12,25,52.0%,36m
37136,1,Nikita,2345,397,12,20,32,37.5%,16m
37136,1,elektrik,2345,296,9,4,13,69.2%,42m
37136,1,Visionrage,2345,320,9,9,18,50.0%,35m
37136,3,[mfxed]Odin,2345,221,9,14,23,39.1%,22m
37136,1,[AAWW]Txustice,2345,276,8,7,15,53.3%,44m
37136,1,Enem,2345,357,8,13,21,38.1%,48m
37136,3,Sharos,2345,222,6,9,15,40.0%,20m
37136,1,therfouf,2345,203,5,0,5,100.0%,52m
37136,1,cosmos,2345,117,4,0,4,100.0%,17m
37136,1,Raili,2345,126,4,1,5,80.0%,39m
37136,1,KaEmIks,2345,120,4,7,11,36.4%,24m
37136,3,Zerco,2345,58,4,8,12,33.3%,30m
37136,3,PrinzBreidi,2345,121,3,6,9,33.3%,4m
37136,1,Phex,2345,30,3,8,11,27.3%,45m
37136,1,Bartek,2345,42,2,0,2,100.0%,35m
37136,1,Light,2345,0,1,0,1,100.0%,35m
37136,1,[WarKak]Codeglee,2345,97,1,2,3,33.3%,14m
37136,1,Kilebor,2345,40,1,2,3,33.3%,16m
37136,1,upuaut,2345,0,1,5,6,16.7%,41m
37136,2,LAITCHO,2345,0,1,7,8,12.5%,45m
37136,1,piko,2345,0,0,1,1,0.0%,44m
37136,1,RayBradbury,2345,0,0,1,1,0.0%,1h
37136,1,Alarak,2345,0,0,1,1,0.0%,36m
37136,1,Sanek,2345,0,0,2,2,0.0%,45m
37136,1,xKedr,2345,0,0,3,3,0.0%,29m
37136,3,PINGVIN,2345,0,0,8,8,0.0%,29m
37176,3,LaBuche,2344,1483,149,146,295,50.5%,21m
37176,1,FenixPro,2344,1812,112,97,209,53.6%,1h
37176,3,IIIIIIIIIIII,2344,977,50,42,92,54.3%,32m
37176,1,AvaturiusII,2344,459,21,10,31,67.7%,53m
37176,1,RoiDuFeu,2344,746,21,23,44,47.7%,26m
37176,2,GaDanic,2344,350,16,16,32,50.0%,30m
37176,1,Odysseus,2344,541,14,12,26,53.8%,24m
37176,1,Max,2344,328,9,8,17,52.9%,6m
37176,2,[Wänked]Hendrefaist,2344,241,7,14,21,33.3%,16m
37176,3,Pickleswag,2344,145,6,7,13,46.2%,22m
37176,1,Jutikka,2344,172,5,5,10,50.0%,25m
37176,1,арти,2344,132,4,3,7,57.1%,40m
37176,3,SpeCter,2344,125,4,9,13,30.8%,1h
37176,1,GliRoaMutHyd,2344,84,3,2,5,60.0%,1h
37176,1,Hannibal,2344,167,3,6,9,33.3%,27m
37176,1,[ĦĦ]blackbrain,2344,96,3,6,9,33.3%,16m
37176,2,CellarChild,2344,123,3,8,11,27.3%,36m
37176,1,[Chomps]TheChompy,2344,48,2,0,2,100.0%,27m
37176,1,momorinhi,2344,48,2,3,5,40.0%,11m
37176,1,Nagibator,2344,48,2,6,8,25.0%,49m
37176,1,Павел,2344,0,1,0,1,100.0%,52m
37176,1,pdphun,2344,0,1,0,1,100.0%,35m
37176,1,[ARTAS]KidEnot,2344,0,1,0,1,100.0%,36m
37176,1,Gisch,2344,0,1,2,3,33.3%,39m
37176,2,Maks,2344,0,1,4,5,20.0%,50m
37176,2,NightKnight,2344,0,1,4,5,20.0%,28m
37176,2,CapCake,2344,0,1,4,5,20.0%,37m
37176,3,latinofrozen,2344,0,1,5,6,16.7%,17m
37176,1,Ant,2344,0,0,1,1,0.0%,48m
37176,3,DaNiLkA,2344,0,0,1,1,0.0%,54m
37176,1,Ulan,2344,0,0,2,2,0.0%,52m
37176,1,BeingBadAss,2344,0,0,3,3,0.0%,14m
37176,1,IIlIIllIlIll,2344,0,0,3,3,0.0%,23m
37209,3,Spleenfloyd,2343,1518,137,125,262,52.3%,34m
37209,3,hybrid,2343,850,43,47,90,47.8%,6m
37209,2,Cheenaski,2343,1159,39,48,87,44.8%,34m
37209,1,Slipman,2343,1130,37,45,82,45.1%,10m
37209,1,ASH,2343,1003,33,27,60,55.0%,1h
37209,1,hellbot,2343,543,33,28,61,54.1%,4m
37209,3,SkyMyNight,2343,470,15,17,32,46.9%,36m
37209,3,blank,2343,398,14,19,33,42.4%,36m
37209,1,ZloiKILLER,2343,442,12,8,20,60.0%,4m
37209,2,VincentLaw,2343,298,12,8,20,60.0%,31m
37209,1,JustNoobie,2343,187,5,3,8,62.5%,26m
37209,1,rabiddios,2343,101,4,2,6,66.7%,44m
37209,1,spartan,2343,48,4,4,8,50.0%,16m
37209,1,Kwinkwin,2343,48,4,4,8,50.0%,27m
37209,1,mrBlues,2343,176,4,7,11,36.4%,39m
37209,1,Tyvo,2343,86,3,1,4,75.0%,1h
37209,3,Акула,2343,118,3,5,8,37.5%,35m
37209,1,BrexitPlanQ,2343,82,2,4,6,33.3%,17m
37209,1,LegoLaz,2343,0,1,0,1,100.0%,46m
37209,1,голубь,2343,97,1,1,2,50.0%,34m
37209,1,NAGADAGABOO,2343,0,1,1,2,50.0%,5m
37209,3,VartV,2343,34,1,4,5,20.0%,34m
37209,1,alex,2343,0,0,1,1,0.0%,32m
37209,1,riddarn,2343,0,0,1,1,0.0%,7m
37209,1,WXSZCZXS,2343,0,0,1,1,0.0%,39m
37209,1,Lolo,2343,0,0,4,4,0.0%,1h
37209,1,gbts,2343,0,0,5,5,0.0%,24m
37236,1,HoshNaaiers,2342,1681,191,180,371,51.5%,1h
37236,2,Terrano,2342,1474,113,113,226,50.0%,4m
37236,1,Michael,2342,1346,43,42,85,50.6%,46m
37236,1,ChikiPuki,2342,1019,35,32,67,52.2%,48m
37236,2,MrMem,2342,886,34,41,75,45.3%,39m
37236,1,Jangster,2342,766,33,31,64,51.6%,6m
37236,3,SpaceMarine,2342,374,17,15,32,53.1%,17m
37236,1,band,2342,419,15,18,33,45.5%,25m
37236,2,Joe,2342,249,10,14,24,41.7%,3m
37236,1,Prudencia,2342,160,7,10,17,41.2%,46m
37236,1,[DBTU]Lexus,2342,198,5,5,10,50.0%,21m
37236,3,skyfire,2342,147,4,5,9,44.4%,54m
37236,3,Thul,2342,125,4,8,12,33.3%,49m
37236,1,[Пот]Asermora,2342,84,3,0,3,100.0%,42m
37236,1,kenzos,2342,73,3,1,4,75.0%,1h
37236,1,Artsch,2342,134,3,7,10,30.0%,36m
37236,1,[Vizzor]ManiekŁowca,2342,42,2,0,2,100.0%,1h
37236,1,Denis,2342,40,2,3,5,40.0%,44m
37236,1,Nebuchadnezr,2342,48,2,4,6,33.3%,21m
37236,1,[ÖMO]Revenant,2342,97,2,5,7,28.6%,45m
37236,1,George,2342,42,2,6,8,25.0%,35m
37236,1,[lignum]KidRay,2342,0,1,0,1,100.0%,5m
37236,1,[YoiPop]DEN,2342,0,1,0,1,100.0%,28m
37236,1,gigilord,2342,0,1,0,1,100.0%,39m
37236,3,SlagterSvend,2342,0,1,1,2,50.0%,29m
37236,1,JaNo,2342,0,1,1,2,50.0%,29m
37236,1,PislikBocek,2342,42,1,2,3,33.3%,16m
37236,1,Hator,2342,0,1,2,3,33.3%,1h
37236,3,Noobsterboi,2342,97,1,3,4,25.0%,40m
37236,1,mazzi,2342,0,1,4,5,20.0%,39m
37236,1,Revalacs,2342,0,1,4,5,20.0%,44m
37236,1,DonOmar,2342,0,1,4,5,20.0%,38m
37236,1,зигзаг,2342,0,1,5,6,16.7%,49m
37236,2,LINK,2342,30,1,6,7,14.3%,7m
37236,1,Родослав,2342,0,0,1,1,0.0%,21m
37236,1,FireBall,2342,0,0,1,1,0.0%,1h
37236,1,jujules,2342,73,0,3,3,0.0%,29m
37273,3,Pyrokar,2341,1546,167,168,335,49.9%,35m
37273,1,grjgrj,2341,1825,128,119,247,51.8%,31m
37273,1,HBKnight,2341,997,78,68,146,53.4%,39m
37273,2,Maryz,2341,1114,68,71,139,48.9%,4m
37273,2,lazyturtle,2341,1389,66,68,134,49.3%,31m
37273,1,Tistobal,2341,1588,60,52,112,53.6%,1h
37273,1,QeenNayeon,2341,1567,56,47,103,54.4%,1h
37273,1,DECIMOTERCER,2341,1155,54,35,89,60.7%,51m
37273,3,Pudding,2341,1152,46,50,96,47.9%,6m
37273,1,NiceHentai,2341,940,43,42,85,50.6%,46m
37273,1,Volkano,2341,1053,41,33,74,55.4%,38m
37273,2,Excel,2341,860,33,44,77,42.9%,18m
37273,3,[KingzR]Waiseheill,2341,592,24,33,57,42.1%,12m
37273,3,Kostello,2341,364,19,23,42,45.2%,24m
37273,3,testtest,2341,372,17,14,31,54.8%,24m
37273,1,SOUL,2341,399,13,13,26,50.0%,1h
37273,1,[Radium]Tiger,2341,146,5,0,5,100.0%,16m
37273,1,zuprextra,2341,194,5,4,9,55.6%,19m
37273,1,MIGGS,2341,214,5,8,13,38.5%,7m
37273,1,Mongo,2341,115,4,8,12,33.3%,1h
37273,1,Angetimi,2341,80,3,3,6,50.0%,21m
37273,1,llllllll,2341,145,3,3,6,50.0%,27m
37273,1,Харкур,2341,30,2,1,3,66.7%,43m
37273,1,OmgItsAlx,2341,42,2,2,4,50.0%,1h
37273,1,[FDVR]Justin,2341,0,2,5,7,28.6%,1h
37273,3,STARBUCKS,2341,0,2,6,8,25.0%,34m
37273,3,Arrogant,2341,95,2,6,8,25.0%,35m
37273,3,Pyro,2341,60,2,10,12,16.7%,42m
37273,1,[RUS61]Egorka,2341,0,1,1,2,50.0%,16m
37273,1,GoodGames,2341,46,1,3,4,25.0%,39m
37273,1,Falk,2341,48,1,4,5,20.0%,1h
37273,1,bala,2341,0,1,5,6,16.7%,42m
37273,1,Reiter,2341,0,0,1,1,0.0%,53m
37273,1,Ron,2341,0,0,1,1,0.0%,33m
37273,1,brainstorm,2341,0,0,2,2,0.0%,6m
37308,3,Weolland,2340,872,64,57,121,52.9%,11m
37308,2,PinkDragoon,2340,922,41,46,87,47.1%,1h
37308,3,[güntgn]Modicum,2340,684,25,29,54,46.3%,32m
37308,1,enot,2340,407,17,24,41,41.5%,51m
37308,3,coco,2340,282,15,14,29,51.7%,35m
37308,1,Lenour,2340,416,14,18,32,43.8%,45m
37308,1,Rexsone,2340,500,13,13,26,50.0%,32m
37308,3,AgentJH,2340,320,12,15,27,44.4%,21m
37308,1,Sleepless,2340,192,7,6,13,53.8%,52m
37308,1,Valokordin,2340,142,5,4,9,55.6%,8m
37308,3,Webi,2340,122,3,3,6,50.0%,14m
37308,1,Greendale,2340,145,3,6,9,33.3%,13m
37308,1,Haimdall,2340,116,3,7,10,30.0%,32m
37308,1,Vrudor,2340,82,2,2,4,50.0%,46m
37308,1,Hoplita,2340,111,2,2,4,50.0%,46m
37308,1,[SAE]JohannesT,2340,86,2,3,5,40.0%,48m
37308,1,JaviRC,2340,82,2,3,5,40.0%,46m
37308,3,[FUARK]Rebourne,2340,127,2,4,6,33.3%,5m
37308,1,EoS,2340,86,2,5,7,28.6%,43m
37308,1,ImposterJR,2340,86,2,5,7,28.6%,35m
37308,1,tkhonya,2340,121,2,6,8,25.0%,35m
37308,1,damage,2340,0,1,1,2,50.0%,7m
37308,2,IIIIIIIII,2340,0,1,1,2,50.0%,33m
37308,1,ǂßẫŊąŊƏǂ,2340,0,1,3,4,25.0%,25m
37308,1,BIGDOG,2340,42,1,5,6,16.7%,51m
37308,1,zedy,2340,0,1,5,6,16.7%,45m
37308,1,Marquo,2340,0,1,5,6,16.7%,31m
37308,1,dadadada,2340,0,1,6,7,14.3%,16m
37308,2,MadaraCZ,2340,0,0,1,1,0.0%,37m
37337,1,[WSKY]sky,2339,1682,66,63,129,51.2%,1h
37337,1,BARACAS,2339,1614,57,48,105,54.3%,5m
37337,1,RoosterJr,2339,1241,48,42,90,53.3%,2m
37337,1,WarPriCe,2339,929,31,36,67,46.3%,36m
37337,1,Takato,2339,757,27,18,45,60.0%,50m
37337,1,TheDarDevil,2339,697,27,38,65,41.5%,53m
37337,3,KANTUSA,2339,696,25,30,55,45.5%,21m
37337,3,assajak,2339,565,24,25,49,49.0%,1h
37337,1,[зерно]KibeRPanc,2339,554,22,10,32,68.8%,3m
37337,1,Bendogg,2339,388,13,17,30,43.3%,55m
37337,1,LitNik,2339,312,9,6,15,60.0%,42m
37337,1,Ian,2339,262,9,8,17,52.9%,1h
37337,1,BETLEROK,2339,322,9,12,21,42.9%,5m
37337,3,Dat,2339,300,9,14,23,39.1%,28m
37337,2,Zeta,2339,261,9,14,23,39.1%,53m
37337,2,react,2339,130,5,13,18,27.8%,17m
37337,1,eXmorTis,2339,136,4,4,8,50.0%,1h
37337,1,DaniiXeto,2339,84,3,2,5,60.0%,5m
37337,1,Рекрут,2339,0,3,2,5,60.0%,25m
37337,1,[ZERGTV]ЗлойДух,2339,78,2,3,5,40.0%,51m
37337,1,Atreides,2339,0,1,0,1,100.0%,46m
37337,1,[Apoka1]тимофей,2339,0,1,0,1,100.0%,32m
37337,1,SamuraiHunt,2339,40,1,1,2,50.0%,43m
37337,1,Highlander,2339,88,1,2,3,33.3%,39m
37337,1,[HASTER]EvenFast,2339,42,1,2,3,33.3%,10m
37337,1,TaLiBAN,2339,0,1,4,5,20.0%,1h
37337,2,Tintron,2339,0,1,4,5,20.0%,51m
37337,1,Archi,2339,0,1,4,5,20.0%,17m
37337,1,Scarlett,2339,0,0,1,1,0.0%,44m
37337,1,[BrothW]Seryas,2339,0,0,1,1,0.0%,8m
37337,1,[lZornG]Алек,2339,0,0,2,2,0.0%,19m
37368,1,[ExTr1m]gizmatulin,2338,1836,130,128,258,50.4%,1h
37368,1,NudeDude,2338,1169,75,95,170,44.1%,1h
37368,2,Mocki,2338,586,34,41,75,45.3%,6m
37368,1,[wazzzz]KAWABOUGA,2338,529,32,27,59,54.2%,17m
37368,1,[AtrK]MaverickS,2338,793,27,20,47,57.4%,42m
37368,1,BigC,2338,596,24,13,37,64.9%,34m
37368,3,diabezdemona,2338,482,19,27,46,41.3%,16m
37368,1,andrey,2338,304,12,16,28,42.9%,1h
37368,3,Phil,2338,346,11,20,31,35.5%,33m
37368,2,BlackGhost,2338,204,7,12,19,36.8%,50m
37368,1,Zir,2338,135,6,7,13,46.2%,37m
37368,3,sdghsjk,2338,158,6,8,14,42.9%,14m
37368,3,Broc,2338,196,6,10,16,37.5%,35m
37368,1,Alfirionfirs,2338,192,5,9,14,35.7%,34m
37368,3,[LeSang]Narvalo,2338,142,4,5,9,44.4%,28m
37368,2,Max,2338,30,4,8,12,33.3%,21m
37368,2,strain,2338,118,4,11,15,26.7%,21m
37368,1,BlackParrot,2338,145,2,2,4,50.0%,16m
37368,1,LoKET,2338,38,2,4,6,33.3%,24m
37368,1,[НОД17]DonWin,2338,97,2,5,7,28.6%,24m
37368,1,DarkStar,2338,48,2,6,8,25.0%,49m
37368,1,Arbot,2338,42,1,1,2,50.0%,34m
37368,1,Cowpower,2338,0,1,1,2,50.0%,14m
37368,1,[Нrr]Rensir,2338,0,1,1,2,50.0%,35m
37368,2,zenit,2338,0,1,2,3,33.3%,10m
37368,1,[TBRain]Sawano,2338,0,1,4,5,20.0%,39m
37368,1,Frawks,2338,0,1,4,5,20.0%,1h
37368,2,Methnic,2338,0,0,1,1,0.0%,18m
37368,1,Dambo,2338,0,0,1,1,0.0%,38m
37368,1,[Giper]Viktoriya,2338,0,0,1,1,0.0%,32m
37368,1,Вова,2338,0,0,1,1,0.0%,39m
37368,1,nefas,2338,0,0,3,3,0.0%,24m
37400,2,tuğçe,2337,1478,193,188,381,50.7%,20m
37400,3,Hardett,2337,1442,167,175,342,48.8%,14m
37400,2,Farenheit,2337,754,99,107,206,48.1%,22m
37400,1,Loec,2337,1003,36,28,64,56.2%,28m
37400,3,Sharm,2337,346,20,26,46,43.5%,36m
37400,1,Senpai,2337,466,13,8,21,61.9%,5m
37400,3,equinox,2337,281,9,13,22,40.9%,32m
37400,1,AlexTiger,2337,252,7,4,11,63.6%,5m
37400,3,RashMen,2337,172,5,5,10,50.0%,17m
37400,1,[Щитон]RAmz,2337,210,5,6,11,45.5%,17m
37400,2,Andreas,2337,46,4,10,14,28.6%,7m
37400,2,макар,2337,0,3,2,5,60.0%,47m
37400,1,Flesh,2337,96,3,2,5,60.0%,1h
37400,1,Protoss,2337,0,3,2,5,60.0%,30m
37400,3,Клюква,2337,0,3,5,8,37.5%,51m
37400,1,[WWOGU]Zero,2337,46,2,0,2,100.0%,44m
37400,3,Thieums,2337,42,2,5,7,28.6%,1h
37400,1,Starman,2337,0,1,0,1,100.0%,24m
37400,1,Kerotic,2337,0,1,0,1,100.0%,31m
37400,1,SHEL,2337,48,1,2,3,33.3%,48m
37400,1,ustes,2337,48,1,3,4,25.0%,35m
37400,1,LChaos,2337,0,1,4,5,20.0%,17m
37400,1,LéDovahkiin,2337,0,1,4,5,20.0%,28m
37423,3,[RVodka]Nikon,2336,1590,124,120,244,50.8%,19m
37423,1,Starfighter,2336,1504,122,121,243,50.2%,3m
37423,1,hoRkiN,2336,1767,115,108,223,51.6%,1h
37423,3,MAG,2336,1390,79,78,157,50.3%,1h
37423,1,soszkers,2336,1639,57,51,108,52.8%,1h
37423,3,PATTQUARTIER,2336,468,39,30,69,56.5%,24m
37423,3,fleck,2336,1096,38,47,85,44.7%,44m
37423,3,Venetica,2336,938,35,41,76,46.1%,5m
37423,3,[VNT4GE]MadMax,2336,582,24,19,43,55.8%,11m
37423,1,RozwalaczJd,2336,560,19,12,31,61.3%,16m
37423,1,Performer,2336,464,16,21,37,43.2%,16m
37423,1,Nom,2336,379,12,14,26,46.2%,17m
37423,1,[Order]Ragnarok,2336,214,9,7,16,56.2%,52m
37423,3,[ScHb3R]razer,2336,180,8,14,22,36.4%,7m
37423,1,Losthippie,2336,280,7,7,14,50.0%,27m
37423,3,fatfa,2336,140,5,7,12,41.7%,43m
37423,1,Hubert,2336,144,5,7,12,41.7%,28m
37423,1,DarkMarine,2336,91,4,8,12,33.3%,35m
37423,1,LovkiZerg,2336,149,4,9,13,30.8%,1h
37423,1,Scion,2336,82,3,1,4,75.0%,1h
37423,1,VimanA,2336,86,3,2,5,60.0%,18m
37423,1,SlaaV,2336,122,3,5,8,37.5%,29m
37423,1,Сергей,2336,96,3,7,10,30.0%,45m
37423,3,PajaxCZ,2336,30,3,7,10,30.0%,1h
37423,1,DesanteR,2336,42,2,1,3,66.7%,34m
37423,1,jenvador,2336,138,2,5,7,28.6%,17m
37423,1,TrUkO,2336,48,2,6,8,25.0%,8m
37423,1,[TBiC]DeXaT,2336,122,2,6,8,25.0%,29m
37423,1,[Tales]Volcano,2336,0,1,0,1,100.0%,37m
37423,1,gruby,2336,0,1,0,1,100.0%,8m
37423,2,jajcogniot,2336,0,1,4,5,20.0%,14m
37423,2,[SIGEVL]BadRandolph,2336,0,1,4,5,20.0%,47m
37423,2,Sipuli,2336,0,1,4,5,20.0%,50m
37423,1,BobII,2336,44,1,5,6,16.7%,24m
37423,1,Charmed,2336,32,1,5,6,16.7%,21m
37423,1,slider,2336,44,1,6,7,14.3%,14m
37423,1,ЧёрныйКот,2336,0,0,1,1,0.0%,28m
37460,1,Libor,2335,1814,112,109,221,50.7%,1h
37460,2,[2hrd4u]Sualc,2335,1512,71,72,143,49.7%,1h
37460,1,Det,2335,1821,70,72,142,49.3%,14m
37460,1,tiego,2335,1312,62,68,130,47.7%,28m
37460,3,GREEN,2335,946,45,49,94,47.9%,22m
37460,1,WIELKLEB,2335,122,8,3,11,72.7%,22m
37460,3,крабик,2335,211,7,7,14,50.0%,44m
37460,1,bacura,2335,250,7,8,15,46.7%,48m
37460,3,Slash,2335,178,7,10,17,41.2%,49m
37460,1,Trump,2335,212,7,15,22,31.8%,21m
37460,2,FrostyNova,2335,0,4,1,5,80.0%,10m
37460,1,cerseixd,2335,132,4,7,11,36.4%,6m
37460,3,Warlord,2335,72,4,10,14,28.6%,32m
37460,1,РозовыйПони,2335,145,3,7,10,30.0%,31m
37460,1,wormaaaa,2335,149,3,9,12,25.0%,38m
37460,1,sificrafter,2335,121,2,1,3,66.7%,32m
37460,1,[DeaDNB]BLACKSTAR,2335,42,2,2,4,50.0%,51m
37460,1,Saman,2335,88,2,2,4,50.0%,55m
37460,1,Fanat,2335,44,1,2,3,33.3%,35m
37460,2,[SC2KI]Sentinal,2335,0,1,4,5,20.0%,41m
37460,2,Diomede,2335,0,1,4,5,20.0%,1h
37460,1,CaptainHervé,2335,0,0,2,2,0.0%,54m
37460,3,[Bould]Crambu,2335,0,0,2,2,0.0%,54m
37460,1,Hateless,2335,0,0,5,5,0.0%,33m
37484,3,[Torba]Hunter,2334,251,101,87,188,53.7%,49m
37484,3,jevx,2334,1498,70,65,135,51.9%,1h
37484,2,moRRT,2334,1071,52,56,108,48.1%,45m
37484,3,JUANKAR,2334,1028,39,38,77,50.6%,1h
37484,1,ilya,2334,616,18,16,34,52.9%,5m
37484,1,[NoMøre]ObTortoCollo,2334,479,17,7,24,70.8%,36m
37484,3,Беззаботный,2334,396,14,14,28,50.0%,14m
37484,1,renkagop,2334,266,14,17,31,45.2%,4m
37484,2,TECHNiCK,2334,360,14,23,37,37.8%,52m
37484,1,shangrila,2334,430,12,13,25,48.0%,48m
37484,1,Karnickel,2334,428,12,15,27,44.4%,36m
37484,1,keavan,2334,384,10,9,19,52.6%,48m
37484,1,Леший,2334,354,9,10,19,47.4%,5m
37484,1,nsd,2334,224,7,5,12,58.3%,53m
37484,1,Forve,2334,125,7,15,22,31.8%,24m
37484,1,[BNest]ChuRe,2334,228,6,5,11,54.5%,32m
37484,3,[Pkr]CoFFeiN,2334,148,6,7,13,46.2%,54m
37484,2,aegerad,2334,148,6,11,17,35.3%,31m
37484,1,LazyTitan,2334,166,5,2,7,71.4%,53m
37484,1,cuk,2334,122,4,1,5,80.0%,39m
37484,1,[Chariz]Christmas,2334,130,4,2,6,66.7%,31m
37484,3,[NLSB]Starven,2334,86,4,8,12,33.3%,15m
37484,1,[Xy9lce]immaeagle,2334,124,3,6,9,33.3%,6m
37484,1,irrational,2334,36,2,0,2,100.0%,44m
37484,1,PromeX,2334,97,2,6,8,25.0%,4m
37484,1,XElisTratX,2334,0,1,0,1,100.0%,8m
37484,1,meem,2334,0,1,4,5,20.0%,1h
37484,1,[ŁBD]Outlander,2334,44,1,5,6,16.7%,32m
37484,1,Kali,2334,0,0,1,1,0.0%,7m
37484,1,ken,2334,0,0,1,1,0.0%,7m
37484,2,ludoleader,2334,0,0,5,5,0.0%,47m
37515,3,OmegaSupreme,2333,1041,61,67,128,47.7%,19m
37515,3,Gaja,2333,1608,57,63,120,47.5%,23m
37515,2,RuiNeR,2333,1106,52,41,93,55.9%,55m
37515,2,SoUThDoGG,2333,1199,49,62,111,44.1%,39m
37515,3,Olo,2333,367,38,41,79,48.1%,17m
37515,3,Zeratul,2333,318,16,18,34,47.1%,24m
37515,1,Igord,2333,442,14,9,23,60.9%,39m
37515,1,NIMCblue,2333,382,13,4,17,76.5%,3m
37515,3,Faxonal,2333,227,9,10,19,47.4%,10m
37515,1,[LEVARP]MrFang,2333,288,8,9,17,47.1%,10m
37515,1,[WАSD]DelcoreEgo,2333,269,8,15,23,34.8%,1h
37515,3,[RBlood]Epyks,2333,251,7,12,19,36.8%,33m
37515,1,КузькинаМать,2333,200,6,3,9,66.7%,37m
37515,1,noone,2333,84,6,3,9,66.7%,22m
37515,3,MiCrObE,2333,175,6,10,16,37.5%,37m
37515,3,Robot,2333,182,5,5,10,50.0%,52m
37515,1,akaNaka,2333,168,5,7,12,41.7%,51m
37515,2,[chah]prometheus,2333,128,5,15,20,25.0%,22m
37515,1,MaderFlex,2333,165,4,2,6,66.7%,17m
37515,1,ricoshet,2333,128,3,5,8,37.5%,48m
37515,1,nutex,2333,170,3,7,10,30.0%,28m
37515,3,leyzaro,2333,36,2,5,7,28.6%,23m
37515,1,mou,2333,152,2,6,8,25.0%,1h
37515,1,Del,2333,0,1,2,3,33.3%,18m
37515,1,WJooH,2333,40,1,2,3,33.3%,21m
37515,2,librarian,2333,0,1,2,3,33.3%,13m
37515,1,[NoeSS]Павел,2333,0,1,2,3,33.3%,25m
37515,1,overmintea,2333,42,1,5,6,16.7%,12m
37515,1,Матвей,2333,0,1,5,6,16.7%,1h
37515,3,[kill2u]Jimiasty,2333,30,1,11,12,8.3%,49m
37515,3,Urael,2333,0,0,7,7,0.0%,24m
37546,3,fortheKing,2332,1202,178,172,350,50.9%,17m
37546,3,Kuskus,2332,756,70,67,137,51.1%,41m
37546,2,wizzbot,2332,1421,60,61,121,49.6%,1h
37546,1,StrafeMasta,2332,1266,43,43,86,50.0%,44m
37546,2,[TBIRRA]javidr,2332,856,40,51,91,44.0%,41m
37546,2,capy,2332,1015,39,48,87,44.8%,45m
37546,1,DanceParty,2332,1211,38,34,72,52.8%,10m
37546,3,Zorg,2332,1078,38,47,85,44.7%,26m
37546,1,Siempre,2332,593,35,32,67,52.2%,40m
37546,1,Sebeast,2332,754,26,20,46,56.5%,1h
37546,3,[Gоld]Bonuz,2332,364,13,18,31,41.9%,1h
37546,3,AxelderGroße,2332,220,9,7,16,56.2%,42m
37546,3,WalterHelss,2332,151,8,4,12,66.7%,18m
37546,1,DhiseTea,2332,221,7,2,9,77.8%,53m
37546,1,GreyDay,2332,279,6,4,10,60.0%,41m
37546,1,War,2332,176,6,5,11,54.5%,36m
37546,1,[WienA]Truper,2332,166,4,5,9,44.4%,3m
37546,2,[MadKuy]GachiVanya,2332,152,4,8,12,33.3%,44m
37546,1,HeaDwAr,2332,42,3,4,7,42.9%,35m
37546,3,tag,2332,123,3,7,10,30.0%,42m
37546,3,Opanos,2332,30,3,7,10,30.0%,48m
37546,1,makeaturret,2332,80,2,1,3,66.7%,28m
37546,3,Xax,2332,60,2,3,5,40.0%,1h
37546,1,Kaerto,2332,0,1,2,3,33.3%,21m
37546,1,курск,2332,44,1,2,3,33.3%,36m
37546,1,HackForLife,2332,0,0,1,1,0.0%,14m
37572,2,Anthony,2331,865,80,88,168,47.6%,16m
37572,1,DeathRiter,2331,1676,67,64,131,51.1%,49m
37572,3,[NINJ88]Angel,2331,1532,62,65,127,48.8%,40m
37572,1,FeonwOw,2331,1251,52,50,102,51.0%,36m
37572,1,sucemoi,2331,452,21,5,26,80.8%,11m
37572,3,[FrSlip]Leopard,2331,304,12,12,24,50.0%,14m
37572,3,Мужикица,2331,188,12,15,27,44.4%,26m
37572,1,Bollandus,2331,291,9,9,18,50.0%,10m
37572,3,Naymath,2331,225,9,10,19,47.4%,34m
37572,1,Iroc,2331,346,9,13,22,40.9%,17m
37572,1,Shidev,2331,252,7,7,14,50.0%,39m
37572,1,YaourtNature,2331,171,4,0,4,100.0%,36m
37572,1,dominicP,2331,134,4,4,8,50.0%,34m
37572,1,Trup,2331,194,4,6,10,40.0%,42m
37572,1,Psiclops,2331,126,3,3,6,50.0%,44m
37572,1,akurilo,2331,84,3,3,6,50.0%,32m
37572,1,ДимаGSpot,2331,86,3,4,7,42.9%,38m
37572,1,Supernova,2331,76,3,6,9,33.3%,50m
37572,1,Fraker,2331,145,3,6,9,33.3%,23m
37572,3,egorstarkraw,2331,30,3,6,9,33.3%,42m
37572,1,pedro,2331,38,2,0,2,100.0%,47m
37572,1,Tarkwinusz,2331,42,2,1,3,66.7%,28m
37572,1,[ZBteam]trplK,2331,42,2,1,3,66.7%,12m
37572,1,Pianist,2331,97,2,1,3,66.7%,39m
37572,1,[S5RTA]PaulaMamdouh,2331,46,2,5,7,28.6%,34m
37572,3,Kideal,2331,0,2,6,8,25.0%,1h
37572,3,SilentSword,2331,0,1,0,1,100.0%,17m
37572,1,[Raven6]JonatanJosta,2331,0,0,2,2,0.0%,31m
37572,1,Dimas,2331,0,0,5,5,0.0%,1h
37601,3,sandomoto,2330,1570,251,245,496,50.6%,32m
37601,1,[MW2G]Focus,2330,1433,171,164,335,51.0%,39m
37601,3,ironcris,2330,1315,111,121,232,47.8%,1h
37601,2,Pawuk,2330,896,56,58,114,49.1%,51m
37601,1,shOrtle,2330,1150,42,39,81,51.9%,41m
37601,1,Damarantho,2330,1206,41,35,76,53.9%,8m
37601,1,[Айюрец]Fenix,2330,770,26,26,52,50.0%,8m
37601,1,thokar,2330,308,12,13,25,48.0%,36m
37601,1,AsiRis,2330,240,7,5,12,58.3%,10m
37601,3,Emix,2330,164,7,12,19,36.8%,31m
37601,2,[GGTOP]Zlodei,2330,221,6,5,11,54.5%,9m
37601,1,Ninja,2330,244,6,7,13,46.2%,50m
37601,2,Fanta,2330,222,6,13,19,31.6%,3m
37601,1,Arhon,2330,204,5,6,11,45.5%,35m
37601,1,[lBSGl]IVV,2330,150,5,7,12,41.7%,32m
37601,1,chladam,2330,144,5,9,14,35.7%,35m
37601,1,MrWhite,2330,144,5,9,14,35.7%,1h
37601,1,Vishna,2330,214,4,2,6,66.7%,39m
37601,1,hAÏku,2330,188,4,6,10,40.0%,45m
37601,1,Maxi,2330,84,3,2,5,60.0%,38m
37601,1,[258]Cuirassier,2330,199,3,6,9,33.3%,48m
37601,3,Papashka,2330,148,3,7,10,30.0%,1h
37601,1,Fuff,2330,48,2,1,3,66.7%,49m
37601,1,ShevilKID,2330,0,1,0,1,100.0%,6m
37601,1,[НИШТЯК]danytro,2330,0,1,0,1,100.0%,36m
37601,1,[STDES]Krucjata,2330,0,1,1,2,50.0%,26m
37601,3,серг,2330,97,1,3,4,25.0%,53m
37601,1,[Turе22]RixteriuS,2330,0,1,4,5,20.0%,28m
37601,1,BTV,2330,0,1,5,6,16.7%,27m
37601,1,PuhShef,2330,0,0,1,1,0.0%,27m
37601,1,[Саваны]KrinDar,2330,73,0,5,5,0.0%,48m
37632,2,[iSport]JUUHOO,2329,1513,269,273,542,49.6%,49m
37632,3,MVN,2329,1044,138,149,287,48.1%,1h
37632,3,Kinou,2329,1049,41,45,86,47.7%,1h
37632,1,Blaze,2329,654,27,26,53,50.9%,10m
37632,1,Bubble,2329,656,19,16,35,54.3%,39m
37632,3,nikolay,2329,429,17,16,33,51.5%,14m
37632,3,Mojtaba,2329,406,15,22,37,40.5%,9m
37632,1,Saitama,2329,382,13,15,28,46.4%,32m
37632,1,SanSan,2329,416,12,11,23,52.2%,1h
37632,1,GameWinner,2329,347,11,9,20,55.0%,29m
37632,1,laborantkata,2329,259,10,5,15,66.7%,1h
37632,1,zjxpro,2329,354,10,13,23,43.5%,7m
37632,1,WRGC,2329,217,5,8,13,38.5%,35m
37632,1,[Dnmt]MoonBang,2329,174,4,8,12,33.3%,48m
37632,2,speedUp,2329,90,4,10,14,28.6%,29m
37632,1,Daveomac,2329,0,3,4,7,42.9%,28m
37632,2,SQTFU,2329,0,3,6,9,33.3%,22m
37632,1,Bouboule,2329,143,3,8,11,27.3%,16m
37632,3,deswoelfle,2329,0,2,3,5,40.0%,34m
37632,3,Monster,2329,0,1,0,1,100.0%,27m
37632,3,[GawS]Arinoki,2329,0,1,0,1,100.0%,23m
37632,2,MalRey,2329,48,1,1,2,50.0%,1h
37632,1,[brosBE]ErlusPerlu,2329,44,1,1,2,50.0%,27m
37632,1,Tonislaf,2329,0,1,1,2,50.0%,25m
37632,1,ХмурыйМонах,2329,44,1,3,4,25.0%,36m
37632,2,Samul,2329,0,1,4,5,20.0%,28m
37632,2,Sovka,2329,0,0,1,1,0.0%,53m
37632,2,Deqyou,2329,0,0,1,1,0.0%,1h
37632,1,starlitTulip,2329,0,0,1,1,0.0%,22m
37632,1,Unemerix,2329,0,0,2,2,0.0%,24m
37632,1,stasgun,2329,0,0,2,2,0.0%,39m
37632,2,Darktemplar,2329,0,0,5,5,0.0%,14m
37664,1,CEKI,2328,959,81,85,166,48.8%,16m
37664,3,BigPoppa,2328,1197,53,59,112,47.3%,19m
37664,1,Adlay,2328,950,34,28,62,54.8%,35m
37664,1,Lakon,2328,796,32,24,56,57.1%,53m
37664,1,[voodtr]Vincent,2328,862,31,25,56,55.4%,10m
37664,1,cichy,2328,879,29,22,51,56.9%,1h
37664,1,Belgrade,2328,830,22,26,48,45.8%,1h
37664,3,ylloh,2328,260,20,23,43,46.5%,27m
37664,1,lolipop,2328,606,19,14,33,57.6%,45m
37664,1,viktoroven,2328,423,16,14,30,53.3%,49m
37664,1,DimanKS,2328,414,11,14,25,44.0%,50m
37664,3,Trollvrål,2328,313,11,15,26,42.3%,39m
37664,1,Slowpokeplay,2328,258,9,1,10,90.0%,21m
37664,1,Laec,2328,208,6,6,12,50.0%,3m
37664,1,Chuck,2328,181,5,9,14,35.7%,46m
37664,1,GoldenBrown,2328,112,4,6,10,40.0%,35m
37664,2,maroual,2328,106,3,7,10,30.0%,23m
37664,2,ENIGMA,2328,0,2,3,5,40.0%,1h
37664,3,ShinyPants,2328,93,2,5,7,28.6%,33m
37664,1,NightKing,2328,0,2,5,7,28.6%,42m
37664,3,vovar,2328,0,1,0,1,100.0%,54m
37664,3,Buravchik,2328,0,1,0,1,100.0%,40m
37664,1,[рейнор]буба,2328,73,1,3,4,25.0%,46m
37664,1,danik,2328,0,0,1,1,0.0%,38m
37664,1,[HMarch]KNOBODYIKNOW,2328,0,0,1,1,0.0%,19m
37664,3,MadNinjaHach,2328,0,0,1,1,0.0%,18m
37664,1,Dark,2328,0,0,1,1,0.0%,37m
37664,2,justin,2328,0,0,1,1,0.0%,27m
37664,1,Princo,2328,0,0,2,2,0.0%,36m
37664,1,sicario,2328,0,0,2,2,0.0%,14m
37694,3,raven,2327,1523,215,217,432,49.8%,10m
37694,3,LBJ,2327,1573,149,149,298,50.0%,22m
37694,3,[ADM]marc,2327,1338,102,101,203,50.2%,25m
37694,1,TRaLesYnD,2327,852,47,46,93,50.5%,1h
37694,1,DeutscheLowe,2327,1156,44,46,90,48.9%,39m
37694,1,Matpakk,2327,665,24,18,42,57.1%,39m
37694,1,Stas,2327,649,21,15,36,58.3%,32m
37694,1,Snowz,2327,537,18,19,37,48.6%,32m
37694,3,dafi,2327,518,17,25,42,40.5%,5m
37694,1,BiGFooT,2327,554,15,16,31,48.4%,40m
37694,1,тим,2327,338,14,22,36,38.9%,35m
37694,1,[1NFEC7]caillou,2327,325,12,9,21,57.1%,24m
37694,1,Артемон,2327,360,12,14,26,46.2%,32m
37694,2,Zikaël,2327,233,9,12,21,42.9%,20m
37694,1,Lac,2327,260,8,12,20,40.0%,1h
37694,2,Oyrad,2327,303,8,19,27,29.6%,53m
37694,3,[SURN]MicKey,2327,225,7,9,16,43.8%,24m
37694,3,[HsDL]Lafnen,2327,142,6,6,12,50.0%,1h
37694,3,EdyssoN,2327,95,5,7,12,41.7%,10m
37694,1,PUCHINGORRI,2327,108,4,4,8,50.0%,6m
37694,1,Mightyowl,2327,124,3,6,9,33.3%,51m
37694,1,Slamy,2327,76,3,6,9,33.3%,10m
37694,1,Dallak,2327,111,3,7,10,30.0%,51m
37694,2,Zornball,2327,114,3,9,12,25.0%,20m
37694,1,Singylar,2327,88,2,5,7,28.6%,11m
37694,1,Helledussen,2327,0,1,0,1,100.0%,36m
37694,1,toka,2327,0,1,1,2,50.0%,1h
37694,1,PeakDiagram,2327,97,1,2,3,33.3%,39m
37694,1,[TRaven]Phylon,2327,48,1,3,4,25.0%,4m
37694,2,ZENISTAR,2327,0,1,4,5,20.0%,1h
37694,1,Makas,2327,0,1,4,5,20.0%,25m
37694,1,MariaCirneci,2327,0,1,4,5,20.0%,24m
37694,1,kempes,2327,0,0,1,1,0.0%,42m
37694,1,FINN,2327,0,0,3,3,0.0%,10m
37728,1,LukaS,2326,1610,151,158,309,48.9%,46m
37728,3,Adopt,2326,885,36,36,72,50.0%,1h
37728,2,[ANREN]Graf,2326,314,34,35,69,49.3%,33m
37728,1,[AiRǂ]Carogna,2326,996,31,28,59,52.5%,21m
37728,1,schenya,2326,688,22,24,46,47.8%,25m
37728,1,benji,2326,582,16,17,33,48.5%,52m
37728,1,Ali,2326,530,15,18,33,45.5%,49m
37728,3,Alaric,2326,326,14,0,14,100.0%,55m
37728,1,Rahlen,2326,453,11,10,21,52.4%,46m
37728,3,RigorMortis,2326,250,10,14,24,41.7%,19m
37728,1,Sabin,2326,236,7,4,11,63.6%,17m
37728,1,Mensey,2326,248,7,8,15,46.7%,19m
37728,2,Jmead,2326,172,6,17,23,26.1%,45m
37728,1,Hildegunst,2326,70,4,5,9,44.4%,8m
37728,2,[ESW]TerransHill,2326,157,4,8,12,33.3%,43m
37728,1,[PKTS]Sabber,2326,156,3,2,5,60.0%,39m
37728,1,chaika,2326,123,3,6,9,33.3%,6m
37728,2,[050]Majestyk,2326,30,3,7,10,30.0%,31m
37728,1,[Tостер]XstepnX,2326,40,2,0,2,100.0%,36m
37728,3,Lloyl,2326,0,2,5,7,28.6%,10m
37728,3,Krtek,2326,30,2,5,7,28.6%,16m
37728,1,capadonna,2326,86,2,7,9,22.2%,40m
37728,2,[rushaa]XREY,2326,0,1,1,2,50.0%,3m
37728,1,LuckySpike,2326,0,1,2,3,33.3%,23m
37728,3,[kek34]солдат,2326,97,1,2,3,33.3%,35m
37728,1,Daloon,2326,0,1,4,5,20.0%,38m
37728,1,Amazing,2326,0,0,1,1,0.0%,10m
37728,2,pidor,2326,0,0,1,1,0.0%,28m
37728,3,[M5old]twitti,2326,0,0,4,4,0.0%,29m
37757,3,[JaPP]mOrs,2325,1516,398,392,790,50.4%,21m
37757,1,Rubiogoe,2325,1801,216,212,428,50.5%,11m
37757,1,Valkyr,2325,1161,103,97,200,51.5%,3m
37757,3,[Olеg]Cheezh,2325,814,96,92,188,51.1%,19m
37757,3,BiHorpaD,2325,441,35,26,61,57.4%,29m
37757,1,iiieeee,2325,747,35,27,62,56.5%,22m
37757,1,stratagia,2325,557,22,9,31,71.0%,18m
37757,1,[Rarara]TDoggyWoggy,2325,577,20,19,39,51.3%,39m
37757,3,Syrinx,2325,464,19,24,43,44.2%,6m
37757,1,Bourbony,2325,484,18,13,31,58.1%,32m
37757,1,FIREBLADESTR,2325,586,16,14,30,53.3%,41m
37757,3,Levi,2325,373,16,17,33,48.5%,29m
37757,1,Barik,2325,315,15,20,35,42.9%,40m
37757,1,NapoleonV,2325,478,14,19,33,42.4%,32m
37757,1,TheViking,2325,397,11,7,18,61.1%,49m
37757,3,Nimb,2325,281,11,12,23,47.8%,43m
37757,1,Equal,2325,420,11,15,26,42.3%,48m
37757,3,Chelabuk,2325,174,10,11,21,47.6%,44m
37757,1,[EXPANT]Splayn,2325,398,10,14,24,41.7%,8m
37757,1,WEEBARIUM,2325,324,8,7,15,53.3%,45m
37757,1,CoFFin,2325,172,8,8,16,50.0%,17m
37757,1,kill,2325,145,5,4,9,55.6%,1h
37757,2,loganjoe,2325,114,5,12,17,29.4%,10m
37757,1,Styx,2325,74,3,0,3,100.0%,38m
37757,1,Fenix,2325,96,3,3,6,50.0%,6m
37757,3,LOWMANAMAGE,2325,62,3,11,14,21.4%,4m
37757,1,[GamerX]AlphaZero,2325,42,2,0,2,100.0%,24m
37757,1,цербер,2325,121,2,2,4,50.0%,42m
37757,1,DSanGiovanni,2325,97,2,3,5,40.0%,49m
37757,1,[RBZ]Goblin,2325,0,2,9,11,18.2%,43m
37757,2,Schmidy,2325,0,1,0,1,100.0%,26m
37757,1,Бродяга,2325,38,1,1,2,50.0%,14m
37757,2,Tarkar,2325,0,1,4,5,20.0%,39m
37757,1,MrKing,2325,0,1,5,6,16.7%,39m
37757,1,ScorpioMan,2325,0,0,1,1,0.0%,5m
37757,3,Zizou,2325,0,0,2,2,0.0%,42m
37757,3,GröFaZ,2325,0,0,2,2,0.0%,43m
37794,3,сергейРус,2324,1450,183,186,369,49.6%,55m
37794,1,[54D]GvozdukRU,2324,1167,50,53,103,48.5%,1h
37794,3,[xWARx]INFERNALelf,2324,897,49,54,103,47.6%,1h
37794,3,[SngR]gargamel,2324,936,35,45,80,43.8%,6m
37794,1,lIllIIllIllI,2324,756,32,31,63,50.8%,27m
37794,1,Weezyx,2324,635,28,25,53,52.8%,34m
37794,3,Maxmor,2324,257,12,13,25,48.0%,32m
37794,1,ToPoirrot,2324,452,11,14,25,44.0%,51m
37794,2,PorpoiseXQ,2324,256,9,15,24,37.5%,26m
37794,1,[Dose]Wonko,2324,120,3,5,8,37.5%,33m
37794,2,Invizzy,2324,0,1,0,1,100.0%,47m
37794,3,Tapocheck,2324,0,1,0,1,100.0%,45m
37794,2,KekmaN,2324,88,1,1,2,50.0%,1h
37794,1,Veronika,2324,36,1,2,3,33.3%,33m
37794,1,botschek,2324,0,1,4,5,20.0%,1h
37794,2,Coeus,2324,30,1,26,27,3.7%,8m
37794,1,[unuce]Osiris,2324,0,0,1,1,0.0%,37m
37794,2,hayri,2324,0,0,1,1,0.0%,53m
37812,3,ZerGutt,2323,1413,184,178,362,50.8%,53m
37812,1,[SPAINs]PENRIL,2323,1189,133,129,262,50.8%,1h
37812,1,Тимофей,2323,1707,61,61,122,50.0%,53m
37812,1,valekk,2323,1119,43,35,78,55.1%,10m
37812,1,[AIKAK]Cerkill,2323,963,33,25,58,56.9%,21m
37812,1,[MG3M]Interstar,2323,711,21,27,48,43.8%,1h
37812,1,MAX,2323,310,11,7,18,61.1%,19m
37812,1,Wyrwiflak,2323,212,7,10,17,41.2%,30m
37812,1,sweetfood,2323,197,6,1,7,85.7%,17m
37812,3,Snow,2323,150,5,3,8,62.5%,38m
37812,1,MDK,2323,136,5,5,10,50.0%,42m
37812,1,Vak,2323,164,5,7,12,41.7%,38m
37812,1,Decadence,2323,144,5,10,15,33.3%,42m
37812,2,huasheng,2323,122,5,12,17,29.4%,14m
37812,1,sesik,2323,96,4,7,11,36.4%,20m
37812,1,Melenkor,2323,124,4,8,12,33.3%,1h
37812,1,[6L6]pancakes,2323,128,3,6,9,33.3%,53m
37812,2,StarLord,2323,32,2,1,3,66.7%,1h
37812,1,Thevil,2323,0,2,2,4,50.0%,14m
37812,1,STARSKY,2323,0,1,0,1,100.0%,40m
37812,1,жорик,2323,0,1,1,2,50.0%,4m
37812,1,WarpOut,2323,42,1,2,3,33.3%,32m
37812,1,xurewin,2323,48,1,4,5,20.0%,31m
37812,2,Musashi,2323,0,1,4,5,20.0%,47m
37812,1,UltharCat,2323,0,1,5,6,16.7%,32m
37812,1,WishYouLuckk,2323,0,1,5,6,16.7%,7m
37812,1,Furkan,2323,0,1,5,6,16.7%,36m
37812,3,IIIIIIIIIIII,2323,30,1,9,10,10.0%,17m
37812,1,Plestin,2323,0,0,1,1,0.0%,48m
37812,1,prototek,2323,0,0,1,1,0.0%,26m
37842,1,tura,2322,1761,75,58,133,56.4%,1h
37842,3,TossMenda,2322,1323,51,51,102,50.0%,37m
37842,3,Gandalfchris,2322,751,29,31,60,48.3%,20m
37842,1,FASTER,2322,477,20,21,41,48.8%,33m
37842,1,Siriusstar,2322,732,20,21,41,48.8%,48m
37842,1,Watain,2322,507,18,15,33,54.5%,7m
37842,1,shockwave,2322,477,17,22,39,43.6%,49m
37842,2,DOCTORDRAG,2322,252,11,20,31,35.5%,20m
37842,1,GENJIF,2322,406,10,11,21,47.6%,45m
37842,1,[Søre]Yarg,2322,305,10,13,23,43.5%,33m
37842,3,[PUNZEL]Awesome,2322,182,9,11,20,45.0%,33m
37842,1,sasha,2322,0,4,6,10,40.0%,49m
37842,3,jizzgoood,2322,86,4,10,14,28.6%,29m
37842,1,Link,2322,122,3,4,7,42.9%,40m
37842,3,AimlessDuck,2322,30,3,6,9,33.3%,14m
37842,3,сид,2322,126,3,7,10,30.0%,55m
37842,1,Castiel,2322,48,2,6,8,25.0%,31m
37842,1,[рank]Shram,2322,0,1,0,1,100.0%,36m
37842,1,Misha,2322,0,1,0,1,100.0%,29m
37842,1,Selena,2322,0,1,2,3,33.3%,22m
37842,3,Sobriety,2322,0,0,1,1,0.0%,32m
37842,3,ShadoW,2322,0,0,1,1,0.0%,9m
37864,3,bob,2321,1460,244,254,498,49.0%,1h
37864,3,PBMagic,2321,769,59,67,126,46.8%,15m
37864,2,LukiKing,2321,1454,54,63,117,46.2%,20m
37864,2,ImmaNvEl,2321,1056,41,42,83,49.4%,45m
37864,3,TheAlmighty,2321,795,32,29,61,52.5%,38m
37864,1,[NICHE]Bluesoul,2321,387,17,19,36,47.2%,17m
37864,1,Jack,2321,404,14,6,20,70.0%,12m
37864,1,Vania,2321,311,13,4,17,76.5%,35m
37864,3,Moonman,2321,319,11,14,25,44.0%,15m
37864,1,Geks,2321,346,10,6,16,62.5%,1h
37864,3,neituede,2321,239,10,9,19,52.6%,3m
37864,1,FEGY,2321,248,9,5,14,64.3%,36m
37864,1,GoldenGambas,2321,280,9,8,17,52.9%,28m
37864,1,bloko,2321,324,8,5,13,61.5%,1h
37864,2,AlterEgo,2321,144,7,5,12,58.3%,4m
37864,1,csalol,2321,299,7,6,13,53.8%,37m
37864,1,MamsB,2321,203,7,7,14,50.0%,41m
37864,3,Zerg,2321,202,7,13,20,35.0%,19m
37864,3,[VWaile]HATEAGGRO,2321,168,6,10,16,37.5%,16m
37864,1,Azzulla,2321,220,5,4,9,55.6%,22m
37864,1,Levente,2321,209,5,12,17,29.4%,3m
37864,1,SirRiko,2321,110,4,5,9,44.4%,35m
37864,1,Kailek,2321,117,4,6,10,40.0%,44m
37864,1,centfroid,2321,80,3,1,4,75.0%,41m
37864,2,pocok,2321,102,3,6,9,33.3%,41m
37864,1,proGamer,2321,90,2,0,2,100.0%,42m
37864,1,[PDG]BITCOIN,2321,42,2,1,3,66.7%,53m
37864,1,kurten,2321,0,1,0,1,100.0%,4m
37864,1,[Lemnad]Demonaid,2321,0,1,1,2,50.0%,41m
37864,1,vegetable,2321,96,1,1,2,50.0%,7m
37864,1,Scorpion,2321,0,0,1,1,0.0%,1h
37864,1,LizA,2321,0,0,1,1,0.0%,32m
37864,1,ShimrAa,2321,0,0,2,2,0.0%,7m
37864,1,Avel,2321,0,0,2,2,0.0%,31m
37864,3,Limonchik,2321,0,0,2,2,0.0%,1h
37864,1,KisShot,2321,0,0,2,2,0.0%,21m
37864,1,Fcknkarl,2321,0,0,4,4,0.0%,19m
37901,2,lewandl,2320,1544,233,230,463,50.3%,21m
37901,1,GnrlFailure,2320,1491,67,63,130,51.5%,31m
37901,3,BLAZE,2320,1055,52,47,99,52.5%,26m
37901,1,RedSnow,2320,291,11,5,16,68.8%,48m
37901,1,MrSalamandr,2320,331,11,6,17,64.7%,1h
37901,1,Batlakruta,2320,410,11,9,20,55.0%,1h
37901,1,DarkFart,2320,331,11,17,28,39.3%,1h
37901,1,Tuubi,2320,326,9,6,15,60.0%,7m
37901,3,Lunkan,2320,256,9,16,25,36.0%,35m
37901,1,apocc,2320,285,8,15,23,34.8%,19m
37901,2,Dodo,2320,157,6,10,16,37.5%,51m
37901,1,Moço,2320,210,5,11,16,31.2%,1h
37901,2,learton,2320,155,4,8,12,33.3%,36m
37901,1,sorrelh,2320,86,3,3,6,50.0%,1h
37901,3,Lazy,2320,122,3,4,7,42.9%,22m
37901,1,Stukov,2320,42,2,3,5,40.0%,38m
37901,1,PinkPanther,2320,0,1,0,1,100.0%,1h
37901,1,Slimshady,2320,0,1,0,1,100.0%,1h
37901,1,Askf,2320,0,1,1,2,50.0%,25m
37901,1,qsen,2320,0,1,5,6,16.7%,30m
37901,1,ImDuartePT,2320,89,1,5,6,16.7%,30m
37901,1,[HMarch]CyberKNIGHT,2320,40,1,6,7,14.3%,1h
37901,3,smiims,2320,0,1,8,9,11.1%,27m
37901,1,Wuju,2320,0,0,1,1,0.0%,35m
37901,2,[Foxize]Vad,2320,0,0,1,1,0.0%,14m
37926,2,BELKA,2319,874,66,79,145,45.5%,45m
37926,1,Tomtom,2319,1467,55,53,108,50.9%,1h
37926,1,KopabJIeB,2319,733,33,34,67,49.3%,12m
37926,1,Falcon,2319,892,27,32,59,45.8%,24m
37926,3,Adora,2319,582,21,30,51,41.2%,49m
37926,1,[59APM]aVerLOK,2319,519,14,12,26,53.8%,34m
37926,1,LoafBox,2319,377,13,5,18,72.2%,30m
37926,1,Macno,2319,257,12,16,28,42.9%,13m
37926,1,trottelacht,2319,261,11,14,25,44.0%,34m
37926,1,JokkePokke,2319,228,10,5,15,66.7%,36m
37926,3,Computer,2319,256,8,9,17,47.1%,14m
37926,1,[krdo]SilentStorm,2319,204,6,6,12,50.0%,12m
37926,2,[STMS]traktor,2319,138,5,6,11,45.5%,48m
37926,1,EpicJD,2319,193,3,2,5,60.0%,39m
37926,1,zuurkool,2319,78,3,6,9,33.3%,14m
37926,3,[FSMD88]Mailman,2319,58,3,9,12,25.0%,53m
37926,1,Nitora,2319,48,2,0,2,100.0%,49m
37926,1,Zatoichi,2319,88,2,3,5,40.0%,3m
37926,1,Nanabot,2319,82,2,4,6,33.3%,19m
37926,1,OnLink,2319,82,2,4,6,33.3%,39m
37926,1,DowntuTim,2319,42,2,4,6,33.3%,55m
37926,1,[Nagplz]JellyBear,2319,42,2,5,7,28.6%,35m
37926,2,Sputnik,2319,0,2,7,9,22.2%,18m
37926,1,[OЗД]AnimesKun,2319,0,1,1,2,50.0%,18m
37926,3,pad,2319,97,1,2,3,33.3%,1h
37951,1,chardonay,2318,1651,111,106,217,51.2%,8m
37951,1,bibilbo,2318,1778,94,86,180,52.2%,49m
37951,1,Malibu,2318,1447,55,48,103,53.4%,39m
37951,2,[LeNi3]KoRnELpl,2318,1144,44,50,94,46.8%,29m
37951,3,Deterok,2318,912,34,40,74,45.9%,34m
37951,1,[PrTer]Chadwick,2318,865,29,28,57,50.9%,1h
37951,3,Scrofula,2318,605,23,35,58,39.7%,12m
37951,1,NottNott,2318,570,22,18,40,55.0%,17m
37951,1,вонючийносок,2318,396,16,9,25,64.0%,44m
37951,1,WindCent,2318,606,16,16,32,50.0%,1h
37951,1,Reomi,2318,527,14,11,25,56.0%,21m
37951,1,NiaZi,2318,213,7,12,19,36.8%,24m
37951,1,[Töff]Enkephalin,2318,252,6,8,14,42.9%,31m
37951,1,asandrik,2318,162,4,4,8,50.0%,51m
37951,3,vlad,2318,121,4,6,10,40.0%,5m
37951,1,Pedro,2318,147,4,7,11,36.4%,35m
37951,1,Gundul,2318,124,3,5,8,37.5%,16m
37951,1,monti,2318,42,2,1,3,66.7%,7m
37951,1,DarkMewtu,2318,40,2,5,7,28.6%,38m
37951,1,[DEAD2R]SLAY,2318,42,1,2,3,33.3%,31m
37951,2,Athlon,2318,0,1,2,3,33.3%,26m
37951,1,Motomoto,2318,42,1,4,5,20.0%,47m
37951,2,OperCWALL,2318,0,1,4,5,20.0%,29m
37951,2,Dattyberg,2318,0,1,4,5,20.0%,29m
37951,1,[DoPzz]Claw,2318,0,1,5,6,16.7%,21m
37951,1,ASMA,2318,0,1,5,6,16.7%,35m
37951,2,FutureFunk,2318,0,1,5,6,16.7%,52m
37951,1,gogaie,2318,0,0,1,1,0.0%,15m
37951,1,[PrTer]Srg,2318,0,0,2,2,0.0%,3m
37951,1,elMariachi,2318,0,0,2,2,0.0%,34m
37981,1,Lasper,2317,1799,142,136,278,51.1%,22m
37981,1,Kurrupt,2317,1423,68,66,134,50.7%,36m
37981,3,Ando,2317,1444,59,62,121,48.8%,14m
37981,1,COFFEEMAN,2317,906,43,39,82,52.4%,19m
37981,1,Besen,2317,516,22,15,37,59.5%,1h
37981,1,[Dokii]DARKSTAR,2317,364,15,14,29,51.7%,1h
37981,3,BadWizzo,2317,356,11,20,31,35.5%,4m
37981,1,[GdAT]sansego,2317,314,9,9,18,50.0%,46m
37981,3,TestoTom,2317,263,9,13,22,40.9%,11m
37981,1,potato,2317,200,8,7,15,53.3%,17m
37981,3,Zaharel,2317,0,4,6,10,40.0%,17m
37981,1,ric,2317,169,4,7,11,36.4%,19m
37981,1,Zulraggar,2317,158,4,7,11,36.4%,36m
37981,1,Liveno,2317,0,3,3,6,50.0%,22m
37981,1,Sultanius,2317,126,3,6,9,33.3%,1h
37981,1,Deckim,2317,42,2,1,3,66.7%,1h
37981,2,Hoakin,2317,0,2,3,5,40.0%,34m
37981,1,HeyRock,2317,0,2,3,5,40.0%,32m
37981,1,[яєѕ]Morpheus,2317,44,2,4,6,33.3%,39m
37981,2,[Smok3r]CheckOff,2317,143,2,5,7,28.6%,3m
37981,1,Саня,2317,105,2,5,7,28.6%,30m
37981,1,BattleBot,2317,0,1,4,5,20.0%,16m
37981,2,Tychon,2317,36,1,4,5,20.0%,17m
37981,1,DarkmaN,2317,0,1,4,5,20.0%,39m
37981,2,Nestro,2317,0,1,4,5,20.0%,1h
37981,1,Miiii,2317,0,1,5,6,16.7%,19m
37981,1,EnzoGiorgi,2317,0,1,5,6,16.7%,50m
37981,1,[xTBBSx]Venemones,2317,97,1,6,7,14.3%,34m
37981,1,wishn,2317,0,0,1,1,0.0%,32m
37981,1,[ISC2I]Smolfy,2317,0,0,1,1,0.0%,1h
37981,1,[EOSE]Destination,2317,0,0,2,2,0.0%,54m
37981,1,bigstarnik,2317,0,0,3,3,0.0%,5m
38013,1,[АСС]СэрГригорий,2316,1330,69,73,142,48.6%,3m
38013,1,runes,2316,837,42,25,67,62.7%,32m
38013,1,BOBRODA,2316,900,36,26,62,58.1%,50m
38013,1,STARGAZEYPIE,2316,705,34,16,50,68.0%,1h
38013,1,Joker,2316,700,27,25,52,51.9%,10m
38013,2,Aragami,2316,649,25,28,53,47.2%,14m
38013,1,campa,2316,322,24,26,50,48.0%,52m
38013,1,CHIMPATOM,2316,620,20,23,43,46.5%,25m
38013,1,Niviera,2316,274,19,23,42,45.2%,46m
38013,3,slkfdddd,2316,576,19,25,44,43.2%,33m
38013,1,garlik,2316,382,14,10,24,58.3%,38m
38013,1,[AntiZ]seawaks,2316,374,13,8,21,61.9%,22m
38013,1,ffatu,2316,353,11,9,20,55.0%,1h
38013,1,Adun,2316,362,11,10,21,52.4%,1h
38013,1,totor,2316,283,8,6,14,57.1%,5m
38013,1,Ozimandiás,2316,234,7,5,12,58.3%,49m
38013,1,Pileofshiit,2316,286,7,10,17,41.2%,22m
38013,3,Alex,2316,226,7,11,18,38.9%,48m
38013,1,MaxX,2316,160,6,4,10,60.0%,3m
38013,3,MRW,2316,197,5,12,17,29.4%,20m
38013,1,Frantic,2316,126,4,6,10,40.0%,27m
38013,1,rekcneb,2316,141,4,7,11,36.4%,26m
38013,1,USSR,2316,116,3,5,8,37.5%,6m
38013,2,Ecor,2316,0,2,1,3,66.7%,40m
38013,3,Silenther,2316,120,2,1,3,66.7%,23m
38013,1,ArrowWarrior,2316,86,2,2,4,50.0%,38m
38013,3,Cenete,2316,30,2,2,4,50.0%,52m
38013,1,maxformer,2316,84,2,2,4,50.0%,48m
38013,1,DAJMON,2316,82,2,3,5,40.0%,1h
38013,1,САНГВИНИЙ,2316,30,2,3,5,40.0%,1h
38013,3,OctoGone,2316,0,2,7,9,22.2%,27m
38013,1,BOGUS,2316,0,1,0,1,100.0%,39m
38013,1,WickedSaint,2316,0,1,0,1,100.0%,55m
38013,1,Leilin,2316,0,1,1,2,50.0%,40m
38013,1,COMPOglobal,2316,0,1,2,3,33.3%,32m
38013,1,George,2316,0,1,2,3,33.3%,40m
38013,2,EvanBurner,2316,0,1,3,4,25.0%,41m
38013,3,[PALTIM]PulSe,2316,30,1,4,5,20.0%,49m
38013,2,EniK,2316,0,1,4,5,20.0%,37m
38013,1,Comunix,2316,0,1,5,6,16.7%,30m
38013,1,ssBLEACHss,2316,0,1,5,6,16.7%,55m
38013,1,mielu,2316,0,0,1,1,0.0%,10m
38013,1,Святик,2316,0,0,1,1,0.0%,3m
38013,2,Ekatasun,2316,0,0,1,1,0.0%,29m
38013,3,[GGWPGO]Fenix,2316,0,0,2,2,0.0%,1h
38013,2,Hidaru,2316,0,0,4,4,0.0%,41m
38059,1,AXL,2315,1440,168,165,333,50.5%,19m
38059,1,KoT,2315,1580,59,48,107,55.1%,42m
38059,3,ccc,2315,715,34,21,55,61.8%,45m
38059,1,Олег,2315,767,25,23,48,52.1%,6m
38059,1,смертобрюх,2315,643,18,17,35,51.4%,30m
38059,1,WinSmoke,2315,262,15,14,29,51.7%,46m
38059,1,СуперЗалупа,2315,492,15,14,29,51.7%,25m
38059,3,Владос,2315,419,14,15,29,48.3%,43m
38059,3,highpin,2315,158,8,5,13,61.5%,11m
38059,3,GEOgreEMe,2315,224,8,11,19,42.1%,9m
38059,2,Adii,2315,90,7,10,17,41.2%,24m
38059,1,[SLW]speedyPifPaf,2315,236,6,8,14,42.9%,1h
38059,1,MAHAX,2315,131,5,4,9,55.6%,19m
38059,1,InsaneBee,2315,122,4,4,8,50.0%,12m
38059,1,Sadic,2315,164,4,7,11,36.4%,49m
38059,2,Cheeseburger,2315,46,3,4,7,42.9%,40m
38059,2,nooblegend,2315,0,2,3,5,40.0%,26m
38059,3,Stalin,2315,117,2,6,8,25.0%,29m
38059,1,[Tuki]MrOrange,2315,48,2,8,10,20.0%,42m
38059,3,Morf,2315,0,1,2,3,33.3%,54m
38059,1,Xerachy,2315,0,1,5,6,16.7%,1h
38059,1,Bruninator,2315,0,0,2,2,0.0%,23m
38059,2,[CxCx]Tobiasz,2315,0,0,5,5,0.0%,50m
38082,1,KASZA,2314,1195,112,110,222,50.5%,41m
38082,1,ViroS,2314,1549,104,108,212,49.1%,52m
38082,3,CzechSpurs,2314,1004,39,46,85,45.9%,49m
38082,1,Dardem,2314,764,26,30,56,46.4%,36m
38082,1,SldPowell,2314,670,25,30,55,45.5%,49m
38082,1,[r161om]KosinusUA,2314,538,22,10,32,68.8%,24m
38082,1,simon,2314,460,12,15,27,44.4%,21m
38082,1,Totmato,2314,261,11,2,13,84.6%,45m
38082,3,BigFootCris,2314,280,11,19,30,36.7%,15m
38082,1,Xixia,2314,342,10,11,21,47.6%,46m
38082,1,Mistic,2314,187,9,8,17,52.9%,42m
38082,3,promsky,2314,234,8,9,17,47.1%,52m
38082,1,spinne,2314,200,7,4,11,63.6%,49m
38082,1,Cyberessence,2314,173,7,8,15,46.7%,1h
38082,1,[isIMBА]DazayPozitiv,2314,212,6,6,12,50.0%,1h
38082,1,yamagato,2314,164,5,9,14,35.7%,1h
38082,3,tede,2314,126,5,11,16,31.2%,1h
38082,1,Newpeon,2314,190,4,8,12,33.3%,20m
38082,1,serhio,2314,132,4,9,13,30.8%,6m
38082,1,[CCCCP]Ворон,2314,122,3,9,12,25.0%,45m
38082,1,[SPAINs]caymansitojr,2314,0,2,3,5,40.0%,34m
38082,3,arti,2314,30,2,7,9,22.2%,43m
38082,1,DENOFEViL,2314,0,1,0,1,100.0%,48m
38082,1,MoreCowbell,2314,0,1,0,1,100.0%,16m
38082,1,Phoenix,2314,0,1,0,1,100.0%,1h
38082,1,БОБА,2314,30,1,2,3,33.3%,1h
38082,1,Akeno,2314,48,1,2,3,33.3%,23m
38082,1,urte,2314,0,1,5,6,16.7%,54m
38082,1,Artron,2314,0,1,5,6,16.7%,43m
38082,1,[RRNow]Goodlack,2314,0,0,2,2,0.0%,35m
38082,3,[KIST]GLHF,2314,0,0,2,2,0.0%,17m
38113,3,[JFKKen]ProtosLife,2313,844,82,84,166,49.4%,18m
38113,1,SBLACK,2313,1821,69,72,141,48.9%,52m
38113,3,danypata,2313,973,61,63,124,49.2%,23m
38113,1,Zerg,2313,976,35,37,72,48.6%,10m
38113,2,[DCoz]tassot,2313,614,34,39,73,46.6%,39m
38113,1,Atu,2313,705,25,27,52,48.1%,1h
38113,1,[Altair]Prometheus,2313,590,16,16,32,50.0%,10m
38113,3,Demppis,2313,426,14,24,38,36.8%,7m
38113,3,SlowNLow,2313,300,12,19,31,38.7%,8m
38113,1,Tima,2313,190,5,10,15,33.3%,51m
38113,3,AmirMoti,2313,86,5,13,18,27.8%,23m
38113,1,bdfg,2313,122,4,4,8,50.0%,17m
38113,1,Rubin,2313,126,4,4,8,50.0%,12m
38113,1,рыцарь,2313,199,4,6,10,40.0%,23m
38113,3,Radioteddy,2313,88,4,9,13,30.8%,23m
38113,1,[TTL]Merghos,2313,132,3,1,4,75.0%,43m
38113,1,SeeMeFall,2313,82,3,1,4,75.0%,1h
38113,1,MarineIncHUN,2313,147,3,2,5,60.0%,8m
38113,2,FARAMIR,2313,125,3,5,8,37.5%,29m
38113,1,SurfinSulo,2313,121,3,6,9,33.3%,21m
38113,3,Kurtis,2313,60,3,9,12,25.0%,1h
38113,2,[msa]Marius,2313,48,2,0,2,100.0%,1h
38113,1,[D0N3]yamahandrea,2313,42,2,0,2,100.0%,40m
38113,1,Bajekon,2313,80,2,2,4,50.0%,32m
38113,1,[v8ZX7h]anonem,2313,42,2,3,5,40.0%,7m
38113,1,Mengsk,2313,84,2,3,5,40.0%,38m
38113,3,RichFroning,2313,0,2,6,8,25.0%,37m
38113,2,XMANN,2313,44,2,7,9,22.2%,17m
38113,1,[АСС]ILvIR,2313,0,1,0,1,100.0%,3m
38113,1,Hades,2313,0,1,2,3,33.3%,44m
38113,2,Bigbang,2313,0,1,4,5,20.0%,48m
38113,2,[u7k2f5]Bigbonfit,2313,0,0,5,5,0.0%,41m
38145,2,Nicholas,2312,1239,134,147,281,47.7%,1h
38145,1,Noxxl,2312,1027,67,53,120,55.8%,21m
38145,1,Heffa,2312,890,29,27,56,51.8%,24m
38145,1,[TRPo]Adam,2312,363,13,15,28,46.4%,31m
38145,1,Dawngyard,2312,286,11,7,18,61.1%,30m
38145,1,Raiden,2312,326,11,8,19,57.9%,6m
38145,3,Искандер,2312,330,11,22,33,33.3%,21m
38145,1,[L0L]belljoh,2312,346,9,8,17,52.9%,33m
38145,1,kwaaaaa,2312,257,6,4,10,60.0%,44m
38145,1,FriedEgg,2312,255,6,8,14,42.9%,40m
38145,3,Havane,2312,172,5,1,6,83.3%,35m
38145,3,[TGTGTG]Mittnatch,2312,167,5,7,12,41.7%,42m
38145,3,RussianWoman,2312,92,4,12,16,25.0%,32m
38145,1,MohamedHewil,2312,44,2,0,2,100.0%,7m
38145,1,SelinaHunter,2312,44,2,0,2,100.0%,39m
38145,1,Schokoboo,2312,0,1,2,3,33.3%,39m
38145,2,Ian,2312,0,1,4,5,20.0%,28m
38145,1,Ung,2312,0,0,2,2,0.0%,44m
38163,3,Surfanoid,2311,1503,316,311,627,50.4%,29m
38163,2,[BZTeam]PgmTriope,2311,1569,246,247,493,49.9%,15m
38163,3,воевода,2311,1118,102,111,213,47.9%,52m
38163,1,Diebels,2311,1741,79,84,163,48.5%,33m
38163,2,[P0NY]MysterySkull,2311,1052,40,41,81,49.4%,31m
38163,1,ErImOtt,2311,1049,35,30,65,53.8%,41m
38163,1,xQuakx,2311,480,33,24,57,57.9%,34m
38163,1,itsmatthewd,2311,548,29,20,49,59.2%,22m
38163,1,Krapiva,2311,804,28,23,51,54.9%,19m
38163,1,nabrosokk,2311,426,12,12,24,50.0%,10m
38163,3,underdog,2311,342,11,18,29,37.9%,28m
38163,1,faraday,2311,312,9,10,19,47.4%,8m
38163,3,Dimetry,2311,177,4,11,15,26.7%,21m
38163,3,maci,2311,121,3,1,4,75.0%,48m
38163,1,[BTCPS]Mobsyn,2311,80,3,3,6,50.0%,12m
38163,1,Protostitute,2311,116,3,5,8,37.5%,30m
38163,1,RuraPenthe,2311,156,3,7,10,30.0%,6m
38163,1,Alduin,2311,132,3,8,11,27.3%,51m
38163,3,Vincent,2311,97,2,1,3,66.7%,34m
38163,2,DarkO,2311,0,1,0,1,100.0%,31m
38163,1,Crusader,2311,42,1,2,3,33.3%,17m
38163,2,dos,2311,0,1,4,5,20.0%,4m
38163,1,димон,2311,44,1,7,8,12.5%,46m
38163,1,[NOLLER]Zash,2311,0,0,1,1,0.0%,34m
38163,1,Waggy,2311,0,0,2,2,0.0%,15m
38163,1,JohnLocke,2311,0,0,2,2,0.0%,10m
38163,1,Mike,2311,0,0,3,3,0.0%,6m
38190,1,gounteur,2310,1551,301,314,615,48.9%,20m
38190,1,Sargas,2310,1590,151,143,294,51.4%,38m
38190,1,[panno]human,2310,1773,108,103,211,51.2%,35m
38190,1,LilAl,2310,1773,84,75,159,52.8%,37m
38190,1,FabulousSean,2310,1804,66,66,132,50.0%,41m
38190,1,grypsus,2310,1300,40,46,86,46.5%,19m
38190,1,HenryJ,2310,671,37,31,68,54.4%,6m
38190,2,Hyde,2310,808,31,35,66,47.0%,20m
38190,1,[ATC28]pusztulat,2310,834,28,23,51,54.9%,1h
38190,2,Indiana,2310,560,21,29,50,42.0%,7m
38190,1,Skaleuh,2310,524,15,15,30,50.0%,42m
38190,1,Aladdin,2310,308,12,5,17,70.6%,33m
38190,1,Dropbear,2310,320,8,9,17,47.1%,1h
38190,1,[SupprM]SupremCC,2310,158,6,7,13,46.2%,50m
38190,1,Gader,2310,84,4,6,10,40.0%,50m
38190,3,sosiska,2310,149,4,11,15,26.7%,20m
38190,1,[olive]Artemiy,2310,137,3,0,3,100.0%,19m
38190,1,[FougR]Maltrian,2310,96,3,1,4,75.0%,37m
38190,1,RACER,2310,42,2,0,2,100.0%,33m
38190,1,Erizo,2310,96,2,3,5,40.0%,34m
38190,1,[svinik]grandan,2310,0,2,3,5,40.0%,1h
38190,1,Algatron,2310,42,1,1,2,50.0%,17m
38190,1,Trax,2310,48,1,2,3,33.3%,34m
38190,1,mati,2310,0,1,4,5,20.0%,29m
38190,1,luni,2310,0,0,1,1,0.0%,1h
38190,1,skyh,2310,0,0,1,1,0.0%,46m
38190,1,tbadass,2310,0,0,2,2,0.0%,31m
38190,1,[r3ich]RichieHawtin,2310,0,0,3,3,0.0%,37m
38218,1,bouyou,2309,1590,73,60,133,54.9%,10m
38218,1,BorisTheBlad,2309,1376,55,54,109,50.5%,26m
38218,3,NautiluS,2309,969,41,36,77,53.2%,11m
38218,3,[Cheas]Tuff,2309,924,37,43,80,46.2%,40m
38218,1,RostZzz,2309,950,36,34,70,51.4%,34m
38218,1,ACIO,2309,1058,32,30,62,51.6%,1h
38218,1,AkunTelar,2309,762,31,31,62,50.0%,33m
38218,1,ZooL,2309,536,15,17,32,46.9%,32m
38218,1,Kruger,2309,431,13,8,21,61.9%,27m
38218,3,Pigouse,2309,254,11,15,26,42.3%,10m
38218,1,Apelsinchik,2309,392,10,19,29,34.5%,53m
38218,2,Kaydara,2309,201,8,11,19,42.1%,32m
38218,2,[FMG]SgtShake,2309,298,8,17,25,32.0%,51m
38218,1,DerLauch,2309,254,7,6,13,53.8%,40m
38218,1,ALVARO,2309,280,7,12,19,36.8%,30m
38218,1,[SLGH]sova,2309,290,6,9,15,40.0%,16m
38218,1,Potowy,2309,264,6,14,20,30.0%,41m
38218,1,Naughty,2309,179,4,9,13,30.8%,35m
38218,3,Илья,2309,139,4,10,14,28.6%,41m
38218,1,Limitless,2309,122,3,3,6,50.0%,3m
38218,1,[Рrobe]KostiaKot,2309,72,3,3,6,50.0%,6m
38218,3,BobaFall,2309,48,3,8,11,27.3%,33m
38218,3,Azonic,2309,94,3,11,14,21.4%,53m
38218,1,Anubirnabis,2309,88,2,7,9,22.2%,1h
38218,1,[Steep]IvanYST,2309,42,1,2,3,33.3%,35m
38218,2,DarkSider,2309,0,1,4,5,20.0%,37m
38218,1,TuLuHu,2309,0,1,4,5,20.0%,30m
38218,1,MeisterFips,2309,0,0,1,1,0.0%,31m
38218,1,[401]Sima,2309,0,0,1,1,0.0%,45m
38218,1,Aringhot,2309,0,0,2,2,0.0%,6m
38248,2,reg,2308,1397,144,150,294,49.0%,34m
38248,1,Odinokiy,2308,1378,56,43,99,56.6%,49m
38248,1,SirTuDaBlee,2308,1105,40,30,70,57.1%,48m
38248,3,TyTiger,2308,839,31,42,73,42.5%,1h
38248,1,Vanille,2308,604,24,20,44,54.5%,3m
38248,1,artisdent,2308,647,23,22,45,51.1%,26m
38248,1,Golanno,2308,545,14,13,27,51.9%,33m
38248,1,Hugal,2308,432,13,21,34,38.2%,45m
38248,2,HANNIBAL,2308,237,10,9,19,52.6%,19m
38248,1,robmagic,2308,374,10,13,23,43.5%,1h
38248,1,Draven,2308,253,8,7,15,53.3%,16m
38248,3,BadMar,2308,242,7,7,14,50.0%,21m
38248,1,[CoFi]Timco,2308,197,6,1,7,85.7%,1h
38248,1,Thomas,2308,240,6,8,14,42.9%,32m
38248,1,МосЛеро,2308,157,5,0,5,100.0%,17m
38248,3,Kost,2308,159,4,7,11,36.4%,41m
38248,3,[BCNE]Bendikov,2308,142,4,9,13,30.8%,23m
38248,1,Vlast,2308,48,3,7,10,30.0%,15m
38248,1,GOGI,2308,0,1,1,2,50.0%,45m
38248,1,Flynn,2308,42,1,2,3,33.3%,8m
38248,1,[Актив]Kriont,2308,0,0,1,1,0.0%,1h
38248,1,Боров,2308,0,0,1,1,0.0%,49m
38248,1,MaNNeQuN,2308,0,0,1,1,0.0%,1h
38248,1,DéFéo,2308,0,0,3,3,0.0%,41m
38248,3,ParrisHilton,2308,0,0,8,8,0.0%,3m
38273,1,maks,2307,1585,63,66,129,48.8%,14m
38273,1,frost,2307,406,61,56,117,52.1%,33m
38273,1,Forrestko,2307,1146,49,53,102,48.0%,1h
38273,1,Masterplex,2307,1234,45,42,87,51.7%,24m
38273,3,DarkNobo,2307,687,43,44,87,49.4%,1h
38273,1,xXTSkyaTXx,2307,915,40,38,78,51.3%,10m
38273,3,Kiki,2307,819,30,38,68,44.1%,1h
38273,1,fidefix,2307,959,29,41,70,41.4%,35m
38273,1,AlphaA,2307,572,23,24,47,48.9%,19m
38273,1,Chumpes,2307,508,14,14,28,50.0%,47m
38273,1,[ZerusZ]Alavardo,2307,532,14,20,34,41.2%,1h
38273,1,Furox,2307,313,11,15,26,42.3%,40m
38273,3,CrazyBlazie,2307,244,9,9,18,50.0%,51m
38273,1,cazeg,2307,274,8,8,16,50.0%,1h
38273,1,[Soldi]Zman,2307,185,7,2,9,77.8%,30m
38273,1,jacmaxi,2307,247,7,8,15,46.7%,7m
38273,1,lazzan,2307,276,7,8,15,46.7%,49m
38273,1,Stepa,2307,254,6,8,14,42.9%,27m
38273,1,Boncroissant,2307,42,4,3,7,57.1%,55m
38273,1,[Drkgme]ESD,2307,182,4,5,9,44.4%,28m
38273,1,mapez,2307,78,3,3,6,50.0%,19m
38273,1,[LiLov]gapdan,2307,128,3,7,10,30.0%,17m
38273,1,Sherman,2307,48,2,6,8,25.0%,49m
38273,1,Tib,2307,42,1,1,2,50.0%,34m
38273,1,[TSC2C]ZAGAR,2307,38,1,2,3,33.3%,1h
38273,1,[QaDo]WARPOZ,2307,0,1,2,3,33.3%,7m
38273,1,NaegiKun,2307,0,1,2,3,33.3%,19m
38273,2,BalD,2307,0,1,4,5,20.0%,37m
38273,1,kaetka,2307,0,1,4,5,20.0%,17m
38273,1,[em66]Stef,2307,0,1,5,6,16.7%,33m
38273,1,DarkMatter,2307,0,1,6,7,14.3%,8m
38273,2,MorningGAP,2307,30,1,9,10,10.0%,45m
38273,1,mercuriouss,2307,0,0,3,3,0.0%,30m
38306,1,Nagval,2306,1776,77,66,143,53.8%,33m
38306,1,LaughinBubba,2306,1417,66,56,122,54.1%,1h
38306,1,dif,2306,1675,66,57,123,53.7%,26m
38306,1,MrFreeman,2306,1068,33,36,69,47.8%,12m
38306,3,Guardian,2306,768,33,36,69,47.8%,1h
38306,1,Alfaxiriuz,2306,795,30,31,61,49.2%,19m
38306,1,Cyberex,2306,700,26,22,48,54.2%,1h
38306,1,[Кумыс]Великолепный,2306,669,25,15,40,62.5%,22m
38306,1,Patapuf,2306,640,19,19,38,50.0%,47m
38306,1,[13Rätt]Virkler,2306,454,16,13,29,55.2%,10m
38306,1,MrM,2306,394,14,11,25,56.0%,1h
38306,1,QvYke,2306,266,12,13,25,48.0%,49m
38306,1,TheExpert,2306,414,12,21,33,36.4%,6m
38306,1,dODgY,2306,322,11,15,26,42.3%,36m
38306,1,[NULOSS]freezygamer,2306,370,10,11,21,47.6%,53m
38306,3,raZieL,2306,234,10,22,32,31.2%,4m
38306,3,Nikki,2306,186,9,14,23,39.1%,16m
38306,3,Glenn,2306,252,8,6,14,57.1%,55m
38306,1,MKMK,2306,260,8,7,15,53.3%,34m
38306,1,miroslav,2306,186,8,8,16,50.0%,35m
38306,1,[Negas]Budula,2306,289,8,14,22,36.4%,1h
38306,1,[PPPS]karma,2306,48,6,8,14,42.9%,36m
38306,3,[JKCNFT]niktank,2306,198,5,8,13,38.5%,40m
38306,1,funkmatic,2306,107,5,11,16,31.2%,13m
38306,1,Terran,2306,170,4,4,8,50.0%,21m
38306,1,Jakub,2306,82,3,2,5,60.0%,17m
38306,2,LKYJoe,2306,0,3,2,5,60.0%,35m
38306,1,Warlord,2306,124,3,3,6,50.0%,6m
38306,1,ElDiablo,2306,96,3,9,12,25.0%,37m
38306,3,LEV,2306,127,3,9,12,25.0%,43m
38306,1,Chaeryoung,2306,48,2,6,8,25.0%,43m
38306,3,Gray,2306,0,2,7,9,22.2%,1h
38306,1,ChapperSRI,2306,0,1,0,1,100.0%,36m
38306,1,OlezhekGhost,2306,0,1,0,1,100.0%,23m
38306,1,Hamekas,2306,0,1,0,1,100.0%,52m
38306,1,[GML]МиниТитан,2306,0,1,1,2,50.0%,37m
38306,1,GoblinTVT,2306,0,1,1,2,50.0%,41m
38306,1,COBECTb,2306,40,1,2,3,33.3%,7m
38306,1,[ECP19]AntonyLazer,2306,44,1,4,5,20.0%,24m
38306,1,crystal,2306,0,1,5,6,16.7%,23m
38306,1,taurinkill,2306,0,1,5,6,16.7%,28m
38306,1,[Kunu]warriorYTB,2306,0,0,1,1,0.0%,38m
38306,1,[OmDi]Erd,2306,0,0,2,2,0.0%,1h
38306,2,Kaoschrit,2306,0,0,2,2,0.0%,48m
38306,1,ChrysCRZ,2306,0,0,4,4,0.0%,1h
38306,3,Aquilius,2306,0,0,7,7,0.0%,35m
38352,2,DIAZ,2305,1170,157,165,322,48.8%,13m
38352,1,Panimoni,2305,1662,78,70,148,52.7%,31m
38352,1,delo,2305,1045,38,31,69,55.1%,10m
38352,1,Dziubson,2305,581,24,12,36,66.7%,18m
38352,2,[LMBD]Talha,2305,649,24,26,50,48.0%,32m
38352,2,Fasthand,2305,742,24,39,63,38.1%,8m
38352,1,GeneralBeast,2305,527,21,15,36,58.3%,5m
38352,3,DuCharles,2305,419,17,24,41,41.5%,20m
38352,1,krot,2305,506,15,18,33,45.5%,38m
38352,1,ZiBalas,2305,494,15,21,36,41.7%,17m
38352,1,Chroma,2305,258,9,16,25,36.0%,33m
38352,1,Devass,2305,258,7,6,13,53.8%,44m
38352,1,Davix,2305,191,6,8,14,42.9%,41m
38352,3,Spartak,2305,120,5,6,11,45.5%,34m
38352,1,Dworking,2305,150,4,1,5,80.0%,42m
38352,1,Marci,2305,128,3,7,10,30.0%,26m
38352,1,Stas,2305,40,2,3,5,40.0%,48m
38352,1,БаЛьТаЗаР,2305,0,2,4,6,33.3%,6m
38352,1,AnGeJI,2305,123,2,5,7,28.6%,51m
38352,2,YNe,2305,0,2,6,8,25.0%,20m
38352,1,lmstar,2305,0,1,0,1,100.0%,36m
38352,1,[teksol]Sairus,2305,0,1,1,2,50.0%,10m
38352,1,Джокер,2305,0,1,2,3,33.3%,15m
38352,1,LivingForce,2305,0,1,4,5,20.0%,1h
38352,1,[sc2rf]Danila,2305,0,0,1,1,0.0%,37m
38352,1,bdfg,2305,0,0,1,1,0.0%,41m
38352,1,[SCDX]ministalker,2305,0,0,2,2,0.0%,52m
38352,1,[Whattt]GhostHunter,2305,0,0,5,5,0.0%,26m
38380,1,[OmDi]Enakino,2304,1610,122,107,229,53.3%,16m
38380,1,Bubin,2304,1172,38,42,80,47.5%,6m
38380,1,Aze,2304,646,20,22,42,47.6%,6m
38380,2,Tournevis,2304,470,18,24,42,42.9%,9m
38380,3,Shrad,2304,511,17,21,38,44.7%,33m
38380,1,[230ММ]JonnySins,2304,362,14,16,30,46.7%,16m
38380,1,Leion,2304,428,11,18,29,37.9%,46m
38380,1,Vagnerlove,2304,198,6,4,10,60.0%,33m
38380,1,[MinP]Erdass,2304,107,3,0,3,100.0%,35m
38380,3,iTheMaster,2304,0,3,8,11,27.3%,5m
38380,3,Darkgiver,2304,96,3,10,13,23.1%,50m
38380,2,[GLHFGL]KäsekuchenB,2304,94,3,10,13,23.1%,52m
38380,1,ParrotGod,2304,42,2,0,2,100.0%,35m
38380,1,Ebaka,2304,30,2,1,3,66.7%,24m
38380,1,HyCy,2304,82,2,3,5,40.0%,16m
38380,1,[UHSF]CraigJones,2304,38,1,2,3,33.3%,8m
38380,3,FanFan,2304,30,1,3,4,25.0%,3m
38380,1,JustSayJambo,2304,48,1,3,4,25.0%,12m
38380,2,Thora,2304,0,1,4,5,20.0%,47m
38380,2,XxURBIxX,2304,0,1,4,5,20.0%,10m
38380,1,Apoch,2304,0,1,4,5,20.0%,38m
38380,1,TokarevRav,2304,0,1,6,7,14.3%,1h
38380,1,finaldoom,2304,0,0,1,1,0.0%,1h
38380,1,pekod,2304,0,0,1,1,0.0%,19m
38404,3,drifthawk,2303,522,95,83,178,53.4%,1h
38404,1,onay,2303,1766,92,86,178,51.7%,32m
38404,3,alexxxeeeyyy,2303,724,91,72,163,55.8%,21m
38404,1,zeratul,2303,1161,40,35,75,53.3%,1h
38404,1,[Z3nA]Bappo,2303,883,34,31,65,52.3%,3m
38404,1,meepmeep,2303,689,24,16,40,60.0%,16m
38404,3,jerras,2303,648,22,34,56,39.3%,27m
38404,1,lebac,2303,618,19,22,41,46.3%,24m
38404,1,[OulX]Sette,2303,409,14,12,26,53.8%,52m
38404,1,[Pkt3s]biquillo,2303,498,14,13,27,51.9%,31m
38404,1,iaotti,2303,271,8,9,17,47.1%,23m
38404,1,dorik,2303,242,8,11,19,42.1%,26m
38404,1,Dji,2303,204,5,5,10,50.0%,38m
38404,2,MrNobody,2303,156,5,11,16,31.2%,14m
38404,1,gorby,2303,0,4,1,5,80.0%,55m
38404,1,XeRMaYoR,2303,86,4,2,6,66.7%,41m
38404,1,RIKUONO,2303,48,4,4,8,50.0%,1h
38404,1,ПроАртёмПро,2303,155,3,2,5,60.0%,23m
38404,1,Perseus,2303,88,3,8,11,27.3%,1h
38404,1,яммармалад,2303,96,3,8,11,27.3%,55m
38404,1,LusorAmorum,2303,0,2,3,5,40.0%,6m
38404,1,cosmic,2303,42,1,2,3,33.3%,10m
38404,1,KOTCHANKIN,2303,0,1,3,4,25.0%,22m
38404,1,SuPSHaMaN,2303,48,1,3,4,25.0%,23m
38404,1,Rogba,2303,0,1,4,5,20.0%,49m
38404,2,GunsFlint,2303,0,1,4,5,20.0%,41m
38404,1,AlexMarine,2303,0,0,1,1,0.0%,33m
38404,1,Бетель,2303,0,0,2,2,0.0%,49m
38404,1,Raner,2303,0,0,3,3,0.0%,1h
38404,3,Loyolo,2303,0,0,4,4,0.0%,26m
38404,1,[s0rry]AKPAM,2303,73,0,4,4,0.0%,26m
38435,3,GeoX,2302,1136,44,47,91,48.4%,43m
38435,1,RinatST,2302,1036,30,35,65,46.2%,36m
38435,1,Fenrir,2302,878,28,27,55,50.9%,48m
38435,1,Mashi,2302,818,25,29,54,46.3%,1h
38435,1,Wookie,2302,602,24,22,46,52.2%,48m
38435,3,DenChik,2302,501,18,21,39,46.2%,11m
38435,2,AndreiAra,2302,422,16,20,36,44.4%,17m
38435,3,Futon,2302,418,14,22,36,38.9%,5m
38435,2,Robs,2302,418,14,24,38,36.8%,32m
38435,3,[NIGC]Admiral,2302,144,7,12,19,36.8%,55m
38435,3,Jam,2302,149,6,8,14,42.9%,14m
38435,1,Вася,2302,202,5,5,10,50.0%,16m
38435,3,ProbablyMark,2302,92,4,5,9,44.4%,1h
38435,1,Bacześ,2302,48,2,5,7,28.6%,36m
38435,1,Miron,2302,0,1,4,5,20.0%,41m
38435,1,[BBXT]Azuvaal,2302,0,1,5,6,16.7%,51m
38435,1,KALIGULA,2302,0,0,1,1,0.0%,1h
38435,1,NikMoro,2302,0,0,3,3,0.0%,23m
38453,1,Crichou,2301,1794,145,146,291,49.8%,1h
38453,1,striker,2301,1183,48,50,98,49.0%,36m
38453,1,Kenji,2301,1292,42,46,88,47.7%,26m
38453,1,Flanbie,2301,590,33,35,68,48.5%,27m
38453,1,dethroner,2301,674,21,22,43,48.8%,18m
38453,1,Граф,2301,561,20,10,30,66.7%,30m
38453,1,SuperIceRat,2301,346,9,9,18,50.0%,21m
38453,1,DarkNGreat,2301,298,9,10,19,47.4%,37m
38453,1,PenaPerse,2301,264,9,15,24,37.5%,18m
38453,3,Hanzo,2301,217,7,10,17,41.2%,27m
38453,1,Zingo,2301,120,4,2,6,66.7%,21m
38453,1,ssz,2301,141,3,6,9,33.3%,1h
38453,1,nikotin,2301,153,3,7,10,30.0%,35m
38453,1,[ShiJun]DakenNaken,2301,84,2,4,6,33.3%,27m
38453,1,Juice,2301,42,2,4,6,33.3%,51m
38453,2,[RNKS]Dana,2301,48,2,5,7,28.6%,31m
38453,1,Dioboli,2301,38,1,1,2,50.0%,40m
38453,1,ElTime,2301,44,1,1,2,50.0%,37m
38453,1,clochard,2301,44,1,1,2,50.0%,30m
38453,1,Cipher,2301,0,1,6,7,14.3%,37m
38453,1,IngoImDingo,2301,0,0,1,1,0.0%,23m
38453,1,[TCC974]tya,2301,0,0,1,1,0.0%,1h
38453,1,[kek34]Fireice,2301,0,0,1,1,0.0%,1h
38453,1,IIIIIIIIIIII,2301,0,0,1,1,0.0%,43m
38477,2,[GWN]idanmenashes,2300,1234,215,219,434,49.5%,49m
38477,1,Kamikazykid,2300,1332,46,44,90,51.1%,35m
38477,1,[TAW]Rich,2300,709,39,30,69,56.5%,41m
38477,3,IIIIIIIIIIII,2300,646,34,46,80,42.5%,25m
38477,1,SENTINEL,2300,578,33,35,68,48.5%,24m
38477,3,Акакий,2300,887,32,37,69,46.4%,7m
38477,3,destreg,2300,234,30,24,54,55.6%,25m
38477,3,Parkrunner,2300,675,26,42,68,38.2%,3m
38477,1,ZingZeng,2300,658,19,20,39,48.7%,8m
38477,1,sajbend,2300,335,14,6,20,70.0%,37m
38477,1,kamottasu,2300,426,13,18,31,41.9%,1h
38477,1,Eichhörnchen,2300,162,4,1,5,80.0%,45m
38477,1,[i512]Zabrakahn,2300,113,4,4,8,50.0%,52m
38477,3,[RuRø]Kamura,2300,102,4,7,11,36.4%,6m
38477,3,Xuluh,2300,170,4,9,13,30.8%,21m
38477,1,MindelVK,2300,128,3,3,6,50.0%,38m
38477,2,Kuroneko,2300,88,3,4,7,42.9%,48m
38477,1,[YEABOI]Nexorek,2300,82,3,4,7,42.9%,1h
38477,1,fomich,2300,145,3,6,9,33.3%,42m
38477,2,Callum,2300,137,2,5,7,28.6%,51m
38477,2,[CFR]evilevich,2300,46,2,5,7,28.6%,47m
38477,1,Gill,2300,97,2,6,8,25.0%,6m
38477,1,Zamut,2300,38,1,3,4,25.0%,52m
38477,1,Slaven,2300,0,0,3,3,0.0%,13m
38501,1,Mandrake,2299,1274,51,44,95,53.7%,26m
38501,3,straszyk,2299,913,34,40,74,45.9%,1h
38501,1,Wacky,2299,956,31,34,65,47.7%,44m
38501,3,[DТ]Accelerator,2299,644,24,31,55,43.6%,38m
38501,1,Hauwell,2299,515,18,14,32,56.2%,37m
38501,1,Vladimir,2299,536,17,13,30,56.7%,35m
38501,1,DJORZE,2299,341,15,14,29,51.7%,18m
38501,1,Tharanor,2299,289,6,9,15,40.0%,1h
38501,1,[ScSg]Erster,2299,264,6,13,19,31.6%,37m
38501,1,Aotling,2299,150,5,3,8,62.5%,7m
38501,1,NoNo,2299,241,5,4,9,55.6%,16m
38501,1,DTCzvalderi,2299,144,4,8,12,33.3%,1h
38501,2,[HUNSR]Doofface,2299,0,2,3,5,40.0%,28m
38501,1,kvg,2299,0,1,1,2,50.0%,45m
38501,1,PJT,2299,40,1,2,3,33.3%,52m
38501,1,veener,2299,40,1,2,3,33.3%,1h
38501,3,Terry,2299,0,1,4,5,20.0%,1h
38501,2,diabetesHERO,2299,0,1,4,5,20.0%,40m
38501,1,Solhatten,2299,0,0,1,1,0.0%,13m
38501,1,[ALED]Boomyxx,2299,0,0,2,2,0.0%,3m
38501,1,Seleucos,2299,0,0,3,3,0.0%,17m
38501,1,bombel,2299,0,0,5,5,0.0%,26m
38523,2,Steelstorm,2298,1228,493,500,993,49.6%,18m
38523,2,PVK,2298,1364,176,176,352,50.0%,44m
38523,3,Nicototo,2298,1555,94,94,188,50.0%,32m
38523,1,ANRII,2298,918,71,74,145,49.0%,18m
38523,3,[RÖÖV]Yorgro,2298,1102,44,46,90,48.9%,22m
38523,1,Olo,2298,1068,35,36,71,49.3%,27m
38523,1,Darus,2298,429,12,8,20,60.0%,23m
38523,1,Exostron,2298,273,9,14,23,39.1%,52m
38523,1,Ceko,2298,262,8,9,17,47.1%,36m
38523,3,nava,2298,241,7,9,16,43.8%,33m
38523,1,Nevermind,2298,227,6,9,15,40.0%,10m
38523,1,BozZ,2298,198,5,8,13,38.5%,51m
38523,1,Zoloman,2298,97,4,2,6,66.7%,26m
38523,1,[Arrows]Klemst,2298,86,3,3,6,50.0%,19m
38523,1,spectre,2298,80,3,7,10,30.0%,30m
38523,2,Серый,2298,46,2,0,2,100.0%,41m
38523,3,Univerce,2298,30,2,5,7,28.6%,17m
38523,1,Platypus,2298,46,2,5,7,28.6%,49m
38523,1,[IB1941]Ash,2298,37,1,3,4,25.0%,10m
38523,1,KVNG,2298,0,1,5,6,16.7%,23m
38523,1,[PioD]Lisoedov,2298,0,1,5,6,16.7%,28m
38523,1,[FJW]anfieldv,2298,0,0,1,1,0.0%,37m
38523,2,LINUS,2298,0,0,1,1,0.0%,48m
38523,1,shadowBroker,2298,0,0,3,3,0.0%,33m
38523,1,Pinguin,2298,0,0,4,4,0.0%,45m
38548,1,MuadDib,2297,1800,146,145,291,50.2%,41m
38548,1,Nesstk,2297,1685,67,64,131,51.1%,37m
38548,3,FENIX,2297,1513,60,67,127,47.2%,30m
38548,1,[RMM]SuperStein,2297,452,50,43,93,53.8%,6m
38548,1,Jash,2297,651,41,30,71,57.7%,33m
38548,1,Poehli,2297,836,29,32,61,47.5%,27m
38548,1,Thami,2297,623,19,17,36,52.8%,23m
38548,1,jenkins,2297,524,18,18,36,50.0%,35m
38548,1,[widma]Kerrigan,2297,571,17,13,30,56.7%,35m
38548,2,Chrïstian,2297,410,16,22,38,42.1%,9m
38548,3,spekkyo,2297,248,10,9,19,52.6%,33m
38548,3,Hideyoshi,2297,229,7,5,12,58.3%,52m
38548,3,Rüdigea,2297,191,6,5,11,54.5%,20m
38548,1,Silentd,2297,255,6,8,14,42.9%,1h
38548,1,[NSJLM]XeQiu,2297,163,3,2,5,60.0%,1h
38548,2,[4orce]TheEmperor,2297,30,3,7,10,30.0%,4m
38548,1,[ЕGО]NightWarrior,2297,0,1,0,1,100.0%,47m
38548,1,рыжийдемон,2297,44,1,2,3,33.3%,45m
38548,1,Protectr,2297,38,1,3,4,25.0%,8m
38548,1,Абвгдейка,2297,44,1,4,5,20.0%,1h
38548,1,Thib,2297,0,0,1,1,0.0%,21m
38548,1,serjs,2297,0,0,1,1,0.0%,24m
38548,2,EnnumaEllish,2297,0,0,1,1,0.0%,1h
38571,1,DED,2296,1518,113,99,212,53.3%,30m
38571,1,WarLordKai,2296,1717,79,86,165,47.9%,53m
38571,1,and,2296,904,63,58,121,52.1%,55m
38571,1,yrchilxx,2296,1210,53,43,96,55.2%,1h
38571,1,Nikotin,2296,514,31,29,60,51.7%,12m
38571,1,Petro,2296,714,20,19,39,51.3%,41m
38571,1,Shogun,2296,468,13,15,28,46.4%,37m
38571,1,[DRÖM]Zentiic,2296,414,12,12,24,50.0%,49m
38571,1,[Krusti]Smulan,2296,340,10,9,19,52.6%,19m
38571,1,CrazyyArms,2296,324,10,9,19,52.6%,36m
38571,1,DGENERATIONX,2296,358,9,11,20,45.0%,40m
38571,1,Loukasse,2296,258,8,14,22,36.4%,1h
38571,1,Sharudow,2296,88,7,3,10,70.0%,51m
38571,1,ihateterran,2296,201,7,11,18,38.9%,41m
38571,1,Frost,2296,272,7,12,19,36.8%,4m
38571,1,laotemujeneu,2296,146,6,2,8,75.0%,55m
38571,1,RamDass,2296,188,6,5,11,54.5%,5m
38571,1,Tasche,2296,189,4,8,12,33.3%,46m
38571,1,Mooncake,2296,121,4,8,12,33.3%,10m
38571,1,Wmuellix,2296,82,3,1,4,75.0%,55m
38571,3,TaBoo,2296,30,3,8,11,27.3%,50m
38571,1,Slimedi,2296,74,2,3,5,40.0%,17m
38571,1,CAMOCBET,2296,0,1,0,1,100.0%,28m
38571,1,baja,2296,0,1,4,5,20.0%,36m
38571,3,RedAlert,2296,30,1,6,7,14.3%,21m
38571,3,BannanaMama,2296,0,1,7,8,12.5%,1h
38571,2,gouzzy,2296,0,0,1,1,0.0%,21m
38571,1,mazaTRoll,2296,0,0,1,1,0.0%,13m
38571,2,MacMillan,2296,0,0,1,1,0.0%,14m
38600,1,Anustart,2295,1784,107,117,224,47.8%,17m
38600,2,Migajiro,2295,1564,63,77,140,45.0%,26m
38600,1,Unplugged,2295,1166,56,59,115,48.7%,23m
38600,1,qnxt,2295,1295,47,42,89,52.8%,22m
38600,1,maks,2295,1147,41,38,79,51.9%,1h
38600,1,gonzo,2295,423,32,25,57,56.1%,46m
38600,1,leevskij,2295,778,32,29,61,52.5%,24m
38600,3,Shepard,2295,457,19,23,42,45.2%,22m
38600,1,Tehho,2295,528,17,23,40,42.5%,32m
38600,1,Nif,2295,464,16,9,25,64.0%,26m
38600,1,GoDen,2295,446,14,20,34,41.2%,52m
38600,1,EugeneSky,2295,418,12,10,22,54.5%,35m
38600,1,dexaps,2295,403,12,18,30,40.0%,21m
38600,1,Bob,2295,281,10,22,32,31.2%,15m
38600,1,Vimer,2295,238,8,4,12,66.7%,8m
38600,1,[ENV]Paczek,2295,204,8,11,19,42.1%,10m
38600,3,MatStar,2295,222,7,9,16,43.8%,35m
38600,1,ComradGenery,2295,212,7,12,19,36.8%,35m
38600,1,bruh,2295,292,7,14,21,33.3%,5m
38600,2,[PaniC]scnightfire,2295,158,6,20,26,23.1%,20m
38600,3,Booday,2295,193,5,2,7,71.4%,28m
38600,1,Silskshadow,2295,160,5,4,9,55.6%,45m
38600,2,Суворов,2295,0,4,1,5,80.0%,48m
38600,1,Gralem,2295,139,4,3,7,57.1%,35m
38600,1,CoNsTrUcToR,2295,152,4,4,8,50.0%,1h
38600,1,[НОД17]MenronVoque,2295,40,2,1,3,66.7%,1h
38600,1,[NINJ88]iliyanpetrov,2295,86,2,3,5,40.0%,12m
38600,2,Plutopia,2295,0,2,3,5,40.0%,30m
38600,1,[Nxv]Deceive,2295,36,2,5,7,28.6%,36m
38600,1,tothun,2295,84,2,8,10,20.0%,1h
38600,1,[NUBBIE]STROY,2295,0,1,1,2,50.0%,49m
38600,1,Luix,2295,0,1,1,2,50.0%,12m
38600,2,ZERG,2295,46,1,1,2,50.0%,11m
38600,1,urke,2295,42,1,2,3,33.3%,10m
38600,1,MCAS,2295,0,0,2,2,0.0%,1h
38600,3,FlamingOtter,2295,0,0,2,2,0.0%,47m
38636,3,[DaRaBa]VANTHRAX,2294,1522,98,103,201,48.8%,55m
38636,3,Latik,2294,1504,68,74,142,47.9%,30m
38636,3,liquidbrowne,2294,1373,52,58,110,47.3%,44m
38636,1,Killeri,2294,590,23,22,45,51.1%,37m
38636,3,Idaho,2294,455,21,26,47,44.7%,39m
38636,1,AaronTorkil,2294,478,13,13,26,50.0%,1h
38636,3,mycelium,2294,279,10,9,19,52.6%,42m
38636,1,LiveEvil,2294,325,10,13,23,43.5%,27m
38636,1,Talos,2294,322,8,11,19,42.1%,51m
38636,1,bilbi,2294,171,6,2,8,75.0%,6m
38636,1,Van,2294,310,6,10,16,37.5%,40m
38636,3,Blackend,2294,124,5,6,11,45.5%,21m
38636,1,KNECHTER,2294,158,4,5,9,44.4%,46m
38636,1,Petro,2294,170,4,5,9,44.4%,12m
38636,1,DeadlyKitten,2294,165,3,2,5,60.0%,39m
38636,1,LordTorpeda,2294,88,3,3,6,50.0%,50m
38636,1,Ayver,2294,144,3,4,7,42.9%,39m
38636,1,JamesFord,2294,70,2,2,4,50.0%,1h
38636,1,BamfEffect,2294,0,2,2,4,50.0%,37m
38636,1,Davide,2294,80,2,3,5,40.0%,8m
38636,1,Next,2294,82,2,5,7,28.6%,36m
38636,1,[radiol]Grotoo,2294,97,2,6,8,25.0%,41m
38636,1,[bonx]Remix,2294,0,1,0,1,100.0%,33m
38636,1,Avalon,2294,0,1,0,1,100.0%,22m
38636,1,playAlex,2294,0,0,2,2,0.0%,42m
38661,3,TaDa,2293,1282,90,102,192,46.9%,34m
38661,1,theboxghost,2293,1187,59,67,126,46.8%,48m
38661,1,BigB,2293,1351,50,45,95,52.6%,36m
38661,3,[QaDo]Neversmile,2293,1021,43,46,89,48.3%,40m
38661,3,Coval,2293,923,37,46,83,44.6%,34m
38661,3,HaNkYn,2293,620,23,29,52,44.2%,12m
38661,3,Azamalin,2293,579,23,29,52,44.2%,12m
38661,3,buhvim,2293,436,16,23,39,41.0%,53m
38661,1,Fooby,2293,279,15,18,33,45.5%,15m
38661,1,thanos,2293,298,10,5,15,66.7%,46m
38661,1,Atlas,2293,250,9,3,12,75.0%,55m
38661,1,maxan,2293,304,8,9,17,47.1%,1h
38661,1,дракон,2293,205,5,3,8,62.5%,41m
38661,3,yeetdHamster,2293,60,4,7,11,36.4%,26m
38661,1,Satellite,2293,126,4,8,12,33.3%,30m
38661,3,PUSYHUNTER,2293,177,4,10,14,28.6%,23m
38661,3,jungleboogie,2293,86,3,8,11,27.3%,4m
38661,1,ZeRgRuSh,2293,114,3,8,11,27.3%,8m
38661,1,Vovarus,2293,88,3,8,11,27.3%,43m
38661,1,Martin,2293,78,2,3,5,40.0%,15m
38661,1,smith,2293,0,2,6,8,25.0%,23m
38661,1,Бабуйн,2293,0,1,1,2,50.0%,28m
38661,2,Kaper,2293,0,1,5,6,16.7%,54m
38661,1,Harley,2293,0,1,6,7,14.3%,1h
38661,1,goOfy,2293,0,0,1,1,0.0%,29m
38661,1,YUKINE,2293,0,0,1,1,0.0%,23m
38661,1,Cygnux,2293,0,0,1,1,0.0%,6m
38661,1,Hagbard,2293,0,0,6,6,0.0%,8m
38689,3,UkSrAaIsNty,2292,1330,189,186,375,50.4%,45m
38689,2,Drak,2292,1468,69,71,140,49.3%,9m
38689,1,neveleeleven,2292,948,64,49,113,56.6%,1h
38689,1,Bosniii,2292,1539,55,54,109,50.5%,50m
38689,1,zajacbo,2292,1140,48,55,103,46.6%,49m
38689,1,boris,2292,1432,47,50,97,48.5%,33m
38689,2,Eugen,2292,623,20,29,49,40.8%,22m
38689,2,Psyduck,2292,514,19,35,54,35.2%,55m
38689,3,cvisualpl,2292,501,18,27,45,40.0%,41m
38689,1,dinn,2292,398,14,10,24,58.3%,32m
38689,1,Flavi,2292,400,14,12,26,53.8%,4m
38689,1,HotRod,2292,442,13,13,26,50.0%,47m
38689,1,Set,2292,350,12,17,29,41.4%,49m
38689,1,ZAR,2292,194,11,5,16,68.8%,16m
38689,1,Monkey,2292,311,10,17,27,37.0%,32m
38689,1,Steve,2292,221,8,5,13,61.5%,46m
38689,1,Nutti,2292,267,8,11,19,42.1%,36m
38689,3,[MSTL]mugiwara,2292,199,6,11,17,35.3%,21m
38689,1,baptistenulo,2292,155,5,8,13,38.5%,1h
38689,2,Chernoboy,2292,168,5,10,15,33.3%,32m
38689,2,Begrand,2292,48,4,2,6,66.7%,1h
38689,1,[TemG]MaKsImKaRU,2292,124,4,6,10,40.0%,24m
38689,1,trione,2292,168,4,7,11,36.4%,49m
38689,1,ham,2292,180,4,9,13,30.8%,1h
38689,3,Баклажан,2292,70,4,10,14,28.6%,42m
38689,2,ьллж,2292,0,2,2,4,50.0%,55m
38689,1,skylla,2292,122,2,5,7,28.6%,33m
38689,1,marateyka,2292,90,1,1,2,50.0%,29m
38689,1,vrlcs,2292,0,0,1,1,0.0%,30m
38689,1,Dirsa,2292,0,0,2,2,0.0%,29m
38689,3,[ThDoDo]MrTankmeta,2292,0,0,6,6,0.0%,52m
38720,1,Shelby,2291,1468,94,90,184,51.1%,30m
38720,1,akesplota,2291,1024,60,54,114,52.6%,32m
38720,1,Megatron,2291,1192,48,49,97,49.5%,39m
38720,3,Huan,2291,753,26,31,57,45.6%,44m
38720,2,Lichking,2291,703,23,40,63,36.5%,41m
38720,1,MirrorMan,2291,525,20,19,39,51.3%,10m
38720,1,timster,2291,652,19,19,38,50.0%,37m
38720,1,Overlod,2291,330,15,6,21,71.4%,26m
38720,1,[Petruc]DanielDARTH,2291,440,15,10,25,60.0%,19m
38720,1,random,2291,474,14,22,36,38.9%,44m
38720,1,ilBATTERISTA,2291,384,11,10,21,52.4%,17m
38720,3,Pelmenishe,2291,247,9,8,17,52.9%,53m
38720,3,aethion,2291,269,9,11,20,45.0%,52m
38720,1,joseisamurai,2291,271,7,8,15,46.7%,36m
38720,3,[Exprt]SamLeSerpent,2291,158,5,13,18,27.8%,27m
38720,1,dogyboy,2291,128,4,4,8,50.0%,6m
38720,1,Belerafon,2291,133,4,6,10,40.0%,15m
38720,2,firetank,2291,48,2,1,3,66.7%,31m
38720,1,CapriSun,2291,0,2,3,5,40.0%,30m
38720,1,HighWisnia,2291,0,2,4,6,33.3%,25m
38720,3,PassivPVP,2291,73,2,4,6,33.3%,28m
38720,2,ishka,2291,0,1,0,1,100.0%,41m
38720,1,artold,2291,0,1,4,5,20.0%,47m
38720,1,EvilKing,2291,40,1,6,7,14.3%,24m
38720,1,[TGTGTG]darkantoine,2291,0,0,1,1,0.0%,36m
38720,2,KennY,2291,0,0,1,1,0.0%,51m
38720,1,RobexTgMs,2291,73,0,2,2,0.0%,7m
38747,1,[Duvel]MiaoMiao,2290,1420,156,160,316,49.4%,18m
38747,1,garik,2290,1736,146,139,285,51.2%,35m
38747,1,nonobigboss,2290,1206,43,45,88,48.9%,42m
38747,1,NeverMInd,2290,495,20,14,34,58.8%,15m
38747,3,TFZMistery,2290,121,18,14,32,56.2%,33m
38747,1,qvs,2290,498,18,23,41,43.9%,16m
38747,1,GregoR,2290,402,13,19,32,40.6%,1h
38747,3,[SKB1]Studystaff,2290,251,10,10,20,50.0%,53m
38747,1,Gollin,2290,313,9,7,16,56.2%,50m
38747,3,KrennyGx,2290,246,8,12,20,40.0%,31m
38747,3,MitchConner,2290,222,7,4,11,63.6%,9m
38747,1,One,2290,246,7,6,13,53.8%,1h
38747,1,reret,2290,285,7,6,13,53.8%,7m
38747,1,Raqu,2290,204,5,3,8,62.5%,10m
38747,3,EkSeL,2290,86,5,9,14,35.7%,34m
38747,1,doubrechka,2290,144,4,1,5,80.0%,32m
38747,1,[Tripa]BestNoobEver,2290,146,4,2,6,66.7%,44m
38747,1,Light,2290,96,4,7,11,36.4%,40m
38747,1,nosok,2290,91,3,3,6,50.0%,22m
38747,1,ABUSOFIAN,2290,129,2,2,4,50.0%,9m
38747,1,Judex,2290,40,2,2,4,50.0%,37m
38747,1,YPKIS,2290,38,1,1,2,50.0%,15m
38747,1,LETSPLAY,2290,42,1,1,2,50.0%,23m
38747,1,[BMDR]Kinder,2290,36,1,2,3,33.3%,49m
38747,1,Безымянный,2290,48,1,3,4,25.0%,21m
38747,2,Givic,2290,0,1,4,5,20.0%,35m
38747,1,[HPCOG]Jeyger,2290,0,0,3,3,0.0%,45m
38774,3,Jake,2289,1462,69,61,130,53.1%,14m
38774,1,kirill,2289,1502,50,50,100,50.0%,39m
38774,1,Zavesa,2289,740,26,29,55,47.3%,1h
38774,2,[BeerTm]SashaN,2289,687,25,29,54,46.3%,37m
38774,1,DrLecter,2289,422,23,20,43,53.5%,40m
38774,1,pety,2289,590,20,23,43,46.5%,7m
38774,1,serdjo,2289,392,12,10,22,54.5%,36m
38774,3,andrei,2289,254,12,16,28,42.9%,8m
38774,3,Crumbly,2289,308,11,21,32,34.4%,23m
38774,3,Rogue,2289,291,8,15,23,34.8%,12m
38774,1,[aNNa]JeanneOscour,2289,156,7,7,14,50.0%,35m
38774,1,Abbysss,2289,210,6,9,15,40.0%,52m
38774,2,[GeFa]núe,2289,144,5,3,8,62.5%,1h
38774,2,Emir,2289,0,3,2,5,60.0%,51m
38774,1,taraponcho,2289,0,2,6,8,25.0%,26m
38774,2,Pogi,2289,0,1,3,4,25.0%,12m
38774,2,ReaD,2289,0,1,4,5,20.0%,9m
38774,2,[NW]SemDestroyer,2289,0,1,4,5,20.0%,10m
38774,1,qweasdzxczxc,2289,0,1,5,6,16.7%,16m
38793,1,DustyFrog,2288,1785,262,273,535,49.0%,22m
38793,3,ShaggyDogg,2288,1553,64,67,131,48.9%,12m
38793,3,KILLZONE,2288,1275,58,69,127,45.7%,5m
38793,1,[Tuur]Fair,2288,707,28,19,47,59.6%,37m
38793,3,AMEN,2288,638,21,27,48,43.8%,26m
38793,1,ZoMBIe,2288,560,16,18,34,47.1%,49m
38793,1,Lion,2288,459,15,9,24,62.5%,25m
38793,3,duduś,2288,333,15,17,32,46.9%,1h
38793,1,sliceoflife,2288,367,12,13,25,48.0%,47m
38793,1,Kiman,2288,214,9,1,10,90.0%,36m
38793,1,DjVetalProff,2288,298,9,9,18,50.0%,22m
38793,1,JackLigting,2288,266,8,13,21,38.1%,24m
38793,1,LazyTitan,2288,168,7,15,22,31.8%,54m
38793,1,MadHumbo,2288,144,5,8,13,38.5%,32m
38793,1,Dracarn,2288,124,4,4,8,50.0%,47m
38793,1,[Сold]loverdover,2288,146,4,4,8,50.0%,47m
38793,1,zxsaturnix,2288,109,4,7,11,36.4%,51m
38793,1,[roph]TheDragon,2288,158,4,8,12,33.3%,27m
38793,1,Pawel,2288,0,3,2,5,60.0%,26m
38793,1,eous,2288,133,3,2,5,60.0%,42m
38793,1,Zumbalalla,2288,111,3,4,7,42.9%,29m
38793,3,CENATRA,2288,122,3,8,11,27.3%,18m
38793,3,DRY,2288,60,3,9,12,25.0%,42m
38793,1,alexzero,2288,38,2,7,9,22.2%,38m
38793,1,Devastator,2288,48,2,7,9,22.2%,15m
38793,3,Alarma,2288,97,1,1,2,50.0%,50m
38793,1,Rodin,2288,38,1,3,4,25.0%,26m
38793,3,Tyre,2288,30,1,4,5,20.0%,54m
38793,1,Elrond,2288,0,1,5,6,16.7%,28m
38793,1,[NnSK]Max,2288,0,0,1,1,0.0%,1h
38793,1,[DSeal]DafDude,2288,0,0,1,1,0.0%,53m
38793,1,[II3II]Pampanikiel,2288,0,0,1,1,0.0%,26m
38825,1,Mari,2287,1790,179,166,345,51.9%,36m
38825,3,Plugin,2287,1502,115,114,229,50.2%,37m
38825,1,Ulysse,2287,978,103,94,197,52.3%,49m
38825,1,Lizard,2287,1585,58,54,112,51.8%,27m
38825,1,AzA,2287,1033,41,28,69,59.4%,49m
38825,1,MarkP,2287,1078,37,35,72,51.4%,5m
38825,2,[7STAR]zergaprotos,2287,918,30,42,72,41.7%,53m
38825,1,iioxep,2287,833,27,35,62,43.5%,27m
38825,3,[PÂRłAH]makak,2287,737,26,31,57,45.6%,30m
38825,1,[LIE]dftghjgdfhdf,2287,718,23,24,47,48.9%,22m
38825,1,coach,2287,383,12,17,29,41.4%,7m
38825,3,Audi,2287,313,11,16,27,40.7%,14m
38825,3,Maximax,2287,204,7,11,18,38.9%,15m
38825,1,mendell,2287,282,6,6,12,50.0%,1h
38825,3,ALUCARD,2287,0,5,5,10,50.0%,54m
38825,1,reqwer,2287,96,4,7,11,36.4%,32m
38825,2,[NEPROM]Randomguy,2287,0,3,1,4,75.0%,51m
38825,1,englishfox,2287,42,3,5,8,37.5%,37m
38825,1,Camral,2287,126,3,8,11,27.3%,32m
38825,1,[XIØI]Damazta,2287,74,2,4,6,33.3%,5m
38825,3,Maekys,2287,30,2,5,7,28.6%,44m
38825,1,вячеслав,2287,0,1,0,1,100.0%,8m
38825,1,[OmDi]Hashlael,2287,0,1,1,2,50.0%,37m
38825,1,JuliOne,2287,0,0,1,1,0.0%,40m
38825,1,fatonbaton,2287,0,0,1,1,0.0%,11m
38825,1,Kira,2287,0,0,2,2,0.0%,13m
38825,1,Joe,2287,0,0,3,3,0.0%,1h
38852,2,flurografia,2286,1535,70,83,153,45.8%,7m
38852,3,Mortiferr,2286,1250,59,70,129,45.7%,22m
38852,2,eddie,2286,799,55,70,125,44.0%,46m
38852,2,PozitronW,2286,740,34,43,77,44.2%,1h
38852,1,MisioX,2286,853,30,27,57,52.6%,1h
38852,1,Dimok,2286,856,28,23,51,54.9%,30m
38852,1,Nocdrive,2286,635,19,19,38,50.0%,51m
38852,3,Eveee,2286,437,15,20,35,42.9%,1h
38852,3,Tyran,2286,349,12,14,26,46.2%,37m
38852,1,[TTVM]Peanut,2286,340,10,9,19,52.6%,23m
38852,1,[HBGG]TheSwarm,2286,176,7,8,15,46.7%,25m
38852,1,VladShiko,2286,235,7,11,18,38.9%,6m
38852,1,Pipigp,2286,120,5,7,12,41.7%,49m
38852,3,Nico,2286,88,5,9,14,35.7%,18m
38852,3,TopKek,2286,114,5,12,17,29.4%,12m
38852,2,jean,2286,120,5,13,18,27.8%,21m
38852,1,repulsion,2286,168,4,5,9,44.4%,31m
38852,1,Lelik,2286,0,3,0,3,100.0%,1h
38852,1,Slicer,2286,192,3,5,8,37.5%,1h
38852,1,[OcК]ReeFox,2286,122,3,7,10,30.0%,1h
38852,1,FeeL,2286,40,2,1,3,66.7%,6m
38852,1,VersaltoDIO,2286,84,2,6,8,25.0%,9m
38852,1,Frustamonkey,2286,0,1,0,1,100.0%,4m
38852,1,FirstFallen,2286,0,1,0,1,100.0%,25m
38852,3,[Pyc]Фауст,2286,0,1,0,1,100.0%,14m
38852,1,Teabox,2286,0,1,3,4,25.0%,26m
38852,2,Bohni,2286,0,1,4,5,20.0%,1h
38852,1,Mygicc,2286,0,1,5,6,16.7%,22m
38852,1,fleyah,2286,88,1,5,6,16.7%,33m
38852,1,odion,2286,0,0,1,1,0.0%,42m
38852,3,Sonic,2286,0,0,2,2,0.0%,3m
38883,3,waldor,2285,305,103,105,208,49.5%,15m
38883,3,RIMAC,2285,1037,70,72,142,49.3%,6m
38883,1,Crude,2285,711,52,53,105,49.5%,44m
38883,1,Vlad,2285,761,26,21,47,55.3%,1h
38883,1,Leo,2285,702,23,27,50,46.0%,1h
38883,1,moeminator,2285,430,22,7,29,75.9%,55m
38883,1,smok,2285,578,21,31,52,40.4%,5m
38883,2,Stolitantum,2285,451,19,25,44,43.2%,3m
38883,1,Wisienka,2285,580,16,20,36,44.4%,19m
38883,1,DustinC,2285,315,12,10,22,54.5%,30m
38883,3,PegaS,2285,270,10,11,21,47.6%,1h
38883,1,lofstraker,2285,344,9,10,19,47.4%,40m
38883,1,hombeboy,2285,264,7,6,13,53.8%,41m
38883,3,Meloh,2285,254,7,11,18,38.9%,19m
38883,1,Paramoor,2285,140,4,8,12,33.3%,37m
38883,1,Dominik,2285,40,3,4,7,42.9%,27m
38883,3,Gesichtzslos,2285,60,3,9,12,25.0%,5m
38883,1,[HHOTS]ThePolletor,2285,0,2,3,5,40.0%,44m
38883,1,[EYQTPI]Dincht,2285,97,2,5,7,28.6%,1h
38883,1,Delta,2285,90,1,1,2,50.0%,12m
38883,2,BuChu,2285,0,1,4,5,20.0%,31m
38883,1,Zandorras,2285,44,1,6,7,14.3%,26m
38883,1,GreaterGood,2285,0,0,2,2,0.0%,1h
38883,1,Ryuk,2285,0,0,4,4,0.0%,19m
38907,1,kemosabe,2284,1293,76,81,157,48.4%,24m
38907,1,André,2284,1587,61,57,118,51.7%,51m
38907,1,Zippo,2284,1294,51,45,96,53.1%,5m
38907,1,DiegoMalote,2284,1409,49,50,99,49.5%,40m
38907,1,GrafMaxim,2284,884,29,35,64,45.3%,30m
38907,1,Astral,2284,802,26,26,52,50.0%,33m
38907,3,léo,2284,601,23,29,52,44.2%,10m
38907,1,Rookskerm,2284,684,21,24,45,46.7%,1h
38907,3,Llpol,2284,572,20,30,50,40.0%,33m
38907,2,Skrew,2284,538,17,29,46,37.0%,50m
38907,2,кот,2284,379,14,22,36,38.9%,48m
38907,1,Sparta,2284,295,11,6,17,64.7%,38m
38907,1,Айаал,2284,304,11,12,23,47.8%,51m
38907,1,skumfidusen,2284,300,8,5,13,61.5%,12m
38907,1,CorvoCox,2284,273,8,12,20,40.0%,1h
38907,1,DrNifario,2284,233,6,8,14,42.9%,44m
38907,2,Extortioner,2284,166,5,15,20,25.0%,53m
38907,1,[guppi]SKW,2284,120,4,1,5,80.0%,1h
38907,1,naget,2284,118,4,1,5,80.0%,17m
38907,2,CaptainFeed,2284,46,3,4,7,42.9%,52m
38907,1,Devourer,2284,118,3,4,7,42.9%,35m
38907,1,Loras,2284,193,3,6,9,33.3%,50m
38907,1,даниил,2284,116,3,9,12,25.0%,1h
38907,1,Istar,2284,0,1,0,1,100.0%,42m
38907,1,vskolomiets,2284,48,1,2,3,33.3%,40m
38907,2,Mertamus,2284,0,1,4,5,20.0%,51m
38907,1,GerhardsLV,2284,0,1,6,7,14.3%,1h
38907,1,[Burla]atlasCZE,2284,0,0,1,1,0.0%,12m
38907,2,ТоПчИп,2284,0,0,1,1,0.0%,48m
38907,1,Zuram,2284,0,0,3,3,0.0%,35m
38907,3,Ersu,2284,0,0,3,3,0.0%,21m
38938,1,Dork,2283,1768,117,125,242,48.3%,51m
38938,1,Betelguese,2283,933,69,74,143,48.3%,27m
38938,1,FFF,2283,1387,57,61,118,48.3%,32m
38938,1,Zero,2283,955,51,44,95,53.7%,53m
38938,3,[13NRV]SirIronprick,2283,1192,40,52,92,43.5%,48m
38938,1,Alliage,2283,862,25,27,52,48.1%,12m
38938,1,Elsing,2283,330,24,16,40,60.0%,33m
38938,2,[BLINtv]DungeonMastr,2283,448,17,25,42,40.5%,22m
38938,1,Тридцатый,2283,510,14,15,29,48.3%,9m
38938,1,[Frap10]Snake,2283,425,13,12,25,52.0%,38m
38938,1,[FTWWP]IVaNPaMuKa,2283,283,10,9,19,52.6%,26m
38938,1,[bgzona]zorosas,2283,277,7,5,12,58.3%,15m
38938,3,xenon,2283,178,7,14,21,33.3%,20m
38938,1,Aurora,2283,153,4,3,7,57.1%,35m
38938,2,Palziolo,2283,88,2,3,5,40.0%,55m
38938,1,OLEG,2283,0,1,1,2,50.0%,8m
38938,1,ДОРОГА,2283,38,1,3,4,25.0%,52m
38938,2,Tinurasa,2283,0,1,4,5,20.0%,53m
38938,2,Trapdoor,2283,0,1,4,5,20.0%,1h
38938,1,Paladinu,2283,0,0,1,1,0.0%,41m
38938,1,DNice,2283,0,0,1,1,0.0%,51m
38938,1,Модифик,2283,0,0,1,1,0.0%,35m
38960,1,Sancho,2282,1788,114,111,225,50.7%,35m
38960,1,Tjc,2282,1779,70,63,133,52.6%,33m
38960,3,NadzoR,2282,487,18,22,40,45.0%,1h
38960,3,[IDQ]XENOX,2282,355,13,15,28,46.4%,34m
38960,3,Mithradtes,2282,193,6,4,10,60.0%,54m
38960,1,Saladious,2282,135,5,1,6,83.3%,13m
38960,1,guguen,2282,202,5,10,15,33.3%,32m
38960,2,Адель,2282,163,5,12,17,29.4%,23m
38960,1,[SibOPG]SiberianOPG,2282,74,4,7,11,36.4%,35m
38960,2,AlTheGeneral,2282,0,3,0,3,100.0%,41m
38960,1,Karkonosz,2282,84,3,4,7,42.9%,13m
38960,1,Dimas,2282,71,3,4,7,42.9%,1h
38960,2,[boși]Ionut,2282,46,2,5,7,28.6%,27m
38960,1,[1FU2]старик,2282,84,2,6,8,25.0%,6m
38960,2,selia,2282,0,2,7,9,22.2%,1h
38960,1,achil,2282,0,1,3,4,25.0%,1h
38960,1,Mousey,2282,0,1,5,6,16.7%,43m
38960,2,MolleGrolle,2282,0,1,5,6,16.7%,14m
38960,1,batibot,2282,0,1,5,6,16.7%,1h
38960,1,TeQiilla,2282,0,1,5,6,16.7%,26m
38960,3,Starblind,2282,0,1,7,8,12.5%,33m
38960,3,XoMute,2282,0,1,7,8,12.5%,44m
38960,1,GuenterKrass,2282,0,0,1,1,0.0%,40m
38983,1,Ubiquitous,2281,1774,83,80,163,50.9%,38m
38983,1,Laocoon,2281,1067,38,31,69,55.1%,11m
38983,1,Flet,2281,945,36,34,70,51.4%,36m
38983,1,CrolenStone,2281,764,27,25,52,51.9%,36m
38983,1,Xcharo,2281,680,23,19,42,54.8%,10m
38983,1,MrGoldFish,2281,394,18,15,33,54.5%,1h
38983,2,ElectronChik,2281,459,17,19,36,47.2%,21m
38983,1,NRT,2281,484,14,11,25,56.0%,38m
38983,1,Yanok,2281,109,3,1,4,75.0%,22m
38983,3,serjik,2281,151,3,5,8,37.5%,42m
38983,1,OlD,2281,136,3,6,9,33.3%,52m
38983,2,Diaboliik,2281,30,3,8,11,27.3%,14m
38983,2,Avii,2281,30,3,8,11,27.3%,9m
38983,1,[tjack]sad,2281,44,2,6,8,25.0%,38m
38983,1,haymitch,2281,0,1,0,1,100.0%,55m
38983,1,sticker,2281,0,1,0,1,100.0%,25m
38983,1,TERRANO,2281,40,1,3,4,25.0%,29m
38983,2,[H0X]Gladiator,2281,0,0,1,1,0.0%,41m
38983,1,KuLito,2281,0,0,2,2,0.0%,52m
38983,1,vlakir,2281,0,0,2,2,0.0%,38m
39003,2,[N0IP]Braincracker,2280,1535,241,254,495,48.7%,23m
39003,1,binman,2280,1645,62,59,121,51.2%,17m
39003,1,cornus,2280,421,40,12,52,76.9%,18m
39003,1,nikita,2280,693,34,32,66,51.5%,47m
39003,1,Mingazov,2280,824,31,19,50,62.0%,11m
39003,3,Garinich,2280,479,21,24,45,46.7%,6m
39003,1,Nemesiz,2280,669,20,17,37,54.1%,12m
39003,1,[zpn3]MerlinDeMonk,2280,650,20,23,43,46.5%,36m
39003,3,MatTheGenius,2280,428,18,23,41,43.9%,48m
39003,2,Gerolsteiner,2280,467,14,25,39,35.9%,45m
39003,1,Привет,2280,410,13,20,33,39.4%,1h
39003,2,Lip,2280,305,11,12,23,47.8%,6m
39003,1,Babar,2280,298,7,7,14,50.0%,33m
39003,2,HansenLange,2280,236,7,13,20,35.0%,7m
39003,3,[420GG]Chiken,2280,185,5,11,16,31.2%,51m
39003,1,Shinorow,2280,165,4,6,10,40.0%,23m
39003,1,BladHeBamnip,2280,122,4,7,11,36.4%,23m
39003,3,Merlin,2280,30,2,0,2,100.0%,52m
39003,1,zolik,2280,106,2,1,3,66.7%,16m
39003,1,Agitator,2280,118,2,1,3,66.7%,17m
39003,2,Kozicyc,2280,0,2,6,8,25.0%,19m
39003,1,[S1B]AWBTiet,2280,0,1,0,1,100.0%,1h
39003,1,xakis,2280,0,1,0,1,100.0%,1h
39003,1,OFsaID,2280,0,1,0,1,100.0%,14m
39003,3,Oswin,2280,97,1,2,3,33.3%,43m
39003,1,oskar,2280,0,1,7,8,12.5%,40m
39003,1,Kserk,2280,0,0,1,1,0.0%,32m
39003,2,Kamaz,2280,0,0,1,1,0.0%,42m
39003,1,[krdo]Mertojack,2280,0,0,1,1,0.0%,33m
39003,1,BoeBoga,2280,0,0,2,2,0.0%,1h
39033,2,[2bgr2]Sumrak,2279,1093,76,74,150,50.7%,25m
39033,3,lolpeep,2279,879,61,52,113,54.0%,12m
39033,2,BadKrevedko,2279,1166,48,45,93,51.6%,1h
39033,1,IIIIIIIIII,2279,1034,39,40,79,49.4%,41m
39033,2,VOAH,2279,1118,39,51,90,43.3%,20m
39033,1,[mfixed]PieRun,2279,768,29,29,58,50.0%,44m
39033,1,[geym]Zeratul,2279,602,28,16,44,63.6%,49m
39033,1,Yammamotosan,2279,825,27,32,59,45.8%,5m
39033,1,SNAKER,2279,734,24,24,48,50.0%,45m
39033,1,[ExTr1m]IZI,2279,327,13,8,21,61.9%,1h
39033,3,Taac,2279,317,11,12,23,47.8%,19m
39033,1,Watee,2279,314,11,14,25,44.0%,12m
39033,1,mamenkoUaRu,2279,332,10,9,19,52.6%,52m
39033,1,Adalfuns,2279,308,8,6,14,57.1%,45m
39033,1,[BOTSI]MiTysy,2279,309,8,8,16,50.0%,40m
39033,2,WolfyerK,2279,152,8,16,24,33.3%,36m
39033,3,nerazim,2279,222,7,18,25,28.0%,26m
39033,1,Oskar,2279,242,6,8,14,42.9%,41m
39033,1,Molok,2279,210,6,9,15,40.0%,1h
39033,3,yackerforeve,2279,180,6,13,19,31.6%,1h
39033,1,SleepyAF,2279,148,5,5,10,50.0%,36m
39033,2,Tyran,2279,142,5,10,15,33.3%,9m
39033,1,Danya,2279,129,4,5,9,44.4%,11m
39033,1,[mfxed]vGAv,2279,192,3,2,5,60.0%,49m
39033,1,RagaFlo,2279,169,3,3,6,50.0%,27m
39033,1,QueenOfCreep,2279,129,3,5,8,37.5%,25m
39033,3,Fallergo,2279,97,3,7,10,30.0%,22m
39033,3,iPlAy,2279,36,3,13,16,18.8%,5m
39033,1,Aleks,2279,90,2,0,2,100.0%,35m
39033,1,BrutalDeluxe,2279,0,1,0,1,100.0%,6m
39033,1,Maxim,2279,97,1,2,3,33.3%,5m
39033,1,Lanfear,2279,42,1,4,5,20.0%,9m
39033,2,SOMA,2279,0,1,5,6,16.7%,48m
39033,1,hells,2279,89,1,5,6,16.7%,33m
39033,3,[RBMS]Fenrir,2279,30,1,8,9,11.1%,22m
39033,1,PNR,2279,0,0,1,1,0.0%,18m
39033,1,Antey,2279,0,0,1,1,0.0%,26m
39033,1,[SKRSPZ]толя,2279,0,0,1,1,0.0%,50m
39033,3,xtrmzero,2279,0,0,1,1,0.0%,35m
39033,1,domiks,2279,0,0,1,1,0.0%,23m
39073,1,SolArgenti,2278,743,122,122,244,50.0%,23m
39073,1,VladFreeze,2278,1760,82,70,152,53.9%,1h
39073,1,LSDMonk,2278,839,77,77,154,50.0%,49m
39073,1,[zurt]zurtmaster,2278,1041,43,31,74,58.1%,43m
39073,1,Daikiri,2278,628,43,40,83,51.8%,1h
39073,1,feliuarro,2278,773,28,24,52,53.8%,25m
39073,1,SADUTI,2278,557,27,18,45,60.0%,52m
39073,1,Victormik,2278,465,16,14,30,53.3%,32m
39073,3,werso,2278,466,16,26,42,38.1%,54m
39073,1,AutumnKit,2278,480,15,15,30,50.0%,44m
39073,1,RMGL,2278,504,13,21,34,38.2%,50m
39073,3,[2iq]XUI,2278,328,12,9,21,57.1%,7m
39073,1,RoiserV,2278,396,10,12,22,45.5%,1h
39073,3,Deje,2278,274,10,12,22,45.5%,14m
39073,1,SPoTSepSiS,2278,184,7,4,11,63.6%,49m
39073,3,first,2278,216,7,18,25,28.0%,26m
39073,1,[ExTr1m]MaverickClaw,2278,227,6,4,10,60.0%,7m
39073,1,Valentin,2278,193,6,6,12,50.0%,16m
39073,2,[NeoHex]Ecanos,2278,182,6,20,26,23.1%,9m
39073,1,Krochak,2278,91,5,9,14,35.7%,8m
39073,1,Deky,2278,0,3,3,6,50.0%,22m
39073,1,ZEUS,2278,144,3,6,9,33.3%,25m
39073,1,[Hrѓ]СтаяИгнуса,2278,40,2,3,5,40.0%,4m
39073,1,МЕТАЛИК,2278,78,2,4,6,33.3%,25m
39073,1,fity,2278,96,2,6,8,25.0%,8m
39073,2,Tairz,2278,0,1,0,1,100.0%,32m
39073,3,[Ctlo]Singularity,2278,0,1,3,4,25.0%,1h
39073,1,NOMADIC,2278,38,1,3,4,25.0%,17m
39073,1,Màmàdou,2278,0,1,4,5,20.0%,40m
39073,2,Sezam,2278,0,0,1,1,0.0%,55m
39073,2,MrDude,2278,0,0,1,1,0.0%,30m
39073,1,Remontoir,2278,0,0,4,4,0.0%,35m
39105,2,MARKUS,2277,1579,236,238,474,49.8%,1h
39105,1,Bear,2277,1112,60,59,119,50.4%,1h
39105,1,ПАПАНЯ,2277,1226,43,48,91,47.3%,1h
39105,1,AssassinX,2277,491,26,26,52,50.0%,1h
39105,1,SalmonSushi,2277,494,22,18,40,55.0%,31m
39105,3,RoYkin,2277,471,18,23,41,43.9%,50m
39105,1,[CRAB3]Barcode,2277,316,9,43,52,17.3%,35m
39105,1,krypto,2277,190,8,2,10,80.0%,33m
39105,3,Gosho,2277,178,7,11,18,38.9%,28m
39105,1,Flavi,2277,154,5,5,10,50.0%,40m
39105,1,mac,2277,156,4,8,12,33.3%,17m
39105,1,Vladonator,2277,100,4,9,13,30.8%,4m
39105,1,Zan,2277,120,3,1,4,75.0%,21m
39105,1,[Medoеd]BeRGOmoY,2277,132,3,6,9,33.3%,22m
39105,1,[ЕШКИ]ESHICH,2277,126,2,2,4,50.0%,40m
39105,2,akela,2277,0,2,6,8,25.0%,1h
39105,3,TigerDavid,2277,95,2,6,8,25.0%,1h
39105,1,Zaur,2277,73,2,7,9,22.2%,1h
39105,2,Toolkin,2277,30,2,7,9,22.2%,34m
39105,1,Ramadi,2277,0,0,1,1,0.0%,51m
39105,2,[GGB]McPete,2277,0,0,1,1,0.0%,42m
39105,1,Leeroy,2277,0,0,5,5,0.0%,33m
39127,1,WhiteYmka,2276,1547,128,134,262,48.9%,33m
39127,1,Dragon,2276,1768,116,116,232,50.0%,25m
39127,1,romarioaggro,2276,1242,46,37,83,55.4%,36m
39127,1,Meskalito,2276,765,25,18,43,58.1%,35m
39127,1,MRBLACK,2276,450,21,9,30,70.0%,27m
39127,1,[1448]Chriserx,2276,678,19,20,39,48.7%,51m
39127,1,[RUA]Rudi,2276,516,19,23,42,45.2%,46m
39127,1,Solar,2276,376,12,18,30,40.0%,22m
39127,1,MIROILLL,2276,100,5,5,10,50.0%,8m
39127,1,Krillok,2276,185,5,10,15,33.3%,8m
39127,1,[GGro]LucheSSe,2276,126,4,5,9,44.4%,41m
39127,1,Bayesd,2276,157,4,8,12,33.3%,1h
39127,1,martin,2276,102,4,9,13,30.8%,19m
39127,1,Yachio,2276,119,3,2,5,60.0%,24m
39127,1,SzybkaMiśka,2276,112,3,8,11,27.3%,7m
39127,1,Max,2276,97,2,6,8,25.0%,1h
39127,1,Glaxos,2276,40,1,4,5,20.0%,11m
39127,2,glenj,2276,0,1,5,6,16.7%,22m
39127,1,Plexxer,2276,0,1,5,6,16.7%,33m
39127,1,LibertyChimp,2276,0,0,1,1,0.0%,49m
39127,2,Lumpus,2276,0,0,1,1,0.0%,42m
39127,1,Doner,2276,0,0,2,2,0.0%,46m
39149,1,[ZUBS]RAIDAGE,2275,682,21,25,46,45.7%,55m
39149,1,[БУБУБ]somebdysm,2275,405,13,12,25,52.0%,37m
39149,1,[Chariz]Забвение,2275,185,11,11,22,50.0%,47m
39149,1,Ender,2275,267,9,7,16,56.2%,49m
39149,1,deimik,2275,198,8,8,16,50.0%,32m
39149,3,kradox,2275,196,5,5,10,50.0%,29m
39149,1,[ValidG]Pinoester,2275,131,4,1,5,80.0%,30m
39149,1,asaut,2275,134,4,1,5,80.0%,33m
39149,1,Dukembus,2275,42,2,1,3,66.7%,7m
39149,1,XACK,2275,130,2,2,4,50.0%,36m
39149,1,[GBang]LordFrancis,2275,82,2,3,5,40.0%,8m
39149,1,DenBercut,2275,97,2,6,8,25.0%,30m
39149,2,trynda,2275,0,2,8,10,20.0%,18m
39149,1,Gerc,2275,6,1,3,4,25.0%,51m
39149,1,Varjaga,2275,40,1,4,5,20.0%,33m
39149,1,BabyNoob,2275,0,1,4,5,20.0%,43m
39149,1,Gabion,2275,0,0,1,1,0.0%,49m
39149,1,siNoptik,2275,0,0,1,1,0.0%,27m
39149,1,Camel,2275,0,0,3,3,0.0%,1h
39168,1,respiner,2274,1436,65,64,129,50.4%,36m
39168,1,[RUS61]lev,2274,1338,49,48,97,50.5%,54m
39168,1,[AW9]JonCrispy,2274,906,33,36,69,47.8%,3m
39168,1,Sebalubu,2274,746,25,24,49,51.0%,37m
39168,1,василий,2274,694,19,22,41,46.3%,34m
39168,3,[258]Alexzed,2274,557,19,24,43,44.2%,8m
39168,1,[EWEN]karol,2274,205,10,6,16,62.5%,15m
39168,3,[J4E]Machtiern,2274,234,8,17,25,32.0%,36m
39168,1,Empire,2274,242,7,8,15,46.7%,11m
39168,2,SerG,2274,128,7,13,20,35.0%,19m
39168,1,веган,2274,48,6,4,10,60.0%,19m
39168,1,TEM,2274,189,6,5,11,54.5%,32m
39168,2,Artemexe,2274,198,6,13,19,31.6%,44m
39168,3,SEETOON,2274,62,5,9,14,35.7%,12m
39168,1,DANIIL,2274,145,3,4,7,42.9%,15m
39168,1,Эдик,2274,68,3,5,8,37.5%,3m
39168,1,maxgeny,2274,80,3,6,9,33.3%,7m
39168,1,Chronos,2274,88,2,0,2,100.0%,35m
39168,1,zdravosloven,2274,121,2,3,5,40.0%,32m
39168,1,Biscuits,2274,88,2,4,6,33.3%,53m
39168,1,Resurrection,2274,38,2,5,7,28.6%,21m
39168,1,drschmidt,2274,88,1,1,2,50.0%,40m
39168,1,Kazan,2274,42,1,2,3,33.3%,1h
39168,1,Sasha,2274,0,1,5,6,16.7%,1h
39168,2,MythicMilo,2274,0,0,1,1,0.0%,19m
39168,1,LastSin,2274,0,0,3,3,0.0%,29m
39168,1,Sniperov,2274,0,0,3,3,0.0%,25m
39195,1,Torac,2273,1763,126,118,244,51.6%,19m
39195,3,Archangel,2273,1246,64,73,137,46.7%,26m
39195,1,Blaze,2273,1164,58,52,110,52.7%,33m
39195,1,BelondBelond,2273,1046,37,35,72,51.4%,1h
39195,1,Itherael,2273,582,28,12,40,70.0%,47m
39195,1,geo,2273,302,9,8,17,52.9%,9m
39195,2,PersikZerg,2273,186,9,18,27,33.3%,8m
39195,1,MrGreen,2273,187,6,4,10,60.0%,35m
39195,3,SFM,2273,121,6,7,13,46.2%,37m
39195,1,Nenerial,2273,202,5,4,9,55.6%,25m
39195,1,Angel,2273,162,5,5,10,50.0%,20m
39195,3,NeoX,2273,194,5,10,15,33.3%,37m
39195,2,[DAVMAR]JOE,2273,118,5,11,16,31.2%,8m
39195,3,Werhoz,2273,204,5,14,19,26.3%,30m
39195,1,Buddha,2273,145,4,2,6,66.7%,1h
39195,1,[Rokk]Frain,2273,124,4,5,9,44.4%,3m
39195,1,LunguNJA,2273,160,4,6,10,40.0%,8m
39195,1,suppa,2273,82,3,2,5,60.0%,30m
39195,1,Bieszczader,2273,74,3,2,5,60.0%,37m
39195,1,[CIDIM]RageSae,2273,0,1,0,1,100.0%,8m
39195,1,RudzinJin,2273,0,1,0,1,100.0%,38m
39195,2,[Y3БАН]kirlan,2273,0,1,4,5,20.0%,40m
39195,1,ADaptation,2273,0,0,1,1,0.0%,50m
39195,1,[UGRA]Grats,2273,0,0,1,1,0.0%,55m
39195,1,Grombrindal,2273,0,0,2,2,0.0%,13m
39195,1,Noscoper,2273,0,0,3,3,0.0%,11m
39195,1,САДИСТ,2273,0,0,3,3,0.0%,5m
39222,3,calvin,2272,1518,187,186,373,50.1%,36m
39222,1,Johan,2272,1747,115,113,228,50.4%,28m
39222,1,Genesequasss,2272,1536,92,87,179,51.4%,1h
39222,3,eblonsky,2272,788,92,90,182,50.5%,7m
39222,3,doctor,2272,1293,55,52,107,51.4%,11m
39222,1,Gzuspod,2272,724,34,20,54,63.0%,16m
39222,1,SCrEaM,2272,834,28,31,59,47.5%,6m
39222,1,[MayDie]Nekromant,2272,578,21,13,34,61.8%,26m
39222,1,Akrum,2272,497,20,11,31,64.5%,49m
39222,1,IsekaiReaper,2272,546,16,16,32,50.0%,18m
39222,1,Guggi,2272,352,9,14,23,39.1%,8m
39222,3,EnDOrFIncHIC,2272,302,9,16,25,36.0%,34m
39222,1,ГОМОТРОН,2272,205,8,7,15,53.3%,47m
39222,1,[YQ]buyfn,2272,269,8,10,18,44.4%,44m
39222,1,ЖУЖА,2272,177,6,2,8,75.0%,45m
39222,1,ivan,2272,155,5,4,9,55.6%,1h
39222,1,Jabka,2272,193,5,7,12,41.7%,45m
39222,2,MWF,2272,176,5,16,21,23.8%,35m
39222,1,Matis,2272,121,4,3,7,57.1%,26m
39222,2,Sunshine,2272,62,4,9,13,30.8%,34m
39222,1,[LoGiN]fraer,2272,131,3,2,5,60.0%,1h
39222,2,Frelzw,2272,90,3,5,8,37.5%,19m
39222,1,smogiiiii,2272,30,3,9,12,25.0%,46m
39222,1,Sodomizer,2272,86,2,4,6,33.3%,45m
39222,1,Voiddd,2272,131,2,4,6,33.3%,36m
39222,2,[SFXtm]SFXPix,2272,0,2,6,8,25.0%,45m
39222,1,Protossoluke,2272,0,1,0,1,100.0%,35m
39222,2,[ÜPZO]BierPirat,2272,0,1,5,6,16.7%,27m
39222,1,Andrey,2272,40,1,5,6,16.7%,46m
39222,1,Sibastion,2272,42,1,5,6,16.7%,33m
39222,1,SEISOKKI,2272,0,1,5,6,16.7%,34m
39222,1,Anti,2272,0,0,1,1,0.0%,43m
39222,1,Duller,2272,0,0,1,1,0.0%,11m
39222,2,Ceravid,2272,0,0,1,1,0.0%,34m
39222,1,Mars,2272,0,0,2,2,0.0%,1h
39257,3,Equido,2271,1603,96,87,183,52.5%,22m
39257,1,YoussefB,2271,1184,64,49,113,56.6%,35m
39257,1,ToTo,2271,1318,47,53,100,47.0%,1h
39257,1,Ador,2271,343,36,43,79,45.6%,7m
39257,3,ArTsi,2271,955,34,39,73,46.6%,37m
39257,1,HeroSecreT,2271,651,28,30,58,48.3%,1h
39257,1,Rafert,2271,510,18,19,37,48.6%,1h
39257,1,Ars,2271,347,15,13,28,53.6%,36m
39257,1,MistaEvil,2271,436,12,15,27,44.4%,8m
39257,3,delfees,2271,258,11,19,30,36.7%,24m
39257,1,GHOST,2271,203,10,6,16,62.5%,6m
39257,1,Салоед,2271,374,10,13,23,43.5%,41m
39257,1,PapaSchlumpf,2271,292,10,15,25,40.0%,1h
39257,1,Blue,2271,144,6,6,12,50.0%,37m
39257,1,dukE,2271,134,4,7,11,36.4%,20m
39257,1,PaniC,2271,0,3,2,5,60.0%,55m
39257,1,Quetzalito,2271,72,3,2,5,60.0%,1h
39257,1,roger,2271,145,3,3,6,50.0%,17m
39257,1,[lSOFl]SgtBarnard,2271,78,3,5,8,37.5%,8m
39257,1,сладенький,2271,96,2,1,3,66.7%,12m
39257,1,Sukkamehu,2271,48,2,3,5,40.0%,26m
39257,3,Michelman,2271,30,2,7,9,22.2%,44m
39257,3,KlerikVoo,2271,0,1,0,1,100.0%,11m
39257,1,IceFire,2271,0,1,4,5,20.0%,40m
39257,1,Khriss,2271,0,0,1,1,0.0%,1h
39257,3,[Achim]AggroPeter,2271,0,0,1,1,0.0%,6m
39257,1,[TProxy]WhatsMyName,2271,0,0,5,5,0.0%,1h
39284,1,cool,2270,1787,211,211,422,50.0%,1h
39284,1,[GMR13]AlkAliK,2270,1572,56,57,113,49.6%,7m
39284,1,HardLamer,2270,1108,45,40,85,52.9%,43m
39284,1,NOVOSIB,2270,836,25,26,51,49.0%,34m
39284,1,OttoRolf,2270,785,24,25,49,49.0%,44m
39284,2,druss,2270,614,23,28,51,45.1%,53m
39284,1,MisterDuck,2270,491,19,20,39,48.7%,1h
39284,1,NortherEast,2270,451,15,19,34,44.1%,51m
39284,1,oljg,2270,488,13,21,34,38.2%,8m
39284,1,yeti,2270,450,13,37,50,26.0%,49m
39284,1,ForgoTTeN,2270,365,11,16,27,40.7%,44m
39284,1,conan,2270,183,7,7,14,50.0%,43m
39284,3,ProstoNoob,2270,184,7,13,20,35.0%,14m
39284,1,xShockSkillz,2270,139,5,3,8,62.5%,7m
39284,1,fogo,2270,196,5,9,14,35.7%,49m
39284,3,caveman,2270,60,4,8,12,33.3%,43m
39284,1,Andruxa,2270,113,3,0,3,100.0%,50m
39284,1,DonCosciotte,2270,105,3,1,4,75.0%,1h
39284,1,blue,2270,129,3,2,5,60.0%,36m
39284,1,BrainlessQQ,2270,48,3,7,10,30.0%,30m
39284,1,McJOHN,2270,114,2,7,9,22.2%,47m
39284,3,[MaAM]QQW,2270,0,2,7,9,22.2%,21m
39284,2,Looping,2270,0,2,7,9,22.2%,15m
39284,1,[TExGG]TausendFisch,2270,0,1,0,1,100.0%,36m
39284,1,Deathnar,2270,0,1,1,2,50.0%,37m
39284,1,PureLight,2270,0,1,1,2,50.0%,32m
39284,1,[4Cap]Crowe,2270,0,1,2,3,33.3%,44m
39284,3,[Sepuku]ruslan,2270,30,1,12,13,7.7%,41m
39284,1,Blairwitch,2270,0,0,1,1,0.0%,25m
39284,1,[Бульба]Mixsar,2270,0,0,1,1,0.0%,1h
39284,1,Carlos,2270,0,0,2,2,0.0%,15m
39284,3,вапыв,2270,0,0,2,2,0.0%,39m
39284,2,[Аtomic]Данька,2270,0,0,3,3,0.0%,7m
39317,1,VelociRAPTOR,2269,1778,156,161,317,49.2%,1h
39317,1,Stefano,2269,1786,91,100,191,47.6%,51m
39317,1,forgotten,2269,670,20,24,44,45.5%,32m
39317,1,master,2269,337,12,8,20,60.0%,40m
39317,1,[Lolers]Kaizerai,2269,201,11,6,17,64.7%,33m
39317,1,ede,2269,294,9,5,14,64.3%,26m
39317,1,lulutop,2269,258,8,8,16,50.0%,29m
39317,1,Tiammat,2269,126,6,7,13,46.2%,17m
39317,1,Elerionis,2269,306,6,23,29,20.7%,18m
39317,1,Ignis,2269,154,4,11,15,26.7%,54m
39317,1,Taz,2269,157,4,11,15,26.7%,40m
39317,1,Gosha,2269,105,3,4,7,42.9%,25m
39317,1,frabouil,2269,36,3,4,7,42.9%,36m
39317,1,Arhangel,2269,84,3,6,9,33.3%,43m
39317,3,YVZFRT,2269,92,3,12,15,20.0%,1h
39317,1,[TFSC]Helitacker,2269,89,2,1,3,66.7%,1h
39317,1,Sentinel,2269,84,2,4,6,33.3%,25m
39317,1,Vitalii,2269,82,2,4,6,33.3%,51m
39317,1,ZsSta,2269,28,2,6,8,25.0%,42m
39317,2,[BLSS]Melancholion,2269,0,1,0,1,100.0%,30m
39317,1,Orion,2269,0,1,2,3,33.3%,28m
39317,2,BrentVE,2269,88,1,5,6,16.7%,1h
39317,1,predator,2269,0,1,5,6,16.7%,1h
39317,1,Chernogled,2269,42,1,6,7,14.3%,16m
39317,2,Stan,2269,0,0,1,1,0.0%,1h
39317,1,daff,2269,0,0,6,6,0.0%,53m
39343,1,[FR1]BABA,2268,1174,53,51,104,51.0%,35m
39343,3,Winterstein,2268,762,29,32,61,47.5%,27m
39343,1,Dark,2268,620,23,15,38,60.5%,30m
39343,1,[TrolBZ]ROADHOUSE,2268,754,20,27,47,42.6%,29m
39343,1,llllllllllll,2268,307,13,6,19,68.4%,55m
39343,1,Freemind,2268,296,12,19,31,38.7%,14m
39343,1,Meric,2268,408,11,15,26,42.3%,47m
39343,1,MonoxyExtra,2268,213,7,3,10,70.0%,49m
39343,1,[FAJAS]berecikpl,2268,242,7,9,16,43.8%,54m
39343,1,[VGSC]CivilSteel,2268,224,6,8,14,42.9%,1h
39343,1,DeNNiS,2268,170,5,7,12,41.7%,1h
39343,1,WİLDWolf,2268,80,3,7,10,30.0%,23m
39343,1,min,2268,96,3,8,11,27.3%,1h
39343,1,hollipolli,2268,0,2,5,7,28.6%,30m
39343,1,owen,2268,40,2,6,8,25.0%,18m
39343,1,[ZЕRGML]antonslah,2268,0,1,1,2,50.0%,51m
39343,1,ZeroHour,2268,0,1,2,3,33.3%,36m
39343,2,ProWilku,2268,0,1,3,4,25.0%,34m
39343,1,oberkaiser,2268,0,1,6,7,14.3%,40m
39343,1,зазаз,2268,0,0,1,1,0.0%,1h
39343,1,Nevervideo,2268,0,0,2,2,0.0%,33m
39343,1,Alesior,2268,0,0,5,5,0.0%,1h
39365,1,bomba,2267,986,40,47,87,46.0%,1h
39365,1,XENIX,2267,843,38,26,64,59.4%,32m
39365,1,Ipodster,2267,832,31,26,57,54.4%,5m
39365,1,mrOlegarh,2267,741,24,30,54,44.4%,5m
39365,3,XIMIK,2267,489,21,24,45,46.7%,28m
39365,1,darkwhisper,2267,467,18,19,37,48.6%,5m
39365,1,zerGeeWoo,2267,594,18,24,42,42.9%,28m
39365,1,[HAKS]BLACKALIROSE,2267,390,13,11,24,54.2%,16m
39365,1,swole,2267,436,13,12,25,52.0%,1h
39365,1,Lichtwangof,2267,376,12,10,22,54.5%,8m
39365,1,pomalaNca,2267,273,8,7,15,53.3%,18m
39365,3,Crugs,2267,232,7,12,19,36.8%,1h
39365,1,Bilal,2267,131,6,4,10,60.0%,35m
39365,3,Nedlloyd,2267,0,5,2,7,71.4%,50m
39365,1,[mfxed]NigrumF,2267,154,5,4,9,55.6%,13m
39365,1,[Аоуэйя]kok,2267,174,5,7,12,41.7%,47m
39365,1,Denim,2267,121,3,7,10,30.0%,22m
39365,3,Chenji,2267,149,3,14,17,17.6%,23m
39365,1,Dyps,2267,97,2,0,2,100.0%,5m
39365,2,Konkord,2267,123,2,2,4,50.0%,1h
39365,1,GaaraAD,2267,0,2,5,7,28.6%,31m
39365,2,MRLOVALOVA,2267,48,2,6,8,25.0%,40m
39365,3,[MSII]Helljumper,2267,0,1,0,1,100.0%,1h
39365,1,[VDteam]Ekzorcist,2267,0,1,0,1,100.0%,33m
39365,1,Дишеб,2267,90,1,2,3,33.3%,1h
39365,1,DeathPlayer,2267,0,1,2,3,33.3%,37m
39365,3,Roin,2267,0,1,6,7,14.3%,49m
39365,1,Denis,2267,0,0,2,2,0.0%,11m
39365,1,RayRayz,2267,0,0,6,6,0.0%,40m
39365,3,Leonoid,2267,0,0,6,6,0.0%,1h
39395,2,FelixZXZ,2266,1274,115,119,234,49.1%,50m
39395,1,Korrigan,2266,1460,53,54,107,49.5%,30m
39395,1,Gandalf,2266,1109,47,47,94,50.0%,41m
39395,1,MapHacker,2266,930,29,30,59,49.2%,22m
39395,1,Hazamun,2266,698,25,27,52,48.1%,12m
39395,1,BendeR,2266,664,21,19,40,52.5%,16m
39395,1,Gicke,2266,299,17,21,38,44.7%,8m
39395,2,Sarge,2266,392,15,22,37,40.5%,5m
39395,1,humu,2266,485,15,22,37,40.5%,38m
39395,1,Tomi,2266,408,10,19,29,34.5%,8m
39395,2,CaptainMeddl,2266,0,3,3,6,50.0%,37m
39395,1,Moritzdg,2266,124,3,5,8,37.5%,47m
39395,1,[DLTED]HammerHound,2266,96,3,8,11,27.3%,1h
39395,2,[soldat]Adelante,2266,36,2,0,2,100.0%,44m
39395,3,Pain,2266,0,2,6,8,25.0%,22m
39395,1,USOA,2266,0,2,7,9,22.2%,5m
39395,2,Viperio,2266,0,1,0,1,100.0%,40m
39395,1,[monstr]hercules,2266,36,1,2,3,33.3%,13m
39395,1,ZENIT,2266,42,1,3,4,25.0%,1h
39395,1,UberPalka,2266,48,1,5,6,16.7%,23m
39395,1,[HDPL]BOBMARLEY,2266,111,1,6,7,14.3%,36m
39395,2,Wulf,2266,0,0,1,1,0.0%,11m
39395,2,Alex,2266,0,0,1,1,0.0%,55m
39395,2,oudomiium,2266,0,0,1,1,0.0%,51m
39395,2,[Petruc]BaileEnxutos,2266,0,0,1,1,0.0%,21m
39420,3,Max,2265,1535,221,222,443,49.9%,35m
39420,1,krzysgg,2265,1421,100,97,197,50.8%,25m
39420,1,ultred,2265,813,95,97,192,49.5%,51m
39420,1,Aladar,2265,1543,64,61,125,51.2%,53m
39420,1,PlaceboDublo,2265,1287,53,49,102,52.0%,26m
39420,3,[RedPen]DrHase,2265,1337,51,54,105,48.6%,35m
39420,2,Aelstal,2265,454,37,35,72,51.4%,5m
39420,1,NORA,2265,737,25,27,52,48.1%,1h
39420,1,Dean,2265,625,23,22,45,51.1%,11m
39420,1,CoKoJI,2265,747,23,23,46,50.0%,53m
39420,1,lavrushka,2265,580,16,20,36,44.4%,28m
39420,2,Electricfish,2265,322,12,11,23,52.2%,35m
39420,3,WildCatling,2265,270,9,14,23,39.1%,41m
39420,1,ponkicha,2265,118,7,6,13,53.8%,12m
39420,1,Moldovich,2265,228,6,6,12,50.0%,19m
39420,2,[foots]blackarrow,2265,121,5,5,10,50.0%,1h
39420,1,Obst,2265,94,5,11,16,31.2%,46m
39420,3,ArtzCoffe,2265,97,4,5,9,44.4%,35m
39420,1,andreiul,2265,126,4,11,15,26.7%,47m
39420,3,LevelUP,2265,148,3,9,12,25.0%,21m
39420,1,Zumbla,2265,36,2,5,7,28.6%,1h
39420,1,Flonsus,2265,84,2,6,8,25.0%,1h
39420,1,Geröllheimer,2265,0,2,7,9,22.2%,29m
39420,3,RAYNHART,2265,30,1,1,2,50.0%,55m
39420,2,[CZxX]DayRay,2265,0,1,1,2,50.0%,15m
39420,2,Martin,2265,97,1,1,2,50.0%,43m
39420,1,[D0N3]Rivera,2265,40,1,3,4,25.0%,51m
39420,2,buze,2265,0,0,1,1,0.0%,36m
39420,2,Josh,2265,0,0,1,1,0.0%,47m
39420,2,DrStalker,2265,0,0,1,1,0.0%,8m
39420,2,[MG974]ArionWind,2265,0,0,1,1,0.0%,40m
39420,1,Dwanadziesię,2265,0,0,3,3,0.0%,19m
39452,1,[НОД17]alex,2264,1784,164,151,315,52.1%,38m
39452,3,[lgdjn]ShadowMurloc,2264,1572,130,126,256,50.8%,15m
39452,3,Toere,2264,474,41,38,79,51.9%,27m
39452,1,Gilintro,2264,391,34,32,66,51.5%,47m
39452,1,[SD2014]Wolfi,2264,398,17,11,28,60.7%,1h
39452,1,Xxnoobslayer,2264,544,17,17,34,50.0%,1h
39452,2,[VéGaNo]Picono,2264,502,17,19,36,47.2%,4m
39452,1,Hagoromo,2264,341,12,15,27,44.4%,19m
39452,1,DaVince,2264,332,10,9,19,52.6%,11m
39452,3,Märk,2264,158,9,10,19,47.4%,33m
39452,2,CroNos,2264,270,9,14,23,39.1%,1h
39452,1,rubick,2264,144,5,9,14,35.7%,17m
39452,1,DeChardin,2264,206,5,13,18,27.8%,27m
39452,3,Exilius,2264,62,4,7,11,36.4%,24m
39452,1,Provodnik,2264,170,3,4,7,42.9%,1h
39452,3,Eddi,2264,116,3,7,10,30.0%,44m
39452,1,Neodym,2264,30,3,9,12,25.0%,1h
39452,1,[DioBr]IndShock,2264,40,2,2,4,50.0%,1h
39452,1,Greg,2264,40,2,2,4,50.0%,32m
39452,1,Daareek,2264,78,2,4,6,33.3%,36m
39452,2,InFlame,2264,88,1,2,3,33.3%,15m
39452,1,Tascobo,2264,97,1,2,3,33.3%,30m
39452,2,persraiskari,2264,0,0,1,1,0.0%,27m
39452,2,Pragamtic,2264,0,0,1,1,0.0%,27m
39452,2,Dendy,2264,0,0,1,1,0.0%,36m
39452,2,[Dytred]SayCheese,2264,0,0,5,5,0.0%,1h
39478,1,Warwar,2263,1620,133,135,268,49.6%,36m
39478,2,Deathjam,2263,1590,96,103,199,48.2%,35m
39478,1,DISPARITATAS,2263,1723,66,64,130,50.8%,11m
39478,3,Antiste,2263,650,56,63,119,47.1%,36m
39478,3,Drfinch,2263,638,39,41,80,48.8%,37m
39478,3,[xFDPx]JhnJhn,2263,699,38,45,83,45.8%,22m
39478,1,ctnvlad,2263,1076,36,32,68,52.9%,51m
39478,1,Zanpakuto,2263,689,21,21,42,50.0%,1h
39478,1,boogeyman,2263,630,20,20,40,50.0%,6m
39478,2,MasterChief,2263,528,19,18,37,51.4%,55m
39478,1,[KoyBee]fredfredberg,2263,513,15,16,31,48.4%,25m
39478,1,mufafa,2263,479,14,12,26,53.8%,37m
39478,1,Anikirt,2263,331,9,14,23,39.1%,38m
39478,1,jellybean,2263,176,8,4,12,66.7%,32m
39478,2,Mitko,2263,290,8,9,17,47.1%,30m
39478,1,MiniNija,2263,238,8,9,17,47.1%,1h
39478,2,bodopi,2263,222,8,14,22,36.4%,29m
39478,1,XOX,2263,190,5,8,13,38.5%,15m
39478,2,Besmir,2263,30,4,2,6,66.7%,37m
39478,1,FUSTIGADOR,2263,146,4,8,12,33.3%,23m
39478,2,McDruff,2263,108,3,1,4,75.0%,26m
39478,2,[AofK]goku,2263,108,3,1,4,75.0%,27m
39478,1,tararim,2263,0,3,3,6,50.0%,44m
39478,2,Gamer,2263,110,3,6,9,33.3%,19m
39478,1,ksk,2263,40,2,4,6,33.3%,38m
39478,1,[3q]Xbeatz,2263,76,2,7,9,22.2%,29m
39478,2,[M4M]Marius,2263,0,1,0,1,100.0%,18m
39478,2,FlynnTaggart,2263,0,1,0,1,100.0%,55m
39478,1,[II3II]SamSung,2263,0,1,1,2,50.0%,47m
39478,2,Maish,2263,0,1,4,5,20.0%,11m
39478,3,DAVIDrik,2263,40,1,7,8,12.5%,11m
39478,2,frosty,2263,0,0,1,1,0.0%,35m
39478,2,[Un00bz]Azyryx,2263,0,0,1,1,0.0%,1h
39478,2,SaysW,2263,0,0,1,1,0.0%,55m
39478,1,[lol234]Anton,2263,0,0,3,3,0.0%,44m
39513,1,[SeVenV]Tormozko,2262,722,21,22,43,48.8%,41m
39513,1,LeCerveau,2262,373,13,15,28,46.4%,26m
39513,2,Soren,2262,332,11,8,19,57.9%,29m
39513,3,Kira,2262,274,8,7,15,53.3%,23m
39513,2,zero,2262,180,6,3,9,66.7%,44m
39513,2,AnDroksus,2262,162,6,5,11,54.5%,35m
39513,3,Greh,2262,179,6,11,17,35.3%,51m
39513,1,YOUSHIiTNOOB,2262,196,5,7,12,41.7%,37m
39513,3,PanSnake,2262,191,5,11,16,31.2%,50m
39513,1,INSANE,2262,118,4,3,7,57.1%,43m
39513,2,Alex,2262,94,3,1,4,75.0%,52m
39513,3,Caedence,2262,95,2,6,8,25.0%,6m
39513,1,grifkoks,2262,48,2,7,9,22.2%,35m
39513,1,PoroshokUhod,2262,0,1,0,1,100.0%,8m
39513,2,Micci,2262,48,1,2,3,33.3%,36m
39513,1,Angolim,2262,97,1,3,4,25.0%,33m
39513,1,Troels,2262,40,1,4,5,20.0%,51m
39513,2,Hannibal,2262,0,1,5,6,16.7%,52m
39513,1,Closed,2262,0,0,3,3,0.0%,32m
39513,2,Kole,2262,0,0,5,5,0.0%,11m
39533,1,eaglebird,2261,1370,85,83,168,50.6%,18m
39533,1,BurryProtos,2261,1290,49,38,87,56.3%,1h
39533,1,CheGolle,2261,1116,49,43,92,53.3%,40m
39533,1,Pepper,2261,901,44,43,87,50.6%,13m
39533,1,Shamanking,2261,1101,36,42,78,46.2%,49m
39533,1,кокс,2261,798,30,27,57,52.6%,23m
39533,3,Julien,2261,722,25,35,60,41.7%,37m
39533,1,vitmak,2261,639,22,20,42,52.4%,17m
39533,1,Kulek,2261,581,21,23,44,47.7%,40m
39533,1,жека,2261,564,15,20,35,42.9%,13m
39533,1,neoflo,2261,352,14,9,23,60.9%,45m
39533,1,thug,2261,307,13,18,31,41.9%,30m
39533,1,WARRIOR,2261,343,11,6,17,64.7%,33m
39533,3,[PhoX]Robstaa,2261,162,9,11,20,45.0%,1h
39533,1,[NFA]Romby,2261,268,8,9,17,47.1%,22m
39533,2,CRiMiSoN,2261,142,5,2,7,71.4%,12m
39533,2,aloe,2261,0,4,1,5,80.0%,16m
39533,2,Roger,2261,166,4,4,8,50.0%,8m
39533,3,Miniandry,2261,58,4,9,13,30.8%,54m
39533,3,DarkShift,2261,60,3,9,12,25.0%,11m
39533,1,RGDRACOS,2261,82,2,8,10,20.0%,1h
39533,2,Chris,2261,32,1,1,2,50.0%,47m
39533,1,[1crt1]Mateo,2261,32,1,4,5,20.0%,28m
39533,1,orangeyunky,2261,0,1,5,6,16.7%,7m
39533,1,GORASH,2261,0,1,5,6,16.7%,1h
39533,2,Tyz,2261,0,0,1,1,0.0%,6m
39533,2,OpenAI,2261,0,0,1,1,0.0%,19m
39533,1,Champions,2261,0,0,2,2,0.0%,1h
39533,1,RomanKRSK,2261,0,0,3,3,0.0%,23m
39562,3,Forgo,2260,1539,62,64,126,49.2%,50m
39562,2,LuckySnail,2260,756,29,23,52,55.8%,5m
39562,1,Zoe,2260,462,16,25,41,39.0%,36m
39562,1,BranislavR,2260,528,15,21,36,41.7%,26m
39562,2,Dominic,2260,321,12,14,26,46.2%,36m
39562,3,[Z3R6TV]XeNoS,2260,136,6,12,18,33.3%,9m
39562,1,Nikos,2260,236,5,6,11,45.5%,27m
39562,1,Leizu,2260,145,5,13,18,27.8%,37m
39562,2,FENIX,2260,120,4,2,6,66.7%,15m
39562,1,LyrikM,2260,107,3,2,5,60.0%,1h
39562,1,Analog,2260,0,2,5,7,28.6%,36m
39562,2,CrazyDuck,2260,0,1,3,4,25.0%,37m
39562,2,марадор,2260,0,1,4,5,20.0%,10m
39562,1,Sympak,2260,48,1,5,6,16.7%,21m
39576,1,CrazyCat,2259,858,96,83,179,53.6%,45m
39576,2,Necrofero,2259,1056,41,36,77,53.2%,1h
39576,3,sanekvrn,2259,905,35,45,80,43.8%,37m
39576,1,darotrefl,2259,560,23,29,52,44.2%,11m
39576,1,Strategie,2259,622,18,17,35,51.4%,1h
39576,1,DannyBoi,2259,221,9,4,13,69.2%,1h
39576,1,[MynFre]Panzerbille,2259,240,6,8,14,42.9%,15m
39576,1,[nps]Shade,2259,237,5,5,10,50.0%,23m
39576,1,ProtosLomi,2259,180,5,6,11,45.5%,33m
39576,1,wurmiii,2259,173,4,3,7,57.1%,36m
39576,1,AexeL,2259,48,2,3,5,40.0%,32m
39576,2,cesarferlo,2259,30,2,4,6,33.3%,27m
39576,1,Blackout,2259,149,2,7,9,22.2%,1h
39576,3,kuikai,2259,0,2,7,9,22.2%,6m
39576,2,METZ,2259,0,1,0,1,100.0%,1h
39576,1,ArcyAdam,2259,73,1,3,4,25.0%,1h
39576,1,Kris,2259,42,1,5,6,16.7%,7m
39576,1,Profyali,2259,0,1,6,7,14.3%,22m
39576,2,roribreaker,2259,0,0,1,1,0.0%,11m
39576,2,Hanluk,2259,0,0,1,1,0.0%,54m
39576,2,алим,2259,0,0,1,1,0.0%,41m
39576,2,Vuk,2259,0,0,1,1,0.0%,11m
39576,2,ºFU,2259,0,0,1,1,0.0%,11m
39599,3,[OGCC]zorro,2258,1484,170,179,349,48.7%,7m
39599,3,PETSGOOD,2258,1149,124,126,250,49.6%,42m
39599,1,Shpanit,2258,1760,105,101,206,51.0%,38m
39599,1,Virtua,2258,923,73,73,146,50.0%,33m
39599,1,bogdan,2258,1675,60,69,129,46.5%,28m
39599,3,Jochem,2258,813,36,42,78,46.2%,36m
39599,1,Nefrit,2258,803,33,26,59,55.9%,49m
39599,1,Feomer,2258,475,16,11,27,59.3%,25m
39599,3,uurdmc,2258,462,15,27,42,35.7%,28m
39599,2,Sander,2258,360,14,4,18,77.8%,1h
39599,1,heyzuez,2258,344,13,18,31,41.9%,40m
39599,1,Пеликан,2258,412,12,15,27,44.4%,36m
39599,1,namalev,2258,292,7,12,19,36.8%,3m
39599,1,TheRedShadow,2258,188,5,5,10,50.0%,1h
39599,2,ItWasMel,2258,165,4,9,13,30.8%,41m
39599,1,[SРID]Серега,2258,82,3,4,7,42.9%,49m
39599,1,KarelAnker,2258,80,3,7,10,30.0%,40m
39599,1,Alystene,2258,36,2,2,4,50.0%,1h
39599,1,BlackBlood,2258,42,2,2,4,50.0%,39m
39599,1,Jerkki,2258,97,2,5,7,28.6%,12m
39599,3,eliminator,2258,0,2,7,9,22.2%,42m
39599,2,Ttt,2258,73,2,7,9,22.2%,51m
39599,2,Casilas,2258,0,2,7,9,22.2%,23m
39599,2,KuzyaTasher,2258,0,1,0,1,100.0%,27m
39599,2,alexbbn,2258,0,1,0,1,100.0%,29m
39599,2,KZZZ,2258,34,1,1,2,50.0%,29m
39599,2,Perfid,2258,0,1,1,2,50.0%,41m
39599,1,[Seek]NightFury,2258,95,1,2,3,33.3%,33m
39599,1,Lolli,2258,42,1,3,4,25.0%,17m
39599,2,PondSC,2258,0,1,4,5,20.0%,18m
39599,2,RinceWind,2258,0,1,5,6,16.7%,48m
39599,2,Boxonxo,2258,30,1,5,6,16.7%,52m
39599,1,shiftdel,2258,0,1,6,7,14.3%,26m
39599,3,Poiples,2258,0,0,1,1,0.0%,42m
39599,2,RedBrean,2258,0,0,1,1,0.0%,39m
39634,1,edu,2257,1753,174,172,346,50.3%,51m
39634,1,whatever,2257,1452,73,76,149,49.0%,32m
39634,1,Elladan,2257,1343,68,63,131,51.9%,19m
39634,1,[GgWp9]leo,2257,930,29,31,60,48.3%,1h
39634,1,Fox,2257,736,22,23,45,48.9%,49m
39634,1,[SCSM]ToolTime,2257,715,22,25,47,46.8%,41m
39634,1,Aberback,2257,518,16,24,40,40.0%,1h
39634,1,Tankir,2257,372,12,15,27,44.4%,28m
39634,2,Bison,2257,300,10,15,25,40.0%,47m
39634,1,DChocolate,2257,284,7,9,16,43.8%,34m
39634,1,Swearengen,2257,250,7,13,20,35.0%,18m
39634,3,DrAgOnFoRcE,2257,174,6,9,15,40.0%,15m
39634,1,GrumpyCat,2257,78,5,5,10,50.0%,1h
39634,2,Yankee,2257,94,4,3,7,57.1%,54m
39634,3,SapoArmado,2257,123,4,8,12,33.3%,49m
39634,2,[WoLA]Tiberius,2257,64,2,1,3,66.7%,11m
39634,2,Claustro,2257,138,2,5,7,28.6%,1h
39634,2,[B0NERS]DinkyBoy,2257,42,2,9,11,18.2%,15m
39634,1,Freddzie,2257,89,1,2,3,33.3%,27m
39634,2,Emckisch,2257,46,1,2,3,33.3%,34m
39634,2,Enot,2257,0,1,5,6,16.7%,38m
39634,2,ТврщСержант,2257,0,1,5,6,16.7%,1h
39656,2,MichMich,2256,1108,45,38,83,54.2%,56m
39656,1,TheBusDriver,2256,1023,43,44,87,49.4%,45m
39656,2,Supercoco,2256,894,37,30,67,55.2%,1h
39656,1,[VRIL]Ulanbator,2256,512,21,17,38,55.3%,41m
39656,1,Veroniiae,2256,412,14,9,23,60.9%,15m
39656,2,yuugen,2256,362,12,25,37,32.4%,13m
39656,2,oleg,2256,292,10,27,37,27.0%,49m
39656,2,Florencio,2256,147,3,3,6,50.0%,41m
39656,2,Aronmon,2256,34,2,0,2,100.0%,37m
39656,1,brunao,2256,90,2,6,8,25.0%,42m
39656,2,Teo,2256,0,1,0,1,100.0%,41m
39656,2,Snezhevika,2256,0,1,0,1,100.0%,54m
39656,2,[31337Ъ]albert,2256,0,1,1,2,50.0%,1h
39656,2,Bombey,2256,32,1,1,2,50.0%,46m
39656,1,ALEX,2256,0,1,1,2,50.0%,29m
39656,2,TRON,2256,0,1,4,5,20.0%,52m
39656,1,[NLTN]Wokram,2256,73,1,5,6,16.7%,38m
39656,1,Hirohito,2256,0,1,5,6,16.7%,22m
39656,2,onea,2256,0,0,5,5,0.0%,11m
39675,1,dmim,2255,1759,96,85,181,53.0%,1h
39675,1,portos,2255,820,29,28,57,50.9%,29m
39675,1,kofeinik,2255,965,29,37,66,43.9%,45m
39675,1,scriptacc,2255,646,23,23,46,50.0%,11m
39675,1,Nexus,2255,315,13,6,19,68.4%,30m
39675,1,bojan,2255,452,12,19,31,38.7%,53m
39675,1,Yoryix,2255,192,11,14,25,44.0%,15m
39675,1,[lBBTl]LeBon,2255,424,11,15,26,42.3%,22m
39675,1,TheRedKing,2255,316,9,13,22,40.9%,40m
39675,3,Flarezest,2255,228,8,11,19,42.1%,35m
39675,3,Tincanman,2255,243,7,12,19,36.8%,6m
39675,1,Призрак,2255,244,6,9,15,40.0%,28m
39675,2,eisenLIX,2255,120,4,1,5,80.0%,10m
39675,1,Noobforever,2255,146,4,13,17,23.5%,11m
39675,2,MrPointyToe,2255,0,3,2,5,60.0%,50m
39675,2,Дед,2255,34,2,0,2,100.0%,36m
39675,2,железрукава,2255,32,2,1,3,66.7%,1h
39675,1,Dumaghedon,2255,97,2,2,4,50.0%,30m
39675,2,Vitunahk,2255,97,2,5,7,28.6%,18m
39675,1,Levani,2255,48,2,7,9,22.2%,22m
39675,1,Kobod,2255,0,1,0,1,100.0%,50m
39675,2,DUMMSDEI,2255,97,1,5,6,16.7%,34m
39675,1,Tuncis,2255,0,1,5,6,16.7%,15m
39675,1,Дима,2255,0,0,1,1,0.0%,22m
39675,1,[PonyPS]MangoJuice,2255,0,0,2,2,0.0%,53m
39700,1,Vagamundo,2254,1316,42,48,90,46.7%,40m
39700,3,[PbtH]Angelus,2254,1026,34,47,81,42.0%,15m
39700,3,darkslayer,2254,775,32,36,68,47.1%,54m
39700,2,[DZRs]Tanox,2254,674,24,28,52,46.2%,46m
39700,1,iccctepika,2254,625,21,19,40,52.5%,39m
39700,1,maksimkla,2254,629,21,23,44,47.7%,1h
39700,1,Panda,2254,406,13,21,34,38.2%,13m
39700,2,[LGduDi]Artemis,2254,346,11,8,19,57.9%,44m
39700,3,Taleo,2254,318,10,21,31,32.3%,17m
39700,1,delovoy,2254,265,9,7,16,56.2%,40m
39700,2,Zaglik,2254,275,9,13,22,40.9%,49m
39700,1,valhalla,2254,290,7,13,20,35.0%,1h
39700,1,TaDesLok,2254,272,7,13,20,35.0%,13m
39700,1,Ermac,2254,162,6,8,14,42.9%,33m
39700,1,calibru,2254,128,3,8,11,27.3%,32m
39700,1,Sallo,2254,86,2,5,7,28.6%,22m
39700,2,Splinterjack,2254,0,2,7,9,22.2%,1h
39700,1,[80s]Inestier,2254,0,1,0,1,100.0%,8m
39700,2,[LEpur]lowemax,2254,0,0,1,1,0.0%,11m
39700,1,Danilja,2254,0,0,4,4,0.0%,8m
39720,1,Berserkier,2253,1763,312,324,636,49.1%,35m
39720,1,Dyønizøs,2253,1739,131,132,263,49.8%,1h
39720,2,Panasonic,2253,760,90,106,196,45.9%,50m
39720,1,Kimo,2253,1667,77,79,156,49.4%,35m
39720,1,zet,2253,1174,38,39,77,49.4%,8m
39720,1,[DL2006]Tonytag,2253,541,22,15,37,59.5%,51m
39720,1,Mellon,2253,542,22,21,43,51.2%,35m
39720,1,crazysheep,2253,307,20,22,42,47.6%,47m
39720,1,Dimandin,2253,710,20,26,46,43.5%,15m
39720,1,Kupixer,2253,594,19,19,38,50.0%,1h
39720,1,Wazza,2253,328,11,7,18,61.1%,53m
39720,1,DiKei,2253,275,10,7,17,58.8%,20m
39720,3,lukasesok,2253,178,8,16,24,33.3%,20m
39720,1,Laxsy,2253,257,8,16,24,33.3%,15m
39720,1,ZecheTop,2253,126,4,4,8,50.0%,1h
39720,1,irasstar,2253,42,4,4,8,50.0%,23m
39720,1,CREATOR,2253,160,4,6,10,40.0%,17m
39720,1,Ayman,2253,193,4,8,12,33.3%,40m
39720,1,[BRSRK]turteI,2253,120,4,8,12,33.3%,51m
39720,1,Irukanji,2253,76,3,6,9,33.3%,20m
39720,2,Seter,2253,34,2,0,2,100.0%,1h
39720,2,Rosset,2253,30,2,0,2,100.0%,55m
39720,1,Porcupine,2253,48,2,6,8,25.0%,27m
39720,3,[BNCREW]Luster,2253,0,2,8,10,20.0%,7m
39720,2,капрал,2253,0,1,0,1,100.0%,13m
39720,3,Ravenacek,2253,0,1,0,1,100.0%,54m
39720,2,Zbignieff,2253,97,1,4,5,20.0%,1h
39720,2,Pulsar,2253,0,1,5,6,16.7%,20m
39720,2,DanZZya,2253,0,0,1,1,0.0%,6m
39749,1,Marco,2252,1741,144,157,301,47.8%,36m
39749,1,DoboJR,2252,1496,110,109,219,50.2%,31m
39749,1,[BrassZ]Tyra,2252,1231,57,53,110,51.8%,13m
39749,1,[Jail]Rasengan,2252,842,25,30,55,45.5%,47m
39749,1,[Ирбис]Нездешний,2252,663,24,19,43,55.8%,33m
39749,1,[EMCs]TomTom,2252,684,22,19,41,53.7%,40m
39749,1,Vennies,2252,422,15,21,36,41.7%,1h
39749,2,husky,2252,326,14,12,26,53.8%,42m
39749,3,TroMpok,2252,305,12,17,29,41.4%,35m
39749,1,Дмитрий,2252,340,10,10,20,50.0%,11m
39749,1,Dakku,2252,338,10,12,22,45.5%,38m
39749,1,vuko,2252,120,4,8,12,33.3%,47m
39749,3,Darderion,2252,60,3,10,13,23.1%,41m
39749,1,FireBluXiZ,2252,44,2,6,8,25.0%,30m
39749,1,[Mirko]krillaz,2252,147,2,8,10,20.0%,52m
39749,1,DvjBazuka,2252,40,1,3,4,25.0%,13m
39749,1,ScopCony,2252,0,1,5,6,16.7%,1h
39749,2,Ixill,2252,0,0,1,1,0.0%,8m
39749,1,warrior,2252,0,0,1,1,0.0%,30m
39749,2,Galad,2252,0,0,1,1,0.0%,15m
39749,2,Felix,2252,0,0,1,1,0.0%,41m
39749,1,Anakin,2252,0,0,3,3,0.0%,1h
39771,1,[инж]UniQx,2251,1219,106,106,212,50.0%,1h
39771,3,DRW,2251,1488,74,83,157,47.1%,28m
39771,1,[LPZFR]Ban,2251,1336,56,56,112,50.0%,33m
39771,1,Hero,2251,911,34,32,66,51.5%,1h
39771,3,[фыва]Роскомнадзор,2251,722,30,26,56,53.6%,1h
39771,1,ketjow,2251,770,24,25,49,49.0%,25m
39771,1,MANOWAR,2251,738,20,28,48,41.7%,33m
39771,1,luchyk,2251,643,19,23,42,45.2%,32m
39771,2,Vibo,2251,436,16,12,28,57.1%,7m
39771,2,Dehomag,2251,384,14,12,26,53.8%,12m
39771,1,[RRQ]DaveO,2251,332,13,14,27,48.1%,25m
39771,1,TheStormRage,2251,360,11,12,23,47.8%,50m
39771,2,KaloyanNikov,2251,280,10,7,17,58.8%,1h
39771,1,Bajinx,2251,330,10,15,25,40.0%,19m
39771,1,woj,2251,303,8,8,16,50.0%,35m
39771,1,Richi,2251,181,5,7,12,41.7%,1h
39771,2,Coundo,2251,0,1,0,1,100.0%,11m
39771,3,lebron,2251,0,1,3,4,25.0%,36m
39771,1,Jirossil,2251,0,1,7,8,12.5%,38m
39771,1,RTC,2251,0,0,2,2,0.0%,25m
39771,1,MARATILIUS,2251,0,0,2,2,0.0%,1h
39771,1,EGBlood,2251,0,0,3,3,0.0%,22m
39771,1,juan,2251,0,0,3,3,0.0%,28m
39794,3,guiosteo,2250,1482,90,86,176,51.1%,22m
39794,1,circ,2250,1443,73,78,151,48.3%,1h
39794,2,Gochuani,2250,640,34,35,69,49.3%,45m
39794,2,mrPro,2250,772,30,24,54,55.6%,20m
39794,1,Topler,2250,768,30,29,59,50.8%,43m
39794,3,SkyWalker,2250,550,22,22,44,50.0%,29m
39794,1,Vertrag,2250,522,16,13,29,55.2%,36m
39794,2,[Tassar]Aeternant,2250,312,12,6,18,66.7%,29m
39794,2,ДжеймсБолт,2250,272,10,5,15,66.7%,43m
39794,1,darckmilo,2250,142,6,9,15,40.0%,33m
39794,2,Mattagon,2250,160,5,1,6,83.3%,8m
39794,1,Diniskoff,2250,200,5,5,10,50.0%,13m
39794,1,SCReg,2250,198,5,9,14,35.7%,7m
39794,1,Ultimatule,2250,137,4,2,6,66.7%,33m
39794,1,[ЕМPIRE]Виктор,2250,156,4,3,7,57.1%,43m
39794,1,[Пиупиу]PavloGame,2250,166,4,7,11,36.4%,43m
39794,2,[JediK]Chewbacca,2250,48,3,4,7,42.9%,28m
39794,1,Weretrang,2250,126,3,6,9,33.3%,32m
39794,1,coolmaster,2250,84,3,7,10,30.0%,33m
39794,1,Maqe,2250,122,3,8,11,27.3%,53m
39794,1,Agriotes,2250,0,1,0,1,100.0%,23m
39794,2,[Kandis]Necrophagia,2250,0,1,0,1,100.0%,44m
39794,2,Блицкриг,2250,0,1,0,1,100.0%,39m
39794,2,VapeL,2250,0,1,0,1,100.0%,41m
39794,2,sanandi,2250,32,1,2,3,33.3%,51m
39794,2,Liam,2250,0,1,5,6,16.7%,15m
39794,1,[TSC69]Comrade,2250,44,1,7,8,12.5%,1h
39794,2,KonKing,2250,0,0,1,1,0.0%,14m
39794,3,Angeleus,2250,0,0,1,1,0.0%,36m
39794,1,Zilo,2250,0,0,2,2,0.0%,1h
39794,1,ProtosAdy,2250,0,0,2,2,0.0%,13m
39825,2,UnLegiT,2249,1122,43,35,78,55.1%,18m
39825,1,Eduviteri,2249,766,28,43,71,39.4%,1h
39825,1,OLEGWINGER,2249,876,26,29,55,47.3%,51m
39825,1,[VeTaCa]Fiunigorf,2249,507,26,33,59,44.1%,5m
39825,1,GITSL,2249,244,21,18,39,53.8%,40m
39825,1,[TFSC]LittleCaZo,2249,455,15,10,25,60.0%,37m
39825,2,GeorgeCZHK,2249,400,13,14,27,48.1%,52m
39825,3,lihoy,2249,279,12,13,25,48.0%,22m
39825,1,Покемон,2249,317,12,17,29,41.4%,1h
39825,1,АзогСеквар,2249,450,12,19,31,38.7%,32m
39825,2,WeIRd,2249,268,11,15,26,42.3%,3m
39825,2,[JÖREG]HagMag,2249,307,9,10,19,47.4%,25m
39825,1,Raveheart,2249,143,8,6,14,57.1%,49m
39825,1,indexlife,2249,204,6,4,10,60.0%,1h
39825,1,Ovenit,2249,141,6,4,10,60.0%,31m
39825,1,Draxies,2249,135,4,2,6,66.7%,1h
39825,2,[mfixed]Glebur,2249,122,4,2,6,66.7%,36m
39825,3,[SHSX]noxiousone,2249,121,3,6,9,33.3%,11m
39825,1,[NoPC]Demiurge,2249,96,2,1,3,66.7%,46m
39825,1,Anorak,2249,106,2,3,5,40.0%,17m
39825,1,kedibasi,2249,0,2,4,6,33.3%,39m
39825,2,[ImbaTm]Tiamat,2249,112,2,5,7,28.6%,20m
39825,1,Grande,2249,82,2,10,12,16.7%,41m
39825,1,Nezorf,2249,0,1,1,2,50.0%,14m
39825,1,DRDMAN,2249,48,1,2,3,33.3%,22m
39825,1,Boogieman,2249,0,1,2,3,33.3%,22m
39825,2,root,2249,97,1,5,6,16.7%,37m
39825,2,[AciNoN]Terramikys,2249,0,0,1,1,0.0%,1h
39825,1,Centurion,2249,0,0,1,1,0.0%,5m
39825,1,Mordka,2249,73,0,3,3,0.0%,1h
39855,3,SvantE,2248,1171,94,93,187,50.3%,5m
39855,1,minibhatta,2248,1588,84,81,165,50.9%,38m
39855,1,max,2248,480,21,23,44,47.7%,40m
39855,1,Elex,2248,486,20,12,32,62.5%,22m
39855,1,TERMINATOR,2248,533,18,17,35,51.4%,31m
39855,1,LordofPain,2248,445,16,14,30,53.3%,8m
39855,1,kwe,2248,460,12,12,24,50.0%,8m
39855,1,Jordan,2248,226,6,5,11,54.5%,44m
39855,1,Goodman,2248,178,6,7,13,46.2%,52m
39855,1,DiVladi,2248,236,6,11,17,35.3%,35m
39855,1,efkeney,2248,167,4,8,12,33.3%,47m
39855,1,[USDǂ]ChickHunter,2248,121,3,7,10,30.0%,21m
39855,1,Barmaglot,2248,90,2,1,3,66.7%,11m
39855,1,Zabpehely,2248,117,2,6,8,25.0%,32m
39855,1,DunkTruckk,2248,42,2,6,8,25.0%,27m
39855,2,Лавилас,2248,32,1,1,2,50.0%,32m
39855,2,FoXiK,2248,0,1,5,6,16.7%,48m
39872,1,Marcus,2247,1570,319,337,656,48.6%,46m
39872,1,EnolaGrey,2247,1763,177,177,354,50.0%,40m
39872,2,AlexKMR,2247,1344,97,87,184,52.7%,56m
39872,2,TpasUnKdo,2247,1213,73,76,149,49.0%,54m
39872,1,Ivan,2247,1672,65,66,131,49.6%,23m
39872,3,Cptfailflop,2247,794,29,36,65,44.6%,23m
39872,1,pinniwini,2247,760,27,25,52,51.9%,29m
39872,1,kolia,2247,847,27,31,58,46.6%,1h
39872,1,Turinqui,2247,536,18,24,42,42.9%,8m
39872,3,Track,2247,483,18,25,43,41.9%,43m
39872,3,[TSC2C]Osoko,2247,468,17,32,49,34.7%,50m
39872,1,[GGOSC]ALARM,2247,534,15,22,37,40.5%,36m
39872,2,Archer,2247,389,13,13,26,50.0%,47m
39872,1,Ernek,2247,317,11,12,23,47.8%,39m
39872,3,Din,2247,245,8,14,22,36.4%,1h
39872,1,UMos,2247,222,6,10,16,37.5%,43m
39872,3,peterminus,2247,0,5,9,14,35.7%,21m
39872,1,[Хакеры]Ушкуйник,2247,97,4,2,6,66.7%,29m
39872,2,Alecots,2247,46,3,2,5,60.0%,9m
39872,3,mkpseregarus,2247,0,3,9,12,25.0%,1h
39872,1,[NSJLM]Steez,2247,40,2,4,6,33.3%,25m
39872,2,Salavat,2247,30,1,1,2,50.0%,45m
39872,2,cOZo,2247,0,1,4,5,20.0%,55m
39872,2,[zBB]zCaptaiin,2247,0,1,5,6,16.7%,55m
39872,3,Nightrider,2247,0,1,6,7,14.3%,1h
39872,3,Melorka,2247,0,0,1,1,0.0%,46m
39872,2,Boo,2247,0,0,1,1,0.0%,51m
39899,1,nukenuke,2246,827,71,75,146,48.6%,27m
39899,3,Turan,2246,709,42,36,78,53.8%,19m
39899,3,Cyprine,2246,389,14,25,39,35.9%,42m
39899,1,Catkats,2246,282,13,10,23,56.5%,45m
39899,1,МирнаяУтка,2246,298,10,9,19,52.6%,41m
39899,3,cookiedough,2246,269,10,10,20,50.0%,26m
39899,1,Rodzynek,2246,294,10,13,23,43.5%,33m
39899,1,[scarab]SadlyLacking,2246,268,7,13,20,35.0%,27m
39899,2,invokion,2246,96,6,1,7,85.7%,14m
39899,2,effeM,2246,203,6,2,8,75.0%,1h
39899,1,LeathaL,2246,254,6,10,16,37.5%,51m
39899,1,[КПлан]Jesus,2246,228,5,7,12,41.7%,40m
39899,1,Lichi,2246,192,5,9,14,35.7%,1h
39899,3,[Varose]Shanelight,2246,147,4,9,13,30.8%,1h
39899,1,XXXXXXXXXXX,2246,145,3,2,5,60.0%,30m
39899,2,clasicr,2246,34,2,1,3,66.7%,51m
39899,2,дима,2246,58,2,1,3,66.7%,10m
39899,2,good,2246,0,2,3,5,40.0%,43m
39899,2,Marauder,2246,0,2,3,5,40.0%,54m
39899,2,Tomi,2246,0,2,3,5,40.0%,10m
39899,2,КоТэНаРкОтЭ,2246,0,1,1,2,50.0%,1h
39899,1,Boiar,2246,0,1,5,6,16.7%,40m
39899,2,MajorAndy,2246,0,0,1,1,0.0%,15m
39922,3,Garry,2245,1534,118,109,227,52.0%,11m
39922,3,Bcek,2245,818,34,35,69,49.3%,1h
39922,3,Ottokristus,2245,550,20,27,47,42.6%,54m
39922,1,Hastur,2245,369,13,14,27,48.1%,45m
39922,1,diegozama,2245,320,11,13,24,45.8%,43m
39922,1,ROUGHNECKS,2245,352,10,13,23,43.5%,20m
39922,2,SirOnenaGro,2245,223,6,10,16,37.5%,1h
39922,1,[БУБУБ]ЗЛАЯфотонка,2245,40,4,3,7,57.1%,38m
39922,1,Drakonit,2245,156,4,7,11,36.4%,5m
39922,1,[TPONCH]krooz,2245,166,4,8,12,33.3%,42m
39922,3,Ooops,2245,60,4,10,14,28.6%,26m
39922,1,Armenius,2245,78,3,7,10,30.0%,20m
39922,2,[IFNY]Bournasman,2245,60,2,1,3,66.7%,34m
39922,1,TakiLucky,2245,97,2,4,6,33.3%,36m
39922,2,NiczooF,2245,0,1,0,1,100.0%,20m
39922,2,IDAssasin,2245,0,1,2,3,33.3%,56m
39922,2,Valex,2245,30,1,2,3,33.3%,1h
39922,2,Streeke,2245,0,1,5,6,16.7%,48m
39922,2,SneakySnek,2245,0,0,1,1,0.0%,1h
39922,1,Zacken,2245,0,0,2,2,0.0%,52m
39942,3,Kylar,2244,1408,68,76,144,47.2%,35m
39942,1,devastatore,2244,1050,35,36,71,49.3%,6m
39942,1,wegeve,2244,698,27,32,59,45.8%,13m
39942,1,Siso,2244,581,19,28,47,40.4%,30m
39942,2,jefe,2244,538,18,16,34,52.9%,18m
39942,3,SasaTANG,2244,441,16,20,36,44.4%,7m
39942,1,Slash,2244,437,14,16,30,46.7%,50m
39942,1,Lycian,2244,361,13,14,27,48.1%,1h
39942,1,Pilou,2244,341,13,16,29,44.8%,53m
39942,3,indartzu,2244,282,12,16,28,42.9%,24m
39942,1,Manu,2244,248,10,16,26,38.5%,5m
39942,2,fedd,2244,303,9,8,17,52.9%,1h
39942,1,totrik,2244,314,8,11,19,42.1%,38m
39942,3,igor,2244,243,7,14,21,33.3%,46m
39942,2,LeytLan,2244,124,6,5,11,54.5%,39m
39942,1,jefemax,2244,196,6,7,13,46.2%,49m
39942,1,Reddevil,2244,206,4,5,9,44.4%,26m
39942,2,IlIlIlI,2244,0,3,2,5,60.0%,48m
39942,2,KosMos,2244,180,3,6,9,33.3%,29m
39942,1,Jakes,2244,145,2,1,3,66.7%,43m
39942,1,sergeiminsky,2244,42,2,2,4,50.0%,37m
39942,1,Ragmash,2244,48,2,3,5,40.0%,28m
39942,2,JERZY,2244,0,2,7,9,22.2%,46m
39942,2,Phoenix,2244,0,1,0,1,100.0%,23m
39942,2,flashcraft,2244,32,1,1,2,50.0%,54m
39942,2,[nWss]nlwittenl,2244,0,1,4,5,20.0%,27m
39942,2,Rognek,2244,0,1,4,5,20.0%,41m
39942,2,Seth,2244,0,1,4,5,20.0%,52m
39942,1,VLAD,2244,0,1,5,6,16.7%,51m
39942,1,meow,2244,0,1,5,6,16.7%,33m
39942,1,Maelito,2244,42,1,6,7,14.3%,1h
39942,1,MTC,2244,0,0,1,1,0.0%,37m
39942,2,[KECHU]SouL,2244,0,0,2,2,0.0%,52m
39975,2,Luca,2243,1254,50,45,95,52.6%,27m
39975,2,[tchü]keny,2243,988,39,36,75,52.0%,7m
39975,2,[fubb]angiant,2243,562,22,16,38,57.9%,6m
39975,1,ILOoOLI,2243,619,22,20,42,52.4%,33m
39975,1,Saloka,2243,430,19,17,36,52.8%,51m
39975,1,Gaddar,2243,541,19,31,50,38.0%,24m
39975,1,Skatman,2243,472,15,17,32,46.9%,40m
39975,1,[Adlscø]nerukan,2243,514,15,22,37,40.5%,28m
39975,2,Jetflie,2243,434,14,16,30,46.7%,44m
39975,1,Buelo,2243,430,13,19,32,40.6%,38m
39975,2,MMH,2243,202,7,4,11,63.6%,41m
39975,2,StormBringer,2243,213,7,5,12,58.3%,44m
39975,1,Torgor,2243,226,7,6,13,53.8%,40m
39975,1,mita,2243,204,7,7,14,50.0%,1h
39975,3,[Funke1]KEFOU,2243,189,6,2,8,75.0%,29m
39975,1,[SaZ]MaXiMus,2243,157,5,0,5,100.0%,28m
39975,2,Jolenemo,2243,118,5,2,7,71.4%,35m
39975,1,DOGGYSLEAZE,2243,160,5,7,12,41.7%,13m
39975,1,UDB,2243,160,5,11,16,31.2%,1h
39975,3,paithan,2243,168,4,4,8,50.0%,1h
39975,1,Kindred,2243,140,4,8,12,33.3%,18m
39975,1,jonted,2243,131,3,3,6,50.0%,56m
39975,1,TheGhost,2243,68,3,4,7,42.9%,1h
39975,1,KOKOKUN,2243,160,3,15,18,16.7%,8m
39975,2,MaxxeN,2243,32,2,2,4,50.0%,51m
39975,2,DarovskikhYY,2243,0,1,0,1,100.0%,20m
39975,1,Аскер,2243,0,1,1,2,50.0%,51m
39975,2,Tim,2243,0,1,1,2,50.0%,1h
39975,2,Gobbo,2243,30,1,1,2,50.0%,32m
39975,3,Wenk,2243,0,1,2,3,33.3%,7m
39975,2,BROJAGA,2243,0,1,5,6,16.7%,27m
39975,1,scOC,2243,0,1,7,8,12.5%,34m
39975,2,Tronblon,2243,0,0,1,1,0.0%,4m
40008,3,Zongoku,2242,1504,86,90,176,48.9%,15m
40008,3,пук,2242,666,72,61,133,54.1%,11m
40008,1,Dimasia,2242,350,17,7,24,70.8%,28m
40008,1,RaketenBär,2242,477,15,13,28,53.6%,15m
40008,1,[ESW]champ,2242,488,15,15,30,50.0%,1h
40008,2,Siuldar,2242,276,10,8,18,55.6%,1h
40008,2,BronzeHero,2242,271,9,8,17,52.9%,43m
40008,3,Golgeyele,2242,224,7,14,21,33.3%,10m
40008,2,Synx,2242,94,6,14,20,30.0%,19m
40008,1,BreakPunk,2242,0,3,3,6,50.0%,11m
40008,2,Alta,2242,68,3,5,8,37.5%,37m
40008,3,voidage,2242,0,3,5,8,37.5%,50m
40008,1,[RBP3]Connor,2242,68,2,3,5,40.0%,11m
40008,1,Zelektt,2242,97,2,5,7,28.6%,33m
40008,2,Wortelex,2242,0,1,1,2,50.0%,36m
40008,2,Kvazard,2242,0,1,1,2,50.0%,36m
40008,2,[MEKU]фанатик,2242,30,1,1,2,50.0%,38m
40008,1,alex,2242,0,1,3,4,25.0%,55m
40008,2,promajk,2242,30,1,4,5,20.0%,10m
40008,1,LiquidSLO,2242,40,1,5,6,16.7%,22m
40008,2,Straik,2242,0,0,1,1,0.0%,36m
40008,2,KAPATEJl,2242,0,0,1,1,0.0%,8m
40008,2,lifeline,2242,0,0,1,1,0.0%,48m
40008,1,matreshka,2242,0,0,5,5,0.0%,17m
40032,3,Angel,2241,1481,144,156,300,48.0%,1h
40032,1,langenpg,2241,1291,112,117,229,48.9%,1h
40032,1,vrivsem,2241,1096,52,60,112,46.4%,1h
40032,1,Overdose,2241,1367,45,45,90,50.0%,33m
40032,1,Shoggy,2241,792,33,34,67,49.3%,11m
40032,1,[JxN]Klohorst,2241,624,24,24,48,50.0%,1h
40032,2,FatalError,2241,280,10,8,18,55.6%,25m
40032,3,[CeGeTe]UnKnown,2241,241,8,12,20,40.0%,11m
40032,2,webiss,2241,140,6,1,7,85.7%,21m
40032,1,TumanZ,2241,183,6,9,15,40.0%,38m
40032,2,Fourninator,2241,171,6,10,16,37.5%,45m
40032,2,КусьКиска,2241,122,5,3,8,62.5%,47m
40032,1,Runk,2241,173,5,3,8,62.5%,36m
40032,2,[0MGz]pandocha,2241,60,3,0,3,100.0%,44m
40032,3,Nox,2241,115,3,7,10,30.0%,54m
40032,1,NickNaylor,2241,70,2,4,6,33.3%,54m
40032,1,[Mavis]HellerCS,2241,66,2,5,7,28.6%,47m
40032,2,IIIIIIIIII,2241,0,1,0,1,100.0%,29m
40032,2,Slendir,2241,0,0,1,1,0.0%,1h
40032,2,smoker,2241,0,0,1,1,0.0%,20m
40032,1,Pancras,2241,0,0,4,4,0.0%,40m
40053,1,[mfxed]WitchHammer,2240,1268,73,73,146,50.0%,13m
40053,1,deligan,2240,908,30,32,62,48.4%,7m
40053,1,Вася,2240,924,29,39,68,42.6%,22m
40053,1,zhakey,2240,518,26,29,55,47.3%,11m
40053,1,Mineyer,2240,610,25,19,44,56.8%,7m
40053,1,meoiel,2240,670,19,23,42,45.2%,7m
40053,2,ErtHalf,2240,372,14,12,26,53.8%,54m
40053,2,TheGammie,2240,162,7,9,16,43.8%,54m
40053,2,Spolonic,2240,30,2,4,6,33.3%,43m
40053,2,RavenImp,2240,36,1,2,3,33.3%,17m
40053,2,[KrankS]Schranky,2240,0,1,4,5,20.0%,42m
40053,1,Fejuu,2240,38,1,6,7,14.3%,19m
40053,2,ЛакиРайдар,2240,0,0,1,1,0.0%,32m
40066,1,HarDcore,2239,725,29,18,47,61.7%,28m
40066,2,omTTTom,2239,608,21,20,41,51.2%,9m
40066,1,PrIz,2239,371,17,8,25,68.0%,11m
40066,3,Usiak,2239,275,12,12,24,50.0%,21m
40066,1,Orhum,2239,277,10,12,22,45.5%,41m
40066,1,ChundaJunka,2239,236,9,4,13,69.2%,40m
40066,2,[NWGD]GAx,2239,277,9,12,21,42.9%,11m
40066,1,SirOboldui,2239,268,8,6,14,57.1%,15m
40066,3,NotHadrien,2239,223,8,13,21,38.1%,56m
40066,1,Dargarin,2239,286,8,14,22,36.4%,32m
40066,1,dimka,2239,227,7,16,23,30.4%,1h
40066,1,amandy,2239,123,4,2,6,66.7%,13m
40066,2,JoksuPoksu,2239,166,4,9,13,30.8%,37m
40066,1,Skys,2239,148,4,10,14,28.6%,35m
40066,2,[KaaTri]Valeyellow,2239,62,3,1,4,75.0%,54m
40066,2,GARETH,2239,0,3,4,7,42.9%,5m
40066,1,BlackTornado,2239,140,3,7,10,30.0%,21m
40066,3,Raphael,2239,27,2,4,6,33.3%,34m
40066,1,NikosSky,2239,0,1,0,1,100.0%,24m
40066,2,[TdFd]strondo,2239,0,1,1,2,50.0%,51m
40066,1,nicolas,2239,42,1,3,4,25.0%,46m
40066,1,davidease,2239,0,1,6,7,14.3%,41m
40066,1,[BVInf]HardingGrimm,2239,0,0,2,2,0.0%,24m
40066,2,MimiMajster,2239,0,0,2,2,0.0%,18m
40090,1,Link,2238,1704,231,230,461,50.1%,22m
40090,1,GamBiT,2238,1766,138,144,282,48.9%,45m
40090,1,Voislav,2238,1558,88,79,167,52.7%,32m
40090,3,[TLGNL]architetTHOR,2238,523,88,90,178,49.4%,12m
40090,1,Gargamel,2238,885,76,71,147,51.7%,35m
40090,1,nowas,2238,532,27,28,55,49.1%,46m
40090,2,Feodor,2238,689,25,26,51,49.0%,37m
40090,1,Moench,2238,572,17,20,37,45.9%,33m
40090,2,[SKYBRS]Ianofc,2238,228,7,5,12,58.3%,37m
40090,1,Kismiska,2238,272,7,10,17,41.2%,7m
40090,1,SleepyBoar,2238,181,5,2,7,71.4%,35m
40090,2,Babayaga,2238,60,5,3,8,62.5%,41m
40090,1,Marlendsky,2238,174,5,6,11,45.5%,31m
40090,3,[WDYA]Roblix,2238,90,5,11,16,31.2%,54m
40090,2,dyango,2238,118,4,2,6,66.7%,41m
40090,1,Phoenix,2238,48,2,1,3,66.7%,32m
40090,2,[VSTEAM]Val,2238,60,2,2,4,50.0%,15m
40090,1,AngryJelly,2238,40,2,3,5,40.0%,28m
40090,2,mirnik,2238,58,2,3,5,40.0%,56m
40090,1,deathstar,2238,48,2,5,7,28.6%,27m
40090,1,tops,2238,48,2,8,10,20.0%,9m
40090,1,Vilgro,2238,0,1,1,2,50.0%,32m
40090,2,mosu,2238,0,1,5,6,16.7%,48m
40090,1,Ognian,2238,0,1,5,6,16.7%,33m
40090,2,Ragnar,2238,0,0,1,1,0.0%,40m
40090,2,[scMAUI]Jayden,2238,0,0,2,2,0.0%,53m
40090,1,ThatTommyM,2238,0,0,3,3,0.0%,17m
40117,3,[R4Time]Zeratul,2237,1512,282,286,568,49.6%,22m
40117,1,OnurD,2237,1651,182,180,362,50.3%,1h
40117,1,DjP,2237,1708,166,165,331,50.2%,22m
40117,3,[OPA]why,2237,1513,142,139,281,50.5%,26m
40117,1,bananaboi,2237,1489,106,84,190,55.8%,43m
40117,1,[RBP3]NonStopçho,2237,1516,78,62,140,55.7%,39m
40117,1,[N1NJ4Z]Patilan,2237,966,31,38,69,44.9%,43m
40117,1,[4orce]Arcanum,2237,812,26,29,55,47.3%,18m
40117,2,Velund,2237,516,18,22,40,45.0%,47m
40117,1,[Тимон]Legeon,2237,548,16,21,37,43.2%,1h
40117,2,Djomla,2237,309,10,16,26,38.5%,21m
40117,2,[SPAINs]JaMa,2237,228,9,12,21,42.9%,14m
40117,1,Alvvaru,2237,278,9,15,24,37.5%,13m
40117,2,Mafiakiller,2237,212,8,6,14,57.1%,50m
40117,3,Kłapouchy,2237,30,5,3,8,62.5%,18m
40117,2,[Croqus]Rastacoolo,2237,190,5,8,13,38.5%,39m
40117,1,master,2237,97,4,4,8,50.0%,13m
40117,2,vita,2237,30,2,2,4,50.0%,11m
40117,2,MauZZeR,2237,0,2,3,5,40.0%,1h
40117,2,Pafestivo,2237,30,1,1,2,50.0%,32m
40117,1,OssOne,2237,97,1,2,3,33.3%,28m
40117,2,[STRIP2]EDK,2237,0,1,4,5,20.0%,37m
40117,2,Kai,2237,0,1,5,6,16.7%,29m
40117,2,Arishwen,2237,0,1,5,6,16.7%,48m
40117,1,Longer,2237,38,1,5,6,16.7%,28m
40117,2,Chiru,2237,0,0,1,1,0.0%,21m
40117,2,sniperbite,2237,0,0,1,1,0.0%,1h
40117,2,DmitriiDonsk,2237,0,0,1,1,0.0%,7m
40145,3,Balon,2236,1585,236,250,486,48.6%,9m
40145,1,Luthor,2236,1768,172,166,338,50.9%,11m
40145,3,Knubbsälen,2236,760,81,83,164,49.4%,15m
40145,3,Eniac,2236,1530,77,87,164,47.0%,1h
40145,2,WhiteEagle,2236,1186,46,37,83,55.4%,46m
40145,2,Maeglin,2236,832,34,32,66,51.5%,1h
40145,1,Kratos,2236,872,29,27,56,51.8%,1h
40145,1,Double,2236,690,25,29,54,46.3%,35m
40145,1,WaRMiKSer,2236,826,25,31,56,44.6%,9m
40145,1,AbaMester,2236,336,11,10,21,52.4%,53m
40145,1,PRocc,2236,267,10,16,26,38.5%,28m
40145,1,[Perita]DonRuy,2236,227,6,6,12,50.0%,20m
40145,3,[PаK]Terran,2236,173,5,4,9,55.6%,22m
40145,2,jannik,2236,58,4,9,13,30.8%,45m
40145,1,Satanas,2236,145,3,3,6,50.0%,13m
40145,3,UggOR,2236,122,3,5,8,37.5%,47m
40145,2,Megyminimba,2236,66,2,1,3,66.7%,55m
40145,1,AnDrEy,2236,0,2,5,7,28.6%,24m
40145,2,DrakBlekSK,2236,34,1,2,3,33.3%,1h
40145,1,LegendTR,2236,90,1,3,4,25.0%,49m
40145,2,[LMBD]joss,2236,0,1,4,5,20.0%,17m
40145,1,Боня,2236,0,1,6,7,14.3%,18m
40145,2,sugus,2236,0,0,1,1,0.0%,54m
40145,2,SHIFT,2236,0,0,1,1,0.0%,32m
40169,1,Barbouzz,2235,919,105,100,205,51.2%,9m
40169,1,Babashkin,2235,1536,71,70,141,50.4%,43m
40169,1,LenovoIL,2235,787,32,29,61,52.5%,39m
40169,1,Alex,2235,720,25,22,47,53.2%,30m
40169,3,[UNPE]Kcrook,2235,651,25,34,59,42.4%,22m
40169,2,topmichael,2235,598,24,16,40,60.0%,13m
40169,2,[SeVenV]kreker,2235,626,24,21,45,53.3%,7m
40169,1,lone,2235,488,19,17,36,52.8%,1h
40169,1,Danny,2235,500,19,23,42,45.2%,28m
40169,1,пупсик,2235,457,15,15,30,50.0%,27m
40169,1,GhostDog,2235,486,14,22,36,38.9%,39m
40169,3,NecrogenetiC,2235,300,10,14,24,41.7%,43m
40169,3,Flanagan,2235,199,8,11,19,42.1%,35m
40169,3,[SF69]andrew,2235,192,6,17,23,26.1%,28m
40169,1,[ExMen]Gambit,2235,232,5,7,12,41.7%,51m
40169,2,Skippy,2235,202,5,10,15,33.3%,32m
40169,1,ZLAT,2235,84,4,8,12,33.3%,38m
40169,2,[ШОУМЕН]ЛюбительЧая,2235,123,3,1,4,75.0%,1h
40169,1,Smorly,2235,121,3,7,10,30.0%,50m
40169,2,Red,2235,46,2,1,3,66.7%,18m
40169,2,LubieKotyHeh,2235,68,2,4,6,33.3%,47m
40169,1,Nuke,2235,118,2,6,8,25.0%,29m
40169,1,Shayadan,2235,48,2,7,9,22.2%,29m
40169,1,spoutnick,2235,86,2,7,9,22.2%,45m
40169,2,ShterenbergS,2235,0,1,0,1,100.0%,25m
40169,2,ФанатTV,2235,0,1,0,1,100.0%,1h
40169,2,[Tic2]lynx,2235,0,1,0,1,100.0%,29m
40169,2,wukop,2235,30,1,1,2,50.0%,38m
40169,2,Piromant,2235,32,1,1,2,50.0%,53m
40169,1,LuckyPanda,2235,0,1,2,3,33.3%,13m
40169,2,GhoSt,2235,0,0,1,1,0.0%,28m
40200,2,Paha,2234,1504,128,134,262,48.9%,46m
40200,1,Yareactor,2234,650,66,54,120,55.0%,18m
40200,1,Ambrosio,2234,942,48,50,98,49.0%,46m
40200,1,karan,2234,1089,39,40,79,49.4%,20m
40200,1,Chickensniff,2234,658,38,35,73,52.1%,12m
40200,1,eghr,2234,898,36,37,73,49.3%,20m
40200,1,[2iq]Shizoid,2234,982,31,33,64,48.4%,17m
40200,2,Dandoh,2234,604,23,15,38,60.5%,13m
40200,3,[Zergar]Raf,2234,572,22,25,47,46.8%,1h
40200,2,Esmeron,2234,494,20,15,35,57.1%,20m
40200,2,DarkTurtle,2234,192,6,2,8,75.0%,20m
40200,2,Spaceon,2234,0,4,1,5,80.0%,28m
40200,2,Haradrim,2234,0,4,1,5,80.0%,22m
40200,1,Илья,2234,119,4,6,10,40.0%,17m
40200,3,Gore,2234,76,4,11,15,26.7%,1h
40200,1,Mammouth,2234,96,3,2,5,60.0%,8m
40200,2,rerens,2234,30,2,0,2,100.0%,11m
40200,2,Dmail,2234,32,2,0,2,100.0%,17m
40200,1,Zergood,2234,44,2,3,5,40.0%,28m
40200,2,BLANK,2234,48,2,5,7,28.6%,23m
40200,2,Rathalos,2234,48,2,6,8,25.0%,4m
40200,1,CalebLee,2234,40,2,7,9,22.2%,1h
40200,1,aisep,2234,36,1,8,9,11.1%,36m
40200,2,Microgłód,2234,0,0,1,1,0.0%,1h
40200,2,BetalGeze,2234,0,0,1,1,0.0%,49m
40200,2,Sakear,2234,0,0,1,1,0.0%,17m
40200,2,[LOGS]blacksheep,2234,0,0,1,1,0.0%,45m
40200,2,Megadudik,2234,0,0,1,1,0.0%,55m
40200,1,bospano,2234,0,0,2,2,0.0%,26m
40200,1,person,2234,0,0,4,4,0.0%,1h
40200,1,kelvinkool,2234,0,0,4,4,0.0%,5m
40231,1,NoMaam,2233,1648,78,81,159,49.1%,32m
40231,3,TheIrishBear,2233,1156,46,44,90,51.1%,15m
40231,3,IAmNoisy,2233,688,27,27,54,50.0%,20m
40231,1,İnFeruu,2233,761,24,30,54,44.4%,36m
40231,1,superduper,2233,511,19,27,46,41.3%,29m
40231,3,rikx,2233,554,18,31,49,36.7%,24m
40231,1,palalaka,2233,484,14,22,36,38.9%,32m
40231,1,Perses,2233,320,12,12,24,50.0%,54m
40231,2,[DHYD]Priest,2233,332,11,18,29,37.9%,36m
40231,1,DarthPedro,2233,340,9,19,28,32.1%,45m
40231,3,parakrama,2233,237,8,13,21,38.1%,26m
40231,1,[Pr8xy]BobaFett,2233,164,4,5,9,44.4%,1h
40231,1,[xX00Xx]benhur,2233,122,3,2,5,60.0%,52m
40231,2,Blackfile,2233,0,3,4,7,42.9%,37m
40231,1,[Ирбис]mdd,2233,119,3,5,8,37.5%,22m
40231,2,Danissimo,2233,88,2,2,4,50.0%,8m
40231,2,SuperTudor,2233,0,1,0,1,100.0%,11m
40231,1,Teddy,2233,0,1,1,2,50.0%,28m
40231,2,Karachan,2233,0,1,5,6,16.7%,4m
40231,2,DONTSHOOTME,2233,0,0,1,1,0.0%,36m
40231,2,skarjoppe,2233,0,0,2,2,0.0%,53m
40252,1,cmc,2232,1743,201,201,402,50.0%,33m
40252,3,Леший,2232,1021,74,81,155,47.7%,1h
40252,2,Baffo,2232,1192,40,56,96,41.7%,14m
40252,1,giov,2232,593,24,20,44,54.5%,28m
40252,1,Aralax,2232,596,24,20,44,54.5%,20m
40252,2,Bansei,2232,628,23,41,64,35.9%,46m
40252,2,christoforos,2232,452,15,13,28,53.6%,11m
40252,2,wrach,2232,446,15,18,33,45.5%,35m
40252,2,[PEJA]JTL,2232,38,4,3,7,57.1%,38m
40252,1,Richter,2232,145,4,7,11,36.4%,15m
40252,1,[JUNTUK]IIIIIIIIIIII,2232,156,4,8,12,33.3%,18m
40252,1,[Myrm]AKTIS,2232,90,3,4,7,42.9%,50m
40252,2,HANSOLO,2232,163,3,5,8,37.5%,54m
40252,1,dadakvs,2232,193,3,5,8,37.5%,28m
40252,1,Chicken,2232,70,3,8,11,27.3%,1h
40252,2,[MG2K]Demianno,2232,30,2,0,2,100.0%,30m
40252,1,zxr,2232,48,2,0,2,100.0%,40m
40252,2,iliajefre,2232,0,1,0,1,100.0%,36m
40252,1,Флу,2232,97,1,2,3,33.3%,22m
40252,2,Solar,2232,0,0,1,1,0.0%,11m
40252,2,mikecurious,2232,0,0,1,1,0.0%,15m
40252,2,NightShadow,2232,0,0,1,1,0.0%,37m
40252,1,[Tambor]хитрый,2232,0,0,2,2,0.0%,39m
40275,1,Chloe,2231,1451,323,339,662,48.8%,39m
40275,3,Александр,2231,908,34,36,70,48.6%,23m
40275,1,HiImCeddi,2231,575,25,18,43,58.1%,45m
40275,3,Suomy,2231,699,23,32,55,41.8%,35m
40275,1,Nagsky,2231,573,18,17,35,51.4%,19m
40275,1,[sQnPL]fiszu,2231,558,17,20,37,45.9%,35m
40275,1,TommyEisbaer,2231,505,16,16,32,50.0%,22m
40275,2,blackmadra,2231,327,12,15,27,44.4%,47m
40275,1,[TDFR]Izolenta,2231,365,11,10,21,52.4%,34m
40275,1,[GhRa]LümmelLörres,2231,168,5,9,14,35.7%,20m
40275,2,deadlygamero,2231,140,4,3,7,57.1%,54m
40275,2,neekoo,2231,98,4,4,8,50.0%,29m
40275,1,kokos,2231,144,4,10,14,28.6%,26m
40275,1,DareDevil,2231,190,3,1,4,75.0%,1h
40275,1,Majoneze,2231,144,3,6,9,33.3%,2m
40275,1,Necro,2231,97,2,1,3,66.7%,21m
40275,2,Zeus,2231,0,1,1,2,50.0%,18m
40275,2,Hubaskis,2231,32,1,2,3,33.3%,1h
40275,1,OrangeDuck,2231,0,1,6,7,14.3%,4m
40275,2,MIHAS,2231,0,0,1,1,0.0%,1h
40275,2,zadrotyarik,2231,0,0,3,3,0.0%,2m
40296,1,sagrado,2230,1504,112,108,220,50.9%,54m
40296,1,comod,2230,1086,44,35,79,55.7%,47m
40296,1,shinoa,2230,963,29,31,60,48.3%,1h
40296,1,Williamumana,2230,575,23,22,45,51.1%,13m
40296,1,oldmustache,2230,349,13,12,25,52.0%,27m
40296,3,Yurok,2230,286,10,13,23,43.5%,30m
40296,2,[DrNost]Banana,2230,328,9,14,23,39.1%,1h
40296,1,Kvant,2230,346,9,17,26,34.6%,26m
40296,1,Paflekk,2230,298,8,12,20,40.0%,43m
40296,2,[2O2L]lotopq,2230,88,4,1,5,80.0%,36m
40296,1,terran,2230,119,3,5,8,37.5%,50m
40296,2,Цукерберег,2230,66,3,5,8,37.5%,41m
40296,2,Enyptée,2230,76,2,1,3,66.7%,49m
40296,1,Salix,2230,76,2,4,6,33.3%,38m
40296,1,vergaas,2230,76,2,5,7,28.6%,35m
40296,3,человвек,2230,0,1,1,2,50.0%,54m
40296,1,Oblivion,2230,0,1,6,7,14.3%,48m
40296,2,animelol,2230,0,0,1,1,0.0%,39m
40296,2,[IndVar]alexToss,2230,0,0,2,2,0.0%,3m
40296,1,[KDV]Brolins,2230,0,0,5,5,0.0%,49m
40316,3,[36C]HummerKette,2229,1537,67,78,145,46.2%,20m
40316,1,HacheL,2229,701,57,54,111,51.4%,46m
40316,1,ottoman,2229,1310,45,50,95,47.4%,27m
40316,2,[MOdJO]cptdoshirak,2229,821,33,24,57,57.9%,47m
40316,1,Eilonking,2229,936,33,40,73,45.2%,18m
40316,2,speedVLADOS,2229,696,29,18,47,61.7%,11m
40316,2,GANIBBAL,2229,625,22,21,43,51.2%,56m
40316,2,CyrusThe,2229,560,21,14,35,60.0%,15m
40316,1,Benzaemon,2229,585,17,18,35,48.6%,13m
40316,2,Dozer,2229,420,16,14,30,53.3%,46m
40316,1,cheetah,2229,552,15,20,35,42.9%,23m
40316,3,Schmerlz,2229,350,11,27,38,28.9%,8m
40316,2,Inpax,2229,196,6,4,10,60.0%,13m
40316,2,Montu,2229,60,4,5,9,44.4%,26m
40316,1,spenser,2229,119,4,5,9,44.4%,50m
40316,2,Bartas,2229,60,3,6,9,33.3%,18m
40316,2,IcathianRain,2229,46,2,1,3,66.7%,48m
40316,2,[mypivo]Farel,2229,58,2,1,3,66.7%,7m
40316,2,TeRiFy,2229,0,2,3,5,40.0%,41m
40316,2,[SEEYA]Camicaze,2229,46,2,4,6,33.3%,5m
40316,1,marinica,2229,30,2,6,8,25.0%,46m
40316,2,Adaś,2229,0,0,1,1,0.0%,35m
40316,2,Dzureg,2229,0,0,2,2,0.0%,50m
40316,2,Xeran,2229,0,0,5,5,0.0%,1m
40340,2,MADCOR,2228,857,36,24,60,60.0%,54m
40340,1,Fra,2228,356,23,25,48,47.9%,7m
40340,2,jebaks,2228,531,22,27,49,44.9%,11m
40340,1,Russy,2228,666,19,25,44,43.2%,22m
40340,1,aaaaaa,2228,438,17,30,47,36.2%,36m
40340,1,DinorD,2228,502,16,19,35,45.7%,23m
40340,1,Santy,2228,461,15,20,35,42.9%,1h
40340,3,[ANASH]Loosefer,2228,372,12,17,29,41.4%,13m
40340,2,SeraphinDo,2228,238,9,8,17,52.9%,45m
40340,1,bashor,2228,233,9,9,18,50.0%,36m
40340,1,MONTORO,2228,258,8,12,20,40.0%,17m
40340,1,[РУC]alpir,2228,239,6,8,14,42.9%,27m
40340,1,[тубз]жужушечка,2228,179,5,6,11,45.5%,36m
40340,2,HaBam,2228,90,4,2,6,66.7%,42m
40340,2,Ovid,2228,116,4,8,12,33.3%,1h
40340,2,Vylmir,2228,60,4,10,14,28.6%,19m
40340,2,[Bkc]Esus,2228,66,3,2,5,60.0%,47m
40340,1,example,2228,131,3,4,7,42.9%,11m
40340,2,Pijonsio,2228,90,3,5,8,37.5%,2m
40340,2,kaporale,2228,186,3,7,10,30.0%,2m
40340,2,[n3wb13]SpookyFoxPL,2228,32,2,0,2,100.0%,41m
40340,2,foxtrot,2228,60,2,1,3,66.7%,1h
40340,2,hellsquirrel,2228,0,2,3,5,40.0%,29m
40340,1,Steve,2228,74,2,6,8,25.0%,50m
40340,2,unimetal,2228,0,1,0,1,100.0%,34m
40340,2,Apocalyptic,2228,0,1,5,6,16.7%,2m
40340,2,MoNtY,2228,0,1,5,6,16.7%,41m
40340,1,bot,2228,0,1,6,7,14.3%,26m
40340,1,Ghosthost,2228,0,1,6,7,14.3%,43m
40340,2,VITALIK,2228,0,0,1,1,0.0%,18m
40340,2,Wolf,2228,0,0,1,1,0.0%,31m
40340,1,Norik,2228,0,0,3,3,0.0%,34m
40372,1,[OmDi]xXxDiabloxXx,2227,1755,145,153,298,48.7%,38m
40372,2,NoEffort,2227,651,61,77,138,44.2%,1m
40372,1,Dosnowin,2227,952,33,36,69,47.8%,23m
40372,1,Ragzus,2227,431,13,22,35,37.1%,56m
40372,1,Artemitol,2227,161,12,16,28,42.9%,25m
40372,1,Privatemax,2227,400,11,16,27,40.7%,50m
40372,1,xNoobhunterx,2227,158,9,9,18,50.0%,51m
40372,1,SuperMan,2227,177,7,3,10,70.0%,17m
40372,2,[BGBKBR]Neeb,2227,150,6,1,7,85.7%,13m
40372,3,[ETBAV]ZIeyKIzzy,2227,152,4,6,10,40.0%,24m
40372,3,Hanter,2227,74,4,9,13,30.8%,30m
40372,2,[ZZee]MURWELL,2227,64,3,3,6,50.0%,1h
40372,2,Starseed,2227,140,3,6,9,33.3%,1h
40372,1,Atoomiusz,2227,165,3,6,9,33.3%,33m
40372,1,Astares,2227,70,2,4,6,33.3%,4m
40372,2,Starstriker,2227,124,2,5,7,28.6%,11m
40372,2,[AnGoSt]DanyaPyccom,2227,116,2,6,8,25.0%,5m
40372,1,MLyoube,2227,48,2,7,9,22.2%,20m
40372,1,Landkrabban,2227,40,2,7,9,22.2%,39m
40372,2,Sotomayor,2227,97,2,8,10,20.0%,1h
40372,2,aksemoron,2227,0,1,0,1,100.0%,51m
40372,2,[NeCriN]Shigi,2227,0,1,1,2,50.0%,34m
40372,2,FarToBblu,2227,0,1,1,2,50.0%,3m
40372,2,autkiller,2227,36,1,1,2,50.0%,56m
40372,1,Karl,2227,89,1,3,4,25.0%,39m
40372,2,Samppanja,2227,0,1,4,5,20.0%,11m
40372,2,Dima,2227,0,1,5,6,16.7%,14m
40372,1,IIIIIIIIIIII,2227,0,0,1,1,0.0%,1h
40372,2,Kirito,2227,0,0,5,5,0.0%,30m
40401,3,Vinz,2226,1105,41,48,89,46.1%,15m
40401,1,Warsa,2226,1058,39,52,91,42.9%,34m
40401,1,Родя,2226,695,35,23,58,60.3%,52m
40401,2,Sephiroth,2226,758,34,36,70,48.6%,45m
40401,1,Локвил,2226,625,27,20,47,57.4%,36m
40401,2,Atesh,2226,710,26,25,51,51.0%,53m
40401,2,EAGLEASIUS,2226,574,22,13,35,62.9%,27m
40401,2,Salmo,2226,440,17,13,30,56.7%,36m
40401,3,MilkMaid,2226,443,16,23,39,41.0%,36m
40401,1,SISERA,2226,447,12,13,25,48.0%,11m
40401,2,LordDron,2226,272,10,8,18,55.6%,44m
40401,3,UKJex,2226,216,10,17,27,37.0%,9m
40401,2,SurvivedInTs,2226,206,9,3,12,75.0%,2m
40401,2,Rpg,2226,232,8,10,18,44.4%,32m
40401,2,akkii,2226,212,7,10,17,41.2%,43m
40401,2,[HONERS]LEMONHAZE,2226,128,5,3,8,62.5%,1m
40401,1,GUILHEM,2226,159,5,3,8,62.5%,31m
40401,3,[Buldog]САНЕК,2226,88,5,12,17,29.4%,54m
40401,2,[glhf20]MacElroi,2226,185,3,7,10,30.0%,9m
40401,2,[ƈG]Tossah,2226,46,2,1,3,66.7%,34m
40401,2,SashaWarlord,2226,30,2,2,4,50.0%,32m
40401,2,hemibaba,2226,0,2,3,5,40.0%,1h
40401,1,Flame,2226,96,2,6,8,25.0%,45m
40401,1,teranid,2226,0,1,1,2,50.0%,20m
40401,1,atiandrei,2226,42,1,4,5,20.0%,25m
40401,2,MRdadon,2226,0,1,4,5,20.0%,21m
40401,1,BoBudowniczy,2226,0,1,6,7,14.3%,1h
40401,2,[RofIer]Bogdan,2226,0,0,1,1,0.0%,18m
40401,2,slupsky,2226,0,0,1,1,0.0%,29m
40401,2,TheMachine,2226,0,0,2,2,0.0%,7m
40401,2,Zergdoktor,2226,0,0,5,5,0.0%,41m
40432,2,serral,2225,968,37,40,77,48.1%,2m
40432,1,Galaxius,2225,915,31,35,66,47.0%,26m
40432,1,[Rbth]Nabe,2225,265,26,32,58,44.8%,49m
40432,2,SuperAK,2225,608,21,22,43,48.8%,42m
40432,1,AJIeLLIKa,2225,557,20,23,43,46.5%,1m
40432,3,[S5RTA]Velmo,2225,348,19,30,49,38.8%,36m
40432,2,Doudou,2225,434,17,15,32,53.1%,18m
40432,1,Patrik,2225,398,14,17,31,45.2%,9m
40432,1,ISubMarinerI,2225,424,12,14,26,46.2%,40m
40432,3,[Cheas]БогиняНаоми,2225,287,9,7,16,56.2%,38m
40432,2,LokiGang,2225,246,7,7,14,50.0%,48m
40432,3,blinker,2225,150,7,11,18,38.9%,49m
40432,2,JLV,2225,179,7,12,19,36.8%,52m
40432,1,BettnässHero,2225,122,6,11,17,35.3%,37m
40432,1,SirHeinz,2225,130,6,15,21,28.6%,17m
40432,1,PoKrYshKa,2225,145,4,6,10,40.0%,55m
40432,2,Surge,2225,0,2,1,3,66.7%,42m
40432,2,Joker,2225,0,1,0,1,100.0%,38m
40432,1,Alchemist,2225,0,1,0,1,100.0%,24m
40432,2,chupameelqlo,2225,0,0,1,1,0.0%,36m
40432,2,[GTkz]GTKZ,2225,0,0,2,2,0.0%,17m
40432,1,SleepyHorse,2225,0,0,3,3,0.0%,1h
40454,1,ANDRII,2224,1201,43,46,89,48.3%,15m
40454,2,[РУИНА]ДИЗРАПТОР,2224,570,20,26,46,43.5%,33m
40454,1,Dissy,2224,502,19,19,38,50.0%,35m
40454,1,gringio,2224,394,15,16,31,48.4%,23m
40454,1,Krevan,2224,378,13,17,30,43.3%,40m
40454,1,UDIE,2224,330,11,19,30,36.7%,33m
40454,1,Cederlund,2224,320,9,13,22,40.9%,42m
40454,1,MariusAlin,2224,275,8,13,21,38.1%,20m
40454,2,Maxheadroom,2224,92,3,4,7,42.9%,41m
40454,1,zhjj,2224,82,3,8,11,27.3%,36m
40454,2,Seva,2224,34,2,0,2,100.0%,11m
40454,1,Zavion,2224,96,2,1,3,66.7%,31m
40454,2,[KROK]DRGazeton,2224,0,2,3,5,40.0%,1h
40454,2,Qeeg,2224,44,1,2,3,33.3%,1h
40454,1,[ДeRpy]ANIME,2224,0,1,2,3,33.3%,16m
40454,1,kirok,2224,48,1,3,4,25.0%,30m
40454,2,zidan,2224,32,1,3,4,25.0%,36m
40454,2,Локи,2224,0,1,5,6,16.7%,42m
40454,2,Matare,2224,0,1,6,7,14.3%,27m
40473,2,ChilSkilBil,2223,1063,134,149,283,47.3%,50m
40473,1,Perko,2223,730,64,68,132,48.5%,41m
40473,1,Glenelg,2223,1476,53,52,105,50.5%,31m
40473,3,Serg,2223,552,48,49,97,49.5%,54m
40473,1,Argoniel,2223,1045,36,36,72,50.0%,37m
40473,2,sellingmoms,2223,695,28,25,53,52.8%,29m
40473,1,RedLine,2223,740,23,27,50,46.0%,27m
40473,1,WaveRider,2223,566,20,18,38,52.6%,40m
40473,3,[TUAIC]nicktyran,2223,478,16,30,46,34.8%,9m
40473,2,[antkr]yoma,2223,290,11,8,19,57.9%,34m
40473,3,[Gottg]MrLong,2223,248,8,14,22,36.4%,43m
40473,1,Käseee,2223,223,7,11,18,38.9%,50m
40473,1,Oona,2223,223,7,12,19,36.8%,38m
40473,2,WPther,2223,116,5,2,7,71.4%,7m
40473,1,PUTEYPIE,2223,190,5,8,13,38.5%,29m
40473,1,ScurvyGordo,2223,80,3,6,9,33.3%,8m
40473,2,Txeriff,2223,58,2,1,3,66.7%,3m
40473,1,[NRWPro]Votaner,2223,78,2,8,10,20.0%,7m
40473,1,[WSKP]RichardIII,2223,78,2,9,11,18.2%,23m
40473,2,Rams,2223,0,1,1,2,50.0%,15m
40473,2,SCprobe,2223,0,1,1,2,50.0%,40m
40473,1,ZioPorcone,2223,0,1,1,2,50.0%,1h
40473,2,satana,2223,0,1,5,6,16.7%,35m
40473,1,nangmarr,2223,0,1,6,7,14.3%,19m
40473,2,Skatchi,2223,48,1,6,7,14.3%,11m
40473,2,IЭnwer,2223,48,1,6,7,14.3%,38m
40473,1,WhiteDemon,2223,0,1,6,7,14.3%,20m
40473,2,[DUSH]POTNEX,2223,0,0,1,1,0.0%,17m
40473,2,Shaytan,2223,0,0,2,2,0.0%,17m
40473,1,Oris,2223,0,0,3,3,0.0%,24m
40473,2,NightKnight,2223,0,0,5,5,0.0%,11m
40504,3,Vincent,2222,1489,191,202,393,48.6%,12m
40504,1,Evgenyi,2222,1560,63,69,132,47.7%,54m
40504,1,Balla,2222,980,47,45,92,51.1%,35m
40504,1,HAKAN,2222,1313,47,47,94,50.0%,38m
40504,1,RIDER,2222,984,41,38,79,51.9%,28m
40504,1,MimouN,2222,771,32,28,60,53.3%,47m
40504,1,Foxtrot,2222,414,13,14,27,48.1%,25m
40504,3,Szwagier,2222,277,9,15,24,37.5%,51m
40504,2,lupo,2222,238,6,10,16,37.5%,54m
40504,2,Zerantoss,2222,86,5,5,10,50.0%,28m
40504,1,PolloOscuro,2222,150,5,8,13,38.5%,1h
40504,2,Simbax,2222,96,3,5,8,37.5%,20m
40504,3,Azagapp,2222,125,3,6,9,33.3%,24m
40504,2,[DeHi]Mystix,2222,102,2,2,4,50.0%,8m
40504,2,Paradokc,2222,60,2,3,5,40.0%,31m
40504,2,nachok,2222,112,2,5,7,28.6%,56m
40504,2,[HGHA]greatgirl,2222,0,1,0,1,100.0%,7m
40504,2,QuikThistle,2222,0,0,1,1,0.0%,42m
40504,2,[PICACZ]Zaklin,2222,0,0,1,1,0.0%,11m
40504,2,ARESIO,2222,0,0,2,2,0.0%,30m
40524,3,RONIN,2221,1051,75,81,156,48.1%,16m
40524,2,Sly,2221,1302,49,58,107,45.8%,54m
40524,1,Imperal,2221,1338,45,53,98,45.9%,42m
40524,1,SCGod,2221,885,39,36,75,52.0%,40m
40524,2,Purivan,2221,892,39,41,80,48.8%,3m
40524,1,Girth,2221,669,34,28,62,54.8%,22m
40524,2,Leodiruk,2221,616,26,20,46,56.5%,45m
40524,1,Slider,2221,474,23,30,53,43.4%,34m
40524,3,Galadus,2221,375,12,22,34,35.3%,1h
40524,1,decoch,2221,324,10,17,27,37.0%,17m
40524,3,LemonFreezer,2221,200,9,10,19,47.4%,21m
40524,2,LUXRONIK,2221,182,6,6,12,50.0%,32m
40524,1,[SCRTV]BatON,2221,196,6,9,15,40.0%,1m
40524,2,PavlovsDog,2221,151,3,1,4,75.0%,56m
40524,3,solist,2221,30,3,8,11,27.3%,36m
40524,1,Mockingbird,2221,123,3,9,12,25.0%,37m
40524,2,carloswa,2221,48,2,1,3,66.7%,12m
40524,2,Trashnyak,2221,32,2,1,3,66.7%,53m
40524,2,Altaear,2221,32,2,1,3,66.7%,11m
40524,2,realUlulu,2221,34,2,2,4,50.0%,38m
40524,1,[BSnow]naglertattoo,2221,0,2,4,6,33.3%,27m
40524,1,karaz,2221,97,2,7,9,22.2%,22m
40524,1,Andy,2221,96,1,1,2,50.0%,41m
40524,2,БАНЗАЙ,2221,30,1,1,2,50.0%,54m
40524,2,ShangriLo,2221,34,1,2,3,33.3%,1h
40524,1,Heisenberg,2221,0,1,6,7,14.3%,1h
40524,1,SlockTheSock,2221,0,1,7,8,12.5%,29m
40524,2,IlIlIlIIIllI,2221,0,0,1,1,0.0%,52m
40524,2,[20062]Godran,2221,0,0,1,1,0.0%,36m
40524,2,CTPEJlOK,2221,0,0,1,1,0.0%,18m
40524,2,Foodnar,2221,0,0,1,1,0.0%,26m
40524,2,PEWBIZZ,2221,0,0,1,1,0.0%,48m
40524,1,obiksus,2221,0,0,3,3,0.0%,27m
40557,2,pomidor,2220,1618,80,74,154,51.9%,7m
40557,1,Melaka,2220,905,47,43,90,52.2%,45m
40557,2,SPEKTR,2220,984,44,40,84,52.4%,26m
40557,2,[N1TDA]HarryCover,2220,674,23,26,49,46.9%,32m
40557,1,Mediocrema,2220,478,16,21,37,43.2%,50m
40557,3,MrWhite,2220,444,15,25,40,37.5%,27m
40557,1,TRPhoenix,2220,170,7,13,20,35.0%,26m
40557,1,shurkyj,2220,0,5,3,8,62.5%,13m
40557,1,coronakrätze,2220,132,5,9,14,35.7%,50m
40557,2,Mrpettson,2220,88,5,10,15,33.3%,1h
40557,2,LimNylon,2220,116,4,3,7,57.1%,27m
40557,1,Nikiw,2220,70,3,5,8,37.5%,37m
40557,1,Kula,2220,145,3,5,8,37.5%,14m
40557,2,Neikma,2220,97,2,4,6,33.3%,4m
40557,2,BELDAN,2220,34,1,2,3,33.3%,45m
40557,2,[0ldS]Holymoly,2220,0,1,5,6,16.7%,5m
40557,1,Oskar,2220,0,1,6,7,14.3%,1h
40557,2,Potato,2220,0,0,1,1,0.0%,9m
40557,2,criss,2220,0,0,3,3,0.0%,33m
40576,2,Phoenix,2219,776,30,20,50,60.0%,2m
40576,2,vetpeter,2219,774,27,31,58,46.6%,36m
40576,1,Tetriz,2219,834,25,30,55,45.5%,13m
40576,1,Vandelein,2219,636,20,21,41,48.8%,25m
40576,1,BROOT,2219,455,20,29,49,40.8%,13m
40576,1,[NTsa]Pommedeterre,2219,575,19,25,44,43.2%,20m
40576,1,oggo,2219,616,18,23,41,43.9%,53m
40576,2,Deborn,2219,430,17,12,29,58.6%,42m
40576,2,BladoS,2219,434,15,14,29,51.7%,28m
40576,1,typhenke,2219,470,15,20,35,42.9%,38m
40576,1,[tnt]bytethunder,2219,423,13,18,31,41.9%,8m
40576,1,LUCKYYASSO,2219,294,10,8,18,55.6%,1h
40576,3,falk,2219,222,7,12,19,36.8%,28m
40576,1,[ENV]Mylny,2219,175,6,5,11,54.5%,17m
40576,2,YANfzltt,2219,30,5,1,6,83.3%,36m
40576,1,Blakcat,2219,48,4,8,12,33.3%,8m
40576,2,Junin,2219,86,3,2,5,60.0%,53m
40576,2,ivod,2219,66,2,2,4,50.0%,11m
40576,2,Yan,2219,30,2,3,5,40.0%,13m
40576,1,[HBeS]youngKami,2219,0,1,0,1,100.0%,22m
40576,1,[justS]Bic,2219,0,1,5,6,16.7%,7m
40576,2,ReeeF,2219,0,0,2,2,0.0%,27m
40576,1,Joerg,2219,0,0,6,6,0.0%,52m
40599,2,picatrix,2218,1543,144,157,301,47.8%,16m
40599,2,Dod,2218,1112,126,128,254,49.6%,29m
40599,2,Mehanik,2218,753,81,79,160,50.6%,4m
40599,1,[JYD]Gwildor,2218,1426,61,52,113,54.0%,29m
40599,1,KamusheK,2218,1176,40,36,76,52.6%,11m
40599,3,Take,2218,570,24,29,53,45.3%,29m
40599,1,petruha,2218,462,14,16,30,46.7%,11m
40599,1,TheHose,2218,297,11,8,19,57.9%,26m
40599,1,GromoKoshka,2218,370,11,10,21,52.4%,9m
40599,1,Beks,2218,300,10,11,21,47.6%,17m
40599,1,kjacks,2218,283,6,9,15,40.0%,34m
40599,1,[ZERGSC]Crazycat,2218,154,4,4,8,50.0%,23m
40599,2,Tenshoga,2218,0,3,2,5,60.0%,14m
40599,3,razzer,2218,123,3,3,6,50.0%,21m
40599,2,ichigo,2218,0,1,1,2,50.0%,51m
40599,3,KürtBöree,2218,97,1,1,2,50.0%,1h
40599,1,Besty,2218,0,1,5,6,16.7%,24m
40599,2,valy,2218,0,0,1,1,0.0%,56m
40599,1,[Шизоид]XorTik,2218,0,0,2,2,0.0%,42m
40618,2,normanbeats,2217,938,120,129,249,48.2%,6m
40618,2,starslimo,2217,723,56,51,107,52.3%,56m
40618,1,SilverHaze,2217,670,43,44,87,49.4%,13m
40618,3,Sentient,2217,458,18,21,39,46.2%,21m
40618,2,SimplePlayer,2217,300,15,14,29,51.7%,16m
40618,3,avlife,2217,224,9,11,20,45.0%,54m
40618,2,Glayoss,2217,228,8,7,15,53.3%,47m
40618,2,RoachRush,2217,146,6,1,7,85.7%,52m
40618,1,AyKeON,2217,36,2,4,6,33.3%,1h
40618,3,Aepheon,2217,0,1,0,1,100.0%,1m
40618,3,DoggoLife,2217,0,1,4,5,20.0%,33m
40618,2,freefrog,2217,0,1,4,5,20.0%,4m
40618,1,Чувак,2217,40,1,5,6,16.7%,51m
40618,2,Rastaman,2217,0,1,5,6,16.7%,29m
40618,2,Zitz,2217,0,0,1,1,0.0%,1h
40618,2,Katashy,2217,0,0,2,2,0.0%,35m
40618,1,klasikmaster,2217,0,0,3,3,0.0%,1h
40635,3,Batoti,2216,1081,189,194,383,49.3%,9m
40635,3,[basdp]OLDBOY,2216,1258,167,175,342,48.8%,17m
40635,3,[НОД17]Delonge,2216,1140,61,75,136,44.9%,11m
40635,1,[LEToo]jackko,2216,1032,50,51,101,49.5%,11m
40635,2,yogsototh,2216,757,31,24,55,56.4%,53m
40635,1,Gurvan,2216,573,30,37,67,44.8%,42m
40635,2,Tillion,2216,433,17,17,34,50.0%,22m
40635,1,Pequod,2216,330,15,24,39,38.5%,46m
40635,3,Lokii,2216,385,14,22,36,38.9%,34m
40635,2,Woko,2216,284,10,10,20,50.0%,36m
40635,2,zivil,2216,289,10,13,23,43.5%,12m
40635,1,Rammud,2216,322,10,15,25,40.0%,43m
40635,1,Tobsen,2216,145,5,7,12,41.7%,1h
40635,2,Pandemonium,2216,88,4,1,5,80.0%,56m
40635,1,krisimoto,2216,158,4,8,12,33.3%,50m
40635,1,[strael]Teprindtetai,2216,101,3,3,6,50.0%,28m
40635,1,AgentulGg,2216,64,3,6,9,33.3%,52m
40635,1,calibur,2216,120,3,7,10,30.0%,8m
40635,1,Voldermars,2216,118,3,11,14,21.4%,1h
40635,1,asdfsadf,2216,0,2,4,6,33.3%,43m
40635,2,EvgeniKa,2216,0,1,0,1,100.0%,38m
40635,1,perekaz,2216,0,1,1,2,50.0%,24m
40635,2,Freezrogue,2216,0,1,1,2,50.0%,1h
40635,2,alm,2216,0,1,2,3,33.3%,11m
40635,2,banraju,2216,30,1,3,4,25.0%,17m
40635,2,Nib,2216,0,1,4,5,20.0%,51m
40635,1,kostya,2216,0,0,3,3,0.0%,1h
40662,2,[OmDi]ultraprotoss,2215,1625,153,160,313,48.9%,54m
40662,1,Alex,2215,1592,74,73,147,50.3%,1h
40662,1,[MSII]goewolf,2215,1504,57,54,111,51.4%,1h
40662,2,Happy,2215,937,39,23,62,62.9%,37m
40662,1,camardon,2215,869,34,35,69,49.3%,44m
40662,1,starmen,2215,919,31,37,68,45.6%,1h
40662,2,Legion,2215,533,22,20,42,52.4%,22m
40662,2,EssenceStrng,2215,392,15,13,28,53.6%,11m
40662,3,Moi,2215,446,14,23,37,37.8%,17m
40662,2,[clavak]Alexua,2215,250,10,6,16,62.5%,53m
40662,3,phaso,2215,217,7,12,19,36.8%,28m
40662,1,BbIDP,2215,156,5,8,13,38.5%,45m
40662,2,PsewDoKnight,2215,118,4,5,9,44.4%,54m
40662,1,Silron,2215,108,4,9,13,30.8%,35m
40662,2,[numb1]LeaderRG,2215,0,3,2,5,60.0%,42m
40662,2,MrHeisenber,2215,88,3,3,6,50.0%,18m
40662,1,dremdzhiev,2215,62,3,7,10,30.0%,38m
40662,1,Killair,2215,48,2,3,5,40.0%,26m
40662,2,ItsMOCKAJlb,2215,0,2,3,5,40.0%,50m
40662,3,Malvo,2215,0,2,8,10,20.0%,27m
40662,2,[Мульт]макс,2215,0,1,0,1,100.0%,17m
40662,2,GoodBoiPat,2215,46,1,4,5,20.0%,2m
40662,1,JediMaster,2215,0,1,6,7,14.3%,29m
40662,1,[Kartus]Suszej,2215,0,1,6,7,14.3%,52m
40662,2,qqq,2215,88,1,6,7,14.3%,52m
40662,1,FARF,2215,0,1,7,8,12.5%,13m
40662,1,Amorir,2215,0,0,1,1,0.0%,31m
40662,2,AgentKingsma,2215,0,0,1,1,0.0%,11m
40662,2,pitei,2215,0,0,2,2,0.0%,1m
40662,2,[Herosi]Zuzia,2215,0,0,5,5,0.0%,49m
40692,1,Hubusxz,2214,382,30,27,57,52.6%,46m
40692,3,Raphy,2214,768,28,36,64,43.8%,50m
40692,3,LuckyDavid,2214,742,25,42,67,37.3%,34m
40692,1,[zuc]dar,2214,570,22,20,42,52.4%,35m
40692,1,Bucleator,2214,508,15,18,33,45.5%,8m
40692,2,vadimag,2214,116,5,1,6,83.3%,45m
40692,1,Apollo,2214,198,5,12,17,29.4%,22m
40692,1,Pataphysics,2214,0,4,3,7,57.1%,27m
40692,2,Reyz,2214,88,3,2,5,60.0%,1h
40692,2,Janekxxxx,2214,68,2,4,6,33.3%,48m
40692,2,Tsabu,2214,30,1,1,2,50.0%,44m
40692,2,Charaz,2214,30,1,2,3,33.3%,54m
40692,2,Azquelt,2214,30,1,2,3,33.3%,27m
40692,1,Ivan,2214,42,1,5,6,16.7%,52m
40692,1,Comix,2214,0,0,1,1,0.0%,54m
40692,2,izak,2214,0,0,1,1,0.0%,18m
40692,2,Vanish,2214,0,0,1,1,0.0%,43m
40692,2,CoryS,2214,0,0,1,1,0.0%,46m
40710,1,unlimited,2213,1405,63,59,122,51.6%,6m
40710,1,[GAMI]Valounours,2213,1310,52,48,100,52.0%,34m
40710,3,EdleBoucher,2213,695,31,32,63,49.2%,1h
40710,1,Shaftwannabe,2213,631,25,23,48,52.1%,22m
40710,1,Schorschi,2213,504,14,19,33,42.4%,52m
40710,1,Baayo,2213,270,10,7,17,58.8%,26m
40710,1,Fbel,2213,240,8,9,17,47.1%,39m
40710,2,Jinster,2213,156,5,6,11,45.5%,30m
40710,1,Lotos,2213,174,5,8,13,38.5%,42m
40710,2,Propofol,2213,88,4,1,5,80.0%,18m
40710,3,xxloli,2213,0,4,5,9,44.4%,29m
40710,3,KillerBunny,2213,116,4,10,14,28.6%,40m
40710,1,TheVeryBest,2213,38,3,2,5,60.0%,25m
40710,1,BillyDude,2213,96,3,8,11,27.3%,29m
40710,2,WildWolf,2213,32,2,1,3,66.7%,36m
40710,1,[Poofff]HxCKid,2213,48,1,2,3,33.3%,34m
40710,1,[Olеg]SazZaks,2213,0,1,3,4,25.0%,32m
40710,2,Ouroz,2213,0,1,4,5,20.0%,9m
40710,2,[zhuds]Кот,2213,0,0,1,1,0.0%,50m
40710,2,[FQ87]NeSova,2213,0,0,1,1,0.0%,27m
40710,2,Devastador,2213,0,0,4,4,0.0%,34m
40710,2,monster,2213,0,0,5,5,0.0%,54m
40710,3,JohnnyBravo,2213,0,0,6,6,0.0%,11m
40733,1,MaxProton,2212,1554,350,361,711,49.2%,30m
40733,1,ceejay,2212,1734,272,277,549,49.5%,43m
40733,2,[AnC1ub]mishajard,2212,894,36,35,71,50.7%,11m
40733,1,DED,2212,590,22,21,43,51.2%,30m
40733,1,Simsisamstar,2212,423,17,15,32,53.1%,26m
40733,1,Mozza,2212,305,16,11,27,59.3%,34m
40733,1,Kloop,2212,392,10,18,28,35.7%,23m
40733,1,[Аоуэйя]zajebioza,2212,246,7,13,20,35.0%,53m
40733,2,[Hyper1]citizen,2212,198,5,6,11,45.5%,17m
40733,1,LUX,2212,126,3,10,13,23.1%,7m
40733,2,[НОД17]foxgamer,2212,30,2,1,3,66.7%,49m
40733,1,MonroE,2212,48,2,4,6,33.3%,16m
40733,2,Wolverine,2212,141,2,6,8,25.0%,51m
40733,2,Banis,2212,46,2,6,8,25.0%,14m
40733,3,TRekt,2212,35,2,8,10,20.0%,7m
40733,1,BroodFather,2212,0,1,1,2,50.0%,29m
40733,1,[Nova11]Justitius,2212,48,1,2,3,33.3%,25m
40733,2,Coekie,2212,30,1,2,3,33.3%,11m
40733,1,Yellow,2212,42,1,5,6,16.7%,48m
40733,1,SilentStorm,2212,0,1,5,6,16.7%,34m
40733,1,noobb,2212,0,0,1,1,0.0%,56m
40733,2,Apollon,2212,0,0,1,1,0.0%,8m
40755,1,ShadowOrbite,2211,1233,50,53,103,48.5%,28m
40755,1,Varg,2211,1237,44,46,90,48.9%,6m
40755,2,ninja,2211,598,22,19,41,53.7%,47m
40755,1,MokkadEdE,2211,216,20,19,39,51.3%,9m
40755,2,Sebo,2211,368,17,11,28,60.7%,18m
40755,1,andrei,2211,554,17,19,36,47.2%,28m
40755,3,Strixie,2211,423,16,20,36,44.4%,23m
40755,1,BoxerMF,2211,448,13,22,35,37.1%,43m
40755,1,MalwormRO,2211,422,11,19,30,36.7%,11m
40755,2,Demetriusz,2211,210,7,5,12,58.3%,27m
40755,2,TEMPLER,2211,64,6,7,13,46.2%,49m
40755,3,marcelo,2211,179,5,10,15,33.3%,50m
40755,1,BloodMan,2211,142,3,4,7,42.9%,1h
40755,2,GASTO,2211,0,1,0,1,100.0%,15m
40755,2,[BTSM]Dementor,2211,0,1,0,1,100.0%,3m
40755,1,Дмитрий,2211,0,1,6,7,14.3%,13m
40755,1,PainTrain,2211,0,1,7,8,12.5%,25m
40755,1,Shagrat,2211,0,1,7,8,12.5%,32m
40755,2,DizzyDwarf,2211,0,0,1,1,0.0%,7m
40755,2,danogano,2211,0,0,3,3,0.0%,1h
40755,1,Azrial,2211,0,0,4,4,0.0%,20m
40776,3,DeinOnkel,2210,1130,214,227,441,48.5%,24m
40776,1,kasi,2210,1704,138,135,273,50.5%,1h
40776,3,TroubleMaker,2210,1049,138,138,276,50.0%,11m
40776,3,waluszek,2210,1041,60,59,119,50.4%,36m
40776,1,ramzi,2210,998,38,42,80,47.5%,13m
40776,1,BarsikRiga,2210,960,34,30,64,53.1%,22m
40776,2,przem,2210,724,26,28,54,48.1%,3m
40776,1,Hati,2210,451,16,29,45,35.6%,9m
40776,1,Azazell,2210,454,12,17,29,41.4%,7m
40776,1,[GАYSS]MicroAnonim,2210,363,10,17,27,37.0%,11m
40776,3,Welsnoon,2210,321,10,17,27,37.0%,12m
40776,1,XpycT,2210,188,5,6,11,45.5%,36m
40776,2,SteeL,2210,188,5,8,13,38.5%,34m
40776,3,[Buldog]AgentBrauns,2210,88,4,12,16,25.0%,6m
40776,1,badford,2210,145,3,8,11,27.3%,41m
40776,2,[PLPK]IstoD,2210,30,2,3,5,40.0%,1m
40776,2,tapok,2210,66,2,4,6,33.3%,24m
40776,1,DooM,2210,132,2,5,7,28.6%,11m
40776,3,anton,2210,0,0,1,1,0.0%,43m
40776,2,MaX,2210,0,0,2,2,0.0%,49m
40776,1,[CRYS]ReBro,2210,0,0,2,2,0.0%,38m
40797,1,thePlankfish,2209,1667,139,140,279,49.8%,25m
40797,1,zoarengBZH,2209,1032,90,95,185,48.6%,34m
40797,1,[SUFI]YadolusTG,2209,1353,60,55,115,52.2%,41m
40797,1,Gasan,2209,416,11,18,29,37.9%,51m
40797,1,KERGULDU,2209,276,10,12,22,45.5%,37m
40797,1,Gagarin,2209,150,5,10,15,33.3%,36m
40797,2,CRAKEN,2209,32,4,2,6,66.7%,11m
40797,3,assasinushka,2209,126,4,3,7,57.1%,18m
40797,2,[ISC2I]GhostRider,2209,58,3,2,5,60.0%,47m
40797,1,Разрушитель,2209,169,3,4,7,42.9%,1h
40797,1,Andrei,2209,80,2,7,9,22.2%,26m
40797,2,[АРМАДА]Авиан,2209,0,1,0,1,100.0%,1h
40797,2,HamLass,2209,0,1,0,1,100.0%,42m
40797,2,[Мяу]Lodka,2209,30,1,1,2,50.0%,42m
40797,1,LARGO,2209,0,1,5,6,16.7%,36m
40812,1,[Kboin]Higgins,2208,1305,57,60,117,48.7%,26m
40812,1,Gang,2208,1012,43,36,79,54.4%,1m
40812,2,Giedrius,2208,960,32,51,83,38.6%,18m
40812,2,SideraITAG,2208,508,20,15,35,57.1%,16m
40812,2,[sTarTA]mInDetoNAtoR,2208,449,13,20,33,39.4%,18m
40812,2,[59APM]gameover,2208,359,12,9,21,57.1%,11m
40812,2,Viki,2208,332,12,17,29,41.4%,3m
40812,1,[HEROX]Jleyher,2208,218,6,9,15,40.0%,22m
40812,1,pershing,2208,198,5,8,13,38.5%,28m
40812,2,ThePeoshow,2208,118,4,3,7,57.1%,7m
40812,2,Samolooo,2208,64,3,2,5,60.0%,40m
40812,2,[CОS]zaurs,2208,30,2,0,2,100.0%,18m
40812,2,Pretoriano,2208,30,2,1,3,66.7%,53m
40812,1,[THIC]ThisIsCotik,2208,144,2,2,4,50.0%,15m
40812,2,Whitepill,2208,58,2,5,7,28.6%,36m
40812,1,XcerX,2208,34,2,7,9,22.2%,37m
40812,2,gothic,2208,0,1,0,1,100.0%,1h
40812,2,Putiii,2208,0,1,0,1,100.0%,1h
40812,2,elixias,2208,99,1,2,3,33.3%,49m
40812,2,[WАSD]Raven,2208,30,1,4,5,20.0%,45m
40812,2,Crusader,2208,30,1,5,6,16.7%,18m
40812,1,revizorro,2208,0,1,5,6,16.7%,24m
40812,3,Prizrak,2208,46,1,18,19,5.3%,54m
40812,2,[Dzikii]Apink,2208,0,0,1,1,0.0%,11m
40812,2,Soltek,2208,0,0,1,1,0.0%,36m
40812,2,Eredain,2208,0,0,1,1,0.0%,27m
40838,2,Vlados,2207,949,54,51,105,51.4%,42m
40838,1,tytan,2207,1198,41,41,82,50.0%,3m
40838,1,RushMeSlowly,2207,978,30,37,67,44.8%,37m
40838,1,ArtemkasSs,2207,647,20,23,43,46.5%,1h
40838,2,Miha,2207,254,10,7,17,58.8%,22m
40838,3,Mayday,2207,261,10,14,24,41.7%,33m
40838,2,DrSpaceman,2207,254,9,7,16,56.2%,56m
40838,1,David,2207,240,7,12,19,36.8%,34m
40838,1,iLF,2207,214,6,9,15,40.0%,41m
40838,1,Darkling,2207,287,6,11,17,35.3%,1h
40838,1,Tinker,2207,265,6,12,18,33.3%,17m
40838,2,СУПЕРМАГ,2207,116,6,13,19,31.6%,17m
40838,2,Irvin,2207,114,5,2,7,71.4%,44m
40838,1,bot,2207,196,5,11,16,31.2%,39m
40838,1,PhiliPL,2207,121,4,12,16,25.0%,51m
40838,2,Lowrider,2207,95,1,5,6,16.7%,52m
40838,1,Switcher,2207,0,0,3,3,0.0%,7m
40855,1,Vovarussia,2206,1662,98,98,196,50.0%,34m
40855,3,SwarmKing,2206,838,66,64,130,50.8%,21m
40855,1,ImamMahtab,2206,962,60,56,116,51.7%,54m
40855,2,OlesiaYur,2206,1427,58,45,103,56.3%,18m
40855,1,HappyRogue,2206,1296,45,52,97,46.4%,28m
40855,1,nockbcn,2206,1126,35,46,81,43.2%,19m
40855,1,[UAŦeam]pacific,2206,840,32,31,63,50.8%,51m
40855,1,Allatar,2206,493,16,13,29,55.2%,39m
40855,1,Zealot,2206,371,13,12,25,52.0%,54m
40855,1,[AnQ]Oldie,2206,414,11,22,33,33.3%,3m
40855,2,Interstellar,2206,236,10,17,27,37.0%,20m
40855,1,RouxNounoune,2206,119,4,6,10,40.0%,56m
40855,2,[SUD34]MortelCraft,2206,133,3,1,4,75.0%,37m
40855,2,NerV,2206,0,3,2,5,60.0%,54m
40855,2,GrafDark,2206,46,3,4,7,42.9%,55m
40855,2,Vank,2206,94,2,7,9,22.2%,42m
40855,2,STEAMPUNKRUS,2206,0,1,0,1,100.0%,53m
40855,2,[Ru75]lowe,2206,0,1,0,1,100.0%,54m
40855,2,[JrSt]Vorahaz,2206,32,1,3,4,25.0%,42m
40855,2,RUMIT,2206,0,1,4,5,20.0%,27m
40855,2,Casper,2206,0,1,6,7,14.3%,28m
40855,2,Nano,2206,0,0,1,1,0.0%,28m
40855,2,[NecX]Plomki,2206,0,0,1,1,0.0%,56m
40855,3,[RofIer]SkilleT,2206,0,0,2,2,0.0%,52m
40855,1,[morg]Legeon,2206,0,0,2,2,0.0%,34m
40855,1,CAndrey,2206,0,0,8,8,0.0%,32m
40881,1,woezii,2205,769,48,49,97,49.5%,32m
40881,1,darkboss,2205,945,35,30,65,53.8%,27m
40881,2,Osiris,2205,649,27,21,48,56.2%,11m
40881,1,Жириновский,2205,760,27,32,59,45.8%,17m
40881,1,rtspro,2205,635,24,26,50,48.0%,29m
40881,2,ReAnimator,2205,538,20,20,40,50.0%,29m
40881,3,Electronik,2205,468,17,21,38,44.7%,55m
40881,1,AtamanRD,2205,423,12,16,28,42.9%,6m
40881,1,БУЛОЧКА,2205,221,6,8,14,42.9%,40m
40881,1,[FL4PS]Fingu,2205,270,6,11,17,35.3%,36m
40881,2,Hakuya,2205,126,5,6,11,45.5%,36m
40881,2,Tavarom,2205,132,4,1,5,80.0%,31m
40881,2,theUltimate,2205,124,4,5,9,44.4%,33m
40881,2,Zergo,2205,0,3,2,5,60.0%,38m
40881,2,[UZX]TRETTONTOLV,2205,182,3,7,10,30.0%,54m
40881,1,Rolus,2205,80,2,7,9,22.2%,17m
40881,1,[AGON]Антон,2205,80,2,10,12,16.7%,39m
40881,2,[Ogz]Bernard,2205,0,1,0,1,100.0%,1h
40881,2,Chief,2205,0,1,4,5,20.0%,38m
40881,2,süheyl,2205,0,0,1,1,0.0%,1h
40881,2,PurgenRu,2205,0,0,2,2,0.0%,56m
40902,3,ini,2204,1251,90,91,181,49.7%,50m
40902,2,[nonigs]Temple,2204,1000,38,41,79,48.1%,35m
40902,1,Piotrsnk,2204,1030,34,39,73,46.6%,11m
40902,1,Kiux,2204,606,20,23,43,46.5%,41m
40902,2,Xurisso,2204,538,18,20,38,47.4%,44m
40902,2,ahnevskiy,2204,481,17,13,30,56.7%,45m
40902,2,KpacT,2204,328,13,16,29,44.8%,44m
40902,1,Tardigrade,2204,335,12,10,22,54.5%,56m
40902,2,Wortigen,2204,319,11,17,28,39.3%,36m
40902,3,Sanay,2204,244,8,11,19,42.1%,34m
40902,1,BALEiNe,2204,324,8,15,23,34.8%,46m
40902,2,Cyrix,2204,154,5,5,10,50.0%,15m
40902,3,[WiNeRR]ilyu,2204,89,4,1,5,80.0%,34m
40902,2,PPish,2204,112,4,3,7,57.1%,51m
40902,2,каракс,2204,30,4,3,7,57.1%,54m
40902,1,[Bopos]SatellitexHD,2204,104,4,8,12,33.3%,1h
40902,2,andrey,2204,34,2,2,4,50.0%,11m
40902,1,Inveker,2204,48,2,2,4,50.0%,9m
40902,2,Rockcer,2204,96,2,3,5,40.0%,17m
40902,2,iloveyou,2204,44,2,3,5,40.0%,41m
40902,1,Atmos,2204,38,2,5,7,28.6%,1h
40902,1,PerikoCastro,2204,120,2,7,9,22.2%,3m
40902,1,vakhrymchuk,2204,0,2,9,11,18.2%,6m
40902,2,[Ctrl]ClickMore,2204,0,1,2,3,33.3%,12m
40902,2,[Lumen]Ace,2204,94,1,5,6,16.7%,9m
40902,2,AndyzZ,2204,0,0,2,2,0.0%,35m
40902,2,[3x3tea]luxor,2204,0,0,2,2,0.0%,38m
40902,1,[dd33nt]AvengerX,2204,0,0,4,4,0.0%,1h
40930,1,[MUTPLA]SirCornelius,2203,1677,161,167,328,49.1%,37m
40930,2,AxN,2203,369,42,31,73,57.5%,38m
40930,2,pofigy,2203,912,38,31,69,55.1%,52m
40930,1,Alex,2203,736,31,28,59,52.5%,41m
40930,1,[ZЕRGТV]Sovushka,2203,451,18,12,30,60.0%,22m
40930,3,BITE,2203,462,18,18,36,50.0%,17m
40930,2,Escape,2203,438,15,14,29,51.7%,17m
40930,3,TsunTsun,2203,440,15,22,37,40.5%,15m
40930,3,paulhus,2203,463,15,27,42,35.7%,15m
40930,1,juanramon,2203,414,13,20,33,39.4%,17m
40930,2,JustNoob,2203,327,12,14,26,46.2%,27m
40930,2,Cosa,2203,258,11,8,19,57.9%,8m
40930,1,Ellale,2203,306,10,10,20,50.0%,16m
40930,1,[TCC974]Gil,2203,270,9,11,20,45.0%,1m
40930,3,Insight,2203,141,8,7,15,53.3%,7m
40930,2,Schlachsahne,2203,238,8,12,20,40.0%,22m
40930,1,Oyche,2203,183,7,6,13,53.8%,38m
40930,2,[IPSI]Quasar,2203,116,6,13,19,31.6%,1h
40930,2,Squall,2203,149,4,8,12,33.3%,12m
40930,2,powerslide,2203,88,3,3,6,50.0%,46m
40930,1,[Goldin]taily,2203,0,2,5,7,28.6%,24m
40930,1,Pvm,2203,118,2,6,8,25.0%,50m
40930,1,[IPPNNH]Quagmire,2203,78,2,7,9,22.2%,20m
40930,1,Enfer,2203,0,2,9,11,18.2%,18m
40930,2,Kristina,2203,94,1,2,3,33.3%,3m
40930,1,[TC212]TerrorWolf,2203,97,1,4,5,20.0%,24m
40930,3,gouzzy,2203,0,0,1,1,0.0%,51m
40930,2,[warrio]artanisLE,2203,0,0,1,1,0.0%,29m
40930,2,DorónAshont,2203,0,0,2,2,0.0%,3m
40930,1,xBlaze,2203,0,0,3,3,0.0%,4m
40930,1,badman,2203,0,0,5,5,0.0%,24m
40930,2,GeO,2203,0,0,5,5,0.0%,49m
40962,2,KriFi,2202,1031,42,41,83,50.6%,39m
40962,1,ObsidianX,2202,1127,40,42,82,48.8%,34m
40962,2,[TB02]Stachu,2202,1031,36,34,70,51.4%,16m
40962,1,AlelCraft,2202,724,25,22,47,53.2%,6m
40962,1,Sui,2202,377,16,20,36,44.4%,36m
40962,2,HerrKaleun,2202,223,15,8,23,65.2%,20m
40962,1,ElGomo,2202,452,15,14,29,51.7%,11m
40962,1,[ZЕRGТV]MonsterEVO,2202,503,15,19,34,44.1%,23m
40962,1,ZixenZ,2202,315,10,9,19,52.6%,50m
40962,1,[LE3]BlasDeLezo,2202,181,7,13,20,35.0%,4m
40962,3,[SYED]HamzGG,2202,156,5,12,17,29.4%,22m
40962,2,Silence,2202,124,4,5,9,44.4%,12m
40962,1,jeanpipi,2202,241,4,7,11,36.4%,1h
40962,3,Sereti,2202,97,2,0,2,100.0%,6m
40962,1,[ЯlСосу]Mypka,2202,115,2,4,6,33.3%,23m
40962,3,[Сold]СТРЕЛОК,2202,0,1,0,1,100.0%,12m
40962,2,kamox,2202,42,1,1,2,50.0%,50m
40962,2,WavixSan,2202,0,1,4,5,20.0%,11m
40962,2,Asanff,2202,94,1,5,6,16.7%,33m
40962,2,Lukaz,2202,0,0,1,1,0.0%,29m
40962,2,slevin,2202,0,0,1,1,0.0%,50m
40962,2,[ExTr1m]LeoN,2202,0,0,1,1,0.0%,31m
40962,2,tohha,2202,0,0,2,2,0.0%,34m
40962,1,UNIVERSO,2202,0,0,5,5,0.0%,48m
40986,1,Sadron,2201,998,122,130,252,48.4%,47m
40986,1,ogpaul,2201,1731,104,107,211,49.3%,23m
40986,1,Simo,2201,839,69,66,135,51.1%,1m
40986,3,[firstb]Sahrteck,2201,575,66,75,141,46.8%,7m
40986,1,Abxaz,2201,1230,42,52,94,44.7%,31m
40986,2,Wictor,2201,964,38,34,72,52.8%,51m
40986,1,Славян,2201,1041,37,45,82,45.1%,1h
40986,2,TuQueMiras,2201,864,35,29,64,54.7%,12m
40986,1,Risbal,2201,822,30,32,62,48.4%,38m
40986,1,Ехоу,2201,757,29,30,59,49.2%,25m
40986,3,sssss,2201,338,27,37,64,42.2%,11m
40986,2,Grauk,2201,544,21,15,36,58.3%,1h
40986,1,Ultra,2201,401,19,16,35,54.3%,13m
40986,2,VVVkEstik,2201,282,11,8,19,57.9%,56m
40986,2,Incrimentato,2201,178,7,3,10,70.0%,44m
40986,2,[BSG19]Krusader,2201,184,7,9,16,43.8%,22m
40986,2,zelg,2201,150,6,7,13,46.2%,36m
40986,1,yahooo,2201,204,6,7,13,46.2%,28m
40986,2,Ganoff,2201,156,5,7,12,41.7%,37m
40986,1,NeuroAB,2201,96,4,9,13,30.8%,22m
40986,3,CottonBanjo,2201,116,3,9,12,25.0%,1h
40986,1,HuFFnerr,2201,132,2,6,8,25.0%,1h
40986,2,[LØV2B3]DUSTYBIGC,2201,46,2,7,9,22.2%,35m
40986,2,DeadBeat,2201,0,1,0,1,100.0%,11m
40986,2,[fndtn]Rockless,2201,0,1,1,2,50.0%,20m
40986,2,[R3ject]Sytherclaw,2201,46,1,1,2,50.0%,20m
40986,1,mironduzy,2201,0,1,2,3,33.3%,38m
40986,1,dreamhack,2201,0,1,6,7,14.3%,24m
41014,1,Lior,2200,1736,195,201,396,49.2%,18m
41014,2,Hermisid,2200,1342,52,50,102,51.0%,1h
41014,3,JULIUS,2200,1034,42,49,91,46.2%,13m
41014,2,Marsruben,2200,625,34,32,66,51.5%,36m
41014,2,BidBack,2200,776,30,27,57,52.6%,13m
41014,1,[IntCC]Nic,2200,624,26,21,47,55.3%,1h
41014,2,шепард,2200,518,22,14,36,61.1%,1m
41014,2,Sick,2200,574,22,19,41,53.7%,42m
41014,2,Raider,2200,638,22,22,44,50.0%,18m
41014,1,FireFly,2200,348,20,19,39,51.3%,32m
41014,3,TaURuS,2200,534,20,23,43,46.5%,39m
41014,1,Bybear,2200,477,20,27,47,42.6%,36m
41014,2,FroZiks,2200,478,17,21,38,44.7%,49m
41014,1,Synti,2200,383,16,22,38,42.1%,20m
41014,2,AspiD,2200,390,13,10,23,56.5%,51m
41014,1,Bak,2200,156,13,17,30,43.3%,7m
41014,2,KAin,2200,209,11,10,21,52.4%,36m
41014,2,Nemo,2200,282,9,7,16,56.2%,12m
41014,2,[megal4]Gregg,2200,125,9,8,17,52.9%,42m
41014,2,YRK,2200,210,8,5,13,61.5%,1h
41014,2,TheSaskia,2200,246,8,5,13,61.5%,38m
41014,2,Mirco,2200,225,6,10,16,37.5%,3m
41014,1,Dokles,2200,247,6,10,16,37.5%,54m
41014,2,Uczuł,2200,205,6,13,19,31.6%,1h
41014,1,Eliitaliano,2200,143,4,4,8,50.0%,31m
41014,2,Новичог,2200,64,3,4,7,42.9%,54m
41014,2,Ramses,2200,88,3,7,10,30.0%,11m
41014,1,Ainotenshi,2200,30,2,7,9,22.2%,3m
41014,2,Andi,2200,30,1,1,2,50.0%,18m
41014,2,[cOLOrs]iBou,2200,0,1,5,6,16.7%,29m
41014,2,СмертоМышь,2200,0,0,1,1,0.0%,41m
41014,2,[Zakel]Dinastix,2200,0,0,1,1,0.0%,42m
41014,2,Nekyz,2200,0,0,1,1,0.0%,36m
41014,2,RedOrDead,2200,0,0,2,2,0.0%,1m
41048,2,PasutusI,2199,1547,240,234,474,50.6%,8m
41048,1,Ngarth,2199,1447,120,121,241,49.8%,36m
41048,1,gyom,2199,1538,84,94,178,47.2%,1h
41048,1,Feniks,2199,1300,46,48,94,48.9%,13m
41048,1,Adrianus,2199,1081,36,41,77,46.8%,45m
41048,1,[SPF]LalkaPL,2199,678,21,25,46,45.7%,48m
41048,1,Zarek,2199,265,7,10,17,41.2%,14m
41048,3,KIRILLESINO,2199,178,7,13,20,35.0%,38m
41048,1,remty,2199,266,6,12,18,33.3%,34m
41048,2,[OGPP]Theundermind,2199,152,5,3,8,62.5%,31m
41048,2,porka,2199,140,4,3,7,57.1%,35m
41048,2,tovarm,2199,124,4,6,10,40.0%,1h
41048,2,[ProbKA]Ruiner,2199,118,4,6,10,40.0%,20m
41048,1,ineedajob,2199,122,4,9,13,30.8%,8m
41048,2,[SpFs]Легат,2199,58,3,3,6,50.0%,53m
41048,2,Agonytech,2199,34,2,1,3,66.7%,6m
41048,2,JABASS,2199,60,2,3,5,40.0%,6m
41048,1,Dirici,2199,0,1,2,3,33.3%,1h
41048,2,DAX,2199,30,1,3,4,25.0%,48m
41048,2,Belcka,2199,46,1,3,4,25.0%,15m
41048,2,deni,2199,48,1,3,4,25.0%,36m
41048,1,GoodWin,2199,79,1,5,6,16.7%,1h
41048,1,[ÆGlS]ETinspace,2199,0,1,6,7,14.3%,31m
41048,2,Sonozaki,2199,0,0,1,1,0.0%,47m
41048,2,Бдышытс,2199,0,0,2,2,0.0%,48m
41048,2,qawsed,2199,0,0,5,5,0.0%,18m
41074,1,[mfxed]Marcin,2198,1525,67,78,145,46.2%,33m
41074,2,[grB420]Kastor,2198,1587,65,46,111,58.6%,1h
41074,1,GreenBlack,2198,1178,47,43,90,52.2%,33m
41074,2,Trewidant,2198,1094,40,35,75,53.3%,32m
41074,1,YuGin,2198,726,27,29,56,48.2%,45m
41074,2,miarmi,2198,510,22,16,38,57.9%,37m
41074,1,PrOvIdEr,2198,518,21,19,40,52.5%,45m
41074,1,yellow,2198,286,21,24,45,46.7%,52m
41074,2,Dendi,2198,459,17,20,37,45.9%,3m
41074,1,Darknight,2198,379,15,17,32,46.9%,32m
41074,2,Angel,2198,368,14,11,25,56.0%,9m
41074,1,EPICKIEPIK,2198,320,9,16,25,36.0%,54m
41074,2,Vakh,2198,171,5,6,11,45.5%,44m
41074,2,johnMcCain,2198,30,2,0,2,100.0%,6m
41074,3,[OUUH]Charogne,2198,97,2,1,3,66.7%,54m
41074,1,tjdgk,2198,42,2,6,8,25.0%,13m
41074,3,llllllllllll,2198,97,1,2,3,33.3%,32m
41074,1,sven,2198,88,1,3,4,25.0%,23m
41074,2,Borzik,2198,0,1,5,6,16.7%,38m
41074,1,goshaka,2198,0,1,6,7,14.3%,6m
41074,1,[BWD]JohnCoffey,2198,42,1,10,11,9.1%,34m
41095,3,Asterix,2197,1570,91,97,188,48.4%,35m
41095,2,wantedMW,2197,1614,68,61,129,52.7%,31m
41095,1,Maiwaifu,2197,1108,40,42,82,48.8%,27m
41095,1,dijoke,2197,994,37,34,71,52.1%,6m
41095,2,DemonWolf,2197,698,27,30,57,47.4%,8m
41095,2,MariusTavi,2197,343,24,24,48,50.0%,33m
41095,2,NemoOudeis,2197,295,13,13,26,50.0%,44m
41095,2,rodanas,2197,230,9,5,14,64.3%,18m
41095,1,MaxL,2197,192,5,14,19,26.3%,14m
41095,1,SerzhAnt,2197,96,3,8,11,27.3%,32m
41095,3,loczek,2197,58,2,8,10,20.0%,51m
41095,2,JGCAPT,2197,0,1,4,5,20.0%,33m
41095,1,[Pyrric]Sam,2197,0,1,5,6,16.7%,45m
41095,2,DrunkenFist,2197,0,1,6,7,14.3%,52m
41095,2,[ShDg]Steigen,2197,42,1,6,7,14.3%,29m
41095,1,[TLGC]JiuZaa,2197,0,0,1,1,0.0%,34m
41095,2,REPTILE,2197,0,0,1,1,0.0%,12m
41095,2,[H1]Leris,2197,0,0,2,2,0.0%,56m
41113,2,[IomgI]Gent,2196,1589,87,107,194,44.8%,6m
41113,3,jocmi,2196,948,75,78,153,49.0%,36m
41113,1,MariusBFS,2196,542,32,29,61,52.5%,47m
41113,3,Segfault,2196,837,30,32,62,48.4%,49m
41113,2,Romutti,2196,565,26,28,54,48.1%,43m
41113,2,jorcuaovi,2196,694,24,26,50,48.0%,8m
41113,1,Arnaud,2196,520,20,23,43,46.5%,28m
41113,1,Thibagon,2196,632,19,23,42,45.2%,52m
41113,3,[INCELS]НагибПРОГРАМ,2196,354,15,19,34,44.1%,23m
41113,2,DrakonRe,2196,402,14,11,25,56.0%,55m
41113,2,FIux,2196,404,14,16,30,46.7%,31m
41113,1,Silverblest,2196,371,13,11,24,54.2%,30m
41113,2,SimXgaminG,2196,274,11,15,26,42.3%,34m
41113,2,SucharL,2196,210,7,1,8,87.5%,6m
41113,1,danul,2196,248,7,12,19,36.8%,53m
41113,1,XTGeneral,2196,180,5,12,17,29.4%,29m
41113,2,adylyl,2196,120,4,5,9,44.4%,44m
41113,1,[MOOOH]Kaan,2196,193,4,9,13,30.8%,1h
41113,2,Merzus,2196,153,4,9,13,30.8%,30m
41113,2,[HACKZ]HappyGMR,2196,62,3,0,3,100.0%,7m
41113,2,[CH70]Gargoyle,2196,109,3,4,7,42.9%,17m
41113,2,hior,2196,60,2,2,4,50.0%,49m
41113,2,Mosco,2196,0,2,3,5,40.0%,1h
41113,1,Seneca,2196,88,2,11,13,15.4%,27m
41113,2,lamia,2196,0,1,0,1,100.0%,28m
41113,3,Andrew,2196,30,1,1,2,50.0%,43m
41113,2,PABLO,2196,94,1,5,6,16.7%,32m
41113,2,Wasdead,2196,0,0,1,1,0.0%,38m
41113,2,sanchelo,2196,0,0,1,1,0.0%,40m
41113,2,OzcV,2196,0,0,1,1,0.0%,28m
41143,1,FuturEgg,2195,1720,143,139,282,50.7%,36m
41143,2,TanZZzzz,2195,1514,96,94,190,50.5%,43m
41143,1,zionizos,2195,1533,83,78,161,51.6%,39m
41143,2,[Сold]ДжОнУиК,2195,477,19,14,33,57.6%,37m
41143,1,[zpn3]TrollToll,2195,548,19,22,41,46.3%,11m
41143,2,Drakula,2195,560,19,23,42,45.2%,8m
41143,2,BingeMaster,2195,462,17,21,38,44.7%,12m
41143,1,Vadinoy,2195,461,15,16,31,48.4%,51m
41143,1,Nicetolk,2195,364,11,10,21,52.4%,1h
41143,3,[ЗИБиАГ]SonorBodya,2195,180,9,18,27,33.3%,8m
41143,2,ZwEi,2195,101,5,5,10,50.0%,16m
41143,2,Hychion,2195,124,5,7,12,41.7%,8m
41143,2,Gwendalin,2195,0,4,1,5,80.0%,20m
41143,1,бобер,2195,189,4,9,13,30.8%,36m
41143,2,LieAbleitung,2195,138,3,8,11,27.3%,11m
41143,2,kef,2195,0,2,3,5,40.0%,44m
41143,2,JIEIE,2195,0,2,4,6,33.3%,11m
41143,1,pupok,2195,90,2,7,9,22.2%,47m
41143,1,warrior,2195,42,2,9,11,18.2%,16m
41143,2,borio,2195,0,1,1,2,50.0%,31m
41143,1,magn,2195,0,1,6,7,14.3%,1h
41143,2,jacouille,2195,0,0,1,1,0.0%,28m
41143,2,NadgobHol,2195,0,0,1,1,0.0%,44m
41143,2,KIRILL,2195,0,0,2,2,0.0%,26m
41143,2,Dimaandi,2195,0,0,4,4,0.0%,13m
41168,3,[Sc2V]joaquin,2194,1520,251,248,499,50.3%,46m
41168,1,Anders,2194,1707,110,108,218,50.5%,23m
41168,3,NecesaryEVIL,2194,1245,99,107,206,48.1%,1h
41168,1,amateus,2194,1633,61,62,123,49.6%,1h
41168,1,Kyaze,2194,721,41,47,88,46.6%,45m
41168,1,erem,2194,996,35,38,73,47.9%,3m
41168,1,Grelo,2194,956,31,36,67,46.3%,43m
41168,1,[Poker]merkuryo,2194,727,25,25,50,50.0%,1h
41168,2,Blaze,2194,444,16,14,30,53.3%,42m
41168,2,apus,2194,140,7,12,19,36.8%,13m
41168,1,maesking,2194,157,5,3,8,62.5%,2m
41168,2,Tøklane,2194,94,4,4,8,50.0%,1h
41168,1,[TuPiZi]MyTaBOR,2194,140,4,9,13,30.8%,13m
41168,1,[DarkTI]FreeMush,2194,40,2,5,7,28.6%,1h
41168,2,Diax,2194,139,2,6,8,25.0%,23m
41168,2,LazyTurtle,2194,30,1,1,2,50.0%,12m
41168,2,Sawel,2194,0,1,4,5,20.0%,38m
41168,1,Wickedone,2194,0,1,5,6,16.7%,34m
41168,2,[OTLSS]wyvernheart,2194,0,0,1,1,0.0%,52m
41168,2,Xtranghero,2194,0,0,1,1,0.0%,16m
41188,2,ricky,2193,1564,182,180,362,50.3%,6m
41188,1,Berschter,2193,1320,103,104,207,49.8%,1h
41188,1,Milce,2193,1254,47,51,98,48.0%,44m
41188,1,qwerty,2193,958,31,37,68,45.6%,30m
41188,2,Alysme,2193,752,30,38,68,44.1%,30m
41188,1,Baton,2193,601,22,19,41,53.7%,36m
41188,2,FReq,2193,335,12,17,29,41.4%,25m
41188,2,Meriodasu,2193,224,9,8,17,52.9%,11m
41188,1,ruslan,2193,350,9,10,19,47.4%,13m
41188,2,alexz,2193,156,6,4,10,60.0%,1h
41188,2,[NukeZ]VOLT,2193,180,6,5,11,54.5%,33m
41188,2,Axefighter,2193,96,4,5,9,44.4%,54m
41188,2,Overlord,2193,128,4,5,9,44.4%,7m
41188,1,Radons,2193,146,4,7,11,36.4%,41m
41188,3,Hiick,2193,146,4,12,16,25.0%,22m
41188,2,ApostaL,2193,94,3,6,9,33.3%,11m
41188,1,Mixax,2193,0,2,4,6,33.3%,26m
41188,2,Владичара,2193,30,1,3,4,25.0%,46m
41188,1,kolo,2193,0,1,6,7,14.3%,34m
41188,1,Славон,2193,48,1,8,9,11.1%,54m
41188,3,Capone,2193,48,1,8,9,11.1%,53m
41188,2,badukone,2193,0,0,1,1,0.0%,17m
41188,2,littlenemo,2193,0,0,5,5,0.0%,54m
41211,2,[NLLO]Alexoss,2192,1600,99,94,193,51.3%,43m
41211,2,Tonanusvic,2192,1510,54,59,113,47.8%,48m
41211,2,StevenGomman,2192,939,34,29,63,54.0%,6m
41211,2,[AFL]Behindyou,2192,724,29,26,55,52.7%,37m
41211,2,ghandy,2192,553,19,24,43,44.2%,54m
41211,1,JIRI,2192,343,10,19,29,34.5%,10m
41211,2,Osmo,2192,204,9,3,12,75.0%,48m
41211,2,Sanntan,2192,192,8,4,12,66.7%,12m
41211,1,MsLab,2192,241,8,8,16,50.0%,54m
41211,2,bredesen,2192,246,7,6,13,53.8%,56m
41211,2,sokol,2192,202,7,7,14,50.0%,8m
41211,1,KlementinV,2192,239,6,10,16,37.5%,2m
41211,1,ptflea,2192,192,6,12,18,33.3%,5m
41211,2,TAL,2192,193,5,3,8,62.5%,20m
41211,3,[krishu]Shadow,2192,62,5,6,11,45.5%,20m
41211,2,adamSpec,2192,96,4,1,5,80.0%,2m
41211,1,Blokeman,2192,68,4,11,15,26.7%,50m
41211,1,Grommash,2192,0,1,5,6,16.7%,1h
41211,2,DarkFire,2192,0,0,1,1,0.0%,11m
41211,1,Vegas,2192,0,0,5,5,0.0%,51m
41231,2,Brentus,2191,1638,86,78,164,52.4%,53m
41231,2,Kotopes,2191,830,34,30,64,53.1%,14m
41231,2,[KPZA]kirill,2191,832,29,32,61,47.5%,2m
41231,1,Zvirbulis,2191,652,18,24,42,42.9%,20m
41231,2,pajsarn,2191,390,14,15,29,48.3%,37m
41231,2,Punker,2191,412,14,17,31,45.2%,27m
41231,2,nehmo,2191,269,12,11,23,52.2%,38m
41231,1,luxepower,2191,257,10,5,15,66.7%,31m
41231,2,Foldike,2191,210,7,8,15,46.7%,44m
41231,1,pulse,2191,172,6,10,16,37.5%,34m
41231,1,Cabal,2191,122,5,9,14,35.7%,3m
41231,1,BOgdan,2191,102,3,3,6,50.0%,33m
41231,1,Ferdossi,2191,144,3,7,10,30.0%,26m
41231,1,DevilNT,2191,36,2,6,8,25.0%,12m
41231,2,[PGYT]Retamik,2191,0,1,0,1,100.0%,53m
41231,3,SPIDOZNICK,2191,97,1,1,2,50.0%,54m
41231,2,Blossom,2191,94,1,5,6,16.7%,49m
41231,2,Bommel,2191,0,0,1,1,0.0%,22m
41231,2,TOSHETO,2191,73,0,2,2,0.0%,54m
41231,2,[Papka4]PapkaЧ,2191,0,0,2,2,0.0%,15m
41251,1,MrAlexWhite,2190,1200,42,46,88,47.7%,17m
41251,2,NIKITOS,2190,587,23,27,50,46.0%,38m
41251,1,MadTrIx,2190,368,18,16,34,52.9%,31m
41251,1,frosty,2190,358,13,16,29,44.8%,38m
41251,2,Ganibal,2190,270,10,12,22,45.5%,50m
41251,1,ARTHAS,2190,340,9,17,26,34.6%,50m
41251,1,Darkwolf,2190,284,7,17,24,29.2%,2m
41251,2,Byssss,2190,176,5,6,11,45.5%,1h
41251,3,Paddyff,2190,94,5,12,17,29.4%,49m
41251,1,[1DZ1]пИДоИТЕР,2190,165,4,6,10,40.0%,26m
41251,1,CcTop,2190,120,3,1,4,75.0%,47m
41251,2,Bandwuermche,2190,0,3,2,5,60.0%,11m
41251,2,[TERIZM]TERRARIST,2190,0,1,0,1,100.0%,17m
41251,1,Predator,2190,0,1,0,1,100.0%,54m
41251,2,Štanci,2190,0,1,2,3,33.3%,41m
41251,2,[NeCriN]ZizouLarson,2190,32,1,2,3,33.3%,33m
41251,2,DoderDik,2190,30,1,2,3,33.3%,51m
41251,2,Anglachel,2190,0,1,4,5,20.0%,11m
41251,1,ZerGyHuK,2190,0,1,7,8,12.5%,14m
41251,2,blejer,2190,0,0,1,1,0.0%,12m
41251,2,[QLSS]DevoltN,2190,0,0,1,1,0.0%,1h
41251,2,Wimmeltof,2190,0,0,1,1,0.0%,33m
41273,1,OldSkuLL,2189,1726,166,169,335,49.6%,13m
41273,1,hotfire,2189,607,43,31,74,58.1%,25m
41273,2,VaasKasich,2189,792,27,34,61,44.3%,46m
41273,1,[КРН]Ibrik,2189,630,20,21,41,48.8%,36m
41273,1,Kira,2189,666,20,24,44,45.5%,48m
41273,1,[qwqw]iliili,2189,622,20,28,48,41.7%,19m
41273,2,Regas,2189,470,16,19,35,45.7%,1h
41273,1,[ЭЩКЕРЕ]Mihals,2189,386,15,12,27,55.6%,1h
41273,2,Torpedo,2189,398,14,9,23,60.9%,20m
41273,1,nnm,2189,498,13,22,35,37.1%,47m
41273,2,Abutony,2189,172,8,8,16,50.0%,2m
41273,2,szamanzagaj,2189,170,6,5,11,54.5%,1h
41273,3,[SCSh1t]Kozis,2189,200,6,7,13,46.2%,4m
41273,1,Avar,2189,136,4,8,12,33.3%,27m
41273,2,Rambozelle,2189,58,3,1,4,75.0%,29m
41273,1,OSIRIS,2189,145,3,5,8,37.5%,24m
41273,2,vlad,2189,92,3,8,11,27.3%,11m
41273,2,luczefer,2189,30,2,0,2,100.0%,9m
41273,2,zerg,2189,30,2,2,4,50.0%,39m
41273,2,VALLANDER,2189,114,2,6,8,25.0%,51m
41273,2,Leonard,2189,30,1,1,2,50.0%,52m
41273,2,GeraltOutlaw,2189,30,1,2,3,33.3%,50m
41273,2,[USST]Sil,2189,46,1,6,7,14.3%,52m
41273,3,Gurumanik,2189,0,0,3,3,0.0%,1h
41297,1,[PRTING]Zergulator,2188,1576,423,431,854,49.5%,50m
41297,1,Vlad,2188,1643,162,154,316,51.3%,48m
41297,3,DYSTREX,2188,971,47,71,118,39.8%,16m
41297,2,Fromage,2188,1198,41,59,100,41.0%,26m
41297,2,toss,2188,847,31,27,58,53.4%,56m
41297,3,ostry,2188,684,25,37,62,40.3%,13m
41297,2,XxNikarroxX,2188,567,24,13,37,64.9%,12m
41297,2,BigBlueBlock,2188,531,20,22,42,47.6%,49m
41297,1,maronx,2188,714,20,28,48,41.7%,1h
41297,1,Feri,2188,443,17,17,34,50.0%,1h
41297,2,Dubsteak,2188,320,12,9,21,57.1%,19m
41297,1,Atilius,2188,342,9,21,30,30.0%,12m
41297,2,Lin,2188,216,8,9,17,47.1%,22m
41297,2,Дархен,2188,116,4,3,7,57.1%,45m
41297,2,gundabadboyz,2188,140,4,4,8,50.0%,23m
41297,2,Helt,2188,160,4,5,9,44.4%,7m
41297,1,Dante,2188,193,4,8,12,33.3%,5m
41297,1,[0110]Kanima,2188,158,4,11,15,26.7%,8m
41297,3,Adrenalin,2188,175,4,15,19,21.1%,43m
41297,1,Vindedious,2188,142,3,7,10,30.0%,39m
41297,2,unamedjfw,2188,30,1,2,3,33.3%,18m
41297,2,Okazaki,2188,30,1,4,5,20.0%,14m
41297,2,MadDemon,2188,0,1,4,5,20.0%,45m
41297,2,TheTerranGuy,2188,88,1,5,6,16.7%,30m
41297,2,barnus,2188,0,1,8,9,11.1%,22m
41297,2,Moncho,2188,0,0,3,3,0.0%,56m
41323,2,Alfor,2187,1233,58,56,114,50.9%,48m
41323,2,CLOVICH,2187,1312,58,59,117,49.6%,53m
41323,2,[Laröd]Hobbleknee,2187,668,25,26,51,49.0%,12m
41323,2,Ghost,2187,426,16,20,36,44.4%,54m
41323,2,CrankyPants,2187,402,14,26,40,35.0%,53m
41323,2,oCx,2187,274,10,7,17,58.8%,2m
41323,2,StrangeWay,2187,144,5,5,10,50.0%,3m
41323,2,DarkArthur,2187,92,4,4,8,50.0%,3m
41323,2,руслан,2187,86,4,4,8,50.0%,53m
41323,2,NKNickSkill,2187,124,4,7,11,36.4%,33m
41323,1,cazoubiz,2187,96,3,9,12,25.0%,54m
41323,2,olfleouf,2187,66,2,1,3,66.7%,54m
41323,1,каракc,2187,97,2,2,4,50.0%,36m
41323,2,hodigol,2187,30,2,2,4,50.0%,32m
41323,2,rasX,2187,94,2,4,6,33.3%,32m
41323,1,bigGeneral,2187,96,2,5,7,28.6%,33m
41323,1,sportblr,2187,0,2,8,10,20.0%,56m
41323,2,Swrd,2187,0,1,0,1,100.0%,4m
41323,2,OmegaVlad,2187,0,1,0,1,100.0%,12m
41323,2,Vendetta,2187,0,1,0,1,100.0%,30m
41323,2,schippelah,2187,0,1,2,3,33.3%,45m
41323,1,Stephane,2187,0,1,6,7,14.3%,26m
41323,2,Yokozuna,2187,0,0,2,2,0.0%,47m
41323,2,Sawra,2187,0,0,5,5,0.0%,10m
41347,2,rOt,2186,1516,116,113,229,50.7%,47m
41347,2,MadMax,2186,560,46,48,94,48.9%,52m
41347,1,Kelte,2186,829,34,36,70,48.6%,34m
41347,2,Cem,2186,937,34,38,72,47.2%,33m
41347,3,Xulortin,2186,711,30,30,60,50.0%,36m
41347,2,Chop,2186,585,21,31,52,40.4%,36m
41347,1,Arsenic,2186,477,20,16,36,55.6%,19m
41347,2,TheMLGSword,2186,472,18,17,35,51.4%,6m
41347,2,JTBK,2186,408,14,11,25,56.0%,37m
41347,1,[SPAINs]matrizzxx,2186,293,12,8,20,60.0%,44m
41347,1,[21789]kevin,2186,424,12,15,27,44.4%,37m
41347,1,NavI,2186,256,7,12,19,36.8%,53m
41347,2,Зашибиь,2186,162,6,10,16,37.5%,22m
41347,2,танк,2186,133,5,3,8,62.5%,1h
41347,3,Disonda,2186,161,5,11,16,31.2%,36m
41347,1,diavobox,2186,192,4,8,12,33.3%,36m
41347,2,antoine,2186,117,3,4,7,42.9%,3m
41347,3,Uchiha,2186,135,3,11,14,21.4%,21m
41347,2,Митька,2186,0,1,4,5,20.0%,56m
41347,1,Mindhunter,2186,0,1,7,8,12.5%,28m
41347,2,[LSPs]Borrallo,2186,0,0,1,1,0.0%,47m
41347,2,szijastock,2186,0,0,1,1,0.0%,11m
41347,2,MaxiPRO,2186,0,0,1,1,0.0%,54m
41347,2,Msew,2186,0,0,2,2,0.0%,45m
41347,2,tum,2186,0,0,3,3,0.0%,36m
41372,1,[LKDSC2]Shaihulud,2185,1675,249,247,496,50.2%,1h
41372,2,Ringo,2185,1249,64,70,134,47.8%,52m
41372,1,[ADHDMA]Water,2185,595,20,23,43,46.5%,9m
41372,2,CLON,2185,356,16,14,30,53.3%,12m
41372,1,Marshal,2185,461,13,20,33,39.4%,2m
41372,1,Wudel,2185,469,13,23,36,36.1%,12m
41372,2,Manurk,2185,210,9,5,14,64.3%,48m
41372,1,VIKTORvPOPOV,2185,293,8,10,18,44.4%,27m
41372,2,LordOfSouls,2185,279,8,13,21,38.1%,1h
41372,2,SDanny,2185,248,7,16,23,30.4%,28m
41372,2,Gryphon,2185,141,5,4,9,55.6%,42m
41372,2,JorgeLL,2185,162,5,6,11,45.5%,20m
41372,1,Arhanghel,2185,96,3,3,6,50.0%,6m
41372,2,[SРID]artem,2185,60,3,4,7,42.9%,19m
41372,2,SuperAshe,2185,30,2,5,7,28.6%,1h
41372,2,Breaksmith,2185,48,2,6,8,25.0%,31m
41372,2,CuddlyPillow,2185,58,2,7,9,22.2%,39m
41372,2,seven,2185,0,1,4,5,20.0%,1h
41372,1,Bolat,2185,0,1,6,7,14.3%,13m
41372,2,xxxfrixxx,2185,0,0,1,1,0.0%,37m
41372,2,[TTCF]MrAnengyst,2185,0,0,1,1,0.0%,17m
41372,2,[96LGCH]BrawlLeon,2185,0,0,1,1,0.0%,1h
41372,2,[krest]Azthurano,2185,0,0,2,2,0.0%,27m
41372,1,wolfy,2185,0,0,4,4,0.0%,24m
41396,3,MAR,2184,455,28,40,68,41.2%,53m
41396,2,Engelking,2184,527,23,19,42,54.8%,3m
41396,1,[TODOW]Den,2184,694,21,29,50,42.0%,26m
41396,3,GUGUMAY,2184,222,13,10,23,56.5%,16m
41396,1,Daniel,2184,474,13,21,34,38.2%,20m
41396,1,phalanx,2184,366,12,10,22,54.5%,16m
41396,2,Legollas,2184,306,11,15,26,42.3%,1h
41396,1,[BRose]RockMet,2184,224,8,12,20,40.0%,52m
41396,2,FairCry,2184,196,7,5,12,58.3%,30m
41396,1,[GRINGO]Heybi,2184,224,6,10,16,37.5%,34m
41396,1,альфашлюха,2184,144,5,6,11,45.5%,29m
41396,1,Luiggggi,2184,192,5,11,16,31.2%,24m
41396,2,drfab,2184,32,3,4,7,42.9%,54m
41396,2,ПапаКарло,2184,48,3,4,7,42.9%,12m
41396,1,Аларак,2184,48,2,0,2,100.0%,56m
41396,2,Deejay,2184,30,2,7,9,22.2%,19m
41396,2,Cambion,2184,88,1,5,6,16.7%,54m
41396,2,vozhyk,2184,0,0,1,1,0.0%,44m
41396,2,Nebulys,2184,0,0,2,2,0.0%,56m
41396,2,Luke,2184,0,0,5,5,0.0%,54m
41416,2,Olevonpoff,2183,1622,126,132,258,48.8%,27m
41416,1,МрачныйВорон,2183,1441,72,77,149,48.3%,52m
41416,2,GhGiov,2183,1182,47,41,88,53.4%,1m
41416,1,cylon,2183,1114,46,50,96,47.9%,34m
41416,2,Alarak,2183,869,36,26,62,58.1%,54m
41416,1,АЛЛ,2183,1039,35,43,78,44.9%,20m
41416,1,[OverX]Arawnar,2183,432,24,23,47,51.1%,38m
41416,1,FavaroLeone,2183,669,22,29,51,43.1%,31m
41416,1,[InTime]WarParadigm,2183,343,17,13,30,56.7%,42m
41416,3,SlayerOD,2183,408,16,23,39,41.0%,40m
41416,2,flesh,2183,425,15,20,35,42.9%,26m
41416,2,trillking,2183,238,8,13,21,38.1%,2m
41416,2,юра,2183,174,6,9,15,40.0%,31m
41416,3,ptrmarvel,2183,192,6,12,18,33.3%,6m
41416,1,Notti,2183,143,5,8,13,38.5%,24m
41416,1,Cancellar,2183,164,4,6,10,40.0%,38m
41416,1,Gabrielbuth,2183,142,4,9,13,30.8%,51m
41416,2,[H0ly]miniRo,2183,60,2,2,4,50.0%,48m
41416,1,[PGYT]LiquidClem,2183,120,2,2,4,50.0%,31m
41416,1,Mirage,2183,130,2,12,14,14.3%,28m
41416,2,Ganiball,2183,0,1,0,1,100.0%,52m
41416,2,[SQUI]Lithium,2183,30,1,1,2,50.0%,44m
41416,2,Litourd,2183,30,1,2,3,33.3%,17m
41416,2,Tusko,2183,0,1,4,5,20.0%,41m
41416,2,RatonPoeta,2183,94,1,5,6,16.7%,3m
41416,2,Matze,2183,0,0,1,1,0.0%,30m
41416,2,SLAVIK,2183,0,0,1,1,0.0%,42m
41416,2,Canalet,2183,0,0,5,5,0.0%,53m
41444,1,Akoleg,2182,1641,90,102,192,46.9%,1h
41444,2,Friendsen,2182,1306,55,47,102,53.9%,31m
41444,2,Cesc,2182,626,23,28,51,45.1%,56m
41444,1,твойбатя,2182,552,20,29,49,40.8%,23m
41444,2,Ramzie,2182,332,12,15,27,44.4%,1h
41444,2,supermario,2182,349,11,9,20,55.0%,49m
41444,2,ShnecK,2182,243,9,3,12,75.0%,42m
41444,1,TOCS,2182,265,6,12,18,33.3%,5m
41444,2,tornado,2182,177,6,12,18,33.3%,18m
41444,1,Hallelujah,2182,156,5,11,16,31.2%,20m
41444,2,Zene,2182,94,4,2,6,66.7%,52m
41444,2,claylord,2182,120,4,4,8,50.0%,52m
41444,2,[Kuro]Kurogano,2182,62,4,5,9,44.4%,19m
41444,2,Madbro,2182,62,3,1,4,75.0%,37m
41444,3,DarkSerg,2182,133,3,9,12,25.0%,24m
41444,1,ZergoMurlock,2182,120,2,4,6,33.3%,17m
41444,2,monorailcat,2182,0,2,8,10,20.0%,5m
41444,2,ZERATUL,2182,30,1,4,5,20.0%,54m
41444,2,Mraknes,2182,0,1,4,5,20.0%,31m
41444,1,MrG,2182,0,1,5,6,16.7%,2m
41444,2,elmasmalo,2182,0,0,2,2,0.0%,36m
41444,2,muravei,2182,0,0,2,2,0.0%,30m
41444,2,Aspid,2182,0,0,5,5,0.0%,11m
41467,3,ArdoMelnikov,2181,1462,116,117,233,49.8%,24m
41467,3,atibarsgen,2181,876,51,54,105,48.6%,18m
41467,1,illusha,2181,924,30,31,61,49.2%,50m
41467,1,[ZERGTB]Malsey,2181,785,26,32,58,44.8%,12m
41467,1,REX,2181,586,17,25,42,40.5%,39m
41467,2,poni,2181,332,12,15,27,44.4%,12m
41467,1,[wazzo]Arkanitt,2181,242,8,2,10,80.0%,1h
41467,1,ANANDA,2181,250,7,11,18,38.9%,22m
41467,2,[21789]nuriki,2181,44,4,4,8,50.0%,38m
41467,1,Текс,2181,148,4,4,8,50.0%,30m
41467,2,Kir,2181,92,3,3,6,50.0%,48m
41467,1,Blind,2181,48,3,7,10,30.0%,5m
41467,2,Milan,2181,60,2,2,4,50.0%,52m
41467,1,МастерЙода,2181,101,2,8,10,20.0%,50m
41467,1,Tyrannus,2181,73,2,8,10,20.0%,34m
41467,2,PatvilAVGN,2181,46,1,1,2,50.0%,33m
41467,2,Flockie,2181,0,1,1,2,50.0%,52m
41467,2,Psly,2181,0,1,2,3,33.3%,50m
41467,1,Sven,2181,0,1,6,7,14.3%,27m
41467,2,deniolo,2181,0,0,1,1,0.0%,49m
41467,2,Virginia,2181,0,0,1,1,0.0%,47m
41488,1,Hayabusa,2180,1241,216,220,436,49.5%,47m
41488,1,Wortspiel,2180,1482,53,60,113,46.9%,34m
41488,3,[xVdMx]Coeppi,2180,1252,50,65,115,43.5%,12m
41488,1,NikoGeG,2180,637,37,35,72,51.4%,46m
41488,1,[ISV]robert,2180,1020,35,41,76,46.1%,53m
41488,1,niknikitin,2180,364,18,13,31,58.1%,52m
41488,1,trastar,2180,352,15,14,29,51.7%,23m
41488,1,WillBeSick,2180,444,13,17,30,43.3%,56m
41488,1,Daxos,2180,248,7,9,16,43.8%,23m
41488,2,Kain,2180,241,6,11,17,35.3%,30m
41488,2,sophist,2180,202,4,7,11,36.4%,38m
41488,1,frantimir,2180,143,3,5,8,37.5%,44m
41488,2,[SS2208]SergZerg,2180,30,2,0,2,100.0%,19m
41488,2,NeYson,2180,0,2,8,10,20.0%,17m
41488,2,Mekz,2180,0,1,0,1,100.0%,19m
41488,2,[Рубль]ROFLER,2180,32,1,4,5,20.0%,22m
41488,2,BLACKMOUSE,2180,0,1,5,6,16.7%,38m
41488,2,lolkicker,2180,88,1,5,6,16.7%,53m
41488,1,TOMY,2180,0,1,7,8,12.5%,38m
41488,2,ProtossFreak,2180,0,0,1,1,0.0%,53m
41488,2,Thore,2180,0,0,1,1,0.0%,2m
41488,2,plusmore,2180,0,0,1,1,0.0%,36m
41488,2,killer,2180,0,0,1,1,0.0%,24m
41511,2,Novart,2179,453,16,23,39,41.0%,3m
41511,2,Pashgun,2179,433,15,20,35,42.9%,28m
41511,2,Мировинг,2179,226,8,9,17,47.1%,6m
41511,2,Wolfer,2179,200,7,10,17,41.2%,26m
41511,2,IsKay,2179,151,5,4,9,55.6%,37m
41511,1,WeiserJohann,2179,110,5,9,14,35.7%,52m
41511,2,Gupmup,2179,64,4,4,8,50.0%,44m
41511,1,Busterenko,2179,97,3,5,8,37.5%,34m
41511,1,[FFD]cCFamOusCc,2179,96,3,9,12,25.0%,27m
41511,2,[Nüsse]TopSekret,2179,30,2,1,3,66.7%,52m
41511,1,FFIGROKOT,2179,48,2,6,8,25.0%,31m
41511,2,MooN,2179,0,1,3,4,25.0%,44m
41511,1,Gusto,2179,40,1,4,5,20.0%,39m
41511,2,[NSNW]Hyb,2179,0,0,1,1,0.0%,43m
41511,2,Hunter,2179,0,0,5,5,0.0%,54m
41526,1,Yoghy,2178,1665,129,137,266,48.5%,42m
41526,1,Craftycurts,2178,1473,92,93,185,49.7%,46m
41526,2,Maene,2178,1395,56,46,102,54.9%,52m
41526,1,dim,2178,1413,54,51,105,51.4%,1h
41526,2,Myxomop,2178,1084,39,44,83,47.0%,30m
41526,2,Алекс,2178,739,31,24,55,56.4%,37m
41526,3,DEMIGOD,2178,828,29,38,67,43.3%,27m
41526,1,Macinator,2178,609,22,28,50,44.0%,54m
41526,3,AlexeyMega,2178,560,21,24,45,46.7%,45m
41526,2,pexotinec,2178,238,9,10,19,47.4%,48m
41526,2,шмэл,2178,60,6,3,9,66.7%,28m
41526,1,Jojo,2178,194,6,11,17,35.3%,50m
41526,2,RōniN,2178,142,5,2,7,71.4%,3m
41526,3,Fluttershy,2178,195,5,8,13,38.5%,32m
41526,1,kism,2178,142,4,10,14,28.6%,36m
41526,2,Zébrax,2178,0,3,2,5,60.0%,42m
41526,2,powercell,2178,44,3,5,8,37.5%,41m
41526,2,Muumbaba,2178,0,3,7,10,30.0%,25m
41526,2,komazZZ,2178,0,2,3,5,40.0%,3m
41526,2,darkpredator,2178,0,2,5,7,28.6%,43m
41526,1,STORN,2178,0,2,6,8,25.0%,52m
41526,1,[LIQUID]Giamo,2178,0,1,0,1,100.0%,26m
41526,2,Zoragstyle,2178,0,1,4,5,20.0%,15m
41526,2,[PiS0S]xarlampNooBy,2178,88,1,5,6,16.7%,42m
41526,2,[ProbKA]kasik,2178,0,0,1,1,0.0%,52m
41526,2,IXDIXaTuKo,2178,0,0,3,3,0.0%,34m
41526,2,[5thT]imikenod,2178,0,0,3,3,0.0%,15m
41553,1,scar,2177,1697,147,144,291,50.5%,34m
41553,1,Typhlosis,2177,967,48,46,94,51.1%,34m
41553,2,[WT3]Killer,2177,889,36,29,65,55.4%,44m
41553,1,Naruto,2177,506,28,21,49,57.1%,51m
41553,2,SeregaBicker,2177,510,19,21,40,47.5%,50m
41553,2,[Catory]Bricker,2177,412,14,11,25,56.0%,19m
41553,2,draguion,2177,222,8,13,21,38.1%,3m
41553,1,Southkenny,2177,238,5,10,15,33.3%,24m
41553,2,Кароль,2177,141,4,3,7,57.1%,49m
41553,1,Egnaz,2177,111,4,5,9,44.4%,34m
41553,2,LEGGEONS,2177,58,4,6,10,40.0%,47m
41553,2,[НЕТУДА]Doshik,2177,94,3,5,8,37.5%,49m
41553,1,[GfG]Bilbo,2177,78,3,7,10,30.0%,7m
41553,1,Yury,2177,74,3,7,10,30.0%,34m
41553,2,SPECTRA,2177,30,2,0,2,100.0%,1h
41553,2,[Tic2]Satrox,2177,64,2,3,5,40.0%,3m
41553,2,[Catory]Kychcio,2177,121,2,4,6,33.3%,1h
41553,2,[DaFF]Herom,2177,58,2,5,7,28.6%,28m
41553,2,kraken,2177,0,1,0,1,100.0%,16m
41553,1,PuHbIЧ,2177,0,1,6,7,14.3%,26m
41553,2,BlackMonkey,2177,0,0,1,1,0.0%,31m
41553,2,OrcoBello,2177,0,0,1,1,0.0%,49m
41553,1,Reinoff,2177,0,0,2,2,0.0%,34m
41553,1,MajklT,2177,0,0,4,4,0.0%,56m
41553,2,Maxim,2177,0,0,5,5,0.0%,15m
41578,2,Steph,2176,1463,83,73,156,53.2%,45m
41578,3,kozejro,2176,1229,55,54,109,50.5%,31m
41578,2,WooDoo,2176,1130,45,48,93,48.4%,45m
41578,1,Vexra,2176,526,24,27,51,47.1%,50m
41578,3,Mar,2176,484,19,31,50,38.0%,21m
41578,1,Анвар,2176,627,18,23,41,43.9%,34m
41578,1,Zan,2176,408,13,17,30,43.3%,20m
41578,2,AlfaTrion,2176,380,13,17,30,43.3%,48m
41578,2,[SNAG]theNd,2176,350,12,12,24,50.0%,19m
41578,3,Wanderer,2176,312,10,20,30,33.3%,38m
41578,2,MaLiFiKaR,2176,260,9,9,18,50.0%,48m
41578,2,TuberG,2176,148,8,7,15,53.3%,31m
41578,2,Scarzul,2176,48,5,2,7,71.4%,35m
41578,2,daeril,2176,148,5,8,13,38.5%,8m
41578,2,Nick,2176,58,3,0,3,100.0%,6m
41578,1,[TgK]YaDaG,2176,145,3,5,8,37.5%,34m
41578,1,mkzloy,2176,34,2,5,7,28.6%,36m
41578,2,BlackVolf,2176,0,1,0,1,100.0%,42m
41578,2,Dimitry,2176,30,1,1,2,50.0%,14m
41578,3,Nic,2176,0,0,1,1,0.0%,54m
41578,3,[Vepar]Cyclop,2176,0,0,5,5,0.0%,15m
41599,1,HeavensAtlas,2175,1286,244,256,500,48.8%,43m
41599,1,Collaps,2175,1245,87,86,173,50.3%,27m
41599,2,Sokolof,2175,1448,56,58,114,49.1%,45m
41599,2,Predator,2175,809,44,36,80,55.0%,34m
41599,1,Jokerrr,2175,712,25,30,55,45.5%,27m
41599,2,Alfa,2175,590,19,25,44,43.2%,45m
41599,1,EasyKill,2175,372,16,16,32,50.0%,2m
41599,2,FoxxyGrandpa,2175,254,10,8,18,55.6%,1h
41599,1,[HAVTT]NSC,2175,144,9,10,19,47.4%,4m
41599,1,[OGCC]CHAZAK,2175,224,8,10,18,44.4%,1h
41599,3,eomerr,2175,197,6,13,19,31.6%,31m
41599,1,VitorNeto,2175,91,5,3,8,62.5%,32m
41599,3,Commander,2175,115,5,6,11,45.5%,31m
41599,2,wArCartoO,2175,140,5,18,23,21.7%,1h
41599,2,Morpheus,2175,30,2,1,3,66.7%,48m
41599,2,Strud,2175,66,2,4,6,33.3%,16m
41599,1,Ghost,2175,0,2,5,7,28.6%,1h
41599,2,SuperFussel,2175,42,2,5,7,28.6%,36m
41599,1,FaerVover,2175,48,2,9,11,18.2%,43m
41599,2,celmer,2175,0,1,1,2,50.0%,22m
41599,2,LTa,2175,88,1,1,2,50.0%,38m
41599,1,Dany,2175,48,1,4,5,20.0%,9m
41599,2,[NØX]Sayajin,2175,0,0,1,1,0.0%,48m
41599,2,[FIGHTR]Fatidic,2175,0,0,2,2,0.0%,55m
41599,2,minecraft,2175,0,0,2,2,0.0%,8m
41599,2,JayDee,2175,0,0,4,4,0.0%,54m
41625,1,Devx,2174,1494,58,52,110,52.7%,34m
41625,2,Conker,2174,454,58,61,119,48.7%,38m
41625,3,AzzieElbub,2174,815,37,55,92,40.2%,1h
41625,1,nebxort,2174,675,29,29,58,50.0%,45m
41625,1,Ozymandias,2174,476,28,23,51,54.9%,42m
41625,3,moonhide,2174,428,26,33,59,44.1%,45m
41625,3,Tiemes,2174,298,12,10,22,54.5%,52m
41625,1,MaNoWar,2174,268,11,11,22,50.0%,43m
41625,2,[ROTR]ArtiSmail,2174,280,10,8,18,55.6%,49m
41625,3,LiquidLight,2174,227,9,12,21,42.9%,1h
41625,2,Fawarit,2174,198,8,9,17,47.1%,19m
41625,2,Azte,2174,163,4,3,7,57.1%,33m
41625,2,DELL,2174,132,4,8,12,33.3%,16m
41625,2,Stargazer,2174,60,3,1,4,75.0%,30m
41625,2,Qanths,2174,58,3,1,4,75.0%,53m
41625,2,ВоваЗадний,2174,86,3,2,5,60.0%,36m
41625,2,[GTDK]Paucix,2174,148,3,9,12,25.0%,16m
41625,2,[Scvs]CyberDog,2174,58,2,2,4,50.0%,1h
41625,2,Arthasacafé,2174,32,2,4,6,33.3%,1h
41625,1,JoséZet,2174,141,2,5,7,28.6%,38m
41625,1,Forewer,2174,42,2,7,9,22.2%,44m
41625,2,[Raid13]ghostonlive,2174,0,0,1,1,0.0%,43m
41625,2,[Miho]Tyckin,2174,0,0,1,1,0.0%,54m
41625,2,Andonisobri,2174,0,0,1,1,0.0%,44m
41625,2,KapitanJakes,2174,0,0,1,1,0.0%,17m
41625,2,Klyftan,2174,0,0,2,2,0.0%,23m
41651,1,[Jail]Daszbur,2173,1481,113,114,227,49.8%,41m
41651,1,Фартовый,2173,1638,68,76,144,47.2%,46m
41651,2,[zsír]hukkle,2173,625,26,20,46,56.5%,38m
41651,1,Murphy,2173,657,19,26,45,42.2%,54m
41651,1,gomesh,2173,428,17,16,33,51.5%,44m
41651,2,MAESTRO,2173,304,11,5,16,68.8%,37m
41651,2,Tarsier,2173,128,10,8,18,55.6%,17m
41651,1,LENINMARCS,2173,333,10,15,25,40.0%,1h
41651,2,eliotnezz,2173,108,7,10,17,41.2%,25m
41651,2,ImWorse,2173,176,6,8,14,42.9%,33m
41651,2,Kldyn,2173,118,5,5,10,50.0%,52m
41651,2,ThugLife,2173,82,4,5,9,44.4%,32m
41651,3,[PNKS]Епвшмть,2173,157,4,11,15,26.7%,52m
41651,2,[13NRV]Nerf,2173,58,3,0,3,100.0%,33m
41651,2,Сирано,2173,108,3,4,7,42.9%,45m
41651,3,iiiiiiiiiii,2173,123,3,8,11,27.3%,45m
41651,2,Elrob,2173,114,2,2,4,50.0%,18m
41651,2,ZiSheTou,2173,0,1,0,1,100.0%,46m
41651,1,AlexHUN,2173,0,1,0,1,100.0%,29m
41651,1,[Wamaj]DrakoaoKakao,2173,0,1,1,2,50.0%,28m
41651,2,[ЭтоНе]Озабоченный,2173,96,1,1,2,50.0%,2m
41651,2,[EXTTS]spartan,2173,0,1,1,2,50.0%,6m
41651,2,hagen,2173,32,1,3,4,25.0%,13m
41651,2,Freeweller,2173,0,0,1,1,0.0%,48m
41651,1,Arkasha,2173,0,0,3,3,0.0%,52m
41651,2,catmaster,2173,0,0,3,3,0.0%,24m
41651,2,popeig,2173,0,0,5,5,0.0%,21m
41678,1,sinkelis,2172,1438,117,112,229,51.1%,19m
41678,1,[vandal]Rob,2172,1709,117,117,234,50.0%,14m
41678,2,Artunion,2172,1523,93,103,196,47.4%,21m
41678,2,ReM,2172,1462,86,80,166,51.8%,55m
41678,3,Vinda,2172,1597,81,94,175,46.3%,41m
41678,2,Oggenhuber,2172,1030,36,47,83,43.4%,42m
41678,1,Pozitiv,2172,915,30,40,70,42.9%,54m
41678,2,[Ôline]ultac,2172,700,24,28,52,46.2%,43m
41678,3,Wojt,2172,674,23,31,54,42.6%,15m
41678,2,Zucketorte,2172,499,20,18,38,52.6%,13m
41678,2,Ibsen,2172,327,10,12,22,45.5%,20m
41678,1,[IRSGI]AdroseML,2172,237,8,13,21,38.1%,27m
41678,1,Lima,2172,226,6,13,19,31.6%,1h
41678,1,FIFer,2172,186,5,5,10,50.0%,1h
41678,2,Luxck,2172,90,4,5,9,44.4%,38m
41678,3,Eraser,2172,64,4,11,15,26.7%,33m
41678,2,[Star57]Сольпуга,2172,58,3,3,6,50.0%,54m
41678,1,Amigos,2172,0,2,9,11,18.2%,6m
41678,1,CUSTODES,2172,48,1,5,6,16.7%,24m
41678,2,Dolvas,2172,0,0,1,1,0.0%,1h
41678,2,SpaceWalker,2172,0,0,1,1,0.0%,54m
41678,2,Rico,2172,0,0,5,5,0.0%,12m
41700,3,Pussiboy,2171,536,20,37,57,35.1%,13m
41700,2,Melky,2171,420,16,19,35,45.7%,12m
41700,2,TryOnceMore,2171,418,15,12,27,55.6%,46m
41700,3,seeyaa,2171,162,9,13,22,40.9%,44m
41700,2,[Z3RGTV]Mihan,2171,176,7,3,10,70.0%,45m
41700,2,[LeWin]TotalTalent,2171,197,6,7,13,46.2%,1h
41700,2,LUCA,2171,58,3,0,3,100.0%,7m
41700,2,Artemis,2171,90,3,6,9,33.3%,48m
41700,2,Tarvanis,2171,122,3,7,10,30.0%,45m
41700,2,[Re342]Inqvizitor,2171,60,2,4,6,33.3%,45m
41700,2,sergeygt,2171,0,1,0,1,100.0%,45m
41700,1,johnnystar,2171,48,1,2,3,33.3%,51m
41700,1,BigASsMattaF,2171,0,1,5,6,16.7%,33m
41700,3,Pazzer,2171,0,0,1,1,0.0%,8m
41700,2,Nick,2171,0,0,1,1,0.0%,8m
41700,2,Quity,2171,0,0,1,1,0.0%,43m
41700,2,Калибан,2171,0,0,1,1,0.0%,45m
41700,2,kotonator,2171,0,0,2,2,0.0%,6m
41700,2,MeisterHawk,2171,0,0,5,5,0.0%,6m
41700,2,[DL2006]waspd,2171,0,0,5,5,0.0%,48m
41720,2,Симач,2170,1133,59,59,118,50.0%,19m
41720,1,BoBObOLIciU,2170,772,30,30,60,50.0%,19m
41720,2,Zenec,2170,468,16,12,28,57.1%,1h
41720,2,ClaOMaMaOSa,2170,412,15,13,28,53.6%,54m
41720,2,[CxCx]димидролл,2170,446,14,19,33,42.4%,43m
41720,1,uniSon,2170,100,6,6,12,50.0%,52m
41720,2,ZabójczyPies,2170,212,6,13,19,31.6%,8m
41720,3,Corocotas,2170,162,6,19,25,24.0%,9m
41720,1,[BBorne]funkymonk,2170,142,5,10,15,33.3%,50m
41720,2,[CRLTNS]Alberto,2170,88,4,3,7,57.1%,48m
41720,1,RunnerMan,2170,42,4,5,9,44.4%,1h
41720,2,maNN,2170,30,2,0,2,100.0%,52m
41720,1,[Buldog]proKirft,2170,97,2,2,4,50.0%,31m
41720,1,ouioui,2170,48,2,8,10,20.0%,29m
41720,2,Гераклион,2170,0,1,0,1,100.0%,12m
41720,2,swarmoneoone,2170,88,1,1,2,50.0%,26m
41720,1,СолоМон,2170,97,1,3,4,25.0%,33m
41720,2,[NoeSS]Agravaine,2170,36,1,4,5,20.0%,26m
41720,2,SebiAghe,2170,0,1,6,7,14.3%,6m
41720,1,Immortal,2170,0,1,6,7,14.3%,26m
41720,1,MasterJeddy,2170,0,0,1,1,0.0%,29m
41720,1,sikutnik,2170,0,0,1,1,0.0%,16m
41720,2,[SPАRТА]Данил,2170,0,0,1,1,0.0%,48m
41720,2,Mike,2170,0,0,2,2,0.0%,17m
41744,2,RichieStar,2169,1615,166,169,335,49.6%,40m
41744,2,manolitouu,2169,1488,80,87,167,47.9%,12m
41744,2,ElektroL,2169,1564,63,61,124,50.8%,5m
41744,1,Maze,2169,1005,56,68,124,45.2%,37m
41744,1,Gerolsteiner,2169,670,38,42,80,47.5%,24m
41744,1,[lBSGl]Sergey,2169,852,33,36,69,47.8%,4m
41744,1,Azgard,2169,508,14,20,34,41.2%,24m
41744,2,Demonhunter,2169,417,12,20,32,37.5%,8m
41744,1,[I036]MaliXI,2169,180,4,9,13,30.8%,13m
41744,2,shubbydoo,2169,62,3,1,4,75.0%,36m
41744,2,Gannik,2169,60,3,3,6,50.0%,20m
41744,2,petersand,2169,46,3,4,7,42.9%,52m
41744,1,rmaron,2169,97,2,6,8,25.0%,32m
41744,3,Gizd,2169,30,2,8,10,20.0%,56m
41744,2,[BKN]Généric,2169,30,1,3,4,25.0%,5m
41744,1,Malis,2169,0,1,7,8,12.5%,35m
41744,2,DerJudge,2169,0,0,1,1,0.0%,50m
41744,2,Gonfaloner,2169,0,0,1,1,0.0%,16m
41744,2,zilaaa,2169,0,0,1,1,0.0%,33m
41744,1,[GROF]MechAlex,2169,0,0,2,2,0.0%,37m
41764,1,Sorilian,2168,1006,147,152,299,49.2%,4m
41764,1,Starling,2168,472,16,21,37,43.2%,9m
41764,1,Hugbjo,2168,390,14,15,29,48.3%,16m
41764,2,Hofi,2168,340,12,7,19,63.2%,45m
41764,1,DEMON,2168,352,11,17,28,39.3%,27m
41764,2,nibeon,2168,214,8,9,17,47.1%,33m
41764,2,Mike,2168,140,7,5,12,58.3%,1h
41764,1,Yacouneone,2168,144,4,10,14,28.6%,14m
41764,2,[NExtr]BACKUP,2168,0,2,5,7,28.6%,10m
41764,1,ДаНрин,2168,48,2,5,7,28.6%,24m
41764,1,[DaFF]Whiteshark,2168,38,2,7,9,22.2%,27m
41764,1,mjrcurtains,2168,42,2,8,10,20.0%,26m
41764,2,[G3O]ShenaniGans,2168,0,1,0,1,100.0%,11m
41764,2,jennerj,2168,0,1,4,5,20.0%,14m
41764,2,sztinka,2168,0,0,1,1,0.0%,49m
41764,2,andy,2168,0,0,5,5,0.0%,52m
41780,2,Cubanezu,2167,1600,133,133,266,50.0%,45m
41780,2,Griftarr,2167,470,17,15,32,53.1%,44m
41780,2,mxl,2167,310,12,6,18,66.7%,1h
41780,2,Domini,2167,231,8,8,16,50.0%,33m
41780,2,BobbyLapoint,2167,223,8,14,22,36.4%,47m
41780,2,kartalm,2167,170,5,2,7,71.4%,38m
41780,2,[eMORS]Brukser,2167,118,5,5,10,50.0%,51m
41780,1,sverre,2167,158,5,14,19,26.3%,34m
41780,2,[LMBD]QuiGonJinn,2167,58,4,4,8,50.0%,44m
41780,1,AliceBob,2167,146,4,9,13,30.8%,44m
41780,2,YanisThePie,2167,90,3,3,6,50.0%,37m
41780,1,[Dobro]кром,2167,112,3,9,12,25.0%,13m
41780,1,FIDI,2167,48,2,0,2,100.0%,26m
41780,3,VOID,2167,0,1,1,2,50.0%,4m
41780,1,lager,2167,34,1,4,5,20.0%,1h
41780,2,WarHuman,2167,46,1,6,7,14.3%,41m
41780,1,Blacksmith,2167,97,1,8,9,11.1%,1h
41780,2,ElMnchacho,2167,0,0,1,1,0.0%,54m
41780,2,[K0RM2]Leonykt,2167,0,0,1,1,0.0%,43m
41780,2,Doomkingleo,2167,0,0,1,1,0.0%,38m
41780,2,[FinSc2]Tesla,2167,0,0,2,2,0.0%,44m
41780,2,Scientist,2167,0,0,2,2,0.0%,37m
41780,1,[Zhig]Killtech,2167,0,0,5,5,0.0%,22m
41780,2,AlecseyGey,2167,0,0,5,5,0.0%,4m
41804,2,barbarian,2166,1164,50,42,92,54.3%,11m
41804,1,usALar,2166,1326,45,51,96,46.9%,52m
41804,1,Loadinshoot,2166,566,43,44,87,49.4%,16m
41804,1,Vertexus,2166,1043,36,37,73,49.3%,40m
41804,1,Kannabis,2166,843,29,31,60,48.3%,45m
41804,3,domnuldavid,2166,829,28,43,71,39.4%,25m
41804,2,Kess,2166,598,21,24,45,46.7%,27m
41804,2,адскийволк,2166,322,15,7,22,68.2%,46m
41804,3,[ProveK]Don,2166,318,11,19,30,36.7%,13m
41804,2,McN,2166,297,9,9,18,50.0%,37m
41804,2,Piffpoff,2166,198,8,4,12,66.7%,56m
41804,2,[HMarch]Realles,2166,226,7,3,10,70.0%,45m
41804,1,GvanGReaper,2166,264,7,10,17,41.2%,19m
41804,3,sas,2166,180,7,13,20,35.0%,45m
41804,2,beppe,2166,128,4,7,11,36.4%,42m
41804,2,OXXXYMORON,2166,88,3,3,6,50.0%,48m
41804,1,xdarkryan,2166,145,3,5,8,37.5%,51m
41804,1,[Pзrsia]TifaNova,2166,108,3,7,10,30.0%,20m
41804,1,Filip,2166,68,3,8,11,27.3%,2m
41804,2,snapii,2166,30,2,1,3,66.7%,52m
41804,2,Sandfurz,2166,0,1,0,1,100.0%,44m
41804,2,Alcatrazfr,2166,0,1,1,2,50.0%,1h
41804,2,SHADOWDRAGON,2166,0,1,4,5,20.0%,53m
41804,2,krisp,2166,30,1,5,6,16.7%,1h
41804,2,[apsGC]Kleryk,2166,0,0,1,1,0.0%,36m
41804,2,gery,2166,0,0,1,1,0.0%,8m
41804,2,ПодПивасом,2166,0,0,1,1,0.0%,54m
41804,2,[Ginf]leo,2166,0,0,2,2,0.0%,56m
41832,2,staticx,2165,1138,49,48,97,50.5%,12m
41832,3,GRANDMAX,2165,1246,46,52,98,46.9%,25m
41832,2,[GOLDPL]Lancelot,2165,1040,39,37,76,51.3%,23m
41832,2,[LOGS]bEaR,2165,859,28,38,66,42.4%,20m
41832,3,wandtapete,2165,486,19,23,42,45.2%,13m
41832,1,ODIN,2165,464,14,21,35,40.0%,1h
41832,2,Belhun,2165,348,13,18,31,41.9%,2m
41832,2,rip,2165,340,12,12,24,50.0%,21m
41832,2,Doberka,2165,365,12,20,32,37.5%,21m
41832,1,Cypek,2165,342,11,14,25,44.0%,44m
41832,1,apok,2165,334,11,16,27,40.7%,24m
41832,2,Locutus,2165,282,10,13,23,43.5%,2m
41832,3,Фродо,2165,193,6,4,10,60.0%,36m
41832,2,myway,2165,171,6,8,14,42.9%,12m
41832,1,Zeevonk,2165,335,6,9,15,40.0%,4m
41832,1,timafaer,2165,234,6,10,16,37.5%,23m
41832,2,feruz,2165,92,4,3,7,57.1%,40m
41832,2,Streicher,2165,0,3,5,8,37.5%,35m
41832,3,doni,2165,149,3,7,10,30.0%,44m
41832,1,Zera,2165,145,3,9,12,25.0%,18m
41832,2,Tiglath,2165,0,1,0,1,100.0%,21m
41832,2,Centewhy,2165,0,1,0,1,100.0%,4m
41832,2,cluv,2165,0,1,1,2,50.0%,55m
41832,2,[HudraD]Alpharius,2165,0,1,1,2,50.0%,45m
41832,3,Sunzy,2165,0,1,8,9,11.1%,37m
41832,2,hgdgdfd,2165,0,0,2,2,0.0%,18m
41832,2,Ктовсехврот,2165,0,0,3,3,0.0%,19m
41859,2,Enemy,2164,554,24,18,42,57.1%,53m
41859,2,DeltaZbuzany,2164,328,20,15,35,57.1%,48m
41859,1,MrHungry,2164,609,17,25,42,40.5%,36m
41859,2,Brunier,2164,390,16,18,34,47.1%,14m
41859,2,freaky,2164,422,14,20,34,41.2%,8m
41859,2,[GRK]ProLinke,2164,208,12,17,29,41.4%,7m
41859,2,VladfreD,2164,242,10,4,14,71.4%,48m
41859,3,Hellion,2164,230,8,18,26,30.8%,12m
41859,1,AbsolutZerro,2164,242,7,12,19,36.8%,34m
41859,1,[TQQG]Massacre,2164,120,5,9,14,35.7%,52m
41859,1,Nanoc,2164,96,4,7,11,36.4%,16m
41859,2,Blonde,2164,30,2,1,3,66.7%,44m
41859,2,[FkNiga]Fodão,2164,114,2,6,8,25.0%,53m
41859,2,Diston,2164,0,1,0,1,100.0%,10m
41859,2,MrachnyVoron,2164,0,0,3,3,0.0%,19m
41874,1,MrLimette,2163,1659,181,193,374,48.4%,54m
41874,1,Altair,2163,1054,64,63,127,50.4%,40m
41874,3,DemionBlack,2163,1078,48,58,106,45.3%,47m
41874,2,PCihopaT,2163,1098,39,41,80,48.8%,9m
41874,2,Toran,2163,658,25,23,48,52.1%,9m
41874,1,Badmania,2163,520,18,21,39,46.2%,1h
41874,2,[Chariz]chrZZ,2163,377,14,10,24,58.3%,1h
41874,2,Arman,2163,286,11,16,27,40.7%,56m
41874,2,[971]ROCOCO,2163,273,8,9,17,47.1%,52m
41874,2,[LMBD]cderici,2163,253,7,5,12,58.3%,44m
41874,2,sibika,2163,192,7,6,13,53.8%,52m
41874,2,Trictro,2163,150,7,10,17,41.2%,16m
41874,1,SPACE,2163,158,7,17,24,29.2%,31m
41874,2,zelratul,2163,168,5,7,12,41.7%,17m
41874,2,Zeus,2163,0,3,2,5,60.0%,54m
41874,2,robot,2163,86,3,7,10,30.0%,53m
41874,2,Windvortrexo,2163,30,2,0,2,100.0%,9m
41874,2,[Gauge]Roaxx,2163,58,2,1,3,66.7%,2m
41874,2,Mandarinka,2163,135,2,6,8,25.0%,23m
41874,1,Zen,2163,120,2,7,9,22.2%,1h
41874,2,Mimbranna,2163,0,1,0,1,100.0%,18m
41874,2,[MGGGGG]EyeOfCthulhu,2163,0,1,4,5,20.0%,41m
41874,2,gksdbcks,2163,88,1,5,6,16.7%,19m
41874,1,Афорин,2163,0,1,6,7,14.3%,2m
41874,1,Michael,2163,96,1,7,8,12.5%,39m
41874,2,CleverPRO,2163,0,0,1,1,0.0%,52m
41874,1,AlanWolker,2163,0,0,1,1,0.0%,31m
41874,2,Meldir,2163,0,0,5,5,0.0%,56m
41902,1,Kosh,2162,1256,161,170,331,48.6%,8m
41902,2,[ARISS3]ARISTSIVO,2162,1301,60,61,121,49.6%,4m
41902,1,Elkanijo,2162,433,39,35,74,52.7%,19m
41902,1,VALFLY,2162,1156,39,44,83,47.0%,8m
41902,1,swordfisha,2162,605,37,38,75,49.3%,31m
41902,1,WILDCRAFT,2162,874,29,32,61,47.5%,45m
41902,1,[Spehx]Anerad,2162,872,27,33,60,45.0%,9m
41902,3,[JuCla]Rish,2162,158,25,36,61,41.0%,54m
41902,2,Отчаяный,2162,405,17,10,27,63.0%,55m
41902,2,Turro,2162,275,14,14,28,50.0%,14m
41902,3,Ashendar,2162,240,9,14,23,39.1%,10m
41902,1,Katysak,2162,258,8,11,19,42.1%,34m
41902,3,[IIOGII]SagaNoGemini,2162,140,7,14,21,33.3%,18m
41902,1,ApOlLOL,2162,189,5,9,14,35.7%,28m
41902,2,OscarStone,2162,166,4,7,11,36.4%,9m
41902,2,Rabbit,2162,102,3,3,6,50.0%,14m
41902,2,[JXGG]emptywolf,2162,0,3,4,7,42.9%,35m
41902,1,Дима,2162,134,3,8,11,27.3%,29m
41902,1,SgtSwegger,2162,30,3,10,13,23.1%,47m
41902,2,[кроссы]Riddie,2162,30,2,2,4,50.0%,19m
41902,2,TARK,2162,0,1,0,1,100.0%,31m
41902,2,[Kunca]illu,2162,0,1,1,2,50.0%,8m
41902,2,UrukHay,2162,0,1,1,2,50.0%,37m
41902,2,NAOR,2162,96,1,2,3,33.3%,30m
41902,2,Aro,2162,0,0,1,1,0.0%,31m
41902,1,Gendernator,2162,0,0,2,2,0.0%,36m
41902,1,[ccraft]lincho,2162,0,0,7,7,0.0%,46m
41929,1,ballsnroll,2161,1554,192,204,396,48.5%,34m
41929,2,гандопяз,2161,727,29,22,51,56.9%,37m
41929,1,Spacefly,2161,589,26,21,47,55.3%,53m
41929,1,[EvK19]Oldpiper,2161,368,10,14,24,41.7%,8m
41929,3,[TCSRep]xSpagHeddy,2161,297,9,16,25,36.0%,28m
41929,2,Анасик,2161,92,7,3,10,70.0%,51m
41929,1,[UHSF]HarGrifJons,2161,144,4,3,7,57.1%,15m
41929,3,Trykaz,2161,60,4,9,13,30.8%,23m
41929,2,Wudu,2161,0,3,2,5,60.0%,4m
41929,1,САСАМБУС,2161,108,2,7,9,22.2%,26m
41929,1,ecafnugyevad,2161,110,2,7,9,22.2%,1h
41929,3,БАБУШКА,2161,97,1,1,2,50.0%,23m
41929,1,StolKn,2161,0,1,4,5,20.0%,26m
41929,2,zloy,2161,0,1,5,6,16.7%,54m
41929,2,electrowiz,2161,0,0,1,1,0.0%,38m
41929,2,kostya,2161,0,0,1,1,0.0%,16m
41929,2,Vinegredinka,2161,0,0,1,1,0.0%,12m
41929,2,kramiistyle,2161,0,0,2,2,0.0%,20m
41947,1,Tortoise,2160,1666,108,105,213,50.7%,23m
41947,2,Alarmist,2160,1596,95,91,186,51.1%,52m
41947,2,xilluks,2160,735,42,48,90,46.7%,8m
41947,1,DenisSKR,2160,575,33,33,66,50.0%,19m
41947,1,skripakk,2160,482,31,27,58,53.4%,34m
41947,2,Алиночка,2160,758,29,37,66,43.9%,37m
41947,1,[NFGS]PAFF,2160,414,15,29,44,34.1%,22m
41947,2,Henke,2160,311,12,13,25,48.0%,1h
41947,2,Naropa,2160,337,11,17,28,39.3%,36m
41947,2,ploii,2160,180,10,8,18,55.6%,42m
41947,1,[lDZPl]Rike,2160,196,5,8,13,38.5%,30m
41947,2,MIKO,2160,152,4,8,12,33.3%,34m
41947,2,sentry,2160,60,3,3,6,50.0%,2m
41947,2,maitredijon,2160,30,2,0,2,100.0%,27m
41947,2,BoBSley,2160,0,2,5,7,28.6%,12m
41947,2,LizaSolnceva,2160,70,2,21,23,8.7%,1h
41947,2,LeTgO,2160,0,1,2,3,33.3%,50m
41947,1,Chupakabra,2160,0,1,6,7,14.3%,2m
41947,1,Хрихорий,2160,0,0,2,2,0.0%,9m
41966,1,Artus,2159,1703,70,77,147,47.6%,52m
41966,3,TERRANMIX,2159,1236,56,53,109,51.4%,27m
41966,2,Rababio,2159,1197,52,54,106,49.1%,2m
41966,1,Adya,2159,1004,35,39,74,47.3%,12m
41966,2,sad,2159,712,28,28,56,50.0%,47m
41966,2,drspartnil,2159,697,27,21,48,56.2%,1h
41966,2,Ressehc,2159,760,25,38,63,39.7%,1h
41966,1,Radu,2159,674,23,21,44,52.3%,26m
41966,1,GepardBud,2159,562,22,27,49,44.9%,37m
41966,2,iZapp,2159,458,15,21,36,41.7%,36m
41966,2,RobertSeven,2159,311,13,15,28,46.4%,1h
41966,2,Bonny,2159,282,10,13,23,43.5%,52m
41966,2,Ufeks,2159,212,8,7,15,53.3%,11m
41966,2,mouggy,2159,228,8,9,17,47.1%,21m
41966,1,Derif,2159,240,6,11,17,35.3%,4m
41966,1,JiDoO,2159,224,6,13,19,31.6%,30m
41966,1,Lolo,2159,166,4,8,12,33.3%,34m
41966,2,libra,2159,30,3,10,13,23.1%,33m
41966,2,[AClD]narsou,2159,70,2,1,3,66.7%,31m
41966,2,Shest,2159,58,2,2,4,50.0%,46m
41966,1,ZiS,2159,0,2,8,10,20.0%,1h
41966,2,BlyTung,2159,0,1,0,1,100.0%,5m
41966,2,Seneca,2159,30,1,1,2,50.0%,48m
41966,2,Moonlight,2159,0,0,1,1,0.0%,55m
41966,2,Rabouni,2159,0,0,2,2,0.0%,17m
41966,1,Poh,2159,0,0,3,3,0.0%,41m
41992,2,SHMELru,2158,520,38,40,78,48.7%,14m
41992,1,[улей55]ADIshineTime,2158,920,34,41,75,45.3%,9m
41992,3,AThos,2158,965,34,44,78,43.6%,12m
41992,2,Sergg,2158,638,21,20,41,51.2%,52m
41992,1,[UMBC]Capo,2158,325,15,19,34,44.1%,9m
41992,2,morongongo,2158,490,14,22,36,38.9%,37m
41992,2,[stulj]Mravich,2158,190,7,1,8,87.5%,12m
41992,2,[BSGG]Korpus,2158,167,7,6,13,53.8%,46m
41992,1,pavelstrunc,2158,193,4,10,14,28.6%,38m
41992,2,alMic,2158,58,3,2,5,60.0%,1h
41992,1,VecToR,2158,142,3,2,5,60.0%,31m
41992,2,[004]Dave,2158,94,3,8,11,27.3%,1h
41992,1,Avoš,2158,158,3,9,12,25.0%,36m
41992,2,glhf,2158,0,1,0,1,100.0%,35m
41992,2,RDR,2158,32,1,3,4,25.0%,2m
41992,2,Asmodée,2158,0,0,1,1,0.0%,42m
41992,2,[CJFF]Danyyyaaa,2158,0,0,1,1,0.0%,42m
41992,3,Sana,2158,0,0,3,3,0.0%,29m
41992,2,Lexusnoguera,2158,0,0,5,5,0.0%,17m
42011,1,patriOt,2157,1203,46,56,102,45.1%,33m
42011,1,Grut,2157,613,30,29,59,50.8%,38m
42011,1,BIBA,2157,674,28,26,54,51.9%,37m
42011,2,ScottishHunt,2157,695,27,23,50,54.0%,40m
42011,1,myAss,2157,294,16,19,35,45.7%,9m
42011,2,YoWantSum,2157,488,16,21,37,43.2%,16m
42011,3,[Catory]MrFilmoosh,2157,300,11,3,14,78.6%,4m
42011,2,unluckyguy,2157,126,8,9,17,47.1%,38m
42011,2,[zCCCPz]diedmoon,2157,183,4,1,5,80.0%,35m
42011,2,Iranianrider,2157,142,4,1,5,80.0%,1h
42011,2,Esexe,2157,0,2,4,6,33.3%,20m
42011,2,Faellin,2157,114,2,6,8,25.0%,52m
42011,1,BCAD,2157,119,2,8,10,20.0%,1h
42011,1,CrapyPoopoo,2157,0,1,0,1,100.0%,55m
42011,2,chrislaser,2157,0,1,2,3,33.3%,52m
42026,1,Tomatovic,2156,824,51,56,107,47.7%,34m
42026,2,ArgentiSol,2156,1447,51,64,115,44.3%,52m
42026,2,Quasar,2156,1170,48,41,89,53.9%,33m
42026,2,ErelDin,2156,1040,45,47,92,48.9%,7m
42026,2,Ede,2156,1084,40,39,79,50.6%,5m
42026,2,Asker,2156,644,33,33,66,50.0%,54m
42026,2,[рейд]AMikkelsen,2156,706,25,25,50,50.0%,48m
42026,2,BoxAndOne,2156,513,21,15,36,58.3%,18m
42026,2,WolfFromHell,2156,592,20,27,47,42.6%,50m
42026,2,[BlaSH]JeBlackHole,2156,434,16,14,30,53.3%,33m
42026,2,euskal,2156,412,16,15,31,51.6%,4m
42026,2,[SRCrus]Tacots,2156,312,14,8,22,63.6%,53m
42026,2,[TheI]Chrille,2156,406,13,18,31,41.9%,36m
42026,1,[INFLAM]panic,2156,356,11,17,28,39.3%,4m
42026,2,leny,2156,280,10,13,23,43.5%,19m
42026,3,Alkares,2156,244,9,12,21,42.9%,48m
42026,1,NeStEr,2156,192,7,33,40,17.5%,47m
42026,2,pigeonLord,2156,128,4,6,10,40.0%,43m
42026,1,Dark,2156,239,4,6,10,40.0%,24m
42026,2,Sundmay,2156,92,3,8,11,27.3%,1h
42026,1,matras,2156,98,3,9,12,25.0%,43m
42026,2,Melan,2156,30,2,4,6,33.3%,8m
42026,2,Johnyproo,2156,30,1,1,2,50.0%,8m
42026,2,LORD,2156,0,0,1,1,0.0%,11m
42026,2,GORN,2156,0,0,1,1,0.0%,37m
42026,2,knockyou,2156,0,0,2,2,0.0%,8m
42026,2,Alex,2156,0,0,4,4,0.0%,29m
42026,2,saske,2156,0,0,5,5,0.0%,44m
42026,2,Vladfear,2156,0,0,5,5,0.0%,9m
42055,2,daqiao,2155,945,37,40,77,48.1%,27m
42055,1,tip,2155,732,26,27,53,49.1%,6m
42055,2,Nora,2155,530,22,21,43,51.2%,22m
42055,2,Danoll,2155,480,17,17,34,50.0%,45m
42055,2,[OnaCHe]aaren,2155,474,17,26,43,39.5%,44m
42055,1,FROL,2155,102,6,8,14,42.9%,54m
42055,2,IIIIIIIIIIII,2155,114,5,3,8,62.5%,28m
42055,2,[PITYX]Lisi,2155,167,4,4,8,50.0%,2m
42055,2,kOLEGa,2155,86,3,1,4,75.0%,56m
42055,2,Waluigi,2155,60,3,3,6,50.0%,19m
42055,1,piratesman,2155,74,3,7,10,30.0%,33m
42055,2,тихийМЕЧ,2155,73,3,8,11,27.3%,23m
42055,3,Jacobs,2155,30,3,9,12,25.0%,1h
42055,2,azerty,2155,122,2,3,5,40.0%,45m
42055,2,Somebody,2155,0,1,0,1,100.0%,21m
42055,1,MIrKo,2155,0,1,2,3,33.3%,44m
42055,2,PANOSDIM,2155,0,1,4,5,20.0%,35m
42055,2,PepinoMarino,2155,93,1,5,6,16.7%,15m
42055,3,[BIFT]Sid,2155,0,0,1,1,0.0%,1h
42055,2,[BMDR]alex,2155,0,0,1,1,0.0%,19m
42055,2,Yseult,2155,0,0,3,3,0.0%,56m
42055,1,LtFlyer,2155,0,0,4,4,0.0%,1h
42055,1,[MGME]KappaClappa,2155,73,0,5,5,0.0%,34m
42055,2,Glimbold,2155,0,0,5,5,0.0%,54m
42079,1,Smokijo,2154,1701,209,216,425,49.2%,37m
42079,1,MrBeefy,2154,670,29,31,60,48.3%,3m
42079,2,Underdog,2154,296,28,25,53,52.8%,48m
42079,1,Coteplace,2154,720,22,28,50,44.0%,37m
42079,2,DonalTrump,2154,336,11,9,20,55.0%,7m
42079,2,Артем,2154,276,10,10,20,50.0%,45m
42079,1,[NTD]Daniel,2154,309,10,16,26,38.5%,44m
42079,2,joker,2154,310,9,8,17,52.9%,56m
42079,2,White,2154,266,9,10,19,47.4%,20m
42079,2,Falconer,2154,204,8,9,17,47.1%,5m
42079,1,Gardt,2154,268,8,15,23,34.8%,5m
42079,2,[EKORN]langly,2154,102,4,2,6,66.7%,55m
42079,2,FaithonRun,2154,62,3,4,7,42.9%,1h
42079,1,Greenbit,2154,145,3,8,11,27.3%,24m
42079,2,[RBadB]GoldenCat,2154,0,1,1,2,50.0%,10m
42079,2,Yeehoo,2154,0,1,5,6,16.7%,49m
42079,2,SirDarb,2154,0,0,2,2,0.0%,36m
42079,2,Dadadanielek,2154,0,0,2,2,0.0%,53m
42079,1,Eternal,2154,0,0,3,3,0.0%,21m
42079,2,Saga,2154,0,0,3,3,0.0%,30m
42099,2,Aytal,2153,1452,104,112,216,48.1%,17m
42099,2,AcTePuu,2153,326,56,55,111,50.5%,7m
42099,2,Жора,2153,1157,52,44,96,54.2%,19m
42099,1,callvin,2153,1412,52,59,111,46.8%,52m
42099,1,Waldi,2153,1296,44,48,92,47.8%,1h
42099,2,Tokalosh,2153,672,26,20,46,56.5%,28m
42099,2,[ESPION]Askorbik,2153,517,19,21,40,47.5%,35m
42099,2,ЭмгырЭмрейс,2153,348,13,15,28,46.4%,48m
42099,2,[lZornG]Alarak,2153,430,13,23,36,36.1%,8m
42099,2,KruttGutten,2153,217,11,4,15,73.3%,46m
42099,2,[iSucks]Honik,2153,219,9,1,10,90.0%,37m
42099,2,rataton,2153,238,9,6,15,60.0%,25m
42099,1,Neomhm,2153,282,9,19,28,32.1%,54m
42099,1,[UHSF]Striker,2153,226,6,11,17,35.3%,44m
42099,1,ShakaZoulu,2153,138,5,6,11,45.5%,38m
42099,1,Чизер,2153,157,4,5,9,44.4%,8m
42099,3,dernor,2153,34,2,1,3,66.7%,5m
42099,2,[nafash]BatNaiden,2153,97,2,4,6,33.3%,44m
42099,2,meliodos,2153,0,1,0,1,100.0%,30m
42099,3,soyck,2153,0,1,1,2,50.0%,5m
42099,2,LoveAndPeace,2153,30,1,1,2,50.0%,55m
42099,2,Sejun,2153,0,1,3,4,25.0%,42m
42099,2,NOK,2153,30,1,4,5,20.0%,38m
42099,2,Hellstaff,2153,0,1,6,7,14.3%,53m
42099,2,Zzombieswar,2153,48,1,7,8,12.5%,52m
42124,1,WildWold,2152,1244,45,49,94,47.9%,1h
42124,2,Universal,2152,727,37,39,76,48.7%,14m
42124,1,RobotHobisi,2152,603,31,36,67,46.3%,34m
42124,1,kildevang,2152,674,20,28,48,41.7%,34m
42124,2,[CGEO]Tirorero,2152,236,16,19,35,45.7%,55m
42124,2,wolf,2152,383,14,12,26,53.8%,7m
42124,1,[Brando]LUPA,2152,415,13,18,31,41.9%,21m
42124,2,Ringoman,2152,226,12,11,23,52.2%,48m
42124,1,LomArt,2152,286,10,9,19,52.6%,6m
42124,1,Nebucadnetar,2152,316,10,17,27,37.0%,37m
42124,2,Overlord,2152,180,9,6,15,60.0%,3m
42124,2,öälüähiöönüp,2152,272,9,14,23,39.1%,1h
42124,2,[FCCO]Shrike,2152,208,7,9,16,43.8%,19m
42124,2,[PNC]Drufus,2152,176,6,6,12,50.0%,55m
42124,2,Bubul,2152,182,6,12,18,33.3%,53m
42124,2,Shresser,2152,175,5,12,17,29.4%,7m
42124,2,alex,2152,178,3,2,5,60.0%,54m
42124,2,Munio,2152,0,2,6,8,25.0%,23m
42124,2,[4JEN]NotoriosPUD,2152,125,2,7,9,22.2%,1h
42124,2,Daemos,2152,0,1,0,1,100.0%,30m
42124,2,[BMDR]Yarik,2152,30,1,1,2,50.0%,2m
42124,2,Selekant,2152,93,1,5,6,16.7%,49m
42124,2,Tanor,2152,0,1,5,6,16.7%,47m
42124,2,RooT,2152,46,1,6,7,14.3%,53m
42124,2,kon,2152,34,1,6,7,14.3%,28m
42124,1,RiseDenise,2152,0,1,7,8,12.5%,38m
42124,2,skat,2152,0,0,2,2,0.0%,36m
42124,2,Krul,2152,0,0,2,2,0.0%,15m
42124,1,broc,2152,0,0,3,3,0.0%,34m
42124,2,UninstallPlz,2152,0,0,5,5,0.0%,12m
42124,2,Trogen,2152,0,0,5,5,0.0%,48m
42155,1,хищник,2151,1383,120,126,246,48.8%,48m
42155,2,[TSC2C]JamesCradock,2151,1054,45,44,89,50.6%,19m
42155,1,xdkssc,2151,778,25,33,58,43.1%,19m
42155,1,Hanzo,2151,640,24,29,53,45.3%,1h
42155,1,Jetty,2151,850,24,35,59,40.7%,4m
42155,2,MishGaN,2151,575,20,24,44,45.5%,38m
42155,1,Pchel,2151,325,12,9,21,57.1%,34m
42155,2,Imre,2151,216,9,14,23,39.1%,47m
42155,1,JimmyNoodlez,2151,220,8,12,20,40.0%,45m
42155,3,POBOCHKA,2151,201,8,14,22,36.4%,42m
42155,1,Ovi,2151,306,8,21,29,27.6%,33m
42155,2,Tamas,2151,170,6,5,11,54.5%,57m
42155,3,Lavliett,2151,96,5,11,16,31.2%,56m
42155,2,ALEkBOBO,2151,44,4,2,6,66.7%,1h
42155,2,[BobiK]Minewen,2151,120,3,0,3,100.0%,52m
42155,1,Emre,2151,97,2,6,8,25.0%,41m
42155,2,[CDIR]Bumhorn,2151,97,2,7,9,22.2%,44m
42155,2,ЯрКо,2151,0,1,0,1,100.0%,33m
42155,2,Sjefskiller,2151,30,1,3,4,25.0%,1h
42155,2,Duckin,2151,48,1,3,4,25.0%,12m
42155,1,[mfixed]KUBIX,2151,0,1,6,7,14.3%,36m
42155,2,Pulsar,2151,0,0,1,1,0.0%,54m
42177,2,Beginner,2150,700,148,150,298,49.7%,54m
42177,2,KRS,2150,1655,142,161,303,46.9%,1h
42177,1,[xZero]Obilisk,2150,1694,130,135,265,49.1%,55m
42177,1,WOLFSBLUT,2150,1042,98,93,191,51.3%,48m
42177,2,Oleg,2150,891,66,68,134,49.3%,8m
42177,2,Cedric,2150,1421,56,54,110,50.9%,48m
42177,2,Nakaz,2150,1102,53,57,110,48.2%,25m
42177,2,RNO,2150,802,39,37,76,51.3%,1h
42177,1,gilu,2150,566,22,25,47,46.8%,42m
42177,1,WhiteVi,2150,507,19,23,42,45.2%,23m
42177,2,BANDOS,2150,322,12,10,22,54.5%,8m
42177,2,Borber,2150,308,10,12,22,45.5%,18m
42177,1,Archimède,2150,241,6,10,16,37.5%,29m
42177,3,GrowlyViking,2150,189,5,9,14,35.7%,19m
42177,2,VTwelve,2150,94,4,2,6,66.7%,22m
42177,2,Patucho,2150,167,4,2,6,66.7%,2m
42177,1,Dropper,2150,169,4,6,10,40.0%,23m
42177,1,baphosa,2150,140,4,10,14,28.6%,26m
42177,2,noe,2150,92,3,5,8,37.5%,57m
42177,1,TheTurcoman,2150,70,3,8,11,27.3%,32m
42177,2,Zimmek,2150,30,2,1,3,66.7%,38m
42177,2,Overlord,2150,30,2,1,3,66.7%,19m
42177,2,Player,2150,173,2,10,12,16.7%,52m
42177,1,maromanpo,2150,74,2,13,15,13.3%,18m
42177,2,aleksey,2150,0,1,0,1,100.0%,45m
42177,2,Xiaomi,2150,0,0,1,1,0.0%,36m
42177,1,[ProbKA]Японец,2150,0,0,1,1,0.0%,26m
42177,2,VoidWalker,2150,0,0,1,1,0.0%,37m
42177,2,mAtU,2150,0,0,2,2,0.0%,48m
42206,1,ALELS,2149,1688,146,157,303,48.2%,1h
42206,1,SimonT,2149,1648,94,103,197,47.7%,9m
42206,1,ZOHB,2149,1308,50,53,103,48.5%,29m
42206,1,ilfff,2149,841,38,45,83,45.8%,2m
42206,2,[Mastr]cooollmomins,2149,848,32,29,61,52.5%,8m
42206,1,Amou,2149,486,14,25,39,35.9%,38m
42206,2,TAM,2149,310,12,7,19,63.2%,44m
42206,1,Vag,2149,406,12,18,30,40.0%,54m
42206,1,MrComrade,2149,366,10,14,24,41.7%,23m
42206,1,Mattuu,2149,310,10,14,24,41.7%,46m
42206,2,avieor,2149,206,8,8,16,50.0%,3m
42206,1,Marseille,2149,230,8,15,23,34.8%,44m
42206,1,Guy,2149,202,6,10,16,37.5%,9m
42206,1,Buliwyf,2149,155,4,9,13,30.8%,33m
42206,2,[Sk1K]Ghh,2149,58,3,4,7,42.9%,30m
42206,1,Ayho,2149,96,2,0,2,100.0%,13m
42206,2,Rockoreal,2149,0,2,3,5,40.0%,44m
42206,2,wolf,2149,30,2,3,5,40.0%,4m
42206,2,desant,2149,64,2,3,5,40.0%,28m
42206,2,Dragon,2149,0,0,1,1,0.0%,40m
42206,2,JagerRus,2149,0,0,1,1,0.0%,3m
42227,2,imYourFather,2148,1483,167,185,352,47.4%,47m
42227,1,Zukim,2148,1408,94,98,192,49.0%,52m
42227,2,OverLord,2148,1431,85,78,163,52.1%,30m
42227,2,KataVVina,2148,868,32,38,70,45.7%,16m
42227,1,[TAW]Ferd,2148,707,23,27,50,46.0%,34m
42227,2,evindor,2148,448,19,23,42,45.2%,1h
42227,1,Rustic,2148,288,16,12,28,57.1%,53m
42227,1,Nekronus,2148,370,14,20,34,41.2%,29m
42227,1,Lexx,2148,279,8,13,21,38.1%,44m
42227,2,crispybacon,2148,202,7,7,14,50.0%,47m
42227,1,needmore,2148,147,6,8,14,42.9%,6m
42227,3,[JaPP]Xakep,2148,30,5,7,12,41.7%,35m
42227,2,BlitzKrieG,2148,94,4,4,8,50.0%,43m
42227,2,arsénne,2148,94,4,5,9,44.4%,52m
42227,3,TheGreatZab,2148,144,4,10,14,28.6%,43m
42227,2,WIDOWMAKER,2148,119,3,0,3,100.0%,1h
42227,2,Sutuco,2148,60,2,2,4,50.0%,47m
42227,2,ЛовкиеЯйцаЪ,2148,118,2,3,5,40.0%,27m
42227,3,GuyFawkes,2148,95,2,8,10,20.0%,16m
42227,2,[20ЛетO]hayzenberg,2148,0,0,1,1,0.0%,51m
42227,2,[aqui97]Aquila,2148,0,0,2,2,0.0%,48m
42227,2,volk,2148,0,0,4,4,0.0%,53m
42227,2,[sAos]Spite,2148,0,0,5,5,0.0%,1h
42227,2,Cryss,2148,0,0,5,5,0.0%,4m
42251,1,[HMarch]alexmvb,2147,1512,122,117,239,51.0%,46m
42251,2,stéfano,2147,1191,52,55,107,48.6%,28m
42251,2,Урукхай,2147,1166,52,57,109,47.7%,8m
42251,2,WinterDreamr,2147,1120,51,54,105,48.6%,7m
42251,1,MrDarius,2147,592,49,57,106,46.2%,34m
42251,1,Valuj,2147,1071,37,49,86,43.0%,23m
42251,2,Alvaro,2147,916,34,29,63,54.0%,12m
42251,2,IvenTV,2147,702,30,38,68,44.1%,38m
42251,1,Chayhanshik,2147,724,26,37,63,41.3%,3m
42251,2,ais,2147,739,25,26,51,49.0%,3m
42251,1,Arendal,2147,245,22,30,52,42.3%,37m
42251,1,yaron,2147,388,16,22,38,42.1%,1h
42251,2,pizzadough,2147,282,10,6,16,62.5%,7m
42251,2,THORIN,2147,280,10,12,22,45.5%,12m
42251,1,SSF,2147,292,10,14,24,41.7%,52m
42251,2,DeMoNiAc,2147,194,7,7,14,50.0%,13m
42251,2,blaz,2147,144,6,3,9,66.7%,38m
42251,2,qdqdq,2147,114,5,2,7,71.4%,30m
42251,2,[БАЗА45]Scorpion,2147,174,5,3,8,62.5%,23m
42251,3,Dezzert,2147,66,4,11,15,26.7%,6m
42251,2,dub,2147,0,3,2,5,60.0%,21m
42251,3,Saratheas,2147,126,3,2,5,60.0%,2m
42251,1,tommy,2147,96,3,9,12,25.0%,1h
42251,2,SpringKerrik,2147,26,2,3,5,40.0%,42m
42251,2,deBeutel,2147,30,2,6,8,25.0%,5m
42251,1,Warrior,2147,36,2,7,9,22.2%,52m
42251,2,llllllllllll,2147,0,1,0,1,100.0%,35m
42251,2,Theoage,2147,0,1,1,2,50.0%,19m
42251,2,SGTJohnson,2147,46,1,1,2,50.0%,12m
42251,3,LoliHunt,2147,0,1,2,3,33.3%,45m
42251,1,BAC,2147,96,1,2,3,33.3%,25m
42251,2,Yeashay,2147,0,1,5,6,16.7%,21m
42251,2,Madara,2147,0,1,6,7,14.3%,49m
42251,2,karem,2147,0,0,1,1,0.0%,52m
42251,3,ciripotto,2147,0,0,1,1,0.0%,53m
42251,2,Kirvesperse,2147,0,0,2,2,0.0%,38m
42287,2,blackstorm,2146,1113,84,72,156,53.8%,28m
42287,2,SulmanR,2146,1509,69,76,145,47.6%,28m
42287,2,Grouler,2146,1142,46,35,81,56.8%,42m
42287,2,Leech,2146,940,37,35,72,51.4%,45m
42287,2,[CAI]Careear,2146,506,18,15,33,54.5%,28m
42287,2,PrimeGride,2146,378,15,12,27,55.6%,7m
42287,1,Gavlo,2146,272,7,13,20,35.0%,18m
42287,2,Android,2146,176,6,7,13,46.2%,26m
42287,3,minDTool,2146,86,6,12,18,33.3%,10m
42287,2,Logol,2146,86,5,16,21,23.8%,38m
42287,1,Kraso,2146,119,4,11,15,26.7%,6m
42287,2,KomisarTarik,2146,0,1,0,1,100.0%,4m
42287,2,Name,2146,0,1,0,1,100.0%,49m
42287,2,genkax,2146,0,1,1,2,50.0%,52m
42287,2,Leon,2146,32,1,3,4,25.0%,25m
42287,2,Norbivagyok,2146,46,1,6,7,14.3%,3m
42287,2,LemanRuss,2146,0,0,2,2,0.0%,19m
42287,1,Chabaaaaal,2146,0,0,5,5,0.0%,26m
42305,2,Zeon,2145,1618,176,193,369,47.7%,12m
42305,2,Скот,2145,1618,149,150,299,49.8%,28m
42305,1,Mark,2145,701,34,42,76,44.7%,1h
42305,2,Korch,2145,858,33,28,61,54.1%,30m
42305,2,МистерСмерть,2145,951,32,42,74,43.2%,47m
42305,2,Eldermann,2145,514,23,27,50,46.0%,33m
42305,2,buduumnee,2145,443,20,14,34,58.8%,8m
42305,1,Ovidiashlin,2145,625,19,25,44,43.2%,1h
42305,2,Zoblar,2145,220,7,4,11,63.6%,1h
42305,1,Obreryn,2145,284,7,13,20,35.0%,9m
42305,2,semekh,2145,132,6,1,7,85.7%,22m
42305,2,NotAnOmen,2145,126,5,4,9,55.6%,20m
42305,2,[Сold]ЯрЧ,2145,96,4,6,10,40.0%,31m
42305,2,lefty,2145,112,3,4,7,42.9%,53m
42305,2,IOB,2145,0,3,4,7,42.9%,18m
42305,2,[674]dominox,2145,32,2,0,2,100.0%,1h
42305,2,STYPLA,2145,60,2,3,5,40.0%,4m
42305,2,Podeon,2145,58,2,3,5,40.0%,38m
42305,2,LRD,2145,0,1,0,1,100.0%,18m
42305,2,[вввв]силач,2145,30,1,3,4,25.0%,48m
42305,3,chesney,2145,0,1,4,5,20.0%,43m
42305,2,Aristogeiton,2145,0,0,2,2,0.0%,28m
42327,1,Awthur,2144,285,9,9,18,50.0%,13m
42327,2,Demolisher,2144,210,7,9,16,43.8%,37m
42327,1,mensisCZ,2144,234,7,10,17,41.2%,27m
42327,1,SuperStas,2144,186,6,6,12,50.0%,1h
42327,3,Regonzu,2144,175,6,13,19,31.6%,24m
42327,1,SzprytnyLunt,2144,90,4,9,13,30.8%,12m
42327,1,[1992]Unterweger,2144,94,3,11,14,21.4%,51m
42327,2,johannes,2144,30,2,0,2,100.0%,19m
42327,2,Nexxras,2144,0,2,4,6,33.3%,31m
42327,2,Gobochul,2144,0,1,1,2,50.0%,44m
42327,2,DexterousMC,2144,0,0,1,1,0.0%,18m
42327,2,leoken,2144,0,0,1,1,0.0%,11m
42327,2,DeCopas,2144,0,0,2,2,0.0%,2m
42327,2,MARADER,2144,0,0,2,2,0.0%,17m
42327,2,AlexanderIII,2144,0,0,5,5,0.0%,47m
42342,1,Zaltoi,2143,1263,156,167,323,48.3%,19m
42342,2,[Bplus]Peanut,2143,1054,57,52,109,52.3%,13m
42342,1,StreetKid,2143,935,41,38,79,51.9%,13m
42342,2,[SyperS]Repzpank,2143,1084,39,43,82,47.6%,54m
42342,1,protos,2143,875,29,37,66,43.9%,33m
42342,2,Potato,2143,322,10,9,19,52.6%,1h
42342,1,Creven,2143,249,8,9,17,47.1%,30m
42342,3,Highlandcrow,2143,236,8,16,24,33.3%,44m
42342,2,BlackRaven,2143,180,6,11,17,35.3%,33m
42342,1,Benko,2143,96,5,7,12,41.7%,38m
42342,2,RangerRyan,2143,114,4,3,7,57.1%,48m
42342,2,lexaabz,2143,160,4,4,8,50.0%,51m
42342,1,Dagestan,2143,145,3,1,4,75.0%,23m
42342,1,Crayon,2143,120,3,12,15,20.0%,28m
42342,2,Krey,2143,30,2,0,2,100.0%,1h
42342,2,Sevil,2143,30,2,3,5,40.0%,7m
42342,1,Spiff,2143,145,2,10,12,16.7%,39m
42342,2,Igor,2143,95,1,2,3,33.3%,30m
42342,2,[NlGE]BobRoss,2143,0,0,2,2,0.0%,12m
42361,2,Cerberus,2142,1286,191,195,386,49.5%,55m
42361,2,whalehumpack,2142,621,68,64,132,51.5%,52m
42361,2,Vennies,2142,428,42,29,71,59.2%,55m
42361,1,sssss,2142,1237,42,52,94,44.7%,14m
42361,2,BraIN,2142,929,40,38,78,51.3%,4m
42361,2,MarTime,2142,613,23,22,45,51.1%,54m
42361,2,Brezelring,2142,475,19,14,33,57.6%,12m
42361,2,tomy,2142,322,14,12,26,53.8%,30m
42361,2,Namess,2142,327,12,9,21,57.1%,30m
42361,2,Zonder,2142,192,10,3,13,76.9%,38m
42361,2,[3A]Хищник,2142,236,8,6,14,57.1%,19m
42361,2,evgeniy,2142,166,6,5,11,54.5%,9m
42361,2,Dardanius,2142,30,2,0,2,100.0%,57m
42361,2,[CОS]Heretic,2142,139,2,2,4,50.0%,56m
42361,2,[AMN]BumBumFede,2142,30,2,4,6,33.3%,53m
42361,2,[GGVPD]LitchKing,2142,60,2,6,8,25.0%,4m
42361,3,dansaev,2142,30,2,9,11,18.2%,51m
42361,2,Fish,2142,93,1,1,2,50.0%,43m
42361,1,[JaPP]Luxfrium,2142,97,1,2,3,33.3%,34m
42361,1,caman,2142,0,1,2,3,33.3%,47m
42361,1,blackshadow,2142,0,1,7,8,12.5%,27m
42361,2,Zuber,2142,0,0,1,1,0.0%,13m
42361,2,WithShadow,2142,0,0,1,1,0.0%,56m
42361,2,mrmistake,2142,0,0,2,2,0.0%,21m
42361,2,Bia,2142,0,0,3,3,0.0%,4m
42361,1,[Сold]спартазерга,2142,0,0,4,4,0.0%,34m
42361,2,KpeBeTko,2142,0,0,5,5,0.0%,21m
42388,1,Mario,2141,1351,91,95,186,48.9%,33m
42388,2,Sany,2141,1532,64,52,116,55.2%,51m
42388,2,krot,2141,1121,52,52,104,50.0%,56m
42388,2,EvilGoogle,2141,998,46,50,96,47.9%,48m
42388,1,TDR,2141,1005,46,53,99,46.5%,10m
42388,2,mordred,2141,846,34,27,61,55.7%,21m
42388,1,[Ximic]Тиховет,2141,794,26,30,56,46.4%,34m
42388,1,RoHarD,2141,432,19,29,48,39.6%,36m
42388,2,bratkom,2141,312,12,11,23,52.2%,12m
42388,1,Toddo,2141,356,12,16,28,42.9%,34m
42388,3,Zealot,2141,322,12,18,30,40.0%,42m
42388,2,Psolokopanos,2141,224,8,2,10,80.0%,42m
42388,2,MasterFireSi,2141,220,8,8,16,50.0%,1h
42388,1,Max,2141,368,8,13,21,38.1%,16m
42388,1,Darkk,2141,163,5,3,8,62.5%,24m
42388,1,Cyron,2141,168,4,10,14,28.6%,18m
42388,2,Warel,2141,90,3,5,8,37.5%,44m
42388,1,Reazer,2141,94,3,9,12,25.0%,51m
42388,2,Tom,2141,0,1,0,1,100.0%,52m
42388,3,URAN,2141,97,1,1,2,50.0%,47m
42388,2,Fallen,2141,0,1,2,3,33.3%,1h
42388,3,dangernk,2141,0,1,2,3,33.3%,5m
42388,1,SirHoney,2141,0,1,2,3,33.3%,47m
42388,2,Starlight,2141,30,1,5,6,16.7%,7m
42388,2,xander,2141,0,0,1,1,0.0%,11m
42413,2,GROM,2140,914,37,34,71,52.1%,44m
42413,1,SyNcZ,2140,669,29,28,57,50.9%,18m
42413,2,[BlackX]Kendatchi,2140,546,20,18,38,52.6%,45m
42413,1,Lizer,2140,502,17,22,39,43.6%,12m
42413,2,DobryKot,2140,390,14,15,29,48.3%,7m
42413,2,Crono,2140,136,4,0,4,100.0%,44m
42413,2,XROYALxRAGEX,2140,92,3,5,8,37.5%,5m
42413,2,Loge,2140,60,2,4,6,33.3%,52m
42413,2,Kuolleille,2140,102,2,5,7,28.6%,47m
42413,2,LouK,2140,60,2,5,7,28.6%,5m
42413,2,TERRAkiller,2140,0,0,1,1,0.0%,45m
42413,2,spoke,2140,0,0,2,2,0.0%,27m
42413,2,eddi,2140,0,0,4,4,0.0%,24m
42413,1,Pol,2140,0,0,4,4,0.0%,26m
42413,2,Klinkerklotz,2140,0,0,5,5,0.0%,45m
42428,2,Charles,2139,1232,47,50,97,48.5%,55m
42428,2,Judofson,2139,1032,40,47,87,46.0%,2m
42428,2,Necronomicon,2139,691,30,19,49,61.2%,55m
42428,2,Sibspas,2139,670,26,31,57,45.6%,52m
42428,2,Thamkrabok,2139,552,21,18,39,53.8%,56m
42428,2,[mfixed]TYTY,2139,403,16,13,29,55.2%,12m
42428,2,JMR,2139,304,12,6,18,66.7%,1h
42428,2,Cloudbob,2139,233,9,3,12,75.0%,5m
42428,2,futrzak,2139,178,6,8,14,42.9%,55m
42428,1,rtrer,2139,112,5,5,10,50.0%,30m
42428,2,AAA,2139,104,4,4,8,50.0%,1h
42428,1,Wikolek,2139,96,4,11,15,26.7%,35m
42428,2,Batay,2139,58,3,0,3,100.0%,52m
42428,2,[ZhMi]DeaDealerBoB,2139,92,3,2,5,60.0%,31m
42428,1,bruhu,2139,0,3,7,10,30.0%,34m
42428,2,Wolfsnake,2139,58,2,2,4,50.0%,3m
42428,2,Hakha,2139,0,1,0,1,100.0%,39m
42428,2,Pavel,2139,95,1,6,7,14.3%,21m
42428,1,Хой,2139,0,1,7,8,12.5%,1h
42428,1,Hrycku,2139,40,1,8,9,11.1%,50m
42428,1,[Seu]shadowlord,2139,42,1,9,10,10.0%,44m
42428,2,xikaro,2139,0,0,1,1,0.0%,22m
42428,2,Meriguan,2139,0,0,1,1,0.0%,33m
42428,2,JACOB,2139,0,0,2,2,0.0%,37m
42428,3,GAV,2139,0,0,3,3,0.0%,45m
42428,3,Johnny,2139,0,0,5,5,0.0%,6m
42454,2,HajimeZ,2138,1267,96,96,192,50.0%,52m
42454,1,[PTVru]Fatality,2138,1467,91,92,183,49.7%,37m
42454,1,Lizardstorm,2138,868,26,39,65,40.0%,24m
42454,2,яНеБот,2138,528,22,14,36,61.1%,3m
42454,1,gWsBartman,2138,650,22,33,55,40.0%,13m
42454,1,Капитан,2138,350,14,17,31,45.2%,39m
42454,2,Phoenix,2138,274,12,11,23,52.2%,38m
42454,2,Awerkwar,2138,256,10,13,23,43.5%,9m
42454,2,Juggernaut,2138,232,9,10,19,47.4%,7m
42454,2,DOOM,2138,272,9,14,23,39.1%,1h
42454,2,Timur,2138,242,8,13,21,38.1%,14m
42454,2,Invituz,2138,140,7,6,13,53.8%,49m
42454,3,[0MGz]YTOP,2138,181,6,11,17,35.3%,1h
42454,2,master,2138,182,5,4,9,55.6%,1h
42454,1,AlcoPunk,2138,127,5,4,9,55.6%,27m
42454,2,RuElephant,2138,136,4,1,5,80.0%,30m
42454,1,snowwulf,2138,97,4,4,8,50.0%,55m
42454,2,WoobsGaming,2138,226,4,12,16,25.0%,45m
42454,2,TRAX,2138,60,3,1,4,75.0%,57m
42454,2,CAMEIFUCA,2138,92,3,4,7,42.9%,57m
42454,3,[Kиски]Qumannyy,2138,117,3,5,8,37.5%,16m
42454,2,Tarnar,2138,86,3,8,11,27.3%,56m
42454,2,hansjee,2138,58,2,3,5,40.0%,52m
42454,2,drico,2138,60,2,5,7,28.6%,19m
42454,2,Erenet,2138,60,2,9,11,18.2%,1h
42454,1,RaStaBasSta,2138,0,1,6,7,14.3%,52m
42454,1,qwerty,2138,0,1,7,8,12.5%,1h
42454,2,kayzer,2138,0,0,3,3,0.0%,20m
42482,2,Niggo,2137,1029,39,39,78,50.0%,1h
42482,1,[TDMPT]Eragon,2137,800,38,26,64,59.4%,41m
42482,2,WaRzOnE,2137,796,29,35,64,45.3%,12m
42482,2,Hyksos,2137,670,25,21,46,54.3%,37m
42482,2,Ponyalone,2137,484,19,13,32,59.4%,17m
42482,2,Gerton,2137,456,16,13,29,55.2%,45m
42482,2,Richi,2137,332,13,11,24,54.2%,25m
42482,2,bzyqmyq,2137,357,11,11,22,50.0%,28m
42482,1,Mepulsor,2137,336,11,13,24,45.8%,37m
42482,2,Rodiyz,2137,389,11,17,28,39.3%,8m
42482,2,Limenius,2137,366,10,15,25,40.0%,37m
42482,1,Dark,2137,166,4,2,6,66.7%,4m
42482,2,Chorley,2137,88,2,4,6,33.3%,53m
42482,2,sdfw,2137,0,2,8,10,20.0%,11m
42482,1,MiKola,2137,0,1,0,1,100.0%,1h
42482,2,ROMEODELYON,2137,30,1,2,3,33.3%,42m
42482,2,PiuPiu,2137,0,1,6,7,14.3%,41m
42482,1,[TeUn]Gabriel,2137,0,1,6,7,14.3%,53m
42482,1,Takeo,2137,0,1,7,8,12.5%,42m
42482,2,[1717]vadorus,2137,0,0,1,1,0.0%,11m
42482,2,ПересветIvan,2137,0,0,1,1,0.0%,1h
42482,3,Aminus,2137,0,0,1,1,0.0%,4m
42482,2,Пророк,2137,0,0,2,2,0.0%,38m
42482,3,[Still]bleed,2137,0,0,5,5,0.0%,45m
42482,3,hris,2137,0,0,5,5,0.0%,47m
42507,1,mangyite,2136,1226,43,49,92,46.7%,7m
42507,2,redDragon,2136,1069,40,46,86,46.5%,40m
42507,1,Blitz,2136,943,34,38,72,47.2%,19m
42507,2,[Chariz]KSK,2136,458,17,16,33,51.5%,46m
42507,2,mimi,2136,431,16,12,28,57.1%,53m
42507,2,[AiRǂ]ATHOR,2136,302,16,12,28,57.1%,4m
42507,1,Batonya,2136,220,5,7,12,41.7%,50m
42507,1,bold,2136,80,5,7,12,41.7%,53m
42507,2,[tldm]letenebreux,2136,62,3,2,5,60.0%,36m
42507,2,[OG8]ewgen,2136,60,3,3,6,50.0%,38m
42507,1,сергей,2136,0,3,4,7,42.9%,30m
42507,2,ast,2136,110,2,5,7,28.6%,52m
42507,2,evrIka,2136,30,1,1,2,50.0%,2m
42507,2,Overlord,2136,0,1,2,3,33.3%,45m
42507,1,Ithriel,2136,48,1,6,7,14.3%,13m
42507,2,Gerkules,2136,0,0,1,1,0.0%,1h
42507,2,Kukama,2136,0,0,4,4,0.0%,1h
42524,1,StilTrapd,2135,1613,245,248,493,49.7%,13m
42524,1,Venom,2135,1549,138,144,282,48.9%,2m
42524,2,[BHIT]Hego,2135,1523,127,125,252,50.4%,40m
42524,2,MrPickles,2135,799,42,39,81,51.9%,52m
42524,1,Bubaj,2135,641,20,29,49,40.8%,18m
42524,1,ELPEPE,2135,364,11,15,26,42.3%,36m
42524,1,polskipolak,2135,233,9,6,15,60.0%,27m
42524,1,SergejSOU,2135,304,9,21,30,30.0%,19m
42524,3,HUNNU,2135,152,6,5,11,54.5%,19m
42524,3,QuickSort,2135,219,6,13,19,31.6%,39m
42524,3,Trikolor,2135,194,6,13,19,31.6%,6m
42524,2,bob,2135,145,5,6,11,45.5%,21m
42524,1,Joopig,2135,144,4,5,9,44.4%,29m
42524,1,RedWolf,2135,110,4,11,15,26.7%,30m
42524,2,TGS,2135,30,2,1,3,66.7%,2m
42524,2,[V3to]Hondo,2135,112,2,1,3,66.7%,37m
42524,2,wet,2135,58,2,2,4,50.0%,14m
42524,2,Milkcruiser,2135,32,2,3,5,40.0%,54m
42524,1,Vega,2135,96,2,4,6,33.3%,29m
42524,2,[SaloXD]WHAT,2135,0,1,0,1,100.0%,33m
42524,2,SupaEcureuil,2135,0,1,0,1,100.0%,46m
42524,3,sarrel,2135,0,1,4,5,20.0%,49m
42524,2,demid,2135,0,0,2,2,0.0%,36m
42524,1,[vFam]Argfede,2135,0,0,9,9,0.0%,33m
42548,1,Rutek,2134,1527,89,90,179,49.7%,47m
42548,2,LatteIgel,2134,616,67,68,135,49.6%,4m
42548,2,RAOS,2134,1031,51,49,100,51.0%,13m
42548,2,[SPAINs]Urik,2134,1176,45,50,95,47.4%,44m
42548,1,Kiianna,2134,711,25,29,54,46.3%,23m
42548,2,Gottfridd,2134,503,23,29,52,44.2%,1h
42548,1,[ChiGa]Junorub,2134,355,18,19,37,48.6%,49m
42548,2,LordLowlife,2134,364,14,12,26,53.8%,37m
42548,1,Franky,2134,319,12,8,20,60.0%,47m
42548,1,Ripley,2134,198,6,6,12,50.0%,1h
42548,1,leDUC,2134,178,6,14,20,30.0%,1h
42548,1,TENELEVEN,2134,238,5,9,14,35.7%,38m
42548,2,[HAYTER]MMM,2134,58,4,5,9,44.4%,49m
42548,2,COUSIIL,2134,0,3,2,5,60.0%,9m
42548,2,ats,2134,96,3,4,7,42.9%,4m
42548,1,Ren,2134,76,3,6,9,33.3%,24m
42548,2,Croker,2134,48,2,0,2,100.0%,33m
42548,2,ajmot,2134,48,2,2,4,50.0%,22m
42548,2,yiro,2134,58,2,4,6,33.3%,49m
42548,2,Ksardrey,2134,0,1,0,1,100.0%,52m
42548,2,Adix,2134,0,1,0,1,100.0%,33m
42548,2,aiur,2134,0,1,1,2,50.0%,15m
42548,2,MitkoToploto,2134,0,1,1,2,50.0%,44m
42548,2,dzhandosov,2134,0,1,2,3,33.3%,28m
42548,2,CenLogis,2134,30,1,2,3,33.3%,2m
42548,2,Habib,2134,0,0,1,1,0.0%,53m
42548,2,gloc,2134,0,0,1,1,0.0%,19m
42548,2,Misijo,2134,0,0,3,3,0.0%,23m
42548,3,Waxu,2134,0,0,5,5,0.0%,16m
42577,1,Jaro,2133,1693,436,444,880,49.5%,46m
42577,1,Alliance,2133,1567,137,148,285,48.1%,1h
42577,1,bimmbalas,2133,1606,135,132,267,50.6%,3m
42577,2,KingSlayer,2133,1606,62,61,123,50.4%,1h
42577,3,ProxyAura,2133,1159,49,51,100,49.0%,34m
42577,3,Jajebe,2133,1173,42,54,96,43.8%,31m
42577,2,ProtoBlogas,2133,545,36,38,74,48.6%,31m
42577,2,Алёшаа,2133,892,35,34,69,50.7%,1h
42577,1,BOBCAT,2133,976,30,41,71,42.3%,44m
42577,2,[DArmy]Warmonkey,2133,484,19,23,42,45.2%,1h
42577,2,bombergamer,2133,474,17,20,37,45.9%,1h
42577,2,Chezs,2133,413,15,14,29,51.7%,37m
42577,2,[Cynaps]KaneHelax,2133,374,14,23,37,37.8%,38m
42577,2,РанокКактуса,2133,302,11,11,22,50.0%,26m
42577,1,[morts]Raptor,2133,296,9,12,21,42.9%,52m
42577,2,Edu,2133,178,7,9,16,43.8%,20m
42577,2,Marko,2133,208,7,9,16,43.8%,3m
42577,2,Merluzote,2133,140,4,1,5,80.0%,12m
42577,1,MatVas,2133,150,4,6,10,40.0%,47m
42577,2,[Bishi]MaganoAAA,2133,0,1,0,1,100.0%,50m
42577,2,knivok,2133,88,1,1,2,50.0%,53m
42577,2,JudgeDredd,2133,30,1,7,8,12.5%,8m
42577,2,Hrubiks,2133,0,0,2,2,0.0%,1h
42577,2,Raptor,2133,0,0,3,3,0.0%,18m
42577,2,METHRAGE,2133,0,0,5,5,0.0%,55m
42602,1,[corbs]Zorgofulus,2132,1571,216,220,436,49.5%,1h
42602,2,Protti,2132,1589,151,160,311,48.6%,1h
42602,2,[Muist]MateiT,2132,671,64,64,128,50.0%,21m
42602,2,MOOCT,2132,1069,44,46,90,48.9%,46m
42602,1,WizarD,2132,1100,41,45,86,47.7%,26m
42602,1,Alienratte,2132,1237,40,55,95,42.1%,30m
42602,2,rom,2132,660,23,27,50,46.0%,46m
42602,2,Cactus,2132,488,22,12,34,64.7%,44m
42602,2,ПАН,2132,648,22,26,48,45.8%,4m
42602,2,Toxichof,2132,510,19,17,36,52.8%,1h
42602,2,Sumpfeule,2132,467,19,17,36,52.8%,57m
42602,1,gagge,2132,396,16,17,33,48.5%,8m
42602,1,NAKAMACHIDAI,2132,292,12,14,26,46.2%,33m
42602,2,SnowManGo,2132,410,12,16,28,42.9%,50m
42602,1,GRIFA,2132,438,12,18,30,40.0%,36m
42602,3,Baccardi,2132,306,11,12,23,47.8%,33m
42602,1,Gama,2132,340,11,16,27,40.7%,1h
42602,1,lazz,2132,329,11,18,29,37.9%,26m
42602,2,AngryFox,2132,202,7,2,9,77.8%,22m
42602,2,Icdeadppl,2132,156,6,9,15,40.0%,1h
42602,1,SiloJopov,2132,130,5,9,14,35.7%,34m
42602,3,GESMER,2132,171,4,4,8,50.0%,27m
42602,2,Reticent,2132,112,2,1,3,66.7%,21m
42602,2,elnegro,2132,0,1,1,2,50.0%,52m
42602,2,Sleepy,2132,95,1,6,7,14.3%,10m
42602,2,Arkantroks,2132,0,0,1,1,0.0%,56m
42602,1,Glarthir,2132,0,0,5,5,0.0%,27m
42602,3,DonFlamingo,2132,0,0,5,5,0.0%,4m
42630,1,Robins,2131,1694,408,410,818,49.9%,47m
42630,2,Rma,2131,1432,137,155,292,46.9%,9m
42630,1,Steven,2131,1340,52,62,114,45.6%,3m
42630,2,MadcoW,2131,1013,47,43,90,52.2%,52m
42630,1,доктор,2131,1103,46,49,95,48.4%,46m
42630,2,[OLT]bogdanbzw,2131,270,10,11,21,47.6%,46m
42630,1,DeCeNeU,2131,218,7,16,23,30.4%,50m
42630,2,Dmitri,2131,167,6,2,8,75.0%,53m
42630,2,Правоверный,2131,182,6,2,8,75.0%,53m
42630,2,morozoff,2131,132,4,4,8,50.0%,10m
42630,1,[vivi]darkknight,2131,146,4,9,13,30.8%,1h
42630,1,Monster,2131,160,4,10,14,28.6%,39m
42630,2,Gogafom,2131,136,3,4,7,42.9%,35m
42630,2,JOSÉ,2131,36,3,7,10,30.0%,16m
42630,1,[HOMIE]Stafin,2131,96,2,6,8,25.0%,14m
42630,1,TeaRex,2131,0,2,7,9,22.2%,41m
42630,2,PapielGruchi,2131,46,1,2,3,33.3%,55m
42630,2,toxic,2131,0,0,1,1,0.0%,16m
42630,1,SALAGA,2131,0,0,2,2,0.0%,51m
42630,2,Евгеньевич,2131,0,0,2,2,0.0%,30m
42630,2,XoMSAN,2131,0,0,3,3,0.0%,49m
42651,2,Miekele,2130,1068,64,58,122,52.5%,53m
42651,1,[Panger]Bambatant,2130,1592,60,64,124,48.4%,6m
42651,2,SmallRock,2130,656,25,22,47,53.2%,53m
42651,2,[Xenor]WAYll,2130,662,23,28,51,45.1%,2m
42651,2,Libris,2130,296,10,13,23,43.5%,44m
42651,2,LandGame,2130,247,9,8,17,52.9%,55m
42651,2,szyb,2130,232,8,12,20,40.0%,22m
42651,2,Indelion,2130,252,8,16,24,33.3%,1h
42651,2,Mementoz,2130,217,7,11,18,38.9%,53m
42651,1,Ciceron,2130,134,6,5,11,54.5%,37m
42651,2,Сталкер,2130,182,6,8,14,42.9%,1h
42651,2,[FR1]albert,2130,263,6,11,17,35.3%,2m
42651,3,kell,2130,178,6,12,18,33.3%,30m
42651,1,Zeruel,2130,0,4,3,7,57.1%,34m
42651,2,QUEPO,2130,70,2,4,6,33.3%,14m
42651,2,drac,2130,46,2,6,8,25.0%,24m
42651,2,Swaggy,2130,76,2,8,10,20.0%,9m
42651,2,NoZerex,2130,0,1,0,1,100.0%,45m
42651,2,erogaz,2130,88,1,1,2,50.0%,57m
42651,2,ton,2130,0,1,5,6,16.7%,55m
42651,2,[Bizou]Saphiosa,2130,30,1,6,7,14.3%,11m
42651,1,[8kg]GERoyal,2130,0,0,1,1,0.0%,33m
42651,1,SATI,2130,0,0,1,1,0.0%,56m
42651,2,kisho,2130,0,0,1,1,0.0%,14m
42651,2,rino,2130,0,0,1,1,0.0%,18m
42651,2,Ytow,2130,0,0,3,3,0.0%,55m
42651,3,Admanand,2130,0,0,5,5,0.0%,47m
42678,1,Shaman,2129,1621,372,380,752,49.5%,33m
42678,2,[NINJ88]Gameboy,2129,1512,109,113,222,49.1%,22m
42678,2,Korolev,2129,1615,71,73,144,49.3%,2m
42678,2,killi,2129,1326,51,49,100,51.0%,2m
42678,2,[Es]spidy,2129,649,35,40,75,46.7%,8m
42678,2,Boomer,2129,816,34,37,71,47.9%,11m
42678,2,[EnFi]orlando,2129,634,24,30,54,44.4%,9m
42678,2,[MTPL]TeutonicWall,2129,350,10,16,26,38.5%,37m
42678,1,император,2129,330,9,12,21,42.9%,35m
42678,1,Yuri,2129,214,6,16,22,27.3%,7m
42678,1,exolothrefti,2129,144,4,5,9,44.4%,33m
42678,1,HenryThree,2129,148,4,10,14,28.6%,3m
42678,2,ThomasShelby,2129,62,2,7,9,22.2%,52m
42678,2,NoxicQ,2129,97,2,8,10,20.0%,9m
42678,2,Violator,2129,0,1,6,7,14.3%,48m
42678,2,tati,2129,0,0,1,1,0.0%,1h
42694,2,Postko,2128,1541,115,112,227,50.7%,52m
42694,2,adechanterac,2128,1212,46,45,91,50.5%,53m
42694,2,XALK,2128,422,20,24,44,45.5%,2m
42694,2,Gishacobi,2128,423,15,23,38,39.5%,47m
42694,2,DarkRage,2128,166,7,7,14,50.0%,42m
42694,3,Kimo,2128,216,6,4,10,60.0%,8m
42694,2,RuntyGoblin,2128,118,4,10,14,28.6%,10m
42694,2,Vladimir,2128,114,3,0,3,100.0%,37m
42694,2,[Geil1]tec,2128,147,3,4,7,42.9%,32m
42694,1,Ass,2128,123,3,9,12,25.0%,44m
42694,3,Levingard,2128,30,2,5,7,28.6%,37m
42694,1,glab,2128,0,1,1,2,50.0%,35m
42694,2,[166]AlexFil,2128,0,1,2,3,33.3%,1h
42694,2,Glupfrog,2128,0,1,2,3,33.3%,1h
42694,3,Actarus,2128,0,1,3,4,25.0%,16m
42694,2,Zeratul,2128,0,0,1,1,0.0%,16m
42694,2,Валартарус,2128,0,0,1,1,0.0%,39m
42694,2,Drozdie,2128,0,0,1,1,0.0%,4m
42694,2,[sksksk]starspl,2128,0,0,1,1,0.0%,47m
42694,2,sosso,2128,0,0,2,2,0.0%,35m
42714,1,nOOdles,2127,1277,136,145,281,48.4%,29m
42714,2,Gabiles,2127,388,16,17,33,48.5%,26m
42714,1,MeowNine,2127,530,16,24,40,40.0%,29m
42714,2,blaydero,2127,436,15,18,33,45.5%,46m
42714,2,Amir,2127,363,14,12,26,53.8%,2m
42714,2,[ANREN]GGZerg,2127,396,14,13,27,51.9%,35m
42714,2,Apokalypse,2127,220,9,7,16,56.2%,18m
42714,2,varvar,2127,116,5,4,9,55.6%,27m
42714,2,Overfiel,2127,136,5,8,13,38.5%,55m
42714,1,Houshi,2127,144,5,11,16,31.2%,56m
42714,3,olozz,2127,122,5,12,17,29.4%,25m
42714,2,DreikP,2127,0,1,0,1,100.0%,38m
42714,1,Drake,2127,0,1,6,7,14.3%,37m
42714,2,DaronFox,2127,0,0,1,1,0.0%,48m
42714,2,Sauron,2127,0,0,3,3,0.0%,35m
42714,2,ДедБородед,2127,0,0,3,3,0.0%,16m
42730,1,linox,2126,758,82,88,170,48.2%,47m
42730,1,WhitePanda,2126,898,37,45,82,45.1%,16m
42730,3,Pil,2126,486,19,33,52,36.5%,12m
42730,2,Onimii,2126,440,13,19,32,40.6%,30m
42730,2,MobileEmpire,2126,316,10,10,20,50.0%,1h
42730,2,Denver,2126,220,9,7,16,56.2%,53m
42730,1,Sif,2126,263,8,14,22,36.4%,12m
42730,1,AlphaCentaur,2126,256,8,15,23,34.8%,53m
42730,2,[NOOBpl]nokia,2126,186,7,10,17,41.2%,2m
42730,2,Apo,2126,157,4,0,4,100.0%,24m
42730,2,DanValahul,2126,138,3,2,5,60.0%,12m
42730,2,ПростоМакс,2126,60,2,4,6,33.3%,19m
42730,2,Kapsha,2126,0,0,2,2,0.0%,29m
42730,2,cmvpolska,2126,0,0,4,4,0.0%,5m
42730,3,[ICUNLD]Regz,2126,0,0,5,5,0.0%,34m
42745,1,RoryGory,2125,1675,157,164,321,48.9%,36m
42745,2,OQPAKCDQ,2125,470,29,13,42,69.0%,53m
42745,2,BOROC,2125,776,29,27,56,51.8%,17m
42745,2,QwerAntropod,2125,613,25,27,52,48.1%,45m
42745,2,artik,2125,418,16,15,31,51.6%,3m
42745,1,Hyrveli,2125,292,7,13,20,35.0%,22m
42745,3,Garavel,2125,216,6,5,11,54.5%,53m
42745,2,haw,2125,145,4,2,6,66.7%,54m
42745,2,Harvax,2125,134,4,4,8,50.0%,53m
42745,1,[VWaile]FuсkAgro,2125,139,4,12,16,25.0%,55m
42745,2,WulfyTL,2125,112,3,0,3,100.0%,46m
42745,2,ColTrain,2125,0,3,2,5,60.0%,44m
42745,2,sow,2125,30,2,2,4,50.0%,27m
42745,2,VincePrince,2125,0,2,3,5,40.0%,4m
42745,2,MAROCLIU,2125,0,2,5,7,28.6%,39m
42745,2,[СБ]vZASADE,2125,0,1,0,1,100.0%,51m
42745,1,Ceny,2125,0,1,4,5,20.0%,21m
42745,1,Parsifals,2125,0,1,6,7,14.3%,1h
42745,2,storge,2125,0,0,1,1,0.0%,18m
42745,2,SilentSword,2125,0,0,3,3,0.0%,2m
42745,3,[улей55]HellScream,2125,0,0,5,5,0.0%,28m
42766,2,Jax,2124,965,36,42,78,46.2%,37m
42766,2,DeadWolf,2124,809,33,28,61,54.1%,44m
42766,2,ЧайИЗZилота,2124,749,30,32,62,48.4%,53m
42766,2,Timka,2124,768,27,30,57,47.4%,48m
42766,2,MAXUS,2124,391,16,13,29,55.2%,37m
42766,2,Spawnerr,2124,306,12,12,24,50.0%,21m
42766,2,cmdkarlsen,2124,143,4,8,12,33.3%,39m
42766,2,Махно,2124,0,3,5,8,37.5%,36m
42766,1,[frazf]Hookeup,2124,158,3,6,9,33.3%,12m
42766,2,Nizi,2124,86,3,8,11,27.3%,5m
42766,2,Waggle,2124,102,2,1,3,66.7%,35m
42766,2,knownPlayer,2124,60,2,7,9,22.2%,4m
42766,2,Wolfgard,2124,0,1,0,1,100.0%,48m
42766,2,Yunche,2124,0,1,2,3,33.3%,37m
42766,2,[cRoZzZ]DeNiis,2124,0,1,3,4,25.0%,47m
42766,1,asket,2124,84,1,3,4,25.0%,42m
42766,2,Victor,2124,30,1,5,6,16.7%,56m
42766,2,limolion,2124,0,0,1,1,0.0%,1h
42766,2,bOkeaneOn,2124,0,0,1,1,0.0%,40m
42766,2,Kratos,2124,0,0,3,3,0.0%,19m
42766,2,MattyZet,2124,0,0,4,4,0.0%,46m
42766,3,Freeman,2124,0,0,5,5,0.0%,54m
42788,2,FearLess,2123,882,46,48,94,48.9%,5m
42788,1,Анд,2123,506,18,24,42,42.9%,28m
42788,2,Jon,2123,464,16,19,35,45.7%,26m
42788,2,MiniMaxi,2123,409,14,20,34,41.2%,49m
42788,2,[3oda]Oliwavirus,2123,399,13,13,26,50.0%,27m
42788,2,ghost,2123,235,7,6,13,53.8%,52m
42788,2,zalman,2123,200,4,3,7,57.1%,31m
42788,1,MaxMocelot,2123,191,4,6,10,40.0%,32m
42788,1,[ICCZ]Croll,2123,126,3,4,7,42.9%,37m
42788,2,SenQmaN,2123,30,3,4,7,42.9%,25m
42788,2,Pavlitospb,2123,30,2,3,5,40.0%,20m
42788,1,Cottand,2123,38,2,8,10,20.0%,1h
42788,1,[VRND]Kfir,2123,96,2,9,11,18.2%,44m
42788,1,[Jc4]superantjosh,2123,48,1,2,3,33.3%,51m
42788,2,Justin,2123,0,1,4,5,20.0%,21m
42788,1,CaptCurtis,2123,97,1,4,5,20.0%,15m
42788,2,Hokage,2123,30,1,4,5,20.0%,57m
42788,2,Draculino,2123,0,0,1,1,0.0%,3m
42788,2,[Đrink]MultitalNtum,2123,0,0,1,1,0.0%,16m
42788,2,pocho,2123,0,0,1,1,0.0%,46m
42788,2,Christar,2123,0,0,1,1,0.0%,45m
42788,2,gewi,2123,0,0,2,2,0.0%,39m
42788,2,Anubis,2123,0,0,2,2,0.0%,1h
42788,2,GELM,2123,0,0,2,2,0.0%,1h
42788,2,[псина]АндрейПёс,2123,0,0,3,3,0.0%,37m
42788,2,Tristan,2123,0,0,4,4,0.0%,16m
42814,1,dukenukem,2122,747,69,70,139,49.6%,57m
42814,2,Uranhön,2122,1266,57,57,114,50.0%,19m
42814,2,[Koffie]Trasher,2122,582,20,27,47,42.6%,35m
42814,2,[Seal69]CaptainGlen,2122,396,16,14,30,53.3%,12m
42814,2,diospiro,2122,326,13,14,27,48.1%,1h
42814,2,Esolate,2122,264,10,7,17,58.8%,9m
42814,2,Cyfer,2122,288,10,14,24,41.7%,47m
42814,2,Ruel,2122,208,8,9,17,47.1%,19m
42814,2,HERETIK,2122,195,6,11,17,35.3%,22m
42814,1,Kenshin,2122,182,5,10,15,33.3%,9m
42814,2,Alexander,2122,151,3,7,10,30.0%,1h
42814,2,SilverEagle,2122,144,3,9,12,25.0%,12m
42814,1,PtiZiZi,2122,48,2,9,11,18.2%,43m
42814,2,[13g12p]brny,2122,0,1,0,1,100.0%,28m
42814,2,Snoops,2122,97,1,4,5,20.0%,28m
42814,2,LEV,2122,0,0,2,2,0.0%,14m
42814,2,Kittiaara,2122,0,0,5,5,0.0%,46m
42831,2,Starlord,2121,1470,187,193,380,49.2%,7m
42831,1,PatLOrD,2121,1584,97,102,199,48.7%,18m
42831,1,Dexter,2121,669,74,81,155,47.7%,41m
42831,1,[Katz]KrisFerein,2121,788,72,81,153,47.1%,21m
42831,2,SergiOm,2121,1346,65,59,124,52.4%,8m
42831,2,Greeniigames,2121,677,30,23,53,56.6%,47m
42831,2,[COOL]Joker,2121,702,25,31,56,44.6%,23m
42831,2,kicsipower,2121,506,20,20,40,50.0%,29m
42831,2,ABCD,2121,375,16,17,33,48.5%,2m
42831,3,KillMePlz,2121,480,16,25,41,39.0%,6m
42831,2,BlackCat,2121,224,9,8,17,52.9%,49m
42831,2,Cristal,2121,264,8,11,19,42.1%,37m
42831,2,udisemana,2121,181,7,1,8,87.5%,1h
42831,2,mert,2121,167,6,2,8,75.0%,7m
42831,2,[N7TKKD]Dimidrol,2121,128,4,1,5,80.0%,55m
42831,1,deepmusic,2121,138,4,13,17,23.5%,47m
42831,2,[сюда]XXX,2121,128,3,2,5,60.0%,2m
42831,2,KostikH,2121,60,2,2,4,50.0%,33m
42831,2,[Pkt3s]nacho,2121,62,2,5,7,28.6%,3m
42831,2,Truth,2121,0,1,0,1,100.0%,12m
42831,2,Xezardрус,2121,0,1,0,1,100.0%,15m
42831,2,ketch,2121,30,1,3,4,25.0%,8m
42831,2,Onyx,2121,0,0,1,1,0.0%,53m
42831,3,Qarkbällchen,2121,0,0,5,5,0.0%,16m
42831,3,ClicEastwood,2121,0,0,5,5,0.0%,4m
42856,2,[mfixed]gupihuj,2120,1596,137,131,268,51.1%,1h
42856,2,Zoárd,2120,1146,43,47,90,47.8%,12m
42856,1,[Zavood]Talupoeg,2120,792,35,41,76,46.1%,5m
42856,2,kikin,2120,718,26,31,57,45.6%,14m
42856,2,KWASI,2120,416,19,15,34,55.9%,3m
42856,2,Pixie,2120,218,7,11,18,38.9%,22m
42856,1,nanoSmetanka,2120,263,6,13,19,31.6%,29m
42856,2,jas,2120,150,5,2,7,71.4%,4m
42856,2,WestViper,2120,116,3,2,5,60.0%,45m
42856,1,SACHAlePIG,2120,145,3,9,12,25.0%,18m
42856,2,Flavio,2120,88,2,0,2,100.0%,43m
42856,1,Satchmo,2120,36,2,7,9,22.2%,18m
42856,2,Alfisto,2120,46,1,3,4,25.0%,33m
42856,2,Bartix,2120,0,0,2,2,0.0%,12m
42856,2,ALIEN,2120,0,0,5,5,0.0%,54m
42871,3,darkknight,2119,740,72,73,145,49.7%,34m
42871,2,Lightselect,2119,724,29,29,58,50.0%,1h
42871,2,gostik,2119,699,26,25,51,51.0%,46m
42871,1,[BOTSI]TwojaStara,2119,693,22,30,52,42.3%,2m
42871,1,racok,2119,524,16,23,39,41.0%,3m
42871,1,Bifford,2119,367,12,21,33,36.4%,35m
42871,2,GAVR,2119,333,10,18,28,35.7%,38m
42871,2,[A100]prototer,2119,212,8,10,18,44.4%,12m
42871,2,Darek,2119,255,8,12,20,40.0%,16m
42871,1,SPY,2119,232,8,17,25,32.0%,56m
42871,1,Vairo,2119,256,7,13,20,35.0%,38m
42871,2,Kaioh,2119,152,6,3,9,66.7%,15m
42871,2,[IndyK]kacperszczur,2119,144,6,7,13,46.2%,19m
42871,2,StArKiiLL,2119,150,5,10,15,33.3%,52m
42871,1,Kerosinchik,2119,143,4,9,13,30.8%,56m
42871,2,Sakul,2119,127,3,5,8,37.5%,28m
42871,1,Ted,2119,132,3,8,11,27.3%,1h
42871,2,splendeat,2119,62,2,3,5,40.0%,1h
42871,1,Robbienator,2119,0,2,5,7,28.6%,32m
42871,2,Tim,2119,0,1,0,1,100.0%,51m
42871,2,SharkOrigin,2119,0,1,0,1,100.0%,7m
42871,1,Bighut,2119,0,1,1,2,50.0%,6m
42871,2,Morpheus,2119,0,1,1,2,50.0%,31m
42871,2,Prdak,2119,0,0,1,1,0.0%,44m
42871,2,Victor,2119,0,0,2,2,0.0%,19m
42871,2,[ExTr1m]хорнэр,2119,0,0,4,4,0.0%,19m
42871,2,Dima,2119,0,0,4,4,0.0%,5m
42871,1,uniDIYversal,2119,0,0,5,5,0.0%,24m
42871,3,Stevie,2119,0,0,5,5,0.0%,48m
42871,2,Maackus,2119,0,0,5,5,0.0%,12m
42901,2,[mfxed]Julas,2118,877,66,61,127,52.0%,46m
42901,2,snowbor,2118,424,15,13,28,53.6%,19m
42901,2,Chill,2118,293,11,18,29,37.9%,45m
42901,2,евгений,2118,116,5,8,13,38.5%,21m
42901,2,Xyron,2118,84,5,13,18,27.8%,22m
42901,2,[RBR]Kïnta,2118,205,4,11,15,26.7%,1h
42901,2,Morpherrer,2118,0,1,0,1,100.0%,55m
42901,2,HenDi,2118,30,1,6,7,14.3%,13m
42909,2,сайнед,2117,846,130,136,266,48.9%,57m
42909,1,Hitane,2117,1652,68,77,145,46.9%,1h
42909,2,MIG,2117,1469,58,51,109,53.2%,1h
42909,1,Lakdate,2117,531,20,25,45,44.4%,47m
42909,2,TITAN,2117,0,4,3,7,57.1%,42m
42909,1,HellbirdIV,2117,0,3,5,8,37.5%,1h
42909,1,Revane,2117,30,3,7,10,30.0%,2m
42909,2,Flydor,2117,30,2,2,4,50.0%,51m
42909,2,MELT,2117,30,2,5,7,28.6%,32m
42909,2,[diseas]Коронавирус,2117,0,1,0,1,100.0%,3m
42909,2,PandaSamurai,2117,0,1,0,1,100.0%,2m
42909,2,Khaine,2117,88,1,1,2,50.0%,44m
42909,1,Maxexmax,2117,0,1,7,8,12.5%,1h
42909,1,[LCN]Francisco,2117,0,0,1,1,0.0%,38m
42909,2,ROCKETxSPUDZ,2117,0,0,1,1,0.0%,30m
42924,1,ocococ,2116,1672,107,114,221,48.4%,38m
42924,2,casito,2116,1336,52,52,104,50.0%,44m
42924,2,IURY,2116,1301,49,55,104,47.1%,12m
42924,2,Flow,2116,1080,39,37,76,51.3%,23m
42924,1,Evi,2116,636,31,38,69,44.9%,3m
42924,2,JBL,2116,526,18,21,39,46.2%,46m
42924,1,Atlantis,2116,430,13,20,33,39.4%,39m
42924,1,EBayOR,2116,370,11,17,28,39.3%,18m
42924,1,[NucLea]Sharkie,2116,356,11,19,30,36.7%,13m
42924,1,donlnz,2116,239,6,11,17,35.3%,23m
42924,1,Rick,2116,135,5,8,13,38.5%,32m
42924,1,lCarlitos,2116,24,2,4,6,33.3%,25m
42924,2,[PTVru]BigD,2116,0,1,3,4,25.0%,7m
42924,1,drfrPL,2116,0,1,7,8,12.5%,55m
42924,2,RMDark,2116,0,0,1,1,0.0%,44m
42924,2,fabinator,2116,0,0,5,5,0.0%,19m
42940,2,Ixid,2115,1603,122,128,250,48.8%,46m
42940,2,Arseniy,2115,708,42,37,79,53.2%,8m
42940,2,KnightOkiss,2115,940,33,36,69,47.8%,1h
42940,2,Kamikaze,2115,428,22,32,54,40.7%,37m
42940,2,GAGI,2115,465,16,24,40,40.0%,48m
42940,1,Aegiseevee,2115,434,15,16,31,48.4%,5m
42940,2,omosgames,2115,174,7,13,20,35.0%,33m
42940,3,Qualia,2115,224,7,14,21,33.3%,16m
42940,1,[AESC]Dmitry,2115,148,5,0,5,100.0%,44m
42940,1,Imperial,2115,48,4,10,14,28.6%,32m
42940,2,Sraka,2115,144,3,4,7,42.9%,55m
42940,2,Turtule,2115,128,3,6,9,33.3%,12m
42940,2,Dionza,2115,118,3,8,11,27.3%,3m
42940,2,tarach,2115,88,2,0,2,100.0%,18m
42940,2,Сергей,2115,30,2,1,3,66.7%,8m
42940,1,NightAngel,2115,48,2,8,10,20.0%,51m
42940,2,Borzo,2115,84,2,13,15,13.3%,40m
42940,3,Hyroph,2115,0,1,3,4,25.0%,5m
42940,3,jarod,2115,0,0,5,5,0.0%,22m
42940,2,Rodrigeuz,2115,0,0,5,5,0.0%,1h
42940,2,protzerg,2115,0,0,5,5,0.0%,51m
42961,1,Capitain,2114,1533,102,112,214,47.7%,53m
42961,2,[3ЕRGTV]Kaori,2114,813,34,39,73,46.6%,55m
42961,2,Шпротос,2114,742,31,28,59,52.5%,19m
42961,2,гарис,2114,456,28,25,53,52.8%,31m
42961,2,SamTX,2114,466,20,19,39,51.3%,57m
42961,2,Zin,2114,528,19,26,45,42.2%,7m
42961,2,KaplaStaven,2114,531,18,24,42,42.9%,47m
42961,2,Kama,2114,448,16,19,35,45.7%,23m
42961,2,Voyouse,2114,426,15,16,31,48.4%,8m
42961,2,Uragimiru,2114,271,12,8,20,60.0%,27m
42961,2,Winkii,2114,228,8,5,13,61.5%,57m
42961,1,Branchie,2114,268,7,16,23,30.4%,55m
42961,2,RYLIN,2114,116,6,2,8,75.0%,29m
42961,2,WiseJoe,2114,196,5,6,11,45.5%,27m
42961,2,vofvendetta,2114,75,4,2,6,66.7%,12m
42961,1,alexeevdv,2114,94,3,8,11,27.3%,55m
42961,2,SirXander,2114,30,2,1,3,66.7%,37m
42961,1,skydragon,2114,0,1,7,8,12.5%,1h
42961,1,ONEDENSLAZ,2114,97,1,8,9,11.1%,27m
42961,1,[HgrC]makkapakka,2114,0,0,1,1,0.0%,35m
42981,2,[SPAINs]KevinToPro,2113,1302,49,51,100,49.0%,22m
42981,2,ErectionMan,2113,609,22,21,43,51.2%,37m
42981,1,Kairos,2113,510,18,28,46,39.1%,1h
42981,2,Chechundra,2113,419,16,12,28,57.1%,21m
42981,2,goodGuyZim,2113,384,16,17,33,48.5%,1h
42981,2,KaKaRoTTo,2113,264,13,4,17,76.5%,13m
42981,1,Matys,2113,407,13,15,28,46.4%,28m
42981,2,Herpestes,2113,255,11,9,20,55.0%,44m
42981,1,SirBroken,2113,394,11,19,30,36.7%,34m
42981,1,zamir,2113,366,11,20,31,35.5%,38m
42981,2,JustMeDanny,2113,372,10,15,25,40.0%,3m
42981,1,killerdashka,2113,208,7,4,11,63.6%,22m
42981,2,Megam,2113,30,4,5,9,44.4%,38m
42981,2,[соклан]Денис,2113,123,3,7,10,30.0%,19m
42981,2,pikou,2113,92,2,7,9,22.2%,55m
42981,1,Raskol,2113,0,2,7,9,22.2%,43m
42981,2,Andrey,2113,0,1,1,2,50.0%,45m
42981,1,[WАSD]BenBrown,2113,48,1,2,3,33.3%,1h
42981,3,[душит]Иван,2113,0,1,6,7,14.3%,1h
42981,1,Crazylemur,2113,0,1,6,7,14.3%,3m
42981,1,Artanis,2113,0,1,7,8,12.5%,55m
43002,1,IxLahac,2112,1678,105,119,224,46.9%,47m
43002,1,кивин,2112,1085,39,43,82,47.6%,24m
43002,2,Doomster,2112,693,27,30,57,47.4%,25m
43002,1,TITTO,2112,685,23,28,51,45.1%,39m
43002,2,генерал,2112,503,22,22,44,50.0%,14m
43002,1,Prometheus,2112,670,22,30,52,42.3%,8m
43002,2,PapitchSpec,2112,195,11,6,17,64.7%,52m
43002,2,Соломон,2112,255,10,6,16,62.5%,10m
43002,1,Fevral,2112,284,7,14,21,33.3%,38m
43002,1,toncho,2112,166,4,3,7,57.1%,25m
43002,2,Maru,2112,95,3,2,5,60.0%,21m
43002,2,Charly,2112,0,3,2,5,60.0%,12m
43002,2,PATRICKstar,2112,30,2,1,3,66.7%,48m
43002,2,Arturus,2112,44,1,2,3,33.3%,53m
43002,2,REKA,2112,97,1,6,7,14.3%,24m
43002,2,Lugaroc,2112,0,1,7,8,12.5%,41m
43002,2,Liosnse,2112,0,0,1,1,0.0%,18m
43002,2,Awink,2112,0,0,2,2,0.0%,28m
43002,2,ChickenLord,2112,0,0,3,3,0.0%,21m
43002,3,Kivune,2112,0,0,5,5,0.0%,43m
43022,2,[N1TDA]Ramsès,2111,1572,199,222,421,47.3%,18m
43022,2,Noumen,2111,1265,58,64,122,47.5%,46m
43022,1,TrafalMat,2111,1193,43,50,93,46.2%,34m
43022,2,Toss,2111,482,38,35,73,52.1%,37m
43022,1,[2GV]JasondinAlt,2111,368,26,38,64,40.6%,54m
43022,2,TryHard,2111,309,14,13,27,51.9%,50m
43022,2,Manassi,2111,364,13,16,29,44.8%,19m
43022,2,[ANREN]Ravzan,2111,293,12,5,17,70.6%,1h
43022,2,Tobastov,2111,283,9,16,25,36.0%,46m
43022,2,[N01ZE]EmptyZerO,2111,242,7,6,13,53.8%,55m
43022,2,Narloth,2111,135,5,3,8,62.5%,57m
43022,2,kimy,2111,122,4,7,11,36.4%,30m
43022,2,[WÓDKA1]PIOTER,2111,86,3,1,4,75.0%,55m
43022,2,Gundam,2111,116,3,1,4,75.0%,26m
43022,1,Terror,2111,120,3,9,12,25.0%,29m
43022,1,BESHANYI,2111,166,3,10,13,23.1%,35m
43022,2,tatabulby,2111,30,2,1,3,66.7%,33m
43022,2,Penelope,2111,0,1,0,1,100.0%,41m
43022,2,django,2111,0,1,1,2,50.0%,48m
43022,2,Anastasio,2111,30,1,4,5,20.0%,14m
43022,1,[BWLD]Baloo,2111,0,1,7,8,12.5%,33m
43022,3,Злоубийца,2111,0,0,4,4,0.0%,11m
43022,3,Kotuva,2111,0,0,5,5,0.0%,54m
43045,1,trift,2110,1015,96,96,192,50.0%,47m
43045,2,TuLong,2110,1529,66,70,136,48.5%,46m
43045,1,Nitrogen,2110,871,32,35,67,47.8%,18m
43045,2,[sacros]Jost,2110,570,23,25,48,47.9%,7m
43045,2,Caeon,2110,602,22,27,49,44.9%,54m
43045,2,SNOW,2110,235,15,10,25,60.0%,40m
43045,2,maximus,2110,236,12,15,27,44.4%,52m
43045,2,Crabman,2110,375,11,18,29,37.9%,28m
43045,2,kseroys,2110,228,8,4,12,66.7%,29m
43045,2,SzéligPeti,2110,204,7,12,19,36.8%,1h
43045,2,MarshalCole,2110,167,6,2,8,75.0%,48m
43045,2,Joeshipday,2110,156,5,8,13,38.5%,37m
43045,1,HajoxxCool,2110,191,4,3,7,57.1%,31m
43045,2,Yokitori,2110,46,4,3,7,57.1%,12m
43045,2,COLDSCORPION,2110,116,4,10,14,28.6%,46m
43045,2,Shimrra,2110,102,3,0,3,100.0%,1h
43045,2,ROB,2110,48,2,4,6,33.3%,16m
43045,2,xanawaro,2110,119,2,7,9,22.2%,3m
43045,1,ALUKARD,2110,46,2,8,10,20.0%,25m
43045,2,Turbeek,2110,44,1,2,3,33.3%,12m
43045,2,Catherine,2110,88,1,5,6,16.7%,42m
43045,2,VVV,2110,0,0,1,1,0.0%,54m
43045,2,[Pulpo]KRW,2110,0,0,1,1,0.0%,12m
43045,2,TimDimik,2110,0,0,2,2,0.0%,31m
43069,2,Lorium,2109,1553,95,102,197,48.2%,1h
43069,3,Paul,2109,986,89,93,182,48.9%,47m
43069,2,kishin,2109,704,27,32,59,45.8%,3m
43069,3,[RRQ]MrBroиzeЖ,2109,672,24,39,63,38.1%,1h
43069,2,[valdaa]Valda,2109,430,21,18,39,53.8%,21m
43069,1,Raid,2109,698,21,25,46,45.7%,8m
43069,2,student,2109,107,7,8,15,46.7%,43m
43069,3,Dusken,2109,220,7,14,21,33.3%,44m
43069,2,dantess,2109,94,6,12,18,33.3%,4m
43069,1,TomasGops,2109,211,5,5,10,50.0%,26m
43069,2,Injaw,2109,130,4,3,7,57.1%,1h
43069,2,[VGZR]Swaffeln,2109,151,4,6,10,40.0%,14m
43069,3,Лердн,2109,0,3,2,5,60.0%,44m
43069,2,TOM,2109,58,2,8,10,20.0%,55m
43069,2,jake,2109,30,1,2,3,33.3%,46m
43069,2,Arsek,2109,0,0,2,2,0.0%,8m
43069,2,BarbaroR,2109,0,0,2,2,0.0%,10m
43069,2,[13NRV]Stilet,2109,0,0,5,5,0.0%,18m
43087,2,coolSnake,2108,1360,167,171,338,49.4%,5m
43087,2,ТРАМПЕЦ,2108,1236,52,46,98,53.1%,49m
43087,1,[Karuna]Keruto,2108,1054,46,55,101,45.5%,1h
43087,1,Hubert,2108,349,12,22,34,35.3%,3m
43087,2,PeaceAndLove,2108,303,11,8,19,57.9%,23m
43087,2,ZEK,2108,234,9,12,21,42.9%,48m
43087,2,Schiano,2108,208,8,9,17,47.1%,20m
43087,3,Overmind,2108,120,7,13,20,35.0%,1h
43087,2,[Stoog]RuMnCokE,2108,125,4,0,4,100.0%,53m
43087,2,Ghost,2108,0,1,0,1,100.0%,38m
43087,2,DaFr,2108,0,1,6,7,14.3%,39m
43087,2,standoff,2108,0,0,1,1,0.0%,1h
43087,2,AIAR,2108,0,0,1,1,0.0%,4m
43087,2,leonid,2108,0,0,3,3,0.0%,12m
43087,2,Starslayer,2108,0,0,5,5,0.0%,29m
43102,1,Emperator,2107,1431,251,252,503,49.9%,38m
43102,2,[Cancro]Optimus,2107,1308,89,98,187,47.6%,12m
43102,2,Leikan,2107,889,55,50,105,52.4%,8m
43102,2,naglfar,2107,744,27,31,58,46.6%,45m
43102,2,Shalex,2107,576,20,21,41,48.8%,1h
43102,2,MaximusPL,2107,530,19,23,42,45.2%,30m
43102,2,LAKATOS,2107,494,16,23,39,41.0%,1h
43102,2,archVillain,2107,172,7,6,13,53.8%,57m
43102,2,Anomander,2107,209,7,9,16,43.8%,39m
43102,1,Nefarious,2107,156,6,12,18,33.3%,32m
43102,2,zerg,2107,116,4,0,4,100.0%,45m
43102,2,Narf,2107,146,4,2,6,66.7%,41m
43102,2,heroes,2107,128,4,6,10,40.0%,18m
43102,2,mmisii,2107,90,3,5,8,37.5%,53m
43102,2,[666999]IsoldMySoul,2107,86,3,7,10,30.0%,52m
43102,1,Лывпиу,2107,48,3,8,11,27.3%,39m
43102,2,IskroMan,2107,88,1,1,2,50.0%,39m
43102,2,krtok,2107,30,1,2,3,33.3%,51m
43102,2,MAXIM,2107,30,1,4,5,20.0%,12m
43102,2,Beccobecs,2107,0,1,6,7,14.3%,49m
43102,2,lightnokami,2107,90,1,6,7,14.3%,39m
43102,1,Trociu,2107,0,0,2,2,0.0%,18m
43102,2,MrFreaked,2107,0,0,5,5,0.0%,39m
43125,1,DNA,2106,1105,73,76,149,49.0%,54m
43125,2,djoolay,2106,743,36,38,74,48.6%,1h
43125,2,JiPark,2106,944,34,40,74,45.9%,55m
43125,1,Skorpio,2106,913,33,38,71,46.5%,1h
43125,2,DreadLord,2106,460,18,16,34,52.9%,39m
43125,2,[Apoka1]EGORODS,2106,408,16,16,32,50.0%,16m
43125,2,poLi,2106,244,11,3,14,78.6%,18m
43125,2,Android,2106,315,10,10,20,50.0%,12m
43125,2,[LOB]Servietsky,2106,335,10,17,27,37.0%,33m
43125,2,[croWz]chizu,2106,264,8,15,23,34.8%,54m
43125,2,DeadEuclid,2106,30,2,1,3,66.7%,45m
43125,1,AMARU,2106,30,2,7,9,22.2%,40m
43125,2,[221232]Zon,2106,0,1,0,1,100.0%,1h
43125,2,ROUKOUNIS,2106,88,1,1,2,50.0%,1h
43125,2,[Surya]Olma,2106,36,1,3,4,25.0%,7m
43125,3,Damon,2106,0,1,4,5,20.0%,44m
43125,1,[VBP]Stilton,2106,48,1,5,6,16.7%,36m
43125,1,Sufentanil,2106,0,1,7,8,12.5%,26m
43125,2,malkom,2106,0,0,1,1,0.0%,47m
43125,2,[Kboin]Letty,2106,0,0,2,2,0.0%,44m
43125,3,Raptor,2106,0,0,3,3,0.0%,47m
43146,1,Amsterdemon,2105,1669,219,220,439,49.9%,39m
43146,1,Drugsoul,2105,1662,154,149,303,50.8%,26m
43146,2,ödu,2105,1101,105,105,210,50.0%,4m
43146,1,[KRONOM]GHOST,2105,1126,83,76,159,52.2%,18m
43146,1,Veon,2105,1070,82,86,168,48.8%,1h
43146,2,snamikot,2105,1048,39,42,81,48.1%,9m
43146,2,ILLUMINATI,2105,882,33,37,70,47.1%,19m
43146,1,Geos,2105,192,5,13,18,27.8%,36m
43146,1,AleksV,2105,167,4,10,14,28.6%,6m
43146,2,[Zhig]остап,2105,60,4,11,15,26.7%,27m
43146,2,[CHOPAA]SEMENKORNEEV,2105,118,3,2,5,60.0%,12m
43146,2,[SPAINs]Eolydo,2105,141,3,4,7,42.9%,36m
43146,2,sashabos,2105,0,1,2,3,33.3%,12m
43146,2,Underground,2105,93,1,2,3,33.3%,39m
43146,1,Teodor,2105,0,1,7,8,12.5%,37m
43146,2,[AusGam]AzAzElIuS,2105,0,0,1,1,0.0%,25m
43146,2,cheery,2105,0,0,1,1,0.0%,39m
43146,2,james,2105,0,0,3,3,0.0%,3m
43146,3,Wheeler,2105,0,0,5,5,0.0%,4m
43146,2,Wutbuffen,2105,0,0,5,5,0.0%,47m
43146,2,stathis,2105,0,0,5,5,0.0%,36m
43146,2,YurgenDnepr,2105,0,0,7,7,0.0%,12m
43168,3,pitch,2104,1419,183,193,376,48.7%,21m
43168,2,STARTERRAN,2104,1453,79,92,171,46.2%,1h
43168,1,SANDR,2104,589,24,25,49,49.0%,40m
43168,2,вячеслав,2104,499,19,24,43,44.2%,25m
43168,2,CleverZerg,2104,424,18,16,34,52.9%,32m
43168,1,ДмитрийВремя,2104,386,12,20,32,37.5%,1h
43168,2,[Ypikaï]Aou,2104,327,11,9,20,55.0%,50m
43168,2,CyberPhantom,2104,201,6,3,9,66.7%,16m
43168,2,[54D]doni,2104,150,6,9,15,40.0%,48m
43168,1,Rommel,2104,236,6,13,19,31.6%,17m
43168,2,Zergey,2104,130,3,3,6,50.0%,18m
43168,2,[HMarch]Alltair,2104,88,2,0,2,100.0%,52m
43168,2,MrSlashUa,2104,30,2,1,3,66.7%,48m
43168,2,краб,2104,30,2,2,4,50.0%,2m
43168,2,Djouw,2104,137,2,6,8,25.0%,24m
43168,2,[NCT]Lakhamu,2104,0,1,0,1,100.0%,37m
43168,2,Sentenx,2104,0,1,0,1,100.0%,27m
43168,2,MultyGamer,2104,0,0,1,1,0.0%,1h
43168,2,[CLMS]Flotaku,2104,0,0,2,2,0.0%,53m
43187,2,snoopy,2103,909,86,81,167,51.5%,5m
43187,1,[OmDi]DSX,2103,1585,82,83,165,49.7%,3m
43187,2,german,2103,1572,81,79,160,50.6%,12m
43187,1,[UscHi]Stein,2103,804,32,42,74,43.2%,41m
43187,2,meng,2103,490,28,2,30,93.3%,43m
43187,2,FILLOWN,2103,832,28,35,63,44.4%,54m
43187,2,Donald,2103,552,19,25,44,43.2%,47m
43187,2,wHyEt,2103,458,16,21,37,43.2%,50m
43187,2,Donet,2103,388,14,17,31,45.2%,46m
43187,2,[CieNT]CieNQuadril,2103,380,13,21,34,38.2%,53m
43187,2,Rubendepoes,2103,208,7,9,16,43.8%,30m
43187,2,Backspace,2103,251,5,9,14,35.7%,4m
43187,3,БиБа,2103,92,3,10,13,23.1%,1h
43187,3,[XDMan]SIGGE,2103,30,3,11,14,21.4%,52m
43187,3,ninobulo,2103,40,2,10,12,16.7%,1h
43187,2,SpaceGhost,2103,0,0,4,4,0.0%,12m
43187,3,OpticHaze,2103,0,0,5,5,0.0%,47m
43204,1,Monking,2102,1430,218,228,446,48.9%,50m
43204,2,borisfoto,2102,875,36,32,68,52.9%,23m
43204,2,KNLord,2102,521,22,26,48,45.8%,29m
43204,1,Wind,2102,411,19,22,41,46.3%,14m
43204,2,Chronos,2102,396,16,14,30,53.3%,45m
43204,2,Alexeichua,2102,438,16,18,34,47.1%,8m
43204,2,STRKuper,2102,376,12,12,24,50.0%,19m
43204,1,Dariosmith,2102,390,11,21,32,34.4%,3m
43204,2,SteamRoller,2102,143,10,7,17,58.8%,46m
43204,2,RoGhost,2102,304,9,16,25,36.0%,8m
43204,2,Despota,2102,176,5,4,9,55.6%,8m
43204,2,DarkDynastie,2102,120,5,4,9,55.6%,12m
43204,2,Zorg,2102,164,4,5,9,44.4%,21m
43204,2,JeLite,2102,46,2,7,9,22.2%,35m
43204,2,Commander,2102,0,1,3,4,25.0%,44m
43204,2,Balthazor,2102,44,1,3,4,25.0%,43m
43204,2,BOUGNA,2102,0,0,1,1,0.0%,43m
43204,1,[JaPP]Владимир,2102,0,0,2,2,0.0%,27m
43204,3,Benido,2102,0,0,5,5,0.0%,26m
43223,1,Sushi,2101,1574,81,82,163,49.7%,2m
43223,2,TukiiTukii,2101,914,45,47,92,48.9%,54m
43223,1,ЖирныйКот,2101,603,23,27,50,46.0%,27m
43223,1,Regent,2101,201,20,20,40,50.0%,28m
43223,2,Patmat,2101,371,15,16,31,48.4%,37m
43223,1,[10RuS]papasan,2101,334,10,19,29,34.5%,4m
43223,1,[2Dteam]pacman,2101,210,8,13,21,38.1%,28m
43223,3,KillerLev,2101,0,4,1,5,80.0%,35m
43223,2,Trypochek,2101,158,4,3,7,57.1%,8m
43223,2,[ЕViLs]SioN,2101,120,4,6,10,40.0%,19m
43223,1,Petroslav,2101,110,3,12,15,20.0%,53m
43223,2,decooos,2101,30,2,2,4,50.0%,47m
43223,2,Olgon,2101,96,2,6,8,25.0%,4m
43223,2,AlfSanz,2101,60,2,6,8,25.0%,39m
43223,3,CANITO,2101,97,1,1,2,50.0%,8m
43223,2,Skywalker,2101,95,1,6,7,14.3%,10m
43223,2,[NaNii]Sparda,2101,0,0,1,1,0.0%,46m
43223,1,MrMagoo,2101,0,0,6,6,0.0%,33m
43241,1,qunn,2100,1229,75,72,147,51.0%,42m
43241,2,[NsG20]Shrogh,2100,831,33,28,61,54.1%,1h
43241,1,leshman,2100,685,25,26,51,49.0%,28m
43241,2,Dawann,2100,726,25,31,56,44.6%,57m
43241,2,Ferrum,2100,459,18,14,32,56.2%,55m
43241,2,BigS,2100,362,15,20,35,42.9%,18m
43241,1,Shizmo,2100,317,12,18,30,40.0%,31m
43241,2,AlfaSammeC,2100,390,12,22,34,35.3%,39m
43241,2,warior,2100,278,9,7,16,56.2%,52m
43241,2,unkown,2100,254,9,11,20,45.0%,2m
43241,2,[CeRviD]IvBar,2100,202,9,13,22,40.9%,47m
43241,2,GIZMO,2100,221,7,14,21,33.3%,48m
43241,2,SanJosanto,2100,178,5,10,15,33.3%,46m
43241,2,Nikit,2100,0,4,1,5,80.0%,55m
43241,2,Deadpool,2100,114,4,7,11,36.4%,19m
43241,2,JBJ,2100,0,3,3,6,50.0%,42m
43241,2,Kauri,2100,114,2,7,9,22.2%,12m
43241,1,АртёмБаг,2100,97,2,8,10,20.0%,42m
43241,2,galagan,2100,88,1,2,3,33.3%,32m
43241,1,Ulrik,2100,0,1,2,3,33.3%,6m
43241,2,ApolloMB,2100,30,1,3,4,25.0%,54m
43241,2,BlackHunter,2100,0,0,1,1,0.0%,33m
43241,2,Karthesis,2100,0,0,6,6,0.0%,43m
43264,3,avt,2099,1478,152,169,321,47.4%,8m
43264,2,Jomass,2099,274,13,5,18,72.2%,7m
43264,2,Şeref,2099,360,13,17,30,43.3%,53m
43264,2,[БaT]SoX,2099,284,10,13,23,43.5%,52m
43264,2,RonZ,2099,246,8,9,17,47.1%,46m
43264,2,IbramGaunt,2099,154,5,13,18,27.8%,46m
43264,2,kolakek,2099,124,3,2,5,60.0%,1h
43264,2,Cavalian,2099,136,3,3,6,50.0%,46m
43264,2,SosuZaRagu,2099,149,3,8,11,27.3%,12m
43264,1,Hell,2099,141,3,9,12,25.0%,36m
43264,1,Liberdon,2099,34,2,7,9,22.2%,17m
43264,2,Andreielpro,2099,0,1,0,1,100.0%,28m
43264,2,OverlordArc,2099,0,1,1,2,50.0%,23m
43264,1,[JediK]icid,2099,48,1,7,8,12.5%,47m
43264,2,tyron,2099,0,0,1,1,0.0%,15m
43264,3,rainbowllama,2099,0,0,1,1,0.0%,48m
43264,2,WoolyBugger,2099,0,0,2,2,0.0%,57m
43264,2,LorDolor,2099,0,0,2,2,0.0%,20m
43264,2,derklin,2099,0,0,4,4,0.0%,22m
43264,2,Mainactor,2099,0,0,6,6,0.0%,27m
43284,2,SRC,2098,1595,142,146,288,49.3%,1h
43284,2,JebieUkraine,2098,905,102,103,205,49.8%,49m
43284,2,Swayzomad,2098,574,20,21,41,48.8%,57m
43284,2,[Mursu]Veturi,2098,471,18,27,45,40.0%,37m
43284,2,pop,2098,194,8,11,19,42.1%,27m
43284,2,Сoolscar,2098,151,5,14,19,26.3%,27m
43284,2,Yage,2098,94,4,6,10,40.0%,1h
43284,2,Spiderpig,2098,138,3,3,6,50.0%,19m
43284,2,MrO,2098,60,3,5,8,37.5%,22m
43284,2,MrWorleg,2098,46,2,4,6,33.3%,13m
43284,2,MihaiMD,2098,60,2,5,7,28.6%,45m
43284,2,[oooboy]BattlePatrik,2098,0,1,0,1,100.0%,47m
43284,1,Juteux,2098,0,1,7,8,12.5%,1h
43284,2,sciopes,2098,0,0,3,3,0.0%,21m
43284,2,Anatoly,2098,0,0,5,5,0.0%,12m
43299,2,Proppa,2097,1457,142,157,299,47.5%,7m
43299,2,waterwater,2097,1553,107,118,225,47.6%,36m
43299,2,Влад,2097,424,18,18,36,50.0%,12m
43299,2,Bontarget,2097,401,16,15,31,51.6%,23m
43299,2,Madex,2097,366,13,20,33,39.4%,1h
43299,2,DarkZergling,2097,156,6,1,7,85.7%,23m
43299,1,MrKC,2097,198,5,11,16,31.2%,37m
43299,2,Logan,2097,114,3,1,4,75.0%,3m
43299,1,Smerch,2097,142,3,7,10,30.0%,30m
43299,1,Jeannie,2097,38,2,8,10,20.0%,24m
43299,2,Skyraptor,2097,0,1,0,1,100.0%,41m
43299,2,mitashkistz,2097,88,1,1,2,50.0%,21m
43299,2,[Rofler]Razvan,2097,30,1,3,4,25.0%,23m
43299,2,Eridan,2097,0,0,1,1,0.0%,46m
43299,2,Stefan,2097,0,0,2,2,0.0%,35m
43299,2,IinxivAtE,2097,0,0,2,2,0.0%,21m
43299,2,Stef,2097,0,0,2,2,0.0%,28m
43299,3,[ABDI]Dadane,2097,0,0,5,5,0.0%,44m
43317,2,Lokkee,2096,332,27,27,54,50.0%,54m
43317,2,Berg,2096,517,20,18,38,52.6%,53m
43317,2,Darinan,2096,344,11,12,23,47.8%,31m
43317,1,[IFGDI]Hraptor,2096,298,10,19,29,34.5%,47m
43317,1,Zargnaza,2096,221,6,8,14,42.9%,12m
43317,2,Прыскин,2096,92,5,7,12,41.7%,2m
43317,2,Yuerson,2096,116,4,1,5,80.0%,7m
43317,2,zergys,2096,116,4,6,10,40.0%,48m
43317,2,David,2096,94,4,9,13,30.8%,48m
43317,1,slimeedot,2096,0,0,1,1,0.0%,4m
43317,2,[LifeTV]SmerchKZ,2096,0,0,1,1,0.0%,5m
43317,2,Leshka,2096,0,0,1,1,0.0%,30m
43317,1,НИККК,2096,0,0,1,1,0.0%,16m
43317,2,[Fabbel]МистерГипс,2096,0,0,1,1,0.0%,21m
43317,1,[LVxVL]Kyng,2096,0,0,2,2,0.0%,42m
43317,3,Original,2096,0,0,5,5,0.0%,50m
43333,3,[OmDi]ThePriest,2095,1509,77,89,166,46.4%,21m
43333,1,[SUDA]xapourep,2095,753,38,47,85,44.7%,48m
43333,2,[MRSA]Kiezpirat,2095,690,36,31,67,53.7%,23m
43333,1,KING,2095,580,30,33,63,47.6%,4m
43333,2,Nannack,2095,453,19,14,33,57.6%,3m
43333,2,Void,2095,264,13,15,28,46.4%,37m
43333,2,CRAZYDAVE,2095,299,10,16,26,38.5%,8m
43333,2,RobinMaster,2095,296,9,10,19,47.4%,49m
43333,1,Mattyhyde,2095,300,9,13,22,40.9%,39m
43333,2,Watermelon,2095,297,9,18,27,33.3%,5m
43333,2,garrot,2095,301,9,21,30,30.0%,13m
43333,2,PROXMEN,2095,276,8,10,18,44.4%,13m
43333,2,DuranDuran,2095,206,7,8,15,46.7%,7m
43333,2,elda,2095,182,6,6,12,50.0%,20m
43333,2,Dovahkïn,2095,96,5,5,10,50.0%,35m
43333,2,SHIBARI,2095,58,5,5,10,50.0%,55m
43333,2,Leinad,2095,126,5,9,14,35.7%,14m
43333,1,Valaric,2095,118,2,1,3,66.7%,1h
43333,1,[IHBtI]Redguard,2095,38,2,4,6,33.3%,34m
43333,2,Merlen,2095,116,2,9,11,18.2%,39m
43333,2,Ramdeon,2095,94,1,2,3,33.3%,34m
43333,2,PAKEman,2095,0,0,1,1,0.0%,9m
43333,3,Hoplitespear,2095,0,0,5,5,0.0%,22m
43333,3,[Kicx]Fantoh,2095,0,0,5,5,0.0%,4m
43357,2,Predator,2094,445,71,71,142,50.0%,33m
43357,2,littlepanda,2094,1144,65,66,131,49.6%,50m
43357,2,GOHAR,2094,613,31,38,69,44.9%,8m
43357,3,[Lolers]Mrpoloko,2094,559,19,29,48,39.6%,16m
43357,2,Bordun,2094,443,16,13,29,55.2%,52m
43357,3,[OLIM]Mauro,2094,477,16,30,46,34.8%,37m
43357,2,Ximachu,2094,272,9,13,22,40.9%,21m
43357,2,PitFiend,2094,148,6,1,7,85.7%,44m
43357,2,[ffffhj]DiAbEtIk,2094,158,4,3,7,57.1%,12m
43357,2,Furycode,2094,88,3,3,6,50.0%,18m
43357,2,[4Cap]CPTMichael,2094,58,2,3,5,40.0%,43m
43357,3,DiamondHACK,2094,48,2,4,6,33.3%,38m
43357,1,незламний,2094,0,1,1,2,50.0%,33m
43357,3,IIIIIII,2094,46,1,1,2,50.0%,24m
43357,2,[45IQ]OLWchips,2094,95,1,2,3,33.3%,51m
43357,2,[Burla]alettaO,2094,0,0,1,1,0.0%,1h
43357,1,Leviofan,2094,0,0,2,2,0.0%,1h
43357,2,lilute,2094,0,0,2,2,0.0%,45m
43357,3,Valher,2094,0,0,5,5,0.0%,54m
43357,3,Borstol,2094,0,0,5,5,0.0%,22m
43357,2,BOGDAN,2094,0,0,5,5,0.0%,12m
43378,2,[Ahouuu]TITIFR,2093,722,62,66,128,48.4%,27m
43378,1,CrAnKJoKeR,2093,496,33,36,69,47.8%,55m
43378,1,Schamane,2093,894,31,42,73,42.5%,21m
43378,1,Felix,2093,295,10,15,25,40.0%,57m
43378,2,GhostDragon,2093,283,10,16,26,38.5%,33m
43378,2,[Skgs]KOBRAKAI,2093,240,8,14,22,36.4%,51m
43378,2,TailedFox,2093,198,7,4,11,63.6%,4m
43378,2,SinteZzz,2093,152,5,6,11,45.5%,12m
43378,1,Besylur,2093,142,5,12,17,29.4%,3m
43378,2,gjseminario,2093,128,4,3,7,57.1%,18m
43378,1,rOO,2093,122,4,6,10,40.0%,42m
43378,2,messia,2093,102,3,1,4,75.0%,18m
43378,3,ВованМосква,2093,125,3,10,13,23.1%,21m
43378,3,siopsys,2093,0,1,0,1,100.0%,27m
43378,1,PanaVL,2093,0,1,6,7,14.3%,45m
43378,2,MerlinT,2093,0,0,1,1,0.0%,54m
43378,3,[Emрire]ахмед,2093,0,0,1,1,0.0%,21m
43378,3,[7D]абуббандит,2093,0,0,2,2,0.0%,21m
43378,3,[БИЗНЕС]VOLKAR,2093,0,0,3,3,0.0%,10m
43378,2,DoWePlayLike,2093,0,0,4,4,0.0%,1h
43398,1,Kablys,2092,1234,262,281,543,48.3%,1h
43398,2,Dzhigit,2092,979,93,89,182,51.1%,48m
43398,2,Ishak,2092,1360,69,74,143,48.3%,1h
43398,2,DISCOVER,2092,1528,61,68,129,47.3%,49m
43398,3,Adil,2092,694,26,25,51,51.0%,28m
43398,1,BondiCastle,2092,824,25,36,61,41.0%,32m
43398,2,prinz,2092,476,19,10,29,65.5%,19m
43398,3,Gorgondo,2092,393,13,11,24,54.2%,4m
43398,2,Necum,2092,275,10,12,22,45.5%,18m
43398,1,akapest,2092,300,9,25,34,26.5%,45m
43398,2,doMert,2092,143,8,5,13,61.5%,1h
43398,3,Sewip,2092,169,8,7,15,53.3%,10m
43398,2,makc,2092,236,8,10,18,44.4%,8m
43398,2,DimazKamaz,2092,164,5,6,11,45.5%,42m
43398,3,Nope,2092,0,0,1,1,0.0%,49m
43398,3,Rehajel,2092,0,0,1,1,0.0%,8m
43398,3,SSIT,2092,0,0,1,1,0.0%,29m
43398,2,JohnDoe,2092,0,0,3,3,0.0%,54m
43398,2,Obsidian,2092,0,0,9,9,0.0%,31m
43417,2,[AusGam]evic,2091,1004,168,176,344,48.8%,21m
43417,1,[EASA]MLY,2091,1349,149,161,310,48.1%,5m
43417,1,MortalLord,2091,1635,85,84,169,50.3%,37m
43417,1,Tofa,2091,771,48,63,111,43.2%,53m
43417,2,[palats]Mhordwar,2091,1139,43,44,87,49.4%,50m
43417,3,Rus,2091,716,28,26,54,51.9%,19m
43417,2,[PowerG]MrWhocares,2091,414,15,17,32,46.9%,37m
43417,3,Micantorus,2091,400,14,8,22,63.6%,19m
43417,3,Laker,2091,178,7,10,17,41.2%,27m
43417,3,[iSAR]lARS,2091,193,7,15,22,31.8%,57m
43417,3,yoelwin,2091,30,4,2,6,66.7%,1h
43417,2,NashKraag,2091,118,4,8,12,33.3%,1h
43417,3,inSame,2091,58,2,2,4,50.0%,56m
43417,2,Reaperdom,2091,60,2,6,8,25.0%,4m
43417,2,ТЕМА,2091,0,2,7,9,22.2%,5m
43417,2,[ULTX]Матвей,2091,0,1,0,1,100.0%,5m
43417,3,BoDyBaLSaM,2091,0,1,0,1,100.0%,10m
43417,2,mastersheef,2091,0,1,1,2,50.0%,4m
43417,2,GhostKM,2091,0,1,1,2,50.0%,21m
43417,2,Dcxcaliberz,2091,30,1,3,4,25.0%,12m
43417,2,[lsc2]MJL,2091,30,1,4,5,20.0%,1h
43417,3,[FRzerg]manu,2091,0,0,1,1,0.0%,37m
43417,1,[BBMM]BurgerJockel,2091,0,0,3,3,0.0%,14m
43417,3,PABLO,2091,0,0,5,5,0.0%,22m
43441,2,SukramD,2090,1418,62,67,129,48.1%,55m
43441,2,Aurelian,2090,587,59,52,111,53.2%,54m
43441,1,Rain,2090,716,24,32,56,42.9%,24m
43441,2,KillAAkikitt,2090,436,16,19,35,45.7%,54m
43441,2,lolo,2090,366,12,25,37,32.4%,54m
43441,3,[TPZGG]Max,2090,250,10,2,12,83.3%,56m
43441,3,LiNo,2090,244,8,7,15,53.3%,44m
43441,2,Hansderkanns,2090,248,8,14,22,36.4%,21m
43441,3,David,2090,200,7,7,14,50.0%,28m
43441,2,[Radium]ElinaRosle,2090,194,6,2,8,75.0%,46m
43441,2,DouxPanda,2090,140,5,5,10,50.0%,15m
43441,2,onebleda,2090,90,5,12,17,29.4%,15m
43441,2,WEODRES,2090,92,5,15,20,25.0%,28m
43441,3,Horus,2090,145,3,8,11,27.3%,4m
43441,3,Parzival,2090,30,2,0,2,100.0%,30m
43441,2,Enneman,2090,58,2,5,7,28.6%,48m
43441,3,DarkWarrior,2090,0,2,10,12,16.7%,40m
43441,3,RadostevGame,2090,0,1,4,5,20.0%,44m
43441,3,ShadowStorm,2090,0,1,4,5,20.0%,22m
43441,2,ХЕНТАЙ,2090,46,1,5,6,16.7%,39m
43441,1,Murchal,2090,0,0,2,2,0.0%,35m
43441,3,[OПГ]ghost,2090,0,0,5,5,0.0%,1h
43463,2,JAN,2089,1350,130,153,283,45.9%,35m
43463,1,Sandiego,2089,1620,119,121,240,49.6%,4m
43463,1,Vegr,2089,1495,91,95,186,48.9%,39m
43463,2,Amans,2089,1398,52,55,107,48.6%,54m
43463,2,deep,2089,384,13,17,30,43.3%,5m
43463,2,VirgilioIII,2089,185,5,4,9,55.6%,47m
43463,2,BarnacleBOY,2089,0,3,3,6,50.0%,1h
43463,2,Xype,2089,0,1,1,2,50.0%,32m
43463,3,MasterKrismo,2089,30,1,1,2,50.0%,53m
43463,2,machineman,2089,0,1,2,3,33.3%,3m
43463,3,Sanchezz,2089,0,1,2,3,33.3%,21m
43463,1,Starship,2089,48,1,4,5,20.0%,4m
43463,2,macros,2089,0,0,2,2,0.0%,46m
43463,2,Gorizont,2089,0,0,2,2,0.0%,36m
43463,3,creepysleepy,2089,0,0,5,5,0.0%,19m
43463,2,ShortToGND,2089,0,0,6,6,0.0%,43m
43463,2,ThSwarm,2089,0,0,7,7,0.0%,13m
43480,2,Darren,2088,1515,133,135,268,49.6%,46m
43480,2,GRfl,2088,1288,59,63,122,48.4%,27m
43480,2,[LPGR]GameR,2088,923,32,42,74,43.2%,1h
43480,2,Jonas,2088,652,29,24,53,54.7%,47m
43480,2,Jolma,2088,782,29,33,62,46.8%,30m
43480,2,sOstOked,2088,471,21,26,47,44.7%,3m
43480,2,Dew,2088,433,17,11,28,60.7%,57m
43480,1,Cristian,2088,460,14,25,39,35.9%,33m
43480,2,Doni,2088,284,11,4,15,73.3%,1h
43480,2,jojek,2088,265,9,7,16,56.2%,45m
43480,2,токсикипорук,2088,94,8,10,18,44.4%,21m
43480,3,piotrek,2088,176,7,4,11,63.6%,37m
43480,2,MeinerEiner,2088,190,6,5,11,54.5%,12m
43480,2,Freek,2088,120,5,8,13,38.5%,3m
43480,3,windost,2088,0,3,3,6,50.0%,24m
43480,2,Thunder,2088,126,3,8,11,27.3%,1h
43480,2,Peka,2088,97,2,2,4,50.0%,18m
43480,2,raBHup,2088,0,2,4,6,33.3%,36m
43480,3,mihanik,2088,0,1,0,1,100.0%,13m
43480,3,Ikani,2088,30,1,4,5,20.0%,49m
43480,3,Трешшшшшшшшш,2088,0,0,1,1,0.0%,45m
43480,3,[EUTeam]DraK,2088,0,0,1,1,0.0%,43m
43480,2,Klavdi,2088,0,0,1,1,0.0%,53m
43503,2,waze,2087,796,42,34,76,55.3%,57m
43503,2,Derble,2087,1114,41,49,90,45.6%,43m
43503,2,Aeglos,2087,814,31,38,69,44.9%,31m
43503,1,DragKos,2087,612,21,28,49,42.9%,35m
43503,3,Drakene,2087,319,10,8,18,55.6%,30m
43503,1,sadis,2087,96,6,9,15,40.0%,42m
43503,1,[SV49]VfB,2087,184,5,16,21,23.8%,43m
43503,2,[PiPsA]Super,2087,98,4,4,8,50.0%,20m
43503,2,ZoiFi,2087,58,3,3,6,50.0%,44m
43503,2,MrPanda,2087,94,3,7,10,30.0%,21m
43503,3,deecee,2087,30,2,1,3,66.7%,19m
43503,2,Skrill,2087,48,2,8,10,20.0%,5m
43503,2,[Killi]Taurin,2087,0,1,1,2,50.0%,51m
43503,3,EddyStortion,2087,30,1,3,4,25.0%,43m
43503,2,Lazeh,2087,30,1,3,4,25.0%,1h
43503,3,Simple,2087,0,1,4,5,20.0%,37m
43503,2,Markelof,2087,0,1,6,7,14.3%,36m
43503,2,AndragonLE,2087,0,0,1,1,0.0%,1h
43503,2,MCDaniil,2087,0,0,2,2,0.0%,50m
43503,3,[FraaY]Stark,2087,0,0,4,4,0.0%,44m
43503,3,Notwo,2087,0,0,5,5,0.0%,1h
43503,2,mako,2087,0,0,6,6,0.0%,39m
43503,3,[BsG]Aria,2087,0,0,6,6,0.0%,22m
43526,1,APOLLO,2086,1542,164,169,333,49.2%,1h
43526,1,Koldojonky,2086,1652,99,108,207,47.8%,12m
43526,2,nFoPD,2086,767,71,79,150,47.3%,48m
43526,1,Rytase,2086,1502,55,63,118,46.6%,1h
43526,1,Siren,2086,1310,54,63,117,46.2%,35m
43526,2,Keptea,2086,534,18,18,36,50.0%,31m
43526,3,Nyél,2086,286,10,9,19,52.6%,28m
43526,1,Insaybr,2086,252,9,11,20,45.0%,1h
43526,2,[II3II]SñrFuixench,2086,205,8,6,14,57.1%,1h
43526,1,BDog,2086,190,7,12,19,36.8%,48m
43526,1,LexaOPG,2086,218,6,10,16,37.5%,14m
43526,3,[Дошик1]Rocknik,2086,154,5,0,5,100.0%,4m
43526,3,Toni,2086,100,5,13,18,27.8%,6m
43526,1,DhaliLama,2086,193,4,11,15,26.7%,42m
43526,1,Liess,2086,148,4,12,16,25.0%,10m
43526,1,McFit,2086,70,3,8,11,27.3%,40m
43526,1,Medax,2086,0,1,0,1,100.0%,25m
43526,3,vladaecа,2086,0,0,1,1,0.0%,1h
43526,3,lilKUS,2086,0,0,1,1,0.0%,35m
43526,3,LaLaLog,2086,0,0,2,2,0.0%,40m
43526,3,Blast,2086,0,0,5,5,0.0%,16m
43526,3,[BNCREW]Civa,2086,0,0,5,5,0.0%,1h
43548,2,skifgr,2085,1242,92,89,181,50.8%,31m
43548,1,[DIVOC]TheCaribouX,2085,525,36,36,72,50.0%,54m
43548,2,Myway,2085,866,35,30,65,53.8%,12m
43548,1,[H104]MadeInHeaven,2085,480,20,23,43,46.5%,3m
43548,2,[YOMAMA]Koroextreme,2085,482,18,21,39,46.2%,1h
43548,2,[DS07]Dionysus,2085,451,17,15,32,53.1%,57m
43548,2,Rodeons,2085,442,15,20,35,42.9%,12m
43548,2,Cophow,2085,356,11,15,26,42.3%,49m
43548,2,Nurshat,2085,132,5,5,10,50.0%,5m
43548,1,Rorooze,2085,96,3,10,13,23.1%,15m
43548,1,ViRuoSe,2085,96,3,11,14,21.4%,15m
43548,2,Filipgamer,2085,0,1,0,1,100.0%,1h
43548,3,Johnnywalks,2085,30,1,1,2,50.0%,43m
43548,2,Emmm,2085,92,1,1,2,50.0%,42m
43548,2,bullet,2085,97,1,3,4,25.0%,34m
43548,2,lynx,2085,0,0,2,2,0.0%,1h
43548,3,Shadnax,2085,0,0,5,5,0.0%,49m
43565,2,kyskys,2084,264,28,27,55,50.9%,53m
43565,2,Bhaalspawn,2084,211,22,22,44,50.0%,54m
43565,2,DrBooooM,2084,372,16,17,33,48.5%,55m
43565,1,kimo,2084,412,15,26,41,36.6%,1h
43565,2,Aisuviz,2084,316,12,14,26,46.2%,50m
43565,3,Narew,2084,249,8,16,24,33.3%,49m
43565,3,Arilox,2084,209,6,15,21,28.6%,9m
43565,1,Atlas,2084,30,3,11,14,21.4%,8m
43565,2,[KCD]Kachna,2084,114,2,3,5,40.0%,50m
43565,3,ICY,2084,0,2,3,5,40.0%,35m
43565,3,Freethinker,2084,0,1,0,1,100.0%,10m
43565,3,Drendris,2084,0,0,1,1,0.0%,24m
43565,3,uNoN,2084,0,0,1,1,0.0%,27m
43565,3,Biotas,2084,0,0,3,3,0.0%,7m
43565,1,phiray,2084,0,0,6,6,0.0%,10m
43565,2,Rjezek,2084,0,0,6,6,0.0%,55m
43581,2,Ulfbert,2083,1594,449,471,920,48.8%,4m
43581,1,peterpan,2083,1667,142,158,300,47.3%,51m
43581,2,[ST2SAS]kirkland,2083,668,24,25,49,49.0%,3m
43581,3,DRONOXXX,2083,246,10,6,16,62.5%,37m
43581,2,Anak,2083,361,10,19,29,34.5%,31m
43581,1,Ryoh,2083,30,4,5,9,44.4%,52m
43581,3,CHALDON,2083,30,1,2,3,33.3%,44m
43581,2,Ognjen,2083,0,1,6,7,14.3%,56m
43581,2,Xuupi,2083,30,1,6,7,14.3%,1h
43581,1,Panic,2083,36,1,7,8,12.5%,40m
43581,1,ilya,2083,0,0,2,2,0.0%,32m
43581,1,Roffor,2083,0,0,4,4,0.0%,8m
43581,3,Eidolon,2083,0,0,5,5,0.0%,5m
43594,2,Serenity,2082,671,28,22,50,56.0%,1h
43594,2,Vrotello,2082,476,22,21,43,51.2%,8m
43594,2,koolc,2082,599,22,27,49,44.9%,3m
43594,2,Jibbox,2082,290,16,18,34,47.1%,55m
43594,3,BouncyPoo,2082,250,8,9,17,47.1%,2m
43594,2,Alto,2082,303,7,17,24,29.2%,1h
43594,2,FANTOM,2082,90,6,7,13,46.2%,39m
43594,2,Flouk,2082,172,4,7,11,36.4%,1h
43594,1,Serg,2082,0,2,10,12,16.7%,55m
43594,3,Mexanik,2082,0,1,4,5,20.0%,54m
43594,2,Emilut,2082,97,1,6,7,14.3%,11m
43594,3,Skykilla,2082,0,0,1,1,0.0%,6m
43594,3,butr,2082,0,0,5,5,0.0%,23m
43594,3,mordisquitos,2082,0,0,5,5,0.0%,5m
43608,1,ZanyDruid,2081,1379,54,57,111,48.6%,47m
43608,1,cashmereffec,2081,1096,41,49,90,45.6%,40m
43608,2,Pumuckl,2081,653,26,33,59,44.1%,23m
43608,2,Zumbaos,2081,600,21,25,46,45.7%,1m
43608,2,Gab,2081,449,15,20,35,42.9%,36m
43608,2,[DDiv]SpeedyFrog,2081,350,14,9,23,60.9%,53m
43608,3,CrazyHorse,2081,368,13,12,25,52.0%,37m
43608,2,[Furios]Feqir,2081,309,12,8,20,60.0%,54m
43608,1,KoNa,2081,244,9,10,19,47.4%,32m
43608,3,ArnoldRoth,2081,181,8,5,13,61.5%,29m
43608,2,[JaPP]Астарот,2081,204,7,8,15,46.7%,47m
43608,1,Rama,2081,277,7,12,19,36.8%,42m
43608,1,Schlandmann,2081,265,6,10,16,37.5%,25m
43608,2,[Dadgar]gyzelote,2081,116,3,3,6,50.0%,2m
43608,3,Nevermind,2081,0,1,4,5,20.0%,56m
43608,3,RaGdE,2081,42,1,6,7,14.3%,43m
43608,2,muffin,2081,0,0,2,2,0.0%,2m
43608,3,Hydro,2081,0,0,2,2,0.0%,17m
43608,3,liebesbaer,2081,0,0,5,5,0.0%,21m
43627,2,Ant,2080,185,41,39,80,51.2%,3m
43627,3,deWizeFool,2080,505,36,30,66,54.5%,8m
43627,3,[KJ420]DarkTemplar,2080,610,27,30,57,47.4%,22m
43627,3,Bogus,2080,315,14,7,21,66.7%,20m
43627,2,[LOldo]FarsanEger,2080,271,10,13,23,43.5%,28m
43627,2,HeroMarine,2080,298,9,14,23,39.1%,38m
43627,1,EmilioBandi,2080,174,5,10,15,33.3%,28m
43627,3,[ЮФО]fastman,2080,86,4,1,5,80.0%,56m
43627,2,Elad,2080,86,3,5,8,37.5%,51m
43627,1,Jipakazoid,2080,0,2,8,10,20.0%,35m
43627,3,DeadPoulp,2080,0,1,0,1,100.0%,19m
43627,2,Daskepaven,2080,96,1,2,3,33.3%,53m
43627,3,PiTon,2080,0,1,4,5,20.0%,55m
43627,2,technetium,2080,0,1,5,6,16.7%,57m
43627,3,LasiSaga,2080,30,1,5,6,16.7%,1h
43627,1,Артём,2080,0,0,3,3,0.0%,1h
43627,3,PlayBeagle,2080,0,0,5,5,0.0%,30m
43644,2,Eon,2079,592,185,184,369,50.1%,37m
43644,2,Krieg,2079,1591,100,102,202,49.5%,52m
43644,2,DShlepenhund,2079,1085,41,42,83,49.4%,1m
43644,2,LINCOLN,2079,830,29,41,70,41.4%,37m
43644,2,Alfirionfirs,2079,292,26,33,59,44.1%,33m
43644,2,[SC22SC]RUNO,2079,754,25,34,59,42.4%,15m
43644,2,Sigismondo,2079,518,22,27,49,44.9%,14m
43644,3,Rituximab,2079,410,17,14,31,54.8%,21m
43644,3,SanczOSan,2079,351,14,16,30,46.7%,42m
43644,2,SlikRæven,2079,380,14,17,31,45.2%,49m
43644,3,KukluS,2079,356,14,18,32,43.8%,44m
43644,3,Killer,2079,97,6,9,15,40.0%,44m
43644,3,димоооон,2079,102,6,16,22,27.3%,44m
43644,3,Evgeni,2079,58,2,1,3,66.7%,29m
43644,3,[OTW6]Float,2079,119,2,8,10,20.0%,44m
43644,2,Hammy,2079,30,1,3,4,25.0%,37m
43644,2,Valaren,2079,0,1,7,8,12.5%,43m
43644,1,Ephe,2079,0,1,7,8,12.5%,36m
43644,3,Kiowaska,2079,0,0,1,1,0.0%,43m
43644,2,[LQV]SupinPOL,2079,0,0,2,2,0.0%,46m
43644,2,Eniax,2079,0,0,3,3,0.0%,52m
43644,3,RADEGAST,2079,0,0,3,3,0.0%,2m
43666,2,[XZ3R0X]BeHappyyy,2078,884,35,41,76,46.1%,57m
43666,2,AITH,2078,557,27,38,65,41.5%,9m
43666,2,sXV,2078,439,16,15,31,51.6%,38m
43666,1,Blueverine,2078,249,11,6,17,64.7%,30m
43666,2,Huitus,2078,325,9,19,28,32.1%,46m
43666,3,Neznaika,2078,192,8,2,10,80.0%,8m
43666,2,Ega,2078,113,5,5,10,50.0%,1h
43666,1,ElDanches,2078,231,5,7,12,41.7%,27m
43666,3,asd,2078,58,3,4,7,42.9%,18m
43666,1,Tireon,2078,96,3,11,14,21.4%,30m
43666,3,Kakarotto,2078,58,2,1,3,66.7%,43m
43666,2,Suicide,2078,102,2,2,4,50.0%,21m
43666,3,FoxyRUS,2078,0,1,4,5,20.0%,35m
43666,3,[TzGx]GOSTE,2078,30,1,6,7,14.3%,21m
43666,1,Pignolo,2078,94,1,6,7,14.3%,38m
43666,1,[TCSRep]cool,2078,0,1,8,9,11.1%,37m
43666,2,Flo,2078,0,0,2,2,0.0%,4m
43666,2,Stoqnskiii,2078,0,0,3,3,0.0%,48m
43666,3,asasina,2078,0,0,5,5,0.0%,54m
43666,3,aboodhnini,2078,0,0,5,5,0.0%,52m
43666,2,Shaman,2078,0,0,6,6,0.0%,36m
43687,2,Marchello,2077,989,39,40,79,49.4%,4m
43687,2,Mircea,2077,625,25,32,57,43.9%,15m
43687,2,Ravi,2077,300,12,4,16,75.0%,43m
43687,3,FENIXTAN,2077,262,10,8,18,55.6%,23m
43687,2,Treehugger,2077,145,3,7,10,30.0%,46m
43687,1,[M62]Arasher,2077,0,1,1,2,50.0%,30m
43687,3,iMax,2077,0,0,1,1,0.0%,1h
43687,3,uki,2077,0,0,5,5,0.0%,43m
43687,3,Alkyr,2077,0,0,5,5,0.0%,4m
43687,2,Miksu,2077,0,0,6,6,0.0%,49m
43697,2,Hypno,2076,1475,88,90,178,49.4%,7m
43697,2,Jhizzle,2076,343,9,13,22,40.9%,57m
43697,1,Master,2076,334,9,15,24,37.5%,24m
43697,2,grimin,2076,268,8,13,21,38.1%,9m
43697,3,BeoWulf,2076,148,5,6,11,45.5%,1h
43697,2,ElipkaZz,2076,128,5,6,11,45.5%,4m
43697,2,PattaThememe,2076,158,5,9,14,35.7%,12m
43697,2,Eddy,2076,187,4,7,11,36.4%,39m
43697,2,Frederick,2076,60,3,9,12,25.0%,1h
43697,1,RaWge,2076,141,2,1,3,66.7%,24m
43697,1,OduVan,2076,97,2,8,10,20.0%,1m
43697,3,MERROW,2076,30,1,2,3,33.3%,29m
43697,1,ArturidZzze,2076,96,1,4,5,20.0%,25m
43697,2,[TERIZM]Familiya,2076,30,1,5,6,16.7%,5m
43697,2,Ludvig,2076,0,1,7,8,12.5%,32m
43697,1,germar,2076,0,1,7,8,12.5%,32m
43697,2,londgin,2076,0,0,5,5,0.0%,43m
43697,3,artem,2076,0,0,5,5,0.0%,52m
43697,3,Honkenstein,2076,0,0,5,5,0.0%,7m
43697,3,Tochto,2076,0,0,5,5,0.0%,16m
43697,2,Basstowel,2076,0,0,6,6,0.0%,12m
43718,2,AMG,2075,1468,73,76,149,49.0%,12m
43718,2,Phoenix,2075,1395,59,61,120,49.2%,1h
43718,2,jim,2075,884,33,36,69,47.8%,46m
43718,1,ualex,2075,706,24,30,54,44.4%,7m
43718,3,[HRisk]СуперМаг,2075,471,18,9,27,66.7%,39m
43718,2,Jurij,2075,498,18,25,43,41.9%,52m
43718,1,Oayder,2075,281,9,15,24,37.5%,38m
43718,2,PsychoCraft,2075,198,7,13,20,35.0%,20m
43718,2,JonasDT,2075,166,6,11,17,35.3%,19m
43718,3,Enzo,2075,204,6,11,17,35.3%,54m
43718,3,[SoothK]Kafk,2075,124,6,14,20,30.0%,7m
43718,3,[keloo]SELIH,2075,198,6,16,22,27.3%,33m
43718,3,[SeVenV]ElderBear,2075,144,3,3,6,50.0%,21m
43718,2,xDimaMysiKx,2075,60,3,4,7,42.9%,12m
43718,2,[ЧСВ]Протосс,2075,108,2,2,4,50.0%,15m
43718,2,Zelax,2075,0,2,4,6,33.3%,39m
43718,2,Pony,2075,30,2,7,9,22.2%,19m
43718,3,[DABM]BigMis,2075,96,2,8,10,20.0%,45m
43718,3,zergpro,2075,0,1,0,1,100.0%,40m
43718,2,[Vizzor]Nikita,2075,0,1,1,2,50.0%,32m
43718,3,Mokoron,2075,30,1,2,3,33.3%,56m
43718,2,sharky,2075,44,1,3,4,25.0%,21m
43718,3,Caveman,2075,0,0,1,1,0.0%,2m
43718,3,NUU,2075,0,0,1,1,0.0%,52m
43718,3,Ayneks,2075,0,0,5,5,0.0%,2m
43743,1,Karol,2074,1634,224,236,460,48.7%,28m
43743,2,DeeJay,2074,1569,171,177,348,49.1%,52m
43743,2,[OmDi]DESTROY,2074,1288,57,57,114,50.0%,55m
43743,3,[Ctlo]SecondOfFive,2074,1175,48,41,89,53.9%,7m
43743,1,ZaPa,2074,794,44,43,87,50.6%,50m
43743,1,PsYkLpWn,2074,1027,37,47,84,44.0%,19m
43743,2,[GGZERG]BeshinyKot,2074,572,20,25,45,44.4%,48m
43743,2,[shoo]muldrothaEDH,2074,272,9,14,23,39.1%,34m
43743,3,TRAFKA,2074,196,8,5,13,61.5%,45m
43743,1,Spartaneca,2074,236,6,12,18,33.3%,57m
43743,2,Grisha,2074,122,5,5,10,50.0%,44m
43743,2,MEMO,2074,116,5,9,14,35.7%,54m
43743,1,GildAragorn,2074,203,5,13,18,27.8%,26m
43743,2,[ILSA]Alpha,2074,124,4,11,15,26.7%,51m
43743,1,PINOY,2074,0,1,0,1,100.0%,19m
43743,2,Rmmondello,2074,0,1,1,2,50.0%,44m
43743,2,Hagen,2074,93,1,5,6,16.7%,4m
43743,3,upakowka,2074,0,0,1,1,0.0%,1h
43743,3,sasha,2074,0,0,1,1,0.0%,1h
43743,3,Elgenath,2074,0,0,3,3,0.0%,16m
43743,3,firewall,2074,0,0,5,5,0.0%,16m
43764,2,Fred,2073,1588,146,145,291,50.2%,49m
43764,2,Mammon,2073,763,32,27,59,54.2%,8m
43764,2,kamyan,2073,679,32,30,62,51.6%,1h
43764,2,Outrageous,2073,328,27,27,54,50.0%,19m
43764,2,mikitoni,2073,591,25,18,43,58.1%,48m
43764,3,ПЕНДАЛЬФ,2073,621,25,21,46,54.3%,45m
43764,1,RedPikachu,2073,468,15,21,36,41.7%,52m
43764,1,Топер,2073,459,15,23,38,39.5%,39m
43764,1,RXX,2073,442,15,29,44,34.1%,56m
43764,2,Cobas,2073,367,14,12,26,53.8%,34m
43764,2,Cieniu,2073,173,6,5,11,54.5%,12m
43764,2,Gilad,2073,114,5,9,14,35.7%,17m
43764,2,chejahmonf,2073,140,4,7,11,36.4%,34m
43764,2,Bzikeroff,2073,142,4,8,12,33.3%,55m
43764,2,tobbi,2073,90,3,10,13,23.1%,11m
43764,3,BARTGROZNY,2073,97,2,0,2,100.0%,18m
43764,1,Starker,2073,107,2,6,8,25.0%,13m
43764,2,DarkMatter,2073,0,2,7,9,22.2%,29m
43764,3,[ZDND]Jason,2073,97,1,3,4,25.0%,5m
43764,1,ADDER,2073,0,1,7,8,12.5%,35m
43764,3,[1488ZT]ЖОРЖ,2073,0,0,1,1,0.0%,56m
43764,2,[plCake]GumaZ,2073,0,0,3,3,0.0%,9m
43764,3,mitarao,2073,0,0,3,3,0.0%,54m
43764,3,Socrat,2073,0,0,5,5,0.0%,52m
43764,3,Auron,2073,0,0,5,5,0.0%,44m
43789,1,Nicholas,2072,1563,75,92,167,44.9%,11m
43789,3,wonhaj,2072,782,30,34,64,46.9%,1h
43789,2,[Uсhiha]Джотароо,2072,659,25,25,50,50.0%,31m
43789,2,[KøF]Kosby,2072,434,15,15,30,50.0%,38m
43789,2,blackpilled,2072,350,11,16,27,40.7%,55m
43789,1,Miky,2072,200,7,10,17,41.2%,32m
43789,2,[OSgZ]Kiliman,2072,198,6,5,11,54.5%,3m
43789,3,RawHide,2072,180,6,6,12,50.0%,17m
43789,1,[SPAINs]Sten,2072,0,3,6,9,33.3%,12m
43789,3,Polter,2072,0,1,2,3,33.3%,19m
43789,1,ElLuz,2072,0,1,6,7,14.3%,24m
43789,2,kala,2072,0,0,2,2,0.0%,48m
43801,2,[OmDi]zuar,2071,1267,65,66,131,49.6%,29m
43801,2,Alquimista,2071,700,31,31,62,50.0%,12m
43801,2,Advokate,2071,512,20,21,41,48.8%,48m
43801,2,avelan,2071,466,17,18,35,48.6%,55m
43801,2,EvilCow,2071,350,12,12,24,50.0%,4m
43801,2,BarelySleep,2071,342,12,18,30,40.0%,1m
43801,2,[reinor]ultralchick,2071,352,11,21,32,34.4%,57m
43801,2,NatLaFrap,2071,258,9,14,23,39.1%,9m
43801,2,Foxbone,2071,194,7,4,11,63.6%,17m
43801,1,MANIAC,2071,262,7,18,25,28.0%,24m
43801,2,RYDER,2071,165,6,5,11,54.5%,10m
43801,3,srub,2071,60,3,2,5,60.0%,11m
43801,2,Sporek,2071,88,3,9,12,25.0%,18m
43801,1,Jonás,2071,78,3,9,12,25.0%,31m
43801,2,Sebastian,2071,30,2,5,7,28.6%,1m
43801,1,NoRMaN,2071,48,1,4,5,20.0%,1m
43801,2,kap,2071,88,1,6,7,14.3%,46m
43801,3,luki,2071,0,0,1,1,0.0%,34m
43801,2,begemotik,2071,0,0,3,3,0.0%,8m
43801,1,ASDS,2071,0,0,3,3,0.0%,57m
43801,3,HappyRogue,2071,0,0,5,5,0.0%,4m
43801,3,Maicce,2071,0,0,5,5,0.0%,30m
43823,1,SuperBierMan,2070,1531,67,69,136,49.3%,42m
43823,1,KanUndead,2070,1144,45,54,99,45.5%,19m
43823,1,ZerOShiftY,2070,398,15,28,43,34.9%,19m
43823,3,[SDO]ErnestGuerra,2070,248,9,5,14,64.3%,52m
43823,2,[TiN]sokoban,2070,128,3,4,7,42.9%,48m
43823,3,[batat]Pavlo,2070,30,2,1,3,66.7%,37m
43823,2,Berserk,2070,92,1,1,2,50.0%,50m
43823,1,Voirax,2070,0,1,1,2,50.0%,51m
43823,2,UwU,2070,93,1,6,7,14.3%,43m
43823,2,duduc,2070,0,1,6,7,14.3%,42m
43823,1,HatakiKakshi,2070,0,1,8,9,11.1%,28m
43823,3,Stels,2070,0,1,9,10,10.0%,12m
43823,2,Dreey,2070,0,0,6,6,0.0%,55m
43836,3,GOBLIN,2069,1543,82,81,163,50.3%,8m
43836,2,Dominik,2069,668,41,39,80,51.2%,8m
43836,1,ili,2069,822,31,40,71,43.7%,40m
43836,2,NIKKACM,2069,641,23,23,46,50.0%,1h
43836,3,Trace,2069,331,20,20,40,50.0%,8m
43836,2,EMan,2069,406,17,18,35,48.6%,12m
43836,2,Pinkelephant,2069,481,17,24,41,41.5%,36m
43836,2,SupCrusader,2069,188,10,8,18,55.6%,10m
43836,2,BlackLotus,2069,198,10,18,28,35.7%,54m
43836,3,Aldies,2069,168,6,5,11,54.5%,2m
43836,2,ImDavid,2069,156,5,6,11,45.5%,14m
43836,2,ttck,2069,122,5,8,13,38.5%,21m
43836,3,[ъь]Trivinmoriy,2069,90,4,2,6,66.7%,28m
43836,3,anna,2069,30,4,3,7,57.1%,41m
43836,2,SilverDragon,2069,121,2,4,6,33.3%,47m
43836,2,imreallybad,2069,0,1,1,2,50.0%,12m
43836,3,Bargel,2069,30,1,2,3,33.3%,50m
43836,3,[NSCSC]Kirill,2069,0,0,1,1,0.0%,54m
43836,2,SuperCooper,2069,0,0,1,1,0.0%,57m
43836,3,Зератул,2069,0,0,5,5,0.0%,35m
43856,1,AntonIII,2068,1608,189,200,389,48.6%,20m
43856,3,NCHSııLøukid,2068,700,45,56,101,44.6%,35m
43856,1,[OmDi]MOMO,2068,1331,45,59,104,43.3%,34m
43856,2,DEMON,2068,621,24,22,46,52.2%,52m
43856,2,Kez,2068,569,20,30,50,40.0%,50m
43856,3,TaylorSwift,2068,336,13,12,25,52.0%,20m
43856,1,IvanD,2068,433,12,25,37,32.4%,26m
43856,3,OpTu,2068,192,8,2,10,80.0%,54m
43856,2,[КЕКS]Dost,2068,197,6,12,18,33.3%,2m
43856,2,Nazarix,2068,114,4,7,11,36.4%,12m
43856,2,[GtLcky]lotto,2068,136,4,10,14,28.6%,31m
43856,3,SYKAYAKTO,2068,0,3,2,5,60.0%,21m
43856,3,[thepot]MIPROTO,2068,120,3,4,7,42.9%,3m
43856,2,Hucky,2068,92,3,7,10,30.0%,2m
43856,3,ДенМастер,2068,0,1,4,5,20.0%,28m
43856,2,Orisy,2068,0,1,6,7,14.3%,41m
43856,2,Darostef,2068,0,0,2,2,0.0%,52m
43856,3,Dmitriyouric,2068,0,0,5,5,0.0%,45m
43856,3,Lauren,2068,0,0,5,5,0.0%,57m
43856,3,Telepyzik,2068,0,0,5,5,0.0%,2m
43876,2,Ava,2067,1021,115,113,228,50.4%,5m
43876,2,Sanguinius,2067,457,17,18,35,48.6%,37m
43876,1,БонииКлайд,2067,488,17,21,38,44.7%,1h
43876,1,tonio,2067,422,13,21,34,38.2%,51m
43876,3,[Flammy]Wilkenson,2067,323,11,7,18,61.1%,8m
43876,2,ShadowBlade,2067,246,10,7,17,58.8%,21m
43876,2,Mimeo,2067,206,8,9,17,47.1%,55m
43876,3,JamMangoo,2067,150,8,25,33,24.2%,23m
43876,2,[KPZA]ILoveDi,2067,222,7,8,15,46.7%,4m
43876,2,retuil,2067,142,6,10,16,37.5%,57m
43876,2,xxxKGBxxx,2067,102,3,9,12,25.0%,53m
43876,3,tracksmoker,2067,58,2,1,3,66.7%,24m
43876,2,EROPYCGG,2067,88,2,1,3,66.7%,43m
43876,2,Greedy,2067,102,2,3,5,40.0%,49m
43876,3,MrIbragim,2067,97,2,6,8,25.0%,2m
43876,2,linkeniffo,2067,92,2,8,10,20.0%,21m
43876,3,sircuicui,2067,0,1,0,1,100.0%,37m
43876,3,[FDPD]Kazelodie,2067,0,1,0,1,100.0%,2m
43876,1,WielkiTopór,2067,0,1,7,8,12.5%,25m
43876,3,BUMPFINATOR,2067,0,0,1,1,0.0%,37m
43876,3,[BÖØBS]Floppy,2067,0,0,1,1,0.0%,9m
43876,3,Den,2067,0,0,1,1,0.0%,56m
43876,3,DedIvan,2067,0,0,1,1,0.0%,7m
43876,2,[TGZP]Nik,2067,0,0,1,1,0.0%,35m
43876,3,[Саваны]iloros,2067,0,0,1,1,0.0%,6m
43876,2,DragonPL,2067,0,0,3,3,0.0%,57m
43876,2,Jose,2067,0,0,3,3,0.0%,28m
43876,2,subziro,2067,0,0,5,5,0.0%,15m
43904,2,zat,2066,1536,324,357,681,47.6%,45m
43904,2,Gruchic,2066,1136,118,136,254,46.5%,1m
43904,2,JNK,2066,268,11,11,22,50.0%,33m
43904,2,DarkLord,2066,310,10,13,23,43.5%,50m
43904,3,Alega,2066,176,6,2,8,75.0%,21m
43904,3,hesienberg,2066,116,4,4,8,50.0%,44m
43904,2,Эльджера,2066,74,3,4,7,42.9%,6m
43904,3,[xFRSx]Reding,2066,58,2,2,4,50.0%,41m
43904,1,[z666z]Maximus,2066,96,2,9,11,18.2%,5m
43904,1,SpartanRider,2066,0,1,0,1,100.0%,17m
43904,1,cLaY,2066,0,1,2,3,33.3%,42m
43904,2,PrehDathoR,2066,30,1,7,8,12.5%,49m
43904,1,Rundstedt,2066,0,1,8,9,11.1%,4m
43904,3,BIGBen,2066,0,0,5,5,0.0%,52m
43904,3,peppote,2066,0,0,6,6,0.0%,16m
43904,2,Jest,2066,0,0,7,7,0.0%,15m
43920,2,MaSTerQ,2065,1525,199,221,420,47.4%,12m
43920,2,Deus,2065,1491,83,81,164,50.6%,13m
43920,2,SergeyUA,2065,615,29,20,49,59.2%,55m
43920,2,Shamil,2065,459,18,13,31,58.1%,9m
43920,2,Ewuara,2065,503,18,25,43,41.9%,46m
43920,2,TjTurtle,2065,374,14,17,31,45.2%,1h
43920,2,ROYALPL,2065,347,12,12,24,50.0%,57m
43920,2,[nwby]Korgus,2065,231,11,6,17,64.7%,20m
43920,1,Ivrerire,2065,282,7,12,19,36.8%,18m
43920,1,QuiGone,2065,238,7,14,21,33.3%,30m
43920,1,[DeaDhi]старккравт,2065,144,3,3,6,50.0%,10m
43920,2,Flipster,2065,62,2,5,7,28.6%,4m
43920,2,Zolimester,2065,102,2,5,7,28.6%,45m
43920,1,khan,2065,32,2,11,13,15.4%,28m
43920,3,Lion,2065,0,1,0,1,100.0%,28m
43920,2,Ghoustrider,2065,88,1,2,3,33.3%,20m
43920,2,[ExTr1m]Dehaka,2065,0,1,4,5,20.0%,55m
43920,3,Zerkzes,2065,0,0,1,1,0.0%,21m
43920,3,[Pisyn]KROMSATEL,2065,0,0,1,1,0.0%,56m
43920,2,Bertles,2065,0,0,1,1,0.0%,34m
43940,2,mka,2064,1551,112,116,228,49.1%,28m
43940,2,DEstroyer,2064,1178,46,43,89,51.7%,20m
43940,2,protossico,2064,824,37,40,77,48.1%,13m
43940,1,Cels,2064,754,25,36,61,41.0%,9m
43940,2,Naggle,2064,455,15,18,33,45.5%,55m
43940,3,MACK,2064,344,14,15,29,48.3%,19m
43940,2,Mizeri,2064,267,8,12,20,40.0%,4m
43940,2,TalTheNew,2064,256,8,19,27,29.6%,6m
43940,3,Dibule,2064,174,6,4,10,60.0%,33m
43940,1,[RÖÖV]iOso,2064,186,6,16,22,27.3%,16m
43940,3,[Ɖŕąĩǵǿ]DuneRunner,2064,130,4,5,9,44.4%,5m
43940,2,[ZrgZer]Крыведко,2064,170,4,5,9,44.4%,53m
43940,3,Comandos,2064,0,3,2,5,60.0%,7m
43940,3,feiwel,2064,100,3,3,6,50.0%,40m
43940,3,TheWizard,2064,143,3,5,8,37.5%,8m
43940,3,oposumi,2064,30,2,2,4,50.0%,11m
43940,2,[ValidG]Goose,2064,92,2,8,10,20.0%,39m
43940,1,DaddelThor,2064,48,1,4,5,20.0%,17m
43940,3,Xypho,2064,0,0,5,5,0.0%,50m
43959,3,Marko,2063,1399,64,60,124,51.6%,39m
43959,2,heisenberg,2063,768,38,41,79,48.1%,37m
43959,2,Peacemaker,2063,859,35,41,76,46.1%,46m
43959,1,[SeVenV]Mengsk,2063,934,28,45,73,38.4%,54m
43959,2,BLAZE,2063,704,25,29,54,46.3%,34m
43959,2,Willhelm,2063,552,22,23,45,48.9%,29m
43959,2,[CusTos]Ciprian,2063,529,21,20,41,51.2%,49m
43959,1,iMake,2063,384,13,17,30,43.3%,21m
43959,1,ledr,2063,178,7,7,14,50.0%,32m
43959,3,LUVARDE,2063,86,7,9,16,43.8%,8m
43959,3,Motumbo,2063,114,5,2,7,71.4%,56m
43959,2,MroźnyGnat,2063,122,5,9,14,35.7%,57m
43959,1,greatguy,2063,104,5,10,15,33.3%,27m
43959,2,Babazorro,2063,76,4,7,11,36.4%,39m
43959,1,Finni,2063,153,4,11,15,26.7%,20m
43959,1,[GLGLG]Огмар,2063,48,2,12,14,14.3%,28m
43959,3,SmOoTH,2063,92,1,3,4,25.0%,28m
43959,2,Paulosa,2063,88,1,6,7,14.3%,54m
43959,3,[EisMC2]FireCrakFart,2063,0,0,1,1,0.0%,18m
43959,3,Stoun,2063,0,0,1,1,0.0%,21m
43959,3,roadkill,2063,0,0,1,1,0.0%,3m
43959,3,ТУРЕЦКИЙ,2063,0,0,2,2,0.0%,24m
43959,3,TrYsO,2063,0,0,5,5,0.0%,24m
43982,2,[RconUK]CarpyRecon,2062,1250,67,70,137,48.9%,1h
43982,2,mamba,2062,1252,45,53,98,45.9%,37m
43982,3,OKASSO,2062,1066,43,38,81,53.1%,24m
43982,2,MorgothPL,2062,850,37,38,75,49.3%,39m
43982,2,Willy,2062,624,23,26,49,46.9%,51m
43982,2,Edmaker,2062,595,22,25,47,46.8%,57m
43982,2,MisterCoco,2062,224,18,19,37,48.6%,20m
43982,3,Doronium,2062,303,14,12,26,53.8%,43m
43982,2,Mirost,2062,230,12,13,25,48.0%,53m
43982,2,[3q]bladenet,2062,176,7,9,16,43.8%,20m
43982,2,DaMac,2062,90,4,4,8,50.0%,46m
43982,2,Шмель,2062,0,3,3,6,50.0%,31m
43982,3,Denfior,2062,70,3,4,7,42.9%,5m
43982,3,Zeratul,2062,30,2,1,3,66.7%,6m
43982,1,Solei,2062,32,2,7,9,22.2%,31m
43982,3,popcorn,2062,0,1,0,1,100.0%,19m
43982,2,Halakost,2062,93,1,2,3,33.3%,39m
43982,2,zerg,2062,30,1,5,6,16.7%,53m
43982,2,ShadowsDeath,2062,0,1,6,7,14.3%,12m
43982,3,GeneralH,2062,0,0,1,1,0.0%,44m
43982,3,Black,2062,0,0,1,1,0.0%,54m
43982,2,Renessa,2062,0,0,2,2,0.0%,36m
43982,3,GafOriginal,2062,0,0,5,5,0.0%,4m
43982,3,FediM,2062,0,0,5,5,0.0%,50m
43982,2,Ethan,2062,0,0,7,7,0.0%,1m
44007,2,Neomag,2061,1277,51,51,102,50.0%,39m
44007,1,Jey,2061,460,46,52,98,46.9%,36m
44007,2,Pioter,2061,1028,40,47,87,46.0%,1h
44007,2,Glarusa,2061,934,35,38,73,47.9%,48m
44007,1,Krabi,2061,555,19,29,48,39.6%,13m
44007,2,[BPX]Blacksaw,2061,322,12,19,31,38.7%,23m
44007,1,medi,2061,188,5,12,17,29.4%,57m
44007,3,Danku,2061,88,4,1,5,80.0%,11m
44007,3,Waters,2061,90,4,2,6,66.7%,49m
44007,2,[nWss]llllllllllRa,2061,100,4,12,16,25.0%,48m
44007,3,[ØC]Jon,2061,86,3,3,6,50.0%,7m
44007,3,Jumboz,2061,0,1,1,2,50.0%,44m
44007,3,ShadowWalker,2061,0,1,1,2,50.0%,54m
44007,2,MaximusPrime,2061,40,1,4,5,20.0%,1m
44007,1,StErBeN,2061,48,1,4,5,20.0%,1m
44007,3,SEMEN,2061,30,1,6,7,14.3%,39m
44007,2,Monak,2061,95,1,7,8,12.5%,34m
44007,2,DARK,2061,94,1,7,8,12.5%,42m
44007,3,OWERGAME,2061,0,0,5,5,0.0%,28m
44007,3,EverDavosDie,2061,0,0,5,5,0.0%,21m
44007,2,Monkeyz,2061,0,0,6,6,0.0%,52m
44028,1,ardobabus,2060,1563,133,132,265,50.2%,1h
44028,2,[OmDi]viking,2060,1577,82,98,180,45.6%,38m
44028,2,Highvoid,2060,1328,67,74,141,47.5%,34m
44028,3,картошка,2060,676,25,19,44,56.8%,4m
44028,1,ROD,2060,574,21,36,57,36.8%,4m
44028,2,Akatsuki,2060,339,13,24,37,35.1%,17m
44028,2,Tool,2060,359,12,19,31,38.7%,57m
44028,2,Romsteak,2060,290,8,15,23,34.8%,1h
44028,1,Deivuxas,2060,170,6,12,18,33.3%,42m
44028,2,MazeX,2060,0,3,3,6,50.0%,4m
44028,2,Spiro,2060,0,3,5,8,37.5%,50m
44028,2,MatrixVlad,2060,124,3,7,10,30.0%,53m
44028,2,molossus,2060,88,3,9,12,25.0%,50m
44028,2,fredyfred,2060,64,3,10,13,23.1%,3m
44028,2,DeusMachina,2060,88,2,2,4,50.0%,44m
44028,3,[animch]animecheniy,2060,0,1,0,1,100.0%,57m
44028,3,bongakill,2060,0,1,0,1,100.0%,40m
44028,3,[NJoke]MOnsoon,2060,30,1,2,3,33.3%,8m
44028,3,GASIEV,2060,30,1,6,7,14.3%,56m
44028,3,elias,2060,0,0,1,1,0.0%,52m
44028,2,Prad,2060,0,0,3,3,0.0%,54m
44028,2,Shadow,2060,0,0,4,4,0.0%,28m
44028,1,Maxlo,2060,0,0,5,5,0.0%,44m
44028,3,[DomPre]lantrixsoof,2060,0,0,5,5,0.0%,6m
44052,3,Cryptonz,2059,789,59,57,116,50.9%,56m
44052,2,[инж]LEXX,2059,1308,52,54,106,49.1%,38m
44052,2,[AiRǂ]Frisesomorum,2059,750,28,34,62,45.2%,34m
44052,2,Rico,2059,682,25,28,53,47.2%,1m
44052,3,[004]SpaceJuanjo,2059,280,11,7,18,61.1%,37m
44052,2,Unknown,2059,186,10,6,16,62.5%,39m
44052,3,ZERATUL,2059,192,8,4,12,66.7%,43m
44052,3,Buttplug,2059,225,7,11,18,38.9%,23m
44052,3,Thomas,2059,128,6,15,21,28.6%,22m
44052,3,FAKETaxi,2059,60,3,1,4,75.0%,44m
44052,3,MikleLooser,2059,90,3,4,7,42.9%,2m
44052,3,Achilles,2059,0,2,3,5,40.0%,48m
44052,3,SkyHammer,2059,60,2,7,9,22.2%,5m
44052,3,егор,2059,0,1,1,2,50.0%,56m
44052,2,[SPAINs]yalipooo,2059,0,1,5,6,16.7%,43m
44052,2,mourek,2059,30,1,8,9,11.1%,39m
44052,2,FRANX,2059,0,0,1,1,0.0%,4m
44052,2,жоп,2059,0,0,1,1,0.0%,49m
44052,2,SunShow,2059,0,0,1,1,0.0%,7m
44052,3,MGHonor,2059,0,0,5,5,0.0%,35m
44052,3,Ben,2059,0,0,6,6,0.0%,4m
44073,1,[SC2SA]BlayiD,2058,1615,180,184,364,49.5%,1h
44073,2,shawn,2058,1350,145,148,293,49.5%,47m
44073,2,Shogun,2058,1104,43,47,90,47.8%,55m
44073,2,filamester,2058,814,33,35,68,48.5%,3m
44073,2,[Xan]DeSade,2058,195,23,14,37,62.2%,53m
44073,3,bob,2058,568,21,25,46,45.7%,45m
44073,1,Miratexo,2058,373,11,20,31,35.5%,3m
44073,2,nik,2058,220,10,8,18,55.6%,1h
44073,1,Skurwol,2058,330,9,14,23,39.1%,25m
44073,2,Bat,2058,268,8,11,19,42.1%,1h
44073,3,LiquideYe,2058,202,7,6,13,53.8%,37m
44073,2,Almar,2058,208,7,10,17,41.2%,1m
44073,3,RassBroKZ,2058,140,5,3,8,62.5%,23m
44073,2,cuting,2058,138,3,4,7,42.9%,31m
44073,3,hollowknight,2058,0,2,1,3,66.7%,4m
44073,2,Max,2058,60,2,6,8,25.0%,31m
44073,3,Neverdeath,2058,30,1,6,7,14.3%,9m
44073,3,januszek,2058,0,0,1,1,0.0%,57m
44073,3,Lyxolax,2058,0,0,1,1,0.0%,19m
44073,3,UnitedPotato,2058,0,0,1,1,0.0%,56m
44073,3,Layr,2058,0,0,5,5,0.0%,54m
44094,2,tal,2057,1055,54,51,105,51.4%,31m
44094,2,Jurrow,2057,353,13,13,26,50.0%,18m
44094,3,Gwuw,2057,292,12,7,19,63.2%,44m
44094,2,FatHomoKing,2057,141,6,5,11,54.5%,31m
44094,3,Grziwi,2057,167,5,6,11,45.5%,57m
44094,3,Rreebbeell,2057,0,3,3,6,50.0%,52m
44094,3,Роман,2057,125,2,6,8,25.0%,25m
44094,1,Lenar,2057,46,2,10,12,16.7%,51m
44094,3,skaloo,2057,30,1,1,2,50.0%,23m
44094,2,iwishiwasfun,2057,30,1,7,8,12.5%,34m
44094,3,Sonne,2057,0,0,1,1,0.0%,24m
44094,2,IronFalcon,2057,0,0,2,2,0.0%,46m
44094,3,[TTF]HDnova,2057,0,0,5,5,0.0%,24m
44107,2,[DECIMA]kierantodds,2056,1207,102,106,208,49.0%,4m
44107,2,Ged,2056,872,36,36,72,50.0%,24m
44107,2,MrShon,2056,905,33,41,74,44.6%,9m
44107,2,KRONER,2056,517,18,27,45,40.0%,2m
44107,3,[EoNabs]theDude,2056,305,11,14,25,44.0%,45m
44107,1,nico,2056,302,8,6,14,57.1%,2m
44107,2,Vlakie,2056,233,7,11,18,38.9%,49m
44107,3,Lenkon,2056,179,6,4,10,60.0%,28m
44107,2,rain,2056,148,6,7,13,46.2%,28m
44107,2,[LMBD]demci,2056,173,5,11,16,31.2%,22m
44107,2,Rasmussen,2056,202,5,15,20,25.0%,22m
44107,2,Predator,2056,152,4,8,12,33.3%,46m
44107,2,Antus,2056,122,4,11,15,26.7%,50m
44107,2,xazka,2056,154,3,4,7,42.9%,34m
44107,2,Angel,2056,108,2,1,3,66.7%,42m
44107,3,ddw,2056,0,1,4,5,20.0%,45m
44107,1,neirinho,2056,0,1,7,8,12.5%,53m
44107,3,saddasd,2056,0,0,1,1,0.0%,24m
44107,2,[ZERG7V]Aiross,2056,0,0,2,2,0.0%,36m
44107,2,GRUUL,2056,0,0,2,2,0.0%,49m
44107,2,FallenGhost,2056,0,0,3,3,0.0%,53m
44107,3,xalita,2056,0,0,5,5,0.0%,35m
44107,3,lion,2056,0,0,11,11,0.0%,47m
44130,2,vicioprofo,2055,1118,38,49,87,43.7%,38m
44130,3,Hekktor,2055,566,31,34,65,47.7%,44m
44130,2,[HMB666]Nightmare,2055,499,18,18,36,50.0%,13m
44130,2,plahdenchik,2055,377,15,21,36,41.7%,17m
44130,2,Nibble,2055,491,15,29,44,34.1%,23m
44130,2,NyxAssassin,2055,386,13,15,28,46.4%,41m
44130,3,masterwaflz,2055,213,8,10,18,44.4%,10m
44130,3,Greenleaf,2055,174,7,8,15,46.7%,28m
44130,2,unclebob,2055,271,7,16,23,30.4%,4m
44130,2,Player,2055,183,6,5,11,54.5%,9m
44130,3,PrinceDelhu,2055,60,4,12,16,25.0%,5m
44130,3,matt,2055,40,2,4,6,33.3%,16m
44130,1,Jormungandoo,2055,42,2,9,11,18.2%,5m
44130,1,mentoc,2055,0,1,0,1,100.0%,32m
44130,2,Funny,2055,0,1,1,2,50.0%,29m
44130,2,[FBBW]Novalis,2055,48,1,3,4,25.0%,42m
44130,3,Noe,2055,0,0,1,1,0.0%,24m
44130,3,Mehavv,2055,0,0,1,1,0.0%,10m
44130,2,ХодячийЖаль,2055,0,0,3,3,0.0%,3m
44130,2,ThomV,2055,0,0,6,6,0.0%,5m
44150,3,Bluesausage,2054,750,31,40,71,43.7%,41m
44150,1,DFLight,2054,362,14,19,33,42.4%,1m
44150,3,[InkInc]Trolololo,2054,280,11,5,16,68.8%,11m
44150,2,Floryncrg,2054,150,5,11,16,31.2%,37m
44150,2,Krasiolet,2054,150,5,11,16,31.2%,19m
44150,1,Greven,2054,96,3,11,14,21.4%,27m
44150,2,nuter,2054,30,2,4,6,33.3%,53m
44150,3,luckytiger,2054,114,2,7,9,22.2%,53m
44150,3,Leeeeroy,2054,97,2,9,11,18.2%,43m
44150,3,Ultima,2054,0,1,0,1,100.0%,21m
44150,3,EMark,2054,30,1,1,2,50.0%,28m
44150,2,Teax,2054,0,1,4,5,20.0%,41m
44150,2,gos,2054,30,1,5,6,16.7%,38m
44150,3,merlin,2054,0,0,1,1,0.0%,43m
44150,3,admiraalbeer,2054,0,0,1,1,0.0%,4m
44165,2,Darwin,2053,858,32,34,66,48.5%,22m
44165,2,[3x6]Kkleiv,2053,616,28,29,57,49.1%,20m
44165,3,[Buśki]Kagawa,2053,324,11,12,23,47.8%,20m
44165,1,GGmaster,2053,359,10,18,28,35.7%,27m
44165,3,TheAlcorian,2053,144,6,3,9,66.7%,9m
44165,3,dann,2053,88,3,5,8,37.5%,54m
44165,3,lochistloch,2053,0,2,3,5,40.0%,38m
44165,3,TimeWillTell,2053,48,2,5,7,28.6%,38m
44165,3,Steve,2053,0,1,1,2,50.0%,45m
44165,2,DEQU,2053,88,1,3,4,25.0%,18m
44165,3,Fertii,2053,0,0,2,2,0.0%,57m
44165,2,covid,2053,0,0,2,2,0.0%,1h
44177,2,Kabardinec,2052,771,45,48,93,48.4%,3m
44177,2,Lulian,2052,1046,43,39,82,52.4%,17m
44177,2,dart,2052,697,25,32,57,43.9%,24m
44177,1,kitcat,2052,568,19,29,48,39.6%,21m
44177,1,Ryuk,2052,482,17,26,43,39.5%,19m
44177,2,[woron]тимофей,2052,260,11,16,27,40.7%,12m
44177,1,name,2052,301,10,23,33,30.3%,3m
44177,3,Glutołaz,2052,226,9,5,14,64.3%,33m
44177,3,XITMANLI,2052,202,8,5,13,61.5%,52m
44177,2,Andrij,2052,131,4,1,5,80.0%,4m
44177,3,Raphael,2052,147,4,3,7,57.1%,29m
44177,3,Abdou,2052,100,3,1,4,75.0%,52m
44177,3,ghost,2052,86,3,4,7,42.9%,11m
44177,2,EbsStaRR,2052,94,3,10,13,23.1%,29m
44177,3,[ŞỮҜǺ]ĘĿvįŖḀ,2052,30,2,0,2,100.0%,23m
44177,2,Sxros,2052,60,2,4,6,33.3%,21m
44177,3,Götzeus,2052,72,2,7,9,22.2%,45m
44177,3,Justinus,2052,0,1,0,1,100.0%,11m
44177,3,Assassin,2052,0,0,5,5,0.0%,21m
44196,1,Predator,2051,1626,91,99,190,47.9%,24m
44196,3,matthias,2051,1562,72,90,162,44.4%,7m
44196,3,простоЛис,2051,1599,66,71,137,48.2%,57m
44196,2,nikimen,2051,571,40,38,78,51.3%,8m
44196,2,OnlyOneShot,2051,974,37,37,74,50.0%,14m
44196,2,emilio,2051,575,22,29,51,43.1%,54m
44196,1,Kairos,2051,220,5,2,7,71.4%,39m
44196,3,Avramo,2051,144,4,2,6,66.7%,57m
44196,2,[CBraz]Centalia,2051,0,3,3,6,50.0%,46m
44196,2,TONIOrangina,2051,116,3,4,7,42.9%,46m
44196,2,Quelenat,2051,90,3,8,11,27.3%,43m
44196,2,Magmusus,2051,88,2,2,4,50.0%,33m
44196,3,ProtossGuru,2051,0,1,0,1,100.0%,21m
44196,3,ITHEEB,2051,0,0,5,5,0.0%,35m
44210,1,sorhser,2050,1619,153,157,310,49.4%,27m
44210,2,IronCross,2050,563,28,26,54,51.9%,53m
44210,3,Speld,2050,618,24,21,45,53.3%,41m
44210,2,EDENSILLEN,2050,658,24,27,51,47.1%,55m
44210,2,Linkis,2050,311,19,21,40,47.5%,53m
44210,1,AleksMeison,2050,620,19,31,50,38.0%,28m
44210,3,[Тянки]Reaper,2050,226,8,3,11,72.7%,1h
44210,1,Francois,2050,280,8,13,21,38.1%,7m
44210,3,Nysumo,2050,176,7,5,12,58.3%,45m
44210,3,Sztrifler,2050,144,5,3,8,62.5%,2m
44210,2,Hellmaster,2050,197,4,6,10,40.0%,36m
44210,2,Kayzer,2050,102,3,3,6,50.0%,39m
44210,2,misterp,2050,60,3,5,8,37.5%,9m
44210,3,[SHTORM]Shaman,2050,58,2,3,5,40.0%,6m
44210,3,wizard,2050,0,1,0,1,100.0%,52m
44210,3,Георгий,2050,0,1,1,2,50.0%,21m
44210,3,[NOLLER]Poire,2050,97,1,5,6,16.7%,24m
44210,3,AlexRUSH,2050,0,0,1,1,0.0%,19m
44210,3,marci,2050,0,0,2,2,0.0%,21m
44210,2,Acronix,2050,0,0,3,3,0.0%,15m
44210,2,[N8]Danledresh,2050,0,0,6,6,0.0%,13m
44210,2,ThreeArrows,2050,0,0,6,6,0.0%,1h
44232,2,FUFA,2049,1212,55,47,102,53.9%,46m
44232,2,MANU,2049,737,28,32,60,46.7%,55m
44232,2,badtastex,2049,572,20,31,51,39.2%,1m
44232,2,Hitman,2049,330,13,13,26,50.0%,13m
44232,1,Robynius,2049,244,9,15,24,37.5%,38m
44232,3,Dranica,2049,222,8,13,21,38.1%,18m
44232,3,DENERGAR,2049,224,6,6,12,50.0%,55m
44232,2,BUBS,2049,30,5,5,10,50.0%,22m
44232,1,zpkeks,2049,164,5,9,14,35.7%,7m
44232,3,MixerDixer,2049,176,5,13,18,27.8%,48m
44232,3,[youy]kot,2049,58,3,0,3,100.0%,43m
44232,3,ZitrusFruit,2049,58,2,1,3,66.7%,6m
44232,2,ujkjdjhtp,2049,88,2,3,5,40.0%,56m
44232,2,MassivMAK,2049,46,2,7,9,22.2%,57m
44232,3,adamP,2049,0,0,1,1,0.0%,52m
44247,1,eweljusz,2048,1554,68,70,138,49.3%,22m
44247,1,shosh,2048,968,50,52,102,49.0%,14m
44247,2,Milenios,2048,518,22,22,44,50.0%,3m
44247,2,Rob,2048,237,5,10,15,33.3%,32m
44247,2,KolBaska,2048,186,4,9,13,30.8%,1m
44247,3,Sandmaker,2048,0,3,2,5,60.0%,45m
44247,2,Eidrift,2048,30,3,6,9,33.3%,49m
44247,1,jessterm,2048,48,3,10,13,23.1%,31m
44247,1,Mois,2048,119,2,2,4,50.0%,44m
44247,2,killerolya,2048,88,2,3,5,40.0%,12m
44247,1,Wepix,2048,30,2,7,9,22.2%,14m
44247,2,Stefan,2048,48,2,8,10,20.0%,31m
44247,3,Titanium,2048,0,1,4,5,20.0%,18m
44247,3,lauri,2048,0,0,1,1,0.0%,54m
44247,3,goug,2048,0,0,3,3,0.0%,9m
44247,2,NikitaTerran,2048,0,0,7,7,0.0%,37m
44263,2,Kylo,2047,842,30,38,68,44.1%,34m
44263,2,Firstblood,2047,611,23,23,46,50.0%,9m
44263,3,[CxCx]karakancolos,2047,288,22,23,45,48.9%,43m
44263,3,DonDiego,2047,501,17,17,34,50.0%,24m
44263,3,[Chariz]FLOOBAROO,2047,410,14,15,29,48.3%,1h
44263,1,Matti,2047,124,7,8,15,46.7%,41m
44263,2,iskaimin,2047,213,7,9,16,43.8%,57m
44263,3,[VStars]SaeZy,2047,178,6,7,13,46.2%,21m
44263,3,Destructeur,2047,30,4,3,7,57.1%,45m
44263,2,Jakuru,2047,175,4,3,7,57.1%,16m
44263,3,Sparta,2047,114,4,6,10,40.0%,25m
44263,2,[FR1]cuaterback,2047,150,4,13,17,23.5%,50m
44263,2,shMark,2047,134,3,1,4,75.0%,29m
44263,3,Pupsik,2047,58,2,4,6,33.3%,45m
44263,1,узбек,2047,0,1,3,4,25.0%,17m
44263,2,StarCrafcik,2047,0,1,3,4,25.0%,45m
44263,3,PATAFON,2047,0,1,4,5,20.0%,22m
44263,3,Anomaly,2047,0,0,3,3,0.0%,2m
44281,3,Hanmandu,2046,1528,334,367,701,47.6%,21m
44281,3,Sempronio,2046,1066,40,39,79,50.6%,2m
44281,3,[LOGS]wazzzuuuupp,2046,380,24,17,41,58.5%,41m
44281,2,powa,2046,317,11,20,31,35.5%,45m
44281,3,Atheh,2046,283,9,4,13,69.2%,1h
44281,3,Arkanoid,2046,224,9,7,16,56.2%,54m
44281,3,[GKTRK]Zaloğlu,2046,168,6,3,9,66.7%,37m
44281,2,MadeOrk,2046,90,6,7,13,46.2%,13m
44281,2,[Сold]Маэстро,2046,138,5,5,10,50.0%,3m
44281,2,Devil,2046,206,5,7,12,41.7%,21m
44281,1,TechNoBlade,2046,102,4,6,10,40.0%,49m
44281,1,Candela,2046,58,3,9,12,25.0%,35m
44281,3,MrLunion,2046,58,2,4,6,33.3%,29m
44281,3,Twistedbyte,2046,0,1,0,1,100.0%,9m
44281,3,Bararide,2046,0,1,0,1,100.0%,50m
44281,2,Inrocket,2046,95,1,7,8,12.5%,12m
44281,3,некит,2046,0,0,1,1,0.0%,1h
44298,1,PiotrBabinki,2045,1204,66,71,137,48.2%,40m
44298,2,NightMaster,2045,1127,40,49,89,44.9%,13m
44298,1,jqub,2045,390,14,22,36,38.9%,25m
44298,2,ARTO,2045,366,13,17,30,43.3%,1h
44298,2,мастер,2045,439,12,18,30,40.0%,49m
44298,2,PuLLDP,2045,361,10,19,29,34.5%,24m
44298,1,mandragor,2045,153,6,5,11,54.5%,5m
44298,1,Multe,2045,198,5,12,17,29.4%,53m
44298,2,Latrell,2045,0,3,5,8,37.5%,29m
44298,3,zborg,2045,88,3,6,9,33.3%,9m
44298,2,Gabounch,2045,117,3,6,9,33.3%,29m
44298,1,palka,2045,138,3,8,11,27.3%,29m
44298,3,[Arrows]iDax,2045,0,0,1,1,0.0%,18m
44298,3,ПАПА,2045,0,0,5,5,0.0%,22m
44312,2,Uran,2044,1517,157,161,318,49.4%,57m
44312,2,[HONERS]DarkSpawn,2044,1087,40,40,80,50.0%,18m
44312,2,Blade,2044,656,24,30,54,44.4%,38m
44312,2,vini,2044,484,20,16,36,55.6%,20m
44312,2,DexxTER,2044,504,17,25,42,40.5%,14m
44312,3,xTriMeEe,2044,396,14,15,29,48.3%,41m
44312,1,ricardor,2044,290,11,16,27,40.7%,20m
44312,3,serer,2044,296,10,6,16,62.5%,32m
44312,2,FROL,2044,246,9,14,23,39.1%,31m
44312,2,DvP,2044,254,7,8,15,46.7%,38m
44312,2,[LMBD]UseLite,2044,147,4,11,15,26.7%,43m
44312,2,[XPLOD]LostSoul,2044,148,4,11,15,26.7%,56m
44312,3,steve,2044,58,3,1,4,75.0%,4m
44312,3,CestLaVie,2044,30,2,1,3,66.7%,28m
44312,3,[VozD]Hanibal,2044,0,1,0,1,100.0%,8m
44312,1,Monk,2044,0,1,1,2,50.0%,28m
44312,3,kobra,2044,0,1,2,3,33.3%,11m
44312,3,[AIDP]odjuret,2044,42,1,3,4,25.0%,37m
44312,3,MICH,2044,40,1,6,7,14.3%,38m
44312,1,[Z666Zx]zorg,2044,0,1,7,8,12.5%,20m
44312,3,[LMquee]LMqueen,2044,0,0,1,1,0.0%,1h
44312,3,kirill,2044,0,0,1,1,0.0%,35m
44312,3,[FAJAS]myks,2044,0,0,1,1,0.0%,2m
44312,3,Dawnbringer,2044,0,0,3,3,0.0%,56m
44312,1,ВОЛОСАТЫЙ,2044,0,0,3,3,0.0%,17m
44312,2,Mannfort,2044,0,0,3,3,0.0%,29m
44312,3,[IceCub]АнимеТян,2044,0,0,4,4,0.0%,26m
44312,3,ultraviolisk,2044,0,0,4,4,0.0%,1h
44340,2,[ЕМPIRE]Aletkz,2043,1402,67,71,138,48.6%,15m
44340,2,Byoz,2043,626,27,41,68,39.7%,51m
44340,2,Darkkill,2043,518,19,23,42,45.2%,17m
44340,3,[TFNB]Tpow,2043,278,11,5,16,68.8%,23m
44340,3,ZeroTwo,2043,167,9,7,16,56.2%,13m
44340,2,[РусЭл]roboji,2043,206,9,10,19,47.4%,38m
44340,1,MerK,2043,242,9,15,24,37.5%,14m
44340,1,Tchoupi,2043,225,7,15,22,31.8%,1h
44340,2,DarkKing,2043,228,6,9,15,40.0%,56m
44340,2,KondR,2043,36,4,4,8,50.0%,29m
44340,1,[THpls]Lizarres,2043,146,4,22,26,15.4%,38m
44340,2,FireStorm,2043,110,3,4,7,42.9%,23m
44340,3,IIIIIIIIII,2043,30,2,0,2,100.0%,31m
44340,3,HotShots,2043,30,2,1,3,66.7%,23m
44340,3,MrMello,2043,58,2,2,4,50.0%,3m
44340,1,ControL,2043,48,2,11,13,15.4%,2m
44340,2,[Promil]Stefciogrzyb,2043,60,2,11,13,15.4%,21m
44340,3,SirQuieckeS,2043,0,1,1,2,50.0%,10m
44340,3,Максимилиан,2043,30,1,2,3,33.3%,13m
44340,3,[22asw1]Dydus,2043,0,0,1,1,0.0%,52m
44340,3,Moonwalker,2043,0,0,1,1,0.0%,37m
44340,3,dishi,2043,0,0,1,1,0.0%,38m
44340,3,krypto,2043,0,0,5,5,0.0%,45m
44363,1,gama,2042,867,87,94,181,48.1%,19m
44363,2,kart,2042,1098,52,48,100,52.0%,47m
44363,3,Siansor,2042,948,39,44,83,47.0%,30m
44363,2,MadDOG,2042,689,31,29,60,51.7%,51m
44363,2,Ulukay,2042,710,25,33,58,43.1%,32m
44363,3,bountyknight,2042,484,19,13,32,59.4%,9m
44363,2,papichampüuu,2042,250,7,10,17,41.2%,45m
44363,2,vautren,2042,210,7,13,20,35.0%,18m
44363,2,filemixer,2042,152,5,11,16,31.2%,38m
44363,3,XiMIK,2042,86,4,6,10,40.0%,19m
44363,2,MihansterII,2042,44,2,0,2,100.0%,15m
44363,3,Champiman,2042,30,2,1,3,66.7%,20m
44363,2,Alex,2042,91,2,1,3,66.7%,15m
44363,3,Bigboikhey,2042,66,2,4,6,33.3%,40m
44363,2,[RRQ]HaitiFox,2042,0,1,0,1,100.0%,4m
44363,1,Drboom,2042,95,1,2,3,33.3%,42m
44363,2,Fakver,2042,30,1,7,8,12.5%,52m
44380,2,Schorle,2041,671,28,26,54,51.9%,7m
44380,3,MOsquItO,2041,673,25,26,51,49.0%,39m
44380,2,Nicholas,2041,570,21,29,50,42.0%,47m
44380,3,Baw,2041,407,15,9,24,62.5%,8m
44380,2,[z666z]frace,2041,224,9,11,20,45.0%,20m
44380,1,Wurst,2041,186,7,10,17,41.2%,1h
44380,3,LeRotatif,2041,140,7,15,22,31.8%,9m
44380,1,[GSBLol]ogonek,2041,222,6,16,22,27.3%,54m
44380,1,VatanBayrak,2041,168,5,12,17,29.4%,33m
44380,2,Txuster,2041,94,4,8,12,33.3%,1h
44380,3,[KuCo]Kullerkex,2041,86,3,4,7,42.9%,48m
44380,3,ElNavajero,2041,30,2,2,4,50.0%,56m
44380,1,[Soldi]SimcaReef,2041,48,2,4,6,33.3%,16m
44380,2,scSilver,2041,121,2,6,8,25.0%,31m
44380,3,Hill,2041,30,1,1,2,50.0%,23m
44380,2,Serg,2041,30,1,4,5,20.0%,53m
44380,3,unclesamlv,2041,42,1,7,8,12.5%,29m
44380,3,pati,2041,0,0,1,1,0.0%,54m
44380,3,[AOTW]Fantom,2041,0,0,3,3,0.0%,9m
44380,3,Ascor,2041,0,0,6,6,0.0%,20m
44380,3,charlie,2041,0,0,6,6,0.0%,17m
44401,2,madman,2040,1260,61,46,107,57.0%,3m
44401,2,CeleryBear,2040,779,58,55,113,51.3%,29m
44401,3,DavidE,2040,1105,44,39,83,53.0%,49m
44401,1,[669]HunterWolf,2040,866,29,41,70,41.4%,4m
44401,3,starcraf,2040,590,23,22,45,51.1%,5m
44401,1,Havoc,2040,724,23,40,63,36.5%,28m
44401,2,Reystlin,2040,424,17,21,38,44.7%,47m
44401,2,Treviz,2040,335,13,12,25,52.0%,22m
44401,2,[CØG]ZangetsuKuro,2040,286,11,23,34,32.4%,46m
44401,3,LolDom,2040,288,10,7,17,58.8%,57m
44401,3,JJustice,2040,228,9,9,18,50.0%,9m
44401,2,KARADOK,2040,0,3,5,8,37.5%,18m
44401,2,HOSENKRIEGER,2040,30,2,2,4,50.0%,29m
44401,1,tom,2040,48,1,4,5,20.0%,43m
44401,1,Aemyl,2040,0,0,1,1,0.0%,31m
44401,3,Kardum,2040,0,0,2,2,0.0%,5m
44401,3,WedbeR,2040,0,0,5,5,0.0%,57m
44401,3,[P00T]AnvilNext,2040,0,0,5,5,0.0%,38m
44401,2,DrunkNoob,2040,0,0,6,6,0.0%,52m
44420,3,Krawcowy,2039,1221,50,47,97,51.5%,6m
44420,2,Devillos,2039,1114,41,52,93,44.1%,49m
44420,2,[Lndsrd]Dune,2039,608,34,28,62,54.8%,4m
44420,2,PurmanSA,2039,702,27,28,55,49.1%,1h
44420,3,юра,2039,494,18,23,41,43.9%,43m
44420,3,FALCON,2039,286,10,5,15,66.7%,38m
44420,2,[ICCCPI]макентоSH,2039,242,10,19,29,34.5%,55m
44420,2,seveneleven,2039,115,8,8,16,50.0%,51m
44420,1,Michelle,2039,120,6,15,21,28.6%,3m
44420,1,Vac,2039,101,5,9,14,35.7%,4m
44420,3,[GBang]Ucciditore,2039,90,4,5,9,44.4%,8m
44420,2,eos,2039,130,3,5,8,37.5%,5m
44420,3,uсk,2039,0,2,3,5,40.0%,28m
44420,2,classic,2039,0,1,2,3,33.3%,39m
44420,3,XOMYACHOK,2039,0,0,2,2,0.0%,1h
44420,2,ruairidh,2039,0,0,2,2,0.0%,13m
44436,3,Cavaldi,2038,1503,62,74,136,45.6%,37m
44436,2,[KSMH]KeSeMeKa,2038,785,32,31,63,50.8%,3m
44436,1,Alex,2038,262,7,14,21,33.3%,27m
44436,2,HWeinstein,2038,210,6,13,19,31.6%,38m
44436,3,UnderGround,2038,0,5,0,5,100.0%,17m
44436,2,Buakox,2038,164,4,8,12,33.3%,21m
44436,3,[NOSV]Nosferatul,2038,58,2,4,6,33.3%,57m
44436,1,benolot,2038,44,2,9,11,18.2%,19m
44436,3,[GoForA]Romulus,2038,0,0,1,1,0.0%,22m
44445,2,itsaruck,2037,1461,71,77,148,48.0%,5m
44445,3,daze,2037,775,53,53,106,50.0%,41m
44445,2,[BCNE]Kristatos,2037,875,36,34,70,51.4%,28m
44445,2,CrovidXX,2037,866,29,41,70,41.4%,6m
44445,2,Дровосек,2037,336,23,16,39,59.0%,21m
44445,3,ХАН,2037,602,22,42,64,34.4%,20m
44445,3,Rasoon,2037,435,16,16,32,50.0%,21m
44445,3,LILACBOB,2037,398,15,9,24,62.5%,30m
44445,2,fennhycs,2037,338,15,15,30,50.0%,15m
44445,3,MajesticRoar,2037,382,15,18,33,45.5%,45m
44445,2,adato,2037,342,11,14,25,44.0%,7m
44445,3,mash,2037,203,6,12,18,33.3%,31m
44445,2,Čuchoprd,2037,94,3,5,8,37.5%,39m
44445,2,Andariel,2037,125,3,6,9,33.3%,45m
44445,1,Галеон,2037,96,3,13,16,18.8%,24m
44445,1,Roman,2037,114,3,19,22,13.6%,51m
44445,3,AverieAutumn,2037,0,2,3,5,40.0%,1h
44445,2,Albert,2037,60,2,6,8,25.0%,28m
44445,3,finmake,2037,0,1,0,1,100.0%,10m
44445,3,dTag,2037,0,1,1,2,50.0%,24m
44445,2,Snyz,2037,30,1,7,8,12.5%,13m
44445,3,halbert,2037,0,0,1,1,0.0%,30m
44445,3,Timo,2037,0,0,1,1,0.0%,23m
44445,3,DiShLMena,2037,0,0,2,2,0.0%,37m
44445,1,Arnie,2037,0,0,2,2,0.0%,16m
44445,2,drahlana,2037,0,0,4,4,0.0%,35m
44471,2,Ябадабаду,2036,850,61,65,126,48.4%,14m
44471,2,Biggie,2036,610,41,52,93,44.1%,54m
44471,2,MER,2036,806,32,40,72,44.4%,38m
44471,3,mavrick,2036,830,31,28,59,52.5%,6m
44471,2,Anakin,2036,484,22,32,54,40.7%,6m
44471,2,Milun,2036,500,18,21,39,46.2%,19m
44471,3,Anczyns,2036,378,13,17,30,43.3%,21m
44471,3,Стронгсокол,2036,86,4,4,8,50.0%,49m
44471,2,PhantomXXL,2036,185,3,10,13,23.1%,32m
44471,3,diegladeitor,2036,0,2,3,5,40.0%,56m
44471,1,Scarecrow,2036,34,2,10,12,16.7%,38m
44471,3,[Smarty]SeregaL,2036,30,1,1,2,50.0%,1h
44471,3,JarO,2036,0,0,1,1,0.0%,49m
44471,2,ahmedefoudag,2036,0,0,4,4,0.0%,27m
44485,2,RannMiliaro,2035,1159,97,103,200,48.5%,15m
44485,2,eduardo,2035,1567,78,88,166,47.0%,38m
44485,2,LtColRazma,2035,968,34,42,76,44.7%,1h
44485,2,ben,2035,450,16,24,40,40.0%,12m
44485,3,vunak,2035,97,2,4,6,33.3%,30m
44485,3,Wizzardo,2035,0,0,1,1,0.0%,6m
44485,3,саня,2035,0,0,2,2,0.0%,48m
44485,3,CricketArsen,2035,0,0,6,6,0.0%,22m
44485,3,agentBARSIK,2035,0,0,6,6,0.0%,52m
44494,3,Christina,2034,872,78,79,157,49.7%,55m
44494,2,ЗабытаяДверь,2034,1396,63,49,112,56.2%,37m
44494,3,elreymago,2034,1468,58,54,112,51.8%,30m
44494,3,[Meavv]airamana,2034,553,30,31,61,49.2%,33m
44494,1,Augustus,2034,665,26,32,58,44.8%,39m
44494,3,Bolvar,2034,281,10,8,18,55.6%,21m
44494,2,[beaste]TheSwarmLead,2034,122,5,8,13,38.5%,56m
44494,3,[tospro]Dragoncat,2034,97,4,9,13,30.8%,45m
44494,3,destro,2034,86,3,2,5,60.0%,23m
44494,2,PalleKuling,2034,90,3,8,11,27.3%,34m
44494,3,[ME1]Melancholy,2034,0,2,3,5,40.0%,52m
44494,2,VolcanoMan,2034,0,1,1,2,50.0%,36m
44494,3,Данте,2034,0,1,4,5,20.0%,22m
44494,1,[YMCAP]ViRUSAlexx,2034,30,1,13,14,7.1%,45m
44494,3,[BierG]MainRANDOM,2034,0,0,1,1,0.0%,57m
44494,3,llllllllllll,2034,0,0,1,1,0.0%,6m
44510,2,nehaisi,2033,806,31,32,63,49.2%,43m
44510,3,TimirXan,2033,716,27,27,54,50.0%,2m
44510,3,Xavv,2033,368,14,24,38,36.8%,2m
44510,3,sergpac,2033,138,10,10,20,50.0%,3m
44510,3,LeoLejon,2033,223,6,6,12,50.0%,3m
44510,2,Xwost,2033,152,3,3,6,50.0%,4m
44510,3,[3DEN]Nust,2033,0,2,3,5,40.0%,45m
44510,3,NightFury,2033,60,2,4,6,33.3%,41m
44510,2,Vlkn,2033,102,2,7,9,22.2%,39m
44510,3,IusDesign,2033,0,2,10,12,16.7%,23m
44510,1,Murdok,2033,48,2,11,13,15.4%,1h
44510,1,Yazoru,2033,0,1,7,8,12.5%,17m
44510,2,Darq,2033,94,1,8,9,11.1%,44m
44510,3,volikovvv,2033,0,0,1,1,0.0%,7m
44510,2,Skorpio,2033,0,0,5,5,0.0%,56m
44525,2,Sedmin,2032,1177,132,143,275,48.0%,39m
44525,2,[Фыр]Limonka,2032,920,68,79,147,46.3%,38m
44525,1,NOX,2032,533,51,63,114,44.7%,41m
44525,2,Dragon,2032,280,9,12,21,42.9%,51m
44525,2,Starbuck,2032,254,9,17,26,34.6%,46m
44525,2,Jempa,2032,88,4,8,12,33.3%,57m
44525,3,[K700]ветеран,2032,90,3,4,7,42.9%,37m
44525,1,Man,2032,70,3,8,11,27.3%,40m
44525,2,mcfly,2032,94,3,9,12,25.0%,46m
44525,1,metallimax,2032,118,2,4,6,33.3%,7m
44525,3,MqNI,2032,60,2,4,6,33.3%,21m
44525,3,Razor,2032,0,1,1,2,50.0%,49m
44525,3,schnarphooo,2032,0,0,1,1,0.0%,38m
44525,3,HeyApple,2032,0,0,1,1,0.0%,45m
44525,2,HEX,2032,0,0,2,2,0.0%,43m
44525,3,Mosquito,2032,0,0,2,2,0.0%,54m
44525,1,[G6AS]Tyrok,2032,0,0,3,3,0.0%,25m
44525,2,JayKay,2032,0,0,7,7,0.0%,57m
44543,2,IKC,2031,475,30,38,68,44.1%,1h
44543,1,sarkofa,2031,784,29,41,70,41.4%,24m
44543,2,Yoshi,2031,266,19,20,39,48.7%,34m
44543,2,[Gülden]RustyManfred,2031,444,18,20,38,47.4%,13m
44543,2,onmymind,2031,405,15,17,32,46.9%,46m
44543,2,[BRSKR]DawnTime,2031,385,13,24,37,35.1%,49m
44543,3,tylay,2031,320,10,20,30,33.3%,17m
44543,3,Trofidio,2031,208,8,11,19,42.1%,42m
44543,3,joab,2031,178,7,19,26,26.9%,28m
44543,2,Vanguard,2031,60,5,7,12,41.7%,4m
44543,1,[N1CANI]Gexy,2031,134,4,2,6,66.7%,56m
44543,2,Girafdinger,2031,88,3,7,10,30.0%,31m
44543,3,GarryWolf,2031,30,2,1,3,66.7%,3m
44543,2,joseeduardo,2031,103,2,5,7,28.6%,46m
44543,1,Aksi,2031,96,2,8,10,20.0%,42m
44543,1,Gigelush,2031,0,1,9,10,10.0%,31m
44543,3,paf,2031,0,0,1,1,0.0%,18m
44543,2,Rialo,2031,0,0,1,1,0.0%,53m
44543,3,drkorte,2031,0,0,2,2,0.0%,21m
44543,3,Hexxx,2031,0,0,2,2,0.0%,41m
44543,3,Candle,2031,0,0,3,3,0.0%,57m
44543,3,Bazinga,2031,0,0,6,6,0.0%,6m
44543,2,kasper,2031,0,0,10,10,0.0%,41m
44566,3,Martn,2030,922,35,27,62,56.5%,3m
44566,3,DDGms,2030,907,32,42,74,43.2%,42m
44566,2,Axel,2030,388,18,25,43,41.9%,33m
44566,2,XAKERbelarus,2030,224,8,13,21,38.1%,38m
44566,2,ReinedesRats,2030,226,6,9,15,40.0%,36m
44566,1,LIMAPASIV,2030,217,4,13,17,23.5%,32m
44566,2,Alex,2030,0,2,6,8,25.0%,42m
44566,2,SCCHRabbit,2030,30,2,8,10,20.0%,46m
44566,3,[DeRpYH]DerpyHooves,2030,30,1,2,3,33.3%,55m
44566,2,NanoNasone,2030,46,1,4,5,20.0%,21m
44566,3,Remuneration,2030,0,0,1,1,0.0%,21m
44566,3,Foton,2030,0,0,2,2,0.0%,5m
44566,3,Sashikoster,2030,0,0,3,3,0.0%,35m
44579,3,imba,2029,1310,116,124,240,48.3%,36m
44579,2,Terminator,2029,596,23,22,45,51.1%,47m
44579,1,Hextia,2029,595,23,27,50,46.0%,1h
44579,3,[SPAINs]mon,2029,494,19,14,33,57.6%,30m
44579,3,SirElClariso,2029,210,7,10,17,41.2%,28m
44579,2,Лёха,2029,175,6,6,12,50.0%,53m
44579,2,CaYpouTest,2029,114,5,4,9,55.6%,5m
44579,3,[gogone]SirRubik,2029,144,5,6,11,45.5%,29m
44579,1,deadmetal,2029,104,4,11,15,26.7%,51m
44579,3,BLO,2029,60,3,3,6,50.0%,2m
44579,1,Hvu,2029,145,3,10,13,23.1%,45m
44579,2,NigaДяй,2029,30,2,7,9,22.2%,56m
44579,2,Tinyman,2029,46,2,8,10,20.0%,13m
44579,2,[LAIDI]Cenzo,2029,0,1,2,3,33.3%,52m
44579,2,[NGCS]SOKOL,2029,94,1,7,8,12.5%,21m
44579,1,wisa,2029,0,1,8,9,11.1%,42m
44579,3,MMAzerg,2029,0,0,1,1,0.0%,49m
44579,3,Brimstone,2029,0,0,2,2,0.0%,18m
44579,3,TimucinKey,2029,0,0,3,3,0.0%,55m
44579,3,Hybrill,2029,0,0,3,3,0.0%,43m
44579,3,SUBZERO,2029,0,0,4,4,0.0%,45m
44600,1,Mcannin,2028,1201,102,114,216,47.2%,13m
44600,3,trOnk,2028,1157,55,49,104,52.9%,20m
44600,2,SLTnVNGR,2028,1120,51,52,103,49.5%,14m
44600,2,[Aple]DENTRON,2028,1142,46,54,100,46.0%,47m
44600,3,батлщет,2028,470,18,15,33,54.5%,57m
44600,2,serzlo,2028,369,15,23,38,39.5%,48m
44600,2,serral,2028,352,13,13,26,50.0%,1m
44600,3,Deadinside,2028,398,13,17,30,43.3%,45m
44600,3,[SPSes]EspaRraGO,2028,164,6,3,9,66.7%,57m
44600,2,[АРМАДА]Носочек,2028,110,5,1,6,83.3%,36m
44600,3,BeeKiller,2028,145,4,2,6,66.7%,23m
44600,2,каратель,2028,94,4,8,12,33.3%,20m
44600,3,[ЕМPIRE]Ебалай,2028,58,3,2,5,60.0%,31m
44600,2,frotoss,2028,58,2,7,9,22.2%,9m
44600,3,fear,2028,60,2,14,16,12.5%,3m
44600,2,CreAtiVe,2028,93,1,7,8,12.5%,39m
44600,3,Schwalbe,2028,0,0,5,5,0.0%,18m
44617,2,Respect,2027,1540,150,157,307,48.9%,12m
44617,3,Deerhunter,2027,1422,94,104,198,47.5%,45m
44617,1,yarsk,2027,878,81,91,172,47.1%,13m
44617,3,Lax,2027,853,34,23,57,59.6%,45m
44617,2,TITAN,2027,815,31,30,61,50.8%,41m
44617,3,EIVOR,2027,399,16,9,25,64.0%,56m
44617,1,Hass,2027,389,12,19,31,38.7%,45m
44617,2,IIIIIIIIIIII,2027,247,10,12,22,45.5%,1m
44617,2,Bbqer,2027,258,9,16,25,36.0%,49m
44617,3,Dozzzerboss,2027,259,8,9,17,47.1%,13m
44617,1,Google,2027,193,4,12,16,25.0%,24m
44617,1,heiligefeuer,2027,97,3,8,11,27.3%,34m
44617,2,[ISK]Derzelis,2027,95,2,1,3,66.7%,38m
44617,3,Shifter,2027,0,1,2,3,33.3%,16m
44617,3,Ruder,2027,30,1,3,4,25.0%,23m
44617,3,Zsáki,2027,30,1,3,4,25.0%,23m
44617,2,Rover,2027,44,1,7,8,12.5%,39m
44617,2,marguzzio,2027,95,1,8,9,11.1%,28m
44617,2,SilverActive,2027,99,1,13,14,7.1%,20m
44617,3,goga,2027,0,0,1,1,0.0%,2m
44637,3,[IRMGZ]Lambespinhas,2026,216,9,9,18,50.0%,43m
44637,3,Самит,2026,142,8,5,13,61.5%,12m
44637,3,Morty,2026,241,8,12,20,40.0%,45m
44637,2,Alex,2026,138,5,6,11,45.5%,1h
44637,2,[2usty]Richard,2026,130,4,8,12,33.3%,3m
44637,2,LookTherIWon,2026,114,3,5,8,37.5%,57m
44637,3,DaRk,2026,72,2,6,8,25.0%,56m
44637,3,DaThristan,2026,0,1,1,2,50.0%,22m
44637,3,Simonee,2026,0,0,3,3,0.0%,6m
44637,2,IIIIIIIIIIII,2026,0,0,3,3,0.0%,45m
44637,2,evan,2026,0,0,9,9,0.0%,30m
44648,2,Zeph,2025,1172,45,44,89,50.6%,1h
44648,3,[CEV]Konqueror,2025,222,9,5,14,64.3%,23m
44648,2,wafel,2025,209,9,5,14,64.3%,49m
44648,1,GiantBalls,2025,212,7,16,23,30.4%,6m
44648,2,[CrBd]ALittleBit,2025,128,4,11,15,26.7%,45m
44648,3,Sixten,2025,58,3,0,3,100.0%,21m
44648,3,Kokosik,2025,60,3,3,6,50.0%,9m
44648,3,RandomChik,2025,90,3,7,10,30.0%,11m
44648,2,thekiller,2025,132,3,9,12,25.0%,56m
44648,3,PYJIb,2025,0,1,0,1,100.0%,22m
44648,3,AntGre,2025,0,1,1,2,50.0%,41m
44648,2,ILsctwo,2025,0,1,5,6,16.7%,57m
44648,2,geuz,2025,0,0,1,1,0.0%,44m
44648,3,sleepybear,2025,0,0,4,4,0.0%,45m
44662,1,shadowdanil,2024,990,58,57,115,50.4%,37m
44662,2,Даве,2024,714,30,29,59,50.8%,51m
44662,1,boulickjr,2024,764,29,41,70,41.4%,21m
44662,1,[KOtics]Sinator,2024,520,17,28,45,37.8%,15m
44662,2,[утка]ZERGPEK,2024,338,11,17,28,39.3%,2m
44662,2,SweetPotatoe,2024,190,10,8,18,55.6%,37m
44662,3,Tadzio,2024,280,10,9,19,52.6%,8m
44662,3,Sylvain,2024,174,5,6,11,45.5%,41m
44662,3,Michał,2024,88,4,1,5,80.0%,16m
44662,2,Nicosaurus,2024,127,3,7,10,30.0%,57m
44662,2,Stalker,2024,115,2,8,10,20.0%,13m
44662,2,ManafestOwnZ,2024,0,1,6,7,14.3%,34m
44662,1,Hugo,2024,0,1,8,9,11.1%,45m
44662,2,Yanro,2024,0,0,1,1,0.0%,39m
44662,2,Renexxx,2024,0,0,6,6,0.0%,2m
44677,1,Checker,2023,1616,131,134,265,49.4%,1h
44677,2,HzUBEYDULLA,2023,1307,85,82,167,50.9%,38m
44677,3,Vanerd,2023,969,48,50,98,49.0%,56m
44677,2,[aDGa]Gamerunner,2023,546,19,28,47,40.4%,48m
44677,3,[bisdak]StarLord,2023,457,17,13,30,56.7%,57m
44677,3,[Jail]Sacredlore,2023,162,12,15,27,44.4%,57m
44677,2,DarkEthanX,2023,234,9,9,18,50.0%,36m
44677,3,Mauro,2023,193,7,5,12,58.3%,6m
44677,3,[VP33]MACA,2023,134,5,7,12,41.7%,30m
44677,2,Dedpool,2023,120,5,7,12,41.7%,18m
44677,3,[SPAINs]batchar,2023,30,4,2,6,66.7%,22m
44677,2,GoodbaD,2023,58,2,7,9,22.2%,18m
44677,3,[кроул]вершитель,2023,30,1,2,3,33.3%,57m
44677,2,[mfxed]LegendaVoidu,2023,95,1,3,4,25.0%,24m
44677,1,[minire]BeepSheep,2023,0,1,7,8,12.5%,27m
44677,1,Adrian,2023,0,1,8,9,11.1%,17m
44677,3,[971]Braximus,2023,0,0,1,1,0.0%,3m
44677,3,Phi,2023,0,0,6,6,0.0%,29m
44695,2,lihetavi,2022,1384,53,57,110,48.2%,38m
44695,3,[R4Time]ДЖИЗУС,2022,496,33,32,65,50.8%,20m
44695,2,COSMIN,2022,866,31,39,70,44.3%,4m
44695,3,Ades,2022,349,13,6,19,68.4%,25m
44695,3,Abormotrnd,2022,312,11,13,24,45.8%,45m
44695,2,Pavlik,2022,261,8,8,16,50.0%,53m
44695,2,Demon,2022,166,5,7,12,41.7%,29m
44695,1,DoubleCream,2022,140,4,11,15,26.7%,10m
44695,2,Archon,2022,94,3,5,8,37.5%,38m
44695,2,GIGROBOT,2022,94,3,13,16,18.8%,23m
44695,3,Kezyr,2022,30,2,4,6,33.3%,1h
44695,3,GaNDoN,2022,0,1,0,1,100.0%,29m
44695,2,LeiT,2022,44,1,2,3,33.3%,29m
44695,3,Stefanenkov,2022,0,0,1,1,0.0%,41m
44695,3,[DTCz]altéra,2022,0,0,1,1,0.0%,9m
44710,2,Eylon,2021,1234,44,50,94,46.8%,39m
44710,1,Predy,2021,528,17,25,42,40.5%,25m
44710,3,ATHForce,2021,258,8,9,17,47.1%,30m
44710,2,Axumaron,2021,220,7,11,18,38.9%,1m
44710,2,SCpappa,2021,162,5,11,16,31.2%,56m
44710,2,[VENGam]BadNexusYT,2021,118,3,6,9,33.3%,44m
44710,3,Snuksen,2021,0,0,1,1,0.0%,20m
44710,3,MissingLink,2021,0,0,5,5,0.0%,3m
44718,3,MisterNavy,2020,399,18,17,35,51.4%,11m
44718,3,LeMeilleu,2020,226,9,11,20,45.0%,5m
44718,2,ScopperCaban,2020,60,3,10,13,23.1%,45m
44718,3,AlexSerbanro,2020,30,2,2,4,50.0%,52m
44718,2,Stown,2020,60,2,7,9,22.2%,56m
44718,3,[Pastor]DonForte,2020,0,1,0,1,100.0%,57m
44718,3,Malcador,2020,30,1,1,2,50.0%,3m
44718,2,[ЕМPIRE]Барбатос,2020,0,1,1,2,50.0%,12m
44718,2,Fox,2020,0,1,3,4,25.0%,54m
44718,2,brutus,2020,0,1,7,8,12.5%,7m
44718,2,Трор,2020,0,1,7,8,12.5%,36m
44718,3,[PrGema]Dreamfaker,2020,0,0,1,1,0.0%,20m
44718,1,kinterAwka,2020,0,0,1,1,0.0%,57m
44718,3,BobaZhito,2020,0,0,2,2,0.0%,9m
44718,2,KingAkul,2020,0,0,7,7,0.0%,25m
44733,2,avv,2019,1558,145,158,303,47.9%,53m
44733,2,Bloodlust,2019,1535,134,154,288,46.5%,55m
44733,2,desemyr,2019,1118,83,96,179,46.4%,53m
44733,2,Ласка,2019,1435,66,68,134,49.3%,1h
44733,2,StMeatballs,2019,1023,65,75,140,46.4%,45m
44733,3,Noradbylat,2019,458,17,15,32,53.1%,55m
44733,2,kuzima,2019,288,10,11,21,47.6%,54m
44733,3,Deniro,2019,34,4,4,8,50.0%,29m
44733,3,rams,2019,102,3,5,8,37.5%,1h
44733,2,MumriyAlex,2019,128,2,1,3,66.7%,55m
44733,3,Roman,2019,0,1,3,4,25.0%,41m
44733,1,SugiMori,2019,46,1,3,4,25.0%,34m
44733,3,[SszZ7]дима,2019,0,1,3,4,25.0%,45m
44733,1,Goodnes,2019,0,0,2,2,0.0%,40m
44747,3,[CSVG]Gibson,2018,376,14,16,30,46.7%,45m
44747,3,MaHuak,2018,234,8,10,18,44.4%,6m
44747,3,QwerAntropod,2018,213,8,12,20,40.0%,17m
44747,2,Sly,2018,202,6,14,20,30.0%,56m
44747,2,Laura,2018,114,5,9,14,35.7%,3m
44747,2,Corvinus,2018,60,4,8,12,33.3%,43m
44747,1,yaya,2018,134,3,4,7,42.9%,27m
44747,3,EKI,2018,60,2,7,9,22.2%,49m
44747,3,otd,2018,0,1,1,2,50.0%,49m
44747,3,gogo,2018,30,1,1,2,50.0%,41m
44747,2,RunRobot,2018,0,1,2,3,33.3%,11m
44747,3,APride,2018,30,1,3,4,25.0%,54m
44747,2,miguelito,2018,0,1,3,4,25.0%,55m
44747,3,LosKop,2018,0,0,1,1,0.0%,43m
44747,3,DANDOS,2018,0,0,1,1,0.0%,2m
44747,3,Sentry,2018,0,0,3,3,0.0%,1h
44763,2,Manze,2017,1548,99,106,205,48.3%,34m
44763,2,Next,2017,1533,71,66,137,51.8%,1h
44763,2,Cheburek,2017,1539,66,74,140,47.1%,54m
44763,2,[SS13]ASD,2017,1112,41,46,87,47.1%,3m
44763,3,КОТ,2017,340,13,10,23,56.5%,23m
44763,2,Protector,2017,314,11,15,26,42.3%,54m
44763,1,Elemiah,2017,318,10,20,30,33.3%,9m
44763,3,DieGrootBaas,2017,218,9,19,28,32.1%,38m
44763,3,PanKraz,2017,118,5,3,8,62.5%,6m
44763,1,Lumpinator,2017,231,5,5,10,50.0%,40m
44763,2,Xtremekillz,2017,162,5,14,19,26.3%,49m
44763,3,ТеСей,2017,120,4,8,12,33.3%,20m
44763,3,Vision,2017,74,2,3,5,40.0%,37m
44763,3,hristodjolev,2017,113,2,6,8,25.0%,21m
44763,2,sci,2017,138,2,8,10,20.0%,25m
44763,2,[TULEN]samurakavkaz,2017,30,2,9,11,18.2%,56m
44763,2,CPTNiJo,2017,30,1,8,9,11.1%,56m
44763,3,Dirtywizard,2017,0,0,2,2,0.0%,1h
44763,1,Danielread,2017,0,0,5,5,0.0%,30m
44763,2,[CaZT]gagarin,2017,0,0,6,6,0.0%,3m
44783,2,Robertakus,2016,1138,78,84,162,48.1%,49m
44783,2,Kruskal,2016,868,46,63,109,42.2%,53m
44783,2,AhrenWam,2016,452,26,25,51,51.0%,4m
44783,2,Limon,2016,539,22,26,48,45.8%,20m
44783,2,ZockingHD,2016,556,20,22,42,47.6%,39m
44783,2,TeMFiS,2016,134,11,9,20,55.0%,29m
44783,2,Dobba,2016,212,9,18,27,33.3%,52m
44783,3,Slayzer,2016,212,7,4,11,63.6%,5m
44783,2,Roman,2016,220,7,9,16,43.8%,53m
44783,3,Chrispy,2016,176,6,7,13,46.2%,7m
44783,3,ТихийШторм,2016,88,5,4,9,55.6%,12m
44783,3,vlad,2016,0,3,2,5,60.0%,6m
44783,3,FluffyTail,2016,60,3,2,5,60.0%,8m
44783,3,TimFMV,2016,88,3,3,6,50.0%,17m
44783,2,Locrian,2016,0,3,4,7,42.9%,29m
44783,3,AMNIBAL,2016,102,3,5,8,37.5%,54m
44783,2,makundi,2016,48,2,7,9,22.2%,31m
44783,3,savvy,2016,34,1,5,6,16.7%,22m
44783,2,DiGreez,2016,0,1,7,8,12.5%,40m
44783,2,Littleghosty,2016,0,0,6,6,0.0%,55m
44783,3,[wpwpwp]TEMBINP,2016,0,0,6,6,0.0%,17m
44783,3,DEN,2016,0,0,6,6,0.0%,20m
44783,1,hituli,2016,0,0,8,8,0.0%,28m
44806,2,[ANREN]Neonion,2015,997,55,69,124,44.4%,4m
44806,2,FNLega,2015,1008,44,56,100,44.0%,24m
44806,2,Kardok,2015,1092,39,49,88,44.3%,3m
44806,2,Manore,2015,539,31,33,64,48.4%,27m
44806,2,skreoach,2015,803,28,37,65,43.1%,5m
44806,3,Hiei,2015,381,18,13,31,58.1%,3m
44806,2,Kazah,2015,497,16,22,38,42.1%,53m
44806,3,Slide,2015,246,9,22,31,29.0%,37m
44806,3,NikDevil,2015,166,6,4,10,60.0%,31m
44806,3,Master,2015,120,4,7,11,36.4%,49m
44806,2,Protoculture,2015,82,3,3,6,50.0%,22m
44806,3,Jason,2015,30,2,0,2,100.0%,21m
44806,3,Azamurabi,2015,48,2,2,4,50.0%,37m
44806,3,neiji,2015,0,2,3,5,40.0%,38m
44806,3,LogosCL,2015,118,2,8,10,20.0%,21m
44806,3,[Reano]stealthplays,2015,30,1,1,2,50.0%,17m
44806,3,dima,2015,30,1,1,2,50.0%,9m
44806,3,criterrus,2015,30,1,2,3,33.3%,6m
44806,3,[047]Vasan,2015,0,0,3,3,0.0%,36m
44825,3,[BaneX]JAMBO,2014,1466,68,67,135,50.4%,56m
44825,2,azakiller,2014,590,22,25,47,46.8%,21m
44825,3,Yar,2014,335,14,8,22,63.6%,45m
44825,3,uplingur,2014,318,13,11,24,54.2%,17m
44825,3,maxxx,2014,344,12,20,32,37.5%,21m
44825,3,[SwgBoi]Nanuuki,2014,273,9,11,20,45.0%,38m
44825,2,SirSasi,2014,194,7,10,17,41.2%,32m
44825,3,uevon,2014,174,6,8,14,42.9%,56m
44825,2,Jinofix,2014,86,2,9,11,18.2%,7m
44825,3,TenYearsOld,2014,0,0,1,1,0.0%,8m
44825,2,Veepomm,2014,0,0,1,1,0.0%,13m
44825,2,Slava,2014,0,0,3,3,0.0%,39m
44837,2,[LFBro]StarLord,2013,1094,44,47,91,48.4%,53m
44837,1,Phantooobias,2013,811,25,45,70,35.7%,30m
44837,2,Kaktus,2013,263,13,13,26,50.0%,54m
44837,3,DIMAPIDORASS,2013,297,11,8,19,57.9%,41m
44837,1,Bezemkaas,2013,289,7,14,21,33.3%,37m
44837,3,Бибурат,2013,174,6,9,15,40.0%,4m
44837,3,LoKuSt,2013,86,4,3,7,57.1%,45m
44837,3,DarkBeaver,2013,120,4,9,13,30.8%,17m
44837,3,Aztec,2013,86,3,5,8,37.5%,54m
44837,3,Vanber,2013,30,1,1,2,50.0%,12m
44837,3,aaronct,2013,0,0,1,1,0.0%,48m
44837,2,Thybril,2013,0,0,6,6,0.0%,46m
44849,3,Tomaszek,2012,1601,69,81,150,46.0%,3m
44849,2,Elai,2012,755,46,56,102,45.1%,49m
44849,3,Vodoley,2012,974,37,34,71,52.1%,56m
44849,3,alexfrise,2012,878,36,31,67,53.7%,9m
44849,2,Jotto,2012,643,23,34,57,40.4%,31m
44849,1,linglecha,2012,326,9,18,27,33.3%,43m
44849,2,[SEWP]CuteCactus,2012,94,6,12,18,33.3%,2m
44849,3,XxX,2012,88,4,4,8,50.0%,34m
44849,2,[GGVPD]Bud,2012,119,4,5,9,44.4%,38m
44849,2,[OPALA]PekiNeutron,2012,86,4,6,10,40.0%,13m
44849,2,pOtInCk,2012,154,4,8,12,33.3%,29m
44849,1,Varhmundin,2012,190,4,12,16,25.0%,14m
44849,1,Bronttosaur,2012,48,3,11,14,21.4%,25m
44849,2,Mimokaa,2012,62,2,8,10,20.0%,9m
44849,3,[TaMort]pichnic,2012,0,1,0,1,100.0%,45m
44849,3,[Xenor]naruto,2012,0,1,0,1,100.0%,34m
44849,3,FlutterShy,2012,30,1,4,5,20.0%,23m
44849,2,darkNUNO,2012,40,1,6,7,14.3%,5m
44849,1,Sllow,2012,0,1,7,8,12.5%,9m
44849,3,Tom,2012,0,0,1,1,0.0%,17m
44849,3,Сvaruna,2012,0,0,1,1,0.0%,3m
44849,2,DOMINIO,2012,0,0,6,6,0.0%,2m
44871,2,Greg,2011,1403,52,60,112,46.4%,9m
44871,2,GuuuuZ,2011,1191,49,54,103,47.6%,13m
44871,1,Odyn,2011,823,29,41,70,41.4%,35m
44871,2,Velikiy,2011,433,22,29,51,43.1%,47m
44871,3,Chewy,2011,560,20,20,40,50.0%,41m
44871,1,Killyox,2011,516,18,27,45,40.0%,39m
44871,1,Tim,2011,532,17,29,46,37.0%,1m
44871,3,Like,2011,315,13,23,36,36.1%,30m
44871,3,BaZinGa,2011,369,12,22,34,35.3%,2m
44871,3,перс,2011,116,4,6,10,40.0%,54m
44871,2,alexia,2011,128,3,5,8,37.5%,29m
44871,2,LaGrassa,2011,90,3,11,14,21.4%,39m
44871,3,Pacothor,2011,0,2,3,5,40.0%,45m
44871,1,Hirufim,2011,48,2,9,11,18.2%,26m
44871,2,Прокростинат,2011,44,1,3,4,25.0%,31m
44871,3,Feather,2011,34,1,5,6,16.7%,38m
44871,2,Navarro,2011,0,0,1,1,0.0%,16m
44888,2,DimirVla,2010,1107,46,49,95,48.4%,20m
44888,1,PeteyDeLacy,2010,1132,43,51,94,45.7%,58m
44888,2,Skyfall,2010,822,31,40,71,43.7%,1h
44888,2,FireFox,2010,649,28,26,54,51.9%,5m
44888,1,SILE,2010,716,28,41,69,40.6%,19m
44888,2,Fear,2010,143,5,7,12,41.7%,50m
44888,3,JoeDalton,2010,199,5,10,15,33.3%,23m
44888,1,unnamednotch,2010,216,5,11,16,31.2%,19m
44888,3,ALGAZAR,2010,118,4,5,9,44.4%,44m
44888,2,Encio,2010,0,3,4,7,42.9%,14m
44888,3,[MAH3]Sivonja,2010,30,2,2,4,50.0%,23m
44888,2,LUXUS,2010,0,1,2,3,33.3%,55m
44888,3,somebody,2010,0,0,1,1,0.0%,6m
44888,3,Libík,2010,0,0,1,1,0.0%,1h
44888,3,[Podpol]Лёша,2010,0,0,2,2,0.0%,20m
44888,2,Laurequetil,2010,0,0,2,2,0.0%,31m
44888,3,samo,2010,0,0,3,3,0.0%,49m
44905,2,Trigger,2009,1244,130,140,270,48.1%,49m
44905,2,maeon,2009,1354,50,65,115,43.5%,48m
44905,2,Bars,2009,854,33,39,72,45.8%,27m
44905,2,Dango,2009,661,26,29,55,47.3%,48m
44905,3,gARRICKSTORM,2009,301,24,31,55,43.6%,35m
44905,2,джокер,2009,492,21,22,43,48.8%,41m
44905,3,[GATILA]DoniMoore,2009,476,17,16,33,51.5%,57m
44905,3,Rogan,2009,421,14,13,27,51.9%,6m
44905,3,BennyB,2009,304,11,12,23,47.8%,6m
44905,3,Dragon,2009,249,7,14,21,33.3%,21m
44905,1,BenMi,2009,268,7,14,21,33.3%,39m
44905,2,Zorroforlive,2009,148,5,13,18,27.8%,45m
44905,3,Theo,2009,137,3,9,12,25.0%,54m
44905,3,PoProstu,2009,60,2,3,5,40.0%,43m
44905,2,dedee,2009,96,2,9,11,18.2%,22m
44905,3,Talon,2009,0,1,1,2,50.0%,52m
44905,3,[liPG]NeonNAX,2009,0,1,2,3,33.3%,3m
44905,3,TheRealGismo,2009,30,1,2,3,33.3%,45m
44905,3,wetTerran,2009,0,0,1,1,0.0%,54m
44905,3,[TDwtf]Rollhase,2009,0,0,1,1,0.0%,3m
44905,3,MeisterNero,2009,0,0,1,1,0.0%,38m
44905,3,Tansonville,2009,0,0,2,2,0.0%,37m
44905,2,[оОо0]EFEM,2009,0,0,3,3,0.0%,36m
44905,3,Rononelektro,2009,0,0,3,3,0.0%,45m
44905,2,[FteamF]Aynn,2009,0,0,4,4,0.0%,39m
44905,2,aleksdan,2009,0,0,5,5,0.0%,22m
44905,3,igormacadams,2009,0,0,6,6,0.0%,6m
44905,3,Prectoant,2009,0,0,6,6,0.0%,38m
44905,1,DonDiego,2009,0,0,7,7,0.0%,17m
44934,3,reCaRd,2008,1105,115,136,251,45.8%,9m
44934,3,LolKin,2008,763,29,22,51,56.9%,9m
44934,2,kercak,2008,736,23,36,59,39.0%,24m
44934,1,Kvinto,2008,662,22,29,51,43.1%,51m
44934,2,Chrispy,2008,271,10,19,29,34.5%,24m
44934,3,Khym,2008,164,7,8,15,46.7%,9m
44934,3,Sankenryu,2008,177,5,13,18,27.8%,7m
44934,3,egzekutor,2008,92,2,6,8,25.0%,37m
44934,3,Eiganjo,2008,0,1,1,2,50.0%,40m
44934,1,siegfrid,2008,0,1,9,10,10.0%,7m
44934,3,[kek34]DEMON,2008,0,0,1,1,0.0%,21m
44934,2,Sopogx,2008,0,0,1,1,0.0%,49m
44934,3,Gangsta,2008,0,0,1,1,0.0%,7m
44934,3,ZORG,2008,0,0,3,3,0.0%,49m
44948,2,IIkar,2007,1478,51,60,111,45.9%,54m
44948,2,Dédé,2007,1136,47,47,94,50.0%,39m
44948,2,seravin,2007,696,30,37,67,44.8%,39m
44948,3,Святоша,2007,225,10,12,22,45.5%,3m
44948,3,Toffer,2007,333,10,16,26,38.5%,38m
44948,3,DarkKain,2007,200,8,6,14,57.1%,57m
44948,2,Creambum,2007,167,6,7,13,46.2%,8m
44948,2,Weedor,2007,150,4,14,18,22.2%,27m
44948,3,Zpapaone,2007,0,2,1,3,66.7%,46m
44948,3,[JYD]jpoha,2007,0,2,4,6,33.3%,52m
44948,3,physicist,2007,0,1,0,1,100.0%,38m
44948,2,Atuin,2007,0,1,1,2,50.0%,42m
44948,3,InAlve,2007,30,1,6,7,14.3%,56m
44948,2,seal,2007,32,1,8,9,11.1%,50m
44948,3,АдскаяКухня,2007,0,0,1,1,0.0%,36m
44948,2,satana,2007,0,0,3,3,0.0%,52m
44948,2,teorugby,2007,0,0,6,6,0.0%,31m
44965,3,техфиз,2006,368,15,12,27,55.6%,1h
44965,1,[Harley]strativarius,2006,402,8,17,25,32.0%,31m
44965,3,MorganSaturn,2006,233,7,14,21,33.3%,20m
44965,3,rommel,2006,142,5,4,9,55.6%,1h
44965,3,jose,2006,92,3,6,9,33.3%,37m
44965,2,Loki,2006,0,1,0,1,100.0%,39m
44965,2,Eagle,2006,0,1,0,1,100.0%,13m
44965,2,LIKMIJNBALLE,2006,30,1,8,9,11.1%,54m
44965,3,galahad,2006,0,0,1,1,0.0%,46m
44974,2,CAMIL,2005,1185,226,251,477,47.4%,3m
44974,2,[PND18]DarkPepette,2005,961,35,42,77,45.5%,48m
44974,3,алекс,2005,864,31,32,63,49.2%,30m
44974,3,xDisaster,2005,404,13,21,34,38.2%,9m
44974,1,[рейнор]tatoshi,2005,250,9,17,26,34.6%,53m
44974,3,Avalanche,2005,154,5,7,12,41.7%,32m
44974,3,Smiles,2005,156,5,32,37,13.5%,1h
44974,2,[HaoS]Ghost,2005,0,1,0,1,100.0%,54m
44974,3,MaitreJules,2005,30,1,3,4,25.0%,13m
44974,3,JIM,2005,0,1,3,4,25.0%,57m
44974,3,Аджита,2005,0,1,5,6,16.7%,24m
44974,2,FOX,2005,30,1,8,9,11.1%,19m
44974,3,numbber,2005,0,0,1,1,0.0%,34m
44974,2,[КSQUАD]ЛеонидКрон,2005,0,0,1,1,0.0%,34m
44974,2,korol,2005,0,0,1,1,0.0%,34m
44974,2,Fynster,2005,0,0,6,6,0.0%,36m
44974,3,pizza,2005,0,0,6,6,0.0%,17m
44991,2,nik,2004,1512,73,79,152,48.0%,31m
44991,2,kris,2004,900,32,39,71,45.1%,3m
44991,1,Krzysiek,2004,679,22,33,55,40.0%,30m
44991,1,ROSTOHEKNUKI,2004,381,12,19,31,38.7%,37m
44991,1,Wave,2004,204,9,19,28,32.1%,30m
44991,2,NuKLeaR,2004,187,7,7,14,50.0%,53m
44991,3,andrei,2004,118,5,4,9,55.6%,57m
44991,2,Bonum,2004,140,5,5,10,50.0%,37m
44991,2,tommdelong,2004,0,4,3,7,57.1%,34m
44991,3,killgarah,2004,58,3,1,4,75.0%,57m
44991,3,leonard,2004,60,2,2,4,50.0%,2m
44991,1,Nedis,2004,122,2,10,12,16.7%,34m
44991,3,CarolusRex,2004,0,1,0,1,100.0%,56m
44991,2,luntik,2004,0,1,1,2,50.0%,50m
44991,2,[2WoD]MoJo,2004,0,1,6,7,14.3%,56m
44991,2,Élythia,2004,46,1,8,9,11.1%,50m
44991,3,КирпиДон,2004,0,0,1,1,0.0%,5m
44991,3,RobsonPL,2004,0,0,5,5,0.0%,17m
44991,3,Seku,2004,0,0,6,6,0.0%,7m
44991,2,IIIIIIIII,2004,0,0,6,6,0.0%,1h
44991,2,Lula,2004,0,0,6,6,0.0%,43m
45012,2,Charasa,2003,1555,164,172,336,48.8%,53m
45012,2,Arianna,2003,1458,67,82,149,45.0%,48m
45012,2,[GDZg]KOJIbIBAH,2003,539,24,29,53,45.3%,58m
45012,2,Cronous,2003,569,19,30,49,38.8%,13m
45012,3,smok,2003,358,14,11,25,56.0%,9m
45012,2,CCCPRussia,2003,316,12,16,28,42.9%,56m
45012,3,CII,2003,329,12,18,30,40.0%,17m
45012,2,TWilnEt,2003,285,11,10,21,52.4%,23m
45012,3,Vichik,2003,293,10,16,26,38.5%,9m
45012,2,[K1LL]Luiggi,2003,294,9,11,20,45.0%,45m
45012,3,DrinDin,2003,256,9,12,21,42.9%,56m
45012,3,[sonic1]фаталтактик,2003,58,3,2,5,60.0%,52m
45012,3,Verion,2003,123,3,5,8,37.5%,36m
45012,3,zefire,2003,146,3,7,10,30.0%,9m
45012,1,Lioulik,2003,60,3,10,13,23.1%,1h
45012,3,Sonic,2003,0,2,3,5,40.0%,38m
45012,3,Паладинчик,2003,0,1,0,1,100.0%,43m
45012,3,EIDOS,2003,30,1,1,2,50.0%,41m
45012,3,Cesareus,2003,0,0,2,2,0.0%,9m
45012,3,Lucathor,2003,0,0,5,5,0.0%,44m
45032,2,Kerki,2002,514,28,31,59,47.5%,21m
45032,3,PaLm,2002,419,19,13,32,59.4%,44m
45032,3,Phelka,2002,142,9,5,14,64.3%,49m
45032,3,[αX]woodooo,2002,233,8,1,9,88.9%,5m
45032,1,Nikolai,2002,170,6,14,20,30.0%,42m
45032,3,Julien,2002,38,4,3,7,57.1%,1m
45032,3,Bucephalus,2002,149,3,4,7,42.9%,20m
45032,3,Федор,2002,32,2,2,4,50.0%,27m
45032,3,Merzh,2002,58,2,5,7,28.6%,13m
45032,1,cgarridoh,2002,96,2,8,10,20.0%,28m
45032,2,JokeR,2002,76,2,9,11,18.2%,29m
45032,3,predalexisYt,2002,0,1,0,1,100.0%,7m
45032,1,HUAWEI,2002,0,1,8,9,11.1%,24m
45032,3,Mitto,2002,0,0,1,1,0.0%,3m
45046,3,[KDV]bambuspunk,2001,715,27,17,44,61.4%,20m
45046,2,безумныйеж,2001,366,15,19,34,44.1%,21m
45046,3,Johni,2001,320,11,8,19,57.9%,18m
45046,3,Xorgx,2001,318,11,12,23,47.8%,49m
45046,3,AdrianPop,2001,194,5,3,8,62.5%,38m
45046,2,ant,2001,135,5,6,11,45.5%,17m
45046,2,qzKizi,2001,118,3,6,9,33.3%,4m
45046,1,InkVisitor,2001,0,3,7,10,30.0%,48m
45046,3,dynamojoe,2001,0,2,4,6,33.3%,35m
45046,1,rty,2001,58,2,23,25,8.0%,41m
45046,3,Demn,2001,97,1,2,3,33.3%,23m
45046,3,Samat,2001,30,1,2,3,33.3%,30m
45046,2,Creamer,2001,46,1,6,7,14.3%,11m
45046,3,[lkgg]ДЕШЁФФКА,2001,0,0,1,1,0.0%,38m
45046,1,MikiPL,2001,0,0,2,2,0.0%,52m
45061,2,ГАЛСТАРКРАФ,2000,1384,81,100,181,44.8%,22m
45061,2,NoboLulu,2000,869,49,52,101,48.5%,53m
45061,3,SilverFox,2000,973,37,35,72,51.4%,35m
45061,2,Pain,2000,823,33,34,67,49.3%,2m
45061,1,серый,2000,858,33,42,75,44.0%,52m
45061,3,Lotzi,2000,509,20,15,35,57.1%,44m
45061,3,Schnitzel,2000,522,19,18,37,51.4%,17m
45061,3,Löwenherz,2000,292,11,12,23,47.8%,49m
45061,2,derBisi,2000,242,8,9,17,47.1%,34m
45061,3,lukolik,2000,172,6,8,14,42.9%,20m
45061,3,Zep,2000,88,3,5,8,37.5%,57m
45061,1,Sascha,2000,62,3,10,13,23.1%,35m
45061,3,Nohuma,2000,30,2,1,3,66.7%,9m
45061,3,[CaLe]Subotay,2000,30,1,2,3,33.3%,57m
45061,3,BossSokół,2000,30,1,3,4,25.0%,1h
45061,2,thorus,2000,88,1,3,4,25.0%,53m
45061,2,WesołyFloria,2000,95,1,7,8,12.5%,40m
45061,3,ShOfer,2000,0,0,1,1,0.0%,34m
45061,3,Stylker,2000,0,0,1,1,0.0%,44m
45061,2,Gradius,2000,0,0,2,2,0.0%,29m
45061,3,[RiOTS]ProTerZerg,2000,0,0,6,6,0.0%,7m
45082,2,Alican,1999,491,17,23,40,42.5%,6m
45082,2,KIKO,1999,448,15,26,41,36.6%,54m
45082,3,Thunder,1999,184,5,2,7,71.4%,6m
45082,1,RussoTyristo,1999,172,5,7,12,41.7%,30m
45082,2,Suejle,1999,198,5,9,14,35.7%,1m
45082,2,Boris,1999,133,4,5,9,44.4%,51m
45082,3,Bozo,1999,58,3,3,6,50.0%,18m
45082,3,Maximatey,1999,22,2,1,3,66.7%,7m
45082,3,Dragonscar,1999,0,0,1,1,0.0%,6m
45082,3,[STDES]mixter,1999,0,0,1,1,0.0%,9m
45082,3,mutya,1999,0,0,6,6,0.0%,2m
45093,2,krapiva,1998,1330,54,61,115,47.0%,19m
45093,2,[Y8U]Ana,1998,841,34,35,69,49.3%,26m
45093,3,AleBarbus,1998,911,33,32,65,50.8%,5m
45093,3,Witia,1998,379,13,20,33,39.4%,9m
45093,1,boomboks,1998,308,10,13,23,43.5%,26m
45093,1,Leonidas,1998,245,8,16,24,33.3%,27m
45093,3,inferno,1998,166,7,5,12,58.3%,30m
45093,1,Anakeim,1998,204,7,16,23,30.4%,35m
45093,1,wendigo,1998,146,5,13,18,27.8%,33m
45093,1,NinjaDodo,1998,187,3,5,8,37.5%,44m
45093,3,Anubis,1998,90,3,7,10,30.0%,12m
45093,3,[607]sana,1998,42,2,1,3,66.7%,18m
45093,3,SimeonMoney,1998,12,2,6,8,25.0%,49m
45093,2,SubaroVOD,1998,0,1,6,7,14.3%,5m
45093,1,AnewHERO,1998,0,0,8,8,0.0%,20m
45108,2,HoodsAntifa,1997,628,23,31,54,42.6%,2m
45108,2,EtOverlord,1997,521,22,23,45,48.9%,46m
45108,3,[FrSlip]ELEPHANT,1997,510,18,23,41,43.9%,17m
45108,2,Mason,1997,251,6,7,13,46.2%,16m
45108,2,SanyaReaper,1997,124,5,11,16,31.2%,53m
45108,3,Lsong,1997,102,5,16,21,23.8%,41m
45108,3,Dizzy,1997,86,4,3,7,57.1%,21m
45108,3,Rublev,1997,64,4,3,7,57.1%,5m
45108,3,LeChefs,1997,145,3,1,4,75.0%,41m
45108,2,Mauki,1997,0,3,4,7,42.9%,42m
45108,1,TonyMontana,1997,119,3,6,9,33.3%,39m
45108,2,peter,1997,62,3,8,11,27.3%,3m
45108,2,[99999]димон,1997,30,2,4,6,33.3%,14m
45108,3,[v8ZX7h]scorpion,1997,0,0,1,1,0.0%,49m
45122,1,Vova,1996,1473,199,218,417,47.7%,2m
45122,3,graham,1996,1536,60,68,128,46.9%,1h
45122,2,Refa,1996,952,57,71,128,44.5%,15m
45122,2,Draco,1996,991,35,39,74,47.3%,9m
45122,2,KAMIKAZE,1996,311,11,20,31,35.5%,45m
45122,3,Sledopyt,1996,226,10,13,23,43.5%,45m
45122,1,[7a8DAN]DanSolo,1996,150,6,9,15,40.0%,30m
45122,3,Jheid,1996,0,1,0,1,100.0%,44m
45122,3,UbaNawak,1996,30,1,1,2,50.0%,45m
45122,2,Maxeros,1996,30,1,7,8,12.5%,10m
45122,2,Xiad,1996,0,0,1,1,0.0%,37m
45122,2,InfoDecision,1996,0,0,1,1,0.0%,34m
45122,3,Hentoxen,1996,0,0,1,1,0.0%,20m
45122,3,kaneki,1996,0,0,2,2,0.0%,9m
45122,2,DrGhostdog,1996,0,0,3,3,0.0%,13m
45122,2,StG,1996,0,0,3,3,0.0%,38m
45122,3,VETERBY,1996,0,0,6,6,0.0%,23m
45139,3,Mantella,1995,1408,57,56,113,50.4%,43m
45139,1,GreatZerg,1995,969,39,55,94,41.5%,1h
45139,2,Magic,1995,679,33,36,69,47.8%,15m
45139,2,[БИЗНЕС]Фатонщик,1995,530,22,26,48,45.8%,46m
45139,3,furionix,1995,327,12,3,15,80.0%,20m
45139,2,Maroldorn,1995,182,8,13,21,38.1%,43m
45139,1,[Yoga]MissEffie,1995,256,8,21,29,27.6%,20m
45139,2,[НОД17]blacksun,1995,88,5,7,12,41.7%,53m
45139,3,UPGRADDDE,1995,149,4,9,13,30.8%,56m
45139,2,nilZOR,1995,166,4,11,15,26.7%,2m
45139,3,Gergely,1995,30,2,3,5,40.0%,43m
45139,3,Daantes,1995,38,2,5,7,28.6%,52m
45139,2,[4672]Gratisninja,1995,0,2,10,12,16.7%,21m
45139,3,perry,1995,0,1,0,1,100.0%,38m
45139,3,DesertRose,1995,0,0,5,5,0.0%,45m
45139,3,poinashero,1995,0,0,6,6,0.0%,44m
45155,2,[SPAINs]Jordi,1994,1541,269,289,558,48.2%,58m
45155,2,Tristan,1994,1543,92,102,194,47.4%,33m
45155,2,MaBaobao,1994,1446,56,59,115,48.7%,20m
45155,2,jmdr,1994,575,23,29,52,44.2%,45m
45155,2,Panart,1994,346,22,35,57,38.6%,34m
45155,1,MicxyDough,1994,350,12,20,32,37.5%,43m
45155,2,malice,1994,94,4,8,12,33.3%,11m
45155,3,Morlock,1994,62,4,13,17,23.5%,23m
45155,3,driof,1994,86,3,2,5,60.0%,8m
45155,3,Heisenberg,1994,66,2,7,9,22.2%,7m
45155,2,Ben,1994,88,1,5,6,16.7%,36m
45155,3,Perets,1994,0,1,5,6,16.7%,36m
45155,1,nDymion,1994,0,0,3,3,0.0%,39m
45155,3,KyloXD,1994,0,0,6,6,0.0%,5m
45169,2,[Jail]Arturiatus,1993,690,36,37,73,49.3%,8m
45169,3,Tosondr,1993,876,32,31,63,50.8%,24m
45169,2,[BSK88]Hallora,1993,501,22,32,54,40.7%,41m
45169,3,Simon,1993,492,20,19,39,51.3%,1h
45169,2,[Proto5]DonChulio,1993,532,18,30,48,37.5%,49m
45169,3,Divad,1993,435,15,15,30,50.0%,4m
45169,2,Toycrawler,1993,425,12,24,36,33.3%,4m
45169,2,uekilaw,1993,312,11,19,30,36.7%,52m
45169,3,WingNut,1993,288,10,9,19,52.6%,57m
45169,3,EgorZero,1993,291,10,13,23,43.5%,57m
45169,2,Frillo,1993,350,10,16,26,38.5%,45m
45169,3,Deadfight,1993,221,7,15,22,31.8%,3m
45169,1,nosferatu,1993,192,6,8,14,42.9%,32m
45169,3,IgzzzJet,1993,108,4,6,10,40.0%,2m
45169,3,Cliffjumper,1993,30,2,2,4,50.0%,57m
45169,1,DankBeetle,1993,32,2,10,12,16.7%,40m
45169,3,Escanor,1993,0,1,0,1,100.0%,13m
45169,3,swedikok,1993,38,1,1,2,50.0%,27m
45169,3,Bulldozzer,1993,0,0,1,1,0.0%,37m
45169,3,VKaz,1993,0,0,2,2,0.0%,55m
45169,1,Insidious,1993,0,0,4,4,0.0%,26m
45169,3,Skorpion,1993,0,0,5,5,0.0%,55m
45169,2,[SBeV]Sigg,1993,0,0,6,6,0.0%,8m
45169,3,MagicMyLoveC,1993,0,0,6,6,0.0%,50m
45193,2,Improwizer,1992,602,82,97,179,45.8%,45m
45193,3,Eismaster,1992,121,3,11,14,21.4%,56m
45193,2,smeilk,1992,0,1,0,1,100.0%,54m
45193,2,[СК20]MrMaKs,1992,48,1,8,9,11.1%,36m
45197,2,Zeebbn,1991,1111,45,46,91,49.5%,38m
45197,3,Grinchen,1991,935,42,43,85,49.4%,43m
45197,3,SpacialRonin,1991,508,18,19,37,48.6%,45m
45197,3,jeremy,1991,422,14,17,31,45.2%,35m
45197,3,Magnus,1991,210,13,14,27,48.1%,12m
45197,2,Raiseurhatch,1991,262,12,14,26,46.2%,54m
45197,3,JAIR,1991,279,10,11,21,47.6%,18m
45197,3,Wolf,1991,187,9,5,14,64.3%,49m
45197,1,[STMS]Nayoko,1991,176,6,8,14,42.9%,40m
45197,2,ANGELRCXD,1991,214,6,12,18,33.3%,42m
45197,3,JUDGEMENT,1991,140,5,3,8,62.5%,23m
45197,3,ASDRS,1991,116,4,3,7,57.1%,22m
45197,3,MWSURFER,1991,90,4,4,8,50.0%,58m
45197,1,антон,1991,144,4,7,11,36.4%,36m
45197,2,Optimus,1991,60,2,6,8,25.0%,20m
45197,2,Wándorr,1991,48,1,5,6,16.7%,34m
45197,2,Sanek,1991,0,0,2,2,0.0%,38m
45214,2,OldDeus,1990,1283,162,163,325,49.8%,45m
45214,1,thanos,1990,501,18,29,47,38.3%,19m
45214,3,Hse,1990,336,12,19,31,38.7%,28m
45214,3,Maraki,1990,172,7,6,13,53.8%,22m
45214,2,diego,1990,92,6,7,13,46.2%,33m
45214,3,[LØV2B3]Chatou,1990,126,6,9,15,40.0%,14m
45214,3,dreed,1990,142,5,8,13,38.5%,37m
45214,1,Dze,1990,92,5,9,14,35.7%,34m
45214,2,[NINJ88]Pipo,1990,204,4,11,15,26.7%,4m
45214,3,megatron,1990,34,2,0,2,100.0%,38m
45214,3,Gektarka,1990,58,2,1,3,66.7%,45m
45214,3,justAlex,1990,30,2,3,5,40.0%,20m
45214,3,Faktor,1990,30,2,4,6,33.3%,48m
45214,2,[Xenor]Link,1990,0,1,0,1,100.0%,42m
45214,2,Szkieleton,1990,0,0,1,1,0.0%,7m
45214,3,Vodachka,1990,0,0,5,5,0.0%,20m
45214,3,TWA,1990,0,0,6,6,0.0%,44m
45231,3,[MRaven]Return,1989,312,11,11,22,50.0%,17m
45231,3,Гоблин,1989,0,4,1,5,80.0%,7m
45231,1,[TDraC]Snoweyes,1989,139,3,1,4,75.0%,39m
45231,2,[VOLKI]romatolmach,1989,135,2,2,4,50.0%,34m
45231,2,GreenNK,1989,74,2,6,8,25.0%,30m
45231,1,Eken,1989,97,2,10,12,16.7%,28m
45231,2,campus,1989,0,1,7,8,12.5%,37m
45231,1,Anhiklom,1989,0,1,8,9,11.1%,13m
45231,3,Wiktors,1989,0,0,3,3,0.0%,56m
45231,3,[LOVlaw]CAT,1989,0,0,4,4,0.0%,8m
45231,3,piro,1989,0,0,6,6,0.0%,6m
45231,3,Seignorarth,1989,0,0,6,6,0.0%,55m
45243,2,Sol,1988,1145,85,83,168,50.6%,38m
45243,2,PlayerOne,1988,1241,66,72,138,47.8%,23m
45243,3,ferka,1988,1234,47,61,108,43.5%,9m
45243,3,Liviathanx,1988,268,14,14,28,50.0%,3m
45243,2,zbattle,1988,254,9,7,16,56.2%,32m
45243,2,Ixes,1988,212,7,15,22,31.8%,21m
45243,3,ghostdragon,1988,88,3,4,7,42.9%,55m
45243,3,seriyronin,1988,0,1,0,1,100.0%,38m
45243,3,[MG01]Maximatorn,1988,0,1,1,2,50.0%,29m
45243,2,[okere]Adricool,1988,0,1,2,3,33.3%,25m
45243,2,Ale,1988,88,1,7,8,12.5%,47m
45243,3,Utaak,1988,0,0,1,1,0.0%,35m
45243,3,Megalovania,1988,0,0,1,1,0.0%,24m
45243,3,omatrees,1988,0,0,2,2,0.0%,1h
45257,2,Benda,1987,1517,110,126,236,46.6%,13m
45257,3,Benny,1987,753,37,34,71,52.1%,9m
45257,3,[GSP1]ALZAR,1987,398,29,22,51,56.9%,28m
45257,3,TbMA,1987,554,22,19,41,53.7%,36m
45257,2,Ferrituss,1987,524,19,26,45,42.2%,45m
45257,2,Dschadir,1987,182,7,16,23,30.4%,54m
45257,3,[Wo4R]kisreal,1987,174,6,8,14,42.9%,9m
45257,2,FiRePhaNtOm,1987,159,4,8,12,33.3%,13m
45257,2,Azereuss,1987,86,3,8,11,27.3%,5m
45257,3,Dorota,1987,58,2,1,3,66.7%,34m
45257,3,Shearsky,1987,34,1,2,3,33.3%,35m
45257,2,Kajus,1987,0,1,3,4,25.0%,22m
45257,3,Costin,1987,0,0,2,2,0.0%,55m
45270,2,Janek,1986,1491,79,86,165,47.9%,36m
45270,2,Vaunted,1986,570,23,25,48,47.9%,31m
45270,3,[Wul]EWOLF,1986,437,16,7,23,69.6%,56m
45270,3,Nico,1986,376,15,12,27,55.6%,3m
45270,3,Keto,1986,366,15,15,30,50.0%,17m
45270,3,[3ЕRGTV]Kot,1986,360,13,14,27,48.1%,54m
45270,2,Kostya,1986,232,10,14,24,41.7%,48m
45270,1,Pilote,1986,233,6,11,17,35.3%,32m
45270,3,[LDF]aHacPaTb,1986,118,4,8,12,33.3%,36m
45270,3,dadek,1986,0,3,2,5,60.0%,52m
45270,3,cAnAdA,1986,66,2,2,4,50.0%,45m
45270,1,max,1986,46,2,9,11,18.2%,11m
45270,3,Apox,1986,30,1,1,2,50.0%,12m
45270,2,Esfranken,1986,0,1,7,8,12.5%,56m
45270,3,Andry,1986,0,0,1,1,0.0%,43m
45285,2,Iri,1985,1446,81,86,167,48.5%,20m
45285,2,vladsabou,1985,1527,62,67,129,48.1%,13m
45285,2,[minire]Amarinta,1985,575,30,27,57,52.6%,56m
45285,3,[RMWP]maddfroggie,1985,700,26,26,52,50.0%,57m
45285,2,Dor,1985,490,16,21,37,43.2%,45m
45285,3,MrPerfect,1985,72,3,0,3,100.0%,41m
45285,3,bobby,1985,90,3,4,7,42.9%,36m
45285,3,yrm,1985,0,1,1,2,50.0%,8m
45285,2,[SUD34]Shinoda,1985,30,1,8,9,11.1%,45m
45285,2,[Дошик1]Александр,1985,0,0,1,1,0.0%,50m
45285,2,Kadetik,1985,0,0,5,5,0.0%,4m
45285,3,Duha,1985,0,0,5,5,0.0%,29m
45285,3,KarmaZorg,1985,0,0,6,6,0.0%,48m
45298,3,Aragorn,1984,940,38,37,75,50.7%,54m
45298,3,xzchris,1984,406,36,41,77,46.8%,17m
45298,2,[ANREN]dimontas,1984,549,27,26,53,50.9%,17m
45298,2,Condor,1984,603,20,29,49,40.8%,33m
45298,2,gromoshot,1984,318,13,15,28,46.4%,55m
45298,1,Xordessa,1984,216,5,11,16,31.2%,15m
45298,3,[MVV77]Hero,1984,90,3,4,7,42.9%,17m
45298,2,GreyFox,1984,154,3,4,7,42.9%,6m
45298,2,deathangel,1984,160,3,9,12,25.0%,29m
45298,2,[KSMH]NOOBFRACS,1984,42,2,0,2,100.0%,35m
45298,2,Grozz,1984,46,2,3,5,40.0%,13m
45298,3,Necro,1984,0,2,4,6,33.3%,46m
45298,1,[lOoKer]Max,1984,48,1,2,3,33.3%,5m
45298,3,MenEfrego,1984,0,0,1,1,0.0%,56m
45298,3,Dragonlord,1984,0,0,1,1,0.0%,46m
45298,3,JohnCena,1984,0,0,2,2,0.0%,17m
45298,3,Shaze,1984,0,0,7,7,0.0%,17m
45315,2,Uwe,1983,1476,75,80,155,48.4%,4m
45315,3,BaldEagle,1983,1135,45,45,90,50.0%,45m
45315,2,Chronophage,1983,1138,45,53,98,45.9%,45m
45315,2,Zorander,1983,1054,36,46,82,43.9%,23m
45315,2,[Nastуa]NARIMAN,1983,893,35,38,73,47.9%,38m
45315,3,JEF,1983,948,34,37,71,47.9%,3m
45315,3,Superlupo,1983,692,27,22,49,55.1%,54m
45315,2,SNorthWood,1983,618,22,28,50,44.0%,24m
45315,2,Огрик,1983,486,17,34,51,33.3%,2m
45315,3,FRIENDS,1983,422,14,15,29,48.3%,25m
45315,3,karapuz,1983,315,10,8,18,55.6%,20m
45315,3,Zarathustra,1983,304,10,21,31,32.3%,30m
45315,3,Shark,1983,180,7,8,15,46.7%,57m
45315,3,Nelturion,1983,191,6,12,18,33.3%,31m
45315,3,emperor,1983,118,5,5,10,50.0%,49m
45315,1,bartol,1983,142,4,4,8,50.0%,19m
45315,2,MontevonzoT,1983,30,4,6,10,40.0%,13m
45315,3,TyTaN,1983,30,2,0,2,100.0%,25m
45315,3,AWI,1983,118,2,5,7,28.6%,49m
45315,3,Sharaní,1983,0,1,0,1,100.0%,3m
45315,3,Commander,1983,42,1,4,5,20.0%,55m
45315,2,SweetFantasy,1983,0,1,8,9,11.1%,43m
45337,3,AlvaroNinja,1982,1448,53,56,109,48.6%,5m
45337,2,[NINJ88]Raffmax,1982,832,48,53,101,47.5%,30m
45337,3,Libertarian,1982,1220,43,50,93,46.2%,3m
45337,3,Rhyd,1982,561,22,27,49,44.9%,51m
45337,3,RKJale,1982,344,11,10,21,52.4%,12m
45337,3,jackhammer,1982,162,5,2,7,71.4%,31m
45337,1,falegname,1982,223,5,13,18,27.8%,42m
45337,3,BlackDragon,1982,58,2,3,5,40.0%,30m
45337,2,NUKESHIP,1982,114,2,4,6,33.3%,13m
45337,3,SGT,1982,38,1,2,3,33.3%,5m
45337,3,[PsiX]Nikola,1982,0,0,1,1,0.0%,25m
45337,3,yura,1982,0,0,1,1,0.0%,45m
45337,3,Ciryl,1982,0,0,1,1,0.0%,22m
45337,3,[REC]mimö,1982,0,0,1,1,0.0%,17m
45337,3,MasterLom,1982,0,0,1,1,0.0%,17m
45352,3,siriuss,1981,418,15,15,30,50.0%,44m
45352,2,goatcommand,1981,515,15,26,41,36.6%,51m
45352,3,eftouxis,1981,373,12,14,26,46.2%,46m
45352,1,[LycHSE]WolfRage,1981,344,11,14,25,44.0%,28m
45352,3,kekdambaz,1981,288,10,11,21,47.6%,24m
45352,3,samir,1981,146,6,6,12,50.0%,9m
45352,3,Наташенька,1981,170,5,12,17,29.4%,25m
45352,3,Domenus,1981,145,4,1,5,80.0%,9m
45352,2,kholio,1981,174,3,10,13,23.1%,44m
45352,3,[TedB]RazRazRaz,1981,30,2,0,2,100.0%,20m
45352,3,[GRT1]stieglitz,1981,0,1,0,1,100.0%,22m
45352,3,[Csélör]Zalanoid,1981,0,1,0,1,100.0%,9m
45352,2,Aries,1981,0,1,8,9,11.1%,7m
45352,1,Minchenlord,1981,0,0,1,1,0.0%,48m
45352,2,krask,1981,0,0,4,4,0.0%,37m
45352,3,котик,1981,0,0,4,4,0.0%,22m
45352,2,Paphoved,1981,0,0,4,4,0.0%,1h
45352,3,Bismarck,1981,0,0,6,6,0.0%,38m
45370,2,[Kicx]TheFoeah,1980,1535,68,77,145,46.9%,5m
45370,3,[1NFEC7]SALTARBA,1980,629,59,62,121,48.8%,6m
45370,3,destroyer,1980,534,24,30,54,44.4%,38m
45370,3,titan,1980,298,10,15,25,40.0%,44m
45370,3,Traktortomas,1980,198,7,8,15,46.7%,20m
45370,1,Xyris,1980,206,6,11,17,35.3%,31m
45370,2,PaxLykia,1980,88,4,9,13,30.8%,17m
45370,2,sersergiu,1980,0,1,2,3,33.3%,15m
45370,3,AliG,1980,0,0,1,1,0.0%,20m
45370,3,Mardok,1980,0,0,2,2,0.0%,54m
45370,3,LinkinDust,1980,0,0,2,2,0.0%,1h
45381,3,xxx,1979,1236,99,94,193,51.3%,58m
45381,2,Polus,1979,306,11,21,32,34.4%,44m
45381,3,BadDUCK,1979,60,3,4,7,42.9%,45m
45381,1,darkSpirits,1979,95,2,1,3,66.7%,34m
45381,3,[TLot5b]xVENOMsReace,1979,0,0,6,6,0.0%,58m
45386,3,zorcka,1978,1538,248,258,506,49.0%,45m
45386,3,Kuba,1978,405,15,18,33,45.5%,5m
45386,2,guziu,1978,256,11,9,20,55.0%,8m
45386,2,raggnar,1978,310,11,17,28,39.3%,26m
45386,1,LLIOKEP,1978,184,6,8,14,42.9%,29m
45386,3,alesha,1978,116,5,2,7,71.4%,22m
45386,1,WarLord,1978,142,3,5,8,37.5%,1h
45386,3,злыештаны,1978,90,3,5,8,37.5%,56m
45386,3,Emildquity,1978,0,2,3,5,40.0%,58m
45386,3,Wince,1978,60,2,4,6,33.3%,17m
45386,3,caser,1978,44,2,6,8,25.0%,45m
45386,3,[GdAT]Disaster,1978,0,1,0,1,100.0%,19m
45386,1,[gd0t6]kolunyah,1978,0,1,9,10,10.0%,25m
45386,3,Консул,1978,0,0,1,1,0.0%,30m
45386,3,Muztasch,1978,0,0,5,5,0.0%,50m
45401,2,Bulatik,1977,1573,228,258,486,46.9%,20m
45401,1,Grid,1977,693,46,64,110,41.8%,38m
45401,2,AoD,1977,795,28,38,66,42.4%,19m
45401,3,Schattenwolf,1977,60,3,1,4,75.0%,3m
45401,3,Draculius,1977,0,3,3,6,50.0%,3m
45401,3,[glhf20]ghizi,1977,40,1,2,3,33.3%,19m
45401,3,Крахмал,1977,0,0,2,2,0.0%,17m
45401,2,Hierons,1977,0,0,8,8,0.0%,36m
45409,2,xenon,1976,1396,75,81,156,48.1%,34m
45409,3,bulbazaur,1976,150,5,8,13,38.5%,9m
45409,2,ghhfghdfg,1976,231,5,9,14,35.7%,36m
45409,2,Stranken,1976,94,3,12,15,20.0%,30m
45409,2,[SPAINs]Boa,1976,42,1,2,3,33.3%,44m
45409,3,cinu,1976,30,1,3,4,25.0%,44m
45409,3,mangodehuey,1976,30,1,5,6,16.7%,45m
45409,3,Zelus,1976,0,0,1,1,0.0%,22m
45409,3,[TEJ]Diegales,1976,0,0,3,3,0.0%,24m
45409,3,Apopheos,1976,0,0,3,3,0.0%,23m
45409,3,Альянс,1976,0,0,6,6,0.0%,52m
45420,3,Serban,1975,431,88,109,197,44.7%,52m
45420,3,dumix,1975,519,19,18,37,51.4%,5m
45420,3,AliP,1975,122,5,3,8,62.5%,30m
45420,1,Javangar,1975,235,5,14,19,26.3%,13m
45420,3,WildChessRu,1975,142,4,0,4,100.0%,9m
45420,3,Animissimo,1975,0,2,4,6,33.3%,28m
45420,3,PolkMaksimus,1975,0,1,0,1,100.0%,49m
45420,3,melnick,1975,30,1,2,3,33.3%,44m
45420,1,Florian,1975,0,0,3,3,0.0%,38m
45429,2,nesha,1974,1038,35,53,88,39.8%,43m
45429,3,КалибрИ,1974,541,20,25,45,44.4%,19m
45429,3,Snoopy,1974,309,10,11,21,47.6%,51m
45429,1,KOSTIK,1974,116,4,12,16,25.0%,1h
45429,3,Pandarus,1974,90,3,3,6,50.0%,44m
45429,2,моргенштерн,1974,122,3,5,8,37.5%,25m
45429,3,Ays,1974,0,3,5,8,37.5%,55m
45429,2,WhiteAngel,1974,114,2,9,11,18.2%,4m
45429,3,Nyx,1974,0,1,1,2,50.0%,41m
45438,1,Espiritu,1973,1193,65,73,138,47.1%,1h
45438,2,mitroglou,1973,426,25,40,65,38.5%,19m
45438,3,Karel,1973,504,21,21,42,50.0%,23m
45438,3,Loko,1973,341,14,16,30,46.7%,31m
45438,3,SelimdurTR,1973,293,13,13,26,50.0%,54m
45438,3,[LEZZO]Metamorfosi,1973,194,8,9,17,47.1%,1h
45438,3,[ponte]MENSEM,1973,182,6,10,16,37.5%,48m
45438,2,[TheLA]MrJeanDoe,1973,118,4,11,15,26.7%,56m
45438,3,Kwiil,1973,117,2,5,7,28.6%,56m
45438,2,FAFOI,1973,42,2,9,11,18.2%,31m
45438,2,SgrAStar,1973,0,1,0,1,100.0%,36m
45438,3,Wümme,1973,0,1,4,5,20.0%,23m
45438,2,Xeresa,1973,0,0,4,4,0.0%,22m
45451,2,BrentheGreat,1972,1582,238,270,508,46.9%,2m
45451,1,Brain,1972,1205,101,109,210,48.1%,11m
45451,3,Avatar,1972,1227,60,74,134,44.8%,3m
45451,2,Ivan,1972,1286,46,52,98,46.9%,35m
45451,2,IronMaiden,1972,172,5,7,12,41.7%,13m
45451,3,Часовой,1972,118,4,7,11,36.4%,56m
45451,3,Belkasuper,1972,0,4,8,12,33.3%,56m
45451,3,[KNUS]SnowMan,1972,46,2,3,5,40.0%,6m
45451,2,SilentStorm,1972,0,1,0,1,100.0%,13m
45451,3,jcccc,1972,0,1,2,3,33.3%,27m
45451,2,samie,1972,0,1,7,8,12.5%,5m
45451,3,Tifty,1972,0,0,1,1,0.0%,1h
45451,3,ZACATICK,1972,0,0,1,1,0.0%,23m
45464,2,klepek,1971,1571,132,132,264,50.0%,2m
45464,3,xispado,1971,1156,74,77,151,49.0%,7m
45464,3,eljay,1971,413,19,25,44,43.2%,45m
45464,3,Ghostrider,1971,30,2,3,5,40.0%,9m
45464,3,Ноэль,1971,0,1,0,1,100.0%,3m
45464,2,DstroyerMike,1971,97,1,8,9,11.1%,30m
45464,1,kyiel,1971,0,1,9,10,10.0%,35m
45464,1,eljajuar,1971,30,1,18,19,5.3%,31m
45464,3,BchMika,1971,0,0,1,1,0.0%,1h
45464,3,Tiberius,1971,0,0,1,1,0.0%,37m
45464,3,aldeano,1971,0,0,3,3,0.0%,28m
45464,3,[LoTVPL]Sauron,1971,0,0,6,6,0.0%,2m
45476,3,Boven,1970,511,20,22,42,47.6%,55m
45476,2,Bigoudy,1970,285,10,21,31,32.3%,2m
45476,1,FRIEND,1970,269,9,7,16,56.2%,29m
45476,3,Molder,1970,58,4,11,15,26.7%,52m
45476,2,[EWEN]youtube,1970,74,3,4,7,42.9%,36m
45476,2,[PLKurw]Obahh,1970,162,3,11,14,21.4%,30m
45476,3,[Cubers]Деффка,1970,30,2,5,7,28.6%,45m
45476,3,Istvan,1970,48,1,6,7,14.3%,17m
45476,3,OraetLabora,1970,38,1,7,8,12.5%,55m
45476,2,Miikaaa,1970,0,0,7,7,0.0%,38m
45486,2,John,1969,401,24,37,61,39.3%,49m
45486,3,Rozbebeszacz,1969,297,16,12,28,57.1%,20m
45486,2,ZorDMV,1969,342,15,17,32,46.9%,27m
45486,2,[Derpt]трататашка,1969,349,14,19,33,42.4%,48m
45486,2,[B11G]Navi,1969,118,9,14,23,39.1%,3m
45486,2,littleboy,1969,148,6,10,16,37.5%,48m
45486,3,ShadowBrine,1969,197,5,4,9,55.6%,49m
45486,3,Briz,1969,86,4,4,8,50.0%,35m
45486,3,tin,1969,143,3,1,4,75.0%,1h
45486,1,BLACKlotus,1969,106,3,14,17,17.6%,1h
45486,3,MOFLY,1969,30,2,5,7,28.6%,17m
45486,2,scorpion,1969,40,1,5,6,16.7%,40m
45486,2,moonlight,1969,46,1,7,8,12.5%,34m
45486,2,Thelmas,1969,0,0,4,4,0.0%,37m
45486,2,max,1969,0,0,4,4,0.0%,36m
45486,3,NotAydee,1969,0,0,6,6,0.0%,56m
45502,3,Dobbi,1968,1550,100,108,208,48.1%,1h
45502,1,[ZERG7V]RedBulVodka,1968,589,21,38,59,35.6%,4m
45502,2,Bobby,1968,452,16,25,41,39.0%,58m
45502,3,Petua,1968,294,9,7,16,56.2%,22m
45502,2,Requin,1968,242,8,14,22,36.4%,3m
45502,3,Olko,1968,118,5,6,11,45.5%,40m
45502,2,Métamorph,1968,252,5,12,17,29.4%,39m
45502,3,Grzegorz,1968,58,2,3,5,40.0%,31m
45502,3,soDa,1968,0,2,5,7,28.6%,23m
45502,3,seniorsonic,1968,0,0,1,1,0.0%,1h
45512,3,Parzao,1967,696,25,22,47,53.2%,1h
45512,2,ivan,1967,518,25,23,48,52.1%,8m
45512,2,[Darks1]Cory,1967,474,19,21,40,47.5%,17m
45512,2,Beast,1967,325,13,16,29,44.8%,4m
45512,3,[КРН]Prometheus,1967,324,11,13,24,45.8%,23m
45512,3,GrandMom,1967,185,5,7,12,41.7%,51m
45512,2,DeZeRtiR,1967,0,4,3,7,57.1%,56m
45512,2,Teranid,1967,44,2,3,5,40.0%,39m
45512,2,Kaen,1967,123,2,5,7,28.6%,45m
45512,3,SCLEROS,1967,0,1,0,1,100.0%,9m
45512,3,NoTAiR,1967,0,1,0,1,100.0%,22m
45512,1,Ncjojo,1967,30,1,8,9,11.1%,1h
45512,1,Denis,1967,0,0,1,1,0.0%,52m
45512,3,earthworm,1967,0,0,1,1,0.0%,30m
45512,3,Zkill,1967,0,0,4,4,0.0%,36m
45527,2,DedNoob,1966,817,30,41,71,42.3%,6m
45527,3,Colliejjj,1966,500,17,20,37,45.9%,9m
45527,3,SCANONICA,1966,254,8,4,12,66.7%,28m
45527,3,Русич,1966,264,8,10,18,44.4%,38m
45527,3,kikadas,1966,179,5,7,12,41.7%,25m
45527,3,SzoSziiChef,1966,30,2,1,3,66.7%,36m
45527,2,Georgian,1966,73,2,13,15,13.3%,54m
45527,2,rene,1966,0,1,1,2,50.0%,14m
45527,3,biggiesmalls,1966,0,1,1,2,50.0%,44m
45527,3,zeekazavr,1966,0,0,1,1,0.0%,28m
45527,3,skAt,1966,0,0,3,3,0.0%,1h
45527,3,AndryPowers,1966,0,0,6,6,0.0%,45m
45527,3,Neeb,1966,0,0,6,6,0.0%,45m
45540,2,AlexYar,1965,1055,45,52,97,46.4%,41m
45540,3,Alpha,1965,423,16,18,34,47.1%,56m
45540,2,vladvolk,1965,276,10,14,24,41.7%,11m
45540,2,Mundus,1965,235,8,19,27,29.6%,31m
45540,1,Norkos,1965,191,4,12,16,25.0%,42m
45540,1,Crisstooferr,1965,134,3,10,13,23.1%,24m
45540,3,Derek,1965,30,2,0,2,100.0%,45m
45540,3,BlackDaddy,1965,58,2,3,5,40.0%,45m
45540,3,[TsVg]Bencsy,1965,58,2,6,8,25.0%,43m
45540,2,[Chaven]Vlad,1965,40,1,2,3,33.3%,44m
45540,3,Mockra,1965,0,0,6,6,0.0%,22m
45551,3,starhant,1964,1193,48,52,100,48.0%,56m
45551,3,dnkiller,1964,657,24,22,46,52.2%,20m
45551,3,[20ЛетO]NotGood,1964,170,9,12,21,42.9%,40m
45551,2,Shadowlord,1964,88,5,3,8,62.5%,40m
45551,3,NoUpgrades,1964,144,3,3,6,50.0%,56m
45551,3,King,1964,38,3,5,8,37.5%,55m
45551,1,ZEROIQ,1964,30,2,9,11,18.2%,28m
45551,3,iFaLLeN,1964,0,1,0,1,100.0%,22m
45551,3,[Wn2]starlord,1964,0,0,1,1,0.0%,44m
45551,2,MnschnFressr,1964,0,0,2,2,0.0%,51m
45561,2,Nerys,1963,817,57,67,124,46.0%,36m
45561,2,Kaytec,1963,254,8,17,25,32.0%,13m
45561,2,gauthier,1963,242,7,13,20,35.0%,15m
45561,1,Agazzi,1963,282,7,16,23,30.4%,15m
45561,3,seizetheday,1963,120,5,6,11,45.5%,28m
45561,1,[SPAINs]MegaKartoxa,1963,236,5,10,15,33.3%,45m
45561,1,Peter,1963,118,3,10,13,23.1%,33m
45561,3,LoveBugged,1963,0,2,3,5,40.0%,46m
45561,3,[FOREX]USDCHFsell,1963,0,0,1,1,0.0%,37m
45561,2,melenoide,1963,0,0,1,1,0.0%,40m
45561,3,[Tchoin]Babou,1963,0,0,6,6,0.0%,31m
45572,3,[СКБ]Буран,1962,442,15,23,38,39.5%,57m
45572,3,SANYA,1962,286,10,12,22,45.5%,34m
45572,2,Toby,1962,168,4,10,14,28.6%,40m
45572,3,ninjhigh,1962,60,3,5,8,37.5%,3m
45572,3,[Red33]RedGamer,1962,30,2,2,4,50.0%,48m
45572,3,DanilaS,1962,60,2,8,10,20.0%,44m
45572,3,MAXIMYS,1962,94,1,8,9,11.1%,20m
45572,3,lampa,1962,0,0,1,1,0.0%,49m
45572,3,moutongamind,1962,0,0,1,1,0.0%,46m
45572,3,Игорёшка,1962,0,0,3,3,0.0%,21m
45572,2,Братишка,1962,0,0,7,7,0.0%,2m
45572,3,WladMKD,1962,0,0,7,7,0.0%,17m
45572,3,DagoSK,1962,0,0,7,7,0.0%,45m
45585,2,lachin,1961,1495,101,112,213,47.4%,13m
45585,2,[NINJ88]Ragman,1961,843,32,34,66,48.5%,37m
45585,2,EBITDA,1961,908,32,42,74,43.2%,47m
45585,2,Mads,1961,581,21,25,46,45.7%,2m
45585,3,[СГА]Romberg,1961,167,6,8,14,42.9%,32m
45585,3,ZaUrodinu,1961,30,1,4,5,20.0%,57m
45585,3,Убица,1961,30,1,4,5,20.0%,9m
45585,1,Qubutus,1961,0,1,8,9,11.1%,41m
45585,3,KyRen,1961,0,0,1,1,0.0%,41m
45594,3,Andalit,1960,706,38,48,86,44.2%,23m
45594,3,Клim,1960,754,28,31,59,47.5%,56m
45594,3,Madmanny,1960,552,22,21,43,51.2%,44m
45594,2,Xecautioner,1960,480,21,20,41,51.2%,4m
45594,3,mevzun,1960,586,19,30,49,38.8%,52m
45594,3,Stefano,1960,230,8,10,18,44.4%,9m
45594,3,ERNST,1960,158,5,7,12,41.7%,7m
45594,2,даска,1960,58,3,7,10,30.0%,53m
45594,3,Natoon,1960,58,2,2,4,50.0%,43m
45594,3,[LGNÄRS]Nico,1960,97,1,2,3,33.3%,8m
45594,2,Nykterstein,1960,0,0,3,3,0.0%,36m
45594,2,Matous,1960,0,0,4,4,0.0%,5m
45594,3,SvSt,1960,0,0,5,5,0.0%,58m
45607,2,Boomer,1959,1197,46,57,103,44.7%,1h
45607,3,pop,1959,1169,45,45,90,50.0%,9m
45607,3,skiff,1959,869,29,31,60,48.3%,17m
45607,3,Marat,1959,656,26,17,43,60.5%,3m
45607,3,aud,1959,351,13,11,24,54.2%,17m
45607,3,Kuhn,1959,371,12,20,32,37.5%,37m
45607,2,Tibar,1959,304,10,16,26,38.5%,44m
45607,2,[АГР]SHALUN,1959,148,4,5,9,44.4%,10m
45607,1,[ANREN]про,1959,0,1,0,1,100.0%,30m
45607,3,FuZZiX,1959,30,1,2,3,33.3%,25m
45607,3,amntdm,1959,0,1,2,3,33.3%,11m
45607,1,Piedro,1959,0,1,10,11,9.1%,22m
45607,3,inpos,1959,0,0,3,3,0.0%,5m
45607,3,LiterallyOKB,1959,0,0,5,5,0.0%,36m
45607,3,Ragnar,1959,0,0,6,6,0.0%,52m
45607,2,Andrej,1959,0,0,7,7,0.0%,40m
45607,2,DerekS,1959,0,0,9,9,0.0%,34m
45624,3,Mantot,1958,1115,71,86,157,45.2%,24m
45624,2,Aeon,1958,1408,53,64,117,45.3%,13m
45624,2,[RTGG]Awake,1958,749,27,31,58,46.6%,5m
45624,1,DefMero,1958,541,17,24,41,41.5%,42m
45624,3,[XGRX]Hildre,1958,0,0,2,2,0.0%,12m
45624,2,Rama,1958,0,0,3,3,0.0%,38m
45624,3,Shadowamper,1958,0,0,7,7,0.0%,48m
45631,2,Reinhart,1957,1563,435,518,953,45.6%,54m
45631,2,TAT,1957,1531,136,144,280,48.6%,13m
45631,2,johnny,1957,794,126,131,257,49.0%,11m
45631,2,AndrewIronic,1957,1037,72,86,158,45.6%,47m
45631,2,LivingThing,1957,539,21,38,59,35.6%,1h
45631,2,razl,1957,257,6,12,18,33.3%,50m
45631,2,Triatonix,1957,184,5,11,16,31.2%,39m
45631,2,Kevin,1957,84,2,2,4,50.0%,29m
45631,3,TROINYAK,1957,0,2,4,6,33.3%,56m
45631,3,danielowski,1957,97,1,3,4,25.0%,11m
45631,3,[Foki]НЕозабоченый,1957,0,0,1,1,0.0%,25m
45631,2,IslandGuy,1957,0,0,7,7,0.0%,56m
45643,1,Eliran,1956,1520,149,160,309,48.2%,24m
45643,2,[45IQ]DRED,1956,1426,83,94,177,46.9%,45m
45643,2,IIIIIIIII,1956,328,12,21,33,36.4%,56m
45643,3,Keira,1956,200,11,9,20,55.0%,30m
45643,2,VTS,1956,330,11,16,27,40.7%,9m
45643,3,KorowaNaHaip,1956,230,9,8,17,52.9%,12m
45643,3,SonicRim,1956,200,7,8,15,46.7%,5m
45643,3,servinaty,1956,144,6,5,11,54.5%,41m
45643,3,artanis,1956,121,2,2,4,50.0%,56m
45643,2,JimKnopf,1956,111,2,8,10,20.0%,54m
45643,1,Harim,1956,48,2,11,13,15.4%,32m
45643,3,EGORER,1956,90,1,1,2,50.0%,55m
45643,3,Rokko,1956,0,0,1,1,0.0%,1h
45643,3,SweBlondie,1956,0,0,5,5,0.0%,22m
45657,2,Gids,1955,1548,121,130,251,48.2%,26m
45657,2,[II3II]Dragleigh,1955,1172,59,62,121,48.8%,17m
45657,3,amarohk,1955,1113,45,46,91,49.5%,48m
45657,2,vdg,1955,707,26,28,54,48.1%,49m
45657,2,[GOHELL]Anihilyator,1955,188,8,9,17,47.1%,58m
45657,3,BlackWolf,1955,176,6,7,13,46.2%,54m
45657,3,zeratul,1955,58,2,7,9,22.2%,38m
45657,3,Azel,1955,0,1,0,1,100.0%,18m
45657,3,[I12DR]FilypW,1955,0,0,1,1,0.0%,20m
45657,2,tmrg,1955,0,0,1,1,0.0%,4m
45657,3,elkware,1955,0,0,1,1,0.0%,17m
45668,3,CleverAlexAU,1954,931,33,43,76,43.4%,28m
45668,3,Ottoman,1954,762,27,31,58,46.6%,45m
45668,1,Max,1954,36,5,10,15,33.3%,43m
45668,2,Neo,1954,134,5,11,16,31.2%,14m
45668,3,MAJORNICO,1954,167,5,12,17,29.4%,45m
45668,3,[TraNah]Dionysus,1954,88,4,5,9,44.4%,53m
45668,2,Lam,1954,62,3,9,12,25.0%,13m
45668,3,baja,1954,30,1,6,7,14.3%,19m
45676,3,Alius,1953,1363,71,74,145,49.0%,17m
45676,1,[ThTw]Honigmelone,1953,273,7,17,24,29.2%,27m
45676,2,Kildedal,1953,107,5,5,10,50.0%,16m
45676,1,jeanjean,1953,193,4,13,17,23.5%,15m
45676,3,NotMaru,1953,30,3,3,6,50.0%,41m
45676,3,Megatron,1953,88,3,7,10,30.0%,41m
45676,2,bogdan,1953,93,2,5,7,28.6%,40m
45676,3,Kardon,1953,0,1,3,4,25.0%,37m
45676,3,Hofbolzer,1953,48,1,7,8,12.5%,2m
45676,3,KaFo,1953,0,0,5,5,0.0%,38m
45686,3,[kinkel]Nosticus,1952,1050,40,45,85,47.1%,44m
45686,3,Ozooo,1952,923,37,39,76,48.7%,51m
45686,3,[svinik]ArmoredRaven,1952,753,28,30,58,48.3%,17m
45686,3,KoTeu,1952,348,12,8,20,60.0%,9m
45686,3,RealLife,1952,0,3,3,6,50.0%,45m
45686,3,ColMARKO,1952,163,3,10,13,23.1%,58m
45686,3,DaniilKun,1952,30,2,1,3,66.7%,45m
45686,3,shadwell,1952,0,1,0,1,100.0%,37m
45686,3,Danger,1952,0,1,5,6,16.7%,11m
45686,2,Alexandrit,1952,0,1,7,8,12.5%,1h
45686,3,LikWid,1952,0,0,1,1,0.0%,37m
45686,3,Smirnayga,1952,0,0,1,1,0.0%,22m
45686,2,Bantor,1952,0,0,3,3,0.0%,13m
45686,3,ionas,1952,0,0,3,3,0.0%,18m
45700,2,desvlt,1951,1366,45,62,107,42.1%,1h
45700,2,smokrasyzerg,1951,600,26,33,59,44.1%,21m
45700,3,Hammer,1951,545,17,29,46,37.0%,45m
45700,3,lightdark,1951,242,12,10,22,54.5%,20m
45700,3,[kmbch]Kirwa,1951,105,7,20,27,25.9%,5m
45700,2,crocdecroc,1951,169,5,8,13,38.5%,56m
45700,3,Rych,1951,114,4,5,9,44.4%,20m
45700,3,Rostovskii,1951,122,4,10,14,28.6%,45m
45700,2,siegodalas,1951,128,4,15,19,21.1%,31m
45700,2,Domon,1951,0,1,6,7,14.3%,31m
45700,2,MightyWizard,1951,42,1,9,10,10.0%,6m
45700,2,MoonLight,1951,0,0,8,8,0.0%,58m
45712,3,Mkive,1950,1117,53,59,112,47.3%,8m
45712,3,ArminiaBI,1950,433,15,11,26,57.7%,6m
45712,3,JinX,1950,327,10,10,20,50.0%,45m
45712,3,Zephrenic,1950,198,7,5,12,58.3%,30m
45712,1,Ray,1950,283,6,17,23,26.1%,27m
45712,3,gulan,1950,120,3,0,3,100.0%,25m
45712,2,staspro,1950,88,2,6,8,25.0%,5m
45712,1,xega,1950,30,2,9,11,18.2%,3m
45712,1,DingoPower,1950,0,1,9,10,10.0%,40m
45712,2,Reycz,1950,0,1,11,12,8.3%,13m
45712,3,Afran,1950,0,0,1,1,0.0%,5m
45712,3,Haivis,1950,0,0,5,5,0.0%,27m
45724,2,Thundersky,1949,1349,65,74,139,46.8%,49m
45724,2,[LOGS]RynoWNell,1949,1339,53,65,118,44.9%,56m
45724,3,TheVibe,1949,390,13,18,31,41.9%,30m
45724,3,[OmDi]nemesys,1949,300,10,18,28,35.7%,6m
45724,2,Val,1949,294,10,23,33,30.3%,51m
45724,3,Poseidon,1949,252,7,18,25,28.0%,3m
45724,3,Lud,1949,174,5,7,12,41.7%,32m
45724,3,[DFYJTU]ALEXSSS,1949,201,5,12,17,29.4%,17m
45724,3,ELPATOPATOSO,1949,30,4,5,9,44.4%,17m
45724,3,kufargery,1949,152,4,7,11,36.4%,7m
45724,3,Halion,1949,0,3,2,5,60.0%,48m
45724,3,[Harley]bezon,1949,0,1,1,2,50.0%,57m
45724,3,артём,1949,30,1,2,3,33.3%,54m
45724,3,DaNaPetr,1949,0,0,1,1,0.0%,19m
45738,2,RemyLacoste,1948,1398,229,265,494,46.4%,46m
45738,3,deodio,1948,1012,43,40,83,51.8%,31m
45738,2,Virenkiller,1948,1091,42,45,87,48.3%,44m
45738,3,Toffee,1948,453,22,20,42,52.4%,6m
45738,3,LUKE,1948,562,20,15,35,57.1%,37m
45738,2,lxxBENDERxxl,1948,359,15,21,36,41.7%,9m
45738,1,[OmDi]ADRYANADY,1948,445,14,31,45,31.1%,17m
45738,3,swifty,1948,361,13,23,36,36.1%,37m
45738,3,Ivor,1948,196,7,10,17,41.2%,32m
45738,2,fernando,1948,266,7,19,26,26.9%,8m
45738,3,[WCGT]Daniel,1948,188,5,3,8,62.5%,9m
45738,3,ZIDIZO,1948,0,4,1,5,80.0%,5m
45738,2,multpit,1948,128,3,9,12,25.0%,4m
45738,3,MrMaximus,1948,30,2,0,2,100.0%,56m
45738,3,galaxide,1948,0,1,0,1,100.0%,19m
45738,2,NooBot,1948,0,1,7,8,12.5%,14m
45738,3,SEba,1948,0,0,1,1,0.0%,57m
45738,3,MisterDark,1948,0,0,1,1,0.0%,22m
45756,1,WOLVARINE,1947,648,23,30,53,43.4%,53m
45756,2,Beemcee,1947,294,14,15,29,48.3%,13m
45756,3,DomSniperX,1947,366,13,22,35,37.1%,23m
45756,3,lol,1947,341,11,13,24,45.8%,45m
45756,1,Burabay,1947,192,8,13,21,38.1%,21m
45756,3,sparki,1947,192,6,6,12,50.0%,22m
45756,3,zoorii,1947,168,5,2,7,71.4%,6m
45756,3,[прас]Dyus,1947,152,5,8,13,38.5%,30m
45756,3,жиролет,1947,30,2,1,3,66.7%,37m
45756,3,Chrepechrep,1947,32,2,6,8,25.0%,45m
45756,1,Bradega,1947,48,2,10,12,16.7%,45m
45756,3,Cronos,1947,0,1,0,1,100.0%,22m
45756,3,iMBA,1947,97,1,5,6,16.7%,26m
45756,2,OrcWithSmg,1947,0,1,9,10,10.0%,16m
45770,2,HarryB,1946,1465,129,137,266,48.5%,4m
45770,2,raf,1946,1269,87,93,180,48.3%,19m
45770,3,tao,1946,638,28,22,50,56.0%,49m
45770,1,Vukan,1946,752,27,38,65,41.5%,5m
45770,2,SERJANT,1946,374,17,30,47,36.2%,6m
45770,3,YtKa,1946,265,9,7,16,56.2%,11m
45770,2,neves,1946,257,6,8,14,42.9%,16m
45770,2,LtCmdrData,1946,104,4,17,21,19.0%,35m
45770,3,Feketevölgy,1946,64,2,5,7,28.6%,30m
45779,3,Masalu,1945,1528,101,110,211,47.9%,12m
45779,3,RedNinja,1945,317,12,11,23,52.2%,17m
45779,2,[137228]piopeleSS,1945,327,10,17,27,37.0%,39m
45779,1,DrAkula,1945,211,9,12,21,42.9%,44m
45779,3,Sergey,1945,223,8,12,20,40.0%,20m
45779,1,Sztandar,1945,209,8,13,21,38.1%,42m
45779,3,Archavon,1945,152,7,16,23,30.4%,14m
45779,1,[1NO2]molotov,1945,214,7,19,26,26.9%,41m
45779,2,Arman,1945,193,6,10,16,37.5%,45m
45779,3,[1BR1]MORFrus,1945,114,4,5,9,44.4%,49m
45779,3,sootruebyul,1945,0,1,0,1,100.0%,38m
45779,3,Maks,1945,0,1,0,1,100.0%,21m
45779,3,kimo,1945,30,1,5,6,16.7%,1h
45779,3,TheTestedOne,1945,30,1,6,7,14.3%,46m
45779,3,Knotsgek,1945,0,0,1,1,0.0%,46m
45794,2,THORAX,1944,1340,56,75,131,42.7%,6m
45794,3,GTO,1944,314,13,14,27,48.1%,46m
45794,2,enrique,1944,0,3,5,8,37.5%,48m
45794,3,Unknown,1944,30,2,14,16,12.5%,56m
45794,3,SLAKER,1944,30,1,1,2,50.0%,45m
45794,3,Ozark,1944,97,1,2,3,33.3%,23m
45794,3,FavSon,1944,38,1,6,7,14.3%,46m
45794,3,Cedric,1944,0,0,1,1,0.0%,57m
45794,3,DezGar,1944,0,0,1,1,0.0%,49m
45794,3,нагибатор,1944,0,0,2,2,0.0%,36m
45804,3,Smekla,1943,669,26,25,51,51.0%,45m
45804,3,Glivi,1943,292,10,18,28,35.7%,5m
45804,3,kawazx,1943,242,8,10,18,44.4%,8m
45804,3,Filip,1943,208,7,9,16,43.8%,38m
45804,3,Tut,1943,183,5,7,12,41.7%,45m
45804,2,xbrf,1943,134,4,7,11,36.4%,5m
45804,2,linvincible,1943,86,3,12,15,20.0%,13m
45804,3,HellaShreda,1943,0,1,6,7,14.3%,25m
45804,2,Kettle,1943,0,1,9,10,10.0%,54m
45804,3,DEMOLITION,1943,0,0,2,2,0.0%,58m
45804,3,Starus,1943,0,0,2,2,0.0%,57m
45804,2,Bibe,1943,0,0,8,8,0.0%,20m
45816,3,IlikeLoli,1942,1413,62,67,129,48.1%,57m
45816,3,DredRed,1942,1233,45,53,98,45.9%,53m
45816,3,[OLIM]ATA,1942,488,19,21,40,47.5%,38m
45816,3,alka,1942,432,16,17,33,48.5%,9m
45816,3,BurebistaEu,1942,286,10,5,15,66.7%,24m
45816,1,Keyd,1942,96,6,8,14,42.9%,28m
45816,2,MaliMarko,1942,245,5,14,19,26.3%,51m
45816,3,Vicb,1942,144,4,2,6,66.7%,48m
45816,3,[Саваны]ilor,1942,123,3,5,8,37.5%,57m
45816,2,GDI,1942,113,2,5,7,28.6%,25m
45816,2,врсмло,1942,0,1,0,1,100.0%,13m
45816,3,Legion,1942,30,1,3,4,25.0%,34m
45816,2,BATOTE,1942,0,0,7,7,0.0%,36m
45829,2,marina,1941,1542,216,228,444,48.6%,58m
45829,2,spatoulas,1941,556,22,28,50,44.0%,2m
45829,3,Tomawak,1941,498,18,17,35,51.4%,12m
45829,3,TerenceHill,1941,252,9,11,20,45.0%,17m
45829,1,Synchi,1941,245,7,18,25,28.0%,46m
45829,2,Deeathwing,1941,122,4,12,16,25.0%,38m
45829,1,sander,1941,92,3,11,14,21.4%,13m
45829,2,ЦонкоКъсмета,1941,93,1,7,8,12.5%,33m
45829,1,ghost,1941,0,1,9,10,10.0%,1h
45829,3,superbtr,1941,0,0,1,1,0.0%,46m
45839,1,Luxun,1940,968,66,79,145,45.5%,35m
45839,3,Xarkov,1940,146,6,5,11,54.5%,21m
45839,3,arad,1940,163,5,6,11,45.5%,3m
45839,2,ColorböY,1940,180,5,13,18,27.8%,1h
45839,2,Ruskad,1940,30,3,7,10,30.0%,40m
45839,3,Gwenael,1940,0,1,0,1,100.0%,57m
45839,3,INCASE,1940,0,1,1,2,50.0%,34m
45839,3,Лисколиск,1940,0,0,6,6,0.0%,48m
45847,2,MarineX,1939,845,30,35,65,46.2%,47m
45847,3,ЕСКАДРОНБГ,1939,763,27,28,55,49.1%,1h
45847,2,pabl,1939,680,25,61,86,29.1%,51m
45847,3,[PECAN]SanfroixX,1939,275,11,18,29,37.9%,20m
45847,3,[MODRR]Botikario,1939,150,6,7,13,46.2%,9m
45847,3,Rosomak,1939,188,5,3,8,62.5%,23m
45847,3,PvpAxe,1939,32,4,3,7,57.1%,18m
45847,3,[Stunt]Sonic,1939,60,2,3,5,40.0%,1h
45847,1,Joker,1939,0,1,9,10,10.0%,24m
45847,2,EmperorEzio,1939,0,0,1,1,0.0%,51m
45847,2,Brainor,1939,0,0,9,9,0.0%,6m
45858,2,Ledus,1938,1441,105,114,219,47.9%,33m
45858,3,Sapman,1938,1305,63,82,145,43.4%,42m
45858,3,Бориска,1938,595,25,28,53,47.2%,21m
45858,2,joy,1938,536,19,24,43,44.2%,41m
45858,3,Crazy,1938,120,5,3,8,62.5%,23m
45858,2,keelr,1938,94,3,12,15,20.0%,4m
45858,1,[Энтаро]Alzadar,1938,0,0,1,1,0.0%,24m
45858,3,russich,1938,0,0,1,1,0.0%,45m
45858,2,sugardaddy,1938,0,0,2,2,0.0%,14m
45858,3,Washborn,1938,0,0,5,5,0.0%,46m
45868,1,Neverhood,1937,580,19,31,50,38.0%,43m
45868,3,WildFire,1937,274,12,16,28,42.9%,22m
45868,3,UsadaPekora,1937,348,12,19,31,38.7%,49m
45868,1,tournevis,1937,268,10,14,24,41.7%,5m
45868,3,Tiaaa,1937,200,10,15,25,40.0%,9m
45868,2,LEOPARDI,1937,200,8,16,24,33.3%,13m
45868,3,Destructor,1937,68,5,15,20,25.0%,9m
45868,3,DarkReaper,1937,120,3,0,3,100.0%,34m
45868,3,manson,1937,30,3,5,8,37.5%,30m
45868,2,chumbo,1937,84,2,10,12,16.7%,25m
45868,3,Dmitriy,1937,40,1,8,9,11.1%,36m
45868,3,CelMaiBun,1937,0,0,1,1,0.0%,57m
45868,2,ROBOSTIOP,1937,0,0,14,14,0.0%,54m
45881,3,alexvey,1936,593,23,23,46,50.0%,49m
45881,3,Skander,1936,479,19,16,35,54.3%,57m
45881,2,RUSMarkuel,1936,334,12,20,32,37.5%,26m
45881,1,Martin,1936,352,11,21,32,34.4%,47m
45881,2,gesha,1936,58,6,11,17,35.3%,25m
45881,3,[ABDI]Sacha,1936,120,5,7,12,41.7%,53m
45881,3,Electryke,1936,0,3,4,7,42.9%,3m
45881,2,MightyOwl,1936,0,3,5,8,37.5%,43m
45881,3,[prts69]clumsyToss,1936,121,2,3,5,40.0%,57m
45881,3,baruuk,1936,0,2,3,5,40.0%,44m
45881,3,froxz,1936,96,2,4,6,33.3%,9m
45881,1,[Rusia]Повелитель,1936,42,2,10,12,16.7%,3m
45881,3,Flip,1936,30,1,3,4,25.0%,35m
45881,3,Giumbix,1936,30,1,5,6,16.7%,34m
45881,3,MAXIME,1936,0,0,1,1,0.0%,3m
45881,2,Zengar,1936,0,0,7,7,0.0%,22m
45897,3,lesha,1935,1552,89,99,188,47.3%,23m
45897,3,[Pasxa]РеДиС,1935,442,17,16,33,51.5%,30m
45897,3,SZNT,1935,202,8,10,18,44.4%,8m
45897,3,MagicTurtle,1935,144,6,6,12,50.0%,49m
45897,3,CaptainSlice,1935,157,5,7,12,41.7%,51m
45897,1,Hörnchen,1935,85,3,4,7,42.9%,11m
45897,2,Smoki,1935,149,3,10,13,23.1%,37m
45897,3,NITRY,1935,40,2,7,9,22.2%,45m
45897,2,Waldo,1935,88,2,8,10,20.0%,36m
45897,1,tom,1935,30,2,11,13,15.4%,25m
45897,3,[ECH0ES]Supercomete,1935,0,1,5,6,16.7%,37m
45897,3,tomaskhan,1935,0,1,5,6,16.7%,30m
45897,1,kostas,1935,0,1,10,11,9.1%,31m
45897,2,OPTOBOT,1935,0,0,5,5,0.0%,43m
45897,3,csucsu,1935,0,0,6,6,0.0%,19m
45912,2,[NOOBpl]RadYkaLnYxPL,1934,1567,156,180,336,46.4%,10m
45912,3,Milckyway,1934,1600,95,107,202,47.0%,36m
45912,2,Leonidas,1934,1485,65,83,148,43.9%,41m
45912,3,Aaronator,1934,902,54,65,119,45.4%,55m
45912,3,[II3II]Boniek,1934,522,19,19,38,50.0%,45m
45912,2,FairyFighter,1934,295,18,21,39,46.2%,30m
45912,3,Lysia,1934,256,7,7,14,50.0%,53m
45912,3,Grinni,1934,167,6,9,15,40.0%,46m
45912,3,[V2K]ERNIE,1934,170,4,4,8,50.0%,23m
45912,3,mistermac,1934,147,3,3,6,50.0%,57m
45912,3,[DaFF]Cstar,1934,96,2,0,2,100.0%,38m
45912,3,Killerloli,1934,0,2,4,6,33.3%,48m
45912,2,EffecT,1934,0,1,0,1,100.0%,6m
45912,2,NoSkill,1934,0,0,1,1,0.0%,37m
45912,3,Vadim,1934,0,0,1,1,0.0%,55m
45912,3,HAIN,1934,0,0,7,7,0.0%,21m
45928,2,HellHappel,1933,626,20,31,51,39.2%,31m
45928,3,Santa,1933,522,19,26,45,42.2%,44m
45928,3,Neptune,1933,341,14,16,30,46.7%,12m
45928,2,kooler,1933,259,10,14,24,41.7%,38m
45928,3,Tochka,1933,149,4,3,7,57.1%,22m
45928,3,ВУВ,1933,121,3,4,7,42.9%,12m
45928,2,[PSTORM]llllllllllll,1933,38,2,3,5,40.0%,2m
45928,3,Adaś,1933,64,2,8,10,20.0%,50m
45928,2,Zeratul,1933,0,0,5,5,0.0%,51m
45937,3,RBHPluton,1932,547,19,18,37,51.4%,28m
45937,3,Faethonas,1932,480,17,19,36,47.2%,44m
45937,2,neondragon,1932,339,12,20,32,37.5%,19m
45937,2,[173]Roman,1932,266,9,15,24,37.5%,38m
45937,3,MiX,1932,169,6,3,9,66.7%,21m
45937,3,ciofu,1932,0,1,4,5,20.0%,40m
45937,3,IIIIIIIIIIII,1932,0,0,1,1,0.0%,57m
45937,3,lutinebaba,1932,0,0,1,1,0.0%,49m
45937,3,Krechet,1932,0,0,2,2,0.0%,2m
45937,3,Zerus,1932,0,0,2,2,0.0%,36m
45937,2,Cherepundel,1932,73,0,3,3,0.0%,37m
45948,2,[mfxed]Bimbały,1931,1371,280,316,596,47.0%,56m
45948,3,mapi,1931,178,6,11,17,35.3%,58m
45948,3,IRIARTEI,1931,188,6,13,19,31.6%,5m
45948,2,cTepBoчКа,1931,98,4,10,14,28.6%,38m
45948,3,todogratis,1931,30,2,1,3,66.7%,1h
45948,1,Серёжа,1931,0,1,1,2,50.0%,24m
45954,3,Tombstone,1930,316,11,12,23,47.8%,56m
45954,3,allen,1930,132,5,5,10,50.0%,41m
45954,3,Spillouz,1930,30,2,4,6,33.3%,23m
45954,1,damdamgor,1930,30,2,7,9,22.2%,13m
45954,3,steve,1930,0,1,0,1,100.0%,57m
45954,3,TudorBot,1930,96,1,1,2,50.0%,55m
45954,2,UchihaItachi,1930,0,1,2,3,33.3%,35m
45954,3,[StSta]SaGiMan,1930,0,1,5,6,16.7%,44m
45954,3,ArchadiusPro,1930,0,0,1,1,0.0%,22m
45954,3,Frol,1930,0,0,2,2,0.0%,23m
45964,3,HERVE,1929,856,31,39,70,44.3%,9m
45964,3,Terranium,1929,395,17,12,29,58.6%,56m
45964,3,budiak,1929,400,14,22,36,38.9%,1h
45964,3,BAU,1929,245,7,16,23,30.4%,49m
45964,3,kolyan,1929,179,5,11,16,31.2%,1h
45964,1,[TAW]SabaknuGara,1929,142,4,13,17,23.5%,3m
45964,3,ShadowSev,1929,62,3,4,7,42.9%,30m
45964,3,hulk,1929,0,1,3,4,25.0%,41m
45964,3,espeon,1929,0,0,1,1,0.0%,8m
45964,3,BlackDevill,1929,0,0,5,5,0.0%,6m
45974,1,[НОД17]Sergey,1928,1570,244,275,519,47.0%,3m
45974,1,ТурокМаклок,1928,1579,207,237,444,46.6%,47m
45974,3,lightduke,1928,874,29,33,62,46.8%,37m
45974,3,Florin,1928,495,18,21,39,46.2%,1h
45974,3,DariusCross,1928,436,16,24,40,40.0%,8m
45974,3,jojo,1928,394,13,12,25,52.0%,12m
45974,3,Cezar,1928,300,10,14,24,41.7%,9m
45974,3,еммДрасте,1928,267,8,7,15,53.3%,45m
45974,3,oGpDøøm,1928,128,4,12,16,25.0%,1h
45974,3,mat,1928,88,3,7,10,30.0%,17m
45974,3,Tekens,1928,30,2,2,4,50.0%,22m
45974,1,jophielmark,1928,73,2,12,14,14.3%,5m
45974,1,[KTŻCN]Ynmiz,1928,0,1,3,4,25.0%,16m
45987,3,Lion,1927,949,36,39,75,48.0%,31m
45987,2,Armageddon,1927,704,24,30,54,44.4%,5m
45987,3,DarkAngel,1927,554,20,23,43,46.5%,3m
45987,3,alma,1927,355,11,14,25,44.0%,5m
45987,3,Warmecanic,1927,260,9,4,13,69.2%,1h
45987,3,FukamachiSho,1927,110,4,5,9,44.4%,55m
45987,2,Warrior,1927,168,4,11,15,26.7%,34m
45987,2,ALTEZ,1927,48,2,1,3,66.7%,44m
45987,2,matrax,1927,46,2,4,6,33.3%,43m
45987,3,Cillij,1927,0,2,5,7,28.6%,2m
45987,3,[MKBO]BeBOP,1927,0,1,0,1,100.0%,51m
45987,3,AkairaAki,1927,0,0,3,3,0.0%,36m
45987,3,CMMT,1927,0,0,5,5,0.0%,10m
46000,2,Samokat,1926,1356,51,58,109,46.8%,20m
46000,3,Valléria,1926,622,27,11,38,71.1%,31m
46000,3,Emperor,1926,398,18,28,46,39.1%,38m
46000,3,Murri,1926,363,15,14,29,51.7%,58m
46000,3,LillyYen,1926,304,10,7,17,58.8%,37m
46000,3,Gamerlolly,1926,253,8,12,20,40.0%,50m
46000,1,next,1926,246,7,15,22,31.8%,31m
46000,3,Black,1926,58,3,2,5,60.0%,29m
46000,3,RamsesHH,1926,92,3,11,14,21.4%,32m
46000,3,[1NFEC7]MeHigh,1926,98,3,16,19,15.8%,12m
46000,3,RAMSIIS,1926,60,2,8,10,20.0%,51m
46000,2,rati,1926,0,0,7,7,0.0%,19m
46012,3,Nosferatu,1925,894,33,46,79,41.8%,48m
46012,2,Fitnesspuff,1925,734,32,30,62,51.6%,13m
46012,1,xXmhtsosXx,1925,148,7,7,14,50.0%,18m
46012,2,Matvey,1925,128,4,8,12,33.3%,55m
46012,2,JSTooth,1925,172,4,10,14,28.6%,13m
46012,1,wintik,1925,30,4,21,25,16.0%,24m
46012,2,rreriamani,1925,0,1,7,8,12.5%,40m
46012,3,mars,1925,0,0,1,1,0.0%,3m
46012,3,Jab,1925,0,0,1,1,0.0%,7m
46012,3,TravelMate,1925,0,0,3,3,0.0%,55m
46022,2,[BSG19]tiziano,1924,1542,146,165,311,46.9%,31m
46022,2,Goga,1924,1542,106,114,220,48.2%,50m
46022,3,Palkie,1924,237,10,6,16,62.5%,37m
46022,2,Alister,1924,262,7,9,16,43.8%,25m
46022,3,Tobi,1924,36,3,5,8,37.5%,55m
46027,3,[ELKTRA]Tomba,1923,611,55,63,118,46.6%,5m
46027,3,GhostDog,1923,432,14,14,28,50.0%,50m
46027,3,Lodrop,1923,368,12,11,23,52.2%,31m
46027,3,GhostDog,1923,268,9,7,16,56.2%,50m
46027,3,rInaS,1923,247,7,8,15,46.7%,44m
46027,3,Melyntje,1923,96,1,1,2,50.0%,22m
46027,3,Mojo,1923,0,1,5,6,16.7%,30m
46034,3,WilliWinzig,1922,1561,99,110,209,47.4%,7m
46034,3,Fergus,1922,667,25,36,61,41.0%,46m
46034,3,BlueTech,1922,143,3,2,5,60.0%,5m
46034,3,Dark,1922,0,3,4,7,42.9%,56m
46034,3,Snakepit,1922,60,2,3,5,40.0%,42m
46034,3,martyfame,1922,0,0,2,2,0.0%,35m
46034,3,Chetovm,1922,0,0,4,4,0.0%,24m
46034,3,[AniME6]ToBi,1922,0,0,4,4,0.0%,3m
46034,3,Dor,1922,0,0,6,6,0.0%,53m
46043,3,albert,1921,506,19,23,42,45.2%,46m
46043,3,tartarin,1921,295,10,11,21,47.6%,28m
46043,1,BronzeMaster,1921,308,10,26,36,27.8%,58m
46043,3,Wooshoo,1921,206,6,15,21,28.6%,13m
46043,2,[TBAS]Rataraula,1921,182,6,18,24,25.0%,42m
46043,3,Krolist,1921,60,3,4,7,42.9%,5m
46043,3,Miau,1921,0,2,3,5,40.0%,55m
46043,3,Redshadow,1921,29,2,4,6,33.3%,50m
46043,3,дихака,1921,130,2,6,8,25.0%,36m
46043,2,lvov,1921,0,0,1,1,0.0%,38m
46043,2,WingedWillow,1921,0,0,1,1,0.0%,11m
46054,2,[OmDi]Romul,1920,1484,59,60,119,49.6%,14m
46054,1,byloo,1920,356,13,21,34,38.2%,40m
46054,3,ANCHAN,1920,270,11,9,20,55.0%,22m
46054,3,Endrju,1920,337,11,21,32,34.4%,25m
46054,1,Gritomos,1920,182,4,3,7,57.1%,43m
46054,3,[KoxySC]Nightmere,1920,0,2,3,5,40.0%,31m
46054,3,StarLord,1920,62,2,7,9,22.2%,46m
46054,2,[UlgCy]tomKET,1920,88,2,11,13,15.4%,11m
46054,1,Deatpool,1920,46,1,1,2,50.0%,34m
46054,3,IIIIIIIIIIII,1920,30,1,3,4,25.0%,55m
46064,3,buba,1919,1448,189,210,399,47.4%,6m
46064,3,vincent,1919,1492,70,87,157,44.6%,42m
46064,3,Kohre,1919,380,14,15,29,48.3%,34m
46064,3,Krasher,1919,388,12,27,39,30.8%,6m
46064,3,homelessjim,1919,30,2,4,6,33.3%,48m
46064,3,Shadow,1919,0,2,4,6,33.3%,19m
46064,1,Chiefgogo,1919,73,0,2,2,0.0%,48m
46064,3,illyane,1919,0,0,2,2,0.0%,14m
46064,2,Zhigilevsk,1919,0,0,3,3,0.0%,35m
46073,3,Lemillion,1918,934,48,57,105,45.7%,9m
46073,3,basiorro,1918,743,30,39,69,43.5%,8m
46073,3,lamor,1918,627,22,32,54,40.7%,37m
46073,1,Snapshot,1918,323,7,17,24,29.2%,48m
46073,3,[LMBD]Aponthez,1918,60,5,5,10,50.0%,45m
46073,3,tomi,1918,33,5,8,13,38.5%,41m
46073,2,MrVince,1918,152,5,13,18,27.8%,6m
46073,1,Sparkle,1918,186,3,1,4,75.0%,16m
46073,3,publıcenemy,1918,30,3,5,8,37.5%,34m
46073,2,trelled,1918,0,1,1,2,50.0%,54m
46083,2,RoneDogg,1917,1354,86,109,195,44.1%,1h
46083,1,protas,1917,115,3,1,4,75.0%,15m
46083,3,TIME,1917,46,2,3,5,40.0%,53m
46083,3,RoiHeenok,1917,60,2,3,5,40.0%,3m
46083,3,proxyd,1917,96,1,2,3,33.3%,22m
46083,2,[GHTRV]Hunterling,1917,0,1,9,10,10.0%,7m
46083,2,dani,1917,0,0,1,1,0.0%,36m
46090,3,liph,1916,763,38,25,63,60.3%,11m
46090,2,MrDen,1916,598,24,29,53,45.3%,12m
46090,3,Analogue,1916,635,23,26,49,46.9%,9m
46090,2,Adur,1916,562,17,29,46,37.0%,56m
46090,3,MKzi,1916,361,11,13,24,45.8%,57m
46090,1,nico,1916,302,8,7,15,53.3%,10m
46090,3,PowerLexx,1916,189,6,3,9,66.7%,45m
46090,2,Sawer,1916,125,6,7,13,46.2%,21m
46090,2,Fiskesuppe,1916,86,2,5,7,28.6%,16m
46090,1,Kentaur,1916,58,2,14,16,12.5%,20m
46090,1,acro,1916,94,1,1,2,50.0%,48m
46090,1,[SPAINs]Mmet,1916,0,1,4,5,20.0%,10m
46090,3,TAKTIK,1916,30,1,7,8,12.5%,9m
46090,2,Leksiu,1916,0,0,5,5,0.0%,14m
46090,2,Arise,1916,0,0,7,7,0.0%,53m
46105,2,stinis,1915,1486,63,80,143,44.1%,50m
46105,3,David,1915,439,16,24,40,40.0%,46m
46105,3,mrcool,1915,350,15,14,29,51.7%,58m
46105,3,den,1915,198,8,10,18,44.4%,20m
46105,3,Derron,1915,173,7,7,14,50.0%,50m
46105,3,Gio,1915,90,5,8,13,38.5%,19m
46105,2,Wraiten,1915,100,4,14,18,22.2%,42m
46105,3,DREZZED,1915,58,2,6,8,25.0%,24m
46105,3,Akinski,1915,64,2,9,11,18.2%,58m
46105,3,Nighteagle,1915,0,1,2,3,33.3%,3m
46105,3,СансСпотел,1915,0,1,5,6,16.7%,53m
46105,3,dimonmon,1915,0,0,3,3,0.0%,9m
46105,3,Riddik,1915,0,0,6,6,0.0%,2m
46118,3,[Inqu]PapaJoe,1914,644,32,39,71,45.1%,50m
46118,2,Schilzbolt,1914,246,9,15,24,37.5%,46m
46118,3,JANNY,1914,122,3,4,7,42.9%,38m
46118,1,InYourFace,1914,0,1,0,1,100.0%,36m
46118,2,giculescu,1914,93,1,9,10,10.0%,13m
46118,3,SergeStav,1914,0,0,6,6,0.0%,36m
46124,3,SPARTAK,1913,1062,57,64,121,47.1%,22m
46124,3,KASPERNIP,1913,351,11,11,22,50.0%,51m
46124,3,Dynamiterr,1913,267,8,9,17,47.1%,43m
46124,3,JohnyMET,1913,247,7,16,23,30.4%,46m
46124,2,ClikMan,1913,200,6,15,21,28.6%,19m
46124,3,[CJFF]EgorDark,1913,173,5,7,12,41.7%,34m
46124,3,stelinkov,1913,94,3,10,13,23.1%,20m
46124,3,[C12760]Nicolars,1913,30,1,5,6,16.7%,57m
46124,3,Led,1913,30,1,7,8,12.5%,2m
46133,3,BlaCkCruNk,1912,173,5,6,11,45.5%,1h
46133,3,felix,1912,97,2,2,4,50.0%,34m
46133,3,dertkaes,1912,64,2,5,7,28.6%,19m
46133,3,SergeyVally,1912,30,2,6,8,25.0%,1h
46133,2,chilli,1912,0,2,6,8,25.0%,57m
46133,2,Trev,1912,90,1,1,2,50.0%,25m
46133,2,Brinuz,1912,88,1,3,4,25.0%,13m
46133,3,RuBot,1912,96,1,5,6,16.7%,1h
46133,3,[CS0]Cineman,1912,0,0,1,1,0.0%,30m
46142,3,Rizon,1911,1361,71,88,159,44.7%,50m
46142,3,FERCAN,1911,203,22,26,48,45.8%,36m
46142,1,Spacetrooper,1911,816,21,16,37,56.8%,31m
46142,3,ker,1911,498,20,22,42,47.6%,50m
46142,1,Ghostiii,1911,398,13,18,31,41.9%,28m
46142,3,Tiger,1911,185,7,14,21,33.3%,45m
46142,1,MajorPayne,1911,214,4,9,13,30.8%,28m
46142,2,KingOfTime,1911,216,4,9,13,30.8%,40m
46142,3,gerfild,1911,60,3,9,12,25.0%,1h
46142,2,MiNiTeRrAnMi,1911,60,2,10,12,16.7%,40m
46142,1,seb,1911,0,0,1,1,0.0%,22m
46142,2,Ghost,1911,0,0,6,6,0.0%,36m
46154,2,Боб,1910,446,35,46,81,43.2%,8m
46154,3,Haryok,1910,168,9,9,18,50.0%,43m
46154,3,kotila,1910,120,6,18,24,25.0%,55m
46154,3,Nicer,1910,195,5,6,11,45.5%,22m
46154,1,tetonnnnnnnn,1910,156,3,3,6,50.0%,43m
46154,3,Entrecoteh,1910,36,3,6,9,33.3%,2m
46154,3,Billobor,1910,92,2,5,7,28.6%,5m
46154,2,den,1910,102,2,8,10,20.0%,28m
46154,3,Han,1910,34,2,14,16,12.5%,15m
46154,2,JoNinja,1910,0,1,0,1,100.0%,33m
46154,1,DrDeMoon,1910,0,1,4,5,20.0%,18m
46154,3,WiThErOsE,1910,0,0,2,2,0.0%,58m
46166,3,Jambo,1909,1354,62,58,120,51.7%,40m
46166,3,[ЕШКИ]BLACKSUNCHEZ,1909,424,16,20,36,44.4%,55m
46166,3,MonsterKevin,1909,168,5,12,17,29.4%,23m
46166,3,Luciano,1909,162,5,16,21,23.8%,45m
46166,3,Enny,1909,144,3,4,7,42.9%,55m
46166,3,hunter,1909,58,3,7,10,30.0%,5m
46166,3,Frency,1909,127,3,13,16,18.8%,31m
46166,3,kkkyhh,1909,0,1,0,1,100.0%,36m
46166,2,EchoCZ,1909,48,1,2,3,33.3%,5m
46166,1,Karatay,1909,73,1,3,4,25.0%,32m
46166,3,GerryDeSnail,1909,30,1,10,11,9.1%,11m
46166,3,ImPoopy,1909,0,0,1,1,0.0%,20m
46178,1,pirojok,1908,1543,94,113,207,45.4%,41m
46178,3,Бутербродище,1908,485,19,26,45,42.2%,1h
46178,3,lilsandwich,1908,237,18,24,42,42.9%,7m
46178,3,Pegasus,1908,204,10,14,24,41.7%,5m
46178,3,Trixta,1908,156,4,6,10,40.0%,19m
46178,2,[RBadB]TimGP,1908,139,3,2,5,60.0%,38m
46178,1,fivethumbs,1908,80,2,3,5,40.0%,32m
46178,3,[HYÐRA]Lixn,1908,0,1,3,4,25.0%,8m
46178,2,Daniil,1908,0,0,9,9,0.0%,4m
46187,1,Taliodent,1907,1524,56,70,126,44.4%,38m
46187,3,Strider,1907,522,17,20,37,45.9%,54m
46187,2,Richard,1907,335,13,17,30,43.3%,36m
46187,3,Vadrugir,1907,299,12,12,24,50.0%,51m
46187,3,Novah,1907,110,5,3,8,62.5%,36m
46187,3,barsik,1907,138,4,3,7,57.1%,9m
46187,3,Феникс,1907,97,3,9,12,25.0%,9m
46187,3,Oliud,1907,0,1,1,2,50.0%,55m
46187,1,Lewishu,1907,48,1,5,6,16.7%,36m
46187,1,MightSnow,1907,0,1,10,11,9.1%,1h
46187,1,DERESPECT,1907,0,0,1,1,0.0%,31m
46187,2,Johannes,1907,0,0,7,7,0.0%,47m
46199,3,JimmyRaynor,1906,705,27,33,60,45.0%,37m
46199,2,SuperAlex,1906,759,25,41,66,37.9%,5m
46199,2,Krasavik,1906,636,24,29,53,45.3%,20m
46199,2,Süsie,1906,250,9,18,27,33.3%,55m
46199,1,IMS,1906,186,4,4,8,50.0%,31m
46199,3,jonny,1906,118,4,12,16,25.0%,19m
46199,2,Xagula,1906,145,3,11,14,21.4%,31m
46199,1,Alex,1906,0,1,0,1,100.0%,30m
46199,2,LadyYuna,1906,91,1,1,2,50.0%,58m
46199,1,codomanus,1906,0,0,1,1,0.0%,24m
46199,1,AlexInfinity,1906,0,0,1,1,0.0%,17m
46210,2,Marko,1905,307,15,22,37,40.5%,30m
46210,3,Megaroboten,1905,388,12,14,26,46.2%,3m
46210,3,[xzw12]szymiqq,1905,270,9,7,16,56.2%,53m
46210,1,gouns,1905,0,1,0,1,100.0%,30m
46210,1,[SarSwe]Franco,1905,0,1,0,1,100.0%,26m
46210,1,Zeraphul,1905,0,1,0,1,100.0%,40m
46210,1,Zevenger,1905,46,1,1,2,50.0%,40m
46210,3,[FDAY]Ratchoulback,1905,0,1,5,6,16.7%,5m
46210,3,fagh,1905,0,0,3,3,0.0%,46m
46219,2,[mfixed]Danifae,1904,1114,39,53,92,42.4%,39m
46219,2,Aura,1904,642,20,31,51,39.2%,56m
46219,3,Bappé,1904,0,1,1,2,50.0%,38m
46219,3,trollking,1904,0,0,2,2,0.0%,3m
46219,3,[BNAs]крякря,1904,0,0,2,2,0.0%,30m
46219,3,Theot,1904,0,0,3,3,0.0%,10m
46225,3,Barbarian,1903,319,10,20,30,33.3%,24m
46225,1,Kelevra,1903,118,3,1,4,75.0%,58m
46225,3,[Ptit]Fly,1903,30,3,5,8,37.5%,45m
46225,1,Lorenzo,1903,64,3,11,14,21.4%,54m
46225,3,[ProbKA]SunALM,1903,60,2,7,9,22.2%,18m
46225,2,machinehead,1903,109,2,7,9,22.2%,44m
46225,3,viArt,1903,0,1,1,2,50.0%,31m
46225,2,MASTER,1903,30,1,9,10,10.0%,56m
46225,2,[FiIc]Cabuton,1903,44,1,10,11,9.1%,54m
46234,1,jawsbite,1902,522,12,13,25,48.0%,16m
46234,3,Volchemy,1902,191,8,12,20,40.0%,49m
46234,3,феникс,1902,120,4,13,17,23.5%,57m
46234,3,Kemi,1902,0,2,5,7,28.6%,46m
46234,1,tester,1902,96,2,7,9,22.2%,36m
46234,3,Plazzy,1902,0,0,1,1,0.0%,23m
46234,3,Курицын,1902,0,0,2,2,0.0%,46m
46241,1,MEN,1901,904,41,59,100,41.0%,32m
46241,3,Кобан,1901,861,28,44,72,38.9%,22m
46241,2,gmbowe,1901,497,18,29,47,38.3%,24m
46241,3,[D0N3]TheGhost,1901,222,7,79,86,8.1%,37m
46241,1,hankitank,1901,226,5,3,8,62.5%,43m
46241,3,Slapper,1901,161,5,7,12,41.7%,58m
46241,1,макс,1901,208,4,8,12,33.3%,26m
46241,3,KingDave,1901,144,3,3,6,50.0%,22m
46241,3,[OFSA]Owerumer,1901,0,2,5,7,28.6%,19m
46241,3,TheoMay,1901,0,1,1,2,50.0%,31m
46241,3,peter,1901,30,1,3,4,25.0%,42m
46241,2,FranzXaver,1901,30,1,7,8,12.5%,14m
46241,3,Pioneer,1901,34,1,8,9,11.1%,18m
46241,3,Кот,1901,0,0,1,1,0.0%,36m
46255,3,TrollArdenne,1900,738,30,29,59,50.8%,58m
46255,1,Iulian,1900,669,18,8,26,69.2%,24m
46255,3,Stregatto,1900,234,13,20,33,39.4%,50m
46255,2,АРТ,1900,302,10,22,32,31.2%,16m
46255,3,AbrisjediHUN,1900,30,2,1,3,66.7%,24m
46255,1,Roven,1900,0,2,3,5,40.0%,44m
46261,3,FanZak,1899,830,34,32,66,51.5%,22m
46261,1,fabiobest,1899,400,10,6,16,62.5%,17m
46261,2,gegohim,1899,306,10,19,29,34.5%,4m
46261,3,[Сold]даникпро,1899,0,3,4,7,42.9%,22m
46261,2,GaiusJulius,1899,36,3,14,17,17.6%,8m
46261,1,muctertrup,1899,46,2,1,3,66.7%,33m
46261,2,Optimus,1899,0,2,7,9,22.2%,53m
46261,3,Honkus,1899,0,2,12,14,14.3%,53m
46261,3,MARATON,1899,0,1,1,2,50.0%,51m
46261,1,Raptus,1899,0,0,2,2,0.0%,52m
46261,3,SandMasteur,1899,0,0,3,3,0.0%,53m
46272,2,HahneClane,1898,1422,126,141,267,47.2%,24m
46272,1,masik,1898,1511,109,119,228,47.8%,35m
46272,3,Roadstar,1898,782,29,36,65,44.6%,51m
46272,3,Lith,1898,253,23,30,53,43.4%,7m
46272,3,XhyroFalcon,1898,101,3,12,15,20.0%,8m
46272,1,[LOGS]Alientip,1898,89,1,1,2,50.0%,56m
46272,1,caxan,1898,0,0,1,1,0.0%,22m
46272,3,Warford,1898,0,0,1,1,0.0%,51m
46272,2,Endy,1898,0,0,8,8,0.0%,16m
46281,1,StinkyOrc,1897,1382,229,246,475,48.2%,24m
46281,1,[Fansaf]Alexey,1897,480,15,20,35,42.9%,1h
46281,3,Leonas,1897,188,6,15,21,28.6%,53m
46281,3,SSerg,1897,146,3,5,8,37.5%,57m
46281,1,[teksol]Sand,1897,73,1,10,11,9.1%,31m
46281,2,donddave,1897,0,0,1,1,0.0%,38m
46281,1,Drov,1897,0,0,1,1,0.0%,2m
46281,3,Serofim,1897,0,0,2,2,0.0%,55m
46281,3,Ultra,1897,0,0,8,8,0.0%,48m
46281,2,Umbre,1897,0,0,8,8,0.0%,53m
46291,2,HellBound,1896,1024,37,45,82,45.1%,32m
46291,1,Gerd,1896,1224,32,38,70,45.7%,26m
46291,3,[Z0815]Gremlin,1896,379,19,28,47,40.4%,24m
46291,1,[GIOBE]ZagorPonders,1896,375,8,18,26,30.8%,46m
46291,3,Ggamnol,1896,191,6,10,16,37.5%,26m
46291,3,kolka,1896,60,4,7,11,36.4%,46m
46291,1,BROKOT,1896,0,3,2,5,60.0%,40m
46291,1,Festu,1896,30,2,11,13,15.4%,9m
46291,3,Lamas,1896,30,1,4,5,20.0%,53m
46291,3,Vai,1896,0,0,1,1,0.0%,8m
46291,1,Leslie,1896,73,0,2,2,0.0%,49m
46291,3,Родион,1896,0,0,3,3,0.0%,42m
46303,3,Ars,1895,1544,78,84,162,48.1%,50m
46303,3,StarM,1895,956,34,37,71,47.9%,45m
46303,3,kkurek,1895,649,28,34,62,45.2%,7m
46303,3,ктото,1895,372,13,17,30,43.3%,49m
46303,3,Nick,1895,184,5,7,12,41.7%,53m
46303,2,Korchi,1895,162,5,9,14,35.7%,54m
46303,3,[TPZGG]Metalhead,1895,171,4,8,12,33.3%,42m
46303,1,garsens,1895,134,4,13,17,23.5%,1h
46303,1,Luck,1895,0,3,5,8,37.5%,38m
46303,1,Ragneton,1895,46,1,1,2,50.0%,1h
46303,3,Slon,1895,0,0,5,5,0.0%,9m
46314,2,Эквалайзер,1894,803,29,35,64,45.3%,55m
46314,3,YukkiE,1894,324,12,16,28,42.9%,42m
46314,3,Aleksey,1894,124,4,12,16,25.0%,31m
46314,3,maloy,1894,114,3,7,10,30.0%,22m
46314,3,monki,1894,0,3,16,19,15.8%,12m
46314,3,[KoSII]XIPHIOIDES,1894,30,2,6,8,25.0%,1h
46320,3,caiiikabro,1893,497,20,25,45,44.4%,24m
46320,3,sopilka,1893,356,16,19,35,45.7%,40m
46320,3,DarkSide,1893,293,10,10,20,50.0%,51m
46320,3,[Kyth]Waryo,1893,325,10,19,29,34.5%,28m
46320,1,ЗлаяБронза,1893,136,4,2,6,66.7%,26m
46320,1,Karatel,1893,48,1,2,3,33.3%,1h
46320,1,SAMED,1893,0,0,1,1,0.0%,28m
46320,1,[GG1sec]lSDl,1893,0,0,3,3,0.0%,46m
46328,3,serega,1892,331,55,54,109,50.5%,38m
46328,2,Pounarou,1892,1164,45,58,103,43.7%,44m
46328,3,[ForUA]lobutov,1892,536,18,25,43,41.9%,7m
46328,1,Asteus,1892,130,4,1,5,80.0%,24m
46328,3,hlop,1892,90,4,10,14,28.6%,3m
46328,3,Wickerman,1892,30,2,4,6,33.3%,57m
46328,1,emeralder,1892,163,2,10,12,16.7%,46m
46328,1,ljrev,1892,0,1,0,1,100.0%,30m
46328,3,AlphaEngine,1892,0,0,6,6,0.0%,32m
46328,3,[DEDAL]krzyskozak,1892,0,0,7,7,0.0%,22m
46338,3,Londoneyes,1891,1177,48,60,108,44.4%,45m
46338,3,CatarroSporc,1891,407,14,23,37,37.8%,29m
46338,3,DAavidekhaha,1891,316,11,21,32,34.4%,37m
46338,1,Siiik,1891,362,10,23,33,30.3%,40m
46338,1,MXfire,1891,130,4,10,14,28.6%,52m
46338,1,[черепо]РыбаКапля,1891,92,2,2,4,50.0%,36m
46338,2,mttgrd,1891,0,1,8,9,11.1%,37m
46338,3,Visored,1891,30,1,9,10,10.0%,44m
46338,3,Tingofotz,1891,0,0,1,1,0.0%,5m
46347,3,AlexRoman,1890,1207,47,54,101,46.5%,41m
46347,1,LOGAN,1890,1109,31,36,67,46.3%,1h
46347,3,[AiRǂ]FrankHrd,1890,851,31,44,75,41.3%,30m
46347,1,Rubix,1890,408,10,7,17,58.8%,42m
46347,1,[Avgus]Chepitezz,1890,270,6,4,10,60.0%,2m
46347,3,[nwby]XenoKing,1890,213,6,6,12,50.0%,42m
46347,2,BlkbyRequest,1890,78,5,8,13,38.5%,56m
46347,3,Artem,1890,121,2,9,11,18.2%,22m
46347,3,[AA36]GoLLum,1890,0,1,0,1,100.0%,5m
46347,3,MurlloKK,1890,96,1,2,3,33.3%,3m
46347,1,kuznec,1890,0,1,4,5,20.0%,46m
46347,2,SeñorCogollo,1890,0,0,2,2,0.0%,25m
46359,3,Puschi,1889,1598,76,92,168,45.2%,3m
46359,1,XENOM,1889,1023,68,84,152,44.7%,36m
46359,3,Trador,1889,162,4,3,7,57.1%,24m
46359,2,NeMoNik,1889,214,4,15,19,21.1%,43m
46359,1,JZMD,1889,121,3,4,7,42.9%,16m
46359,3,Starconkeror,1889,30,1,7,8,12.5%,9m
46359,1,BinekPL,1889,0,1,10,11,9.1%,32m
46366,2,allezlesbleu,1888,1384,52,61,113,46.0%,1h
46366,2,Guiscard,1888,546,19,27,46,41.3%,14m
46366,2,Masachristus,1888,273,13,18,31,41.9%,11m
46366,3,NIK,1888,158,6,10,16,37.5%,3m
46366,3,deMichel,1888,118,4,7,11,36.4%,9m
46366,3,[FFaaN]Duca,1888,72,3,8,11,27.3%,5m
46366,2,kate,1888,156,3,10,13,23.1%,56m
46366,3,aaaaaaaaaaa,1888,32,1,8,9,11.1%,5m
46366,1,Matrixxx,1888,0,0,2,2,0.0%,40m
46375,3,mag,1887,1527,86,104,190,45.3%,31m
46375,3,Stick,1887,573,27,27,54,50.0%,3m
46375,1,ZERO,1887,469,14,32,46,30.4%,55m
46375,3,Xrsist,1887,160,7,12,19,36.8%,3m
46375,1,[SPAINs]elbeto,1887,159,5,7,12,41.7%,1h
46375,1,[KingA]LVEAI,1887,126,4,7,11,36.4%,40m
46375,3,destinyisall,1887,176,4,8,12,33.3%,58m
46375,2,chingachgook,1887,152,3,4,7,42.9%,37m
46375,2,MattHeafy,1887,0,0,1,1,0.0%,50m
46375,3,[pndrag]CANARYCRAZY,1887,0,0,4,4,0.0%,45m
46375,3,Czoko,1887,0,0,6,6,0.0%,58m
46386,3,KRISTIAN,1886,926,40,42,82,48.8%,12m
46386,2,[morts]ARCHANGE,1886,769,30,35,65,46.2%,6m
46386,1,[TULEN]liolikkp,1886,270,10,19,29,34.5%,25m
46386,3,Fibo,1886,222,7,13,20,35.0%,56m
46386,1,LanaFiriat,1886,190,6,18,24,25.0%,1h
46386,3,Wazaaaaaaaaa,1886,0,4,3,7,57.1%,5m
46386,3,[FR1]avore,1886,98,4,5,9,44.4%,50m
46386,2,click,1886,138,3,14,17,17.6%,44m
46386,1,JayStar,1886,46,2,0,2,100.0%,2m
46386,1,Tamant,1886,0,1,0,1,100.0%,8m
46386,3,[DHHD]Kanashii,1886,0,1,4,5,20.0%,55m
46386,1,Cunundrum,1886,0,0,1,1,0.0%,52m
46398,3,JDB,1885,319,11,16,27,40.7%,46m
46398,3,Lon,1885,324,11,22,33,33.3%,24m
46398,1,franasm,1885,388,10,9,19,52.6%,52m
46398,1,SaLEm,1885,296,6,6,12,50.0%,28m
46398,3,FAFABOY,1885,97,2,5,7,28.6%,5m
46403,1,enginar,1884,986,27,26,53,50.9%,58m
46403,1,Timhic,1884,575,17,25,42,40.5%,53m
46403,1,[HoS201]TigerNoir,1884,434,16,27,43,37.2%,22m
46403,3,illyuzionist,1884,258,10,9,19,52.6%,42m
46403,1,Prosvet,1884,173,3,3,6,50.0%,26m
46403,1,Winsearch,1884,0,1,0,1,100.0%,19m
46403,2,Corpsman,1884,0,0,2,2,0.0%,33m
46403,3,Wariacik,1884,0,0,5,5,0.0%,44m
46411,3,[SDW2]Viktorier,1883,595,21,22,43,48.8%,1h
46411,3,XMEN,1883,372,12,15,27,44.4%,10m
46411,3,Panda,1883,152,5,9,14,35.7%,9m
46411,3,Riot,1883,94,2,6,8,25.0%,38m
46411,1,helmet,1883,90,2,11,13,15.4%,36m
46411,1,Dakhellzero,1883,103,2,11,13,15.4%,1h
46411,3,[MODRR]Kamaleon,1883,30,1,5,6,16.7%,3m
46418,3,ДемонРок,1882,326,11,17,28,39.3%,30m
46418,3,Zalder,1882,202,7,12,19,36.8%,40m
46418,1,arsnl,1882,48,2,12,14,14.3%,32m
46418,2,FREDDO,1882,45,1,8,9,11.1%,2m
46418,2,StaSix,1882,0,0,1,1,0.0%,43m
46418,1,DeeTwo,1882,0,0,1,1,0.0%,28m
46418,3,Artorios,1882,0,0,2,2,0.0%,36m
46425,3,JoRussi,1881,471,19,22,41,46.3%,46m
46425,3,ilMousTro,1881,30,2,4,6,33.3%,20m
46425,1,Ачетакможно,1881,0,1,3,4,25.0%,8m
46425,3,karo,1881,0,0,3,3,0.0%,30m
46429,3,elettro,1880,257,8,9,17,47.1%,33m
46429,3,[RCM]pablito,1880,38,1,4,5,20.0%,47m
46429,2,Zorag,1880,0,0,3,3,0.0%,12m
46432,3,DaKhun,1879,824,31,34,65,47.7%,20m
46432,3,mrbud,1879,524,25,31,56,44.6%,23m
46432,3,Comquat,1879,355,12,12,24,50.0%,32m
46432,3,Laz,1879,162,6,8,14,42.9%,57m
46432,1,NPedersen,1879,46,1,3,4,25.0%,34m
46437,3,[svinik]MineralWalk,1878,541,23,25,48,47.9%,56m
46437,3,SvgTheHunter,1878,387,18,15,33,54.5%,3m
46437,3,[Gurkie]Midnor,1878,344,11,16,27,40.7%,34m
46437,1,Orikih,1878,92,2,1,3,66.7%,40m
46437,3,fuox,1878,76,2,8,10,20.0%,44m
46437,2,storm,1878,60,2,10,12,16.7%,46m
46437,1,LôrdHass,1878,48,2,11,13,15.4%,42m
46437,3,Giller,1878,30,1,8,9,11.1%,17m
46437,1,Phenixfeuer,1878,0,1,9,10,10.0%,33m
46437,1,Yushin,1878,0,0,1,1,0.0%,40m
46437,3,[HMarch]JankoZG,1878,0,0,4,4,0.0%,5m
46437,3,Marculius,1878,0,0,5,5,0.0%,55m
46449,1,BradToys,1877,612,16,17,33,48.5%,30m
46449,2,макс,1877,232,6,8,14,42.9%,44m
46449,1,[Ginf]Toony,1877,124,5,14,19,26.3%,40m
46449,1,Shkermajor,1877,46,1,1,2,50.0%,40m
46449,3,hibi,1877,0,0,1,1,0.0%,5m
46449,1,JanekKwadrat,1877,0,0,2,2,0.0%,17m
46449,1,warnighttown,1877,0,0,2,2,0.0%,36m
46456,2,Метрокепочка,1876,1614,218,243,461,47.3%,30m
46456,1,Merquryshow,1876,622,15,17,32,46.9%,17m
46456,2,Kirily,1876,0,3,6,9,33.3%,36m
46456,1,AlphaWolf,1876,0,1,0,1,100.0%,2m
46456,1,Dlander,1876,0,1,0,1,100.0%,24m
46456,3,[THIC]BlaZe,1876,0,0,1,1,0.0%,36m
46456,1,Vagabond,1876,73,0,8,8,0.0%,30m
46463,3,selarom,1875,1543,172,181,353,48.7%,7m
46463,2,alex,1875,1240,92,100,192,47.9%,24m
46463,3,Drake,1875,684,25,33,58,43.1%,20m
46463,1,Ganniball,1875,392,10,21,31,32.3%,31m
46463,3,kryštofleff,1875,92,4,6,10,40.0%,36m
46463,3,Zuzya,1875,90,3,8,11,27.3%,1h
46463,3,mopolita,1875,0,2,5,7,28.6%,8m
46463,2,vulkan,1875,44,2,11,13,15.4%,40m
46463,3,Yannick,1875,0,1,4,5,20.0%,46m
46463,1,ArchetypeOne,1875,0,0,1,1,0.0%,18m
46473,3,RainMaker,1874,1088,40,48,88,45.5%,57m
46473,1,Materoxloo,1874,490,13,12,25,52.0%,56m
46473,3,Orion,1874,149,3,5,8,37.5%,22m
46473,1,KlikoBoom,1874,90,2,2,4,50.0%,18m
46473,1,albench,1874,48,1,4,5,20.0%,18m
46473,1,Kamilostar,1874,0,0,1,1,0.0%,3m
46473,3,DOGFISHWAR,1874,0,0,6,6,0.0%,44m
46473,3,Kitsunedie,1874,0,0,8,8,0.0%,47m
46473,2,johan,1874,0,0,8,8,0.0%,5m
46482,2,ALdiablo,1873,920,30,46,76,39.5%,18m
46482,3,Lucky,1873,416,21,26,47,44.7%,7m
46482,3,PRDEL,1873,490,17,22,39,43.6%,57m
46482,3,[MoonTr]katatsu,1873,218,6,8,14,42.9%,19m
46482,1,Imbirek,1873,175,5,14,19,26.3%,39m
46482,1,Dimonpokimon,1873,118,5,16,21,23.8%,43m
46482,1,deekay,1873,0,1,2,3,33.3%,26m
46482,2,TyphonZede,1873,0,1,2,3,33.3%,51m
46482,3,Евгений,1873,0,0,1,1,0.0%,48m
46482,3,AshIsLame,1873,0,0,1,1,0.0%,30m
46482,3,Martinator,1873,0,0,7,7,0.0%,46m
46493,3,Nuke,1872,269,12,20,32,37.5%,5m
46493,1,kindehidna,1872,314,10,27,37,27.0%,30m
46493,1,MicroFraud,1872,336,9,16,25,36.0%,25m
46493,2,Jordi,1872,30,5,9,14,35.7%,48m
46493,2,itsRL,1872,0,0,6,6,0.0%,44m
46498,3,Dyno,1871,1397,105,132,237,44.3%,58m
46498,3,Eyetech,1871,574,20,29,49,40.8%,41m
46498,1,dobione,1871,573,19,20,39,48.7%,11m
46498,3,MistiK,1871,224,6,15,21,28.6%,55m
46498,3,OskaRocKet,1871,86,3,5,8,37.5%,27m
46498,2,[LGKBH]DarkWolF,1871,0,1,0,1,100.0%,32m
46498,3,DiskSender,1871,0,0,1,1,0.0%,5m
46498,3,Apollonius,1871,0,0,6,6,0.0%,47m
46506,3,IstdochRille,1870,1242,75,85,160,46.9%,50m
46506,3,Xenonstar,1870,808,26,42,68,38.2%,29m
46506,1,[CREPES]leo,1870,965,25,28,53,47.2%,25m
46506,1,Sorooz,1870,734,24,36,60,40.0%,22m
46506,3,LekiR,1870,398,19,25,44,43.2%,41m
46506,2,Meow,1870,294,8,20,28,28.6%,54m
46506,3,Carlo,1870,242,7,9,16,43.8%,7m
46506,1,IvanSelick,1870,239,6,6,12,50.0%,6m
46506,1,ObltNova,1870,182,4,6,10,40.0%,26m
46506,1,Lucifer,1870,46,2,2,4,50.0%,17m
46506,1,ArtKing,1870,128,2,2,4,50.0%,38m
46506,1,[комча]lordtopgg,1870,0,1,0,1,100.0%,26m
46506,2,ViruX,1870,36,1,1,2,50.0%,54m
46506,2,[Madao]NightyZockt,1870,97,1,9,10,10.0%,5m
46506,3,Franusku,1870,0,0,4,4,0.0%,8m
46521,3,Oasis,1869,1503,67,76,143,46.9%,55m
46521,2,KAPRAL,1869,1454,66,77,143,46.2%,45m
46521,2,fasststrike,1869,701,25,34,59,42.4%,38m
46521,1,Greenberet,1869,186,5,16,21,23.8%,38m
46521,3,tantimao,1869,72,4,8,12,33.3%,31m
46526,3,Mikstray,1868,503,16,29,45,35.6%,45m
46526,1,Soap,1868,301,8,16,24,33.3%,26m
46526,1,SvenRagnar,1868,0,0,2,2,0.0%,19m
46526,2,Sedoi,1868,0,0,4,4,0.0%,29m
46530,2,Ferranscio,1867,542,19,30,49,38.8%,30m
46530,1,Marsus,1867,46,2,0,2,100.0%,15m
46530,1,Blusome,1867,0,1,8,9,11.1%,30m
46530,1,FURY,1867,0,0,1,1,0.0%,17m
46530,1,ZyGoDzilla,1867,73,0,5,5,0.0%,20m
46535,3,CePeeS,1866,816,29,40,69,42.0%,50m
46535,1,SDS,1866,150,6,8,14,42.9%,11m
46535,3,PHANTOMAS,1866,208,5,11,16,31.2%,18m
46535,2,Gepard,1866,44,2,5,7,28.6%,56m
46535,1,[Makkie]GekkeMarki,1866,0,1,3,4,25.0%,36m
46535,2,gorgoth,1866,88,1,8,9,11.1%,36m
46535,1,Marin,1866,0,0,3,3,0.0%,40m
46535,2,Anzo,1866,0,0,5,5,0.0%,44m
46535,2,PCcutza,1866,0,0,8,8,0.0%,36m
46544,1,Ghost,1865,439,10,8,18,55.6%,25m
46544,2,Cyva,1865,291,10,18,28,35.7%,1h
46544,1,Boandlcramer,1865,0,0,7,7,0.0%,29m
46547,3,MiniM,1864,1089,38,50,88,43.2%,30m
46547,3,Яркий,1864,386,12,25,37,32.4%,56m
46547,1,[CIU2]walla,1864,432,11,10,21,52.4%,38m
46547,1,ДжИн,1864,274,7,7,14,50.0%,18m
46547,1,Mettabaron,1864,96,2,4,6,33.3%,35m
46547,3,Wicht,1864,34,1,8,9,11.1%,7m
46547,1,MillieDog,1864,0,1,8,9,11.1%,21m
46547,2,Teisseire,1864,30,1,10,11,9.1%,58m
46547,1,Sedokiro,1864,0,0,1,1,0.0%,16m
46556,3,Quiro,1863,1240,51,52,103,49.5%,46m
46556,1,CoronaCorona,1863,678,18,16,34,52.9%,28m
46556,3,Snoozy,1863,449,14,27,41,34.1%,56m
46556,1,Mummy,1863,408,9,19,28,32.1%,2m
46556,2,Arkadiusz,1863,239,5,13,18,27.8%,2m
46556,2,der,1863,166,4,2,6,66.7%,37m
46556,1,[basdp]Metalpunker,1863,170,4,2,6,66.7%,17m
46556,1,serg,1863,138,4,5,9,44.4%,11m
46556,3,MaLoU,1863,86,4,8,12,33.3%,45m
46556,1,Silverdeer,1863,129,3,13,16,18.8%,30m
46556,1,Akaraf,1863,42,2,0,2,100.0%,15m
46556,1,ELIMARVSON,1863,88,2,1,3,66.7%,2m
46556,3,InterGRATOR,1863,32,2,2,4,50.0%,48m
46556,1,amFINtamin,1863,0,1,0,1,100.0%,52m
46556,2,yolo,1863,0,1,8,9,11.1%,32m
46571,3,Yurbas,1862,0,2,5,7,28.6%,1h
46571,2,FevePL,1862,0,1,0,1,100.0%,36m
46571,3,Antho,1862,0,0,8,8,0.0%,17m
46574,3,warrior,1861,589,24,30,54,44.4%,38m
46574,2,PlayerRayX,1861,199,7,13,20,35.0%,21m
46574,1,sporik,1861,0,1,0,1,100.0%,40m
46577,1,Dude,1860,291,8,17,25,32.0%,58m
46577,3,Vazon,1860,146,5,13,18,27.8%,29m
46577,1,Pulsar,1860,143,3,9,12,25.0%,40m
46577,1,firebug,1860,94,2,5,7,28.6%,36m
46577,2,Ares,1860,0,0,6,6,0.0%,32m
46582,3,PÆSCÆL,1859,1287,56,66,122,45.9%,57m
46582,2,VenoM,1859,197,8,9,17,47.1%,54m
46582,1,серж,1859,73,1,2,3,33.3%,44m
46582,3,Ondrej,1859,30,1,3,4,25.0%,49m
46582,1,cidor,1859,46,1,5,6,16.7%,15m
46582,3,damianZ,1859,0,0,7,7,0.0%,2m
46588,3,Diogene,1858,1019,36,59,95,37.9%,46m
46588,1,Archon,1858,370,8,11,19,42.1%,24m
46588,2,MaxiM,1858,161,3,9,12,25.0%,47m
46588,3,Mrakobes,1858,30,2,4,6,33.3%,7m
46588,2,AMETIST,1858,42,1,2,3,33.3%,14m
46588,3,хачупитсы,1858,42,1,9,10,10.0%,53m
46588,1,Bozo,1858,0,0,1,1,0.0%,29m
46588,1,bob,1858,0,0,1,1,0.0%,43m
46596,1,Costel,1857,1008,28,29,57,49.1%,40m
46596,3,IIIIIIIIIIII,1857,420,14,14,28,50.0%,50m
46596,3,Trueno,1857,270,8,8,16,50.0%,58m
46596,1,Aldo,1857,130,3,5,8,37.5%,15m
46596,1,StrongMAN,1857,92,2,5,7,28.6%,32m
46596,1,[DaFF]Blutschwert,1857,0,1,0,1,100.0%,32m
46602,2,Александр,1856,510,15,37,52,28.8%,11m
46602,3,krystian,1856,343,13,15,28,46.4%,54m
46602,1,Gspilap,1856,416,12,13,25,48.0%,58m
46602,2,mattica,1856,234,10,21,31,32.3%,39m
46602,3,Ronan,1856,145,4,7,11,36.4%,24m
46602,1,relanpago,1856,116,2,5,7,28.6%,2m
46602,3,Nutser,1856,30,1,9,10,10.0%,35m
46602,1,Legend,1856,0,0,1,1,0.0%,15m
46602,3,OOPS,1856,0,0,2,2,0.0%,42m
46611,3,Zaran,1855,1534,161,207,368,43.8%,41m
46611,3,Hammer,1855,361,34,34,68,50.0%,44m
46611,1,Károly,1855,448,11,9,20,55.0%,24m
46611,2,saskeeeeee,1855,294,7,15,22,31.8%,56m
46611,3,RECTOR,1855,0,1,0,1,100.0%,53m
46611,1,[BDF]Odin,1855,0,0,1,1,0.0%,31m
46611,3,Zed,1855,0,0,1,1,0.0%,21m
46611,1,Amira,1855,0,0,4,4,0.0%,31m
46611,3,Бабл,1855,0,0,7,7,0.0%,34m
46620,1,face,1854,534,13,16,29,44.8%,28m
46620,2,aleksej,1854,247,8,12,20,40.0%,37m
46620,2,MacWaldspast,1854,168,6,19,25,24.0%,29m
46620,3,Pitbull,1854,0,1,0,1,100.0%,49m
46620,1,SOAP,1854,0,1,0,1,100.0%,52m
46620,3,nano,1854,46,1,10,11,9.1%,44m
46620,1,DCeres,1854,0,0,1,1,0.0%,30m
46627,1,Pjotr,1853,182,8,24,32,25.0%,51m
46627,1,Sethekh,1853,320,7,10,17,41.2%,26m
46627,3,blackfun,1853,148,4,8,12,33.3%,31m
46627,1,ZeuS,1853,46,2,1,3,66.7%,31m
46627,1,Spoooky,1853,48,1,1,2,50.0%,29m
46627,2,NFO,1853,0,1,4,5,20.0%,2m
46627,1,optimusprime,1853,0,0,2,2,0.0%,33m
46627,3,MattiuNinja,1853,0,0,7,7,0.0%,22m
46635,3,Zorack,1852,1528,63,70,133,47.4%,31m
46635,3,Macfdfed,1852,716,25,33,58,43.1%,46m
46635,3,noah,1852,250,9,20,29,31.0%,44m
46635,2,WHITEANGEL,1852,0,0,2,2,0.0%,40m
46635,3,julian,1852,0,0,7,7,0.0%,23m
46640,3,пика,1851,418,16,16,32,50.0%,19m
46640,3,Mariño,1851,298,10,12,22,45.5%,55m
46640,3,[DMTRY]Velorex,1851,232,7,10,17,41.2%,55m
46640,3,RomeoZ,1851,30,1,8,9,11.1%,24m
46640,3,карлисончик,1851,0,0,1,1,0.0%,36m
46640,1,Oso,1851,73,0,8,8,0.0%,46m
46640,1,ebrithil,1851,0,0,10,10,0.0%,16m
46647,2,makarov,1850,1095,101,119,220,45.9%,15m
46647,2,DirtyToss,1850,823,29,32,61,47.5%,39m
46647,3,tyrion,1850,160,5,12,17,29.4%,50m
46647,1,CHAKALAN,1850,172,4,6,10,40.0%,18m
46647,1,Mickachu,1850,152,4,13,17,23.5%,38m
46647,2,MENTAL,1850,176,4,14,18,22.2%,17m
46647,3,Dialex,1850,0,1,1,2,50.0%,27m
46647,1,naraku,1850,0,1,1,2,50.0%,1h
46647,3,[УЗУ]yar,1850,0,1,1,2,50.0%,17m
46647,3,JODGY,1850,30,1,5,6,16.7%,24m
46657,3,бриангур,1849,923,35,39,74,47.3%,58m
46657,1,Mortex,1849,690,16,21,37,43.2%,52m
46657,1,Mastercheff,1849,539,13,16,29,44.8%,32m
46657,3,JulyRain,1849,30,1,9,10,10.0%,6m
46657,1,[ANREN]Dalsis,1849,0,0,1,1,0.0%,24m
46657,1,ogy,1849,0,0,1,1,0.0%,1h
46663,3,Ronen,1848,928,147,157,304,48.4%,42m
46663,3,McombéOUANG,1848,1476,110,128,238,46.2%,50m
46663,3,Tweedy,1848,907,32,46,78,41.0%,29m
46663,3,CatS,1848,362,13,20,33,39.4%,58m
46663,2,ShinAlu,1848,258,5,14,19,26.3%,35m
46663,1,[EliteX]IlllIllllI,1848,186,4,4,8,50.0%,45m
46663,1,[win2]DJANGOROD,1848,184,4,7,11,36.4%,25m
46663,2,OSWALDOCV,1848,84,2,7,9,22.2%,45m
46663,1,GrEEnGHOst,1848,0,0,1,1,0.0%,32m
46663,3,Frank,1848,0,0,3,3,0.0%,32m
46673,1,nok,1847,515,11,9,20,55.0%,36m
46673,3,MaximSVD,1847,285,8,20,28,28.6%,6m
46673,1,Arbok,1847,254,7,1,8,87.5%,34m
46673,3,ryzy,1847,228,7,17,24,29.2%,6m
46677,3,Nelegal,1846,608,23,30,53,43.4%,31m
46677,3,YanBlood,1846,420,16,34,50,32.0%,38m
46677,1,labeforever,1846,527,12,23,35,34.3%,36m
46677,1,Haytone,1846,206,5,4,9,55.6%,52m
46677,1,Superniala,1846,138,4,2,6,66.7%,40m
46677,2,Sveton,1846,60,2,9,11,18.2%,32m
46677,1,Vladimir,1846,0,1,2,3,33.3%,31m
46677,2,Rares,1846,0,0,1,1,0.0%,38m
46677,1,Pontius,1846,0,0,3,3,0.0%,20m
46677,1,artur,1846,0,0,3,3,0.0%,26m
46687,1,[starBf]Bofa,1845,44,2,2,4,50.0%,49m
46687,1,danilka,1845,82,2,3,5,40.0%,15m
46687,3,НадКирпичек,1845,40,2,9,11,18.2%,55m
46687,2,Kisune,1845,70,2,11,13,15.4%,17m
46687,3,Ras,1845,30,1,7,8,12.5%,58m
46687,2,LINK,1845,0,1,8,9,11.1%,16m
46687,3,PsyHo,1845,0,0,1,1,0.0%,36m
46687,2,xaxa,1845,0,0,2,2,0.0%,45m
46687,3,[HOTS3]BoneCrusher,1845,0,0,4,4,0.0%,10m
46687,2,Aras,1845,0,0,8,8,0.0%,48m
46697,2,OmegaTech,1844,1041,39,55,94,41.5%,47m
46697,1,MKTheKing,1844,353,8,20,28,28.6%,2m
46697,2,xor,1844,216,6,11,17,35.3%,51m
46697,1,MonkeyMagic,1844,324,6,14,20,30.0%,38m
46697,1,[Listic]Jeppsson,1844,0,0,1,1,0.0%,48m
46697,3,[twisku]Moriggane,1844,0,0,1,1,0.0%,39m
46703,2,PREDATOR,1843,1468,59,64,123,48.0%,20m
46703,2,Steve,1843,474,15,26,41,36.6%,13m
46703,1,dreifimisi,1843,388,14,18,32,43.8%,46m
46703,2,Thomas,1843,460,14,32,46,30.4%,58m
46703,2,Rendrix,1843,396,13,27,40,32.5%,27m
46703,3,SpaceSpandex,1843,308,9,17,26,34.6%,50m
46703,1,Ozan,1843,46,2,0,2,100.0%,52m
46703,3,Crayzing,1843,0,0,8,8,0.0%,49m
46711,1,joseantonio,1842,1009,53,58,111,47.7%,8m
46711,2,aleksei,1842,450,15,26,41,36.6%,21m
46711,3,Jellipino,1842,383,13,26,39,33.3%,4m
46711,1,RAW,1842,322,8,5,13,61.5%,18m
46711,1,Corben,1842,188,7,18,25,28.0%,1h
46711,3,Egorushka,1842,92,3,6,9,33.3%,4m
46711,3,[GANGP]AgenteKris,1842,30,2,2,4,50.0%,2m
46711,3,metalika,1842,0,2,5,7,28.6%,29m
46711,3,Kakashi,1842,0,0,1,1,0.0%,3m
46711,1,Lucky,1842,0,0,1,1,0.0%,40m
46721,3,sisko,1841,746,28,32,60,46.7%,7m
46721,1,bErTi,1841,220,5,9,14,35.7%,1h
46721,2,hallonspelar,1841,140,3,11,14,21.4%,15m
46721,3,Stud,1841,62,2,9,11,18.2%,34m
46721,2,Rincecochon,1841,42,2,11,13,15.4%,44m
46721,2,Argol,1841,30,1,9,10,10.0%,20m
46721,3,sakkemannen,1841,0,0,7,7,0.0%,23m
46721,3,NUkeR,1841,0,0,7,7,0.0%,51m
46729,3,Cube,1840,86,4,6,10,40.0%,9m
46729,2,[MEKU]Kuternega,1840,0,3,5,8,37.5%,40m
46729,1,Barbidon,1840,46,2,2,4,50.0%,29m
46729,3,Masi,1840,97,2,3,5,40.0%,10m
46729,1,[batPT]Daxter,1840,0,0,1,1,0.0%,46m
46734,1,WARLORD,1839,1438,46,53,99,46.5%,11m
46734,2,Lumerk,1839,856,30,48,78,38.5%,5m
46734,3,Skrem,1839,441,23,24,47,48.9%,18m
46734,3,Guiu,1839,282,13,19,32,40.6%,4m
46734,3,BaldWamin,1839,212,10,14,24,41.7%,25m
46734,1,Serenity,1839,202,7,18,25,28.0%,30m
46734,1,Rolord,1839,48,3,4,7,42.9%,18m
46734,3,Rulle,1839,96,2,2,4,50.0%,30m
46742,3,sominsomin,1838,72,4,9,13,30.8%,8m
46742,1,NET,1838,0,3,2,5,60.0%,29m
46742,3,fobus,1838,0,2,3,5,40.0%,53m
46742,1,[Gustll]Axel,1838,0,0,2,2,0.0%,2m
46746,3,[OmDi]караедикин,1837,1405,96,124,220,43.6%,46m
46746,2,EnVill,1837,1098,38,54,92,41.3%,11m
46746,1,Daniel,1837,467,12,8,20,60.0%,30m
46746,1,DanzBodz,1837,176,4,6,10,40.0%,56m
46746,2,ruton,1837,64,4,18,22,18.2%,51m
46746,1,[TnySC]KingVaath,1837,134,3,3,6,50.0%,31m
46746,1,pinetree,1837,44,2,12,14,14.3%,22m
46746,3,MisterED,1837,36,1,5,6,16.7%,51m
46746,1,jgueabr,1837,0,0,1,1,0.0%,11m
46755,3,Eduard,1836,1384,83,111,194,42.8%,22m
46755,3,[KJ420]Capone,1836,848,36,109,145,24.8%,40m
46755,3,iTacHiFoUaD,1836,942,31,49,80,38.8%,44m
46755,3,Javi,1836,158,6,12,18,33.3%,34m
46755,2,iLoVeYoUaloT,1836,86,3,24,27,11.1%,53m
46755,2,joker,1836,84,2,10,12,16.7%,17m
46755,1,azazazazazaz,1836,0,1,9,10,10.0%,25m
46755,1,[100PSC]MiguelAngelo,1836,0,0,1,1,0.0%,34m
46755,3,TAygerenok,1836,0,0,7,7,0.0%,21m
46764,1,adelheit,1835,1918,93,114,207,44.9%,43m
46764,3,luisin,1835,272,9,22,31,29.0%,54m
46764,3,eldevarhuzun,1835,30,2,0,2,100.0%,39m
46764,1,[AMN]LorenzCraft,1835,73,2,5,7,28.6%,30m
46764,1,[Iperyt]Лизонька,1835,90,2,6,8,25.0%,2m
46764,1,TUĞRANLI,1835,46,1,3,4,25.0%,43m
46764,3,Demonsir,1835,0,1,4,5,20.0%,3m
46771,3,macodo,1834,1563,144,183,327,44.0%,41m
46771,3,Mick,1834,458,25,36,61,41.0%,53m
46771,3,Warbrun,1834,548,21,34,55,38.2%,37m
46771,1,Flash,1834,202,6,2,8,75.0%,33m
46771,3,Bluu,1834,58,4,3,7,57.1%,5m
46771,3,gamlet,1834,30,2,6,8,25.0%,22m
46771,3,SergiOK,1834,0,1,10,11,9.1%,5m
46778,3,Росомаха,1833,1342,52,59,111,46.8%,22m
46778,1,TicTac,1833,199,8,11,19,42.1%,36m
46778,1,Cherobim,1833,0,0,1,1,0.0%,24m
46778,3,GLOBUS,1833,0,0,1,1,0.0%,53m
46782,1,cloud,1832,44,3,4,7,42.9%,30m
46782,2,GoldHavk,1832,128,3,10,13,23.1%,56m
46782,2,[pugio]DarkPhoenix,1832,36,2,2,4,50.0%,30m
46782,1,[21789]JoshuaM,1832,86,2,3,5,40.0%,28m
46782,1,grasp,1832,0,1,3,4,25.0%,43m
46787,3,TORDEN,1831,311,10,20,30,33.3%,43m
46787,1,[ponly]bleach,1831,340,9,21,30,30.0%,52m
46787,2,imnoob,1831,232,6,14,20,30.0%,37m
46790,3,niels,1830,1548,298,323,621,48.0%,58m
46790,2,Ben,1830,1348,48,69,117,41.0%,2m
46790,3,Fightscanner,1830,1184,43,55,98,43.9%,19m
46790,1,soupel,1830,375,9,12,21,42.9%,15m
46790,2,Tishoo,1830,226,9,23,32,28.1%,46m
46790,1,ovi,1830,116,5,13,18,27.8%,43m
46790,1,deredez,1830,0,1,4,5,20.0%,26m
46790,1,AlexRom,1830,0,1,11,12,8.3%,17m
46790,3,Toki,1830,0,0,5,5,0.0%,5m
46799,1,[КЮ]Cklewerr,1829,881,25,27,52,48.1%,29m
46799,1,StinkyPiss,1829,228,6,4,10,60.0%,53m
46799,1,Diplomaster,1829,0,0,2,2,0.0%,30m
46802,2,Tragedijus,1828,1517,268,296,564,47.5%,39m
46802,3,Chris,1828,1382,96,124,220,43.6%,30m
46802,1,[getric]ELMIDA,1828,265,7,19,26,26.9%,1h
46802,3,[palats]Catweazle,1828,30,2,1,3,66.7%,17m
46802,2,Regenttripel,1828,48,2,12,14,14.3%,55m
46802,3,[SUDA]Alim,1828,0,1,0,1,100.0%,6m
46802,2,Perpedon,1828,0,0,1,1,0.0%,22m
46802,1,[CREPES]HUgmob,1828,0,0,1,1,0.0%,38m
46802,1,PlatonT,1828,0,0,1,1,0.0%,33m
46802,1,Sebs,1828,0,0,4,4,0.0%,26m
46812,3,Adrian,1827,1580,272,332,604,45.0%,3m
46812,1,RomanPo,1827,657,25,25,50,50.0%,53m
46812,1,Igorechelo,1827,147,2,4,6,33.3%,26m
46812,2,samael,1827,0,0,1,1,0.0%,29m
46812,1,homodeus,1827,0,0,2,2,0.0%,35m
46812,1,зилот,1827,0,0,2,2,0.0%,8m
46818,1,Kindness,1826,721,33,26,59,55.9%,32m
46818,3,lol,1826,58,4,7,11,36.4%,55m
46818,1,[N1TDA]Akashi,1826,0,1,0,1,100.0%,56m
46818,1,mariaccio,1826,0,0,1,1,0.0%,18m
46822,1,NightLark,1825,942,30,36,66,45.5%,58m
46822,3,Maverick,1825,634,27,35,62,43.5%,55m
46822,1,Konov,1825,639,16,27,43,37.2%,34m
46822,1,Mazox,1825,450,15,16,31,48.4%,48m
46822,3,MoD,1825,354,15,25,40,37.5%,33m
46827,3,StarJunkie,1824,450,15,28,43,34.9%,38m
46827,2,Phyushin,1824,44,2,12,14,14.3%,54m
46827,1,Imperator,1824,0,0,1,1,0.0%,53m
46827,3,[Ostre]Antolol,1824,0,0,1,1,0.0%,55m
46831,1,reinhold,1823,1955,123,174,297,41.4%,53m
46831,1,AleKiller,1823,388,9,11,20,45.0%,56m
46831,1,HighDreams,1823,348,9,21,30,30.0%,26m
46831,3,CanisLupus,1823,211,5,11,16,31.2%,11m
46831,1,kalef,1823,138,3,4,7,42.9%,32m
46831,3,FailSC,1823,0,1,4,5,20.0%,55m
46837,1,BuGaGaGeR,1822,1019,31,35,66,47.0%,20m
46837,2,Rajko,1822,201,9,8,17,52.9%,43m
46837,1,BaradDur,1822,82,3,2,5,60.0%,26m
46837,2,[SpcWar]Hafka,1822,163,3,13,16,18.8%,37m
46837,2,Magma,1822,92,2,0,2,100.0%,58m
46837,1,Aruna,1822,0,1,1,2,50.0%,15m
46837,3,[SPАRТА]Dana,1822,30,1,6,7,14.3%,37m
46837,3,[btbN]Benz,1822,30,1,9,10,10.0%,38m
46837,1,viki,1822,73,0,3,3,0.0%,34m
46846,1,Jazcab,1821,990,27,28,55,49.1%,40m
46846,3,whY,1821,395,13,29,42,31.0%,43m
46846,1,Anduril,1821,212,5,10,15,33.3%,33m
46846,3,Vectron,1821,148,3,10,13,23.1%,58m
46846,1,[2iq]FNuts,1821,144,3,14,17,17.6%,36m
46846,1,Pierrick,1821,0,2,4,6,33.3%,29m
46846,1,also,1821,48,1,2,3,33.3%,32m
46846,3,неустрой,1821,0,0,2,2,0.0%,30m
46846,3,BlaCKinbom,1821,0,0,6,6,0.0%,53m
46855,1,koryaga,1820,355,8,4,12,66.7%,31m
46855,1,[Ogz]Starshooter,1820,172,5,7,12,41.7%,24m
46855,3,HaiHo,1820,0,2,4,6,33.3%,49m
46855,1,TandT,1820,106,2,7,9,22.2%,45m
46855,1,DarkFenris,1820,44,1,4,5,20.0%,40m
46855,3,mourou,1820,0,1,5,6,16.7%,47m
46855,3,Berggnom,1820,0,1,6,7,14.3%,33m
46862,3,PREDATOR,1819,448,14,22,36,38.9%,4m
46862,3,Limon,1819,304,10,22,32,31.2%,46m
46862,2,Macelek,1819,0,1,0,1,100.0%,17m
46862,1,Zak,1819,0,0,1,1,0.0%,30m
46866,1,Allerdings,1818,446,13,14,27,48.1%,38m
46866,1,[u2b]Shadowkill,1818,0,1,4,5,20.0%,29m
46866,3,Erwin,1818,30,1,6,7,14.3%,21m
46866,1,[EnFi]Jakubsek,1818,0,0,1,1,0.0%,32m
46866,1,guyvers,1818,0,0,6,6,0.0%,24m
46871,1,[Siguan]Aelin,1817,130,3,7,10,30.0%,30m
46871,1,Pelia,1817,104,3,14,17,17.6%,28m
46871,1,DuncanIdaho,1817,0,0,2,2,0.0%,30m
46871,1,Wweis,1817,73,0,3,3,0.0%,33m
46875,2,WingsOfFire,1816,1482,48,73,121,39.7%,35m
46875,1,[SDKG]AAZWARTEAM,1816,1544,43,57,100,43.0%,36m
46875,1,OberstBreit,1816,236,6,14,20,30.0%,33m
46875,3,Azog,1816,106,5,8,13,38.5%,55m
46875,3,momodevils,1816,104,4,0,4,100.0%,46m
46875,1,StarShine,1816,88,2,7,9,22.2%,37m
46875,1,[fafan]Godemperor,1816,117,1,9,10,10.0%,3m
46882,1,Swizzly,1815,606,15,19,34,44.1%,56m
46882,3,[deers]DERMAN,1815,0,1,4,5,20.0%,7m
46882,1,кирилл,1815,0,0,1,1,0.0%,35m
46885,3,SMOKYBANDIT,1814,197,6,8,14,42.9%,1h
46885,2,[mpsi19]koteika,1814,220,6,14,20,30.0%,33m
46885,1,ElGringo,1814,218,5,4,9,55.6%,32m
46885,3,Niceguy,1814,145,3,7,10,30.0%,7m
46885,3,KSzab,1814,121,3,7,10,30.0%,31m
46885,2,jaki,1814,0,1,2,3,33.3%,35m
46885,1,Généraux,1814,0,0,2,2,0.0%,53m
46892,1,Speda,1813,1105,38,34,72,52.8%,43m
46892,1,DedBulachnik,1813,44,2,1,3,66.7%,35m
46892,1,Aapdo,1813,0,1,0,1,100.0%,30m
46892,1,RichDenaRd,1813,88,1,8,9,11.1%,32m
46892,1,pavel,1813,73,1,9,10,10.0%,26m
46892,3,[BULB]Faraday,1813,0,0,1,1,0.0%,47m
46898,2,kvent,1812,998,35,55,90,38.9%,1h
46898,3,evgen,1812,370,25,38,63,39.7%,41m
46898,3,[GrimCl]WannaBGrimus,1812,46,1,9,10,10.0%,18m
46898,1,КОМАР,1812,0,0,5,5,0.0%,2m
46902,2,[xCrüe]Strykker,1811,0,0,1,1,0.0%,54m
46902,3,asease,1811,0,0,2,2,0.0%,45m
46904,2,Rysiek,1810,305,38,60,98,38.8%,21m
46904,1,ВАСИЛИЙ,1810,44,1,6,7,14.3%,30m
46904,1,[2ПУПСА]Catindead,1810,0,0,1,1,0.0%,36m
46907,1,Geamurd,1809,132,4,4,8,50.0%,40m
46907,2,Aurumъ,1809,42,1,3,4,25.0%,54m
46907,1,Hunter,1809,94,1,4,5,20.0%,17m
46910,1,Damjan,1808,181,5,10,15,33.3%,1h
46910,1,Hellson,1808,92,3,4,7,42.9%,48m
46912,3,hashmalator,1807,452,16,17,33,48.5%,25m
46912,3,Sjokola,1807,236,7,11,18,38.9%,17m
46912,1,ваня,1807,171,4,6,10,40.0%,2m
46915,3,Peter,1806,544,20,29,49,40.8%,22m
46915,1,MoeLester,1806,224,6,3,9,66.7%,18m
46915,1,Persching,1806,256,6,9,15,40.0%,48m
46915,2,Überheld,1806,152,5,15,20,25.0%,2m
46915,2,filipMKD,1806,120,2,11,13,15.4%,13m
46915,1,Affliction,1806,0,0,5,5,0.0%,35m
46915,1,genar,1806,0,0,5,5,0.0%,46m
46915,3,DEN,1806,0,0,7,7,0.0%,7m
46923,1,Daklen,1805,698,19,19,38,50.0%,29m
46923,2,connar,1805,196,7,15,22,31.8%,6m
46923,2,silver,1805,146,4,14,18,22.2%,35m
46923,3,joki,1805,62,2,10,12,16.7%,7m
46923,1,[Llcg]Padutou,1805,0,0,3,3,0.0%,8m
46928,1,Khary,1804,655,15,19,34,44.1%,44m
46928,3,Interceptor,1804,140,4,14,18,22.2%,30m
46928,1,hulk,1804,42,1,3,4,25.0%,29m
46928,3,[ANREN]zergling,1804,0,0,2,2,0.0%,21m
46932,3,sebu,1803,1530,76,106,182,41.8%,29m
46932,1,Amadeus,1803,840,34,50,84,40.5%,36m
46932,1,patriots,1803,418,10,23,33,30.3%,37m
46932,1,Nowator,1803,300,7,8,15,46.7%,35m
46932,2,[corbs]Brenda,1803,155,5,5,10,50.0%,51m
46937,2,bob,1802,200,7,16,23,30.4%,58m
46937,3,Spleyn,1802,32,1,1,2,50.0%,51m
46937,2,KrissieBabes,1802,0,0,4,4,0.0%,14m
46937,3,Absorblol,1802,0,0,8,8,0.0%,22m
46941,3,Billibons,1801,1453,66,91,157,42.0%,54m
46941,3,younes,1801,434,16,24,40,40.0%,30m
46941,1,Иван,1801,338,8,13,21,38.1%,44m
46941,1,[ARGUAL]ACOSTA,1801,215,5,19,24,20.8%,18m
46941,1,BatlleAnt,1801,0,0,1,1,0.0%,20m
46946,2,[GAMI]OlivFR,1800,1502,131,144,275,47.6%,7m
46946,1,Raph,1800,463,11,20,31,35.5%,28m
46946,1,Fiodor,1800,186,4,7,11,36.4%,30m
46946,1,Biwan,1800,147,3,15,18,16.7%,43m
46946,1,SirXL,1800,0,1,0,1,100.0%,18m
46946,1,[NCRZ]BarbeBlonde,1800,48,1,4,5,20.0%,20m
46946,1,picachulon,1800,0,0,1,1,0.0%,3m
46953,1,saker,1799,1746,81,98,179,45.3%,37m
46953,1,ShadowDragon,1799,1386,39,46,85,45.9%,29m
46953,1,dovchar,1799,1278,36,54,90,40.0%,53m
46953,1,[mfxed]igor,1799,644,16,30,46,34.8%,8m
46953,1,[971]Gwad,1799,282,7,13,20,35.0%,15m
46953,1,Kurgan,1799,244,6,11,17,35.3%,31m
46953,2,Averon,1799,176,4,12,16,25.0%,6m
46953,1,CatLev,1799,134,3,3,6,50.0%,11m
46953,2,DARKTHANIT,1799,0,1,8,9,11.1%,6m
46953,1,LEGENDPLAYER,1799,0,0,1,1,0.0%,11m
46953,2,[XENT]Рафик,1799,0,0,1,1,0.0%,43m
46964,1,QawaS,1798,718,17,26,43,39.5%,33m
46964,1,Stefan,1798,292,6,7,13,46.2%,35m
46964,1,WArch,1798,274,6,11,17,35.3%,8m
46964,1,idontspekeng,1798,84,2,3,5,40.0%,20m
46968,1,Zavirit,1797,386,11,13,24,45.8%,36m
46968,1,[Zhig]TinebrisElv,1797,272,7,10,17,41.2%,43m
46968,2,flashbang,1797,173,6,9,15,40.0%,40m
46968,1,miky,1797,166,4,8,12,33.3%,32m
46968,2,Haydar,1797,168,4,16,20,20.0%,2m
46968,1,CROC,1797,0,2,3,5,40.0%,48m
46968,3,rocketboot,1797,92,1,9,10,10.0%,56m
46968,3,Zero,1797,0,1,10,11,9.1%,7m
46976,3,Яшья,1796,316,11,25,36,30.6%,12m
46976,3,Rambo,1796,325,10,21,31,32.3%,20m
46976,3,SerEgik,1796,62,2,16,18,11.1%,33m
46976,1,Deathitself,1796,0,1,6,7,14.3%,48m
46976,2,[Buddys]Demic,1796,0,0,7,7,0.0%,40m
46981,2,Elsa,1795,88,1,2,3,33.3%,54m
46981,2,Christin,1795,0,0,1,1,0.0%,8m
46981,1,[mfixed]stal,1795,0,0,1,1,0.0%,18m
46984,1,Saturas,1794,208,5,11,16,31.2%,29m
46984,1,RomaXa,1794,94,2,5,7,28.6%,53m
46984,3,qwark,1794,30,1,2,3,33.3%,30m
46984,3,gellos,1794,0,0,2,2,0.0%,53m
46988,1,aniilashongo,1793,609,16,23,39,41.0%,30m
46988,1,[SodsLV]billydominos,1793,286,9,12,21,42.9%,44m
46988,2,BUREWIK,1793,125,3,16,19,15.8%,6m
46988,1,Vegeta,1793,46,1,1,2,50.0%,30m
46988,1,Khabal,1793,0,0,1,1,0.0%,20m
46993,2,Andre,1792,160,8,12,20,40.0%,47m
46994,3,StrayCat,1791,620,26,31,57,45.6%,42m
46994,1,Davout,1791,934,26,33,59,44.1%,11m
46994,1,Betelgeuse,1791,132,5,16,21,23.8%,29m
46994,1,DoctorGonzo,1791,48,1,2,3,33.3%,20m
46998,3,chelas,1790,1125,48,60,108,44.4%,40m
46998,1,BadgerrOne,1790,901,24,34,58,41.4%,25m
46998,1,Materamoris,1790,558,13,17,30,43.3%,35m
46998,1,masegaz,1790,193,4,17,21,19.0%,45m
46998,1,Dani,1790,90,3,2,5,60.0%,48m
46998,3,[ARFA]KingDylan,1790,68,3,9,12,25.0%,27m
46998,1,Alejandro,1790,80,2,3,5,40.0%,46m
46998,1,illgritz,1790,0,0,2,2,0.0%,38m
47006,3,aspide,1789,1448,82,96,178,46.1%,57m
47006,1,luktatinator,1789,642,23,41,64,35.9%,1h
47006,1,macsas,1789,124,3,4,7,42.9%,40m
47006,3,[АУЕШКИ]Cobainkillme,1789,149,3,12,15,20.0%,53m
47006,1,kruiz,1789,46,1,2,3,33.3%,36m
47006,3,ROBAQ,1789,0,0,7,7,0.0%,13m
47012,1,chimadan,1788,401,13,7,20,65.0%,28m
47012,3,Freeman,1788,260,9,18,27,33.3%,44m
47012,1,Lev,1788,0,0,2,2,0.0%,35m
47012,3,Spoutnik,1788,0,0,5,5,0.0%,3m
47012,1,sanek,1788,0,0,6,6,0.0%,8m
47012,3,lukasow,1788,0,0,10,10,0.0%,7m
47018,3,office,1787,529,19,26,45,42.2%,26m
47018,1,Nicodemus,1787,179,4,15,19,21.1%,21m
47018,1,dimavydrin,1787,46,1,3,4,25.0%,28m
47018,1,Aiexia,1787,0,1,10,11,9.1%,41m
47018,3,Nedved,1787,0,0,8,8,0.0%,22m
47023,2,bartolinsko,1786,639,23,42,65,35.4%,54m
47023,1,fredi,1786,184,5,9,14,35.7%,3m
47023,1,[DEDAL]Furno,1786,40,1,3,4,25.0%,3m
47023,1,halel,1786,0,0,1,1,0.0%,32m
47027,3,Андрей,1785,1549,122,155,277,44.0%,50m
47027,1,Bâhlrok,1785,520,14,12,26,53.8%,29m
47027,1,[0mega]Wiseguys,1785,399,10,13,23,43.5%,37m
47027,1,Сильверблу,1785,108,1,10,11,9.1%,44m
47027,3,Töminator,1785,0,0,8,8,0.0%,8m
47032,3,[4453]Ganzyll,1784,838,27,40,67,40.3%,55m
47032,3,Jamboy,1784,231,6,17,23,26.1%,4m
47032,2,franksch,1784,148,3,12,15,20.0%,46m
47032,1,EGORIUS,1784,94,2,10,12,16.7%,39m
47032,3,jonika,1784,0,0,3,3,0.0%,47m
47037,1,MAD,1783,1360,40,44,84,47.6%,45m
47037,1,marius,1783,178,4,4,8,50.0%,33m
47037,1,гриша,1783,84,4,4,8,50.0%,30m
47037,2,KRIN,1783,0,4,7,11,36.4%,45m
47037,1,IDsDaddy,1783,148,3,3,6,50.0%,38m
47037,2,[RBCOMM]GeNiUSssS,1783,30,1,10,11,9.1%,16m
47043,1,ECNS,1782,268,6,10,16,37.5%,20m
47043,3,[4EK]Robotix,1782,0,1,0,1,100.0%,37m
47045,3,Tim,1781,247,8,11,19,42.1%,10m
47045,1,dervovan,1781,0,1,0,1,100.0%,35m
47045,3,Splash,1781,30,1,8,9,11.1%,1h
47045,1,Marko,1781,0,0,1,1,0.0%,3m
47049,1,AYA,1780,690,19,26,45,42.2%,32m
47049,1,Анисим,1780,111,3,7,10,30.0%,25m
47049,3,Markus,1780,60,2,6,8,25.0%,18m
47049,1,Alectius,1780,0,1,3,4,25.0%,33m
47049,1,Swemeer,1780,0,0,1,1,0.0%,24m
47054,1,joseluis,1779,88,3,4,7,42.9%,44m
47054,1,max,1779,46,2,0,2,100.0%,58m
47054,3,Jocovitj,1779,30,2,2,4,50.0%,46m
47054,3,breadboi,1779,0,2,6,8,25.0%,51m
47054,1,AlarickSama,1779,44,1,1,2,50.0%,32m
47054,1,Roman,1779,102,1,6,7,14.3%,53m
47054,1,[FR1]Mikay,1779,88,1,8,9,11.1%,46m
47054,1,PoolShark,1779,0,0,1,1,0.0%,37m
47054,3,Zeratul,1779,0,0,2,2,0.0%,3m
47063,3,mkmk,1778,820,29,48,77,37.7%,38m
47063,3,MarkocEUrus,1778,651,24,27,51,47.1%,42m
47063,1,AHAB,1778,325,9,23,32,28.1%,53m
47063,3,Ziffa,1778,0,0,8,8,0.0%,58m
47067,3,FITZ,1777,578,19,34,53,35.8%,6m
47067,1,NitramGA,1777,621,16,11,27,59.3%,36m
47067,1,[KaLaRu]СанТехник,1777,243,6,11,17,35.3%,20m
47067,3,akalexus,1777,0,0,3,3,0.0%,18m
47067,3,muk,1777,0,0,8,8,0.0%,27m
47072,3,АлексейVDL,1776,122,5,8,13,38.5%,49m
47072,2,atam,1776,129,3,12,15,20.0%,4m
47072,3,raidnoresion,1776,0,1,0,1,100.0%,55m
47072,2,[AOTW]Gaben,1776,40,1,3,4,25.0%,17m
47072,2,ThorsHammer,1776,40,1,4,5,20.0%,44m
47072,1,MSHD,1776,0,0,1,1,0.0%,43m
47078,3,Sanches,1775,1393,137,174,311,44.1%,7m
47078,2,Sander,1775,166,5,7,12,41.7%,55m
47078,2,SwatRuss,1775,150,5,9,14,35.7%,47m
47081,1,Anton,1774,524,14,20,34,41.2%,30m
47081,1,Aurèle,1774,246,7,14,21,33.3%,32m
47081,1,Кулибякин,1774,119,1,5,6,16.7%,43m
47084,1,СмертоМышь,1773,949,28,37,65,43.1%,1h
47084,1,Blue,1773,770,20,36,56,35.7%,32m
47084,3,Karamise,1773,463,16,30,46,34.8%,35m
47084,3,hbhbh,1773,180,7,13,20,35.0%,42m
47084,3,VDE,1773,0,1,6,7,14.3%,50m
47089,1,Joshuaswanep,1772,1278,36,64,100,36.0%,33m
47089,1,Andopando,1772,302,8,3,11,72.7%,3m
47089,1,KAROL,1772,220,4,7,11,36.4%,43m
47089,3,LuissPedro,1772,0,0,5,5,0.0%,39m
47093,1,sinner,1771,241,6,1,7,85.7%,31m
47093,2,Unreall,1771,226,6,12,18,33.3%,17m
47093,1,geust,1771,188,4,9,13,30.8%,26m
47093,1,AlexUA,1771,191,3,12,15,20.0%,40m
47097,1,SONOFJESUZ,1770,827,26,37,63,41.3%,28m
47097,1,RMMD,1770,912,23,33,56,41.1%,53m
47097,1,Dariusz,1770,450,10,21,31,32.3%,53m
47097,1,Dami,1770,138,4,7,11,36.4%,26m
47097,3,Miguelsd,1770,0,1,1,2,50.0%,3m
47102,1,DeGuN,1769,80,3,13,16,18.8%,18m
47103,1,CroDoc,1768,424,10,11,21,47.6%,57m
47103,2,HISPANOLATIN,1768,88,4,7,11,36.4%,52m
47103,3,Infinity,1768,0,0,5,5,0.0%,46m
47106,3,SimplyBest,1767,1496,108,142,250,43.2%,37m
47106,3,Pucio,1767,1418,92,107,199,46.2%,25m
47106,1,Hendrik,1767,1318,69,84,153,45.1%,53m
47106,1,Baahll,1767,1581,44,61,105,41.9%,32m
47106,1,[ANREN]Stalex,1767,278,6,9,15,40.0%,15m
47106,3,Pazifist,1767,0,1,0,1,100.0%,49m
47106,3,EpsToDay,1767,0,0,7,7,0.0%,10m
47113,3,alex,1766,589,19,29,48,39.6%,29m
47113,1,Cezus,1766,432,11,22,33,33.3%,39m
47113,1,Jugien,1766,218,5,19,24,20.8%,35m
47113,2,Hudson,1766,0,1,1,2,50.0%,45m
47113,3,Ducke,1766,0,0,6,6,0.0%,18m
47118,1,[MATMAR]WolfMage,1765,406,10,13,23,43.5%,35m
47118,1,BeatMe,1765,386,9,9,18,50.0%,1h
47118,2,SilentStorm,1765,212,7,19,26,26.9%,55m
47118,1,[NINJ88]BaBaZoN,1765,30,2,10,12,16.7%,29m
47122,3,SilentSword,1764,384,13,24,37,35.1%,43m
47122,3,Kasa,1764,412,12,28,40,30.0%,58m
47124,1,flamedk,1763,622,17,22,39,43.6%,38m
47124,1,Leeham,1763,242,11,24,35,31.4%,37m
47124,3,BlackNalym,1763,88,6,10,16,37.5%,4m
47124,3,ZOMLJHGT,1763,0,2,4,6,33.3%,6m
47124,1,LADICUS,1763,48,1,8,9,11.1%,39m
47129,1,Zoélixe,1762,612,16,22,38,42.1%,29m
47129,1,FoxtrotUnion,1762,256,6,11,17,35.3%,17m
47129,3,Dondamiano,1762,30,2,4,6,33.3%,55m
47132,2,[13NRV]виктор,1761,1491,55,84,139,39.6%,24m
47132,1,[3DTOSS]xeron,1761,655,23,28,51,45.1%,11m
47132,1,Atilla,1761,102,2,1,3,66.7%,32m
47132,2,Lethal,1761,46,2,9,11,18.2%,56m
47132,1,LePresident,1761,0,1,0,1,100.0%,28m
47137,1,Joldas,1760,663,18,24,42,42.9%,23m
47137,1,[ITmani]isoka,1760,90,4,5,9,44.4%,20m
47139,1,maxi,1759,154,5,18,23,21.7%,42m
47139,1,Tamarillo,1759,0,0,3,3,0.0%,8m
47141,1,Косикос,1758,487,10,15,25,40.0%,46m
47141,1,Artanis,1758,176,5,8,13,38.5%,43m
47141,1,Cocopops,1758,0,1,7,8,12.5%,35m
47141,1,Fes,1758,0,0,2,2,0.0%,37m
47141,3,Kjonen,1758,0,0,3,3,0.0%,6m
47146,1,mav,1757,592,15,22,37,40.5%,11m
47146,3,Evgeshka,1757,223,8,18,26,30.8%,39m
47146,1,Мегалкарвен,1757,0,0,1,1,0.0%,32m
47149,1,MarshElll,1756,247,4,8,12,33.3%,53m
47149,3,Владислав,1756,78,2,11,13,15.4%,23m
47149,3,Littleship,1756,0,1,0,1,100.0%,30m
47152,3,Scôrp,1755,598,18,36,54,33.3%,57m
47152,2,Roman,1755,161,3,13,16,18.8%,17m
47152,1,WendigerDax,1755,0,1,6,7,14.3%,32m
47152,3,Miro,1755,0,0,1,1,0.0%,46m
47152,1,Morphologic,1755,0,0,1,1,0.0%,32m
47157,1,[DL2006]Exdar,1754,0,1,0,1,100.0%,35m
47157,1,DragonSid,1754,44,1,10,11,9.1%,31m
47157,3,ixTrustME,1754,0,0,1,1,0.0%,39m
47157,1,ZmeuNinja,1754,0,0,1,1,0.0%,18m
47161,3,Tassadar,1753,1201,79,99,178,44.4%,55m
47161,1,Bart,1753,557,16,20,36,44.4%,43m
47161,1,smoukywhail,1753,324,15,15,30,50.0%,58m
47161,2,JacobX,1753,195,6,4,10,60.0%,5m
47161,3,AleksKalin,1753,86,3,8,11,27.3%,10m
47161,3,Drachenkrieg,1753,0,1,4,5,20.0%,53m
47161,3,Turbo,1753,34,1,4,5,20.0%,49m
47161,1,Bomje,1753,0,0,10,10,0.0%,3m
47169,2,SETISHE,1752,284,10,19,29,34.5%,1h
47169,1,PACIU,1752,300,7,13,20,35.0%,31m
47169,1,Practice,1752,162,5,9,14,35.7%,31m
47169,1,deathcore,1752,138,4,5,9,44.4%,49m
47169,2,[IDPZ]Midi,1752,184,4,9,13,30.8%,55m
47169,1,Ben,1752,169,3,10,13,23.1%,26m
47175,1,Tolik,1751,508,16,16,32,50.0%,28m
47175,1,zandwitch,1751,296,8,13,21,38.1%,36m
47175,3,Gwan,1751,98,3,13,16,18.8%,8m
47175,3,kanamuna,1751,0,0,1,1,0.0%,53m
47179,3,GianaSisters,1750,118,4,15,19,21.1%,1h
47179,1,nevesbm,1750,0,0,1,1,0.0%,53m
47181,1,rambojonx,1749,1787,56,74,130,43.1%,25m
47181,1,ratanixll,1749,1152,31,48,79,39.2%,46m
47181,3,XXX,1749,96,2,14,16,12.5%,8m
47181,1,[EliteX]Feuerrabe,1749,0,0,1,1,0.0%,35m
47185,1,karsten,1748,713,20,22,42,47.6%,17m
47185,1,psine,1748,412,10,16,26,38.5%,15m
47185,1,ПУПСback,1748,318,9,15,24,37.5%,1h
47185,2,[SEBULA]mixedmix,1748,0,1,7,8,12.5%,40m
47185,1,Stalker,1748,73,0,3,3,0.0%,53m
47190,1,крутов,1747,138,3,7,10,30.0%,36m
47190,3,Kamenia,1747,0,0,5,5,0.0%,6m
47192,3,Karel,1746,947,36,40,76,47.4%,42m
47193,1,Uragan,1745,869,25,42,67,37.3%,35m
47193,3,ArtemAlmaz,1745,551,19,32,51,37.3%,50m
47193,1,ANNYULI,1745,471,13,17,30,43.3%,46m
47193,2,Threlgor,1745,231,7,7,14,50.0%,17m
47193,1,Frisbald,1745,255,7,9,16,43.8%,36m
47193,2,Seratul,1745,128,2,5,7,28.6%,43m
47193,1,Muppet,1745,0,0,2,2,0.0%,24m
47193,3,Gain,1745,0,0,2,2,0.0%,50m
47193,1,gter,1745,0,0,4,4,0.0%,32m
47202,1,[prosy9]eryk,1744,482,13,16,29,44.8%,40m
47202,3,[twnty]TOTORO,1744,265,9,19,28,32.1%,55m
47202,3,Turar,1744,150,4,7,11,36.4%,22m
47202,2,PanMIM,1744,145,3,7,10,30.0%,12m
47202,2,Sveturis,1744,0,1,0,1,100.0%,41m
47202,1,sorinel,1744,0,1,1,2,50.0%,36m
47208,1,MegaMax,1743,217,4,15,19,21.1%,39m
47208,1,Reptil,1743,0,0,2,2,0.0%,30m
47210,3,Gallifan,1742,391,19,33,52,36.5%,57m
47210,1,mrwoops,1742,46,2,0,2,100.0%,38m
47210,1,emilius,1742,0,0,3,3,0.0%,18m
47213,1,PiratRoger,1741,231,5,9,14,35.7%,35m
47213,3,kirk,1741,40,1,9,10,10.0%,18m
47213,3,LEO,1741,0,0,4,4,0.0%,13m
47216,1,ramon,1740,0,4,2,6,66.7%,2m
47216,3,PolishFox,1740,30,1,10,11,9.1%,58m
47218,1,Selva,1739,130,3,9,12,25.0%,2m
47218,3,emdor,1739,0,0,1,1,0.0%,18m
47218,3,Tchukomo,1739,0,0,9,9,0.0%,21m
47221,1,[SW69]Uchiha,1738,462,14,11,25,56.0%,35m
47221,1,Yamaraj,1738,227,6,8,14,42.9%,26m
47221,3,Paliers,1738,0,0,1,1,0.0%,36m
47224,1,[VzA]ДикийВолк,1737,357,9,15,24,37.5%,40m
47224,1,CancelALEX,1737,92,5,5,10,50.0%,39m
47226,1,CrazyCat,1736,426,10,22,32,31.2%,46m
47226,2,[CS0]harken,1736,231,8,8,16,50.0%,25m
47226,1,LucTheTerror,1736,187,6,6,12,50.0%,35m
47226,3,[Рrobe]BabahaKus,1736,94,3,14,17,17.6%,46m
47226,1,SonD,1736,84,2,2,4,50.0%,18m
47226,3,Shei,1736,0,1,2,3,33.3%,30m
47226,1,VoVmx,1736,48,1,5,6,16.7%,18m
47226,3,[D3L]JJxDUB,1736,0,0,8,8,0.0%,50m
47234,1,GACELA,1735,1624,45,64,109,41.3%,11m
47234,1,aleksei,1735,250,6,20,26,23.1%,49m
47234,1,[Man1ch]STOK,1735,209,5,1,6,83.3%,26m
47234,1,Jeroenrm,1735,48,2,3,5,40.0%,43m
47238,1,[LSDXIX]SummerSnow,1733,1280,34,46,80,42.5%,3m
47238,1,VAVA,1733,164,3,10,13,23.1%,30m
47238,1,STARK,1733,48,1,2,3,33.3%,44m
47241,1,KingGodzilla,1732,288,8,33,41,19.5%,11m
47241,1,Каа,1732,124,4,4,8,50.0%,33m
47241,1,[7STAR]Prejudice,1732,48,1,4,5,20.0%,46m
47244,1,OneForYou,1731,505,13,22,35,37.1%,1h
47244,1,mathias,1731,506,12,16,28,42.9%,36m
47244,1,PepsiMax,1731,406,12,18,30,40.0%,41m
47244,1,Redhead,1731,226,5,10,15,33.3%,44m
47244,1,CryptoG,1731,94,3,7,10,30.0%,39m
47249,3,[MF5]Stengo,1730,240,10,19,29,34.5%,10m
47249,3,Freedom,1730,0,1,8,9,11.1%,49m
47251,3,Mati,1729,829,34,47,81,42.0%,1h
47251,3,MalyshVShoko,1729,30,2,1,3,66.7%,7m
47251,1,aras,1729,90,2,6,8,25.0%,32m
47251,1,darkviper,1729,0,1,4,5,20.0%,26m
47255,1,Vince,1728,128,3,6,9,33.3%,38m
47255,2,Yuriy,1728,88,1,2,3,33.3%,18m
47255,3,ловкий,1728,0,0,10,10,0.0%,1h
47258,1,Zavr,1727,267,9,13,22,40.9%,1h
47258,3,Miracle,1727,172,6,9,15,40.0%,55m
47258,3,Romulus,1727,160,5,18,23,21.7%,46m
47258,3,Demon,1727,0,0,1,1,0.0%,45m
47258,1,Crabby,1727,0,0,1,1,0.0%,33m
47263,1,LiliMora,1726,1330,44,61,105,41.9%,26m
47263,1,IIIIIIIIIIII,1726,241,7,4,11,63.6%,25m
47263,3,JabbaElJack,1726,30,2,0,2,100.0%,25m
47266,1,missC,1724,620,16,21,37,43.2%,3m
47266,1,Oribie,1724,348,9,11,20,45.0%,15m
47266,1,[VSC2]MSF,1724,390,9,17,26,34.6%,43m
47266,3,lagunero,1724,0,1,7,8,12.5%,12m
47266,1,wiesiek,1724,73,0,7,7,0.0%,1h
47271,3,Quartermaine,1723,554,16,31,47,34.0%,58m
47271,1,[Temeri]zorg,1723,169,2,7,9,22.2%,2m
47271,3,SNOWPATROL,1723,0,0,3,3,0.0%,39m
47274,1,Brags,1722,1045,43,44,87,49.4%,11m
47274,3,DarKCat,1722,520,19,38,57,33.3%,9m
47274,1,LackofRex,1722,80,2,10,12,16.7%,43m
47274,1,Gigi,1722,0,0,1,1,0.0%,18m
47274,3,XcoveR,1722,0,0,1,1,0.0%,36m
47274,3,Varus,1722,0,0,7,7,0.0%,7m
47280,1,jbsmoke,1721,1798,78,103,181,43.1%,20m
47280,3,Gotfrid,1721,0,0,1,1,0.0%,51m
47280,1,Destroyer,1721,0,0,1,1,0.0%,11m
47280,3,greg,1721,0,0,9,9,0.0%,45m
47284,1,[SPAINs]Aimarace,1720,159,3,13,16,18.8%,20m
47284,2,solo,1720,0,0,1,1,0.0%,44m
47286,1,MackyFlou,1719,304,7,15,22,31.8%,20m
47286,1,ДимонОмон,1719,0,1,3,4,25.0%,1h
47288,1,Simsasimi,1718,618,23,34,57,40.4%,58m
47288,1,Xarcrom,1718,233,4,15,19,21.1%,45m
47290,3,[Cancro]NightMareCPU,1716,149,4,11,15,26.7%,8m
47290,1,gleb,1716,0,0,1,1,0.0%,28m
47290,1,jimjohanson,1716,0,0,3,3,0.0%,31m
47293,3,goliath,1715,822,53,67,120,44.2%,58m
47293,1,LOLтакНельзя,1715,228,5,15,20,25.0%,57m
47293,3,Francesco,1715,92,3,10,13,23.1%,1h
47293,3,Бибиджабал,1715,58,2,11,13,15.4%,10m
47293,1,Bananakin,1715,73,1,3,4,25.0%,31m
47293,1,devilsnake,1715,0,0,1,1,0.0%,3m
47299,3,джедай,1713,1429,148,164,312,47.4%,55m
47299,1,SolacoMan,1713,0,1,4,5,20.0%,3m
47299,3,Hatiman,1713,0,0,3,3,0.0%,21m
47302,1,Ermolay,1712,48,2,1,3,66.7%,40m
47302,3,Kallisthea,1712,0,1,5,6,16.7%,21m
47304,1,Asiya,1711,48,4,5,9,44.4%,43m
47304,1,Talito,1711,0,1,13,14,7.1%,21m
47304,1,Vrazer,1711,0,0,1,1,0.0%,26m
47307,1,husoo,1710,486,15,19,34,44.1%,32m
47307,1,LaserOptic,1710,243,6,19,25,24.0%,57m
47307,3,[JEDEEM]Petr,1710,0,0,1,1,0.0%,53m
47307,3,Pavel,1710,0,0,1,1,0.0%,18m
47307,1,luntik,1710,73,0,3,3,0.0%,38m
47307,3,Mafiaboss,1710,0,0,5,5,0.0%,30m
47313,3,TEXproROI,1709,418,13,33,46,28.3%,1h
47313,2,Triskkell,1709,0,1,5,6,16.7%,17m
47313,1,simoKw,1709,0,0,4,4,0.0%,11m
47313,3,Diamond,1709,0,0,4,4,0.0%,55m
47317,1,EnTaro,1708,374,9,14,23,39.1%,29m
47317,1,ZergRanger,1708,62,3,12,15,20.0%,4m
47319,1,SkyWorrier,1707,656,17,24,41,41.5%,33m
47320,1,[krotSC]jom,1706,417,12,15,27,44.4%,58m
47320,1,Perets,1706,267,8,7,15,53.3%,53m
47320,3,gruso,1706,271,7,21,28,25.0%,29m
47320,3,Ian,1706,0,1,1,2,50.0%,21m
47320,3,VOLiMBUREK,1706,0,1,4,5,20.0%,37m
47320,1,FoXXoF,1706,0,0,1,1,0.0%,53m
47326,1,Rublo,1705,1206,35,49,84,41.7%,37m
47326,2,tibtill,1705,0,2,18,20,10.0%,35m
47326,1,TakSiakStef,1705,0,1,0,1,100.0%,37m
47326,3,CastorTroy,1705,0,1,4,5,20.0%,53m
47326,3,Halion,1705,0,0,1,1,0.0%,24m
47326,1,[SC2CAT]XDcat,1705,0,0,3,3,0.0%,26m
47332,2,Han,1704,1498,47,81,128,36.7%,20m
47332,2,Dune,1704,146,4,4,8,50.0%,2m
47332,1,Creative,1704,112,3,3,6,50.0%,35m
47332,3,[rkkd]LLLLLLLLLL,1704,30,1,10,11,9.1%,6m
47332,3,HaSSaSiN,1704,0,0,1,1,0.0%,6m
47337,2,sOs,1703,220,7,35,42,16.7%,24m
47337,3,alan,1703,235,6,21,27,22.2%,12m
47337,1,[Famlly]FirezzBoyz,1703,0,0,3,3,0.0%,3m
47340,1,ĐENERALE,1702,617,32,49,81,39.5%,24m
47340,1,ritz,1702,178,5,16,21,23.8%,41m
47340,3,Sharpblade,1702,62,2,11,13,15.4%,1h
47340,1,Picaasso,1702,0,1,4,5,20.0%,29m
47340,3,Konfed,1702,30,1,10,11,9.1%,39m
47345,3,DaDi,1701,266,8,49,57,14.0%,30m
47345,1,RainbowStar,1701,116,3,5,8,37.5%,38m
47345,3,Eder,1701,0,2,4,6,33.3%,18m
47345,1,Bestpedro,1701,42,1,2,3,33.3%,6m
47345,1,xera,1701,46,1,3,4,25.0%,8m
47350,1,RYP,1699,1454,51,84,135,37.8%,37m
47350,1,ShotInjectio,1699,821,20,34,54,37.0%,35m
47350,1,Marina,1699,465,12,24,36,33.3%,20m
47350,1,MISTERLOBO,1699,368,9,19,28,32.1%,15m
47350,1,MASTER,1699,185,4,4,8,50.0%,44m
47350,2,[DTST]Active,1699,0,2,9,11,18.2%,57m
47356,1,Pablo,1698,1873,87,113,200,43.5%,31m
47356,2,neville,1698,227,7,14,21,33.3%,17m
47356,2,Lazerturken,1698,80,2,14,16,12.5%,45m
47356,1,Friedrich,1698,48,1,4,5,20.0%,20m
47356,3,Nereide,1698,0,1,4,5,20.0%,2m
47361,1,miki,1697,0,3,4,7,42.9%,1h
47361,1,Jirecstu,1697,0,0,4,4,0.0%,8m
47363,1,Intakt,1696,498,14,23,37,37.8%,17m
47363,3,Hawkx,1696,178,8,9,17,47.1%,2m
47363,1,gun,1696,73,1,2,3,33.3%,11m
47363,1,DjantMan,1696,0,0,1,1,0.0%,3m
47367,1,daniii,1695,1523,60,75,135,44.4%,57m
47367,1,Gighen,1695,307,10,22,32,31.2%,23m
47367,1,SirTobi,1695,279,9,17,26,34.6%,32m
47367,3,[Chaven]Jirnnobruh,1695,0,1,4,5,20.0%,39m
47371,1,[TESIL]IBUPROFENO,1694,645,26,46,72,36.1%,11m
47371,3,тим,1694,106,3,14,17,17.6%,8m
47371,1,jeema,1694,0,1,1,2,50.0%,39m
47374,3,[FR1]KaltenCPN,1693,812,28,34,62,45.2%,6m
47374,1,Вырвиглаз,1693,283,9,11,20,45.0%,15m
47374,3,Storm,1693,164,5,11,16,31.2%,53m
47374,1,manolea,1693,0,3,3,6,50.0%,26m
47378,3,Taurys,1692,126,4,14,18,22.2%,12m
47378,3,Valkorion,1692,34,2,7,9,22.2%,30m
47378,3,[glhf20]Phil,1692,0,2,9,11,18.2%,19m
47381,1,AlexRION,1691,665,26,30,56,46.4%,18m
47381,1,Bumblebeebat,1691,506,12,27,39,30.8%,53m
47381,1,Silver,1691,254,6,19,25,24.0%,6m
47381,1,[БУБУБ]ValeraZeRg,1691,119,3,4,7,42.9%,2m
47381,2,Itachi,1691,163,3,15,18,16.7%,45m
47381,1,SnowZ,1691,90,2,6,8,25.0%,3m
47381,3,MegaTavusSCS,1691,0,0,4,4,0.0%,55m
47388,1,DaringSVK,1690,263,18,0,18,100.0%,40m
47388,1,Zombiakkk,1690,231,5,6,11,45.5%,26m
47388,1,MaxW,1690,73,0,6,6,0.0%,28m
47391,3,[Denied]Robert,1689,0,0,3,3,0.0%,50m
47391,1,Schleuse,1689,0,0,3,3,0.0%,37m
47393,1,Nichts,1688,441,10,26,36,27.8%,18m
47393,1,Platinum,1688,291,7,22,29,24.1%,36m
47393,3,Julien,1688,62,3,9,12,25.0%,46m
47393,3,ERDEM,1688,0,0,1,1,0.0%,55m
47393,3,Bravehart,1688,0,0,2,2,0.0%,18m
47398,2,Mahlzahn,1687,163,3,14,17,17.6%,33m
47398,1,Cobalt,1687,138,2,3,5,40.0%,33m
47400,1,[CAI]Clem,1686,448,11,22,33,33.3%,40m
47400,3,VALENTOR,1686,64,6,11,17,35.3%,53m
47400,2,Jkq,1686,84,2,14,16,12.5%,31m
47400,2,Azirov,1686,0,0,4,4,0.0%,37m
47404,2,adriannic,1685,100,1,3,4,25.0%,51m
47405,1,stanley,1684,106,2,3,5,40.0%,2m
47406,2,edy,1683,0,0,1,1,0.0%,41m
47407,3,Colin,1682,1468,57,75,132,43.2%,4m
47407,1,papyrus,1682,412,9,24,33,27.3%,29m
47407,2,UrKo,1682,74,3,1,4,75.0%,50m
47407,3,LaBrique,1682,60,3,6,9,33.3%,37m
47407,2,kemo,1682,48,1,4,5,20.0%,38m
47412,1,legcyofthevo,1681,114,3,3,6,50.0%,16m
47413,3,stimpack,1680,0,1,5,6,16.7%,45m
47414,3,Treydor,1679,352,13,31,44,29.5%,7m
47414,1,Dartes,1679,140,3,8,11,27.3%,31m
47416,2,Argus,1678,0,1,0,1,100.0%,17m
47417,3,bandit,1677,76,5,8,13,38.5%,55m
47417,1,FakeIIIIIIII,1677,112,2,7,9,22.2%,24m
47419,3,[IceCub]EГОР,1675,670,21,41,62,33.9%,21m
47419,1,Stifler,1675,0,1,8,9,11.1%,35m
47421,3,Imperator,1674,58,3,5,8,37.5%,39m
47421,3,Jaybo,1674,0,2,2,4,50.0%,45m
47423,1,[MaG6i]liviumoc,1673,1858,138,216,354,39.0%,44m
47423,1,Sesalin,1673,489,11,25,36,30.6%,32m
47423,3,davidrisko,1673,0,2,3,5,40.0%,49m
47423,1,erikeriksson,1673,48,1,4,5,20.0%,57m
47427,1,Sigma,1672,1042,31,37,68,45.6%,46m
47427,1,Tarazar,1672,453,18,17,35,51.4%,38m
47427,3,Matthekube,1672,100,3,4,7,42.9%,21m
47427,1,JOHNJOHN,1672,48,3,7,10,30.0%,49m
47431,2,taharounalli,1671,176,5,4,9,55.6%,41m
47431,1,Модный,1671,121,1,10,11,9.1%,40m
47431,3,Mahoney,1671,0,0,1,1,0.0%,39m
47434,1,Sharphorn,1669,355,10,11,21,47.6%,1h
47434,1,Ramzai,1669,0,1,4,5,20.0%,37m
47434,3,ARTANIS,1669,0,0,4,4,0.0%,28m
47434,3,Phu,1669,0,0,9,9,0.0%,51m
47438,1,nightswing,1668,124,5,20,25,20.0%,26m
47438,2,Печенка,1668,0,0,1,1,0.0%,54m
47440,3,[ASUFR]ultimefourbe,1667,885,34,55,89,38.2%,4m
47440,1,Leosteps,1667,96,4,18,22,18.2%,38m
47440,1,Nefero,1667,161,3,17,20,15.0%,1h
47443,1,Endymion,1666,939,30,48,78,38.5%,31m
47444,1,hawkeye,1665,136,3,9,12,25.0%,44m
47445,1,ChanSolo,1664,0,1,12,13,7.7%,44m
47445,2,łysyśledź,1664,0,0,11,11,0.0%,50m
47447,1,Archangel,1663,1190,36,65,101,35.6%,26m
47447,3,[xHaoSx]LOLBIT,1663,32,2,7,9,22.2%,51m
47447,2,RompiOssa,1663,0,1,4,5,20.0%,6m
47450,2,JEDREK,1662,354,10,17,27,37.0%,40m
47450,1,Meliodas,1662,259,8,10,18,44.4%,31m
47452,1,surprzAttach,1661,576,18,16,34,52.9%,27m
47452,3,CREAM,1661,0,1,2,3,33.3%,6m
47452,2,JOXIS,1661,0,1,12,13,7.7%,6m
47455,2,Turambar,1660,114,4,10,14,28.6%,31m
47456,3,Scoolboy,1659,486,18,34,52,34.6%,52m
47456,1,[Meavv]foca,1659,316,14,13,27,51.9%,26m
47456,3,[STRCPS]PROtos,1659,0,0,5,5,0.0%,19m
47459,3,PROTOS,1658,116,3,9,12,25.0%,24m
47459,3,[умри]хреножук,1658,0,0,9,9,0.0%,53m
47461,1,TrBloodAngel,1656,0,0,8,8,0.0%,25m
47462,1,mel,1655,0,0,3,3,0.0%,1h
47463,1,Legeoner,1653,254,6,16,22,27.3%,25m
47463,1,Psilzar,1653,144,2,13,15,13.3%,33m
47463,2,cygan,1653,40,1,1,2,50.0%,17m
47463,3,VoidStranger,1653,30,1,7,8,12.5%,37m
47463,3,Cheburek,1653,30,1,11,12,8.3%,46m
47463,3,lantern,1653,0,0,2,2,0.0%,6m
47463,3,ItzBlue,1653,0,0,2,2,0.0%,18m
47470,3,TEX,1652,70,5,9,14,35.7%,53m
47471,2,KenanD,1651,538,15,38,53,28.3%,15m
47472,3,Dazla,1650,0,2,7,9,22.2%,6m
47473,2,myllenyum,1649,0,1,0,1,100.0%,45m
47473,1,dcl,1649,0,0,7,7,0.0%,32m
47475,1,Zipote,1648,1072,35,61,96,36.5%,35m
47475,1,Seb,1648,207,4,17,21,19.0%,11m
47475,3,kratos,1648,0,1,4,5,20.0%,21m
47475,3,GinaLisa,1648,0,0,1,1,0.0%,21m
47479,1,demoneSKILL,1647,1237,47,73,120,39.2%,25m
47480,1,TurbyHUN,1646,622,17,33,50,34.0%,53m
47480,1,WILK,1646,46,6,5,11,54.5%,32m
47482,2,Bosley,1645,297,10,15,25,40.0%,44m
47482,1,Ciripi,1645,46,1,6,7,14.3%,39m
47484,2,Merlin,1644,0,0,5,5,0.0%,37m
47485,3,[FAL1]Annotate,1643,80,4,3,7,57.1%,30m
47485,3,Hainex,1643,108,3,10,13,23.1%,8m
47485,1,SAIX,1643,0,1,6,7,14.3%,3m
47488,1,[ONru]Codeboy,1641,0,0,6,6,0.0%,53m
47489,3,Kobrettie,1640,0,0,1,1,0.0%,50m
47490,1,Donfriou,1639,84,3,18,21,14.3%,8m
47490,1,JEANPIERRE,1639,30,1,11,12,8.3%,43m
47492,3,Yanou,1638,0,0,10,10,0.0%,51m
47493,1,armageddon,1637,1015,31,43,74,41.9%,3m
47494,2,www,1636,864,26,39,65,40.0%,23m
47494,2,[GeeBZ]Shocker,1636,474,15,19,34,44.1%,14m
47494,3,Tecron,1636,280,10,33,43,23.3%,53m
47494,3,alicantes,1636,0,0,12,12,0.0%,55m
47498,2,ChmoEbanoe,1635,746,24,62,86,27.9%,6m
47499,1,florian,1634,550,16,30,46,34.8%,15m
47499,3,Archalia,1634,0,0,1,1,0.0%,36m
47501,3,kageyami,1633,0,1,1,2,50.0%,6m
47502,1,ZEWS,1632,599,18,29,47,38.3%,24m
47502,2,Alsi,1632,157,3,17,20,15.0%,54m
47502,3,PiouPiou,1632,30,1,4,5,20.0%,2m
47502,2,Fedux,1632,0,0,1,1,0.0%,37m
47506,2,Ullezan,1631,244,9,24,33,27.3%,55m
47506,3,Oxer,1631,30,1,2,3,33.3%,21m
47508,3,[PŖïMĄŁ]Gekkouga,1630,90,3,15,18,16.7%,1h
47509,3,ferry,1629,30,1,7,8,12.5%,2m
47510,2,asafhadar,1628,36,2,4,6,33.3%,55m
47510,2,Bullymong,1628,46,1,2,3,33.3%,41m
47512,1,goalpepsi,1626,712,20,35,55,36.4%,38m
47512,1,Dennis,1626,408,12,19,31,38.7%,17m
47512,3,Zee,1626,88,3,3,6,50.0%,50m
47512,2,Predator,1626,0,0,1,1,0.0%,50m
47516,2,Maciej,1625,374,10,17,27,37.0%,50m
47517,3,BERRIES,1622,255,8,15,23,34.8%,39m
47517,3,Адвенчу,1622,0,0,1,1,0.0%,45m
47519,1,[FF5EU]Kai,1621,268,7,16,23,30.4%,3m
47520,2,Daan,1619,126,2,8,10,20.0%,45m
47520,3,akakiy,1619,0,1,1,2,50.0%,55m
47520,3,Olo,1619,0,0,3,3,0.0%,37m
47523,1,DarkVoid,1618,94,3,19,22,13.6%,12m
47523,1,АРТУР,1618,0,1,8,9,11.1%,3m
47525,3,GFORCE,1617,30,1,8,9,11.1%,50m
47526,1,kot,1615,246,7,23,30,23.3%,58m
47526,2,Mirascael,1615,128,6,5,11,54.5%,37m
47528,2,[drain]assplay,1614,192,5,20,25,20.0%,8m
47528,3,Youps,1614,30,1,2,3,33.3%,37m
47528,2,[WPru]ramst,1614,0,0,1,1,0.0%,40m
47531,1,Shayne,1613,92,3,17,20,15.0%,31m
47531,1,гандурас,1613,0,2,5,7,28.6%,17m
47531,1,EveryDayUser,1613,0,1,3,4,25.0%,32m
47531,3,Altary,1613,0,0,2,2,0.0%,51m
47535,3,FlissPitsche,1610,1026,31,68,99,31.3%,44m
47535,1,Silverdragon,1610,122,5,10,15,33.3%,36m
47537,3,Борис,1609,0,0,11,11,0.0%,23m
47538,1,BigH,1608,339,10,21,31,32.3%,24m
47539,3,EroLock,1607,690,24,50,74,32.4%,23m
47539,1,Max,1607,60,3,16,19,15.8%,1h
47541,2,Alex,1606,352,11,13,24,45.8%,14m
47542,2,IgorNick,1603,753,25,44,69,36.2%,43m
47542,3,HUURRRE,1603,100,3,15,18,16.7%,51m
47542,3,EddieEdwards,1603,0,0,1,1,0.0%,36m
47542,3,Avsienko,1603,0,0,1,1,0.0%,21m
47546,1,AHSPWR,1602,30,2,5,7,28.6%,37m
47546,3,Micron,1602,0,0,4,4,0.0%,19m
47548,1,[luchik]михмиханик,1601,264,6,14,20,30.0%,39m
47549,1,able,1600,0,1,5,6,16.7%,49m
47549,3,Jealca,1600,34,1,11,12,8.3%,7m
47549,2,BOBO,1600,0,0,1,1,0.0%,56m
47552,2,Erwina,1599,0,0,1,1,0.0%,51m
47553,1,Hodnydylko,1598,562,14,31,45,31.1%,58m
47553,2,hannistar,1598,0,0,3,3,0.0%,43m
47555,1,[CREPES]PhiphiClash,1597,242,7,15,22,31.8%,43m
47556,3,RedRock,1596,92,3,18,21,14.3%,8m
47557,2,YFEX,1594,30,1,14,15,6.7%,57m
47558,2,debug,1593,134,4,8,12,33.3%,18m
47559,3,jcmc,1592,30,2,3,5,40.0%,39m
47560,1,[IWOLFI]Gillette,1591,290,9,15,24,37.5%,28m
47560,1,Stawr,1591,290,8,18,26,30.8%,24m
47560,1,Aiur,1591,198,7,26,33,21.2%,36m
47563,2,roboghost,1590,916,27,45,72,37.5%,37m
47564,1,омлет,1588,121,2,15,17,11.8%,27m
47565,1,jakub,1587,706,20,36,56,35.7%,11m
47565,2,BimNik,1587,153,3,7,10,30.0%,18m
47567,1,Andinator,1585,278,8,10,18,44.4%,16m
47568,2,MisterBenz,1584,520,70,117,187,37.4%,14m
47569,3,Nides,1583,101,4,9,13,30.8%,19m
47569,3,[I1I]lilijj,1583,0,1,0,1,100.0%,37m
47571,2,SeventyOne,1581,338,15,23,38,39.5%,2m
47571,2,Shadow,1581,0,0,12,12,0.0%,3m
47573,2,Melodi,1579,0,0,1,1,0.0%,50m
47574,3,Schmulian,1577,86,3,2,5,60.0%,8m
47574,2,[IRvGI]vladosibl,1577,0,0,2,2,0.0%,50m
47576,3,Lucenzo,1576,122,2,9,11,18.2%,46m
47577,2,[Coop00]Nazar,1575,0,0,3,3,0.0%,37m
47578,3,Lukabee,1574,0,0,12,12,0.0%,36m
47579,2,LostHappy,1573,0,1,5,6,16.7%,44m
47579,3,Lexx,1573,0,0,3,3,0.0%,56m
47581,3,PepsiRambow,1572,98,4,23,27,14.8%,30m
47581,2,FriDen,1572,149,3,9,12,25.0%,6m
47581,3,Austra,1572,0,0,6,6,0.0%,37m
47584,1,Adam,1571,378,11,26,37,29.7%,35m
47584,1,ИмяПерсонаж,1571,139,3,11,14,21.4%,25m
47584,2,Uga,1571,68,2,16,18,11.1%,32m
47587,2,kirito,1570,204,7,6,13,53.8%,32m
47587,2,Клеопатра,1570,171,4,5,9,44.4%,8m
47587,2,sever,1570,100,3,11,14,21.4%,14m
47587,2,Physio,1570,114,2,1,3,66.7%,50m
47591,1,zkiller,1569,42,2,5,7,28.6%,37m
47592,1,bartek,1568,1034,30,61,91,33.0%,39m
47592,1,gocebucin,1568,142,4,21,25,16.0%,39m
47594,3,varrion,1566,30,1,7,8,12.5%,6m
47595,2,gurra,1565,40,1,4,5,20.0%,45m
47596,2,quart,1563,492,12,28,40,30.0%,41m
47596,2,zulu,1563,221,6,12,18,33.3%,58m
47596,2,Artem,1563,70,2,4,6,33.3%,35m
47599,3,slslslslslsl,1559,144,4,11,15,26.7%,24m
47600,2,endSADboy,1558,0,2,5,7,28.6%,50m
47601,2,Raymond,1557,203,5,7,12,41.7%,41m
47601,2,suphek,1557,101,1,4,5,20.0%,43m
47603,2,Lemon,1555,0,0,1,1,0.0%,35m
47604,1,Luca,1554,0,3,6,9,33.3%,24m
47604,3,gogolneuf,1554,0,0,3,3,0.0%,19m
47604,3,Shingo,1554,0,0,4,4,0.0%,37m
47604,3,matvei,1554,0,0,10,10,0.0%,19m
47608,2,Marrow,1553,121,3,9,12,25.0%,37m
47609,3,asafzrihan,1550,0,0,1,1,0.0%,28m
47610,2,teco,1546,358,12,22,34,35.3%,6m
47611,3,Amalthea,1545,0,0,5,5,0.0%,55m
47612,1,Barsilion,1543,174,3,14,17,17.6%,46m
47613,2,KuBBaCZ,1542,266,6,9,15,40.0%,45m
47613,3,Fabry,1542,0,1,4,5,20.0%,6m
47613,1,coldghost,1542,44,1,9,10,10.0%,46m
47616,2,[CMM]CaptainWhite,1540,109,2,3,5,40.0%,31m
47616,2,superdiablo,1540,0,0,1,1,0.0%,50m
47618,2,[kek34]рассия,1537,100,4,4,8,50.0%,40m
47619,1,LonelyWolf,1535,666,18,43,61,29.5%,23m
47620,3,loriproWGF,1528,0,0,2,2,0.0%,45m
47621,2,ademp,1523,0,1,4,5,20.0%,6m
47621,2,megaknight,1523,30,1,17,18,5.6%,47m
47621,3,starny,1523,0,0,1,1,0.0%,6m
47624,2,Noodle,1522,30,2,2,4,50.0%,26m
47624,3,Iris,1522,0,0,5,5,0.0%,36m
47626,1,DARKLORD,1520,765,20,43,63,31.7%,32m
47627,2,lihatskiy,1518,325,10,21,31,32.3%,8m
47627,3,[woron]Троцкий,1518,32,1,1,2,50.0%,19m
47627,2,НЕРВНЫЙ,1518,0,0,4,4,0.0%,7m
47630,1,Snorrski,1515,356,9,20,29,31.0%,33m
47630,3,Dodokiller,1515,0,0,11,11,0.0%,36m
47632,2,HappyFail,1513,0,0,1,1,0.0%,55m
47633,2,Furbosa,1512,279,11,12,23,47.8%,37m
47634,1,Астенкен,1510,0,0,7,7,0.0%,40m
47635,2,verdgin,1509,0,0,1,1,0.0%,33m
47636,2,[Muist]mirewn,1508,282,10,12,22,45.5%,41m
47636,2,FoksRot,1508,111,2,4,6,33.3%,38m
47636,2,DRCAT,1508,66,2,10,12,16.7%,45m
47639,3,Laree,1505,0,0,14,14,0.0%,39m
47640,3,nymeria,1503,60,3,10,13,23.1%,45m
47641,1,DOUDA,1500,34,3,7,10,30.0%,1h
47641,2,vital,1500,88,2,5,7,28.6%,35m
47643,2,NoxPrixcz,1498,0,1,1,2,50.0%,37m
47644,2,akasha,1493,76,2,5,7,28.6%,43m
47645,2,EfimProtoss,1492,0,0,1,1,0.0%,40m
47646,2,MAryANC,1491,506,14,35,49,28.6%,37m
47646,2,EpicComeBack,1491,0,0,11,11,0.0%,33m
47648,3,Wmonster,1490,88,4,2,6,66.7%,30m
47648,2,Maurizio,1490,0,0,1,1,0.0%,35m
47648,2,Gorjeck,1490,0,0,5,5,0.0%,31m
47651,1,Protoss,1486,837,20,57,77,26.0%,6m
47652,3,Dedene,1485,30,1,15,16,6.2%,8m
47652,3,[izék]paleotom,1485,0,0,2,2,0.0%,3m
47652,2,[CxCx]Amine,1485,0,0,5,5,0.0%,50m
47655,2,mortanius,1484,0,0,7,7,0.0%,8m
47656,1,[AgresU]Владимир,1481,126,4,13,17,23.5%,11m
47656,3,kalt,1481,0,1,0,1,100.0%,8m
47658,3,Morgling,1480,0,0,1,1,0.0%,45m
47659,2,Primalcrux,1479,90,5,8,13,38.5%,6m
47659,2,Vampy,1479,46,2,8,10,20.0%,43m
47661,2,VLAD,1474,213,4,12,16,25.0%,50m
47662,2,Olga,1473,1054,33,69,102,32.4%,55m
47662,1,ALI,1473,40,1,11,12,8.3%,35m
47664,3,Omax,1472,158,5,24,29,17.2%,19m
47664,2,end,1472,91,1,6,7,14.3%,41m
47666,2,fix,1471,0,0,3,3,0.0%,8m
47667,2,nieznisczaln,1470,30,1,2,3,33.3%,54m
47667,3,Petr,1470,0,0,11,11,0.0%,21m
47669,2,[АNIМЕ]AleksA,1467,0,1,7,8,12.5%,57m
47669,3,tirsus,1467,0,0,3,3,0.0%,55m
47671,2,Kryalx,1466,0,0,1,1,0.0%,32m
47672,2,[ANREN]Перун,1455,151,2,19,21,9.5%,32m
47672,3,Drek,1455,0,0,1,1,0.0%,18m
47674,3,[kluni]Evilprotos,1451,0,2,5,7,28.6%,7m
47674,2,Aiur,1451,88,1,3,4,25.0%,41m
47676,2,Андрей,1450,331,13,26,39,33.3%,14m
47677,3,[x24]Soopafresh,1442,58,2,18,20,10.0%,51m
47677,1,ilker,1442,0,0,10,10,0.0%,53m
47679,3,Mikasa,1439,0,0,1,1,0.0%,19m
47680,2,stefanov,1436,202,6,9,15,40.0%,54m
47681,3,paperbag,1435,30,1,2,3,33.3%,39m
47682,2,Anderson,1434,0,1,6,7,14.3%,38m
47683,3,KazukiHime,1433,0,0,5,5,0.0%,2m
47684,3,Daeliavan,1432,46,1,10,11,9.1%,53m
47685,1,llillillilil,1431,0,0,17,17,0.0%,32m
47686,3,red,1426,0,0,2,2,0.0%,56m
47687,3,Evkakiy,1423,74,5,14,19,26.3%,46m
47687,3,Rollo,1423,32,2,3,5,40.0%,7m
47689,3,Luke,1421,0,0,2,2,0.0%,25m
47690,3,гидралиск,1420,0,0,1,1,0.0%,56m
47691,3,Reuke,1417,104,3,5,8,37.5%,25m
47691,3,CptNemo,1417,42,1,4,5,20.0%,56m
47693,3,jirkajirka,1409,0,0,2,2,0.0%,6m
47694,1,chriscas,1406,253,7,20,27,25.9%,29m
47695,3,[Moskva]sunzdragonx,1400,0,0,4,4,0.0%,24m
47696,2,BLACKSTAR,1399,40,1,9,10,10.0%,58m
47697,1,Fantasy,1392,332,9,38,47,19.1%,24m
47698,3,ARHANGEL,1391,76,3,8,11,27.3%,7m
47699,1,[BuO]OmentumMajus,1390,863,82,233,315,26.0%,29m
47700,1,CEKO,1388,124,4,16,20,20.0%,1h
47701,3,aiur,1387,30,1,5,6,16.7%,25m
47702,3,gouzzy,1383,0,0,16,16,0.0%,39m
47703,3,[Burla]Sebastijan,1378,124,4,10,14,28.6%,21m
47703,3,RaketenKarli,1378,30,2,7,9,22.2%,51m
47703,2,PLUUUTO,1378,30,2,9,11,18.2%,51m
47706,3,Leizergean,1377,0,2,3,5,40.0%,39m
47707,3,Killer,1374,30,1,7,8,12.5%,19m
47708,3,[HMarch]STRELOOK,1373,0,0,1,1,0.0%,24m
47709,1,tonyvegas,1371,132,6,17,23,26.1%,44m
47709,1,[v8ZX7h]PATRON,1371,257,5,29,34,14.7%,45m
47711,3,IIIIIIIIIIII,1370,0,0,2,2,0.0%,19m
47712,1,[TLT]Spin,1369,180,7,36,43,16.3%,7m
47712,3,LeonidWOLF,1369,0,0,8,8,0.0%,56m
47714,3,Falciu,1367,0,0,3,3,0.0%,25m
47715,3,Squishy,1366,0,0,14,14,0.0%,49m
47716,2,Morohir,1357,62,2,27,29,6.9%,14m
47717,3,protosek,1354,88,4,8,12,33.3%,25m
47718,3,vJullian,1344,0,1,0,1,100.0%,25m
47719,3,skydreamfall,1340,42,1,8,9,11.1%,46m
47720,3,VIXUSNET,1318,0,0,1,1,0.0%,18m
47721,3,TOMV,1317,0,0,8,8,0.0%,36m
47722,2,Митяй,1311,60,2,25,27,7.4%,20m
47723,2,CAYILO,1294,319,8,35,43,18.6%,54m
47723,3,Nves,1294,36,1,1,2,50.0%,39m
47725,1,YANKEE,1293,249,8,31,39,20.5%,36m
47726,3,cyril,1292,0,0,1,1,0.0%,39m
47727,2,PLLacek,1281,30,3,8,11,27.3%,51m
47728,1,OldDirtyBug,1275,780,23,89,112,20.5%,3m
47728,3,JumpJet,1275,0,0,9,9,0.0%,56m
47730,1,tijojo,1271,690,20,62,82,24.4%,31m
47731,3,carlos,1265,30,1,3,4,25.0%,6m
47732,2,arhi,1234,192,6,33,39,15.4%,47m
47733,3,benuts,1217,0,0,3,3,0.0%,18m
47734,1,Discount,1216,0,0,16,16,0.0%,8m
47735,1,[Gregg]EscherBacon,1215,0,0,15,15,0.0%,16m
47736,2,APOLLO,1214,30,1,23,24,4.2%,35m
47737,3,meneldil,1211,0,0,6,6,0.0%,28m
47738,3,IIIIIIIIIIII,1200,0,1,7,8,12.5%,37m
47739,3,Hadès,1189,68,3,11,14,21.4%,25m
47740,3,Seikatsu,1164,44,2,8,10,20.0%,30m
47741,3,Majo,1163,0,0,5,5,0.0%,3m
47742,3,Tom,1162,30,1,7,8,12.5%,36m
47743,3,lupar,1103,62,2,13,15,13.3%,37m
47744,3,IIIIIIIIIIII,1092,58,3,0,3,100.0%,39m
47745,3,Slangen,1063,0,0,29,29,0.0%,3m
47746,1,Triforce,1046,64,3,45,48,6.2%,39m
47747,3,artanis,1028,0,0,1,1,0.0%,25m
47748,3,Bronawix,875,0,0,38,38,0.0%,42m
47749,1,Plecto,873,4,600,514,1114,53.9%,25m
47750,2,Nub,779,188,5,96,101,5.0%,51m
47751,3,lanvo,74,0,1,0,1,100.0%,30m
