rank,tier,name,mmr,points,wins,losses,played,winrate,age
1,1,[n33b]Phil,6136,0,0,1,1,0.0%,17m
2,1,TheCowboy,6121,192,4,2,6,66.7%,11m
3,1,LiquidClem,6092,0,0,1,1,0.0%,16m
4,1,[Clevеr]AlexUA,6060,0,0,1,1,0.0%,17m
5,1,[n33b]PeterPan,6029,0,1,0,1,100.0%,24m
6,1,IIIIIIIIII,5983,0,0,1,1,0.0%,2m
7,1,[QTcIub]Beastyqt,5842,896,20,25,45,44.4%,6m
8,1,[ArGGEU]vmgNarra,5776,0,0,1,1,0.0%,15m
9,1,[TRotti]Rondaaaaaa,5755,48,2,1,3,66.7%,22m
10,1,[сSсǃ]SKILLOUS,5737,0,0,1,1,0.0%,9m
11,1,[TSI]Mix,5684,465,24,15,39,61.5%,22m
12,1,PoKeMoM,5645,48,2,0,2,100.0%,9m
13,1,[aW]Yuhmo,5609,0,1,0,1,100.0%,3m
14,1,[foado]GoForBroke,5551,0,1,0,1,100.0%,9m
15,1,[QLASH]RotterdaM,5529,0,0,1,1,0.0%,3m
16,2,[Li3]SuGaRBuNNY,5489,0,2,1,3,66.7%,5m
17,1,[GWWB]BillieJopish,5452,140,3,5,8,37.5%,9m
18,1,[TheDOH]FightingFrog,5434,144,3,5,8,37.5%,6m
19,1,[Potati]MrPotato,5431,48,5,7,12,41.7%,2m
20,1,[αX]Rodzyn,5427,245,18,24,42,42.9%,11m
21,1,[SLAAAP]Paragon,5363,188,7,3,10,70.0%,26m
22,1,[PaniC]ДжохниПрогей,5346,96,3,0,3,100.0%,15m
23,1,SenseiKanye,5300,617,14,9,23,60.9%,15m
24,1,[ArGGEU]CripSeil,5290,312,8,3,11,72.7%,21m
25,1,EnifRots,5268,48,2,1,3,66.7%,5m
26,1,VanillaRush,5258,2344,96,51,147,65.3%,2m
27,1,[ENGNS]ChillerView,5257,1122,30,26,56,53.6%,6m
28,1,OldBenoni,5237,1072,30,17,47,63.8%,24m
29,1,HânTattoo,5230,917,36,26,62,58.1%,24m
30,1,folloburg,5227,0,0,1,1,0.0%,5m
31,1,Фортнайт,5211,2912,122,103,225,54.2%,2m
32,2,IIIIIIIIIIII,5206,0,1,0,1,100.0%,2m
33,1,[f2af2a]Ezekiel,5197,48,1,2,3,33.3%,16m
34,1,[PÂRłAH]Argon,5169,88,2,2,4,50.0%,6m
35,1,llllllllllll,5168,0,4,1,5,80.0%,24m
36,1,Capablanca,5157,94,3,1,4,75.0%,21m
37,1,[StalkZ]Cheesus,5154,0,0,1,1,0.0%,3m
38,1,[ToeJoe]OwenBenjamin,5112,140,4,5,9,44.4%,6m
39,2,Pütschern,5106,130,3,0,3,100.0%,6m
40,1,[НТТ]Zanter,5096,0,2,3,5,40.0%,6m
41,1,Wanderer,5091,266,6,19,25,24.0%,6m
42,1,IIIIIIIIIIII,5074,0,2,1,3,66.7%,26m
43,1,Bitcoin,5062,0,0,2,2,0.0%,22m
44,1,[ǃcScǃ]ŴhýŠoŠéríouŚ,5047,212,6,2,8,75.0%,11m
45,1,[GWWB]CarlyRaeJope,5039,0,1,0,1,100.0%,16m
46,3,[AISC]Surge,5032,97,2,0,2,100.0%,9m
47,1,Hydra,5004,395,9,13,22,40.9%,16m
48,1,[Oath]LogiC,5000,876,28,15,43,65.1%,12m
49,1,Impostor,4998,2560,115,105,220,52.3%,2m
49,1,[VFish]Aelith,4998,212,6,8,14,42.9%,6m
51,1,[Oxia]Evolution,4996,0,1,0,1,100.0%,23m
52,1,IIIIIIIIIIII,4995,664,18,13,31,58.1%,15m
53,1,Mufflebot,4985,3053,588,571,1159,50.7%,2m
54,1,[PLA2N]RazvaZAR,4975,40,2,6,8,25.0%,24m
55,1,[ArGGEU]EnigmA,4972,138,4,2,6,66.7%,9m
56,3,kauP,4971,121,2,6,8,25.0%,9m
57,3,[GoldM]Bromaria,4963,0,1,0,1,100.0%,16m
58,3,[TWIM]Earendil,4961,2,1,1,2,50.0%,26m
59,1,[100APM]Operator,4948,3054,357,351,708,50.4%,5m
59,1,SoMa,4948,0,0,2,2,0.0%,23m
61,1,[ÆR]JuGGer,4947,2396,156,136,292,53.4%,3m
62,1,[aW]LIGHT,4940,80,2,2,4,50.0%,6m
63,1,Nightmare,4937,0,0,1,1,0.0%,2m
64,1,IrishLad,4932,137,3,5,8,37.5%,21m
65,1,supernoob,4931,0,4,1,5,80.0%,2m
66,1,[XYFAN]INcuBo,4927,112,4,5,9,44.4%,9m
67,1,Derderdon,4920,44,2,2,4,50.0%,9m
68,1,[DoK]JangoFett,4917,2647,111,89,200,55.5%,5m
69,1,[ENCE]Welmu,4905,208,7,14,21,33.3%,2m
70,1,[iX]Meditail,4899,0,1,0,1,100.0%,9m
71,1,MustiSuckt,4889,30,1,6,7,14.3%,26m
72,1,[HBGS]JEROS,4888,1160,37,32,69,53.6%,5m
73,1,[BFeS]RainmaNǂ,4881,1867,97,80,177,54.8%,5m
73,1,[PŖïMĄŁ]CristoDorado,4881,0,1,3,4,25.0%,18m
75,1,[Peeps]BUFOR,4879,0,1,1,2,50.0%,2m
76,1,[INAE]ReiToR,4869,1887,84,53,137,61.3%,21m
77,1,[IceHus]balance,4866,0,1,0,1,100.0%,16m
78,1,ZurbaTopova,4864,182,10,2,12,83.3%,26m
79,1,villee,4862,0,0,1,1,0.0%,24m
80,1,Nevermore,4857,0,1,0,1,100.0%,2m
81,1,Nanaki,4854,170,7,8,15,46.7%,26m
81,1,[VFN]Xorx,4854,0,1,0,1,100.0%,12m
83,1,MonkeyDragon,4853,648,19,15,34,55.9%,6m
83,3,asdfasdfasdf,4853,219,11,2,13,84.6%,15m
85,1,Tsogi,4844,0,1,0,1,100.0%,17m
86,1,Praimfaya,4843,242,6,8,14,42.9%,9m
87,1,[TUPL]Vulcan,4841,48,1,4,5,20.0%,13m
88,1,[EmŦ]MagnuM,4838,376,17,9,26,65.4%,17m
89,1,Voxy,4837,139,3,2,5,60.0%,3m
90,1,[αX]Mamba,4836,596,16,19,35,45.7%,6m
91,1,[LifeS]CmeTanKa,4830,206,9,5,14,64.3%,9m
92,3,Nuffy,4823,0,1,0,1,100.0%,2m
93,1,[LqT]tiltedcaster,4821,255,11,9,20,55.0%,21m
94,1,[3Dǃ]ploge,4817,243,6,5,11,54.5%,6m
95,2,[isIMBA]Parathix,4801,62,2,1,3,66.7%,13m
96,1,[K0mpis]WeRiano,4794,0,3,3,6,50.0%,15m
97,1,[PLA2N]Ink,4792,244,7,6,13,53.8%,17m
97,2,[WITCHs]YuzuruYamai,4792,0,0,1,1,0.0%,7m
99,2,Strawhat,4787,0,1,0,1,100.0%,16m
100,1,[ArGGEU]ADIBOU,4781,2439,136,118,254,53.5%,26m
101,1,[Trains]Backware,4780,0,1,0,1,100.0%,8m
102,2,HeelHooker,4775,66,2,4,6,33.3%,7m
103,1,[INAE]TAUREN,4772,952,34,39,73,46.6%,22m
104,2,[LifeS]Random,4769,121,6,1,7,85.7%,10m
105,1,[SqAUT]TheMassivMan,4765,216,7,11,18,38.9%,3m
106,1,MrSuidAfrika,4754,0,1,0,1,100.0%,25m
107,1,[GoldM]WindmillMan,4753,192,4,8,12,33.3%,9m
107,2,[IBeAŚI]BeAsT,4753,0,0,5,5,0.0%,16m
109,2,rus,4743,0,0,1,1,0.0%,8m
110,1,Leorio,4738,2869,210,212,422,49.8%,2m
111,2,AlphaStar,4735,0,2,0,2,100.0%,8m
112,1,[PŖïMĄŁ]ŞҚцŁŁўĢдИ,4734,0,2,4,6,33.3%,17m
113,2,frayRize,4730,30,5,1,6,83.3%,7m
113,2,silvercrow,4730,0,2,3,5,40.0%,17m
115,1,max,4725,0,0,1,1,0.0%,23m
116,1,TossIsZeroIQ,4723,0,2,3,5,40.0%,21m
117,2,[RBP3]kOliO,4720,2668,190,178,368,51.6%,10m
118,2,[ØC]Dicet,4718,623,33,18,51,64.7%,10m
119,2,[GdAT]Unhealthy,4715,1855,93,88,181,51.4%,6m
120,2,[BFeS]TOTOPOTATO,4714,708,29,31,60,48.3%,16m
121,2,[TAGGX]SlammerPower,4711,58,2,4,6,33.3%,17m
122,2,[Dobro]Dobro,4709,138,5,7,12,41.7%,6m
123,2,REEEEEEEEEEE,4708,0,1,0,1,100.0%,5m
124,2,PixelPerfect,4707,1534,66,64,130,50.8%,5m
124,2,Troizza,4707,38,5,4,9,55.6%,10m
126,1,asdf,4706,145,6,1,7,85.7%,9m
127,3,JustMonika,4705,241,8,1,9,88.9%,5m
128,2,[OSgZ]Euweb,4700,415,22,11,33,66.7%,10m
129,2,scout,4699,0,0,1,1,0.0%,12m
130,1,[Blacer]MarineKing,4696,0,1,4,5,20.0%,16m
131,1,[lMMl]Ike,4695,40,1,9,10,10.0%,2m
132,2,[JDМ]SlotH,4694,0,0,1,1,0.0%,10m
133,2,Perkele,4693,0,4,1,5,80.0%,12m
134,1,Grogu,4689,2830,332,276,608,54.6%,6m
134,2,[1Left]loveYou,4689,0,1,0,1,100.0%,5m
134,2,debaz,4689,0,1,0,1,100.0%,10m
137,2,IIIIIIIIIII,4684,74,2,3,5,40.0%,17m
138,1,[aW]IIIIIIIIIIII,4681,0,1,1,2,50.0%,23m
139,1,[DyWmP]MSIMakouni,4677,74,4,7,11,36.4%,24m
139,3,ReFleXioN,4677,22,1,5,6,16.7%,9m
141,2,[ÆR]Psz,4675,516,28,30,58,48.3%,16m
141,2,SpiritOfMage,4675,16,1,3,4,25.0%,5m
143,1,NEO,4668,0,1,0,1,100.0%,26m
143,2,[Animе]XelNaga,4668,0,0,1,1,0.0%,19m
145,2,[DoS98]Larogue,4666,654,36,25,61,59.0%,2m
146,2,HinternWelp,4661,0,0,2,2,0.0%,16m
147,2,[Sacred]ImpuLse,4657,0,0,1,1,0.0%,12m
148,2,[Xa]Sforza,4643,76,4,1,5,80.0%,5m
149,2,root,4638,770,38,26,64,59.4%,13m
150,2,[Unclе]themoOsician,4636,1782,101,86,187,54.0%,16m
150,1,sdafasdfqwqe,4636,363,11,7,18,61.1%,22m
152,3,DirkGently,4633,419,22,1,23,95.7%,16m
152,2,llllllllllll,4633,26,1,1,2,50.0%,13m
154,1,LemonLyman,4632,1970,192,192,384,50.0%,9m
155,2,[VFish]VoiceOfFall,4629,392,19,17,36,52.8%,5m
155,2,MyNameIs,4629,30,5,3,8,62.5%,2m
155,2,[Burla]Burlaczech,4629,0,1,0,1,100.0%,12m
158,2,[JAREK]leSzCz,4628,499,25,16,41,61.0%,10m
158,2,higgi,4628,0,2,4,6,33.3%,13m
160,2,[LifeS]ÐÎÁßØŁÎČÀ,4627,4,3,0,3,100.0%,19m
161,1,IIIIIIIIIIII,4626,121,3,3,6,50.0%,16m
161,2,[TIT4NS]FujMs,4626,0,0,1,1,0.0%,7m
163,2,[Ex0n]Kulka,4620,0,0,2,2,0.0%,10m
164,2,[HBGS]Starfish,4617,1046,54,42,96,56.2%,10m
165,2,Smoothie,4612,238,8,6,14,57.1%,13m
165,2,Raiden,4612,99,5,2,7,71.4%,10m
167,2,[Nzth]Xrestos,4606,2401,131,140,271,48.3%,7m
167,2,Nephilim,4606,0,1,0,1,100.0%,5m
169,2,[Wø]Aicha,4605,185,8,8,16,50.0%,16m
170,2,AsTeR,4604,149,6,3,9,66.7%,5m
171,2,[WBO]ZESTisBEST,4603,0,1,1,2,50.0%,16m
172,2,[Нope]aling,4602,368,13,12,25,52.0%,8m
173,1,llllllllllll,4599,266,6,1,7,85.7%,21m
174,2,[BRSKR]Washikie,4594,529,29,9,38,76.3%,5m
174,2,[lWHl]Hans,4594,0,0,1,1,0.0%,16m
176,1,[BlaDia]granitor,4587,97,4,4,8,50.0%,23m
177,3,llllllllllll,4586,10,2,0,2,100.0%,3m
177,2,[ArGGEU]Dennery,4586,0,0,2,2,0.0%,10m
179,3,[CYG]Alpha,4582,92,8,5,13,61.5%,22m
180,3,TerranUApart,4580,808,45,27,72,62.5%,25m
180,2,[Wø]AǂMitch,4580,97,1,6,7,14.3%,10m
182,3,[lMMl]Fagballs,4577,176,10,13,23,43.5%,8m
183,2,[ICGl]BananenBaum,4575,204,9,10,19,47.4%,6m
184,3,Kuckuck,4569,587,54,24,78,69.2%,3m
185,2,[WBO]Suidam,4568,1753,100,95,195,51.3%,16m
186,2,Faras,4567,338,17,19,36,47.2%,17m
186,2,TestDrive,4567,86,5,4,9,55.6%,2m
186,2,Julian,4567,0,0,1,1,0.0%,16m
189,1,asdf,4556,265,9,6,15,60.0%,8m
190,3,llllllllllll,4555,406,24,3,27,88.9%,4m
190,2,[IBeAŚI]GUMGUMRuFFy,4555,120,6,10,16,37.5%,13m
192,1,Strapi,4554,0,1,3,4,25.0%,26m
193,2,[LOMZA]ruthless,4551,84,4,3,7,57.1%,10m
193,2,Patzer,4551,0,0,4,4,0.0%,7m
195,2,[Heroes]Magnath,4550,28,4,5,9,44.4%,10m
196,2,[ICGl]React,4547,179,8,12,20,40.0%,17m
197,2,[НТТ]Power,4545,455,21,18,39,53.8%,13m
198,3,[CpL]KrOk,4543,575,33,28,61,54.1%,23m
198,3,PizeriaZorba,4543,302,17,1,18,94.4%,13m
198,2,Crackling,4543,212,12,14,26,46.2%,13m
198,3,MrBurnYgrT,4543,62,7,3,10,70.0%,22m
202,2,Bolo,4542,234,36,27,63,57.1%,16m
203,3,CARRIERS,4539,489,25,11,36,69.4%,23m
203,3,CryingTerran,4539,369,20,1,21,95.2%,22m
203,3,BaKaA,4539,0,2,0,2,100.0%,10m
206,3,[GdAT]Napolcochon,4537,613,125,115,240,52.1%,10m
206,2,short,4537,0,3,2,5,60.0%,26m
206,2,IIIIIIIIIIII,4537,0,1,4,5,20.0%,6m
209,2,[CocoCo]DansGame,4536,0,1,0,1,100.0%,6m
210,3,NoName,4530,218,12,5,17,70.6%,13m
210,2,Staris,4530,120,6,10,16,37.5%,10m
212,3,[Peeps]SpiderPig,4529,106,13,8,21,61.9%,12m
213,3,[TSVB]JCGamer,4526,0,0,1,1,0.0%,15m
214,3,sYz,4522,744,49,20,69,71.0%,4m
215,3,[NWGD]Hippotamus,4521,0,1,0,1,100.0%,13m
216,3,IIIIIIIIIIII,4520,28,3,2,5,60.0%,13m
217,3,TrustItOrNot,4517,12,2,1,3,66.7%,10m
217,3,Yesteryear,4517,0,0,5,5,0.0%,11m
219,3,MEMMO,4516,0,0,1,1,0.0%,10m
220,2,RMP,4513,845,39,42,81,48.1%,10m
221,1,[Mkers]ÐęąÐŞĦąÐoŴ,4510,48,1,1,2,50.0%,17m
222,3,ieatzergs,4509,12,3,1,4,75.0%,9m
223,3,[TAW]Zgredek,4508,0,1,5,6,16.7%,23m
223,1,IlIlIlIlIlIl,4508,0,1,9,10,10.0%,7m
225,2,[RÐ]ElNathador,4507,170,7,14,21,33.3%,19m
226,3,Diane,4503,381,25,6,31,80.6%,25m
226,3,Pvtbryan,4503,60,6,6,12,50.0%,3m
228,3,Taimyr,4502,128,13,12,25,52.0%,15m
229,2,IlIlIIIIllll,4501,598,31,28,59,52.5%,10m
230,3,IIIIIIIIIIII,4499,182,19,19,38,50.0%,25m
230,2,[αX]ThiasHP,4499,356,15,22,37,40.5%,6m
230,3,Flanders,4499,0,0,1,1,0.0%,9m
233,3,llllllllllll,4496,0,3,2,5,60.0%,21m
234,3,[Dae]HyuMan,4494,0,1,0,1,100.0%,23m
235,3,ulc,4492,0,0,1,1,0.0%,5m
236,3,BobToss,4490,0,3,3,6,50.0%,25m
237,3,[13g12p]TheRex,4489,0,0,1,1,0.0%,25m
238,2,[cFADDA]KoloSSaL,4487,48,3,6,9,33.3%,23m
239,1,BeatrixKiddo,4485,396,39,14,53,73.6%,22m
240,3,FraxReaper,4484,1510,82,70,152,53.9%,3m
240,3,IIIIIIIIIIII,4484,0,2,3,5,40.0%,13m
242,3,Polgogol,4482,18,3,1,4,75.0%,10m
243,3,[PLA2N]rom,4480,0,0,1,1,0.0%,3m
244,2,[Heroes]Elias,4477,2386,352,366,718,49.0%,19m
245,3,TinTin,4476,0,0,2,2,0.0%,4m
246,3,NoSmokingBro,4474,30,4,4,8,50.0%,12m
247,3,[Ричард]GooD,4473,167,8,1,9,88.9%,9m
247,2,Saiph,4473,0,1,0,1,100.0%,6m
249,3,[сSсǃ]August,4471,88,9,8,17,52.9%,9m
250,3,[RÐ]CuréCalin,4469,30,4,5,9,44.4%,23m
251,2,Maix,4467,243,10,13,23,43.5%,10m
252,3,[Картош]IIIIIIIIIIII,4464,12,1,5,6,16.7%,25m
253,3,[sGeeks]zettick,4462,1475,72,75,147,49.0%,13m
254,2,[EESC]Killermonjas,4461,122,7,13,20,35.0%,8m
255,1,[ƮesXG]WhySoSeriouS,4458,1647,68,68,136,50.0%,16m
255,3,YouAnimal,4458,28,4,3,7,57.1%,5m
257,3,[LLFF]Hydroxi,4457,121,2,2,4,50.0%,22m
257,3,[S3]Amorr,4457,0,0,1,1,0.0%,11m
259,3,IIIIIIIIIIII,4456,1232,79,49,128,61.7%,9m
259,3,[LoCarb]Microroni,4456,686,37,23,60,61.7%,15m
259,3,[ORRO]jul,4456,36,6,2,8,75.0%,12m
262,3,[BLaGa]SirAlex,4454,179,15,10,25,60.0%,3m
263,1,[lLiTl]Failure,4450,97,1,1,2,50.0%,8m
264,3,[МД86]Moldovanin,4448,619,58,36,94,61.7%,8m
265,3,[JILLZ]Cyber,4446,22,4,7,11,36.4%,21m
265,3,[iX]Meddle,4446,0,0,2,2,0.0%,22m
267,3,FailArazul,4445,16,2,2,4,50.0%,12m
268,3,[Cannоn]Timo,4444,42,6,3,9,66.7%,21m
269,3,Interesting,4441,0,0,1,1,0.0%,8m
270,3,[UATeam]HopeX,4438,0,0,1,1,0.0%,12m
271,3,[Хобот]Hellion,4437,20,4,1,5,80.0%,5m
272,3,[ЯD]eXit,4436,266,12,10,22,54.5%,12m
272,3,Reverse,4436,0,0,1,1,0.0%,11m
274,3,[DFgs]GuMihu,4435,4,2,4,6,33.3%,9m
275,3,[Cannоn]Bam,4431,0,1,0,1,100.0%,25m
276,3,[TAW]WaRzOnE,4430,54,8,7,15,53.3%,22m
277,3,Ragnar,4429,34,5,6,11,45.5%,10m
277,3,[eXøde]powerspike,4429,4,1,1,2,50.0%,25m
279,3,BlueDevil,4424,0,0,1,1,0.0%,10m
280,3,[SLD]Pixelbuddha,4423,109,5,0,5,100.0%,8m
281,1,Issou,4422,335,14,2,16,87.5%,12m
282,3,[GoldM]Carbine,4421,787,46,42,88,52.3%,2m
283,3,Hook,4417,616,34,12,46,73.9%,15m
283,3,[Sarmat]Samael,4417,97,1,5,6,16.7%,11m
285,2,IIIIIIIIIIII,4416,132,4,3,7,57.1%,25m
285,2,Addict,4416,0,0,3,3,0.0%,13m
287,3,ƉǂƬƬƟ,4415,169,8,7,15,53.3%,5m
288,3,ƁęŊŧữŞĭ,4414,0,0,1,1,0.0%,10m
289,3,Ollowain,4413,0,3,0,3,100.0%,5m
289,3,Duggi,4413,4,2,3,5,40.0%,13m
291,2,[Ɛï3]ƅĩǥпợŋşҭƹг,4409,14,1,9,10,10.0%,8m
292,3,[VuV]Jidduu,4408,1352,71,65,136,52.2%,9m
292,3,ShadowLight,4408,0,1,0,1,100.0%,15m
294,3,Abver,4406,266,17,3,20,85.0%,12m
294,3,Enigma,4406,0,1,0,1,100.0%,22m
296,3,Czubi,4403,2226,515,521,1036,49.7%,9m
296,3,[BHESS]LeBregognon,4403,321,12,9,21,57.1%,5m
296,3,[ØC]Inkisiteur,4403,92,11,11,22,50.0%,11m
296,1,FckTeran,4403,178,5,22,27,18.5%,12m
300,3,[icbajs]COCК,4402,0,0,2,2,0.0%,22m
301,3,katzoo,4401,606,45,45,90,50.0%,8m
302,3,Tactyw,4400,674,28,9,37,75.7%,25m
303,3,[Lort]MonkeyMan,4399,97,3,3,6,50.0%,15m
303,3,Imbalex,4399,0,1,0,1,100.0%,15m
305,3,ThatGuy,4398,16,2,1,3,66.7%,12m
305,3,[PiGPan]Akoo,4398,0,1,0,1,100.0%,15m
305,3,[ƮesXG]Kronos,4398,0,1,0,1,100.0%,10m
305,1,[RstE]NicoStar,4398,48,1,9,10,10.0%,9m
309,3,DarK,4396,14,2,3,5,40.0%,25m
310,3,[BRSKR]TeaCup,4395,559,29,21,50,58.0%,21m
310,3,[ØC]Hoshi,4395,12,3,1,4,75.0%,25m
310,3,[RÐ]Mazrok,4395,0,1,0,1,100.0%,25m
313,2,[Kicx]simtom,4394,94,6,2,8,75.0%,10m
313,3,[Arrows]Salty,4394,0,1,0,1,100.0%,9m
315,3,[MD86]AlexeiMD,4392,495,53,27,80,66.2%,26m
315,3,[Zguege]JULMonBijou,4392,100,12,14,26,46.2%,21m
317,3,SuperMeatBoy,4391,666,27,21,48,56.2%,21m
317,3,[BATG]SnipeFive,4391,97,2,0,2,100.0%,9m
319,3,[JAREK]Gumkomen,4387,0,0,1,1,0.0%,9m
320,3,tidusff,4385,115,6,3,9,66.7%,10m
320,1,Hunta,4385,215,6,3,9,66.7%,17m
322,3,[YLLUMA]Bentus,4383,0,0,1,1,0.0%,15m
323,3,[ECFeV]Havior,4382,594,28,19,47,59.6%,23m
324,3,Claire,4381,145,7,1,8,87.5%,22m
325,3,[PTLc]Keiga,4380,301,11,4,15,73.3%,25m
325,3,gag,4380,96,2,0,2,100.0%,12m
325,3,cyber,4380,121,2,1,3,66.7%,23m
328,1,[eli]girlgamerxD,4379,0,0,2,2,0.0%,11m
329,3,[Hambbe]SCBoy,4378,22,3,2,5,60.0%,9m
329,3,BruceTwarze,4378,0,0,1,1,0.0%,22m
331,3,Bobbbbbbbbbb,4376,609,25,14,39,64.1%,22m
331,3,[МТ]ShaakTi,4376,441,18,17,35,51.4%,23m
331,3,DodonMyHero,4376,108,15,12,27,55.6%,4m
334,3,[Voll]Quma,4374,2067,119,108,227,52.4%,26m
334,3,DeadlyKitten,4374,442,22,4,26,84.6%,12m
336,3,[AG]BlueBlood,4373,275,21,15,36,58.3%,15m
336,2,[Картош]Oldwizard,4373,80,2,6,8,25.0%,10m
336,3,Koibomlin,4373,0,0,1,1,0.0%,22m
339,2,Urameshi,4372,0,1,0,1,100.0%,16m
339,3,[αX]Victor,4372,0,1,0,1,100.0%,3m
341,3,Doc,4371,1395,124,115,239,51.9%,13m
341,3,Burbn,4371,804,44,37,81,54.3%,10m
343,3,[ḾǂḰ]Mikifor,4370,173,6,3,9,66.7%,26m
343,3,KKonaW,4370,146,3,2,5,60.0%,22m
345,3,doomwaffle,4369,495,62,57,119,52.1%,12m
345,3,hypnotoad,4369,954,55,43,98,56.1%,5m
345,3,Orpiment,4369,559,23,23,46,50.0%,23m
345,3,[ØC]GatsbY,4369,91,4,0,4,100.0%,8m
345,3,pedick,4369,0,1,0,1,100.0%,13m
350,3,[nB]DreinarK,4367,381,19,19,38,50.0%,9m
350,3,NoobMaster,4367,0,1,0,1,100.0%,8m
352,3,Okimuk,4366,102,9,4,13,69.2%,12m
352,3,[CnG]DrBerto,4366,0,1,1,2,50.0%,22m
352,3,Shinycarrier,4366,97,1,1,2,50.0%,2m
352,3,[SoSaTb]CryPony,4366,0,0,1,1,0.0%,16m
356,3,[SCPO]Theblaack,4364,936,56,61,117,47.9%,13m
356,2,[Li3]Manny,4364,0,1,0,1,100.0%,15m
356,3,[BGuard]CardBoxMan,4364,97,1,1,2,50.0%,8m
359,3,gehemon,4363,214,34,40,74,45.9%,12m
360,3,NiceOne,4362,604,29,23,52,55.8%,13m
360,2,[AiRǂ]SuperNova,4362,88,3,1,4,75.0%,26m
360,3,CIIC,4362,0,1,0,1,100.0%,23m
360,3,lVlagic,4362,0,0,1,1,0.0%,5m
364,3,[InFy]Dod,4361,967,130,112,242,53.7%,9m
364,3,Critolix,4361,222,8,3,11,72.7%,13m
364,3,Erlin,4361,0,3,2,5,60.0%,26m
367,1,yukoSefZ,4359,94,1,1,2,50.0%,23m
368,3,[WBO]Spectre,4358,115,4,5,9,44.4%,12m
369,3,Tokieno,4357,2106,201,210,411,48.9%,16m
369,3,Mirrari,4357,164,25,23,48,52.1%,8m
371,1,Zmey,4356,0,1,0,1,100.0%,16m
371,1,Scarlatti,4356,0,0,1,1,0.0%,5m
373,3,Mizu,4355,382,31,27,58,53.4%,13m
373,1,llllllllllll,4355,387,18,3,21,85.7%,2m
373,1,[AmW1]NeonRa,4355,96,3,0,3,100.0%,25m
376,3,[36484]ŔRRŘÕÒÖØÓØØƠ,4353,16,5,10,15,33.3%,8m
377,1,Exar,4351,325,10,5,15,66.7%,16m
378,1,[PŖïMĄŁ]InTotheSky,4347,0,1,0,1,100.0%,4m
378,3,[HypC]TheSun,4347,97,1,2,3,33.3%,5m
380,3,Bucephalus,4346,60,8,10,18,44.4%,9m
381,1,[ØC]Capucin,4344,385,10,14,24,41.7%,6m
382,3,AgressorGG,4343,1364,78,82,160,48.8%,12m
383,3,llllllllllll,4342,1211,233,222,455,51.2%,5m
384,1,ssgta,4340,144,6,3,9,66.7%,10m
385,2,Efes,4339,0,1,0,1,100.0%,2m
386,3,Leto,4338,728,31,30,61,50.8%,25m
386,3,KEKW,4338,658,28,19,47,59.6%,9m
386,3,[VBM]Frammer,4338,319,23,24,47,48.9%,15m
389,3,Starkiller,4336,4,2,3,5,40.0%,15m
390,2,Vilma,4334,44,2,2,4,50.0%,18m
390,3,WALLE,4334,0,0,6,6,0.0%,4m
392,3,[PLA2N]чahka,4331,1548,107,88,195,54.9%,15m
392,3,IIIIIIIIIIII,4331,663,50,23,73,68.5%,12m
392,1,marius,4331,73,1,6,7,14.3%,4m
395,1,SILF,4329,1929,101,63,164,61.6%,21m
396,3,IIIIIIIIIIII,4326,0,3,3,6,50.0%,10m
397,3,Stalker,4324,640,27,16,43,62.8%,22m
397,1,Wenden,4324,144,4,1,5,80.0%,4m
399,1,YouNoName,4323,144,4,1,5,80.0%,6m
400,2,Strutsel,4319,2341,284,306,590,48.1%,5m
400,1,[PaniC]Kronaz,4319,999,34,20,54,63.0%,13m
400,3,[ENGNS]Mechanics,4319,381,27,28,55,49.1%,25m
400,1,[TheDOH]Dain,4319,96,2,2,4,50.0%,9m
400,1,[RеG]papastreck,4319,48,1,1,2,50.0%,16m
405,3,Kaivu,4318,141,5,3,8,62.5%,4m
406,1,Lasttray,4317,380,11,5,16,68.8%,4m
406,1,[PiGPan]Nopret,4317,96,2,5,7,28.6%,22m
408,3,[Ǽ1]Demon,4316,246,26,32,58,44.8%,21m
408,2,Hatador,4316,0,0,1,1,0.0%,10m
408,1,[bitoQ2]charlix,4316,73,0,3,3,0.0%,13m
411,3,[isIMBA]IndeX,4315,173,8,8,16,50.0%,9m
411,3,ShowKhan,4315,0,1,3,4,25.0%,8m
413,1,[SuperF]Ljuflingur,4310,48,3,1,4,75.0%,5m
414,1,llllllllllll,4308,451,17,11,28,60.7%,16m
415,2,Oblivion,4307,214,4,3,7,57.1%,26m
415,3,[αX]Blisk,4307,0,1,3,4,25.0%,13m
417,3,dicdix,4303,219,6,7,13,46.2%,10m
418,1,[ƮesXG]Whisky,4301,1298,95,81,176,54.0%,22m
418,1,IIIIIIIIIIII,4301,902,27,14,41,65.9%,13m
418,1,YoLOSWaGGiNS,4301,0,0,1,1,0.0%,25m
421,3,realmz,4300,435,80,83,163,49.1%,12m
421,3,[PÂRłAH]Ryuzakhi,4300,146,13,25,38,34.2%,8m
423,3,Amnesia,4299,125,7,4,11,63.6%,10m
424,1,cYclopYze,4297,1461,74,48,122,60.7%,16m
425,1,DeadTokard,4295,192,4,5,9,44.4%,11m
426,1,KupaTrupa,4294,144,4,5,9,44.4%,25m
427,3,Venturi,4293,266,15,13,28,53.6%,5m
427,1,[Tvirus]Wesker,4293,96,2,6,8,25.0%,8m
429,3,[5HEADS]SCout,4292,121,7,8,15,46.7%,10m
429,1,EstebanOcon,4292,144,4,2,6,66.7%,12m
431,3,Duke,4287,1073,78,74,152,51.3%,12m
432,1,Sibylle,4284,278,16,3,19,84.2%,12m
433,1,RuToss,4283,808,19,10,29,65.5%,4m
433,1,Dav,4283,0,0,1,1,0.0%,17m
435,1,[TWIM]Mangomati,4281,96,2,3,5,40.0%,22m
436,1,Ronny,4279,384,8,11,19,42.1%,8m
437,1,[13Rätt]District,4278,1704,55,28,83,66.3%,16m
437,1,[PÂRłAH]Heli,4278,474,10,8,18,55.6%,25m
439,1,Helios,4276,1152,31,26,57,54.4%,25m
440,3,Ryan,4275,50,6,15,21,28.6%,5m
440,1,[HBGS]Licemer,4275,48,2,0,2,100.0%,5m
442,1,Damon,4274,0,3,2,5,60.0%,22m
443,2,hrrrufrr,4272,2350,372,393,765,48.6%,8m
443,1,spark,4272,0,1,4,5,20.0%,16m
445,1,Soetenga,4271,432,9,8,17,52.9%,8m
446,1,[apeiro]ALow,4270,48,1,2,3,33.3%,12m
447,3,Banksy,4268,496,32,36,68,47.1%,8m
447,2,Kindness,4268,138,4,1,5,80.0%,26m
447,1,[Blacer]canabuz,4268,144,4,4,8,50.0%,25m
450,3,[NVY]DeathMarine,4267,0,2,3,5,40.0%,2m
451,1,NIO,4265,428,9,11,20,45.0%,10m
451,3,[Gné]Pickipoc,4265,0,1,4,5,20.0%,5m
453,1,[YlKES]Nat,4264,0,0,1,1,0.0%,23m
454,1,ГОСТ,4260,2240,304,290,594,51.2%,23m
455,1,Rasto,4258,384,10,6,16,62.5%,16m
456,1,Mandalorian,4257,562,13,4,17,76.5%,25m
456,1,[AofK]LuckyPhoenix,4257,48,1,1,2,50.0%,17m
458,3,Nanowi,4255,10,3,9,12,25.0%,3m
459,1,Newt,4252,58,4,3,7,57.1%,13m
459,1,[MSUSC2]Temir,4252,0,1,0,1,100.0%,23m
461,1,[PaniC]Martouf,4248,0,1,0,1,100.0%,12m
462,1,BetaStar,4246,878,20,18,38,52.6%,9m
462,1,[SJSr]Paragon,4246,312,13,8,21,61.9%,2m
462,1,[PLA2N]Lisara,4246,144,3,2,5,60.0%,8m
465,1,Magnanik,4244,1682,43,41,84,51.2%,8m
465,1,llllllllllll,4244,0,0,1,1,0.0%,18m
467,3,EMx,4241,394,32,40,72,44.4%,3m
467,1,NoReason,4241,48,1,7,8,12.5%,8m
469,3,[EseEse]EseEseEse,4240,252,22,34,56,39.3%,12m
469,1,Jeece,4240,295,6,6,12,50.0%,23m
471,1,ДОБРО,4238,0,0,6,6,0.0%,12m
472,1,[Wø]SQR,4231,2093,81,73,154,52.6%,26m
472,1,[SEWP]UnstopSevern,4231,96,3,1,4,75.0%,23m
474,2,[TAW]MarsBar,4230,44,2,2,4,50.0%,6m
474,2,Frost,4230,0,0,2,2,0.0%,26m
476,1,Похоронный,4229,188,6,1,7,85.7%,4m
477,1,ByunFan,4227,482,11,7,18,61.1%,8m
477,2,[IPW]NiceBiT,4227,0,3,3,6,50.0%,6m
479,2,[lOoKer]Werewolf,4226,170,5,1,6,83.3%,11m
480,1,Ronyer,4225,875,48,19,67,71.6%,10m
480,1,[SY2G]xZeiiden,4225,286,6,5,11,54.5%,8m
482,1,Loy,4223,2232,156,159,315,49.5%,9m
482,1,[Mobius]guilhem,4223,1656,46,38,84,54.8%,25m
482,1,[Ǽ1]MaSsACrO,4223,0,0,1,1,0.0%,5m
485,1,Taylor,4221,0,1,4,5,20.0%,6m
486,1,Filetongoute,4219,76,3,5,8,37.5%,8m
487,1,BabyYoda,4218,0,1,0,1,100.0%,23m
488,1,[НТТ]TrustInMe,4217,0,0,2,2,0.0%,25m
489,2,LunaSea,4215,262,14,1,15,93.3%,9m
489,1,Cromm,4215,564,12,11,23,52.2%,18m
489,1,[PLA2N]Torasaki,4215,0,0,1,1,0.0%,22m
492,1,MrTwoBonKu,4210,286,9,7,16,56.2%,5m
493,1,BuryTheLight,4209,818,23,19,42,54.8%,26m
494,1,[duсks]maniachillo,4208,956,38,32,70,54.3%,23m
494,1,[Furet]eAzy,4208,144,3,4,7,42.9%,12m
494,1,[TNSGN]ironduck,4208,48,1,2,3,33.3%,13m
497,1,Mamling,4207,518,12,18,30,40.0%,22m
497,3,VBHustler,4207,109,4,12,16,25.0%,9m
499,1,lousa,4205,748,17,18,35,48.6%,18m
500,1,LULU,4204,48,1,1,2,50.0%,9m
501,3,[jonasi]LYHxAlucard,4201,32,5,21,26,19.2%,8m
501,1,roro,4201,0,1,0,1,100.0%,21m
503,1,Dutes,4200,1339,48,30,78,61.5%,16m
503,1,Gesperrt,4200,0,1,0,1,100.0%,12m
505,1,Kastle,4199,48,1,4,5,20.0%,8m
506,1,[ZBL]SplitSeven,4198,144,3,4,7,42.9%,9m
506,2,PepperWood,4198,73,0,2,2,0.0%,11m
508,1,[mCon]VeNi,4196,144,3,8,11,27.3%,12m
509,2,american,4194,116,4,1,5,80.0%,5m
509,1,[PŖïMĄŁ]Azi,4194,144,3,6,9,33.3%,12m
511,1,[THRLLA]MicroJackson,4193,321,9,5,14,64.3%,12m
512,1,StimAddict,4187,1392,34,27,61,55.7%,3m
513,1,MikeHock,4186,129,4,7,11,36.4%,4m
514,1,Rincewind,4185,0,1,0,1,100.0%,16m
515,1,Babayaga,4184,90,1,2,3,33.3%,21m
516,1,[sGeeks]Skogshuggarn,4183,2058,135,105,240,56.2%,18m
517,1,Phive,4182,1716,175,167,342,51.2%,22m
517,1,youhavelost,4182,1190,30,26,56,53.6%,18m
519,3,LostReaper,4179,0,5,0,5,100.0%,26m
519,1,[MkersA]slide,4179,0,2,4,6,33.3%,6m
521,1,NewbRevenge,4177,749,27,29,56,48.2%,22m
522,1,[PaniC]xxMVGNUMxx,4176,1384,55,48,103,53.4%,8m
522,2,NanatoScop,4176,292,15,2,17,88.2%,26m
524,2,Artstyle,4175,130,3,4,7,42.9%,17m
524,3,[Dicboy]Pudgey,4175,0,1,0,1,100.0%,4m
524,3,[weblak]AzUhL,4175,0,0,1,1,0.0%,2m
527,1,[Dobro]FARD,4174,0,0,1,1,0.0%,11m
528,1,Sunshine,4173,210,5,3,8,62.5%,6m
529,1,GoPlayTetris,4171,1034,28,31,59,47.5%,23m
529,1,[AISC]Dunmer,4171,330,9,6,15,60.0%,18m
529,3,Erik,4171,97,4,5,9,44.4%,22m
532,1,Wasia,4170,2179,174,176,350,49.7%,9m
532,1,LearnToScout,4170,585,22,9,31,71.0%,16m
534,1,Esontial,4166,0,0,1,1,0.0%,4m
535,1,[ƮesXG]Tacki,4165,0,0,1,1,0.0%,8m
536,1,[RGSC2]LifeForAiur,4163,349,8,3,11,72.7%,25m
536,1,NezukoChan,4163,376,8,7,15,53.3%,26m
536,1,Fiorano,4163,320,7,11,18,38.9%,22m
539,1,[Fele]Myllarguten,4162,608,13,14,27,48.1%,25m
539,1,LastCell,4162,0,0,1,1,0.0%,5m
541,3,[Blocki]derBlocker,4161,418,46,62,108,42.6%,25m
541,3,[Hаsu]Ajax,4161,109,16,23,39,41.0%,9m
543,3,braeburn,4160,644,57,55,112,50.9%,12m
543,1,[LVPN]Zazar,4160,688,16,13,29,55.2%,26m
543,1,Nuffy,4160,207,9,0,9,100.0%,18m
546,1,[ǂHD]Aura,4159,48,1,2,3,33.3%,11m
546,3,Madman,4159,0,0,1,1,0.0%,26m
548,1,[EXPANT]Eclipse,4158,0,1,2,3,33.3%,22m
549,1,[BotN]CptPolarBear,4157,880,21,13,34,61.8%,11m
550,1,Celestis,4156,0,0,1,1,0.0%,23m
551,1,Gillbill,4154,2148,233,233,466,50.0%,26m
552,1,PaCJlaboHeC,4150,229,9,1,10,90.0%,21m
553,2,Zera,4148,88,2,0,2,100.0%,26m
554,3,[MGBNom]Hobo,4147,10,4,11,15,26.7%,2m
554,1,[Peeps]Christiaan,4147,88,2,2,4,50.0%,8m
556,1,Freekill,4146,1693,90,58,148,60.8%,18m
556,1,BaseUnit,4146,192,5,7,12,41.7%,25m
558,1,[улей55]Steelwar,4144,1641,51,42,93,54.8%,3m
558,1,[BROSER]Kurgan,4144,682,16,10,26,61.5%,16m
558,1,[HUJA]GUESH,4144,0,0,1,1,0.0%,2m
561,1,[K0mpis]Mojster,4143,551,13,5,18,72.2%,16m
561,1,vvg,4143,313,7,6,13,53.8%,2m
563,1,Daedra,4142,157,9,4,13,69.2%,8m
563,1,llllllllllll,4142,137,3,3,6,50.0%,8m
565,1,Jonny,4141,2153,217,219,436,49.8%,8m
565,1,[WetInd]SoakinWett,4141,180,4,6,10,40.0%,18m
567,1,[opFaiL]danischu,4140,1679,102,101,203,50.2%,23m
567,1,[PŖïMĄŁ]PaLLo,4140,556,13,11,24,54.2%,5m
569,1,[Sarmat]SaoriKimura,4139,142,4,2,6,66.7%,3m
569,2,[PaniC]Johnnie,4139,0,2,4,6,33.3%,21m
569,1,weirdo,4139,48,1,3,4,25.0%,21m
569,1,Lyakusha,4139,0,0,1,1,0.0%,25m
573,1,[Ahegаo]ElonMaks,4138,144,3,2,5,60.0%,10m
574,1,Komisola,4137,332,11,8,19,57.9%,9m
574,1,[GP]Terric,4137,0,1,4,5,20.0%,13m
576,1,Sephiroth,4136,96,2,2,4,50.0%,18m
577,1,Dexter,4135,1461,78,63,141,55.3%,16m
577,1,PhilDunphy,4135,48,1,3,4,25.0%,5m
579,1,[EXPANT]LePascu,4134,436,11,3,14,78.6%,16m
580,1,[LaggIT]FlexTerror,4132,563,15,12,27,55.6%,22m
581,1,[IMBAO]HellAlbY,4131,238,6,5,11,54.5%,16m
582,1,ẕѧұø,4130,1733,48,48,96,50.0%,12m
582,1,Vorck,4130,415,12,11,23,52.2%,25m
584,1,JPCarCanGG,4129,0,4,1,5,80.0%,16m
585,1,Andrius,4127,144,3,5,8,37.5%,26m
585,1,[АDV]CraZyPinGuiN,4127,48,1,4,5,20.0%,5m
587,1,[FR1]Hurricane,4126,586,14,17,31,45.2%,18m
587,1,ArkonoM,4126,48,1,1,2,50.0%,12m
587,1,ProdzaaH,4126,0,0,1,1,0.0%,23m
590,1,[MeIina]UndeadGirl,4123,48,1,4,5,20.0%,18m
591,1,[НТТ]set,4121,244,6,4,10,60.0%,16m
591,2,[UlaS]WannaBeZEST,4121,0,1,0,1,100.0%,15m
591,1,[EmScTv]Emil,4121,48,1,1,2,50.0%,4m
594,1,[ØC]iceman,4119,0,0,2,2,0.0%,18m
595,1,Chadoboy,4117,1701,52,42,94,55.3%,18m
596,1,Ponta,4116,596,16,15,31,51.6%,18m
597,1,LOKI,4115,96,3,2,5,60.0%,18m
597,3,[HOTFIR]AIphaStar,4115,30,1,1,2,50.0%,3m
599,1,[RøckeT]ElKassos,4113,676,16,11,27,59.3%,23m
600,1,[PŖïMĄŁ]Euron,4112,1253,33,22,55,60.0%,8m
600,2,[Wolven]DevilMarine,4112,108,2,3,5,40.0%,10m
602,3,raychuna,4110,262,62,57,119,52.1%,25m
602,3,TwentyTwenty,4110,0,2,3,5,40.0%,4m
604,1,Macrowave,4108,2081,68,72,140,48.6%,22m
604,1,[ENCEE]serral,4108,0,3,2,5,60.0%,12m
604,1,Pecueca,4108,88,1,2,3,33.3%,11m
607,1,[nB]MekTypro,4107,416,9,7,16,56.2%,13m
608,1,[PaniC]Losting,4106,48,1,8,9,11.1%,25m
609,1,rAyLayA,4105,94,3,7,10,30.0%,17m
609,1,Edax,4105,0,0,1,1,0.0%,16m
611,3,sva,4103,32,9,14,23,39.1%,15m
612,3,[GZerO]Aztec,4102,1540,240,241,481,49.9%,22m
613,1,Salomon,4101,211,6,8,14,42.9%,11m
613,1,JacobGayCop,4101,0,1,1,2,50.0%,22m
613,1,DripDrop,4101,0,0,4,4,0.0%,2m
616,1,[Lambro]edominator,4100,288,6,7,13,46.2%,18m
617,2,[WBO]Quezacoalt,4099,86,4,8,12,33.3%,15m
617,1,gazon,4099,94,2,1,3,66.7%,8m
619,1,roken,4098,48,2,0,2,100.0%,6m
619,1,[XxKxA]Mizukia,4098,0,1,2,3,33.3%,9m
619,3,Firefly,4098,0,0,1,1,0.0%,18m
622,1,[lBWl]Daman,4097,1858,59,64,123,48.0%,26m
622,2,[UAŦeam]Sensei,4097,0,1,0,1,100.0%,23m
622,2,Chuckie,4097,0,1,10,11,9.1%,5m
625,1,[dDb]Halalkött,4096,336,8,4,12,66.7%,18m
626,2,LEBONCARLOS,4095,129,2,5,7,28.6%,2m
626,1,[KRŽ]GreenDoom,4095,0,0,1,1,0.0%,9m
628,1,StrOng,4093,94,3,4,7,42.9%,18m
628,1,Majordark,4093,0,0,1,1,0.0%,16m
630,1,[RevoGG]Jehuty,4092,0,0,1,1,0.0%,13m
631,1,BritishGirl,4091,96,2,2,4,50.0%,5m
632,1,[PŖïMĄŁ]Primal,4090,704,16,20,36,44.4%,12m
632,1,Haluc,4090,0,1,0,1,100.0%,5m
634,1,Stayback,4089,46,1,2,3,33.3%,22m
635,1,CarloV,4088,0,2,3,5,40.0%,22m
635,1,[CPSLCK]Eule,4088,96,2,6,8,25.0%,2m
635,1,[SPTK]Piasek,4088,0,0,2,2,0.0%,17m
638,1,æææ,4087,1427,40,30,70,57.1%,8m
638,1,RSABoereWors,4087,499,11,6,17,64.7%,22m
638,1,[KoyBee]TROTSKY,4087,190,6,8,14,42.9%,21m
641,1,Gadfour,4085,0,0,1,1,0.0%,22m
642,1,[αX]NeWHoriZonS,4084,1715,46,56,102,45.1%,25m
643,1,BananaStand,4083,48,1,8,9,11.1%,18m
643,3,BuBBleS,4083,0,0,5,5,0.0%,19m
645,1,Hoilati,4082,631,30,21,51,58.8%,13m
645,1,Golanchik,4082,0,0,5,5,0.0%,22m
647,1,Dreamer,4081,1071,61,50,111,55.0%,22m
647,1,Ruffy,4081,0,1,0,1,100.0%,23m
649,1,FireFly,4080,286,6,10,16,37.5%,8m
649,1,SoralARaison,4080,94,3,0,3,100.0%,8m
649,1,[duсks]aikrash,4080,48,1,2,3,33.3%,23m
652,1,MarineRu,4079,231,8,12,20,40.0%,23m
653,1,[CxCx]Froenk,4078,0,1,0,1,100.0%,22m
653,1,PajackOP,4078,0,0,1,1,0.0%,8m
655,2,[tMnrd]Exercitus,4077,159,7,3,10,70.0%,5m
655,1,VuLTuRe,4077,94,3,0,3,100.0%,4m
657,1,[TheDOH]ghost,4075,1068,26,24,50,52.0%,13m
657,1,[1TNS1]Jamasman,4075,562,13,16,29,44.8%,18m
659,1,Kay,4072,370,13,15,28,46.4%,16m
659,3,[ggBDC]ThePatriot,4072,30,3,4,7,42.9%,19m
661,1,[HBGSJR]magic,4071,1991,70,57,127,55.1%,18m
662,1,[Arrows]DarKKnightSC,4070,1158,46,29,75,61.3%,26m
662,1,[OSgZ]Hednar,4070,229,7,5,12,58.3%,16m
662,1,kiim,4070,162,6,5,11,54.5%,6m
665,1,[DisES]Squall,4069,822,20,24,44,45.5%,6m
665,1,[ШОУМЕН]StereoClub,4069,521,15,7,22,68.2%,17m
667,1,Knalle,4068,138,4,3,7,57.1%,21m
667,1,[Peeps]TGO,4068,0,2,3,5,40.0%,8m
669,1,CitronBaBa,4067,580,65,38,103,63.1%,5m
670,1,Omega,4066,1632,53,61,114,46.5%,26m
671,1,Owlrazum,4064,1510,55,44,99,55.6%,16m
671,1,Eliasson,4064,1002,29,26,55,52.7%,8m
671,1,FlacidFAP,4064,487,18,9,27,66.7%,12m
674,3,Alexisonfire,4063,0,3,0,3,100.0%,23m
675,1,[XYFAN]Wanderer,4062,473,11,5,16,68.8%,22m
675,1,[EBIG]Duncan,4062,0,1,1,2,50.0%,22m
677,1,Vex,4061,1242,31,46,77,40.3%,12m
677,1,Aryster,4061,327,9,6,15,60.0%,5m
679,1,Calçot,4060,0,3,2,5,60.0%,26m
680,1,[BRSKR]Viroos,4059,915,50,15,65,76.9%,13m
680,1,[NovaX]Inspire,4059,230,6,8,14,42.9%,16m
680,1,Noisym,4059,0,1,0,1,100.0%,5m
683,1,iGod,4058,876,117,92,209,56.0%,16m
683,1,Mike,4058,1445,56,53,109,51.4%,25m
683,1,Acidstorm,4058,1073,38,36,74,51.4%,26m
686,1,UncleRuckus,4057,425,25,10,35,71.4%,8m
686,3,[BornG]AsheN,4057,11,10,20,30,33.3%,26m
686,1,[Dae]Skoll,4057,142,3,4,7,42.9%,23m
689,1,Yoyo,4056,232,5,0,5,100.0%,22m
689,1,EconDude,4056,190,5,5,10,50.0%,16m
689,1,[aW]VVV,4056,0,0,3,3,0.0%,8m
692,1,[EESC]Aramos,4053,1590,43,46,89,48.3%,25m
692,2,єМагвітер,4053,0,0,1,1,0.0%,16m
694,1,[ArGGEU]VanHelsingLQ,4051,48,2,4,6,33.3%,11m
695,1,Pacer,4050,267,6,5,11,54.5%,8m
696,1,QQQQQQQQQQQQ,4049,784,40,25,65,61.5%,26m
697,1,[MBK]Mikami,4048,2058,94,71,165,57.0%,21m
697,1,[NOW]Hilmekru,4048,0,0,1,1,0.0%,17m
699,1,BananKing,4047,2050,91,82,173,52.6%,22m
699,1,Isses,4047,484,11,12,23,47.8%,2m
699,1,Angesandet,4047,48,2,2,4,50.0%,10m
702,1,KaZe,4046,0,3,2,5,60.0%,18m
702,1,Spada,4046,0,1,4,5,20.0%,12m
704,1,OneDirection,4044,92,5,1,6,83.3%,16m
704,2,[LDLV]Poun,4044,0,0,1,1,0.0%,16m
706,1,[SaviOr]GhostMaster,4043,1355,76,46,122,62.3%,18m
706,1,[DN3N]Ardn,4043,366,8,10,18,44.4%,9m
708,1,knurrp,4042,473,10,16,26,38.5%,9m
708,1,Darkseall,4042,146,3,9,12,25.0%,16m
708,1,ArnoldS,4042,48,2,1,3,66.7%,16m
711,1,[WBO]iloveyou,4041,2047,96,83,179,53.6%,12m
712,1,[SGTA]Eclipse,4040,598,15,20,35,42.9%,8m
712,1,Kafelnikov,4040,0,1,0,1,100.0%,13m
714,1,Vodkaccount,4039,878,21,22,43,48.8%,4m
714,2,Feminist,4039,0,0,1,1,0.0%,24m
716,1,SorrY,4038,309,18,3,21,85.7%,4m
716,1,boanaan,4038,414,10,9,19,52.6%,10m
718,3,cyan,4037,191,7,0,7,100.0%,3m
718,1,[IndyK]Fly,4037,48,1,3,4,25.0%,10m
720,1,STellaR,4036,1876,72,62,134,53.7%,5m
721,1,[WBO]iLu,4034,668,19,18,37,51.4%,8m
721,1,[iX]Aerocool,4034,382,9,8,17,52.9%,23m
721,1,[simon]Simon,4034,0,1,1,2,50.0%,16m
724,1,llllllllllll,4033,804,20,27,47,42.6%,22m
724,1,[vCH]MrPépitos,4033,48,1,3,4,25.0%,18m
726,1,thD,4032,1574,66,79,145,45.5%,26m
726,1,[ОВOЩ]Player,4032,96,2,2,4,50.0%,13m
728,1,[LawB]Adik,4030,380,9,13,22,40.9%,23m
728,1,Kabooom,4030,0,0,1,1,0.0%,8m
730,1,[Heroes]Newton,4029,599,27,11,38,71.1%,14m
731,1,IIIIIIIIIIII,4028,1456,49,32,81,60.5%,21m
731,2,[BMD]Galaxy,4028,156,5,6,11,45.5%,17m
733,1,[BMI]Fezvez,4027,0,0,1,1,0.0%,10m
734,1,[DLOK]Tmaista,4026,0,1,0,1,100.0%,8m
735,1,Marbet,4025,1806,52,52,104,50.0%,2m
735,1,Song,4025,122,7,1,8,87.5%,21m
735,1,[JAFFE]tonnis,4025,140,5,6,11,45.5%,12m
738,3,[SALTYY]Muori,4024,790,57,67,124,46.0%,4m
739,1,Tyras,4023,881,47,38,85,55.3%,5m
739,1,Weon,4023,1278,30,45,75,40.0%,8m
739,1,[ShNice]IIIIIIIIIIII,4023,213,4,5,9,44.4%,23m
742,1,Noobgam,4022,1505,179,143,322,55.6%,5m
742,1,[Hrr]Singer,4022,0,1,2,3,33.3%,16m
744,1,yikes,4021,491,23,7,30,76.7%,25m
744,1,Flamby,4021,578,13,15,28,46.4%,11m
744,1,[ESErl]Devastating,4021,186,5,10,15,33.3%,25m
744,1,HopHopHop,4021,46,1,1,2,50.0%,14m
748,1,Thenix,4020,245,44,23,67,65.7%,5m
749,1,Fresh,4019,1972,127,120,247,51.4%,5m
749,1,[WÖLFE]Wulfen,4019,0,0,3,3,0.0%,8m
751,1,FabzG,4017,372,8,11,19,42.1%,6m
751,2,Albert,4017,88,1,1,2,50.0%,9m
753,1,Tomeus,4016,1080,26,28,54,48.1%,26m
754,1,[TAW]Baker,4014,491,18,10,28,64.3%,13m
754,1,[SNHonk]Fluffy,4014,46,2,1,3,66.7%,22m
754,3,ТайныйКраб,4014,0,1,5,6,16.7%,12m
754,1,[GEGT]Awesomesauce,4014,46,1,6,7,14.3%,22m
758,1,qDIABLOp,4012,0,1,0,1,100.0%,26m
758,1,[B1G]Slacker,4012,0,0,4,4,0.0%,16m
760,1,[Ahegаo]Frakish,4011,1750,62,39,101,61.4%,5m
760,1,[illGG]Jin,4011,295,12,13,25,48.0%,5m
762,1,PTGǂAcEteK,4010,0,1,0,1,100.0%,12m
762,1,[GXalpH]IIIIIIIIIIII,4010,0,0,2,2,0.0%,23m
764,1,Magephil,4008,276,7,8,15,46.7%,6m
764,1,ДжохниПрогей,4008,48,2,1,3,66.7%,6m
766,3,Alcyonée,4007,58,5,2,7,71.4%,6m
766,1,[ØC]Bekoj,4007,0,0,1,1,0.0%,25m
768,1,[HBGSJR]ace,4005,811,21,19,40,52.5%,16m
768,1,[сSсǃ]pluggglacior,4005,210,11,9,20,55.0%,9m
770,1,WarKnighT,4004,278,6,6,12,50.0%,2m
770,1,[henD]Cerberi,4004,272,6,6,12,50.0%,13m
770,1,[aW]MrTrixouille,4004,135,3,0,3,100.0%,16m
770,1,Маэстро,4004,0,0,1,1,0.0%,17m
774,1,[MSUSC2]mibig,4003,805,35,31,66,53.0%,8m
775,1,IIIIIIIIII,4002,343,12,8,20,60.0%,4m
775,2,ZemmourLove,4002,0,0,1,1,0.0%,10m
777,1,[ZERGTV]CaMCa,4000,94,3,2,5,60.0%,26m
778,1,epicnoob,3999,0,0,1,1,0.0%,16m
778,1,[44IQ]FourHead,3999,0,0,3,3,0.0%,6m
780,1,FunkyPants,3998,1188,37,29,66,56.1%,9m
781,1,NuclearPasta,3995,93,1,1,2,50.0%,22m
781,2,PiNkUniCORN,3995,0,0,1,1,0.0%,6m
783,3,QtAnimeGirl,3994,58,3,0,3,100.0%,26m
783,1,[fastgg]bioNade,3994,138,3,4,7,42.9%,18m
785,1,[BeSC]Skipp,3990,156,3,2,5,60.0%,9m
786,1,nangaybiss,3989,1146,51,37,88,58.0%,18m
786,1,AngryDonut,3989,347,16,6,22,72.7%,8m
788,1,[6PhD]ghost,3988,1446,45,42,87,51.7%,25m
788,1,[ØC]ParaBelluM,3988,174,5,1,6,83.3%,6m
790,1,Ghost,3987,1933,103,106,209,49.3%,22m
790,1,CrazyPanda,3987,759,51,55,106,48.1%,6m
792,1,[Maegis]SherKhan,3986,1229,32,37,69,46.4%,12m
792,1,miomaMo,3986,0,0,1,1,0.0%,22m
794,1,NIKI,3985,1660,76,57,133,57.1%,14m
794,1,DinDomino,3985,908,23,24,47,48.9%,23m
796,3,Ling,3983,30,1,3,4,25.0%,25m
797,1,ChOpSeR,3982,2017,430,435,865,49.7%,24m
798,1,liquid,3981,0,1,0,1,100.0%,22m
799,1,[7x]SevenXIGG,3980,2064,202,187,389,51.9%,26m
799,1,[Zelos]Zersandet,3980,406,8,8,16,50.0%,18m
799,1,GatewayMan,3980,91,1,1,2,50.0%,18m
802,1,[ЯD]Florujin,3978,195,8,7,15,53.3%,17m
802,1,[PL4NCK]jemp,3978,0,1,1,2,50.0%,12m
804,1,[RеG]ZOOOM,3977,927,38,25,63,60.3%,13m
804,1,Bunny,3977,130,6,2,8,75.0%,8m
804,1,YooZ,3977,0,1,1,2,50.0%,4m
807,1,IIIIIIIIIIII,3976,2031,772,769,1541,50.1%,18m
807,1,Protosex,3976,1117,38,21,59,64.4%,22m
807,1,HaviLing,3976,1013,38,28,66,57.6%,11m
807,1,YaoFace,3976,0,0,1,1,0.0%,16m
811,1,[prYde]SaberRider,3974,93,2,0,2,100.0%,22m
811,1,[TheDOH]Miczu,3974,0,1,0,1,100.0%,18m
813,1,[QreskT]SOVA,3973,713,38,30,68,55.9%,27m
813,3,TeilobRUN,3973,121,5,2,7,71.4%,25m
813,1,Tommy,3973,46,2,2,4,50.0%,8m
816,1,[eXøde]Saphir,3972,46,1,3,4,25.0%,26m
817,1,[FRZS]Troizza,3971,543,22,10,32,68.8%,5m
818,1,[SCRAB]PaRa,3969,350,9,7,16,56.2%,16m
818,1,[KDV]kiesiew,3969,90,2,1,3,66.7%,5m
818,3,UGOlivander,3969,0,1,4,5,20.0%,2m
818,2,IlIlIIIIIIII,3969,0,0,1,1,0.0%,23m
822,2,Doomer,3968,0,0,1,1,0.0%,14m
823,3,[DeVu]IMoGsPrime,3967,0,1,0,1,100.0%,8m
823,1,sdTV,3967,0,1,2,3,33.3%,2m
825,1,Korcky,3965,2017,165,166,331,49.8%,16m
825,1,Desperado,3965,1334,66,34,100,66.0%,22m
825,2,IIIIIIIIIIII,3965,38,4,3,7,57.1%,19m
825,1,jimi,3965,93,2,1,3,66.7%,22m
829,2,[БАНДА]scaRFace,3964,0,1,0,1,100.0%,10m
829,2,Mörri,3964,38,1,1,2,50.0%,17m
829,2,[WSB]Oggogg,3964,0,0,1,1,0.0%,11m
832,1,[PHØMUI]Eran,3963,1336,36,39,75,48.0%,17m
832,2,IngSoc,3963,40,2,1,3,66.7%,11m
832,2,Quib,3963,38,1,1,2,50.0%,11m
835,1,[BRUSHT]Aquafresh,3962,440,10,12,22,45.5%,25m
836,1,[HBGSJR]mchoma,3961,274,7,9,16,43.8%,8m
836,1,PeterPan,3961,138,4,6,10,40.0%,13m
838,1,Ryder,3960,1595,734,678,1412,52.0%,16m
838,1,[MERKL]AtilaHiltman,3960,230,15,4,19,78.9%,18m
838,1,[COSMIQ]Albator,3960,0,1,6,7,14.3%,4m
841,2,DiScHdiScH,3959,80,2,2,4,50.0%,23m
842,2,Moebius,3958,102,3,0,3,100.0%,6m
842,2,[tMnrd]mrDarcy,3958,0,0,1,1,0.0%,6m
844,2,Hydrenoire,3956,638,25,12,37,67.6%,11m
844,2,[KDV]Lucius,3956,0,1,0,1,100.0%,16m
846,3,Rumo,3955,0,1,0,1,100.0%,12m
847,1,Charlie,3954,316,8,8,16,50.0%,16m
847,2,[FlyPy]joonTerror,3954,0,1,0,1,100.0%,7m
849,1,BlunTeD,3953,1754,174,180,354,49.2%,9m
849,1,FeetAreLove,3953,689,25,21,46,54.3%,22m
849,2,LDH,3953,308,9,8,17,52.9%,24m
849,1,Paralizzka,3953,319,6,7,13,46.2%,2m
849,3,Xenocide,3953,97,1,1,2,50.0%,18m
854,2,[HTY]LOL,3952,210,6,4,10,60.0%,7m
855,1,[7x]Ravengg,3951,92,3,4,7,42.9%,9m
856,2,luke,3949,715,33,21,54,61.1%,24m
856,3,JeanCastex,3949,215,11,2,13,84.6%,2m
858,1,shtopr,3948,501,12,11,23,52.2%,17m
859,1,moki,3946,1082,67,63,130,51.5%,5m
859,3,iliya,3946,0,0,1,1,0.0%,25m
861,2,LifeIVs,3945,84,2,4,6,33.3%,17m
862,2,bosswoss,3944,1586,128,117,245,52.2%,25m
862,1,[0Dfeat]Probe,3944,1114,31,30,61,50.8%,9m
862,2,Left,3944,30,2,1,3,66.7%,2m
865,2,Eliphas,3943,0,1,1,2,50.0%,16m
865,2,[IÐŠI]snadge,3943,0,0,1,1,0.0%,16m
867,1,[Hаsu]Makunouchi,3942,0,1,2,3,33.3%,22m
868,1,Okee,3941,375,18,17,35,51.4%,11m
868,1,Vedi,3941,582,13,19,32,40.6%,26m
868,2,KendreeamTV,3941,0,0,2,2,0.0%,6m
871,1,[PRlME]Faeton,3940,695,72,71,143,50.3%,24m
871,2,Sashamon,3940,0,1,0,1,100.0%,13m
871,3,Dead,3940,97,1,1,2,50.0%,16m
871,2,Clem,3940,0,0,1,1,0.0%,26m
875,2,Bronco,3939,682,149,128,277,53.8%,22m
875,2,cKoL,3939,354,11,9,20,55.0%,26m
875,3,Aina,3939,30,2,0,2,100.0%,14m
875,2,[Frzen]Elsa,3939,32,1,1,2,50.0%,23m
879,3,Arcticus,3938,955,68,90,158,43.0%,2m
879,1,[LSPs]SeñorPepino,3938,957,27,29,56,48.2%,9m
879,1,[h3z]MasterSmurf,3938,295,18,12,30,60.0%,12m
879,1,[AiRǂ]rIpSatomi,3938,449,14,10,24,58.3%,18m
879,2,Freeman,3938,0,1,0,1,100.0%,23m
884,1,Marid,3937,368,9,17,26,34.6%,22m
885,3,PriceYouPay,3936,0,0,1,1,0.0%,17m
886,2,Ulz,3934,132,4,5,9,44.4%,3m
887,2,buffy,3933,166,6,3,9,66.7%,18m
887,2,Jooot,3933,34,2,0,2,100.0%,25m
889,2,[Hаsu]Karaks,3932,0,0,1,1,0.0%,16m
890,2,[Kompis]ChubbS,3930,88,2,1,3,66.7%,3m
890,2,[AnD]SpeCial,3930,0,0,1,1,0.0%,23m
892,2,UedSoldier,3929,70,2,1,3,66.7%,26m
893,1,iga,3928,1403,322,336,658,48.9%,9m
893,1,[Ovrrtd]Alexander,3928,203,8,9,17,47.1%,11m
893,3,[UAŦeam]Corrz,3928,0,0,2,2,0.0%,17m
896,1,иван,3927,1991,94,106,200,47.0%,18m
896,1,[HEROV]HeroMandarin,3927,935,34,19,53,64.2%,11m
896,2,IlIlIlIlIlIl,3927,100,4,3,7,57.1%,10m
896,3,Wirt,3927,0,3,2,5,60.0%,6m
900,2,[EAU]Storm,3926,132,4,3,7,57.1%,3m
900,1,Jonas,3926,0,1,8,9,11.1%,9m
902,2,[ExpdtD]DiabloFeTo,3925,278,10,2,12,83.3%,16m
902,3,[FrBz]Didi,3925,0,0,1,1,0.0%,13m
902,3,[MkersA]OblIVIoN,3925,0,0,5,5,0.0%,19m
905,2,KoNeKø,3924,30,1,2,3,33.3%,18m
906,2,Truth,3923,326,11,7,18,61.1%,19m
906,3,BiggySama,3923,0,0,1,1,0.0%,8m
906,2,[SCiE]TinToon,3923,0,0,1,1,0.0%,13m
906,3,[QTcIub]novichkovnik,3923,0,0,2,2,0.0%,9m
910,2,ClownFiesta,3922,0,1,0,1,100.0%,25m
911,2,[CrWw]Dost,3921,1200,46,42,88,52.3%,26m
911,1,Nylky,3921,613,29,18,47,61.7%,18m
911,3,SaveTheQueen,3921,30,4,3,7,57.1%,6m
914,1,THERIPPER,3920,1564,76,75,151,50.3%,26m
914,1,[Li3]Samur,3920,0,1,8,9,11.1%,18m
916,2,[SZ]NeMo,3919,1674,85,61,146,58.2%,26m
916,1,OOOOOOOOOOOO,3919,989,26,30,56,46.4%,8m
918,1,MadDog,3918,0,0,3,3,0.0%,5m
919,2,BobRoss,3917,66,3,1,4,75.0%,26m
919,2,Seki,3917,36,1,1,2,50.0%,11m
919,3,Atlas,3917,0,0,3,3,0.0%,4m
922,1,[Dralag]FullMaster,3916,239,8,7,15,53.3%,22m
923,2,[aW]DonDada,3915,138,5,3,8,62.5%,26m
923,2,littleINno,3915,38,1,3,4,25.0%,10m
923,3,[lWHl]Destro,3915,30,1,5,6,16.7%,9m
926,2,IceDalek,3914,0,0,1,1,0.0%,23m
927,2,vanderlokken,3912,264,8,8,16,50.0%,17m
927,2,MoreGG,3912,134,4,5,9,44.4%,13m
927,3,[GTMNG]FroZeN,3912,0,1,1,2,50.0%,11m
930,1,[CSM]CosmicGus,3910,1376,39,50,89,43.8%,6m
931,1,Boubou,3909,320,7,12,19,36.8%,18m
931,2,Kharyb,3909,0,4,1,5,80.0%,10m
931,2,JeremyHunt,3909,38,1,3,4,25.0%,6m
934,2,[TAW]FreeZ,3908,202,7,5,12,58.3%,13m
935,3,Nice,3907,0,0,1,1,0.0%,13m
936,1,MattThePie,3906,94,2,7,9,22.2%,5m
937,1,SHOSHO,3905,229,7,9,16,43.8%,11m
937,2,[Batmen]ActionJaxon,3905,0,0,1,1,0.0%,5m
939,2,[IÐŠI]pure,3904,0,0,1,1,0.0%,17m
940,1,louvirilou,3903,566,13,22,35,37.1%,6m
941,2,youtoonoob,3902,602,25,10,35,71.4%,5m
941,1,MrFancyPants,3902,396,10,13,23,43.5%,18m
941,2,[EZ4XY]Magejiterran,3902,126,5,0,5,100.0%,15m
944,2,Molu,3901,507,18,19,37,48.6%,3m
944,2,[PÂRłAH]SmokedSloth,3901,418,15,12,27,55.6%,16m
944,2,СиД,3901,254,14,6,20,70.0%,5m
947,2,MentalSnipe,3900,36,1,1,2,50.0%,13m
947,3,[PaniC]Gongilimb,3900,0,0,1,1,0.0%,15m
949,2,Fess,3898,310,11,5,16,68.8%,25m
950,2,Kanadan,3897,0,0,1,1,0.0%,22m
951,1,Nejolight,3896,1757,115,111,226,50.9%,12m
951,1,Kyezer,3896,816,21,27,48,43.8%,16m
951,2,Imminent,3896,0,0,1,1,0.0%,14m
954,1,[ICGl]MoDDiB,3895,902,87,85,172,50.6%,16m
954,1,[bitoQ2]Sazzaro,3895,659,21,17,38,55.3%,9m
954,1,[PTSL]Starscream,3895,588,14,23,37,37.8%,2m
954,2,[T404]Midir,3895,0,1,0,1,100.0%,11m
958,1,Abrissbirne,3894,1577,78,74,152,51.3%,23m
959,1,TripleDK,3892,855,58,54,112,51.8%,3m
959,2,[PÂRłAH]SolusRex,3892,68,2,2,4,50.0%,24m
961,2,[ICG]Brute,3891,0,1,0,1,100.0%,26m
962,2,[WBO]Moon,3890,683,28,9,37,75.7%,19m
962,2,quietMADman,3890,209,9,7,16,56.2%,24m
964,3,[EHH]Omop,3889,30,2,0,2,100.0%,8m
965,2,pingEling,3888,145,13,11,24,54.2%,24m
965,2,Insideme,3888,164,6,3,9,66.7%,16m
965,1,Punk,3888,0,3,2,5,60.0%,13m
968,1,GartenZerg,3887,1188,51,28,79,64.6%,13m
968,3,XereoArboron,3887,169,4,2,6,66.7%,25m
970,2,xXNoScOpeXx,3886,0,1,4,5,20.0%,21m
970,2,JauneD,3886,0,1,5,6,16.7%,19m
970,2,Jolatis,3886,0,0,1,1,0.0%,25m
973,1,[PŖïMĄŁ]LeTsGoBiLLy,3885,0,1,4,5,20.0%,11m
974,2,VaultOne,3884,106,4,3,7,57.1%,19m
975,2,[AI1]VeeRust,3883,106,3,6,9,33.3%,10m
975,2,Krilian,3883,0,0,3,3,0.0%,7m
977,1,Michael,3882,415,25,18,43,58.1%,6m
977,2,llllllllllll,3882,471,21,10,31,67.7%,15m
977,2,[PaniC]Happytoss,3882,30,1,1,2,50.0%,17m
980,2,зерг,3881,203,8,6,14,57.1%,5m
980,2,[TGosuB]SandKrab,3881,64,7,1,8,87.5%,26m
982,2,CrabiTTo,3880,280,10,5,15,66.7%,26m
983,2,Yoyo,3879,30,1,2,3,33.3%,17m
984,1,CheesusChrst,3876,1214,31,51,82,37.8%,18m
985,2,[Castpl]michus,3874,759,28,30,58,48.3%,10m
985,2,Masturbifant,3874,254,13,3,16,81.2%,25m
985,2,[WLovB]Pikachiu,3874,206,6,7,13,46.2%,13m
985,2,Ultimat,3874,74,3,1,4,75.0%,10m
989,2,FANATICK,3873,540,18,18,36,50.0%,3m
989,2,IIIIIIIIIIII,3873,0,5,0,5,100.0%,19m
991,2,[6MP]Zeo,3872,612,23,16,39,59.0%,4m
991,1,OlekStark,3872,558,14,19,33,42.4%,9m
991,2,Syocto,3872,175,5,8,13,38.5%,15m
994,2,epicvoid,3871,0,4,1,5,80.0%,7m
994,2,[VFish]Nimzo,3871,72,3,1,4,75.0%,26m
994,2,Hennes,3871,0,0,3,3,0.0%,17m
997,1,Xaaros,3870,421,11,15,26,42.3%,23m
997,1,tschack,3870,454,10,16,26,38.5%,18m
999,3,AyneDikka,3869,1732,722,760,1482,48.7%,23m
999,2,[KAOTx]Smilingblade,3869,1526,62,49,111,55.9%,11m
1001,2,[lOoKer]DrAxelroose,3868,124,5,2,7,71.4%,2m
1001,2,[crabz]guliver,3868,0,0,4,4,0.0%,5m
1003,2,[ICGl]elfleischo,3867,1123,55,26,81,67.9%,23m
1003,3,Golo,3867,0,0,2,2,0.0%,19m
1005,2,Random,3866,410,35,10,45,77.8%,16m
1005,2,AlPacino,3866,534,19,14,33,57.6%,23m
1005,2,pyrox,3866,72,2,6,8,25.0%,11m
1008,2,Kauhu,3865,120,4,1,5,80.0%,9m
1008,2,Anhtai,3865,128,4,1,5,80.0%,5m
1010,3,[iOwnU]ImbaLJ,3864,0,1,0,1,100.0%,7m
1011,1,[fastgg]Turrican,3863,1959,423,421,844,50.1%,26m
1011,1,Terranosaure,3863,666,20,18,38,52.6%,23m
1013,1,[TLMC]LSD,3862,614,15,21,36,41.7%,23m
1013,2,[mlem]TheBotanist,3862,378,14,10,24,58.3%,3m
1013,2,[RNSFL]TheDwarf,3862,70,2,5,7,28.6%,15m
1013,2,ANDROID,3862,0,0,1,1,0.0%,9m
1017,2,Algernon,3860,0,1,0,1,100.0%,5m
1018,2,yoda,3859,253,9,2,11,81.8%,11m
1019,2,[CYC]hansi,3858,126,5,5,10,50.0%,26m
1020,2,Burger,3857,200,8,3,11,72.7%,16m
1020,2,quietMADman,3857,0,0,1,1,0.0%,25m
1022,1,[CocoCo]ugly,3856,1757,63,61,124,50.8%,3m
1022,3,Ronald,3856,60,4,6,10,40.0%,25m
1022,2,[lOoOl]TGNP,3856,138,3,2,5,60.0%,5m
1022,2,ToniFlex,3856,0,0,1,1,0.0%,13m
1026,1,tEzE,3855,1960,787,793,1580,49.8%,18m
1026,2,[SJSr]ChainBurn,3855,34,1,2,3,33.3%,26m
1026,2,[PLOPI]Aston,3855,0,0,1,1,0.0%,26m
1029,1,IIIIIIIIIIII,3854,596,15,19,34,44.1%,5m
1030,1,Dal,3852,498,12,21,33,36.4%,16m
1030,1,LeJoker,3852,0,3,2,5,60.0%,17m
1030,2,Xtse,3852,66,3,3,6,50.0%,15m
1033,1,ArturPirojkv,3851,1944,465,496,961,48.4%,9m
1033,3,YippeeKiYay,3851,149,4,4,8,50.0%,16m
1035,2,[SigV]Metikha,3850,776,89,73,162,54.9%,18m
1035,2,Ouroboros,3850,144,8,0,8,100.0%,26m
1035,3,Dikoobrazz,3850,121,3,4,7,42.9%,22m
1035,3,[OXs]Hyppox,3850,97,2,0,2,100.0%,26m
1039,3,HanZo,3847,191,5,4,9,55.6%,3m
1039,2,[QTclub]Sprite,3847,34,2,1,3,66.7%,14m
1039,2,[Ex0n]Hønsking,3847,68,2,4,6,33.3%,17m
1042,3,zzzzzzzzzzzz,3846,97,5,1,6,83.3%,12m
1043,2,Deckard,3844,206,8,5,13,61.5%,2m
1044,2,Cube,3843,1292,56,44,100,56.0%,18m
1044,2,[DUX]Khaƴsaril,3843,809,36,27,63,57.1%,16m
1044,1,barcode,3843,539,15,18,33,45.5%,2m
1044,2,GoldenArmada,3843,0,0,1,1,0.0%,26m
1048,2,[read]reudigekatze,3842,486,20,16,36,55.6%,11m
1048,1,Infinity,3842,0,4,0,4,100.0%,9m
1048,2,[yubm]Eyþór,3842,62,3,2,5,60.0%,13m
1048,3,[FearEU]Snake,3842,121,3,3,6,50.0%,23m
1048,2,Slashman,3842,0,1,0,1,100.0%,17m
1048,2,Brasida,3842,0,0,1,1,0.0%,7m
1054,2,CptProtoss,3841,833,56,38,94,59.6%,4m
1054,1,StifleR,3841,871,24,30,54,44.4%,23m
1056,1,[GHOGHH]RedKokiedo,3840,1106,50,47,97,51.5%,22m
1056,2,EinVolT,3840,0,0,1,1,0.0%,16m
1056,2,[SøE]Impi,3840,0,0,1,1,0.0%,7m
1056,2,FireBird,3840,0,0,3,3,0.0%,26m
1060,2,[GyCd]Alcootest,3839,589,85,83,168,50.6%,4m
1060,2,Mpeta,3839,469,22,17,39,56.4%,25m
1060,2,SeaS,3839,178,6,3,9,66.7%,19m
1060,2,Zergling,3839,66,2,1,3,66.7%,26m
1060,2,[EESC]JoaN,3839,0,0,1,1,0.0%,5m
1065,2,VelvetThunda,3838,192,6,10,16,37.5%,22m
1065,2,Explosion,3838,94,5,5,10,50.0%,12m
1065,2,[NBBS]pasen,3838,0,1,0,1,100.0%,6m
1068,2,Coffeeman,3837,389,20,6,26,76.9%,5m
1069,2,[KDV]DrZerg,3836,58,3,1,4,75.0%,8m
1070,1,[NerCC]Nerzgul,3835,1145,75,59,134,56.0%,27m
1070,2,FistBruh,3835,450,18,8,26,69.2%,11m
1070,2,PacRAT,3835,456,17,17,34,50.0%,2m
1070,2,notforall,3835,0,2,3,5,40.0%,17m
1074,2,[INAE]Kronos,3833,382,13,14,27,48.1%,4m
1074,3,BigRichard,3833,191,10,1,11,90.9%,10m
1074,1,[Worms]Yellowman,3833,0,0,4,4,0.0%,22m
1077,2,[aW]ZphiR,3832,354,13,10,23,56.5%,13m
1077,2,arvak,3832,178,7,5,12,58.3%,10m
1077,2,Eledion,3832,34,3,4,7,42.9%,23m
1080,2,TMlevel,3829,1612,417,402,819,50.9%,26m
1080,1,[tMnrd]Toffee,3829,1208,54,54,108,50.0%,16m
1080,1,NodMCV,3829,1237,41,41,82,50.0%,23m
1080,2,Ewells,3829,528,22,22,44,50.0%,23m
1080,2,Strategy,3829,212,11,3,14,78.6%,10m
1085,2,Flake,3828,662,22,25,47,46.8%,18m
1085,1,Carcajadas,3828,317,12,19,31,38.7%,22m
1085,3,Predator,3828,217,11,3,14,78.6%,6m
1085,2,[BornG]arT,3828,64,4,6,10,40.0%,25m
1085,2,[ZЕRGTV]Qwan,3828,0,0,1,1,0.0%,23m
1090,1,MidOrFeed,3827,1821,224,208,432,51.9%,8m
1091,1,prototype,3826,660,15,26,41,36.6%,12m
1092,1,szeweningen,3825,1670,94,78,172,54.7%,11m
1092,2,IIIIIIIIIIII,3825,402,14,8,22,63.6%,26m
1094,2,[lMMl]Moreal,3824,664,26,21,47,55.3%,9m
1094,2,AfterSeven,3824,329,25,22,47,53.2%,26m
1096,2,[ФАНСАФ]PaiN,3823,219,7,3,10,70.0%,27m
1096,2,[HUN1]somdreamer,3823,66,2,4,6,33.3%,7m
1096,2,[NoGy]IMBarabba,3823,38,1,5,6,16.7%,22m
1099,2,Lonkero,3822,486,22,12,34,64.7%,26m
1099,2,AfterLife,3822,164,9,1,10,90.0%,10m
1101,1,epikfaal,3821,152,5,8,13,38.5%,17m
1101,1,JaceKaoS,3821,97,3,3,6,50.0%,16m
1103,2,Onoes,3820,1138,56,48,104,53.8%,4m
1103,2,[ZERGML]QWERTY,3820,914,38,25,63,60.3%,17m
1103,2,KirillVolkov,3820,150,9,0,9,100.0%,17m
1106,2,[lMMl]salama,3819,166,6,7,13,46.2%,7m
1106,2,SaNiCh,3819,0,0,1,1,0.0%,23m
1108,2,Asparagus,3818,188,8,3,11,72.7%,14m
1108,2,Seat,3818,146,5,3,8,62.5%,11m
1110,2,[SVRO]AirBlaze,3817,88,3,6,9,33.3%,11m
1110,2,IIIIIIIIIIII,3817,0,1,0,1,100.0%,23m
1110,1,JinJaeJeong,3817,0,1,0,1,100.0%,17m
1110,2,[ÖRRR]Whaittis,3817,0,1,5,6,16.7%,13m
1114,1,[Bruvas]MikeLarry,3816,650,17,25,42,40.5%,26m
1114,2,[8TaO8]Avalon,3816,100,3,4,7,42.9%,11m
1116,2,[nDiie]Saske,3815,1612,258,253,511,50.5%,4m
1116,2,majic,3815,1247,111,113,224,49.6%,26m
1116,2,WngsOfLbrty,3815,554,22,19,41,53.7%,11m
1116,2,Eco,3815,0,0,1,1,0.0%,2m
1120,2,[hängA]Shiva,3814,184,6,6,12,50.0%,15m
1120,2,[SpagLo]Asheir,3814,0,1,1,2,50.0%,7m
1120,2,sorcio,3814,32,1,1,2,50.0%,26m
1123,1,[D0N3]ImbaLino,3813,1379,46,44,90,51.1%,16m
1123,1,Kys,3813,145,3,4,7,42.9%,14m
1125,1,[UATeam]HighHopes,3812,1693,78,87,165,47.3%,11m
1125,2,Thirty,3812,1260,53,37,90,58.9%,16m
1125,2,Brocklyn,3812,296,11,7,18,61.1%,17m
1128,2,[BRSKR]Paloma,3811,32,2,2,4,50.0%,10m
1128,2,BlackAnubis,3811,0,0,2,2,0.0%,23m
1130,2,Pablink,3810,586,21,19,40,52.5%,18m
1130,2,Razhalgul,3810,92,4,2,6,66.7%,5m
1130,2,[Frzen]Elsa,3810,0,1,0,1,100.0%,25m
1133,2,Phantøm,3809,439,15,15,30,50.0%,11m
1133,2,[TGCrew]KCal,3809,246,9,7,16,56.2%,16m
1135,1,Fullbringer,3808,97,1,2,3,33.3%,24m
1135,2,Mode,3808,0,0,1,1,0.0%,23m
1135,2,ekko,3808,0,0,1,1,0.0%,13m
1138,2,Rocky,3807,30,1,7,8,12.5%,23m
1139,1,jeahrait,3806,180,5,12,17,29.4%,25m
1140,2,Emufarmer,3805,97,1,1,2,50.0%,26m
1140,2,Teva,3805,0,1,4,5,20.0%,12m
1142,2,Last,3804,1088,42,39,81,51.9%,19m
1142,2,[Benz]WhySoSeriOus,3804,30,3,4,7,42.9%,26m
1144,2,FreeHongkong,3803,0,0,1,1,0.0%,26m
1145,2,[valars]iluvatar,3802,142,5,1,6,83.3%,26m
1145,2,exePriMe,3802,58,2,2,4,50.0%,8m
1145,3,jeanairoldi,3802,0,1,1,2,50.0%,7m
1145,2,Crazy,3802,0,0,2,2,0.0%,14m
1149,1,NookY,3801,88,4,8,12,33.3%,10m
1149,3,[HayCe]Mazicho,3801,97,2,5,7,28.6%,21m
1149,2,RobertDindon,3801,0,1,0,1,100.0%,14m
1152,3,KellogZ,3800,97,2,0,2,100.0%,18m
1152,2,[VFN]NinJa,3800,30,2,1,3,66.7%,10m
1152,2,WhereBalance,3800,30,1,1,2,50.0%,15m
1155,1,Aaskereia,3799,1408,144,142,286,50.3%,6m
1155,2,Bayash,3799,234,8,4,12,66.7%,7m
1155,2,[tvESP]maralekos,3799,0,3,2,5,60.0%,13m
1155,3,Kvothe,3799,37,2,3,5,40.0%,14m
1155,3,TMT,3799,0,1,0,1,100.0%,15m
1155,2,PlayerOne,3799,0,0,1,1,0.0%,14m
1155,2,[DaGOAT]Sinus,3799,0,0,1,1,0.0%,12m
1162,2,zatic,3798,910,230,224,454,50.7%,22m
1162,2,[TAW]HenpeT,3798,0,1,0,1,100.0%,15m
1164,2,[PwS]Berstuk,3797,0,1,1,2,50.0%,13m
1165,1,AlphaStar,3795,1902,310,308,618,50.2%,25m
1165,2,DonStefano,3795,496,18,25,43,41.9%,26m
1165,2,[PAWC]Mateusz,3795,0,1,0,1,100.0%,3m
1165,2,[BNest]LoneWolf,3795,0,1,0,1,100.0%,14m
1165,3,SomeGuy,3795,0,1,1,2,50.0%,6m
1170,2,zup,3794,198,8,3,11,72.7%,25m
1170,2,atomas,3794,0,3,2,5,60.0%,5m
1170,2,OPmarine,3794,34,1,4,5,20.0%,25m
1170,2,spireet,3794,0,0,5,5,0.0%,8m
1174,2,dumè,3793,1020,45,29,74,60.8%,23m
1174,3,NazmoX,3793,190,6,0,6,100.0%,12m
1174,2,[TirolA]bodia,3793,30,3,3,6,50.0%,7m
1174,2,Double,3793,0,0,3,3,0.0%,22m
1178,2,Xado,3792,446,15,17,32,46.9%,23m
1178,2,[PLA2N]Zerash,3792,408,14,16,30,46.7%,14m
1180,1,[BPaF]military,3791,1895,343,355,698,49.1%,18m
1180,2,WAZABI,3791,416,22,10,32,68.8%,7m
1182,1,[ĦRZ]mindjames,3789,434,12,24,36,33.3%,18m
1182,2,TriBBleX,3789,30,3,4,7,42.9%,16m
1184,2,Dranik,3788,30,1,5,6,16.7%,26m
1185,1,MAX,3787,1831,75,83,158,47.5%,17m
1185,1,slatten,3787,395,8,18,26,30.8%,13m
1187,2,Fedary,3786,324,12,12,24,50.0%,23m
1187,3,Troggenir,3786,218,11,3,14,78.6%,24m
1187,3,lIIIIlllllIl,3786,143,4,2,6,66.7%,15m
1187,2,ImpuLse,3786,64,4,6,10,40.0%,17m
1187,1,[Fridge]Shiro,3786,0,2,3,5,40.0%,25m
1192,2,GucciPoochie,3785,284,10,15,25,40.0%,26m
1192,3,[8TaO8]shadow,3785,188,9,0,9,100.0%,8m
1194,2,Gumby,3784,1557,120,91,211,56.9%,26m
1194,2,DJAY,3784,364,14,6,20,70.0%,13m
1194,2,Shiny,3784,60,2,1,3,66.7%,23m
1194,2,jffun,3784,30,1,2,3,33.3%,25m
1194,2,[IBeAŚI]Windsurfer,3784,0,0,1,1,0.0%,25m
1199,2,UnknownNoTwo,3783,0,0,1,1,0.0%,19m
1199,2,[сSсǃ]GooDCat,3783,0,0,4,4,0.0%,23m
1201,2,genghiswolf,3782,1370,70,77,147,47.6%,23m
1201,2,[nB]Addon,3782,348,14,7,21,66.7%,26m
1201,1,[50x]Breaker,3782,0,1,21,22,4.5%,14m
1204,2,[Animoo]Dannie,3781,1294,52,47,99,52.5%,25m
1204,2,Koba,3781,713,31,39,70,44.3%,3m
1204,2,[Heroes]Chris,3781,0,1,0,1,100.0%,5m
1204,2,Xistl,3781,0,1,0,1,100.0%,5m
1208,2,bonta,3779,1554,82,35,117,70.1%,10m
1209,2,Springfield,3778,456,21,15,36,58.3%,19m
1209,2,[WN1]neUtricK,3778,0,0,1,1,0.0%,11m
1211,1,[LandP]LordFekalos,3777,1004,28,36,64,43.8%,5m
1211,2,RussianDad,3777,502,19,15,34,55.9%,11m
1213,2,BilboZeRabit,3775,34,2,1,3,66.7%,5m
1214,1,Geronimo,3774,1893,146,154,300,48.7%,18m
1214,1,GhostTemplar,3774,1079,37,39,76,48.7%,9m
1214,3,MikeHawk,3774,118,5,7,12,41.7%,4m
1217,2,[ManB]surculus,3773,30,2,0,2,100.0%,12m
1218,2,[FИCK]DanjA,3772,422,17,4,21,81.0%,5m
1219,1,ShadyDealer,3771,1137,33,40,73,45.2%,16m
1219,2,CaptainTruel,3771,34,2,6,8,25.0%,14m
1221,2,Coinlecanard,3770,678,23,30,53,43.4%,6m
1221,1,[TheDOH]secretspace,3770,386,9,32,41,22.0%,3m
1221,2,Inferno,3770,216,7,8,15,46.7%,5m
1221,2,DarK,3770,30,1,2,3,33.3%,23m
1225,2,[ioStuN]Eddy,3769,0,0,2,2,0.0%,2m
1226,2,ProtossSmurf,3768,359,17,7,24,70.8%,11m
1226,2,[BuO]destroy,3768,0,1,0,1,100.0%,26m
1228,1,[Tren]Naccer,3767,894,31,30,61,50.8%,22m
1229,2,benjatoooo,3766,399,37,30,67,55.2%,15m
1229,2,KurtBlock,3766,144,6,2,8,75.0%,2m
1231,2,[KewanK]sayka,3765,894,56,52,108,51.9%,13m
1231,2,[Сlеvеr]Swarm,3765,190,8,0,8,100.0%,3m
1231,2,[aW]Jeatall,3765,30,1,3,4,25.0%,5m
1234,2,[aW]clockmaster,3764,58,2,3,5,40.0%,11m
1234,2,[Kaput]lejneb,3764,30,2,4,6,33.3%,23m
1236,2,Ergopro,3763,322,12,10,22,54.5%,5m
1236,3,Isaac,3763,30,1,2,3,33.3%,16m
1238,2,[NetGG]Gwun,3762,250,9,5,14,64.3%,23m
1238,2,Yorkie,3762,260,9,10,19,47.4%,18m
1240,2,fqsfqsdfqzef,3761,624,22,23,45,48.9%,5m
1240,2,Steinway,3761,264,14,7,21,66.7%,22m
1240,2,KIss,3761,282,10,14,24,41.7%,4m
1240,1,NightKnight,3761,0,4,1,5,80.0%,11m
1240,2,[Looser]IYIBlade,3761,60,2,8,10,20.0%,4m
1245,2,[TheDOH]LoKlok,3760,200,8,7,15,53.3%,3m
1246,2,JCTC,3759,376,20,6,26,76.9%,4m
1246,2,[E1X]ExTenZ,3759,454,15,20,35,42.9%,23m
1246,2,[QQ]Pitch,3759,266,9,12,21,42.9%,25m
1246,2,SeriousSam,3759,0,2,1,3,66.7%,17m
1250,2,[STFUNB]Anonymouse,3758,832,32,30,62,51.6%,23m
1250,2,[kælder]GeOrgi,3758,184,20,17,37,54.1%,26m
1252,2,OHOOUO,3757,701,31,15,46,67.4%,15m
1253,2,yayagrou,3756,277,9,8,17,52.9%,8m
1253,2,BeWater,3756,0,2,1,3,66.7%,7m
1255,2,[сSсǃ]Мороженко,3755,1504,110,48,158,69.6%,10m
1255,2,[ĦĦ]Ʀơƴaƪ,3755,0,0,1,1,0.0%,12m
1255,2,Cheesy,3755,0,0,1,1,0.0%,18m
1258,2,[FxL]Lapin,3754,220,8,10,18,44.4%,22m
1258,2,iPod,3754,0,1,0,1,100.0%,5m
1258,2,Humpen,3754,0,1,2,3,33.3%,2m
1261,2,[PŖïMĄŁ]DarkGhost,3753,1443,66,58,124,53.2%,10m
1261,2,[xNGSx]Rykuu,3753,174,7,5,12,58.3%,14m
1261,2,mOOdY,3753,58,2,2,4,50.0%,19m
1264,1,[MWOT]Mimicry,3752,1859,84,89,173,48.6%,9m
1264,2,VladyslavUa,3752,790,82,73,155,52.9%,22m
1264,2,Kappa,3752,174,7,2,9,77.8%,9m
1264,2,[Bread]Blondie,3752,0,2,3,5,40.0%,14m
1268,2,[T4E]TFEnos,3751,978,103,99,202,51.0%,9m
1268,2,[qwerh]PrinceAdam,3751,1120,80,79,159,50.3%,26m
1268,2,[SRC]MooDuck,3751,30,2,0,2,100.0%,18m
1271,2,[NeGsyS]Ygdragzil,3750,1585,111,79,190,58.4%,5m
1271,2,Ekuspuroshon,3750,847,35,23,58,60.3%,10m
1271,2,Mobius,3750,0,4,1,5,80.0%,25m
1271,2,[RbF]Neon,3750,30,3,3,6,50.0%,11m
1271,2,scoutyx,3750,62,2,4,6,33.3%,15m
1276,2,IIIIIIIIIIII,3749,1407,84,65,149,56.4%,4m
1276,2,Lufia,3749,0,1,0,1,100.0%,6m
1278,1,[WBO]Parabelitano,3748,97,4,2,6,66.7%,5m
1279,2,demon,3747,951,100,99,199,50.3%,4m
1279,2,[LAFK]gee,3747,60,2,5,7,28.6%,5m
1279,2,[Oursbl]Kuberaz,3747,30,1,2,3,33.3%,26m
1282,2,JinC,3746,1475,219,201,420,52.1%,23m
1282,2,Baysen,3746,1559,114,104,218,52.3%,26m
1284,2,Answer,3745,828,32,30,62,51.6%,4m
1284,2,Sarrkette,3745,774,28,25,53,52.8%,16m
1284,2,[Oo0]lifelight,3745,0,1,0,1,100.0%,18m
1287,2,llllllllllll,3744,621,32,11,43,74.4%,17m
1287,2,[SKYBRS]CLASSIC,3744,471,22,19,41,53.7%,26m
1289,2,[TUPL]McDoudles,3743,172,9,1,10,90.0%,6m
1289,3,Reizor,3743,121,2,1,3,66.7%,2m
1291,2,[TNZs]Aioaior,3742,284,12,16,28,42.9%,15m
1292,2,[PLA2N]Nontar,3741,1383,122,109,231,52.8%,13m
1292,2,[Kiber]MacZero,3741,813,31,36,67,46.3%,26m
1292,2,Seventh,3741,418,16,16,32,50.0%,23m
1295,2,BeHappy,3740,748,55,65,120,45.8%,15m
1295,2,[PnP]boyboyluV,3740,432,15,22,37,40.5%,26m
1297,2,[Chrys]Sharen,3739,520,21,15,36,58.3%,16m
1297,2,IAmSoNoo,3739,228,10,3,13,76.9%,6m
1297,1,[PLA2N]tommygun,3739,0,1,0,1,100.0%,4m
1300,2,[зерно]rrRamilka,3738,502,20,13,33,60.6%,16m
1301,2,MAPElites,3737,395,19,7,26,73.1%,3m
1301,2,NorthWind,3737,0,1,0,1,100.0%,11m
1301,2,blue,3737,0,1,0,1,100.0%,18m
1301,2,glhf,3737,0,1,1,2,50.0%,26m
1305,2,Kawa,3736,144,3,7,10,30.0%,23m
1305,2,Supernoob,3736,0,1,0,1,100.0%,17m
1307,2,[TgK]CubeCow,3735,628,37,14,51,72.5%,11m
1307,3,[PsiVan]SlyOstrich,3735,0,1,0,1,100.0%,9m
1309,1,[INOE]Zamarak,3734,88,7,7,14,50.0%,18m
1309,2,RXM,3734,0,1,0,1,100.0%,22m
1311,2,hØrny,3733,1378,53,52,105,50.5%,22m
1311,2,[NLLO]EvA,3733,94,4,2,6,66.7%,17m
1311,2,Szudemer,3733,0,2,3,5,40.0%,23m
1314,2,[SpCI]RAMZESPL,3732,573,25,11,36,69.4%,26m
1314,2,Mengsk,3732,269,12,6,18,66.7%,4m
1314,2,TuKi,3732,0,3,2,5,60.0%,19m
1317,2,ysanafa,3731,1227,484,477,961,50.4%,9m
1317,2,Just,3731,1597,308,307,615,50.1%,9m
1317,2,myherO,3731,1296,79,80,159,49.7%,22m
1317,2,xaverx,3731,408,16,12,28,57.1%,26m
1317,2,DVNeric,3731,30,1,3,4,25.0%,4m
1322,2,Mitrix,3730,1445,568,543,1111,51.1%,22m
1322,2,ANAZAPTA,3730,801,62,60,122,50.8%,3m
1322,2,kekboi,3730,386,15,14,29,51.7%,19m
1322,3,ROG,3730,177,4,11,15,26.7%,23m
1322,2,[4X4]Palputin,3730,30,1,2,3,33.3%,16m
1327,2,noodlewalger,3729,112,7,0,7,100.0%,23m
1327,3,[Vodo]MagiCmaN,3729,147,4,3,7,57.1%,18m
1327,2,Fartosis,3729,28,3,2,5,60.0%,4m
1327,2,Borland,3729,0,0,3,3,0.0%,22m
1331,1,[ExpdtD]Aragnath,3728,0,0,1,1,0.0%,15m
1332,2,[TFSC]CaZo,3727,429,15,12,27,55.6%,10m
1332,2,[CIB]Alpha,3727,30,3,3,6,50.0%,12m
1332,2,Livinsky,3727,30,1,3,4,25.0%,10m
1335,2,crazypants,3726,465,20,8,28,71.4%,5m
1335,2,almostiOG,3726,260,13,5,18,72.2%,23m
1335,2,PartaSTI,3726,114,5,2,7,71.4%,5m
1335,2,MeNoBrain,3726,88,4,3,7,57.1%,4m
1335,2,[3AS]Luckfish,3726,58,3,2,5,60.0%,11m
1335,2,LAKTOSFRIKEB,3726,30,1,2,3,33.3%,10m
1341,2,Halo,3725,1282,62,51,113,54.9%,16m
1341,2,[LOPATA]elZarael,3725,0,5,0,5,100.0%,25m
1341,2,Knowing,3725,0,1,0,1,100.0%,26m
1344,2,necedakrene,3724,405,19,24,43,44.2%,17m
1344,2,[adR]awS,3724,206,6,9,15,40.0%,5m
1344,2,[DNARI]opasnoste,3724,60,2,1,3,66.7%,3m
1344,2,[RSyn]Joe,3724,60,2,4,6,33.3%,11m
1348,2,[KøF]Finalys,3723,868,31,35,66,47.0%,6m
1348,2,MonstR,3723,558,23,15,38,60.5%,17m
1348,2,Guterino,3723,0,0,1,1,0.0%,26m
1351,1,Hitchhiker,3722,1696,54,61,115,47.0%,6m
1351,2,Snouf,3722,542,19,19,38,50.0%,4m
1351,1,atom,3722,143,8,1,9,88.9%,17m
1351,3,[Cannоn]Saitama,3722,0,1,0,1,100.0%,2m
1355,2,[BWArmy]TRC,3720,1626,140,98,238,58.8%,5m
1355,2,[uscore]Moe,3720,60,2,3,5,40.0%,15m
1355,2,Stimmur,3720,0,0,1,1,0.0%,5m
1355,2,SenSaTiOnELL,3720,0,0,1,1,0.0%,9m
1359,2,Smasher,3719,761,31,27,58,53.4%,26m
1359,2,Banse,3719,386,16,16,32,50.0%,17m
1361,2,Shahmatist,3718,0,0,1,1,0.0%,4m
1362,1,Apendix,3717,1218,35,53,88,39.8%,6m
1362,2,[forceX]lion,3717,148,6,6,12,50.0%,26m
1362,2,Foolishness,3717,140,5,6,11,45.5%,2m
1362,2,GLHF,3717,30,2,0,2,100.0%,7m
1362,3,[emop]Polly,3717,97,2,1,3,66.7%,10m
1362,2,[Frogy]AsdoxZ,3717,0,0,3,3,0.0%,25m
1368,2,lenor,3716,42,1,3,4,25.0%,16m
1369,2,[ranDoM]FoX,3715,1427,166,144,310,53.5%,26m
1369,2,WARTANK,3715,0,2,3,5,40.0%,13m
1369,2,Lel,3715,0,0,1,1,0.0%,26m
1369,2,Balder,3715,0,0,1,1,0.0%,23m
1373,2,Mapusan,3714,1308,65,64,129,50.4%,9m
1373,2,GalaxY,3714,1404,57,47,104,54.8%,22m
1373,2,GGWellplayed,3714,964,36,36,72,50.0%,11m
1373,2,Tundra,3714,606,25,24,49,51.0%,26m
1373,2,Sora,3714,84,4,4,8,50.0%,26m
1373,3,Dovahkiin,3714,30,1,1,2,50.0%,22m
1379,2,[сSсǃ]NaJi,3713,593,25,11,36,69.4%,9m
1379,2,OniKratos,3713,224,8,7,15,53.3%,26m
1379,2,CalmMKD,3713,0,1,1,2,50.0%,15m
1379,2,General,3713,0,0,4,4,0.0%,6m
1383,2,[RSK]GantDeToilet,3712,192,8,2,10,80.0%,19m
1383,2,Yazuac,3712,30,1,4,5,20.0%,16m
1383,2,[INOE]IIIIIIIIIIII,3712,0,1,4,5,20.0%,24m
1386,2,[EZPTS]ВованТерран,3711,293,36,18,54,66.7%,15m
1386,2,Shadowformer,3711,60,3,3,6,50.0%,16m
1388,2,strem,3710,315,17,5,22,77.3%,26m
1388,2,[WITCHs]Monky,3710,426,17,10,27,63.0%,17m
1388,2,IIIIIIIIIIII,3710,114,5,1,6,83.3%,22m
1388,2,mobo,3710,0,3,2,5,60.0%,7m
1392,2,[BRSKR]PRIME,3709,1594,82,67,149,55.0%,26m
1392,2,grimalk,3709,1214,71,40,111,64.0%,5m
1392,2,IMBateValcho,3709,124,5,8,13,38.5%,14m
1392,2,temperance,3709,0,1,0,1,100.0%,7m
1396,2,[Brgman]TritZiu,3708,908,35,36,71,49.3%,15m
1397,2,MaxPower,3707,0,3,2,5,60.0%,27m
1397,2,dajmi,3707,58,2,5,7,28.6%,12m
1397,2,Wilzyx,3707,66,2,10,12,16.7%,5m
1397,2,kipfilet,3707,0,0,2,2,0.0%,22m
1401,2,Hodor,3706,1481,73,61,134,54.5%,14m
1401,2,[Zsquad]Ostik,3706,116,4,3,7,57.1%,25m
1401,2,Stdioh,3706,30,4,4,8,50.0%,19m
1401,2,[DWTeam]Wolfstalker,3706,0,1,0,1,100.0%,4m
1405,2,[QTcIub]IbRA,3704,758,31,29,60,51.7%,25m
1405,2,unbi,3704,366,14,11,25,56.0%,4m
1405,2,[OAC]Grizzly,3704,288,10,10,20,50.0%,25m
1405,1,Jeff,3704,0,0,1,1,0.0%,2m
1409,2,[NetGG]Lelouche,3703,1624,143,130,273,52.4%,13m
1409,2,Rotsor,3703,348,13,12,25,52.0%,26m
1411,2,reaper,3702,114,4,1,5,80.0%,25m
1411,2,WinterSC,3702,0,1,4,5,20.0%,26m
1411,2,ReStartZerg,3702,0,0,4,4,0.0%,23m
1414,2,Scatrex,3701,1540,214,219,433,49.4%,10m
1414,2,reklemhuk,3701,1320,71,58,129,55.0%,4m
1414,2,Curryking,3701,0,1,2,3,33.3%,25m
1414,2,Drego,3701,0,0,1,1,0.0%,26m
1418,3,[BX3]fubb,3700,301,14,9,23,60.9%,10m
1418,2,ITsux,3700,118,4,10,14,28.6%,4m
1418,2,Rainbow,3700,0,2,3,5,40.0%,25m
1418,2,[GGTGV]Duroniel,3700,0,0,2,2,0.0%,23m
1422,1,EmilioZapata,3699,0,2,8,10,20.0%,10m
1423,2,[DaFF]gotmilk,3697,346,14,7,21,66.7%,2m
1423,3,OldYoghurt,3697,220,11,4,15,73.3%,4m
1423,3,TheorY,3697,168,7,4,11,63.6%,8m
1423,2,[НТТ]Fargus,3697,0,2,3,5,40.0%,26m
1423,2,IIIIIIIIIIII,3697,0,1,0,1,100.0%,18m
1428,2,[TaTe]SpryToss,3696,0,0,1,1,0.0%,4m
1429,2,CityZen,3695,303,14,18,32,43.8%,16m
1429,2,[Frass]TigeRFurY,3695,0,1,0,1,100.0%,5m
1429,1,Midnight,3695,0,1,2,3,33.3%,4m
1429,2,FADIMUH,3695,0,0,3,3,0.0%,18m
1433,2,[MGWTF]simout,3694,695,43,46,89,48.3%,4m
1433,2,swarmCore,3694,226,10,3,13,76.9%,27m
1435,2,seed,3693,506,19,13,32,59.4%,16m
1435,2,[0BO]threepio,3693,381,13,16,29,44.8%,6m
1435,2,Gimli,3693,0,0,7,7,0.0%,11m
1438,2,Jetix,3691,0,1,4,5,20.0%,17m
1439,2,NoRespect,3690,522,27,11,38,71.1%,17m
1439,2,Levi,3690,92,3,5,8,37.5%,15m
1439,2,[KRAKOT]Wiztek,3690,0,1,0,1,100.0%,26m
1439,2,SnipeFive,3690,0,1,0,1,100.0%,5m
1439,3,[RISKE]ALLin,3690,0,0,1,1,0.0%,16m
1444,2,[Kelev]Penelope,3689,469,74,74,148,50.0%,7m
1444,2,Bartholomaus,3689,1108,43,48,91,47.3%,26m
1444,2,[ǂǂǂǂǂ]Ustavson,3689,536,27,8,35,77.1%,25m
1444,2,[bod]Projectile,3689,86,6,4,10,60.0%,22m
1444,2,Dragonfire,3689,0,1,0,1,100.0%,10m
1444,1,ZergiuS,3689,0,0,2,2,0.0%,27m
1450,2,Hellcat,3688,424,17,9,26,65.4%,14m
1450,2,Shegin,3688,338,13,14,27,48.1%,2m
1450,1,MoonLightETA,3688,0,1,1,2,50.0%,8m
1450,2,[PLA2N]Quark,3688,0,0,1,1,0.0%,7m
1450,2,[oniz]Timws,3688,0,0,3,3,0.0%,25m
1455,2,HOZIPS,3687,1593,130,139,269,48.3%,3m
1455,2,[WCGtop]SenFx,3687,0,1,0,1,100.0%,19m
1455,3,NinjaTurtle,3687,30,1,3,4,25.0%,10m
1458,2,AuntIrma,3686,169,7,11,18,38.9%,6m
1458,2,ThirtyThree,3686,112,3,0,3,100.0%,14m
1458,2,syn,3686,62,2,6,8,25.0%,10m
1458,2,[24I7]MrKeks,3686,62,2,7,9,22.2%,23m
1458,2,Glide,3686,0,0,1,1,0.0%,7m
1463,2,meti,3685,211,16,15,31,51.6%,3m
1463,3,[JW]Jaesonian,3685,311,11,11,22,50.0%,10m
1463,1,dribbel,3685,192,3,7,10,30.0%,14m
1463,2,[GWuH]GosuGoich,3685,0,1,0,1,100.0%,13m
1463,2,[SwgBoi]DeadGame,3685,0,1,2,3,33.3%,12m
1463,3,AngelVonyos,3685,0,0,1,1,0.0%,4m
1469,2,[OРДА]NerZull,3684,30,1,1,2,50.0%,13m
1469,3,Rennick,3684,0,0,1,1,0.0%,2m
1471,2,Snurskalle,3683,60,6,4,10,60.0%,12m
1471,2,BNDS,3683,30,1,1,2,50.0%,26m
1473,2,[lMMl]ShadowRoCk,3682,296,37,25,62,59.7%,26m
1474,2,Thraundil,3681,0,1,4,5,20.0%,25m
1474,2,[VetM]KimboSlice,3681,0,1,6,7,14.3%,7m
1474,2,[Gimbus]Feedmother,3681,0,0,1,1,0.0%,26m
1477,2,[VHSEK]MackTheKnife,3680,416,14,28,42,33.3%,18m
1477,2,[FrNiCl]Retsof,3680,206,7,8,15,46.7%,26m
1477,2,AngryBird,3680,0,0,5,5,0.0%,11m
1480,3,Garvock,3679,30,2,0,2,100.0%,18m
1480,3,[Kompis]Soren,3679,0,1,0,1,100.0%,17m
1480,2,[Krasty]NAkiddo,3679,0,1,0,1,100.0%,3m
1483,2,xShogo,3678,239,12,5,17,70.6%,5m
1483,2,Equalizer,3678,170,6,6,12,50.0%,4m
1483,2,[TaKeUL]Satalko,3678,30,2,1,3,66.7%,10m
1483,2,dasRabid,3678,32,1,6,7,14.3%,7m
1487,2,PPO,3676,816,49,47,96,51.0%,2m
1487,2,[JUSTG]RANDOM,3676,594,20,28,48,41.7%,22m
1487,2,[WTFSC2]Vanni,3676,205,9,7,16,56.2%,22m
1490,2,[hufter]Luxus,3674,114,5,4,9,55.6%,26m
1490,2,[PSlSTC]Minimoog,3674,0,2,3,5,40.0%,7m
1490,2,Shrader,3674,0,2,3,5,40.0%,26m
1490,2,[ECOMP]maula,3674,30,1,2,3,33.3%,26m
1490,2,CaptaiN,3674,0,0,3,3,0.0%,22m
1495,2,kentin,3673,828,41,24,65,63.1%,26m
1495,1,KOERAN,3673,189,9,2,11,81.8%,17m
1495,2,[Ugg]JCreepers,3673,30,2,0,2,100.0%,22m
1495,2,[fam1ly]ZAKOLEBALO,3673,0,1,1,2,50.0%,5m
1499,2,[SCBoys]Tegla,3672,512,19,17,36,52.8%,22m
1500,2,[NMF]jeff,3671,176,7,7,14,50.0%,7m
1500,2,[Wolven]Tempest,3671,0,2,5,7,28.6%,5m
1500,2,AresNyx,3671,0,0,1,1,0.0%,10m
1503,2,[Smoula]CzeEmperor,3670,0,1,1,2,50.0%,19m
1503,2,[αX]Migwel,3670,30,1,3,4,25.0%,18m
1503,2,[ØC]Miloux,3670,0,0,1,1,0.0%,25m
1503,1,[SEWP]FrostLight,3670,0,0,1,1,0.0%,3m
1507,2,CASHFORHASH,3669,200,8,5,13,61.5%,18m
1507,2,Gratraf,3669,176,7,5,12,58.3%,14m
1507,2,[JGT]NoN,3669,30,1,1,2,50.0%,4m
1507,1,[HERP]tHeReaveR,3669,0,0,1,1,0.0%,11m
1507,3,[TheDOH]Executioner,3669,0,0,2,2,0.0%,14m
1512,2,Arialkz,3668,1509,254,260,514,49.4%,25m
1512,2,Dodo,3668,714,30,24,54,55.6%,23m
1512,2,[сSсǃ]Labsick,3668,0,1,0,1,100.0%,10m
1515,2,Skytoss,3667,382,17,16,33,51.5%,7m
1515,2,krypto,3667,188,7,1,8,87.5%,17m
1515,2,Alkesh,3667,30,2,4,6,33.3%,3m
1515,2,TripleSec,3667,58,2,7,9,22.2%,27m
1519,2,[SPAINs]hzheng,3666,1462,77,61,138,55.8%,10m
1519,2,iathsdeia,3666,1556,76,66,142,53.5%,18m
1519,2,Gruba,3666,1316,71,32,103,68.9%,26m
1519,2,EctoPlasm,3666,0,1,0,1,100.0%,10m
1519,2,Love,3666,0,1,0,1,100.0%,19m
1519,2,poichiche,3666,0,0,1,1,0.0%,11m
1525,2,[kewl]gnarK,3665,1553,363,357,720,50.4%,7m
1525,2,Alow,3665,676,32,32,64,50.0%,16m
1525,2,Paco,3665,234,12,15,27,44.4%,19m
1525,3,Mrvjack,3665,169,5,1,6,83.3%,10m
1529,3,[RuVoid]ilurius,3664,164,5,1,6,83.3%,8m
1529,2,Twentyfive,3664,102,4,2,6,66.7%,22m
1529,2,Ström,3664,170,4,4,8,50.0%,7m
1529,2,Lax,3664,0,0,1,1,0.0%,26m
1533,2,PatchRace,3663,1291,221,218,439,50.3%,4m
1533,2,Gexigags,3663,930,34,36,70,48.6%,10m
1533,2,Textonic,3663,288,6,17,23,26.1%,8m
1536,2,[CanPC]ZenZ,3662,200,7,1,8,87.5%,15m
1536,2,IIIIIIIIIIII,3662,88,3,3,6,50.0%,10m
1536,2,Bonbeurre,3662,0,2,3,5,40.0%,10m
1536,2,KalergiPlan,3662,0,2,3,5,40.0%,25m
1536,3,Ahoy,3662,0,0,1,1,0.0%,2m
1541,2,barney,3661,671,53,39,92,57.6%,18m
1541,2,[bugPP]SMURFIN,3661,88,3,3,6,50.0%,8m
1541,2,[BR0DER]Atravir,3661,0,0,1,1,0.0%,27m
1541,2,[Longdu]Zboub,3661,0,0,3,3,0.0%,7m
1545,2,neltharion,3660,644,25,23,48,52.1%,7m
1545,2,mysteryH,3660,0,3,2,5,60.0%,5m
1545,2,TeddyBear,3660,62,2,4,6,33.3%,22m
1545,2,[FUCBOY]Stracatela,3660,30,2,7,9,22.2%,17m
1545,3,[PLA2N]MihaEGO,3660,0,1,0,1,100.0%,16m
1545,2,[WNTR]Hydrogenium,3660,0,0,1,1,0.0%,18m
1551,2,[сSсǃ]XumKO,3659,1376,55,57,112,49.1%,27m
1551,1,MJHolland,3659,163,8,1,9,88.9%,5m
1551,2,LaCruz,3659,203,6,7,13,46.2%,11m
1551,2,[FrostG]iant,3659,0,2,3,5,40.0%,2m
1555,2,Psylon,3658,654,22,28,50,44.0%,22m
1555,2,Dionys,3658,583,20,32,52,38.5%,15m
1555,2,Wandfliese,3658,0,1,4,5,20.0%,6m
1558,2,IIIIIIIIIIII,3657,277,9,2,11,81.8%,14m
1558,2,[R3IGN]SkyBoiii,3657,60,2,6,8,25.0%,14m
1560,2,ChicCo,3656,414,23,13,36,63.9%,12m
1560,2,tyy,3656,236,8,3,11,72.7%,27m
1560,2,[ZERG7V]ЛягушкаЛяга,3656,0,2,3,5,40.0%,23m
1560,2,[KAOTx]Wizard,3656,0,1,0,1,100.0%,14m
1560,2,[ffddfd]IIIIIIIIIIII,3656,0,0,1,1,0.0%,26m
1565,2,[SZ]Fairespiter,3655,0,0,1,1,0.0%,25m
1566,1,Etharis,3654,0,1,0,1,100.0%,5m
1566,2,AshlynRae,3654,0,1,0,1,100.0%,17m
1566,2,[TRQǂ]jlobart,3654,0,0,1,1,0.0%,19m
1569,2,NotSoGood,3653,1206,88,72,160,55.0%,3m
1569,2,[RSPCT]Foooxxx,3653,60,3,3,6,50.0%,23m
1569,2,tret,3653,0,1,1,2,50.0%,26m
1569,2,KpTainZurg,3653,0,0,1,1,0.0%,18m
1573,2,partizan,3652,398,17,12,29,58.6%,7m
1573,2,Markvart,3652,120,4,7,11,36.4%,23m
1573,2,[BBOY]Kvarc,3652,30,2,3,5,40.0%,11m
1573,3,saabniohundr,3652,0,0,7,7,0.0%,2m
1577,1,twarenik,3651,1742,308,320,628,49.0%,9m
1577,2,[xFUD]Araken,3651,382,12,14,26,46.2%,10m
1577,3,[malone]bugzY,3651,0,0,1,1,0.0%,2m
1580,2,[FYBF]eulerO,3650,342,12,15,27,44.4%,19m
1580,2,Fusebot,3650,222,8,10,18,44.4%,25m
1580,2,[SCiE]Ghost,3650,198,7,2,9,77.8%,18m
1580,2,[QTclub]BreffXX,3650,0,0,1,1,0.0%,26m
1584,2,[BL00DY]ТерранСталин,3649,1531,96,101,197,48.7%,7m
1584,2,[PIGI]ElGratador,3649,1189,70,71,141,49.6%,26m
1584,2,Dijkkie,3649,1525,70,73,143,49.0%,26m
1584,2,JustusBumm,3649,508,34,32,66,51.5%,15m
1584,3,Turtle,3649,377,17,6,23,73.9%,2m
1584,2,dottt,3649,157,7,9,16,43.8%,15m
1584,2,[Skunks]Stinktier,3649,58,2,2,4,50.0%,4m
1591,2,SmokeDope,3648,474,17,19,36,47.2%,16m
1591,2,[iGD2D]ReachLT,3648,350,12,11,23,52.2%,22m
1591,2,Alexander,3648,104,4,8,12,33.3%,23m
1591,2,IIIIIIIIIIII,3648,60,2,4,6,33.3%,4m
1595,2,Rookie,3647,512,33,14,47,70.2%,11m
1595,2,Chronos,3647,194,7,2,9,77.8%,4m
1595,2,Aymeric,3647,114,6,1,7,85.7%,7m
1595,1,aaron,3647,40,5,7,12,41.7%,8m
1595,2,[PLA2N]Reycer,3647,95,4,1,5,80.0%,6m
1595,2,[OtES]cronos,3647,86,3,4,7,42.9%,10m
1595,2,ßaha,3647,0,0,1,1,0.0%,8m
1602,3,[EZPTS]rizo,3646,171,4,2,6,66.7%,14m
1602,2,mrluiaard,3646,0,0,1,1,0.0%,17m
1604,2,Atonement,3645,904,35,31,66,53.0%,12m
1604,3,Mauridius,3645,288,13,5,18,72.2%,7m
1604,2,Willileliram,3645,30,2,0,2,100.0%,19m
1604,3,EdvanSchleck,3645,0,1,0,1,100.0%,11m
1604,2,[IÐŠI]rigger,3645,0,1,0,1,100.0%,25m
1604,2,DogMonthly,3645,0,1,4,5,20.0%,26m
1610,2,Freesky,3644,1550,327,315,642,50.9%,26m
1610,2,[F42]Nuklearwurst,3644,716,27,30,57,47.4%,15m
1610,2,[UATeam]SHOCK,3644,423,20,10,30,66.7%,7m
1610,2,Aaytowi,3644,0,1,3,4,25.0%,10m
1610,2,PenOnAir,3644,0,0,1,1,0.0%,19m
1615,2,ELLe,3643,476,120,125,245,49.0%,14m
1615,2,KernelPanic,3643,58,2,3,5,40.0%,18m
1615,2,Nicolas,3643,0,1,0,1,100.0%,10m
1615,2,[HBGSJR]llllllllllll,3643,0,1,5,6,16.7%,12m
1619,2,[hängA]hehejow,3642,731,31,22,53,58.5%,12m
1619,2,LaoTzu,3642,318,12,13,25,48.0%,19m
1619,2,Dragon,3642,215,8,2,10,80.0%,13m
1619,2,Slappe,3642,220,8,7,15,53.3%,4m
1619,2,[DvX]RuggiFuma,3642,0,4,1,5,80.0%,26m
1619,2,KillingSpree,3642,120,4,7,11,36.4%,25m
1619,1,CHAAAARGE,3642,48,2,1,3,66.7%,7m
1619,2,NFloN,3642,0,1,0,1,100.0%,25m
1619,2,[NagirU]Urigan,3642,0,0,1,1,0.0%,5m
1628,2,Emyox,3641,700,66,61,127,52.0%,11m
1628,2,[GdAT]Blutmilan,3641,368,16,7,23,69.6%,7m
1628,3,[74Rus]петушара,3641,175,9,2,11,81.8%,8m
1628,2,[Heroes]CharactR,3641,150,4,4,8,50.0%,14m
1628,2,[SSheep]SuicideSheep,3641,102,2,5,7,28.6%,24m
1628,2,Looper,3641,0,1,0,1,100.0%,26m
1628,2,[ƮesXG2]Mulemech,3641,0,0,1,1,0.0%,12m
1628,2,Sorryx,3641,0,0,1,1,0.0%,8m
1636,1,TristanI,3640,1175,142,157,299,47.5%,2m
1636,2,DrPepper,3640,1140,44,46,90,48.9%,3m
1636,1,Giratina,3640,119,7,1,8,87.5%,12m
1636,2,zeratul,3640,114,5,2,7,71.4%,14m
1636,3,[AchrK9]GenWilkins,3640,151,5,9,14,35.7%,14m
1636,2,Rick,3640,0,0,1,1,0.0%,11m
1636,3,notgood,3640,0,0,2,2,0.0%,26m
1643,2,tiga,3639,30,4,11,15,26.7%,6m
1643,2,[PaniC]Xлебушек,3639,0,1,1,2,50.0%,12m
1645,2,[DHCP]AntiDog,3638,226,8,9,17,47.1%,15m
1645,2,[FR1]Nicomouk,3638,0,4,3,7,57.1%,3m
1645,2,[ChaGa]KotNasher,3638,46,2,0,2,100.0%,8m
1645,3,BuBble,3638,30,1,3,4,25.0%,4m
1645,2,[DMI]BlinkFloyd,3638,0,1,4,5,20.0%,10m
1650,2,EnDLessSkiLL,3637,1571,127,121,248,51.2%,23m
1650,2,Milamber,3637,562,21,17,38,55.3%,5m
1650,2,[BadTvT]viag,3637,522,20,24,44,45.5%,23m
1653,2,luuudeee,3636,1110,111,105,216,51.4%,15m
1653,2,Kamala,3636,265,11,4,15,73.3%,17m
1653,3,[MoopyS]Eternity,3636,121,3,1,4,75.0%,6m
1653,2,SirGhost,3636,0,1,0,1,100.0%,12m
1657,2,PandaBear,3635,96,4,2,6,66.7%,18m
1658,2,[2MS]Nyalab,3633,762,37,20,57,64.9%,10m
1658,2,[4X4]eZNighTmarE,3633,30,1,2,3,33.3%,26m
1660,2,Reign,3632,338,25,28,53,47.2%,23m
1660,2,[Arrows]chiter,3632,366,14,16,30,46.7%,12m
1660,2,[Салоед]OMOHinc,3632,256,9,9,18,50.0%,19m
1660,2,[1A2857]Tio,3632,90,4,7,11,36.4%,25m
1660,2,[SetY]Spock,3632,0,0,1,1,0.0%,16m
1665,2,HarryManback,3631,547,36,8,44,81.8%,25m
1665,2,WilgeforZ,3631,294,12,14,26,46.2%,10m
1665,2,Trololo,3631,120,6,8,14,42.9%,27m
1665,2,[Cannоn]RoadToDako,3631,30,1,4,5,20.0%,15m
1665,2,[Kpa6]Alarak,3631,0,0,1,1,0.0%,26m
1670,2,[RstE]JahNesta,3630,318,11,9,20,55.0%,16m
1670,1,AzoG,3630,166,4,2,6,66.7%,14m
1670,2,Cassedi,3630,0,3,3,6,50.0%,17m
1673,2,Admin,3629,152,6,10,16,37.5%,25m
1674,2,Whïte,3628,60,2,7,9,22.2%,11m
1674,2,Beuhbel,3628,0,1,0,1,100.0%,10m
1674,2,Tchoupinax,3628,0,1,6,7,14.3%,26m
1674,2,Zumwalazi,3628,0,0,1,1,0.0%,19m
1678,2,KingChris,3627,892,37,35,72,51.4%,27m
1678,2,[QTclub]Leifur,3627,602,29,21,50,58.0%,18m
1678,2,dudebro,3627,90,4,5,9,44.4%,18m
1678,2,neeroo,3627,30,3,5,8,37.5%,24m
1678,2,[DutchG]imfaded,3627,30,2,15,17,11.8%,16m
1678,1,[EESC]Kakashi,3627,0,1,7,8,12.5%,24m
1684,2,Fifteen,3626,238,13,8,21,61.9%,24m
1684,2,[ATSEV]blux,3626,278,9,7,16,56.2%,5m
1684,2,[UPS]kinglizard,3626,30,2,0,2,100.0%,16m
1684,2,General,3626,0,1,0,1,100.0%,22m
1688,2,Leopard,3625,414,37,44,81,45.7%,18m
1688,2,Poodle,3625,210,8,6,14,57.1%,25m
1688,3,[DoPorn]Sayux,3625,123,3,4,7,42.9%,8m
1688,2,uberluberl,3625,0,1,1,2,50.0%,27m
1688,2,alanmortier,3625,0,1,8,9,11.1%,22m
1688,2,[crabz]WhiteNights,3625,0,0,1,1,0.0%,26m
1694,2,ruslanbest,3624,1615,267,262,529,50.5%,19m
1694,2,covd,3624,627,86,77,163,52.8%,7m
1694,2,Gamer,3624,923,40,29,69,58.0%,19m
1694,2,[lOoOl]foREVer,3624,0,2,3,5,40.0%,3m
1694,2,[FxL]Atty,3624,0,1,0,1,100.0%,26m
1694,2,[DFgs]Turbulence,3624,0,1,3,4,25.0%,13m
1700,2,eeevnsun,3623,453,24,25,49,49.0%,26m
1700,2,SkIoASarkan,3623,0,1,0,1,100.0%,18m
1700,2,FateZero,3623,30,1,3,4,25.0%,19m
1700,2,[fastgg]Xulatis,3623,97,1,4,5,20.0%,27m
1704,2,BsCMBANerd,3622,950,127,139,266,47.7%,7m
1704,2,smu,3622,212,7,18,25,28.0%,10m
1704,2,[ZЕRGТV]ArturZerg,3622,88,4,2,6,66.7%,14m
1704,2,[TRYY]Nightmare,3622,60,2,3,5,40.0%,26m
1704,2,rumost,3622,0,0,1,1,0.0%,26m
1709,3,[OXF]Richielol,3620,171,5,4,9,55.6%,13m
1709,2,[0BO]StarFox,3620,143,3,2,5,60.0%,16m
1709,2,[Quite]Kabuto,3620,0,3,4,7,42.9%,11m
1709,2,Houdini,3620,90,3,6,9,33.3%,19m
1709,2,[SLD]mogoh,3620,0,0,1,1,0.0%,26m
1714,1,ivhen,3619,1423,500,505,1005,49.8%,22m
1714,2,Reamonn,3619,381,19,8,27,70.4%,10m
1714,2,flep,3619,291,10,7,17,58.8%,7m
1717,2,sdy,3618,1482,99,76,175,56.6%,10m
1717,2,Kojkoloo,3618,174,9,4,13,69.2%,26m
1717,2,BroNumberOne,3618,88,4,2,6,66.7%,26m
1717,2,Bane,3618,88,2,0,2,100.0%,17m
1721,2,[UAŦeam]Niklaus,3617,116,5,2,7,71.4%,2m
1721,2,[easter]GoldenbunnY,3617,64,3,3,6,50.0%,25m
1721,2,Alarak,3617,58,2,2,4,50.0%,23m
1721,2,TriangleTom,3617,58,2,5,7,28.6%,16m
1721,2,DrNoob,3617,0,0,1,1,0.0%,4m
1721,2,Jason,3617,0,0,3,3,0.0%,14m
1727,2,Terratosozer,3616,140,9,1,10,90.0%,10m
1727,2,[Pr0xу]MozG,3616,58,2,3,5,40.0%,10m
1727,2,[GLD]FrapKunKù,3616,0,1,0,1,100.0%,11m
1730,1,HihfglggGO,3615,1724,254,266,520,48.8%,14m
1730,2,oIITiMicT,3615,498,23,11,34,67.6%,19m
1730,2,[RBlood]hotTemplar,3615,229,9,3,12,75.0%,22m
1730,2,MoonLine,3615,92,2,2,4,50.0%,26m
1734,2,Savoir,3614,102,6,2,8,75.0%,12m
1734,2,[Ǽ1]Superhero,3614,190,6,3,9,66.7%,6m
1734,3,WarrioR,3614,0,1,0,1,100.0%,25m
1737,2,IIIIIIIIIIII,3613,341,14,14,28,50.0%,22m
1737,2,Jinsei,3613,0,0,2,2,0.0%,19m
1739,2,[AoT]gray,3612,567,43,25,68,63.2%,2m
1740,2,Jurez,3611,576,31,25,56,55.4%,14m
1740,2,Timeout,3611,0,1,0,1,100.0%,10m
1740,2,[MTBB]Norbert,3611,0,1,0,1,100.0%,13m
1740,2,Louisss,3611,30,1,3,4,25.0%,5m
1740,2,[MYG]Marvel,3611,0,0,1,1,0.0%,8m
1740,1,IIIIIIIIIIII,3611,0,0,1,1,0.0%,22m
1746,2,GoSuAti,3610,519,24,14,38,63.2%,25m
1746,2,[No0Bzz]Azerothian,3610,0,0,1,1,0.0%,14m
1746,2,[HBGSJR]Darkwolf,3610,0,0,1,1,0.0%,26m
1746,2,nklzwei,3610,0,0,2,2,0.0%,27m
1750,2,[TLpsE]IloveYeony,3609,1537,100,93,193,51.8%,10m
1750,2,TitLe,3609,604,25,17,42,59.5%,12m
1750,2,[HamT]Tantale,3609,278,9,16,25,36.0%,25m
1750,2,Micton,3609,30,2,2,4,50.0%,24m
1750,2,[afk247]Marineplay,3609,0,1,0,1,100.0%,8m
1750,2,MysteryL,3609,0,1,0,1,100.0%,16m
1750,2,miEye,3609,97,1,3,4,25.0%,24m
1757,2,CouiLLoN,3608,1462,98,89,187,52.4%,14m
1757,2,[InFy]XRater,3608,740,28,28,56,50.0%,24m
1757,2,[EAU]OgAgAl,3608,312,11,16,27,40.7%,11m
1757,2,Apex,3608,62,3,6,9,33.3%,16m
1757,2,[MoBro]Florp,3608,30,1,1,2,50.0%,5m
1757,2,[RеG]Rostok,3608,0,1,1,2,50.0%,6m
1757,2,[GGMS]BlackAdder,3608,0,0,2,2,0.0%,3m
1764,2,[ezpz]Erdbeerblau,3607,1319,60,49,109,55.0%,26m
1764,2,PunchingTree,3607,455,24,17,41,58.5%,10m
1764,2,[RеG]Стас,3607,304,14,5,19,73.7%,18m
1764,2,Полосатый,3607,0,0,1,1,0.0%,17m
1768,1,BILLYLO,3606,1262,57,68,125,45.6%,11m
1768,1,Pessle,3606,205,11,2,13,84.6%,24m
1768,2,Bufftin,3606,0,3,2,5,60.0%,4m
1768,2,NYdiesel,3606,0,0,5,5,0.0%,11m
1772,2,Change,3605,985,52,29,81,64.2%,10m
1772,2,borsh,3605,984,39,40,79,49.4%,7m
1772,2,[0Head]SmurfGranate,3605,668,26,21,47,55.3%,10m
1772,2,yaki,3605,30,2,3,5,40.0%,14m
1772,2,Kimbo,3605,0,1,0,1,100.0%,19m
1777,2,angepissst,3604,1495,296,293,589,50.3%,26m
1777,2,ComebackKid,3604,274,13,4,17,76.5%,5m
1777,2,[яєѕ]Lurkas,3604,182,7,8,15,46.7%,2m
1777,3,Sacatar,3604,122,2,5,7,28.6%,22m
1781,2,leanes,3603,1500,88,83,171,51.5%,16m
1781,2,[TGB]Kuschelbunny,3603,0,2,3,5,40.0%,14m
1781,2,[ЯD]Prospect,3603,60,2,4,6,33.3%,10m
1781,2,Cidre,3603,27,1,4,5,20.0%,26m
1785,1,llllllllllll,3602,162,9,2,11,81.8%,17m
1785,2,[Psyc]Naz,3602,88,2,0,2,100.0%,3m
1785,2,[1202]LucaRamon,3602,0,2,3,5,40.0%,26m
1785,2,[CocoCo]BlackHawk,3602,0,1,2,3,33.3%,24m
1789,2,OhmInpw,3601,1298,142,130,272,52.2%,16m
1789,2,Parsifal,3601,1111,107,93,200,53.5%,14m
1789,2,boppers,3601,1032,103,105,208,49.5%,4m
1789,2,LennartNL,3601,239,10,4,14,71.4%,24m
1789,2,[MiA]Evuser,3601,160,9,4,13,69.2%,8m
1789,2,[Gloves]AlexIG,3601,0,0,1,1,0.0%,22m
1795,2,[НОД17]SuMmeR,3600,120,6,10,16,37.5%,16m
1795,2,[T3]rustyisback,3600,140,4,2,6,66.7%,26m
1795,2,MicroMarine,3600,0,0,1,1,0.0%,25m
1798,2,Twentythree,3599,386,22,8,30,73.3%,19m
1798,2,[Steamy]TinJuice,3599,161,13,5,18,72.2%,7m
1798,2,[ZoDiep]Raijingeki,3599,304,10,17,27,37.0%,15m
1798,2,[IndyK]McClane,3599,88,1,1,2,50.0%,6m
1802,2,Hass,3598,230,12,6,18,66.7%,17m
1802,2,Sprite,3598,0,0,1,1,0.0%,22m
1804,2,NIKI,3597,1222,169,167,336,50.3%,7m
1804,2,KRGMToss,3597,58,2,3,5,40.0%,26m
1804,2,Kasperl,3597,0,1,0,1,100.0%,25m
1804,2,ElunMosk,3597,88,1,1,2,50.0%,18m
1808,2,SirWhite,3596,422,20,11,31,64.5%,27m
1808,2,[IÐŠI]salt,3596,0,0,1,1,0.0%,18m
1810,2,[Lambro]BigBrother,3595,1273,143,160,303,47.2%,15m
1810,2,[AciNoN]TwilightZeRR,3595,811,39,34,73,53.4%,6m
1810,2,ManofOneway,3595,220,8,4,12,66.7%,11m
1810,2,[ExTr1m]Pioneer,3595,160,6,11,17,35.3%,17m
1810,2,[KRice]nWaDemo,3595,94,3,4,7,42.9%,8m
1810,2,Fuziorak,3595,0,0,1,1,0.0%,18m
1810,2,Destroyer,3595,0,0,2,2,0.0%,27m
1817,2,Artos,3594,812,31,33,64,48.4%,14m
1817,2,Tobi,3594,249,9,6,15,60.0%,22m
1817,1,SuperBaker,3594,164,8,2,10,80.0%,6m
1817,2,CoSysopK,3594,167,7,2,9,77.8%,17m
1817,2,JunkiedStar,3594,0,0,1,1,0.0%,11m
1822,2,Mad,3593,387,16,11,27,59.3%,27m
1822,2,[Hаsu]Quasar,3593,233,13,1,14,92.9%,22m
1822,2,[NoBugs]NerfZerg,3593,57,5,7,12,41.7%,4m
1822,2,[mfixed]drzungla,3593,0,1,0,1,100.0%,7m
1822,2,Stollet,3593,0,0,1,1,0.0%,16m
1827,3,Overmind,3592,280,13,5,18,72.2%,6m
1827,2,[НОД17]chef,3592,0,1,0,1,100.0%,27m
1827,2,[KDV]lobendz,3592,30,1,7,8,12.5%,14m
1827,2,[4H]Monolith,3592,0,0,1,1,0.0%,23m
1831,2,mainman,3591,528,30,16,46,65.2%,6m
1831,2,Iluvatar,3591,529,22,15,37,59.5%,17m
1831,2,Jebediah,3591,520,18,23,41,43.9%,19m
1831,2,[Fussel]Fiboniker,3591,378,17,8,25,68.0%,5m
1831,2,[unƊeaƊ]jeanjean,3591,431,17,12,29,58.6%,11m
1831,2,Cesar,3591,0,5,0,5,100.0%,6m
1831,2,RageKing,3591,88,4,6,10,40.0%,10m
1831,2,Soothsayer,3591,0,2,6,8,25.0%,14m
1831,2,[YYRTTT]Yahikage,3591,0,1,0,1,100.0%,15m
1831,2,[IÐŠI]Hawken,3591,0,0,1,1,0.0%,18m
1831,2,jazzboy,3591,0,0,1,1,0.0%,14m
1842,2,Lucifer,3590,285,11,9,20,55.0%,11m
1842,2,DonDiego,3590,223,10,13,23,43.5%,7m
1842,2,[moo]Hybridius,3590,141,4,9,13,30.8%,7m
1842,2,DaneelOlivaw,3590,0,1,0,1,100.0%,10m
1842,3,[MGTSC2]Voidreaper,3590,0,0,1,1,0.0%,11m
1842,2,Vortex,3590,0,0,6,6,0.0%,24m
1848,2,[SY2G]Guts,3589,1176,44,49,93,47.3%,4m
1848,2,[KBС]bobsmirnoff,3589,518,17,25,42,40.5%,7m
1848,2,[INCV]UTLRA,3589,222,12,12,24,50.0%,5m
1848,1,[сSсǃ]SiriuS,3589,191,5,3,8,62.5%,22m
1848,2,willus,3589,0,1,0,1,100.0%,24m
1848,2,TIToss,3589,0,0,1,1,0.0%,5m
1854,2,Dvak,3588,239,12,3,15,80.0%,26m
1854,2,Ryzen,3588,0,4,1,5,80.0%,5m
1854,2,bugster,3588,102,4,3,7,57.1%,6m
1854,2,[Kontra]Neutra,3588,88,2,0,2,100.0%,4m
1854,2,[PiGPan]Chaosstreuer,3588,0,0,1,1,0.0%,25m
1854,2,DuMIIJIc,3588,0,0,1,1,0.0%,5m
1860,2,[AISC]CluEleSs,3587,1247,82,82,164,50.0%,7m
1860,2,dionisius,3587,378,30,20,50,60.0%,23m
1860,2,Fermi,3587,349,10,17,27,37.0%,4m
1860,2,Malikou,3587,118,7,10,17,41.2%,26m
1864,2,[HBGSJR]HackErIsTop,3586,1373,168,166,334,50.3%,17m
1864,2,KJBGsalina,3586,1516,118,107,225,52.4%,25m
1864,2,[M1B]AgentJ,3586,0,0,2,2,0.0%,14m
1867,2,[K0mpis]Arastein,3585,30,4,4,8,50.0%,17m
1867,3,TommesOB,3585,0,0,1,1,0.0%,18m
1869,2,[uGetKO]Kais,3584,1221,82,82,164,50.0%,7m
1869,2,Rain,3584,200,7,5,12,58.3%,24m
1869,3,[МУЛ]IceKing,3584,0,2,3,5,40.0%,18m
1869,3,[spbila]Adama,3584,0,0,1,1,0.0%,13m
1869,3,[BBSC2]extremboy,3584,0,0,1,1,0.0%,23m
1874,2,[SxS]Radio,3583,1440,127,115,242,52.5%,14m
1874,2,[ZERGML]HolySatan,3583,465,18,15,33,54.5%,15m
1874,3,BEbnataGDeep,3583,0,0,1,1,0.0%,10m
1874,3,[FMG]WhiteEagle,3583,0,0,1,1,0.0%,2m
1878,2,[AUTAJ]crapo,3582,1583,171,117,288,59.4%,26m
1878,2,[αX]Danotory,3582,170,7,9,16,43.8%,10m
1880,2,[KörSa]Neiko,3581,398,26,25,51,51.0%,25m
1880,2,[FalPal]Marbuel,3581,438,14,25,39,35.9%,14m
1880,3,chuckyeager,3581,166,9,1,10,90.0%,10m
1880,3,[PHØMUI]Winchester,3581,30,1,2,3,33.3%,16m
1884,2,Hawk,3580,60,2,4,6,33.3%,7m
1885,2,Overmars,3579,355,24,12,36,66.7%,7m
1885,3,OmaDesala,3579,444,17,17,34,50.0%,3m
1885,2,[Yame]GEEK,3579,60,2,7,9,22.2%,19m
1885,3,[HaWu]Gene,3579,30,1,1,2,50.0%,25m
1885,2,[hueheh]Zirplai,3579,30,1,5,6,16.7%,25m
1885,3,[RTrain]Maix,3579,0,0,1,1,0.0%,13m
1891,2,[ZERGML]БейнлинЛингс,3578,1538,160,158,318,50.3%,25m
1891,2,[DZTK]hoppla,3578,608,24,20,44,54.5%,7m
1891,2,[AdHx]Hotzenplotz,3578,156,4,4,8,50.0%,15m
1891,3,[SunGmr]BadDayRDK,3578,0,1,2,3,33.3%,4m
1895,2,Alpha,3577,545,86,75,161,53.4%,11m
1895,2,IQlab,3577,577,25,33,58,43.1%,3m
1895,3,renren,3577,284,11,11,22,50.0%,6m
1895,2,[BxFǂ]Draebae,3577,210,8,13,21,38.1%,10m
1895,2,[VETS]ImaG,3577,0,1,5,6,16.7%,14m
1900,2,Vision,3576,443,27,23,50,54.0%,6m
1900,2,Next,3576,314,14,18,32,43.8%,2m
1900,2,KwazyKwumble,3576,278,10,17,27,37.0%,10m
1900,2,[HtTK]TarTur,3576,235,9,7,16,56.2%,6m
1900,3,CharityCase,3576,58,3,0,3,100.0%,6m
1900,3,Misery,3576,97,2,1,3,66.7%,13m
1900,2,Appelschrapp,3576,118,2,4,6,33.3%,19m
1907,2,КОРИЦА,3575,864,32,34,66,48.5%,18m
1908,2,[LPeeeG]lFgCreaper,3574,1571,88,85,173,50.9%,14m
1908,2,ANGEL,3574,1298,83,86,169,49.1%,2m
1908,2,CannonRusher,3574,419,31,9,40,77.5%,25m
1908,2,dddmel,3574,246,18,10,28,64.3%,7m
1908,2,[DrGNT]DRAGONPIOU,3574,502,18,28,46,39.1%,3m
1908,3,[QTclub]JackDeRipper,3574,88,3,4,7,42.9%,27m
1908,3,icecreamsund,3574,0,1,3,4,25.0%,22m
1908,1,[EXC]Devotee,3574,0,1,7,8,12.5%,9m
1916,2,Barcode,3573,1654,428,420,848,50.5%,26m
1916,2,[SR5]Arantir,3573,670,45,40,85,52.9%,2m
1918,2,Kackophonist,3572,940,118,126,244,48.4%,18m
1918,2,[FlyFkr]Zhorliz,3572,176,5,5,10,50.0%,6m
1918,2,[WÖLFE]UnitedNation,3572,30,2,3,5,40.0%,14m
1918,3,[NetJ]BoBo,3572,30,1,2,3,33.3%,17m
1922,2,Dmik,3571,1045,45,35,80,56.2%,14m
1922,2,GLgames,3571,218,9,4,13,69.2%,18m
1922,3,TheDarkOne,3571,244,8,9,17,47.1%,24m
1922,3,CHL,3571,0,1,0,1,100.0%,17m
1922,3,yety,3571,0,0,1,1,0.0%,7m
1927,2,Hunternope,3570,1068,88,83,171,51.5%,14m
1927,2,[TaNt3]Patinator,3570,686,24,32,56,42.9%,4m
1927,2,[Acte]Ladidum,3570,244,14,7,21,66.7%,12m
1927,3,ichyron,3570,88,6,3,9,66.7%,4m
1931,3,[ƮesXG]BlueIce,3569,0,0,1,1,0.0%,18m
1932,2,Azamantes,3568,396,16,20,36,44.4%,14m
1932,3,SoVeReiGN,3568,0,3,2,5,60.0%,4m
1932,2,George,3568,0,0,2,2,0.0%,18m
1932,2,[Regret]Arachnid,3568,0,0,2,2,0.0%,16m
1936,2,[QTclub]Viewtiful,3566,904,33,36,69,47.8%,12m
1936,3,[justS]Gheorghe,3566,318,12,3,15,80.0%,24m
1936,2,[Troupe]Bebop,3566,176,6,11,17,35.3%,26m
1936,2,[Bias]piml,3566,32,4,7,11,36.4%,7m
1936,3,Sol,3566,0,0,1,1,0.0%,24m
1941,2,BigBang,3565,112,2,3,5,40.0%,5m
1941,3,Arthous,3565,0,0,2,2,0.0%,16m
1941,2,[Convoy]Jakke,3565,0,0,5,5,0.0%,25m
1944,2,[SaiYaN]OuB,3564,1548,117,114,231,50.6%,6m
1944,2,Kalimor,3564,1495,108,109,217,49.8%,3m
1944,3,[Caus]Armhulebusk,3564,30,1,3,4,25.0%,6m
1947,3,Cherminator,3563,97,1,2,3,33.3%,26m
1948,2,Troligt,3562,1183,109,88,197,55.3%,24m
1948,2,[ncotic]Doctor,3562,696,25,33,58,43.1%,16m
1948,3,HughMungus,3562,461,19,4,23,82.6%,5m
1951,2,[C17468]CarneliusROP,3561,194,7,4,11,63.6%,10m
1951,3,[dzv3rg]Ifak,3561,217,7,4,11,63.6%,17m
1951,2,Горчичка,3561,165,5,1,6,83.3%,9m
1954,3,tyy,3560,58,2,1,3,66.7%,23m
1954,3,OMA,3560,0,1,4,5,20.0%,25m
1954,2,squall,3560,30,1,4,5,20.0%,26m
1957,2,[Sativa]SNEG,3558,897,44,26,70,62.9%,6m
1957,3,Eleven,3558,396,14,12,26,53.8%,12m
1957,3,[KREU]KimKunhee,3558,170,6,6,12,50.0%,18m
1957,2,Vasec,3558,166,4,5,9,44.4%,27m
1957,3,Imbamannen,3558,60,2,2,4,50.0%,7m
1962,2,Ferox,3557,504,18,23,41,43.9%,16m
1962,3,fgvyjmvgbyki,3557,30,6,0,6,100.0%,6m
1962,3,Wersi,3557,174,5,5,10,50.0%,24m
1962,2,Skorpo,3557,162,4,6,10,40.0%,22m
1962,3,DevilsFire,3557,0,1,0,1,100.0%,22m
1962,3,George,3557,0,0,1,1,0.0%,25m
1968,2,Nameless,3556,728,60,42,102,58.8%,4m
1968,2,SecretName,3556,538,22,14,36,61.1%,22m
1968,3,[Żółw]Azore,3556,0,0,1,1,0.0%,17m
1971,2,DavbondNoob,3555,1563,119,126,245,48.6%,16m
1972,2,IIIIIIIIIIII,3554,1601,1100,1081,2181,50.4%,15m
1972,2,Grimforce,3554,326,42,37,79,53.2%,5m
1972,3,[giBik]BScythe,3554,191,5,6,11,45.5%,7m
1972,3,[ArGGEU]Kilokilo,3554,0,4,0,4,100.0%,22m
1972,2,[Phaseo]Xolocotzii,3554,0,0,3,3,0.0%,25m
1977,3,[lMBA]GGInsAnItY,3553,95,2,1,3,66.7%,26m
1977,3,Goshater,3553,0,1,0,1,100.0%,23m
1977,3,SaltySusan,3553,0,0,2,2,0.0%,9m
1980,3,[Dahu]Aleksander,3552,1063,46,24,70,65.7%,17m
1980,2,[ConFed]Wanted,3552,143,7,1,8,87.5%,18m
1980,3,[BadMen]SupremeBeing,3552,0,0,1,1,0.0%,12m
1983,3,DonutDrake,3551,1000,59,51,110,53.6%,25m
1983,2,August,3551,864,46,33,79,58.2%,5m
1983,2,iTERRAN,3551,326,25,18,43,58.1%,26m
1983,2,[708906]indigo,3551,562,21,27,48,43.8%,10m
1983,3,JustSeventy,3551,373,15,15,30,50.0%,22m
1983,3,[ǂRSǂ]HotS,3551,96,2,0,2,100.0%,7m
1983,3,[EESC]TripleS,3551,0,0,1,1,0.0%,17m
1983,3,[HellSD]Unfug,3551,0,0,1,1,0.0%,4m
1983,3,SenfGlas,3551,0,0,1,1,0.0%,18m
1992,2,RICH,3550,1122,52,42,94,55.3%,23m
1992,2,Skeeter,3550,152,5,5,10,50.0%,11m
1994,2,Sondaljan,3549,692,36,34,70,51.4%,11m
1994,2,Vio,3549,427,19,14,33,57.6%,27m
1996,3,Pessle,3548,403,18,8,26,69.2%,10m
1996,3,[NeMoKi]DarKside,3548,0,3,2,5,60.0%,12m
1996,3,[LesGP]FunkyFerdi,3548,0,2,3,5,40.0%,22m
1999,2,[Hrr]zag,3547,332,14,10,24,58.3%,11m
1999,2,GrandMister,3547,146,7,10,17,41.2%,16m
1999,2,Rocky,3547,185,6,6,12,50.0%,25m
1999,2,Jackal,3547,94,3,13,16,18.8%,11m
1999,3,[TAW]DigitZ,3547,30,1,1,2,50.0%,22m
1999,2,[BLkSa]YaBYaB,3547,0,1,2,3,33.3%,17m
2005,2,Beni,3546,1067,78,84,162,48.1%,3m
2005,2,CollinCobra,3546,130,4,2,6,66.7%,27m
2007,3,zyle,3545,1048,42,34,76,55.3%,9m
2007,2,[aW]Whitelinker,3545,144,6,7,13,46.2%,22m
2007,3,ElFleischo,3545,190,5,3,8,62.5%,11m
2007,3,[Hаsu]TbIrEnИй,3545,121,3,1,4,75.0%,12m
2007,3,Tic,3545,0,1,4,5,20.0%,7m
2012,3,Hatebreeder,3544,686,27,21,48,56.2%,23m
2012,3,Pantal,3544,519,22,11,33,66.7%,7m
2012,3,IWIking,3544,0,4,1,5,80.0%,5m
2012,3,ЛовкийЗерг,3544,30,2,1,3,66.7%,2m
2012,3,[ĦĦ]JamesWade,3544,0,1,0,1,100.0%,18m
2012,3,DarckWaacku,3544,30,1,1,2,50.0%,5m
2018,1,Lyuganok,3543,184,5,1,6,83.3%,25m
2018,3,[Dobro]Doppelgänger,3543,30,2,0,2,100.0%,22m
2018,1,Prizrak,3543,96,1,3,4,25.0%,3m
2018,3,waizen,3543,0,0,2,2,0.0%,7m
2022,3,HyperNEAT,3542,826,36,23,59,61.0%,10m
2022,3,Player,3542,0,5,0,5,100.0%,4m
2022,3,[LAMPA]ShinoaLovers,3542,0,1,0,1,100.0%,27m
2025,3,[Dniw3]StoneSculpt,3541,88,4,1,5,80.0%,17m
2025,3,ponal,3541,0,0,3,3,0.0%,14m
2027,3,KenKaneki,3540,388,15,14,29,51.7%,5m
2028,2,robotikov,3539,123,2,11,13,15.4%,10m
2028,3,[FGDU]Prometheus,3539,30,1,1,2,50.0%,7m
2028,3,Stingz,3539,0,0,5,5,0.0%,14m
2031,2,IIIIIIIIIIII,3538,883,202,192,394,51.3%,11m
2031,2,sawyer,3538,1534,140,141,281,49.8%,17m
2031,2,HIERARCH,3538,663,32,31,63,50.8%,3m
2031,2,[häZt]mOOnCake,3538,290,14,8,22,63.6%,25m
2031,3,Apodarilli,3538,0,3,2,5,60.0%,22m
2036,3,МаминХулиган,3537,366,15,10,25,60.0%,24m
2036,3,ChristineEVE,3537,220,14,8,22,63.6%,25m
2036,3,GakTakLakPak,3537,294,12,3,15,80.0%,5m
2036,3,Rororooooooo,3537,318,12,6,18,66.7%,11m
2036,3,HKreporter,3537,114,5,4,9,55.6%,10m
2036,3,NaysayeR,3537,97,4,2,6,66.7%,13m
2036,3,Kuroko,3537,58,3,0,3,100.0%,18m
2036,3,Maleb,3537,120,2,1,3,66.7%,3m
2044,3,NPGCMadGuy,3536,86,4,1,5,80.0%,13m
2044,3,[RFL]Fluo,3536,0,0,1,1,0.0%,26m
2046,3,LazyGuyIII,3535,525,25,6,31,80.6%,23m
2046,3,theswarm,3535,226,9,5,14,64.3%,7m
2046,2,[Mooи]Aethelwulf,3535,126,7,3,10,70.0%,23m
2046,3,CrazyDutchy,3535,30,1,1,2,50.0%,13m
2050,3,TheRacha,3534,172,7,3,10,70.0%,8m
2050,3,herrar,3534,30,2,0,2,100.0%,3m
2052,2,[GELSEN]Masaru,3533,1071,80,81,161,49.7%,17m
2052,3,Idletime,3533,580,23,14,37,62.2%,22m
2052,2,Велоцераптор,3533,208,8,4,12,66.7%,25m
2052,2,[KZstan]Quasar,3533,0,1,1,2,50.0%,6m
2052,3,[C0smiC]Suycide,3533,30,1,3,4,25.0%,3m
2052,3,[MAYEK]gabtro,3533,0,1,3,4,25.0%,4m
2052,3,JacobaZomato,3533,0,0,1,1,0.0%,17m
2052,3,schooled,3533,0,0,2,2,0.0%,24m
2060,2,aaaaaa,3532,1290,456,446,902,50.6%,6m
2060,3,IIIIIIIIIIII,3532,30,6,1,7,85.7%,25m
2060,2,[Pullis]Pumi,3532,90,3,9,12,25.0%,15m
2063,3,Troublemaker,3531,520,20,16,36,55.6%,16m
2063,3,Rickoshet,3531,366,15,9,24,62.5%,4m
2063,2,[SJSr]mixunio,3531,221,10,11,21,47.6%,6m
2063,2,[Hаsu]crew,3531,0,0,6,6,0.0%,10m
2067,3,Oli,3529,441,16,12,28,57.1%,2m
2067,3,nosinmidaro,3529,0,5,0,5,100.0%,11m
2067,2,[ябог]КожаныйМешок,3529,116,3,5,8,37.5%,10m
2067,3,[EnTгpY]Screamer,3529,0,1,0,1,100.0%,14m
2067,3,[UATeam]bigbeat,3529,30,1,3,4,25.0%,23m
2067,3,AdevodE,3529,0,0,4,4,0.0%,17m
2073,2,ThirtySixYO,3528,323,35,35,70,50.0%,16m
2073,3,[Ǽ1]ЙôŠŠťęḞ,3528,248,9,18,27,33.3%,13m
2073,2,[TermiT]Firework,3528,183,5,6,11,45.5%,8m
2073,3,[MPTUS]Kisser,3528,0,1,1,2,50.0%,11m
2073,3,rOoSter,3528,0,1,5,6,16.7%,23m
2078,2,Florin,3527,911,99,107,206,48.1%,15m
2078,3,[SFine]Granis,3527,0,1,0,1,100.0%,18m
2078,3,Umbonia,3527,30,1,1,2,50.0%,19m
2078,3,Amethyst,3527,0,0,1,1,0.0%,16m
2082,2,Guerter,3526,560,195,200,395,49.4%,4m
2082,3,[7D5]lowje,3526,1163,97,92,189,51.3%,8m
2082,3,MrSharky,3526,0,4,1,5,80.0%,22m
2082,3,OFF,3526,88,3,4,7,42.9%,4m
2082,2,Cibernetic,3526,0,0,1,1,0.0%,4m
2087,2,[MHACKS]SiliconSlick,3525,945,103,108,211,48.8%,23m
2087,2,Spookyd,3525,755,43,34,77,55.8%,7m
2087,3,[RstE]Témelios,3525,86,4,2,6,66.7%,8m
2087,3,[JANEZI]Xeon,3525,0,2,0,2,100.0%,12m
2091,2,Origami,3524,1048,121,109,230,52.6%,10m
2091,2,Alraerir,3524,760,52,44,96,54.2%,26m
2091,2,[QDoSai]Chrlie,3524,406,15,15,30,50.0%,26m
2091,3,[ba5ic]IIIbarCODEII,3524,58,6,1,7,85.7%,26m
2095,2,AubeZero,3523,112,7,2,9,77.8%,17m
2095,3,[OwMind]Aaz,3523,0,0,1,1,0.0%,17m
2097,3,[НТТ]Mangaka,3522,1513,134,37,171,78.4%,27m
2097,2,SilentGait,3522,811,77,73,150,51.3%,17m
2097,3,RamenKage,3522,1166,64,47,111,57.7%,5m
2097,2,NewLeafJones,3522,721,48,48,96,50.0%,22m
2097,3,[W33]Apollo,3522,280,11,8,19,57.9%,4m
2097,3,RobBot,3522,101,6,4,10,60.0%,10m
2103,3,BeastyFlw,3521,828,34,28,62,54.8%,10m
2103,2,[EuroS]Roygbiv,3521,696,31,39,70,44.3%,18m
2103,2,[NWGD]Destroyer,3521,144,7,9,16,43.8%,25m
2103,1,[AplZi]RegandwyZ,3521,0,1,0,1,100.0%,4m
2107,3,Byaka,3520,165,7,2,9,77.8%,26m
2107,2,[LøL]JiKu,3520,30,2,7,9,22.2%,12m
2107,1,Fettoni,3520,0,1,0,1,100.0%,3m
2107,3,ProßerGenis,3520,0,1,0,1,100.0%,22m
2107,3,[X3S]Ankou,3520,0,0,1,1,0.0%,18m
2107,3,ƎxƬƦƸmƸ,3520,0,0,3,3,0.0%,25m
2113,2,MargariN,3519,1217,58,53,111,52.3%,24m
2113,3,Benzy,3519,262,10,11,21,47.6%,7m
2115,2,SolidSnake,3518,254,10,3,13,76.9%,13m
2115,3,JustInSane,3518,30,1,3,4,25.0%,16m
2117,2,Rasterfant,3517,307,11,9,20,55.0%,26m
2117,3,[3DE]Buzz,3517,0,5,0,5,100.0%,27m
2117,3,[BMPZ]uPǂSpotlight,3517,0,5,0,5,100.0%,8m
2117,2,Hubris,3517,144,5,5,10,50.0%,14m
2121,2,[Aud100]Domas,3516,30,1,5,6,16.7%,7m
2122,2,stranger,3515,939,435,374,809,53.8%,16m
2122,2,[GeF]SuperOXd,3515,1262,47,49,96,49.0%,18m
2122,3,Murash,3515,0,1,0,1,100.0%,5m
2122,3,Chrthegreat,3515,0,0,1,1,0.0%,14m
2126,2,Kharyb,3514,1414,63,66,129,48.8%,26m
2126,2,Lev,3514,624,21,33,54,38.9%,16m
2126,3,[DDdogs]wizig,3514,86,4,1,5,80.0%,22m
2126,3,[SO0S]Roxxas,3514,30,2,0,2,100.0%,3m
2126,3,Gamblesock,3514,44,2,4,6,33.3%,22m
2126,1,Hachiman,3514,0,0,1,1,0.0%,9m
2132,3,[202pop]crotale,3513,1446,94,80,174,54.0%,14m
2132,3,MeiRyu,3513,330,12,14,26,46.2%,24m
2132,3,Molybdenum,3513,270,10,10,20,50.0%,8m
2132,3,Genovis,3513,166,7,0,7,100.0%,16m
2132,3,BabaUB,3513,0,3,2,5,60.0%,8m
2132,3,castorman,3513,0,1,1,2,50.0%,13m
2138,2,Sinapz,3512,1491,102,90,192,53.1%,22m
2138,3,[NCSR]ErneGosu,3512,1652,73,64,137,53.3%,4m
2138,3,Hacip,3512,1481,72,53,125,57.6%,6m
2138,3,Executor,3512,1478,59,52,111,53.2%,4m
2138,3,Pikaboo,3512,924,37,26,63,58.7%,14m
2138,2,JustMe,3512,709,36,37,73,49.3%,17m
2138,3,[EGi]MichZor,3512,60,2,3,5,40.0%,18m
2145,2,[KStyle]sitry,3511,1466,55,57,112,49.1%,25m
2145,3,Ewanda,3511,470,20,2,22,90.9%,19m
2145,3,[яєѕ]astro,3511,0,0,3,3,0.0%,18m
2148,3,[αX]Boulanger,3510,497,27,7,34,79.4%,19m
2148,3,[NINJ88]ishiren,3510,58,3,1,4,75.0%,11m
2148,3,Dremora,3510,85,3,4,7,42.9%,4m
2148,2,Executioner,3510,0,1,6,7,14.3%,6m
2148,3,AcidRain,3510,0,0,1,1,0.0%,24m
2148,3,Valorfist,3510,0,0,1,1,0.0%,24m
2154,3,Shine,3509,88,2,1,3,66.7%,6m
2154,3,OrdanBest,3509,0,1,0,1,100.0%,3m
2156,3,Tyranid,3508,1437,68,54,122,55.7%,11m
2156,2,LORM,3508,1003,41,42,83,49.4%,19m
2156,3,zlrka,3508,479,28,16,44,63.6%,3m
2156,3,Omgsuperjedi,3508,58,5,2,7,71.4%,19m
2156,2,katsumoto,3508,121,5,3,8,62.5%,5m
2156,2,Mahtisonni,3508,156,5,6,11,45.5%,18m
2156,3,YongStASS,3508,58,3,2,5,60.0%,25m
2156,3,Random,3508,46,2,1,3,66.7%,22m
2156,3,JustScout,3508,0,0,1,1,0.0%,8m
2165,3,Meruem,3507,1042,140,133,273,51.3%,18m
2165,2,[KNCHT]ImpalTu,3507,626,28,23,51,54.9%,4m
2167,3,Justacheeser,3506,1602,202,184,386,52.3%,24m
2167,2,[Rem1x]Trix,3506,1460,72,67,139,51.8%,14m
2167,3,escaton,3506,669,27,20,47,57.4%,9m
2167,3,TPxSpAnZo,3506,408,18,7,25,72.0%,10m
2167,1,Legioner,3506,126,4,2,6,66.7%,4m
2167,3,[YEAH]Nosegrind,3506,0,0,1,1,0.0%,23m
2167,3,[PbPlan]ILLtimberU,3506,0,0,1,1,0.0%,7m
2174,2,[SpaceB]LoneStar,3505,1044,35,50,85,41.2%,10m
2174,3,[CØG]skyter,3505,30,1,2,3,33.3%,13m
2174,3,ddu,3505,30,1,3,4,25.0%,3m
2177,3,PanzerPanda,3504,1563,205,192,397,51.6%,13m
2177,3,[Boiv]Scar,3504,1605,87,78,165,52.7%,9m
2177,2,[TeDa]TechnoFreak,3504,573,18,32,50,36.0%,10m
2177,3,TakeOnMe,3504,0,1,0,1,100.0%,18m
2181,3,[ASTT]Mantiquore,3503,838,78,62,140,55.7%,14m
2181,3,NoLa,3503,1012,41,33,74,55.4%,12m
2181,3,[sort]Jonathan,3503,282,10,11,21,47.6%,5m
2181,3,[GoForA]Hoffenheim,3503,86,8,1,9,88.9%,22m
2181,3,[BUAA]scboy,3503,148,5,9,14,35.7%,3m
2186,3,IIIIIIIIIIII,3502,876,57,41,98,58.2%,12m
2186,3,GoussLegend,3502,434,18,7,25,72.0%,17m
2186,3,[LaPaCa]Shyl,3502,344,14,8,22,63.6%,9m
2186,3,Crapnoob,3502,218,9,2,11,81.8%,18m
2186,3,Yinut,3502,0,0,1,1,0.0%,14m
2191,3,Bertie,3501,430,17,7,24,70.8%,14m
2191,1,Deeznutzz,3501,209,10,5,15,66.7%,10m
2191,3,hellop,3501,143,7,1,8,87.5%,23m
2191,3,Bamboo,3501,137,3,2,5,60.0%,11m
2191,3,PausePeco,3501,30,3,3,6,50.0%,5m
2196,2,Lucky,3500,1604,109,92,201,54.2%,6m
2196,3,volanis,3500,166,4,3,7,57.1%,27m
2198,3,Guetron,3498,946,79,65,144,54.9%,9m
2198,2,[ØC2]Kellidan,3498,1413,58,61,119,48.7%,14m
2198,3,PrettyFly,3498,0,5,0,5,100.0%,22m
2198,3,BeaverBuster,3498,0,1,2,3,33.3%,24m
2198,2,loveandmusic,3498,0,1,3,4,25.0%,18m
2203,3,[DT11]BoBo,3497,1172,51,42,93,54.8%,9m
2203,1,Tom,3497,153,4,2,6,66.7%,3m
2203,2,[75рус]Patriot,3497,126,4,5,9,44.4%,19m
2203,2,Jay,3497,60,3,8,11,27.3%,7m
2207,2,[H0C]NoFrx,3496,362,15,9,24,62.5%,27m
2207,2,mehha,3496,254,12,13,25,48.0%,18m
2207,3,[sTGVs]TASSADAR,3496,30,2,5,7,28.6%,22m
2207,3,Veda,3496,0,1,0,1,100.0%,7m
2207,3,[CrYNoW]AgGreSivE,3496,0,0,1,1,0.0%,11m
2207,3,[BiOdrO]TemplarGBA,3496,0,0,1,1,0.0%,9m
2213,2,TranceFuZion,3495,314,14,25,39,35.9%,19m
2213,3,Imblinkspire,3495,181,7,2,9,77.8%,14m
2213,2,Hølm,3495,0,4,3,7,57.1%,9m
2213,3,july,3495,88,3,5,8,37.5%,17m
2213,3,Nova,3495,30,2,1,3,66.7%,3m
2213,2,[4YLiFe]SPiriT,3495,102,2,4,6,33.3%,26m
2213,3,[DZTK]Nyres,3495,0,1,0,1,100.0%,18m
2213,3,JosephStalin,3495,0,0,2,2,0.0%,16m
2221,3,[Roo]PaSǂNopmat,3494,1661,132,111,243,54.3%,9m
2221,3,IIIIIIIIIIII,3494,60,3,2,5,60.0%,13m
2221,3,[Hаsu]HazeOne,3494,0,2,3,5,40.0%,6m
2221,3,KingOfBlades,3494,0,0,2,2,0.0%,22m
2225,2,MagisterLudi,3493,1497,60,65,125,48.0%,23m
2225,3,[Oops]Randsan,3493,60,3,5,8,37.5%,7m
2225,3,[PTZS]Xeon,3493,0,1,0,1,100.0%,26m
2225,3,Rafalolej,3493,0,1,0,1,100.0%,5m
2225,3,Nokipoki,3493,0,0,2,2,0.0%,18m
2230,2,Drill,3492,139,5,5,10,50.0%,14m
2230,3,TROMPADEFALO,3492,114,4,7,11,36.4%,10m
2232,1,Vamskie,3491,1554,136,129,265,51.3%,23m
2232,3,Johnny,3491,310,13,10,23,56.5%,22m
2232,3,zwift,3491,0,1,1,2,50.0%,24m
2232,3,marsO,3491,0,0,3,3,0.0%,4m
2236,3,ShiznGiggz,3490,192,8,3,11,72.7%,10m
2236,3,[JWG]Skigur,3490,145,6,7,13,46.2%,17m
2236,3,[GFXM]JackDaniel,3490,90,4,2,6,66.7%,26m
2236,3,Xexano,3490,30,2,0,2,100.0%,23m
2240,3,Lupes,3489,365,12,16,28,42.9%,11m
2240,2,[QTclub]Dave,3489,186,6,11,17,35.3%,14m
2240,3,[AlIin]EUez,3489,58,3,0,3,100.0%,3m
2240,3,Stockish,3489,82,3,2,5,60.0%,19m
2240,3,[ABRUTI]Max,3489,143,3,4,7,42.9%,25m
2240,3,FeldJäger,3489,0,1,0,1,100.0%,26m
2240,3,Balrok,3489,0,0,1,1,0.0%,4m
2247,3,[ЯD]Magico,3488,312,12,13,25,48.0%,11m
2247,3,[nK]Anubis,3488,207,9,3,12,75.0%,26m
2247,3,Sothoth,3488,0,0,1,1,0.0%,10m
2250,3,Derand,3487,914,80,72,152,52.6%,26m
2250,3,[KAOTx]xpinkyxx,3487,0,1,0,1,100.0%,17m
2252,3,[Kh4os]Shurath,3486,591,23,18,41,56.1%,22m
2252,2,Dargie,3486,0,1,0,1,100.0%,9m
2254,2,EnerVation,3485,1554,116,114,230,50.4%,14m
2254,2,VipNim,3485,747,30,35,65,46.2%,18m
2254,3,Ukko,3485,330,13,6,19,68.4%,4m
2254,2,DAA,3485,252,9,15,24,37.5%,5m
2254,1,YOYOYOG,3485,0,5,0,5,100.0%,31m
2254,3,Shibal,3485,0,1,2,3,33.3%,27m
2260,3,[UAŦeam]Adventurer,3484,1134,58,53,111,52.3%,17m
2260,2,[LGC]Tranquilo,3484,440,15,24,39,38.5%,26m
2260,3,[BarRO]Macheji,3484,30,2,1,3,66.7%,7m
2260,3,[OkKOk]pouleroi,3484,30,2,6,8,25.0%,23m
2260,1,[voff]SpiderPig,3484,0,1,4,5,20.0%,1h
2265,2,BuThor,3483,531,23,24,47,48.9%,19m
2265,3,Belmont,3483,0,0,1,1,0.0%,3m
2265,3,Ave,3483,0,0,1,1,0.0%,24m
2268,3,[iBBQ]MrFluffles,3482,460,18,13,31,58.1%,24m
2268,2,StreetCarp,3482,182,7,15,22,31.8%,18m
2268,2,[ArGGEJ]Bismarck,3482,58,3,4,7,42.9%,14m
2268,3,Fks,3482,30,2,0,2,100.0%,7m
2268,3,NLJosh,3482,0,2,3,5,40.0%,6m
2268,3,[JnduGG]winkzzzzzzzz,3482,0,1,0,1,100.0%,24m
2268,3,[SFXtm]Mat,3482,0,0,1,1,0.0%,6m
2275,3,Drako,3481,1030,47,34,81,58.0%,22m
2275,3,TheBabyPixel,3481,804,32,23,55,58.2%,14m
2275,3,eskimolimon,3481,88,4,2,6,66.7%,25m
2275,3,[PŖïMĄŁ]BØØØØØØØØØØM,3481,0,1,0,1,100.0%,12m
2275,2,Balt,3481,93,1,2,3,33.3%,9m
2280,2,Грандмастер,3480,530,21,22,43,48.8%,14m
2280,3,Pekkakahva,3480,286,11,7,18,61.1%,23m
2280,3,[NFE]Jackomio,3480,263,9,3,12,75.0%,7m
2280,3,Crimson,3480,86,3,3,6,50.0%,7m
2280,3,EpicLOLZdude,3480,0,1,0,1,100.0%,14m
2280,3,[AON100]Mati,3480,0,1,1,2,50.0%,9m
2280,3,[IndyK]ZaGGara,3480,0,0,1,1,0.0%,22m
2287,3,Jazzbear,3479,968,102,99,201,50.7%,5m
2287,3,MahnaMahna,3479,628,30,16,46,65.2%,13m
2287,3,Scofield,3479,488,22,13,35,62.9%,7m
2290,1,[RPTRMX]Andris,3478,281,7,12,19,36.8%,13m
2290,3,[ArsB]kiwiking,3478,88,3,3,6,50.0%,5m
2290,3,OnkelBob,3478,0,1,0,1,100.0%,14m
2290,1,[TAW]Alexandria,3478,0,1,1,2,50.0%,6m
2294,2,neper,3477,1543,226,225,451,50.1%,7m
2294,3,[Roger]ArseniK,3477,542,19,22,41,46.3%,9m
2294,3,MrPotatoHead,3477,282,11,11,22,50.0%,27m
2294,3,[TODOW]Neyin,3477,30,1,1,2,50.0%,11m
2298,2,SleepOnMic,3476,362,30,36,66,45.5%,18m
2298,3,Mindblaster,3476,295,12,13,25,48.0%,18m
2298,3,[LEGOs]RockRaider,3476,58,7,0,7,100.0%,25m
2298,3,Europa,3476,0,1,0,1,100.0%,14m
2298,3,Tank,3476,0,0,1,1,0.0%,23m
2298,3,deama,3476,0,0,1,1,0.0%,17m
2298,3,AvoKaDO,3476,0,0,5,5,0.0%,25m
2305,3,Сумрак,3475,1301,90,82,172,52.3%,4m
2305,3,[DarkEZ]FunkyPants,3475,838,30,32,62,48.4%,23m
2305,3,[QMnewb]FiveSZ,3475,44,1,1,2,50.0%,17m
2308,3,[MRCW]Alphonsekarr,3474,30,1,2,3,33.3%,10m
2309,3,htmlDevelope,3473,60,3,3,6,50.0%,26m
2309,3,wanted,3473,58,2,3,5,40.0%,4m
2309,3,[Frzen]Lanaya,3473,0,1,1,2,50.0%,18m
2312,3,[SkîIlz]Fabulol,3472,292,10,14,24,41.7%,7m
2312,3,PooopTroper,3472,30,6,1,7,85.7%,22m
2312,2,[RaR]Garthealis,3472,88,5,3,8,62.5%,26m
2312,2,[HAHAH]Khyane,3472,138,2,3,5,40.0%,3m
2316,1,[BbLanD]Isku,3471,0,3,2,5,60.0%,1h
2317,2,chausen,3470,1125,48,51,99,48.5%,25m
2317,3,[APER0]rakhnam,3470,692,27,25,52,51.9%,8m
2317,3,NOOBER,3470,140,5,1,6,83.3%,13m
2317,3,[Умоджа]TEPPAH,3470,0,0,1,1,0.0%,9m
2317,3,BiggestBro,3470,0,0,1,1,0.0%,19m
2322,2,Inex,3469,1541,162,169,331,48.9%,4m
2322,3,Karamba,3469,1638,110,71,181,60.8%,22m
2322,3,[SCBoys]CiRkuS,3469,1201,86,85,171,50.3%,16m
2322,3,[LoLa]Tudar,3469,178,8,2,10,80.0%,7m
2322,3,[NSBM]AntisaDød,3469,0,1,0,1,100.0%,16m
2327,3,venatiC,3468,146,6,4,10,60.0%,11m
2328,2,[fumv]MrFister,3467,964,49,45,94,52.1%,11m
2328,2,[TiMMy]Grizzly,3467,550,18,22,40,45.0%,11m
2328,3,[SCOTS]LargeToad,3467,254,10,5,15,66.7%,24m
2328,2,hitmenas,3467,58,5,7,12,41.7%,10m
2332,3,Dschihād,3466,1649,82,55,137,59.9%,24m
2332,2,saint,3466,145,3,9,12,25.0%,13m
2332,3,RainbowDash,3466,0,0,1,1,0.0%,10m
2332,3,IIIIIIIIIIII,3466,0,0,1,1,0.0%,24m
2336,3,Bartosz,3465,1285,80,74,154,51.9%,23m
2336,3,Robute,3465,492,20,11,31,64.5%,19m
2336,3,[КодБи]uranbee,3465,30,2,0,2,100.0%,5m
2336,3,[D5C]Lavova,3465,30,2,2,4,50.0%,8m
2336,3,[TIKIS]CrisiX,3465,0,2,3,5,40.0%,27m
2336,3,JOCKER,3465,30,2,5,7,28.6%,22m
2336,3,ElNiNos,3465,0,0,2,2,0.0%,10m
2343,3,Lappen,3464,202,8,4,12,66.7%,5m
2343,3,SigmaFactor,3464,113,6,1,7,85.7%,7m
2343,1,DeNis,3464,0,5,0,5,100.0%,1h
2343,1,Freedom,3464,166,3,7,10,30.0%,14m
2343,3,ScrappyCoco,3464,0,0,1,1,0.0%,23m
2348,2,Nibku,3463,1451,54,61,115,47.0%,4m
2348,3,[BWArmy]yaze,3463,830,38,14,52,73.1%,3m
2348,3,eco,3463,439,16,18,34,47.1%,19m
2348,1,DrJhonnySins,3463,318,12,8,20,60.0%,7m
2348,3,Staskesensei,3463,30,2,1,3,66.7%,7m
2348,3,wOOdy,3463,0,1,0,1,100.0%,13m
2348,1,[NuF]Cyclopes,3463,0,1,1,2,50.0%,5m
2355,2,ForzaSvW,3462,350,18,11,29,62.1%,26m
2355,3,McLovIn,3462,464,17,12,29,58.6%,4m
2355,3,Nobody,3462,250,10,9,19,52.6%,10m
2355,3,[DENG]Mclvor,3462,243,7,8,15,46.7%,5m
2355,3,[TFSC]Wormms,3462,142,5,4,9,55.6%,5m
2355,3,[Cuack]SneakyCuack,3462,86,4,1,5,80.0%,4m
2355,3,[Desire]ZutuZ,3462,97,2,0,2,100.0%,14m
2355,3,Tetra,3462,30,2,2,4,50.0%,3m
2355,3,[Mining]Roi,3462,0,0,1,1,0.0%,24m
2355,3,[3ke]QueenGaby,3462,0,0,2,2,0.0%,16m
2365,2,Ozymandias,3461,506,18,23,41,43.9%,26m
2365,3,[Peeps]REnoVation,3461,0,0,1,1,0.0%,22m
2367,3,[DutchG]Deliciata,3460,242,8,14,22,36.4%,22m
2367,3,lllllllllllI,3460,0,3,2,5,60.0%,24m
2367,2,[НТТ]Machpella,3460,0,1,0,1,100.0%,22m
2370,3,Zufallsgott,3459,405,16,6,22,72.7%,7m
2370,3,LuckyStar,3459,236,9,9,18,50.0%,27m
2370,3,isak,3459,0,1,0,1,100.0%,13m
2373,2,OoO,3457,1257,207,191,398,52.0%,23m
2373,3,Brontosaure,3457,778,29,30,59,49.2%,10m
2373,3,btee,3457,166,6,1,7,85.7%,18m
2373,3,NadineMorano,3457,90,4,4,8,50.0%,4m
2373,2,Hero,3457,30,2,7,9,22.2%,11m
2373,2,[Cheats]MasterMind,3457,0,0,1,1,0.0%,9m
2379,2,Calvity,3456,152,7,14,21,33.3%,27m
2379,1,[CCAV]EnErgy,3456,0,1,0,1,100.0%,25m
2379,3,DogTor,3456,30,1,3,4,25.0%,3m
2382,3,[zVVz]Anathema,3455,278,11,6,17,64.7%,18m
2382,2,Octopus,3455,206,9,9,18,50.0%,7m
2382,3,KillerQueen,3455,30,2,1,3,66.7%,7m
2382,3,ASvool,3455,30,2,2,4,50.0%,19m
2382,3,[NetGG]PrettyFly,3455,0,1,0,1,100.0%,4m
2382,3,[AlSq]Bomberdile,3455,0,1,1,2,50.0%,16m
2388,2,Itachi,3454,319,13,10,23,56.5%,17m
2389,3,Etupelas,3453,1380,72,19,91,79.1%,4m
2389,3,[wedown]DiVuS,3453,60,3,5,8,37.5%,11m
2389,1,Tsirkon,3453,0,2,11,13,15.4%,5m
2389,3,[QTcIub]jackie,3453,0,1,0,1,100.0%,14m
2393,3,Broketoss,3452,620,27,13,40,67.5%,23m
2393,3,[NISHOD]SkiLongLion,3452,142,6,2,8,75.0%,4m
2393,3,WassupMan,3452,62,3,4,7,42.9%,10m
2393,3,[BrKi]Forsaken,3452,0,1,0,1,100.0%,7m
2393,3,Pikowet,3452,0,0,2,2,0.0%,4m
2398,3,fikumiku,3451,351,26,11,37,70.3%,4m
2398,3,[GET]pANDE,3451,30,2,0,2,100.0%,17m
2398,3,NOD,3451,60,2,3,5,40.0%,24m
2401,3,Anomaly,3450,1536,81,73,154,52.6%,17m
2401,3,Syber,3450,158,7,8,15,46.7%,25m
2401,3,[3Macro]Бонапарт,3450,114,6,2,8,75.0%,13m
2401,2,Lokirz,3450,88,3,6,9,33.3%,9m
2401,3,IIIIIIIIIIII,3450,30,1,2,3,33.3%,14m
2406,2,Robertino,3449,921,41,39,80,51.2%,11m
2406,3,Qzut,3449,224,9,7,16,56.2%,3m
2406,2,dashet,3449,197,9,16,25,36.0%,14m
2406,3,[Prima]Majoren,3449,0,1,0,1,100.0%,25m
2406,3,dolmio,3449,30,1,1,2,50.0%,14m
2406,1,DemiGodd,3449,0,0,1,1,0.0%,22m
2412,3,Liquid,3448,30,2,3,5,40.0%,7m
2413,2,[FIHDVI]Lukas,3447,194,13,15,28,46.4%,24m
2413,1,fckProtoss,3447,190,5,7,12,41.7%,9m
2413,3,Marso,3447,30,1,3,4,25.0%,7m
2416,3,CupOfTea,3446,1027,46,31,77,59.7%,22m
2416,2,[PKTS]heizi,3446,166,9,6,15,60.0%,4m
2416,3,[EXPANT]Livradianth,3446,86,3,7,10,30.0%,14m
2419,3,Lohikäärme,3445,0,0,1,1,0.0%,14m
2419,3,zerg,3445,0,0,5,5,0.0%,4m
2421,3,Zurglub,3444,1442,103,90,193,53.4%,24m
2421,3,Kranon,3444,345,12,17,29,41.4%,17m
2423,3,[IceHus]законМерфи,3443,1473,95,93,188,50.5%,3m
2423,3,[IX9TH]Deidara,3443,118,5,4,9,55.6%,10m
2423,3,whiplash,3443,114,4,4,8,50.0%,27m
2423,2,ThomasTor,3443,88,2,3,5,40.0%,13m
2423,3,[ШОУМЕН]Amur,3443,30,1,2,3,33.3%,10m
2423,3,Ryuk,3443,0,0,4,4,0.0%,3m
2429,3,[KDV]GoLdEnLioN,3442,152,5,10,15,33.3%,7m
2429,3,Algous,3442,120,4,6,10,40.0%,7m
2429,2,[ArShrk]SharKMouZ,3442,62,2,9,11,18.2%,23m
2429,3,[BornG]DusK,3442,0,1,0,1,100.0%,16m
2429,3,[Hrr]Безразличие,3442,0,0,2,2,0.0%,5m
2434,3,[BleakC]Predator,3441,1550,87,64,151,57.6%,22m
2434,3,[MP1]Cole,3441,490,17,20,37,45.9%,12m
2434,2,MrBarcode,3441,412,14,19,33,42.4%,6m
2434,2,PolluX,3441,200,14,28,42,33.3%,6m
2434,3,tsaga,3441,230,10,11,21,47.6%,13m
2434,3,LonelyBoy,3441,30,4,2,6,66.7%,4m
2434,3,[13NRV]valithor,3441,30,3,3,6,50.0%,13m
2434,3,[42OP]HyperOrange,3441,0,1,0,1,100.0%,26m
2434,3,TrumpTwenty,3441,0,1,0,1,100.0%,5m
2443,2,Goguryeo,3440,156,8,4,12,66.7%,3m
2443,3,Harkey,3440,0,1,4,5,20.0%,14m
2443,3,TheEviL,3440,30,1,5,6,16.7%,7m
2446,2,[SSC2]tango,3439,1517,205,216,421,48.7%,14m
2446,2,BioRNN,3439,711,32,27,59,54.2%,7m
2446,3,[ULTX]Apolcalpyse,3439,118,4,9,13,30.8%,3m
2449,2,Hoola,3438,928,37,45,82,45.1%,26m
2449,3,Xabibulin,3438,869,34,24,58,58.6%,3m
2449,3,Oleg,3438,520,20,15,35,57.1%,9m
2449,2,[MAS]ZWECK,3438,436,15,24,39,38.5%,6m
2449,3,IMCPalblitz,3438,86,4,0,4,100.0%,7m
2449,3,[SL]pebriniel,3438,58,2,1,3,66.7%,19m
2455,2,kyle,3437,1377,196,201,397,49.4%,3m
2455,2,[EESC]ııVersmooRıı,3437,484,17,24,41,41.5%,10m
2455,3,Agradar,3437,335,13,12,25,52.0%,11m
2455,2,Fourteen,3437,209,10,3,13,76.9%,11m
2455,3,MadBoyScout,3437,208,7,9,16,43.8%,3m
2460,2,IIIIIIIIIIII,3436,826,35,36,71,49.3%,24m
2460,3,Challenger,3436,380,14,13,27,51.9%,7m
2460,3,[BCBB]Nummy,3436,111,2,2,4,50.0%,4m
2463,3,Somefatkid,3435,1677,345,340,685,50.4%,27m
2463,2,Veers,3435,640,21,28,49,42.9%,17m
2463,3,Begin,3435,370,14,13,27,51.9%,14m
2463,3,Anzen,3435,260,12,9,21,57.1%,7m
2463,3,[Heroes]Moes,3435,192,6,2,8,75.0%,14m
2463,2,[Blacer]Malik,3435,46,3,8,11,27.3%,19m
2469,3,AdRéNaLiNe,3434,1427,118,115,233,50.6%,26m
2469,3,[T4E]odihimself,3434,224,9,12,21,42.9%,3m
2469,3,Dash,3434,114,5,3,8,62.5%,9m
2469,3,[PiGPan]FissKael,3434,0,1,0,1,100.0%,3m
2469,3,[2II5]FootAbuser,3434,0,1,0,1,100.0%,10m
2474,3,blinblin,3433,766,29,28,57,50.9%,11m
2474,3,[Pot]Bucóka,3433,46,6,2,8,75.0%,17m
2476,3,[Ливай]grohom,3432,338,13,13,26,50.0%,25m
2476,2,Chapchui,3432,0,5,2,7,71.4%,14m
2476,2,Einsteinium,3432,196,5,9,14,35.7%,4m
2476,3,DrMobius,3432,0,1,0,1,100.0%,25m
2476,3,[Batia]Марик,3432,0,1,0,1,100.0%,27m
2476,3,Hidden,3432,0,0,1,1,0.0%,27m
2482,2,Gulman,3431,946,31,47,78,39.7%,24m
2482,3,[MCat]DrOrk,3431,401,16,4,20,80.0%,18m
2482,3,zifan,3431,0,2,3,5,40.0%,7m
2482,3,[TonT0n]Tonstor,3431,0,0,1,1,0.0%,16m
2486,3,wekzzz,3430,90,6,6,12,50.0%,7m
2487,3,[Goouda]Mojoe,3429,63,8,10,18,44.4%,27m
2487,3,[BMDR]ArEsǂDragon,3429,88,3,3,6,50.0%,3m
2489,3,biztosan,3428,1564,151,132,283,53.4%,3m
2489,3,[SBROT]Scenmox,3428,420,17,15,32,53.1%,14m
2489,3,Omni,3428,324,13,8,21,61.9%,11m
2489,3,Zaner,3428,198,7,7,14,50.0%,7m
2489,1,SHOCK,3428,0,5,0,5,100.0%,1h
2489,1,SpaceMaster,3428,0,4,1,5,80.0%,18m
2489,3,Qest,3428,88,3,7,10,30.0%,12m
2489,3,StefTheGreat,3428,0,2,3,5,40.0%,17m
2497,2,[PogC]Omni,3427,782,102,109,211,48.3%,18m
2497,3,[GrandT]SnoolP,3427,828,88,74,162,54.3%,3m
2497,3,Zhivotnaja,3427,58,6,1,7,85.7%,7m
2497,3,[CaBaL]nGp,3427,45,4,3,7,57.1%,10m
2501,3,Velkor,3426,640,42,25,67,62.7%,19m
2501,2,[SLW]Titans,3426,0,5,8,13,38.5%,17m
2501,3,[HBGSJR]Smiley,3426,0,1,1,2,50.0%,5m
2501,3,Gnaampf,3426,0,0,6,6,0.0%,10m
2505,3,JoeNova,3425,268,10,14,24,41.7%,18m
2505,3,HeX,3425,0,4,1,5,80.0%,23m
2505,3,KINGKONG,3425,0,1,0,1,100.0%,7m
2508,2,[Galois]DocSnyder,3424,1467,93,102,195,47.7%,11m
2508,3,CROMRAZ,3424,223,11,3,14,78.6%,12m
2508,3,kaizen,3424,0,0,1,1,0.0%,23m
2511,3,[FRLT]sKy,3423,140,8,3,11,72.7%,25m
2511,3,postman,3423,144,6,3,9,66.7%,26m
2511,3,[SDCB]Pilgore,3423,58,3,1,4,75.0%,23m
2511,3,[lnvoid]DYM,3423,30,2,1,3,66.7%,24m
2511,1,Serral,3423,0,1,0,1,100.0%,33m
2511,3,Nikusz,3423,0,0,1,1,0.0%,24m
2517,3,Pacific,3422,1569,117,107,224,52.2%,10m
2517,1,[DFgs]MasterMind,3422,1472,57,73,130,43.8%,23m
2517,3,Rotnacum,3422,1288,56,51,107,52.3%,19m
2517,3,Rasyl,3422,58,3,0,3,100.0%,3m
2517,3,iceface,3422,0,0,1,1,0.0%,22m
2522,3,ParkSodam,3421,390,14,17,31,45.2%,19m
2522,3,Omega,3421,88,3,5,8,37.5%,26m
2522,2,HellBoy,3421,44,1,1,2,50.0%,4m
2522,3,RevaN,3421,0,0,5,5,0.0%,5m
2526,3,[RUSMÜL]FONGUY,3420,1603,296,291,587,50.4%,6m
2526,3,IIIIIIIIIIII,3420,636,30,16,46,65.2%,4m
2526,3,BlinkyWinky,3420,366,18,21,39,46.2%,7m
2526,3,[ÆR]Shiro,3420,166,7,2,9,77.8%,23m
2526,3,PTRǂlokichou,3420,146,6,3,9,66.7%,9m
2526,3,Exolius,3420,30,2,1,3,66.7%,16m
2526,3,[QTclub]Sentinel,3420,0,0,1,1,0.0%,16m
2533,2,[GGMM]GuiberGros,3419,315,15,21,36,41.7%,27m
2533,2,[Hrr]Verniy,3419,229,7,6,13,53.8%,16m
2533,3,EagleEye,3419,0,0,1,1,0.0%,11m
2533,3,ilikebananas,3419,0,0,1,1,0.0%,5m
2533,3,Icu,3419,0,0,1,1,0.0%,13m
2533,3,Cocaa,3419,0,0,3,3,0.0%,23m
2539,3,nuclear,3418,35,8,10,18,44.4%,10m
2539,2,Kamalalala,3418,126,4,12,16,25.0%,6m
2539,1,[Wild99]sCirem,3418,0,3,3,6,50.0%,1h
2539,3,[ЛĐT]Draf,3418,0,1,0,1,100.0%,19m
2543,3,dodoodle,3417,248,10,6,16,62.5%,23m
2543,2,VavanST,3417,299,10,16,26,38.5%,3m
2543,3,[BNTRNG]Bajun,3417,57,4,4,8,50.0%,3m
2543,3,[VSC]Vespucci,3417,92,3,11,14,21.4%,19m
2547,2,Lachend,3416,1248,323,320,643,50.2%,22m
2547,3,Linteros,3416,190,62,52,114,54.4%,25m
2547,3,ЗлойКошара,3416,498,21,19,40,52.5%,3m
2547,3,koma,3416,516,19,16,35,54.3%,8m
2547,3,StrimSnaйper,3416,160,6,10,16,37.5%,24m
2547,3,CasualGaming,3416,0,5,1,6,83.3%,9m
2547,1,seppukuban,3416,230,5,8,13,38.5%,27m
2547,3,[IndyK]EVOLET,3416,30,2,0,2,100.0%,14m
2547,3,InSoLenT,3416,0,1,0,1,100.0%,13m
2547,2,Ahsoka,3416,94,1,1,2,50.0%,10m
2547,3,ChefEjtebez,3416,97,1,2,3,33.3%,16m
2558,3,Potato,3415,1389,134,132,266,50.4%,5m
2558,3,[TheDOH]kadesh,3415,920,44,32,76,57.9%,7m
2558,3,[BJÖRN]Peltz,3415,445,19,16,35,54.3%,19m
2558,3,set,3415,363,17,11,28,60.7%,5m
2558,3,itisme,3415,421,14,20,34,41.2%,7m
2558,3,[МуDТ]Shadow,3415,116,4,12,16,25.0%,25m
2558,1,lllllllll,3415,120,3,0,3,100.0%,17m
2558,3,[Peeps]Donn,3415,58,3,7,10,30.0%,23m
2566,3,[SCor]Tyrano,3414,662,45,35,80,56.2%,27m
2566,3,YamaSita,3414,915,40,36,76,52.6%,26m
2566,3,PANIE,3414,144,3,2,5,60.0%,18m
2566,3,Homelander,3414,102,2,1,3,66.7%,7m
2566,3,MrBroski,3414,0,1,0,1,100.0%,7m
2566,3,bareknuckle,3414,0,1,0,1,100.0%,25m
2566,3,LazyProbe,3414,0,0,1,1,0.0%,7m
2573,2,hoodlum,3413,824,36,41,77,46.8%,10m
2573,3,[GHFZ]KekeN,3413,346,12,18,30,40.0%,24m
2573,3,Marcel,3413,194,5,2,7,71.4%,14m
2573,1,[Traxen]Mihalich,3413,121,3,2,5,60.0%,1h
2573,3,[SpCI]ReDBuL,3413,30,2,0,2,100.0%,18m
2573,3,argeitqu,3413,60,2,2,4,50.0%,27m
2579,1,[FSCOTB]Arcanacal,3412,0,0,1,1,0.0%,1h
2579,3,[voff]BigBoyRandy,3412,0,0,1,1,0.0%,4m
2581,3,Sisteur,3411,850,120,106,226,53.1%,10m
2581,3,GrainDePixel,3411,1364,51,51,102,50.0%,17m
2581,3,DBko,3411,0,1,0,1,100.0%,18m
2581,1,MoonCake,3411,0,1,5,6,16.7%,23m
2585,3,DrunkAccount,3410,799,43,21,64,67.2%,19m
2585,3,[ZЕRGТV]SPARTA,3410,30,1,2,3,33.3%,17m
2585,2,[iX]Fenix,3410,94,1,4,5,20.0%,26m
2588,3,[GLHFGL]KäsekuchenA,3409,684,29,20,49,59.2%,10m
2588,3,ElTortuga,3409,292,10,11,21,47.6%,19m
2588,3,[GFLG]Vavar,3409,248,9,10,19,47.4%,7m
2588,3,hatcher,3409,0,1,0,1,100.0%,10m
2588,1,[AFCN]Flomotion,3409,0,1,3,4,25.0%,3m
2588,3,[PANPR]Kohlrabi,3409,30,1,3,4,25.0%,12m
2588,3,[PŖïMĄŁ]GgMaChine,3409,0,0,2,2,0.0%,26m
2595,3,[JaPP]Dubrovskijj,3408,667,27,25,52,51.9%,3m
2595,3,Overed,3408,592,25,12,37,67.6%,13m
2595,3,NetShadowXX,3408,352,14,15,29,48.3%,22m
2595,1,[SSC2]DeDMaZaY,3408,257,12,9,21,57.1%,6m
2595,3,[D0N3]tiakun,3408,300,11,17,28,39.3%,13m
2600,3,LookAround,3407,179,10,10,20,50.0%,13m
2600,3,platzhalter,3407,144,8,6,14,57.1%,8m
2600,1,RedRosa,3407,97,5,1,6,83.3%,31m
2600,3,tecasse,3407,62,5,5,10,50.0%,12m
2604,2,[CAMW]Sandr,3406,1487,120,86,206,58.3%,11m
2604,2,RaphaelGonza,3406,1439,111,117,228,48.7%,18m
2604,2,hAbaJ,3406,1254,45,57,102,44.1%,13m
2604,3,[PlAr]Shadowmeld,3406,794,36,39,75,48.0%,19m
2604,3,Maxipocak,3406,194,9,3,12,75.0%,23m
2604,3,[FlFi]Nereon,3406,62,2,8,10,20.0%,4m
2604,3,RageSkill,3406,0,1,2,3,33.3%,23m
2604,3,Tesla,3406,0,0,2,2,0.0%,17m
2612,2,Jossi,3405,1484,195,195,390,50.0%,16m
2612,3,Prayer,3405,403,16,5,21,76.2%,9m
2612,3,HopY,3405,254,16,6,22,72.7%,19m
2612,3,[TheDOH]Dimaria,3405,254,9,9,18,50.0%,26m
2612,3,DonaldTrump,3405,30,5,1,6,83.3%,3m
2612,3,[GosuRU]LiMBO,3405,90,4,4,8,50.0%,27m
2612,3,Serenity,3405,30,2,0,2,100.0%,9m
2612,3,[CCAV]ToWaPo,3405,30,1,1,2,50.0%,10m
2612,3,Lütters,3405,30,1,2,3,33.3%,6m
2621,3,Shatzy,3404,1599,303,281,584,51.9%,17m
2621,2,OneTwo,3404,1020,59,62,121,48.8%,4m
2621,3,DragonKirb,3404,210,8,9,17,47.1%,3m
2621,2,[RGAN]Quasar,3404,145,4,5,9,44.4%,16m
2621,3,[RedFmm]Zilord,3404,30,1,1,2,50.0%,13m
2621,3,Foxy,3404,0,0,2,2,0.0%,5m
2627,3,HiO,3403,334,13,11,24,54.2%,12m
2627,3,MalXantholos,3403,89,5,6,11,45.5%,23m
2627,3,ChegZ,3403,97,3,3,6,50.0%,19m
2627,3,graimeur,3403,0,1,1,2,50.0%,25m
2627,3,[DandA]Monami,3403,0,0,1,1,0.0%,27m
2627,3,stroier,3403,0,0,1,1,0.0%,14m
2633,2,Virtue,3402,1044,75,73,148,50.7%,3m
2633,3,[MPTUS]FisTeR,3402,1205,74,80,154,48.1%,10m
2633,3,AmigoOpossum,3402,0,4,2,6,66.7%,5m
2633,3,[PÂRłAH]Tomaso,3402,0,0,4,4,0.0%,17m
2637,3,[MilVi]ColonelMojo,3401,1147,94,88,182,51.6%,4m
2637,3,MrPink,3401,140,5,7,12,41.7%,6m
2637,3,[WTCR]ChugunOK,3401,0,3,2,5,60.0%,8m
2637,3,Dodo,3401,0,1,1,2,50.0%,24m
2641,3,Vigo,3400,404,17,19,36,47.2%,27m
2641,3,Guska,3400,202,11,7,18,61.1%,24m
2641,3,[Kuchen]Roqskillz,3400,86,4,0,4,100.0%,17m
2641,3,[omnce]NazmoX,3400,30,2,0,2,100.0%,25m
2641,3,WoutVanAert,3400,0,2,3,5,40.0%,23m
2641,3,ChrzCTZ,3400,0,0,3,3,0.0%,25m
2647,2,[HAYTER]Pete,3399,130,6,7,13,46.2%,24m
2647,3,Ereiarrus,3399,30,1,4,5,20.0%,22m
2649,3,[Invǂ]Simple,3398,1559,90,85,175,51.4%,24m
2649,2,NajiM,3398,872,34,41,75,45.3%,16m
2649,3,Eighth,3398,196,13,9,22,59.1%,6m
2649,3,vonster,3398,30,2,0,2,100.0%,26m
2649,3,[CPC]BoyboyCN,3398,30,2,1,3,66.7%,24m
2649,3,pHisch,3398,121,2,2,4,50.0%,10m
2655,2,[DRE4MS]Landrew,3397,915,85,91,176,48.3%,19m
2655,3,[AiRǂ]SwaiX,3397,1615,69,72,141,48.9%,7m
2657,3,MightyMoon,3396,613,26,14,40,65.0%,3m
2657,3,[InitRu]HelLioS,3396,122,2,2,4,50.0%,9m
2657,3,DrPhilGood,3396,120,2,3,5,40.0%,7m
2657,3,MORFIN,3396,0,1,0,1,100.0%,7m
2657,3,PurpleStuff,3396,0,1,0,1,100.0%,9m
2662,3,KirovReport,3395,933,82,74,156,52.6%,6m
2662,3,PouleGéante,3395,1042,49,24,73,67.1%,24m
2662,3,Kazio,3395,388,15,15,30,50.0%,16m
2662,1,sONEg,3395,262,10,8,18,55.6%,26m
2662,3,[JXL]TROR,3395,86,3,4,7,42.9%,25m
2662,3,Sheyenne,3395,0,1,0,1,100.0%,3m
2668,3,[xSRx]Bullseye,3394,444,16,13,29,55.2%,27m
2668,3,AboryM,3394,214,8,15,23,34.8%,27m
2668,3,[ÏnOuY]Spenouh,3394,58,2,4,6,33.3%,26m
2671,3,[CrøkeT]CrystaLWaLL,3393,1490,113,98,211,53.6%,26m
2671,3,[QreskT]Arevalz,3393,613,27,17,44,61.4%,9m
2671,3,[D0N3]sal,3393,315,13,12,25,52.0%,23m
2671,3,[TExGG]Granate,3393,172,9,6,15,60.0%,25m
2671,3,RaptorII,3393,254,8,14,22,36.4%,26m
2676,3,Claustro,3392,1243,57,41,98,58.2%,6m
2676,3,[CHOPAA]Argonavt,3392,1374,55,48,103,53.4%,11m
2676,3,[JS]bubiyascha,3392,554,22,15,37,59.5%,7m
2679,3,IIIIIIIIIIII,3391,208,18,20,38,47.4%,11m
2680,3,Slawsh,3390,0,4,1,5,80.0%,7m
2680,3,TorresK,3390,42,1,1,2,50.0%,13m
2680,3,Оладушек,3390,0,0,1,1,0.0%,10m
2683,2,HorstLocal,3389,1559,519,526,1045,49.7%,4m
2683,2,Gouki,3389,1067,96,102,198,48.5%,11m
2683,3,[MMKing]MacroKing,3389,773,34,22,56,60.7%,4m
2683,3,link,3389,168,6,2,8,75.0%,8m
2683,3,[JaPP]makatao,3389,90,4,3,7,57.1%,23m
2683,1,lIlIlIlIlI,3389,95,2,1,3,66.7%,5m
2683,3,[Q3A]Venser,3389,0,1,1,2,50.0%,7m
2683,3,ТёмТёмыч,3389,30,1,1,2,50.0%,27m
2683,3,broly,3389,30,1,3,4,25.0%,6m
2683,3,[IndyK]KaaPII,3389,0,0,1,1,0.0%,4m
2693,3,GoFMido,3388,1186,86,74,160,53.8%,6m
2693,3,Dare,3388,823,75,73,148,50.7%,17m
2693,3,[MeDuS]attas,3388,890,44,45,89,49.4%,3m
2693,1,IIIIIIIIIIII,3388,361,14,5,19,73.7%,26m
2693,3,LiquidFlem,3388,58,2,1,3,66.7%,7m
2693,3,[0Fks]hpx,3388,0,1,0,1,100.0%,8m
2693,3,[aYs]HPIƜicket,3388,0,0,1,1,0.0%,4m
2700,3,kaltos,3387,1481,225,211,436,51.6%,18m
2700,2,tRex,3387,439,104,103,207,50.2%,17m
2700,3,Poiy,3387,480,18,18,36,50.0%,4m
2703,3,Combain,3386,1553,71,46,117,60.7%,14m
2703,1,ProtoBieber,3386,334,14,8,22,63.6%,25m
2703,3,Strat,3386,58,3,3,6,50.0%,14m
2703,3,NorDerot,3386,82,3,5,8,37.5%,11m
2703,3,[MSK5]Dastmodest,3386,60,2,5,7,28.6%,13m
2703,2,[TMGM]Shadow,3386,42,1,5,6,16.7%,7m
2709,3,ASSAGGIAMELO,3385,340,15,9,24,62.5%,17m
2709,3,[TheER]UxorialRook,3385,0,2,3,5,40.0%,24m
2711,3,PiPappaParap,3384,572,23,14,37,62.2%,8m
2711,3,[V1]laktoz,3384,564,20,21,41,48.8%,6m
2711,3,Blackfire,3384,172,7,4,11,63.6%,7m
2714,3,Ulrezaj,3383,344,14,8,22,63.6%,24m
2714,3,KamilDab,3383,198,8,6,14,57.1%,5m
2714,3,[ToZea]Wizoux,3383,140,6,4,10,60.0%,16m
2714,3,lymmeln,3383,0,4,1,5,80.0%,13m
2718,3,DDmonkey,3382,254,10,10,20,50.0%,7m
2719,3,[Froz]FrOzeNDuDe,3381,533,19,23,42,45.2%,4m
2719,3,Lemmings,3381,86,3,12,15,20.0%,19m
2719,3,KimJungAdun,3381,30,1,1,2,50.0%,22m
2719,3,[ƮesXG]Endo,3381,30,1,3,4,25.0%,7m
2723,3,[ChXx]JakRam,3380,566,23,18,41,56.1%,25m
2723,3,[1stGG]JacDraco,3380,294,14,12,26,53.8%,13m
2725,3,[GfL]FrozZen,3379,94,1,1,2,50.0%,23m
2725,3,[ZBreed]Hardthof,3379,30,1,1,2,50.0%,22m
2725,3,[EAU]Foxsuze,3379,0,1,2,3,33.3%,11m
2725,3,[JustFF]Itarossa,3379,96,1,2,3,33.3%,24m
2729,3,MrBind,3378,355,13,13,26,50.0%,7m
2729,3,SlaYeR,3378,97,2,0,2,100.0%,17m
2729,3,TeamTeemo,3378,30,2,0,2,100.0%,13m
2729,3,[SC2MX]razac,3378,58,2,2,4,50.0%,16m
2729,3,[girlz]emmylou,3378,95,2,6,8,25.0%,25m
2734,3,[Medoed]nAPEHb,3377,581,24,19,43,55.8%,16m
2734,1,IIIIIIIIIIII,3377,262,13,7,20,65.0%,6m
2734,3,BlackStar,3377,316,13,11,24,54.2%,11m
2734,2,рэпернотми,3377,208,8,5,13,61.5%,27m
2734,3,macro,3377,114,4,3,7,57.1%,7m
2734,3,Borealis,3377,30,2,1,3,66.7%,8m
2734,3,hariseldon,3377,0,0,1,1,0.0%,6m
2734,3,[boredx]NoobHunter,3377,0,0,1,1,0.0%,14m
2734,1,sesdasdw,3377,0,0,3,3,0.0%,28m
2743,3,Qwan,3376,431,16,14,30,53.3%,19m
2743,3,[NrFms]LinGLeaDeR,3376,0,5,1,6,83.3%,9m
2743,1,[VOES]Stryder,3376,0,2,3,5,40.0%,17m
2746,1,Tanki,3375,97,6,0,6,100.0%,1h
2746,3,executor,3375,144,5,6,11,45.5%,27m
2746,3,řoyalƒlush,3375,30,2,2,4,50.0%,25m
2746,3,[SEWP]Герой,3375,123,2,2,4,50.0%,13m
2746,3,[0VI]Spike,3375,30,1,8,9,11.1%,4m
2751,3,TylooTaeja,3374,987,44,41,85,51.8%,3m
2751,3,Editor,3374,120,9,3,12,75.0%,26m
2751,1,[lOoOl]KatyaAngel,3374,0,4,1,5,80.0%,1h
2751,3,[Тетере]IIIIIIIIIIII,3374,133,3,2,5,60.0%,26m
2751,3,MSG,3374,0,1,1,2,50.0%,4m
2751,1,Alexrdl,3374,97,1,3,4,25.0%,1h
2751,3,[EZPTS]Rizo,3374,0,0,1,1,0.0%,18m
2751,3,[Пуцка]NewDedhawana,3374,0,0,9,9,0.0%,14m
2759,3,Alleusia,3373,0,3,4,7,42.9%,8m
2759,3,[SKSS]ringo,3373,0,2,3,5,40.0%,12m
2761,3,MarineKing,3372,437,15,15,30,50.0%,7m
2761,3,[PVRUS]saha,3372,86,4,2,6,66.7%,24m
2761,1,PinZaaar,3372,0,3,1,4,75.0%,14m
2764,2,[2P2a]Yokonisos,3371,696,226,243,469,48.2%,26m
2764,3,[S4V4GE]ßêđľãѪ,3371,1477,93,112,205,45.4%,27m
2764,3,[LNGBRR]jibbmn,3371,814,34,33,67,50.7%,9m
2764,2,Boom,3371,230,9,7,16,56.2%,12m
2764,3,Tio,3371,192,7,5,12,58.3%,25m
2764,3,[Blacer]wasted,3371,102,4,4,8,50.0%,11m
2770,3,broukmoute,3370,622,35,37,72,48.6%,25m
2770,3,privetpivz,3370,346,14,11,25,56.0%,26m
2770,1,Deorsa,3370,139,4,4,8,50.0%,17m
2770,3,[3GBY]GentleMan,3370,0,0,1,1,0.0%,17m
2774,3,Rethnael,3369,340,13,7,20,65.0%,17m
2774,3,Cougay,3369,58,6,2,8,75.0%,23m
2774,3,IIIIIIIIIII,3369,58,3,1,4,75.0%,9m
2774,1,[AiRǂ]PiccoloConte,3369,94,2,1,3,66.7%,13m
2774,1,apple,3369,46,1,1,2,50.0%,25m
2774,3,Avendis,3369,0,0,1,1,0.0%,23m
2774,3,[NoLair]Lords,3369,0,0,1,1,0.0%,25m
2781,2,[URNOOB]Lukareon,3368,1542,115,127,242,47.5%,27m
2781,3,Azyniklae,3368,86,3,2,5,60.0%,5m
2781,3,[dæD]InFeCTedLinG,3368,58,2,5,7,28.6%,7m
2784,2,[ENGNS]RandomGüffel,3367,1250,120,117,237,50.6%,27m
2784,3,MATHEMATIK,3367,537,49,35,84,58.3%,26m
2784,3,[KLDRi]Vuvuzela,3367,766,31,25,56,55.4%,27m
2784,3,Naked,3367,264,8,10,18,44.4%,19m
2784,1,[LIQUID]SheeBa,3367,97,4,1,5,80.0%,1h
2789,3,[theDH]Singo,3366,60,2,4,6,33.3%,17m
2789,2,luk,3366,84,2,5,7,28.6%,19m
2789,3,[αX]Serpagel,3366,0,1,0,1,100.0%,10m
2792,2,Sargas,3365,1515,234,240,474,49.4%,14m
2792,3,[FLOTOZ]TopFivHotKys,3365,328,13,11,24,54.2%,7m
2792,3,MrDracula,3365,224,9,8,17,52.9%,13m
2792,3,[ICFI]Xid,3365,0,0,1,1,0.0%,9m
2796,3,[AofK]Dachuuu,3364,169,8,3,11,72.7%,25m
2796,3,Bebe,3364,114,8,4,12,66.7%,6m
2796,3,Speedlink,3364,228,8,5,13,61.5%,24m
2796,2,ichi,3364,137,7,5,12,58.3%,24m
2796,3,[ĦĦ]Kerzz,3364,90,4,8,12,33.3%,27m
2796,3,robotfunk,3364,0,0,1,1,0.0%,3m
2802,3,Elinar,3363,633,27,20,47,57.4%,26m
2802,3,Ayou,3363,146,5,7,12,41.7%,25m
2802,3,Dowel,3363,58,3,1,4,75.0%,3m
2802,3,fingerkiller,3363,60,2,2,4,50.0%,19m
2802,3,[Bigold]Fefer,3363,58,2,2,4,50.0%,13m
2807,3,FormerChild,3362,1172,530,524,1054,50.3%,24m
2807,3,Huegelkoenig,3362,1513,186,182,368,50.5%,17m
2807,3,[XGKS]PeCoRiNo,3362,1663,89,89,178,50.0%,4m
2807,3,quiz,3362,729,27,32,59,45.8%,24m
2807,3,llllllllllll,3362,459,25,3,28,89.3%,5m
2807,3,Ovi,3362,574,24,21,45,53.3%,11m
2807,3,fura,3362,239,7,6,13,53.8%,11m
2807,1,[LezLox]WanBeParting,3362,97,3,2,5,60.0%,8m
2807,2,[Evins]EmilyEnif,3362,93,2,0,2,100.0%,13m
2807,3,[WeGr]McFeast,3362,0,2,3,5,40.0%,5m
2807,3,Sako,3362,0,1,0,1,100.0%,9m
2807,3,Refugee,3362,0,0,1,1,0.0%,26m
2819,3,[BWArmy]Oxwaa,3361,242,10,6,16,62.5%,26m
2819,3,[BeSC]AshOP,3361,121,4,3,7,57.1%,26m
2819,2,theconkerer,3361,0,3,2,5,60.0%,1h
2819,3,Alider,3361,0,0,1,1,0.0%,9m
2823,3,itsLorentz,3360,1562,134,112,246,54.5%,4m
2823,3,Nikoxlas,3360,848,33,23,56,58.9%,19m
2823,1,GreySquid,3360,97,5,2,7,71.4%,17m
2823,1,Azalius,3360,0,4,2,6,66.7%,22m
2823,3,Massive,3360,0,3,2,5,60.0%,26m
2823,3,BoneSButcheR,3360,30,3,3,6,50.0%,11m
2823,1,[GBGB]Joroe,3360,0,0,1,1,0.0%,26m
2823,3,[РУИНА]ИМБАМИНА,3360,0,0,3,3,0.0%,23m
2831,3,Gyyyzmo,3359,984,65,63,128,50.8%,14m
2831,3,feliba,3359,1390,56,46,102,54.9%,3m
2831,3,Fruityloop,3359,1154,46,43,89,51.7%,13m
2831,3,mxg,3359,374,16,17,33,48.5%,27m
2831,3,Daemon,3359,248,13,13,26,50.0%,13m
2836,3,BigSocks,3358,258,12,6,18,66.7%,13m
2836,1,Michalaa,3358,232,9,10,19,47.4%,9m
2836,3,Sblat,3358,58,4,3,7,57.1%,3m
2836,3,[SpaMml]Lambda,3358,18,1,2,3,33.3%,26m
2840,3,PhENOm,3357,116,7,5,12,58.3%,13m
2840,1,Flit,3357,142,4,0,4,100.0%,6m
2840,3,[FIXi]Мася,3357,0,0,1,1,0.0%,3m
2840,3,[DZ16]kakoki,3357,0,0,2,2,0.0%,13m
2844,3,KarambA,3356,916,135,140,275,49.1%,20m
2844,3,[Z3RGML]LeeCurtis,3356,0,1,0,1,100.0%,25m
2844,1,Kronos,3356,0,1,2,3,33.3%,1h
2847,2,[Mattis]MøøG,3355,215,7,11,18,38.9%,13m
2847,3,Lucius,3355,146,6,6,12,50.0%,17m
2847,3,AhtunG,3355,30,1,1,2,50.0%,4m
2847,3,Tuzaak,3355,30,1,5,6,16.7%,13m
2847,3,[GGGLHF]fxprochess,3355,0,0,1,1,0.0%,7m
2852,3,Ashalka,3354,1182,64,56,120,53.3%,22m
2852,3,[ZERG7V]IAmWhiteBear,3354,818,37,18,55,67.3%,26m
2852,3,YdOOm,3354,261,9,5,14,64.3%,17m
2852,3,[MHACKS]Fenris,3354,30,2,0,2,100.0%,14m
2856,3,Jarruraita,3353,870,33,35,68,48.5%,26m
2856,3,Cosmos,3353,0,1,1,2,50.0%,18m
2856,3,GoodWin,3353,0,1,3,4,25.0%,4m
2856,3,Asnofyx,3353,0,0,1,1,0.0%,7m
2860,3,Tamme,3351,1584,166,160,326,50.9%,27m
2860,3,FadMaggot,3351,1286,91,81,172,52.9%,17m
2860,2,MurlocHolmes,3351,292,14,18,32,43.8%,23m
2860,3,[BRSKR]firendted,3351,200,7,12,19,36.8%,24m
2860,3,[OneTOP]SunYoung,3351,142,6,5,11,54.5%,3m
2860,3,LyOner,3351,0,4,0,4,100.0%,18m
2860,1,ImbaAdepts,3351,97,1,1,2,50.0%,6m
2860,3,[FFoHM]Denali,3351,0,0,2,2,0.0%,13m
2868,3,AlexCaiman,3350,1657,193,173,366,52.7%,6m
2868,3,Hok,3350,729,100,75,175,57.1%,7m
2868,3,yurared,3350,883,39,33,72,54.2%,18m
2868,1,WhiteRa,3350,279,10,4,14,71.4%,27m
2868,3,[SNKN]PhoneticsPro,3350,254,7,9,16,43.8%,24m
2873,3,[Vizzor]titan,3349,1401,113,122,235,48.1%,18m
2873,3,Hectorion,3349,1362,75,64,139,54.0%,11m
2873,3,MaxRoach,3349,1116,43,35,78,55.1%,22m
2873,3,Bodo,3349,742,28,23,51,54.9%,9m
2873,2,Chien,3349,693,27,34,61,44.3%,27m
2873,3,[DTBMII]Kyu,3349,354,13,13,26,50.0%,26m
2873,3,Draf,3349,148,6,6,12,50.0%,5m
2873,3,Beatso,3349,122,5,4,9,55.6%,9m
2873,3,MrJoe,3349,86,4,1,5,80.0%,24m
2882,2,[MeDuS]Maito,3348,628,70,72,142,49.3%,27m
2882,3,Tyrfang,3348,218,14,9,23,60.9%,17m
2882,2,Amove,3348,0,2,3,5,40.0%,4m
2882,3,[PÂRłAH]MaF,3348,58,2,5,7,28.6%,17m
2886,3,BanterBoy,3347,144,8,6,14,57.1%,16m
2886,3,WildPants,3347,151,6,3,9,66.7%,23m
2886,1,Rin,3347,97,4,2,6,66.7%,31m
2886,3,[LPeeeG]Baucheffe,3347,30,1,1,2,50.0%,24m
2886,3,Mutal,3347,30,1,2,3,33.3%,17m
2891,3,[BornG]levver,3346,1170,47,44,91,51.6%,18m
2891,3,[TExGG]AtomicShot,3346,261,10,4,14,71.4%,22m
2891,3,UnicoN,3346,42,6,3,9,66.7%,16m
2891,3,[NetGG]Elsi,3346,92,4,5,9,44.4%,11m
2895,3,Nawaro,3345,116,5,3,8,62.5%,3m
2895,3,legolas,3345,148,5,10,15,33.3%,13m
2897,3,DeaTh,3344,1090,39,46,85,45.9%,16m
2897,2,[ESS]Eekez,3344,380,13,21,34,38.2%,6m
2897,3,Antoinette,3344,164,7,2,9,77.8%,5m
2897,3,SexForFood,3344,181,6,6,12,50.0%,12m
2897,3,[RBlood]ZseicH,3344,0,3,0,3,100.0%,10m
2897,3,djark,3344,0,1,0,1,100.0%,11m
2903,3,[Mavis]rodeo,3343,633,38,32,70,54.3%,12m
2903,3,[ICYFAR]Blodzil,3343,116,3,2,5,60.0%,10m
2903,3,Filips,3343,0,1,0,1,100.0%,19m
2903,1,zxccv,3343,0,0,1,1,0.0%,1h
2907,2,[PiTi]Анунаки,3342,128,40,53,93,43.0%,5m
2908,2,[Pönös]Archernar,3341,1208,55,63,118,46.6%,11m
2908,3,[BRSKR]mmcalum,3341,202,8,12,20,40.0%,19m
2908,3,AlsOb,3341,88,3,3,6,50.0%,11m
2911,3,StarTux,3340,211,8,6,14,57.1%,17m
2911,3,FKKLord,3340,142,7,7,14,50.0%,11m
2911,3,[OSgZ]CoolDrink,3340,30,2,0,2,100.0%,7m
2911,3,Tutyi,3340,0,0,7,7,0.0%,6m
2915,3,BamBam,3339,1437,93,75,168,55.4%,7m
2915,2,[HämSec]LightTrack,3339,0,1,4,5,20.0%,34m
2917,3,Shadowblate,3338,458,19,7,26,73.1%,13m
2917,3,[1239]Xenon,3338,0,0,1,1,0.0%,8m
2919,2,KGN,3337,1558,94,91,185,50.8%,7m
2919,3,Cubanomiasca,3337,717,33,26,59,55.9%,19m
2919,3,[CUB]Zeratyl,3337,304,11,9,20,55.0%,16m
2919,3,DoggoDerp,3337,30,5,1,6,83.3%,24m
2923,3,[QTcIub]TrollingPoo,3336,1588,78,67,145,53.8%,7m
2923,3,Lokky,3336,810,41,43,84,48.8%,27m
2923,3,Cropon,3336,352,13,9,22,59.1%,23m
2923,3,[PUSS]Architect,3336,58,3,4,7,42.9%,19m
2923,3,NurAbSal,3336,30,1,3,4,25.0%,17m
2923,1,[NvRScT]Nerg,3336,46,1,5,6,16.7%,7m
2929,3,Underbot,3335,1586,182,169,351,51.9%,6m
2929,3,[Froze]Elsa,3335,754,29,21,50,58.0%,22m
2929,3,Naupilus,3335,60,6,3,9,66.7%,24m
2929,3,DustLord,3335,116,5,3,8,62.5%,6m
2929,3,SharonKo,3335,30,2,0,2,100.0%,26m
2929,3,gglauge,3335,0,0,1,1,0.0%,13m
2929,3,[LSPs]Zaladriel,3335,0,0,3,3,0.0%,5m
2936,2,Algeroth,3334,1637,375,376,751,49.9%,27m
2936,3,lllllllll,3334,339,15,10,25,60.0%,8m
2936,1,Geroz,3334,258,9,14,23,39.1%,7m
2936,3,Xaldrion,3334,30,1,3,4,25.0%,9m
2940,2,Happy,3333,1442,75,90,165,45.5%,16m
2940,3,Tiof,3333,760,30,26,56,53.6%,8m
2940,3,Alf,3333,502,19,17,36,52.8%,11m
2940,3,[ĦRZ]Xplode,3333,500,18,20,38,47.4%,19m
2940,3,XIPNOSIS,3333,178,6,5,11,54.5%,4m
2940,3,[Conten]DeGaulle,3333,0,0,4,4,0.0%,26m
2946,3,[IceHus]kytsyr,3332,695,26,26,52,50.0%,13m
2946,3,[WCKYLN]Abrissbirne,3332,216,9,9,18,50.0%,22m
2946,3,Casty,3332,0,1,1,2,50.0%,23m
2946,3,Ghraskull,3332,0,0,2,2,0.0%,4m
2950,3,Qallzar,3331,1616,190,167,357,53.2%,17m
2950,3,justme,3331,1607,138,133,271,50.9%,6m
2950,3,[ZZoo]szabrownik,3331,88,24,29,53,45.3%,23m
2950,3,DangerZone,3331,416,22,12,34,64.7%,5m
2950,3,Medicine,3331,236,12,8,20,60.0%,5m
2950,3,[oGh]Balmung,3331,245,11,8,19,57.9%,14m
2950,3,[LiFe]Zeracyb,3331,116,5,6,11,45.5%,24m
2950,3,newbe,3331,30,4,3,7,57.1%,17m
2950,3,SnitteLittle,3331,0,3,3,6,50.0%,26m
2950,3,[B1C]Artwenki,3331,0,1,1,2,50.0%,14m
2960,3,[RedFmm]REDDEVIL,3330,300,12,6,18,66.7%,7m
2960,3,CarpetDiatom,3330,155,7,4,11,63.6%,23m
2960,1,Nowarich,3330,119,4,3,7,57.1%,8m
2960,3,nidck,3330,0,1,0,1,100.0%,19m
2964,3,Callboy,3329,811,33,25,58,56.9%,14m
2964,3,schwayn,3329,382,16,9,25,64.0%,9m
2964,3,[DF5]BudSpenzer,3329,60,2,7,9,22.2%,6m
2964,3,[SPAINs]SOYTUCULO,3329,0,0,1,1,0.0%,7m
2968,3,Stelios,3328,416,15,15,30,50.0%,24m
2968,3,Sva,3328,388,15,17,32,46.9%,4m
2970,3,sereetz,3327,1657,1044,1027,2071,50.4%,10m
2970,2,[KpaБ]kerriGan,3327,1520,147,157,304,48.4%,27m
2970,3,[Kuh]Puyo,3327,1619,98,93,191,51.3%,4m
2970,3,[ENQ]Yarxxxnov,3327,795,55,58,113,48.7%,15m
2970,3,Alexandr,3327,1048,45,33,78,57.7%,26m
2970,3,Lihoy,3327,482,20,10,30,66.7%,3m
2970,1,[CxCx]GasDrinker,3327,182,4,11,15,26.7%,16m
2970,1,Narisia,3327,97,3,4,7,42.9%,15m
2978,3,youkibear,3326,168,5,5,10,50.0%,9m
2978,3,ISanych,3326,60,4,4,8,50.0%,18m
2978,3,ShadowEagle,3326,97,2,0,2,100.0%,8m
2978,3,[00WW00]dugong,3326,0,1,0,1,100.0%,9m
2982,3,Chad,3325,0,4,1,5,80.0%,8m
2982,3,Unfug,3325,0,1,4,5,20.0%,24m
2982,3,FiskeNett,3325,0,0,1,1,0.0%,20m
2985,3,radschko,3324,1124,80,66,146,54.8%,25m
2985,3,doud,3324,1557,77,75,152,50.7%,13m
2985,3,[GAMI]Reset,3324,891,38,25,63,60.3%,20m
2985,2,CriticalStar,3324,96,5,1,6,83.3%,1h
2985,3,Lazare,3324,0,4,1,5,80.0%,23m
2985,3,[Rafi]John,3324,85,4,2,6,66.7%,25m
2985,3,[HBGS]Wisper,3324,0,1,0,1,100.0%,7m
2985,3,mroz,3324,30,1,1,2,50.0%,7m
2993,3,Lamelisk,3323,450,16,19,35,45.7%,13m
2993,3,[Hrѓ]Акулка,3323,368,13,6,19,68.4%,5m
2993,3,ChromeSteed,3323,284,11,9,20,55.0%,13m
2993,3,[LuuZ]Grawer,3323,86,5,9,14,35.7%,5m
2993,3,[NOW]Colt,3323,30,1,1,2,50.0%,7m
2993,3,Hyuk,3323,0,0,1,1,0.0%,3m
2999,3,friendly,3322,142,5,10,15,33.3%,26m
2999,3,novo,3322,0,1,0,1,100.0%,26m
2999,3,deadpool,3322,30,1,3,4,25.0%,12m
2999,3,Taison,3322,0,0,1,1,0.0%,25m
3003,3,Luna,3321,583,38,16,54,70.4%,12m
3003,2,ForStrings,3321,0,1,0,1,100.0%,1h
3005,3,[DNARI]KIrpich,3320,1620,818,815,1633,50.1%,24m
3005,1,jezeur,3320,97,5,2,7,71.4%,1h
3005,2,BaSSBaSS,3320,40,2,2,4,50.0%,26m
3005,3,Anakin,3320,0,1,0,1,100.0%,14m
3009,3,Amerkan,3319,1109,44,37,81,54.3%,27m
3009,3,[BSK88]Skiizz,3319,324,30,37,67,44.8%,6m
3009,2,[HsDL]stichtom,3319,301,14,27,41,34.1%,26m
3009,3,[NG0ld]CarryPotter,3319,264,11,5,16,68.8%,13m
3009,3,[Sarmat]MatiKlok,3319,0,3,2,5,60.0%,7m
3009,3,mcjc,3319,0,1,0,1,100.0%,7m
3015,3,SonOfMalice,3318,1552,99,101,200,49.5%,27m
3015,3,Plugawy,3318,1554,59,57,116,50.9%,5m
3015,2,[Peeps]Kobold,3318,520,53,62,115,46.1%,27m
3015,3,WeDestroyYou,3318,1204,52,42,94,55.3%,3m
3015,3,Bevery,3318,416,15,14,29,51.7%,27m
3015,3,[LYBITE]leonidas,3318,58,2,4,6,33.3%,7m
3015,3,Beckumer,3318,0,0,1,1,0.0%,13m
3015,3,Ayaya,3318,0,0,1,1,0.0%,11m
3015,3,sludog,3318,0,0,2,2,0.0%,18m
3024,3,Shapovalov,3317,114,5,2,7,71.4%,7m
3025,3,Jont,3316,1589,69,54,123,56.1%,13m
3025,3,KarlMartell,3316,50,5,3,8,62.5%,14m
3025,3,ChaimVital,3316,58,3,1,4,75.0%,3m
3025,3,Gazeur,3316,121,2,2,4,50.0%,5m
3025,2,Dorn,3316,0,2,3,5,40.0%,13m
3030,3,[Kompis]SagasPappa,3315,1606,84,75,159,52.8%,26m
3030,3,[Havu]Ressu,3315,0,3,2,5,60.0%,19m
3030,3,[TZCrew]Proodz,3315,58,2,2,4,50.0%,17m
3033,3,[cFADDA]WetPiricoccu,3314,396,14,8,22,63.6%,7m
3033,1,IlIllIllIllI,3314,322,13,10,23,56.5%,5m
3033,1,Zockerbabba,3314,114,2,2,4,50.0%,14m
3033,2,[UAŦeam]Megalith,3314,0,1,0,1,100.0%,35m
3037,3,walabiz,3313,1614,82,58,140,58.6%,23m
3037,3,[InBri]AlGor,3313,233,8,2,10,80.0%,4m
3037,3,[TheShy]Galoschinio,3313,0,4,1,5,80.0%,23m
3037,3,clik,3313,58,3,4,7,42.9%,13m
3037,3,tilapin,3313,30,2,4,6,33.3%,6m
3042,3,FABZ,3312,375,17,10,27,63.0%,27m
3042,3,[Moskva]DropProbes,3312,60,6,3,9,66.7%,23m
3042,3,Alucard,3312,62,3,6,9,33.3%,6m
3042,1,[BLED]davidspieder,3312,92,3,7,10,30.0%,17m
3046,3,[Anim4l]DrFatch,3311,724,26,29,55,47.3%,19m
3046,3,Zlider,3311,30,4,3,7,57.1%,13m
3046,3,xlPaRaNoiiDz,3311,30,3,6,9,33.3%,5m
3046,3,Grimous,3311,30,2,4,6,33.3%,5m
3046,3,Khao,3311,0,0,1,1,0.0%,25m
3051,3,[B1lLie]Eilish,3310,286,13,5,18,72.2%,9m
3051,3,[NiGL]Deontay,3310,322,12,10,22,54.5%,11m
3051,3,Hydra,3310,263,8,11,19,42.1%,13m
3051,3,[RBlood]Galactus,3310,114,5,0,5,100.0%,15m
3051,3,CleaningSqud,3310,0,1,1,2,50.0%,13m
3051,3,Paxanb,3310,0,0,1,1,0.0%,9m
3057,3,Alvear,3309,552,19,24,43,44.2%,3m
3057,3,Sandro,3309,120,9,10,19,47.4%,19m
3057,3,[SuvwI]ThaniMontana,3309,248,9,15,24,37.5%,3m
3057,2,BuGNUKEM,3309,164,6,13,19,31.6%,6m
3057,2,Undlrak,3309,152,5,18,23,21.7%,11m
3057,3,BakaSan,3309,0,1,0,1,100.0%,4m
3057,3,lIlIlllIlIII,3309,0,1,0,1,100.0%,3m
3057,1,Dada,3309,0,1,2,3,33.3%,1h
3057,2,[Anlav]Uolupukkie,3309,0,1,4,5,20.0%,6m
3057,3,Janush,3309,0,0,1,1,0.0%,26m
3067,3,[HADHE]festShikarno,3308,1493,187,173,360,51.9%,8m
3067,3,Freekl,3308,577,34,27,61,55.7%,3m
3067,3,[Rep]trolli,3308,644,28,22,50,56.0%,13m
3067,3,KingOfNoob,3308,0,1,0,1,100.0%,25m
3071,3,[o1l]CastorTroy,3307,1129,72,73,145,49.7%,23m
3071,2,Doodje,3307,389,45,54,99,45.5%,26m
3071,1,[MAKinG]DreamCatcher,3307,227,8,8,16,50.0%,22m
3071,2,[SonAsg]Alpha,3307,92,4,12,16,25.0%,9m
3071,2,Gazedo,3307,82,3,2,5,60.0%,4m
3071,3,BigJim,3307,0,0,1,1,0.0%,12m
3077,3,Tysd,3306,0,4,1,5,80.0%,11m
3077,1,ThisAintFun,3306,48,2,1,3,66.7%,31m
3077,3,Terran,3306,0,1,0,1,100.0%,13m
3077,3,Skippy,3306,0,0,1,1,0.0%,9m
3077,3,MicroMarine,3306,0,0,1,1,0.0%,23m
3082,3,Dippo,3305,560,23,17,40,57.5%,27m
3082,3,Skar,3305,92,4,5,9,44.4%,14m
3082,3,SmElLyArS,3305,0,0,1,1,0.0%,7m
3082,3,Пупырка,3305,0,0,2,2,0.0%,11m
3082,3,flipke,3305,0,0,3,3,0.0%,13m
3087,3,DrDeadmeat,3304,1116,60,49,109,55.0%,10m
3087,3,Pintiboy,3304,351,60,55,115,52.2%,10m
3087,3,maxQ,3304,318,11,11,22,50.0%,25m
3087,3,TrYaL,3304,0,5,1,6,83.3%,17m
3087,3,[Bruuuu]Krunkies,3304,146,5,6,11,45.5%,24m
3087,3,[Kicx]Slàyèr,3304,118,5,8,13,38.5%,4m
3087,3,readme,3304,114,4,1,5,80.0%,13m
3087,3,[AciNoN]AngryFrog,3304,0,0,2,2,0.0%,6m
3087,3,Zero,3304,0,0,5,5,0.0%,7m
3096,3,Londo,3303,0,0,1,1,0.0%,18m
3096,3,Snide,3303,0,0,1,1,0.0%,22m
3096,3,Aheron,3303,0,0,1,1,0.0%,25m
3096,3,[Arrows]vladux,3303,0,0,2,2,0.0%,13m
3100,2,[PTSL]ZéBruto,3302,1555,105,109,214,49.1%,20m
3100,3,OstrichO,3302,558,42,35,77,54.5%,27m
3100,3,KarlSberg,3302,144,6,2,8,75.0%,5m
3100,3,Yoshi,3302,58,4,6,10,40.0%,19m
3100,3,Stereophobia,3302,30,3,0,3,100.0%,17m
3105,3,Regis,3301,896,56,20,76,73.7%,19m
3105,3,FleetCommand,3301,981,38,31,69,55.1%,9m
3105,3,CERBERO,3301,0,4,3,7,57.1%,5m
3105,3,[HBGS]Borbet,3301,174,4,5,9,44.4%,19m
3105,3,[InitRu]SameOldName,3301,0,0,1,1,0.0%,7m
3110,2,DeadInside,3300,1494,188,173,361,52.1%,16m
3110,3,Gambeulin,3300,679,46,95,141,32.6%,3m
3110,3,Heartless,3300,371,19,0,19,100.0%,19m
3110,3,[0G]Xyusin,3300,328,12,18,30,40.0%,19m
3110,3,IIIIIIIIII,3300,174,7,11,18,38.9%,25m
3110,3,Falstaff,3300,0,3,2,5,60.0%,25m
3110,2,[АРМОР]neAnatoliy,3300,0,1,0,1,100.0%,25m
3110,3,[xBLACK]Moukoko,3300,0,1,0,1,100.0%,11m
3110,3,[GeWapo]Darklight,3300,30,1,2,3,33.3%,18m
3110,3,NotEnough,3300,0,0,1,1,0.0%,25m
3120,3,binarydude,3299,416,14,9,23,60.9%,19m
3120,2,[NvP]stiles,3299,95,5,1,6,83.3%,34m
3120,3,[SGEY]Асхат,3299,80,4,4,8,50.0%,4m
3123,3,Pagaille,3298,518,21,11,32,65.6%,18m
3123,2,[BatCom]WishMaster,3298,304,14,29,43,32.6%,16m
3125,3,[MaSiYa]Hercules,3297,482,18,15,33,54.5%,3m
3125,3,[УТочка]JarosFox,3297,314,17,12,29,58.6%,5m
3125,2,briznokovic,3297,304,11,15,26,42.3%,10m
3125,3,[Brra]Chachou,3297,228,9,6,15,60.0%,4m
3125,3,Urshnak,3297,30,2,5,7,28.6%,25m
3125,3,saver,3297,0,0,2,2,0.0%,18m
3131,3,Turel,3296,625,44,43,87,50.6%,3m
3131,3,[FkDyMw]Ðryft,3296,758,43,30,73,58.9%,5m
3131,3,Elendil,3296,328,14,2,16,87.5%,6m
3131,2,ImBadSryTeam,3296,118,6,1,7,85.7%,1h
3131,3,[UNS]OmuVerde,3296,0,1,0,1,100.0%,16m
3131,3,[Olk]Tomek,3296,0,0,5,5,0.0%,10m
3137,3,BenZaka,3295,1462,76,67,143,53.1%,9m
3137,3,Chezz,3295,0,1,0,1,100.0%,3m
3137,3,Yujin,3295,0,1,4,5,20.0%,27m
3137,3,LORDGG,3295,0,0,1,1,0.0%,8m
3141,3,RusWillis,3294,1623,177,166,343,51.6%,17m
3141,3,RentFree,3294,681,28,24,52,53.8%,6m
3141,3,Athoshiro,3294,60,3,1,4,75.0%,5m
3144,3,Refactor,3293,288,12,13,25,48.0%,16m
3144,3,[TheDOH]Zinnie,3293,280,9,14,23,39.1%,5m
3144,3,Alprazolam,3293,241,7,4,11,63.6%,19m
3144,1,[IAN]Davfrosk,3293,96,2,1,3,66.7%,19m
3144,3,[SAGe]TaMereLaPomm,3293,58,2,2,4,50.0%,27m
3144,3,Wackd,3293,30,2,3,5,40.0%,25m
3144,1,BannedSCV,3293,0,0,1,1,0.0%,19m
3144,3,Fatamorgana,3293,0,0,1,1,0.0%,19m
3152,3,cROMwell,3292,1573,200,205,405,49.4%,27m
3152,3,[MkersA]morph,3292,573,30,32,62,48.4%,3m
3152,3,Amsterdam,3292,342,15,11,26,57.7%,17m
3152,3,VinniThePooh,3292,120,4,11,15,26.7%,25m
3152,3,nvasion,3292,0,1,0,1,100.0%,23m
3152,3,Muhi,3292,0,0,1,1,0.0%,24m
3158,3,togostyrael,3291,946,56,32,88,63.6%,13m
3158,3,[TeamJ]moratim,3291,206,8,14,22,36.4%,25m
3160,3,BlackCoffee,3290,1472,71,71,142,50.0%,19m
3160,3,Tawa,3290,581,24,24,48,50.0%,3m
3160,3,Grumpy,3290,561,23,12,35,65.7%,5m
3160,1,[Levit]Levitas,3290,213,7,4,11,63.6%,1h
3160,3,GrumpyPants,3290,0,4,1,5,80.0%,20m
3160,3,ProbeProbius,3290,0,1,0,1,100.0%,24m
3166,3,pOwl,3289,977,91,80,171,53.2%,22m
3166,3,Thracian,3289,350,14,17,31,45.2%,14m
3166,3,uProShadow,3289,190,7,11,18,38.9%,5m
3166,1,Ghostproject,3289,97,1,3,4,25.0%,34m
3170,3,VeryAngry,3288,154,17,7,24,70.8%,13m
3170,3,[Boulas]Julius,3288,0,4,1,5,80.0%,26m
3170,3,[SERKl]CZARYǂMARY,3288,60,3,7,10,30.0%,3m
3170,3,BlackDog,3288,0,1,0,1,100.0%,19m
3174,3,[QZC]Falamir,3287,1225,64,45,109,58.7%,5m
3174,2,[UCHIНA]Pekker,3287,0,3,2,5,60.0%,4m
3174,1,[BCBB]whitewolf,3287,0,1,1,2,50.0%,37m
3177,3,Ksanch,3286,1103,46,40,86,53.5%,11m
3177,3,AlexisLionel,3286,0,3,2,5,60.0%,18m
3177,1,Flo,3286,48,2,2,4,50.0%,19m
3177,3,bababbababab,3286,30,1,5,6,16.7%,23m
3177,3,SirSucksAlot,3286,0,0,1,1,0.0%,24m
3177,3,[H0DEN]StahlKraft,3286,0,0,3,3,0.0%,3m
3177,3,Castral,3286,0,0,4,4,0.0%,13m
3184,2,Last,3285,406,15,26,41,36.6%,27m
3184,3,HypnotiX,3285,241,9,11,20,45.0%,4m
3184,3,Stressling,3285,248,9,17,26,34.6%,8m
3184,3,SuperMango,3285,0,4,2,6,66.7%,22m
3184,3,TogoRot,3285,30,4,3,7,57.1%,11m
3184,2,jari,3285,0,3,2,5,60.0%,1h
3184,3,ImSoMadBro,3285,30,1,2,3,33.3%,25m
3184,3,Svaia,3285,0,0,1,1,0.0%,3m
3184,3,TheMadnessOn,3285,0,0,2,2,0.0%,12m
3184,2,noobIOII,3285,0,0,3,3,0.0%,1h
3194,3,Zentie,3284,932,37,37,74,50.0%,13m
3194,3,llllllllllll,3284,589,31,25,56,55.4%,5m
3194,3,[LWH]dramon,3284,590,29,34,63,46.0%,8m
3194,3,fallofmath,3284,450,20,20,40,50.0%,15m
3194,3,Bagdas,3284,376,17,10,27,63.0%,26m
3194,1,Whistler,3284,40,2,0,2,100.0%,10m
3194,3,[DNUH]Yamato,3284,30,2,1,3,66.7%,25m
3194,3,[SwK]КАРАКУРТ,3284,0,1,0,1,100.0%,7m
3194,3,CaptainRARAA,3284,0,1,0,1,100.0%,11m
3194,3,[Hall]Mythicos,3284,30,1,1,2,50.0%,12m
3204,3,[EuK]Blair,3283,370,16,13,29,55.2%,18m
3204,3,Thanatos,3283,288,15,10,25,60.0%,27m
3204,3,Metanoia,3283,194,15,18,33,45.5%,27m
3204,3,Brazillian,3283,268,10,10,20,50.0%,25m
3204,3,[IceHus]IceRai,3283,213,7,0,7,100.0%,7m
3204,3,trotrolop,3283,0,4,1,5,80.0%,4m
3204,2,Ymiril,3283,0,3,2,5,60.0%,1h
3204,3,MuNikAll,3283,30,2,0,2,100.0%,7m
3204,3,[TNeko]jujulodace,3283,30,1,1,2,50.0%,16m
3204,3,[WarD]Hozg,3283,0,0,1,1,0.0%,9m
3204,3,southwave,3283,0,0,1,1,0.0%,7m
3215,2,YourHighness,3282,1083,128,134,262,48.9%,24m
3215,3,benadam,3282,1498,92,89,181,50.8%,17m
3215,3,Orogotorogon,3282,838,27,38,65,41.5%,22m
3215,3,[IceHus]llllllllll,3282,393,18,16,34,52.9%,5m
3215,2,DerNachbar,3282,221,7,4,11,63.6%,19m
3215,2,Termi,3282,0,1,1,2,50.0%,9m
3215,3,dTm,3282,30,1,2,3,33.3%,18m
3222,3,bamsic,3281,776,149,122,271,55.0%,10m
3222,3,Tea,3281,558,20,25,45,44.4%,4m
3222,3,aRsony,3281,410,18,12,30,60.0%,6m
3222,3,[Sarmat]Mewa,3281,308,12,3,15,80.0%,9m
3222,3,RedVelvetCke,3281,114,5,2,7,71.4%,19m
3227,3,[C02133]phil,3280,1495,362,361,723,50.1%,5m
3227,3,kent,3280,282,77,31,108,71.3%,17m
3227,3,Антоний,3280,1226,69,66,135,51.1%,14m
3227,3,[NeStar]ОЯШ,3280,309,10,10,20,50.0%,25m
3227,1,[IÐŠI]LuckyDuck,3280,98,9,3,12,75.0%,22m
3227,3,[W3E3D]Zlasedab,3280,62,5,5,10,50.0%,16m
3227,3,Fire,3280,0,1,0,1,100.0%,25m
3234,3,Red,3279,1522,75,61,136,55.1%,5m
3234,3,[InFy]Crane,3279,129,11,12,23,47.8%,3m
3234,2,Headshooter,3279,228,6,7,13,46.2%,26m
3234,3,BadModaFuker,3279,0,5,0,5,100.0%,3m
3234,2,Robby,3279,0,4,1,5,80.0%,15m
3234,1,Amalthea,3279,0,1,0,1,100.0%,9m
3240,3,Mektron,3278,1618,126,124,250,50.4%,16m
3240,3,Solace,3278,534,20,18,38,52.6%,6m
3240,1,[сSсǃ]KailoR,3278,108,3,0,3,100.0%,18m
3240,3,Flojiqui,3278,0,2,3,5,40.0%,4m
3240,1,[Bilout]Greed,3278,0,0,1,1,0.0%,1h
3245,2,[BBSC]Sequency,3277,1080,40,54,94,42.6%,26m
3245,3,Vision,3277,461,22,12,34,64.7%,14m
3245,3,Danger,3277,221,10,5,15,66.7%,16m
3245,3,Otis,3277,0,4,1,5,80.0%,7m
3245,3,Infanrix,3277,42,1,6,7,14.3%,17m
3245,3,Annie,3277,0,0,1,1,0.0%,13m
3251,3,SalfetKa,3276,1549,111,111,222,50.0%,14m
3251,3,[ärhoo]syila,3276,460,17,19,36,47.2%,27m
3251,3,Gortak,3276,302,16,23,39,41.0%,25m
3251,2,Seom,3276,142,7,1,8,87.5%,1h
3251,3,[Ǽ1]spid,3276,114,4,2,6,66.7%,13m
3251,2,[HämSec]sciencedwarf,3276,0,1,0,1,100.0%,6m
3251,3,casualplayer,3276,0,1,0,1,100.0%,25m
3258,3,Toasted,3275,954,186,181,367,50.7%,13m
3258,3,Korlim,3275,680,53,49,102,52.0%,4m
3258,3,FunnyJingl,3275,661,30,27,57,52.6%,23m
3258,1,[PUPSIK]IsifLife,3275,245,12,11,23,52.2%,13m
3258,2,[Br4ümu]Arkanny,3275,144,7,8,15,46.7%,11m
3258,3,scsinkjibe,3275,0,5,0,5,100.0%,20m
3258,3,DarHaz,3275,0,1,1,2,50.0%,13m
3258,3,Fernstein,3275,0,0,1,1,0.0%,13m
3258,3,[Noble]Gekko,3275,0,0,7,7,0.0%,4m
3267,3,vita,3274,1427,95,89,184,51.6%,8m
3267,3,LaXJunkie,3274,368,14,18,32,43.8%,24m
3267,2,[IceHus]LiquidWoo,3274,318,13,8,21,61.9%,18m
3267,3,daylight,3274,206,8,10,18,44.4%,5m
3267,3,Lilith,3274,0,0,1,1,0.0%,19m
3267,3,UShadow,3274,0,0,1,1,0.0%,14m
3273,3,KUBES,3273,937,37,29,66,56.1%,17m
3273,3,[GC]Christoss,3273,328,12,5,17,70.6%,24m
3273,3,FeuzG,3273,161,5,5,10,50.0%,19m
3273,3,Gone,3273,30,2,2,4,50.0%,17m
3273,3,[K0mpis]Henrik,3273,0,0,2,2,0.0%,19m
3273,2,Parse,3273,0,0,3,3,0.0%,12m
3279,3,Svorceta,3272,1572,208,203,411,50.6%,4m
3279,3,Michnek,3272,1253,80,67,147,54.4%,16m
3279,3,[Revolt]Moukav,3272,412,13,22,35,37.1%,9m
3279,3,[YEMAN]Alix,3272,0,4,1,5,80.0%,24m
3279,3,Pitou,3272,30,2,5,7,28.6%,19m
3279,3,illumiNation,3272,0,1,0,1,100.0%,20m
3279,3,Сhamomile,3272,0,1,1,2,50.0%,3m
3286,3,NaiJi,3271,762,30,23,53,56.6%,17m
3286,3,PAXI,3271,288,11,12,23,47.8%,26m
3286,1,COMMANDER,3271,145,3,1,4,75.0%,28m
3286,3,ЛомаюЛица,3271,86,3,3,6,50.0%,7m
3286,3,volk,3271,0,1,0,1,100.0%,16m
3286,2,JenniferRush,3271,0,0,1,1,0.0%,6m
3292,3,llllllllllll,3270,1198,48,46,94,51.1%,6m
3292,2,DrunkMaster,3270,632,27,29,56,48.2%,27m
3292,3,Krona,3270,462,18,15,33,54.5%,19m
3292,3,lololik,3270,301,11,6,17,64.7%,16m
3292,3,[ISSGI]KingMidas,3270,0,0,1,1,0.0%,4m
3292,3,Nahoy,3270,0,0,2,2,0.0%,8m
3298,3,[TiH]DrunkenRhino,3269,297,11,7,18,61.1%,4m
3298,3,[ESHD]Master,3269,215,9,5,14,64.3%,25m
3298,3,[SSgF]Wildjäger,3269,114,4,2,6,66.7%,8m
3298,3,LAPLACE,3269,58,2,4,6,33.3%,5m
3298,3,MagicMaker,3269,0,1,5,6,16.7%,11m
3298,3,lucifer,3269,0,0,2,2,0.0%,17m
3304,3,[DLM12]Belardo,3268,1434,184,87,271,67.9%,25m
3304,3,[TCorp]ƱǺƦƵƴ,3268,1320,92,85,177,52.0%,10m
3304,3,[RIPERY]Lasic,3268,926,42,25,67,62.7%,23m
3304,3,MakeItRAYNor,3268,58,6,2,8,75.0%,13m
3304,3,FreestyloKZ,3268,114,4,2,6,66.7%,5m
3304,3,[SC2R]Bunkobuna,3268,0,1,1,2,50.0%,5m
3304,3,Nameless,3268,0,0,3,3,0.0%,16m
3311,3,[BBOW]MouThieR,3267,595,26,21,47,55.3%,13m
3311,3,Protosexual,3267,94,6,0,6,100.0%,11m
3311,3,[Terb]Walter,3267,94,6,0,6,100.0%,16m
3311,1,Prevail,3267,121,5,3,8,62.5%,10m
3311,2,BongoZ,3267,0,1,0,1,100.0%,13m
3311,3,[ZERG7V]Vifesia,3267,94,1,5,6,16.7%,7m
3317,3,[0NBG0]Tomo,3266,862,34,29,63,54.0%,8m
3317,3,[V2K]zergonator,3266,60,3,3,6,50.0%,5m
3317,3,[сSсǃ]SpektoR,3266,0,1,4,5,20.0%,6m
3317,3,Dirtus,3266,0,0,1,1,0.0%,8m
3317,3,namaste,3266,0,0,1,1,0.0%,4m
3322,3,[Tvirus]BarryBurton,3265,875,38,24,62,61.3%,4m
3322,3,KFJ,3265,622,34,33,67,50.7%,19m
3322,3,Krak,3265,178,7,6,13,53.8%,11m
3322,3,SkyLie,3265,58,2,5,7,28.6%,10m
3326,3,Rakovoz,3264,1609,600,603,1203,49.9%,17m
3326,3,Blarance,3264,86,3,7,10,30.0%,9m
3326,3,[Dobro]ninofabula,3264,0,0,1,1,0.0%,24m
3329,3,Kachu,3263,1459,64,65,129,49.6%,17m
3329,3,[BLkSa]Susano,3263,1447,52,65,117,44.4%,23m
3329,3,Cnsbmkpsr,3263,912,50,37,87,57.5%,26m
3329,3,MarineFox,3263,465,28,30,58,48.3%,7m
3329,3,[NoLair]Ziol,3263,169,8,4,12,66.7%,11m
3329,3,[DaFF]IIIIIIIIIIII,3263,236,8,4,12,66.7%,7m
3329,3,[PLA2N]GuilleVGX,3263,30,2,2,4,50.0%,3m
3329,2,[SEKN]SecondTry,3263,0,1,0,1,100.0%,25m
3329,3,[IDGaGa]BaKBaK,3263,30,1,1,2,50.0%,5m
3338,3,[WAAAAL]KaTiKuLa,3262,769,82,73,155,52.9%,4m
3338,3,[StalkZ]Grrrr,3262,1489,77,80,157,49.0%,6m
3338,3,Saryrn,3262,1303,71,64,135,52.6%,3m
3341,3,[KO]GeneralMaud,3261,462,17,19,36,47.2%,20m
3341,2,Parzival,3261,48,4,3,7,57.1%,1h
3341,3,[West]UncleLarry,3261,62,3,4,7,42.9%,10m
3341,3,ZguhZer,3261,30,1,1,2,50.0%,6m
3345,3,Hamza,3260,1502,79,67,146,54.1%,20m
3345,3,solitude,3260,312,42,33,75,56.0%,24m
3345,3,[SURR]elHuron,3260,542,20,21,41,48.8%,25m
3345,3,[MGALS]MirandasMom,3260,422,16,14,30,53.3%,11m
3345,3,[JaPP]LeTLe,3260,384,15,12,27,55.6%,7m
3345,3,JARN,3260,432,15,21,36,41.7%,27m
3345,3,Svoychelovek,3260,214,12,13,25,48.0%,14m
3345,3,[impro]Natasat,3260,220,9,6,15,60.0%,17m
3345,3,[ArGGEJ]GuitarKing,3260,30,2,0,2,100.0%,7m
3345,3,[WCKYLN]DrunkenProbe,3260,0,0,1,1,0.0%,6m
3355,2,Kilson,3259,1576,1037,1022,2059,50.4%,5m
3355,3,Furexus,3259,754,27,31,58,46.6%,27m
3355,3,RandomName,3259,219,23,22,45,51.1%,3m
3355,3,Dragos,3259,352,12,14,26,46.2%,14m
3355,3,[NotEM]Edpayasugo,3259,122,8,9,17,47.1%,25m
3355,1,ScottyBoom,3259,0,1,1,2,50.0%,8m
3355,2,[MmS]RyûK,3259,0,0,2,2,0.0%,9m
3362,3,cyberstorm,3258,674,48,50,98,49.0%,18m
3362,2,graNite,3258,741,40,57,97,41.2%,11m
3362,3,Deftey,3258,419,20,4,24,83.3%,23m
3362,3,[BRSKR]Illustrated,3258,116,5,12,17,29.4%,26m
3362,3,Haughtgernon,3258,90,3,8,11,27.3%,24m
3362,3,Meranae,3258,116,2,1,3,66.7%,6m
3362,3,[TRASHD]Anasha,3258,0,0,3,3,0.0%,5m
3369,3,Merlin,3257,1556,130,122,252,51.6%,12m
3369,3,Arcteryx,3257,644,31,25,56,55.4%,5m
3369,3,Pegu,3257,647,24,32,56,42.9%,14m
3369,3,[FakJU]jazda,3257,398,15,8,23,65.2%,7m
3369,3,Wurstbrot,3257,176,10,7,17,58.8%,19m
3369,2,Etern,3257,95,5,1,6,83.3%,13m
3369,2,ale,3257,0,5,1,6,83.3%,1h
3376,2,TerranTears,3256,1544,255,250,505,50.5%,15m
3376,3,planB,3256,1431,64,62,126,50.8%,24m
3376,3,[RBP3]Zli,3256,1074,42,39,81,51.9%,19m
3376,3,llllllllllll,3256,296,11,11,22,50.0%,12m
3376,3,[mRwih]Bigt,3256,204,7,12,19,36.8%,14m
3376,2,[DMNED]IMBABRUCK,3256,95,5,1,6,83.3%,10m
3376,2,Zakalwe,3256,0,4,1,5,80.0%,1h
3376,3,Bartalife,3256,127,3,2,5,60.0%,12m
3376,3,camaka,3256,58,2,2,4,50.0%,24m
3376,3,[DogSG]Niki,3256,94,2,4,6,33.3%,17m
3376,2,BMO,3256,46,1,2,3,33.3%,22m
3376,3,Klitzipetel,3256,94,1,4,5,20.0%,9m
3388,2,GeorgMovut,3255,227,13,4,17,76.5%,9m
3388,2,kyznecov,3255,94,6,0,6,100.0%,1h
3388,3,[VuV]Lichtkrieger,3255,58,2,2,4,50.0%,17m
3388,3,[LaPack]DDOG,3255,0,1,0,1,100.0%,17m
3388,2,[canZeg]oscaridley,3255,0,1,0,1,100.0%,3m
3388,3,DraXter,3255,0,0,1,1,0.0%,19m
3388,3,Androide,3255,0,0,3,3,0.0%,16m
3395,3,[vln]Sirius,3254,700,29,25,54,53.7%,3m
3395,3,[NLTN]mutant,3254,58,3,11,14,21.4%,9m
3395,3,[BWArmy]Lefrancais,3254,0,1,0,1,100.0%,3m
3395,3,[HBGSJR]Bayash,3254,0,1,0,1,100.0%,4m
3395,3,AIphaStar,3254,0,1,0,1,100.0%,23m
3395,3,[TAW]Arno,3254,0,1,3,4,25.0%,25m
3401,3,TwoMore,3253,1394,144,142,286,50.3%,27m
3401,3,corea,3253,1142,83,47,130,63.8%,9m
3401,3,YourAnimeGF,3253,0,1,0,1,100.0%,23m
3401,3,[НТТ]shadowranger,3253,30,1,3,4,25.0%,27m
3401,3,Fadroma,3253,0,0,1,1,0.0%,5m
3406,3,knedlík,3252,1576,151,140,291,51.9%,3m
3406,3,GreatToss,3252,410,16,18,34,47.1%,17m
3406,2,TheGreedyOne,3252,257,12,5,17,70.6%,26m
3406,3,TORETTO,3252,163,5,5,10,50.0%,24m
3406,3,YYFYYF,3252,148,4,2,6,66.7%,16m
3406,3,[PFlow]Pabi,3252,150,4,4,8,50.0%,23m
3406,3,[ECFeV]Czuppy,3252,0,1,0,1,100.0%,3m
3406,3,[STRLAD]Harrizard,3252,0,0,1,1,0.0%,15m
3414,3,[WАSD]Livingstone,3251,1523,72,60,132,54.5%,5m
3414,3,PapyTony,3251,550,22,15,37,59.5%,25m
3414,3,granos,3251,248,8,15,23,34.8%,8m
3414,3,aMove,3251,164,7,4,11,63.6%,11m
3414,3,[OFocus]Alcubierre,3251,30,2,0,2,100.0%,14m
3414,3,MasterKWM,3251,95,2,3,5,40.0%,11m
3414,3,Апельсин,3251,0,1,0,1,100.0%,26m
3414,3,[m3mez]Katz,3251,30,1,1,2,50.0%,4m
3422,3,[WACCA]Ruddy,3250,1379,201,209,410,49.0%,11m
3422,3,AcidForBlood,3250,1143,49,35,84,58.3%,25m
3422,3,Mutal,3250,30,4,3,7,57.1%,6m
3422,3,Rowannn,3250,30,2,2,4,50.0%,23m
3422,3,[VaoR]VanDerVouts,3250,0,1,0,1,100.0%,3m
3422,3,[NТB]ZergsPaPa,3250,0,0,1,1,0.0%,25m
3428,3,[RBP3]Guerilla,3249,152,6,13,19,31.6%,3m
3428,3,pizu,3249,0,2,7,9,22.2%,26m
3428,3,[VertGe]RockFort,3249,0,0,1,1,0.0%,5m
3431,3,[mfxed]owner,3248,144,5,0,5,100.0%,13m
3431,1,[NoobIP]Lucifer,3248,164,4,1,5,80.0%,35m
3431,3,[Z3RGML]Сомбреро,3248,72,4,9,13,30.8%,13m
3431,3,[pTa]ShiQuRas,3248,30,2,2,4,50.0%,7m
3431,3,sone,3248,30,1,2,3,33.3%,24m
3436,3,MrAlien,3247,1540,366,357,723,50.6%,25m
3436,3,Sixth,3247,1147,53,55,108,49.1%,27m
3436,3,[GymBoy]MucKaBoy,3247,321,18,6,24,75.0%,26m
3436,3,[Kodos]farba,3247,0,4,1,5,80.0%,10m
3436,3,Hawk,3247,60,3,6,9,33.3%,11m
3436,3,[LAGY]Taquizan,3247,0,1,0,1,100.0%,10m
3436,3,[LОLI]tabletochka,3247,0,1,0,1,100.0%,7m
3436,3,BlackCat,3247,0,0,2,2,0.0%,7m
3436,3,[2M1B]ZIBAR,3247,0,0,3,3,0.0%,22m
3445,2,Raiminho,3246,1519,369,357,726,50.8%,6m
3445,3,BICHO,3246,1507,104,103,207,50.2%,6m
3445,3,Reuenthal,3246,157,11,4,15,73.3%,19m
3445,2,Bettedaniel,3246,244,10,9,19,52.6%,25m
3445,3,ArkGrendl,3246,0,0,1,1,0.0%,16m
3450,3,BERBERECHOS,3245,855,36,30,66,54.5%,20m
3450,1,Zwiback,3245,245,7,8,15,46.7%,24m
3450,3,kokonat,3245,0,1,0,1,100.0%,11m
3450,3,Brice,3245,0,1,1,2,50.0%,5m
3450,3,aalpsoy,3245,0,1,1,2,50.0%,25m
3450,3,SFJ,3245,30,1,4,5,20.0%,11m
3450,3,InstantPizza,3245,0,0,1,1,0.0%,7m
3450,3,NeoBlade,3245,0,0,1,1,0.0%,7m
3458,3,xRay,3244,388,15,6,21,71.4%,14m
3458,3,Poseidon,3244,357,15,11,26,57.7%,17m
3458,3,Ares,3244,240,9,5,14,64.3%,23m
3458,3,Chessmaster,3244,276,9,21,30,30.0%,3m
3458,3,daling,3244,30,2,7,9,22.2%,10m
3458,3,Coprocraft,3244,0,1,0,1,100.0%,13m
3458,3,[UNCNKG]GireOut,3244,0,0,1,1,0.0%,17m
3465,3,Conguer,3243,1482,81,80,161,50.3%,11m
3465,3,TBob,3243,950,35,39,74,47.3%,24m
3465,3,Tau,3243,390,13,22,35,37.1%,23m
3465,3,Doom,3243,230,8,8,16,50.0%,22m
3465,3,htissiez,3243,86,7,5,12,58.3%,19m
3465,2,Solid,3243,112,4,1,5,80.0%,26m
3465,3,HYDRAK,3243,142,3,1,4,75.0%,11m
3465,2,[Heroes]pavele,3243,96,3,4,7,42.9%,33m
3465,3,[TaqT]Aadera,3243,0,1,0,1,100.0%,12m
3474,3,Поэт,3242,842,32,35,67,47.8%,5m
3474,3,[TOWEA]TobyfleX,3242,0,0,1,1,0.0%,17m
3474,3,Flero,3242,0,0,1,1,0.0%,4m
3477,3,Vencundo,3241,726,31,21,52,59.6%,13m
3477,3,Heisenzerg,3241,0,4,1,5,80.0%,7m
3477,3,Slash,3241,117,3,5,8,37.5%,25m
3477,3,Nikitiiy,3241,0,1,2,3,33.3%,5m
3477,3,[nKITs]Philbort,3241,0,1,4,5,20.0%,25m
3477,3,[JEBLA]kikondo,3241,0,0,1,1,0.0%,17m
3483,3,[WCKYLN]BOSSHOORE,3240,1615,172,172,344,50.0%,16m
3483,3,wowvaqa,3240,246,8,7,15,53.3%,7m
3483,3,IcEdrAgOn,3240,180,5,6,11,45.5%,9m
3483,3,Busty,3240,0,3,2,5,60.0%,25m
3483,3,Lum,3240,94,3,3,6,50.0%,7m
3483,3,Devolhan,3240,0,0,1,1,0.0%,23m
3489,3,[ETSy]Turozumo,3239,189,55,48,103,53.4%,20m
3489,2,vnmZor,3239,211,7,4,11,63.6%,13m
3489,3,idol,3239,140,5,4,9,55.6%,18m
3492,3,Frezdébwoa,3238,1618,201,192,393,51.1%,9m
3492,3,[AiRǂ]Biscibasci,3238,1205,86,67,153,56.2%,3m
3492,3,Lucifer,3238,206,9,6,15,60.0%,6m
3492,2,[AD]ResTinPeace,3238,146,6,18,24,25.0%,26m
3492,3,DionJnD,3238,88,4,2,6,66.7%,17m
3492,3,skazy,3238,58,3,1,4,75.0%,13m
3492,3,Greypfrut,3238,58,2,3,5,40.0%,12m
3492,3,Celeste,3238,0,2,4,6,33.3%,9m
3492,3,LunaticFool,3238,0,1,0,1,100.0%,6m
3492,3,[Xa]Zyklon,3238,0,0,2,2,0.0%,24m
3502,3,PWFD,3237,151,19,4,23,82.6%,5m
3502,3,NightBaker,3237,272,12,8,20,60.0%,18m
3502,3,misery,3237,276,10,11,21,47.6%,11m
3502,1,MUKHMAJONCH,3237,293,10,11,21,47.6%,27m
3502,1,[Newbis]Singularity,3237,215,9,5,14,64.3%,38m
3502,3,[BornG]qlimax,3237,177,5,9,14,35.7%,16m
3502,3,Reverence,3237,0,1,0,1,100.0%,27m
3502,3,GendalfSnipe,3237,0,0,1,1,0.0%,6m
3510,3,Nol,3236,1580,127,122,249,51.0%,5m
3510,3,Stemir,3236,618,23,21,44,52.3%,7m
3510,3,DönerKnight,3236,286,10,11,21,47.6%,18m
3510,1,РядовойРудге,3236,94,5,6,11,45.5%,19m
3510,3,Executor,3236,0,1,0,1,100.0%,23m
3510,3,BOMJGANG,3236,0,0,1,1,0.0%,12m
3516,3,Elnirath,3235,1200,119,113,232,51.3%,5m
3516,3,[NGDY]SMaRTFeeD,3235,998,42,32,74,56.8%,18m
3516,3,DaNoM,3235,784,29,30,59,49.2%,27m
3516,3,lohgff,3235,378,16,18,34,47.1%,26m
3516,3,Aloura,3235,343,15,12,27,55.6%,10m
3516,3,[MUZG]Agieh,3235,376,13,18,31,41.9%,12m
3516,3,[Floren]Zape,3235,245,8,5,13,61.5%,19m
3516,3,[Z3R9]Näx,3235,197,7,2,9,77.8%,5m
3516,3,idaniel,3235,145,3,2,5,60.0%,25m
3516,3,[OMGHAM]OMGJAMBON,3235,95,2,0,2,100.0%,5m
3516,3,xliqhtbeatz,3235,0,1,0,1,100.0%,19m
3516,3,[Hühner]Pavane,3235,94,1,1,2,50.0%,10m
3516,3,Acog,3235,30,1,3,4,25.0%,14m
3516,3,kurva,3235,0,0,1,1,0.0%,17m
3516,2,BlackpinkBTS,3235,0,0,8,8,0.0%,27m
3531,3,[CTLF]Idoria,3234,1289,56,47,103,54.4%,24m
3531,3,Dagfari,3234,222,16,18,34,47.1%,19m
3531,3,[GGL1]ossir,3234,373,14,9,23,60.9%,8m
3531,3,Glorinflont,3234,225,6,11,17,35.3%,13m
3531,1,Hikarimoon,3234,183,5,4,9,55.6%,25m
3531,3,РАСТАМАН,3234,30,1,1,2,50.0%,19m
3531,3,[VBNTM]FiestA,3234,0,0,1,1,0.0%,19m
3538,3,dingalapadum,3233,101,23,38,61,37.7%,25m
3538,3,GLHF,3233,432,22,14,36,61.1%,23m
3538,3,Steler,3233,495,18,15,33,54.5%,12m
3538,1,OhRIP,3233,206,8,3,11,72.7%,29m
3538,3,Najash,3233,0,4,1,5,80.0%,13m
3538,3,[GWB]Vexvl,3233,116,4,7,11,36.4%,8m
3538,3,Santian,3233,46,2,2,4,50.0%,10m
3538,1,[CH33SE]thanandar,3233,97,1,2,3,33.3%,13m
3538,3,Night,3233,0,0,3,3,0.0%,19m
3538,1,dimarus,3233,0,0,3,3,0.0%,35m
3548,3,Dio,3232,528,99,91,190,52.1%,3m
3548,3,Kirk,3232,299,20,19,39,51.3%,25m
3548,3,Sita,3232,362,14,16,30,46.7%,17m
3548,3,Fistalk,3232,114,6,2,8,75.0%,16m
3548,3,andy,3232,0,4,1,5,80.0%,6m
3548,3,Bart,3232,140,4,1,5,80.0%,19m
3548,3,[Foenum]AlienWiz,3232,30,1,6,7,14.3%,12m
3555,3,[Islay]PeatyZzz,3231,1501,126,125,251,50.2%,13m
3555,3,[ArDoC]onelastkiss,3231,1415,70,68,138,50.7%,20m
3555,3,[VFN]Helios,3231,413,21,17,38,55.3%,27m
3555,3,Woe,3231,143,7,4,11,63.6%,26m
3555,3,Rumshack,3231,160,6,4,10,60.0%,4m
3555,3,Sean,3231,0,3,2,5,60.0%,11m
3555,3,[ḆŽǤ]DIAZ,3231,94,3,3,6,50.0%,14m
3555,3,[TAW]cruelrichard,3231,0,1,0,1,100.0%,10m
3555,3,thor,3231,30,1,3,4,25.0%,23m
3555,3,Elminster,3231,0,0,1,1,0.0%,4m
3565,3,Heuner,3230,232,12,15,27,44.4%,4m
3565,3,Антошка,3230,266,10,8,18,55.6%,9m
3565,3,[CFFF]Flasher,3230,240,9,15,24,37.5%,7m
3565,3,[IIG]Armageddon,3230,0,4,1,5,80.0%,4m
3565,3,astro,3230,94,2,0,2,100.0%,26m
3565,3,spL,3230,30,2,3,5,40.0%,7m
3565,3,[crabz]Vladimir,3230,0,1,0,1,100.0%,9m
3565,3,[HRgroQ]kent,3230,30,1,8,9,11.1%,9m
3565,3,[ØC]Elrel,3230,0,0,1,1,0.0%,25m
3565,1,[SaCult]Ouroboros,3230,0,0,1,1,0.0%,5m
3565,1,SarXon,3230,0,0,2,2,0.0%,35m
3576,3,Leeroy,3229,1459,126,117,243,51.9%,3m
3576,3,[GBGB]KingBurt,3229,1573,74,69,143,51.7%,9m
3576,3,iamzeus,3229,1351,61,46,107,57.0%,16m
3576,3,holistic,3229,735,37,17,54,68.5%,25m
3576,3,AeonOfStrife,3229,589,24,21,45,53.3%,13m
3576,3,[YlKES]Kotbert,3229,490,21,10,31,67.7%,3m
3576,3,Psionic,3229,523,19,17,36,52.8%,16m
3576,3,MOJIOMS,3229,310,14,11,25,56.0%,26m
3576,3,[CHPT]Ackimm,3229,349,14,13,27,51.9%,18m
3576,3,[NCSR]Androide,3229,163,5,2,7,71.4%,4m
3576,3,rakeyrakey,3229,0,4,1,5,80.0%,35m
3576,3,Loss,3229,0,3,2,5,60.0%,6m
3576,3,[LNPT]Sharadar,3229,0,1,1,2,50.0%,9m
3576,2,llllllllll,3229,0,1,2,3,33.3%,6m
3576,3,[Wø]Darcklaw,3229,0,0,1,1,0.0%,10m
3576,3,Klimo,3229,0,0,1,1,0.0%,17m
3592,3,Alff,3228,1502,126,120,246,51.2%,18m
3592,3,Chronos,3228,1075,50,31,81,61.7%,14m
3592,3,SixGuns,3228,658,27,18,45,60.0%,11m
3592,3,[ШиШаНы]Nyashka,3228,206,9,4,13,69.2%,23m
3592,3,aScDeadcam,3228,0,3,2,5,60.0%,5m
3592,3,Dhjon,3228,60,2,3,5,40.0%,14m
3592,3,[FIXi]Папус,3228,0,2,3,5,40.0%,7m
3592,3,[яєѕ]Killavalon,3228,0,0,1,1,0.0%,16m
3600,3,IIIIIIIIIIII,3227,1332,88,68,156,56.4%,16m
3600,3,[TWGs]Tohammator,3227,1401,79,76,155,51.0%,23m
3600,3,batist,3227,215,42,14,56,75.0%,4m
3600,3,Kestal,3227,0,4,2,6,66.7%,14m
3600,3,Kryp,3227,59,3,2,5,60.0%,14m
3600,3,[xSMAx]PAGANEL,3227,0,1,0,1,100.0%,25m
3600,3,bmJulietLove,3227,0,1,0,1,100.0%,14m
3607,3,[1FU2]FELASAF,3226,696,25,24,49,51.0%,4m
3607,3,Proberto,3226,234,8,15,23,34.8%,25m
3607,3,Nerevar,3226,0,1,0,1,100.0%,24m
3607,3,SquidproCrow,3226,0,1,0,1,100.0%,6m
3607,3,EGStephanoRC,3226,30,1,1,2,50.0%,14m
3612,3,Poww,3225,500,18,27,45,40.0%,14m
3612,3,[BELR]Amonbofils,3225,280,10,10,20,50.0%,23m
3612,3,eulzef,3225,241,7,10,17,41.2%,20m
3612,2,[TaOr]Hex,3225,95,2,5,7,28.6%,1h
3612,3,[HAIGH]Haighstrom,3225,0,1,0,1,100.0%,5m
3612,3,BloodyChild,3225,0,1,0,1,100.0%,23m
3612,2,GawrGura,3225,0,1,1,2,50.0%,12m
3619,3,Joker,3224,657,91,76,167,54.5%,18m
3619,3,Spudz,3224,387,19,8,27,70.4%,13m
3619,2,yukecen,3224,394,16,7,23,69.6%,8m
3619,3,[YEP4VR]Fire,3224,58,3,2,5,60.0%,19m
3619,3,Sok,3224,30,2,2,4,50.0%,17m
3619,3,[K700]kornolio,3224,0,1,0,1,100.0%,24m
3619,3,kumiho,3224,0,1,0,1,100.0%,7m
3626,3,Antsu,3223,356,17,10,27,63.0%,13m
3626,2,[Straw]помидор,3223,336,14,8,22,63.6%,23m
3626,3,AnNiHiLaToR,3223,288,11,5,16,68.8%,3m
3626,3,idd,3223,144,8,10,18,44.4%,4m
3626,3,Melon,3223,121,6,3,9,66.7%,25m
3626,2,Cosmokoloss,3223,113,2,1,3,66.7%,1h
3626,3,Whirros,3223,60,2,2,4,50.0%,26m
3626,3,Valsoray,3223,0,0,1,1,0.0%,4m
3634,3,MeThraTon,3222,1038,38,44,82,46.3%,6m
3634,3,Necros,3222,631,26,15,41,63.4%,17m
3634,3,IsoMurmeli,3222,88,3,6,9,33.3%,6m
3634,3,[QTcIub]Saevitium,3222,30,2,5,7,28.6%,11m
3634,3,[Кусь]нуненадо,3222,0,0,1,1,0.0%,5m
3639,3,Firefou,3221,387,49,50,99,49.5%,23m
3639,3,LowLife,3221,611,25,18,43,58.1%,24m
3639,3,Stardu,3221,497,17,16,33,51.5%,6m
3639,3,[БУТЕР1]Ribolov,3221,200,8,2,10,80.0%,5m
3639,3,[ePro]Clipstar,3221,88,5,7,12,41.7%,3m
3639,3,RoffeRuff,3221,0,4,1,5,80.0%,35m
3639,3,Neon,3221,95,2,0,2,100.0%,23m
3639,3,assintex,3221,0,1,1,2,50.0%,13m
3639,3,Swekills,3221,0,0,1,1,0.0%,16m
3639,3,Citizen,3221,0,0,4,4,0.0%,11m
3649,3,roquefort,3220,387,20,13,33,60.6%,15m
3649,3,BarackPyjama,3220,380,19,11,30,63.3%,24m
3649,3,Mihawk,3220,435,18,27,45,40.0%,23m
3649,3,classic,3220,246,14,13,27,51.9%,26m
3649,3,[EAU]nSgBoosters,3220,0,5,0,5,100.0%,10m
3649,3,Frodefrodig,3220,161,4,4,8,50.0%,17m
3649,3,[AnD]STATS,3220,121,3,1,4,75.0%,12m
3649,3,[G2I]LonelyProbe,3220,0,1,1,2,50.0%,24m
3649,3,sadji,3220,30,1,3,4,25.0%,26m
3658,3,Fear,3219,417,22,4,26,84.6%,13m
3658,1,ilurius,3219,141,6,3,9,66.7%,19m
3658,3,[NWGD]ksisovec,3219,86,4,7,11,36.4%,17m
3658,3,DrK,3219,94,2,0,2,100.0%,18m
3658,3,flyrev,3219,0,2,3,5,40.0%,6m
3658,3,Hush,3219,58,2,5,7,28.6%,11m
3658,3,Gekautes,3219,0,1,0,1,100.0%,9m
3658,3,PiKiTrOn,3219,95,1,1,2,50.0%,26m
3658,3,storm,3219,0,0,4,4,0.0%,25m
3667,3,TimGold,3218,697,96,92,188,51.1%,19m
3667,3,Smile,3218,696,40,41,81,49.4%,15m
3667,3,tiny,3218,60,7,3,10,70.0%,20m
3667,2,TrustNoOne,3218,180,6,4,10,60.0%,26m
3667,3,Gondou,3218,30,5,2,7,71.4%,9m
3667,3,[InitRu]wispEr,3218,163,4,3,7,57.1%,25m
3667,1,[WCFAN]Schlitzer,3218,153,4,5,9,44.4%,9m
3667,3,Fil,3218,118,3,1,4,75.0%,7m
3667,3,Marcin,3218,144,3,3,6,50.0%,12m
3676,3,[GSRbe]Tenebris,3217,766,63,52,115,54.8%,18m
3676,3,[Ǽ1]OttoSpritz,3217,353,25,15,40,62.5%,9m
3676,3,rangleklods,3217,464,19,13,32,59.4%,3m
3676,3,[CloudX]Estated,3217,370,13,11,24,54.2%,5m
3676,3,[JLK]xxviking,3217,111,3,2,5,60.0%,27m
3676,3,Diamand,3217,0,3,2,5,60.0%,1h
3676,3,[EXPANT]Moon,3217,94,2,0,2,100.0%,12m
3676,3,[1Best]Froll,3217,94,1,1,2,50.0%,13m
3676,3,Zerifa,3217,30,1,4,5,20.0%,23m
3685,3,akduun,3216,1535,72,72,144,50.0%,25m
3685,3,random,3216,959,41,30,71,57.7%,17m
3685,3,Shansur,3216,909,37,30,67,55.2%,25m
3685,3,Moneytalkz,3216,237,12,4,16,75.0%,18m
3685,1,Zadyszek,3216,141,6,3,9,66.7%,37m
3685,1,llllllllllll,3216,119,4,2,6,66.7%,7m
3685,3,[SEWP]Rezerfordium,3216,0,1,4,5,20.0%,12m
3685,3,NecroBorg,3216,0,0,1,1,0.0%,3m
3693,3,Pikabuz,3215,637,27,18,45,60.0%,4m
3693,3,[TheDOH]Grubson,3215,613,26,19,45,57.8%,24m
3693,3,JuiceBox,3215,511,22,12,34,64.7%,23m
3693,3,[BRSKR]Berzerker,3215,195,7,3,10,70.0%,17m
3693,3,EvilDwarf,3215,159,5,2,7,71.4%,17m
3693,3,Caponetti,3215,159,5,3,8,62.5%,23m
3699,3,[J4E]atillabet,3214,779,63,48,111,56.8%,11m
3699,3,[WCKYLN]Lonestar,3214,615,27,17,44,61.4%,4m
3699,3,[RvlD]Pramuk,3214,556,21,19,40,52.5%,7m
3699,3,AnttiAnttila,3214,215,6,4,10,60.0%,9m
3699,3,gimilzor,3214,136,4,5,9,44.4%,12m
3699,3,arthann,3214,30,2,2,4,50.0%,12m
3699,3,PanTo,3214,122,2,3,5,40.0%,3m
3699,1,Jebediah,3214,48,1,2,3,33.3%,3m
3699,3,Łapczywy,3214,0,0,1,1,0.0%,5m
3708,3,huhu,3213,566,41,34,75,54.7%,27m
3708,3,Dartti,3213,768,27,35,62,43.5%,15m
3708,3,IIIIIIIIIIII,3213,468,19,13,32,59.4%,23m
3708,3,ZMEY,3213,152,5,9,14,35.7%,26m
3708,1,Korn,3213,120,4,3,7,57.1%,6m
3708,3,PainKiller,3213,0,1,0,1,100.0%,7m
3708,3,[GdAT]ScarlettUK,3213,0,1,1,2,50.0%,19m
3708,3,[PandaC]GRX,3213,0,0,1,1,0.0%,17m
3716,3,[ESOT]SuperIorni,3212,524,25,11,36,69.4%,7m
3716,3,ydg,3212,481,19,16,35,54.3%,26m
3716,3,Brax,3212,184,7,2,9,77.8%,5m
3716,3,[ЕМPIRE]DoorsXP,3212,30,5,5,10,50.0%,24m
3716,3,[OwOOwO]Krishn,3212,185,5,8,13,38.5%,23m
3716,3,Shinluu,3212,0,2,3,5,40.0%,25m
3716,3,BloodLind,3212,0,1,0,1,100.0%,9m
3716,3,oNe,3212,0,0,2,2,0.0%,4m
3724,3,Mephystofel,3211,1027,53,53,106,50.0%,27m
3724,3,[Трутни]Wanewolf,3211,382,16,8,24,66.7%,6m
3724,3,TSD,3211,279,12,9,21,57.1%,9m
3724,1,OBenDeR,3211,166,6,2,8,75.0%,7m
3724,3,[TOPZIK]Kinson,3211,178,6,4,10,60.0%,10m
3724,3,[zouave]Photino,3211,0,4,1,5,80.0%,26m
3724,3,IIIIIIIIIIII,3211,117,2,1,3,66.7%,6m
3724,3,Woland,3211,118,2,2,4,50.0%,26m
3724,3,Dithmarscher,3211,30,1,3,4,25.0%,19m
3724,3,Lasileuka,3211,0,1,4,5,20.0%,3m
3734,3,WTFôÔFTW,3210,1561,103,100,203,50.7%,15m
3734,3,csdemons,3210,1531,69,47,116,59.5%,8m
3734,3,Paradise,3210,1217,43,53,96,44.8%,26m
3734,3,[AiRǂ]Warf,3210,534,20,19,39,51.3%,11m
3734,3,zeradun,3210,282,12,16,28,42.9%,6m
3734,3,[LAGY]Societ,3210,169,10,9,19,52.6%,25m
3734,3,TaRKuS,3210,207,7,5,12,58.3%,6m
3734,3,Warbringer,3210,0,5,0,5,100.0%,13m
3734,3,Endofo,3210,0,4,1,5,80.0%,26m
3734,3,MisiAQ,3210,0,4,1,5,80.0%,14m
3734,3,Tron,3210,93,3,3,6,50.0%,5m
3734,3,SapoGg,3210,116,2,1,3,66.7%,13m
3734,1,Yamborghini,3210,0,0,3,3,0.0%,16m
3747,3,yodaogkush,3209,1396,106,97,203,52.2%,25m
3747,3,[WBK]KOLIBREI,3209,0,4,1,5,80.0%,1h
3747,3,[Blacer]BlueKnight,3209,88,3,8,11,27.3%,5m
3747,3,BlueSide,3209,95,2,0,2,100.0%,6m
3747,3,Seifer,3209,0,1,0,1,100.0%,7m
3747,1,genius,3209,48,1,1,2,50.0%,1h
3747,1,[Smthc]drFurryballs,3209,96,1,2,3,33.3%,11m
3747,3,[Specii]LEGITMONSTA,3209,0,0,1,1,0.0%,20m
3755,3,[lOoOl]microjackson,3208,361,15,8,23,65.2%,12m
3755,3,DroneForever,3208,312,10,6,16,62.5%,17m
3755,3,Psy,3208,116,6,8,14,42.9%,26m
3755,3,[Arrows]Soundwave,3208,145,5,0,5,100.0%,5m
3755,3,DarthMono,3208,158,4,3,7,57.1%,15m
3755,3,Dasha,3208,0,1,0,1,100.0%,23m
3755,3,[Razzle]Elkeezy,3208,0,0,2,2,0.0%,27m
3762,3,[Imba]Dussae,3207,1461,138,136,274,50.4%,5m
3762,3,Curlviv,3207,804,76,60,136,55.9%,11m
3762,3,[ThUdLu]JustlDead,3207,422,14,22,36,38.9%,11m
3762,3,[SPHTRS]Monty,3207,184,7,14,21,33.3%,7m
3762,2,Coffee,3207,95,5,2,7,71.4%,11m
3762,3,INFERNAL,3207,0,1,0,1,100.0%,17m
3762,3,wolvangel,3207,30,1,2,3,33.3%,20m
3769,3,[GAMI]santiego,3206,1447,78,66,144,54.2%,9m
3769,3,ebick,3206,519,26,9,35,74.3%,4m
3769,3,[lOoOl]TEPPOPUCT,3206,471,20,11,31,64.5%,23m
3769,2,[IAODI]Davdi,3206,322,12,19,31,38.7%,27m
3769,3,[CCAV]miago,3206,124,11,3,14,78.6%,16m
3769,3,Gambos,3206,273,11,6,17,64.7%,11m
3769,3,fjjotizz,3206,167,8,5,13,61.5%,12m
3769,3,Milky,3206,108,5,2,7,71.4%,19m
3769,3,boubou,3206,0,4,1,5,80.0%,7m
3769,3,javiorpas,3206,153,4,2,6,66.7%,4m
3769,3,Atoli,3206,119,3,1,4,75.0%,26m
3769,2,YFC,3206,161,3,2,5,60.0%,14m
3769,3,Dionmaister,3206,60,3,3,6,50.0%,15m
3769,3,[DragoM]GolD,3206,90,1,1,2,50.0%,13m
3783,3,Winstorm,3205,446,19,19,38,50.0%,20m
3783,3,Sergeevich,3205,368,18,18,36,50.0%,6m
3783,3,Zee,3205,278,17,10,27,63.0%,5m
3783,3,Антон,3205,318,13,8,21,61.9%,25m
3783,3,FatherDrift,3205,153,5,2,7,71.4%,27m
3783,3,[IceHus]IIIIIIIIIIII,3205,192,5,5,10,50.0%,13m
3783,3,Virik,3205,0,4,1,5,80.0%,23m
3783,2,KernelPanic,3205,117,3,0,3,100.0%,4m
3783,1,LaKalaSH,3205,119,3,2,5,60.0%,4m
3783,3,Burjuman,3205,88,3,4,7,42.9%,12m
3783,3,martiros,3205,0,1,0,1,100.0%,17m
3783,3,[DNKСFТ]BenDover,3205,0,1,0,1,100.0%,5m
3795,3,Billiboyed,3204,801,68,49,117,58.1%,13m
3795,3,Rick,3204,665,30,18,48,62.5%,19m
3795,3,axsc,3204,320,24,19,43,55.8%,6m
3795,3,NuclearK,3204,418,14,14,28,50.0%,11m
3795,3,[RYDA]aLx,3204,172,12,1,13,92.3%,19m
3795,3,Houden,3204,172,6,9,15,40.0%,25m
3795,3,AtarashīKami,3204,209,5,12,17,29.4%,26m
3795,3,Bethell,3204,154,4,7,11,36.4%,6m
3795,2,[PLOPI]BlackMamba,3204,95,2,0,2,100.0%,1h
3795,3,[сSсǃ]DjeKi,3204,0,1,0,1,100.0%,26m
3795,3,sctf,3204,94,1,1,2,50.0%,8m
3795,3,Joe,3204,0,0,2,2,0.0%,7m
3807,3,[ECU]ecuYaz,3203,489,46,30,76,60.5%,13m
3807,3,[SoulP]Sylvaris,3203,156,12,7,19,63.2%,5m
3807,3,Kryp,3203,253,11,2,13,84.6%,24m
3807,3,Rangleklods,3203,288,10,9,19,52.6%,9m
3807,3,[RеG]CiZzyX,3203,136,6,4,10,60.0%,6m
3807,3,[ZЕRGTV]бухой,3203,30,4,2,6,66.7%,25m
3807,3,Nissa,3203,0,1,0,1,100.0%,7m
3807,3,[iX]Tanuki,3203,0,0,3,3,0.0%,5m
3815,3,MrFluffy,3202,1148,67,57,124,54.0%,9m
3815,3,sweetZerg,3202,1298,52,56,108,48.1%,15m
3815,3,[Cannоn]Granate,3202,532,28,7,35,80.0%,11m
3815,3,Rhoynar,3202,538,21,16,37,56.8%,7m
3815,3,BuDa,3202,380,16,10,26,61.5%,11m
3815,3,shadowlight,3202,122,8,24,32,25.0%,25m
3815,3,SuperGoat,3202,60,6,3,9,66.7%,17m
3815,3,FatCat,3202,146,6,6,12,50.0%,25m
3815,3,[PiGPan]OmaMorkie,3202,182,6,8,14,42.9%,15m
3815,3,[PLA2N]KOT,3202,168,5,1,6,83.3%,25m
3815,3,[C1KK]Golgoth,3202,114,3,0,3,100.0%,18m
3815,3,SMA,3202,0,0,1,1,0.0%,5m
3827,3,[glhf20]Sok,3201,616,42,31,73,57.5%,10m
3827,3,[MAKinG]xTrIckKsHotx,3201,682,32,16,48,66.7%,6m
3827,3,[WOSCHD]Wizzo,3201,263,13,4,17,76.5%,4m
3827,3,Ougao,3201,276,9,18,27,33.3%,5m
3827,3,[XENIA]Beastmode,3201,154,7,1,8,87.5%,4m
3827,3,Drasard,3201,0,4,1,5,80.0%,1h
3827,3,Tigerdyret,3201,86,3,9,12,25.0%,7m
3827,1,ClockwiseLGI,3201,0,1,0,1,100.0%,9m
3827,3,Aimie,3201,0,0,1,1,0.0%,26m
3827,3,[ValidG]AmandaGoats,3201,0,0,2,2,0.0%,11m
3837,1,[SFight]Dova,3200,1052,50,29,79,63.3%,14m
3837,3,Iceman,3200,577,42,34,76,55.3%,3m
3837,3,[OwN3d]YERG,3200,590,30,15,45,66.7%,23m
3837,3,Fearnoevil,3200,205,14,14,28,50.0%,15m
3837,3,Pohren,3200,186,6,3,9,66.7%,23m
3837,3,[Sarmat]RisingSun,3200,62,3,5,8,37.5%,8m
3837,3,[InƑeS]Sergio,3200,0,2,5,7,28.6%,11m
3837,1,aTable,3200,0,1,2,3,33.3%,1h
3837,2,Diego,3200,0,0,1,1,0.0%,5m
3837,3,[pbss]LingKing,3200,0,0,2,2,0.0%,9m
3837,3,[NoFear]Lagreed,3200,0,0,2,2,0.0%,20m
3848,3,HyfoxT,3199,674,103,88,191,53.9%,11m
3848,3,eLFix,3199,1186,49,47,96,51.0%,5m
3848,3,RiskofRain,3199,420,19,15,34,55.9%,8m
3848,3,Pepero,3199,30,2,1,3,66.7%,16m
3852,3,[ÖMO]Jules,3198,97,3,3,6,50.0%,38m
3852,3,Demi,3198,0,2,4,6,33.3%,24m
3852,1,[Рачелы]Seesker,3198,0,1,0,1,100.0%,27m
3852,1,Crankor,3198,40,1,1,2,50.0%,18m
3856,3,[DМG]Hades,3197,537,22,24,46,47.8%,19m
3856,3,Immortal,3197,424,21,11,32,65.6%,15m
3856,3,Joh,3197,179,19,16,35,54.3%,15m
3856,3,StarLight,3197,409,13,22,35,37.1%,14m
3856,3,JustinBridou,3197,258,9,16,25,36.0%,11m
3856,3,Quad,3197,58,4,5,9,44.4%,18m
3856,1,rostoshka,3197,40,1,1,2,50.0%,12m
3863,2,[bbmGk]PoliteGirl,3196,795,46,64,110,41.8%,19m
3863,3,IamWeasel,3196,514,20,22,42,47.6%,18m
3863,3,Erratus,3196,265,15,17,32,46.9%,17m
3863,3,[ZgEgZ]Starius,3196,358,13,17,30,43.3%,23m
3863,1,SilverLeague,3196,309,10,3,13,76.9%,25m
3863,2,MufasaPrime,3196,118,3,1,4,75.0%,13m
3863,3,WIKINGER,3196,30,2,3,5,40.0%,10m
3863,2,[SqAUT]Pluu,3196,46,2,6,8,25.0%,1h
3871,1,MrDiarrhea,3195,1251,45,36,81,55.6%,6m
3871,3,[RDKa]Mith,3195,642,22,27,49,44.9%,24m
3871,3,Tibul,3195,254,9,15,24,37.5%,23m
3871,3,[AjA]Chaga,3195,240,8,16,24,33.3%,24m
3871,1,[УТочка]SeregaELCAMX,3195,96,2,0,2,100.0%,19m
3876,3,Silverthorn,3194,1614,160,152,312,51.3%,13m
3876,3,Napalman,3194,785,35,33,68,51.5%,26m
3876,3,[DUF]Bllizdy,3194,602,28,20,48,58.3%,8m
3876,3,coremore,3194,215,27,20,47,57.4%,5m
3876,3,[муррка]Кирито,3194,310,12,6,18,66.7%,25m
3876,3,MsWho,3194,274,10,10,20,50.0%,4m
3876,3,[XNTC]net,3194,256,7,17,24,29.2%,7m
3876,1,belly,3194,40,5,2,7,71.4%,18m
3876,2,[BaNLeB]Zergu,3194,0,0,1,1,0.0%,23m
3885,3,julien,3193,612,31,36,67,46.3%,13m
3885,1,Szaky,3193,473,16,7,23,69.6%,4m
3885,2,[iMv]Tappsi,3193,303,12,16,28,42.9%,20m
3885,1,NeoThird,3193,126,3,3,6,50.0%,27m
3885,1,[WCKYLN]Mootek,3193,95,1,1,2,50.0%,4m
3890,3,caineurs,3192,1296,256,247,503,50.9%,19m
3890,3,[Dobro]Kulinar,3192,1169,44,45,89,49.4%,12m
3890,3,[FxL]mmTOOshae,3192,691,29,28,57,50.9%,13m
3890,3,[Hrr]Misterio,3192,390,18,15,33,54.5%,23m
3890,3,VioletStorm,3192,0,5,0,5,100.0%,10m
3890,1,gaaaaaaaaaaa,3192,181,3,4,7,42.9%,24m
3890,2,[RеG]дядяСаня,3192,0,1,0,1,100.0%,1h
3890,1,[IceHus]LeGend,3192,42,1,1,2,50.0%,12m
3890,3,PSINA,3192,30,1,3,4,25.0%,24m
3890,3,Jonsey,3192,0,0,1,1,0.0%,1h
3890,1,[lnvoke]MicMaN,3192,0,0,1,1,0.0%,12m
3901,3,CaptainBebop,3191,1566,179,154,333,53.8%,23m
3901,3,[LaLeLu]ReXaR,3191,1564,151,156,307,49.2%,3m
3901,1,BigTing,3191,1087,43,27,70,61.4%,6m
3901,3,ouki,3191,630,33,17,50,66.0%,25m
3901,3,Serval,3191,330,16,6,22,72.7%,23m
3901,3,UGlennylee,3191,0,3,1,4,75.0%,33m
3901,3,Mojo,3191,52,2,5,7,28.6%,15m
3901,2,Burns,3191,0,1,0,1,100.0%,13m
3901,3,WhoRlyCares,3191,0,1,0,1,100.0%,28m
3901,3,[theDH]Hurut,3191,30,1,4,5,20.0%,14m
3911,3,[TNZs]Nadapolis,3190,94,1,2,3,33.3%,23m
3911,1,HUGO,3190,0,0,1,1,0.0%,18m
3911,1,[FLU5H]ArchonToilet,3190,0,0,1,1,0.0%,26m
3914,3,KeyHey,3189,170,24,15,39,61.5%,23m
3914,2,TimeSplit,3189,163,5,2,7,71.4%,25m
3914,1,BlueCake,3189,0,1,0,1,100.0%,15m
3914,3,[httman]Hattman,3189,96,1,2,3,33.3%,11m
3918,3,Dreamshock,3188,952,82,74,156,52.6%,12m
3918,3,Yago,3188,178,6,8,14,42.9%,7m
3918,3,[RusTM]vintik,3188,0,4,1,5,80.0%,13m
3918,1,wwwSEOtaxi,3188,127,3,4,7,42.9%,12m
3918,3,Kalter,3188,62,2,8,10,20.0%,17m
3918,1,Killoheal,3188,0,1,0,1,100.0%,11m
3924,3,idontcare,3187,125,6,3,9,66.7%,19m
3924,3,[KerriS]Sireals,3187,60,2,6,8,25.0%,11m
3924,1,[ØN]KIIIIN,3187,42,1,1,2,50.0%,18m
3924,1,[TAW]Sulkosaurus,3187,42,1,4,5,20.0%,7m
3928,3,Lantar,3186,333,11,20,31,35.5%,3m
3928,2,fufu,3186,166,7,2,9,77.8%,19m
3928,3,Finwer,3186,184,7,7,14,50.0%,9m
3928,2,NiceHat,3186,38,2,0,2,100.0%,9m
3928,3,Roger,3186,94,2,1,3,66.7%,4m
3933,3,wooka,3185,1391,79,75,154,51.3%,23m
3933,3,[PiGPan]Koritska,3185,1203,49,47,96,51.0%,9m
3933,3,Volkodav,3185,341,15,17,32,46.9%,24m
3933,3,Jurre,3185,356,13,23,36,36.1%,13m
3933,1,Vamis,3185,172,3,6,9,33.3%,28m
3933,3,StewieGrifin,3185,62,2,6,8,25.0%,8m
3933,3,HEKPOMAHT,3185,0,1,0,1,100.0%,12m
3940,3,Ghordann,3184,886,140,118,258,54.3%,28m
3940,3,Qwan,3184,966,41,37,78,52.6%,17m
3940,3,Stratulat,3184,223,8,5,13,61.5%,8m
3940,3,Miraxle,3184,150,7,10,17,41.2%,14m
3940,3,[xPr]Jah,3184,169,5,9,14,35.7%,11m
3940,1,king,3184,116,3,0,3,100.0%,19m
3940,3,Arctus,3184,138,3,3,6,50.0%,26m
3940,3,EllieFingers,3184,88,2,1,3,66.7%,25m
3940,1,bObmc,3184,0,1,0,1,100.0%,9m
3949,3,[RAMP]pIrIpIToK,3183,359,32,24,56,57.1%,5m
3949,2,[БУБУБ]mmrGendarme,3183,348,15,7,22,68.2%,23m
3949,3,SofTndrTouch,3183,295,14,7,21,66.7%,9m
3949,3,Fogs,3183,315,13,16,29,44.8%,19m
3949,3,Cash,3183,287,10,7,17,58.8%,24m
3949,3,SkyWaterLine,3183,0,4,1,5,80.0%,35m
3949,1,[LOGS]Dodo,3183,44,2,0,2,100.0%,7m
3949,3,MCT,3183,97,2,4,6,33.3%,23m
3949,3,[NumbAc]Puigs,3183,0,0,1,1,0.0%,34m
3958,3,Somi,3182,703,29,27,56,51.8%,13m
3958,1,abbou,3182,299,13,6,19,68.4%,7m
3958,2,[Exp]WhiteGuard,3182,240,7,7,14,50.0%,3m
3958,2,JeReX,3182,0,1,0,1,100.0%,1h
3958,3,Toulk,3182,0,0,4,4,0.0%,5m
3963,3,VincentVega,3181,1620,268,268,536,50.0%,26m
3963,3,CarrotJam,3181,482,17,15,32,53.1%,26m
3963,3,krakanhakan,3181,142,8,4,12,66.7%,3m
3963,3,[3DE]evoLG,3181,202,8,9,17,47.1%,28m
3963,1,[DG5500]Maxiste,3181,163,7,3,10,70.0%,13m
3963,1,bogiman,3181,0,1,0,1,100.0%,7m
3963,1,Jax,3181,0,1,0,1,100.0%,5m
3970,3,Dendunadan,3180,1585,233,235,468,49.8%,27m
3970,3,TheGoldenRat,3180,62,3,6,9,33.3%,5m
3970,1,noone,3180,144,3,6,9,33.3%,28m
3970,3,carlosvzas,3180,0,2,4,6,33.3%,28m
3970,3,harddrill,3180,0,1,1,2,50.0%,7m
3970,2,sve,3180,0,1,1,2,50.0%,14m
3970,1,zumBerg,3180,48,1,2,3,33.3%,1h
3970,1,[ExTr1m]Lite,3180,0,0,1,1,0.0%,10m
3978,3,red,3179,720,39,48,87,44.8%,4m
3978,1,[ncotic]Paradox,3179,73,1,3,4,25.0%,6m
3978,3,Caabi,3179,0,0,2,2,0.0%,26m
3981,3,TmG,3178,961,43,28,71,60.6%,23m
3981,3,StarKing,3178,821,31,25,56,55.4%,5m
3981,1,[DKLE]Stoei,3178,259,7,4,11,63.6%,33m
3981,3,[flyrev]flyrev,3178,186,6,4,10,60.0%,6m
3981,3,KLOYN,3178,178,5,4,9,55.6%,26m
3981,3,Viktor,3178,97,4,2,6,66.7%,29m
3981,1,[HZeS]Vasay,3178,0,1,0,1,100.0%,15m
3981,1,[CrBees]Fighter,3178,0,0,1,1,0.0%,13m
3981,1,[SRC]GunDone,3178,0,0,1,1,0.0%,11m
3981,3,ZERO,3178,0,0,1,1,0.0%,15m
3991,3,[ВSL]Exalted,3177,901,35,33,68,51.5%,18m
3991,3,[1ndica]ZerO,3177,262,19,13,32,59.4%,4m
3991,3,Priti,3177,358,12,11,23,52.2%,12m
3991,3,Benas,3177,228,8,10,18,44.4%,12m
3991,1,BroJeRaT,3177,0,4,1,5,80.0%,15m
3991,1,ƁѺҲǃŅĢҁạƞƞѻƞ,3177,0,0,1,1,0.0%,28m
3991,1,WawaCool,3177,0,0,5,5,0.0%,12m
3998,1,Starrrr,3176,522,37,24,61,60.7%,13m
3998,3,[PenOZ]Neristelrooy,3176,308,11,9,20,55.0%,23m
3998,3,Yann,3176,277,10,7,17,58.8%,25m
3998,3,llllllllllll,3176,60,3,8,11,27.3%,11m
3998,1,Shagrim,3176,0,1,4,5,20.0%,28m
3998,3,Valo,3176,38,1,5,6,16.7%,8m
4004,3,gob,3175,1025,48,47,95,50.5%,26m
4004,3,[LVXE]AƻC,3175,542,23,21,44,52.3%,11m
4004,3,Tekkers,3175,376,23,23,46,50.0%,18m
4004,3,Nemesis,3175,274,10,7,17,58.8%,5m
4004,3,Виктор,3175,170,8,6,14,57.1%,23m
4004,3,[SaMz]ElGringo,3175,233,6,8,14,42.9%,7m
4004,1,[z666z]MakeMyWeapon,3175,159,4,2,6,66.7%,6m
4004,3,Snapshot,3175,62,3,6,9,33.3%,16m
4012,3,nightmare,3174,1276,79,83,162,48.8%,12m
4012,1,[ToZea]combattant,3174,870,34,27,61,55.7%,7m
4012,1,[SkeSS]JensDemens,3174,235,8,5,13,61.5%,1h
4012,3,[994]Bananashell,3174,246,8,6,14,57.1%,23m
4012,3,Lulo,3174,192,8,8,16,50.0%,13m
4017,3,Mxl,3173,617,191,178,369,51.8%,8m
4017,3,Fruityloop,3173,1468,174,163,337,51.6%,23m
4017,3,Razingbal,3173,1338,50,54,104,48.1%,16m
4017,1,Пупок,3173,203,9,1,10,90.0%,12m
4017,3,Aiko,3173,0,4,1,5,80.0%,38m
4017,1,REY,3173,82,3,3,6,50.0%,25m
4017,1,[DWTeam]darclord,3173,42,2,0,2,100.0%,6m
4017,1,kingping,3173,42,1,2,3,33.3%,13m
4017,1,Deicide,3173,0,0,1,1,0.0%,11m
4017,1,kesstarwars,3173,0,0,1,1,0.0%,23m
4027,3,[GADA]Maniac,3172,1555,109,110,219,49.8%,14m
4028,3,[EnTar0]Aiur,3171,934,35,32,67,52.2%,25m
4028,3,unicorn,3171,235,7,7,14,50.0%,9m
4028,3,Wojtaskiler,3171,0,4,1,5,80.0%,23m
4028,3,[Batmen]JayIITheP,3171,96,1,1,2,50.0%,9m
4028,1,Sleeky,3171,0,1,4,5,20.0%,24m
4028,1,Kilo,3171,0,1,4,5,20.0%,5m
4028,3,Raynor,3171,0,0,3,3,0.0%,5m
4028,3,[FIow]Smeerlap,3171,0,0,5,5,0.0%,13m
4036,2,PinkGuy,3170,184,5,2,7,71.4%,20m
4036,3,Skipper,3170,0,4,1,5,80.0%,1h
4036,1,redline,3170,122,3,5,8,37.5%,27m
4036,1,[ValidG]snusmumriken,3170,82,2,1,3,66.7%,8m
4036,1,Wasiu,3170,0,2,3,5,40.0%,13m
4036,3,[ŋǤ]HorMi,3170,0,1,1,2,50.0%,7m
4036,1,[SproL]Sheik,3170,0,0,2,2,0.0%,5m
4043,3,[5QI]Ninotter,3169,309,15,24,39,38.5%,15m
4043,1,Vudoo,3169,74,6,3,9,66.7%,8m
4043,3,LEIT,3169,150,6,13,19,31.6%,12m
4043,3,[74leg]dima,3169,42,5,2,7,71.4%,1h
4043,1,[NevSur]nurFischer,3169,40,2,0,2,100.0%,27m
4043,3,Orwell,3169,0,2,3,5,40.0%,1h
4043,1,Rugrud,3169,0,1,0,1,100.0%,18m
4043,3,[meowz]JbossSenpai,3169,0,0,1,1,0.0%,31m
4051,1,BIgBean,3168,1327,55,40,95,57.9%,4m
4051,3,Joo,3168,255,8,9,17,47.1%,26m
4053,3,[C37224]GranPedrito,3167,456,14,17,31,45.2%,13m
4053,1,Nkl,3167,294,9,6,15,60.0%,15m
4053,3,naikEn,3167,119,2,3,5,40.0%,22m
4053,1,Dektral,3167,0,1,0,1,100.0%,11m
4053,1,LifeForAyur,3167,0,1,0,1,100.0%,8m
4058,1,[Ne1]GeNome,3166,640,26,13,39,66.7%,15m
4058,3,[aAa]Togi,3166,674,24,27,51,47.1%,14m
4058,2,KoScHmArChE,3166,143,4,1,5,80.0%,13m
4058,1,BIO,3166,0,0,2,2,0.0%,5m
4062,1,Хрусткостей,3165,987,36,25,61,59.0%,8m
4062,3,Quest,3165,296,8,16,24,33.3%,4m
4062,1,Lunarius,3165,124,6,8,14,42.9%,15m
4062,2,IsifLiferu,3165,184,5,6,11,45.5%,25m
4062,3,fictional,3165,0,1,5,6,16.7%,26m
4062,3,[hängA]omg,3165,0,0,1,1,0.0%,11m
4068,3,[CFX]Rovado,3164,704,44,49,93,47.3%,20m
4068,3,Sankari,3164,758,26,29,55,47.3%,8m
4068,3,Tritanis,3164,134,8,8,16,50.0%,27m
4068,3,Cyz,3164,97,2,0,2,100.0%,21m
4068,2,[Hаsu]OZZY,3164,36,1,6,7,14.3%,9m
4073,3,Vince,3163,1600,135,135,270,50.0%,12m
4073,3,Wrogashz,3163,314,11,13,24,45.8%,4m
4073,1,AspenCat,3163,192,6,6,12,50.0%,17m
4073,1,[SlayAP]Iceri,3163,0,4,1,5,80.0%,8m
4073,1,[RyS]CHuRRaSKo,3163,115,1,3,4,25.0%,28m
4073,1,calamiTy,3163,0,0,1,1,0.0%,27m
4073,3,[eMpRC]zodiaK,3163,0,0,4,4,0.0%,9m
4080,3,Citru,3162,523,52,39,91,57.1%,26m
4080,1,omgvi,3162,310,9,6,15,60.0%,13m
4080,3,Flens,3162,285,9,9,18,50.0%,8m
4080,3,wozuiji,3162,258,9,9,18,50.0%,5m
4080,1,AuntEdith,3162,198,6,7,13,46.2%,4m
4080,3,HumaJay,3162,169,4,7,11,36.4%,14m
4086,1,Mäkus,3161,1779,181,172,353,51.3%,12m
4086,1,Edge,3161,589,31,16,47,66.0%,10m
4086,1,LobStrokk,3161,736,24,20,44,54.5%,6m
4086,3,[VARP]PUSTOTA,3161,240,9,8,17,52.9%,13m
4086,1,DarkShiado,3161,156,5,3,8,62.5%,13m
4086,1,piry,3161,202,4,4,8,50.0%,4m
4092,3,[DSY]kalast,3160,1531,175,181,356,49.2%,15m
4092,3,Wharfedale,3160,1518,158,164,322,49.1%,8m
4092,3,Arcji,3160,683,74,63,137,54.0%,26m
4092,1,Mentat,3160,776,30,18,48,62.5%,18m
4092,1,DrDlPSHlT,3160,485,20,12,32,62.5%,11m
4092,3,Kiarna,3160,244,7,7,14,50.0%,7m
4092,1,Deispater,3160,0,5,0,5,100.0%,12m
4092,1,Nartek,3160,0,4,1,5,80.0%,8m
4092,1,[Moisty]Ilyen,3160,105,4,2,6,66.7%,7m
4092,3,GrandMal,3160,94,4,3,7,57.1%,25m
4092,1,SENJUxMIGUEL,3160,38,2,4,6,33.3%,7m
4092,1,Aqvialeblik,3160,0,1,0,1,100.0%,11m
4092,3,Pumba,3160,0,1,1,2,50.0%,1h
4092,1,VilkaVilka,3160,0,1,2,3,33.3%,3m
4092,1,dorald,3160,0,0,1,1,0.0%,5m
4107,3,TheVK,3159,1535,205,192,397,51.6%,9m
4107,3,Optus,3159,890,98,100,198,49.5%,9m
4107,1,BanglaDezu,3159,1795,82,71,153,53.6%,6m
4107,1,SWARM,3159,214,6,4,10,60.0%,23m
4107,1,Stas,3159,0,1,1,2,50.0%,18m
4107,1,River,3159,40,1,1,2,50.0%,6m
4113,3,ElectroHouse,3158,1240,92,91,183,50.3%,9m
4113,3,goaulD,3158,606,42,37,79,53.2%,19m
4113,3,Liste,3158,575,28,17,45,62.2%,26m
4113,3,[PLA2N]ILYA,3158,468,18,19,37,48.6%,3m
4113,3,Gullesnuffs,3158,344,13,17,30,43.3%,16m
4113,3,TWiace,3158,292,8,21,29,27.6%,8m
4113,1,[1FU2]Shinobi,3158,182,5,5,10,50.0%,19m
4113,1,Kwis,3158,82,2,2,4,50.0%,8m
4113,1,[KAKOO]Predator,3158,0,0,1,1,0.0%,15m
4113,1,[Hrr]MrsPresident,3158,0,0,2,2,0.0%,18m
4123,3,[696]BrainWashed,3157,1556,477,474,951,50.2%,23m
4123,3,surrur,3157,1302,74,79,153,48.4%,10m
4123,1,theconker,3157,390,14,12,26,53.8%,8m
4123,2,KFanatic,3157,95,3,3,6,50.0%,1h
4123,3,NeverCheese,3157,62,3,8,11,27.3%,3m
4123,1,[TlTTIE]FatalSausage,3157,42,2,1,3,66.7%,28m
4123,3,[ЛаЛ]Tigger,3157,0,2,3,5,40.0%,19m
4123,1,LittleAksMax,3157,0,1,0,1,100.0%,15m
4123,3,Awkward,3157,0,1,4,5,20.0%,7m
4132,3,eXtReMeFiReX,3156,1437,103,107,210,49.0%,8m
4132,1,[Ape]korpuskel,3156,900,29,26,55,52.7%,11m
4132,3,[NOKOFF]OldYogurt,3156,223,11,9,20,55.0%,8m
4132,1,ololo,3156,339,11,9,20,55.0%,18m
4132,3,Enigma,3156,290,10,8,18,55.6%,19m
4132,1,KroN,3156,34,2,0,2,100.0%,5m
4132,3,[shoot]BlacKEaglE,3156,0,1,3,4,25.0%,35m
4132,1,Холди,3156,0,0,1,1,0.0%,12m
4140,1,[SGSA]Fierce,3155,224,7,4,11,63.6%,27m
4140,3,[IPARTY]RageKit,3155,98,4,6,10,40.0%,15m
4140,3,[MRCW]himsir,3155,0,0,4,4,0.0%,5m
4143,3,Jaguar,3154,1236,189,184,373,50.7%,24m
4143,3,Serensha,3154,1510,185,188,373,49.6%,17m
4143,3,[PhAFr]Papuche,3154,1035,86,94,180,47.8%,7m
4143,2,[FakJU]Lesiak,3154,176,9,14,23,39.1%,14m
4143,2,ufo,3154,46,5,3,8,62.5%,1h
4143,2,skileet,3154,0,1,0,1,100.0%,30m
4143,3,Mylo,3154,30,1,4,5,20.0%,18m
4143,2,[DruMas]Steve,3154,0,0,2,2,0.0%,6m
4151,3,ZenFire,3153,1392,63,60,123,51.2%,26m
4151,3,McWigg,3153,744,27,24,51,52.9%,18m
4151,1,[N1TDA]HarryCover,3153,668,19,20,39,48.7%,7m
4151,1,KazioWichura,3153,310,15,11,26,57.7%,3m
4151,1,High,3153,320,10,7,17,58.8%,37m
4151,1,krabator,3153,112,4,1,5,80.0%,14m
4151,1,Gramps,3153,0,0,1,1,0.0%,14m
4158,3,ZveR,3152,958,36,36,72,50.0%,18m
4158,3,suprBixlov,3152,0,4,0,4,100.0%,1h
4158,1,[1A2857]ErZil,3152,124,4,3,7,57.1%,26m
4158,3,SAN,3152,30,1,6,7,14.3%,12m
4162,3,Rimool,3151,1379,219,226,445,49.2%,19m
4162,3,Pahvinkeitin,3151,873,37,37,74,50.0%,20m
4162,1,zeta,3151,486,24,9,33,72.7%,10m
4162,3,Aleks,3151,375,14,12,26,53.8%,9m
4162,1,pommes,3151,0,1,1,2,50.0%,19m
4162,2,Nonshlen,3151,0,0,3,3,0.0%,11m
4168,3,[GODSSS]Fuzileiro,3150,1440,73,60,133,54.9%,7m
4168,1,[1ndica]deweb,3150,890,31,26,57,54.4%,28m
4168,1,Gaston,3150,729,23,18,41,56.1%,28m
4168,3,Killed,3150,411,17,20,37,45.9%,17m
4168,1,plusmore,3150,0,3,2,5,60.0%,19m
4168,1,Akiraa,3150,0,1,0,1,100.0%,13m
4168,1,[UWDIE]Khimi,3150,40,1,1,2,50.0%,19m
4168,2,FatBasterd,3150,36,1,3,4,25.0%,20m
4176,3,lundanto,3149,810,32,29,61,52.5%,26m
4176,3,[BMA]Fossi,3149,765,27,32,59,45.8%,5m
4176,3,anbecha,3149,144,8,10,18,44.4%,19m
4176,1,[CRL]ShaFaX,3149,120,3,4,7,42.9%,23m
4176,3,[MLFCG]fran,3149,0,2,0,2,100.0%,1h
4176,1,[PGaS]PinkyGoose,3149,0,0,1,1,0.0%,15m
4176,1,entroadun,3149,0,0,1,1,0.0%,5m
4176,1,[Minc]mixos,3149,0,0,2,2,0.0%,28m
4184,3,Magikarp,3148,327,12,15,27,44.4%,25m
4184,3,Rcvtheninja,3148,308,11,16,27,40.7%,16m
4184,3,Torque,3148,0,4,2,6,66.7%,8m
4184,1,Funkydrummer,3148,124,4,3,7,57.1%,12m
4184,3,[tTDDs]Slayer,3148,97,2,1,3,66.7%,28m
4184,1,[UoM]ALLCAPS,3148,0,0,1,1,0.0%,6m
4190,1,[CBot]RoadToElune,3147,413,12,7,19,63.2%,26m
4190,3,[ncotic]StarRain,3147,288,10,8,18,55.6%,5m
4190,1,[GUGE]AjjKillJuu,3147,194,5,8,13,38.5%,9m
4190,3,Kahlos,3147,165,4,3,7,57.1%,14m
4190,3,[TDCHK]Croustigrou,3147,94,4,11,15,26.7%,24m
4190,3,Tracer,3147,97,2,1,3,66.7%,35m
4190,2,[Hommus]Soto,3147,40,1,8,9,11.1%,13m
4190,3,Iowa,3147,0,0,1,1,0.0%,17m
4198,1,[HGame]Ghazgh,3146,881,50,14,64,78.1%,24m
4198,1,Leckatall,3146,808,32,23,55,58.2%,10m
4198,1,Traviktox,3146,437,16,14,30,53.3%,11m
4198,3,MeLkor,3146,150,5,9,14,35.7%,19m
4198,3,[HẹṚø]ỈṣḣøẊ,3146,108,2,3,5,40.0%,14m
4198,1,StimRine,3146,0,2,3,5,40.0%,12m
4198,1,criticalDMG,3146,0,1,0,1,100.0%,13m
4198,1,Crollspell,3146,0,0,1,1,0.0%,11m
4198,1,Dennis,3146,0,0,1,1,0.0%,1h
4198,1,FLORIN,3146,0,0,1,1,0.0%,26m
4208,3,Oekel,3145,1200,50,57,107,46.7%,19m
4208,3,NoName,3145,1005,45,39,84,53.6%,10m
4208,1,Hmfya,3145,417,14,24,38,36.8%,23m
4208,1,[zukaCo]MaMu,3145,200,6,3,9,66.7%,8m
4208,3,wintermute,3145,70,6,6,12,50.0%,11m
4208,1,GGZiiStreams,3145,0,3,2,5,60.0%,8m
4208,1,YellowDragon,3145,80,2,2,4,50.0%,7m
4215,3,Tormentor,3144,317,28,33,61,45.9%,23m
4215,1,ISOLATE,3144,419,12,13,25,48.0%,5m
4215,3,mindCrtl,3144,134,11,7,18,61.1%,4m
4215,2,[BZL]TheProfessor,3144,165,7,4,11,63.6%,20m
4215,2,Luka,3144,96,5,3,8,62.5%,11m
4215,1,failzor,3144,90,4,2,6,66.7%,18m
4215,1,Just,3144,118,3,2,5,60.0%,26m
4215,3,FireSheep,3144,0,3,2,5,60.0%,38m
4215,1,ZoniDruid,3144,0,1,1,2,50.0%,3m
4215,1,TheDexter,3144,40,1,2,3,33.3%,28m
4215,1,[Zactar]Nubbling,3144,0,0,1,1,0.0%,18m
4226,3,Miggy,3143,1247,426,435,861,49.5%,26m
4226,1,[HLFLMN]balka,3143,714,28,16,44,63.6%,7m
4226,1,[KIU]PsYchoPatH,3143,481,19,12,31,61.3%,5m
4226,3,[tH]Takushin,3143,452,16,22,38,42.1%,26m
4226,3,mvtonyss,3143,354,15,12,27,55.6%,16m
4226,3,duckspeaker,3143,0,2,8,10,20.0%,5m
4232,1,MoeSzyslak,3142,1728,172,142,314,54.8%,24m
4232,1,[300IQ]AverDroz,3142,744,39,7,46,84.8%,19m
4232,1,Metalsous,3142,214,6,4,10,60.0%,18m
4232,3,[T2T]Kruku,3142,0,5,1,6,83.3%,24m
4232,1,[GaMbH]xSuneT,3142,0,0,1,1,0.0%,26m
4232,3,llllllllllll,3142,0,0,1,1,0.0%,1h
4232,1,megapapa,3142,0,0,2,2,0.0%,11m
4232,3,Neytral,3142,0,0,2,2,0.0%,11m
4232,3,CanIWatch,3142,0,0,6,6,0.0%,3m
4241,3,Валантис,3141,1561,252,257,509,49.5%,5m
4241,3,Mush,3141,436,87,91,178,48.9%,5m
4241,3,[Dobro]PontyPilat,3141,749,32,30,62,51.6%,15m
4241,1,nikihaku,3141,633,22,22,44,50.0%,18m
4241,2,CblP,3141,186,6,5,11,54.5%,11m
4241,2,MarcoPolo,3141,97,4,3,7,57.1%,37m
4241,1,Fronziman,3141,0,0,2,2,0.0%,11m
4241,1,Bluecloud,3141,0,0,3,3,0.0%,10m
4249,3,MrSepp,3140,446,15,17,32,46.9%,10m
4249,3,Arcsinger,3140,165,8,7,15,53.3%,27m
4249,1,[LaLooz]HotBlooded,3140,141,7,2,9,77.8%,33m
4249,1,CemRaynors,3140,154,4,6,10,40.0%,6m
4249,3,SuperGau,3140,171,4,7,11,36.4%,27m
4249,1,[PrimeC]AKpRo,3140,89,3,3,6,50.0%,5m
4249,2,TomBombadil,3140,95,2,1,3,66.7%,26m
4249,1,Sooriuken,3140,0,0,1,1,0.0%,7m
4249,1,[NuRe]Ragnar,3140,0,0,2,2,0.0%,11m
4258,1,MikeOxLong,3139,1102,104,109,213,48.8%,18m
4258,3,Колдунопрыг,3139,1296,62,64,126,49.2%,7m
4258,1,mruniversum,3139,46,2,0,2,100.0%,1h
4258,2,madeon,3139,0,2,6,8,25.0%,5m
4258,1,tosha,3139,0,0,1,1,0.0%,25m
4263,3,BRO,3138,1571,138,143,281,49.1%,19m
4263,3,MrWednesday,3138,1308,119,123,242,49.2%,18m
4263,1,Lapido,3138,1136,64,55,119,53.8%,18m
4263,3,Kladenx,3138,1117,39,56,95,41.1%,5m
4263,3,protos,3138,787,31,29,60,51.7%,17m
4263,1,Keepoeu,3138,368,19,11,30,63.3%,5m
4263,1,[y0ur]attention,3138,418,15,10,25,60.0%,9m
4263,3,NoTimE,3138,0,4,1,5,80.0%,30m
4263,3,robsky,3138,0,4,2,6,66.7%,23m
4263,3,Chimp,3138,0,2,2,4,50.0%,9m
4263,1,[viz]Lost,3138,0,1,0,1,100.0%,13m
4263,1,IlIIlIlI,3138,0,1,0,1,100.0%,13m
4263,1,[EAU]ArKu,3138,0,0,1,1,0.0%,15m
4276,3,snowfalling,3137,1158,198,186,384,51.6%,7m
4276,3,[Dragen]STERBANS,3137,1398,78,71,149,52.3%,5m
4276,3,IIIIIIIIIIII,3137,648,30,19,49,61.2%,10m
4276,1,[FURTIF]maxonebad,3137,512,26,21,47,55.3%,27m
4276,3,Oleewere,3137,293,12,10,22,54.5%,15m
4276,1,[Овощи]Easy,3137,277,8,7,15,53.3%,14m
4276,3,chartzono,3137,0,2,3,5,40.0%,12m
4276,1,TeOulb,3137,42,1,2,3,33.3%,13m
4284,3,BReal,3136,1596,121,118,239,50.6%,19m
4284,3,[TAW]equiNoxSC,3136,1576,93,88,181,51.4%,25m
4284,1,CaptBigBoss,3136,913,83,77,160,51.9%,28m
4284,1,Mestah,3136,78,7,2,9,77.8%,26m
4284,3,[3ØØ]SkiNNyOne,3136,97,4,2,6,66.7%,28m
4284,1,Romchester,3136,88,2,0,2,100.0%,27m
4284,1,[Amun]FaQ,3136,0,0,1,1,0.0%,6m
4291,3,MrBaneling,3135,400,15,17,32,46.9%,5m
4291,2,[BjwA]Thorogmar,3135,140,2,8,10,20.0%,1h
4291,3,[HotB]Jadam,3135,0,1,0,1,100.0%,1h
4291,1,[PLA2N]Uroboros,3135,40,1,2,3,33.3%,26m
4291,1,[DaAm]NielsErGud,3135,0,0,1,1,0.0%,4m
4296,3,[EArena]superlancelo,3134,1235,194,173,367,52.9%,4m
4296,1,Brainshack,3134,666,21,18,39,53.8%,6m
4296,1,gewt,3134,274,12,6,18,66.7%,25m
4296,3,Fenrack,3134,286,10,18,28,35.7%,7m
4296,2,MMA,3134,252,8,8,16,50.0%,3m
4296,1,UnlimitedTD,3134,213,8,8,16,50.0%,1h
4296,3,[SOECES]BridoKiLLeR,3134,219,7,7,14,50.0%,15m
4296,1,[O2Ds]Fufel,3134,224,6,1,7,85.7%,8m
4296,1,Lambda,3134,0,3,2,5,60.0%,10m
4296,1,Илья,3134,0,0,1,1,0.0%,13m
4306,3,Wijsman,3133,1535,128,120,248,51.6%,26m
4306,3,donkeyshot,3133,741,86,81,167,51.5%,19m
4306,1,[AMCque]WasGeht,3133,328,10,8,18,55.6%,11m
4306,3,БроМутиДобро,3133,306,10,12,22,45.5%,8m
4306,1,Essar,3133,0,4,0,4,100.0%,1h
4306,1,XaPyZaTnik,3133,140,4,4,8,50.0%,18m
4312,3,kim,3132,500,33,25,58,56.9%,15m
4312,1,ueapfel,3132,476,14,12,26,53.8%,18m
4312,1,Belazhur,3132,295,11,2,13,84.6%,10m
4312,3,[SpCI]sylwekPL,3132,330,10,13,23,43.5%,19m
4312,1,Megalomania,3132,162,5,5,10,50.0%,9m
4312,1,Bordiur,3132,0,2,3,5,40.0%,26m
4312,3,BooN,3132,94,2,4,6,33.3%,18m
4312,2,[mMcH]MeleeKeeper,3132,0,1,1,2,50.0%,28m
4320,3,[BnRY]Clemooooooou,3131,465,55,61,116,47.4%,25m
4320,1,turboworm,3131,685,28,24,52,53.8%,8m
4320,3,Boogle,3131,229,7,8,15,46.7%,4m
4320,3,[TKRs]houser,3131,230,7,10,17,41.2%,7m
4320,3,Minox,3131,121,5,2,7,71.4%,1h
4320,1,Linjo,3131,0,1,0,1,100.0%,9m
4320,1,MicroMarine,3131,40,1,1,2,50.0%,18m
4327,1,Huberknecht,3130,824,26,27,53,49.1%,9m
4327,1,WhiteFangmsi,3130,501,19,13,32,59.4%,10m
4327,1,Donkrawallo,3130,587,18,19,37,48.6%,7m
4327,3,[IRTG]Futorius,3130,313,14,13,27,51.9%,11m
4327,2,Ago,3130,164,7,4,11,63.6%,32m
4327,1,Someone,3130,162,5,3,8,62.5%,27m
4327,1,NoScared,3130,103,3,4,7,42.9%,27m
4327,1,kev,3130,0,0,1,1,0.0%,29m
4327,1,TommyLeeGun,3130,0,0,4,4,0.0%,26m
4336,1,[Abdul]Vedro,3129,329,61,51,112,54.5%,16m
4336,1,NeoSecond,3129,444,33,17,50,66.0%,3m
4336,3,FuriousDuck,3129,580,23,21,44,52.3%,12m
4336,3,[инж]RaDy,3129,422,14,16,30,46.7%,5m
4336,3,[CAZO]CmAd,3129,93,13,13,26,50.0%,24m
4336,2,[LMBD]LaZMariNE,3129,232,9,4,13,69.2%,36m
4336,3,Testi,3129,152,5,13,18,27.8%,23m
4336,1,[Bigold]IIIIIIIIIIII,3129,0,3,2,5,60.0%,12m
4336,3,MMM,3129,0,0,1,1,0.0%,17m
4336,1,[prxspr]Moriz,3129,0,0,2,2,0.0%,11m
4346,3,Redfild,3128,536,43,49,92,46.7%,5m
4346,1,Jamalam,3128,304,15,7,22,68.2%,19m
4346,1,Jileanu,3128,194,5,4,9,55.6%,11m
4346,3,[Geetoo]clems,3128,162,5,4,9,55.6%,3m
4346,1,CiumaRosie,3128,0,4,1,5,80.0%,37m
4346,3,[ReBrG]LaChenille,3128,60,3,6,9,33.3%,5m
4346,2,Mojo,3128,0,1,0,1,100.0%,11m
4353,3,Slama,3127,1117,189,180,369,51.2%,19m
4353,1,SleKKiT,3127,789,26,22,48,54.2%,18m
4353,1,JackRackham,3127,189,8,5,13,61.5%,37m
4353,3,LukeSc,3127,113,5,4,9,55.6%,11m
4353,1,GHOST,3127,40,2,0,2,100.0%,26m
4353,1,[APs]Fitz,3127,0,1,0,1,100.0%,6m
4353,3,smellyshoes,3127,0,1,3,4,25.0%,26m
4360,1,BeliboOn,3126,1057,41,33,74,55.4%,14m
4360,3,demich,3126,120,5,2,7,71.4%,9m
4362,3,Mitropanos,3125,1556,332,332,664,50.0%,7m
4362,3,[ĦĦ]chocdaddy,3125,1582,218,217,435,50.1%,18m
4362,3,BondageChair,3125,1168,88,73,161,54.7%,8m
4362,3,[EAU]LouisDCLXVI,3125,415,13,20,33,39.4%,25m
4362,3,SnowWhite,3125,140,6,6,12,50.0%,25m
4362,3,Hools,3125,182,6,13,19,31.6%,13m
4362,3,GaBBaMoNsTeR,3125,0,4,2,6,66.7%,11m
4362,3,[KTZ]Hakunamatada,3125,30,4,6,10,40.0%,18m
4362,1,Alexey,3125,0,1,0,1,100.0%,28m
4362,1,llllllllllll,3125,0,1,0,1,100.0%,6m
4362,1,[C0RE]Crawftie,3125,44,1,2,3,33.3%,26m
4362,1,limak,3125,0,0,1,1,0.0%,10m
4374,3,speezil,3124,1075,152,151,303,50.2%,8m
4374,3,OxyGeNiuM,3124,1313,107,103,210,51.0%,4m
4374,3,FedosFF,3124,627,22,26,48,45.8%,5m
4374,1,[voff]spacey,3124,231,7,10,17,41.2%,8m
4374,1,Qwan,3124,192,5,3,8,62.5%,1h
4374,3,[N5F]MiNoChiz,3124,148,4,6,10,40.0%,15m
4374,3,Holgerrr,3124,0,2,4,6,33.3%,8m
4374,1,Basipooh,3124,0,0,1,1,0.0%,4m
4374,3,MrGambit,3124,0,0,3,3,0.0%,24m
4383,3,[Mattis]SameBoy,3123,1325,148,142,290,51.0%,25m
4383,3,gal,3123,703,61,62,123,49.6%,19m
4383,3,HEASAGER,3123,750,30,31,61,49.2%,7m
4383,3,[2H]Aleksandr,3123,698,30,32,62,48.4%,3m
4383,1,[Hаsu]StrateG,3123,374,10,9,19,52.6%,14m
4383,1,[aHsK]AreS,3123,218,9,8,17,52.9%,10m
4383,3,matrixneo,3123,97,2,0,2,100.0%,1h
4383,1,[UAONE]shadowstorm,3123,36,2,2,4,50.0%,9m
4383,1,Schlitz,3123,0,0,1,1,0.0%,7m
4383,1,[CIGC]MrSmi,3123,0,0,4,4,0.0%,12m
4393,1,[AiRǂ]SaveAz,3122,485,20,12,32,62.5%,13m
4393,1,msckson,3122,394,11,12,23,47.8%,6m
4393,3,McBook,3122,122,4,12,16,25.0%,7m
4393,1,[Stunt]Theios,3122,76,3,0,3,100.0%,19m
4393,1,[DILIT]MaXiNe,3122,0,3,2,5,60.0%,8m
4393,1,[MNGGTV]MaNNaGGia,3122,104,3,8,11,27.3%,28m
4393,1,Ворюга,3122,0,1,0,1,100.0%,6m
4393,1,[L3F]aguibast,3122,0,1,1,2,50.0%,12m
4393,1,Mono,3122,40,1,3,4,25.0%,14m
4393,1,IIIIIIIIIIII,3122,0,0,1,1,0.0%,25m
4393,1,Kharnis,3122,0,0,1,1,0.0%,6m
4404,3,[XiSPoo]Lockdown,3121,459,24,39,63,38.1%,19m
4404,2,Annatar,3121,180,4,3,7,57.1%,30m
4404,1,[XYX21]tatamumu,3121,40,2,1,3,66.7%,7m
4404,1,General,3121,118,2,2,4,50.0%,13m
4404,1,Niram,3121,0,1,0,1,100.0%,5m
4409,1,kidpaddle,3120,1340,67,57,124,54.0%,14m
4409,3,llllllll,3120,1109,66,64,130,50.8%,9m
4409,1,Mamon,3120,801,27,22,49,55.1%,12m
4409,1,balabala,3120,573,24,15,39,61.5%,18m
4409,3,[TBMF]Lukas,3120,97,2,2,4,50.0%,20m
4409,1,[lloll]DadSkil,3120,0,1,3,4,25.0%,28m
4415,1,inoxia,3119,1744,90,83,173,52.0%,28m
4415,3,RedAlert,3119,1499,78,74,152,51.3%,13m
4415,1,Bullfinch,3119,546,39,26,65,60.0%,23m
4415,1,[ToXin]SternJumper,3119,530,19,10,29,65.5%,12m
4415,1,Freud,3119,672,19,23,42,45.2%,25m
4415,1,[4qq]BitchBotBoi,3119,355,13,6,19,68.4%,6m
4415,3,LEX,3119,177,4,8,12,33.3%,25m
4415,1,[Fridge]Freezer,3119,0,0,1,1,0.0%,15m
4423,3,smiley,3118,1100,51,46,97,52.6%,5m
4423,1,[SuperF]princeyolo,3118,982,36,34,70,51.4%,15m
4423,1,[BCM]Iceman,3118,266,13,9,22,59.1%,3m
4423,2,karen,3118,238,10,11,21,47.6%,4m
4423,1,alexfould,3118,316,9,8,17,52.9%,19m
4423,3,moid,3118,200,7,13,20,35.0%,18m
4423,1,[N40G]Kâleem,3118,160,6,5,11,54.5%,8m
4423,1,llllllllllll,3118,106,3,3,6,50.0%,10m
4423,1,[XSpace]FireDrake,3118,0,1,1,2,50.0%,23m
4423,1,WoahPasssan,3118,40,1,1,2,50.0%,11m
4423,1,GGGLHF,3118,0,1,1,2,50.0%,11m
4423,1,Voodoochilli,3118,36,1,2,3,33.3%,5m
4423,1,[RªW]iwilldiezerg,3118,38,1,4,5,20.0%,4m
4423,1,docmukx,3118,0,0,1,1,0.0%,18m
4437,3,Eraston,3117,1076,103,94,197,52.3%,7m
4437,1,leberkasPepe,3117,1764,66,62,128,51.6%,7m
4437,3,Akwol,3117,407,25,35,60,41.7%,26m
4437,1,Xpomocoma,3117,625,21,20,41,51.2%,7m
4437,3,[Biu]Noir,3117,40,4,7,11,36.4%,11m
4437,1,[SCiE]TheNewTos,3117,84,3,2,5,60.0%,15m
4437,1,[VBNTM]darkness,3117,0,1,0,1,100.0%,14m
4444,3,Taonos,3116,1481,179,177,356,50.3%,24m
4444,3,СИЛ,3116,1534,157,151,308,51.0%,8m
4444,2,[R1917]JohnBrown,3116,1505,105,122,227,46.3%,11m
4444,3,SummerWind,3116,264,11,8,19,57.9%,10m
4444,3,[UnderP]Romano,3116,30,5,4,9,55.6%,8m
4444,3,ProffDR,3116,141,4,6,10,40.0%,14m
4444,1,Aruin,3116,0,3,2,5,60.0%,8m
4444,1,Joystick,3116,40,1,4,5,20.0%,26m
4444,1,[SpasG]Tūmatauenga,3116,0,0,1,1,0.0%,9m
4444,1,[3KFC]Fliewatüüt,3116,0,0,1,1,0.0%,16m
4454,3,ANDROCK,3115,1044,147,144,291,50.5%,28m
4454,3,[Pago]George,3115,576,21,23,44,47.7%,4m
4454,1,[Nððþs]MataramaSugo,3115,598,18,19,37,48.6%,10m
4454,3,Funny,3115,329,12,12,24,50.0%,5m
4454,1,simpson,3115,298,8,10,18,44.4%,3m
4454,1,kepKolbaskin,3115,121,6,5,11,54.5%,13m
4454,1,Gregus,3115,94,1,3,4,25.0%,15m
4454,1,changhav,3115,0,0,1,1,0.0%,7m
4454,1,[Plysch]Krakowich,3115,0,0,2,2,0.0%,18m
4463,3,DrFunke,3114,799,150,146,296,50.7%,11m
4463,3,cedlabalbis,3114,856,30,33,63,47.6%,26m
4463,1,[ЕПРСТ]JuGGler,3114,548,16,16,32,50.0%,16m
4463,1,[KhSo]Pierre,3114,189,6,3,9,66.7%,10m
4463,3,Jeral,3114,200,6,8,14,42.9%,18m
4463,3,[N1NJ4Z]MrKey,3114,90,4,5,9,44.4%,11m
4463,2,Dustry,3114,149,3,8,11,27.3%,15m
4463,2,JThunders,3114,95,2,2,4,50.0%,6m
4463,1,bykovalex,3114,119,2,6,8,25.0%,8m
4472,1,AldarsKose,3113,1484,56,48,104,53.8%,27m
4472,3,BPog,3113,438,16,17,33,48.5%,26m
4472,1,DalekSec,3113,229,11,7,18,61.1%,18m
4472,1,[NiN]NiNjadO,3113,200,5,10,15,33.3%,27m
4472,3,Sirxi,3113,0,3,3,6,50.0%,1h
4472,1,[youlol]Keturioz,3113,38,2,0,2,100.0%,18m
4472,1,[Dogmin]bohong,3113,126,2,2,4,50.0%,10m
4472,3,NiCeViBeZZ,3113,0,1,0,1,100.0%,38m
4480,3,Sarminator,3112,302,20,21,41,48.8%,19m
4480,1,pchel,3112,418,16,14,30,53.3%,6m
4480,1,Patton,3112,196,11,0,11,100.0%,24m
4480,3,shad,3112,236,10,10,20,50.0%,9m
4480,1,Professor,3112,202,9,10,19,47.4%,14m
4480,1,whonoobtheme,3112,0,1,0,1,100.0%,12m
4480,1,Czakol,3112,0,0,2,2,0.0%,7m
4487,1,[FlaMer]FaiER,3111,1160,70,63,133,52.6%,15m
4487,3,Viktor,3111,839,33,31,64,51.6%,26m
4487,1,[NiN]Nimbus,3111,781,29,16,45,64.4%,26m
4487,1,[f0rtt5]BusæÑorose,3111,361,14,4,18,77.8%,26m
4487,3,[Ирбис]Цербер,3111,264,10,1,11,90.9%,12m
4487,1,Bald,3111,224,9,6,15,60.0%,18m
4487,3,[DeTime]Alfakvark,3111,186,8,14,22,36.4%,9m
4487,1,[NMSQ]kakemonosc,3111,112,3,2,5,60.0%,28m
4487,1,FlyyTime,3111,118,3,4,7,42.9%,15m
4487,1,[WIch]PiOeuvre,3111,179,3,5,8,37.5%,23m
4497,1,[Bruvas]maxi,3110,984,115,109,224,51.3%,24m
4497,3,Bonjour,3110,623,90,82,172,52.3%,9m
4497,1,[LSPs]Mochuelo,3110,396,11,11,22,50.0%,12m
4497,1,[UF2AC]Rick,3110,294,9,6,15,60.0%,24m
4497,1,[Blacer]Deminz,3110,185,6,10,16,37.5%,19m
4497,1,Clozer,3110,152,4,5,9,44.4%,14m
4497,1,PSYCHIATRIST,3110,0,3,2,5,60.0%,8m
4504,1,Delf,3109,647,30,33,63,47.6%,5m
4504,1,donFabio,3109,307,9,14,23,39.1%,5m
4504,1,[LA63]Inkognito,3109,124,2,1,3,66.7%,15m
4504,3,Grixx,3109,95,1,3,4,25.0%,14m
4504,1,llllllllllll,3109,0,1,5,6,16.7%,8m
4504,1,[PIML]McLane,3109,0,0,2,2,0.0%,14m
4510,1,zkfkzk,3108,356,17,9,26,65.4%,11m
4510,1,NoMoreSkyTos,3108,78,2,7,9,22.2%,23m
4510,3,Mopstorm,3108,62,2,8,10,20.0%,4m
4510,1,Torrison,3108,40,1,1,2,50.0%,19m
4510,1,IlIlIlIllIIl,3108,88,1,1,2,50.0%,8m
4515,3,Supicat,3107,1542,139,141,280,49.6%,11m
4515,3,Fil,3107,1498,99,105,204,48.5%,23m
4515,3,Jager,3107,766,63,55,118,53.4%,17m
4515,1,Borgrdr,3107,714,27,25,52,51.9%,11m
4515,1,hunter,3107,291,10,7,17,58.8%,25m
4515,3,[AciNoN]Brutalisk,3107,0,5,1,6,83.3%,25m
4515,1,Skroma,3107,42,1,4,5,20.0%,23m
4515,1,CattleBruisR,3107,0,0,1,1,0.0%,8m
4523,1,Selephodron,3106,849,34,26,60,56.7%,12m
4523,3,Smithski,3106,512,22,21,43,51.2%,11m
4523,3,MaskedGauss,3106,589,22,25,47,46.8%,8m
4523,1,[U19]Next,3106,342,14,11,25,56.0%,6m
4523,3,IMakeLings,3106,243,7,9,16,43.8%,11m
4523,1,[WaPR]Mathelm,3106,139,6,3,9,66.7%,8m
4523,3,Balthazor,3106,138,6,6,12,50.0%,27m
4523,1,azanta,3106,196,5,9,14,35.7%,12m
4523,1,Siomi,3106,88,2,0,2,100.0%,5m
4523,1,CanadianZerg,3106,0,1,0,1,100.0%,14m
4523,1,[SAAALZ]Omega,3106,0,0,1,1,0.0%,18m
4534,3,POL,3105,1418,109,85,194,56.2%,7m
4534,3,AgentSmith,3105,1036,44,34,78,56.4%,23m
4534,1,[ZGlot]Mirrorer,3105,251,8,4,12,66.7%,18m
4534,1,[TBPZDA]Borodality,3105,268,7,7,14,50.0%,7m
4534,3,[Peru20]CatteRose,3105,245,7,12,19,36.8%,14m
4534,1,[eXit]Console,3105,0,0,1,1,0.0%,4m
4534,1,Capablanca,3105,0,0,2,2,0.0%,15m
4541,3,Biloute,3104,1471,141,138,279,50.5%,5m
4541,1,NLBTW,3104,992,44,37,81,54.3%,26m
4541,3,blackfox,3104,503,23,21,44,52.3%,12m
4541,3,Doppelganger,3104,242,17,14,31,54.8%,23m
4541,3,Flaku,3104,251,14,9,23,60.9%,26m
4541,3,[VB]Sauce,3104,180,9,8,17,52.9%,5m
4541,2,StuckPlat,3104,232,8,5,13,61.5%,1h
4541,1,[Prisma]Mauldaeschle,3104,308,8,11,19,42.1%,15m
4541,3,Skyler,3104,121,5,1,6,83.3%,1h
4541,1,[Витязи]Hopeless,3104,165,5,3,8,62.5%,19m
4541,3,NoobOK,3104,121,2,1,3,66.7%,1h
4541,1,BlackFlame,3104,0,2,3,5,40.0%,1h
4553,3,Drake,3103,890,91,61,152,59.9%,13m
4553,3,Simon,3103,344,32,29,61,52.5%,19m
4553,1,[SHNOZ]Roscoe,3103,603,29,19,48,60.4%,24m
4553,1,PipandPop,3103,575,20,16,36,55.6%,28m
4553,1,Barada,3103,40,1,1,2,50.0%,11m
4558,3,Shentoza,3102,1152,44,52,96,45.8%,18m
4558,3,[ǂMWRǂ]GoOn,3102,332,12,17,29,41.4%,23m
4558,3,defaultUser,3102,317,11,10,21,52.4%,23m
4558,2,[AjKA]Swarci,3102,141,6,4,10,60.0%,28m
4558,3,BioFreak,3102,159,6,6,12,50.0%,18m
4558,2,[L4DYS]MissTake,3102,190,5,6,11,45.5%,26m
4558,1,Jeff,3102,107,2,1,3,66.7%,12m
4558,1,Amalirr,3102,0,0,3,3,0.0%,27m
4566,1,AsyncAwait,3101,301,32,33,65,49.2%,7m
4566,3,[BFG3K]Arek,3101,386,13,19,32,40.6%,15m
4566,1,reloco,3101,258,8,9,17,47.1%,14m
4566,3,FancyCandies,3101,206,7,8,15,46.7%,7m
4566,1,Androide,3101,78,3,2,5,60.0%,11m
4566,3,[ABRX]twistednose,3101,96,1,1,2,50.0%,25m
4572,1,lusifer,3100,1577,70,59,129,54.3%,15m
4572,1,ENRICOLETTA,3100,550,16,33,49,32.7%,18m
4572,1,[MgSt]Kampfkarotte,3100,229,5,5,10,50.0%,13m
4572,1,SMOKE,3100,0,1,0,1,100.0%,15m
4572,1,Whsprs,3100,0,1,2,3,33.3%,10m
4577,1,[xoxxoo]llllllllllll,3099,623,27,17,44,61.4%,5m
4577,1,bengbengezpz,3099,131,5,0,5,100.0%,13m
4579,3,Thelon,3098,731,102,105,207,49.3%,17m
4579,1,[GjJc]Cyhm,3098,1477,76,80,156,48.7%,18m
4579,1,[ЭЩКЕРЕ]TsCoX,3098,0,0,1,1,0.0%,23m
4582,1,[PLA2N]barcode,3097,450,17,12,29,58.6%,19m
4582,1,SIKN,3097,234,10,6,16,62.5%,18m
4582,2,Ryper,3097,190,8,4,12,66.7%,29m
4582,1,QUETZALCOATL,3097,114,8,4,12,66.7%,9m
4582,1,Saucisse,3097,229,8,9,17,47.1%,10m
4582,1,EvilivE,3097,0,4,1,5,80.0%,1h
4582,3,Drown,3097,0,3,4,7,42.9%,18m
4582,1,[Furya]Ziorko,3097,123,2,1,3,66.7%,14m
4582,1,[RеG]LeYsi,3097,126,2,1,3,66.7%,28m
4582,1,[DmD]CARBON,3097,0,0,1,1,0.0%,10m
4592,3,Lucki,3096,1336,119,116,235,50.6%,14m
4592,1,[AiRǂ]Bonsai,3096,738,32,20,52,61.5%,23m
4592,1,Jonny,3096,212,6,2,8,75.0%,23m
4592,3,[cun7]GreatWhiteSi,3096,121,4,3,7,57.1%,29m
4592,1,fefe,3096,70,4,5,9,44.4%,25m
4592,1,ToxicGod,3096,0,1,0,1,100.0%,5m
4592,1,[ULTX]Moritz,3096,0,1,0,1,100.0%,13m
4599,1,[RJD]mauZKilla,3095,284,14,8,22,63.6%,18m
4599,3,[IN]Vanyali,3095,286,10,16,26,38.5%,26m
4599,1,[PdP]Burgoff,3095,48,4,2,6,66.7%,37m
4599,1,Isithran,3095,88,1,1,2,50.0%,10m
4599,1,Krisstad,3095,38,1,4,5,20.0%,23m
4604,3,KimJungUn,3094,1040,45,47,92,48.9%,27m
4604,3,sooibot,3094,131,6,4,10,60.0%,6m
4604,3,[H0C]softmax,3094,42,5,3,8,62.5%,20m
4604,1,JustinBieber,3094,0,1,0,1,100.0%,18m
4604,1,LazySnail,3094,0,0,2,2,0.0%,26m
4609,1,[HZeS]LordTaldarim,3093,375,14,5,19,73.7%,14m
4609,1,Makc,3093,458,13,13,26,50.0%,23m
4609,1,Calibra,3093,228,10,8,18,55.6%,11m
4609,1,[пепега]suchAKrab,3093,329,10,11,21,47.6%,15m
4609,1,[NONAMЕ]Glacier,3093,183,8,1,9,88.9%,6m
4609,1,[SkyB]Asuna,3093,280,8,9,17,47.1%,12m
4609,1,WTF,3093,255,7,9,16,43.8%,23m
4609,3,BroLuk,3093,42,2,0,2,100.0%,1h
4609,1,[Negoid]YPeRiET,3093,0,0,1,1,0.0%,12m
4618,3,[BgScum]Mifkata,3092,298,93,97,190,48.9%,25m
4618,1,[GaMToX]TaKMashido,3092,221,5,5,10,50.0%,13m
4618,1,RilizeKraken,3092,0,0,1,1,0.0%,25m
4621,1,Beren,3091,510,19,14,33,57.6%,28m
4621,1,joman,3091,191,16,17,33,48.5%,10m
4621,1,Virtue,3091,391,14,15,29,48.3%,25m
4621,1,Nattura,3091,118,4,0,4,100.0%,25m
4621,3,IIIIIIIIIIII,3091,30,2,9,11,18.2%,6m
4621,3,TrusyEnota,3091,0,1,0,1,100.0%,11m
4621,1,battleking,3091,0,1,0,1,100.0%,18m
4621,1,help,3091,0,1,1,2,50.0%,10m
4621,1,NKI,3091,0,0,1,1,0.0%,18m
4621,1,[Аven]ShamanKing,3091,0,0,2,2,0.0%,11m
4631,1,MoJo,3090,0,0,4,4,0.0%,8m
4631,3,[bTsC]tHeTeaTcheR,3090,0,0,6,6,0.0%,20m
4633,3,[CRULLC]DonnaLee,3089,1504,73,63,136,53.7%,10m
4633,3,[Mozart]DirTyMoOnKeY,3089,1302,55,52,107,51.4%,6m
4633,1,Mulehammer,3089,574,23,16,39,59.0%,11m
4633,1,PinkPony,3089,444,20,22,42,47.6%,25m
4633,1,[GdAT]Legendk,3089,332,16,4,20,80.0%,18m
4633,2,netus,3089,211,6,8,14,42.9%,33m
4633,1,SunLightKing,3089,227,5,4,9,55.6%,6m
4633,1,dreaded,3089,150,4,5,9,44.4%,6m
4633,1,Perian,3089,127,2,1,3,66.7%,13m
4633,1,SmarkS,3089,40,1,4,5,20.0%,14m
4633,1,[МŴŚ]Zerokara,3089,0,0,1,1,0.0%,10m
4644,3,[NTuna]MasterBait,3088,1398,109,110,219,49.8%,4m
4644,1,InSidE,3088,463,22,9,31,71.0%,5m
4644,1,CannonCoward,3088,212,9,7,16,56.2%,35m
4644,3,Zergnase,3088,129,5,3,8,62.5%,7m
4644,1,Odysseus,3088,0,0,1,1,0.0%,10m
4644,1,Yoda,3088,0,0,6,6,0.0%,12m
4650,1,andreychorny,3087,1166,137,118,255,53.7%,25m
4650,3,MegaDeth,3087,1329,135,141,276,48.9%,25m
4650,1,hollabrrack,3087,753,32,29,61,52.5%,18m
4650,3,llllllllllll,3087,540,20,24,44,45.5%,27m
4650,1,Sspray,3087,530,18,15,33,54.5%,5m
4650,1,Furiosa,3087,279,13,7,20,65.0%,8m
4650,3,Indianadrone,3087,290,13,8,21,61.9%,10m
4650,3,[NGJ]OverNice,3087,359,13,15,28,46.4%,26m
4650,1,Logan,3087,97,2,4,6,33.3%,36m
4650,1,Dodo,3087,0,1,1,2,50.0%,13m
4660,3,Sky,3086,1570,147,155,302,48.7%,5m
4660,1,Flux,3086,1183,101,101,202,50.0%,18m
4660,3,Kirtruhro,3086,940,34,38,72,47.2%,4m
4660,1,[ZaG]Brez,3086,428,16,15,31,51.6%,18m
4660,2,Arktorius,3086,136,7,3,10,70.0%,20m
4660,1,[3raza]Cazagames,3086,142,3,3,6,50.0%,4m
4660,1,Qwerty,3086,40,2,1,3,66.7%,7m
4660,1,Swalow,3086,0,0,2,2,0.0%,18m
4668,1,SweetRamekin,3085,835,24,28,52,46.2%,18m
4668,1,LehtineN,3085,434,19,4,23,82.6%,13m
4668,1,[EmpKas]JLiiii,3085,152,4,6,10,40.0%,13m
4668,1,Kulkoth,3085,106,2,1,3,66.7%,26m
4668,1,[Hrr]Ethanolos,3085,68,2,3,5,40.0%,4m
4668,3,MoTTa,3085,0,1,0,1,100.0%,18m
4668,3,Nibelunge,3085,0,1,0,1,100.0%,19m
4668,2,ArDUinO,3085,0,0,1,1,0.0%,11m
4676,1,Chris,3084,563,24,15,39,61.5%,25m
4676,3,NotByun,3084,171,3,3,6,50.0%,25m
4676,1,[CTaS]CrazyDave,3084,114,3,4,7,42.9%,28m
4676,3,Lenichi,3084,0,1,2,3,33.3%,9m
4676,1,gautgoth,3084,40,1,3,4,25.0%,26m
4681,3,NewPlayer,3083,1639,139,135,274,50.7%,4m
4681,3,nOta,3083,1489,59,73,132,44.7%,5m
4681,1,MCC,3083,458,27,17,44,61.4%,18m
4681,1,Piketchup,3083,619,27,20,47,57.4%,8m
4681,1,Mistgun,3083,804,26,30,56,46.4%,8m
4681,1,[ÆVT]Naesle,3083,499,17,16,33,51.5%,12m
4681,1,Mazel,3083,358,11,9,20,55.0%,26m
4681,3,WanniX,3083,240,8,6,14,57.1%,14m
4681,1,[GSLs]BioS,3083,108,4,4,8,50.0%,11m
4681,1,[Cybro]bogar,3083,167,3,5,8,37.5%,8m
4681,1,Xean,3083,0,0,3,3,0.0%,11m
4692,1,Nymoon,3082,1249,82,77,159,51.6%,28m
4692,1,popo,3082,1381,68,63,131,51.9%,14m
4692,1,MarineChien,3082,575,41,34,75,54.7%,11m
4692,1,DonPorolon,3082,616,18,19,37,48.6%,18m
4692,1,Bertalanffy,3082,333,13,12,25,52.0%,19m
4692,1,Gravix,3082,345,10,9,19,52.6%,10m
4692,3,MagiC,3082,190,6,14,20,30.0%,27m
4692,1,Licht,3082,187,5,2,7,71.4%,9m
4692,1,JanStar,3082,0,0,1,1,0.0%,13m
4701,3,MrFlay,3081,1554,253,251,504,50.2%,18m
4701,1,[MRSM]szabolcs,3081,1598,62,55,117,53.0%,8m
4701,1,gurcore,3081,1140,43,41,84,51.2%,13m
4701,1,[HBGSJR]Taruviel,3081,339,9,11,20,45.0%,19m
4701,1,ArkKnight,3081,116,3,6,9,33.3%,5m
4701,1,oOC,3081,0,1,5,6,16.7%,23m
4701,3,[Toshko]Amadeaus,3081,0,0,1,1,0.0%,20m
4701,1,Firler,3081,0,0,1,1,0.0%,18m
4701,1,Зелень,3081,0,0,1,1,0.0%,23m
4710,3,[CuWoǂ]OmegA,3080,672,26,23,49,53.1%,5m
4710,1,Piopiotte,3080,517,18,13,31,58.1%,18m
4710,1,Gencho,3080,298,8,13,21,38.1%,18m
4710,3,romchikk,3080,144,4,5,9,44.4%,28m
4710,3,john,3080,95,2,0,2,100.0%,17m
4715,1,LeDude,3079,626,19,23,42,45.2%,23m
4715,1,Krawalle,3079,362,14,9,23,60.9%,14m
4715,1,[FRMSTR]Tingles,3079,432,13,15,28,46.4%,23m
4715,1,TessaBliss,3079,215,11,5,16,68.8%,14m
4715,3,akmyt,3079,274,10,23,33,30.3%,8m
4715,1,[Донный]GRIF,3079,191,7,4,11,63.6%,19m
4715,1,[moo]axsk,3079,148,5,8,13,38.5%,8m
4715,1,kecar,3079,0,0,1,1,0.0%,4m
4723,3,Alvaro,3078,1255,139,141,280,49.6%,8m
4723,1,Cloudy,3078,554,64,52,116,55.2%,26m
4723,1,Tkitwa,3078,493,20,11,31,64.5%,25m
4723,1,[LofE]Asakura,3078,409,15,5,20,75.0%,18m
4723,1,[BodyO]Zlatan,3078,152,8,4,12,66.7%,12m
4723,1,frankimahri,3078,167,5,5,10,50.0%,15m
4723,1,Skagg,3078,0,4,2,6,66.7%,8m
4723,1,[WBO]Epekto,3078,122,3,1,4,75.0%,8m
4723,1,glhf,3078,74,2,5,7,28.6%,13m
4723,1,[D0N3]ERGoN,3078,0,1,2,3,33.3%,8m
4723,1,[EGS]NOSIBEAR,3078,0,1,3,4,25.0%,28m
4734,1,Loli,3077,264,12,6,18,66.7%,6m
4734,2,[NoPC]SpaceHulk,3077,116,7,3,10,70.0%,14m
4734,1,Фортнайтер,3077,361,7,24,31,22.6%,28m
4734,1,[КАМ]Mukyma,3077,182,5,3,8,62.5%,6m
4734,1,ЯМашина,3077,143,4,3,7,57.1%,35m
4739,1,DougSluggins,3076,695,21,20,41,51.2%,25m
4739,1,[Nosda]Kiwi,3076,302,10,6,16,62.5%,14m
4739,1,[PRlSM]Demphie,3076,118,4,4,8,50.0%,11m
4739,1,[WoodHd]GhostSR,3076,0,0,1,1,0.0%,14m
4743,1,ЛУКАВЫЙ,3075,665,48,38,86,55.8%,8m
4743,3,[SPAINs]Jomasteur,3075,899,42,42,84,50.0%,7m
4743,1,Atreyd,3075,402,13,10,23,56.5%,18m
4743,1,Kantoraketti,3075,216,6,5,11,54.5%,27m
4743,1,[DeBoys]Hackrolf,3075,162,5,7,12,41.7%,18m
4743,1,[NBV]Loagen,3075,0,4,1,5,80.0%,18m
4743,1,[ReBrG]LeMolusque,3075,44,1,3,4,25.0%,6m
4743,1,NINININI,3075,0,0,1,1,0.0%,9m
4751,3,Reiswind,3074,722,28,31,59,47.5%,26m
4751,1,[eli]MrSnibbles,3074,233,10,9,19,52.6%,25m
4751,1,reckoner,3074,188,6,6,12,50.0%,13m
4751,1,[PLANgg]Venator,3074,106,2,1,3,66.7%,28m
4751,3,[SLW]NainPro,3074,0,1,0,1,100.0%,23m
4751,3,MontereyJack,3074,0,1,0,1,100.0%,17m
4751,1,CroEtnA,3074,0,0,1,1,0.0%,8m
4758,3,ROA,3073,1560,207,192,399,51.9%,14m
4758,1,Skrippel,3073,520,24,18,42,57.1%,26m
4758,1,[HYÐRA]faery,3073,148,18,12,30,60.0%,15m
4758,1,Plikis,3073,207,9,5,14,64.3%,25m
4758,2,Knybiz,3073,204,6,4,10,60.0%,36m
4758,1,[planB]asVa,3073,178,4,3,7,57.1%,18m
4758,1,BBKR,3073,143,4,3,7,57.1%,1h
4758,1,[Lowko]Dinouu,3073,122,3,9,12,25.0%,10m
4758,1,[Glor]Caesar,3073,36,1,2,3,33.3%,5m
4758,1,Sololo,3073,0,0,1,1,0.0%,8m
4758,3,SirOk,3073,0,0,2,2,0.0%,10m
4769,3,[washed]UPhasBEEN,3072,1181,137,122,259,52.9%,12m
4769,1,[Colic]Kronik,3072,743,37,32,69,53.6%,12m
4769,3,CptSpyro,3072,642,26,25,51,51.0%,18m
4769,1,Terry,3072,392,15,11,26,57.7%,12m
4769,1,[FR1]AstRaxx,3072,104,5,3,8,62.5%,13m
4769,1,Tbone,3072,173,4,3,7,57.1%,4m
4769,1,Ubyvatel,3072,100,3,4,7,42.9%,8m
4769,1,[GRF]Laxen,3072,0,0,2,2,0.0%,9m
4777,3,zacke,3071,818,96,81,177,54.2%,8m
4777,1,Protox,3071,717,27,24,51,52.9%,5m
4777,1,Sonic,3071,561,16,16,32,50.0%,27m
4777,1,[202pop]kip,3071,240,10,7,17,58.8%,25m
4777,1,[eXGE]cabris,3071,332,9,13,22,40.9%,14m
4777,2,brax,3071,139,6,4,10,60.0%,1h
4783,3,[Rlyeh]Cthulhoo,3070,1604,165,173,338,48.8%,26m
4783,1,[FMmkay]telkamp,3070,1186,40,34,74,54.1%,4m
4783,1,Magic,3070,269,19,13,32,59.4%,10m
4783,1,RegentCID,3070,389,18,16,34,52.9%,16m
4783,1,Arti,3070,406,15,12,27,55.6%,4m
4783,1,Urzai,3070,389,13,9,22,59.1%,4m
4783,1,FoX,3070,320,13,11,24,54.2%,18m
4783,3,FatalT,3070,237,11,9,20,55.0%,13m
4783,1,Synthetic,3070,0,1,0,1,100.0%,4m
4783,1,glhf,3070,0,1,0,1,100.0%,5m
4793,1,Grib,3069,1721,150,142,292,51.4%,4m
4793,3,AveSwarmWLM,3069,1458,77,72,149,51.7%,4m
4793,1,Brownsugar,3069,477,19,17,36,52.8%,4m
4793,1,nofan,3069,640,19,24,43,44.2%,15m
4793,1,[MMNSK]Neodymus,3069,256,7,10,17,41.2%,4m
4793,1,Linuel,3069,152,5,5,10,50.0%,5m
4793,1,[Bloro]Lestaron,3069,190,5,6,11,45.5%,23m
4793,1,[KoyBee]McButtFace,3069,123,2,2,4,50.0%,8m
4793,1,Holzken,3069,0,1,0,1,100.0%,1h
4793,3,Torello,3069,30,1,12,13,7.7%,10m
4793,1,LarsSloth,3069,0,0,1,1,0.0%,6m
4804,1,Wingent,3068,516,21,15,36,58.3%,11m
4804,1,[ASNII]Cohanes,3068,76,3,2,5,60.0%,10m
4804,1,[AOoG]Cayser,3068,78,3,6,9,33.3%,11m
4804,1,[ENGNS]lHero,3068,0,0,1,1,0.0%,11m
4804,1,[БУБУБ]Hellbatking,3068,0,0,4,4,0.0%,18m
4809,1,MeSzeS,3067,1496,442,431,873,50.6%,5m
4809,3,NazGuL,3067,1218,108,101,209,51.7%,26m
4809,1,Fab,3067,724,25,24,49,51.0%,18m
4809,1,ShadoW,3067,265,7,6,13,53.8%,25m
4809,2,ZergAteYou,3067,0,4,1,5,80.0%,11m
4809,2,BLUNT,3067,84,3,6,9,33.3%,1h
4809,1,Vynes,3067,40,1,3,4,25.0%,25m
4816,1,Ayatsuru,3066,1337,149,150,299,49.8%,14m
4816,1,[DéKá]Chose,3066,360,12,14,26,46.2%,5m
4816,2,HacheDeuxOs,3066,208,8,6,14,57.1%,35m
4816,1,Juhku,3066,0,1,1,2,50.0%,13m
4816,1,PUTEN,3066,30,1,2,3,33.3%,14m
4821,3,Oss,3065,1147,56,59,115,48.7%,14m
4821,1,Beast,3065,983,45,30,75,60.0%,25m
4821,1,Sardukar,3065,512,19,15,34,55.9%,6m
4821,1,ucantouchme,3065,209,8,6,14,57.1%,18m
4821,3,abadeer,3065,48,5,14,19,26.3%,15m
4821,1,[BRSKR]Sedator,3065,154,3,7,10,30.0%,10m
4821,1,NemavrSoc,3065,105,2,2,4,50.0%,8m
4828,1,[TaKeUL]Hirnspalter,3064,898,89,77,166,53.6%,5m
4828,1,clemmrogg,3064,903,40,27,67,59.7%,12m
4828,1,Gubbins,3064,307,9,9,18,50.0%,26m
4831,1,Apocalypsis,3063,1059,82,94,176,46.6%,25m
4831,1,[Rofler]purpose,3063,1624,80,75,155,51.6%,25m
4831,1,[mCb]KAMIONČINA,3063,1031,49,30,79,62.0%,27m
4831,3,ToRRiTi,3063,384,13,18,31,41.9%,10m
4831,1,SunSinK,3063,30,5,3,8,62.5%,18m
4831,2,baraka,3063,32,1,2,3,33.3%,14m
4837,3,IIIIIIIIIIII,3062,1187,76,81,157,48.4%,4m
4837,1,Gillesberg,3062,1463,52,47,99,52.5%,6m
4837,2,[SlllH]SuperSilver,3062,592,27,17,44,61.4%,12m
4837,1,happytissue,3062,486,25,21,46,54.3%,10m
4837,1,[PIKNU]CaptainSlow,3062,721,21,21,42,50.0%,14m
4837,1,MeHTaJLUCT,3062,492,20,15,35,57.1%,14m
4837,1,Batman,3062,280,8,6,14,57.1%,26m
4837,2,barcode,3062,154,5,3,8,62.5%,25m
4845,1,[ENV]Ausashi,3061,834,30,26,56,53.6%,11m
4845,1,Iados,3061,322,15,7,22,68.2%,5m
4845,3,Celenos,3061,332,10,26,36,27.8%,13m
4845,2,Yazon,3061,210,7,7,14,50.0%,25m
4845,2,[CocSac]вкусняшка,3061,152,6,4,10,60.0%,28m
4845,2,[LaPLS]Python,3061,96,3,2,5,60.0%,15m
4845,2,[Ultrа]aquarius,3061,0,1,0,1,100.0%,20m
4845,1,[GGB]McFlyhigh,3061,0,1,4,5,20.0%,1h
4845,2,llllllllllll,3061,0,0,1,1,0.0%,15m
4854,1,lllllll,3060,645,27,18,45,60.0%,27m
4854,1,BoomerBTI,3060,403,15,13,28,53.6%,18m
4854,2,Lou,3060,0,3,2,5,60.0%,4m
4854,1,marc,3060,40,2,2,4,50.0%,25m
4854,1,ArtBrut,3060,0,0,2,2,0.0%,12m
4859,1,[POTAT]pwet,3059,1576,86,80,166,51.8%,8m
4859,1,[ERQ]MawlinsTV,3059,1565,80,79,159,50.3%,13m
4859,3,Feelgood,3059,944,40,40,80,50.0%,4m
4859,1,Jahh,3059,649,28,19,47,59.6%,23m
4859,1,Izzard,3059,334,16,16,32,50.0%,15m
4859,1,Sadenki,3059,221,8,8,16,50.0%,23m
4859,1,DrewShow,3059,155,5,3,8,62.5%,18m
4859,2,zergislife,3059,0,3,2,5,60.0%,8m
4859,2,[PLA2N]ReversOnFire,3059,0,1,0,1,100.0%,19m
4868,3,randomize,3058,1571,137,135,272,50.4%,7m
4868,1,[InvKit]SFoxner,3058,1148,43,39,82,52.4%,18m
4868,1,YouTubTigron,3058,364,11,11,22,50.0%,5m
4868,2,KuDoS,3058,154,5,3,8,62.5%,27m
4868,2,[Chonky]Effigy,3058,0,3,2,5,60.0%,15m
4868,2,[J4E]Golddragon,3058,94,2,0,2,100.0%,15m
4868,3,Franklin,3058,0,1,0,1,100.0%,1h
4875,2,oDiNe,3057,446,17,10,27,63.0%,26m
4875,1,[LawB]NitramVHive,3057,162,14,8,22,63.6%,15m
4875,3,DrunkBender,3057,369,13,16,29,44.8%,7m
4875,2,WarpigCTS,3057,228,9,7,16,56.2%,1h
4875,3,aNDRYs,3057,247,9,12,21,42.9%,25m
4875,1,BabiboB,3057,284,7,7,14,50.0%,18m
4875,3,Neuro,3057,0,4,3,7,57.1%,1h
4875,1,Sovjet,3057,0,1,2,3,33.3%,13m
4883,1,Panda,3056,0,1,1,2,50.0%,25m
4883,3,[RoXY]hYtAkYtE,3056,0,0,1,1,0.0%,29m
4885,3,[SenCit]Pinky,3055,975,49,56,105,46.7%,20m
4885,2,nucleus,3055,1018,40,32,72,55.6%,24m
4885,1,[CS0]Tarwe,3055,554,18,21,39,46.2%,6m
4885,1,[NucPus]PussуРusher,3055,97,5,1,6,83.3%,1h
4885,2,Lox,3055,0,4,1,5,80.0%,26m
4885,1,Vendetta,3055,0,4,1,5,80.0%,10m
4885,2,moebius,3055,64,2,3,5,40.0%,25m
4892,3,TiMson,3054,1599,226,236,462,48.9%,25m
4892,1,[RRRRDT]HappyBeeps,3054,1016,87,90,177,49.2%,15m
4892,3,MATIS,3054,316,12,19,31,38.7%,24m
4892,1,[Esply]EsplyEd,3054,213,8,4,12,66.7%,12m
4892,1,Nathuram,3054,165,5,7,12,41.7%,25m
4892,2,[КПCC]OurVictoury,3054,94,3,4,7,42.9%,27m
4892,2,OceloT,3054,0,1,0,1,100.0%,11m
4892,1,Jekenius,3054,0,1,4,5,20.0%,1h
4892,2,[TuttiG]Yuurina,3054,0,0,1,1,0.0%,17m
4901,1,NeferPitou,3053,282,29,25,54,53.7%,18m
4901,1,TigIDigI,3053,818,29,26,55,52.7%,25m
4901,3,[MFclub]LeDuc,3053,626,25,23,48,52.1%,24m
4901,2,smileRUN,3053,625,24,19,43,55.8%,11m
4901,1,[TOWEA]juicelink,3053,487,22,25,47,46.8%,7m
4901,3,Icyteck,3053,567,21,24,45,46.7%,8m
4901,1,Humongous,3053,405,14,11,25,56.0%,5m
4901,2,pyspark,3053,341,14,12,26,53.8%,27m
4901,2,[дгд]Eddie,3053,128,5,3,8,62.5%,17m
4901,1,[BWArmy]Slazy,3053,120,4,1,5,80.0%,11m
4901,2,LarsMorten,3053,0,3,2,5,60.0%,26m
4901,2,Makeshik,3053,0,0,1,1,0.0%,19m
4913,2,[SESpo]Yamal,3052,1569,179,151,330,54.2%,5m
4913,3,Random,3052,1464,146,151,297,49.2%,17m
4913,1,Assssssssss,3052,504,16,17,33,48.5%,25m
4913,1,PiPmaSter,3052,248,10,7,17,58.8%,8m
4913,2,Icki,3052,187,6,4,10,60.0%,22m
4913,3,BARCODE,3052,30,3,7,10,30.0%,18m
4913,3,WidowCruiser,3052,121,2,1,3,66.7%,1h
4920,2,[OFRO]Punishment,3051,1612,116,102,218,53.2%,6m
4920,1,[elCrab]Gazmyas,3051,281,11,7,18,61.1%,18m
4920,1,NovemberTen,3051,211,10,5,15,66.7%,5m
4920,1,chucknorris,3051,154,4,10,14,28.6%,6m
4920,1,[Peeps]GFG,3051,38,2,3,5,40.0%,11m
4920,2,[8DJ8]mhY,3051,0,1,0,1,100.0%,5m
4920,2,Bierchen,3051,0,1,0,1,100.0%,14m
4927,1,[LPTP]ShowDowN,3050,1216,257,265,522,49.2%,6m
4927,1,TheNational,3050,1227,104,104,208,50.0%,15m
4927,1,FusilàPompe,3050,989,82,65,147,55.8%,27m
4927,1,SuperManer,3050,1477,82,72,154,53.2%,11m
4927,1,Drölf,3050,426,46,50,96,47.9%,15m
4927,1,UrinGelber,3050,412,15,9,24,62.5%,11m
4927,3,Opa,3050,129,4,12,16,25.0%,9m
4927,3,IIIIIII,3050,30,3,6,9,33.3%,17m
4927,1,RavenSiberia,3050,0,2,4,6,33.3%,10m
4927,2,onli,3050,0,1,0,1,100.0%,27m
4927,2,oleg,3050,0,1,0,1,100.0%,10m
4927,2,Mirage,3050,0,0,1,1,0.0%,4m
4939,3,NoName,3049,720,53,60,113,46.9%,9m
4939,2,[Z3RG7V]Garret,3049,998,38,32,70,54.3%,6m
4939,3,[3ky]Puffcio,3049,485,27,35,62,43.5%,4m
4939,1,[BHN]sergoRU,3049,569,20,18,38,52.6%,4m
4939,2,Danceacy,3049,324,13,4,17,76.5%,28m
4939,2,CANNONRUSH,3049,314,12,4,16,75.0%,24m
4939,1,Foodmaker,3049,200,7,7,14,50.0%,28m
4939,1,[ZSAA]gectra,3049,48,5,2,7,71.4%,1h
4939,1,Bauernheld,3049,114,4,6,10,40.0%,19m
4939,3,PIT,3049,0,1,0,1,100.0%,15m
4939,1,[Slakin]SslackSton,3049,92,1,2,3,33.3%,12m
4939,3,NAGIBATOR,3049,0,0,1,1,0.0%,1h
4951,3,CNM,3048,1594,90,87,177,50.8%,6m
4951,3,nSlPindle,3048,587,31,43,74,41.9%,5m
4951,1,UNDERTACOS,3048,385,12,13,25,48.0%,18m
4951,3,[Рrіmе]Chatlanin,3048,340,11,17,28,39.3%,17m
4951,1,AnimusCore,3048,0,3,2,5,60.0%,1h
4951,3,Kimi,3048,42,1,8,9,11.1%,18m
4951,2,jnS,3048,0,0,1,1,0.0%,26m
4951,2,che,3048,0,0,1,1,0.0%,18m
4959,1,[ABGB]SuBuRbiA,3047,1574,59,57,116,50.9%,6m
4959,2,WWWWWWWWWWWW,3047,600,26,19,45,57.8%,14m
4959,1,[PIWN]Milord,3047,296,10,9,19,52.6%,15m
4959,1,[Gécé]MacCoy,3047,246,7,6,13,53.8%,18m
4959,2,Granate,3047,141,6,5,11,54.5%,34m
4959,3,ShiningLazer,3047,97,5,3,8,62.5%,1h
4959,1,[Deleam]WarLord,3047,146,3,4,7,42.9%,17m
4959,2,LifeFoNerzul,3047,0,2,3,5,40.0%,5m
4959,2,Protosik,3047,0,1,2,3,33.3%,28m
4959,2,Baltø,3047,0,0,1,1,0.0%,4m
4969,3,[Jedi]MasterBetty,3046,1571,488,486,974,50.1%,7m
4969,3,[ƒƒm]instantGG,3046,1530,361,368,729,49.5%,9m
4969,2,[SiSM]SzczaF,3046,248,14,16,30,46.7%,4m
4969,2,[Gehakt]Furby,3046,88,5,7,12,41.7%,26m
4969,2,BlazejJagge,3046,30,4,2,6,66.7%,11m
4969,3,[RuVoid]ЧереЧпоЧек,3046,135,4,4,8,50.0%,1h
4969,2,[J4E]ACID,3046,0,1,0,1,100.0%,26m
4969,1,Asand,3046,0,0,1,1,0.0%,1h
4969,1,TrashPanda,3046,0,0,3,3,0.0%,8m
4978,1,[SuApp]Qualme,3045,1396,92,83,175,52.6%,28m
4978,3,[DgF2]Malzbier,3045,605,24,34,58,41.4%,28m
4978,3,[Skolan]Enron,3045,328,10,16,26,38.5%,8m
4978,1,[aW]error,3045,90,2,2,4,50.0%,13m
4978,1,[EHET]LeChatVentru,3045,70,2,4,6,33.3%,10m
4978,3,MasterLordi,3045,97,1,1,2,50.0%,25m
4984,3,MakkO,3044,1151,48,55,103,46.6%,9m
4984,1,Marte,3044,862,36,26,62,58.1%,17m
4986,2,HeteroHero,3043,1618,458,459,917,49.9%,8m
4986,1,[xFRSx]Rafus,3043,1506,105,81,186,56.5%,23m
4986,3,TheStone,3043,1226,83,80,163,50.9%,17m
4986,1,Triton,3043,775,61,54,115,53.0%,23m
4986,1,Kral,3043,352,12,11,23,52.2%,25m
4986,1,VechnoOdinok,3043,205,9,3,12,75.0%,13m
4986,1,wodkaisgood,3043,214,6,10,16,37.5%,13m
4986,1,Dema,3043,222,6,11,17,35.3%,25m
4986,2,AviatioN,3043,64,3,1,4,75.0%,14m
4986,2,MisteR,3043,89,2,2,4,50.0%,27m
4986,2,[P3rsé]Leondor,3043,44,2,3,5,40.0%,29m
4986,1,WienTank,3043,0,2,3,5,40.0%,29m
4986,2,Thunder,3043,0,1,0,1,100.0%,15m
4986,2,Moi,3043,0,0,1,1,0.0%,15m
4986,2,[GPL]EnGrimFan,3043,0,0,1,1,0.0%,5m
4986,2,Clement,3043,0,0,5,5,0.0%,28m
5002,1,Lifeson,3042,1718,63,62,125,50.4%,3m
5002,1,[W4SP]jberkani,3042,497,29,27,56,51.8%,4m
5002,2,Yeldoow,3042,418,15,9,24,62.5%,11m
5002,1,[Arrows]LoMaster,3042,528,15,20,35,42.9%,1m
5002,2,Tagged,3042,349,14,4,18,77.8%,2m
5002,1,DiscoStu,3042,188,8,7,15,53.3%,19m
5002,1,Czapka,3042,230,6,9,15,40.0%,7m
5002,2,[1825]AlainSoral,3042,30,2,0,2,100.0%,9m
5002,2,SpeedyRogue,3042,0,0,1,1,0.0%,1m
5011,2,SAS,3041,1160,43,45,88,48.9%,26m
5011,1,detail,3041,611,19,20,39,48.7%,13m
5011,1,saigo,3041,604,18,23,41,43.9%,3m
5011,3,[wpwpwp]Positron,3041,320,16,17,33,48.5%,28m
5011,1,[Sarmat]Majkelrooshi,3041,387,15,10,25,60.0%,6m
5011,2,[SPCs]RightProfit,3041,159,11,8,19,57.9%,3m
5011,2,[HZeS]ТеньМонолита,3041,237,9,2,11,81.8%,14m
5011,2,dennisje,3041,206,7,0,7,100.0%,14m
5011,1,Паханчик,3041,34,1,3,4,25.0%,13m
5011,1,MeowMeow,3041,0,0,4,4,0.0%,13m
5021,1,Knackwurst,3040,974,35,33,68,51.5%,18m
5021,1,RondatFlyak,3040,522,16,19,35,45.7%,7m
5021,2,[IBTMBL]DJNana,3040,300,11,5,16,68.8%,11m
5021,2,[0BO]Leo,3040,0,2,3,5,40.0%,15m
5021,2,Reiner,3040,30,2,4,6,33.3%,9m
5021,1,[SBad]McLovin,3040,78,2,5,7,28.6%,13m
5021,2,Denka,3040,0,1,4,5,20.0%,12m
5028,1,[SplX]amigo,3039,670,23,30,53,43.4%,14m
5028,3,LikerGames,3039,171,8,7,15,53.3%,14m
5028,2,DrunkGamer,3039,166,5,3,8,62.5%,16m
5028,1,Winchester,3039,184,5,4,9,55.6%,14m
5028,1,Шиза,3039,0,4,2,6,66.7%,3m
5028,2,Bouce,3039,30,1,2,3,33.3%,19m
5028,1,[leOS]Civolt,3039,44,1,6,7,14.3%,1m
5028,2,cRYZ,3039,0,0,1,1,0.0%,26m
5036,2,[Ǽ1]AGoatedPlat,3038,668,28,14,42,66.7%,19m
5036,3,MightyMan,3038,88,7,4,11,63.6%,8m
5036,1,Dump,3038,176,5,3,8,62.5%,28m
5036,2,BigChungus,3038,105,5,4,9,55.6%,19m
5036,1,elektroluse,3038,172,5,5,10,50.0%,8m
5036,2,БезТрусов,3038,0,3,2,5,60.0%,5m
5036,1,[CrøkeT]ElPijon,3038,0,1,3,4,25.0%,6m
5043,2,fozzy,3037,335,12,8,20,60.0%,4m
5043,3,BruV,3037,0,5,1,6,83.3%,15m
5043,1,RoninBlade,3037,0,3,2,5,60.0%,1h
5043,1,Grimalkin,3037,124,3,3,6,50.0%,28m
5043,1,[ĀşƇ]Hikari,3037,0,2,2,4,50.0%,1h
5043,2,[BGDK]Viking,3037,0,0,1,1,0.0%,13m
5049,1,[123abc]stowgood,3036,1702,100,104,204,49.0%,4m
5049,1,Tonimon,3036,1296,97,89,186,52.2%,10m
5049,3,YesNoCancel,3036,1564,73,84,157,46.5%,7m
5049,2,[αX]Shohei,3036,256,24,12,36,66.7%,11m
5049,3,Mulder,3036,646,22,32,54,40.7%,12m
5049,3,LennyTheLing,3036,97,5,2,7,71.4%,15m
5049,3,MiguelPérez,3036,0,1,0,1,100.0%,1m
5049,2,Spenouh,3036,30,1,3,4,25.0%,4m
5049,2,PfCla,3036,0,1,4,5,20.0%,3m
5058,2,UltraM,3035,434,22,2,24,91.7%,10m
5058,2,AEC,3035,208,7,8,15,46.7%,28m
5058,3,[PGRF]ZeroTone,3035,150,4,10,14,28.6%,19m
5058,3,edpistemic,3035,116,3,0,3,100.0%,2m
5058,1,Rainor,3035,0,3,2,5,60.0%,38m
5058,1,[GSCOC]Noco,3035,171,3,7,10,30.0%,15m
5058,3,uninv,3035,0,1,0,1,100.0%,3m
5058,2,[IceHus]INnoVation,3035,0,1,0,1,100.0%,28m
5058,2,Ratero,3035,0,0,1,1,0.0%,11m
5067,1,Pacalpöri,3034,962,78,75,153,51.0%,26m
5067,2,[fam1ly]ArtiDo,3034,580,27,10,37,73.0%,8m
5067,2,[wtw]WEITNOW,3034,222,8,11,19,42.1%,15m
5067,1,WILLY,3034,48,4,3,7,57.1%,1h
5067,2,[DINANT]SlaatjeBla,3034,62,2,2,4,50.0%,11m
5067,1,Meliodas,3034,0,2,5,7,28.6%,26m
5067,1,[NINJ88]iliyanpetrov,3034,120,2,7,9,22.2%,8m
5067,2,phoenix,3034,0,1,0,1,100.0%,2m
5067,1,[Herz]Isengrim,3034,46,1,1,2,50.0%,1h
5076,1,VoidWanderer,3033,1052,49,33,82,59.8%,1m
5076,2,can,3033,592,27,18,45,60.0%,5m
5076,1,[HRDS]ZeroCooL,3033,753,24,23,47,51.1%,10m
5076,2,benis,3033,247,10,7,17,58.8%,2m
5076,2,niu,3033,202,6,2,8,75.0%,5m
5076,1,knigurai,3033,165,4,5,9,44.4%,7m
5076,1,Haber,3033,142,3,13,16,18.8%,18m
5076,1,Yalos,3033,120,2,2,4,50.0%,11m
5076,2,Zeus,3033,0,0,1,1,0.0%,15m
5076,2,Homeguard,3033,0,0,2,2,0.0%,10m
5086,1,Biohazard,3032,1549,68,58,126,54.0%,28m
5086,1,ItsNoGood,3032,1220,41,47,88,46.6%,7m
5086,2,llllllllllll,3032,32,2,3,5,40.0%,3m
5086,3,[FlSCH]Staimi,3032,97,1,1,2,50.0%,13m
5086,1,Brizzy,3032,0,1,2,3,33.3%,4m
5086,3,Dionis,3032,0,0,1,1,0.0%,11m
5086,3,[SDTL]Veritas,3032,0,0,4,4,0.0%,2m
5093,1,KOZA,3031,126,8,2,10,80.0%,4m
5093,2,CandyThief,3031,234,8,4,12,66.7%,6m
5093,2,velbloud,3031,116,5,4,9,55.6%,13m
5093,2,[ialm]Kefaem,3031,62,3,2,5,60.0%,9m
5093,3,[Buggo]CreepRemover,3031,97,3,4,7,42.9%,16m
5093,1,Freakout,3031,108,3,6,9,33.3%,14m
5093,2,[NoeSS]Visper,3031,30,2,0,2,100.0%,15m
5093,2,Akuma,3031,62,2,2,4,50.0%,5m
5101,1,[TheLH]BurtMacklin,3030,1436,66,71,137,48.2%,11m
5101,1,WhiteRabbit,3030,1303,56,49,105,53.3%,12m
5101,2,[KStönz]Spacey,3030,1012,46,35,81,56.8%,14m
5101,1,pusswy,3030,315,12,9,21,57.1%,1h
5101,3,djglatnakke,3030,191,8,5,13,61.5%,18m
5101,2,[KnbZ]BrThome,3030,150,6,6,12,50.0%,3m
5101,1,[SeeLaw]Jordan,3030,97,4,2,6,66.7%,6m
5101,2,[isIMBA]Sinnaah,3030,90,3,3,6,50.0%,8m
5101,2,Michael,3030,0,1,0,1,100.0%,11m
5101,1,[scam0]UnoCarb,3030,38,1,5,6,16.7%,13m
5101,1,Yasheryk,3030,0,0,1,1,0.0%,30m
5112,2,WaRW,3029,993,58,53,111,52.3%,19m
5112,1,[Graps]AbouDiaby,3029,144,5,13,18,27.8%,23m
5112,3,Shahun,3029,143,4,13,17,23.5%,3m
5112,2,Modebog,3029,176,3,6,9,33.3%,5m
5112,2,[xOuOx]Königstiger,3029,58,2,3,5,40.0%,11m
5117,2,[xDNOx]XeLaS,3028,1306,116,108,224,51.8%,1m
5117,1,[hrdcor]Herms,3028,1697,111,109,220,50.5%,3m
5117,3,ImNoOb,3028,570,21,33,54,38.9%,12m
5117,2,katamorphism,3028,60,3,1,4,75.0%,12m
5117,1,[VGZR]Knazpa,3028,0,3,3,6,50.0%,19m
5117,2,Blast,3028,30,2,0,2,100.0%,2m
5117,2,[lolw0t]Vegan,3028,30,2,4,6,33.3%,15m
5124,2,[lOoOl]NukeLord,3027,733,35,16,51,68.6%,3m
5124,1,[PTZMuc]Darkness,3027,563,22,17,39,56.4%,13m
5124,1,cosmicbaby,3027,471,14,14,28,50.0%,27m
5124,1,[DgF2]DankeMerkel,3027,152,5,0,5,100.0%,4m
5124,2,kerasin,3027,30,2,1,3,66.7%,12m
5124,2,Rumus,3027,0,2,3,5,40.0%,4m
5124,2,Asti,3027,0,0,1,1,0.0%,14m
5131,3,pupsikUA,3026,1455,299,296,595,50.3%,5m
5131,1,magass,3026,1039,39,37,76,51.3%,11m
5131,1,pivanov,3026,691,31,21,52,59.6%,6m
5131,1,niCEEmAN,3026,326,9,16,25,36.0%,7m
5131,2,[DgF2]Hanfkeks,3026,226,6,6,12,50.0%,17m
5131,1,Ishtar,3026,175,5,4,9,55.6%,27m
5131,2,Гусь,3026,93,2,0,2,100.0%,14m
5138,2,Runich,3025,1306,74,61,135,54.8%,20m
5138,1,[fam1ly]KinpachLordX,3025,1010,62,57,119,52.1%,12m
5138,1,[FRGSP]Chavi,3025,964,36,35,71,50.7%,7m
5138,2,Simas,3025,402,15,16,31,48.4%,12m
5138,2,[ZADR]Quonix,3025,126,4,5,9,44.4%,7m
5138,3,[RUINPP]Prax,3025,142,3,5,8,37.5%,2m
5138,2,CmmBTK,3025,0,2,3,5,40.0%,20m
5138,2,Молганус,3025,0,0,1,1,0.0%,19m
5138,2,CowaBunGaa,3025,0,0,1,1,0.0%,5m
5138,2,[WurS]samdaskod,3025,0,0,2,2,0.0%,6m
5148,1,Skopy,3024,1234,47,46,93,50.5%,15m
5148,2,Sightlyfan,3024,714,27,25,52,51.9%,20m
5148,3,Inflict,3024,283,12,9,21,57.1%,9m
5148,3,Stringset,3024,306,11,6,17,64.7%,11m
5148,2,[OtES]GraineGivre,3024,0,3,2,5,60.0%,17m
5148,1,[HBGSJR]Retaliator,3024,40,2,7,9,22.2%,11m
5154,1,herOS,3023,799,32,25,57,56.1%,14m
5154,1,FilthyCasual,3023,693,27,21,48,56.2%,27m
5154,1,[101101]Kindlund,3023,403,16,8,24,66.7%,26m
5154,1,Vers,3023,431,13,14,27,48.1%,18m
5154,2,[CRIMP]iZnoGouD,3023,196,12,0,12,100.0%,17m
5154,1,HavaN,3023,116,7,3,10,70.0%,13m
5154,2,[Konkos]destro,3023,58,3,0,3,100.0%,17m
5161,3,Hanurik,3022,213,12,11,23,52.2%,9m
5161,2,Zhorikcccp,3022,193,10,4,14,71.4%,1h
5161,1,[HMB]Tydirius,3022,155,5,3,8,62.5%,15m
5161,1,[Burla]Starvind,3022,0,4,2,6,66.7%,2m
5161,1,Makmerdo,3022,122,3,2,5,60.0%,6m
5161,2,Mithrandir,3022,0,1,1,2,50.0%,8m
5161,2,[Hydrа]Kaspiec,3022,0,0,2,2,0.0%,1h
5161,2,[GGDrZ]DrZ,3022,0,0,3,3,0.0%,26m
5161,2,Jerix,3022,0,0,3,3,0.0%,12m
5170,2,CpuCwp,3021,695,31,19,50,62.0%,14m
5170,2,[Nеzukо]OniUbiliKeni,3021,353,16,16,32,50.0%,26m
5170,3,[Perm]protosek,3021,289,13,13,26,50.0%,18m
5170,3,[khoans]vjsr,3021,208,9,13,22,40.9%,14m
5170,2,ShadoW,3021,195,5,5,10,50.0%,1h
5170,1,Vertical,3021,145,3,5,8,37.5%,25m
5170,1,[ErR]StroKe,3021,103,2,6,8,25.0%,4m
5170,2,shjOoR,3021,30,1,2,3,33.3%,14m
5170,1,CCAA,3021,0,0,1,1,0.0%,1h
5170,2,[FMG]Tassada,3021,0,0,1,1,0.0%,5m
5180,1,GLUK,3020,806,33,38,71,46.5%,18m
5180,2,Gladiator,3020,548,18,17,35,51.4%,12m
5180,2,ZveReK,3020,140,6,4,10,60.0%,3m
5180,2,FishNett,3020,144,5,2,7,71.4%,7m
5180,1,Стараюсь,3020,142,5,4,9,55.6%,1h
5180,3,sudoVoid,3020,0,4,4,8,50.0%,19m
5180,2,[RBadB]Thieum,3020,141,3,3,6,50.0%,1h
5180,2,Petosiris,3020,0,1,4,5,20.0%,27m
5180,2,Grimlinks,3020,0,0,1,1,0.0%,12m
5189,1,Ulibashkin,3019,1695,125,126,251,49.8%,7m
5189,3,Nerdking,3019,424,17,7,24,70.8%,8m
5189,2,Mango,3019,357,15,11,26,57.7%,2m
5189,1,Thurlogus,3019,0,1,1,2,50.0%,1h
5189,2,skazy,3019,32,1,4,5,20.0%,15m
5189,2,Ladord,3019,0,0,1,1,0.0%,20m
5189,2,KatariTari,3019,0,0,1,1,0.0%,10m
5196,2,MihansterII,3018,1346,121,107,228,53.1%,10m
5196,2,DrGreenthumb,3018,563,27,10,37,73.0%,26m
5196,2,TalDarim,3018,286,11,6,17,64.7%,26m
5196,2,[BHR]Khlint,3018,212,6,7,13,46.2%,26m
5196,1,Pistola,3018,123,3,6,9,33.3%,6m
5196,2,[MUUMI]ropo,3018,0,0,1,1,0.0%,17m
5196,2,[TaTe]Tommy,3018,0,0,1,1,0.0%,4m
5196,2,refrigeratus,3018,0,0,1,1,0.0%,9m
5196,3,Henry,3018,0,0,1,1,0.0%,1h
5205,3,[Kompi]Exedo,3017,1094,40,52,92,43.5%,4m
5205,2,PereNoël,3017,443,16,15,31,51.6%,27m
5205,1,Khuul,3017,97,4,2,6,66.7%,1h
5205,3,[Rebеls]vpmail,3017,0,2,2,4,50.0%,1m
5205,1,[ialm]adelante,3017,0,1,0,1,100.0%,38m
5210,1,[ziMMes]Kamikadze,3016,634,23,23,46,50.0%,26m
5210,3,DaSwarm,3016,372,14,10,24,58.3%,1m
5210,2,hashtnt,3016,224,7,6,13,53.8%,13m
5210,3,Starkiller,3016,97,4,3,7,57.1%,36m
5210,2,[BEL4]Darmelo,3016,126,3,2,5,60.0%,26m
5210,2,subserver,3016,0,3,2,5,60.0%,20m
5210,1,TheBlackFrog,3016,143,3,11,14,21.4%,29m
5210,2,KeminSSHKG,3016,30,2,1,3,66.7%,2m
5210,1,Psøøm,3016,46,2,2,4,50.0%,1h
5210,1,LunarMAX,3016,95,2,3,5,40.0%,1h
5210,2,[Radium]POCHKA,3016,38,1,2,3,33.3%,17m
5221,1,Nick,3015,1071,168,163,331,50.8%,5m
5221,2,jasta,3015,788,41,34,75,54.7%,9m
5221,2,IIIIIIIIIIII,3015,807,31,26,57,54.4%,2m
5221,2,[RiseTG]GnlAnakin,3015,552,22,17,39,56.4%,26m
5221,2,[971]Corsair,3015,306,14,7,21,66.7%,27m
5221,2,Meszuga,3015,258,10,9,19,52.6%,17m
5221,3,Distortion,3015,214,7,6,13,53.8%,11m
5221,2,Brebux,3015,164,5,6,11,45.5%,1h
5221,2,[Çipet]mombohunter,3015,0,0,2,2,0.0%,26m
5221,3,SlubberBub,3015,0,0,2,2,0.0%,19m
5231,2,ChinaMAC,3014,1306,58,43,101,57.4%,3m
5231,3,[Trran]aea,3014,300,14,9,23,60.9%,10m
5231,1,jaweeeeel,3014,275,8,7,15,53.3%,6m
5231,1,FoxShadow,3014,0,5,1,6,83.3%,6m
5231,3,Dragster,3014,30,4,6,10,40.0%,19m
5231,2,Pentarh,3014,0,1,0,1,100.0%,4m
5237,2,[D0N3]Pacselly,3013,238,9,9,18,50.0%,4m
5237,2,[AHill]Wanze,3013,142,5,6,11,45.5%,29m
5237,1,[kiborg]няшка,3013,124,3,3,6,50.0%,7m
5237,2,PacMan,3013,120,3,6,9,33.3%,4m
5237,1,Чуча,3013,0,1,0,1,100.0%,34m
5237,1,Enge,3013,90,1,4,5,20.0%,10m
5243,2,Negod,3012,484,25,23,48,52.1%,5m
5243,3,[Aw3]Diroks,3012,506,21,28,49,42.9%,26m
5243,1,vova,3012,512,20,21,41,48.8%,18m
5243,1,LOPUH,3012,0,4,2,6,66.7%,15m
5243,2,Arko,3012,0,3,2,5,60.0%,14m
5243,2,Steve,3012,0,1,0,1,100.0%,20m
5243,2,[TTpom]Curare,3012,0,1,0,1,100.0%,27m
5243,2,[АDMIN]ZergLing,3012,0,0,1,1,0.0%,26m
5251,2,[Pedick]Gomosek,3011,1624,221,198,419,52.7%,3m
5251,1,[PvZEU]Arany,3011,531,23,19,42,54.8%,11m
5251,2,Harry,3011,511,22,10,32,68.8%,20m
5251,2,Dasbooty,3011,582,22,16,38,57.9%,20m
5251,1,likonit,3011,339,18,6,24,75.0%,19m
5251,3,dobridiv,3011,0,5,2,7,71.4%,26m
5251,2,GinAndJuice,3011,0,5,3,8,62.5%,16m
5251,2,Coldnuker,3011,60,3,1,4,75.0%,15m
5251,2,[ГРУЗИН]MIshazerg,3011,0,3,2,5,60.0%,2m
5251,1,[EESC]Donday,3011,104,3,7,10,30.0%,8m
5251,2,РАСTAMAH,3011,30,2,1,3,66.7%,13m
5262,2,KrimiX,3010,1033,45,38,83,54.2%,17m
5262,1,guigsou,3010,153,7,2,9,77.8%,13m
5262,1,[LDG69]Photon,3010,210,7,9,16,43.8%,1m
5262,1,FisherKing,3010,249,6,7,13,46.2%,32m
5262,3,[ToZea]thom,3010,121,4,2,6,66.7%,3m
5262,1,[CLo07]Mithrandir,3010,76,3,5,8,37.5%,27m
5262,2,[Bádzsó]nerelf,3010,0,0,1,1,0.0%,14m
5262,2,Kai,3010,0,0,1,1,0.0%,11m
5270,1,BlueBanana,3009,1538,75,72,147,51.0%,28m
5270,3,Yaleo,3009,1246,46,55,101,45.5%,8m
5270,2,IIIIIIIII,3009,384,17,4,21,81.0%,2m
5270,2,Karma,3009,429,16,9,25,64.0%,14m
5270,2,Cronus,3009,308,12,10,22,54.5%,26m
5270,2,sevro,3009,256,10,6,16,62.5%,13m
5270,2,Laggg,3009,167,8,3,11,72.7%,27m
5270,2,Goldenass,3009,210,8,4,12,66.7%,5m
5270,2,Idolatracier,3009,197,7,6,13,53.8%,12m
5270,1,[SLW]speedyPifPaf,3009,40,4,4,8,50.0%,18m
5270,2,DrStrudel,3009,0,1,0,1,100.0%,5m
5270,2,agentFerat,3009,0,0,1,1,0.0%,27m
5282,3,FRIK,3008,1557,98,89,187,52.4%,14m
5282,1,[KKRoch]GetTTChoppa,3008,312,10,11,21,47.6%,7m
5282,1,Max,3008,135,4,6,10,40.0%,7m
5282,1,Nehalem,3008,0,3,2,5,60.0%,1h
5282,1,ZuKi,3008,40,3,5,8,37.5%,14m
5282,2,louiseflbdv,3008,30,2,3,5,40.0%,14m
5282,1,STORM,3008,0,2,4,6,33.3%,14m
5282,2,[ZERG7V]Nuclear,3008,0,1,0,1,100.0%,14m
5282,2,KaldorDraigo,3008,0,0,1,1,0.0%,7m
5282,2,Never,3008,0,0,2,2,0.0%,14m
5292,1,Michał,3007,997,47,45,92,51.1%,18m
5292,1,gorre,3007,316,14,11,25,56.0%,10m
5292,1,[lLiTl]DREDGE,3007,348,12,12,24,50.0%,10m
5292,1,[ProMnk]Araksam,3007,362,11,13,24,45.8%,11m
5292,1,MrToxyy,3007,148,5,8,13,38.5%,3m
5292,1,LikeSmoke,3007,116,4,8,12,33.3%,26m
5292,2,Jaggernout,3007,32,2,1,3,66.7%,13m
5292,2,Gratz,3007,30,2,2,4,50.0%,14m
5292,3,Ragschas,3007,0,0,1,1,0.0%,23m
5301,1,Auron,3006,176,9,5,14,64.3%,13m
5301,1,[SWN]Erébus,3006,271,9,10,19,47.4%,8m
5301,1,Lostyrek,3006,317,9,11,20,45.0%,8m
5301,2,[KRUNK]Grandma,3006,58,5,4,9,55.6%,13m
5301,2,EnderWiggin,3006,90,3,5,8,37.5%,15m
5306,1,Masterme,3005,849,44,43,87,50.6%,28m
5306,1,Jasper,3005,726,33,24,57,57.9%,12m
5306,2,dukenukem,3005,467,19,18,37,51.4%,14m
5306,2,Rastamon,3005,302,11,12,23,47.8%,4m
5306,1,ЧудоПёс,3005,116,3,0,3,100.0%,1h
5306,1,ЕПИСКОП,3005,48,3,5,8,37.5%,1h
5306,2,[WLE]freya,3005,0,1,0,1,100.0%,14m
5306,1,NicolasCage,3005,0,0,5,5,0.0%,1h
5314,1,Artemis,3004,580,18,19,37,48.6%,26m
5314,3,IkillMALL,3004,398,16,24,40,40.0%,14m
5314,2,mcgui,3004,305,11,8,19,57.9%,3m
5314,2,DeLeT,3004,180,6,6,12,50.0%,14m
5314,2,[MBG]Cuzen,3004,30,2,0,2,100.0%,18m
5314,2,AllSilentSky,3004,119,2,2,4,50.0%,38m
5314,2,[InBri]Fedor,3004,0,1,1,2,50.0%,17m
5314,2,[OFocus]Kelthar,3004,0,0,1,1,0.0%,19m
5322,1,Capzda,3003,1257,47,53,100,47.0%,10m
5322,1,fazzel,3003,981,36,39,75,48.0%,28m
5322,3,Alantreyd,3003,462,17,25,42,40.5%,4m
5322,2,[Drachw]Seburzal,3003,288,11,7,18,61.1%,27m
5322,2,EnTaroGeoff,3003,300,10,12,22,45.5%,14m
5322,2,MOHAK,3003,188,7,2,9,77.8%,4m
5322,2,Altaran,3003,118,3,1,4,75.0%,17m
5322,1,MarlboroO,3003,74,3,6,9,33.3%,4m
5322,2,[VMLH1R]VAALHIR,3003,30,2,1,3,66.7%,2m
5322,2,DarkGuard,3003,58,2,1,3,66.7%,5m
5322,1,Pivchash,3003,0,2,2,4,50.0%,38m
5322,2,Ronin,3003,0,1,0,1,100.0%,11m
5334,3,ОтецСКхХх,3002,1331,48,58,106,45.3%,7m
5334,2,Hellden,3002,197,9,6,15,60.0%,32m
5334,1,Einstein,3002,221,7,5,12,58.3%,9m
5334,2,[ISWAGl]Linde,3002,58,2,2,4,50.0%,5m
5334,2,Ken,3002,0,1,0,1,100.0%,9m
5334,1,[BABYSS]Babyman,3002,48,1,2,3,33.3%,1h
5334,2,Paradisum,3002,0,1,3,4,25.0%,14m
5341,2,Chomp,3001,756,31,23,54,57.4%,10m
5341,2,Semion,3001,532,22,18,40,55.0%,3m
5341,1,Kotyara,3001,593,19,21,40,47.5%,28m
5341,1,MadScientist,3001,288,9,14,23,39.1%,6m
5341,1,Ares,3001,97,4,2,6,66.7%,32m
5341,2,Affliction,3001,0,0,1,1,0.0%,17m
5341,2,Xyu,3001,0,0,1,1,0.0%,17m
5341,2,SNV,3001,0,0,3,3,0.0%,26m
5349,1,WINIKE,3000,1140,39,43,82,47.6%,13m
5349,2,DayMan,3000,289,12,13,25,48.0%,15m
5349,1,abishell,3000,175,11,8,19,57.9%,2m
5349,2,[TSC2C]Тирион,3000,182,5,1,6,83.3%,13m
5349,2,danar,3000,34,1,4,5,20.0%,13m
5349,1,[FrzDrv]Drivzz,3000,32,1,7,8,12.5%,27m
5355,2,Насяльника,2999,1604,183,165,348,52.6%,28m
5355,2,PRIMARCH,2999,949,95,77,172,55.2%,14m
5355,2,Yan,2999,882,39,28,67,58.2%,20m
5355,1,[Heroes]CapnCrunch,2999,672,36,28,64,56.2%,19m
5355,1,[1NFEC7]BiZarKiD,2999,330,10,14,24,41.7%,28m
5355,2,[LV]TargeT,2999,230,7,7,14,50.0%,4m
5355,2,SmirnOFF,2999,142,6,7,13,46.2%,15m
5355,2,[LsSsD]eTRIP,2999,158,5,1,6,83.3%,11m
5355,2,Izvas,2999,102,5,2,7,71.4%,14m
5355,2,GDim,2999,30,4,3,7,57.1%,15m
5355,2,LKNR,2999,102,4,3,7,57.1%,1m
5355,1,MegaDeath,2999,145,3,0,3,100.0%,34m
5355,2,RamzesXIII,2999,0,1,4,5,20.0%,28m
5355,2,LuHoTTe,2999,0,0,1,1,0.0%,4m
5355,2,[SPAINs]Pamperaso,2999,0,0,1,1,0.0%,5m
5355,1,SoulHunter,2999,0,0,8,8,0.0%,15m
5371,1,PooHolePirat,2998,1614,88,83,171,51.5%,5m
5371,2,[Dobro]PunisherJ,2998,825,46,26,72,63.9%,20m
5371,2,ROACH,2998,204,7,1,8,87.5%,8m
5371,2,Sjakieownz,2998,60,2,2,4,50.0%,20m
5371,2,[Kapt]Fery,2998,0,1,0,1,100.0%,26m
5371,2,Michael,2998,0,1,1,2,50.0%,4m
5371,2,Manabu,2998,44,1,3,4,25.0%,1h
5371,2,[RahLuk]dorido,2998,0,0,1,1,0.0%,13m
5379,1,lolcake,2997,602,28,26,54,51.9%,17m
5379,1,BaZinga,2997,446,19,21,40,47.5%,10m
5379,2,StarLight,2997,264,9,8,17,52.9%,26m
5379,3,MundoPc,2997,240,7,10,17,41.2%,18m
5379,2,Shynamo,2997,148,6,3,9,66.7%,3m
5379,1,[TSB]Pawlak,2997,88,5,2,7,71.4%,11m
5379,2,Dumbledore,2997,86,3,3,6,50.0%,14m
5379,2,clowncraft,2997,90,3,7,10,30.0%,11m
5379,2,Widowmaker,2997,0,2,2,4,50.0%,19m
5379,2,Mobacca,2997,0,1,0,1,100.0%,3m
5379,2,Mythos,2997,0,0,1,1,0.0%,14m
5390,3,Driftoss,2996,1531,334,336,670,49.9%,9m
5390,2,vulock,2996,319,18,15,33,54.5%,20m
5390,3,FireFlame,2996,0,4,3,7,57.1%,2m
5390,2,Cho,2996,93,1,2,3,33.3%,32m
5390,2,[T1apS]Monas,2996,0,0,1,1,0.0%,4m
5390,3,[H2OKT]focation,2996,0,0,1,1,0.0%,28m
5396,2,[OaSa]Styxx,2995,1126,51,42,93,54.8%,19m
5396,2,inzSzlaga,2995,598,20,22,42,47.6%,14m
5396,2,Gades,2995,222,17,10,27,63.0%,17m
5396,2,[LRDP]LRPDCuv,2995,277,11,8,19,57.9%,9m
5396,1,[Cloaca]rtan,2995,286,10,11,21,47.6%,1h
5396,2,LonelyOrenot,2995,198,7,2,9,77.8%,27m
5396,2,САМОГОНЬ,2995,96,4,2,6,66.7%,4m
5396,3,[VetM]FloW,2995,30,3,7,10,30.0%,20m
5404,1,hlebushek,2994,1612,66,74,140,47.1%,14m
5404,1,Torino,2994,774,43,37,80,53.8%,28m
5404,1,BobMarley,2994,794,27,27,54,50.0%,17m
5404,3,[P00T]Вович,2994,368,17,7,24,70.8%,12m
5404,2,Maxmager,2994,254,10,6,16,62.5%,9m
5404,3,Lauerto,2994,155,3,2,5,60.0%,24m
5404,2,[THANOS]Hungary,2994,30,1,2,3,33.3%,14m
5404,2,LordHaarhus,2994,0,0,9,9,0.0%,28m
5412,1,OnlyFrans,2993,1562,62,59,121,51.2%,5m
5412,1,millemille,2993,676,23,26,49,46.9%,15m
5412,1,крюк,2993,435,13,17,30,43.3%,14m
5412,1,waneksx,2993,268,11,10,21,52.4%,14m
5412,1,Rendodo,2993,372,10,18,28,35.7%,18m
5412,2,[NoHоmо]Danya,2993,260,9,10,19,47.4%,5m
5412,1,pitkerij,2993,294,9,13,22,40.9%,7m
5412,2,Špekov,2993,150,5,0,5,100.0%,18m
5412,1,[TRGV]Rairium,2993,48,5,2,7,71.4%,7m
5412,2,alm,2993,142,3,1,4,75.0%,4m
5412,1,Aphex,2993,30,1,4,5,20.0%,6m
5412,2,[39Rus]Alx,2993,0,0,2,2,0.0%,3m
5424,1,TheGoodLad,2992,1643,231,232,463,49.9%,10m
5424,1,bes,2992,677,32,33,65,49.2%,28m
5424,2,mrDudzich,2992,718,26,25,51,51.0%,17m
5424,2,[PNZ]Plague,2992,351,12,9,21,57.1%,3m
5424,1,[TRDM]lolo,2992,245,8,6,14,57.1%,20m
5424,1,[Aie]MORO,2992,136,8,8,16,50.0%,1h
5424,3,Йода,2992,187,7,4,11,63.6%,11m
5424,1,[RofIer]Obsidien,2992,0,3,2,5,60.0%,4m
5424,1,Libertad,2992,0,3,2,5,60.0%,38m
5424,2,korail,2992,140,3,4,7,42.9%,1h
5424,2,Demion,2992,0,1,0,1,100.0%,13m
5424,2,IIIIIIIIIIII,2992,0,1,0,1,100.0%,12m
5424,2,Skouliki,2992,30,1,3,4,25.0%,15m
5424,1,blue,2992,0,0,5,5,0.0%,3m
5438,1,AspireGlobal,2991,1539,299,293,592,50.5%,6m
5438,3,[eli]Adam,2991,1145,148,150,298,49.7%,18m
5438,1,SunInShining,2991,1680,104,106,210,49.5%,14m
5438,1,Merser,2991,1434,100,95,195,51.3%,13m
5438,2,[B00bz]juju,2991,400,14,15,29,48.3%,3m
5438,1,RedDragon,2991,205,8,7,15,53.3%,11m
5438,1,Draze,2991,148,8,9,17,47.1%,8m
5438,2,[EV]DoctorZ,2991,174,7,5,12,58.3%,11m
5438,3,Spyder,2991,139,6,7,13,46.2%,4m
5438,1,Greeniigames,2991,102,5,3,8,62.5%,13m
5438,1,[OKSAS]MartiG,2991,191,5,8,13,38.5%,26m
5438,2,[FXs]Devitca,2991,0,1,0,1,100.0%,28m
5438,2,Asturianu,2991,0,1,0,1,100.0%,17m
5438,1,GroMoBoy,2991,0,1,0,1,100.0%,1h
5438,3,[Nudz]Imeryll,2991,44,1,4,5,20.0%,3m
5438,2,asic,2991,0,0,1,1,0.0%,6m
5438,2,Piegus,2991,0,0,1,1,0.0%,20m
5455,3,[TR8]GrosNoob,2990,984,32,42,74,43.2%,13m
5455,2,MIXRISH,2990,366,14,13,27,51.9%,26m
5455,1,[WDAL1]Swarlo,2990,257,8,5,13,61.5%,18m
5455,2,JhonnyCash,2990,176,6,7,13,46.2%,14m
5459,3,[Mester]Contingente,2989,1391,52,64,116,44.8%,11m
5459,2,[BERKUT]Хищник,2989,180,7,8,15,46.7%,27m
5459,2,AkaGi,2989,0,1,0,1,100.0%,11m
5459,3,func,2989,30,1,15,16,6.2%,3m
5459,2,BlokkerMC,2989,0,0,1,1,0.0%,26m
5464,2,[SDDDD]ОдинокийСтар,2988,676,30,23,53,56.6%,27m
5464,2,slash,2988,287,11,14,25,44.0%,17m
5464,3,SombreroPlz,2988,196,8,6,14,57.1%,9m
5464,2,Kratos,2988,88,4,2,6,66.7%,11m
5464,2,Poual,2988,114,3,5,8,37.5%,14m
5464,3,princess,2988,36,2,1,3,66.7%,10m
5464,2,llllllllllll,2988,0,1,0,1,100.0%,2m
5471,3,[LMyLF]Grimes,2987,1486,687,690,1377,49.9%,16m
5471,1,[qip]BigDeuce,2987,1617,137,143,280,48.9%,14m
5471,2,[EWGF]Kazuya,2987,281,10,11,21,47.6%,15m
5471,3,[LQR]QuackYou,2987,145,7,6,13,53.8%,2m
5471,2,Deleron,2987,120,4,6,10,40.0%,11m
5471,2,Tomiris,2987,0,3,2,5,60.0%,14m
5471,2,[EFEct]Blackrain,2987,0,0,2,2,0.0%,1m
5471,2,cronzzz,2987,0,0,2,2,0.0%,8m
5479,1,Nightmare,2986,954,55,29,84,65.5%,14m
5479,2,Ludegr,2986,678,34,12,46,73.9%,2m
5479,2,Naapukka,2986,142,6,3,9,66.7%,10m
5479,2,[iX]Robert,2986,0,1,0,1,100.0%,11m
5479,2,HTRON,2986,0,0,1,1,0.0%,27m
5484,1,Tema,2985,1589,170,168,338,50.3%,10m
5484,1,Shockrocket,2985,1659,142,131,273,52.0%,10m
5484,2,[lOoOl]josito,2985,1346,51,54,105,48.6%,9m
5484,1,precisionist,2985,320,14,12,26,53.8%,27m
5484,3,trooper,2985,285,12,13,25,48.0%,20m
5484,1,Costel,2985,287,8,11,19,42.1%,15m
5484,2,OROR,2985,189,6,3,9,66.7%,26m
5484,2,[GSTAR]Pain,2985,0,1,0,1,100.0%,11m
5484,1,[RBlood]Akinetsu,2985,0,0,1,1,0.0%,15m
5484,1,[BRBZ]Fenix,2985,0,0,2,2,0.0%,5m
5484,2,LastHero,2985,0,0,3,3,0.0%,20m
5495,1,TpaXyXoJIb,2984,1003,90,74,164,54.9%,6m
5495,2,[MSUSC2]SatelliteX,2984,355,13,8,21,61.9%,9m
5495,1,[wedown]BloodySmoker,2984,320,12,10,22,54.5%,1h
5495,2,[Heroes]Beacon,2984,90,4,2,6,66.7%,17m
5495,2,RêveDeVerre,2984,0,3,2,5,60.0%,14m
5495,1,[3DE]JOSHAN,2984,0,0,1,1,0.0%,34m
5495,2,Has,2984,0,0,5,5,0.0%,26m
5502,1,Ranzbock,2983,1405,65,62,127,51.2%,8m
5502,2,woody,2983,951,44,41,85,51.8%,14m
5502,2,[BaPaBo]Erdgeist,2983,574,22,15,37,59.5%,15m
5502,2,[ILRush]Tarnix,2983,92,3,7,10,30.0%,20m
5502,2,Nistelbog,2983,0,1,0,1,100.0%,8m
5502,2,[пепега]Farmacevt,2983,0,0,1,1,0.0%,13m
5508,2,SHGAMMELL,2982,976,43,30,73,58.9%,4m
5508,2,Spartacus,2982,889,41,23,64,64.1%,12m
5508,2,shmrckelzz,2982,347,14,11,25,56.0%,28m
5508,2,sidi,2982,320,12,11,23,52.2%,4m
5508,2,Rahvin,2982,250,9,8,17,52.9%,28m
5508,3,Mergi,2982,224,6,7,13,46.2%,11m
5508,2,[NIK2]Cavman,2982,0,1,1,2,50.0%,5m
5508,2,Fano,2982,0,0,1,1,0.0%,28m
5508,2,Grogu,2982,0,0,1,1,0.0%,3m
5517,2,fatman,2981,1405,59,53,112,52.7%,10m
5517,1,Timo,2981,1432,57,60,117,48.7%,28m
5517,1,stoltz,2981,948,42,46,88,47.7%,4m
5517,1,[LLTeam]Briac,2981,752,30,27,57,52.6%,14m
5517,3,llllllllllll,2981,248,15,9,24,62.5%,28m
5517,2,Alexy,2981,258,10,11,21,47.6%,11m
5517,1,[NoSock]ZSTRANNIK,2981,249,7,9,16,43.8%,26m
5517,2,Sparte,2981,0,3,2,5,60.0%,27m
5517,2,ElPoutros,2981,164,3,4,7,42.9%,3m
5517,2,Petrichor,2981,0,0,1,1,0.0%,14m
5517,2,goqsane,2981,0,0,2,2,0.0%,5m
5517,3,fluffuffe,2981,0,0,2,2,0.0%,14m
5529,2,Sensei,2980,542,20,17,37,54.1%,8m
5529,1,overlord,2980,446,14,19,33,42.4%,11m
5529,2,balkall,2980,131,13,11,24,54.2%,17m
5529,2,haq,2980,215,10,5,15,66.7%,4m
5529,2,Korp,2980,128,4,0,4,100.0%,17m
5529,2,angels,2980,0,4,1,5,80.0%,15m
5529,1,Theol,2980,48,4,3,7,57.1%,4m
5529,2,[HBeS]Raynor,2980,0,3,2,5,60.0%,28m
5529,2,[0860]Broxi,2980,0,1,0,1,100.0%,4m
5529,2,Lagger,2980,30,1,1,2,50.0%,26m
5529,1,Artstyle,2980,97,1,1,2,50.0%,20m
5540,1,sebzore,2979,903,167,164,331,50.5%,15m
5540,3,Clément,2979,724,25,33,58,43.1%,12m
5540,2,wanted,2979,150,6,7,13,46.2%,5m
5540,2,Ubiquitous,2979,0,5,0,5,100.0%,15m
5540,1,[IncS]Galeokerdo,2979,72,2,7,9,22.2%,11m
5540,2,Ents,2979,30,1,1,2,50.0%,18m
5540,2,[KTQ]Uskhan,2979,30,1,1,2,50.0%,4m
5540,1,qoi,2979,0,1,4,5,20.0%,5m
5540,3,FluffyZling,2979,0,1,4,5,20.0%,20m
5549,3,Ntony,2978,1522,264,273,537,49.2%,14m
5549,2,[BRSKR]Tropic,2978,806,75,27,102,73.5%,28m
5549,2,GGz,2978,1288,57,56,113,50.4%,12m
5549,2,IFELSE,2978,190,6,3,9,66.7%,28m
5549,2,[ToC]TOXYQ,2978,0,3,2,5,60.0%,17m
5549,2,[Yame]Christophe,2978,102,2,1,3,66.7%,3m
5555,2,Nederplebs,2977,344,13,13,26,50.0%,17m
5555,2,Karnaval,2977,0,4,1,5,80.0%,3m
5555,2,MrCrackFox,2977,86,4,2,6,66.7%,20m
5555,2,Timon,2977,112,3,0,3,100.0%,26m
5555,2,Nasher,2977,112,2,1,3,66.7%,14m
5555,1,[RBlood]Ninjuke,2977,0,1,0,1,100.0%,39m
5555,2,ShaolinAmove,2977,0,0,2,2,0.0%,4m
5562,2,Dmail,2976,1647,258,216,474,54.4%,14m
5562,1,[ЕМPIRE]Mikhail,2976,789,38,36,74,51.4%,14m
5562,1,heme,2976,878,36,30,66,54.5%,4m
5562,2,Jembo,2976,384,13,14,27,48.1%,26m
5562,1,Lover,2976,359,12,11,23,52.2%,19m
5562,1,Kippa,2976,274,11,14,25,44.0%,6m
5562,1,slazy,2976,96,5,3,8,62.5%,14m
5562,2,UxorialBack,2976,0,3,2,5,60.0%,1m
5562,2,CodePrisme,2976,90,3,3,6,50.0%,10m
5562,2,[ISCS]Syndrox,2976,30,2,0,2,100.0%,14m
5562,2,[сSсǃ]WannaBeMyslf,2976,30,2,0,2,100.0%,26m
5562,2,[KDV]Adamin,2976,135,2,4,6,33.3%,1h
5562,2,KsEden,2976,0,0,1,1,0.0%,20m
5575,3,Micke,2975,584,93,94,187,49.7%,18m
5575,1,kaboombaby,2975,929,36,35,71,50.7%,6m
5575,1,LetsDoItQuik,2975,310,11,12,23,47.8%,3m
5575,2,[D0N3]MANU,2975,138,3,5,8,37.5%,3m
5575,2,Demangelo,2975,96,3,6,9,33.3%,1m
5575,3,Thanpren,2975,0,1,4,5,20.0%,2m
5575,2,[BV]nikishok,2975,0,1,4,5,20.0%,3m
5575,2,Todja,2975,32,1,4,5,20.0%,17m
5575,2,SoupCatcher,2975,0,0,1,1,0.0%,27m
5575,1,llllllllllll,2975,0,0,1,1,0.0%,7m
5585,1,[eXe]Sobek,2974,859,28,32,60,46.7%,7m
5585,2,Titi,2974,198,18,7,25,72.0%,10m
5585,2,Gwaar,2974,156,5,1,6,83.3%,14m
5585,2,AHS,2974,60,2,3,5,40.0%,8m
5585,2,dyrek,2974,0,2,3,5,40.0%,20m
5585,2,[J4tS]Bakka,2974,0,1,0,1,100.0%,4m
5585,2,[Heroes]PaxAeterna,2974,0,1,0,1,100.0%,2m
5585,2,Weltenfisch,2974,0,1,0,1,100.0%,12m
5585,1,DrMANo,2974,91,1,6,7,14.3%,6m
5585,2,OmarEightTwo,2974,0,0,3,3,0.0%,3m
5595,2,Grod,2973,1356,63,57,120,52.5%,20m
5595,2,huitza,2973,1358,51,51,102,50.0%,3m
5595,2,[hf4X4]Fix,2973,621,24,23,47,51.1%,12m
5595,2,spacemutter,2973,466,16,20,36,44.4%,3m
5595,2,Dixienormous,2973,355,14,8,22,63.6%,9m
5595,2,NtAnxtgenius,2973,260,10,8,18,55.6%,13m
5595,2,Sinfool,2973,147,4,3,7,57.1%,20m
5595,2,SHOEBELL,2973,118,4,7,11,36.4%,11m
5595,2,glhf,2973,30,2,0,2,100.0%,19m
5595,1,Vadim,2973,0,1,0,1,100.0%,32m
5595,2,zaqqum,2973,0,0,1,1,0.0%,28m
5595,1,[BG45]Zarathoustra,2973,0,0,2,2,0.0%,36m
5595,2,MrZorg,2973,0,0,3,3,0.0%,10m
5608,3,spawnferkel,2972,1496,86,96,182,47.3%,10m
5608,3,BigBig,2972,452,69,68,137,50.4%,2m
5608,2,[Bloopz]StormBlooper,2972,869,59,49,108,54.6%,16m
5608,1,[BetJ]JFC,2972,685,23,24,47,48.9%,13m
5608,2,[eXze]fxTRIXERZ,2972,363,15,8,23,65.2%,13m
5608,2,TeamHoneyBee,2972,207,6,5,11,54.5%,13m
5608,1,Rha,2972,212,6,8,14,42.9%,19m
5608,2,[Ирбис]TROLLZZZZZZ,2972,30,5,2,7,71.4%,13m
5608,2,Demetris,2972,0,3,2,5,60.0%,14m
5617,1,Skrippel,2971,864,42,43,85,49.4%,6m
5617,2,Tsalykval,2971,720,27,28,55,49.1%,4m
5617,2,Meech,2971,86,5,6,11,45.5%,13m
5617,1,[BIFFIG]fungahh,2971,48,4,3,7,57.1%,37m
5617,2,Concord,2971,62,3,6,9,33.3%,26m
5617,2,ZerOxOne,2971,0,1,0,1,100.0%,12m
5617,2,inz,2971,0,0,1,1,0.0%,7m
5624,1,elmerFudd,2970,1077,41,39,80,51.2%,28m
5624,1,Bullepower,2970,529,20,23,43,46.5%,7m
5624,2,Xanathos,2970,347,11,8,19,57.9%,1h
5624,2,NSTecTonic,2970,123,5,3,8,62.5%,11m
5624,1,Hitto,2970,0,2,2,4,50.0%,1h
5624,2,[profit]HellothereXD,2970,0,1,1,2,50.0%,3m
5624,2,BKG,2970,0,1,1,2,50.0%,26m
5624,2,Boyington,2970,0,0,1,1,0.0%,12m
5624,2,Sunflower,2970,0,0,1,1,0.0%,20m
5633,1,KurzyPomiot,2969,1473,271,268,539,50.3%,4m
5633,1,[pumps]Aladdin,2969,1662,190,188,378,50.3%,1m
5633,2,DarkMoli,2969,1622,133,130,263,50.6%,4m
5633,2,[MGK]Nicocotier,2969,877,58,47,105,55.2%,1m
5633,1,dio,2969,615,22,23,45,48.9%,7m
5633,1,ich,2969,350,14,14,28,50.0%,16m
5633,2,[Ximic]Mitrofan,2969,315,12,7,19,63.2%,15m
5633,2,[MAIDAN]Fransua,2969,272,10,9,19,52.6%,6m
5633,1,[TIAIA]nagyjan,2969,279,8,10,18,44.4%,11m
5633,2,Cancerbarn,2969,126,3,1,4,75.0%,8m
5633,2,[lOoOl]NoobyDoo,2969,60,2,4,6,33.3%,26m
5633,2,[jpeg]Octozane,2969,30,1,2,3,33.3%,13m
5633,2,qinyme,2969,0,0,1,1,0.0%,9m
5646,1,eagle,2968,1131,86,91,177,48.6%,10m
5646,2,SailorPorky,2968,1437,81,72,153,52.9%,5m
5646,2,[K0RM2]DoKToR,2968,291,11,8,19,57.9%,14m
5646,2,ХрякЕда,2968,232,8,8,16,50.0%,3m
5646,2,[BjwA]Puco,2968,144,6,5,11,54.5%,27m
5646,1,Excitle,2968,154,5,9,14,35.7%,27m
5646,2,Salazar,2968,122,4,4,8,50.0%,3m
5646,2,bronzodia,2968,0,1,0,1,100.0%,3m
5646,2,[UAŦeam]RAM,2968,0,1,0,1,100.0%,3m
5646,1,Azazel,2968,0,0,1,1,0.0%,5m
5656,3,Slevin,2967,1470,175,189,364,48.1%,3m
5656,1,SouldreamXe,2967,633,31,28,59,52.5%,1m
5656,2,HefeWeizen,2967,274,27,23,50,54.0%,12m
5656,1,YopsToDay,2967,530,16,23,39,41.0%,6m
5656,3,whoeveris,2967,335,15,17,32,46.9%,9m
5656,1,EuroStupid,2967,314,10,8,18,55.6%,19m
5656,2,[NigTer]AlexdjEP,2967,252,9,5,14,64.3%,5m
5656,2,[ABOMB]FatMan,2967,234,9,8,17,52.9%,12m
5656,2,BrLeagueHero,2967,178,6,2,8,75.0%,27m
5656,1,HappyMaumau,2967,159,6,7,13,46.2%,1m
5656,2,[BjwA]Foxdonut,2967,58,3,1,4,75.0%,5m
5656,2,[Coons]JanJan,2967,30,2,0,2,100.0%,2m
5656,2,[VaNa]DeeCeeCee,2967,0,2,3,5,40.0%,10m
5656,2,Termy,2967,0,1,0,1,100.0%,6m
5656,2,strech,2967,30,1,4,5,20.0%,15m
5656,2,DrWhimp,2967,0,0,1,1,0.0%,11m
5656,1,Winger,2967,0,0,3,3,0.0%,28m
5673,2,FourTwentyLE,2966,1288,70,63,133,52.6%,4m
5673,2,Kara,2966,957,40,31,71,56.3%,11m
5673,1,FǂAbo,2966,334,30,53,83,36.1%,8m
5673,2,[ZERGTV]IvanGP,2966,603,29,11,40,72.5%,14m
5673,2,llllllllllll,2966,313,14,9,23,60.9%,14m
5673,2,Pil,2966,320,12,11,23,52.2%,15m
5673,1,Kinkade,2966,193,7,3,10,70.0%,2m
5673,2,ENCEaEMIK,2966,154,5,4,9,55.6%,7m
5673,2,Shaftpunk,2966,58,3,4,7,42.9%,11m
5673,2,Anomick,2966,0,1,0,1,100.0%,7m
5683,2,HowHardCanZb,2965,671,26,27,53,49.1%,15m
5683,1,jaimenak,2965,332,15,12,27,55.6%,28m
5683,2,[HACK3R]MatsuPro,2965,164,8,6,14,57.1%,7m
5683,2,[QMnewb]Gringotseru,2965,168,7,5,12,58.3%,15m
5683,3,HuGOo,2965,0,1,0,1,100.0%,18m
5683,2,Darkfeever,2965,0,0,2,2,0.0%,18m
5689,3,Gorthaur,2964,1552,343,344,687,49.9%,2m
5689,1,[EUww1]Andrei,2964,1273,144,122,266,54.1%,2m
5689,2,Xopc,2964,1393,54,52,106,50.9%,13m
5689,1,Nemesis,2964,995,38,45,83,45.8%,8m
5689,2,Spartan,2964,396,14,15,29,48.3%,3m
5689,2,[F3N]Dragoon,2964,30,2,0,2,100.0%,20m
5689,2,Django,2964,102,2,1,3,66.7%,15m
5689,2,Чудик,2964,0,0,1,1,0.0%,10m
5689,3,FrittenPaul,2964,0,0,2,2,0.0%,32m
5689,2,Perpendiculo,2964,0,0,2,2,0.0%,13m
5699,2,[Aw3]Fryday,2963,214,6,5,11,54.5%,14m
5699,1,EvilBeaver,2963,97,4,2,6,66.7%,31m
5699,2,Feligion,2963,0,3,2,5,60.0%,3m
5699,2,fraNk,2963,0,2,3,5,40.0%,20m
5699,2,Criminal,2963,38,2,3,5,40.0%,28m
5699,2,Widar,2963,0,1,0,1,100.0%,17m
5699,2,DrArtanis,2963,0,0,1,1,0.0%,27m
5706,2,Chemiczny,2962,804,29,29,58,50.0%,4m
5706,1,Joles,2962,236,7,11,18,38.9%,7m
5706,1,PinkFloyd,2962,0,4,1,5,80.0%,1h
5706,2,GagaShaggy,2962,104,4,3,7,57.1%,5m
5706,2,Dica,2962,0,3,2,5,60.0%,5m
5706,2,[VBros]wunder,2962,0,2,3,5,40.0%,14m
5706,2,LittleCreepy,2962,0,1,1,2,50.0%,4m
5706,1,[boomer]Ady,2962,0,1,1,2,50.0%,1h
5706,2,Noxm,2962,0,1,4,5,20.0%,4m
5706,2,[Rus37]Max,2962,0,0,1,1,0.0%,3m
5706,3,WakeUp,2962,0,0,1,1,0.0%,18m
5706,2,[scp3]moussaka,2962,0,0,2,2,0.0%,2m
5718,1,ciceron,2961,667,59,66,125,47.2%,17m
5718,2,PinGponGnE,2961,648,33,23,56,58.9%,16m
5718,2,[OPStar]Merciful,2961,454,18,16,34,52.9%,7m
5718,2,kalan,2961,277,13,11,24,54.2%,14m
5718,2,Shev,2961,274,10,13,23,43.5%,17m
5718,1,BorisKrev,2961,359,10,17,27,37.0%,7m
5718,2,[298K]Okarin,2961,248,8,3,11,72.7%,39m
5718,2,veretskii,2961,166,7,5,12,58.3%,2m
5718,2,[JIH]Mařen,2961,140,5,6,11,45.5%,1m
5718,2,Pandarroganz,2961,0,1,1,2,50.0%,17m
5718,2,Laconnex,2961,0,1,2,3,33.3%,26m
5718,2,[Abibas]UberBoec,2961,0,0,1,1,0.0%,27m
5718,2,KruchuVerchu,2961,0,0,1,1,0.0%,21m
5718,2,[ЕST]TaHku,2961,0,0,3,3,0.0%,1h
5732,3,DrAxelWitsel,2960,1533,74,81,155,47.7%,7m
5732,1,RedArmy,2960,442,15,20,35,42.9%,14m
5732,2,[Turtlz]Anonymouz,2960,30,2,2,4,50.0%,7m
5732,1,[VuV]AiGiL,2960,0,1,0,1,100.0%,15m
5732,1,[8701]TrueFinalCry,2960,0,0,1,1,0.0%,36m
5732,2,MarkF,2960,0,0,1,1,0.0%,28m
5732,2,Rvach,2960,0,0,1,1,0.0%,17m
5732,2,Kirigiri,2960,0,0,1,1,0.0%,15m
5740,2,dooznet,2959,504,19,16,35,54.3%,1m
5740,1,CoCoKyJIuTKu,2959,162,8,6,14,57.1%,13m
5740,3,[MGTSC2]Feltini,2959,247,7,7,14,50.0%,24m
5740,2,sTrawHat,2959,226,6,6,12,50.0%,4m
5740,1,JKnightmare,2959,48,2,6,8,25.0%,1h
5740,2,IrinaBruno,2959,30,1,1,2,50.0%,27m
5740,2,palleppesce,2959,0,0,1,1,0.0%,15m
5740,2,Spagheet,2959,0,0,6,6,0.0%,5m
5748,1,[Guidos]CarlO,2958,1489,241,242,483,49.9%,6m
5748,2,[Flexen]NaturTalent,2958,1487,180,172,352,51.1%,28m
5748,1,ClayWaifu,2958,967,66,57,123,53.7%,7m
5748,2,ultra,2958,946,44,34,78,56.4%,10m
5748,2,slap,2958,436,16,14,30,53.3%,14m
5748,2,[NarcoR]SLYOR,2958,227,9,4,13,69.2%,5m
5748,1,[SGEY]TYTY,2958,220,8,12,20,40.0%,10m
5748,2,Smoke,2958,152,5,8,13,38.5%,5m
5748,2,NanaKay,2958,48,2,6,8,25.0%,4m
5748,3,xDontxCryx,2958,97,1,1,2,50.0%,30m
5748,2,cblp,2958,30,1,7,8,12.5%,20m
5748,2,PiedZ,2958,0,0,2,2,0.0%,12m
5760,1,Sarge,2957,1428,132,132,264,50.0%,15m
5760,1,Damandred,2957,1592,121,114,235,51.5%,8m
5760,2,QuirkyToss,2957,294,18,12,30,60.0%,7m
5760,1,waldymarxtnf,2957,271,11,10,21,52.4%,7m
5760,2,reusch,2957,174,7,10,17,41.2%,17m
5760,2,NoobSCII,2957,86,4,7,11,36.4%,14m
5760,2,Maxu,2957,88,2,0,2,100.0%,26m
5760,1,KMarch,2957,103,2,5,7,28.6%,19m
5760,2,Ranafein,2957,0,1,0,1,100.0%,28m
5760,1,[iF]Darshu,2957,0,1,0,1,100.0%,17m
5760,2,[PlAr]akhileus,2957,30,1,1,2,50.0%,14m
5760,2,Amadeus,2957,30,1,2,3,33.3%,5m
5760,2,RizeN,2957,0,0,1,1,0.0%,26m
5773,2,[НОД17]Eagle,2956,942,66,55,121,54.5%,9m
5773,2,Forsaken,2956,337,17,14,31,54.8%,10m
5773,1,[K0mpis]Robzki,2956,526,17,20,37,45.9%,10m
5773,2,lIlIlIlIlIlI,2956,223,6,11,17,35.3%,14m
5773,2,motoros,2956,0,4,0,4,100.0%,29m
5773,1,StormzBG,2956,97,4,2,6,66.7%,38m
5773,1,[eSGs]Dekbedhoes,2956,48,4,3,7,57.1%,9m
5773,1,[FYBF]Archstefesis,2956,46,1,1,2,50.0%,32m
5773,2,Ostmärker,2956,0,0,1,1,0.0%,14m
5782,3,Itachi,2955,820,68,70,138,49.3%,10m
5782,1,[6Gears]Antoma,2955,1239,44,47,91,48.4%,28m
5782,2,[1000]Joystick,2955,223,9,6,15,60.0%,15m
5782,3,HaTiko,2955,145,6,5,11,54.5%,31m
5782,2,gepardy,2955,191,6,5,11,54.5%,1m
5782,1,DNSoul,2955,145,5,3,8,62.5%,38m
5782,1,CloudBoi,2955,117,5,6,11,45.5%,35m
5782,1,[DSKone]GIMIK,2955,97,4,3,7,57.1%,39m
5782,2,[LLAP]Nostromo,2955,128,3,2,5,60.0%,11m
5782,2,[SCJS]Jacky,2955,0,0,3,3,0.0%,11m
5792,2,enkarito,2954,1052,50,44,94,53.2%,28m
5792,2,Resistance,2954,325,17,19,36,47.2%,2m
5792,1,Greengimp,2954,361,11,13,24,45.8%,15m
5792,2,[ƬC]WraithCraft,2954,203,8,3,11,72.7%,3m
5792,2,PMT,2954,92,6,3,9,66.7%,14m
5792,2,[TheDOH]NemesisBoY,2954,152,5,2,7,71.4%,1m
5792,1,CARTMAN,2954,192,5,16,21,23.8%,4m
5792,2,Energy,2954,62,3,7,10,30.0%,4m
5792,2,[h0mos]death,2954,90,3,8,11,27.3%,13m
5792,2,TRIL,2954,86,3,8,11,27.3%,16m
5792,2,[Shr3Kd]MeNeSbatto,2954,0,1,0,1,100.0%,27m
5792,2,Tyrios,2954,0,1,1,2,50.0%,10m
5792,2,[696]llllllllllll,2954,30,1,2,3,33.3%,4m
5792,2,Breeze,2954,0,0,2,2,0.0%,11m
5806,1,[ZЕRGML]Strangerxxx,2953,745,67,68,135,49.6%,14m
5806,2,[Harley]Liberty,2953,443,18,17,35,51.4%,15m
5806,1,[OpSun]mAdmAze,2953,345,13,9,22,59.1%,18m
5806,2,SkyTossOP,2953,94,2,1,3,66.7%,21m
5806,2,STarVation,2953,30,1,4,5,20.0%,5m
5811,1,VReal,2952,1216,49,44,93,52.7%,28m
5811,1,Fesch,2952,1147,44,40,84,52.4%,10m
5811,2,БаРкОд,2952,576,27,20,47,57.4%,10m
5811,2,RinGO,2952,342,14,8,22,63.6%,27m
5811,2,SixPooL,2952,120,3,1,4,75.0%,5m
5811,2,[Batmen]PongLenis,2952,58,3,2,5,60.0%,27m
5811,1,[vHr]niiBeR,2952,0,0,4,4,0.0%,20m
5818,2,[JINX]SokoOne,2951,828,67,5,72,93.1%,27m
5818,2,Warlord,2951,671,28,23,51,54.9%,12m
5818,1,[мрази]Алинадурында,2951,350,13,11,24,54.2%,1h
5818,1,Xiteld,2951,145,6,3,9,66.7%,32m
5818,2,Argy,2951,148,6,6,12,50.0%,1m
5818,2,[xBBCx]Heliz,2951,121,5,5,10,50.0%,1h
5818,1,lelutin,2951,152,5,13,18,27.8%,18m
5818,2,zet,2951,119,4,2,6,66.7%,19m
5818,2,HuugeNOOB,2951,112,3,1,4,75.0%,1m
5818,2,[JTH]schneemarco,2951,0,3,2,5,60.0%,24m
5828,3,julio,2950,1306,65,73,138,47.1%,14m
5828,2,Ray,2950,438,17,14,31,54.8%,9m
5828,3,[theDH]Hetman,2950,408,17,19,36,47.2%,3m
5828,2,Resko,2950,320,10,8,18,55.6%,26m
5828,2,[Torby]STINGER,2950,204,9,2,11,81.8%,10m
5828,1,SHEnin,2950,48,4,4,8,50.0%,19m
5828,2,[KHY]kanen,2950,0,3,2,5,60.0%,33m
5828,2,trollkarl,2950,0,3,3,6,50.0%,26m
5836,2,Callum,2949,1228,128,106,234,54.7%,15m
5836,2,Tobi,2949,1142,47,36,83,56.6%,11m
5836,1,Callesen,2949,1089,39,41,80,48.8%,8m
5836,2,DAAS,2949,610,26,16,42,61.9%,9m
5836,1,Haneikut,2949,700,22,29,51,43.1%,18m
5836,2,[BGpk]packo,2949,388,19,16,35,54.3%,28m
5836,2,Ssinxdy,2949,528,18,21,39,46.2%,13m
5836,2,Pakowa,2949,284,12,8,20,60.0%,14m
5836,3,Geko,2949,195,6,11,17,35.3%,19m
5836,1,FrmUndaChees,2949,97,4,2,6,66.7%,2m
5836,3,[EUww1]CorvetteCorp,2949,62,4,11,15,26.7%,17m
5836,2,DIVERSANT,2949,62,3,4,7,42.9%,5m
5836,1,soyCowboy,2949,94,2,2,4,50.0%,1h
5836,1,[Regnum]DokwoN,2949,97,1,1,2,50.0%,7m
5850,1,Pencroff,2948,1614,206,205,411,50.1%,28m
5850,1,Aronakss,2948,1437,84,69,153,54.9%,11m
5850,2,[WTF]cocooow,2948,1508,72,45,117,61.5%,14m
5850,2,Himera,2948,1352,58,54,112,51.8%,27m
5850,3,Nathaviel,2948,428,20,28,48,41.7%,3m
5850,2,Arashtoi,2948,170,8,3,11,72.7%,11m
5850,1,[ORLCY]NickAce,2948,122,4,6,10,40.0%,19m
5850,2,[BPPS]MoltenPucki,2948,126,3,2,5,60.0%,4m
5850,2,Matos,2948,0,3,2,5,60.0%,3m
5850,2,Sebien,2948,114,2,2,4,50.0%,5m
5860,1,Burzok,2947,825,75,77,152,49.3%,28m
5860,3,Alex,2947,1406,75,78,153,49.0%,10m
5860,3,dgz,2947,1425,72,76,148,48.6%,6m
5860,3,MrFister,2947,878,59,74,133,44.4%,12m
5860,1,XioX,2947,1305,49,53,102,48.0%,5m
5860,3,OsirUs,2947,174,12,11,23,52.2%,2m
5860,1,Viktorio,2947,264,10,12,22,45.5%,13m
5860,2,[Lort]GypsyKing,2947,286,9,10,19,47.4%,31m
5860,3,testdetruc,2947,209,8,6,14,57.1%,20m
5860,3,Alchemist,2947,129,3,1,4,75.0%,21m
5860,2,Jelmer,2947,102,2,2,4,50.0%,3m
5860,2,[rages]Chewbacca,2947,0,0,2,2,0.0%,1h
5872,2,KoshNaranek,2946,182,7,2,9,77.8%,10m
5872,2,[GnW]EniDead,2946,119,5,1,6,83.3%,13m
5872,1,Вениамин,2946,100,5,4,9,55.6%,7m
5872,1,[MDLB]lNFERNO,2946,0,4,2,6,66.7%,1h
5872,2,Jorun,2946,154,4,2,6,66.7%,1h
5872,2,[isMVP]subzero,2946,88,3,2,5,60.0%,26m
5872,2,DANIL,2946,0,2,3,5,40.0%,19m
5872,2,Cyclops,2946,30,1,2,3,33.3%,3m
5872,2,noCtrL,2946,0,0,1,1,0.0%,4m
5881,2,Kaofael,2945,1579,88,72,160,55.0%,5m
5881,2,ZinG,2945,852,32,29,61,52.5%,11m
5881,2,SnikerSnikS,2945,344,12,10,22,54.5%,3m
5881,2,Evgeniy,2945,244,12,16,28,42.9%,13m
5881,2,Rico,2945,266,11,7,18,61.1%,2m
5881,1,Yarmaul,2945,283,10,3,13,76.9%,33m
5881,1,menyak,2945,143,5,1,6,83.3%,1h
5881,2,[FENIKS]Imbech,2945,88,4,3,7,57.1%,4m
5881,2,Degenerał,2945,0,1,0,1,100.0%,14m
5881,1,Ebukentiy,2945,0,1,0,1,100.0%,1h
5881,2,biverVs,2945,0,1,1,2,50.0%,5m
5892,1,Ruise,2944,1572,57,61,118,48.3%,27m
5892,2,Purifier,2944,409,39,25,64,60.9%,20m
5892,2,Forti,2944,776,27,29,56,48.2%,13m
5892,2,[Floren]Cakisco,2944,606,23,19,42,54.8%,27m
5892,2,sensii,2944,201,7,6,13,53.8%,14m
5892,2,Tiep,2944,164,4,4,8,50.0%,28m
5892,3,evdosius,2944,145,3,2,5,60.0%,27m
5892,2,klodreaver,2944,0,3,2,5,60.0%,32m
5892,2,Edorock,2944,0,1,0,1,100.0%,20m
5892,2,KrekeN,2944,88,1,1,2,50.0%,20m
5892,2,BloodCloud,2944,30,1,4,5,20.0%,13m
5892,2,Smoke,2944,0,0,1,1,0.0%,9m
5904,2,WarBuffett,2943,1047,56,41,97,57.7%,13m
5904,2,zalupich,2943,471,37,33,70,52.9%,4m
5904,1,TPmfgZG,2943,463,16,19,35,45.7%,14m
5904,2,HailToKing,2943,262,9,14,23,39.1%,6m
5904,2,deadpool,2943,141,5,1,6,83.3%,26m
5904,1,NicoBUISSON,2943,0,4,3,7,57.1%,1h
5904,2,SCVready,2943,108,4,3,7,57.1%,14m
5904,2,jurgen,2943,0,2,3,5,40.0%,5m
5904,2,Imissmycat,2943,88,2,4,6,33.3%,5m
5904,1,GhostDog,2943,0,1,0,1,100.0%,38m
5904,2,[RGSC2]StraTov,2943,0,1,0,1,100.0%,9m
5904,2,MrSpy,2943,88,1,1,2,50.0%,14m
5904,2,[CIMI]Saribanum,2943,0,0,1,1,0.0%,14m
5917,2,kid,2942,928,44,28,72,61.1%,20m
5917,1,Vechtmeneer,2942,1070,36,42,78,46.2%,8m
5917,2,RIPHarambe,2942,519,22,14,36,61.1%,7m
5917,2,Medusa,2942,203,12,10,22,54.5%,5m
5917,2,ZakalibdoR,2942,146,10,7,17,58.8%,16m
5917,3,[Hitech]Prime,2942,187,7,7,14,50.0%,21m
5917,2,Tarasz,2942,167,5,2,7,71.4%,4m
5917,2,Dizzydi,2942,142,5,3,8,62.5%,27m
5917,2,Korvin,2942,102,5,3,8,62.5%,27m
5917,2,HUNTER,2942,0,3,2,5,60.0%,17m
5917,2,Kujira,2942,0,0,3,3,0.0%,5m
5928,2,Laura,2941,1604,111,111,222,50.0%,26m
5928,1,[15ANS]TikiBoom,2941,1164,43,48,91,47.3%,8m
5928,2,[SC2SPB]Ila,2941,1068,40,40,80,50.0%,17m
5928,2,LovCassoulet,2941,273,19,15,34,55.9%,12m
5928,2,Yeti,2941,355,15,13,28,53.6%,3m
5928,2,[FUSB]Samxtar,2941,350,12,11,23,52.2%,16m
5928,2,Rainor,2941,233,8,7,15,53.3%,4m
5928,2,Hellraven,2941,118,5,5,10,50.0%,7m
5928,2,[Pu238]Ryoshi,2941,0,0,1,1,0.0%,1m
5928,2,Гдетыбыл,2941,0,0,1,1,0.0%,3m
5928,2,FoxFord,2941,0,0,2,2,0.0%,10m
5939,2,rag,2940,1472,124,122,246,50.4%,26m
5939,1,Macheengun,2940,1244,98,84,182,53.8%,8m
5939,1,BolDeMorve,2940,1243,79,82,161,49.1%,10m
5939,2,Devil,2940,1499,69,57,126,54.8%,15m
5939,2,rogana,2940,643,27,20,47,57.4%,10m
5939,1,Monochrome,2940,614,21,25,46,45.7%,14m
5939,2,Leembo,2940,554,19,25,44,43.2%,28m
5939,2,Frywind,2940,243,11,8,19,57.9%,14m
5939,2,Csr,2940,88,6,5,11,54.5%,3m
5939,1,SadMarine,2940,0,1,0,1,100.0%,35m
5939,2,Wandereule,2940,0,0,1,1,0.0%,19m
5939,2,sabrE,2940,0,0,2,2,0.0%,6m
5939,2,[041074]Milko,2940,0,0,3,3,0.0%,27m
5952,2,[TrrTrr]plar,2939,665,23,22,45,51.1%,5m
5952,1,BeBeZiaNa,2939,275,13,7,20,65.0%,13m
5952,2,gumbold,2939,175,6,1,7,85.7%,9m
5952,2,XantiXae,2939,114,5,3,8,62.5%,10m
5952,3,Lavos,2939,144,4,5,9,44.4%,29m
5952,2,JTR,2939,0,3,2,5,60.0%,29m
5952,2,Metalbrain,2939,0,1,0,1,100.0%,20m
5952,2,SoloTurk,2939,0,1,1,2,50.0%,29m
5952,2,[THMU]Colorise,2939,42,1,4,5,20.0%,1h
5961,2,[team09]MechItHappen,2938,1284,59,42,101,58.4%,15m
5961,2,Öööö,2938,387,19,6,25,76.0%,5m
5961,2,eazY,2938,404,18,9,27,66.7%,4m
5961,2,[Brgman]Coleman,2938,206,9,2,11,81.8%,20m
5961,2,LurryFan,2938,212,7,6,13,53.8%,2m
5961,2,yuyules,2938,147,4,5,9,44.4%,4m
5961,2,MasterLEXA,2938,0,3,2,5,60.0%,32m
5961,2,[KsL]SuLTaN,2938,140,3,3,6,50.0%,5m
5961,2,бог,2938,0,2,1,3,66.7%,26m
5961,2,DoctorDuncan,2938,58,2,3,5,40.0%,14m
5961,2,Blaubär,2938,0,0,1,1,0.0%,16m
5972,1,Zyklus,2937,416,13,23,36,36.1%,28m
5972,2,grushan,2937,217,9,8,17,52.9%,1h
5972,2,POR,2937,88,4,2,6,66.7%,3m
5972,1,Despacity,2937,110,3,7,10,30.0%,5m
5972,2,BloodyDancer,2937,114,2,2,4,50.0%,13m
5977,2,HaveFun,2936,562,23,21,44,52.3%,20m
5977,2,RTS,2936,425,18,11,29,62.1%,26m
5977,1,cannonrusher,2936,453,15,19,34,44.1%,28m
5977,1,[SoulP]NicO,2936,424,13,19,32,40.6%,11m
5977,2,[Penza]regar,2936,249,10,6,16,62.5%,11m
5977,2,Battlebeast,2936,92,3,4,7,42.9%,11m
5977,2,Rais,2936,0,2,3,5,40.0%,1h
5977,3,[glhf20]Ṥậṱằṁӑӣ,2936,0,1,2,3,33.3%,2m
5977,1,[COCHON]LapinRose,2936,48,1,2,3,33.3%,1h
5977,2,sayes,2936,0,0,1,1,0.0%,14m
5977,2,[OESTE]AyNuRCiLLo,2936,0,0,2,2,0.0%,13m
5988,2,Nobody,2935,1422,106,103,209,50.7%,19m
5988,2,StarWarrior,2935,169,7,3,10,70.0%,5m
5988,2,[NiGL]Demarkus,2935,152,5,9,14,35.7%,13m
5988,2,terminator,2935,0,0,1,1,0.0%,5m
5988,2,DoDo,2935,0,0,2,2,0.0%,5m
5993,3,frenao,2934,1174,47,50,97,48.5%,6m
5993,2,OhWhy,2934,403,23,19,42,54.8%,20m
5993,2,[Eagls]Ocula,2934,577,23,25,48,47.9%,14m
5993,3,[Fenzy]Humblegar,2934,629,22,24,46,47.8%,3m
5993,2,Dancore,2934,394,18,9,27,66.7%,2m
5993,2,[x2G]shadow,2934,417,16,14,30,53.3%,17m
5993,2,[xĐяeaм]SPOMii,2934,357,12,12,24,50.0%,5m
5993,2,[SVGS]RAPHYIR,2934,0,4,2,6,66.7%,4m
5993,2,Vargen,2934,0,3,2,5,60.0%,1h
5993,2,Trauma,2934,131,3,5,8,37.5%,1h
5993,2,[dLife1]RainBOw,2934,30,3,5,8,37.5%,15m
5993,2,Rugedas,2934,0,1,0,1,100.0%,11m
5993,2,costin,2934,0,1,1,2,50.0%,3m
5993,2,Moonlight,2934,0,1,4,5,20.0%,13m
5993,2,Bidet,2934,0,0,1,1,0.0%,19m
6008,2,[Brah]Supergoon,2933,437,23,19,42,54.8%,5m
6008,3,Gray,2933,0,5,0,5,100.0%,13m
6008,1,TothyColonel,2933,0,4,2,6,66.7%,37m
6008,2,[ReDo]RaZZOOM,2933,162,4,4,8,50.0%,1h
6008,2,Zedryx,2933,30,2,5,7,28.6%,13m
6008,2,prnZ,2933,60,2,7,9,22.2%,1m
6008,3,CaptainSalt,2933,0,2,8,10,20.0%,20m
6008,2,Ceder,2933,0,1,1,2,50.0%,1h
6008,2,BloOdǂSoun,2933,0,1,2,3,33.3%,3m
6008,1,TooLazy,2933,0,1,3,4,25.0%,39m
6018,2,Psyduck,2932,1107,70,70,140,50.0%,9m
6018,3,RainTeller,2932,549,45,49,94,47.9%,28m
6018,2,ipopotem,2932,978,39,40,79,49.4%,14m
6018,2,[Cannоn]Lukas,2932,420,15,18,33,45.5%,26m
6018,2,Shaggy,2932,294,11,12,23,47.8%,27m
6018,2,[Azimut]Morgoth,2932,250,9,12,21,42.9%,6m
6018,3,[DZTK]zergbräter,2932,0,1,0,1,100.0%,7m
6018,2,Skinner,2932,0,1,3,4,25.0%,28m
6018,2,Игнезис,2932,0,0,2,2,0.0%,10m
6027,2,[E1VDC]Kayvan,2931,1543,125,121,246,50.8%,2m
6027,1,cocooow,2931,660,37,48,85,43.5%,6m
6027,3,[NSJLM]Smidarok,2931,284,8,9,17,47.1%,11m
6027,2,NoMatter,2931,119,6,5,11,54.5%,1h
6027,1,[VZON]Frisk,2931,0,4,3,7,57.1%,14m
6027,3,Furzknoten,2931,97,4,4,8,50.0%,4m
6027,3,gincha,2931,0,2,2,4,50.0%,3m
6027,2,[decoy]dib,2931,120,1,4,5,20.0%,3m
6035,1,LoVeIsInTAiR,2930,1168,89,92,181,49.2%,7m
6035,2,Jast,2930,434,35,32,67,52.2%,26m
6035,1,Тимур,2930,1016,35,42,77,45.5%,4m
6035,2,Nikon,2930,335,13,13,26,50.0%,7m
6035,3,[GdAT]Ciclyde,2930,244,7,9,16,43.8%,8m
6035,1,NEOnik,2930,158,5,16,21,23.8%,8m
6035,2,[REDFOX]Faneco,2930,30,4,3,7,57.1%,3m
6035,3,UwU,2930,140,4,4,8,50.0%,10m
6035,3,StaryKomuch,2930,0,3,2,5,60.0%,12m
6035,3,KnackTwoBaby,2930,125,3,3,6,50.0%,36m
6035,3,HolzPirat,2930,97,3,7,10,30.0%,1h
6035,3,[Jürgen]andiS,2930,30,2,0,2,100.0%,14m
6035,2,Ringelsocke,2930,0,2,1,3,66.7%,32m
6035,2,[Tripin]SiCKO,2930,93,2,2,4,50.0%,12m
6035,2,DerFrosch,2930,30,1,6,7,14.3%,13m
6050,1,FannyFart,2929,1557,142,103,245,58.0%,12m
6050,1,ITACHI,2929,678,47,45,92,51.1%,3m
6050,2,[FLYTT]IIIIIIIIIIII,2929,160,12,4,16,75.0%,28m
6050,3,Hjarsta,2929,116,6,5,11,54.5%,1h
6050,3,Zmajmun,2929,145,4,2,6,66.7%,1h
6050,2,Daniel,2929,0,3,2,5,60.0%,38m
6050,3,stepaXgg,2929,0,1,0,1,100.0%,9m
6050,2,SokolDV,2929,0,1,1,2,50.0%,7m
6050,2,Razmetka,2929,30,1,9,10,10.0%,20m
6059,1,[HBGSJR]stepanator,2928,780,61,53,114,53.5%,19m
6059,1,Vestnik,2928,419,26,27,53,49.1%,7m
6059,2,RoManHD,2928,598,24,24,48,50.0%,13m
6059,2,HeyHoLetsGo,2928,379,13,14,27,48.1%,21m
6059,2,StormWolf,2928,192,10,7,17,58.8%,20m
6059,3,[Navvy]Egon,2928,231,9,5,14,64.3%,13m
6059,1,Arthur,2928,97,4,3,7,57.1%,1h
6059,2,[Bizim]Thork,2928,30,3,5,8,37.5%,13m
6067,1,myth,2927,1370,120,124,244,49.2%,11m
6067,1,glandosaure,2927,847,32,38,70,45.7%,6m
6067,2,[IMoGsP]trollman,2927,522,23,9,32,71.9%,5m
6067,2,[37ers]Biercarsten,2927,385,15,13,28,53.6%,20m
6067,2,Menos,2927,64,2,8,10,20.0%,6m
6067,2,[BDHR]Omegalul,2927,30,1,4,5,20.0%,13m
6067,3,SpaceFREEZER,2927,0,0,1,1,0.0%,7m
6067,3,SargentoHek,2927,0,0,1,1,0.0%,3m
6067,1,[ſŧłǂƻ]DrBerst,2927,0,0,4,4,0.0%,32m
6076,1,Lumar,2926,1419,62,60,122,50.8%,15m
6076,2,[SUZUKI]Costin,2926,644,44,40,84,52.4%,2m
6076,2,Ragnar,2926,804,29,33,62,46.8%,13m
6076,3,rotn,2926,341,14,4,18,77.8%,13m
6076,3,Sanguinius,2926,145,6,5,11,54.5%,14m
6076,3,[Еда]РазПелмень,2926,0,4,1,5,80.0%,6m
6076,2,frikadello,2926,30,2,3,5,40.0%,17m
6076,1,Topimo,2926,102,2,4,6,33.3%,14m
6076,3,nalole,2926,0,0,1,1,0.0%,11m
6076,3,Tanis,2926,0,0,1,1,0.0%,11m
6086,1,FarshMaster,2925,1468,97,87,184,52.7%,5m
6086,3,Jakut,2925,987,61,64,125,48.8%,13m
6086,2,Vypeer,2925,606,24,20,44,54.5%,14m
6086,1,[QaDo]bog,2925,334,12,13,25,48.0%,2m
6086,3,[DrPlat]Paer,2925,270,10,8,18,55.6%,8m
6086,2,Khaolin,2925,238,9,14,23,39.1%,19m
6086,3,djaba,2925,183,7,7,14,50.0%,1h
6086,1,Kalyan,2925,192,5,2,7,71.4%,15m
6086,1,[РОб]Jylik,2925,97,4,3,7,57.1%,18m
6086,2,Kuru,2925,122,4,7,11,36.4%,27m
6086,2,[apeiro]Fraukenstein,2925,66,3,3,6,50.0%,19m
6086,3,GeoGeo,2925,30,2,0,2,100.0%,10m
6086,2,Antho,2925,0,1,0,1,100.0%,1h
6086,3,LeMonLinK,2925,0,0,1,1,0.0%,17m
6086,3,[BRock]Guanty,2925,0,0,1,1,0.0%,13m
6101,1,[A0P]Tanatheld,2924,937,36,36,72,50.0%,2m
6101,3,Froze,2924,221,15,2,17,88.2%,10m
6101,2,Morose,2924,102,4,4,8,50.0%,5m
6101,2,[USSR02]LoLiK,2924,0,3,2,5,60.0%,1m
6101,3,[SSC2]Stratocaster,2924,30,2,0,2,100.0%,2m
6101,1,Crean,2924,97,2,1,3,66.7%,12m
6101,3,Странный,2924,0,1,0,1,100.0%,28m
6101,3,[DМG]BerryBee,2924,0,1,0,1,100.0%,13m
6101,3,[GORPE]Grotteaalen,2924,0,1,1,2,50.0%,4m
6101,3,IlIlIlIlIIlI,2924,0,0,1,1,0.0%,17m
6101,3,[L2ERS]Hor,2924,0,0,1,1,0.0%,16m
6112,2,memorex,2923,535,23,16,39,59.0%,4m
6112,2,zandR,2923,462,17,18,35,48.6%,17m
6112,2,IIIIIIIIIII,2923,306,12,8,20,60.0%,6m
6112,2,IrdisDevil,2923,289,9,10,19,47.4%,1m
6112,2,RedMag,2923,188,6,4,10,60.0%,6m
6112,1,nomadoda,2923,190,5,16,21,23.8%,3m
6112,2,[DLGP]LeftMan,2923,0,3,2,5,60.0%,35m
6112,2,cykalord,2923,0,2,3,5,40.0%,6m
6112,2,pilgrimoth,2923,0,1,1,2,50.0%,4m
6112,3,[DМG]Gaiety,2923,0,0,1,1,0.0%,19m
6122,2,LImE,2922,434,20,10,30,66.7%,10m
6122,2,Banan,2922,476,19,18,37,51.4%,10m
6122,2,logonihiht,2922,378,18,14,32,56.2%,27m
6122,3,Blaiize,2922,115,5,2,7,71.4%,9m
6122,2,РыцарьРейха,2922,88,5,2,7,71.4%,20m
6122,3,BlueBandit,2922,0,3,2,5,60.0%,20m
6122,2,HonkyMonky,2922,0,2,3,5,40.0%,38m
6122,2,HEKPOMAHT,2922,0,1,1,2,50.0%,20m
6122,3,SpaceRanger,2922,0,1,4,5,20.0%,12m
6122,2,Shakes,2922,0,1,5,6,16.7%,17m
6132,2,[Сыр]NecroLoli,2921,236,9,11,20,45.0%,7m
6132,2,Zankage,2921,90,3,6,9,33.3%,20m
6132,3,[PaniC]BeMole,2921,0,1,1,2,50.0%,11m
6132,2,tole,2921,0,0,3,3,0.0%,20m
6136,3,AlexThunder,2920,599,138,134,272,50.7%,14m
6136,3,DANGER,2920,786,76,85,161,47.2%,19m
6136,2,poggy,2920,645,39,39,78,50.0%,10m
6136,2,AuxiLeCookie,2920,814,30,31,61,49.2%,27m
6136,2,[HBGSJR]qwaqsha,2920,290,11,8,19,57.9%,19m
6136,2,[GG2020]Dragora,2920,190,7,7,14,50.0%,3m
6136,3,[1GH1]Alfastigma,2920,0,0,2,2,0.0%,1h
6143,1,timi,2919,1487,109,121,230,47.4%,16m
6143,2,MrT,2919,399,17,14,31,54.8%,15m
6143,2,Gnoba,2919,467,16,24,40,40.0%,14m
6143,1,[Narnia]JustinReaper,2919,321,12,12,24,50.0%,9m
6143,2,Smartboy,2919,209,8,5,13,61.5%,20m
6143,2,Daemos,2919,152,4,4,8,50.0%,10m
6143,2,PityPang,2919,0,1,2,3,33.3%,27m
6143,2,[Kompis]PlatinumYoda,2919,88,1,2,3,33.3%,17m
6143,2,IvO,2919,0,0,3,3,0.0%,28m
6152,3,Anti,2918,1241,207,209,416,49.8%,14m
6152,1,NoLogic,2918,1076,153,149,302,50.7%,7m
6152,2,Kotik,2918,1334,53,51,104,51.0%,15m
6152,2,GreenGenyó,2918,228,10,6,16,62.5%,5m
6152,2,Philosophe,2918,58,5,4,9,55.6%,13m
6152,3,muk,2918,114,4,3,7,57.1%,20m
6152,2,wowo,2918,90,4,4,8,50.0%,14m
6152,3,[ZARAKI]StarEater,2918,0,3,2,5,60.0%,28m
6152,2,Vaaco,2918,60,2,8,10,20.0%,11m
6161,1,[Degab]DEFEHUN,2917,733,39,42,81,48.1%,12m
6161,2,[QTclub]YoAnSingSong,2917,628,22,23,45,48.9%,9m
6161,2,[DТ]BeelzeBul,2917,433,18,16,34,52.9%,17m
6161,3,[P0NY]MysterySkull,2917,0,3,2,5,60.0%,12m
6161,3,[MioInc]MioDrank,2917,0,3,2,5,60.0%,11m
6161,3,MonsterKIR,2917,0,3,2,5,60.0%,28m
6161,2,[IIuBo]KickOFF,2917,0,1,0,1,100.0%,31m
6168,3,Marine,2916,1586,70,55,125,56.0%,10m
6168,2,Strahu,2916,1338,56,54,110,50.9%,14m
6168,3,Ragnaro,2916,670,24,23,47,51.1%,3m
6168,2,RitUga,2916,216,11,10,21,52.4%,11m
6168,2,OPturtle,2916,104,2,2,4,50.0%,27m
6168,2,Magicadam,2916,0,2,4,6,33.3%,11m
6168,2,Sharadur,2916,0,1,0,1,100.0%,1h
6168,2,Hervé,2916,0,0,4,4,0.0%,13m
6176,2,[Put05]Sephiroth,2915,738,29,36,65,44.6%,12m
6176,3,[JotC]Calamitavia,2915,712,28,16,44,63.6%,13m
6176,2,[Snax]crsy,2915,384,21,25,46,45.7%,28m
6176,3,Beckha,2915,518,19,14,33,57.6%,17m
6176,2,[СКИЛЫ]Aleksmas,2915,280,9,15,24,37.5%,15m
6176,1,[hängA]kuPsen,2915,208,7,15,22,31.8%,28m
6176,3,[aviEU2]aviloSoAmaze,2915,0,3,2,5,60.0%,2m
6176,2,Thundor,2915,0,3,2,5,60.0%,13m
6176,3,[mfxed]MioFx,2915,0,1,0,1,100.0%,2m
6176,3,TritonPL,2915,0,0,1,1,0.0%,21m
6186,1,ImCharliCooL,2914,1634,166,166,332,50.0%,6m
6186,1,Teg,2914,1617,104,85,189,55.0%,19m
6186,2,LuţăAgresoru,2914,46,4,2,6,66.7%,1h
6186,2,[900iq]veloci,2914,145,4,4,8,50.0%,1h
6186,1,HellraiZR,2914,121,2,8,10,20.0%,1h
6191,2,DrZogg,2913,406,14,15,29,48.3%,6m
6191,2,TotalCreep,2913,400,14,16,30,46.7%,2m
6191,2,Zero,2913,369,14,19,33,42.4%,3m
6191,2,Pavlova,2913,90,3,6,9,33.3%,4m
6195,3,Monochrome,2912,939,74,42,116,63.8%,6m
6195,1,Lorandil,2912,451,51,47,98,52.0%,9m
6195,2,[PARCE]Niloc,2912,504,20,26,46,43.5%,11m
6195,2,Walknort,2912,482,19,19,38,50.0%,13m
6195,1,[TRMNT]NahkaÄpärä,2912,441,15,20,35,42.9%,12m
6195,2,Crystalize,2912,270,9,4,13,69.2%,1h
6195,3,Keeyang,2912,0,4,1,5,80.0%,20m
6195,2,[WINT]Baluu,2912,0,3,3,6,50.0%,13m
6203,2,Woland,2911,1602,63,60,123,51.2%,20m
6203,2,[alu]uvran,2911,906,33,32,65,50.8%,9m
6203,2,Sanity,2911,346,13,14,27,48.1%,14m
6203,2,besik,2911,360,12,17,29,41.4%,17m
6203,2,[ClDlN]TotalBWord,2911,262,9,8,17,52.9%,3m
6203,2,Devastator,2911,142,5,2,7,71.4%,4m
6203,3,[ZPasta]AroNal,2911,0,1,0,1,100.0%,12m
6203,2,Auri,2911,0,0,4,4,0.0%,12m
6211,2,Einstein,2910,1096,42,48,90,46.7%,14m
6211,3,Winner,2910,152,19,13,32,59.4%,2m
6211,2,Ilya,2910,0,3,2,5,60.0%,1h
6211,3,[BnKy]KiNGTETC,2910,88,3,4,7,42.9%,5m
6211,3,Pol,2910,30,2,0,2,100.0%,26m
6216,2,[EMRS]Graps,2909,782,78,68,146,53.4%,17m
6216,1,Gallkeeper,2909,250,8,9,17,47.1%,1h
6216,3,mikeynoob,2909,199,7,8,15,46.7%,6m
6216,2,Spurcius,2909,154,5,9,14,35.7%,19m
6216,3,DedSpace,2909,0,3,2,5,60.0%,12m
6216,3,Kavaleon,2909,0,1,0,1,100.0%,13m
6216,3,[vi2018]Panzone,2909,0,0,1,1,0.0%,27m
6223,1,Espelurius,2908,1496,297,303,600,49.5%,8m
6223,2,Jayminator,2908,1012,161,147,308,52.3%,4m
6223,2,WiKkee,2908,763,65,64,129,50.4%,10m
6223,2,[aTw]Ash,2908,720,30,26,56,53.6%,5m
6223,2,[NSBM]Mandalore,2908,567,23,21,44,52.3%,27m
6223,2,KoZ,2908,219,7,8,15,46.7%,3m
6223,1,Blossom,2908,208,7,14,21,33.3%,19m
6223,2,Joker,2908,178,5,6,11,45.5%,14m
6223,2,altushka,2908,140,5,8,13,38.5%,37m
6223,2,TcL,2908,0,2,4,6,33.3%,15m
6223,1,Drachenfeuer,2908,97,2,5,7,28.6%,39m
6223,2,phantom,2908,0,1,0,1,100.0%,26m
6223,2,Tatara,2908,0,0,3,3,0.0%,10m
6236,2,SimakinK,2907,1567,95,100,195,48.7%,20m
6236,2,Tiberium,2907,340,14,11,25,56.0%,20m
6236,3,TheNewOne,2907,338,13,9,22,59.1%,2m
6236,2,Selmo,2907,90,8,3,11,72.7%,6m
6236,3,Arbiter,2907,192,6,6,12,50.0%,7m
6236,1,KikiOG,2907,191,5,8,13,38.5%,22m
6236,2,ForAiur,2907,158,4,6,10,40.0%,20m
6236,1,MjuTaS,2907,0,3,3,6,50.0%,4m
6244,2,[NvRmNd]Tweedeldum,2906,497,21,15,36,58.3%,6m
6244,2,[LIQUID]IgorZ,2906,466,16,19,35,45.7%,2m
6244,3,[HeiTim]Schokobubi,2906,310,12,7,19,63.2%,3m
6244,3,[MrCnR]Broxor,2906,296,11,3,14,78.6%,28m
6244,2,Qnugg,2906,341,11,15,26,42.3%,17m
6244,2,MrRedEYeZ,2906,0,0,1,1,0.0%,35m
6250,2,Flash,2905,1554,90,72,162,55.6%,13m
6250,2,RandomJoker,2905,561,33,7,40,82.5%,11m
6250,1,Siguru,2905,695,32,30,62,51.6%,7m
6250,2,KpacyH,2905,309,20,12,32,62.5%,27m
6250,3,Yarik,2905,411,16,6,22,72.7%,27m
6250,3,Salty,2905,363,13,17,30,43.3%,28m
6250,3,[BMF]SID,2905,196,7,5,12,58.3%,8m
6250,2,[k1raen]amidamary,2905,144,5,6,11,45.5%,28m
6250,2,Fingerslave,2905,142,5,6,11,45.5%,14m
6250,3,Nor,2905,86,3,2,5,60.0%,13m
6250,3,[RusLv]ЭпичныйОН,2905,0,3,2,5,60.0%,10m
6250,1,[TePt]Lukas,2905,0,3,3,6,50.0%,30m
6262,1,Duke,2904,1620,220,210,430,51.2%,27m
6262,2,Shango,2904,824,78,66,144,54.2%,27m
6262,2,crsy,2904,544,62,57,119,52.1%,4m
6262,2,MouldySock,2904,1141,47,44,91,51.6%,14m
6262,3,[45silm]tamadCZ,2904,955,38,30,68,55.9%,28m
6262,1,bartas,2904,573,32,33,65,49.2%,19m
6262,2,Machmol,2904,483,19,13,32,59.4%,4m
6262,3,[SLbook]Megakorv,2904,116,5,3,8,62.5%,26m
6262,2,Duts,2904,0,3,1,4,75.0%,10m
6262,1,PAPA,2904,0,1,0,1,100.0%,19m
6262,2,Darkside,2904,34,1,5,6,16.7%,11m
6262,3,Luggäs,2904,0,0,1,1,0.0%,10m
6262,3,GerOfTheStar,2904,0,0,1,1,0.0%,11m
6275,2,[REGGE]SEAR,2903,450,29,25,54,53.7%,20m
6275,3,Gneras,2903,629,25,21,46,54.3%,19m
6275,2,Shakuras,2903,441,21,14,35,60.0%,2m
6275,3,[StTrpr]Fern,2903,142,5,3,8,62.5%,11m
6275,3,MaJaeYoon,2903,86,3,2,5,60.0%,4m
6275,2,[kimbap]Sven,2903,46,2,5,7,28.6%,1h
6275,2,Salo,2903,0,0,1,1,0.0%,1h
6275,2,tuetenfrog,2903,0,0,1,1,0.0%,1h
6283,2,[Muhaha]San,2902,733,55,51,106,51.9%,3m
6283,2,[CL212]VeniVidiFail,2902,735,33,22,55,60.0%,13m
6283,3,Stringset,2902,366,15,4,19,78.9%,27m
6283,1,[B3ard]Dontyr,2902,250,12,8,20,60.0%,12m
6283,3,Akaneron,2902,195,6,6,12,50.0%,20m
6283,1,[Posos]FlashSamolet,2902,96,4,8,12,33.3%,38m
6283,3,injinero,2902,0,3,2,5,60.0%,12m
6283,3,SKYFALL,2902,143,3,4,7,42.9%,4m
6283,2,[NotSuR]xtkbr,2902,140,3,5,8,37.5%,10m
6283,3,sasha,2902,0,0,2,2,0.0%,28m
6283,3,[YPG]Klayter,2902,0,0,5,5,0.0%,13m
6294,2,Thunderbird,2901,825,67,62,129,51.9%,27m
6294,3,[1ndica]StOnEd,2901,824,31,25,56,55.4%,17m
6294,2,beau,2901,681,27,26,53,50.9%,29m
6294,2,xLeONIDaSx,2901,0,4,1,5,80.0%,37m
6294,3,[Freya]have,2901,30,2,0,2,100.0%,10m
6294,3,Banshee,2901,30,1,1,2,50.0%,11m
6294,2,PROteamart,2901,0,1,6,7,14.3%,28m
6294,3,Shrunkai,2901,0,0,2,2,0.0%,13m
6302,2,GERG,2900,854,62,67,129,48.1%,5m
6302,2,Eldarion,2900,1492,56,60,116,48.3%,15m
6302,2,EliteInvest,2900,812,28,32,60,46.7%,21m
6302,1,[IsTcI]Bledus,2900,97,6,3,9,66.7%,9m
6302,3,HOGU,2900,117,3,4,7,42.9%,19m
6302,3,Alex,2900,60,2,3,5,40.0%,21m
6302,3,CoOons,2900,30,1,1,2,50.0%,9m
6302,2,[Mronn]Warburton,2900,30,1,4,5,20.0%,2m
6310,2,Игорь,2899,1306,74,60,134,55.2%,26m
6310,1,Garna,2899,941,45,52,97,46.4%,13m
6310,1,jakaba,2899,341,17,25,42,40.5%,1m
6310,2,INeBriAtion,2899,395,15,11,26,57.7%,13m
6310,3,[НОД17]Overmind,2899,262,8,4,12,66.7%,2m
6310,3,RacoD,2899,0,1,0,1,100.0%,11m
6316,1,[stem]deniska,2898,1636,122,118,240,50.8%,4m
6316,2,khain,2898,791,65,65,130,50.0%,13m
6316,2,GooDcAt,2898,327,13,13,26,50.0%,12m
6316,2,YEEHAW,2898,165,8,4,12,66.7%,14m
6316,2,[DUM3]XenoRage,2898,189,8,6,14,57.1%,28m
6316,2,MasterFireSi,2898,0,4,2,6,66.7%,27m
6316,3,[PFrusH]Jacke,2898,90,4,3,7,57.1%,13m
6316,1,NarenKat,2898,0,3,4,7,42.9%,5m
6316,2,[1ami1]elEnd,2898,60,2,5,7,28.6%,10m
6325,1,Jazzor,2897,1442,174,176,350,49.7%,19m
6325,2,Tri,2897,486,75,76,151,49.7%,21m
6325,3,[Ǽ1]Impostor,2897,794,37,12,49,75.5%,6m
6325,3,Hilps,2897,262,8,4,12,66.7%,18m
6325,1,SkyClasH,2897,0,1,0,1,100.0%,21m
6325,2,FaDjong,2897,0,0,7,7,0.0%,13m
6331,2,[AciNoN]WERTEX,2896,899,42,41,83,50.6%,4m
6331,3,PeachyTea,2896,30,1,2,3,33.3%,21m
6331,2,Dylan,2896,34,1,3,4,25.0%,15m
6331,3,DJB,2896,0,0,2,2,0.0%,13m
6331,2,zerzergue,2896,0,0,5,5,0.0%,1h
6336,1,[SVK014]OLDStone,2895,1592,291,292,583,49.9%,28m
6336,2,ghost,2895,1473,79,58,137,57.7%,14m
6336,3,QuamfyBrah,2895,1705,74,78,152,48.7%,17m
6336,3,XXEpheneAXX,2895,652,35,3,38,92.1%,27m
6336,3,Sophia,2895,500,19,17,36,52.8%,1m
6336,3,shama,2895,0,3,2,5,60.0%,1m
6336,1,PBR,2895,40,2,0,2,100.0%,25m
6336,2,Mifico,2895,30,2,4,6,33.3%,27m
6336,3,Danik,2895,30,1,2,3,33.3%,17m
6336,2,zhouyi,2895,0,1,4,5,20.0%,38m
6336,3,[DNGs]Frontela,2895,0,0,2,2,0.0%,18m
6347,2,Splicer,2894,927,60,67,127,47.2%,19m
6347,1,[RoxtaR]megavit,2894,986,59,62,121,48.8%,6m
6347,2,[IceHus]Дурашка,2894,555,21,17,38,55.3%,17m
6347,2,[UKSG]Giancarlo,2894,485,19,17,36,52.8%,28m
6347,2,[EDI]Timelapse,2894,336,12,15,27,44.4%,2m
6347,2,SeaSharp,2894,346,11,13,24,45.8%,10m
6347,2,[beebop]Bloubi,2894,0,3,3,6,50.0%,13m
6347,3,Rashka,2894,0,1,1,2,50.0%,17m
6355,1,[WITCHs]DarkCCII,2893,1594,161,150,311,51.8%,11m
6355,2,qooqoo,2893,400,17,13,30,56.7%,3m
6355,2,ramirez,2893,341,15,12,27,55.6%,20m
6355,2,[ExCo]RuRandom,2893,286,12,13,25,48.0%,20m
6355,3,[DIRSTK]Endorama,2893,264,10,5,15,66.7%,11m
6355,2,albertt,2893,181,7,5,12,58.3%,11m
6355,3,[RBadB]Smaug,2893,214,6,4,10,60.0%,27m
6355,2,Rusta,2893,0,4,1,5,80.0%,38m
6355,2,[EAU]taktik,2893,0,1,3,4,25.0%,27m
6355,1,MercyLife,2893,0,0,2,2,0.0%,1h
6365,3,Kroll,2892,1103,43,39,82,52.4%,17m
6365,3,[CuWoǂ]Theknife,2892,383,14,15,29,48.3%,20m
6365,2,oma,2892,256,10,8,18,55.6%,15m
6365,3,SquiD,2892,88,4,1,5,80.0%,5m
6365,3,GolDaniels,2892,0,0,1,1,0.0%,1m
6370,2,Cromwell,2891,857,69,64,133,51.9%,11m
6370,3,Lasaqus,2891,1436,62,58,120,51.7%,13m
6370,3,BlackSmith,2891,340,12,5,17,70.6%,27m
6370,3,LeoZealot,2891,277,11,4,15,73.3%,2m
6370,2,JadranKrt,2891,131,7,9,16,43.8%,27m
6370,2,cocico,2891,0,3,3,6,50.0%,3m
6370,3,[HDTV]USax,2891,60,2,2,4,50.0%,10m
6370,3,PIER,2891,0,2,3,5,40.0%,14m
6370,3,sebyca,2891,30,1,1,2,50.0%,19m
6379,2,Axillesus,2890,416,16,14,30,53.3%,11m
6379,2,[Meuuh]Akenatton,2890,336,13,12,25,52.0%,13m
6379,3,[Павшие]ttttttt,2890,0,1,0,1,100.0%,6m
6379,2,Snore,2890,30,1,9,10,10.0%,9m
6383,2,Obibi,2889,1257,55,52,107,51.4%,9m
6383,3,maximus,2889,1038,42,37,79,53.2%,12m
6383,2,Jdem,2889,704,32,26,58,55.2%,13m
6383,2,Balazs,2889,395,14,14,28,50.0%,28m
6383,3,[HZeS]GooseLuck,2889,328,12,6,18,66.7%,10m
6383,2,Funuko,2889,294,10,15,25,40.0%,2m
6383,3,Pache,2889,168,6,4,10,60.0%,10m
6383,3,[0BO]Bluby,2889,30,1,2,3,33.3%,11m
6383,3,Neodreamer,2889,0,0,1,1,0.0%,16m
6383,3,DerRoteBaron,2889,0,0,1,1,0.0%,10m
6393,2,SlowHandsOiq,2888,671,182,161,343,53.1%,13m
6393,2,Drakers,2888,1068,172,152,324,53.1%,17m
6393,3,HiDik,2888,1610,162,143,305,53.1%,17m
6393,2,[K0RM2]RobotGG,2888,1554,122,99,221,55.2%,15m
6393,1,frogsontoast,2888,872,73,65,138,52.9%,6m
6393,1,RaGe,2888,1307,51,52,103,49.5%,4m
6393,2,[NTP]nonololo,2888,732,28,28,56,50.0%,5m
6393,2,[basdp]Mora,2888,524,19,18,37,51.4%,10m
6393,3,[RomanV]Roman,2888,196,9,4,13,69.2%,6m
6393,2,Tassadar,2888,194,7,2,9,77.8%,1h
6393,3,Teejing,2888,189,7,5,12,58.3%,18m
6393,2,NanoTr,2888,120,5,7,12,41.7%,10m
6393,2,[TIVIM]Nooblord,2888,88,4,3,7,57.1%,9m
6393,3,wuuh,2888,0,3,2,5,60.0%,14m
6393,3,Darkglasses,2888,58,2,2,4,50.0%,10m
6393,2,BlackUnit,2888,30,2,3,5,40.0%,19m
6393,3,[Jinho]brahms,2888,60,2,4,6,33.3%,6m
6393,3,BooomKirill,2888,0,0,1,1,0.0%,15m
6393,1,TheFikz,2888,0,0,1,1,0.0%,1h
6412,3,ЭхоУнитаза,2887,890,46,11,57,80.7%,20m
6412,3,EatMyPepe,2887,487,21,18,39,53.8%,17m
6412,2,benzer,2887,265,8,4,12,66.7%,21m
6412,2,neasi,2887,89,8,10,18,44.4%,10m
6412,2,IIIIIIIIIIII,2887,143,6,5,11,54.5%,27m
6412,3,[ĦĦ]xmiio,2887,0,0,1,1,0.0%,10m
6412,2,[WWOGU]Sky,2887,0,0,1,1,0.0%,1h
6419,3,Murphy,2886,793,34,24,58,58.6%,3m
6419,2,WhySoSerious,2886,464,22,20,42,52.4%,11m
6419,2,Greger,2886,402,14,15,29,48.3%,14m
6419,2,[BULD0G]KalmeCavia,2886,118,4,6,10,40.0%,2m
6419,3,BaboJan,2886,30,2,1,3,66.7%,9m
6419,3,[1stGG]wurzelsepp,2886,30,1,1,2,50.0%,4m
6419,1,llllllllllll,2886,0,0,1,1,0.0%,1h
6419,3,ZERATUL,2886,0,0,2,2,0.0%,3m
6427,2,Padonok,2885,1369,86,74,160,53.8%,4m
6427,2,Treadstoun,2885,636,25,23,48,52.1%,27m
6427,3,[SMF]Qminator,2885,370,14,14,28,50.0%,9m
6427,2,zerginator,2885,300,13,14,27,48.1%,11m
6427,3,школьник,2885,86,4,4,8,50.0%,3m
6427,2,Kroll,2885,0,3,2,5,60.0%,1h
6427,3,gjogob,2885,86,3,4,7,42.9%,9m
6427,3,DarkProbe,2885,0,1,0,1,100.0%,1h
6427,3,bompa,2885,0,1,0,1,100.0%,12m
6427,3,CaDuDé,2885,0,0,1,1,0.0%,10m
6437,3,[QTclub]Rey,2884,278,11,7,18,61.1%,29m
6437,3,UTTER,2884,231,7,1,8,87.5%,5m
6437,3,Ratte,2884,140,6,3,9,66.7%,9m
6437,3,Spunks,2884,118,4,5,9,44.4%,28m
6437,2,ElFrancisco,2884,0,3,2,5,60.0%,1h
6437,2,Sonyman,2884,0,3,3,6,50.0%,6m
6437,1,ipxZerg,2884,120,2,1,3,66.7%,29m
6437,2,[KrPls]TaylorSwift,2884,48,1,1,2,50.0%,1h
6437,3,Bene,2884,30,1,2,3,33.3%,14m
6446,3,popug,2883,1641,145,142,287,50.5%,2m
6446,3,[LRDP]Scrats,2883,1603,78,67,145,53.8%,2m
6446,2,bycraft,2883,180,10,11,21,47.6%,17m
6446,3,Fakie,2883,212,9,7,16,56.2%,1h
6446,2,MightyAphro,2883,48,5,2,7,71.4%,24m
6446,2,[dumbfu]BlackJack,2883,83,5,8,13,38.5%,4m
6446,2,Jalexo,2883,95,2,5,7,28.6%,1h
6446,1,RazorBeak,2883,117,2,9,11,18.2%,36m
6446,3,ProNoob,2883,0,1,0,1,100.0%,9m
6446,3,nikitarus,2883,0,0,1,1,0.0%,6m
6456,2,[MPakC]majaus,2882,897,41,31,72,56.9%,5m
6456,3,[ASS]Konrad,2882,483,21,9,30,70.0%,28m
6456,2,[IceHus]KartofunSumy,2882,470,20,15,35,57.1%,2m
6456,2,utrator,2882,514,19,24,43,44.2%,10m
6456,2,Archonhaz,2882,146,5,9,14,35.7%,27m
6456,3,[Rebеls]Raven,2882,86,4,0,4,100.0%,9m
6456,2,jinior,2882,136,4,6,10,40.0%,14m
6456,2,Ashenari,2882,0,3,2,5,60.0%,19m
6456,3,[Mastín]Ethelion,2882,60,2,2,4,50.0%,11m
6456,2,[Sw0rm]DRsloper,2882,0,2,2,4,50.0%,1h
6456,1,SmoykiArt,2882,97,2,5,7,28.6%,1h
6456,3,Fortune,2882,0,1,0,1,100.0%,13m
6456,3,[FDA]Mist,2882,0,1,0,1,100.0%,20m
6456,3,Kimbo,2882,30,1,3,4,25.0%,2m
6470,3,Protothrope,2881,888,46,40,86,53.5%,10m
6470,2,PAVEL,2881,164,13,10,23,56.5%,6m
6470,2,[696]MishRqt,2881,240,9,9,18,50.0%,3m
6470,1,MagicDiamond,2881,253,9,10,19,47.4%,14m
6470,3,Chefzocker,2881,235,8,3,11,72.7%,5m
6470,3,Noname,2881,216,7,2,9,77.8%,11m
6470,3,YEYKO,2881,198,7,6,13,53.8%,13m
6470,2,BapBap,2881,166,6,8,14,42.9%,15m
6470,3,[CОS]Jypsy,2881,174,5,3,8,62.5%,1m
6470,3,BusI,2881,146,5,6,11,45.5%,5m
6470,2,jCsTyLe,2881,48,2,5,7,28.6%,19m
6470,3,[WADER]LittleDiablo,2881,0,1,0,1,100.0%,16m
6470,3,[MCBP]Master,2881,0,0,1,1,0.0%,13m
6470,3,Soàh,2881,0,0,1,1,0.0%,13m
6484,2,[KTribe]MASSI,2880,1524,76,72,148,51.4%,3m
6484,2,[buckie]Behemoth,2880,819,36,34,70,51.4%,12m
6484,2,CuberWarrior,2880,980,35,39,74,47.3%,4m
6484,3,IOIO,2880,338,19,13,32,59.4%,20m
6484,2,SmokingFenix,2880,463,18,19,37,48.6%,2m
6484,2,zenitka,2880,255,9,8,17,52.9%,27m
6484,3,Colstone,2880,228,9,8,17,52.9%,18m
6484,1,Abathur,2880,296,9,14,23,39.1%,13m
6484,2,LeoMessi,2880,186,7,8,15,46.7%,1h
6484,3,trasjol,2880,143,6,3,9,66.7%,13m
6484,2,Cannibal,2880,48,4,3,7,57.1%,16m
6484,1,[PenOZ]Bruno,2880,121,3,4,7,42.9%,1h
6484,3,[DWTeam]Andragon,2880,60,2,5,7,28.6%,13m
6484,2,NIKITA,2880,133,2,6,8,25.0%,38m
6484,2,ShustrOFF,2880,0,1,0,1,100.0%,35m
6484,3,KING,2880,0,1,0,1,100.0%,17m
6484,3,ceko,2880,0,1,0,1,100.0%,15m
6484,3,[LAMPA]ТоксичныйТеР,2880,30,1,6,7,14.3%,7m
6502,2,SJK,2879,1144,90,86,176,51.1%,20m
6502,2,Xvolte,2879,976,34,40,74,45.9%,19m
6502,3,[FR1]FRxENCHnoob,2879,594,30,4,34,88.2%,10m
6502,3,TRIBUNAL,2879,382,13,9,22,59.1%,8m
6502,3,BriVicShadow,2879,288,10,11,21,47.6%,5m
6502,1,ReDevil,2879,235,8,14,22,36.4%,1h
6502,1,Draren,2879,274,7,15,22,31.8%,27m
6502,3,[JaPP]XachApuri,2879,0,0,1,1,0.0%,11m
6510,2,LightBetStrs,2878,909,33,34,67,49.3%,20m
6510,3,Bozzy,2878,642,28,23,51,54.9%,2m
6510,3,Troddler,2878,354,13,17,30,43.3%,13m
6510,2,Zed,2878,114,6,7,13,46.2%,7m
6510,2,DrunkenChimp,2878,0,1,1,2,50.0%,34m
6510,3,Pims,2878,0,0,3,3,0.0%,28m
6516,2,[xFRSx]aNarCHy,2877,727,102,102,204,50.0%,6m
6516,3,Zatsep,2877,1199,94,76,170,55.3%,11m
6516,1,[H2OKT]Hydroïde,2877,1455,66,72,138,47.8%,14m
6516,2,sisk,2877,435,18,15,33,54.5%,27m
6516,3,[IceHus]Vlad,2877,318,14,2,16,87.5%,4m
6516,3,Shell,2877,166,4,1,5,80.0%,21m
6516,3,Leucopterus,2877,30,1,2,3,33.3%,5m
6523,3,[MyXo]Joto,2876,1495,126,133,259,48.6%,13m
6523,3,bagdonex,2876,887,37,29,66,56.1%,15m
6523,2,SuckMyHuge,2876,759,31,21,52,59.6%,10m
6523,3,[Petrus]ZWAttitude,2876,621,26,22,48,54.2%,19m
6523,2,[MecGR]Tartens,2876,646,23,24,47,48.9%,3m
6523,1,OMSK,2876,310,12,15,27,44.4%,8m
6523,2,ZergLord,2876,150,5,9,14,35.7%,27m
6523,1,Tvorobey,2876,48,2,1,3,66.7%,1h
6523,3,Arzibaani,2876,0,0,1,1,0.0%,5m
6532,2,link,2875,684,25,27,52,48.1%,21m
6532,2,MoNGoL,2875,274,23,23,46,50.0%,6m
6532,2,Phantom,2875,558,20,25,45,44.4%,27m
6532,3,Diaboluss,2875,455,16,12,28,57.1%,10m
6532,2,GuNii,2875,341,13,11,24,54.2%,2m
6532,2,[NetGG]Joker,2875,234,11,6,17,64.7%,15m
6532,2,Arcanum,2875,218,6,9,15,40.0%,2m
6532,1,Pochtalon,2875,145,4,5,9,44.4%,20m
6532,3,[PÂRłAH]DARK,2875,135,3,1,4,75.0%,11m
6532,2,[Какуля]FacTron,2875,0,2,0,2,100.0%,1h
6532,3,zougoulou,2875,30,2,2,4,50.0%,3m
6532,3,RoadKiLL,2875,60,2,4,6,33.3%,10m
6532,3,[PTLc]Pallas,2875,0,1,0,1,100.0%,7m
6532,3,XTerminatorX,2875,0,1,0,1,100.0%,27m
6532,3,ghoUst,2875,0,0,2,2,0.0%,17m
6547,3,Uras,2874,1222,152,137,289,52.6%,13m
6547,3,Makatou,2874,1546,86,69,155,55.5%,27m
6547,2,[G0UDA]nhutton,2874,792,78,76,154,50.6%,21m
6547,1,Egoista,2874,833,75,76,151,49.7%,27m
6547,2,LeGrandJojo,2874,1189,53,46,99,53.5%,27m
6547,3,AngryProbe,2874,674,29,25,54,53.7%,14m
6547,3,DTCBöB,2874,740,26,28,54,48.1%,27m
6547,3,FiXells,2874,414,18,5,23,78.3%,8m
6547,2,Alecsander,2874,90,7,6,13,53.8%,20m
6547,2,матвей,2874,284,7,9,16,43.8%,1h
6547,2,OozzE,2874,122,4,8,12,33.3%,4m
6547,3,[Pogo]Ecclebert,2874,90,3,6,9,33.3%,29m
6547,3,[PAFn]Pougli,2874,30,2,2,4,50.0%,10m
6547,3,crusty,2874,0,2,3,5,40.0%,12m
6547,3,[PowerG]MasterMind,2874,0,1,0,1,100.0%,9m
6547,3,[Lambro]IBA,2874,0,0,1,1,0.0%,28m
6563,3,Beefheart,2873,1545,164,163,327,50.2%,2m
6563,2,[Yig]Drake,2873,874,40,26,66,60.6%,11m
6563,2,[BBOW]TheMichel,2873,462,34,33,67,50.7%,10m
6563,2,ConstantSin,2873,507,23,17,40,57.5%,9m
6563,2,beardulf,2873,385,17,16,33,51.5%,15m
6563,2,Kerotic,2873,270,11,6,17,64.7%,28m
6563,3,joooo,2873,107,4,3,7,57.1%,10m
6563,3,[ULTX]Shadowflame,2873,30,3,4,7,42.9%,8m
6563,3,[EPEX]Lyjacko,2873,58,2,1,3,66.7%,2m
6563,3,GagamelsRage,2873,95,2,4,6,33.3%,9m
6563,3,Sapozhnik,2873,0,1,0,1,100.0%,12m
6563,1,Archangel,2873,0,0,1,1,0.0%,1h
6563,3,[Peeps]RickyTheDoom,2873,0,0,1,1,0.0%,18m
6563,3,guerilla,2873,0,0,1,1,0.0%,19m
6563,1,shadowStorm,2873,0,0,2,2,0.0%,30m
6563,3,SNOW,2873,0,0,3,3,0.0%,3m
6579,2,west,2872,911,127,118,245,51.8%,12m
6579,1,[DLTED]AnarQ,2872,600,24,28,52,46.2%,2m
6579,2,CptPicard,2872,213,10,14,24,41.7%,6m
6579,2,Kingpin,2872,254,8,10,18,44.4%,27m
6579,3,SiK,2872,192,6,4,10,60.0%,12m
6579,3,IIIIIIIIIIII,2872,114,5,2,7,71.4%,18m
6579,3,hiimzaki,2872,168,5,3,8,62.5%,11m
6579,3,BROSSSS,2872,0,0,1,1,0.0%,3m
6587,3,ChickenBOSS,2871,114,5,2,7,71.4%,7m
6587,3,Sebus,2871,0,3,2,5,60.0%,27m
6587,3,[BRSKR]Blade,2871,0,1,0,1,100.0%,28m
6587,3,kiruKatO,2871,0,0,1,1,0.0%,27m
6591,2,[maximu]Player,2870,502,20,20,40,50.0%,6m
6591,3,ZloDey,2870,155,6,5,11,54.5%,10m
6591,2,love,2870,116,5,9,14,35.7%,13m
6591,3,slipnote,2870,86,4,2,6,66.7%,19m
6591,3,coca,2870,0,3,2,5,60.0%,11m
6591,3,HeHefgrt,2870,0,1,0,1,100.0%,4m
6597,3,Secret,2869,1474,148,132,280,52.9%,10m
6597,3,VOVAINUA,2869,634,23,21,44,52.3%,27m
6597,3,[PL345]QuBuS,2869,384,18,8,26,69.2%,10m
6597,3,ZORGALOG,2869,206,10,7,17,58.8%,10m
6597,3,Apo,2869,146,6,6,12,50.0%,1h
6597,3,Marlito,2869,146,5,4,9,55.6%,11m
6597,2,Mata,2869,0,3,2,5,60.0%,1h
6597,3,Kenny,2869,88,3,4,7,42.9%,6m
6597,3,jeanpascal,2869,86,3,6,9,33.3%,13m
6597,3,BackPocket,2869,0,1,1,2,50.0%,3m
6607,3,planB,2868,965,62,69,131,47.3%,21m
6607,2,Glenfiddich,2868,906,49,41,90,54.4%,14m
6607,2,FlinkeMaus,2868,635,26,23,49,53.1%,19m
6607,1,MadJack,2868,594,23,27,50,46.0%,19m
6607,3,Intro,2868,443,19,12,31,61.3%,19m
6607,3,Fireffin,2868,120,4,4,8,50.0%,9m
6607,3,KayKay,2868,155,4,9,13,30.8%,10m
6607,3,[ЗИБиАГ]DimirSpybug,2868,0,3,2,5,60.0%,5m
6607,3,MoodSwings,2868,58,2,2,4,50.0%,7m
6616,1,RaGnArOk,2867,1567,95,89,184,51.6%,12m
6616,3,deeew,2867,707,30,23,53,56.6%,3m
6616,2,[СТРАТ]ODeN,2867,434,19,13,32,59.4%,20m
6616,3,LöAslan,2867,232,9,9,18,50.0%,10m
6616,3,DarkAdino,2867,210,6,9,15,40.0%,29m
6616,1,PARASITE,2867,96,5,5,10,50.0%,1h
6616,3,Botsia,2867,157,4,1,5,80.0%,20m
6616,3,[frruju]frido,2867,86,3,2,5,60.0%,6m
6616,3,mKw,2867,30,2,3,5,40.0%,18m
6616,2,Voin,2867,0,2,5,7,28.6%,8m
6616,3,Darlanio,2867,0,0,1,1,0.0%,6m
6616,1,[XIV]niK,2867,0,0,12,12,0.0%,2m
6628,1,Jpeg,2866,1618,211,195,406,52.0%,3m
6628,2,AbuturWorm,2866,1533,187,169,356,52.5%,14m
6628,1,Valera,2866,1594,113,121,234,48.3%,14m
6628,2,[CC4N]Finwecillo,2866,1538,64,62,126,50.8%,11m
6628,3,КтоТам,2866,775,27,27,54,50.0%,6m
6628,2,Majic,2866,682,24,29,53,45.3%,14m
6628,1,[ExTr1m]valax,2866,349,14,15,29,48.3%,5m
6628,1,RogiLutrak,2866,256,11,13,24,45.8%,1h
6628,3,LipStick,2866,232,9,9,18,50.0%,20m
6628,2,Vperde,2866,202,6,9,15,40.0%,5m
6628,2,YOodAh,2866,0,4,1,5,80.0%,38m
6628,3,LizaSolnceva,2866,0,0,1,1,0.0%,5m
6640,3,Insurg,2865,792,127,108,235,54.0%,15m
6640,2,CVDH,2865,727,28,27,55,50.9%,7m
6640,3,[SAKZ]Polidrap,2865,262,10,9,19,52.6%,2m
6640,3,[OUBL]Xenophon,2865,217,7,9,16,43.8%,15m
6640,2,[PYHU]Пучахендза,2865,0,4,6,10,40.0%,14m
6640,3,Ledenec,2865,30,2,0,2,100.0%,3m
6640,3,[NNcity]nosochek,2865,34,2,6,8,25.0%,9m
6640,3,[PBZ]BlackMamba,2865,0,1,0,1,100.0%,6m
6640,3,[run]serways,2865,0,1,1,2,50.0%,2m
6640,3,hank,2865,88,1,1,2,50.0%,35m
6640,3,[Ebloid]llllllllllll,2865,0,1,2,3,33.3%,29m
6651,3,Vino,2864,490,18,22,40,45.0%,4m
6651,2,[K0mpis]banjo,2864,447,17,14,31,54.8%,27m
6651,3,Mariusz,2864,326,13,11,24,54.2%,13m
6651,3,ГИГАПИГА,2864,179,7,5,12,58.3%,2m
6651,3,NoChanceForU,2864,186,6,3,9,66.7%,21m
6651,1,iodineIЗI,2864,48,4,4,8,50.0%,4m
6651,3,Stephan,2864,129,3,4,7,42.9%,1h
6651,2,Stormleaf,2864,46,2,0,2,100.0%,3m
6651,3,Power,2864,119,2,2,4,50.0%,15m
6651,3,bigmanIsak,2864,132,2,4,6,33.3%,13m
6651,3,shellschock,2864,0,1,0,1,100.0%,19m
6651,1,mauroprovato,2864,0,0,1,1,0.0%,10m
6663,3,KILLACOWBOY,2863,690,30,22,52,57.7%,13m
6663,2,[igni]Nanning,2863,392,14,15,29,48.3%,2m
6663,3,Bonus,2863,299,11,4,15,73.3%,9m
6663,1,[AS90]JeeratRome,2863,178,9,8,17,52.9%,5m
6663,3,Yeet,2863,212,6,3,9,66.7%,28m
6663,3,Behnrow,2863,166,5,1,6,83.3%,4m
6663,2,sAfricanus,2863,150,5,8,13,38.5%,2m
6663,3,[CEI]Jonthegiant,2863,143,3,2,5,60.0%,36m
6663,3,[K72Q]Blacksii,2863,0,1,0,1,100.0%,13m
6663,2,[PLA2N]Medvedev,2863,0,1,2,3,33.3%,6m
6663,3,[UKG]Ellii,2863,0,0,1,1,0.0%,2m
6674,2,Yamanouchi,2862,429,31,25,56,55.4%,13m
6674,1,[13NRV]Fear,2862,430,16,18,34,47.1%,27m
6674,2,[ĦĦ]BaXcoX,2862,434,14,23,37,37.8%,13m
6674,1,NumBer,2862,168,5,3,8,62.5%,1h
6674,3,masterone,2862,137,5,4,9,55.6%,3m
6674,2,GGeryx,2862,60,3,8,11,27.3%,10m
6674,2,[ARTAS]Eeroladan,2862,0,1,0,1,100.0%,39m
6674,3,[ZdZ]Uranus,2862,30,1,3,4,25.0%,8m
6674,2,Nasai,2862,0,1,4,5,20.0%,2m
6674,3,InLove,2862,0,1,4,5,20.0%,12m
6674,2,FLASTIK,2862,0,0,7,7,0.0%,29m
6685,2,lëni,2861,1547,71,70,141,50.4%,17m
6685,2,Morroz,2861,564,22,25,47,46.8%,12m
6685,3,Gulain,2861,195,9,6,15,60.0%,2m
6685,2,[GTDK]Drocky,2861,274,9,11,20,45.0%,19m
6685,3,YliKylä,2861,189,8,7,15,53.3%,2m
6685,3,[Няшкa]wRtZipPe,2861,184,6,8,14,42.9%,17m
6685,3,SCPlusPlus,2861,158,5,3,8,62.5%,9m
6685,3,[E1VDC]Krohm,2861,0,4,1,5,80.0%,6m
6685,1,RoyBamboo,2861,121,4,6,10,40.0%,36m
6685,3,Spambot,2861,0,3,2,5,60.0%,21m
6685,3,valshmel,2861,30,2,0,2,100.0%,28m
6685,2,Gatto,2861,0,1,0,1,100.0%,1h
6685,3,Willi,2861,0,1,2,3,33.3%,29m
6685,3,Wertrop,2861,0,1,3,4,25.0%,6m
6699,3,[DRUCK]eepsmann,2860,1602,241,233,474,50.8%,11m
6699,2,Nelio,2860,1046,204,216,420,48.6%,27m
6699,3,Gutter,2860,1618,82,68,150,54.7%,12m
6699,2,[SiTFLY]ryeryerye,2860,300,13,11,24,54.2%,4m
6699,3,timehider,2860,346,11,11,22,50.0%,9m
6699,2,Zest,2860,200,10,9,19,52.6%,13m
6699,3,[PGCom]Cyberrevo,2860,196,7,8,15,46.7%,19m
6699,2,desnartdani,2860,224,7,13,20,35.0%,10m
6699,2,Deyshan,2860,86,6,6,12,50.0%,29m
6699,3,RpgFiftyNine,2860,142,4,0,4,100.0%,15m
6699,3,[ЗЕRGТV]nikkop,2860,88,4,1,5,80.0%,19m
6699,3,Kotev,2860,30,2,2,4,50.0%,9m
6699,3,[KnK]WolVeRinE,2860,0,0,1,1,0.0%,27m
6712,2,[ARG]vincaa,2859,866,32,37,69,46.4%,27m
6712,3,Hoggerita,2859,198,7,6,13,53.8%,18m
6712,2,[4SALE]Netruner,2859,218,7,15,22,31.8%,6m
6712,2,gccPøivrøn,2859,124,6,10,16,37.5%,6m
6712,2,[ZERGТV]VICTOR,2859,95,4,9,13,30.8%,1h
6712,2,LosTinWooDs,2859,0,3,2,5,60.0%,21m
6712,2,MindBlues,2859,116,2,7,9,22.2%,13m
6712,3,Miro,2859,0,1,0,1,100.0%,12m
6712,1,Libra,2859,96,1,1,2,50.0%,24m
6712,3,[HV]DexX,2859,0,1,3,4,25.0%,5m
6712,3,[LOGS]Chinis,2859,0,1,4,5,20.0%,27m
6723,2,Hoody,2858,862,31,33,64,48.4%,29m
6723,1,Monsoon,2858,339,13,17,30,43.3%,13m
6723,2,[tetguy]higgs,2858,207,7,7,14,50.0%,13m
6723,2,BillyGristle,2858,180,6,8,14,42.9%,11m
6723,2,Doughboy,2858,142,5,11,16,31.2%,19m
6723,2,RXX,2858,152,4,7,11,36.4%,3m
6723,3,KoningJan,2858,0,0,1,1,0.0%,27m
6723,3,[kreol]redhood,2858,0,0,1,1,0.0%,18m
6723,3,[GNEP]NXValiant,2858,0,0,1,1,0.0%,26m
6723,3,ƁơǥƊaƞ,2858,0,0,1,1,0.0%,2m
6723,3,[TSMMM]MaddaFakka,2858,0,0,1,1,0.0%,13m
6723,2,TERRAN,2858,0,0,5,5,0.0%,30m
6735,1,[YRU]Cephei,2857,119,6,3,9,66.7%,14m
6735,3,awokenbear,2857,94,5,1,6,83.3%,12m
6735,2,OneWolf,2857,0,3,0,3,100.0%,1h
6735,3,[0108]Mathmagician,2857,86,3,4,7,42.9%,16m
6735,3,ALHK,2857,0,2,2,4,50.0%,29m
6740,3,kopatch,2856,633,24,15,39,61.5%,19m
6740,1,[TSURP]SuperLuznad,2856,772,24,37,61,39.3%,19m
6740,3,MadMan,2856,114,7,5,12,58.3%,8m
6740,1,Glinomess,2856,214,6,14,20,30.0%,2m
6740,3,Alebrant,2856,114,5,3,8,62.5%,3m
6740,2,Maks,2856,88,4,2,6,66.7%,27m
6740,2,Gillerboy,2856,62,3,5,8,37.5%,27m
6740,3,Hrust,2856,0,1,0,1,100.0%,17m
6740,2,padRe,2856,0,1,1,2,50.0%,15m
6740,3,roguebee,2856,30,1,2,3,33.3%,7m
6740,2,OneSecPlz,2856,0,0,4,4,0.0%,15m
6751,3,[AnD]ßØÜkǺŞ,2855,606,94,32,126,74.6%,16m
6751,2,JohnnyGroove,2855,1635,69,56,125,55.2%,3m
6751,2,[Bbatal]PODIMONISSE,2855,414,17,6,23,73.9%,16m
6751,3,loupstylé,2855,225,8,3,11,72.7%,18m
6751,3,SadPanda,2855,208,6,3,9,66.7%,10m
6751,1,Unhealthy,2855,0,4,2,6,66.7%,33m
6751,3,[OP2]Klima,2855,42,4,7,11,36.4%,24m
6751,1,Snapi,2855,140,4,15,19,21.1%,4m
6751,3,Spendorf,2855,30,2,3,5,40.0%,19m
6751,1,[HZeS]Dream,2855,145,2,3,5,40.0%,7m
6751,3,Ternence,2855,0,1,4,5,20.0%,2m
6751,3,[DL2006]Roithar,2855,0,0,1,1,0.0%,9m
6751,3,samtec,2855,0,0,2,2,0.0%,18m
6751,3,[earlyT]theDESTROYER,2855,0,0,2,2,0.0%,28m
6765,3,OmniKai,2854,698,37,29,66,56.1%,10m
6765,3,CORONAVR,2854,327,11,12,23,47.8%,14m
6765,3,RimmJob,2854,195,8,0,8,100.0%,18m
6765,2,Gratwicke,2854,95,4,2,6,66.7%,8m
6765,2,[DSMA]sebtoss,2854,90,4,6,10,40.0%,4m
6765,2,Dudemannn,2854,0,3,2,5,60.0%,1h
6765,3,Awesomus,2854,30,1,1,2,50.0%,10m
6765,3,pebg,2854,0,0,1,1,0.0%,6m
6773,2,[RsTb]kid,2853,192,7,13,20,35.0%,14m
6773,1,[КРОТ]Светомеч,2853,143,5,5,10,50.0%,2m
6773,1,crssleeper,2853,170,5,6,11,45.5%,4m
6773,3,zealot,2853,30,2,1,3,66.7%,21m
6773,2,[Ulnar]MarineKing,2853,116,2,8,10,20.0%,20m
6773,3,kobra,2853,0,1,0,1,100.0%,14m
6779,3,IntroSpirit,2852,686,29,21,50,58.0%,19m
6779,3,[SURN]Heledorn,2852,287,26,10,36,72.2%,16m
6779,3,Pepe,2852,452,22,13,35,62.9%,12m
6779,2,[LeDude]Duckling,2852,399,16,16,32,50.0%,6m
6779,2,[DWTeam]Agent,2852,306,13,8,21,61.9%,14m
6779,1,Lightofday,2852,318,11,17,28,39.3%,7m
6779,3,Harribert,2852,164,10,8,18,55.6%,29m
6779,2,Microwave,2852,181,6,6,12,50.0%,20m
6779,3,[CS1rus]Quasar,2852,143,4,1,5,80.0%,19m
6779,3,SherKhan,2852,165,4,4,8,50.0%,11m
6779,3,Hummingbird,2852,58,2,4,6,33.3%,13m
6779,1,[Белшир]BlackNinja,2852,116,2,4,6,33.3%,20m
6779,3,[KSN]DyxectoR,2852,0,1,0,1,100.0%,9m
6779,3,HasNot,2852,0,1,0,1,100.0%,27m
6779,3,LemonenJäger,2852,0,1,0,1,100.0%,19m
6779,3,[Petrиs]JusttheKeL,2852,0,1,0,1,100.0%,30m
6779,3,Zerggut,2852,30,1,2,3,33.3%,6m
6779,3,III,2852,0,0,1,1,0.0%,13m
6779,3,Chris,2852,0,0,1,1,0.0%,13m
6798,2,ChickyBricky,2851,1474,201,174,375,53.6%,15m
6798,2,Heinrich,2851,793,64,68,132,48.5%,12m
6798,1,Erynnis,2851,1197,47,47,94,50.0%,9m
6798,3,[So0]ORANGERANGE,2851,518,39,26,65,60.0%,10m
6798,3,[RBP3]zeverynth,2851,740,28,23,51,54.9%,28m
6798,2,[Beeer]Tommilee,2851,650,27,25,52,51.9%,2m
6798,2,zumBerg,2851,304,13,13,26,50.0%,3m
6798,3,Lorex,2851,320,10,8,18,55.6%,11m
6798,3,VerseUni,2851,254,10,8,18,55.6%,13m
6798,2,lollif,2851,237,10,9,19,52.6%,6m
6798,2,Katniss,2851,240,10,9,19,52.6%,20m
6798,3,[EmŦ]blackpearl,2851,191,6,2,8,75.0%,9m
6798,3,[SPAINs]madara,2851,124,6,2,8,75.0%,11m
6798,3,[UAŦeam]DerI,2851,166,6,6,12,50.0%,9m
6798,1,Hanumon,2851,88,6,9,15,40.0%,28m
6798,2,SteinShirt,2851,141,5,0,5,100.0%,1h
6798,2,Pechkin,2851,0,3,3,6,50.0%,14m
6798,3,Roquefort,2851,30,2,1,3,66.7%,5m
6798,2,SilliN,2851,30,2,3,5,40.0%,15m
6798,3,Elladan,2851,30,1,1,2,50.0%,11m
6798,3,Nuke,2851,0,0,1,1,0.0%,8m
6819,3,[sctrap]KarlMarxxx,2850,1032,66,49,115,57.4%,19m
6819,2,Rai,2850,496,18,19,37,48.6%,15m
6819,3,[Nudist]Golgotai,2850,213,15,2,17,88.2%,10m
6819,3,serega,2850,192,7,8,15,46.7%,21m
6819,3,Cherry,2850,185,5,3,8,62.5%,5m
6819,2,Dioraks,2850,90,2,1,3,66.7%,1h
6819,2,Monos,2850,0,2,3,5,40.0%,39m
6819,3,Улькаир,2850,0,2,3,5,40.0%,15m
6819,2,[CHLEB]Fersinil,2850,62,2,6,8,25.0%,4m
6819,3,RobinNormann,2850,30,1,1,2,50.0%,20m
6819,3,HydraDen,2850,30,1,3,4,25.0%,18m
6830,3,[IOGTVI]Lezgegos,2849,706,68,55,123,55.3%,18m
6830,2,Гинко,2849,584,20,24,44,45.5%,3m
6830,2,Dizzy,2849,398,13,19,32,40.6%,19m
6830,3,GKar,2849,223,12,6,18,66.7%,18m
6830,1,Baneling,2849,238,11,11,22,50.0%,7m
6830,2,Ellumination,2849,242,7,7,14,50.0%,20m
6830,3,MAloy,2849,191,7,7,14,50.0%,32m
6830,2,Master,2849,118,5,4,9,55.6%,14m
6830,2,[PMMM]Ender,2849,0,2,2,4,50.0%,18m
6830,3,Alatriste,2849,58,2,2,4,50.0%,18m
6830,3,stifler,2849,0,1,0,1,100.0%,9m
6830,2,PSY,2849,0,1,0,1,100.0%,2m
6830,1,AnKalisto,2849,0,1,3,4,25.0%,8m
6830,3,mATz,2849,0,0,1,1,0.0%,4m
6844,2,Silicium,2848,742,28,29,57,49.1%,2m
6844,3,SwasoW,2848,0,2,3,5,40.0%,4m
6844,2,LDMA,2848,30,2,4,6,33.3%,27m
6844,3,StahanFX,2848,0,0,2,2,0.0%,10m
6848,2,Zico,2847,1330,51,48,99,51.5%,5m
6848,3,SPY,2847,713,28,22,50,56.0%,13m
6848,3,Fieder,2847,351,14,9,23,60.9%,17m
6848,3,[SeVenV]Tamamo,2847,233,7,3,10,70.0%,8m
6848,2,NikoN,2847,30,4,4,8,50.0%,5m
6848,3,[Alеx07]KacTuEJlb,2847,0,1,0,1,100.0%,16m
6848,3,Victus,2847,0,1,0,1,100.0%,20m
6848,3,LCGaming,2847,0,1,2,3,33.3%,20m
6848,1,Loota,2847,0,0,1,1,0.0%,7m
6848,3,zevs,2847,0,0,3,3,0.0%,10m
6848,3,Scoffer,2847,0,0,5,5,0.0%,8m
6859,3,[NcTsT]Ewemek,2846,998,56,56,112,50.0%,10m
6859,2,minuteman,2846,1328,52,49,101,51.5%,20m
6859,3,FalkE,2846,730,33,24,57,57.9%,6m
6859,3,DoCaCeBaL,2846,385,17,15,32,53.1%,20m
6859,2,Timingsleet,2846,348,15,17,32,46.9%,3m
6859,3,sNaiL,2846,290,12,10,22,54.5%,27m
6859,3,[ZERGTV]mamaHacker,2846,222,7,9,16,43.8%,1h
6859,3,pmLǂNebis,2846,86,3,2,5,60.0%,19m
6859,3,[69780]lucky,2846,0,3,2,5,60.0%,14m
6859,3,KATIE,2846,0,3,3,6,50.0%,11m
6859,3,[CM4R]bakermir,2846,0,2,4,6,33.3%,27m
6859,3,Frosch,2846,30,2,5,7,28.6%,5m
6859,3,MTALdrummeR,2846,0,1,0,1,100.0%,9m
6859,3,Wuschel,2846,0,0,1,1,0.0%,18m
6859,2,[BauB]wolpertinger,2846,0,0,3,3,0.0%,27m
6874,3,[TEKU]guarana,2845,1508,87,94,181,48.1%,9m
6874,1,[yedi]DirkDiggler,2845,745,55,64,119,46.2%,4m
6874,3,Yamn,2845,546,22,18,40,55.0%,21m
6874,3,soc,2845,507,19,14,33,57.6%,18m
6874,3,dux,2845,242,19,16,35,54.3%,18m
6874,2,[ClSq]Ислам,2845,398,18,18,36,50.0%,13m
6874,2,Deniss,2845,268,11,14,25,44.0%,15m
6874,2,VII,2845,230,9,10,19,47.4%,20m
6874,3,[Ecoli]Dreon,2845,230,6,5,11,54.5%,34m
6874,3,jakub,2845,58,3,0,3,100.0%,17m
6874,3,RealBigFish,2845,0,1,0,1,100.0%,3m
6874,3,kitkat,2845,0,0,1,1,0.0%,6m
6874,2,Kuuhaku,2845,0,0,3,3,0.0%,17m
6887,3,XEYTER,2844,1602,166,154,320,51.9%,3m
6887,3,Mike,2844,861,51,49,100,51.0%,9m
6887,3,Gryphus,2844,772,29,26,55,52.7%,4m
6887,3,GameGode,2844,430,16,16,32,50.0%,12m
6887,1,Magus,2844,348,12,19,31,38.7%,6m
6887,2,[Vioc]STAROS,2844,22,3,7,10,30.0%,13m
6887,3,Màmàdou,2844,0,2,3,5,40.0%,5m
6887,2,thepicpowner,2844,0,1,0,1,100.0%,29m
6887,3,[XzF]Radix,2844,0,1,0,1,100.0%,10m
6887,3,Cyberdriver,2844,0,1,0,1,100.0%,9m
6887,3,Joker,2844,30,1,1,2,50.0%,18m
6887,3,HeadCoach,2844,0,0,1,1,0.0%,2m
6899,2,[NOOBpl]Blineq,2843,1589,210,198,408,51.5%,4m
6899,2,[IBTMBL]MadHatters,2843,356,17,13,30,56.7%,27m
6899,3,AsagumoWang,2843,267,12,6,18,66.7%,19m
6899,2,OutOfNowhere,2843,216,11,9,20,55.0%,1h
6899,3,overlord,2843,201,8,4,12,66.7%,27m
6899,3,[skh]flip,2843,159,6,5,11,54.5%,4m
6899,1,[TGWPx]Ash,2843,48,5,5,10,50.0%,36m
6899,3,[SCiE]LEOKA,2843,0,3,2,5,60.0%,2m
6899,3,[FXB1]Bosancero,2843,0,1,5,6,16.7%,20m
6899,3,Salih,2843,0,0,1,1,0.0%,13m
6909,1,Hubabuba,2842,1621,163,170,333,48.9%,15m
6909,3,MrCrab,2842,549,29,25,54,53.7%,2m
6909,2,Daws,2842,502,18,20,38,47.4%,10m
6909,2,TitoRobert,2842,204,7,2,9,77.8%,28m
6909,3,Lino,2842,121,2,3,5,40.0%,7m
6909,3,Motop,2842,0,1,4,5,20.0%,12m
6909,2,SharpDOTSWE,2842,0,1,5,6,16.7%,20m
6909,3,Shax,2842,0,0,5,5,0.0%,5m
6917,1,JUliusCäsar,2841,140,5,10,15,33.3%,12m
6917,3,Manatee,2841,0,3,2,5,60.0%,11m
6917,3,SeeJah,2841,58,2,3,5,40.0%,10m
6917,3,tacocat,2841,30,2,3,5,40.0%,9m
6917,3,Coiless,2841,62,2,21,23,8.7%,11m
6917,3,[K0RM2]zerg,2841,0,0,1,1,0.0%,6m
6917,3,[Wonki]ArcaneForce,2841,0,0,1,1,0.0%,28m
6924,3,[ACNJP]Skadi,2840,287,9,10,19,47.4%,39m
6924,3,Timurkin,2840,200,6,3,9,66.7%,9m
6924,2,[CruZe]Marian,2840,0,4,1,5,80.0%,7m
6924,3,badarty,2840,122,4,6,10,40.0%,18m
6924,3,Mojo,2840,0,3,2,5,60.0%,9m
6924,1,[Arrows]AID,2840,97,3,3,6,50.0%,38m
6924,3,ThePreacher,2840,0,0,3,3,0.0%,8m
6931,2,RinAzgar,2839,1271,114,111,225,50.7%,2m
6931,1,kekeke,2839,1198,66,67,133,49.6%,6m
6931,2,SIVERTOV,2839,456,20,21,41,48.8%,10m
6931,3,Eljy,2839,120,7,6,13,53.8%,3m
6931,3,[LUSERS]PiojoCojo,2839,246,7,6,13,53.8%,10m
6931,3,[HZeS]CheckLeds,2839,0,2,3,5,40.0%,28m
6931,2,Valkyrie,2839,0,2,3,5,40.0%,1h
6931,2,cooking,2839,0,0,1,1,0.0%,29m
6939,3,[ValidG]Kers,2838,681,46,37,83,55.4%,18m
6939,3,Noobone,2838,273,28,4,32,87.5%,10m
6939,3,giantschrimp,2838,512,20,21,41,48.8%,21m
6939,1,Joel,2838,315,11,14,25,44.0%,28m
6939,3,[clanBé]Ulthwé,2838,86,3,4,7,42.9%,18m
6939,1,Barcode,2838,120,2,4,6,33.3%,1h
6939,3,super,2838,0,1,0,1,100.0%,9m
6939,3,[zouave]Niethalf,2838,0,0,1,1,0.0%,18m
6939,3,[Cyber]Thralanar,2838,0,0,1,1,0.0%,6m
6948,2,Schadow,2837,756,31,30,61,50.8%,2m
6948,2,Roks,2837,457,20,18,38,52.6%,6m
6948,2,xaverseltsam,2837,176,8,7,15,53.3%,17m
6948,2,[HSSN]HentropyH,2837,206,5,9,14,35.7%,10m
6948,2,[NTBD]EQUINUSOCIO,2837,0,4,1,5,80.0%,1h
6948,3,ChickenJoe,2837,164,4,2,6,66.7%,18m
6948,3,[43rus]Bot,2837,0,1,1,2,50.0%,10m
6948,3,[NO0Ber]porkiuss,2837,0,1,4,5,20.0%,14m
6948,3,BRAT,2837,0,0,1,1,0.0%,19m
6957,2,Alkadia,2836,697,58,58,116,50.0%,20m
6957,2,[FaiI]Kahmoon,2836,707,29,33,62,46.8%,6m
6957,3,прк,2836,498,21,10,31,67.7%,4m
6957,1,Thea,2836,394,17,19,36,47.2%,7m
6957,3,Meldir,2836,277,13,8,21,61.9%,11m
6957,3,CryptoKittie,2836,215,9,6,15,60.0%,10m
6957,3,Cheesecake,2836,208,7,3,10,70.0%,10m
6957,2,bEarchZz,2836,30,5,5,10,50.0%,27m
6957,2,kwizs,2836,146,5,10,15,33.3%,5m
6957,1,BALANCANET,2836,121,3,1,4,75.0%,1h
6957,3,Prototype,2836,0,3,3,6,50.0%,12m
6957,3,DarkTJ,2836,0,2,1,3,66.7%,16m
6957,3,Stirrer,2836,30,2,3,5,40.0%,13m
6957,3,Teshkul,2836,0,0,1,1,0.0%,12m
6971,2,Павел,2835,1566,150,140,290,51.7%,4m
6971,2,CoboltRazzil,2835,675,31,29,60,51.7%,10m
6971,3,robo,2835,291,14,11,25,56.0%,11m
6971,3,Ouch,2835,190,8,6,14,57.1%,14m
6971,3,[fam1ly]Steha,2835,232,8,9,17,47.1%,1h
6971,3,[fFlags]zrn,2835,0,4,1,5,80.0%,27m
6971,3,koosz,2835,106,4,3,7,57.1%,8m
6971,3,vlad,2835,0,3,0,3,100.0%,6m
6971,3,sserg,2835,0,2,1,3,66.7%,11m
6971,3,AttilaHM,2835,0,2,3,5,40.0%,16m
6971,3,Кикита,2835,0,2,3,5,40.0%,9m
6971,3,RunningMan,2835,30,1,2,3,33.3%,13m
6971,3,Funkykong,2835,30,1,2,3,33.3%,3m
6971,3,GhostDog,2835,0,1,2,3,33.3%,17m
6971,3,Lakaoum,2835,30,1,6,7,14.3%,5m
6971,3,[Molot]Мандаринка,2835,0,0,1,1,0.0%,16m
6987,2,Nide,2834,1611,368,370,738,49.9%,21m
6987,1,Kidzy,2834,1578,230,228,458,50.2%,7m
6987,2,Sem,2834,398,18,17,35,51.4%,6m
6987,1,PoZiTiVCHiK,2834,96,2,5,7,28.6%,26m
6987,3,Automaton,2834,0,2,7,9,22.2%,3m
6987,1,aye,2834,48,1,2,3,33.3%,1h
6987,1,Artanis,2834,0,1,3,4,25.0%,15m
6987,3,skyknight,2834,0,0,2,2,0.0%,2m
6995,3,Vixu,2833,1445,95,80,175,54.3%,28m
6995,3,Gal,2833,925,68,71,139,48.9%,3m
6995,2,[HighP]Федор,2833,472,20,18,38,52.6%,16m
6995,3,xOz,2833,86,3,3,6,50.0%,16m
6995,3,[Arrows]IvanKoghedub,2833,142,3,3,6,50.0%,10m
6995,3,apollon,2833,0,2,3,5,40.0%,9m
6995,2,[Stunt]Sonic,2833,0,2,5,7,28.6%,6m
6995,3,Huguenciorg,2833,0,1,0,1,100.0%,4m
6995,3,LimaPerse,2833,0,1,1,2,50.0%,11m
6995,3,[QClan]opahs,2833,0,0,1,1,0.0%,8m
7005,2,Ziko,2832,1583,231,224,455,50.8%,29m
7005,3,ForrestFunk,2832,328,11,11,22,50.0%,12m
7005,2,Greg,2832,296,10,12,22,45.5%,27m
7005,3,Sebo,2832,240,8,6,14,57.1%,1h
7005,3,cоndomring,2832,176,5,1,6,83.3%,10m
7005,3,Zéric,2832,0,4,1,5,80.0%,28m
7005,3,[PrTons]kelesha,2832,97,2,1,3,66.7%,17m
7005,3,[FROP]azlecas,2832,30,2,2,4,50.0%,18m
7005,3,ArazulHD,2832,0,1,0,1,100.0%,19m
7005,3,никита,2832,0,1,0,1,100.0%,10m
7005,1,BronX,2832,48,1,3,4,25.0%,2m
7005,2,[BWArmy]Iricommi,2832,0,0,1,1,0.0%,1h
7017,3,RobotNinja,2831,588,30,25,55,54.5%,3m
7017,2,ElTuzo,2831,725,28,28,56,50.0%,12m
7017,1,Fon,2831,364,16,16,32,50.0%,20m
7017,2,HotCoffeeDog,2831,180,6,12,18,33.3%,5m
7017,2,Metalyst,2831,60,2,27,29,6.9%,3m
7017,3,[G52]DEDMazdaj,2831,0,1,0,1,100.0%,9m
7017,2,Noob,2831,0,1,0,1,100.0%,1h
7017,1,Iron,2831,0,0,3,3,0.0%,20m
7025,1,HiHello,2830,620,62,57,119,52.1%,11m
7025,3,mwrevo,2830,448,28,18,46,60.9%,5m
7025,2,[Nerdom]OGBurnher,2830,152,7,6,13,53.8%,9m
7025,3,[N1TDA]erbol,2830,30,2,4,6,33.3%,4m
7025,3,Kyznec,2830,30,1,2,3,33.3%,11m
7025,2,[harald]Reckntech,2830,0,0,1,1,0.0%,1h
7031,2,Karnaf,2829,1392,51,53,104,49.0%,5m
7031,3,[SCMate]ImYourDream,2829,560,31,1,32,96.9%,10m
7031,3,ZergPower,2829,295,12,8,20,60.0%,19m
7031,2,VanDerFenix,2829,302,12,12,24,50.0%,5m
7031,2,MrDurden,2829,271,8,8,16,50.0%,38m
7031,3,Jolie,2829,170,6,6,12,50.0%,20m
7031,1,HappyBoy,2829,97,4,4,8,50.0%,20m
7031,3,Creepy,2829,88,3,3,6,50.0%,9m
7031,3,RanDomCoVid,2829,0,0,1,1,0.0%,12m
7040,3,boozzee,2828,332,27,22,49,55.1%,27m
7040,2,[R33]Damnight,2828,141,17,5,22,77.3%,29m
7040,3,[DirStr]Bombandil,2828,136,6,8,14,42.9%,18m
7040,3,Salader,2828,0,3,2,5,60.0%,11m
7040,3,HanSolo,2828,0,1,0,1,100.0%,10m
7040,3,Rostov,2828,0,0,1,1,0.0%,27m
7040,3,Tazguiel,2828,0,0,2,2,0.0%,28m
7047,3,DaveyBach,2827,1178,75,63,138,54.3%,29m
7047,3,PavlovsDog,2827,675,42,7,49,85.7%,8m
7047,2,haeikou,2827,953,37,38,75,49.3%,12m
7047,3,SPIRT,2827,431,20,14,34,58.8%,10m
7047,3,Lotusss,2827,385,16,12,28,57.1%,18m
7047,3,Паша,2827,60,3,2,5,60.0%,2m
7047,3,HitcH,2827,117,2,1,3,66.7%,27m
7047,2,[Traxen]Space,2827,0,2,3,5,40.0%,37m
7047,3,DaftJoker,2827,0,1,3,4,25.0%,4m
7047,2,[HISSSS]Leafmeisterr,2827,0,0,2,2,0.0%,24m
7057,3,Konstantinus,2826,1591,191,187,378,50.5%,8m
7057,1,KorwinCraft,2826,1502,65,67,132,49.2%,20m
7057,3,Валуев,2826,327,14,3,17,82.4%,2m
7057,3,LimitLesS,2826,392,14,10,24,58.3%,16m
7057,3,SupAndy,2826,247,10,16,26,38.5%,8m
7057,3,[TnpHun]Firefly,2826,225,7,5,12,58.3%,2m
7057,3,[0ne]wuschelandy,2826,30,4,3,7,57.1%,11m
7057,2,[HTAED]Eichhörnchen,2826,0,3,2,5,60.0%,1h
7057,2,StepsAhead,2826,96,2,2,4,50.0%,2m
7057,3,enesercin,2826,0,1,0,1,100.0%,4m
7057,3,FuNdaMentaL,2826,0,0,3,3,0.0%,6m
7068,3,Andarno,2825,950,144,106,250,57.6%,11m
7068,2,[Bkc]Darking,2825,1410,143,141,284,50.4%,15m
7068,3,[LeVaV]Borislav,2825,1178,50,47,97,51.5%,3m
7068,2,lllllllll,2825,610,23,29,52,44.2%,12m
7068,2,CBD,2825,216,6,9,15,40.0%,5m
7068,3,Mitstel,2825,0,1,0,1,100.0%,28m
7068,3,Fingolfin,2825,30,1,2,3,33.3%,8m
7068,1,[Krabы]titanik,2825,0,1,5,6,16.7%,1h
7068,3,Dyia,2825,0,0,1,1,0.0%,8m
7068,1,[PIZIKS]uvikay,2825,0,0,2,2,0.0%,36m
7078,3,RecycleBin,2824,1048,39,42,81,48.1%,13m
7078,2,[NForL]Budle,2824,962,38,35,73,52.1%,15m
7078,3,NaNome,2824,370,15,7,22,68.2%,9m
7078,3,Dyo,2824,237,7,6,13,53.8%,19m
7078,3,[KSMAST]Vole,2824,204,7,9,16,43.8%,15m
7078,2,countryroad,2824,230,7,10,17,41.2%,1h
7078,2,[EREKT]SuperHadoken,2824,66,3,7,10,30.0%,20m
7078,3,Fral,2824,88,3,7,10,30.0%,9m
7078,3,Kopaul,2824,0,2,3,5,40.0%,13m
7078,3,Natic,2824,0,1,0,1,100.0%,3m
7078,3,maslovoEuro,2824,0,1,1,2,50.0%,12m
7078,2,neverpuick,2824,0,0,2,2,0.0%,37m
7090,2,IVI,2823,1002,89,94,183,48.6%,15m
7090,3,SmallManIsak,2823,492,23,11,34,67.6%,6m
7090,3,Hedos,2823,378,17,9,26,65.4%,27m
7090,2,Rene,2823,416,15,14,29,51.7%,6m
7090,3,MiLaShKa,2823,351,14,13,27,51.9%,28m
7090,3,[raahhh]Flexi,2823,236,10,4,14,71.4%,3m
7090,3,Epitaph,2823,58,3,4,7,42.9%,8m
7090,3,Bumblebee,2823,30,1,1,2,50.0%,11m
7090,2,ExTZeiKo,2823,0,0,1,1,0.0%,1h
7090,3,Xeltif,2823,0,0,2,2,0.0%,8m
7090,3,Alex,2823,0,0,2,2,0.0%,5m
7101,3,[LifeTV]dantes,2822,185,76,42,118,64.4%,18m
7101,2,MericanChees,2822,836,32,37,69,46.4%,9m
7101,3,[MiMs]Gonzo,2822,218,9,0,9,100.0%,11m
7101,2,Lyurax,2822,197,8,8,16,50.0%,13m
7101,3,Fününününü,2822,115,4,4,8,50.0%,16m
7101,3,Fortnite,2822,119,2,2,4,50.0%,11m
7101,3,Jungleman,2822,0,1,0,1,100.0%,5m
7101,2,brtk,2822,0,1,0,1,100.0%,17m
7101,3,ololo,2822,0,1,7,8,12.5%,9m
7101,1,ionas,2822,0,0,3,3,0.0%,4m
7111,3,Awe,2821,685,84,67,151,55.6%,27m
7111,3,Jorunn,2821,1166,67,63,130,51.5%,18m
7111,2,METHUSALEM,2821,1346,58,59,117,49.6%,20m
7111,3,Vibe,2821,812,33,27,60,55.0%,7m
7111,2,EZFHO,2821,388,15,20,35,42.9%,15m
7111,2,AsaLiaH,2821,203,7,11,18,38.9%,4m
7111,3,Wolf,2821,145,6,4,10,60.0%,18m
7111,2,Alexandru,2821,112,5,5,10,50.0%,4m
7111,2,Deskariot,2821,30,4,5,9,44.4%,2m
7111,2,Plouc,2821,0,2,3,5,40.0%,1h
7111,2,Patriot,2821,0,0,3,3,0.0%,38m
7122,3,Sebs,2820,1610,479,475,954,50.2%,9m
7122,3,meng,2820,792,46,8,54,85.2%,18m
7122,3,Pincho,2820,570,23,21,44,52.3%,21m
7122,3,Jooe,2820,377,16,14,30,53.3%,2m
7122,3,[PLA2N]Cruiser,2820,140,4,1,5,80.0%,15m
7122,2,NotSaitama,2820,0,3,2,5,60.0%,1h
7122,1,Omones,2820,96,2,0,2,100.0%,4m
7122,1,Tseng,2820,96,1,1,2,50.0%,32m
7130,1,zzz,2819,1565,638,640,1278,49.9%,8m
7130,2,Gylisan,2819,1543,75,64,139,54.0%,15m
7130,2,Sverok,2819,685,44,45,89,49.4%,21m
7130,3,[ЯсЛИ]kolokol,2819,243,8,5,13,61.5%,10m
7130,2,sorcassio,2819,122,4,13,17,23.5%,12m
7130,3,FoxX,2819,0,3,2,5,60.0%,12m
7130,2,Taharii,2819,0,3,3,6,50.0%,2m
7130,3,[Str8]kostos,2819,115,3,3,6,50.0%,12m
7130,3,Andrfed,2819,0,2,3,5,40.0%,28m
7130,3,Dracool,2819,118,2,4,6,33.3%,2m
7130,3,sant,2819,0,1,0,1,100.0%,9m
7130,2,[Vio]Jin,2819,0,0,1,1,0.0%,23m
7130,1,Transend,2819,0,0,3,3,0.0%,2m
7143,3,RaimisFx,2818,1579,109,95,204,53.4%,19m
7143,2,borealis,2818,1550,103,102,205,50.2%,13m
7143,3,hawkk,2818,1381,80,60,140,57.1%,27m
7143,3,MonkeY,2818,720,35,16,51,68.6%,11m
7143,3,Bridgeburner,2818,117,7,4,11,63.6%,10m
7143,2,[sonic1]Reaper,2818,174,6,6,12,50.0%,13m
7143,2,[TTIS]PoppZg,2818,0,3,3,6,50.0%,2m
7143,3,llllllllllll,2818,0,2,3,5,40.0%,27m
7143,3,Inkognito,2818,0,1,0,1,100.0%,14m
7143,3,Gaius,2818,93,1,1,2,50.0%,8m
7143,3,[ČSČR]maLeJdžon,2818,94,1,4,5,20.0%,19m
7154,3,Alex,2817,833,37,26,63,58.7%,11m
7154,3,friedchicken,2817,751,31,29,60,51.7%,13m
7154,3,IIIIIIIII,2817,330,13,13,26,50.0%,11m
7154,3,Владыка,2817,232,12,0,12,100.0%,19m
7154,3,Keter,2817,199,8,8,16,50.0%,16m
7154,3,Lucky,2817,189,6,2,8,75.0%,19m
7154,1,Houston,2817,96,6,10,16,37.5%,11m
7154,3,one,2817,134,5,5,10,50.0%,12m
7154,3,calmvibes,2817,94,2,0,2,100.0%,4m
7154,3,[DthCon]McBlanc,2817,94,2,0,2,100.0%,9m
7154,3,Stakerrt,2817,30,2,1,3,66.7%,14m
7154,1,JosUA,2817,0,2,5,7,28.6%,14m
7154,3,[SРID]ПеЧеНьКа,2817,0,1,2,3,33.3%,7m
7154,3,pitboss,2817,0,0,1,1,0.0%,9m
7168,3,xiou,2816,1292,93,83,176,52.8%,11m
7168,3,[Rakia]MindStorm,2816,559,25,13,38,65.8%,13m
7168,3,[Hppl]Axezz,2816,418,25,21,46,54.3%,18m
7168,2,[LIQUID]NOOBeERrXD,2816,594,22,26,48,45.8%,10m
7168,3,Vershok,2816,492,18,15,33,54.5%,3m
7168,1,Verenz,2816,261,6,7,13,46.2%,4m
7168,3,alex,2816,0,3,3,6,50.0%,2m
7168,3,[oooboy]prizma,2816,30,1,3,4,25.0%,12m
7168,2,[WCKYLN]Geschlossen,2816,0,0,1,1,0.0%,1h
7168,3,[RLA]Bierbauch,2816,0,0,1,1,0.0%,2m
7168,3,babydead,2816,0,0,2,2,0.0%,11m
7168,2,Eoks,2816,0,0,7,7,0.0%,1h
7180,2,[BNerdZ]HumbaHarry,2815,1592,155,158,313,49.5%,16m
7180,2,[FLAX]DnBWicked,2815,994,47,49,96,49.0%,5m
7180,3,MpK,2815,993,46,27,73,63.0%,10m
7180,3,Coprocraft,2815,498,19,15,34,55.9%,12m
7180,3,Gspot,2815,30,2,2,4,50.0%,15m
7180,2,[MTGpow]DarthTrollus,2815,0,0,1,1,0.0%,6m
7180,3,KokaDIY,2815,0,0,1,1,0.0%,5m
7180,2,missC,2815,0,0,1,1,0.0%,37m
7188,1,ZaK,2814,1554,289,296,585,49.4%,6m
7188,3,Bluntus,2814,1503,75,91,166,45.2%,29m
7188,3,lel,2814,747,55,37,92,59.8%,29m
7188,3,Diggahs,2814,1002,40,35,75,53.3%,10m
7188,3,Goralden,2814,351,21,10,31,67.7%,13m
7188,3,[snowsf]Robin,2814,304,11,16,27,40.7%,3m
7188,3,EnkiVritra,2814,298,10,11,21,47.6%,11m
7188,3,ElSe,2814,281,9,6,15,60.0%,4m
7188,1,Inchworm,2814,227,9,7,16,56.2%,1h
7188,3,EliteBowser,2814,114,5,8,13,38.5%,8m
7188,3,Wanderlust,2814,0,3,2,5,60.0%,11m
7188,2,Lukey,2814,0,1,0,1,100.0%,31m
7188,3,thySEus,2814,0,1,0,1,100.0%,10m
7188,3,Strypkeroz,2814,0,1,1,2,50.0%,15m
7188,3,pwi,2814,0,0,2,2,0.0%,28m
7188,3,[USSO]breakershot,2814,0,0,3,3,0.0%,11m
7204,2,MissLaura,2813,1258,153,154,307,49.8%,17m
7204,3,RobPiton,2813,601,21,22,43,48.8%,18m
7204,3,Terran,2813,542,19,22,41,46.3%,18m
7204,3,ПoTpoWuTeJl,2813,276,10,4,14,71.4%,29m
7204,3,[GаVnO]Alpheratz,2813,276,9,7,16,56.2%,15m
7204,3,Rolly,2813,239,9,7,16,56.2%,9m
7204,3,[SURN]MicKey,2813,114,7,2,9,77.8%,9m
7204,3,[охота]YellowRuby,2813,133,5,3,8,62.5%,12m
7204,2,Maevius,2813,116,5,5,10,50.0%,2m
7204,3,NaSHx,2813,194,5,5,10,50.0%,1h
7204,3,[Mergel]Wigglos,2813,162,5,7,12,41.7%,3m
7204,3,antizack,2813,134,3,1,4,75.0%,12m
7204,3,aratap,2813,30,2,1,3,66.7%,9m
7204,3,SayNoToStim,2813,118,2,2,4,50.0%,3m
7204,3,EncOre,2813,94,1,1,2,50.0%,19m
7204,1,asdf,2813,0,1,1,2,50.0%,1h
7204,3,DarkSector,2813,0,1,2,3,33.3%,27m
7204,3,leoken,2813,0,0,2,2,0.0%,11m
7222,1,CaNnoNdaLe,2812,1463,95,99,194,49.0%,13m
7222,3,Buba,2812,819,48,24,72,66.7%,3m
7222,3,VACvicent,2812,928,41,36,77,53.2%,6m
7222,3,KlimenToS,2812,280,14,11,25,56.0%,5m
7222,2,Padachan,2812,182,8,8,16,50.0%,1h
7222,3,[NINJ88]DaZe,2812,226,8,16,24,33.3%,9m
7222,2,Swacha,2812,130,4,7,11,36.4%,2m
7222,2,Yesterday,2812,48,3,4,7,42.9%,34m
7222,1,BlacKZ,2812,122,3,6,9,33.3%,1h
7222,3,BlackGhost,2812,0,2,3,5,40.0%,11m
7222,3,Jochem,2812,30,1,3,4,25.0%,13m
7222,2,CosmicFlower,2812,0,1,4,5,20.0%,1h
7222,1,Jaimevh,2812,0,1,6,7,14.3%,30m
7222,1,[Miszcz]kaktanternak,2812,0,0,1,1,0.0%,1h
7222,3,[BRock]EmpireZ,2812,0,0,1,1,0.0%,2m
7222,3,efoincflcefc,2812,0,0,1,1,0.0%,3m
7222,2,Windowsuser,2812,0,0,3,3,0.0%,1h
7239,3,Romulus,2811,433,20,7,27,74.1%,29m
7239,3,bronzy,2811,380,14,16,30,46.7%,11m
7239,3,Zertzustr,2811,262,11,11,22,50.0%,3m
7239,3,polakziomek,2811,129,3,6,9,33.3%,29m
7239,3,[TPcs]SETTO,2811,30,2,1,3,66.7%,12m
7239,3,Nooby,2811,94,1,1,2,50.0%,21m
7239,3,Tayshys,2811,94,1,1,2,50.0%,16m
7239,3,[zukaCo]Roakin,2811,93,1,1,2,50.0%,27m
7239,3,ToNyM,2811,0,0,3,3,0.0%,12m
7248,3,[VFN]RazvanBly,2810,626,29,25,54,53.7%,28m
7248,3,XxMOBABOxX,2810,511,19,19,38,50.0%,6m
7248,3,HaiRcuT,2810,462,19,21,40,47.5%,11m
7248,3,[NS2019]Alariy,2810,392,16,10,26,61.5%,11m
7248,2,BlackAssasin,2810,486,16,24,40,40.0%,13m
7248,3,TheStickyBun,2810,208,9,9,18,50.0%,21m
7248,3,Hydrius,2810,223,8,3,11,72.7%,15m
7248,1,Dominius,2810,119,2,1,3,66.7%,1h
7248,3,Bluesman,2810,114,2,2,4,50.0%,21m
7248,3,theolo,2810,0,2,3,5,40.0%,9m
7248,2,[AciNoN]Ambrella,2810,0,1,2,3,33.3%,21m
7248,3,StarKillers,2810,0,0,1,1,0.0%,21m
7248,3,xxArenaMxx,2810,0,0,2,2,0.0%,15m
7248,1,[BL4Z3r]Aleksanderto,2810,0,0,3,3,0.0%,1h
7262,3,[SMFS]teaz,2809,1461,160,169,329,48.6%,28m
7262,1,[3Dcla]Alexlocky,2809,1423,93,95,188,49.5%,9m
7262,1,shadow,2809,770,59,70,129,45.7%,14m
7262,2,aral,2809,966,46,42,88,52.3%,16m
7262,3,spottyknotty,2809,656,28,19,47,59.6%,12m
7262,3,dadou,2809,388,16,14,30,53.3%,4m
7262,3,ZergMan,2809,336,15,6,21,71.4%,10m
7262,2,Shoobos,2809,390,14,23,37,37.8%,12m
7262,3,ICA,2809,224,9,3,12,75.0%,20m
7262,1,noid,2809,140,5,5,10,50.0%,1h
7262,2,DFox,2809,0,4,1,5,80.0%,25m
7262,3,Hornet,2809,0,1,0,1,100.0%,3m
7262,3,[KkzZ]kouzin,2809,0,0,1,1,0.0%,3m
7262,2,DedFura,2809,0,0,2,2,0.0%,1h
7276,3,Intoxikot,2808,756,49,37,86,57.0%,11m
7276,3,ReturnValue,2808,650,27,16,43,62.8%,14m
7276,2,JaKkals,2808,656,22,28,50,44.0%,12m
7276,2,[nSl]nSlZik,2808,258,12,13,25,48.0%,2m
7276,3,Бульба,2808,263,9,7,16,56.2%,14m
7276,3,llllllllllll,2808,217,8,8,16,50.0%,19m
7276,3,RhinoHUN,2808,114,5,6,11,45.5%,26m
7276,3,Lucifer,2808,158,5,10,15,33.3%,11m
7276,3,[STOBAG]haniball,2808,111,4,2,6,66.7%,16m
7276,3,Mefisto,2808,114,3,0,3,100.0%,27m
7276,2,[JJBZ]LawnMower,2808,117,3,2,5,60.0%,1h
7276,1,BeLzmEn,2808,145,2,3,5,40.0%,1h
7276,1,karanas,2808,0,2,6,8,25.0%,23m
7276,3,uNiT,2808,0,1,0,1,100.0%,18m
7276,3,Alone,2808,0,0,1,1,0.0%,6m
7276,1,[K0RM2]Agrobot,2808,0,0,1,1,0.0%,38m
7276,3,[ioStuN]IIIIIIIIIIII,2808,0,0,1,1,0.0%,7m
7276,3,[Nipps]SITTner,2808,0,0,4,4,0.0%,27m
7294,2,[U22U2]cardslash,2807,1373,57,60,117,48.7%,21m
7294,3,DumbFatPig,2807,1069,50,38,88,56.8%,4m
7294,3,Xakari,2807,783,33,25,58,56.9%,5m
7294,2,ReipasPoika,2807,412,15,17,32,46.9%,17m
7294,2,MBS,2807,232,9,13,22,40.9%,12m
7294,3,wIxXoR,2807,227,8,10,18,44.4%,13m
7294,2,zeroe,2807,186,6,14,20,30.0%,6m
7294,2,[Xtreme]Requiem,2807,163,4,0,4,100.0%,1h
7294,3,daedr,2807,118,3,1,4,75.0%,12m
7294,1,GoDKaRaKaN,2807,48,3,7,10,30.0%,1h
7294,3,GREG,2807,30,1,3,4,25.0%,14m
7294,2,Referendum,2807,0,1,7,8,12.5%,4m
7294,1,[Boota]Penge,2807,0,0,1,1,0.0%,4m
7294,3,Kane,2807,0,0,2,2,0.0%,2m
7308,1,[BotN]FunkyBear,2806,1306,102,112,214,47.7%,8m
7308,3,Nova,2806,1109,81,67,148,54.7%,8m
7308,3,ButchT,2806,813,54,53,107,50.5%,11m
7308,3,Buba,2806,518,25,16,41,61.0%,5m
7308,2,planB,2806,548,20,25,45,44.4%,15m
7308,3,Harbinger,2806,408,14,13,27,51.9%,18m
7308,1,Parliament,2806,303,9,6,15,60.0%,26m
7308,1,[CBFPL]bialo,2806,143,8,3,11,72.7%,23m
7308,1,ilafat,2806,148,7,4,11,63.6%,3m
7308,3,Gnu,2806,164,4,3,7,57.1%,16m
7308,3,Frankoi,2806,0,2,3,5,40.0%,15m
7319,3,tssd,2805,1461,174,161,335,51.9%,5m
7319,3,Donbass,2805,376,21,23,44,47.7%,6m
7319,3,DEATHSTAR,2805,410,18,19,37,48.6%,3m
7319,2,[SPАRТА]Akixiro,2805,357,15,14,29,51.7%,7m
7319,3,izeRR,2805,318,10,9,19,52.6%,2m
7319,2,[BWArmy]RoiDeMars,2805,172,7,7,14,50.0%,12m
7319,3,Pornotraktar,2805,122,7,9,16,43.8%,11m
7319,3,Jopetto,2805,154,5,8,13,38.5%,5m
7319,3,petusa,2805,132,4,1,5,80.0%,21m
7319,2,Thibzzz,2805,96,4,1,5,80.0%,31m
7319,3,RichFroning,2805,30,4,3,7,57.1%,9m
7319,3,JluC,2805,0,3,2,5,60.0%,12m
7319,3,hodor,2805,88,3,6,9,33.3%,5m
7319,3,EveryLevel,2805,58,2,3,5,40.0%,13m
7319,3,EtTuBrutus,2805,0,1,0,1,100.0%,18m
7319,2,vlad,2805,0,1,0,1,100.0%,1h
7319,3,MEGAPASH,2805,92,1,1,2,50.0%,16m
7319,3,Cephalotus,2805,0,0,4,4,0.0%,7m
7337,2,Milites,2804,1366,193,197,390,49.5%,27m
7337,3,Whitenova,2804,798,71,67,138,51.4%,19m
7337,3,[MVV77]MVVRock,2804,657,57,45,102,55.9%,19m
7337,1,CheekyJoker,2804,1264,44,57,101,43.6%,15m
7337,3,Troy,2804,236,8,12,20,40.0%,18m
7337,3,[Gremli]Zorrotul,2804,0,3,2,5,60.0%,12m
7343,3,SpYcY,2803,661,36,12,48,75.0%,8m
7343,3,gammis,2803,349,18,17,35,51.4%,8m
7343,3,TerranMan,2803,203,15,11,26,57.7%,3m
7343,3,Zhuke,2803,241,9,9,18,50.0%,17m
7343,2,TnT,2803,94,2,1,3,66.7%,5m
7343,3,Amberman,2803,0,2,3,5,40.0%,20m
7343,3,IIIIIIIIIIII,2803,0,0,1,1,0.0%,28m
7350,3,Maneken,2802,1556,153,141,294,52.0%,8m
7350,3,Rosen,2802,899,67,59,126,53.2%,9m
7350,2,Hacker,2802,834,64,65,129,49.6%,27m
7350,3,bodryachock,2802,1372,62,57,119,52.1%,15m
7350,3,SHALFEY,2802,813,52,39,91,57.1%,5m
7350,3,TVister,2802,296,11,5,16,68.8%,11m
7350,3,Rhaegar,2802,252,9,15,24,37.5%,5m
7350,3,[RGSC2]train,2802,279,8,12,20,40.0%,9m
7350,2,Milcheis,2802,278,8,17,25,32.0%,6m
7350,1,Plate,2802,217,7,6,13,53.8%,28m
7350,3,Zvirbulis,2802,0,3,2,5,60.0%,2m
7350,1,MrBig,2802,96,2,4,6,33.3%,28m
7350,3,[Маньяк]llllllllllll,2802,0,1,0,1,100.0%,29m
7350,3,scywe,2802,0,1,1,2,50.0%,9m
7350,3,PilouPilou,2802,0,0,1,1,0.0%,3m
7365,3,denrus,2801,1370,124,110,234,53.0%,20m
7365,1,SingleMan,2801,1170,99,102,201,49.3%,6m
7365,2,dompiche,2801,1183,49,48,97,50.5%,27m
7365,3,LaSaK,2801,530,24,18,42,57.1%,5m
7365,3,[beaste]Storm,2801,319,15,7,22,68.2%,12m
7365,1,NadMozg,2801,466,14,28,42,33.3%,13m
7365,2,Illusion,2801,179,8,10,18,44.4%,29m
7365,3,[ZERGTB]Meliodas,2801,193,6,6,12,50.0%,26m
7365,3,Cheesus,2801,106,4,3,7,57.1%,14m
7365,3,Xristi,2801,0,2,3,5,40.0%,18m
7365,3,żuraw,2801,0,0,1,1,0.0%,2m
7365,3,RoX,2801,0,0,3,3,0.0%,3m
7377,3,TTToooMMM,2800,1561,139,136,275,50.5%,18m
7377,3,Ben,2800,1454,116,108,224,51.8%,2m
7377,3,[GhostW]Grantz,2800,270,10,11,21,47.6%,18m
7377,3,MCLK,2800,227,7,9,16,43.8%,27m
7377,2,shakir,2800,0,4,2,6,66.7%,22m
7377,1,[Clan64]SilentBot,2800,0,3,4,7,42.9%,34m
7377,1,Samnya,2800,48,2,0,2,100.0%,1h
7377,3,NightCrawler,2800,30,2,1,3,66.7%,9m
7377,3,StalZ,2800,0,1,4,5,20.0%,13m
7377,3,AdasW,2800,0,0,2,2,0.0%,8m
7387,3,Dallacost,2799,340,16,15,31,51.6%,2m
7387,2,[DET54]DimonLimON,2799,303,10,10,20,50.0%,12m
7387,2,[Dnozar]Zeliboba,2799,262,9,18,27,33.3%,15m
7387,3,[RaLaKn]ToMoKrOwA,2799,242,8,7,15,53.3%,4m
7387,3,[1NFEC7]doggy,2799,119,3,1,4,75.0%,18m
7387,3,pryaniksex,2799,120,2,3,5,40.0%,9m
7387,1,Maelstrom,2799,0,2,7,9,22.2%,15m
7387,1,Blackbird,2799,0,0,1,1,0.0%,1h
7387,3,Moridin,2799,0,0,2,2,0.0%,5m
7396,2,loic,2798,1277,129,128,257,50.2%,21m
7396,3,BlueOcean,2798,1543,73,71,144,50.7%,3m
7396,2,[Apocs]kingwarde,2798,684,25,32,57,43.9%,7m
7396,3,[Cigar]TomRipley,2798,504,21,12,33,63.6%,13m
7396,3,Emeraude,2798,454,18,16,34,52.9%,19m
7396,3,Amigo,2798,252,10,10,20,50.0%,19m
7396,2,hamilyon,2798,181,8,8,16,50.0%,29m
7396,3,WingsOfNike,2798,170,4,5,9,44.4%,26m
7396,3,[UndCo]jackhaze,2798,58,3,3,6,50.0%,18m
7396,1,superfil,2798,76,2,2,4,50.0%,11m
7396,1,[BYTCA]thorN,2798,0,0,1,1,0.0%,26m
7407,3,Octava,2797,448,17,18,35,48.6%,18m
7407,3,[FRANCE]CAESAR,2797,384,13,31,44,29.5%,7m
7407,2,Qwan,2797,335,12,12,24,50.0%,1h
7407,1,Kawa,2797,257,6,3,9,66.7%,29m
7407,3,Eldores,2797,90,4,4,8,50.0%,5m
7407,3,BlackGad,2797,60,3,5,8,37.5%,11m
7407,3,SIZZURP,2797,0,1,0,1,100.0%,21m
7407,1,[Dytred]MayorKirov,2797,0,1,4,5,20.0%,2m
7407,2,HeroZergling,2797,0,0,1,1,0.0%,36m
7407,1,TRENER,2797,0,0,1,1,0.0%,19m
7417,2,ArquiRaVeN,2796,1423,124,120,244,50.8%,27m
7417,2,oeufalacoc,2796,1606,124,122,246,50.4%,15m
7417,2,MaSeGe,2796,1459,57,58,115,49.6%,12m
7417,1,Pinky,2796,973,36,26,62,58.1%,32m
7417,3,Tarjan,2796,676,27,22,49,55.1%,12m
7417,1,LadyNoob,2796,631,23,20,43,53.5%,33m
7417,3,Radiance,2796,216,7,5,12,58.3%,9m
7417,1,GriwMF,2796,232,7,6,13,53.8%,23m
7417,2,raduku,2796,102,5,4,9,55.6%,29m
7417,1,anaujiraM,2796,148,4,1,5,80.0%,16m
7417,1,[Gоld]JEKA,2796,78,3,0,3,100.0%,37m
7417,3,[exQ]Mave,2796,60,3,2,5,60.0%,21m
7417,3,Djecraft,2796,0,1,1,2,50.0%,2m
7417,3,[GPs57]Kzkh,2796,0,1,3,4,25.0%,3m
7417,3,[BBNOBZ]GosUNooB,2796,0,0,1,1,0.0%,12m
7432,3,Blackadder,2795,609,82,85,167,49.1%,18m
7432,2,Docent,2795,1598,64,67,131,48.9%,12m
7432,1,Genji,2795,615,29,16,45,64.4%,6m
7432,2,Mahadeva,2795,846,29,34,63,46.0%,12m
7432,3,MrFer,2795,592,25,23,48,52.1%,13m
7432,3,pewyrtu,2795,330,12,10,22,54.5%,8m
7432,3,Schneider,2795,207,8,8,16,50.0%,34m
7432,3,[P0P0]KickAss,2795,30,2,2,4,50.0%,8m
7432,2,Mendo,2795,0,2,5,7,28.6%,4m
7441,1,johnybill,2794,1411,61,34,95,64.2%,35m
7441,1,Sketch,2794,848,51,41,92,55.4%,1h
7441,1,Uthegen,2794,834,36,33,69,52.2%,30m
7441,3,[M1SE]maghea,2794,360,14,12,26,53.8%,11m
7445,3,Bartas,2793,761,59,45,104,56.7%,12m
7445,3,[Obz]Yéthylique,2793,126,5,9,14,35.7%,19m
7445,3,xRUGBYx,2793,30,2,6,8,25.0%,19m
7445,1,[TOCC]Vendetta,2793,0,0,1,1,0.0%,35m
7449,3,Envy,2792,683,29,21,50,58.0%,13m
7449,2,[AbNorm]Uglùk,2792,248,11,9,20,55.0%,18m
7449,1,AndyTRAMBLEx,2792,236,7,8,15,46.7%,38m
7449,1,Slayther,2792,42,5,2,7,71.4%,28m
7449,1,Velnyke,2792,114,5,6,11,45.5%,1h
7449,3,[EGDA]Ensten,2792,120,4,6,10,40.0%,6m
7449,1,OOMPH,2792,0,3,2,5,60.0%,16m
7449,3,Listefar,2792,58,3,4,7,42.9%,3m
7449,2,Bigdaddy,2792,0,2,3,5,40.0%,1h
7449,3,[XIID]Bilos,2792,0,1,2,3,33.3%,11m
7449,2,Reverser,2792,0,1,6,7,14.3%,16m
7449,1,yamatoria,2792,0,0,1,1,0.0%,1h
7449,3,HeDoBoDKa,2792,0,0,2,2,0.0%,18m
7449,2,zockerever,2792,0,0,5,5,0.0%,1h
7463,3,Tiger,2791,1325,65,60,125,52.0%,11m
7463,3,[G500]Uveryugly,2791,1382,60,59,119,50.4%,12m
7463,1,[NLTN]illilililili,2791,1207,54,65,119,45.4%,8m
7463,3,KdM,2791,564,24,19,43,55.8%,5m
7463,3,Homelander,2791,578,24,20,44,54.5%,9m
7463,3,[PGPOOL]Shura,2791,662,23,27,50,46.0%,5m
7463,1,Timay,2791,304,10,6,16,62.5%,37m
7463,3,NoobSaibot,2791,121,6,3,9,66.7%,2m
7471,3,Coach,2790,446,18,16,34,52.9%,16m
7471,2,AlaBalaPorto,2790,0,3,2,5,60.0%,8m
7471,1,[0001]Bredator,2790,102,3,4,7,42.9%,18m
7471,1,[DarS]Ashka,2790,78,2,3,5,40.0%,1h
7475,2,grider,2789,952,53,55,108,49.1%,8m
7475,1,Naturalplan,2789,1144,50,55,105,47.6%,7m
7475,2,[GALU]LXXVII,2789,691,26,29,55,47.3%,3m
7475,1,yoba,2789,425,18,19,37,48.6%,12m
7475,2,Darkflip,2789,144,4,9,13,30.8%,29m
7475,3,Rise,2789,142,3,1,4,75.0%,1h
7475,2,HuntGuy,2789,0,2,0,2,100.0%,35m
7475,2,[FIB153]TartanComa,2789,0,0,1,1,0.0%,40m
7475,1,Bruzzlee,2789,0,0,1,1,0.0%,35m
7475,2,SilkShadow,2789,0,0,2,2,0.0%,1h
7485,3,DragonMaouss,2788,1020,53,25,78,67.9%,19m
7485,2,Biseptold,2788,103,21,15,36,58.3%,5m
7485,3,IronKansler,2788,476,18,19,37,48.6%,5m
7485,3,OutoOlio,2788,294,11,11,22,50.0%,11m
7485,3,Niga,2788,206,7,14,21,33.3%,14m
7485,3,FENIX,2788,30,2,3,5,40.0%,11m
7485,3,Quester,2788,0,0,2,2,0.0%,16m
7492,2,Julo,2787,359,52,52,104,50.0%,3m
7492,1,Veto,2787,142,4,5,9,44.4%,32m
7492,1,Tzeench,2787,120,2,1,3,66.7%,1h
7492,1,Manrom,2787,0,1,0,1,100.0%,11m
7492,2,[PUT1]SaMere,2787,30,1,9,10,10.0%,5m
7492,1,Artisan,2787,0,0,1,1,0.0%,35m
7492,3,noVice,2787,0,0,5,5,0.0%,10m
7499,3,[Catory]Kacpeross,2786,479,21,15,36,58.3%,5m
7499,3,Canuma,2786,399,18,22,40,45.0%,16m
7499,3,tolstij,2786,175,5,4,9,55.6%,1h
7499,3,kamax,2786,0,4,2,6,66.7%,19m
7499,1,Iron,2786,38,3,3,6,50.0%,1h
7499,2,[RGSC2]MONSTER,2786,0,1,0,1,100.0%,1h
7499,2,AbsolutSim,2786,0,0,1,1,0.0%,31m
7506,3,Jerome,2785,1001,65,57,122,53.3%,13m
7506,2,RuneSpirit,2785,770,33,39,72,45.8%,15m
7506,1,[Wt1]uszi,2785,920,32,40,72,44.4%,9m
7506,3,WeltallAlpha,2785,318,28,19,47,59.6%,3m
7506,1,salah,2785,351,12,5,17,70.6%,5m
7506,1,Jesuke,2785,0,1,0,1,100.0%,1h
7506,1,Nestea,2785,0,0,1,1,0.0%,1h
7513,2,xapepama,2784,1510,198,177,375,52.8%,16m
7513,1,wafflecopter,2784,1439,86,93,179,48.0%,3m
7513,2,HrSpEgEpØlSe,2784,1246,48,51,99,48.5%,14m
7513,2,Human,2784,595,24,27,51,47.1%,20m
7513,3,saber,2784,464,17,21,38,44.7%,19m
7513,1,DiGrizz,2784,226,7,4,11,63.6%,1h
7513,3,[l2poca]ltwopoca,2784,162,7,5,12,58.3%,5m
7513,3,Reckvus,2784,144,5,12,17,29.4%,3m
7513,1,Myxomor,2784,72,2,6,8,25.0%,6m
7513,3,[mltdcz]NickMcCloud,2784,0,1,3,4,25.0%,10m
7523,3,[coors]coorsllte,2783,1680,161,163,324,49.7%,7m
7523,3,Silence,2783,1339,62,54,116,53.4%,11m
7523,3,LingMuchDing,2783,1132,43,44,87,49.4%,19m
7523,2,crazycorn,2783,679,28,37,65,43.1%,4m
7523,2,King,2783,480,22,18,40,55.0%,8m
7523,3,Roro,2783,254,9,8,17,52.9%,5m
7523,1,SHYTBIRD,2783,194,6,6,12,50.0%,7m
7523,3,[PdTus]Vogul,2783,110,4,4,8,50.0%,14m
7523,3,goobypls,2783,0,3,3,6,50.0%,6m
7523,1,Energizer,2783,40,3,3,6,50.0%,1h
7523,3,Chamber,2783,0,1,3,4,25.0%,1h
7523,2,kroll,2783,46,1,4,5,20.0%,16m
7535,3,Unrealfff,2782,408,16,13,29,55.2%,12m
7535,3,jaakkome,2782,374,14,17,31,45.2%,3m
7535,1,SingularBio,2782,296,12,13,25,48.0%,9m
7535,1,[fackme]борода,2782,259,9,2,11,81.8%,1h
7535,1,SpartakRuS,2782,0,4,1,5,80.0%,33m
7535,1,daxmax,2782,40,2,4,6,33.3%,19m
7535,3,[Hanse]DeWil,2782,0,1,5,6,16.7%,29m
7542,2,[AiRǂ]AirBass,2781,644,149,139,288,51.7%,10m
7542,3,[Kans]Умник,2781,1277,85,86,171,49.7%,3m
7542,3,FoxX,2781,1025,37,34,71,52.1%,21m
7542,3,Cake,2781,766,30,33,63,47.6%,12m
7542,1,Zarathustra,2781,534,23,12,35,65.7%,9m
7542,3,Eldershot,2781,398,14,20,34,41.2%,13m
7542,2,Zeratul,2781,242,10,12,22,45.5%,4m
7542,1,Kingzilla,2781,136,8,9,17,47.1%,12m
7542,1,Satanademon,2781,139,7,4,11,63.6%,1h
7542,1,Yanodin,2781,193,3,5,8,37.5%,1h
7542,3,Stixoo,2781,0,1,0,1,100.0%,1h
7542,2,Killerkueken,2781,0,0,4,4,0.0%,23m
7554,2,iamsama,2780,1514,185,193,378,48.9%,15m
7554,2,zero,2780,1351,60,58,118,50.8%,15m
7554,2,Laker,2780,435,18,17,35,51.4%,5m
7554,3,Arbiter,2780,376,14,5,19,73.7%,37m
7554,3,MaCaBrOs,2780,143,5,4,9,55.6%,29m
7554,1,[BrothW]SPaiDyR,2780,157,4,8,12,33.3%,20m
7554,3,knecht,2780,30,1,3,4,25.0%,9m
7561,2,PowerOID,2779,1328,127,135,262,48.5%,7m
7561,2,[BigDad]WarTC,2779,1356,73,78,151,48.3%,13m
7561,2,Akavir,2779,739,67,74,141,47.5%,5m
7561,1,[HaSKo]Den,2779,781,30,23,53,56.6%,1h
7561,3,AytugBerat,2779,429,30,24,54,55.6%,5m
7561,2,Trick,2779,474,18,24,42,42.9%,6m
7561,2,WOLF,2779,314,13,10,23,56.5%,32m
7561,3,MarineMonroe,2779,246,8,15,23,34.8%,12m
7561,1,MsxMods,2779,97,3,5,8,37.5%,35m
7561,1,[MDLeg]Fobos,2779,0,2,3,5,40.0%,19m
7561,3,Fogy,2779,0,0,7,7,0.0%,8m
7572,1,otec,2778,459,13,10,23,56.5%,17m
7572,3,roronoa,2778,252,8,8,16,50.0%,13m
7572,3,zifan,2778,220,7,7,14,50.0%,8m
7572,3,[2iq]MacroLI,2778,159,5,3,8,62.5%,11m
7572,3,MXCIIXTRIP,2778,114,5,5,10,50.0%,7m
7572,3,[SLIM]Rainbow,2778,144,4,7,11,36.4%,18m
7572,3,Raven,2778,62,3,5,8,37.5%,13m
7572,1,[ExTr1m]LUX,2778,94,2,0,2,100.0%,1h
7572,3,esLXeqtR,2778,62,2,5,7,28.6%,14m
7572,1,ahtohhh,2778,44,1,2,3,33.3%,35m
7572,1,[VVA]BigNoob,2778,0,0,1,1,0.0%,1h
7572,1,Heeger,2778,0,0,1,1,0.0%,16m
7584,2,[XF71]Ich,2777,1126,46,45,91,50.5%,5m
7584,1,Fatnoob,2777,391,13,15,28,46.4%,23m
7584,2,SevenSins,2777,207,7,4,11,63.6%,1h
7584,2,McgregorJR,2777,30,4,6,10,40.0%,15m
7584,1,Neuro,2777,84,3,2,5,60.0%,31m
7584,1,[HUIHUI]kdp,2777,167,3,3,6,50.0%,1h
7584,2,[ClubL]Keryatos,2777,78,3,6,9,33.3%,1h
7584,1,Tsuna,2777,0,1,0,1,100.0%,1h
7584,1,[SkCzM]mičkakingCZ,2777,0,1,1,2,50.0%,1h
7584,1,bombarbia,2777,0,0,1,1,0.0%,6m
7584,1,[ioStuN]FluffyKitten,2777,0,0,1,1,0.0%,27m
7584,1,[BPT]gado,2777,0,0,3,3,0.0%,35m
7596,3,GancteR,2776,1112,63,55,118,53.4%,8m
7596,2,Lokierin,2776,612,35,35,70,50.0%,21m
7596,1,[loxi]Kurad,2776,194,10,14,24,41.7%,15m
7596,1,Faron,2776,237,4,5,9,44.4%,1h
7596,1,[MHACKS]kenji,2776,0,0,1,1,0.0%,16m
7596,1,Mastrer,2776,0,0,1,1,0.0%,1h
7596,3,[Hаsu]vitekes,2776,0,0,2,2,0.0%,31m
7603,2,meta,2775,666,34,38,72,47.2%,20m
7603,3,Valahano,2775,640,26,20,46,56.5%,6m
7603,1,Zergy,2775,370,13,9,22,59.1%,1h
7603,1,Eltsengur,2775,244,8,6,14,57.1%,40m
7603,1,[ONKIE]binloadin,2775,169,5,7,12,41.7%,1h
7603,3,Ghost,2775,0,4,2,6,66.7%,29m
7603,1,[KYSM]Terrecator,2775,0,3,2,5,60.0%,23m
7603,3,Hypogojix,2775,90,3,6,9,33.3%,27m
7603,1,MkL,2775,0,0,1,1,0.0%,10m
7612,3,[Frntln]Mylor,2774,412,22,18,40,55.0%,20m
7612,3,Merline,2774,524,20,17,37,54.1%,21m
7612,2,Lenin,2774,344,11,19,30,36.7%,6m
7612,3,twocap,2774,195,8,8,16,50.0%,9m
7612,1,[Kripta]САФАРИ,2774,254,7,4,11,63.6%,19m
7612,1,[PCon]PISTOLAxHERO,2774,0,2,3,5,40.0%,10m
7612,2,[Emot]NyDuS,2774,95,2,4,6,33.3%,1h
7612,2,Fotis,2774,96,1,1,2,50.0%,1h
7612,3,[QClan]JSDK,2774,30,1,3,4,25.0%,2m
7612,1,Tselest,2774,0,0,2,2,0.0%,17m
7622,2,[ShSq]Randomizer,2773,1188,491,483,974,50.4%,7m
7622,2,[Dahu]KserChew,2773,1252,130,133,263,49.4%,16m
7622,2,ZorPit,2773,1508,127,119,246,51.6%,4m
7622,3,ARzR,2773,1457,110,109,219,50.2%,13m
7622,2,bouncybear,2773,599,21,26,47,44.7%,20m
7622,3,Subzero,2773,249,8,8,16,50.0%,15m
7622,3,Veiger,2773,198,7,5,12,58.3%,7m
7622,3,[UMTAIS]KACT,2773,204,6,5,11,54.5%,9m
7622,1,[ImbaG]Vladimir,2773,0,0,1,1,0.0%,24m
7631,3,Diego,2772,177,5,4,9,55.6%,11m
7631,3,[mohu]nosnicu,2772,120,5,6,11,45.5%,10m
7631,3,[FGF92]GwiGwi,2772,30,4,4,8,50.0%,7m
7631,3,EwokuChan,2772,0,2,3,5,40.0%,16m
7631,3,[III]Entitaet,2772,127,2,6,8,25.0%,3m
7631,3,UmadBro,2772,0,1,2,3,33.3%,14m
7631,3,BroilerBear,2772,30,1,5,6,16.7%,7m
7631,3,Belo,2772,30,1,7,8,12.5%,11m
7631,2,[Hells9]Hellskeleton,2772,0,0,1,1,0.0%,1h
7631,3,Grulk,2772,0,0,4,4,0.0%,13m
7641,2,JimM,2771,1516,346,344,690,50.1%,16m
7641,3,[THANOS]Winston,2771,1106,47,39,86,54.7%,8m
7641,3,[ODISO]igor,2771,965,35,36,71,49.3%,9m
7641,1,Раян,2771,806,25,24,49,51.0%,37m
7641,3,maxpower,2771,186,4,9,13,30.8%,7m
7641,2,ПокимонСтайл,2771,0,3,3,6,50.0%,26m
7641,1,lalalaalalal,2771,0,1,0,1,100.0%,31m
7641,2,GustavGhost,2771,46,1,3,4,25.0%,1h
7641,3,koschey,2771,30,1,6,7,14.3%,16m
7641,1,[PLcreW]BGT,2771,0,0,1,1,0.0%,13m
7641,2,Dux,2771,0,0,1,1,0.0%,19m
7641,1,aiur,2771,0,0,2,2,0.0%,1h
7641,3,[SHT]Elvis,2771,0,0,3,3,0.0%,3m
7654,2,VULPE,2770,948,37,41,78,47.4%,29m
7654,3,rect,2770,835,35,31,66,53.0%,19m
7654,1,DIMI,2770,74,3,1,4,75.0%,6m
7654,2,FearKillsYou,2770,116,3,16,19,15.8%,12m
7654,1,Janos,2770,0,1,1,2,50.0%,15m
7654,2,Smucky,2770,0,1,1,2,50.0%,31m
7654,1,Licorico,2770,0,0,1,1,0.0%,16m
7661,1,ramin,2769,1227,56,53,109,51.4%,38m
7661,3,gabi,2769,639,34,32,66,51.5%,13m
7661,3,SuperSquid,2769,464,14,36,50,28.0%,11m
7661,1,Snow,2769,154,4,2,6,66.7%,1h
7661,2,Ezir,2769,94,4,2,6,66.7%,1h
7661,3,IIIIIIIIIIII,2769,122,4,6,10,40.0%,11m
7661,1,Bruce,2769,0,3,5,8,37.5%,18m
7661,3,[xDniwe]Ether,2769,111,2,2,4,50.0%,5m
7669,3,Teodog,2768,458,15,21,36,41.7%,14m
7669,3,Tartalacreme,2768,211,6,9,15,40.0%,12m
7669,1,squishy,2768,152,4,1,5,80.0%,23m
7669,1,Zulraggar,2768,84,3,2,5,60.0%,9m
7669,1,CornHoliO,2768,0,1,0,1,100.0%,37m
7669,1,[Brah]Stormpigeon,2768,0,0,1,1,0.0%,7m
7669,3,[FAV1]MYSTADERRA,2768,0,0,5,5,0.0%,18m
7676,3,XYLON,2767,1231,112,107,219,51.1%,18m
7676,1,[ULteam]VvVEfaestion,2767,1439,57,48,105,54.3%,20m
7676,2,[OoE]Spithas,2767,587,37,42,79,46.8%,5m
7676,3,Solar,2767,868,34,33,67,50.7%,4m
7676,3,FlameWater,2767,612,22,24,46,47.8%,28m
7676,1,YeZealver,2767,563,21,30,51,41.2%,29m
7676,1,HexagonSun,2767,463,20,11,31,64.5%,23m
7676,1,liluk,2767,259,10,1,11,90.9%,1h
7676,3,shaMash,2767,150,7,10,17,41.2%,7m
7676,3,[D0N3]Enyalos,2767,62,4,6,10,40.0%,6m
7676,3,MasterVAN,2767,131,4,6,10,40.0%,26m
7676,3,[Zhig]Деларис,2767,140,3,4,7,42.9%,29m
7676,1,[P0W3RD]ECHO,2767,107,2,1,3,66.7%,1h
7676,2,DerehamPride,2767,0,1,0,1,100.0%,25m
7676,2,nesanot,2767,0,1,1,2,50.0%,6m
7676,1,Niñiah,2767,0,0,1,1,0.0%,35m
7692,3,Vena,2766,915,37,32,69,53.6%,18m
7692,3,[W00F]PuppyDog,2766,834,34,30,64,53.1%,19m
7692,1,Insane,2766,393,18,12,30,60.0%,1h
7692,3,Serenity,2766,292,10,9,19,52.6%,2m
7692,3,[3MD]Disk,2766,239,10,9,19,52.6%,14m
7692,1,[StatsF]PashaF,2766,104,4,1,5,80.0%,9m
7692,1,balamut,2766,145,2,5,7,28.6%,5m
7692,3,[IceHus]shiper,2766,0,1,2,3,33.3%,13m
7700,1,cos,2765,82,2,1,3,66.7%,1h
7700,3,[SPSes]ivanrsz,2765,0,1,5,6,16.7%,4m
7700,1,Jack,2765,0,0,1,1,0.0%,5m
7700,1,[сSсǃ]Fluke,2765,0,0,1,1,0.0%,18m
7704,1,Chiddybang,2764,361,17,17,34,50.0%,5m
7704,2,brigadis,2764,334,13,17,30,43.3%,13m
7704,1,Spitzeuk,2764,358,10,9,19,52.6%,38m
7704,3,GreenLord,2764,226,9,10,19,47.4%,12m
7704,1,AgriGo,2764,0,4,1,5,80.0%,39m
7704,1,jiji,2764,40,2,0,2,100.0%,38m
7704,3,[vi2018]Shenby,2764,0,1,1,2,50.0%,9m
7711,1,[CMBO]eOliAs,2763,470,22,32,54,40.7%,15m
7711,3,SiberiaS,2763,282,10,14,24,41.7%,13m
7711,3,KroNax,2763,268,9,13,22,40.9%,16m
7711,3,[MNKTS]Adrianmika,2763,140,6,8,14,42.9%,7m
7711,1,[Лакерс]Рик,2763,0,3,2,5,60.0%,14m
7711,1,Scout,2763,82,2,1,3,66.7%,9m
7711,3,Maple,2763,0,2,3,5,40.0%,30m
7711,1,EPICurus,2763,0,0,1,1,0.0%,9m
7719,1,Jorge,2762,984,54,33,87,62.1%,36m
7719,3,[Jöthem]Bergamot,2762,173,9,14,23,39.1%,19m
7719,2,[fFlags]barthem,2762,95,6,0,6,100.0%,1h
7719,3,ubilskap,2762,154,5,8,13,38.5%,9m
7719,1,PokiZ,2762,0,1,0,1,100.0%,33m
7719,1,Kiok,2762,0,0,1,1,0.0%,1h
7719,1,[G2kids]GamesTwoKids,2762,0,0,2,2,0.0%,31m
7726,3,DimonGold,2761,667,26,27,53,49.1%,10m
7726,2,Shtani,2761,134,7,6,13,53.8%,16m
7726,1,Wakmn,2761,0,3,2,5,60.0%,10m
7726,3,tEhfiSh,2761,0,2,0,2,100.0%,1h
7726,2,MadWarder,2761,0,2,4,6,33.3%,30m
7726,2,zlzsheep,2761,0,2,6,8,25.0%,3m
7726,1,[DLOK]Deadly,2761,0,1,1,2,50.0%,30m
7726,1,NeverNude,2761,0,0,1,1,0.0%,1h
7734,1,Millemmm,2760,1320,72,53,125,57.6%,2m
7734,1,Naamar,2760,0,1,0,1,100.0%,26m
7734,1,[Tymmy]Tymmy,2760,0,0,2,2,0.0%,1h
7737,3,ezicik,2759,334,11,12,23,47.8%,9m
7737,3,llllllllllll,2759,320,10,12,22,45.5%,10m
7737,2,Nervenzelle,2759,48,5,3,8,62.5%,5m
7737,3,Contactu,2759,168,5,4,9,55.6%,2m
7737,1,tomvessey,2759,88,4,2,6,66.7%,23m
7737,1,vombatttt,2759,84,3,3,6,50.0%,35m
7737,1,SilveR,2759,48,2,6,8,25.0%,1h
7744,2,energy,2758,330,24,33,57,42.1%,15m
7744,1,GornorPo,2758,444,18,7,25,72.0%,17m
7744,1,proBeHeaVy,2758,368,14,11,25,56.0%,35m
7744,3,Ralf,2758,140,7,14,21,33.3%,13m
7744,2,[DEDAL]SkopoSer,2758,99,6,2,8,75.0%,1h
7744,1,[xISISx]Jesus,2758,94,5,2,7,71.4%,10m
7744,1,[RBlood]Epyks,2758,38,2,0,2,100.0%,12m
7744,1,Wolfie,2758,0,0,1,1,0.0%,2m
7752,2,PERAL,2757,1518,73,80,153,47.7%,14m
7752,1,MamaMia,2757,788,37,10,47,78.7%,1h
7752,1,[74Rus]ДиКиЙнУбАсИк,2757,727,35,27,62,56.5%,32m
7752,3,MrSpaceMan,2757,503,16,18,34,47.1%,16m
7752,2,Anarchy,2757,206,6,5,11,54.5%,1h
7752,1,ksilartlu,2757,144,5,6,11,45.5%,26m
7752,2,battbot,2757,0,3,3,6,50.0%,31m
7752,1,Fyntik,2757,113,3,8,11,27.3%,16m
7752,1,Spirit,2757,78,2,3,5,40.0%,1h
7761,3,[ALTrG]Angelikus,2756,982,35,39,74,47.3%,27m
7761,1,ntl,2756,120,3,3,6,50.0%,20m
7761,3,[invc]IdrA,2756,0,2,3,5,40.0%,11m
7761,1,Alex,2756,0,1,1,2,50.0%,24m
7761,2,[B7]Eldraim,2756,0,1,5,6,16.7%,1h
7761,3,[DeLT]KingArthur,2756,0,0,1,1,0.0%,1h
7761,3,eCakes,2756,0,0,4,4,0.0%,13m
7768,1,ТраТаТа,2755,1584,109,99,208,52.4%,5m
7768,2,Milk,2755,782,28,37,65,43.1%,6m
7768,3,tamse,2755,541,22,28,50,44.0%,18m
7768,3,SleviN,2755,250,8,16,24,33.3%,16m
7768,3,[N0IP]Elander,2755,182,7,10,17,41.2%,11m
7768,3,[WWP]melyf,2755,152,6,6,12,50.0%,27m
7768,1,KittyFight,2755,190,5,6,11,45.5%,17m
7768,1,abce,2755,36,4,3,7,57.1%,1h
7768,3,[ØZc]EnTaroBeerS,2755,30,4,4,8,50.0%,7m
7768,1,wuerze,2755,139,4,7,11,36.4%,1h
7768,2,[Zhig]arturrium,2755,161,3,2,5,60.0%,19m
7768,2,Rico,2755,137,2,1,3,66.7%,6m
7768,1,ExEcuTor,2755,42,1,3,4,25.0%,30m
7768,1,[2SG2]KOT,2755,0,0,1,1,0.0%,28m
7782,1,[NetGG]Pumbaa,2754,1326,112,100,212,52.8%,23m
7782,3,[DOKA2]СтарыйВолк,2754,1060,39,41,80,48.8%,7m
7782,3,mouz,2754,199,8,11,19,42.1%,4m
7782,1,[No0opE]Mutsue,2754,287,7,4,11,63.6%,1h
7782,1,Vaha,2754,170,4,5,9,44.4%,1h
7782,3,Derpling,2754,94,3,4,7,42.9%,28m
7782,1,[blut]virus,2754,0,0,1,1,0.0%,2m
7789,3,ghostNiGHT,2753,1510,72,71,143,50.3%,14m
7789,1,nicolaï,2753,584,21,20,41,51.2%,19m
7789,3,AGATIKUS,2753,252,8,7,15,53.3%,12m
7789,3,[Phelma]bosure,2753,90,3,7,10,30.0%,27m
7789,3,[ROLK]Naika,2753,0,2,3,5,40.0%,31m
7789,1,[DmdSh]Solt,2753,0,1,3,4,25.0%,26m
7795,3,madsjl,2752,1036,41,42,83,49.4%,11m
7795,2,badarty,2752,812,28,40,68,41.2%,3m
7795,3,waltraud,2752,527,20,19,39,51.3%,8m
7795,3,[NCtk]Rage,2752,474,18,20,38,47.4%,19m
7795,1,MaMoHTeHoK,2752,0,1,0,1,100.0%,6m
7800,1,MurphysLaw,2751,678,106,95,201,52.7%,20m
7800,3,Repton,2751,403,17,12,29,58.6%,12m
7800,3,IBAK,2751,280,11,9,20,55.0%,3m
7800,1,SuicideFrog,2751,173,4,2,6,66.7%,1h
7800,2,ChopSuey,2751,62,4,8,12,33.3%,3m
7800,2,cartman,2751,104,3,2,5,60.0%,1h
7800,3,Wolfy,2751,0,2,2,4,50.0%,10m
7807,1,Kocim,2750,1465,54,48,102,52.9%,6m
7807,1,SnIpEr,2750,0,3,2,5,60.0%,1h
7807,1,DblDbl,2750,97,2,1,3,66.7%,38m
7807,2,Darguus,2750,0,0,4,4,0.0%,18m
7811,3,[mfxed]Onceinalife,2749,1239,165,152,317,52.1%,5m
7811,3,avengerone,2749,514,18,25,43,41.9%,5m
7811,1,tuladansleq,2749,334,14,9,23,60.9%,7m
7811,2,flexman,2749,188,9,6,15,60.0%,16m
7811,2,[Iancu]Moloz,2749,0,3,4,7,42.9%,14m
7811,3,Krusk,2749,60,3,7,10,30.0%,15m
7811,1,[Rushrs]MiruMir,2749,40,1,1,2,50.0%,1h
7818,1,[AkaneS]EnEtoRiator,2748,40,2,1,3,66.7%,1h
7818,1,Тяфтеля,2748,0,1,0,1,100.0%,16m
7818,1,Rick,2748,40,1,2,3,33.3%,6m
7818,1,Fega,2748,0,0,1,1,0.0%,11m
7822,1,misekemitoko,2747,250,7,3,10,70.0%,19m
7822,2,Oldffashione,2747,96,2,2,4,50.0%,16m
7824,1,Grummelbär,2746,828,91,98,189,48.1%,4m
7824,1,FunkyPan,2746,1074,40,35,75,53.3%,1h
7824,3,grrr,2746,476,18,16,34,52.9%,19m
7824,1,XDDDDDDDDDDD,2746,279,9,2,11,81.8%,6m
7824,3,ZhukeZZlay,2746,238,9,9,18,50.0%,15m
7824,1,TuPadre,2746,234,7,24,31,22.6%,11m
7824,1,[usbr]Broformist,2746,186,5,3,8,62.5%,31m
7824,2,Mrkuzy,2746,48,3,5,8,37.5%,1h
7824,3,IlIlIlIlI,2746,0,1,4,5,20.0%,31m
7824,1,Man,2746,0,0,1,1,0.0%,29m
7824,1,NuStream,2746,0,0,2,2,0.0%,18m
7835,1,Tarakan,2745,180,7,5,12,58.3%,1h
7835,2,[FroFo]Ekkman,2745,148,6,10,16,37.5%,29m
7835,1,[TheDOH]syD,2745,117,3,1,4,75.0%,21m
7835,1,Lelouch,2745,89,2,4,6,33.3%,7m
7835,1,[Stary]FOSSOYEUR,2745,88,1,4,5,20.0%,10m
7835,3,seko,2745,0,0,1,1,0.0%,39m
7841,2,raph,2744,900,33,34,67,49.3%,5m
7841,1,[H0C]SandStorm,2744,616,24,13,37,64.9%,1h
7841,1,Corolla,2744,98,3,2,5,60.0%,19m
7841,1,Black,2744,0,3,2,5,60.0%,25m
7841,1,BigLebowski,2744,0,1,0,1,100.0%,1h
7846,3,[Рrobe]KostiaKot,2743,797,75,55,130,57.7%,18m
7846,3,TheRusher,2743,670,28,21,49,57.1%,15m
7846,1,[IceCub]Meow,2743,224,9,4,13,69.2%,1h
7846,1,Zergii,2743,275,8,9,17,47.1%,1h
7846,1,xXx,2743,162,5,3,8,62.5%,1h
7846,1,Max,2743,76,5,4,9,55.6%,1h
7846,1,BadMove,2743,159,4,8,12,33.3%,22m
7846,3,[sp1r1t]GOstVladO,2743,30,2,4,6,33.3%,27m
7846,1,Zchrtchx,2743,0,0,1,1,0.0%,38m
7846,1,[Dobro]OneHandor,2743,0,0,1,1,0.0%,40m
7856,2,[P4Li]planlosrockt,2742,695,117,113,230,50.9%,15m
7856,3,RioRo,2742,476,16,18,34,47.1%,28m
7856,2,[BrCrft]SkySultan,2742,274,11,12,23,47.8%,14m
7856,2,BugBunny,2742,320,11,22,33,33.3%,18m
7856,3,Osghiliath,2742,0,2,10,12,16.7%,4m
7856,3,[GLAaND]bernardmenez,2742,0,1,0,1,100.0%,30m
7856,2,[ZN]Manwe,2742,0,1,0,1,100.0%,1h
7863,3,Samurai,2741,807,35,30,65,53.8%,19m
7863,1,[eFikSZ]psyler,2741,576,18,14,32,56.2%,23m
7863,1,FRIGOPLEIN,2741,480,16,19,35,45.7%,39m
7863,1,Reitifoh,2741,226,6,2,8,75.0%,1h
7863,2,Andrey,2741,44,3,4,7,42.9%,2m
7863,3,[7wonde]Lithium,2741,0,0,5,5,0.0%,26m
7869,3,Buddha,2740,913,98,82,180,54.4%,15m
7869,3,Ultra,2740,446,17,17,34,50.0%,11m
7869,1,xestermind,2740,152,5,3,8,62.5%,24m
7869,2,[PaniC]NotMe,2740,138,4,5,9,44.4%,1h
7869,1,[P00P00]TBǂGoldorak,2740,0,1,0,1,100.0%,16m
7869,2,Moriartik,2740,0,1,0,1,100.0%,1h
7869,1,Burgerkill,2740,40,1,1,2,50.0%,1h
7869,1,Danjal,2740,0,0,1,1,0.0%,33m
7877,3,[MFE]Bravess,2739,740,28,36,64,43.8%,14m
7877,1,Сюрприз,2739,118,4,3,7,57.1%,19m
7877,3,Amile,2739,117,4,5,9,44.4%,12m
7877,1,PuPsik,2739,144,4,7,11,36.4%,1h
7877,1,Alarion,2739,122,3,3,6,50.0%,1h
7877,3,darknoob,2739,120,3,6,9,33.3%,8m
7877,2,[Lyoko]Odd,2739,0,1,2,3,33.3%,37m
7884,1,Petipoi,2738,1685,132,123,255,51.8%,1h
7884,3,chologringo,2738,791,44,42,86,51.2%,18m
7884,1,drCeucc,2738,1068,40,31,71,56.3%,2m
7884,1,Christmas,2738,755,38,30,68,55.9%,24m
7884,1,lightplayer,2738,252,7,5,12,58.3%,1h
7884,1,Mickaël,2738,192,6,6,12,50.0%,20m
7884,3,[xEDGYx]Shinobirin,2738,0,2,3,5,40.0%,27m
7884,2,[thEnd]DeadEnd,2738,0,0,1,1,0.0%,2m
7884,3,zndr,2738,0,0,4,4,0.0%,21m
7893,3,Camembert,2737,1317,138,126,264,52.3%,12m
7893,3,Szultan,2737,1274,46,57,103,44.7%,20m
7893,3,eXsaRs,2737,158,13,15,28,46.4%,19m
7893,1,LLIEPLLIEHb,2737,130,9,9,18,50.0%,28m
7893,1,[Sencor]Leguan,2737,89,2,0,2,100.0%,2m
7893,2,MagmaWAR,2737,66,2,14,16,12.5%,21m
7893,3,Cerb,2737,30,1,5,6,16.7%,21m
7900,1,TheJangler,2736,1332,63,53,116,54.3%,33m
7900,2,Sqboxer,2736,479,44,50,94,46.8%,27m
7900,1,PixelTrooper,2736,227,7,7,14,50.0%,32m
7900,1,LongJohnson,2736,152,5,0,5,100.0%,5m
7900,1,ÜBERTALENT,2736,40,3,4,7,42.9%,16m
7900,1,[wN5]Vanan,2736,0,1,0,1,100.0%,26m
7900,2,ItsBehindYou,2736,0,1,7,8,12.5%,14m
7900,2,[PÂRłAH]Fangate,2736,0,0,1,1,0.0%,1h
7908,2,Ophidian,2735,1437,170,164,334,50.9%,18m
7908,1,Duffenzag,2735,402,13,9,22,59.1%,37m
7908,3,[O4FUN]Cyngiel,2735,0,2,3,5,40.0%,34m
7908,2,[spaks]hoops,2735,0,0,1,1,0.0%,16m
7908,2,Mivcheg,2735,0,0,3,3,0.0%,24m
7913,2,Naktul,2734,1505,224,219,443,50.6%,18m
7913,1,LOYKO,2734,1132,39,36,75,52.0%,2m
7913,3,[XinXan]flanyer,2734,684,25,28,53,47.2%,4m
7913,3,DST,2734,588,19,27,46,41.3%,18m
7913,1,Credenza,2734,380,13,19,32,40.6%,15m
7913,1,Ixpy,2734,312,10,4,14,71.4%,20m
7913,2,esdenk,2734,117,6,3,9,66.7%,30m
7913,1,[Petrиs]Kiranos,2734,116,3,6,9,33.3%,23m
7913,1,[Gnomed]Oxygenboy,2734,40,2,0,2,100.0%,35m
7913,1,[BoKs]Pyro,2734,78,2,4,6,33.3%,24m
7913,1,Elmswood,2734,0,1,0,1,100.0%,8m
7924,3,alb,2733,1532,157,150,307,51.1%,9m
7924,3,ArToFZeRg,2733,630,25,27,52,48.1%,7m
7924,1,gules,2733,644,22,21,43,51.2%,8m
7924,1,Aloco,2733,221,5,5,10,50.0%,2m
7924,1,Gneus,2733,159,3,2,5,60.0%,19m
7924,3,Abaddon,2733,112,3,2,5,60.0%,13m
7924,3,[RDDN]Tsyuko,2733,0,2,5,7,28.6%,10m
7924,1,SpaceWUBU,2733,42,1,4,5,20.0%,20m
7924,1,NIRIDO,2733,0,0,1,1,0.0%,1h
7924,3,Metalisk,2733,0,0,1,1,0.0%,1h
7934,3,[KAKU]Haitz,2732,1357,74,76,150,49.3%,21m
7934,1,MGL,2732,869,29,24,53,54.7%,39m
7934,3,whistle,2732,721,27,24,51,52.9%,12m
7934,1,DYSTREX,2732,345,14,8,22,63.6%,5m
7934,3,erosdevil,2732,146,6,10,16,37.5%,12m
7934,2,[NMSQ]Fullar,2732,30,2,6,8,25.0%,5m
7934,1,Kepray,2732,0,1,2,3,33.3%,1h
7934,1,Benni,2732,0,0,3,3,0.0%,11m
7942,1,Madbonya,2731,862,31,29,60,51.7%,14m
7942,1,Lokiknight,2731,631,23,13,36,63.9%,1h
7942,1,GuitarIpod,2731,398,19,10,29,65.5%,1h
7942,3,Stanisław,2731,390,15,12,27,55.6%,15m
7942,2,abracula,2731,241,8,11,19,42.1%,21m
7942,2,Влад,2731,92,4,6,10,40.0%,31m
7942,1,BitByBit,2731,78,3,0,3,100.0%,30m
7942,3,Steeleague,2731,0,2,3,5,40.0%,1h
7950,1,[CMArmy]PoyZone,2730,532,21,9,30,70.0%,39m
7950,2,KMM,2730,338,14,14,28,50.0%,2m
7950,1,Rurouni,2730,390,11,13,24,45.8%,1h
7950,1,popeye,2730,78,3,2,5,60.0%,40m
7950,2,HazZoS,2730,0,3,3,6,50.0%,1h
7950,2,[НОД17]SCII,2730,44,3,5,8,37.5%,2m
7950,1,Doomer,2730,34,1,2,3,33.3%,20m
7950,1,[ÆR]EbeEndocott,2730,0,0,1,1,0.0%,33m
7958,1,Komi,2729,1500,74,51,125,59.2%,17m
7958,1,Cranium,2729,1357,55,39,94,58.5%,25m
7958,3,Аларак,2729,388,15,14,29,51.7%,19m
7958,1,[RtGz]JSL,2729,243,8,7,15,53.3%,1h
7958,2,NoobBot,2729,192,6,7,13,46.2%,3m
7963,3,SiriusBLACK,2728,1098,42,45,87,48.3%,27m
7963,3,[tetguy]Gamygym,2728,936,34,34,68,50.0%,7m
7963,3,[WNTR]Paweuek,2728,450,19,16,35,54.3%,19m
7963,2,GaEsEx,2728,88,4,5,9,44.4%,13m
7963,3,DragonLune,2728,42,3,3,6,50.0%,9m
7963,1,Darkbaf,2728,36,2,2,4,50.0%,16m
7963,1,David,2728,0,2,3,5,40.0%,19m
7963,1,[mrcoh]Deeew,2728,36,2,5,7,28.6%,29m
7963,1,Barm,2728,0,0,3,3,0.0%,7m
7963,3,[fackme]turbo,2728,0,0,5,5,0.0%,11m
7973,3,Makina,2727,1301,117,113,230,50.9%,7m
7973,2,ccAnthrax,2727,1000,87,87,174,50.0%,21m
7973,2,Graviton,2727,338,15,15,30,50.0%,21m
7973,3,[TryLH]BanQuo,2727,281,12,11,23,52.2%,2m
7973,1,[StWill]Izgoi,2727,273,10,3,13,76.9%,1h
7973,1,[FGYT]Wiviiides,2727,193,6,7,13,46.2%,7m
7973,1,BraiNur,2727,140,3,2,5,60.0%,1h
7973,3,Jjaay,2727,97,2,0,2,100.0%,32m
7973,3,[CREPES]leo,2727,0,2,3,5,40.0%,3m
7973,3,Reoflex,2727,0,2,3,5,40.0%,39m
7973,3,Blito,2727,0,2,3,5,40.0%,22m
7973,1,KuduVoodoo,2727,0,1,0,1,100.0%,24m
7973,1,Jaduar,2727,0,1,1,2,50.0%,1h
7973,1,Ghost,2727,38,1,5,6,16.7%,34m
7987,1,[DMTRY]RedShift,2726,789,115,125,240,47.9%,2m
7987,1,AleX,2726,193,9,4,13,69.2%,1h
7987,3,NAZGUL,2726,86,4,5,9,44.4%,15m
7987,1,Dikoi,2726,150,4,9,13,30.8%,19m
7987,1,blaze,2726,120,2,8,10,20.0%,1h
7987,3,[INSO]dropbear,2726,0,1,3,4,25.0%,1h
7987,2,Andy,2726,0,0,4,4,0.0%,1h
7994,1,Räminator,2725,1622,132,133,265,49.8%,1h
7994,3,[Moskva]донкихотт,2725,351,16,20,36,44.4%,18m
7994,1,SaxaVolk,2725,272,7,6,13,53.8%,2m
7994,2,Smale,2725,0,5,3,8,62.5%,6m
7994,1,Omni,2725,0,3,2,5,60.0%,29m
7994,3,lamobot,2725,94,3,4,7,42.9%,13m
7994,1,ZakHooi,2725,80,2,3,5,40.0%,19m
8001,1,WurzelSepp,2724,271,12,1,13,92.3%,10m
8001,1,xainon,2724,334,10,15,25,40.0%,10m
8001,1,[QWARK]Alienskater,2724,163,9,5,14,64.3%,5m
8001,1,[GАY]PLAIOP,2724,220,8,5,13,61.5%,1h
8001,3,[GoldR]Piociek,2724,0,2,3,5,40.0%,16m
8001,1,[QMnewb]ANDERSX,2724,0,1,0,1,100.0%,1h
8001,1,Zarattul,2724,0,1,0,1,100.0%,33m
8001,2,filly,2724,88,1,2,3,33.3%,1h
8001,1,Naughty,2724,42,1,3,4,25.0%,40m
8010,1,KrouStiCore,2723,1365,64,54,118,54.2%,25m
8010,1,[EQLM]Lineweaver,2723,397,14,7,21,66.7%,1h
8010,1,[YRU]Twosmoker,2723,192,7,6,13,53.8%,20m
8010,1,Bjedna,2723,154,5,4,9,55.6%,1h
8010,1,[Achtun]vadim,2723,162,5,6,11,45.5%,5m
8010,1,[bvbo9]painuser,2723,116,3,7,10,30.0%,1h
8010,1,HappyHour,2723,36,2,1,3,66.7%,19m
8010,2,[Laim]Virtapiuha,2723,0,2,4,6,33.3%,34m
8010,2,IPxGhost,2723,0,1,0,1,100.0%,16m
8010,1,[66CLAN]Charkieweed,2723,0,1,1,2,50.0%,1h
8010,1,sid,2723,0,0,1,1,0.0%,33m
8010,1,[pfdsva]fabian,2723,0,0,2,2,0.0%,35m
8022,1,gigo,2722,453,18,12,30,60.0%,1h
8022,3,[ULTX]BrooDMasteR,2722,220,9,10,19,47.4%,36m
8022,1,llllllllllll,2722,177,6,1,7,85.7%,34m
8022,3,[САТ]BEZUMNYIVAN,2722,150,6,11,17,35.3%,27m
8022,3,[NS2019]PhoenixNS,2722,40,3,3,6,50.0%,1h
8022,1,Babo,2722,0,0,1,1,0.0%,19m
8022,1,jano,2722,0,0,2,2,0.0%,38m
8029,1,CeytNot,2721,220,7,7,14,50.0%,5m
8029,3,Hydra,2721,206,7,7,14,50.0%,13m
8029,3,Victoire,2721,58,5,5,10,50.0%,12m
8029,1,Александр,2721,182,5,6,11,45.5%,1h
8029,2,Сталин,2721,113,4,5,9,44.4%,1h
8029,1,Минск,2721,0,1,0,1,100.0%,1h
8035,1,pasha,2720,268,8,7,15,53.3%,35m
8035,1,chery,2720,178,7,7,14,50.0%,1h
8035,1,JimmyRacheta,2720,177,7,8,15,46.7%,1h
8035,1,WeeWeeRNA,2720,168,5,2,7,71.4%,23m
8035,2,[jfcs]jules,2720,30,5,6,11,45.5%,12m
8035,1,ELF,2720,119,5,6,11,45.5%,37m
8035,2,Roomero,2720,92,4,6,10,40.0%,1h
8035,1,kosmos,2720,0,3,3,6,50.0%,19m
8043,3,SunCanRock,2719,488,25,22,47,53.2%,2m
8043,1,[reep]Shira,2719,369,17,4,21,81.0%,35m
8043,2,Hadgehog,2719,369,15,9,24,62.5%,39m
8043,1,MagusAdptus,2719,338,10,9,19,52.6%,16m
8043,1,MusliM,2719,227,5,9,14,35.7%,15m
8043,1,[PiGPan]Conzy,2719,139,4,0,4,100.0%,34m
8043,2,[Smthc]SwiminZerg,2719,0,4,2,6,66.7%,18m
8043,1,Raft,2719,0,3,5,8,37.5%,16m
8043,1,RimruTempset,2719,73,1,1,2,50.0%,36m
8043,3,Molotow,2719,0,1,7,8,12.5%,13m
8043,3,Targaryen,2719,0,0,1,1,0.0%,34m
8054,2,Proven,2718,1491,181,181,362,50.0%,29m
8054,3,JjabOnOsO,2718,1325,122,115,237,51.5%,4m
8054,1,Emmerson,2718,208,7,7,14,50.0%,19m
8054,3,[PAPIS]HolyThunder,2718,92,3,11,14,21.4%,3m
8058,3,Ghola,2717,1617,273,250,523,52.2%,11m
8058,2,KaKolaK,2717,766,76,91,167,45.5%,11m
8058,3,kiberAlex,2717,1029,38,36,74,51.4%,7m
8058,1,лорд,2717,752,28,20,48,58.3%,1h
8058,1,NORandom,2717,712,23,19,42,54.8%,5m
8058,1,Nikolai,2717,281,7,9,16,43.8%,1h
8058,3,Monkey,2717,221,6,7,13,46.2%,1h
8058,3,[REGGE]MAJORxHOSCHY,2717,167,4,7,11,36.4%,29m
8058,3,Vash,2717,0,3,2,5,60.0%,9m
8058,1,Dominus,2717,78,2,5,7,28.6%,7m
8058,1,YouNeedLube,2717,0,1,0,1,100.0%,30m
8058,3,MBC,2717,0,0,1,1,0.0%,9m
8070,3,BadPete,2716,711,47,45,92,51.1%,3m
8070,1,lohkar,2716,175,7,4,11,63.6%,20m
8070,1,supertrashyn,2716,171,7,4,11,63.6%,33m
8070,2,Titanfol,2716,30,5,6,11,45.5%,14m
8070,1,ButPlug,2716,193,4,3,7,57.1%,1h
8070,1,Grosnaze,2716,100,3,4,7,42.9%,36m
8070,1,Limej,2716,40,1,7,8,12.5%,25m
8070,3,Scrouji,2716,0,0,1,1,0.0%,32m
8070,1,cloy,2716,0,0,2,2,0.0%,36m
8079,3,[BBTinc]Busparachute,2715,626,25,25,50,50.0%,8m
8079,1,[DHYD]SalyT,2715,701,22,18,40,55.0%,38m
8079,3,jinxer,2715,411,16,18,34,47.1%,4m
8079,1,minbear,2715,302,8,11,19,42.1%,5m
8079,3,[LifeTV]ultralisco,2715,169,7,7,14,50.0%,13m
8079,2,Dzigoro,2715,144,6,7,13,46.2%,18m
8079,3,[Agury]StefeK,2715,0,4,3,7,57.1%,27m
8079,1,CdLate,2715,38,2,0,2,100.0%,1h
8079,2,[EBoI]RogalDorn,2715,0,1,0,1,100.0%,1h
8079,1,Alexander,2715,0,0,2,2,0.0%,29m
8089,1,andrei,2714,367,11,8,19,57.9%,16m
8089,2,[SKoD]PsYkOoO,2714,221,7,6,13,53.8%,33m
8089,2,drGreenTown,2714,229,7,6,13,53.8%,8m
8089,1,mda,2714,190,5,5,10,50.0%,32m
8089,1,[B2oS]Segas,2714,114,4,5,9,44.4%,31m
8089,3,Arlesko,2714,97,3,3,6,50.0%,36m
8089,1,[SPAINs]Avefenix,2714,34,2,1,3,66.7%,1h
8089,1,shØut,2714,97,1,6,7,14.3%,1h
8097,1,[101101]Axel,2713,610,64,52,116,55.2%,4m
8097,1,MoonChild,2713,1463,54,48,102,52.9%,1h
8097,1,[holyJ]psst,2713,472,17,11,28,60.7%,16m
8097,1,Трибанки,2713,38,2,0,2,100.0%,19m
8097,1,[RPro]HAV,2713,0,1,0,1,100.0%,36m
8097,1,Darkaaragon,2713,88,1,1,2,50.0%,19m
8097,1,Equalizer,2713,0,0,1,1,0.0%,19m
8104,2,Xaussit,2712,0,1,0,1,100.0%,22m
8104,2,[ProbKA]chipalino,2712,0,0,7,7,0.0%,19m
8106,3,CWarlike,2711,1239,177,175,352,50.3%,5m
8106,1,[TROPBG]arlam,2711,1608,74,66,140,52.9%,19m
8106,1,AniMaLiTy,2711,671,26,23,49,53.1%,16m
8106,1,WatWatInDaBu,2711,345,12,5,17,70.6%,16m
8106,2,Cherry,2711,181,6,6,12,50.0%,25m
8106,1,Сопляк,2711,148,5,4,9,55.6%,1h
8106,1,DevilMayCry,2711,94,3,3,6,50.0%,27m
8106,1,[UWDIE]Asimov,2711,0,1,3,4,25.0%,36m
8106,2,[CRSRIO]VaLmaLisK,2711,0,1,7,8,12.5%,26m
8106,1,[FRANZ]Endrox,2711,0,0,1,1,0.0%,1h
8106,3,Vladisl,2711,0,0,1,1,0.0%,1h
8106,2,Totmato,2711,0,0,2,2,0.0%,1h
8118,2,Magic,2710,1054,55,64,119,46.2%,16m
8118,2,tree,2710,88,4,12,16,25.0%,14m
8118,1,Gottlob,2710,90,2,0,2,100.0%,33m
8118,3,[Larjan]Riday,2710,0,2,3,5,40.0%,8m
8118,3,Zerg,2710,0,2,3,5,40.0%,22m
8118,1,JhonnyG,2710,107,2,5,7,28.6%,1h
8118,1,Trykester,2710,0,0,2,2,0.0%,30m
8118,1,SirJim,2710,0,0,3,3,0.0%,12m
8126,3,savionok,2709,340,14,18,32,43.8%,28m
8126,1,[HNS]Knut,2709,288,12,18,30,40.0%,9m
8126,3,[LGO123]Jimblot,2709,298,11,14,25,44.0%,11m
8126,1,Brotoss,2709,302,10,9,19,52.6%,1h
8126,1,tormentor,2709,240,7,10,17,41.2%,1h
8126,1,kopalych,2709,34,4,2,6,66.7%,20m
8126,1,УбийцаЛохов,2709,40,2,1,3,66.7%,10m
8126,1,Panish,2709,0,2,2,4,50.0%,1h
8126,1,kababik,2709,38,1,1,2,50.0%,1h
8126,1,DerKaiser,2709,0,0,2,2,0.0%,17m
8126,3,[IRLA]TheFinalBoss,2709,0,0,5,5,0.0%,18m
8137,1,[J4E]Snehulko,2708,1635,165,149,314,52.5%,1h
8137,1,Raycor,2708,625,48,38,86,55.8%,35m
8137,1,Leggy,2708,1242,42,42,84,50.0%,23m
8137,3,[1ndica]elZablo,2708,401,17,19,36,47.2%,19m
8137,1,iLoveProtoss,2708,483,16,13,29,55.2%,17m
8137,1,TICUSAURIOS,2708,485,13,12,25,52.0%,16m
8137,1,Chingizhan,2708,326,7,9,16,43.8%,19m
8137,1,Silver,2708,272,7,11,18,38.9%,35m
8137,1,GukiKOkd,2708,154,3,4,7,42.9%,36m
8137,1,[CОS]Hohol,2708,48,1,4,5,20.0%,15m
8137,1,[OPANA]RoarOfProxy,2708,40,1,4,5,20.0%,5m
8148,1,Tyrion,2707,1474,105,116,221,47.5%,7m
8148,2,[Crаzy]DaniLa,2707,1296,79,66,145,54.5%,15m
8148,1,[scp3]bertnard,2707,745,30,28,58,51.7%,20m
8148,1,Falham,2707,499,20,15,35,57.1%,25m
8148,2,DanteJusTesT,2707,46,4,4,8,50.0%,1h
8148,3,Hatiman,2707,0,1,0,1,100.0%,1h
8154,1,[ZinCo]benens,2706,1327,59,47,106,55.7%,1h
8154,3,Synops,2706,1154,40,48,88,45.5%,27m
8154,3,[dinge]Tarnschaf,2706,496,18,23,41,43.9%,11m
8154,3,ужж,2706,397,17,18,35,48.6%,5m
8154,1,efsgshjdh,2706,254,9,8,17,52.9%,8m
8154,1,OmarFallaha,2706,76,3,2,5,60.0%,8m
8154,3,rmaron,2706,0,3,4,7,42.9%,5m
8154,3,Lilit,2706,0,2,6,8,25.0%,11m
8154,1,NickGN,2706,0,0,1,1,0.0%,6m
8154,1,Justman,2706,0,0,1,1,0.0%,35m
8164,3,crollander,2705,1015,49,47,96,51.0%,4m
8164,1,NYO,2705,312,10,8,18,55.6%,19m
8164,1,Meridian,2705,286,8,7,15,53.3%,1h
8164,2,Palmarin,2705,46,1,2,3,33.3%,16m
8164,1,siopsys,2705,0,0,1,1,0.0%,1h
8169,1,[696]Aiur,2704,143,3,2,5,60.0%,19m
8169,1,Imbanessy,2704,93,2,1,3,66.7%,29m
8169,1,Darkzealot,2704,48,2,5,7,28.6%,16m
8169,1,Choppur,2704,0,1,0,1,100.0%,40m
8173,1,NomadRusso,2703,375,112,108,220,50.9%,12m
8173,3,ColdasGonzlz,2703,782,32,32,64,50.0%,19m
8173,1,Rambo,2703,374,14,10,24,58.3%,5m
8173,3,Reaper,2703,339,13,9,22,59.1%,39m
8173,3,DunkanZmey,2703,0,3,4,7,42.9%,21m
8173,1,Nitrux,2703,100,3,4,7,42.9%,8m
8173,1,[COCHON]Hoka,2703,0,1,1,2,50.0%,18m
8173,1,Rezerfordium,2703,34,1,1,2,50.0%,36m
8173,1,EvolutioN,2703,0,1,4,5,20.0%,40m
8173,1,Frim,2703,0,0,2,2,0.0%,5m
8173,1,Darkon,2703,0,0,2,2,0.0%,1h
8184,3,karroni,2702,1395,97,102,199,48.7%,14m
8184,3,filipboss,2702,972,34,39,73,46.6%,6m
8184,1,hiroes,2702,470,21,18,39,53.8%,6m
8184,3,[Patang]Dauden,2702,301,11,11,22,50.0%,12m
8184,3,[TAW]KIO,2702,294,11,15,26,42.3%,19m
8184,1,skippy,2702,238,10,7,17,58.8%,32m
8184,3,Teddy,2702,84,5,3,8,62.5%,9m
8184,1,ДраконТеней,2702,74,2,3,5,40.0%,10m
8184,3,Trangut,2702,30,2,4,6,33.3%,11m
8184,1,NeagerPins,2702,38,1,2,3,33.3%,7m
8184,1,AMIRALNICOR,2702,0,0,1,1,0.0%,4m
8184,1,Erebos,2702,0,0,1,1,0.0%,40m
8196,3,KanNonRushky,2701,793,153,118,271,56.5%,15m
8196,2,ESAPETTER,2701,1455,56,60,116,48.3%,6m
8196,3,darki,2701,403,16,23,39,41.0%,19m
8196,1,spekkyo,2701,336,15,8,23,65.2%,39m
8196,3,ZecheTop,2701,119,3,2,5,60.0%,4m
8196,3,BHyk,2701,97,3,3,6,50.0%,26m
8196,3,Whykickem,2701,97,2,4,6,33.3%,32m
8196,2,[SevRud]Sevan,2701,0,1,0,1,100.0%,22m
8196,1,Nik,2701,0,1,1,2,50.0%,37m
8196,1,Gewürzgurke,2701,0,0,1,1,0.0%,1h
8206,1,Kapis,2700,1130,43,36,79,54.4%,20m
8206,1,PREDATOR,2700,444,30,23,53,56.6%,7m
8206,1,[TedB]NEV,2700,407,13,13,26,50.0%,30m
8206,1,NemO,2700,462,13,16,29,44.8%,21m
8206,3,[ZERGTV]qzmitch,2700,342,12,18,30,40.0%,29m
8206,1,Slayer,2700,119,6,7,13,46.2%,1h
8206,1,PetShip,2700,149,5,5,10,50.0%,20m
8206,1,papanou,2700,239,5,12,17,29.4%,39m
8206,1,NIghtRaven,2700,108,4,2,6,66.7%,1h
8206,1,[WldCaT]YummyDead,2700,128,3,2,5,60.0%,33m
8206,1,Zoblar,2700,0,3,2,5,60.0%,2m
8206,1,herO,2700,89,2,0,2,100.0%,6m
8206,1,notafish,2700,0,2,3,5,40.0%,1h
8206,1,Eichhörnchen,2700,0,0,1,1,0.0%,25m
8220,2,[3DE]HeckobA,2699,730,37,43,80,46.2%,28m
8220,1,SaNYa,2699,614,19,18,37,51.4%,1h
8220,1,doppleGG,2699,390,18,9,27,66.7%,1h
8220,1,[EpicSr]Lisiqmetodis,2699,447,16,14,30,53.3%,1h
8220,1,LosLosLos,2699,249,8,6,14,57.1%,7m
8220,1,[CCNN]PsychicToss,2699,96,2,1,3,66.7%,1h
8220,3,TheWhiteFrog,2699,0,2,3,5,40.0%,30m
8220,1,[Böcke]HerbertKrull,2699,48,1,3,4,25.0%,31m
8228,3,[DSK15]Feniks,2698,823,72,68,140,51.4%,12m
8228,1,Pedro,2698,873,49,12,61,80.3%,36m
8228,1,[Moskva]Rodnoy,2698,729,36,20,56,64.3%,20m
8228,2,gronichon,2698,690,23,35,58,39.7%,22m
8228,1,[Frgs]Scrin,2698,528,20,18,38,52.6%,1h
8228,1,RabbidLesbo,2698,165,6,2,8,75.0%,25m
8228,3,Aeon,2698,134,3,6,9,33.3%,10m
8228,1,Mathibx,2698,140,3,6,9,33.3%,17m
8228,1,[STZK]Snack,2698,30,2,1,3,66.7%,39m
8228,1,[THANOS]RAYMANKAPEEN,2698,0,1,1,2,50.0%,39m
8228,1,SpvceHvze,2698,0,1,2,3,33.3%,8m
8228,3,Ежик,2698,0,0,1,1,0.0%,1h
8240,1,[Изувер]МитчИИ,2697,1557,126,100,226,55.8%,8m
8240,1,MAMOHT,2697,1143,76,69,145,52.4%,1h
8240,2,[C0RE]Scrappy,2697,1051,42,50,92,45.7%,15m
8240,1,STYKE,2697,817,27,24,51,52.9%,20m
8240,1,[Rafi]Lord,2697,298,21,29,50,42.0%,9m
8240,3,Webi,2697,534,20,22,42,47.6%,10m
8240,1,Polermo,2697,443,18,13,31,58.1%,6m
8240,1,Kaotiques,2697,404,16,9,25,64.0%,14m
8240,1,mixas,2697,276,13,8,21,61.9%,10m
8240,3,Hawok,2697,210,10,10,20,50.0%,4m
8240,1,Haugen,2697,268,7,8,15,46.7%,19m
8240,3,[TOFSC]Jops,2697,210,7,14,21,33.3%,19m
8240,2,[latp]GROBISOUS,2697,159,5,6,11,45.5%,1h
8240,1,JPB,2697,196,5,10,15,33.3%,16m
8240,1,Radiance,2697,132,4,1,5,80.0%,13m
8240,1,gremelin,2697,157,4,5,9,44.4%,36m
8240,1,[ZERG7V]MadBird,2697,152,4,8,12,33.3%,38m
8240,2,Слава,2697,0,3,6,9,33.3%,14m
8240,1,SSgtEversman,2697,122,2,2,4,50.0%,1h
8240,1,[FARLIG]Terminator,2697,48,2,4,6,33.3%,1h
8240,1,somebody,2697,0,1,0,1,100.0%,36m
8240,1,[PaniC]ProRockSpiro,2697,0,0,1,1,0.0%,1h
8240,1,Gonzo,2697,0,0,1,1,0.0%,1h
8240,3,kazuma,2697,0,0,1,1,0.0%,22m
8240,1,Левославный,2697,0,0,3,3,0.0%,23m
8265,3,Allex,2696,1562,241,230,471,51.2%,4m
8265,3,MishoSikisha,2696,890,77,80,157,49.0%,21m
8265,1,BigPi,2696,907,39,29,68,57.4%,29m
8265,3,[QuBuS]QuBuS,2696,388,16,5,21,76.2%,22m
8265,1,[Radium]DFG,2696,237,10,3,13,76.9%,36m
8265,1,[ATOMS]gzzz,2696,288,8,10,18,44.4%,28m
8265,1,Rodolphe,2696,232,6,11,17,35.3%,23m
8265,1,Hougs,2696,106,5,3,8,62.5%,1h
8265,1,Larry,2696,142,4,7,11,36.4%,1h
8265,1,aheezaly,2696,0,0,1,1,0.0%,14m
8275,1,rambo,2695,1736,174,159,333,52.3%,1h
8275,3,[FR1]TRUMP,2695,948,61,56,117,52.1%,4m
8275,1,[GOLDPL]Lancelot,2695,726,30,22,52,57.7%,36m
8275,3,Pippeli,2695,462,16,21,37,43.2%,13m
8275,1,Huanito,2695,350,13,13,26,50.0%,10m
8275,1,[Chaven]Qwi,2695,0,3,3,6,50.0%,1h
8275,3,Prophet,2695,0,2,3,5,40.0%,1h
8275,1,Pavarotti,2695,0,2,4,6,33.3%,10m
8275,1,Aisam,2695,0,1,1,2,50.0%,1h
8275,3,Businesstour,2695,0,0,1,1,0.0%,1h
8285,1,Loki,2694,413,11,11,22,50.0%,1h
8285,1,Wing,2694,296,10,9,19,52.6%,11m
8285,2,CBR,2694,141,4,5,9,44.4%,18m
8285,1,teksla,2694,150,4,6,10,40.0%,7m
8285,3,[Tостер]Тень,2694,0,1,0,1,100.0%,22m
8285,1,[Covid]Eli,2694,0,0,1,1,0.0%,1h
8291,1,atreyu,2693,402,14,10,24,58.3%,20m
8291,1,Chronologia,2693,382,13,11,24,54.2%,23m
8291,1,[Komet]Histrion,2693,122,2,2,4,50.0%,1h
8291,1,[1PLSD]LeMaika,2693,0,1,0,1,100.0%,28m
8291,3,RxC,2693,0,0,5,5,0.0%,18m
8296,3,Dylan,2692,850,51,40,91,56.0%,13m
8296,1,[DirStr]Stahor,2692,343,15,6,21,71.4%,18m
8296,3,aizakharov,2692,0,4,1,5,80.0%,1h
8296,1,PINGALOKA,2692,0,3,2,5,60.0%,11m
8296,1,[lTMl]Baumi,2692,38,2,1,3,66.7%,1h
8296,3,[mUn]mUnSPECTROS,2692,0,2,3,5,40.0%,28m
8296,1,VrAg,2692,0,1,0,1,100.0%,27m
8296,1,[OLDbad]MatejSK,2692,0,0,3,3,0.0%,7m
8304,3,Broze,2691,911,45,49,94,47.9%,12m
8304,1,Pissmypantsu,2691,869,37,28,65,56.9%,38m
8304,1,llllllllllll,2691,449,19,14,33,57.6%,32m
8304,1,Phily,2691,188,9,8,17,52.9%,1h
8304,3,Nindan,2691,204,8,12,20,40.0%,12m
8304,1,MindelVK,2691,130,7,4,11,63.6%,40m
8304,1,[HoWaY]Mando,2691,122,3,1,4,75.0%,11m
8304,1,SoldierTriad,2691,32,2,1,3,66.7%,36m
8304,3,[ReSw]Muronordan,2691,0,1,0,1,100.0%,28m
8304,1,[НС]Zergling,2691,44,1,2,3,33.3%,8m
8304,1,ClinLoy,2691,38,1,6,7,14.3%,7m
8315,3,[FLTY]Bubble,2690,1099,43,43,86,50.0%,11m
8315,3,[MDFAKK]drpsyk,2690,1178,42,47,89,47.2%,9m
8315,1,[esox]barcode,2690,423,19,16,35,54.3%,25m
8315,1,DimidrolRus,2690,170,16,7,23,69.6%,4m
8315,1,Winner,2690,342,13,5,18,72.2%,36m
8315,1,Sammy,2690,80,2,8,10,20.0%,33m
8315,1,[1C5]CocainCowboy,2690,0,0,1,1,0.0%,1h
8315,1,Klappskalli,2690,0,0,2,2,0.0%,20m
8323,1,[XKot]XmuriyKot,2689,212,7,8,15,46.7%,1h
8323,2,Greuceanu,2689,48,4,5,9,44.4%,40m
8323,1,Heznzu,2689,0,1,4,5,20.0%,1h
8323,1,Snusmumrik,2689,0,0,3,3,0.0%,1h
8327,1,REDDAK,2688,724,83,72,155,53.5%,31m
8327,3,Sohillo,2688,396,39,38,77,50.6%,29m
8327,1,[xFRSx]cristo,2688,208,7,5,12,58.3%,1h
8327,1,Tklz,2688,30,3,4,7,42.9%,39m
8327,1,Chroma,2688,0,3,6,9,33.3%,1h
8327,3,Fornakter,2688,0,2,3,5,40.0%,22m
8327,1,Observer,2688,82,2,4,6,33.3%,33m
8334,1,RandomPlayer,2687,1703,220,214,434,50.7%,1h
8334,3,CptKock,2687,646,33,37,70,47.1%,10m
8334,1,[ZZW]AstroTrick,2687,305,12,11,23,52.2%,1h
8334,1,Neuro,2687,252,8,7,15,53.3%,5m
8334,2,Original,2687,180,7,4,11,63.6%,30m
8334,1,Lüdda,2687,156,5,2,7,71.4%,1h
8334,1,Fastik,2687,117,5,5,10,50.0%,31m
8334,1,Dakre,2687,72,4,5,9,44.4%,23m
8334,1,[BVE]TöbbN,2687,88,3,3,6,50.0%,21m
8334,1,cheery,2687,97,2,1,3,66.7%,1h
8334,2,Youfi,2687,0,1,0,1,100.0%,29m
8334,3,HardBot,2687,0,0,2,2,0.0%,28m
8334,3,[pansky]gerdos,2687,0,0,2,2,0.0%,25m
8334,1,[Tist]baptistesqy,2687,0,0,3,3,0.0%,40m
8348,2,tipoc,2686,1206,138,145,283,48.8%,28m
8348,1,[2500]Корсар,2686,881,48,27,75,64.0%,1h
8348,1,[Kingz]Krypt,2686,1174,45,37,82,54.9%,1h
8348,1,[LaRaZa]vampire,2686,48,5,5,10,50.0%,1h
8348,1,LiquidAdri,2686,110,4,3,7,57.1%,40m
8348,2,[kristi]DödsgroggXXL,2686,132,4,5,9,44.4%,22m
8348,1,freeZell,2686,193,4,11,15,26.7%,5m
8348,3,MOJLOT,2686,0,3,2,5,60.0%,2m
8348,1,[WWW]Eagle,2686,90,2,0,2,100.0%,1h
8348,1,[RKZ]FrozenFritz,2686,76,2,5,7,28.6%,36m
8348,3,[R88lol]MilkyWay,2686,0,1,0,1,100.0%,1h
8348,1,MeisterY,2686,0,0,1,1,0.0%,1h
8348,1,Cricket,2686,0,0,1,1,0.0%,1h
8361,3,[tpt06]Guillaume,2685,1308,61,62,123,49.6%,13m
8361,1,[Izual]VeryEasy,2685,374,12,10,22,54.5%,1h
8361,1,nodelynk,2685,132,5,4,9,55.6%,36m
8361,2,RuWaKing,2685,0,3,4,7,42.9%,1h
8361,1,YingFan,2685,30,1,6,7,14.3%,1h
8361,1,[IMeQ]NinnZyAeQ,2685,0,0,1,1,0.0%,20m
8361,1,Eric,2685,0,0,1,1,0.0%,39m
8361,1,Gnaeus,2685,0,0,1,1,0.0%,37m
8361,1,Cullo,2685,0,0,1,1,0.0%,1h
8370,1,Профсоюз,2684,483,21,15,36,58.3%,1h
8370,2,TANOS,2684,413,16,22,38,42.1%,20m
8370,2,Xerox,2684,300,15,19,34,44.1%,7m
8370,1,UNHAPPY,2684,176,6,2,8,75.0%,23m
8370,3,despedudu,2684,90,6,7,13,46.2%,20m
8370,2,[ELO3]Gruqer,2684,46,4,5,9,44.4%,1h
8370,2,DevitcaZerg,2684,188,3,9,12,25.0%,24m
8370,1,[Snаkеs]SaltSnake,2684,40,2,3,5,40.0%,1h
8378,1,NoRec,2683,1679,185,163,348,53.2%,7m
8378,1,Beau,2683,384,22,16,38,57.9%,1h
8378,1,[RFTW2k]Tardface,2683,371,11,12,23,47.8%,40m
8378,1,ValeX,2683,96,3,4,7,42.9%,16m
8382,3,OFFICERMLCEL,2682,1360,235,218,453,51.9%,7m
8382,1,[NWGD]Panir,2682,232,8,5,13,61.5%,1h
8382,2,JustAPlayer,2682,223,6,7,13,46.2%,1h
8382,1,[PUNZEL]mozz,2682,120,5,3,8,62.5%,23m
8382,2,Flightofbird,2682,95,4,3,7,57.1%,1h
8382,3,TurisaZ,2682,122,3,8,11,27.3%,11m
8382,1,Supersoft,2682,54,2,4,6,33.3%,1h
8382,1,[1s1]ToolTimr,2682,0,1,1,2,50.0%,1h
8382,1,elDuderino,2682,40,1,3,4,25.0%,1h
8382,1,Anov,2682,42,1,3,4,25.0%,17m
8392,3,FoozyWoozy,2681,1195,95,83,178,53.4%,7m
8392,1,Fenders,2681,1702,75,72,147,51.0%,1h
8392,2,[TheL]SMac,2681,1573,75,88,163,46.0%,11m
8392,1,Robly,2681,1130,62,55,117,53.0%,36m
8392,3,[KAOTx]WhoseThat,2681,332,12,16,28,42.9%,13m
8392,1,Troptox,2681,332,9,14,23,39.1%,25m
8392,3,IlIlIlIIllII,2681,207,8,8,16,50.0%,2m
8392,1,Engeron,2681,192,6,9,15,40.0%,1h
8392,2,Misanthrope,2681,137,6,21,27,22.2%,6m
8392,1,Lenintru,2681,211,5,6,11,45.5%,1h
8392,3,[RZEB]FazerMoust,2681,97,4,2,6,66.7%,36m
8392,1,spbb,2681,36,2,2,4,50.0%,27m
8392,1,[LFTW]XLoRD,2681,0,2,3,5,40.0%,11m
8392,1,Nikotin,2681,48,2,4,6,33.3%,21m
8392,3,dark,2681,0,1,0,1,100.0%,35m
8392,1,MORPHINE,2681,88,1,1,2,50.0%,1h
8408,1,SayNoToStim,2680,1528,107,100,207,51.7%,1h
8408,3,[NINJ88]CieniU,2680,1591,95,100,195,48.7%,6m
8408,3,Sathol,2680,661,25,29,54,46.3%,13m
8408,2,rottenorange,2680,302,13,17,30,43.3%,11m
8408,1,Aurèle,2680,194,8,9,17,47.1%,40m
8408,1,[hf4X4]Parapoomba,2680,173,7,1,8,87.5%,1h
8408,2,TheWitchking,2680,0,4,2,6,66.7%,17m
8408,1,TeddyJay,2680,115,2,2,4,50.0%,24m
8408,1,[GLD]GwrwDsekwrs,2680,66,2,3,5,40.0%,32m
8408,1,[SSV]OrionRU,2680,0,1,0,1,100.0%,6m
8408,3,Imel,2680,0,1,1,2,50.0%,4m
8408,3,IsaacClarke,2680,0,0,1,1,0.0%,35m
8408,1,TroLLPuKe,2680,0,0,2,2,0.0%,31m
8408,2,[PrTons]SpooneyKnify,2680,0,0,3,3,0.0%,39m
8422,2,Tagger,2679,1158,59,75,134,44.0%,3m
8422,2,QuBuS,2679,307,13,5,18,72.2%,1h
8422,1,[QTcIub]Robotopia,2679,240,9,1,10,90.0%,36m
8422,3,Volwerine,2679,260,7,11,18,38.9%,19m
8422,1,Yokai,2679,141,4,4,8,50.0%,10m
8422,2,iMahila,2679,0,2,3,5,40.0%,38m
8422,2,[STDES]Krucjata,2679,0,1,0,1,100.0%,40m
8422,3,Stoofy,2679,0,0,2,2,0.0%,6m
8422,3,ixaakeex,2679,0,0,5,5,0.0%,19m
8431,1,Flirti,2678,565,70,67,137,51.1%,5m
8431,3,OrbitalPerio,2678,799,68,61,129,52.7%,6m
8431,1,[TheDOH]CombatAnt,2678,252,9,6,15,60.0%,35m
8431,3,[J4E]Geronimus,2678,208,9,9,18,50.0%,5m
8431,2,Drop,2678,0,0,1,1,0.0%,39m
8436,2,Comrad,2677,30,4,3,7,57.1%,33m
8436,3,[BzhTm]PINOUILLE,2677,94,4,12,16,25.0%,13m
8436,3,Elenfall,2677,0,3,2,5,60.0%,2m
8436,2,Dany,2677,34,2,0,2,100.0%,1h
8436,1,ProxyTwoGate,2677,34,2,1,3,66.7%,1h
8436,1,Víctor,2677,42,2,2,4,50.0%,23m
8436,2,SHADOW,2677,0,1,0,1,100.0%,29m
8436,2,GuamHurJun,2677,0,0,1,1,0.0%,1h
8436,3,Серж,2677,0,0,1,1,0.0%,1h
8445,1,Sanya,2676,1435,82,78,160,51.2%,36m
8445,1,[Gøsu]ĐiamondĐrop,2676,206,13,5,18,72.2%,13m
8445,2,noncheeseacc,2676,0,2,2,4,50.0%,17m
8445,2,[KgsC]RaNCer,2676,30,1,1,2,50.0%,29m
8445,1,nazrim,2676,0,1,1,2,50.0%,33m
8450,2,[PowOw]TheDoctor,2675,272,24,3,27,88.9%,30m
8450,1,JackpoT,2675,438,15,15,30,50.0%,17m
8450,1,[CsT]CsTǂPierre,2675,317,12,20,32,37.5%,8m
8450,2,[LIQUID]Alex,2675,32,2,1,3,66.7%,14m
8450,2,Azdrubael,2675,0,1,0,1,100.0%,1h
8455,1,serg,2674,1084,38,38,76,50.0%,37m
8455,1,Kaizen,2674,291,9,7,16,56.2%,36m
8455,3,Mistan,2674,270,9,13,22,40.9%,4m
8455,1,[Y8U]Jogarcg,2674,0,1,5,6,16.7%,27m
8455,2,Myutix,2674,0,0,1,1,0.0%,1h
8455,2,ALEXEY,2674,0,0,1,1,0.0%,27m
8455,3,LynIx,2674,0,0,3,3,0.0%,11m
8462,1,[NIC]niclucky,2673,1102,44,48,92,47.8%,1h
8462,2,Karol,2673,701,29,22,51,56.9%,1h
8462,2,TheRaiNBOw,2673,92,3,2,5,60.0%,23m
8462,3,Cronous,2673,0,2,3,5,40.0%,9m
8462,1,[NWGD]AXILES,2673,0,0,1,1,0.0%,25m
8467,2,Gernhart,2672,1583,57,66,123,46.3%,14m
8467,3,Wally,2672,786,33,31,64,51.6%,11m
8467,1,wastlbastl,2672,550,23,14,37,62.2%,24m
8467,2,[Trasch]Pico,2672,429,15,12,27,55.6%,1h
8467,3,[SigV]Dlacreme,2672,165,7,7,14,50.0%,6m
8467,3,neo,2672,122,5,5,10,50.0%,29m
8467,1,vojta,2672,119,4,7,11,36.4%,11m
8467,3,Bekele,2672,0,3,5,8,37.5%,28m
8467,1,Moichi,2672,0,1,3,4,25.0%,1h
8467,1,angrypanda,2672,40,1,5,6,16.7%,11m
8467,2,Bugrahan,2672,0,0,1,1,0.0%,1h
8467,2,Svoi,2672,0,0,1,1,0.0%,15m
8479,1,Khadgar,2671,347,15,16,31,48.4%,1h
8479,2,Chasokin,2671,290,11,5,16,68.8%,1h
8479,3,Koolk,2671,204,7,15,22,31.8%,9m
8479,3,JackKill,2671,0,3,2,5,60.0%,1h
8479,2,Tintin,2671,60,3,19,22,13.6%,15m
8479,2,Wana,2671,70,2,1,3,66.7%,1h
8485,3,Jimmy,2670,1306,60,61,121,49.6%,10m
8485,3,Leszu,2670,910,45,48,93,48.4%,27m
8485,3,EliteHunter,2670,995,36,44,80,45.0%,14m
8485,2,Darth,2670,272,11,13,24,45.8%,29m
8485,3,MaJIou,2670,122,6,14,20,30.0%,4m
8485,2,Dom,2670,0,2,3,5,40.0%,1h
8485,2,Unforeseen,2670,30,1,1,2,50.0%,1h
8485,3,[nbalm]Jumo,2670,0,0,1,1,0.0%,1h
8485,3,Etrisc,2670,0,0,1,1,0.0%,40m
8494,3,FrostFisk,2669,1562,300,290,590,50.8%,13m
8494,3,bengazhibob,2669,399,49,59,108,45.4%,18m
8494,2,DKlHybrid,2669,320,12,11,23,52.2%,1h
8494,3,WurstBonbon,2669,109,5,5,10,50.0%,11m
8498,1,llucke,2668,933,46,24,70,65.7%,7m
8498,1,Geo,2668,796,33,30,63,52.4%,21m
8498,2,Mojita,2668,404,16,18,34,47.1%,2m
8498,1,[SBTO]Tombstone,2668,337,12,9,21,57.1%,6m
8498,2,[UGHAGH]Ugh,2668,182,11,6,17,64.7%,29m
8498,1,[DAK]MLCxBöserlux,2668,104,4,5,9,44.4%,1h
8498,2,Thor,2668,0,0,1,1,0.0%,4m
8505,1,LolYou,2667,296,13,14,27,48.1%,5m
8505,3,Grina,2667,97,3,3,6,50.0%,40m
8505,1,AnakinAltair,2667,78,3,6,9,33.3%,18m
8505,2,pilotkill,2667,0,2,2,4,50.0%,1h
8505,1,Sergej,2667,40,2,2,4,50.0%,27m
8505,1,Kiki,2667,38,1,3,4,25.0%,17m
8505,1,lIIiiiiiilll,2667,0,1,3,4,25.0%,1h
8512,1,NOtalent,2666,650,20,24,44,45.5%,1h
8512,3,[Khazar]Misha,2666,114,6,4,10,60.0%,11m
8512,2,[GWN]idanmenashes,2666,0,2,3,5,40.0%,1h
8512,3,FireStarter,2666,62,2,10,12,16.7%,21m
8512,2,McSushi,2666,30,1,2,3,33.3%,24m
8517,3,Parabellum,2665,1441,106,92,198,53.5%,16m
8517,2,ElonaGay,2665,558,20,21,41,48.8%,1h
8517,1,[roph]Manny,2665,476,14,16,30,46.7%,19m
8517,1,[o3o]Askari,2665,288,8,11,19,42.1%,37m
8517,1,Zermingore,2665,226,6,10,16,37.5%,1h
8517,3,Serp,2665,0,3,2,5,60.0%,17m
8517,1,Olanin,2665,89,2,1,3,66.7%,1h
8517,1,Yurgen,2665,36,2,2,4,50.0%,3m
8517,1,[YFY]brancy,2665,0,0,1,1,0.0%,1h
8526,1,Nervai,2664,1291,163,157,320,50.9%,14m
8526,3,saracin,2664,1215,117,120,237,49.4%,15m
8526,1,[DucK]SpaceDucK,2664,1105,72,61,133,54.1%,1h
8526,1,[SoSaGe]jorrrrris,2664,340,29,27,56,51.8%,17m
8526,1,[RBP3]KostoF,2664,632,26,22,48,54.2%,1h
8526,1,[SoothK]Alkemisten,2664,700,24,26,50,48.0%,31m
8526,3,ERIKtheRED,2664,253,8,6,14,57.1%,23m
8526,3,svinsane,2664,30,4,5,9,44.4%,8m
8534,3,[MeDiT8]flOwZEn,2663,1600,80,71,151,53.0%,12m
8534,1,[ProRax]Maksimys,2663,878,38,25,63,60.3%,1h
8534,1,[4CB]IIIIIIIIIIII,2663,243,34,21,55,61.8%,20m
8534,3,Ven,2663,765,32,36,68,47.1%,9m
8534,1,Dava,2663,537,17,19,36,47.2%,21m
8534,2,QuBuS,2663,167,7,3,10,70.0%,1h
8534,2,XTOTAM,2663,88,3,4,7,42.9%,18m
8534,2,[TaxiTT]FROL,2663,0,2,3,5,40.0%,27m
8534,3,darckdestroy,2663,0,2,3,5,40.0%,1h
8534,3,mamba,2663,42,1,1,2,50.0%,1h
8534,2,[WWP]bybybyraguga,2663,32,1,1,2,50.0%,18m
8534,1,[RеG]MaximiliaN,2663,0,0,6,6,0.0%,39m
8546,1,Trostu,2662,1702,129,127,256,50.4%,33m
8546,2,AntoniuD,2662,1089,41,45,86,47.7%,17m
8546,1,Empresslilyy,2662,741,27,23,50,54.0%,39m
8546,1,Molok,2662,256,8,9,17,47.1%,1h
8546,2,Nexussix,2662,168,6,6,12,50.0%,5m
8546,1,[FoK]Uziel,2662,40,1,3,4,25.0%,17m
8546,1,[NLTN]dzoryx,2662,0,0,5,5,0.0%,25m
8553,3,Azazel,2661,581,34,30,64,53.1%,7m
8553,1,JeanLuc,2661,575,26,19,45,57.8%,1h
8553,2,benzeone,2661,495,17,26,43,39.5%,14m
8553,2,KalaKukko,2661,102,3,1,4,75.0%,32m
8553,2,[DfVv]МалОта,2661,0,1,0,1,100.0%,1h
8553,1,крабик,2661,0,0,5,5,0.0%,39m
8559,3,[ĦĦ]blockzwoa,2660,1568,109,109,218,50.0%,18m
8559,3,ХанАспарух,2660,1221,97,86,183,53.0%,22m
8559,2,palact,2660,612,23,19,42,54.8%,1h
8559,1,CrimsonKing,2660,269,10,6,16,62.5%,33m
8559,2,Seingeschäft,2660,228,8,6,14,57.1%,1h
8559,1,WoRnD,2660,178,7,3,10,70.0%,39m
8559,1,TerraStorm,2660,208,7,8,15,46.7%,16m
8559,3,DeLorean,2660,0,3,5,8,37.5%,7m
8559,3,Thor,2660,0,2,3,5,40.0%,1h
8559,3,Irick,2660,0,2,3,5,40.0%,1h
8559,3,Oshikuru,2660,0,0,1,1,0.0%,26m
8570,1,Zox,2659,628,64,62,126,50.8%,11m
8570,1,Zel,2659,1451,49,57,106,46.2%,1h
8570,2,Hero,2659,164,5,2,7,71.4%,1h
8570,1,Endeka,2659,32,4,4,8,50.0%,1h
8570,2,onionthought,2659,34,2,1,3,66.7%,34m
8570,2,Firevd,2659,0,1,0,1,100.0%,1h
8570,2,StarCat,2659,0,0,1,1,0.0%,17m
8577,3,[ToonT]TTDuffyDuck,2658,1589,362,353,715,50.6%,28m
8577,3,Rocinante,2658,437,15,14,29,51.7%,7m
8577,1,DrAybolit,2658,279,9,4,13,69.2%,15m
8577,1,[ZЕRGTV]pitip,2658,138,3,4,7,42.9%,32m
8577,3,Proxy,2658,97,2,0,2,100.0%,1h
8577,1,Defiet,2658,96,2,2,4,50.0%,37m
8577,2,[BOAE]Bandit,2658,46,2,6,8,25.0%,19m
8584,1,[CubRub]Gymnopedie,2657,934,51,26,77,66.2%,7m
8584,1,LOBODEMAR,2657,1092,42,43,85,49.4%,3m
8584,2,Mcitci,2657,1042,38,49,87,43.7%,29m
8584,2,Orbitalforce,2657,669,29,16,45,64.4%,1h
8584,3,[BloTi]barcode,2657,443,20,16,36,55.6%,6m
8584,3,Noumz,2657,183,6,12,18,33.3%,23m
8584,2,[3ЕRGTV]Vlad,2657,48,4,6,10,40.0%,39m
8584,2,Tolomeo,2657,0,2,6,8,25.0%,1h
8584,2,NicowAPM,2657,0,1,4,5,20.0%,14m
8584,2,[QTcIub]Tudor,2657,44,1,8,9,11.1%,1h
8594,1,Denico,2656,1254,62,49,111,55.9%,29m
8594,1,[PGRF]Sorceror,2656,194,6,3,9,66.7%,5m
8594,2,mezek,2656,0,0,1,1,0.0%,1h
8597,1,llllllllllll,2655,910,34,32,66,51.5%,25m
8597,3,Batlakruta,2655,78,6,9,15,40.0%,14m
8597,2,танто,2655,64,3,2,5,60.0%,5m
8597,2,[StRa]Barktooth,2655,0,0,1,1,0.0%,1h
8601,1,Mescaline,2654,1375,101,100,201,50.2%,1h
8601,2,[mFAPm]leRATAel,2654,346,18,8,26,69.2%,29m
8601,2,UPYR,2654,379,14,8,22,63.6%,1h
8601,1,Doods,2654,171,7,7,14,50.0%,24m
8601,2,[4EW]PuteDeLucxs,2654,233,6,5,11,54.5%,37m
8601,1,CaptainD,2654,153,6,7,13,46.2%,1h
8601,3,[NWGD]illia,2654,97,2,0,2,100.0%,1h
8601,1,Derrick,2654,108,2,2,4,50.0%,39m
8601,1,[MeDuS]barauskas,2654,78,2,6,8,25.0%,39m
8601,1,Twinkie,2654,78,2,9,11,18.2%,1h
8601,1,ЗверяЗмейПРо,2654,0,1,1,2,50.0%,1h
8601,1,Virius,2654,42,1,3,4,25.0%,36m
8601,2,CLONik,2654,0,0,2,2,0.0%,1h
8601,1,etadex,2654,0,0,3,3,0.0%,25m
8615,3,[Yhng]NIK,2653,1147,79,69,148,53.4%,14m
8615,1,aliocha,2653,920,42,32,74,56.8%,39m
8615,3,[AOTW]Gaben,2653,294,14,8,22,63.6%,21m
8615,2,Maciek,2653,160,5,3,8,62.5%,1h
8615,1,kierenz,2653,170,4,10,14,28.6%,1h
8615,3,[DUPAx]zzabakk,2653,0,3,2,5,60.0%,23m
8615,3,[Тропа]Повелитель,2653,30,3,6,9,33.3%,12m
8615,3,micubisi,2653,30,3,7,10,30.0%,12m
8615,2,Even,2653,0,2,3,5,40.0%,7m
8615,3,XMANN,2653,0,0,2,2,0.0%,1h
8625,2,danypata,2652,1502,62,50,112,55.4%,17m
8625,2,[DYR]StarVoyager,2652,1252,47,44,91,51.6%,17m
8625,1,GuiltYCroWn,2652,699,26,22,48,54.2%,1h
8625,1,ciupaila,2652,559,21,21,42,50.0%,23m
8625,1,[BWArmy]IIIIIIII,2652,400,18,14,32,56.2%,20m
8625,1,[FuсkUU]Player,2652,202,9,15,24,37.5%,11m
8625,2,Ninja,2652,196,8,3,11,72.7%,18m
8625,1,[SaviOr]GhostKeeper,2652,209,7,7,14,50.0%,1h
8625,2,Irvine,2652,116,4,2,6,66.7%,37m
8625,2,Skadi,2652,60,3,1,4,75.0%,36m
8625,3,[Teror]Fok,2652,40,2,0,2,100.0%,1h
8636,2,[oooo89]TheCiuLi,2651,460,19,14,33,57.6%,1h
8636,1,[ligma]DarthVader,2651,102,3,3,6,50.0%,1h
8636,2,[Nz4L]Kwosie,2651,0,0,1,1,0.0%,1h
8636,2,TARAS,2651,0,0,1,1,0.0%,13m
8636,2,PuMBa,2651,0,0,1,1,0.0%,30m
8636,1,romaAmour,2651,0,0,2,2,0.0%,33m
8642,3,[AKAMAT]ReiZulu,2650,1468,122,110,232,52.6%,19m
8642,3,Rastuzio,2650,1007,115,112,227,50.7%,29m
8642,2,BottomQuak,2650,1325,65,77,142,45.8%,21m
8642,1,teli,2650,1286,44,49,93,47.3%,31m
8642,1,RaVeR,2650,854,34,24,58,58.6%,1h
8642,1,ГрАл,2650,450,23,25,48,47.9%,31m
8642,1,bardosm,2650,412,12,17,29,41.4%,1h
8642,1,Gungani,2650,262,9,7,16,56.2%,24m
8642,2,[sonic1]ERROR,2650,58,3,1,4,75.0%,1h
8642,3,Faker,2650,0,3,2,5,60.0%,1h
8642,2,Ragolas,2650,121,3,4,7,42.9%,17m
8642,3,[0142]WENGER,2650,97,1,2,3,33.3%,18m
8654,2,[NWGD]benito,2649,380,14,8,22,63.6%,20m
8654,2,[PIKMN]UnPrisoned,2649,236,8,3,11,72.7%,1h
8654,1,morok,2649,188,6,7,13,46.2%,14m
8654,3,Sunca,2649,169,6,8,14,42.9%,11m
8658,3,inexxt,2648,1226,84,70,154,54.5%,29m
8658,1,[ENV]Rumun,2648,862,28,32,60,46.7%,1h
8658,2,[Ultm]TXK,2648,46,2,1,3,66.7%,1h
8658,3,ERiC,2648,0,2,2,4,50.0%,1h
8658,3,Abradoks,2648,0,2,3,5,40.0%,1h
8658,2,Sarpoxicity,2648,0,1,0,1,100.0%,17m
8658,1,DDave,2648,0,0,1,1,0.0%,21m
8665,3,ThaMagician,2647,534,20,25,45,44.4%,19m
8665,2,Vendetta,2647,227,8,7,15,53.3%,1h
8665,1,Уья,2647,161,7,10,17,41.2%,28m
8665,1,Салоед,2647,121,4,1,5,80.0%,22m
8665,1,GuitarGuitar,2647,0,1,2,3,33.3%,1h
8665,2,ShadowskY,2647,0,0,1,1,0.0%,15m
8671,1,Messir,2646,1507,175,180,355,49.3%,15m
8671,2,Trasig,2646,1244,47,42,89,52.8%,6m
8671,2,SIMAX,2646,428,16,13,29,55.2%,11m
8671,3,George,2646,381,13,16,29,44.8%,14m
8671,1,goodkid,2646,295,12,14,26,46.2%,1h
8671,1,LeszekPisz,2646,114,8,10,18,44.4%,17m
8671,1,richards,2646,163,5,10,15,33.3%,36m
8671,1,[PLA2N]Psihosenser,2646,114,3,6,9,33.3%,33m
8671,1,Unrealshoot,2646,36,2,5,7,28.6%,21m
8671,3,[HEАT]CHE,2646,0,1,0,1,100.0%,1h
8671,1,[GР]Ringo,2646,40,1,6,7,14.3%,39m
8671,2,Rinzler,2646,0,0,1,1,0.0%,16m
8671,1,SSS,2646,0,0,3,3,0.0%,36m
8684,2,Harry,2645,1379,62,65,127,48.8%,15m
8684,3,[PsF]Gery,2645,1265,49,62,111,44.1%,18m
8684,2,vielonia,2645,411,38,37,75,50.7%,1h
8684,2,Ressehc,2645,623,31,20,51,60.8%,1h
8684,1,naget,2645,438,16,12,28,57.1%,11m
8684,2,DobrO,2645,0,4,3,7,57.1%,17m
8684,1,[Mines9]miha,2645,163,4,7,11,36.4%,1h
8684,3,upuaut,2645,0,2,3,5,40.0%,1h
8684,2,[TFSC]aaa,2645,0,0,2,2,0.0%,1h
8693,1,[GBCSC2]Maggy,2644,1328,99,107,206,48.1%,5m
8693,1,Vitok,2644,1453,68,68,136,50.0%,1h
8693,2,Ruslan,2644,482,17,14,31,54.8%,4m
8693,2,yoo,2644,335,13,17,30,43.3%,15m
8693,1,Gurrinho,2644,129,6,7,13,46.2%,6m
8693,2,Vladimer,2644,120,5,3,8,62.5%,1h
8693,1,Zornpranke,2644,97,5,4,9,55.6%,1h
8693,2,Рубик,2644,58,3,1,4,75.0%,17m
8693,1,LaZappelin,2644,95,2,0,2,100.0%,3m
8693,3,[Nawak]Aelfric,2644,0,2,4,6,33.3%,11m
8693,2,Greugaan,2644,30,1,1,2,50.0%,1h
8693,3,AlphaSik,2644,42,1,3,4,25.0%,1h
8693,2,GidraLisk,2644,0,0,1,1,0.0%,5m
8693,2,FARSH,2644,0,0,1,1,0.0%,14m
8707,1,ptolingio,2643,1693,100,98,198,50.5%,1h
8707,3,[FR1]Vlayd,2643,1551,92,96,188,48.9%,8m
8707,2,[Muhaha]Machiel,2643,1635,69,68,137,50.4%,1h
8707,2,Taro,2643,325,13,12,25,52.0%,34m
8707,1,PvtSnowball,2643,267,8,11,19,42.1%,5m
8707,1,Churifriski,2643,90,1,3,4,25.0%,28m
8713,2,nossnevs,2642,446,17,13,30,56.7%,28m
8713,2,KACKA,2642,340,11,7,18,61.1%,5m
8713,1,[GGBOYZ]puckY,2642,155,4,4,8,50.0%,37m
8713,3,Ocram,2642,0,1,0,1,100.0%,20m
8717,3,ТРЕНДЕ,2641,919,46,54,100,46.0%,19m
8717,1,Ruso,2641,454,18,18,36,50.0%,20m
8717,2,Tycyn,2641,0,3,2,5,60.0%,1h
8717,3,Kuiper,2641,62,3,8,11,27.3%,6m
8717,2,MicroondasR,2641,62,2,5,7,28.6%,17m
8717,2,ParanOidaL,2641,0,1,0,1,100.0%,6m
8717,2,Bore,2641,0,1,0,1,100.0%,39m
8717,2,[KRAKOT]tassadar,2641,30,1,1,2,50.0%,1h
8717,2,[SkBG]GetRektNoob,2641,109,1,2,3,33.3%,34m
8726,2,[crabz]MauZeR,2640,1528,260,249,509,51.1%,12m
8726,1,Tenenberg,2640,371,73,68,141,51.8%,1h
8726,3,BlackAlert,2640,535,21,23,44,47.7%,12m
8726,3,LebenAmLimes,2640,295,12,11,23,52.2%,39m
8726,3,Zaniah,2640,261,10,12,22,45.5%,1h
8726,3,RandomStorY,2640,0,4,1,5,80.0%,30m
8726,2,NeoGeek,2640,0,2,3,5,40.0%,1h
8726,2,[SkyB]Koshirou,2640,90,2,4,6,33.3%,32m
8726,2,Kerrigan,2640,0,1,0,1,100.0%,40m
8726,2,TuristBear,2640,93,1,1,2,50.0%,40m
8726,1,[GTERZ]Blueberry,2640,0,1,3,4,25.0%,19m
8726,1,Krovn,2640,0,1,5,6,16.7%,1h
8726,2,[DLOK]Forsman,2640,30,1,6,7,14.3%,12m
8726,2,Akai,2640,0,0,1,1,0.0%,1h
8740,1,Halakost,2639,1447,77,65,142,54.2%,36m
8740,1,Blurlover,2639,612,21,26,47,44.7%,33m
8740,3,[HighP]KingdomPower,2639,508,18,25,43,41.9%,10m
8740,3,yorick,2639,399,17,20,37,45.9%,8m
8740,3,[DSAS]darkice,2639,526,17,31,48,35.4%,14m
8740,2,[Sizzle]RisingFenix,2639,254,9,7,16,56.2%,1h
8740,2,Ragnarock,2639,30,4,3,7,57.1%,5m
8740,2,[heavyM]Neezo,2639,0,3,2,5,60.0%,33m
8740,2,alsinoc,2639,0,0,1,1,0.0%,1h
8749,3,Adolf,2638,305,23,27,50,46.0%,16m
8749,2,miki,2638,303,12,3,15,80.0%,1h
8749,1,Pixel,2638,339,11,11,22,50.0%,23m
8749,1,ahb,2638,216,10,8,18,55.6%,38m
8749,1,[TmFlei]Noha,2638,220,8,7,15,53.3%,36m
8749,2,[Meowts]MeowTV,2638,0,1,0,1,100.0%,18m
8749,2,rumi,2638,0,0,1,1,0.0%,1h
8756,3,Lou,2637,1132,57,52,109,52.3%,11m
8756,3,Folken,2637,495,41,35,76,53.9%,14m
8756,3,[БУБУБ]Virtuzo,2637,251,10,12,22,45.5%,37m
8756,3,Odin,2637,30,3,8,11,27.3%,28m
8756,3,happyfaceAR,2637,134,3,9,12,25.0%,19m
8756,2,sorko,2637,60,2,3,5,40.0%,1h
8756,2,Safe,2637,88,2,4,6,33.3%,1h
8756,2,Blood,2637,30,1,3,4,25.0%,16m
8764,2,GoSuGhOsT,2636,439,15,11,26,57.7%,7m
8764,1,indigo,2636,445,15,16,31,48.4%,1h
8764,2,Kurczak,2636,367,14,7,21,66.7%,12m
8764,3,Shirogane,2636,0,1,4,5,20.0%,6m
8768,2,[SwSII]Meepo,2635,202,8,13,21,38.1%,11m
8768,3,llllllllllll,2635,197,8,14,22,36.4%,13m
8768,3,[WndKnd]ywecur,2635,38,3,4,7,42.9%,14m
8768,3,manokanaka,2635,0,2,3,5,40.0%,26m
8768,1,[Mercy1]Grumbleball,2635,36,2,3,5,40.0%,7m
8768,2,Vladimir,2635,0,2,3,5,40.0%,39m
8774,1,KryG,2634,994,140,124,264,53.0%,21m
8774,2,[HPBL]simonctnr,2634,1569,99,80,179,55.3%,1h
8774,2,Tarantul,2634,1569,83,48,131,63.4%,5m
8774,3,Spoiler,2634,270,12,12,24,50.0%,11m
8774,1,PowerNap,2634,337,12,19,31,38.7%,36m
8774,1,[Ark]Dariox,2634,0,3,4,7,42.9%,7m
8774,3,Noobik,2634,0,2,5,7,28.6%,18m
8774,2,cobrakin,2634,0,2,5,7,28.6%,9m
8774,3,PlayerOne,2634,0,1,0,1,100.0%,35m
8774,2,NikSlaughter,2634,32,1,1,2,50.0%,1h
8784,1,Alesh,2633,636,25,23,48,52.1%,37m
8784,3,Bleys,2633,534,22,24,46,47.8%,28m
8784,1,БешеныйГлист,2633,254,10,13,23,43.5%,1h
8784,1,KappaGandalf,2633,198,7,4,11,63.6%,2m
8784,2,Арториас,2633,60,3,2,5,60.0%,1h
8784,2,kinze,2633,42,2,1,3,66.7%,16m
8784,3,Erik,2633,0,1,0,1,100.0%,9m
8784,2,[SCTR]BobToss,2633,0,1,1,2,50.0%,38m
8792,2,Perturabo,2632,1155,110,115,225,48.9%,11m
8792,2,Ninja,2632,534,23,12,35,65.7%,25m
8792,2,STARrussher,2632,474,19,9,28,67.9%,6m
8792,1,DarkSeven,2632,524,16,21,37,43.2%,11m
8792,1,Sedativ,2632,268,9,8,17,52.9%,39m
8792,1,[axis]Theo,2632,272,9,14,23,39.1%,31m
8792,1,XxYunYunFanX,2632,194,7,11,18,38.9%,15m
8792,2,jiwi,2632,114,4,5,9,44.4%,30m
8792,3,[Rebеls]ling,2632,119,3,8,11,27.3%,18m
8792,2,[IceHus]Krep,2632,30,2,0,2,100.0%,1h
8792,2,Niskanen,2632,0,0,1,1,0.0%,15m
8803,1,[SSV]OriOn,2631,1020,37,38,75,49.3%,1h
8803,1,[Xy9lce]HumArist,2631,840,26,31,57,45.6%,31m
8803,2,kelf,2631,44,5,4,9,55.6%,38m
8803,1,[LeDude]FunGeneraL,2631,192,5,6,11,45.5%,7m
8803,2,[GlNYU]Onlineritter,2631,58,3,1,4,75.0%,1h
8803,2,pewy,2631,90,3,2,5,60.0%,1h
8803,1,Papir,2631,36,3,4,7,42.9%,14m
8803,1,Storm,2631,96,3,8,11,27.3%,35m
8803,2,Fransekaas,2631,30,2,0,2,100.0%,8m
8803,1,[PowOw]SABCJayme,2631,89,2,2,4,50.0%,35m
8803,3,[lkgg]MOMO,2631,0,2,3,5,40.0%,12m
8803,1,Лап,2631,95,1,1,2,50.0%,1h
8803,3,ManLove,2631,0,0,9,9,0.0%,28m
8816,2,ELKAPO,2630,0,3,2,5,60.0%,33m
8816,2,[ExTr1m]ERRORЗOЗ,2630,0,1,0,1,100.0%,5m
8818,2,Happy,2629,505,74,64,138,53.6%,1h
8818,2,[NWGD]MirayGee,2629,366,14,8,22,63.6%,29m
8818,1,[VATAN]iceman,2629,100,3,2,5,60.0%,37m
8818,2,HighTea,2629,0,0,1,1,0.0%,32m
8822,3,energy,2628,1342,83,96,179,46.4%,11m
8822,1,[Weedoc]CriticalHaze,2628,1355,70,66,136,51.5%,20m
8822,3,Peti,2628,0,0,2,2,0.0%,1h
8825,1,kazak,2627,1679,277,267,544,50.9%,1h
8825,2,Rychmistrz,2627,1547,86,84,170,50.6%,1h
8825,2,Archina,2627,536,32,31,63,50.8%,13m
8825,2,Tartararam,2627,590,25,15,40,62.5%,27m
8825,2,Necronomicon,2627,708,25,25,50,50.0%,11m
8825,1,bobby,2627,348,10,15,25,40.0%,17m
8825,3,LifeIsPain,2627,0,3,2,5,60.0%,22m
8825,2,Neal,2627,88,2,4,6,33.3%,1h
8825,2,[NSVL]mutozek,2627,0,1,0,1,100.0%,5m
8825,2,[VadLan]Joker,2627,0,1,1,2,50.0%,13m
8825,2,HoYaGa,2627,0,0,1,1,0.0%,1h
8836,2,infestor,2626,1109,69,58,127,54.3%,37m
8836,1,Rebel,2626,1389,67,68,135,49.6%,35m
8836,2,Raiden,2626,588,34,34,68,50.0%,39m
8836,1,YouKnow,2626,468,16,15,31,51.6%,1h
8836,2,bloom,2626,317,9,8,17,52.9%,1h
8836,3,Pettersen,2626,119,2,4,6,33.3%,18m
8836,3,[THANOS]sazan,2626,0,1,0,1,100.0%,22m
8836,2,BogdanDOL,2626,32,1,2,3,33.3%,33m
8836,2,[OSgZ]EatMyShorts,2626,0,0,1,1,0.0%,32m
8845,3,Raynor,2625,748,25,35,60,41.7%,16m
8845,1,[Etna]Vulturne,2625,529,18,21,39,46.2%,7m
8845,2,nikilebrave,2625,354,14,9,23,60.9%,1h
8845,1,Ioerrge,2625,334,12,16,28,42.9%,19m
8845,2,slake,2625,0,3,2,5,60.0%,32m
8845,3,efro,2625,0,2,2,4,50.0%,8m
8845,2,Nosk,2625,0,1,0,1,100.0%,23m
8852,2,Elijah,2624,398,17,15,32,53.1%,1h
8852,2,Voislav,2624,285,10,11,21,47.6%,39m
8852,1,SourAlpaca,2624,145,5,8,13,38.5%,19m
8852,1,Smirky,2624,0,1,0,1,100.0%,1h
8852,2,JerraXuS,2624,0,1,1,2,50.0%,25m
8857,1,[Batia]alariii,2623,833,35,27,62,56.5%,21m
8857,3,[IVöVI]MAXHE,2623,908,33,42,75,44.0%,29m
8857,1,[LOLscv]SCVrush,2623,310,12,11,23,52.2%,21m
8857,1,proCBETKA,2623,348,9,12,21,42.9%,19m
8857,3,EML,2623,154,5,17,22,22.7%,18m
8857,3,koshara,2623,0,1,4,5,20.0%,1h
8857,1,Usul,2623,38,1,10,11,9.1%,1h
8864,3,[XKK]dynast,2622,804,59,70,129,45.7%,9m
8864,2,Tweety,2622,482,21,16,37,56.8%,39m
8864,1,Esseker,2622,537,18,17,35,51.4%,1h
8864,2,[IceHus]Pandosss,2622,210,7,5,12,58.3%,33m
8864,1,konservator,2622,217,6,10,16,37.5%,1h
8864,1,ManySided,2622,158,5,12,17,29.4%,7m
8864,2,[R61]dixy,2622,91,2,0,2,100.0%,37m
8864,2,[YIY]Foxlord,2622,0,0,1,1,0.0%,33m
8864,2,[OnDack]MrSmile,2622,0,0,1,1,0.0%,1h
8873,2,Killerfridge,2621,857,68,62,130,52.3%,34m
8873,2,veggieking,2621,526,23,24,47,48.9%,28m
8873,1,[NLTN]Adler,2621,220,7,9,16,43.8%,25m
8873,3,AmazingMoon,2621,133,3,4,7,42.9%,23m
8877,3,viovio,2620,466,16,26,42,38.1%,6m
8877,2,[230ММ]IronKerya,2620,134,6,4,10,60.0%,1h
8877,1,[JJMP]Kosimazaki,2620,184,6,8,14,42.9%,1h
8877,1,Frayt,2620,91,4,4,8,50.0%,1h
8877,3,Aiur,2620,141,3,0,3,100.0%,9m
8877,2,kikaxa,2620,58,3,1,4,75.0%,1h
8877,1,shadow,2620,152,3,6,9,33.3%,21m
8877,3,[Looz]silver,2620,0,2,3,5,40.0%,28m
8877,2,[AtrK]MaverickS,2620,0,1,0,1,100.0%,1h
8877,2,[pdrz]Massa,2620,30,1,3,4,25.0%,17m
8887,1,LadyGaga,2619,1564,135,136,271,49.8%,11m
8887,2,Rangleklods,2619,898,38,28,66,57.6%,1h
8887,1,[Arrows]dikkkkkkkkkk,2619,739,30,28,58,51.7%,28m
8887,2,EchoSierra,2619,574,27,11,38,71.1%,1h
8887,2,Cons,2619,449,18,14,32,56.2%,1h
8887,1,[RMM]spartacus,2619,355,13,20,33,39.4%,17m
8887,1,[GiRLgg]CuteKitty,2619,461,13,21,34,38.2%,21m
8887,1,[COMMIE]TheSamMiner,2619,235,7,5,12,58.3%,39m
8887,1,Parzival,2619,154,4,9,13,30.8%,34m
8887,2,[s23b]Picho,2619,112,3,0,3,100.0%,1h
8887,1,Joanmelian,2619,88,3,4,7,42.9%,1h
8887,2,schensen,2619,0,2,3,5,40.0%,1h
8887,2,Godbrazer,2619,0,0,1,1,0.0%,40m
8900,2,[LMBD]Talha,2618,144,6,10,16,37.5%,15m
8901,2,EvilZerg,2617,262,9,12,21,42.9%,39m
8901,1,Joel,2617,295,8,12,20,40.0%,2m
8901,1,roos,2617,118,5,4,9,55.6%,29m
8901,2,Pitiku,2617,0,1,1,2,50.0%,38m
8901,3,[illjil]MateFeedKill,2617,0,1,4,5,20.0%,4m
8906,2,PegaS,2616,479,19,12,31,61.3%,13m
8906,1,Drive,2616,372,13,14,27,48.1%,25m
8906,2,SorrowShine,2616,228,9,9,18,50.0%,17m
8906,1,Patas,2616,200,8,7,15,53.3%,40m
8906,2,Max,2616,119,5,3,8,62.5%,34m
8906,2,Hornet,2616,102,3,4,7,42.9%,6m
8906,3,Boemz,2616,0,1,0,1,100.0%,1h
8906,1,BooMBorG,2616,0,0,1,1,0.0%,1h
8914,1,[BSK88]Hallora,2615,347,21,12,33,63.6%,13m
8914,3,dOmInAtE,2615,558,19,29,48,39.6%,21m
8914,2,Hizashik,2615,179,8,10,18,44.4%,1h
8914,2,NiceSpirit,2615,144,6,8,14,42.9%,3m
8914,2,[PLFS]Tarkes,2615,30,1,3,4,25.0%,1h
8914,2,Väinämöinen,2615,93,1,7,8,12.5%,17m
8914,2,juozapas,2615,0,0,1,1,0.0%,17m
8914,3,[dd33nt]daJonas,2615,0,0,5,5,0.0%,9m
8922,3,Kiketurry,2614,1487,175,182,357,49.0%,14m
8922,1,DenzelCurry,2614,1446,59,56,115,51.3%,1h
8922,1,ivanko,2614,461,29,32,61,47.5%,25m
8922,3,Armenino,2614,273,23,25,48,47.9%,19m
8922,3,crw,2614,215,7,7,14,50.0%,2m
8922,1,deBeutel,2614,0,4,2,6,66.7%,1h
8922,2,Роман,2614,60,3,3,6,50.0%,40m
8922,2,ParadoX,2614,90,3,6,9,33.3%,1h
8922,2,IIIIIIIIIIII,2614,32,2,0,2,100.0%,16m
8922,2,Blitzkrieg,2614,64,2,4,6,33.3%,3m
8922,2,weakling,2614,0,1,0,1,100.0%,17m
8922,3,Antares,2614,38,1,3,4,25.0%,34m
8922,2,[TSC2C]chudini,2614,0,0,1,1,0.0%,8m
8922,2,скорпион,2614,0,0,1,1,0.0%,32m
8936,3,Silenther,2613,42,5,2,7,71.4%,18m
8936,1,enoRginE,2613,181,4,6,10,40.0%,1h
8936,3,[NSJLM]XeQiu,2613,135,3,5,8,37.5%,20m
8939,2,Iwanow,2612,458,16,15,31,51.6%,35m
8939,2,TaLiBAN,2612,123,5,4,9,55.6%,1h
8939,2,Franzi,2612,155,4,2,6,66.7%,40m
8939,2,Skippy,2612,146,4,4,8,50.0%,1h
8939,1,[NINJ88]Ant,2612,144,4,8,12,33.3%,14m
8939,2,[FMG]SgtShake,2612,0,3,2,5,60.0%,15m
8939,2,cbx,2612,32,2,1,3,66.7%,1h
8939,3,candycekae,2612,0,2,4,6,33.3%,20m
8939,2,noza,2612,0,1,3,4,25.0%,22m
8939,2,Jenicek,2612,0,0,1,1,0.0%,39m
8939,2,Clouddigger,2612,0,0,1,1,0.0%,22m
8950,1,ParadoxOn,2611,647,22,25,47,46.8%,18m
8950,3,[EXPANT]Bratta,2611,161,14,17,31,45.2%,3m
8950,2,Mihanic,2611,136,4,5,9,44.4%,22m
8950,3,GANZI,2611,0,2,4,6,33.3%,3m
8950,2,Sarge,2611,0,1,0,1,100.0%,31m
8955,2,Lujien,2610,286,10,14,24,41.7%,1h
8955,1,RiseDenise,2610,0,3,2,5,60.0%,23m
8955,1,Auch,2610,0,2,4,6,33.3%,1h
8955,2,UnlayerSoul,2610,0,1,3,4,25.0%,38m
8955,2,Nabulak,2610,0,0,2,2,0.0%,36m
8960,2,TesTo,2609,1040,81,91,172,47.1%,6m
8960,1,TryHard,2609,774,33,33,66,50.0%,11m
8960,2,marijane,2609,199,9,8,17,52.9%,22m
8960,2,Scorpio,2609,204,8,7,15,53.3%,1h
8960,1,Nightstate,2609,169,6,7,13,46.2%,1h
8960,1,RAYNHART,2609,97,4,2,6,66.7%,1h
8960,3,[BURG3R]HotBob,2609,38,4,3,7,57.1%,37m
8960,1,Miguelator,2609,0,2,3,5,40.0%,6m
8968,1,Snake,2608,371,24,24,48,50.0%,7m
8968,2,jwe,2608,526,22,11,33,66.7%,37m
8968,2,JeanMiAulas,2608,333,16,11,27,59.3%,34m
8968,1,Elkanijo,2608,298,13,9,22,59.1%,38m
8968,1,[PTWTM]Raven,2608,278,11,12,23,47.8%,20m
8968,2,[SLNC]NicoSS,2608,196,9,7,16,56.2%,34m
8968,2,[SCGTR]NaRtEzAs,2608,158,4,3,7,57.1%,1h
8975,1,rub,2607,1009,94,103,197,47.7%,28m
8975,1,[krdo]Mertojack,2607,0,3,2,5,60.0%,4m
8975,2,Zealot,2607,0,2,3,5,40.0%,1h
8975,2,[ZAFT]Goodman,2607,60,2,3,5,40.0%,1h
8975,2,Gagarin,2607,0,2,3,5,40.0%,17m
8975,3,Reaper,2607,0,1,0,1,100.0%,1h
8975,1,douuuuuuuuu,2607,0,1,4,5,20.0%,31m
8975,2,[JG]BLadeZ,2607,0,0,1,1,0.0%,1h
8975,3,rtm,2607,0,0,1,1,0.0%,1h
8975,2,Hercule,2607,0,0,1,1,0.0%,21m
8975,2,LostCrusader,2607,0,0,1,1,0.0%,11m
8986,1,Mum,2606,799,33,36,69,47.8%,34m
8986,1,[SloT]Kocó,2606,155,5,5,10,50.0%,31m
8986,2,frol,2606,112,3,0,3,100.0%,1h
8986,2,[Stim]Tor,2606,80,3,6,9,33.3%,27m
8986,2,[BloTi]Kozanostra,2606,0,0,3,3,0.0%,40m
8991,1,[x67x]ROHoZ,2605,552,16,20,36,44.4%,34m
8991,3,[MinDes]SPIRIT,2605,0,1,0,1,100.0%,1h
8991,2,Mentos,2605,0,1,0,1,100.0%,38m
8991,2,[CОS]innoVation,2605,0,0,1,1,0.0%,13m
8995,1,Тусич,2604,1304,194,208,402,48.3%,9m
8995,3,SoulAssassin,2604,1515,131,140,271,48.3%,10m
8995,2,GoluBostRui,2604,804,46,31,77,59.7%,6m
8995,3,Shiansu,2604,674,25,31,56,44.6%,4m
8995,2,PsYcHoO,2604,275,8,8,16,50.0%,21m
8995,3,Zed,2604,268,8,21,29,27.6%,12m
8995,3,Quentin,2604,72,4,4,8,50.0%,3m
8995,3,AFCArt,2604,161,4,6,10,40.0%,4m
8995,2,SleepyJoe,2604,137,4,9,13,30.8%,1h
8995,1,[Colony]BlueMax,2604,148,4,10,14,28.6%,1h
8995,1,Maximus,2604,48,2,1,3,66.7%,1h
8995,2,sebax,2604,0,1,0,1,100.0%,1h
8995,3,Kingofwars,2604,0,1,0,1,100.0%,1h
8995,2,[LosLaT]bartøx,2604,0,0,1,1,0.0%,1h
9009,1,starlord,2603,1411,51,52,103,49.5%,1h
9009,2,TBAG,2603,749,28,24,52,53.8%,1h
9009,1,CombatPilot,2603,286,8,11,19,42.1%,1h
9009,2,Foxtrot,2603,102,4,4,8,50.0%,3m
9009,2,StarDuck,2603,123,4,5,9,44.4%,32m
9009,2,GhsT,2603,0,1,0,1,100.0%,6m
9009,2,[STMS]Krosis,2603,94,1,1,2,50.0%,6m
9009,1,[Щитон]Star,2603,0,0,1,1,0.0%,39m
9017,1,Bief,2602,809,69,57,126,54.8%,39m
9017,2,[FnGsGs]Egarly,2602,856,35,25,60,58.3%,17m
9017,3,Nilf,2602,881,33,37,70,47.1%,14m
9017,2,Nakhttoter,2602,649,27,16,43,62.8%,1h
9017,1,OlegionUA,2602,353,14,15,29,48.3%,1h
9017,3,Clees,2602,0,3,5,8,37.5%,19m
9017,2,[TaMort]DontCryBaby,2602,114,2,1,3,66.7%,23m
9017,2,gaintrain,2602,0,1,0,1,100.0%,22m
9017,1,[NagibX]JasonM,2602,0,0,4,4,0.0%,1h
9026,2,JackOfHearts,2601,765,104,116,220,47.3%,17m
9026,1,DOCG,2601,751,28,32,60,46.7%,34m
9026,1,[FTEII]FTElite,2601,716,25,28,53,47.2%,36m
9026,2,[NLLO]llllllllllll,2601,398,17,9,26,65.4%,1h
9026,1,GhostPepper,2601,320,13,10,23,56.5%,25m
9026,2,nox,2601,217,8,11,19,42.1%,16m
9026,1,xDerJulianx,2601,121,3,4,7,42.9%,38m
9026,2,[НТТ]Hashirama,2601,30,2,1,3,66.7%,1h
9026,2,Noddy,2601,116,2,2,4,50.0%,1h
9026,2,Fragile,2601,0,0,1,1,0.0%,38m
9026,2,[Jöthem]Indominus,2601,0,0,2,2,0.0%,1h
9037,2,Jvz,2600,1410,83,55,138,60.1%,1h
9037,1,[Pikaia]Pikaia,2600,1256,51,54,105,48.6%,1h
9037,2,Sherminator,2600,615,34,5,39,87.2%,1h
9037,2,Pucka,2600,713,34,21,55,61.8%,32m
9037,1,Bizzy,2600,250,9,10,19,47.4%,28m
9037,1,FESS,2600,194,8,7,15,53.3%,1h
9037,2,Huang,2600,58,2,1,3,66.7%,1h
9037,2,[SmOv]yolenain,2600,30,1,1,2,50.0%,7m
9037,2,[12345S]АРТЁМКА,2600,0,1,3,4,25.0%,11m
9037,2,McKlappstuhl,2600,0,0,3,3,0.0%,11m
9047,3,Ryan,2599,707,118,128,246,48.0%,9m
9047,2,Gym,2599,1528,64,58,122,52.5%,1h
9047,1,LETSPLAY,2599,1232,47,43,90,52.2%,29m
9047,1,[axis]Benthe,2599,1031,41,43,84,48.8%,18m
9047,2,ShPoOnT,2599,342,22,10,32,68.8%,20m
9047,2,[RO2020]DonEnzone,2599,200,6,5,11,54.5%,32m
9047,1,[HRD]Lukotas,2599,106,5,4,9,55.6%,5m
9047,2,Apicis,2599,60,2,2,4,50.0%,39m
9047,2,Atlantis,2599,0,1,1,2,50.0%,10m
9047,2,[iBBQ]Shrengo,2599,0,0,2,2,0.0%,25m
9057,1,SebastianeK,2598,1435,166,140,306,54.2%,19m
9057,2,Fridge,2598,683,35,8,43,81.4%,32m
9057,2,Cra,2598,430,17,10,27,63.0%,21m
9057,2,sdf,2598,156,7,8,15,46.7%,33m
9057,1,charlotte,2598,180,6,4,10,60.0%,1h
9057,2,quartane,2598,64,3,3,6,50.0%,1h
9057,2,Ishuo,2598,30,2,1,3,66.7%,1h
9064,1,[E0D]NeilBlaze,2597,945,37,39,76,48.7%,29m
9064,1,Shlamovoy,2597,737,32,40,72,44.4%,21m
9064,2,benet,2597,689,30,17,47,63.8%,38m
9064,2,Throgaash,2597,0,2,3,5,40.0%,39m
9064,2,MyasnikDI,2597,0,2,3,5,40.0%,1h
9069,2,Artorias,2596,387,16,9,25,64.0%,28m
9069,2,[LRXS]Aganna,2596,62,5,8,13,38.5%,28m
9069,2,Touine,2596,0,3,2,5,60.0%,7m
9069,2,DarkWolf,2596,0,1,1,2,50.0%,1h
9069,2,Otzelot,2596,0,1,2,3,33.3%,32m
9074,2,hooger,2595,1553,135,133,268,50.4%,30m
9074,2,Avgustin,2595,518,29,27,56,51.8%,1h
9074,1,AzimuthXeno,2595,280,13,17,30,43.3%,27m
9074,2,Dopeaf,2595,282,8,10,18,44.4%,37m
9074,3,OptimusPrime,2595,120,4,12,16,25.0%,14m
9074,1,pofigy,2595,88,3,4,7,42.9%,32m
9074,2,IIIIIIIIIIII,2595,62,2,4,6,33.3%,10m
9074,2,Überninja,2595,0,1,0,1,100.0%,1h
9074,2,MichaILove,2595,0,0,1,1,0.0%,1h
9074,2,rawér,2595,0,0,3,3,0.0%,1h
9084,2,MistaEvil,2594,1555,99,92,191,51.8%,38m
9084,1,[UndeD]Under,2594,831,34,33,67,50.7%,32m
9084,3,balabala,2594,463,19,22,41,46.3%,18m
9084,1,Darknova,2594,264,10,10,20,50.0%,20m
9084,2,Womble,2594,159,5,6,11,45.5%,8m
9084,1,Global,2594,114,4,8,12,33.3%,12m
9084,2,EvilSquirrel,2594,90,3,4,7,42.9%,29m
9084,2,[НH]Merdrim,2594,0,1,0,1,100.0%,1h
9084,2,fryingpan,2594,0,1,0,1,100.0%,8m
9084,2,[MALYXA]Kamenskiy,2594,0,0,1,1,0.0%,17m
9094,1,Ragen,2593,717,35,28,63,55.6%,39m
9094,2,Icedemon,2593,826,30,32,62,48.4%,1h
9094,1,Waaghrall,2593,475,18,22,40,45.0%,10m
9094,2,[RusMoo]Vencendor,2593,347,13,12,25,52.0%,1h
9094,3,Athmoless,2593,388,11,21,32,34.4%,14m
9094,2,ANSA,2593,172,7,6,13,53.8%,1h
9094,2,wiggi,2593,135,4,7,11,36.4%,39m
9094,2,ich,2593,60,3,4,7,42.9%,39m
9094,2,aiur,2593,0,1,0,1,100.0%,34m
9094,2,[RYMDEN]daaH,2593,30,1,1,2,50.0%,30m
9094,3,[CRAYZE]Адунтеридас,2593,0,1,2,3,33.3%,1h
9094,3,versus,2593,0,0,1,1,0.0%,17m
9106,1,promsky,2592,623,25,22,47,53.2%,1h
9106,2,[AK47]HOH,2592,389,12,14,26,46.2%,1h
9106,1,Rheinevan,2592,385,11,13,24,45.8%,3m
9106,2,laow,2592,267,11,14,25,44.0%,31m
9106,2,scoon,2592,155,5,8,13,38.5%,38m
9106,1,miniBidule,2592,0,4,1,5,80.0%,1h
9106,3,WestSpirit,2592,137,4,5,9,44.4%,37m
9106,2,Fusto,2592,0,2,3,5,40.0%,1h
9106,2,Omaba,2592,0,2,3,5,40.0%,33m
9106,3,[DTST]nilz,2592,0,1,0,1,100.0%,1h
9106,3,plusspeed,2592,0,0,1,1,0.0%,11m
9106,2,Boba,2592,0,0,1,1,0.0%,33m
9106,2,[улей55]qwerty,2592,0,0,1,1,0.0%,17m
9106,1,Juggernaut,2592,0,0,4,4,0.0%,9m
9120,2,TATANGALAR,2591,858,32,30,62,51.6%,1h
9120,2,[ILR]Ulpiotraiano,2591,112,3,1,4,75.0%,18m
9120,3,Kuha,2591,97,3,4,7,42.9%,1h
9120,2,[N8Wrst]Lennox,2591,0,1,4,5,20.0%,1h
9124,1,NUDEXxX,2590,1630,73,68,141,51.8%,33m
9124,2,Redox,2590,1236,65,63,128,50.8%,7m
9124,1,TenLetters,2590,478,18,24,42,42.9%,1h
9124,2,PHENIX,2590,381,14,10,24,58.3%,1h
9124,2,[ExTr1m]sashaTopGg,2590,214,7,3,10,70.0%,27m
9124,2,ReXeR,2590,181,7,6,13,53.8%,1h
9124,2,[Sylla]Sylla,2590,244,7,8,15,46.7%,27m
9124,2,Noctorian,2590,176,6,2,8,75.0%,1h
9124,2,Azurok,2590,0,4,4,8,50.0%,35m
9124,2,Moralex,2590,60,3,2,5,60.0%,1h
9124,2,[skuzi]frinzo,2590,0,2,3,5,40.0%,13m
9124,1,nightingale,2590,40,2,7,9,22.2%,17m
9124,2,Plantago,2590,0,1,0,1,100.0%,1h
9124,2,KovidXii,2590,0,1,4,5,20.0%,1h
9138,2,Zvereff,2589,667,53,43,96,55.2%,17m
9138,2,Grim,2589,297,10,7,17,58.8%,17m
9138,2,Axamiya,2589,162,4,3,7,57.1%,36m
9141,3,giga,2588,1581,325,324,649,50.1%,3m
9141,1,Creativite,2588,164,8,9,17,47.1%,1h
9141,2,[killU]Marineder,2588,168,7,4,11,63.6%,1h
9141,2,[DV]Biscornus,2588,118,4,4,8,50.0%,1h
9145,1,Critical,2587,709,51,52,103,49.5%,35m
9145,2,Alex,2587,937,39,30,69,56.5%,34m
9145,2,rom,2587,795,35,22,57,61.4%,1h
9145,2,Storkuuuk,2587,195,6,8,14,42.9%,20m
9145,1,BlumeCorp,2587,186,6,10,16,37.5%,29m
9145,2,Pinghinizer,2587,88,4,2,6,66.7%,1h
9145,2,Irbis,2587,0,3,2,5,60.0%,39m
9145,3,Рентген,2587,0,1,0,1,100.0%,1h
9145,1,Baiania,2587,0,0,1,1,0.0%,1h
9145,2,[TuNa95]BiGxLebowski,2587,0,0,3,3,0.0%,31m
9155,1,boultan,2586,647,35,37,72,48.6%,1h
9155,1,bigbang,2586,436,14,20,34,41.2%,1h
9155,3,WookieITA,2586,412,14,26,40,35.0%,3m
9155,3,Evst,2586,190,6,18,24,25.0%,28m
9155,1,[TTGL]KingofWeebs,2586,0,2,3,5,40.0%,38m
9155,2,[ReproT]ZyrO,2586,0,1,0,1,100.0%,17m
9155,1,NoNamedPl,2586,36,1,8,9,11.1%,1h
9155,2,[TENRIX]Darktherion,2586,0,0,1,1,0.0%,1h
9155,2,Cosmyn,2586,0,0,1,1,0.0%,15m
9155,2,BrightLord,2586,0,0,1,1,0.0%,3m
9165,2,[Laki]PhantomKI,2585,944,36,28,64,56.2%,1h
9165,2,DICCTUCKERRR,2585,174,6,6,12,50.0%,1h
9165,2,ПроАртёмПро,2585,94,4,6,10,40.0%,1h
9165,1,[0Head]artur,2585,0,2,0,2,100.0%,38m
9165,2,terZERprot,2585,88,2,4,6,33.3%,35m
9165,3,GoldeadMage,2585,0,2,4,6,33.3%,1h
9165,1,VIVAMOS,2585,0,0,7,7,0.0%,1h
9172,2,[KYB]BujajTorbe,2584,1496,63,62,125,50.4%,29m
9172,2,КирюшаБледны,2584,720,37,17,54,68.5%,1h
9172,1,Дракон,2584,625,21,29,50,42.0%,40m
9172,2,Vyrus,2584,337,12,10,22,54.5%,1h
9172,1,Inserter,2584,198,7,11,18,38.9%,1h
9172,1,[RoPtm]TAKESHY,2584,0,3,2,5,60.0%,18m
9172,2,Tyfoon,2584,30,2,2,4,50.0%,6m
9172,2,Gasan,2584,0,0,1,1,0.0%,20m
9172,3,[31Baka]Silver,2584,0,0,2,2,0.0%,14m
9172,2,AllFiction,2584,0,0,3,3,0.0%,1h
9182,2,[ŚS6]PiraMID,2583,1598,100,90,190,52.6%,30m
9182,2,[SoWas]Neight,2583,1262,98,90,188,52.1%,18m
9182,2,Gelo,2583,456,18,16,34,52.9%,1h
9182,2,Pati,2583,336,15,13,28,53.6%,39m
9182,2,[PIZIKS]RIPer,2583,285,10,8,18,55.6%,1h
9182,3,ELKAPO,2583,175,7,8,15,46.7%,29m
9182,3,Ruso,2583,155,4,5,9,44.4%,15m
9182,2,Savage,2583,0,3,2,5,60.0%,1h
9182,1,GrafRucola,2583,48,3,3,6,50.0%,3m
9182,2,Kerenos,2583,58,2,3,5,40.0%,39m
9182,2,LoWeSt,2583,0,1,4,5,20.0%,40m
9193,1,[BYOS]Phobos,2582,490,183,179,362,50.6%,1h
9193,2,Guest,2582,926,34,36,70,48.6%,1h
9193,3,momo,2582,451,17,25,42,40.5%,14m
9193,2,[TxM]EgRoJ,2582,369,14,10,24,58.3%,38m
9193,1,[lnvoke]Mithrandir,2582,0,2,4,6,33.3%,25m
9193,3,Shorty,2582,40,1,4,5,20.0%,5m
9193,2,DECADE,2582,0,1,5,6,16.7%,9m
9193,2,[VetM]Tanatos,2582,30,1,6,7,14.3%,13m
9201,3,[PiGPan]CJV,2581,1502,112,105,217,51.6%,16m
9201,2,DERF,2581,719,31,32,63,49.2%,1h
9201,1,[FSMD88]Mailman,2581,741,26,33,59,44.1%,1h
9201,2,Fouman,2581,442,17,19,36,47.2%,28m
9201,3,tomfoolery,2581,336,17,22,39,43.6%,6m
9201,3,Coimao,2581,330,12,15,27,44.4%,11m
9201,2,jungleboogie,2581,120,4,7,11,36.4%,7m
9201,1,MADGAKKIN,2581,0,2,1,3,66.7%,6m
9201,2,ktBarnaul,2581,0,0,2,2,0.0%,7m
9210,3,Teckel,2580,1551,215,215,430,50.0%,19m
9210,1,replayRTW,2580,1646,64,73,137,46.7%,1h
9210,2,stygg,2580,618,26,29,55,47.3%,40m
9210,2,[4LF]Nauzijo,2580,385,16,18,34,47.1%,40m
9210,2,Enigma,2580,247,9,8,17,52.9%,1h
9210,1,PreMorteM,2580,0,3,4,7,42.9%,20m
9210,2,Finaldav,2580,0,1,1,2,50.0%,34m
9210,1,peaceprayer,2580,34,1,12,13,7.7%,40m
9210,2,[RNKS]SÄÄTÄJÄ,2580,0,0,1,1,0.0%,28m
9219,2,SviterOk,2579,316,11,7,18,61.1%,30m
9219,2,DarKLine,2579,253,11,14,25,44.0%,1h
9219,3,DSRinger,2579,287,10,14,24,41.7%,27m
9219,2,Ponchik,2579,182,7,6,13,53.8%,29m
9219,2,ElCid,2579,0,4,4,8,50.0%,38m
9219,1,[охота]Salamander,2579,88,4,4,8,50.0%,36m
9219,2,Sharpblade,2579,88,4,7,11,36.4%,4m
9219,2,IIIIIIII,2579,88,2,0,2,100.0%,1h
9219,2,[22asw1]BENIS,2579,0,1,0,1,100.0%,3m
9219,2,DrKisel,2579,0,1,0,1,100.0%,28m
9219,2,Lannister,2579,0,1,2,3,33.3%,1h
9219,2,Fugitiv,2579,0,0,1,1,0.0%,1h
9231,1,Ulysse,2578,122,4,5,9,44.4%,39m
9231,2,Danikray,2578,121,3,1,4,75.0%,23m
9231,1,DoReMe,2578,0,3,2,5,60.0%,1h
9231,2,[HAKS]BLACKALIROSE,2578,0,0,4,4,0.0%,21m
9235,3,BUCS,2577,1490,268,278,546,49.1%,28m
9235,1,БэшеныйПэдро,2577,569,23,21,44,52.3%,1h
9235,2,deathman,2577,208,9,6,15,60.0%,13m
9235,2,MichalO,2577,183,6,4,10,60.0%,1h
9235,2,Hello,2577,178,5,7,12,41.7%,7m
9235,2,Flekz,2577,0,4,1,5,80.0%,13m
9235,3,LongStroke,2577,127,3,5,8,37.5%,30m
9235,2,notyou,2577,0,1,0,1,100.0%,1h
9235,3,GACHIped,2577,0,0,1,1,0.0%,1h
9235,2,[ESP1]Legislador,2577,0,0,1,1,0.0%,1h
9235,2,[DTBMII]Vivacious,2577,0,0,1,1,0.0%,1h
9246,2,[Søre]Yarg,2576,1425,70,60,130,53.8%,32m
9246,1,KorbenDallas,2576,534,34,35,69,49.3%,14m
9246,2,Лирой,2576,702,31,28,59,52.5%,1h
9246,2,Andy,2576,748,28,28,56,50.0%,1h
9246,2,kanacraft,2576,272,12,15,27,44.4%,5m
9246,2,SchoKoPanDa,2576,30,3,4,7,42.9%,19m
9246,2,Rubi,2576,0,1,1,2,50.0%,1h
9253,2,[DiPeNi]mib,2575,1572,174,170,344,50.6%,1h
9253,2,Comeasyouare,2575,1382,53,56,109,48.6%,13m
9253,2,buczer,2575,118,5,8,13,38.5%,13m
9256,3,Мегатрон,2574,1544,200,201,401,49.9%,12m
9256,3,Alex,2574,378,76,84,160,47.5%,17m
9256,2,ǂßẫŊąŊƏǂ,2574,310,13,6,19,68.4%,1h
9256,2,reverite,2574,0,2,3,5,40.0%,1h
9256,1,Ехоу,2574,0,2,3,5,40.0%,9m
9256,2,[SrFt]Сардар,2574,0,2,4,6,33.3%,6m
9256,2,[CovPar]Cyrialkiller,2574,30,2,7,9,22.2%,8m
9263,2,Michi,2573,1131,44,44,88,50.0%,1h
9263,2,[PaniC]scnightfire,2573,384,16,10,26,61.5%,40m
9263,1,Wicket,2573,409,14,17,31,45.2%,34m
9263,2,Enigma,2573,218,13,14,27,48.1%,22m
9263,3,Wizzard,2573,169,5,5,10,50.0%,26m
9263,2,Jowkasta,2573,88,4,4,8,50.0%,1h
9263,1,Gremlin,2573,142,4,5,9,44.4%,6m
9263,2,PopovOrlov,2573,80,2,4,6,33.3%,20m
9263,1,Tyran,2573,0,2,4,6,33.3%,19m
9263,2,Opal,2573,88,1,1,2,50.0%,34m
9273,1,[MSK77]Greyfox,2572,1551,148,157,305,48.5%,21m
9273,1,[LBZ]ElAhui,2572,747,62,38,100,62.0%,39m
9273,1,TaiTai,2572,1237,48,52,100,48.0%,25m
9273,2,Novrex,2572,697,28,26,54,51.9%,7m
9273,2,[VoxX]sghjJR,2572,148,4,2,6,66.7%,7m
9273,2,osman,2572,0,3,2,5,60.0%,1h
9273,3,иван,2572,97,3,4,7,42.9%,4m
9273,2,Mercury,2572,114,2,6,8,25.0%,1h
9273,2,ArQoNyqn,2572,0,1,2,3,33.3%,11m
9282,2,[GGSC2]Gimy,2571,1438,55,54,109,50.5%,40m
9282,1,Royaly,2571,886,32,38,70,45.7%,21m
9282,1,Nerak,2571,98,6,7,13,46.2%,32m
9282,2,EridoN,2571,0,3,6,9,33.3%,17m
9282,2,Sendo,2571,46,3,7,10,30.0%,39m
9282,1,Highlander,2571,117,2,3,5,40.0%,1h
9282,2,Puppet,2571,0,0,3,3,0.0%,1h
9289,2,[StrLz]Valandil,2570,1566,73,76,149,49.0%,1h
9289,3,wowa,2570,442,16,25,41,39.0%,28m
9289,2,[xPAPPA]Generalen,2570,157,6,5,11,54.5%,1h
9289,2,stason,2570,116,5,5,10,50.0%,1h
9289,2,[hf4X4]ProfKahre,2570,116,4,0,4,100.0%,1h
9289,1,Skyline,2570,161,4,4,8,50.0%,3m
9289,2,DrHoernchen,2570,0,1,0,1,100.0%,30m
9289,2,[WАSD]lXXXWASDXXXl,2570,0,1,2,3,33.3%,11m
9289,2,VartV,2570,0,0,1,1,0.0%,40m
9298,1,DJartie,2569,1640,115,119,234,49.1%,1h
9298,2,[WeDoM]Onja,2569,1161,50,44,94,53.2%,1h
9298,2,Mirceatop,2569,208,7,10,17,41.2%,1h
9298,2,nikon,2569,100,5,2,7,71.4%,1h
9298,2,Keb,2569,132,5,4,9,55.6%,1h
9298,2,Integra,2569,60,3,6,9,33.3%,10m
9298,2,bestlover,2569,58,2,4,6,33.3%,1h
9298,2,DeX,2569,0,1,0,1,100.0%,32m
9298,2,Smarog,2569,0,1,2,3,33.3%,30m
9298,2,Popelschleim,2569,30,1,3,4,25.0%,35m
9298,2,Gully,2569,0,0,1,1,0.0%,6m
9298,2,[izék]Skydrive,2569,0,0,1,1,0.0%,35m
9310,2,Lexotan,2568,689,33,31,64,51.6%,1h
9310,2,iGGotchu,2568,753,31,27,58,53.4%,1h
9310,2,Arxont,2568,304,11,10,21,52.4%,35m
9310,2,[RvdS]Thorin,2568,242,9,5,14,64.3%,1h
9310,3,Duwe,2568,208,7,12,19,36.8%,15m
9310,1,Lecumberry,2568,141,6,7,13,46.2%,5m
9310,2,Raynor,2568,116,4,1,5,80.0%,1h
9310,2,Darkhides,2568,0,2,3,5,40.0%,31m
9318,2,SecdThought,2567,396,19,17,36,52.8%,1h
9318,2,KingOfLimbo,2567,180,8,2,10,80.0%,21m
9318,3,JohnRembo,2567,40,4,5,9,44.4%,35m
9318,3,pomalaNca,2567,157,3,2,5,60.0%,1h
9318,2,[4672]Niceguy,2567,93,3,4,7,42.9%,1h
9318,2,[DaFF]Delusion,2567,92,3,5,8,37.5%,28m
9318,2,Gremlin,2567,0,1,2,3,33.3%,1h
9318,1,[GoldM]Cemzx,2567,0,0,3,3,0.0%,25m
9326,1,Failure,2566,1446,76,81,157,48.4%,1h
9326,1,zaggy,2566,1327,57,51,108,52.8%,1h
9326,3,PENGUIN,2566,710,29,29,58,50.0%,12m
9326,3,Sikclle,2566,152,7,10,17,41.2%,13m
9326,1,PikkewynMan,2566,136,4,10,14,28.6%,1h
9326,3,ikL,2566,40,1,1,2,50.0%,12m
9332,1,Dendis,2565,1417,103,101,204,50.5%,38m
9332,2,Mattagon,2565,239,11,1,12,91.7%,40m
9332,2,leopshef,2565,234,5,12,17,29.4%,13m
9332,1,GeneralHell,2565,36,3,5,8,37.5%,1h
9336,3,Vancraft,2564,1545,227,224,451,50.3%,19m
9336,2,Kerrigan,2564,357,16,10,26,61.5%,17m
9336,1,Schnuckel,2564,272,12,11,23,52.2%,36m
9336,1,DerStrumpf,2564,191,6,9,15,40.0%,29m
9336,2,IlIlIlIlIlIl,2564,117,3,8,11,27.3%,1h
9336,2,[НИШТЯК]tnt,2564,0,2,3,5,40.0%,1h
9336,1,LXgMidnightt,2564,0,2,4,6,33.3%,32m
9336,2,Radi,2564,0,1,0,1,100.0%,39m
9336,3,Foton,2564,0,1,1,2,50.0%,12m
9345,1,benizakura,2563,1135,109,107,216,50.5%,1h
9345,3,Shablul,2563,746,30,40,70,42.9%,5m
9345,1,freddykrüger,2563,644,25,25,50,50.0%,25m
9345,2,Bill,2563,521,21,14,35,60.0%,39m
9345,2,FinalDegree,2563,352,16,11,27,59.3%,1h
9345,2,KeY,2563,131,5,0,5,100.0%,1h
9345,2,nhabine,2563,119,2,1,3,66.7%,32m
9345,1,Falcon,2563,0,2,3,5,40.0%,21m
9345,2,[Fääät]AdrianBmg,2563,0,0,1,1,0.0%,1h
9354,2,LBA,2562,1572,89,86,175,50.9%,40m
9354,3,Curbitec,2562,1337,73,72,145,50.3%,29m
9354,3,MrLenha,2562,1242,45,56,101,44.6%,27m
9354,3,ПапаКарло,2562,873,35,47,82,42.7%,11m
9354,2,Hydralisk,2562,564,23,19,42,54.8%,17m
9354,2,Byteit,2562,252,22,14,36,61.1%,25m
9354,2,Zhabi,2562,336,16,9,25,64.0%,30m
9354,2,[uWutM8]uMad,2562,420,15,19,34,44.1%,15m
9354,2,AllinOne,2562,216,6,9,15,40.0%,21m
9354,2,respect,2562,60,3,4,7,42.9%,1h
9354,2,[AotWS]Dappa,2562,0,1,4,5,20.0%,30m
9354,2,antex,2562,0,0,1,1,0.0%,6m
9366,2,Konfusius,2561,588,21,23,44,47.7%,1h
9366,2,Massaraksh,2561,402,17,21,38,44.7%,1h
9366,1,[HRD]Hasherino,2561,62,4,6,10,40.0%,1h
9366,3,Pazu,2561,97,2,0,2,100.0%,32m
9366,2,Liksio,2561,0,1,0,1,100.0%,27m
9366,2,[FBON]Nakami,2561,92,1,2,3,33.3%,1h
9366,2,[ÄoB]drofus,2561,0,0,2,2,0.0%,1h
9373,1,OMEGABOOM,2560,177,6,9,15,40.0%,3m
9373,2,RedJohn,2560,161,4,7,11,36.4%,28m
9373,2,Phoenix,2560,0,1,1,2,50.0%,30m
9373,2,ILFANG,2560,0,0,1,1,0.0%,15m
9373,3,lille,2560,0,0,1,1,0.0%,26m
9378,3,SBI,2559,335,14,14,28,50.0%,25m
9378,2,Бекукелька,2559,193,7,4,11,63.6%,1h
9378,1,[IceHus]КоролеваРоя,2559,160,4,5,9,44.4%,23m
9378,1,OneBasePony,2559,0,2,3,5,40.0%,1h
9378,3,[2RVLV]Rambo,2559,0,1,0,1,100.0%,13m
9378,3,[Zhig]SirXamoid,2559,0,1,0,1,100.0%,40m
9384,2,KungMarco,2558,1209,126,138,264,47.7%,15m
9384,3,Untake,2558,190,16,31,47,34.0%,17m
9384,2,borgius,2558,212,10,2,12,83.3%,1h
9384,1,Aleksei,2558,140,4,10,14,28.6%,34m
9384,3,[IBMS]Mangomera,2558,0,3,3,6,50.0%,18m
9384,2,Scuby,2558,0,0,1,1,0.0%,1h
9390,3,AppleJ,2557,295,94,105,199,47.2%,10m
9390,1,[dgmj]bibi,2557,851,28,34,62,45.2%,1h
9390,2,[BZerO]txtsxm,2557,664,27,23,50,54.0%,38m
9390,2,Andr,2557,304,12,6,18,66.7%,1h
9390,3,MaxiBraDa,2557,198,7,10,17,41.2%,21m
9390,3,Horgot,2557,74,5,5,10,50.0%,10m
9390,2,XeliX,2557,30,3,5,8,37.5%,1h
9390,1,[Боец]Alassar,2557,112,3,11,14,21.4%,34m
9390,3,phiby,2557,0,2,4,6,33.3%,14m
9390,3,Teeee,2557,0,1,0,1,100.0%,39m
9390,1,Brutaliti,2557,0,1,4,5,20.0%,16m
9390,2,yuugen,2557,0,0,6,6,0.0%,32m
9402,1,MorbusGravis,2556,1618,204,196,400,51.0%,20m
9402,1,Kharnrostro,2556,1601,161,164,325,49.5%,36m
9402,1,Dreier,2556,574,19,26,45,42.2%,1h
9402,3,[ICCCPI]Shadow,2556,268,12,14,26,46.2%,21m
9402,2,Zargnaza,2556,261,9,8,17,52.9%,1h
9402,2,Artur,2556,182,6,7,13,46.2%,39m
9402,3,BotaNeagra,2556,0,2,3,5,40.0%,40m
9402,1,kirillko,2556,0,2,3,5,40.0%,11m
9402,3,lockra,2556,0,2,4,6,33.3%,1h
9402,2,Rasty,2556,0,1,0,1,100.0%,27m
9402,1,Terra,2556,0,1,2,3,33.3%,10m
9402,2,Solomon,2556,88,1,2,3,33.3%,1h
9402,2,[3Mz]Strog,2556,30,1,6,7,14.3%,7m
9402,2,Mike,2556,0,0,1,1,0.0%,34m
9416,2,[Dagon]sath,2555,942,38,36,74,51.4%,6m
9416,1,LEONIDAS,2555,780,28,32,60,46.7%,36m
9416,2,Izzi,2555,547,22,21,43,51.2%,1h
9416,2,Nevermind,2555,553,19,17,36,52.8%,1h
9416,1,Torres,2555,194,19,26,45,42.2%,1h
9416,2,Napoleon,2555,203,9,3,12,75.0%,1h
9416,2,bloodwolff,2555,232,6,9,15,40.0%,11m
9416,2,[ICCCPI]Dgon,2555,88,4,3,7,57.1%,17m
9416,3,[zlvlj]wardog,2555,30,2,0,2,100.0%,4m
9416,3,[KTOP]Agouha,2555,58,2,3,5,40.0%,38m
9416,1,Ravdrien,2555,0,2,3,5,40.0%,13m
9416,3,hoce,2555,0,0,1,1,0.0%,28m
9416,2,Иван,2555,0,0,2,2,0.0%,1h
9429,2,МАКС,2554,1565,195,187,382,51.0%,28m
9429,1,[xxDSxx]SirArgos,2554,414,15,18,33,45.5%,1h
9429,2,Hakan,2554,214,7,13,20,35.0%,25m
9429,1,Тимур,2554,0,5,5,10,50.0%,39m
9429,2,Keeer,2554,86,4,4,8,50.0%,1h
9429,3,[BLMVPs]Gumel,2554,120,4,5,9,44.4%,1h
9429,1,BeefHoBread,2554,0,2,3,5,40.0%,17m
9429,3,SpaceChad,2554,0,2,3,5,40.0%,1h
9429,2,PSYCHO,2554,0,0,1,1,0.0%,1h
9438,2,WespeWilly,2553,1020,38,39,77,49.4%,39m
9438,1,Vivi,2553,575,22,29,51,43.1%,1h
9438,1,younger,2553,280,12,14,26,46.2%,29m
9438,1,Dante,2553,230,8,10,18,44.4%,1h
9442,1,sett,2552,1188,43,49,92,46.7%,1h
9442,1,Calbe,2552,553,20,23,43,46.5%,21m
9442,3,Flexon,2552,375,16,0,16,100.0%,31m
9442,2,[boredx]HuntedNoob,2552,380,15,11,26,57.7%,16m
9442,2,JedesPolar,2552,0,3,2,5,60.0%,6m
9442,3,PowerPleb,2552,40,3,5,8,37.5%,32m
9442,3,[Трутни]RazarRiper,2552,0,1,0,1,100.0%,3m
9442,2,[ROFG]AnatoliyNoha,2552,0,1,1,2,50.0%,3m
9450,1,Lucifer,2551,886,33,35,68,48.5%,30m
9450,2,Mystic,2551,147,3,11,14,21.4%,9m
9450,2,Smith,2551,30,2,2,4,50.0%,31m
9450,3,davide,2551,30,1,1,2,50.0%,1h
9450,3,LuckyPanda,2551,0,0,1,1,0.0%,22m
9455,1,cedoeyxo,2550,566,20,23,43,46.5%,9m
9455,2,gaara,2550,407,16,12,28,57.1%,1h
9455,2,[Dralag]NeroDeath,2550,230,9,9,18,50.0%,10m
9455,2,Gandalf,2550,0,4,2,6,66.7%,35m
9455,2,ElectronChik,2550,0,4,2,6,66.7%,33m
9455,3,Iluminium,2550,0,2,4,6,33.3%,17m
9455,3,[mineXD]Bumbi,2550,0,1,0,1,100.0%,9m
9462,2,Palm,2549,586,28,21,49,57.1%,7m
9462,2,DKlAcidViper,2549,231,7,4,11,63.6%,39m
9462,2,teromit,2549,194,7,5,12,58.3%,23m
9462,3,[163bro]EnotVatake,2549,192,6,7,13,46.2%,10m
9462,3,diamondlors,2549,58,2,2,4,50.0%,9m
9462,3,[Pxyool]MMRSanta,2549,0,1,0,1,100.0%,1h
9462,3,LightElfTank,2549,0,0,1,1,0.0%,30m
9469,1,Karotter,2548,564,32,33,65,49.2%,35m
9469,3,[Habibs]Dhulqarnain,2548,272,11,6,17,64.7%,9m
9469,3,[Кратос]zuzik,2548,187,8,11,19,42.1%,12m
9469,3,[N1CANI]Gexy,2548,139,4,1,5,80.0%,32m
9469,1,[PDG]BITCOIN,2548,0,0,1,1,0.0%,1h
9474,3,[PetF]barbiche,2547,673,28,39,67,41.8%,15m
9474,1,dominonzerg,2547,478,16,21,37,43.2%,1h
9474,2,Langebo,2547,199,6,4,10,60.0%,25m
9474,1,techno,2547,88,5,2,7,71.4%,20m
9474,1,george,2547,96,2,2,4,50.0%,1h
9474,3,wind,2547,0,1,0,1,100.0%,15m
9474,3,Blinchik,2547,0,0,1,1,0.0%,1h
9481,2,Volrath,2546,1317,92,94,186,49.5%,31m
9481,1,[ViokMS]KENJI,2546,1545,60,62,122,49.2%,29m
9481,2,hola,2546,306,25,14,39,64.1%,2m
9481,2,[LOOOOS]RobotVegan,2546,117,5,4,9,55.6%,15m
9481,2,Meru,2546,132,3,2,5,60.0%,31m
9481,3,[xFRSx]HySteriX,2546,122,3,5,8,37.5%,1h
9481,2,Guguinhas,2546,0,1,3,4,25.0%,34m
9481,2,Random,2546,34,1,8,9,11.1%,1h
9489,1,Nomak,2545,1475,195,197,392,49.7%,38m
9489,1,[Olk]HORUS,2545,1579,151,155,306,49.3%,20m
9489,2,Sigfried,2545,1579,121,115,236,51.3%,1h
9489,1,Smog,2545,321,11,13,24,45.8%,28m
9489,2,ivanko,2545,0,1,1,2,50.0%,1h
9489,1,Incognito,2545,0,0,1,1,0.0%,6m
9495,1,OrangeJuice,2544,1050,35,44,79,44.3%,8m
9495,2,Eurotrash,2544,414,26,32,58,44.8%,5m
9495,2,RageQuitRudi,2544,274,10,9,19,52.6%,17m
9495,2,GradunSemkov,2544,215,8,8,16,50.0%,39m
9495,1,RoboCop,2544,154,7,11,18,38.9%,1h
9495,3,shooroop,2544,0,1,0,1,100.0%,1h
9495,3,flint,2544,0,1,0,1,100.0%,1h
9495,2,TheFury,2544,0,0,2,2,0.0%,7m
9503,1,Korki,2543,1259,121,137,258,46.9%,7m
9503,1,[VadN]butzMrSatan,2543,698,26,30,56,46.4%,1h
9503,1,zagar,2543,140,8,5,13,61.5%,3m
9503,2,RageWD,2543,222,7,6,13,53.8%,27m
9503,3,korkers,2543,172,5,3,8,62.5%,15m
9503,3,TurtleTobi,2543,93,4,6,10,40.0%,3m
9503,2,Tatthwa,2543,0,3,5,8,37.5%,1h
9503,3,[ESOT]TiMaN,2543,58,2,1,3,66.7%,15m
9503,1,Akama,2543,118,2,3,5,40.0%,34m
9503,2,[GK27]DarkSoul,2543,0,1,0,1,100.0%,1h
9503,2,КРАБ,2543,30,1,4,5,20.0%,39m
9503,1,[JaPP]JoKeR,2543,0,0,1,1,0.0%,30m
9515,3,[HNTK]Kallewirsch,2542,1554,140,149,289,48.4%,4m
9515,2,Thanatos,2542,690,31,26,57,54.4%,39m
9515,3,[Wúlfpk]Apex,2542,0,2,3,5,40.0%,23m
9515,2,Cosya,2542,0,2,4,6,33.3%,7m
9515,2,[BKEG]Personanon,2542,0,1,0,1,100.0%,22m
9515,3,TeRRRaN,2542,30,1,2,3,33.3%,1h
9521,1,[44139]Vexator,2541,1595,86,95,181,47.5%,1h
9521,3,zannall,2541,1177,67,71,138,48.6%,1h
9521,2,BartMan,2541,557,24,15,39,61.5%,6m
9521,3,Pamnek,2541,408,15,14,29,51.7%,1h
9521,3,[HFR]Redeyed,2541,350,15,21,36,41.7%,30m
9521,3,Lßaz,2541,228,10,12,22,45.5%,29m
9521,2,[DizC]MentatYasha,2541,156,9,8,17,52.9%,5m
9521,2,kastamer,2541,180,7,8,15,46.7%,1h
9521,3,[nr40]gracken,2541,138,4,0,4,100.0%,17m
9521,3,FEBREZE,2541,0,1,0,1,100.0%,10m
9531,3,Roarshark,2540,1567,242,239,481,50.3%,5m
9531,2,SDSting,2540,1445,78,73,151,51.7%,17m
9531,1,Starwarrior,2540,1083,71,75,146,48.6%,25m
9531,2,Freeman,2540,1311,54,45,99,54.5%,1h
9531,2,[BigRat]qZilot,2540,571,27,10,37,73.0%,1m
9531,3,[PaF]Eppo,2540,256,18,11,29,62.1%,33m
9531,3,Everlord,2540,244,9,10,19,47.4%,1h
9531,3,Riel,2540,165,4,6,10,40.0%,22m
9531,3,[HZeS]nicci,2540,0,2,3,5,40.0%,4m
9540,1,ATB,2539,1512,243,238,481,50.5%,28m
9540,2,mamba,2539,916,38,36,74,51.4%,1h
9540,1,Neks,2539,552,18,25,43,41.9%,17m
9540,1,AmPotate,2539,286,10,5,15,66.7%,16m
9540,1,СТРЭЙК,2539,116,5,3,8,62.5%,17m
9540,3,Copperhead,2539,0,2,3,5,40.0%,41m
9540,3,Whistler,2539,0,1,1,2,50.0%,15m
9540,3,seth,2539,0,1,1,2,50.0%,2m
9548,1,[CSJCSJ]skoddet,2538,1535,161,160,321,50.2%,1h
9548,3,Bolshevist,2538,842,29,44,73,39.7%,19m
9548,2,Mihai,2538,347,13,9,22,59.1%,7m
9548,2,Леденец,2538,195,8,8,16,50.0%,1h
9548,2,bietschi,2538,178,6,9,15,40.0%,31m
9548,2,AKM,2538,88,2,2,4,50.0%,6m
9548,2,Bobby,2538,0,2,3,5,40.0%,14m
9555,2,Rexortom,2537,644,24,22,46,52.2%,6m
9555,1,Rieutheu,2537,608,23,23,46,50.0%,1h
9555,3,FasBenDeR,2537,404,16,8,24,66.7%,19m
9555,1,izzonu,2537,0,2,3,5,40.0%,3m
9555,1,botyara,2537,0,2,3,5,40.0%,33m
9555,1,Harhama,2537,48,2,4,6,33.3%,15m
9555,2,FireKaton,2537,0,0,3,3,0.0%,15m
9555,2,Macco,2537,0,0,5,5,0.0%,7m
9563,2,[Woomy]mrgeneral,2536,0,2,4,6,33.3%,14m
9563,2,MRX,2536,0,1,1,2,50.0%,33m
9563,3,Angriff,2536,0,1,4,5,20.0%,39m
9563,3,nol,2536,0,0,1,1,0.0%,1m
9563,1,Evandre,2536,0,0,2,2,0.0%,1h
9568,2,GOTOHELL,2535,238,22,24,46,47.8%,1h
9568,2,VasaZaicev,2535,542,19,26,45,42.2%,1h
9568,3,valhalla,2535,338,13,10,23,56.5%,26m
9568,1,mseven,2535,316,9,14,23,39.1%,7m
9568,2,ZopAgent,2535,277,8,11,19,42.1%,1h
9568,1,Glenelg,2535,229,7,9,16,43.8%,21m
9568,3,ReGaLo,2535,121,3,1,4,75.0%,31m
9568,2,[FYBF]ASAP,2535,60,3,4,7,42.9%,1h
9568,3,Zorry,2535,133,3,5,8,37.5%,37m
9568,1,[VdpV]PloKoon,2535,0,2,3,5,40.0%,12m
9568,3,Musashi,2535,0,2,4,6,33.3%,1h
9568,3,Sideswipe,2535,0,1,0,1,100.0%,8m
9568,1,Студент,2535,0,1,0,1,100.0%,1h
9568,3,[servus]FruitPunsh,2535,0,0,1,1,0.0%,31m
9568,3,Lucian,2535,0,0,1,1,0.0%,18m
9568,2,DonPampa,2535,0,0,3,3,0.0%,13m
9584,1,DunkelZwei,2534,1622,126,129,255,49.4%,9m
9584,2,Criminal,2534,916,38,36,74,51.4%,38m
9584,2,SmoothOperat,2534,446,14,17,31,45.2%,7m
9584,3,Chris,2534,76,4,7,11,36.4%,37m
9588,2,[JaPP]Notorious,2533,1302,66,60,126,52.4%,14m
9588,3,TERMG,2533,1090,66,63,129,51.2%,1h
9588,2,James,2533,686,62,39,101,61.4%,24m
9588,1,[BURIZA]AlexKoks,2533,936,45,42,87,51.7%,21m
9588,1,eazzymdfc,2533,652,26,27,53,49.1%,24m
9588,3,[love2D]Light,2533,202,21,25,46,45.7%,4m
9588,2,WizzleLi,2533,352,14,9,23,60.9%,39m
9588,2,[TGWN]Python,2533,272,12,11,23,52.2%,1h
9588,3,TiiviTaavi,2533,241,9,1,10,90.0%,2m
9588,3,Leckatall,2533,196,7,4,11,63.6%,1h
9588,3,gizgil,2533,74,3,3,6,50.0%,18m
9588,3,Tripleninja,2533,60,2,2,4,50.0%,18m
9588,1,Cyanocitta,2533,0,2,6,8,25.0%,1h
9588,3,Sfay,2533,0,0,1,1,0.0%,1h
9588,3,Crowley,2533,0,0,1,1,0.0%,22m
9603,2,NoEffort,2532,545,25,26,51,49.0%,1h
9603,2,CaptainLippy,2532,399,17,11,28,60.7%,37m
9603,2,PlanckTime,2532,89,12,12,24,50.0%,1h
9603,2,Ryan,2532,192,8,10,18,44.4%,35m
9603,3,MrTom,2532,122,4,6,10,40.0%,38m
9603,3,StarSchwarf,2532,0,0,1,1,0.0%,25m
9603,3,[Aorus]IIStrongerII,2532,0,0,1,1,0.0%,20m
9610,2,Maximus,2531,1405,90,85,175,51.4%,7m
9610,1,[lapipa]MrFurioso,2531,693,23,28,51,45.1%,21m
9610,3,[AAWW]Txustice,2531,484,19,8,27,70.4%,18m
9610,2,[Skaro]LuLu,2531,361,16,6,22,72.7%,4m
9610,3,[842703]Jacek,2531,0,4,0,4,100.0%,32m
9610,3,[hvfjk]LuCAKInGGTX,2531,0,2,4,6,33.3%,28m
9610,2,CoronaVirus,2531,114,2,8,10,20.0%,13m
9617,1,aki,2530,468,16,23,39,41.0%,1h
9617,2,krapp,2530,289,10,11,21,47.6%,39m
9617,3,Axefighter,2530,0,4,1,5,80.0%,5m
9617,3,ARYEN,2530,60,2,4,6,33.3%,1h
9617,3,Коматозник,2530,0,2,4,6,33.3%,17m
9617,3,ToinToin,2530,30,1,1,2,50.0%,1h
9617,1,Computer,2530,0,0,4,4,0.0%,1h
9624,2,Dyb,2529,544,21,21,42,50.0%,1h
9624,2,LoneSurvivor,2529,408,20,21,41,48.8%,39m
9624,2,Noob,2529,565,19,26,45,42.2%,1h
9624,2,Alex,2529,427,16,14,30,53.3%,27m
9624,3,[GBSO]Brute,2529,58,3,2,5,60.0%,1h
9624,3,[CREPES]Guideuz,2529,112,3,2,5,60.0%,16m
9624,1,dangernk,2529,0,1,0,1,100.0%,12m
9624,3,Amnesiac,2529,0,0,1,1,0.0%,1h
9624,2,[dgmj]Jpea,2529,0,0,2,2,0.0%,39m
9633,1,Marous,2528,1547,235,243,478,49.2%,40m
9633,1,[DTINC]MythicalDuck,2528,1233,63,68,131,48.1%,21m
9633,2,Lucky,2528,819,45,33,78,57.7%,1h
9633,2,NomadRusso,2528,208,36,35,71,50.7%,30m
9633,3,Fantomstrike,2528,613,24,21,45,53.3%,26m
9633,1,mou,2528,331,10,9,19,52.6%,1h
9633,3,[xNSax]Noire,2528,122,5,4,9,55.6%,1h
9633,2,HansJohannes,2528,42,4,7,11,36.4%,6m
9633,1,[wedown]Pollo,2528,0,3,2,5,60.0%,17m
9633,1,[IFAI]NAkamA,2528,74,2,10,12,16.7%,21m
9643,3,flash,2527,794,29,24,53,54.7%,22m
9643,3,[PLA2N]Menorik,2527,0,2,3,5,40.0%,1h
9643,3,[TENRIX]Innocence,2527,0,1,0,1,100.0%,12m
9643,3,zeot,2527,0,0,5,5,0.0%,6m
9647,2,[помним]Gruppenfürer,2526,60,4,6,10,40.0%,1h
9647,2,[DoAII]Soulrazy,2526,140,4,7,11,36.4%,14m
9647,2,HenryThree,2526,0,3,3,6,50.0%,13m
9647,3,Luna,2526,0,2,3,5,40.0%,22m
9647,1,[DNOser]GeteRo,2526,46,1,7,8,12.5%,32m
9647,3,Renn,2526,0,0,1,1,0.0%,10m
9647,1,Aisuviz,2526,0,0,3,3,0.0%,38m
9654,2,[GGWin]RobSnydeR,2525,798,29,30,59,49.2%,1h
9654,3,Yooda,2525,540,21,25,46,45.7%,13m
9654,3,Esuges,2525,516,18,17,35,51.4%,25m
9654,3,Zardoz,2525,202,8,6,14,57.1%,1h
9654,1,Skull,2525,170,6,7,13,46.2%,27m
9654,3,voltab,2525,88,4,1,5,80.0%,38m
9654,3,[45silm]KingCZE,2525,0,1,2,3,33.3%,23m
9654,3,BlackEdition,2525,0,1,4,5,20.0%,1h
9654,3,crall,2525,0,0,1,1,0.0%,1h
9654,2,Frost,2525,0,0,5,5,0.0%,13m
9664,2,Розенпук,2524,30,3,5,8,37.5%,33m
9664,3,[TeUn]Kai,2524,0,2,3,5,40.0%,1h
9664,3,IgorNick,2524,0,2,4,6,33.3%,1h
9664,3,karasik,2524,0,2,5,7,28.6%,12m
9664,1,Martishow,2524,36,1,10,11,9.1%,12m
9664,3,Radioghost,2524,0,0,1,1,0.0%,1h
9670,2,Кирилл,2523,318,32,33,65,49.2%,30m
9670,1,AlexPUA,2523,664,26,26,52,50.0%,1h
9670,2,[Nagplz]JellyBear,2523,569,23,16,39,59.0%,1h
9670,3,Jonrock,2523,97,5,3,8,62.5%,32m
9670,2,Arktischer,2523,211,5,8,13,38.5%,1h
9670,3,miles,2523,142,4,5,9,44.4%,1h
9670,1,Karl,2523,89,3,6,9,33.3%,33m
9670,2,Chainsoflawl,2523,0,0,3,3,0.0%,34m
9670,2,[НС]Надзиратель,2523,0,0,4,4,0.0%,33m
9679,3,Thechief,2522,614,28,39,67,41.8%,6m
9679,3,BogvABW,2522,353,14,2,16,87.5%,15m
9679,2,speedUp,2522,248,9,11,20,45.0%,1h
9679,3,Caspor,2522,121,5,3,8,62.5%,3m
9679,2,SerKar,2522,136,5,6,11,45.5%,1h
9679,2,Iwan,2522,134,4,8,12,33.3%,1h
9679,3,Nigg,2522,0,1,0,1,100.0%,40m
9679,3,Chaosu,2522,0,1,3,4,25.0%,37m
9679,2,kirk,2522,30,1,5,6,16.7%,13m
9679,3,Vag,2522,0,0,1,1,0.0%,1h
9689,1,shador,2521,1461,115,104,219,52.5%,37m
9689,2,Серега,2521,236,8,12,20,40.0%,1h
9689,2,tehpwnrer,2521,122,6,14,20,30.0%,14m
9689,2,incognizable,2521,110,4,9,13,30.8%,1h
9689,2,KOMBINER,2521,30,2,3,5,40.0%,17m
9689,3,[CLMOB]Archijevny,2521,121,2,7,9,22.2%,21m
9695,3,Hoschi,2520,314,12,8,20,60.0%,10m
9695,3,CooL,2520,172,6,5,11,54.5%,20m
9695,3,StrafeMasta,2520,0,3,2,5,60.0%,1h
9695,1,ADHD,2520,121,2,3,5,40.0%,3m
9695,3,[QLSS]DevoltN,2520,0,1,0,1,100.0%,1h
9700,2,lukibalboą,2519,576,27,13,40,67.5%,1h
9700,3,Heretic,2519,314,12,12,24,50.0%,12m
9700,3,KstaN,2519,148,5,5,10,50.0%,14m
9700,3,[BWArmy]GABY,2519,122,3,3,6,50.0%,8m
9700,2,[nXh]iMarine,2519,92,3,13,16,18.8%,14m
9700,2,blademaster,2519,30,2,3,5,40.0%,14m
9700,1,[SUDA]Alim,2519,0,2,3,5,40.0%,15m
9700,3,Septra,2519,0,1,0,1,100.0%,30m
9700,2,[VL0rds]FourAces,2519,30,1,9,10,10.0%,16m
9700,1,TEZCATLIPOCA,2519,0,0,1,1,0.0%,15m
9700,3,Fulgur,2519,0,0,1,1,0.0%,2m
9711,2,Kronos,2518,1463,214,216,430,49.8%,7m
9711,2,CountVitola,2518,216,10,10,20,50.0%,5m
9711,2,baraNeo,2518,244,8,9,17,47.1%,1h
9711,3,Discover,2518,0,4,2,6,66.7%,1h
9711,2,Random,2518,126,4,7,11,36.4%,38m
9711,3,ShasDk,2518,97,3,5,8,37.5%,38m
9711,2,KingMike,2518,62,3,6,9,33.3%,13m
9711,1,[Nudist]FlayedOne,2518,46,2,0,2,100.0%,23m
9711,1,volc,2518,0,2,3,5,40.0%,10m
9711,2,WickedWasp,2518,0,1,0,1,100.0%,35m
9721,3,Terrano,2517,1572,82,68,150,54.7%,17m
9721,1,Vezérelv,2517,1580,77,83,160,48.1%,1h
9721,2,МудрыйМонах,2517,955,36,40,76,47.4%,16m
9721,3,Han,2517,592,23,20,43,53.5%,38m
9721,3,бухряк,2517,337,12,14,26,46.2%,22m
9721,3,Menes,2517,300,9,19,28,32.1%,3m
9721,3,walleout,2517,132,3,2,5,60.0%,10m
9721,3,mknyaz,2517,97,2,2,4,50.0%,3m
9721,2,Humanity,2517,58,2,5,7,28.6%,2m
9721,1,Scarecrow,2517,0,1,1,2,50.0%,1h
9721,3,Calimor,2517,30,1,3,4,25.0%,13m
9721,3,Dawn,2517,0,0,2,2,0.0%,36m
9733,1,NoFo,2516,1604,266,259,525,50.7%,24m
9733,2,NoFate,2516,460,21,20,41,51.2%,1h
9733,3,[TYPE01]ORiON,2516,266,13,10,23,56.5%,15m
9733,1,Digitallogos,2516,355,11,18,29,37.9%,31m
9733,3,[ImbaTm]Tiamat,2516,237,8,1,9,88.9%,20m
9733,2,SusukiVse,2516,76,5,7,12,41.7%,1h
9733,3,NaNo,2516,145,3,5,8,37.5%,31m
9733,3,TTstasTT,2516,30,2,1,3,66.7%,1h
9733,1,vladrus,2516,0,0,1,1,0.0%,25m
9733,2,tenubre,2516,0,0,3,3,0.0%,16m
9743,2,[Thunde]Thor,2515,1587,63,63,126,50.0%,13m
9743,2,Konstantin,2515,643,58,61,119,48.7%,1h
9743,3,Scalzofedda,2515,730,25,34,59,42.4%,13m
9743,2,fatfa,2515,144,6,5,11,54.5%,1h
9743,3,toineduke,2515,116,4,5,9,44.4%,1h
9743,3,Corocotas,2515,30,3,1,4,75.0%,1h
9743,1,NarThalos,2515,97,2,4,6,33.3%,1h
9743,3,KridgiGames,2515,0,0,2,2,0.0%,1h
9751,2,Altermann,2514,1370,74,67,141,52.5%,30m
9751,2,Badger,2514,524,27,26,53,50.9%,13m
9751,2,Chivas,2514,524,22,27,49,44.9%,1h
9751,2,tnqordjr,2514,0,2,4,6,33.3%,1h
9751,2,Paganwitch,2514,60,2,7,9,22.2%,17m
9751,2,[Dedeki]ooSEVEN,2514,62,2,8,10,20.0%,14m
9751,3,Thnks,2514,30,1,2,3,33.3%,8m
9751,3,Alex,2514,0,0,1,1,0.0%,33m
9751,3,Agrozel,2514,0,0,1,1,0.0%,14m
9751,1,[EZKBM]HeavensWolf,2514,0,0,2,2,0.0%,1h
9751,3,TimEY,2514,0,0,3,3,0.0%,41m
9762,3,Catherine,2513,1418,65,53,118,55.1%,27m
9762,3,Órói,2513,502,18,18,36,50.0%,39m
9762,2,[PXLD]Tronzi,2513,450,15,17,32,46.9%,1h
9762,2,[NLTN]Rożek,2513,204,8,12,20,40.0%,6m
9762,3,KeepITcool,2513,191,7,7,14,50.0%,32m
9762,3,[AQR]AQRpogpog,2513,30,2,3,5,40.0%,33m
9762,2,[VCa]SabbatielL,2513,0,0,2,2,0.0%,19m
9769,3,OpTiixVik,2512,352,13,15,28,46.4%,22m
9769,3,[aNNa]JeanneOscour,2512,228,8,7,15,53.3%,1h
9769,3,WeirdOne,2512,177,5,7,12,41.7%,17m
9769,3,СосоКурва,2512,0,4,3,7,57.1%,17m
9769,1,Slepoy,2512,76,4,8,12,33.3%,37m
9769,3,Griffin,2512,30,1,2,3,33.3%,1h
9775,1,namsoft,2511,1601,214,216,430,49.8%,3m
9775,3,johnakis,2511,295,13,13,26,50.0%,13m
9775,2,Misael,2511,0,1,0,1,100.0%,23m
9775,3,[RuNOOB]FLAUBER,2511,0,0,1,1,0.0%,1h
9779,3,Noodles,2510,317,11,7,18,61.1%,20m
9779,3,[APV]Neketron,2510,338,11,12,23,47.8%,8m
9779,2,[P0W3RD]Adolphus,2510,296,10,14,24,41.7%,1h
9779,3,Rick,2510,221,8,5,13,61.5%,25m
9779,2,Belltrocity,2510,30,3,5,8,37.5%,13m
9779,3,MutAnte,2510,30,2,1,3,66.7%,23m
9779,2,minatokai,2510,88,2,3,5,40.0%,1h
9786,1,MEGaboss,2509,1606,133,133,266,50.0%,32m
9786,1,Fryak,2509,1392,121,112,233,51.9%,1h
9786,2,pampadores,2509,1567,93,87,180,51.7%,39m
9786,2,elga,2509,652,31,22,53,58.5%,14m
9786,2,spinogryz,2509,406,16,18,34,47.1%,35m
9786,2,MissingLink,2509,384,15,16,31,48.4%,1h
9786,3,[Oupss]Padawan,2509,235,11,13,24,45.8%,37m
9786,1,yeti,2509,284,8,22,30,26.7%,35m
9786,3,Starvmarvin,2509,233,7,3,10,70.0%,41m
9786,3,ProFide,2509,236,6,9,15,40.0%,10m
9786,3,Turdinson,2509,0,2,3,5,40.0%,12m
9786,3,[Щитон]Керриган,2509,95,1,2,3,33.3%,36m
9786,1,Prashtyuc,2509,0,1,3,4,25.0%,8m
9799,2,KingSashka,2508,500,48,36,84,57.1%,1h
9799,1,[xFSRx]Erich,2508,199,8,8,16,50.0%,1h
9799,2,Chris,2508,128,5,8,13,38.5%,9m
9799,3,Snorxl,2508,58,2,3,5,40.0%,1h
9799,1,Hexag,2508,0,1,0,1,100.0%,21m
9799,1,Myn,2508,0,0,5,5,0.0%,10m
9805,2,Shaman,2507,1537,59,59,118,50.0%,1h
9805,3,[R4Time]KinGCOCkROaC,2507,764,49,36,85,57.6%,4m
9805,3,Zenit,2507,369,15,3,18,83.3%,1h
9805,2,Nikolas,2507,305,11,11,22,50.0%,7m
9805,1,Triflest,2507,145,3,3,6,50.0%,18m
9805,3,ady,2507,30,2,1,3,66.7%,36m
9805,3,MassiveFred,2507,60,2,3,5,40.0%,1h
9812,2,[r32]Борщевик,2506,712,27,23,50,54.0%,1h
9812,3,Larrel,2506,372,15,16,31,48.4%,4m
9812,3,Zwofel,2506,272,10,10,20,50.0%,36m
9812,3,VladIsLove,2506,192,6,4,10,60.0%,15m
9812,3,Astat,2506,88,3,2,5,60.0%,33m
9812,3,Crall,2506,0,2,5,7,28.6%,1h
9812,3,WooDLee,2506,0,0,1,1,0.0%,39m
9812,2,IIIIIIIIIIII,2506,0,0,3,3,0.0%,16m
9820,2,MyNameIsNot,2505,807,69,63,132,52.3%,1h
9820,3,Pierre,2505,1098,52,54,106,49.1%,1h
9820,2,Kremenko,2505,325,11,11,22,50.0%,2m
9820,2,TorontoTill,2505,232,8,10,18,44.4%,34m
9820,3,BoxAndOne,2505,30,5,8,13,38.5%,15m
9820,2,[NoPa]niceone,2505,135,4,9,13,30.8%,39m
9820,1,Brattmosh,2505,0,3,2,5,60.0%,10m
9820,3,[шаурм]нотище,2505,0,3,2,5,60.0%,35m
9820,3,Satz,2505,0,1,2,3,33.3%,26m
9820,2,IIIIIIIIII,2505,30,1,3,4,25.0%,35m
9830,2,Espiritu,2504,1568,87,85,172,50.6%,1h
9830,2,CuiCui,2504,1218,60,53,113,53.1%,12m
9830,1,[MkerIT]Barbaro,2504,947,34,43,77,44.2%,31m
9830,3,Light,2504,172,7,5,12,58.3%,1h
9830,3,Erase,2504,217,6,9,15,40.0%,1h
9830,3,trashmaster,2504,58,3,6,9,33.3%,26m
9830,3,CoaxyuM,2504,118,2,1,3,66.7%,17m
9830,2,DrForex,2504,0,1,5,6,16.7%,14m
9830,2,Blackfear,2504,30,1,10,11,9.1%,33m
9830,3,Sokolof,2504,0,0,1,1,0.0%,16m
9840,2,boss,2503,1574,127,121,248,51.2%,31m
9840,3,CarryMaster,2503,645,53,44,97,54.6%,21m
9840,2,Anup,2503,44,2,2,4,50.0%,1h
9840,1,deathNote,2503,0,2,3,5,40.0%,3m
9840,3,Lichking,2503,38,1,9,10,10.0%,1h
9845,3,JanSolo,2502,619,27,11,38,71.1%,1h
9845,1,Maisie,2502,181,10,13,23,43.5%,12m
9845,3,Jules,2502,199,6,7,13,46.2%,1h
9845,3,[FkDyMw]Neil,2502,146,4,7,11,36.4%,12m
9845,1,AliseMadness,2502,0,3,2,5,60.0%,1h
9845,2,XtremeDeath,2502,0,3,3,6,50.0%,23m
9845,2,PértinaxIII,2502,30,3,5,8,37.5%,38m
9845,3,[FrcLn]SzobiPetya,2502,30,2,2,4,50.0%,10m
9845,2,DirtyToss,2502,0,2,4,6,33.3%,38m
9845,2,JMRP,2502,30,1,5,6,16.7%,1h
9855,3,Spiritoftime,2501,1050,41,36,77,53.2%,27m
9855,1,LyrikM,2501,562,24,24,48,50.0%,1h
9855,3,Skipper,2501,517,17,19,36,47.2%,1h
9855,2,[aYs]HPIƤeachboy,2501,389,15,20,35,42.9%,1h
9855,3,[Aie]MASTER,2501,312,11,6,17,64.7%,3m
9855,3,Pechenьka,2501,184,5,7,12,41.7%,9m
9855,3,Dezz,2501,94,1,4,5,20.0%,17m
9862,3,boldxhead,2500,1196,61,66,127,48.0%,17m
9862,3,[RIZY]ЗлойПингвин,2500,261,9,6,15,60.0%,29m
9862,3,[TPAXEP]Avid,2500,164,6,3,9,66.7%,11m
9862,3,bratwurst,2500,99,5,2,7,71.4%,11m
9862,1,barkley,2500,145,4,5,9,44.4%,27m
9862,3,xNinjaFish,2500,30,1,1,2,50.0%,1h
9868,1,Alka,2499,0,3,2,5,60.0%,21m
9869,1,Bajula,2498,616,51,58,109,46.8%,1h
9869,3,[PIML]ChuckPoriss,2498,988,37,35,72,51.4%,1h
9869,3,[NBaft]Flamdragos,2498,503,18,14,32,56.2%,25m
9869,1,rabosot,2498,170,7,11,18,38.9%,20m
9869,3,[Destab]Sprinter,2498,157,5,1,6,83.3%,9m
9869,3,Iga,2498,62,3,4,7,42.9%,2m
9869,3,Sovic,2498,0,2,3,5,40.0%,35m
9869,2,LLMutation,2498,44,1,5,6,16.7%,1h
9869,1,[EWEN]youtube,2498,0,0,4,4,0.0%,5m
9878,1,Daniel,2497,1382,186,199,385,48.3%,6m
9878,3,Rocu,2497,1208,114,105,219,52.1%,25m
9878,3,[eRZGEb]CommanderFun,2497,917,35,29,64,54.7%,1h
9878,2,[Z3B]lucyfer,2497,674,26,34,60,43.3%,12m
9878,3,veleye,2497,174,7,4,11,63.6%,39m
9878,2,Etircopyh,2497,218,7,10,17,41.2%,1h
9878,3,VoodooDolls,2497,95,4,2,6,66.7%,5m
9885,1,Soldjah,2496,445,15,20,35,42.9%,1h
9885,2,Marduk,2496,230,8,14,22,36.4%,1h
9885,1,[CMGB]ßÅrT,2496,100,4,3,7,57.1%,21m
9885,3,Daniel,2496,58,4,5,9,44.4%,13m
9885,1,[DOGI]Menax,2496,46,4,9,13,30.8%,20m
9885,2,Mateo,2496,0,3,3,6,50.0%,30m
9885,2,Flums,2496,30,2,4,6,33.3%,28m
9885,3,[4N00b]Broli,2496,0,0,1,1,0.0%,17m
9893,1,Jack,2495,1604,266,266,532,50.0%,2m
9893,1,[BND]Gnollface,2495,1114,38,53,91,41.8%,17m
9893,2,Silhouette,2495,463,20,23,43,46.5%,38m
9893,2,guimelo,2495,306,14,16,30,46.7%,1h
9893,2,[Xzé]Deorman,2495,275,9,11,20,45.0%,3m
9893,2,JleLmeshek,2495,168,7,9,16,43.8%,34m
9893,3,Lait,2495,58,2,2,4,50.0%,32m
9893,3,CubeTrist,2495,0,2,5,7,28.6%,1h
9893,3,KDAshnik,2495,0,0,2,2,0.0%,1h
9902,1,BronzeMaster,2494,510,18,26,44,40.9%,1h
9902,3,Turan,2494,97,2,1,3,66.7%,11m
9902,3,Loung,2494,0,2,3,5,40.0%,15m
9902,3,AngelFace,2494,0,1,4,5,20.0%,20m
9906,1,Arzh,2493,498,16,24,40,40.0%,1h
9906,1,Spiridon,2493,96,5,3,8,62.5%,8m
9906,2,simtel,2493,30,5,4,9,55.6%,1h
9906,1,SYBSYBSYB,2493,0,3,3,6,50.0%,1h
9910,2,Beubeu,2492,660,25,31,56,44.6%,1h
9910,3,rPj,2492,242,11,15,26,42.3%,11m
9910,1,Martini,2492,340,9,22,31,29.0%,17m
9910,3,QuickFox,2492,0,2,3,5,40.0%,35m
9910,3,kaboom,2492,0,0,1,1,0.0%,1h
9915,2,MAREKMYCROFT,2491,1335,94,92,186,50.5%,21m
9915,2,wml,2491,383,17,19,36,47.2%,1h
9915,1,Demetrio,2491,392,12,25,37,32.4%,34m
9915,3,zendelphi,2491,149,5,4,9,55.6%,40m
9915,1,kostja,2491,165,5,7,12,41.7%,4m
9915,3,[WWIS]WildShaman,2491,92,4,3,7,57.1%,12m
9915,2,syIko,2491,88,4,3,7,57.1%,29m
9915,1,WhiteYmka,2491,192,4,5,9,44.4%,25m
9915,3,[RBlood]ChenZen,2491,95,1,1,2,50.0%,1h
9915,2,[VädA]dAVaddA,2491,30,1,19,20,5.0%,7m
9925,1,token,2490,1593,125,129,254,49.2%,14m
9925,3,George,2490,1601,90,89,179,50.3%,20m
9925,3,Emergy,2490,708,55,45,100,55.0%,5m
9925,3,DesEsseintes,2490,0,4,4,8,50.0%,2m
9925,2,[NOLIF3]Micky,2490,58,3,6,9,33.3%,38m
9925,1,Chiller,2490,48,2,5,7,28.6%,17m
9925,2,SUNSHINE,2490,0,2,8,10,20.0%,32m
9925,3,[Taruv]DarkDevil,2490,0,0,2,2,0.0%,23m
9933,2,SleepyBoar,2489,862,136,125,261,52.1%,1h
9933,1,DiSneXia,2489,123,4,9,13,30.8%,28m
9933,3,Sonyson,2489,0,2,5,7,28.6%,31m
9933,3,[Svet]langalier,2489,0,1,6,7,14.3%,6m
9933,3,SSgtMcKnight,2489,0,0,3,3,0.0%,1h
9938,2,NFsan,2488,303,11,9,20,55.0%,9m
9938,3,Zeeki,2488,202,7,9,16,43.8%,16m
9938,1,SkewTheWise,2488,134,6,11,17,35.3%,11m
9938,1,Ganesha,2488,150,4,6,10,40.0%,41m
9938,3,[Crews]MrSkiller,2488,133,2,1,3,66.7%,1h
9938,1,[MaxLow]JahLove,2488,145,2,4,6,33.3%,17m
9938,3,Hit,2488,0,1,0,1,100.0%,40m
9938,2,ХЁН,2488,0,1,0,1,100.0%,35m
9946,2,[ßnDª]Kaptar,2487,878,33,38,71,46.5%,20m
9946,2,Chakakazull,2487,417,17,12,29,58.6%,38m
9946,2,RedMAK,2487,293,11,14,25,44.0%,30m
9946,3,llllllllllll,2487,166,4,1,5,80.0%,23m
9946,2,LoveLife,2487,88,2,3,5,40.0%,40m
9946,1,[demenn]Tim,2487,48,1,4,5,20.0%,23m
9946,1,[4Han]Smorgrel,2487,34,1,13,14,7.1%,1h
9946,3,PhoeniX,2487,0,0,4,4,0.0%,16m
9954,1,LUX,2486,1357,193,187,380,50.8%,1h
9954,1,Finjaeger,2486,639,132,138,270,48.9%,32m
9954,2,Maxlin,2486,594,69,67,136,50.7%,38m
9954,1,Decoy,2486,483,19,27,46,41.3%,25m
9954,3,[pedar]XiMiC,2486,177,6,7,13,46.2%,11m
9954,3,eql,2486,117,2,1,3,66.7%,39m
9954,3,KillerCZ,2486,30,1,2,3,33.3%,1h
9954,2,MiTiaY,2486,0,1,4,5,20.0%,25m
9954,3,[zyd]zzk,2486,0,0,1,1,0.0%,21m
9963,3,UEberMonster,2485,1201,46,43,89,51.7%,17m
9963,3,NaHell,2485,393,12,22,34,35.3%,11m
9963,3,ramirezzzzzz,2485,333,11,9,20,55.0%,1h
9963,3,jaguartordu,2485,167,5,5,10,50.0%,4m
9963,3,Zeratul,2485,176,5,7,12,41.7%,11m
9963,3,Besa,2485,60,3,1,4,75.0%,25m
9963,3,KoWBoY,2485,40,1,3,4,25.0%,1h
9963,3,Abzac,2485,0,0,1,1,0.0%,1h
9963,2,Eskurian,2485,0,0,3,3,0.0%,2m
9972,2,Shark,2484,388,13,19,32,40.6%,1h
9972,3,[OBT]Skud,2484,30,2,0,2,100.0%,5m
9974,1,vycas,2483,167,6,2,8,75.0%,1h
9974,1,Dody,2483,100,6,9,15,40.0%,27m
9974,3,Maxi,2483,0,3,2,5,60.0%,13m
9974,3,Hyperlighter,2483,119,3,2,5,60.0%,1h
9974,2,GlTRON,2483,30,2,2,4,50.0%,28m
9974,2,[беш]PalmDropov,2483,0,2,6,8,25.0%,36m
9974,1,UCG,2483,0,1,0,1,100.0%,24m
9981,1,Pascal,2482,1281,47,50,97,48.5%,7m
9981,1,kanTe,2482,456,42,50,92,45.7%,21m
9981,1,[TheDOH]MineralThief,2482,976,40,37,77,51.9%,1h
9981,2,komyna,2482,649,32,18,50,64.0%,33m
9981,3,[h0mos]BeBe,2482,561,22,17,39,56.4%,1h
9981,1,Zedized,2482,256,10,11,21,47.6%,34m
9981,3,Freakshot,2482,215,9,3,12,75.0%,1h
9981,3,KIR,2482,178,8,4,12,66.7%,1h
9981,3,corvonoturno,2482,220,7,5,12,58.3%,1h
9981,3,generalY,2482,159,5,6,11,45.5%,23m
9981,2,Andrey,2482,62,3,6,9,33.3%,31m
9981,1,IIIIIIIIIIII,2482,96,2,2,4,50.0%,38m
9981,3,[SC2T4K]Porcinerate,2482,0,0,2,2,0.0%,15m
9994,1,Zilast,2481,1456,70,68,138,50.7%,14m
9994,3,VasimSPB,2481,1069,46,40,86,53.5%,1h
9994,2,anakin,2481,505,28,26,54,51.9%,31m
9994,1,InSanguinum,2481,156,7,7,14,50.0%,34m
9994,1,TaoPaiPai,2481,96,3,6,9,33.3%,1h
9994,3,Banner,2481,60,2,3,5,40.0%,13m
9994,3,[ScanS]POSTmanIK,2481,30,1,4,5,20.0%,2m
9994,2,Ngasta,2481,0,0,1,1,0.0%,27m
9994,3,[тьма]multosss,2481,0,0,3,3,0.0%,16m
9994,1,deniolo,2481,0,0,3,3,0.0%,33m
9994,1,Luma,2481,0,0,5,5,0.0%,9m
9994,2,[Jdge]Hellkid,2481,0,0,7,7,0.0%,17m
10006,2,ColT,2480,1475,80,79,159,50.3%,7m
10006,3,Henke,2480,1194,70,65,135,51.9%,29m
10006,3,jake,2480,1268,48,51,99,48.5%,26m
10006,2,Diffractor,2480,498,47,52,99,47.5%,9m
10006,2,[lLiTl]Gibbon,2480,686,23,31,54,42.6%,1h
10006,2,Sarkany,2480,568,20,22,42,47.6%,1h
10006,1,Adora,2480,96,2,2,4,50.0%,1h
10006,3,hybride,2480,0,1,0,1,100.0%,1h
10006,3,LuckyShot,2480,0,1,1,2,50.0%,26m
10006,3,korigien,2480,0,0,1,1,0.0%,1h
10006,1,Max,2480,0,0,2,2,0.0%,1h
10017,3,Hellhound,2479,1600,181,173,354,51.1%,30m
10017,3,[NINJ88]bromqist,2479,654,26,21,47,55.3%,33m
10017,1,dave,2479,203,8,3,11,72.7%,17m
10017,3,LelloreX,2479,237,7,4,11,63.6%,1h
10017,3,Krelian,2479,30,2,1,3,66.7%,25m
10017,3,Alkado,2479,30,2,2,4,50.0%,39m
10017,3,[Фыр]OkamiSan,2479,0,0,1,1,0.0%,16m
10024,2,Broadhurst,2478,278,12,14,26,46.2%,1h
10024,3,tovarm,2478,164,7,4,11,63.6%,3m
10024,1,[BrCrft]LED,2478,223,4,11,15,26.7%,27m
10024,1,[Faith1]DrBanshee,2478,122,3,2,5,60.0%,16m
10024,2,[Актив]serega,2478,113,2,5,7,28.6%,1h
10024,3,Avalon,2478,0,0,1,1,0.0%,1h
10030,3,ViGiLaNT,2477,380,17,21,38,44.7%,10m
10030,3,Raxelslem,2477,449,16,19,35,45.7%,5m
10030,2,Shigeko,2477,278,9,14,23,39.1%,1h
10030,3,Haier,2477,176,8,8,16,50.0%,41m
10030,2,TODD,2477,203,7,4,11,63.6%,1h
10030,2,vIrUS,2477,140,5,12,17,29.4%,33m
10030,3,[Arrows]GOLDY,2477,97,3,5,8,37.5%,9m
10030,3,[NWGD]GranAdmiral,2477,30,2,1,3,66.7%,10m
10030,2,Tris,2477,0,2,4,6,33.3%,1h
10039,2,Axon,2476,1097,55,53,108,50.9%,1h
10039,3,Anonymous,2476,728,35,32,67,52.2%,12m
10039,3,IIIIIlllIII,2476,234,8,3,11,72.7%,26m
10039,3,CIRO,2476,0,3,2,5,60.0%,40m
10039,2,Chu,2476,178,3,6,9,33.3%,1h
10039,3,oleg,2476,135,3,7,10,30.0%,1h
10039,3,Lebedun,2476,0,1,0,1,100.0%,25m
10039,3,[DaFF]MOISTLING,2476,0,1,1,2,50.0%,1h
10039,2,Sanya,2476,40,1,1,2,50.0%,41m
10039,3,BicheRobot,2476,0,0,1,1,0.0%,1h
10049,3,Jaz,2475,1460,60,51,111,54.1%,20m
10049,2,Spiruline,2475,346,12,18,30,40.0%,18m
10049,3,Sirtomw,2475,86,5,5,10,50.0%,4m
10049,3,[tchü]sephiroth,2475,62,5,7,12,41.7%,34m
10049,3,przem,2475,0,4,1,5,80.0%,15m
10049,3,[ШиШаНы]BomBersem,2475,0,3,2,5,60.0%,17m
10049,3,dawa,2475,42,3,6,9,33.3%,38m
10049,3,Saveliy,2475,34,2,1,3,66.7%,27m
10049,3,[JGRU]Papamix,2475,0,1,0,1,100.0%,31m
10049,3,diyazgame,2475,0,1,1,2,50.0%,1h
10049,3,LeBreton,2475,30,1,1,2,50.0%,36m
10049,3,DeNNiS,2475,0,0,1,1,0.0%,18m
10061,2,[NecX]QuBit,2474,744,38,43,81,46.9%,12m
10061,2,Serafimzik,2474,510,18,23,41,43.9%,7m
10061,3,Fumin,2474,279,11,9,20,55.0%,23m
10061,3,zeezdk,2474,256,9,4,13,69.2%,13m
10061,3,DVonBraun,2474,0,2,5,7,28.6%,34m
10061,3,killhh,2474,0,2,6,8,25.0%,33m
10061,3,PantyDropper,2474,0,1,0,1,100.0%,29m
10061,2,Baxter,2474,0,0,2,2,0.0%,14m
10061,3,Alkator,2474,0,0,4,4,0.0%,3m
10070,2,pascalr,2473,1142,52,52,104,50.0%,37m
10070,3,artemkin,2473,432,17,22,39,43.6%,16m
10070,3,MZperX,2473,282,9,8,17,52.9%,21m
10070,1,Vapauden,2473,96,3,6,9,33.3%,1h
10074,2,Bloddyelbow,2472,1208,54,52,106,50.9%,1h
10074,2,Mineos,2472,892,45,42,87,51.7%,40m
10074,2,[IvS]SorroW,2472,823,34,34,68,50.0%,4m
10074,3,lepoupon,2472,402,33,22,55,60.0%,1h
10074,1,[KMLT]Ninbajem,2472,602,31,40,71,43.7%,1h
10074,3,Бывалый,2472,442,30,26,56,53.6%,5m
10074,3,BirzhanIM,2472,389,28,23,51,54.9%,1h
10074,2,Wojz,2472,534,19,22,41,46.3%,1h
10074,3,[ISRI]sol,2472,96,2,4,6,33.3%,27m
10074,3,FrostyFeet,2472,0,1,0,1,100.0%,1h
10074,3,ILD,2472,97,1,1,2,50.0%,18m
10074,3,dukenukem,2472,0,0,1,1,0.0%,1h
10086,1,tivoli,2471,638,29,28,57,50.9%,1h
10086,3,semamen,2471,432,15,15,30,50.0%,1h
10086,3,DenBercut,2471,280,11,14,25,44.0%,1h
10086,2,Albatrosul,2471,246,8,14,22,36.4%,22m
10086,2,Vasya,2471,88,4,7,11,36.4%,1h
10086,1,Yokoo,2471,0,2,2,4,50.0%,3m
10086,1,PrimeHunter,2471,97,2,4,6,33.3%,13m
10086,1,Sugarcult,2471,0,2,5,7,28.6%,41m
10086,1,[MARSS]Modejo,2471,0,2,6,8,25.0%,33m
10086,3,gigi,2471,89,1,1,2,50.0%,10m
10096,3,jump,2470,633,27,20,47,57.4%,18m
10096,3,Thunder,2470,282,9,10,19,47.4%,1h
10096,2,Knorri,2470,195,6,3,9,66.7%,26m
10096,1,Guile,2470,116,5,6,11,45.5%,11m
10096,3,Nemuray,2470,118,3,4,7,42.9%,32m
10096,3,[VBZ]Slade,2470,119,2,1,3,66.7%,27m
10096,1,KissShot,2470,0,1,4,5,20.0%,9m
10096,3,light,2470,0,0,3,3,0.0%,6m
10104,1,zitov,2469,1572,105,117,222,47.3%,1h
10104,3,llllIlllll,2469,1227,59,51,110,53.6%,1h
10104,3,aiur,2469,404,18,11,29,62.1%,28m
10104,3,Jwaren,2469,125,4,6,10,40.0%,1h
10104,3,TheMiddleone,2469,97,3,5,8,37.5%,41m
10104,3,[YOLOSK]BobBatzen,2469,30,2,0,2,100.0%,41m
10104,3,DrSceern,2469,0,1,1,2,50.0%,37m
10104,3,Renegade,2469,0,0,1,1,0.0%,1h
10112,1,[ALARM]urmomsalurka,2468,1554,107,79,186,57.5%,22m
10112,3,[AlienR]Macromaster,2468,766,28,30,58,48.3%,12m
10112,3,FeeL,2468,532,20,20,40,50.0%,22m
10112,3,[BaSpIn]DeusEx,2468,390,13,11,24,54.2%,23m
10112,3,poLi,2468,334,11,11,22,50.0%,27m
10112,1,Seledka,2468,0,2,4,6,33.3%,1h
10112,3,Scorn,2468,0,1,0,1,100.0%,19m
10112,2,Devillos,2468,0,0,1,1,0.0%,4m
10112,3,Varjaga,2468,0,0,1,1,0.0%,12m
10121,3,Zorg,2467,1295,56,52,108,51.9%,34m
10121,1,Debellum,2467,1085,55,53,108,50.9%,3m
10121,3,[RMM]SuperStein,2467,221,14,13,27,51.9%,5m
10121,3,oZF,2467,305,10,5,15,66.7%,36m
10121,2,Холодный,2467,203,7,10,17,41.2%,17m
10121,2,Nitora,2467,260,7,12,19,36.8%,5m
10121,2,Jade,2467,114,4,1,5,80.0%,1h
10121,3,Shef,2467,88,3,4,7,42.9%,1h
10121,3,noobtactics,2467,97,2,4,6,33.3%,37m
10121,3,tinyZerg,2467,30,1,6,7,14.3%,4m
10131,3,llllllllllll,2466,1002,169,162,331,51.1%,1h
10131,2,SgtMono,2466,686,26,25,51,51.0%,1h
10131,3,MrSalamandr,2466,504,21,12,33,63.6%,5m
10131,2,chippR,2466,458,17,20,37,45.9%,28m
10131,2,[PLSgdh]kik,2466,274,12,15,27,44.4%,1h
10131,3,KokadabRa,2466,176,5,5,10,50.0%,35m
10131,3,[SLGH]IIIIIIIIIIII,2466,90,3,7,10,30.0%,1h
10131,3,StarsCrapToo,2466,30,2,1,3,66.7%,31m
10131,2,WMB,2466,0,2,2,4,50.0%,35m
10131,3,[KAOTx]Django,2466,0,1,0,1,100.0%,1h
10131,3,Arsikul,2466,0,1,1,2,50.0%,1h
10142,2,Maanesyume,2465,1562,202,208,410,49.3%,1h
10142,2,Faltarn,2465,194,8,10,18,44.4%,1h
10142,3,[SAoN]nightknight,2465,128,5,5,10,50.0%,1h
10142,2,Yuri,2465,84,5,9,14,35.7%,37m
10142,3,Skald,2465,147,4,6,10,40.0%,10m
10142,1,Outkasst,2465,97,3,5,8,37.5%,12m
10142,3,Akinovitch,2465,0,1,0,1,100.0%,16m
10149,3,BiBa,2464,1588,212,211,423,50.1%,13m
10149,2,raid,2464,471,33,26,59,55.9%,16m
10149,2,[КПCC]анскилл,2464,170,6,5,11,54.5%,18m
10149,2,[213123]DejáVu,2464,147,5,6,11,45.5%,18m
10149,2,[Floren]ACR,2464,160,5,9,14,35.7%,20m
10149,1,ekim,2464,0,1,1,2,50.0%,5m
10155,2,RedheadBeast,2463,1524,60,59,119,50.4%,1h
10155,3,[VDN]Zorn,2463,518,32,29,61,52.5%,1h
10155,3,InOutLake,2463,638,26,23,49,53.1%,18m
10155,2,frayas,2463,448,16,24,40,40.0%,22m
10155,3,[SkBG]CATU,2463,92,3,6,9,33.3%,15m
10155,3,aquarius,2463,30,1,4,5,20.0%,41m
10161,3,Barik,2462,1575,94,93,187,50.3%,1h
10161,3,Scarecrow,2462,370,16,11,27,59.3%,1h
10161,2,Alfred,2462,446,15,21,36,41.7%,38m
10161,2,[Herz]GreenPeach,2462,182,6,9,15,40.0%,1h
10161,2,[7I0]Cheesus,2462,174,4,1,5,80.0%,1h
10166,3,[N1NJ4Z]Patilan,2461,820,35,33,68,51.5%,4m
10166,3,[Dobro]кром,2461,375,13,10,23,56.5%,15m
10166,3,[lZornG]DArthurD,2461,225,7,7,14,50.0%,12m
10166,3,[BWArmy]FreeMmrGiver,2461,117,2,1,3,66.7%,23m
10166,3,[blizou]darkAz,2461,62,2,5,7,28.6%,3m
10166,3,Ciciarampa,2461,0,1,0,1,100.0%,1h
10166,3,BlaSco,2461,0,1,3,4,25.0%,1h
10166,3,Nik,2461,0,0,4,4,0.0%,5m
10174,3,Quiqueg,2460,970,333,366,699,47.6%,4m
10174,3,Mały,2460,1566,81,80,161,50.3%,21m
10174,1,Vaal,2460,248,7,12,19,36.8%,1h
10174,2,Siix,2460,162,6,14,20,30.0%,21m
10174,3,[GURKI]Homunculus,2460,159,5,5,10,50.0%,38m
10174,3,NooboeD,2460,0,2,5,7,28.6%,34m
10174,3,zoOz,2460,30,1,1,2,50.0%,6m
10174,3,Occupant,2460,30,1,3,4,25.0%,1h
10182,3,[GGGLHF]noah,2459,940,38,31,69,55.1%,23m
10182,2,[JediK]Shagrath,2459,866,30,40,70,42.9%,1h
10182,3,avieor,2459,387,29,23,52,55.8%,15m
10182,3,StimMyRine,2459,166,14,10,24,58.3%,11m
10182,3,LuckyNoob,2459,284,12,1,13,92.3%,4m
10182,3,Wahn,2459,334,12,9,21,57.1%,32m
10182,3,hellei,2459,229,9,8,17,52.9%,20m
10182,3,XAXOL,2459,162,4,1,5,80.0%,1h
10182,2,Taiipz,2459,89,2,1,3,66.7%,32m
10182,1,Jekko,2459,121,2,1,3,66.7%,1h
10182,3,[r3ich]RichieHawtin,2459,0,1,2,3,33.3%,1h
10182,3,Vazec,2459,0,0,1,1,0.0%,41m
10194,3,vavl,2458,808,37,30,67,55.2%,41m
10194,3,[SEWP]STALKER,2458,546,22,24,46,47.8%,34m
10194,3,[oVeryy]AngryChikenZ,2458,383,17,22,39,43.6%,4m
10194,1,Alpachino,2458,119,4,7,11,36.4%,1h
10194,1,SwankyPants,2458,167,3,5,8,37.5%,13m
10194,3,Patan,2458,96,1,1,2,50.0%,1h
10200,3,disem,2457,1295,56,50,106,52.8%,3m
10200,3,Rogba,2457,1045,42,40,82,51.2%,27m
10200,3,[play45]IIIIIIIIIIII,2457,803,31,25,56,55.4%,13m
10200,3,Zangetas,2457,285,9,9,18,50.0%,1h
10200,3,Aggregator,2457,206,8,9,17,47.1%,41m
10200,3,KuramaTCSC,2457,218,6,5,11,54.5%,32m
10200,2,[FuFoFi]Renderman,2457,148,5,12,17,29.4%,1h
10200,3,[TFJR]SysShock,2457,137,4,6,10,40.0%,1h
10200,3,[NlGE]BobRoss,2457,0,3,2,5,60.0%,26m
10200,3,Dimo,2457,36,3,8,11,27.3%,34m
10210,1,[SPAINs]FeniX,2456,1558,74,76,150,49.3%,37m
10210,2,SirTuDaBlee,2456,187,9,8,17,52.9%,30m
10210,3,[TöVõ]IEQI,2456,0,3,2,5,60.0%,1h
10210,3,mrpink,2456,0,1,0,1,100.0%,12m
10214,3,Lucanakin,2455,771,57,45,102,55.9%,29m
10214,3,[Щитон]Solpik,2455,140,6,5,11,54.5%,20m
10214,3,[NeCriN]Shigi,2455,174,6,7,13,46.2%,1h
10214,3,[Radium]WarStep,2455,30,1,2,3,33.3%,1h
10214,3,lofstraker,2455,0,0,1,1,0.0%,40m
10219,3,IlIlIlIlIlIl,2454,1540,783,802,1585,49.4%,22m
10219,3,Jonny,2454,996,44,33,77,57.1%,32m
10219,3,PeeKaBQQ,2454,119,5,8,13,38.5%,14m
10219,3,[11121]JimmyJoe,2454,90,4,4,8,50.0%,36m
10219,3,JohnDoe,2454,90,3,5,8,37.5%,26m
10219,2,[HDNKBL]sebinger,2454,0,1,0,1,100.0%,36m
10219,1,Noxus,2454,0,1,4,5,20.0%,1h
10226,3,Stes,2453,306,14,15,29,48.3%,36m
10226,2,SoulAsS,2453,262,8,12,20,40.0%,32m
10226,3,FatlandFatty,2453,179,5,7,12,41.7%,1h
10226,3,[NiN]TryRaptor,2453,121,3,0,3,100.0%,6m
10226,2,WEEBARIUM,2453,0,2,3,5,40.0%,35m
10226,3,Loomp,2453,0,2,5,7,28.6%,34m
10226,3,Reg,2453,96,1,1,2,50.0%,1h
10226,1,[Ebloid]RivanHobb,2453,48,1,1,2,50.0%,11m
10226,1,Nero,2453,0,1,4,5,20.0%,25m
10226,3,[3ЕRGTV]unster,2453,0,0,2,2,0.0%,1h
10236,3,Fruchtfliege,2452,1359,113,117,230,49.1%,1h
10236,3,portoslemac,2452,983,75,54,129,58.1%,1h
10236,2,[123123]Jethro,2452,216,7,15,22,31.8%,36m
10236,3,Stone,2452,142,4,1,5,80.0%,1h
10236,3,[humo]Caraclonch,2452,42,2,3,5,40.0%,1h
10236,1,Babz,2452,97,2,4,6,33.3%,21m
10236,3,Dozer,2452,0,1,0,1,100.0%,1h
10236,1,Thore,2452,0,1,0,1,100.0%,1h
10236,3,diDarth,2452,30,1,5,6,16.7%,30m
10245,3,Bevardis,2451,481,18,14,32,56.2%,1h
10245,3,CreeperTNT,2451,266,8,9,17,47.1%,1h
10245,3,Prygames,2451,95,3,3,6,50.0%,5m
10248,3,[BUND]WorkerRash,2450,1476,57,57,114,50.0%,1h
10248,3,NashUA,2450,566,21,17,38,55.3%,33m
10248,2,[ExTr1m]pinkers,2450,479,18,27,45,40.0%,24m
10248,3,Khalil,2450,483,17,14,31,54.8%,20m
10248,3,Gaja,2450,300,11,21,32,34.4%,17m
10248,3,[TRVMP]dobispr,2450,262,8,7,15,53.3%,20m
10248,1,DyzerPak,2450,0,1,4,5,20.0%,24m
10248,1,IgorS,2450,0,1,4,5,20.0%,1h
10248,2,Jawker,2450,0,0,1,1,0.0%,1h
10257,3,Dexter,2449,1622,175,159,334,52.4%,15m
10257,3,[NBK]PAPPO,2449,1029,45,57,102,44.1%,4m
10257,3,MrPanda,2449,92,3,3,6,50.0%,10m
10257,3,Nicer,2449,0,0,1,1,0.0%,1h
10257,1,TomHariless,2449,0,0,1,1,0.0%,24m
10262,3,davegamer,2448,219,10,10,20,50.0%,16m
10262,2,Tavronch,2448,58,5,6,11,45.5%,1h
10262,3,[НОД17]foxgamer,2448,147,3,3,6,50.0%,1h
10262,3,Ballzdeep,2448,112,2,5,7,28.6%,23m
10262,1,Tumba,2448,97,1,5,6,16.7%,39m
10267,3,akela,2447,1081,53,50,103,51.5%,23m
10267,3,REALbestname,2447,757,45,35,80,56.2%,1h
10267,2,МосЛеро,2447,878,36,32,68,52.9%,15m
10267,3,Vadinoy,2447,753,28,23,51,54.9%,6m
10267,3,SiCKO,2447,110,3,4,7,42.9%,41m
10267,3,Nini,2447,0,1,4,5,20.0%,11m
10267,3,Wwin,2447,30,1,6,7,14.3%,10m
10267,3,[TRS1]SportTR,2447,0,0,1,1,0.0%,1h
10275,2,luk,2446,1598,95,99,194,49.0%,22m
10275,3,Ionus,2446,416,60,51,111,54.1%,5m
10275,3,[GdAT]sansego,2446,990,41,35,76,53.9%,1h
10275,3,[МуDТ]festSurPrize,2446,461,27,0,27,100.0%,40m
10275,1,NiBlis,2446,575,24,35,59,40.7%,31m
10275,2,Ritheu,2446,491,20,26,46,43.5%,1h
10275,3,CrAsHbOy,2446,279,12,15,27,44.4%,4m
10275,2,franksch,2446,0,3,8,11,27.3%,12m
10275,3,Kethamine,2446,0,1,0,1,100.0%,36m
10275,3,starkiller,2446,0,1,3,4,25.0%,9m
10285,3,[SuPi]BuaMan,2445,1294,47,49,96,49.0%,1h
10285,3,[Ptit]Балиас,2445,86,3,5,8,37.5%,40m
10285,3,xamillion,2445,117,2,2,4,50.0%,36m
10285,3,RastaMan,2445,0,2,5,7,28.6%,4m
10285,3,Shpanit,2445,0,0,2,2,0.0%,41m
10290,1,Zilaz,2444,1632,573,572,1145,50.0%,22m
10290,3,LaMaGrA,2444,887,46,46,92,50.0%,38m
10290,3,ZLOW,2444,559,19,22,41,46.3%,26m
10290,3,takerman,2444,265,9,8,17,52.9%,41m
10290,3,VinceFC,2444,264,9,14,23,39.1%,11m
10290,2,DrKepler,2444,145,3,6,9,33.3%,6m
10290,2,MooM,2444,88,1,4,5,20.0%,1h
10297,3,Adya,2443,877,133,123,256,52.0%,12m
10297,2,[FMBC]marsjo,2443,852,31,39,70,44.3%,1h
10297,3,bdfg,2443,614,27,27,54,50.0%,9m
10297,2,[ZLOBOZ]Impaler,2443,177,6,8,14,42.9%,23m
10297,3,florian,2443,191,6,9,15,40.0%,1h
10297,3,LePOULPE,2443,88,4,3,7,57.1%,17m
10297,3,CLAVDIVS,2443,60,3,5,8,37.5%,1h
10297,3,Denis,2443,30,2,1,3,66.7%,1h
10297,2,Namiro,2443,0,1,1,2,50.0%,19m
10306,3,WiseKaa,2442,1355,90,82,172,52.3%,32m
10306,3,[qip]БогМикро,2442,346,15,3,18,83.3%,30m
10306,3,[uCHAD]KolesławCh,2442,325,12,6,18,66.7%,26m
10306,2,BoJack,2442,247,9,12,21,42.9%,31m
10306,2,StarCrossed,2442,182,7,8,15,46.7%,1h
10306,3,[SB6020]ENTP,2442,208,7,11,18,38.9%,1h
10306,3,[Arenot]ГейБой,2442,30,3,2,5,60.0%,40m
10306,3,Koevoet,2442,88,3,4,7,42.9%,6m
10306,3,[SteeZ]Gribouts,2442,0,1,0,1,100.0%,21m
10315,2,[MNDLRN]FlameSoul,2441,1015,76,82,158,48.1%,16m
10315,3,Hatty,2441,1206,48,55,103,46.6%,5m
10315,3,[EsOst]Infinity,2441,378,43,36,79,54.4%,32m
10315,3,czesie,2441,185,9,10,19,47.4%,15m
10315,2,[clavak]Alexua,2441,30,4,3,7,57.1%,35m
10320,2,[buyu]NoCivilWar,2440,789,50,42,92,54.3%,28m
10320,2,RoachRush,2440,1102,45,39,84,53.6%,37m
10320,3,SystemSlayer,2440,326,14,12,26,53.8%,16m
10320,3,kpectohoceu,2440,344,13,10,23,56.5%,9m
10320,3,SoulReaper,2440,337,12,13,25,48.0%,36m
10320,1,Tom,2440,104,7,8,15,46.7%,20m
10320,3,KeFir,2440,118,4,5,9,44.4%,12m
10320,1,Somnorosu,2440,96,3,6,9,33.3%,17m
10320,3,SerJaws,2440,103,2,1,3,66.7%,1h
10320,3,TerRazit,2440,30,2,6,8,25.0%,5m
10320,1,Revoke,2440,0,1,4,5,20.0%,1h
10320,1,Rykomi,2440,0,0,1,1,0.0%,1h
10332,3,[HWN]Karêdhíumn,2439,1105,49,34,83,59.0%,27m
10332,3,artem,2439,868,40,31,71,56.3%,11m
10332,3,cawa,2439,599,24,19,43,55.8%,1h
10332,1,zakurega,2439,420,19,15,34,55.9%,37m
10332,1,DepNsk,2439,454,11,11,22,50.0%,6m
10332,3,DeusEx,2439,161,7,5,12,58.3%,1h
10332,3,jihadxdeath,2439,90,5,13,18,27.8%,12m
10332,3,inox,2439,30,3,5,8,37.5%,1h
10332,3,riddarn,2439,0,1,1,2,50.0%,36m
10332,1,Stachun,2439,0,0,1,1,0.0%,1h
10342,2,BBZ,2438,921,46,49,95,48.4%,1h
10342,2,FruitTastic,2438,130,7,9,16,43.8%,28m
10342,3,[burrit]dafvid,2438,184,7,12,19,36.8%,1h
10345,2,Mightyretard,2437,708,28,29,57,49.1%,33m
10345,3,Luru,2437,188,27,14,41,65.9%,32m
10345,1,[zhuds]Саня,2437,292,8,2,10,80.0%,1h
10345,1,mickel,2437,0,3,2,5,60.0%,17m
10349,3,Kraken,2436,1574,153,164,317,48.3%,7m
10349,3,darklink,2436,511,23,19,42,54.8%,26m
10349,3,diverstrateg,2436,0,3,3,6,50.0%,10m
10349,1,NighTy,2436,0,1,0,1,100.0%,8m
10349,1,[VLAD25]ЛордВлад,2436,0,0,1,1,0.0%,15m
10354,3,[WАSD]SimulacraTos,2435,353,13,9,22,59.1%,39m
10354,1,kil,2435,122,4,5,9,44.4%,33m
10354,1,MASSUKKAMURA,2435,140,3,5,8,37.5%,1h
10354,3,cfpa,2435,30,1,3,4,25.0%,15m
10354,1,maniac,2435,0,1,4,5,20.0%,5m
10354,1,psychedelic,2435,0,0,1,1,0.0%,1h
10360,1,HKGK,2434,1615,293,294,587,49.9%,30m
10360,3,Seboulba,2434,1502,55,77,132,41.7%,19m
10360,1,[13NRV]Nerf,2434,501,31,33,64,48.4%,41m
10360,3,ŻryjGruz,2434,491,19,14,33,57.6%,1h
10360,1,[xKillx]wikti,2434,298,10,15,25,40.0%,17m
10360,3,TossMaster,2434,169,4,9,13,30.8%,1h
10360,1,GeneralDrake,2434,48,2,4,6,33.3%,11m
10360,3,[zukaCo]benjamin,2434,34,2,7,9,22.2%,1h
10360,1,[Казах]Bomberman,2434,0,1,4,5,20.0%,1h
10360,1,Ralouf,2434,0,1,4,5,20.0%,16m
10360,3,Lifebtrippin,2434,0,1,5,6,16.7%,26m
10371,3,Dablo,2433,318,12,5,17,70.6%,3m
10371,1,Vlados,2433,394,10,10,20,50.0%,20m
10371,3,Exodus,2433,231,7,7,14,50.0%,41m
10371,1,[AC]BloodRaven,2433,114,3,6,9,33.3%,1h
10371,3,Kara,2433,0,1,2,3,33.3%,1h
10371,1,[gliOrc]OrcoSveglio,2433,0,0,1,1,0.0%,39m
10377,2,limfostar,2432,1565,102,94,196,52.0%,1h
10377,3,Elf,2432,575,24,20,44,54.5%,10m
10377,3,[GdAT]Disaster,2432,478,17,18,35,48.6%,26m
10377,1,DimaBorsch,2432,145,4,0,4,100.0%,9m
10377,2,Денис,2432,170,4,11,15,26.7%,1h
10377,1,ChillWars,2432,44,1,1,2,50.0%,12m
10377,1,Aqua,2432,0,1,3,4,25.0%,13m
10377,3,Garvug,2432,95,1,8,9,11.1%,1h
10385,2,[Seek]martin,2431,722,25,33,58,43.1%,1h
10385,1,XYZEN,2431,234,9,9,18,50.0%,39m
10385,3,Toxichof,2431,156,7,4,11,63.6%,17m
10385,3,STan,2431,121,2,1,3,66.7%,5m
10385,3,NiNeu,2431,97,2,5,7,28.6%,34m
10385,1,[Нога]Bash,2431,0,1,4,5,20.0%,1h
10391,3,[ЕМPIRE]MEFESTO,2430,610,22,17,39,56.4%,25m
10391,2,Hikana,2430,76,6,8,14,42.9%,40m
10391,2,EnDOrFIncHIC,2430,30,3,5,8,37.5%,15m
10391,1,RashidJAN,2430,0,0,1,1,0.0%,30m
10391,3,Adama,2430,0,0,2,2,0.0%,1h
10391,3,FtNScarra,2430,0,0,5,5,0.0%,38m
10397,3,WINTER,2429,360,20,22,42,47.6%,36m
10397,3,noob,2429,122,4,4,8,50.0%,17m
10397,3,Чех,2429,97,1,3,4,25.0%,1h
10397,3,LordorIgamer,2429,0,0,2,2,0.0%,26m
10401,2,zatZ,2427,776,28,34,62,45.2%,1h
10401,2,[BliTau]Octane,2427,576,24,28,52,46.2%,1h
10401,3,Chronos,2427,178,6,8,14,42.9%,1h
10401,1,Potowy,2427,0,2,2,4,50.0%,10m
10401,1,[HOERS]BlessYou,2427,0,0,1,1,0.0%,2m
10401,3,[USA42]BerwiSwander,2427,0,0,3,3,0.0%,38m
10407,1,Kaffitørst,2426,328,11,16,27,40.7%,33m
10407,3,pieczzarek,2426,269,9,8,17,52.9%,21m
10407,1,aeiu,2426,339,8,9,17,47.1%,3m
10407,2,[eplg5]vonFoo,2426,226,7,17,24,29.2%,1h
10407,1,FocuS,2426,180,4,10,14,28.6%,1h
10407,3,Precious,2426,90,3,6,9,33.3%,15m
10413,1,WolnyBrovar,2425,964,36,43,79,45.6%,3m
10413,3,[Thune]Nexus,2425,271,9,8,17,52.9%,1h
10413,3,[luxdd]Gupu,2425,174,8,10,18,44.4%,1h
10413,1,[InitRu]Lambo,2425,233,7,6,13,53.8%,8m
10413,1,Washborn,2425,145,3,3,6,50.0%,17m
10413,3,FAKER,2425,142,3,4,7,42.9%,23m
10413,3,[Minas]Mineru,2425,97,3,5,8,37.5%,12m
10413,3,[BoEin]Teslon,2425,55,2,4,6,33.3%,20m
10421,3,PrixViande,2424,1397,54,57,111,48.6%,19m
10421,3,Tharadon,2424,510,20,21,41,48.8%,41m
10421,1,berserkgatz,2424,354,15,25,40,37.5%,37m
10421,2,krelin,2424,98,6,8,14,42.9%,37m
10421,1,[TRULUX]Loxly,2424,176,5,2,7,71.4%,1h
10421,3,Otfun,2424,114,4,9,13,30.8%,31m
10421,1,innofear,2424,88,2,2,4,50.0%,1h
10421,1,Janekxxxx,2424,0,0,1,1,0.0%,7m
10421,3,GrimsDottir,2424,0,0,1,1,0.0%,1h
10430,3,Namele,2423,294,11,11,22,50.0%,32m
10430,1,[DТ]Accelerator,2423,96,5,4,9,55.6%,13m
10430,3,[ExTr1m]Dehaka,2423,117,3,2,5,60.0%,1h
10430,1,[CORSA]llxXxll,2423,42,1,1,2,50.0%,5m
10430,1,Puckich,2423,0,1,4,5,20.0%,16m
10430,1,maksi,2423,0,0,1,1,0.0%,40m
10436,2,Geniy,2422,923,79,71,150,52.7%,1h
10436,1,BeatMeGoGold,2422,999,37,40,77,48.1%,36m
10436,3,Gatskopper,2422,756,29,22,51,56.9%,32m
10436,1,Beornegar,2422,218,5,6,11,45.5%,17m
10436,1,[HMarch]KNOBODYIKNOW,2422,0,0,1,1,0.0%,36m
10436,1,[Учиха]Itachi,2422,0,0,1,1,0.0%,37m
10442,3,GAWI,2421,1340,81,73,154,52.6%,27m
10442,1,[NuF]Umbra,2421,622,25,27,52,48.1%,21m
10442,1,Dream,2421,582,16,9,25,64.0%,27m
10442,3,[2WoD]Philipp,2421,339,13,14,27,48.1%,1h
10442,2,ToughKnight,2421,320,10,13,23,43.5%,33m
10442,1,[Cheas]Tuff,2421,74,5,9,14,35.7%,20m
10442,3,Gurvan,2421,97,4,5,9,44.4%,1h
10442,3,XYU,2421,30,3,4,7,42.9%,36m
10442,3,babok,2421,89,1,2,3,33.3%,16m
10442,1,TanocaCocok,2421,0,1,4,5,20.0%,40m
10452,3,skyh,2420,1564,103,108,211,48.8%,1h
10452,3,Козяпки,2420,1246,46,45,91,50.5%,41m
10452,3,AurskogMafia,2420,378,14,19,33,42.4%,19m
10452,3,Doom,2420,62,3,5,8,37.5%,25m
10452,3,Briz,2420,0,1,0,1,100.0%,6m
10452,1,Oyrad,2420,0,1,4,5,20.0%,10m
10452,1,fox,2420,0,0,1,1,0.0%,1h
10459,1,[IWD]lIlIlIl,2419,1559,145,144,289,50.2%,37m
10459,3,GLHaveRun,2419,1483,89,95,184,48.4%,20m
10459,3,AlecGorek,2419,987,35,34,69,50.7%,1h
10459,3,Facepalm,2419,560,26,23,49,53.1%,17m
10459,2,Valou,2419,92,6,8,14,42.9%,18m
10459,3,Napalm,2419,120,5,8,13,38.5%,1h
10459,3,zjinder,2419,30,3,5,8,37.5%,1h
10459,1,Biard,2419,48,2,6,8,25.0%,10m
10459,1,[ZHEL]TarasZhel,2419,0,0,1,1,0.0%,1h
10468,2,samboets,2418,139,4,11,15,26.7%,14m
10468,3,Constantine,2418,90,3,6,9,33.3%,41m
10468,2,bruh,2418,92,3,11,14,21.4%,1h
10468,1,[Саваны]KrinDar,2418,48,2,5,7,28.6%,1h
10472,3,Шурик,2417,1629,180,173,353,51.0%,28m
10472,2,LittleDemon,2417,612,48,56,104,46.2%,16m
10472,3,[ToZea]Yawasay,2417,161,3,6,9,33.3%,34m
10472,2,Blackwell,2417,100,2,1,3,66.7%,1h
10472,1,Daemonicus,2417,90,2,4,6,33.3%,1h
10472,2,Glaspearl,2417,1,1,9,10,10.0%,1h
10478,1,ZaJaC,2416,355,12,9,21,57.1%,36m
10478,3,ksbiv,2416,240,7,9,16,43.8%,3m
10478,3,Sufferu,2416,216,7,10,17,41.2%,18m
10478,1,Jeetah,2416,118,3,4,7,42.9%,5m
10478,1,Turop,2416,121,3,4,7,42.9%,21m
10483,3,Ludebam,2415,426,16,22,38,42.1%,41m
10483,3,MrGreen,2415,168,5,0,5,100.0%,17m
10483,2,Gelos,2415,154,5,7,12,41.7%,15m
10483,1,[Foxize]Vad,2415,0,2,3,5,40.0%,1h
10483,3,ManTu,2415,0,2,5,7,28.6%,1h
10483,1,Lentines,2415,0,1,4,5,20.0%,40m
10489,2,Hahashnikoff,2414,616,25,25,50,50.0%,30m
10489,2,WideEye,2414,234,11,8,19,57.9%,40m
10489,3,BleinMono,2414,270,10,11,21,47.6%,1h
10489,3,[Cybro]bestmatxi,2414,116,4,8,12,33.3%,15m
10489,1,[SPGN12]COBRA,2414,92,3,6,9,33.3%,20m
10489,1,[BWArmy]Tchipe,2414,38,1,1,2,50.0%,8m
10495,2,MİLLER,2413,1384,69,73,142,48.6%,30m
10495,3,[TGCLAN]Grotsil,2413,1230,47,43,90,52.2%,41m
10495,1,[DIS]MarineKingPR,2413,343,11,9,20,55.0%,1h
10495,1,TuiMau,2413,0,2,3,5,40.0%,23m
10495,2,[3DEN]Nust,2413,0,2,5,7,28.6%,2m
10495,3,Druchu,2413,38,2,6,8,25.0%,10m
10495,1,[FrCl]DarthVader,2413,0,1,0,1,100.0%,6m
10495,1,Elbon,2413,44,1,1,2,50.0%,1h
10503,1,[DieDD]Tyranneuo,2412,1494,48,45,93,51.6%,1h
10503,3,Iamaman,2412,912,36,33,69,52.2%,23m
10503,1,shagi,2412,0,3,3,6,50.0%,21m
10503,1,Fasthand,2412,0,1,1,2,50.0%,1h
10507,3,Durandal,2411,1571,130,128,258,50.4%,23m
10507,3,vongola,2411,1041,45,38,83,54.2%,1h
10507,1,Андрейка,2411,1081,41,46,87,47.1%,26m
10507,3,SurvivedInTs,2411,438,37,26,63,58.7%,3m
10507,2,ProtonM,2411,486,17,26,43,39.5%,28m
10507,2,[SPAINs]Agnos,2411,280,12,12,24,50.0%,1h
10507,1,Norfolks,2411,86,6,3,9,66.7%,1h
10507,1,llllllllllll,2411,254,6,9,15,40.0%,19m
10507,3,[Trusia]UddGt,2411,150,5,8,13,38.5%,1h
10507,1,[BCNG]goldeagleeee,2411,0,1,0,1,100.0%,2m
10507,1,[HST7]watsup,2411,44,1,1,2,50.0%,4m
10507,3,AnisMaster,2411,30,1,6,7,14.3%,18m
10519,1,Arcane,2410,923,49,39,88,55.7%,1h
10520,2,FTFTXH,2409,1254,72,82,154,46.8%,23m
10520,3,kkiismo,2409,1045,39,37,76,51.3%,27m
10520,1,Noble,2409,86,3,0,3,100.0%,25m
10520,1,IIIIIIIIIIII,2409,0,1,4,5,20.0%,1h
10520,3,Hellfish,2409,0,1,5,6,16.7%,41m
10520,1,lexa,2409,0,0,1,1,0.0%,2m
10520,1,Dimon,2409,0,0,2,2,0.0%,1h
10527,3,Allarmen,2408,1495,117,122,239,49.0%,5m
10527,3,Mercury,2408,216,36,42,78,46.2%,20m
10527,2,mergingFalls,2408,114,3,0,3,100.0%,40m
10527,1,Tyoma,2408,0,1,0,1,100.0%,29m
10527,2,nairolF,2408,30,1,9,10,10.0%,1h
10532,2,Abraham,2407,1540,105,104,209,50.2%,34m
10532,3,[CYOSK]flöwrilège,2407,1562,63,62,125,50.4%,13m
10532,2,MiSetztnenRe,2407,1138,44,48,92,47.8%,18m
10532,3,MacroKing,2407,511,18,19,37,48.6%,17m
10532,2,NightFall,2407,242,6,13,19,31.6%,12m
10532,1,Trey,2407,0,3,2,5,60.0%,38m
10532,2,Fluffy,2407,30,2,8,10,20.0%,18m
10532,1,matiBTC,2407,0,1,0,1,100.0%,19m
10532,1,DopingDrone,2407,0,1,4,5,20.0%,34m
10532,1,CountDrugula,2407,0,0,1,1,0.0%,1h
10532,1,[EliteX]Amsel,2407,0,0,1,1,0.0%,38m
10532,2,[SLGH]sova,2407,0,0,3,3,0.0%,1h
10544,3,fRANELI,2406,1051,39,38,77,50.6%,1h
10544,1,[AnReal]deni,2406,521,16,13,29,55.2%,11m
10544,1,DoTank,2406,443,12,10,22,54.5%,6m
10544,3,JeremLyon,2406,229,7,10,17,41.2%,1h
10544,3,Luke,2406,53,4,8,12,33.3%,32m
10544,1,[Listic]Traktobu,2406,88,2,1,3,66.7%,17m
10544,1,drwoswaa,2406,0,0,1,1,0.0%,1h
10544,3,[AGneit]mishka,2406,0,0,1,1,0.0%,9m
10552,1,SkyWalker,2405,208,5,8,13,38.5%,1h
10552,3,OddWarrior,2405,30,1,2,3,33.3%,1h
10552,1,апав,2405,0,1,4,5,20.0%,15m
10552,1,Cicco,2405,0,0,1,1,0.0%,20m
10552,2,[NWAro]Tavi,2405,0,0,2,2,0.0%,19m
10552,1,Jigslol,2405,0,0,5,5,0.0%,39m
10558,3,BORI,2404,1318,102,94,196,52.0%,37m
10558,3,HerrKaleun,2404,332,30,26,56,53.6%,30m
10558,3,RedPatrick,2404,254,7,8,15,46.7%,1h
10558,3,BabyShark,2404,88,4,5,9,44.4%,41m
10558,1,sugus,2404,0,3,2,5,60.0%,1h
10558,1,Bukakulis,2404,44,1,2,3,33.3%,19m
10558,1,Sleeper,2404,0,0,1,1,0.0%,1h
10565,3,Maurokun,2403,1131,45,53,98,45.9%,3m
10565,1,arzack,2403,1353,43,44,87,49.4%,5m
10565,1,Azov,2403,936,30,44,74,40.5%,32m
10565,1,Saint,2403,195,6,4,10,60.0%,1h
10565,3,[PTVru]BigD,2403,176,4,9,13,30.8%,4m
10565,1,Nieux,2403,42,2,5,7,28.6%,5m
10565,1,GROM,2403,0,1,5,6,16.7%,17m
10565,1,[RP1]Ksamilion,2403,0,0,1,1,0.0%,33m
10573,3,[TAW]Senbean,2402,292,10,7,17,58.8%,6m
10573,1,[berezi]Valyantin,2402,177,4,7,11,36.4%,13m
10573,1,Rabitrage,2402,0,2,4,6,33.3%,16m
10576,3,MishaDILL,2401,1568,78,67,145,53.8%,23m
10576,1,OMGUSUCK,2401,396,10,9,19,52.6%,2m
10576,1,Conman,2401,265,8,3,11,72.7%,21m
10576,1,sanandi,2401,278,8,6,14,57.1%,1h
10576,3,Visar,2401,208,6,6,12,50.0%,10m
10576,3,Darwin,2401,166,6,8,14,42.9%,3m
10576,3,Roger,2401,30,4,6,10,40.0%,32m
10576,1,ViveLaQuebec,2401,0,1,0,1,100.0%,4m
10576,1,[2D2Д]Chan,2401,0,1,0,1,100.0%,1h
10576,1,Liborius,2401,44,1,3,4,25.0%,1h
10576,3,Tasher,2401,0,0,1,1,0.0%,5m
10576,3,yeuda,2401,0,0,5,5,0.0%,3m
10588,1,Phip,2400,1320,60,55,115,52.2%,14m
10588,3,Makc,2400,374,13,13,26,50.0%,20m
10588,1,[NWGD]GraphpiTTV,2400,132,2,6,8,25.0%,16m
10588,1,ZEUS,2400,0,1,1,2,50.0%,5m
10588,3,[izako]BoarsKratos,2400,0,0,1,1,0.0%,27m
10588,1,EnnumaEllish,2400,0,0,1,1,0.0%,1h
10588,3,[Sikret]varlas,2400,0,0,2,2,0.0%,1h
10595,2,[Pewds]alex,2399,1563,133,138,271,49.1%,16m
10595,2,IVANSON,2399,277,8,5,13,61.5%,1h
10595,3,Somehy,2399,131,3,8,11,27.3%,18m
10595,1,JhonyGhost,2399,44,2,1,3,66.7%,2m
10595,1,Palziolo,2399,38,1,2,3,33.3%,19m
10595,1,Haddock,2399,0,1,4,5,20.0%,13m
10595,1,Glassjaw,2399,0,1,6,7,14.3%,5m
10602,2,GTTN,2398,299,43,47,90,47.8%,1h
10602,3,Dulk,2398,810,39,25,64,60.9%,3m
10602,3,Danielrj,2398,182,6,8,14,42.9%,12m
10602,3,[RWTF]Justice,2398,88,4,7,11,36.4%,4m
10602,1,deymon,2398,96,3,7,10,30.0%,4m
10602,3,TrooperTi,2398,97,2,1,3,66.7%,1h
10602,3,Magikanin,2398,30,1,5,6,16.7%,36m
10602,1,xenocombo,2398,0,0,1,1,0.0%,16m
10610,3,sss,2397,1309,66,60,126,52.4%,1h
10610,3,Burzum,2397,1228,44,51,95,46.3%,18m
10610,3,[IceHus]SCVReady,2397,215,6,10,16,37.5%,23m
10610,3,Cleaver,2397,96,2,3,5,40.0%,12m
10610,1,[Balaik]ReynArts,2397,0,1,2,3,33.3%,21m
10610,1,Lugburz,2397,0,1,4,5,20.0%,1h
10610,1,StinkyBell,2397,0,0,1,1,0.0%,16m
10617,1,Leeroy,2396,643,21,15,36,58.3%,7m
10617,3,[злань]PycckuuZerg,2396,431,17,16,33,51.5%,12m
10617,3,killer,2396,330,12,18,30,40.0%,17m
10617,3,todesritter,2396,224,7,10,17,41.2%,38m
10617,1,[MEKU]фанатик,2396,96,3,3,6,50.0%,19m
10617,1,ZergAxe,2396,44,2,1,3,66.7%,41m
10617,1,MoistLord,2396,0,1,0,1,100.0%,1h
10617,3,JagHasie,2396,0,1,2,3,33.3%,13m
10617,1,Edark,2396,0,1,4,5,20.0%,1h
10617,2,[GoTerr]QuirkyTurtle,2396,0,0,3,3,0.0%,30m
10617,3,sugar,2396,0,0,4,4,0.0%,32m
10628,2,Steve,2395,1597,105,114,219,47.9%,20m
10628,2,Lama,2395,203,14,19,33,42.4%,18m
10628,1,Mirco,2395,376,12,10,22,54.5%,1h
10628,1,[Drunk9]RouSou,2395,250,6,5,11,54.5%,9m
10628,1,Zedd,2395,168,4,5,9,44.4%,1h
10628,3,SwankY,2395,121,3,7,10,30.0%,16m
10628,1,[GJC]NikitaB,2395,0,2,1,3,66.7%,39m
10628,1,[r161om]KosinusUA,2395,0,2,3,5,40.0%,1h
10628,1,Weardz,2395,0,2,3,5,40.0%,1h
10628,1,bobinator,2395,48,2,5,7,28.6%,10m
10628,1,[PLUB]vncnt,2395,0,1,4,5,20.0%,7m
10628,1,TrollOfJom,2395,0,1,4,5,20.0%,5m
10628,1,FOX,2395,0,0,1,1,0.0%,1h
10641,1,MacroLi,2394,442,12,9,21,57.1%,20m
10641,1,nightwings,2394,80,2,2,4,50.0%,1h
10641,1,Lizardstorm,2394,0,1,0,1,100.0%,8m
10641,1,[grimgr]icedregon,2394,0,1,1,2,50.0%,1h
10641,1,Vlad,2394,0,1,1,2,50.0%,9m
10641,3,DrWhyte,2394,0,1,3,4,25.0%,1h
10641,1,СлышРаботать,2394,0,0,1,1,0.0%,35m
10648,1,[Olney]Skeletor,2393,1208,57,67,124,46.0%,31m
10648,3,pieczzarek,2393,912,33,40,73,45.2%,34m
10648,2,Gor,2393,221,9,9,18,50.0%,1h
10648,1,[mfxed]Odin,2393,0,2,2,4,50.0%,1h
10648,3,SanitaR,2393,85,1,2,3,33.3%,29m
10648,3,PrOvIdEr,2393,36,1,3,4,25.0%,1h
10648,1,[xCrüe]Strykker,2393,0,0,1,1,0.0%,1h
10655,2,Iwan,2392,1117,80,85,165,48.5%,40m
10655,2,YugQuesExos,2392,523,20,26,46,43.5%,15m
10655,1,пупсик,2392,284,8,2,10,80.0%,1h
10655,1,Furia,2392,239,6,6,12,50.0%,17m
10655,1,Nikus,2392,210,5,4,9,55.6%,1h
10655,1,[NoAir]Simulakrum,2392,46,2,1,3,66.7%,1h
10655,1,spacer,2392,0,1,0,1,100.0%,1h
10655,3,piotrwielki,2392,96,1,4,5,20.0%,27m
10655,1,[панда]zErLONG,2392,0,1,4,5,20.0%,26m
10655,1,AlanHawke,2392,0,0,1,1,0.0%,1h
10665,3,Somebody,2391,1057,62,57,119,52.1%,16m
10665,2,[Rok4]Appleman,2391,617,22,23,45,48.9%,13m
10665,2,robair,2391,484,19,21,40,47.5%,1h
10665,3,[µlµ]Firespeier,2391,279,9,11,20,45.0%,20m
10665,1,JokeR,2391,264,7,4,11,63.6%,8m
10665,3,Hardek,2391,228,7,10,17,41.2%,34m
10665,3,Randocheeees,2391,176,7,12,19,36.8%,17m
10665,1,[Zhig]VICTOR,2391,0,2,3,5,40.0%,1h
10665,1,LittelJ,2391,0,0,2,2,0.0%,1h
10674,3,SatanClaus,2390,402,30,31,61,49.2%,3m
10674,1,[scMAUI]Jayden,2390,912,27,25,52,51.9%,1h
10674,3,Antonf,2390,340,12,10,22,54.5%,1h
10674,2,[Users]Nosfiarmus,2390,268,9,9,18,50.0%,39m
10674,1,Shees,2390,118,3,6,9,33.3%,30m
10674,1,griiigg,2390,0,2,5,7,28.6%,1h
10674,1,[Limee]kringe,2390,0,1,4,5,20.0%,1h
10674,1,gegedemeur,2390,0,0,3,3,0.0%,5m
10682,2,michael,2389,1476,79,90,169,46.7%,1h
10682,3,macus,2389,1281,50,51,101,49.5%,20m
10682,1,lookdasoup,2389,436,11,10,21,52.4%,40m
10682,1,Dzhimax,2389,38,5,2,7,71.4%,1h
10682,1,LYCAN,2389,131,4,9,13,30.8%,39m
10682,3,toyo,2389,30,3,7,10,30.0%,3m
10682,1,[SeVenV]Mengsk,2389,88,2,3,5,40.0%,19m
10682,3,AverieAutumn,2389,0,2,4,6,33.3%,25m
10682,3,Endert,2389,108,2,6,8,25.0%,26m
10691,3,qwerty,2388,60,5,6,11,45.5%,28m
10691,3,[EXOS]Kgeri,2388,96,2,5,7,28.6%,16m
10693,1,Alex,2387,833,62,50,112,55.4%,35m
10693,2,[TMOS]ZergDrachen,2387,204,25,23,48,52.1%,1h
10693,3,ATC,2387,165,3,7,10,30.0%,1h
10693,1,ThisIsMeMeee,2387,0,1,0,1,100.0%,1h
10697,2,vegeta,2386,58,4,7,11,36.4%,1h
10697,1,malurite,2386,0,1,0,1,100.0%,1h
10699,3,Hasenmeier,2385,644,24,30,54,44.4%,1h
10699,3,Angendy,2385,522,20,25,45,44.4%,1h
10699,1,Nudelaug,2385,297,9,14,23,39.1%,1h
10699,2,Lyucifer,2385,149,4,9,13,30.8%,1h
10699,1,ZeenDR,2385,88,3,1,4,75.0%,1h
10699,1,JuicyZerg,2385,120,2,5,7,28.6%,7m
10699,1,Lolo,2385,42,1,1,2,50.0%,37m
10699,1,Cthuhlu,2385,0,1,4,5,20.0%,1h
10699,1,Maicce,2385,0,1,4,5,20.0%,16m
10699,1,PiriaLRUSss,2385,0,0,1,1,0.0%,1h
10699,1,MasterChief,2385,0,0,1,1,0.0%,1h
10699,1,RTC,2385,0,0,2,2,0.0%,13m
10711,3,[DBLSCB]Obtuse,2384,581,24,25,49,49.0%,6m
10711,3,Neptonus,2384,146,3,5,8,37.5%,1h
10711,1,[Dobro]Odoroblo,2384,0,1,0,1,100.0%,31m
10711,1,Hriibek,2384,0,1,4,5,20.0%,26m
10715,2,zagabar,2383,965,35,40,75,46.7%,1h
10715,1,LanSung,2383,0,0,5,5,0.0%,37m
10717,1,Harmakhis,2382,606,24,28,52,46.2%,1h
10717,2,UrexTheGreat,2382,624,20,34,54,37.0%,33m
10717,1,Oayder,2382,261,10,10,20,50.0%,2m
10717,1,[RuVoid]FriskCerber,2382,114,4,2,6,66.7%,22m
10717,1,Fago,2382,82,3,5,8,37.5%,36m
10717,2,DarkMatter,2382,0,1,4,5,20.0%,1h
10723,3,onethree,2381,1085,56,57,113,49.6%,1h
10723,3,[LaggIT]Vidde,2381,622,47,51,98,48.0%,41m
10723,2,Canada,2381,122,5,10,15,33.3%,37m
10723,3,atomik,2381,0,3,3,6,50.0%,16m
10723,3,DevFrost,2381,30,1,7,8,12.5%,16m
10723,2,Molokoto,2381,0,0,1,1,0.0%,1h
10729,3,Stavaros,2380,1553,119,126,245,48.6%,36m
10729,1,[Blini]Lamp,2380,273,12,14,26,46.2%,12m
10729,1,[1stGG]MiKa,2380,48,1,1,2,50.0%,3m
10729,1,esqesqq,2380,0,1,1,2,50.0%,20m
10729,1,TIM,2380,48,1,4,5,20.0%,1h
10729,1,BassToad,2380,0,0,1,1,0.0%,1h
10735,2,norman,2379,1107,156,159,315,49.5%,1h
10735,1,Solhatten,2379,572,42,40,82,51.2%,1h
10735,3,JokkePokke,2379,256,10,8,18,55.6%,1h
10735,1,[xFRSx]kartofel,2379,286,7,5,12,58.3%,16m
10735,1,Lemon,2379,134,3,6,9,33.3%,20m
10735,1,Papay,2379,0,0,1,1,0.0%,13m
10735,1,UNSU,2379,0,0,1,1,0.0%,34m
10735,1,Shaman,2379,0,0,1,1,0.0%,1h
10735,1,[izék]gyuri,2379,0,0,1,1,0.0%,17m
10735,1,kaminsky,2379,0,0,3,3,0.0%,4m
10745,2,Midnight,2377,1149,61,64,125,48.8%,9m
10745,2,[DGNRT]Jericho,2377,746,29,35,64,45.3%,2m
10745,1,DonMimimi,2377,742,21,16,37,56.8%,14m
10745,3,faker,2377,390,13,26,39,33.3%,13m
10745,1,Hopestone,2377,278,8,16,24,33.3%,1h
10745,1,[KFSRus]IIIIIIIIIIII,2377,0,2,3,5,40.0%,37m
10751,1,темай,2376,1851,70,73,143,49.0%,27m
10751,1,Marcopolo,2376,1370,58,58,116,50.0%,7m
10751,1,[ODISO]Zozo,2376,496,14,10,24,58.3%,39m
10751,3,[GTG]jokfil,2376,345,11,14,25,44.0%,3m
10751,1,Thomish,2376,260,8,8,16,50.0%,1h
10751,1,ColonelWolf,2376,164,6,6,12,50.0%,9m
10751,1,MrBotka,2376,119,6,11,17,35.3%,9m
10751,1,Ingi,2376,0,2,7,9,22.2%,1h
10751,1,mrD,2376,0,1,4,5,20.0%,12m
10760,3,GOOFYGOOBER,2375,314,10,25,35,28.6%,13m
10760,3,[ExTr1m]MaverickClaw,2375,250,7,10,17,41.2%,29m
10760,1,NotAnOmen,2375,0,4,2,6,66.7%,24m
10760,1,gorlash,2375,144,4,5,9,44.4%,41m
10764,1,GouLaG,2374,1802,68,71,139,48.9%,12m
10764,3,ElBakko,2374,331,15,15,30,50.0%,40m
10764,1,FalorRu,2374,48,2,6,8,25.0%,26m
10767,3,kyrtishman,2373,546,20,24,44,45.5%,12m
10767,3,ArtemIO,2373,97,2,1,3,66.7%,1h
10767,2,[MTYSON]GhiroCraft,2373,30,1,15,16,6.2%,1h
10767,1,sootruebyul,2373,0,0,1,1,0.0%,1h
10771,1,[RøS]Grant,2372,854,37,28,65,56.9%,22m
10771,3,Khazmodan,2372,717,34,30,64,53.1%,40m
10771,3,RoYkin,2372,691,28,29,57,49.1%,1h
10771,2,Шоквейв,2372,560,20,26,46,43.5%,12m
10771,2,Schuhsohle,2372,311,11,11,22,50.0%,1h
10771,1,andrey,2372,340,10,16,26,38.5%,1h
10771,1,naibuleuse,2372,190,6,3,9,66.7%,9m
10771,1,[AiRǂ]Giovanni,2372,42,4,3,7,57.1%,11m
10771,1,kwaaaaa,2372,0,1,0,1,100.0%,27m
10771,1,brutus,2372,0,1,5,6,16.7%,35m
10781,1,DuckSie,2371,247,11,11,22,50.0%,27m
10781,3,Tuubi,2371,296,10,15,25,40.0%,17m
10781,3,Kaurus,2371,180,7,12,19,36.8%,36m
10781,2,ksw,2371,0,2,3,5,40.0%,1h
10781,1,[Scvs]CyberDog,2371,113,1,3,4,25.0%,7m
10781,3,JohnWayne,2371,0,0,4,4,0.0%,17m
10787,1,Beardman,2370,1832,142,132,274,51.8%,1h
10787,2,[SpasG]SgtCodey,2370,689,25,33,58,43.1%,1h
10787,1,Crowley,2370,222,6,8,14,42.9%,17m
10787,2,[twnty]TOTORO,2370,0,1,4,5,20.0%,1h
10787,1,[SvTact]ArReS,2370,0,0,1,1,0.0%,30m
10792,1,[dTemp]MaGeBaN,2369,649,32,6,38,84.2%,1h
10792,3,[SUI]Crylex,2369,526,18,28,46,39.1%,8m
10792,1,joleclodo,2369,279,13,19,32,40.6%,31m
10792,3,greg,2369,308,12,14,26,46.2%,1h
10792,2,Lucos,2369,210,9,14,23,39.1%,1h
10792,1,Bbaiovou,2369,0,2,5,7,28.6%,10m
10798,2,ZergEatYou,2368,455,19,21,40,47.5%,1h
10798,1,котик,2368,621,19,21,40,47.5%,41m
10798,3,jjay,2368,451,16,20,36,44.4%,10m
10798,1,spaermiosis,2368,339,9,8,17,52.9%,1h
10798,1,ПЕРВОПРЕДОК,2368,254,6,9,15,40.0%,22m
10798,3,Finix,2368,148,5,10,15,33.3%,26m
10798,1,[TC58]xLuisitox,2368,128,2,3,5,40.0%,1h
10805,2,Beren,2367,950,36,43,79,45.6%,28m
10805,1,[357mag]benek,2367,0,1,1,2,50.0%,17m
10807,3,[Heroes]sempie,2366,521,19,17,36,52.8%,5m
10807,3,Snaipaz,2366,78,14,10,24,58.3%,11m
10807,3,kseroys,2366,255,12,10,22,54.5%,32m
10807,1,[Uсhiha]KarmaIakb,2366,254,8,11,19,42.1%,11m
10807,1,[WWOGU]Zero,2366,128,3,4,7,42.9%,1h
10812,2,Dave,2365,1413,278,289,567,49.0%,39m
10812,1,ScottishHunt,2365,1754,78,82,160,48.8%,1h
10812,1,holtby,2365,906,32,27,59,54.2%,1h
10812,1,JlевыйНосок,2365,144,7,8,15,46.7%,1h
10812,2,pablitoahah,2365,172,7,8,15,46.7%,1h
10812,1,cwZerro,2365,146,3,3,6,50.0%,20m
10812,1,Kutagen,2365,138,3,5,8,37.5%,1h
10812,1,enj,2365,0,1,6,7,14.3%,24m
10812,1,Mdehl,2365,0,0,1,1,0.0%,31m
10812,3,gouzzy,2365,0,0,5,5,0.0%,29m
10822,1,Slavovich,2364,1759,184,177,361,51.0%,19m
10822,3,mikk,2364,1564,70,70,140,50.0%,23m
10822,1,Solar,2364,1384,54,49,103,52.4%,33m
10822,1,[XYZ123]MarkusT,2364,730,29,30,59,49.2%,14m
10822,2,dyablobody,2364,615,23,29,52,44.2%,1h
10822,1,dodgyphil,2364,84,3,2,5,60.0%,1h
10822,3,Jimbo,2364,0,1,1,2,50.0%,1h
10822,1,Ursus,2364,0,1,4,5,20.0%,1h
10822,1,[hexOr]чешипузик,2364,0,0,3,3,0.0%,14m
10831,3,[London]SlapTrick,2363,783,32,38,70,45.7%,9m
10831,2,beef,2363,511,18,24,42,42.9%,33m
10831,1,Caresafe,2363,0,1,1,2,50.0%,1h
10831,1,[PIZIKS]DarkVenumMMA,2363,42,1,5,6,16.7%,1h
10835,3,alexprotasov,2362,1482,153,149,302,50.7%,23m
10835,1,oba,2362,901,28,24,52,53.8%,4m
10835,1,respiner,2362,728,24,20,44,54.5%,3m
10835,1,Khazeo,2362,358,15,2,17,88.2%,1h
10835,3,Pauline,2362,338,13,19,32,40.6%,29m
10835,1,Nanoc,2362,202,6,2,8,75.0%,1h
10835,1,LEV,2362,223,5,5,10,50.0%,1h
10842,1,Taac,2361,1472,56,50,106,52.8%,27m
10842,1,GlebMark,2361,848,32,28,60,53.3%,32m
10842,1,MefizZzda,2361,543,19,14,33,57.6%,39m
10842,3,Marum,2361,486,19,18,37,51.4%,1h
10842,1,[TheLA]MrJeanDoe,2361,512,18,13,31,58.1%,40m
10842,1,[POPIK]popik,2361,316,8,9,17,47.1%,38m
10842,1,llllllllllll,2361,246,7,10,17,41.2%,1h
10842,3,orbitus,2361,173,6,7,13,46.2%,35m
10842,3,Conker,2361,227,6,8,14,42.9%,12m
10842,1,Zstory,2361,48,2,1,3,66.7%,16m
10842,2,WhoDOESthat,2361,76,2,3,5,40.0%,1h
10842,1,[JYD]jpoha,2361,42,2,5,7,28.6%,20m
10842,2,Tengu,2361,0,1,4,5,20.0%,3m
10842,2,WeebSlayer,2361,0,1,4,5,20.0%,16m
10842,1,aLkaSelZer,2361,0,0,1,1,0.0%,4m
10842,1,astana,2361,0,0,2,2,0.0%,1h
10858,1,Kunglosman,2360,1761,78,75,153,51.0%,1h
10858,3,Iruga,2360,488,21,19,40,52.5%,36m
10858,1,Suntra,2360,438,13,9,22,59.1%,1h
10858,1,UAP,2360,387,11,22,33,33.3%,23m
10858,3,KaLaSh,2360,169,6,10,16,37.5%,1h
10858,1,EmperorGG,2360,44,3,1,4,75.0%,16m
10858,2,Lyudmiliks,2360,0,2,3,5,40.0%,23m
10858,1,LOLтакНельзя,2360,0,0,2,2,0.0%,1h
10858,3,EvilKnivle,2360,0,0,3,3,0.0%,31m
10867,1,[F7R]Bitz,2359,750,22,27,49,44.9%,34m
10867,3,[проSC2]Tamples,2359,291,12,15,27,44.4%,26m
10867,2,EmoSnek,2359,300,10,11,21,47.6%,41m
10867,1,BloodMan,2359,229,7,5,12,58.3%,1h
10867,1,[TGTGTG]darkantoine,2359,250,6,10,16,37.5%,3m
10867,3,Tenthor,2359,151,5,8,13,38.5%,1h
10867,3,jakbal,2359,172,4,8,12,33.3%,1h
10867,3,[Zorzot]Azot,2359,32,1,4,5,20.0%,1h
10867,1,[WuTaCl]Jannis,2359,0,0,1,1,0.0%,13m
10876,2,TodesRuu,2358,515,33,44,77,42.9%,2m
10876,3,[Hybrid]Boboklatttt,2358,204,7,13,20,35.0%,26m
10876,1,kostov,2358,30,5,5,10,50.0%,3m
10876,1,XBadBoyX,2358,0,0,1,1,0.0%,1h
10880,3,ArcyAdam,2357,1506,74,82,156,47.4%,1h
10880,3,Leprosorium,2357,192,21,21,42,50.0%,1h
10880,1,thl,2357,228,8,9,17,47.1%,35m
10880,1,Rababio,2357,73,2,6,8,25.0%,11m
10884,2,supplyBlock,2356,1414,66,70,136,48.5%,14m
10884,1,[607]НИКИТА,2356,646,18,16,34,52.9%,4m
10884,1,mafiosi,2356,96,5,6,11,45.5%,1h
10884,1,porek,2356,0,1,0,1,100.0%,35m
10884,1,liluk,2356,0,0,3,3,0.0%,1h
10889,3,Ferrante,2355,1175,54,53,107,50.5%,34m
10889,1,[SRF]bounes,2355,878,42,40,82,51.2%,1h
10889,1,RagaFlo,2355,276,8,5,13,61.5%,1h
10889,3,Aaron,2355,141,7,10,17,41.2%,5m
10889,1,LeGedeon,2355,156,4,5,9,44.4%,16m
10889,1,Zergus,2355,0,0,2,2,0.0%,31m
10895,1,Yokozuna,2354,627,31,7,38,81.6%,30m
10895,2,[CumA4]fourgeymer,2354,412,13,24,37,35.1%,1h
10895,1,RAIMOND,2354,233,10,11,21,47.6%,1h
10895,1,Rammud,2354,166,7,10,17,41.2%,41m
10895,3,IKE,2354,180,6,13,19,31.6%,28m
10895,2,Parmesan,2354,0,1,4,5,20.0%,1h
10901,2,IgorGulyaev,2353,1601,405,441,846,47.9%,30m
10901,2,ELJey,2353,533,19,24,43,44.2%,1h
10901,1,[PLA2N]deathNote,2353,578,17,14,31,54.8%,31m
10901,1,[Zergal]Serene,2353,512,16,21,37,43.2%,11m
10901,1,FruttiK,2353,0,1,0,1,100.0%,8m
10901,3,rorog,2353,0,1,0,1,100.0%,1h
10901,1,SirPoopins,2353,44,1,6,7,14.3%,38m
10908,3,mecajet,2352,1241,115,112,227,50.7%,23m
10908,3,Root,2352,328,12,12,24,50.0%,37m
10908,1,[Lyoko]LinuxFR,2352,288,7,10,17,41.2%,27m
10908,1,Pasha,2352,162,4,2,6,66.7%,1h
10908,1,Toothless,2352,48,4,6,10,40.0%,1h
10908,1,Sveinar,2352,96,3,7,10,30.0%,1h
10908,2,Steve,2352,0,1,4,5,20.0%,1h
10908,1,ПроСтоСаня,2352,0,0,2,2,0.0%,10m
10916,3,Luis,2351,1571,78,90,168,46.4%,5m
10916,2,Bergen,2351,1127,43,46,89,48.3%,1h
10916,2,Bazil,2351,626,21,23,44,47.7%,33m
10916,1,LoSTaR,2351,217,5,2,7,71.4%,17m
10916,3,erni,2351,30,2,6,8,25.0%,12m
10916,1,LeTypicBison,2351,0,1,4,5,20.0%,1h
10916,2,Victor,2351,0,1,5,6,16.7%,19m
10923,3,kerop,2350,508,20,22,42,47.6%,6m
10923,1,MrBombastic,2350,291,13,13,26,50.0%,1h
10923,1,[Whizka]Hellcore,2350,84,3,1,4,75.0%,8m
10923,3,KASZA,2350,114,2,7,9,22.2%,1h
10923,1,LuckyPig,2350,0,1,1,2,50.0%,1h
10928,2,[KJ420]DarkTemplar,2349,330,35,34,69,50.7%,1h
10928,3,Indaclub,2349,525,19,22,41,46.3%,10m
10928,1,BoBoMB,2349,510,13,13,26,50.0%,32m
10928,3,[ǂLOTLǂ]Viszer,2349,215,6,9,15,40.0%,1h
10928,1,Marcus,2349,139,3,6,9,33.3%,11m
10933,1,Pavlus,2348,1723,122,122,244,50.0%,9m
10933,3,VeTerran,2348,228,9,12,21,42.9%,25m
10933,3,OrHeBuK,2348,124,5,12,17,29.4%,1h
10933,1,xGambitx,2348,0,4,5,9,44.4%,30m
10933,2,llllllllllll,2348,107,3,6,9,33.3%,1h
10933,1,kokorom,2348,42,2,0,2,100.0%,11m
10933,1,[ark722]Arkling,2348,0,0,1,1,0.0%,37m
10940,3,[VISIK]virusnya,2347,758,25,35,60,41.7%,4m
10940,1,[SBHAWK]Iggy,2347,613,19,22,41,46.3%,22m
10940,1,DmitriyArch,2347,329,14,15,29,48.3%,1h
10940,1,Gunzis,2347,431,13,14,27,48.1%,26m
10940,1,android,2347,0,0,1,1,0.0%,38m
10940,1,Jester,2347,0,0,5,5,0.0%,1h
10946,1,NazGul,2346,999,46,58,104,44.2%,38m
10946,2,Cactus,2346,0,3,2,5,60.0%,16m
10946,1,CRuser,2346,86,2,3,5,40.0%,40m
10946,1,ВАСЯ,2346,144,2,4,6,33.3%,1h
10946,1,[ffn]Rampage,2346,0,1,1,2,50.0%,19m
10946,1,TideGainer,2346,0,1,5,6,16.7%,17m
10946,3,staspro,2346,0,0,1,1,0.0%,1h
10953,1,FleX,2345,1846,72,74,146,49.3%,1h
10953,2,[Gand]Starfury,2345,948,45,58,103,43.7%,12m
10953,3,Colour,2345,528,22,19,41,53.7%,23m
10953,1,BloodyHell,2345,710,22,23,45,48.9%,3m
10953,1,TheFox,2345,641,19,29,48,39.6%,1h
10953,1,Crude,2345,197,6,5,11,54.5%,13m
10953,1,BARcode,2345,175,4,12,16,25.0%,40m
10953,3,[ULOST]RoeterToeter,2345,91,2,5,7,28.6%,10m
10953,1,Murphy,2345,0,1,1,2,50.0%,38m
10953,2,Rich,2345,0,1,4,5,20.0%,1h
10953,3,omiz,2345,0,0,2,2,0.0%,17m
10964,3,Lauodamus,2344,1506,89,81,170,52.4%,15m
10964,1,FlowerPot,2344,396,14,12,26,53.8%,1h
10964,2,COCA,2344,314,10,23,33,30.3%,1h
10964,3,AlphaStar,2344,176,9,13,22,40.9%,5m
10964,2,Apelsinchik,2344,269,8,11,19,42.1%,25m
10964,2,PheelGood,2344,236,6,13,19,31.6%,30m
10964,1,TPol,2344,214,5,8,13,38.5%,37m
10964,1,[LawAPM]Pirroot,2344,228,5,12,17,29.4%,1h
10964,2,[ABDI]Sacha,2344,0,3,2,5,60.0%,1h
10964,1,SiMulat,2344,0,1,0,1,100.0%,1h
10974,3,marcolion,2343,172,5,9,14,35.7%,31m
10974,1,[Sewer]Dynamite,2343,0,2,1,3,66.7%,24m
10974,2,Zerantoss,2343,0,2,5,7,28.6%,31m
10974,3,Mikstray,2343,30,2,6,8,25.0%,3m
10974,1,[EnBeR]SpotLighT,2343,36,1,1,2,50.0%,1h
10974,1,Hoshikage,2343,0,0,1,1,0.0%,5m
10974,1,DIMESS,2343,0,0,4,4,0.0%,1h
10981,3,Dave,2342,653,27,28,55,49.1%,6m
10981,1,EnjoyKaos,2342,362,12,15,27,44.4%,3m
10981,1,[FSTM]FireStar,2342,272,8,1,9,88.9%,23m
10981,1,SPoTSepSiS,2342,277,8,9,17,47.1%,40m
10981,3,Нубас,2342,214,8,15,23,34.8%,1h
10981,1,Krokette,2342,42,2,5,7,28.6%,16m
10981,1,Xaira,2342,0,1,1,2,50.0%,7m
10981,3,teramus,2342,0,1,5,6,16.7%,36m
10981,2,[ZЕRG7V]АнтихрисТ,2342,0,0,1,1,0.0%,1h
10990,3,Tito,2341,852,43,40,83,51.8%,15m
10990,2,diabezdemona,2341,0,4,1,5,80.0%,36m
10990,2,Shadnax,2341,88,2,6,8,25.0%,22m
10990,2,[findus]DjoKO,2341,30,2,10,12,16.7%,41m
10990,1,Azrael,2341,0,0,1,1,0.0%,31m
10990,1,Starmuppet,2341,0,0,2,2,0.0%,40m
10996,1,Kerrigan,2340,921,36,21,57,63.2%,17m
10996,2,sustav,2340,212,7,4,11,63.6%,1h
10996,3,Brutalisk,2340,191,7,5,12,58.3%,32m
10996,3,SpiritHunter,2340,48,6,15,21,28.6%,25m
10996,3,Geos,2340,58,5,7,12,41.7%,1h
10996,1,darkboss,2340,0,3,2,5,60.0%,37m
10996,1,ArGoN,2340,48,2,1,3,66.7%,1h
10996,2,Kjiflm,2340,0,1,4,5,20.0%,9m
11004,1,pahipahi,2339,1691,64,63,127,50.4%,4m
11004,2,[RoBotS]lNnoVation,2339,293,40,22,62,64.5%,14m
11004,3,Pileofshiit,2339,529,21,25,46,45.7%,18m
11004,3,noks,2339,360,13,13,26,50.0%,13m
11004,3,yellow,2339,225,8,11,19,42.1%,18m
11004,1,[CxCx]Mercilla,2339,96,2,8,10,20.0%,1h
11004,1,Drednout,2339,0,1,2,3,33.3%,32m
11011,1,[Harley]Agate,2338,1376,82,98,180,45.6%,34m
11011,3,[Zhig]демон,2338,192,9,8,17,52.9%,24m
11011,3,[2bgr2]Sumrak,2338,269,8,11,19,42.1%,31m
11011,3,[Yedaz]grumpyelf,2338,58,5,5,10,50.0%,1h
11011,3,[SLPRY]HGbeatnik,2338,60,3,6,9,33.3%,34m
11011,1,[SB6020]Elsewhere,2338,0,1,1,2,50.0%,22m
11011,1,Boec,2338,0,1,4,5,20.0%,40m
11018,1,GeHero,2337,280,7,10,17,41.2%,1h
11018,1,MaxHimself,2337,148,5,4,9,55.6%,40m
11018,3,[Trasch]SorryBud,2337,116,4,9,13,30.8%,13m
11018,1,Padre,2337,74,3,5,8,37.5%,1h
11022,1,[ugline]exquisite,2336,1668,490,518,1008,48.6%,28m
11022,2,Heffa,2336,1585,90,94,184,48.9%,1h
11022,1,[S3ise]Sorin,2336,296,8,10,18,44.4%,17m
11022,1,Nelturion,2336,0,3,3,6,50.0%,1h
11022,3,Ikarus,2336,0,3,5,8,37.5%,26m
11022,2,[J4E]Machtiern,2336,38,2,2,4,50.0%,41m
11022,1,ZeRo,2336,131,2,3,5,40.0%,23m
11022,1,артём,2336,42,2,6,8,25.0%,8m
11022,3,JbnOsOrus,2336,0,1,5,6,16.7%,28m
11022,1,Arto,2336,0,0,2,2,0.0%,1h
11032,3,Igorrr,2335,821,82,77,159,51.6%,27m
11032,1,ZZZZ,2335,630,17,18,35,48.6%,39m
11032,3,[НОД17]Lain,2335,96,5,9,14,35.7%,1h
11032,1,[nrkz]Sherbet,2335,86,2,4,6,33.3%,4m
11032,1,[iNz]SirBorito,2335,0,1,0,1,100.0%,12m
11032,1,DuKec,2335,0,0,1,1,0.0%,3m
11038,3,Wiersbrowsky,2334,1467,120,118,238,50.4%,34m
11038,1,Emre,2334,373,13,15,28,46.4%,2m
11038,3,Burning,2334,0,1,0,1,100.0%,36m
11041,1,TOPIMAN,2333,950,29,27,56,51.8%,11m
11041,1,MagicJones,2333,242,7,8,15,46.7%,35m
11041,2,darkboss,2333,44,2,5,7,28.6%,20m
11041,1,ZaAiur,2333,0,1,4,5,20.0%,20m
11041,1,Benchmark,2333,0,0,5,5,0.0%,30m
11046,3,Lerroux,2332,933,33,36,69,47.8%,1h
11046,1,[kill2u]Jimiasty,2332,197,7,3,10,70.0%,4m
11046,1,[SuDm]Inthehouse,2332,126,2,6,8,25.0%,1h
11046,1,VikiR,2332,0,1,0,1,100.0%,1h
11046,1,offside,2332,38,1,1,2,50.0%,40m
11046,1,Chronos,2332,0,0,1,1,0.0%,36m
11046,1,python,2332,0,0,1,1,0.0%,32m
11046,1,koRn,2332,0,0,2,2,0.0%,39m
11054,3,SokoloF,2331,1029,83,77,160,51.9%,15m
11054,1,[Winnie]WinniePooh,2331,0,1,4,5,20.0%,6m
11056,1,Ghoran,2330,408,17,19,36,47.2%,19m
11056,2,kwas,2330,261,10,15,25,40.0%,29m
11056,3,LoLKicK,2330,150,6,9,15,40.0%,34m
11056,1,TEMPLER,2330,0,3,2,5,60.0%,23m
11056,2,Lasconi,2330,0,1,4,5,20.0%,35m
11061,1,[FNK]Voidcommando,2329,286,14,0,14,100.0%,23m
11061,1,[Monlit]LoLNetKlip,2329,316,8,8,16,50.0%,22m
11061,1,minlexx,2329,164,4,7,11,36.4%,23m
11061,3,DonLeon,2329,0,1,0,1,100.0%,41m
11061,1,belka,2329,97,1,3,4,25.0%,14m
11066,3,[PSHZ]LesbConv,2328,733,26,31,57,45.6%,1h
11066,1,DeathRiter,2328,0,0,2,2,0.0%,36m
11068,3,JustNoobie,2327,818,34,33,67,50.7%,1h
11068,1,MissTanyanya,2327,220,7,4,11,63.6%,36m
11068,1,jeePers,2327,42,2,1,3,66.7%,1h
11068,1,Bogus,2327,0,0,1,1,0.0%,12m
11072,1,zless,2326,898,33,42,75,44.0%,1h
11072,1,Dark,2326,225,5,4,9,55.6%,4m
11072,1,sinkelis,2326,76,5,5,10,50.0%,27m
11072,2,bulbaZguard,2326,96,3,3,6,50.0%,24m
11072,1,ChapterD,2326,42,1,1,2,50.0%,1h
11072,1,ShadowStorm,2326,0,1,1,2,50.0%,17m
11072,1,USvNethert,2326,0,0,1,1,0.0%,16m
11079,3,[PowOw]FluffyRSA,2325,366,12,18,30,40.0%,1h
11079,3,Ilich,2325,190,8,7,15,53.3%,35m
11079,3,idkfa,2325,196,7,9,16,43.8%,33m
11079,1,Tistobal,2325,0,2,3,5,40.0%,4m
11079,1,WaRmEaTeR,2325,0,0,1,1,0.0%,1h
11084,3,ALPJUAN,2324,1569,179,182,361,49.6%,5m
11084,1,Faint,2324,278,7,4,11,63.6%,40m
11084,1,[HaCo]NerViX,2324,0,1,4,5,20.0%,1h
11087,1,Kamikazykid,2323,1300,44,46,90,48.9%,13m
11087,1,paphitis,2323,748,31,18,49,63.3%,33m
11087,1,JabbaElJack,2323,95,2,0,2,100.0%,8m
11087,2,berti,2323,0,2,2,4,50.0%,1h
11087,1,Bandit,2323,48,2,8,10,20.0%,17m
11087,1,Bomg,2323,0,1,0,1,100.0%,1h
11093,3,Exosome,2322,1150,102,111,213,47.9%,34m
11093,3,RoscanAlex,2322,1225,43,48,91,47.3%,15m
11093,3,Sindyr,2322,969,38,37,75,50.7%,15m
11093,3,Limur,2322,552,20,24,44,45.5%,26m
11093,1,Lillo,2322,222,12,14,26,46.2%,1h
11093,2,AxyWarrior,2322,282,10,21,31,32.3%,5m
11093,1,[Y2AeoN]BuD,2322,192,4,9,13,30.8%,5m
11093,1,karubu,2322,167,3,5,8,37.5%,12m
11093,1,USUL,2322,91,2,3,5,40.0%,37m
11093,1,mcmaquein,2322,48,2,4,6,33.3%,22m
11093,3,Driss,2322,97,2,6,8,25.0%,32m
11093,1,Dámonische,2322,0,0,1,1,0.0%,1h
11105,1,shurikus,2321,1147,55,40,95,57.9%,11m
11105,1,[proto3]shrek,2321,174,4,3,7,57.1%,28m
11105,1,Shoggy,2321,42,2,0,2,100.0%,1h
11105,1,Cryza,2321,48,2,6,8,25.0%,1h
11105,3,Mkive,2321,85,2,8,10,20.0%,1h
11105,2,[WDLE]Lex,2321,0,1,4,5,20.0%,24m
11105,2,Sayrman,2321,0,1,4,5,20.0%,7m
11112,3,Istvan,2320,1525,85,92,177,48.0%,1h
11112,3,ETL,2320,643,47,40,87,54.0%,38m
11112,2,[ABidz]Sinvay,2320,662,23,37,60,38.3%,1h
11112,1,PlayerTwo,2320,341,15,15,30,50.0%,39m
11112,2,Flet,2320,116,3,5,8,37.5%,1h
11112,1,BlackSynergy,2320,96,3,9,12,25.0%,1h
11112,2,HaSSaSiN,2320,0,1,0,1,100.0%,39m
11112,1,[75рус]SADRON,2320,36,1,1,2,50.0%,32m
11112,1,[123212]кирилл,2320,0,1,5,6,16.7%,3m
11112,1,ALIEN,2320,0,1,5,6,16.7%,31m
11122,1,Chubakka,2319,830,25,29,54,46.3%,33m
11122,1,Сверхразум,2319,395,14,12,26,53.8%,1h
11122,1,[SszZ7]дима,2319,432,13,16,29,44.8%,39m
11122,3,wandtapete,2319,198,7,10,17,41.2%,5m
11122,1,zucnarf,2319,73,4,4,8,50.0%,16m
11122,1,BIM,2319,0,3,10,13,23.1%,16m
11122,1,[XDE12]TheTrj,2319,0,2,5,7,28.6%,5m
11122,1,VaviMax,2319,40,1,2,3,33.3%,17m
11122,1,[УЗУ]yar,2319,0,0,4,4,0.0%,33m
11131,1,Stilgarr,2318,1196,49,38,87,56.3%,1h
11131,1,Katilcho,2318,434,14,13,27,51.9%,40m
11131,1,[Maitri]AryaTara,2318,248,7,4,11,63.6%,38m
11131,1,Nyador,2318,48,3,5,8,37.5%,7m
11131,1,ddw,2318,0,2,3,5,40.0%,8m
11131,3,RiGGzR,2318,90,2,6,8,25.0%,17m
11131,2,[DRGO]Mastakiller,2318,0,0,1,1,0.0%,33m
11131,1,Wice,2318,0,0,2,2,0.0%,31m
11139,3,PanicMarine,2317,703,89,90,179,49.7%,12m
11139,1,Uvex,2317,468,12,17,29,41.4%,32m
11139,1,KomissarNKVD,2317,178,5,15,20,25.0%,33m
11139,1,[yakis]Nightmare,2317,0,1,2,3,33.3%,24m
11139,1,Superzerg,2317,0,1,4,5,20.0%,1h
11139,1,[sksksk]młodypl,2317,0,0,2,2,0.0%,14m
11145,1,CedBenglez,2316,250,6,10,16,37.5%,1h
11145,1,bdfg,2316,84,3,4,7,42.9%,25m
11145,1,javibox,2316,0,1,0,1,100.0%,1h
11145,2,PhuroX,2316,0,1,4,5,20.0%,1h
11145,1,toka,2316,0,0,1,1,0.0%,8m
11145,1,RuinatoR,2316,0,0,2,2,0.0%,1h
11151,3,DeChardin,2315,1236,49,50,99,49.5%,22m
11151,1,[UbS]Smoople,2315,80,3,2,5,60.0%,7m
11153,1,Whistler,2314,1169,65,66,131,49.6%,1h
11153,3,КУЗБАСС,2314,415,19,22,41,46.3%,10m
11153,1,[NUL2]LiquidGoofy,2314,462,13,10,23,56.5%,1h
11153,2,Effect,2314,286,11,15,26,42.3%,3m
11153,2,OlD,2314,46,2,3,5,40.0%,37m
11153,2,Marvell,2314,0,1,4,5,20.0%,4m
11159,1,KyleKtan,2313,1275,48,43,91,52.7%,19m
11159,1,HaChaCha,2313,1214,40,38,78,51.3%,1h
11159,1,Сивцов,2313,381,9,13,22,40.9%,22m
11159,2,[ODISO]Granité,2313,167,5,12,17,29.4%,1h
11159,1,kepgo,2313,0,0,1,1,0.0%,12m
11159,1,Коражёр,2313,0,0,1,1,0.0%,1h
11159,1,Dantessss,2313,0,0,5,5,0.0%,6m
11166,3,[ГУБНУБ]Gull,2312,566,19,27,46,41.3%,6m
11166,2,[CTLF]Silith,2312,88,4,12,16,25.0%,14m
11166,1,MarkP,2312,0,3,2,5,60.0%,14m
11166,1,Ryrik,2312,88,3,3,6,50.0%,38m
11166,1,[Святой]ПожилойГриша,2312,122,3,5,8,37.5%,1h
11166,1,RedDevil,2312,0,2,3,5,40.0%,1h
11166,1,Cerberus,2312,95,1,2,3,33.3%,21m
11166,1,ShadoW,2312,0,0,2,2,0.0%,33m
11174,1,sokol,2311,1171,66,69,135,48.9%,1h
11174,2,[Rajkit]NazMax,2311,1016,40,39,79,50.6%,1h
11174,1,Ybipbip,2311,536,14,14,28,50.0%,28m
11174,1,[LEZZO]parafinìco,2311,197,6,5,11,54.5%,1h
11174,1,Мазай,2311,0,1,2,3,33.3%,1h
11174,1,ORZ,2311,0,0,1,1,0.0%,1h
11180,1,SAYgg,2310,122,5,6,11,45.5%,17m
11180,1,LoNi,2310,0,0,1,1,0.0%,32m
11182,1,Shroom,2309,1299,43,46,89,48.3%,17m
11182,1,Kampfzwiebal,2309,556,16,18,34,47.1%,2m
11182,1,Цезарь,2309,103,5,2,7,71.4%,40m
11182,1,Bajekon,2309,106,3,4,7,42.9%,1h
11182,1,Syrinx,2309,0,0,1,1,0.0%,1h
11187,1,KOKOKUN,2308,1790,79,78,157,50.3%,28m
11187,1,nikimen,2308,766,23,28,51,45.1%,38m
11187,1,LizaKhvan,2308,236,6,9,15,40.0%,11m
11187,2,Denver,2308,62,5,9,14,35.7%,2m
11187,1,IIIIIIIIII,2308,217,4,8,12,33.3%,19m
11187,1,Swarm,2308,0,2,3,5,40.0%,1h
11187,1,Monapx,2308,0,1,5,6,16.7%,9m
11187,1,gremdirgen,2308,0,0,1,1,0.0%,38m
11187,1,TheLastCalvo,2308,0,0,1,1,0.0%,16m
11196,3,Critikal,2307,872,44,55,99,44.4%,17m
11196,1,Ragnaros,2307,546,17,19,36,47.2%,6m
11196,1,Bearking,2307,128,3,6,9,33.3%,1h
11196,1,[StSta]Budgerigan,2307,0,0,1,1,0.0%,1h
11200,1,Anvilar,2306,718,23,20,43,53.5%,39m
11200,1,Vladmenss,2306,516,14,17,31,45.2%,17m
11200,1,RaketenBär,2306,164,4,4,8,50.0%,1h
11200,3,gokussj,2306,30,3,7,10,30.0%,41m
11200,2,Barbarian,2306,0,1,4,5,20.0%,1h
11205,3,Sebalubu,2305,1290,89,85,174,51.1%,16m
11205,1,ASKEN,2305,1341,63,56,119,52.9%,27m
11205,1,ЗлойГусь,2305,499,20,28,48,41.7%,19m
11205,1,Mikalus,2305,554,16,19,35,45.7%,1h
11205,1,sockenhoppel,2305,337,12,25,37,32.4%,1h
11205,1,Pliskin,2305,96,4,8,12,33.3%,10m
11205,1,дракон,2305,121,3,3,6,50.0%,22m
11205,1,LorrdPicollo,2305,0,2,3,5,40.0%,11m
11205,1,Manio,2305,0,1,0,1,100.0%,1h
11205,1,ArHam,2305,0,1,2,3,33.3%,16m
11205,1,[CAI]Careear,2305,42,1,3,4,25.0%,39m
11205,2,smino,2305,0,1,4,5,20.0%,1h
11205,1,Rudebwoy,2305,0,0,2,2,0.0%,31m
11218,1,pomidor,2304,1492,54,46,100,54.0%,33m
11218,3,naishman,2304,543,27,38,65,41.5%,1h
11218,1,swole,2304,412,12,14,26,46.2%,6m
11218,3,[recska]Bableves,2304,120,5,10,15,33.3%,36m
11218,1,Bettastar,2304,131,3,0,3,100.0%,27m
11218,1,good,2304,88,3,3,6,50.0%,40m
11218,1,Straightman,2304,0,0,1,1,0.0%,8m
11225,2,Millenium,2303,523,68,69,137,49.6%,12m
11225,2,matrash,2303,478,18,26,44,40.9%,24m
11225,1,SEREDAS,2303,319,12,14,26,46.2%,20m
11225,1,Seleucos,2303,82,2,4,6,33.3%,1h
11225,1,Jocker,2303,0,1,0,1,100.0%,32m
11225,2,Rygel,2303,0,1,4,5,20.0%,1h
11225,1,Yurek,2303,0,0,2,2,0.0%,6m
11232,2,[SeVenV]Tormozko,2302,1597,256,254,510,50.2%,2m
11232,1,Kuolleille,2302,1409,61,63,124,49.2%,7m
11232,3,Lifeline,2302,764,30,35,65,46.2%,21m
11232,1,GiantBalls,2302,803,24,28,52,46.2%,1h
11232,1,TheWarDoctor,2302,142,5,4,9,55.6%,14m
11232,3,dots,2302,165,4,8,12,33.3%,37m
11232,1,shaoultz,2302,42,2,5,7,28.6%,9m
11232,1,[EXPANT]Splayn,2302,0,0,1,1,0.0%,4m
11232,1,Volkl,2302,0,0,1,1,0.0%,1h
11232,1,capiclecrane,2302,0,0,1,1,0.0%,1h
11242,1,Ragnarson,2301,419,14,17,31,45.2%,21m
11242,3,yazik,2301,296,11,10,21,52.4%,15m
11242,3,Skirata,2301,259,8,12,20,40.0%,41m
11242,1,[NucLea]ExperT,2301,199,6,7,13,46.2%,31m
11242,2,IIIIIIIIIIII,2301,158,6,14,20,30.0%,9m
11242,1,Maxim,2301,0,1,3,4,25.0%,5m
11242,3,TimeRay,2301,0,0,3,3,0.0%,8m
11249,3,sssss,2300,1582,290,295,585,49.6%,31m
11249,3,Blackhorn,2300,518,92,91,183,50.3%,38m
11249,1,Кобра,2300,1777,81,80,161,50.3%,6m
11249,1,Nogan,2300,518,15,16,31,48.4%,16m
11253,1,Cosmo,2299,1084,35,39,74,47.3%,16m
11253,1,Peaky,2299,241,6,8,14,42.9%,1h
11253,3,Newby,2299,179,6,10,16,37.5%,12m
11253,3,Hawk,2299,0,1,0,1,100.0%,1h
11253,1,[AlphC]Morhold,2299,0,1,0,1,100.0%,1h
11258,1,Elennor,2298,306,8,5,13,61.5%,8m
11258,1,LUX,2298,205,6,6,12,50.0%,23m
11258,3,Usbwarrior,2298,185,6,8,14,42.9%,12m
11258,1,[BeP]RekaBull,2298,134,4,3,7,57.1%,1h
11258,1,Paradigm,2298,105,2,2,4,50.0%,11m
11258,1,Новичог,2298,0,1,0,1,100.0%,39m
11258,1,Foman,2298,40,1,2,3,33.3%,19m
11265,3,[BZSS]Lazard,2297,1490,57,61,118,48.3%,24m
11265,1,Ezik,2297,1240,40,41,81,49.4%,39m
11265,3,GIVEMEACAGE,2297,171,4,5,9,44.4%,31m
11265,1,CrazzyMan,2297,84,2,4,6,33.3%,25m
11265,1,BlueRabbit,2297,0,1,0,1,100.0%,1h
11265,1,CVS,2297,0,1,4,5,20.0%,1h
11265,2,Raph,2297,0,1,4,5,20.0%,1h
11272,1,Betatest,2296,658,69,69,138,50.0%,28m
11272,1,Malk,2296,409,32,34,66,48.5%,11m
11272,1,HaNkYn,2296,170,5,7,12,41.7%,40m
11272,1,Metal,2296,181,4,3,7,57.1%,7m
11272,1,HaZe,2296,118,3,5,8,37.5%,1h
11272,1,Qken,2296,30,1,3,4,25.0%,33m
11278,3,Stygi,2295,1150,300,306,606,49.5%,36m
11278,3,PeriZat,2295,1311,225,231,456,49.3%,1h
11278,3,ETALIANEC,2295,451,28,31,59,47.5%,1h
11278,3,nonono,2295,499,17,24,41,41.5%,1h
11278,1,Guillohm,2295,84,3,3,6,50.0%,32m
11278,1,Titan,2295,38,2,0,2,100.0%,1h
11278,2,Melorka,2295,0,0,1,1,0.0%,12m
11278,2,[KrnBrs]Волшебник,2295,0,0,1,1,0.0%,1h
11286,3,винтик,2294,1536,142,140,282,50.4%,1h
11286,1,stavr,2294,0,1,2,3,33.3%,18m
11286,1,[375785]Ufo,2294,0,0,1,1,0.0%,11m
11289,1,SirOnenaGro,2293,1798,101,110,211,47.9%,22m
11289,1,[Tic2]Satrox,2293,264,8,6,14,57.1%,23m
11291,3,Hadwin,2292,1551,384,392,776,49.5%,28m
11291,1,Apollo,2292,1714,67,68,135,49.6%,39m
11291,2,Executeur,2292,204,7,12,19,36.8%,14m
11291,1,[TSC2C]Osoko,2292,82,2,5,7,28.6%,1h
11291,1,vvhisper,2292,40,1,3,4,25.0%,1h
11296,3,NIMCblue,2291,293,10,11,21,47.6%,1h
11296,1,DamiNouMineT,2291,124,4,3,7,57.1%,30m
11296,1,ДимаGSpot,2291,0,1,0,1,100.0%,1h
11296,1,Domon,2291,95,1,5,6,16.7%,13m
11296,1,Fly,2291,0,0,3,3,0.0%,18m
11301,1,scar,2290,1694,120,102,222,54.1%,6m
11301,1,Axel,2290,110,4,2,6,66.7%,1h
11301,1,Madara,2290,120,3,5,8,37.5%,30m
11301,2,Tussufeis,2290,48,2,1,3,66.7%,25m
11301,3,Luke,2290,0,1,6,7,14.3%,21m
11306,1,[Bishi]MaganoAAA,2289,1414,119,110,229,52.0%,39m
11306,1,Kozlostroj,2289,51,2,2,4,50.0%,37m
11306,1,BRIGHT,2289,0,1,4,5,20.0%,1h
11309,1,Danille,2288,641,69,65,134,51.5%,1h
11309,1,Genka,2288,740,20,27,47,42.6%,1h
11309,3,SAINT,2288,265,11,11,22,50.0%,4m
11309,1,KonTiki,2288,0,0,1,1,0.0%,6m
11313,1,perry,2287,1390,48,47,95,50.5%,1h
11313,2,COUSIIL,2287,626,27,29,56,48.2%,35m
11313,1,AzA,2287,303,10,11,21,47.6%,1h
11313,2,Breakcore,2287,0,3,6,9,33.3%,35m
11313,1,AAngelus,2287,0,2,3,5,40.0%,36m
11318,1,Mayota,2286,42,2,6,8,25.0%,1h
11318,2,backinblack,2286,0,1,4,5,20.0%,3m
11320,1,StickySock,2285,402,18,22,40,45.0%,1h
11320,1,HARDWAR,2285,458,12,13,25,48.0%,39m
11320,1,[FGger]BerlinrMario,2285,216,10,9,19,52.6%,11m
11320,3,Kelte,2285,185,6,8,14,42.9%,16m
11320,2,sleepfighter,2285,48,1,1,2,50.0%,7m
11325,3,Ark,2284,946,125,132,257,48.6%,12m
11325,1,Jeloponti,2284,1444,48,51,99,48.5%,28m
11325,1,Люцифер,2284,905,39,35,74,52.7%,6m
11325,1,[GPSFR1]mérovingiani,2284,466,13,14,27,48.1%,1h
11325,3,Berilii,2284,153,5,10,15,33.3%,1h
11325,2,Deathnar,2284,0,2,3,5,40.0%,9m
11325,2,kIRa,2284,0,1,0,1,100.0%,1h
11332,1,Chocobo,2283,510,15,15,30,50.0%,1h
11332,2,WildCatling,2283,217,7,12,19,36.8%,1h
11332,1,Vergil,2283,235,6,7,13,46.2%,4m
11332,1,pulse,2283,124,3,5,8,37.5%,35m
11332,1,Bilbo,2283,0,1,0,1,100.0%,1h
11332,1,Kefiras,2283,0,1,4,5,20.0%,13m
11338,3,[ToQ]Geraldo,2282,30,1,2,3,33.3%,6m
11338,1,Cabia,2282,42,1,3,4,25.0%,40m
11338,1,[лампа]саша,2282,0,0,2,2,0.0%,19m
11341,1,[OmDi]PomThomas,2281,1247,172,162,334,51.5%,20m
11341,1,Ashel,2281,621,27,21,48,56.2%,19m
11341,1,[NZO]KiLiug,2281,165,5,3,8,62.5%,41m
11341,1,Zasz,2281,193,5,7,12,41.7%,6m
11341,1,nightukraine,2281,32,5,9,14,35.7%,21m
11341,1,stovm,2281,114,2,1,3,66.7%,38m
11341,1,DugeThor,2281,0,0,5,5,0.0%,39m
11348,1,[FalPal]zaratulSVK,2280,1709,74,59,133,55.6%,28m
11348,1,NoName,2280,1007,67,72,139,48.2%,13m
11348,1,shernan,2280,216,20,18,38,52.6%,7m
11348,3,NoBrain,2280,278,9,19,28,32.1%,40m
11348,1,BladHeBamnip,2280,180,6,4,10,60.0%,8m
11348,1,СЕРАФИМ,2280,139,4,2,6,66.7%,37m
11348,1,KamusheK,2280,147,4,4,8,50.0%,17m
11348,1,SalmonSushi,2280,103,2,6,8,25.0%,40m
11348,1,KingCrimson,2280,0,1,2,3,33.3%,1h
11357,3,Novice,2279,274,9,22,31,29.0%,14m
11357,2,Horoc,2279,0,2,4,6,33.3%,3m
11357,2,MajPilot,2279,0,1,4,5,20.0%,1h
11360,3,Kariya,2278,1520,87,89,176,49.4%,1h
11360,1,KanatStar,2278,809,29,28,57,50.9%,1h
11360,3,[xTSAx]Firuz,2278,218,7,14,21,33.3%,3m
11360,1,virus,2278,145,3,2,5,60.0%,6m
11360,3,Psina,2278,0,2,8,10,20.0%,1h
11360,3,nikotin,2278,91,2,9,11,18.2%,3m
11360,1,AsiRis,2278,0,1,0,1,100.0%,20m
11360,1,HUNNU,2278,0,0,1,1,0.0%,1h
11360,1,kokorom,2278,0,0,2,2,0.0%,11m
11369,1,zergys,2277,916,28,31,59,47.5%,25m
11369,1,EZBELNG,2277,155,3,3,6,50.0%,12m
11369,1,yoh,2277,0,2,4,6,33.3%,6m
11369,1,JudahPaul,2277,97,1,3,4,25.0%,17m
11373,3,JornSnow,2276,1330,54,53,107,50.5%,1h
11373,1,Andrew,2276,174,5,7,12,41.7%,11m
11373,1,DeadShoot,2276,124,4,4,8,50.0%,39m
11373,1,[VOLKI]Браттвоего,2276,132,4,5,9,44.4%,1h
11373,1,IronTerran,2276,156,4,7,11,36.4%,40m
11373,2,justin,2276,0,1,0,1,100.0%,11m
11373,2,Sasiska,2276,0,0,1,1,0.0%,5m
11380,1,piko,2275,1737,126,124,250,50.4%,15m
11380,1,sasha,2275,1270,50,42,92,54.3%,14m
11380,3,Gandalfchris,2275,630,21,32,53,39.6%,22m
11380,3,Mafus,2275,60,4,8,12,33.3%,5m
11380,1,[FMGFM]nik,2275,38,2,2,4,50.0%,1h
11380,1,[SLW]Aurelien,2275,0,1,0,1,100.0%,40m
11380,1,vegetable,2275,88,1,5,6,16.7%,4m
11380,1,Gore,2275,0,1,6,7,14.3%,37m
11380,1,Caosgamer,2275,0,0,1,1,0.0%,39m
11389,1,Schmulian,2274,284,7,14,21,33.3%,1h
11389,1,Lichi,2274,173,6,6,12,50.0%,1h
11389,1,[ReAE]LordOfFate,2274,195,4,4,8,50.0%,29m
11389,2,Gustaff,2274,88,3,7,10,30.0%,29m
11389,1,[ZZT]Azeliel,2274,140,3,7,10,30.0%,6m
11389,1,[PÂRłAH]sadko,2274,120,2,2,4,50.0%,41m
11395,1,llllllllll,2273,858,37,34,71,52.1%,1h
11395,3,Olgierd,2273,88,6,8,14,42.9%,40m
11397,3,xilluks,2272,220,7,6,13,53.8%,1h
11397,1,loks,2272,44,2,2,4,50.0%,1h
11397,1,Woredan,2272,0,1,2,3,33.3%,40m
11397,1,SpartaKook,2272,0,0,1,1,0.0%,38m
11397,1,MicroJackson,2272,0,0,1,1,0.0%,5m
11402,1,Miru,2271,551,34,35,69,49.3%,37m
11402,1,razser,2271,588,22,24,46,47.8%,39m
11402,1,Grziwi,2271,0,3,2,5,60.0%,19m
11402,3,Chaps,2271,0,0,8,8,0.0%,10m
11406,1,PTYTb,2270,1244,46,44,90,51.1%,7m
11406,1,[xFRSx]GrosNounours,2270,572,16,18,34,47.1%,21m
11406,1,Dryacktòr,2270,112,3,1,4,75.0%,1h
11406,1,[FouTa]Tof,2270,107,3,1,4,75.0%,17m
11406,1,Starlight,2270,118,3,4,7,42.9%,7m
11406,1,GosuAppa,2270,119,3,6,9,33.3%,1h
11406,3,[MidR]Encoche,2270,0,2,7,9,22.2%,8m
11406,1,lilKUS,2270,0,1,3,4,25.0%,4m
11406,2,[zsír]hukkle,2270,0,0,1,1,0.0%,1h
11406,1,pTz,2270,0,0,2,2,0.0%,22m
11406,1,EmperorDash,2270,0,0,3,3,0.0%,1h
11417,1,Panimoni,2269,1275,53,46,99,53.5%,23m
11417,1,Ктулху,2269,1080,37,42,79,46.8%,1h
11417,1,Deadpresiden,2269,754,23,25,48,47.9%,28m
11417,1,[N8]Danledresh,2269,404,14,12,26,53.8%,8m
11417,1,[VovKla]Vovchek,2269,163,4,2,6,66.7%,16m
11417,1,kdb,2269,0,3,3,6,50.0%,4m
11417,1,undertaker,2269,0,1,4,5,20.0%,38m
11417,2,AmericAFyeah,2269,48,1,5,6,16.7%,36m
11417,1,tize,2269,0,0,2,2,0.0%,1h
11417,1,LenovoIL,2269,0,0,4,4,0.0%,1h
11427,1,Starlord,2268,1579,155,153,308,50.3%,1h
11427,1,torlien,2268,284,7,12,19,36.8%,36m
11427,1,[MW2G]AgreGoL,2268,162,5,6,11,45.5%,39m
11427,1,Bezman,2268,115,5,11,16,31.2%,1h
11427,1,[JAT]Luzold,2268,70,3,7,10,30.0%,39m
11432,1,wirdcea,2267,434,46,36,82,56.1%,15m
11433,3,Lorn,2266,991,40,45,85,47.1%,33m
11433,1,Madrin,2266,508,14,26,40,35.0%,12m
11433,1,[H0M0]GuGuN,2266,498,13,21,34,38.2%,30m
11433,3,Arty,2266,199,8,9,17,47.1%,1h
11433,1,[GRINGO]Heybi,2266,0,2,7,9,22.2%,40m
11433,2,ThisIsASteak,2266,0,1,4,5,20.0%,30m
11439,3,ShadowStorm,2265,1575,77,82,159,48.4%,1h
11439,2,ДариН,2265,533,20,19,39,51.3%,39m
11439,2,RandomRacePH,2265,34,1,1,2,50.0%,1h
11439,2,Centurion,2265,0,0,1,1,0.0%,36m
11443,1,BreakPunk,2264,1781,75,73,148,50.7%,6m
11443,1,Grandfather,2264,462,12,16,28,42.9%,19m
11443,2,Nub,2264,276,8,21,29,27.6%,1h
11443,3,sonix,2264,195,7,10,17,41.2%,1h
11443,1,Brotherluk,2264,97,2,3,5,40.0%,6m
11443,2,Indigo,2264,0,1,4,5,20.0%,1h
11443,1,Sebeast,2264,40,1,7,8,12.5%,14m
11450,3,blais,2263,1543,119,126,245,48.6%,15m
11450,1,Savombre,2263,469,33,39,72,45.8%,15m
11450,3,Tonic,2263,306,10,20,30,33.3%,1h
11450,1,Lavliett,2263,315,8,11,19,42.1%,14m
11450,1,[EvK19]deonisijRU,2263,258,6,6,12,50.0%,6m
11450,2,das,2263,146,5,10,15,33.3%,1h
11450,1,Makariow,2263,0,0,2,2,0.0%,5m
11457,2,Eran,2262,384,15,5,20,75.0%,39m
11457,1,FreshMint,2262,179,5,10,15,33.3%,1h
11457,1,Baas,2262,76,2,4,6,33.3%,1h
11457,1,ленивыйтитан,2262,97,2,6,8,25.0%,4m
11457,1,connor,2262,48,1,4,5,20.0%,1h
11462,3,OoNnEeSs,2261,446,17,16,33,51.5%,19m
11462,2,Brindille,2261,114,2,5,7,28.6%,19m
11462,2,[OX]zap,2261,0,1,0,1,100.0%,21m
11465,1,[MaLo]dakterjones,2260,114,3,6,9,33.3%,1h
11466,1,emperor,2259,1777,139,144,283,49.1%,6m
11466,1,Calgarus,2259,1626,55,58,113,48.7%,1h
11466,1,JiayouCH,2259,940,38,34,72,52.8%,32m
11466,2,Schiggy,2259,222,7,3,10,70.0%,1h
11470,3,gascanu,2258,579,20,23,43,46.5%,13m
11470,3,SxualChcolat,2258,368,16,22,38,42.1%,16m
11470,3,MrGoldFish,2258,302,11,15,26,42.3%,3m
11470,1,[MadKuy]GachiVanya,2258,221,6,5,11,54.5%,1h
11470,1,[BArCo]Sakura,2258,198,6,8,14,42.9%,1h
11470,2,DemonPS,2258,0,2,3,5,40.0%,1h
11470,2,Steffen,2258,32,1,1,2,50.0%,3m
11477,1,Sioss,2257,370,18,21,39,46.2%,15m
11477,1,shura,2257,222,6,8,14,42.9%,27m
11477,2,WielkiBUM,2257,0,0,1,1,0.0%,29m
11480,1,Matzethias,2256,316,14,24,38,36.8%,19m
11480,3,Zaros,2256,201,6,11,17,35.3%,1h
11480,1,wotter,2256,68,4,7,11,36.4%,33m
11480,2,Zeleemon,2256,32,2,0,2,100.0%,33m
11480,1,серый,2256,0,1,1,2,50.0%,1h
11485,3,MagicSoul,2255,1360,47,76,123,38.2%,22m
11485,2,Laitius,2255,64,3,6,9,33.3%,2m
11485,3,angryANT,2255,117,2,8,10,20.0%,40m
11485,2,Muchaillon,2255,0,0,1,1,0.0%,12m
11489,2,Mips,2254,1546,174,182,356,48.9%,22m
11489,1,Aesarion,2254,974,32,34,66,48.5%,1h
11489,1,TpasUnKdo,2254,366,11,12,23,47.8%,27m
11489,1,Daywalker,2254,290,8,12,20,40.0%,6m
11489,2,[2Pizzа]Polaris,2254,0,0,4,4,0.0%,1h
11494,1,RAZAR,2253,1771,269,273,542,49.6%,16m
11494,1,[PARSE]abc,2253,601,22,20,42,52.4%,40m
11494,2,tomy,2253,0,3,2,5,60.0%,16m
11494,1,Kaesebrot,2253,0,2,5,7,28.6%,1h
11494,1,[Ɖŕąĩǵǿ]DuneRunner,2253,97,1,2,3,33.3%,17m
11494,1,cocoleboss,2253,42,1,3,4,25.0%,23m
11500,2,CryingMonkey,2252,1467,87,113,200,43.5%,24m
11500,1,LtDamn,2252,235,67,105,172,39.0%,12m
11500,1,Märk,2252,984,33,32,65,50.8%,14m
11500,2,Lazymox,2252,378,13,11,24,54.2%,1h
11500,2,[RBCOMM]GeNiUSssS,2252,164,6,5,11,54.5%,1h
11500,3,Rocklog,2252,211,5,8,13,38.5%,1h
11500,1,Radikal,2252,136,5,13,18,27.8%,34m
11500,1,EZHOWWW,2252,145,3,7,10,30.0%,1h
11500,2,GaNDoN,2252,0,1,0,1,100.0%,5m
11500,2,ponti,2252,44,1,5,6,16.7%,1h
11510,1,ArchO,2251,1034,52,54,106,49.1%,7m
11510,1,Studio,2251,785,24,22,46,52.2%,1h
11510,1,VooDoo,2251,683,20,20,40,50.0%,32m
11510,1,Kosanchu,2251,222,12,9,21,57.1%,39m
11510,1,[CdNRO]Dane,2251,236,7,8,15,46.7%,41m
11510,1,RuFF,2251,198,5,9,14,35.7%,1h
11510,1,Blindness,2251,100,4,7,11,36.4%,28m
11510,2,HuitSix,2251,112,2,5,7,28.6%,1h
11510,2,Tiga,2251,0,0,1,1,0.0%,18m
11519,1,YAYAP,2250,0,3,5,8,37.5%,18m
11519,2,[MayDie]Nekromant,2250,0,1,0,1,100.0%,23m
11521,1,BurryProtos,2249,360,16,7,23,69.6%,32m
11521,1,[YSRY]TerranTaran,2249,48,1,2,3,33.3%,14m
11521,1,HCure,2249,48,1,5,6,16.7%,11m
11521,2,Natsu,2249,0,0,1,1,0.0%,14m
11525,2,Malte,2248,0,0,1,1,0.0%,1h
11525,2,VeganBurrito,2248,0,0,1,1,0.0%,1h
11525,2,[GIBLA]povidloooman,2248,0,0,1,1,0.0%,26m
11528,1,[DaFF]PinkyStar,2247,732,24,30,54,44.4%,28m
11528,1,panos,2247,222,6,11,17,35.3%,33m
11528,3,dansaev,2247,170,5,11,16,31.2%,1h
11528,1,ВоваЗадний,2247,139,2,7,9,22.2%,1h
11528,2,karapuz,2247,0,1,4,5,20.0%,23m
11528,2,[ILSA]wolf,2247,0,0,1,1,0.0%,14m
11528,2,Dozia,2247,0,0,1,1,0.0%,38m
11535,1,ThePowerPuff,2246,1296,66,59,125,52.8%,39m
11535,1,pioneer,2246,876,49,55,104,47.1%,1h
11535,3,ZerBärUs,2246,536,45,42,87,51.7%,6m
11535,1,Caladois,2246,521,15,18,33,45.5%,28m
11535,1,SCrEaM,2246,220,9,10,19,47.4%,1h
11535,2,Dioboli,2246,148,7,9,16,43.8%,3m
11535,2,[amk666]JoKeR,2246,30,2,4,6,33.3%,1h
11535,2,Yuriy,2246,0,1,3,4,25.0%,1h
11535,2,Hybrill,2246,0,0,1,1,0.0%,4m
11535,2,arachneo,2246,0,0,5,5,0.0%,1h
11545,1,ERIELISEO,2245,846,35,33,68,51.5%,33m
11545,1,JackSparrow,2245,348,13,10,23,56.5%,17m
11545,2,Thoko,2245,118,6,5,11,54.5%,1h
11545,1,GodStopMe,2245,158,4,9,13,30.8%,14m
11545,2,Finwych,2245,62,3,0,3,100.0%,29m
11545,2,FoXiK,2245,0,2,3,5,40.0%,1h
11551,1,[AbsA]FrozenBrain,2244,1781,82,89,171,48.0%,40m
11551,1,Draxies,2244,475,14,13,27,51.9%,28m
11551,3,Nate,2244,435,14,20,34,41.2%,1h
11551,1,GTnik,2244,84,2,8,10,20.0%,1h
11551,2,TERRAkiller,2244,0,1,1,2,50.0%,29m
11551,2,Vitalii,2244,0,0,4,4,0.0%,9m
11557,2,[2iq]Shizoid,2243,182,12,5,17,70.6%,37m
11557,1,Dmitriyouric,2243,240,6,11,17,35.3%,17m
11557,2,[M62]Arasher,2243,142,4,3,7,57.1%,1h
11557,1,SkinnyC,2243,96,4,6,10,40.0%,6m
11557,1,anger,2243,97,2,6,8,25.0%,33m
11557,2,[L5EM]HentaiPanda,2243,0,1,4,5,20.0%,1h
11557,1,[RoDjo]RoDjo,2243,0,0,3,3,0.0%,36m
11564,2,Arnaud,2242,1124,41,45,86,47.7%,31m
11564,1,Georgi,2242,978,32,39,71,45.1%,32m
11564,2,Braulio,2242,794,29,31,60,48.3%,3m
11564,1,Homax,2242,196,10,5,15,66.7%,39m
11564,3,TheFetaGamer,2242,277,10,12,22,45.5%,1h
11564,2,mBOIARDOm,2242,98,6,14,20,30.0%,36m
11564,2,[drrsch]Oliverinspac,2242,48,3,2,5,60.0%,4m
11564,1,Crystalchik,2242,0,0,3,3,0.0%,1h
11572,1,[Hаsu]GorogonA,2241,873,67,79,146,45.9%,25m
11572,3,Opanos,2241,98,4,10,14,28.6%,28m
11572,2,kirito,2241,0,1,4,5,20.0%,10m
11575,1,gotovcev,2240,936,36,42,78,46.2%,36m
11575,1,Duch,2240,0,2,4,6,33.3%,1h
11575,2,Price,2240,0,1,0,1,100.0%,31m
11578,3,Behemoth,2239,246,7,8,15,46.7%,15m
11579,1,Ars,2238,1207,75,70,145,51.7%,40m
11579,2,Libertarian,2238,1302,48,46,94,51.1%,21m
11579,2,BlitzKrieG,2238,280,17,24,41,41.5%,2m
11579,1,valhalla,2238,332,14,20,34,41.2%,20m
11579,2,Maxpatac,2238,102,3,3,6,50.0%,38m
11584,1,StableGenius,2237,377,23,21,44,52.3%,1h
11584,3,Arturo,2237,0,0,1,1,0.0%,16m
11586,1,Maratos,2236,0,3,3,6,50.0%,19m
11586,3,[RATTIG]Uncoro,2236,0,2,8,10,20.0%,38m
11586,1,NotMe,2236,0,0,2,2,0.0%,1h
11589,3,gre,2235,1449,124,131,255,48.6%,26m
11589,1,ZerGutt,2235,1324,47,45,92,51.1%,28m
11589,1,Seredas,2235,224,6,9,15,40.0%,1h
11589,1,Warjah,2235,96,3,5,8,37.5%,1h
11589,2,Voldro,2235,0,0,5,5,0.0%,1h
11594,1,evanpie,2234,1170,42,46,88,47.7%,26m
11594,1,Raid,2234,886,33,30,63,52.4%,4m
11594,1,blackjack,2234,284,11,7,18,61.1%,40m
11594,2,[CumBoy]Foreyton,2234,46,4,4,8,50.0%,1h
11594,2,iWeed,2234,32,1,2,3,33.3%,1h
11594,2,[micute]Mentula,2234,0,0,1,1,0.0%,1h
11600,2,Gulliver,2233,124,6,11,17,35.3%,3m
11601,1,Tyberius,2232,327,21,16,37,56.8%,13m
11601,1,NullPointer,2232,162,7,8,15,46.7%,6m
11601,2,fransaka,2232,88,4,1,5,80.0%,12m
11604,1,Ulysse,2231,1421,153,153,306,50.0%,28m
11604,2,[Chariz]Maxsut,2231,894,33,42,75,44.0%,1h
11604,1,ddda,2231,418,14,21,35,40.0%,40m
11604,1,AsaP,2231,165,3,5,8,37.5%,8m
11604,2,Barrett,2231,0,2,8,10,20.0%,40m
11604,2,bkv,2231,0,1,0,1,100.0%,3m
11604,2,[zurt]zurtmaster,2231,0,1,3,4,25.0%,1h
11611,3,Noob,2230,173,44,52,96,45.8%,37m
11611,1,Dew,2230,1022,42,37,79,53.2%,6m
11611,1,MisterBaum,2230,412,14,14,28,50.0%,6m
11611,2,aloe,2230,30,3,3,6,50.0%,1h
11611,1,Hydra,2230,112,3,9,12,25.0%,1h
11611,2,MAXIMYS,2230,0,2,3,5,40.0%,5m
11611,1,Perpedon,2230,89,1,3,4,25.0%,3m
11611,2,Punkeloff,2230,0,0,1,1,0.0%,4m
11611,2,ShnecK,2230,0,0,1,1,0.0%,1h
11620,1,eyal,2229,699,54,58,112,48.2%,1h
11620,1,DanceJunkie,2229,902,39,31,70,55.7%,1h
11620,1,tararim,2229,566,31,33,64,48.4%,1h
11620,1,HydraD,2229,118,2,1,3,66.7%,8m
11624,1,Alex,2228,1750,127,127,254,50.0%,1h
11624,2,BIGDOG,2228,30,2,2,4,50.0%,3m
11626,1,Чистопацан,2227,1107,39,37,76,51.3%,1h
11626,3,Torulf,2227,707,37,40,77,48.1%,1h
11626,3,Adventure,2227,354,14,16,30,46.7%,37m
11626,1,[Floren]Milogav,2227,335,12,7,19,63.2%,41m
11626,1,Lik,2227,210,8,6,14,57.1%,28m
11626,2,Ivanushka,2227,0,2,3,5,40.0%,18m
11632,2,МудрыйСокол,2226,30,2,0,2,100.0%,29m
11632,3,HoobНУБ,2226,30,1,3,4,25.0%,21m
11632,2,Expendable,2226,0,1,4,5,20.0%,7m
11632,2,Yoka,2226,0,0,1,1,0.0%,1h
11636,2,[scp3]Rylavein,2225,814,27,46,73,37.0%,1h
11636,1,dorik,2225,159,4,9,13,30.8%,13m
11636,2,Kaban,2225,94,2,3,5,40.0%,1h
11636,2,OskarJR,2225,0,2,3,5,40.0%,19m
11636,2,Predacon,2225,0,1,4,5,20.0%,37m
11641,1,[SibOPG]SiberianOPG,2224,516,23,22,45,51.1%,21m
11641,1,Dasego,2224,458,19,20,39,48.7%,1h
11641,1,Chris,2224,88,3,10,13,23.1%,1h
11641,1,Razvanov,2224,96,2,4,6,33.3%,39m
11641,3,Braindead,2224,0,2,8,10,20.0%,23m
11641,2,[AiRǂ]FrankHrd,2224,46,1,6,7,14.3%,1h
11641,2,jonted,2224,0,0,1,1,0.0%,21m
11641,1,duu,2224,0,0,2,2,0.0%,8m
11649,3,boredom,2223,1063,136,150,286,47.6%,4m
11649,3,FINN,2223,934,33,43,76,43.4%,1h
11649,1,hallan,2223,862,26,35,61,42.6%,1h
11649,2,Xelor,2223,136,6,3,9,66.7%,1h
11649,2,Player,2223,94,4,3,7,57.1%,1h
11654,3,Alysme,2222,1501,69,69,138,50.0%,20m
11654,2,[MKBO]BeBOP,2222,224,8,6,14,57.1%,38m
11654,1,KoMbaTiK,2222,204,7,12,19,36.8%,2m
11654,1,Joopig,2222,195,6,8,14,42.9%,1h
11654,2,Nicolai,2222,125,5,5,10,50.0%,12m
11654,2,Maden,2222,0,1,4,5,20.0%,36m
11654,2,ToaFooL,2222,0,0,1,1,0.0%,1h
11661,1,kalt,2221,251,8,7,15,53.3%,14m
11661,3,poolie,2221,30,4,5,9,44.4%,1h
11661,2,PanAdam,2221,0,0,1,1,0.0%,24m
11661,2,marvinclay,2221,0,0,3,3,0.0%,24m
11665,1,Kreol,2220,971,41,35,76,53.9%,28m
11665,2,SpacialRonin,2220,66,6,2,8,75.0%,27m
11665,2,Mephisto,2220,66,3,1,4,75.0%,26m
11665,2,Honter,2220,32,2,0,2,100.0%,1h
11665,2,dexaps,2220,0,2,3,5,40.0%,1h
11665,3,Robibob,2220,0,2,7,9,22.2%,1h
11665,1,[Белшир]PROdoomin,2220,0,0,1,1,0.0%,11m
11672,3,Slonopotam,2219,1158,102,106,208,49.0%,26m
11673,3,[Br0k3n]Wingz,2218,1473,219,265,484,45.2%,10m
11673,2,[DJ3]Vegeta,2218,428,15,14,29,51.7%,38m
11673,1,Nomisarache,2218,476,12,21,33,36.4%,21m
11673,1,ZappZarapp,2218,448,11,14,25,44.0%,1h
11673,1,Holo,2218,447,11,19,30,36.7%,15m
11673,2,[AoDC]BoTTo,2218,234,8,9,17,47.1%,1h
11673,1,Cloudbob,2218,164,5,8,13,38.5%,3m
11673,2,Asker,2218,0,3,2,5,60.0%,1h
11673,2,Eken,2218,0,1,4,5,20.0%,1h
11673,3,LeaderUSSR,2218,97,1,4,5,20.0%,33m
11683,1,EasyAI,2217,1704,160,194,354,45.2%,19m
11683,1,Singylar,2217,765,29,29,58,50.0%,14m
11683,1,[OUUH]Charogne,2217,592,24,22,46,52.2%,41m
11683,3,[PND18]Cabal,2217,405,13,20,33,39.4%,16m
11683,2,Nhektor,2217,260,8,24,32,25.0%,36m
11683,1,kemosabe,2217,0,4,3,7,57.1%,1h
11689,1,TommyEisbaer,2216,559,15,17,32,46.9%,1h
11689,1,loggers,2216,480,13,22,35,37.1%,38m
11689,2,DeMarco,2216,193,7,7,14,50.0%,1h
11689,2,Orcus,2216,132,5,3,8,62.5%,19m
11693,1,prozeus,2215,1099,47,54,101,46.5%,32m
11693,1,lIlIlIl,2215,0,1,2,3,33.3%,1h
11693,1,Blonde,2215,0,1,6,7,14.3%,19m
11693,2,Choncha,2215,0,0,2,2,0.0%,1h
11697,1,ьллж,2214,638,87,80,167,52.1%,24m
11697,2,MadMax,2214,624,21,23,44,47.7%,36m
11697,1,Инквизитор,2214,168,4,8,12,33.3%,13m
11697,2,[4X4]effect,2214,86,3,1,4,75.0%,1h
11697,2,kempacy,2214,0,0,1,1,0.0%,5m
11697,2,Wispa,2214,0,0,2,2,0.0%,1h
11703,1,[PLA2N]BrainDeadNoo,2213,389,38,53,91,41.8%,11m
11703,1,Futon,2213,579,18,20,38,47.4%,36m
11703,1,Tastosis,2213,110,4,6,10,40.0%,8m
11703,2,FatalError,2213,152,4,7,11,36.4%,22m
11703,1,DironModys,2213,142,3,4,7,42.9%,15m
11703,2,MatialLAW,2213,60,3,6,9,33.3%,1h
11709,2,Varg,2212,1285,48,51,99,48.5%,3m
11709,3,ZoMBIe,2212,830,32,43,75,42.7%,20m
11709,1,Plestin,2212,1012,31,38,69,44.9%,40m
11709,1,Stéphano,2212,361,10,14,24,41.7%,37m
11709,1,[Dralag]FatCocк,2212,0,3,3,6,50.0%,8m
11714,2,Cheech,2211,0,2,3,5,40.0%,12m
11714,2,руслан,2211,0,1,0,1,100.0%,21m
11716,1,Ponyalone,2210,285,12,7,19,63.2%,38m
11716,1,Ung,2210,235,9,8,17,52.9%,11m
11716,2,Flydor,2210,220,8,9,17,47.1%,21m
11716,2,BAUWO,2210,142,5,2,7,71.4%,22m
11716,1,Radu,2210,167,5,8,13,38.5%,7m
11716,2,nasum,2210,62,2,5,7,28.6%,41m
11716,2,LordDron,2210,30,1,1,2,50.0%,39m
11716,2,SCOMPEYROLS,2210,0,0,1,1,0.0%,9m
11724,1,CSTCxBiGlOoO,2209,44,2,3,5,40.0%,13m
11724,1,Jens,2209,76,2,5,7,28.6%,3m
11724,1,Crazy,2209,0,1,6,7,14.3%,25m
11724,2,ivga,2209,0,0,1,1,0.0%,23m
11724,2,KWASI,2209,0,0,3,3,0.0%,4m
11729,3,Turtleterran,2208,1447,215,228,443,48.5%,9m
11729,1,Valentinchik,2208,1558,76,82,158,48.1%,1h
11729,2,ArgentiSol,2208,1585,66,63,129,51.2%,22m
11729,1,tho,2208,362,11,13,24,45.8%,1h
11729,2,Tegan,2208,60,2,1,3,66.7%,40m
11729,2,Srolikan,2208,0,1,4,5,20.0%,1h
11729,2,крутов,2208,0,0,3,3,0.0%,1h
11729,2,Calmo,2208,0,0,5,5,0.0%,40m
11737,2,takiinbor,2207,196,8,2,10,80.0%,32m
11737,2,Илья,2207,122,4,2,6,66.7%,40m
11737,2,HEROGEO,2207,0,2,3,5,40.0%,26m
11737,2,IlIlIlI,2207,0,1,4,5,20.0%,36m
11737,1,Amwas,2207,0,1,6,7,14.3%,1h
11737,1,ZeroCool,2207,0,0,4,4,0.0%,2m
11743,1,[TFSC]Helitacker,2206,484,16,15,31,51.6%,17m
11743,3,Celta,2206,68,4,11,15,26.7%,1h
11743,2,thanos,2206,0,3,2,5,60.0%,35m
11743,1,Omikron,2206,44,2,7,9,22.2%,1h
11743,2,Ugly,2206,0,2,7,9,22.2%,20m
11748,3,DISPARITATAS,2205,86,6,8,14,42.9%,32m
11748,3,feliuarro,2205,0,3,5,8,37.5%,1h
11748,2,[FDAY]Ratchoulback,2205,0,2,4,6,33.3%,35m
11748,1,Scat,2205,0,1,6,7,14.3%,32m
11748,2,Contact,2205,0,0,1,1,0.0%,40m
11748,2,Fallen,2205,0,0,2,2,0.0%,35m
11754,1,[R0]Stefy,2204,977,32,55,87,36.8%,1h
11754,1,Gnakapuf,2204,584,19,29,48,39.6%,20m
11754,2,Photoshop,2204,254,8,6,14,57.1%,1h
11754,2,Albe,2204,30,1,1,2,50.0%,3m
11758,2,DarkHome,2203,154,5,3,8,62.5%,1h
11758,1,Wildjäger,2203,124,5,3,8,62.5%,17m
11758,1,Sim,2203,192,5,10,15,33.3%,16m
11758,2,luczefer,2203,32,2,1,3,66.7%,3m
11758,2,[Dzikii]Apink,2203,0,1,0,1,100.0%,4m
11763,1,[Bx2]Djaneezy,2202,1698,252,270,522,48.3%,12m
11763,1,Sprudel,2202,905,77,81,158,48.7%,1h
11763,2,[GfG]Bilbo,2202,683,30,34,64,46.9%,1h
11763,1,MirrorMan,2202,413,15,17,32,46.9%,17m
11763,1,GGtoss,2202,78,3,10,13,23.1%,22m
11763,2,Laocoon,2202,0,2,3,5,40.0%,1h
11763,2,Clovicek,2202,30,1,1,2,50.0%,38m
11763,2,TordFocus,2202,95,1,5,6,16.7%,1h
11763,1,Akademik,2202,0,0,4,4,0.0%,1h
11763,2,ulkor,2202,0,0,5,5,0.0%,1h
11773,1,Martingale,2201,950,31,35,66,47.0%,7m
11773,2,Zaltoi,2201,294,7,10,17,41.2%,40m
11773,2,IIIIIIIIIIII,2201,138,3,4,7,42.9%,36m
11776,1,LeytLan,2199,417,16,22,38,42.1%,39m
11776,1,AlelCraft,2199,125,5,6,11,45.5%,16m
11776,1,Massy,2199,112,3,5,8,37.5%,16m
11776,2,Starcounter,2199,0,1,0,1,100.0%,37m
11776,1,gera,2199,0,0,2,2,0.0%,40m
11781,1,lamba,2198,587,21,20,41,51.2%,4m
11781,1,[NoMIC]Loki,2198,237,8,6,14,57.1%,3m
11781,2,fOCUS,2198,138,6,6,12,50.0%,32m
11781,2,UbaNawak,2198,135,4,3,7,57.1%,1h
11781,2,[Тянки]Nikollya,2198,138,2,1,3,66.7%,1h
11781,2,[HZeS]Wolffy,2198,0,1,0,1,100.0%,1h
11787,1,[JCLM]Daweed,2197,668,20,24,44,45.5%,1h
11787,2,dyango,2197,0,2,3,5,40.0%,12m
11787,1,OssOne,2197,96,2,5,7,28.6%,35m
11790,1,Romaniaa,2196,1353,375,384,759,49.4%,1h
11790,1,[ProbKA]kasik,2196,1576,105,104,209,50.2%,1h
11790,2,[TǂT]Mysterginox,2196,281,9,17,26,34.6%,28m
11790,2,Vottot,2196,253,8,15,23,34.8%,9m
11790,2,Centewhy,2196,152,6,3,9,66.7%,21m
11795,1,[Klownz]FlyingSirkus,2195,1239,44,44,88,50.0%,1h
11796,1,Rambod,2194,906,32,41,73,43.8%,32m
11796,3,Kreuzwerfer,2194,472,21,30,51,41.2%,6m
11796,1,PlayerOne,2194,369,14,15,29,48.3%,1h
11796,1,ТАЩУМБА,2194,97,1,3,4,25.0%,16m
11800,1,SkyWan,2193,96,1,6,7,14.3%,1h
11800,2,Elprimo,2193,0,0,2,2,0.0%,11m
11800,2,tatou,2193,73,0,3,3,0.0%,1h
11803,2,DedBulachnik,2192,140,5,0,5,100.0%,1h
11803,1,[lkgg]Aleksha,2192,176,5,5,10,50.0%,15m
11803,1,Ishak,2192,140,5,5,10,50.0%,14m
11803,2,Misha,2192,187,3,7,10,30.0%,1h
11807,1,Nicholas,2191,1014,37,33,70,52.9%,4m
11807,1,UltraNoob,2191,367,11,10,21,52.4%,1h
11807,2,МалышKid,2191,186,6,7,13,46.2%,18m
11807,2,menawer,2191,227,5,11,16,31.2%,39m
11807,2,BlackCat,2191,30,3,4,7,42.9%,18m
11807,2,gouzzy,2191,30,1,1,2,50.0%,1h
11807,1,[Indeec]IgrokFantazi,2191,0,0,4,4,0.0%,16m
11814,1,SLAKER,2190,799,32,23,55,58.2%,22m
11814,2,[DV]Tété,2190,459,21,5,26,80.8%,1h
11814,3,ILOoOLI,2190,309,11,12,23,47.8%,24m
11814,3,МистерСмерть,2190,113,5,5,10,50.0%,28m
11814,2,DBFJ,2190,0,0,1,1,0.0%,7m
11819,2,SoeinZufall,2189,730,26,34,60,43.3%,18m
11819,2,[R4Time]KingCrimson,2189,73,5,2,7,71.4%,42m
11819,1,[HAis]Devil,2189,168,4,2,6,66.7%,16m
11819,1,Croutonbobo,2189,0,3,4,7,42.9%,7m
11823,3,[13NRV]SirIronprick,2188,1466,186,208,394,47.2%,23m
11823,1,MEN,2188,691,26,24,50,52.0%,7m
11823,1,deligan,2188,72,5,6,11,45.5%,1h
11823,3,[XvFe]Sacke,2188,149,3,5,8,37.5%,9m
11823,1,noobgg,2188,0,2,7,9,22.2%,1h
11823,2,ScurvyGordo,2188,0,1,0,1,100.0%,36m
11823,3,[Pisyn]KROMSATEL,2188,0,1,0,1,100.0%,36m
11830,2,zerg,2187,73,1,2,3,33.3%,1h
11831,2,SinusExperte,2186,0,1,4,5,20.0%,30m
11832,2,HeinB,2185,880,34,26,60,56.7%,12m
11832,1,Protoss,2185,193,5,8,13,38.5%,23m
11832,2,[DmdSh]DrHubbas,2185,30,2,0,2,100.0%,1h
11832,2,kkkeasy,2185,106,2,6,8,25.0%,1h
11832,1,batbekh,2185,0,1,6,7,14.3%,39m
11837,1,[A100]prototer,2184,471,23,27,50,46.0%,31m
11837,2,fclacruzc,2184,0,2,3,5,40.0%,5m
11837,2,арти,2184,0,1,1,2,50.0%,39m
11837,2,DAMNED,2184,30,1,3,4,25.0%,1h
11837,2,Балмат,2184,46,1,3,4,25.0%,7m
11837,2,[InFy]Erduyta,2184,0,0,5,5,0.0%,12m
11843,2,dsded,2183,1215,140,145,285,49.1%,1h
11843,1,[Spehx]Anerad,2183,465,19,17,36,52.8%,1h
11843,2,BIGDADDY,2183,0,1,6,7,14.3%,1h
11843,2,Chubaka,2183,0,0,5,5,0.0%,40m
11847,1,фергент,2182,366,13,20,33,39.4%,14m
11847,1,Asterix,2182,332,10,13,23,43.5%,3m
11847,1,ASMOOT,2182,162,5,10,15,33.3%,1h
11847,2,bananaboi,2182,0,3,2,5,60.0%,41m
11847,2,DooMMen,2182,0,1,4,5,20.0%,1h
11852,1,Siecinianin,2181,1219,47,51,98,48.0%,7m
11852,3,DDGms,2181,1002,36,47,83,43.4%,13m
11852,1,Tanatosua,2181,941,31,32,63,49.2%,20m
11852,1,Kost,2181,523,22,27,49,44.9%,1h
11852,1,Faucheur,2181,483,15,22,37,40.5%,13m
11852,1,lyckegard,2181,216,5,11,16,31.2%,9m
11852,2,Chloe,2181,30,2,11,13,15.4%,28m
11852,2,DonBitoc,2181,0,1,0,1,100.0%,37m
11852,2,Zaraziteli,2181,0,0,2,2,0.0%,41m
11861,1,kavezic,2180,432,14,19,33,42.4%,39m
11861,1,Tiga,2180,144,5,9,14,35.7%,34m
11861,2,dtan,2180,32,2,3,5,40.0%,1h
11864,2,ricardor,2179,604,23,23,46,50.0%,42m
11864,3,Evgi,2179,342,13,24,37,35.1%,26m
11864,2,DonDiego,2179,94,4,4,8,50.0%,1h
11864,2,iamSOplastic,2179,88,2,4,6,33.3%,18m
11864,1,AlexXandr,2179,0,1,6,7,14.3%,14m
11869,2,guguen,2178,94,4,5,9,44.4%,1h
11869,3,MarrowGnawer,2178,0,2,7,9,22.2%,26m
11869,1,Ryo,2178,46,1,2,3,33.3%,18m
11869,2,EPMAKOB,2178,97,1,5,6,16.7%,1h
11873,2,Crevette,2177,170,6,14,20,30.0%,3m
11873,2,Champions,2177,0,1,0,1,100.0%,1h
11873,1,Dimon,2177,0,1,0,1,100.0%,17m
11873,2,salazar,2177,0,0,2,2,0.0%,1h
11877,2,Wiggle,2176,451,20,16,36,55.6%,9m
11877,2,[Zhig]остап,2176,178,8,17,25,32.0%,1h
11877,2,[TBKH]Hopefull,2176,208,6,3,9,66.7%,36m
11877,2,yeetdHamster,2176,0,0,5,5,0.0%,40m
11881,1,[Прото1]текилла,2175,1003,37,42,79,46.8%,1h
11881,2,[PITYX]Lisi,2175,0,3,2,5,60.0%,7m
11881,2,TumanZ,2175,60,3,6,9,33.3%,28m
11881,1,Alchibade,2175,76,2,8,10,20.0%,19m
11881,2,IskroMan,2175,0,1,4,5,20.0%,1h
11886,1,Drikce,2174,666,23,27,50,46.0%,34m
11886,2,[НамПОХ]sKy,2174,292,7,10,17,41.2%,31m
11886,2,Spyda,2174,0,1,0,1,100.0%,1h
11886,2,Catkats,2174,0,0,5,5,0.0%,28m
11890,1,TheBusDriver,2173,1539,87,78,165,52.7%,1h
11890,1,Basym,2173,282,8,17,25,32.0%,17m
11890,1,qwujebpiwqub,2173,228,7,12,19,36.8%,21m
11890,2,nava,2173,30,3,5,8,37.5%,23m
11894,2,Grizzlyman,2172,420,15,16,31,48.4%,3m
11894,1,[WARWAR]Clouder,2172,126,5,9,14,35.7%,1h
11894,2,nibeon,2172,30,1,2,3,33.3%,1h
11894,2,starscrapper,2172,88,1,2,3,33.3%,26m
11898,2,DIMAPIDORASS,2171,288,10,9,19,52.6%,1h
11898,2,[OPStar]Vadim,2171,152,6,3,9,66.7%,1h
11898,1,zabor,2171,94,4,15,19,21.1%,4m
11898,2,Goman,2171,0,2,4,6,33.3%,39m
11898,2,[ZERGYT]BTCHunter,2171,0,1,0,1,100.0%,1h
11898,2,denaturatpl,2171,32,1,1,2,50.0%,1h
11904,2,AmonXd,2170,555,24,29,53,45.3%,31m
11904,2,zadrotyarik,2170,351,17,12,29,58.6%,1h
11904,2,NikDevil,2170,410,15,11,26,57.7%,1h
11904,2,matr,2170,390,13,14,27,48.1%,40m
11904,2,[InitRu]gacar,2170,277,13,18,31,41.9%,12m
11904,2,BouncyPoo,2170,213,7,6,13,53.8%,35m
11904,1,Peaky,2170,96,3,1,4,75.0%,10m
11904,2,MadGodEater,2170,0,1,2,3,33.3%,39m
11904,2,Maxexmax,2170,38,1,6,7,14.3%,1h
11904,2,[Аtomic]Данька,2170,0,0,1,1,0.0%,11m
11904,2,Daniel,2170,0,0,1,1,0.0%,1h
11904,2,jack,2170,0,0,5,5,0.0%,28m
11916,1,[NTsa]Pommedeterre,2169,190,8,11,19,42.1%,1h
11916,2,Robber,2169,0,0,5,5,0.0%,5m
11918,2,[ganten]Felix,2168,962,47,42,89,52.8%,1h
11918,3,Danne,2168,494,19,26,45,42.2%,18m
11918,2,MGLbill,2168,0,3,3,6,50.0%,13m
11918,2,[TheDOH]miko,2168,0,1,4,5,20.0%,1h
11918,2,kolia,2168,0,1,6,7,14.3%,17m
11918,2,Onyx,2168,0,0,1,1,0.0%,9m
11918,2,DaNiLkA,2168,0,0,1,1,0.0%,1h
11925,2,[DioBr]IndShock,2167,266,9,9,18,50.0%,40m
11925,2,[NINJ88]Angel,2167,228,8,11,19,42.1%,1h
11925,1,GLoOoB,2167,0,2,7,9,22.2%,26m
11925,2,illi,2167,30,1,3,4,25.0%,9m
11925,2,PapaBear,2167,0,0,5,5,0.0%,15m
11930,1,andyczech,2166,543,18,17,35,51.4%,1h
11930,1,Rakanishyu,2166,493,16,26,42,38.1%,7m
11930,2,SISERA,2166,323,11,9,20,55.0%,7m
11930,2,Enx,2166,94,4,7,11,36.4%,1h
11930,2,[D3L]JJxDUB,2166,0,2,3,5,40.0%,1h
11935,2,Cykron,2165,1505,85,87,172,49.4%,41m
11935,1,Dimok,2165,224,5,10,15,33.3%,3m
11935,1,[Ihanri]ThanderKnigh,2165,121,3,3,6,50.0%,1h
11935,2,Austerlitz,2165,116,2,6,8,25.0%,31m
11939,2,PATAFON,2164,204,5,6,11,45.5%,7m
11939,1,WhiteWidow,2164,0,1,0,1,100.0%,33m
11939,2,Rache,2164,0,0,1,1,0.0%,1h
11942,1,[Hаsu]CreATIve,2163,819,139,143,282,49.3%,32m
11942,1,Ilmarinen,2163,421,11,16,27,40.7%,1h
11942,3,FFD,2163,102,4,19,23,17.4%,33m
11945,1,Alaric,2162,1458,99,105,204,48.5%,3m
11945,2,Славон,2162,354,17,19,36,47.2%,13m
11945,2,PasutusI,2162,282,10,11,21,47.6%,1h
11945,2,Mario,2162,152,6,5,11,54.5%,15m
11945,2,[SCHLIA]luc,2162,178,6,7,13,46.2%,1h
11945,2,mptm,2162,64,4,11,15,26.7%,24m
11951,3,ARKADiE,2161,266,9,9,18,50.0%,32m
11951,1,Merro,2161,248,8,12,20,40.0%,13m
11951,2,ShaiHulud,2161,102,3,3,6,50.0%,41m
11951,2,Ezekiel,2161,0,0,1,1,0.0%,1h
11955,1,Fra,2160,1575,145,151,296,49.0%,19m
11955,1,Pcifir,2160,716,52,43,95,54.7%,1h
11955,2,сергей,2160,286,9,14,23,39.1%,40m
11955,2,[PTVru]Fatality,2160,158,4,2,6,66.7%,1h
11955,1,Bayesd,2160,0,1,7,8,12.5%,28m
11960,1,WillBeSick,2159,1342,68,69,137,49.6%,14m
11960,2,[Ирбис]alex,2159,144,3,6,9,33.3%,28m
11960,2,Vakula,2159,0,2,4,6,33.3%,7m
11963,1,[SCSM]ToolTime,2158,1662,59,62,121,48.8%,1h
11963,2,STARSKY,2158,30,2,0,2,100.0%,23m
11963,2,Изящно,2158,0,0,1,1,0.0%,1h
11966,3,abc,2157,58,2,8,10,20.0%,1h
11966,2,[Додик]ZeroTwo,2157,0,0,1,1,0.0%,38m
11966,2,TheHero,2157,0,0,3,3,0.0%,1h
11969,1,Valkyr,2156,403,24,28,52,46.2%,1h
11969,2,JustNoob,2156,390,14,15,29,48.3%,36m
11969,2,Katisha,2156,210,8,5,13,61.5%,24m
11969,2,ZEUS,2156,126,4,9,13,30.8%,24m
11969,2,StimmedAdict,2156,66,3,2,5,60.0%,38m
11969,1,Wizard,2156,97,2,0,2,100.0%,11m
11969,2,BillyBobba,2156,0,0,5,5,0.0%,1h
11976,2,Iris,2155,637,26,28,54,48.1%,1h
11976,2,Hatana,2155,352,12,10,22,54.5%,21m
11976,2,XXXXXXXXXXX,2155,148,8,6,14,57.1%,1h
11976,1,DerNotch,2155,193,4,9,13,30.8%,1h
11976,1,jean,2155,135,3,8,11,27.3%,32m
11976,2,[NargH]RaffKing,2155,58,2,2,4,50.0%,14m
11982,1,[ZELT]Venom,2154,308,9,19,28,32.1%,21m
11982,1,[360G]rOOfer,2154,0,0,3,3,0.0%,26m
11984,1,rikx,2153,961,35,37,72,48.6%,1h
11984,2,HoBa,2153,0,1,0,1,100.0%,10m
11986,1,LimNylon,2152,1623,71,74,145,49.0%,13m
11986,2,JonGalindo,2152,717,30,25,55,54.5%,13m
11986,2,Anonimee,2152,248,10,8,18,55.6%,27m
11986,3,Roman,2152,97,1,4,5,20.0%,19m
11986,1,HollowKitty,2152,88,1,6,7,14.3%,12m
11991,2,GANIBBAL,2151,774,30,29,59,50.8%,36m
11991,1,[SeVenV]kreker,2151,759,27,30,57,47.4%,18m
11991,2,Plagegeist,2151,420,14,13,27,51.9%,9m
11991,2,Вавилон,2151,415,14,17,31,45.2%,7m
11991,1,[GSCV]Razem,2151,104,2,7,9,22.2%,1h
11991,2,Grekoss,2151,0,0,1,1,0.0%,28m
11997,2,Totowipeout,2150,948,37,35,72,51.4%,21m
11997,2,[UA]Eagle,2150,30,1,2,3,33.3%,1h
11999,2,LolDom,2149,720,30,23,53,56.6%,28m
11999,2,Spleenfloyd,2149,126,5,5,10,50.0%,1h
11999,2,akapest,2149,48,2,3,5,40.0%,1h
11999,1,fabien,2149,0,1,6,7,14.3%,39m
11999,2,kekdambaz,2149,0,0,2,2,0.0%,29m
11999,3,Махно,2149,0,0,5,5,0.0%,33m
12005,2,Leon,2148,803,45,32,77,58.4%,1h
12005,2,BlackVolf,2148,1034,40,42,82,48.8%,36m
12005,2,[khps]Cherembsha,2148,294,10,19,29,34.5%,14m
12005,2,[lRDSl]Addiction,2148,46,1,3,4,25.0%,1h
12009,2,YRK,2147,414,15,16,31,48.4%,8m
12009,2,ASDASDASDASD,2147,222,8,9,17,47.1%,15m
12009,2,Stukov,2147,142,6,4,10,60.0%,3m
12009,3,Janko,2147,30,4,12,16,25.0%,15m
12009,3,Hydro,2147,0,2,3,5,40.0%,12m
12009,2,[XDalek]Tsuki,2147,0,1,4,5,20.0%,12m
12009,2,[Rohal]Omegatherion,2147,0,1,6,7,14.3%,19m
12009,2,[Tic2]lynx,2147,0,0,1,1,0.0%,41m
12017,1,Panasonic,2146,241,6,11,17,35.3%,10m
12017,2,[VCa]Phantom,2146,30,2,0,2,100.0%,40m
12017,2,персифаль,2146,0,1,4,5,20.0%,1h
12017,2,OskaRocKet,2146,0,0,1,1,0.0%,1h
12017,2,GUIWILLY,2146,0,0,2,2,0.0%,1h
12017,3,Uchiha,2146,0,0,5,5,0.0%,1h
12023,2,Kitten,2145,272,10,11,21,47.6%,1h
12023,2,[SPAINs]Mmet,2145,230,7,10,17,41.2%,37m
12023,2,[SergAt]SergBas,2145,30,2,0,2,100.0%,1h
12023,2,Schattenwolf,2145,0,2,1,3,66.7%,28m
12023,2,RudelGurken,2145,0,1,0,1,100.0%,7m
12028,2,[Sc2V]joaquin,2144,398,15,11,26,57.7%,1h
12028,2,LeMoucheur,2144,400,14,21,35,40.0%,1h
12028,1,NottNott,2144,192,7,10,17,41.2%,1h
12028,2,murf,2144,0,4,6,10,40.0%,31m
12028,1,[2iq]XUI,2144,48,2,3,5,40.0%,8m
12033,1,Dritklumpen,2143,696,22,30,52,42.3%,7m
12033,2,[ĽşĐ]LegiT,2143,406,17,22,39,43.6%,1h
12033,2,eljajuar,2143,146,3,2,5,60.0%,1h
12033,2,AmazingMrG,2143,30,1,3,4,25.0%,27m
12033,2,Ебанутый,2143,0,1,5,6,16.7%,21m
12038,1,[MPLC]Alex,2142,879,29,36,65,44.6%,1h
12038,2,Alfa,2142,0,3,5,8,37.5%,25m
12038,1,[baker]PauK,2142,141,2,1,3,66.7%,25m
12038,2,[WAZARD]GarryKSeward,2142,0,1,2,3,33.3%,18m
12038,1,Черепешка,2142,0,0,1,1,0.0%,16m
12038,1,IIIIIIIIIIII,2142,0,0,5,5,0.0%,26m
12044,1,DrÖlüm,2141,1295,146,147,293,49.8%,1h
12044,1,Shtirus,2141,312,10,16,26,38.5%,1h
12044,1,Merlinou,2141,186,5,12,17,29.4%,16m
12044,2,Marcuss,2141,150,4,1,5,80.0%,26m
12044,2,FlasH,2141,72,3,2,5,60.0%,1h
12044,1,bigstalker,2141,48,2,1,3,66.7%,16m
12044,2,mopastar,2141,32,2,5,7,28.6%,1h
12044,2,Sewip,2141,0,1,5,6,16.7%,19m
12044,1,DIMARO,2141,0,0,4,4,0.0%,38m
12044,3,tOfUmaO,2141,0,0,5,5,0.0%,3m
12054,2,saskeeeeee,2140,573,20,24,44,45.5%,41m
12054,2,[DGA]DarthPhallus,2140,162,5,8,13,38.5%,13m
12054,2,Cardo,2140,0,1,0,1,100.0%,37m
12057,2,Blackdream,2139,974,41,52,93,44.1%,32m
12057,2,[scarab]SadlyLacking,2139,564,20,17,37,54.1%,33m
12057,2,[Jotaro]firestargame,2139,224,6,5,11,54.5%,21m
12057,2,AndreanGreen,2139,0,1,1,2,50.0%,36m
12057,2,BTV,2139,30,1,6,7,14.3%,1h
12057,1,Chezs,2139,0,0,1,1,0.0%,14m
12063,1,Devil,2138,192,9,10,19,47.4%,37m
12063,1,[FilsDe]kitach,2138,184,7,11,18,38.9%,14m
12063,2,StyrianTower,2138,0,0,3,3,0.0%,28m
12066,2,claylord,2137,150,5,7,12,41.7%,3m
12066,1,BigILYASS,2137,186,5,13,18,27.8%,1h
12068,2,Borber,2136,526,19,19,38,50.0%,32m
12068,2,comod,2136,397,15,13,28,53.6%,1h
12068,2,ауе,2136,171,4,5,9,44.4%,39m
12068,2,[Eon]Eon,2136,30,1,1,2,50.0%,1h
12068,2,Ryuk,2136,0,0,1,1,0.0%,35m
12068,3,LôrdHass,2136,0,0,4,4,0.0%,34m
12068,3,Hurricane,2136,0,0,5,5,0.0%,3m
12075,2,Brodyaga,2135,136,4,0,4,100.0%,32m
12075,2,Karik,2135,120,4,5,9,44.4%,38m
12075,3,JIEIE,2135,0,1,4,5,20.0%,39m
12078,1,Starship,2134,758,27,31,58,46.6%,1h
12078,2,sramoslyab,2134,32,1,2,3,33.3%,40m
12078,3,Voros,2134,0,0,1,1,0.0%,24m
12078,2,LeGenDarySea,2134,0,0,1,1,0.0%,1h
12082,2,Miiiki,2133,245,10,5,15,66.7%,1h
12082,2,Sedmin,2133,114,4,4,8,50.0%,8m
12082,2,jOuEuR,2133,0,3,2,5,60.0%,1h
12082,2,cuk,2133,92,3,6,9,33.3%,30m
12086,1,Babar,2132,1679,149,156,305,48.9%,30m
12086,1,[OTLSS]wyvernheart,2132,286,21,19,40,52.5%,7m
12086,2,SuperAK,2132,454,15,20,35,42.9%,1h
12086,2,daRkJke,2132,94,2,4,6,33.3%,32m
12090,2,SegunSigai,2131,1068,45,56,101,44.6%,40m
12090,2,[1BR1]MORFrus,2131,376,16,9,25,64.0%,36m
12090,1,mattis,2131,191,7,7,14,50.0%,18m
12090,1,Nif,2131,40,4,5,9,44.4%,39m
12090,2,Momo,2131,0,0,1,1,0.0%,38m
12090,2,Predator,2131,0,0,2,2,0.0%,9m
12090,2,Cilwer,2131,0,0,5,5,0.0%,1h
12097,1,[PS23]IVirtual,2130,1275,67,62,129,51.9%,1h
12097,2,WindCent,2130,270,9,6,15,60.0%,1h
12097,2,Styx,2130,0,0,1,1,0.0%,39m
12097,3,ApOlLOL,2130,0,0,5,5,0.0%,39m
12097,2,katyushas,2130,0,0,6,6,0.0%,1h
12102,2,Élythia,2129,1141,66,69,135,48.9%,3m
12102,1,jebaks,2129,217,7,8,15,46.7%,1h
12102,2,Kaiowas,2129,0,1,6,7,14.3%,1h
12102,1,ALBERTO,2129,0,0,1,1,0.0%,11m
12102,3,Brygadier,2129,0,0,2,2,0.0%,1h
12107,2,Apatia,2128,278,9,7,16,56.2%,7m
12107,2,Mirodasc,2128,0,2,3,5,40.0%,1h
12107,2,Rostovskii,2128,0,1,4,5,20.0%,1h
12107,2,Tientienne,2128,0,0,1,1,0.0%,1h
12111,2,BigC,2127,533,20,18,38,52.6%,10m
12111,3,Sirply,2127,116,3,10,13,23.1%,5m
12111,2,Skvor,2127,0,0,2,2,0.0%,40m
12114,1,MagicPants,2126,1413,67,69,136,49.3%,3m
12114,1,[PECAN]DarthVader,2126,797,34,42,76,44.7%,9m
12114,3,[VKX]ZergZwerg,2126,0,1,4,5,20.0%,1h
12117,2,Ыштынгыздр,2125,527,17,19,36,47.2%,1h
12117,2,СмертоМышь,2125,495,17,21,38,44.7%,3m
12117,2,Акакий,2125,272,9,10,19,47.4%,3m
12117,2,Faust,2125,124,5,7,12,41.7%,3m
12117,2,Destructeur,2125,0,1,5,6,16.7%,28m
12117,3,Jaegar,2125,0,0,5,5,0.0%,1h
12123,1,Elrob,2124,149,4,5,9,44.4%,1h
12123,2,Jormumu,2124,148,3,9,12,25.0%,18m
12123,2,Next,2124,60,2,2,4,50.0%,1h
12123,3,SipSopedie,2124,0,2,7,9,22.2%,33m
12127,2,Comunix,2123,93,1,6,7,14.3%,5m
12127,3,Lukaz,2123,0,0,5,5,0.0%,15m
12129,1,DITIS,2122,332,15,19,34,44.1%,1h
12130,1,PashaBig,2121,162,5,8,13,38.5%,19m
12130,2,Wortigen,2121,0,2,4,6,33.3%,35m
12130,2,[camohi]Mohicanos,2121,0,0,2,2,0.0%,38m
12133,1,SATI,2120,1439,82,88,170,48.2%,20m
12133,1,mauwie,2120,336,10,14,24,41.7%,12m
12133,2,Blackhole,2120,266,8,21,29,27.6%,33m
12133,2,[1squad]alexzero,2120,216,7,12,19,36.8%,26m
12133,1,Bellwoman,2120,166,6,10,16,37.5%,9m
12133,3,Floriank,2120,206,6,16,22,27.3%,23m
12133,2,[TFSC]LittleCaZo,2120,0,1,3,4,25.0%,19m
12140,1,Spoutnik,2119,584,29,34,63,46.0%,1h
12140,2,[ESPION]Askorbik,2119,373,23,26,49,46.9%,12m
12140,2,KUNG,2119,228,9,8,17,52.9%,12m
12140,2,Zoferos,2119,0,1,1,2,50.0%,1h
12140,2,Confessor,2119,0,0,2,2,0.0%,36m
12140,2,[Vizzor]Nikita,2119,0,0,2,2,0.0%,1h
12146,2,Sheras,2118,512,18,21,39,46.2%,1h
12146,2,Atuin,2118,274,11,14,25,44.0%,1h
12146,2,Titouan,2118,278,9,10,19,47.4%,1h
12146,3,rocker,2118,0,0,5,5,0.0%,1h
12146,2,KPSS,2118,0,0,5,5,0.0%,28m
12151,2,Stan,2117,1439,89,91,180,49.4%,1h
12151,2,[vandal]Rob,2117,497,45,40,85,52.9%,13m
12151,2,Flutze,2117,413,14,17,31,45.2%,1h
12151,2,Tofa,2117,76,2,8,10,20.0%,11m
12155,2,ADP,2116,914,83,84,167,49.7%,1h
12155,2,KAin,2116,1272,48,50,98,49.0%,4m
12155,2,CLON,2116,373,14,10,24,58.3%,6m
12155,1,PopCorn,2116,471,13,20,33,39.4%,26m
12155,2,Giloproflex,2116,176,5,3,8,62.5%,42m
12155,3,Sar,2116,0,2,3,5,40.0%,17m
12161,3,Eugeniu,2115,30,5,8,13,38.5%,1h
12161,2,MARIXYANA,2115,102,3,6,9,33.3%,32m
12161,2,[nWss]Overlord,2115,0,1,2,3,33.3%,11m
12161,2,Dom,2115,0,1,4,5,20.0%,42m
12161,2,cookielord,2115,88,1,5,6,16.7%,27m
12161,2,[NeCriN]ZizouLarson,2115,0,0,2,2,0.0%,18m
12167,2,Dambo,2114,554,20,23,43,46.5%,22m
12167,2,Zed,2114,202,8,3,11,72.7%,1h
12167,2,Starkiller,2114,94,4,6,10,40.0%,1h
12170,1,[noоb]Abedulnegro,2113,1672,261,278,539,48.4%,2m
12170,2,BiG,2113,1623,147,149,296,49.7%,38m
12170,2,FENIX,2113,1518,58,64,122,47.5%,1h
12170,2,юра,2113,24,2,5,7,28.6%,33m
12170,2,sztinka,2113,0,1,0,1,100.0%,1h
12170,2,[Cancro]NightMareCPU,2113,0,1,4,5,20.0%,1h
12170,2,Laar,2113,94,1,6,7,14.3%,36m
12170,2,[DHYD]Priest,2113,0,1,7,8,12.5%,5m
12178,2,Aurenen,2112,449,23,25,48,47.9%,1h
12178,1,GeraltOutlaw,2112,328,22,33,55,40.0%,25m
12178,2,[PEOS]LittleTimmy,2112,209,7,6,13,53.8%,1h
12178,1,Tjus,2112,237,7,11,18,38.9%,1h
12178,1,Butcher,2112,200,5,17,22,22.7%,26m
12178,2,Kickert,2112,0,0,6,6,0.0%,34m
12184,2,Ayonarendis,2111,30,2,2,4,50.0%,1h
12184,2,CrazyRaccoon,2111,32,1,6,7,14.3%,36m
12184,3,Androns,2111,0,1,9,10,10.0%,36m
12187,2,MroźnyGnat,2110,1012,39,35,74,52.7%,3m
12187,2,kultalas,2110,543,25,23,48,52.1%,23m
12187,2,Olgon,2110,169,4,9,13,30.8%,19m
12187,1,Lorir,2110,162,3,10,13,23.1%,1h
12191,3,Zerg,2109,1593,109,125,234,46.6%,11m
12191,2,[ANREN]АРСЕНИЙ,2109,192,7,12,19,36.8%,1h
12191,2,BlackRaven,2109,88,1,1,2,50.0%,21m
12194,2,Zeratul,2108,1106,42,45,87,48.3%,18m
12194,2,Fitnesspuff,2108,158,6,5,11,54.5%,1h
12194,1,GogetaSSJ,2108,68,3,9,12,25.0%,4m
12194,2,Arec,2108,0,2,4,6,33.3%,38m
12198,1,KyRen,2107,732,35,42,77,45.5%,21m
12198,1,PsewDoKnight,2107,96,3,1,4,75.0%,26m
12198,2,Itherael,2107,42,1,1,2,50.0%,28m
12201,1,stormtrooper,2106,576,17,23,40,42.5%,1h
12201,3,Vagus,2106,146,4,2,6,66.7%,20m
12201,2,Mar,2106,0,0,1,1,0.0%,22m
12201,2,Tenshoga,2106,0,0,2,2,0.0%,18m
12205,1,Zpapa,2105,1470,99,102,201,49.3%,1h
12205,2,NEWPLAYER,2105,337,28,31,59,47.5%,1h
12205,2,[HAYTER]MMM,2105,449,17,18,35,48.6%,36m
12205,2,Mszczuj,2105,242,10,21,31,32.3%,18m
12205,2,[FanGG]Scorpion,2105,58,2,3,5,40.0%,1h
12205,2,IsaaC,2105,0,0,1,1,0.0%,17m
12211,1,[GAMI]Valounours,2104,146,7,9,16,43.8%,28m
12211,2,THUMBA,2104,0,1,0,1,100.0%,39m
12211,1,XxPAULxX,2104,0,1,7,8,12.5%,8m
12211,2,Bricox,2104,0,0,5,5,0.0%,40m
12215,2,[Chariz]chrZZ,2103,275,9,15,24,37.5%,14m
12215,2,julian,2103,94,1,4,5,20.0%,2m
12215,3,[IceCub]EГОР,2103,0,0,1,1,0.0%,39m
12218,2,Sam,2102,626,23,26,49,46.9%,24m
12218,1,ABCD,2102,265,8,15,23,34.8%,20m
12218,2,Отчаяный,2102,133,3,4,7,42.9%,3m
12218,1,Sarge,2102,0,1,6,7,14.3%,17m
12218,2,[EzD]ikar,2102,0,0,1,1,0.0%,1h
12218,3,CONSUBI,2102,0,0,1,1,0.0%,15m
12218,2,[NSJLM]Steez,2102,0,0,6,6,0.0%,23m
12225,2,Wudu,2101,1092,41,40,81,50.6%,27m
12225,2,Geks,2101,1141,41,49,90,45.6%,36m
12225,2,[DUSH]POTNEX,2101,0,0,2,2,0.0%,23m
12228,2,FENIXTAN,2100,259,10,6,16,62.5%,1h
12228,1,MNS,2100,32,1,11,12,8.3%,1h
12228,2,[LCN]BossEscuDero,2100,0,0,1,1,0.0%,1h
12228,2,bob,2100,0,0,2,2,0.0%,27m
12228,2,Egor,2100,0,0,5,5,0.0%,41m
12233,2,[FR1]BABA,2099,515,22,16,38,57.9%,1h
12233,2,magmus,2099,244,18,20,38,47.4%,37m
12233,2,Barben,2099,242,8,14,22,36.4%,4m
12236,2,Aleaiactaest,2098,907,40,34,74,54.1%,38m
12236,2,[Tuur]Fair,2098,910,34,37,71,47.9%,21m
12236,2,ПАПАНЯ,2098,432,17,15,32,53.1%,1h
12236,1,stylewalker,2098,181,7,10,17,41.2%,40m
12236,3,Sunnygirl,2098,0,1,3,4,25.0%,36m
12236,1,IMPERATOR,2098,48,1,6,7,14.3%,24m
12242,2,MaHuak,2097,1446,285,313,598,47.7%,1h
12242,2,RuskoKiller,2097,1463,90,92,182,49.5%,1h
12242,2,Bullymong,2097,1012,51,53,104,49.0%,31m
12242,2,MAMAKSIO,2097,0,0,5,5,0.0%,19m
12246,2,MnschnFressr,2096,741,27,30,57,47.4%,38m
12246,1,SekaiSenpai,2096,0,2,10,12,16.7%,42m
12248,2,bob,2095,500,18,23,41,43.9%,1h
12248,2,FUSTIGADOR,2095,388,14,17,31,45.2%,18m
12248,3,Рома,2095,30,5,5,10,50.0%,1h
12248,3,Blossom,2095,0,0,5,5,0.0%,1h
12252,2,[OmDi]BoyJoke,2094,1574,96,99,195,49.2%,33m
12252,2,Pupsik,2094,641,59,59,118,50.0%,36m
12252,1,[BWD]JohnCoffey,2094,1164,44,57,101,43.6%,20m
12252,3,rafel,2094,1196,42,58,100,42.0%,16m
12252,1,LOLтакНельзя,2094,315,11,10,21,52.4%,1h
12252,2,АзогСеквар,2094,88,2,0,2,100.0%,22m
12252,2,[Эщкер]deeen,2094,0,1,0,1,100.0%,19m
12259,2,Gottfridd,2093,1065,44,53,97,45.4%,28m
12259,1,Anywhere,2093,318,11,19,30,36.7%,41m
12259,1,[CØG]ZangetsuKuro,2093,197,7,9,16,43.8%,41m
12259,2,[OGPP]Theundermind,2093,170,5,5,10,50.0%,31m
12259,2,[CS0]harken,2093,0,3,4,7,42.9%,1h
12259,2,Tunder,2093,30,2,2,4,50.0%,41m
12259,2,[ZЕRGТV]Sovushka,2093,46,1,1,2,50.0%,5m
12266,2,franjjjj,2092,1546,147,154,301,48.8%,13m
12266,1,[em66]Stef,2092,187,6,9,15,40.0%,3m
12268,2,inSame,2091,30,2,2,4,50.0%,1h
12268,1,Артём,2091,0,1,4,5,20.0%,8m
12268,1,[DECIMA]kierantodds,2091,46,1,6,7,14.3%,19m
12271,2,Uthroy,2090,1131,47,62,109,43.1%,1h
12271,2,Yunuz,2090,906,30,36,66,45.5%,7m
12271,1,[луна]Сергей,2090,394,12,23,35,34.3%,40m
12271,2,obo,2090,0,1,5,6,16.7%,37m
12275,2,PsYkLpWn,2089,745,49,45,94,52.1%,3m
12275,2,DieGrootBaas,2089,570,19,31,50,38.0%,3m
12275,1,Billkong,2089,184,8,12,20,40.0%,2m
12275,3,[COBMEC]VAD,2089,0,1,0,1,100.0%,1h
12275,3,[Z666Zx]zorg,2089,0,1,4,5,20.0%,36m
12280,1,Potato,2088,996,43,40,83,51.8%,11m
12280,1,PurpleBroly,2088,242,10,14,24,41.7%,1h
12280,3,Cemen,2088,0,0,1,1,0.0%,36m
12280,3,ADP,2088,0,0,1,1,0.0%,1h
12280,3,amazon,2088,0,0,5,5,0.0%,39m
12285,2,merlin,2087,1554,68,70,138,49.3%,21m
12285,2,Hokus,2087,384,14,13,27,51.9%,1h
12285,3,DrDeMoon,2087,0,0,5,5,0.0%,18m
12288,3,AzzieElbub,2086,1078,95,106,201,47.3%,21m
12288,2,tuğçe,2086,576,21,25,46,45.7%,1h
12288,2,[bBlitz]Loki,2086,294,10,13,23,43.5%,1h
12288,3,Aemyl,2086,0,1,0,1,100.0%,36m
12288,2,SlaYerTAM,2086,0,1,2,3,33.3%,4m
12288,2,[SyperS]Repzpank,2086,97,1,3,4,25.0%,10m
12288,1,Gabounch,2086,48,1,3,4,25.0%,11m
12288,2,Citta,2086,34,1,5,6,16.7%,1h
12296,2,Gamer,2085,102,2,6,8,25.0%,4m
12296,2,Prikol,2085,0,1,0,1,100.0%,36m
12296,3,Dimriy,2085,38,1,6,7,14.3%,30m
12296,3,Sporthan,2085,0,0,1,1,0.0%,24m
12296,3,tag,2085,0,0,1,1,0.0%,24m
12301,2,PatLOrD,2084,500,18,19,37,48.6%,28m
12301,3,Kinrany,2084,219,8,6,14,57.1%,7m
12301,2,ABDITRETUSEN,2084,156,4,4,8,50.0%,3m
12304,2,MAHO,2083,354,12,15,27,44.4%,1h
12304,2,[scp3]Kane,2083,116,4,4,8,50.0%,13m
12304,3,OFsaID,2083,0,1,5,6,16.7%,24m
12304,2,Tata,2083,0,0,6,6,0.0%,4m
12308,3,boeberking,2082,90,3,4,7,42.9%,33m
12308,3,[AresG]king,2082,30,2,0,2,100.0%,38m
12308,1,[MSNTRP]Hexos,2082,0,2,7,9,22.2%,33m
12308,2,BaanVeredar,2082,30,1,7,8,12.5%,27m
12312,2,Croker,2081,1105,47,46,93,50.5%,37m
12312,2,Alvabar,2081,1114,45,48,93,48.4%,20m
12312,2,[COLI]ORTEGA,2081,295,18,23,41,43.9%,1h
12312,2,PeaceAndLove,2081,264,9,7,16,56.2%,40m
12312,2,Limonchik,2081,94,2,5,7,28.6%,19m
12312,2,Keyenn,2081,0,1,3,4,25.0%,1h
12312,3,Skyraptor,2081,0,0,1,1,0.0%,1h
12312,1,Arseniy,2081,0,0,5,5,0.0%,11m
12320,2,Foreach,2080,1193,47,48,95,49.5%,10m
12320,2,[OЗД]AnimesKun,2080,48,3,7,10,30.0%,22m
12322,2,Zorg,2079,542,20,24,44,45.5%,28m
12323,3,Aiki,2078,90,4,3,7,57.1%,1h
12323,2,Tofisowa,2078,0,1,2,3,33.3%,10m
12325,2,Angst,2077,1560,118,132,250,47.2%,1h
12325,2,Ggamnol,2077,1572,57,71,128,44.5%,29m
12325,2,перс,2077,46,1,6,7,14.3%,5m
12328,2,[SkBG]BojowyRopuch,2076,1534,182,191,373,48.8%,1h
12328,1,Aurèle,2076,1310,56,58,114,49.1%,1h
12328,2,MajorAndy,2076,116,4,7,11,36.4%,1h
12328,3,Noxxl,2076,0,0,5,5,0.0%,6m
12332,1,[Аоуэйя]zajebioza,2075,489,16,23,39,41.0%,1h
12332,2,deimik,2075,0,2,4,6,33.3%,1h
12332,2,scriptacc,2075,0,2,4,6,33.3%,12m
12332,1,woe,2075,0,0,4,4,0.0%,14m
12336,2,[AofK]АБДХШБА,2074,118,4,6,10,40.0%,23m
12336,3,Buran,2074,0,0,5,5,0.0%,21m
12338,2,ZOM,2073,318,8,16,24,33.3%,1h
12338,2,LINCOLN,2073,146,5,8,13,38.5%,21m
12338,3,JBL,2073,0,2,3,5,40.0%,35m
12338,3,GUGSTER,2073,0,0,1,1,0.0%,39m
12338,1,AVAN,2073,0,0,2,2,0.0%,1h
12338,3,AlainNicolas,2073,0,0,5,5,0.0%,19m
12344,2,ZwiTTeR,2072,1536,180,186,366,49.2%,1h
12344,1,surrender,2072,1265,45,69,114,39.5%,25m
12344,3,DDD,2072,254,9,0,9,100.0%,1h
12344,3,zergpro,2072,0,0,1,1,0.0%,4m
12344,3,Chessmaster,2072,0,0,5,5,0.0%,23m
12344,3,TuffGong,2072,0,0,5,5,0.0%,1h
12350,2,MRtraitor,2071,381,16,16,32,50.0%,29m
12350,3,[EvilGG]xarlat,2071,256,9,9,18,50.0%,1h
12350,2,siriuss,2071,176,5,4,9,55.6%,41m
12350,2,drfab,2071,0,2,4,6,33.3%,20m
12350,3,LLIYTHUK,2071,0,0,5,5,0.0%,36m
12355,3,Starlord,2070,212,9,16,25,36.0%,3m
12356,1,Angelicrune,2069,1475,132,141,273,48.4%,1h
12356,2,maks,2069,564,20,26,46,43.5%,1h
12356,1,Yoshi,2069,160,5,3,8,62.5%,1h
12356,3,Vector,2069,30,1,5,6,16.7%,42m
12360,1,Necro,2068,78,3,10,13,23.1%,22m
12360,3,usALar,2068,0,1,0,1,100.0%,1h
12362,1,MerzigEU,2067,338,12,17,29,41.4%,3m
12362,3,Alexeichua,2067,142,7,8,15,46.7%,33m
12362,2,Feniks,2067,88,6,7,13,46.2%,1h
12362,3,ADANRO,2067,190,5,11,16,31.2%,1h
12362,3,iVer,2067,0,3,2,5,60.0%,1h
12362,2,Fractal,2067,97,3,6,9,33.3%,1h
12362,3,unamedjfw,2067,0,1,0,1,100.0%,28m
12362,1,Randall,2067,97,1,4,5,20.0%,1h
12370,2,NTulyakov,2066,274,10,20,30,33.3%,20m
12371,1,OzcV,2065,178,5,11,16,31.2%,13m
12372,2,[HMarch]Realles,2064,286,10,10,20,50.0%,20m
12372,3,SGT,2064,0,2,1,3,66.7%,1h
12374,2,waxzce,2063,1500,156,168,324,48.1%,27m
12374,2,[GGZERG]BeshinyKot,2063,497,18,20,38,47.4%,29m
12374,2,[MWorld]sweatyduck,2063,298,11,13,24,45.8%,21m
12374,2,SHIVA,2063,126,4,7,11,36.4%,21m
12378,1,Peesky,2062,32,4,6,10,40.0%,8m
12379,2,Smiles,2060,672,24,29,53,45.3%,38m
12379,2,Skl,2060,198,9,20,29,31.0%,35m
12379,1,Antonубийца,2060,48,1,3,4,25.0%,18m
12379,1,[шаурм]PIGERROR,2060,0,0,8,8,0.0%,1h
12383,2,dert,2059,152,6,10,16,37.5%,41m
12383,2,[3ЕRGTV]Kot,2059,109,2,2,4,50.0%,1h
12383,2,[RAT01]RatRobain,2059,30,1,6,7,14.3%,1h
12383,2,bmc,2059,0,0,3,3,0.0%,36m
12387,2,leoM,2058,1267,114,120,234,48.7%,1h
12387,3,shaineu,2058,0,2,3,5,40.0%,7m
12387,2,Fenrir,2058,0,2,6,8,25.0%,37m
12390,2,[WEWE]RAGNAR,2057,1558,96,96,192,50.0%,1h
12390,3,[OmDi]sutermisou,2057,950,37,29,66,56.1%,1h
12390,2,DVS,2057,337,12,22,34,35.3%,28m
12390,3,nerazim,2057,0,1,0,1,100.0%,20m
12390,3,NUKESHIP,2057,0,1,0,1,100.0%,24m
12390,2,MyNamesBarry,2057,0,0,3,3,0.0%,6m
12390,3,Phantom,2057,0,0,5,5,0.0%,18m
12397,2,Gruz,2056,208,7,6,13,53.8%,35m
12397,3,HeroSecreT,2056,172,5,11,16,31.2%,18m
12397,1,bodopi,2056,48,3,11,14,21.4%,22m
12397,3,bnbarkas,2056,0,0,1,1,0.0%,12m
12401,1,Roujizi,2055,1635,56,67,123,45.5%,37m
12401,3,[MiiiM]ZiiVOID,2055,0,1,0,1,100.0%,1h
12401,2,Artifem,2055,30,1,3,4,25.0%,38m
12401,3,GravyTrain,2055,0,0,5,5,0.0%,39m
12405,1,Nahratzah,2054,235,6,10,16,37.5%,4m
12405,3,Triatonix,2054,30,2,4,6,33.3%,24m
12405,1,kwasos,2054,0,1,3,4,25.0%,24m
12405,3,Luca,2054,0,0,1,1,0.0%,32m
12405,2,[ABDI]Dadane,2054,0,0,6,6,0.0%,35m
12410,3,drum,2053,158,6,4,10,60.0%,42m
12411,2,[KSMH]KeSeMeKa,2052,419,16,13,29,55.2%,29m
12411,3,Tosondr,2052,166,7,1,8,87.5%,41m
12411,2,Benfor,2052,209,5,4,9,55.6%,17m
12411,3,ДмитрийВремя,2052,0,2,3,5,40.0%,1h
12411,2,kercak,2052,0,2,5,7,28.6%,30m
12411,3,CatLev,2052,0,0,1,1,0.0%,13m
12411,2,[DTCz]altéra,2052,0,0,2,2,0.0%,28m
12418,2,[NiN]snuifduif,2051,928,38,56,94,40.4%,4m
12418,3,DobryKot,2051,0,0,2,2,0.0%,18m
12418,3,sasiti,2051,0,0,5,5,0.0%,1h
12421,2,Eva,2050,199,6,6,12,50.0%,1h
12421,3,Dani,2050,128,6,7,13,46.2%,33m
12421,3,killgarah,2050,0,0,1,1,0.0%,30m
12421,3,cAnAdA,2050,0,0,2,2,0.0%,20m
12425,2,jediknight,2049,240,8,14,22,36.4%,28m
12425,3,[13g12p]brny,2049,0,0,1,1,0.0%,23m
12425,3,kevin,2049,0,0,5,5,0.0%,23m
12428,1,Chapai,2048,261,7,14,21,33.3%,34m
12428,2,Domovoy,2048,166,6,17,23,26.1%,1h
12428,2,Reginald,2048,0,1,5,6,16.7%,1h
12431,1,rak,2047,46,2,1,3,66.7%,17m
12432,2,HarDcore,2046,446,18,19,37,48.6%,36m
12432,1,Sedokiro,2046,0,0,1,1,0.0%,39m
12432,3,Корсаков,2046,0,0,5,5,0.0%,30m
12432,3,UninstallPlz,2046,0,0,6,6,0.0%,3m
12436,2,[RRQ]HaitiFox,2045,30,2,3,5,40.0%,1h
12437,3,[Zavood]Talupoeg,2044,298,12,14,26,46.2%,1h
12437,3,Treviz,2044,236,8,10,18,44.4%,1h
12437,2,IRonin,2044,156,6,9,15,40.0%,1h
12437,3,Apepki,2044,0,0,1,1,0.0%,1h
12441,2,danul,2043,818,28,38,66,42.4%,13m
12441,2,UETIX,2043,318,11,14,25,44.0%,37m
12441,1,[топ4ик]Hommunkulus,2043,0,1,4,5,20.0%,11m
12444,3,FalkDaRula,2042,298,10,14,24,41.7%,16m
12444,1,Panart,2042,132,6,7,13,46.2%,1h
12444,3,[kotner]KotoKing,2042,0,0,1,1,0.0%,1h
12447,3,VVVkEstik,2041,86,3,2,5,60.0%,21m
12447,2,ГрязныйДжони,2041,0,1,8,9,11.1%,25m
12449,3,[HBeS]Nub,2040,946,73,99,172,42.4%,12m
12449,2,[HMB666]Nightmare,2040,497,24,25,49,49.0%,21m
12451,2,Цинга,2039,128,5,7,12,41.7%,24m
12451,2,Crabman,2039,130,3,7,10,30.0%,9m
12451,2,танк,2039,0,1,0,1,100.0%,1h
12454,3,euskal,2038,478,18,10,28,64.3%,33m
12454,1,junior,2038,168,4,7,11,36.4%,7m
12456,2,luke,2037,46,3,9,12,25.0%,13m
12456,3,Qrx,2037,0,3,10,13,23.1%,1h
12456,2,[Herosi]Czareski,2037,0,0,1,1,0.0%,3m
12456,1,Sirk,2037,0,0,4,4,0.0%,1h
12460,1,Yzzin,2036,209,11,8,19,57.9%,1h
12460,1,yay,2036,296,8,12,20,40.0%,1h
12460,3,[Kpa6]cfif,2036,0,0,1,1,0.0%,34m
12460,3,Kyper,2036,0,0,2,2,0.0%,1h
12460,3,ragnarokk,2036,0,0,5,5,0.0%,42m
12465,1,ДикийВолк,2035,490,16,26,42,38.1%,1h
12466,1,iKnowYourMom,2034,797,48,55,103,46.6%,41m
12466,3,Gamer,2034,508,18,13,31,58.1%,4m
12466,3,Digikden,2034,146,6,5,11,54.5%,1h
12466,2,[DZerst]Karlo,2034,133,5,5,10,50.0%,20m
12466,3,McNinja,2034,142,3,8,11,27.3%,12m
12471,3,Factorymouse,2033,90,4,6,10,40.0%,30m
12471,3,NoboLulu,2033,0,1,2,3,33.3%,7m
12473,2,Deus,2032,748,27,30,57,47.4%,33m
12473,2,[ANREN]Stalex,2032,424,16,17,33,48.5%,1h
12473,2,Manogaroff,2032,225,7,13,20,35.0%,26m
12473,1,battleFly,2032,166,3,6,9,33.3%,26m
12473,3,ToPiK,2032,0,2,3,5,40.0%,21m
12478,2,[DoAII]Jepsor,2031,1188,41,46,87,47.1%,1h
12478,3,Phenix,2031,229,10,11,21,47.6%,1h
12478,3,Goyim,2031,248,9,13,22,40.9%,1h
12481,3,stormzss,2030,298,9,13,22,40.9%,1h
12481,3,[BierG]MainRANDOM,2030,88,4,1,5,80.0%,36m
12481,3,[AgnG]LightRider,2030,58,3,1,4,75.0%,1h
12481,3,Andrey,2030,0,1,0,1,100.0%,24m
12481,2,Ganiball,2030,0,1,0,1,100.0%,28m
12481,3,Nevervideo,2030,0,0,1,1,0.0%,6m
12487,3,turtletramp,2029,147,4,3,7,57.1%,1h
12487,3,Jojo,2029,0,3,2,5,60.0%,1h
12487,1,[krest]Azthurano,2029,0,1,0,1,100.0%,6m
12487,1,TWK,2029,0,0,1,1,0.0%,41m
12487,2,[GamerX]Whanos,2029,0,0,1,1,0.0%,8m
12492,2,Wolfer,2028,1564,108,113,221,48.9%,18m
12492,2,Dizzy,2028,1384,98,109,207,47.3%,33m
12492,3,[HRisk]СуперМаг,2028,188,6,7,13,46.2%,32m
12495,3,mav,2027,1072,40,40,80,50.0%,1h
12495,2,[FREESY]Generalskill,2027,204,6,13,19,31.6%,1h
12495,3,playFast,2027,58,2,2,4,50.0%,1h
12498,2,tayz,2026,133,2,4,6,33.3%,10m
12499,1,CTOPAC,2025,750,22,38,60,36.7%,6m
12500,2,ZerggyDoggy,2024,947,64,66,130,49.2%,28m
12500,2,[Silius]Shiza,2024,114,6,4,10,60.0%,23m
12502,2,yopyop,2023,1563,84,101,185,45.4%,1h
12502,3,Hadji,2023,60,3,3,6,50.0%,1h
12502,3,jaanonim,2023,0,0,1,1,0.0%,40m
12502,3,LegendTR,2023,0,0,2,2,0.0%,32m
12506,3,ProfessorT,2022,364,11,20,31,35.5%,1h
12507,2,dodge,2021,1337,163,181,344,47.4%,1h
12507,3,[NVRGUP]Miziq,2021,30,4,4,8,50.0%,20m
12507,3,loomika,2021,0,0,4,4,0.0%,1h
12510,2,Kubaxxx,2020,108,3,6,9,33.3%,1h
12510,3,llllllllllll,2020,0,1,4,5,20.0%,32m
12512,2,SGFindlay,2019,1576,78,84,162,48.1%,24m
12512,2,bewhy,2019,613,39,53,92,42.4%,20m
12512,3,MYTOGEH,2019,58,3,1,4,75.0%,16m
12512,1,Дмитрий,2019,125,2,10,12,16.7%,37m
12516,2,HochPVI,2018,150,6,14,20,30.0%,1h
12516,1,ikane,2018,94,3,6,9,33.3%,24m
12516,3,MrTauri,2018,0,1,4,5,20.0%,20m
12516,3,MisterDark,2018,0,0,1,1,0.0%,20m
12520,2,Manore,2017,239,7,7,14,50.0%,1h
12520,1,TRAFKA,2017,114,7,8,15,46.7%,21m
12522,1,Auswahlliste,2016,480,15,24,39,38.5%,40m
12522,3,DeadWolf,2016,169,4,5,9,44.4%,1h
12522,3,tim,2016,0,0,1,1,0.0%,33m
12522,3,yum,2016,0,0,1,1,0.0%,11m
12526,2,SANTEY,2015,1460,341,383,724,47.1%,1h
12526,3,StreetKid,2015,217,6,6,12,50.0%,1h
12526,2,JuiceBbox,2015,180,5,13,18,27.8%,30m
12526,2,[R4Time]Zeratul,2015,0,1,0,1,100.0%,1h
12526,3,PowerNoob,2015,0,0,2,2,0.0%,36m
12531,2,ГАЛСТАРКРАФ,2014,1531,80,82,162,49.4%,36m
12531,3,Fumety,2014,513,18,25,43,41.9%,1h
12531,3,Yage,2014,178,6,8,14,42.9%,1h
12531,3,Syrus,2014,0,2,3,5,40.0%,1h
12535,3,[AiurRO]Aquasonic,2013,700,25,28,53,47.2%,1h
12535,3,Anko,2013,0,2,2,4,50.0%,1h
12535,2,SkuggStorm,2013,97,1,2,3,33.3%,13m
12535,2,TeRiFy,2013,0,1,6,7,14.3%,1h
12539,2,пук,2012,253,38,30,68,55.9%,12m
12539,2,[САСНЫЕ]ЕБАНУТЫЙ,2012,56,3,3,6,50.0%,28m
12541,3,WingNut,2011,691,25,24,49,51.0%,1h
12541,3,[2RVLV]Gribouille,2011,202,7,9,16,43.8%,18m
12541,3,MAXUS,2011,0,2,3,5,40.0%,1h
12541,3,Мастик,2011,30,1,4,5,20.0%,1h
12541,3,MrDarius,2011,44,1,8,9,11.1%,34m
12541,3,IiIcookieIiI,2011,0,0,6,6,0.0%,17m
12547,3,Filixxx,2010,587,22,14,36,61.1%,24m
12547,2,Gama,2010,306,10,21,31,32.3%,1h
12547,3,Laz,2010,78,3,0,3,100.0%,13m
12547,3,XIMIK,2010,60,2,4,6,33.3%,1h
12547,1,FeLemonTM,2010,34,2,9,11,18.2%,28m
12547,1,SwarmGost,2010,0,0,5,5,0.0%,31m
12547,3,MikeyMike,2010,0,0,5,5,0.0%,21m
12554,1,Undrion,2009,165,5,12,17,29.4%,13m
12554,3,[SHTORM]Shaman,2009,62,2,4,6,33.3%,35m
12554,3,Lavan,2009,0,0,1,1,0.0%,1h
12557,1,Ryuuzaki,2008,414,14,23,37,37.8%,1h
12557,3,kuzima,2008,292,10,9,19,52.6%,8m
12557,3,Nesstk,2008,187,6,3,9,66.7%,1h
12560,2,Deusmore,2007,520,18,23,41,43.9%,38m
12560,2,Zpapaone,2007,440,15,20,35,42.9%,28m
12560,2,Panda,2007,140,4,10,14,28.6%,1h
12560,3,RYDER,2007,36,1,2,3,33.3%,1h
12560,2,RBpanther,2007,0,1,6,7,14.3%,28m
12565,3,camardon,2006,0,1,1,2,50.0%,36m
12566,3,JukeboxDK,2005,0,1,0,1,100.0%,29m
12566,3,sasha,2005,0,0,1,1,0.0%,34m
12566,2,mangodehuey,2005,0,0,2,2,0.0%,1h
12569,1,MacWaldspast,2004,931,33,44,77,42.9%,37m
12570,2,GioC,2003,656,23,29,52,44.2%,1h
12570,2,RosaCherokee,2003,330,13,25,38,34.2%,30m
12570,3,Kyoru,2003,315,10,16,26,38.5%,41m
12570,3,[ImbaSC]Engineer,2003,60,3,1,4,75.0%,10m
12570,3,Highvoid,2003,30,2,0,2,100.0%,1h
12570,1,[kek34]МиниНиндзя,2003,0,1,0,1,100.0%,1h
12570,3,KnightValmir,2003,0,0,5,5,0.0%,1h
12577,3,[9Lives]Honey,2002,30,2,2,4,50.0%,33m
12577,3,[BULB]Faraday,2002,95,1,2,3,33.3%,23m
12577,3,Sonozaki,2002,0,1,4,5,20.0%,1h
12577,3,Fatih,2002,0,0,1,1,0.0%,10m
12581,3,LiNo,2001,322,12,12,24,50.0%,23m
12582,2,Райдер,2000,602,23,26,49,46.9%,1h
12582,3,GroMinet,2000,152,5,8,13,38.5%,1h
12584,3,[NOOBpl]Frank,1999,234,9,10,19,47.4%,1h
12584,3,[ĽşĐ]ÇâŅňÅƀĪş,1999,58,2,3,5,40.0%,1h
12584,1,ghost,1999,96,2,6,8,25.0%,24m
12584,3,Zaornak,1999,42,1,7,8,12.5%,19m
12584,2,DaRtiZ,1999,0,0,1,1,0.0%,17m
12584,2,Riccardo,1999,0,0,4,4,0.0%,40m
12590,2,racok,1998,907,31,44,75,41.3%,1h
12590,2,cykplanet,1998,184,6,13,19,31.6%,29m
12590,3,твойбатя,1998,0,1,5,6,16.7%,1h
12593,3,Jaskóła,1997,132,4,8,12,33.3%,21m
12593,2,BloodyRusk,1997,128,3,8,11,27.3%,1h
12593,2,skykontra,1997,0,0,3,3,0.0%,13m
12593,3,Dekel,1997,0,0,5,5,0.0%,34m
12597,2,davidq,1996,852,34,35,69,49.3%,9m
12597,3,SACHA,1996,97,1,1,2,50.0%,41m
12597,3,Slapper,1996,0,0,5,5,0.0%,36m
12600,3,rams,1995,402,23,20,43,53.5%,1h
12600,3,Nerpa,1995,193,5,7,12,41.7%,1h
12602,3,POLy,1994,258,9,8,17,52.9%,24m
12602,2,WiThErOsE,1994,166,3,1,4,75.0%,12m
12602,3,Saman,1994,66,2,1,3,66.7%,1h
12602,3,[RMF]Ферыч,1994,0,0,6,6,0.0%,17m
12606,2,Loko,1993,468,26,26,52,50.0%,36m
12607,3,broc,1992,34,3,4,7,42.9%,39m
12607,2,DooM,1992,0,2,6,8,25.0%,1h
12607,3,MMAzerg,1992,0,0,1,1,0.0%,36m
12610,2,MajorFlinch,1991,996,34,42,76,44.7%,20m
12610,2,Nysumo,1991,862,33,31,64,51.6%,32m
12610,2,Uranhön,1991,303,19,22,41,46.3%,7m
12610,3,Mikael,1991,18,1,2,3,33.3%,1h
12610,1,Keg,1991,0,1,9,10,10.0%,15m
12610,2,[Teor]OnlyTrueNOOB,1991,0,0,2,2,0.0%,3m
12616,3,Warwan,1990,742,25,30,55,45.5%,8m
12616,2,Tediforworld,1990,188,7,15,22,31.8%,10m
12616,1,RiSe,1990,148,4,11,15,26.7%,1h
12619,3,BrentheGreat,1989,392,14,17,31,45.2%,1h
12619,2,RanL,1989,156,6,9,15,40.0%,1h
12619,2,Ombre,1989,88,4,4,8,50.0%,1h
12619,3,[kiler]Baltha,1989,60,3,2,5,60.0%,24m
12619,3,drspartnil,1989,0,2,3,5,40.0%,16m
12619,2,JeanMichel,1989,62,2,9,11,18.2%,1h
12619,3,KlikoBoom,1989,0,0,1,1,0.0%,19m
12619,3,cmoival,1989,0,0,4,4,0.0%,1h
12627,3,MSW,1988,599,22,18,40,55.0%,18m
12627,2,buduumnee,1988,355,19,14,33,57.6%,1h
12629,2,chrysa,1987,1433,90,109,199,45.2%,7m
12629,2,ivod,1987,381,16,16,32,50.0%,10m
12629,2,danik,1987,60,2,10,12,16.7%,21m
12629,3,ROSTOHEKNUKI,1987,0,1,5,6,16.7%,1h
12629,3,[CrBd]ALittleBit,1987,0,0,2,2,0.0%,1h
12634,3,defaultname,1986,30,2,12,14,14.3%,33m
12634,3,jysus,1986,30,1,7,8,12.5%,1h
12636,3,Мирослав,1985,442,14,19,33,42.4%,18m
12636,3,KonRan,1985,58,2,1,3,66.7%,7m
12636,2,hammer,1985,30,1,2,3,33.3%,20m
12639,3,heisenberg,1984,837,33,30,63,52.4%,22m
12639,3,wesołaFoka,1984,166,4,11,15,26.7%,1h
12639,2,[Cooop]Reynor,1984,0,0,1,1,0.0%,1h
12642,2,Fuсker,1983,944,40,46,86,46.5%,20m
12642,1,ghost,1983,0,0,2,2,0.0%,39m
12642,3,GuDviN,1983,0,0,6,6,0.0%,13m
12645,2,SilverFox,1982,884,38,38,76,50.0%,1h
12645,2,Oshikuru,1982,358,26,33,59,44.1%,1h
12645,2,vladvolk,1982,48,4,6,10,40.0%,1h
12645,3,HellRaider,1982,0,1,0,1,100.0%,1h
12645,3,Master,1982,0,0,1,1,0.0%,1h
12650,3,Petro,1981,97,2,1,3,66.7%,1h
12650,3,rambosoy,1981,0,1,5,6,16.7%,1h
12650,3,Snorrski,1981,0,0,6,6,0.0%,17m
12653,1,Electricfish,1980,330,11,21,32,34.4%,1h
12653,3,SolArgenti,1980,176,6,5,11,54.5%,10m
12653,3,Lifetime,1980,58,6,9,15,40.0%,1h
12656,2,BigS,1978,1514,86,96,182,47.3%,32m
12656,3,DustyFrog,1978,30,3,5,8,37.5%,7m
12656,2,Damarantho,1978,128,3,7,10,30.0%,21m
12656,1,[45IQ]DRED,1978,73,0,5,5,0.0%,19m
12660,3,Mystic,1977,1012,73,80,153,47.7%,22m
12660,3,jackhammer,1977,890,49,49,98,50.0%,1h
12660,2,[GDZg]KOJIbIBAH,1977,734,31,39,70,44.3%,42m
12660,3,[3ЕRGTV]Kaori,1977,206,7,5,12,58.3%,29m
12660,2,evrIka,1977,0,0,1,1,0.0%,12m
12665,3,Pain,1975,204,8,12,20,40.0%,11m
12665,3,[420GG]Chiken,1975,30,2,6,8,25.0%,3m
12667,2,Noumaios,1974,561,32,43,75,42.7%,26m
12667,2,Lokkee,1974,308,21,20,41,51.2%,13m
12667,3,Boven,1974,404,14,20,34,41.2%,21m
12667,3,JamesCole,1974,30,1,1,2,50.0%,1h
12671,3,Sargas,1973,0,0,1,1,0.0%,20m
12672,2,[54D]doni,1972,923,33,40,73,45.2%,21m
12672,2,Krechet,1972,137,2,5,7,28.6%,1h
12672,2,DEBGAME,1972,60,2,8,10,20.0%,9m
12672,2,FrankGotti,1972,0,0,7,7,0.0%,10m
12676,3,Ryuk,1971,137,4,7,11,36.4%,1h
12676,3,Kylo,1971,74,2,5,7,28.6%,39m
12676,3,Chiefgogo,1971,0,0,1,1,0.0%,11m
12679,2,Snoopy,1970,209,5,4,9,55.6%,1h
12679,1,IIIIIIIIIIII,1970,115,2,1,3,66.7%,16m
12679,2,NooBot,1970,114,2,8,10,20.0%,1h
12679,3,hugh,1970,0,1,3,4,25.0%,18m
12679,3,[batPT]Daxter,1970,0,0,1,1,0.0%,28m
12679,3,kotBazilyo,1970,0,0,1,1,0.0%,23m
12685,2,FROL,1969,936,33,38,71,46.5%,40m
12685,2,Cronos,1969,230,8,12,20,40.0%,16m
12685,3,SarkyPad,1969,0,0,2,2,0.0%,21m
12685,3,Phoenix,1969,0,0,2,2,0.0%,14m
12685,3,Cyberslav,1969,0,0,3,3,0.0%,10m
12690,2,sarkofa,1968,643,65,62,127,51.2%,1h
12690,2,Focus,1968,554,19,27,46,41.3%,1h
12690,3,myplayer,1968,293,10,7,17,58.8%,33m
12690,3,Аларий,1968,0,0,1,1,0.0%,6m
12694,2,BluB,1967,963,38,48,86,44.2%,18m
12694,2,Céphalotank,1967,315,10,16,26,38.5%,20m
12694,1,Daddy,1967,239,4,15,19,21.1%,40m
12694,3,DarkFist,1967,38,1,7,8,12.5%,34m
12698,3,[MASTOR]ThelwKrepes,1966,259,8,9,17,47.1%,1h
12698,3,DannyBoi,1966,0,3,2,5,60.0%,20m
12698,3,Vodachka,1966,0,3,2,5,60.0%,1h
12701,3,Gamerlolly,1965,122,3,7,10,30.0%,5m
12702,2,NoUpgrades,1964,1306,70,80,150,46.7%,10m
12702,2,[AnQ]Oldie,1964,324,11,22,33,33.3%,1h
12702,3,HighWisnia,1964,272,8,18,26,30.8%,1h
12702,1,NaraNN,1964,138,3,5,8,37.5%,17m
12706,3,PoF,1963,575,21,20,41,51.2%,23m
12706,1,aaron,1963,474,16,32,48,33.3%,37m
12708,1,DarkSerg,1962,289,5,17,22,22.7%,25m
12708,3,TheThirdDay,1962,116,3,3,6,50.0%,1h
12708,3,arsc,1962,0,0,1,1,0.0%,39m
12711,1,AJzzz,1961,251,6,16,22,27.3%,31m
12711,3,[Smarty]SeregaL,1961,30,2,1,3,66.7%,42m
12711,2,MasterLom,1961,62,2,11,13,15.4%,38m
12714,3,Fedor,1960,88,4,6,10,40.0%,24m
12714,1,VatanBayrak,1960,120,4,13,17,23.5%,13m
12714,3,exec,1960,0,0,7,7,0.0%,35m
12717,2,JonasDT,1959,304,10,15,25,40.0%,1h
12717,3,smok,1959,30,1,2,3,33.3%,30m
12719,1,Rubiogoe,1958,1412,290,307,597,48.6%,1h
12720,3,Maze,1957,1342,49,52,101,48.5%,8m
12720,2,MDK,1957,409,16,29,45,35.6%,32m
12722,3,Matt,1956,102,6,7,13,46.2%,8m
12722,3,BlaCkCruNk,1956,146,6,9,15,40.0%,38m
12722,3,romarioaggro,1956,116,5,4,9,55.6%,1h
12722,3,FRIZua,1956,0,1,4,5,20.0%,1h
12726,3,Strider,1955,36,4,3,7,57.1%,21m
12726,3,Irokönomicho,1955,147,3,2,5,60.0%,11m
12726,3,Wesker,1955,0,1,2,3,33.3%,21m
12729,3,Relicanth,1954,0,3,2,5,60.0%,1h
12729,3,DON,1954,0,0,1,1,0.0%,23m
12729,2,[Rofler]Madusa,1954,0,0,3,3,0.0%,13m
12732,3,Косикос,1953,1607,98,111,209,46.9%,1h
12732,3,lfybkf,1953,1512,71,78,149,47.7%,1h
12732,3,killkissboy,1953,410,15,18,33,45.5%,1h
12732,2,WingsOfFire,1953,132,5,6,11,45.5%,1h
12736,3,alka,1952,36,2,6,8,25.0%,1h
12737,2,IVLEGION,1951,672,25,38,63,39.7%,38m
12737,2,miha,1951,320,15,32,47,31.9%,14m
12737,3,IvenTV,1951,70,3,2,5,60.0%,36m
12740,2,MINE,1949,1143,73,81,154,47.4%,23m
12740,3,kmadhad,1949,289,11,15,26,42.3%,18m
12740,3,[Listic]Jeppsson,1949,30,2,1,3,66.7%,30m
12740,3,Apøphis,1949,38,2,4,6,33.3%,1h
12744,3,BrewedWar,1948,0,0,6,6,0.0%,24m
12745,3,Liric,1947,30,1,3,4,25.0%,42m
12746,3,Derble,1946,742,26,23,49,53.1%,1h
12746,3,RealityShift,1946,589,20,21,41,48.8%,1h
12748,3,GhosT,1945,1399,58,69,127,45.7%,13m
12749,3,Бориска,1944,737,27,34,61,44.3%,1h
12749,3,adato,1944,0,1,4,5,20.0%,1h
12749,3,STYPLA,1944,0,0,1,1,0.0%,22m
12752,1,GenzGame,1943,62,3,11,14,21.4%,1h
12752,2,[OkTM]MAJI,1943,133,2,6,8,25.0%,1h
12754,2,КеряЭрудит,1942,159,4,3,7,57.1%,25m
12755,2,BASILE,1941,1040,38,44,82,46.3%,36m
12756,3,shadowdanil,1940,183,6,4,10,60.0%,42m
12756,3,CorolJab,1940,0,3,1,4,75.0%,20m
12756,3,Speld,1940,0,1,0,1,100.0%,36m
12756,3,Feketevölgy,1940,0,0,1,1,0.0%,36m
12756,3,ANTILIUS,1940,0,0,2,2,0.0%,1h
12761,3,MagicPylon,1939,162,4,2,6,66.7%,1h
12761,3,Otshelnik,1939,0,0,2,2,0.0%,1h
12763,2,TanZZzzz,1938,677,94,108,202,46.5%,1h
12763,3,Stown,1938,30,2,2,4,50.0%,24m
12763,3,luftig,1938,30,2,6,8,25.0%,7m
12766,3,Nick,1936,1219,41,51,92,44.6%,1h
12766,3,Cesar,1936,473,18,10,28,64.3%,1h
12766,2,matthias,1936,154,5,14,19,26.3%,1h
12766,2,solo,1936,109,3,2,5,60.0%,1h
12766,2,darioyannis,1936,92,2,8,10,20.0%,30m
12771,2,McJohnny,1935,1067,37,46,83,44.6%,29m
12771,2,sanivek,1935,192,4,7,11,36.4%,7m
12771,3,Rosomak,1935,135,3,5,8,37.5%,1h
12774,3,Dschadir,1934,495,18,19,37,48.6%,33m
12774,2,bimmbalas,1934,0,2,5,7,28.6%,1h
12774,3,Zeevonk,1934,0,1,4,5,20.0%,1h
12777,3,trelled,1933,152,3,8,11,27.3%,1h
12777,2,Cohen,1933,0,1,6,7,14.3%,1h
12779,3,Escanor,1932,912,36,37,73,49.3%,4m
12779,3,PARITY,1932,366,16,17,33,48.5%,1h
12779,3,[PGYT]LiquidClem,1932,451,16,21,37,43.2%,1h
12779,3,RUSMarkuel,1932,278,9,14,23,39.1%,1h
12779,3,[VGZR]Swaffeln,1932,143,3,8,11,27.3%,1h
12779,3,White,1932,0,0,1,1,0.0%,1h
12785,3,Fibo,1931,626,24,30,54,44.4%,1h
12785,3,hellstarrr,1931,118,6,8,14,42.9%,19m
12785,3,arch,1931,0,1,0,1,100.0%,42m
12785,3,[Jail]Asyreus,1931,0,0,3,3,0.0%,1h
12785,3,Amalthea,1931,0,0,6,6,0.0%,1h
12790,2,Comandos,1930,156,3,3,6,50.0%,1h
12790,3,[RGSC2]MrLEzOffFire,1930,0,1,2,3,33.3%,29m
12790,3,asdfsadf,1930,30,1,7,8,12.5%,8m
12793,3,iTzVodka,1929,598,23,23,46,50.0%,42m
12793,3,Wave,1929,352,11,22,33,33.3%,1h
12793,3,DirtLeague,1929,0,1,4,5,20.0%,1h
12793,3,Leonard,1929,0,0,1,1,0.0%,22m
12793,3,[UBES]Menorieth,1929,0,0,5,5,0.0%,30m
12798,2,ЕдкийЁбжик,1928,1363,122,135,257,47.5%,1h
12798,3,Mason,1928,448,14,22,36,38.9%,1h
12798,3,Jurrow,1928,30,1,8,9,11.1%,1h
12798,3,Elke,1928,0,0,1,1,0.0%,1h
12798,3,Ted,1928,0,0,2,2,0.0%,4m
12803,3,starhant,1927,681,26,28,54,48.1%,8m
12804,3,[G3O]ShenaniGans,1926,1511,331,365,696,47.6%,1h
12804,2,CatarroSporc,1926,30,4,7,11,36.4%,1h
12804,3,zerzilot,1926,0,2,1,3,66.7%,24m
12804,3,[MVV77]Hero,1926,0,0,1,1,0.0%,8m
12808,3,raggnar,1925,121,3,1,4,75.0%,19m
12809,3,SLVsektor,1923,0,0,1,1,0.0%,39m
12809,3,Titou,1923,0,0,3,3,0.0%,4m
12811,2,Krasiolet,1922,347,11,18,29,37.9%,38m
12811,3,Enarova,1922,305,9,16,25,36.0%,17m
12811,3,SergeyUA,1922,148,5,6,11,45.5%,1h
12814,3,redarmy,1921,88,1,1,2,50.0%,19m
12815,3,Turar,1920,0,0,3,3,0.0%,1h
12816,1,terminateboy,1919,226,7,15,22,31.8%,11m
12816,3,ValliriusACV,1919,0,1,2,3,33.3%,20m
12816,1,physicist,1919,48,1,2,3,33.3%,34m
12819,1,Necro,1917,140,3,1,4,75.0%,18m
12819,3,serBlack,1917,0,2,4,6,33.3%,1h
12821,3,Vanber,1915,0,1,0,1,100.0%,36m
12821,3,WorstPlayer,1915,0,1,3,4,25.0%,1h
12823,3,[Y3БАН]kirlan,1912,410,15,26,41,36.6%,41m
12823,3,OQPAKCDQ,1912,86,3,7,10,30.0%,28m
12823,1,egorstarkraw,1912,0,2,3,5,40.0%,1h
12823,1,seregaklus,1912,48,1,2,3,33.3%,5m
12827,3,Brags,1910,224,11,10,21,52.4%,1h
12828,3,bartol,1909,30,2,2,4,50.0%,11m
12828,1,RAW,1909,0,0,1,1,0.0%,14m
12830,3,[Gamaw]HellGhost,1908,34,1,6,7,14.3%,1h
12831,3,MasterKrismo,1907,244,9,12,21,42.9%,1h
12831,1,WuTanG,1907,73,0,2,2,0.0%,8m
12833,3,Stefano,1906,238,8,12,20,40.0%,37m
12833,3,zeus,1906,96,2,5,7,28.6%,18m
12833,1,HeroMarine,1906,0,0,5,5,0.0%,18m
12836,1,playforfun,1905,350,9,3,12,75.0%,11m
12836,3,GummY,1905,96,1,3,4,25.0%,20m
12838,1,FrissFaust,1904,92,2,3,5,40.0%,6m
12838,3,JJustice,1904,0,1,1,2,50.0%,1h
12838,3,[2L33T]KimJongSkill,1904,0,0,8,8,0.0%,28m
12841,3,Adaś,1903,611,21,32,53,39.6%,39m
12842,3,SCHROTTPILZ,1902,500,17,25,42,40.5%,1h
12842,1,Kagayaga,1902,527,14,24,38,36.8%,1h
12842,3,[NINJ88]Ragman,1902,292,11,12,23,47.8%,1h
12842,2,BunkerWolf,1902,168,5,9,14,35.7%,1h
12842,1,adrimax,1902,0,2,3,5,40.0%,34m
12842,3,zergslayer,1902,32,1,2,3,33.3%,1h
12842,1,Forestcat,1902,0,0,1,1,0.0%,12m
12849,2,Vila,1901,1142,140,154,294,47.6%,42m
12849,3,Ben,1901,144,5,6,11,45.5%,24m
12849,1,Dcru,1901,0,0,1,1,0.0%,23m
12849,2,dominatorx,1901,0,0,4,4,0.0%,1h
12853,3,[svinik]ArmoredRaven,1900,249,9,14,23,39.1%,1h
12854,3,maxka,1899,617,23,33,56,41.1%,4m
12854,3,DuranDuran,1899,374,13,19,32,40.6%,7m
12856,3,Дамбалдор,1898,95,4,7,11,36.4%,1h
12856,3,NCHSııLøukid,1898,0,1,4,5,20.0%,31m
12856,2,[YpT]sebbix,1898,0,0,9,9,0.0%,1h
12859,1,JohnCena,1897,1562,424,462,886,47.9%,1h
12859,3,kufargery,1897,147,4,7,11,36.4%,38m
12861,2,Даве,1896,1145,129,145,274,47.1%,18m
12861,3,DUMMSDEI,1896,395,15,17,32,46.9%,1h
12861,1,[ICCCPI]Юрион,1896,322,7,12,19,36.8%,20m
12861,3,[Wasp7]hyungyoon,1896,40,1,8,9,11.1%,36m
12861,1,[1svin]IIuTaCHoK,1896,0,0,1,1,0.0%,1h
12861,3,MTC,1896,0,0,1,1,0.0%,6m
12867,1,Turamir,1895,101,4,18,22,18.2%,21m
12868,3,Yoghy,1894,345,12,7,19,63.2%,20m
12869,1,Stranken,1893,687,22,34,56,39.3%,1h
12869,2,Ashu,1893,464,18,25,43,41.9%,21m
12869,3,Atheh,1893,94,3,9,12,25.0%,39m
12869,3,BaadnewZ,1893,0,1,1,2,50.0%,42m
12869,2,Leonidas,1893,0,0,10,10,0.0%,3m
12874,3,Flip,1892,148,4,5,9,44.4%,35m
12874,3,ПаДж,1892,30,2,7,9,22.2%,1h
12876,3,[SEBULA]mixedmix,1891,271,11,18,29,37.9%,21m
12876,3,[NOSV]Nosferatul,1891,116,4,7,11,36.4%,1h
12878,3,[Сold]спартазерга,1890,147,3,5,8,37.5%,1h
12878,3,Dozzzerboss,1890,68,2,3,5,40.0%,39m
12880,3,Skrem,1889,76,3,1,4,75.0%,24m
12880,1,ToiletDive,1889,0,0,1,1,0.0%,36m
12882,1,[TAW]Thunderchild,1887,96,2,6,8,25.0%,4m
12883,1,llIllIllI,1886,702,19,8,27,70.4%,12m
12883,2,WeakNess,1886,130,3,13,16,18.8%,40m
12885,3,tomaskhan,1885,0,0,5,5,0.0%,17m
12886,3,[Croqus]Rastacoolo,1884,248,8,17,25,32.0%,1h
12886,1,Lion,1884,156,4,11,15,26.7%,11m
12888,1,LIKMIJNBALLE,1883,136,7,2,9,77.8%,24m
12888,1,nesha,1883,74,3,12,15,20.0%,13m
12888,3,Jeff,1883,0,0,5,5,0.0%,36m
12891,1,[Un00bz]Azyryx,1882,0,1,0,1,100.0%,16m
12891,3,[Upva]kozaknt,1882,0,0,3,3,0.0%,32m
12893,2,KorowaNaHaip,1881,76,5,8,13,38.5%,40m
12893,3,Hydra,1881,0,0,3,3,0.0%,1h
12895,3,Roblochon,1880,150,6,11,17,35.3%,4m
12895,3,CoronaVirus,1880,0,1,0,1,100.0%,6m
12895,3,Pluton,1880,0,0,5,5,0.0%,4m
12898,2,obiksus,1879,38,2,1,3,66.7%,1h
12898,3,Tomatovic,1879,0,1,1,2,50.0%,1h
12900,3,Inquisitor,1877,1258,148,160,308,48.1%,24m
12900,2,Xecautioner,1877,142,5,8,13,38.5%,1h
12902,1,Charasa,1876,454,11,14,25,44.0%,1h
12902,3,Jamespot,1876,0,0,4,4,0.0%,23m
12904,3,Treydor,1875,38,3,8,11,27.3%,34m
12905,3,tartarin,1874,829,29,33,62,46.8%,10m
12905,3,Аста,1874,114,3,5,8,37.5%,19m
12907,3,CannonRusher,1873,58,2,6,8,25.0%,24m
12907,1,Бугага,1873,46,1,4,5,20.0%,5m
12907,1,Megalovania,1873,0,0,1,1,0.0%,35m
12910,3,[iHold]GrosStick,1872,58,2,7,9,22.2%,34m
12911,3,Prosvet,1870,1056,76,102,178,42.7%,33m
12911,1,beregmira,1870,92,3,2,5,60.0%,8m
12911,3,[P2T]suita,1870,0,0,4,4,0.0%,4m
12914,3,нагибатор,1869,0,2,3,5,40.0%,19m
12914,2,krzychustach,1869,44,1,3,4,25.0%,31m
12914,3,gogo,1869,0,0,1,1,0.0%,24m
12917,2,[GEC]PfleGer,1868,1024,56,70,126,44.4%,23m
12918,2,Rixifox,1867,156,6,9,15,40.0%,4m
12918,3,kart,1867,30,3,7,10,30.0%,5m
12918,3,Storm,1867,0,0,3,3,0.0%,1h
12921,3,Alfirionfirs,1864,378,15,20,35,42.9%,42m
12921,1,Victor,1864,132,3,2,5,60.0%,6m
12921,3,MaliMarko,1864,0,2,3,5,40.0%,17m
12921,2,tom,1864,0,0,8,8,0.0%,24m
12925,1,GoodbaD,1863,0,1,0,1,100.0%,42m
12925,1,DreadLord,1863,106,1,4,5,20.0%,1h
12925,3,[Тянки]Reaper,1863,0,0,1,1,0.0%,22m
12928,3,Averon,1862,767,28,42,70,40.0%,8m
12928,3,slvian,1862,62,3,7,10,30.0%,38m
12928,1,blade,1862,0,2,13,15,13.3%,3m
12928,3,Leonidas,1862,30,2,13,15,13.3%,18m
12932,3,Antey,1861,0,0,1,1,0.0%,1h
12933,3,DyBHkJngwr,1860,58,2,11,13,15.4%,13m
12933,3,Wmonster,1860,30,1,2,3,33.3%,22m
12933,1,Edward,1860,0,1,4,5,20.0%,16m
12936,1,Elthachou,1859,1193,32,37,69,46.4%,1h
12936,1,Atilla,1859,0,0,1,1,0.0%,12m
12936,3,[ßnDª]jobran,1859,0,0,3,3,0.0%,4m
12939,2,Nitrogen,1858,964,33,47,80,41.2%,22m
12939,3,SeñorCogollo,1858,127,3,6,9,33.3%,11m
12941,1,[РусЭл]roboji,1857,0,1,4,5,20.0%,34m
12942,1,Dexter,1856,490,12,25,37,32.4%,40m
12942,1,RYP,1856,0,0,1,1,0.0%,17m
12944,3,[Zhig]хитрый,1854,809,27,33,60,45.0%,1h
12944,1,Pushnoyzver,1854,360,9,7,16,56.2%,25m
12946,3,zebulon,1852,282,9,20,29,31.0%,4m
12946,3,Sesalin,1852,0,3,3,6,50.0%,1h
12948,3,Mcannin,1851,476,17,23,40,42.5%,1h
12948,3,zeekazavr,1851,38,1,3,4,25.0%,4m
12948,3,[Сold]даникпро,1851,0,0,7,7,0.0%,42m
12951,1,[IomgI]Gent,1850,94,2,4,6,33.3%,1h
12951,1,AlphaA,1850,73,1,5,6,16.7%,16m
12953,1,[EliteX]IlllIllllI,1849,456,12,15,27,44.4%,1h
12953,1,MaXpOwEr,1849,0,1,3,4,25.0%,1h
12953,3,tal,1849,30,1,3,4,25.0%,6m
12956,1,[pOc]AvP,1847,1559,262,341,603,43.4%,1h
12956,1,vrillette,1847,78,2,3,5,40.0%,7m
12958,1,Robbie,1845,650,15,18,33,45.5%,24m
12958,1,kirito,1845,0,0,2,2,0.0%,16m
12958,3,Archalia,1845,0,0,5,5,0.0%,6m
12961,3,Vodoley,1844,304,10,13,23,43.5%,1h
12962,3,Kostyra,1843,30,1,3,4,25.0%,1h
12962,2,Bakaow,1843,0,0,6,6,0.0%,1h
12964,3,Falke,1842,0,0,6,6,0.0%,1h
12965,3,SirTobi,1840,0,3,3,6,50.0%,17m
12966,1,Shefutinskiy,1839,0,0,5,5,0.0%,36m
12967,1,[Heroes]CrashDragon,1838,740,24,52,76,31.6%,4m
12967,3,JOSE,1838,200,6,15,21,28.6%,1h
12969,2,[TXNOOB]Sephiroth,1837,269,7,15,22,31.8%,1h
12970,1,[AniME6]ToBi,1836,48,2,3,5,40.0%,20m
12970,1,[Radium]ElinaRosle,1836,0,1,0,1,100.0%,27m
12972,3,Dood,1834,0,1,7,8,12.5%,19m
12973,1,SakeKujira,1833,244,7,16,23,30.4%,10m
12973,2,Paul,1833,208,6,16,22,27.3%,1h
12975,2,[Colony]MacGyver,1832,1475,108,125,233,46.4%,1h
12975,2,[xRoSS]KuroYonu,1832,327,10,16,26,38.5%,36m
12975,3,OlesiaYur,1832,122,4,6,10,40.0%,31m
12975,3,VoidOverlord,1832,0,0,6,6,0.0%,37m
12979,3,Talisca,1830,30,3,15,18,16.7%,22m
12980,1,Juuzo,1829,0,0,3,3,0.0%,3m
12981,3,Vladonator,1826,205,6,17,23,26.1%,14m
12981,3,[mstake]SeeYouEnTee,1826,48,1,4,5,20.0%,1h
12983,1,NOX,1825,0,1,5,6,16.7%,1h
12984,3,Amsterdemon,1823,359,13,22,35,37.1%,1h
12985,2,stéfano,1822,148,5,12,17,29.4%,1h
12986,3,OMGClayAiken,1818,1527,179,221,400,44.8%,18m
12986,3,LibertyChimp,1818,0,0,8,8,0.0%,1h
12988,1,Fandal,1817,1959,110,124,234,47.0%,14m
12988,3,[Fansaf]NoobMaster,1817,153,4,19,23,17.4%,1h
12990,3,Aspid,1816,30,2,5,7,28.6%,1h
12990,3,Predator,1816,0,1,0,1,100.0%,1h
12992,3,[Фыр]KuraiSan,1815,505,18,22,40,45.0%,29m
12992,1,MȃrieJǿhȃƞƞȃ,1815,0,0,1,1,0.0%,31m
12994,1,MonroE,1812,46,1,3,4,25.0%,18m
12994,1,[Teror]CHINESE,1812,0,0,1,1,0.0%,1h
12994,3,Sander,1812,0,0,1,1,0.0%,13m
12997,2,kkurek,1811,88,1,2,3,33.3%,1h
12997,1,Nowator,1811,0,0,3,3,0.0%,7m
12999,1,DEstroyer,1810,216,5,10,15,33.3%,1h
13000,2,Seyara,1809,259,8,14,22,36.4%,31m
13001,1,Cesareus,1808,270,6,11,17,35.3%,14m
13002,1,Hehehehehehe,1807,180,4,0,4,100.0%,22m
13002,3,[iSucks]Honik,1807,151,3,11,14,21.4%,1h
13002,3,[gairt]Gainullin,1807,0,1,2,3,33.3%,22m
13005,1,ELPATOPATOSO,1806,517,15,25,40,37.5%,14m
13006,1,NekoMeow,1804,0,1,1,2,50.0%,1h
13006,1,SternenNinja,1804,0,0,1,1,0.0%,31m
13008,3,Geo,1803,1052,37,50,87,42.5%,1h
13008,1,Hubert,1803,117,2,7,9,22.2%,40m
13010,1,rzv,1802,672,17,21,38,44.7%,41m
13010,3,ZPBABICH,1802,0,0,1,1,0.0%,6m
13012,3,Veroniiae,1801,0,2,4,6,33.3%,34m
13013,1,Denis,1800,238,6,8,14,42.9%,1h
13013,1,uki,1800,0,1,10,11,9.1%,4m
13015,1,cygan,1799,38,1,1,2,50.0%,24m
13016,3,Evolucidity,1798,0,0,6,6,0.0%,24m
13017,3,TuTucse,1796,170,6,11,17,35.3%,24m
13018,1,Bernhard,1795,73,0,6,6,0.0%,1h
13019,1,UlliManHD,1793,473,17,18,35,48.6%,16m
13020,1,lachin,1792,1538,51,63,114,44.7%,18m
13020,1,AWI,1792,0,0,5,5,0.0%,1h
13022,1,Orion,1791,372,9,15,24,37.5%,14m
13022,1,[Mastr]cooollmomins,1791,73,1,1,2,50.0%,1h
13022,2,Mihai,1791,0,1,8,9,11.1%,36m
13025,1,[I1I]lilijj,1789,891,53,67,120,44.2%,31m
13026,2,didiou,1788,137,4,4,8,50.0%,6m
13027,3,elixias,1787,308,10,23,33,30.3%,36m
13027,1,IIIIIIIIIIII,1787,130,3,7,10,30.0%,1h
13027,1,Ksas,1787,92,2,10,12,16.7%,16m
13030,3,SolacoMan,1784,278,10,17,27,37.0%,31m
13030,1,Abdou,1784,0,0,1,1,0.0%,25m
13030,1,LeoValdez,1784,0,0,2,2,0.0%,8m
13030,2,FEITAN,1784,0,0,9,9,0.0%,25m
13034,3,Frederick,1783,0,2,4,6,33.3%,24m
13034,1,kvent,1783,0,1,4,5,20.0%,11m
13036,1,[BSG19]tiziano,1781,398,9,15,24,37.5%,23m
13037,1,Colin,1776,1304,36,49,85,42.4%,1h
13037,1,alex,1776,379,12,5,17,70.6%,35m
13039,3,ThorsHammer,1775,0,0,4,4,0.0%,24m
13040,1,IIIIIIIIIIII,1774,249,10,9,19,52.6%,8m
13040,2,buba,1774,177,7,13,20,35.0%,4m
13040,1,[TrueMe]Dragonrider,1774,0,0,5,5,0.0%,1h
13043,1,LePresident,1772,30,5,10,15,33.3%,1h
13044,1,[FR1]avore,1771,136,3,3,6,50.0%,1h
13045,2,RudiPrudy,1767,46,2,12,14,14.3%,31m
13046,1,Okidoka,1766,1533,46,78,124,37.1%,18m
13046,3,[lAreSl]DaNiMoTh,1766,277,8,15,23,34.8%,38m
13048,1,Дантес,1765,681,39,63,102,38.2%,31m
13048,1,Кулибякин,1765,84,3,5,8,37.5%,34m
13050,1,nicocab,1764,214,7,11,18,38.9%,11m
13051,1,NemesiS,1761,1775,62,75,137,45.3%,27m
13052,1,HelioStormx,1760,1415,110,171,281,39.1%,40m
13052,2,donddave,1760,0,0,1,1,0.0%,4m
13054,3,caminante,1759,1491,199,241,440,45.2%,1h
13055,1,SpeCialNeeDs,1757,0,3,2,5,60.0%,11m
13056,3,pad,1756,841,146,174,320,45.6%,1h
13056,1,SilentSword,1756,350,8,6,14,57.1%,1h
13058,1,[HOMIE]Stafin,1754,46,1,1,2,50.0%,31m
13059,1,gachiboy,1753,360,10,16,26,38.5%,9m
13060,3,Aizen,1752,0,0,5,5,0.0%,1h
13061,3,Sanchezz,1751,28,1,2,3,33.3%,6m
13062,3,llllllllllll,1749,270,12,25,37,32.4%,5m
13062,1,OldSnipzubik,1749,335,9,21,30,30.0%,13m
13064,1,ProfessorOak,1748,0,2,4,6,33.3%,1h
13065,1,mihaita,1746,391,10,9,19,52.6%,14m
13066,1,dedkill,1743,103,1,4,5,20.0%,27m
13067,1,CleverPRO,1742,0,1,0,1,100.0%,13m
13067,3,neiji,1742,0,1,4,5,20.0%,1h
13069,1,Pigeon,1741,265,6,13,19,31.6%,13m
13069,3,kholio,1741,0,1,4,5,20.0%,1h
13071,1,tommy,1740,1525,90,140,230,39.1%,41m
13072,1,Marmotte,1738,526,18,26,44,40.9%,11m
13073,1,WhiSpeR,1737,834,21,29,50,42.0%,1h
13073,2,PREDATOR,1737,452,14,29,43,32.6%,1h
13073,3,tom,1737,0,0,1,1,0.0%,22m
13076,1,GGAllin,1735,631,18,17,35,51.4%,1h
13076,1,CatNarcet,1735,48,3,5,8,37.5%,36m
13078,1,xavier,1734,135,3,7,10,30.0%,5m
13078,1,BlackWolf,1734,94,2,5,7,28.6%,1h
13078,3,hbhbh,1734,60,2,8,10,20.0%,6m
13081,1,Bezlikiy,1732,76,2,6,8,25.0%,31m
13082,3,Lotos,1729,0,0,5,5,0.0%,15m
13083,1,[skiing]Aldus,1728,689,26,25,51,51.0%,27m
13084,1,Capybara,1725,1139,46,99,145,31.7%,13m
13085,1,Dazberito,1724,628,17,25,42,40.5%,1h
13086,1,[RTO]Echo,1722,329,18,20,38,47.4%,14m
13086,1,Scôrp,1722,436,12,18,30,40.0%,1h
13086,2,Stifler,1722,100,3,12,15,20.0%,21m
13089,1,Kerber,1721,0,1,0,1,100.0%,10m
13090,1,Bananakin,1718,235,11,10,21,52.4%,18m
13091,3,HANNIBAL,1717,612,85,105,190,44.7%,10m
13092,3,BOBO,1716,0,1,4,5,20.0%,35m
13093,3,[Stealt]Vethax,1715,32,2,11,13,15.4%,34m
13094,1,Navarro,1714,211,7,12,19,36.8%,1h
13094,3,Potato,1714,0,1,4,5,20.0%,1h
13096,1,[Lucky7]Vouljin,1710,0,1,0,1,100.0%,1h
13097,3,mopolita,1709,30,1,7,8,12.5%,39m
13098,3,Kobrettie,1708,30,1,5,6,16.7%,1h
13099,1,selarom,1706,34,3,4,7,42.9%,1h
13100,1,[умри]хреножук,1699,214,6,9,15,40.0%,17m
13100,1,[CAI]Clem,1699,0,0,3,3,0.0%,12m
13102,1,krystian,1698,1000,29,35,64,45.3%,24m
13103,2,bsbaxxter,1696,0,1,5,6,16.7%,25m
13104,1,EveryDayUser,1694,193,4,5,9,44.4%,11m
13105,2,CEKO,1692,86,3,16,19,15.8%,6m
13105,3,InfoDecision,1692,0,0,3,3,0.0%,13m
13107,1,PlayBeagle,1690,46,2,7,9,22.2%,23m
13108,2,FakeIIIIIIII,1687,454,13,23,36,36.1%,10m
13109,1,proceas,1685,171,4,4,8,50.0%,34m
13110,1,SapoArmado,1683,241,7,9,16,43.8%,1h
13110,1,MicxyDough,1683,138,2,8,10,20.0%,1h
13112,1,ViOLent,1680,302,8,14,22,36.4%,31m
13113,3,DeGuN,1679,0,0,8,8,0.0%,15m
13114,1,dekurou,1678,1430,94,150,244,38.5%,24m
13115,1,sandwich,1677,210,5,11,16,31.2%,25m
13115,3,Smirnayga,1677,0,1,0,1,100.0%,1h
13117,1,Roman,1674,1033,36,55,91,39.6%,15m
13118,3,BaZinGa,1672,62,4,12,16,25.0%,24m
13118,3,Vadrugir,1672,38,2,5,7,28.6%,13m
13120,3,[woron]Троцкий,1670,0,1,0,1,100.0%,6m
13121,1,SaKay,1669,48,3,7,10,30.0%,23m
13122,1,cornus,1668,0,1,2,3,33.3%,1h
13123,2,[DStrik]Mantis,1666,0,1,0,1,100.0%,8m
13123,1,Sahaci,1666,73,0,10,10,0.0%,15m
13125,1,[TXRio7]Erik,1662,1040,34,52,86,39.5%,1h
13125,3,[pdrz]Asterot,1662,0,0,1,1,0.0%,19m
13127,1,[IBCMI]DankselleR,1658,88,3,39,42,7.1%,20m
13128,3,ЕСКАДРОНБГ,1656,0,1,4,5,20.0%,1h
13129,1,Davout,1654,792,21,43,64,32.8%,9m
13129,1,Miguelsd,1654,208,4,13,17,23.5%,16m
13131,1,storm,1652,92,3,11,14,21.4%,13m
13132,3,romandy,1651,30,1,3,4,25.0%,13m
13133,1,Leod,1647,0,0,10,10,0.0%,1h
13134,1,bala,1645,34,3,7,10,30.0%,13m
13135,1,[DS9]Tassillio,1641,717,35,24,59,59.3%,22m
13136,1,Ponce,1640,539,12,20,32,37.5%,9m
13137,2,SpaceMarine,1637,474,13,28,41,31.7%,28m
13138,1,JEDREK,1636,354,8,19,27,29.6%,7m
13139,1,Oasis,1633,164,4,13,17,23.5%,1h
13140,2,ElToro,1629,145,3,3,6,50.0%,35m
13141,2,Exevat,1626,0,0,14,14,0.0%,20m
13142,3,Chobo,1624,0,0,2,2,0.0%,24m
13143,3,Kostyan,1623,0,1,4,5,20.0%,6m
13143,2,thedylan,1623,0,0,1,1,0.0%,25m
13143,2,supermurloc,1623,0,0,2,2,0.0%,1h
13146,2,[IWOLFI]Gillette,1622,1012,28,48,76,36.8%,20m
13146,2,JEANPIERRE,1622,0,0,1,1,0.0%,1h
13148,2,kko,1620,0,0,3,3,0.0%,1h
13149,3,Kävin,1614,1493,136,194,330,41.2%,1h
13150,2,Endymion,1609,156,5,2,7,71.4%,1h
13151,2,Каа,1604,62,2,8,10,20.0%,1h
13152,2,CancelALEX,1601,30,1,6,7,14.3%,10m
13153,1,Barcode,1599,93,2,6,8,25.0%,13m
13154,2,Romulus,1593,306,9,22,31,29.0%,1h
13155,3,Lumpus,1592,0,0,1,1,0.0%,1h
13156,1,тим,1591,1090,38,64,102,37.3%,5m
13157,3,momodevils,1586,30,2,0,2,100.0%,1h
13158,1,TheUnreal,1581,1665,80,124,204,39.2%,35m
13159,3,[0G]ǀḨḝḸṿḝṬịĄ,1577,1264,132,196,328,40.2%,38m
13160,1,Jim,1575,327,7,38,45,15.6%,1h
13161,1,BERRIES,1574,128,5,7,12,41.7%,1h
13162,1,ПутинРулит,1572,472,12,30,42,28.6%,10m
13163,2,[NWGD]mrgamerasd,1570,457,13,32,45,28.9%,5m
13164,2,[K1ttY]HydrA,1565,326,10,12,22,45.5%,24m
13165,2,Stalker,1564,73,0,9,9,0.0%,10m
13166,2,Mitzonghel,1561,934,29,44,73,39.7%,34m
13167,2,Nykterstein,1556,376,10,20,30,33.3%,1h
13168,2,BeN,1551,0,0,5,5,0.0%,1h
13169,3,Kostya,1548,30,1,1,2,50.0%,1h
13170,3,Archangel,1527,0,3,2,5,60.0%,1h
13171,2,DaDi,1525,0,0,9,9,0.0%,1h
13172,3,ALPHAZEALOT,1524,1446,96,154,250,38.4%,6m
13173,3,StrayCat,1520,0,0,12,12,0.0%,1h
13174,2,Тормилон,1519,1286,42,101,143,29.4%,35m
13175,2,AntonioS,1518,40,1,9,10,10.0%,37m
13176,2,НИКИТА,1517,0,0,1,1,0.0%,1h
13177,1,RaiderACDC,1512,299,8,21,29,27.6%,42m
13178,3,Katana,1506,0,2,3,5,40.0%,19m
13179,2,KuBBaCZ,1501,208,7,14,21,33.3%,1h
13180,2,[P4K]Cage,1500,512,17,16,33,51.5%,24m
13181,3,[GasNub]Clawsharp,1495,18,1,4,5,20.0%,6m
13182,3,Miro,1492,0,0,3,3,0.0%,1h
13183,2,Biwan,1476,0,0,7,7,0.0%,37m
13184,2,HarryB,1475,32,1,6,7,14.3%,1h
13185,2,Cammy,1473,158,5,22,27,18.5%,1h
13185,2,ZockingHD,1473,128,3,4,7,42.9%,35m
13187,2,[AoTu]ABNOOD,1465,671,20,30,50,40.0%,25m
13188,3,Necrom,1450,124,4,1,5,80.0%,22m
13189,2,[Stealt]Chigo,1447,120,4,9,13,30.8%,1h
13190,1,sellingmoms,1440,1388,63,99,162,38.9%,11m
13191,2,[lölBAD]ROXXORBOSS,1415,309,8,30,38,21.1%,1h
13192,2,[Burla]Sebastijan,1407,209,7,14,21,33.3%,37m
13193,3,Туман,1397,0,0,5,5,0.0%,22m
13194,2,bartek,1386,246,7,23,30,23.3%,1h
13195,3,SERATORAPHЮN,1385,220,26,57,83,31.3%,24m
13196,1,Seikatsu,1376,98,4,15,19,21.1%,13m
13197,1,Boudy,1373,80,1,16,17,5.9%,6m
13198,2,gouzzy,1370,110,3,29,32,9.4%,6m
13199,3,Shingo,1367,30,2,6,8,25.0%,24m
13199,3,oGt,1367,48,1,2,3,33.3%,17m
13201,3,[drain]assplay,1366,60,2,20,22,9.1%,22m
13202,3,SonD,1364,0,1,6,7,14.3%,1h
13203,3,лучшыйигрок,1362,58,2,2,4,50.0%,4m
13204,1,Samir,1356,304,9,40,49,18.4%,1h
13205,3,Rollo,1326,58,2,2,4,50.0%,35m
13206,3,IvsOO,1313,0,0,1,1,0.0%,6m
13207,1,Pelekis,1308,1597,788,1368,2156,36.5%,1h
13207,2,[BWD]Det,1308,366,10,59,69,14.5%,10m
13209,3,aniilashongo,1306,0,0,2,2,0.0%,24m
13210,2,Discount,1223,30,1,21,22,4.5%,28m
13211,1,[Gregg]EscherBacon,1219,382,8,44,52,15.4%,27m
13212,3,AHSPWR,1215,58,2,1,3,66.7%,1h
13213,3,Василиса,1213,323,9,29,38,23.7%,24m
13214,1,[HFLAN]Xii,1209,98,4,28,32,12.5%,1h
13215,3,IIIIIIIIIIII,1169,86,3,9,12,25.0%,17m
13216,3,MedicSerg,1163,0,0,5,5,0.0%,17m
13217,3,Majo,1162,0,0,5,5,0.0%,39m
13218,3,Kjonen,1148,0,0,1,1,0.0%,36m
13219,3,[BilieJ]MicroJackson,1105,242,12,12,24,50.0%,17m
13220,3,IIIIIIIIII,1090,924,144,147,291,49.5%,40m
13221,3,Plecto,1080,0,136,739,875,15.5%,6m
13222,3,[DCBFF]Freak,1035,30,1,28,29,3.4%,35m
13223,3,InfesTKaracK,1007,1219,78,98,176,44.3%,1h
13224,3,Kallisthea,958,62,2,47,49,4.1%,1h
13225,3,xjtianSucks,957,0,0,8,8,0.0%,1h
13226,1,Tirano,941,744,46,217,263,17.5%,6m
13227,3,TwitchChat,716,0,0,1,1,0.0%,22m
13228,3,GeoGodley,556,0,0,1,1,0.0%,1h
