rank,tier,name,mmr,points,wins,losses,played,winrate,age
1,1,lllIllllIlll,7300,480,11,1,12,91.7%,8m
2,1,LiquidClem,7131,2813,116,31,147,78.9%,17m
3,1,ChatMarauder,7075,503,27,4,31,87.1%,25m
4,1,KaelzY,7032,1906,152,29,181,84.0%,2m
5,1,PrinceOtze,7012,3948,201,66,267,75.3%,2m
6,1,[mouz]HeroMarine,7004,1844,73,22,95,76.8%,2m
6,1,[mlem]mlem,7004,240,6,2,8,75.0%,13m
8,1,GabeTalks,6875,3556,217,79,296,73.3%,2m
9,1,[TKAP]MarineLorD,6800,0,1,2,3,33.3%,13m
10,1,[FrostG]wake,6779,3861,339,157,496,68.3%,2m
11,1,[сSсǃ]soul,6725,3207,86,51,137,62.8%,2m
12,1,llllllllllll,6697,1512,79,42,121,65.3%,12m
13,1,Ronaldinho,6666,384,8,10,18,44.4%,10m
14,1,uwuThermal,6653,672,15,12,27,55.6%,3m
15,1,aLive,6619,2891,75,37,112,67.0%,2m
16,1,IIIIllIIIIIl,6606,720,16,3,19,84.2%,3m
17,1,HeroCyclistX,6464,943,23,16,39,59.0%,14m
18,1,[DemuCl]demuLarva,6446,3963,1201,684,1885,63.7%,2m
19,1,IIIIIIIIIIII,6413,96,3,2,5,60.0%,8m
20,1,[EZ4XY]llllllllllll,6385,240,6,3,9,66.7%,16m
21,1,[WinX]Progamer,6372,0,2,3,5,40.0%,12m
22,1,iGCoffeeMs,6332,218,7,1,8,87.5%,3m
23,1,llllllllllll,6320,587,22,11,33,66.7%,6m
24,1,Radko,6304,842,37,18,55,67.3%,10m
25,1,IIIIIIIIIIII,6288,192,4,1,5,80.0%,10m
26,1,robotikov,6270,555,72,59,131,55.0%,12m
27,1,[НBGS]Creed,6263,979,50,35,85,58.8%,16m
28,1,[FrostG]aquarium,6230,760,41,33,74,55.4%,25m
29,1,RileyReid,6225,1325,54,17,71,76.1%,13m
30,1,[PMǂ]LadderManRon,6216,1964,220,197,417,52.8%,16m
31,1,IIIIIlllIII,6214,544,19,16,35,54.3%,2m
32,1,[MICKEY]MickeyMouse,6212,0,0,1,1,0.0%,8m
33,1,IIIIIIIIIIII,6205,531,17,5,22,77.3%,2m
34,1,sorry,6202,0,1,1,2,50.0%,16m
35,1,[W3SG]futurimus,6199,96,2,9,11,18.2%,10m
36,1,[PMǂ]Hopt,6195,3726,189,147,336,56.2%,2m
37,1,INTRUDER,6185,1147,142,50,192,74.0%,14m
37,1,IIIIIIIIIIII,6185,266,7,1,8,87.5%,2m
39,1,IIIIIIIIIIII,6150,836,28,17,45,62.2%,22m
40,1,IIIIIIIIIIII,6149,1729,80,59,139,57.6%,13m
41,1,Inzane,6135,0,1,1,2,50.0%,16m
42,1,[QTcIub]Beastyqt,6132,1070,35,21,56,62.5%,17m
43,1,[SТАR]Kas,6112,3734,213,168,381,55.9%,2m
44,1,[Нasu]Nicoract,6104,528,13,11,24,54.2%,2m
45,1,[GOsir]SCV,6099,1535,35,26,61,57.4%,14m
46,1,IIIIIIIIIIII,6086,3753,211,156,367,57.5%,2m
47,1,BudgetBomber,6085,1221,49,29,78,62.8%,2m
47,1,Strelok,6085,96,3,0,3,100.0%,12m
49,1,TheViRuS,6084,0,0,5,5,0.0%,3m
50,1,IIIIIIIIIIII,6059,73,1,0,1,100.0%,2m
51,1,[ePunks]AiLillekanin,6057,240,6,4,10,60.0%,16m
52,1,[Цвет]ПесняРадуги,6053,96,3,3,6,50.0%,14m
53,1,SpeCial,6052,48,1,4,5,20.0%,16m
54,1,[SТАR]BratOK,6042,1656,38,31,69,55.1%,2m
54,1,Stella,6042,150,4,6,10,40.0%,14m
56,1,Chess,6022,48,1,1,2,50.0%,14m
57,1,llllllllllll,6011,3614,522,404,926,56.4%,2m
58,1,llllllllllll,6010,2382,209,192,401,52.1%,2m
59,1,Shiek,6007,1464,131,73,204,64.2%,5m
60,1,Unix,6003,2159,471,308,779,60.5%,13m
60,1,[ЯD]RazerBlader,6003,217,4,7,11,36.4%,2m
62,1,builtdiff,5995,1372,48,47,95,50.5%,5m
63,1,Creed,5991,0,0,4,4,0.0%,13m
64,1,[BRSKR]milkicow,5990,3631,481,400,881,54.6%,2m
65,1,IIIIIIIII,5978,0,0,1,1,0.0%,3m
66,1,IIIIIIIIIIII,5970,0,1,0,1,100.0%,16m
67,1,[ArGGEU]Ricus,5968,3350,317,259,576,55.0%,2m
67,1,IIIIIIIIIIII,5968,97,2,0,2,100.0%,2m
69,1,IIIIIlIIlIII,5957,1379,42,42,84,50.0%,13m
70,1,CarstenStahl,5943,3548,517,297,814,63.5%,2m
71,1,IEatHandSoap,5929,1381,84,61,145,57.9%,17m
72,1,malloc,5922,48,2,0,2,100.0%,24m
73,1,ZipperTheFly,5906,1530,217,182,399,54.4%,3m
74,1,[Ex0n]Kado,5905,1302,29,26,55,52.7%,17m
75,1,[ǃcScǃ]ŴhýŠoŠéríouŚ,5903,759,37,5,42,88.1%,2m
76,1,Player,5902,3329,145,132,277,52.3%,2m
77,1,[JuggrJ]Jason,5896,576,13,12,25,52.0%,24m
78,1,IIIIIIIIIIII,5887,0,0,1,1,0.0%,17m
79,1,[FrostG]Tsukki,5879,3568,348,311,659,52.8%,2m
80,1,[РUNK]DeeDan,5869,2213,294,247,541,54.3%,5m
81,1,Moon,5868,1017,45,23,68,66.2%,2m
82,1,[αX]Vindicta,5862,144,4,4,8,50.0%,24m
83,1,[HBGS]Awers,5854,742,29,24,53,54.7%,16m
84,1,LeaM,5852,48,2,0,2,100.0%,16m
85,1,llllllllllll,5850,3508,190,168,358,53.1%,2m
85,1,[Mkers]Diord,5850,0,0,1,1,0.0%,23m
87,1,[TROPBG]Twine,5847,336,7,6,13,53.8%,10m
88,1,IIIIIIIII,5846,1205,39,36,75,52.0%,14m
89,1,IIIIIIIIIIII,5842,0,1,0,1,100.0%,16m
90,1,llllllllllll,5839,3408,200,116,316,63.3%,2m
91,1,IIIIIIIIIIII,5838,1659,310,236,546,56.8%,12m
92,1,llllllllllll,5827,1403,61,29,90,67.8%,3m
92,1,llllllllllll,5827,288,6,11,17,35.3%,6m
94,1,Модж,5826,192,5,8,13,38.5%,23m
95,1,[Hаsu]Nicoract,5820,2564,130,124,254,51.2%,2m
96,1,WannaBeMaru,5819,0,1,0,1,100.0%,12m
97,1,[αX]Uzikoti,5805,943,83,83,166,50.0%,22m
98,1,llllllllllll,5802,1350,45,25,70,64.3%,23m
98,1,BratOK,5802,0,1,0,1,100.0%,23m
100,1,BornToWin,5800,171,4,2,6,66.7%,6m
101,1,[TSVB]Psenna,5798,192,5,1,6,83.3%,25m
102,1,cxcxcxvvcx,5767,318,10,7,17,58.8%,24m
103,1,MacroMaru,5764,142,4,0,4,100.0%,2m
104,1,[αX]June,5757,0,1,0,1,100.0%,8m
105,1,redpilled,5748,406,10,6,16,62.5%,13m
106,1,notIIIIIIIII,5741,1386,62,47,109,56.9%,3m
107,1,[HBGS]Irbis,5737,1096,23,30,53,43.4%,16m
108,1,llllllllllll,5734,3252,404,295,699,57.8%,3m
108,1,llllllllllll,5734,96,2,3,5,40.0%,22m
110,1,[ArGGEU]Dolan,5729,3356,119,116,235,50.6%,3m
111,1,Lambo,5728,433,10,3,13,76.9%,3m
112,1,[CocoCo]Djorjx,5722,0,0,1,1,0.0%,17m
113,1,DönerKomplet,5711,1151,47,48,95,49.5%,13m
114,1,zulema,5708,687,26,22,48,54.2%,14m
115,1,[Cannоn]TypVomAldi,5707,0,1,0,1,100.0%,13m
116,1,Marulord,5704,1606,47,29,76,61.8%,3m
117,1,Xistl,5691,96,2,1,3,66.7%,24m
118,1,ZeuSiNTHeaiR,5690,3118,220,198,418,52.6%,3m
119,1,[RøckeT]ElDringo,5684,1172,32,22,54,59.3%,3m
120,1,Skyler,5683,96,3,3,6,50.0%,8m
120,1,[Ex0n]Snowden,5683,0,1,0,1,100.0%,17m
122,1,Jaani,5679,96,2,3,5,40.0%,10m
123,1,[SТАR]MODEUS,5671,1392,53,39,92,57.6%,3m
124,1,[HBGS]JEROS,5669,3351,368,337,705,52.2%,3m
124,1,Sverre,5669,308,7,8,15,46.7%,12m
126,1,[ArGGEU]Botvinnik,5664,2996,171,149,320,53.4%,3m
127,1,[BRSKR]Fallenger,5661,0,0,1,1,0.0%,16m
128,1,PKBoy,5659,96,2,8,10,20.0%,5m
129,1,[ArGGEZ]PoggyBee,5655,1578,190,145,335,56.7%,10m
129,1,llllllllllll,5655,284,11,6,17,64.7%,2m
131,1,[HBGS]MasterVasya,5654,1345,35,30,65,53.8%,3m
132,1,PlayLikeMaru,5651,915,36,28,64,56.2%,2m
133,1,[Reason]eXsTaTiC,5643,276,6,8,14,42.9%,16m
134,1,[αX]ArT,5642,0,0,9,9,0.0%,8m
135,1,[Hаsu]ELESTRAGO,5636,2687,164,149,313,52.4%,3m
135,1,Wanderer,5636,980,22,15,37,59.5%,13m
137,1,Avilo,5634,1107,331,244,575,57.6%,16m
138,1,Kylekatarn,5631,432,9,3,12,75.0%,16m
139,1,BigCockerGuy,5626,824,19,6,25,76.0%,5m
140,1,СутулаяПсина,5622,192,5,4,9,55.6%,25m
141,1,[Li3]IlPrincipino,5620,192,4,6,10,40.0%,16m
141,1,[boredx]NoobHunter,5620,0,0,1,1,0.0%,6m
143,1,[PR0Гей]Ебанический,5617,144,3,2,5,60.0%,5m
144,1,Iosys,5616,1764,57,40,97,58.8%,3m
145,1,AveningAngel,5615,254,17,13,30,56.7%,16m
145,1,MuleIncoming,5615,0,0,1,1,0.0%,16m
147,1,Luca,5605,564,13,5,18,72.2%,12m
148,1,Sardoche,5602,48,1,4,5,20.0%,16m
149,1,[DutchG]Sciosis,5601,96,2,4,6,33.3%,14m
150,1,lIlIlIlIlIlI,5594,48,1,5,6,16.7%,25m
151,1,IIIIIIIIIIII,5589,701,26,17,43,60.5%,25m
152,1,Anubis,5588,0,0,1,1,0.0%,3m
153,1,hfuhruhurr,5587,0,0,2,2,0.0%,2m
154,1,TTD,5585,2185,149,125,274,54.4%,2m
155,1,PoulpeCuit,5584,0,0,1,1,0.0%,5m
156,1,[Ex0n]Sweetzy,5578,97,1,1,2,50.0%,3m
157,1,IIIIIIIIIIII,5572,1321,45,27,72,62.5%,3m
158,1,OwningYUeasy,5570,2974,330,275,605,54.5%,3m
159,1,[сSсǃ]GunGFuBanDa,5567,1464,58,57,115,50.4%,3m
160,1,ACID,5565,2838,179,171,350,51.1%,3m
160,1,[KEKWW]ProToSEZRace,5565,192,4,6,10,40.0%,12m
162,1,Livibee,5564,46,1,3,4,25.0%,24m
163,1,[PR0Гей]ТётяЭлизабет,5562,424,9,8,17,52.9%,17m
164,1,[ORACL3]jheffe,5561,1517,43,38,81,53.1%,3m
165,1,frozz,5560,430,10,13,23,43.5%,6m
165,1,[TSO1]TheSilentOne,5560,284,6,11,17,35.3%,12m
167,1,Ahsoka,5556,2002,87,54,141,61.7%,13m
168,1,[Sarmat]Angry,5553,2958,144,120,264,54.5%,3m
168,1,IIIIIIIIIIII,5553,0,0,1,1,0.0%,14m
170,1,MonkeyKing,5550,3094,207,211,418,49.5%,3m
171,1,IIIIIIIIIIII,5546,2058,94,87,181,51.9%,3m
172,1,eMotionFan,5541,1214,30,20,50,60.0%,16m
173,1,Xinu,5538,676,29,15,44,65.9%,3m
174,1,IIIIIIIIIIII,5532,0,1,5,6,16.7%,10m
175,1,[KELA]twitchFuzer,5530,3230,241,226,467,51.6%,3m
176,1,[ArGGEU]vmgNarra,5529,2032,111,103,214,51.9%,3m
177,1,[αX]BabyMarine,5528,651,14,15,29,48.3%,3m
178,1,[NN]BuLLe,5527,0,0,1,1,0.0%,25m
179,1,[ArGGEU]Dennery,5525,2358,176,137,313,56.2%,3m
179,1,FckTeran,5525,3197,152,144,296,51.4%,3m
179,1,[MtS]GoOdy,5525,3195,137,132,269,50.9%,3m
182,1,MagicTurtle,5523,875,36,26,62,58.1%,14m
183,1,LeeKnow,5522,279,20,10,30,66.7%,14m
184,1,lllIIlIIIlll,5521,332,7,7,14,50.0%,16m
185,1,masterbonsai,5520,0,0,1,1,0.0%,3m
186,1,RuinBlaster,5516,2278,158,130,288,54.9%,3m
187,1,IIIIIIIIIIII,5514,724,55,24,79,69.6%,10m
188,1,[ArGGEU]CuKu,5512,335,12,3,15,80.0%,3m
188,1,[ÆÆÆÆÆ]ÆÆÆÆÆÆÆÆÆÆÆÆ,5512,0,5,0,5,100.0%,25m
190,1,[Ex0n]MaxPax,5511,2009,66,49,115,57.4%,3m
191,1,Sottorks,5507,276,7,1,8,87.5%,13m
192,1,[ÆR]Psz,5504,2260,365,321,686,53.2%,3m
192,1,iPrefereDota,5504,296,9,8,17,52.9%,12m
194,1,ParaPeter,5503,2399,135,110,245,55.1%,3m
194,1,[2010]SUPERNOVA,5503,220,61,3,64,95.3%,16m
196,1,June,5500,2352,100,77,177,56.5%,5m
196,1,[Ex0n]silveR,5500,1570,45,39,84,53.6%,17m
196,1,[BRSKR]HydrA,5500,0,1,0,1,100.0%,10m
199,1,[НТТ]Matvey,5497,384,14,12,26,53.8%,3m
200,1,llllllllllll,5491,1726,62,34,96,64.6%,16m
200,1,PasSweetzy,5491,779,33,28,61,54.1%,8m
202,1,ByunJovi,5486,1045,48,37,85,56.5%,25m
203,1,[Oath]Varys,5483,2587,365,348,713,51.2%,3m
204,1,Denver,5479,1335,61,58,119,51.3%,13m
205,1,CoolLichtJon,5475,1535,94,29,123,76.4%,24m
205,1,[сSсǃ]WannaBeByuN,5475,384,9,5,14,64.3%,14m
207,1,OliveiRa,5473,909,41,30,71,57.7%,5m
208,1,TeslaTank,5471,979,43,36,79,54.4%,3m
209,1,[SaneGG]Roodaka,5468,2474,240,209,449,53.5%,16m
210,1,Roombruhhhhh,5467,1053,56,7,63,88.9%,5m
211,1,[PÂRłAH]Rainmaker,5463,2667,464,418,882,52.6%,3m
212,1,llllllllllll,5460,2710,195,183,378,51.6%,12m
212,1,DJDJ,5460,762,29,20,49,59.2%,14m
214,1,llllllllllll,5455,1574,66,11,77,85.7%,3m
215,1,[PRОTОS]OPERATOR,5451,578,14,8,22,63.6%,10m
216,1,IIIIIIIIIIII,5445,2706,259,232,491,52.7%,2m
217,1,CovidNinetee,5444,961,54,11,65,83.1%,2m
218,1,CombatWombat,5443,2415,95,52,147,64.6%,25m
219,1,CatBoy,5440,48,2,1,3,66.7%,3m
220,1,[Нasu]КротУбийца,5438,284,7,6,13,53.8%,16m
221,1,[Il1lI]Arnak,5437,0,1,0,1,100.0%,16m
221,1,[MousЕ]goncharoVa,5437,0,1,0,1,100.0%,14m
223,1,llllllllll,5431,3274,117,94,211,55.5%,5m
223,1,[xGenGx]WoodedMicrob,5431,812,19,22,41,46.3%,13m
223,1,IIIIIIIIIIII,5431,140,3,1,4,75.0%,12m
226,1,[AnD]SmallPeePee,5427,20,6,1,7,85.7%,12m
227,1,Dicet,5414,0,0,1,1,0.0%,12m
227,1,Jeeves,5414,0,0,1,1,0.0%,23m
229,1,[ИYDUS]Aggression,5412,0,0,1,1,0.0%,13m
230,1,[lMMl]Luolis,5411,96,2,9,11,18.2%,13m
231,1,[Li3]SuGaRBuNNY,5407,1845,150,130,280,53.6%,14m
232,1,Mustitier,5404,151,20,10,30,66.7%,8m
233,1,[lMMl]Larkkonen,5403,3051,419,390,809,51.8%,16m
233,1,focus,5403,533,20,20,40,50.0%,6m
235,1,IIIIIIIIIIII,5401,1312,52,50,102,51.0%,16m
235,1,IIIIIIIIIIII,5401,44,2,4,6,33.3%,24m
237,1,IIIIIIIIIIII,5400,1598,43,35,78,55.1%,12m
237,1,PandaSquad,5400,0,1,0,1,100.0%,16m
239,1,IIIIIIIIIIII,5398,1227,44,8,52,84.6%,24m
240,1,[ÆR]Nihed,5391,956,22,17,39,56.4%,10m
240,1,[Xa]LaWeedaLoca,5391,944,22,22,44,50.0%,2m
240,1,IIIIIIIIIIII,5391,0,1,0,1,100.0%,16m
243,1,Dredd,5389,0,1,0,1,100.0%,16m
244,1,Xelan,5387,48,1,4,5,20.0%,14m
245,1,[ENGNS]ChillerView,5385,653,16,20,36,44.4%,14m
246,1,Pororoca,5384,0,0,1,1,0.0%,10m
247,1,Waxer,5383,1272,34,27,61,55.7%,10m
247,1,RaptoR,5383,0,0,1,1,0.0%,23m
249,1,slrkrpaktdmf,5381,94,3,8,11,27.3%,16m
250,1,Kayser,5377,0,0,2,2,0.0%,25m
251,1,lIlIlIlIlIlI,5373,186,5,2,7,71.4%,23m
252,1,katalin,5368,0,1,0,1,100.0%,16m
253,1,LeeJunghoon,5367,606,15,20,35,42.9%,2m
254,1,[TRotti]goblin,5363,2017,159,107,266,59.8%,17m
255,1,[RAUDER]OmgHackerWOW,5362,48,1,8,9,11.1%,3m
256,1,ZbebZbeb,5358,1593,52,62,114,45.6%,17m
257,1,[FxL]BaLListiC,5356,0,1,0,1,100.0%,23m
257,1,Raclette,5356,0,0,1,1,0.0%,12m
259,1,DontPlayT,5345,1530,46,32,78,59.0%,23m
260,1,Dragon,5343,506,12,6,18,66.7%,16m
261,1,[GoldM]JohMan,5332,2514,189,181,370,51.1%,14m
261,1,[ArGGEU]RobbyG,5332,184,5,15,20,25.0%,16m
263,1,ReFleXioN,5330,2785,301,287,588,51.2%,3m
263,1,llllllllllll,5330,1324,38,21,59,64.4%,14m
263,1,[ШОУМЕН]выбирай,5330,238,6,6,12,50.0%,24m
266,1,NyamNyam,5328,2039,66,70,136,48.5%,8m
267,1,[EESC]Rote,5326,2666,92,91,183,50.3%,8m
268,1,llllllllllll,5323,570,17,3,20,85.0%,16m
268,1,[RavenZ]Frutiger,5323,136,4,7,11,36.4%,3m
270,1,[HBGS]Licemer,5320,2046,67,46,113,59.3%,16m
271,1,[TMROW]Zarael,5319,132,4,0,4,100.0%,14m
272,1,[ArGGEU]EruptioN,5317,0,1,0,1,100.0%,10m
273,1,VIRGIL,5314,0,1,0,1,100.0%,17m
274,1,ChesteR,5310,0,0,1,1,0.0%,5m
274,1,IIIIIIIIIII,5310,0,0,1,1,0.0%,12m
276,1,[ArGGEU]MonstR,5309,2225,162,137,299,54.2%,14m
276,1,BerryCrunch,5309,0,1,0,1,100.0%,14m
278,1,[HBeS]Chaos,5308,2487,389,365,754,51.6%,12m
279,1,TOperator,5307,3296,276,269,545,50.6%,14m
279,1,MaNNerMule,5307,716,21,4,25,84.0%,16m
281,1,[TKAP]Okaneby,5306,960,41,37,78,52.6%,3m
281,1,kauP,5306,96,3,5,8,37.5%,23m
281,1,[5kMMR]KEKW,5306,0,1,0,1,100.0%,16m
284,1,[7x]Surprise,5304,1605,75,71,146,51.4%,3m
284,1,[FrostG]BurgerFlippr,5304,466,10,9,19,52.6%,16m
286,1,lllllllLULll,5303,2959,116,104,220,52.7%,12m
287,1,IlIIlIIIllIl,5298,0,1,0,1,100.0%,14m
288,1,TLHarstem,5296,1200,31,27,58,53.4%,3m
289,1,LiquidMaNa,5295,134,3,7,10,30.0%,13m
290,1,BabyYodaFAN,5293,236,5,6,11,45.5%,12m
291,1,[PR0Гей]ГеройОрска,5290,46,1,3,4,25.0%,17m
292,1,HeelHooker,5289,1323,47,35,82,57.3%,17m
292,1,LilSexual,5289,226,6,1,7,85.7%,23m
294,1,[сSсǃ]SKILLOUS,5288,1433,42,48,90,46.7%,16m
295,1,llllllllllll,5285,1234,45,8,53,84.9%,12m
295,2,[Нasu]upakowka,5285,0,1,0,1,100.0%,13m
297,1,Höðr,5284,1540,51,20,71,71.8%,16m
297,1,IIIIIIIIIIII,5284,0,1,1,2,50.0%,13m
299,1,IIIIIIIIIIII,5282,232,6,1,7,85.7%,12m
299,1,БокалОливье,5282,42,1,4,5,20.0%,14m
301,1,[HBGS]ZámbóJimmy,5279,1604,43,37,80,53.8%,16m
302,1,[eXøde]SayL,5278,2490,88,95,183,48.1%,25m
302,1,[lMMl]Fagballs,5278,1668,49,36,85,57.6%,12m
302,1,GöKHaN,5278,770,21,5,26,80.8%,23m
305,1,[16MRNE]Musti,5277,3247,785,734,1519,51.7%,10m
305,1,llllllllllll,5277,1476,59,17,76,77.6%,16m
307,1,YourMove,5273,186,5,12,17,29.4%,2m
308,1,Dicet,5272,2590,96,74,170,56.5%,12m
309,1,[Ex0n]Geralt,5269,2064,72,58,130,55.4%,3m
310,1,[IceHus]TerranUser,5268,790,20,17,37,54.1%,8m
310,1,same,5268,0,0,1,1,0.0%,10m
312,1,Gumbi,5267,3264,756,689,1445,52.3%,16m
312,1,WhosSly,5267,2769,116,81,197,58.9%,14m
312,1,[KELA]SannaMarine,5267,96,3,5,8,37.5%,3m
312,1,[ReZero]Echidna,5267,0,0,5,5,0.0%,23m
316,1,[isIMBA]GiveFeedback,5266,88,2,1,3,66.7%,13m
317,1,[PLA2N]Silwercrow,5265,2756,95,93,188,50.5%,14m
318,1,IceGoldEye,5258,0,0,1,1,0.0%,10m
319,1,[RøckeT]ElPueblo,5252,1414,60,15,75,80.0%,23m
319,1,llllllllllll,5252,48,2,2,4,50.0%,23m
321,1,Bloop,5250,112,3,4,7,42.9%,6m
321,1,STATIC,5250,0,0,1,1,0.0%,10m
323,1,[MrL2]MisterL,5248,306,7,11,18,38.9%,14m
324,1,LLLLLLLLLLLL,5247,174,4,2,6,66.7%,12m
324,1,[BBVB]MiCroJacKSon,5247,0,0,1,1,0.0%,23m
326,1,MeOwEx,5246,40,1,4,5,20.0%,17m
326,1,Vegetable,5246,0,0,1,1,0.0%,6m
328,1,Contentgaga,5245,3256,152,143,295,51.5%,25m
329,1,[SaneGG]Goofy,5244,3256,192,169,361,53.2%,6m
330,1,IIIIIIIIIIII,5242,2881,121,97,218,55.5%,14m
331,1,[aW]IIIIIIIIIIII,5238,804,26,16,42,61.9%,16m
332,1,[TerBHD]Anthony,5237,178,4,5,9,44.4%,16m
333,1,[7x]control,5236,3205,278,258,536,51.9%,12m
333,1,[lMMl]Arttuyo,5236,0,1,0,1,100.0%,16m
333,2,[StalkZ]Cheesus,5236,0,0,1,1,0.0%,12m
336,1,Tronder,5235,1114,27,36,63,42.9%,16m
336,1,[PSISTM]RuFF,5235,130,4,1,5,80.0%,23m
338,1,[АNIME]Agumon,5233,1861,65,71,136,47.8%,10m
339,1,ghasT,5232,0,1,0,1,100.0%,16m
340,1,Plecto,5230,1384,124,118,242,51.2%,10m
340,1,HânTattoo,5230,0,1,4,5,20.0%,6m
340,1,BasicMarine,5230,0,0,1,1,0.0%,3m
343,1,Pxvxl,5229,0,1,0,1,100.0%,16m
344,1,[ÆR]SpártaiKemál,5227,2758,133,115,248,53.6%,17m
345,1,[RAAAWR]Robotikov,5225,1446,46,27,73,63.0%,8m
345,1,[Mеrcу]DrZub,5225,0,0,1,1,0.0%,13m
347,1,[Heroes]BuRny,5224,1662,54,45,99,54.5%,23m
347,1,[Sch]Pinard,5224,0,1,0,1,100.0%,16m
349,1,[lMMl]YdinJäte,5221,0,0,2,2,0.0%,12m
350,1,[ArGGEU]MouLou,5219,3243,144,138,282,51.1%,23m
351,1,[ØC]Dicet,5216,938,22,28,50,44.0%,16m
352,1,Taci,5215,226,6,2,8,75.0%,2m
352,1,Fortnite,5215,222,6,5,11,54.5%,10m
352,1,IIIIIIIIIIII,5215,0,1,0,1,100.0%,6m
355,1,[lMMl]Haspe,5214,2628,114,89,203,56.2%,10m
356,1,[XYFAN]INcuBo,5213,2528,89,85,174,51.1%,16m
356,1,ChangeName,5213,228,5,3,8,62.5%,12m
358,1,lllIIlIIIllI,5212,854,31,18,49,63.3%,10m
358,1,[sryITS]Complicated,5212,472,11,11,22,50.0%,25m
358,1,[YlKES]saixy,5212,90,2,1,3,66.7%,16m
361,1,Intoxicated,5211,350,8,5,13,61.5%,14m
362,1,[Blacer]PAPI,5210,192,4,1,5,80.0%,17m
362,1,Warbsky,5210,0,1,2,3,33.3%,2m
364,1,IIIIIIIIIIII,5209,546,14,18,32,43.8%,10m
364,1,llllllllllll,5209,330,8,12,20,40.0%,10m
364,1,[WРеS]Dexter,5209,44,1,1,2,50.0%,17m
367,1,[RøckeT]ElBastos,5207,3243,359,336,695,51.7%,12m
367,1,llllllllllll,5207,2861,357,299,656,54.4%,10m
367,1,[TRotti]OpTiMiStC,5207,600,15,7,22,68.2%,24m
370,1,[Oath]NoMercy,5203,1416,73,60,133,54.9%,6m
371,1,[Хобот]Hellion,5202,348,9,4,13,69.2%,23m
372,1,[Swerin]Sogeking,5200,3157,158,141,299,52.8%,14m
372,1,TheCowboy,5200,1792,55,57,112,49.1%,17m
374,1,[Нope]aling,5199,2505,145,133,278,52.2%,10m
374,1,HalfLegend,5199,551,17,10,27,63.0%,10m
376,1,niceq,5198,1545,104,93,197,52.8%,6m
377,1,speaknow,5197,556,13,12,25,52.0%,12m
378,1,Bullerpik,5196,3049,591,500,1091,54.2%,23m
379,1,[GWWB]CarlyRaeJope,5193,44,2,2,4,50.0%,24m
380,1,PlebLord,5191,0,0,2,2,0.0%,14m
381,1,[TKAP]Koka,5190,3193,280,274,554,50.5%,14m
381,1,[YlKES]downLink,5190,94,3,0,3,100.0%,12m
383,1,NEAGGERUS,5189,530,13,24,37,35.1%,16m
384,1,[Люблю]ПриветДобро,5188,0,0,7,7,0.0%,12m
385,1,DrunkenSCV,5187,0,0,1,1,0.0%,14m
386,3,Jin,5186,34,1,2,3,33.3%,9m
387,1,[aW]Reap,5185,645,15,15,30,50.0%,12m
388,1,Erik,5184,48,2,4,6,33.3%,3m
389,1,[KELA]Serral,5183,1499,59,49,108,54.6%,16m
389,1,Ourk,5183,1164,34,24,58,58.6%,10m
391,1,[aW]Tee,5182,1332,51,44,95,53.7%,14m
392,1,[KELA]Flash,5181,3076,153,137,290,52.8%,16m
393,1,[Hаsu]Karaks,5180,0,0,1,1,0.0%,24m
394,1,[MiLker]iLikeMilk,5179,1764,57,46,103,55.3%,16m
395,1,SplitDedulek,5176,1143,49,1,50,98.0%,10m
396,1,paiN,5172,835,34,4,38,89.5%,2m
396,1,llllllllllll,5172,0,0,2,2,0.0%,10m
398,1,Faith,5169,1903,78,48,126,61.9%,14m
399,1,[RÐ]ElNathador,5167,452,11,4,15,73.3%,3m
400,1,[16MRNE]MiniDream,5166,3055,205,191,396,51.8%,8m
400,1,[lWHl]Designer,5166,0,1,0,1,100.0%,25m
402,1,[IBeAŚI]BeAsT,5165,3153,180,162,342,52.6%,10m
402,1,[ICGl]BananenBaum,5165,1579,83,90,173,48.0%,17m
404,1,Disrespect,5164,1500,40,42,82,48.8%,13m
405,1,StaticX,5163,2698,115,95,210,54.8%,10m
405,1,[сSсǃ]pluggglacior,5163,1730,112,92,204,54.9%,16m
407,1,llllllllllll,5160,244,7,4,11,63.6%,10m
408,1,AvrilLavigne,5159,2490,159,142,301,52.8%,8m
408,1,[Draigo]AntonioDinis,5159,0,1,0,1,100.0%,14m
408,1,Flashover,5159,0,0,1,1,0.0%,6m
411,1,[HBGS]shuhard,5153,1022,27,28,55,49.1%,3m
411,1,[Ex0n]ForJumY,5153,128,3,3,6,50.0%,5m
411,1,pidorage,5153,0,1,0,1,100.0%,3m
414,1,llllllllllll,5151,1270,48,16,64,75.0%,25m
415,1,llllllllllll,5150,2348,78,78,156,50.0%,3m
416,1,yxias,5149,342,8,2,10,80.0%,10m
417,1,WhoCars,5147,1186,73,70,143,51.0%,13m
418,1,[JAREK]Miszu,5146,444,10,17,27,37.0%,25m
419,1,[aW]Dext,5145,3059,134,122,256,52.3%,6m
420,1,MateuZ,5144,960,30,13,43,69.8%,16m
421,1,[Blacer]pwNEd,5142,0,0,1,1,0.0%,16m
422,1,IIIIIIIIIIII,5141,94,3,4,7,42.9%,2m
422,1,[ĄoĐ]ĹěgàńdàrýȜRa,5141,0,0,1,1,0.0%,10m
424,1,[MDeS]SharKRippeR,5139,3201,209,190,399,52.4%,3m
425,1,Goma,5138,3170,466,421,887,52.5%,10m
426,1,[PatchT]Primadonna,5135,44,2,2,4,50.0%,14m
427,1,[EZ4XY]Saratoga,5132,572,14,10,24,58.3%,16m
428,1,CarryGun,5131,1230,38,39,77,49.4%,16m
429,1,[ArGGEU]EnigmA,5130,138,2,3,5,40.0%,13m
430,1,[lMMl]TossGirl,5127,817,46,35,81,56.8%,14m
430,1,llllllllllll,5127,1335,44,38,82,53.7%,3m
432,1,llllllllllll,5125,2161,132,115,247,53.4%,8m
432,1,[Ex0n]Krr,5125,142,4,13,17,23.5%,6m
432,1,[EмŦ]MarkSucaPini,5125,0,0,3,3,0.0%,3m
435,1,RadiRabougri,5124,2120,72,72,144,50.0%,3m
436,1,[IBeAŚI]Terxel,5123,1620,50,56,106,47.2%,16m
436,1,SIMP,5123,0,0,1,1,0.0%,14m
438,1,[ProRax]DeadEnd,5120,0,1,0,1,100.0%,8m
438,1,OppaiDragon,5120,0,0,1,1,0.0%,3m
440,1,[eXøde]FerouCyril,5119,1588,76,62,138,55.1%,13m
441,1,IIIIIIIIII,5118,2672,101,90,191,52.9%,16m
441,1,PlayLikeMaru,5118,0,1,0,1,100.0%,10m
443,1,SoMa,5117,0,0,2,2,0.0%,2m
444,1,ktFlaSh,5116,412,11,6,17,64.7%,10m
444,1,mTwKnoppers,5116,0,1,0,1,100.0%,16m
446,1,llllllllllll,5114,2958,176,157,333,52.9%,23m
446,1,LittleFinger,5114,0,0,1,1,0.0%,13m
448,1,blap,5113,769,25,19,44,56.8%,3m
448,1,[Hаsu]ProXy,5113,0,0,2,2,0.0%,14m
450,1,stonks,5112,44,1,1,2,50.0%,14m
451,1,[musti2]Tower,5111,1286,50,39,89,56.2%,3m
452,1,[комча]заходит,5110,1234,37,24,61,60.7%,24m
453,1,JoJo,5107,1276,169,160,329,51.4%,17m
454,1,IIIIIIIIIIII,5106,1306,40,28,68,58.8%,23m
454,1,Jutso,5106,851,38,28,66,57.6%,3m
454,1,[ArGGEU]JaCkal,5106,248,6,2,8,75.0%,10m
457,1,[mоuz]GosuFavi,5105,671,18,2,20,90.0%,3m
457,1,имя,5105,0,1,0,1,100.0%,23m
459,1,[αX]Tocon,5103,1733,73,79,152,48.0%,17m
460,1,RauwR,5102,1052,29,33,62,46.8%,8m
461,1,Leorio,5101,3062,137,113,250,54.8%,16m
461,1,[Wø]gasahert,5101,44,2,1,3,66.7%,23m
463,1,wake,5097,972,32,12,44,72.7%,13m
464,1,PerroCagando,5096,1490,63,26,89,70.8%,25m
464,1,[musti2]Tower,5096,420,11,5,16,68.8%,23m
466,1,AdlsctSniper,5095,800,57,30,87,65.5%,14m
467,1,[Руслан]ХочуДетей,5094,94,2,5,7,28.6%,13m
468,1,Anthony,5093,144,3,3,6,50.0%,14m
469,1,IIIIIIIIIIII,5091,186,4,7,11,36.4%,25m
470,1,Pajarote,5090,126,4,6,10,40.0%,17m
471,1,IIIIIIIIIIII,5089,0,1,4,5,20.0%,17m
471,1,[400PNG]MogarFNSMASH,5089,0,0,1,1,0.0%,17m
473,1,llllllllllll,5087,2900,242,209,451,53.7%,3m
473,3,JeanMarineRC,5087,0,0,5,5,0.0%,24m
475,1,Nerazim,5086,1141,76,38,114,66.7%,12m
475,1,Lyyna,5086,122,4,0,4,100.0%,23m
477,1,[PÂRłAH]bArtH,5085,2666,483,453,936,51.6%,23m
477,1,Gorilla,5085,130,4,4,8,50.0%,6m
479,1,Søldier,5082,0,1,0,1,100.0%,3m
480,1,[IBeAŚI]GUMGUMRuFFy,5081,3111,461,446,907,50.8%,6m
481,1,[NetGG]Antlko,5080,3091,500,475,975,51.3%,14m
481,1,Dave,5080,0,0,1,1,0.0%,3m
483,1,[lMMl]PuPu,5079,506,13,14,27,48.1%,12m
483,1,[Sl4yrS]Prøject,5079,474,12,8,20,60.0%,12m
485,1,llllllllllll,5078,788,63,27,90,70.0%,17m
485,1,FullOfFlaw,5078,930,42,7,49,85.7%,23m
487,1,Gustav,5076,188,5,17,22,22.7%,12m
488,1,[SqAUT]TheMassivMan,5074,758,23,8,31,74.2%,16m
488,1,[Blacer]gifford,5074,0,0,1,1,0.0%,10m
490,1,Impostor,5073,584,17,12,29,58.6%,10m
491,1,[PaniC]BlackEagle,5071,1940,69,62,131,52.7%,8m
491,1,сайкси,5071,1037,42,13,55,76.4%,3m
493,1,[aW]Yuhmo,5070,2208,79,73,152,52.0%,10m
494,1,[HBGS]MAKSIM,5068,166,5,4,9,55.6%,6m
495,1,Lost,5066,0,0,1,1,0.0%,14m
496,1,[duсks]SlayerSBoxeR,5065,0,1,0,1,100.0%,14m
497,1,[ВИЗГЕР]передвигаюсь,5063,2416,106,77,183,57.9%,14m
497,1,RetardGumbi,5063,556,15,7,22,68.2%,16m
497,1,Masvidal,5063,0,1,0,1,100.0%,24m
500,1,[aW]SlayersYoga,5060,2858,146,120,266,54.9%,10m
500,1,IIIIIIIIIIII,5060,90,3,1,4,75.0%,3m
502,1,llllllllllll,5059,1249,44,33,77,57.1%,16m
502,1,IIIIIIIIIIII,5059,1020,30,35,65,46.2%,16m
502,1,dropBabulek,5059,654,15,22,37,40.5%,3m
502,1,IIIIIIIIIIII,5059,0,1,0,1,100.0%,16m
506,1,Metahurtz,5057,0,1,0,1,100.0%,16m
507,1,Ineffable,5056,1994,162,146,308,52.6%,10m
507,1,[CRUX]Lancel,5056,226,5,6,11,45.5%,5m
509,1,InfernNus,5055,0,0,3,3,0.0%,10m
510,1,Haidar,5053,522,14,11,25,56.0%,14m
510,1,[НТТ]NeGaN,5053,0,0,2,2,0.0%,14m
512,1,IIIIlllI,5052,3088,145,133,278,52.2%,12m
513,1,[ArGGEU]Prøject,5051,176,5,1,6,83.3%,16m
514,1,NiicDK,5050,0,0,1,1,0.0%,8m
514,1,[Blacer]Ziomek,5050,0,0,5,5,0.0%,10m
516,1,Dicehammer,5049,90,2,4,6,33.3%,6m
517,1,[lNAl]PracticeX,5048,465,21,7,28,75.0%,13m
517,1,[K0mpis]ArpoS,5048,390,9,11,20,45.0%,16m
517,1,[Sc2Gms]pħĭłĭpp,5048,0,0,1,1,0.0%,6m
517,1,Charoisaur,5048,0,0,4,4,0.0%,23m
521,1,[Sarmat]Mazi,5044,72,4,0,4,100.0%,16m
522,1,Calt,5043,904,22,27,49,44.9%,17m
523,1,IlIlIlIlIlIl,5041,402,11,13,24,45.8%,5m
524,1,БУБУБИК,5040,881,38,5,43,88.4%,12m
525,1,Lapharos,5039,2158,119,94,213,55.9%,14m
526,1,RAiN,5038,84,2,13,15,13.3%,13m
527,1,[ЯD]SupplyBlock,5036,1703,64,49,113,56.6%,3m
528,1,[BRSKR]GipsyDanger,5033,3051,203,198,401,50.6%,8m
528,1,[IBeAŚI]Fienend,5033,823,51,36,87,58.6%,10m
530,1,СmeTanKa,5032,2351,192,182,374,51.3%,17m
530,1,[BFeS]LikeAMonster,5032,0,1,0,1,100.0%,2m
532,1,IIIIIIIIIIII,5031,1220,50,16,66,75.8%,14m
532,1,Flanders,5031,0,0,1,1,0.0%,25m
534,1,IIIIIIIIIIII,5030,340,9,7,16,56.2%,16m
535,1,[lMMl]Divinesia,5029,1572,51,58,109,46.8%,16m
536,1,[Sn1p3d]Infinity,5026,44,1,3,4,25.0%,23m
537,1,[HBGS]Neowolf,5025,3074,226,210,436,51.8%,23m
537,1,[TAGGX]SlammerPower,5025,1702,73,64,137,53.3%,16m
539,1,сайкси,5024,166,6,1,7,85.7%,14m
539,1,WOOOOOOOOOOO,5024,182,5,7,12,41.7%,10m
539,1,[BFeS]NeOPriMaL,5024,0,1,0,1,100.0%,6m
542,1,llllllllllll,5023,248,8,22,30,26.7%,10m
543,1,[ÆR]JuGGer,5021,704,45,49,94,47.9%,8m
544,1,[OSgZ]Euweb,5020,1530,167,159,326,51.2%,13m
544,1,FiRePlaY,5020,0,0,1,1,0.0%,10m
546,1,Taquacman,5019,3094,645,631,1276,50.5%,14m
546,1,[boomer]BlueSky,5019,1490,60,39,99,60.6%,12m
548,1,Shadowelock,5018,168,4,3,7,57.1%,10m
549,1,[HBGS]APOSTAL,5017,754,67,56,123,54.5%,13m
549,1,DragoN,5017,1132,35,26,61,57.4%,3m
549,1,muffin,5017,514,31,24,55,56.4%,3m
552,1,[RøckeT]ElClochar,5016,708,20,10,30,66.7%,14m
553,1,Nardpi,5013,839,66,59,125,52.8%,3m
553,1,[TheDOH]FightingFrog,5013,0,1,0,1,100.0%,5m
555,1,[EmŦ]MovieMaker,5012,2602,126,121,247,51.0%,12m
555,1,MiniMarine,5012,1404,59,33,92,64.1%,24m
555,1,IlIlIIlIIlIl,5012,46,2,0,2,100.0%,10m
558,1,[ECV]ManofOneway,5011,590,26,9,35,74.3%,10m
558,1,BinaryNinja,5011,596,15,9,24,62.5%,8m
560,1,merz,5010,1861,362,307,669,54.1%,8m
560,1,CasualMarine,5010,1912,71,67,138,51.4%,12m
562,1,Servyoa,5009,1570,49,53,102,48.0%,16m
562,1,Ceviche,5009,362,10,16,26,38.5%,10m
564,1,Laukyo,5005,1958,447,415,862,51.9%,12m
564,1,DeadInsidE,5005,0,1,0,1,100.0%,14m
566,1,Adjutant,5004,2296,91,76,167,54.5%,16m
566,1,[ArGGEU]alfi,5004,426,11,4,15,73.3%,14m
566,1,FadeSG,5004,0,1,0,1,100.0%,10m
569,1,[thrax]thrax,5003,947,42,35,77,54.5%,16m
569,1,HeRoSeGaT,5003,76,3,1,4,75.0%,2m
569,1,IIIIIIIIIIII,5003,90,2,3,5,40.0%,16m
569,1,[NVY]Locutuss,5003,0,0,1,1,0.0%,24m
573,1,IrishLad,5002,902,26,26,52,50.0%,17m
573,1,llllllllllll,5002,0,0,1,1,0.0%,10m
575,1,[DRGno1]LobsterBrain,5001,0,0,2,2,0.0%,16m
576,1,Gary,4999,2440,167,127,294,56.8%,23m
577,1,[ArGGEU]FrisK,4997,164,4,1,5,80.0%,14m
577,1,[ArGGEU]INeVitable,4997,44,2,0,2,100.0%,17m
579,1,LupusRex,4996,0,1,0,1,100.0%,10m
580,1,IIIIIIIIII,4995,2390,92,86,178,51.7%,12m
581,1,IceTea,4991,2197,103,98,201,51.2%,6m
581,1,ZeuSiNTHeaiR,4991,1159,73,55,128,57.0%,13m
583,1,Bakemonoda,4990,3065,335,317,652,51.4%,23m
584,1,[SqAUT]TheMassivMan,4989,1123,33,32,65,50.8%,17m
584,1,IlIlIlIlIlIl,4989,0,2,3,5,40.0%,2m
586,1,почтиМС,4988,0,0,1,1,0.0%,5m
587,1,SoulSmith,4987,3017,223,167,390,57.2%,16m
588,1,llllllllllll,4986,182,6,4,10,60.0%,13m
589,1,[Sarmat]NataszPL,4985,2340,130,123,253,51.4%,14m
589,1,HayasakaAi,4985,846,35,9,44,79.5%,8m
589,1,[ƮesXG]Zlayer,4985,0,0,2,2,0.0%,2m
592,1,IIIIIIIIIII,4982,768,32,10,42,76.2%,12m
592,1,Ekidona,4982,82,3,2,5,60.0%,16m
594,1,IIIIIIIIIIII,4981,812,24,22,46,52.2%,16m
595,1,TheDarkOne,4980,2279,118,47,165,71.5%,24m
596,1,PatchTerran,4979,200,5,5,10,50.0%,24m
596,1,Hardwell,4979,0,0,1,1,0.0%,14m
598,1,[ZadiRa]SuperRanger,4978,2825,144,143,287,50.2%,13m
599,1,[DHiWe]MightyThor,4975,91,2,5,7,28.6%,5m
600,1,[FrostG]CorAngar,4974,826,29,12,41,70.7%,12m
600,1,XelNaga,4974,0,0,1,1,0.0%,14m
600,1,[FEDUP]Feniks,4974,0,0,1,1,0.0%,17m
603,1,[IceHus]balance,4970,1998,73,58,131,55.7%,16m
603,1,[ШОУМЕН]гаригудини,4970,744,21,12,33,63.6%,5m
605,1,[INAE]ReiToR,4967,2902,236,187,423,55.8%,12m
605,1,Oskar,4967,3070,171,176,347,49.3%,16m
605,1,[3Dǃ]SaLemandr,4967,0,0,2,2,0.0%,16m
608,1,[Oath]LogiC,4966,1081,43,24,67,64.2%,10m
609,1,OldBenoni,4964,446,17,3,20,85.0%,16m
610,1,[Trulli]ItzYumy,4963,497,15,3,18,83.3%,23m
610,1,llllllllllll,4963,46,2,2,4,50.0%,16m
612,1,[TheDOH]ghost,4962,1332,44,46,90,48.9%,17m
613,1,Sebastien,4961,1968,155,154,309,50.2%,6m
613,1,PoGGery,4961,40,1,2,3,33.3%,17m
615,1,Sedna,4960,2690,213,209,422,50.5%,6m
615,1,[iX]Shakyor,4960,702,18,22,40,45.0%,23m
617,1,[αX]Protiselaos,4958,777,26,23,49,53.1%,17m
617,1,[ETAN]eTn,4958,0,1,0,1,100.0%,12m
617,1,Flovous,4958,0,0,2,2,0.0%,16m
620,1,Soetenga,4956,829,28,30,58,48.3%,17m
621,1,Pleb,4955,1657,101,90,191,52.9%,16m
622,1,VBHustler,4954,3000,151,144,295,51.2%,10m
623,1,CRODeny,4953,0,0,2,2,0.0%,10m
623,1,Chrome,4953,0,0,2,2,0.0%,3m
625,1,[SadCat]Chaeyoung,4952,0,0,1,1,0.0%,17m
626,1,Junkdog,4951,2830,367,384,751,48.9%,3m
626,1,spirit,4951,636,18,14,32,56.2%,12m
628,1,Grim,4950,1718,119,116,235,50.6%,14m
629,1,Alibril,4949,2043,133,127,260,51.2%,10m
629,1,Xanax,4949,374,10,8,18,55.6%,16m
631,1,[aW]Røy,4948,0,1,0,1,100.0%,5m
631,1,Braindead,4948,42,1,1,2,50.0%,6m
631,1,MakeItLookEz,4948,0,0,1,1,0.0%,14m
634,1,[HBGS]OliVer,4947,1926,63,64,127,49.6%,13m
634,1,[αX]Rodzyn,4947,602,15,19,34,44.1%,3m
634,1,Merlin,4947,0,3,2,5,60.0%,14m
637,1,[ICGl]MeMo,4946,178,5,7,12,41.7%,14m
638,1,Lasha,4945,818,24,24,48,50.0%,16m
638,1,Lucifer,4945,0,0,2,2,0.0%,3m
640,1,LashaGOAT,4944,200,5,6,11,45.5%,3m
641,1,MonkeyDragon,4941,196,6,0,6,100.0%,12m
642,1,[isIMBA]Parathix,4940,1318,41,57,98,41.8%,23m
643,1,[BdT]Skuggaco,4939,1773,78,86,164,47.6%,3m
644,1,italz,4938,326,10,7,17,58.8%,16m
645,1,[HFXX]Humfluxx,4936,2406,138,141,279,49.5%,14m
645,1,[PR0Гей]Тамара,4936,82,2,1,3,66.7%,5m
647,1,LoGG,4935,1605,59,56,115,51.3%,12m
647,1,IIIIIIIIIIII,4935,86,2,12,14,14.3%,12m
649,1,cayenne,4934,1562,81,37,118,68.6%,10m
649,1,КРИСТИАН,4934,0,0,1,1,0.0%,14m
651,1,[Heroes]Xellos,4933,2961,378,372,750,50.4%,6m
652,1,[PÂRłAH]czJOHNcz,4932,2884,181,162,343,52.8%,13m
653,1,[GoldM]Olluquito,4931,576,15,21,36,41.7%,10m
654,1,IIIIIIIIIIII,4927,2131,100,59,159,62.9%,13m
654,1,IIIIIIIIIIII,4927,1251,53,49,102,52.0%,13m
656,1,Nshake,4926,46,1,3,4,25.0%,17m
657,1,YoungRonin,4925,604,17,16,33,51.5%,17m
658,1,Numi,4924,116,3,4,7,42.9%,8m
658,1,droku,4924,48,1,1,2,50.0%,6m
660,1,llllllllllll,4923,1794,130,126,256,50.8%,3m
661,1,Shellbee,4921,94,3,1,4,75.0%,16m
662,1,IcKmore,4920,942,43,18,61,70.5%,23m
663,1,ArkonoM,4918,2735,113,100,213,53.1%,10m
663,1,FoodCheese,4918,907,57,17,74,77.0%,17m
663,1,JosefHermann,4918,88,3,1,4,75.0%,23m
666,1,[pSi]Nuc,4916,0,1,0,1,100.0%,23m
666,1,ByunJovi,4916,0,1,0,1,100.0%,12m
668,1,[αX]LastSurprise,4915,850,25,28,53,47.2%,3m
669,1,INcuBo,4914,248,7,5,12,58.3%,10m
670,1,Власть,4913,1400,66,46,112,58.9%,16m
671,1,Broda,4912,0,1,3,4,25.0%,23m
672,1,Tesselhoff,4911,0,0,2,2,0.0%,12m
673,1,StimMeister,4909,2959,380,370,750,50.7%,23m
673,1,[Axi]CranK,4909,238,6,7,13,46.2%,5m
673,1,llllllllllll,4909,0,0,1,1,0.0%,3m
676,1,[HBGS]leon,4908,3017,148,137,285,51.9%,6m
676,1,iLoveInno,4908,816,39,14,53,73.6%,2m
678,1,llllllllllll,4907,645,99,77,176,56.2%,8m
678,1,[SZ]Danilix,4907,448,11,11,22,50.0%,14m
680,1,IIIIIIIIIIII,4906,0,0,1,1,0.0%,16m
681,1,Fantasma,4904,2548,131,147,278,47.1%,13m
681,1,[RÐ]Mazrok,4904,46,2,3,5,40.0%,17m
681,1,[KQP]IIIIIIIIIIII,4904,34,1,5,6,16.7%,25m
684,1,[Cannоn]Schlumpfine,4903,0,0,1,1,0.0%,10m
685,1,[3Д]SpeCial,4902,2231,126,117,243,51.9%,16m
686,1,[3Dǃ]waidmannshei,4901,2737,221,232,453,48.8%,10m
687,1,taylor,4900,38,2,4,6,33.3%,17m
688,1,Willy,4899,710,20,23,43,46.5%,10m
689,1,barcode,4898,1295,61,24,85,71.8%,17m
689,1,llllllllllll,4898,340,37,10,47,78.7%,12m
691,1,Pressure,4895,128,4,8,12,33.3%,16m
691,1,ŔąŹëŘßõÿ,4895,0,1,0,1,100.0%,13m
691,1,rioter,4895,44,1,1,2,50.0%,14m
694,1,PunknotMrkev,4894,126,3,1,4,75.0%,2m
695,1,[DoS98]Larogue,4893,146,4,9,13,30.8%,3m
696,1,[DFgs]spacesurgeon,4892,0,1,3,4,25.0%,13m
697,1,iMPoopi,4891,372,10,19,29,34.5%,14m
698,1,STimWiN,4890,1170,34,39,73,46.6%,13m
698,1,[JDUNEZ]mrBETONSKIy,4890,422,10,15,25,40.0%,10m
698,1,NSky,4890,248,7,7,14,50.0%,25m
698,1,[DaDdYo]lllll,4890,0,0,1,1,0.0%,6m
702,1,[PŖïMĄŁ]Thyphoon,4889,2640,420,385,805,52.2%,23m
703,1,Sam,4888,1027,37,28,65,56.9%,2m
704,1,AvrilLaQueen,4887,402,11,6,17,64.7%,8m
705,1,higgi,4886,2118,515,508,1023,50.3%,23m
706,1,[CS0]XPA,4885,2301,123,129,252,48.8%,12m
706,1,[RBlood]ZbTR,4885,177,4,0,4,100.0%,12m
706,1,[ICGl]MrJones,4885,0,0,1,1,0.0%,14m
706,1,PeaceDeath,4885,0,0,3,3,0.0%,5m
710,1,MrTwoBonKu,4882,2962,286,270,556,51.4%,13m
711,1,lIIIIllIIIIl,4881,168,4,10,14,28.6%,14m
711,1,Sweter,4881,88,2,3,5,40.0%,14m
713,1,SirAspiC,4880,2887,426,378,804,53.0%,11m
713,1,SKTDream,4880,590,31,6,37,83.8%,12m
715,1,[FxL]Boboop,4879,456,13,11,24,54.2%,10m
715,1,PlayLikeTrap,4879,166,6,13,19,31.6%,25m
717,1,[gec2Ü]MSMSMSM,4878,32,1,2,3,33.3%,24m
717,1,IIIIIIIIIIII,4878,36,1,3,4,25.0%,10m
719,1,Dynasty,4876,1999,152,147,299,50.8%,13m
719,1,llllllllllll,4876,1624,84,45,129,65.1%,8m
719,1,[MechT]Mason,4876,0,0,1,1,0.0%,5m
722,1,llllllllllll,4875,956,25,65,90,27.8%,23m
723,1,[PaniC]Mark,4872,2187,100,83,183,54.6%,14m
723,1,[AISC]Dunmer,4872,92,2,4,6,33.3%,10m
723,1,[Mkers]ÐęąÐŞĦąÐoŴ,4872,0,1,0,1,100.0%,17m
723,1,Killerfive,4872,46,1,6,7,14.3%,12m
723,1,MZj,4872,0,0,1,1,0.0%,16m
728,1,[Мaki]LicemerToxic,4871,2890,280,242,522,53.6%,25m
729,1,[aW]Deuxcentonze,4870,1538,114,113,227,50.2%,23m
729,1,Kindness,4870,645,29,30,59,49.2%,6m
729,1,[EUping]Wonder,4870,38,1,4,5,20.0%,17m
732,1,[кoтик]киселёчек,4868,90,2,0,2,100.0%,17m
732,1,fAkeSpeedq,4868,42,1,1,2,50.0%,16m
734,1,[Zavess]ISFCKNGHOT,4867,1370,56,43,99,56.6%,16m
734,1,[MSUSC2]Ulrezash,4867,756,26,19,45,57.8%,23m
736,1,llllllllllll,4865,579,26,15,41,63.4%,24m
737,1,bibi,4864,2961,529,525,1054,50.2%,14m
737,1,Yountax,4864,288,7,13,20,35.0%,10m
737,1,Chendar,4864,0,0,1,1,0.0%,16m
740,1,Lowman,4862,1628,131,129,260,50.4%,12m
741,1,IIIIIIIIIIII,4861,2129,126,135,261,48.3%,6m
742,1,[Peeps]BUFOR,4859,2730,320,308,628,51.0%,12m
742,1,IIIIIIIIIIII,4859,317,9,5,14,64.3%,11m
744,1,Rapter,4858,0,1,0,1,100.0%,16m
744,1,Decoutan,4858,0,0,1,1,0.0%,14m
746,1,Guinness,4857,1962,77,78,155,49.7%,16m
746,1,[OFFpro]Milka,4857,610,16,23,39,41.0%,14m
746,1,Incomplete,4857,0,0,1,1,0.0%,2m
749,1,[BPink]Jennie,4856,1112,75,30,105,71.4%,16m
749,1,CryStun,4856,190,4,2,6,66.7%,14m
749,1,[EESC]LuIsBoR,4856,0,0,3,3,0.0%,2m
752,1,rikurdi,4855,1585,143,126,269,53.2%,3m
752,1,SpaceOrc,4855,520,23,11,34,67.6%,14m
752,1,[MlNG]Antrip,4855,580,21,16,37,56.8%,10m
755,1,MechOuilles,4854,726,18,28,46,39.1%,3m
755,1,wowser,4854,332,16,9,25,64.0%,14m
755,1,[TheDOH]pond,4854,328,8,6,14,57.1%,23m
758,1,[B3est]ape,4853,2810,135,127,262,51.5%,24m
758,1,[TheRPW]Liberty,4853,274,14,21,35,40.0%,14m
760,1,FlozoR,4852,0,0,2,2,0.0%,23m
761,1,Mufflebot,4851,116,4,5,9,44.4%,23m
762,1,[BRSKR]Lucasdart,4848,2959,293,275,568,51.6%,23m
762,1,Algoustu,4848,389,14,11,25,56.0%,5m
762,1,Broesl,4848,130,4,6,10,40.0%,12m
765,1,Versus,4847,1923,115,65,180,63.9%,17m
765,1,llllllllllll,4847,42,2,0,2,100.0%,3m
765,1,lllllllllIIl,4847,44,1,5,6,16.7%,23m
768,1,[TheDOH]Incubusk,4846,1371,225,220,445,50.6%,11m
769,1,Sata,4845,388,10,13,23,43.5%,10m
770,1,marius,4844,503,33,4,37,89.2%,2m
771,1,fyyfyy,4842,1379,59,48,107,55.1%,23m
771,1,llllllllllll,4842,199,7,2,9,77.8%,10m
771,1,ThunderJønes,4842,106,2,1,3,66.7%,16m
774,1,Azrael,4839,2908,248,239,487,50.9%,12m
774,1,[LifeS]CmeTanKa,4839,91,2,0,2,100.0%,23m
776,1,fyy,4838,2385,168,157,325,51.7%,11m
777,1,Tikakoti,4837,498,30,4,34,88.2%,2m
778,1,[aW]SaYBoT,4836,2714,319,298,617,51.7%,3m
778,1,farSight,4836,545,28,30,58,48.3%,6m
778,1,[ICGl]EDER,4836,46,1,4,5,20.0%,23m
781,1,FFFFFFFFFFFF,4835,2068,74,75,149,49.7%,13m
781,1,[AnD]ArChViLe,4835,1016,46,41,87,52.9%,16m
781,1,[PÂRłAH]Markus,4835,1296,45,41,86,52.3%,23m
781,1,[Wø]SynPoO,4835,344,17,6,23,73.9%,14m
781,1,IIIIIIIIIIII,4835,189,10,6,16,62.5%,10m
781,1,[Dw4rfs]HaNfy,4835,0,0,5,5,0.0%,17m
787,1,Dream,4834,798,55,17,72,76.4%,11m
787,1,[aW]LIGHT,4834,906,39,34,73,53.4%,2m
787,1,xlFinalGamer,4834,36,3,1,4,75.0%,3m
787,1,[WYG]Lightning,4834,114,3,3,6,50.0%,8m
787,1,Joker,4834,46,2,1,3,66.7%,14m
792,1,YanXII,4833,2907,159,153,312,51.0%,3m
792,1,[EESC]EotenaS,4833,2148,146,129,275,53.1%,12m
794,1,[BFeS]TOTOPOTATO,4832,1141,116,98,214,54.2%,23m
794,1,maeksle,4832,0,0,1,1,0.0%,4m
796,1,QIpoulpecuit,4831,380,24,2,26,92.3%,17m
796,1,GnomoMagico,4831,516,24,15,39,61.5%,16m
796,1,llllllllllll,4831,215,5,5,10,50.0%,6m
796,1,DarkSide,4831,0,1,0,1,100.0%,11m
796,1,Imposter,4831,0,1,3,4,25.0%,3m
801,1,[AiRǂ]Skikky,4830,477,51,34,85,60.0%,8m
801,1,Redemption,4830,466,31,2,33,93.9%,4m
803,1,[KDV]Marcino,4829,2927,272,266,538,50.6%,14m
803,1,Violet,4829,0,0,1,1,0.0%,10m
803,1,[0Team]RiSky,4829,0,0,5,5,0.0%,2m
806,1,tumpy,4828,149,7,0,7,100.0%,10m
807,1,OpTosMustDiE,4827,2035,103,95,198,52.0%,17m
807,1,lllllllllll,4827,90,1,1,2,50.0%,24m
807,1,AnDreJOO,4827,0,0,4,4,0.0%,11m
810,1,NoMoreWords,4826,0,1,0,1,100.0%,14m
810,1,ThorZaIN,4826,40,1,4,5,20.0%,17m
812,1,llllllllllll,4825,828,47,31,78,60.3%,14m
812,1,[N0bOdy]Gannicus,4825,1056,32,34,66,48.5%,12m
814,1,Tbag,4824,2643,162,164,326,49.7%,5m
814,1,[LqT]tiltedcaster,4824,110,3,5,8,37.5%,14m
814,1,[RSI]Icky,4824,93,1,1,2,50.0%,16m
814,1,Rise,4824,91,1,1,2,50.0%,23m
818,2,IIIIIIIIIIII,4823,318,11,3,14,78.6%,13m
818,1,Requiem,4823,192,5,4,9,55.6%,14m
818,1,HelioN,4823,106,3,0,3,100.0%,12m
818,1,[PLA2N]Bleak,4823,0,1,0,1,100.0%,25m
818,1,RQOnly,4823,93,1,2,3,33.3%,2m
818,1,KoNeKø,4823,0,0,1,1,0.0%,23m
824,1,Smurfax,4822,2906,134,122,256,52.3%,14m
824,2,Thrive,4822,0,1,0,1,100.0%,14m
826,2,BigBrother,4821,684,30,20,50,60.0%,7m
826,1,[Blacer]MarineKing,4821,828,24,30,54,44.4%,16m
828,1,[TSATSA]Kinkyy,4820,246,10,8,18,55.6%,16m
828,1,IIIIIIIIIIII,4820,178,3,4,7,42.9%,11m
830,1,[TheDOH]Gorthauer,4819,2404,119,104,223,53.4%,5m
830,1,IIIIIIIIIIII,4819,1551,58,42,100,58.0%,4m
830,1,REEEEEEEEEEE,4819,0,0,2,2,0.0%,17m
833,1,Daz,4818,350,13,11,24,54.2%,17m
834,2,HansSuper,4817,0,0,1,1,0.0%,7m
834,1,[ØC]iceman,4817,0,0,3,3,0.0%,25m
836,1,KofyeinTV,4816,1131,135,139,274,49.3%,14m
836,1,[DFgs]BlueSenSe,4816,2407,112,122,234,47.9%,23m
838,1,sdafasdfqwqe,4815,0,4,2,6,66.7%,13m
839,1,[PaniC]Marador,4814,1148,37,41,78,47.4%,12m
840,1,[TRYY]SolidDeath,4812,2887,173,167,340,50.9%,14m
841,1,[WBO]Suidam,4811,1618,63,58,121,52.1%,14m
842,1,[lKoTl]Moppi,4809,1185,60,53,113,53.1%,14m
843,1,IncroyauX,4806,1066,36,41,77,46.8%,8m
843,2,veysiii,4806,44,1,1,2,50.0%,9m
845,1,[PLA2N]Strannik,4805,904,53,34,87,60.9%,5m
845,1,ShowKhan,4805,216,12,6,18,66.7%,23m
845,1,[Xa]Sforza,4805,44,2,3,5,40.0%,24m
848,2,BabouLeFou,4804,808,47,25,72,65.3%,6m
848,1,Tortoise,4804,1172,45,37,82,54.9%,24m
850,1,Rächer,4803,516,33,14,47,70.2%,16m
851,1,Dark,4802,944,132,126,258,51.2%,16m
852,2,[HBGSJR]Рагнарос,4800,2346,171,160,331,51.7%,12m
852,2,Sye,4800,1226,76,57,133,57.1%,14m
854,1,[Heroes]Xylophone,4799,2863,439,433,872,50.3%,23m
854,2,[Oath]SantaSam,4799,0,0,1,1,0.0%,24m
856,2,IIIIIIIIIIII,4798,0,1,0,1,100.0%,13m
856,1,llllllllllll,4798,0,0,1,1,0.0%,5m
858,1,Protossimba,4797,150,5,3,8,62.5%,14m
859,1,[HeFi]MonkeyBallz,4796,2920,193,174,367,52.6%,5m
859,2,BuryTheLight,4796,1048,69,42,111,62.2%,24m
859,2,SaltyOlty,4796,0,0,1,1,0.0%,14m
862,1,[ƮesXG]Huski,4795,2829,279,252,531,52.5%,23m
862,1,archon,4795,982,58,47,105,55.2%,4m
862,1,Lalo,4795,40,1,3,4,25.0%,17m
865,1,Jagours,4794,2789,531,535,1066,49.8%,13m
865,1,JustOneDrink,4794,2889,198,204,402,49.3%,3m
867,1,[ARK88]Eman,4793,2164,187,191,378,49.5%,10m
867,1,Splitter,4793,1628,68,62,130,52.3%,12m
867,2,BoethiuS,4793,0,1,0,1,100.0%,13m
870,1,[ICGl]DarkTilRisen,4792,2572,115,115,230,50.0%,10m
870,2,CsipA,4792,78,3,1,4,75.0%,7m
872,1,lIlIlIlIlIlI,4791,870,25,31,56,44.6%,8m
872,2,SolKing,4791,0,0,1,1,0.0%,14m
874,2,[ENV]NeHe,4790,184,5,4,9,55.6%,24m
875,2,[AciNoN]Invader,4788,198,8,2,10,80.0%,17m
876,1,DarkGamer,4784,2764,108,112,220,49.1%,7m
876,2,DieMauer,4784,309,16,2,18,88.9%,9m
876,1,[Animе]XelNaga,4784,48,2,1,3,66.7%,22m
879,1,[RstE]NicoStar,4783,1839,87,76,163,53.4%,24m
879,2,[w3c]Markus,4783,0,0,2,2,0.0%,9m
881,1,TyLyLa,4782,1111,244,237,481,50.7%,17m
881,1,[ArGGEU]DarknessK,4782,1232,45,45,90,50.0%,14m
881,2,Smoothie,4782,68,2,2,4,50.0%,6m
881,2,[TSFU]HDZOMBIEKILL,4782,0,1,0,1,100.0%,23m
881,1,[PŖïMĄŁ]Desive,4782,0,0,4,4,0.0%,14m
886,1,[CRAIC]Penta,4780,1200,42,51,93,45.2%,14m
887,1,[НВGS]Аверс,4779,362,11,11,22,50.0%,14m
887,2,[Penix]GoDofWaR,4779,0,1,0,1,100.0%,12m
889,1,[ƮesXG]anghost,4778,36,1,7,8,12.5%,12m
890,1,[KELA]CycloneOP,4776,828,54,26,80,67.5%,16m
890,2,Whinelord,4776,351,17,4,21,81.0%,14m
892,2,[2025]Pure,4772,0,1,1,2,50.0%,22m
893,1,[Dae]HyuMan,4771,1565,77,67,144,53.5%,16m
894,2,IIIIIIIIIIII,4770,74,3,4,7,42.9%,24m
895,2,buhnrop,4769,272,13,6,19,68.4%,14m
896,2,Gino,4768,625,36,10,46,78.3%,23m
896,2,Necro,4768,424,19,12,31,61.3%,14m
896,1,REEEEE,4768,552,19,20,39,48.7%,16m
899,2,[Cannоn]LiquidClum,4767,166,7,2,9,77.8%,23m
899,2,Skeptic,4767,0,0,1,1,0.0%,14m
901,1,[ЯD]Cluster,4766,2890,272,284,556,48.9%,17m
901,2,Rednax,4766,474,26,9,35,74.3%,23m
903,1,libidas,4765,2481,98,105,203,48.3%,13m
903,1,[НBGS]WannaBeByun,4765,237,7,7,14,50.0%,23m
905,2,[Li3]eLive,4763,16,1,4,5,20.0%,17m
905,2,[LbCH]agadmtCH,4763,0,0,1,1,0.0%,9m
907,2,IIIIIIIIIIII,4762,0,0,1,1,0.0%,12m
908,2,Tahiti,4760,144,4,6,10,40.0%,9m
909,1,Seanpawll,4759,2860,322,325,647,49.8%,4m
909,1,[IWDRI]Domian,4759,806,30,35,65,46.2%,8m
909,2,[TKMERD]TKL,4759,470,17,14,31,54.8%,23m
909,3,[Ex0n]Srade,4759,121,3,4,7,42.9%,2m
909,2,[3A]luckeri,4759,66,2,4,6,33.3%,9m
914,2,Guts,4758,2682,210,162,372,56.5%,9m
914,2,pepeJAM,4758,485,27,6,33,81.8%,9m
914,2,BeepBoop,4758,461,21,11,32,65.6%,22m
914,2,Septerran,4758,0,0,1,1,0.0%,13m
918,2,Afonso,4757,16,3,2,5,60.0%,22m
918,2,Mason,4757,0,0,1,1,0.0%,14m
920,1,Nightmare,4751,2770,161,156,317,50.8%,3m
920,2,WhySoSmurfy,4751,915,121,36,157,77.1%,12m
920,1,Ziroy,4751,970,63,65,128,49.2%,13m
920,2,imbaRenger,4751,0,0,5,5,0.0%,6m
924,1,[Monik]NekomajinZ,4750,938,334,327,661,50.5%,13m
924,1,[wedown]CyBeRdEmOoN,4750,1038,66,54,120,55.0%,16m
926,2,[DRUCK]eepsmann,4749,0,0,1,1,0.0%,12m
927,2,[ЯD]MaRek,4748,24,2,2,4,50.0%,14m
927,2,[QLASH]HellraiseR,4748,0,1,1,2,50.0%,17m
929,2,HerpDerp,4747,422,22,1,23,95.7%,9m
929,2,OutOfSpace,4747,0,1,0,1,100.0%,9m
931,1,Dan,4745,2342,130,138,268,48.5%,7m
931,2,[duсks]Жмышь,4745,146,7,2,9,77.8%,23m
933,3,Kleinthor,4743,0,1,0,1,100.0%,4m
934,1,IlIIllllllII,4742,44,1,13,14,7.1%,17m
935,2,FrogMaster,4741,82,4,4,8,50.0%,14m
935,2,Chibron,4741,0,0,1,1,0.0%,7m
937,1,Barcode,4740,2756,165,167,332,49.7%,13m
937,2,NoSmokingBro,4740,348,19,12,31,61.3%,13m
939,1,[ЯD]TBA,4739,1552,96,96,192,50.0%,24m
939,1,[Zelos]Sheppard,4739,1255,64,69,133,48.1%,10m
939,2,[Jimmeh]Jimmeh,4739,236,11,6,17,64.7%,12m
939,1,AccountXIXV,4739,312,10,11,21,47.6%,10m
939,2,[ØC]MadMax,4739,0,0,1,1,0.0%,17m
944,2,Life,4738,338,14,7,21,66.7%,9m
944,2,[FxL]LittleGirl,4738,112,5,4,9,55.6%,14m
944,1,KeyHey,4738,0,0,1,1,0.0%,2m
947,2,shishi,4737,431,25,0,25,100.0%,17m
947,2,IIIIIIIIIIII,4737,329,14,15,29,48.3%,6m
947,2,[ICGl]Aero,4737,272,11,7,18,61.1%,22m
947,2,TheLordAC,4737,102,3,4,7,42.9%,12m
951,1,[OGTV]FunKa,4736,2850,277,279,556,49.8%,23m
951,2,SenseiKanye,4736,430,21,2,23,91.3%,9m
953,2,[Fridge]Sheephead,4735,1116,95,99,194,49.0%,13m
953,2,NezukoChan,4735,1111,87,79,166,52.4%,12m
953,1,IIIIIIIIIIII,4735,1444,45,67,112,40.2%,16m
953,1,[3Dǃ]ƎDǃBee,4735,715,31,34,65,47.7%,24m
957,1,[PÂRłAH]noname,4734,2791,150,147,297,50.5%,17m
957,2,ByunJr,4734,266,11,8,19,57.9%,6m
959,1,[NaBoKI]Chrankon,4733,2705,176,177,353,49.9%,12m
959,2,SHOSHO,4733,1372,63,52,115,54.8%,12m
959,3,llllllllllll,4733,97,1,2,3,33.3%,8m
962,1,GetOverHere,4732,1215,118,113,231,51.1%,8m
963,2,[UATeam]Николай,4731,2665,235,222,457,51.4%,9m
963,2,DeadInside,4731,405,24,10,34,70.6%,9m
963,2,Bobby,4731,60,3,0,3,100.0%,24m
963,2,gameofdrones,4731,0,0,1,1,0.0%,14m
967,2,SCARLXRD,4730,1110,49,50,99,49.5%,24m
968,2,[Peeps]SpiderPig,4728,0,1,0,1,100.0%,14m
969,2,[Blacer]Krystianer,4726,38,2,1,3,66.7%,17m
969,2,[RеG]GeNieS,4726,0,1,1,2,50.0%,9m
969,2,IIIlllIIIlll,4726,0,0,1,1,0.0%,6m
972,1,[ØC]Hoshi,4725,2896,210,214,424,49.5%,7m
972,2,[Hаsu]CadoEverto,4725,2143,105,77,182,57.7%,14m
972,2,Heisenberg,4725,436,18,19,37,48.6%,24m
972,2,MassReaper,4725,216,7,2,9,77.8%,14m
976,1,[PŖïMĄŁ]iNveiN,4724,1073,46,41,87,52.9%,3m
976,2,zarco,4724,887,45,18,63,71.4%,12m
976,2,[ArGGEU]ADIBOU,4724,74,4,2,6,66.7%,22m
976,2,[LifeS]MingLee,4724,72,3,2,5,60.0%,14m
976,2,Maffe,4724,0,0,1,1,0.0%,6m
981,2,Nine,4723,1339,114,110,224,50.9%,14m
981,2,[EBIG]Eiger,4723,1520,86,57,143,60.1%,9m
981,1,salHeh,4723,646,19,25,44,43.2%,14m
981,2,[ØC]Bekoj,4723,112,10,6,16,62.5%,23m
985,2,IIIIIIIIIIII,4721,693,43,13,56,76.8%,12m
986,1,Solidmore,4720,2881,1029,1021,2050,50.2%,13m
986,1,IIIIIIIIIIII,4720,760,25,29,54,46.3%,17m
986,2,[W2i]MaDiNiNa,4720,200,9,10,19,47.4%,24m
986,2,IllllIIllllI,4720,173,5,3,8,62.5%,13m
990,2,TOTOPOTATO,4719,1040,83,49,132,62.9%,6m
990,2,IIIIIIIIIIII,4719,1071,69,72,141,48.9%,14m
990,2,[PÂRłAH]Argon,4719,812,31,34,65,47.7%,22m
993,1,BCSTheory,4717,2236,114,95,209,54.5%,23m
993,2,IIIIIIIIIIII,4717,512,32,5,37,86.5%,12m
993,2,glhf,4717,335,22,5,27,81.5%,24m
996,2,[nTr0pY]HeXeD,4716,0,0,1,1,0.0%,9m
997,2,VladSlymor,4714,722,27,26,53,50.9%,7m
997,2,[ICGl]React,4714,0,1,0,1,100.0%,9m
999,2,[WBO]Spectre,4713,1313,62,61,123,50.4%,24m
999,2,[QTp2T]Zoxx,4713,466,20,18,38,52.6%,13m
999,1,[TnItB]Eriodin,4713,0,0,1,1,0.0%,17m
1002,2,[OGTV]Algost,4712,2472,169,174,343,49.3%,14m
1002,2,Terran,4712,1116,73,53,126,57.9%,14m
1004,1,[SY2G]Nath,4710,2614,103,114,217,47.5%,17m
1004,2,[TAW]FreeZ,4710,1238,50,57,107,46.7%,14m
1004,2,[100APM]Operator,4710,413,22,26,48,45.8%,13m
1004,1,[ArGGEU]Mangokopf,4710,48,2,1,3,66.7%,24m
1008,2,Cosmos,4709,106,4,3,7,57.1%,24m
1008,2,IIIIIIIIIIII,4709,0,0,3,3,0.0%,13m
1010,2,Prokofiev,4708,0,1,0,1,100.0%,12m
1011,2,[ePunks]Garitos,4707,1139,54,49,103,52.4%,6m
1012,2,[SY2G]xZeiiden,4706,350,18,9,27,66.7%,24m
1012,2,DriupMatt,4706,60,2,6,8,25.0%,6m
1014,1,[ExpdtD]DiabloFeTo,4705,2032,246,234,480,51.2%,14m
1014,2,ElMentos,4705,565,29,25,54,53.7%,12m
1016,1,Funcio,4704,1866,73,78,151,48.3%,16m
1016,2,[RGn]FeniX,4704,156,6,7,13,46.2%,12m
1016,2,Spacefox,4704,72,4,3,7,57.1%,14m
1019,2,[Zguege]JULMonBijou,4703,1927,96,88,184,52.2%,9m
1020,2,Thaniri,4702,886,43,21,64,67.2%,23m
1020,2,IIIIIIIIIIII,4702,257,13,3,16,81.2%,9m
1022,2,[Hаsu]samoZLO,4701,2653,359,358,717,50.1%,7m
1022,1,[DFgs]GuMihu,4701,1900,136,124,260,52.3%,23m
1022,2,[FFF]LinkPak,4701,0,1,0,1,100.0%,13m
1022,2,[CYC]lllllIIIllll,4701,73,1,1,2,50.0%,24m
1026,1,[ENV]SoBoTeK,4700,1604,94,89,183,51.4%,16m
1026,1,Corvo,4700,36,1,7,8,12.5%,5m
1026,2,zwijntje,4700,0,0,1,1,0.0%,14m
1029,2,[DioD]Vengeance,4699,1516,120,91,211,56.9%,17m
1029,2,Pupkin,4699,0,0,1,1,0.0%,14m
1031,1,Player,4698,1403,131,138,269,48.7%,16m
1031,2,[FElite]KGKnatscher,4698,0,1,0,1,100.0%,6m
1031,2,MxL,4698,0,0,1,1,0.0%,12m
1034,2,Phobia,4697,132,6,3,9,66.7%,22m
1034,2,slayerBoxer,4697,116,4,5,9,44.4%,24m
1034,2,IIIIIIIIIIII,4697,0,0,1,1,0.0%,23m
1037,2,[DØG]ProDogoss,4696,186,8,9,17,47.1%,14m
1037,2,Kimpacka,4696,104,5,4,9,55.6%,14m
1039,1,BobaFett,4694,570,17,26,43,39.5%,13m
1039,2,[LegVI]ShaGGy,4694,228,12,13,25,48.0%,17m
1041,2,[INFED]FläskFräsarN,4693,0,0,3,3,0.0%,14m
1041,2,ace,4693,0,0,4,4,0.0%,13m
1043,2,[Wolven]DevilMarine,4692,2165,215,206,421,51.1%,14m
1043,2,JustMonika,4692,24,2,1,3,66.7%,14m
1043,2,[SGEY]TYTY,4692,0,0,2,2,0.0%,14m
1046,1,[HBGSJR]ReMinDeR,4691,2704,255,248,503,50.7%,16m
1047,2,[NMSQ]Maretto,4690,622,31,20,51,60.8%,13m
1047,1,[Фаталя]GachiMan,4690,258,9,9,18,50.0%,17m
1047,2,Louisca,4690,58,2,8,10,20.0%,12m
1047,2,[KRŽ]EvilSmile,4690,0,1,0,1,100.0%,12m
1051,1,Aliby,4688,1128,49,41,90,54.4%,12m
1052,1,Trifax,4687,1839,69,72,141,48.9%,25m
1052,2,KarmaPrime,4687,151,11,15,26,42.3%,12m
1052,2,RiccyG,4687,146,5,7,12,41.7%,6m
1052,1,ЛёшаСтимпак,4687,0,0,16,16,0.0%,23m
1056,2,SaYBoT,4685,2039,148,111,259,57.1%,13m
1057,2,[ZadiRa]Beastmode,4684,2607,163,149,312,52.2%,17m
1057,2,[Dobro]Dobro,4684,0,0,1,1,0.0%,14m
1057,2,GoriK,4684,0,0,1,1,0.0%,17m
1060,1,[WatThe]Frak,4682,408,12,25,37,32.4%,11m
1060,2,БИМБОУНИТАЗ,4682,0,1,0,1,100.0%,17m
1062,2,[isIMBA]Tirith,4681,751,55,25,80,68.8%,14m
1063,2,Roman,4680,678,31,27,58,53.4%,17m
1063,2,VrooomVroooo,4680,42,3,8,11,27.3%,9m
1065,2,Niy,4679,2407,120,109,229,52.4%,12m
1066,1,Taeyeon,4678,2445,139,140,279,49.8%,4m
1066,2,Chipolino,4678,1328,129,77,206,62.6%,6m
1066,1,[БУБУБ]PussyBoy,4678,1671,70,68,138,50.7%,23m
1066,2,Rival,4678,0,0,1,1,0.0%,14m
1070,1,[ВSL]JCIPOWER,4677,2832,721,730,1451,49.7%,23m
1070,2,Leviathan,4677,2142,297,288,585,50.8%,24m
1070,2,WielkaPałka,4677,150,5,6,11,45.5%,13m
1070,2,[PaniC]Kenpachy,4677,26,2,4,6,33.3%,12m
1070,2,Bilf,4677,0,0,2,2,0.0%,9m
1075,2,[LOIS]OrisOnFire,4676,30,1,3,4,25.0%,7m
1076,2,CrustyCumSox,4675,0,1,0,1,100.0%,13m
1077,2,Tianzi,4674,176,10,13,23,43.5%,12m
1078,2,[PaniC]Martouf,4673,1721,74,72,146,50.7%,12m
1079,2,SetsunaFSeie,4672,0,1,0,1,100.0%,14m
1080,1,[Hаsu]Haloman,4671,2797,233,245,478,48.7%,16m
1080,2,llllllllllll,4671,2638,215,208,423,50.8%,17m
1080,2,[HBGSJR]MishaDavay,4671,644,91,83,174,52.3%,22m
1080,2,kvarg,4671,754,39,15,54,72.2%,7m
1080,1,Tesla,4671,918,27,36,63,42.9%,4m
1080,2,Yharnam,4671,320,18,12,30,60.0%,23m
1086,2,jeongsin,4670,1006,48,46,94,51.1%,22m
1086,2,Lucky,4670,0,1,0,1,100.0%,23m
1088,1,Stonkz,4669,2794,475,493,968,49.1%,5m
1088,2,[НТТ]pazhiloy,4669,380,16,13,29,55.2%,12m
1088,2,Argetlames,4669,0,1,0,1,100.0%,14m
1088,2,[EmpKas]Jepin,4669,0,0,1,1,0.0%,6m
1088,2,llllllllllll,4669,0,0,1,1,0.0%,12m
1093,2,MaksL,4668,860,43,31,74,58.1%,12m
1093,2,[xRtG]MacUseR,4668,841,41,42,83,49.4%,14m
1093,2,Demidar,4668,454,21,21,42,50.0%,7m
1093,2,[PaniC]Cassiopeia,4668,398,15,17,32,46.9%,24m
1093,2,llllllllllll,4668,0,0,1,1,0.0%,14m
1098,2,JLN,4667,0,0,1,1,0.0%,22m
1099,2,[TuS]harhar,4666,371,27,26,53,50.9%,14m
1099,2,Bunners,4666,340,13,4,17,76.5%,17m
1101,2,[NVY]PrOsMaShErO,4665,110,3,8,11,27.3%,24m
1101,2,SaikiK,4665,0,1,0,1,100.0%,7m
1101,2,LeMiche,4665,0,1,1,2,50.0%,12m
1104,2,BMorge,4664,1702,97,99,196,49.5%,14m
1105,2,HisAirness,4662,1302,155,109,264,58.7%,17m
1105,2,[EESC]Faith,4662,1977,95,84,179,53.1%,24m
1107,2,[BGThot]MiQ,4661,2614,146,159,305,47.9%,7m
1107,2,Moonlight,4661,139,6,3,9,66.7%,24m
1107,1,trash,4661,0,1,0,1,100.0%,18m
1107,2,BobRoss,4661,0,0,1,1,0.0%,12m
1111,2,Misery,4659,184,8,4,12,66.7%,9m
1112,1,Strawhat,4658,2795,293,305,598,49.0%,10m
1112,2,Nosleep,4658,562,30,22,52,57.7%,17m
1114,1,borsh,4657,2794,257,251,508,50.6%,12m
1114,2,[SaneGG]Rednax,4657,1340,158,96,254,62.2%,14m
1114,2,[MkersA]Nomisking,4657,562,26,24,50,52.0%,12m
1117,2,[DogBob]Cafards,4656,478,18,22,40,45.0%,22m
1118,2,[PŖïMĄŁ]Virtual,4655,0,0,1,1,0.0%,24m
1119,2,[RøckeT]ElTwingo,4654,792,36,34,70,51.4%,14m
1120,2,Smasher,4652,2613,365,330,695,52.5%,6m
1120,2,Derderdon,4652,0,1,0,1,100.0%,6m
1122,1,GameTime,4650,2130,136,134,270,50.4%,17m
1122,2,[αX]Mamba,4650,0,0,2,2,0.0%,17m
1124,1,[eXøde]Walker,4649,962,31,44,75,41.3%,13m
1124,2,[ØC]Viipers,4649,28,1,6,7,14.3%,24m
1126,2,[Peeps]Dekusuta,4648,0,1,0,1,100.0%,22m
1127,2,Harkonnen,4646,260,10,9,19,52.6%,17m
1127,2,BabinHood,4646,56,6,4,10,60.0%,9m
1127,2,[9to5]fitschi,4646,0,0,1,1,0.0%,14m
1130,2,LunarSC,4645,515,30,7,37,81.1%,9m
1130,2,llllllllllll,4645,96,6,5,11,54.5%,7m
1130,2,NoobMaster,4645,0,1,0,1,100.0%,13m
1130,2,FurY,4645,0,0,4,4,0.0%,7m
1134,2,MarinePrince,4644,154,6,10,16,37.5%,13m
1134,2,Jupiter,4644,26,2,0,2,100.0%,9m
1136,2,Spaler,4643,1834,83,74,157,52.9%,9m
1136,2,ƚƧƐẊƳƁȀƇǨƚ,4643,0,1,0,1,100.0%,24m
1136,2,[BdT]Zenob,4643,0,0,1,1,0.0%,9m
1139,2,KapitanBomba,4642,1168,175,161,336,52.1%,14m
1139,2,[GoldM]Bromaria,4642,32,2,0,2,100.0%,12m
1141,2,TRIDENT,4641,1881,83,75,158,52.5%,12m
1141,2,Leto,4641,0,0,1,1,0.0%,14m
1143,2,[FrostG]Xayad,4640,277,15,6,21,71.4%,9m
1144,1,[TheDOH]TYTY,4639,675,62,61,123,50.4%,23m
1145,2,llllllllllll,4638,162,5,3,8,62.5%,7m
1145,2,[Nastуa]Мерзавга,4638,124,5,8,13,38.5%,9m
1147,2,[BFeS]RainmaNǂ,4637,1946,238,245,483,49.3%,14m
1147,2,[33cl]Pepsi,4637,0,1,0,1,100.0%,9m
1149,2,[TerBHD]Aclickterran,4636,0,0,1,1,0.0%,17m
1150,1,[HBGSJR]BananOnFire,4635,2778,308,304,612,50.3%,12m
1150,1,cast,4635,424,42,32,74,56.8%,16m
1150,2,[IceHus]deadman,4635,326,16,12,28,57.1%,9m
1153,2,forsakeNXE,4634,2189,135,104,239,56.5%,24m
1153,2,SevenAteNine,4634,0,0,1,1,0.0%,7m
1155,2,Bibizyan,4633,2337,109,92,201,54.2%,23m
1156,1,[ArGGEU]VanHelsingLQ,4631,2798,446,435,881,50.6%,17m
1156,2,Kadabeu,4631,0,1,0,1,100.0%,6m
1156,2,ẕѧұø,4631,0,1,0,1,100.0%,13m
1159,2,[ÆR]sephistoeu,4630,2523,303,303,606,50.0%,23m
1159,2,VOLK,4630,781,39,26,65,60.0%,14m
1159,2,TerranUApart,4630,193,10,4,14,71.4%,9m
1159,1,Kilimandjaro,4630,338,10,19,29,34.5%,4m
1159,2,DontMindMe,4630,0,1,0,1,100.0%,22m
1159,2,[BornG]deribou,4630,0,0,3,3,0.0%,23m
1165,2,[αX]Onigami,4629,2265,246,241,487,50.5%,13m
1165,2,Yuki,4629,993,51,32,83,61.4%,22m
1165,2,Unclespam,4629,0,0,1,1,0.0%,12m
1168,2,[PLA2N]SlyBeetle,4628,136,7,4,11,63.6%,24m
1168,2,[D0N3]TheGhost,4628,0,0,1,1,0.0%,6m
1170,2,[Teor]probeX,4627,1792,83,69,152,54.6%,22m
1170,2,[LifeS]ÐÎÁßØŁÎČÀ,4627,110,22,1,23,95.7%,12m
1172,2,Atoms,4626,2158,108,104,212,50.9%,14m
1172,2,[eXøde]Ivy,4626,889,45,36,81,55.6%,17m
1172,2,[Dinn3r]NoSauce,4626,0,1,4,5,20.0%,24m
1175,2,Masternoob,4625,1668,86,43,129,66.7%,9m
1176,2,ZeroBrain,4623,1898,207,201,408,50.7%,12m
1176,2,ImSoTrash,4623,2482,122,106,228,53.5%,24m
1176,2,[PŖïMĄŁ]PØŴĔЯмãи,4623,226,9,7,16,56.2%,9m
1176,2,Seki,4623,133,7,3,10,70.0%,9m
1180,1,ddooomm,4622,1485,93,61,154,60.4%,14m
1180,2,Spec,4622,0,1,0,1,100.0%,12m
1182,2,[aviEU2]aviloSoAmaze,4621,1618,146,97,243,60.1%,23m
1183,2,Coffey,4620,16,1,1,2,50.0%,12m
1184,2,[HBGSJR]SenseiTapok,4619,368,15,18,33,45.5%,7m
1184,2,[BBro]Bandit,4619,0,0,1,1,0.0%,14m
1184,3,[SPO0KY]HunteR,4619,0,0,1,1,0.0%,15m
1184,2,[CsT]Kharnos,4619,0,0,1,1,0.0%,6m
1184,2,MiOh,4619,0,0,3,3,0.0%,24m
1189,2,IIIIIIIIIIII,4617,1162,96,66,162,59.3%,24m
1189,2,[UATeam]UFO,4617,1425,87,40,127,68.5%,9m
1189,2,[eXøde]Crysing,4617,772,41,43,84,48.8%,7m
1192,2,[lMMl]Belgarath,4616,1918,81,76,157,51.6%,9m
1192,2,[XYFAN]Wanderer,4616,138,6,10,16,37.5%,23m
1194,2,[Hаsu]MAKE,4615,394,20,23,43,46.5%,24m
1194,2,TinTin,4615,332,15,14,29,51.7%,14m
1194,2,[VFish]VoiceOfFall,4615,176,6,9,15,40.0%,22m
1194,2,[EmŦ]MagnuM,4615,0,0,2,2,0.0%,14m
1198,2,[isIMBA]Silvisor,4614,0,0,1,1,0.0%,14m
1199,2,SvenskeN,4613,88,4,4,8,50.0%,14m
1200,2,[1984]TheBigPeaT,4612,2146,102,108,210,48.6%,12m
1200,2,llllllllllll,4612,327,21,2,23,91.3%,6m
1200,2,[Sarmat]Samael,4612,285,17,9,26,65.4%,13m
1203,2,Sam,4611,2567,176,149,325,54.2%,23m
1203,2,luvkillwow,4611,1134,81,46,127,63.8%,9m
1203,2,IIIIIIIIIIII,4611,536,31,10,41,75.6%,9m
1203,2,MicroJackson,4611,316,19,15,34,55.9%,9m
1203,2,Morell,4611,155,13,7,20,65.0%,22m
1208,2,llllllllllll,4610,869,62,58,120,51.7%,14m
1208,2,MONUMENTS,4610,1367,61,64,125,48.8%,7m
1208,2,[ЯD]Distan,4610,208,9,18,27,33.3%,12m
1211,2,[сSсǃ]SiriuS,4609,879,62,29,91,68.1%,23m
1211,2,[KRŽ]GreenDoom,4609,58,2,4,6,33.3%,14m
1213,2,Why,4608,2581,150,122,272,55.1%,7m
1213,1,Hermite,4608,884,64,70,134,47.8%,18m
1213,2,[icbajs]COCК,4608,344,15,17,32,46.9%,12m
1213,2,IIIIIIIIIIII,4608,170,7,9,16,43.8%,9m
1213,2,[nKnown]Schizophren,4608,92,6,6,12,50.0%,14m
1213,2,[BeSC]Wanna,4608,0,0,1,1,0.0%,12m
1219,2,Lukino,4607,151,7,6,13,53.8%,23m
1219,2,[F42]GreyestWolf,4607,80,3,5,8,37.5%,13m
1219,2,[Draigo]Kubusiek,4607,0,0,1,1,0.0%,14m
1222,2,[WiLD]Breach,4606,1862,121,93,214,56.5%,14m
1222,2,llllllllllll,4606,117,6,2,8,75.0%,12m
1222,2,EzForMe,4606,0,0,1,1,0.0%,23m
1225,2,[ßaller]MicroJackson,4605,1344,108,100,208,51.9%,12m
1226,2,Chuckie,4604,2554,140,148,288,48.6%,6m
1226,2,[PMǂ]JustLikeFire,4604,1630,95,87,182,52.2%,22m
1226,2,DuMbeutel,4604,70,3,6,9,33.3%,12m
1226,2,[ЯD]Voltacus,4604,0,1,0,1,100.0%,14m
1226,2,[3Dǃ]CASPER,4604,0,0,3,3,0.0%,24m
1231,2,[EESC]NovemberAjax,4603,312,21,3,24,87.5%,6m
1231,2,JuNo,4603,26,2,5,7,28.6%,9m
1231,2,BimBamBoum,4603,0,1,0,1,100.0%,17m
1234,1,Efreet,4602,856,27,45,72,37.5%,4m
1234,2,Syndrome,4602,96,4,6,10,40.0%,17m
1236,2,RnmN,4601,635,30,20,50,60.0%,12m
1236,2,llllllllllll,4601,393,25,7,32,78.1%,9m
1236,2,root,4601,142,9,2,11,81.8%,14m
1236,2,ShinyRay,4601,170,9,10,19,47.4%,12m
1236,2,[aW]Novo,4601,0,1,0,1,100.0%,6m
1241,2,Unclespam,4600,197,14,4,18,77.8%,14m
1241,2,[MaEs]Esra,4600,0,1,2,3,33.3%,12m
1241,2,[duсks]ASSonFIRE,4600,0,0,1,1,0.0%,12m
1244,2,topgir,4598,2385,175,163,338,51.8%,9m
1244,2,Schrumpumpel,4598,1481,69,66,135,51.1%,14m
1244,1,[ROOT]Bravery,4598,54,2,9,11,18.2%,24m
1247,2,Twice,4597,2300,111,119,230,48.3%,14m
1247,2,[HBGSJR]Smiley,4597,515,44,25,69,63.8%,24m
1249,2,MagicPT,4596,2076,90,83,173,52.0%,9m
1249,2,[Cannоn]Timo,4596,468,28,13,41,68.3%,23m
1249,2,[7x]Motörhead,4596,36,2,5,7,28.6%,9m
1249,2,[M0CH3]Isil,4596,0,1,0,1,100.0%,22m
1253,2,[HBGSJR]Isten,4595,1324,121,113,234,51.7%,17m
1253,2,JackONeill,4595,1345,81,79,160,50.6%,15m
1253,2,ƚƧƐẊƳƁȀƇǨƚ,4595,0,1,0,1,100.0%,6m
1256,2,Flame,4594,668,35,32,67,52.2%,14m
1256,2,Chocopie,4594,174,12,12,24,50.0%,7m
1256,2,[ZjustZ]Zaringat,4594,0,1,0,1,100.0%,13m
1256,2,[SLW]Slayer,4594,0,1,0,1,100.0%,13m
1256,2,[s92]pillar,4594,0,1,0,1,100.0%,6m
1256,2,FireLord,4594,0,0,1,1,0.0%,6m
1262,1,VitoSkaletta,4593,1708,166,172,338,49.1%,17m
1262,2,[ÆR]CacoS,4593,1106,53,54,107,49.5%,13m
1262,2,KakaKiPu,4593,128,4,3,7,57.1%,24m
1265,2,Tiga,4592,286,13,10,23,56.5%,13m
1265,3,Marauder,4592,97,2,0,2,100.0%,9m
1265,2,[RеG]PrinzEugen,4592,87,2,1,3,66.7%,14m
1265,2,[RGAN]Railgan,4592,0,0,1,1,0.0%,24m
1269,2,NewbRevenge,4591,2548,450,459,909,49.5%,9m
1269,2,Bumbler,4591,1729,155,162,317,48.9%,22m
1269,3,Nano,4591,472,31,10,41,75.6%,10m
1269,2,Qiqi,4591,511,23,15,38,60.5%,9m
1269,3,PuMa,4591,46,5,2,7,71.4%,18m
1269,1,[EBU]KIDU,4591,0,0,2,2,0.0%,22m
1269,2,[DGǂ]Muscle,4591,0,0,3,3,0.0%,7m
1276,2,ElstEverto,4590,874,48,50,98,49.0%,22m
1277,2,Kickboxerj,4589,601,32,25,57,56.1%,22m
1278,2,[UATeam]NtStreamline,4588,1270,52,58,110,47.3%,24m
1278,2,[HBGS]BravO,4588,166,8,5,13,61.5%,24m
1278,3,noodlekebab,4588,0,1,0,1,100.0%,10m
1281,2,[GP]Terric,4587,2468,107,116,223,48.0%,22m
1282,2,[FR1]Hurricane,4586,2542,476,477,953,49.9%,9m
1282,3,robotikovVI,4586,84,9,5,14,64.3%,25m
1282,2,YHWH,4586,143,7,5,12,58.3%,13m
1285,1,LuNe,4585,2753,253,274,527,48.0%,8m
1285,2,[TAW]WaRzOnE,4585,469,22,21,43,51.2%,9m
1285,2,PargeLennis,4585,86,2,2,4,50.0%,14m
1288,2,[iX]Meditail,4582,152,7,11,18,38.9%,15m
1288,1,[nB]Rasmuth,4582,277,7,20,27,25.9%,14m
1288,2,SLVR,4582,0,0,3,3,0.0%,6m
1291,2,HideRDK,4581,2109,99,93,192,51.6%,23m
1291,3,Standalone,4581,4,1,2,3,33.3%,18m
1293,2,[CnG]DrBerto,4578,2539,282,294,576,49.0%,13m
1294,2,[BitS]esow,4577,2547,198,204,402,49.3%,12m
1294,2,Salomon,4577,2241,120,114,234,51.3%,24m
1294,1,WalfTheWolf,4577,619,33,47,80,41.2%,13m
1294,2,Wingman,4577,0,0,2,2,0.0%,9m
1298,2,DARK,4576,120,6,11,17,35.3%,14m
1299,2,FOGL,4575,521,25,19,44,56.8%,24m
1299,2,SymphoniC,4575,108,8,7,15,53.3%,14m
1301,2,llllllllllll,4574,2319,159,140,299,53.2%,9m
1301,3,[mejmej]Bubler,4574,0,0,1,1,0.0%,8m
1303,2,Bullerpik,4573,715,89,81,170,52.4%,14m
1304,2,TheBatman,4572,1443,100,59,159,62.9%,9m
1304,2,Improving,4572,1016,53,40,93,57.0%,24m
1304,2,[BHC]BlackHand,4572,1109,49,50,99,49.5%,24m
1304,3,IIIIIIIIIIII,4572,566,35,10,45,77.8%,25m
1304,2,Akke,4572,386,16,20,36,44.4%,9m
1304,1,[DHOPEN]LibrA,4572,272,7,17,24,29.2%,8m
1310,2,[ƮesXG]Yepla,4571,96,5,5,10,50.0%,24m
1311,2,[Hаsu]LazZzyBoy,4570,1018,57,65,122,46.7%,14m
1312,1,Lamo,4569,2704,296,311,607,48.8%,17m
1312,3,EzTwentySix,4569,1038,60,46,106,56.6%,10m
1312,2,[aW]Infinity,4569,125,9,10,19,47.4%,15m
1312,3,Deadline,4569,0,1,0,1,100.0%,17m
1312,3,[YLLUMA]Feroth,4569,0,0,1,1,0.0%,6m
1317,2,AlaD,4568,558,29,29,58,50.0%,12m
1317,2,Tyson,4568,8,1,5,6,16.7%,9m
1319,2,TrapMan,4567,1440,81,31,112,72.3%,9m
1319,3,Nevermore,4567,88,7,8,15,46.7%,8m
1319,3,ƚƧƐẊƳƁȀƇǨƚ,4567,0,1,0,1,100.0%,12m
1322,1,[aW]mingo,4566,1458,145,152,297,48.8%,18m
1322,1,Törttö,4566,1381,140,154,294,47.6%,16m
1322,1,Kay,4566,97,4,4,8,50.0%,5m
1322,3,[3e5m]Insomnia,4566,0,1,1,2,50.0%,9m
1322,2,пятьктерран,4566,14,1,4,5,20.0%,24m
1327,3,[SLD]Pixelbuddha,4565,902,51,41,92,55.4%,9m
1327,2,[αX]Arrogfire,4565,116,6,10,16,37.5%,14m
1329,3,Australe,4564,210,9,2,11,81.8%,6m
1329,3,Flamongo,4564,0,0,1,1,0.0%,5m
1331,2,[KoyBee]Koy,4563,2247,320,302,622,51.4%,12m
1331,2,Stoic,4563,367,46,44,90,51.1%,14m
1331,3,[NwAs]Draconix,4563,189,7,3,10,70.0%,8m
1334,1,[Oath]eagle,4561,1219,117,124,241,48.5%,18m
1334,2,Yála,4561,781,41,29,70,58.6%,17m
1334,2,MacroMonster,4561,723,41,29,70,58.6%,12m
1334,3,Tactyw,4561,228,21,15,36,58.3%,25m
1338,2,[Nzth]Xrestos,4560,940,48,37,85,56.5%,7m
1338,2,Weecka,4560,696,27,39,66,40.9%,24m
1338,3,OrisAVGN,4560,0,1,0,1,100.0%,7m
1341,3,effffOrt,4559,272,10,4,14,71.4%,10m
1342,2,[сSсǃ]August,4558,480,26,24,50,52.0%,17m
1342,2,ByunFan,4558,209,14,11,25,56.0%,7m
1344,1,[PŖïMĄŁ]jabonlagarto,4556,1792,231,236,467,49.5%,18m
1344,2,[JAREK]leSzCz,4556,239,18,13,31,58.1%,17m
1344,3,SpeakNow,4556,49,12,7,19,63.2%,15m
1344,3,[AppSha]Temu,4556,0,1,0,1,100.0%,25m
1344,3,MKH,4556,4,1,1,2,50.0%,6m
1349,2,DireStraits,4555,754,32,40,72,44.4%,13m
1350,2,Eyeballz,4554,1094,61,52,113,54.0%,23m
1350,2,Sig,4554,812,39,36,75,52.0%,9m
1350,2,Daloze,4554,360,18,19,37,48.6%,12m
1353,2,pali,4552,614,36,26,62,58.1%,23m
1354,1,GattoPazzo,4551,2066,122,135,257,47.5%,16m
1354,1,IIIIIIIIIIII,4551,143,4,0,4,100.0%,11m
1354,2,ieatzergs,4551,102,2,5,7,28.6%,15m
1357,2,KierowcaPKS,4550,363,21,18,39,53.8%,23m
1357,3,[Kurios]IIIlllIIIlll,4550,0,1,1,2,50.0%,17m
1359,2,[BRSKR]TeaCup,4549,1759,79,76,155,51.0%,24m
1359,3,[DRTYLR]EzBM,4549,114,11,8,19,57.9%,25m
1359,1,RnmN,4549,0,1,7,8,12.5%,6m
1362,2,PreSelection,4548,1442,70,49,119,58.8%,9m
1362,1,[EESC]Aramos,4548,1058,41,61,102,40.2%,10m
1362,3,aMATTeur,4548,0,1,0,1,100.0%,17m
1365,3,[duсks]RomahaTM,4547,0,0,1,1,0.0%,5m
1366,3,[EXPANT]Alexis,4546,0,0,1,1,0.0%,7m
1366,3,alesha,4546,0,0,1,1,0.0%,16m
1368,3,[ØC]GatsbY,4545,0,0,1,1,0.0%,12m
1369,2,Egal,4544,360,21,10,31,67.7%,9m
1370,3,[Batia]alariii,4543,649,109,13,122,89.3%,2m
1370,2,[BeSC]Skipp,4543,372,19,22,41,46.3%,7m
1370,3,NotKorea,4543,138,4,0,4,100.0%,10m
1370,3,[AiRǂ]MacroAclicK,4543,0,1,1,2,50.0%,14m
1374,3,[Cakes]vestnik,4542,796,45,41,86,52.3%,10m
1374,3,llIlIllIllII,4542,487,33,10,43,76.7%,25m
1374,2,[TbMzor]OLI,4542,740,32,39,71,45.1%,12m
1374,3,MimonBaraka,4542,38,9,1,10,90.0%,18m
1374,3,IIIIIIIIIIII,4542,12,4,8,12,33.3%,10m
1379,3,lIlIlIllIllI,4541,46,5,4,9,55.6%,17m
1379,3,short,4541,12,2,4,6,33.3%,10m
1381,2,Ashenuwuwuwu,4540,776,41,29,70,58.6%,9m
1381,2,[ESErl]Devastating,4540,438,24,24,48,50.0%,12m
1381,2,[xMiCx]Angerfist,4540,24,3,4,7,42.9%,9m
1384,3,PatchZerg,4539,78,11,4,15,73.3%,10m
1384,2,Cronabak,4539,0,0,5,5,0.0%,17m
1386,1,IIIIIIIIIIII,4537,1591,405,384,789,51.3%,14m
1386,2,[RSK]Tazwarrior,4537,292,18,12,30,60.0%,12m
1386,3,[sfc]Qwaky,4537,8,2,0,2,100.0%,17m
1389,2,Higgs,4536,1844,243,244,487,49.9%,7m
1389,2,Pastabrain,4536,636,32,16,48,66.7%,22m
1391,3,[Cannоn]Timo,4535,626,37,27,64,57.8%,10m
1391,3,[SMK]ScRiBbLe,4535,82,11,6,17,64.7%,9m
1391,2,Sevnin,4535,56,3,9,12,25.0%,24m
1391,3,[PSlSTC]MyLifeFrAiur,4535,0,1,0,1,100.0%,15m
1395,3,RandyRandom,4534,218,21,15,36,58.3%,7m
1395,3,[PŖïMĄŁ]Calixter,4534,158,17,10,27,63.0%,15m
1395,2,IIIIIIIIIIII,4534,0,2,3,5,40.0%,8m
1395,1,Dior,4534,0,0,1,1,0.0%,2m
1399,2,[PŖïMĄŁ]BlueS,4533,1679,77,68,145,53.1%,12m
1399,2,imbaUral,4533,882,41,50,91,45.1%,23m
1401,2,[PAUR]Walla,4532,1132,126,125,251,50.2%,7m
1401,2,Alivan,4532,1591,124,124,248,50.0%,15m
1401,2,FarMoR,4532,841,45,36,81,55.6%,23m
1401,2,[BornG]Shask,4532,544,35,29,64,54.7%,14m
1401,3,ƚƧƐẊƳƁȀƇǨƚ,4532,0,1,0,1,100.0%,17m
1401,3,[AnD]ßØÜkǺŞ,4532,0,0,1,1,0.0%,10m
1401,1,[44IQ]TheTinyMelon,4532,0,0,1,1,0.0%,12m
1408,2,IIIIIIIIIIII,4531,919,53,31,84,63.1%,17m
1409,3,[HBGSJR]Singler,4530,61,16,8,24,66.7%,5m
1409,2,[PŖïMĄŁ]gab,4530,82,4,9,13,30.8%,24m
1409,3,Ykrang,4530,0,1,0,1,100.0%,5m
1409,3,aNDad,4530,0,1,0,1,100.0%,25m
1413,3,JraycBBII,4529,0,0,1,1,0.0%,26m
1414,3,SparKy,4528,914,53,5,58,91.4%,14m
1415,3,[UATeam]Reyden,4527,0,0,2,2,0.0%,9m
1416,2,[HBGSJR]CeazaR,4526,1035,49,49,98,50.0%,13m
1416,1,Osthøvel,4526,308,16,0,16,100.0%,6m
1416,3,MaksL,4526,0,1,0,1,100.0%,15m
1416,3,ƚƧƐẊƳƁȀƇǨƚ,4526,0,1,0,1,100.0%,10m
1420,2,BeefITek,4525,1596,136,129,265,51.3%,7m
1420,3,[GoldM]Blackwidow,4525,142,16,9,25,64.0%,15m
1420,3,IlIlIlIIIlIl,4525,100,13,7,20,65.0%,8m
1420,3,[RÐ]Nath,4525,62,5,2,7,71.4%,2m
1424,3,Yoyo,4523,730,35,5,40,87.5%,18m
1425,2,[OrDan]Samurai,4522,281,89,92,181,49.2%,22m
1425,2,[CYC]StimToWin,4522,1126,65,71,136,47.8%,22m
1425,3,[1RaxCC]Khôra,4522,48,5,4,9,55.6%,4m
1425,3,Breath,4522,0,3,3,6,50.0%,6m
1425,3,[ØC]Capucin,4522,0,0,1,1,0.0%,2m
1430,2,Fireman,4521,2318,214,226,440,48.6%,14m
1430,3,[mTLeu]Suladân,4521,166,16,12,28,57.1%,6m
1432,3,onama,4520,150,29,24,53,54.7%,17m
1432,2,[nB]XeNo,4520,278,14,17,31,45.2%,22m
1434,2,[PLSV]Sperwinnable,4519,20,2,5,7,28.6%,17m
1434,3,[IEM21]Clemwillwin,4519,0,1,2,3,33.3%,2m
1436,2,Snorry,4518,2533,429,353,782,54.9%,14m
1436,2,Miam,4518,1961,342,350,692,49.4%,7m
1436,2,[HBGSJR]magic,4518,1662,105,108,213,49.3%,12m
1439,2,KillInHeaven,4517,2278,106,110,216,49.1%,7m
1439,2,Omega,4517,1890,85,80,165,51.5%,9m
1439,3,[TAW]SpaceMarine,4517,100,16,11,27,59.3%,7m
1439,1,Exehn,4517,96,2,4,6,33.3%,11m
1439,2,[XpLeu]Cython,4517,36,2,7,9,22.2%,13m
1444,3,[Living]TerranKinG,4516,832,53,27,80,66.2%,16m
1444,2,[OpIba]IlIlIlIlIlIl,4516,260,13,15,28,46.4%,23m
1444,3,BaBuShaSha,4516,0,1,0,1,100.0%,17m
1447,2,[NRV]HiDo,4515,522,28,36,64,43.8%,15m
1447,3,[ECFeV]Havior,4515,212,15,10,25,60.0%,12m
1447,3,TODIEFOR,4515,136,13,18,31,41.9%,17m
1447,3,aep,4515,30,4,1,5,80.0%,5m
1447,3,silvercrow,4515,20,3,4,7,42.9%,11m
1447,3,eQual,4515,16,1,3,4,25.0%,16m
1453,3,Crabencia,4514,2329,434,400,834,52.0%,4m
1453,3,Zubex,4514,70,7,7,14,50.0%,5m
1453,3,ƚƧƐẊƳƁȀƇǨƚ,4514,0,1,0,1,100.0%,15m
1453,3,SacredCocos,4514,0,1,0,1,100.0%,14m
1457,2,[nB]DreinarK,4513,2283,167,160,327,51.1%,7m
1457,3,Sccc,4513,506,40,15,55,72.7%,9m
1457,3,[marcW]Daffe,4513,0,1,3,4,25.0%,10m
1460,1,Coudest,4512,2688,313,309,622,50.3%,17m
1460,2,[GTMNG]FroZeN,4512,2350,173,150,323,53.6%,24m
1460,3,Witchqueen,4512,313,33,27,60,55.0%,12m
1460,3,Kou,4512,153,5,5,10,50.0%,4m
1460,2,Cake,4512,124,4,6,10,40.0%,23m
1465,3,lIIIIIIIIIII,4511,18,2,2,4,50.0%,25m
1466,3,ilikecookies,4510,540,47,27,74,63.5%,4m
1466,3,NoSoupfOu,4510,154,16,14,30,53.3%,25m
1468,2,[1984]BearBeard,4509,1470,63,74,137,46.0%,15m
1468,3,TryHard,4509,495,37,14,51,72.5%,16m
1468,3,LuPiN,4509,6,2,1,3,66.7%,12m
1468,3,[FSeS]jZR,4509,12,1,3,4,25.0%,25m
1472,3,Chucky,4508,1299,70,64,134,52.2%,4m
1472,2,[WBO]Quezacoalt,4508,1506,67,74,141,47.5%,12m
1472,3,luvkill,4508,370,27,14,41,65.9%,5m
1472,3,ƚƧƐẊƳƁȀƇǨƚ,4508,0,1,0,1,100.0%,15m
1472,1,Kato,4508,0,0,1,1,0.0%,25m
1472,3,AlphaStar,4508,0,0,1,1,0.0%,6m
1478,2,[LoCarb]Microroni,4507,938,76,42,118,64.4%,12m
1478,3,sAviOR,4507,666,52,36,88,59.1%,15m
1478,3,aNDad,4507,18,2,1,3,66.7%,18m
1478,3,[SeTeH]MoCu,4507,0,0,1,1,0.0%,17m
1482,3,DeusXMachina,4506,82,9,5,14,64.3%,18m
1482,3,Trick,4506,30,2,2,4,50.0%,17m
1484,3,[WYG]OzyMandiaS,4505,166,31,28,59,52.5%,12m
1484,3,Myorg,4505,6,2,0,2,100.0%,14m
1484,3,[lMMl]hUed,4505,0,0,1,1,0.0%,12m
1487,3,Limba,4504,30,2,6,8,25.0%,8m
1488,1,Alice,4503,406,18,2,20,90.0%,17m
1488,2,Siegfried,4503,372,16,26,42,38.1%,12m
1488,2,Kev,4503,316,15,27,42,35.7%,7m
1488,3,[lsexyl]illusion,4503,0,0,3,3,0.0%,11m
1492,3,HaviLing,4502,502,54,31,85,63.5%,17m
1492,3,InShock,4502,22,3,5,8,37.5%,26m
1492,3,IIIIIIIIIII,4502,8,2,2,4,50.0%,9m
1492,3,[морген]Снюс,4502,4,1,3,4,25.0%,18m
1492,3,RoMario,4502,0,0,1,1,0.0%,10m
1492,3,llllllllllll,4502,0,0,3,3,0.0%,17m
1498,2,IIIIIIIIIIII,4501,884,99,94,193,51.3%,25m
1498,3,Pech,4501,420,22,3,25,88.0%,9m
1498,3,MikePence,4501,0,1,0,1,100.0%,6m
1498,3,zbawl,4501,0,0,1,1,0.0%,2m
1502,1,[5kter]KEKW,4500,114,3,34,37,8.1%,13m
1503,2,[neuroW]murlibrumm,4499,2098,117,118,235,49.8%,7m
1503,3,FrosT,4499,1178,93,72,165,56.4%,6m
1503,1,IIIIIIIIIIII,4499,97,1,7,8,12.5%,23m
1506,2,[RеG]ProtoFey,4498,788,41,39,80,51.2%,13m
1506,2,FullBuster,4498,412,17,26,43,39.5%,14m
1506,3,wendy,4498,0,0,1,1,0.0%,6m
1509,2,ZincZeppelin,4497,2467,144,151,295,48.8%,13m
1509,3,[CDLB]pfffGG,4497,0,0,4,4,0.0%,2m
1511,2,Нафаняяяяяяя,4496,282,15,24,39,38.5%,12m
1512,3,Maqua,4495,2303,269,234,503,53.5%,15m
1512,3,[salvo]Marfor,4495,0,1,0,1,100.0%,18m
1512,3,[PariSG]Tonio,4495,0,0,1,1,0.0%,10m
1515,2,[EESC]EnDeR,4494,2481,345,367,712,48.5%,15m
1516,2,[MSUSC2]ShiFu,4493,1822,86,77,163,52.8%,7m
1516,2,SonG,4493,1133,51,53,104,49.0%,9m
1516,3,Hush,4493,24,3,2,5,60.0%,16m
1516,3,[3Dǃ]SunRise,4493,0,1,0,1,100.0%,10m
1520,2,TikiTiki,4492,2395,153,170,323,47.4%,12m
1520,3,Nagi,4492,319,22,4,26,84.6%,6m
1520,1,[Любблю]Русланадобро,4492,42,1,19,20,5.0%,14m
1520,3,[WITCHs]Lindsey,4492,0,0,1,1,0.0%,10m
1524,3,Xenity,4491,14,2,1,3,66.7%,16m
1524,3,[IndyK]ZaGGara,4491,8,1,1,2,50.0%,12m
1524,3,UedSoldier,4491,0,1,3,4,25.0%,10m
1527,3,IIIIIIIIIIII,4490,475,35,12,47,74.5%,8m
1528,2,LiveSixx,4489,2201,213,210,423,50.4%,17m
1528,3,RoyaL,4489,173,6,0,6,100.0%,15m
1528,3,JJH,4489,0,1,0,1,100.0%,9m
1528,3,[Maaate]Chirasu,4489,0,0,1,1,0.0%,16m
1532,2,Platypus,4488,2418,257,255,512,50.2%,24m
1532,3,[IBeAŚI]Tornadotom,4488,0,0,2,2,0.0%,15m
1534,3,Taimyr,4487,3,6,6,12,50.0%,10m
1534,3,zet,4487,18,3,3,6,50.0%,25m
1534,3,[ScSwrm]JadedShard,4487,0,1,0,1,100.0%,18m
1534,3,LucaDsouplie,4487,2,1,1,2,50.0%,7m
1538,3,[CoFi]Ahlco,4486,2273,147,92,239,61.5%,16m
1538,3,Chimp,4486,1109,86,58,144,59.7%,9m
1538,3,ivangnom,4486,56,8,3,11,72.7%,4m
1538,2,Dav,4486,142,6,13,19,31.6%,14m
1542,3,[BHESS]LeBregognon,4485,813,57,49,106,53.8%,4m
1542,2,DenLilleMand,4485,269,15,16,31,48.4%,15m
1542,3,Nuguri,4485,56,6,3,9,66.7%,25m
1542,2,SLAVok,4485,130,6,12,18,33.3%,15m
1542,3,Montolovich,4485,26,2,1,3,66.7%,2m
1542,3,Freddiet,4485,0,0,1,1,0.0%,4m
1548,1,phlegmat,4484,2658,342,345,687,49.8%,17m
1548,2,Betrayer,4484,228,10,18,28,35.7%,7m
1550,2,[HGay]Dnopy,4483,0,0,1,1,0.0%,22m
1551,3,HeatedStove,4481,32,4,2,6,66.7%,10m
1551,3,Whitebeard,4481,10,2,0,2,100.0%,16m
1551,3,Фортнайтер,4481,0,1,0,1,100.0%,6m
1554,3,Pipo,4480,126,35,22,57,61.4%,25m
1555,3,[RBlood]Kawasaki,4479,2240,224,204,428,52.3%,11m
1556,3,[AEJAP]DarkFallen,4478,20,3,2,5,60.0%,26m
1556,3,[KDV]Zleworzygacz,4478,0,1,0,1,100.0%,17m
1556,3,Moebius,4478,12,1,1,2,50.0%,26m
1559,2,Forum,4477,2485,239,245,484,49.4%,12m
1559,2,iLoveBusia,4477,1049,180,167,347,51.9%,25m
1559,2,[VuV]Jidduu,4477,1913,116,114,230,50.4%,22m
1562,3,BigBrain,4476,1535,166,159,325,51.1%,2m
1562,3,MulTTitask,4476,0,1,0,1,100.0%,16m
1562,3,Orcinus,4476,0,0,3,3,0.0%,11m
1565,1,KoToL,4474,2143,165,174,339,48.7%,4m
1565,2,[PÂRłAH]robotikov,4474,539,23,30,53,43.4%,7m
1565,3,Addict,4474,186,19,20,39,48.7%,9m
1565,3,[TheDOH]ZIEPJUP,4474,82,13,9,22,59.1%,4m
1565,3,IIIIIIIIIIII,4474,292,10,15,25,40.0%,17m
1565,3,[BÆSJER]CORONNERS,4474,0,0,1,1,0.0%,17m
1571,3,Olty,4473,1282,73,68,141,51.8%,15m
1572,3,lIlIlIllIIII,4472,0,0,1,1,0.0%,17m
1573,3,Paxters,4471,410,25,27,52,48.1%,8m
1573,3,[Yet]EnzoOL,4471,0,1,1,2,50.0%,17m
1575,1,[IceHus]balance,4470,2463,176,179,355,49.6%,17m
1575,3,[PaniC]MarineKing,4470,479,34,28,62,54.8%,26m
1575,2,[eW0lfz]XxMetalxX,4470,612,34,46,80,42.5%,15m
1575,3,Arther,4470,0,1,0,1,100.0%,11m
1579,2,[FTW]benjii,4469,1706,87,90,177,49.2%,14m
1579,3,deferFree,4469,28,4,7,11,36.4%,10m
1579,3,[BornG]AsheN,4469,0,1,0,1,100.0%,9m
1582,3,TheSchiebung,4468,24,2,7,9,22.2%,6m
1582,3,Tubac,4468,0,0,1,1,0.0%,17m
1584,3,Slaislom,4467,539,48,52,100,48.0%,10m
1584,3,[6k]ДобрыйДобряк,4467,254,13,4,17,76.5%,15m
1584,3,NoReason,4467,14,3,2,5,60.0%,15m
1587,3,qqI,4466,48,8,2,10,80.0%,10m
1587,3,NEETmaster,4466,0,1,0,1,100.0%,8m
1587,3,[VetM]tRankill,4466,0,0,1,1,0.0%,18m
1590,3,[Русдрk]SirShiFt,4465,750,34,16,50,68.0%,16m
1590,3,Axion,4465,22,4,4,8,50.0%,10m
1592,3,[IceHus]Krep,4464,997,53,30,83,63.9%,11m
1592,3,[ArGGEJ]Bismarck,4464,914,53,36,89,59.6%,16m
1592,3,[SQL]Kvassten,4464,0,0,1,1,0.0%,2m
1595,1,YINGYINGYING,4463,168,6,7,13,46.2%,6m
1595,3,[BRSKR]Space,4463,10,3,1,4,75.0%,15m
1595,3,LongJohn,4463,18,2,2,4,50.0%,6m
1595,3,NarO,4463,0,1,1,2,50.0%,26m
1599,2,[улей55]Steelwar,4462,2222,288,273,561,51.3%,17m
1599,2,SKs,4462,555,64,72,136,47.1%,22m
1599,3,[ZeTePr]MicroMelon,4462,648,42,43,85,49.4%,11m
1599,3,[EESC]Orcrist,4462,175,13,8,21,61.9%,25m
1603,2,[SZ]NeMo,4461,2457,127,127,254,50.0%,17m
1603,3,Lasttray,4461,273,21,13,34,61.8%,5m
1605,3,[RÐ]CuréCalin,4460,2056,123,120,243,50.6%,6m
1605,3,MEDIV,4460,823,41,32,73,56.2%,16m
1605,2,[KaGa]Aerox,4460,452,38,37,75,50.7%,12m
1605,2,llllllllllll,4460,264,15,15,30,50.0%,7m
1605,1,llllllllllll,4460,71,3,3,6,50.0%,14m
1605,3,Pommettes,4460,16,2,3,5,40.0%,25m
1605,3,NervO,4460,0,1,0,1,100.0%,7m
1605,3,[GoldM]ImProvement,4460,0,0,5,5,0.0%,15m
1613,3,katzoo,4459,898,56,54,110,50.9%,8m
1613,2,[Heroes]CptHindsight,4459,966,49,52,101,48.5%,14m
1613,2,[sGeeks]zettick,4459,748,38,42,80,47.5%,12m
1613,3,ƚƧƐẊƳƁȀƇǨƚ,4459,0,1,0,1,100.0%,16m
1613,3,puchiii,4459,0,0,1,1,0.0%,8m
1613,3,[Tiz]MELO,4459,0,0,1,1,0.0%,5m
1619,3,[PLA2N]Ryan,4458,418,30,30,60,50.0%,25m
1619,3,Reylight,4458,0,1,0,1,100.0%,8m
1621,3,Kokotikov,4457,32,4,3,7,57.1%,8m
1621,3,IIIIIIIIIIII,4457,6,2,0,2,100.0%,10m
1621,3,Ratzcal,4457,0,1,0,1,100.0%,9m
1624,3,[EoAiur]Duvan,4456,975,168,136,304,55.3%,25m
1624,3,[WBO]bLitZ,4456,0,0,1,1,0.0%,8m
1626,3,Siosnarf,4455,0,1,0,1,100.0%,4m
1627,2,wojtek,4454,2460,226,239,465,48.6%,7m
1627,3,flying,4454,278,13,1,14,92.9%,15m
1627,3,[AnD]SpeCial,4454,12,3,2,5,60.0%,25m
1627,3,HJM,4454,0,0,1,1,0.0%,10m
1627,3,vladek,4454,0,0,2,2,0.0%,17m
1632,2,Enigma,4453,2454,212,208,420,50.5%,23m
1632,3,muesli,4453,6,2,0,2,100.0%,26m
1632,3,Duggi,4453,8,2,7,9,22.2%,10m
1632,3,HyperVirgin,4453,0,0,1,1,0.0%,8m
1636,2,Pacsi,4452,714,30,44,74,40.5%,7m
1636,3,[3Dǃ]AntonyZerg,4452,0,1,2,3,33.3%,18m
1636,3,cmob,4452,0,0,1,1,0.0%,16m
1639,2,Ace,4451,2416,296,314,610,48.5%,14m
1639,3,Rachmaninoff,4451,368,51,54,105,48.6%,10m
1639,2,starry,4451,454,22,27,49,44.9%,15m
1639,3,Sherminator,4451,0,1,0,1,100.0%,6m
1643,2,SoralARaison,4450,2277,144,149,293,49.1%,14m
1643,3,Dubee,4450,1292,69,72,141,48.9%,4m
1643,1,llllllllllll,4450,239,20,4,24,83.3%,17m
1646,3,[Megumi]Katou,4449,2118,101,97,198,51.0%,17m
1646,3,[MATI]Akilis,4449,274,14,7,21,66.7%,6m
1646,3,Elmo,4449,4,2,2,4,50.0%,4m
1646,3,IIIIIIIIIIII,4449,8,1,6,7,14.3%,10m
1650,3,[PBZ]BlackMamba,4447,2088,130,105,235,55.3%,15m
1650,2,TheCho,4447,818,37,32,69,53.6%,24m
1650,3,iMReallYMaDD,4447,233,13,2,15,86.7%,2m
1653,3,[DoA]Gabri,4446,889,129,88,217,59.4%,4m
1653,3,IIIIIIIIIIII,4446,46,10,9,19,52.6%,10m
1653,3,Bobbbbbbbbbb,4446,20,3,1,4,75.0%,15m
1653,3,Warpig,4446,12,2,1,3,66.7%,17m
1653,3,[ØC2]Kellidan,4446,0,0,1,1,0.0%,25m
1658,1,TossIsZeroIQ,4445,2668,237,236,473,50.1%,15m
1658,3,[PŖïMĄŁ]NiTo,4445,242,19,22,41,46.3%,15m
1658,3,jumpEr,4445,112,13,14,27,48.1%,16m
1658,3,NorthWind,4445,6,1,3,4,25.0%,10m
1662,3,[HBeS]Pulsar,4444,1055,60,45,105,57.1%,4m
1663,3,ЛомаюЛица,4443,1678,243,227,470,51.7%,15m
1663,2,Hellhound,4443,571,135,136,271,49.8%,14m
1663,3,IIIIIIIIII,4443,847,50,43,93,53.8%,8m
1663,3,FingerMeDady,4443,26,5,3,8,62.5%,11m
1663,3,llllllllllll,4443,26,4,5,9,44.4%,18m
1663,2,[ØC]ParaBelluM,4443,142,3,4,7,42.9%,25m
1663,3,[DDHV]danskiy,4443,12,1,1,2,50.0%,16m
1670,3,mxl,4442,657,53,37,90,58.9%,6m
1670,3,[iX]Meddle,4442,0,1,0,1,100.0%,7m
1672,3,ByuN,4441,379,48,49,97,49.5%,12m
1672,3,Aster,4441,627,40,23,63,63.5%,7m
1672,1,Roselio,4441,434,19,3,22,86.4%,25m
1672,3,DarKhan,4441,0,0,1,1,0.0%,15m
1676,2,[GoldM]Axios,4440,54,4,11,15,26.7%,12m
1676,3,[illGG]Fraggzy,4440,8,2,4,6,33.3%,25m
1678,2,[RBlood]Dounutz,4439,426,77,72,149,51.7%,7m
1678,3,[Ǽ1]hajprut,4439,627,37,19,56,66.1%,18m
1678,3,Samson,4439,0,1,0,1,100.0%,5m
1681,2,Etharis,4438,2479,471,481,952,49.5%,7m
1681,2,[KrnBrs]Divine,4438,637,59,64,123,48.0%,22m
1681,2,MicroJackson,4438,878,42,44,86,48.8%,9m
1681,3,Taitaiwoo,4438,327,24,12,36,66.7%,8m
1681,3,[EAU]Storm,4438,0,1,0,1,100.0%,8m
1681,3,Wizardking,4438,0,1,0,1,100.0%,15m
1681,3,FruitBunker,4438,0,0,1,1,0.0%,9m
1688,1,HairlineBoss,4437,235,11,4,15,73.3%,14m
1688,3,[TAW]WaRzOnE,4437,58,5,7,12,41.7%,25m
1688,3,bob,4437,6,2,2,4,50.0%,4m
1688,3,bendoro,4437,0,1,0,1,100.0%,15m
1688,3,Bestbrother,4437,0,1,3,4,25.0%,10m
1693,3,Xephos,4436,883,54,5,59,91.5%,18m
1693,1,Mekar,4436,320,11,24,35,31.4%,11m
1693,3,[PŖïMĄŁ]ŞҚцŁŁўĢдИ,4436,0,1,0,1,100.0%,12m
1693,3,[duсks]Ĺēñìñ,4436,0,0,1,1,0.0%,6m
1697,2,Ariez,4435,2036,354,367,721,49.1%,15m
1697,3,[ICGl]MoDDiB,4435,1540,163,158,321,50.8%,10m
1697,3,[VetM]KimboSlice,4435,0,0,1,1,0.0%,10m
1700,3,[ØC]Phyrsos,4434,18,2,7,9,22.2%,17m
1700,3,Dilhando,4434,6,1,3,4,25.0%,12m
1702,2,[OoE]JonSnow,4433,1947,187,207,394,47.5%,12m
1702,3,Khlox,4433,1276,147,125,272,54.0%,16m
1702,2,[Based]Pato,4433,1266,92,106,198,46.5%,15m
1705,3,Bachira,4432,877,104,108,212,49.1%,10m
1705,3,JayKay,4432,324,33,28,61,54.1%,7m
1705,3,dryhips,4432,0,1,1,2,50.0%,6m
1705,3,HissigFuru,4432,0,0,3,3,0.0%,2m
1709,2,Lavib,4431,1895,154,134,288,53.5%,12m
1709,3,[NVY]DeathMarine,4431,18,4,3,7,57.1%,15m
1711,2,[PaniC]Freezard,4430,789,57,54,111,51.4%,14m
1712,3,Plumeria,4429,178,36,29,65,55.4%,25m
1712,1,Theovide,4429,48,1,1,2,50.0%,14m
1712,3,[BROSER]Kurgan,4429,0,0,1,1,0.0%,11m
1715,3,MystiH,4427,925,88,72,160,55.0%,10m
1715,2,Ame,4427,1268,60,60,120,50.0%,9m
1715,2,[NMSQ]RubiX,4427,184,10,16,26,38.5%,23m
1715,3,Slayer,4427,26,6,5,11,54.5%,12m
1715,3,[НТТ]paNix,4427,0,1,0,1,100.0%,18m
1720,3,IlIIllIIlIIl,4426,418,22,7,29,75.9%,10m
1720,2,[TSI]Aicy,4426,106,4,14,18,22.2%,15m
1722,3,Blopi,4425,2255,230,222,452,50.9%,6m
1722,3,[BFeS]Tachyon,4425,353,31,17,48,64.6%,15m
1722,3,[ArGGEJ]BratBratKAǃ,4425,164,18,16,34,52.9%,16m
1722,3,petrLXXIVrus,4425,222,18,18,36,50.0%,15m
1722,3,[Kompis]Glorfindel,4425,8,1,7,8,12.5%,10m
1722,3,IIIIIIIIIIII,4425,0,0,2,2,0.0%,5m
1728,3,Karloo,4424,2222,227,218,445,51.0%,9m
1728,2,[LMBD]llllllllllll,4424,1745,143,137,280,51.1%,15m
1728,3,Sniper,4424,8,2,0,2,100.0%,18m
1728,3,Sniper,4424,0,0,1,1,0.0%,18m
1732,3,Leon,4423,2080,172,165,337,51.0%,9m
1732,3,ƚƧƐẊƳƁȀƇǨƚ,4423,0,1,0,1,100.0%,2m
1734,3,lilTRX,4422,133,5,2,7,71.4%,15m
1734,3,[aW]ZphiR,4422,12,3,3,6,50.0%,6m
1734,3,ƚƧƐẊƳƁȀƇǨƚ,4422,0,1,0,1,100.0%,12m
1737,3,[HTR57]ProbyTheProb,4421,530,81,86,167,48.5%,4m
1737,3,IIIIIIIIIIII,4421,634,33,12,45,73.3%,15m
1737,3,[Sarmat]THEYNECK,4421,12,3,0,3,100.0%,25m
1740,2,[GoldM]sulzbard,4420,2342,281,287,568,49.5%,12m
1740,3,IIIIIIIIIII,4420,530,24,12,36,66.7%,25m
1742,3,[Sarmat]SaoriKimura,4419,1355,84,77,161,52.2%,16m
1742,3,Salos,4419,954,76,70,146,52.1%,9m
1742,2,[UATeam]Governor,4419,258,6,22,28,21.4%,9m
1742,3,LØAD,4419,0,1,6,7,14.3%,25m
1742,3,[MARLB]NEs,4419,0,0,1,1,0.0%,9m
1747,3,[CHCH]TossTheWay,4418,0,0,1,1,0.0%,10m
1748,3,Haini,4417,440,27,20,47,57.4%,9m
1748,3,[LOMZA]Marin,4417,0,0,1,1,0.0%,5m
1750,3,tingeltangel,4416,2220,231,227,458,50.4%,16m
1750,3,[ReRise]JaKeN,4416,54,6,9,15,40.0%,15m
1750,3,llllllllllll,4416,28,3,5,8,37.5%,10m
1753,3,BigRichard,4415,158,11,5,16,68.8%,10m
1753,3,llllllllllll,4415,20,4,5,9,44.4%,4m
1753,1,fAzNi,4415,144,3,0,3,100.0%,5m
1753,2,ƚƧƐẊƳƁȀƇǨƚ,4415,0,1,0,1,100.0%,10m
1753,3,[MaryMe]SuperTramp,4415,0,0,1,1,0.0%,18m
1753,3,MarineRu,4415,0,0,2,2,0.0%,7m
1759,3,[HBGSJR]llllllllllll,4414,1157,437,412,849,51.5%,8m
1759,3,Sihoe,4414,1162,128,111,239,53.6%,18m
1759,3,RydbergAtom,4414,0,1,0,1,100.0%,15m
1762,2,[Wø]AǂMitch,4413,1034,45,60,105,42.9%,15m
1762,3,Saiph,4413,269,20,11,31,64.5%,8m
1762,3,[KMЅ]TTK,4413,90,11,17,28,39.3%,11m
1762,3,[Yame]Heisenberg,4413,0,0,1,1,0.0%,16m
1766,3,[PLA2N]Bekzhan,4412,495,30,21,51,58.8%,4m
1766,3,GreyWorm,4412,0,1,0,1,100.0%,5m
1766,3,[PiGPan]Akoo,4412,0,0,1,1,0.0%,18m
1766,3,Ttofinator,4412,0,0,1,1,0.0%,5m
1770,3,[KAY5]blitzkrieg,4411,1040,233,234,467,49.9%,5m
1770,3,mrcrowley,4411,4,1,5,6,16.7%,9m
1772,3,[CrøkeT]ElMakac,4410,411,20,1,21,95.2%,16m
1772,3,Pvtbryan,4410,10,2,4,6,33.3%,25m
1774,3,[Enda]Endante,4409,14,3,2,5,60.0%,17m
1774,3,jayzory,4409,115,2,1,3,66.7%,11m
1774,3,[MFclub]makoz,4409,0,0,4,4,0.0%,11m
1777,3,[InBri]unimat,4408,22,4,2,6,66.7%,17m
1777,3,ILoveShirin,4408,0,0,1,1,0.0%,8m
1779,3,[LDLV]Poun,4407,0,0,1,1,0.0%,25m
1780,3,asdf,4406,0,3,2,5,60.0%,18m
1780,3,STAY,4406,0,1,0,1,100.0%,8m
1782,3,llIllIlIlIll,4405,892,70,58,128,54.7%,10m
1782,2,fiReSD,4405,986,48,52,100,48.0%,17m
1784,2,[FrostG]wAAYYkkhkh,4404,1104,120,122,242,49.6%,25m
1784,3,[QTclub]DoomCookie,4404,1471,69,64,133,51.9%,18m
1784,3,[Картош]Oldwizard,4404,30,4,13,17,23.5%,4m
1784,1,Skylla,4404,118,3,0,3,100.0%,3m
1788,3,Omelette,4403,693,50,40,90,55.6%,9m
1788,3,[PŖïMĄŁ]sakis,4403,0,1,0,1,100.0%,10m
1790,1,[LMBD]ByuNJr,4402,1670,93,94,187,49.7%,11m
1790,3,[BotN]CptPolarBear,4402,976,53,58,111,47.7%,25m
1790,1,[lMMl]Ike,4402,928,30,57,87,34.5%,17m
1790,2,spaghetti,4402,204,21,34,55,38.2%,13m
1790,3,SetoKaiba,4402,8,2,2,4,50.0%,18m
1790,3,Immortal,4402,0,2,3,5,40.0%,18m
1790,3,[CCAV]JIEBANREN,4402,0,0,1,1,0.0%,10m
1797,3,atom,4401,339,21,3,24,87.5%,18m
1797,3,IcePanda,4401,42,5,8,13,38.5%,8m
1797,3,Darkness,4401,0,0,1,1,0.0%,11m
1800,3,PaN,4400,406,29,31,60,48.3%,10m
1800,3,[Voll]Quma,4400,34,6,6,12,50.0%,7m
1802,2,[TheDOH]LoKlok,4399,1537,71,85,156,45.5%,24m
1803,3,TenaciousD,4398,452,20,6,26,76.9%,7m
1804,2,llllllllllll,4397,979,82,89,171,48.0%,15m
1804,3,[НТТ]Kovu,4397,0,0,3,3,0.0%,10m
1806,3,Random,4396,1501,173,171,344,50.3%,17m
1806,2,Solitude,4396,2427,137,156,293,46.8%,9m
1806,3,Order,4396,1090,127,140,267,47.6%,17m
1806,3,lIlIlIlIlIlI,4396,560,24,11,35,68.6%,10m
1806,3,[weblak]AzUhL,4396,0,1,0,1,100.0%,17m
1806,3,[Ex0n]Kulka,4396,0,0,2,2,0.0%,10m
1812,3,llllllllllll,4395,368,25,10,35,71.4%,15m
1812,3,[BRSKR]Hylladria,4395,0,1,0,1,100.0%,10m
1812,3,[TAW]RSN,4395,0,1,0,1,100.0%,9m
1815,3,UDTseal,4394,611,50,27,77,64.9%,9m
1815,3,MonsterMunch,4394,14,3,2,5,60.0%,7m
1815,3,[ƔƟƪƟ]illmatic,4394,4,2,0,2,100.0%,10m
1815,3,[13g12p]TheRex,4394,0,1,0,1,100.0%,10m
1815,3,ƚƧƐẊƳƁȀƇǨƚ,4394,0,1,0,1,100.0%,18m
1815,2,MilkyAlien,4394,46,1,1,2,50.0%,8m
1821,3,biotikov,4393,454,27,10,37,73.0%,10m
1822,3,ChinaVirus,4392,0,5,2,7,71.4%,25m
1822,2,IIIIIIIIIIII,4392,0,0,11,11,0.0%,9m
1824,3,FeedMe,4391,0,0,1,1,0.0%,8m
1825,3,asdfasfd,4390,365,14,5,19,73.7%,18m
1825,3,[PLA2N]rom,4390,14,3,3,6,50.0%,16m
1825,3,Guzmán,4390,4,1,2,3,33.3%,3m
1828,3,[VFN]NinJa,4389,2144,180,185,365,49.3%,12m
1828,3,KGKG,4389,196,17,21,38,44.7%,15m
1828,3,[Wardi]Wardí,4389,251,9,6,15,60.0%,25m
1831,3,[iX]Edoras,4388,1214,101,83,184,54.9%,15m
1831,3,tribe,4388,448,22,17,39,56.4%,9m
1831,3,JPCarCanGG,4388,384,17,3,20,85.0%,25m
1831,3,CuX,4388,400,17,8,25,68.0%,3m
1831,3,Todesteufel,4388,0,1,0,1,100.0%,26m
1836,1,IIIIIIIIIIII,4387,2182,251,267,518,48.5%,11m
1836,3,TheReason,4387,335,21,21,42,50.0%,10m
1836,3,Hatador,4387,0,1,0,1,100.0%,9m
1836,3,pczergrocks,4387,0,1,0,1,100.0%,12m
1836,3,AerO,4387,0,0,1,1,0.0%,8m
1841,3,mortyfeo,4386,1677,93,72,165,56.4%,16m
1841,3,cArpa,4386,865,54,36,90,60.0%,8m
1841,3,[axis]Omynös,4386,446,25,6,31,80.6%,15m
1841,3,[ncotic]Marlock,4386,20,3,3,6,50.0%,25m
1845,3,[CosCom]Biryukov,4385,590,27,16,43,62.8%,3m
1845,3,sNǂpRx,4385,266,21,29,50,42.0%,26m
1845,3,futuRe,4385,24,3,8,11,27.3%,8m
1845,3,PatchTerran,4385,97,1,1,2,50.0%,8m
1849,3,[Fridge]gezellig,4384,567,30,15,45,66.7%,15m
1849,3,[1984]Taketsuru,4384,129,5,1,6,83.3%,11m
1849,3,[QTclub]Sprite,4384,0,1,0,1,100.0%,12m
1849,3,[GdAT]Jakdax,4384,97,1,5,6,16.7%,16m
1849,3,StriKeR,4384,0,0,1,1,0.0%,8m
1854,3,Sumire,4383,272,65,56,121,53.7%,7m
1854,3,RadekDaNa,4383,486,36,39,75,48.0%,10m
1854,3,IziRadrix,4383,66,10,11,21,47.6%,16m
1854,3,SapphireStar,4383,20,2,7,9,22.2%,26m
1854,3,[Hаsu]Pihto,4383,0,1,0,1,100.0%,12m
1854,3,[BMD]Galaxy,4383,4,1,4,5,20.0%,8m
1854,3,[TheDOH]Rob,4383,0,0,2,2,0.0%,16m
1861,3,GrosTarnagas,4382,1414,215,203,418,51.4%,16m
1861,3,[OGTVs]Ponterus,4382,592,22,14,36,61.1%,18m
1861,3,llllllllllll,4382,0,1,0,1,100.0%,26m
1861,3,[illGG]NjordSkall,4382,0,0,3,3,0.0%,26m
1865,3,Dewd,4381,375,28,19,47,59.6%,4m
1865,3,ЗлойДобряк,4381,0,12,12,24,50.0%,10m
1865,3,FeelsBadMan,4381,70,7,10,17,41.2%,18m
1865,3,[AmW1]NeonRa,4381,99,2,1,3,66.7%,10m
1869,3,Pogi,4380,559,39,22,61,63.9%,15m
1869,3,[4Kappa]Yeskis,4380,268,12,5,17,70.6%,11m
1869,3,melC,4380,0,4,1,5,80.0%,18m
1869,3,[InBri]Mart,4380,0,0,1,1,0.0%,15m
1869,3,Eclipse,4380,0,0,3,3,0.0%,15m
1874,3,FTImbaBliz,4379,2206,218,228,446,48.9%,3m
1874,3,MrBind,4379,933,160,159,319,50.2%,10m
1874,3,lulWut,4379,1004,44,31,75,58.7%,18m
1874,3,Rolli,4379,546,29,22,51,56.9%,26m
1874,3,Hidra,4379,24,6,6,12,50.0%,6m
1874,3,pedick,4379,0,1,0,1,100.0%,15m
1880,3,Yui,4378,14,3,3,6,50.0%,18m
1880,3,Nuguri,4378,121,2,2,4,50.0%,15m
1880,3,[Mkers]baduer,4378,0,0,1,1,0.0%,18m
1880,3,rexy,4378,0,0,1,1,0.0%,6m
1884,3,Echoes,4377,1130,213,197,410,52.0%,10m
1884,3,LOLOLOLOLOL,4377,1044,54,20,74,73.0%,8m
1884,3,[SCiE]TinToon,4377,966,40,25,65,61.5%,16m
1884,3,[Peeps]Neko,4377,108,15,20,35,42.9%,26m
1884,3,TrulleSWE,4377,10,2,3,5,40.0%,26m
1884,1,[MnrcK]Hirano,4377,0,0,1,1,0.0%,25m
1890,3,[TSVB]JCGamer,4376,858,53,40,93,57.0%,10m
1890,3,roken,4376,751,34,19,53,64.2%,15m
1890,3,Fortu,4376,128,17,3,20,85.0%,18m
1890,3,Soulia,4376,409,15,9,24,62.5%,10m
1890,3,FormerChild,4376,149,4,4,8,50.0%,25m
1890,3,[NWGD]Hippotamus,4376,0,1,0,1,100.0%,7m
1890,3,[NVY]iTsPrime,4376,0,1,0,1,100.0%,4m
1897,3,winterlover,4375,1297,208,188,396,52.5%,7m
1897,3,[PiGPan]Adrusis,4375,1232,187,192,379,49.3%,4m
1897,3,DAVY,4375,729,87,84,171,50.9%,8m
1897,3,IamNotAGirl,4375,396,22,5,27,81.5%,3m
1897,2,[title]LadderHero,4375,348,15,28,43,34.9%,25m
1897,3,[PÂRłAH]Microbot,4375,0,1,0,1,100.0%,8m
1903,3,[WBO]RokietFjueL,4374,605,194,193,387,50.1%,26m
1903,3,[OoE]theghost,4374,864,36,20,56,64.3%,10m
1903,3,Machamp,4374,100,4,0,4,100.0%,16m
1903,3,[SƬǂ]IrOnChain,4374,103,4,2,6,66.7%,4m
1903,3,[eW0lfz]Bever,4374,12,2,13,15,13.3%,10m
1903,3,Gambeulin,4374,6,1,2,3,33.3%,8m
1909,3,MarMat,4373,621,196,193,389,50.4%,15m
1909,3,[L4K]Venefica,4373,337,100,56,156,64.1%,15m
1909,3,[DøA]quaygon,4373,1310,95,31,126,75.4%,7m
1909,3,[RIQ]Troy,4373,1338,55,57,112,49.1%,18m
1909,3,[ISWAGl]Uber,4373,712,46,40,86,53.5%,25m
1909,3,ReVoluTioN,4373,60,7,11,18,38.9%,15m
1909,1,Hello,4373,289,6,9,15,40.0%,6m
1909,3,ƚƧƐẊƳƁȀƇǨƚ,4373,97,2,0,2,100.0%,26m
1917,3,RorO,4372,1471,66,56,122,54.1%,15m
1917,3,[ERHELM]Erik,4372,505,27,14,41,65.9%,6m
1917,3,MolagBal,4372,291,9,6,15,60.0%,10m
1917,3,[SpCI]Samurai,4372,0,1,1,2,50.0%,18m
1917,3,[TV]fOfOfTV,4372,0,0,1,1,0.0%,16m
1917,3,llllllllllll,4372,0,0,1,1,0.0%,15m
1923,3,cKoL,4371,1518,107,104,211,50.7%,18m
1923,3,[aW]Oripe,4371,1213,68,63,131,51.9%,26m
1923,3,[FcG]degaulle,4371,678,30,16,46,65.2%,25m
1923,3,Starkiller,4371,126,14,14,28,50.0%,16m
1923,3,Lestote,4371,0,0,2,2,0.0%,7m
1928,3,[αX]NeWHoriZonS,4370,1503,80,68,148,54.1%,10m
1928,3,IamYupex,4370,1395,70,70,140,50.0%,17m
1928,3,Johnney,4370,1003,67,78,145,46.2%,26m
1928,3,Lilian,4370,516,36,47,83,43.4%,10m
1928,3,[Hаsu]Lopatqa,4370,404,33,37,70,47.1%,15m
1928,3,Dusty,4370,130,6,2,8,75.0%,18m
1928,2,[1A2857]Tio,4370,0,0,1,1,0.0%,4m
1935,3,[BRSKR]Paloma,4369,800,70,46,116,60.3%,12m
1935,2,[Dae]Skoll,4369,970,43,62,105,41.0%,12m
1935,3,[FИCK]DanjA,4369,456,24,14,38,63.2%,6m
1935,3,[PLA2N]skillraiser,4369,248,19,13,32,59.4%,16m
1935,3,DirkGently,4369,386,14,7,21,66.7%,15m
1935,3,[StalkZ]aSaHerBa,4369,322,12,2,14,85.7%,10m
1935,3,[OSgZ]MyMojo,4369,97,1,1,2,50.0%,10m
1942,3,MEMMO,4368,1457,246,241,487,50.5%,7m
1942,3,[EмŦS]Historia,4368,1392,240,195,435,55.2%,10m
1942,1,cideM,4368,2192,159,172,331,48.0%,17m
1942,3,[SNHonk]Fluffy,4368,489,60,40,100,60.0%,10m
1942,3,[Nekro]Tyrrant,4368,834,38,19,57,66.7%,11m
1942,3,PWAМакс,4368,750,32,17,49,65.3%,16m
1942,3,Damz,4368,265,10,11,21,47.6%,8m
1942,3,LoXeS,4368,0,2,3,5,40.0%,7m
1950,3,[PiGPan]AssumedSite,4367,1428,109,112,221,49.3%,26m
1950,3,LULU,4367,97,2,0,2,100.0%,18m
1950,3,EfreeTT,4367,4,1,2,3,33.3%,15m
1953,3,[T4E]Cabbage,4366,1453,129,113,242,53.3%,16m
1953,3,[AiRǂ]Purce,4366,1147,71,53,124,57.3%,18m
1953,3,[Дядя]BARRISTA,4366,558,67,60,127,52.8%,6m
1953,3,[UATeam]KoMaP,4366,1082,61,61,122,50.0%,18m
1953,3,[SBeZ]Teufel,4366,575,38,34,72,52.8%,7m
1953,3,wwwwwwwvv,4366,48,7,10,17,41.2%,11m
1953,3,[Digga]Alucard,4366,121,2,1,3,66.7%,16m
1960,3,TheEfilist,4365,1368,83,87,170,48.8%,15m
1960,3,[2G1M]Mime,4365,187,75,80,155,48.4%,18m
1960,3,ƚƧƐẊƳƁȀƇǨƚ,4365,456,23,7,30,76.7%,16m
1960,3,DarkShadOw,4365,8,3,6,9,33.3%,17m
1960,3,Okimuk,4365,0,1,0,1,100.0%,16m
1965,3,ЗлойКошара,4364,600,194,189,383,50.7%,3m
1965,3,[4KROOT]misery,4364,559,97,82,179,54.2%,3m
1965,2,llllllllllll,4364,1176,60,63,123,48.8%,22m
1965,3,[НТТ]ART,4364,1054,49,38,87,56.3%,18m
1965,3,Hermes,4364,738,35,15,50,70.0%,7m
1965,3,[ImbaNB]ImbaBiondo,4364,122,9,9,18,50.0%,10m
1965,3,Newbie,4364,80,9,15,24,37.5%,16m
1972,3,[B3est]sirPlayALot,4363,2069,234,248,482,48.5%,25m
1972,3,[Kicx]NawaL,4363,890,63,67,130,48.5%,16m
1972,3,Raxxes,4363,797,44,47,91,48.4%,26m
1972,3,[EoAiur]feesk,4363,351,36,25,61,59.0%,15m
1972,3,PRSPRS,4363,228,21,22,43,48.8%,11m
1972,3,[ЕХАLT]tBly,4363,105,15,14,29,51.7%,5m
1972,3,Pütschern,4363,128,11,17,28,39.3%,16m
1972,3,supernoob,4363,0,1,1,2,50.0%,5m
1972,3,ihatesex,4363,0,0,2,2,0.0%,18m
1981,3,JonBonjovi,4362,382,16,6,22,72.7%,15m
1981,3,Ragnar,4362,249,7,9,16,43.8%,10m
1983,3,Protoss,4361,121,3,0,3,100.0%,18m
1983,3,sherminator,4361,0,1,0,1,100.0%,16m
1983,3,[МД86]Moldovanin,4361,0,1,0,1,100.0%,16m
1983,3,[LiFe]MettEagle,4361,97,1,1,2,50.0%,17m
1983,3,Dead,4361,0,0,1,1,0.0%,16m
1983,3,ВялаяМина,4361,0,0,1,1,0.0%,6m
1989,2,WhiteRabbit,4360,2161,476,500,976,48.8%,12m
1989,3,[iGer]Flopgun,4360,2204,183,203,386,47.4%,12m
1989,3,[ProRax]AmaN,4360,568,25,12,37,67.6%,16m
1989,3,TFO,4360,121,2,2,4,50.0%,7m
1993,2,[SY2G]Swarm,4359,138,3,5,8,37.5%,3m
1993,2,[FSeS]Barry,4359,0,0,5,5,0.0%,25m
1995,3,LLV,4358,827,92,68,160,57.5%,25m
1995,1,[ĦRZ]ejozl,4358,0,0,1,1,0.0%,5m
1995,1,[Dobro]Qwan,4358,0,0,1,1,0.0%,10m
1998,3,BigBen,4356,710,38,38,76,50.0%,10m
1998,1,LingKing,4356,143,13,3,16,81.2%,17m
1998,1,TuVeuxTesTeR,4356,0,1,0,1,100.0%,10m
1998,3,[MkersA]PetrusV,4356,4,1,3,4,25.0%,18m
2002,3,[HBGSJR]Radical,4355,128,14,16,30,46.7%,10m
2002,1,Revolver,4355,0,0,1,1,0.0%,8m
2004,3,shocktapus,4354,646,228,229,457,49.9%,10m
2004,3,Horstling,4354,1220,67,74,141,47.5%,16m
2004,1,IIIIIIIIIIII,4354,1410,56,11,67,83.6%,15m
2004,1,HoVa,4354,421,18,0,18,100.0%,12m
2004,1,[ESErl]Anextacy,4354,0,0,1,1,0.0%,9m
2004,1,JaYDaddY,4354,0,0,1,1,0.0%,11m
2010,3,Laetic,4353,1012,50,25,75,66.7%,15m
2010,3,Netolip,4353,284,14,10,24,58.3%,18m
2010,3,Shiny,4353,72,10,12,22,45.5%,10m
2010,3,[BRSKR]Washikie,4353,172,9,11,20,45.0%,17m
2010,1,[Arrows]Salty,4353,0,0,1,1,0.0%,4m
2015,3,Nogard,4351,1734,136,126,262,51.9%,18m
2015,3,LDH,4351,1803,101,99,200,50.5%,26m
2015,3,[ФАНСАФ]PaiN,4351,640,37,43,80,46.2%,10m
2018,3,[K0mpis]WeRiano,4350,707,39,33,72,54.2%,25m
2018,3,Sizzle,4350,124,13,19,32,40.6%,7m
2018,3,[MD86]AlexeiMD,4350,10,3,3,6,50.0%,4m
2018,1,[RstE]Solkanar,4350,48,2,1,3,66.7%,18m
2018,1,MyOPTION,4350,0,1,0,1,100.0%,11m
2023,2,Alice,4349,1046,44,54,98,44.9%,9m
2023,3,[TSVB]ava,4349,30,6,8,14,42.9%,10m
2023,1,IIIIIIIIIIII,4349,0,0,1,1,0.0%,7m
2026,3,Canardosse,4348,870,71,72,143,49.7%,11m
2026,3,[DyWmP]MSIMakouni,4348,655,36,30,66,54.5%,25m
2026,1,[ZERGTV]ZrK,4348,48,1,2,3,33.3%,18m
2026,1,Alpha,4348,0,0,1,1,0.0%,5m
2030,3,YTYT,4347,433,50,38,88,56.8%,10m
2030,1,Zyrrezix,4347,0,1,0,1,100.0%,24m
2030,2,DeepsYug,4347,0,1,0,1,100.0%,10m
2030,1,Sintiya,4347,0,0,1,1,0.0%,18m
2034,3,[НТТ]Fargus,4346,1508,240,234,474,50.6%,10m
2035,3,[LLFF]Hydroxi,4345,1185,69,54,123,56.1%,6m
2035,3,æøå,4345,672,39,49,88,44.3%,7m
2035,3,Martyr,4345,26,5,10,15,33.3%,10m
2035,3,ORAF,4345,6,1,5,6,16.7%,10m
2039,3,nuclearpunch,4344,90,94,89,183,51.4%,18m
2039,3,BoNeS,4344,891,50,20,70,71.4%,25m
2039,1,IIIIIIIIIIII,4344,599,22,4,26,84.6%,15m
2039,3,AcieSs,4344,4,1,4,5,20.0%,7m
2043,3,Maix,4343,336,28,36,64,43.8%,10m
2043,3,[Oath]DasDuelon,4343,78,8,16,24,33.3%,8m
2043,3,Infinity,4343,44,6,15,21,28.6%,6m
2043,1,Mengnan,4343,96,3,0,3,100.0%,6m
2043,3,[VHSEK]MackTheKnife,4343,121,2,3,5,40.0%,3m
2048,2,[Mkers]Raven,4342,2304,369,372,741,49.8%,24m
2048,3,AsTeR,4342,26,6,6,12,50.0%,5m
2050,3,KeyserSoze,4341,378,27,34,61,44.3%,17m
2050,3,ElPresidente,4341,237,20,29,49,40.8%,10m
2050,1,JPCarCanGGSC,4341,96,3,0,3,100.0%,8m
2050,3,[MSUSC2]Judgin,4341,0,1,4,5,20.0%,10m
2050,1,Damian,4341,0,0,1,1,0.0%,5m
2055,3,[HZeS]ThroughTime,4340,2167,355,378,733,48.4%,10m
2055,1,[RAHRAH]Riegel,4340,2262,235,213,448,52.5%,4m
2055,3,[tMnrd]Nickorlator,4340,40,5,10,15,33.3%,5m
2055,1,Rixt,4340,0,0,1,1,0.0%,25m
2055,1,llllllllllll,4340,0,0,1,1,0.0%,23m
2060,3,LHC,4339,691,61,60,121,50.4%,25m
2060,3,[MDeS]TheFeral,4339,8,4,5,9,44.4%,8m
2060,3,[QTcIub]FrostyFeet,4339,0,3,3,6,50.0%,16m
2060,1,[Łunar]AIAIA,4339,0,0,2,2,0.0%,5m
2064,3,mroz,4338,1709,358,353,711,50.4%,15m
2064,1,RikiMaru,4338,0,1,0,1,100.0%,14m
2064,1,Night,4338,0,0,1,1,0.0%,15m
2067,3,[MkersA]slide,4337,635,41,38,79,51.9%,25m
2067,3,[KDV]MCU,4337,488,24,25,49,49.0%,7m
2067,1,Conflict,4337,94,3,2,5,60.0%,14m
2067,1,luxovac,4337,0,0,2,2,0.0%,25m
2071,3,[RBlood]bigmonster,4336,451,19,15,34,55.9%,6m
2072,3,AngryNoob,4335,1031,59,43,102,57.8%,18m
2072,3,IIIIIIIIII,4335,220,33,25,58,56.9%,12m
2072,2,llllllllllll,4335,136,4,3,7,57.1%,5m
2075,3,[FrostG]factoryman,4334,795,104,109,213,48.8%,16m
2075,3,peroron,4334,268,58,48,106,54.7%,8m
2075,3,[PÂRłAH]Robar,4334,826,42,28,70,60.0%,10m
2075,3,[0o0o0]Ragnarr,4334,0,0,3,3,0.0%,3m
2079,3,GalaxY,4333,1969,152,163,315,48.3%,10m
2079,1,TheOddChap,4333,868,20,14,34,58.8%,23m
2079,3,[EseEse]EseEseEse,4333,232,20,28,48,41.7%,12m
2079,1,Zanna,4333,132,5,2,7,71.4%,17m
2079,3,IIIIIIIIII,4333,0,1,2,3,33.3%,10m
2079,1,BXTR,4333,0,0,1,1,0.0%,5m
2085,3,[WNET]reepz,4332,1326,128,132,260,49.2%,15m
2085,3,artanis,4332,394,21,6,27,77.8%,10m
2087,1,ОТМОРОЗОК,4331,2166,96,78,174,55.2%,5m
2087,1,Legion,4331,1740,65,44,109,59.6%,18m
2087,3,[ValidG]Bykagan,4331,296,43,44,87,49.4%,18m
2087,1,BreadCrumbs,4331,144,4,2,6,66.7%,8m
2091,1,CovidFr,4330,2273,83,59,142,58.5%,15m
2092,3,blackfox,4329,463,35,32,67,52.2%,18m
2092,3,Толкач,4329,104,27,36,63,42.9%,7m
2092,1,Almviken,4329,0,0,1,1,0.0%,6m
2095,3,Braza,4327,2102,201,210,411,48.9%,25m
2095,2,Koibomlin,4327,2169,156,163,319,48.9%,9m
2095,3,lIlIlIlIllll,4327,670,33,15,48,68.8%,7m
2095,2,HeLt,4327,410,19,35,54,35.2%,15m
2095,3,[АMOVE]ELENTOS,4327,128,11,21,32,34.4%,5m
2095,1,SleepA,4327,48,1,3,4,25.0%,9m
2095,3,Section,4327,0,0,4,4,0.0%,16m
2102,3,[eXøde]powerspike,4326,316,13,16,29,44.8%,11m
2102,1,IIIIIIIII,4326,0,0,1,1,0.0%,25m
2104,1,Babayaga,4325,2046,98,86,184,53.3%,17m
2104,1,[NoSurr]luukario,4325,0,0,1,1,0.0%,23m
2106,1,[B0xer]Stalk,4324,0,0,1,1,0.0%,10m
2107,3,STPUWU,4323,1542,360,240,600,60.0%,18m
2107,3,[ArGGEU]Utopi,4323,1261,63,44,107,58.9%,16m
2109,1,Koning,4322,0,0,2,2,0.0%,23m
2110,1,[PaniC]Алиса,4321,254,6,5,11,54.5%,18m
2111,3,YoungTerran,4320,810,47,54,101,46.5%,11m
2111,1,[69420]Juggernug,4320,144,3,5,8,37.5%,14m
2111,2,Rippeh,4320,0,1,2,3,33.3%,15m
2111,1,PedroSantos,4320,0,0,1,1,0.0%,11m
2115,1,[SKR]Cheebah,4319,0,0,2,2,0.0%,18m
2116,3,[ƮesXG]MästareN,4318,104,12,15,27,44.4%,16m
2116,1,DingAutomat,4318,144,3,3,6,50.0%,11m
2118,1,[pr0p]gillon,4316,0,1,0,1,100.0%,24m
2119,2,[PioC]Käsebrot,4315,1899,133,144,277,48.0%,14m
2119,3,ferefar,4315,1554,124,104,228,54.4%,25m
2119,2,[CYC]Gramz,4315,1448,89,101,190,46.8%,15m
2119,3,UnknowN,4315,83,18,24,42,42.9%,10m
2119,1,[bullD]ВеселОФФ,4315,668,15,11,26,57.7%,11m
2119,3,IIIIIIIIIIII,4315,155,6,5,11,54.5%,8m
2119,2,[SZ]IBIMarine,4315,92,3,1,4,75.0%,13m
2126,3,Sheamus,4314,410,149,136,285,52.3%,15m
2126,2,ДжохниПрогей,4314,1625,78,81,159,49.1%,7m
2126,1,[INAE]Panda,4314,1204,30,27,57,52.6%,3m
2126,1,[KhalD]YoGo,4314,380,16,34,50,32.0%,17m
2130,3,yepstoday,4313,1720,120,123,243,49.4%,5m
2130,3,[veR]Jonathan,4313,669,51,42,93,54.8%,17m
2130,3,[RecoN]Hozem,4313,291,42,41,83,50.6%,16m
2130,2,FeridunAbi,4313,726,31,51,82,37.8%,14m
2130,3,[ЯD]rcL,4313,311,23,21,44,52.3%,16m
2130,2,[PaniC]BraveRaven,4313,290,12,30,42,28.6%,24m
2136,2,Agodak,4312,1799,125,131,256,48.8%,7m
2136,3,CheekClapper,4312,198,19,23,42,45.2%,12m
2136,3,IIIIIIIIIIII,4312,16,5,8,13,38.5%,5m
2136,1,[PLA2N]DarkKenny,4312,48,2,2,4,50.0%,7m
2140,3,prime,4311,1202,149,159,308,48.4%,16m
2140,1,GøsuSiLenT,4311,2280,80,71,151,53.0%,11m
2140,1,Blaze,4311,1918,58,53,111,52.3%,5m
2140,1,Sunshine,4311,992,23,8,31,74.2%,25m
2140,3,Mazode,4311,62,8,15,23,34.8%,7m
2145,1,ДОБРО,4310,96,3,4,7,42.9%,7m
2146,1,aNDad,4308,288,6,8,14,42.9%,7m
2147,3,[TKGctm]NVC,4307,1600,452,440,892,50.7%,18m
2147,3,EMx,4307,2026,179,169,348,51.4%,15m
2147,1,Nightstalker,4307,0,1,0,1,100.0%,8m
2147,3,Oda,4307,0,1,4,5,20.0%,7m
2151,1,nangaybiss,4306,257,6,2,8,75.0%,7m
2152,1,Evael,4305,1110,103,100,203,50.7%,17m
2152,3,psychobenny,4305,93,24,29,53,45.3%,7m
2152,1,Gromster,4305,378,8,9,17,47.1%,10m
2152,1,Meridian,4305,192,4,5,9,44.4%,12m
2152,1,Amnesiä,4305,48,2,1,3,66.7%,11m
2152,3,nOpantsIRL,4305,6,2,10,12,16.7%,18m
2152,1,Dinster,4305,0,0,1,1,0.0%,7m
2159,1,[PMS1]Jungla,4304,2195,164,147,311,52.7%,18m
2159,3,DinDjarin,4304,1251,69,67,136,50.7%,3m
2161,3,[BabG]SengoS,4303,165,12,13,25,48.0%,25m
2162,1,[GoldM]sLaiz,4302,1020,35,29,64,54.7%,18m
2162,1,RandolF,4302,426,10,5,15,66.7%,25m
2162,1,ShadowLight,4302,243,6,4,10,60.0%,12m
2162,1,[Vоr]HautQuetsche,4302,192,6,6,12,50.0%,6m
2162,3,[ImrA]Imrahil,4302,22,3,8,11,27.3%,6m
2162,3,RAWD,4302,101,2,5,7,28.6%,10m
2162,1,Polderleo,4302,0,0,1,1,0.0%,17m
2169,1,[UCIV]Legacy,4300,0,1,3,4,25.0%,12m
2170,1,[3Dǃ]SmoKeShEEp,4299,1198,28,19,47,59.6%,11m
2170,1,[aW]Destro,4299,786,17,14,31,54.8%,7m
2170,3,IIIIIlllII,4299,6,2,6,8,25.0%,10m
2173,2,CloWnFiEsTa,4298,249,15,0,15,100.0%,26m
2173,1,Reverse,4298,238,5,6,11,45.5%,6m
2173,1,Dexter,4298,0,1,0,1,100.0%,23m
2176,3,simpai,4297,230,46,32,78,59.0%,7m
2176,3,Azocyclin,4297,510,34,44,78,43.6%,6m
2176,3,markloparen,4297,370,14,14,28,50.0%,10m
2176,1,rem,4297,242,6,4,10,60.0%,17m
2176,2,[InBri]KrokDerGar,4297,0,0,1,1,0.0%,13m
2181,3,[GsYc]Redhorrn,4296,2174,160,143,303,52.8%,15m
2181,1,wololo,4296,192,4,5,9,44.4%,25m
2181,1,[RBlood]DVNWeak,4296,0,0,1,1,0.0%,12m
2184,3,YvesMartinez,4295,514,39,39,78,50.0%,10m
2185,1,[GET]krastone,4294,1207,43,33,76,56.6%,11m
2185,3,NoNnSiiO,4294,28,4,11,15,26.7%,16m
2187,1,[MGBNom]Hobo,4293,2403,236,270,506,46.6%,18m
2187,3,[BBOY]Kvarc,4293,1140,200,191,391,51.2%,5m
2187,3,[gronk]CAVEMAN,4293,147,10,14,24,41.7%,15m
2187,2,Glück,4293,0,4,1,5,80.0%,10m
2187,1,Jpd,4293,0,0,1,1,0.0%,23m
2192,3,Crenshaw,4292,401,86,81,167,51.5%,25m
2192,1,[PŖïMĄŁ]LeTsGoBiLLy,4292,1792,53,28,81,65.4%,25m
2192,3,Nahoy,4292,10,2,7,9,22.2%,5m
2195,3,BigCack,4290,501,52,37,89,58.4%,10m
2196,3,[lOoOl]TEPPOPUCT,4289,218,23,25,48,47.9%,16m
2196,1,Multimorbid,4289,192,5,0,5,100.0%,23m
2198,3,Randiii,4288,2158,321,328,649,49.5%,10m
2198,3,Etupelas,4288,973,170,77,247,68.8%,25m
2198,3,[ASTT]Pyrom,4288,299,22,23,45,48.9%,12m
2198,1,Kautschuk,4288,96,3,1,4,75.0%,18m
2198,1,[GdAT]Unhealthy,4288,0,0,3,3,0.0%,25m
2203,3,weirdo,4287,2093,192,170,362,53.0%,11m
2203,1,MarineKing,4287,889,24,20,44,54.5%,11m
2203,1,HelloCanada,4287,418,16,2,18,88.9%,15m
2203,1,[U2]DaRo,4287,0,1,0,1,100.0%,11m
2207,3,MathewGg,4286,2097,259,254,513,50.5%,16m
2207,2,Nimrod,4286,2306,235,236,471,49.9%,22m
2207,1,adrenAlin,4286,2106,122,127,249,49.0%,25m
2207,3,[ncotic]Käsekuchen,4286,275,13,14,27,48.1%,8m
2211,1,Flake,4285,2234,136,124,260,52.3%,5m
2211,1,[1C5]Naiv,4285,892,22,10,32,68.8%,17m
2211,1,fjfalcon,4285,160,6,30,36,16.7%,11m
2214,1,[VFish]Heggy,4284,240,6,6,12,50.0%,14m
2214,1,BabySchlumpf,4284,0,1,0,1,100.0%,14m
2214,2,[duсks]взломЖепки,4284,0,0,4,4,0.0%,23m
2217,3,[ValidG]ArcbostsSimp,4283,1866,248,254,502,49.4%,26m
2217,2,Hoàng,4283,2361,232,243,475,48.8%,22m
2217,3,[FxL]SoulNight,4283,2077,195,204,399,48.9%,11m
2217,3,Nephilim,4283,495,28,31,59,47.5%,15m
2217,1,Keepman,4283,0,1,0,1,100.0%,23m
2222,2,Hittsu,4282,2268,244,220,464,52.6%,9m
2222,1,coolBreeze,4282,0,1,0,1,100.0%,3m
2224,3,Keen,4281,1626,180,175,355,50.7%,15m
2224,1,ImNakedfOu,4281,2100,142,133,275,51.6%,11m
2224,3,TORNADER,4281,213,21,23,44,47.7%,26m
2224,3,MatisS,4281,108,12,17,29,41.4%,10m
2224,1,Dashy,4281,336,7,5,12,58.3%,5m
2224,3,[Xa]Kabal,4281,167,7,12,19,36.8%,16m
2230,1,Helios,4280,217,9,2,11,81.8%,8m
2231,3,realmz,4279,1224,88,93,181,48.6%,8m
2231,1,[ЯD]eXit,4279,931,27,21,48,56.2%,23m
2231,1,[TVÐ]mumming,4279,144,3,8,11,27.3%,6m
2234,1,Imbalex,4278,240,6,4,10,60.0%,6m
2234,1,MikeFrost,4278,0,1,2,3,33.3%,25m
2236,3,nardex,4277,2119,451,448,899,50.2%,25m
2236,3,Roreno,4277,655,34,31,65,52.3%,8m
2236,3,RIPToss,4277,427,29,27,56,51.8%,5m
2236,3,[lLiTl]REz,4277,137,7,11,18,38.9%,7m
2236,1,RorK,4277,0,1,0,1,100.0%,9m
2236,1,Vex,4277,0,1,0,1,100.0%,2m
2236,1,[RMW]TheMvS,4277,0,0,4,4,0.0%,23m
2243,3,[Litty]StackedGamer,4276,1593,137,139,276,49.6%,8m
2243,1,LoveandHate,4276,1038,36,17,53,67.9%,25m
2243,3,oGsthestorm,4276,334,19,5,24,79.2%,25m
2243,1,[VFish]PresTiGe,4276,0,1,0,1,100.0%,24m
2243,1,NIO,4276,0,0,1,1,0.0%,23m
2248,1,delcrimen,4275,240,5,8,13,38.5%,17m
2248,1,[foad]foad,4275,96,2,7,9,22.2%,14m
2250,3,Chronos,4274,1646,182,188,370,49.2%,18m
2250,3,Goty,4274,173,5,7,12,41.7%,3m
2250,3,ReAP,4274,18,3,7,10,30.0%,15m
2250,1,[boomer]Bleed,4274,0,1,0,1,100.0%,18m
2254,3,ignore,4273,1805,171,166,337,50.7%,15m
2254,3,[lookin]BioBallBest,4273,56,7,14,21,33.3%,5m
2254,1,[Gozoub]TomEkiNoX,4273,96,3,0,3,100.0%,11m
2254,1,[IMGG]TheLukieOne,4273,0,0,2,2,0.0%,7m
2258,1,Colonist,4272,96,3,2,5,60.0%,9m
2258,1,[AOLs]LittleMaru,4272,0,1,1,2,50.0%,12m
2260,3,KingRush,4271,1206,83,80,163,50.9%,25m
2260,3,[DarkAG]SEWERAT,4271,1021,57,49,106,53.8%,18m
2260,1,NoName,4271,1088,24,21,45,53.3%,2m
2263,1,[BARJO]IntiFada,4270,1362,44,30,74,59.5%,25m
2263,1,mrGBG,4270,48,2,3,5,40.0%,11m
2263,1,PengestMunch,4270,48,1,1,2,50.0%,11m
2266,1,IIIIIIIIIIII,4269,1426,87,64,151,57.6%,12m
2266,1,[SLB]ScReaM,4269,0,3,2,5,60.0%,18m
2268,3,evilnw,4268,1098,56,63,119,47.1%,18m
2268,1,Stepbro,4268,1155,41,11,52,78.8%,18m
2268,1,Bucephalus,4268,270,7,7,14,50.0%,15m
2268,2,BbylngsMacro,4268,110,5,3,8,62.5%,9m
2268,1,[Kompis]Riksosten,4268,48,1,3,4,25.0%,10m
2273,1,Terran,4267,1045,26,20,46,56.5%,24m
2273,3,[GDA]Yoyomec,4267,168,19,24,43,44.2%,5m
2273,3,Bukagan,4267,146,16,24,40,40.0%,10m
2273,1,[isIMBA]TheShrimp,4267,48,2,1,3,66.7%,3m
2273,1,StupidRandom,4267,96,2,2,4,50.0%,11m
2273,1,Thirteen,4267,0,0,3,3,0.0%,6m
2279,1,Meister,4266,1195,120,109,229,52.4%,18m
2279,3,ADTank,4266,296,25,32,57,43.9%,16m
2279,1,TwentyTwenty,4266,240,6,4,10,60.0%,23m
2279,1,Montolovich,4266,96,3,4,7,42.9%,8m
2283,1,zlewozgryz,4265,1295,49,35,84,58.3%,23m
2283,1,BanhCanh,4265,1233,40,22,62,64.5%,18m
2283,1,Krosta,4265,0,0,2,2,0.0%,23m
2286,1,[aW]Grim,4262,1388,56,42,98,57.1%,9m
2286,1,XDXD,4262,238,5,4,9,55.6%,18m
2286,1,[ZERGTV]maksim,4262,0,0,3,3,0.0%,18m
2289,1,[BluexF]Axiom,4261,654,14,22,36,38.9%,14m
2289,1,lIlIlIlIlIlI,4261,0,3,2,5,60.0%,24m
2289,2,quaZa,4261,0,0,1,1,0.0%,5m
2292,1,GeneralSkarm,4260,192,4,5,9,44.4%,7m
2293,2,[NMSQ]Calm,4258,2305,168,176,344,48.8%,13m
2293,1,[OÐ]Flixse,4258,1613,53,26,79,67.1%,18m
2293,1,flying,4258,243,14,3,17,82.4%,5m
2293,1,Perkele,4258,153,6,4,10,60.0%,18m
2297,1,IIIIIIIIIIII,4257,272,16,2,18,88.9%,17m
2297,1,[Nððþs]IceRaider,4257,0,0,5,5,0.0%,24m
2299,3,Thiaz,4256,231,15,17,32,46.9%,8m
2299,1,Shimada,4256,422,9,3,12,75.0%,25m
2299,3,HyperXorigin,4256,0,0,4,4,0.0%,5m
2302,1,[ncotic]Firebird,4255,240,6,8,14,42.9%,14m
2302,1,[ToLǂ]Soey,4255,48,2,2,4,50.0%,24m
2302,1,Armleg,4255,0,0,4,4,0.0%,5m
2305,1,Bronko,4254,1862,110,108,218,50.5%,18m
2305,3,[JAREK]Gumkomen,4254,182,18,25,43,41.9%,10m
2305,1,Deathwing,4254,616,13,10,23,56.5%,14m
2305,2,[ArGGEU]AnySoSex,4254,0,0,2,2,0.0%,7m
2305,1,[CMPD]Storm,4254,0,0,4,4,0.0%,11m
2310,3,IIIIIII,4253,1825,600,623,1223,49.1%,18m
2310,1,[Dralag]FullMaster,4253,288,6,3,9,66.7%,11m
2310,1,WooX,4253,96,3,2,5,60.0%,25m
2310,1,IIIIIIIIIIII,4253,0,0,1,1,0.0%,11m
2314,1,NoReSelect,4252,1239,109,64,173,63.0%,5m
2314,3,StrOng,4252,485,44,33,77,57.1%,15m
2314,1,[GOLDPL]LIMONAD,4252,240,5,4,9,55.6%,12m
2314,1,Scipio,4252,144,3,9,12,25.0%,11m
2314,1,Scarlatti,4252,0,1,0,1,100.0%,23m
2319,3,[IBIMS]Yvolot,4251,2090,152,159,311,48.9%,6m
2319,1,Wardruna,4251,1982,106,98,204,52.0%,9m
2319,1,[SCPO]Theblaack,4251,96,3,3,6,50.0%,15m
2319,1,VelvetThunda,4251,0,0,5,5,0.0%,11m
2323,1,Flux,4250,2223,141,134,275,51.3%,14m
2323,3,[VuV]Opti,4250,840,127,126,253,50.2%,8m
2323,3,[q3d]GWS,4250,84,11,17,28,39.3%,25m
2323,1,wojak,4250,96,3,0,3,100.0%,8m
2323,1,[PLA2N]gSChelser,4250,0,0,5,5,0.0%,7m
2328,1,SweetDreams,4249,1090,43,38,81,53.1%,14m
2328,3,FuriousFred,4249,558,24,29,53,45.3%,6m
2328,1,[KETA]CµnicalƒScum,4249,48,2,3,5,40.0%,6m
2328,1,[Draigo]Pretorian,4249,0,0,1,1,0.0%,11m
2328,2,Alien,4249,0,0,2,2,0.0%,26m
2333,3,[PaniC]Happytoss,4248,934,60,50,110,54.5%,25m
2334,1,[GoldM]sLaiz,4247,1446,90,75,165,54.5%,23m
2334,3,[RecoN]Rams,4247,605,27,32,59,45.8%,18m
2334,1,[Kokyko]Zergumciser,4247,470,11,8,19,57.9%,18m
2337,3,PADDUS,4246,1585,120,119,239,50.2%,15m
2337,2,[Enemy9]adusti,4246,916,43,69,112,38.4%,22m
2337,1,Hopeless,4246,490,20,9,29,69.0%,18m
2337,1,razor,4246,656,14,10,24,58.3%,3m
2337,1,KanNoN,4246,284,7,0,7,100.0%,14m
2337,1,[FSeS]Emin,4246,48,2,2,4,50.0%,23m
2343,1,[BGuard]AnAlThIs,4245,284,6,4,10,60.0%,11m
2343,1,LaBiscotte,4245,240,5,20,25,20.0%,25m
2343,2,[НТТ]Zanter,4245,136,4,3,7,57.1%,24m
2343,1,llllllllllll,4245,144,3,9,12,25.0%,18m
2343,1,[FLTY]BGǂTheJC,4245,0,1,2,3,33.3%,7m
2348,3,slowhands,4244,1660,189,202,391,48.3%,15m
2348,1,kratzigel,4244,2209,157,154,311,50.5%,11m
2348,1,RANgER,4244,96,3,6,9,33.3%,7m
2348,1,dave,4244,0,0,1,1,0.0%,8m
2348,1,JackXLVII,4244,0,0,4,4,0.0%,6m
2353,3,[αX]PatgaData,4243,928,41,39,80,51.2%,16m
2353,1,[HZeS]SLAVok,4243,1337,39,43,82,47.6%,9m
2353,1,Clem,4243,430,10,8,18,55.6%,18m
2353,1,[BGuard]CardBoxMan,4243,144,4,4,8,50.0%,12m
2353,1,Andrius,4243,0,0,1,1,0.0%,6m
2358,1,ToggoStar,4242,1988,126,128,254,49.6%,23m
2358,3,Chopp,4242,318,68,78,146,46.6%,16m
2358,1,CyClown,4242,930,22,13,35,62.9%,15m
2358,1,DeFacto,4242,125,4,3,7,57.1%,11m
2358,1,Wenden,4242,96,3,3,6,50.0%,3m
2358,1,gazon,4242,0,1,3,4,25.0%,14m
2364,3,[ØC]Tehuur,4241,150,16,23,39,41.0%,15m
2365,3,[Xa]MugeN,4239,556,79,71,150,52.7%,16m
2365,1,MentalSnipe,4239,24,1,1,2,50.0%,11m
2365,1,[HBGS]ВялыйМарик,4239,0,0,2,2,0.0%,25m
2368,1,[meowz]SpaceOrc,4238,192,4,8,12,33.3%,11m
2368,1,[xNGSx]Rykuu,4238,48,2,2,4,50.0%,15m
2370,1,[AirPwn]BenJ,4237,2236,325,308,633,51.3%,23m
2370,1,Rocket,4237,1795,62,57,119,52.1%,7m
2372,1,Artyom,4236,2235,130,85,215,60.5%,7m
2372,1,[Chariz]gazza,4236,1350,34,28,62,54.8%,9m
2372,1,[SaneGG]MissClick,4236,898,29,29,58,50.0%,17m
2372,1,[αX]DojoGamer,4236,706,16,16,32,50.0%,11m
2372,3,zavix,4236,290,14,20,34,41.2%,3m
2372,1,[KDV]Biurek,4236,514,12,3,15,80.0%,17m
2372,1,NSƒFaxo,4236,48,2,1,3,66.7%,14m
2372,1,[FOG]NaRTiS,4236,0,0,1,1,0.0%,11m
2372,1,[HBGSJR]ace,4236,0,0,3,3,0.0%,11m
2381,1,[MIEM]Syncker,4235,540,22,27,49,44.9%,18m
2381,1,Csihar,4235,336,8,2,10,80.0%,17m
2381,1,[NetGG]лЯхулюгАн,4235,48,2,0,2,100.0%,11m
2381,1,Jotaro,4235,0,1,6,7,14.3%,5m
2385,3,Ptato,4234,614,45,63,108,41.7%,10m
2385,1,Behaemmerter,4234,86,3,0,3,100.0%,23m
2385,1,[TABY]SYRE,4234,0,1,1,2,50.0%,8m
2388,3,[CYC]FATALITY,4233,1601,295,288,583,50.6%,26m
2388,1,[CPSLCK]Eule,4233,698,16,18,34,47.1%,25m
2388,2,[ВИЗГЕР]славик,4233,46,2,0,2,100.0%,10m
2391,1,[RTeuB]Tarask,4232,1144,35,23,58,60.3%,23m
2391,1,Fortnite,4232,0,0,1,1,0.0%,11m
2393,1,IIIIIIIIIIII,4231,628,21,12,33,63.6%,18m
2393,1,[OMARS]FlatWaifu,4231,281,6,9,15,40.0%,17m
2393,1,[DaGOAT]Sinus,4231,0,1,0,1,100.0%,7m
2396,3,FreddYCooL,4230,1093,299,285,584,51.2%,10m
2396,3,[TheDOH]Furious,4230,2130,148,143,291,50.9%,16m
2398,1,rrrrrt,4229,1389,98,95,193,50.8%,3m
2398,1,[VSHL]Arikado,4229,954,22,9,31,71.0%,23m
2398,1,[Wolven]GuardianWisp,4229,950,21,19,40,52.5%,25m
2398,1,[BeSC]Mayne,4229,286,6,4,10,60.0%,5m
2398,2,[Gassy]zUP,4229,88,2,0,2,100.0%,16m
2403,1,[ZelO]HITMAN,4228,1355,44,19,63,69.8%,14m
2403,1,RetorieS,4228,288,6,5,11,54.5%,1m
2403,1,[Wø]Equinox,4228,0,1,0,1,100.0%,23m
2403,1,Kenpachi,4228,0,0,2,2,0.0%,16m
2403,1,BlooDDevil,4228,0,0,3,3,0.0%,8m
2408,1,[NetGG]Gwun,4227,1711,55,53,108,50.9%,24m
2408,1,[NRV]ZENsafe,4227,346,16,2,18,88.9%,2m
2408,1,[TROPBG]ZBelin,4227,428,9,12,21,42.9%,11m
2411,1,Platharum,4226,2203,346,322,668,51.8%,14m
2411,3,[αX]Tirailleur,4226,267,36,41,77,46.8%,10m
2411,1,Scramble,4226,650,14,5,19,73.7%,25m
2411,1,Merigold,4226,240,5,6,11,45.5%,14m
2415,3,[Blacer]BlueKnight,4225,2091,619,609,1228,50.4%,15m
2415,3,[TheDOH]Aztrack,4225,1188,63,62,125,50.4%,7m
2415,3,IlIlIlIlIlIl,4225,110,18,27,45,40.0%,10m
2415,1,[CYC]Capitalism,4225,0,1,2,3,33.3%,25m
2415,1,KiwiThief,4225,0,1,3,4,25.0%,10m
2415,1,llllllllllll,4225,0,0,1,1,0.0%,11m
2421,1,zvei,4224,2135,201,193,394,51.0%,6m
2421,3,[BRUSHT]Aquafresh,4224,1613,95,104,199,47.7%,12m
2421,1,Timekiller,4224,96,3,5,8,37.5%,2m
2424,1,Sapphire,4223,48,1,4,5,20.0%,23m
2425,1,Vorck,4222,1791,120,118,238,50.4%,2m
2425,1,hihihihihihi,4222,786,18,18,36,50.0%,23m
2425,1,MARINESEU,4222,688,16,9,25,64.0%,7m
2425,1,Факульминат,4222,190,5,4,9,55.6%,11m
2425,1,[Kompis]Hoofen,4222,96,3,4,7,42.9%,14m
2425,1,Betalands,4222,48,2,0,2,100.0%,25m
2425,1,BreachX,4222,92,2,4,6,33.3%,6m
2425,1,Ryppa,4222,0,0,1,1,0.0%,24m
2433,1,ZombieMarine,4221,0,1,2,3,33.3%,2m
2434,3,Silence,4220,716,38,20,58,65.5%,12m
2434,1,IIIIIIIIIIII,4220,927,33,15,48,68.8%,9m
2434,3,Softisch,4220,154,10,25,35,28.6%,1m
2434,1,Calvin,4220,238,5,5,10,50.0%,10m
2434,1,IIIIIIIIIIII,4220,96,2,7,9,22.2%,25m
2439,3,[ZBL]SplitSeven,4219,586,39,54,93,41.9%,7m
2439,1,Arcanewinds,4219,370,10,13,23,43.5%,11m
2439,1,[AiRǂ]AirstrikeITA,4219,232,5,12,17,29.4%,9m
2442,1,gehemon,4218,1773,98,100,198,49.5%,17m
2443,3,liquid,4217,929,64,72,136,47.1%,11m
2443,1,[SmBr]VeTerrAn,4217,1110,30,18,48,62.5%,1m
2443,1,zioN,4217,96,2,5,7,28.6%,7m
2443,1,[ЯD]ScIIWoL,4217,0,1,0,1,100.0%,23m
2447,1,Embargo,4216,240,6,4,10,60.0%,6m
2447,1,Aasgeier,4216,0,1,0,1,100.0%,8m
2449,1,SayonaraSckr,4215,0,0,1,1,0.0%,8m
2449,1,rockstar,4215,0,0,1,1,0.0%,25m
2451,1,chichu,4214,1957,79,55,134,59.0%,1m
2451,1,[αX]Serpagel,4214,1694,76,62,138,55.1%,12m
2451,1,youhavelost,4214,618,13,19,32,40.6%,6m
2451,1,Drake,4214,228,5,8,13,38.5%,2m
2455,3,Svagu,4213,119,6,10,16,37.5%,8m
2455,1,MateNn,4213,0,0,1,1,0.0%,25m
2457,1,TDawg,4212,144,4,2,6,66.7%,14m
2458,1,[PŖïMĄŁ]Indemix,4211,2218,130,131,261,49.8%,6m
2458,3,Kami,4211,107,3,11,14,21.4%,25m
2458,1,GiuGGiola,4211,48,1,1,2,50.0%,1m
2461,3,Stalker,4210,1689,107,86,193,55.4%,25m
2461,1,Stigg,4210,48,2,0,2,100.0%,14m
2463,3,[Mobius]guilhem,4209,1598,160,133,293,54.6%,11m
2463,1,Brad,4209,1449,60,44,104,57.7%,12m
2463,1,[s0h22]PoWerDrivE,4209,834,19,20,39,48.7%,1m
2463,1,Hagakure,4209,433,12,17,29,41.4%,10m
2463,1,[YSB]Marone,4209,286,6,15,21,28.6%,17m
2468,1,EconDude,4208,2215,251,251,502,50.0%,18m
2468,1,LymphocyteNK,4208,948,22,21,43,51.2%,18m
2468,1,Ghostr,4208,462,10,10,20,50.0%,14m
2471,1,[PHØMUI]Eran,4207,2209,78,71,149,52.3%,11m
2471,1,Edelscott,4207,1969,67,69,136,49.3%,8m
2471,3,[SEWP]Serenchanter,4207,482,33,44,77,42.9%,10m
2471,1,Sam,4207,628,15,7,22,68.2%,5m
2471,1,MADAFAKER,4207,94,5,2,7,71.4%,10m
2471,1,Fadezzzx,4207,0,0,1,1,0.0%,11m
2471,1,[Roger]SoliD,4207,0,0,2,2,0.0%,24m
2478,3,[Xa]CenturioN,4206,1571,132,150,282,46.8%,16m
2478,3,Bylkase,4206,1535,84,74,158,53.2%,11m
2478,1,[HsDL]MiaNonna,4206,472,10,7,17,58.8%,5m
2481,1,Magnanik,4205,738,16,12,28,57.1%,11m
2481,1,[GZerO]StarDrive,4205,240,6,4,10,60.0%,7m
2481,1,[TEEMOS]galgtonold,4205,48,1,7,8,12.5%,8m
2484,1,Tsirkon,4204,2230,282,127,409,68.9%,23m
2484,3,[TheDOH]BlackPsycho,4204,1429,122,132,254,48.0%,16m
2484,3,[SuperF]Ljuflingur,4204,1245,75,80,155,48.4%,5m
2484,1,Maddy,4204,710,20,24,44,45.5%,17m
2484,1,ONBlivionS,4204,288,7,2,9,77.8%,17m
2484,1,Laser,4204,0,0,1,1,0.0%,1m
2484,1,GuyInTheChat,4204,0,0,3,3,0.0%,7m
2491,1,[Arrows]Dorse,4203,1350,32,34,66,48.5%,25m
2491,1,[Hаsu]Andreyggwp,4203,286,7,2,9,77.8%,15m
2493,1,[AiRǂ]PiccoloConte,4202,2136,68,60,128,53.1%,11m
2493,1,[WBO]iLu,4202,1157,29,25,54,53.7%,11m
2493,1,RobsonEC,4202,832,18,15,33,54.5%,12m
2493,3,Blagojce,4202,0,2,1,3,66.7%,3m
2493,1,Tarnor,4202,96,2,2,4,50.0%,25m
2493,1,[NMSQ]Kazaro,4202,96,2,3,5,40.0%,7m
2493,1,Caesar,4202,73,2,5,7,28.6%,25m
2500,1,TheCandyman,4201,1568,123,112,235,52.3%,11m
2500,1,Babayaga,4201,2113,107,98,205,52.2%,6m
2500,3,[KDV]ALEK,4201,37,72,73,145,49.7%,1m
2500,1,TankianRage,4201,879,35,19,54,64.8%,12m
2500,1,[B0xers]KingMacron,4201,94,2,7,9,22.2%,5m
2500,1,Krzemyk,4201,48,1,6,7,14.3%,15m
2506,3,Sentinel,4200,2078,601,612,1213,49.5%,2m
2506,1,[IndyK]Flexy,4200,2094,117,89,206,56.8%,5m
2506,1,[MPRZ]EarlGrey,4200,1223,49,41,90,54.4%,7m
2506,1,Yewualb,4200,1546,48,29,77,62.3%,8m
2506,1,[ЯD]Unknown,4200,702,22,25,47,46.8%,12m
2511,1,EgoRich,4199,1387,34,43,77,44.2%,11m
2511,1,[Blacer]Tinwe,4199,288,7,3,10,70.0%,25m
2511,1,PieT,4199,48,1,3,4,25.0%,14m
2514,3,[R33]DemoN,4198,978,169,97,266,63.5%,10m
2514,1,HyperNEAT,4198,1325,35,30,65,53.8%,23m
2514,1,JUU,4198,994,23,26,49,46.9%,14m
2514,1,[ƮesXG]EffecT,4198,48,2,0,2,100.0%,14m
2518,1,reactive,4197,1168,28,23,51,54.9%,1m
2518,1,AlfaBlommaN,4197,679,27,25,52,51.9%,10m
2518,1,rAyLayA,4197,446,13,10,23,56.5%,24m
2518,1,[Klitor]EAklitor,4197,0,1,0,1,100.0%,12m
2518,1,Coin,4197,0,1,0,1,100.0%,10m
2523,1,Cougay,4196,190,9,0,9,100.0%,5m
2523,1,yukoSefZ,4196,96,2,0,2,100.0%,10m
2525,1,увуку,4194,504,12,3,15,80.0%,15m
2525,1,MichaelKael,4194,48,2,3,5,40.0%,14m
2527,1,Kristo,4193,2202,227,228,455,49.9%,23m
2527,1,[pooooo]GrosSacASac,4193,974,23,19,42,54.8%,23m
2527,2,Zergcraft,4193,48,2,1,3,66.7%,8m
2530,1,IIIIIIIIIIII,4192,2025,136,102,238,57.1%,10m
2530,1,[TV]fOfOf,4192,1112,61,56,117,52.1%,3m
2530,1,[Hаsu]XVII,4192,1622,44,41,85,51.8%,23m
2530,3,Undlrak,4192,453,26,12,38,68.4%,8m
2530,1,GregThufram,4192,0,0,2,2,0.0%,3m
2530,2,IIIIIIIIIIII,4192,0,0,11,11,0.0%,14m
2536,1,[Kompis]Wille,4191,514,11,16,27,40.7%,10m
2536,1,lKazura,4191,402,10,8,18,55.6%,6m
2536,1,FlacidFAP,4191,352,7,5,12,58.3%,15m
2539,1,Via,4190,2171,277,273,550,50.4%,7m
2540,1,IIIIIIIIIIII,4189,1033,34,17,51,66.7%,3m
2540,1,[PRLS]Lorktar,4189,566,12,20,32,37.5%,25m
2540,1,Spartan,4189,0,0,5,5,0.0%,25m
2543,1,[ßabek]ninox,4188,1663,109,88,197,55.3%,3m
2543,3,SILF,4188,123,22,31,53,41.5%,11m
2543,1,EMPIRE,4188,906,20,22,42,47.6%,17m
2543,1,[eSubaI]Wanty,4188,640,15,14,29,51.7%,23m
2547,1,Foxer,4187,2184,226,207,433,52.2%,12m
2547,1,[PiGPan]ScaryMouse,4187,2191,179,179,358,50.0%,14m
2547,3,[aW]MoOkaShade,4187,458,32,39,71,45.1%,25m
2547,3,Amator,4187,50,7,18,25,28.0%,12m
2551,3,Shark,4186,309,16,15,31,51.6%,9m
2551,2,zergistooop,4186,266,14,1,15,93.3%,14m
2551,2,Magic,4186,218,13,0,13,100.0%,16m
2551,1,[BRSKR]GhostCrypt,4186,468,10,9,19,52.6%,7m
2555,1,IlIlIlIlIlIl,4184,982,29,17,46,63.0%,8m
2555,1,LilaC,4184,378,9,14,23,39.1%,5m
2555,3,Mjölner,4184,6,2,11,13,15.4%,5m
2558,1,[CYC]Tim,4183,2185,296,299,595,49.7%,12m
2558,1,[TEKEMA]Yisianmind,4183,467,20,6,26,76.9%,25m
2560,1,kSokSo,4182,2189,334,325,659,50.7%,1m
2560,3,[ICGl]Aven,4182,991,208,211,419,49.6%,9m
2560,1,ScarlettFan,4182,286,7,3,10,70.0%,5m
2560,1,Exar,4182,334,7,13,20,35.0%,23m
2560,1,dlwlrma,4182,48,1,3,4,25.0%,8m
2565,3,Uplifter,4181,2082,482,512,994,48.5%,10m
2565,1,NaMraC,4181,236,5,4,9,55.6%,10m
2565,1,[PLA2N]Zerash,4181,48,1,3,4,25.0%,9m
2568,1,GartenZerg,4180,1870,55,36,91,60.4%,23m
2568,1,MickQudZ,4180,986,24,15,39,61.5%,10m
2568,1,wizard,4180,144,3,5,8,37.5%,8m
2571,1,ignite,4179,710,29,20,49,59.2%,3m
2571,1,Prostitute,4179,0,0,1,1,0.0%,11m
2573,1,[LOIX]Dziekan,4178,1965,86,77,163,52.8%,17m
2573,1,[GoldM]Crilath,4178,647,17,19,36,47.2%,12m
2573,2,lIlIlIlIlIlI,4178,171,11,0,11,100.0%,6m
2573,1,Artanis,4178,372,8,8,16,50.0%,25m
2573,1,Irkutskiy,4178,94,3,1,4,75.0%,14m
2573,1,IIIIIIIIIIII,4178,48,2,0,2,100.0%,25m
2579,1,KawaPouki,4177,830,26,23,49,53.1%,2m
2579,1,ZEST,4177,236,5,1,6,83.3%,10m
2579,1,Exyder,4177,144,4,6,10,40.0%,5m
2582,3,chips,4176,841,102,96,198,51.5%,9m
2582,1,[59APM]Djaube,4176,585,13,18,31,41.9%,2m
2582,3,DeadlyFeet,4176,8,2,10,12,16.7%,15m
2585,3,Ilosealot,4175,1065,65,54,119,54.6%,17m
2585,1,Ralph,4175,879,25,15,40,62.5%,14m
2585,3,Siegfried,4175,393,21,25,46,45.7%,9m
2585,1,LaserDagger,4175,420,9,12,21,42.9%,10m
2585,1,Juppe,4175,190,5,1,6,83.3%,2m
2585,1,[50x]Breaker,4175,0,0,3,3,0.0%,1m
2591,1,JuliaMarine,4174,425,14,16,30,46.7%,17m
2592,3,[DOwls]Aurigami,4173,1664,251,269,520,48.3%,16m
2592,3,Ryse,4173,1616,104,101,205,50.7%,5m
2592,3,Mirrari,4173,752,51,56,107,47.7%,10m
2592,1,glhf,4173,1112,29,20,49,59.2%,25m
2592,1,Wanderfalke,4173,48,1,4,5,20.0%,25m
2592,1,[lLiTl]Hatsge,4173,0,0,3,3,0.0%,11m
2598,3,Spica,4172,1710,198,216,414,47.8%,25m
2598,1,[eXǂ]NeoW,4172,1369,40,39,79,50.6%,6m
2598,1,DJLarude,4172,1185,36,33,69,52.2%,12m
2598,1,MarineKing,4172,238,6,3,9,66.7%,10m
2598,1,[šƒ]DeSTRuCtioN,4172,48,1,1,2,50.0%,2m
2598,1,Typhus,4172,0,0,3,3,0.0%,18m
2598,1,IIIIIIIIIIII,4172,0,0,8,8,0.0%,12m
2605,1,[ЯD]NEEK,4171,2101,167,173,340,49.1%,25m
2605,1,[PaniC]Kronaz,4171,326,8,2,10,80.0%,14m
2607,3,[IceHus]teryagov,4170,1307,71,68,139,51.1%,17m
2607,1,[БУБУБ]Hellbatking,4170,1842,71,87,158,44.9%,2m
2607,1,LimeMoscow,4170,1092,28,25,53,52.8%,15m
2607,1,Norbert,4170,725,17,7,24,70.8%,1m
2607,1,Meson,4170,0,0,2,2,0.0%,17m
2612,1,[isIMBA]Soeil,4169,1577,123,122,245,50.2%,17m
2612,1,DVM,4169,692,15,17,32,46.9%,25m
2612,1,[IBeAŚI]Bene,4169,205,7,7,14,50.0%,1m
2612,1,Max,4169,0,1,0,1,100.0%,11m
2612,1,[ORRO]jul,4169,0,0,1,1,0.0%,17m
2617,1,MeDiTeRRaN,4168,2142,198,172,370,53.5%,14m
2617,3,[Kompis]Tohatzu,4168,1571,96,104,200,48.0%,9m
2617,1,Vamskie,4168,2069,72,66,138,52.2%,23m
2620,1,Spanmeister,4167,1984,193,190,383,50.4%,14m
2620,1,foxeylady,4167,1047,26,24,50,52.0%,9m
2620,1,[nB]MekTypro,4167,559,13,12,25,52.0%,23m
2623,3,[Kicx]Naiko,4166,1173,132,118,250,52.8%,10m
2623,1,[ArGGEJ]Fjant,4166,466,11,5,16,68.8%,13m
2623,1,[Wolven]Thor,4166,48,1,1,2,50.0%,8m
2626,1,donrazee,4165,332,8,4,12,66.7%,2m
2627,1,[75рус]Мастер,4164,919,161,154,315,51.1%,12m
2627,3,[veni]Veni,4164,239,47,54,101,46.5%,25m
2627,1,[JS]draaykinG,4164,1007,37,26,63,58.7%,25m
2627,1,WarHound,4164,332,7,9,16,43.8%,11m
2627,1,SCREGNEUGNEU,4164,0,0,3,3,0.0%,23m
2627,1,[213123]Ulysses,4164,0,0,5,5,0.0%,3m
2633,1,NookY,4163,2095,62,64,126,49.2%,1m
2633,1,AngryPenguin,4163,1429,47,30,77,61.0%,6m
2633,1,xampi,4163,726,36,25,61,59.0%,3m
2633,1,[NXTCRP]nextlvlq,4163,719,30,14,44,68.2%,11m
2633,1,llIIllIIllII,4163,190,11,0,11,100.0%,9m
2638,1,[aW]Chweps,4162,2163,353,346,699,50.5%,9m
2638,2,[FalPal]Marbuel,4162,311,12,6,18,66.7%,25m
2638,1,SpiritSun,4162,96,3,6,9,33.3%,1m
2638,1,Jungleman,4162,0,1,0,1,100.0%,6m
2638,1,[PLA2N]Viking,4162,0,0,2,2,0.0%,12m
2643,1,Rufus,4161,1865,570,565,1135,50.2%,11m
2643,1,fark,4161,888,30,22,52,57.7%,17m
2643,1,[BRSKR]Quickman,4161,0,1,5,6,16.7%,1m
2643,1,Русландобро,4161,0,0,2,2,0.0%,17m
2643,1,Perjantaina,4161,0,0,3,3,0.0%,7m
2643,1,[FCL]Nukez,4161,0,0,8,8,0.0%,7m
2649,1,[ICGl]BeatFlitz,4160,2008,60,46,106,56.6%,23m
2649,3,CoLdAViS,4160,322,31,42,73,42.5%,9m
2649,1,Qyun,4160,239,12,7,19,63.2%,15m
2649,1,fAkeSpeedq,4160,192,4,6,10,40.0%,24m
2653,3,[NGVs]Online,4159,2043,573,593,1166,49.1%,10m
2653,1,XtrA,4159,1052,25,19,44,56.8%,7m
2653,1,PriNce,4159,0,0,2,2,0.0%,5m
2656,3,[aW]MrTrixouille,4158,2052,307,306,613,50.1%,6m
2656,1,[Kicx]IcanFLY,4158,782,28,38,66,42.4%,12m
2656,1,Kastle,4158,0,1,0,1,100.0%,11m
2659,3,[Q3A]Venser,4157,1778,348,366,714,48.7%,2m
2659,2,TacoTruck,4157,270,11,5,16,68.8%,6m
2661,1,Leso,4156,1624,160,161,321,49.8%,17m
2661,1,Provieh,4156,1490,139,139,278,50.0%,14m
2661,1,GLHF,4156,552,12,9,21,57.1%,8m
2661,1,[ICGl]Doniel,4156,476,11,12,23,47.8%,6m
2661,3,[Kicx]simtom,4156,30,3,3,6,50.0%,3m
2666,1,[ĦĦ]Elonmusk,4155,1510,89,63,152,58.6%,1m
2666,1,knurrp,4155,1810,65,63,128,50.8%,1m
2666,1,höllenforsch,4155,422,10,7,17,58.8%,24m
2666,1,Dutes,4155,96,4,7,11,36.4%,23m
2670,3,Kuben,4154,1282,90,100,190,47.4%,17m
2670,1,Mime,4154,2147,66,67,133,49.6%,5m
2670,1,Leecher,4154,791,55,41,96,57.3%,12m
2670,1,Insecureish,4154,349,20,4,24,83.3%,5m
2670,1,[xp]Aiolos,4154,238,5,8,13,38.5%,2m
2670,1,[PiGPan]Kilkenny,4154,190,4,6,10,40.0%,8m
2676,1,[FrostG]BetaStar,4153,1637,189,201,390,48.5%,11m
2676,3,esvi,4153,2087,161,180,341,47.2%,6m
2676,1,Manna,4153,2075,68,68,136,50.0%,12m
2676,1,FireBird,4153,1600,41,42,83,49.4%,12m
2676,1,KerriCrip,4153,192,5,2,7,71.4%,1m
2681,3,Mintcrystall,4152,1775,118,121,239,49.4%,26m
2681,1,Ryukyu,4152,1040,24,36,60,40.0%,23m
2681,1,[WBO]Atais,4152,868,20,24,44,45.5%,10m
2681,1,LuckyFree,4152,236,6,1,7,85.7%,2m
2681,1,LastCell,4152,48,2,1,3,66.7%,12m
2681,2,DREAM,4152,0,1,0,1,100.0%,13m
2687,1,HiSpdLoDrag,4151,1776,184,172,356,51.7%,18m
2687,1,Cazzah,4151,2153,124,131,255,48.6%,6m
2687,3,IIIIIIIIIIII,4151,521,29,41,70,41.4%,3m
2687,2,[Dae]Daestra,4151,0,1,6,7,14.3%,6m
2691,1,[FrostG]Matt,4150,593,19,6,25,76.0%,1m
2691,1,[AofK]LuckyPhoenix,4150,672,16,10,26,61.5%,2m
2691,1,Kakashi,4150,0,0,2,2,0.0%,8m
2694,1,Lililililili,4149,0,5,0,5,100.0%,8m
2694,1,[eXøde]imData,4149,48,1,1,2,50.0%,24m
2696,1,[AppSha]NeoWave,4148,1751,238,225,463,51.4%,23m
2696,1,Farts,4148,2094,168,158,326,51.5%,6m
2696,1,rerun,4148,2053,65,50,115,56.5%,9m
2696,1,llllllllllll,4148,841,27,14,41,65.9%,23m
2696,1,Wunderf,4148,192,6,2,8,75.0%,17m
2696,1,[ÆR]WiNtER,4148,73,0,7,7,0.0%,2m
2702,3,[Sarmat]HaPe,4147,1031,52,58,110,47.3%,8m
2702,1,bijon,4147,144,3,6,9,33.3%,14m
2704,1,BlitZZ,4146,1740,90,82,172,52.3%,1m
2704,3,Blackhammer,4146,288,23,35,58,39.7%,12m
2704,1,GumBa,4146,48,1,3,4,25.0%,11m
2704,1,[WLovB]Pikachiu,4146,0,0,1,1,0.0%,3m
2708,3,[justS]Gheorghe,4145,202,23,34,57,40.4%,16m
2708,1,IIIIIIIIIIII,4145,650,14,17,31,45.2%,6m
2708,1,Rat,4145,140,4,1,5,80.0%,25m
2708,1,Barcode,4145,190,4,11,15,26.7%,24m
2708,1,[IF1l]Tamplier,4145,0,1,0,1,100.0%,14m
2713,1,kalarazar,4144,1831,87,85,172,50.6%,5m
2713,1,ТЗЧка,4144,1605,78,88,166,47.0%,13m
2713,1,[ToSSer]Alqualondë,4144,0,0,4,4,0.0%,11m
2713,1,[αX]IlluSion,4144,0,0,4,4,0.0%,7m
2717,1,Lin,4143,839,28,28,56,50.0%,14m
2717,1,MarShall,4143,768,18,15,33,54.5%,23m
2717,1,fsfsfsfssf,4143,282,6,8,14,42.9%,7m
2720,3,[PLSV]MegroN,4142,2015,420,434,854,49.2%,1m
2720,1,[IceHus]Hopexs,4142,0,2,3,5,40.0%,9m
2720,1,Apendix,4142,0,0,1,1,0.0%,6m
2723,1,[lLiTl]Failure,4141,935,25,15,40,62.5%,24m
2723,1,[ШОУМЕН]StereoClub,4141,584,14,9,23,60.9%,23m
2723,2,[VFish]XCet,4141,88,2,1,3,66.7%,13m
2723,1,Shiroiken,4141,0,0,1,1,0.0%,16m
2727,3,Ballod,4140,1901,135,145,280,48.2%,26m
2727,1,Player,4140,1190,68,50,118,57.6%,12m
2727,1,[JAFFE]tonnis,4140,328,8,7,15,53.3%,24m
2727,1,PenspinningG,4140,236,6,7,13,46.2%,5m
2727,1,[FrOGTV]MJperchey,4140,48,1,2,3,33.3%,3m
2727,1,[KRTerr]CarryRiven,4140,0,0,1,1,0.0%,16m
2733,1,Planck,4139,1706,241,200,441,54.6%,24m
2733,1,Hatador,4139,201,5,4,9,55.6%,11m
2733,1,Dan,4139,48,1,4,5,20.0%,25m
2733,1,illusiveman,4139,0,0,1,1,0.0%,5m
2737,1,[Gloves]WSW,4138,1717,103,107,210,49.0%,10m
2737,1,Miikachu,4138,1586,42,51,93,45.2%,23m
2737,1,[SEWP]Герой,4138,1001,29,26,55,52.7%,1m
2737,3,CaedNua,4138,441,28,39,67,41.8%,25m
2737,1,[ǂHD]Aura,4138,330,7,5,12,58.3%,14m
2737,1,[ƮesXG]Kronos,4138,48,1,2,3,33.3%,17m
2737,1,[RеG]papastreck,4138,48,1,2,3,33.3%,11m
2737,1,Chris,4138,0,0,1,1,0.0%,1m
2745,1,[Eryth]SilencedBomb,4137,2152,127,111,238,53.4%,25m
2745,1,Freemind,4137,1789,92,98,190,48.4%,24m
2745,1,BuzzDee,4137,1750,84,72,156,53.8%,10m
2745,1,[Hаsu]SaraNYA,4137,0,1,0,1,100.0%,6m
2749,1,[KeWa]Makarios,4136,1504,60,39,99,60.6%,1m
2749,2,[EESC]JoaN,4136,104,12,22,34,35.3%,14m
2749,1,Bernard,4136,142,4,1,5,80.0%,23m
2752,1,[OrPix]tOtOr,4135,144,3,8,11,27.3%,10m
2752,2,MouthFeel,4135,0,1,0,1,100.0%,24m
2752,1,Shinycarrier,4135,48,1,4,5,20.0%,1m
2752,1,Reys,4135,0,0,1,1,0.0%,8m
2756,1,DeMercurial,4134,1094,114,115,229,49.8%,14m
2756,3,SgtGump,4134,960,88,97,185,47.6%,10m
2756,1,FireFly,4134,2147,74,82,156,47.4%,3m
2756,1,Starlight,4134,1584,41,42,83,49.4%,10m
2756,1,Deathbringer,4134,830,18,28,46,39.1%,5m
2761,1,Pim,4133,2087,168,186,354,47.5%,11m
2761,1,[KDV]BaBaGuGu,4133,538,16,7,23,69.6%,2m
2761,1,Czaro,4133,240,5,4,9,55.6%,11m
2761,1,Маэстро,4133,0,1,2,3,33.3%,23m
2765,1,Podpass,4132,699,26,18,44,59.1%,6m
2765,1,GmTOriginale,4132,0,0,2,2,0.0%,15m
2767,2,OniKratos,4131,2259,302,348,650,46.5%,25m
2767,1,yikes,4131,1103,36,22,58,62.1%,6m
2769,1,[блять]Pomme,4130,948,44,22,66,66.7%,23m
2769,1,Farkychat,4130,286,6,11,17,35.3%,12m
2769,1,Roughnet,4130,0,0,1,1,0.0%,8m
2769,1,[DaAm]balle,4130,0,0,5,5,0.0%,24m
2773,1,[MkersA]morph,4129,2119,218,225,443,49.2%,6m
2773,1,[AiRǂ]SuperNova,4129,712,17,18,35,48.6%,14m
2773,1,[lMMl]Mirzo,4129,324,7,4,11,63.6%,14m
2773,1,[Hаsu]TbIrEnИй,4129,282,6,5,11,54.5%,12m
2773,1,Harpegnathos,4129,48,2,0,2,100.0%,1m
2773,1,[A11]MisterABC,4129,96,2,5,7,28.6%,11m
2773,1,[TWIM]Mangomati,4129,0,0,1,1,0.0%,8m
2780,1,[Hrr]XtraCrispy,4128,96,2,3,5,40.0%,7m
2780,1,[MiClan]MiSHANYA,4128,0,0,1,1,0.0%,3m
2782,1,GosuNoob,4127,1730,441,447,888,49.7%,11m
2782,1,[Frass]TigeRFurY,4127,1846,70,82,152,46.1%,24m
2782,1,NoobTerran,4127,928,28,28,56,50.0%,6m
2782,1,[Peeps]TGO,4127,634,15,16,31,48.4%,25m
2782,1,[ØC]MonEwok,4127,0,0,1,1,0.0%,25m
2782,1,FreshPro,4127,0,0,1,1,0.0%,3m
2788,1,StimAddict,4126,1655,55,51,106,51.9%,17m
2788,3,[1Tank]Panzerfahrer,4126,58,3,0,3,100.0%,13m
2790,3,DomainFlag,4125,1801,114,123,237,48.1%,25m
2790,3,Малыш,4125,223,15,26,41,36.6%,9m
2790,3,sorcio,4125,0,4,1,5,80.0%,13m
2790,1,[illGG]Jin,4125,96,3,3,6,50.0%,10m
2790,1,biz,4125,0,0,4,4,0.0%,23m
2795,1,Romio,4124,1828,159,159,318,50.0%,12m
2795,1,DiscoRico,4124,2096,117,128,245,47.8%,11m
2795,1,[αX]Blisk,4124,422,10,14,24,41.7%,6m
2795,1,Sekiro,4124,94,3,5,8,37.5%,25m
2795,1,Secret,4124,0,1,0,1,100.0%,11m
2800,1,[DZ16]Corp,4123,1742,122,104,226,54.0%,25m
2800,1,Castillo,4123,838,19,19,38,50.0%,1m
2800,1,[TUPL]Vulcan,4123,615,16,15,31,51.6%,8m
2800,1,Мусоровоз,4123,468,10,9,19,52.6%,23m
2800,1,[EWEN]Kosiarrrra,4123,0,1,0,1,100.0%,10m
2805,1,Divi,4122,2000,75,57,132,56.8%,14m
2805,1,dokka,4122,526,16,15,31,51.6%,7m
2805,1,NanMarine,4122,412,10,5,15,66.7%,14m
2805,1,[EXPANT]MasterChief,4122,0,1,0,1,100.0%,10m
2805,1,Haze,4122,0,0,1,1,0.0%,8m
2810,1,Dampth,4121,1304,45,42,87,51.7%,6m
2810,1,FooFoo,4121,1100,28,23,51,54.9%,12m
2810,3,[RLA]Verlar,4121,222,25,43,68,36.8%,17m
2813,1,aaL,4120,1158,74,44,118,62.7%,5m
2813,2,Joy,4120,0,1,0,1,100.0%,13m
2813,1,ZemmourLove,4120,0,1,0,1,100.0%,6m
2813,2,llllllllllll,4120,0,1,2,3,33.3%,7m
2817,3,Brookie,4119,1846,97,112,209,46.4%,25m
2817,1,adorable,4119,1743,91,72,163,55.8%,1m
2817,3,Bison,4119,1589,78,83,161,48.4%,11m
2817,1,STB,4119,956,22,20,42,52.4%,14m
2817,1,llllllllllll,4119,618,15,4,19,78.9%,25m
2817,1,[5HEADS]SCout,4119,378,11,11,22,50.0%,11m
2817,1,TrustItOrNot,4119,186,6,2,8,75.0%,12m
2817,1,[SkWay]Reva,4119,46,1,3,4,25.0%,14m
2817,1,[fmiily]sothea,4119,48,1,6,7,14.3%,2m
2817,1,DOCTORE,4119,0,0,1,1,0.0%,9m
2817,2,[CocoCo]DansGame,4119,0,0,1,1,0.0%,14m
2817,1,american,4119,0,0,4,4,0.0%,9m
2829,1,[SwgBoi]DeadGame,4118,1321,68,59,127,53.5%,11m
2829,1,Zmey,4118,2022,67,61,128,52.3%,25m
2829,1,[PINGAS]Berdorel,4118,380,18,4,22,81.8%,9m
2829,1,Boqueron,4118,759,18,22,40,45.0%,11m
2829,3,IIIIIIIIIIII,4118,30,6,1,7,85.7%,25m
2834,1,Baneblade,4117,1274,33,29,62,53.2%,14m
2834,1,[SƬǂ]WANTyoMMR,4117,282,7,9,16,43.8%,23m
2834,1,CheesyNaan,4117,0,4,1,5,80.0%,16m
2837,1,[GWB]AngryLobster,4116,1570,48,41,89,53.9%,2m
2837,1,lousa,4116,994,29,28,57,50.9%,17m
2837,1,Kaivu,4116,730,16,14,30,53.3%,7m
2837,1,JacobGayCop,4116,94,3,0,3,100.0%,1m
2837,1,[Rizumu]SuMiRe,4116,0,1,2,3,33.3%,23m
2842,1,Heimdall,4115,1136,66,63,129,51.2%,3m
2842,1,LemonGreeN,4115,1043,46,27,73,63.0%,14m
2842,1,MindMaker,4115,0,0,1,1,0.0%,6m
2845,1,[LIMDZ]AlbandebriC,4114,405,12,9,21,57.1%,14m
2845,1,Gwynbleidd,4114,96,3,0,3,100.0%,23m
2845,1,FireFly,4114,0,1,0,1,100.0%,5m
2845,2,dgs,4114,0,1,0,1,100.0%,11m
2849,1,Marth,4113,2015,264,258,522,50.6%,24m
2849,1,[SEWP]ThEk,4113,1146,36,26,62,58.1%,24m
2849,1,LeBeaussetan,4113,736,31,18,49,63.3%,14m
2849,1,[Blacer]Malik,4113,568,17,10,27,63.0%,15m
2849,1,[AIlin]Terradin,4113,274,8,14,22,36.4%,16m
2854,1,[Gryère]DuRaiN,4112,2149,143,147,290,49.3%,9m
2854,1,Terrazin,4112,1086,104,94,198,52.5%,7m
2854,1,DioR,4112,982,23,30,53,43.4%,3m
2854,1,Hunta,4112,482,18,9,27,66.7%,7m
2854,1,[MSUSC2]Temir,4112,504,11,12,23,47.8%,8m
2854,1,TYTY,4112,0,0,2,2,0.0%,16m
2860,1,[OWL]sqrtoftwo,4111,2037,181,176,357,50.7%,9m
2860,3,[Yking]smashoman,4111,1691,159,151,310,51.3%,8m
2860,1,PrimeMarine,4111,1664,101,100,201,50.2%,12m
2860,1,Kyuubi,4111,823,29,16,45,64.4%,14m
2860,1,[RøckeT]ElKassos,4111,519,15,8,23,65.2%,9m
2860,3,KhalDrogo,4111,0,1,2,3,33.3%,23m
2860,1,[AnD]WallStreet,4111,48,1,3,4,25.0%,13m
2860,1,CrAnK,4111,0,0,2,2,0.0%,23m
2868,1,Fox,4110,1340,67,38,105,63.8%,25m
2868,1,july,4110,1380,35,32,67,52.2%,24m
2868,1,LionHeart,4110,732,23,12,35,65.7%,25m
2868,1,SengoS,4110,275,7,5,12,58.3%,12m
2868,3,dribbel,4110,86,4,2,6,66.7%,7m
2873,1,Honorem,4109,2157,245,224,469,52.2%,15m
2874,1,[aW]Marti,4108,1339,38,40,78,48.7%,3m
2874,1,Cromm,4108,328,8,10,18,44.4%,24m
2874,1,Abyss,4108,250,6,7,13,46.2%,3m
2874,1,[Ybs]Dembski,4108,96,3,1,4,75.0%,17m
2874,1,[Xa]Grenade,4108,48,2,1,3,66.7%,11m
2874,1,Alyaska,4108,96,2,1,3,66.7%,5m
2874,3,Lapras,4108,0,1,0,1,100.0%,9m
2874,1,[FKSD]bloodybread,4108,48,1,1,2,50.0%,25m
2882,3,Krys,4107,2031,1039,1045,2084,49.9%,7m
2882,3,Paco,4107,2010,246,229,475,51.8%,7m
2882,1,IIIIIIIIIIII,4107,1964,57,62,119,47.9%,9m
2882,1,XLIMIT,4107,48,2,0,2,100.0%,15m
2886,1,xLTJx,4106,952,49,29,78,62.8%,17m
2886,1,RainClouD,4106,1148,29,33,62,46.8%,2m
2886,1,BobToss,4106,139,5,2,7,71.4%,25m
2889,1,Evil,4105,1990,721,677,1398,51.6%,11m
2889,3,LittleStorm,4105,2006,296,274,570,51.9%,11m
2889,1,[iN7]IIIIIIIIIIII,4105,1247,73,53,126,57.9%,5m
2889,1,Teypo,4105,1270,50,55,105,47.6%,24m
2889,1,ExistanZ,4105,46,1,1,2,50.0%,3m
2894,1,MarineFox,4104,2041,100,86,186,53.8%,10m
2894,1,Glitch,4104,567,32,17,49,65.3%,24m
2894,1,KiSkA,4104,857,22,20,42,52.4%,2m
2894,1,[InBri]AventadorSV,4104,0,0,1,1,0.0%,25m
2898,1,[KonoH]RaccyG,4103,2133,122,110,232,52.6%,6m
2898,1,Pandorum,4103,337,11,10,21,52.4%,6m
2898,1,CoinCidenCe,4103,96,3,10,13,23.1%,14m
2898,1,spectris,4103,48,1,4,5,20.0%,12m
2898,1,[PÂRłAH]FreeThinker,4103,0,0,1,1,0.0%,23m
2903,1,[ƮesXG]WhySoSeriouS,4102,1988,73,51,124,58.9%,16m
2903,1,ТолчокСмерти,4102,332,8,6,14,57.1%,25m
2903,1,[BATG]SnipeFive,4102,48,1,1,2,50.0%,24m
2906,3,DuncanDalas,4101,1983,275,265,540,50.9%,10m
2906,1,Qwan,4101,1344,122,89,211,57.8%,23m
2906,1,zeratul,4101,1411,50,41,91,54.9%,24m
2906,1,Kwexine,4101,238,6,8,14,42.9%,2m
2906,1,Tyras,4101,0,0,1,1,0.0%,3m
2911,1,[HBGSJR]Khamul,4100,1202,159,143,302,52.6%,12m
2911,1,[SGZARM]Arthur,4100,1723,140,131,271,51.7%,17m
2911,1,JustYan,4100,1461,38,30,68,55.9%,3m
2911,1,[Dobro]gapk,4100,1414,36,50,86,41.9%,2m
2911,3,[aW]Papaours,4100,320,23,44,67,34.3%,17m
2911,1,[CORE]DrStoopid,4100,435,22,12,34,64.7%,12m
2911,1,CurryUdon,4100,90,4,2,6,66.7%,10m
2911,1,[IceHus]БауырсаК,4100,142,4,3,7,57.1%,2m
2911,1,DrEaDFuL,4100,94,2,3,5,40.0%,25m
2911,1,[NOT420]Rascal,4100,0,1,0,1,100.0%,6m
2911,1,Originale,4100,0,0,1,1,0.0%,12m
2922,1,[LaPaCa]Shyl,4099,1899,86,86,172,50.0%,14m
2922,1,noob,4099,589,20,3,23,87.0%,9m
2922,1,SerraAngelDK,4099,0,1,1,2,50.0%,23m
2922,1,[FLCN]tunay,4099,48,1,1,2,50.0%,25m
2926,1,Vodkaccount,4098,1127,36,43,79,45.6%,9m
2926,1,Sipher,4098,1007,34,36,70,48.6%,11m
2926,1,[GC]KingOfQueenS,4098,278,7,5,12,58.3%,3m
2926,1,[Папик]Хайдекай,4098,208,6,6,12,50.0%,24m
2926,1,Cheshire,4098,0,0,2,2,0.0%,9m
2931,1,grubsiud,4097,1853,135,122,257,52.5%,16m
2931,1,[HsDL]stichtom,4097,989,85,81,166,51.2%,14m
2931,1,[RGn]Pwnika,4097,276,9,9,18,50.0%,7m
2931,2,SomeGuy,4097,114,3,2,5,60.0%,17m
2935,1,[VINCI]kartnico,4096,2047,216,214,430,50.2%,6m
2935,1,[DeVu]LunatiC,4096,603,15,6,21,71.4%,24m
2935,1,[TheFWF]NavyBlue,4096,0,0,1,1,0.0%,6m
2938,1,yyc,4095,1972,81,76,157,51.6%,25m
2938,1,[ЯD]Azures,4095,840,20,16,36,55.6%,7m
2938,1,[FTWPRO]Ezio,4095,402,11,15,26,42.3%,12m
2938,1,Gosumarine,4095,99,2,2,4,50.0%,15m
2938,1,[FREE]Olaf,4095,0,0,1,1,0.0%,25m
2943,3,MatchMakingg,4094,1952,193,190,383,50.4%,16m
2943,1,theglml,4094,584,14,9,23,60.9%,5m
2945,1,NYdiesel,4093,1582,108,104,212,50.9%,14m
2945,1,[ApeT]ednor,4093,48,2,2,4,50.0%,9m
2945,1,[inferi]Weiv,4093,0,1,1,2,50.0%,12m
2945,1,wolfpl,4093,0,0,2,2,0.0%,11m
2949,1,JoeNova,4092,2122,235,229,464,50.6%,7m
2949,1,[Heroes]Vales,4092,2123,90,97,187,48.1%,3m
2949,1,[f2amov]REDARMY,4092,911,30,26,56,53.6%,12m
2949,1,RoTtiN,4092,796,28,15,43,65.1%,12m
2949,3,Vortex,4092,0,2,3,5,40.0%,5m
2954,1,[TheDOH]Zizou,4091,2117,401,405,806,49.8%,14m
2954,1,ReDa,4091,1277,80,94,174,46.0%,2m
2954,1,JorgeCis,4091,1809,59,45,104,56.7%,2m
2954,1,BarCode,4091,1610,58,48,106,54.7%,2m
2954,1,ProstoChel,4091,749,39,42,81,48.1%,2m
2954,1,robotter,4091,831,23,25,48,47.9%,2m
2960,1,Metrox,4090,142,3,4,7,42.9%,25m
2960,1,[lVl]MsK,4090,0,1,0,1,100.0%,25m
2960,1,Eliasson,4090,0,0,1,1,0.0%,25m
2960,1,Golanchik,4090,0,0,5,5,0.0%,2m
2964,1,Maru,4089,2014,403,422,825,48.8%,14m
2964,1,krasto,4089,2034,341,325,666,51.2%,24m
2964,1,Skorbien,4089,2102,76,85,161,47.2%,7m
2964,1,Mata,4089,1405,45,50,95,47.4%,7m
2964,1,MrFancyPants,4089,1282,34,25,59,57.6%,15m
2964,1,Doc,4089,140,4,4,8,50.0%,16m
2964,1,MysticMuse,4089,48,2,3,5,40.0%,8m
2964,1,[CKi]ViperXk,4089,48,1,4,5,20.0%,25m
2964,1,[ØC]Cody,4089,0,0,6,6,0.0%,25m
2973,1,[Li3]KosioOOSeven,4088,1949,451,417,868,52.0%,17m
2973,1,Hiisi,4088,1726,97,70,167,58.1%,6m
2973,1,[AciNoN]ķøćmøķøтэ,4088,874,24,12,36,66.7%,17m
2973,1,IIIIIIIIIIII,4088,48,2,2,4,50.0%,23m
2973,1,KorZo,4088,96,2,7,9,22.2%,10m
2973,1,Upgrayedd,4088,48,1,5,6,16.7%,5m
2973,2,MICROMANCER,4088,0,0,1,1,0.0%,6m
2980,1,[CRAIC]Vulvatron,4087,1550,162,161,323,50.2%,10m
2980,1,Aza,4087,2127,158,167,325,48.6%,6m
2980,1,Brocklyn,4087,1750,76,85,161,47.2%,17m
2980,1,mojonseco,4087,379,16,18,34,47.1%,6m
2984,1,delavierfred,4086,1238,38,30,68,55.9%,9m
2984,1,[maow]Orimek,4086,753,31,12,43,72.1%,16m
2984,3,MMA,4086,254,22,40,62,35.5%,8m
2984,1,DedMazai,4086,600,14,17,31,45.2%,3m
2984,1,[44IQ]ManOfOneWay,4086,0,0,1,1,0.0%,11m
2984,1,Tony,4086,0,0,1,1,0.0%,16m
2990,3,[HaC]Zôon,4085,763,260,265,525,49.5%,9m
2990,3,[eXøde]Slayer,4085,666,173,162,335,51.6%,17m
2990,1,JeorMormont,4085,696,50,55,105,47.6%,3m
2990,1,FormulaOne,4085,417,18,6,24,75.0%,1m
2990,1,raychuna,4085,493,16,17,33,48.5%,25m
2990,1,WAZABI,4085,590,14,15,29,48.3%,5m
2990,1,Vanitas,4085,0,1,4,5,20.0%,6m
2990,1,[RSI]Saske,4085,0,0,1,1,0.0%,7m
2998,1,Dziobo,4084,584,21,16,37,56.8%,14m
2998,1,beautiful,4084,401,10,4,14,71.4%,16m
2998,1,boss,4084,94,3,7,10,30.0%,17m
2998,1,[tMnrd]mrDarcy,4084,0,1,0,1,100.0%,24m
3002,1,[DSCOM]zKay,4083,2114,354,321,675,52.4%,25m
3002,3,IIIIIIIIIIII,4083,545,75,89,164,45.7%,8m
3002,3,theloopa,4083,18,6,18,24,25.0%,2m
3002,1,Bust,4083,0,0,1,1,0.0%,16m
3006,1,[Maegis]SherKhan,4082,1541,51,45,96,53.1%,7m
3006,1,[DvulA]Rolli,4082,1198,29,28,57,50.9%,5m
3006,1,[FlyPy]joonTerror,4082,636,14,15,29,48.3%,12m
3006,1,FireWing,4082,0,0,1,1,0.0%,12m
3010,3,infy,4081,1844,137,162,299,45.8%,1m
3010,1,ROCKSTAR,4081,48,1,2,3,33.3%,14m
3012,1,MiNDTRiKS,4080,2127,116,89,205,56.6%,7m
3012,1,MthreeMarine,4080,937,33,29,62,53.2%,2m
3012,1,Contista,4080,552,17,9,26,65.4%,23m
3012,1,Taylor,4080,564,12,21,33,36.4%,11m
3012,1,Severian,4080,497,10,6,16,62.5%,2m
3012,1,delmak,4080,0,1,2,3,33.3%,2m
3012,1,bonta,4080,0,0,1,1,0.0%,12m
3019,1,Ulz,4079,1888,72,69,141,51.1%,6m
3019,1,[SkWay]arbol,4079,514,12,16,28,42.9%,14m
3019,3,Chocov,4079,113,10,12,22,45.5%,3m
3019,1,Tossimba,4079,382,9,11,20,45.0%,6m
3019,1,[Spec]SKAÐI,4079,236,5,5,10,50.0%,14m
3019,1,General,4079,0,1,1,2,50.0%,5m
3019,1,[K0mpis]Gyllenegeten,4079,0,1,2,3,33.3%,25m
3026,1,face,4078,1958,130,120,250,52.0%,17m
3026,3,[CpL]eDen,4078,0,1,0,1,100.0%,1m
3026,1,dgs,4078,46,1,6,7,14.3%,24m
3029,1,Oink,4077,705,27,11,38,71.1%,5m
3029,1,[GosuRU]Беконя,4077,799,19,13,32,59.4%,24m
3029,1,[PTLc]Keiga,4077,624,15,13,28,53.6%,14m
3029,1,[ЯD]IGnition,4077,63,3,0,3,100.0%,3m
3029,1,slatten,4077,48,1,4,5,20.0%,2m
3034,3,lIxXxIl,4076,1952,273,284,557,49.0%,17m
3034,1,Nemlec,4076,48,1,4,5,20.0%,11m
3036,1,llllllllllll,4075,1143,46,44,90,51.1%,18m
3037,1,privacyAnnul,4074,1934,73,58,131,55.7%,18m
3037,1,Dhawos,4074,1520,58,43,101,57.4%,14m
3037,1,DeathKick,4074,1372,40,29,69,58.0%,25m
3037,2,LyOner,4074,42,2,1,3,66.7%,1m
3041,1,[BWArmy]TRC,4073,1921,98,74,172,57.0%,14m
3041,1,[ViBErs]DrMacro,4073,1484,50,33,83,60.2%,16m
3041,1,Tomeus,4073,1013,26,21,47,55.3%,18m
3041,1,IIIIIIIIIIII,4073,238,5,13,18,27.8%,16m
3041,1,[LBeast]shadye,4073,142,3,4,7,42.9%,14m
3046,3,Starstiflor,4072,1522,291,294,585,49.7%,3m
3046,1,[Bling]CptOwnalot,4072,2043,123,122,245,50.2%,23m
3046,3,Kuckuck,4072,214,11,0,11,100.0%,16m
3046,1,Bogata,4072,188,4,3,7,57.1%,2m
3050,1,Freddy,4071,1589,51,51,102,50.0%,5m
3050,1,[aW]DonDada,4071,1014,31,18,49,63.3%,11m
3050,1,Mercy,4071,1208,28,32,60,46.7%,25m
3053,1,Nibby,4070,2103,92,98,190,48.4%,3m
3053,1,[TheDOH]Mathis,4070,1596,48,45,93,51.6%,2m
3053,1,Artstyle,4070,738,17,20,37,45.9%,6m
3053,1,TerranOPrace,4070,140,4,3,7,57.1%,5m
3053,1,tAlion,4070,188,4,4,8,50.0%,12m
3053,1,aTroX,4070,0,0,1,1,0.0%,16m
3059,1,[šƒ]apLxmerl,4068,1466,200,199,399,50.1%,8m
3059,1,[EXORT]Seneka,4068,1648,94,74,168,56.0%,14m
3059,1,[WEEDfr]scizoFoxY,4068,1538,41,40,81,50.6%,14m
3059,1,BaNaNaSKY,4068,378,9,21,30,30.0%,1m
3059,2,Chubaka,4068,102,3,1,4,75.0%,9m
3059,1,Ambition,4068,48,2,0,2,100.0%,16m
3059,1,JauchePeter,4068,0,0,1,1,0.0%,15m
3059,1,[LesPro]Enigma,4068,0,0,1,1,0.0%,9m
3067,1,[DSTARI]Nedved,4067,1831,165,140,305,54.1%,11m
3067,1,Tomito,4067,1395,97,102,199,48.7%,2m
3067,1,[CULTE]TKL,4067,930,32,33,65,49.2%,14m
3067,2,Lyuganok,4067,0,1,0,1,100.0%,6m
3071,1,haxor,4066,1722,48,45,93,51.6%,12m
3071,1,[MSUSC2]Nickless,4066,999,28,29,57,49.1%,12m
3071,1,NewParadigm,4066,464,11,12,23,47.8%,25m
3071,1,nani,4066,361,10,1,11,90.9%,16m
3071,1,Zycholek,4066,147,5,2,7,71.4%,17m
3071,1,[KZstar]Saga,4066,138,3,3,6,50.0%,23m
3077,1,DrunkMaster,4065,1711,57,54,111,51.4%,8m
3077,3,IceFluffy,4065,592,35,47,82,42.7%,10m
3077,1,TWiace,4065,1336,34,30,64,53.1%,2m
3077,1,[Heroes]Magnath,4065,48,2,0,2,100.0%,2m
3081,3,Protosex,4064,433,23,18,41,56.1%,7m
3081,1,LifeIVs,4064,48,1,1,2,50.0%,24m
3081,1,[Cruxis]headcrusher,4064,0,0,1,1,0.0%,23m
3084,3,MementoMori,4063,52,17,25,42,40.5%,16m
3084,2,mom,4063,311,15,2,17,88.2%,10m
3084,2,[GHOGHH]RedKokiedo,4063,86,2,4,6,33.3%,24m
3087,1,fakeMedivac,4062,96,3,8,11,27.3%,14m
3087,1,fastr,4062,0,1,2,3,33.3%,10m
3087,3,Saruman,4062,0,1,4,5,20.0%,14m
3087,1,Carnage,4062,0,0,2,2,0.0%,25m
3091,1,[ObG1]CidHighwing,4061,2097,132,132,264,50.0%,9m
3091,1,VoiceLegion,4061,1702,81,69,150,54.0%,24m
3091,1,madtovih,4061,993,44,18,62,71.0%,15m
3091,1,Venturi,4061,1474,39,35,74,52.7%,14m
3091,1,[QreskT]SOVA,4061,635,23,11,34,67.6%,23m
3091,1,[FxL]PhynixHduO,4061,490,11,14,25,44.0%,16m
3097,1,BorisBritva,4060,1920,81,73,154,52.6%,6m
3097,1,Rigged,4060,1187,63,50,113,55.8%,2m
3097,1,[ENGNS]Mechanics,4060,1560,43,41,84,51.2%,24m
3097,1,Angesandet,4060,96,2,3,5,40.0%,12m
3097,1,Rumo,4060,46,1,1,2,50.0%,23m
3097,2,[Ex0n]StekepaNNe,4060,0,0,1,1,0.0%,6m
3097,1,[ESCast]Dysix,4060,0,0,1,1,0.0%,14m
3097,1,[UTFI]RadeberGER,4060,73,0,2,2,0.0%,10m
3105,1,Basusay,4059,1430,48,49,97,49.5%,6m
3105,1,Takemikazuch,4059,246,5,1,6,83.3%,5m
3105,1,vvg,4059,94,3,5,8,37.5%,3m
3105,1,MrBarcode,4059,0,1,4,5,20.0%,23m
3105,1,[DN3N]Square,4059,0,0,2,2,0.0%,25m
3105,1,[EFPICO]Struck,4059,0,0,4,4,0.0%,6m
3111,1,KazoO,4058,2083,307,283,590,52.0%,15m
3111,1,DJP,4058,2093,180,192,372,48.4%,24m
3111,1,[INAE]Striker,4058,911,47,28,75,62.7%,14m
3111,1,[Pøg]Mangue,4058,694,24,7,31,77.4%,11m
3111,1,BluePray,4058,492,16,4,20,80.0%,7m
3111,1,ZergKnight,4058,121,4,7,11,36.4%,2m
3111,1,Faras,4058,96,3,10,13,23.1%,25m
3111,1,[HBGS]Starfish,4058,0,1,0,1,100.0%,23m
3111,1,Puha,4058,48,1,1,2,50.0%,17m
3120,1,[ZZW]Imanji,4057,1052,42,47,89,47.2%,18m
3120,1,IIIIIIIIII,4057,278,13,2,15,86.7%,16m
3120,1,Sołdat,4057,408,13,8,21,61.9%,25m
3120,1,Mandalorian,4057,48,2,1,3,66.7%,25m
3120,1,llllllllllll,4057,0,0,2,2,0.0%,6m
3125,1,KVS,4056,1911,134,124,258,51.9%,9m
3125,1,[kælder]GeOrgi,4056,48,1,2,3,33.3%,24m
3125,1,[MoonM]ScientistSvk,4056,48,1,6,7,14.3%,11m
3125,1,Nobubo,4056,0,0,1,1,0.0%,9m
3125,1,[FrC]Benzoate,4056,0,0,3,3,0.0%,9m
3130,1,WonReasley,4055,783,55,45,100,55.0%,18m
3130,1,[Lab001]MadScientist,4055,1127,45,29,74,60.8%,25m
3130,2,GoodEvil,4055,263,14,2,16,87.5%,15m
3130,1,InteИse,4055,140,4,3,7,57.1%,8m
3134,1,[dziova]IIIIIIIIIIII,4054,1368,35,33,68,51.5%,13m
3134,1,IIIIIIIIIIII,4054,94,2,2,4,50.0%,25m
3134,1,llllllllllll,4054,0,1,0,1,100.0%,6m
3134,1,[twinZ]MadNiTE,4054,0,0,1,1,0.0%,15m
3134,1,SageFrancis,4054,0,0,1,1,0.0%,23m
3139,1,[αX]Blackone,4053,1275,63,71,134,47.0%,13m
3139,1,Fov,4053,1477,58,47,105,55.2%,5m
3139,1,cgxcn,4053,318,7,3,10,70.0%,9m
3139,1,vanderlokken,4053,280,6,11,17,35.3%,23m
3139,1,[сSсǃ]DjeKi,4053,48,1,4,5,20.0%,12m
3144,1,[EESC]Piwon,4052,1900,216,202,418,51.7%,23m
3144,1,[GoldM]SaPa,4052,2099,126,114,240,52.5%,14m
3144,1,Farnoér,4052,691,47,53,100,47.0%,18m
3144,1,ivanpeque,4052,929,28,16,44,63.6%,3m
3144,1,AngryDonut,4052,328,13,3,16,81.2%,11m
3144,1,creer,4052,502,12,12,24,50.0%,24m
3150,1,Left,4051,802,19,18,37,51.4%,3m
3150,1,[DOP]Praptor,4051,232,6,4,10,60.0%,3m
3150,1,Harzadous,4051,46,1,3,4,25.0%,6m
3153,1,smilence,4050,2009,146,127,273,53.5%,26m
3153,1,IIIIIIIIIIII,4050,1636,70,54,124,56.5%,3m
3153,3,[Mkers]DeMiGoDSh,4050,193,10,0,10,100.0%,24m
3153,1,[GОVNО]DOBROED,4050,48,2,0,2,100.0%,23m
3157,1,MehToo,4049,1480,433,458,891,48.6%,24m
3157,1,DarKhan,4049,236,14,2,16,87.5%,7m
3157,1,[GoldM]Bumbz,4049,588,14,14,28,50.0%,24m
3157,1,[LESeV]Einherjar,4049,540,13,11,24,54.2%,9m
3157,1,ƤƑƻƘ,4049,278,6,5,11,54.5%,14m
3157,1,Wêex,4049,0,1,0,1,100.0%,23m
3157,1,[ĦRZ]Banti,4049,0,1,1,2,50.0%,2m
3157,1,Alstrice,4049,0,0,1,1,0.0%,23m
3157,1,[Xa]MadMarine,4049,0,0,1,1,0.0%,23m
3166,1,midhigh,4048,1324,34,41,75,45.3%,14m
3166,1,TǂPerFecTion,4048,656,14,11,25,56.0%,12m
3166,1,[PŖïMĄŁ]Azi,4048,96,2,1,3,66.7%,9m
3166,1,Vanquish,4048,48,2,5,7,28.6%,3m
3166,2,Flying,4048,0,1,0,1,100.0%,15m
3171,1,Owlrazum,4047,2088,601,578,1179,51.0%,3m
3171,1,Rawwk,4047,1961,158,163,321,49.2%,12m
3171,1,Mosaïk,4047,1805,88,71,159,55.3%,6m
3171,1,[NTLA]DrunkCarbot,4047,48,1,3,4,25.0%,24m
3171,1,SevenOfNine,4047,0,0,1,1,0.0%,2m
3171,1,AAAA,4047,0,0,1,1,0.0%,11m
3177,1,[ITDI]Taz,4046,2078,285,288,573,49.7%,2m
3177,1,CrazyPanda,4046,1266,88,73,161,54.7%,11m
3177,1,hairball,4046,1169,32,32,64,50.0%,13m
3177,1,[PiGPan]Noose,4046,92,3,2,5,60.0%,3m
3177,1,[BiPU]Fompe,4046,0,0,1,1,0.0%,24m
3182,1,Frankenberry,4045,999,107,98,205,52.2%,12m
3182,1,SNORLAX,4045,842,29,36,65,44.6%,12m
3182,1,[Hаsu]CreATIve,4045,322,7,5,12,58.3%,25m
3182,1,[1405]Torra,4045,144,4,11,15,26.7%,2m
3182,1,[AlDS]TomCrOOse,4045,0,1,0,1,100.0%,14m
3187,1,megatronco,4044,1940,245,245,490,50.0%,17m
3187,1,MoreGG,4044,1038,26,26,52,50.0%,3m
3187,1,Ankonia,4044,180,5,8,13,38.5%,9m
3187,1,[BPX]Andi,4044,0,1,2,3,33.3%,2m
3187,1,MechJagger,4044,0,0,2,2,0.0%,12m
3192,3,Rafavr,4043,1978,271,273,544,49.8%,11m
3192,1,Gòdzilla,4043,2099,112,114,226,49.6%,3m
3192,1,toR,4043,822,34,21,55,61.8%,5m
3192,1,[Xa]Nisho,4043,1036,24,35,59,40.7%,3m
3192,1,Nuffy,4043,230,13,1,14,92.9%,15m
3192,1,Tanker,4043,186,7,4,11,63.6%,24m
3192,1,PikaPika,4043,196,5,1,6,83.3%,1m
3192,1,Elite,4043,0,0,2,2,0.0%,23m
3200,1,ManofOneway,4042,2106,165,182,347,47.6%,6m
3200,3,[Dobro]ProStyMe,4042,236,21,39,60,35.0%,11m
3202,1,Possible,4041,1287,98,80,178,55.1%,15m
3202,1,XXXXXXXXXXXX,4041,2059,79,81,160,49.4%,16m
3204,1,llllllllllll,4040,324,7,7,14,50.0%,2m
3204,1,llllllllllll,4040,282,6,9,15,40.0%,11m
3204,1,Byun,4040,138,4,2,6,66.7%,24m
3204,1,Fifou,4040,142,3,12,15,20.0%,6m
3204,1,[SQUÍK]Ernshow,4040,48,1,5,6,16.7%,26m
3209,1,luckyluciano,4039,2056,295,279,574,51.4%,18m
3209,1,[Ex0n]Hønsking,4039,1905,60,53,113,53.1%,23m
3209,1,Legat,4039,1298,40,33,73,54.8%,13m
3209,1,Exolius,4039,576,21,11,32,65.6%,7m
3209,1,StatsIsBest,4039,293,7,4,11,63.6%,23m
3209,1,доброМЕХтерр,4039,0,1,0,1,100.0%,23m
3209,1,choice,4039,0,0,1,1,0.0%,13m
3216,1,Wookyman,4038,1703,108,98,206,52.4%,9m
3216,1,Kruger,4038,1510,43,34,77,55.8%,1m
3216,1,RandomMarine,4038,1236,39,41,80,48.8%,13m
3216,2,NickGG,4038,272,15,3,18,83.3%,10m
3216,1,[Soil]madOne,4038,274,11,6,17,64.7%,12m
3216,1,[AG]BlueBlood,4038,222,9,3,12,75.0%,14m
3216,1,[RBlood]Stef,4038,188,5,2,7,71.4%,13m
3216,1,Artanior,4038,144,3,6,9,33.3%,7m
3216,1,alphago,4038,0,0,1,1,0.0%,9m
3225,3,CleanSweep,4037,1421,241,242,483,49.9%,16m
3225,3,[BøZø]LtDan,4037,1815,111,139,250,44.4%,16m
3225,1,[Камрад]Kukaracha,4037,1587,59,47,106,55.7%,12m
3225,1,[Heroes]MegaStar,4037,876,27,18,45,60.0%,16m
3225,1,Adresant,4037,312,7,7,14,50.0%,14m
3225,1,[αX]ThiasHP,4037,0,0,1,1,0.0%,13m
3231,1,[OSgZ]Hednar,4036,1433,55,53,108,50.9%,14m
3231,1,[PLA2N]Torasaki,4036,384,14,13,27,51.9%,11m
3231,1,Song,4036,230,13,2,15,86.7%,23m
3231,1,[TŋT]StiMMpack,4036,96,2,3,5,40.0%,24m
3231,1,[AiRǂ]Tommaso,4036,0,0,3,3,0.0%,9m
3236,1,Bartimeus,4035,1102,138,119,257,53.7%,2m
3236,1,Odin,4035,1467,67,61,128,52.3%,16m
3236,1,[ЯD]Arc,4035,1206,31,32,63,49.2%,24m
3236,1,RaijiN,4035,400,10,5,15,66.7%,25m
3236,1,EmpireBormaN,4035,96,2,3,5,40.0%,13m
3236,1,[FREEDM]Thx,4035,0,0,1,1,0.0%,12m
3236,1,StaryPijany,4035,0,0,1,1,0.0%,2m
3243,1,OnkelDampf,4034,1500,106,95,201,52.7%,2m
3243,1,IlllIIllIlll,4034,446,10,16,26,38.5%,14m
3243,1,[ǂRSǂ]HotS,4034,324,8,12,20,40.0%,17m
3243,1,DerKrieg,4034,0,1,1,2,50.0%,2m
3243,1,[SCMate]ImYourDream,4034,0,0,1,1,0.0%,6m
3243,1,supernoob,4034,0,0,1,1,0.0%,10m
3249,1,IlIlIlIlIlI,4033,2065,94,98,192,49.0%,17m
3249,1,KEKW,4033,2079,88,83,171,51.5%,3m
3249,1,PuXoR,4033,1937,81,70,151,53.6%,10m
3249,1,[CLICKk]Draco,4033,1878,60,59,119,50.4%,9m
3249,1,Napoléon,4033,1531,53,59,112,47.3%,2m
3249,1,ReDB,4033,218,35,27,62,56.5%,3m
3249,1,matrix,4033,184,4,7,11,36.4%,5m
3249,2,SteDwaLich,4033,76,2,3,5,40.0%,6m
3249,1,zatic,4033,0,1,0,1,100.0%,26m
3258,1,ИМПЕРАТОР,4032,1596,150,148,298,50.3%,17m
3258,1,TiiCaL,4032,354,29,21,50,58.0%,7m
3258,1,Rakan,4032,0,1,1,2,50.0%,26m
3258,1,Protan,4032,0,0,1,1,0.0%,5m
3262,1,[DarkAG]AlphaÄffchen,4031,1965,172,163,335,51.3%,26m
3262,1,Tobi,4031,1990,138,118,256,53.9%,5m
3262,1,[AiRǂ]Gialluca,4031,1414,74,52,126,58.7%,26m
3262,1,dom,4031,683,46,38,84,54.8%,12m
3262,1,DJLAMBO,4031,144,3,5,8,37.5%,16m
3267,1,[GrMas]hillllfire,4030,1918,59,61,120,49.2%,6m
3267,1,Studencik,4030,859,29,18,47,61.7%,2m
3267,1,LeComplete,4030,254,8,3,11,72.7%,1m
3267,3,CaptainTruel,4030,58,2,1,3,66.7%,13m
3267,1,Irator,4030,48,2,2,4,50.0%,6m
3267,1,Ojjlj,4030,0,1,0,1,100.0%,5m
3273,1,TheStag,4029,2078,89,95,184,48.4%,12m
3273,1,[Фаталя]Фаталя,4029,1666,73,66,139,52.5%,17m
3273,1,[JDUNEZ]petrovich,4029,0,0,1,1,0.0%,1m
3273,1,llllllllllll,4029,0,0,1,1,0.0%,6m
3273,3,StimToWin,4029,0,0,1,1,0.0%,17m
3278,1,DraS,4028,2010,250,245,495,50.5%,17m
3278,1,Phive,4028,1128,46,35,81,56.8%,24m
3278,1,NineIron,4028,848,21,31,52,40.4%,24m
3278,2,IIIIIIIIIIII,4028,214,13,2,15,86.7%,9m
3278,1,[RеG]Hitka,4028,188,5,6,11,45.5%,6m
3278,1,dykecheese,4028,96,3,12,15,20.0%,12m
3284,1,Subversa,4027,1318,35,53,88,39.8%,13m
3284,1,Exmario,4027,905,25,22,47,53.2%,3m
3284,1,[CxCx]Froenk,4027,430,18,8,26,69.2%,5m
3284,1,Sam,4027,172,10,0,10,100.0%,23m
3284,1,BossTerran,4027,92,2,4,6,33.3%,5m
3289,1,BNAN,4026,925,44,41,85,51.8%,24m
3289,1,DavbondMaker,4026,94,3,3,6,50.0%,11m
3289,1,tCup,4026,0,1,0,1,100.0%,11m
3292,1,TurboDymoMen,4025,2080,234,245,479,48.9%,8m
3292,1,[ÆR]ProNoob,4025,1787,74,76,150,49.3%,9m
3292,3,ToTheDeath,4025,88,10,29,39,25.6%,1m
3292,1,[ChX]SOSolacex,4025,163,5,9,14,35.7%,9m
3292,1,[ASEB]ChecKMaTe,4025,96,3,4,7,42.9%,26m
3292,1,[crabz]IronMax,4025,46,1,3,4,25.0%,15m
3298,1,MarcusAS,4024,2085,255,270,525,48.6%,6m
3298,1,Nooblet,4024,1401,90,90,180,50.0%,25m
3298,1,Bananensaft,4024,0,0,2,2,0.0%,6m
3298,1,ǂTenshiǂ,4024,0,0,6,6,0.0%,25m
3302,1,Guixo,4023,1983,68,70,138,49.3%,2m
3302,1,KOmBaCbKA,4023,406,9,10,19,47.4%,25m
3302,1,[duсks]maniachillo,4023,229,4,2,6,66.7%,24m
3302,1,[DarKwi]IvanSOHO,4023,0,0,3,3,0.0%,17m
3306,1,Terranosaure,4022,1759,170,171,341,49.9%,2m
3306,1,SMRTGANS,4022,1537,126,100,226,55.8%,23m
3306,1,[Гарный]Молодой,4022,1460,113,111,224,50.4%,18m
3306,1,Sydney,4022,1459,65,48,113,57.5%,1m
3306,1,[aW]Weedababzz,4022,1422,38,36,74,51.4%,5m
3306,1,sLaiz,4022,298,6,8,14,42.9%,25m
3306,1,[FxL]OverRainbow,4022,232,5,9,14,35.7%,5m
3313,1,Charlie,4021,1971,311,317,628,49.5%,12m
3313,1,[MeDuS]attas,4021,2060,87,97,184,47.3%,17m
3313,1,nikita,4021,1418,53,55,108,49.1%,18m
3313,1,iMbaWoMbat,4021,186,5,6,11,45.5%,7m
3313,1,IIIIIIIIIIII,4021,48,2,0,2,100.0%,25m
3313,1,gag,4021,46,1,2,3,33.3%,6m
3313,1,Religion,4021,0,0,1,1,0.0%,7m
3320,1,kee,4020,1890,327,317,644,50.8%,9m
3320,1,llllllllIllI,4020,225,10,2,12,83.3%,16m
3320,1,junglenasus,4020,46,2,1,3,66.7%,1m
3320,1,[0BO]Eribour,4020,0,0,2,2,0.0%,23m
3320,2,Alexander,4020,0,0,8,8,0.0%,7m
3325,1,ELLe,4019,1014,40,44,84,47.6%,18m
3325,1,[INAE]Kronos,4019,1083,31,25,56,55.4%,16m
3325,1,zane,4019,807,26,35,61,42.6%,7m
3325,1,JSweatshirt,4019,904,23,18,41,56.1%,6m
3325,1,МилашПорташ,4019,610,21,11,32,65.6%,9m
3325,1,ClydefroG,4019,161,13,6,19,68.4%,17m
3325,1,[ASGǂ]Speedy,4019,244,6,8,14,42.9%,1m
3325,1,Moo,4019,140,4,3,7,57.1%,16m
3325,1,[TRKZ]Tùrambar,4019,48,2,1,3,66.7%,25m
3325,1,eclipse,4019,139,2,1,3,66.7%,12m
3325,1,Wahla,4019,94,2,3,5,40.0%,5m
3336,1,VouS,4018,2052,309,317,626,49.4%,12m
3336,1,[AciNoN]Элайт,4018,516,32,14,46,69.6%,3m
3336,1,KLÜFT,4018,1058,25,25,50,50.0%,5m
3336,1,Vegas,4018,946,23,29,52,44.2%,6m
3336,2,FlipFlop,4018,284,15,2,17,88.2%,11m
3341,1,garuda,4017,1380,94,85,179,52.5%,3m
3341,1,mercurial,4017,1137,81,90,171,47.4%,12m
3341,1,[TSFF]Alphon,4017,1427,59,61,120,49.2%,6m
3341,1,[StarG]Saixy,4017,1116,27,35,62,43.5%,13m
3341,1,SPARVAGN,4017,698,16,16,32,50.0%,26m
3341,1,miked,4017,231,4,3,7,57.1%,5m
3341,1,[lnvoke]Valazus,4017,0,1,0,1,100.0%,24m
3348,1,FMarineKing,4016,1083,181,166,347,52.2%,25m
3348,1,slimbo,4016,1930,81,83,164,49.4%,18m
3348,1,Titan,4016,756,59,43,102,57.8%,26m
3348,1,Skrinki,4016,345,13,7,20,65.0%,16m
3348,1,IIIIIIIIIIII,4016,500,12,9,21,57.1%,23m
3348,1,IGotRejected,4016,0,0,1,1,0.0%,24m
3354,1,[Cannоn]LebRaKaeSe,4015,1207,62,47,109,56.9%,6m
3354,1,Holykolya,4015,138,4,6,10,40.0%,10m
3354,1,Pixel,4015,0,1,0,1,100.0%,3m
3354,1,Arcticus,4015,0,0,1,1,0.0%,10m
3358,1,Trololo,4014,962,96,53,149,64.4%,23m
3358,3,[WaCKi]krzychacz,4014,0,1,4,5,20.0%,11m
3358,1,LimiteR,4014,0,0,1,1,0.0%,25m
3361,1,NOOB,4013,1024,62,14,76,81.6%,9m
3361,3,IIIIlIIIIlII,4013,214,11,1,12,91.7%,17m
3361,1,[ChAuTr]Sanga,4013,126,4,6,10,40.0%,24m
3361,1,Anastasia,4013,46,1,5,6,16.7%,12m
3361,1,Kimo,4013,0,0,1,1,0.0%,12m
3366,1,[EMMMMM]Erin,4012,1285,62,57,119,52.1%,25m
3366,1,OmegaStar,4012,1016,32,33,65,49.2%,13m
3366,1,bunny,4012,243,9,1,10,90.0%,16m
3366,1,Caz,4012,94,2,7,9,22.2%,9m
3370,1,[iX]TuneTrigger,4011,2049,453,442,895,50.6%,16m
3370,1,KillhaBee,4011,1983,397,372,769,51.6%,9m
3370,1,pingEling,4011,287,14,5,19,73.7%,12m
3370,1,Enthalpy,4011,140,4,4,8,50.0%,2m
3370,1,Monor,4011,0,0,1,1,0.0%,24m
3370,1,Enigma,4011,0,0,1,1,0.0%,16m
3376,1,Blind,4010,1732,210,204,414,50.7%,13m
3376,1,[MeDuS]Valdas,4010,1374,97,53,150,64.7%,9m
3376,1,[AoTu]Evolver,4010,145,4,0,4,100.0%,16m
3376,1,SlayersBoxer,4010,136,3,0,3,100.0%,23m
3380,1,[FSeS]Bertman,4009,46,2,5,7,28.6%,4m
3380,1,Tom,4009,0,0,6,6,0.0%,13m
3382,1,soultekeur,4008,1250,43,26,69,62.3%,5m
3382,1,[Caus]Armhulebusk,4008,0,0,1,1,0.0%,9m
3384,1,[ManB]surculus,4007,1934,342,228,570,60.0%,6m
3384,1,Deus,4007,1263,69,55,124,55.6%,10m
3384,1,[PŖïMĄŁ]GgMaChine,4007,1307,58,41,99,58.6%,13m
3384,1,urgz,4007,1714,54,51,105,51.4%,2m
3384,1,[SLD]GeneralBlack,4007,315,11,18,29,37.9%,6m
3384,1,PKT,4007,152,4,0,4,100.0%,5m
3384,1,[Serral]deep,4007,46,1,2,3,33.3%,7m
3384,1,[NMF]jeff,4007,48,1,4,5,20.0%,14m
3384,2,[Hаsu]Makunouchi,4007,0,0,2,2,0.0%,25m
3393,1,NanatoScop,4006,677,60,39,99,60.6%,14m
3393,1,[0Head]SmurfGranate,4006,1178,51,30,81,63.0%,9m
3393,1,[PŖïMĄŁ]ÐęŚŢŖùÇŢîØN,4006,552,14,13,27,51.9%,24m
3393,1,Unsainted,4006,472,12,10,22,54.5%,2m
3393,1,ShinyCoin,4006,48,2,7,9,22.2%,9m
3393,1,[LSPs]Bloody,4006,0,1,0,1,100.0%,18m
3393,1,[CFeS]BraveDuke,4006,0,1,1,2,50.0%,14m
3400,1,Kalevi,4005,672,30,27,57,52.6%,13m
3400,1,[LandP]LordFekalos,4005,182,4,9,13,30.8%,11m
3400,1,abcdefghijkl,4005,94,2,18,20,10.0%,2m
3400,1,TriangleTom,4005,0,1,0,1,100.0%,8m
3404,1,Jabadabadu,4004,1976,236,224,460,51.3%,23m
3404,1,[duсks]Mimicrid,4004,1197,201,209,410,49.0%,12m
3404,1,lSatol,4004,761,40,39,79,50.6%,12m
3404,3,[ZERGML]Seva,4004,376,28,47,75,37.3%,6m
3404,3,llllllllllll,4004,60,3,7,10,30.0%,7m
3404,1,Alexclusive,4004,0,1,1,2,50.0%,12m
3404,1,BatKinG,4004,94,1,1,2,50.0%,11m
3411,3,[RBlood]Galactus,4003,1868,251,263,514,48.8%,12m
3411,1,BobKelso,4003,892,49,34,83,59.0%,8m
3411,1,[HMarch]nightstar,4003,789,28,20,48,58.3%,6m
3411,1,[BjC]lamens,4003,433,21,9,30,70.0%,23m
3411,1,ChaseLorD,4003,452,10,12,22,45.5%,12m
3411,1,[PiGPan]Nopret,4003,244,6,3,9,66.7%,9m
3411,1,XiaoXiao,4003,42,1,2,3,33.3%,2m
3411,1,Obama,4003,0,0,1,1,0.0%,14m
3419,1,NikitaSmall,4002,1856,151,151,302,50.0%,7m
3419,1,Falken,4002,1588,127,95,222,57.2%,24m
3419,1,THERIPPER,4002,1417,47,38,85,55.3%,16m
3419,1,WonkySpecs,4002,1110,40,32,72,55.6%,24m
3419,2,[CivW]Willsoon,4002,139,3,3,6,50.0%,7m
3419,1,IIIIIIIIIIII,4002,92,2,9,11,18.2%,3m
3419,1,[eli]girlgamerxD,4002,0,0,1,1,0.0%,13m
3419,1,Lorewalker,4002,0,0,1,1,0.0%,11m
3419,3,llllllllllll,4002,0,0,2,2,0.0%,14m
3428,1,AnTi,4001,1559,52,47,99,52.5%,16m
3428,1,[PandaT]Zechodian,4001,826,20,25,45,44.4%,12m
3428,1,NightAngel,4001,544,18,18,36,50.0%,2m
3428,1,[AciNoN]TheLite,4001,408,10,11,21,47.6%,24m
3428,1,laksonen,4001,48,2,2,4,50.0%,25m
3428,1,[TFSC]Wormms,4001,0,1,0,1,100.0%,18m
3428,1,[BRSKR]Rainier,4001,46,1,1,2,50.0%,2m
3428,1,Heather,4001,48,1,2,3,33.3%,14m
3428,3,Oblivion,4001,0,0,1,1,0.0%,10m
3437,1,[Dobro]KINE,4000,1827,61,70,131,46.6%,12m
3437,1,PatchTerran,4000,0,1,1,2,50.0%,2m
3437,1,Vilma,4000,48,1,2,3,33.3%,7m
3437,1,[AISC]PinkBlood,4000,30,1,3,4,25.0%,15m
3441,1,fucboinugget,3999,1044,446,423,869,51.3%,2m
3441,1,AbbaOCTO,3999,432,11,7,18,61.1%,3m
3441,1,dArkskY,3999,184,5,5,10,50.0%,5m
3441,1,[Maddox]Lege,3999,138,3,4,7,42.9%,15m
3441,1,[opFaiL]danischu,3999,0,1,0,1,100.0%,4m
3441,1,Fredwinge,3999,0,1,0,1,100.0%,4m
3441,1,[ICGl]ProPaine,3999,48,1,2,3,33.3%,2m
3441,3,ogogo,3999,0,0,2,2,0.0%,10m
3449,3,ljootQln,3998,1884,556,601,1157,48.1%,9m
3449,1,Xenocide,3998,1715,279,267,546,51.1%,13m
3449,1,[Itami]Demesus,3998,955,197,183,380,51.8%,12m
3449,1,[BRSKR]WizardCat,3998,1262,145,135,280,51.8%,4m
3449,1,UncleRuckus,3998,731,30,23,53,56.6%,18m
3449,1,Ociffer,3998,0,0,2,2,0.0%,24m
3455,1,[EBF]Fake,3997,1282,68,60,128,53.1%,11m
3455,1,[SGEY]Асхат,3997,1380,51,42,93,54.8%,9m
3455,1,Flapoon,3997,368,16,6,22,72.7%,24m
3455,1,GAGARIN,3997,534,15,13,28,53.6%,17m
3455,1,Player,3997,638,15,19,34,44.1%,25m
3455,1,DVVvilla,3997,0,0,1,1,0.0%,16m
3461,1,[FlyFkr]Zhorliz,3996,2036,304,297,601,50.6%,24m
3461,1,Mietron,3996,1928,138,142,280,49.3%,4m
3461,1,Juliàn,3996,665,33,16,49,67.3%,6m
3461,1,Leni,3996,218,5,4,9,55.6%,17m
3461,1,[XDN]FlyWing,3996,46,2,0,2,100.0%,7m
3466,1,zlrka,3995,1146,159,139,298,53.4%,7m
3466,3,llllllllllll,3995,1716,149,155,304,49.0%,17m
3466,1,Darkshogun,3995,1310,93,91,184,50.5%,9m
3466,1,Eintopf,3995,320,8,12,20,40.0%,17m
3466,1,KEKW,3995,314,7,5,12,58.3%,23m
3466,1,[TFSC]CitronVert,3995,0,1,0,1,100.0%,24m
3466,1,OloNLO,3995,46,1,2,3,33.3%,24m
3466,2,IIIIIIIIIIII,3995,0,0,1,1,0.0%,9m
3474,1,SeverusSimp,3994,1287,166,164,330,50.3%,4m
3475,1,PiggieSmalls,3993,1105,146,126,272,53.7%,5m
3475,1,DespoT,3993,1235,82,60,142,57.7%,10m
3475,1,IIlllIIllI,3993,1115,56,34,90,62.2%,25m
3475,1,Xares,3993,436,23,11,34,67.6%,9m
3475,1,[PÂRłAH]Hexed,3993,377,17,7,24,70.8%,2m
3475,1,Mithr,3993,586,13,13,26,50.0%,17m
3475,1,[OXs]Hyppox,3993,382,8,8,16,50.0%,12m
3475,1,Tnglrk,3993,140,4,9,13,30.8%,17m
3475,1,BUHmax,3993,0,1,1,2,50.0%,13m
3484,1,[Mikii]catharsis,3992,1232,221,195,416,53.1%,6m
3484,1,Kanto,3992,92,1,1,2,50.0%,26m
3486,1,[TSNM]Thyraya,3991,1857,272,257,529,51.4%,14m
3486,1,FaiLo,3991,682,23,13,36,63.9%,7m
3486,1,[DisES]Squall,3991,0,2,7,9,22.2%,13m
3486,3,[WFS]Berdorel,3991,30,1,1,2,50.0%,23m
3486,1,Eäril,3991,0,0,1,1,0.0%,5m
3486,3,Yadon,3991,0,0,1,1,0.0%,9m
3486,1,tedydeluxe,3991,0,0,3,3,0.0%,24m
3493,1,FunkyPants,3990,1292,60,39,99,60.6%,9m
3493,1,Stefan,3990,1302,34,35,69,49.3%,14m
3493,1,[Dobro]FARD,3990,316,6,6,12,50.0%,9m
3493,1,Clx,3990,140,4,5,9,44.4%,13m
3493,1,[DooM]Creator,3990,0,0,2,2,0.0%,2m
3498,1,Takeiteasy,3989,1035,63,50,113,55.8%,6m
3498,1,KirillVolkov,3989,1343,60,38,98,61.2%,14m
3498,1,[BoJeuu]aDiBoO,3989,1345,43,45,88,48.9%,10m
3498,1,ПтицаЛятун,3989,564,14,16,30,46.7%,25m
3498,1,[VFish]sebesdes,3989,175,5,1,6,83.3%,26m
3498,1,Onoes,3989,90,5,4,9,55.6%,6m
3498,1,[dumbfu]WetFartosis,3989,0,1,1,2,50.0%,9m
3498,1,[NetGG]BadTerran,3989,46,1,3,4,25.0%,24m
3506,1,Lapeno,3988,1576,140,131,271,51.7%,25m
3506,1,IIIIIIIIIIII,3988,469,17,9,26,65.4%,11m
3506,1,quietMADman,3988,417,14,8,22,63.6%,25m
3506,1,WolfReaper,3988,0,1,2,3,33.3%,25m
3510,1,[HBGSJR]Bayash,3987,1903,85,77,162,52.5%,12m
3510,1,[SSCT]ChipsTERROR,3987,698,18,17,35,51.4%,16m
3510,1,SignuM,3987,175,12,0,12,100.0%,23m
3510,1,ARTOFBOXING,3987,361,12,7,19,63.2%,9m
3510,1,SkIoASarkan,3987,235,10,2,12,83.3%,25m
3510,1,koffman,3987,108,2,2,4,50.0%,9m
3510,1,Odin,3987,0,0,1,1,0.0%,26m
3510,1,ZiZiR,3987,0,0,1,1,0.0%,8m
3518,1,[Sarmat]Tomstar,3986,274,6,10,16,37.5%,12m
3518,1,Contempt,3986,138,4,9,13,30.8%,23m
3518,2,[BRSKR]mmcalum,3986,0,1,0,1,100.0%,10m
3518,1,[TFÀG]STARKKRAFT,3986,0,0,3,3,0.0%,23m
3522,1,Prioception,3985,2001,613,620,1233,49.7%,2m
3522,1,ChOsenOne,3985,1090,132,135,267,49.4%,2m
3522,1,Rash,3985,2020,119,100,219,54.3%,16m
3522,1,[JS]bubiyascha,3985,1661,52,43,95,54.7%,15m
3522,1,Tucky,3985,200,21,7,28,75.0%,10m
3522,1,WeakMe,3985,106,2,1,3,66.7%,2m
3522,1,TheHitman,3985,0,1,5,6,16.7%,15m
3529,1,Behnrow,3984,2056,368,341,709,51.9%,26m
3529,1,radulable,3984,2023,209,204,413,50.6%,12m
3529,1,[АDV]CraZyPinGuiN,3984,1711,144,132,276,52.2%,16m
3529,1,Achilles,3984,1468,62,38,100,62.0%,9m
3529,1,[HBGS]GladiaThor,3984,1043,31,41,72,43.1%,7m
3529,1,[DraLo]WizarD,3984,140,3,5,8,37.5%,24m
3529,1,aoteman,3984,0,1,0,1,100.0%,26m
3536,1,RuXeR,3983,1397,50,45,95,52.6%,12m
3536,1,hypnotoad,3983,780,36,21,57,63.2%,7m
3536,1,saru,3983,308,14,5,19,73.7%,26m
3536,1,[iksD]SeptimusReyt,3983,445,9,9,18,50.0%,2m
3536,1,SOFII,3983,46,1,4,5,20.0%,25m
3536,1,[NNK]Kabanos,3983,0,0,1,1,0.0%,3m
3542,1,Kranon,3982,1483,156,145,301,51.8%,16m
3542,1,Shahmatist,3982,1991,130,129,259,50.2%,9m
3542,1,PoWeR,3982,238,86,78,164,52.4%,17m
3542,1,Jagger,3982,1229,73,74,147,49.7%,23m
3542,1,Droco,3982,996,65,34,99,65.7%,2m
3542,1,Genoob,3982,209,7,3,10,70.0%,14m
3542,1,Nukular,3982,140,3,5,8,37.5%,24m
3542,1,[GoldM]Pain,3982,92,2,0,2,100.0%,6m
3542,1,[ØC5]dad,3982,0,1,7,8,12.5%,2m
3542,3,[Kicx]SymraynoR,3982,0,0,1,1,0.0%,24m
3552,1,Goorg,3981,1975,142,143,285,49.8%,9m
3552,3,MarcellDavis,3981,171,5,1,6,83.3%,12m
3552,1,[PaniC]BigBoss,3981,92,2,0,2,100.0%,7m
3552,1,[NewLR]GrishaHit,3981,0,2,1,3,66.7%,24m
3556,1,[Brotha]filduz,3980,2049,1237,1238,2475,50.0%,17m
3556,1,ReconkinG,3980,1746,289,298,587,49.2%,12m
3556,1,[HypC]TheSun,3980,1203,55,51,106,51.9%,25m
3556,1,Rohrox,3980,138,2,2,4,50.0%,5m
3556,1,blackhole,3980,0,0,4,4,0.0%,16m
3561,3,IIIIIIIIIIII,3979,851,163,181,344,47.4%,10m
3561,1,ToadSage,3979,1695,68,53,121,56.2%,7m
3561,1,[GTD]xyCz,3979,998,41,36,77,53.2%,11m
3561,1,[Ahegаo]ElonMaks,3979,205,7,3,10,70.0%,14m
3561,1,Biodude,3979,0,1,0,1,100.0%,9m
3561,1,[Oath]BlackRider,3979,0,0,1,1,0.0%,12m
3561,1,YanioZ,3979,0,0,2,2,0.0%,25m
3568,1,UShouldScout,3978,1126,165,169,334,49.4%,12m
3568,1,Method,3978,1407,57,36,93,61.3%,9m
3568,1,[tMnrd]Flockster,3978,1188,29,44,73,39.7%,10m
3568,1,KupaTrupa,3978,46,1,3,4,25.0%,24m
3568,1,MuChe,3978,0,0,1,1,0.0%,23m
3573,1,[szaft]KisCica,3977,1547,162,146,308,52.6%,2m
3573,1,NoMicro,3977,1573,108,48,156,69.2%,25m
3573,1,ZergSucks,3977,838,50,22,72,69.4%,6m
3573,3,[D0N3]LordMaJuDraK,3977,97,2,1,3,66.7%,18m
3573,1,CrAzYApE,3977,0,1,0,1,100.0%,16m
3573,1,BestNameEver,3977,0,0,1,1,0.0%,11m
3573,1,OPmarine,3977,0,0,1,1,0.0%,5m
3580,1,GrUvi,3976,495,44,23,67,65.7%,5m
3580,1,Sky,3976,124,4,0,4,100.0%,16m
3580,1,[HP4Fun]Clementine,3976,92,3,4,7,42.9%,2m
3580,1,[НТТ]Mangaka,3976,0,1,0,1,100.0%,12m
3580,1,[ЯD]Florujin,3976,92,1,1,2,50.0%,13m
3585,1,Canoa,3975,1563,274,246,520,52.7%,14m
3585,1,Elfigus,3975,1787,255,249,504,50.6%,24m
3585,1,EstebanOcon,3975,1858,107,89,196,54.6%,26m
3585,1,lulianito,3975,1263,58,38,96,60.4%,16m
3585,1,[PioC]Gouda,3975,1197,40,40,80,50.0%,24m
3585,1,BananKing,3975,275,21,12,33,63.6%,12m
3585,1,[GBoys]KingLui,3975,562,12,28,40,30.0%,8m
3585,1,[iX]holden,3975,368,9,10,19,47.4%,5m
3585,1,Lupes,3975,186,5,5,10,50.0%,24m
3585,1,SoleSurvivor,3975,98,3,0,3,100.0%,2m
3585,1,Midgard,3975,0,0,1,1,0.0%,12m
3585,3,StanFrey,3975,0,0,5,5,0.0%,23m
3597,1,[Graps]Gimme,3974,736,35,19,54,64.8%,24m
3597,1,[Siеge]Doyla,3974,143,6,0,6,100.0%,24m
3597,1,Carabobium,3974,92,1,1,2,50.0%,24m
3597,1,Henkk,3974,0,1,2,3,33.3%,2m
3597,1,BeamBoom,3974,0,0,6,6,0.0%,13m
3602,1,mrBochasCze,3973,2045,254,232,486,52.3%,26m
3602,1,RunGen,3973,2019,109,112,221,49.3%,2m
3602,1,[WBO]Parabelitano,3973,632,31,17,48,64.6%,5m
3602,1,[AiRǂ]OnePatchMan,3973,368,12,7,19,63.2%,23m
3602,1,louvirilou,3973,318,7,13,20,35.0%,24m
3602,1,DoMino,3973,245,6,6,12,50.0%,8m
3602,1,[Trains]AngelaMerkel,3973,0,1,2,3,33.3%,23m
3602,2,Ventias,3973,0,0,1,1,0.0%,8m
3602,2,epicnoob,3973,0,0,1,1,0.0%,10m
3611,1,MacroPlayer,3972,1933,177,150,327,54.1%,16m
3611,1,Fremen,3972,307,22,15,37,59.5%,17m
3611,1,WinterinG,3972,444,15,15,30,50.0%,16m
3611,1,[eMpRC]zodiaK,3972,274,7,11,18,38.9%,13m
3611,1,Tony,3972,182,6,4,10,60.0%,5m
3611,2,[C84]skiLLet,3972,0,1,0,1,100.0%,13m
3617,1,Komisola,3971,1992,216,190,406,53.2%,15m
3617,2,Haru,3971,778,51,3,54,94.4%,11m
3617,1,[GoldM]Molten,3971,137,2,2,4,50.0%,13m
3617,2,bxjh,3971,0,0,1,1,0.0%,7m
3621,1,self,3970,1775,219,205,424,51.7%,7m
3621,1,[RеG]Rostok,3970,1921,108,89,197,54.8%,26m
3621,1,[TheDOH]Andromeda,3970,914,29,34,63,46.0%,3m
3621,1,llllllllllll,3970,928,23,27,50,46.0%,26m
3621,2,Kryki,3970,473,17,14,31,54.8%,3m
3621,1,TrixXxa,3970,280,6,10,16,37.5%,12m
3627,2,[TheDOH]morel,3969,281,8,8,16,50.0%,24m
3627,1,XsReD,3969,212,7,5,12,58.3%,3m
3627,2,TROMPADEFALO,3969,72,2,1,3,66.7%,2m
3627,1,patchwerk,3969,106,2,3,5,40.0%,6m
3627,1,[MeDuS]nuotaika,3969,0,0,5,5,0.0%,26m
3627,1,[AoTu]Sentinel,3969,0,0,18,18,0.0%,24m
3633,1,[ssev]Maiheu,3968,1877,130,126,256,50.8%,23m
3633,1,Kurtis,3968,1523,110,109,219,50.2%,24m
3633,1,[6P00L]SquidFighter,3968,1239,104,107,211,49.3%,18m
3633,1,grim,3968,748,18,18,36,50.0%,26m
3633,1,skYnet,3968,242,16,4,20,80.0%,9m
3633,1,Delaam,3968,182,4,6,10,40.0%,12m
3633,2,NaRa,3968,0,1,0,1,100.0%,18m
3633,1,[DeafEu]SUCITU,3968,92,1,2,3,33.3%,16m
3641,1,[mfxed]Essu,3967,1091,44,39,83,53.0%,8m
3641,2,llllllllllll,3967,496,23,7,30,76.7%,10m
3641,1,Sakoha,3967,140,4,4,8,50.0%,12m
3641,1,LilCookie,3967,142,3,5,8,37.5%,5m
3641,2,Shogun,3967,0,0,1,1,0.0%,24m
3646,1,EmmaTWatson,3966,1907,142,115,257,55.3%,2m
3646,1,Serla,3966,1366,91,66,157,58.0%,24m
3646,1,BawsRawr,3966,341,16,11,27,59.3%,8m
3646,3,Buttsack,3966,261,14,2,16,87.5%,4m
3646,2,IIIIIIIIIIII,3966,162,5,3,8,62.5%,7m
3646,1,[Ni]FrOsty,3966,140,4,7,11,36.4%,24m
3646,2,Lex,3966,78,2,2,4,50.0%,8m
3646,2,hakkeENzage,3966,36,1,2,3,33.3%,9m
3646,2,[Shiеld]Subi,3966,0,0,1,1,0.0%,25m
3655,3,WoLf,3965,1699,306,319,625,49.0%,9m
3655,1,Cat,3965,1305,225,241,466,48.3%,4m
3655,1,[Cannоn]Stromberg,3965,778,37,39,76,48.7%,6m
3655,1,Kotvič,3965,190,5,6,11,45.5%,10m
3655,2,[KøF]Finalys,3965,0,3,2,5,60.0%,2m
3655,1,YELLOWCAR,3965,82,3,5,8,37.5%,7m
3655,2,RememberMe,3965,0,0,1,1,0.0%,9m
3655,2,fepnatchy,3965,0,0,1,1,0.0%,7m
3663,1,Seifer,3964,1991,104,100,204,51.0%,12m
3663,1,[rages]Avedis,3964,1063,41,35,76,53.9%,2m
3663,1,IIIIIIIIIII,3964,1308,33,44,77,42.9%,15m
3663,1,[LESeV]iceclaw,3964,1176,30,30,60,50.0%,12m
3663,1,Tabasco,3964,885,26,21,47,55.3%,25m
3663,2,[WeYuCo]rtRvani,3964,687,25,24,49,51.0%,6m
3663,1,SlayersMMA,3964,734,17,30,47,36.2%,8m
3663,2,llllllllllll,3964,172,6,3,9,66.7%,24m
3663,1,[LTPX]Xantoky,3964,97,1,2,3,33.3%,15m
3672,3,[PÂRłAH]Advocaat,3963,216,21,45,66,31.8%,7m
3672,1,AdAstra,3963,245,9,3,12,75.0%,23m
3672,3,DarkNoobik,3963,30,2,0,2,100.0%,10m
3672,2,Smorkin,3963,0,0,1,1,0.0%,4m
3672,1,[TheDOH]secretspace,3963,0,0,2,2,0.0%,17m
3677,1,versus,3962,907,38,28,66,57.6%,2m
3677,1,[BrlghT]Light,3962,110,3,1,4,75.0%,7m
3677,1,LeRollier,3962,0,0,6,6,0.0%,24m
3680,1,llllllllllll,3961,1555,109,115,224,48.7%,3m
3680,1,MysteryL,3961,886,58,55,113,51.3%,6m
3680,2,LiquidClem,3961,289,15,2,17,88.2%,11m
3680,2,PPBOI,3961,290,15,3,18,83.3%,26m
3680,1,[PÂRłAH]Heli,3961,438,10,14,24,41.7%,26m
3680,2,[Hаsu]Encelad,3961,0,0,1,1,0.0%,25m
3686,1,[Rofler]Life,3960,1499,67,56,123,54.5%,9m
3686,1,[Lambro]IBA,3960,1270,57,42,99,57.6%,16m
3686,1,[RBP3]Vladoman,3960,1275,38,37,75,50.7%,26m
3686,1,Kurokushka,3960,309,7,8,15,46.7%,16m
3686,1,Marchj,3960,276,7,13,20,35.0%,26m
3686,1,[MkersA]Tiwie,3960,226,5,5,10,50.0%,26m
3686,3,JulyZerg,3960,0,1,0,1,100.0%,13m
3686,2,Penguiner,3960,0,1,4,5,20.0%,17m
3694,1,ArturPirojkv,3959,326,7,15,22,31.8%,24m
3694,3,JohnRambo,3959,58,6,3,9,66.7%,2m
3694,2,CestMOI,3959,0,1,0,1,100.0%,27m
3694,2,Solonik,3959,0,0,1,1,0.0%,7m
3698,2,ByD,3957,278,10,4,14,71.4%,26m
3698,1,PAIN,3957,227,6,6,12,50.0%,10m
3698,2,Rod,3957,0,1,0,1,100.0%,27m
3701,1,[EZDUNK]ChthoniC,3956,1110,88,52,140,62.9%,6m
3701,1,[Skunks]seNex,3956,140,4,10,14,28.6%,12m
3703,1,Sacatar,3955,1508,79,77,156,50.6%,24m
3703,1,ZeroRa,3955,696,16,35,51,31.4%,24m
3703,1,zrhzhth,3955,241,12,3,15,80.0%,9m
3703,3,Hook,3955,60,4,6,10,40.0%,1m
3703,1,[zecher]vAder,3955,94,3,7,10,30.0%,24m
3703,2,[IÐŠI]snadge,3955,0,1,0,1,100.0%,25m
3709,1,TittyTwister,3954,1304,34,42,76,44.7%,3m
3709,2,[ØC]Inkisiteur,3954,162,5,2,7,71.4%,15m
3709,2,leached,3954,0,0,1,1,0.0%,13m
3712,1,[PŖïMĄŁ]Exit,3953,1998,68,68,136,50.0%,7m
3712,2,uThermal,3953,188,10,0,10,100.0%,18m
3712,1,[TGCrew]Dae,3953,140,3,6,9,33.3%,2m
3712,1,Ghost,3953,46,1,6,7,14.3%,3m
3712,2,[TheDOH]Executioner,3953,0,0,3,3,0.0%,6m
3712,1,Leejo,3953,0,0,6,6,0.0%,15m
3718,1,JackyLeMat,3952,1460,134,125,259,51.7%,24m
3718,1,[OrPix]derHase,3952,1502,90,82,172,52.3%,24m
3718,1,TiKoz,3952,1162,30,40,70,42.9%,6m
3718,1,Negharzul,3952,606,25,14,39,64.1%,2m
3718,2,Lohikäärme,3952,38,2,0,2,100.0%,11m
3718,1,JeanMax,3952,92,2,8,10,20.0%,15m
3718,1,xEREk,3952,0,1,1,2,50.0%,24m
3725,1,NaRa,3951,1697,241,226,467,51.6%,8m
3725,1,[NOCW]Saph,3951,1984,166,167,333,49.8%,8m
3725,1,Noisym,3951,676,85,80,165,51.5%,15m
3725,1,[3MD]SuppLyPowEr,3951,1425,84,42,126,66.7%,16m
3725,1,voodoomagic,3951,1010,29,32,61,47.5%,8m
3725,1,OOOOOOOOOOOO,3951,719,20,18,38,52.6%,17m
3725,2,Freesky,3951,498,19,9,28,67.9%,9m
3725,1,chicho,3951,605,18,14,32,56.2%,2m
3725,2,Gigantiops,3951,78,2,2,4,50.0%,5m
3725,2,Tramadillo,3951,0,0,2,2,0.0%,24m
3735,2,Latex,3950,278,14,2,16,87.5%,25m
3735,1,[YoKai]BabyByeBye,3950,94,2,13,15,13.3%,2m
3735,2,[CocoCo]Jaedolph,3950,0,1,0,1,100.0%,16m
3738,1,Abstemious,3949,1653,229,238,467,49.0%,2m
3738,2,[llIlkI]WarRieR,3949,1190,100,82,182,54.9%,1m
3738,2,Brazko,3949,1178,73,58,131,55.7%,8m
3738,1,IIIIIIIIIIII,3949,910,31,39,70,44.3%,15m
3738,2,Dingus,3949,38,2,1,3,66.7%,5m
3738,1,Recon,3949,109,2,4,6,33.3%,23m
3738,1,[kitiM]sja,3949,0,1,4,5,20.0%,24m
3738,1,Sinus,3949,0,0,4,4,0.0%,24m
3746,1,[xDMWx]Grolg,3948,970,27,29,56,48.2%,2m
3746,1,[Ovrrtd]Alexander,3948,924,22,28,50,44.0%,15m
3746,1,[SpaceB]LoneStar,3948,446,11,13,24,45.8%,12m
3746,2,FABRIZOU,3948,0,1,1,2,50.0%,10m
3746,2,RzuggiG,3948,36,1,2,3,33.3%,26m
3746,1,Senjo,3948,0,0,3,3,0.0%,2m
3752,1,Happy,3947,1174,35,30,65,53.8%,24m
3752,1,crepe,3947,588,13,20,33,39.4%,4m
3752,1,[TheDOH]Dain,3947,322,8,14,22,36.4%,12m
3752,1,yaRus,3947,130,4,2,6,66.7%,24m
3752,1,Resuu,3947,0,1,2,3,33.3%,24m
3752,2,[Removе]Countdown,3947,34,1,2,3,33.3%,18m
3758,1,[Фаталя]Uzbek,3946,862,34,25,59,57.6%,16m
3758,2,[SUTDA]ssibalnom,3946,78,3,2,5,60.0%,24m
3760,2,iNterferoN,3945,638,23,18,41,56.1%,3m
3760,2,[RBlood]Hakan,3945,274,9,6,15,60.0%,6m
3760,2,[CoBro]Calcifer,3945,126,5,2,7,71.4%,11m
3760,2,Тор,3945,0,0,1,1,0.0%,2m
3760,1,[RSK]Chocolatine,3945,0,0,3,3,0.0%,3m
3760,1,Curryking,3945,0,0,4,4,0.0%,26m
3766,2,IIIIIIIIII,3944,851,33,16,49,67.3%,6m
3766,2,[I1I1I1]Barcode,3944,196,10,7,17,58.8%,24m
3766,1,IIIIIIIIIIII,3944,438,10,14,24,41.7%,12m
3766,2,[dDb]Halalkött,3944,0,0,2,2,0.0%,5m
3770,1,[ZBL]RoiDa,3943,562,14,16,30,46.7%,7m
3770,1,TheKiss,3943,533,13,19,32,40.6%,3m
3770,2,pOKo,3943,132,6,8,14,42.9%,6m
3770,2,ArchAngel,3943,0,1,0,1,100.0%,2m
3770,2,[Split]Joker,3943,36,1,2,3,33.3%,10m
3775,1,Kosmatiy,3942,1941,56,61,117,47.9%,5m
3775,2,llllllllllll,3942,273,14,2,16,87.5%,25m
3777,1,[VoiDTS]Robola,3941,311,11,11,22,50.0%,2m
3777,2,Theloopa,3941,182,5,4,9,55.6%,23m
3777,2,HwaSin,3941,0,0,1,1,0.0%,10m
3780,1,CaroleBaskin,3940,1985,100,104,204,49.0%,12m
3780,2,IIIIIIIIIIII,3940,1275,79,48,127,62.2%,7m
3780,1,NAURA,3940,179,9,8,17,52.9%,6m
3780,2,[SBǂ]Crookef,3940,32,2,0,2,100.0%,9m
3780,2,[LPELO]MrEffect,3940,0,0,1,1,0.0%,25m
3785,2,DrunkenByun,3939,0,5,0,5,100.0%,5m
3785,2,lllllllll,3939,0,1,0,1,100.0%,7m
3787,1,Babb,3938,1929,224,230,454,49.3%,7m
3787,1,Sanedude,3938,1932,177,174,351,50.4%,26m
3787,1,[RAB]Terranathor,3938,1414,56,59,115,48.7%,15m
3787,1,Teecon,3938,1263,52,42,94,55.3%,16m
3787,1,WannaBeAce,3938,850,43,34,77,55.8%,15m
3792,1,[EmScTv]Emil,3937,1306,80,82,162,49.4%,12m
3792,1,NaKeDman,3937,734,27,32,59,45.8%,12m
3792,2,Kerio,3937,550,19,13,32,59.4%,24m
3792,2,Quad,3937,502,17,13,30,56.7%,27m
3792,2,lllllIIIIll,3937,253,10,2,12,83.3%,5m
3792,3,Zera,3937,0,1,0,1,100.0%,16m
3792,2,Mish,3937,0,1,0,1,100.0%,15m
3792,1,[ØC]AzZix,3937,0,1,5,6,16.7%,13m
3800,3,[QTclub]Viewtiful,3936,511,259,269,528,49.1%,12m
3800,1,Roktan,3936,1870,100,93,193,51.8%,10m
3800,2,[BRSKR]Illustrated,3936,1288,61,58,119,51.3%,13m
3800,1,OFF,3936,1647,51,59,110,46.4%,15m
3800,1,hookazone,3936,308,14,18,32,43.8%,6m
3800,1,General,3936,388,12,10,22,54.5%,6m
3800,2,[J4S]Machinator,3936,225,12,15,27,44.4%,26m
3800,1,SunnyRush,3936,175,8,4,12,66.7%,3m
3808,1,[RеG]Stak,3935,718,32,33,65,49.2%,17m
3808,1,[Heet]assnibbler,3935,628,28,20,48,58.3%,5m
3808,1,NeverCheese,3935,622,15,22,37,40.5%,5m
3808,3,[GXalpH]Lemon,3935,216,11,2,13,84.6%,16m
3808,1,Ruffy,3935,182,4,8,12,33.3%,24m
3808,1,[WoG]ZaiKo,3935,92,2,5,7,28.6%,16m
3808,2,anakiouss,3935,0,0,1,1,0.0%,13m
3808,1,Chadoboy,3935,0,0,2,2,0.0%,10m
3816,1,Busia,3934,493,13,14,27,48.1%,24m
3816,1,Buccaneer,3934,48,1,5,6,16.7%,2m
3818,2,Ryder,3933,1021,50,26,76,65.8%,14m
3818,2,Cim,3933,276,10,7,17,58.8%,17m
3818,2,Myers,3933,34,2,1,3,66.7%,6m
3821,1,Alucard,3932,257,15,5,20,75.0%,5m
3821,1,jean,3932,287,9,10,19,47.4%,18m
3821,1,Derek,3932,92,3,5,8,37.5%,9m
3821,2,IIIIIIIIIIII,3932,0,1,0,1,100.0%,8m
3825,1,[boomer]Ady,3931,1967,253,268,521,48.6%,4m
3825,1,dapan,3931,659,66,54,120,55.0%,26m
3825,2,Barristan,3931,359,16,6,22,72.7%,6m
3825,2,Relax,3931,0,1,1,2,50.0%,27m
3829,3,Plebking,3930,659,214,244,458,46.7%,26m
3829,2,Qwan,3930,1229,83,68,151,55.0%,23m
3829,2,FabzG,3930,535,31,30,61,50.8%,6m
3829,1,[MSUSC2]Hentos,3930,779,21,19,40,52.5%,2m
3829,2,nvq,3930,568,19,17,36,52.8%,8m
3829,1,[FxL]Genti,3930,658,15,28,43,34.9%,24m
3829,2,CPP,3930,300,10,7,17,58.8%,14m
3829,1,[RBP3]kOliO,3930,312,7,12,19,36.8%,11m
3829,2,Darwin,3930,110,3,4,7,42.9%,27m
3838,1,[DarKwi]BOBAH,3929,1896,290,276,566,51.2%,16m
3838,1,DayTeezy,3929,447,155,125,280,55.4%,24m
3838,1,[BornG]MCauthon,3929,848,74,55,129,57.4%,5m
3838,2,KTsTYTY,3929,292,15,3,18,83.3%,7m
3838,1,[ERaven]ĐēåŦħƘƞȋǥḥŦ,3929,402,10,14,24,41.7%,11m
3838,2,[PnP]Azamato,3929,0,0,1,1,0.0%,7m
3844,1,[RCMM]poukilou,3928,1807,142,146,288,49.3%,9m
3844,2,Dibbs,3928,1672,96,67,163,58.9%,6m
3844,1,[VFN]Sonny,3928,754,51,49,100,51.0%,10m
3844,1,Boban,3928,371,12,16,28,42.9%,12m
3844,2,Bryguy,3928,254,7,7,14,50.0%,18m
3849,2,Kräuterork,3927,838,124,94,218,56.9%,17m
3849,1,Qlaimax,3927,1120,93,72,165,56.4%,11m
3849,2,[GoldM]Sparkyy,3927,622,23,13,36,63.9%,4m
3849,1,PoWeRMuLe,3927,94,2,10,12,16.7%,7m
3849,2,maru,3927,0,1,0,1,100.0%,15m
3854,1,LAPLACE,3926,1905,201,180,381,52.8%,16m
3854,1,Dezaxe,3926,1659,131,109,240,54.6%,8m
3854,2,LonelyBoy,3926,1217,79,24,103,76.7%,23m
3854,1,[STАR]PlatOK,3926,586,17,20,37,45.9%,2m
3854,2,JEBAĆDISA,3926,298,9,7,16,56.2%,23m
3854,3,Amnesia,3926,0,4,1,5,80.0%,3m
3854,1,WChampByuN,3926,46,2,5,7,28.6%,5m
3854,2,[TopUSA]Zerg,3926,36,1,4,5,20.0%,26m
3862,2,[ZCrew]turtle,3925,1683,159,113,272,58.5%,2m
3862,2,[Hаsu]cheets,3925,628,31,29,60,51.7%,15m
3862,2,[XxKxA]Mizukia,3925,760,27,23,50,54.0%,3m
3862,2,burp,3925,254,13,3,16,81.2%,13m
3862,2,Devas,3925,76,2,2,4,50.0%,3m
3862,3,JustForFun,3925,0,2,3,5,40.0%,14m
3862,2,Milcho,3925,0,0,1,1,0.0%,27m
3862,2,[SeRik]SeBs,3925,0,0,2,2,0.0%,6m
3862,2,Soulsalesman,3925,0,0,2,2,0.0%,25m
3871,3,manulorc,3924,1485,620,623,1243,49.9%,17m
3872,2,Beleive,3923,928,35,33,68,51.5%,9m
3872,2,Cybernight,3923,136,3,4,7,42.9%,11m
3872,1,OiWatson,3923,92,1,3,4,25.0%,25m
3875,1,Rambo,3922,1912,499,508,1007,49.6%,12m
3875,1,SCMVP,3922,1129,58,42,100,58.0%,9m
3875,2,deepcik,3922,332,11,10,21,52.4%,14m
3875,2,[TYDROP]IVIusheenBOI,3922,174,5,6,11,45.5%,25m
3875,1,[сSсǃ]anioki,3922,228,5,9,14,35.7%,23m
3875,2,[owouwu]LogicSystem,3922,38,1,1,2,50.0%,13m
3875,1,IIIIIIIIIIII,3922,46,1,6,7,14.3%,7m
3882,1,[CrøkeT]ElGropor,3921,1932,118,123,241,49.0%,2m
3882,1,[HFXX]Boosh,3921,107,3,1,4,75.0%,9m
3882,1,[HMSU]Xorda,3921,48,2,7,9,22.2%,8m
3885,1,Liftman,3920,1930,70,77,147,47.6%,11m
3885,1,LNT,3920,1356,35,43,78,44.9%,26m
3885,1,Nicole,3920,902,23,27,50,46.0%,12m
3885,1,llllllllllll,3920,412,17,14,31,54.8%,24m
3885,2,[SUFU]imbaA,3920,106,4,0,4,100.0%,25m
3885,1,[BluS]loginn,3920,203,4,8,12,33.3%,15m
3885,2,Hanako,3920,32,2,2,4,50.0%,7m
3885,3,BlackCoffee,3920,0,2,3,5,40.0%,14m
3885,2,AlexKilgur,3920,0,1,0,1,100.0%,17m
3885,2,Chefgrunzer,3920,0,0,1,1,0.0%,24m
3895,1,[BPX]Lutrax,3919,1322,137,127,264,51.9%,8m
3895,1,[MkersA]ClusterFCUK,3919,1812,84,88,172,48.8%,12m
3895,2,[NARP]Joesol,3919,1316,53,51,104,51.0%,3m
3895,1,Predators,3919,452,11,15,26,42.3%,15m
3895,2,Krass,3919,38,2,0,2,100.0%,24m
3900,1,[TDCHK]Helium,3918,1570,150,147,297,50.5%,12m
3900,1,[PubgL]Пройдоха,3918,1748,87,88,175,49.7%,8m
3900,2,Profectus,3918,1357,51,47,98,52.0%,3m
3900,1,Uniq,3918,982,42,32,74,56.8%,13m
3900,2,ƁĀŦŢŁĀĢ,3918,570,35,12,47,74.5%,11m
3900,1,Mitchowyn,3918,310,8,11,19,42.1%,17m
3900,2,BouncyBouncy,3918,155,5,7,12,41.7%,26m
3900,1,Smoerebroed,3918,186,5,13,18,27.8%,9m
3900,2,BakKutTeh,3918,0,2,2,4,50.0%,3m
3900,2,[DestFC]KiD,3918,36,1,1,2,50.0%,6m
3900,2,JimmyWopo,3918,30,1,1,2,50.0%,15m
3900,2,[Hаsu]crew,3918,0,0,1,1,0.0%,15m
3912,1,Fridja,3917,1944,157,149,306,51.3%,5m
3912,3,[FOFO]Hos,3917,86,3,4,7,42.9%,17m
3912,2,WinterWonder,3917,0,0,1,1,0.0%,27m
3912,1,[0BO]Nilius,3917,0,0,9,9,0.0%,3m
3916,1,[RMWP]Azathoth,3916,1843,379,387,766,49.5%,12m
3916,1,Zero,3916,267,64,60,124,51.6%,24m
3916,2,MAPElites,3916,629,27,15,42,64.3%,2m
3916,2,FANATICK,3916,580,24,13,37,64.9%,27m
3916,1,[OCG]mairaki,3916,484,11,19,30,36.7%,5m
3916,2,KKonaW,3916,102,3,4,7,42.9%,16m
3916,2,Leukos,3916,0,1,0,1,100.0%,16m
3916,3,[TirolA]Urono,3916,0,1,0,1,100.0%,13m
3916,2,Darkmatter,3916,34,1,3,4,25.0%,9m
3925,1,[leOS]Fistking,3915,1990,454,436,890,51.0%,24m
3925,1,BabouLeFou,3915,1970,364,373,737,49.4%,12m
3925,1,davinchi,3915,1970,263,258,521,50.5%,18m
3925,1,IiIiIiIiIiIi,3915,1963,172,194,366,47.0%,12m
3925,2,YungSally,3915,210,7,7,14,50.0%,14m
3925,3,[7x]SevenXIGG,3915,2,5,9,14,35.7%,17m
3925,2,Albert,3915,72,2,2,4,50.0%,18m
3925,3,[TExGG]laZysCv,3915,0,1,0,1,100.0%,13m
3925,2,[Li3]badcompany,3915,0,0,1,1,0.0%,9m
3925,2,Prepodavatel,3915,0,0,1,1,0.0%,15m
3935,2,Asur,3914,683,62,42,104,59.6%,6m
3935,1,helloRJ,3914,648,29,29,58,50.0%,24m
3935,2,Trump,3914,742,27,23,50,54.0%,7m
3935,2,[CCG]Kadamudi,3914,324,15,7,22,68.2%,10m
3935,1,Fitchy,3914,536,13,16,29,44.8%,18m
3935,3,[GdAT]Mabadixt,3914,213,8,1,9,88.9%,5m
3935,2,BuBBleS,3914,252,7,16,23,30.4%,24m
3935,1,Haxx,3914,272,6,15,21,28.6%,24m
3935,2,DieHard,3914,34,2,2,4,50.0%,24m
3944,1,prometheus,3913,2014,274,272,546,50.2%,8m
3944,1,llllllllllll,3913,1965,150,142,292,51.4%,8m
3944,1,[Tranc3]PirLo,3913,1379,99,102,201,49.3%,15m
3944,1,KwazyKwumble,3913,1838,69,82,151,45.7%,8m
3944,2,Freestyler,3913,1497,65,50,115,56.5%,6m
3944,3,BossMarine,3913,1106,63,91,154,40.9%,15m
3944,1,DaXxTeR,3913,502,18,14,32,56.2%,9m
3944,2,[GyCd]Alcootest,3913,356,13,13,26,50.0%,16m
3944,2,Booker,3913,164,6,5,11,54.5%,2m
3944,2,SmartRoach,3913,36,2,1,3,66.7%,2m
3944,3,JaSønGG,3913,30,2,2,4,50.0%,18m
3944,3,GhostTemplar,3913,0,0,1,1,0.0%,15m
3944,2,DaiMaDôshi,3913,0,0,1,1,0.0%,24m
3957,1,ramleren,3912,1457,173,170,343,50.4%,17m
3957,2,LORDGG,3912,879,41,34,75,54.7%,18m
3957,1,BarBeQ,3912,614,21,27,48,43.8%,13m
3957,2,Nyze,3912,415,19,10,29,65.5%,24m
3957,1,Pikachu,3912,506,13,19,32,40.6%,24m
3957,2,[Fussel]Fiboniker,3912,289,11,1,12,91.7%,5m
3957,1,NanoW,3912,92,3,5,8,37.5%,24m
3957,1,[МуDТ]BlizzHackCHK,3912,80,3,6,9,33.3%,15m
3957,2,[ICG]Brute,3912,0,1,0,1,100.0%,26m
3966,1,[EGi]MichZor,3911,1739,193,191,384,50.3%,12m
3966,2,TPxSpAnZo,3911,90,6,2,8,75.0%,3m
3966,1,[Vortx]Zurile,3911,204,6,6,12,50.0%,15m
3966,2,BaLoOzA,3911,0,1,2,3,33.3%,14m
3970,1,Marbet,3910,1732,52,56,108,48.1%,18m
3970,1,[FxL]amx,3910,1338,37,42,79,46.8%,5m
3970,1,WINNERatLIFE,3910,460,11,22,33,33.3%,15m
3970,1,InsighT,3910,233,5,7,12,41.7%,11m
3970,2,NainMaboul,3910,130,4,3,7,57.1%,25m
3970,3,[SSC2]kiborg,3910,0,3,2,5,60.0%,14m
3976,1,ToTheTop,3909,1983,191,197,388,49.2%,24m
3976,1,Truzel,3909,1346,87,85,172,50.6%,25m
3976,1,neeroo,3909,1568,59,47,106,55.7%,2m
3976,2,Cure,3909,307,11,11,22,50.0%,17m
3976,2,KANG,3909,0,0,1,1,0.0%,10m
3981,2,Potato,3908,1692,110,89,199,55.3%,25m
3981,1,Danpler,3908,872,109,120,229,47.6%,4m
3981,1,MuCheSC,3908,1040,47,30,77,61.0%,12m
3981,2,[PaniC]Losting,3908,324,10,13,23,43.5%,27m
3981,2,[LVPN]Zazar,3908,70,3,3,6,50.0%,3m
3981,2,Nelyo,3908,0,1,1,2,50.0%,11m
3987,1,Numen,3907,1599,117,115,232,50.4%,24m
3987,1,[wAi]Merlint,3907,789,36,20,56,64.3%,26m
3987,1,[ICGl]NightHawk,3907,1073,31,29,60,51.7%,25m
3987,2,ViperX,3907,66,3,4,7,42.9%,2m
3991,1,[R0K]Myst,3906,761,56,56,112,50.0%,24m
3991,1,KonCha,3906,1383,55,39,94,58.5%,8m
3991,2,Ronny,3906,469,20,13,33,60.6%,11m
3991,1,SkyLie,3906,380,17,11,28,60.7%,5m
3991,2,ANTIZ,3906,448,15,13,28,53.6%,26m
3991,1,Grivious,3906,499,15,19,34,44.1%,2m
3991,2,AffroKrull,3906,288,9,8,17,52.9%,14m
3991,2,IIIIIIIIIIII,3906,70,2,2,4,50.0%,6m
3991,2,WAR,3906,0,0,1,1,0.0%,26m
4000,1,Hazzelnut,3905,1709,79,82,161,49.1%,15m
4000,1,[SLD]Eisdieler,3905,829,22,26,48,45.8%,15m
4000,2,Nobody,3905,514,18,17,35,51.4%,25m
4000,2,DUKICH,3905,0,0,1,1,0.0%,6m
4004,1,[Clocks]Euphoria,3904,1978,209,207,416,50.2%,2m
4004,1,llllllllllll,3904,1947,148,137,285,51.9%,26m
4004,1,arrr,3904,1964,93,95,188,49.5%,3m
4004,2,[PLA2N]XomkaTY,3904,1239,89,78,167,53.3%,17m
4004,1,Peter,3904,866,34,47,81,42.0%,18m
4004,1,NorDerot,3904,662,26,37,63,41.3%,2m
4004,1,[QTclub]Leifur,3904,476,23,20,43,53.5%,8m
4004,1,[Hybr1d]ADG,3904,682,16,20,36,44.4%,15m
4004,2,Stereophobia,3904,38,4,2,6,66.7%,5m
4013,1,GeeeeeeZa,3903,1963,306,316,622,49.2%,12m
4013,3,Seriovsky,3903,97,3,4,7,42.9%,24m
4013,2,IIIIIIIIIIII,3903,62,2,2,4,50.0%,14m
4013,2,Blead,3903,0,1,0,1,100.0%,7m
4013,2,OneBaseNydus,3903,0,0,2,2,0.0%,27m
4018,2,lllllllll,3902,1463,144,138,282,51.1%,14m
4018,1,MystiK,3902,1185,94,78,172,54.7%,24m
4018,1,[HLORDS]LardHelmchen,3902,1555,78,91,169,46.2%,4m
4018,1,choji,3902,1010,73,80,153,47.7%,18m
4018,1,GrosserBauer,3902,950,24,28,52,46.2%,5m
4018,1,[НТТ]dEspAiR,3902,470,17,11,28,60.7%,8m
4018,1,Nodus,3902,471,16,14,30,53.3%,24m
4018,2,kekboi,3902,70,3,1,4,75.0%,6m
4018,2,[WaNt3D]WurSTsemmel,3902,0,1,0,1,100.0%,24m
4027,1,Absolem,3901,1773,235,243,478,49.2%,26m
4027,2,[AKALLA]Nyrek,3901,0,0,1,1,0.0%,2m
4029,2,Tank,3900,350,14,13,27,51.9%,16m
4029,2,Headshooter,3900,217,12,9,21,57.1%,25m
4029,1,[Co19]MiracleRogue,3900,318,8,16,24,33.3%,12m
4029,2,Sparkster,3900,0,1,0,1,100.0%,11m
4029,2,BilboZeRabit,3900,0,1,0,1,100.0%,6m
4034,2,[TV]CobraTV,3899,1487,87,80,167,52.1%,3m
4034,2,[STFUNB]stehorz,3899,1663,80,67,147,54.4%,11m
4034,1,[HBGSJR]Smasher,3899,1042,47,33,80,58.8%,24m
4034,2,conspiracy,3899,578,26,13,39,66.7%,16m
4034,2,SaberAthena,3899,467,21,18,39,53.8%,16m
4034,2,[KDV]Jarczyk,3899,244,9,5,14,64.3%,25m
4034,2,[Blacer]Cobra,3899,38,1,4,5,20.0%,16m
4041,2,Persephone,3898,1357,129,125,254,50.8%,9m
4041,1,Gwenegan,3898,957,37,39,76,48.7%,25m
4041,2,CptProtoss,3898,0,0,1,1,0.0%,6m
4041,1,Вёртолёт,3898,0,0,7,7,0.0%,7m
4045,1,Syocto,3897,1808,303,312,615,49.3%,2m
4045,1,Weytley,3897,1805,126,123,249,50.6%,3m
4045,2,Howie,3897,1560,124,118,242,51.2%,24m
4045,2,llllllllllll,3897,828,47,32,79,59.5%,14m
4045,2,Yugo,3897,670,34,34,68,50.0%,27m
4045,2,[сSсǃ]icygeo,3897,736,32,11,43,74.4%,17m
4045,2,ElPueblo,3897,34,6,0,6,100.0%,23m
4045,2,[TFS1]EBoy,3897,146,4,8,12,33.3%,6m
4045,2,caulknbawlz,3897,72,2,5,7,28.6%,16m
4054,2,[GoldM]Carbine,3896,592,21,18,39,53.8%,17m
4054,2,Dreams,3896,74,2,4,6,33.3%,11m
4054,3,Predator,3896,0,2,4,6,33.3%,12m
4054,2,Noice,3896,36,1,1,2,50.0%,23m
4054,1,[RBP3]WaRaX,3896,0,1,7,8,12.5%,9m
4059,1,Invictus,3895,1347,42,49,91,46.2%,13m
4059,1,Berg,3895,442,10,12,22,45.5%,12m
4059,3,[GueZ]Frunobulax,3895,121,4,3,7,57.1%,4m
4059,2,IceWallOComb,3895,38,2,1,3,66.7%,24m
4059,2,[Waterr]ÆÆÆÆsmugÆÆÆÆ,3895,0,0,1,1,0.0%,16m
4059,2,Jolatis,3895,0,0,1,1,0.0%,5m
4059,3,Rakete,3895,0,0,4,4,0.0%,24m
4066,2,[MvN]Maxfab,3894,1520,90,84,174,51.7%,16m
4066,2,TheBest,3894,1135,55,18,73,75.3%,7m
4066,2,[PИD]Clydefrog,3894,931,53,42,95,55.8%,12m
4066,2,qpNAMTACS,3894,862,37,25,62,59.7%,10m
4066,2,Stijn,3894,833,32,27,59,54.2%,16m
4066,2,Deltasque,3894,52,3,0,3,100.0%,14m
4072,2,llllllllllll,3893,160,9,0,9,100.0%,9m
4072,2,Nka,3893,170,6,5,11,54.5%,23m
4072,2,oppresticles,3893,0,1,0,1,100.0%,17m
4072,2,[GŁ]Klimha,3893,0,0,3,3,0.0%,6m
4072,1,[K0mpis]numberJ,3893,0,0,8,8,0.0%,8m
4077,1,[D0N3]sal,3892,1946,215,204,419,51.3%,15m
4077,1,TFN,3892,1598,147,111,258,57.0%,16m
4077,2,Zindigard,3892,0,1,0,1,100.0%,2m
4077,1,Happa,3892,30,1,7,8,12.5%,4m
4077,3,[aW]darox,3892,0,0,1,1,0.0%,16m
4077,1,BOOOOOOOOOOO,3892,0,0,5,5,0.0%,24m
4083,1,Tiger,3891,1840,260,265,525,49.5%,24m
4083,1,Pirdiens,3891,1524,159,153,312,51.0%,2m
4083,1,Rrokan,3891,1783,108,110,218,49.5%,12m
4083,1,Halo,3891,1684,88,68,156,56.4%,9m
4083,1,[NoGy]Nova,3891,1627,83,102,185,44.9%,6m
4083,2,Instinct,3891,520,24,3,27,88.9%,14m
4083,2,[GBMǂ]KFColossGBM,3891,184,5,9,14,35.7%,23m
4090,1,ChicCo,3890,1953,251,226,477,52.6%,10m
4090,2,СТАРКРАФТЕР,3890,338,15,7,22,68.2%,6m
4090,2,[TAW]storakles,3890,0,1,0,1,100.0%,24m
4090,2,Flongwairs,3890,0,1,0,1,100.0%,10m
4090,2,IlIlIllI,3890,0,1,1,2,50.0%,24m
4090,2,PblHeXoD,3890,0,0,1,1,0.0%,3m
4096,1,HoPpleR,3889,1959,176,173,349,50.4%,13m
4096,1,[STFUNB]Anonymouse,3889,1946,145,146,291,49.8%,5m
4096,1,llllllllllll,3889,619,33,16,49,67.3%,7m
4096,1,bNd,3889,505,16,30,46,34.8%,2m
4096,1,Smarty,3889,134,3,9,12,25.0%,13m
4096,2,cFrost,3889,0,0,1,1,0.0%,15m
4102,1,[SonAsg]JarlTorstein,3888,1857,83,84,167,49.7%,2m
4102,1,Benbaz,3888,1798,54,59,113,47.8%,12m
4102,2,princeps,3888,598,40,27,67,59.7%,14m
4102,2,SumTingWong,3888,380,30,32,62,48.4%,23m
4102,2,[InBri]AlGor,3888,696,27,20,47,57.4%,7m
4102,2,JIMSY,3888,164,5,7,12,41.7%,9m
4102,2,KiNGOfBaTs,3888,130,4,2,6,66.7%,6m
4102,2,Fade,3888,36,2,1,3,66.7%,7m
4102,2,[TSTG]Nahtlos,3888,34,1,1,2,50.0%,18m
4102,2,DavideUP,3888,38,1,3,4,25.0%,14m
4102,2,[XianYu]ChaosY,3888,0,0,1,1,0.0%,14m
4102,2,[MaChOe]LeMarketeur,3888,0,0,2,2,0.0%,11m
4114,1,[HFR]Avek,3887,1712,111,108,219,50.7%,10m
4114,1,[AISC]CluEleSs,3887,1931,79,83,162,48.8%,26m
4114,2,IIIIIIIIIIII,3887,1535,67,48,115,58.3%,10m
4114,2,SamSepiol,3887,186,10,1,11,90.9%,27m
4114,2,sTeF,3887,0,3,2,5,60.0%,27m
4114,2,[FOX]Jakilau,3887,34,1,1,2,50.0%,25m
4120,1,Drovosek,3886,1962,501,489,990,50.6%,11m
4120,2,LittlePrick,3886,1629,221,204,425,52.0%,27m
4120,1,[SLMJAM]Crofty,3886,1693,202,194,396,51.0%,16m
4120,2,Deis,3886,1631,88,64,152,57.9%,13m
4120,1,Lobster,3886,1042,43,35,78,55.1%,10m
4120,2,[BRSKR]KingVulture,3886,256,10,4,14,71.4%,6m
4120,2,GoGrillU,3886,0,1,0,1,100.0%,6m
4120,3,ShyGhost,3886,0,0,1,1,0.0%,17m
4128,1,[BornG]Rook,3885,412,9,22,31,29.0%,4m
4128,2,[wedown]Maru,3885,133,7,2,9,77.8%,23m
4128,2,[QTclub]snoW,3885,0,0,2,2,0.0%,25m
4131,1,lllllllllll,3884,1865,74,90,164,45.1%,2m
4131,1,[OCL]Sig,3884,461,13,20,33,39.4%,12m
4131,2,AryaStark,3884,154,5,3,8,62.5%,24m
4131,2,Kys,3884,166,4,6,10,40.0%,2m
4131,2,BarCode,3884,0,0,5,5,0.0%,27m
4136,2,AlDor,3883,1553,133,124,257,51.8%,25m
4136,2,Skeng,3883,696,26,28,54,48.1%,15m
4136,2,Solo,3883,202,14,11,25,56.0%,12m
4136,1,llllllllllll,3883,0,5,0,5,100.0%,6m
4136,2,Mizu,3883,96,3,2,5,60.0%,15m
4136,2,[MoonR]astrodroid,3883,0,0,1,1,0.0%,9m
4136,2,[MSUSC2]Vadkrarr,3883,0,0,2,2,0.0%,17m
4143,1,LOKI,3882,270,7,15,22,31.8%,2m
4143,2,SuperPants,3882,102,4,4,8,50.0%,3m
4143,2,narri,3882,0,0,2,2,0.0%,14m
4146,2,Alaine,3881,1656,160,137,297,53.9%,5m
4146,2,Fredlol,3881,378,19,8,27,70.4%,24m
4146,1,Indi,3881,286,13,19,32,40.6%,6m
4146,2,DuTuMirNix,3881,64,3,1,4,75.0%,6m
4146,2,ApOsTaTe,3881,0,0,1,1,0.0%,11m
4151,2,Oqulist,3880,907,134,125,259,51.7%,14m
4151,1,NoPasarán,3880,1747,94,111,205,45.9%,24m
4151,2,MonkeyDisco,3880,1183,83,64,147,56.5%,15m
4151,1,Wolfy,3880,1676,68,62,130,52.3%,12m
4151,2,flapiyo,3880,290,11,5,16,68.8%,16m
4151,2,GypsyRoFatXD,3880,0,1,0,1,100.0%,14m
4151,2,Dolskin,3880,36,1,3,4,25.0%,6m
4151,2,[dAce]Sockisen,3880,0,0,1,1,0.0%,2m
4151,2,Bumblebee,3880,0,0,1,1,0.0%,12m
4160,1,Ice,3879,1466,166,137,303,54.8%,3m
4160,2,Jamish,3879,1666,88,67,155,56.8%,23m
4160,2,scoutyx,3879,468,20,19,39,51.3%,5m
4160,2,Cube,3879,156,6,0,6,100.0%,13m
4160,2,AnimaL,3879,0,1,0,1,100.0%,16m
4160,3,notgood,3879,97,1,1,2,50.0%,4m
4160,2,[WCGtop]SenFx,3879,0,1,2,3,33.3%,7m
4167,1,[ShNice]IIIIIIIIIIII,3878,1479,121,128,249,48.6%,15m
4167,2,Delirhom,3878,656,27,13,40,67.5%,16m
4167,1,Technique,3878,466,23,12,35,65.7%,15m
4167,2,PSF,3878,0,1,0,1,100.0%,11m
4167,2,[Hrr]MyHero,3878,36,1,1,2,50.0%,6m
4167,2,[KHrsn]Saures,3878,0,0,1,1,0.0%,2m
4173,2,Wackyiraqi,3877,1474,126,113,239,52.7%,3m
4173,1,Qshon,3877,1405,79,76,155,51.0%,26m
4173,1,[MeIina]UndeadGirl,3877,1930,61,73,134,45.5%,15m
4173,1,BadMICROBe,3877,828,32,32,64,50.0%,24m
4173,1,[0nFirе]cawa,3877,742,20,24,44,45.5%,8m
4173,1,Jetix,3877,417,17,28,45,37.8%,6m
4173,3,[xTZRx]NastyPear,3877,0,0,1,1,0.0%,3m
4180,1,[laVsl]IIIGGGxIII,3876,1946,97,101,198,49.0%,15m
4180,2,Marypoppins,3876,669,70,62,132,53.0%,5m
4180,1,[kB5]jambon,3876,1247,48,50,98,49.0%,12m
4180,2,ManofSTEEL,3876,383,25,18,43,58.1%,6m
4180,1,vilbrii,3876,575,24,16,40,60.0%,24m
4180,2,HJM,3876,360,12,12,24,50.0%,18m
4180,2,[TAW]HenpeT,3876,138,4,8,12,33.3%,24m
4180,2,Anosan,3876,0,0,1,1,0.0%,25m
4188,2,rob,3875,878,41,27,68,60.3%,10m
4188,2,DarKraii,3875,528,22,6,28,78.6%,9m
4188,2,llllllllllll,3875,371,17,5,22,77.3%,7m
4188,2,[MST]hanswurst,3875,30,1,3,4,25.0%,7m
4188,2,Thugsta,3875,0,0,1,1,0.0%,16m
4188,2,littlr,3875,0,0,3,3,0.0%,17m
4188,2,contrast,3875,0,0,3,3,0.0%,3m
4195,2,llllllllllll,3874,202,16,7,23,69.6%,17m
4195,2,Gatsbu,3874,458,16,12,28,57.1%,7m
4195,2,[KDV]GoLdEnLioN,3874,318,11,11,22,50.0%,6m
4195,2,CrappyCoco,3874,177,9,7,16,56.2%,3m
4195,1,[GELSEN]Masaru,3874,138,2,7,9,22.2%,12m
4195,2,AKIMITSU,3874,0,0,1,1,0.0%,3m
4201,1,Afterlife,3873,1954,302,319,621,48.6%,13m
4201,1,WolFi,3873,1029,116,117,233,49.8%,26m
4201,1,NiceOne,3873,1211,35,38,73,47.9%,5m
4201,1,llllllllllll,3873,1019,28,36,64,43.8%,12m
4201,1,[SL]pebriniel,3873,372,9,22,31,29.0%,6m
4201,3,[myLT]Avalon,3873,0,1,0,1,100.0%,11m
4201,2,iTzfLicK,3873,0,1,0,1,100.0%,25m
4201,2,IlIlIlIlIlIl,3873,0,1,1,2,50.0%,12m
4201,2,[Zguege]naincraft,3873,0,0,1,1,0.0%,23m
4201,2,DarK,3873,0,0,2,2,0.0%,5m
4211,2,[RеG]Anonymously,3872,1107,107,92,199,53.8%,8m
4211,2,avpauleu,3872,1470,103,94,197,52.3%,2m
4211,1,LennartNL,3872,1242,100,91,191,52.4%,15m
4211,1,TiredMarine,3872,1040,36,44,80,45.0%,15m
4211,2,HIERARCH,3872,632,27,11,38,71.1%,14m
4211,1,OpeL,3872,478,22,11,33,66.7%,6m
4211,1,[ICGl]Simba,3872,660,16,31,47,34.0%,8m
4211,3,snama,3872,166,9,0,9,100.0%,12m
4211,2,shtopr,3872,238,9,4,13,69.2%,6m
4211,1,[418]MachineHead,3872,222,5,11,16,31.2%,18m
4211,2,[Zelos]Zersandet,3872,74,3,3,6,50.0%,24m
4211,2,silun,3872,0,1,0,1,100.0%,6m
4211,2,[IPW]NiceBiT,3872,0,1,4,5,20.0%,25m
4224,2,[DZTK]hoppla,3871,854,56,42,98,57.1%,17m
4224,2,KweiTeow,3871,32,3,4,7,42.9%,5m
4224,2,[SY2G]mouton,3871,30,2,0,2,100.0%,23m
4224,2,DrOOpy,3871,0,1,4,5,20.0%,12m
4224,2,Maybe,3871,0,0,1,1,0.0%,11m
4224,2,[EZDUNK]CHADMARINE,3871,0,0,2,2,0.0%,14m
4230,2,MicroGG,3870,1325,69,28,97,71.1%,23m
4230,1,Mando,3870,1316,49,56,105,46.7%,24m
4230,2,[sngy]DarkSlider,3870,0,0,1,1,0.0%,23m
4233,1,ShzbtRitual,3869,1117,67,59,126,53.2%,15m
4233,2,PotatoKing,3869,222,12,5,17,70.6%,25m
4233,2,Prestige,3869,0,2,3,5,40.0%,10m
4236,1,LetaL,3868,1937,153,160,313,48.9%,8m
4236,1,MrMustasch,3868,818,107,104,211,50.7%,8m
4236,1,[CzMz]Wettis,3868,1174,32,47,79,40.5%,3m
4236,3,[lMMl]Herbefa,3868,305,14,3,17,82.4%,14m
4236,2,AzazEl,3868,104,4,5,9,44.4%,27m
4241,1,[Wolven]sehriyar,3867,1943,241,253,494,48.8%,12m
4241,1,tArenzsé,3867,1789,64,66,130,49.2%,2m
4241,3,Nature,3867,700,47,75,122,38.5%,7m
4241,2,Falcon,3867,554,26,11,37,70.3%,17m
4245,2,[TMLT]LateNuke,3866,1272,47,45,92,51.1%,16m
4245,2,raaf,3866,541,22,18,40,55.0%,6m
4245,2,[DONKEY]Hastati,3866,324,16,5,21,76.2%,11m
4245,1,BlackAnubis,3866,546,12,22,34,35.3%,5m
4245,1,[0Dfeat]Probe,3866,284,7,10,17,41.2%,8m
4250,1,Insomnium,3865,1340,74,72,146,50.7%,12m
4251,1,[Ф2]ИмбаТерран,3864,1919,76,86,162,46.9%,15m
4251,3,llllllllllll,3864,90,4,3,7,57.1%,16m
4251,2,Bummsjordy,3864,0,0,2,2,0.0%,6m
4254,1,[mod]Korpsy,3863,989,39,33,72,54.2%,12m
4254,3,[lDil]Artcore,3863,196,8,5,13,61.5%,23m
4254,2,Anlot,3863,192,7,5,12,58.3%,27m
4254,2,[bitoQ2]charlix,3863,66,2,3,5,40.0%,24m
4254,2,[PTSL]Starscream,3863,0,0,1,1,0.0%,6m
4259,1,[tMnrd]Toffee,3862,1869,77,93,170,45.3%,7m
4259,1,[isMVP]Drew,3862,1091,60,63,123,48.8%,15m
4259,2,[GGxC]TreeStump,3862,348,17,5,22,77.3%,16m
4259,2,[PŖïMĄŁ]Euron,3862,188,7,5,12,58.3%,11m
4259,2,[TheDOH]BaumesBaum,3862,150,6,3,9,66.7%,17m
4259,2,JoeBiden,3862,132,4,5,9,44.4%,7m
4259,2,Kaileen,3862,62,2,2,4,50.0%,3m
4259,2,[BornG]HiIamPi,3862,72,2,6,8,25.0%,26m
4259,2,[Arrows]oWneDge,3862,0,0,1,1,0.0%,25m
4268,1,MacLambert,3861,1701,197,210,407,48.4%,7m
4268,1,[K0mpis]PantFlaska,3861,520,19,24,43,44.2%,6m
4268,2,ArtifacT,3861,261,11,4,15,73.3%,12m
4268,1,Winraven,3861,0,1,5,6,16.7%,12m
4272,1,FunkyDragon,3860,1799,228,219,447,51.0%,9m
4272,2,Puti,3860,809,83,70,153,54.2%,25m
4272,2,IIIIIIIIII,3860,330,13,5,18,72.2%,12m
4272,2,Pacer,3860,228,8,8,16,50.0%,2m
4272,1,Timreiner,3860,314,8,15,23,34.8%,12m
4272,2,[YMB]Arzann,3860,70,3,2,5,60.0%,14m
4278,2,Slavianin,3859,1639,139,132,271,51.3%,6m
4278,2,athila,3859,1575,68,58,126,54.0%,9m
4278,1,[4Everr]ateapotist,3859,886,40,48,88,45.5%,6m
4278,2,NOD,3859,898,36,25,61,59.0%,16m
4278,2,DrunkJoule,3859,224,13,4,17,76.5%,6m
4278,2,TomatoHate,3859,310,10,16,26,38.5%,5m
4278,2,DrMobius,3859,100,4,2,6,66.7%,6m
4278,2,Fredde,3859,0,1,4,5,20.0%,5m
4286,2,TerranPatch,3858,714,26,24,50,52.0%,24m
4286,2,[ezboy]CNMGBprotoss,3858,80,4,0,4,100.0%,9m
4286,1,NettoCity,3858,186,4,13,17,23.5%,25m
4286,2,[STED]Izaya,3858,0,0,1,1,0.0%,10m
4290,2,[SpCI]ReDBuL,3857,1402,145,132,277,52.3%,14m
4290,2,[ǂVVVǂ]TakeMid,3857,438,40,37,77,51.9%,17m
4290,2,TDK,3857,70,2,5,7,28.6%,17m
4290,2,Autonigerrr,3857,0,1,0,1,100.0%,7m
4290,2,LostToZerg,3857,0,0,1,1,0.0%,25m
4295,2,Cardilogy,3856,1615,188,184,372,50.5%,5m
4295,2,[1202]LucaRamon,3856,1617,76,78,154,49.4%,23m
4295,2,Pain,3856,1014,62,29,91,68.1%,24m
4295,1,OmaDesala,3856,963,30,28,58,51.7%,12m
4295,3,Souila,3856,184,13,4,17,76.5%,5m
4295,2,superhero,3856,92,4,1,5,80.0%,5m
4295,2,Vylania,3856,64,3,3,6,50.0%,5m
4295,2,[oniz]Rorsers,3856,32,2,2,4,50.0%,2m
4303,1,NihonGo,3855,1951,296,295,591,50.1%,5m
4303,2,lohgff,3855,361,15,11,26,57.7%,6m
4303,2,[AoTu]happydrops,3855,214,10,1,11,90.9%,11m
4303,3,[K0mpis]HawkingS,3855,30,2,1,3,66.7%,11m
4307,2,Turtana,3854,32,1,1,2,50.0%,18m
4307,2,Compass,3854,30,1,2,3,33.3%,6m
4309,1,Drewsie,3853,1943,352,363,715,49.2%,6m
4309,1,KJP,3853,1926,241,245,486,49.6%,11m
4309,2,Ben,3853,1648,128,125,253,50.6%,2m
4309,1,[Yoli]ets,3853,1555,107,120,227,47.1%,4m
4309,2,[SaviOr]GhostMaster,3853,856,34,23,57,59.6%,15m
4309,2,SpaceCowboy,3853,358,12,13,25,48.0%,14m
4309,1,[HsDL]TheCrow,3853,174,4,13,17,23.5%,10m
4309,3,JUSTKILLER,3853,30,1,1,2,50.0%,23m
4309,2,[SCTR]LimeTime,3853,36,1,2,3,33.3%,27m
4309,2,[FrF]NoeeeeeeD,3853,0,0,1,1,0.0%,11m
4309,2,TerranStorm,3853,0,0,2,2,0.0%,18m
4320,3,Legionaru,3852,1842,292,309,601,48.6%,17m
4320,2,Agravein,3852,1050,185,179,364,50.8%,27m
4320,2,æææ,3852,340,11,11,22,50.0%,16m
4320,2,BaKaA,3852,66,2,2,4,50.0%,16m
4320,2,LongHaKoh,3852,0,1,3,4,25.0%,6m
4325,2,[НОД17]SuMmeR,3851,694,52,36,88,59.1%,6m
4325,1,[tutuut]Buggis,3851,222,6,12,18,33.3%,15m
4325,2,Ardu,3851,0,0,1,1,0.0%,12m
4325,2,[maƒia]Rammbock,3851,0,0,5,5,0.0%,10m
4329,1,Schuster,3850,1852,90,111,201,44.8%,3m
4329,2,[SNKN]PhoneticsPro,3850,1112,58,50,108,53.7%,6m
4329,2,[aW]darkpouet,3850,738,52,49,101,51.5%,6m
4329,1,dNdR,3850,1135,48,34,82,58.5%,2m
4329,1,[AuInc]Valerie,3850,728,19,25,44,43.2%,6m
4329,1,thisServerEz,3850,0,2,1,3,66.7%,5m
4329,2,[ЕМPIRE]InSTALINg,3850,68,2,7,9,22.2%,12m
4329,2,Leinax,3850,0,1,1,2,50.0%,2m
4329,2,[Kicx]Ste,3850,0,0,1,1,0.0%,9m
4338,2,Begemot,3849,1636,360,359,719,50.1%,6m
4338,2,[Dobro]RubRub,3849,1012,39,31,70,55.7%,26m
4338,2,Logo,3849,406,19,9,28,67.9%,5m
4338,2,JasonU,3849,436,18,5,23,78.3%,6m
4338,2,Rewind,3849,36,2,3,5,40.0%,23m
4343,2,IceWind,3848,1580,62,55,117,53.0%,3m
4343,2,[VFN]Exodus,3848,565,25,28,53,47.2%,17m
4343,2,ultomato,3848,620,21,24,45,46.7%,15m
4343,2,[bitoQ2]Sazzaro,3848,489,18,14,32,56.2%,25m
4343,2,Awkward,3848,118,4,3,7,57.1%,2m
4343,3,IIIIIIIIIIII,3848,30,1,7,8,12.5%,17m
4343,2,Quasimodo,3848,0,0,1,1,0.0%,25m
4343,3,[RеG]MARU,3848,0,0,1,1,0.0%,24m
4351,2,[TedB]LazyRusBear,3847,242,9,5,14,64.3%,25m
4351,2,[lDil]Hemlock,3847,198,7,10,17,41.2%,15m
4351,2,Gnoll,3847,0,1,0,1,100.0%,9m
4351,2,IIIIIIIIIIII,3847,0,1,0,1,100.0%,6m
4351,2,AkkaNation,3847,0,0,2,2,0.0%,8m
4356,2,ACDC,3846,1648,515,499,1014,50.8%,17m
4356,1,merrrls,3846,1912,71,74,145,49.0%,3m
4356,1,[ZelF]BrotherFlame,3846,805,24,35,59,40.7%,7m
4356,2,[PŖïMĄŁ]LUKITREK,3846,74,3,3,6,50.0%,16m
4356,2,BananaStand,3846,0,0,1,1,0.0%,23m
4361,3,SonOfMaru,3845,1434,169,174,343,49.3%,16m
4361,2,[ZBL]DrBanshee,3845,970,146,131,277,52.7%,7m
4361,2,[KoyBee]McButtFace,3845,787,50,57,107,46.7%,26m
4361,1,[AntC]Tesil,3845,1560,50,59,109,45.9%,3m
4361,1,[12rak]Cob,3845,814,28,35,63,44.4%,12m
4361,2,FeloSentient,3845,692,26,20,46,56.5%,10m
4361,2,[ОВOЩ]Player,3845,430,14,12,26,53.8%,25m
4361,2,[TeamNV]Maru,3845,160,6,3,9,66.7%,26m
4361,2,[KyG]TEDDY,3845,0,0,1,1,0.0%,6m
4370,2,[RBP3]Medox,3844,1157,52,43,95,54.7%,24m
4370,2,[ZЕRGTV]Qwan,3844,400,14,10,24,58.3%,8m
4370,2,TeamRocket,3844,288,13,6,19,68.4%,18m
4370,1,Kabooom,3844,516,12,16,28,42.9%,5m
4370,2,Explosion,3844,38,1,1,2,50.0%,17m
4370,2,Fedak,3844,0,0,2,2,0.0%,8m
4370,2,[PGR]JeanSweeping,3844,0,0,4,4,0.0%,18m
4377,2,WARTANK,3843,1127,94,79,173,54.3%,18m
4377,1,KaaRYN,3843,443,23,24,47,48.9%,12m
4377,2,Ozen,3843,285,21,3,24,87.5%,6m
4377,3,IngSoc,3843,169,4,2,6,66.7%,25m
4377,2,Ruffy,3843,108,4,6,10,40.0%,23m
4377,2,[Mo0o]ReefCake,3843,32,2,0,2,100.0%,10m
4377,2,[1ndica]StOnEd,3843,0,0,5,5,0.0%,27m
4384,1,Wouane,3842,1473,102,99,201,50.7%,13m
4384,2,aLive,3842,356,12,10,22,54.5%,6m
4384,2,hotte,3842,72,3,3,6,50.0%,7m
4384,2,aDri,3842,30,2,0,2,100.0%,14m
4384,2,[0BO]threepio,3842,30,2,1,3,66.7%,15m
4389,1,[TSC]Claudy,3841,1846,117,118,235,49.8%,3m
4389,2,JmenFou,3841,1500,66,36,102,64.7%,5m
4389,3,NightElf,3841,167,4,2,6,66.7%,18m
4389,2,[GWuH]GosuGoich,3841,62,3,4,7,42.9%,16m
4393,2,[Based]Karstico,3840,1163,136,121,257,52.9%,5m
4393,1,rex,3840,1814,103,111,214,48.1%,10m
4393,1,Haluc,3840,568,14,22,36,38.9%,24m
4393,2,lolx,3840,296,10,14,24,41.7%,6m
4393,2,[TSVB]Nesquik,3840,202,7,11,18,38.9%,26m
4393,2,[D7P]Ekitai,3840,158,6,5,11,54.5%,17m
4393,3,AlcoMarine,3840,171,6,5,11,54.5%,15m
4393,3,Rubbisher,3840,30,2,1,3,66.7%,3m
4393,2,MikeJohnson,3840,32,1,6,7,14.3%,10m
4393,2,UltraViolet,3840,0,0,1,1,0.0%,7m
4393,2,MrElusive,3840,0,0,1,1,0.0%,6m
4393,1,FǂAbo,3840,0,0,5,5,0.0%,15m
4405,2,[WNTR]DurumKeftaXL,3839,723,63,61,124,50.8%,17m
4405,2,[Hybrid]ledeboss,3839,1106,42,39,81,51.9%,11m
4405,2,[59APM]Debashir,3839,192,13,10,23,56.5%,14m
4405,2,mthebike,3839,128,4,8,12,33.3%,7m
4405,2,Toastie,3839,60,2,3,5,40.0%,3m
4410,1,theprodiGy,3838,1934,273,268,541,50.5%,7m
4410,1,[RealEG]LeoS,3838,976,24,37,61,39.3%,10m
4410,2,[GZerO]Luther,3838,68,2,3,5,40.0%,17m
4410,2,Herzog,3838,0,1,0,1,100.0%,23m
4414,2,[TWDs]DrSommer,3837,1280,80,73,153,52.3%,25m
4414,2,rOoSter,3837,678,34,32,66,51.5%,6m
4414,2,Ebrithil,3837,604,22,20,42,52.4%,8m
4414,2,JMK,3837,438,15,18,33,45.5%,17m
4414,2,[ohSL]Nussschale,3837,32,1,2,3,33.3%,15m
4414,2,SnipeFive,3837,0,0,1,1,0.0%,26m
4420,2,Aehnn,3836,1619,82,80,162,50.6%,12m
4420,1,[Ptyc]CryptacZolid,3836,1508,45,57,102,44.1%,2m
4420,2,Lanfe,3836,295,24,18,42,57.1%,18m
4420,2,DinDomino,3836,115,4,7,11,36.4%,16m
4420,2,[Hplts]HarDDD,3836,32,1,7,8,12.5%,3m
4425,2,ZERGisAMOVE,3835,1636,146,134,280,52.1%,16m
4425,2,BLACKki,3835,1575,123,127,250,49.2%,5m
4425,2,BennYouioui,3835,1148,98,75,173,56.6%,6m
4425,2,Blackjack,3835,404,18,11,29,62.1%,6m
4425,2,Rotface,3835,0,5,0,5,100.0%,25m
4425,2,[lightt]light,3835,94,4,1,5,80.0%,15m
4425,2,[DrGNT]DRAGONPIOU,3835,0,0,1,1,0.0%,2m
4432,2,Epitaphe,3834,1576,111,107,218,50.9%,6m
4432,1,[Ex0n]Cellsidus,3834,905,33,28,61,54.1%,8m
4432,2,[ZERGML]Melu,3834,288,10,11,21,47.6%,25m
4432,2,[XIICCC]iLikeRules,3834,160,8,1,9,88.9%,6m
4432,3,bobabomber,3834,30,6,3,9,66.7%,3m
4432,3,Cyclone,3834,165,6,3,9,66.7%,2m
4432,2,dnbs,3834,30,1,1,2,50.0%,3m
4432,3,LazyGuy,3834,30,1,4,5,20.0%,13m
4432,3,[WoPe]Torumon,3834,0,0,1,1,0.0%,17m
4432,2,GatewayMan,3834,0,0,1,1,0.0%,26m
4442,2,NovaTerran,3833,1390,90,89,179,50.3%,24m
4442,2,VeniVidiVici,3833,313,20,25,45,44.4%,27m
4442,2,SâM,3833,330,11,11,22,50.0%,5m
4442,1,[fam1ly]PapaCountry,3833,260,6,13,19,31.6%,6m
4442,2,[Wø]Aicha,3833,30,1,8,9,11.1%,11m
4442,2,RexJYong,3833,0,0,1,1,0.0%,27m
4448,2,[WYG]drynix,3832,1503,96,85,181,53.0%,7m
4448,2,iamEXIT,3832,313,16,4,20,80.0%,13m
4448,2,Seldon,3832,30,4,2,6,66.7%,7m
4448,1,[HayCe]Mazicho,3832,46,1,10,11,9.1%,2m
4448,3,Arabacha,3832,0,0,1,1,0.0%,24m
4453,2,пес,3831,1003,89,77,166,53.6%,10m
4453,1,[MBK]Mikami,3831,1452,78,70,148,52.7%,2m
4453,1,fissureX,3831,1149,51,36,87,58.6%,15m
4453,2,TENDER,3831,58,3,0,3,100.0%,7m
4453,2,[FxL]Beramus,3831,0,0,5,5,0.0%,8m
4458,1,juustokalle,3830,240,10,20,30,33.3%,18m
4458,2,IceDalek,3830,0,0,2,2,0.0%,7m
4458,2,Magic,3830,0,0,3,3,0.0%,17m
4461,1,[ЯD]Mono,3829,1919,466,454,920,50.7%,16m
4461,1,ALbatarD,3829,1068,49,70,119,41.2%,10m
4461,2,Manta,3829,872,40,26,66,60.6%,26m
4461,2,nghtMaRe,3829,136,4,7,11,36.4%,18m
4461,2,[RPQ]akinator,3829,0,0,1,1,0.0%,15m
4461,2,Sommelo,3829,0,0,1,1,0.0%,4m
4467,2,Pechka,3828,1017,178,166,344,51.7%,26m
4467,1,[aW]RRR,3828,1326,91,83,174,52.3%,12m
4467,2,WilgeforZ,3828,729,35,17,52,67.3%,7m
4467,2,DAzer,3828,365,18,7,25,72.0%,5m
4467,2,[FxL]Slake,3828,424,15,15,30,50.0%,18m
4467,2,[UlaS]WannaBeZEST,3828,232,9,4,13,69.2%,27m
4467,3,KaLyPso,3828,142,8,0,8,100.0%,6m
4467,2,Counterparts,3828,144,8,0,8,100.0%,4m
4467,3,NeOfAcE,3828,144,8,9,17,47.1%,4m
4467,1,IIIIIIIIIIII,3828,312,7,16,23,30.4%,24m
4467,3,[36484]ŔRRŘÕÒÖØÓØØƠ,3828,10,5,21,26,19.2%,2m
4467,3,Kerthek,3828,123,3,1,4,75.0%,5m
4467,2,monte,3828,110,3,6,9,33.3%,17m
4467,2,[BornG]CLP,3828,0,1,3,4,25.0%,12m
4481,1,HushHush,3827,1409,106,90,196,54.1%,24m
4481,2,DeadInside,3827,997,98,65,163,60.1%,16m
4481,1,[BlaDia]granitor,3827,1326,45,60,105,42.9%,25m
4481,2,Relaxo,3827,542,28,30,58,48.3%,5m
4481,2,IIIIIIIIIIII,3827,0,4,2,6,66.7%,11m
4481,2,[NCT]Jersey,3827,0,0,1,1,0.0%,7m
4481,3,[AnD]Alpina,3827,0,0,1,1,0.0%,7m
4481,2,DropDaHammer,3827,0,0,1,1,0.0%,17m
4489,2,mesip,3826,898,93,65,158,58.9%,6m
4489,2,[TheDOH]Daniello,3826,949,48,49,97,49.5%,25m
4489,2,[UATeam]mainVAR,3826,908,33,36,69,47.8%,14m
4489,2,MuleLord,3826,380,16,22,38,42.1%,12m
4489,2,[CYC]hansi,3826,36,2,1,3,66.7%,16m
4489,2,MrSverl,3826,12,1,6,7,14.3%,5m
4489,2,PADA,3826,0,0,2,2,0.0%,7m
4489,2,naileN,3826,0,0,3,3,0.0%,5m
4497,2,walkthisway,3825,1642,146,136,282,51.8%,12m
4497,1,[Gaofu]Eric,3825,1757,59,66,125,47.2%,26m
4497,2,Кирилл,3825,479,57,58,115,49.6%,17m
4497,2,[5up]Swisstox,3825,237,54,44,98,55.1%,24m
4497,2,[IceHus]IIIIIIIIIII,3825,403,54,47,101,53.5%,27m
4497,2,Andreasson,3825,272,9,10,19,47.4%,14m
4497,1,[stdlib]Lunatik,3825,424,9,16,25,36.0%,13m
4497,1,Hazelnut,3825,0,1,4,5,20.0%,12m
4497,2,Stefan,3825,32,1,5,6,16.7%,25m
4497,2,HeXGandalf,3825,0,0,2,2,0.0%,7m
4507,2,Osterei,3824,836,58,41,99,58.6%,27m
4507,2,[vlast]MickeyMouse,3824,423,26,2,28,92.9%,5m
4507,2,[сSсǃ]GooDCat,3824,578,20,24,44,45.5%,6m
4507,3,derp,3824,167,9,1,10,90.0%,8m
4507,2,llllllllllll,3824,182,7,5,12,58.3%,16m
4507,2,toxish,3824,0,1,0,1,100.0%,11m
4513,2,[KörSa]Neiko,3823,949,90,83,173,52.0%,25m
4513,2,xcos,3823,560,41,17,58,70.7%,14m
4513,2,[Aziz]Senn,3823,330,12,13,25,48.0%,17m
4513,2,ZveReK,3823,122,7,2,9,77.8%,27m
4513,2,KOERAN,3823,0,3,2,5,60.0%,6m
4513,2,[WITCHs]KILLROCK,3823,30,2,3,5,40.0%,23m
4513,2,TomiJ,3823,0,0,3,3,0.0%,6m
4520,1,Bolo,3822,1909,69,73,142,48.6%,9m
4520,1,[fam1ly]dDD,3822,1198,58,60,118,49.2%,6m
4520,2,xaverx,3822,280,10,10,20,50.0%,6m
4520,2,[K0mpis]MrBojangles,3822,244,8,11,19,42.1%,26m
4520,2,moki,3822,30,2,0,2,100.0%,27m
4525,2,Quinn,3821,1189,268,263,531,50.5%,25m
4525,2,Pubby,3821,1241,52,38,90,57.8%,24m
4525,2,FiFtyWaYs,3821,541,46,42,88,52.3%,6m
4525,2,NightDawn,3821,525,21,25,46,45.7%,16m
4525,2,Broketoss,3821,236,12,3,15,80.0%,27m
4525,1,[IceHus]СТИМПАК,3821,226,5,15,20,25.0%,12m
4525,2,CityZen,3821,64,3,2,5,60.0%,18m
4525,2,VladmirPutin,3821,98,3,2,5,60.0%,25m
4525,2,Troempa,3821,0,1,0,1,100.0%,13m
4525,2,[RstE]IIlIllIllII,3821,0,0,4,4,0.0%,9m
4535,1,MrEasy,3820,1527,88,82,170,51.8%,15m
4535,1,[ЯD]Rinogg,3820,749,23,34,57,40.4%,12m
4535,2,Nameless,3820,254,12,13,25,48.0%,11m
4535,2,PiNkUniCORN,3820,0,0,1,1,0.0%,15m
4535,2,Amove,3820,0,0,1,1,0.0%,14m
4540,1,[CNC3]Cybernetix,3819,1927,544,512,1056,51.5%,12m
4540,2,[αX]Victor,3819,1313,76,75,151,50.3%,14m
4540,2,[GOGOLS]Roldak,3819,439,20,9,29,69.0%,10m
4540,1,Strategy,3819,333,18,11,29,62.1%,9m
4540,2,Gragouzy,3819,284,10,7,17,58.8%,27m
4540,2,[Фаталя]PitsaMan,3819,238,9,4,13,69.2%,27m
4540,2,[aW]HânTattoo,3819,128,6,1,7,85.7%,12m
4540,2,Dominion,3819,32,2,0,2,100.0%,2m
4540,2,billis,3819,0,1,1,2,50.0%,25m
4540,2,ployha,3819,0,0,1,1,0.0%,3m
4540,2,romkatut,3819,0,0,3,3,0.0%,27m
4551,2,PassionPlaya,3818,560,69,54,123,56.1%,27m
4551,3,mORE,3818,304,14,3,17,82.4%,18m
4551,2,[vincis]Ares,3818,32,1,1,2,50.0%,5m
4551,2,yukee,3818,30,1,1,2,50.0%,8m
4551,2,TTBZ,3818,0,0,1,1,0.0%,5m
4556,2,[VertGe]RockFort,3817,1535,142,130,272,52.2%,16m
4556,2,Noobgam,3817,1494,131,105,236,55.5%,27m
4556,1,[DisES]Kamenashi,3817,1802,130,123,253,51.4%,12m
4556,1,[lMMl]salama,3817,1458,100,104,204,49.0%,26m
4556,1,HanZo,3817,710,26,32,58,44.8%,3m
4556,2,Srg,3817,367,21,7,28,75.0%,6m
4556,2,[KRAKOT]Wiztek,3817,554,21,16,37,56.8%,6m
4556,2,parasiteEve,3817,432,16,14,30,53.3%,9m
4556,2,StepO,3817,360,13,12,25,52.0%,23m
4556,2,DASBINICH,3817,206,8,6,14,57.1%,26m
4556,2,[50CM]Chris,3817,120,4,5,9,44.4%,17m
4556,2,mahanahan,3817,64,3,3,6,50.0%,25m
4556,2,Dindonneau,3817,0,0,1,1,0.0%,14m
4556,2,Blackflash,3817,0,0,2,2,0.0%,25m
4556,2,[Kompis]ElMojjo,3817,0,0,3,3,0.0%,25m
4571,2,BCman,3816,1615,382,364,746,51.2%,27m
4571,1,[ḾǂḰ]Mikifor,3816,1940,137,149,286,47.9%,15m
4571,2,[Triolo]Kourkz,3816,1516,61,56,117,52.1%,11m
4571,2,kaospoka,3816,1235,53,46,99,53.5%,27m
4571,2,CheF,3816,564,28,38,66,42.4%,25m
4571,2,[N0odle]SCNOODLE,3816,176,7,3,10,70.0%,25m
4571,1,ChibiRobo,3816,203,5,10,15,33.3%,6m
4571,2,KingOfBlades,3816,90,3,4,7,42.9%,24m
4571,2,Letmode,3816,58,2,2,4,50.0%,6m
4571,2,Fullbringer,3816,32,2,3,5,40.0%,7m
4581,1,Francesco,3815,1190,91,81,172,52.9%,25m
4581,2,Joker,3815,550,20,18,38,52.6%,8m
4581,2,[SWWT]Papa,3815,461,17,20,37,45.9%,25m
4581,2,ferari,3815,0,2,4,6,33.3%,11m
4581,2,[Cannоn]saVer,3815,60,2,4,6,33.3%,11m
4581,2,[DUUDE]ZepH,3815,0,1,2,3,33.3%,26m
4587,2,noddaba,3814,1112,190,169,359,52.9%,6m
4587,2,[ICGl]elfleischo,3814,1514,105,77,182,57.7%,2m
4587,1,[BRs]GoodFellas,3814,1782,64,71,135,47.4%,24m
4587,2,ipri,3814,1358,54,44,98,55.1%,7m
4587,2,[ЯD]Exo,3814,316,11,12,23,47.8%,16m
4587,2,Cute,3814,77,4,5,9,44.4%,18m
4587,3,XXLPANTS,3814,121,3,0,3,100.0%,24m
4587,2,[BLC]dalton,3814,0,1,0,1,100.0%,18m
4587,2,Quazatic,3814,0,0,1,1,0.0%,6m
4596,1,RoyOrbison,3813,1866,172,183,355,48.5%,18m
4596,2,[NMSQ]DraGo,3813,157,5,2,7,71.4%,24m
4596,2,Viittajeesus,3813,58,2,2,4,50.0%,14m
4596,2,Migglesworth,3813,29,2,4,6,33.3%,6m
4600,2,Milan,3812,1637,90,73,163,55.2%,6m
4600,2,Fermion,3812,1399,70,60,130,53.8%,24m
4600,2,[InBri]DESTROYER,3812,1402,56,48,104,53.8%,7m
4600,2,Zenith,3812,148,6,8,14,42.9%,5m
4600,2,Jerem,3812,90,3,3,6,50.0%,6m
4600,2,Starman,3812,0,1,0,1,100.0%,15m
4606,2,DevilOP,3811,1326,97,94,191,50.8%,27m
4606,1,[ULTX]Apolcalpyse,3811,1857,95,93,188,50.5%,7m
4606,2,emil,3811,653,38,35,73,52.1%,18m
4606,2,MetalKnight,3811,201,16,19,35,45.7%,3m
4606,2,Chuckdoodle,3811,200,7,5,12,58.3%,5m
4606,2,Weltraumwolf,3811,117,5,3,8,62.5%,18m
4606,2,[сSсǃ]NaJi,3811,0,1,1,2,50.0%,5m
4606,2,Linkersky,3811,0,0,1,1,0.0%,25m
4606,2,[PŖïMĄŁ]Dronehard,3811,0,0,2,2,0.0%,8m
4615,2,[RBlood]Nas,3810,1334,144,116,260,55.4%,11m
4615,1,PapaDragon,3810,516,12,24,36,33.3%,12m
4615,2,[IBeAŚI]IcyDust,3810,0,3,2,5,60.0%,25m
4615,2,BurSt,3810,0,0,1,1,0.0%,14m
4619,2,[0BO]Schmeribour,3809,1487,104,101,205,50.7%,24m
4619,2,Carles,3809,909,49,17,66,74.2%,6m
4619,2,vhl,3809,321,13,7,20,65.0%,2m
4619,2,[1NFEC7]Fury,3809,96,4,4,8,50.0%,2m
4619,2,Tuzbek,3809,38,2,4,6,33.3%,9m
4619,2,[KgNaab]rirezero,3809,68,2,4,6,33.3%,24m
4619,2,[premad]HanSoloZumbi,3809,32,1,2,3,33.3%,11m
4626,2,Pogo,3808,1581,137,144,281,48.8%,9m
4626,1,[Vodo]MagiCmaN,3808,0,3,1,4,75.0%,5m
4626,2,[aW]OrangeBleue,3808,98,3,8,11,27.3%,5m
4626,2,ODISEO,3808,32,2,2,4,50.0%,23m
4626,2,TommyKiller,3808,0,0,1,1,0.0%,11m
4626,2,Ivan,3808,0,0,2,2,0.0%,8m
4632,2,[RBP3]Guerilla,3807,1608,237,245,482,49.2%,2m
4632,2,PandaMarine,3807,1620,126,114,240,52.5%,7m
4632,1,[ЗИБиАГ]DiamondDog,3807,1118,63,61,124,50.8%,12m
4632,2,nimsec,3807,646,25,19,44,56.8%,23m
4632,1,mightyMungo,3807,571,17,19,36,47.2%,13m
4632,1,DayZ,3807,317,14,19,33,42.4%,15m
4632,2,[FИCK]INVINCIBLE,3807,340,12,4,16,75.0%,6m
4632,2,TanKxYou,3807,172,6,7,13,46.2%,11m
4632,1,PhilDunphy,3807,88,2,15,17,11.8%,24m
4632,2,Torbrand,3807,0,0,1,1,0.0%,24m
4642,1,Eobard,3806,1385,141,144,285,49.5%,24m
4642,2,Nihilus,3806,953,124,103,227,54.6%,26m
4642,2,NaNou,3806,1065,45,37,82,54.9%,16m
4642,2,[NMSQ]FaJeReDDDDDD,3806,516,23,7,30,76.7%,16m
4642,1,[AISC]Mouse,3806,531,12,20,32,37.5%,9m
4642,3,GLHFGG,3806,215,10,3,13,76.9%,5m
4642,2,[SEWP]skiff,3806,94,3,3,6,50.0%,6m
4649,1,Veder,3805,963,152,158,310,49.0%,24m
4649,2,Евгений,3805,1525,131,127,258,50.8%,14m
4649,2,Fuglinn,3805,1121,69,69,138,50.0%,3m
4649,2,TvTisCanceR,3805,1084,61,64,125,48.8%,17m
4649,2,Lunar,3805,894,34,33,67,50.7%,11m
4649,1,SpaceOrc,3805,570,21,21,42,50.0%,12m
4649,2,ClairVoyance,3805,480,17,17,34,50.0%,14m
4649,2,PEEPEEBOI,3805,282,14,4,18,77.8%,5m
4649,3,AJSC,3805,208,7,2,9,77.8%,5m
4649,1,MJHolland,3805,145,4,3,7,57.1%,25m
4649,2,[JustFF]Nibiru,3805,0,3,1,4,75.0%,2m
4649,2,WassupMan,3805,0,0,1,1,0.0%,15m
4649,2,OldTerran,3805,0,0,1,1,0.0%,4m
4662,2,QQQQQQQQQQQQ,3804,1667,247,230,477,51.8%,9m
4662,2,PartaSTI,3804,762,80,66,146,54.8%,24m
4662,2,[TerBHD]Trooper,3804,656,51,45,96,53.1%,7m
4662,2,OceanBlu,3804,418,17,9,26,65.4%,11m
4662,2,UDisgustMe,3804,66,3,3,6,50.0%,8m
4662,3,llllllllllll,3804,0,0,1,1,0.0%,17m
4668,2,Mirajje,3803,1367,156,142,298,52.3%,2m
4668,1,[Benz]WhySoSeriOus,3803,1665,96,87,183,52.5%,7m
4668,2,Algous,3803,667,32,26,58,55.2%,11m
4668,2,GoldenArmada,3803,140,5,11,16,31.2%,2m
4668,2,[DWTeam]Wolfstalker,3803,32,1,2,3,33.3%,18m
4673,1,[GIKI]Sapper,3802,1277,472,489,961,49.1%,13m
4673,1,[mCorǂ]starscream,3802,1826,464,466,930,49.9%,15m
4673,2,llllllllll,3802,1609,339,326,665,51.0%,23m
4673,2,TwoMore,3802,1421,106,103,209,50.7%,11m
4673,1,Khrell,3802,1875,103,113,216,47.7%,7m
4673,1,FrostyProbe,3802,923,46,44,90,51.1%,12m
4673,2,[ADMEN]Balzer,3802,896,34,32,66,51.5%,5m
4673,2,stalker,3802,696,24,33,57,42.1%,16m
4673,2,Bigtom,3802,368,14,11,25,56.0%,26m
4673,3,Wirt,3802,143,8,1,9,88.9%,23m
4673,3,[nFc]NineLives,3802,30,2,1,3,66.7%,27m
4673,2,IIIIIIIIIII,3802,0,1,1,2,50.0%,6m
4685,1,LaoTzu,3801,1859,82,88,170,48.2%,26m
4685,1,SinO,3801,1734,55,72,127,43.3%,16m
4685,1,AerialSheep,3801,702,38,46,84,45.2%,15m
4685,2,[THRLLA]Gav,3801,476,18,19,37,48.6%,26m
4685,2,stas,3801,262,13,4,17,76.5%,4m
4685,1,llllllllllll,3801,86,3,12,15,20.0%,26m
4685,2,[BLC]Tao,3801,35,2,3,5,40.0%,17m
4685,2,[valars]iluvatar,3801,30,1,4,5,20.0%,7m
4693,1,[MSUSC2]Raskol,3800,1883,243,247,490,49.6%,6m
4693,2,[ЯD]SliCk,3800,1264,132,128,260,50.8%,7m
4693,2,whatwill,3800,1639,74,53,127,58.3%,2m
4693,2,[GTSPLR]majesty,3800,1068,42,35,77,54.5%,9m
4693,3,[TTOG]Bergem,3800,191,7,1,8,87.5%,15m
4693,2,IIIIIIIIIIII,3800,120,6,4,10,60.0%,8m
4693,2,Pasto,3800,126,5,5,10,50.0%,17m
4693,2,Evenfin,3800,110,3,11,14,21.4%,12m
4693,2,TryFather,3800,0,1,1,2,50.0%,26m
4702,2,[ArGGEU]mOsTeN,3799,880,30,38,68,44.1%,25m
4702,2,IIIIIIIIIIII,3799,459,20,10,30,66.7%,11m
4702,3,Jonas,3799,257,10,9,19,52.6%,3m
4702,2,[GXalpH]IIIIIIIIIIII,3799,165,9,9,18,50.0%,23m
4702,3,Fanatig,3799,196,6,4,10,60.0%,8m
4702,2,PainGamer,3799,116,5,6,11,45.5%,23m
4702,1,Freedom,3799,132,3,12,15,20.0%,2m
4702,2,coni,3799,30,2,0,2,100.0%,14m
4702,2,[SRoB]Robin,3799,0,1,3,4,25.0%,3m
4702,2,[Tricky]Ender,3799,0,0,4,4,0.0%,17m
4712,1,[DemuCl]Jazzz,3798,1900,200,209,409,48.9%,15m
4712,2,Seventh,3798,176,7,4,11,63.6%,2m
4712,2,Gyyyzmo,3798,132,4,7,11,36.4%,6m
4715,2,TheHummus,3797,1666,277,257,534,51.9%,26m
4715,2,Oxlaeg,3797,516,18,18,36,50.0%,27m
4715,3,IIIIIIIIIIII,3797,119,10,0,10,100.0%,14m
4715,3,rodbrok,3797,167,9,1,10,90.0%,27m
4715,2,Jack,3797,0,0,3,3,0.0%,17m
4720,2,Entita,3796,374,49,30,79,62.0%,25m
4720,1,thD,3796,1419,43,47,90,47.8%,16m
4720,1,[MDLB]Traka,3796,1358,39,50,89,43.8%,4m
4720,2,Monomine,3796,375,33,30,63,52.4%,24m
4720,2,Serendipity,3796,208,9,8,17,52.9%,16m
4720,1,[Jedi]MasterBetty,3796,0,3,2,5,60.0%,8m
4720,2,LOBstah,3796,0,2,3,5,40.0%,11m
4720,2,iloveoov,3796,62,2,3,5,40.0%,2m
4720,2,Zera,3796,0,1,0,1,100.0%,7m
4720,2,MSteamhammer,3796,40,1,7,8,12.5%,3m
4730,2,[Goðar]Duddijons,3795,824,54,54,108,50.0%,27m
4730,2,[HEROV]HeroMandarin,3795,1047,47,24,71,66.2%,10m
4730,2,OrderinChaos,3795,150,8,5,13,61.5%,3m
4730,2,DanTerran,3795,88,4,2,6,66.7%,3m
4730,2,HEAVYMETAL,3795,86,3,2,5,60.0%,23m
4735,2,[HQ31er]IIIIIIIIIIII,3794,324,11,13,24,45.8%,12m
4735,2,Gosumarine,3794,160,6,6,12,50.0%,3m
4735,2,СосКSuсКer,3794,152,5,4,9,55.6%,23m
4735,3,MicroMarine,3794,164,4,1,5,80.0%,3m
4735,2,[Kingz]MasterLxPt,3794,0,1,0,1,100.0%,6m
4735,3,[JBBz]raptailor,3794,0,1,0,1,100.0%,14m
4741,1,[MIÉRT]RisiKo,3793,1812,176,187,363,48.5%,24m
4741,1,sid,3793,956,122,98,220,55.5%,26m
4741,2,AcQ,3793,655,31,32,63,49.2%,5m
4741,2,Neowise,3793,613,27,25,52,51.9%,25m
4741,2,Nahtloser,3793,584,21,18,39,53.8%,6m
4741,2,ЕдкийЁж,3793,430,20,9,29,69.0%,10m
4741,2,IlIlIlIlIlIl,3793,62,3,1,4,75.0%,11m
4741,2,Sashko,3793,58,2,2,4,50.0%,14m
4741,2,[ЯD]Justinian,3793,66,2,3,5,40.0%,25m
4741,2,[PIGEY]Pigenator,3793,0,2,5,7,28.6%,23m
4741,2,[R3TARD]Arthas,3793,34,2,5,7,28.6%,10m
4741,2,williams,3793,0,1,0,1,100.0%,8m
4741,2,Sam,3793,0,0,2,2,0.0%,5m
4754,2,chichi,3792,1436,165,156,321,51.4%,11m
4754,2,Eliphas,3792,751,27,31,58,46.6%,27m
4754,2,Feleks,3792,602,24,24,48,50.0%,7m
4754,2,Heunabu,3792,360,17,7,24,70.8%,27m
4754,2,[MHACKS]Gizmo,3792,172,11,9,20,55.0%,25m
4754,3,ZeroCool,3792,259,9,12,21,42.9%,18m
4754,3,wuffeltuffel,3792,240,7,5,12,58.3%,7m
4754,2,Leshti,3792,168,6,2,8,75.0%,8m
4762,1,kumiho,3791,1324,139,139,278,50.0%,24m
4762,1,[Zone]ArAyA,3791,1884,133,134,267,49.8%,10m
4762,1,[CYC]SooThSayeR,3791,1172,48,58,106,45.3%,13m
4762,1,[bBbg7]CrYpTiCnicK,3791,1145,40,36,76,52.6%,15m
4762,2,MCKILLER,3791,334,17,8,25,68.0%,16m
4762,2,zup,3791,396,14,15,29,48.3%,14m
4762,2,RuegenWalder,3791,0,3,2,5,60.0%,4m
4762,2,[TMROW]alxO,3791,30,1,1,2,50.0%,5m
4762,3,Jieaell,3791,30,1,9,10,10.0%,18m
4771,3,opl,3790,262,12,5,17,70.6%,8m
4771,2,BumBleBee,3790,248,9,3,12,75.0%,7m
4771,2,Jukhan,3790,267,9,17,26,34.6%,26m
4771,2,[BN]Tikou,3790,0,0,1,1,0.0%,6m
4771,2,[crisp]pinzke,3790,0,0,3,3,0.0%,4m
4776,2,Beng,3789,715,110,110,220,50.0%,15m
4776,2,covd,3789,987,107,92,199,53.8%,12m
4776,1,[EESC]ııVersmooRıı,3789,1561,63,58,121,52.1%,6m
4776,2,avpaul,3789,1406,62,59,121,51.2%,25m
4776,2,Orkis,3789,1086,44,38,82,53.7%,14m
4776,2,Tsar,3789,844,32,33,65,49.2%,23m
4776,1,WonderJ,3789,424,11,19,30,36.7%,26m
4776,2,[BRSKR]Zomby,3789,190,9,2,11,81.8%,17m
4776,2,Atonement,3789,206,8,7,15,53.3%,18m
4776,2,Mathlife,3789,216,8,7,15,53.3%,25m
4776,2,[K0mpis]TheDounat,3789,124,5,3,8,62.5%,8m
4776,2,[Æsir]Ronixi,3789,0,0,2,2,0.0%,14m
4776,2,[LTPX]LeMagicien,3789,0,0,2,2,0.0%,25m
4789,2,[SKALEN]POTOP,3788,890,35,26,61,57.4%,16m
4789,2,escaton,3788,528,18,24,42,42.9%,15m
4789,2,Nyarlathotep,3788,302,12,5,17,70.6%,17m
4789,1,Menekor,3788,316,8,16,24,33.3%,16m
4789,2,ender,3788,62,3,2,5,60.0%,15m
4789,2,ThreePM,3788,30,2,2,4,50.0%,27m
4789,2,Anubasch,3788,30,1,1,2,50.0%,25m
4789,2,GraceFul,3788,0,1,2,3,33.3%,6m
4789,2,msi,3788,30,1,3,4,25.0%,3m
4789,2,[PŖïMĄŁ]Sensei,3788,0,0,2,2,0.0%,16m
4789,2,[F4NCY]XLGMaGeFiRE,3788,0,0,2,2,0.0%,13m
4800,2,Nippy,3787,1352,97,85,182,53.3%,6m
4800,2,Dirk,3787,1202,69,73,142,48.6%,26m
4800,2,[CSM]CosmicGus,3787,999,63,63,126,50.0%,18m
4800,2,TheTerran,3787,1061,54,26,80,67.5%,14m
4800,2,Monnorox,3787,515,25,12,37,67.6%,18m
4800,2,[SCiE]Ghost,3787,526,20,17,37,54.1%,25m
4800,2,[Lambro]edominator,3787,465,16,19,35,45.7%,6m
4800,2,MiRaGe,3787,309,11,12,23,47.8%,17m
4800,2,llllllllllll,3787,136,8,0,8,100.0%,16m
4800,2,IIIIIII,3787,60,3,1,4,75.0%,16m
4800,2,LikeaDrunk,3787,94,3,8,11,27.3%,14m
4800,2,BoyNextDoor,3787,0,1,1,2,50.0%,11m
4800,2,Airlord,3787,30,1,3,4,25.0%,18m
4813,2,[TmVsn]obi,3786,1309,241,237,478,50.4%,2m
4813,2,[FKTS]TheDoctor,3786,1602,83,71,154,53.9%,18m
4813,2,Liquid,3786,1144,79,50,129,61.2%,26m
4813,1,Scarecrow,3786,1335,63,63,126,50.0%,12m
4813,3,LostReaper,3786,163,8,1,9,88.9%,11m
4818,1,Dare,3785,1082,160,139,299,53.5%,7m
4818,2,[CIB]Alpha,3785,496,21,11,32,65.6%,5m
4818,3,[SpSh]Davidouni,3785,311,14,4,18,77.8%,2m
4818,3,ImissU,3785,0,0,9,9,0.0%,17m
4822,1,[NLLO]EvA,3784,1857,161,161,322,50.0%,12m
4822,2,[Ri17]RinKiller,3784,1259,90,83,173,52.0%,16m
4822,1,[RNBA]Braios,3784,1321,64,66,130,49.2%,13m
4822,2,[Blacer]babatounet,3784,589,20,26,46,43.5%,3m
4822,2,StatsIsBest,3784,274,11,5,16,68.8%,6m
4822,2,llllllllllll,3784,262,7,6,13,53.8%,6m
4822,2,Ithor,3784,200,7,9,16,43.8%,27m
4822,2,Malvorio,3784,62,2,4,6,33.3%,15m
4830,2,Stok,3783,1580,172,163,335,51.3%,16m
4830,2,[ZERG7V]Vifesia,3783,1380,85,84,169,50.3%,26m
4830,2,Begin,3783,1198,83,58,141,58.9%,2m
4830,2,[IceHus]DashYarik,3783,943,39,26,65,60.0%,6m
4830,1,Layle,3783,1098,38,47,85,44.7%,2m
4830,2,Tobi,3783,767,30,20,50,60.0%,7m
4830,2,IAmSoNoo,3783,0,4,2,6,66.7%,10m
4830,2,Sarkastik,3783,32,1,1,2,50.0%,6m
4838,1,[oTCo]LTJ,3782,1565,126,115,241,52.3%,26m
4838,2,Answer,3782,1500,72,59,131,55.0%,11m
4838,1,[AISC]Surge,3782,991,26,41,67,38.8%,4m
4838,2,qwersiK,3782,0,5,0,5,100.0%,15m
4838,2,[brztlb]filobedo,3782,87,5,5,10,50.0%,12m
4838,2,[BLkSa]NarkotiKa,3782,0,0,1,1,0.0%,14m
4844,1,Goodfella,3781,1893,748,757,1505,49.7%,11m
4844,1,RUwinningson,3781,1862,635,633,1268,50.1%,26m
4844,2,Prometheus,3781,1364,98,83,181,54.1%,6m
4844,2,[EESC]rexTOLA,3781,1257,84,79,163,51.5%,6m
4844,1,BCNHumanoid,3781,1142,56,66,122,45.9%,24m
4844,2,dumè,3781,1217,51,50,101,50.5%,17m
4844,2,JanDeMan,3781,438,16,16,32,50.0%,7m
4844,1,[NetGG]Zed,3781,262,6,20,26,23.1%,16m
4844,2,Toriilll,3781,30,2,1,3,66.7%,8m
4844,2,[WYG]ramose,3781,32,2,2,4,50.0%,3m
4844,2,[ncotic]Doctor,3781,0,0,1,1,0.0%,18m
4855,2,wtfisHedOing,3780,956,135,110,245,55.1%,15m
4855,2,[TGNE]EpicElvin,3780,504,19,10,29,65.5%,9m
4855,2,CountDunkula,3780,30,4,2,6,66.7%,5m
4855,2,[QYLB]MrSlooz,3780,68,3,4,7,42.9%,14m
4855,2,[GRYM]morecal,3780,30,1,2,3,33.3%,3m
4855,2,[ID10TS]Pie,3780,30,1,7,8,12.5%,6m
4855,2,[HTY]LOL,3780,0,0,3,3,0.0%,26m
4862,2,Hjarsta,3779,1230,119,93,212,56.1%,15m
4862,2,HyperLeo,3779,1240,56,45,101,55.4%,16m
4862,2,llllllllllll,3779,1070,53,31,84,63.1%,6m
4862,2,Acidstorm,3779,548,27,7,34,79.4%,27m
4862,2,[AoTu]JéRémy,3779,456,17,13,30,56.7%,27m
4862,2,SleepOnMic,3779,0,1,0,1,100.0%,12m
4862,3,sauza,3779,30,1,1,2,50.0%,11m
4862,2,[1stGG]MrRoboto,3779,0,0,1,1,0.0%,8m
4862,2,erik,3779,0,0,4,4,0.0%,10m
4871,1,[A11]SkillLesS,3778,1788,228,236,464,49.1%,19m
4871,2,RageQuit,3778,1605,74,75,149,49.7%,16m
4871,2,NoScared,3778,566,36,12,48,75.0%,18m
4871,2,lolnice,3778,784,28,30,58,48.3%,4m
4871,2,[TиCo]УБИЙЦАvСеКСА,3778,278,10,12,22,45.5%,25m
4871,2,Alraerir,3778,146,6,5,11,54.5%,3m
4871,2,[LawB]METHikCZ,3778,90,3,7,10,30.0%,7m
4871,1,Killborne,3778,0,0,5,5,0.0%,7m
4879,1,[0G]Yurisan,3777,1757,176,192,368,47.8%,13m
4879,2,BlackWidow,3777,1360,72,57,129,55.8%,14m
4879,2,Dargel,3777,291,11,4,15,73.3%,8m
4879,2,[GKTRK]Celomanx,3777,198,8,7,15,53.3%,18m
4879,3,[lLiTl]BlodgeNinja,3777,88,3,0,3,100.0%,4m
4879,2,Arialkz,3777,0,1,0,1,100.0%,5m
4879,2,[UFktBy]FBIOpnSouply,3777,0,1,0,1,100.0%,2m
4879,3,[IBeAŚI]Luga,3777,0,0,1,1,0.0%,14m
4879,2,Kapsu,3777,0,0,1,1,0.0%,5m
4888,1,LearnToScout,3776,1843,100,104,204,49.0%,8m
4888,2,[DZ16]kakoki,3776,1447,89,84,173,51.4%,27m
4888,2,Dijkkie,3776,0,3,4,7,42.9%,16m
4888,2,[TeK]Flash,3776,66,2,9,11,18.2%,3m
4892,1,Doghum,3775,1830,438,447,885,49.5%,26m
4892,2,mEtRo,3775,1579,84,49,133,63.2%,14m
4892,2,[CFeS]NEO,3775,1021,53,58,111,47.7%,8m
4892,2,Lazzymen,3775,400,20,8,28,71.4%,15m
4892,2,eitan,3775,126,4,6,10,40.0%,17m
4892,2,[M3CHA]Veysh,3775,0,0,1,1,0.0%,25m
4892,2,[SSCP]SauC,3775,0,0,4,4,0.0%,26m
4899,1,[GOLDPL]marinos,3774,1898,308,314,622,49.5%,10m
4899,2,Guerter,3774,1592,262,250,512,51.2%,25m
4899,1,[AGI]Liberty,3774,1003,115,123,238,48.3%,15m
4899,2,[ObG1]Lunde,3774,328,13,13,26,50.0%,8m
4899,3,tasKforce,3774,192,10,3,13,76.9%,25m
4899,2,[R3ASON]Frezzie,3774,202,7,11,18,38.9%,8m
4899,2,DarKEmpiRE,3774,30,1,2,3,33.3%,6m
4906,1,llllllllllll,3773,1873,89,98,187,47.6%,24m
4906,2,[RGSC2]LifeForAiur,3773,1607,67,54,121,55.4%,6m
4906,2,Сумрак,3773,624,28,16,44,63.6%,8m
4906,1,protossiimba,3773,425,17,13,30,56.7%,8m
4910,2,[Сlеvеr]Olrin,3772,1602,293,275,568,51.6%,25m
4910,1,lightbringer,3772,1847,161,165,326,49.4%,12m
4910,1,Mauridius,3772,1532,116,114,230,50.4%,15m
4910,2,[lWHl]Destro,3772,534,20,17,37,54.1%,25m
4910,3,Burger,3772,245,8,5,13,61.5%,5m
4910,2,qqq,3772,32,2,1,3,66.7%,17m
4910,2,absiNt,3772,0,0,1,1,0.0%,7m
4910,2,LeTerran,3772,0,0,1,1,0.0%,4m
4918,1,[ZERG7V]ChaMpioN,3771,1874,182,176,358,50.8%,26m
4918,2,jari,3771,1601,134,100,234,57.3%,8m
4918,2,[NMSQ]Sareth,3771,359,14,7,21,66.7%,25m
4918,2,Blanca,3771,356,12,15,27,44.4%,11m
4918,2,IIIIIIIII,3771,312,10,16,26,38.5%,8m
4918,2,[TheDOH]Enzo,3771,60,2,2,4,50.0%,18m
4918,2,BBRuBBy,3771,0,1,1,2,50.0%,2m
4918,2,[Schmus]BRUDI,3771,0,0,1,1,0.0%,23m
4918,2,[PMIP]Terror,3771,0,0,2,2,0.0%,7m
4927,2,NoRulez,3770,1184,46,41,87,52.9%,6m
4927,2,Rodolphe,3770,1030,41,34,75,54.7%,10m
4927,2,Maosu,3770,294,11,5,16,68.8%,14m
4927,3,crazypants,3770,168,9,1,10,90.0%,8m
4927,2,крутойморпех,3770,118,5,2,7,71.4%,27m
4927,2,Ber,3770,0,0,1,1,0.0%,26m
4927,2,OcKhaM,3770,0,0,1,1,0.0%,18m
4934,2,MSG,3769,893,86,74,160,53.8%,4m
4934,1,PlaySC,3769,848,49,52,101,48.5%,25m
4934,2,[RbF]Neon,3769,382,13,15,28,46.4%,26m
4934,2,[FiIthy]COVID,3769,240,8,14,22,36.4%,5m
4934,2,kagerou,3769,30,2,0,2,100.0%,8m
4934,1,Deathwing,3769,48,2,2,4,50.0%,6m
4940,2,[CCAV]FanglinRush,3768,1140,116,105,221,52.5%,7m
4940,1,[UYourS]Mwalimu,3768,1580,55,59,114,48.2%,11m
4940,2,flokk,3768,1302,49,50,99,49.5%,15m
4940,2,Wooldot,3768,702,32,26,58,55.2%,12m
4940,2,[vcvt]fioletoviy,3768,282,12,4,16,75.0%,7m
4940,1,Hydrenoire,3768,306,9,15,24,37.5%,7m
4940,2,GoodLuckHave,3768,60,5,5,10,50.0%,11m
4940,2,[PLA2N]SXO,3768,102,3,8,11,27.3%,27m
4940,2,RED,3768,0,1,0,1,100.0%,4m
4940,2,[IBeAŚI]DeepThought,3768,0,0,2,2,0.0%,11m
4940,2,MRy,3768,0,0,4,4,0.0%,26m
4940,2,[Obm]AeTher,3768,0,0,5,5,0.0%,18m
4952,1,[sone]Tails,3767,1744,168,162,330,50.9%,26m
4952,3,MarineKing,3767,287,9,5,14,64.3%,18m
4952,2,LoveMarines,3767,0,1,0,1,100.0%,7m
4955,2,JustDontDrop,3766,1385,69,66,135,51.1%,26m
4955,2,[TAW]Ares,3766,268,37,28,65,56.9%,27m
4955,1,[Babes]drainjab,3766,1135,37,47,84,44.0%,4m
4955,2,[abbb]AllaNDaRiTY,3766,236,8,10,18,44.4%,24m
4955,2,Kable,3766,122,5,2,7,71.4%,5m
4955,2,DragonKirb,3766,86,3,2,5,60.0%,6m
4955,2,quaZa,3766,134,2,4,6,33.3%,23m
4955,2,TheLDK,3766,30,1,1,2,50.0%,8m
4955,2,[TheDOH]SimAsS,3766,88,1,1,2,50.0%,10m
4964,2,RaenTorgon,3765,1256,107,105,212,50.5%,18m
4964,2,Ferro,3765,1566,92,85,177,52.0%,7m
4964,3,Feardarkness,3765,121,3,1,4,75.0%,24m
4964,2,[YEP4VR]Cubeloz,3765,0,0,1,1,0.0%,13m
4968,2,[IFAI]AnFalslh,3764,1525,103,79,182,56.6%,6m
4968,2,suNstrider,3764,1143,59,33,92,64.1%,17m
4968,2,[Ричард]GooD,3764,1084,51,44,95,53.7%,5m
4968,2,[Kingz]LiquidZektra,3764,983,46,41,87,52.9%,16m
4968,2,[BNDOVR]Domiman,3764,472,28,19,47,59.6%,25m
4968,2,[ExTr1m]Lite,3764,276,12,8,20,60.0%,6m
4968,2,GGBB,3764,288,11,10,21,52.4%,4m
4968,2,bravo,3764,114,4,7,11,36.4%,4m
4968,2,[TGCrew]Defiance,3764,58,2,3,5,40.0%,6m
4968,2,BeTa,3764,0,0,3,3,0.0%,12m
4978,2,PenspinningG,3763,823,87,64,151,57.6%,14m
4978,1,Legion,3763,1443,42,54,96,43.8%,13m
4978,2,[TGCrew]KCal,3763,342,15,14,29,51.7%,18m
4978,2,[Xa]superbimbo,3763,224,8,10,18,44.4%,27m
4978,2,littleINno,3763,202,7,9,16,43.8%,18m
4978,2,ShiVA,3763,120,4,5,9,44.4%,7m
4978,2,wawrinka,3763,60,2,2,4,50.0%,14m
4978,2,PeaceMaker,3763,0,1,3,4,25.0%,10m
4978,2,[FREEDM]Thx,3763,32,1,4,5,20.0%,26m
4978,2,[ApkCrw]PeterAllaoui,3763,0,0,1,1,0.0%,8m
4988,2,[KDV]NarcyZ,3762,306,12,10,22,54.5%,7m
4988,2,[BigDad]RyoNarushima,3762,0,1,4,5,20.0%,7m
4988,2,[FxL]Logan,3762,0,0,1,1,0.0%,8m
4988,2,[UpMs]Astute,3762,0,0,1,1,0.0%,5m
4992,1,Rumburak,3761,1861,436,434,870,50.1%,2m
4992,2,Anh,3761,471,23,15,38,60.5%,26m
4992,2,[RzBn]LeGardien,3761,608,23,19,42,54.8%,6m
4992,2,Alpha,3761,129,17,15,32,53.1%,16m
4992,2,FloFly,3761,312,10,18,28,35.7%,14m
4992,2,[TheDOH]Zinnie,3761,118,5,3,8,62.5%,4m
4992,2,Nïàk,3761,30,2,0,2,100.0%,24m
4992,3,[InitRu]RodgerYoung,3761,30,2,2,4,50.0%,16m
5000,2,GANDALFMAN,3760,1612,349,349,698,50.0%,25m
5000,2,james,3760,1616,193,174,367,52.6%,11m
5000,2,RobTho,3760,497,26,12,38,68.4%,27m
5000,3,speakdown,3760,214,7,1,8,87.5%,26m
5000,2,SmoovE,3760,32,1,2,3,33.3%,3m
5000,2,Motor,3760,0,0,1,1,0.0%,18m
5000,2,Chickenman,3760,0,0,1,1,0.0%,6m
5007,1,Slevin,3759,1798,673,669,1342,50.1%,11m
5007,2,Marranelo,3759,979,99,98,197,50.3%,25m
5007,1,[HEIßE]Bratwurst,3759,1465,83,101,184,45.1%,24m
5007,2,PlayerOne,3759,1034,40,33,73,54.8%,4m
5007,2,DarkRaven,3759,458,15,20,35,42.9%,15m
5007,2,INnoVation,3759,262,9,16,25,36.0%,17m
5007,2,Efes,3759,186,7,13,20,35.0%,15m
5007,2,NAPS,3759,0,1,0,1,100.0%,8m
5007,2,ZenOnTM,3759,0,0,1,1,0.0%,26m
5007,2,Ghoulie,3759,0,0,4,4,0.0%,15m
5017,2,Angrybanana,3758,1634,273,263,536,50.9%,6m
5017,2,Kempto,3758,766,84,79,163,51.5%,17m
5017,2,iPlayMuted,3758,952,37,33,70,52.9%,19m
5017,2,BeastModeOn,3758,124,5,4,9,55.6%,8m
5017,2,StreetCarp,3758,0,4,1,5,80.0%,23m
5017,2,Roland,3758,0,1,1,2,50.0%,2m
5017,2,[N64Ram]XlecreatorX,3758,0,0,1,1,0.0%,11m
5017,2,MaNiAkSdF,3758,0,0,8,8,0.0%,10m
5025,1,panic,3757,1170,170,166,336,50.6%,19m
5025,2,Oreeo,3757,828,65,67,132,49.2%,17m
5025,2,Erik,3757,1094,46,39,85,54.1%,4m
5025,2,[Сlеvеr]Swarm,3757,896,35,31,66,53.0%,27m
5025,2,[PLA2N]limboid,3757,818,33,22,55,60.0%,9m
5025,2,IIIIIIIIIIII,3757,0,1,1,2,50.0%,24m
5025,2,superhero,3757,0,0,1,1,0.0%,27m
5032,1,lIQUID,3756,1870,259,263,522,49.6%,13m
5032,2,[TgK]CubeCow,3756,825,103,53,156,66.0%,17m
5032,1,BioMotor,3756,992,89,91,180,49.4%,26m
5032,1,poroshok,3756,674,68,80,148,45.9%,7m
5032,2,BigLupu,3756,384,21,21,42,50.0%,27m
5032,2,Maki,3756,403,18,11,29,62.1%,15m
5032,2,Snoony,3756,62,2,2,4,50.0%,18m
5032,2,[JILLZ]Cyber,3756,58,2,5,7,28.6%,25m
5032,2,Toncho,3756,0,0,3,3,0.0%,17m
5032,2,Error,3756,0,0,4,4,0.0%,25m
5042,2,Conquest,3755,1316,56,48,104,53.8%,5m
5042,2,Achillez,3755,222,9,6,15,60.0%,7m
5042,3,OlekStark,3755,92,5,9,14,35.7%,4m
5042,2,RaphaelGonza,3755,94,4,3,7,57.1%,3m
5042,2,eGaliza,3755,92,3,6,9,33.3%,4m
5042,2,DRONOS,3755,0,1,0,1,100.0%,26m
5042,2,kroker,3755,0,0,1,1,0.0%,7m
5049,1,Heisenberg,3754,1379,108,110,218,49.5%,24m
5049,1,[CirKus]Gallus,3754,1541,85,88,173,49.1%,26m
5049,2,[FrostG]iant,3754,1419,72,77,149,48.3%,25m
5049,2,[UnWp]nWpLawliet,3754,966,59,48,107,55.1%,5m
5049,2,kanal,3754,65,9,11,20,45.0%,16m
5049,2,smokke,3754,173,7,4,11,63.6%,11m
5049,2,ProßerGenis,3754,139,6,10,16,37.5%,12m
5049,2,PizeriaZorba,3754,97,5,1,6,83.3%,25m
5049,2,DuoPump,3754,0,0,1,1,0.0%,11m
5058,2,iTERRAN,3753,1620,164,159,323,50.8%,27m
5058,2,MrRedder,3753,628,22,26,48,45.8%,12m
5058,2,HappyFiit,3753,119,7,0,7,100.0%,5m
5058,2,NepNep,3753,142,6,4,10,60.0%,7m
5058,2,[24I7]MrKeks,3753,150,5,7,12,41.7%,25m
5058,2,JerryYu,3753,30,4,2,6,66.7%,27m
5064,1,[αX]Tsuneo,3752,1772,253,252,505,50.1%,16m
5064,2,EvoBambi,3752,1572,171,160,331,51.7%,27m
5064,2,[iX]Kuhmelker,3752,1571,69,47,116,59.5%,7m
5064,1,szeweningen,3752,198,8,10,18,44.4%,3m
5064,2,Acquittal,3752,144,6,3,9,66.7%,25m
5064,2,ReXtar,3752,64,2,3,5,40.0%,7m
5064,3,AstheFriend,3752,0,1,0,1,100.0%,11m
5064,2,[PMS]Woodoo,3752,0,1,0,1,100.0%,18m
5072,2,Mack,3751,1584,187,182,369,50.7%,15m
5072,2,[KREU]KimKunhee,3751,1543,110,105,215,51.2%,23m
5072,2,[MSUSC2]krirller,3751,1198,71,67,138,51.4%,25m
5072,2,WhoAmI,3751,617,26,14,40,65.0%,3m
5072,2,Magic,3751,524,18,21,39,46.2%,18m
5072,2,GrandMister,3751,458,17,18,35,48.6%,25m
5072,3,IIIIIIIIIIII,3751,170,5,3,8,62.5%,19m
5072,1,[NFE]NiceOne,3751,0,1,0,1,100.0%,8m
5072,2,Optisoin,3751,30,1,1,2,50.0%,23m
5072,1,Reizor,3751,0,0,1,1,0.0%,4m
5082,1,HasuGosuSoju,3750,1434,162,162,324,50.0%,6m
5082,2,[Bread]Blondie,3750,1164,87,81,168,51.8%,24m
5082,1,[AiRǂ]AirBass,3750,770,61,43,104,58.7%,26m
5082,1,[TEHE]Eden,3750,949,50,46,96,52.1%,2m
5082,2,boanaan,3750,996,37,37,74,50.0%,2m
5082,2,[fam1ly]kaan,3750,372,13,7,20,65.0%,9m
5082,2,Villa,3750,255,8,6,14,57.1%,9m
5082,2,[VRIK]Morgal,3750,198,7,10,17,41.2%,8m
5082,2,Pessle,3750,0,3,2,5,60.0%,9m
5082,2,Weasel,3750,58,2,3,5,40.0%,11m
5082,2,[ЯD]Flux,3750,30,1,2,3,33.3%,26m
5082,2,PANIE,3750,73,0,2,2,0.0%,23m
5094,2,Maglon,3749,1610,262,259,521,50.3%,25m
5094,2,[PLCM]Kohlhaas,3749,1164,101,94,195,51.8%,18m
5094,2,HowDoYouRead,3749,1412,97,82,179,54.2%,8m
5094,2,Sophie,3749,464,22,11,33,66.7%,14m
5094,2,Gadget,3749,0,1,1,2,50.0%,11m
5094,2,[CCAV]PTW,3749,32,1,4,5,20.0%,4m
5100,1,AyoH,3748,758,29,32,61,47.5%,24m
5100,3,JeanCastex,3748,330,15,8,23,65.2%,24m
5100,2,SayaTh,3748,141,14,14,28,50.0%,15m
5100,1,Ceddel,3748,97,1,5,6,16.7%,8m
5104,2,mayden,3747,1621,176,162,338,52.1%,12m
5104,2,Boosh,3747,1432,109,101,210,51.9%,5m
5104,2,AcSplit,3747,1273,68,29,97,70.1%,11m
5104,2,JoniBravo,3747,514,17,24,41,41.5%,27m
5104,3,[BSK88]Skiizz,3747,116,5,4,9,55.6%,23m
5104,2,[PsiVan]SlyOstrich,3747,66,3,3,6,50.0%,7m
5104,2,IIIIIIIIIIII,3747,90,3,4,7,42.9%,10m
5104,2,JohnBob,3747,64,2,8,10,20.0%,9m
5112,2,[RSyn]Joe,3746,1566,76,72,148,51.4%,16m
5112,2,Hitchhiker,3746,1166,43,48,91,47.3%,6m
5112,2,[SZ]Fairespiter,3746,1048,40,43,83,48.2%,2m
5112,2,IIIIIIIIIIII,3746,828,37,23,60,61.7%,23m
5112,2,LeaveMeAlone,3746,673,34,33,67,50.7%,27m
5112,2,evlampiy,3746,602,21,28,49,42.9%,6m
5112,2,Grimi,3746,176,7,6,13,53.8%,24m
5112,2,trut,3746,152,6,12,18,33.3%,18m
5112,2,[S4S5]Sined,3746,58,3,0,3,100.0%,26m
5112,2,[AiRǂ]natopigro,3746,58,2,1,3,66.7%,10m
5112,2,[αX]Danotory,3746,0,1,2,3,33.3%,7m
5112,2,Preston,3746,0,0,3,3,0.0%,26m
5124,2,[SEWP]Farlengar,3745,459,39,35,74,52.7%,27m
5124,2,Fresh,3745,956,35,38,73,47.9%,11m
5124,2,PanTo,3745,642,27,17,44,61.4%,24m
5124,2,Crach,3745,224,11,10,21,52.4%,15m
5124,2,freakshow,3745,114,7,0,7,100.0%,4m
5124,2,Inferno,3745,146,5,13,18,27.8%,27m
5124,2,QtAnimeGirl,3745,121,3,0,3,100.0%,27m
5124,2,SpeC,3745,86,3,1,4,75.0%,4m
5124,2,IIIIIIIIIIII,3745,30,2,1,3,66.7%,15m
5124,2,[NetGG]PrettyFly,3745,0,0,1,1,0.0%,27m
5124,2,[WysH]Wish,3745,0,0,1,1,0.0%,23m
5135,2,exeNagib,3744,940,40,29,69,58.0%,18m
5135,2,BroLeev,3744,528,21,14,35,60.0%,5m
5135,2,[3Dǃ]kazim,3744,140,5,4,9,55.6%,24m
5135,2,Nemesis,3744,58,3,2,5,60.0%,7m
5139,2,Ewells,3743,1502,75,56,131,57.3%,24m
5139,1,BuryEukalipt,3743,1109,36,44,80,45.0%,25m
5139,2,Mysterion,3743,30,2,2,4,50.0%,17m
5139,2,[PL4NCK]jemp,3743,60,2,3,5,40.0%,11m
5139,2,Vision,3743,30,1,2,3,33.3%,10m
5139,2,Guterino,3743,0,0,1,1,0.0%,5m
5145,1,[Peeps]REnoVation,3742,1858,402,417,819,49.1%,10m
5145,2,MrFurlough,3742,1592,312,295,607,51.4%,23m
5145,2,Shegin,3742,1559,166,165,331,50.2%,5m
5145,2,Nergal,3742,804,30,26,56,53.6%,5m
5145,2,kirtapk,3742,496,21,13,34,61.8%,10m
5145,2,HyperAries,3742,470,18,11,29,62.1%,26m
5145,2,CARRIERS,3742,180,5,12,17,29.4%,26m
5145,2,[xSNSD]Jessica,3742,64,3,0,3,100.0%,27m
5145,2,NoRushForMe,3742,90,3,12,15,20.0%,18m
5145,1,Chester,3742,97,1,2,3,33.3%,18m
5145,2,IIIIIIIIIIII,3742,0,0,5,5,0.0%,14m
5156,2,Urameshi,3741,1026,44,47,91,48.4%,18m
5156,2,fjuri,3741,178,11,15,26,42.3%,2m
5156,2,Luker,3741,0,1,0,1,100.0%,15m
5156,3,MagicBanana,3741,0,1,0,1,100.0%,6m
5160,2,[NagirU]Urigan,3740,1591,168,160,328,51.2%,8m
5160,2,cYclopYze,3740,1113,65,56,121,53.7%,15m
5160,2,Ronald,3740,567,24,28,52,46.2%,24m
5160,2,[DBr]Nùméréction,3740,0,0,1,1,0.0%,23m
5164,1,[EESC]Madara,3739,1677,407,397,804,50.6%,24m
5164,2,[VodVod]Kyslikator,3739,1347,272,235,507,53.6%,15m
5164,2,Liss,3739,609,34,32,66,51.5%,12m
5164,2,[TirolA]CommanderPim,3739,598,21,23,44,47.7%,5m
5164,2,[QTclub]Oecophylla,3739,340,11,16,27,40.7%,7m
5164,2,Alestes,3739,114,8,3,11,72.7%,5m
5164,2,Glorinflont,3739,239,7,12,19,36.8%,17m
5164,3,Ykyshy,3739,48,4,7,11,36.4%,15m
5164,2,Jonny,3739,122,4,14,18,22.2%,10m
5173,2,[goodp]DudeAustin,3738,1588,267,269,536,49.8%,17m
5173,2,Lubert,3738,1583,119,128,247,48.2%,18m
5173,2,KiritoOnlinr,3738,1508,96,78,174,55.2%,3m
5173,2,RaySky,3738,1105,65,59,124,52.4%,11m
5173,2,Dodjyz,3738,1127,46,35,81,56.8%,7m
5173,2,[PLA2N]ILYA,3738,526,20,15,35,57.1%,17m
5173,2,[EXPANT]LePascu,3738,200,7,9,16,43.8%,25m
5173,2,[ØC]Miloux,3738,0,1,0,1,100.0%,7m
5173,2,[0G]Pernix,3738,0,0,2,2,0.0%,18m
5182,2,TOKUS,3737,1305,75,69,144,52.1%,5m
5182,2,eLF,3737,1454,74,73,147,50.3%,18m
5182,2,AyneDikka,3737,1086,38,46,84,45.2%,14m
5182,2,Buttons,3737,119,7,0,7,100.0%,25m
5182,2,hacenet,3737,86,4,3,7,57.1%,26m
5182,2,Glückspilz,3737,88,3,3,6,50.0%,5m
5182,1,BiggestBro,3737,0,1,0,1,100.0%,27m
5182,2,Reverence,3737,30,1,1,2,50.0%,15m
5182,2,Gaard,3737,0,0,2,2,0.0%,26m
5191,2,PewPew,3736,982,40,30,70,57.1%,12m
5191,2,Ardo,3736,678,27,19,46,58.7%,7m
5191,2,Rakk,3736,539,24,10,34,70.6%,7m
5191,2,[PFNTCS]Kaneki,3736,308,11,13,24,45.8%,17m
5191,3,Pessle,3736,213,7,1,8,87.5%,23m
5191,2,AWAVY,3736,60,3,8,11,27.3%,15m
5191,2,ЛордКиберПес,3736,30,2,1,3,66.7%,27m
5191,2,Redrik,3736,30,1,5,6,16.7%,18m
5191,3,Bruno,3736,0,0,2,2,0.0%,23m
5191,2,Random,3736,0,0,4,4,0.0%,5m
5201,1,Spasfon,3735,1874,230,235,465,49.5%,13m
5201,2,MumenRider,3735,769,156,154,310,50.3%,17m
5201,1,dirtyharry,3735,796,71,91,162,43.8%,25m
5201,2,atomas,3735,476,23,14,37,62.2%,8m
5201,2,[AciNoN]TwilightZeRR,3735,434,17,12,29,58.6%,11m
5201,3,pottytrained,3735,350,13,11,24,54.2%,16m
5201,2,SugarRay,3735,118,5,6,11,45.5%,14m
5201,2,Breedlove,3735,0,0,1,1,0.0%,9m
5201,2,Leshty,3735,0,0,1,1,0.0%,6m
5201,3,TorbenPeter,3735,0,0,3,3,0.0%,8m
5211,2,Techmaster,3734,1156,54,59,113,47.8%,7m
5211,1,[aW]clockmaster,3734,537,14,24,38,36.8%,12m
5211,2,SecndMonitor,3734,378,11,18,29,37.9%,7m
5211,2,[iX]Aerocool,3734,0,1,3,4,25.0%,8m
5215,2,ProtossOTP,3733,1546,191,169,360,53.1%,15m
5215,2,Gamblesock,3733,1504,91,70,161,56.5%,6m
5215,2,[2II5]FootAbuser,3733,1481,82,59,141,58.2%,3m
5215,2,[PaniC]WhiteEagle,3733,1601,77,57,134,57.5%,15m
5215,2,[TagPed]dedgaem,3733,498,18,21,39,46.2%,16m
5215,2,Rin,3733,406,16,7,23,69.6%,15m
5215,2,Gadz,3733,254,11,12,23,47.8%,26m
5215,1,[Cannоn]HotGirl,3733,420,11,24,35,31.4%,3m
5215,2,[Afreca]Elartan,3733,268,10,4,14,71.4%,8m
5215,2,Strawberry,3733,222,9,4,13,69.2%,11m
5215,1,Tehe,3733,118,7,0,7,100.0%,10m
5215,2,[Viprs]FascisTerran,3733,216,7,13,20,35.0%,26m
5215,2,[468946]MasterChief,3733,86,3,5,8,37.5%,27m
5215,1,saixy,3733,97,2,0,2,100.0%,19m
5215,2,Mirage,3733,30,1,3,4,25.0%,8m
5230,1,ITZY,3732,1851,168,174,342,49.1%,15m
5230,2,[SHGx]Datrax,3732,229,11,10,21,52.4%,17m
5230,2,[KoyBee]TROTSKY,3732,202,8,8,16,50.0%,26m
5230,2,Arawr,3732,170,6,3,9,66.7%,11m
5230,2,[Teho]Blduck,3732,30,1,6,7,14.3%,15m
5230,2,[FainF]XxFETTESAUxX,3732,0,0,1,1,0.0%,8m
5236,1,Rogba,3731,1842,248,201,449,55.2%,3m
5236,1,KoScHmArChE,3731,855,148,142,290,51.0%,6m
5236,2,llllllllllll,3731,420,19,8,27,70.4%,15m
5236,2,Nemesis,3731,0,3,2,5,60.0%,14m
5236,2,AndrewPUDGE,3731,57,3,3,6,50.0%,27m
5236,2,[Jedi]Markov,3731,30,1,2,3,33.3%,6m
5236,2,cycofrog,3731,30,1,3,4,25.0%,24m
5243,2,Morpheus,3730,1630,243,222,465,52.3%,16m
5243,2,AzOtE,3730,1176,130,124,254,51.2%,11m
5243,2,Саша,3730,1368,92,57,149,61.7%,15m
5243,2,Geronimo,3730,1060,40,42,82,48.8%,27m
5243,2,Benden,3730,876,31,33,64,48.4%,5m
5243,1,[DisES]Pedrolito,3730,332,8,22,30,26.7%,12m
5243,2,jUNgLe,3730,150,6,8,14,42.9%,12m
5243,2,TheNonschi,3730,0,0,1,1,0.0%,15m
5251,1,[mfxed]Zildan,3729,1814,310,313,623,49.8%,8m
5251,1,BELUNI,3729,1836,241,248,489,49.3%,7m
5251,2,MrTwiISTeR,3729,462,16,19,35,45.7%,25m
5251,2,Rabkin,3729,148,5,6,11,45.5%,18m
5251,2,[Fridge]Shiro,3729,112,3,0,3,100.0%,5m
5251,2,[ELQ]Daniel,3729,0,0,2,2,0.0%,24m
5251,2,[RIML]Maru,3729,0,0,2,2,0.0%,10m
5251,2,[VAǂ]Tjatte,3729,0,0,3,3,0.0%,26m
5259,2,Deidrekem,3728,1482,282,273,555,50.8%,24m
5259,1,[ZZW]DNA,3728,1828,145,139,284,51.1%,26m
5259,2,ILikeButter,3728,1200,55,66,121,45.5%,8m
5259,2,YourMuMisEZ,3728,0,1,0,1,100.0%,18m
5259,2,[TEPCO]SPARTORN,3728,30,1,2,3,33.3%,18m
5259,2,MasterPendal,3728,32,1,9,10,10.0%,3m
5259,2,Link,3728,0,0,1,1,0.0%,27m
5259,2,dyckfarts,3728,0,0,1,1,0.0%,5m
5267,2,sila,3727,1628,133,124,257,51.8%,15m
5267,2,Leopard,3727,751,65,63,128,50.8%,15m
5267,2,IvanDurak,3727,897,40,28,68,58.8%,6m
5267,2,PandaBear,3727,669,29,17,46,63.0%,10m
5267,2,Bbqfeet,3727,394,14,8,22,63.6%,19m
5267,2,CRONOS,3727,54,3,7,10,30.0%,26m
5267,2,[Maison]Minato,3727,99,2,3,5,40.0%,6m
5267,2,[RIP007]allexx,3727,0,1,0,1,100.0%,7m
5267,1,MiNdReAdEr,3727,0,1,0,1,100.0%,5m
5267,2,AlphaZero,3727,0,0,1,1,0.0%,7m
5267,2,Deadinside,3727,0,0,1,1,0.0%,8m
5267,2,[QRQ]lapa,3727,0,0,2,2,0.0%,11m
5279,1,[Sarmat]Mewa,3726,1750,178,145,323,55.1%,9m
5279,2,MarineKing,3726,1403,108,101,209,51.7%,7m
5279,2,[FD030]HunterMG,3726,1252,68,77,145,46.9%,5m
5279,2,Maraudeur,3726,514,27,10,37,73.0%,4m
5279,2,[NoobIP]Lucifer,3726,657,26,19,45,57.8%,26m
5279,2,Nameless,3726,479,24,15,39,61.5%,14m
5279,2,MagicProtoss,3726,189,13,8,21,61.9%,15m
5279,2,[ШОУМЕН]Amur,3726,318,12,15,27,44.4%,8m
5279,2,Sashamon,3726,322,11,12,23,47.8%,8m
5288,2,IIIIIIIIIIII,3725,494,20,8,28,71.4%,7m
5288,2,Cloud,3725,307,14,23,37,37.8%,26m
5288,2,ElCapitain,3725,287,12,2,14,85.7%,26m
5288,2,SergoF,3725,176,7,3,10,70.0%,26m
5288,2,llllllllllll,3725,136,6,1,7,85.7%,26m
5288,2,GeneralKNobi,3725,58,2,1,3,66.7%,27m
5294,2,MysteryMq,3724,1411,62,47,109,56.9%,26m
5294,2,IIIIIIIIIIII,3724,997,56,54,110,50.9%,24m
5294,1,ADAMBOS,3724,1512,46,56,102,45.1%,7m
5294,2,noxtherox,3724,394,15,15,30,50.0%,10m
5294,2,[FUCBOY]Stracatela,3724,374,13,14,27,48.1%,11m
5294,2,ISKOlovesYOU,3724,140,5,6,11,45.5%,16m
5294,2,spaceLucky,3724,58,2,7,9,22.2%,25m
5294,2,Pitchbowl,3724,0,0,2,2,0.0%,18m
5294,2,Jknighty,3724,0,0,2,2,0.0%,16m
5294,2,[IReStI]Klimor,3724,0,0,4,4,0.0%,27m
5304,2,Sarno,3723,629,112,117,229,48.9%,7m
5304,2,Yeah,3723,772,63,67,130,48.5%,15m
5304,2,[Dobro]Cactus,3723,846,33,31,64,51.6%,5m
5304,2,[GRONOT]InfestedPoli,3723,814,29,31,60,48.3%,5m
5304,2,[OWLCO]MaxInk,3723,425,21,12,33,63.6%,7m
5304,2,Craw,3723,396,14,17,31,45.2%,27m
5304,2,MeNoBrain,3723,218,9,5,14,64.3%,11m
5304,2,Valerio,3723,259,9,14,23,39.1%,18m
5304,2,[EuroS]Roygbiv,3723,118,5,5,10,50.0%,6m
5304,2,[CrBees]Fighter,3723,0,1,0,1,100.0%,18m
5314,2,Xarien,3722,761,55,45,100,55.0%,16m
5314,2,[NeGsyS]Ygdragzil,3722,1118,51,35,86,59.3%,26m
5314,2,Gruba,3722,345,23,7,30,76.7%,24m
5314,2,Green,3722,351,18,11,29,62.1%,2m
5314,2,willus,3722,416,16,11,27,59.3%,11m
5314,2,[HBGSJR]deaded,3722,174,7,5,12,58.3%,26m
5314,2,Dranik,3722,58,3,0,3,100.0%,27m
5314,2,exbugs,3722,30,1,2,3,33.3%,10m
5314,1,[Didim]Fckling,3722,0,0,1,1,0.0%,8m
5314,2,[SSAC]JLoo,3722,0,0,3,3,0.0%,6m
5324,2,Icebarg,3721,1560,358,344,702,51.0%,18m
5324,2,[BRCU]NaamaVanukka,3721,1222,48,49,97,49.5%,9m
5324,2,[MoopyS]Eternity,3721,463,22,21,43,51.2%,16m
5324,2,[SRDRG]XIX,3721,470,17,19,36,47.2%,16m
5324,2,[H0C]Strygwyr,3721,458,15,20,35,42.9%,9m
5324,2,[jCr]TriXxx,3721,142,7,8,15,46.7%,27m
5324,2,[YEP4VR]Fire,3721,103,4,4,8,50.0%,17m
5324,1,BarelyAlive,3721,48,2,3,5,40.0%,2m
5332,1,lippy,3720,1825,486,479,965,50.4%,11m
5332,2,DJAY,3720,756,144,126,270,53.3%,27m
5332,2,Exlxaxl,3720,1641,67,62,129,51.9%,6m
5332,2,aLLora,3720,844,37,27,64,57.8%,14m
5332,2,[CFeS]Matador,3720,768,31,24,55,56.4%,14m
5332,2,NaRa,3720,450,21,14,35,60.0%,4m
5332,2,Dark,3720,336,21,24,45,46.7%,27m
5332,2,Nagasch,3720,240,14,11,25,56.0%,16m
5332,2,Грандмастер,3720,308,12,11,23,52.2%,27m
5332,2,Potet,3720,144,5,8,13,38.5%,25m
5332,2,BobRoss,3720,30,2,3,5,40.0%,9m
5343,2,[Edream]Serenity,3719,1580,508,488,996,51.0%,10m
5343,1,Lokal,3719,1726,428,439,867,49.4%,19m
5343,1,[Knäck]MooseMasher,3719,1594,335,333,668,50.1%,7m
5343,2,Noose,3719,792,88,47,135,65.2%,25m
5343,2,[Heroes]Cloud,3719,112,5,0,5,100.0%,8m
5343,2,IISFISH,3719,114,4,2,6,66.7%,26m
5343,2,EricMX,3719,58,3,0,3,100.0%,11m
5350,2,[IndyK]McClane,3718,836,150,141,291,51.5%,24m
5350,2,Rajuuken,3718,1278,132,135,267,49.4%,6m
5350,2,[BMNL]Bartaggio,3718,1436,97,97,194,50.0%,18m
5350,2,[lOoOl]foREVer,3718,713,32,14,46,69.6%,6m
5350,2,Caltenbruner,3718,450,19,4,23,82.6%,3m
5350,2,Serral,3718,341,15,3,18,83.3%,26m
5350,2,llllllllllll,3718,369,15,6,21,71.4%,12m
5350,3,Korol,3718,191,9,3,12,75.0%,15m
5350,2,[OFUR]Ölvi,3718,200,8,7,15,53.3%,15m
5350,1,Yoyo,3718,213,7,1,8,87.5%,13m
5360,2,graNite,3717,1746,170,153,323,52.6%,16m
5360,2,[ƔĘƝ]Valerian,3717,1059,65,58,123,52.8%,24m
5360,2,[bugPP]SMURFIN,3717,682,41,26,67,61.2%,25m
5360,2,[Animoo]Dannie,3717,756,37,37,74,50.0%,24m
5360,2,wApfeddex,3717,550,20,25,45,44.4%,12m
5360,3,BrutalCat,3717,185,10,2,12,83.3%,19m
5360,2,TzarOK,3717,112,7,0,7,100.0%,8m
5360,3,[lOoOl]TGNP,3717,0,1,0,1,100.0%,17m
5360,2,dottt,3717,30,1,3,4,25.0%,24m
5369,2,Uzumumv,3716,1604,305,300,605,50.4%,18m
5369,2,EtamiN,3716,1169,113,87,200,56.5%,15m
5369,2,slothdemon,3716,1381,76,70,146,52.1%,16m
5369,2,[Link23]LnkTecFischi,3716,720,32,18,50,64.0%,5m
5369,2,[cFADDA]KoloSSaL,3716,640,25,28,53,47.2%,16m
5369,2,mvtonyss,3716,323,16,7,23,69.6%,8m
5369,2,[SSheep]SuicideSheep,3716,218,9,2,11,81.8%,24m
5369,2,[PLA2N]Tokyo,3716,86,4,3,7,57.1%,16m
5369,2,Xclusive,3716,0,1,0,1,100.0%,27m
5369,2,koku,3716,0,0,1,1,0.0%,11m
5369,2,WinterSC,3716,0,0,1,1,0.0%,7m
5380,2,Rêgo,3715,1633,150,152,302,49.7%,7m
5380,2,banker,3715,1309,84,70,154,54.5%,16m
5380,2,[GAMI]Veyux,3715,936,39,31,70,55.7%,7m
5380,2,Staskesensei,3715,436,17,15,32,53.1%,5m
5380,1,bcrmz,3715,589,16,27,43,37.2%,13m
5380,2,[AHT]Saturos,3715,378,14,16,30,46.7%,12m
5380,3,IIIIIIIIIIII,3715,332,11,9,20,55.0%,10m
5380,2,Dymchik,3715,124,5,14,19,26.3%,25m
5380,2,Leo,3715,86,3,2,5,60.0%,16m
5380,2,Pipain,3715,0,1,1,2,50.0%,26m
5390,2,Bateman,3714,1507,243,227,470,51.7%,6m
5390,2,[BuO]LULkAKTUS,3714,172,7,4,11,63.6%,24m
5390,2,Tyberius,3714,0,1,0,1,100.0%,27m
5390,2,[NHrz]ShiWaii,3714,0,0,2,2,0.0%,27m
5394,2,[Hrr]Nikso,3713,658,88,82,170,51.8%,15m
5394,2,[FlexIN]Yamato,3713,58,3,1,4,75.0%,5m
5394,1,Textonic,3713,48,2,6,8,25.0%,12m
5394,1,Simple,3713,46,1,16,17,5.9%,14m
5394,2,[EMST]MapKyc,3713,0,0,1,1,0.0%,28m
5399,2,Rain,3712,1491,312,312,624,50.0%,15m
5399,2,lithopedion,3712,1554,263,247,510,51.6%,7m
5399,2,Virtue,3712,1543,117,114,231,50.6%,27m
5399,2,RainbowJeZ,3712,1537,86,81,167,51.5%,3m
5399,2,[ADVIA]InterNeto,3712,891,66,55,121,54.5%,26m
5399,2,aaron,3712,922,65,70,135,48.1%,18m
5399,2,[AoW]AoWAraGorn,3712,544,25,11,36,69.4%,8m
5399,2,[КХЕ]ComradeArtem,3712,0,1,0,1,100.0%,5m
5399,2,BuBble,3712,30,1,3,4,25.0%,6m
5399,3,cloy,3712,0,0,1,1,0.0%,4m
5409,2,IronSide,3711,292,10,16,26,38.5%,8m
5409,2,Tabithy,3711,60,3,5,8,37.5%,7m
5409,2,[Kingz]Mondragon,3711,0,2,3,5,40.0%,16m
5409,2,Salattasche,3711,32,1,4,5,20.0%,16m
5409,3,[DBr]HyneK,3711,0,0,5,5,0.0%,18m
5414,1,Booyah,3710,1696,154,151,305,50.5%,25m
5414,2,[KDV]lukat,3710,1541,104,107,211,49.3%,17m
5414,2,ToYs,3710,621,37,37,74,50.0%,2m
5414,2,[tNb]michinoob,3710,791,35,35,70,50.0%,27m
5414,2,[BRSKR]MadTwatter,3710,443,20,14,34,58.8%,12m
5414,3,[SALTYY]Muori,3710,36,16,39,55,29.1%,9m
5414,3,[Утюги]NiceyO,3710,214,11,2,13,84.6%,18m
5414,2,LoBaakGo,3710,0,4,1,5,80.0%,26m
5414,2,Rantor,3710,0,0,1,1,0.0%,11m
5414,2,Winner,3710,0,0,1,1,0.0%,25m
5414,2,tryharder,3710,0,0,1,1,0.0%,16m
5425,1,[WBO]Bucky,3709,1748,363,372,735,49.4%,6m
5425,2,DrGreenthumb,3709,964,55,11,66,83.3%,7m
5425,1,[ǂVVVǂ]Aramis,3709,697,20,30,50,40.0%,13m
5425,3,Benden,3709,306,14,5,19,73.7%,18m
5425,2,єМагвітер,3709,30,2,0,2,100.0%,26m
5425,2,Somename,3709,58,2,3,5,40.0%,8m
5425,2,noskill,3709,0,1,0,1,100.0%,7m
5432,2,[WaWRuS]RAMBO,3708,1593,618,607,1225,50.4%,4m
5432,2,SmuGash,3708,1594,165,167,332,49.7%,24m
5432,2,BabaVoss,3708,1588,115,112,227,50.7%,12m
5432,2,Remirez,3708,1129,88,79,167,52.7%,7m
5432,2,djogedj,3708,1538,64,62,126,50.8%,7m
5432,2,Gambos,3708,679,35,16,51,68.6%,9m
5432,1,wickedsick,3708,772,20,37,57,35.1%,4m
5432,3,Anomaly,3708,86,3,1,4,75.0%,18m
5432,3,Oleg,3708,0,1,0,1,100.0%,11m
5432,2,[TAW]VenomEuro,3708,30,1,2,3,33.3%,16m
5432,2,SmoothYBuBB,3708,0,0,1,1,0.0%,19m
5432,2,Mediocretes,3708,0,0,2,2,0.0%,4m
5444,1,[MiMs]Zarbula,3707,1826,189,213,402,47.0%,13m
5444,2,[TeamJ]moratim,3707,1558,148,159,307,48.2%,18m
5444,2,[PaniC]ДжохниПрогей,3707,1592,98,77,175,56.0%,15m
5444,2,[CARBS]Joker,3707,854,80,63,143,55.9%,7m
5444,2,Binki,3707,1235,77,72,149,51.7%,18m
5444,2,NemesiS,3707,1035,72,35,107,67.3%,3m
5444,2,aLL,3707,972,38,38,76,50.0%,4m
5444,3,DioS,3707,233,11,2,13,84.6%,11m
5444,2,Greiv,3707,304,10,23,33,30.3%,18m
5444,2,Jaraxus,3707,202,7,8,15,46.7%,11m
5444,2,[Deezer]SpK,3707,186,7,18,25,28.0%,2m
5444,2,BeHappy,3707,120,4,6,10,40.0%,6m
5444,2,[B3est]ragner,3707,0,1,0,1,100.0%,24m
5457,2,[Heroes]Fele,3706,1562,278,268,546,50.9%,18m
5457,2,Lord,3706,1396,168,138,306,54.9%,11m
5457,2,Benas,3706,1638,159,138,297,53.5%,7m
5457,2,Dummy,3706,825,123,113,236,52.1%,10m
5457,2,astro,3706,666,37,27,64,57.8%,8m
5457,2,[LGNDS]Delta,3706,602,25,23,48,52.1%,7m
5457,2,[K0mpis]SkalmaN,3706,438,15,20,35,42.9%,25m
5457,2,simphunter,3706,204,11,2,13,84.6%,24m
5457,2,Nahkis,3706,148,5,8,13,38.5%,16m
5457,2,[ПОПА]PIskaSTroy,3706,100,4,12,16,25.0%,11m
5457,3,[YeRlN]ler,3706,30,2,2,4,50.0%,15m
5457,2,[HBGSJR]Maxvel,3706,0,1,0,1,100.0%,11m
5469,2,RandomFish,3705,597,128,117,245,52.2%,27m
5469,2,[IХLGSS]Daedra,3705,1416,76,70,146,52.1%,27m
5469,2,[KVOID]CandyShy,3705,1099,67,41,108,62.0%,9m
5469,1,Ziiim,3705,1553,54,62,116,46.6%,14m
5469,2,Valdemar,3705,635,28,30,58,48.3%,18m
5469,2,[BootyD]TomatoFORCE,3705,423,19,12,31,61.3%,7m
5469,2,num,3705,296,10,9,19,52.6%,26m
5469,2,[PezEz]IHateProtoss,3705,118,4,5,9,44.4%,12m
5469,2,kaskavel,3705,30,1,4,5,20.0%,18m
5469,2,LarryDavid,3705,0,0,1,1,0.0%,13m
5479,2,barcode,3704,1322,54,54,108,50.0%,27m
5479,1,DrJhonnySins,3704,183,9,1,10,90.0%,26m
5479,2,CrunK,3704,90,4,4,8,50.0%,11m
5479,2,Ammko,3704,122,4,7,11,36.4%,26m
5479,2,Leepkij,3704,0,0,1,1,0.0%,7m
5484,2,[ЯD]Prospect,3703,1360,78,67,145,53.8%,7m
5484,1,AbdulAkbar,3703,1265,62,74,136,45.6%,8m
5484,2,Eikasang,3703,308,12,4,16,75.0%,2m
5484,3,hydrerouge,3703,254,7,8,15,46.7%,24m
5484,2,[Rofler]Enigma,3703,118,5,5,10,50.0%,26m
5484,2,Ourlad,3703,57,2,5,7,28.6%,12m
5484,2,Pepero,3703,0,1,0,1,100.0%,8m
5484,2,CannaBicol,3703,0,0,1,1,0.0%,4m
5492,2,Dionys,3702,349,30,34,64,46.9%,14m
5492,2,idk,3702,442,19,12,31,61.3%,4m
5492,2,[SSC2]Aleksandr,3702,534,18,28,46,39.1%,4m
5492,2,IIIIIIIIIIII,3702,422,14,20,34,41.2%,12m
5492,2,[ENVOL]boTUIHok,3702,226,9,9,18,50.0%,16m
5492,2,[ЯD]Bobicus,3702,156,6,10,16,37.5%,15m
5492,2,Nighthawk,3702,62,3,3,6,50.0%,18m
5499,2,[TheDOH]Maxfly,3701,1002,305,301,606,50.3%,7m
5499,2,MajOrDanGeR,3701,1583,115,117,232,49.6%,26m
5499,2,[z1z1z1]mum,3701,1642,113,101,214,52.8%,7m
5499,2,[qDDSp]Phillie,3701,670,39,27,66,59.1%,25m
5499,2,Machine,3701,599,32,21,53,60.4%,4m
5499,2,Hydra,3701,162,9,2,11,81.8%,9m
5499,2,Urnec,3701,210,5,12,17,29.4%,27m
5499,2,[SFA]Irukandji,3701,0,1,0,1,100.0%,7m
5499,2,Doubt,3701,0,1,0,1,100.0%,25m
5499,3,Akkarin,3701,0,0,1,1,0.0%,15m
5499,2,Mooncake,3701,0,0,1,1,0.0%,12m
5499,2,Ganjhaman,3701,0,0,5,5,0.0%,10m
5511,2,FloDrows,3700,1371,86,87,173,49.7%,7m
5511,2,Explosive,3700,1165,59,28,87,67.8%,17m
5511,2,Jumbala,3700,527,30,18,48,62.5%,15m
5511,2,IlIlIlIlIIII,3700,528,21,19,40,52.5%,14m
5511,2,[EmŦ]ReVeNgE,3700,190,7,13,20,35.0%,8m
5511,2,[ƮesXG2]Mulemech,3700,87,3,4,7,42.9%,17m
5511,2,[ØC]Pandalord,3700,46,2,0,2,100.0%,14m
5511,3,MoreGG,3700,30,2,1,3,66.7%,17m
5511,2,[WOODYS]Korzan,3700,30,1,1,2,50.0%,15m
5520,2,JNspatten,3699,1495,304,288,592,51.4%,18m
5520,2,Dubblestep,3699,1605,125,113,238,52.5%,18m
5520,2,schatzgoblin,3699,1172,46,40,86,53.5%,9m
5520,2,ComradeTrump,3699,1002,41,36,77,53.2%,27m
5520,2,perceval,3699,867,36,46,82,43.9%,17m
5520,2,[HBGSJR]Zeidos,3699,695,35,33,68,51.5%,27m
5520,2,[PLA]champytoad,3699,462,15,25,40,37.5%,4m
5520,1,llllllllllll,3699,142,8,1,9,88.9%,4m
5520,1,[Hrr]Пупсеныш,3699,166,5,5,10,50.0%,15m
5520,1,[Krasty]NAkiddo,3699,0,1,0,1,100.0%,10m
5520,2,JBthefirst,3699,0,0,1,1,0.0%,8m
5520,2,Qwan,3699,0,0,1,1,0.0%,26m
5532,1,[KLDRi]Vuvuzela,3698,1813,178,162,340,52.4%,4m
5532,2,yeyeye,3698,871,60,63,123,48.8%,4m
5532,2,Bossmode,3698,1335,58,56,114,50.9%,18m
5532,2,BaseUnit,3698,1308,53,49,102,52.0%,11m
5532,2,[ValidG]Mac,3698,1065,46,42,88,52.3%,15m
5532,2,Florking,3698,703,35,37,72,48.6%,19m
5532,2,Baki,3698,490,31,26,57,54.4%,2m
5532,2,HolyJoseph,3698,823,31,29,60,51.7%,7m
5532,1,Serral,3698,834,24,38,62,38.7%,9m
5532,3,IIIIIIIIIII,3698,206,11,3,14,78.6%,17m
5532,2,Erebos,3698,58,3,3,6,50.0%,19m
5532,2,IIIIIIIIIIII,3698,0,2,3,5,40.0%,15m
5532,1,Synergy,3698,0,1,0,1,100.0%,26m
5532,2,[EESC]Supersonic,3698,0,1,2,3,33.3%,8m
5546,2,[CIique]WetLettuce,3697,696,24,32,56,42.9%,26m
5546,2,Zufallsgott,3697,454,23,8,31,74.2%,7m
5546,2,XereoArboron,3697,455,18,10,28,64.3%,7m
5546,2,[RitoTT]Autsch,3697,256,9,9,18,50.0%,7m
5546,2,Ari,3697,96,6,11,17,35.3%,24m
5546,3,Erebus,3697,112,4,2,6,66.7%,8m
5546,2,NutCrackee,3697,0,2,1,3,66.7%,24m
5546,2,Ahzenreï,3697,0,1,3,4,25.0%,26m
5546,3,Kawa,3697,0,0,4,4,0.0%,14m
5555,1,[HBGSJR]megadimon,3696,1441,95,104,199,47.7%,11m
5555,2,WannaBeSCV,3696,782,34,22,56,60.7%,4m
5555,2,Napster,3696,454,17,9,26,65.4%,7m
5555,2,[TAW]Baker,3696,434,15,20,35,42.9%,15m
5555,2,[IceHus]Lucker,3696,194,7,18,25,28.0%,2m
5555,2,GORELik,3696,58,3,2,5,60.0%,25m
5555,2,Rezolventa,3696,58,2,1,3,66.7%,25m
5555,2,VenoM,3696,0,0,1,1,0.0%,26m
5555,2,DALLAS,3696,0,0,4,4,0.0%,16m
5564,2,Massinisa,3695,1005,42,35,77,54.5%,4m
5564,2,tpfx,3695,784,36,18,54,66.7%,7m
5564,2,Tier,3695,376,14,20,34,41.2%,7m
5564,2,[EZ4XY]gshxd,3695,317,11,16,27,40.7%,15m
5564,2,trooper,3695,178,10,2,12,83.3%,14m
5564,2,PouleGéante,3695,30,5,2,7,71.4%,14m
5564,2,[TChain]AMAtheHAMMA,3695,94,4,10,14,28.6%,24m
5564,2,Osnazeni,3695,30,2,3,5,40.0%,19m
5564,2,[Dupie]Return,3695,30,1,2,3,33.3%,27m
5573,2,Mac,3694,720,58,14,72,80.6%,7m
5573,2,Peleandrin,3694,928,37,29,66,56.1%,27m
5573,2,Airmen,3694,422,19,10,29,65.5%,27m
5573,2,[mlem]TheBotanist,3694,222,8,10,18,44.4%,18m
5573,2,[SJSr]ChainBurn,3694,0,1,0,1,100.0%,5m
5578,2,[JWG]Skigur,3693,797,94,74,168,56.0%,4m
5578,2,[BLkSa]Susano,3693,940,39,34,73,53.4%,16m
5578,2,[PaniC]xxMVGNUMxx,3693,716,28,26,54,51.9%,18m
5578,2,SirGhost,3693,622,23,21,44,52.3%,2m
5578,2,OHWHY,3693,304,12,8,20,60.0%,24m
5578,2,Chadry,3693,146,5,8,13,38.5%,16m
5578,2,[ICFI]Xid,3693,0,1,1,2,50.0%,8m
5578,2,[Willma]Fergan,3693,0,0,3,3,0.0%,7m
5586,2,ЖАк,3692,1583,325,311,636,51.1%,11m
5586,2,Era,3692,1601,253,249,502,50.4%,7m
5586,2,Tonyace,3692,1247,90,60,150,60.0%,4m
5586,2,marc,3692,876,37,36,73,50.7%,16m
5586,2,mysterium,3692,206,29,35,64,45.3%,15m
5586,2,Laroi,3692,254,10,6,16,62.5%,2m
5586,3,Shibal,3692,220,7,4,11,63.6%,19m
5586,2,[Shukun]lemortel,3692,148,6,4,10,60.0%,24m
5586,2,[Avveck]aGPizzaBoy,3692,30,2,0,2,100.0%,15m
5586,2,Kelthuzda,3692,0,0,1,1,0.0%,11m
5596,2,[KDV]KerivePL,3691,1549,286,289,575,49.7%,17m
5596,2,Sparvagn,3691,1287,55,42,97,56.7%,7m
5596,2,EvilMentat,3691,753,38,28,66,57.6%,18m
5596,2,FeuzG,3691,590,37,12,49,75.5%,7m
5596,2,Lazare,3691,781,34,22,56,60.7%,9m
5596,2,[EYSAT]Meldior,3691,595,29,29,58,50.0%,15m
5596,2,salaheddine,3691,165,10,1,11,90.9%,27m
5596,2,Axiomel,3691,196,7,6,13,53.8%,28m
5596,2,[SxOxM]iLoveVicky,3691,142,5,5,10,50.0%,15m
5596,2,[Froze]Elsa,3691,116,4,3,7,57.1%,7m
5596,2,[aW]Audric,3691,60,3,3,6,50.0%,27m
5596,2,discordgf,3691,0,1,1,2,50.0%,7m
5596,2,[Heroes]selbster,3691,30,1,4,5,20.0%,15m
5609,2,ThirtyThree,3690,1480,197,200,397,49.6%,7m
5609,2,EVOLUTİONX,3690,550,147,139,286,51.4%,24m
5609,2,iathsdeia,3690,1606,74,68,142,52.1%,8m
5609,2,[RеG]ZOOOM,3690,830,30,31,61,49.2%,18m
5609,2,[Hаsu]Ajax,3690,448,18,22,40,45.0%,8m
5609,2,FRANZITO,3690,30,2,1,3,66.7%,26m
5609,3,[PiGPan]TripleHelix,3690,62,2,9,11,18.2%,16m
5609,2,nTla,3690,0,1,0,1,100.0%,7m
5609,2,[PiGPan]sneakyleming,3690,0,1,0,1,100.0%,14m
5618,2,Justelis,3689,1125,195,188,383,50.9%,7m
5618,1,[сSсǃ]Мороженко,3689,1518,75,56,131,57.3%,8m
5618,2,Sherlock,3689,1370,62,58,120,51.7%,18m
5618,2,[TITTIT]ILuvZilina,3689,1334,51,48,99,51.5%,12m
5618,2,[RevoGG]iSy,3689,722,28,22,50,56.0%,15m
5618,2,[TerBHD]Cuthbert,3689,352,14,10,24,58.3%,7m
5618,2,Paradise,3689,102,7,0,7,100.0%,11m
5618,1,Terrantula,3689,118,7,1,8,87.5%,4m
5618,2,Pajamas,3689,114,4,3,7,57.1%,4m
5618,2,FiNiTioN,3689,0,3,2,5,60.0%,6m
5618,3,majic,3689,0,0,1,1,0.0%,3m
5618,2,genius,3689,0,0,1,1,0.0%,25m
5618,2,ProMarines,3689,0,0,1,1,0.0%,27m
5631,2,Косолапый,3688,1600,71,69,140,50.7%,25m
5631,2,fjjotizz,3688,1081,47,41,88,53.4%,25m
5631,2,max,3688,374,12,19,31,38.7%,5m
5631,2,[JeanKu]JeanBalSec,3688,148,5,8,13,38.5%,8m
5631,2,Joeyy,3688,0,0,1,1,0.0%,25m
5636,2,kaniteller,3687,1568,189,190,379,49.9%,27m
5636,2,Panopticon,3687,734,32,28,60,53.3%,28m
5638,2,xxxNARUTOxxx,3686,1475,146,141,287,50.9%,16m
5638,2,Strong,3686,1440,55,52,107,51.4%,15m
5638,2,VeNDeTTa,3686,679,50,45,95,52.6%,26m
5638,2,MikeHawk,3686,301,11,10,21,52.4%,10m
5638,2,NekoChan,3686,188,10,3,13,76.9%,24m
5638,3,mobo,3686,145,5,6,11,45.5%,15m
5638,2,Cypher,3686,38,3,7,10,30.0%,12m
5638,2,[Animе]Кексик,3686,30,2,2,4,50.0%,25m
5638,2,[Take]pilzkopf,3686,30,1,5,6,16.7%,6m
5638,2,[LøL]JiKu,3686,0,1,5,6,16.7%,7m
5638,2,Bigelou,3686,0,0,1,1,0.0%,10m
5649,2,Dopamine,3685,1585,171,156,327,52.3%,16m
5649,2,pOKEMON,3685,606,25,15,40,62.5%,12m
5649,2,GnarK,3685,230,7,17,24,29.2%,25m
5649,2,lIIIIlllllIl,3685,176,6,3,9,66.7%,26m
5649,2,dolan,3685,140,5,4,9,55.6%,26m
5649,3,[evi1]fulgertuney,3685,0,1,1,2,50.0%,14m
5649,3,Flammeur,3685,0,0,2,2,0.0%,7m
5656,2,asdf,3684,346,17,9,26,65.4%,26m
5656,2,ForWin,3684,296,12,5,17,70.6%,25m
5656,2,Equalizer,3684,200,7,4,11,63.6%,27m
5656,2,[Zünd]Lollymonster,3684,34,2,4,6,33.3%,15m
5656,2,[AI1]VeeRust,3684,58,2,4,6,33.3%,15m
5656,2,[SKHG]gamepro,3684,0,0,1,1,0.0%,9m
5656,2,Taptap,3684,0,0,5,5,0.0%,8m
5663,2,Poussy,3683,1685,464,461,925,50.2%,11m
5663,2,Latteless,3683,1084,117,108,225,52.0%,25m
5663,2,[TZCrew]Spiro,3683,1130,42,41,83,50.6%,14m
5663,2,[IIDTCI]rybnik,3683,773,29,40,69,42.0%,12m
5663,2,Mandalorian,3683,349,17,13,30,56.7%,9m
5663,2,[ArShrk]SharKMouZ,3683,402,15,15,30,50.0%,16m
5663,2,IIIIIIIIIIII,3683,278,13,7,20,65.0%,7m
5663,2,[RDrewf]MKH,3683,152,5,16,21,23.8%,24m
5663,2,IIIIIIIIIIII,3683,60,3,2,5,60.0%,24m
5663,1,[Rüfos]celphy,3683,97,3,4,7,42.9%,13m
5663,2,[RoBotS]lNnoVation,3683,0,0,1,1,0.0%,18m
5663,2,Yandex,3683,0,0,1,1,0.0%,16m
5675,2,[bettyF]Nick,3682,1577,92,91,183,50.3%,12m
5675,2,GrantCardone,3682,774,27,33,60,45.0%,5m
5675,1,hateYou,3682,166,8,1,9,88.9%,10m
5675,1,[KDV]lobendz,3682,0,1,1,2,50.0%,10m
5675,2,Blueszz,3682,0,0,3,3,0.0%,4m
5680,2,Tom,3681,683,94,73,167,56.3%,4m
5680,2,CASHFORHASH,3681,1472,75,67,142,52.8%,6m
5680,2,BigFatDonkey,3681,1443,74,51,125,59.2%,6m
5680,2,Lowie,3681,516,20,15,35,57.1%,14m
5680,2,[DYPKA]Askilad,3681,370,19,9,28,67.9%,12m
5680,3,Ponta,3681,325,15,4,19,78.9%,6m
5680,2,[oneA]Chimptacular,3681,395,13,20,33,39.4%,15m
5680,2,UareFakeNews,3681,213,6,2,8,75.0%,24m
5680,2,Alelka,3681,30,1,6,7,14.3%,11m
5689,2,Kicker,3680,1017,161,130,291,55.3%,7m
5689,2,SmokeFast,3680,824,59,57,116,50.9%,18m
5689,2,[Blacer]BleakLord,3680,1182,49,50,99,49.5%,11m
5689,2,[glBn]Zergantos,3680,650,24,20,44,54.5%,7m
5689,2,[SKR]Bender,3680,482,18,13,31,58.1%,14m
5689,2,Matt,3680,86,4,0,4,100.0%,6m
5689,2,Kentucky,3680,100,4,6,10,40.0%,7m
5689,1,[Пуцка]NewDedhawana,3680,0,1,1,2,50.0%,16m
5697,2,croco,3679,1333,110,94,204,53.9%,6m
5697,1,[Didim]Meglomaniac,3679,1664,90,85,175,51.4%,7m
5697,2,[LMBD]Seraph,3679,1556,79,80,159,49.7%,7m
5697,2,[EXC]Devotee,3679,443,33,27,60,55.0%,27m
5697,2,hqbrutal,3679,0,2,7,9,22.2%,26m
5697,2,CraZyJ,3679,0,0,1,1,0.0%,8m
5697,2,thugplay,3679,0,0,1,1,0.0%,27m
5704,2,[CTVVMB]Gardakan,3678,1609,191,159,350,54.6%,26m
5704,2,[KNT]proxyBC,3678,1541,153,151,304,50.3%,18m
5704,2,Valentin,3678,1546,108,112,220,49.1%,26m
5704,2,Rainbow,3678,1352,50,53,103,48.5%,11m
5704,2,ssgta,3678,854,33,35,68,48.5%,7m
5704,2,Mate,3678,484,23,13,36,63.9%,8m
5704,2,Mapusan,3678,286,11,12,23,47.8%,7m
5704,2,Klol,3678,188,10,3,13,76.9%,14m
5704,2,InGodsName,3678,146,4,4,8,50.0%,8m
5704,2,[7x]Ravengg,3678,124,4,7,11,36.4%,7m
5704,1,Jart,3678,48,1,3,4,25.0%,10m
5704,2,[ENV]BAATT,3678,0,0,1,1,0.0%,27m
5716,2,[F0sK]CrazYMaestro,3677,552,35,33,68,51.5%,10m
5716,2,Mrjonson,3677,455,21,16,37,56.8%,27m
5716,2,AboryM,3677,30,1,1,2,50.0%,16m
5716,2,[Smegma]KingLouie,3677,0,0,1,1,0.0%,28m
5720,2,ClownFiesta,3676,1481,65,47,112,58.0%,4m
5720,2,[SQLAN]Lyngan,3676,843,36,26,62,58.1%,7m
5720,2,[RioF]fraat,3676,782,32,25,57,56.1%,11m
5720,2,ölnö,3676,437,22,10,32,68.8%,12m
5720,1,[SPFAN]Jaco,3676,164,8,1,9,88.9%,26m
5720,2,[f0rtt5]BusæÑorose,3676,175,4,8,12,33.3%,12m
5720,2,[DonaId]Trump,3676,76,3,5,8,37.5%,7m
5720,2,IIIIIIIIIIII,3676,30,1,1,2,50.0%,11m
5720,2,troitatam,3676,0,0,4,4,0.0%,25m
5729,2,Makc,3675,1503,103,83,186,55.4%,15m
5729,2,[Arrows]IvanKoghedub,3675,1133,103,105,208,49.5%,27m
5729,2,Kdude,3675,275,48,54,102,47.1%,16m
5729,2,Shadowfiend,3675,783,44,32,76,57.9%,17m
5729,2,ЗлойКошарик,3675,430,17,16,33,51.5%,11m
5729,2,[neuroW]Avatron,3675,320,12,9,21,57.1%,18m
5729,3,IIIIIIIIII,3675,236,9,2,11,81.8%,17m
5729,2,Sora,3675,118,5,7,12,41.7%,25m
5729,2,[nB]Elie,3675,0,0,1,1,0.0%,4m
5729,2,FLORIN,3675,0,0,1,1,0.0%,18m
5739,2,Kaiser,3674,1402,69,57,126,54.8%,24m
5739,2,MethMicro,3674,852,36,27,63,57.1%,15m
5739,2,AnTidote,3674,642,23,19,42,54.8%,6m
5739,2,Wut,3674,178,12,14,26,46.2%,5m
5739,2,[Xa]GenGaR,3674,172,6,6,12,50.0%,10m
5739,2,Chrthegreat,3674,30,1,1,2,50.0%,18m
5745,2,CoolewicZ,3673,1633,313,281,594,52.7%,4m
5745,2,[Stix]LeCo,3673,1568,170,165,335,50.7%,6m
5745,2,Listig,3673,1561,61,69,130,46.9%,15m
5745,2,[Galois]DocSnyder,3673,761,27,39,66,40.9%,18m
5745,2,[Dae]Will,3673,284,11,11,22,50.0%,18m
5745,2,BUS,3673,142,5,2,7,71.4%,7m
5745,2,[Kuh]Puyo,3673,0,2,3,5,40.0%,27m
5745,2,daling,3673,0,1,4,5,20.0%,28m
5745,2,Monch,3673,0,0,2,2,0.0%,16m
5754,1,[DeusV]Brian,3672,1663,93,111,204,45.6%,2m
5754,2,Yonggi,3672,1038,87,97,184,47.3%,2m
5754,1,[BMDR]ArEsǂDragon,3672,1372,58,63,121,47.9%,2m
5754,2,[AWESUM]Initiator,3672,1306,51,49,100,51.0%,25m
5754,2,[TV]EliumTV,3672,120,4,7,11,36.4%,11m
5754,2,[Watjuu]Smokemonster,3672,30,1,3,4,25.0%,25m
5754,2,[FFoHM]Footstomp,3672,0,0,1,1,0.0%,2m
5754,2,Milamber,3672,0,0,2,2,0.0%,11m
5754,2,Bond,3672,0,0,5,5,0.0%,25m
5763,2,SpecialForce,3671,872,154,110,264,58.3%,4m
5763,2,GTXR,3671,1299,150,128,278,54.0%,6m
5763,2,MaKroW,3671,836,66,45,111,59.5%,10m
5763,2,sword,3671,976,34,41,75,45.3%,15m
5763,2,[CFeS]Specter,3671,763,31,38,69,44.9%,5m
5763,2,Guido,3671,552,21,20,41,51.2%,25m
5763,2,[NIHED]evilke,3671,0,0,1,1,0.0%,8m
5770,2,Mellow,3670,1584,212,216,428,49.5%,4m
5770,2,[HAMPEL]Jayham,3670,1602,166,171,337,49.3%,16m
5770,2,[SPAINs]hzheng,3670,1612,106,106,212,50.0%,27m
5770,2,[BPX]derRichter,3670,1520,97,96,193,50.3%,10m
5770,2,xShogo,3670,360,14,13,27,51.9%,7m
5770,2,[WBO]iloveyou,3670,268,11,8,19,57.9%,6m
5770,2,WildPants,3670,114,11,12,23,47.8%,12m
5770,2,[HBGSJR]mchoma,3670,214,7,14,21,33.3%,8m
5770,3,Шахматенок,3670,56,3,0,3,100.0%,7m
5770,2,Hugo,3670,0,0,1,1,0.0%,6m
5780,2,Clark,3669,1575,143,137,280,51.1%,24m
5780,2,Burnyby,3669,478,98,91,189,51.9%,18m
5780,1,GHOST,3669,814,48,69,117,41.0%,13m
5780,2,yaniNacepqni,3669,464,16,20,36,44.4%,27m
5780,2,[ĦRZ]Skimer,3669,282,10,17,27,37.0%,18m
5780,1,followMLS,3669,213,9,2,11,81.8%,26m
5780,2,Chebyrec,3669,184,7,11,18,38.9%,26m
5780,2,Flopi,3669,30,1,2,3,33.3%,25m
5788,2,HTooL,3668,539,27,22,49,55.1%,27m
5788,2,Rebellx,3668,756,27,32,59,45.8%,27m
5788,1,Pazuzu,3668,758,19,37,56,33.9%,14m
5788,2,WhiteRabbit,3668,388,14,15,29,48.3%,27m
5788,2,[read]reudigekatze,3668,266,9,9,18,50.0%,7m
5788,2,Default,3668,176,7,7,14,50.0%,7m
5788,1,prodi,3668,112,5,10,15,33.3%,14m
5788,2,[eloelo]Shakur,3668,86,3,1,4,75.0%,18m
5788,2,[MWorld]DonCarleone,3668,0,0,2,2,0.0%,7m
5797,2,Fnordious,3667,1076,115,126,241,47.7%,19m
5797,2,specter,3667,1564,62,57,119,52.1%,3m
5797,2,MrNice,3667,692,46,27,73,63.0%,3m
5797,2,Yorkie,3667,830,33,36,69,47.8%,24m
5797,2,[QTclub]Sentinel,3667,271,10,12,22,45.5%,24m
5797,2,[BWArmy]LiGhtNinG,3667,196,8,4,12,66.7%,7m
5797,2,GHX,3667,94,4,9,13,30.8%,2m
5797,3,AthosTheOne,3667,0,0,1,1,0.0%,11m
5797,3,FRIZFOREVER,3667,0,0,2,2,0.0%,5m
5797,2,XOXO,3667,0,0,4,4,0.0%,5m
5807,2,Loskman,3666,1525,211,209,420,50.2%,24m
5807,2,MechItHappen,3666,1369,105,109,214,49.1%,18m
5807,2,drunkcraft,3666,1004,46,47,93,49.5%,18m
5807,2,[UATeam]HighHopes,3666,477,33,24,57,57.9%,19m
5807,2,Growl,3666,258,12,3,15,80.0%,16m
5807,2,Fer,3666,342,12,16,28,42.9%,11m
5807,3,Zamestnanec,3666,227,8,0,8,100.0%,26m
5807,2,[НТТ]DonLingo,3666,60,3,1,4,75.0%,25m
5807,2,MMRTHIEF,3666,30,2,0,2,100.0%,16m
5807,2,[DPCE]llllllllllll,3666,96,2,0,2,100.0%,8m
5807,2,TIToss,3666,0,0,1,1,0.0%,27m
5807,2,MаXGrig,3666,0,0,1,1,0.0%,16m
5807,3,blackbear,3666,0,0,1,1,0.0%,18m
5807,2,[WSTRN]HandShotXD,3666,0,0,2,2,0.0%,11m
5807,3,WhiteWolf,3666,0,0,4,4,0.0%,3m
5822,2,IIIIIIIIIIII,3665,1670,330,321,651,50.7%,27m
5822,2,[IIE]Lux,3665,1464,172,165,337,51.0%,12m
5822,1,max,3665,1800,135,141,276,48.9%,24m
5822,2,[Bbatal]PODIMONISSE,3665,829,84,54,138,60.9%,16m
5822,2,[SNMRTZ]Ilian,3665,1383,74,53,127,58.3%,24m
5822,2,JohnBlond,3665,1164,65,51,116,56.0%,7m
5822,2,JonyWoo,3665,447,48,29,77,62.3%,8m
5822,2,[Ntsyos]Skullface,3665,798,28,30,58,48.3%,27m
5822,1,Narisia,3665,233,10,2,12,83.3%,19m
5822,2,NeXT,3665,116,4,6,10,40.0%,27m
5822,2,napOLeOn,3665,114,4,7,11,36.4%,11m
5822,2,[WINTEX]Rapt0r_,3665,58,3,1,4,75.0%,7m
5822,2,[Tuki]TukiFocky,3665,90,3,5,8,37.5%,27m
5822,2,[biglol]marvel,3665,48,2,0,2,100.0%,25m
5822,2,Scribe,3665,58,2,7,9,22.2%,11m
5822,2,LEBONCARLOS,3665,0,0,1,1,0.0%,16m
5838,2,[Сold]Raul,3664,1613,336,334,670,50.1%,26m
5838,2,BlackBly,3664,1496,116,118,234,49.6%,5m
5838,2,[ÆVT]TerraNisImbA,3664,1073,99,99,198,50.0%,7m
5838,2,DeepOnes,3664,460,18,21,39,46.2%,18m
5838,2,KyleKatarn,3664,350,13,11,24,54.2%,4m
5838,2,sek,3664,236,12,14,26,46.2%,24m
5838,3,MexanikCH,3664,199,10,4,14,71.4%,17m
5838,3,drush,3664,184,10,7,17,58.8%,9m
5838,2,Wabbe,3664,203,9,7,16,56.2%,15m
5838,3,Waldum,3664,0,1,0,1,100.0%,7m
5838,2,[ØC]Antares,3664,0,0,2,2,0.0%,18m
5849,2,LeafKabbage,3663,1445,261,247,508,51.4%,7m
5849,2,oxymoron,3663,1415,187,196,383,48.8%,10m
5849,2,[FR1]BadBorz,3663,1173,53,36,89,59.6%,7m
5849,2,Paw,3663,668,45,47,92,48.9%,7m
5849,2,Osmics,3663,828,41,29,70,58.6%,7m
5849,1,Use,3663,537,14,26,40,35.0%,15m
5849,2,[CRL]Freeman,3663,355,12,11,23,52.2%,9m
5849,2,IBQ,3663,114,5,2,7,71.4%,12m
5849,2,Huck,3663,144,5,10,15,33.3%,18m
5849,2,[DisKCo]Cann,3663,30,2,0,2,100.0%,15m
5849,2,[KPGSC2]SeleiXi,3663,0,1,0,1,100.0%,7m
5849,2,[EFA]pRo,3663,0,0,1,1,0.0%,26m
5849,2,YoRHa,3663,0,0,1,1,0.0%,16m
5862,2,NetShadowXX,3662,1370,60,44,104,57.7%,8m
5862,2,TIMEbest,3662,583,32,30,62,51.6%,15m
5862,2,[SuAJo]Hita,3662,217,11,3,14,78.6%,2m
5862,2,SpaceOrc,3662,196,7,17,24,29.2%,25m
5862,2,[SkCzM]Peter,3662,86,3,4,7,42.9%,26m
5862,2,WhaAU,3662,30,1,3,4,25.0%,6m
5862,2,NIHOWMA,3662,0,0,1,1,0.0%,16m
5869,2,IIIIIIIIIIII,3661,1647,66,63,129,51.2%,12m
5869,2,Syduta,3661,813,34,38,72,47.2%,24m
5869,2,[RoAST]TeddyBagwell,3661,252,9,18,27,33.3%,27m
5869,2,Gidra,3661,168,7,4,11,63.6%,27m
5869,2,fura,3661,88,2,0,2,100.0%,3m
5869,2,TrãX,3661,30,1,12,13,7.7%,11m
5869,2,[3dfx]Voodoo,3661,0,0,1,1,0.0%,16m
5869,2,sid,3661,0,0,2,2,0.0%,11m
5869,2,[4X4]Wolfvrick,3661,0,0,5,5,0.0%,2m
5878,2,BerserK,3660,1556,76,75,151,50.3%,11m
5878,2,[Pylo]RnRoger,3660,647,57,46,103,55.3%,8m
5878,2,Zorro,3660,988,36,36,72,50.0%,27m
5878,2,[сSсǃ]Pakemon,3660,744,31,22,53,58.5%,8m
5878,2,WrathOfFlame,3660,708,29,25,54,53.7%,27m
5878,2,ChaineRubis,3660,200,8,6,14,57.1%,4m
5878,2,PiuPiu,3660,214,7,11,18,38.9%,7m
5878,2,Joens,3660,62,3,3,6,50.0%,6m
5878,2,IIIIIIIIIIII,3660,116,2,2,4,50.0%,15m
5878,2,[KyG]SLy,3660,0,0,1,1,0.0%,24m
5878,2,Hisoka,3660,0,0,1,1,0.0%,7m
5889,2,Jellyfish,3659,1143,112,95,207,54.1%,26m
5889,2,[KUG]ErlendRon,3659,1480,70,55,125,56.0%,7m
5889,2,PichorR,3659,463,23,12,35,65.7%,6m
5889,2,[sirW]Raku,3659,498,21,18,39,53.8%,18m
5889,2,Roxy,3659,88,2,1,3,66.7%,7m
5889,2,WiseTerran,3659,0,0,1,1,0.0%,9m
5889,2,[Bambi2]HellozL,3659,0,0,1,1,0.0%,11m
5889,2,Ayo,3659,0,0,1,1,0.0%,8m
5889,2,[CranKy]Daunted,3659,0,0,2,2,0.0%,24m
5889,2,MrdkaZkrtka,3659,0,0,2,2,0.0%,3m
5899,2,[AciNoN]TASSADAR,3658,1635,156,142,298,52.3%,27m
5899,2,[DFC]PrideofLight,3658,1448,111,96,207,53.6%,8m
5899,2,Nomak,3658,1542,89,100,189,47.1%,4m
5899,2,MrNew,3658,1448,62,69,131,47.3%,12m
5899,2,[lOoKer]DrAxelroose,3658,324,24,29,53,45.3%,7m
5899,2,[OРДА]FriendlyRUS,3658,206,10,8,18,55.6%,16m
5899,2,Hox,3658,152,6,2,8,75.0%,14m
5899,2,Akbar,3658,62,3,3,6,50.0%,7m
5899,2,[0VI]SicJack,3658,0,2,3,5,40.0%,10m
5899,2,DarthSchlexi,3658,0,0,2,2,0.0%,11m
5899,2,[Kicx]Keysen,3658,0,0,3,3,0.0%,26m
5910,1,[hf4X4]RichMond,3657,1773,94,115,209,45.0%,26m
5910,2,[Heroes]Newton,3657,1166,49,38,87,56.3%,25m
5910,2,[lMBA]THh,3657,1100,40,47,87,46.0%,2m
5910,2,Thiano,3657,164,9,2,11,81.8%,3m
5910,2,[EBIG]Duncan,3657,116,5,4,9,55.6%,6m
5910,2,BigJim,3657,86,4,1,5,80.0%,27m
5916,2,[WaSl]TheButcher,3656,651,27,23,50,54.0%,16m
5916,2,Dunno,3656,574,20,25,45,44.4%,9m
5916,2,[tAkTiC]Shiro,3656,364,13,17,30,43.3%,8m
5916,2,[Smoula]CzeEmperor,3656,288,11,11,22,50.0%,11m
5916,2,UgndaKnckleS,3656,137,8,0,8,100.0%,12m
5916,3,gabriel,3656,116,3,0,3,100.0%,26m
5916,2,[Tren]Naccer,3656,64,3,12,15,20.0%,26m
5916,2,[LmtdG]thebesciak,3656,0,0,1,1,0.0%,27m
5924,2,Emeraude,3655,1615,249,230,479,52.0%,2m
5924,2,pullen,3655,1448,88,82,170,51.8%,16m
5924,2,Haneke,3655,856,50,46,96,52.1%,2m
5924,2,Terrifin,3655,1002,43,56,99,43.4%,15m
5924,2,BigJoe,3655,546,28,13,41,68.3%,28m
5924,2,Caedus,3655,43,13,15,28,46.4%,27m
5924,2,ChemT,3655,322,12,13,25,48.0%,24m
5924,1,AramKa,3655,118,7,1,8,87.5%,10m
5924,2,Pmango,3655,202,7,12,19,36.8%,24m
5924,2,RageKing,3655,0,4,3,7,57.1%,14m
5924,2,[Razzle]Elkeezy,3655,62,3,3,6,50.0%,7m
5924,2,msR,3655,86,3,6,9,33.3%,27m
5924,2,lovegs,3655,0,1,0,1,100.0%,12m
5924,2,Kirigiri,3655,0,0,1,1,0.0%,26m
5924,2,eNVy,3655,0,0,1,1,0.0%,18m
5939,2,Boubou,3654,1601,265,248,513,51.7%,6m
5939,2,POL,3654,1589,122,98,220,55.5%,17m
5939,2,wekzzz,3654,1128,115,90,205,56.1%,10m
5939,2,[CivW]kjartan,3654,1558,113,125,238,47.5%,18m
5939,2,Tawa,3654,948,107,95,202,53.0%,24m
5939,2,Nikrosk,3654,1249,85,80,165,51.5%,25m
5939,2,miomaMo,3654,1326,80,62,142,56.3%,4m
5939,2,zagoun,3654,911,41,29,70,58.6%,8m
5939,2,[Hаsu]DobryuMultic,3654,515,23,17,40,57.5%,10m
5939,2,[T4E]odihimself,3654,300,10,11,21,47.6%,24m
5939,2,[PrStar]Illogic,3654,185,6,6,12,50.0%,7m
5939,2,VikivanDale,3654,124,5,9,14,35.7%,6m
5939,2,DarkKnight,3654,58,3,2,5,60.0%,25m
5939,2,TerranDisco,3654,0,1,0,1,100.0%,17m
5939,2,Panda,3654,0,0,1,1,0.0%,15m
5939,2,[NMCX]Xpeater,3654,0,0,1,1,0.0%,7m
5939,2,[0GKusH]uNreaLTT,3654,0,0,1,1,0.0%,26m
5956,2,Arturoh,3653,1599,377,362,739,51.0%,27m
5956,2,yondai,3653,1531,206,194,400,51.5%,28m
5956,2,[Oursbl]Kuberaz,3653,1276,78,56,134,58.2%,15m
5956,2,[Arrows]Samer,3653,1447,62,60,122,50.8%,7m
5956,2,[XIICCC]PrinceMarine,3653,385,14,9,23,60.9%,27m
5956,2,LiTiy,3653,156,7,3,10,70.0%,17m
5956,2,BlazeFort,3653,88,4,1,5,80.0%,26m
5956,2,Porty,3653,30,4,4,8,50.0%,8m
5956,2,ObeVonGraff,3653,30,1,1,2,50.0%,8m
5965,2,[CaBaL]LKJ,3652,1556,530,513,1043,50.8%,8m
5965,2,ChaimVital,3652,1624,104,103,207,50.2%,8m
5965,2,[FR1]Nicomouk,3652,871,41,27,68,60.3%,7m
5965,2,Roasted,3652,814,32,29,61,52.5%,7m
5965,2,sucseks,3652,441,21,11,32,65.6%,24m
5965,2,[SchamR]CptCapslock,3652,150,6,6,12,50.0%,24m
5965,2,Tuk,3652,86,3,1,4,75.0%,15m
5965,2,AlphaLegion,3652,30,2,0,2,100.0%,15m
5965,2,[Zsquad]Ostik,3652,0,0,1,1,0.0%,6m
5965,2,[SZ]Withen,3652,0,0,2,2,0.0%,7m
5965,2,HyperioN,3652,0,0,2,2,0.0%,7m
5976,2,NoLa,3651,866,46,45,91,50.5%,14m
5976,2,BarCode,3651,707,39,22,61,63.9%,6m
5976,2,Einsteinium,3651,956,33,42,75,44.0%,15m
5976,2,JeffChelios,3651,772,27,32,59,45.8%,12m
5976,2,[FRZS]Troizza,3651,694,24,28,52,46.2%,27m
5976,3,[Kipu4]eXoValdo,3651,160,5,3,8,62.5%,27m
5976,2,ghostar,3651,142,5,4,9,55.6%,25m
5976,2,даня,3651,60,3,3,6,50.0%,7m
5976,1,mkdir,3651,96,2,0,2,100.0%,14m
5976,2,[Siggi]Doncabrio,3651,0,1,0,1,100.0%,18m
5976,2,nomatch,3651,0,0,2,2,0.0%,25m
5987,2,Bomber,3650,837,94,97,191,49.2%,4m
5987,2,Laplada,3650,465,58,54,112,51.8%,25m
5987,2,[s182]Varax,3650,212,8,2,10,80.0%,25m
5987,2,[eZwins]perplex,3650,86,3,1,4,75.0%,24m
5987,3,LEEDK,3650,30,1,3,4,25.0%,18m
5987,2,[CCHP]MicroChelik,3650,0,0,2,2,0.0%,25m
5993,2,[CrøkeT]ElPijon,3649,1542,313,302,615,50.9%,11m
5993,2,Prcpt,3649,760,39,46,85,45.9%,18m
5993,2,[SCROo]SleazyWeazy,3649,477,22,11,33,66.7%,26m
5993,3,JacK,3649,351,16,8,24,66.7%,10m
5993,2,unLimiTed,3649,0,5,0,5,100.0%,7m
5993,2,Letozzzzzzzz,3649,94,3,7,10,30.0%,6m
5993,2,Fartosis,3649,30,2,0,2,100.0%,7m
5993,2,Kern,3649,30,2,1,3,66.7%,28m
5993,2,WAZR,3649,0,0,1,1,0.0%,26m
6002,2,[InFy]XRater,3648,1469,96,77,173,55.5%,26m
6002,2,[KDV]RaptownY,3648,956,88,69,157,56.1%,7m
6002,2,Marine,3648,321,37,10,47,78.7%,25m
6002,2,[L4DYS]MissHapen,3648,366,19,8,27,70.4%,25m
6002,2,ReppagekiPH,3648,386,17,10,27,63.0%,24m
6002,3,vilandre,3648,334,16,7,23,69.6%,12m
6002,2,Mimci,3648,88,6,0,6,100.0%,25m
6002,2,Дымоходец,3648,114,4,5,9,44.4%,17m
6002,2,Vessago,3648,90,3,5,8,37.5%,8m
6002,2,[DMOED]falschgeld,3648,58,2,1,3,66.7%,7m
6002,2,Aspect,3648,30,1,2,3,33.3%,6m
6002,2,Hushfield,3648,0,0,1,1,0.0%,18m
6002,2,Anhydre,3648,0,0,1,1,0.0%,11m
6002,2,ezpz,3648,0,0,1,1,0.0%,17m
6016,2,Jesu,3647,1561,158,148,306,51.6%,7m
6016,2,Terrantosaur,3647,592,21,24,45,46.7%,7m
6016,2,[ZЕRGТV]SPARTA,3647,279,13,3,16,81.2%,11m
6016,2,Silencer,3647,196,6,17,23,26.1%,11m
6016,2,Circovid,3647,0,1,0,1,100.0%,18m
6016,1,[LJai]AiSaranG,3647,90,1,10,11,9.1%,27m
6022,2,Seat,3646,440,16,14,30,53.3%,17m
6022,2,MaxPower,3646,0,1,0,1,100.0%,7m
6022,2,Neron,3646,0,1,0,1,100.0%,11m
6025,2,Eridanus,3645,1464,197,176,373,52.8%,16m
6025,2,ivicibli,3645,1579,158,128,286,55.2%,25m
6025,2,arpanet,3645,1574,116,102,218,53.2%,17m
6025,2,[ROBERT]JoeBassin,3645,926,42,37,79,53.2%,5m
6025,2,[Yking]Outplayed,3645,191,11,3,14,78.6%,25m
6025,2,IIIIIIIIIII,3645,204,7,8,15,46.7%,7m
6025,2,llllllllllll,3645,160,5,2,7,71.4%,25m
6025,2,[Chauss]Kirok,3645,148,5,6,11,45.5%,19m
6025,3,Gratraf,3645,30,2,2,4,50.0%,3m
6025,2,GlaDiaTor,3645,30,2,3,5,40.0%,8m
6025,2,[PAINT]Coratex,3645,30,1,4,5,20.0%,25m
6036,2,kasper,3644,1584,253,244,497,50.9%,9m
6036,2,Waldschrat,3644,1580,239,247,486,49.2%,26m
6036,2,Calçot,3644,1039,53,47,100,53.0%,6m
6036,2,[AoTu]ADMIN,3644,546,21,17,38,55.3%,4m
6036,2,[FLYTT]MightyXI,3644,468,18,20,38,47.4%,11m
6036,3,exatje,3644,274,13,4,17,76.5%,10m
6036,2,PaCJlaboHeC,3644,283,11,5,16,68.8%,11m
6036,2,[SxS]Radio,3644,114,4,3,7,57.1%,15m
6036,2,Outlord,3644,30,2,0,2,100.0%,6m
6036,2,King,3644,30,2,4,6,33.3%,7m
6036,1,[VhD]Valdegero,3644,0,0,4,4,0.0%,3m
6047,2,[XBM]Sabaka,3643,1238,177,180,357,49.6%,25m
6047,2,Warember,3643,1289,161,158,319,50.5%,19m
6047,2,Brasida,3643,1468,118,118,236,50.0%,3m
6047,2,Collider,3643,1386,56,59,115,48.7%,27m
6047,2,gau,3643,867,41,22,63,65.1%,28m
6047,2,[сSсǃ]KailoR,3643,785,31,29,60,51.7%,27m
6047,2,MechItHappen,3643,165,7,0,7,100.0%,16m
6047,2,[PÂRłAH]Liquidator,3643,170,7,8,15,46.7%,8m
6047,2,[PŖïMĄŁ]Agricultor,3643,114,4,0,4,100.0%,7m
6047,2,[Mdaa]Алекс,3643,30,2,1,3,66.7%,8m
6047,2,[SKRRR]devinpro,3643,0,1,0,1,100.0%,11m
6047,3,Sleek,3643,0,1,1,2,50.0%,13m
6047,2,[NBBS]pasen,3643,0,0,1,1,0.0%,18m
6047,3,[pSi]martishon,3643,0,0,2,2,0.0%,24m
6061,2,[NerCC]Nerzgul,3642,1445,118,110,228,51.8%,4m
6061,2,arvak,3642,1503,106,99,205,51.7%,15m
6061,2,Zaïtsev,3642,1126,52,53,105,49.5%,9m
6061,2,BronzeHero,3642,304,45,38,83,54.2%,4m
6061,2,[PwS]Hellboy,3642,326,13,10,23,56.5%,11m
6061,2,KiceK,3642,206,8,11,19,42.1%,10m
6061,2,[Ar4ont]llllllllllll,3642,30,2,3,5,40.0%,28m
6061,2,LogicSoldier,3642,0,1,0,1,100.0%,14m
6061,2,Sanitar,3642,0,1,0,1,100.0%,7m
6070,2,SniPerSp,3641,1569,211,220,431,49.0%,6m
6070,2,Azoth,3641,1546,174,174,348,50.0%,24m
6070,2,[FxL]Bojan,3641,680,94,85,179,52.5%,7m
6070,2,AnttiAnttila,3641,1551,90,80,170,52.9%,18m
6070,2,[LeaveC]Alpha,3641,619,30,23,53,56.6%,14m
6070,2,[JnduGG]winkzzzzzzzz,3641,573,22,16,38,57.9%,15m
6070,2,[WyN]Garam,3641,570,21,17,38,55.3%,4m
6070,2,[Hаsu]OZZY,3641,428,19,16,35,54.3%,16m
6070,2,TraperPrime,3641,90,3,7,10,30.0%,8m
6070,2,SKYTOSS,3641,92,3,9,12,25.0%,18m
6070,2,GBB,3641,30,2,0,2,100.0%,6m
6070,2,tenenoitre,3641,0,1,0,1,100.0%,14m
6070,2,ReunioN,3641,30,1,1,2,50.0%,15m
6070,2,Seiken,3641,0,0,1,1,0.0%,27m
6070,2,CrazyTrain,3641,0,0,3,3,0.0%,26m
6085,2,LodBrock,3640,684,96,92,188,51.1%,18m
6085,2,Interloper,3640,502,22,13,35,62.9%,6m
6085,2,AEZAKMI,3640,474,17,24,41,41.5%,26m
6085,2,Neptune,3640,136,4,0,4,100.0%,8m
6085,2,[Pullis]Pumi,3640,58,2,4,6,33.3%,28m
6085,2,[PÂRłAH]SolusRex,3640,0,0,1,1,0.0%,11m
6091,2,Mechanicus,3639,1067,163,133,296,55.1%,8m
6091,2,[Rocko]ArmadilloJak,3639,1463,110,104,214,51.4%,6m
6091,2,[GGWPEZ]BBoyALIK,3639,1465,107,104,211,50.7%,18m
6091,2,DeLeT,3639,1500,94,96,190,49.5%,12m
6091,2,Dony,3639,1164,48,39,87,55.2%,10m
6091,2,SuJi,3639,883,45,33,78,57.7%,12m
6091,2,Zepyhr,3639,350,13,17,30,43.3%,25m
6091,3,Midnight,3639,200,8,3,11,72.7%,26m
6091,2,PrettyFly,3639,119,7,0,7,100.0%,17m
6091,2,GeneralTanz,3639,86,3,7,10,30.0%,5m
6091,2,[DumpD]MTS,3639,0,0,2,2,0.0%,7m
6091,3,Hospak,3639,0,0,2,2,0.0%,8m
6091,2,AkinKilic,3639,0,0,4,4,0.0%,27m
6104,2,[НТТ]ImmunitY,3638,1345,161,116,277,58.1%,3m
6104,1,CaptainTruel,3638,1427,103,111,214,48.1%,25m
6104,2,mpouldozas,3638,1058,36,51,87,41.4%,11m
6104,2,deyimd,3638,292,11,15,26,42.3%,28m
6108,2,Titch,3637,1583,155,149,304,51.0%,24m
6108,2,Purity,3637,1655,119,104,223,53.4%,4m
6108,2,zakeN,3637,555,26,15,41,63.4%,11m
6108,2,Chemotherapy,3637,351,15,9,24,62.5%,3m
6108,2,BNDS,3637,280,11,5,16,68.8%,27m
6108,2,FishyFetus,3637,202,9,2,11,81.8%,8m
6108,3,Ryppinho,3637,172,9,8,17,52.9%,15m
6108,2,Coxta,3637,168,8,8,16,50.0%,26m
6108,2,CCAA,3637,206,7,4,11,63.6%,27m
6108,2,TristanI,3637,180,6,9,15,40.0%,27m
6108,2,JustZyriak,3637,152,6,9,15,40.0%,11m
6108,2,Trojan,3637,58,3,1,4,75.0%,7m
6108,2,[ExpdtD]Aragnath,3637,58,3,1,4,75.0%,3m
6108,2,Dysxelia,3637,60,2,3,5,40.0%,10m
6108,2,Valorfist,3637,0,0,1,1,0.0%,25m
6108,2,[ERZ]Marphux,3637,0,0,2,2,0.0%,12m
6124,2,TFM,3636,806,45,33,78,57.7%,25m
6124,2,Nexmar,3636,521,19,25,44,43.2%,26m
6124,2,[Batmen]ActionJaxon,3636,414,13,30,43,30.2%,27m
6124,2,[Fuarkk]Zyzz,3636,160,7,5,12,58.3%,18m
6124,2,Scatrex,3636,152,5,12,17,29.4%,8m
6124,2,oTrolly,3636,51,4,5,9,44.4%,7m
6124,2,Simon,3636,0,3,2,5,60.0%,16m
6124,2,StrangeGuy,3636,88,3,5,8,37.5%,25m
6124,2,[VlomGG]Hulumulu,3636,0,1,0,1,100.0%,4m
6124,2,[PÂRłAH]Fpohozlobr,3636,0,1,0,1,100.0%,7m
6124,2,jijx,3636,0,1,0,1,100.0%,4m
6124,2,Toshiro,3636,0,0,2,2,0.0%,4m
6136,1,[Aliexp]snow,3635,610,141,164,305,46.2%,3m
6136,2,Knocks,3635,618,63,53,116,54.3%,25m
6136,2,BRuAbsolute,3635,1104,52,46,98,53.1%,19m
6136,2,XSol,3635,1225,50,51,101,49.5%,18m
6136,2,[Plots]Peanuts,3635,542,39,30,69,56.5%,12m
6136,2,Frostwolf,3635,774,36,21,57,63.2%,24m
6136,2,fMMplz,3635,352,13,19,32,40.6%,7m
6136,2,Timurian,3635,177,7,4,11,63.6%,7m
6136,2,dolla,3635,120,4,6,10,40.0%,16m
6136,2,Chinro,3635,0,1,0,1,100.0%,14m
6136,2,Deathwatcher,3635,30,1,3,4,25.0%,8m
6136,2,maffia,3635,0,0,1,1,0.0%,25m
6148,2,PicoAranha,3634,886,189,184,373,50.7%,15m
6148,2,CRAPOUILLOU,3634,902,41,31,72,56.9%,25m
6148,2,IIIIIIIIIIII,3634,489,19,14,33,57.6%,4m
6148,2,LoveYourself,3634,86,3,3,6,50.0%,15m
6148,2,LooHasake,3634,88,1,1,2,50.0%,7m
6148,1,[Viva]Rubalom,3634,0,0,2,2,0.0%,5m
6154,2,Hody,3633,1059,206,199,405,50.9%,27m
6154,2,[ezE]smellyD,3633,1595,90,66,156,57.7%,26m
6154,2,IIIIIIIIII,3633,758,25,38,63,39.7%,14m
6154,2,strelnik,3633,154,9,2,11,81.8%,24m
6154,2,Morozic,3633,192,8,1,9,88.9%,24m
6154,2,[JW]Jaesonian,3633,62,2,11,13,15.4%,19m
6154,2,Saphirox,3633,0,0,3,3,0.0%,11m
6161,2,SlimShady,3632,1159,246,234,480,51.2%,9m
6161,2,DearName,3632,860,56,55,111,50.5%,15m
6161,2,[hiddle]Snowfox,3632,884,51,36,87,58.6%,4m
6161,2,GodOfFutsal,3632,1076,43,42,85,50.6%,25m
6161,2,Hemocles,3632,284,10,9,19,52.6%,7m
6161,2,EXECUTOR,3632,0,3,2,5,60.0%,6m
6161,2,NiTiN,3632,30,2,3,5,40.0%,14m
6161,2,[lIPJIl]josscar,3632,60,2,7,9,22.2%,28m
6161,2,Topdeckarn,3632,0,1,0,1,100.0%,7m
6161,1,[kAm]cYaN,3632,97,1,3,4,25.0%,14m
6161,2,ShOOm,3632,0,0,1,1,0.0%,28m
6161,2,Monkey,3632,0,0,1,1,0.0%,27m
6173,2,llllllll,3631,1465,86,79,165,52.1%,24m
6173,1,OsteFar,3631,992,50,68,118,42.4%,9m
6173,2,Andrey,3631,360,13,16,29,44.8%,11m
6173,2,GgMachineSC,3631,228,8,3,11,72.7%,12m
6173,2,[QTclub]Creepy,3631,186,6,16,22,27.3%,7m
6173,2,Jeff,3631,0,1,0,1,100.0%,27m
6173,2,[BoI]Clawboy,3631,0,1,0,1,100.0%,3m
6173,2,[SPAINs]Destajador,3631,30,1,4,5,20.0%,2m
6181,2,FADIMUH,3630,1523,127,127,254,50.0%,25m
6181,2,Smile,3630,1065,46,32,78,59.0%,8m
6181,2,Tsogi,3630,434,25,6,31,80.6%,8m
6181,2,[WUBBB]Chem,3630,345,20,23,43,46.5%,18m
6181,2,[mfixed]IIIIlIlIIIll,3630,312,14,7,21,66.7%,7m
6181,2,Limpasse,3630,366,13,9,22,59.1%,3m
6181,2,[EPK]SlowStyLe,3630,186,10,4,14,71.4%,11m
6181,2,yayagrou,3630,144,6,4,10,60.0%,6m
6181,2,Tygrys,3630,148,5,8,13,38.5%,28m
6181,2,trollinator,3630,0,0,1,1,0.0%,16m
6191,2,Hoyo,3629,1057,129,120,249,51.8%,6m
6191,2,[BaföG]Turbocat,3629,1641,81,81,162,50.0%,7m
6191,2,remfortz,3629,1118,79,67,146,54.1%,4m
6191,2,[CocoCo]ugly,3629,1236,69,70,139,49.6%,17m
6191,2,Stabvil,3629,705,42,42,84,50.0%,27m
6191,2,INTERNETLORD,3629,702,40,21,61,65.6%,4m
6191,2,FreestyloKZ,3629,418,14,22,36,38.9%,8m
6191,2,PolluX,3629,277,11,5,16,68.8%,8m
6191,1,Shooky,3629,120,7,2,9,77.8%,5m
6191,2,InriXs,3629,182,6,1,7,85.7%,17m
6191,2,[W6]StandHAFT,3629,114,4,5,9,44.4%,11m
6191,2,[FisssT]Zorro,3629,96,3,1,4,75.0%,25m
6191,2,Krissy,3629,58,2,3,5,40.0%,24m
6191,2,[ØC]Sparrow,3629,60,2,5,7,28.6%,4m
6191,2,SaintGlé,3629,0,0,1,1,0.0%,12m
6191,2,NatterJack,3629,0,0,1,1,0.0%,12m
6191,1,Riddle,3629,0,0,3,3,0.0%,26m
6208,2,LYNN,3628,1568,250,251,501,49.9%,6m
6208,2,ErikwithaK,3628,1399,196,184,380,51.6%,7m
6208,2,NurAbSal,3628,572,58,66,124,46.8%,12m
6208,2,Bayash,3628,1153,46,42,88,52.3%,4m
6208,2,Strat,3628,534,18,25,43,41.9%,28m
6208,2,Onfroy,3628,307,11,9,20,55.0%,7m
6208,2,Женя,3628,152,5,9,14,35.7%,26m
6208,2,Kamljat,3628,30,1,6,7,14.3%,4m
6208,2,EddieSmurphy,3628,0,0,1,1,0.0%,28m
6217,2,yastar,3627,900,65,60,125,52.0%,11m
6217,2,Amerkan,3627,1219,58,34,92,63.0%,16m
6217,2,Still,3627,607,26,17,43,60.5%,27m
6217,2,Merlin,3627,482,18,14,32,56.2%,6m
6217,2,ATAraXia,3627,178,6,13,19,31.6%,26m
6217,2,JenniferRush,3627,122,4,8,12,33.3%,7m
6217,2,Nasste,3627,88,1,1,2,50.0%,16m
6217,2,Kate,3627,0,0,1,1,0.0%,18m
6217,2,[DDSC]Flame,3627,0,0,3,3,0.0%,7m
6226,2,MRaMOR,3626,1121,248,233,481,51.6%,25m
6226,1,suicideisez,3626,1615,189,198,387,48.8%,24m
6226,2,TheBOne,3626,434,91,77,168,54.2%,7m
6226,2,Anarki,3626,1545,85,88,173,49.1%,28m
6226,2,PITTIPIT,3626,441,16,13,29,55.2%,12m
6226,2,LeifGWPerson,3626,279,15,5,20,75.0%,6m
6226,2,IllIIIIIIIII,3626,157,9,9,18,50.0%,7m
6226,2,[pLine]Idwood,3626,178,7,9,16,43.8%,11m
6226,1,VoidRay,3626,48,4,6,10,40.0%,6m
6226,2,[MATI]czarny,3626,60,3,1,4,75.0%,11m
6226,2,Boundless,3626,30,1,1,2,50.0%,12m
6237,2,Sva,3625,1488,133,119,252,52.8%,25m
6237,2,Stefan,3625,1158,44,50,94,46.8%,6m
6237,2,pYg,3625,216,7,14,21,33.3%,11m
6237,2,kingrral,3625,0,1,0,1,100.0%,18m
6241,2,[IBeAŚI]Herold,3624,1412,106,96,202,52.5%,12m
6241,2,Frankiller,3624,1503,94,102,196,48.0%,27m
6241,2,[Larry]Anaxagore,3624,1222,90,72,162,55.6%,4m
6241,2,TooTsiE,3624,1498,64,53,117,54.7%,8m
6241,2,MacroMarinE,3624,1158,54,37,91,59.3%,26m
6241,2,Nekromant,3624,297,12,8,20,60.0%,7m
6241,2,reklemhuk,3624,341,9,16,25,36.0%,12m
6241,2,LePâté,3624,271,8,11,19,42.1%,27m
6241,2,[IWBK]Tom,3624,86,4,3,7,57.1%,15m
6241,1,[HämSec]sciencedwarf,3624,0,1,0,1,100.0%,18m
6241,2,Baysen,3624,0,0,1,1,0.0%,27m
6241,3,UgglyNigglet,3624,0,0,1,1,0.0%,24m
6241,2,Geksogen,3624,0,0,1,1,0.0%,3m
6254,2,alamo,3623,1589,192,190,382,50.3%,11m
6254,2,Warsmith,3623,1381,101,90,191,52.9%,8m
6254,2,[KAOTx]Morlag,3623,260,38,31,69,55.1%,12m
6254,2,Reach,3623,826,35,30,65,53.8%,14m
6254,2,[BIIC]SundeR,3623,184,30,28,58,51.7%,17m
6254,2,Vixshke,3623,524,20,20,40,50.0%,10m
6254,2,REtoX,3623,350,14,20,34,41.2%,27m
6254,1,GipsyQueen,3623,186,9,1,10,90.0%,16m
6254,2,Christopher,3623,95,6,0,6,100.0%,24m
6254,2,[BRSKR]goodluckhave,3623,0,2,3,5,40.0%,18m
6254,2,MissClick,3623,0,0,1,1,0.0%,7m
6265,2,xakcar,3622,1617,202,188,390,51.8%,18m
6265,2,smolly,3622,1543,80,79,159,50.3%,17m
6265,1,Private,3622,906,73,97,170,42.9%,19m
6265,2,KendreeamTV,3622,1504,68,55,123,55.3%,27m
6265,2,[AsJRHD]Tutterbobs,3622,388,14,18,32,43.8%,18m
6265,2,[НОД17]Aerilis,3622,86,4,5,9,44.4%,18m
6265,2,ZIKWIT,3622,118,4,9,13,30.8%,7m
6265,2,CovidShow,3622,0,1,0,1,100.0%,17m
6265,2,Wormer,3622,0,0,1,1,0.0%,27m
6274,1,[FUPS]Drogi,3621,630,16,41,57,28.1%,13m
6274,3,[4EYES]DasAuto,3621,140,4,1,5,80.0%,3m
6274,2,[ZDI]Reedly,3621,0,1,0,1,100.0%,27m
6277,1,[pØuce]Socks,3620,1767,315,316,631,49.9%,15m
6277,2,[EZc]TadaItsBean,3620,1550,236,242,478,49.4%,11m
6277,2,Kuba,3620,1586,184,162,346,53.2%,26m
6277,2,Azgar,3620,1462,174,172,346,50.3%,7m
6277,2,CptRetard,3620,750,143,135,278,51.4%,25m
6277,2,[PLA2N]AmoralDed,3620,1544,72,61,133,54.1%,9m
6277,2,NDNO,3620,864,34,39,73,46.6%,7m
6277,2,[IceHus]shiper,3620,726,33,19,52,63.5%,25m
6277,2,[TheDOH]Susken,3620,548,19,29,48,39.6%,3m
6277,2,jimi,3620,590,19,33,52,36.5%,7m
6277,2,AriGold,3620,248,10,8,18,55.6%,19m
6277,2,Leo,3620,230,8,4,12,66.7%,28m
6277,2,MidPlatinium,3620,0,4,1,5,80.0%,4m
6277,2,ImSoMadBro,3620,0,1,0,1,100.0%,10m
6277,2,[OoE]Rufus,3620,0,1,1,2,50.0%,12m
6277,2,[vinc]Vincent,3620,30,1,2,3,33.3%,6m
6277,2,Krab,3620,0,1,2,3,33.3%,19m
6277,2,kokochA,3620,30,1,4,5,20.0%,16m
6277,2,Designer,3620,0,0,1,1,0.0%,18m
6296,2,[ЯD]Magico,3619,1490,156,161,317,49.2%,5m
6296,2,[LGNxEU]Attrition,3619,1382,140,101,241,58.1%,7m
6296,2,FaBeRiO,3619,1329,110,105,215,51.2%,18m
6296,2,StarMail,3619,994,43,26,69,62.3%,27m
6296,2,briznokovic,3619,356,33,28,61,54.1%,28m
6296,2,VembersSimp,3619,230,8,4,12,66.7%,14m
6296,2,Dad,3619,88,5,1,6,83.3%,15m
6296,2,[PŖïMĄŁ]DarkGhost,3619,126,3,2,5,60.0%,8m
6296,2,Ced,3619,0,1,0,1,100.0%,5m
6296,2,NPGCMadGuy,3619,30,1,2,3,33.3%,4m
6296,2,Corez,3619,0,1,3,4,25.0%,4m
6296,2,Anna,3619,0,0,1,1,0.0%,11m
6308,2,KamChaTkaSuD,3618,1216,287,267,554,51.8%,7m
6308,2,[SHIFT]flouchy,3618,1545,110,110,220,50.0%,28m
6308,2,[G0A]RoY,3618,842,31,34,65,47.7%,3m
6308,2,greeny,3618,878,31,43,74,41.9%,5m
6308,2,ЧерныйТолчок,3618,482,15,22,37,40.5%,7m
6308,3,IIIIIIIIIII,3618,261,12,6,18,66.7%,19m
6308,2,Welfik,3618,128,7,2,9,77.8%,4m
6308,2,Glückspilz,3618,132,4,0,4,100.0%,11m
6308,2,[IVE]SilenceTime,3618,30,2,0,2,100.0%,15m
6308,2,FaerskFisk,3618,0,1,1,2,50.0%,28m
6308,2,[ffddfd]IIIIIIIIIIII,3618,0,0,1,1,0.0%,7m
6308,2,[U2]tAleSpin,3618,0,0,2,2,0.0%,11m
6320,2,[Hrr]Tennouzan,3617,1526,247,241,488,50.6%,17m
6320,2,XeRiON,3617,1113,53,37,90,58.9%,17m
6320,2,[TLpsE]IloveYeony,3617,1131,46,36,82,56.1%,25m
6320,2,[nDieǂ]tyrion,3617,946,36,34,70,51.4%,24m
6320,2,Control,3617,753,35,18,53,66.0%,17m
6320,2,Ultrarich,3617,627,30,18,48,62.5%,4m
6320,2,[CrWw]Dost,3617,426,14,26,40,35.0%,25m
6320,2,LunarMAX,3617,30,3,3,6,50.0%,26m
6320,2,Vex,3617,0,0,1,1,0.0%,6m
6320,2,OptimusPrime,3617,0,0,1,1,0.0%,14m
6330,2,TooLameForSc,3616,1053,63,59,122,51.6%,14m
6330,2,latt,3616,578,21,25,46,45.7%,15m
6330,2,[SRaven]Blackstar,3616,590,21,26,47,44.7%,2m
6330,2,[20XX]Pyre,3616,158,17,12,29,58.6%,17m
6330,2,DAG,3616,184,15,8,23,65.2%,7m
6330,2,camaka,3616,30,1,2,3,33.3%,6m
6336,2,KennyAce,3615,1280,150,143,293,51.2%,3m
6336,2,[PŖïMĄŁ]Licalo,3615,708,108,112,220,49.1%,18m
6336,2,StubbornOwl,3615,1491,93,82,175,53.1%,10m
6336,2,Nikola,3615,1043,60,40,100,60.0%,27m
6336,2,Giratina,3615,482,24,13,37,64.9%,27m
6336,2,[MiMs]PrimeLappen,3615,217,12,4,16,75.0%,27m
6336,2,deama,3615,210,7,7,14,50.0%,18m
6336,2,[Ǽ1]Terminator,3615,109,1,3,4,25.0%,6m
6336,2,SpliTe,3615,0,0,1,1,0.0%,5m
6345,2,Zulhuky,3614,1484,60,60,120,50.0%,24m
6345,2,TaGrandmère,3614,222,54,31,85,63.5%,7m
6345,2,[SLW]Titans,3614,867,45,26,71,63.4%,14m
6345,2,Dream,3614,754,44,18,62,71.0%,25m
6345,2,Ulir,3614,944,39,30,69,56.5%,10m
6345,2,Todd,3614,820,29,33,62,46.8%,19m
6345,2,Aryster,3614,245,7,13,20,35.0%,18m
6345,2,NuSieKu,3614,126,3,1,4,75.0%,17m
6345,2,sosh,3614,30,2,1,3,66.7%,15m
6345,2,[SQUÍK]Dompl,3614,30,2,5,7,28.6%,6m
6345,2,[NOW]Colt,3614,60,2,5,7,28.6%,18m
6345,2,necedakrene,3614,30,1,6,7,14.3%,15m
6345,2,[lMMl]Snowsoul,3614,0,0,1,1,0.0%,17m
6358,1,[Knight]Empire,3613,1311,140,137,277,50.5%,12m
6358,1,Carcajadas,3613,1114,40,56,96,41.7%,16m
6358,2,[Тетере]IIIIIIIIIIII,3613,789,37,30,67,55.2%,15m
6358,2,slajjven,3613,456,36,21,57,63.2%,19m
6358,2,[jezza]Mercury,3613,114,24,11,35,68.6%,5m
6358,2,Allen,3613,417,22,21,43,51.2%,15m
6358,3,VoodooWeed,3613,279,13,5,18,72.2%,19m
6358,2,terminator,3613,288,9,8,17,52.9%,7m
6358,2,PoulpeMalade,3613,130,6,4,10,60.0%,8m
6358,2,dFNCP,3613,114,5,9,14,35.7%,10m
6358,2,exePriMe,3613,0,1,0,1,100.0%,11m
6358,2,[Abs]Zelfurax,3613,30,1,3,4,25.0%,7m
6370,2,[BV86]Berkoko,3612,1399,303,278,581,52.2%,27m
6370,2,sebastian,3612,1247,164,161,325,50.5%,14m
6370,2,IIIIIIIIIIII,3612,759,48,47,95,50.5%,26m
6370,2,[Jooooo]PitON,3612,437,24,15,39,61.5%,19m
6370,2,[Иod]SyntaxError,3612,386,13,18,31,41.9%,10m
6370,2,Humpen,3612,92,3,5,8,37.5%,13m
6370,2,aFFinity,3612,0,1,0,1,100.0%,27m
6370,2,StorKatt,3612,0,0,3,3,0.0%,4m
6370,2,DjYmep,3612,0,0,4,4,0.0%,7m
6379,2,sBim,3611,1180,371,369,740,50.1%,7m
6379,2,JohnyPony,3611,356,139,138,277,50.2%,7m
6379,2,[GŏDawn]Frinkle,3611,1171,129,129,258,50.0%,2m
6379,2,[theEH]Trunek,3611,843,43,27,70,61.4%,4m
6379,2,[LeUcHt]InvaderZ,3611,599,34,28,62,54.8%,25m
6379,2,[ValidG]loganpaul,3611,710,29,24,53,54.7%,18m
6379,2,BullzZ,3611,491,20,18,38,52.6%,19m
6379,2,OHOOUO,3611,30,4,4,8,50.0%,8m
6379,2,PepKeck,3611,0,0,2,2,0.0%,11m
6388,2,[PRlME]Faeton,3610,1566,259,248,507,51.1%,25m
6388,2,[KeWa]Razgriz,3610,742,29,27,56,51.8%,4m
6388,2,Beautiful,3610,303,10,9,19,52.6%,6m
6388,2,medved,3610,206,9,2,11,81.8%,16m
6388,1,Bardoqui,3610,209,9,3,12,75.0%,12m
6388,2,Øæx,3610,136,5,10,15,33.3%,7m
6388,2,[URSI]Seimenon,3610,116,4,6,10,40.0%,11m
6388,2,Jeanne,3610,30,2,2,4,50.0%,11m
6388,2,[OGCC]albadrworld,3610,30,1,2,3,33.3%,7m
6388,2,TrumpFTW,3610,0,0,1,1,0.0%,27m
6398,2,[mfxed]dawid,3609,852,169,154,323,52.3%,25m
6398,2,TitLe,3609,1126,52,60,112,46.4%,11m
6398,2,[PKaP]Titi,3609,902,35,34,69,50.7%,11m
6398,2,Stormrider,3609,548,20,28,48,41.7%,18m
6398,2,llllllllllll,3609,405,15,11,26,57.7%,6m
6398,2,Twitch,3609,434,14,26,40,35.0%,18m
6398,2,Oww,3609,241,11,5,16,68.8%,26m
6398,2,[OYY]Peclesh,3609,228,9,7,16,56.2%,7m
6398,2,[TheDOH]loeblix,3609,94,6,14,20,30.0%,28m
6398,2,[ПИCYN]TigrSeX,3609,120,5,6,11,45.5%,10m
6398,2,Demone,3609,30,1,3,4,25.0%,27m
6398,2,Gryms,3609,30,1,4,5,20.0%,12m
6398,2,Tarantula,3609,0,0,2,2,0.0%,7m
6398,2,[RGH]Maffay,3609,0,0,6,6,0.0%,7m
6412,2,KuBa,3608,1516,118,132,250,47.2%,11m
6412,2,[ArGGEU]ElectroEagle,3608,1498,68,51,119,57.1%,3m
6412,2,BigTerran,3608,867,50,17,67,74.6%,8m
6412,2,MakiMix,3608,436,29,9,38,76.3%,9m
6412,2,Jugei,3608,765,29,28,57,50.9%,26m
6412,2,Dmitryb,3608,166,7,5,12,58.3%,9m
6412,2,[PAV]Kerdinand,3608,94,4,5,9,44.4%,15m
6412,2,McClurgDumb,3608,58,2,5,7,28.6%,7m
6412,2,sneiz,3608,0,1,4,5,20.0%,27m
6412,2,[xMiCx]RoNKolA,3608,0,0,1,1,0.0%,7m
6422,2,[ocwe]TheGeneral,3607,1223,122,122,244,50.0%,15m
6422,2,LastHero,3607,1327,53,53,106,50.0%,26m
6422,2,TomSullenly,3607,289,24,2,26,92.3%,9m
6422,2,Gothic,3607,501,24,13,37,64.9%,12m
6422,2,SnFeeK,3607,90,4,4,8,50.0%,9m
6422,2,[INCV]TBURO,3607,114,3,1,4,75.0%,7m
6422,2,[sGeeks]Skogshuggarn,3607,0,2,3,5,40.0%,27m
6422,3,Kisel,3607,0,1,4,5,20.0%,11m
6422,2,[QTcIub]Tayzerr,3607,0,0,1,1,0.0%,11m
6422,2,[VFish]Nimzo,3607,0,0,1,1,0.0%,7m
6422,2,[BLCKWD]megalike,3607,0,0,2,2,0.0%,26m
6433,2,[AUT]DieForIt,3606,1218,94,92,186,50.5%,27m
6433,2,Keiser,3606,1174,76,80,156,48.7%,24m
6433,2,llllllllllll,3606,400,19,10,29,65.5%,15m
6433,3,EmoLing,3606,70,19,59,78,24.4%,18m
6433,2,KingArthur,3606,450,18,21,39,46.2%,19m
6433,2,Allin,3606,235,14,2,16,87.5%,27m
6433,2,CasualGaming,3606,298,14,6,20,70.0%,8m
6433,2,[SCBoys]CiRkuS,3606,213,10,10,20,50.0%,7m
6433,2,Scerian,3606,162,5,2,7,71.4%,7m
6433,2,[Быдло]cucumber,3606,0,1,1,2,50.0%,9m
6433,1,Ström,3606,0,1,2,3,33.3%,17m
6433,2,blast,3606,30,1,3,4,25.0%,25m
6445,2,Apollo,3605,1198,241,237,478,50.4%,25m
6445,2,Teva,3605,1492,107,105,212,50.5%,18m
6445,2,lele,3605,374,12,23,35,34.3%,27m
6445,2,VladyslavUa,3605,200,7,8,15,46.7%,11m
6445,2,Luutarhuri,3605,114,4,7,11,36.4%,11m
6445,2,[Bestie]RexChance,3605,88,1,1,2,50.0%,26m
6451,2,Tim,3604,1292,107,112,219,48.9%,14m
6451,2,[aW]Titi,3604,1557,101,106,207,48.8%,3m
6451,2,BeMarine,3604,1224,100,99,199,50.3%,18m
6451,2,[THRLLA]Randaban,3604,612,29,31,60,48.3%,13m
6451,2,gosuboy,3604,660,24,36,60,40.0%,8m
6451,2,TheHeaTisOn,3604,275,20,15,35,57.1%,12m
6451,2,[AndréM]PiErrEPoncE,3604,390,16,10,26,61.5%,24m
6451,2,[Sp3TAK]kidd,3604,208,12,3,15,80.0%,24m
6451,2,[Mimi]Poseidon,3604,60,2,3,5,40.0%,28m
6451,2,ZeeLow,3604,0,2,3,5,40.0%,8m
6451,2,Brooks,3604,0,1,0,1,100.0%,25m
6451,2,PurpleHaze,3604,88,1,1,2,50.0%,3m
6463,2,Schmaunzer,3603,1620,165,163,328,50.3%,25m
6463,2,Miti,3603,1572,110,87,197,55.8%,26m
6463,2,carlosvzas,3603,1154,63,67,130,48.5%,26m
6463,2,Alf,3603,577,54,44,98,55.1%,27m
6463,2,FGAlvaro,3603,1015,41,30,71,57.7%,17m
6463,2,Reppageki,3603,349,14,9,23,60.9%,4m
6463,2,ProbeiusCorp,3603,300,13,10,23,56.5%,17m
6463,2,[U2]Inspired,3603,287,11,15,26,42.3%,18m
6463,2,[FTS]MuScOne,3603,245,8,6,14,57.1%,12m
6463,2,гидрочка,3603,188,6,4,10,60.0%,16m
6463,2,[ThAc]Gaettwo,3603,116,4,0,4,100.0%,12m
6463,2,MarlboroO,3603,0,1,0,1,100.0%,24m
6463,2,bege,3603,0,0,1,1,0.0%,16m
6463,2,Kamilione,3603,0,0,2,2,0.0%,6m
6477,2,cyses,3602,815,51,44,95,53.7%,4m
6477,2,Luc,3602,905,39,29,68,57.4%,26m
6477,2,Human,3602,534,26,12,38,68.4%,4m
6477,2,Arcturus,3602,453,22,19,41,53.7%,18m
6477,2,Aspa,3602,256,13,6,19,68.4%,7m
6477,2,Cropon,3602,214,8,4,12,66.7%,28m
6477,2,[44IQ]FourHead,3602,142,4,3,7,57.1%,24m
6477,2,portishead,3602,152,4,3,7,57.1%,17m
6477,2,KurtBlock,3602,122,4,5,9,44.4%,19m
6477,2,PEITSCHE,3602,88,2,0,2,100.0%,7m
6487,2,mich,3601,1556,436,433,869,50.2%,28m
6487,2,TITIWIXI,3601,1488,344,319,663,51.9%,17m
6487,2,Tagged,3601,1518,246,241,487,50.5%,5m
6487,2,[TRNATR]Raphael,3601,1480,175,178,353,49.6%,15m
6487,2,Pawnee,3601,1477,56,69,125,44.8%,4m
6487,2,Miles,3601,491,23,15,38,60.5%,6m
6487,2,[ANTl]Matter,3601,278,11,6,17,64.7%,24m
6487,2,[Li3]PazoZle,3601,178,7,4,11,63.6%,4m
6487,2,Fruityloop,3601,232,7,6,13,53.8%,25m
6487,2,NFloN,3601,0,1,0,1,100.0%,18m
6487,2,[ƮesXG]Endo,3601,88,1,1,2,50.0%,18m
6487,2,[hBǂ]Orion,3601,0,0,2,2,0.0%,26m
6487,2,Kokos,3601,0,0,6,6,0.0%,7m
6487,2,Tyr,3601,0,0,8,8,0.0%,3m
6487,2,[RPTRMX]Andris,3601,0,0,9,9,0.0%,24m
6502,2,Nichos,3600,1092,79,76,155,51.0%,15m
6502,2,Scale,3600,608,20,27,47,42.6%,25m
6502,1,Amix,3600,171,10,4,14,71.4%,26m
6502,2,AuteoS,3600,231,9,4,13,69.2%,7m
6502,2,UxorialBack,3600,130,8,1,9,88.9%,26m
6502,2,[0BO]imbaHorst,3600,202,7,8,15,46.7%,7m
6502,2,Alweare,3600,180,6,12,18,33.3%,5m
6502,2,Beast,3600,126,4,1,5,80.0%,17m
6502,2,HornOfGondor,3600,30,2,1,3,66.7%,11m
6502,2,[FOX]Swere,3600,0,1,0,1,100.0%,24m
6502,2,uwuTerran,3600,0,1,1,2,50.0%,19m
6513,2,TheKing,3599,1023,59,30,89,66.3%,15m
6513,2,HappyDaggeR,3599,693,38,46,84,45.2%,4m
6513,2,Hainmamut,3599,529,28,40,68,41.2%,17m
6513,2,[L0WS]TheRioo,3599,712,27,28,55,49.1%,6m
6513,2,Judalik,3599,260,10,7,17,58.8%,7m
6513,2,EDRSON,3599,88,3,4,7,42.9%,25m
6513,3,SunnyDay,3599,0,1,0,1,100.0%,17m
6513,2,ITMUNIR,3599,0,1,0,1,100.0%,27m
6513,2,AppleJuice,3599,0,0,1,1,0.0%,3m
6522,2,Harkonnen,3598,1541,292,286,578,50.5%,27m
6522,2,Inertia,3598,1082,60,53,113,53.1%,3m
6522,2,[nopvp]sirBlue,3598,687,34,17,51,66.7%,12m
6522,2,soul,3598,386,14,15,29,48.3%,28m
6522,2,IlIlIlIlIlll,3598,281,13,5,18,72.2%,4m
6522,2,[BatCom]WishMaster,3598,292,10,19,29,34.5%,17m
6522,1,Moon,3598,257,7,4,11,63.6%,8m
6522,2,lundanto,3598,166,6,7,13,46.2%,4m
6522,2,Tarsonis,3598,144,5,2,7,71.4%,28m
6522,2,Rawien,3598,0,0,1,1,0.0%,28m
6522,2,[HBeS]Joicody,3598,0,0,1,1,0.0%,5m
6522,2,LazyTurtle,3598,0,0,1,1,0.0%,8m
6522,2,[DioD]Everlast,3598,0,0,2,2,0.0%,16m
6535,2,[HGGZ]Kanoya,3597,1358,490,466,956,51.3%,12m
6535,2,Huky,3597,1277,84,95,179,46.9%,18m
6535,2,zACz,3597,1559,81,42,123,65.9%,6m
6535,2,[BjwA]NiTreXxX,3597,1056,46,36,82,56.1%,4m
6535,2,Scrubb,3597,524,22,17,39,56.4%,27m
6535,2,Twice,3597,436,21,10,31,67.7%,13m
6535,2,incopera,3597,424,19,14,33,57.6%,6m
6535,2,Spudz,3597,454,19,15,34,55.9%,27m
6535,2,Curse,3597,332,11,11,22,50.0%,27m
6535,2,[UATeam]SHOCK,3597,290,11,14,25,44.0%,12m
6535,2,Stradivari,3597,272,9,7,16,56.2%,18m
6535,2,LazyTitan,3597,187,8,2,10,80.0%,13m
6535,3,HelloKitty,3597,128,6,4,10,60.0%,17m
6535,2,[HAY]Fronos,3597,120,5,5,10,50.0%,9m
6535,2,[DUX]Khaƴsaril,3597,160,5,16,21,23.8%,17m
6535,2,Rabbit,3597,64,4,5,9,44.4%,18m
6535,2,[NTLA]Legolas,3597,60,2,3,5,40.0%,10m
6552,2,Nadel,3596,1632,126,120,246,51.2%,8m
6552,2,BRX,3596,924,48,21,69,69.6%,26m
6552,2,AfterLife,3596,384,19,8,27,70.4%,12m
6552,2,Dante,3596,530,19,17,36,52.8%,6m
6552,2,zetoM,3596,184,12,14,26,46.2%,15m
6552,2,[EESC]ShaDow,3596,184,6,16,22,27.3%,13m
6552,2,ЧикЧирик,3596,0,3,3,6,50.0%,25m
6552,2,[PaniC]Johnnie,3596,0,1,0,1,100.0%,3m
6552,2,Nemo,3596,0,0,2,2,0.0%,15m
6561,1,ElTortuga,3595,1724,498,518,1016,49.0%,19m
6561,2,Rumham,3595,1093,88,69,157,56.1%,7m
6561,2,[FWez]HellBator,3595,1419,68,70,138,49.3%,9m
6561,2,Poiy,3595,592,23,21,44,52.3%,7m
6561,2,JeddHardy,3595,313,22,14,36,61.1%,27m
6561,2,[HamT]Tantale,3595,530,19,23,42,45.2%,6m
6561,2,michary,3595,269,12,4,16,75.0%,9m
6561,2,EpicLOLZdude,3595,143,5,1,6,83.3%,12m
6561,2,[HFR]offal,3595,118,3,0,3,100.0%,11m
6561,2,sAfricanus,3595,125,3,5,8,37.5%,27m
6561,2,DarkTech,3595,0,1,0,1,100.0%,6m
6561,2,Mechwarrior,3595,30,1,2,3,33.3%,15m
6573,2,woody,3594,1623,267,258,525,50.9%,26m
6573,2,Basizmiqta,3594,1432,243,243,486,50.0%,7m
6573,2,BloodyPastor,3594,1025,88,82,170,51.8%,3m
6573,2,SyfoDias,3594,561,48,19,67,71.6%,4m
6573,2,[EZfor]Justice,3594,275,15,7,22,68.2%,12m
6573,3,Sira,3594,257,12,5,17,70.6%,12m
6573,2,WICK,3594,260,11,10,21,52.4%,5m
6573,2,LVRos,3594,177,10,2,12,83.3%,11m
6573,2,jester,3594,128,4,1,5,80.0%,7m
6573,2,[nfteam]nfteamRed,3594,102,3,0,3,100.0%,10m
6573,2,[Bigold]Fefer,3594,30,1,2,3,33.3%,15m
6584,2,Riegleren,3593,1512,194,198,392,49.5%,4m
6584,1,[Kicx]terrOne,3593,858,81,70,151,53.6%,10m
6584,1,Bonz,3593,1657,69,87,156,44.2%,25m
6584,2,OnkelBob,3593,749,35,25,60,58.3%,25m
6584,2,TickTockGod,3593,538,21,15,36,58.3%,7m
6584,2,Chifuru,3593,415,16,8,24,66.7%,6m
6584,2,GroźnyKruk,3593,141,8,2,10,80.0%,3m
6584,2,Overture,3593,156,6,1,7,85.7%,8m
6584,2,SoupeAuLait,3593,122,6,9,15,40.0%,17m
6584,2,KillingSpree,3593,176,5,5,10,50.0%,10m
6584,2,[FYBF]eulerO,3593,120,4,10,14,28.6%,16m
6584,2,SaturnSaturn,3593,0,0,1,1,0.0%,9m
6584,2,HEBE,3593,0,0,1,1,0.0%,10m
6597,2,hollabrrack,3592,1317,179,166,345,51.9%,15m
6597,2,deadpool,3592,1550,145,123,268,54.1%,12m
6597,2,BlueR,3592,1409,86,70,156,55.1%,13m
6597,2,Rizon,3592,707,62,60,122,50.8%,27m
6597,2,JaxO,3592,1097,60,43,103,58.3%,10m
6597,2,nbkhjhghfdgr,3592,1545,55,67,122,45.1%,9m
6597,2,Dam,3592,1355,54,65,119,45.4%,24m
6597,2,Thor,3592,380,21,13,34,61.8%,11m
6597,2,[EZDUNK]HornetEU,3592,223,8,3,11,72.7%,6m
6597,2,[EUSalt]Seer,3592,114,5,5,10,50.0%,14m
6597,3,EFFECT,3592,123,2,5,7,28.6%,15m
6597,2,APMeth,3592,0,1,0,1,100.0%,7m
6597,2,[lOoOl]Vader,3592,0,1,0,1,100.0%,7m
6597,1,Xaero,3592,0,1,0,1,100.0%,8m
6597,2,[Heet]SirNoggisI,3592,0,1,4,5,20.0%,24m
6597,1,[SLDZ]SolidZKlant,3592,0,0,1,1,0.0%,7m
6597,2,JeD,3592,0,0,2,2,0.0%,18m
6614,1,MeuH,3591,1758,509,489,998,51.0%,27m
6614,2,SirronKcuhc,3591,1577,391,365,756,51.7%,12m
6614,2,sludog,3591,767,36,33,69,52.2%,28m
6614,2,[KosU]Skoin,3591,524,23,13,36,63.9%,3m
6614,3,[lLiTl]Zaarg,3591,297,14,5,19,73.7%,4m
6614,2,[BWV]Mihal,3591,264,8,23,31,25.8%,15m
6614,2,Fireman,3591,88,6,0,6,100.0%,14m
6621,1,[RIPERY]Lasic,3590,1293,493,482,975,50.6%,3m
6621,2,Zike,3590,1603,114,110,224,50.9%,11m
6621,2,[fmgPEW]Lannister,3590,1043,75,64,139,54.0%,8m
6621,2,[SzZe]Mclowicz,3590,442,17,18,35,48.6%,14m
6621,2,[SkWay]FrShDante,3590,126,4,1,5,80.0%,18m
6621,2,ChefEjtebez,3590,0,1,0,1,100.0%,9m
6621,2,[JaPP]Dubrovskijj,3590,0,1,2,3,33.3%,12m
6621,2,zigwielki,3590,0,0,2,2,0.0%,25m
6629,2,Kyzman,3589,1522,165,163,328,50.3%,28m
6629,2,[DemuCl]rhoeb,3589,1135,66,61,127,52.0%,8m
6629,2,[NWGD]Destroyer,3589,627,32,15,47,68.1%,11m
6629,2,[КПCC]Советыч,3589,130,5,0,5,100.0%,6m
6629,2,[BEKS]Rine,3589,154,5,2,7,71.4%,12m
6629,2,[Peeps]Christiaan,3589,116,4,9,13,30.8%,15m
6629,2,[PBEU]dorgon,3589,60,2,10,12,16.7%,8m
6629,2,ekko,3589,0,0,1,1,0.0%,14m
6637,2,LortGravidy,3588,1174,238,224,462,51.5%,4m
6637,2,[TR3B]UNMAKER,3588,1241,217,207,424,51.2%,19m
6637,2,[Fatty]Beignet,3588,1506,143,116,259,55.2%,26m
6637,2,Blab,3588,794,95,86,181,52.5%,28m
6637,2,[KAOTx]nEtDu,3588,467,47,46,93,50.5%,13m
6637,2,JamesZip,3588,306,17,8,25,68.0%,4m
6637,2,[Kemvo]Rabe,3588,153,4,3,7,57.1%,17m
6637,2,AtarashīKami,3588,125,2,6,8,25.0%,11m
6637,2,DeadGame,3588,0,1,0,1,100.0%,6m
6637,2,RamboMarine,3588,0,1,3,4,25.0%,16m
6637,2,Unhealthy,3588,0,0,1,1,0.0%,25m
6637,2,PallaDium,3588,0,0,1,1,0.0%,6m
6637,2,[HBGS]MissKrause,3588,0,0,10,10,0.0%,7m
6650,2,iado,3587,1524,111,108,219,50.7%,13m
6650,2,Tkitwa,3587,1542,103,83,186,55.4%,7m
6650,2,Asparagus,3587,821,67,52,119,56.3%,7m
6650,2,[JLN19]Heat,3587,583,25,37,62,40.3%,6m
6650,2,Marso,3587,268,11,5,16,68.8%,26m
6650,3,Nehalem,3587,243,11,7,18,61.1%,17m
6650,2,BrusLy,3587,168,6,7,13,46.2%,8m
6650,2,BriKc,3587,88,2,1,3,66.7%,7m
6650,2,[ǂǂǂǂǂ]OvertMuffin,3587,0,0,1,1,0.0%,25m
6650,2,Metanoia,3587,0,0,1,1,0.0%,4m
6650,2,Arrandir,3587,0,0,2,2,0.0%,9m
6650,2,[simon]Simon,3587,0,0,2,2,0.0%,7m
6662,2,[NINJ88]Scorpion,3586,1494,63,65,128,49.2%,26m
6662,2,JULIBULLY,3586,785,32,27,59,54.2%,6m
6662,2,rzoiFlaming,3586,128,3,3,6,50.0%,25m
6662,1,[2kBC]BeRnI,3586,48,3,5,8,37.5%,17m
6662,2,ToxZaiN,3586,30,2,5,7,28.6%,10m
6662,2,MXI,3586,0,1,0,1,100.0%,11m
6662,3,[pSi]Thor,3586,0,1,0,1,100.0%,17m
6662,3,Trerg,3586,0,0,1,1,0.0%,7m
6662,2,[Cuack]SneakyCuack,3586,0,0,2,2,0.0%,13m
6671,1,Thome,3585,1733,187,195,382,49.0%,9m
6671,2,[WITCHs]Quiris,3585,1256,76,73,149,51.0%,25m
6671,2,Kamui,3585,1134,51,55,106,48.1%,4m
6671,2,TheFirstOne,3585,950,48,27,75,64.0%,6m
6671,2,[EXPANT]Livradianth,3585,1167,46,47,93,49.5%,16m
6671,2,SgtInfinity,3585,611,35,19,54,64.8%,4m
6671,1,FarEast,3585,142,8,4,12,66.7%,6m
6671,2,zeta,3585,116,8,7,15,53.3%,28m
6671,3,aling,3585,97,6,0,6,100.0%,7m
6671,2,AndY,3585,150,6,6,12,50.0%,24m
6671,2,uberluberl,3585,152,5,3,8,62.5%,28m
6671,2,ProdzaaH,3585,118,5,7,12,41.7%,19m
6671,3,Wildcard,3585,86,3,1,4,75.0%,27m
6671,2,[MaruGd]ChinaNoOne,3585,102,3,1,4,75.0%,26m
6671,3,marsO,3585,58,3,1,4,75.0%,10m
6671,2,SunCreep,3585,0,1,2,3,33.3%,27m
6671,3,PetitRenard,3585,0,0,1,1,0.0%,6m
6671,2,Crimson,3585,0,0,3,3,0.0%,19m
6689,2,IIIIIIIIIIII,3584,573,28,18,46,60.9%,9m
6689,2,john,3584,718,28,26,54,51.9%,17m
6689,2,derSoeldner,3584,712,25,29,54,46.3%,18m
6689,2,Miox,3584,348,13,12,25,52.0%,6m
6689,2,[86Mod]IMsoFUnny,3584,318,12,9,21,57.1%,17m
6689,2,POP,3584,162,8,1,9,88.9%,25m
6689,2,Cappuccino,3584,214,8,12,20,40.0%,27m
6689,2,Robby,3584,132,7,3,10,70.0%,16m
6689,3,TempleWorld,3584,30,2,0,2,100.0%,9m
6689,3,[WxN]NuTCrAcK,3584,0,1,0,1,100.0%,12m
6689,3,IlIlIlIlIlIl,3584,0,1,0,1,100.0%,3m
6689,3,PutIn,3584,0,0,1,1,0.0%,26m
6701,2,[3Azc]Zaphysic,3583,1528,68,70,138,49.3%,3m
6701,2,red,3583,548,20,20,40,50.0%,12m
6701,2,Thenix,3583,102,8,9,17,47.1%,4m
6701,2,PeterPan,3583,86,4,3,7,57.1%,10m
6701,3,Honnold,3583,58,2,1,3,66.7%,10m
6701,2,janez,3583,58,2,6,8,25.0%,3m
6701,2,ReStartZerg,3583,0,1,1,2,50.0%,18m
6701,2,Flare,3583,0,1,3,4,25.0%,28m
6701,3,[6m30]PhilAngel,3583,0,1,4,5,20.0%,5m
6710,1,Invictus,3582,1732,259,265,524,49.4%,11m
6710,2,[MRCW]Alphonsekarr,3582,1530,126,123,249,50.6%,27m
6710,2,[NsuP]Cakerush,3582,904,37,34,71,52.1%,13m
6710,3,[UCant]TouchMe,3582,347,14,7,21,66.7%,3m
6710,2,[PLA2N]Twice,3582,182,5,4,9,55.6%,16m
6710,2,[ZЕRGML]HobBit,3582,0,1,1,2,50.0%,13m
6710,3,NoisyBoy,3582,0,0,1,1,0.0%,14m
6710,3,[H0C]NoFrx,3582,0,0,2,2,0.0%,18m
6718,3,yann,3581,1620,479,527,1006,47.6%,18m
6718,2,DoctorExitus,3581,762,55,54,109,50.5%,19m
6718,2,[PaniC]BeMole,3581,1043,47,34,81,58.0%,6m
6718,3,[CLICKk]SweetDave,3581,876,39,31,70,55.7%,7m
6718,3,Jaha,3581,648,34,22,56,60.7%,5m
6718,2,Skunnigo,3581,657,32,20,52,61.5%,9m
6718,2,boppers,3581,470,17,19,36,47.2%,28m
6718,3,dru,3581,58,2,3,5,40.0%,6m
6718,3,Violation,3581,30,1,1,2,50.0%,14m
6718,2,Maciej,3581,0,1,3,4,25.0%,9m
6718,2,[SPHTRS]Drogon,3581,30,1,7,8,12.5%,15m
6718,2,[ThPoS]Fregate,3581,0,0,1,1,0.0%,24m
6730,2,hoodlum,3580,1516,92,98,190,48.4%,7m
6730,2,white,3580,1272,46,50,96,47.9%,7m
6730,2,Arthurka,3580,696,26,25,51,51.0%,24m
6730,2,[henD]Cerberi,3580,352,12,22,34,35.3%,27m
6730,1,AcidBurn,3580,203,5,1,6,83.3%,19m
6730,2,Harry,3580,86,4,5,9,44.4%,28m
6730,3,Yuki,3580,120,4,5,9,44.4%,15m
6730,2,[ATROYA]CACHEITOR,3580,30,1,5,6,16.7%,7m
6730,3,Buka,3580,0,0,1,1,0.0%,7m
6739,2,Broodmann,3579,1481,908,890,1798,50.5%,10m
6739,2,Mpoufos,3579,1567,425,424,849,50.1%,7m
6739,2,[acnes]DrTrainwreck,3579,1580,204,199,403,50.6%,18m
6739,2,[FGDU]Arcon,3579,566,32,18,50,64.0%,9m
6739,2,Tidsdemonen,3579,128,3,4,7,42.9%,6m
6739,3,ruslanbest,3579,30,1,1,2,50.0%,17m
6739,3,[ValidG]Poofpoo,3579,0,1,4,5,20.0%,15m
6739,2,[QMnewb]FiveSZ,3579,0,0,1,1,0.0%,3m
6747,2,dvl,3578,1543,152,156,308,49.4%,9m
6747,2,[1BA]Nickle,3578,1552,74,67,141,52.5%,9m
6747,2,[Hrr]Leatherman,3578,508,24,26,50,48.0%,17m
6747,2,Weedo,3578,88,4,6,10,40.0%,12m
6747,3,PPO,3578,0,1,0,1,100.0%,15m
6747,3,mint,3578,0,1,0,1,100.0%,14m
6747,3,derZERSTÖRER,3578,0,0,1,1,0.0%,10m
6754,2,Otori,3577,1474,210,210,420,50.0%,3m
6754,2,Sasquatch,3577,1028,50,27,77,64.9%,17m
6754,2,Phobos,3577,451,32,26,58,55.2%,12m
6754,2,Betrezen,3577,590,22,25,47,46.8%,18m
6754,2,Aylemao,3577,461,21,14,35,60.0%,10m
6754,2,[R0D]WeiYan,3577,316,11,14,25,44.0%,16m
6754,3,[SC2J]moniGGleb,3577,165,9,4,13,69.2%,9m
6754,2,емтравку,3577,196,6,5,11,54.5%,18m
6754,3,KrusTDisharg,3577,0,5,0,5,100.0%,5m
6754,3,XaReV,3577,60,3,1,4,75.0%,13m
6754,3,LiS,3577,86,3,2,5,60.0%,17m
6754,3,Zellan,3577,143,3,4,7,42.9%,7m
6754,3,LemanRuss,3577,30,1,1,2,50.0%,24m
6754,3,IIIIIIIIIIII,3577,0,0,1,1,0.0%,5m
6768,2,Deimos,3576,1638,647,615,1262,51.3%,15m
6768,2,Mic,3576,1574,185,190,375,49.3%,3m
6768,2,[HgS]feN,3576,722,68,65,133,51.1%,11m
6768,2,[Pøg]Mangue,3576,1334,62,72,134,46.3%,17m
6768,2,NexusNess,3576,808,50,43,93,53.8%,11m
6768,2,Lachend,3576,229,9,5,14,64.3%,7m
6768,3,Giap,3576,166,8,1,9,88.9%,5m
6768,3,[P2T]PapaDavII,3576,0,1,0,1,100.0%,19m
6768,3,[SunGmr]BadDayRDK,3576,0,0,1,1,0.0%,25m
6777,2,Zgura,3575,1345,104,110,214,48.6%,19m
6777,2,HaSseL,3575,1196,73,94,167,43.7%,7m
6777,3,[VMB]gAn,3575,1435,68,36,104,65.4%,25m
6777,2,EigOwaKaraN,3575,960,50,42,92,54.3%,7m
6777,2,[Rct]Shiki,3575,408,20,12,32,62.5%,15m
6777,2,KardashKiril,3575,278,15,7,22,68.2%,17m
6777,2,LEMI,3575,320,12,13,25,48.0%,11m
6777,2,DONNERKING,3575,155,8,12,20,40.0%,13m
6777,3,Dragon,3575,174,7,4,11,63.6%,12m
6777,3,MrSuperman,3575,103,5,2,7,71.4%,6m
6777,2,[CFFF]Flasher,3575,30,1,3,4,25.0%,6m
6777,2,ştrampi,3575,0,0,4,4,0.0%,12m
6789,2,yumulcak,3574,1548,380,361,741,51.3%,15m
6789,2,Bigbox,3574,1523,153,151,304,50.3%,15m
6789,3,MarineKing,3574,489,22,12,34,64.7%,24m
6789,3,Vivs,3574,576,22,15,37,59.5%,7m
6789,3,INQTV,3574,228,19,8,27,70.4%,10m
6789,2,thehacker,3574,296,14,8,22,63.6%,9m
6789,3,Dinosaur,3574,30,2,1,3,66.7%,5m
6789,3,[EXPANT]Capac,3574,30,1,1,2,50.0%,6m
6797,1,santa,3573,1743,286,292,578,49.5%,9m
6797,2,RussianBear,3573,1559,120,111,231,51.9%,4m
6797,2,Bärsärk,3573,1284,74,61,135,54.8%,5m
6797,2,Cáno,3573,716,24,32,56,42.9%,3m
6797,3,[iImba]llllllllllll,3573,268,9,5,14,64.3%,26m
6797,2,[BloTi]Space,3573,220,7,19,26,26.9%,18m
6797,2,Aragorn,3573,146,5,7,12,41.7%,8m
6797,2,[DDdogs]wizig,3573,60,2,5,7,28.6%,12m
6797,3,Shark,3573,0,1,0,1,100.0%,18m
6797,3,lilith,3573,0,0,1,1,0.0%,12m
6807,2,Indyb,3572,1543,157,146,303,51.8%,9m
6807,2,ARCMAN,3572,1263,112,113,225,49.8%,18m
6807,3,[ArGGEJ]River,3572,498,21,8,29,72.4%,9m
6807,3,PancakeMix,3572,187,10,5,15,66.7%,24m
6807,3,ceELnO,3572,0,1,0,1,100.0%,13m
6807,2,Apple,3572,0,1,2,3,33.3%,26m
6807,2,Fzweiaez,3572,0,1,4,5,20.0%,26m
6807,3,Alex,3572,0,0,1,1,0.0%,25m
6815,2,Phoenix,3571,1055,315,317,632,49.8%,28m
6815,2,Djurosaur,3571,1271,115,118,233,49.4%,18m
6815,2,ZizzooZazzle,3571,1515,108,108,216,50.0%,27m
6815,2,[IncS]ZICLord,3571,316,11,15,26,42.3%,13m
6815,3,chuckyeager,3571,192,7,6,13,53.8%,6m
6815,2,[SeBa]IamHoward,3571,208,7,10,17,41.2%,27m
6815,3,llllllllllll,3571,86,4,1,5,80.0%,18m
6815,3,Rocky,3571,88,3,3,6,50.0%,19m
6815,2,SiLLY,3571,58,3,6,9,33.3%,27m
6815,3,[Zhig]TyrantPavel,3571,0,1,0,1,100.0%,11m
6815,3,CuTeVikinG,3571,30,1,1,2,50.0%,12m
6815,2,Semcast,3571,0,0,6,6,0.0%,7m
6827,2,[BRSKR]Berzerker,3570,625,30,19,49,61.2%,6m
6827,2,RussianDad,3570,481,18,16,34,52.9%,10m
6827,2,GoSuAti,3570,268,13,9,22,59.1%,17m
6827,2,Shefarin,3570,286,11,14,25,44.0%,19m
6827,2,martin,3570,30,2,3,5,40.0%,19m
6827,3,Artöm,3570,0,1,0,1,100.0%,12m
6827,3,badPlayer,3570,0,1,0,1,100.0%,27m
6827,3,[BoBa]Elite,3570,0,1,0,1,100.0%,3m
6827,2,[BroG]BnanaShotgun,3570,88,1,2,3,33.3%,28m
6827,3,Stube,3570,0,1,4,5,20.0%,13m
6827,3,[K0mpis]Henrik,3570,30,1,5,6,16.7%,6m
6827,3,Batistuta,3570,0,0,1,1,0.0%,19m
6839,2,FunnyDrinker,3569,1515,215,217,432,49.8%,27m
6839,2,Severin,3569,1145,174,153,327,53.2%,8m
6839,2,Arthenas,3569,886,36,33,69,52.2%,5m
6839,2,Phonie,3569,894,32,35,67,47.8%,11m
6839,2,[TerBHD]Ankrama,3569,750,28,33,61,45.9%,24m
6839,2,Last,3569,473,23,19,42,54.8%,24m
6839,3,IIIIIIIIIIII,3569,381,14,12,26,53.8%,25m
6839,2,GGI,3569,0,0,2,2,0.0%,19m
6847,2,[EESC]Torru,3568,1270,64,64,128,50.0%,28m
6847,3,Pinou,3568,1423,56,48,104,53.8%,26m
6847,2,[Blacer]BarCode,3568,674,25,25,50,50.0%,25m
6847,3,LiquidFlem,3568,232,8,1,9,88.9%,12m
6847,2,LittleCheese,3568,119,7,1,8,87.5%,24m
6847,3,Ewanda,3568,208,7,2,9,77.8%,16m
6847,2,[D0N3]tiakun,3568,172,7,11,18,38.9%,25m
6847,3,marco,3568,97,6,0,6,100.0%,19m
6847,2,Niinja,3568,116,5,5,10,50.0%,27m
6847,2,[Heroes]BreaDy,3568,120,4,6,10,40.0%,3m
6847,2,[Mattis]MøøG,3568,116,3,2,5,60.0%,6m
6847,3,OuTSIdeR,3568,44,2,0,2,100.0%,6m
6847,3,[eTAZ]Muadip,3568,60,2,2,4,50.0%,9m
6847,2,ThePigBenis,3568,30,2,6,8,25.0%,7m
6847,3,Executeur,3568,0,0,1,1,0.0%,12m
6847,3,Dune,3568,0,0,1,1,0.0%,17m
6847,3,Mino,3568,0,0,1,1,0.0%,25m
6847,2,Leo,3568,0,0,2,2,0.0%,11m
6865,2,[D0N3]NEOinROME,3567,1559,151,136,287,52.6%,7m
6865,2,IIIIIIIIIIII,3567,1162,81,88,169,47.9%,28m
6865,2,GlokGlok,3567,596,75,79,154,48.7%,18m
6865,2,[Utroll]DaNaR,3567,1444,66,65,131,50.4%,26m
6865,2,dgs,3567,1294,61,73,134,45.5%,7m
6865,2,Rayder,3567,803,59,37,96,61.5%,4m
6865,2,Ferox,3567,1206,47,66,113,41.6%,7m
6865,2,[SRC]VitafreshUA,3567,450,20,13,33,60.6%,6m
6865,3,Brigitte,3567,58,2,2,4,50.0%,12m
6865,2,Veelz,3567,60,2,7,9,22.2%,25m
6865,2,BudgetINno,3567,30,1,3,4,25.0%,12m
6865,3,[MHACKS]SiliconSlick,3567,0,0,1,1,0.0%,16m
6865,2,[batat]Batsko,3567,0,0,2,2,0.0%,12m
6878,2,[MTNO1A]EEEEEEEEE,3566,557,242,240,482,50.2%,13m
6878,2,[RDrA]Fada,3566,1470,196,191,387,50.6%,25m
6878,2,Twanglet,3566,942,37,32,69,53.6%,3m
6878,1,IIIIIII,3566,118,7,2,9,77.8%,6m
6878,2,[AD]ResTinPeace,3566,156,5,13,18,27.8%,11m
6878,3,Shuffleblade,3566,30,2,1,3,66.7%,17m
6878,2,[boomer]depression,3566,30,2,5,7,28.6%,12m
6878,2,Xaaros,3566,30,2,8,10,20.0%,5m
6878,2,IIIIIIIIIIII,3566,30,1,4,5,20.0%,27m
6887,2,ThirtySixYO,3565,760,103,98,201,51.2%,28m
6887,2,RostockHMT,3565,1014,36,40,76,47.4%,27m
6887,2,MarshGeology,3565,890,33,32,65,50.8%,15m
6887,2,Invalid,3565,598,24,29,53,45.3%,8m
6887,2,iFSlayer,3565,487,23,15,38,60.5%,5m
6887,2,volanis,3565,167,5,6,11,45.5%,27m
6887,2,Dustry,3565,94,3,8,11,27.3%,15m
6887,3,Malod,3565,0,0,1,1,0.0%,3m
6887,2,ScrappyCoco,3565,0,0,2,2,0.0%,10m
6896,2,Kyle,3564,1520,217,220,437,49.7%,10m
6896,2,any,3564,837,35,29,64,54.7%,12m
6896,2,[CBTH]dream,3564,417,18,18,36,50.0%,10m
6896,3,Drill,3564,306,14,7,21,66.7%,9m
6896,2,[Wolven]EmirKaon,3564,0,0,5,5,0.0%,10m
6901,2,Wasc,3563,1602,434,427,861,50.4%,12m
6901,2,ChrzCTZ,3563,1140,101,97,198,51.0%,28m
6901,2,Bulldog,3563,1451,60,57,117,51.3%,15m
6901,3,DRad,3563,262,12,5,17,70.6%,18m
6901,2,Untitled,3563,254,9,18,27,33.3%,9m
6901,2,[XYFAN]Liverpool,3563,196,7,9,16,43.8%,8m
6901,1,Kaptajnen,3563,218,6,32,38,15.8%,27m
6901,3,FOX,3563,18,1,1,2,50.0%,11m
6909,2,Sansonov,3562,1539,356,350,706,50.4%,27m
6909,2,Bethell,3562,1588,257,235,492,52.2%,6m
6909,2,LilleSkutt,3562,1613,229,218,447,51.2%,7m
6909,2,MAX,3562,839,101,101,202,50.0%,13m
6909,2,[K0mpis]Pwnies,3562,1258,98,101,199,49.2%,28m
6909,3,Maltese,3562,1647,92,77,169,54.4%,12m
6909,2,Jetong,3562,488,20,21,41,48.8%,27m
6909,2,Terran,3562,512,17,26,43,39.5%,7m
6909,2,pafman,3562,392,13,17,30,43.3%,9m
6909,2,FNCdennis,3562,206,7,14,21,33.3%,4m
6909,2,vrt,3562,102,2,4,6,33.3%,7m
6909,3,FreemanSan,3562,96,1,1,2,50.0%,13m
6921,2,[iTHING]PolarFox,3561,1254,50,46,96,52.1%,26m
6921,3,Skylander,3561,381,20,14,34,58.8%,6m
6921,2,[iX]Winnie,3561,114,4,12,16,25.0%,16m
6921,3,Pekkakahva,3561,30,2,1,3,66.7%,26m
6921,3,[kogt]And,3561,0,1,0,1,100.0%,19m
6921,3,TMT,3561,0,0,1,1,0.0%,16m
6921,3,[xFUD]Araken,3561,0,0,2,2,0.0%,13m
6928,3,FilD,3560,1495,61,50,111,55.0%,8m
6928,2,Smeargollum,3560,1014,45,33,78,57.7%,13m
6928,2,Battler,3560,780,45,50,95,47.4%,25m
6928,2,[T3]rustyisback,3560,797,40,39,79,50.6%,16m
6928,2,Pikaboo,3560,720,33,26,59,55.9%,8m
6928,2,Senderzone,3560,302,29,28,57,50.9%,25m
6928,1,[OAC]Grizzly,3560,211,6,4,10,60.0%,19m
6928,3,OTMOPOzOK,3560,60,3,2,5,60.0%,8m
6928,2,MannerUp,3560,0,2,7,9,22.2%,8m
6928,3,InfesTKaracK,3560,0,0,1,1,0.0%,12m
6938,2,Loy,3559,844,295,291,586,50.3%,25m
6938,2,Poltergeist,3559,1326,154,158,312,49.4%,4m
6938,2,MATOKILLER,3559,1473,73,74,147,49.7%,26m
6938,2,KingChris,3559,1373,66,76,142,46.5%,7m
6938,3,Deicide,3559,961,39,29,68,57.4%,5m
6938,3,theswarm,3559,142,6,1,7,85.7%,10m
6938,3,MISITIC,3559,58,3,1,4,75.0%,5m
6938,3,FALLIN,3559,0,1,1,2,50.0%,13m
6938,2,[hBǂ]KrYstaLîn,3559,30,1,4,5,20.0%,3m
6938,3,[ƮesXG]BlueIce,3559,0,0,1,1,0.0%,3m
6938,3,HUAWEI,3559,0,0,1,1,0.0%,3m
6949,2,LazyGuyIII,3558,836,34,31,65,52.3%,8m
6949,2,Emzeror,3558,301,16,10,26,61.5%,8m
6949,2,[Juliet]Wakaranai,3558,224,9,10,19,47.4%,24m
6949,3,Mini,3558,210,7,7,14,50.0%,10m
6949,2,NiGhTmArE,3558,218,7,19,26,26.9%,5m
6949,3,ghost,3558,150,6,4,10,60.0%,9m
6949,3,SapoGg,3558,120,4,4,8,50.0%,28m
6949,3,nnm,3558,0,1,0,1,100.0%,26m
6949,3,EscapE,3558,0,0,1,1,0.0%,27m
6949,3,МОРДОЙВСАЛАТ,3558,0,0,1,1,0.0%,26m
6949,3,Valderan,3558,0,0,1,1,0.0%,17m
6960,2,okosan,3557,1550,85,76,161,52.8%,3m
6960,2,[1830]fzviii,3557,678,43,44,87,49.4%,27m
6960,3,[Glouk]SuperOliv,3557,296,13,5,18,72.2%,17m
6960,2,[SCVop]Cursingbroom,3557,144,10,13,23,43.5%,16m
6960,2,[FrF]Creed,3557,254,9,8,17,52.9%,7m
6960,3,BeNzX,3557,0,5,0,5,100.0%,9m
6960,2,Bohnicak,3557,158,5,13,18,27.8%,3m
6960,2,RKKA,3557,86,3,8,11,27.3%,9m
6960,3,[TSmash]DelFF,3557,30,2,0,2,100.0%,18m
6960,3,Tassadar,3557,0,1,0,1,100.0%,18m
6960,3,Pharohs,3557,0,1,0,1,100.0%,12m
6960,3,AuxilliuM,3557,0,1,1,2,50.0%,5m
6972,2,CannonFodder,3556,1384,120,112,232,51.7%,7m
6972,2,ElPoutros,3556,340,15,8,23,65.2%,9m
6972,3,NOONE,3556,378,14,10,24,58.3%,28m
6972,2,IgorGulyaev,3556,274,11,8,19,57.9%,9m
6972,2,tensoon,3556,172,10,13,23,43.5%,18m
6972,3,Maiev,3556,86,8,0,8,100.0%,8m
6972,3,Claire,3556,0,2,3,5,40.0%,4m
6972,3,Casalon,3556,0,0,1,1,0.0%,3m
6972,2,[Kbanus]liord,3556,0,0,4,4,0.0%,13m
6981,2,Element,3555,1276,232,228,460,50.4%,7m
6981,3,[R0]DOB,3555,1560,76,66,142,53.5%,4m
6981,2,[F42]Nuklearwurst,3555,762,35,42,77,45.5%,25m
6981,2,NiCe,3555,344,32,15,47,68.1%,18m
6981,2,Zeus,3555,242,22,18,40,55.0%,11m
6981,2,Guixo,3555,354,15,10,25,60.0%,5m
6981,3,Karox,3555,97,6,0,6,100.0%,13m
6981,3,DanDeSmith,3555,152,5,7,12,41.7%,25m
6981,3,[QGCREW]xxQGBroussxx,3555,141,4,1,5,80.0%,19m
6981,3,[Balz]Time,3555,0,1,1,2,50.0%,16m
6981,3,Blackskelet,3555,0,0,1,1,0.0%,19m
6981,3,[degrod]dickies,3555,0,0,1,1,0.0%,19m
6981,3,Grogu,3555,0,0,2,2,0.0%,13m
6994,2,[НТТ]ShinyRay,3554,1552,197,191,388,50.8%,27m
6994,2,adepT,3554,1368,79,64,143,55.2%,24m
6994,2,[PLST]Messircule,3554,1335,72,69,141,51.1%,8m
6994,2,[НТТ]Unwished,3554,752,28,31,59,47.5%,12m
6994,2,fatumow,3554,676,24,30,54,44.4%,27m
6994,2,MagisterLudi,3554,434,17,14,31,54.8%,15m
6994,3,UnknownNoTwo,3554,398,16,9,25,64.0%,19m
6994,2,WOWO,3554,174,15,14,29,51.7%,7m
6994,1,Vegan,3554,118,7,2,9,77.8%,3m
6994,3,NoXiS,3554,60,3,3,6,50.0%,15m
6994,2,ddu,3554,60,3,7,10,30.0%,27m
6994,3,Flachzange,3554,0,0,1,1,0.0%,8m
6994,3,Lollipop,3554,0,0,1,1,0.0%,7m
7007,2,Latte,3553,1492,140,127,267,52.4%,12m
7007,2,[MP2]jbb,3553,1565,105,93,198,53.0%,13m
7007,2,Kanax,3553,850,89,93,182,48.9%,17m
7007,2,[HZeS]Sodon,3553,1023,84,75,159,52.8%,9m
7007,2,Rick,3553,1199,84,76,160,52.5%,28m
7007,2,IronMan,3553,816,48,40,88,54.5%,3m
7007,2,Fruityloop,3553,707,36,30,66,54.5%,24m
7007,2,IIIIIlllllII,3553,212,9,3,12,75.0%,10m
7007,2,Kirk,3553,176,9,9,18,50.0%,7m
7007,1,Thunderstorm,3553,224,7,1,8,87.5%,12m
7007,3,HappyLook,3553,121,4,7,11,36.4%,25m
7007,3,Doublicat,3553,0,0,1,1,0.0%,13m
7019,2,SmartSputnik,3552,1511,160,159,319,50.2%,11m
7019,2,Kass,3552,690,97,101,198,49.0%,28m
7019,2,Dreamshock,3552,1248,76,65,141,53.9%,24m
7019,2,DeerPark,3552,908,60,50,110,54.5%,27m
7019,3,Ayin,3552,833,34,26,60,56.7%,18m
7019,3,Linkin,3552,604,23,18,41,56.1%,17m
7019,2,CooLio,3552,541,20,24,44,45.5%,7m
7019,3,[aW]Sminse,3552,224,8,5,13,61.5%,12m
7019,2,ShaggyKiwi,3552,188,7,9,16,43.8%,26m
7019,2,[Cannоn]RoadToDako,3552,150,6,8,14,42.9%,4m
7019,2,Brasserie,3552,154,5,5,10,50.0%,26m
7019,2,MacroMan,3552,66,2,10,12,16.7%,8m
7019,3,slastar,3552,0,1,0,1,100.0%,19m
7019,3,ПОТНЫЙСАМЕЦ,3552,0,1,4,5,20.0%,15m
7033,2,Ferdinand,3551,1562,562,563,1125,50.0%,11m
7033,2,KeeHo,3551,704,319,307,626,51.0%,12m
7033,2,halbekiste,3551,1554,106,89,195,54.4%,6m
7033,2,alex,3551,420,47,39,86,54.7%,27m
7033,2,Wunderbaum,3551,860,31,39,70,44.3%,11m
7033,2,[Drachw]ponken,3551,647,26,30,56,46.4%,9m
7033,2,[loxi]Oroch,3551,484,21,21,42,50.0%,18m
7033,3,[ICL]frugs,3551,288,10,15,25,40.0%,19m
7033,3,Noise,3551,216,6,4,10,60.0%,17m
7033,3,Trollking,3551,0,5,0,5,100.0%,15m
7033,2,[TÆR]Orion,3551,116,5,7,12,41.7%,7m
7033,3,Duststar,3551,58,3,3,6,50.0%,8m
7033,2,[GawAt]Like,3551,60,3,4,7,42.9%,17m
7033,3,Okeydoke,3551,30,2,0,2,100.0%,3m
7033,3,[Heroes]Kahre,3551,0,1,0,1,100.0%,16m
7033,3,IIIIIIIIII,3551,0,1,4,5,20.0%,3m
7049,2,Maru,3550,1547,103,76,179,57.5%,26m
7049,2,vadbko,3550,1021,101,96,197,51.3%,7m
7049,2,[HBGSJR]llllllllllll,3550,1534,88,96,184,47.8%,7m
7049,2,[iX]DERASTAT,3550,382,13,25,38,34.2%,7m
7049,3,JulianBrink,3550,301,11,3,14,78.6%,17m
7049,3,[CL3]FpLu,3550,0,0,1,1,0.0%,19m
7049,3,Gergi,3550,0,0,1,1,0.0%,26m
7049,3,Torello,3550,0,0,1,1,0.0%,13m
7057,2,Logovaz,3549,1205,47,46,93,50.5%,16m
7057,3,[theTPL]ZioJimbo,3549,681,25,21,46,54.3%,15m
7057,2,bunshichi,3549,426,14,16,30,46.7%,7m
7057,3,[TRUM]Feldred,3549,216,8,3,11,72.7%,12m
7057,3,Englin,3549,58,3,0,3,100.0%,19m
7057,3,[BAPEN]Peadix,3549,30,2,1,3,66.7%,16m
7057,3,Yujin,3549,0,1,0,1,100.0%,8m
7057,2,Aproecoquanß,3549,30,1,10,11,9.1%,16m
7057,3,Neylem,3549,0,0,1,1,0.0%,27m
7057,3,Ænima,3549,0,0,2,2,0.0%,18m
7067,2,Sepsimus,3548,841,268,266,534,50.2%,26m
7067,2,Orion,3548,1448,67,65,132,50.8%,7m
7067,2,[IBeAŚI]Bliss,3548,658,24,34,58,41.4%,18m
7067,2,Tundra,3548,296,11,14,25,44.0%,8m
7067,3,DarkNothingZ,3548,0,5,0,5,100.0%,17m
7072,2,[Heroes]Giaphage,3547,1312,60,45,105,57.1%,6m
7072,2,Niko,3547,978,47,30,77,61.0%,28m
7072,3,Parse,3547,1222,47,43,90,52.2%,16m
7072,2,karnomelk,3547,522,46,46,92,50.0%,27m
7072,2,TheEviL,3547,991,40,37,77,51.9%,27m
7072,3,Coba,3547,817,36,18,54,66.7%,26m
7072,2,Beren,3547,756,26,26,52,50.0%,16m
7072,2,[ANGRYY]poums,3547,562,19,28,47,40.4%,27m
7072,2,sammuelmumm,3547,484,18,18,36,50.0%,12m
7072,3,fdp,3547,324,13,7,20,65.0%,6m
7072,3,pHisch,3547,114,5,4,9,55.6%,6m
7072,3,DaMaDoR,3547,0,1,0,1,100.0%,19m
7072,3,[VVing]Name,3547,0,0,1,1,0.0%,3m
7072,1,[Heroes]Chris,3547,0,0,1,1,0.0%,8m
7072,3,Evgen,3547,0,0,2,2,0.0%,27m
7087,3,PushTheTempo,3546,817,186,165,351,53.0%,5m
7087,2,Irishcofee,3546,1306,102,96,198,51.5%,27m
7087,2,Hemosu,3546,324,11,17,28,39.3%,26m
7087,2,[KStyle]sitry,3546,256,9,14,23,39.1%,19m
7087,3,Hypno,3546,30,2,1,3,66.7%,12m
7087,1,Hoola,3546,0,1,0,1,100.0%,14m
7087,3,IIlIllllllll,3546,30,1,2,3,33.3%,7m
7094,2,CLemens,3545,1481,110,105,215,51.2%,24m
7094,3,zed,3545,982,40,31,71,56.3%,9m
7094,3,Sauce,3545,363,22,13,35,62.9%,4m
7094,3,BOSSVOODOO,3545,351,16,8,24,66.7%,19m
7094,3,Mellow,3545,307,14,9,23,60.9%,15m
7094,3,jffun,3545,142,5,5,10,50.0%,12m
7094,3,Nessbih,3545,0,4,0,4,100.0%,19m
7094,3,DoMioR,3545,30,1,2,3,33.3%,4m
7094,3,Bock,3545,0,0,1,1,0.0%,9m
7103,2,FoX,3544,1569,134,125,259,51.7%,27m
7103,2,SBSxDeepDown,3544,1038,60,54,114,52.6%,10m
7103,3,Tertriss,3544,1412,59,49,108,54.6%,11m
7103,2,[ROXKIS]Craft,3544,855,53,36,89,59.6%,25m
7103,3,Bambystyle,3544,1008,44,33,77,57.1%,19m
7103,2,[Bucket]Deolrin,3544,989,42,33,75,56.0%,10m
7103,1,FaZer,3544,244,11,5,16,68.8%,3m
7103,3,[IIARII]HanSolo,3544,86,3,1,4,75.0%,19m
7103,3,Rose,3544,30,2,0,2,100.0%,18m
7103,3,Zboøby,3544,30,2,2,4,50.0%,26m
7103,3,IIIIIIIIIIII,3544,0,1,0,1,100.0%,6m
7103,3,TheMicro,3544,0,0,1,1,0.0%,25m
7115,3,broly,3543,1635,80,80,160,50.0%,16m
7115,3,[CHSC]robertovic,3543,1087,46,39,85,54.1%,15m
7115,3,EMV,3543,584,42,31,73,57.5%,11m
7115,2,kasm,3543,791,39,41,80,48.8%,26m
7115,2,TommyShelby,3543,691,33,37,70,47.1%,7m
7115,2,[4THK]AniccA,3543,840,32,37,69,46.4%,24m
7115,3,AKiller,3543,506,19,16,35,54.3%,9m
7115,2,[NТB]IronPump,3543,486,18,16,34,52.9%,7m
7115,2,Кабельщик,3543,500,18,27,45,40.0%,18m
7115,2,[HsDL]Wazzup,3543,329,16,15,31,51.6%,7m
7115,3,code,3543,194,9,2,11,81.8%,9m
7115,3,[ChXx]Tam,3543,215,9,9,18,50.0%,17m
7115,3,Edge,3543,196,8,5,13,61.5%,13m
7115,3,PatoMagic,3543,114,4,3,7,57.1%,8m
7115,3,[xGolDx]TheKing,3543,58,3,1,4,75.0%,28m
7115,1,Cibernetic,3543,0,0,1,1,0.0%,5m
7115,3,[RBlood]Zéké,3543,0,0,3,3,0.0%,10m
7132,2,VCHouse,3542,1542,163,160,323,50.5%,6m
7132,2,Atlas,3542,1107,67,63,130,51.5%,7m
7132,2,chrisR,3542,555,25,16,41,61.0%,8m
7132,2,TheorY,3542,392,19,12,31,61.3%,13m
7132,3,ForStrings,3542,321,14,11,25,56.0%,17m
7132,3,[O1G]łJoeAceł,3542,280,11,7,18,61.1%,17m
7132,3,IIlIlllIIlII,3542,140,6,1,7,85.7%,7m
7132,3,Horsey,3542,161,5,1,6,83.3%,6m
7132,3,[IBeAŚI]Bahajinbo,3542,90,4,3,7,57.1%,25m
7132,3,[NoGy]IMBarabba,3542,95,2,2,4,50.0%,26m
7132,2,[ZERGML]Diesel,3542,102,2,3,5,40.0%,26m
7132,2,[PRIYM]ArKaï,3542,60,2,8,10,20.0%,9m
7132,3,Mikc,3542,30,1,3,4,25.0%,19m
7132,3,JosefStalín,3542,0,0,1,1,0.0%,27m
7132,3,RainbowTable,3542,0,0,1,1,0.0%,5m
7132,3,[Hplts]Silver,3542,0,0,3,3,0.0%,10m
7148,2,Blackearth,3541,1369,292,282,574,50.9%,18m
7148,2,Beemax,3541,1627,290,276,566,51.2%,9m
7148,2,NuLlZoNe,3541,1423,186,173,359,51.8%,10m
7148,2,Affenboi,3541,1643,130,118,248,52.4%,24m
7148,3,Viper,3541,1124,91,81,172,52.9%,4m
7148,2,TSUK,3541,1587,77,69,146,52.7%,5m
7148,3,Fresh,3541,810,67,8,75,89.3%,7m
7148,2,[IndyK]MLD,3541,708,37,44,81,45.7%,18m
7148,2,[OEGH]Moox,3541,498,17,22,39,43.6%,12m
7148,2,[Ä0Ä]dfhhhhhhhhhh,3541,296,15,9,24,62.5%,9m
7148,2,[CL0wnZ]VOLODIAGARAJ,3541,267,11,8,19,57.9%,7m
7148,3,IlIlIlIlIlIl,3541,44,4,3,7,57.1%,14m
7148,2,Wilzyx,3541,120,4,8,12,33.3%,17m
7148,2,[BRSKR]Ernie,3541,0,1,3,4,25.0%,16m
7162,2,klover,3540,748,73,64,137,53.3%,10m
7162,3,BRX,3540,768,37,13,50,74.0%,14m
7162,2,zwift,3540,562,21,24,45,46.7%,19m
7162,2,iNdigO,3540,564,20,27,47,42.6%,19m
7162,3,[НТТ]OveRLorD,3540,420,15,13,28,53.6%,17m
7162,2,TimeLord,3540,238,12,5,17,70.6%,12m
7162,3,[Worms]Yellowman,3540,295,10,9,19,52.6%,15m
7162,2,StifleR,3540,288,10,9,19,52.6%,28m
7162,3,[Hаsu]Quasar,3540,88,4,4,8,50.0%,10m
7162,3,CyNskyline,3540,90,3,4,7,42.9%,15m
7162,3,Tromex,3540,60,2,3,5,40.0%,19m
7162,3,[PÄR]Katten,3540,72,2,7,9,22.2%,3m
7162,3,Pistvakt,3540,0,0,1,1,0.0%,7m
7175,2,Kokowitch,3539,1404,215,211,426,50.5%,8m
7175,2,[NVY]Chips,3539,817,96,73,169,56.8%,19m
7175,3,arthann,3539,420,17,7,24,70.8%,7m
7175,3,OverDeadX,3539,312,15,9,24,62.5%,10m
7175,2,[Quite]Kabuto,3539,58,3,4,7,42.9%,8m
7175,3,[ШОУМЕН]Mambo,3539,30,2,1,3,66.7%,6m
7175,2,Kayfay,3539,58,2,7,9,22.2%,24m
7175,3,Leshiy,3539,0,1,0,1,100.0%,18m
7175,3,[Trishy]Bogus,3539,0,1,0,1,100.0%,17m
7175,2,[RCHES]Crank,3539,94,1,2,3,33.3%,9m
7175,3,Biotech,3539,0,1,3,4,25.0%,5m
7175,1,Jamesvin,3539,97,1,3,4,25.0%,11m
7175,2,Fusebot,3539,30,1,4,5,20.0%,26m
7175,3,[BeSC]Dante,3539,0,0,1,1,0.0%,5m
7175,3,[CAZO]CmAd,3539,0,0,1,1,0.0%,15m
7175,3,[CaSY]CarlosNapole,3539,0,0,1,1,0.0%,17m
7191,2,SleepyOwl,3538,1535,573,555,1128,50.8%,8m
7191,2,Eatme,3538,1373,108,117,225,48.0%,18m
7191,2,BlueSide,3538,662,100,77,177,56.5%,11m
7191,3,[wedown]Sorcaunta,3538,1603,75,70,145,51.7%,19m
7191,2,Ehrmantraut,3538,644,61,52,113,54.0%,27m
7191,2,Månegarm,3538,351,18,21,39,46.2%,7m
7191,3,Paws,3538,287,11,8,19,57.9%,8m
7191,2,Jan,3538,246,9,7,16,56.2%,6m
7191,2,Zewban,3538,224,9,8,17,52.9%,9m
7191,2,Akira,3538,178,6,6,12,50.0%,9m
7191,3,Maleb,3538,114,5,1,6,83.3%,15m
7191,2,[SEWP]ЛЕВ,3538,140,4,4,8,50.0%,17m
7191,3,Unfug,3538,58,2,4,6,33.3%,5m
7191,2,Sprut,3538,30,1,8,9,11.1%,12m
7191,3,Bartholomaus,3538,0,0,1,1,0.0%,8m
7206,2,[BCFW]datrandomguy,3537,1319,137,130,267,51.3%,9m
7206,2,Svytoy,3537,1377,110,109,219,50.2%,24m
7206,2,LiżMiJaja,3537,946,36,45,81,44.4%,7m
7206,2,[bbmGk]MrFahrenheit,3537,401,18,13,31,58.1%,5m
7206,3,Tsaari,3537,334,13,10,23,56.5%,12m
7206,3,[PRLS]Ozaro,3537,296,10,6,16,62.5%,18m
7206,2,TEMDH,3537,247,9,9,18,50.0%,8m
7206,2,[TheRPW]LIKER,3537,145,6,5,11,54.5%,28m
7206,3,commando,3537,120,5,5,10,50.0%,5m
7206,2,Sondaljan,3537,118,5,9,14,35.7%,28m
7206,3,[GZerO]tainy,3537,58,2,3,5,40.0%,3m
7206,3,GoldenRatio,3537,0,1,0,1,100.0%,14m
7206,3,[Remtic]mcderfreak,3537,30,1,3,4,25.0%,15m
7206,3,[MapHax]RandoDog,3537,0,0,1,1,0.0%,26m
7206,3,[WaSl]Xonarety,3537,0,0,1,1,0.0%,18m
7221,2,yaki,3536,1355,316,292,608,52.0%,27m
7221,2,SpaceCat,3536,1540,222,221,443,50.1%,19m
7221,2,Death,3536,693,65,44,109,59.6%,11m
7221,2,[BARJO]Maximus,3536,1390,57,53,110,51.8%,7m
7221,2,MyLittlePony,3536,416,20,11,31,64.5%,4m
7221,2,leKapitän,3536,360,15,16,31,48.4%,16m
7221,2,Starknight,3536,446,15,22,37,40.5%,9m
7221,2,[lXBOXl]GartenTerra,3536,480,14,23,37,37.8%,8m
7221,2,Veasharr,3536,198,8,17,25,32.0%,25m
7221,3,BabyMarine,3536,168,7,1,8,87.5%,26m
7221,3,sugus,3536,58,3,1,4,75.0%,14m
7221,2,slu,3536,114,2,5,7,28.6%,25m
7233,3,Tortuga,3535,1334,127,118,245,51.8%,20m
7233,3,Gôdmode,3535,514,23,11,34,67.6%,20m
7233,3,BroNumberOne,3535,526,22,9,31,71.0%,8m
7233,2,Arkhaz,3535,480,20,14,34,58.8%,27m
7233,3,eldiablo,3535,354,13,14,27,48.1%,6m
7233,2,Bogus,3535,162,9,5,14,64.3%,5m
7233,3,Zerg,3535,0,5,0,5,100.0%,15m
7233,3,TeriyakiBoyz,3535,0,5,0,5,100.0%,28m
7233,2,[BN]Pierrot,3535,124,4,13,17,23.5%,27m
7233,2,RedSnapper,3535,62,3,5,8,37.5%,12m
7233,3,[MWOT]Mimicry,3535,0,0,2,2,0.0%,10m
7233,3,[MAOLTE]BigBossALEX,3535,0,0,3,3,0.0%,10m
7245,2,Shlex,3534,1340,164,154,318,51.6%,27m
7245,2,[NoRel]MoRpHy,3534,1086,104,105,209,49.8%,13m
7245,2,SkyDagores,3534,880,53,50,103,51.5%,5m
7245,2,Berzerk,3534,1204,44,53,97,45.4%,25m
7245,3,Sweetling,3534,30,5,2,7,71.4%,5m
7245,3,Onsaker,3534,196,5,8,13,38.5%,6m
7245,3,Arkan,3534,86,4,4,8,50.0%,4m
7245,3,Assi,3534,30,1,1,2,50.0%,13m
7245,3,Trops,3534,30,1,2,3,33.3%,11m
7245,3,[PaniC]Bukhgalter,3534,0,0,4,4,0.0%,25m
7245,2,[FG7]Sweap,3534,0,0,8,8,0.0%,18m
7256,2,Zuko,3533,1536,200,190,390,51.3%,15m
7256,2,Moruen,3533,1176,104,109,213,48.8%,26m
7256,3,Samat,3533,874,85,76,161,52.8%,4m
7256,2,Sharksk,3533,1000,37,39,76,48.7%,12m
7256,2,makson,3533,200,9,15,24,37.5%,16m
7256,2,Mathez,3533,139,7,2,9,77.8%,19m
7256,3,Stoic,3533,114,5,0,5,100.0%,7m
7256,3,[zerkop]Prometheus,3533,88,4,2,6,66.7%,7m
7256,2,[UNCNKG]mobillord,3533,92,4,7,11,36.4%,16m
7256,3,[Shiny]Delta,3533,30,2,1,3,66.7%,28m
7256,2,[Ninjas]Navi,3533,0,1,0,1,100.0%,11m
7256,3,salt,3533,0,1,4,5,20.0%,20m
7268,2,Utposten,3532,659,63,57,120,52.5%,6m
7268,3,Molsbrov,3532,638,50,36,86,58.1%,5m
7268,3,Игон,3532,236,9,6,15,60.0%,13m
7268,3,Hsurwerot,3532,0,5,0,5,100.0%,3m
7268,3,[НТТ]HonMonO,3532,0,5,0,5,100.0%,28m
7268,3,[BLFIN]Predator,3532,0,1,0,1,100.0%,6m
7268,3,Dragon,3532,0,1,0,1,100.0%,28m
7268,3,[SC2SPB]RUDDA,3532,0,0,1,1,0.0%,6m
7268,3,exO,3532,0,0,1,1,0.0%,10m
7268,3,YaNaRion,3532,0,0,1,1,0.0%,25m
7278,2,Leo,3531,1523,173,167,340,50.9%,28m
7278,3,KAKASHI,3531,1614,110,88,198,55.6%,9m
7278,3,EmpShock,3531,1395,67,61,128,52.3%,13m
7278,2,sunnyd,3531,489,22,15,37,59.5%,24m
7278,2,Tavael,3531,284,20,20,40,50.0%,18m
7278,3,LiquidRIP,3531,0,5,0,5,100.0%,6m
7278,2,GaTo,3531,115,3,1,4,75.0%,6m
7278,1,Whistler,3531,119,2,1,3,66.7%,6m
7278,3,Endymion,3531,58,2,2,4,50.0%,17m
7278,3,Amethyst,3531,30,1,2,3,33.3%,25m
7278,3,[HBGSJR]Тescatlipoka,3531,30,1,3,4,25.0%,18m
7289,2,TylooTaeja,3530,861,52,34,86,60.5%,28m
7289,2,Last,3530,1156,42,48,90,46.7%,12m
7289,3,LMérovingien,3530,172,7,4,11,63.6%,13m
7292,2,RumboldQA,3529,1486,311,317,628,49.5%,18m
7292,2,FoodJob,3529,1521,95,110,205,46.3%,7m
7292,2,[iX]Tanuki,3529,1401,66,78,144,45.8%,7m
7292,3,boubou,3529,1310,56,42,98,57.1%,15m
7292,2,ark,3529,832,39,45,84,46.4%,18m
7292,2,Lenoksen,3529,493,20,23,43,46.5%,11m
7292,2,[Hyze]Yoh,3529,438,14,26,40,35.0%,15m
7292,3,FrUitDEaleR,3529,137,10,7,17,58.8%,25m
7292,1,Dreamer,3529,274,8,4,12,66.7%,11m
7292,3,Xerkaix,3529,91,5,6,11,45.5%,19m
7292,3,Stelion,3529,30,2,0,2,100.0%,8m
7292,3,[GerAM]Kratziki,3529,60,2,3,5,40.0%,27m
7292,3,SaintJimmy,3529,60,2,3,5,40.0%,13m
7292,3,HallaG,3529,0,1,0,1,100.0%,15m
7292,3,TyraN,3529,0,1,4,5,20.0%,6m
7292,3,BayLifeGG,3529,0,0,1,1,0.0%,3m
7308,2,blob,3528,1534,206,183,389,53.0%,5m
7308,2,Tio,3528,1466,99,104,203,48.8%,15m
7308,2,EGStephanoRC,3528,1002,66,51,117,56.4%,12m
7308,3,Szlafrok,3528,1298,50,46,96,52.1%,26m
7308,2,[AAhOo]Gandalf,3528,711,32,29,61,52.5%,12m
7308,2,[Ronins]Janusz,3528,280,19,25,44,43.2%,17m
7308,2,[GET]pANDE,3528,483,17,22,39,43.6%,7m
7308,3,Joke,3528,0,5,0,5,100.0%,14m
7308,3,Dodo,3528,114,5,4,9,55.6%,19m
7308,2,Luschbert,3528,90,4,8,12,33.3%,5m
7308,2,zafer,3528,92,3,8,11,27.3%,24m
7308,3,[PvZAS]Drake,3528,118,2,1,3,66.7%,3m
7308,3,ChiliPepper,3528,0,0,1,1,0.0%,13m
7308,3,Yoona,3528,0,0,1,1,0.0%,17m
7308,3,[xFenix]CazaDorMZ,3528,0,0,1,1,0.0%,6m
7308,3,[CCAV]JunnyKuper,3528,0,0,2,2,0.0%,27m
7324,2,[TheLB]TFKrieker,3527,1560,210,200,410,51.2%,7m
7324,2,Dontknow,3527,693,35,25,60,58.3%,9m
7324,3,[RÐ]daresse,3527,773,34,16,50,68.0%,26m
7324,2,[SoJ]JotuN,3527,695,29,20,49,59.2%,5m
7324,3,Cloudhawk,3527,0,1,0,1,100.0%,5m
7324,3,iFYaKKo,3527,30,1,2,3,33.3%,15m
7330,2,[SHiNP]Vitalka,3526,1136,69,46,115,60.0%,12m
7330,3,[THP]Dux,3526,960,37,33,70,52.9%,16m
7330,3,[PLA2N]tommygun,3526,600,25,16,41,61.0%,8m
7330,3,[LEBB]Choke,3526,30,1,1,2,50.0%,15m
7330,3,Оладушек,3526,0,0,1,1,0.0%,12m
7335,2,TERMINATOR,3525,1560,226,215,441,51.2%,9m
7335,2,Titi,3525,914,139,94,233,59.7%,12m
7335,2,[WÖLFE]UnitedNation,3525,1593,85,89,174,48.9%,27m
7335,2,[6POLE]Rocketknight,3525,794,77,70,147,52.4%,6m
7335,2,[CTVVMB]BABsukidesu,3525,925,36,37,73,49.3%,7m
7335,3,ouckack,3525,311,13,8,21,61.9%,18m
7335,3,[EGi]Fenrir,3525,174,10,8,18,55.6%,25m
7335,2,Flye,3525,290,10,11,21,47.6%,24m
7335,3,Mati,3525,234,9,8,17,52.9%,20m
7335,2,ThomasShelby,3525,253,6,13,19,31.6%,27m
7335,2,[LEVATI]čiZiVo,3525,142,3,6,9,33.3%,8m
7335,3,[ezboy]Fate,3525,30,1,1,2,50.0%,16m
7335,3,[servus]FruitPunsh,3525,0,0,1,1,0.0%,18m
7348,2,AGSlave,3524,1019,93,99,192,48.4%,25m
7348,2,PangBUBBA,3524,383,37,37,74,50.0%,15m
7348,2,[FåþFåþ]Whyher,3524,747,33,35,68,48.5%,12m
7348,3,miEye,3524,752,27,27,54,50.0%,19m
7348,2,duckspeaker,3524,439,23,24,47,48.9%,9m
7348,2,[TENRIX]nerz,3524,250,8,13,21,38.1%,16m
7348,3,TheMan,3524,182,6,8,14,42.9%,3m
7348,3,[IIE]WoBuGs,3524,0,5,0,5,100.0%,18m
7348,3,[Hyd]HerrderLinge,3524,0,5,0,5,100.0%,6m
7348,3,Barth,3524,58,2,2,4,50.0%,15m
7348,3,[SBROT]Scenmox,3524,58,2,3,5,40.0%,14m
7348,3,Neo,3524,0,1,1,2,50.0%,24m
7348,3,[Dniw3]StoneSculpt,3524,0,1,2,3,33.3%,18m
7348,3,HCGSA,3524,30,1,3,4,25.0%,12m
7362,2,HandsomeJBW,3523,1057,54,59,113,47.8%,26m
7362,3,VlSsVe,3523,612,37,24,61,60.7%,13m
7362,2,Kojak,3523,584,25,21,46,54.3%,27m
7362,3,[AciNoN]AngryFrog,3523,468,17,19,36,47.2%,27m
7362,3,[CORE]SudO,3523,30,6,1,7,85.7%,5m
7362,3,Vital,3523,42,6,1,7,85.7%,17m
7362,3,[Крух]ПeLMeNb,3523,88,3,4,7,42.9%,16m
7362,3,Arkarr,3523,30,1,1,2,50.0%,9m
7370,2,Martabaff,3522,1599,435,433,868,50.1%,15m
7370,2,Hamster,3522,1228,147,137,284,51.8%,4m
7370,3,Chezz,3522,1246,117,93,210,55.7%,28m
7370,2,Saharok,3522,767,58,51,109,53.2%,7m
7370,3,LittleAksMax,3522,578,43,36,79,54.4%,19m
7370,2,Ghostproject,3522,408,33,29,62,53.2%,9m
7370,3,BuDa,3522,286,13,9,22,59.1%,3m
7370,2,Grimforce,3522,243,12,11,23,52.2%,6m
7370,2,CBField,3522,189,7,7,14,50.0%,15m
7370,3,Cibo,3522,0,5,0,5,100.0%,16m
7370,3,Bench,3522,86,4,2,6,66.7%,9m
7370,3,ImperialFist,3522,0,3,0,3,100.0%,28m
7370,3,[Heroes]CharactR,3522,58,3,3,6,50.0%,4m
7370,3,NaDa,3522,0,1,0,1,100.0%,5m
7370,3,[ǂGSǂ]Steelix,3522,0,1,0,1,100.0%,6m
7370,3,Guru,3522,0,1,0,1,100.0%,9m
7370,3,eXcaLibur,3522,0,1,0,1,100.0%,6m
7370,3,INfernal,3522,30,1,4,5,20.0%,11m
7370,3,[tMnrd]Exercitus,3522,0,0,1,1,0.0%,8m
7370,2,[PLA2N]MoyaPrelest,3522,0,0,4,4,0.0%,27m
7390,2,RIPerRush,3521,1616,422,400,822,51.3%,19m
7390,3,[mfxed]Mitico,3521,1595,155,147,302,51.3%,8m
7390,2,[HQ31er]FENIX,3521,1576,91,89,180,50.6%,6m
7390,3,[УТочка]SeregaELCAMX,3521,1220,59,25,84,70.2%,16m
7390,2,CwanDer,3521,661,51,44,95,53.7%,8m
7390,2,[Kappap]Oceris,3521,671,38,31,69,55.1%,6m
7390,2,OutOfNowhere,3521,680,31,22,53,58.5%,15m
7390,2,IIIIIIIIIIII,3521,564,21,23,44,47.7%,16m
7390,2,classic,3521,358,16,9,25,64.0%,12m
7390,3,TheExault,3521,322,15,4,19,78.9%,6m
7390,2,UnderPants,3521,264,10,12,22,45.5%,3m
7390,2,FeNNy,3521,88,6,1,7,85.7%,12m
7390,2,sprig,3521,128,4,4,8,50.0%,27m
7390,2,carte,3521,82,4,6,10,40.0%,20m
7390,2,Square,3521,116,4,10,14,28.6%,19m
7390,3,jofri,3521,88,3,3,6,50.0%,5m
7390,3,kNo,3521,30,1,3,4,25.0%,8m
7390,3,KingPaploo,3521,0,0,1,1,0.0%,28m
7408,2,Remm,3520,1127,104,99,203,51.2%,12m
7408,2,Martoo,3520,539,32,37,69,46.4%,19m
7408,2,Solace,3520,436,23,17,40,57.5%,26m
7408,3,[KMNDX]MrInsane,3520,427,22,26,48,45.8%,18m
7408,3,[xNGSx]nim,3520,576,21,23,44,47.7%,6m
7408,2,magejiprotos,3520,511,21,25,46,45.7%,24m
7408,2,EBALOLOMATEL,3520,150,16,18,34,47.1%,18m
7408,3,Kharyb,3520,241,10,10,20,50.0%,27m
7408,3,shuggles,3520,72,6,6,12,50.0%,25m
7408,3,PhawZ,3520,120,5,3,8,62.5%,19m
7408,3,ThaLord,3520,0,1,0,1,100.0%,24m
7408,1,FXOSpace,3520,0,0,1,1,0.0%,26m
7408,1,noLAsjIO,3520,0,0,2,2,0.0%,18m
7421,2,[POLLOS]MajorPain,3519,1566,274,260,534,51.3%,7m
7421,2,[POOL8]jeremieleroy,3519,1522,170,175,345,49.3%,20m
7421,3,[VISsc]Kinein,3519,1028,42,32,74,56.8%,17m
7421,3,QuaD,3519,611,38,26,64,59.4%,15m
7421,2,Balance,3519,343,13,15,28,46.4%,9m
7421,2,Misaki,3519,229,7,12,19,36.8%,11m
7421,2,[Oath]Vengeance,3519,130,3,6,9,33.3%,10m
7421,3,KloHAUx,3519,30,2,3,5,40.0%,4m
7421,3,Bingobongo,3519,0,1,0,1,100.0%,5m
7421,3,lewfen,3519,0,1,3,4,25.0%,9m
7421,3,Anhthi,3519,0,0,1,1,0.0%,25m
7432,3,CROSS,3518,1627,195,182,377,51.7%,12m
7432,2,[HBGSJR]snotr,3518,1588,119,124,243,49.0%,19m
7432,2,Maverick,3518,730,102,94,196,52.0%,4m
7432,2,Dragony,3518,760,33,27,60,55.0%,17m
7432,2,[LożaP]AlexMacedon,3518,701,32,26,58,55.2%,17m
7432,2,SecretName,3518,557,31,19,50,62.0%,9m
7432,2,[aW]Whitelinker,3518,646,28,22,50,56.0%,27m
7432,3,Maasdam,3518,510,22,8,30,73.3%,28m
7432,3,KonekoNoHasu,3518,119,10,5,15,66.7%,4m
7432,2,[DRÔLE]MaGoï,3518,288,10,15,25,40.0%,17m
7432,3,Powerzucker,3518,142,9,3,12,75.0%,12m
7432,2,ZlobanChoban,3518,148,6,13,19,31.6%,10m
7432,3,[DeWei]pewpew,3518,120,4,5,9,44.4%,15m
7432,3,[ƮesXG]OceanicBG,3518,60,3,4,7,42.9%,16m
7432,3,Janis,3518,0,2,1,3,66.7%,19m
7432,3,MitrAndiR,3518,0,1,0,1,100.0%,16m
7432,3,Loading,3518,0,0,1,1,0.0%,18m
7432,3,Pouki,3518,0,0,2,2,0.0%,13m
7450,2,TwinDog,3517,1371,68,63,131,51.9%,4m
7450,3,[lMMl]Moreal,3517,626,25,18,43,58.1%,10m
7450,2,Allscorpion,3517,130,6,5,11,54.5%,6m
7450,3,[RBlood]hotTemplar,3517,180,6,9,15,40.0%,24m
7450,2,HorstLocal,3517,0,0,2,2,0.0%,6m
7455,2,Slade,3516,1469,98,95,193,50.8%,6m
7455,2,Morpheuskom,3516,1030,60,62,122,49.2%,7m
7455,3,ladyminya,3516,950,56,2,58,96.6%,5m
7455,3,KOnookie,3516,616,27,18,45,60.0%,12m
7455,3,PriPizdnutiy,3516,303,16,12,28,57.1%,3m
7455,3,Granate,3516,281,13,6,19,68.4%,9m
7455,2,nuclearpro,3516,181,8,2,10,80.0%,8m
7455,2,SomaliPirate,3516,161,6,6,12,50.0%,15m
7455,3,Atreides,3516,0,5,0,5,100.0%,14m
7455,3,Sepfor,3516,60,3,3,6,50.0%,26m
7455,3,sNfL,3516,0,0,1,1,0.0%,27m
7466,3,Moeppi,3515,1524,76,64,140,54.3%,5m
7466,3,[lMMl]Macmed,3515,1095,48,29,77,62.3%,15m
7466,3,Stimmur,3515,722,33,12,45,73.3%,6m
7466,2,[lOoOl]Galahad,3515,487,21,20,41,51.2%,19m
7466,3,[OXXXY]chvek,3515,218,9,4,13,69.2%,12m
7466,2,disorder,3515,206,6,19,25,24.0%,12m
7466,1,Ekra,3515,163,4,2,6,66.7%,15m
7466,3,[3osG]Frank,3515,30,1,1,2,50.0%,3m
7466,3,holy,3515,0,0,1,1,0.0%,16m
7466,3,[Умоджа]TEPPAH,3515,0,0,1,1,0.0%,10m
7466,3,Stef,3515,0,0,1,1,0.0%,9m
7466,3,Zeno,3515,0,0,2,2,0.0%,10m
7466,3,[R0K]itsAZN,3515,0,0,4,4,0.0%,11m
7479,2,[RTD]IRONWOLF,3514,1530,309,313,622,49.7%,18m
7479,2,Albano,3514,1486,169,169,338,50.0%,11m
7479,3,PKappa,3514,974,116,114,230,50.4%,5m
7479,3,Damon,3514,863,82,51,133,61.7%,17m
7479,2,[TAW]skill,3514,915,36,40,76,47.4%,5m
7479,3,[BWArmy]Lefrancais,3514,628,26,17,43,60.5%,9m
7479,2,[TeZet]Pablo,3514,312,12,17,29,41.4%,4m
7479,2,[CU84]PepitoAlcazr,3514,268,9,14,23,39.1%,8m
7479,2,[UATeam]Cronos,3514,214,8,12,20,40.0%,5m
7479,3,Marschmellow,3514,42,5,2,7,71.4%,16m
7479,3,Floki,3514,148,5,5,10,50.0%,6m
7479,3,[GdAT]xyxer,3514,167,4,4,8,50.0%,24m
7479,3,[Longdu]Zboub,3514,90,4,5,9,44.4%,12m
7479,2,BigGabe,3514,116,4,9,13,30.8%,11m
7479,3,JarJarAbrams,3514,30,2,1,3,66.7%,20m
7479,3,DarHaz,3514,0,0,1,1,0.0%,18m
7495,2,[Div303]Dupsko,3513,970,85,95,180,47.2%,28m
7495,2,Vedi,3513,1090,76,73,149,51.0%,27m
7495,3,FourEuro,3513,1228,50,38,88,56.8%,12m
7495,2,FanaT,3513,544,19,25,44,43.2%,7m
7495,3,[GeCl]Atlas,3513,378,15,13,28,53.6%,15m
7495,2,Tedski,3513,171,15,19,34,44.1%,27m
7495,3,llllllllllll,3513,176,10,5,15,66.7%,18m
7495,2,[BRSKR]Viroos,3513,206,9,10,19,47.4%,7m
7495,3,Funky,3513,92,4,3,7,57.1%,11m
7495,3,Hellbounder,3513,88,3,2,5,60.0%,26m
7495,3,[ƬC]Nukewizard,3513,86,3,3,6,50.0%,13m
7495,3,DaisOfHavoc,3513,151,3,4,7,42.9%,27m
7495,3,DreadGhost,3513,30,1,1,2,50.0%,4m
7495,3,[6MP]Zeo,3513,30,1,5,6,16.7%,6m
7509,2,Serval,3512,1471,396,405,801,49.4%,16m
7509,2,[ExTr1m]HeadCrabe,3512,1570,77,70,147,52.4%,15m
7509,2,KaRtOsHkA,3512,1152,51,45,96,53.1%,8m
7509,3,[NepXD]CriveN,3512,540,29,15,44,65.9%,17m
7509,3,[SO0S]Roxxas,3512,662,28,14,42,66.7%,26m
7509,2,[ÆR]ReVeHUN,3512,404,14,19,33,42.4%,18m
7509,3,[JDМ]SlotH,3512,230,9,10,19,47.4%,12m
7509,3,Wersi,3512,222,8,6,14,57.1%,27m
7509,3,Warmaninger,3512,140,6,2,8,75.0%,16m
7509,3,hgku,3512,118,5,4,9,55.6%,27m
7509,3,Issou,3512,0,3,0,3,100.0%,26m
7509,3,Omega,3512,0,2,5,7,28.6%,15m
7509,2,[PLY]Mozzal,3512,30,1,5,6,16.7%,8m
7509,3,[CCAV]EnErgy,3512,0,0,1,1,0.0%,26m
7509,3,DuMIIJIc,3512,0,0,2,2,0.0%,7m
7509,3,corea,3512,0,0,2,2,0.0%,16m
7525,2,[Wø]Darcklaw,3511,1625,176,169,345,51.0%,7m
7525,3,Fettoni,3511,568,24,21,45,53.3%,8m
7525,2,[KDV]Papaj,3511,432,15,17,32,46.9%,9m
7525,2,[B1G]Slacker,3511,152,6,10,16,37.5%,9m
7525,3,Tjensvoll,3511,146,5,6,11,45.5%,4m
7525,3,Acronos,3511,86,3,2,5,60.0%,15m
7525,2,Mike,3511,102,3,4,7,42.9%,9m
7525,1,MNMNMN,3511,0,1,0,1,100.0%,6m
7525,3,Banse,3511,30,1,1,2,50.0%,6m
7525,3,Zanarcane,3511,30,1,1,2,50.0%,12m
7535,2,FCA,3510,1254,109,116,225,48.4%,18m
7535,3,[TerBHD]myrgen,3510,201,40,32,72,55.6%,8m
7535,3,WindFury,3510,532,22,10,32,68.8%,7m
7535,3,[PLANgg]Hitman,3510,219,15,8,23,65.2%,19m
7535,3,[RevoGG]Mash,3510,278,10,12,22,45.5%,3m
7535,2,Source,3510,94,3,9,12,25.0%,19m
7535,3,[MegaPS]Chel,3510,0,0,3,3,0.0%,9m
7542,2,Reggaevac,3509,1538,252,222,474,53.2%,5m
7542,2,CapSto,3509,1539,242,246,488,49.6%,28m
7542,3,[BWArmy]FreeMmrGiver,3509,1635,125,114,239,52.3%,25m
7542,2,[TachIT]Swayman,3509,1089,69,73,142,48.6%,6m
7542,2,JamesBong,3509,1378,47,67,114,41.2%,8m
7542,2,FluffyEss,3509,734,30,31,61,49.2%,3m
7542,3,LGBTerran,3509,140,6,1,7,85.7%,25m
7542,3,[eW0lfz]Lukaku,3509,0,5,0,5,100.0%,14m
7542,3,[QTclub]BreffXX,3509,120,5,7,12,41.7%,8m
7542,3,SiLVeRLeaF,3509,86,4,0,4,100.0%,5m
7542,3,potatosalad,3509,30,2,1,3,66.7%,7m
7542,3,Daniliys,3509,0,0,1,1,0.0%,19m
7542,3,Valen,3509,0,0,1,1,0.0%,16m
7542,3,ZenO,3509,0,0,1,1,0.0%,19m
7556,2,[zukaCo]MaMu,3508,1256,145,145,290,50.0%,26m
7556,2,Sjera,3508,1331,89,87,176,50.6%,16m
7556,2,Littlemaru,3508,1143,53,64,117,45.3%,27m
7556,2,[Forell]Masterchif,3508,556,20,25,45,44.4%,26m
7556,2,Troggenir,3508,187,6,5,11,54.5%,7m
7556,3,[CCHP]erfoint,3508,0,1,0,1,100.0%,15m
7556,3,[APES]CaptainAPE,3508,0,0,1,1,0.0%,5m
7563,2,Whitesmoke,3507,1598,147,155,302,48.7%,5m
7563,2,Gvam,3507,1537,144,138,282,51.1%,12m
7563,3,[BarCОD]TinSoldier,3507,1040,50,30,80,62.5%,26m
7563,3,Olive,3507,384,13,16,29,44.8%,16m
7563,2,[GWB]Vexvl,3507,231,9,8,17,52.9%,24m
7563,3,IIIIIIIIIIII,3507,196,8,5,13,61.5%,27m
7563,3,XiondrapoS,3507,195,7,5,12,58.3%,4m
7563,2,Kilieyn,3507,48,3,7,10,30.0%,18m
7563,3,Rudtrack,3507,60,2,4,6,33.3%,27m
7563,2,[Uchi]HanniibaL,3507,30,2,7,9,22.2%,7m
7563,3,[GaRa]CenZaramos,3507,0,1,0,1,100.0%,5m
7563,3,[DarkMM]Kailer,3507,0,1,0,1,100.0%,16m
7563,3,IlIlIlIlIlIl,3507,0,1,0,1,100.0%,25m
7563,2,Nyxeu,3507,0,0,9,9,0.0%,28m
7577,1,david,3506,1683,262,298,560,46.8%,4m
7577,2,Alexandr,3506,1475,129,129,258,50.0%,27m
7577,2,Bloodcraft,3506,810,74,71,145,51.0%,16m
7577,3,[αX]Tystic,3506,698,27,22,49,55.1%,9m
7577,3,Ksyper,3506,530,21,17,38,55.3%,15m
7577,3,[ANGRYY]iMPRo,3506,411,18,10,28,64.3%,19m
7577,3,OneTrickT,3506,146,7,5,12,58.3%,10m
7577,3,Rosenørn,3506,142,6,4,10,60.0%,19m
7577,3,[440]DOOM,3506,0,5,0,5,100.0%,3m
7577,3,SideShow,3506,30,2,2,4,50.0%,8m
7577,3,IIIIIIIIIIII,3506,30,1,3,4,25.0%,25m
7588,3,Kitem,3505,1598,220,206,426,51.6%,27m
7588,2,[Kicx]Djinn,3505,1575,162,149,311,52.1%,4m
7588,2,Dedal,3505,1618,119,120,239,49.8%,5m
7588,2,[IAODI]Davdi,3505,994,54,48,102,52.9%,11m
7588,3,AnNiHiLaToR,3505,1222,50,40,90,55.6%,18m
7588,3,Mamon,3505,833,47,35,82,57.3%,13m
7588,2,[PaniC]ЛовкийЗерг,3505,1147,47,51,98,48.0%,17m
7588,2,omG,3505,264,9,10,19,47.4%,27m
7588,3,[Arabia]CaZ,3505,182,7,9,16,43.8%,26m
7588,3,[LSPs]lokillo,3505,30,2,2,4,50.0%,9m
7588,3,Maru,3505,0,2,3,5,40.0%,8m
7588,3,Alexander,3505,60,2,4,6,33.3%,15m
7588,3,[Darx]Prisma,3505,30,1,2,3,33.3%,4m
7588,3,[TITONG]SgSlayer,3505,0,0,1,1,0.0%,27m
7588,3,KrazyKariia,3505,0,0,1,1,0.0%,19m
7603,2,ChegZ,3504,856,92,99,191,48.2%,17m
7603,2,KGN,3504,1385,82,86,168,48.8%,6m
7603,3,Lio,3504,1106,77,71,148,52.0%,18m
7603,2,IntrinsiCat,3504,1116,52,64,116,44.8%,26m
7603,2,Barteveen,3504,1070,42,42,84,50.0%,11m
7603,3,[Bruuuu]Krunkies,3504,784,31,25,56,55.4%,7m
7603,3,[HGT]Endspiel,3504,622,23,21,44,52.3%,19m
7603,3,Conventer,3504,234,8,5,13,61.5%,9m
7603,3,StarLorD,3504,192,7,6,13,53.8%,20m
7603,3,Vehsardnök,3504,0,5,0,5,100.0%,18m
7603,3,IIIIIIIIIIII,3504,86,4,4,8,50.0%,18m
7603,3,korslash,3504,0,1,0,1,100.0%,5m
7603,3,[CatBad]MarsuPilami,3504,0,1,0,1,100.0%,27m
7603,3,[JKC]MarineKing,3504,0,0,2,2,0.0%,10m
7603,3,НоваяПапка,3504,0,0,3,3,0.0%,12m
7618,2,[SpCI]RAMZESPL,3503,1580,366,358,724,50.6%,19m
7618,3,dusha,3503,1576,311,275,586,53.1%,10m
7618,3,RavenSiberia,3503,917,132,117,249,53.0%,9m
7618,2,Maynard,3503,1010,75,54,129,58.1%,8m
7618,2,Aquin,3503,720,60,63,123,48.8%,3m
7618,3,[Hаsu]fjfalcon,3503,690,29,17,46,63.0%,19m
7618,3,lllllllllllI,3503,542,23,15,38,60.5%,5m
7618,2,Nick,3503,139,16,23,39,41.0%,18m
7618,3,NightDragon,3503,206,9,4,13,69.2%,26m
7618,2,Graupel,3503,228,9,4,13,69.2%,27m
7618,3,camrypower,3503,0,5,0,5,100.0%,19m
7618,2,[no1fan]INnoVation,3503,93,2,0,2,100.0%,9m
7618,2,Karchakov,3503,60,2,9,11,18.2%,3m
7618,3,MaxNiceOne,3503,0,1,0,1,100.0%,27m
7618,3,Inf,3503,0,1,0,1,100.0%,19m
7618,3,Lightpro,3503,0,1,4,5,20.0%,9m
7618,3,LazyProbe,3503,0,0,1,1,0.0%,24m
7618,3,Predator,3503,0,0,1,1,0.0%,27m
7618,1,[TheUE]Polackken,3503,0,0,2,2,0.0%,6m
7618,3,[vPaM]Regenmacher,3503,0,0,2,2,0.0%,15m
7618,3,[LOGG]belsazer,3503,0,0,4,4,0.0%,16m
7639,3,Nagisa,3502,1605,134,108,242,55.4%,9m
7639,2,granos,3502,1579,63,67,130,48.5%,11m
7639,3,sweetyHD,3502,1118,56,54,110,50.9%,28m
7639,3,[Moped]SirConfused,3502,1236,51,40,91,56.0%,16m
7639,3,[PŖïMĄŁ]PlokoPloko,3502,370,15,8,23,65.2%,5m
7639,1,Awenna,3502,222,11,6,17,64.7%,5m
7639,3,Kagukuk,3502,224,9,5,14,64.3%,15m
7639,3,CasqueOuille,3502,152,6,6,12,50.0%,27m
7639,3,tykin,3502,58,3,0,3,100.0%,25m
7639,3,Nightmare,3502,60,2,2,4,50.0%,4m
7639,3,[БАНДА]ZIBR,3502,0,1,2,3,33.3%,4m
7639,3,egoist,3502,30,1,2,3,33.3%,18m
7639,3,[PSlSTC]Minimoog,3502,0,1,4,5,20.0%,14m
7652,2,demel,3501,1659,410,403,813,50.4%,12m
7652,2,iPod,3501,1179,127,125,252,50.4%,12m
7652,2,[ACP]Pedro,3501,1533,91,79,170,53.5%,11m
7652,2,[LIQUID]SheeBa,3501,422,44,44,88,50.0%,16m
7652,2,[MSUSC2]mibig,3501,706,27,27,54,50.0%,9m
7652,1,Bizzy,3501,221,14,4,18,77.8%,5m
7652,2,[S100]DefloN,3501,154,6,12,18,33.3%,26m
7652,3,[TYWay]Bronze,3501,86,4,3,7,57.1%,27m
7652,3,Pdt,3501,0,1,0,1,100.0%,4m
7652,3,SoBiEllesen,3501,0,0,1,1,0.0%,8m
7652,3,[theDH]DonTStoP,3501,0,0,1,1,0.0%,5m
7652,3,[ATTBot]BudgetNezuKO,3501,0,0,1,1,0.0%,18m
7664,2,Jurassic,3500,1568,277,278,555,49.9%,18m
7664,2,Duck,3500,803,95,78,173,54.9%,11m
7664,2,[ValidG]DeathIsAwe,3500,500,65,71,136,47.8%,19m
7664,3,[HBGSJR]OTMOPOzOK,3500,672,25,25,50,50.0%,24m
7664,3,Andrew,3500,533,22,7,29,75.9%,14m
7664,2,Jeeky,3500,209,7,1,8,87.5%,6m
7664,3,[Granze]Kanapski,3500,184,6,9,15,40.0%,10m
7664,2,MaRs,3500,172,4,8,12,33.3%,4m
7664,3,[PinkPi]LittlePony,3500,0,3,2,5,60.0%,3m
7664,3,Magikarp,3500,0,3,2,5,60.0%,18m
7664,3,DaFella,3500,30,3,3,6,50.0%,5m
7664,3,LMS,3500,62,3,3,6,50.0%,17m
7664,2,dahtroop,3500,60,3,6,9,33.3%,12m
7664,3,[SaneGG]SilverFang,3500,58,2,4,6,33.3%,14m
7664,3,RELAPSE,3500,0,1,0,1,100.0%,18m
7664,3,[4X4]eZNighTmarE,3500,30,1,1,2,50.0%,6m
7680,3,LikeSmoke,3499,1642,137,122,259,52.9%,5m
7680,2,[LPP]helianor,3499,686,25,27,52,48.1%,13m
7680,3,Aucyus,3499,578,23,17,40,57.5%,25m
7680,3,xPaulAvocatx,3499,542,20,18,38,52.6%,19m
7680,2,BUDDHABOXED,3499,426,17,17,34,50.0%,9m
7680,2,mixmoove,3499,307,14,14,28,50.0%,7m
7680,3,[leOS]WLASSTELINE,3499,280,11,3,14,78.6%,6m
7680,2,Midgard,3499,309,10,14,24,41.7%,28m
7680,3,[ArmeAG]Meruem,3499,192,8,3,11,72.7%,12m
7680,3,Tigre,3499,0,5,0,5,100.0%,8m
7690,2,Metalmind,3498,1197,203,207,410,49.5%,26m
7690,2,[LWH]dramon,3498,1280,112,114,226,49.6%,26m
7690,3,[FRxFR]Makabay,3498,276,13,4,17,76.5%,19m
7690,1,Kymu,3498,309,13,5,18,72.2%,7m
7690,3,[αX]Azura,3498,302,12,6,18,66.7%,5m
7690,3,EliteFenix,3498,0,5,0,5,100.0%,14m
7690,3,[3GBY]GentleMan,3498,144,5,6,11,45.5%,19m
7690,3,CompleteMyNa,3498,116,4,4,8,50.0%,27m
7690,3,ErnstRiedler,3498,0,3,0,3,100.0%,18m
7690,3,[34390]reptil,3498,58,3,1,4,75.0%,16m
7690,3,DarkMind,3498,30,2,1,3,66.7%,25m
7690,3,Saint,3498,0,1,0,1,100.0%,5m
7690,3,astra,3498,0,1,0,1,100.0%,11m
7690,3,Hudry,3498,0,0,3,3,0.0%,8m
7704,2,Rostov,3497,1590,160,145,305,52.5%,8m
7704,2,Volrath,3497,888,124,106,230,53.9%,13m
7704,3,MrGambit,3497,1190,86,62,148,58.1%,13m
7704,2,Lolkek,3497,1365,65,57,122,53.3%,8m
7704,2,[GoldM]Hyouka,3497,578,19,32,51,37.3%,16m
7704,2,Toucan,3497,199,7,8,15,46.7%,28m
7704,3,Nikomo,3497,60,3,2,5,60.0%,18m
7704,3,[F2ACLK]Misstress,3497,0,1,0,1,100.0%,16m
7704,3,[ЖезлВО]SmaK,3497,30,1,2,3,33.3%,7m
7704,3,RyUuke,3497,0,0,1,1,0.0%,9m
7704,3,LowLife,3497,0,0,1,1,0.0%,5m
7715,2,PegHuK,3496,1563,386,397,783,49.3%,17m
7715,2,MMMM,3496,1212,180,168,348,51.7%,27m
7715,2,oku,3496,1616,94,99,193,48.7%,6m
7715,3,ÅpoliscreeÐ,3496,867,66,58,124,53.2%,12m
7715,2,челяба,3496,1064,61,56,117,52.1%,19m
7715,3,DPDOOM,3496,494,20,9,29,69.0%,18m
7715,3,Fellows,3496,209,9,5,14,64.3%,15m
7715,3,[RSPCT]Foooxxx,3496,190,7,4,11,63.6%,27m
7715,2,HappyM,3496,144,4,7,11,36.4%,27m
7715,2,[SpagLo]Asheir,3496,94,3,11,14,21.4%,8m
7715,3,Данила,3496,0,1,0,1,100.0%,8m
7715,3,seoulfm,3496,30,1,1,2,50.0%,12m
7715,1,Warrion,3496,0,0,1,1,0.0%,11m
7715,3,TheHomeR,3496,0,0,1,1,0.0%,8m
7715,3,Ran,3496,0,0,1,1,0.0%,6m
7730,3,urselig,3495,1593,167,153,320,52.2%,18m
7730,3,Allich,3495,1574,98,92,190,51.6%,8m
7730,2,misc,3495,1430,59,54,113,52.2%,12m
7730,2,[4H]dailith,3495,727,38,29,67,56.7%,3m
7730,2,[TheDOH]disieh,3495,1062,37,46,83,44.6%,18m
7730,3,Mad,3495,490,20,8,28,71.4%,27m
7730,3,KruT,3495,388,14,10,24,58.3%,27m
7730,2,[4TY2]Prospector,3495,369,13,14,27,48.1%,8m
7730,3,[juggr]Human,3495,200,8,4,12,66.7%,7m
7730,3,Psylogic,3495,58,2,3,5,40.0%,18m
7730,3,JeonTerran,3495,30,2,4,6,33.3%,5m
7730,3,Deuteriumm,3495,30,2,5,7,28.6%,8m
7730,2,[CJFF]JustLap,3495,0,1,5,6,16.7%,5m
7730,3,RoseHari,3495,0,0,1,1,0.0%,19m
7744,2,Josspair,3494,1508,140,137,277,50.5%,14m
7744,2,[IceHus]иван,3494,1282,82,77,159,51.6%,25m
7744,3,Khas,3494,116,4,6,10,40.0%,14m
7744,2,[TAW]Jeddrix,3494,62,2,10,12,16.7%,27m
7744,3,RussiaRustam,3494,0,1,0,1,100.0%,10m
7744,3,GoudaLord,3494,30,1,1,2,50.0%,16m
7744,3,[DnDz]Twisted,3494,0,0,2,2,0.0%,16m
7751,3,Unfug,3493,1554,112,81,193,58.0%,4m
7751,3,GoFast,3493,639,29,15,44,65.9%,17m
7751,3,[nØmnØm]Jaysus,3493,618,26,18,44,59.1%,19m
7751,2,Galaxygazer,3493,356,13,17,30,43.3%,13m
7751,3,[ILMP]Gravy,3493,30,1,5,6,16.7%,4m
7751,3,Zhopashnick,3493,0,0,1,1,0.0%,3m
7751,2,[yubm]Eyþór,3493,0,0,5,5,0.0%,7m
7758,2,KupaTrupa,3492,1553,257,252,509,50.5%,17m
7758,3,[HGame]Ghazgh,3492,873,54,34,88,61.4%,7m
7758,2,Denчik,3492,442,54,50,104,51.9%,4m
7758,3,ussr,3492,728,52,45,97,53.6%,12m
7758,2,arka,3492,679,27,25,52,51.9%,15m
7758,2,[PWNHUB]ChiLaX,3492,644,21,28,49,42.9%,6m
7758,3,INvasion,3492,176,14,10,24,58.3%,27m
7758,3,[EZPTS]rizo,3492,97,3,1,4,75.0%,4m
7758,3,[tvESP]maralekos,3492,0,1,4,5,20.0%,6m
7758,3,[αX]Banana,3492,0,0,1,1,0.0%,27m
7758,1,VHCF,3492,0,0,1,1,0.0%,16m
7758,3,Rayleigh,3492,0,0,4,4,0.0%,10m
7770,3,[WITCHs]KiWi,3491,1600,101,88,189,53.4%,6m
7770,3,MacroGG,3491,944,46,20,66,69.7%,25m
7770,3,blblbl,3491,646,22,27,49,44.9%,25m
7770,3,Chaton,3491,492,20,12,32,62.5%,8m
7770,1,Haruka,3491,280,10,4,14,71.4%,19m
7770,2,Jurez,3491,243,10,12,22,45.5%,8m
7770,3,Andreas,3491,88,4,4,8,50.0%,4m
7770,3,[EESC]Emperor,3491,58,2,6,8,25.0%,20m
7770,3,KpTainZurg,3491,0,1,1,2,50.0%,10m
7770,3,[GEGT]Nobtozz,3491,0,1,4,5,20.0%,18m
7780,3,[10110]Bestasttung,3490,951,124,111,235,52.8%,19m
7780,2,[Sarmat]RisingSun,3490,994,73,75,148,49.3%,7m
7780,3,AEG,3490,1418,54,51,105,51.4%,16m
7780,2,Unzoomed,3490,502,53,41,94,56.4%,5m
7780,3,[Lyster]theMinehamst,3490,800,37,36,73,50.7%,16m
7780,3,[БАНДА]GameOfDrones,3490,285,9,6,15,60.0%,5m
7780,2,DestinyRUSH,3490,126,4,19,23,17.4%,6m
7780,3,[FkDyMw]Ðryft,3490,30,2,1,3,66.7%,10m
7788,2,Asabuloo,3489,1547,218,192,410,53.2%,27m
7788,2,McClane,3489,1571,142,161,303,46.9%,18m
7788,2,BlackWidowK,3489,958,97,104,201,48.3%,11m
7788,3,ulkenauer,3489,688,85,84,169,50.3%,5m
7788,2,Iss,3489,1632,79,84,163,48.5%,11m
7788,3,KiwiNini,3489,687,54,30,84,64.3%,10m
7788,3,MarineSeed,3489,392,17,6,23,73.9%,9m
7788,2,Erwin,3489,384,14,21,35,40.0%,6m
7788,2,[LPaC]tornadoflash,3489,336,11,19,30,36.7%,27m
7788,3,Spotti,3489,197,9,10,19,47.4%,26m
7788,3,themask,3489,114,4,2,6,66.7%,10m
7788,3,eeevnsun,3489,58,2,1,3,66.7%,18m
7788,3,ЧудоПёс,3489,0,1,0,1,100.0%,5m
7801,2,mastercage,3488,1538,256,260,516,49.6%,3m
7801,2,Opponent,3488,1525,223,186,409,54.5%,17m
7801,2,Reign,3488,1183,57,48,105,54.3%,5m
7801,3,Mantlegen,3488,385,35,22,57,61.4%,5m
7801,2,BunchOfNerds,3488,547,24,25,49,49.0%,11m
7801,2,[ATCPT]React,3488,398,13,22,35,37.1%,6m
7801,3,sohay,3488,0,5,0,5,100.0%,5m
7801,3,[WaSl]Tafelwasser,3488,30,1,3,4,25.0%,5m
7809,3,[TSC]KipikK,3487,1142,105,97,202,52.0%,8m
7809,2,tsolis,3487,770,58,61,119,48.7%,25m
7809,3,[Kompis]SagasPappa,3487,390,15,14,29,51.7%,27m
7809,3,Charon,3487,214,10,2,12,83.3%,27m
7809,3,[ImbaIS]Kakuzu,3487,262,10,11,21,47.6%,10m
7809,3,[3M1]Yannik,3487,238,9,11,20,45.0%,27m
7809,2,Riply,3487,280,9,15,24,37.5%,4m
7809,3,[SSN]PriMe,3487,0,5,0,5,100.0%,12m
7809,3,MagicBox,3487,97,2,0,2,100.0%,19m
7809,3,tarekp,3487,30,1,1,2,50.0%,11m
7809,3,Quarwen,3487,30,1,1,2,50.0%,5m
7820,2,[JaPP]LeTLe,3486,1135,56,53,109,51.4%,12m
7820,3,Puffball,3486,263,26,19,45,57.8%,13m
7820,3,Derand,3486,662,26,20,46,56.5%,8m
7820,3,Somich,3486,410,15,16,31,48.4%,18m
7820,3,[D0L4N]Pakt,3486,272,9,14,23,39.1%,9m
7820,3,MDM,3486,88,8,3,11,72.7%,5m
7820,3,Favorit,3486,170,7,4,11,63.6%,18m
7820,3,Hølm,3486,161,6,3,9,66.7%,19m
7820,1,Hardwood,3486,0,5,0,5,100.0%,59m
7820,3,Skillszero,3486,122,4,6,10,40.0%,6m
7820,3,Westopoli,3486,30,2,2,4,50.0%,6m
7820,2,Askari,3486,30,1,15,16,6.2%,12m
7820,1,Fussoar,3486,0,0,3,3,0.0%,44m
7833,3,Theodosius,3485,1548,191,185,376,50.8%,3m
7833,3,Sootha,3485,401,73,70,143,51.0%,13m
7833,3,[plsr]Abueb,3485,484,18,17,35,51.4%,27m
7833,3,[MGTSC2]Feltini,3485,264,10,14,24,41.7%,18m
7833,2,Huansohn,3485,214,8,16,24,33.3%,8m
7833,3,Brick,3485,58,3,0,3,100.0%,16m
7833,3,eXistenZ,3485,60,3,3,6,50.0%,18m
7833,2,[U2]Scoow,3485,126,3,8,11,27.3%,3m
7833,3,[aDGa]Phleppse,3485,60,2,2,4,50.0%,11m
7833,3,Eclipse,3485,0,0,1,1,0.0%,19m
7843,2,ElMarru,3484,1528,172,171,343,50.1%,9m
7843,2,[сSсǃ]XumKO,3484,1205,141,134,275,51.3%,11m
7843,2,Schnitzel,3484,1653,84,81,165,50.9%,10m
7843,3,Deq,3484,1083,47,43,90,52.2%,15m
7843,3,Newnew,3484,732,46,31,77,59.7%,27m
7843,2,kokoka,3484,736,31,27,58,53.4%,3m
7843,3,AlPrK,3484,704,27,23,50,54.0%,15m
7843,3,QuaD,3484,578,25,15,40,62.5%,4m
7843,3,Tschulo,3484,556,21,20,41,51.2%,16m
7843,3,Chan,3484,362,13,17,30,43.3%,5m
7843,3,[cFADDA]WetPiricoccu,3484,254,9,12,21,42.9%,13m
7843,2,[NUKsyn]iRos,3484,172,5,8,13,38.5%,4m
7843,2,Zargothrax,3484,118,5,15,20,25.0%,5m
7843,2,[NBBS]Matte,3484,60,2,8,10,20.0%,13m
7843,3,IlIlIIIIIIII,3484,30,1,2,3,33.3%,18m
7843,3,[LGBTm]Tadach,3484,0,1,2,3,33.3%,3m
7843,3,xaeinxea,3484,0,0,1,1,0.0%,6m
7843,3,[яєѕ]BlackStones,3484,0,0,5,5,0.0%,27m
7861,3,Weinstein,3483,1458,182,168,350,52.0%,5m
7861,3,Zoff,3483,1342,167,163,330,50.6%,12m
7861,3,festyr,3483,372,42,27,69,60.9%,8m
7861,3,[XYX21]MattiCrazy,3483,302,10,12,22,45.5%,15m
7861,3,[PŖïMĄŁ]PaLLo,3483,30,1,4,5,20.0%,7m
7866,2,Masendzekunz,3482,1500,158,160,318,49.7%,3m
7866,3,[FLarva]zgeorgin,3482,1433,100,99,199,50.3%,28m
7866,3,Houden,3482,1337,62,62,124,50.0%,8m
7866,3,Yebaddie,3482,598,26,12,38,68.4%,16m
7866,3,Mojo,3482,218,9,3,12,75.0%,3m
7866,2,YippeeKiYay,3482,90,3,8,11,27.3%,3m
7866,3,[INDC]CHECKFIDER,3482,0,2,1,3,66.7%,5m
7866,3,[Brgman]TritZiu,3482,30,2,2,4,50.0%,12m
7866,3,Opalfruits,3482,30,1,1,2,50.0%,5m
7866,3,artur,3482,0,0,1,1,0.0%,10m
7866,3,JohnGalt,3482,0,0,1,1,0.0%,25m
7877,3,[PiGPan]Qazl,3481,480,18,17,35,51.4%,25m
7877,3,DRcrazy,3481,354,16,15,31,51.6%,19m
7877,2,[hufter]Luxus,3481,83,8,16,24,33.3%,19m
7877,3,ÐouÐ,3481,97,5,2,7,71.4%,12m
7877,3,XANA,3481,60,3,3,6,50.0%,16m
7877,3,IIllIIlIlIll,3481,0,1,0,1,100.0%,18m
7877,3,Narkom,3481,0,0,1,1,0.0%,10m
7877,3,[MLBA]asdfasdf,3481,0,0,1,1,0.0%,5m
7885,2,tsaga,3480,1503,157,164,321,48.9%,3m
7885,2,Ostap,3480,688,120,119,239,50.2%,11m
7885,2,ectoplasme,3480,1515,87,77,164,53.0%,9m
7885,2,MancoYNoob,3480,140,7,2,9,77.8%,19m
7885,3,CrazyRip,3480,0,1,0,1,100.0%,13m
7885,3,Kepons,3480,0,1,2,3,33.3%,8m
7885,3,[CyTron]mrDK,3480,0,0,1,1,0.0%,5m
7892,3,Антоний,3479,238,10,3,13,76.9%,3m
7892,3,DareTex,3479,118,5,2,7,71.4%,27m
7892,3,[Jail]DAVICO,3479,90,4,2,6,66.7%,26m
7892,2,RiotSlug,3479,92,3,10,13,23.1%,28m
7892,3,[BiOdrO]TemplarGBA,3479,0,1,1,2,50.0%,6m
7892,3,[ƮesXG]Spaced,3479,0,1,1,2,50.0%,7m
7892,3,dlinqnt,3479,30,1,1,2,50.0%,26m
7892,3,[Yerin]Youaresolozz,3479,0,1,2,3,33.3%,5m
7892,3,soniCSysteM,3479,0,0,1,1,0.0%,19m
7901,2,[сSсǃ]ROCKnROLL,3478,1534,175,184,359,48.7%,25m
7901,2,LottsPotts,3478,1437,128,129,257,49.8%,13m
7901,2,Apelsino,3478,1086,73,74,147,49.7%,10m
7901,2,bonky,3478,739,55,48,103,53.4%,5m
7901,3,МЁРТВЫЙПАША,3478,704,49,5,54,90.7%,12m
7901,2,Accuran,3478,558,18,31,49,36.7%,5m
7901,2,xlStok,3478,412,15,20,35,42.9%,12m
7901,3,Evolution,3478,114,4,2,6,66.7%,16m
7901,3,[GRYM]ricko,3478,30,2,0,2,100.0%,18m
7901,3,[kokon]OxiToCiN,3478,30,2,3,5,40.0%,20m
7901,3,[BlVr]Maverick,3478,0,1,1,2,50.0%,6m
7901,3,[SEWP]Arthur,3478,0,1,1,2,50.0%,27m
7901,3,[3DE]Checkmate,3478,30,1,3,4,25.0%,5m
7914,2,HyDrO,3477,1550,186,182,368,50.5%,8m
7914,2,higgsBoson,3477,785,56,58,114,49.1%,13m
7914,3,Adentalis,3477,457,22,11,33,66.7%,5m
7914,3,[696]Billy,3477,402,17,9,26,65.4%,18m
7914,3,[SKYBRS]CLASSIC,3477,124,5,8,13,38.5%,10m
7914,3,TripleBum,3477,58,2,2,4,50.0%,19m
7914,3,[MRaven]nfzgad,3477,30,1,1,2,50.0%,12m
7914,2,CrazyDave,3477,0,0,1,1,0.0%,8m
7914,3,Roqum,3477,0,0,1,1,0.0%,4m
7914,3,Fearless,3477,0,0,2,2,0.0%,9m
7924,2,loto,3476,1542,159,154,313,50.8%,5m
7924,2,[LYBITE]leonidas,3476,1105,126,138,264,47.7%,16m
7924,2,FlexOOSEMЪ,3476,1408,78,42,120,65.0%,15m
7924,2,[LePoF]LittleBoy,3476,1384,75,79,154,48.7%,6m
7924,2,[EESC]TripleS,3476,1108,39,49,88,44.3%,15m
7924,3,CitronBaBa,3476,610,27,10,37,73.0%,4m
7924,3,[ZDI]GearShift,3476,414,15,15,30,50.0%,12m
7924,3,Numb,3476,346,14,5,19,73.7%,19m
7924,3,[EseEse]Ese,3476,280,11,14,25,44.0%,16m
7924,3,[MaSiYa]Hercules,3476,244,8,12,20,40.0%,20m
7924,3,StinkyFrench,3476,97,6,1,7,85.7%,8m
7924,3,phox,3476,122,5,5,10,50.0%,13m
7924,3,[PvZEU]Arany,3476,0,4,1,5,80.0%,6m
7924,3,GGWellplayed,3476,45,3,7,10,30.0%,13m
7924,3,Lakan,3476,0,1,0,1,100.0%,8m
7924,3,Leaf,3476,30,1,3,4,25.0%,8m
7924,3,VanDykeBrown,3476,0,0,1,1,0.0%,25m
7924,2,mikeynoob,3476,0,0,1,1,0.0%,18m
7942,2,ROOOKS,3475,1610,383,383,766,50.0%,28m
7942,3,SuperGG,3475,1317,101,92,193,52.3%,8m
7942,3,[АРМОР]neAnatoliy,3475,798,74,64,138,53.6%,9m
7942,3,[lOoOl]microjackson,3475,717,36,16,52,69.2%,9m
7942,2,agarmi,3475,613,33,34,67,49.3%,19m
7942,2,Curtisio,3475,596,24,37,61,39.3%,12m
7942,2,KnifeHappy,3475,660,22,36,58,37.9%,3m
7942,3,llllllllllll,3475,263,10,1,11,90.9%,19m
7942,3,IIIIIIIIIIII,3475,150,7,5,12,58.3%,25m
7942,1,SparTa,3475,216,6,5,11,54.5%,11m
7942,3,LORM,3475,174,6,8,14,42.9%,6m
7942,3,Saint,3475,0,5,1,6,83.3%,10m
7942,3,GazFirst,3475,192,5,3,8,62.5%,25m
7942,3,gOOdGooD,3475,86,4,1,5,80.0%,5m
7942,3,Bentley,3475,0,1,0,1,100.0%,16m
7942,3,[Batia]Марик,3475,0,1,0,1,100.0%,26m
7942,3,liubo,3475,0,0,1,1,0.0%,15m
7942,3,Weezy,3475,0,0,6,6,0.0%,27m
7960,3,Cuddlesmoosh,3474,1045,136,123,259,52.5%,26m
7960,3,XTJ,3474,578,94,78,172,54.7%,17m
7960,3,McLovIn,3474,802,32,29,61,52.5%,5m
7960,3,[TLoG]QuarK,3474,142,5,8,13,38.5%,6m
7960,3,PositroniC,3474,30,1,1,2,50.0%,16m
7960,3,[FTN]Etirion,3474,0,0,1,1,0.0%,24m
7960,1,[PandaC]GRX,3474,0,0,1,1,0.0%,10m
7960,3,Xcessive,3474,0,0,1,1,0.0%,5m
7960,1,FaQuRaS,3474,0,0,1,1,0.0%,7m
7969,3,[SW4GZ]Smocher,3473,944,94,71,165,57.0%,25m
7969,2,MkP,3473,941,48,56,104,46.2%,13m
7969,3,Fredster,3473,557,42,28,70,60.0%,28m
7969,3,Lui,3473,732,32,22,54,59.3%,4m
7969,3,Troizza,3473,353,17,4,21,81.0%,12m
7969,2,Kyezer,3473,330,12,19,31,38.7%,5m
7969,3,HotSingleMom,3473,0,5,0,5,100.0%,27m
7969,3,blinblin,3473,62,3,3,6,50.0%,4m
7969,3,Huhn,3473,0,1,0,1,100.0%,19m
7969,3,Toastbrot,3473,0,1,2,3,33.3%,5m
7969,3,neko,3473,30,1,2,3,33.3%,6m
7969,3,[Övis]Overlord,3473,0,0,1,1,0.0%,6m
7981,3,[EKO]Galoc,3472,1228,49,42,91,53.8%,8m
7981,2,ManVSWild,3472,938,36,43,79,45.6%,28m
7981,3,Tejiuvo,3472,758,31,20,51,60.8%,18m
7981,3,[EUC]HAWX,3472,557,25,13,38,65.8%,18m
7981,2,[CeAa]plopoulpe,3472,580,21,31,52,40.4%,29m
7981,3,ExitSuccess,3472,317,15,8,23,65.2%,15m
7981,3,dirtygreg,3472,146,5,7,12,41.7%,18m
7981,3,[ТОЛЯ]FudoNomura,3472,58,3,1,4,75.0%,25m
7981,3,[FiVC]Asirius,3472,0,1,0,1,100.0%,25m
7981,3,turboworm,3472,0,1,0,1,100.0%,28m
7981,3,[oniz]Timws,3472,0,0,1,1,0.0%,10m
7981,3,lIlIlIlIlI,3472,0,0,1,1,0.0%,5m
7981,1,Greedy,3472,0,0,2,2,0.0%,12m
7981,2,[GXVII]Loli,3472,0,0,3,3,0.0%,7m
7995,2,Kaizen,3471,807,93,82,175,53.1%,27m
7995,3,BYUN,3471,1524,77,64,141,54.6%,12m
7995,3,Genovis,3471,951,40,41,81,49.4%,28m
7995,2,dajmi,3471,1164,40,52,92,43.5%,11m
7995,2,BarDasH,3471,422,15,20,35,42.9%,8m
7995,3,Grumos,3471,283,13,17,30,43.3%,12m
7995,3,NaysayeR,3471,204,8,2,10,80.0%,27m
7995,3,Baga,3471,142,5,5,10,50.0%,20m
7995,3,hochupokakat,3471,106,5,6,11,45.5%,19m
7995,3,[ECOMP]maula,3471,88,3,6,9,33.3%,28m
7995,3,KrzysztofFR,3471,58,2,2,4,50.0%,15m
7995,2,llllllllllll,3471,0,1,0,1,100.0%,10m
7995,3,[Cladoq]Shard,3471,0,0,1,1,0.0%,9m
7995,3,nazar,3471,0,0,1,1,0.0%,19m
7995,3,ZaebaloTvT,3471,0,0,1,1,0.0%,19m
7995,2,Ziven,3471,0,0,3,3,0.0%,5m
8011,3,Mistgun,3470,1493,185,164,349,53.0%,25m
8011,2,[MeDuS]Maito,3470,1498,96,101,197,48.7%,12m
8011,3,Guska,3470,1325,66,43,109,60.6%,9m
8011,2,PlayzMasta,3470,1007,39,41,80,48.8%,11m
8011,3,[PLA2N]Nontar,3470,798,33,22,55,60.0%,25m
8011,3,Berry,3470,474,31,34,65,47.7%,15m
8011,3,MATHEMATIK,3470,561,26,11,37,70.3%,3m
8011,3,riddle,3470,388,17,10,27,63.0%,19m
8011,3,RollyPolly,3470,402,17,12,29,58.6%,4m
8011,3,RageSkill,3470,462,17,17,34,50.0%,15m
8011,3,[DatAPM]Simon,3470,244,10,10,20,50.0%,15m
8011,3,[TheM]GreveGruva,3470,252,9,12,21,42.9%,15m
8011,3,stasMaru,3470,194,8,3,11,72.7%,7m
8011,3,PriceYouPay,3470,97,6,1,7,85.7%,11m
8011,3,Pikle,3470,121,6,1,7,85.7%,10m
8011,3,[Flexen]Synapsus,3470,90,4,2,6,66.7%,25m
8011,2,JakeLaMotta,3470,122,4,12,16,25.0%,13m
8011,3,Kentrum,3470,60,3,4,7,42.9%,28m
8011,3,sYnc,3470,90,3,5,8,37.5%,8m
8011,3,mrluiaard,3470,0,1,0,1,100.0%,13m
8011,3,[ACAB]DonDudelsack,3470,30,1,2,3,33.3%,10m
8011,3,KassToa,3470,30,1,2,3,33.3%,7m
8011,3,NspFancy,3470,0,0,1,1,0.0%,4m
8034,3,akmal,3469,1577,188,176,364,51.6%,18m
8034,3,[SPAINs]Jomasteur,3469,1673,126,97,223,56.5%,19m
8034,3,kjoersvik,3469,403,35,32,67,52.2%,19m
8034,3,Ripi,3469,302,14,8,22,63.6%,25m
8034,2,[0G]Xyusin,3469,270,11,11,22,50.0%,8m
8034,3,[TFSC]CaZo,3469,170,7,5,12,58.3%,27m
8034,3,LittleMac,3469,136,4,0,4,100.0%,12m
8034,3,[EESC]spartacusop,3469,86,4,2,6,66.7%,26m
8034,3,HappySweety,3469,145,4,2,6,66.7%,16m
8034,3,[ЧеЕПТ]NinkaSuka,3469,86,4,3,7,57.1%,11m
8034,3,iPeX,3469,58,3,0,3,100.0%,26m
8034,3,Quib,3469,58,3,3,6,50.0%,25m
8034,3,Solik,3469,0,1,0,1,100.0%,6m
8034,3,cRZRd,3469,0,0,1,1,0.0%,3m
8034,3,rendezvous,3469,0,0,1,1,0.0%,10m
8049,2,Ato,3468,1481,315,320,635,49.6%,19m
8049,2,[Arrows]Abaddon,3468,1465,61,59,120,50.8%,6m
8049,3,[ErSx]MrPumpkinman,3468,220,8,4,12,66.7%,13m
8049,3,gamja,3468,58,6,1,7,85.7%,16m
8049,3,Stdioh,3468,30,4,3,7,57.1%,3m
8049,3,kahite,3468,0,1,0,1,100.0%,16m
8049,3,NaQa,3468,0,0,4,4,0.0%,15m
8056,2,MaterialGirl,3467,462,49,45,94,52.1%,27m
8056,3,AnnoName,3467,554,41,29,70,58.6%,11m
8056,3,[IIOGII]Bobies,3467,384,38,35,73,52.1%,5m
8056,2,Vincent,3467,887,32,42,74,43.2%,4m
8056,3,GreatPeople,3467,784,31,25,56,55.4%,19m
8056,3,[Chrys]Sharen,3467,252,10,6,16,62.5%,15m
8056,2,[VETS]ImaG,3467,294,10,22,32,31.2%,5m
8056,3,szczery,3467,228,9,7,16,56.2%,11m
8056,2,Jazzbear,3467,198,6,16,22,27.3%,17m
8056,3,[PBZ]llIIlIIllllI,3467,97,3,4,7,42.9%,18m
8056,3,[SClaws]Coi,3467,0,0,2,2,0.0%,16m
8067,2,Roterclock,3466,1632,227,229,456,49.8%,28m
8067,3,ParkSodam,3466,1016,72,48,120,60.0%,15m
8067,3,Гошан,3466,1227,63,49,112,56.2%,16m
8067,3,equinox,3466,974,43,29,72,59.7%,6m
8067,2,Mars,3466,570,26,34,60,43.3%,17m
8067,3,[мапхак]Jokkushka,3466,468,16,18,34,47.1%,16m
8067,3,Ferantas,3466,332,12,13,25,48.0%,19m
8067,2,[GAZ]Kippi,3466,332,12,19,31,38.7%,12m
8067,3,DreamRunner,3466,60,3,2,5,60.0%,27m
8067,3,[LeLeK]king,3466,120,2,1,3,66.7%,27m
8067,3,[QRVA]FényJáró,3466,30,1,4,5,20.0%,14m
8067,3,JJson,3466,0,0,1,1,0.0%,9m
8067,3,ProtoSlayer,3466,0,0,1,1,0.0%,8m
8080,2,FURIKO,3465,1549,125,136,261,47.9%,18m
8080,3,CatKat,3465,1092,54,15,69,78.3%,6m
8080,3,Вантиец,3465,1163,49,42,91,53.8%,15m
8080,3,Gungnir,3465,522,21,24,45,46.7%,27m
8080,3,[vedV]Dravosh,3465,372,16,6,22,72.7%,10m
8080,3,[PLEBZZ]Bolt,3465,140,6,4,10,60.0%,6m
8080,3,JanzJenau,3465,118,4,10,14,28.6%,20m
8080,3,adfefnaofnae,3465,30,2,0,2,100.0%,25m
8080,3,IcEdrAgOn,3465,97,1,1,2,50.0%,10m
8080,3,CerO,3465,30,1,1,2,50.0%,17m
8080,3,[voff]SerpaN,3465,30,1,3,4,25.0%,4m
8091,2,Wekim,3464,1445,122,129,251,48.6%,15m
8091,3,PMW,3464,752,30,22,52,57.7%,8m
8091,3,Rhatorell,3464,313,14,9,23,60.9%,25m
8091,3,[CHCH]scvonfire,3464,200,8,9,17,47.1%,16m
8091,3,LionRK,3464,86,4,4,8,50.0%,6m
8091,3,FILIBUSTER,3464,0,3,2,5,60.0%,15m
8091,3,[zozos]predator,3464,92,3,7,10,30.0%,13m
8091,3,smolbe,3464,30,2,0,2,100.0%,6m
8091,3,Flintstone,3464,0,1,2,3,33.3%,7m
8091,3,Lemangrace,3464,0,1,3,4,25.0%,8m
8101,2,schrik,3463,1366,96,100,196,49.0%,28m
8101,2,MrDarkSplit,3463,501,73,67,140,52.1%,28m
8101,3,PlanetGaboTV,3463,1384,53,55,108,49.1%,18m
8101,3,[Xa]RageKraker,3463,512,20,11,31,64.5%,28m
8101,2,Yeti,3463,544,19,31,50,38.0%,12m
8101,3,Detrick,3463,187,13,5,18,72.2%,15m
8101,3,Cidre,3463,342,12,15,27,44.4%,15m
8101,3,TiroOst,3463,169,8,2,10,80.0%,8m
8101,3,[Ronins]Duxagero,3463,168,5,0,5,100.0%,19m
8101,3,[BFRH]SnuteFlute,3463,88,3,5,8,37.5%,17m
8101,3,Michael,3463,30,2,0,2,100.0%,12m
8101,3,[Psyc]Naz,3463,97,2,0,2,100.0%,11m
8101,3,MicroMarine,3463,0,1,0,1,100.0%,6m
8101,3,[SIMONS]Tinqs,3463,0,1,0,1,100.0%,7m
8101,3,[яєѕ]Lurkas,3463,0,0,3,3,0.0%,18m
8116,3,IIIIIIIIIII,3462,143,7,2,9,77.8%,4m
8116,3,[CPROP]GGWP,3462,0,4,2,6,66.7%,27m
8116,3,Pathos,3462,86,4,3,7,57.1%,16m
8116,3,Myta,3462,58,2,1,3,66.7%,16m
8116,3,Anpanman,3462,58,2,3,5,40.0%,18m
8116,3,Uraysis,3462,0,1,0,1,100.0%,4m
8116,3,Miraels,3462,0,0,1,1,0.0%,15m
8123,2,Magomed,3461,823,322,322,644,50.0%,12m
8123,2,sousmarinier,3461,1427,254,248,502,50.6%,17m
8123,2,JanosMlotos,3461,951,95,88,183,51.9%,3m
8123,3,Aykay,3461,772,62,63,125,49.6%,15m
8123,3,Reamonn,3461,1265,54,36,90,60.0%,5m
8123,3,IIIIIIIIIIII,3461,556,26,14,40,65.0%,15m
8123,3,soyCowboy,3461,534,21,13,34,61.8%,27m
8123,2,Tank,3461,490,16,28,44,36.4%,26m
8123,3,Vasec,3461,382,13,16,29,44.8%,19m
8123,3,[JBMr]MVPBASTRI,3461,255,12,7,19,63.2%,26m
8123,3,[Penza]QuZerK,3461,250,11,8,19,57.9%,19m
8123,1,HAMMAR,3461,210,10,8,18,55.6%,16m
8123,3,[BornG]arT,3461,254,10,9,19,52.6%,16m
8123,3,Royal,3461,86,3,3,6,50.0%,20m
8123,3,MarineOne,3461,0,1,0,1,100.0%,25m
8138,3,[RUS124]Wrestler,3460,1011,110,96,206,53.4%,3m
8138,3,[Fѕ]Crazypapy,3460,1229,58,53,111,52.3%,7m
8138,3,Lenin,3460,474,54,38,92,58.7%,18m
8138,2,Guitchauss,3460,584,23,34,57,40.4%,8m
8138,3,Mullemeck,3460,454,16,17,33,48.5%,12m
8138,3,[CDogs]Sephiroth,3460,404,15,13,28,53.6%,19m
8138,2,[RoyF]Methraton,3460,233,12,8,20,60.0%,15m
8138,3,alone,3460,30,2,0,2,100.0%,27m
8138,3,[HämSec]LightTrack,3460,0,1,0,1,100.0%,27m
8138,3,[NAGGAS]BobbyRO,3460,30,1,1,2,50.0%,10m
8138,3,NipeL,3460,0,1,1,2,50.0%,11m
8149,3,WildMarine,3459,1385,153,151,304,50.3%,16m
8149,3,Walle,3459,1560,131,133,264,49.6%,8m
8149,3,[TDEF]PMKASA,3459,1109,63,43,106,59.4%,19m
8149,3,behlinho,3459,1092,60,39,99,60.6%,16m
8149,3,jojozocker,3459,766,47,37,84,56.0%,25m
8149,3,WhiZerg,3459,86,4,3,7,57.1%,7m
8149,3,starfighter,3459,44,3,2,5,60.0%,8m
8149,3,[RB25]ExperienceD,3459,0,1,0,1,100.0%,8m
8149,3,Echizen,3459,0,1,1,2,50.0%,25m
8149,3,[IMBAT]LukaszDudus,3459,30,1,1,2,50.0%,18m
8159,3,theO,3458,1614,226,219,445,50.8%,27m
8159,3,xertion,3458,1584,113,98,211,53.6%,14m
8159,2,[AiRǂ]lorimbo,3458,103,3,5,8,37.5%,5m
8159,2,MicroMarine,3458,95,2,0,2,100.0%,7m
8159,3,[GdAT]Napolcochon,3458,30,2,2,4,50.0%,12m
8159,3,Vorgoth,3458,0,1,0,1,100.0%,27m
8159,3,Happy,3458,0,1,2,3,33.3%,26m
8159,3,[WipeN]Chomano,3458,0,0,1,1,0.0%,13m
8167,2,smiremorque,3457,1543,737,738,1475,50.0%,17m
8167,2,[TheDOH]Dimaria,3457,1572,109,98,207,52.7%,27m
8167,3,Venturo,3457,1581,89,83,172,51.7%,19m
8167,2,Exeo,3457,656,27,28,55,49.1%,5m
8167,3,[Pot]Filemon,3457,632,25,21,46,54.3%,19m
8167,2,[iX]dreign,3457,646,23,29,52,44.2%,5m
8167,3,CarrotJam,3457,528,21,12,33,63.6%,13m
8167,3,EnDLessSkiLL,3457,344,16,11,27,59.3%,19m
8167,2,Lokerbi,3457,186,6,20,26,23.1%,25m
8167,3,DoctorNinja,3457,0,0,1,1,0.0%,6m
8177,2,fzmr,3456,1456,85,100,185,45.9%,12m
8177,3,CyrusII,3456,689,29,29,58,50.0%,3m
8177,3,AuntIrma,3456,30,2,3,5,40.0%,25m
8177,3,Galka,3456,0,1,0,1,100.0%,11m
8177,3,LennyDean,3456,0,1,0,1,100.0%,27m
8177,3,[Yame]Magisthor,3456,0,0,1,1,0.0%,5m
8177,3,RUSLAN,3456,0,0,3,3,0.0%,4m
8184,3,lIlIlIlIlI,3455,465,26,3,29,89.7%,12m
8184,3,RXM,3455,531,21,9,30,70.0%,13m
8184,3,Martin,3455,434,17,10,27,63.0%,25m
8184,1,[VOES]Stryder,3455,342,13,6,19,68.4%,17m
8184,3,Andan,3455,117,8,5,13,61.5%,20m
8184,3,Change,3455,58,3,4,7,42.9%,5m
8184,2,Moufle,3455,95,2,2,4,50.0%,19m
8184,3,[ZERGML]DeinSterben,3455,0,1,0,1,100.0%,13m
8184,3,NicolasCage,3455,40,1,7,8,12.5%,12m
8184,3,OrdanBest,3455,0,0,1,1,0.0%,15m
8184,3,[BNest]LoneWolf,3455,0,0,1,1,0.0%,25m
8184,3,[BAIL]Susumu,3455,0,0,3,3,0.0%,4m
8196,3,ПапаПсих,3454,1409,105,96,201,52.2%,25m
8196,2,MadeClick,3454,349,96,102,198,48.5%,8m
8196,2,QwickPL,3454,1402,92,66,158,58.2%,27m
8196,2,Iden,3454,888,31,39,70,44.3%,6m
8196,2,mrkingsley,3454,412,14,25,39,35.9%,27m
8201,2,llllllllllll,3453,1335,68,82,150,45.3%,27m
8201,2,eGsGalacius,3453,1208,46,48,94,48.9%,8m
8201,3,KFJ,3453,988,40,29,69,58.0%,18m
8201,3,Majestic,3453,386,14,9,23,60.9%,13m
8201,1,BadPlayer,3453,301,13,6,19,68.4%,8m
8201,2,Sharovf,3453,370,12,17,29,41.4%,8m
8201,3,[OGSC]rhadamanthe,3453,239,11,4,15,73.3%,15m
8201,3,ReDy,3453,331,10,12,22,45.5%,19m
8201,3,CALLO,3453,142,6,3,9,66.7%,18m
8201,3,Vito,3453,86,5,5,10,50.0%,18m
8201,3,[MlGHTY]Atze,3453,30,1,1,2,50.0%,28m
8201,1,Niconicopoi,3453,0,1,3,4,25.0%,3m
8201,3,[JGT]NoN,3453,0,0,2,2,0.0%,19m
8214,3,gevilde,3452,1499,64,47,111,57.7%,7m
8214,3,GonzoPunkass,3452,444,45,22,67,67.2%,26m
8214,3,LitPord,3452,357,22,18,40,55.0%,18m
8214,3,strawberry,3452,227,11,3,14,78.6%,26m
8214,3,paknrozerg,3452,220,7,5,12,58.3%,13m
8214,3,HanoverLappy,3452,86,6,6,12,50.0%,12m
8214,3,someboi,3452,148,5,5,10,50.0%,12m
8214,3,[TheDOH]kadesh,3452,146,5,12,17,29.4%,19m
8214,3,IIIIIIIIIIII,3452,88,3,2,5,60.0%,19m
8214,3,IIIIIIIIIIII,3452,58,3,4,7,42.9%,14m
8214,3,[ORLCY]leonidZZB,3452,0,1,0,1,100.0%,19m
8214,3,[NLR]ZIBO,3452,40,1,2,3,33.3%,27m
8214,2,llllllllllll,3452,0,0,2,2,0.0%,25m
8227,2,Endothelion,3451,1333,121,119,240,50.4%,11m
8227,2,[QTcIub]Saevitium,3451,988,62,60,122,50.8%,9m
8227,2,JoeHard,3451,1100,45,45,90,50.0%,29m
8227,3,Derek,3451,58,3,0,3,100.0%,6m
8227,3,GinjaNinja,3451,0,1,3,4,25.0%,14m
8227,3,Zarfy,3451,0,0,1,1,0.0%,10m
8227,3,Сказки,3451,0,0,2,2,0.0%,27m
8234,1,SoulSurvivor,3450,1545,385,407,792,48.6%,19m
8234,2,[BWArmy]RoiDeMars,3450,1512,290,269,559,51.9%,6m
8234,2,AlwaysLoses,3450,920,182,175,357,51.0%,8m
8234,2,rampampampam,3450,1007,95,93,188,50.5%,13m
8234,3,[oneA]Jazz,3450,545,41,28,69,59.4%,16m
8234,2,KingBetto,3450,906,32,39,71,45.1%,12m
8234,2,Spitfire,3450,671,28,33,61,45.9%,7m
8234,2,Tugge,3450,704,25,32,57,43.9%,12m
8234,3,[WYG]Bigdaddy,3450,208,10,7,17,58.8%,3m
8234,3,Bertie,3450,200,8,4,12,66.7%,11m
8234,3,Alucard,3450,0,3,2,5,60.0%,27m
8234,3,SirBehachis,3450,30,2,0,2,100.0%,19m
8234,3,Deepmind,3450,0,1,0,1,100.0%,3m
8234,3,[xP4Px]ГусьУдачи,3450,30,1,1,2,50.0%,19m
8248,3,Skeeter,3449,546,43,28,71,60.6%,7m
8248,2,KingForADay,3449,502,16,23,39,41.0%,16m
8248,3,[CoLW]Insector,3449,299,11,4,15,73.3%,16m
8248,2,[Magin0]Corentin,3449,330,11,23,34,32.4%,5m
8248,3,Nevillz,3449,282,10,10,20,50.0%,16m
8248,3,Citizen,3449,280,9,11,20,45.0%,14m
8248,1,DMITR,3449,0,4,1,5,80.0%,54m
8248,3,ReeeeeFlux,3449,60,3,2,5,60.0%,12m
8248,3,DiCe,3449,0,1,0,1,100.0%,12m
8248,3,Spring,3449,30,1,3,4,25.0%,6m
8248,3,[Wø]Ptynat,3449,0,0,1,1,0.0%,7m
8248,3,[REEEEE]Ouros,3449,0,0,2,2,0.0%,5m
8248,3,[LK3000]TarzanXXXX,3449,0,0,2,2,0.0%,7m
8248,3,[MST]Baldur,3449,0,0,3,3,0.0%,4m
8248,1,[Z3b1]Terj,3449,0,0,5,5,0.0%,1h
8248,2,[FWin]XupinatoR,3449,0,0,10,10,0.0%,5m
8264,3,[Thor2]PetitHomme,3448,1466,62,55,117,53.0%,26m
8264,3,MrGambit,3448,408,19,11,30,63.3%,19m
8264,2,DontAtello,3448,433,19,15,34,55.9%,9m
8264,3,[Stix]Anomaly,3448,218,11,1,12,91.7%,28m
8264,3,llllllllllll,3448,221,7,5,12,58.3%,26m
8264,3,[Duwang]SmokinStyle,3448,122,5,5,10,50.0%,11m
8264,3,Solm,3448,86,3,4,7,42.9%,4m
8264,3,Michalll,3448,86,3,5,8,37.5%,16m
8264,3,MadScientist,3448,88,3,5,8,37.5%,8m
8264,3,urmumgaylol,3448,97,2,0,2,100.0%,16m
8264,1,OverLord,3448,0,0,5,5,0.0%,44m
8275,3,Azamantes,3447,1158,129,109,238,54.2%,11m
8275,2,OneTwo,3447,1205,49,48,97,50.5%,19m
8275,3,ssjakal,3447,148,6,6,12,50.0%,16m
8275,3,[DfF]Spirit,3447,70,4,2,6,66.7%,9m
8275,2,IIIlllIIIlll,3447,30,2,9,11,18.2%,19m
8280,2,LittleE,3446,1518,419,413,832,50.4%,12m
8280,2,Johan,3446,1462,130,135,265,49.1%,8m
8280,3,[1FU2]deathquasar,3446,1609,124,113,237,52.3%,4m
8280,3,[WeGr]McFeast,3446,1332,66,56,122,54.1%,26m
8280,3,Delirium,3446,1406,56,57,113,49.6%,12m
8280,3,Red,3446,1016,53,31,84,63.1%,7m
8280,3,SuJi,3446,734,29,25,54,53.7%,12m
8280,2,[DvX]InVesteR,3446,438,16,21,37,43.2%,19m
8280,1,Pacific,3446,376,14,7,21,66.7%,4m
8280,3,StyX,3446,193,9,3,12,75.0%,19m
8280,3,Great,3446,116,4,5,9,44.4%,6m
8280,3,[TKRs]houser,3446,30,3,3,6,50.0%,10m
8280,3,[aW]Jeatall,3446,0,0,1,1,0.0%,27m
8293,3,Mentat,3445,279,51,35,86,59.3%,5m
8293,3,FastGo,3445,877,43,20,63,68.3%,27m
8293,2,PoPinO,3445,534,25,31,56,44.6%,13m
8293,3,Tyoneb,3445,320,13,10,23,56.5%,16m
8293,3,WTRiker,3445,216,12,9,21,57.1%,26m
8293,2,Zekiah,3445,62,5,10,15,33.3%,27m
8293,3,irisnine,3445,0,1,0,1,100.0%,5m
8293,3,Phobos,3445,0,0,1,1,0.0%,14m
8293,3,YouCube,3445,0,0,1,1,0.0%,4m
8293,3,CeCi,3445,0,0,4,4,0.0%,17m
8303,2,Nonshlen,3444,1518,101,104,205,49.3%,10m
8303,3,Archonia,3444,1169,53,46,99,53.5%,5m
8303,2,MarineMenace,3444,324,12,4,16,75.0%,10m
8303,1,Fenix,3444,291,11,1,12,91.7%,11m
8303,2,Damon,3444,254,9,19,28,32.1%,10m
8303,3,romsel,3444,146,6,4,10,60.0%,13m
8303,3,Snowblind,3444,62,2,7,9,22.2%,18m
8303,3,[PARADX]MIAou,3444,0,1,0,1,100.0%,26m
8303,3,[NSBM]AntisaDød,3444,0,0,1,1,0.0%,27m
8303,3,[FrBz]Didi,3444,0,0,1,1,0.0%,27m
8303,3,[crabz]Vladimir,3444,0,0,1,1,0.0%,25m
8303,3,Nizahe,3444,0,0,1,1,0.0%,25m
8303,3,shøker,3444,0,0,2,2,0.0%,4m
8303,3,fgrds,3444,0,0,2,2,0.0%,9m
8317,2,Jinjopapa,3443,1535,374,375,749,49.9%,3m
8317,3,Infamis,3443,695,93,85,178,52.2%,5m
8317,2,[BWArmy]Oxwaa,3443,1110,46,45,91,50.5%,10m
8317,3,[SKSS]ringo,3443,603,28,21,49,57.1%,19m
8317,3,BoostTerran,3443,392,17,13,30,56.7%,3m
8317,3,PierreBzrd,3443,330,15,2,17,88.2%,4m
8317,3,ZikaKenobi,3443,288,13,10,23,56.5%,11m
8317,3,Zenix,3443,60,2,2,4,50.0%,10m
8317,3,Ønizuka,3443,0,0,1,1,0.0%,9m
8326,2,Zugzwang,3442,1139,220,226,446,49.3%,8m
8326,3,Niklas,3442,981,84,78,162,51.9%,20m
8326,2,[KLONK]Klon,3442,1334,81,82,163,49.7%,19m
8326,2,safter,3442,1303,78,68,146,53.4%,12m
8326,2,SieStein,3442,906,60,49,109,55.0%,27m
8326,3,Abrissbirne,3442,423,47,42,89,52.8%,9m
8326,2,SPBlackFall,3442,612,21,30,51,41.2%,11m
8326,2,[CIB]Spartanjo,3442,326,12,18,30,40.0%,9m
8326,3,XIPNOSIS,3442,280,11,8,19,57.9%,19m
8326,3,[Yame]GEEK,3442,246,9,9,18,50.0%,19m
8326,3,Zed,3442,142,6,2,8,75.0%,19m
8326,3,totoota,3442,90,3,4,7,42.9%,19m
8326,3,[NoObS]SyKo,3442,60,2,5,7,28.6%,18m
8326,3,LoribleStar,3442,30,1,1,2,50.0%,19m
8340,2,bonkian,3441,1012,129,138,267,48.3%,27m
8340,3,DoS,3441,1476,93,78,171,54.4%,28m
8340,2,Hebbe,3441,1380,92,85,177,52.0%,26m
8340,2,[dTemp]MaGeBaN,3441,844,36,32,68,52.9%,15m
8340,3,IIIIIIIIIIII,3441,889,34,23,57,59.6%,14m
8340,3,Kynikoi,3441,753,30,22,52,57.7%,19m
8340,1,[IRKPRO]Hellbat,3441,821,28,56,84,33.3%,8m
8340,3,Jebediah,3441,572,23,18,41,56.1%,18m
8340,2,HyungMin,3441,348,15,16,31,48.4%,12m
8340,3,Funky,3441,226,8,9,17,47.1%,16m
8340,1,[OUUH]Pokill,3441,138,3,0,3,100.0%,4m
8340,3,[Traxen]Mihalich,3441,90,3,7,10,30.0%,7m
8340,3,[Genera]BitokTorma,3441,0,1,0,1,100.0%,26m
8340,3,ManukinGG,3441,0,0,1,1,0.0%,27m
8354,2,Rottweiler,3440,1591,592,575,1167,50.7%,12m
8354,3,RION,3440,1670,239,230,469,51.0%,26m
8354,2,[BWArmy]Tchipe,3440,1485,133,134,267,49.8%,27m
8354,3,InfectiD,3440,1521,131,116,247,53.0%,7m
8354,3,IlIlIlIlIlIl,3440,1362,61,44,105,58.1%,6m
8354,3,[KGSC2]Joji,3440,440,16,15,31,51.6%,8m
8354,3,Gold,3440,246,9,4,13,69.2%,19m
8354,3,ToxicMilkSe,3440,128,5,5,10,50.0%,8m
8354,3,IIIIIIIIIIII,3440,58,2,1,3,66.7%,19m
8354,1,[Deejay]TaSoeur,3440,0,2,3,5,40.0%,49m
8354,3,[APeC]Typhon,3440,0,1,0,1,100.0%,10m
8354,3,Achilles,3440,30,1,6,7,14.3%,25m
8354,3,[OSgZ]MEGAZVER,3440,30,1,7,8,12.5%,5m
8354,3,[MindD]aLone,3440,0,0,3,3,0.0%,14m
8368,2,[BHA]nVy,3439,762,35,38,73,47.9%,13m
8368,3,broscarul,3439,286,11,10,21,52.4%,28m
8368,3,Spring,3439,292,10,17,27,37.0%,4m
8368,1,DogMonthly,3439,97,5,1,6,83.3%,15m
8368,3,Illllllllll,3439,141,4,0,4,100.0%,10m
8368,3,[Coward]Rohan,3439,62,2,7,9,22.2%,25m
8368,3,Kite,3439,0,0,2,2,0.0%,19m
8375,3,TinGodTerra,3438,889,41,32,73,56.2%,27m
8375,3,Kiisu,3438,204,17,17,34,50.0%,6m
8375,3,[AiRǂ]DemoN,3438,114,5,4,9,55.6%,28m
8375,3,[Oudill]WesC,3438,30,2,2,4,50.0%,12m
8375,3,[Repeat]BrokenArrow,3438,30,2,4,6,33.3%,5m
8375,3,TheQwaad,3438,0,1,1,2,50.0%,14m
8381,3,Dalevi,3437,904,103,98,201,51.2%,6m
8381,3,ValorTime,3437,1056,93,80,173,53.8%,19m
8381,2,FalconPawnch,3437,714,25,31,56,44.6%,8m
8381,3,[TheDOH]Miczu,3437,545,24,13,37,64.9%,4m
8381,3,GoOse,3437,386,13,17,30,43.3%,16m
8381,3,BarrettRTS,3437,266,10,10,20,50.0%,14m
8381,3,[UATeam]LFRSergey,3437,145,10,12,22,45.5%,3m
8381,3,[VSC]Vespucci,3437,0,1,0,1,100.0%,5m
8381,3,DraXter,3437,0,0,1,1,0.0%,19m
8381,3,[MDLB]Sevchenko,3437,0,0,1,1,0.0%,28m
8381,3,JOJO,3437,0,0,3,3,0.0%,15m
8392,3,Andrio,3436,1602,112,88,200,56.0%,15m
8392,3,[GdAT]Legendk,3436,1094,42,38,80,52.5%,26m
8392,3,ZuchTieStar,3436,918,32,35,67,47.8%,14m
8392,2,Plastic,3436,442,24,24,48,50.0%,9m
8392,3,KillerQueen,3436,574,22,21,43,51.2%,4m
8392,3,Oceans,3436,367,17,13,30,56.7%,19m
8392,3,[KDV]kiesiew,3436,218,9,3,12,75.0%,28m
8392,3,DasSosh,3436,117,5,1,6,83.3%,16m
8392,3,Scarlet,3436,0,4,1,5,80.0%,25m
8392,3,Sky,3436,88,4,3,7,57.1%,8m
8392,3,BigChair,3436,0,1,0,1,100.0%,13m
8392,3,[IceHus]INnoVation,3436,30,1,1,2,50.0%,7m
8392,3,Dron,3436,0,0,2,2,0.0%,12m
8405,2,[blaize]MikeOxmal,3435,963,151,142,293,51.5%,25m
8405,3,Ziconius,3435,975,105,97,202,52.0%,9m
8405,3,Kratos,3435,357,28,20,48,58.3%,14m
8405,3,[SxS]IlllIIlllllI,3435,599,21,27,48,43.8%,17m
8405,3,heimering,3435,474,19,12,31,61.3%,26m
8405,3,Mpq,3435,438,16,12,28,57.1%,7m
8405,3,NuKe,3435,344,14,5,19,73.7%,12m
8405,2,[PaniC]Gongilimb,3435,356,11,20,31,35.5%,16m
8405,3,[SEWP]Выпуклыш,3435,58,3,6,9,33.3%,28m
8405,3,KaSer,3435,30,1,1,2,50.0%,18m
8405,3,Fenrack,3435,0,0,1,1,0.0%,13m
8416,3,BruTaL,3434,1423,90,85,175,51.4%,19m
8416,2,[lMMl]Revo,3434,1187,70,80,150,46.7%,19m
8416,3,SashT,3434,978,37,38,75,49.3%,19m
8416,3,LaXJunkie,3434,462,16,23,39,41.0%,8m
8416,3,[HypeON]NatiskTolik,3434,0,1,0,1,100.0%,18m
8416,3,che,3434,0,1,0,1,100.0%,13m
8416,3,KaspecCZ,3434,0,0,6,6,0.0%,26m
8423,2,LetMePwnU,3433,1435,338,339,677,49.9%,12m
8423,3,TalDarim,3433,1620,122,109,231,52.8%,10m
8423,3,iceface,3433,776,73,58,131,55.7%,26m
8423,3,bosswoss,3433,766,49,53,102,48.0%,25m
8423,2,Sevchatski,3433,389,35,48,83,42.2%,27m
8423,3,PofukanKurac,3433,268,10,7,17,58.8%,5m
8423,3,[EXBOIS]pilipicant,3433,122,9,10,19,47.4%,8m
8423,3,Rusello,3433,170,6,6,12,50.0%,4m
8423,3,[GLD]FrapKunKù,3433,88,4,3,7,57.1%,4m
8423,3,crypton,3433,0,1,0,1,100.0%,9m
8433,3,[UTech]Ecen,3432,1577,108,96,204,52.9%,18m
8433,2,Fleshsmith,3432,811,98,86,184,53.3%,8m
8433,2,Itachi,3432,1456,88,77,165,53.3%,7m
8433,3,KappAtronicS,3432,1508,63,63,126,50.0%,18m
8433,2,DGZeya,3432,250,12,4,16,75.0%,13m
8433,3,[LOSK]Zordar,3432,296,12,6,18,66.7%,16m
8433,2,TheOlol,3432,332,12,22,34,35.3%,12m
8433,3,Tralarthas,3432,168,10,4,14,71.4%,6m
8433,1,RodiRus,3432,232,8,3,11,72.7%,13m
8433,2,Turbodunker,3432,145,8,21,29,27.6%,3m
8433,3,nitro,3432,30,6,0,6,100.0%,10m
8433,3,[Sp4rt4]SnAkE,3432,92,3,7,10,30.0%,6m
8433,3,MicroMarine,3432,0,1,0,1,100.0%,8m
8433,3,DonGrayGoose,3432,0,1,2,3,33.3%,28m
8433,3,Vincent,3432,30,1,6,7,14.3%,7m
8433,3,[BTwins]Croword,3432,0,0,1,1,0.0%,16m
8433,3,DevilT,3432,0,0,1,1,0.0%,18m
8433,3,Trooper,3432,0,0,3,3,0.0%,14m
8451,2,Morby,3431,1573,284,281,565,50.3%,28m
8451,3,ChAngaChOice,3431,1278,57,53,110,51.8%,11m
8451,3,[UDC2]lykaner,3431,284,10,16,26,38.5%,25m
8451,3,Peach,3431,209,9,3,12,75.0%,11m
8451,3,ZETA,3431,139,8,8,16,50.0%,17m
8451,3,Rokys,3431,86,4,0,4,100.0%,19m
8451,3,Coki,3431,58,3,0,3,100.0%,11m
8451,3,OnkelAdi,3431,58,3,0,3,100.0%,18m
8451,3,PAPINO,3431,0,1,3,4,25.0%,18m
8451,3,Happy,3431,0,0,1,1,0.0%,8m
8461,2,БоняПартович,3430,1267,110,129,239,46.0%,27m
8461,3,[ncotic]BioTech,3430,448,20,21,41,48.8%,19m
8461,2,IIIIIIIIIIII,3430,30,2,8,10,20.0%,15m
8461,3,[ESPION]EagleJohn,3430,0,1,0,1,100.0%,10m
8461,3,[тао]TIG,3430,0,1,0,1,100.0%,12m
8461,3,Storm,3430,0,1,2,3,33.3%,16m
8461,3,Chords,3430,30,1,2,3,33.3%,16m
8461,3,Naserox,3430,0,0,1,1,0.0%,6m
8469,3,[ChXx]ThorvaldAs,3429,1563,92,98,190,48.4%,26m
8469,3,MARaUder,3429,1001,55,52,107,51.4%,26m
8469,3,[Bias]piml,3429,650,32,26,58,55.2%,18m
8469,3,NoMatter,3429,534,22,15,37,59.5%,5m
8469,3,BigNickDigg,3429,422,18,10,28,64.3%,27m
8469,3,YouAnimal,3429,174,10,4,14,71.4%,15m
8469,3,FFScrunch,3429,60,2,3,5,40.0%,15m
8469,3,hukku,3429,58,2,7,9,22.2%,14m
8469,3,Barcode,3429,30,1,6,7,14.3%,10m
8469,3,McMules,3429,0,0,1,1,0.0%,7m
8479,2,[Dinner]kuba,3428,1245,176,179,355,49.6%,28m
8479,3,NRG,3428,797,119,104,223,53.4%,15m
8479,3,Kuriboh,3428,401,64,43,107,59.8%,4m
8479,2,SborS,3428,1270,52,55,107,48.6%,28m
8479,3,ZXCVB,3428,524,24,11,35,68.6%,16m
8479,3,prkstrelok,3428,429,19,12,31,61.3%,10m
8479,3,[dG]Remnant,3428,86,4,0,4,100.0%,9m
8479,1,Snuffels,3428,164,4,4,8,50.0%,11m
8479,3,Apareos,3428,88,4,6,10,40.0%,4m
8479,3,JMSan,3428,30,1,1,2,50.0%,12m
8479,3,Cielo,3428,0,0,1,1,0.0%,28m
8479,3,[PGZ]Konhadii,3428,0,0,1,1,0.0%,11m
8479,3,[УСС]GlebKaroch,3428,0,0,3,3,0.0%,26m
8492,3,TITICHAT,3427,943,62,65,127,48.8%,13m
8492,2,[BAZ]RaZorwire,3427,1248,52,53,105,49.5%,8m
8492,3,GGEZNOOB,3427,398,17,8,25,68.0%,12m
8492,3,[POLish]częstochowia,3427,305,16,18,34,47.1%,19m
8492,3,[PDG]szulu,3427,386,15,15,30,50.0%,19m
8492,3,toni,3427,310,12,12,24,50.0%,14m
8492,3,[CaH]Crownbranch,3427,86,3,4,7,42.9%,19m
8499,3,Ohld,3426,1567,111,98,209,53.1%,5m
8499,3,Danceacy,3426,1374,68,62,130,52.3%,27m
8499,2,Karajoff,3426,1044,44,55,99,44.4%,5m
8499,3,[SGEY]Torgrim,3426,784,35,16,51,68.6%,7m
8499,3,[KKTD]theRedMnM,3426,592,21,27,48,43.8%,14m
8499,3,[iNSEP]Jymmy,3426,316,11,16,27,40.7%,19m
8499,3,robotikov,3426,141,3,1,4,75.0%,19m
8499,3,[B4D4ss]Arty,3426,121,2,1,3,66.7%,14m
8499,3,Myrkotik,3426,30,1,2,3,33.3%,11m
8499,3,[YYRTTT]Neobakeur,3426,30,1,4,5,20.0%,18m
8499,3,[W4N]GaeLife,3426,0,0,1,1,0.0%,16m
8499,3,Blistix,3426,0,0,2,2,0.0%,14m
8499,2,[RSK]GrumpyRoach,3426,0,0,11,11,0.0%,4m
8512,3,[GGL1]ossir,3425,1274,51,47,98,52.0%,19m
8512,3,Shogun,3425,386,20,23,43,46.5%,12m
8512,3,OmasArche,3425,493,17,13,30,56.7%,13m
8512,3,Terransoraus,3425,318,16,11,27,59.3%,6m
8512,3,[ĦRZ]Xplode,3425,280,9,15,24,37.5%,10m
8512,3,AolloN,3425,58,4,1,5,80.0%,15m
8512,3,HeadBeagle,3425,58,3,1,4,75.0%,26m
8512,3,[Rofler]Destroyeur,3425,0,1,0,1,100.0%,19m
8512,3,Citrael,3425,0,1,0,1,100.0%,11m
8521,3,Woozie,3424,783,278,286,564,49.3%,4m
8521,2,Deniska,3424,947,169,166,335,50.4%,9m
8521,2,OMA,3424,617,166,161,327,50.8%,27m
8521,2,LazyPotato,3424,1454,152,154,306,49.7%,15m
8521,3,Albania,3424,835,102,89,191,53.4%,7m
8521,3,[Cannоn]Granate,3424,1164,65,25,90,72.2%,5m
8521,3,Kera,3424,988,61,38,99,61.6%,20m
8521,3,sacri,3424,1288,57,47,104,54.8%,10m
8521,3,Thx,3424,544,21,17,38,55.3%,26m
8521,3,[HEHEH]WsTdBeule,3424,554,21,18,39,53.8%,17m
8521,3,Comandante,3424,164,8,2,10,80.0%,6m
8521,3,[DisES]pitivier,3424,204,7,13,20,35.0%,4m
8521,3,SnoW,3424,0,5,1,6,83.3%,16m
8521,3,twelvepool,3424,0,2,4,6,33.3%,15m
8521,3,Vardes,3424,0,1,0,1,100.0%,6m
8521,3,BerlinSports,3424,30,1,4,5,20.0%,26m
8521,1,[FcG]Elklan,3424,0,0,2,2,0.0%,7m
8521,3,Emperor,3424,0,0,3,3,0.0%,13m
8539,3,JoeBar,3423,1012,54,33,87,62.1%,16m
8539,2,Kein,3423,1027,49,39,88,55.7%,7m
8539,3,BeuzShoot,3423,865,39,21,60,65.0%,13m
8539,2,Teknyc,3423,730,27,31,58,46.6%,5m
8539,3,MindOf,3423,352,15,4,19,78.9%,7m
8539,3,Alexisonfire,3423,267,9,4,13,69.2%,17m
8539,3,KingRoss,3423,258,9,11,20,45.0%,19m
8539,3,МаминХулиган,3423,148,8,4,12,66.7%,19m
8539,3,Tetra,3423,242,8,10,18,44.4%,20m
8539,3,Chimi,3423,166,7,1,8,87.5%,18m
8539,3,[DZTK]Keys,3423,58,2,1,3,66.7%,25m
8539,3,ChipS,3423,0,1,0,1,100.0%,20m
8539,1,[TLIGHT]Squidi,3423,0,0,1,1,0.0%,11m
8539,3,[SVIN]Forfelon,3423,0,0,2,2,0.0%,18m
8553,2,RedKing,3422,1586,266,269,535,49.7%,27m
8553,2,ТраКТоРист,3422,915,132,126,258,51.2%,13m
8553,2,[Zeggg]Mojo,3422,408,110,100,210,52.4%,10m
8553,2,WooD,3422,1541,102,112,214,47.7%,8m
8553,3,Inthoxx,3422,906,35,30,65,53.8%,26m
8553,3,[PiGPan]FissKael,3422,467,22,23,45,48.9%,12m
8553,3,PlaySafe,3422,166,8,12,20,40.0%,19m
8553,3,[APCRPH]WillBe,3422,194,7,5,12,58.3%,4m
8553,3,[SC2ERZ]McMuff,3422,0,0,1,1,0.0%,18m
8562,3,[ExTr1m]tezeld,3421,1619,437,389,826,52.9%,10m
8562,2,shaivl,3421,1590,215,200,415,51.8%,27m
8562,3,Skiwasser,3421,1579,206,183,389,53.0%,17m
8562,3,[HZeS]Wolffy,3421,1623,205,167,372,55.1%,27m
8562,3,BeastyFlw,3421,1439,96,86,182,52.7%,12m
8562,3,IIIIIII,3421,408,26,30,56,46.4%,12m
8562,3,[EZPTS]ВованТерран,3421,268,12,12,24,50.0%,26m
8562,3,Quirl,3421,282,12,14,26,46.2%,4m
8562,3,[GRNSKN]Idunno,3421,178,6,8,14,42.9%,17m
8562,3,DVRemuver,3421,85,4,4,8,50.0%,6m
8562,3,AgentSmith,3421,116,4,7,11,36.4%,13m
8562,3,Monochrome,3421,0,3,3,6,50.0%,15m
8562,3,[ReKit]BusterNut,3421,0,0,1,1,0.0%,17m
8575,3,[Catena]MaltaSoron,3420,1498,125,115,240,52.1%,7m
8575,3,Ramiro,3420,791,33,31,64,51.6%,26m
8575,2,[TrolBZ]FreeSpirit,3420,614,18,32,50,36.0%,9m
8575,3,[IndyK]CaesarTymon,3420,284,10,10,20,50.0%,26m
8575,3,Darking,3420,165,8,3,11,72.7%,7m
8575,3,GeitStar,3420,142,4,2,6,66.7%,10m
8575,3,Lewwawurscht,3420,6,2,0,2,100.0%,14m
8575,2,[PlAr]Shadowmeld,3420,44,2,3,5,40.0%,19m
8575,3,bEsenbinder,3420,0,0,1,1,0.0%,6m
8575,1,Harvester,3420,0,0,2,2,0.0%,26m
8585,3,AldarsKose,3419,1378,89,68,157,56.7%,19m
8585,3,Tamme,3419,1321,84,82,166,50.6%,26m
8585,2,Shrader,3419,213,8,7,15,53.3%,25m
8585,3,[НТТ]Machpella,3419,140,6,1,7,85.7%,13m
8585,3,[TheDOH]Sledgar,3419,166,6,2,8,75.0%,18m
8585,3,LotusBlüte,3419,142,5,5,10,50.0%,7m
8585,3,SeriousSam,3419,124,5,7,12,41.7%,19m
8585,3,[neuroW]NEAC,3419,30,4,2,6,66.7%,4m
8585,3,TheFerret,3419,88,3,2,5,60.0%,4m
8585,2,MMRGift,3419,131,2,3,5,40.0%,10m
8585,3,MaJoRPoiLu,3419,0,1,1,2,50.0%,7m
8596,2,Khoi,3418,1076,165,159,324,50.9%,10m
8596,3,[696]Tragah,3418,577,153,136,289,52.9%,27m
8596,3,xDey,3418,632,23,20,43,53.5%,14m
8596,3,Calashnico,3418,506,19,10,29,65.5%,15m
8596,3,Sperma,3418,321,14,8,22,63.6%,6m
8596,3,Callidus,3418,0,1,0,1,100.0%,18m
8596,3,Paco,3418,30,1,1,2,50.0%,14m
8596,3,TeamTeemo,3418,0,1,3,4,25.0%,25m
8596,3,KYL,3418,0,0,2,2,0.0%,11m
8596,3,iSayGGdude,3418,0,0,3,3,0.0%,17m
8606,3,Farpure,3417,1589,148,148,296,50.0%,9m
8606,2,KnsT,3417,1551,96,103,199,48.2%,7m
8606,3,Chirockat,3417,1246,46,44,90,51.1%,18m
8606,3,Hamsterling,3417,261,12,14,26,46.2%,8m
8606,3,sone,3417,140,6,1,7,85.7%,15m
8606,3,dageth,3417,0,5,1,6,83.3%,19m
8606,3,ALF,3417,0,5,1,6,83.3%,12m
8606,2,Awin,3417,0,1,0,1,100.0%,10m
8606,3,[CUB]Zeratyl,3417,30,1,1,2,50.0%,6m
8606,3,PhAnTøm,3417,0,1,4,5,20.0%,5m
8606,3,Specton,3417,0,0,1,1,0.0%,16m
8606,1,PoWer,3417,0,0,1,1,0.0%,18m
8606,3,ASSAGGIAMELO,3417,0,0,3,3,0.0%,9m
8606,3,[GLGLG]Максимус,3417,0,0,5,5,0.0%,16m
8620,3,Solunis,3416,1596,237,201,438,54.1%,15m
8620,3,Ilyas,3416,256,50,43,93,53.8%,27m
8620,3,[QTcIub]jackie,3416,656,26,20,46,56.5%,27m
8620,3,[WuTC]Prolvl,3416,529,24,14,38,63.2%,9m
8620,3,[TAW]EntityParadx,3416,468,22,11,33,66.7%,8m
8620,3,CosmicKoR,3416,554,22,16,38,57.9%,7m
8620,3,Admin,3416,510,21,17,38,55.3%,18m
8620,3,Shield,3416,483,19,15,34,55.9%,4m
8620,3,[PrimeC]Shibby,3416,88,4,4,8,50.0%,12m
8620,3,[PPST]Zallar,3416,88,4,5,9,44.4%,15m
8620,3,llllllllllll,3416,86,3,3,6,50.0%,17m
8620,3,Sensiskunk,3416,30,2,0,2,100.0%,20m
8620,3,Factus,3416,0,1,0,1,100.0%,10m
8620,3,[ABRUTI]Max,3416,0,0,1,1,0.0%,26m
8634,2,Freki,3415,1613,319,310,629,50.7%,8m
8634,2,Côôky,3415,1468,187,194,381,49.1%,17m
8634,3,Davros,3415,994,155,157,312,49.7%,26m
8634,2,lomme,3415,796,35,32,67,52.2%,17m
8634,2,[SPI]Fbondo,3415,606,24,31,55,43.6%,28m
8634,3,Advantage,3415,470,19,19,38,50.0%,8m
8634,2,FAKEBOMBER,3415,259,10,13,23,43.5%,28m
8634,3,Spackstar,3415,186,9,9,18,50.0%,6m
8634,3,[Skolan]RktrBJUCCA,3415,242,9,11,20,45.0%,19m
8634,3,Raggeica,3415,173,8,3,11,72.7%,14m
8634,2,Crokou,3415,122,4,11,15,26.7%,12m
8634,3,Kryptonite,3415,86,3,3,6,50.0%,9m
8634,3,Ketone,3415,92,3,11,14,21.4%,15m
8634,3,Rantanplan,3415,58,2,2,4,50.0%,8m
8634,3,[ÆR]Cerkof,3415,30,2,5,7,28.6%,16m
8634,3,LeatherFace,3415,30,2,5,7,28.6%,11m
8634,3,Jasmine,3415,30,1,1,2,50.0%,7m
8634,3,Naitch,3415,0,0,1,1,0.0%,12m
8652,3,idaniel,3414,966,97,89,186,52.2%,20m
8652,2,Cantrix,3414,942,35,43,78,44.9%,17m
8652,3,NoScared,3414,455,26,8,34,76.5%,18m
8652,1,GarlicSauce,3414,0,4,1,5,80.0%,1h
8652,3,[Xa]Nash,3414,0,1,1,2,50.0%,27m
8652,3,[eRZGEb]hasgehärt,3414,0,0,1,1,0.0%,13m
8658,2,Diesel,3413,1515,601,591,1192,50.4%,8m
8658,1,Charisma,3413,1529,499,508,1007,49.6%,13m
8658,3,ёпрст,3413,1152,177,164,341,51.9%,4m
8658,3,Fey,3413,1182,131,112,243,53.9%,4m
8658,3,Буратино,3413,1400,86,80,166,51.8%,17m
8658,3,[FxL]Razaac,3413,1130,42,45,87,48.3%,6m
8658,2,Eco,3413,1086,40,52,92,43.5%,9m
8658,3,suprBixlov,3413,610,23,25,48,47.9%,18m
8658,3,[w8tpvr]Полторашка,3413,658,23,28,51,45.1%,12m
8658,3,[LAMPA]ValertinG,3413,456,18,15,33,54.5%,9m
8658,3,Grimlot,3413,272,9,8,17,52.9%,26m
8658,3,зерг,3413,209,7,6,13,53.8%,10m
8658,3,RedArmy,3413,0,5,0,5,100.0%,16m
8658,3,[FancyD]Tutu,3413,142,5,8,13,38.5%,27m
8658,3,[NOBHED]TheDocToss,3413,98,4,10,14,28.6%,11m
8658,3,nullstring,3413,0,1,0,1,100.0%,13m
8658,3,[iMv]Tappsi,3413,0,1,1,2,50.0%,16m
8658,3,Zeus,3413,30,1,1,2,50.0%,27m
8658,1,CloudTemplar,3413,0,0,1,1,0.0%,18m
8658,3,CalmMKD,3413,0,0,3,3,0.0%,25m
8678,2,[Sacred]RAJ,3412,1585,369,375,744,49.6%,19m
8678,3,ftwo,3412,556,32,26,58,55.2%,20m
8678,3,CyrusII,3412,169,13,17,30,43.3%,11m
8678,3,JKnightmare,3412,260,9,4,13,69.2%,8m
8678,3,Zhenksta,3412,182,7,9,16,43.8%,6m
8678,3,Kranas,3412,174,6,9,15,40.0%,20m
8678,2,JoyFuLRoaKel,3412,0,1,0,1,100.0%,6m
8678,3,IIIIIIIIIIII,3412,0,1,0,1,100.0%,9m
8678,3,[FrC]Mackiavel,3412,0,0,1,1,0.0%,12m
8678,2,[LDAD]Kugelburger,3412,0,0,1,1,0.0%,25m
8688,3,LRC,3411,1580,186,179,365,51.0%,9m
8688,3,CAR,3411,566,69,68,137,50.4%,28m
8688,3,ChibaCityblu,3411,1590,65,72,137,47.4%,19m
8688,3,Gniewosz,3411,630,24,17,41,58.5%,13m
8688,2,Mobius,3411,652,22,27,49,44.9%,12m
8688,3,[XNTC]net,3411,195,8,4,12,66.7%,19m
8688,3,Milcheis,3411,148,6,11,17,35.3%,11m
8688,3,Nordres,3411,58,3,3,6,50.0%,4m
8688,2,ZaraBiceps,3411,121,3,8,11,27.3%,4m
8688,3,[LSMS]ELcarniceiro,3411,0,0,1,1,0.0%,4m
8688,3,KleiNnoXe,3411,0,0,2,2,0.0%,16m
8699,2,Pernatiy,3410,1278,166,179,345,48.1%,8m
8699,2,[Colony]Tajon,3410,1502,107,101,208,51.4%,5m
8699,3,LoveSilense,3410,1623,70,65,135,51.9%,7m
8699,3,[NoCal]RaID,3410,328,35,39,74,47.3%,15m
8699,3,[Br4ümu]Arkanny,3410,567,26,15,41,63.4%,10m
8699,3,Honningtyven,3410,235,14,8,22,63.6%,12m
8699,3,MBR,3410,245,9,8,17,52.9%,4m
8699,3,[DМG]TTeHc,3410,192,7,4,11,63.6%,16m
8699,3,John,3410,219,7,4,11,63.6%,18m
8699,3,Feral,3410,140,6,2,8,75.0%,4m
8699,3,[IG20]Sentiar,3410,150,5,11,16,31.2%,10m
8699,3,Lasz,3410,0,4,2,6,66.7%,18m
8699,3,IMwatchingU,3410,14,4,12,16,25.0%,25m
8699,3,Khing,3410,58,3,1,4,75.0%,18m
8699,3,[UATeam]TonnyArno,3410,30,1,1,2,50.0%,25m
8699,3,Bofdunix,3410,0,0,1,1,0.0%,27m
8699,3,IShowUBasics,3410,0,0,1,1,0.0%,4m
8699,3,kalt,3410,0,0,1,1,0.0%,7m
8699,3,GrafDest,3410,0,0,2,2,0.0%,26m
8699,3,MindBender,3410,0,0,4,4,0.0%,25m
8719,3,Nitrogen,3409,1207,140,133,273,51.3%,25m
8719,2,Kifosix,3409,1240,104,111,215,48.4%,17m
8719,3,[TAW]Blood,3409,934,44,46,90,48.9%,6m
8719,3,Camapö,3409,312,13,13,26,50.0%,12m
8719,3,leshiy,3409,342,12,14,26,46.2%,19m
8719,3,Universe,3409,175,8,4,12,66.7%,14m
8719,3,Syalo,3409,212,7,10,17,41.2%,19m
8719,3,Víðarr,3409,90,4,2,6,66.7%,20m
8719,3,NaSkille,3409,58,3,0,3,100.0%,27m
8719,3,ТёмТёмыч,3409,0,1,0,1,100.0%,18m
8719,1,TJbehemoth,3409,0,1,0,1,100.0%,11m
8719,3,NanoTr,3409,0,0,1,1,0.0%,13m
8719,3,Eternal,3409,0,0,1,1,0.0%,9m
8719,1,Zprit,3409,0,0,2,2,0.0%,54m
8733,2,Diversity,3408,1320,216,207,423,51.1%,9m
8733,2,Barlan,3408,814,213,214,427,49.9%,28m
8733,2,[slаyеr]konas,3408,880,127,107,234,54.3%,20m
8733,3,Emyox,3408,1302,54,41,95,56.8%,19m
8733,3,[W4N]PsyStormS,3408,898,46,33,79,58.2%,26m
8733,3,[UoM]Harg,3408,920,34,35,69,49.3%,19m
8733,3,privetpivz,3408,745,32,15,47,68.1%,20m
8733,3,[DEDAL]Glutek,3408,667,28,21,49,57.1%,16m
8733,3,Epictetus,3408,549,28,28,56,50.0%,10m
8733,3,[HZeS]FARI,3408,302,11,7,18,61.1%,27m
8733,2,Nord,3408,95,4,2,6,66.7%,10m
8733,3,[Камрад]Muchacho,3408,118,4,9,13,30.8%,15m
8733,3,[ZelO]Ducky,3408,60,2,3,5,40.0%,6m
8733,3,[SLD]mogoh,3408,0,1,0,1,100.0%,10m
8733,2,WarrioR,3408,0,1,0,1,100.0%,11m
8733,3,Gatsaras,3408,0,0,1,1,0.0%,16m
8733,3,spirit,3408,0,0,1,1,0.0%,14m
8750,3,monsterhunt,3407,970,125,99,224,55.8%,20m
8750,2,[SWeedG]Destiny,3407,788,61,72,133,45.9%,19m
8750,3,lllllllllll,3407,668,26,20,46,56.5%,10m
8750,3,[PSIGH]Slyrand,3407,580,21,22,43,48.8%,11m
8750,3,Frost,3407,376,14,16,30,46.7%,7m
8750,3,BlocTortue,3407,192,7,8,15,46.7%,28m
8750,1,OneBasePony,3407,119,6,1,7,85.7%,56m
8750,3,[Ok]Gnesh,3407,0,1,0,1,100.0%,4m
8750,3,Amarant,3407,0,1,0,1,100.0%,4m
8750,3,[SKPAG]Segfault,3407,30,1,1,2,50.0%,10m
8750,3,Bleuelephant,3407,0,0,1,1,0.0%,6m
8761,3,aligedi,3406,765,36,27,63,57.1%,28m
8761,3,RomperStompr,3406,741,34,24,58,58.6%,18m
8761,2,Wiche,3406,702,25,38,63,39.7%,3m
8761,3,[TAW]TinGodzilla,3406,431,16,9,25,64.0%,5m
8761,3,LEBEN,3406,196,7,7,14,50.0%,15m
8761,2,[SEKN]SecondTry,3406,152,4,2,6,66.7%,28m
8761,3,xaxas,3406,90,3,4,7,42.9%,7m
8761,3,Motionless,3406,30,1,2,3,33.3%,9m
8761,3,bugster,3406,0,0,1,1,0.0%,8m
8761,1,[mazter]benjamin,3406,0,0,1,1,0.0%,19m
8771,3,Boo,3405,1594,373,342,715,52.2%,27m
8771,2,sergio,3405,1464,256,260,516,49.6%,20m
8771,3,Urgh,3405,1536,125,116,241,51.9%,25m
8771,3,BoneSButcheR,3405,1566,63,54,117,53.8%,27m
8771,3,[ЛĐT]Draf,3405,1070,40,37,77,51.9%,9m
8771,3,[TheDOH]wolfsha,3405,420,18,9,27,66.7%,16m
8771,3,bananasplit,3405,198,10,2,12,83.3%,25m
8771,3,[Xa]SoupLie,3405,274,10,8,18,55.6%,8m
8771,1,Erberack,3405,309,8,14,22,36.4%,9m
8771,3,Odin,3405,60,6,2,8,75.0%,28m
8771,3,Laraku,3405,0,5,0,5,100.0%,6m
8771,1,Akoc,3405,118,3,3,6,50.0%,7m
8771,3,[Coons]JanJan,3405,30,2,2,4,50.0%,28m
8771,3,[GgWall]Ramses,3405,58,2,2,4,50.0%,26m
8771,3,[ĦĦ]nullPointer,3405,30,1,2,3,33.3%,13m
8771,3,Styxen,3405,0,1,3,4,25.0%,26m
8771,3,ChrispyCross,3405,0,0,1,1,0.0%,5m
8771,3,wempy,3405,0,0,1,1,0.0%,17m
8771,3,Xyphoss,3405,0,0,3,3,0.0%,16m
8790,3,OldSchool,3404,1501,119,108,227,52.4%,20m
8790,3,RocketRacoon,3404,1367,102,92,194,52.6%,26m
8790,3,Aytaç,3404,957,63,60,123,51.2%,8m
8790,3,[GAMI]Caladrien,3404,1396,56,59,115,48.7%,25m
8790,3,DosSiDos,3404,947,43,37,80,53.8%,13m
8790,2,Max,3404,728,37,39,76,48.7%,8m
8790,3,TerranOP,3404,504,24,9,33,72.7%,11m
8790,3,[OC]Sienionelain,3404,559,24,15,39,61.5%,14m
8790,3,[TeamJ]Behemoth,3404,616,23,19,42,54.8%,6m
8790,3,IIIIIIIIIIII,3404,467,20,13,33,60.6%,20m
8790,3,Sothoth,3404,279,11,15,26,42.3%,13m
8790,1,[BoKs]Sven,3404,190,9,1,10,90.0%,12m
8790,3,Goshater,3404,252,9,11,20,45.0%,13m
8790,3,BadAsS,3404,0,1,1,2,50.0%,7m
8790,1,Asth,3404,0,1,1,2,50.0%,12m
8790,3,Kosta,3404,30,1,2,3,33.3%,7m
8790,3,Serenity,3404,30,1,3,4,25.0%,7m
8807,3,ImpuLse,3403,719,33,36,69,47.8%,20m
8807,3,WindSteel,3403,152,6,7,13,46.2%,7m
8807,3,Ullirush,3403,92,5,6,11,45.5%,10m
8807,3,[gagars]Khazol,3403,0,4,1,5,80.0%,20m
8807,3,Forber,3403,97,2,1,3,66.7%,5m
8807,3,Perserence,3403,30,2,3,5,40.0%,27m
8807,3,SAMSON,3403,0,1,0,1,100.0%,12m
8807,3,BloOoDyBapt,3403,97,1,1,2,50.0%,5m
8807,3,Forlordaeron,3403,0,0,1,1,0.0%,6m
8807,3,TranceFuZion,3403,0,0,2,2,0.0%,5m
8807,1,Fleya,3403,0,0,2,2,0.0%,1h
8818,2,[KB94]LaP,3402,487,233,242,475,49.1%,3m
8818,2,эросэнин,3402,1592,148,152,300,49.3%,25m
8818,3,Hardhead,3402,1605,77,66,143,53.8%,10m
8818,3,RamenKage,3402,1087,65,37,102,63.7%,13m
8818,1,Ubik,3402,1604,57,85,142,40.1%,14m
8818,3,Nikoxlas,3402,789,38,13,51,74.5%,12m
8818,3,PointyBoater,3402,570,32,23,55,58.2%,8m
8818,3,[Heroes]CobbleStone,3402,434,18,8,26,69.2%,4m
8818,2,TimeSplit,3402,272,17,15,32,53.1%,7m
8818,3,szymon,3402,162,11,5,16,68.8%,26m
8818,3,Faya,3402,296,11,11,22,50.0%,25m
8818,3,MacroOdyssey,3402,168,7,4,11,63.6%,6m
8818,3,DarkSmile,3402,134,7,7,14,50.0%,20m
8818,1,TTW,3402,97,5,1,6,83.3%,14m
8818,3,Quell,3402,92,3,5,8,37.5%,7m
8818,3,JohnyKusH,3402,94,3,8,11,27.3%,25m
8818,3,Svoychelovek,3402,92,3,8,11,27.3%,4m
8818,3,Dany,3402,0,1,0,1,100.0%,18m
8818,3,[4ROSAS]Epsilon,3402,0,1,0,1,100.0%,9m
8818,3,Isy,3402,0,0,5,5,0.0%,5m
8838,2,Napalman,3401,1582,134,145,279,48.0%,19m
8838,2,ShadowFury,3401,237,89,74,163,54.6%,8m
8838,3,LiptoN,3401,489,44,30,74,59.5%,16m
8838,3,[ĦĦ]galen,3401,1026,42,29,71,59.2%,20m
8838,3,[Mavis]rodeo,3401,442,40,21,61,65.6%,28m
8838,3,Flingorofil,3401,571,26,22,48,54.2%,8m
8838,3,MBK,3401,371,17,9,26,65.4%,15m
8838,1,FlaSh,3401,224,11,6,17,64.7%,19m
8838,3,XOXO,3401,66,10,10,20,50.0%,14m
8838,3,InSoLenT,3401,176,6,7,13,46.2%,10m
8838,3,Dopa,3401,0,4,1,5,80.0%,18m
8838,3,[OMAEWA]Ghost,3401,118,4,5,9,44.4%,15m
8838,3,[FxL]Hadoken,3401,114,4,7,11,36.4%,17m
8838,3,gabo,3401,30,2,0,2,100.0%,15m
8838,3,ACTPOHABT,3401,30,1,3,4,25.0%,8m
8838,3,Glightyear,3401,0,0,1,1,0.0%,15m
8838,1,[DeTime]Ketf,3401,0,0,1,1,0.0%,45m
8838,3,Palomnik,3401,0,0,1,1,0.0%,8m
8856,2,MegaStress,3400,1445,260,247,507,51.3%,9m
8856,2,Mishka,3400,1187,128,130,258,49.6%,8m
8856,3,[DaFF]IIIIIIIIIIII,3400,663,30,10,40,75.0%,16m
8856,3,Evo,3400,88,4,2,6,66.7%,4m
8856,3,carbon,3400,30,2,0,2,100.0%,19m
8856,3,Hardvision,3400,58,2,3,5,40.0%,27m
8862,2,Daste,3399,1423,234,230,464,50.4%,13m
8862,3,[1stGG]JacDraco,3399,1456,110,87,197,55.8%,6m
8862,2,ChosenOne,3399,823,76,81,157,48.4%,12m
8862,3,JonSmurf,3399,671,40,4,44,90.9%,13m
8862,3,[TheDOH]Grubson,3399,832,34,28,62,54.8%,25m
8862,3,OpTerran,3399,664,31,13,44,70.5%,11m
8862,2,IIIDFGIII,3399,758,26,27,53,49.1%,28m
8862,3,MrPingouin,3399,226,23,13,36,63.9%,4m
8862,3,[зерно]rrRamilka,3399,212,8,7,15,53.3%,25m
8862,3,llllllllllll,3399,158,5,10,15,33.3%,16m
8862,3,Django,3399,0,3,2,5,60.0%,19m
8862,3,[BigBC]DreadHavox,3399,30,2,0,2,100.0%,15m
8862,3,[CWL]Mahaaaadeen,3399,30,1,4,5,20.0%,7m
8862,3,[mwe]miresq,3399,0,0,3,3,0.0%,9m
8862,3,TheLastOfUs,3399,0,0,3,3,0.0%,7m
8877,3,Archimedes,3398,1592,463,460,923,50.2%,11m
8877,2,qeq,3398,709,98,104,202,48.5%,26m
8877,3,aRsony,3398,1028,47,27,74,63.5%,6m
8877,3,kokonat,3398,550,20,18,38,52.6%,4m
8877,2,Szudemer,3398,580,19,35,54,35.2%,8m
8877,2,Sinox,3398,271,14,10,24,58.3%,11m
8877,2,RAZdor,3398,452,14,22,36,38.9%,27m
8877,3,[WU]Error,3398,284,11,6,17,64.7%,9m
8877,3,Sssky,3398,238,8,14,22,36.4%,28m
8877,3,angrykitten,3398,133,7,3,10,70.0%,26m
8877,2,SuchSkill,3398,166,5,18,23,21.7%,29m
8877,3,kovqv,3398,88,4,7,11,36.4%,28m
8877,2,AKD,3398,115,3,2,5,60.0%,18m
8877,3,[SoLw]CetyfityMan,3398,30,2,3,5,40.0%,18m
8877,3,Vectron,3398,0,0,1,1,0.0%,7m
8877,3,gesgincy,3398,0,0,3,3,0.0%,12m
8893,3,Shaxidos,3397,343,79,73,152,52.0%,9m
8893,3,[hf4X4]ProfKahre,3397,1265,72,54,126,57.1%,20m
8893,3,Genezis,3397,1517,71,61,132,53.8%,4m
8893,2,Xese,3397,718,57,51,108,52.8%,12m
8893,2,bObmc,3397,1000,36,43,79,45.6%,27m
8893,3,jardaxiiiiik,3397,886,34,33,67,50.7%,26m
8893,3,stranger,3397,415,30,13,43,69.8%,16m
8893,3,Impulse,3397,327,14,7,21,66.7%,19m
8893,3,ShiSan,3397,114,8,3,11,72.7%,18m
8893,3,Оливия,3397,0,5,1,6,83.3%,5m
8893,3,Costuha,3397,58,3,1,4,75.0%,11m
8893,3,Tanabe,3397,88,3,5,8,37.5%,16m
8893,3,jinxme,3397,30,2,1,3,66.7%,8m
8893,3,Tennewenne,3397,58,2,5,7,28.6%,10m
8893,3,Piiras,3397,0,1,0,1,100.0%,20m
8893,3,Testiface,3397,0,0,3,3,0.0%,19m
8893,3,[BCON]FluffyLings,3397,0,0,4,4,0.0%,5m
8910,3,RoachyRoach,3396,1230,49,46,95,51.6%,27m
8910,3,[TheDOH]NemesisBoY,3396,1130,48,33,81,59.3%,17m
8910,3,WorldWide,3396,684,30,17,47,63.8%,12m
8910,3,Getofarmulos,3396,494,19,18,37,51.4%,6m
8910,3,лёха,3396,250,16,8,24,66.7%,5m
8910,2,zapromant,3396,288,11,3,14,78.6%,4m
8910,3,[ZINNBA]supermarine,3396,321,11,15,26,42.3%,7m
8910,3,[994]Bananashell,3396,185,6,3,9,66.7%,6m
8910,3,SKliveevil,3396,159,4,2,6,66.7%,18m
8910,3,AIphaStar,3396,30,3,2,5,60.0%,4m
8920,3,Opadelirium,3395,1590,157,156,313,50.2%,27m
8920,3,basta,3395,1547,145,143,288,50.3%,10m
8920,3,Hope,3395,632,22,30,52,42.3%,7m
8920,3,Nikas,3395,307,14,10,24,58.3%,11m
8920,3,SvenGablbart,3395,408,13,20,33,39.4%,16m
8920,3,[Frzen]Lanaya,3395,116,5,2,7,71.4%,25m
8920,1,Calle,3395,0,4,1,5,80.0%,18m
8920,3,Chaknaray,3395,0,1,0,1,100.0%,13m
8920,3,[lOoKer]Werewolf,3395,0,1,0,1,100.0%,19m
8920,3,ZguhZer,3395,0,0,1,1,0.0%,12m
8920,3,Kerigir,3395,0,0,4,4,0.0%,8m
8931,2,Blishniy,3394,854,600,581,1181,50.8%,5m
8931,2,Bigbisoux,3394,1579,323,314,637,50.7%,13m
8931,3,Shadowblate,3394,1352,56,47,103,54.4%,8m
8931,3,aykoc,3394,390,15,11,26,57.7%,26m
8931,3,nommnommnomm,3394,270,11,7,18,61.1%,5m
8931,3,Sandman,3394,173,9,7,16,56.2%,6m
8931,3,Tobbigatobba,3394,144,5,5,10,50.0%,28m
8931,3,Jackie,3394,88,4,1,5,80.0%,6m
8931,3,[olive]KiRiA,3394,94,4,7,11,36.4%,14m
8931,3,[GGMS]Grdj,3394,0,1,0,1,100.0%,16m
8931,3,Morgul,3394,0,1,0,1,100.0%,27m
8931,3,[PANPR]Kohlrabi,3394,0,0,1,1,0.0%,11m
8943,2,IlIlIIIlIlIl,3393,1523,266,261,527,50.5%,8m
8943,3,[aW]Sins,3393,1441,105,87,192,54.7%,4m
8943,3,[Noyce]ecruos,3393,630,25,22,47,53.2%,8m
8943,3,[MRCW]himsir,3393,144,6,11,17,35.3%,15m
8943,3,Evlogos,3393,86,4,4,8,50.0%,7m
8943,1,[BRSKR]PseudoMorgan,3393,140,3,2,5,60.0%,14m
8943,3,[dGu]teel,3393,90,3,4,7,42.9%,20m
8943,3,[WCKYLN]BOSSHOORE,3393,30,1,1,2,50.0%,7m
8943,3,[BadMen]SupremeBeing,3393,30,1,4,5,20.0%,14m
8943,3,[KRX]Earlybird,3393,0,0,1,1,0.0%,12m
8943,3,[DoooMz]Mcmini,3393,0,0,2,2,0.0%,17m
8954,2,Odabasz,3392,1595,502,500,1002,50.1%,27m
8954,3,Mazary,3392,621,34,30,64,53.1%,15m
8954,3,inte,3392,702,32,26,58,55.2%,20m
8954,3,millionar,3392,507,22,13,35,62.9%,27m
8954,3,[K0mpis]Mojster,3392,448,17,13,30,56.7%,5m
8954,3,Manabu,3392,316,12,11,23,52.2%,7m
8954,3,kastet,3392,170,10,5,15,66.7%,10m
8954,3,TerranTears,3392,60,3,4,7,42.9%,12m
8954,3,[TUPU]Melysoph,3392,86,3,5,8,37.5%,15m
8954,3,[6Gears]Antoma,3392,94,3,9,12,25.0%,13m
8954,3,[LeDude]Duckling,3392,30,2,0,2,100.0%,4m
8954,1,biggusdickus,3392,0,1,0,1,100.0%,49m
8954,3,HunterX,3392,0,0,1,1,0.0%,17m
8954,3,Milhouse,3392,0,0,1,1,0.0%,15m
8968,2,kramola,3391,634,186,193,379,49.1%,28m
8968,3,Phil,3391,1096,45,43,88,51.1%,18m
8968,3,Burgeratora,3391,995,40,27,67,59.7%,27m
8968,3,PROTOSRETARD,3391,449,32,5,37,86.5%,16m
8968,3,casualxx,3391,844,32,34,66,48.5%,28m
8968,3,ZedKiller,3391,430,15,22,37,40.5%,27m
8968,3,[IYFM]HAtscH,3391,58,6,2,8,75.0%,6m
8968,3,Rayburst,3391,184,6,10,16,37.5%,9m
8968,3,Oddbod,3391,0,5,1,6,83.3%,15m
8968,3,noots,3391,147,5,3,8,62.5%,13m
8968,3,Dowel,3391,142,5,5,10,50.0%,20m
8968,3,[Troude]Gonophylis,3391,88,4,5,9,44.4%,12m
8968,3,TheRatMage,3391,0,2,3,5,40.0%,16m
8968,3,Scapin,3391,62,2,4,6,33.3%,5m
8968,3,Matter,3391,60,2,7,9,22.2%,12m
8968,3,Dentosal,3391,0,1,0,1,100.0%,17m
8968,3,Dlfjs,3391,0,1,0,1,100.0%,7m
8968,3,iCakeYou,3391,0,1,2,3,33.3%,28m
8968,3,Lyconight,3391,0,0,2,2,0.0%,6m
8968,3,mouse,3391,0,0,3,3,0.0%,5m
8968,1,akmal,3391,73,0,17,17,0.0%,11m
8989,3,Splinter,3390,1406,107,99,206,51.9%,15m
8989,3,[Z3R9]Näx,3390,912,72,75,147,49.0%,9m
8989,3,Onalim,3390,1208,53,40,93,57.0%,4m
8989,3,[Sabat]Рубёха,3390,1127,49,48,97,50.5%,8m
8989,3,RusWillis,3390,857,33,27,60,55.0%,14m
8989,3,[profit]Addictive,3390,349,14,7,21,66.7%,14m
8989,3,HiHello,3390,86,7,2,9,77.8%,16m
8989,3,GuterFreund,3390,140,6,2,8,75.0%,16m
8989,3,BarrackObama,3390,58,6,2,8,75.0%,20m
8989,3,[ÐoÐ]Wynton,3390,30,5,1,6,83.3%,19m
8989,3,arnaud,3390,60,3,8,11,27.3%,13m
8989,3,[InBri]gotime,3390,60,3,8,11,27.3%,6m
8989,3,Challenger,3390,30,2,4,6,33.3%,15m
8989,3,Molu,3390,64,2,8,10,20.0%,13m
8989,3,upinsmoke,3390,0,1,1,2,50.0%,4m
8989,3,ITSECURE,3390,0,0,4,4,0.0%,6m
9005,3,MarWin,3389,1480,130,123,253,51.4%,10m
9005,3,Destructo,3389,1439,116,94,210,55.2%,10m
9005,2,VIPTankz,3389,1128,105,119,224,46.9%,7m
9005,2,[PŖïMĄŁ]JSanGo,3389,1542,53,71,124,42.7%,18m
9005,3,QLF,3389,1016,42,34,76,55.3%,16m
9005,3,LozzaA,3389,286,10,7,17,58.8%,6m
9005,3,[Youth]Hyperstorm,3389,146,6,6,12,50.0%,28m
9005,3,RedVelvetCke,3389,30,1,1,2,50.0%,25m
9005,3,[SBluez]Human,3389,0,0,1,1,0.0%,28m
9005,3,chris,3389,0,0,1,1,0.0%,16m
9005,3,tachankin,3389,0,0,1,1,0.0%,12m
9016,2,TredVolt,3388,1628,178,188,366,48.6%,4m
9016,3,[ZERGML]Svist,3388,1480,138,127,265,52.1%,28m
9016,3,Windblown,3388,1598,137,121,258,53.1%,20m
9016,3,[GosuB]Yavoul,3388,1608,66,63,129,51.2%,5m
9016,3,Jasb,3388,750,33,24,57,57.9%,18m
9016,3,Aclick,3388,334,14,10,24,58.3%,27m
9016,3,[giBik]BScythe,3388,238,8,11,19,42.1%,26m
9016,2,NotSoGood,3388,228,7,11,18,38.9%,9m
9016,3,Grimous,3388,182,6,4,10,60.0%,16m
9016,3,HerraJeebos,3388,198,6,4,10,60.0%,27m
9016,3,[LAKAKA]Lakakouille,3388,90,4,4,8,50.0%,13m
9016,1,Tanguychoux,3388,115,3,1,4,75.0%,9m
9016,1,DOMINATOr,3388,48,3,4,7,42.9%,16m
9016,3,split,3388,90,3,6,9,33.3%,4m
9016,3,[Wild99]sCirem,3388,30,2,3,5,40.0%,4m
9016,3,[Br04ce]BroMetheus,3388,62,2,6,8,25.0%,28m
9016,3,Slash,3388,30,1,2,3,33.3%,28m
9016,3,[GeWapo]Darklight,3388,0,0,1,1,0.0%,7m
9034,3,[ƬC]WraithCraft,3387,1497,154,158,312,49.4%,10m
9034,2,JackelToad,3387,1465,139,139,278,50.0%,10m
9034,3,[Y187]Flobi,3387,1101,51,40,91,56.0%,18m
9034,3,Rambrat,3387,373,29,25,54,53.7%,20m
9034,3,[PlantZ]SqTdRAZoR,3387,132,5,5,10,50.0%,11m
9034,3,Mazzader,3387,58,2,6,8,25.0%,6m
9034,3,[TOWEA]TobyfleX,3387,0,1,0,1,100.0%,27m
9034,3,MrTeteDePorc,3387,30,1,2,3,33.3%,27m
9034,3,Wandera,3387,0,0,1,1,0.0%,12m
9034,3,BruhMoment,3387,0,0,4,4,0.0%,15m
9044,3,[ESS]Eekez,3386,1215,113,109,222,50.9%,13m
9044,3,KING,3386,1177,76,42,118,64.4%,13m
9044,3,[RVT]Bolto,3386,741,34,23,57,59.6%,5m
9044,3,MDHouse,3386,246,17,9,26,65.4%,20m
9044,3,Micton,3386,374,14,18,32,43.8%,26m
9044,3,[Spec0p]Siggy,3386,362,13,18,31,41.9%,5m
9044,3,sophy,3386,251,9,3,12,75.0%,27m
9044,3,BORDERLINE,3386,142,9,5,14,64.3%,16m
9044,3,[FIXi]Мася,3386,192,8,5,13,61.5%,26m
9044,3,Rei,3386,58,7,0,7,100.0%,16m
9044,3,Ellron,3386,146,5,7,12,41.7%,9m
9044,3,MacroMachine,3386,104,3,10,13,23.1%,11m
9044,3,Augustus,3386,30,2,1,3,66.7%,26m
9044,3,[BjFC]tReforDEr,3386,0,0,1,1,0.0%,28m
9044,3,Cocaines,3386,0,0,1,1,0.0%,9m
9044,3,GodLiKe,3386,0,0,1,1,0.0%,4m
9060,3,Koagwa,3385,1665,166,150,316,52.5%,18m
9060,3,Den,3385,509,56,49,105,53.3%,10m
9060,3,lemedia,3385,620,24,23,47,51.1%,10m
9060,3,[MWAF]Ocrucius,3385,178,7,6,13,53.8%,10m
9060,3,soniczZ,3385,214,7,13,20,35.0%,17m
9060,3,[DTBMII]Kyu,3385,118,5,4,9,55.6%,12m
9060,3,Enegue,3385,86,4,0,4,100.0%,16m
9060,3,Archer,3385,0,1,0,1,100.0%,18m
9060,3,AliasHunter,3385,0,1,0,1,100.0%,27m
9060,2,MrCrab,3385,0,1,0,1,100.0%,18m
9060,1,[SRC]MooDuck,3385,0,0,1,1,0.0%,8m
9071,2,Goju,3384,1509,400,394,794,50.4%,11m
9071,3,IIIIIIIIIIII,3384,1313,317,315,632,50.2%,15m
9071,3,[CivW]HouseVibeZ,3384,1473,166,162,328,50.6%,19m
9071,3,Pixels,3384,727,73,64,137,53.3%,16m
9071,3,Doppelganger,3384,1188,62,66,128,48.4%,4m
9071,2,[GGMS]BlackAdder,3384,1037,58,65,123,47.2%,19m
9071,2,DICCBOY,3384,481,35,45,80,43.8%,7m
9071,3,BondageChair,3384,446,18,7,25,72.0%,7m
9071,3,Desatr,3384,164,10,8,18,55.6%,10m
9071,3,Sleep,3384,191,8,3,11,72.7%,11m
9071,3,SpicyCorn,3384,204,7,7,14,50.0%,15m
9071,3,WarlordSage,3384,174,7,11,18,38.9%,15m
9071,1,[cun7]GreatWhiteSi,3384,0,4,1,5,80.0%,1h
9071,1,RustyRR,3384,0,0,1,1,0.0%,5m
9071,3,JACQUESELAIR,3384,0,0,2,2,0.0%,20m
9086,3,Ezechiel,3383,701,190,189,379,50.1%,16m
9086,3,VargVikernes,3383,1491,115,71,186,61.8%,26m
9086,3,Onjuno,3383,827,83,65,148,56.1%,26m
9086,3,[PLA2N]KOT,3383,584,23,18,41,56.1%,16m
9086,3,[BiB]still,3383,180,7,8,15,46.7%,27m
9086,1,MikeAntre,3383,140,4,2,6,66.7%,6m
9086,3,[сSсǃ]ToxicTerran,3383,86,4,2,6,66.7%,26m
9086,3,Daxter,3383,30,2,0,2,100.0%,18m
9086,1,zmeNcHic,3383,46,1,6,7,14.3%,14m
9095,3,spunch,3382,1318,136,106,242,56.2%,26m
9095,3,Cobra,3382,1506,79,84,163,48.5%,18m
9095,3,leSt,3382,474,17,17,34,50.0%,28m
9095,3,[nK]Anubis,3382,397,16,8,24,66.7%,27m
9095,3,[Regret]Arachnid,3382,218,9,6,15,60.0%,11m
9095,3,[DandA]Monami,3382,140,6,1,7,85.7%,8m
9095,3,rendi,3382,157,4,2,6,66.7%,12m
9095,3,Anakinn,3382,60,3,3,6,50.0%,16m
9095,3,[NGDY]SMaRTFeeD,3382,0,1,0,1,100.0%,15m
9095,3,[lOoOl]josito,3382,0,0,1,1,0.0%,10m
9105,2,nicesticky,3381,1568,515,510,1025,50.2%,20m
9105,2,Dead,3381,1495,127,138,265,47.9%,4m
9105,3,Bronzeplayer,3381,585,95,81,176,54.0%,9m
9105,3,Lappen,3381,1446,85,86,171,49.7%,7m
9105,3,john,3381,1337,83,86,169,49.1%,19m
9105,3,[CMBO]ovD,3381,877,53,42,95,55.8%,19m
9105,3,Alzapúa,3381,1180,48,40,88,54.5%,16m
9105,3,djecko,3381,717,28,23,51,54.9%,27m
9105,3,ArmaG,3381,537,24,17,41,58.5%,27m
9105,3,sushi,3381,264,19,13,32,59.4%,5m
9105,2,ManLove,3381,380,13,20,33,39.4%,25m
9105,3,[ЗЕRGТV]Sabitik,3381,248,9,9,18,50.0%,5m
9105,3,GLHF,3381,86,6,5,11,54.5%,25m
9105,1,Shadow,3381,0,5,0,5,100.0%,54m
9105,3,[Салоед]OMOHinc,3381,140,5,5,10,50.0%,14m
9105,3,svyat,3381,74,5,7,12,41.7%,5m
9105,2,[Yi]mescon,3381,154,5,16,21,23.8%,8m
9105,3,[3AS]Solidus,3381,90,4,3,7,57.1%,25m
9105,3,[Bregan]Barborid,3381,60,2,3,5,40.0%,13m
9105,3,towlsend,3381,0,1,0,1,100.0%,19m
9105,3,Skwisgaar,3381,30,1,3,4,25.0%,18m
9105,3,PAXI,3381,0,0,2,2,0.0%,13m
9105,1,TeRaLiSK,3381,0,0,4,4,0.0%,43m
9128,2,NOOBEATER,3380,1611,187,183,370,50.5%,12m
9128,3,Mattagon,3380,1561,145,127,272,53.3%,25m
9128,3,Badlock,3380,1532,135,97,232,58.2%,17m
9128,3,dearg,3380,1558,62,57,119,52.1%,16m
9128,3,[BoAnt]Kaya,3380,1377,59,44,103,57.3%,7m
9128,3,[cArB0t]FlorinKratos,3380,770,37,34,71,52.1%,26m
9128,3,[Kobras]jadecabbage,3380,983,37,36,73,50.7%,11m
9128,3,Michalaa,3380,303,13,7,20,65.0%,15m
9128,3,[GanYa]GONIX,3380,268,10,13,23,43.5%,15m
9128,3,Icu,3380,226,9,15,24,37.5%,8m
9128,3,karen,3380,30,4,2,6,66.7%,4m
9128,3,Zell,3380,93,2,0,2,100.0%,19m
9128,3,zoid,3380,118,2,1,3,66.7%,18m
9128,3,[UPX]antaigle,3380,62,2,8,10,20.0%,26m
9128,3,[Fargue]Depredador,3380,0,0,1,1,0.0%,18m
9128,3,Nitram,3380,0,0,1,1,0.0%,15m
9144,2,Newpaw,3379,1370,77,76,153,50.3%,28m
9144,2,[FrRacl]ChrisLord,3379,1024,65,75,140,46.4%,16m
9144,3,pomarancz,3379,1243,62,62,124,50.0%,12m
9144,3,[TaOr]Hex,3379,398,15,14,29,51.7%,20m
9144,3,MrWednesday,3379,110,12,8,20,60.0%,20m
9144,3,HolyInfant,3379,161,5,4,9,55.6%,18m
9144,2,[1NFEC7]Ashley,3379,136,4,3,7,57.1%,15m
9144,3,[Castpl]michus,3379,58,3,1,4,75.0%,27m
9144,3,Beau,3379,0,3,3,6,50.0%,5m
9144,3,hdshovcase,3379,86,3,4,7,42.9%,16m
9144,3,[KT]Elwòód,3379,62,2,9,11,18.2%,7m
9144,1,[IBeAŚI]Soon,3379,0,1,0,1,100.0%,45m
9144,3,Faolin,3379,0,0,1,1,0.0%,5m
9144,3,[Lookat]DatTrap,3379,0,0,1,1,0.0%,11m
9144,3,Alatier,3379,0,0,1,1,0.0%,26m
9144,3,OvercastqT,3379,0,0,2,2,0.0%,20m
9160,3,[MicroK]Sommarkatten,3378,1518,292,270,562,52.0%,11m
9160,3,Nibku,3378,861,36,40,76,47.4%,26m
9160,3,superuser,3378,814,34,30,64,53.1%,16m
9160,3,[MiMs]Gonzo,3378,479,20,4,24,83.3%,17m
9160,1,STRIDE,3378,271,12,7,19,63.2%,18m
9160,1,[DeVu]IMoGsPrime,3378,205,4,4,8,50.0%,14m
9160,3,Daemon,3378,80,4,4,8,50.0%,8m
9160,3,[BTT]Reminisce,3378,0,1,1,2,50.0%,18m
9160,3,kirtet,3378,0,1,1,2,50.0%,25m
9160,3,Fëanor,3378,0,1,3,4,25.0%,4m
9170,2,[W4R]Deadshadow,3377,1610,477,480,957,49.8%,8m
9170,3,[Аоуэйя]YouplaBouM,3377,1609,113,113,226,50.0%,4m
9170,3,Vio,3377,1585,102,88,190,53.7%,10m
9170,2,Drake,3377,1288,78,76,154,50.6%,28m
9170,3,NeYuGeN,3377,1545,61,57,118,51.7%,28m
9170,3,Paprischka,3377,374,37,43,80,46.2%,8m
9170,3,MrDracula,3377,700,28,25,53,52.8%,17m
9170,3,[MAKinG]DreamCatcher,3377,355,14,12,26,53.8%,15m
9170,3,pineapple,3377,372,13,19,32,40.6%,26m
9170,1,[CIGANY]Blackwood,3377,145,5,2,7,71.4%,4m
9170,3,[DMRU]Dmka,3377,114,4,1,5,80.0%,4m
9170,3,Edwin,3377,86,4,2,6,66.7%,9m
9170,3,[DmD]CARBON,3377,58,3,2,5,60.0%,16m
9170,3,[LVF6]PiPo,3377,0,3,2,5,60.0%,6m
9170,3,Pete,3377,90,3,5,8,37.5%,9m
9170,3,[SkCzM]EvilMarine,3377,94,3,10,13,23.1%,6m
9170,3,MonoKuma,3377,30,2,4,6,33.3%,7m
9170,3,DaRliNgZeRG,3377,0,1,4,5,20.0%,6m
9188,3,[ATAB]manystyles,3376,1242,202,142,344,58.7%,27m
9188,2,[LBK]Naepstar,3376,1555,158,161,319,49.5%,8m
9188,2,Fonshake,3376,397,78,73,151,51.7%,19m
9188,3,[TITIEZ]Lunatic,3376,856,35,23,58,60.3%,4m
9188,2,Heisenberg,3376,756,25,36,61,41.0%,20m
9188,3,[TheER]UxorialRook,3376,60,3,5,8,37.5%,20m
9188,3,SaberJenner,3376,30,2,0,2,100.0%,19m
9188,3,[WCKYLN]Abrissbirne,3376,30,2,1,3,66.7%,28m
9196,2,Kimshi,3375,1561,369,354,723,51.0%,7m
9196,3,[K0mpis]Storchen,3375,1645,190,187,377,50.4%,26m
9196,2,Devil,3375,1382,128,129,257,49.8%,17m
9196,3,StepsAhead,3375,906,96,89,185,51.9%,19m
9196,3,LarsSloth,3375,1242,76,72,148,51.4%,19m
9196,3,[ISWAGl]Pharo,3375,753,70,60,130,53.8%,15m
9196,3,wanted,3375,1084,45,38,83,54.2%,11m
9196,3,Walva,3375,844,38,33,71,53.5%,10m
9196,3,Dakyna,3375,398,33,27,60,55.0%,26m
9196,3,TEX,3375,782,28,29,57,49.1%,5m
9196,3,shilo,3375,646,23,25,48,47.9%,13m
9196,2,Blue,3375,293,12,5,17,70.6%,15m
9196,3,Neon,3375,346,12,16,28,42.9%,6m
9196,2,PuddingTime,3375,230,9,2,11,81.8%,19m
9196,3,llllllllllll,3375,242,9,3,12,75.0%,4m
9196,3,ROOM,3375,121,5,3,8,62.5%,19m
9196,3,HateNaLadder,3375,178,4,3,7,57.1%,20m
9196,3,Xanax,3375,0,3,2,5,60.0%,18m
9196,3,Inception,3375,121,3,2,5,60.0%,16m
9196,3,[GFLG]Vavar,3375,0,1,0,1,100.0%,12m
9196,2,Exactlyfail,3375,0,1,0,1,100.0%,7m
9196,3,Rivai,3375,0,1,1,2,50.0%,17m
9218,3,Coffee,3374,1554,190,192,382,49.7%,7m
9218,3,Next,3374,1275,52,50,102,51.0%,12m
9218,3,doSdoSunO,3374,1024,40,36,76,52.6%,18m
9218,3,Bush,3374,354,15,8,23,65.2%,19m
9218,3,UnceL,3374,219,10,4,14,71.4%,6m
9218,3,[1830]Mainzerg,3374,286,10,7,17,58.8%,5m
9218,3,Spark,3374,147,8,9,17,47.1%,19m
9218,1,ROODYPOO,3374,193,7,1,8,87.5%,7m
9218,3,SecondTry,3374,200,7,4,11,63.6%,8m
9218,3,iLLum,3374,196,6,4,10,60.0%,13m
9218,3,ComebackKid,3374,86,4,0,4,100.0%,6m
9218,3,Parzival,3374,88,4,3,7,57.1%,27m
9218,3,[SSBIII]Nakasami,3374,58,2,1,3,66.7%,15m
9218,3,[NCT]Cryptes,3374,0,1,2,3,33.3%,6m
9218,3,[Notag]Protoss,3374,0,0,1,1,0.0%,13m
9233,3,Gulgorf,3373,1571,396,377,773,51.2%,19m
9233,3,Wegorockthis,3373,765,164,148,312,52.6%,28m
9233,2,Maschine,3373,1160,74,85,159,46.5%,14m
9233,3,[3ØØ]Craftyraf,3373,563,30,17,47,63.8%,26m
9233,3,ProTerran,3373,520,24,10,34,70.6%,6m
9233,3,кОНЬАГОНь,3373,600,21,24,45,46.7%,5m
9233,2,Tickles,3373,250,7,10,17,41.2%,9m
9233,3,[lMMl]ShadowRoCk,3373,120,5,3,8,62.5%,4m
9233,3,[FRERO]KloseOne,3373,142,5,5,10,50.0%,12m
9233,3,[MATB]Blackprisme,3373,119,3,0,3,100.0%,18m
9233,3,[mShe]Tugan,3373,58,2,1,3,66.7%,4m
9233,3,MyThOs,3373,60,2,3,5,40.0%,10m
9233,3,Kaylliz,3373,30,2,7,9,22.2%,17m
9233,3,Misiek,3373,0,1,4,5,20.0%,18m
9233,3,[TheDOH]Jefflenious,3373,0,0,1,1,0.0%,28m
9248,3,HotPiron,3372,1572,471,466,937,50.3%,14m
9248,3,MrGreen,3372,1412,245,228,473,51.8%,7m
9248,3,Stoeff,3372,1477,204,197,401,50.9%,14m
9248,3,Houdini,3372,1609,184,177,361,51.0%,19m
9248,2,Ridan,3372,790,160,168,328,48.8%,25m
9248,2,MAX,3372,927,156,149,305,51.1%,16m
9248,3,llllllllllll,3372,300,16,12,28,57.1%,5m
9248,3,KtrE,3372,239,11,6,17,64.7%,20m
9248,2,MIlo,3372,280,11,7,18,61.1%,4m
9248,3,Boris,3372,192,8,5,13,61.5%,18m
9248,3,FrantaSimak,3372,170,6,6,12,50.0%,13m
9248,3,Bryson,3372,0,5,2,7,71.4%,5m
9248,1,bOOmPsykoDad,3372,97,3,1,4,75.0%,13m
9248,3,[4Nordy]Sadhomer,3372,0,1,0,1,100.0%,7m
9248,3,sneem,3372,18,1,5,6,16.7%,25m
9248,3,[pLine]EpSyLoN,3372,0,1,9,10,10.0%,19m
9248,3,Cube,3372,0,0,1,1,0.0%,19m
9248,3,Rick,3372,0,0,2,2,0.0%,12m
9248,3,LeopoldS,3372,0,0,3,3,0.0%,26m
9267,3,MrDefender,3371,1484,135,132,267,50.6%,19m
9267,2,Dadou,3371,1072,74,75,149,49.7%,6m
9267,3,Lyde,3371,1651,69,65,134,51.5%,20m
9267,2,[RBP3]nnm,3371,1537,57,64,121,47.1%,9m
9267,3,Alduin,3371,145,7,2,9,77.8%,19m
9267,3,[ärhoo]syila,3371,182,6,9,15,40.0%,19m
9267,3,AngryJaguar,3371,116,4,4,8,50.0%,17m
9267,3,[WWTG]AwildPikachu,3371,42,3,3,6,50.0%,27m
9267,1,Pinocchio,3371,0,1,0,1,100.0%,1h
9267,3,IIIIIIIIIIII,3371,0,0,1,1,0.0%,11m
9267,3,[WeD]Tanknastole,3371,0,0,1,1,0.0%,4m
9267,3,Bamboubergen,3371,0,0,3,3,0.0%,25m
9267,1,Nazghull,3371,0,0,4,4,0.0%,1h
9280,3,[QTcIub]TrollingPoo,3370,1545,153,145,298,51.3%,28m
9280,3,Whïte,3370,607,117,104,221,52.9%,26m
9280,3,AveKor,3370,1016,75,65,140,53.6%,7m
9280,2,Krenton,3370,894,69,85,154,44.8%,4m
9280,2,[iGD2D]ReachLT,3370,1257,44,53,97,45.4%,11m
9280,3,[Gr3]maxs,3370,934,39,32,71,54.9%,20m
9280,3,BaNaNa,3370,622,36,29,65,55.4%,11m
9280,3,Solomonic,3370,598,25,17,42,59.5%,10m
9280,3,Drako,3370,413,17,10,27,63.0%,17m
9280,3,Wurstbrot,3370,361,16,12,28,57.1%,7m
9280,3,arnisd,3370,278,13,5,18,72.2%,19m
9280,2,lIlIlIlIlIlI,3370,181,4,4,8,50.0%,7m
9280,3,[sksksk]Predator,3370,60,3,4,7,42.9%,20m
9280,3,hardware,3370,58,2,2,4,50.0%,18m
9280,3,[Hаsu]StrateG,3370,60,2,4,6,33.3%,11m
9280,1,[LgMstr]llllll,3370,0,1,0,1,100.0%,1h
9280,2,MrHapka,3370,0,1,0,1,100.0%,9m
9280,3,Lio,3370,0,1,2,3,33.3%,14m
9280,3,Chapman,3370,0,0,2,2,0.0%,29m
9299,3,HoLLowMan,3369,1577,131,133,264,49.6%,18m
9299,3,[Hrr]Massad,3369,1099,130,128,258,50.4%,11m
9299,2,FENIXbg,3369,1404,123,131,254,48.4%,16m
9299,3,[CanFod]ALK,3369,1372,120,113,233,51.5%,1m
9299,3,Fred,3369,1399,120,116,236,50.8%,1m
9299,3,[SCEVER]lolostar,3369,1130,54,24,78,69.2%,13m
9299,3,IIIIIIIIII,3369,880,39,32,71,54.9%,27m
9299,3,Hades,3369,914,33,38,71,46.5%,13m
9299,3,ASvool,3369,546,28,26,54,51.9%,26m
9299,3,iSoff,3369,285,18,18,36,50.0%,11m
9299,3,Robertino,3369,460,16,20,36,44.4%,14m
9299,3,TheTerranGuy,3369,198,11,6,17,64.7%,2m
9299,3,RiMJaYNoR,3369,224,10,4,14,71.4%,5m
9299,3,Magnus,3369,118,6,1,7,85.7%,15m
9299,2,tHUMBz,3369,162,5,24,29,17.2%,10m
9299,2,shytech,3369,0,4,5,9,44.4%,5m
9299,3,KekseBaron,3369,94,3,9,12,25.0%,7m
9299,3,WhizKid,3369,60,2,8,10,20.0%,16m
9299,3,[Z3RG7V]Garret,3369,30,1,1,2,50.0%,11m
9299,3,BadWood,3369,0,0,1,1,0.0%,29m
9299,3,[Olk]Tomek,3369,0,0,2,2,0.0%,8m
9320,3,XNetman,3368,1578,345,337,682,50.6%,6m
9320,2,Tortuga,3368,1551,240,251,491,48.9%,7m
9320,3,Whilter,3368,1355,64,46,110,58.2%,29m
9320,3,UnDeFiNeD,3368,1311,60,71,131,45.8%,9m
9320,3,[Зерат]walthergreis,3368,1392,58,53,111,52.3%,15m
9320,3,Murphy,3368,299,54,53,107,50.5%,9m
9320,3,rakom,3368,1128,47,33,80,58.8%,28m
9320,3,[PLA2N]GULIVER,3368,854,42,16,58,72.4%,15m
9320,3,Daxter,3368,691,30,30,60,50.0%,17m
9320,3,[Zhig]TossTerR,3368,532,21,11,32,65.6%,1m
9320,3,SpOOn,3368,201,15,9,24,62.5%,27m
9320,3,ColaDrinker,3368,218,12,1,13,92.3%,14m
9320,3,effOrt,3368,273,10,4,14,71.4%,7m
9320,3,Ltube,3368,157,5,0,5,100.0%,10m
9320,3,[PŖïMĄŁ]BØØØØØØØØØØM,3368,116,5,5,10,50.0%,3m
9320,3,MoaTailandkz,3368,152,5,16,21,23.8%,14m
9320,3,XLHAX,3368,124,4,10,14,28.6%,2m
9320,3,[PŖïMĄŁ]GolDaniels,3368,58,3,0,3,100.0%,11m
9320,3,ShïNo,3368,0,0,2,2,0.0%,27m
9339,3,[Wolven]YanSanayi,3367,1328,160,154,314,51.0%,1m
9339,3,[ÆR]Reaper,3367,1385,91,91,182,50.0%,11m
9339,3,Ayou,3367,497,43,40,83,51.8%,3m
9339,3,JaRema,3367,838,39,34,73,53.4%,11m
9339,3,Sethroad,3367,439,20,14,34,58.8%,10m
9339,1,coreX,3367,237,12,8,20,60.0%,6m
9339,3,Ramutra,3367,324,11,11,22,50.0%,9m
9339,3,glloyd,3367,264,10,12,22,45.5%,1m
9339,3,NoBraphouX,3367,166,6,2,8,75.0%,16m
9339,3,QuakeII,3367,154,6,7,13,46.2%,6m
9339,3,Jiraya,3367,152,5,9,14,35.7%,15m
9339,3,Verukk,3367,0,4,1,5,80.0%,2m
9339,3,[QTcIub]Nazgul,3367,122,4,9,13,30.8%,2m
9339,3,Rinzler,3367,30,2,1,3,66.7%,6m
9339,3,[EvilGs]deaconfrost,3367,30,2,2,4,50.0%,27m
9339,3,blrpapa,3367,0,2,5,7,28.6%,10m
9339,3,[M88]BlackBaron,3367,0,1,0,1,100.0%,6m
9339,3,GriefSong,3367,0,0,1,1,0.0%,10m
9339,3,jaydee,3367,0,0,5,5,0.0%,6m
9358,2,GoodMorning,3366,1631,498,501,999,49.8%,2m
9358,3,Tony,3366,797,104,96,200,52.0%,1m
9358,2,Mouchou,3366,1545,99,109,208,47.6%,7m
9358,3,Reefer,3366,802,34,31,65,52.3%,17m
9358,3,МистерХел,3366,500,33,7,40,82.5%,14m
9358,3,QuaD,3366,674,27,17,44,61.4%,11m
9358,3,[BKS]GonzoPunkass,3366,220,22,17,39,56.4%,3m
9358,2,[2raxyo]Gammkrab,3366,487,22,22,44,50.0%,4m
9358,3,IllIIlllIlII,3366,299,14,6,20,70.0%,28m
9358,3,Yakain,3366,349,12,14,26,46.2%,5m
9358,3,Antares,3366,170,9,13,22,40.9%,9m
9358,3,[ICYFAR]Blodzil,3366,191,6,1,7,85.7%,28m
9358,3,Doiel,3366,58,2,2,4,50.0%,1m
9358,3,Overmind,3366,0,2,3,5,40.0%,11m
9358,3,BioRNN,3366,62,2,6,8,25.0%,13m
9358,3,[Supplo]Moonshield,3366,30,1,3,4,25.0%,27m
9358,3,GoKzy,3366,30,1,4,5,20.0%,25m
9358,3,Pinky,3366,0,0,1,1,0.0%,14m
9358,3,DonaldDuck,3366,0,0,1,1,0.0%,18m
9377,2,patrick,3365,1551,253,260,513,49.3%,6m
9377,3,[EмŦS]Porphyriel,3365,1105,116,115,231,50.2%,10m
9377,2,petryha,3365,832,106,112,218,48.6%,7m
9377,3,Alex,3365,359,30,29,59,50.8%,8m
9377,3,[BRSKR]Hexe,3365,756,28,29,57,49.1%,10m
9377,3,Rasterfant,3365,682,27,19,46,58.7%,15m
9377,3,Djent,3365,565,24,13,37,64.9%,13m
9377,3,PlayerOne,3365,526,22,19,41,53.7%,3m
9377,3,killik,3365,390,17,11,28,60.7%,2m
9377,3,[TWCE]Whodis,3365,414,16,13,29,55.2%,28m
9377,3,Henra,3365,262,8,19,27,29.6%,7m
9377,3,tiga,3365,30,5,2,7,71.4%,11m
9377,3,[Ris3n]HomeTownCrib,3365,114,4,2,6,66.7%,12m
9377,3,RescheG,3365,30,2,0,2,100.0%,1m
9377,3,Golo,3365,0,1,1,2,50.0%,1m
9377,3,[Herz]Boli,3365,0,1,1,2,50.0%,5m
9377,3,Fearless,3365,0,0,1,1,0.0%,3m
9394,3,JigSAW,3364,1264,56,52,108,51.9%,9m
9394,3,oLoLo,3364,825,51,56,107,47.7%,14m
9394,2,Buch,3364,822,46,45,91,50.5%,10m
9394,3,Bazor,3364,630,43,38,81,53.1%,16m
9394,2,Chute,3364,532,37,57,94,39.4%,1m
9394,3,icarusmarine,3364,820,34,23,57,59.6%,18m
9394,3,HmHoozMilo,3364,656,27,13,40,67.5%,4m
9394,3,Terran,3364,284,17,15,32,53.1%,5m
9394,2,SadTobie,3364,403,17,17,34,50.0%,18m
9394,2,glhf,3364,516,16,32,48,33.3%,14m
9394,3,ZooM,3364,348,13,14,27,48.1%,11m
9394,3,FRuffin,3364,174,9,2,11,81.8%,28m
9394,3,Neurotic,3364,146,5,4,9,55.6%,18m
9394,3,[TmFlei]Raggi,3364,120,4,8,12,33.3%,8m
9394,3,Diniz,3364,60,2,3,5,40.0%,18m
9394,3,Caremachine,3364,60,2,4,6,33.3%,26m
9394,3,Kasperl,3364,30,2,4,6,33.3%,29m
9394,3,Mellon,3364,30,1,2,3,33.3%,7m
9412,3,[ZERG7V]Diontep,3363,1581,302,289,591,51.1%,7m
9412,3,cruz,3363,1004,137,128,265,51.7%,9m
9412,3,[IceHus]LiquidWoo,3363,1208,95,80,175,54.3%,2m
9412,3,MIRUKY,3363,565,40,38,78,51.3%,27m
9412,3,Martin,3363,467,24,24,48,50.0%,9m
9412,3,[IceHus]IIIIIIIIIIII,3363,323,17,10,27,63.0%,28m
9412,3,Lonkero,3363,358,17,10,27,63.0%,16m
9412,3,ddddddd,3363,341,15,9,24,62.5%,5m
9412,2,TERRAN,3363,0,3,2,5,60.0%,18m
9412,3,neo,3363,30,2,0,2,100.0%,6m
9412,3,[5up]cola,3363,30,2,1,3,66.7%,28m
9412,3,[Умоджа]Maksimka,3363,0,1,0,1,100.0%,8m
9412,3,OKINYO,3363,0,0,1,1,0.0%,2m
9425,3,PfCla,3362,1570,91,82,173,52.6%,4m
9425,3,[Dobro]Kulinar,3362,1627,73,65,138,52.9%,15m
9425,3,[FractG]Frostfix,3362,563,49,38,87,56.3%,14m
9425,3,UmeChrono,3362,800,30,27,57,52.6%,17m
9425,3,[ValidG]Leo,3362,618,27,17,44,61.4%,28m
9425,3,[Li0n]PeeSee,3362,482,19,14,33,57.6%,1m
9425,3,[HAHAH]Khyane,3362,437,19,23,42,45.2%,5m
9425,3,[2M1B]AzureAnvil,3362,478,17,24,41,41.5%,14m
9425,3,YourHighness,3362,272,11,7,18,61.1%,3m
9425,3,Malakay,3362,282,10,10,20,50.0%,17m
9425,3,[CTD]Zewrgban,3362,30,2,0,2,100.0%,17m
9425,3,[DmE]pOtAtOs,3362,0,1,0,1,100.0%,28m
9425,3,[BRSKR]Blade,3362,0,1,0,1,100.0%,9m
9425,3,[HBeS]Zabura,3362,30,1,1,2,50.0%,6m
9425,3,alf,3362,30,1,1,2,50.0%,16m
9425,3,Juanfi,3362,0,0,1,1,0.0%,10m
9425,3,Ress,3362,0,0,2,2,0.0%,3m
9425,3,moZol,3362,0,0,2,2,0.0%,14m
9425,3,OldKingMidas,3362,0,0,3,3,0.0%,18m
9444,3,Quest,3361,1255,243,230,473,51.4%,3m
9444,3,Oekel,3361,1197,71,72,143,49.7%,18m
9444,3,Joe,3361,904,32,41,73,43.8%,10m
9444,3,TaRKuS,3361,496,18,11,29,62.1%,4m
9444,3,[BTNB]Barbarry,3361,458,17,18,35,48.6%,13m
9444,3,[UGHAGH]doidoi,3361,258,10,14,24,41.7%,26m
9444,3,[Cracot]xXKiKooLoLXx,3361,0,4,4,8,50.0%,6m
9444,3,[IX9TH]Deidara,3361,0,1,0,1,100.0%,18m
9444,3,[Silvеr]Vitek,3361,30,1,1,2,50.0%,10m
9453,2,Iscariot,3360,1529,653,650,1303,50.1%,15m
9453,3,alexH,3360,1497,147,139,286,51.4%,14m
9453,2,StuckDiamond,3360,1451,144,139,283,50.9%,14m
9453,3,[16yo]Slyce,3360,358,71,54,125,56.8%,26m
9453,3,[GLGML]IIIIIIIIIIII,3360,1512,67,66,133,50.4%,11m
9453,3,[ETESG]ExoticNytra,3360,544,24,8,32,75.0%,2m
9453,3,Ray,3360,582,23,15,38,60.5%,2m
9453,3,Kilzi,3360,412,15,17,32,46.9%,2m
9453,3,chartzono,3360,421,14,13,27,51.9%,16m
9453,2,Skysork,3360,161,13,18,31,41.9%,2m
9453,3,SmartAsS,3360,266,9,10,19,47.4%,15m
9453,3,[bod]Projectile,3360,184,7,11,18,38.9%,26m
9453,3,FirstTime,3360,86,4,0,4,100.0%,14m
9453,3,[lnvoke]MicMaN,3360,30,4,2,6,66.7%,3m
9453,3,koVex,3360,88,3,7,10,30.0%,4m
9453,3,maxxxpankra,3360,30,2,1,3,66.7%,18m
9453,3,[3EER]MrQwert,3360,30,2,1,3,66.7%,18m
9453,3,[TerBHD]GhosT,3360,60,2,3,5,40.0%,5m
9453,3,FistBruh,3360,30,1,2,3,33.3%,7m
9453,3,Bush,3360,30,1,6,7,14.3%,3m
9453,3,CAOCAO,3360,0,0,1,1,0.0%,10m
9453,3,Aidmyster,3360,0,0,2,2,0.0%,10m
9453,3,eduardolobre,3360,0,0,4,4,0.0%,11m
9476,2,KILLSTAR,3359,1529,298,307,605,49.3%,17m
9476,3,[bitoQ2]Luto,3359,1092,52,49,101,51.5%,10m
9476,3,sutarcz,3359,695,30,16,46,65.2%,10m
9476,3,Somi,3359,583,25,16,41,61.0%,28m
9476,2,Kelwyn,3359,250,9,21,30,30.0%,7m
9476,3,Spiddi,3359,188,8,3,11,72.7%,26m
9476,3,[INOE]IIIIIIIIIIII,3359,169,8,3,11,72.7%,4m
9476,3,Sam,3359,195,6,6,12,50.0%,10m
9476,3,[Stim]Crule,3359,126,5,10,15,33.3%,17m
9476,2,khodosss,3359,118,3,3,6,50.0%,25m
9476,3,[BRSKR]firendted,3359,60,2,4,6,33.3%,18m
9476,3,JackOneill,3359,62,2,8,10,20.0%,2m
9476,1,[BbLanD]Isku,3359,94,1,2,3,33.3%,9m
9476,3,thejazzapple,3359,0,0,3,3,0.0%,5m
9476,3,Sephiroth,3359,0,0,4,4,0.0%,7m
9476,3,Rocky,3359,0,0,5,5,0.0%,7m
9492,3,Crocodile,3358,1110,40,48,88,45.5%,2m
9492,3,[DarkEZ]FunkyPants,3358,762,28,36,64,43.8%,11m
9492,3,partizan,3358,698,26,19,45,57.8%,10m
9492,3,Aleke,3358,440,16,11,27,59.3%,7m
9492,3,Frostmourn,3358,290,11,13,24,45.8%,5m
9492,3,SpyritE,3358,176,7,2,9,77.8%,9m
9492,3,[aDIV]BubaX,3358,164,7,14,21,33.3%,16m
9492,3,Only,3358,116,5,4,9,55.6%,4m
9492,3,[KDV]bowman,3358,90,3,3,6,50.0%,6m
9492,3,Stressling,3358,86,3,6,9,33.3%,28m
9492,3,[MFO]DARKLESTAT,3358,60,2,3,5,40.0%,14m
9492,2,GSǂPrototype,3358,0,0,1,1,0.0%,29m
9492,3,[UNCNKG]GireOut,3358,0,0,1,1,0.0%,28m
9492,3,MastrOfOrion,3358,0,0,2,2,0.0%,8m
9506,3,[Heroes]Xeralak,3357,1577,156,143,299,52.2%,4m
9506,3,[ON1ON]czosnek,3357,1168,45,43,88,51.1%,3m
9506,2,[Hаsu]MEDVED,3357,1041,41,40,81,50.6%,3m
9506,3,Mythotheboss,3357,465,18,7,25,72.0%,3m
9506,3,Annatar,3357,404,15,16,31,48.4%,7m
9506,3,NotYouAgain,3357,212,7,11,18,38.9%,10m
9506,3,[Cttr]KeaN,3357,184,6,11,17,35.3%,2m
9506,3,Buggy,3357,114,5,3,8,62.5%,27m
9506,3,Grinch,3357,90,3,10,13,23.1%,26m
9506,3,Odin,3357,30,1,6,7,14.3%,4m
9506,3,[NSFG0D]HappyTown,3357,0,0,1,1,0.0%,15m
9517,2,albin,3356,1557,808,799,1607,50.3%,12m
9517,2,Silverback,3356,1271,204,201,405,50.4%,28m
9517,3,[SASA]Terrorizer,3356,1547,124,118,242,51.2%,4m
9517,3,DarkDiest,3356,1246,88,69,157,56.1%,15m
9517,3,Dmik,3356,1192,54,44,98,55.1%,17m
9517,3,[GawAt]DerSchluppke,3356,855,36,27,63,57.1%,3m
9517,3,Hannibaal,3356,620,23,28,51,45.1%,15m
9517,3,STALINK,3356,564,21,20,41,51.2%,4m
9517,3,ichi,3356,429,18,10,28,64.3%,4m
9517,3,Boris,3356,421,15,13,28,53.6%,8m
9517,3,[IRTG]Futorius,3356,280,14,6,20,70.0%,1m
9517,3,[ZiZii]LouWeed,3356,302,9,15,24,37.5%,15m
9517,3,Flesh,3356,224,8,10,18,44.4%,26m
9517,3,Johnny,3356,140,6,2,8,75.0%,13m
9517,3,mager,3356,30,5,1,6,83.3%,6m
9517,3,[Kompi]Exedo,3356,30,3,3,6,50.0%,13m
9517,3,CoachBuondi,3356,60,2,5,7,28.6%,13m
9517,3,Tesla,3356,0,1,1,2,50.0%,28m
9517,3,[JBosh]Диомед,3356,30,1,2,3,33.3%,1m
9517,3,[ggGGwp]VoidRay,3356,0,1,3,4,25.0%,28m
9537,3,[YLLUMA]Feeko,3355,1580,78,63,141,55.3%,6m
9537,3,[ANGELL]Caillou,3355,420,15,15,30,50.0%,9m
9537,3,Destroyer,3355,272,10,16,26,38.5%,2m
9537,3,samVimes,3355,204,7,9,16,43.8%,10m
9537,3,Zakarumae,3355,121,6,3,9,66.7%,14m
9537,3,puls,3355,229,6,9,15,40.0%,7m
9537,3,[1825]AlainSoral,3355,0,1,0,1,100.0%,7m
9537,3,DevilsFire,3355,0,0,1,1,0.0%,17m
9545,3,Artiiste,3354,1116,205,185,390,52.6%,13m
9545,3,Wippie,3354,1268,71,73,144,49.3%,3m
9545,3,BoostUp,3354,853,50,36,86,58.1%,17m
9545,3,salah,3354,848,48,35,83,57.8%,7m
9545,3,Aylod,3354,302,17,18,35,48.6%,9m
9545,2,Levi,3354,422,14,26,40,35.0%,28m
9545,3,vladplav,3354,320,13,12,25,52.0%,4m
9545,3,[dQQb]CreeXx,3354,220,9,11,20,45.0%,12m
9545,2,jackoo,3354,280,9,22,31,29.0%,18m
9545,3,Jak,3354,198,7,4,11,63.6%,15m
9545,3,[Xa]JairSnow,3354,208,7,16,23,30.4%,16m
9545,1,Nando,3354,193,5,9,14,35.7%,16m
9545,3,[1A2857]ErZil,3354,30,2,6,8,25.0%,11m
9545,3,Neroc,3354,0,1,0,1,100.0%,13m
9559,3,noseglid,3353,1163,155,133,288,53.8%,17m
9559,3,Goden,3353,1456,102,99,201,50.7%,10m
9559,3,[LEVARP]MrDragon,3353,1360,56,41,97,57.7%,8m
9559,3,KillerCookie,3353,1449,55,48,103,53.4%,10m
9559,3,[SaviOr]jezza,3353,823,53,55,108,49.1%,9m
9559,3,[TAW]DigitZ,3353,668,24,24,48,50.0%,4m
9559,3,IIIIIIIIIIII,3353,60,3,3,6,50.0%,27m
9559,3,[CCHG]Tonyo,3353,30,2,3,5,40.0%,9m
9559,3,lllIIIIlllII,3353,0,1,0,1,100.0%,10m
9559,2,[LofE]Asakura,3353,0,1,0,1,100.0%,15m
9559,3,CalvinHarass,3353,0,0,1,1,0.0%,17m
9559,3,[TenCo]fetteheiDi,3353,0,0,1,1,0.0%,10m
9559,3,Drotatcid,3353,0,0,1,1,0.0%,6m
9559,3,[CBTH]Jpus,3353,0,0,2,2,0.0%,2m
9573,2,pathetic,3352,1413,132,136,268,49.3%,13m
9573,3,[SBÜG]SirSchim,3352,1447,102,104,206,49.5%,26m
9573,3,alexd,3352,1155,81,68,149,54.4%,26m
9573,2,Renart,3352,710,24,39,63,38.1%,4m
9573,3,EliKs,3352,292,14,11,25,56.0%,12m
9573,3,LilBuggie,3352,232,13,11,24,54.2%,16m
9573,1,ForeverPlat,3352,244,12,8,20,60.0%,11m
9573,3,[7BINKS]Honey,3352,298,10,19,29,34.5%,3m
9573,3,SupAndy,3352,141,9,9,18,50.0%,14m
9573,2,Eugeln,3352,182,8,4,12,66.7%,10m
9573,3,[LPFG]CCCР,3352,214,7,2,9,77.8%,11m
9573,3,[eli]MrSnibbles,3352,117,6,1,7,85.7%,10m
9573,3,Hobzy,3352,30,2,1,3,66.7%,6m
9573,3,Prezio,3352,0,1,0,1,100.0%,17m
9573,3,[LN69]Tatagoras,3352,0,0,1,1,0.0%,8m
9573,3,Jendker,3352,0,0,1,1,0.0%,1m
9589,2,[Apero]FaberCraft,3351,1562,405,413,818,49.5%,27m
9589,3,DCero,3351,1354,192,173,365,52.6%,16m
9589,3,Aganus,3351,1485,90,86,176,51.1%,6m
9589,3,sexySamurai,3351,767,40,39,79,50.6%,2m
9589,3,asdqweas,3351,551,22,11,33,66.7%,18m
9589,3,[skate]helpy,3351,295,16,19,35,45.7%,27m
9589,3,питбуль,3351,395,15,7,22,68.2%,2m
9589,3,DickHui,3351,194,9,5,14,64.3%,16m
9589,3,[Mask]LazerLarven,3351,0,5,0,5,100.0%,5m
9589,2,JSF,3351,0,5,0,5,100.0%,1h
9589,3,LOPATA,3351,114,4,3,7,57.1%,11m
9589,3,ShabanS,3351,60,3,3,6,50.0%,10m
9589,3,Chii,3351,0,1,0,1,100.0%,15m
9589,3,mikep,3351,0,0,1,1,0.0%,16m
9589,3,IIIIIIIIIIII,3351,0,0,1,1,0.0%,13m
9604,3,Denji,3350,1538,143,140,283,50.5%,16m
9604,3,Karks,3350,1475,73,63,136,53.7%,17m
9604,3,Herpowsky,3350,1410,52,53,105,49.5%,26m
9604,3,[NÛL]CommeTuVeux,3350,246,9,3,12,75.0%,3m
9604,3,[PUPSIK]IsifLife,3350,92,3,7,10,30.0%,3m
9604,3,JumpyLion,3350,0,2,3,5,40.0%,1m
9604,3,Fernstein,3350,0,1,0,1,100.0%,27m
9604,3,CuiBono,3350,0,1,0,1,100.0%,27m
9604,3,[Bulg]MaRINeTo,3350,0,1,0,1,100.0%,15m
9604,3,Fadroma,3350,0,1,1,2,50.0%,15m
9604,3,AlphaStar,3350,0,0,3,3,0.0%,2m
9615,3,andreyka,3349,1568,139,132,271,51.3%,26m
9615,3,Keras,3349,1172,89,67,156,57.1%,17m
9615,2,JuLiENNz,3349,1366,52,55,107,48.6%,8m
9615,3,[Hrѓ]Акулка,3349,1256,50,48,98,51.0%,26m
9615,3,ElectroShock,3349,748,33,27,60,55.0%,15m
9615,3,Shluhogon,3349,590,21,25,46,45.7%,3m
9615,3,[NVY]givos,3349,437,20,12,32,62.5%,10m
9615,3,FlyEater,3349,431,16,24,40,40.0%,2m
9615,3,GospodinNavy,3349,344,14,11,25,56.0%,10m
9615,3,[DaFF]gotmilk,3349,222,9,8,17,52.9%,6m
9615,3,JoeSoul,3349,142,5,4,9,55.6%,12m
9615,3,[lIlIll]Diversity,3349,0,4,1,5,80.0%,17m
9615,3,Tick,3349,121,3,2,5,60.0%,5m
9615,3,[CJFF]BahBahSpiNah,3349,34,2,1,3,66.7%,10m
9615,3,iSeM,3349,0,0,1,1,0.0%,11m
9630,2,iloveyou,3348,1584,372,368,740,50.3%,11m
9630,3,BlackVinny,3348,1375,127,126,253,50.2%,26m
9630,3,AnDiii,3348,839,88,72,160,55.0%,16m
9630,3,laithov,3348,939,85,72,157,54.1%,10m
9630,3,Slaban,3348,1435,79,71,150,52.7%,28m
9630,3,Samuro,3348,1456,59,55,114,51.8%,15m
9630,3,Skeli,3348,460,18,15,33,54.5%,27m
9630,3,ursus,3348,458,18,18,36,50.0%,25m
9630,3,[B3WBS]PsYcHeDeLiC,3348,398,15,16,31,48.4%,10m
9630,2,ProtoZZavr,3348,302,10,26,36,27.8%,26m
9630,3,gun,3348,261,9,4,13,69.2%,9m
9630,3,Poodle,3348,218,8,4,12,66.7%,1m
9630,3,[Spartа]eRrrr,3348,185,5,2,7,71.4%,6m
9630,3,XRay,3348,90,3,5,8,37.5%,26m
9630,3,BBK,3348,0,1,0,1,100.0%,10m
9630,3,HypnotiX,3348,0,0,1,1,0.0%,18m
9630,3,[MPTUS]FisTeR,3348,0,0,2,2,0.0%,5m
9630,3,zzaazzoo,3348,0,0,5,5,0.0%,26m
9648,3,Luciferase,3347,1468,58,55,113,51.3%,26m
9648,3,Thanatos,3347,998,38,34,72,52.8%,3m
9648,2,[nB]Addon,3347,737,27,40,67,40.3%,8m
9648,3,Stoker,3347,479,21,17,38,55.3%,14m
9648,3,Ватрушка,3347,120,6,2,8,75.0%,7m
9648,3,Serek,3347,48,6,2,8,75.0%,5m
9648,3,[theDH]Singo,3347,146,6,9,15,40.0%,17m
9648,3,[MXC]SuperMX,3347,30,2,0,2,100.0%,13m
9648,3,Aira,3347,30,2,2,4,50.0%,18m
9648,3,Matrixx,3347,30,2,3,5,40.0%,7m
9648,3,henrymorgan,3347,0,1,0,1,100.0%,3m
9648,3,hatcher,3347,0,1,0,1,100.0%,16m
9648,2,ndolphin,3347,0,1,1,2,50.0%,10m
9648,3,[STDES]Gerwill,3347,0,1,1,2,50.0%,3m
9648,3,morme,3347,0,0,4,4,0.0%,2m
9663,3,[TeMpp]TRock,3346,1578,241,248,489,49.3%,9m
9663,3,Moglaman,3346,1226,60,49,109,55.0%,29m
9663,3,Kamon,3346,671,52,58,110,47.3%,16m
9663,3,Nerot,3346,987,41,22,63,65.1%,11m
9663,3,[IndyK]EVOLET,3346,682,26,26,52,50.0%,26m
9663,3,PizzaHawaii,3346,216,17,12,29,58.6%,26m
9663,3,IMCPalblitz,3346,413,15,10,25,60.0%,18m
9663,3,Ozymandias,3346,414,15,24,39,38.5%,8m
9663,3,Sassnet,3346,336,12,9,21,57.1%,1m
9663,3,SoulStranger,3346,340,12,11,23,52.2%,19m
9663,2,Planck,3346,254,11,7,18,61.1%,16m
9663,3,PhENOm,3346,166,7,4,11,63.6%,14m
9663,3,voodoo,3346,196,7,6,13,53.8%,16m
9663,3,deadlykitten,3346,176,6,8,14,42.9%,25m
9663,3,Кирюшка,3346,30,5,1,6,83.3%,18m
9663,3,Hades,3346,60,3,8,11,27.3%,9m
9663,3,Wisefull,3346,0,2,3,5,40.0%,28m
9663,3,IIIIIIIIIIII,3346,30,1,1,2,50.0%,1m
9663,3,Chimera,3346,0,0,1,1,0.0%,14m
9663,3,[Yoh]Croustibat,3346,0,0,1,1,0.0%,26m
9663,3,KROMWELL,3346,0,0,1,1,0.0%,27m
9663,3,[PiGPan]Bulya,3346,0,0,2,2,0.0%,28m
9663,3,Eckow,3346,0,0,2,2,0.0%,18m
9686,3,[AAT]kynka,3345,556,36,32,68,52.9%,19m
9686,3,Alpha,3345,455,31,20,51,60.8%,17m
9686,3,[EAU]ELphot,3345,588,21,27,48,43.8%,19m
9686,3,[JT1]ArTǂJakebeaT,3345,574,20,22,42,47.6%,3m
9686,3,KenKaneki,3345,560,19,26,45,42.2%,8m
9686,3,Yago,3345,334,13,8,21,61.9%,28m
9686,3,Stockish,3345,350,13,11,24,54.2%,17m
9686,3,крутойморпех,3345,185,8,2,10,80.0%,6m
9686,3,Gnarfeur,3345,214,7,12,19,36.8%,26m
9686,3,YoWtF,3345,174,6,10,16,37.5%,8m
9686,3,[Oursbl]Kubera,3345,0,2,3,5,40.0%,29m
9686,3,[KpaБ]kerriGan,3345,30,1,1,2,50.0%,18m
9686,3,Grim,3345,30,1,4,5,20.0%,6m
9686,3,[HsDL]JamZ,3345,30,1,4,5,20.0%,15m
9686,3,Kingisdeaddy,3345,30,1,11,12,8.3%,2m
9686,3,picoeur,3345,0,0,1,1,0.0%,6m
9686,1,[Lappen]harryharry,3345,0,0,1,1,0.0%,12m
9686,3,Almore,3345,0,0,2,2,0.0%,4m
9704,3,Maverick,3344,1625,171,162,333,51.4%,14m
9704,2,Koto,3344,1496,152,159,311,48.9%,8m
9704,3,DivPetel,3344,1636,124,105,229,54.1%,18m
9704,3,[DrPlat]kae,3344,793,106,98,204,52.0%,3m
9704,3,Balodya,3344,1574,72,64,136,52.9%,7m
9704,3,dablju,3344,1390,54,51,105,51.4%,6m
9704,3,[BLitng]Ryukoj,3344,955,48,26,74,64.9%,27m
9704,3,Radek,3344,441,41,42,83,49.4%,2m
9704,3,[BRCHTV]Shunra,3344,502,20,12,32,62.5%,28m
9704,3,[PLA2N]Melnik,3344,326,13,8,21,61.9%,4m
9704,3,[Ris3n]StarsFallDim,3344,196,7,10,17,41.2%,18m
9704,3,Dancer,3344,212,6,2,8,75.0%,15m
9704,3,Akrinis,3344,30,5,2,7,71.4%,16m
9704,3,NautiLus,3344,0,3,2,5,60.0%,18m
9704,3,[Ddor]Lopus,3344,60,3,2,5,60.0%,9m
9704,3,[PiGPan]Darden,3344,0,1,1,2,50.0%,7m
9720,2,Lilou,3343,1611,220,231,451,48.8%,2m
9720,3,Rafalolej,3343,592,23,20,43,53.5%,5m
9720,3,Storspoven,3343,522,22,14,36,61.1%,3m
9720,3,[1580]Aleksanya,3343,275,17,11,28,60.7%,6m
9720,3,Brkyishere,3343,418,15,18,33,45.5%,5m
9720,3,DIEGO,3343,197,14,9,23,60.9%,2m
9720,3,Caltrop,3343,269,10,15,25,40.0%,1m
9720,3,[ØC]Beurp,3343,114,4,4,8,50.0%,4m
9720,1,CarryPotter,3343,120,3,3,6,50.0%,1h
9720,3,Ragdub,3343,0,0,1,1,0.0%,19m
9730,3,SPIRAL,3342,720,144,128,272,52.9%,8m
9730,2,BellOMercY,3342,518,67,63,130,51.5%,3m
9730,3,Delete,3342,336,19,12,31,61.3%,13m
9730,3,[OPMFS]eGG,3342,214,9,4,13,69.2%,17m
9730,3,Shavok,3342,104,8,6,14,57.1%,12m
9730,3,[VFish]kjemperaa,3342,194,7,6,13,53.8%,16m
9730,1,Iota,3342,144,6,2,8,75.0%,49m
9730,3,Farseer,3342,168,6,8,14,42.9%,4m
9730,3,[IceHus]Global,3342,114,5,5,10,50.0%,1m
9730,3,[Hаsu]Airi,3342,34,5,6,11,45.5%,8m
9730,3,[H0DEN]StahlKraft,3342,168,4,7,11,36.4%,5m
9730,3,Druss,3342,86,3,4,7,42.9%,2m
9730,3,SnPPrawn,3342,0,1,0,1,100.0%,4m
9730,3,[Arcane]AǂFrespic,3342,0,1,0,1,100.0%,28m
9730,3,Dove,3342,0,1,1,2,50.0%,2m
9730,3,[Cannоn]Bam,3342,30,1,5,6,16.7%,29m
9730,3,[h3fr]john,3342,0,0,1,1,0.0%,8m
9730,3,deadlyKiss,3342,0,0,1,1,0.0%,3m
9748,3,[OB666]Bistoukette,3341,1423,69,63,132,52.3%,6m
9748,3,[ÆR]Zentis,3341,622,51,50,101,50.5%,4m
9748,3,[JMCM]Patten,3341,958,49,52,101,48.5%,26m
9748,3,UnGemm,3341,1138,46,34,80,57.5%,3m
9748,3,Jerry,3341,1167,46,38,84,54.8%,16m
9748,3,[eVVs]Celebrindor,3341,977,46,40,86,53.5%,1m
9748,3,[GdAT]Blutmilan,3341,688,30,22,52,57.7%,13m
9748,3,JebalMthree,3341,255,10,1,11,90.9%,19m
9748,3,Клубничка,3341,232,9,9,18,50.0%,17m
9748,3,[xSRx]Bullseye,3341,50,9,12,21,42.9%,10m
9748,3,[KirbyC]jack,3341,174,6,4,10,60.0%,13m
9748,3,fromage,3341,30,2,3,5,40.0%,2m
9748,3,Velrann,3341,58,2,10,12,16.7%,11m
9748,3,MrFreeman,3341,0,1,0,1,100.0%,17m
9748,1,Mofasa,3341,93,1,1,2,50.0%,12m
9748,3,shaon,3341,0,1,2,3,33.3%,4m
9748,3,SouLzZ,3341,0,0,2,2,0.0%,17m
9748,3,[JOJPA]CrazyDiamond,3341,0,0,8,8,0.0%,28m
9766,3,Stryker,3340,1515,143,145,288,49.7%,28m
9766,3,Ergun,3340,1605,82,74,156,52.6%,15m
9766,3,MODIMC,3340,1441,78,73,151,51.7%,7m
9766,3,Dreamover,3340,530,26,21,47,55.3%,7m
9766,3,NeMArjay,3340,424,15,12,27,55.6%,13m
9766,3,Carr,3340,416,15,16,31,48.4%,7m
9766,3,Pikapikachu,3340,190,9,4,13,69.2%,26m
9766,3,Dusty,3340,145,7,4,11,63.6%,16m
9766,3,[TheDOH]spenzer,3340,214,7,13,20,35.0%,3m
9766,3,[ORRO]Teddy,3340,146,5,6,11,45.5%,3m
9766,3,Rasch,3340,110,4,2,6,66.7%,1m
9766,2,nerazzurri,3340,0,1,1,2,50.0%,15m
9766,3,[JDUNEZ]StarKing,3340,0,1,2,3,33.3%,3m
9766,3,[AbsA]SynX,3340,0,0,1,1,0.0%,13m
9780,3,Ferdi,3339,747,33,21,54,61.1%,9m
9780,2,Bussmange,3339,441,27,41,68,39.7%,14m
9780,3,[ZERG7V]IAmWhiteBear,3339,612,24,17,41,58.5%,6m
9780,3,Dippingsauce,3339,386,13,22,35,37.1%,3m
9780,3,naganuU,3339,148,12,6,18,66.7%,16m
9780,3,Ares,3339,354,12,18,30,40.0%,2m
9780,3,demon,3339,218,8,12,20,40.0%,6m
9780,3,Mydum,3339,86,4,3,7,57.1%,12m
9780,3,[AFKTM]Neon,3339,30,2,0,2,100.0%,26m
9780,3,[ANIÓŁY]kee,3339,30,2,2,4,50.0%,16m
9780,2,iSMajcioch,3339,0,1,3,4,25.0%,16m
9791,3,[bmp]Leech,3338,1570,138,143,281,49.1%,4m
9791,2,Shredster,3338,1552,108,113,221,48.9%,5m
9791,3,Phantom,3338,1198,62,43,105,59.0%,13m
9791,3,EgirlCrusheR,3338,624,55,47,102,53.9%,4m
9791,3,Goshy,3338,605,23,22,45,51.1%,9m
9791,3,[TeCr]juanmotife,3338,690,23,30,53,43.4%,26m
9791,1,pigboy,3338,322,14,7,21,66.7%,9m
9791,2,MADVILLAIN,3338,198,9,8,17,52.9%,26m
9791,3,[isIMBА]Aoshima,3338,258,9,10,19,47.4%,19m
9791,3,SpriteLemon,3338,192,7,4,11,63.6%,6m
9791,3,[HFR]Benza,3338,194,7,7,14,50.0%,28m
9791,1,Buch,3338,164,7,10,17,41.2%,7m
9791,3,Nimrod,3338,0,1,1,2,50.0%,4m
9791,3,[xBr]Eevee,3338,30,1,2,3,33.3%,2m
9791,3,SilentGait,3338,0,1,6,7,14.3%,14m
9791,1,[NerCC]maagicaa,3338,0,0,1,1,0.0%,6m
9791,3,xWhoopsx,3338,0,0,2,2,0.0%,17m
9791,3,[РУИНА]ГȆЛȆТРȌН,3338,0,0,4,4,0.0%,18m
9791,2,Lemmings,3338,0,0,5,5,0.0%,7m
9810,2,[ZERG7V]LoomY,3337,1077,86,86,172,50.0%,28m
9810,3,Melancholy,3337,752,61,63,124,49.2%,4m
9810,3,[CuWoǂ]OmegA,3337,941,44,29,73,60.3%,3m
9810,3,Xibalbaa,3337,679,29,25,54,53.7%,5m
9810,3,Raven,3337,682,26,25,51,51.0%,3m
9810,3,Isti,3337,484,25,17,42,59.5%,10m
9810,3,[wRos]DuoDynn,3337,249,12,4,16,75.0%,3m
9810,3,Rorschach,3337,340,12,15,27,44.4%,27m
9810,3,clausthaler,3337,306,12,20,32,37.5%,9m
9810,3,Toughn,3337,265,10,15,25,40.0%,26m
9810,3,armin,3337,232,8,0,8,100.0%,5m
9810,3,[пепега]kabyraGe,3337,196,7,6,13,53.8%,6m
9810,3,[GELSEN]HaiLRaiN,3337,128,5,16,21,23.8%,19m
9810,3,[NoBugs]NerfZerg,3337,0,1,1,2,50.0%,14m
9810,3,Voldemort,3337,30,1,1,2,50.0%,5m
9810,3,GuardeMarine,3337,0,1,2,3,33.3%,8m
9810,3,[TEMB]Fallakai,3337,30,1,4,5,20.0%,13m
9810,3,Tura,3337,0,0,1,1,0.0%,25m
9810,3,alola,3337,0,0,1,1,0.0%,17m
9810,3,SyndrØme,3337,0,0,1,1,0.0%,26m
9830,3,Gonzo,3336,1424,164,151,315,52.1%,10m
9830,3,[MEKU]Kuternega,3336,970,43,38,81,53.1%,9m
9830,3,CptRofl,3336,404,15,17,32,46.9%,3m
9830,3,Innovation,3336,277,10,7,17,58.8%,25m
9830,3,Coldhardt,3336,296,10,12,22,45.5%,26m
9830,1,Rororooooooo,3336,251,9,10,19,47.4%,10m
9830,3,Oleg,3336,244,8,12,20,40.0%,16m
9830,2,Skippy,3336,0,2,2,4,50.0%,18m
9830,3,[Kanga]ReioS,3336,0,1,0,1,100.0%,13m
9830,3,JayJay,3336,0,0,5,5,0.0%,2m
9840,2,khannea,3335,1501,481,471,952,50.5%,8m
9840,3,Autogestion,3335,1582,192,188,380,50.5%,3m
9840,3,MyBigJoker,3335,1470,152,144,296,51.4%,27m
9840,3,habhunger,3335,1456,82,62,144,56.9%,16m
9840,3,Wojtek,3335,1595,67,76,143,46.9%,3m
9840,3,DjacKeHroR,3335,968,45,41,86,52.3%,6m
9840,3,CeriSe,3335,811,35,35,70,50.0%,9m
9840,3,[StalkZ]Grrrr,3335,700,30,18,48,62.5%,3m
9840,3,eQThib,3335,339,16,10,26,61.5%,15m
9840,3,Zurglub,3335,427,16,10,26,61.5%,6m
9840,3,[SkBG]frank,3335,348,13,10,23,56.5%,17m
9840,2,BeerMan,3335,253,9,4,13,69.2%,8m
9840,3,PandaMarine,3335,200,8,6,14,57.1%,3m
9840,3,MiguelPérez,3335,200,7,6,13,53.8%,10m
9840,1,Kalroc,3335,0,1,1,2,50.0%,4m
9840,2,AlexGl,3335,0,1,4,5,20.0%,1h
9840,3,LIM,3335,0,0,3,3,0.0%,3m
9857,3,tba,3334,686,60,49,109,55.0%,9m
9857,3,Snouf,3334,1163,45,52,97,46.4%,17m
9857,3,[MiNeR]PoLdek,3334,368,13,19,32,40.6%,3m
9857,2,GKO,3334,209,10,5,15,66.7%,12m
9857,1,don,3334,119,6,2,8,75.0%,1h
9857,3,SpiderCochon,3334,140,5,3,8,62.5%,11m
9857,3,[OXs]Matheox,3334,114,4,2,6,66.7%,11m
9857,3,HazeLRaH,3334,119,3,0,3,100.0%,12m
9857,3,rex,3334,30,3,1,4,75.0%,26m
9857,3,[scp3]Alicexplorer,3334,30,2,3,5,40.0%,17m
9857,3,[ARBY]tristan,3334,30,2,3,5,40.0%,6m
9857,3,[JKRUA]TnT,3334,0,1,0,1,100.0%,5m
9857,1,ElNiNos,3334,0,0,2,2,0.0%,55m
9857,3,Smoke,3334,0,0,3,3,0.0%,1m
9857,3,starzic,3334,0,0,5,5,0.0%,13m
9872,3,Andy,3333,973,313,304,617,50.7%,9m
9872,3,PinkPony,3333,1488,93,77,170,54.7%,6m
9872,2,[IceUp]Woodrose,3333,1557,81,96,177,45.8%,28m
9872,3,Tzin,3333,1173,66,55,121,54.5%,16m
9872,3,IIIIIIII,3333,737,36,35,71,50.7%,27m
9872,3,[БибаSC]ScreaM,3333,623,30,20,50,60.0%,3m
9872,3,LorTirius,3333,518,21,16,37,56.8%,14m
9872,3,LuBo,3333,390,15,11,26,57.7%,9m
9872,3,Tuxybuzz,3333,87,4,2,6,66.7%,26m
9872,3,[R3IGN]SkyBoiii,3333,86,3,2,5,60.0%,28m
9872,3,[дгд]Eddie,3333,0,1,0,1,100.0%,14m
9872,3,[LAMPA]ShinoaLovers,3333,30,1,1,2,50.0%,15m
9872,3,ReCoN,3333,0,1,2,3,33.3%,11m
9872,3,KaMa,3333,30,1,5,6,16.7%,10m
9872,3,HispanO,3333,0,0,5,5,0.0%,18m
9887,2,HyperS,3332,1573,732,688,1420,51.5%,9m
9887,3,Tallec,3332,1562,138,143,281,49.1%,8m
9887,2,fashric,3332,1513,59,77,136,43.4%,9m
9887,3,MyWorld,3332,1116,42,44,86,48.8%,19m
9887,3,[Lambro]BigBrother,3332,908,36,31,67,53.7%,15m
9887,2,freDDy,3332,213,22,33,55,40.0%,9m
9887,3,potato,3332,459,17,17,34,50.0%,2m
9887,3,[ExTr1m]Wizardio,3332,382,15,12,27,55.6%,16m
9887,3,Nems,3332,324,11,14,25,44.0%,26m
9887,3,[YEP4VR]Pear,3332,248,8,19,27,29.6%,6m
9887,3,Ecstasy,3332,86,3,1,4,75.0%,29m
9887,3,[saw6]DaytonaJoe,3332,0,0,1,1,0.0%,1m
9887,3,Rixter,3332,0,0,1,1,0.0%,6m
9887,3,Fuziorak,3332,0,0,1,1,0.0%,3m
9887,3,lélé,3332,0,0,2,2,0.0%,12m
9902,3,IIIMerCy,3331,1589,383,375,758,50.5%,10m
9902,2,OpenFold,3331,1633,301,301,602,50.0%,10m
9902,2,Roberto,3331,1495,234,213,447,52.3%,29m
9902,3,[Sw0rm]DRsloper,3331,1458,109,101,210,51.9%,13m
9902,3,[2ndLaw]SuperTable,3331,604,25,15,40,62.5%,13m
9902,3,Double,3331,541,19,25,44,43.2%,11m
9902,3,BVA,3331,428,17,13,30,56.7%,2m
9902,3,Ihatelag,3331,422,16,13,29,55.2%,3m
9902,3,Flusskind,3331,215,9,6,15,60.0%,13m
9902,3,Marius,3331,231,9,9,18,50.0%,19m
9902,3,AeonOfStrife,3331,172,6,5,11,54.5%,14m
9902,3,[MiFiS]Persephal,3331,90,4,5,9,44.4%,2m
9902,3,cAALY,3331,78,4,7,11,36.4%,28m
9902,2,Nerriel,3331,92,2,2,4,50.0%,7m
9902,3,[CoMoDo]SuM,3331,0,1,1,2,50.0%,17m
9902,3,Nikolai,3331,0,1,4,5,20.0%,10m
9902,3,[Teiai]Nefas,3331,0,0,1,1,0.0%,19m
9902,3,BunkyBunk,3331,0,0,1,1,0.0%,19m
9902,3,Chaffinch,3331,0,0,1,1,0.0%,11m
9921,3,aiya,3330,1602,238,233,471,50.5%,13m
9921,3,ImbaAdepts,3330,1178,72,67,139,51.8%,17m
9921,3,xSwiper,3330,1333,61,55,116,52.6%,10m
9921,3,AmyChant,3330,650,26,13,39,66.7%,11m
9921,3,FKKLord,3330,450,17,20,37,45.9%,9m
9921,3,[Skolan]VktmHenkel,3330,326,11,13,24,45.8%,16m
9921,3,TYD,3330,163,8,3,11,72.7%,29m
9921,3,JollyAndBeer,3330,177,6,0,6,100.0%,1m
9921,3,Uisaw,3330,86,4,1,5,80.0%,18m
9921,3,Sentinel,3330,0,1,0,1,100.0%,4m
9921,3,dorku,3330,0,0,1,1,0.0%,27m
9921,3,FortyTwo,3330,0,0,1,1,0.0%,5m
9933,3,Elendil,3329,1097,43,44,87,49.4%,4m
9933,3,henryy,3329,348,16,11,27,59.3%,26m
9933,3,DonDiego,3329,125,14,12,26,53.8%,18m
9933,1,TerraGold,3329,141,6,2,8,75.0%,3m
9933,3,MANvsSC,3329,30,5,1,6,83.3%,28m
9933,3,[T11]NovahTolunay,3329,88,4,8,12,33.3%,9m
9933,3,SDL,3329,30,1,3,4,25.0%,10m
9933,1,Tea,3329,0,0,2,2,0.0%,50m
9941,2,Azerio,3328,1380,121,116,237,51.1%,8m
9941,3,CrypticWeed,3328,929,61,56,117,52.1%,7m
9941,3,[CS0]Tarwe,3328,1423,56,55,111,50.5%,7m
9941,3,Ganerogno,3328,285,47,50,97,48.5%,10m
9941,3,Jägermeister,3328,1052,41,38,79,51.9%,8m
9941,3,Larchange,3328,853,36,22,58,62.1%,13m
9941,3,SoYaMin,3328,690,34,10,44,77.3%,2m
9941,3,Wekeeh,3328,470,22,12,34,64.7%,17m
9941,2,IIIIIIIIIIII,3328,404,18,21,39,46.2%,4m
9941,3,Willileliram,3328,344,14,17,31,45.2%,18m
9941,3,DarkñighT,3328,234,7,10,17,41.2%,27m
9941,3,Example,3328,0,1,0,1,100.0%,10m
9941,3,socialinput,3328,0,1,0,1,100.0%,15m
9941,3,[TAW]Gustav,3328,0,0,1,1,0.0%,19m
9941,3,slowik,3328,0,0,5,5,0.0%,8m
9956,3,[FrRacl]Baxterry,3327,1492,160,147,307,52.1%,6m
9956,3,mehha,3327,1561,132,134,266,49.6%,15m
9956,3,[AǂR]GengisKhan,3327,1270,61,54,115,53.0%,6m
9956,3,Yamn,3327,510,20,10,30,66.7%,13m
9956,3,llllllllll,3327,283,13,7,20,65.0%,15m
9956,3,BasedOnWhat,3327,380,13,18,31,41.9%,2m
9956,3,[GAMI]negyas,3327,278,10,9,19,52.6%,13m
9956,3,TRQ,3327,178,8,4,12,66.7%,10m
9956,3,stroier,3327,30,2,1,3,66.7%,15m
9956,3,WannabeGwin,3327,58,2,1,3,66.7%,8m
9956,3,[Affii]moraisai,3327,0,1,0,1,100.0%,6m
9956,3,[1FU2]azimuthkaden,3327,30,1,1,2,50.0%,6m
9956,3,Aone,3327,30,1,3,4,25.0%,3m
9969,2,LetsRoll,3326,1042,179,190,369,48.5%,6m
9969,3,Alexey,3326,1585,113,109,222,50.9%,9m
9969,3,winzip,3326,975,88,79,167,52.7%,6m
9969,3,[TheSha]Messier,3326,1535,65,49,114,57.0%,26m
9969,3,FQn,3326,869,59,49,108,54.6%,26m
9969,3,[TchaoT]Micro,3326,874,52,53,105,49.5%,28m
9969,3,[ULTX]hannibal,3326,1232,46,51,97,47.4%,5m
9969,3,YonneyOhYes,3326,500,22,16,38,57.9%,19m
9969,3,[STRUTT]Blueburger,3326,461,21,11,32,65.6%,28m
9969,3,AshlynRae,3326,290,10,9,19,52.6%,7m
9969,3,trotsky,3326,152,6,11,17,35.3%,10m
9969,2,IIIIIIIIIIII,3326,133,3,3,6,50.0%,3m
9969,3,Celeste,3326,58,2,2,4,50.0%,2m
9969,3,maulinho,3326,30,1,1,2,50.0%,13m
9969,3,Mess,3326,30,1,4,5,20.0%,29m
9969,3,[BUAA]scboy,3326,0,0,4,4,0.0%,8m
9985,2,JKCOUCOU,3325,1448,83,93,176,47.2%,29m
9985,3,SpursFan,3325,540,48,42,90,53.3%,28m
9985,3,JayKayPrime,3325,300,11,10,21,52.4%,1m
9985,3,What,3325,194,7,7,14,50.0%,18m
9985,3,[nXh]iMarine,3325,0,5,0,5,100.0%,13m
9985,3,TeLseS,3325,0,0,2,2,0.0%,27m
9991,2,twentyfour,3324,1521,427,425,852,50.1%,17m
9991,3,Ryschun,3324,1611,201,190,391,51.4%,6m
9991,3,Wannabedk,3324,1377,68,69,137,49.6%,17m
9991,3,SiLo,3324,1446,66,61,127,52.0%,10m
9991,3,Hhiruma,3324,805,32,26,58,55.2%,10m
9991,3,[GZerO]Sanguor,3324,38,18,66,84,21.4%,6m
9991,3,[Yétard]Tork,3324,408,16,18,34,47.1%,16m
9991,3,[WBGA]aymeric,3324,97,9,9,18,50.0%,4m
9991,3,[TRLBTR]PraiseLittle,3324,176,7,7,14,50.0%,6m
9991,3,[EAU]YouennLBS,3324,137,4,1,5,80.0%,6m
9991,3,DerBaum,3324,58,2,1,3,66.7%,17m
9991,3,[LaHode]Joschi,3324,60,2,4,6,33.3%,28m
9991,1,BorHblK,3324,46,2,4,6,33.3%,10m
9991,3,Степан,3324,0,1,0,1,100.0%,17m
9991,3,[Vørtëx]Hakon,3324,0,0,1,1,0.0%,8m
9991,3,Fatamorgana,3324,0,0,1,1,0.0%,2m
10007,3,[Frоm]Silver,3323,1460,128,118,246,52.0%,12m
10007,2,Tiger,3323,1529,68,82,150,45.3%,18m
10007,3,LocomojO,3323,798,58,53,111,52.3%,3m
10007,3,Deadmaron,3323,388,48,34,82,58.5%,3m
10007,3,Rethnael,3323,649,35,22,57,61.4%,6m
10007,3,[Fru1t]OrEiLLe,3323,408,16,10,26,61.5%,13m
10007,3,IIIIIIIIIIII,3323,168,10,0,10,100.0%,16m
10007,3,[dæD]InFeCTedLinG,3323,250,10,3,13,76.9%,17m
10007,3,Ehcl,3323,114,5,5,10,50.0%,10m
10007,3,[ArsB]kiwiking,3323,71,4,4,8,50.0%,6m
10007,3,IIIIIIIIIII,3323,122,4,8,12,33.3%,3m
10007,1,llllllllllll,3323,97,1,2,3,33.3%,44m
10007,3,[VIIDCS]Tokensy,3323,0,1,3,4,25.0%,13m
10007,3,Matrix,3323,0,0,1,1,0.0%,17m
10007,3,[PŖïMĄŁ]CristoDorado,3323,0,0,4,4,0.0%,2m
10022,3,[xZero]reee,3322,1615,76,56,132,57.6%,8m
10022,3,TakeOnMe,3322,1328,66,53,119,55.5%,2m
10022,3,eram,3322,1396,64,60,124,51.6%,5m
10022,3,KirikBelarus,3322,1016,43,29,72,59.7%,9m
10022,3,Hellcat,3322,612,29,21,50,58.0%,10m
10022,1,[ККП]LikeVoid,3322,187,9,6,15,60.0%,18m
10022,3,IIIIIIIIIIII,3322,178,6,8,14,42.9%,9m
10022,3,DogTor,3322,153,6,14,20,30.0%,10m
10022,3,Massive,3322,142,5,4,9,55.6%,10m
10022,2,SWAT,3322,0,4,1,5,80.0%,13m
10022,3,BERBERECHOS,3322,120,4,7,11,36.4%,28m
10022,3,misterG,3322,94,4,8,12,33.3%,13m
10022,3,WootHu,3322,86,3,8,11,27.3%,3m
10022,3,[HQ31er]Try,3322,58,2,2,4,50.0%,12m
10022,3,[UTGEU]Boteck,3322,0,1,2,3,33.3%,18m
10022,3,hadoukeeen,3322,0,1,4,5,20.0%,26m
10022,3,saint,3322,0,0,6,6,0.0%,19m
10039,3,GERONIMO,3321,1525,124,130,254,48.8%,5m
10039,3,[Croqus]Ciole,3321,1613,72,56,128,56.2%,6m
10039,3,[RoyalR]jomecel,3321,1471,62,51,113,54.9%,6m
10039,3,LoleMonster,3321,674,55,44,99,55.6%,5m
10039,3,starlord,3321,1102,42,39,81,51.9%,4m
10039,3,[PHØMUI]Winchester,3321,1026,40,35,75,53.3%,9m
10039,3,foxer,3321,862,36,29,65,55.4%,2m
10039,3,[HZeS]GooseLuck,3321,747,29,24,53,54.7%,17m
10039,3,[BornG]OnionKnight,3321,436,20,16,36,55.6%,18m
10039,3,Dankata,3321,284,12,6,18,66.7%,11m
10039,3,[delTOS]Serioeoers,3321,302,12,9,21,57.1%,9m
10039,3,[CYC]NerO,3321,242,9,13,22,40.9%,10m
10039,3,Wodan,3321,172,7,6,13,53.8%,17m
10039,3,[HAPING]HapilyInsane,3321,168,6,7,13,46.2%,3m
10039,3,[Peeps]GosuBuddha,3321,152,6,11,17,35.3%,6m
10039,2,[HSSN]Terminator,3321,179,5,4,9,55.6%,17m
10039,2,Nice,3321,159,4,2,6,66.7%,17m
10039,3,[WYFU]onlymatze,3321,120,4,5,9,44.4%,9m
10039,3,Benzy,3321,90,3,5,8,37.5%,3m
10039,3,lytiy,3321,0,1,0,1,100.0%,10m
10039,2,Roublard,3321,0,1,0,1,100.0%,16m
10039,3,TOGA,3321,30,1,1,2,50.0%,16m
10039,3,NaughtyDog,3321,30,1,4,5,20.0%,3m
10039,3,DaSupervisor,3321,0,1,4,5,20.0%,16m
10063,3,Redidondo,3320,955,204,207,411,49.6%,6m
10063,3,[Svin4]KISSARMY,3320,1594,152,154,306,49.7%,27m
10063,3,Saezman,3320,1136,73,58,131,55.7%,12m
10063,3,Cardinali,3320,419,29,17,46,63.0%,28m
10063,3,DeathL,3320,655,26,17,43,60.5%,1m
10063,3,Indebear,3320,566,21,21,42,50.0%,13m
10063,3,[ATROYA]zerveruz,3320,361,14,5,19,73.7%,14m
10063,3,Hÿpø,3320,287,11,4,15,73.3%,19m
10063,3,[FNK]SirFettFisch,3320,252,9,1,10,90.0%,15m
10063,3,[WAAAR]LED,3320,182,8,1,9,88.9%,17m
10063,1,[QTclub]TheOtherOne,3320,165,7,3,10,70.0%,16m
10063,3,Wave,3320,114,5,5,10,50.0%,14m
10063,3,[0BO]BluePlay,3320,60,3,7,10,30.0%,2m
10063,3,gUy,3320,0,1,0,1,100.0%,18m
10063,3,[A4GG]pélicanR,3320,0,1,1,2,50.0%,16m
10063,2,[FOYD]Dovlatov,3320,40,1,2,3,33.3%,4m
10063,2,[SY2G]Guts,3320,30,1,11,12,8.3%,8m
10063,3,[RESET]Nameoliss,3320,0,0,1,1,0.0%,2m
10063,1,Kuru,3320,0,0,2,2,0.0%,17m
10063,3,Maxmenace,3320,0,0,5,5,0.0%,11m
10083,2,[isIMBА]Ipkiss,3319,1539,466,465,931,50.1%,13m
10083,3,[AiRǂ]Caliente,3319,1457,223,212,435,51.3%,26m
10083,2,[IOWT]Posimodias,3319,1385,157,155,312,50.3%,9m
10083,3,Margonash,3319,1592,142,126,268,53.0%,2m
10083,3,asnO,3319,1522,98,99,197,49.7%,19m
10083,3,Grudge,3319,1555,91,85,176,51.7%,12m
10083,3,ChikoSATAN,3319,698,24,30,54,44.4%,19m
10083,2,ForzaSvW,3319,512,20,23,43,46.5%,8m
10083,3,TassieTom,3319,280,10,11,21,47.6%,10m
10083,3,[W33]Apollo,3319,168,7,5,12,58.3%,19m
10083,3,EmperorPutin,3319,0,1,0,1,100.0%,28m
10083,3,[SUFU]KeyJack,3319,0,1,1,2,50.0%,16m
10083,3,kersmo,3319,30,1,3,4,25.0%,11m
10083,3,DarckWaacku,3319,0,0,1,1,0.0%,11m
10083,3,Kira,3319,0,0,2,2,0.0%,26m
10083,2,[STOC]Vinny,3319,0,0,2,2,0.0%,7m
10099,3,AllTiming,3318,1193,81,77,158,51.3%,4m
10099,3,silmarilioon,3318,1065,59,60,119,49.6%,28m
10099,3,Markvart,3318,934,32,40,72,44.4%,4m
10099,3,Prayer,3318,415,17,7,24,70.8%,6m
10099,3,Erebuni,3318,456,17,15,32,53.1%,10m
10099,3,[BCBB]Nummy,3318,232,8,9,17,47.1%,5m
10099,3,CannonRusher,3318,150,6,12,18,33.3%,16m
10099,3,AndachtEU,3318,0,4,1,5,80.0%,10m
10099,3,Appelschrapp,3318,114,4,4,8,50.0%,3m
10099,3,Likan,3318,93,2,1,3,66.7%,16m
10099,3,Dvak,3318,30,2,6,8,25.0%,17m
10099,3,AdmiralShato,3318,0,0,1,1,0.0%,28m
10111,3,Dante,3317,1657,131,106,237,55.3%,2m
10111,3,Neoplasm,3317,1524,126,117,243,51.9%,8m
10111,3,Shulam,3317,512,34,28,62,54.8%,19m
10111,2,Trener,3317,785,33,39,72,45.8%,12m
10111,3,IIIIIIIIIIII,3317,732,32,26,58,55.2%,13m
10111,3,Silan,3317,252,9,7,16,56.2%,6m
10111,3,[Brexit]MightySheep,3317,161,8,3,11,72.7%,27m
10111,3,KINGKONG,3317,176,6,10,16,37.5%,11m
10111,3,MiniNinja,3317,178,6,11,17,35.3%,15m
10111,3,Warpmaster,3317,160,6,14,20,30.0%,19m
10111,3,[биотех]hfafoq,3317,171,5,4,9,55.6%,14m
10111,3,[GooDS]Freeskillz,3317,118,5,5,10,50.0%,8m
10111,3,PWFD,3317,58,3,2,5,60.0%,6m
10111,3,[SVRO]AirBlaze,3317,30,2,0,2,100.0%,15m
10111,3,Twigness,3317,30,1,2,3,33.3%,4m
10126,3,MarcoNeri,3316,1547,612,602,1214,50.4%,27m
10126,3,besik,3316,1647,201,187,388,51.8%,16m
10126,3,Bahiyaa,3316,595,42,49,91,46.2%,5m
10126,3,yuyules,3316,579,22,23,45,48.9%,17m
10126,3,SimpleJack,3316,556,21,18,39,53.8%,28m
10126,3,[CrøkeT]ElClebard,3316,437,17,14,31,54.8%,17m
10126,3,[Split]Rhidar,3316,210,7,13,20,35.0%,11m
10126,2,ReverendPete,3316,95,2,0,2,100.0%,53m
10126,3,Nicomonv,3316,58,2,1,3,66.7%,11m
10126,3,TheStarik,3316,30,1,1,2,50.0%,26m
10126,3,Popa,3316,30,1,3,4,25.0%,19m
10126,3,[rus54]FSpell,3316,0,0,1,1,0.0%,6m
10126,3,WheresMyCar,3316,0,0,1,1,0.0%,5m
10139,3,Peatsy,3315,1648,224,228,452,49.6%,2m
10139,3,[ClDlN]TotalBWord,3315,1555,214,200,414,51.7%,3m
10139,3,meeshu,3315,1639,102,88,190,53.7%,17m
10139,3,EnerVation,3315,1077,51,50,101,50.5%,27m
10139,3,SmellySocks,3315,708,29,24,53,54.7%,28m
10139,3,KIRINLEMON,3315,519,27,26,53,50.9%,3m
10139,3,[ezpz]Erdbeerblau,3315,531,19,19,38,50.0%,8m
10139,3,[RedFmm]Артем,3315,312,12,2,14,85.7%,6m
10139,3,tecasse,3315,336,12,22,34,35.3%,9m
10139,1,Cariboo,3315,343,11,8,19,57.9%,19m
10139,3,[MxP]Bobo,3315,114,8,4,12,66.7%,11m
10139,3,Furionix,3315,202,7,11,18,38.9%,28m
10139,3,[GÖNN]FrozenBlade,3315,55,3,11,14,21.4%,3m
10139,3,NoLajf,3315,30,2,6,8,25.0%,17m
10139,3,Somandr,3315,0,1,0,1,100.0%,11m
10139,3,[SotR]DJPicture,3315,30,1,3,4,25.0%,16m
10139,3,[10AM]Togglet,3315,0,0,1,1,0.0%,11m
10139,3,thomas,3315,0,0,1,1,0.0%,8m
10157,3,[DbH]Ezacki,3314,934,187,186,373,50.1%,4m
10157,2,IIIIIIIII,3314,1236,111,100,211,52.6%,28m
10157,3,Maykr,3314,1303,56,47,103,54.4%,4m
10157,2,[SSGs]GIJoe,3314,555,44,54,98,44.9%,9m
10157,3,[TAW]MarsBar,3314,340,11,7,18,61.1%,27m
10157,2,Jorge,3314,322,11,26,37,29.7%,17m
10157,1,Joshua,3314,118,6,2,8,75.0%,13m
10157,3,Igor,3314,0,5,0,5,100.0%,16m
10157,3,carl,3314,140,5,4,9,55.6%,17m
10157,3,bronko,3314,0,2,3,5,40.0%,10m
10157,3,Shakira,3314,0,1,0,1,100.0%,6m
10157,3,[FET]sprawl,3314,0,1,4,5,20.0%,26m
10157,3,Antiga,3314,0,0,1,1,0.0%,18m
10157,3,[SRC]Sodalv,3314,0,0,1,1,0.0%,9m
10157,1,[ЕМPIRE]Червяк,3314,0,0,1,1,0.0%,12m
10157,3,Wolverine,3314,0,0,2,2,0.0%,28m
10157,3,[EESC]TRiNiGhT,3314,0,0,2,2,0.0%,6m
10157,3,classic,3314,0,0,2,2,0.0%,2m
10175,2,[2P2a]Yokonisos,3313,698,137,139,276,49.6%,27m
10175,3,Gadac,3313,1333,66,47,113,58.4%,4m
10175,3,Norman,3313,623,62,57,119,52.1%,12m
10175,3,Dlrn,3313,1078,42,37,79,53.2%,19m
10175,3,Hardfreaq,3313,395,40,39,79,50.6%,9m
10175,3,edea,3313,630,25,21,46,54.3%,3m
10175,3,LordAngel,3313,475,21,13,34,61.8%,16m
10175,3,Runtime,3313,269,13,7,20,65.0%,28m
10175,3,Montagnik,3313,329,11,11,22,50.0%,2m
10175,3,[AotG]Raknor,3313,272,10,8,18,55.6%,6m
10175,3,Yemzmey,3313,244,8,7,15,53.3%,3m
10175,3,TIME,3313,118,8,7,15,53.3%,17m
10175,3,BKB,3313,220,8,11,19,42.1%,3m
10175,3,FatherDrift,3313,118,5,4,9,55.6%,13m
10175,3,SubMarine,3313,86,3,2,5,60.0%,10m
10175,3,Scarecrow,3313,58,3,3,6,50.0%,9m
10175,3,KamilDab,3313,58,2,1,3,66.7%,6m
10175,3,lllllll,3313,0,1,0,1,100.0%,19m
10175,3,[flyrev]flyrev,3313,0,1,0,1,100.0%,6m
10175,3,ArkGrendl,3313,0,1,0,1,100.0%,5m
10175,3,yety,3313,30,1,1,2,50.0%,11m
10175,3,[Æofa]DocGreeen,3313,0,0,5,5,0.0%,27m
10197,3,badeend,3312,1541,89,87,176,50.6%,5m
10197,3,Lazar,3312,903,76,59,135,56.3%,13m
10197,3,[DLM12]Belardo,3312,498,69,56,125,55.2%,11m
10197,3,Jmus,3312,247,28,23,51,54.9%,5m
10197,3,Derzail,3312,601,25,18,43,58.1%,26m
10197,3,Achilles,3312,618,23,23,46,50.0%,9m
10197,3,HappyMaumau,3312,454,18,8,26,69.2%,15m
10197,3,Krypto,3312,389,17,17,34,50.0%,5m
10197,3,[AiRǂ]Warf,3312,454,16,17,33,48.5%,14m
10197,3,SlannoW,3312,116,8,3,11,72.7%,16m
10197,3,[Pwnz]CleptoMarcus,3312,30,2,0,2,100.0%,10m
10197,3,DarkFox,3312,0,1,1,2,50.0%,29m
10197,3,PROMETHEUS,3312,30,1,3,4,25.0%,2m
10197,3,Echnalest,3312,0,0,1,1,0.0%,6m
10197,3,Ryuk,3312,0,0,1,1,0.0%,6m
10212,3,Rochehouse,3311,961,43,46,89,48.3%,13m
10212,3,[DaKi]AnduR,3311,658,25,21,46,54.3%,1m
10212,3,epicvoid,3311,375,16,7,23,69.6%,13m
10212,3,[TOPZIK]Kinson,3311,420,15,12,27,55.6%,28m
10212,3,[TиCo]Shashlichok,3311,286,12,10,22,54.5%,3m
10212,3,[HERP]tHeReaveR,3311,242,10,4,14,71.4%,16m
10212,3,[PLA]guns,3311,208,7,3,10,70.0%,3m
10212,2,Cbra,3311,164,5,5,10,50.0%,9m
10212,3,[DМG]Hades,3311,122,5,6,11,45.5%,26m
10212,3,Smile,3311,86,3,2,5,60.0%,5m
10212,2,Nemesis,3311,0,1,0,1,100.0%,52m
10212,3,[T0WEL]Rdrums,3311,0,0,1,1,0.0%,10m
10212,3,GAMBIT,3311,0,0,3,3,0.0%,9m
10225,3,[InitRu]SlavianKirov,3310,824,293,256,549,53.4%,2m
10225,3,Reiner,3310,1166,96,77,173,55.5%,9m
10225,3,Kromli,3310,1636,80,73,153,52.3%,29m
10225,3,traoger,3310,1322,78,70,148,52.7%,29m
10225,3,DirtyBadgers,3310,834,36,44,80,45.0%,3m
10225,3,[aW]swardnight,3310,816,34,31,65,52.3%,27m
10225,3,vologdAlarma,3310,263,32,14,46,69.6%,2m
10225,3,Anzu,3310,328,13,16,29,44.8%,26m
10225,3,Jarruraita,3310,244,9,10,19,47.4%,16m
10225,3,Trauma,3310,174,7,8,15,46.7%,17m
10225,2,[BIacer]DLD,3310,0,4,1,5,80.0%,1h
10225,3,[Keion]AlbrEinstein,3310,119,3,1,4,75.0%,8m
10225,3,Like,3310,60,3,1,4,75.0%,10m
10225,3,xprtN,3310,0,2,3,5,40.0%,18m
10225,3,[tRATM]ElmatolM,3310,30,2,4,6,33.3%,11m
10225,3,[НС]Надзиратель,3310,0,1,0,1,100.0%,1m
10225,3,Leona,3310,0,0,1,1,0.0%,2m
10225,3,[mTx]Zeux,3310,0,0,2,2,0.0%,10m
10225,2,[Fanta4]Lavundi,3310,0,0,5,5,0.0%,19m
10244,3,spacemarine,3309,1476,112,92,204,54.9%,4m
10244,3,koka,3309,1226,51,39,90,56.7%,4m
10244,3,[TheLH]BurtMacklin,3309,574,46,36,82,56.1%,17m
10244,3,TheOne,3309,724,44,23,67,65.7%,28m
10244,3,IIIIIIIIIIII,3309,817,39,29,68,57.4%,16m
10244,3,TwinkleShītz,3309,733,34,18,52,65.4%,5m
10244,3,Aporkeo,3309,781,33,22,55,60.0%,28m
10244,3,Omen,3309,427,18,13,31,58.1%,1m
10244,3,SkY,3309,434,16,19,35,45.7%,28m
10244,3,WoletarHeri,3309,343,13,6,19,68.4%,16m
10244,3,Jadduggar,3309,244,9,10,19,47.4%,5m
10244,3,[THRLLA]Cookeie,3309,60,6,2,8,75.0%,28m
10244,1,shadowlight,3309,113,3,0,3,100.0%,5m
10244,2,[IPARTY]RageKit,3309,0,2,3,5,40.0%,15m
10244,3,kev,3309,0,1,0,1,100.0%,27m
10244,3,Arcada,3309,30,1,1,2,50.0%,5m
10244,3,rumokay,3309,0,0,1,1,0.0%,6m
10261,3,[IIMMII]Doktora,3308,1379,176,148,324,54.3%,17m
10261,3,AlexNeumann,3308,1587,153,141,294,52.0%,15m
10261,3,Lalilulelo,3308,773,130,105,235,55.3%,4m
10261,2,Ravenclaw,3308,437,92,98,190,48.4%,28m
10261,3,Därklight,3308,1450,81,73,154,52.6%,17m
10261,3,GreenT,3308,1290,59,51,110,53.6%,28m
10261,3,Ghuust,3308,1362,51,52,103,49.5%,3m
10261,3,Taipan,3308,747,29,22,51,56.9%,9m
10261,3,Skrippel,3308,314,13,6,19,68.4%,28m
10261,3,martinevans,3308,352,13,9,22,59.1%,16m
10261,3,[xRaS]BrokenDreams,3308,304,11,17,28,39.3%,14m
10261,3,[KCoLoK]RoMaNoR,3308,129,9,9,18,50.0%,4m
10261,3,LukeSc,3308,95,5,1,6,83.3%,7m
10261,3,SMRTZEBRA,3308,0,5,2,7,71.4%,11m
10261,3,[DeTime]Alfakvark,3308,144,5,11,16,31.2%,13m
10261,2,Eraze,3308,0,4,1,5,80.0%,46m
10261,3,ObiSidious,3308,30,2,0,2,100.0%,26m
10261,3,[НТТ]SwitcheR,3308,0,1,1,2,50.0%,6m
10261,3,SCVReady,3308,0,0,1,1,0.0%,15m
10261,3,[FxL]montecapute,3308,0,0,6,6,0.0%,6m
10281,2,[Prima]CIAPSYOP,3307,531,116,122,238,48.7%,8m
10281,2,eme,3307,1465,114,120,234,48.7%,16m
10281,3,[RSOF1]LSBOSSES,3307,896,67,59,126,53.2%,13m
10281,3,[veVov]eVo,3307,1138,52,49,101,51.5%,9m
10281,3,[MƇƆ]Waydru,3307,1074,37,46,83,44.6%,10m
10281,3,KEYARIN,3307,246,9,10,19,47.4%,17m
10281,2,MAJ,3307,96,5,1,6,83.3%,7m
10281,3,[Zguege]Quentinous,3307,30,2,0,2,100.0%,28m
10281,3,edii,3307,0,0,1,1,0.0%,5m
10290,3,CEO,3306,1444,99,89,188,52.7%,6m
10290,3,[Hambbe]chrigi,3306,977,58,58,116,50.0%,11m
10290,3,MozGi,3306,1227,47,46,93,50.5%,11m
10290,3,MagicOwl,3306,515,38,44,82,46.3%,28m
10290,3,EUPHORiA,3306,732,31,24,55,56.4%,8m
10290,3,[NaCl6]BBB,3306,295,11,3,14,78.6%,13m
10290,3,[UAŦeam]KAPRANN,3306,344,11,22,33,33.3%,3m
10290,3,[CxCx]GasDrinker,3306,202,8,9,17,47.1%,2m
10290,3,JosRox,3306,118,4,6,10,40.0%,2m
10290,2,[TonT0n]Tonstor,3306,127,2,3,5,40.0%,13m
10290,3,Stonemarine,3306,25,2,5,7,28.6%,9m
10290,3,InfinityRnD,3306,60,2,6,8,25.0%,14m
10290,3,MrHöcker,3306,60,2,7,9,22.2%,19m
10290,3,[KDV]magNETar,3306,0,1,0,1,100.0%,3m
10290,1,OldYoghurt,3306,0,1,0,1,100.0%,1h
10290,3,Leor,3306,30,1,6,7,14.3%,6m
10290,3,[NVY]MiserySignal,3306,0,0,1,1,0.0%,17m
10307,3,RcadeR,3305,1363,88,74,162,54.3%,12m
10307,3,OncleFreddy,3305,854,33,31,64,51.6%,14m
10307,2,GreenWii,3305,732,26,43,69,37.7%,3m
10307,3,KKKKKK,3305,324,13,10,23,56.5%,7m
10307,3,Proberto,3305,214,9,9,18,50.0%,13m
10307,3,Lucky,3305,119,6,3,9,66.7%,6m
10307,3,deesKus,3305,60,3,3,6,50.0%,12m
10307,3,Jolian,3305,58,2,3,5,40.0%,17m
10307,3,[BRSKR]Paprika,3305,30,2,3,5,40.0%,13m
10307,3,iRush,3305,0,1,0,1,100.0%,8m
10307,3,Dantes,3305,30,1,1,2,50.0%,3m
10307,3,[pTa]ShiQuRas,3305,0,1,2,3,33.3%,26m
10307,3,Hakeli,3305,0,0,1,1,0.0%,27m
10307,3,[AiRǂ]Stermineator,3305,0,0,2,2,0.0%,4m
10321,3,Lamzak,3304,1579,109,108,217,50.2%,6m
10321,3,afendi,3304,1540,74,63,137,54.0%,6m
10321,3,llllllllllll,3304,722,50,43,93,53.8%,28m
10321,3,TheKoner,3304,410,38,27,65,58.5%,6m
10321,3,Marinauder,3304,560,38,41,79,48.1%,5m
10321,3,[GoldM]bangu,3304,439,32,25,57,56.1%,9m
10321,3,MyBanana,3304,654,23,28,51,45.1%,26m
10321,3,EllenPage,3304,357,12,14,26,46.2%,17m
10321,3,Virou,3304,0,5,2,7,71.4%,6m
10321,3,[OoE]Virus,3304,116,5,4,9,55.6%,6m
10321,3,Hello,3304,0,4,1,5,80.0%,2m
10321,3,Ice,3304,30,1,2,3,33.3%,10m
10333,3,Tomaszur,3303,1522,276,273,549,50.3%,6m
10333,3,Leming,3303,1325,161,163,324,49.7%,17m
10333,3,Proximus,3303,1533,136,125,261,52.1%,7m
10333,2,Kerouac,3303,1465,131,121,252,52.0%,10m
10333,3,[GdAT]PoulyCroC,3303,1457,105,99,204,51.5%,19m
10333,3,Melenya,3303,1561,86,84,170,50.6%,4m
10333,2,SneakyFish,3303,737,32,36,68,47.1%,30m
10333,3,eThnA,3303,864,32,37,69,46.4%,28m
10333,3,[ENQ]Yarxxxnov,3303,700,27,21,48,56.2%,16m
10333,3,[Moisty]Ilyen,3303,516,19,21,40,47.5%,5m
10333,3,Jubear,3303,433,16,12,28,57.1%,17m
10333,3,Маэрс,3303,274,10,14,24,41.7%,4m
10333,3,saandro,3303,262,9,11,20,45.0%,27m
10333,3,[IN]Vanyali,3303,198,8,4,12,66.7%,10m
10333,3,Alien,3303,209,7,0,7,100.0%,28m
10333,3,[GGxC]TheGREYBUSH,3303,86,3,3,6,50.0%,8m
10333,3,Lutz,3303,58,2,2,4,50.0%,28m
10333,3,[NL]DeadKid,3303,0,1,0,1,100.0%,4m
10333,3,[Fen]Mewtwo,3303,0,1,0,1,100.0%,3m
10333,3,[ǂǂǂǂǂ]Ustavson,3303,0,1,1,2,50.0%,26m
10333,3,Utherbrown,3303,0,0,1,1,0.0%,5m
10333,3,Ætheling,3303,0,0,1,1,0.0%,10m
10333,3,[войны]LifeForAiur,3303,0,0,1,1,0.0%,6m
10356,3,TotalNSG,3302,686,28,23,51,54.9%,16m
10356,3,whatt,3302,401,26,22,48,54.2%,6m
10356,3,[AjA]Chaga,3302,533,19,15,34,55.9%,5m
10356,3,RobertDindon,3302,454,17,14,31,54.8%,11m
10356,3,LngsTasteBad,3302,58,6,3,9,66.7%,14m
10356,3,[EBEMZ]WarFare,3302,92,3,7,10,30.0%,3m
10356,3,GreenHerb,3302,90,3,7,10,30.0%,27m
10356,3,Ben,3302,0,0,1,1,0.0%,6m
10356,3,[SBrø]Nukes,3302,0,0,1,1,0.0%,16m
10356,3,MindStorm,3302,0,0,2,2,0.0%,13m
10366,3,AzoG,3301,847,71,74,145,49.0%,13m
10366,3,CrazyBanana,3301,1246,69,50,119,58.0%,6m
10366,3,Keshikten,3301,170,25,25,50,50.0%,5m
10366,2,ForAdun,3301,262,12,6,18,66.7%,8m
10366,3,JustusBumm,3301,228,8,11,19,42.1%,3m
10366,3,IsifLiferu,3301,143,7,3,10,70.0%,28m
10366,3,LifesAviOr,3301,186,7,8,15,46.7%,13m
10366,3,[TGosuB]SandKrab,3301,95,5,1,6,83.3%,8m
10366,3,Lucky,3301,58,3,0,3,100.0%,18m
10366,3,[EAU]KICKI,3301,0,1,0,1,100.0%,2m
10366,3,[МуDТ]Пятка,3301,30,1,1,2,50.0%,7m
10366,3,Kristall,3301,38,1,7,8,12.5%,4m
10378,3,Cornhulio,3300,1613,225,218,443,50.8%,3m
10378,3,[ТКД]glotkar,3300,1142,95,93,188,50.5%,5m
10378,3,Celestial,3300,1590,80,73,153,52.3%,19m
10378,3,ilikebananas,3300,769,56,47,103,54.4%,28m
10378,3,arno,3300,1117,48,41,89,53.9%,27m
10378,3,LeMaître,3300,494,24,8,32,75.0%,6m
10378,3,ronna,3300,362,24,10,34,70.6%,2m
10378,3,[Dralag]Archangel,3300,518,21,15,36,58.3%,28m
10378,3,Crabich,3300,206,7,0,7,100.0%,28m
10378,3,[PiTi]Анунаки,3300,166,6,3,9,66.7%,19m
10378,3,Nerox,3300,59,4,0,4,100.0%,6m
10378,3,CanisMinoris,3300,92,4,9,13,30.8%,2m
10378,1,[MSUSC2]eferalgan,3300,0,1,1,2,50.0%,1h
10378,3,Alarak,3300,0,0,1,1,0.0%,16m
10378,3,ChromeSteed,3300,0,0,1,1,0.0%,28m
10393,2,Dchocobo,3299,1592,196,190,386,50.8%,13m
10393,3,BigoteGordo,3299,1243,122,97,219,55.7%,2m
10393,3,LilleJohan,3299,1092,38,45,83,45.8%,4m
10393,3,LDMA,3299,864,34,34,68,50.0%,29m
10393,3,BPog,3299,577,33,37,70,47.1%,17m
10393,3,[PHØMUI]DavidKim,3299,478,20,6,26,76.9%,10m
10393,3,[TaReFr]doudou,3299,362,16,24,40,40.0%,9m
10393,3,metric,3299,215,9,4,13,69.2%,6m
10393,3,Itachi,3299,30,5,4,9,55.6%,13m
10393,3,DeltaIII,3299,86,4,0,4,100.0%,2m
10393,3,[HBGSJR]HackErIsTop,3299,86,4,1,5,80.0%,9m
10393,3,[RSK]GantDeToilet,3299,58,3,7,10,30.0%,16m
10393,3,[M6P]FistiPanda,3299,60,2,2,4,50.0%,17m
10393,3,TheCount,3299,82,2,6,8,25.0%,10m
10393,3,Devolhan,3299,0,1,0,1,100.0%,8m
10393,3,[RBTV4]EgoGurke,3299,0,1,0,1,100.0%,2m
10393,1,mack,3299,0,1,1,2,50.0%,17m
10393,3,Insane,3299,0,0,1,1,0.0%,15m
10393,3,VAZ,3299,0,0,5,5,0.0%,6m
10393,3,DrStrudel,3299,0,0,7,7,0.0%,8m
10413,3,Kircheis,3298,1376,82,82,164,50.0%,8m
10413,3,OschZar,3298,693,45,31,76,59.2%,27m
10413,3,[DEDAL]darxx,3298,678,32,20,52,61.5%,16m
10413,3,[SanD]ewK,3298,633,27,14,41,65.9%,16m
10413,3,Eshko,3298,444,17,10,27,63.0%,10m
10413,3,Kvanton,3298,260,10,15,25,40.0%,28m
10413,3,[RstE]Shla,3298,198,9,5,14,64.3%,16m
10413,3,groTesk,3298,262,9,9,18,50.0%,16m
10413,3,ElCucuy,3298,146,5,9,14,35.7%,3m
10413,3,bArs,3298,0,4,1,5,80.0%,18m
10413,2,Afflictiónz,3298,0,3,0,3,100.0%,9m
10413,2,[H4P]green,3298,139,3,8,11,27.3%,8m
10413,3,[QTclub]DanieLionx,3298,30,2,1,3,66.7%,6m
10413,3,Saitoh,3298,0,1,0,1,100.0%,15m
10413,3,[GdAT]Vavin,3298,0,1,0,1,100.0%,9m
10413,3,[JEBLA]kikondo,3298,0,1,0,1,100.0%,4m
10413,3,SpatialAgent,3298,0,0,1,1,0.0%,11m
10413,3,Tiriath,3298,0,0,1,1,0.0%,2m
10413,1,[LaPack]DDOG,3298,0,0,1,1,0.0%,1h
10413,3,[GRK]ragequitinc,3298,0,0,1,1,0.0%,8m
10413,3,skrytyżubr,3298,0,0,2,2,0.0%,5m
10434,3,[DNeN]iMBaCKBrO,3297,1004,86,79,165,52.1%,12m
10434,3,[NxLG]Bladerunner,3297,1400,79,69,148,53.4%,29m
10434,3,Plantax,3297,1032,40,38,78,51.3%,9m
10434,3,avilive,3297,618,29,16,45,64.4%,2m
10434,3,Sokrut,3297,726,26,30,56,46.4%,14m
10434,3,[VFN]Helios,3297,380,14,12,26,53.8%,19m
10434,3,[KFS55]PferdeFreund,3297,329,13,2,15,86.7%,16m
10434,3,KrOmp,3297,118,9,6,15,60.0%,13m
10434,3,[Amigos]jamppa,3297,258,9,11,20,45.0%,28m
10434,2,Tmato,3297,96,6,0,6,100.0%,49m
10434,3,Nsya,3297,60,2,3,5,40.0%,13m
10434,3,LeBy,3297,0,1,2,3,33.3%,11m
10434,3,RADIANCE,3297,30,1,3,4,25.0%,18m
10434,3,noob,3297,0,0,1,1,0.0%,7m
10434,3,SfmLP,3297,0,0,3,3,0.0%,17m
10449,3,RechnovSS,3296,803,38,49,87,43.7%,9m
10449,3,Noxa,3296,484,19,16,35,54.3%,11m
10449,3,nugget,3296,114,9,5,14,64.3%,4m
10449,3,LichKing,3296,92,4,5,9,44.4%,27m
10449,3,Brisecul,3296,30,2,2,4,50.0%,11m
10449,3,[Ahegаo]Frakish,3296,60,2,2,4,50.0%,13m
10449,3,Sol,3296,0,1,0,1,100.0%,4m
10449,3,[FlFi]Nereon,3296,30,1,3,4,25.0%,3m
10449,3,Looper,3296,94,1,3,4,25.0%,16m
10458,3,Ouky,3295,1576,328,333,661,49.6%,13m
10458,3,[D0WN]Jnk,3295,1566,102,104,206,49.5%,2m
10458,3,WetWet,3295,1209,56,33,89,62.9%,3m
10458,3,Demiurg,3295,837,32,26,58,55.2%,16m
10458,3,phlipzter,3295,702,28,27,55,50.9%,4m
10458,3,IIIIIIIIIIII,3295,163,16,13,29,55.2%,14m
10458,3,ZergiuS,3295,410,15,17,32,46.9%,17m
10458,3,Homny,3295,226,9,9,18,50.0%,8m
10458,3,stiligmatic,3295,0,4,1,5,80.0%,2m
10458,2,lollol,3295,0,4,1,5,80.0%,1h
10458,3,[Bambi2]TheAZ,3295,85,3,1,4,75.0%,12m
10458,2,Sparkman,3295,119,3,2,5,60.0%,1h
10458,1,TossBoy,3295,0,1,0,1,100.0%,6m
10471,3,DivineDust,3294,1572,175,153,328,53.4%,16m
10471,3,eco,3294,1422,149,150,299,49.8%,8m
10471,3,Zhivago,3294,814,84,81,165,50.9%,11m
10471,3,[SC5]Kapiibarchik,3294,1023,45,48,93,48.4%,2m
10471,3,GakTakLakPak,3294,781,35,18,53,66.0%,18m
10471,3,[NWGD]LЁva,3294,548,33,21,54,61.1%,7m
10471,3,Lakt,3294,179,17,18,35,48.6%,6m
10471,3,WhiteStone,3294,277,9,8,17,52.9%,8m
10471,3,Demetr,3294,182,8,4,12,66.7%,16m
10471,3,dio,3294,88,4,4,8,50.0%,7m
10471,3,KellogZ,3294,30,1,2,3,33.3%,15m
10471,3,[OtES]cronos,3294,30,1,8,9,11.1%,18m
10471,3,Gazorpazorp,3294,0,0,1,1,0.0%,6m
10484,3,[GSRbe]Tenebris,3293,1380,136,132,268,50.7%,26m
10484,3,Batman,3293,1628,113,107,220,51.4%,13m
10484,3,SgtHeatman,3293,1632,111,93,204,54.4%,5m
10484,3,Анастасия,3293,1499,90,59,149,60.4%,1m
10484,3,Warmedinger,3293,643,86,73,159,54.1%,9m
10484,3,MadaK,3293,746,33,24,57,57.9%,11m
10484,3,DiCaprio,3293,701,28,24,52,53.8%,10m
10484,3,Luru,3293,534,26,11,37,70.3%,1m
10484,3,DenVerDOG,3293,730,26,35,61,42.6%,27m
10484,3,Reminguk,3293,505,21,25,46,45.7%,27m
10484,2,BlAckImPAcT,3293,540,19,32,51,37.3%,9m
10484,3,Dawg,3293,398,17,10,27,63.0%,3m
10484,3,BlackBread,3293,250,10,5,15,66.7%,2m
10484,3,Mixalich,3293,193,10,8,18,55.6%,28m
10484,3,Awesomic,3293,278,10,11,21,47.6%,12m
10484,3,SchurupIK,3293,192,8,3,11,72.7%,10m
10484,3,INnoVation,3293,141,7,2,9,77.8%,18m
10484,3,[TиCo]RedDotOnMap,3293,210,7,15,22,31.8%,3m
10484,1,Echolon,3293,118,6,2,8,75.0%,57m
10484,3,Czarny,3293,30,1,3,4,25.0%,28m
10484,3,[75рус]Patriot,3293,0,1,3,4,25.0%,13m
10484,3,Soothsayer,3293,0,0,1,1,0.0%,28m
10506,3,Arumakaneilk,3292,1594,286,277,563,50.8%,7m
10506,2,[Rylst]Jolly,3292,1562,198,187,385,51.4%,6m
10506,3,DassemUltor,3292,1014,106,112,218,48.6%,6m
10506,3,FateZero,3292,1348,71,73,144,49.3%,7m
10506,2,IIGrasiekII,3292,641,24,37,61,39.3%,7m
10506,3,Evangelion,3292,502,19,20,39,48.7%,4m
10506,3,demo,3292,299,16,18,34,47.1%,26m
10506,3,Artjis,3292,324,12,14,26,46.2%,3m
10506,3,Terratosozer,3292,198,10,5,15,66.7%,16m
10506,3,Peaceoute,3292,179,8,12,20,40.0%,3m
10506,1,ErzaScarlet,3292,162,7,4,11,63.6%,14m
10506,3,Lucrex,3292,174,6,6,12,50.0%,8m
10506,2,llllllllllll,3292,0,4,1,5,80.0%,1h
10506,3,premiere,3292,0,4,1,5,80.0%,6m
10506,3,cLerIck,3292,0,0,1,1,0.0%,5m
10506,3,MoJo,3292,0,0,11,11,0.0%,19m
10522,3,kambina,3291,1465,146,146,292,50.0%,28m
10522,2,Gubbins,3291,1294,132,132,264,50.0%,12m
10522,2,[BRSKR]PRIME,3291,1402,107,104,211,50.7%,9m
10522,2,[TMGM]Shadow,3291,699,48,60,108,44.4%,7m
10522,3,Poramag,3291,872,33,38,71,46.5%,3m
10522,3,Alo,3291,443,20,8,28,71.4%,15m
10522,3,[Cracot]DavidLafarge,3291,328,11,16,27,40.7%,26m
10522,3,[RBP3]hugoagogo,3291,174,8,4,12,66.7%,9m
10522,3,Ian,3291,215,7,4,11,63.6%,6m
10522,3,JungleFever,3291,192,7,19,26,26.9%,4m
10522,3,[NCPL]Kulca,3291,142,5,4,9,55.6%,7m
10522,3,Closeeder,3291,86,4,2,6,66.7%,29m
10522,3,Toquinho,3291,60,3,2,5,60.0%,7m
10522,3,[TeamPP]HoneyBadger,3291,30,2,4,6,33.3%,19m
10522,1,SneakyTurtle,3291,0,2,4,6,33.3%,45m
10522,2,[QTcIub]SaltyAF,3291,42,1,4,5,20.0%,3m
10522,3,NeVgUp,3291,0,0,1,1,0.0%,5m
10522,2,silas,3291,0,0,1,1,0.0%,51m
10522,3,Tamplier,3291,0,0,2,2,0.0%,18m
10541,2,[2RK]IIIIIIIIIIII,3290,1528,167,170,337,49.6%,29m
10541,3,[IceHus]vovque,3290,1153,97,84,181,53.6%,9m
10541,3,[dinmor]manbearpigDK,3290,1366,71,62,133,53.4%,7m
10541,3,[R4p3Rs]HESKEY,3290,781,33,29,62,53.2%,12m
10541,3,Cidragon,3290,572,24,11,35,68.6%,11m
10541,3,[MaNe]SoonANext,3290,389,14,9,23,60.9%,17m
10541,3,Echizen,3290,114,4,2,6,66.7%,10m
10541,3,astra,3290,55,3,1,4,75.0%,4m
10541,2,Пипирка,3290,96,2,0,2,100.0%,10m
10541,3,[FtWm]Cowca,3290,30,2,1,3,66.7%,4m
10541,3,LiptonMobile,3290,30,2,8,10,20.0%,2m
10541,3,Xtse,3290,0,1,0,1,100.0%,6m
10541,3,XRippleX,3290,0,1,0,1,100.0%,3m
10541,3,[ZBL]Diablotyn,3290,0,0,2,2,0.0%,2m
10541,3,Gorgutz,3290,0,0,2,2,0.0%,18m
10556,3,Cosbibi,3289,1533,399,392,791,50.4%,9m
10556,3,MASCHINE,3289,1577,185,182,367,50.4%,13m
10556,3,Scud,3289,1586,183,162,345,53.0%,14m
10556,3,[SoLw]Tredishion,3289,1303,75,68,143,52.4%,16m
10556,3,Bachor,3289,1608,69,58,127,54.3%,8m
10556,3,Keziah,3289,1300,69,58,127,54.3%,6m
10556,3,CaAndaR,3289,1156,60,52,112,53.6%,13m
10556,3,mainman,3289,745,59,61,120,49.2%,2m
10556,3,Smekereven,3289,467,34,24,58,58.6%,19m
10556,3,[OXF]Richielol,3289,275,10,3,13,76.9%,12m
10556,2,LuLu,3289,96,6,0,6,100.0%,1h
10556,3,Шнырь,3289,31,4,10,14,28.6%,11m
10556,3,iceman,3289,58,3,2,5,60.0%,17m
10556,3,DBko,3289,30,2,0,2,100.0%,29m
10556,3,Stiegl,3289,30,1,2,3,33.3%,6m
10556,3,veteris,3289,0,1,4,5,20.0%,28m
10556,3,Sako,3289,30,1,5,6,16.7%,2m
10556,3,[N0LIF3]ruzovej,3289,0,0,1,1,0.0%,18m
10556,3,[GGPD]GGEasY,3289,0,0,3,3,0.0%,7m
10575,3,yij,3288,1407,190,192,382,49.7%,2m
10575,2,Xean,3288,407,177,171,348,50.9%,16m
10575,3,GhostKing,3288,1230,173,158,331,52.3%,4m
10575,3,[Сold]MaxCatarsky,3288,1568,129,129,258,50.0%,28m
10575,3,Negod,3288,1592,121,106,227,53.3%,29m
10575,3,SWAT,3288,654,120,110,230,52.2%,7m
10575,3,Badger,3288,1588,101,92,193,52.3%,7m
10575,3,Pagu,3288,1660,90,91,181,49.7%,16m
10575,3,Zorgling,3288,877,70,65,135,51.9%,8m
10575,3,[EcLanP]BlAcKRaPtOr,3288,1092,62,38,100,62.0%,28m
10575,3,Bobby,3288,819,34,28,62,54.8%,4m
10575,3,[HZeS]VeTerran,3288,576,25,9,34,73.5%,3m
10575,3,Divl,3288,323,15,10,25,60.0%,2m
10575,1,Derico,3288,365,13,7,20,65.0%,9m
10575,3,MiniAtonwint,3288,248,13,9,22,59.1%,11m
10575,3,BARCODE,3288,175,8,3,11,72.7%,27m
10575,3,[FIXi]Папус,3288,117,7,0,7,100.0%,17m
10575,3,sterne,3288,144,5,11,16,31.2%,2m
10575,3,[pBNRq]MasterSuprem,3288,120,5,12,17,29.4%,8m
10575,3,ProstoCHLEN,3288,90,4,4,8,50.0%,6m
10575,3,[CocoCo]BlackHawk,3288,86,3,1,4,75.0%,11m
10575,3,PaulBabbo,3288,86,3,1,4,75.0%,16m
10575,3,Mental,3288,60,2,6,8,25.0%,3m
10575,3,MrMineCrow,3288,60,2,9,11,18.2%,4m
10575,3,NoOne,3288,0,1,0,1,100.0%,8m
10575,3,CapitanZH,3288,0,0,1,1,0.0%,28m
10575,3,benny,3288,0,0,4,4,0.0%,2m
10602,3,[SPAINs]Romu,3287,1609,148,133,281,52.7%,16m
10602,3,LapdFutureCP,3287,1596,87,81,168,51.8%,7m
10602,3,piotrek,3287,1224,70,53,123,56.9%,8m
10602,3,[OРДА]Gerikgood,3287,1542,66,66,132,50.0%,4m
10602,3,LuLu,3287,1202,60,60,120,50.0%,19m
10602,3,Cobaneros,3287,811,58,52,110,52.7%,17m
10602,3,[ШИЗЫ]YokoLit,3287,983,48,41,89,53.9%,13m
10602,3,shogun,3287,297,18,17,35,51.4%,2m
10602,3,LeGazou,3287,288,13,8,21,61.9%,5m
10602,3,Neon,3287,187,7,5,12,58.3%,16m
10602,3,CoachGerbers,3287,198,7,7,14,50.0%,6m
10602,3,Lobos,3287,0,5,1,6,83.3%,5m
10602,3,XTERRANX,3287,117,5,5,10,50.0%,28m
10602,3,Azaghal,3287,122,5,6,11,45.5%,9m
10602,3,BAbu,3287,158,5,12,17,29.4%,2m
10602,3,tbpss,3287,116,5,12,17,29.4%,11m
10602,3,NewPlayer,3287,55,3,1,4,75.0%,28m
10602,1,Jaesung,3287,97,3,5,8,37.5%,27m
10602,3,Osghiliath,3287,58,2,3,5,40.0%,28m
10602,3,Heed,3287,0,1,0,1,100.0%,28m
10602,3,Wastalorde,3287,0,1,0,1,100.0%,13m
10602,3,[KRUTO]bakalux,3287,30,1,3,4,25.0%,2m
10624,3,Начальник,3286,1574,169,164,333,50.8%,10m
10624,3,Zibra,3286,1175,87,93,180,48.3%,5m
10624,3,[NONAMЕ]Glacier,3286,1262,81,64,145,55.9%,6m
10624,2,PiSToLeRo,3286,866,59,72,131,45.0%,18m
10624,3,[InFy]Crane,3286,610,39,43,82,47.6%,28m
10624,3,polskidimon,3286,564,36,39,75,48.0%,29m
10624,3,[FLarva]Raider,3286,542,25,23,48,52.1%,29m
10624,3,Эрик,3286,462,19,7,26,73.1%,11m
10624,3,[IDGaGa]BaKBaK,3286,472,17,15,32,53.1%,17m
10624,3,[Peeps]GFG,3286,362,12,24,36,33.3%,18m
10624,3,SASH,3286,193,9,5,14,64.3%,10m
10624,3,ArthurC,3286,60,5,4,9,55.6%,7m
10624,3,PsyCorez,3286,30,2,0,2,100.0%,2m
10624,3,[JIH]Johny,3286,0,1,0,1,100.0%,27m
10624,3,luckygirl,3286,0,0,1,1,0.0%,12m
10639,3,AHCImode,3285,1549,363,337,700,51.9%,9m
10639,3,QuiGonJay,3285,1597,353,358,711,49.6%,3m
10639,3,DuncanIdaho,3285,1577,119,123,242,49.2%,9m
10639,3,[ZVG]Hellcat,3285,1375,115,97,212,54.2%,8m
10639,3,[SmackB]ZealGoon,3285,1039,60,52,112,53.6%,16m
10639,3,Santik,3285,886,36,28,64,56.2%,7m
10639,3,Akrij,3285,615,34,23,57,59.6%,4m
10639,3,abac,3285,711,32,23,55,58.2%,5m
10639,3,HEASAGER,3285,702,30,36,66,45.5%,28m
10639,3,[Dlck]Hastings,3285,510,21,17,38,55.3%,12m
10639,3,ChaRisMa,3285,280,10,13,23,43.5%,18m
10639,3,KlOlRlElA,3285,96,4,2,6,66.7%,5m
10639,3,hilarious,3285,18,2,4,6,33.3%,27m
10639,3,[RBcom]Reavers,3285,62,2,5,7,28.6%,17m
10639,3,[Reymor]HiveFive,3285,30,1,7,8,12.5%,11m
10639,3,[BTBB]Ohmie,3285,0,0,1,1,0.0%,9m
10639,3,Delece,3285,0,0,8,8,0.0%,4m
10656,3,SiR,3284,1351,500,505,1005,49.8%,7m
10656,3,Insekt,3284,1675,110,93,203,54.2%,6m
10656,3,LaCucaracha,3284,1464,92,72,164,56.1%,11m
10656,3,ZeTToughrash,3284,1486,64,50,114,56.1%,4m
10656,3,ANGEL,3284,1191,51,40,91,56.0%,16m
10656,3,BondageChair,3284,602,27,15,42,64.3%,28m
10656,3,SteamBOT,3284,563,23,19,42,54.8%,18m
10656,3,Source,3284,217,6,3,9,66.7%,27m
10656,3,xXNoScOpeXx,3284,0,4,1,5,80.0%,5m
10656,3,[ĦĦ]droneVSprobe,3284,88,3,5,8,37.5%,27m
10656,3,ValeraLudoed,3284,0,1,0,1,100.0%,9m
10656,3,llllllllll,3284,0,1,1,2,50.0%,26m
10656,3,[GimYoD]Jakiko,3284,0,0,1,1,0.0%,8m
10669,2,GonZo,3283,1472,344,331,675,51.0%,16m
10669,3,Misho,3283,1548,194,175,369,52.6%,8m
10669,3,Trece,3283,1067,123,111,234,52.6%,8m
10669,3,[Heroes]Napolitain,3283,1582,121,119,240,50.4%,7m
10669,3,VANNESS,3283,1355,119,110,229,52.0%,19m
10669,3,Demosthenes,3283,1567,109,104,213,51.2%,14m
10669,3,Aqisiaq,3283,1519,81,74,155,52.3%,29m
10669,3,Tigerdyret,3283,1448,54,59,113,47.8%,11m
10669,3,[IPSI]Soeren,3283,611,42,43,85,49.4%,27m
10669,3,[Scred]OmarKhattab,3283,984,39,34,73,53.4%,15m
10669,2,Lutaris,3283,686,39,51,90,43.3%,9m
10669,3,Blast,3283,407,16,18,34,47.1%,4m
10669,3,Ave,3283,367,12,9,21,57.1%,4m
10669,3,Raiminho,3283,212,11,5,16,68.8%,12m
10669,3,BigOP,3283,314,11,9,20,55.0%,16m
10669,3,YourSyrup,3283,228,9,5,14,64.3%,6m
10669,3,ichyron,3283,0,2,1,3,66.7%,2m
10669,3,[NetGG]Lelouche,3283,30,1,2,3,33.3%,10m
10669,3,[4GAZ]PurpleKing,3283,44,1,5,6,16.7%,16m
10669,3,[D0N3]NephrenKa,3283,0,0,1,1,0.0%,7m
10669,3,[QMnewb]dppf,3283,0,0,1,1,0.0%,13m
10690,3,[ATC28]Bender,3282,1142,178,169,347,51.3%,13m
10690,3,Zhelmike,3282,1580,137,118,255,53.7%,19m
10690,3,Uchenikkk,3282,674,72,65,137,52.6%,12m
10690,3,JhonnyCash,3282,544,20,18,38,52.6%,13m
10690,3,Hidden,3282,271,15,22,37,40.5%,9m
10690,3,vicce,3282,146,6,8,14,42.9%,5m
10690,3,MaccasClone,3282,144,5,6,11,45.5%,6m
10690,3,RoyHarley,3282,86,4,0,4,100.0%,11m
10690,3,Tron,3282,0,4,1,5,80.0%,13m
10690,3,[PIML]McLane,3282,92,3,7,10,30.0%,19m
10690,3,[Roger]ArseniK,3282,30,2,1,3,66.7%,13m
10690,3,Palach,3282,0,1,0,1,100.0%,5m
10690,3,mick,3282,0,0,1,1,0.0%,15m
10690,3,VaeVictis,3282,0,0,1,1,0.0%,7m
10704,3,Resistance,3281,1351,185,182,367,50.4%,5m
10704,2,master,3281,600,133,126,259,51.4%,27m
10704,3,Anarion,3281,1592,88,88,176,50.0%,12m
10704,3,llllllllllll,3281,937,44,33,77,57.1%,17m
10704,3,KaLaReX,3281,522,24,8,32,75.0%,19m
10704,3,[BigML]BigML,3281,395,17,12,29,58.6%,3m
10704,3,Raynor,3281,510,17,24,41,41.5%,13m
10704,3,Draf,3281,386,16,12,28,57.1%,17m
10704,3,Dendunadan,3281,364,15,20,35,42.9%,10m
10704,2,kent,3281,249,12,8,20,60.0%,19m
10704,3,Altaires,3281,251,10,6,16,62.5%,10m
10704,3,Vazymolos,3281,148,6,7,13,46.2%,10m
10704,3,MoonLightETA,3281,86,4,3,7,57.1%,3m
10704,3,Calamar,3281,90,3,6,9,33.3%,13m
10704,3,Barak,3281,30,2,1,3,66.7%,2m
10704,1,fizzy,3281,48,2,2,4,50.0%,1h
10704,3,Skruffy,3281,30,2,5,7,28.6%,17m
10704,3,[DNKСFТ]KamelotQTGod,3281,0,1,0,1,100.0%,13m
10704,3,Covididiot,3281,0,0,1,1,0.0%,13m
10723,3,EMPEROR,3280,1295,101,79,180,56.1%,2m
10723,3,PuraPasión,3280,382,25,3,28,89.3%,6m
10723,3,Moneytalkz,3280,489,17,18,35,48.6%,19m
10723,3,ScForJesús,3280,326,11,7,18,61.1%,19m
10723,3,Interesting,3280,215,7,4,11,63.6%,28m
10723,2,NiGGo,3280,95,5,1,6,83.3%,16m
10723,3,Shentoza,3280,58,4,6,10,40.0%,9m
10723,3,[unƊeaƊ]Rici,3280,0,1,1,2,50.0%,8m
10723,3,TimGold,3280,0,1,1,2,50.0%,10m
10732,3,Hawkeye,3279,1551,107,94,201,53.2%,19m
10732,3,motorchik,3279,845,106,101,207,51.2%,16m
10732,3,[SPCs]RightProfit,3279,253,32,23,55,58.2%,2m
10732,3,[JustFF]Itarossa,3279,758,31,21,52,59.6%,16m
10732,3,Argonauta,3279,752,28,31,59,47.5%,2m
10732,3,[LBVftw]Oemann,3279,395,27,23,50,54.0%,27m
10732,3,Skolev,3279,177,19,14,33,57.6%,17m
10732,3,PacRAT,3279,310,14,10,24,58.3%,5m
10732,3,CarregaFTW,3279,150,5,8,13,38.5%,15m
10732,3,[afk247]Marineplay,3279,86,4,3,7,57.1%,9m
10732,3,ergo,3279,60,2,6,8,25.0%,19m
10732,3,dcare,3279,0,0,6,6,0.0%,28m
10744,3,[NCSR]Androide,3278,1577,154,145,299,51.5%,8m
10744,3,KitCat,3278,1499,128,128,256,50.0%,15m
10744,3,McBeatles,3278,440,45,45,90,50.0%,10m
10744,3,DaemonGinger,3278,808,32,28,60,53.3%,28m
10744,3,[Ме]Cпб,3278,424,18,11,29,62.1%,12m
10744,3,Histerik,3278,311,12,2,14,85.7%,3m
10744,3,[BMANG]TheFilth,3278,288,9,5,14,64.3%,16m
10744,3,TresPoli,3278,133,7,2,9,77.8%,5m
10744,1,[ƬC]XCOM,3278,119,6,3,9,66.7%,8m
10744,1,[Medoed]Svyat,3278,159,5,1,6,83.3%,1h
10744,3,[skyfoo]Rolleander,3278,193,5,2,7,71.4%,7m
10744,2,SunBraaker,3278,0,4,1,5,80.0%,56m
10744,3,Dima,3278,60,2,4,6,33.3%,2m
10744,3,[ябог]КожаныйМешок,3278,0,1,0,1,100.0%,29m
10744,3,Vinuel,3278,0,1,1,2,50.0%,7m
10759,3,[Norpan]vMix,3277,1549,347,362,709,48.9%,28m
10759,2,burewisnyk,3277,903,94,108,202,46.5%,29m
10759,3,BitGhost,3277,1576,75,68,143,52.4%,2m
10759,3,Scorpion,3277,698,30,21,51,58.8%,17m
10759,3,xRay,3277,532,24,9,33,72.7%,14m
10759,3,quiz,3277,476,19,7,26,73.1%,28m
10759,1,IIIIIIIIIIII,3277,306,13,10,23,56.5%,14m
10759,3,[PÄR]Koter,3277,372,13,20,33,39.4%,4m
10759,3,loveandmusic,3277,204,8,9,17,47.1%,11m
10759,3,Blackfire,3277,144,6,3,9,66.7%,3m
10759,3,Storm,3277,66,2,4,6,33.3%,13m
10759,3,DABO,3277,0,2,4,6,33.3%,12m
10759,3,FengTimo,3277,0,1,0,1,100.0%,16m
10759,3,Mode,3277,30,1,1,2,50.0%,2m
10759,3,[DoPorn]Sayux,3277,0,1,4,5,20.0%,16m
10759,3,Sniffs,3277,0,0,1,1,0.0%,17m
10759,3,OffRizer,3277,0,0,1,1,0.0%,6m
10759,3,[Котик]DragonLord,3277,0,0,2,2,0.0%,4m
10759,3,IIIIIIIIIIII,3277,0,0,5,5,0.0%,29m
10778,3,Kelrohir,3276,1328,135,118,253,53.4%,28m
10778,3,fekz,3276,311,52,45,97,53.6%,28m
10778,3,[SROM]BiskupSROMu,3276,645,44,31,75,58.7%,28m
10778,3,WTF,3276,346,17,7,24,70.8%,16m
10778,3,lew,3276,444,17,18,35,48.6%,18m
10778,3,Eurêka,3276,302,13,10,23,56.5%,13m
10778,3,Shakes,3276,310,12,7,19,63.2%,19m
10778,3,Terno,3276,280,10,5,15,66.7%,13m
10778,3,ilovedesign,3276,206,9,5,14,64.3%,19m
10778,3,robo,3276,0,5,0,5,100.0%,11m
10778,3,MrDuSomfing,3276,0,4,1,5,80.0%,27m
10778,3,Scaran,3276,0,1,0,1,100.0%,3m
10778,3,Comet,3276,30,1,3,4,25.0%,11m
10791,3,[EZ4XY]ZeuberTerran,3275,837,250,231,481,52.0%,12m
10791,3,Victor,3275,1133,217,181,398,54.5%,7m
10791,3,Meaning,3275,1519,169,144,313,54.0%,10m
10791,3,CooL,3275,614,120,108,228,52.6%,9m
10791,3,[ais]cyber,3275,1439,86,84,170,50.6%,4m
10791,3,Lemon,3275,328,11,20,31,35.5%,13m
10791,3,Juggler,3275,0,4,1,5,80.0%,19m
10791,2,[GGB]McFlyhigh,3275,0,2,3,5,40.0%,46m
10791,3,[DZPF]falaxdb,3275,0,0,2,2,0.0%,27m
10800,2,Foy,3274,1440,223,224,447,49.9%,27m
10800,3,[LIQUID]NOOBeERrXD,3274,1587,147,124,271,54.2%,17m
10800,3,[TOWEA]juicelink,3274,1601,141,128,269,52.4%,7m
10800,3,PuppetMaster,3274,1365,106,95,201,52.7%,26m
10800,3,GoFMido,3274,1411,104,96,200,52.0%,5m
10800,3,ictleader,3274,1495,82,79,161,50.9%,17m
10800,3,Blobbel,3274,1255,70,69,139,50.4%,9m
10800,3,[Brocks]Siwawa,3274,605,66,68,134,49.3%,10m
10800,3,IIIIIIIIIIII,3274,946,65,42,107,60.7%,9m
10800,3,KoLaZeR,3274,890,35,30,65,53.8%,6m
10800,3,matetee,3274,748,34,26,60,56.7%,11m
10800,3,EEE,3274,603,24,17,41,58.5%,5m
10800,3,[OYY]Koltess,3274,406,17,5,22,77.3%,13m
10800,3,Saucisse,3274,407,17,11,28,60.7%,28m
10800,3,Axass,3274,372,13,13,26,50.0%,3m
10800,3,HavanaObama,3274,211,10,5,15,66.7%,5m
10800,3,ZoovaLI,3274,262,9,5,14,64.3%,2m
10800,3,[Dogmin]bohong,3274,58,3,0,3,100.0%,5m
10800,3,[REGIN]Jastar,3274,58,2,1,3,66.7%,10m
10800,3,[bOvOd]VIOLstar,3274,30,1,5,6,16.7%,2m
10800,3,Abzal,3274,30,1,7,8,12.5%,12m
10800,2,Malikou,3274,97,1,8,9,11.1%,5m
10800,3,Fessepat,3274,0,0,2,2,0.0%,2m
10823,3,[NFGS]NucleoZ,3273,1631,68,63,131,51.9%,28m
10823,2,IIIIIIlIIIII,3273,48,5,2,7,71.4%,1h
10823,3,[lLiTl]fis,3273,86,3,3,6,50.0%,2m
10823,3,Trenchtown,3273,88,3,3,6,50.0%,7m
10823,3,krovaks,3273,0,1,1,2,50.0%,15m
10823,3,[LuTe]Hadamer,3273,0,0,1,1,0.0%,28m
10823,3,Lyno,3273,0,0,2,2,0.0%,11m
10830,2,ILLUMINATY,3272,1140,139,145,284,48.9%,6m
10830,3,[Смешно]Хех,3272,1171,107,99,206,51.9%,27m
10830,3,[BnRY]Clemooooooou,3272,582,38,36,74,51.4%,6m
10830,3,[EmŦ]Taru,3272,529,16,30,46,34.8%,11m
10830,3,Random,3272,140,4,1,5,80.0%,5m
10830,3,[AHAA]Fenrier,3272,0,4,1,5,80.0%,7m
10830,3,Sok,3272,60,3,4,7,42.9%,28m
10830,3,Pheasant,3272,30,2,5,7,28.6%,9m
10830,3,CrYtiCaL,3272,0,1,0,1,100.0%,2m
10830,3,[Slaƴer]Extreme,3272,0,1,1,2,50.0%,5m
10830,2,[G2T]ikhalloufi,3272,0,0,1,1,0.0%,20m
10830,3,JanProfesor,3272,0,0,1,1,0.0%,17m
10842,3,Kinnicoun,3271,1590,135,127,262,51.5%,29m
10842,3,ShrimpeH,3271,797,56,46,102,54.9%,11m
10842,2,Vincellow,3271,950,38,45,83,45.8%,11m
10842,3,Turtle,3271,715,31,22,53,58.5%,14m
10842,3,[m3mez]Katz,3271,476,28,26,54,51.9%,19m
10842,3,Resko,3271,602,25,19,44,56.8%,13m
10842,3,FeorgeGloyd,3271,358,21,21,42,50.0%,3m
10842,3,Isup,3271,518,18,17,35,51.4%,6m
10842,3,[orti]EnTaroAdun,3271,397,15,14,29,51.7%,10m
10842,3,bombadil,3271,86,4,1,5,80.0%,2m
10842,3,IIIIIIIIIIII,3271,119,3,1,4,75.0%,16m
10842,3,last,3271,60,3,4,7,42.9%,4m
10842,3,CALLofCUTIE,3271,92,3,13,16,18.8%,15m
10842,3,[LОLI]tabletochka,3271,0,2,0,2,100.0%,11m
10842,2,TheDarkVoice,3271,0,1,0,1,100.0%,1h
10842,3,Madbanshee,3271,0,0,1,1,0.0%,16m
10858,2,Verbatem,3270,1268,159,160,319,49.8%,17m
10858,3,Bridon,3270,1304,140,142,282,49.6%,27m
10858,3,Shinypants,3270,1419,91,88,179,50.8%,27m
10858,3,Kaddate,3270,1104,47,36,83,56.6%,8m
10858,3,[αX]Boulanger,3270,795,46,43,89,51.7%,15m
10858,3,Rynus,3270,537,44,35,79,55.7%,11m
10858,3,Thorrik,3270,807,31,28,59,52.5%,27m
10858,3,DeadWolf,3270,455,19,8,27,70.4%,19m
10858,3,AlenkaStar,3270,452,16,12,28,57.1%,28m
10858,3,DEMENTOR,3270,267,14,13,27,51.9%,19m
10858,3,sPiN,3270,305,13,4,17,76.5%,19m
10858,3,Kabooom,3270,276,11,4,15,73.3%,10m
10858,3,Fonox,3270,212,10,6,16,62.5%,11m
10858,2,MiTi,3270,219,9,8,17,52.9%,16m
10858,3,Kripz,3270,240,9,15,24,37.5%,6m
10858,1,[LTCS]ХитрыйГном,3270,292,8,12,20,40.0%,8m
10858,3,Battlefrog,3270,127,3,3,6,50.0%,16m
10858,3,[Ninjas]Haraldz,3270,122,2,3,5,40.0%,6m
10858,3,Daimos,3270,0,1,2,3,33.3%,6m
10858,1,Drake,3270,0,0,1,1,0.0%,8m
10858,3,LearnTheRus,3270,0,0,1,1,0.0%,14m
10858,3,[M4S1]Max,3270,0,0,2,2,0.0%,19m
10858,3,kyle,3270,0,0,3,3,0.0%,27m
10881,3,[eSKle]Rzeźnik,3269,1498,205,195,400,51.2%,6m
10881,3,OhRIP,3269,533,27,14,41,65.9%,26m
10881,3,Sardoche,3269,572,26,11,37,70.3%,3m
10881,3,SHANHAI,3269,610,24,20,44,54.5%,13m
10881,3,[BufsDr]Rookie,3269,416,15,16,31,48.4%,6m
10881,2,[FtBaH]Paarth,3269,277,14,7,21,66.7%,9m
10881,2,Totoro,3269,282,12,7,19,63.2%,9m
10881,3,PablO,3269,284,10,14,24,41.7%,28m
10881,3,IronMaiden,3269,139,9,8,17,52.9%,14m
10881,2,[BOSSE]Virren,3269,0,5,0,5,100.0%,1h
10881,2,IIIIIIIIII,3269,94,4,0,4,100.0%,1h
10881,2,[NoLair]Lords,3269,0,4,1,5,80.0%,10m
10881,3,XYNTA,3269,0,4,1,5,80.0%,16m
10881,3,[ZLZNP]GRock,3269,88,3,2,5,60.0%,4m
10881,3,Madness,3269,60,3,4,7,42.9%,6m
10881,2,[HOA]dvh,3269,0,1,4,5,20.0%,12m
10881,3,[Dobro]AlexV,3269,0,0,1,1,0.0%,14m
10881,3,Saeres,3269,0,0,3,3,0.0%,28m
10899,3,[F3N]Dragoon,3268,1424,202,196,398,50.8%,27m
10899,3,Yunghofer,3268,961,128,127,255,50.2%,14m
10899,3,IIIIIIIIIIII,3268,539,85,83,168,50.6%,14m
10899,3,Volshebnica,3268,1002,77,59,136,56.6%,15m
10899,3,CatInBox,3268,890,65,51,116,56.0%,19m
10899,3,[LPeeeG]lFgCreaper,3268,433,45,49,94,47.9%,5m
10899,3,[McCh]Fraset,3268,466,42,33,75,56.0%,7m
10899,3,Cip,3268,458,17,24,41,41.5%,5m
10899,3,[СТБ]KrAISaU,3268,322,15,7,22,68.2%,11m
10899,3,doryas,3268,314,12,12,24,50.0%,27m
10899,3,KraZyGryphon,3268,178,7,5,12,58.3%,5m
10899,3,CyberMax,3268,202,7,6,13,53.8%,13m
10899,3,Ubi,3268,142,6,3,9,66.7%,11m
10899,3,[AKALLA]Goran,3268,114,5,1,6,83.3%,7m
10899,3,[skizo]Alex,3268,118,5,3,8,62.5%,18m
10899,3,Erratus,3268,111,5,3,8,62.5%,9m
10899,3,tomato,3268,129,4,2,6,66.7%,13m
10899,3,FaceSitQueen,3268,119,3,0,3,100.0%,6m
10899,3,CyrusII,3268,86,3,3,6,50.0%,2m
10899,3,[NIHED]nimrod,3268,0,1,1,2,50.0%,7m
10899,3,Jââp,3268,0,0,1,1,0.0%,4m
10899,3,Leshiy,3268,0,0,1,1,0.0%,17m
10899,2,Gouki,3268,0,0,3,3,0.0%,19m
10899,3,HoneyBadger,3268,0,0,5,5,0.0%,3m
10923,3,Tervi,3267,1497,91,94,185,49.2%,28m
10923,3,ХрякЕда,3267,1374,54,49,103,52.4%,11m
10923,3,[Noche]FunkyMonk,3267,272,23,14,37,62.2%,10m
10923,3,[Овощи]Cyrax,3267,465,17,27,44,38.6%,9m
10923,3,[МуDТ]Nazarenko,3267,312,12,8,20,60.0%,29m
10923,3,YungBobbel,3267,0,0,4,4,0.0%,5m
10929,3,moeminator,3266,1555,219,197,416,52.6%,4m
10929,3,Logotype,3266,1551,92,94,186,49.5%,17m
10929,3,[RBlood]Sogo,3266,815,52,56,108,48.1%,2m
10929,3,[H4L4]SSCorona,3266,642,24,28,52,46.2%,2m
10929,3,Pacalpöri,3266,221,8,0,8,100.0%,29m
10929,3,Volta,3266,0,5,0,5,100.0%,8m
10929,3,ScSpaghetti,3266,167,5,3,8,62.5%,17m
10929,3,DReeNo,3266,58,5,7,12,41.7%,7m
10929,2,SHOCK,3266,0,4,1,5,80.0%,1h
10929,3,DragonJohn,3266,30,2,0,2,100.0%,10m
10929,3,SCPlusPlus,3266,58,2,5,7,28.6%,29m
10929,3,[d0cToR]Funkenstein,3266,0,0,2,2,0.0%,16m
10941,3,andrew,3265,1434,182,171,353,51.6%,14m
10941,3,[DarKsS]Santi,3265,814,115,98,213,54.0%,4m
10941,3,[EMASC]jojo,3265,1352,78,76,154,50.6%,3m
10941,3,[PÂRłAH]Dremonzar,3265,1173,73,60,133,54.9%,4m
10941,3,Troye,3265,213,61,67,128,47.7%,19m
10941,2,Metalsous,3265,546,17,43,60,28.3%,14m
10941,3,askar,3265,444,16,11,27,59.3%,11m
10941,3,NaiJi,3265,346,14,13,27,51.9%,8m
10941,3,luke,3265,288,11,10,21,52.4%,27m
10941,3,Aquaman,3265,170,7,4,11,63.6%,5m
10941,3,kippetje,3265,88,4,5,9,44.4%,4m
10941,3,Had,3265,118,3,1,4,75.0%,6m
10941,3,[FZTW]Trycatchme,3265,29,2,1,3,66.7%,10m
10941,3,Monsoon,3265,120,2,2,4,50.0%,12m
10941,3,Criminal,3265,30,1,1,2,50.0%,15m
10941,3,[Rofler]enervant,3265,97,1,2,3,33.3%,13m
10941,1,[Z3RGML]Сомбреро,3265,0,1,6,7,14.3%,17m
10941,3,FroliX,3265,0,0,2,2,0.0%,5m
10941,3,MipZero,3265,0,0,5,5,0.0%,5m
10941,1,iCampsYou,3265,0,0,7,7,0.0%,60m
10961,3,SalvajeJoe,3264,1558,117,109,226,51.8%,11m
10961,3,Noobie,3264,1579,112,105,217,51.6%,28m
10961,2,Seantf,3264,1559,66,77,143,46.2%,18m
10961,3,IIIIIIIIIIII,3264,912,45,18,63,71.4%,19m
10961,3,KiborG,3264,628,27,13,40,67.5%,17m
10961,3,AntiMatter,3264,530,21,23,44,47.7%,12m
10961,3,[Blacer]Serral,3264,384,17,10,27,63.0%,26m
10961,3,[3AW]Géxīn,3264,106,6,10,16,37.5%,14m
10961,3,Todja,3264,190,5,2,7,71.4%,4m
10961,3,[PÂRłAH]SmokedSloth,3264,86,4,1,5,80.0%,3m
10961,3,[TermiT]Firework,3264,166,4,1,5,80.0%,11m
10961,3,hrcRogue,3264,86,3,4,7,42.9%,27m
10961,3,Khan,3264,30,2,2,4,50.0%,11m
10961,3,PuisSanCe,3264,60,2,3,5,40.0%,19m
10961,3,KOB,3264,30,2,11,13,15.4%,6m
10961,3,IIIIIIIIIIII,3264,0,1,0,1,100.0%,2m
10961,3,[Kicx]DVN,3264,0,0,1,1,0.0%,12m
10961,3,MPGRACI,3264,0,0,1,1,0.0%,6m
10979,3,[NetGG]Kurkul,3263,737,204,198,402,50.7%,10m
10979,2,MSKgreen,3263,1358,68,74,142,47.9%,13m
10979,3,mishawisha,3263,1106,38,51,89,42.7%,6m
10979,3,Rocket,3263,688,23,33,56,41.1%,27m
10979,3,Turambarchik,3263,443,18,15,33,54.5%,10m
10979,3,nYdal,3263,438,16,18,34,47.1%,29m
10979,3,[Sacred]iiiiiiiiiiii,3263,294,10,15,25,40.0%,12m
10979,3,BossyJelly,3263,174,6,5,11,54.5%,4m
10979,3,iskar,3263,170,6,10,16,37.5%,14m
10979,3,[Xa]Fantatratto,3263,142,5,4,9,55.6%,2m
10979,3,[LGM]Evlex,3263,90,4,12,16,25.0%,8m
10979,3,TranKass,3263,58,2,4,6,33.3%,16m
10979,3,[Gehakt]Furby,3263,0,1,0,1,100.0%,12m
10979,3,[Nеzukо]OniUbiliKeni,3263,30,1,1,2,50.0%,17m
10979,3,Torune,3263,97,1,2,3,33.3%,16m
10979,3,Destroyer,3263,0,0,1,1,0.0%,27m
10979,2,LInok,3263,0,0,1,1,0.0%,1h
10979,3,TeeJayGaming,3263,0,0,1,1,0.0%,17m
10997,3,Rivrran,3262,1610,201,197,398,50.5%,5m
10997,3,vollo,3262,1021,127,121,248,51.2%,11m
10997,3,Houston,3262,1217,59,50,109,54.1%,17m
10997,3,Kharlamov,3262,460,21,12,33,63.6%,11m
10997,1,tworset,3262,355,14,10,24,58.3%,8m
10997,3,[UEDSFF]EmperorNZ,3262,298,10,11,21,47.6%,10m
10997,3,NajiM,3262,198,8,8,16,50.0%,9m
10997,3,RoManHD,3262,30,5,3,8,62.5%,3m
10997,1,Шиза,3262,97,5,3,8,62.5%,1h
10997,3,EndLevelBoss,3262,146,5,9,14,35.7%,16m
10997,3,XxStEpxX,3262,114,4,4,8,50.0%,19m
10997,3,[ЦЭ]RESISTE,3262,92,4,5,9,44.4%,16m
10997,3,[xGolDx]SuperJohan,3262,122,2,4,6,33.3%,27m
10997,3,Baffron,3262,127,2,5,7,28.6%,10m
10997,3,seiken,3262,30,1,5,6,16.7%,7m
10997,3,[mfixed]Koper,3262,30,1,7,8,12.5%,26m
11013,3,Stagnator,3261,1552,183,183,366,50.0%,16m
11013,3,Antho,3261,1302,100,83,183,54.6%,28m
11013,3,guigsou,3261,1102,63,54,117,53.8%,8m
11013,3,[DNvL]KillerQualle,3261,746,30,28,58,51.7%,2m
11013,3,whatt,3261,702,27,20,47,57.4%,16m
11013,3,togostyrael,3261,462,20,15,35,57.1%,11m
11013,3,[EXPANT]cdsx,3261,425,18,13,31,58.1%,6m
11013,3,[COMO]Hook,3261,301,11,10,21,52.4%,15m
11013,3,Jolie,3261,94,5,1,6,83.3%,16m
11013,2,ПРОБИУС,3261,0,4,1,5,80.0%,52m
11013,3,FireFly,3261,30,2,0,2,100.0%,8m
11013,1,TrainingTime,3261,120,2,3,5,40.0%,44m
11013,3,Neksus,3261,0,1,2,3,33.3%,2m
11013,2,TomBombadil,3261,0,0,1,1,0.0%,8m
11027,3,Feelgood,3260,1218,53,44,97,54.6%,6m
11027,3,[Aggri]Aggressor,3260,715,49,48,97,50.5%,7m
11027,3,[V1B3]STIMZ,3260,691,40,25,65,61.5%,4m
11027,3,Taichoru,3260,334,23,11,34,67.6%,27m
11027,3,titi,3260,512,17,24,41,41.5%,17m
11027,3,XioX,3260,234,7,22,29,24.1%,19m
11027,3,tinou,3260,201,6,5,11,54.5%,4m
11027,3,SlowHarry,3260,114,4,5,9,44.4%,18m
11027,3,NIKNAZ,3260,60,3,5,8,37.5%,13m
11027,3,ViniThePooh,3260,0,1,0,1,100.0%,26m
11027,3,Simp,3260,95,1,5,6,16.7%,6m
11027,3,Serral,3260,0,0,1,1,0.0%,9m
11027,3,Adjutant,3260,0,0,8,8,0.0%,14m
11040,3,[MkerIT]apocalisse,3259,1607,233,217,450,51.8%,5m
11040,3,Zarakalus,3259,1412,179,180,359,49.9%,9m
11040,3,Vilburn,3259,1295,103,107,210,49.0%,5m
11040,3,BlackMichel,3259,1591,65,62,127,51.2%,5m
11040,3,Syranth,3259,476,21,12,33,63.6%,2m
11040,2,plague,3259,434,21,21,42,50.0%,28m
11040,1,Zero,3259,357,13,7,20,65.0%,14m
11040,3,llllll,3259,332,13,9,22,59.1%,5m
11040,3,TyrionImp,3259,100,12,14,26,46.2%,4m
11040,3,[Maegis]Red,3259,299,10,10,20,50.0%,8m
11040,3,KimJongKool,3259,220,9,7,16,56.2%,19m
11040,3,Bart,3259,208,7,1,8,87.5%,2m
11040,3,Heartless,3259,159,4,1,5,80.0%,27m
11040,3,CeProTY,3259,58,3,0,3,100.0%,6m
11040,3,Praetorian,3259,30,1,1,2,50.0%,2m
11040,1,Duck,3259,97,1,1,2,50.0%,3m
11040,3,Mia,3259,0,1,1,2,50.0%,9m
11040,3,[NoTvT]SCV,3259,0,1,4,5,20.0%,27m
11040,3,[GMW]Reset,3259,0,0,1,1,0.0%,19m
11040,3,[aW]error,3259,0,0,2,2,0.0%,28m
11060,3,[SKRSC2]Luckyhuh,3258,1576,118,112,230,51.3%,6m
11060,3,[AoTu]Nev,3258,1591,76,37,113,67.3%,13m
11060,3,Nagual,3258,1542,73,71,144,50.7%,13m
11060,3,CaCaO,3258,625,24,19,43,55.8%,11m
11060,3,OXO,3258,240,10,7,17,58.8%,18m
11060,3,liberator,3258,203,10,10,20,50.0%,5m
11060,3,GGǂMuRRan,3258,282,10,14,24,41.7%,6m
11060,3,[TRiB3]ReeKo,3258,172,8,4,12,66.7%,4m
11060,2,[Amelie]Lacroix,3258,142,5,3,8,62.5%,12m
11060,3,Dreals,3258,92,4,3,7,57.1%,10m
11060,3,Metalista,3258,90,3,3,6,50.0%,5m
11060,3,Feminist,3258,30,2,0,2,100.0%,12m
11060,3,llllllllllll,3258,58,2,2,4,50.0%,6m
11060,3,SpongeBob,3258,0,1,3,4,25.0%,28m
11060,3,Wisperwind,3258,0,0,1,1,0.0%,17m
11060,3,[IH8U]NEoNex,3258,0,0,1,1,0.0%,2m
11076,3,[HFR]Wobeen,3257,1580,138,134,272,50.7%,12m
11076,3,[eseeHC]igoryamba,3257,1592,94,76,170,55.3%,4m
11076,3,Kratos,3257,977,41,30,71,57.7%,5m
11076,3,CMDSHEPARD,3257,569,26,17,43,60.5%,27m
11076,3,notadecvat,3257,348,13,13,26,50.0%,8m
11076,3,[CОS]Andrewpups,3257,251,9,2,11,81.8%,10m
11076,3,Pave,3257,86,4,2,6,66.7%,2m
11076,3,iNhale,3257,114,4,5,9,44.4%,17m
11076,3,LaCruz,3257,120,4,11,15,26.7%,13m
11076,3,Djcomf,3257,58,3,0,3,100.0%,15m
11076,3,[PiGPan]Leonius,3257,0,1,0,1,100.0%,27m
11076,3,Blargenaut,3257,0,1,0,1,100.0%,14m
11076,3,[PGZ]Puntiiiii,3257,0,0,1,1,0.0%,11m
11076,3,Bokser,3257,0,0,5,5,0.0%,10m
11090,3,Killtech,3256,1591,216,199,415,52.0%,18m
11090,2,Japox,3256,1616,200,210,410,48.8%,13m
11090,3,[PNDA]Grim,3256,1597,128,104,232,55.2%,13m
11090,3,krmb,3256,1411,112,85,197,56.9%,5m
11090,3,BadKitten,3256,1506,58,57,115,50.4%,17m
11090,3,Reality,3256,1193,54,54,108,50.0%,5m
11090,3,[FurRev]Bit,3256,331,32,22,54,59.3%,18m
11090,3,Danmirans,3256,611,30,13,43,69.8%,17m
11090,3,[G4MBLE]braindamage,3256,683,28,21,49,57.1%,26m
11090,3,mechbuddy,3256,654,27,18,45,60.0%,9m
11090,3,DmitryKM,3256,748,26,28,54,48.1%,5m
11090,3,KMAG,3256,482,22,15,37,59.5%,5m
11090,3,Darkrai,3256,478,17,13,30,56.7%,5m
11090,3,[4BG]AoiHikari,3256,247,8,6,14,57.1%,9m
11090,3,[NINJ88]ishiren,3256,191,6,3,9,66.7%,5m
11090,3,[GGoat]Palplatine,3256,0,4,1,5,80.0%,16m
11090,3,Suva,3256,0,4,1,5,80.0%,4m
11090,3,Tchayen,3256,0,3,2,5,60.0%,14m
11090,3,frankimahri,3256,0,0,1,1,0.0%,9m
11090,3,[SFine]Granis,3256,0,0,1,1,0.0%,5m
11090,3,Shigeru,3256,0,0,3,3,0.0%,28m
11090,3,[B4LAN]Elfuego,3256,0,0,3,3,0.0%,17m
11112,3,[fFlags]max,3255,1567,575,558,1133,50.8%,2m
11112,3,Miasmos,3255,1504,185,178,363,51.0%,4m
11112,3,BrianMcGee,3255,1543,71,72,143,49.7%,27m
11112,3,Arax,3255,1182,49,40,89,55.1%,7m
11112,3,ImBadSryTeam,3255,1072,40,38,78,51.3%,5m
11112,3,[R4Time]BRN,3255,492,35,30,65,53.8%,27m
11112,3,MaureMan,3255,810,31,31,62,50.0%,28m
11112,3,[NotSuR]Kipyatosh,3255,463,23,5,28,82.1%,28m
11112,3,Sniez,3255,546,22,13,35,62.9%,14m
11112,1,[TMTM]TimeOut,3255,186,9,5,14,64.3%,12m
11112,3,SolarLair,3255,182,6,10,16,37.5%,27m
11112,3,Speedlink,3255,123,4,7,11,36.4%,17m
11112,3,Silverace,3255,97,1,3,4,25.0%,11m
11112,3,Billabong,3255,30,1,5,6,16.7%,27m
11112,3,[CtStWs]Prototype,3255,0,0,1,1,0.0%,29m
11127,3,gensys,3254,1508,103,100,203,50.7%,14m
11127,2,IIIIIIIIIIII,3254,902,59,26,85,69.4%,10m
11127,3,Zagga,3254,972,36,35,71,50.7%,3m
11127,3,Wizard,3254,231,12,6,18,66.7%,7m
11127,3,SKRIPEN,3254,180,8,2,10,80.0%,10m
11127,2,aMove,3254,118,4,3,7,57.1%,1h
11127,3,ZyklonB,3254,30,3,6,9,33.3%,11m
11134,3,gratisLPG,3253,1587,251,233,484,51.9%,8m
11134,3,[Pзrsia]klsnhe,3253,1488,211,216,427,49.4%,2m
11134,3,Sloany,3253,1364,110,120,230,47.8%,8m
11134,3,[UKRA1N]NeoKnight,3253,1631,97,100,197,49.2%,17m
11134,3,dooznet,3253,1328,87,96,183,47.5%,27m
11134,3,Babaljuta,3253,912,49,62,111,44.1%,12m
11134,3,[Brocks]Widdly,3253,980,35,41,76,46.1%,15m
11134,3,KimJungAdun,3253,373,15,7,22,68.2%,12m
11134,3,[AiRǂ]Red,3253,288,11,16,27,40.7%,6m
11134,3,McBook,3253,296,10,16,26,38.5%,17m
11134,3,[tH]Takushin,3253,272,8,8,16,50.0%,16m
11134,1,Thronix,3253,143,7,2,9,77.8%,9m
11134,1,Lacruz,3253,96,3,2,5,60.0%,1h
11134,3,Kinion,3253,144,3,3,6,50.0%,3m
11134,3,[hf4X4]Stiffo,3253,92,3,4,7,42.9%,16m
11134,3,CvsforyoU,3253,30,2,0,2,100.0%,27m
11134,3,[LOVSTR]RPGTitan,3253,30,2,3,5,40.0%,7m
11134,2,[HENR]Gooseman,3253,0,1,5,6,16.7%,20m
11134,3,Makmerdo,3253,30,1,5,6,16.7%,2m
11134,3,Ocelot,3253,0,0,1,1,0.0%,11m
11134,3,[JLT]Yegres,3253,0,0,6,6,0.0%,6m
11155,3,Seltech,3252,1596,113,112,225,50.2%,27m
11155,3,Kratos,3252,1299,92,88,180,51.1%,8m
11155,3,Covid,3252,286,68,21,89,76.4%,16m
11155,3,KarlSberg,3252,1041,43,42,85,50.6%,17m
11155,3,SoLo,3252,652,23,25,48,47.9%,13m
11155,3,[JATE]Liagerse,3252,358,15,11,26,57.7%,9m
11155,3,Haiiro,3252,294,11,9,20,55.0%,17m
11155,3,HunTeR,3252,194,8,6,14,57.1%,3m
11155,2,TSwift,3252,225,7,7,14,50.0%,15m
11155,3,Antigone,3252,215,6,4,10,60.0%,14m
11155,3,papidipupi,3252,178,6,16,22,27.3%,7m
11155,3,Tempest,3252,0,4,1,5,80.0%,19m
11155,3,Ikarimbu,3252,0,4,1,5,80.0%,5m
11155,3,Dzerzhinsky,3252,114,4,8,12,33.3%,17m
11155,3,SHPEKS,3252,0,1,0,1,100.0%,5m
11155,1,[XF71]GhoZty,3252,93,1,3,4,25.0%,16m
11155,3,Reactive,3252,30,1,3,4,25.0%,2m
11155,3,[BrKi]Forsaken,3252,0,0,1,1,0.0%,19m
11155,3,CreYtive,3252,0,0,1,1,0.0%,16m
11155,1,Beuhbel,3252,0,0,1,1,0.0%,1h
11155,3,[Plysch]Krakowich,3252,0,0,1,1,0.0%,6m
11176,3,[UZA]FakeMedivac,3251,1299,223,226,449,49.7%,27m
11176,3,Arnold,3251,929,80,74,154,51.9%,11m
11176,3,[FR1]GuignomeS,3251,960,42,36,78,53.8%,9m
11176,3,Whirros,3251,371,27,12,39,69.2%,8m
11176,3,CooLer,3251,479,23,15,38,60.5%,10m
11176,3,FunkyRobot,3251,490,17,18,35,48.6%,5m
11176,3,Nutter,3251,376,13,15,28,46.4%,29m
11176,3,[LVF6]Zod,3251,314,11,10,21,52.4%,19m
11176,3,KyrohEurope,3251,142,5,5,10,50.0%,17m
11176,3,[Calas]Eclator,3251,58,2,1,3,66.7%,14m
11176,3,[3DE]Maggzy,3251,60,2,3,5,40.0%,12m
11176,3,[Ginf]MagouroX,3251,0,1,0,1,100.0%,16m
11188,3,Icternol,3250,1542,83,82,165,50.3%,12m
11188,3,MarineBand,3250,786,45,47,92,48.9%,2m
11188,3,Alcofribas,3250,836,36,29,65,55.4%,2m
11188,3,[Frio]HerrFrost,3250,731,33,27,60,55.0%,2m
11188,3,RubenOs,3250,432,16,21,37,43.2%,3m
11188,3,[LeBrz]Merdiorian,3250,327,14,9,23,60.9%,12m
11188,3,Darkpagey,3250,289,13,6,19,68.4%,2m
11188,3,OldWolf,3250,225,10,4,14,71.4%,5m
11188,2,Nano,3250,273,9,7,16,56.2%,10m
11188,3,[eRZR]SkyDeR,3250,0,5,3,8,62.5%,7m
11188,3,[TODOW]Neyin,3250,190,5,3,8,62.5%,5m
11188,3,Avogadro,3250,122,5,5,10,50.0%,4m
11188,1,errorofdeath,3250,143,3,3,6,50.0%,55m
11188,3,Arkyon,3250,30,2,1,3,66.7%,17m
11188,3,[WHOOY]kallagen,3250,60,2,5,7,28.6%,17m
11188,3,[JGJG]mikulus,3250,0,1,1,2,50.0%,11m
11188,3,dayoff,3250,0,0,1,1,0.0%,5m
11205,3,[TZCrew]Thorn,3249,1500,170,154,324,52.5%,2m
11205,3,TreebornFrog,3249,1136,67,51,118,56.8%,7m
11205,3,Moonstar,3249,403,24,17,41,58.5%,2m
11205,3,mato,3249,350,14,7,21,66.7%,13m
11205,3,[Arrows]ParaBellum,3249,179,14,12,26,53.8%,8m
11205,3,fReSsOR,3249,225,11,5,16,68.8%,16m
11205,3,Fenixbg,3249,254,9,8,17,52.9%,19m
11205,3,[RPG2]Lumine,3249,252,9,14,23,39.1%,7m
11205,3,Derill,3249,0,4,1,5,80.0%,17m
11205,3,shadow,3249,30,3,6,9,33.3%,13m
11205,3,Slavalucshiu,3249,0,2,3,5,40.0%,16m
11205,3,SinoFish,3249,0,1,0,1,100.0%,27m
11205,3,[Sc2V]Elheroe,3249,0,1,4,5,20.0%,27m
11205,3,[123abc]stowgood,3249,0,0,1,1,0.0%,5m
11205,3,Scandie,3249,0,0,1,1,0.0%,5m
11205,3,NivSliv,3249,0,0,1,1,0.0%,27m
11205,3,newtosctwo,3249,0,0,1,1,0.0%,26m
11205,3,[Oupss]HeK,3249,0,0,3,3,0.0%,14m
11205,3,Волшебник,3249,0,0,3,3,0.0%,16m
11224,3,[PŖïMĄŁ]MyKe,3248,1592,292,265,557,52.4%,18m
11224,3,Medardus,3248,1116,122,106,228,53.5%,19m
11224,3,WSY,3248,1235,88,97,185,47.6%,17m
11224,3,[KTK]calebr,3248,1033,65,71,136,47.8%,12m
11224,3,Bacon,3248,1140,44,50,94,46.8%,17m
11224,3,IamDoduuu,3248,878,41,18,59,69.5%,10m
11224,3,[сSсǃ]Fansaf,3248,264,15,3,18,83.3%,27m
11224,3,UncleBeny,3248,221,11,7,18,61.1%,18m
11224,3,[RUINPP]Marmeros,3248,160,8,3,11,72.7%,2m
11224,1,chess,3248,212,8,4,12,66.7%,19m
11224,3,[IBUMIF]ChillS,3248,0,5,0,5,100.0%,1h
11224,3,TheWickerman,3248,58,5,3,8,62.5%,16m
11224,3,[LPKL]SixisBack,3248,0,1,0,1,100.0%,12m
11224,3,Lilith,3248,0,1,0,1,100.0%,10m
11224,3,[HAIGH]Haighstrom,3248,0,0,1,1,0.0%,16m
11224,3,esLXeqtR,3248,0,0,1,1,0.0%,2m
11224,1,dajanto,3248,0,0,2,2,0.0%,1h
11224,3,PapaMisty,3248,0,0,3,3,0.0%,27m
11242,3,[Peeps]Kobold,3247,1612,506,512,1018,49.7%,19m
11242,3,caineurs,3247,1588,481,472,953,50.5%,16m
11242,3,CHAYKA,3247,1492,199,189,388,51.3%,29m
11242,2,SirBob,3247,1356,103,119,222,46.4%,10m
11242,3,MynHe,3247,1628,98,93,191,51.3%,4m
11242,3,AlieN,3247,1297,89,75,164,54.3%,6m
11242,3,[PTZMuc]Darkness,3247,947,37,31,68,54.4%,2m
11242,3,[AlIin]Bybasick,3247,336,37,31,68,54.4%,2m
11242,3,DeadMonster,3247,475,18,15,33,54.5%,29m
11242,3,РядовойРудге,3247,233,13,14,27,48.1%,4m
11242,3,TopRight,3247,163,5,0,5,100.0%,7m
11242,3,MACROPHONE,3247,120,5,4,9,55.6%,9m
11242,3,Finwer,3247,90,4,3,7,57.1%,15m
11242,3,ArtySca,3247,0,1,0,1,100.0%,28m
11242,3,Sirlosealot,3247,0,0,1,1,0.0%,7m
11242,3,Gandalf,3247,0,0,1,1,0.0%,5m
11242,3,Quidex,3247,0,0,5,5,0.0%,2m
11259,3,[тао]grosx,3246,1525,153,156,309,49.5%,4m
11259,3,[Xygws]Area,3246,1087,118,113,231,51.1%,8m
11259,3,StarLight,3246,1404,73,66,139,52.5%,8m
11259,3,mamboking,3246,1077,58,69,127,45.7%,12m
11259,3,[dgmj]Offax,3246,1054,40,44,84,47.6%,2m
11259,3,[MAYEK]gabtro,3246,763,34,26,60,56.7%,19m
11259,3,Serensha,3246,526,23,12,35,65.7%,8m
11259,3,IceFox,3246,484,17,24,41,41.5%,13m
11259,3,ImbaLaCouill,3246,408,16,9,25,64.0%,5m
11259,3,nept,3246,333,15,14,29,51.7%,2m
11259,3,Neighbor,3246,278,9,6,15,60.0%,6m
11259,3,[sheep8]JIMINLOVE,3246,0,4,1,5,80.0%,11m
11259,3,Alex,3246,0,4,1,5,80.0%,14m
11259,3,Solden,3246,0,2,1,3,66.7%,5m
11259,3,CptObvious,3246,0,0,1,1,0.0%,2m
11259,3,sadji,3246,0,0,1,1,0.0%,11m
11259,3,Obama,3246,0,0,1,1,0.0%,3m
11259,3,llllllllllll,3246,0,0,1,1,0.0%,19m
11259,3,Zhmurik,3246,0,0,2,2,0.0%,10m
11259,3,AlwaysTilted,3246,0,0,2,2,0.0%,16m
11279,3,[RhWd]bello,3245,1582,195,202,397,49.1%,9m
11279,3,Hulimulin,3245,1526,181,164,345,52.5%,9m
11279,3,Baitholder,3245,1475,159,154,313,50.8%,29m
11279,3,BlackFadil,3245,1155,130,129,259,50.2%,10m
11279,3,[Sars]Pplu,3245,513,89,66,155,57.4%,6m
11279,1,FleshO,3245,189,9,3,12,75.0%,3m
11279,3,Dazag,3245,147,8,20,28,28.6%,27m
11279,3,[iGRD]BlackIce,3245,176,6,8,14,42.9%,19m
11279,3,Bax,3245,154,5,12,17,29.4%,27m
11279,3,Syne,3245,116,4,13,17,23.5%,18m
11279,3,JAckie,3245,60,3,8,11,27.3%,5m
11279,3,Kipi,3245,30,2,1,3,66.7%,2m
11279,3,[RCHES]KingsterD,3245,0,2,3,5,40.0%,7m
11279,3,TeLLuriAn,3245,62,2,6,8,25.0%,12m
11279,2,LostToTerran,3245,95,1,1,2,50.0%,15m
11279,3,[G3O]ShenaniGans,3245,0,0,1,1,0.0%,10m
11279,3,[N1NJ4Z]WildPekineS,3245,0,0,1,1,0.0%,15m
11296,2,Gordon,3244,1578,324,318,642,50.5%,6m
11296,2,Elaiir,3244,1161,285,293,578,49.3%,7m
11296,3,Lemen,3244,1578,174,168,342,50.9%,28m
11296,3,PZh,3244,1501,165,163,328,50.3%,14m
11296,3,[NLǂ]Silver,3244,1336,154,153,307,50.2%,9m
11296,3,BoyToi,3244,1541,132,120,252,52.4%,30m
11296,3,LOBsTerr,3244,1437,129,108,237,54.4%,27m
11296,3,furiousMaoz,3244,1553,123,120,243,50.6%,29m
11296,3,Degel,3244,1576,111,106,217,51.2%,29m
11296,3,Phobos,3244,921,61,52,113,54.0%,18m
11296,3,friendly,3244,586,38,43,81,46.9%,28m
11296,3,Bohr,3244,414,19,24,43,44.2%,2m
11296,3,ache,3244,424,14,22,36,38.9%,14m
11296,3,bigmanIsak,3244,257,10,2,12,83.3%,17m
11296,3,Tomathor,3244,254,9,11,20,45.0%,2m
11296,3,Weronsz,3244,94,5,1,6,83.3%,8m
11296,3,Jib,3244,0,4,1,5,80.0%,18m
11296,3,TheMule,3244,0,4,1,5,80.0%,13m
11296,3,[RaR]Garthealis,3244,94,4,2,6,66.7%,5m
11296,3,Midnight,3244,58,3,2,5,60.0%,13m
11296,3,Osci,3244,125,3,12,15,20.0%,5m
11296,3,Ultimat,3244,30,2,0,2,100.0%,27m
11296,3,MiF,3244,58,2,2,4,50.0%,7m
11296,3,AVK,3244,0,1,0,1,100.0%,9m
11296,3,HelloWorld,3244,30,1,3,4,25.0%,15m
11296,3,[Lambro]redflashBG,3244,0,0,1,1,0.0%,5m
11296,3,[DMaTB]JðhnGþves,3244,0,0,2,2,0.0%,19m
11323,3,pinya,3243,1411,134,139,273,49.1%,17m
11323,3,OverKill,3243,1099,69,65,134,51.5%,16m
11323,3,Fundamentals,3243,970,50,22,72,69.4%,14m
11323,3,TurboViking,3243,415,18,6,24,75.0%,12m
11323,3,TobiasKoster,3243,483,17,19,36,47.2%,4m
11323,3,[PLANgg]djVEJDR,3243,261,15,12,27,55.6%,19m
11323,3,[Kuchen]Roqskillz,3243,243,7,5,12,58.3%,7m
11323,1,SlimShady,3243,96,3,2,5,60.0%,57m
11323,3,Макс,3243,0,1,0,1,100.0%,10m
11323,1,[ǂescǂ]Nazgul,3243,0,1,7,8,12.5%,17m
11323,3,[RBlood]bluzraider,3243,0,0,1,1,0.0%,6m
11323,3,Punisher,3243,0,0,1,1,0.0%,16m
11323,3,PaweloElo,3243,0,0,3,3,0.0%,28m
11336,3,Stan,3242,1288,161,149,310,51.9%,12m
11336,3,[BR3AK]MakroLord,3242,589,23,18,41,56.1%,17m
11336,3,[CRL]ShaFaX,3242,532,20,15,35,57.1%,15m
11336,3,[Code52]DarkAlphaAPM,3242,496,19,18,37,51.4%,27m
11336,3,rock,3242,490,17,17,34,50.0%,16m
11336,3,CMo,3242,415,14,21,35,40.0%,16m
11336,3,PULO,3242,322,11,19,30,36.7%,7m
11336,1,[UPMEU]Reverie,3242,144,6,4,10,60.0%,54m
11336,3,[15ANS]TikiBoom,3242,178,6,6,12,50.0%,7m
11336,3,TessaBliss,3242,60,3,2,5,60.0%,7m
11336,3,[decoy]dib,3242,58,2,2,4,50.0%,3m
11336,2,PlayMore,3242,44,2,3,5,40.0%,10m
11336,3,CHAAAARGE,3242,38,2,4,6,33.3%,5m
11336,3,PANZER,3242,60,2,5,7,28.6%,2m
11336,3,[LGBAD]Anrakyr,3242,0,1,1,2,50.0%,11m
11336,1,[KHA]Kaløz,3242,0,1,1,2,50.0%,4m
11336,3,pOOk,3242,0,0,1,1,0.0%,8m
11353,3,justme,3241,907,39,30,69,56.5%,18m
11353,3,TheBOSS,3241,677,38,40,78,48.7%,4m
11353,3,YOLOcheese,3241,913,37,29,66,56.1%,13m
11353,3,Minato,3241,880,35,35,70,50.0%,8m
11353,3,PierroChon,3241,632,21,28,49,42.9%,3m
11353,3,[KRDZ]Tasa,3241,479,19,12,31,61.3%,28m
11353,3,EmperorKyiv,3241,322,12,14,26,46.2%,2m
11353,3,Lookingood,3241,358,12,25,37,32.4%,26m
11353,3,[Vsecs]sonic,3241,134,3,2,5,60.0%,30m
11353,3,[ЭЩКЕPЕ]Элджей,3241,0,3,3,6,50.0%,8m
11353,3,Ssinxdy,3241,64,3,10,13,23.1%,8m
11353,3,Aram,3241,30,1,1,2,50.0%,17m
11353,3,IlIlIlIlIlll,3241,30,1,1,2,50.0%,4m
11353,2,Bluesman,3241,91,1,3,4,25.0%,8m
11353,3,JosephStalin,3241,30,1,5,6,16.7%,4m
11353,3,[vidnos]Bexi,3241,0,0,1,1,0.0%,8m
11369,3,Gonzo,3240,930,308,306,614,50.2%,9m
11369,3,flofix,3240,1569,75,61,136,55.1%,4m
11369,3,NavelUdd,3240,437,56,45,101,55.4%,17m
11369,3,Omnospy,3240,482,17,22,39,43.6%,26m
11369,2,[IceHus]llllllllllll,3240,290,13,8,21,61.9%,26m
11369,3,LtDamn,3240,272,9,17,26,34.6%,8m
11369,3,Nergal,3240,217,6,6,12,50.0%,18m
11369,3,Bonkura,3240,0,4,1,5,80.0%,2m
11369,3,[QTX]iPesterreger,3240,90,4,9,13,30.8%,8m
11369,3,Argonaute,3240,0,1,0,1,100.0%,27m
11369,3,[ECFeV]Heimdall,3240,0,1,0,1,100.0%,5m
11369,3,[EzEz]Shadow,3240,0,1,0,1,100.0%,5m
11369,3,[messys]TheKid,3240,0,0,1,1,0.0%,28m
11382,3,ObinWan,3239,1036,180,166,346,52.0%,13m
11382,3,cbd,3239,959,66,41,107,61.7%,16m
11382,3,seymervtot,3239,1091,64,70,134,47.8%,6m
11382,3,WudiByFang,3239,1065,43,41,84,51.2%,5m
11382,3,Yuinosh,3239,730,35,17,52,67.3%,18m
11382,3,CrazyIvan,3239,469,18,24,42,42.9%,17m
11382,3,KnightXO,3239,387,17,9,26,65.4%,28m
11382,3,[MGALS]MirandasMom,3239,389,14,7,21,66.7%,3m
11382,3,PROKURATOR,3239,334,13,11,24,54.2%,4m
11382,3,Nicolas,3239,127,4,0,4,100.0%,13m
11382,3,Charles,3239,0,1,0,1,100.0%,19m
11382,2,[SOUPE]Bastébola,3239,96,1,3,4,25.0%,8m
11394,3,Tampler,3238,1509,253,246,499,50.7%,28m
11394,3,Oca,3238,1532,150,163,313,47.9%,2m
11394,3,[ValidG]Simmen,3238,1256,63,50,113,55.8%,12m
11394,3,Woland,3238,1230,43,51,94,45.7%,8m
11394,3,[Dobro]PontyPilat,3238,463,42,30,72,58.3%,10m
11394,3,[FearEU]Colombo,3238,522,23,16,39,59.0%,13m
11394,3,[CrøkeT]EIkeutard,3238,534,19,23,42,45.2%,10m
11394,3,javiorpas,3238,489,18,15,33,54.5%,18m
11394,3,Spyro,3238,313,17,18,35,48.6%,9m
11394,3,Troligt,3238,95,9,10,19,47.4%,8m
11394,3,INFERNO,3238,204,8,8,16,50.0%,16m
11394,3,ASTRE,3238,224,8,8,16,50.0%,2m
11394,3,[HBGSJR]KrisFeeD,3238,154,6,7,13,46.2%,27m
11394,3,[LLG]Caribax,3238,86,3,5,8,37.5%,27m
11394,3,Fridrix,3238,90,3,9,12,25.0%,5m
11394,1,[Fluo]MrGold,3238,97,2,2,4,50.0%,51m
11394,1,Kenji,3238,0,1,3,4,25.0%,11m
11394,3,[Arrows]FishOnFire,3238,30,1,5,6,16.7%,11m
11394,2,[RaClan]ChiefCaptain,3238,0,0,1,1,0.0%,1h
11413,3,Ruff,3237,1593,114,101,215,53.0%,12m
11413,3,[TopGS]Doom,3237,837,55,44,99,55.6%,2m
11413,3,[DEDAL]Hydra,3237,1167,49,37,86,57.0%,17m
11413,3,[Pöhn]HibsmyHubs,3237,947,40,30,70,57.1%,17m
11413,3,renren,3237,652,23,34,57,40.4%,8m
11413,3,Eyne,3237,482,21,13,34,61.8%,6m
11413,3,[SC7]sayanel,3237,385,13,13,26,50.0%,10m
11413,3,[BlwJob]Aivr,3237,322,12,12,24,50.0%,7m
11413,3,Dimsos,3237,306,12,16,28,42.9%,28m
11413,3,Lisiy,3237,283,11,2,13,84.6%,19m
11413,3,AcidFalls,3237,173,6,6,12,50.0%,18m
11413,1,RamzesXIII,3237,97,5,2,7,71.4%,2m
11413,3,dionisius,3237,144,5,7,12,41.7%,19m
11413,2,Nomad,3237,96,4,3,7,57.1%,2m
11413,3,[BsG]Lanius,3237,60,3,3,6,50.0%,29m
11413,3,Targus,3237,60,3,3,6,50.0%,12m
11413,3,Xiauio,3237,88,3,9,12,25.0%,27m
11413,3,ThomasTor,3237,30,1,1,2,50.0%,19m
11413,3,[NISHOD]SkiLongLion,3237,30,1,1,2,50.0%,2m
11413,3,HarryFader,3237,30,1,4,5,20.0%,15m
11413,3,Kombat,3237,0,0,1,1,0.0%,17m
11413,3,[GZerO]MarcoDelToro,3237,0,0,2,2,0.0%,27m
11435,3,essusin,3236,1596,82,68,150,54.7%,19m
11435,3,DDmonkey,3236,1144,44,41,85,51.8%,28m
11435,3,Rippon,3236,636,25,30,55,45.5%,7m
11435,3,CountTossula,3236,421,19,12,31,61.3%,5m
11435,3,[Oursbl]Marijenburg,3236,415,16,23,39,41.0%,7m
11435,3,[BSLTW]MasterChief,3236,411,14,13,27,51.9%,3m
11435,3,Mechanicus,3236,167,12,4,16,75.0%,14m
11435,3,Yamazaki,3236,328,12,18,30,40.0%,8m
11435,1,krull,3236,141,6,3,9,66.7%,19m
11435,3,iBaWs,3236,0,4,1,5,80.0%,11m
11435,3,Xinoclash,3236,0,4,1,5,80.0%,1h
11435,3,demonus,3236,30,2,0,2,100.0%,18m
11435,3,mjwYun,3236,0,1,0,1,100.0%,18m
11435,3,Funny,3236,30,1,5,6,16.7%,7m
11435,3,hadesZ,3236,0,0,1,1,0.0%,18m
11435,2,[RZPI]Adam,3236,0,0,1,1,0.0%,10m
11435,3,[G4YoU]SCV,3236,0,0,1,1,0.0%,14m
11452,3,CaptainSqrt,3235,1590,154,149,303,50.8%,17m
11452,3,java,3235,1122,44,42,86,51.2%,11m
11452,3,Leeroy,3235,659,26,19,45,57.8%,28m
11452,3,[T3RR4N]Svelwyn,3235,330,21,18,39,53.8%,9m
11452,3,StarDust,3235,540,21,21,42,50.0%,12m
11452,3,Bismarck,3235,321,16,18,34,47.1%,2m
11452,3,Furexus,3235,337,10,16,26,38.5%,16m
11452,3,ScottyP,3235,148,7,3,10,70.0%,15m
11452,3,AfganUA,3235,125,5,2,7,71.4%,4m
11452,1,[6PhD]ghost,3235,142,3,8,11,27.3%,1h
11452,2,SoVeReiGN,3235,96,2,4,6,33.3%,50m
11452,3,Chatie,3235,0,1,0,1,100.0%,4m
11452,3,[Grays]TheLastGray,3235,30,1,7,8,12.5%,7m
11452,3,Bonospark,3235,0,0,1,1,0.0%,8m
11452,3,Rangleklods,3235,0,0,1,1,0.0%,27m
11452,3,Watrudoin,3235,0,0,2,2,0.0%,4m
11468,3,Nostromo,3234,1440,206,191,397,51.9%,17m
11468,3,Tomtom,3234,815,91,75,166,54.8%,14m
11468,3,Théomède,3234,758,34,38,72,47.2%,3m
11468,3,MoRcHer,3234,624,32,26,58,55.2%,8m
11468,3,IIIIIIIIIIII,3234,499,29,26,55,52.7%,27m
11468,3,Simon,3234,286,20,20,40,50.0%,27m
11468,3,Blipblarg,3234,237,13,13,26,50.0%,27m
11468,3,mysteryH,3234,120,6,2,8,75.0%,2m
11468,3,[GsQ]RzwoDzwo,3234,0,5,0,5,100.0%,12m
11468,3,Sloth,3234,0,5,0,5,100.0%,55m
11468,3,[PLA2N]Reycer,3234,114,5,4,9,55.6%,29m
11468,3,xieqin,3234,0,4,1,5,80.0%,19m
11468,1,Lelouch,3234,119,3,0,3,100.0%,4m
11468,3,schachie,3234,62,2,6,8,25.0%,27m
11468,3,[Farla]wer,3234,0,1,0,1,100.0%,16m
11468,3,Jorun,3234,0,1,0,1,100.0%,29m
11468,2,DeluSiON,3234,0,1,1,2,50.0%,43m
11468,1,llllllllllll,3234,0,0,1,1,0.0%,51m
11468,3,Calambra,3234,0,0,3,3,0.0%,27m
11468,3,[696]ProBEherOboy,3234,0,0,4,4,0.0%,12m
11488,3,grimalk,3233,559,24,22,46,52.2%,8m
11488,3,Defunt,3233,391,15,10,25,60.0%,8m
11488,3,Murena,3233,304,15,12,27,55.6%,4m
11488,3,SSLab,3233,142,7,4,11,63.6%,12m
11488,3,[omnce]NazmoX,3233,160,5,0,5,100.0%,8m
11488,3,SunKnight,3233,0,4,1,5,80.0%,1h
11488,3,[ArsB]NapoléonsD,3233,179,4,8,12,33.3%,7m
11488,3,xen,3233,90,4,8,12,33.3%,5m
11488,3,[Yame]Matisse,3233,0,1,0,1,100.0%,29m
11488,3,Infernalduck,3233,0,1,1,2,50.0%,29m
11488,3,DaS,3233,0,0,1,1,0.0%,18m
11488,3,[GLTD]Scrm,3233,0,0,1,1,0.0%,11m
11488,3,[GNN]TheVikWithin,3233,0,0,1,1,0.0%,15m
11501,3,[E5C]llllliilllll,3232,1299,325,298,623,52.2%,4m
11501,2,[IFAI]NAkamA,3232,1208,279,270,549,50.8%,29m
11501,3,chris,3232,1189,61,60,121,50.4%,19m
11501,3,[ÆR]EbeEndocott,3232,527,27,27,54,50.0%,5m
11501,3,James,3232,334,15,12,27,55.6%,10m
11501,3,TheBabyPixel,3232,243,8,5,13,61.5%,3m
11501,2,ElGranjero,3232,148,8,6,14,57.1%,5m
11501,3,AresNyx,3232,174,7,10,17,41.2%,10m
11501,3,Anhedonia,3232,114,6,2,8,75.0%,27m
11501,3,Starphase,3232,0,4,1,5,80.0%,2m
11501,3,ffffjjjjkkgg,3232,160,4,2,6,66.7%,8m
11501,3,TANOS,3232,106,3,1,4,75.0%,14m
11501,3,Pietrow,3232,60,3,2,5,60.0%,13m
11501,3,Sløïn,3232,58,2,2,4,50.0%,12m
11501,1,Filips,3232,134,2,6,8,25.0%,14m
11501,3,космос,3232,0,1,0,1,100.0%,2m
11501,3,Flammable,3232,0,1,0,1,100.0%,4m
11501,3,[IceHus]Auf,3232,0,1,1,2,50.0%,12m
11501,3,Vlasko,3232,0,0,1,1,0.0%,2m
11520,3,Banan,3231,1429,181,171,352,51.4%,10m
11520,3,WarBuffett,3231,658,83,44,127,65.4%,12m
11520,3,Nozzles,3231,549,40,35,75,53.3%,6m
11520,3,AhtunG,3231,796,29,35,64,45.3%,29m
11520,3,MicroMachine,3231,354,15,11,26,57.7%,16m
11520,3,Zeratul,3231,352,12,14,26,46.2%,12m
11520,3,[MiOwA]WastPowie,3231,206,8,9,17,47.1%,2m
11520,3,[DNKСFТ]RaePiste,3231,137,4,1,5,80.0%,16m
11520,3,Shtab,3231,94,3,3,6,50.0%,19m
11520,3,changhav,3231,0,1,0,1,100.0%,8m
11520,3,WoLfE,3231,0,1,0,1,100.0%,6m
11520,3,IMBateValcho,3231,0,1,1,2,50.0%,2m
11520,3,Iluvatar,3231,30,1,11,12,8.3%,19m
11520,3,llllllllllll,3231,0,0,1,1,0.0%,18m
11520,3,SunGodRa,3231,0,0,1,1,0.0%,15m
11520,3,[NsTt]UrDadIsNice,3231,0,0,2,2,0.0%,18m
11536,2,TGK,3230,1371,265,274,539,49.2%,5m
11536,3,Zottel,3230,1575,106,77,183,57.9%,7m
11536,3,YogSothoth,3230,1097,45,41,86,52.3%,6m
11536,3,YLibelluleG,3230,458,28,21,49,57.1%,16m
11536,3,Time,3230,457,19,7,26,73.1%,27m
11536,3,Capella,3230,368,15,11,26,57.7%,3m
11536,3,SilverLeague,3230,334,14,4,18,77.8%,3m
11536,3,[FCSInc]CommanderAxe,3230,328,12,8,20,60.0%,4m
11536,2,rapines,3230,280,10,4,14,71.4%,13m
11536,3,Battlebro,3230,253,8,4,12,66.7%,17m
11536,3,RockBest,3230,157,7,3,10,70.0%,19m
11536,3,[8000ms]fenfenzhong,3230,176,7,5,12,58.3%,11m
11536,2,Croissant,3230,118,5,2,7,71.4%,1h
11536,3,[RusLv]VoVan,3230,0,3,2,5,60.0%,15m
11536,3,UMXNOZ,3230,58,3,3,6,50.0%,18m
11536,2,POLO,3230,90,2,2,4,50.0%,16m
11536,1,[Plat0n]Absum,3230,46,1,6,7,14.3%,13m
11536,3,[ABOMB]Gadget,3230,0,0,3,3,0.0%,19m
11554,3,Csabesz,3229,1386,168,145,313,53.7%,6m
11554,3,Kahiros,3229,1580,112,90,202,55.4%,6m
11554,3,Shinryo,3229,1460,101,112,213,47.4%,17m
11554,3,Heinz,3229,549,75,69,144,52.1%,9m
11554,3,TeilobRUN,3229,806,48,44,92,52.2%,16m
11554,3,Yooky,3229,895,40,28,68,58.8%,2m
11554,3,[PLCM]RuNNit,3229,898,35,28,63,55.6%,6m
11554,3,[13g12p]SnaKe,3229,624,25,19,44,56.8%,16m
11554,3,Coffeeman,3229,389,14,11,25,56.0%,7m
11554,3,Richizard,3229,343,12,8,20,60.0%,15m
11554,3,[NemID]Ucar,3229,215,8,14,22,36.4%,4m
11554,3,SuperBaker,3229,0,4,1,5,80.0%,19m
11554,3,[MWAF]fanzuu,3229,144,3,7,10,30.0%,11m
11554,3,[SURR]elHuron,3229,30,2,2,4,50.0%,17m
11554,3,[DМG]BerryBee,3229,60,2,4,6,33.3%,16m
11554,3,kriGGus,3229,0,1,0,1,100.0%,19m
11554,3,neptun,3229,0,1,0,1,100.0%,9m
11554,3,whonoobtheme,3229,0,1,0,1,100.0%,3m
11554,3,[NWGD]IIIIIIIIIIII,3229,0,0,1,1,0.0%,5m
11573,3,[GFXM]JackDaniel,3228,1027,42,32,74,56.8%,28m
11573,3,AntMan,3228,379,17,23,40,42.5%,14m
11573,2,Silock,3228,314,14,8,22,63.6%,8m
11573,3,Nemesis,3228,75,7,11,18,38.9%,9m
11573,3,kFog,3228,0,4,1,5,80.0%,1h
11573,3,[GMT]darkcrafter,3228,58,2,2,4,50.0%,27m
11573,3,XSC,3228,30,2,3,5,40.0%,2m
11573,3,millivoje,3228,0,2,3,5,40.0%,18m
11573,3,AlexLock,3228,0,2,3,5,40.0%,10m
11573,3,[bHumbL]Wildfire,3228,0,1,0,1,100.0%,5m
11573,3,dolmio,3228,0,1,0,1,100.0%,10m
11573,2,Shorthusky,3228,0,0,1,1,0.0%,1h
11585,3,Mss,3227,1553,294,280,574,51.2%,14m
11585,2,Masquerade,3227,1478,93,94,187,49.7%,10m
11585,3,exile,3227,826,50,41,91,54.9%,5m
11585,3,ATmSuperStar,3227,882,39,26,65,60.0%,4m
11585,3,KazioWichura,3227,349,30,23,53,56.6%,16m
11585,3,sweet,3227,405,17,13,30,56.7%,2m
11585,3,chicken,3227,175,12,15,27,44.4%,9m
11585,3,[SWJTU]KZGamingXY,3227,237,10,6,16,62.5%,18m
11585,3,[SLeo]ostroym,3227,0,5,0,5,100.0%,48m
11585,3,[RGSC2]DeadSky,3227,146,5,6,11,45.5%,27m
11585,3,KnowKnight,3227,30,1,1,2,50.0%,18m
11585,3,shagernaut,3227,30,1,2,3,33.3%,10m
11585,3,llllllllllll,3227,0,0,1,1,0.0%,16m
11598,3,Wasiu,3226,1514,158,155,313,50.5%,5m
11598,3,[WINFUN]GrandMoD,3226,985,151,118,269,56.1%,19m
11598,3,IndyLiGHT,3226,1408,68,62,130,52.3%,28m
11598,3,Patoshik,3226,1022,42,36,78,53.8%,4m
11598,3,dReAmEr,3226,599,33,31,64,51.6%,14m
11598,3,WaitWhat,3226,413,22,18,40,55.0%,5m
11598,3,zed,3226,492,19,17,36,52.8%,5m
11598,3,Draywer,3226,406,15,16,31,48.4%,7m
11598,3,MikeHawk,3226,194,6,6,12,50.0%,17m
11598,3,Leagon,3226,189,5,5,10,50.0%,8m
11598,3,fred,3226,150,5,9,14,35.7%,17m
11598,3,Lola,3226,60,2,2,4,50.0%,4m
11598,3,SovietSuprem,3226,0,1,1,2,50.0%,4m
11598,2,[Bü]Arcanis,3226,95,1,1,2,50.0%,1h
11598,1,[jopete]CodyTroll,3226,0,0,1,1,0.0%,11m
11598,3,[SCOTS]Sarat,3226,0,0,1,1,0.0%,29m
11598,3,whYAsk,3226,0,0,1,1,0.0%,12m
11615,3,pewy,3225,1596,205,179,384,53.4%,2m
11615,3,qoobic,3225,1082,50,46,96,52.1%,19m
11615,3,StuckPlat,3225,833,39,22,61,63.9%,17m
11615,3,[Arrows]Oleggius,3225,508,19,19,38,50.0%,2m
11615,3,Ernestori,3225,494,18,20,38,47.4%,18m
11615,3,[KhSo]Pierre,3225,308,12,11,23,52.2%,18m
11615,3,Nikitiiy,3225,150,7,7,14,50.0%,9m
11615,3,Qumpei,3225,0,5,0,5,100.0%,5m
11615,2,Sugar,3225,95,5,2,7,71.4%,20m
11615,3,[РRОxy]WannaBeMaru,3225,86,3,3,6,50.0%,9m
11615,2,BenjyX,3225,38,2,1,3,66.7%,10m
11615,3,[WCKYLN]UnkendeUschi,3225,62,2,6,8,25.0%,12m
11615,3,feDOs,3225,0,1,1,2,50.0%,12m
11615,3,[NТB]ZergsPaPa,3225,30,1,1,2,50.0%,12m
11615,3,CONNOR,3225,30,1,2,3,33.3%,30m
11630,3,[BURIZA]mercurio,3224,1379,189,154,343,55.1%,3m
11630,3,Hahaha,3224,1562,113,95,208,54.3%,30m
11630,3,[Arrows]Ururu,3224,1392,103,105,208,49.5%,13m
11630,3,Proquiv,3224,1359,95,86,181,52.5%,14m
11630,3,Tuymaada,3224,1582,77,83,160,48.1%,27m
11630,3,Joles,3224,1467,70,73,143,49.0%,14m
11630,3,Belazhur,3224,379,18,4,22,81.8%,8m
11630,3,notcool,3224,185,12,5,17,70.6%,29m
11630,1,[ЗИБиАГ]Dream,3224,234,10,3,13,76.9%,11m
11630,3,PJB,3224,202,8,9,17,47.1%,17m
11630,3,PaKe,3224,167,6,3,9,66.7%,4m
11630,3,ZeroMarine,3224,199,6,4,10,60.0%,6m
11630,2,XiLo,3224,94,5,2,7,71.4%,9m
11630,3,Bio,3224,142,5,7,12,41.7%,4m
11630,3,[PænAm]Vrowgh,3224,150,5,9,14,35.7%,28m
11630,3,DukeNukeThem,3224,139,4,1,5,80.0%,10m
11630,3,[lMVl]GuilhemF,3224,30,2,3,5,40.0%,19m
11630,3,GenEthic,3224,50,2,5,7,28.6%,11m
11630,3,Sovereign,3224,0,1,0,1,100.0%,19m
11630,2,PolyMorpH,3224,0,0,5,5,0.0%,7m
11650,3,[PÂRłAH]FYA,3223,1564,322,324,646,49.8%,19m
11650,3,Cortex,3223,1182,179,152,331,54.1%,6m
11650,3,ihavetheorb,3223,1572,104,83,187,55.6%,7m
11650,3,oggbonaian,3223,1092,93,84,177,52.5%,19m
11650,3,[Lowko]Dinouu,3223,1541,85,96,181,47.0%,30m
11650,3,MRJ,3223,659,53,46,99,53.5%,28m
11650,3,QubedAces,3223,1310,51,56,107,47.7%,10m
11650,3,DrAcula,3223,995,44,31,75,58.7%,5m
11650,3,precisionist,3223,508,44,34,78,56.4%,19m
11650,3,[PiGPan]Mehrbauer,3223,683,43,38,81,53.1%,19m
11650,3,[AnD]HeartCore,3223,915,40,37,77,51.9%,3m
11650,3,[LUSSR]grishalot,3223,424,39,33,72,54.2%,6m
11650,3,Fereniousis,3223,970,39,42,81,48.1%,2m
11650,3,Notorious,3223,670,29,20,49,59.2%,8m
11650,3,Geroz,3223,574,28,36,64,43.8%,18m
11650,3,[RBlood]Ninjuke,3223,467,26,11,37,70.3%,12m
11650,3,IIIIIIII,3223,648,25,24,49,51.0%,9m
11650,3,[EmpG]Tukutuk,3223,516,23,15,38,60.5%,16m
11650,3,Cheeky,3223,377,14,9,23,60.9%,10m
11650,3,mgh,3223,294,12,14,26,46.2%,8m
11650,3,Fab,3223,232,9,22,31,29.0%,27m
11650,3,HIDARION,3223,172,6,2,8,75.0%,8m
11650,3,[6RD4]Antik,3223,140,5,6,11,45.5%,12m
11650,3,Machetos,3223,30,2,0,2,100.0%,17m
11650,3,sarcaztizm,3223,30,1,4,5,20.0%,19m
11650,3,[GoGoL]Stup,3223,0,0,1,1,0.0%,27m
11650,3,MaadA,3223,0,0,1,1,0.0%,6m
11650,3,Slashman,3223,0,0,1,1,0.0%,26m
11650,3,[DZTK]RagnaroekIV,3223,0,0,1,1,0.0%,12m
11650,3,[1POL]BaKsORO,3223,0,0,2,2,0.0%,7m
11650,3,[CUTY]JayDee,3223,0,0,5,5,0.0%,7m
11681,3,erftyh,3222,1466,319,315,634,50.3%,4m
11681,3,Mengsk,3222,1605,200,186,386,51.8%,12m
11681,3,Maxella,3222,1023,177,156,333,53.2%,7m
11681,3,PhX,3222,903,60,61,121,49.6%,29m
11681,3,Comodoro,3222,915,41,31,72,56.9%,16m
11681,3,ladnopoka,3222,261,37,20,57,64.9%,4m
11681,3,DoomGuy,3222,671,36,21,57,63.2%,2m
11681,3,SpinweB,3222,798,34,25,59,57.6%,4m
11681,3,Laaba,3222,426,25,12,37,67.6%,6m
11681,3,Isk,3222,543,20,18,38,52.6%,16m
11681,3,ZeuBy,3222,428,15,16,31,48.4%,18m
11681,3,MapleJoe,3222,342,15,19,34,44.1%,11m
11681,3,Duke,3222,164,11,7,18,61.1%,18m
11681,3,[STDES]pingponghero,3222,254,10,10,20,50.0%,28m
11681,3,azanta,3222,228,7,6,13,53.8%,6m
11681,3,Havane,3222,90,4,4,8,50.0%,29m
11681,3,[NMF]NiamoR,3222,127,3,6,9,33.3%,11m
11681,3,Max,3222,30,2,1,3,66.7%,4m
11681,3,Destructor,3222,30,2,1,3,66.7%,2m
11681,3,forest,3222,30,2,3,5,40.0%,5m
11681,3,MvanBommel,3222,30,2,3,5,40.0%,3m
11681,1,Herodotus,3222,0,1,0,1,100.0%,5m
11681,3,llllllllllll,3222,0,1,1,2,50.0%,12m
11681,3,[CHICKZ]Hohiro,3222,0,1,1,2,50.0%,8m
11681,3,Harison,3222,0,0,1,1,0.0%,18m
11681,3,[PiGPan]Kirby,3222,0,0,1,1,0.0%,15m
11707,3,ShorF,3221,1525,336,335,671,50.1%,12m
11707,3,Guardian,3221,1559,274,269,543,50.5%,10m
11707,3,GodsRage,3221,1380,132,116,248,53.2%,12m
11707,3,Deftey,3221,1539,92,76,168,54.8%,27m
11707,3,TorresK,3221,1215,51,39,90,56.7%,12m
11707,3,Voodoochilli,3221,1286,49,54,103,47.6%,19m
11707,3,OttavAugusto,3221,1170,47,38,85,55.3%,11m
11707,3,Rammstein,3221,812,44,37,81,54.3%,19m
11707,3,[lolw0t]Vegan,3221,768,42,38,80,52.5%,27m
11707,3,[BWArmy]yaze,3221,754,36,17,53,67.9%,9m
11707,3,Nord,3221,588,25,22,47,53.2%,5m
11707,3,[TBPZDA]ElDistortion,3221,541,23,25,48,47.9%,6m
11707,3,Rennick,3221,366,18,4,22,81.8%,12m
11707,3,Hubert,3221,506,18,19,37,48.6%,29m
11707,3,Stakerrt,3221,401,17,6,23,73.9%,15m
11707,3,Pradazutra,3221,269,13,20,33,39.4%,6m
11707,3,[HFR]Dex,3221,132,12,12,24,50.0%,4m
11707,3,MindOf,3221,183,8,3,11,72.7%,10m
11707,3,Moree,3221,171,6,1,7,85.7%,8m
11707,3,Osamá,3221,0,4,1,5,80.0%,11m
11707,3,Sobber,3221,0,4,1,5,80.0%,29m
11707,3,[Mozart]DirTyMoOnKeY,3221,140,4,2,6,66.7%,4m
11707,1,VIP,3221,97,3,6,9,33.3%,17m
11707,3,Starker,3221,88,3,8,11,27.3%,16m
11707,3,[InFy]Grisha,3221,94,2,0,2,100.0%,7m
11707,3,BZzZzZ,3221,30,2,1,3,66.7%,4m
11707,3,Awegasm,3221,58,2,3,5,40.0%,5m
11707,3,Celenos,3221,0,1,0,1,100.0%,15m
11707,3,ElunMosk,3221,30,1,7,8,12.5%,27m
11707,3,Geradon,3221,0,0,2,2,0.0%,2m
11737,3,ANT,3220,1585,208,167,375,55.5%,15m
11737,3,Negotiator,3220,1349,172,152,324,53.1%,29m
11737,3,DANUKA,3220,878,154,140,294,52.4%,3m
11737,3,Smoke,3220,1601,117,112,229,51.1%,9m
11737,3,[BornG]levver,3220,1088,83,62,145,57.2%,2m
11737,3,Caykus,3220,1466,69,56,125,55.2%,14m
11737,3,Jaggernout,3220,1027,50,29,79,63.3%,17m
11737,3,[яєѕ]mandalore,3220,1143,50,44,94,53.2%,15m
11737,3,[ZBL]Møunii,3220,323,49,39,88,55.7%,12m
11737,3,scaR,3220,855,36,31,67,53.7%,19m
11737,3,[TheDOH]aMacro,3220,568,23,18,41,56.1%,16m
11737,3,[Fruz]Striker,3220,189,13,13,26,50.0%,28m
11737,3,[V1]laktoz,3220,341,12,9,21,57.1%,5m
11737,3,Vestnik,3220,131,6,3,9,66.7%,30m
11737,3,BronzeFaust,3220,0,4,1,5,80.0%,12m
11737,3,Kraven,3220,0,4,1,5,80.0%,51m
11737,3,Dmitriions,3220,120,4,10,14,28.6%,8m
11737,3,Xcellence,3220,0,1,1,2,50.0%,27m
11755,3,Prinf,3219,1421,142,135,277,51.3%,13m
11755,3,killyou,3219,846,48,27,75,64.0%,10m
11755,3,[WTEu]ShaQAttacK,3219,570,24,13,37,64.9%,11m
11755,3,[Blacer]InnosGothic,3219,523,19,17,36,52.8%,29m
11755,3,Agradar,3219,504,19,22,41,46.3%,13m
11755,3,Take,3219,369,18,15,33,54.5%,5m
11755,3,Quick,3219,349,13,11,24,54.2%,5m
11755,3,[QTASY]ZzEerRoO,3219,93,6,0,6,100.0%,19m
11755,3,Harkenstøne,3219,114,5,4,9,55.6%,18m
11755,3,DOFLAMINGO,3219,94,2,0,2,100.0%,29m
11755,2,SupaMug,3219,0,1,0,1,100.0%,8m
11755,1,NiCeViBeZZ,3219,96,1,1,2,50.0%,14m
11755,3,czarek,3219,0,0,1,1,0.0%,7m
11755,3,Furianin,3219,0,0,1,1,0.0%,19m
11755,3,lllllllllll,3219,0,0,2,2,0.0%,5m
11770,3,[KUKA]kela,3218,1576,364,365,729,49.9%,9m
11770,3,Hanekawa,3218,1575,213,178,391,54.5%,4m
11770,3,Veretragna,3218,1568,183,173,356,51.4%,7m
11770,3,[QZC]Falamir,3218,1048,77,87,164,47.0%,28m
11770,2,[RstE]Témelios,3218,1144,66,77,143,46.2%,18m
11770,3,TeamHoneyBee,3218,1113,63,10,73,86.3%,5m
11770,3,McWigg,3218,1304,55,55,110,50.0%,3m
11770,3,Psyduck,3218,594,53,39,92,57.6%,7m
11770,3,lrt,3218,1436,50,60,110,45.5%,28m
11770,3,KamIdZu,3218,526,39,45,84,46.4%,6m
11770,3,prettymofukk,3218,795,34,28,62,54.8%,14m
11770,3,NLBTW,3218,763,33,23,56,58.9%,17m
11770,3,Milczek,3218,748,26,29,55,47.3%,27m
11770,3,Wickson,3218,330,15,12,27,55.6%,11m
11770,3,Herbstleyden,3218,287,11,5,16,68.8%,17m
11770,2,[Jiggel]VibeScholar,3218,325,11,7,18,61.1%,11m
11770,1,Aginor,3218,118,6,3,9,66.7%,27m
11770,3,[lkub]Brifie,3218,196,5,5,10,50.0%,10m
11770,3,Dasen,3218,135,4,0,4,100.0%,15m
11770,3,Колька,3218,134,4,2,6,66.7%,11m
11770,3,InvisTM,3218,60,3,3,6,50.0%,15m
11770,3,TigerusX,3218,84,1,1,2,50.0%,14m
11792,3,Madison,3217,594,201,165,366,54.9%,5m
11792,3,[Øpium]karembas,3217,1493,163,156,319,51.1%,12m
11792,3,Stoks,3217,742,71,60,131,54.2%,12m
11792,3,Atoli,3217,604,26,17,43,60.5%,3m
11792,3,Malygos,3217,359,15,6,21,71.4%,7m
11792,3,ZLOgva,3217,398,14,22,36,38.9%,10m
11792,3,Zerg,3217,308,13,3,16,81.2%,18m
11792,3,[Bambi2]FatGirl,3217,307,13,9,22,59.1%,27m
11792,3,[UCHIНA]Pekker,3217,263,12,7,19,63.2%,6m
11792,3,Nukular,3217,208,10,6,16,62.5%,14m
11792,3,[GET]kYs,3217,264,10,11,21,47.6%,12m
11792,3,[LV]lolsteamroll,3217,209,9,6,15,60.0%,18m
11792,3,Flux,3217,222,6,6,12,50.0%,17m
11792,3,Huchira,3217,118,4,8,12,33.3%,5m
11792,3,PaGo,3217,88,3,6,9,33.3%,17m
11792,3,wzl,3217,93,2,0,2,100.0%,14m
11792,3,Eroune,3217,115,2,2,4,50.0%,19m
11792,3,[CARCAS]Apocalypse,3217,0,0,1,1,0.0%,30m
11792,3,[Specii]Shadow,3217,0,0,1,1,0.0%,14m
11811,3,[ORLCY]NickAce,3216,1596,226,205,431,52.4%,16m
11811,3,Molybdenum,3216,1267,83,61,144,57.6%,6m
11811,3,Nik,3216,1576,71,51,122,58.2%,6m
11811,3,BlackEase,3216,932,62,50,112,55.4%,27m
11811,3,Thurlogus,3216,1134,58,42,100,58.0%,27m
11811,3,Chroma,3216,668,25,28,53,47.2%,29m
11811,3,Camllet,3216,168,21,11,32,65.6%,2m
11811,3,CIA,3216,554,21,20,41,51.2%,5m
11811,3,Bamboo,3216,434,17,12,29,58.6%,12m
11811,3,Zero,3216,248,12,14,26,46.2%,29m
11811,3,Denkan,3216,113,6,2,8,75.0%,15m
11811,3,Zukin,3216,148,6,5,11,54.5%,19m
11811,3,trolinglife,3216,61,6,6,12,50.0%,17m
11811,3,karaya,3216,0,5,0,5,100.0%,8m
11811,3,[Zorg]Oldben,3216,169,4,4,8,50.0%,11m
11811,3,RuSh,3216,132,4,5,9,44.4%,6m
11811,3,Zodiac,3216,114,3,3,6,50.0%,9m
11811,3,[DéKá]Chose,3216,60,3,4,7,42.9%,8m
11811,3,Sindorus,3216,114,2,2,4,50.0%,2m
11811,2,[RØFNEX]Paukum,3216,0,1,0,1,100.0%,8m
11811,3,Never,3216,0,1,0,1,100.0%,27m
11811,3,Rickoshet,3216,0,1,0,1,100.0%,3m
11811,3,Fomich,3216,0,1,0,1,100.0%,10m
11811,3,[RSClan]klakier,3216,0,1,1,2,50.0%,28m
11811,3,Forsaken,3216,0,0,1,1,0.0%,14m
11811,3,saSHOK,3216,0,0,4,4,0.0%,4m
11837,3,llllllllllll,3215,1549,252,234,486,51.9%,2m
11837,3,[Heroes]CrashDragon,3215,1548,148,104,252,58.7%,30m
11837,3,IIIIIIIIIIII,3215,904,135,118,253,53.4%,17m
11837,3,abadascat,3215,1231,96,86,182,52.7%,7m
11837,3,SaintGeorgy,3215,1559,87,80,167,52.1%,4m
11837,3,Scutchi,3215,1052,61,49,110,55.5%,19m
11837,3,IIIIIIIIII,3215,1200,53,46,99,53.5%,2m
11837,3,AnotherAngel,3215,1254,53,58,111,47.7%,11m
11837,3,Arton,3215,660,48,35,83,57.8%,27m
11837,3,ItsProblem,3215,329,12,9,21,57.1%,5m
11837,3,LoRi,3215,117,8,5,13,61.5%,16m
11837,3,[Пчелки]ГоловaчЛенa,3215,153,4,1,5,80.0%,11m
11837,3,Olaf,3215,0,4,1,5,80.0%,8m
11837,3,Aloura,3215,60,4,5,9,44.4%,15m
11837,3,[QTcIub]Guguizg,3215,97,2,3,5,40.0%,5m
11837,3,Exray,3215,0,1,3,4,25.0%,5m
11837,3,Kriukof,3215,0,0,1,1,0.0%,17m
11854,3,GhostKiller,3214,1453,213,220,433,49.2%,12m
11854,3,[CTLF]Idoria,3214,1369,119,119,238,50.0%,3m
11854,3,Billiboyed,3214,1400,111,96,207,53.6%,4m
11854,3,Thea,3214,1095,65,52,117,55.6%,18m
11854,3,Brodyaga,3214,698,31,20,51,60.8%,15m
11854,3,Xado,3214,625,24,23,47,51.1%,27m
11854,3,Rolly,3214,410,21,4,25,84.0%,2m
11854,2,[QuBuS]QuBuS,3214,370,17,6,23,73.9%,17m
11854,3,NiKitaLox,3214,428,17,10,27,63.0%,2m
11854,3,Konkers,3214,314,11,11,22,50.0%,8m
11854,3,[C02133]phil,3214,259,10,3,13,76.9%,11m
11854,3,Sixset,3214,261,9,6,15,60.0%,2m
11854,3,[RGSC2]StraTov,3214,224,8,3,11,72.7%,6m
11854,3,NoNamesLeft,3214,198,7,16,23,30.4%,8m
11854,2,Cityplanning,3214,139,6,3,9,66.7%,1h
11854,3,RazorBeak,3214,97,3,3,6,50.0%,9m
11854,3,Ezekiel,3214,93,2,0,2,100.0%,15m
11854,3,Hildisvíni,3214,112,2,1,3,66.7%,18m
11854,3,LukePL,3214,30,2,3,5,40.0%,18m
11854,3,Tbone,3214,95,1,1,2,50.0%,19m
11854,1,SevereCrab,3214,97,1,3,4,25.0%,57m
11854,3,WmTr,3214,0,0,1,1,0.0%,8m
11854,3,[fuktea]abc,3214,0,0,1,1,0.0%,13m
11854,3,[OCTANE]Shemet,3214,0,0,3,3,0.0%,18m
11878,3,neverfailed,3213,1398,149,149,298,50.0%,29m
11878,3,[FARLIG]LavaPrut,3213,1062,84,98,182,46.2%,28m
11878,3,Perol,3213,906,83,65,148,56.1%,8m
11878,3,Sambo,3213,762,74,67,141,52.5%,27m
11878,3,Zet,3213,1587,70,72,142,49.3%,27m
11878,3,GANS,3213,870,57,64,121,47.1%,29m
11878,3,Savoir,3213,884,37,32,69,53.6%,18m
11878,3,[SCHMUU]aRe,3213,908,33,35,68,48.5%,30m
11878,3,Nord,3213,570,25,20,45,55.6%,2m
11878,3,Spacetime,3213,704,24,35,59,40.7%,11m
11878,3,[ЕПРСТ]JuGGler,3213,112,16,7,23,69.6%,27m
11878,3,[NeMoKi]DarKside,3213,377,13,16,29,44.8%,16m
11878,1,LiquidTaeJa,3213,187,8,4,12,66.7%,44m
11878,3,PaPaCharly,3213,144,7,3,10,70.0%,19m
11878,3,Нубас,3213,0,4,1,5,80.0%,17m
11878,1,AviatioN,3213,120,2,1,3,66.7%,19m
11878,3,Divinesteel,3213,0,0,2,2,0.0%,14m
11878,3,Daedalus,3213,0,0,3,3,0.0%,19m
11878,3,[SayMe]meow,3213,0,0,5,5,0.0%,27m
11897,3,voileipa,3212,1581,170,167,337,50.4%,8m
11897,3,MaxD,3212,592,86,73,159,54.1%,4m
11897,2,Lion,3212,1236,68,85,153,44.4%,14m
11897,3,Anarchista,3212,929,58,65,123,47.2%,11m
11897,3,KdxE,3212,751,30,28,58,51.7%,27m
11897,3,[duсks]ńøṫƁẏûÑ,3212,450,27,0,27,100.0%,4m
11897,3,LaatMaarZijn,3212,543,24,18,42,57.1%,7m
11897,3,ExploiD,3212,575,23,15,38,60.5%,2m
11897,3,Bejebas,3212,394,16,12,28,57.1%,7m
11897,3,[lOoOl]NukeLord,3212,337,14,6,20,70.0%,28m
11897,3,[13NRV]valithor,3212,404,14,14,28,50.0%,11m
11897,3,Piratuga,3212,240,8,6,14,57.1%,14m
11897,3,Banda,3212,204,7,8,15,46.7%,11m
11897,3,[MYMAN]RabiesBabies,3212,86,3,9,12,25.0%,18m
11897,3,[xAngry]angrythomap,3212,30,1,3,4,25.0%,16m
11897,3,[spbila]Adama,3212,0,0,1,1,0.0%,11m
11897,3,Freezlite,3212,0,0,1,1,0.0%,6m
11897,3,oZee,3212,0,0,1,1,0.0%,27m
11897,3,PistolStar,3212,0,0,3,3,0.0%,27m
11916,3,SCIIFool,3211,1650,647,650,1297,49.9%,28m
11916,3,GeneralWang,3211,1576,286,272,558,51.3%,17m
11916,3,Binichnich,3211,707,89,52,141,63.1%,13m
11916,3,Basik,3211,869,74,64,138,53.6%,18m
11916,3,[PaniC]NotMe,3211,826,52,25,77,67.5%,16m
11916,3,sergio,3211,606,50,45,95,52.6%,18m
11916,3,[PLA2N]barcode,3211,865,38,26,64,59.4%,4m
11916,3,Ростик,3211,657,35,24,59,59.3%,5m
11916,3,WaSaBi,3211,882,33,31,64,51.6%,27m
11916,3,Heuner,3211,192,30,20,50,60.0%,17m
11916,3,[GRiM]Sonny,3211,593,25,17,42,59.5%,18m
11916,3,[SCDHun]Zesedar,3211,451,21,13,34,61.8%,7m
11916,3,pblscbr,3211,131,20,15,35,57.1%,5m
11916,3,Darota,3211,534,19,18,37,51.4%,12m
11916,3,МОРОЖЕНКО,3211,372,17,13,30,56.7%,5m
11916,3,Vesgarom,3211,300,10,10,20,50.0%,27m
11916,3,[ENQ]Rayben,3211,269,9,8,17,52.9%,14m
11916,3,kontur,3211,234,8,18,26,30.8%,12m
11916,3,[Krusti]Tjolof,3211,212,7,10,17,41.2%,27m
11916,3,Gillesberg,3211,189,6,4,10,60.0%,17m
11916,3,Tessio,3211,191,6,5,11,54.5%,11m
11916,3,Dabra,3211,192,5,5,10,50.0%,8m
11916,3,Mimistra,3211,116,4,6,10,40.0%,18m
11916,3,[Petrus]Скребкокрыл,3211,97,3,1,4,75.0%,47m
11916,3,WhiteFangmsi,3211,60,3,3,6,50.0%,27m
11916,3,ImaBawsGG,3211,30,2,10,12,16.7%,4m
11916,3,[Rol3kg]Jopa,3211,0,1,0,1,100.0%,19m
11916,3,[ToZea]StarKiller,3211,0,1,0,1,100.0%,9m
11916,3,ZeusOkay,3211,0,1,0,1,100.0%,13m
11916,3,ZhouYu,3211,0,1,4,5,20.0%,5m
11916,3,ofp,3211,0,0,1,1,0.0%,13m
11916,3,BabyPartinG,3211,0,0,2,2,0.0%,8m
11916,3,WrongSide,3211,0,0,4,4,0.0%,11m
11916,2,Zillah,3211,0,0,7,7,0.0%,17m
11950,2,zocker,3210,1578,774,783,1557,49.7%,6m
11950,3,LifeEvil,3210,1570,196,166,362,54.1%,4m
11950,3,McgregorJR,3210,1511,134,108,242,55.4%,7m
11950,3,Serotonin,3210,960,117,113,230,50.9%,7m
11950,3,[cIPOL]JajaMuHarata,3210,1000,76,86,162,46.9%,5m
11950,3,SixGuns,3210,867,75,64,139,54.0%,3m
11950,3,[PiGPan]DuBs,3210,1424,58,53,111,52.3%,4m
11950,3,[TA01]BLiTzKriEg,3210,1286,48,50,98,49.0%,10m
11950,3,Talismancheg,3210,1086,46,36,82,56.1%,27m
11950,3,Rotnacum,3210,810,34,24,58,58.6%,8m
11950,3,OptimusPrime,3210,703,29,24,53,54.7%,14m
11950,3,[Z3RGML]GuessWho,3210,322,28,21,49,57.1%,20m
11950,3,[AiRǂ]SaveAz,3210,632,24,21,45,53.3%,2m
11950,3,Ansenlong,3210,219,8,4,12,66.7%,4m
11950,3,[IceHus]KartofunSumy,3210,152,6,7,13,46.2%,10m
11950,3,Donkrawallo,3210,109,5,2,7,71.4%,12m
11950,3,[AllDiv]XIV,3210,179,5,4,9,55.6%,15m
11950,3,Rakso,3210,58,3,2,5,60.0%,19m
11950,3,Liquid,3210,104,3,8,11,27.3%,18m
11950,1,[SOJUI]Pkbg,3210,48,2,8,10,20.0%,1h
11950,3,kBen,3210,0,1,1,2,50.0%,3m
11950,3,NENEKO,3210,95,1,1,2,50.0%,18m
11950,3,SentryKing,3210,30,1,2,3,33.3%,8m
11973,3,KaskyR,3209,679,117,104,221,52.9%,4m
11973,3,[Islay]PeatyZzz,3209,1371,97,81,178,54.5%,7m
11973,3,Zeltzn,3209,386,79,67,146,54.1%,11m
11973,3,FleetCommand,3209,486,54,45,99,54.5%,18m
11973,3,Kahlos,3209,742,35,24,59,59.3%,9m
11973,3,[FR1]BIGhiiiiiit,3209,397,18,10,28,64.3%,16m
11973,3,Dislife,3209,377,17,10,27,63.0%,12m
11973,3,[NEWS]Moryow,3209,428,16,14,30,53.3%,4m
11973,3,MsWho,3209,198,10,4,14,71.4%,18m
11973,3,Dominion,3209,159,6,1,7,85.7%,13m
11973,1,LadyGaga,3209,143,6,4,10,60.0%,12m
11973,3,SmoykiArt,3209,0,5,0,5,100.0%,9m
11973,3,Naked,3209,163,4,4,8,50.0%,12m
11973,3,[DOP]Luke,3209,142,3,2,5,60.0%,18m
11973,3,Robute,3209,60,3,4,7,42.9%,2m
11973,3,IIIIIIIIIIII,3209,115,2,1,3,66.7%,11m
11973,2,LGstick,3209,39,2,2,4,50.0%,19m
11973,3,Shinluu,3209,0,2,3,5,40.0%,18m
11973,3,DrmKeeper,3209,30,2,3,5,40.0%,18m
11973,3,AzuAzu,3209,94,1,1,2,50.0%,11m
11973,3,[EAU]TOBIRAIIIIII,3209,0,1,4,5,20.0%,28m
11973,3,Rombrant,3209,0,0,2,2,0.0%,27m
11995,3,Drterran,3208,1310,172,129,301,57.1%,16m
11995,3,Lefsa,3208,1130,156,132,288,54.2%,4m
11995,3,SKiPLiP,3208,1546,149,162,311,47.9%,27m
11995,3,Kano,3208,1508,140,132,272,51.5%,27m
11995,3,Caponetti,3208,1144,73,75,148,49.3%,8m
11995,3,Raid,3208,1298,72,65,137,52.6%,7m
11995,3,Canartitude,3208,1228,65,68,133,48.9%,3m
11995,3,[TheDW1]Darkspore,3208,713,30,24,54,55.6%,18m
11995,3,Keller,3208,607,26,23,49,53.1%,14m
11995,3,[202pop]kip,3208,453,19,11,30,63.3%,14m
11995,3,Stelios,3208,323,12,11,23,52.2%,3m
11995,3,Legion,3208,276,10,6,16,62.5%,8m
11995,3,BadBlueBoy,3208,175,8,3,11,72.7%,27m
11995,2,[DiCoTe]Architecte,3208,270,8,14,22,36.4%,6m
11995,3,McTellious,3208,218,7,7,14,50.0%,29m
11995,3,Минск,3208,150,5,7,12,41.7%,17m
11995,3,Bobbyone,3208,148,5,12,17,29.4%,10m
11995,3,NikoN,3208,94,4,2,6,66.7%,12m
11995,3,OceloT,3208,88,4,4,8,50.0%,12m
11995,3,[JBMr]jeta,3208,30,2,5,7,28.6%,12m
11995,3,Achille,3208,0,0,1,1,0.0%,13m
12016,3,Petr,3207,957,86,79,165,52.1%,18m
12016,3,Sibe,3207,935,72,79,151,47.7%,11m
12016,3,ProfChaos,3207,857,71,67,138,51.4%,12m
12016,3,[eXGE]cabris,3207,1592,60,57,117,51.3%,18m
12016,3,AdriaN,3207,727,58,44,102,56.9%,26m
12016,3,Sonic,3207,1205,53,63,116,45.7%,4m
12016,3,NoobUltime,3207,263,32,17,49,65.3%,11m
12016,3,heel,3207,411,32,28,60,53.3%,17m
12016,3,Chad,3207,589,30,5,35,85.7%,7m
12016,3,Tetsu,3207,791,30,24,54,55.6%,17m
12016,3,cyberstorm,3207,712,27,28,55,49.1%,3m
12016,3,[XiSPoo]NesboCZ,3207,712,26,26,52,50.0%,4m
12016,3,[Vioc]STAROS,3207,462,16,15,31,51.6%,29m
12016,3,Razzkarpète,3207,305,14,7,21,66.7%,4m
12016,3,MMA,3207,374,14,11,25,56.0%,17m
12016,2,Evlogos,3207,222,9,13,22,40.9%,17m
12016,1,Mistake,3207,164,7,5,12,58.3%,5m
12016,3,[TTTTS]LoiCCC,3207,120,5,7,12,41.7%,19m
12016,3,abis,3207,144,5,12,17,29.4%,18m
12016,3,Manocsak,3207,0,1,0,1,100.0%,16m
12016,3,Basipooh,3207,0,0,2,2,0.0%,18m
12037,2,ChEwbaca,3206,1353,498,497,995,50.1%,30m
12037,3,Tamagotchi,3206,1301,162,142,304,53.3%,5m
12037,3,[Pdass]Athos,3206,1592,155,148,303,51.2%,14m
12037,3,Eci,3206,1617,110,110,220,50.0%,5m
12037,3,[NetGG]Joker,3206,1220,63,48,111,56.8%,15m
12037,3,korgoth,3206,695,61,50,111,55.0%,16m
12037,3,Sancau,3206,1100,39,45,84,46.4%,4m
12037,3,MaCaBrOs,3206,653,28,20,48,58.3%,15m
12037,3,[3Macro]Бонапарт,3206,477,24,6,30,80.0%,30m
12037,3,Kikounousse,3206,338,13,16,29,44.8%,10m
12037,3,Moolek,3206,340,12,15,27,44.4%,11m
12037,3,[TSBF]Spsonic,3206,113,4,1,5,80.0%,17m
12037,3,[kGk]Zilos,3206,0,4,2,6,66.7%,14m
12037,3,Surtur,3206,123,2,4,6,33.3%,12m
12037,3,Fire,3206,0,1,0,1,100.0%,17m
12037,3,panda,3206,0,1,0,1,100.0%,7m
12037,3,[ENGNS]RandomGüffel,3206,0,1,1,2,50.0%,7m
12037,3,FuzzyTail,3206,0,0,1,1,0.0%,10m
12037,3,Coussin,3206,0,0,3,3,0.0%,48m
12037,3,gerax,3206,0,0,4,4,0.0%,20m
12057,3,[Z3b1]Flechefire,3205,1506,88,73,161,54.7%,30m
12057,3,Bordiur,3205,619,71,60,131,54.2%,9m
12057,3,TiMson,3205,1114,49,36,85,57.6%,17m
12057,3,[ZaG]Brez,3205,1119,44,34,78,56.4%,14m
12057,3,Klomoton,3205,837,41,43,84,48.8%,4m
12057,3,[SPAINs]kevinukooo,3205,519,25,9,34,73.5%,5m
12057,3,Rozyr,3205,459,25,16,41,61.0%,11m
12057,3,ELMINO,3205,610,21,31,52,40.4%,17m
12057,3,rangleklods,3205,466,19,14,33,57.6%,13m
12057,3,[TMFLO]Thursaz,3205,547,19,18,37,51.4%,8m
12057,3,Deftik,3205,346,13,9,22,59.1%,10m
12057,3,WhiteRabbit,3205,308,13,10,23,56.5%,14m
12057,3,QuickFit,3205,293,11,6,17,64.7%,18m
12057,3,Kharnage,3205,0,1,0,1,100.0%,11m
12057,3,Bulat,3205,94,1,1,2,50.0%,3m
12057,3,[Xa]Drator,3205,30,1,4,5,20.0%,11m
12057,3,[Bogart]ToMpa,3205,0,0,1,1,0.0%,4m
12057,3,[TFS1]PizzAce,3205,0,0,1,1,0.0%,5m
12057,3,BlackpinkBTS,3205,0,0,1,1,0.0%,3m
12057,3,[NONIST]JagaJaga,3205,0,0,1,1,0.0%,14m
12057,3,[GGD]Arathinix,3205,0,0,2,2,0.0%,13m
12057,3,nanekill,3205,0,0,3,3,0.0%,10m
12079,3,noogstah,3204,1572,321,323,644,49.8%,3m
12079,3,Thib,3204,1365,237,218,455,52.1%,18m
12079,3,[brosBE]ErlusPerlu,3204,1628,209,194,403,51.9%,29m
12079,3,SolidExo,3204,635,128,126,254,50.4%,17m
12079,3,ScrottMcBall,3204,990,100,101,201,49.8%,11m
12079,3,[Geil1]Nicegamer,3204,1521,79,47,126,62.7%,16m
12079,3,MARTII,3204,1504,77,69,146,52.7%,3m
12079,3,[MAKinG]xTrIckKsHotx,3204,1252,73,53,126,57.9%,27m
12079,3,barcode,3204,517,67,59,126,53.2%,17m
12079,3,Lautstark,3204,878,62,43,105,59.0%,3m
12079,3,Jonny,3204,1153,51,36,87,58.6%,9m
12079,3,own,3204,467,40,31,71,56.3%,13m
12079,3,leon,3204,251,36,22,58,62.1%,7m
12079,3,[PLA2N]ProtoseGG,3204,782,35,18,53,66.0%,27m
12079,3,Bacchus,3204,212,35,20,55,63.6%,18m
12079,3,Klyde,3204,675,27,24,51,52.9%,3m
12079,3,ChinnChaa,3204,364,18,6,24,75.0%,8m
12079,3,Freack,3204,238,10,7,17,58.8%,9m
12079,3,benjatoooo,3204,219,8,4,12,66.7%,18m
12079,3,[ЦЭ]Eleran,3204,176,6,10,16,37.5%,6m
12079,3,Bowser,3204,192,5,5,10,50.0%,27m
12079,3,Sijonara,3204,134,4,0,4,100.0%,5m
12079,3,powerslave,3204,115,2,2,4,50.0%,14m
12079,3,[QTclub]JackDeRipper,3204,0,1,0,1,100.0%,16m
12079,3,JIMPOSSIBLE,3204,0,1,0,1,100.0%,7m
12079,3,[TAW]Tompann,3204,0,0,1,1,0.0%,11m
12079,3,[GssSan]HanY,3204,0,0,1,1,0.0%,14m
12106,3,Asnofyx,3203,1511,141,129,270,52.2%,27m
12106,3,Dancore,3203,1651,136,134,270,50.4%,4m
12106,3,newbe,3203,1320,124,78,202,61.4%,11m
12106,3,Pixel,3203,932,95,94,189,50.3%,11m
12106,3,BlueBanana,3203,1577,73,64,137,53.3%,17m
12106,3,HappyApple,3203,983,72,62,134,53.7%,13m
12106,3,[PiGPan]Midti,3203,1395,60,55,115,52.2%,4m
12106,3,Murneh,3203,1105,46,48,94,48.9%,18m
12106,3,Kreig,3203,1027,41,45,86,47.7%,9m
12106,3,DOLBY,3203,867,35,34,69,50.7%,18m
12106,3,moesgaard,3203,507,24,17,41,58.5%,17m
12106,3,[QTcIub]Robotopia,3203,547,21,18,39,53.8%,15m
12106,3,Ballzdeep,3203,481,20,10,30,66.7%,15m
12106,3,darkness,3203,385,19,10,29,65.5%,18m
12106,3,[ECS]jabathib,3203,367,16,11,27,59.3%,19m
12106,3,[xFRSx]PuvlikEnemy,3203,366,14,10,24,58.3%,8m
12106,3,dreamx,3203,299,14,13,27,51.9%,2m
12106,3,BlackFlame,3203,314,11,14,25,44.0%,4m
12106,3,Prizrak,3203,193,10,4,14,71.4%,6m
12106,3,[КАМ]DeRd,3203,226,8,5,13,61.5%,18m
12106,3,Nathuram,3203,164,7,4,11,63.6%,11m
12106,3,[leOS]Ветер,3203,155,5,0,5,100.0%,18m
12106,3,rrroberto,3203,152,5,12,17,29.4%,15m
12106,3,[SaN]Billirafon,3203,30,2,11,13,15.4%,4m
12106,3,[Kokain]crx,3203,0,1,3,4,25.0%,11m
12106,3,Apotheosis,3203,30,1,4,5,20.0%,3m
12106,3,DexteR,3203,0,0,2,2,0.0%,18m
12133,3,Wozrox,3202,1566,250,236,486,51.4%,11m
12133,3,[b0O0n]Salomon,3202,1609,246,238,484,50.8%,11m
12133,3,Arcane,3202,1004,107,96,203,52.7%,12m
12133,3,TeddyB,3202,1199,70,65,135,51.9%,19m
12133,3,Kasatka,3202,992,59,47,106,55.7%,3m
12133,3,CANNONRUSH,3202,952,47,20,67,70.1%,7m
12133,3,[MiOwA]WasT,3202,1021,44,35,79,55.7%,20m
12133,3,erronical,3202,822,34,27,61,55.7%,18m
12133,3,JustDerpin,3202,592,27,11,38,71.1%,4m
12133,3,[Pyrric]blackmacros,3202,590,21,30,51,41.2%,7m
12133,3,AliAgca,3202,120,16,8,24,66.7%,18m
12133,3,Tsundere,3202,396,15,15,30,50.0%,3m
12133,3,Austin,3202,351,14,11,25,56.0%,16m
12133,3,RushB,3202,374,13,24,37,35.1%,5m
12133,3,[oooo89]TheCiuLi,3202,227,11,12,23,47.8%,17m
12133,3,LuckyStar,3202,114,2,12,14,14.3%,8m
12133,3,HowHardCanZb,3202,0,1,0,1,100.0%,6m
12133,3,BurbleB,3202,0,1,0,1,100.0%,47m
12133,3,[3DE]Namiator,3202,30,1,5,6,16.7%,3m
12133,3,[OotSW]gagman,3202,0,0,2,2,0.0%,14m
12133,3,[HsDL]Lorecricio,3202,0,0,5,5,0.0%,29m
12154,3,Maia,3201,1557,96,94,190,50.5%,4m
12154,3,Manyo,3201,1013,90,85,175,51.4%,27m
12154,3,Burjuman,3201,1490,86,76,162,53.1%,12m
12154,3,itelmen,3201,886,59,40,99,59.6%,10m
12154,3,OnePunchMan,3201,710,37,11,48,77.1%,29m
12154,3,knedlík,3201,626,37,26,63,58.7%,8m
12154,3,shiVaN,3201,908,37,31,68,54.4%,18m
12154,3,Sita,3201,838,37,36,73,50.7%,19m
12154,3,[Ǽ1]OttoSpritz,3201,538,26,15,41,63.4%,5m
12154,3,[GcGv2]WeVincenzo,3201,605,23,22,45,51.1%,17m
12154,3,CheesePolice,3201,558,21,23,44,47.7%,7m
12154,3,Illife,3201,502,18,27,45,40.0%,6m
12154,3,[Brun7]fbksmguld,3201,234,9,4,13,69.2%,3m
12154,1,Maximo,3201,188,9,4,13,69.2%,17m
12154,3,PoPoY,3201,151,6,5,11,54.5%,12m
12154,3,[tMnrd]xExercituSx,3201,114,4,5,9,44.4%,9m
12154,3,Flotschos,3201,0,1,0,1,100.0%,17m
12154,3,AntiCrabik,3201,0,0,1,1,0.0%,15m
12154,3,[TAW]cruelrichard,3201,0,0,1,1,0.0%,7m
12173,3,Батя,3200,1588,281,272,553,50.8%,29m
12173,3,Clemsoth,3200,1588,171,161,332,51.5%,6m
12173,3,shuma,3200,1431,92,86,178,51.7%,7m
12173,3,Jediknight,3200,606,79,68,147,53.7%,10m
12173,3,Asimo,3200,446,59,46,105,56.2%,11m
12173,3,[ТКД]Scorp,3200,692,53,51,104,51.0%,5m
12173,3,GawrGura,3200,864,42,37,79,53.2%,28m
12173,3,Monet,3200,849,33,30,63,52.4%,7m
12173,3,MethodMan,3200,578,20,26,46,43.5%,28m
12173,3,SnarfSnarf,3200,558,19,31,50,38.0%,18m
12173,3,SugerBaby,3200,407,17,10,27,63.0%,19m
12173,3,Aster,3200,363,16,7,23,69.6%,4m
12173,3,Kryp,3200,382,15,9,24,62.5%,11m
12173,1,Chromosomes,3200,361,14,7,21,66.7%,13m
12173,3,NoobSCII,3200,275,13,1,14,92.9%,14m
12173,3,Gambino,3200,287,13,10,23,56.5%,7m
12173,2,Mist,3200,272,12,8,20,60.0%,15m
12173,3,[ATHENE]Mikhan,3200,149,9,17,26,34.6%,8m
12173,1,[Kompis]daboon,3200,208,7,6,13,53.8%,42m
12173,3,NOchatting,3200,124,7,8,15,46.7%,3m
12173,3,Fenicx,3200,181,6,3,9,66.7%,7m
12173,1,NoobOK,3200,240,6,5,11,54.5%,2m
12173,3,Spike,3200,186,6,11,17,35.3%,18m
12173,1,TTshkin,3200,164,5,0,5,100.0%,19m
12173,3,ClownFiësta,3200,120,5,12,17,29.4%,17m
12173,3,AzinSalniu,3200,144,3,4,7,42.9%,12m
12173,1,Terran,3200,82,2,1,3,66.7%,5m
12173,2,AOskipta,3200,139,2,2,4,50.0%,1h
12173,1,YannickTamR,3200,0,1,0,1,100.0%,7m
12173,3,Swarm,3200,0,1,0,1,100.0%,29m
12173,3,EvilDwarf,3200,0,1,1,2,50.0%,9m
12173,2,FatGuardian,3200,95,1,2,3,33.3%,1h
12173,3,marine,3200,0,1,3,4,25.0%,17m
12206,3,Alex,3199,1509,145,136,281,51.6%,4m
12206,3,IceMan,3199,1480,107,115,222,48.2%,10m
12206,3,[Lambro]Lucid,3199,1515,76,77,153,49.7%,9m
12206,3,KingCrevette,3199,1399,75,55,130,57.7%,5m
12206,3,lucker,3199,410,14,22,36,38.9%,18m
12206,3,Gencho,3199,248,10,11,21,47.6%,28m
12206,2,MMA,3199,166,7,2,9,77.8%,1h
12206,1,Oturanx,3199,172,7,3,10,70.0%,4m
12206,3,NikeR,3199,186,6,10,16,37.5%,27m
12206,1,[IceCub]Homut,3199,156,4,1,5,80.0%,6m
12206,3,booyakaa,3199,60,3,8,11,27.3%,14m
12206,3,Symmetryfy,3199,120,2,2,4,50.0%,14m
12206,1,[MTBB]Norbert,3199,0,0,1,1,0.0%,29m
12206,3,Fikimiki,3199,0,0,2,2,0.0%,7m
12206,3,SANcontrol,3199,0,0,4,4,0.0%,12m
12221,3,Faruh,3198,1286,415,399,814,51.0%,9m
12221,3,ddazone,3198,1172,130,127,257,50.6%,8m
12221,3,sonofavitch,3198,1571,104,106,210,49.5%,3m
12221,3,demon,3198,1483,78,73,151,51.7%,16m
12221,3,Aria,3198,376,59,55,114,51.8%,28m
12221,3,Optimus,3198,450,19,21,40,47.5%,18m
12221,3,[VFTǂ]harelc,3198,562,19,29,48,39.6%,3m
12221,3,tjutju,3198,244,9,16,25,36.0%,14m
12221,3,rossHell,3198,220,8,14,22,36.4%,18m
12221,3,naikEn,3198,219,6,5,11,54.5%,30m
12221,3,Miii,3198,0,0,2,2,0.0%,18m
12221,3,[NoHоmо]Danya,3198,0,0,2,2,0.0%,14m
12233,3,Conanesc,3197,1512,561,556,1117,50.2%,4m
12233,3,DamnDirty,3197,1621,324,312,636,50.9%,4m
12233,3,BenZaka,3197,851,132,141,273,48.4%,4m
12233,3,alexfsc,3197,1488,106,108,214,49.5%,10m
12233,3,DrPappy,3197,1243,53,46,99,53.5%,4m
12233,3,NoMore,3197,1202,50,46,96,52.1%,14m
12233,3,youkibear,3197,710,29,25,54,53.7%,15m
12233,3,[ZeDe20]Lacagaste,3197,600,26,15,41,63.4%,14m
12233,3,Dramblys,3197,641,24,25,49,49.0%,3m
12233,3,Whytee,3197,252,15,15,30,50.0%,7m
12233,3,[PLA2N]чебупеля,3197,331,13,9,22,59.1%,11m
12233,3,SneakyHawk,3197,194,11,11,22,50.0%,29m
12233,3,[Kh4os]Shurath,3197,302,11,12,23,47.8%,19m
12233,3,Lolilove,3197,213,10,6,16,62.5%,6m
12233,1,sAIKLs,3197,238,9,5,14,64.3%,46m
12233,1,YaBoi,3197,237,9,5,14,64.3%,5m
12233,2,Sleipnir,3197,0,5,1,6,83.3%,43m
12233,1,sksjw,3197,84,3,2,5,60.0%,19m
12233,2,Rizl,3197,88,2,1,3,66.7%,4m
12233,3,Marco,3197,30,2,2,4,50.0%,27m
12233,1,[D0N3]NapalMinFacE,3197,0,1,0,1,100.0%,11m
12233,3,[StllCs]Starlord,3197,0,1,0,1,100.0%,10m
12233,3,télowmdr,3197,0,1,2,3,33.3%,27m
12233,3,Baekken,3197,30,1,6,7,14.3%,14m
12233,1,Жуль,3197,0,0,1,1,0.0%,18m
12258,3,velbloud,3196,1536,98,87,185,53.0%,11m
12258,3,Mebius,3196,739,48,40,88,54.5%,4m
12258,1,Jailer,3196,531,26,8,34,76.5%,3m
12258,3,Pazzaar,3196,264,11,7,18,61.1%,14m
12258,1,JimNiteBlade,3196,238,9,5,14,64.3%,13m
12258,1,marcos,3196,165,3,4,7,42.9%,1h
12258,3,[ARISS3]koke,3196,30,3,6,9,33.3%,27m
12258,1,[UKSC2]Marco,3196,0,1,0,1,100.0%,9m
12258,1,Dragon,3196,0,1,0,1,100.0%,11m
12258,1,Dithmarscher,3196,0,0,1,1,0.0%,7m
12258,1,[Bæst]Raider,3196,0,0,1,1,0.0%,3m
12258,2,MattThePie,3196,0,0,11,11,0.0%,6m
12270,3,Mxl,3195,654,144,118,262,55.0%,4m
12270,3,kNK,3195,769,67,59,126,53.2%,2m
12270,3,Arthor,3195,1158,44,47,91,48.4%,30m
12270,3,[sfc]crosolid,3195,1055,40,41,81,49.4%,5m
12270,3,PhoenixFire,3195,626,27,22,49,55.1%,19m
12270,1,[XiSPoo]Lockdown,3195,742,24,22,46,52.2%,18m
12270,3,rtet,3195,298,10,9,19,52.6%,18m
12270,2,[DaTal]Barbaris,3195,284,10,28,38,26.3%,17m
12270,1,[ESHD]Master,3195,286,9,7,16,56.2%,7m
12270,1,[TIC]rAij,3195,211,5,3,8,62.5%,14m
12270,2,KalamMekhar,3195,158,4,4,8,50.0%,9m
12270,2,[PLYWKI]Marksmanchik,3195,88,2,2,4,50.0%,11m
12270,3,JulianDE,3195,62,2,5,7,28.6%,28m
12270,3,Mücke,3195,0,2,6,8,25.0%,5m
12270,1,CARLM,3195,0,1,0,1,100.0%,12m
12270,3,Looterpol,3195,30,1,3,4,25.0%,29m
12270,1,[ayyyyy]daru,3195,0,0,1,1,0.0%,8m
12270,3,Adventur,3195,0,0,2,2,0.0%,15m
12270,1,PinZar,3195,0,0,2,2,0.0%,51m
12289,3,[halik]Czesiu,3194,890,683,625,1308,52.2%,14m
12289,3,[PURK]pukela,3194,1404,113,114,227,49.8%,27m
12289,3,[TAW]Senbean,3194,749,102,95,197,51.8%,4m
12289,3,Falstaff,3194,1347,67,56,123,54.5%,11m
12289,3,raw,3194,683,52,47,99,52.5%,18m
12289,3,[DOOGIE]Cantillon,3194,1179,49,46,95,51.6%,3m
12289,3,Logalog,3194,880,45,43,88,51.1%,13m
12289,3,PunchLine,3194,796,27,37,64,42.2%,11m
12289,3,Longus,3194,466,20,14,34,58.8%,28m
12289,3,Stantz,3194,396,18,13,31,58.1%,11m
12289,3,[xBABAx]UnderCtrl,3194,441,17,19,36,47.2%,14m
12289,1,Trump,3194,506,14,14,28,50.0%,15m
12289,3,donHaize,3194,282,9,8,17,52.9%,14m
12289,1,[CОS]Jypsy,3194,164,5,2,7,71.4%,4m
12289,1,[KACHIN]Rukarus,3194,38,2,0,2,100.0%,16m
12289,1,Бывалый,3194,86,2,3,5,40.0%,28m
12289,3,BonkbalBimbo,3194,0,2,5,7,28.6%,27m
12289,3,Remoh,3194,0,1,2,3,33.3%,3m
12289,1,ProbeProbius,3194,0,0,1,1,0.0%,7m
12308,3,MastaChella,3193,1577,197,193,390,50.5%,15m
12308,3,LaTerreur,3193,1148,55,52,107,51.4%,12m
12308,1,Siomi,3193,647,25,13,38,65.8%,10m
12308,3,iTzLogan,3193,636,21,30,51,41.2%,7m
12308,3,ElDoctore,3193,297,13,12,25,52.0%,8m
12308,3,Sleeky,3193,220,9,6,15,60.0%,17m
12308,3,Szebke,3193,200,7,17,24,29.2%,17m
12308,1,InsaneBRT,3193,0,5,0,5,100.0%,19m
12308,3,ДаняПерчик,3193,30,2,2,4,50.0%,3m
12308,1,Freud,3193,0,1,0,1,100.0%,11m
12308,1,[RESET]Deamodiss,3193,0,0,1,1,0.0%,16m
12308,2,gglauge,3193,0,0,1,1,0.0%,11m
12308,3,sOme,3193,0,0,4,4,0.0%,13m
12321,3,fenix,3192,805,55,46,101,54.5%,12m
12321,3,Traider,3192,402,16,15,31,51.6%,4m
12321,2,Ganjaman,3192,328,14,9,23,60.9%,5m
12321,3,Scipion,3192,341,12,10,22,54.5%,9m
12321,3,Serenity,3192,250,8,17,25,32.0%,18m
12321,1,zez,3192,0,0,1,1,0.0%,12m
12321,2,EFEX,3192,0,0,2,2,0.0%,6m
12321,3,From,3192,0,0,2,2,0.0%,27m
12329,3,Jhd,3191,364,97,90,187,51.9%,8m
12329,3,DeadlyPanTs,3191,576,25,18,43,58.1%,27m
12329,3,LagunaRock,3191,626,22,36,58,37.9%,7m
12329,3,Nugias,3191,277,10,11,21,47.6%,11m
12329,3,Waterways,3191,121,3,2,5,60.0%,4m
12329,3,Красивая,3191,0,2,3,5,40.0%,1h
12329,3,Nawaro,3191,62,2,7,9,22.2%,14m
12329,2,Kristofr,3191,0,1,5,6,16.7%,1h
12329,3,[RYDA]aLx,3191,0,0,8,8,0.0%,29m
12338,3,[JINX]SokoOne,3190,797,90,5,95,94.7%,17m
12338,3,[Heroes]NoControl,3190,1450,82,78,160,51.2%,13m
12338,3,[ÖMO]Jules,3190,674,29,25,54,53.7%,29m
12338,3,[WowSpy]MarokoGamer,3190,791,29,27,56,51.8%,28m
12338,3,MykeTV,3190,211,9,7,16,56.2%,15m
12338,3,[Dobro]Arlekin,3190,256,9,7,16,56.2%,4m
12338,1,Hektorus,3190,36,6,0,6,100.0%,28m
12338,1,[Arrows]Soundwave,3190,270,6,1,7,85.7%,7m
12338,1,SgtSchwabbel,3190,137,6,2,8,75.0%,9m
12338,1,Matthi,3190,0,4,1,5,80.0%,27m
12338,1,Gitou,3190,122,3,3,6,50.0%,11m
12338,3,DEZEZ,3190,0,2,3,5,40.0%,7m
12338,1,DocThor,3190,73,2,8,10,20.0%,15m
12338,1,Tartusi,3190,0,1,0,1,100.0%,9m
12352,3,BloodyHamer,3189,1590,259,238,497,52.1%,20m
12352,3,dist,3189,1506,206,206,412,50.0%,18m
12352,3,HABZ,3189,1212,115,95,210,54.8%,11m
12352,3,judicator,3189,390,33,30,63,52.4%,6m
12352,3,Roms,3189,796,27,38,65,41.5%,3m
12352,3,[H4L4]Iamquake,3189,455,24,17,41,58.5%,7m
12352,3,[PETE]Eranoid,3189,486,19,12,31,61.3%,18m
12352,3,Silencios,3189,403,18,14,32,56.2%,20m
12352,3,MyAmaranth,3189,394,13,26,39,33.3%,28m
12352,1,[010001]Ryokan,3189,211,8,5,13,61.5%,15m
12352,3,electricity,3189,115,4,4,8,50.0%,20m
12352,1,Ohmduph,3189,78,3,0,3,100.0%,2m
12352,3,ThisAintFun,3189,141,3,1,4,75.0%,8m
12352,1,[Cannоn]Saitama,3189,38,2,0,2,100.0%,12m
12352,3,Wizzard,3189,58,2,3,5,40.0%,27m
12352,3,HumanSee,3189,64,2,4,6,33.3%,13m
12352,1,[LeWin]Guronsan,3189,44,1,1,2,50.0%,11m
12352,2,[PMMM]Elitar,3189,95,1,1,2,50.0%,43m
12352,1,[TINion]Yura,3189,0,0,1,1,0.0%,13m
12352,1,CCF,3189,0,0,1,1,0.0%,13m
12352,1,АRБАLЕSТЪ,3189,0,0,1,1,0.0%,29m
12352,3,nvasion,3189,0,0,3,3,0.0%,14m
12374,3,TurkzZ,3188,1529,312,294,606,51.5%,11m
12374,3,Lax,3188,1586,290,298,588,49.3%,10m
12374,3,Mustafa,3188,1530,158,154,312,50.6%,2m
12374,3,Comète,3188,1377,126,111,237,53.2%,4m
12374,3,calamiTy,3188,1144,50,35,85,58.8%,14m
12374,3,[ЕST]TaHku,3188,298,26,19,45,57.8%,3m
12374,3,[ReDo]Ostapicus,3188,652,23,25,48,47.9%,2m
12374,3,Lenichi,3188,483,17,17,34,50.0%,27m
12374,3,Fistalk,3188,345,15,8,23,65.2%,19m
12374,1,[Bambi2]BarakObama,3188,274,13,11,24,54.2%,16m
12374,3,AchilleS,3188,257,11,9,20,55.0%,16m
12374,3,ElFleischo,3188,228,9,3,12,75.0%,17m
12374,3,[PAHE]IIIPusherIII,3188,135,6,2,8,75.0%,4m
12374,1,Kaptnblaubar,3188,97,4,3,7,57.1%,20m
12374,3,[Petrus]Knibel,3188,166,4,5,9,44.4%,18m
12374,3,TFC,3188,97,2,1,3,66.7%,19m
12374,3,FagMcGay,3188,30,2,4,6,33.3%,12m
12374,1,[COORGI]SushiiTC,3188,0,1,0,1,100.0%,13m
12374,3,zerg,3188,94,1,2,3,33.3%,12m
12393,3,[EmŦ]blackpearl,3187,1546,282,264,546,51.6%,12m
12393,3,TALAIPWROS,3187,1596,281,279,560,50.2%,29m
12393,3,Царь,3187,1341,149,140,289,51.6%,10m
12393,3,RobPiton,3187,1133,63,52,115,54.8%,18m
12393,3,Provocateur,3187,706,57,62,119,47.9%,2m
12393,3,roquefort,3187,696,32,28,60,53.3%,3m
12393,3,[TheDOH]NeraDraed,3187,322,11,8,19,57.9%,28m
12393,3,Faid,3187,322,11,10,21,52.4%,8m
12393,3,magnum,3187,211,9,10,19,47.4%,6m
12393,3,Naix,3187,157,7,5,12,58.3%,5m
12393,1,AngryBear,3187,122,4,2,6,66.7%,28m
12393,3,Uttarayan,3187,118,4,12,16,25.0%,7m
12393,3,Sadovnick,3187,94,2,1,3,66.7%,28m
12393,3,BoyNextDoor,3187,0,0,2,2,0.0%,14m
12393,3,aapakner,3187,0,0,16,16,0.0%,15m
12408,3,ocin,3186,1313,59,43,102,57.8%,14m
12408,3,[SIayer]Kodoyosa,3186,213,44,29,73,60.3%,17m
12408,3,ArDUinO,3186,1073,44,40,84,52.4%,14m
12408,3,BakeD,3186,487,23,10,33,69.7%,17m
12408,3,EarthCon,3186,364,14,18,32,43.8%,15m
12408,3,[Petrus]Nitromoon,3186,398,14,18,32,43.8%,3m
12408,3,AvivRam,3186,391,13,12,25,52.0%,19m
12408,1,Terraniser,3186,232,11,5,16,68.8%,4m
12408,3,learnFoSkill,3186,165,6,10,16,37.5%,8m
12408,3,mole,3186,176,6,13,19,31.6%,18m
12408,2,[FGStar]SealOil,3186,142,5,1,6,83.3%,19m
12408,1,HoggerTime,3186,48,5,4,9,55.6%,20m
12408,1,[SWN]Erébus,3186,140,4,1,5,80.0%,1h
12408,1,aaa,3186,0,4,1,5,80.0%,9m
12408,3,[SaMz]ElGringo,3186,30,2,5,7,28.6%,17m
12408,1,MrMiddleTv,3186,0,0,1,1,0.0%,30m
12408,1,iPood,3186,0,0,1,1,0.0%,15m
12408,1,AHAPXNCT,3186,0,0,1,1,0.0%,3m
12408,1,[LJKM]Feues,3186,0,0,1,1,0.0%,12m
12408,1,SweetMask,3186,0,0,1,1,0.0%,13m
12428,3,Jeggett,3185,762,237,227,464,51.1%,29m
12428,3,[Petrиs]biznok,3185,1463,214,202,416,51.4%,4m
12428,3,HardGosu,3185,1587,190,188,378,50.3%,13m
12428,3,Prodigy,3185,1570,143,133,276,51.8%,12m
12428,3,[SnSh]Yob,3185,1452,132,119,251,52.6%,11m
12428,3,norskel,3185,545,73,68,141,51.8%,6m
12428,3,Barac,3185,1115,45,37,82,54.9%,16m
12428,3,Aidanoom,3185,1046,40,43,83,48.2%,8m
12428,1,BYUNже,3185,1150,36,37,73,49.3%,18m
12428,3,MrBubblee,3185,207,33,25,58,56.9%,12m
12428,3,[dling]Wirx,3185,679,33,38,71,46.5%,11m
12428,3,AGT,3185,693,24,24,48,50.0%,9m
12428,1,[InƑeS]Sergio,3185,608,18,17,35,51.4%,5m
12428,3,Kakugyō,3185,352,15,18,33,45.5%,14m
12428,1,GayBarMania,3185,303,13,12,25,52.0%,13m
12428,3,Fondue,3185,142,5,8,13,38.5%,18m
12428,1,Glady,3185,0,4,1,5,80.0%,18m
12428,3,SEREP,3185,30,4,4,8,50.0%,19m
12428,3,[Pallo]Mesi,3185,146,3,4,7,42.9%,7m
12428,1,JordiSnoep,3185,116,2,1,3,66.7%,20m
12428,1,Jockel,3185,0,1,4,5,20.0%,4m
12428,3,[C12760]Jawbreaker,3185,0,1,4,5,20.0%,5m
12428,1,KimJongNuke,3185,0,0,1,1,0.0%,28m
12428,3,[Unfair]Ron,3185,0,0,1,1,0.0%,29m
12428,1,[k1raen]Mervin,3185,0,0,1,1,0.0%,29m
12453,3,YOON,3184,1549,208,191,399,52.1%,7m
12453,3,Aqme,3184,1488,188,166,354,53.1%,18m
12453,3,[dG]salchwell,3184,268,67,66,133,50.4%,6m
12453,3,SzyszonEX,3184,1209,57,38,95,60.0%,17m
12453,3,ProtoFossils,3184,908,42,47,89,47.2%,29m
12453,1,CooLWeB,3184,408,12,8,20,60.0%,16m
12453,3,Vladimir,3184,145,8,3,11,72.7%,15m
12453,1,GreenForYou,3184,232,7,12,19,36.8%,14m
12453,2,balantrea,3184,142,6,3,9,66.7%,4m
12453,1,HaiRcuT,3184,0,3,2,5,60.0%,13m
12453,1,sGa,3184,121,2,8,10,20.0%,19m
12453,1,[UAŦeam]Adventurer,3184,0,1,0,1,100.0%,7m
12453,3,Dhjon,3184,30,1,5,6,16.7%,5m
12453,3,Cronos,3184,0,0,8,8,0.0%,14m
12467,3,VeNi,3183,1619,190,177,367,51.8%,27m
12467,3,[SC2ERZ]CaptainM,3183,1454,60,56,116,51.7%,11m
12467,3,[CDS1]Deonid,3183,966,52,51,103,50.5%,29m
12467,3,abrigal,3183,1059,43,50,93,46.2%,15m
12467,3,Orome,3183,593,31,26,57,54.4%,18m
12467,1,TogoRot,3183,514,20,14,34,58.8%,19m
12467,3,Jægermeister,3183,396,19,14,33,57.6%,3m
12467,3,[U238]yassback,3183,416,18,14,32,56.2%,11m
12467,3,GladHeAteHer,3183,480,18,24,42,42.9%,5m
12467,3,aYeti,3183,219,7,6,13,53.8%,14m
12467,1,[FoAUA]Mazip,3183,42,1,2,3,33.3%,28m
12467,1,IlIIllIIllII,3183,40,1,5,6,16.7%,11m
12467,1,melloD,3183,0,0,1,1,0.0%,9m
12467,1,Saryrn,3183,0,0,5,5,0.0%,12m
12481,3,add,3182,1552,205,206,411,49.9%,6m
12481,3,RaynoJxtz,3182,1505,150,123,273,54.9%,7m
12481,3,Alex,3182,984,118,102,220,53.6%,18m
12481,3,Suave,3182,1460,112,115,227,49.3%,15m
12481,3,Egregiorum,3182,1568,94,87,181,51.9%,10m
12481,3,Iceman,3182,668,92,67,159,57.9%,9m
12481,3,Smaok,3182,1425,66,60,126,52.4%,29m
12481,3,llllllllllll,3182,124,48,48,96,50.0%,10m
12481,3,Lucius,3182,532,19,26,45,42.2%,5m
12481,3,Shansur,3182,461,17,16,33,51.5%,4m
12481,1,[EZDUNK]Monkie,3182,354,15,12,27,55.6%,11m
12481,3,[PiGPan]Garethax,3182,334,15,17,32,46.9%,4m
12481,3,BaalAde,3182,364,14,9,23,60.9%,4m
12481,1,Kata,3182,337,13,10,23,56.5%,18m
12481,1,tzaruki,3182,412,12,8,20,60.0%,18m
12481,3,[VdK]DeadUncle,3182,288,11,13,24,45.8%,4m
12481,3,SemKo,3182,220,10,8,18,55.6%,18m
12481,3,LEO,3182,195,6,6,12,50.0%,11m
12481,1,Wonderbra,3182,0,1,0,1,100.0%,13m
12481,3,Noodled,3182,0,1,3,4,25.0%,17m
12481,3,ЛовкийЗерг,3182,30,1,4,5,20.0%,14m
12481,2,Ukushu,3182,0,0,1,1,0.0%,5m
12503,3,Blink,3181,1456,334,318,652,51.2%,10m
12503,3,SavinkOff,3181,1560,97,87,184,52.7%,4m
12503,3,[EoWar]Tchernak,3181,962,97,94,191,50.8%,18m
12503,3,FatalT,3181,1219,90,80,170,52.9%,6m
12503,3,[PИD]Niveon,3181,926,46,45,91,50.5%,12m
12503,1,Roger,3181,543,24,12,36,66.7%,29m
12503,3,IIIIIIIIIIII,3181,255,12,8,20,60.0%,19m
12503,3,doudou,3181,275,10,7,17,58.8%,29m
12503,3,stoltz,3181,242,9,8,17,52.9%,29m
12503,3,YamaSita,3181,184,6,8,14,42.9%,16m
12503,1,MaxD,3181,157,5,4,9,55.6%,4m
12503,1,[EliteX]Kubaxin,3181,42,2,0,2,100.0%,5m
12503,1,ASDASDASDASD,3181,42,1,1,2,50.0%,6m
12503,1,Starcrash,3181,97,1,4,5,20.0%,18m
12517,3,[LMBD]RamboReis,3180,1373,136,115,251,54.2%,13m
12517,3,Frey,3180,1115,119,116,235,50.6%,9m
12517,3,Baikaly,3180,1449,94,84,178,52.8%,9m
12517,3,Itachi,3180,1405,65,47,112,58.0%,7m
12517,1,Alleb,3180,883,31,24,55,56.4%,1m
12517,1,Deex,3180,645,26,17,43,60.5%,15m
12517,3,korkun,3180,286,24,20,44,54.5%,4m
12517,3,BubbleBuddy,3180,479,18,15,33,54.5%,4m
12517,3,[Klawo]Ver,3180,302,10,20,30,33.3%,20m
12517,3,NMSL,3180,172,7,6,13,53.8%,2m
12517,3,[3GBY]NikoNikoNi,3180,221,7,7,14,50.0%,8m
12517,3,leksan,3180,121,6,4,10,60.0%,7m
12517,1,Hanareck,3180,206,5,3,8,62.5%,18m
12517,3,skjoldan,3180,88,4,6,10,40.0%,1m
12517,1,[NuF]Cyclopes,3180,84,3,1,4,75.0%,20m
12517,3,IIIIIIIIII,3180,0,2,3,5,40.0%,54m
12517,3,Beatso,3180,30,2,4,6,33.3%,10m
12517,1,IamPeace,3180,42,1,2,3,33.3%,7m
12517,3,[WNTR]Hydrogenium,3180,94,1,2,3,33.3%,9m
12517,1,desertir,3180,0,0,1,1,0.0%,11m
12537,3,Arirang,3179,1557,178,163,341,52.2%,18m
12537,3,ysanafa,3179,714,116,108,224,51.8%,7m
12537,3,PinkTeddy,3179,1379,82,79,161,50.9%,11m
12537,1,Alarma,3179,728,74,60,134,55.2%,20m
12537,3,nicolai,3179,513,64,64,128,50.0%,29m
12537,3,lightplayer,3179,1311,63,61,124,50.8%,12m
12537,3,Pong,3179,330,43,43,86,50.0%,17m
12537,3,Hypnotoad,3179,158,11,22,33,33.3%,3m
12537,1,Sound,3179,159,8,5,13,61.5%,1h
12537,1,snowfrost,3179,78,3,0,3,100.0%,3m
12537,3,[SRACH]krbloly,3179,58,3,4,7,42.9%,10m
12537,1,[NXMR]shenzi,3179,0,2,1,3,66.7%,12m
12537,1,DrPhilGood,3179,0,2,2,4,50.0%,19m
12537,3,CrustyCrab,3179,115,2,3,5,40.0%,7m
12537,3,[PolSku]Torfingor,3179,119,2,3,5,40.0%,3m
12537,3,SuperSquid,3179,60,2,14,16,12.5%,11m
12537,1,MintCondish,3179,0,1,0,1,100.0%,8m
12537,1,glhf,3179,0,1,0,1,100.0%,3m
12537,3,[D0N3]KwADwO,3179,0,1,2,3,33.3%,12m
12537,1,Ess,3179,0,1,2,3,33.3%,16m
12537,3,TasMaNiA,3179,0,0,5,5,0.0%,16m
12558,3,CoBrAǂKc,3178,1475,221,226,447,49.4%,4m
12558,3,GaTitO,3178,1577,122,110,232,52.6%,3m
12558,3,[Logic]semlantheone,3178,1312,87,87,174,50.0%,18m
12558,3,[RBP3]Dankata,3178,1363,74,70,144,51.4%,10m
12558,3,Zaner,3178,775,39,16,55,70.9%,17m
12558,1,[Фаталя]MassVoidRay,3178,633,37,10,47,78.7%,5m
12558,3,Shtab,3178,799,37,44,81,45.7%,2m
12558,1,[SkBG]pentium,3178,761,29,15,44,65.9%,14m
12558,3,Synthetic,3178,414,16,18,34,47.1%,15m
12558,1,Alex,3178,242,9,6,15,60.0%,15m
12558,3,Moufasa,3178,234,9,12,21,42.9%,30m
12558,3,[2s1ck]VermenoVenti,3178,210,7,11,18,38.9%,19m
12558,1,Idolatracier,3178,0,3,2,5,60.0%,18m
12558,1,[InBri]GurJA,3178,42,2,1,3,66.7%,11m
12558,3,AkVAgRIM,3178,0,2,3,5,40.0%,44m
12558,1,[HUN13r]Cadett,3178,0,1,0,1,100.0%,13m
12558,3,[TExGG]Granate,3178,0,1,3,4,25.0%,7m
12558,1,Gorgutzz,3178,0,0,1,1,0.0%,10m
12558,1,[Animе]BastBasket,3178,0,0,1,1,0.0%,1m
12558,3,Thor,3178,0,0,2,2,0.0%,18m
12578,3,ArchiMoor,3177,1541,284,286,570,49.8%,12m
12578,3,[Chonky]dunkinsailor,3177,709,33,17,50,66.0%,12m
12578,1,[FEIT]Gremal,3177,938,29,26,55,52.7%,29m
12578,3,bOuh,3177,523,22,21,43,51.2%,14m
12578,3,ZERATUL,3177,306,11,9,20,55.0%,14m
12578,3,RaVeN,3177,306,11,10,21,52.4%,30m
12578,2,Iamdude,3177,288,10,30,40,25.0%,10m
12578,3,pAmNikola,3177,208,7,5,12,58.3%,3m
12578,3,Semels,3177,136,5,2,7,71.4%,7m
12578,3,[NMKR]Herbman,3177,0,4,1,5,80.0%,21m
12578,1,[G4VR]BresMatt,3177,154,4,3,7,57.1%,29m
12578,1,SpokaFun,3177,80,2,2,4,50.0%,15m
12578,1,RealBaiter,3177,84,2,3,5,40.0%,8m
12578,1,Scales,3177,0,2,3,5,40.0%,13m
12578,1,[TLB]xKage,3177,42,2,4,6,33.3%,9m
12578,1,Gnik,3177,0,1,0,1,100.0%,3m
12578,1,[TCD]Kevn,3177,42,1,2,3,33.3%,9m
12578,2,Raivix,3177,0,1,2,3,33.3%,1h
12578,2,[xNDGx]olanor,3177,42,1,7,8,12.5%,59m
12597,3,Lime,3176,1190,199,194,393,50.6%,9m
12597,3,[SLABAC]Huncho,3176,1435,182,173,355,51.3%,7m
12597,1,MacroVision,3176,928,82,62,144,56.9%,3m
12597,3,VvVmAsTeR,3176,1114,57,53,110,51.8%,19m
12597,3,[LBGD]Opsid,3176,936,54,50,104,51.9%,9m
12597,3,Shinnybeast,3176,564,37,25,62,59.7%,14m
12597,1,[Radio]ryders,3176,974,34,23,57,59.6%,29m
12597,3,Plastik,3176,822,32,33,65,49.2%,5m
12597,3,ROD,3176,470,28,24,52,53.8%,29m
12597,3,Vinox,3176,310,14,6,20,70.0%,6m
12597,3,ItsNoGood,3176,264,9,11,20,45.0%,10m
12597,3,Veni,3176,230,7,7,14,50.0%,15m
12597,1,[nƮg]Mbuzi,3176,80,2,4,6,33.3%,18m
12597,1,Purplehæze,3176,0,1,0,1,100.0%,6m
12597,1,[Hrr]SmarsA,3176,0,1,0,1,100.0%,9m
12597,3,FatBasterd,3176,0,1,3,4,25.0%,9m
12597,1,Илья,3176,46,1,3,4,25.0%,28m
12597,1,HellFire,3176,0,0,2,2,0.0%,28m
12597,3,Tuaren,3176,0,0,3,3,0.0%,10m
12616,3,lasmiranda,3175,849,142,134,276,51.4%,7m
12616,3,Grampa,3175,960,98,80,178,55.1%,9m
12616,3,Narsus,3175,1085,60,60,120,50.0%,16m
12616,3,Nimrod,3175,1174,50,44,94,53.2%,2m
12616,3,tietotaito,3175,1094,38,49,87,43.7%,3m
12616,3,AlvaroLayon,3175,602,21,31,52,40.4%,3m
12616,3,lëni,3175,490,15,29,44,34.1%,18m
12616,1,Timesciper,3175,170,4,2,6,66.7%,15m
12616,3,RectalAmbush,3175,0,3,2,5,60.0%,6m
12616,1,oIITiMicT,3175,0,1,0,1,100.0%,8m
12616,3,IIIIIIIIIIII,3175,0,1,3,4,25.0%,12m
12616,3,Kwartz,3175,30,1,4,5,20.0%,16m
12628,3,Thunder,3174,1304,118,121,239,49.4%,12m
12628,3,DanDGT,3174,1441,63,53,116,54.3%,7m
12628,3,RedRhum,3174,979,56,54,110,50.9%,7m
12628,1,Megazoid,3174,1478,52,51,103,50.5%,19m
12628,3,Jules,3174,1066,51,34,85,60.0%,9m
12628,1,Imissmycat,3174,716,44,20,64,68.8%,9m
12628,3,MrGlox,3174,877,36,32,68,52.9%,5m
12628,1,Zwiback,3174,888,27,28,55,49.1%,18m
12628,3,[MMMIA]ElPresidente,3174,484,23,17,40,57.5%,15m
12628,3,arravity,3174,397,17,9,26,65.4%,19m
12628,3,Supernoob,3174,434,14,25,39,35.9%,14m
12628,2,EpicPlayer,3174,372,13,9,22,59.1%,12m
12628,1,Slavejik,3174,329,11,13,24,45.8%,15m
12628,3,MediocrePlay,3174,192,10,8,18,55.6%,18m
12628,3,Generation,3174,68,8,17,25,32.0%,10m
12628,1,Bargosh,3174,152,5,5,10,50.0%,13m
12628,1,GOTTA,3174,120,4,1,5,80.0%,20m
12628,1,[LAtvi]DafukLv,3174,80,3,0,3,100.0%,11m
12628,3,Belvedere,3174,60,2,4,6,33.3%,17m
12628,3,Dawnerz,3174,23,1,7,8,12.5%,5m
12628,1,[1FU2]TroubleMaker,3174,0,0,1,1,0.0%,8m
12628,3,Sparta,3174,0,0,1,1,0.0%,54m
12650,3,Gunslinger,3173,1599,117,122,239,49.0%,4m
12650,3,Misket,3173,716,71,67,138,51.4%,10m
12650,3,ThePitmat,3173,644,55,51,106,51.9%,4m
12650,3,Natymer,3173,1288,54,46,100,54.0%,18m
12650,3,singularity,3173,1428,50,60,110,45.5%,2m
12650,3,Solorkych,3173,879,37,29,66,56.1%,3m
12650,1,Jesus,3173,669,25,16,41,61.0%,9m
12650,3,yodasoda,3173,189,17,20,37,45.9%,8m
12650,1,eXecuToR,3173,560,16,10,26,61.5%,18m
12650,3,[XSpace]FireDrake,3173,328,12,16,28,42.9%,29m
12650,3,[Dobro]ninofabula,3173,254,9,6,15,60.0%,6m
12650,3,Daedra,3173,241,7,6,13,53.8%,3m
12650,3,Mike,3173,77,6,18,24,25.0%,18m
12650,1,[Fr33HK]TheGamer,3173,118,4,1,5,80.0%,13m
12650,1,Rhys,3173,0,3,1,4,75.0%,19m
12650,3,[XDD]Nyaaa,3173,97,2,4,6,33.3%,53m
12650,1,[SCTR]BobToss,3173,0,1,0,1,100.0%,18m
12650,1,WhiteDeath,3173,94,1,3,4,25.0%,5m
12650,1,BeaverBuster,3173,0,1,4,5,20.0%,7m
12650,1,ThousandSuns,3173,0,0,1,1,0.0%,15m
12650,1,DeadlyToast,3173,0,0,2,2,0.0%,3m
12650,3,Basy,3173,0,0,3,3,0.0%,20m
12672,3,Alx,3172,1548,343,338,681,50.4%,2m
12672,3,yanndark,3172,1577,173,164,337,51.3%,6m
12672,3,[BigLib]gaillou,3172,1504,90,78,168,53.6%,15m
12672,1,Andrew,3172,1337,75,68,143,52.4%,15m
12672,3,CromONE,3172,806,63,57,120,52.5%,11m
12672,1,[SNH]STCturKiSh,3172,1518,55,48,103,53.4%,1m
12672,3,Krawalle,3172,335,31,28,59,52.5%,12m
12672,2,[Alboz]FeNix,3172,960,30,53,83,36.1%,12m
12672,3,Galaxiors,3172,691,28,22,50,56.0%,15m
12672,3,SergantDruid,3172,410,14,14,28,50.0%,29m
12672,3,mQp,3172,161,4,3,7,57.1%,19m
12672,1,akakins,3172,122,4,3,7,57.1%,13m
12672,2,Cell,3172,127,4,5,9,44.4%,10m
12672,1,Automaton,3172,116,3,4,7,42.9%,5m
12672,3,Dimon,3172,140,3,4,7,42.9%,6m
12672,1,Slick,3172,95,2,0,2,100.0%,18m
12672,3,Atesz,3172,97,2,0,2,100.0%,1h
12672,1,GrogoWar,3172,42,1,2,3,33.3%,13m
12672,3,[DivL]BloBert,3172,0,1,3,4,25.0%,9m
12672,3,nmsl,3172,30,1,10,11,9.1%,14m
12672,2,SchlumpF,3172,0,0,1,1,0.0%,1h
12672,1,[SSFo]LotusKnows,3172,0,0,1,1,0.0%,13m
12694,3,NapoléonXVI,3171,1263,353,335,688,51.3%,2m
12694,3,Yanuko,3171,1445,253,245,498,50.8%,11m
12694,3,cuspidius,3171,1491,89,91,180,49.4%,2m
12694,3,BorriG,3171,1468,65,51,116,56.0%,11m
12694,1,FuriousDuck,3171,732,52,34,86,60.5%,28m
12694,3,Koh,3171,686,25,28,53,47.2%,7m
12694,3,ggashnik,3171,554,21,19,40,52.5%,1m
12694,1,[D2SA]MrFerlane,3171,312,8,8,16,50.0%,15m
12694,3,zadrot,3171,234,8,12,20,40.0%,17m
12694,2,TuckFrump,3171,164,6,4,10,60.0%,47m
12694,3,Felix,3171,118,5,6,11,45.5%,11m
12694,3,[BornG]Socks,3171,120,5,8,13,38.5%,13m
12694,1,SneakyDude,3171,124,4,2,6,66.7%,10m
12694,1,Leglass,3171,84,4,3,7,57.1%,19m
12694,1,Rumshack,3171,38,2,0,2,100.0%,3m
12694,3,helIrazor,3171,30,2,3,5,40.0%,20m
12694,1,[VenZG]alexander,3171,42,1,3,4,25.0%,29m
12694,3,BobyRyan,3171,0,1,3,4,25.0%,14m
12694,1,TheDrunkMonk,3171,0,0,1,1,0.0%,30m
12694,1,[CZMKL]TheMoleMan,3171,0,0,2,2,0.0%,7m
12714,3,BIgBean,3170,1291,111,91,202,55.0%,9m
12714,3,Urzai,3170,1397,109,121,230,47.4%,3m
12714,3,Jaguar,3170,708,52,43,95,54.7%,3m
12714,1,yoda,3170,772,41,7,48,85.4%,13m
12714,1,[S06R]Calvados,3170,676,24,14,38,63.2%,8m
12714,3,Dave,3170,438,19,18,37,51.4%,1m
12714,3,martiros,3170,329,12,9,21,57.1%,2m
12714,3,Fly,3170,182,6,12,18,33.3%,10m
12714,3,[Ǽ1]Cricri,3170,0,5,0,5,100.0%,52m
12714,3,Iruler,3170,166,5,18,23,21.7%,3m
12714,3,Crásh,3170,136,3,3,6,50.0%,17m
12714,3,[Dicboy]Pudgey,3170,60,3,5,8,37.5%,18m
12714,1,Georg,3170,40,1,1,2,50.0%,15m
12714,3,[Ǽ1]berserk,3170,0,1,2,3,33.3%,10m
12714,3,RageQuit,3170,0,0,4,4,0.0%,1m
12729,1,[LifeAD]dekril,3169,796,32,15,47,68.1%,20m
12729,1,hohner,3169,609,22,10,32,68.8%,15m
12729,3,izibanana,3169,451,19,18,37,51.4%,6m
12729,3,Skrippel,3169,297,11,9,20,55.0%,15m
12729,3,Civocky,3169,184,10,12,22,45.5%,3m
12729,1,[WGTG]stefmann,3169,229,6,1,7,85.7%,14m
12729,1,[GBoys]Mars,3169,0,1,0,1,100.0%,18m
12729,1,[DEDAL]qizdaTor,3169,0,1,0,1,100.0%,13m
12729,3,daekian,3169,30,1,4,5,20.0%,4m
12729,3,Iorgo,3169,0,0,4,4,0.0%,2m
12739,3,Excruciatus,3168,1534,265,262,527,50.3%,5m
12739,3,PRETORIUS,3168,1453,229,210,439,52.2%,6m
12739,3,Esdeath,3168,1401,99,96,195,50.8%,13m
12739,1,[POCCNR]KOT,3168,1502,69,66,135,51.1%,14m
12739,1,Vizzord,3168,1209,61,48,109,56.0%,9m
12739,1,[Bloopz]StormBlooper,3168,723,43,34,77,55.8%,9m
12739,3,Conguer,3168,658,41,38,79,51.9%,30m
12739,1,Weedz,3168,850,34,26,60,56.7%,16m
12739,3,Asava,3168,542,26,18,44,59.1%,12m
12739,3,ÆGodders,3168,511,21,15,36,58.3%,9m
12739,1,[Pönös]Archernar,3168,424,12,10,22,54.5%,12m
12739,3,MrFluffy,3168,245,10,4,14,71.4%,29m
12739,3,[Goja81]БуйныйБычара,3168,101,8,6,14,57.1%,13m
12739,3,[TONGJI]Major,3168,206,8,10,18,44.4%,4m
12739,1,Sacrament,3168,160,5,4,9,55.6%,18m
12739,1,Stranger,3168,160,4,4,8,50.0%,13m
12739,2,Deviac,3168,95,2,1,3,66.7%,3m
12739,1,Fernando,3168,0,1,1,2,50.0%,5m
12757,3,SerJ,3167,1454,79,65,144,54.9%,6m
12757,1,Benchmark,3167,1112,60,9,69,87.0%,4m
12757,3,[RеG]LeYsi,3167,1069,49,31,80,61.2%,29m
12757,1,Uran,3167,1253,45,39,84,53.6%,14m
12757,3,[BabG]Arkisto,3167,691,26,25,51,51.0%,6m
12757,3,Apex,3167,285,19,26,45,42.2%,11m
12757,1,[MoscH]Squirrely,3167,448,15,8,23,65.2%,19m
12757,3,LogiiK,3167,249,9,8,17,52.9%,29m
12757,1,Titanium,3167,259,7,5,12,58.3%,15m
12757,3,[DAXEI]HulkHoden,3167,90,3,9,12,25.0%,12m
12757,1,[WNTR]CryVI,3167,121,2,3,5,40.0%,18m
12757,3,StarKing,3167,120,2,3,5,40.0%,7m
12757,3,[ZERGML]HolySatan,3167,119,2,4,6,33.3%,18m
12757,3,qOrLrp,3167,0,1,2,3,33.3%,7m
12757,1,KaNa,3167,0,0,1,1,0.0%,19m
12757,1,LunatikGG,3167,0,0,1,1,0.0%,3m
12773,3,Snoemann,3166,1565,323,310,633,51.0%,9m
12773,3,Ambero,3166,1640,110,104,214,51.4%,5m
12773,1,Puqpetmaster,3166,1193,52,33,85,61.2%,4m
12773,3,DreamX,3166,914,34,33,67,50.7%,18m
12773,1,Wombat,3166,748,22,22,44,50.0%,19m
12773,1,[IceHus]Oleg,3166,440,14,6,20,70.0%,11m
12773,2,MrTOMASSO,3166,254,14,9,23,60.9%,2m
12773,3,[xFRSx]Metalhead,3166,399,13,15,28,46.4%,13m
12773,3,jon,3166,238,8,15,23,34.8%,14m
12773,3,Jackychoun,3166,191,6,6,12,50.0%,2m
12773,1,ЛжеЗерг,3166,78,2,3,5,40.0%,19m
12773,3,[P3rsé]Leondor,3166,0,1,3,4,25.0%,7m
12773,2,LittleChino,3166,30,1,10,11,9.1%,14m
12773,3,InternetOmen,3166,0,0,1,1,0.0%,8m
12773,1,barbouse,3166,0,0,1,1,0.0%,7m
12773,1,MundoPc,3166,0,0,1,1,0.0%,13m
12773,3,DragonGay,3166,0,0,4,4,0.0%,11m
12790,3,eCHo,3165,1439,66,66,132,50.0%,14m
12790,3,UltraM,3165,835,41,20,61,67.2%,19m
12790,3,[forceX]lion,3165,876,33,36,69,47.8%,5m
12790,1,dajpanspokoj,3165,415,15,6,21,71.4%,7m
12790,3,idol,3165,378,14,13,27,51.9%,29m
12790,3,[FMG]WhiteEagle,3165,392,12,29,41,29.3%,17m
12790,3,trailerzs,3165,211,10,7,17,58.8%,12m
12790,3,Mercutio,3165,208,8,9,17,47.1%,14m
12790,1,Raven,3165,143,7,5,12,58.3%,5m
12790,1,[WATW]Klimod,3165,122,3,2,5,60.0%,12m
12790,1,magok,3165,44,1,1,2,50.0%,14m
12790,3,[PrTons]Trancelaxor,3165,30,1,5,6,16.7%,10m
12790,1,[5gb]TheKiller,3165,0,0,2,2,0.0%,13m
12790,3,BadAce,3165,0,0,3,3,0.0%,13m
12804,3,Kruul,3164,1077,137,108,245,55.9%,18m
12804,3,limbo,3164,490,21,15,36,58.3%,13m
12804,3,mcbona,3164,532,19,17,36,52.8%,13m
12804,3,LAJW,3164,314,19,18,37,51.4%,18m
12804,3,[InitRu]wispEr,3164,522,17,19,36,47.2%,30m
12804,1,[BRCH]Hypophis,3164,306,8,10,18,44.4%,10m
12804,1,[BuCrew]luckycro,3164,0,5,0,5,100.0%,1m
12804,1,[ProGC]ekinoxX,3164,40,5,2,7,71.4%,3m
12804,3,Dicboy,3164,0,4,1,5,80.0%,18m
12804,1,gimilzor,3164,42,1,2,3,33.3%,18m
12814,3,SooFeD,3163,452,76,73,149,51.0%,11m
12814,3,[Quite]PremiumToast,3163,951,38,36,74,51.4%,7m
12814,3,SIKN,3163,744,30,31,61,49.2%,29m
12814,3,[Frntln]oODARIOo,3163,302,19,12,31,61.3%,17m
12814,3,Idletime,3163,222,7,15,22,31.8%,2m
12814,3,[TQUILA]MEXIKNmarine,3163,94,5,2,7,71.4%,12m
12814,1,[DOOGIE]BruceWaynne,3163,152,5,5,10,50.0%,13m
12814,3,CrownGuy,3163,90,4,10,14,28.6%,4m
12814,1,Klyuman,3163,0,1,0,1,100.0%,28m
12814,1,EUgayHunter,3163,42,1,2,3,33.3%,16m
12814,1,HarrySeldon,3163,0,0,1,1,0.0%,10m
12814,1,HenryG,3163,0,0,1,1,0.0%,29m
12814,2,ZERO,3163,0,0,1,1,0.0%,10m
12814,1,[LPPBDP]Royalcheese,3163,0,0,2,2,0.0%,14m
12814,1,[PLA2N]Uroboros,3163,0,0,2,2,0.0%,28m
12829,3,SERRAL,3162,1537,549,549,1098,50.0%,9m
12829,3,[CJFF]chee,3162,1496,106,93,199,53.3%,10m
12829,3,IIIIIIIIIIII,3162,532,98,109,207,47.3%,30m
12829,3,Will,3162,1469,73,79,152,48.0%,15m
12829,3,Guwbu,3162,1175,63,48,111,56.8%,4m
12829,3,Dronomeka,3162,896,32,43,75,42.7%,14m
12829,3,WhenRaxFly,3162,644,28,32,60,46.7%,13m
12829,3,OneNatural,3162,645,26,21,47,55.3%,17m
12829,3,Defouraï,3162,89,17,11,28,60.7%,10m
12829,3,pierre,3162,342,15,15,30,50.0%,3m
12829,2,[DLOK]Forsman,3162,322,13,10,23,56.5%,12m
12829,2,[SDTL]Veritas,3162,186,6,5,11,54.5%,5m
12829,3,KarhAn,3162,0,4,1,5,80.0%,3m
12829,3,[ZHxPro]DeltaFirst,3162,130,4,3,7,57.1%,30m
12829,3,[WSBC]Pixelkiller,3162,86,3,8,11,27.3%,5m
12829,3,[xp]BagRa,3162,30,2,9,11,18.2%,7m
12829,1,tryHard,3162,73,1,4,5,20.0%,1m
12829,3,demolistar,3162,0,0,1,1,0.0%,17m
12829,1,SpaceFREEZER,3162,0,0,1,1,0.0%,7m
12829,1,[THESCV]Starkiller,3162,0,0,2,2,0.0%,12m
12829,3,[Thanas]Heinzbert,3162,0,0,3,3,0.0%,3m
12829,3,[LeLeK]iCaLL,3162,0,0,4,4,0.0%,14m
12851,3,[BCHR]EstChe,3161,1597,132,121,253,52.2%,17m
12851,3,[DOKA2]KillReal,3161,1551,104,104,208,50.0%,20m
12851,3,Koda,3161,803,93,92,185,50.3%,8m
12851,3,demagok,3161,1527,74,65,139,53.2%,14m
12851,1,Kuiper,3161,1591,73,58,131,55.7%,29m
12851,3,Wanja,3161,797,44,58,102,43.1%,14m
12851,3,Krak,3161,555,21,19,40,52.5%,11m
12851,1,lymmeln,3161,292,11,4,15,73.3%,13m
12851,1,Miralansa,3161,306,9,6,15,60.0%,29m
12851,1,Макссс,3161,160,8,6,14,57.1%,28m
12851,3,[zVVz]Anathema,3161,220,7,12,19,36.8%,14m
12851,1,[ḾŞ7]Artur,3161,160,5,1,6,83.3%,15m
12851,1,GhostOfDark,3161,97,2,2,4,50.0%,1h
12851,3,AziwA,3161,30,2,3,5,40.0%,10m
12851,3,Denis,3161,58,2,8,10,20.0%,16m
12866,3,[Wu5]NOdie,3160,1540,154,145,299,51.5%,20m
12866,3,Todestrotzer,3160,1578,108,100,208,51.9%,29m
12866,3,Astia,3160,1133,48,39,87,55.2%,4m
12866,3,MementoMori,3160,790,31,31,62,50.0%,29m
12866,3,adder,3160,685,25,25,50,50.0%,6m
12866,3,Fantom,3160,485,21,16,37,56.8%,10m
12866,3,Nyduz,3160,403,17,14,31,54.8%,12m
12866,3,Statem,3160,368,13,19,32,40.6%,7m
12866,3,[ATHENE]Altai,3160,262,11,7,18,61.1%,14m
12866,1,Tiof,3160,355,9,5,14,64.3%,3m
12866,1,[IceHus]Drood,3160,198,6,3,9,66.7%,6m
12866,3,[TacoB]Squid,3160,178,6,10,16,37.5%,11m
12866,1,eXtick,3160,156,5,2,7,71.4%,3m
12866,3,[SТAR]LoganRU,3160,193,5,7,12,41.7%,14m
12866,3,[eXøde]creedyx,3160,139,4,3,7,57.1%,14m
12866,3,SvenRedBeard,3160,121,3,0,3,100.0%,1h
12866,1,Astah,3160,0,3,2,5,60.0%,4m
12866,1,[ScHb3R]MaLexGamer,3160,145,3,3,6,50.0%,58m
12866,1,Empire,3160,120,3,5,8,37.5%,4m
12866,1,Camembert,3160,42,1,3,4,25.0%,20m
12866,1,NastyPiglet,3160,0,0,2,2,0.0%,11m
12887,3,cosmic,3159,1613,138,140,278,49.6%,2m
12887,3,bobi,3159,1289,58,40,98,59.2%,4m
12887,1,[ЛĐT]Shadow,3159,793,29,19,48,60.4%,20m
12887,3,[lOY]JcNOvA,3159,446,17,19,36,47.2%,4m
12887,3,madeon,3159,184,17,20,37,45.9%,18m
12887,3,[FR1]AstRaxx,3159,301,14,9,23,60.9%,5m
12887,2,Trickx,3159,306,13,11,24,54.2%,17m
12887,1,Dragster,3159,347,12,8,20,60.0%,3m
12887,1,УЭБиПК,3159,151,7,3,10,70.0%,10m
12887,3,[lMMl]Cenfict,3159,143,3,4,7,42.9%,14m
12887,3,Babauzis,3159,60,3,6,9,33.3%,17m
12887,1,busybeaver,3159,112,2,5,7,28.6%,3m
12887,1,[HøTV]Zenex,3159,0,1,4,5,20.0%,16m
12887,1,KrO,3159,0,0,1,1,0.0%,20m
12887,1,Cho,3159,0,0,1,1,0.0%,18m
12887,1,Clozer,3159,0,0,4,4,0.0%,45m
12903,3,[Oops]Randsan,3158,1291,83,90,173,48.0%,17m
12903,3,Duffman,3158,1556,82,86,168,48.8%,7m
12903,3,Ythaq,3158,1151,72,60,132,54.5%,2m
12903,3,[lOoOl]Broodie,3158,1239,72,75,147,49.0%,14m
12903,3,[PSlSTC]Reborn,3158,1256,49,50,99,49.5%,12m
12903,3,chocsam,3158,791,32,36,68,47.1%,12m
12903,3,HorrorRabbit,3158,504,24,19,43,55.8%,1m
12903,3,[4qq]BitchBotBoi,3158,666,24,30,54,44.4%,18m
12903,1,rinez,3158,583,20,13,33,60.6%,20m
12903,1,IQlab,3158,313,9,6,15,60.0%,29m
12903,1,QZR,3158,230,7,2,9,77.8%,44m
12903,1,trotrolop,3158,174,7,7,14,50.0%,18m
12903,1,Fox,3158,158,5,4,9,55.6%,19m
12903,3,КрогСис,3158,0,4,2,6,66.7%,8m
12903,1,Tonio,3158,122,3,2,5,60.0%,19m
12903,1,Aheron,3158,0,1,0,1,100.0%,7m
12903,1,SweetCandy,3158,36,1,3,4,25.0%,13m
12903,3,[Frosta]NeverCake,3158,30,1,3,4,25.0%,19m
12903,3,Janush,3158,30,1,6,7,14.3%,9m
12903,1,Pompeyo,3158,0,0,1,1,0.0%,18m
12903,1,frozenhaert,3158,0,0,2,2,0.0%,10m
12903,3,refrigeratus,3158,0,0,3,3,0.0%,9m
12925,3,[Sativa]SNEG,3157,1260,44,62,106,41.5%,2m
12925,1,BulgeTickler,3157,380,23,23,46,50.0%,29m
12925,3,KoWaL,3157,443,19,16,35,54.3%,10m
12925,3,[chickn]Ares,3157,490,18,18,36,50.0%,6m
12925,3,diadon,3157,338,15,7,22,68.2%,4m
12925,3,prisi,3157,282,12,10,22,54.5%,18m
12925,3,thurile,3157,320,11,21,32,34.4%,29m
12925,3,MrLemon,3157,219,6,8,14,42.9%,10m
12925,1,essa,3157,0,5,0,5,100.0%,20m
12925,2,[SSC2]DeDMaZaY,3157,132,5,4,9,55.6%,10m
12925,1,[Beаr]Evgen,3157,124,4,3,7,57.1%,3m
12925,3,HydrØPøNeY,3157,114,4,5,9,44.4%,17m
12925,3,Виктор,3157,97,2,0,2,100.0%,1h
12925,1,benson,3157,0,1,2,3,33.3%,1m
12925,1,Serpent,3157,0,1,4,5,20.0%,10m
12925,3,KVG,3157,0,0,1,1,0.0%,21m
12941,3,LomKirkovich,3156,1606,231,206,437,52.9%,4m
12941,3,Nerull,3156,1567,225,217,442,50.9%,17m
12941,3,Narmer,3156,1513,145,143,288,50.3%,4m
12941,3,SkiF,3156,1354,108,103,211,51.2%,14m
12941,1,qwert,3156,1712,92,79,171,53.8%,12m
12941,3,[ArchTV]Dolmatt,3156,602,25,23,48,52.1%,12m
12941,1,VERZIZI,3156,416,14,9,23,60.9%,6m
12941,1,[STuL]subTEN,3156,353,14,11,25,56.0%,3m
12941,1,Optimist,3156,80,3,0,3,100.0%,6m
12941,2,SrDgo,3156,133,2,2,4,50.0%,60m
12941,1,Zabby,3156,0,0,1,1,0.0%,29m
12952,3,[Prosss]tor,3155,1556,414,413,827,50.1%,6m
12952,3,JulioCH,3155,940,66,58,124,53.2%,16m
12952,1,Cail,3155,501,38,33,71,53.5%,7m
12952,3,DanielSan,3155,541,35,38,73,47.9%,8m
12952,3,Pichu,3155,758,31,31,62,50.0%,17m
12952,1,[GGWPEZ]Koim,3155,759,28,15,43,65.1%,19m
12952,3,[olive]Dako,3155,737,28,39,67,41.8%,5m
12952,3,Gortak,3155,299,11,12,23,47.8%,14m
12952,3,[SƬǂ]GalaxyS,3155,132,9,16,25,36.0%,19m
12952,2,Serv,3155,144,7,3,10,70.0%,15m
12952,1,WidowCruiser,3155,198,6,5,11,54.5%,20m
12952,3,Hyperion,3155,0,5,0,5,100.0%,48m
12952,1,GintareS,3155,163,5,1,6,83.3%,18m
12952,1,Arekk,3155,204,5,8,13,38.5%,28m
12952,3,Aster,3155,0,4,1,5,80.0%,60m
12952,3,RapTor,3155,120,4,9,13,30.8%,17m
12952,1,Gamatix,3155,80,3,0,3,100.0%,12m
12952,2,wBLX,3155,139,3,1,4,75.0%,8m
12952,3,Buizerd,3155,94,2,3,5,40.0%,4m
12952,3,lllllllll,3155,0,2,3,5,40.0%,48m
12952,3,DIanE,3155,0,0,2,2,0.0%,16m
12973,3,[XEUS]Dan,3154,1424,175,177,352,49.7%,29m
12973,3,Tobiasz,3154,1014,169,169,338,50.0%,10m
12973,3,shadwell,3154,1554,117,115,232,50.4%,14m
12973,1,Scylzahr,3154,752,87,50,137,63.5%,11m
12973,2,Mik,3154,845,55,72,127,43.3%,10m
12973,3,Aeroskaedek,3154,1054,54,44,98,55.1%,14m
12973,1,[CS02]Darko,3154,1131,44,36,80,55.0%,12m
12973,1,[Pisdec]Mainkane,3154,817,32,20,52,61.5%,20m
12973,1,[яєѕ]owenose,3154,742,31,20,51,60.8%,8m
12973,3,oGGmux,3154,598,23,24,47,48.9%,9m
12973,1,DWARFRama,3154,702,21,17,38,55.3%,12m
12973,3,conclusus,3154,371,17,11,28,60.7%,20m
12973,3,[NctAc]BlackThunder,3154,268,9,15,24,37.5%,3m
12973,1,Mallazo,3154,0,4,1,5,80.0%,20m
12973,1,IIIIIIIIIIII,3154,118,3,2,5,60.0%,1m
12973,1,Khan,3154,128,3,5,8,37.5%,4m
12973,3,ıııııııııııı,3154,92,3,7,10,30.0%,29m
12973,1,TheDominion,3154,42,2,1,3,66.7%,15m
12973,3,Bone,3154,62,2,10,12,16.7%,6m
12973,1,Schneeble,3154,44,1,4,5,20.0%,12m
12973,1,Muffin,3154,0,0,1,1,0.0%,15m
12973,1,[AISC]Pericles,3154,0,0,1,1,0.0%,11m
12973,1,[CsWL]Dyukz,3154,0,0,1,1,0.0%,9m
12973,3,Spartan,3154,0,0,2,2,0.0%,17m
12997,1,Anduin,3153,1656,206,204,410,50.2%,16m
12997,3,[Pзrsia]ehsan,3153,1557,190,185,375,50.7%,20m
12997,1,[ExTr1m]lnogradsky,3153,1657,96,75,171,56.1%,14m
12997,3,[btwAY]Prolite,3153,1076,69,50,119,58.0%,18m
12997,1,[HeClub]AkashiSei,3153,901,40,13,53,75.5%,15m
12997,1,Zaytor,3153,621,26,7,33,78.8%,20m
12997,1,[SESHWB]RussianBoy,3153,715,24,19,43,55.8%,20m
12997,3,RubiSIO,3153,646,22,27,49,44.9%,7m
12997,3,kaiser,3153,516,17,32,49,34.7%,18m
12997,1,Micka,3153,573,16,18,34,47.1%,5m
12997,1,MicroBeastTV,3153,372,12,7,19,63.2%,18m
12997,1,[PИD]ClockWise,3153,262,8,13,21,38.1%,20m
12997,2,mycyka,3153,143,6,3,9,66.7%,8m
12997,3,EvilAlien,3153,38,6,5,11,54.5%,7m
12997,3,[PPHD]Pädl,3153,176,6,18,24,25.0%,10m
12997,1,Dimitri,3153,154,5,2,7,71.4%,3m
12997,1,fat,3153,100,5,2,7,71.4%,30m
12997,1,OnixJonix,3153,78,3,0,3,100.0%,9m
12997,1,Anajry,3153,78,3,0,3,100.0%,19m
12997,1,Job,3153,132,3,2,5,60.0%,11m
12997,1,Filemon,3153,128,3,6,9,33.3%,13m
12997,2,[CsTr]Korias,3153,182,3,9,12,25.0%,1h
12997,1,Wuk,3153,42,1,2,3,33.3%,19m
12997,3,[NTS]LtTrouble,3153,30,1,5,6,16.7%,15m
12997,1,[MMB]Ðiablø,3153,0,0,2,2,0.0%,13m
12997,1,[16MRNE]Cathilek,3153,0,0,3,3,0.0%,18m
12997,3,MerPanama,3153,0,0,8,8,0.0%,5m
13024,3,pulse,3152,1552,143,147,290,49.3%,3m
13024,3,[Ippon]One,3152,1503,92,106,198,46.5%,15m
13024,3,Panda,3152,565,55,51,106,51.9%,20m
13024,3,Human,3152,1230,54,55,109,49.5%,7m
13024,3,[MRSM]szabolcs,3152,925,50,47,97,51.5%,15m
13024,3,Taiga,3152,903,35,36,71,49.3%,5m
13024,3,LaxPappan,3152,931,33,36,69,47.8%,2m
13024,1,Emad,3152,476,19,11,30,63.3%,29m
13024,3,Arvantis,3152,387,18,19,37,48.6%,6m
13024,3,Picwic,3152,307,15,31,46,32.6%,1m
13024,3,Tendo,3152,394,13,13,26,50.0%,3m
13024,3,MOIxCOM,3152,114,8,5,13,61.5%,7m
13024,3,Richben,3152,275,8,10,18,44.4%,6m
13024,1,Xyu,3152,233,5,2,7,71.4%,11m
13024,1,redline,3152,162,4,2,6,66.7%,10m
13024,1,Kaukatsu,3152,160,4,3,7,57.1%,14m
13024,1,[mfixed]drzungla,3152,118,3,1,4,75.0%,19m
13024,3,Krul,3152,90,3,7,10,30.0%,29m
13024,3,[Blacer]Deminz,3152,94,3,14,17,17.6%,5m
13024,3,Yegorka,3152,0,2,4,6,33.3%,16m
13024,1,Sune,3152,0,1,1,2,50.0%,12m
13024,1,[MАSTER]aleks,3152,0,0,1,1,0.0%,9m
13024,1,[Petrиs]Narf,3152,0,0,1,1,0.0%,12m
13024,1,BigChungus,3152,0,0,2,2,0.0%,16m
13048,3,[NotSuR]xtkbr,3151,1342,126,121,247,51.0%,14m
13048,3,[MaSiYa]Ekesko,3151,1465,105,99,204,51.5%,17m
13048,1,TankDriver,3151,931,41,23,64,64.1%,18m
13048,3,[KoKz]Castro,3151,1073,39,42,81,48.1%,30m
13048,3,Faust,3151,742,33,33,66,50.0%,3m
13048,1,solarwind,3151,462,21,10,31,67.7%,16m
13048,1,GeiSha,3151,234,10,5,15,66.7%,45m
13048,3,jCsTyLe,3151,233,9,13,22,40.9%,15m
13048,1,Gabriel,3151,174,6,2,8,75.0%,3m
13048,1,VATOO,3151,198,6,6,12,50.0%,16m
13048,2,[RUSMÜL]FONGUY,3151,182,5,6,11,45.5%,1h
13048,3,Place,3151,120,5,10,15,33.3%,10m
13048,1,Crafteurien,3151,0,4,1,5,80.0%,11m
13048,1,[Leolan]LonelySpirit,3151,156,4,5,9,44.4%,18m
13048,1,[CIGC]MrSmi,3151,0,1,0,1,100.0%,14m
13048,1,[SC2SPB]Ila,3151,0,1,0,1,100.0%,5m
13048,2,cabbar,3151,0,1,0,1,100.0%,11m
13048,1,[betaAL]Yuno,3151,40,1,4,5,20.0%,28m
13048,3,Original,3151,0,1,4,5,20.0%,14m
13048,1,PowerDen,3151,38,1,5,6,16.7%,18m
13048,3,[AFCN]Flomotion,3151,0,0,1,1,0.0%,49m
13048,1,Gfhh,3151,0,0,1,1,0.0%,12m
13048,3,Hush,3151,0,0,2,2,0.0%,1m
13048,1,zhouyi,3151,0,0,2,2,0.0%,7m
13048,1,[12SKT1]HERO,3151,0,0,3,3,0.0%,1m
13073,3,Slo,3150,1645,148,146,294,50.3%,16m
13073,3,Cyborg,3150,1581,142,135,277,51.3%,5m
13073,3,Basa,3150,901,70,69,139,50.4%,3m
13073,3,mellivora,3150,1452,68,53,121,56.2%,2m
13073,1,Zairo,3150,481,27,28,55,49.1%,20m
13073,2,Muli,3150,910,27,57,84,32.1%,30m
13073,3,[Dz]DzJeth,3150,669,24,41,65,36.9%,18m
13073,1,FlakeyBanana,3150,723,22,17,39,56.4%,18m
13073,1,Mango,3150,682,20,18,38,52.6%,1m
13073,3,Bread,3150,488,19,19,38,50.0%,18m
13073,3,Fried,3150,406,14,21,35,40.0%,18m
13073,3,Bax,3150,414,14,27,41,34.1%,12m
13073,3,Random,3150,334,11,18,29,37.9%,6m
13073,3,SONOFGODS,3150,145,6,2,8,75.0%,58m
13073,3,[Qurwa]Vextor,3150,202,6,6,12,50.0%,19m
13073,1,Shoarmababba,3150,40,5,2,7,71.4%,1m
13073,1,axlspace,3150,150,5,2,7,71.4%,20m
13073,3,[Kira]Dam,3150,30,5,3,8,62.5%,7m
13073,3,Restecp,3150,0,4,1,5,80.0%,51m
13073,3,[DТ]geerzak,3150,114,4,5,9,44.4%,29m
13073,3,iLovePonYsNL,3150,145,3,6,9,33.3%,1m
13073,3,Misu,3150,60,2,5,7,28.6%,8m
13073,3,[ASPRU]Sitewalker,3150,30,2,6,8,25.0%,5m
13073,3,IlIIlllllIII,3150,0,1,0,1,100.0%,15m
13073,3,robotikov,3150,0,0,3,3,0.0%,6m
13073,1,[MadKuy]ELkukuy,3150,0,0,3,3,0.0%,4m
13099,1,[ArchTV]Dolmatt,3149,1661,235,227,462,50.9%,3m
13099,1,spawn,3149,1234,217,201,418,51.9%,6m
13099,3,Lasileuka,3149,655,106,105,211,50.2%,2m
13099,1,[LuuZ]sweetnawseN,3149,834,31,24,55,56.4%,14m
13099,2,Bytesnake,3149,835,29,47,76,38.2%,17m
13099,3,[Troled]ZeRoTRiX,3149,510,22,22,44,50.0%,15m
13099,1,Butcher,3149,439,14,9,23,60.9%,13m
13099,3,[OoZz]iHaWxHD,3149,345,12,12,24,50.0%,1m
13099,1,dio,3149,293,11,6,17,64.7%,18m
13099,1,[HaT]Jaguar,3149,206,5,8,13,38.5%,3m
13099,1,[муррка]Кирито,3149,38,3,3,6,50.0%,13m
13110,3,WaltherSan,3148,1430,207,194,401,51.6%,15m
13110,1,strizzi,3148,320,24,10,34,70.6%,28m
13110,3,Nowarich,3148,536,23,22,45,51.1%,17m
13110,1,Torresno,3148,332,14,10,24,58.3%,10m
13110,1,Cuchu,3148,294,9,5,14,64.3%,11m
13110,3,Good,3148,234,7,3,10,70.0%,16m
13110,3,LeungWing,3148,88,7,5,12,58.3%,8m
13110,1,Chaosberk,3148,262,7,8,15,46.7%,29m
13110,1,BUCS,3148,121,6,1,7,85.7%,20m
13110,1,[Dobro]vandrcontrol,3148,80,3,0,3,100.0%,12m
13110,1,Rudinho,3148,0,1,0,1,100.0%,18m
13110,1,CuRLy,3148,40,1,2,3,33.3%,13m
13110,1,Enderwiggin,3148,40,1,3,4,25.0%,1m
13110,2,DerehamPride,3148,0,0,1,1,0.0%,50m
13124,3,VeilNepula,3147,1416,196,181,377,52.0%,5m
13124,3,RaPaX,3147,1187,97,102,199,48.7%,3m
13124,3,Pagaille,3147,1541,89,84,173,51.4%,17m
13124,3,Innovation,3147,1486,82,82,164,50.0%,10m
13124,3,KindOf,3147,1261,61,69,130,46.9%,28m
13124,1,[NWGD]Skrilex,3147,518,21,13,34,61.8%,10m
13124,1,LUGANA,3147,542,19,10,29,65.5%,18m
13124,3,[KTZ]Hakunamatada,3147,432,19,18,37,51.4%,12m
13124,1,Anokhi,3147,347,15,10,25,60.0%,19m
13124,1,[SPHTRS]Monty,3147,370,11,7,18,61.1%,7m
13124,3,oZo,3147,269,11,8,19,57.9%,5m
13124,2,Zeratul,3147,274,10,7,17,58.8%,9m
13124,3,[AWADM]Jalea,3147,256,10,12,22,45.5%,10m
13124,2,[M1o1T]nabbcake,3147,97,5,3,8,62.5%,1h
13124,1,MLD,3147,190,5,6,11,45.5%,19m
13124,3,[Sinful]Nightmare,3147,0,4,2,6,66.7%,1h
13124,3,[TDCHK]Croustigrou,3147,132,4,5,9,44.4%,18m
13124,1,[UAŦeam]TARoDaRo,3147,114,3,2,5,60.0%,29m
13124,1,rembal,3147,44,2,0,2,100.0%,10m
13124,1,Challenger,3147,42,2,1,3,66.7%,7m
13124,1,Kaya,3147,38,1,1,2,50.0%,7m
13124,3,BigDorull,3147,0,0,1,1,0.0%,16m
13124,1,[BWArmy]NANAR,3147,0,0,1,1,0.0%,10m
13124,1,[TAW]BaneRiders,3147,0,0,2,2,0.0%,4m
13148,3,AndyGw,3146,1599,188,194,382,49.2%,17m
13148,1,Deleron,3146,1772,143,135,278,51.4%,16m
13148,3,Smile,3146,1183,87,82,169,51.5%,12m
13148,1,SmallManIsak,3146,732,38,15,53,71.7%,18m
13148,3,[AoT]gray,3146,400,19,14,33,57.6%,8m
13148,1,jezeur,3146,492,15,11,26,57.7%,11m
13148,3,Zorteil,3146,240,12,9,21,57.1%,29m
13148,1,ByLYama,3146,189,9,4,13,69.2%,1h
13148,3,finmak,3146,244,8,14,22,36.4%,15m
13148,1,Pecorino,3146,187,6,2,8,75.0%,14m
13148,3,KarambA,3146,170,6,10,16,37.5%,20m
13148,3,RealTalk,3146,94,5,2,7,71.4%,14m
13148,3,Eclipse,3146,60,3,7,10,30.0%,20m
13148,3,PieTraS,3146,92,3,11,14,21.4%,6m
13148,1,[TZWP]Glück,3146,0,2,3,5,40.0%,10m
13148,1,[MYRK]Kane,3146,42,1,2,3,33.3%,20m
13148,1,Xvolte,3146,42,1,3,4,25.0%,14m
13148,1,[BREZAR]PurplPeplum,3146,36,1,3,4,25.0%,14m
13148,1,FiskeNett,3146,0,0,1,1,0.0%,14m
13167,1,[U19]Next,3145,1596,168,159,327,51.4%,19m
13167,3,SYaN,3145,1585,154,148,302,51.0%,8m
13167,1,Jhursty,3145,1743,101,75,176,57.4%,14m
13167,1,[LAMPA]ТоксичныйТеР,3145,1453,95,70,165,57.6%,14m
13167,2,[UATeam]Coach,3145,830,51,83,134,38.1%,3m
13167,1,[Дядя]illownQ,3145,1217,46,37,83,55.4%,1m
13167,3,[SCiE]TheNewTos,3145,393,33,19,52,63.5%,11m
13167,1,BuBze,3145,902,29,23,52,55.8%,8m
13167,3,[5Packs]MrGlox,3145,486,16,26,42,38.1%,3m
13167,1,Kwiatek,3145,415,15,8,23,65.2%,13m
13167,1,DeutchLand,3145,378,13,6,19,68.4%,8m
13167,1,rauskimon,3145,343,12,11,23,52.2%,29m
13167,3,noSkills,3145,241,11,7,18,61.1%,3m
13167,1,Anostra,3145,150,7,5,12,58.3%,13m
13167,3,[RTGG]Awake,3145,0,5,1,6,83.3%,14m
13167,3,[forceX]Prynik,3145,0,4,2,6,66.7%,54m
13167,1,[PiGPan]kovic,3145,120,4,2,6,66.7%,28m
13167,3,[ZestCP]INnVocation,3145,150,4,6,10,40.0%,7m
13167,3,Rubaka,3145,30,2,6,8,25.0%,29m
13167,1,[CRIMP]iZnoGouD,3145,0,1,0,1,100.0%,3m
13167,1,GaborEmperor,3145,0,1,0,1,100.0%,6m
13167,1,[PiGPan]CptTurtles,3145,0,1,0,1,100.0%,3m
13167,3,[HFR]AsTro,3145,0,0,6,6,0.0%,13m
13190,3,Dirtus,3144,1558,376,373,749,50.2%,6m
13190,1,KGMHU,3144,1702,142,125,267,53.2%,14m
13190,1,Dem,3144,1779,132,131,263,50.2%,11m
13190,3,dragonheart,3144,1094,118,104,222,53.2%,3m
13190,3,wardice,3144,1479,60,58,118,50.8%,16m
13190,3,wurmvati,3144,805,58,45,103,56.3%,12m
13190,1,[RedP]tonkado,3144,1111,41,32,73,56.2%,8m
13190,1,Schtibbi,3144,352,14,5,19,73.7%,18m
13190,1,Hiro,3144,232,14,11,25,56.0%,19m
13190,3,Jason,3144,384,14,17,31,45.2%,14m
13190,3,Quad,3144,304,14,18,32,43.8%,18m
13190,3,RoviLDoS,3144,299,9,10,19,47.4%,8m
13190,1,romaric,3144,198,5,4,9,55.6%,13m
13190,1,Yuicy,3144,42,2,2,4,50.0%,10m
13190,1,xiele,3144,0,2,3,5,40.0%,18m
13190,1,[NAZBRO]FkY,3144,0,0,1,1,0.0%,29m
13190,1,DoruBunkaru,3144,0,0,1,1,0.0%,16m
13190,1,TERRAN,3144,0,0,1,1,0.0%,29m
13208,3,Clarinian,3143,1529,118,125,243,48.6%,8m
13208,3,[ODR]Spirit,3143,971,51,52,103,49.5%,4m
13208,3,Islander,3143,1026,38,40,78,48.7%,14m
13208,3,[DeWiN]Devin,3143,332,34,29,63,54.0%,20m
13208,3,[TPRR]Chris,3143,321,28,26,54,51.9%,6m
13208,1,Arael,3143,458,26,24,50,52.0%,29m
13208,3,WarLord,3143,511,20,20,40,50.0%,3m
13208,3,SandroGames,3143,424,19,13,32,59.4%,17m
13208,3,Kris,3143,136,4,7,11,36.4%,18m
13208,1,[dEbE]LilStats,3143,80,3,2,5,60.0%,10m
13208,1,[PuSl]BaGGeRTeaM,3143,40,2,3,5,40.0%,11m
13208,3,boFF,3143,30,1,7,8,12.5%,18m
13208,3,[XGKS]PeCoRiNo,3143,30,1,7,8,12.5%,3m
13208,1,zeratul,3143,97,1,8,9,11.1%,18m
13208,1,danBowlen,3143,0,0,1,1,0.0%,10m
13208,1,mumnum,3143,0,0,3,3,0.0%,11m
13224,3,logan,3142,982,308,307,615,50.1%,2m
13224,3,Mystic,3142,1400,88,89,177,49.7%,20m
13224,3,[pTa]Genbu,3142,768,47,55,102,46.1%,18m
13224,1,altrix,3142,986,34,28,62,54.8%,14m
13224,3,EvilE,3142,615,28,27,55,50.9%,2m
13224,3,[HBGSJR]tea,3142,346,19,13,32,59.4%,9m
13224,1,[C88731]KarmoJal,3142,520,17,16,33,51.5%,28m
13224,3,Storm,3142,304,10,14,24,41.7%,3m
13224,3,stickycake,3142,144,7,4,11,63.6%,20m
13224,1,Cassedi,3142,208,6,11,17,35.3%,18m
13224,2,Resotirio,3142,119,5,3,8,62.5%,57m
13224,1,[UMTAIS]Afterdeath,3142,0,4,1,5,80.0%,14m
13224,3,[IceHus]Ivashization,3142,0,1,4,5,20.0%,60m
13224,1,[NLTN]Ultralisk,3142,0,0,1,1,0.0%,17m
13224,1,Targaryen,3142,0,0,2,2,0.0%,20m
13224,1,Asseldor,3142,0,0,2,2,0.0%,9m
13224,3,kah,3142,0,0,4,4,0.0%,3m
13241,3,DaUub,3141,1529,123,117,240,51.2%,2m
13241,1,[Trran]aea,3141,1229,109,101,210,51.9%,13m
13241,3,Shatoboar,3141,1554,94,84,178,52.8%,29m
13241,3,[R0]Ciucaru,3141,1212,85,85,170,50.0%,17m
13241,3,amos,3141,926,45,47,92,48.9%,10m
13241,3,Radislav,3141,700,33,22,55,60.0%,29m
13241,1,RoscoeDream,3141,725,29,21,50,58.0%,3m
13241,1,Finngail,3141,475,25,5,30,83.3%,20m
13241,3,Thak,3141,173,20,24,44,45.5%,8m
13241,3,Alvear,3141,408,16,17,33,48.5%,7m
13241,1,MrMyskyl,3141,390,12,14,26,46.2%,13m
13241,3,ЗлойГном,3141,120,4,8,12,33.3%,30m
13241,1,[GiDi]Universe,3141,90,2,3,5,40.0%,2m
13241,3,totolalutur,3141,60,2,6,8,25.0%,6m
13241,1,Seraph,3141,40,1,1,2,50.0%,14m
13241,2,[MSUSC2]Tabiary,3141,94,1,1,2,50.0%,18m
13241,1,Eazy,3141,40,1,1,2,50.0%,9m
13241,1,zamesin,3141,0,0,1,1,0.0%,12m
13241,2,[viz]Lost,3141,0,0,2,2,0.0%,60m
13241,3,Kryel,3141,0,0,2,2,0.0%,14m
13241,1,[BITVA]Tovarisch,3141,0,0,3,3,0.0%,4m
13262,3,[LAVA]Painkiller,3140,1552,122,121,243,50.2%,14m
13262,3,Zinc,3140,1544,82,87,169,48.5%,13m
13262,1,fozzy,3140,1002,47,39,86,54.7%,19m
13262,3,Wurfyt,3140,195,31,38,69,44.9%,3m
13262,1,zizy,3140,202,6,2,8,75.0%,4m
13262,1,KEKEUGIVESOJ,3140,76,3,1,4,75.0%,20m
13262,1,Kampfkolos,3140,0,1,0,1,100.0%,14m
13262,1,улыбастик,3140,0,1,0,1,100.0%,4m
13262,1,DaNoM,3140,96,1,2,3,33.3%,12m
13262,1,Kinze,3140,89,1,2,3,33.3%,7m
13262,3,PinkGuy,3140,0,0,1,1,0.0%,16m
13273,1,Mortal,3139,1140,181,154,335,54.0%,6m
13273,3,Yukinep,3139,1592,137,121,258,53.1%,5m
13273,3,HeX,3139,1536,82,77,159,51.6%,29m
13273,3,soulyx,3139,860,80,70,150,53.3%,17m
13273,3,BRO,3139,684,46,41,87,52.9%,18m
13273,3,Sarminator,3139,897,36,34,70,51.4%,7m
13273,2,[W4N]Méphy,3139,257,11,11,22,50.0%,18m
13273,1,supermishboy,3139,191,8,6,14,57.1%,12m
13273,1,Chushkar,3139,40,4,1,5,80.0%,18m
13273,3,Kraken,3139,90,4,5,9,44.4%,29m
13273,1,[Regnum]DokwoN,3139,38,2,1,3,66.7%,10m
13273,1,Syber,3139,42,2,2,4,50.0%,29m
13273,1,Animal,3139,0,1,1,2,50.0%,2m
13273,3,[Неll]Devel,3139,0,1,1,2,50.0%,11m
13273,1,MaxManus,3139,0,0,1,1,0.0%,13m
13273,1,Bibbles,3139,0,0,1,1,0.0%,10m
13273,1,[S1MPLE]Mrnousak,3139,0,0,3,3,0.0%,8m
13273,3,Asdfer,3139,0,0,4,4,0.0%,6m
13291,3,YaaakoV,3138,1609,179,175,354,50.6%,2m
13291,3,Weedjo,3138,1553,126,116,242,52.1%,2m
13291,1,Ikarus,3138,1634,76,74,150,50.7%,13m
13291,1,kitkat,3138,956,35,31,66,53.0%,5m
13291,3,[eXe]Sobek,3138,678,27,27,54,50.0%,28m
13291,3,Hervé,3138,536,20,19,39,51.3%,18m
13291,1,[НТТ]Hashirama,3138,298,9,6,15,60.0%,3m
13291,1,GrumpyPants,3138,174,8,3,11,72.7%,28m
13291,3,Citrus,3138,82,6,3,9,66.7%,59m
13291,1,[TUPL]McDoudles,3138,93,5,2,7,71.4%,16m
13291,1,[7µ]Cygnet,3138,120,3,2,5,60.0%,13m
13291,1,Leech,3138,40,1,2,3,33.3%,5m
13291,1,[OEGH]Gothmog,3138,40,1,2,3,33.3%,20m
13291,1,ENDER,3138,0,0,1,1,0.0%,20m
13305,3,Goorr,3137,1371,130,125,255,51.0%,10m
13305,1,Frezzyy,3137,638,58,44,102,56.9%,5m
13305,3,Dewi,3137,809,30,30,60,50.0%,8m
13305,3,[sUpb]Tezcatlipoca,3137,512,28,38,66,42.4%,18m
13305,1,[OvZeTo]MCphilis,3137,559,21,11,32,65.6%,9m
13305,3,Romera,3137,474,18,23,41,43.9%,6m
13305,1,dodoodle,3137,389,12,8,20,60.0%,19m
13305,3,[F2AC]Solitair,3137,247,12,9,21,57.1%,20m
13305,1,CestHonteux,3137,278,11,7,18,61.1%,14m
13305,3,[QaDo]igrok,3137,257,10,7,17,58.8%,9m
13305,1,[OKUTO]Mirl,3137,330,9,7,16,56.2%,16m
13305,3,TheSunshine,3137,172,9,13,22,40.9%,9m
13305,1,Harkor,3137,144,8,4,12,66.7%,19m
13305,1,Paradox,3137,194,8,5,13,61.5%,4m
13305,2,kesha,3137,118,6,2,8,75.0%,1h
13305,3,[TBZVT]ruseh,3137,160,6,10,16,37.5%,13m
13305,2,Mike,3137,96,5,3,8,62.5%,52m
13305,1,USarmy,3137,82,3,0,3,100.0%,9m
13305,1,[Marazm]ПАРКИ,3137,121,3,1,4,75.0%,1h
13305,1,Cake,3137,0,2,3,5,40.0%,4m
13305,3,MeTaLisk,3137,0,1,0,1,100.0%,19m
13305,1,Nikitos,3137,0,1,1,2,50.0%,20m
13305,3,Schlele,3137,0,0,2,2,0.0%,52m
13305,2,[BiDC]Cooper,3137,0,0,2,2,0.0%,19m
13305,1,Xerxes,3137,0,0,2,2,0.0%,6m
13305,1,Exile,3137,0,0,4,4,0.0%,9m
13331,3,LiquidClem,3136,1585,194,201,395,49.1%,2m
13331,3,[HDSǂ]Globeskater,3136,1108,69,86,155,44.5%,8m
13331,3,Hex,3136,672,60,57,117,51.3%,20m
13331,3,eLFix,3136,1383,58,53,111,52.3%,13m
13331,1,KaffeMedFika,3136,708,49,2,51,96.1%,20m
13331,3,gnarl,3136,1126,40,46,86,46.5%,29m
13331,1,voices,3136,838,34,14,48,70.8%,20m
13331,3,SzuflA,3136,340,14,8,22,63.6%,3m
13331,3,Zee,3136,352,14,17,31,45.2%,3m
13331,3,[AMCque]WasGeht,3136,334,13,11,24,54.2%,16m
13331,1,[1C5]Shishajoe,3136,166,8,5,13,61.5%,50m
13331,3,DaRkHeLmeT,3136,202,8,11,19,42.1%,29m
13331,3,roberry,3136,0,3,2,5,60.0%,6m
13331,1,Sheldon,3136,130,3,4,7,42.9%,2m
13331,3,matzOr,3136,149,3,8,11,27.3%,6m
13331,3,[EBU]Snezhok,3136,0,0,1,1,0.0%,9m
13331,3,Arttaaz,3136,0,0,2,2,0.0%,6m
13331,1,quocturtle,3136,0,0,3,3,0.0%,3m
13349,3,DRMxTOF,3135,1549,211,204,415,50.8%,7m
13349,3,Hammuflex,3135,1483,176,174,350,50.3%,20m
13349,3,[HBGSJR]stepanator,3135,849,87,65,152,57.2%,28m
13349,3,nerlock,3135,867,55,64,119,46.2%,1m
13349,3,[voff]Smithyy,3135,976,41,45,86,47.7%,3m
13349,3,lutz,3135,1001,38,38,76,50.0%,18m
13349,3,rust,3135,344,18,18,36,50.0%,12m
13349,3,[PLA2N]Zarem,3135,470,18,23,41,43.9%,30m
13349,1,[H3N1]Aura,3135,428,17,14,31,54.8%,1m
13349,1,Cheyen,3135,422,11,12,23,47.8%,4m
13349,3,Grov,3135,171,5,6,11,45.5%,20m
13349,1,NapalMinFacE,3135,148,4,2,6,66.7%,29m
13349,1,dorald,3135,118,4,3,7,57.1%,18m
13349,1,[αX]BushZk,3135,42,2,1,3,66.7%,9m
13349,1,[Аven]ShamanKing,3135,40,2,2,4,50.0%,12m
13349,1,[Xl7]KnightLord,3135,0,1,0,1,100.0%,29m
13349,1,[ZЕRGTV]DOT,3135,0,1,4,5,20.0%,11m
13349,1,[BRSKR]MadCaT,3135,0,0,1,1,0.0%,7m
13349,1,deadpool,3135,0,0,1,1,0.0%,14m
13349,2,SonicTiger,3135,0,0,2,2,0.0%,12m
13369,3,Ivanhoe,3134,1553,186,175,361,51.5%,18m
13369,3,yoMAN,3134,1146,158,159,317,49.8%,14m
13369,3,[AiRǂ]Bonsai,3134,1536,157,161,318,49.4%,7m
13369,3,Kayak,3134,1536,135,114,249,54.2%,8m
13369,3,Alastor,3134,173,12,13,25,48.0%,14m
13369,1,[Specii]Cobra,3134,253,9,6,15,60.0%,10m
13369,3,[KPot]jutefire,3134,272,9,9,18,50.0%,29m
13369,1,DPDP,3134,206,8,4,12,66.7%,50m
13369,3,SSinner,3134,202,8,13,21,38.1%,9m
13369,1,Reeker,3134,210,6,4,10,60.0%,3m
13369,1,Demtexx,3134,192,5,6,11,45.5%,18m
13369,1,ANGY,3134,32,3,0,3,100.0%,14m
13369,1,zmisw,3134,40,1,4,5,20.0%,10m
13369,1,[Kicx]Cimiur,3134,0,0,1,1,0.0%,13m
13369,1,Driftoss,3134,0,0,1,1,0.0%,18m
13369,3,Батонок,3134,0,0,1,1,0.0%,52m
13369,1,Martoe,3134,0,0,2,2,0.0%,20m
13386,3,[INCRE]WebOn,3133,1554,207,215,422,49.1%,17m
13386,3,NoName,3133,598,137,125,262,52.3%,29m
13386,3,[UoBCP]CAVOK,3133,1582,100,97,197,50.8%,5m
13386,3,Стараюсь,3133,776,46,42,88,52.3%,7m
13386,3,Beckha,3133,1021,36,40,76,47.4%,16m
13386,1,[RIDERS]ChiefTc,3133,952,33,26,59,55.9%,9m
13386,3,Shiokann,3133,505,24,14,38,63.2%,7m
13386,1,zeta,3133,476,16,13,29,55.2%,4m
13386,1,Chombat,3133,335,11,9,20,55.0%,1m
13386,1,StanTheMan,3133,324,9,9,18,50.0%,7m
13386,1,Orc,3133,326,9,9,18,50.0%,2m
13386,1,[ERATA]Lutarus,3133,392,9,12,21,42.9%,18m
13386,3,yobu,3133,221,7,11,18,38.9%,7m
13386,3,Namii,3133,218,7,11,18,38.9%,6m
13386,3,[Peeps]KuomiPasztor,3133,122,5,7,12,41.7%,2m
13386,3,LemON,3133,145,4,0,4,100.0%,47m
13386,3,[GinAir]Pilou,3133,97,4,2,6,66.7%,1h
13386,1,[InfNgh]Dark,3133,197,4,2,6,66.7%,13m
13386,1,Omash,3133,122,3,3,6,50.0%,11m
13386,1,[RIVEN]Cylate,3133,126,3,6,9,33.3%,13m
13386,1,[ZUBS]Falcon,3133,0,2,3,5,40.0%,14m
13386,2,Roryx,3133,0,0,1,1,0.0%,10m
13386,1,[DragoM]GolD,3133,0,0,1,1,0.0%,3m
13386,1,Gryfek,3133,0,0,1,1,0.0%,20m
13386,1,DETROITOSMAA,3133,0,0,3,3,0.0%,9m
13386,1,SlideOfFists,3133,0,0,5,5,0.0%,7m
13412,3,wintermute,3132,1556,243,226,469,51.8%,9m
13412,3,YtekSpouki,3132,1547,231,211,442,52.3%,20m
13412,3,MadCrab,3132,1398,131,132,263,49.8%,1m
13412,1,[ZERGTV]IvanGP,3132,1280,65,45,110,59.1%,8m
13412,3,[SSC2]korsakov,3132,1212,44,48,92,47.8%,30m
13412,1,Perturabo,3132,648,27,10,37,73.0%,18m
13412,3,FallMist,3132,660,23,28,51,45.1%,14m
13412,3,KarisVenner,3132,565,21,18,39,53.8%,17m
13412,3,itgeorge,3132,438,15,19,34,44.1%,3m
13412,1,INSANITY,3132,218,5,2,7,71.4%,28m
13412,1,DUKICH,3132,0,1,0,1,100.0%,52m
13412,1,Orth,3132,0,1,0,1,100.0%,20m
13412,3,OKej,3132,0,1,0,1,100.0%,17m
13412,1,[DutchG]dragoon,3132,0,0,1,1,0.0%,59m
13412,1,lllllIIIIIll,3132,0,0,1,1,0.0%,11m
13412,3,Primal,3132,0,0,3,3,0.0%,4m
13412,3,Pattern,3132,0,0,6,6,0.0%,18m
13429,3,[dd33nt]DigitalDave,3131,1456,102,97,199,51.3%,12m
13429,3,[ÏnOuY]Cabocho,3131,1436,82,70,152,53.9%,8m
13429,1,Ludegr,3131,1556,71,47,118,60.2%,13m
13429,1,Waylander,3131,654,64,42,106,60.4%,6m
13429,3,trecdews,3131,758,27,33,60,45.0%,3m
13429,3,Makro,3131,721,26,32,58,44.8%,14m
13429,3,[glhf20]Sok,3131,569,21,25,46,45.7%,1m
13429,3,Sooriuken,3131,404,18,11,29,62.1%,8m
13429,3,ManyTwoO,3131,395,17,15,32,53.1%,29m
13429,1,[InitRu]MAGRE,3131,282,13,12,25,52.0%,4m
13429,1,[10110]Eiikø,3131,390,12,11,23,52.2%,20m
13429,1,Choco,3131,280,10,5,15,66.7%,10m
13429,1,BeastyQT,3131,153,9,0,9,100.0%,8m
13429,1,Prizrak,3131,350,9,11,20,45.0%,18m
13429,1,zerocool,3131,160,5,2,7,71.4%,19m
13429,3,Icedragon,3131,0,4,2,6,66.7%,8m
13429,1,Neytral,3131,74,2,5,7,28.6%,28m
13429,1,Vashou,3131,42,1,2,3,33.3%,8m
13429,1,Trickster,3131,36,1,5,6,16.7%,16m
13448,3,Foksaket,3130,1284,118,109,227,52.0%,1m
13448,3,Ankou,3130,1531,110,114,224,49.1%,8m
13448,3,[PLBG]KOZAKPL,3130,1141,103,68,171,60.2%,28m
13448,3,JYL,3130,949,59,66,125,47.2%,8m
13448,3,Øbscuritas,3130,715,48,51,99,48.5%,2m
13448,1,kingofmeow,3130,1039,38,31,69,55.1%,13m
13448,3,Segai,3130,616,25,14,39,64.1%,3m
13448,1,Klopowisch,3130,504,24,15,39,61.5%,4m
13448,3,SellHear,3130,493,20,17,37,54.1%,29m
13448,1,Sokolyanchik,3130,335,12,10,22,54.5%,13m
13448,3,eragon,3130,243,10,9,19,52.6%,5m
13448,1,Salomarine,3130,229,9,5,14,64.3%,15m
13448,1,Quoi,3130,240,6,8,14,42.9%,9m
13448,1,Gridjen,3130,158,5,2,7,71.4%,13m
13448,3,avraL,3130,150,5,12,17,29.4%,6m
13448,3,Fabl,3130,0,4,2,6,66.7%,18m
13448,1,[MMNSK]Neodymus,3130,189,4,5,9,44.4%,5m
13448,3,BoRRiCaNCo,3130,93,3,4,7,42.9%,19m
13448,1,Tryhard,3130,42,2,0,2,100.0%,13m
13448,1,Akiwil,3130,40,2,4,6,33.3%,18m
13448,1,[EBU]Princ,3130,0,1,1,2,50.0%,28m
13448,1,Gachimaster,3130,0,1,1,2,50.0%,20m
13448,3,[Toudou]KirniToudou,3130,44,1,3,4,25.0%,18m
13448,1,Sovjet,3130,0,0,1,1,0.0%,16m
13472,3,HTRON,3129,1456,87,85,172,50.6%,30m
13472,1,TaoPaiPai,3129,1767,72,61,133,54.1%,11m
13472,3,[SixPac]GameOfDrones,3129,1502,68,53,121,56.2%,8m
13472,1,Hill,3129,1209,45,46,91,49.5%,13m
13472,3,[Lilla]Voltrik,3129,1175,43,48,91,47.3%,9m
13472,1,bombelks,3129,1000,36,33,69,52.2%,3m
13472,3,Mengsk,3129,740,25,39,64,39.1%,3m
13472,3,AlanDM,3129,658,22,29,51,43.1%,12m
13472,1,Dannllllol,3129,241,12,8,20,60.0%,8m
13472,1,PMmisi,3129,364,11,9,20,55.0%,13m
13472,3,Retroxxar,3129,285,10,11,21,47.6%,15m
13472,1,Oladism,3129,194,6,4,10,60.0%,15m
13472,1,Selven,3129,0,3,2,5,60.0%,18m
13472,2,JumpyFire,3129,118,2,2,4,50.0%,18m
13472,1,Melon,3129,0,0,1,1,0.0%,16m
13487,1,Kamil,3128,1744,503,482,985,51.1%,12m
13487,1,bem,3128,999,108,96,204,52.9%,13m
13487,3,Algeroth,3128,1019,53,42,95,55.8%,17m
13487,3,[LeUcHt]TheDarkNight,3128,324,15,10,25,60.0%,30m
13487,1,ZamirRUS,3128,308,12,8,20,60.0%,18m
13487,1,Casph,3128,268,7,7,14,50.0%,3m
13487,1,axsc,3128,175,6,1,7,85.7%,4m
13487,2,[X2X]Athlonovich,3128,0,5,2,7,71.4%,20m
13487,2,IIllIIllIIll,3128,117,5,3,8,62.5%,51m
13487,1,Холди,3128,160,4,7,11,36.4%,13m
13487,1,Chupa,3128,84,3,2,5,60.0%,1m
13487,1,[Vakt]BearValley,3128,0,1,0,1,100.0%,2m
13487,1,omwibya,3128,0,0,1,1,0.0%,15m
13487,1,IIIIIIIIIIII,3128,0,0,1,1,0.0%,28m
13487,1,mishocii,3128,0,0,2,2,0.0%,29m
13502,3,Tekkers,3127,533,121,119,240,50.4%,3m
13502,3,benadam,3127,1544,86,98,184,46.7%,20m
13502,3,Anzen,3127,1085,56,48,104,53.8%,3m
13502,3,LKR,3127,1290,48,52,100,48.0%,8m
13502,3,DTYA,3127,251,44,40,84,52.4%,30m
13502,1,sasso,3127,1026,35,29,64,54.7%,2m
13502,1,BBKR,3127,576,20,15,35,57.1%,12m
13502,3,Musashi,3127,245,19,29,48,39.6%,18m
13502,1,[SCor]Tyrano,3127,317,13,12,25,52.0%,9m
13502,1,GhostFX,3127,314,9,4,13,69.2%,14m
13502,1,SmilBoy,3127,334,9,13,22,40.9%,11m
13502,1,bobo,3127,156,7,7,14,50.0%,18m
13502,3,Relapse,3127,202,6,20,26,23.1%,6m
13502,3,Cephyric,3127,121,5,2,7,71.4%,14m
13502,3,Mergi,3127,198,5,9,14,35.7%,29m
13502,1,Torres,3127,114,3,1,4,75.0%,20m
13502,1,Mazel,3127,80,3,3,6,50.0%,6m
13502,3,Sneex,3127,121,3,3,6,50.0%,9m
13502,3,TixTix,3127,58,3,5,8,37.5%,3m
13502,1,Summer,3127,80,2,1,3,66.7%,31m
13502,1,Lucki,3127,0,2,3,5,40.0%,15m
13502,1,Viktor,3127,0,2,3,5,40.0%,13m
13502,1,MiracLe,3127,0,0,1,1,0.0%,18m
13502,1,Infest,3127,0,0,1,1,0.0%,13m
13502,3,[115Par]Albombatron,3127,0,0,5,5,0.0%,19m
13527,1,[EV0C]bonecracker,3126,1636,192,179,371,51.8%,28m
13527,3,FeeLtoBlacK,3126,882,49,55,104,47.1%,8m
13527,1,ponchato,3126,829,46,8,54,85.2%,7m
13527,1,Wojeksl,3126,566,19,13,32,59.4%,13m
13527,3,[HANDS]shleopic,3126,406,14,20,34,41.2%,3m
13527,3,Thrall,3126,412,13,24,37,35.1%,11m
13527,1,Reiksguard,3126,306,9,9,18,50.0%,11m
13527,3,Modius,3126,275,9,11,20,45.0%,19m
13527,3,[Pmns]Ajax,3126,286,9,24,33,27.3%,18m
13527,1,galax,3126,192,8,5,13,61.5%,52m
13527,2,SCIIVirgin,3126,144,6,1,7,85.7%,52m
13527,1,[Arrows]Idwing,3126,176,5,7,12,41.7%,19m
13527,1,Anselme,3126,116,4,4,8,50.0%,15m
13527,1,Savior,3126,82,2,3,5,40.0%,20m
13527,1,[ВSL]Exalted,3126,0,1,0,1,100.0%,4m
13527,1,[CZEe]Sirup,3126,38,1,1,2,50.0%,4m
13527,1,qazcdewsx,3126,0,1,2,3,33.3%,13m
13527,1,Isle,3126,0,0,1,1,0.0%,9m
13527,1,SFO,3126,0,0,2,2,0.0%,8m
13546,3,SunSinK,3125,1459,185,179,364,50.8%,12m
13546,3,[ROPain]Insan,3125,1380,183,185,368,49.7%,29m
13546,3,Rvach,3125,1081,47,41,88,53.4%,3m
13546,3,winetu,3125,298,35,43,78,44.9%,3m
13546,1,djuret,3125,637,21,17,38,55.3%,8m
13546,1,Kai,3125,656,19,20,39,48.7%,20m
13546,1,dindontetu,3125,458,18,16,34,52.9%,9m
13546,1,Akillerduck,3125,518,17,12,29,58.6%,14m
13546,3,LikeADoge,3125,314,11,20,31,35.5%,6m
13546,2,effOrt,3125,210,9,9,18,50.0%,8m
13546,1,[GasNub]RosMaria,3125,0,4,1,5,80.0%,52m
13546,3,Itilorin,3125,97,4,2,6,66.7%,52m
13546,3,[Yeager]hollowUnit,3125,164,4,6,10,40.0%,16m
13546,1,chainfire,3125,0,3,0,3,100.0%,6m
13546,1,[RaaGaA]Goethe,3125,38,2,1,3,66.7%,14m
13546,1,NIHONIUM,3125,36,2,1,3,66.7%,13m
13546,1,Kounmani,3125,42,1,5,6,16.7%,29m
13546,1,Hubixb,3125,0,0,1,1,0.0%,5m
13546,2,Esmer,3125,0,0,1,1,0.0%,1h
13546,3,DrunkedSmurf,3125,0,0,1,1,0.0%,3m
13546,3,BlazeMarine,3125,0,0,6,6,0.0%,2m
13567,3,felix,3124,1549,335,335,670,50.0%,13m
13567,3,Skippy,3124,1582,168,159,327,51.4%,29m
13567,3,genius,3124,1489,122,130,252,48.4%,29m
13567,3,[THP]PLGaMo,3124,1415,88,80,168,52.4%,13m
13567,1,[IndyK]Mike,3124,1714,83,63,146,56.8%,18m
13567,1,BigChungus,3124,465,67,32,99,67.7%,29m
13567,3,Shaggy,3124,1209,67,60,127,52.8%,8m
13567,3,hevelius,3124,1330,52,56,108,48.1%,17m
13567,3,Heresy,3124,818,32,29,61,52.5%,11m
13567,1,[LLEDV]Foxtwo,3124,570,29,25,54,53.7%,3m
13567,3,[Shiet]Crysen,3124,494,21,15,36,58.3%,3m
13567,3,Knarr,3124,496,21,25,46,45.7%,13m
13567,3,[DSTARI]Kalapács,3124,205,13,14,27,48.1%,3m
13567,3,Ransom,3124,281,12,8,20,60.0%,13m
13567,3,IIIIIIIIIIII,3124,222,9,13,22,40.9%,18m
13567,3,DerPapa,3124,270,9,19,28,32.1%,7m
13567,3,lIlIllllIl,3124,228,8,16,24,33.3%,13m
13567,2,[ZERGML]hansolmane,3124,95,6,2,8,75.0%,1h
13567,2,Deuton,3124,200,5,8,13,38.5%,10m
13567,2,mishaZH,3124,139,3,1,4,75.0%,1h
13567,1,[COOPM]LOCKDOWN,3124,82,2,2,4,50.0%,9m
13567,1,Ulrezaj,3124,89,2,4,6,33.3%,13m
13567,1,Runich,3124,0,1,0,1,100.0%,5m
13567,1,Trinomic,3124,42,1,2,3,33.3%,9m
13591,3,Seal,3123,1146,126,123,249,50.6%,4m
13591,3,Leon,3123,1382,84,56,140,60.0%,6m
13591,1,denson,3123,1073,36,33,69,52.2%,12m
13591,1,Loliliebe,3123,496,21,10,31,67.7%,17m
13591,1,GeanSSC,3123,310,13,8,21,61.9%,16m
13591,1,iKe,3123,158,5,4,9,55.6%,8m
13591,3,[THANOS]Czaforaa,3123,122,5,10,15,33.3%,12m
13591,1,[U22U2]TerPomo,3123,156,4,5,9,44.4%,7m
13591,1,AiRǂBlackØut,3123,42,2,0,2,100.0%,28m
13591,1,[JaPP]makatao,3123,78,2,3,5,40.0%,4m
13591,1,NoIrek,3123,0,1,1,2,50.0%,18m
13591,1,EtHaNoL,3123,38,1,1,2,50.0%,8m
13591,3,jox,3123,0,0,1,1,0.0%,2m
13591,1,[UJ]JIMMYJOKER,3123,0,0,1,1,0.0%,18m
13591,3,DUMBAF,3123,0,0,1,1,0.0%,16m
13606,1,[Schabe]Napoleon,3122,1343,71,66,137,51.8%,8m
13606,1,[Bsc2]Gascon,3122,1329,50,38,88,56.8%,16m
13606,3,DarKebab,3122,1078,50,48,98,51.0%,8m
13606,1,IIIIIIIIIIII,3122,1165,48,30,78,61.5%,10m
13606,3,DaAims,3122,1184,43,46,89,48.3%,17m
13606,3,Dizzydi,3122,721,28,31,59,47.5%,14m
13606,1,[Hairy]Proffesi,3122,628,26,17,43,60.5%,4m
13606,3,[SAoN]pgo,3122,471,19,19,38,50.0%,8m
13606,3,Lorenz,3122,410,14,20,34,41.2%,8m
13606,1,CoCoKyJIuTKu,3122,400,12,9,21,57.1%,10m
13606,1,Moby,3122,213,10,4,14,71.4%,59m
13606,1,Harkey,3122,298,10,16,26,38.5%,13m
13606,1,bababbababab,3122,206,7,5,12,58.3%,16m
13606,1,KILO,3122,164,5,1,6,83.3%,29m
13606,3,Ntony,3122,60,5,6,11,45.5%,18m
13606,1,[ANKNA]Ankna,3122,40,2,1,3,66.7%,9m
13606,1,Meep,3122,42,2,4,6,33.3%,18m
13606,1,[IceHus]Begemotik,3122,0,1,0,1,100.0%,20m
13606,1,MarkyMcFly,3122,0,0,2,2,0.0%,4m
13625,3,caRnAGE,3121,1626,345,328,673,51.3%,18m
13625,3,Lewy,3121,1620,305,297,602,50.7%,5m
13625,3,[LifEGG]lllllLOYllll,3121,1169,79,59,138,57.2%,7m
13625,3,[ChXx]JakRam,3121,808,46,40,86,53.5%,5m
13625,1,BLEST,3121,762,26,24,50,52.0%,6m
13625,1,Blux,3121,370,10,10,20,50.0%,13m
13625,1,IIIIIIIIIIII,3121,366,10,16,26,38.5%,9m
13625,1,SunnyD,3121,190,6,8,14,42.9%,16m
13625,1,Cephei,3121,189,5,2,7,71.4%,11m
13625,1,tosha,3121,0,1,2,3,33.3%,8m
13625,3,Pirk,3121,0,1,5,6,16.7%,4m
13625,1,EgorC,3121,0,0,1,1,0.0%,16m
13625,1,[GXalpH]DiShU,3121,0,0,2,2,0.0%,13m
13638,1,[love2D]Light,3120,1756,182,146,328,55.5%,13m
13638,3,Jamalam,3120,1475,141,132,273,51.6%,9m
13638,3,Stonekiller,3120,870,126,113,239,52.7%,17m
13638,3,JavaSelenium,3120,1497,93,100,193,48.2%,1m
13638,3,piric,3120,736,67,64,131,51.1%,4m
13638,3,SunLightKing,3120,613,58,62,120,48.3%,6m
13638,1,lft,3120,1400,48,49,97,49.5%,10m
13638,3,Martin,3120,536,45,49,94,47.9%,9m
13638,1,[STDES]siwirus,3120,983,38,26,64,59.4%,29m
13638,3,YoshiYo,3120,686,31,26,57,54.4%,20m
13638,1,MisterJoken,3120,878,27,27,54,50.0%,13m
13638,1,Zzeraku,3120,396,11,15,26,42.3%,4m
13638,1,Bidouloux,3120,242,7,7,14,50.0%,19m
13638,3,llllllllllll,3120,166,6,3,9,66.7%,58m
13638,1,[NaCl6]DrZoidberg,3120,198,6,7,13,46.2%,16m
13638,1,[OUBL]Xenophon,3120,120,3,3,6,50.0%,8m
13638,2,askarmuk,3120,0,1,1,2,50.0%,1h
13638,1,Angron,3120,46,1,4,5,20.0%,1h
13638,1,[AnJ]Jaro,3120,0,0,1,1,0.0%,16m
13638,1,Aradan,3120,0,0,2,2,0.0%,13m
13638,3,soratanobaka,3120,0,0,4,4,0.0%,17m
13659,3,[RetroM]Farrukitito,3119,1555,209,204,413,50.6%,3m
13659,3,MackieMesser,3119,1045,191,189,380,50.3%,5m
13659,3,Gordon,3119,994,129,115,244,52.9%,10m
13659,3,JoeBlack,3119,1597,106,110,216,49.1%,18m
13659,3,Tornado,3119,1536,102,79,181,56.4%,18m
13659,3,DarthVaid,3119,1531,74,72,146,50.7%,9m
13659,3,HeroGosht,3119,812,64,68,132,48.5%,6m
13659,1,[Ktuluu]BlackEagle,3119,1137,47,30,77,61.0%,16m
13659,3,[Torby]STINGER,3119,1081,47,40,87,54.0%,16m
13659,3,Mephystofel,3119,830,32,37,69,46.4%,18m
13659,1,[RBP3]Zli,3119,587,16,15,31,51.6%,17m
13659,1,[Jesed]AcidMarine,3119,353,13,5,18,72.2%,3m
13659,1,[Sparky]Sparky,3119,454,13,12,25,52.0%,9m
13659,3,IoiLOS,3119,223,10,7,17,58.8%,6m
13659,3,TritoX,3119,196,8,7,15,53.3%,9m
13659,1,Jetmunj,3119,74,2,2,4,50.0%,11m
13659,1,[Gauge]antikrispain,3119,44,1,3,4,25.0%,18m
13659,3,ТЕЛЕВИЗОР,3119,0,0,1,1,0.0%,49m
13659,1,DaftJoker,3119,0,0,3,3,0.0%,12m
13678,1,Fede,3118,1517,197,182,379,52.0%,8m
13678,1,KerMiTe,3118,1750,149,139,288,51.7%,13m
13678,3,Angy,3118,1266,145,149,294,49.3%,17m
13678,3,Vell,3118,1311,137,146,283,48.4%,8m
13678,3,MaBro,3118,1419,119,120,239,49.8%,29m
13678,1,Antonio,3118,1589,115,89,204,56.4%,3m
13678,1,GeForce,3118,1144,86,79,165,52.1%,18m
13678,3,Archy,3118,1440,77,61,138,55.8%,29m
13678,3,[OK238]HeartcorE,3118,1172,68,67,135,50.4%,18m
13678,1,AdvaiceJeep,3118,613,31,10,41,75.6%,13m
13678,1,CheeseyPeas,3118,588,30,7,37,81.1%,18m
13678,1,[PaniC]TheNotorious,3118,681,27,29,56,48.2%,17m
13678,1,SmurF,3118,635,24,18,42,57.1%,10m
13678,3,HiotV,3118,624,24,21,45,53.3%,17m
13678,1,Rhaegar,3118,638,21,21,42,50.0%,20m
13678,3,ElBicho,3118,474,18,19,37,48.6%,4m
13678,1,[AgK]stroyer,3118,461,16,9,25,64.0%,20m
13678,3,[BeSC]AshOP,3118,412,15,20,35,42.9%,3m
13678,1,[Madone]CapN,3118,306,12,4,16,75.0%,7m
13678,3,Acustick,3118,319,10,14,24,41.7%,13m
13678,1,Svencho,3118,225,8,3,11,72.7%,16m
13678,1,None,3118,236,7,3,10,70.0%,16m
13678,3,barcode,3118,0,4,1,5,80.0%,20m
13678,1,astOOr,3118,154,4,5,9,44.4%,4m
13678,3,GRZES,3118,58,3,9,12,25.0%,20m
13678,1,MrLazy,3118,92,2,0,2,100.0%,16m
13678,1,[PGPH]bomilll,3118,0,1,0,1,100.0%,29m
13678,3,Partizancheg,3118,0,1,0,1,100.0%,3m
13678,3,Roundabout,3118,0,1,2,3,33.3%,18m
13678,1,[1NFEC7]oneeye,3118,38,1,3,4,25.0%,12m
13708,1,xxinixx,3117,786,169,159,328,51.5%,9m
13708,1,TPmfgZG,3117,1671,140,144,284,49.3%,16m
13708,3,hht,3117,821,129,135,264,48.9%,8m
13708,3,llllllllllll,3117,1242,98,97,195,50.3%,2m
13708,3,GordonRamsay,3117,1111,69,56,125,55.2%,5m
13708,3,Yank,3117,883,35,36,71,49.3%,18m
13708,3,Spectre,3117,499,24,23,47,51.1%,8m
13708,1,Shtirlitz,3117,413,12,8,20,60.0%,11m
13708,1,Entenvogel,3117,166,11,0,11,100.0%,3m
13708,2,[VaoR]VanDerVouts,3117,229,9,4,13,69.2%,20m
13708,1,GVNCGN,3117,190,8,5,13,61.5%,11m
13708,3,FatBlond,3117,118,5,4,9,55.6%,20m
13708,1,StarKiller,3117,0,4,1,5,80.0%,44m
13708,1,PainKiller,3117,84,2,1,3,66.7%,5m
13708,1,Präscha,3117,36,1,1,2,50.0%,13m
13708,2,Psholty,3117,44,1,2,3,33.3%,1h
13708,2,[LLFF]RipperZhalo,3117,46,1,2,3,33.3%,9m
13708,1,Satellite,3117,0,1,3,4,25.0%,10m
13708,3,[НОД17]chef,3117,30,1,7,8,12.5%,20m
13727,1,Terranium,3116,1556,135,123,258,52.3%,17m
13727,3,RedWolverine,3116,1510,118,133,251,47.0%,17m
13727,1,PepinoMarino,3116,1465,72,49,121,59.5%,18m
13727,1,[HsDL]Trebo,3116,1074,39,33,72,54.2%,10m
13727,1,NQlto,3116,380,30,21,51,58.8%,13m
13727,3,[Нrr]FGI,3116,696,25,27,52,48.1%,2m
13727,3,[zsír]FiatalVoltam,3116,426,20,15,35,57.1%,8m
13727,1,Ryzen,3116,544,17,12,29,58.6%,8m
13727,1,RyuMaster,3116,386,15,9,24,62.5%,9m
13727,1,ShiznGiggz,3116,416,11,14,25,44.0%,29m
13727,3,NainMaboul,3116,213,10,8,18,55.6%,19m
13727,1,Hans,3116,160,5,4,9,55.6%,11m
13727,1,bamsic,3116,0,3,2,5,60.0%,4m
13727,1,DarkTemplar,3116,0,3,3,6,50.0%,4m
13727,1,Danzo,3116,40,2,1,3,66.7%,18m
13727,2,RISING,3116,0,2,6,8,25.0%,46m
13727,3,[ez4klz]lokes,3116,64,2,9,11,18.2%,15m
13727,1,Sergeevich,3116,0,0,1,1,0.0%,11m
13727,1,Bexay,3116,0,0,2,2,0.0%,14m
13746,1,Siso,3115,1756,219,205,424,51.7%,13m
13746,3,Scar,3115,1567,182,174,356,51.1%,8m
13746,3,[аймой]HankoBrat,3115,1189,64,44,108,59.3%,13m
13746,1,MacroNoob,3115,1495,63,47,110,57.3%,18m
13746,1,Kelkun,3115,867,39,24,63,61.9%,11m
13746,3,meow,3115,678,32,23,55,58.2%,4m
13746,1,RADIOHEAD,3115,841,28,23,51,54.9%,8m
13746,3,Linteros,3115,98,13,13,26,50.0%,9m
13746,1,MikeJSimpson,3115,356,11,9,20,55.0%,16m
13746,1,jayx,3115,272,7,4,11,63.6%,20m
13746,1,[Heet]Temprature,3115,0,4,1,5,80.0%,1h
13746,3,Bartalife,3115,97,2,3,5,40.0%,1h
13746,1,Tareno,3115,40,1,2,3,33.3%,9m
13746,1,XDDDDDDDDDDD,3115,0,0,1,1,0.0%,6m
13746,1,[INCV]UTLRA,3115,0,0,1,1,0.0%,28m
13746,1,[WeAre]Pactain,3115,0,0,2,2,0.0%,4m
13746,1,SnakiiBall,3115,0,0,3,3,0.0%,13m
13763,1,Commander,3114,1765,271,258,529,51.2%,18m
13763,3,MarineLanD,3114,1528,112,117,229,48.9%,14m
13763,3,Speedmaster,3114,1198,74,64,138,53.6%,4m
13763,1,mRk,3114,717,30,29,59,50.8%,7m
13763,1,[NolG]Dugalle,3114,448,16,14,30,53.3%,15m
13763,3,Toouhoou,3114,305,12,7,19,63.2%,30m
13763,1,dontQ,3114,376,11,12,23,47.8%,8m
13763,1,BuBBles,3114,322,9,8,17,52.9%,13m
13763,1,Izvas,3114,262,7,6,13,53.8%,9m
13763,1,KaktusCar,3114,139,4,3,7,57.1%,29m
13763,1,Oli,3114,159,4,5,9,44.4%,59m
13763,3,MrSharky,3114,120,4,12,16,25.0%,16m
13763,3,Koi,3114,30,2,0,2,100.0%,7m
13763,1,[QTcIub]Kilian,3114,0,1,0,1,100.0%,6m
13763,1,Pennfield,3114,40,1,1,2,50.0%,20m
13763,1,Nick,3114,0,1,4,5,20.0%,10m
13763,2,llllllllllll,3114,0,0,2,2,0.0%,6m
13780,3,[N0glhf]FixVoidsFFS,3113,1514,258,257,515,50.1%,9m
13780,3,Kippa,3113,1484,184,170,354,52.0%,13m
13780,3,Gargamel,3113,905,109,94,203,53.7%,17m
13780,3,Chucky,3113,544,30,33,63,47.6%,11m
13780,1,losingisfun,3113,494,21,16,37,56.8%,15m
13780,3,[SC2L]Undead,3113,258,11,18,29,37.9%,3m
13780,1,niu,3113,217,9,3,12,75.0%,10m
13780,2,NbS,3113,165,7,4,11,63.6%,16m
13780,3,CodeBlue,3113,0,4,2,6,66.7%,14m
13780,3,bobjr,3113,93,4,3,7,57.1%,15m
13780,3,Abar,3113,30,3,7,10,30.0%,17m
13780,1,Torben,3113,111,2,2,4,50.0%,20m
13780,1,readme,3113,0,1,2,3,33.3%,20m
13780,1,LUPOS,3113,0,0,1,1,0.0%,12m
13780,1,[bisk]minigrav,3113,0,0,1,1,0.0%,1h
13780,3,Hibiscus,3113,0,0,2,2,0.0%,17m
13780,1,JustLasse,3113,0,0,2,2,0.0%,3m
13797,3,[SPAINs]Leewey,3112,1322,215,223,438,49.1%,8m
13797,1,[KoyBee]Zuggie,3112,1536,75,70,145,51.7%,3m
13797,1,[Koban]Shisui,3112,974,50,31,81,61.7%,13m
13797,1,Annonymouse,3112,677,39,24,63,61.9%,4m
13797,1,LarryMcfly,3112,911,36,25,61,59.0%,9m
13797,1,elrey,3112,792,25,25,50,50.0%,16m
13797,1,Weedle,3112,677,23,15,38,60.5%,16m
13797,1,[RckS]KSK,3112,634,23,20,43,53.5%,16m
13797,3,MBiologist,3112,240,22,26,48,45.8%,3m
13797,3,Rain,3112,566,20,21,41,48.8%,18m
13797,1,IIIIIIIIIIII,3112,484,16,18,34,47.1%,29m
13797,1,[APATOU]Deutritium,3112,340,9,10,19,47.4%,11m
13797,2,CHEAT,3112,165,7,3,10,70.0%,1h
13797,3,PatchRace,3112,178,6,23,29,20.7%,6m
13797,1,SuperKot,3112,118,4,3,7,57.1%,29m
13797,1,FredFesl,3112,146,4,4,8,50.0%,1h
13797,1,[FoRiGr]Klassic,3112,78,3,1,4,75.0%,29m
13797,1,Jenek,3112,0,1,0,1,100.0%,4m
13797,1,kigg,3112,0,1,0,1,100.0%,8m
13797,1,[ArĮnĒn]ØḼĐђŲÑŦĒŘ,3112,38,1,2,3,33.3%,14m
13797,1,[PNH]Fingolfin,3112,0,0,4,4,0.0%,29m
13797,3,Reshala,3112,0,0,7,7,0.0%,3m
13819,3,[k1raen]Darkstar,3111,1162,73,31,104,70.2%,3m
13819,1,[J4E]AxBattler,3111,815,45,46,91,49.5%,11m
13819,3,[fam1ly]Cheass,3111,686,44,36,80,55.0%,10m
13819,3,Parre,3111,754,31,39,70,44.3%,19m
13819,3,КОРИЦА,3111,617,22,25,47,46.8%,19m
13819,3,StarkerHanne,3111,260,9,17,26,34.6%,10m
13819,1,[сSсǃ]SpektoR,3111,228,7,6,13,53.8%,17m
13819,3,Aki,3111,184,7,19,26,26.9%,11m
13819,1,HaZNa,3111,89,6,0,6,100.0%,2m
13819,3,Miszor,3111,145,6,2,8,75.0%,20m
13819,1,[PIGEY]GRISuS,3111,260,6,5,11,54.5%,9m
13819,1,Dharmakara,3111,0,4,1,5,80.0%,14m
13819,3,Kookain,3111,97,4,2,6,66.7%,6m
13819,1,MrDrool,3111,178,4,2,6,66.7%,52m
13819,1,[QTclub]Boomshine,3111,106,3,6,9,33.3%,18m
13819,1,OKAY,3111,82,2,5,7,28.6%,17m
13819,1,IPxGhost,3111,0,1,0,1,100.0%,16m
13819,1,[WttKK]KHL,3111,0,1,0,1,100.0%,5m
13819,1,saber,3111,0,1,0,1,100.0%,55m
13819,1,Choco,3111,32,1,2,3,33.3%,15m
13839,3,[92rpz]Cocojacquo,3110,914,217,203,420,51.7%,17m
13839,1,Teranova,3110,1644,110,87,197,55.8%,13m
13839,1,Samu,3110,1235,46,39,85,54.1%,15m
13839,1,faucon,3110,1105,45,33,78,57.7%,12m
13839,1,[BaPaBo]Akiramator,3110,1179,41,32,73,56.2%,13m
13839,1,[NGJ]KimuKun,3110,466,18,18,36,50.0%,16m
13839,1,OladismFREE,3110,204,8,5,13,61.5%,1h
13839,3,Чупакупа,3110,186,6,3,9,66.7%,30m
13839,1,[VBNTM]FiestA,3110,97,3,2,5,60.0%,59m
13839,1,Neumann,3110,104,3,7,10,30.0%,13m
13839,1,Triakis,3110,0,1,0,1,100.0%,19m
13839,1,IIIIIIIIIIII,3110,0,0,1,1,0.0%,20m
13839,1,dslidd,3110,0,0,2,2,0.0%,11m
13839,2,[SaGo]Hagorian,3110,0,0,4,4,0.0%,1h
13853,1,Integro,3109,1757,339,331,670,50.6%,5m
13853,1,Fiti,3109,1266,147,117,264,55.7%,2m
13853,3,[ǂTEGǂ]RottiMcPott,3109,852,59,42,101,58.4%,19m
13853,1,[VBros]wunder,3109,988,33,33,66,50.0%,12m
13853,1,GameZsoocube,3109,873,32,24,56,57.1%,18m
13853,1,LiandriCorp,3109,311,26,21,47,55.3%,20m
13853,1,Ralog,3109,415,25,12,37,67.6%,11m
13853,3,GrandMal,3109,302,15,7,22,68.2%,30m
13853,3,Cannapeche,3109,292,12,15,27,44.4%,8m
13853,3,Balto,3109,202,11,8,19,57.9%,6m
13853,1,Daywalker,3109,0,4,1,5,80.0%,6m
13853,3,NizioR,3109,0,2,1,3,66.7%,46m
13853,2,Udini,3109,0,1,0,1,100.0%,18m
13853,1,BusI,3109,0,1,0,1,100.0%,6m
13853,1,Gundyr,3109,0,1,0,1,100.0%,29m
13853,1,[impro]SkyElite,3109,0,1,1,2,50.0%,8m
13853,3,IceStorm,3109,94,1,4,5,20.0%,9m
13853,2,[RFL]Fluo,3109,0,0,1,1,0.0%,1h
13853,1,ClydeTheFrog,3109,0,0,1,1,0.0%,6m
13853,1,Rnds,3109,0,0,4,4,0.0%,13m
13873,3,Fuegy,3108,1581,279,258,537,52.0%,20m
13873,1,NLJosh,3108,1711,87,78,165,52.7%,2m
13873,1,Indiana,3108,1523,55,51,106,51.9%,13m
13873,1,Abugio,3108,880,28,27,55,50.9%,2m
13873,1,[TaKeUL]Hirnspalter,3108,640,19,22,41,46.3%,15m
13873,1,Romanista,3108,534,16,14,30,53.3%,29m
13873,3,BomBardmenT,3108,310,13,9,22,59.1%,18m
13873,2,[Toxy]TomatoOnFire,3108,191,9,3,12,75.0%,1h
13873,1,Derpling,3108,0,4,1,5,80.0%,12m
13873,1,Izadrit,3108,38,2,1,3,66.7%,29m
13873,1,Sonic,3108,123,2,1,3,66.7%,19m
13873,1,[daimo]Zarxz,3108,0,2,3,5,40.0%,3m
13873,1,MiniGazou,3108,0,1,1,2,50.0%,18m
13873,1,Sally,3108,0,1,1,2,50.0%,15m
13873,1,[Kormt]Skipanes,3108,40,1,2,3,33.3%,9m
13873,1,[KillTA]croqpouce,3108,42,1,5,6,16.7%,7m
13873,1,Tarscher,3108,0,0,2,2,0.0%,18m
13873,3,Unexpected,3108,0,0,6,6,0.0%,13m
13891,3,ning,3107,1510,144,144,288,50.0%,14m
13891,1,MalaxovDuke,3107,1734,87,83,170,51.2%,11m
13891,1,[Hrr]Ethanolos,3107,701,39,30,69,56.5%,17m
13891,1,CunningStunt,3107,726,25,19,44,56.8%,12m
13891,1,[NL]Stan,3107,765,24,19,43,55.8%,19m
13891,1,DWolves,3107,368,20,15,35,57.1%,20m
13891,1,JinSquare,3107,258,10,6,16,62.5%,18m
13891,3,arthus,3107,145,8,0,8,100.0%,58m
13891,1,[H3N1]KƐRƐƩ,3107,288,8,9,17,47.1%,18m
13891,1,[Lames]Robot,3107,199,6,5,11,54.5%,29m
13891,1,julien,3107,213,5,4,9,55.6%,20m
13891,1,IIIIIIIIIIII,3107,0,4,1,5,80.0%,15m
13891,3,douki,3107,0,4,2,6,66.7%,1h
13891,1,TheEmpire,3107,108,4,2,6,66.7%,12m
13891,2,Himal,3107,0,4,3,7,57.1%,47m
13891,1,[PaniC]Winter,3107,104,3,6,9,33.3%,6m
13891,1,Plzkillme,3107,40,2,1,3,66.7%,2m
13891,1,Witkacy,3107,72,2,3,5,40.0%,18m
13891,1,INNNNoVatioN,3107,74,2,3,5,40.0%,14m
13891,3,NeverNude,3107,0,0,1,1,0.0%,6m
13891,1,ChiZerg,3107,0,0,2,2,0.0%,13m
13891,1,PrivatNuT,3107,0,0,3,3,0.0%,19m
13913,3,[Wolven]Tempest,3106,1086,141,146,287,49.1%,3m
13913,3,Marcello,3106,1422,90,90,180,50.0%,30m
13913,3,HateThisGame,3106,877,89,94,183,48.6%,5m
13913,3,Freeman,3106,1577,72,74,146,49.3%,15m
13913,3,Joost,3106,1169,47,54,101,46.5%,8m
13913,1,[0BO]Leo,3106,1200,46,33,79,58.2%,2m
13913,1,SalfetKa,3106,850,37,21,58,63.8%,16m
13913,1,[MSII]succersn,3106,583,26,16,42,61.9%,20m
13913,1,Wasserfliege,3106,592,19,15,34,55.9%,18m
13913,1,Dimarin,3106,428,12,12,24,50.0%,15m
13913,3,[GUGE]AjjKillJuu,3106,214,12,18,30,40.0%,8m
13913,1,creep,3106,136,7,5,12,58.3%,2m
13913,3,[PonyPS]ItsMeStillMe,3106,112,4,13,17,23.5%,3m
13913,1,[sc2vid]cyborg,3106,40,2,2,4,50.0%,20m
13913,1,[Sunray]CoalApple,3106,0,1,0,1,100.0%,11m
13913,2,[МLР]AppleJack,3106,0,1,0,1,100.0%,1h
13913,1,Zero,3106,0,1,0,1,100.0%,17m
13913,1,[КПCC]OurVictoury,3106,42,1,1,2,50.0%,29m
13913,1,DarkSonux,3106,44,1,5,6,16.7%,14m
13913,1,[M1SE]maghea,3106,0,0,1,1,0.0%,17m
13913,1,Vattgern,3106,0,0,1,1,0.0%,12m
13913,1,FanBoy,3106,0,0,1,1,0.0%,6m
13913,1,FlamezZz,3106,0,0,4,4,0.0%,17m
13913,3,[GfL]FrozZen,3106,0,0,6,6,0.0%,2m
13937,1,Kurka,3105,1489,55,52,107,51.4%,13m
13937,1,[ICE5]pydkloper,3105,1097,40,37,77,51.9%,5m
13937,1,Oni,3105,929,31,28,59,52.5%,29m
13937,3,Letroubado,3105,289,27,36,63,42.9%,5m
13937,3,Potato,3105,365,16,15,31,51.6%,19m
13937,3,rokis,3105,253,11,8,19,57.9%,17m
13937,3,Pros,3105,286,10,27,37,27.0%,15m
13937,1,Japi,3105,167,5,1,6,83.3%,9m
13937,1,TinTin,3105,198,5,2,7,71.4%,13m
13937,1,HopY,3105,140,3,2,5,60.0%,12m
13937,1,Ghost,3105,108,3,2,5,60.0%,29m
13937,1,Ozymandias,3105,0,3,2,5,60.0%,1h
13937,1,oleandreynik,3105,116,3,4,7,42.9%,7m
13937,3,[HUEMAE]HappyNewFear,3105,92,3,9,12,25.0%,6m
13937,1,Protector,3105,38,1,1,2,50.0%,17m
13937,3,GuamHurJun,3105,30,1,14,15,6.7%,29m
13937,1,[xFRSx]iMaster,3105,0,0,2,2,0.0%,3m
13937,3,[Fridge]Salvato,3105,0,0,6,6,0.0%,47m
13955,3,danaxagoras,3104,1433,230,218,448,51.3%,9m
13955,1,[DUF]Bllizdy,3104,1371,85,61,146,58.2%,19m
13955,1,[ETYM]skrop,3104,1643,64,59,123,52.0%,20m
13955,1,Heartburn,3104,1013,37,34,71,52.1%,13m
13955,1,LetsDoItQuik,3104,412,17,10,27,63.0%,14m
13955,1,LPanda,3104,285,8,5,13,61.5%,45m
13955,1,Scorpion,3104,88,4,2,6,66.7%,13m
13955,1,Lunatic,3104,40,2,1,3,66.7%,14m
13955,1,Axonate,3104,72,2,4,6,33.3%,29m
13955,1,LiveProtoss,3104,0,1,2,3,33.3%,7m
13955,3,[nopvp]nopvp,3104,0,1,7,8,12.5%,3m
13955,1,LionBex,3104,0,0,1,1,0.0%,2m
13955,1,Darkness,3104,0,0,1,1,0.0%,18m
13955,1,AUzg,3104,0,0,2,2,0.0%,14m
13955,2,AllForKix,3104,0,0,2,2,0.0%,20m
13955,1,Mylaur,3104,0,0,3,3,0.0%,3m
13971,3,haq,3103,1180,233,224,457,51.0%,29m
13971,1,Chaps,3103,1673,220,186,406,54.2%,14m
13971,3,Tass,3103,1586,199,188,387,51.4%,18m
13971,1,leif,3103,1282,138,114,252,54.8%,6m
13971,3,TaoMunK,3103,499,105,99,204,51.5%,4m
13971,3,Simkin,3103,988,85,62,147,57.8%,12m
13971,3,[VuV]Lichtkrieger,3103,576,47,56,103,45.6%,3m
13971,1,DangerZone,3103,905,37,26,63,58.7%,8m
13971,3,Sem,3103,715,27,26,53,50.9%,13m
13971,1,[sworld]söderkisen,3103,790,24,21,45,53.3%,29m
13971,1,Kreton,3103,379,20,12,32,62.5%,29m
13971,1,BloodLord,3103,398,18,9,27,66.7%,9m
13971,1,MCLK,3103,324,13,13,26,50.0%,9m
13971,1,fqsfqsdfqzef,3103,352,11,10,21,52.4%,29m
13971,1,MetalJack,3103,362,10,14,24,41.7%,11m
13971,1,eLPacho,3103,286,9,4,13,69.2%,5m
13971,3,dGaǂFortX,3103,114,5,4,9,55.6%,19m
13971,3,[XXXVCI]WonderKlaas,3103,133,5,8,13,38.5%,15m
13971,1,haloluckyboy,3103,0,3,2,5,60.0%,29m
13971,1,[br0t]Gevster,3103,80,3,3,6,50.0%,29m
13971,1,[ERQ]MawlinsTV,3103,42,2,3,5,40.0%,29m
13971,1,MKG,3103,95,1,1,2,50.0%,59m
13971,1,seb,3103,0,0,1,1,0.0%,29m
13971,1,boulevard,3103,0,0,1,1,0.0%,29m
13971,1,IIIIIIII,3103,0,0,3,3,0.0%,6m
13996,3,Mishiba,3102,1525,386,385,771,50.1%,4m
13996,3,[SpCI]sylwekPL,3102,1545,77,74,151,51.0%,8m
13996,3,[K3nGG]Omnipotentus,3102,336,64,62,126,50.8%,30m
13996,3,[ĦĦ]SelectTarget,3102,580,52,58,110,47.3%,19m
13996,3,ARMADA,3102,1100,51,42,93,54.8%,12m
13996,3,[MOLLAR]LeNap,3102,621,49,48,97,50.5%,13m
13996,1,RuLz,3102,678,21,21,42,50.0%,11m
13996,1,AveiMil,3102,303,13,9,22,59.1%,18m
13996,1,[1NFEC7]BiZarKiD,3102,187,8,5,13,61.5%,4m
13996,1,[G79]MajinGAMBIT,3102,158,5,4,9,55.6%,29m
13996,1,[KMaP]ForRseD,3102,82,3,4,7,42.9%,9m
13996,1,Noob,3102,80,2,5,7,28.6%,13m
13996,1,Kharathos,3102,0,1,1,2,50.0%,20m
13996,1,EMPEROROFMAN,3102,0,0,1,1,0.0%,4m
13996,1,[apeiro]propagare,3102,0,0,3,3,0.0%,7m
13996,3,Thorium,3102,0,0,8,8,0.0%,11m
14012,3,Gofarovich,3101,1509,112,107,219,51.1%,30m
14012,3,Bernkastel,3101,1355,99,89,188,52.7%,30m
14012,1,MidRange,3101,1182,82,72,154,53.2%,29m
14012,1,[HFR]TriasThePony,3101,1416,49,49,98,50.0%,19m
14012,1,dotexe,3101,512,17,12,29,58.6%,13m
14012,1,Byegas,3101,473,16,16,32,50.0%,29m
14012,1,Alfadark,3101,274,13,9,22,59.1%,4m
14012,3,ZoRGaT,3101,307,12,8,20,60.0%,13m
14012,3,GreShoN,3101,302,9,12,21,42.9%,15m
14012,1,BeerHead,3101,144,8,6,14,57.1%,1h
14012,3,Infection,3101,161,6,3,9,66.7%,60m
14012,3,pansky,3101,180,6,15,21,28.6%,18m
14012,1,[NTD]Zokanero,3101,0,4,1,5,80.0%,50m
14012,3,Borzvu,3101,97,2,1,3,66.7%,51m
14012,1,MichuX,3101,88,1,1,2,50.0%,14m
14012,1,Maschinchen,3101,0,1,2,3,33.3%,29m
14012,1,Monster,3101,0,0,1,1,0.0%,29m
14029,1,CHerOBukXpeH,3100,1602,315,294,609,51.7%,12m
14029,1,Krato,3100,1137,54,47,101,53.5%,4m
14029,1,overthrown,3100,1265,52,50,102,51.0%,19m
14029,3,Skorpo,3100,721,27,31,58,46.6%,5m
14029,3,GenoCyber,3100,191,20,24,44,45.5%,19m
14029,1,jaguarundi,3100,524,16,16,32,50.0%,2m
14029,3,COOL,3100,306,13,9,22,59.1%,13m
14029,1,Igrakhan,3100,254,12,7,19,63.2%,13m
14029,1,RicardnniZ,3100,219,9,6,15,60.0%,47m
14029,1,Nua,3100,256,7,4,11,63.6%,8m
14029,1,Zayaz,3100,226,7,6,13,53.8%,11m
14029,3,[Pespi]Sechtdamon,3100,145,6,2,8,75.0%,59m
14029,1,ChillyPillow,3100,159,4,2,6,66.7%,6m
14029,3,pchel,3100,156,4,5,9,44.4%,16m
14029,1,[сSсǃ]WannaBeMyslf,3100,131,3,0,3,100.0%,12m
14029,3,General,3100,93,3,2,5,60.0%,8m
14029,3,Egorich,3100,0,1,0,1,100.0%,1h
14029,2,[antkr]RobSchneide,3100,0,1,0,1,100.0%,1h
14029,1,IIIIIIIIIIII,3100,0,0,5,5,0.0%,12m
14048,3,[Arrows]John,3099,1592,613,602,1215,50.5%,20m
14048,3,Shinigami,3099,1583,107,91,198,54.0%,12m
14048,1,Cive,3099,1232,68,53,121,56.2%,16m
14048,3,clemmrogg,3099,1021,52,46,98,53.1%,12m
14048,1,[LIQUID]olddaddy,3099,1458,52,52,104,50.0%,4m
14048,1,croustibaie,3099,708,39,33,72,54.2%,4m
14048,1,Germinator,3099,852,37,25,62,59.7%,15m
14048,1,[REDFOX]Faneco,3099,844,37,29,66,56.1%,2m
14048,1,InLife,3099,494,19,19,38,50.0%,9m
14048,3,DeMHioS,3099,500,19,25,44,43.2%,10m
14048,1,GamerSC,3099,406,12,14,26,46.2%,29m
14048,1,Humos,3099,261,11,8,19,57.9%,18m
14048,3,Bignic,3099,137,8,3,11,72.7%,2m
14048,1,GhostFX,3099,238,8,4,12,66.7%,2m
14048,1,Mozilla,3099,88,5,1,6,83.3%,4m
14048,3,Chino,3099,143,5,2,7,71.4%,52m
14048,1,Sovetsky,3099,102,3,0,3,100.0%,11m
14048,1,CaptObvious,3099,114,3,6,9,33.3%,9m
14048,1,[TWO]TWOmore,3099,80,2,4,6,33.3%,17m
14048,1,[3m41s]KillthemAll,3099,0,1,0,1,100.0%,8m
14048,1,Pomponette,3099,40,1,1,2,50.0%,9m
14048,1,Jim,3099,40,1,2,3,33.3%,8m
14048,1,Asobiy,3099,0,0,1,1,0.0%,11m
14048,1,Moriarty,3099,0,0,1,1,0.0%,18m
14072,3,[PogC]Omni,3098,1354,150,154,304,49.3%,20m
14072,1,Kraskom,3098,818,53,48,101,52.5%,8m
14072,1,KIBERAM,3098,1009,43,34,77,55.8%,9m
14072,1,[RBP3]zeverynth,3098,198,30,15,45,66.7%,13m
14072,1,Louisss,3098,628,19,22,41,46.3%,29m
14072,3,oloftw,3098,181,9,6,15,60.0%,19m
14072,1,smiley,3098,156,5,5,10,50.0%,7m
14072,1,Raxulas,3098,140,3,1,4,75.0%,10m
14072,3,Thelon,3098,145,3,3,6,50.0%,10m
14072,1,[Kbanus]aurel,3098,0,1,0,1,100.0%,18m
14082,3,[russpr]Warvar,3097,1614,250,249,499,50.1%,12m
14082,3,Geekon,3097,1568,119,116,235,50.6%,8m
14082,1,RetribuDef,3097,1375,51,46,97,52.6%,12m
14082,3,[WACCA]Ruddy,3097,1448,51,70,121,42.1%,2m
14082,1,[InitRu]consoleLog,3097,477,31,16,47,66.0%,6m
14082,1,[Gener]Garyzla,3097,795,26,23,49,53.1%,11m
14082,1,[ncotic]SaD,3097,709,26,25,51,51.0%,11m
14082,3,Lexabarbos,3097,601,25,25,50,50.0%,7m
14082,3,GhostCommand,3097,321,14,8,22,63.6%,9m
14082,1,[VuV]MonkeyPower,3097,375,12,8,20,60.0%,15m
14082,1,OneTwo,3097,331,11,7,18,61.1%,13m
14082,1,UzbekyMan,3097,343,11,7,18,61.1%,13m
14082,1,TraiT,3097,336,10,12,22,45.5%,29m
14082,1,[PRVR]Anders,3097,245,9,10,19,47.4%,18m
14082,1,Clay,3097,174,8,2,10,80.0%,29m
14082,1,[NTLA]AlessioHu,3097,195,5,2,7,71.4%,29m
14082,3,mysteryH,3097,97,2,0,2,100.0%,1h
14082,2,DarkSide,3097,94,2,1,3,66.7%,6m
14082,1,Illidan,3097,0,1,0,1,100.0%,16m
14082,1,Redd,3097,88,1,1,2,50.0%,2m
14082,1,Xeato,3097,0,0,1,1,0.0%,19m
14103,3,[Borep]Rowang,3096,1027,98,89,187,52.4%,8m
14103,1,[DsK2]Shudy,3096,1743,88,89,177,49.7%,20m
14103,3,Gizmo,3096,1290,81,58,139,58.3%,14m
14103,1,mingo,3096,1440,68,58,126,54.0%,18m
14103,1,Varlok,3096,1282,52,45,97,53.6%,4m
14103,1,Undying,3096,1190,49,49,98,50.0%,16m
14103,1,[BELLEB]Gab,3096,876,41,38,79,51.9%,3m
14103,1,Klaymer,3096,659,29,15,44,65.9%,13m
14103,3,owlptr,3096,618,29,24,53,54.7%,13m
14103,1,Athoshiro,3096,479,18,18,36,50.0%,4m
14103,3,Arcsinger,3096,451,17,16,33,51.5%,29m
14103,3,[WBever]Jelljel,3096,333,14,16,30,46.7%,14m
14103,1,[ValidG]Qualmless,3096,296,13,7,20,65.0%,3m
14103,3,Bluemulti,3096,290,13,9,22,59.1%,13m
14103,1,GetUpStandUp,3096,330,13,10,23,56.5%,4m
14103,1,yodaogkush,3096,398,13,15,28,46.4%,12m
14103,3,Inbreddesu,3096,205,6,5,11,54.5%,15m
14103,3,[DT11]BoBo,3096,174,6,12,18,33.3%,16m
14103,1,Brox,3096,131,5,1,6,83.3%,16m
14103,2,FRANCYS,3096,0,1,0,1,100.0%,1h
14103,1,Hunyadi,3096,40,1,3,4,25.0%,14m
14103,2,Niñiah,3096,0,0,1,1,0.0%,1h
14103,1,Marco,3096,0,0,1,1,0.0%,20m
14103,1,Skilly,3096,0,0,1,1,0.0%,19m
14103,1,Parzival,3096,0,0,2,2,0.0%,5m
14128,1,Intoxikot,3095,1327,169,145,314,53.8%,14m
14128,3,Darkness,3095,1438,111,116,227,48.9%,5m
14128,3,Elnirath,3095,1448,79,72,151,52.3%,13m
14128,3,лорд,3095,1422,76,73,149,51.0%,16m
14128,1,Camel,3095,1108,46,32,78,59.0%,9m
14128,1,StarLight,3095,500,21,13,34,61.8%,2m
14128,3,[TBst]IstEst,3095,162,10,15,25,40.0%,2m
14128,1,vita,3095,310,9,9,18,50.0%,29m
14128,1,PapyTony,3095,266,8,10,18,44.4%,9m
14128,3,muschmumu,3095,189,5,9,14,35.7%,12m
14128,1,NinjaBorn,3095,102,3,1,4,75.0%,12m
14128,3,[xUKPx]Koki,3095,119,2,1,3,66.7%,18m
14128,1,OnlyMatt,3095,0,2,3,5,40.0%,59m
14128,1,alexfoxdave,3095,78,2,4,6,33.3%,8m
14128,1,Emufarmer,3095,123,2,5,7,28.6%,12m
14128,1,Gazdrek,3095,0,1,0,1,100.0%,8m
14128,1,[Peedrs]dallas,3095,40,1,2,3,33.3%,18m
14128,2,Warfield,3095,0,0,1,1,0.0%,10m
14128,1,BriO,3095,0,0,1,1,0.0%,2m
14128,1,Emilime,3095,0,0,2,2,0.0%,4m
14128,1,Skittles,3095,0,0,2,2,0.0%,7m
14149,3,plusmore,3094,1605,452,439,891,50.7%,19m
14149,3,jorad,3094,1568,389,382,771,50.5%,8m
14149,1,Mustaline,3094,1553,273,233,506,54.0%,15m
14149,3,imbacile,3094,1618,273,279,552,49.5%,13m
14149,3,Spitfire,3094,1473,101,79,180,56.1%,5m
14149,1,Tobi,3094,1736,89,78,167,53.3%,5m
14149,1,Berengere,3094,1601,68,60,128,53.1%,29m
14149,3,nicholincho,3094,941,36,33,69,52.2%,5m
14149,1,[RBP3]KRST,3094,874,26,29,55,47.3%,31m
14149,3,apartment,3094,698,25,32,57,43.9%,5m
14149,3,[BgScum]Mifkata,3094,326,21,29,50,42.0%,6m
14149,1,Callesen,3094,475,15,11,26,57.7%,14m
14149,1,SolidEye,3094,445,13,10,23,56.5%,11m
14149,1,[KIU]PsYchoPatH,3094,169,7,5,12,58.3%,15m
14149,1,[CHCANO]Luzivert,3094,170,6,0,6,100.0%,4m
14149,1,matyatya,3094,106,5,6,11,45.5%,14m
14149,1,waldymarxtnf,3094,124,3,6,9,33.3%,16m
14149,1,Lantariel,3094,38,2,2,4,50.0%,18m
14149,3,[IIllII]Valour,3094,121,2,2,4,50.0%,4m
14149,1,OffBeat,3094,0,0,1,1,0.0%,15m
14149,3,hmm,3094,0,0,1,1,0.0%,52m
14149,1,QuBuS,3094,0,0,1,1,0.0%,20m
14149,1,ALI,3094,0,0,2,2,0.0%,2m
14149,1,[994]DenENajs,3094,0,0,4,4,0.0%,1h
14173,3,[mfixed]Toarlu,3093,1608,308,306,614,50.2%,12m
14173,3,Dervish,3093,1470,163,160,323,50.5%,6m
14173,3,rusty,3093,1535,160,162,322,49.7%,3m
14173,3,zynq,3093,1560,143,149,292,49.0%,6m
14173,1,Thumpa,3093,1013,39,32,71,54.9%,29m
14173,3,Astragenesis,3093,860,31,34,65,47.7%,3m
14173,1,[ǂescǂ]icefordice,3093,852,26,31,57,45.6%,20m
14173,3,Verum,3093,673,23,27,50,46.0%,5m
14173,3,[Rakii]upoltned,3093,612,21,32,53,39.6%,5m
14173,1,mmmett,3093,323,16,13,29,55.2%,19m
14173,1,СЕРАФИМ,3093,355,14,8,22,63.6%,18m
14173,1,Etcelion,3093,393,14,9,23,60.9%,11m
14173,1,akduun,3093,234,9,7,16,56.2%,53m
14173,1,immortal,3093,210,7,10,17,41.2%,29m
14173,1,WinterOwl,3093,48,4,2,6,66.7%,14m
14173,1,llllll,3093,102,3,5,8,37.5%,2m
14173,1,[V1]waf,3093,0,1,0,1,100.0%,29m
14173,1,Shjno,3093,38,1,4,5,20.0%,20m
14173,1,Deathsong,3093,0,0,2,2,0.0%,29m
14192,1,Sanchezz,3092,1593,307,274,581,52.8%,20m
14192,3,Moon,3092,1482,280,283,563,49.7%,30m
14192,3,[k1raen]bebedyk,3092,1458,252,260,512,49.2%,11m
14192,3,Kaliostro,3092,1516,164,154,318,51.6%,16m
14192,3,eviltedy,3092,805,125,127,252,49.6%,9m
14192,3,Naturalplan,3092,1052,102,106,208,49.0%,20m
14192,3,scarabe,3092,738,64,75,139,46.0%,12m
14192,1,Nanatzuja,3092,773,29,22,51,56.9%,10m
14192,1,JawBreaker,3092,484,25,27,52,48.1%,13m
14192,1,прилив,3092,500,19,14,33,57.6%,8m
14192,1,Lisk,3092,258,11,13,24,45.8%,3m
14192,1,[ḆŽǤ]DIAZ,3092,237,8,6,14,57.1%,14m
14192,3,Tiger,3092,30,5,3,8,62.5%,19m
14192,1,Snippsnapp,3092,0,1,0,1,100.0%,8m
14192,3,holyu,3092,30,1,1,2,50.0%,17m
14192,1,Pektz,3092,0,1,2,3,33.3%,1h
14192,1,Xgamer,3092,0,0,1,1,0.0%,20m
14192,1,SeeYouINHell,3092,0,0,2,2,0.0%,29m
14192,3,miguelgondu,3092,0,0,3,3,0.0%,30m
14192,3,GkGxCreepyx,3092,0,0,6,6,0.0%,11m
14212,3,jokerSG,3091,1624,269,254,523,51.4%,20m
14212,3,Kvassi,3091,1537,217,213,430,50.5%,19m
14212,3,[PiGPan]CloudSailor,3091,1583,104,102,206,50.5%,9m
14212,1,Rakh,3091,1627,92,82,174,52.9%,29m
14212,3,Obiwan,3091,1032,41,43,84,48.8%,6m
14212,3,XLerate,3091,430,14,23,37,37.8%,7m
14212,1,ShockWave,3091,407,13,9,22,59.1%,10m
14212,1,[улей55]НосокСудьбы,3091,272,9,3,12,75.0%,2m
14212,1,SwEetTooTh,3091,186,5,6,11,45.5%,6m
14212,1,BrLeagueHero,3091,196,5,6,11,45.5%,15m
14212,1,[Овощи]Easy,3091,34,3,5,8,37.5%,16m
14212,3,Inevitable,3091,97,2,0,2,100.0%,4m
14212,1,CrazyCat,3091,76,2,4,6,33.3%,16m
14212,3,MrTock,3091,58,2,9,11,18.2%,2m
14212,3,ghost,3091,0,0,1,1,0.0%,52m
14212,1,RanbowXy,3091,0,0,2,2,0.0%,29m
14212,1,keirProtos,3091,0,0,4,4,0.0%,14m
14229,3,KZRUS,3090,918,107,97,204,52.5%,13m
14229,1,romaAmour,3090,750,92,51,143,64.3%,9m
14229,3,[SFA]mech,3090,1503,79,80,159,49.7%,18m
14229,1,PereNoël,3090,1368,54,45,99,54.5%,16m
14229,3,TED,3090,671,36,18,54,66.7%,13m
14229,1,[MacG]Mattlinn,3090,565,30,9,39,76.9%,12m
14229,1,zwackel,3090,812,30,25,55,54.5%,5m
14229,1,CraftsMAn,3090,877,28,26,54,51.9%,9m
14229,1,louiseflbdv,3090,465,24,12,36,66.7%,20m
14229,1,Soap,3090,412,18,8,26,69.2%,18m
14229,1,BroccoliRob,3090,306,10,8,18,55.6%,10m
14229,1,Migui,3090,308,8,10,18,44.4%,18m
14229,1,Toperhein,3090,122,5,3,8,62.5%,15m
14229,2,[SpasG]Destructo,3090,160,5,6,11,45.5%,51m
14229,1,[Kingz]Sakato,3090,166,5,6,11,45.5%,10m
14229,1,Lucifer,3090,48,4,2,6,66.7%,13m
14229,1,[ZERGТV]VICTOR,3090,80,2,3,5,40.0%,19m
14229,1,reran,3090,40,2,4,6,33.3%,18m
14229,1,[KlMCHl]LMY,3090,0,1,0,1,100.0%,3m
14229,1,Crime,3090,0,1,0,1,100.0%,1h
14229,1,Jacer,3090,0,1,0,1,100.0%,15m
14229,1,[ODGW]TheZealot,3090,36,1,2,3,33.3%,9m
14229,3,cloudoff,3090,0,1,7,8,12.5%,18m
14229,1,[AZZAAA]Undead,3090,0,0,1,1,0.0%,30m
14229,1,[FFoHM]Denali,3090,0,0,1,1,0.0%,6m
14229,1,[SEMEN]MamkaKenguru,3090,0,0,1,1,0.0%,8m
14229,1,deVoter,3090,0,0,2,2,0.0%,4m
14256,3,Dodger,3089,1479,183,176,359,51.0%,5m
14256,1,JosUA,3089,1647,159,148,307,51.8%,20m
14256,3,JohnJRamman,3089,1581,142,125,267,53.2%,15m
14256,1,kimhj,3089,782,94,92,186,50.5%,19m
14256,1,Thyrone,3089,1482,54,55,109,49.5%,13m
14256,1,sisipisi,3089,1386,53,50,103,51.5%,13m
14256,1,Guy,3089,1066,50,47,97,51.5%,9m
14256,1,macro,3089,761,34,31,65,52.3%,13m
14256,1,Anna,3089,714,30,13,43,69.8%,20m
14256,1,DönerKnight,3089,666,26,21,47,55.3%,8m
14256,1,RedStorm,3089,474,18,13,31,58.1%,19m
14256,1,Magic,3089,216,17,14,31,54.8%,7m
14256,1,[OMGHAM]OMGJAMBON,3089,256,8,7,15,53.3%,16m
14256,1,[Elli]Левиафан,3089,264,7,8,15,46.7%,11m
14256,1,Cletip,3089,133,5,1,6,83.3%,11m
14256,1,[TWIY]Tonydpala,3089,42,2,1,3,66.7%,6m
14256,1,PolandBoy,3089,61,2,2,4,50.0%,19m
14256,2,[LesPro]Mégatron,3089,0,1,1,2,50.0%,18m
14256,1,Funuko,3089,40,1,1,2,50.0%,3m
14256,1,[aL1]ProjektGam,3089,97,1,2,3,33.3%,1h
14256,1,Hyuk,3089,0,0,1,1,0.0%,16m
14256,1,NightKnight,3089,0,0,1,1,0.0%,20m
14256,2,JeDDas,3089,0,0,2,2,0.0%,51m
14256,1,[WIch]rodrigo,3089,0,0,3,3,0.0%,9m
14280,1,[ZERGSC]ALi,3088,1731,309,289,598,51.7%,9m
14280,3,[ØZc]Madman,3088,1473,182,169,351,51.9%,2m
14280,3,Souleater,3088,965,172,157,329,52.3%,4m
14280,1,shakalakabum,3088,1377,141,133,274,51.5%,8m
14280,1,YouTubTigron,3088,1728,123,117,240,51.2%,20m
14280,3,Spawn,3088,1372,104,104,208,50.0%,7m
14280,1,Cybershanks,3088,1519,87,81,168,51.8%,19m
14280,3,[PÂRłAH]Tomaso,3088,1493,65,65,130,50.0%,3m
14280,3,[GLHFGL]KäsekuchenA,3088,1396,58,59,117,49.6%,14m
14280,1,[KinEU]RatJack,3088,874,52,50,102,51.0%,8m
14280,3,TotallySavag,3088,679,31,28,59,52.5%,3m
14280,1,[HZeS]ТеньМонолита,3088,480,24,7,31,77.4%,19m
14280,1,didntwakeup,3088,597,18,18,36,50.0%,7m
14280,3,Ceiny,3088,482,17,18,35,48.6%,20m
14280,1,[Heroes]Konioo,3088,474,15,15,30,50.0%,31m
14280,3,sennt,3088,248,14,12,26,53.8%,30m
14280,1,Bingo,3088,434,13,11,24,54.2%,10m
14280,1,gooby,3088,392,13,12,25,52.0%,9m
14280,3,Augstine,3088,202,11,10,21,52.4%,8m
14280,1,ArkKnight,3088,209,9,3,12,75.0%,8m
14280,1,Dako,3088,117,6,7,13,46.2%,29m
14280,1,[ThUdLu]JustlDead,3088,121,5,3,8,62.5%,9m
14280,1,[Brnhlm]Kilgore,3088,188,5,7,12,41.7%,10m
14280,1,Spyder,3088,30,3,5,8,37.5%,14m
14280,1,[Wrex]seriosblack,3088,102,3,6,9,33.3%,6m
14280,1,Losca,3088,40,1,4,5,20.0%,7m
14280,1,Crankor,3088,0,0,1,1,0.0%,29m
14280,1,Kurgho,3088,0,0,1,1,0.0%,8m
14280,1,[Die4]Hartzfear,3088,0,0,2,2,0.0%,30m
14309,1,PeppeR,3087,1601,85,75,160,53.1%,2m
14309,1,[4ekavo]HranitelOka,3087,1266,62,43,105,59.0%,8m
14309,1,Borgut,3087,1031,45,37,82,54.9%,2m
14309,1,[BATOHb]OnePercent,3087,1194,41,47,88,46.6%,19m
14309,3,[Pylon]Helios,3087,565,40,41,81,49.4%,30m
14309,1,ShiftyShiva,3087,450,23,14,37,62.2%,18m
14309,3,GKmjd,3087,494,16,22,38,42.1%,12m
14309,1,[fumv]MrFister,3087,384,14,11,25,56.0%,16m
14309,3,FlyyTime,3087,214,14,21,35,40.0%,3m
14309,1,barcode,3087,260,13,2,15,86.7%,13m
14309,1,[SR5]Arantir,3087,300,8,12,20,40.0%,11m
14309,3,[Ai24]ATi,3087,146,7,5,12,58.3%,5m
14309,2,Rodman,3087,96,6,2,8,75.0%,20m
14309,2,xela,3087,145,6,3,9,66.7%,1h
14309,1,dhracer,3087,150,6,4,10,60.0%,29m
14309,1,[BigBud]Gamdja,3087,48,5,1,6,83.3%,10m
14309,3,Bjørn,3087,121,5,2,7,71.4%,1h
14309,2,[Sask2]Changeling,3087,167,5,3,8,62.5%,9m
14309,3,AnGo,3087,128,4,11,15,26.7%,10m
14309,1,BlackDog,3087,80,3,2,5,60.0%,11m
14309,3,Miwka,3087,119,2,2,4,50.0%,19m
14309,1,RaZa,3087,0,1,2,3,33.3%,8m
14309,1,Farce,3087,0,0,1,1,0.0%,14m
14332,3,Zatch,3086,1524,238,244,482,49.4%,2m
14332,1,enesercin,3086,1730,161,142,303,53.1%,16m
14332,1,nIls,3086,1668,75,67,142,52.8%,13m
14332,3,Aesthete,3086,1136,52,42,94,55.3%,19m
14332,1,Alexander,3086,936,48,39,87,55.2%,14m
14332,3,gaga,3086,816,35,35,70,50.0%,18m
14332,1,kurva,3086,678,31,12,43,72.1%,29m
14332,3,[MenIB]Gantoris,3086,607,24,20,44,54.5%,9m
14332,1,МастерКоля,3086,468,18,18,36,50.0%,16m
14332,1,[GLNM]CampingRush,3086,426,13,9,22,59.1%,14m
14332,1,Gratz,3086,454,12,14,26,46.2%,9m
14332,1,Krovah,3086,249,11,9,20,55.0%,4m
14332,1,vova,3086,300,9,9,18,50.0%,20m
14332,3,ExalT,3086,134,7,13,20,35.0%,29m
14332,1,Antoshka,3086,152,4,8,12,33.3%,20m
14332,1,Smoke,3086,106,2,2,4,50.0%,29m
14332,1,sandod,3086,88,1,1,2,50.0%,11m
14332,1,[Kingz]Dream,3086,0,0,1,1,0.0%,4m
14332,1,[4YLiFe]SPiriT,3086,0,0,3,3,0.0%,17m
14351,1,Ebeyshiy,3085,1724,133,122,255,52.2%,4m
14351,3,Ivan,3085,1480,133,134,267,49.8%,15m
14351,1,TERrOR,3085,1741,79,70,149,53.0%,14m
14351,1,[DМG]ShadowChar,3085,353,38,31,69,55.1%,13m
14351,1,[bomer]Wintex,3085,395,30,20,50,60.0%,17m
14351,3,[Kemvo]JotaGoldMan,3085,584,21,21,42,50.0%,19m
14351,1,PommeDeTerre,3085,423,13,12,25,52.0%,16m
14351,1,[FLBAR]BaRmaleY,3085,146,8,5,13,61.5%,18m
14351,1,Romance,3085,231,8,6,14,57.1%,8m
14351,1,Jezz,3085,0,4,1,5,80.0%,10m
14351,1,Firler,3085,126,3,2,5,60.0%,29m
14351,1,Gosumarine,3085,120,3,9,12,25.0%,12m
14351,1,omgvi,3085,40,2,1,3,66.7%,8m
14351,1,MariaCurie,3085,0,1,0,1,100.0%,11m
14351,1,[WBGA]danielzar,3085,0,1,2,3,33.3%,16m
14351,3,IIIIIIIIIIII,3085,97,1,2,3,33.3%,1h
14351,1,[prxspr]Moriz,3085,0,0,1,1,0.0%,14m
14368,3,[SodsLV]Cifo,3084,1570,397,412,809,49.1%,30m
14368,1,[Sarmat]Suhinho,3084,1518,329,296,625,52.6%,14m
14368,3,infinity,3084,970,201,188,389,51.7%,19m
14368,1,[BiGBRO]fortheglory,3084,946,32,31,63,50.8%,8m
14368,3,Kral,3084,774,31,29,60,51.7%,31m
14368,1,Artemis,3084,618,18,22,40,45.0%,6m
14368,1,Xador,3084,484,15,15,30,50.0%,29m
14368,1,[DgF2]Malzbier,3084,335,13,8,21,61.9%,14m
14368,1,vnmZor,3084,252,9,6,15,60.0%,17m
14368,3,Chaek,3084,240,9,8,17,52.9%,11m
14368,1,ReZylAzzir,3084,199,8,5,13,61.5%,19m
14368,3,Drumagick,3084,156,5,0,5,100.0%,31m
14368,3,sOzA,3084,0,5,1,6,83.3%,3m
14368,1,Kenzored,3084,154,5,2,7,71.4%,9m
14368,1,FadingLight,3084,114,4,4,8,50.0%,10m
14368,1,UnlimitedTD,3084,78,3,4,7,42.9%,6m
14368,2,diREKT,3084,0,3,5,8,37.5%,18m
14368,2,Parsa,3084,44,2,1,3,66.7%,59m
14368,1,ghosTy,3084,97,2,5,7,28.6%,4m
14368,2,[MaDn]SkA,3084,0,1,0,1,100.0%,21m
14368,1,[H0C]KozaNostra,3084,89,1,1,2,50.0%,3m
14368,1,Duudgy,3084,0,1,1,2,50.0%,3m
14368,1,Horus,3084,0,1,3,4,25.0%,12m
14368,1,WawaCool,3084,0,0,6,6,0.0%,4m
14392,3,BolDeRiz,3083,1563,145,137,282,51.4%,2m
14392,1,Virus,3083,1726,76,62,138,55.1%,19m
14392,1,tfffff,3083,1034,35,35,70,50.0%,16m
14392,1,franky,3083,771,27,21,48,56.2%,12m
14392,1,BamBam,3083,424,19,13,32,59.4%,16m
14392,1,Beansies,3083,284,16,13,29,55.2%,7m
14392,3,Jacubus,3083,400,14,13,27,51.9%,20m
14392,1,[NARUD]mama,3083,257,11,7,18,61.1%,20m
14392,3,AntiSoSexy,3083,342,10,16,26,38.5%,16m
14392,1,Dude,3083,344,9,14,23,39.1%,5m
14392,1,Stikette,3083,163,5,8,13,38.5%,20m
14392,1,XxLEAHPARxX,3083,0,3,2,5,60.0%,55m
14392,1,Barkly,3083,72,3,2,5,60.0%,15m
14392,1,PrivateTiger,3083,88,3,3,6,50.0%,15m
14392,1,Blazer,3083,38,2,5,7,28.6%,9m
14392,1,[TedB]LastDina,3083,0,1,0,1,100.0%,3m
14392,1,EXnoricum,3083,0,0,1,1,0.0%,5m
14392,2,DOCG,3083,0,0,1,1,0.0%,44m
14410,1,Cydonia,3082,1673,272,255,527,51.6%,12m
14410,1,oudeis,3082,1628,232,224,456,50.9%,18m
14410,3,NONT,3082,1595,127,125,252,50.4%,5m
14410,3,Piripero,3082,970,94,100,194,48.5%,12m
14410,1,[DvX]SaSiker,3082,1693,64,66,130,49.2%,29m
14410,1,Raoul,3082,1302,53,42,95,55.8%,16m
14410,1,Hellfire,3082,810,25,29,54,46.3%,6m
14410,1,[HiDu]Chummtoad,3082,454,13,15,28,46.4%,12m
14410,1,Wilpat,3082,307,11,10,21,52.4%,8m
14410,1,kovarnoelamo,3082,236,7,8,15,46.7%,29m
14410,3,Panda,3082,159,5,5,10,50.0%,1h
14410,1,[WIch]PiOeuvre,3082,141,4,1,5,80.0%,6m
14410,3,NiceHat,3082,145,3,2,5,60.0%,8m
14410,1,[BornG]Bleesk,3082,40,2,2,4,50.0%,13m
14410,1,Greypfrut,3082,0,2,4,6,33.3%,14m
14410,1,chaser,3082,40,2,4,6,33.3%,19m
14410,3,[Trals]whApaddy,3082,97,2,5,7,28.6%,1h
14410,1,HLOimnewhere,3082,0,1,0,1,100.0%,8m
14410,1,HanSolo,3082,40,1,2,3,33.3%,18m
14410,1,Brzuza,3082,0,0,1,1,0.0%,2m
14430,1,HbX,3081,1726,167,156,323,51.7%,29m
14430,1,[GHTRV]Heitlinger,3081,1025,68,56,124,54.8%,29m
14430,3,Explenker,3081,1039,41,50,91,45.1%,11m
14430,1,INnovation,3081,650,36,23,59,61.0%,8m
14430,1,Dmitrum,3081,763,34,24,58,58.6%,3m
14430,1,Luke,3081,697,34,29,63,54.0%,9m
14430,1,DarkGiant,3081,507,23,12,35,65.7%,16m
14430,3,Stemir,3081,605,22,27,49,44.9%,3m
14430,3,LDMA,3081,207,15,14,29,51.7%,9m
14430,1,anerki,3081,175,14,9,23,60.9%,11m
14430,3,GenCaster,3081,278,9,26,35,25.7%,10m
14430,2,Xgenman,3081,172,7,5,12,58.3%,2m
14430,1,OBELIX,3081,218,7,11,18,38.9%,16m
14430,1,[MTTT]Commander,3081,140,5,7,12,41.7%,11m
14430,1,knæss,3081,142,4,6,10,40.0%,9m
14430,1,Древний,3081,154,4,9,13,30.8%,14m
14430,1,Bergar,3081,0,3,3,6,50.0%,13m
14430,1,HOTdog,3081,0,2,3,5,40.0%,1h
14430,1,Xeltif,3081,86,2,5,7,28.6%,9m
14430,1,chetaesgayo,3081,0,1,0,1,100.0%,20m
14430,1,Mizur,3081,0,1,1,2,50.0%,20m
14430,1,AyaHomme,3081,0,0,3,3,0.0%,14m
14452,3,leulmark,3080,1363,81,92,173,46.8%,5m
14452,3,Chester,3080,975,79,61,140,56.4%,6m
14452,1,[iGD2D]keyman,3080,1430,64,56,120,53.3%,3m
14452,1,Mamba,3080,1120,40,37,77,51.9%,2m
14452,1,[Yame]Battlemage,3080,656,28,18,46,60.9%,2m
14452,1,Ashtray,3080,364,27,22,49,55.1%,29m
14452,1,Wolf,3080,570,21,16,37,56.8%,16m
14452,1,[RеG]дядяСаня,3080,383,17,9,26,65.4%,3m
14452,1,Demangelo,3080,244,8,9,17,47.1%,31m
14452,1,[KAOTx]Chargak,3080,100,6,1,7,85.7%,2m
14452,3,[SDFS]MrPAPABOY,3080,118,6,4,10,60.0%,16m
14452,2,TTBury,3080,0,4,3,7,57.1%,3m
14452,1,[CLD9]DwiGHTY,3080,130,2,2,4,50.0%,20m
14452,1,[Arrows]Revers,3080,38,1,2,3,33.3%,13m
14452,3,TesTyVexX,3080,0,1,6,7,14.3%,52m
14452,1,megasergPy,3080,0,0,1,1,0.0%,13m
14452,1,AveSwarmWLM,3080,0,0,1,1,0.0%,8m
14452,1,WeatherMan,3080,0,0,1,1,0.0%,13m
14470,3,PiL,3079,1155,208,217,425,48.9%,2m
14470,1,[XClayX]roman,3079,736,35,27,62,56.5%,15m
14470,1,[KAFF]Coestberg,3079,1070,35,38,73,47.9%,29m
14470,1,[StrHon]MonstR,3079,846,27,30,57,47.4%,12m
14470,3,IIIIIIII,3079,586,21,28,49,42.9%,5m
14470,1,[SoothK]OHADI,3079,601,19,18,37,51.4%,30m
14470,3,SweetRamekin,3079,471,18,19,37,48.6%,8m
14470,1,GrandPas,3079,539,17,15,32,53.1%,13m
14470,1,CordinAL,3079,281,9,5,14,64.3%,11m
14470,3,Third,3079,121,5,3,8,62.5%,6m
14470,1,BooMer,3079,103,3,0,3,100.0%,14m
14470,1,Klaus,3079,76,2,4,6,33.3%,17m
14470,3,[Kpa6]eldariel,3079,0,0,1,1,0.0%,7m
14470,1,[WOTBL]laba,3079,0,0,1,1,0.0%,20m
14470,1,Schtormy,3079,0,0,2,2,0.0%,5m
14485,3,airboss,3078,1504,351,338,689,50.9%,3m
14485,3,[KST]maro,3078,1529,154,157,311,49.5%,9m
14485,1,Слава,3078,1340,82,60,142,57.7%,16m
14485,1,Clemempereur,3078,925,60,55,115,52.2%,16m
14485,1,KittyFight,3078,904,29,29,58,50.0%,29m
14485,1,[UnderP]Romano,3078,590,23,17,40,57.5%,13m
14485,1,BlackEmperor,3078,448,13,12,25,52.0%,29m
14485,2,CookieThief,3078,130,12,1,13,92.3%,1h
14485,1,phobos,3078,220,9,7,16,56.2%,17m
14485,1,gnom,3078,306,9,10,19,47.4%,10m
14485,1,chebu,3078,270,8,9,17,47.1%,3m
14485,3,Razingbal,3078,218,8,16,24,33.3%,6m
14485,1,Drovosekpidr,3078,186,6,7,13,46.2%,3m
14485,1,DaMyst,3078,0,5,0,5,100.0%,29m
14485,1,[PickH]Joel,3078,231,5,5,10,50.0%,8m
14485,1,[N40G]Kâleem,3078,168,5,5,10,50.0%,12m
14485,1,[LiFe]Zeracyb,3078,125,4,6,10,40.0%,18m
14485,1,[K0mpis]Draco,3078,118,3,9,12,25.0%,11m
14485,1,ForAiur,3078,38,2,3,5,40.0%,29m
14485,1,exnihilo,3078,46,2,5,7,28.6%,11m
14485,3,Perserus,3078,118,2,9,11,18.2%,4m
14485,1,CMactin,3078,0,1,0,1,100.0%,29m
14485,1,Grumbler,3078,40,1,2,3,33.3%,20m
14485,1,vandal,3078,0,0,1,1,0.0%,5m
14485,1,[BRSKR]Bhix,3078,0,0,1,1,0.0%,8m
14485,1,Giomitico,3078,0,0,2,2,0.0%,20m
14511,1,EndLichGER,3077,1477,290,269,559,51.9%,9m
14511,3,Envoy,3077,1423,107,108,215,49.8%,12m
14511,1,WildPants,3077,892,53,16,69,76.8%,20m
14511,1,Olipeon,3077,1329,50,46,96,52.1%,13m
14511,1,PapaRimskij,3077,1164,48,37,85,56.5%,11m
14511,1,Anakin,3077,625,29,18,47,61.7%,5m
14511,1,ghydsg,3077,619,28,16,44,63.6%,5m
14511,1,[eSpB]RickoDeLucha,3077,350,13,7,20,65.0%,20m
14511,1,heat,3077,233,7,4,11,63.6%,20m
14511,1,YangWi,3077,220,7,8,15,46.7%,15m
14511,1,Denred,3077,88,6,0,6,100.0%,14m
14511,3,Ghostmarine,3077,0,4,2,6,66.7%,1h
14511,1,sonic,3077,104,3,1,4,75.0%,20m
14511,1,bearhugger,3077,104,2,1,3,66.7%,13m
14511,1,Nekromant,3077,0,1,0,1,100.0%,9m
14511,1,KatyPerry,3077,0,1,1,2,50.0%,6m
14511,1,MajorGrogg,3077,0,0,1,1,0.0%,16m
14528,3,rinaks,3076,1516,327,313,640,51.1%,3m
14528,3,Innoszorn,3076,1571,205,197,402,51.0%,30m
14528,1,[KoyBee]DjSwagbat,3076,1455,53,51,104,51.0%,29m
14528,1,[EfeM]kingkong,3076,932,52,42,94,55.3%,14m
14528,3,[YS4J]Hydro,3076,510,41,33,74,55.4%,15m
14528,3,Buur,3076,377,22,25,47,46.8%,30m
14528,3,polakziomek,3076,278,11,16,27,40.7%,16m
14528,3,Lee,3076,114,8,8,16,50.0%,12m
14528,3,Dismember,3076,30,6,3,9,66.7%,21m
14528,3,Gazpix,3076,154,6,11,17,35.3%,4m
14528,2,zeromarine,3076,0,4,3,7,57.1%,5m
14528,1,[CGNAN]PtiChapron,3076,174,4,5,9,44.4%,11m
14528,1,[MSK5]Dastmodest,3076,110,3,4,7,42.9%,8m
14528,1,WakeUp,3076,94,3,5,8,37.5%,10m
14528,1,Texay,3076,0,1,1,2,50.0%,11m
14528,1,toncha,3076,0,1,1,2,50.0%,10m
14528,1,[AlwysC]Stycan,3076,0,0,1,1,0.0%,17m
14528,1,ipman,3076,73,0,3,3,0.0%,2m
14546,3,[mfixed]Ryba,3075,1542,252,254,506,49.8%,16m
14546,1,FlowerKiller,3075,1361,129,122,251,51.4%,12m
14546,3,Phoenix,3075,1317,124,97,221,56.1%,16m
14546,1,PinkSheep,3075,1312,123,84,207,59.4%,29m
14546,1,FoulFiend,3075,1703,112,101,213,52.6%,12m
14546,1,[Burla]DonMario,3075,1438,95,84,179,53.1%,20m
14546,1,Tazer,3075,1601,85,66,151,56.3%,5m
14546,3,[iality]Hurakan,3075,1301,72,64,136,52.9%,3m
14546,3,BezMleka,3075,1404,69,78,147,46.9%,5m
14546,1,[TAW]Arno,3075,1079,56,46,102,54.9%,16m
14546,1,[shiot]Parcode,3075,1308,55,40,95,57.9%,4m
14546,1,Сопляк,3075,1066,54,54,108,50.0%,5m
14546,1,[ANGRYY]BONAC,3075,587,23,18,41,56.1%,4m
14546,1,[Kicx]Pisto,3075,456,18,20,38,47.4%,5m
14546,1,[KZstan]Noger,3075,440,13,15,28,46.4%,14m
14546,1,[UKRPA]TufiTheMan,3075,292,12,7,19,63.2%,18m
14546,1,[Hrr]Verniy,3075,384,11,17,28,39.3%,13m
14546,3,maybeEl,3075,192,6,18,24,25.0%,15m
14546,2,[LKR]BlueStorm,3075,118,5,4,9,55.6%,1h
14546,1,chichibuchka,3075,110,5,4,9,55.6%,16m
14546,1,[YHWH]AniYosy,3075,156,5,6,11,45.5%,2m
14546,3,YoUkNoWwHo,3075,153,4,8,12,33.3%,16m
14546,3,Ymiril,3075,122,3,5,8,37.5%,48m
14546,1,kepalaz,3075,116,3,9,12,25.0%,9m
14546,3,[ICDXXI]BadInFlüenCe,3075,90,3,13,16,18.8%,8m
14546,1,[DQI]Vaelve,3075,0,1,0,1,100.0%,13m
14546,1,[сSсǃ]Labsick,3075,0,1,0,1,100.0%,29m
14546,1,[KuBrAk]Eliminator,3075,88,1,1,2,50.0%,13m
14546,1,[DZTK]Seriouslyy,3075,0,1,1,2,50.0%,2m
14575,1,[N8Wrst]Lennox,3074,1710,169,154,323,52.3%,13m
14575,3,trainee,3074,1513,160,152,312,51.3%,30m
14575,1,raf,3074,893,90,77,167,53.9%,11m
14575,1,Sunspirit,3074,1649,87,78,165,52.7%,14m
14575,1,meDOWN,3074,1191,66,67,133,49.6%,19m
14575,1,FoeHammer,3074,1046,47,40,87,54.0%,12m
14575,1,Nekrom,3074,678,25,23,48,52.1%,10m
14575,1,Nicinavi,3074,558,18,20,38,47.4%,6m
14575,3,dgz,3074,367,15,13,28,53.6%,13m
14575,3,stableman,3074,344,12,22,34,35.3%,30m
14575,1,cbjcamus,3074,230,11,6,17,64.7%,19m
14575,1,Paxan,3074,278,9,8,17,52.9%,13m
14575,1,Terazul,3074,323,8,10,18,44.4%,31m
14575,1,Xbkiller,3074,166,7,6,13,53.8%,13m
14575,1,MrPink,3074,184,6,6,12,50.0%,6m
14575,1,MadCake,3074,102,5,3,8,62.5%,13m
14575,3,Joules,3074,30,5,5,10,50.0%,30m
14575,1,soso,3074,157,5,10,15,33.3%,14m
14575,1,elemi,3074,131,4,1,5,80.0%,29m
14575,3,shramek,3074,0,4,2,6,66.7%,21m
14575,1,prepare,3074,88,2,0,2,100.0%,8m
14575,1,[MOP1]MarinesOP,3074,89,1,1,2,50.0%,8m
14575,1,[Ǽ1]Superhero,3074,38,1,3,4,25.0%,17m
14575,1,Farman,3074,42,1,5,6,16.7%,29m
14575,2,Fear,3074,0,0,1,1,0.0%,1h
14600,3,Silicon,3073,1186,570,563,1133,50.3%,2m
14600,1,CarryMaster,3073,1700,204,172,376,54.3%,2m
14600,1,[ÏnOuY]BillyBoy,3073,1711,181,164,345,52.5%,20m
14600,1,Crow,3073,843,35,19,54,64.8%,20m
14600,1,Teo,3073,932,35,34,69,50.7%,12m
14600,1,Rolando,3073,711,32,18,50,64.0%,8m
14600,1,andrew,3073,909,31,28,59,52.5%,19m
14600,3,SpaceLord,3073,224,13,21,34,38.2%,31m
14600,1,waINe,3073,232,9,5,14,64.3%,5m
14600,1,[eXøde]faiza,3073,242,8,6,14,57.1%,8m
14600,3,[RZJBM]VisMaior,3073,60,6,6,12,50.0%,3m
14600,1,[MrPNIS]SirFapAlot,3073,88,5,1,6,83.3%,12m
14600,1,geminis,3073,118,5,3,8,62.5%,13m
14600,1,pipi,3073,78,3,4,7,42.9%,16m
14600,1,Brothers,3073,89,2,0,2,100.0%,17m
14600,1,[BeBop]SpiKeSpiegel,3073,78,2,4,6,33.3%,13m
14600,1,[k1raen]Sodnom,3073,80,2,4,6,33.3%,13m
14600,1,Murmel,3073,0,1,1,2,50.0%,18m
14600,3,Dash,3073,0,1,5,6,16.7%,12m
14600,1,ERPNWhYTeX,3073,36,1,5,6,16.7%,16m
14600,1,Gibv,3073,0,0,1,1,0.0%,20m
14600,1,IlIlIlIllIIl,3073,0,0,1,1,0.0%,16m
14622,1,KorwinCraft,3072,1267,147,141,288,51.0%,4m
14622,3,marjag,3072,1488,115,114,229,50.2%,30m
14622,3,[Arrows]Derek,3072,201,57,63,120,47.5%,9m
14622,1,Rash,3072,571,52,46,98,53.1%,4m
14622,3,BlackUnit,3072,827,45,48,93,48.4%,13m
14622,1,abbou,3072,817,39,22,61,63.9%,13m
14622,3,Bell,3072,473,19,18,37,51.4%,6m
14622,1,TheTrickster,3072,256,16,8,24,66.7%,8m
14622,1,RaptorII,3072,264,15,12,27,55.6%,31m
14622,1,Lepoilu,3072,242,8,5,13,61.5%,12m
14622,1,SwEetTooTh,3072,292,8,12,20,40.0%,16m
14622,1,[ISK]SnOoOoPyYy,3072,257,6,6,12,50.0%,15m
14622,3,GREGGI,3072,0,4,2,6,66.7%,1h
14622,1,[RNFR]Kjaald,3072,118,4,6,10,40.0%,5m
14622,1,SleppeR,3072,0,3,2,5,60.0%,1h
14622,1,MrBaneling,3072,154,3,3,6,50.0%,11m
14622,3,FritZman,3072,0,3,3,6,50.0%,6m
14622,1,Dedmoroxx,3072,42,2,2,4,50.0%,7m
14622,1,FloIsPablo,3072,34,2,3,5,40.0%,5m
14622,1,Tobisius,3072,42,2,3,5,40.0%,16m
14622,1,TkS,3072,42,2,6,8,25.0%,5m
14622,3,[nkRaz]Divisator,3072,0,1,7,8,12.5%,19m
14622,3,mik,3072,30,1,10,11,9.1%,2m
14622,1,Kazak,3072,0,0,1,1,0.0%,20m
14622,1,JustScout,3072,0,0,1,1,0.0%,17m
14647,3,Kirik,3071,1207,137,146,283,48.4%,16m
14647,3,Yasser,3071,1505,93,93,186,50.0%,18m
14647,1,AbleTo,3071,526,57,32,89,64.0%,6m
14647,1,StarInfestor,3071,973,42,31,73,57.5%,11m
14647,3,[Steamy]TinJuice,3071,817,31,42,73,42.5%,8m
14647,1,pain,3071,890,28,31,59,47.5%,8m
14647,1,Neawin,3071,603,22,23,45,48.9%,16m
14647,1,[InitRu]SameOldName,3071,242,16,13,29,55.2%,15m
14647,3,GrotesQue,3071,450,16,25,41,39.0%,13m
14647,1,[PL345]QuBuS,3071,313,13,8,21,61.9%,15m
14647,3,DoctorCarry,3071,320,13,9,22,59.1%,16m
14647,3,[VGZR]Knazpa,3071,288,12,9,21,57.1%,8m
14647,2,Drakorb,3071,119,5,4,9,55.6%,1h
14647,1,[Chauss]Erwade,3071,154,4,8,12,33.3%,16m
14647,1,Cenator,3071,109,3,1,4,75.0%,19m
14647,1,dasdsa,3071,0,3,2,5,60.0%,1h
14647,1,Aendern,3071,82,3,4,7,42.9%,9m
14647,3,Paysous,3071,96,2,1,3,66.7%,14m
14647,3,Alchemist,3071,97,2,2,4,50.0%,60m
14647,1,MeyRKoenig,3071,143,2,5,7,28.6%,54m
14647,3,PiKiTrOn,3071,123,2,6,8,25.0%,17m
14647,1,[ĦĦ]BaXcoX,3071,0,0,5,5,0.0%,11m
14669,1,Nelson,3070,1326,146,129,275,53.1%,19m
14669,3,madScientist,3070,449,116,116,232,50.0%,20m
14669,1,Tívar,3070,1213,80,84,164,48.8%,19m
14669,3,heizeR,3070,928,52,39,91,57.1%,5m
14669,1,Rookie,3070,572,43,31,74,58.1%,11m
14669,1,Melon,3070,1082,42,33,75,56.0%,10m
14669,1,[SSC2]Mrkiller,3070,991,38,47,85,44.7%,20m
14669,1,IIIIIIIIIIII,3070,815,35,24,59,59.3%,12m
14669,1,PlumpBear,3070,754,30,21,51,58.8%,9m
14669,1,Schrinja,3070,411,21,9,30,70.0%,29m
14669,3,MrDont,3070,340,21,27,48,43.8%,10m
14669,1,ZenPuzzle,3070,351,16,7,23,69.6%,13m
14669,1,Dasbooty,3070,228,10,6,16,62.5%,16m
14669,2,Kitchentable,3070,139,3,3,6,50.0%,17m
14669,2,Waffi,3070,90,3,4,7,42.9%,49m
14669,1,Jossi,3070,82,3,6,9,33.3%,3m
14669,3,[SNE]Wojtek,3070,88,3,10,13,23.1%,10m
14669,2,[CNC3]LurikFalurik,3070,118,2,1,3,66.7%,12m
14669,3,Toro,3070,40,1,2,3,33.3%,11m
14688,1,WipeR,3069,1606,100,74,174,57.5%,20m
14688,3,[3ky]Puffcio,3069,1322,70,63,133,52.6%,19m
14688,1,RickSanchez,3069,1134,58,37,95,61.1%,2m
14688,1,Darksense,3069,1155,43,37,80,53.8%,4m
14688,1,BoBo,3069,573,40,33,73,54.8%,11m
14688,3,[SSC2]Stratocaster,3069,898,36,42,78,46.2%,19m
14688,1,Nixonus,3069,374,15,13,28,53.6%,3m
14688,1,RevaN,3069,324,14,8,22,63.6%,20m
14688,3,nityk,3069,189,13,13,26,50.0%,4m
14688,1,kWarta,3069,406,11,15,26,42.3%,11m
14688,2,Ixido,3069,202,8,6,14,57.1%,1h
14688,1,Hiroshi,3069,143,7,3,10,70.0%,29m
14688,3,Wanz,3069,82,6,4,10,60.0%,3m
14688,1,dudeTWOFIFTp,3069,182,6,5,11,54.5%,16m
14688,1,IxuS,3069,152,4,1,5,80.0%,15m
14688,1,Bober,3069,0,4,1,5,80.0%,19m
14688,3,шпала,3069,0,4,2,6,66.7%,49m
14688,1,Borealis,3069,112,3,7,10,30.0%,4m
14688,1,DonDap,3069,89,2,0,2,100.0%,4m
14688,1,Vlad,3069,129,2,3,5,40.0%,18m
14688,1,Flubjig,3069,40,2,4,6,33.3%,8m
14688,1,[NAGI]SgtBilko,3069,0,1,0,1,100.0%,29m
14688,1,barcode,3069,0,1,0,1,100.0%,17m
14688,1,KucenahradCZ,3069,89,1,1,2,50.0%,13m
14688,1,Apollonn,3069,38,1,3,4,25.0%,8m
14688,1,OpenAI,3069,87,1,5,6,16.7%,12m
14714,1,Tempest,3068,1434,423,404,827,51.1%,14m
14714,1,HellBlade,3068,1531,197,175,372,53.0%,5m
14714,1,rdzdst,3068,1690,135,145,280,48.2%,12m
14714,3,[EWSS]TheEndNooB,3068,1012,77,65,142,54.2%,8m
14714,3,[PÂRłAH]lukySlovakia,3068,1475,69,71,140,49.3%,10m
14714,3,Myst,3068,1467,62,56,118,52.5%,12m
14714,1,Sternenfrost,3068,985,41,32,73,56.2%,5m
14714,3,ghoUst,3068,923,39,37,76,51.3%,31m
14714,1,BadBadNotGoo,3068,855,32,25,57,56.1%,20m
14714,3,Elephantos,3068,877,32,42,74,43.2%,8m
14714,1,danyDark,3068,734,29,23,52,55.8%,14m
14714,1,IIIIIIIIIIII,3068,466,19,13,32,59.4%,8m
14714,1,rostoshka,3068,507,15,22,37,40.5%,13m
14714,3,Padox,3068,241,11,10,21,52.4%,18m
14714,1,[Risker]DoFlamingo,3068,335,10,11,21,47.6%,12m
14714,3,[prOp]Alurian,3068,119,6,5,11,54.5%,2m
14714,1,LuckyBoy,3068,156,4,3,7,57.1%,17m
14714,3,MARU,3068,157,4,3,7,57.1%,12m
14714,1,[Trals]PsyMatic,3068,152,4,8,12,33.3%,13m
14714,1,[ЕМPIRE]Mikhail,3068,100,3,4,7,42.9%,20m
14714,1,[SuperF]princeyolo,3068,120,3,6,9,33.3%,29m
14714,1,Aboudjah,3068,0,1,0,1,100.0%,30m
14714,1,ascgert,3068,0,0,5,5,0.0%,4m
14737,1,Trickster,3067,1563,83,70,153,54.2%,15m
14737,3,LIGHT,3067,1032,59,49,108,54.6%,14m
14737,1,knak,3067,1388,48,50,98,49.0%,20m
14737,3,[ToXIK]LeMarquis,3067,1160,45,47,92,48.9%,2m
14737,1,SuDerk,3067,646,24,20,44,54.5%,8m
14737,1,[MCat]DrOrk,3067,463,19,2,21,90.5%,19m
14737,1,Raikon,3067,496,16,19,35,45.7%,15m
14737,1,leodig,3067,519,15,15,30,50.0%,13m
14737,2,Drölf,3067,288,10,3,13,76.9%,3m
14737,1,potap,3067,273,10,7,17,58.8%,47m
14737,1,Norecha,3067,284,9,11,20,45.0%,1h
14737,1,[ATArmy]zhupelL,3067,164,6,4,10,60.0%,20m
14737,1,TruthSeeker,3067,174,5,4,9,55.6%,16m
14737,1,KILLERCHAMP,3067,142,4,4,8,50.0%,1h
14737,1,GolDaniels,3067,160,4,7,11,36.4%,30m
14737,2,Dorfir,3067,134,2,2,4,50.0%,57m
14737,1,[NLTN]cAJloeg,3067,89,1,1,2,50.0%,18m
14737,1,mindtrance,3067,0,0,1,1,0.0%,8m
14737,1,Drachenfeuer,3067,0,0,2,2,0.0%,20m
14756,2,Kernat,3066,1602,202,185,387,52.2%,5m
14756,1,Mithrandir,3066,1645,122,116,238,51.3%,19m
14756,1,Frichkäse,3066,1656,108,97,205,52.7%,5m
14756,1,Craboid,3066,1611,98,74,172,57.0%,30m
14756,1,Dakuu,3066,1684,97,89,186,52.2%,2m
14756,1,SansTord,3066,1474,64,57,121,52.9%,12m
14756,3,[LVXE]Cloporte,3066,1277,59,68,127,46.5%,2m
14756,2,NazareT,3066,819,45,36,81,55.6%,18m
14756,1,MIXRISH,3066,837,36,21,57,63.2%,30m
14756,3,Fritz,3066,724,28,38,66,42.4%,15m
14756,2,neroxLz,3066,468,17,13,30,56.7%,15m
14756,1,twitchchatgm,3066,424,13,14,27,48.1%,8m
14756,1,mauroprovato,3066,204,6,8,14,42.9%,6m
14756,2,Dielindan,3066,142,5,6,11,45.5%,1h
14756,2,[FauG]Gebrüder,3066,116,3,0,3,100.0%,5m
14756,3,Whirlm,3066,95,3,5,8,37.5%,31m
14756,1,Duts,3066,86,3,7,10,30.0%,11m
14756,1,[GenGG]System,3066,91,2,1,3,66.7%,20m
14756,1,[IceFel]StarVader,3066,40,2,3,5,40.0%,29m
14756,1,TIESEL,3066,42,2,3,5,40.0%,19m
14756,2,Frex,3066,117,2,3,5,40.0%,1h
14756,2,skiracer,3066,0,1,0,1,100.0%,5m
14756,2,FriQze,3066,0,1,0,1,100.0%,14m
14756,2,pafcio,3066,0,0,1,1,0.0%,12m
14756,2,[XoG]Kalet,3066,0,0,1,1,0.0%,9m
14756,1,[darrrk]darckplaigis,3066,0,0,2,2,0.0%,12m
14756,1,OXI,3066,0,0,3,3,0.0%,9m
14783,2,THETABIONIC,3065,593,179,189,368,48.6%,2m
14783,3,Musashi,3065,1563,109,111,220,49.5%,15m
14783,3,MrWard,3065,1378,81,93,174,46.6%,6m
14783,1,TmG,3065,1210,79,68,147,53.7%,17m
14783,3,[eXit]Console,3065,1589,66,69,135,48.9%,15m
14783,3,[Rol3kg]SemVaus,3065,584,52,37,89,58.4%,18m
14783,2,Cherminator,3065,1191,52,37,89,58.4%,20m
14783,1,Пупырка,3065,1046,37,34,71,52.1%,19m
14783,1,Raoth,3065,352,17,12,29,58.6%,11m
14783,1,neverpuick,3065,275,12,4,16,75.0%,31m
14783,3,Kosh,3065,324,11,21,32,34.4%,29m
14783,1,[LОLI]DOSOCHKA,3065,220,9,4,13,69.2%,11m
14783,2,jurikson,3065,192,6,6,12,50.0%,9m
14783,1,eum,3065,185,5,6,11,45.5%,16m
14783,1,PholyH,3065,0,4,1,5,80.0%,45m
14783,1,[Rakii]SolidTurc,3065,152,4,6,10,40.0%,4m
14783,1,[PLA2N]GuilleVGX,3065,107,3,1,4,75.0%,8m
14783,1,Инспектор,3065,0,3,2,5,60.0%,16m
14783,2,XorisOnoma,3065,0,3,2,5,60.0%,5m
14783,1,[ArGGEJ]Tossadar,3065,36,2,3,5,40.0%,9m
14783,2,[SbmZ]gadleft,3065,66,2,3,5,40.0%,20m
14783,1,altushka,3065,78,2,5,7,28.6%,4m
14783,2,dchaser,3065,0,1,0,1,100.0%,5m
14783,1,[WNCRY]gentleman,3065,0,1,1,2,50.0%,8m
14783,1,Julia,3065,89,1,2,3,33.3%,20m
14783,3,desnartdani,3065,93,1,8,9,11.1%,16m
14783,2,Drullen,3065,0,0,1,1,0.0%,5m
14783,1,KruchuVerchu,3065,0,0,1,1,0.0%,12m
14783,1,[LV]Krāns,3065,0,0,2,2,0.0%,15m
14783,1,[EPIX]Kalime,3065,0,0,3,3,0.0%,13m
14783,1,Dolfik,3065,73,0,4,4,0.0%,12m
14783,2,makrofag,3065,0,0,5,5,0.0%,3m
14815,2,Varrag,3064,885,77,66,143,53.8%,10m
14815,1,Kuentrao,3064,495,70,73,143,49.0%,29m
14815,1,Cyber,3064,745,42,42,84,50.0%,12m
14815,3,JonMich,3064,1167,42,47,89,47.2%,17m
14815,2,NiksoN,3064,734,27,23,50,54.0%,21m
14815,1,DeluX,3064,616,18,18,36,50.0%,16m
14815,1,osvald,3064,442,17,13,30,56.7%,19m
14815,1,Slevin,3064,305,15,15,30,50.0%,20m
14815,1,IIIIIIIIIIII,3064,444,14,16,30,46.7%,6m
14815,1,Felix,3064,420,12,12,24,50.0%,4m
14815,1,rado,3064,280,9,8,17,52.9%,16m
14815,1,vVv,3064,259,7,6,13,53.8%,44m
14815,1,Wartortle,3064,122,6,7,13,46.2%,16m
14815,1,[Pitw]Megamaou,3064,230,6,11,17,35.3%,16m
14815,2,Eren,3064,129,5,3,8,62.5%,6m
14815,2,Dawn,3064,174,5,7,12,41.7%,5m
14815,1,DarkCzarny,3064,122,3,4,7,42.9%,17m
14815,2,Busty,3064,0,2,3,5,40.0%,5m
14815,2,brrrrrrr,3064,0,1,0,1,100.0%,20m
14815,2,Chemenem,3064,0,0,1,1,0.0%,20m
14835,1,[tw2NoB]Viktor,3063,1549,126,122,248,50.8%,13m
14835,3,[RAMP]Schreiner,3063,1502,92,97,189,48.7%,21m
14835,3,[GG228]belomor,3063,1504,54,59,113,47.8%,12m
14835,3,[mfixed]Tomek,3063,1173,51,53,104,49.0%,14m
14835,1,stepaXgg,3063,990,37,36,73,50.7%,29m
14835,3,powerjp,3063,682,31,35,66,47.0%,3m
14835,1,MrDiarrhea,3063,515,24,16,40,60.0%,8m
14835,1,Cobalt,3063,546,16,18,34,47.1%,11m
14835,1,isak,3063,420,15,13,28,53.6%,20m
14835,1,[FOOT]Rocksteady,3063,465,14,14,28,50.0%,5m
14835,2,Kejdz,3063,348,13,6,19,68.4%,11m
14835,1,[Lake]Lugasch,3063,231,10,6,16,62.5%,21m
14835,2,Shadowsong,3063,134,7,7,14,50.0%,3m
14835,1,inkopax,3063,224,7,9,16,43.8%,19m
14835,3,GOAT,3063,145,6,3,9,66.7%,1h
14835,1,Spetch,3063,97,4,2,6,66.7%,1h
14835,3,FistingAss,3063,141,4,2,6,66.7%,15m
14835,3,JOSELITO,3063,0,4,2,6,66.7%,12m
14835,1,[ЯD]EmTee,3063,110,3,2,5,60.0%,16m
14835,1,[KoSq]leomaximo,3063,124,3,4,7,42.9%,5m
14835,2,[Petrus]Ostan,3063,30,2,0,2,100.0%,5m
14835,2,[BWArmy]CheftainJ,3063,0,1,0,1,100.0%,5m
14835,1,[ggaruz]koyaan,3063,0,1,3,4,25.0%,5m
14835,2,MufasaPrime,3063,30,1,5,6,16.7%,15m
14835,2,Jin,3063,0,0,1,1,0.0%,9m
14860,3,Londan,3062,1601,349,346,695,50.2%,9m
14860,1,Tim,3062,1080,39,37,76,51.3%,11m
14860,1,livinghippo,3062,777,27,21,48,56.2%,12m
14860,2,Dismass,3062,585,25,12,37,67.6%,31m
14860,2,TheBoomer,3062,566,24,12,36,66.7%,18m
14860,2,ImDrunk,3062,546,20,17,37,54.1%,31m
14860,1,[TTur]GnrlMaximus,3062,544,15,22,37,40.5%,3m
14860,1,БоеваяБорода,3062,276,7,7,14,50.0%,29m
14860,3,herrar,3062,141,3,2,5,60.0%,16m
14860,2,NailSmile,3062,91,3,3,6,50.0%,4m
14860,1,PORLAT,3062,76,3,4,7,42.9%,8m
14860,1,VanBéton,3062,110,3,8,11,27.3%,29m
14860,1,[WOODYS]Shuuichi,3062,29,2,2,4,50.0%,19m
14860,3,Hyperborean,3062,0,1,0,1,100.0%,8m
14860,2,[PŖïMĄŁ]MalbertoM,3062,36,1,1,2,50.0%,20m
14860,2,vladimislav,3062,32,1,1,2,50.0%,14m
14860,2,FEERY,3062,32,1,1,2,50.0%,21m
14860,1,[DZTK]aiur,3062,88,1,2,3,33.3%,13m
14860,1,Baitholder,3062,34,1,7,8,12.5%,8m
14860,3,[FreeN]Shaka,3062,30,1,8,9,11.1%,7m
14860,2,toncha,3062,0,0,1,1,0.0%,14m
14881,3,Electric,3061,1205,140,138,278,50.4%,17m
14881,2,[FMQ]Helix,3061,1605,84,78,162,51.9%,4m
14881,1,Yetiman,3061,1392,80,55,135,59.3%,10m
14881,1,Akamaru,3061,1107,51,32,83,61.4%,30m
14881,1,[PŖïMĄŁ]수상자 작품,3061,1157,40,38,78,51.3%,19m
14881,1,KRom,3061,737,38,39,77,49.4%,31m
14881,3,Someone,3061,744,27,28,55,49.1%,4m
14881,1,itscooL,3061,541,22,17,39,56.4%,16m
14881,1,[R0]DragosIonut,3061,388,14,10,24,58.3%,10m
14881,1,LuCky,3061,444,12,18,30,40.0%,10m
14881,3,Daenerys,3061,372,12,20,32,37.5%,18m
14881,1,leid,3061,320,9,7,16,56.2%,20m
14881,3,Roma,3061,230,7,12,19,36.8%,6m
14881,2,suN,3061,178,6,4,10,60.0%,5m
14881,1,rømer,3061,0,4,2,6,66.7%,16m
14881,2,Dokler,3061,94,4,2,6,66.7%,12m
14881,1,sindikat,3061,116,3,5,8,37.5%,17m
14881,3,Cebulkowicz,3061,60,3,6,9,33.3%,6m
14881,2,[ZTT]Antoine,3061,30,2,0,2,100.0%,2m
14881,1,[TmDOG]oppozitPro,3061,76,2,4,6,33.3%,10m
14881,3,[FxL]Atty,3061,82,2,8,10,20.0%,51m
14881,2,HopeLing,3061,0,1,0,1,100.0%,7m
14881,3,[CNpR]Cyclone,3061,40,1,2,3,33.3%,1h
14881,2,Qusy,3061,0,0,1,1,0.0%,11m
14905,1,Pil,3060,1530,84,76,160,52.5%,14m
14905,1,[H2OKT]Hydroïde,3060,685,61,50,111,55.0%,6m
14905,3,FunyouT,3060,1206,45,52,97,46.4%,5m
14905,1,Kestal,3060,883,39,32,71,54.9%,14m
14905,1,[voff]FoxNews,3060,488,33,28,61,54.1%,10m
14905,1,Dich,3060,677,33,31,64,51.6%,20m
14905,3,HeiSeNBerg,3060,641,27,30,57,47.4%,5m
14905,3,simonsays,3060,688,24,31,55,43.6%,2m
14905,1,Tren,3060,494,20,16,36,55.6%,16m
14905,1,[BWArmy]Corentin,3060,423,17,12,29,58.6%,2m
14905,3,Sweezy,3060,401,17,15,32,53.1%,8m
14905,1,[BFG3K]Arek,3060,152,4,8,12,33.3%,19m
14905,2,Mugiwara,3060,90,3,2,5,60.0%,13m
14905,1,[WysH]crazymanT,3060,133,3,4,7,42.9%,12m
14905,1,Monkeysmash,3060,38,1,3,4,25.0%,4m
14905,1,Snapshot,3060,34,1,4,5,20.0%,4m
14905,2,[BRSKR]LaTeX,3060,0,0,1,1,0.0%,17m
14905,2,NOOBSTMPRNIN,3060,0,0,1,1,0.0%,20m
14923,1,Hans,3059,1734,126,123,249,50.6%,19m
14923,3,Larissan,3059,1358,110,107,217,50.7%,30m
14923,3,КрэйзиУтка,3059,702,89,86,175,50.9%,15m
14923,1,Xelior,3059,643,70,53,123,56.9%,31m
14923,1,Fenrir,3059,1375,57,56,113,50.4%,8m
14923,3,megAdept,3059,1025,49,47,96,51.0%,5m
14923,1,sweetZerg,3059,1253,47,44,91,51.6%,8m
14923,1,[FLANC]SilverStorm,3059,521,21,18,39,53.8%,20m
14923,2,Flora,3059,442,17,10,27,63.0%,18m
14923,1,clown,3059,524,15,20,35,42.9%,10m
14923,2,[Zufall]Aikons,3059,371,14,10,24,58.3%,5m
14923,2,TonyHoes,3059,232,9,5,14,64.3%,51m
14923,2,DarkMatter,3059,210,8,5,13,61.5%,13m
14923,1,Kabroc,3059,165,7,8,15,46.7%,19m
14923,2,PirateJack,3059,146,6,1,7,85.7%,5m
14923,2,jkjkj,3059,30,4,2,6,66.7%,4m
14923,1,KovidXii,3059,163,4,4,8,50.0%,19m
14923,2,Harmonic,3059,120,3,3,6,50.0%,12m
14923,1,ChaosBlood,3059,160,3,4,7,42.9%,30m
14923,1,ORiOn,3059,108,2,3,5,40.0%,16m
14923,2,[Kontra]Neutra,3059,0,1,0,1,100.0%,14m
14923,2,[ryx13]RYXTER,3059,0,0,1,1,0.0%,17m
14923,1,Aries,3059,0,0,2,2,0.0%,12m
14946,3,Wolfius,3058,1108,293,303,596,49.2%,5m
14946,3,lubiiik,3058,1498,270,252,522,51.7%,8m
14946,3,llllllllllll,3058,1582,173,167,340,50.9%,9m
14946,1,STarVation,3058,1721,95,92,187,50.8%,11m
14946,1,sincere,3058,1259,62,63,125,49.6%,17m
14946,1,Ron,3058,910,43,39,82,52.4%,30m
14946,2,[Smert]fankin,3058,823,40,14,54,74.1%,12m
14946,1,[ZigZag]AlexLy,3058,823,34,27,61,55.7%,5m
14946,1,Napoléon,3058,726,29,20,49,59.2%,14m
14946,3,[lloll]DadSkil,3058,731,25,30,55,45.5%,18m
14946,1,Niuffi,3058,633,20,19,39,51.3%,31m
14946,1,BlueTiger,3058,280,14,8,22,63.6%,8m
14946,1,Milky,3058,403,14,13,27,51.9%,5m
14946,1,HYDRAK,3058,357,12,10,22,54.5%,5m
14946,1,Sergeant,3058,190,12,11,23,52.2%,16m
14946,1,Wazaji,3058,324,10,10,20,50.0%,29m
14946,2,ChargeBruhhh,3058,210,7,5,12,58.3%,10m
14946,3,Toppy,3058,120,7,10,17,41.2%,2m
14946,1,Tyler,3058,96,5,4,9,55.6%,13m
14946,1,SaNgOkU,3058,178,5,12,17,29.4%,12m
14946,2,CaDDls,3058,94,4,1,5,80.0%,18m
14946,2,Stas,3058,118,4,3,7,57.1%,10m
14946,2,[TaTe]Tommy,3058,62,3,0,3,100.0%,6m
14946,1,Aløne,3058,0,3,2,5,60.0%,1h
14946,1,xlTommeylx,3058,126,2,3,5,40.0%,12m
14946,2,Krutoy,3058,32,1,2,3,33.3%,20m
14946,3,Epibaterios,3058,0,0,3,3,0.0%,1h
14973,3,SleKKiT,3057,737,50,48,98,51.0%,12m
14973,1,[MalD]Quentin,3057,1008,40,34,74,54.1%,12m
14973,1,Ivelin,3057,594,24,20,44,54.5%,14m
14973,2,Jileanu,3057,519,23,16,39,59.0%,9m
14973,2,Jinsei,3057,306,16,8,24,66.7%,16m
14973,1,Nift,3057,530,16,17,33,48.5%,8m
14973,1,[YlKES]Kotbert,3057,480,13,19,32,40.6%,20m
14973,1,Ric,3057,342,10,9,19,52.6%,20m
14973,1,Bandit,3057,208,8,4,12,66.7%,16m
14973,2,[CosCom]SnazeR,3057,216,8,4,12,66.7%,17m
14973,1,[beeeer]WarKeeper,3057,320,8,9,17,47.1%,13m
14973,2,TeaYellow,3057,58,2,3,5,40.0%,3m
14973,3,Anomick,3057,0,1,0,1,100.0%,13m
14973,2,Hamsterfisch,3057,0,1,0,1,100.0%,15m
14973,2,LukerOK,3057,0,0,1,1,0.0%,9m
14973,2,PaiMei,3057,0,0,1,1,0.0%,18m
14973,2,[MKTW]Dziki,3057,0,0,1,1,0.0%,12m
14973,2,SucukSoldier,3057,0,0,1,1,0.0%,13m
14991,3,Psy,3056,773,67,58,125,53.6%,2m
14991,1,[696]Beadler,3056,865,56,42,98,57.1%,29m
14991,3,Freeeeeze,3056,995,39,44,83,47.0%,8m
14991,1,MZaXiMuS,3056,674,25,23,48,52.1%,8m
14991,1,Vencundo,3056,471,18,13,31,58.1%,9m
14991,1,Elysian,3056,315,11,15,26,42.3%,10m
14991,1,[Poutre]Zboub,3056,349,9,10,19,47.4%,4m
14991,1,[TiH]DrunkenRhino,3056,130,4,2,6,66.7%,2m
14991,2,arMb,3056,147,4,4,8,50.0%,30m
14991,2,marain,3056,34,2,1,3,66.7%,3m
14991,2,IIIIIIIIIIII,3056,0,1,0,1,100.0%,4m
14991,2,Legioner,3056,0,1,0,1,100.0%,31m
14991,1,TFC,3056,88,1,2,3,33.3%,14m
14991,2,[voff]Wildcard,3056,0,0,1,1,0.0%,9m
15005,3,eldiablo,3055,1518,120,111,231,51.9%,4m
15005,1,Kiryl,3055,1582,110,101,211,52.1%,14m
15005,3,Mokasek,3055,682,98,89,187,52.4%,12m
15005,3,player,3055,1198,80,81,161,49.7%,30m
15005,3,Doughboy,3055,1164,75,73,148,50.7%,19m
15005,1,[SAKZ]lurigan,3055,1520,62,62,124,50.0%,8m
15005,1,EurekaGamer,3055,1032,55,38,93,59.1%,12m
15005,1,DuGong,3055,1064,37,41,78,47.4%,12m
15005,2,Boyki,3055,719,31,24,55,56.4%,15m
15005,2,[khoans]vjsr,3055,674,29,19,48,60.4%,2m
15005,1,Breem,3055,580,22,17,39,56.4%,19m
15005,3,helical,3055,434,19,16,35,54.3%,5m
15005,3,FouGere,3055,308,13,8,21,61.9%,9m
15005,1,[1s1]ToolTimr,3055,185,8,3,11,72.7%,14m
15005,1,Fuze,3055,225,8,4,12,66.7%,29m
15005,2,Angelos,3055,163,8,9,17,47.1%,12m
15005,1,Veredis,3055,197,7,5,12,58.3%,6m
15005,1,[bitoQ2]BlueMoon,3055,218,6,9,15,40.0%,13m
15005,2,feolega,3055,30,4,2,6,66.7%,5m
15005,2,Claude,3055,0,3,2,5,60.0%,14m
15005,3,SkaterBoy,3055,0,3,3,6,50.0%,50m
15005,2,[Uaks]Stenforcer,3055,30,2,4,6,33.3%,10m
15005,1,jro,3055,68,2,4,6,33.3%,21m
15005,1,HSS,3055,40,1,4,5,20.0%,12m
15005,2,[DWTeam]Andragon,3055,0,0,1,1,0.0%,19m
15005,2,CrazyZ,3055,0,0,1,1,0.0%,13m
15005,2,ниннзяяя,3055,0,0,1,1,0.0%,15m
15005,1,GbR,3055,0,0,2,2,0.0%,12m
15005,3,Tempest,3055,0,0,2,2,0.0%,7m
15034,3,[mfixed]jado,3054,1575,206,214,420,49.0%,7m
15034,1,BraiNur,3054,1451,119,91,210,56.7%,19m
15034,3,earthlinG,3054,1018,52,67,119,43.7%,4m
15034,1,Karamba,3054,869,39,28,67,58.2%,19m
15034,1,Niramedic,3054,482,38,34,72,52.8%,12m
15034,1,TossMaster,3054,754,36,19,55,65.5%,14m
15034,1,[Лень]BoPoH,3054,637,31,13,44,70.5%,10m
15034,1,Hede,3054,537,22,16,38,57.9%,20m
15034,3,[B1lLie]Eilish,3054,564,22,20,42,52.4%,17m
15034,1,mgjTerran,3054,416,18,13,31,58.1%,12m
15034,1,[BrglR]Nemutz,3054,279,12,13,25,48.0%,15m
15034,3,OVERLORDIK,3054,144,6,3,9,66.7%,7m
15034,1,[PHØMUI]Ayang,3054,104,4,5,9,44.4%,19m
15034,3,Itachi,3054,145,4,9,13,30.8%,10m
15034,1,[FAYAA]MrBroWny,3054,120,3,2,5,60.0%,16m
15034,1,[DRMR]RanKiller,3054,126,3,2,5,60.0%,29m
15034,1,GODRIC,3054,46,2,2,4,50.0%,57m
15034,2,[TerBHD]GES,3054,0,1,0,1,100.0%,21m
15034,2,DropDaBase,3054,30,1,1,2,50.0%,16m
15034,3,maingantée,3054,30,1,11,12,8.3%,6m
15034,2,Ranann,3054,0,0,1,1,0.0%,2m
15034,2,Barrathot,3054,0,0,1,1,0.0%,13m
15034,1,[4KROOT]Fanpoil,3054,0,0,3,3,0.0%,8m
15034,1,gautgoth,3054,0,0,3,3,0.0%,10m
15034,3,ToObar,3054,0,0,4,4,0.0%,15m
15034,1,Lex,3054,0,0,6,6,0.0%,10m
15060,3,Latinalover,3053,1448,147,124,271,54.2%,11m
15060,1,Axces,3053,1502,97,81,178,54.5%,4m
15060,1,Krastanis,3053,958,50,39,89,56.2%,20m
15060,1,PlasticLove,3053,798,30,26,56,53.6%,19m
15060,1,krakanhakan,3053,638,21,22,43,48.8%,16m
15060,1,Seimenon,3053,364,17,9,26,65.4%,15m
15060,1,Nihilus,3053,206,10,13,23,43.5%,21m
15060,1,SoVaLoL,3053,337,10,14,24,41.7%,19m
15060,2,SoeR,3053,48,6,4,10,60.0%,47m
15060,3,Jowkasta,3053,145,5,0,5,100.0%,45m
15060,2,[B1C]Artwenki,3053,98,4,1,5,80.0%,12m
15060,1,Manuel,3053,150,4,4,8,50.0%,12m
15060,1,Linden,3053,0,3,3,6,50.0%,29m
15060,2,fulleur,3053,0,2,3,5,40.0%,11m
15060,2,Shatterer,3053,88,1,1,2,50.0%,14m
15060,1,[TeamRo]GENERALUL,3053,90,1,2,3,33.3%,6m
15060,1,[SAES]chandie,3053,40,1,4,5,20.0%,16m
15060,3,Sunn,3053,0,1,10,11,9.1%,4m
15060,2,gugugugugu,3053,0,0,1,1,0.0%,31m
15060,3,Zorg,3053,0,0,1,1,0.0%,1h
15080,3,[KoyBee]Crimson,3052,1461,183,167,350,52.3%,30m
15080,1,triplecroute,3052,1699,154,142,296,52.0%,10m
15080,3,KLITOR,3052,1292,99,104,203,48.8%,3m
15080,1,Игорь,3052,1597,85,71,156,54.5%,20m
15080,1,Overlord,3052,1711,85,84,169,50.3%,8m
15080,1,DIMI,3052,1217,62,44,106,58.5%,4m
15080,1,PostrelyoNOK,3052,1399,60,55,115,52.2%,16m
15080,3,[axis]PapaRaid,3052,842,60,64,124,48.4%,4m
15080,1,[MousM]iDuc,3052,1478,55,51,106,51.9%,13m
15080,3,[PBears]SWEAMADOR,3052,782,26,36,62,41.9%,15m
15080,1,Haakon,3052,564,17,19,36,47.2%,6m
15080,1,SaltyWaters,3052,391,15,15,30,50.0%,14m
15080,2,tesya,3052,310,12,4,16,75.0%,31m
15080,1,Granitt,3052,307,11,8,19,57.9%,20m
15080,1,Thirteenth,3052,218,10,4,14,71.4%,10m
15080,1,MrBubble,3052,319,10,7,17,58.8%,19m
15080,1,kotofey,3052,260,8,10,18,44.4%,5m
15080,2,BEn,3052,142,7,3,10,70.0%,1h
15080,1,SASCAZI,3052,157,7,7,14,50.0%,2m
15080,3,SameOldName,3052,40,5,3,8,62.5%,59m
15080,1,[EHBA]Todesheiler,3052,144,5,5,10,50.0%,4m
15080,1,TheDestroyer,3052,139,5,5,10,50.0%,29m
15080,2,Pehta,3052,30,4,2,6,66.7%,31m
15080,3,Raft,3052,145,4,5,9,44.4%,56m
15080,3,SwarmPrince,3052,0,3,2,5,60.0%,19m
15080,2,Erling,3052,36,2,1,3,66.7%,20m
15080,1,[HZeS]gollor,3052,38,2,2,4,50.0%,12m
15080,1,Foxy,3052,80,2,6,8,25.0%,10m
15080,2,Yeldoow,3052,0,1,0,1,100.0%,5m
15080,1,DrunkBender,3052,36,1,3,4,25.0%,14m
15080,1,Jefestion,3052,38,1,3,4,25.0%,13m
15080,2,JackyLembush,3052,0,0,1,1,0.0%,14m
15112,3,Andrei,3051,1515,200,203,403,49.6%,8m
15112,3,SoloTurk,3051,1467,132,132,264,50.0%,15m
15112,1,Hazzazin,3051,1149,95,92,187,50.8%,14m
15112,1,Potaufeu,3051,1353,67,65,132,50.8%,14m
15112,1,Ignis,3051,680,21,22,43,48.8%,7m
15112,1,[Pangur]GuiGui,3051,625,20,19,39,51.3%,11m
15112,2,[LAMPA]Surovov,3051,456,18,9,27,66.7%,8m
15112,1,Nanucheka,3051,436,18,12,30,60.0%,17m
15112,3,[ZERG7V]Nuclear,3051,532,18,28,46,39.1%,9m
15112,2,WesCoriginal,3051,267,11,4,15,73.3%,47m
15112,2,Bigmek,3051,234,8,6,14,57.1%,18m
15112,2,Zakis,3051,244,8,11,19,42.1%,17m
15112,1,HaMMeR,3051,203,7,11,18,38.9%,14m
15112,1,SenGal,3051,140,6,4,10,60.0%,14m
15112,3,VectorBundle,3051,186,6,6,12,50.0%,1h
15112,1,AlexTop,3051,97,4,2,6,66.7%,58m
15112,2,IlIllIllIllI,3051,30,4,2,6,66.7%,3m
15112,2,Licus,3051,0,4,3,7,57.1%,1h
15112,3,icymonkeey,3051,126,4,12,16,25.0%,2m
15112,1,[3Dcla]Alexlocky,3051,0,2,3,5,40.0%,1h
15112,2,[NiN]mark,3051,0,1,0,1,100.0%,10m
15112,1,drsps,3051,0,1,2,3,33.3%,10m
15112,2,[SSgF]Wildjäger,3051,0,0,1,1,0.0%,17m
15135,2,DusTy,3050,1635,179,162,341,52.5%,6m
15135,1,Necros,3050,1055,91,70,161,56.5%,14m
15135,1,YouROCK,3050,1616,74,60,134,55.2%,8m
15135,2,JeanMichel,3050,868,36,22,58,62.1%,31m
15135,1,[NHO]MajorOne,3050,599,21,17,38,55.3%,19m
15135,1,Kuzco,3050,311,17,5,22,77.3%,14m
15135,2,Brownsugar,3050,363,14,11,25,56.0%,13m
15135,2,TcL,3050,215,8,5,13,61.5%,1h
15135,3,Sun,3050,222,7,6,13,53.8%,6m
15135,1,TummeUpp,3050,48,5,2,7,71.4%,59m
15135,2,[Dobro]docha,3050,94,4,0,4,100.0%,6m
15135,2,AdarmA,3050,32,2,0,2,100.0%,8m
15135,2,Luyi,3050,0,1,0,1,100.0%,13m
15135,1,unazko,3050,0,1,2,3,33.3%,5m
15135,1,Persona,3050,32,1,4,5,20.0%,7m
15135,2,KopTeZ,3050,0,0,1,1,0.0%,5m
15135,1,Lightman,3050,0,0,1,1,0.0%,54m
15135,1,[Tuki]Lance,3050,0,0,4,4,0.0%,13m
15153,3,High,3049,1001,211,206,417,50.6%,13m
15153,1,Telra,3049,1563,70,49,119,58.8%,15m
15153,3,Maniac,3049,372,45,42,87,51.7%,16m
15153,1,[CUM444]POPA,3049,681,39,26,65,60.0%,5m
15153,1,Lover,3049,788,27,25,52,51.9%,19m
15153,1,djob,3049,693,27,25,52,51.9%,10m
15153,2,DaelkaR,3049,608,25,18,43,58.1%,4m
15153,1,Daimos,3049,618,24,20,44,54.5%,9m
15153,2,[Silvеr]Hack,3049,452,18,11,29,62.1%,16m
15153,1,[InGa]StarLord,3049,400,13,14,27,48.1%,31m
15153,1,supervillain,3049,280,10,6,16,62.5%,29m
15153,3,[SAG]ThoSoa,3049,163,8,5,13,61.5%,15m
15153,1,MoonCake,3049,269,6,8,14,42.9%,45m
15153,2,crock,3049,182,4,5,9,44.4%,1h
15153,1,Onires,3049,38,2,3,5,40.0%,15m
15153,1,[33cl]NeSs,3049,0,2,4,6,33.3%,20m
15153,2,[shnutz]Avhendabi,3049,0,1,0,1,100.0%,20m
15153,2,Vaxx,3049,0,1,0,1,100.0%,8m
15153,2,MrHubbaBubba,3049,0,1,0,1,100.0%,16m
15153,2,[SR597]Wik,3049,30,1,1,2,50.0%,9m
15153,1,VoxTemporis,3049,90,1,2,3,33.3%,8m
15153,1,[Blacer]iiQuaruii,3049,0,1,2,3,33.3%,17m
15153,2,tomawake,3049,0,0,1,1,0.0%,8m
15153,3,Maestro,3049,0,0,1,1,0.0%,19m
15153,2,IaMa,3049,0,0,1,1,0.0%,11m
15153,2,capiclecrane,3049,0,0,1,1,0.0%,9m
15153,2,stereotippe,3049,0,0,1,1,0.0%,18m
15153,1,oldzas,3049,0,0,2,2,0.0%,4m
15153,1,omg,3049,0,0,2,2,0.0%,8m
15182,2,DemiGawd,3048,1482,190,207,397,47.9%,4m
15182,1,madDynamix,3048,1698,108,115,223,48.4%,11m
15182,3,idd,3048,1391,83,84,167,49.7%,18m
15182,1,Goodfather,3048,1709,75,76,151,49.7%,12m
15182,1,Genghis,3048,504,72,51,123,58.5%,17m
15182,2,Kingpin,3048,386,16,6,22,72.7%,12m
15182,1,Smile,3048,378,13,10,23,56.5%,13m
15182,2,NumberTh,3048,94,10,7,17,58.8%,5m
15182,2,Hara,3048,232,8,6,14,57.1%,10m
15182,1,Waylander,3048,181,7,2,9,77.8%,14m
15182,3,дюшес,3048,42,6,2,8,75.0%,21m
15182,1,Neon,3048,154,4,7,11,36.4%,12m
15182,1,[hxx]Strikover,3048,40,2,3,5,40.0%,5m
15182,1,BlackBlyat,3048,34,1,3,4,25.0%,20m
15182,2,[GGAI]macpli,3048,0,0,1,1,0.0%,19m
15182,2,Endurance,3048,0,0,1,1,0.0%,10m
15198,3,ninefourfour,3047,1459,335,318,653,51.3%,30m
15198,2,[VetM]Mahel,3047,1606,214,185,399,53.6%,9m
15198,1,SpeedyRogue,3047,1338,74,67,141,52.5%,8m
15198,1,Enderborn,3047,1116,73,53,126,57.9%,9m
15198,1,Skynet,3047,1193,49,41,90,54.4%,19m
15198,3,faza,3047,1121,44,40,84,52.4%,16m
15198,3,HerculesTheo,3047,951,35,45,80,43.8%,14m
15198,3,Artekus,3047,970,33,47,80,41.2%,13m
15198,1,Email,3047,717,27,28,55,49.1%,8m
15198,3,[PICHES]SuSu,3047,793,26,33,59,44.1%,4m
15198,3,Dikoobrazz,3047,384,24,31,55,43.6%,16m
15198,3,Karabiner,3047,542,19,27,46,41.3%,10m
15198,1,ponal,3047,532,17,15,32,53.1%,19m
15198,1,Alexey,3047,303,13,8,21,61.9%,13m
15198,1,Halet,3047,419,13,19,32,40.6%,10m
15198,1,BoBjoKR,3047,177,8,6,14,57.1%,19m
15198,3,abstract,3047,168,6,1,7,85.7%,22m
15198,1,GuNii,3047,169,6,2,8,75.0%,30m
15198,2,DAD,3047,120,4,6,10,40.0%,4m
15198,1,[Pietre]Euisroman,3047,38,2,2,4,50.0%,14m
15198,2,Democracy,3047,0,1,0,1,100.0%,15m
15198,1,Chamallow,3047,0,1,2,3,33.3%,30m
15198,1,ßaha,3047,0,1,3,4,25.0%,21m
15198,2,Tyranek,3047,0,0,2,2,0.0%,60m
15198,1,[Arkhan]Addaioth,3047,0,0,4,4,0.0%,29m
15198,2,vtec,3047,0,0,5,5,0.0%,18m
15224,1,Chebyrush,3046,1355,145,115,260,55.8%,19m
15224,1,ClaasHinrich,3046,1691,140,129,269,52.0%,21m
15224,3,Kamui,3046,1274,60,53,113,53.1%,12m
15224,3,Lati,3046,551,53,56,109,48.6%,30m
15224,3,[SSC2]Zim,3046,797,32,40,72,44.4%,20m
15224,1,[cx]ceptoplex,3046,644,29,21,50,58.0%,12m
15224,3,Djenster,3046,645,29,24,53,54.7%,12m
15224,1,Kryp,3046,799,28,23,51,54.9%,30m
15224,1,Nal,3046,824,27,27,54,50.0%,17m
15224,1,RinGO,3046,540,19,13,32,59.4%,10m
15224,1,klaymen,3046,453,14,13,27,51.9%,8m
15224,3,maque,3046,350,13,17,30,43.3%,4m
15224,1,WayTeh,3046,198,8,10,18,44.4%,9m
15224,1,Romeo,3046,266,7,12,19,36.8%,13m
15224,1,watermaster,3046,232,6,10,16,37.5%,14m
15224,2,link,3046,114,5,0,5,100.0%,13m
15224,1,FruitEater,3046,150,5,11,16,31.2%,5m
15224,1,Dragonborn,3046,97,4,2,6,66.7%,1h
15224,2,[H0C]softmax,3046,86,3,9,12,25.0%,20m
15224,2,Goku,3046,32,2,0,2,100.0%,20m
15224,2,psg,3046,0,1,0,1,100.0%,17m
15224,1,yosbka,3046,0,1,3,4,25.0%,18m
15224,3,Danny,3046,0,0,1,1,0.0%,2m
15224,2,Buljan,3046,0,0,1,1,0.0%,3m
15224,2,Teamkiller,3046,0,0,1,1,0.0%,53m
15224,1,[RUS]Annabelle,3046,0,0,2,2,0.0%,14m
15224,1,[Dobro]AdmiraLRaid,3046,0,0,2,2,0.0%,19m
15251,3,ALeX,3045,1424,122,128,250,48.8%,9m
15251,1,GWAM,3045,1632,114,97,211,54.0%,14m
15251,3,Dan,3045,1526,111,108,219,50.7%,12m
15251,1,[Витязи]Hopeless,3045,1386,58,54,112,51.8%,19m
15251,1,PlayerTwo,3045,956,44,44,88,50.0%,20m
15251,3,IIIIIIIIIIII,3045,595,23,34,57,40.4%,11m
15251,1,[N1CANI]OverRlde,3045,473,18,12,30,60.0%,21m
15251,1,fornoreason,3045,431,17,14,31,54.8%,30m
15251,3,[TZCrew]Proodz,3045,455,17,21,38,44.7%,10m
15251,1,ReallyKumpel,3045,382,13,9,22,59.1%,11m
15251,3,[Cutten]Nexsis,3045,285,11,11,22,50.0%,11m
15251,1,BigWars,3045,334,10,8,18,55.6%,11m
15251,2,[Oath]Sky,3045,266,10,9,19,52.6%,15m
15251,2,[453]EwigerNoob,3045,264,9,8,17,52.9%,31m
15251,1,PapaDave,3045,224,7,8,15,46.7%,10m
15251,3,Destix,3045,146,6,4,10,60.0%,60m
15251,2,Сибирь,3045,118,5,2,7,71.4%,7m
15251,1,loserplayer,3045,97,4,2,6,66.7%,59m
15251,2,Tubbzie,3045,30,4,3,7,57.1%,9m
15251,1,wehyster,3045,137,3,0,3,100.0%,1h
15251,1,Timmy,3045,78,2,8,10,20.0%,9m
15251,2,Nothing,3045,0,1,0,1,100.0%,3m
15251,2,IIIIIIIIIIII,3045,0,0,1,1,0.0%,8m
15251,2,Thunder,3045,0,0,1,1,0.0%,20m
15251,2,KrAuti,3045,0,0,5,5,0.0%,13m
15276,1,RandomOne,3044,1020,105,108,213,49.3%,8m
15276,3,[696]salva,3044,766,55,58,113,48.7%,4m
15276,1,Darkken,3044,824,43,12,55,78.2%,21m
15276,1,Necho,3044,652,26,25,51,51.0%,12m
15276,2,[crabz]WhiteNights,3044,676,24,22,46,52.2%,15m
15276,2,[Shr3Kd]MeNeSbatto,3044,556,20,17,37,54.1%,16m
15276,1,[SLD]iGude,3044,262,18,18,36,50.0%,7m
15276,1,Ultramarine,3044,357,13,7,20,65.0%,8m
15276,2,Beast,3044,123,5,4,9,55.6%,10m
15276,1,Selephodron,3044,170,5,8,13,38.5%,7m
15276,1,Logan,3044,123,4,6,10,40.0%,2m
15276,1,Lambert,3044,0,3,2,5,60.0%,49m
15276,2,Hawk,3044,0,3,2,5,60.0%,13m
15276,2,MrPink,3044,60,2,3,5,40.0%,4m
15276,2,Cronus,3044,0,1,0,1,100.0%,7m
15276,2,Someone,3044,0,1,0,1,100.0%,31m
15276,1,[NoSepi]TheMarcklar,3044,0,1,1,2,50.0%,6m
15276,1,Christus,3044,0,1,1,2,50.0%,46m
15276,2,Жкь,3044,30,1,1,2,50.0%,10m
15276,1,[BotN]FunkyBear,3044,28,1,4,5,20.0%,19m
15276,2,[GIS9]Ichigo,3044,0,0,1,1,0.0%,8m
15276,2,Moogiwar,3044,0,0,1,1,0.0%,9m
15298,3,Soap,3043,1577,370,370,740,50.0%,13m
15298,2,shaman,3043,1091,87,30,117,74.4%,13m
15298,1,Micutu,3043,1709,80,75,155,51.6%,21m
15298,3,Corman,3043,1530,78,85,163,47.9%,30m
15298,1,Prizmo,3043,1146,44,36,80,55.0%,12m
15298,1,LieSheng,3043,1063,42,34,76,55.3%,14m
15298,3,Bazinga,3043,836,28,41,69,40.6%,10m
15298,1,Gianzex,3043,428,13,11,24,54.2%,12m
15298,1,Andrew,3043,356,12,9,21,57.1%,4m
15298,3,Teie,3043,335,10,17,27,37.0%,18m
15298,2,Gohei,3043,171,5,4,9,55.6%,9m
15298,2,LeeShenShun,3043,30,4,2,6,66.7%,12m
15298,1,[CUBITA]pap,3043,0,2,3,5,40.0%,13m
15298,1,[Bwolfs]NickYU,3043,74,2,4,6,33.3%,31m
15298,1,VincentVega,3043,0,2,5,7,28.6%,19m
15298,1,[Stunt]Theios,3043,0,1,1,2,50.0%,19m
15298,3,Fuwy,3043,0,1,8,9,11.1%,19m
15298,2,[CØG]lucgamer,3043,0,0,1,1,0.0%,3m
15298,2,[dd33nt]daJonas,3043,0,0,1,1,0.0%,9m
15298,2,SkillReX,3043,0,0,1,1,0.0%,15m
15298,2,Asturianu,3043,0,0,1,1,0.0%,10m
15298,2,jejes,3043,0,0,2,2,0.0%,3m
15298,2,SarXon,3043,0,0,5,5,0.0%,3m
15321,3,BitchBotBoii,3042,1577,204,204,408,50.0%,17m
15321,3,Takamura,3042,1028,77,89,166,46.4%,17m
15321,1,[1C5]MaxPayne,3042,854,57,48,105,54.3%,6m
15321,1,Dam,3042,781,49,35,84,58.3%,14m
15321,3,MatsumoBot,3042,1194,46,47,93,49.5%,14m
15321,1,[3raza]Cazagames,3042,935,38,31,69,55.1%,16m
15321,1,milo,3042,623,27,15,42,64.3%,5m
15321,3,ForZHumanity,3042,366,15,9,24,62.5%,17m
15321,1,Jack,3042,347,11,10,21,52.4%,11m
15321,2,[2H]Aleksandr,3042,193,10,5,15,66.7%,9m
15321,1,minimatthews,3042,241,10,8,18,55.6%,7m
15321,2,SirTom,3042,235,9,6,15,60.0%,17m
15321,1,Ghost,3042,161,8,4,12,66.7%,14m
15321,2,[AkS]BeLSunce,3042,156,6,4,10,60.0%,9m
15321,2,[Frbelg]Thibalt,3042,128,4,1,5,80.0%,31m
15321,1,[VLBG]Arvalus,3042,97,3,1,4,75.0%,59m
15321,2,LegioNomen,3042,90,3,2,5,60.0%,6m
15321,1,[NKQ]Sergiulik,3042,136,3,3,6,50.0%,20m
15321,2,[PEEPE]MarcoD,3042,119,3,4,7,42.9%,53m
15321,2,Arctus,3042,64,2,4,6,33.3%,18m
15321,1,QtoWE,3042,0,2,4,6,33.3%,14m
15321,2,HydroGenic,3042,0,1,0,1,100.0%,7m
15321,2,shade,3042,32,1,1,2,50.0%,31m
15321,3,Julio,3042,0,1,2,3,33.3%,1h
15321,1,Lercan,3042,36,1,5,6,16.7%,10m
15321,1,[SK1LL]Darvu,3042,40,1,5,6,16.7%,20m
15321,2,LazyTitan,3042,0,0,1,1,0.0%,14m
15321,2,proplayer,3042,0,0,1,1,0.0%,15m
15349,3,Arcoon,3041,613,89,92,181,49.2%,21m
15349,2,Brutaline,3041,634,28,21,49,57.1%,15m
15349,3,BKedax,3041,464,19,27,46,41.3%,3m
15349,1,[EVA001]NIKOKUN,3041,224,15,9,24,62.5%,8m
15349,1,[nL0]DeiGfriss,3041,271,13,9,22,59.1%,21m
15349,1,SCommander,3041,263,11,10,21,52.4%,13m
15349,1,Reign,3041,232,7,30,37,18.9%,21m
15349,3,Skyrobotte,3041,121,6,3,9,66.7%,53m
15349,2,Sodar,3041,146,5,5,10,50.0%,3m
15349,1,Didi,3041,148,5,7,12,41.7%,19m
15349,1,Terranasuar,3041,97,4,2,6,66.7%,54m
15349,1,Piotr,3041,141,4,2,6,66.7%,14m
15349,2,SlaYeR,3041,130,3,1,4,75.0%,12m
15349,1,Ramuk,3041,110,3,8,11,27.3%,11m
15349,2,[Kicx]Jeko,3041,62,2,3,5,40.0%,5m
15349,2,[lOoOl]KatyaAngel,3041,62,2,3,5,40.0%,4m
15349,2,Mexanick,3041,0,1,0,1,100.0%,12m
15349,1,Elfid,3041,38,1,4,5,20.0%,19m
15349,1,LanOwar,3041,36,1,4,5,20.0%,20m
15349,1,Mureke,3041,0,1,5,6,16.7%,21m
15349,2,[FKHMUP]Uptheshah,3041,0,0,1,1,0.0%,31m
15370,1,GIR,3040,805,30,26,56,53.6%,4m
15370,2,MRgoatman,3040,80,6,5,11,54.5%,47m
15370,2,StalinOnYou,3040,126,4,2,6,66.7%,4m
15370,2,[Floren]Cakisco,3040,120,4,4,8,50.0%,10m
15370,2,Ensiiferum,3040,93,2,1,3,66.7%,20m
15370,1,Callahan,3040,145,2,1,3,66.7%,1h
15370,1,[WField]ZającKażanka,3040,119,2,3,5,40.0%,16m
15370,2,[DN3N]Ardn,3040,30,1,1,2,50.0%,6m
15370,2,[IcMoon]llllllllllll,3040,32,1,3,4,25.0%,9m
15370,2,SkyHerder,3040,0,0,1,1,0.0%,14m
15370,2,Gagloi,3040,0,0,1,1,0.0%,14m
15370,2,LeONyaK,3040,0,0,1,1,0.0%,5m
15370,2,Reborn,3040,0,0,2,2,0.0%,18m
15370,2,[UBQ]Dirichlet,3040,0,0,5,5,0.0%,3m
15370,2,Thracian,3040,0,0,5,5,0.0%,7m
15385,3,Bismarck,3039,1530,226,222,448,50.4%,16m
15385,2,[PLST]Animalex,3039,1340,108,86,194,55.7%,9m
15385,3,[PIML]ChuckPoriss,3039,1407,105,104,209,50.2%,18m
15385,3,Tasior,3039,1334,82,102,184,44.6%,8m
15385,1,[SAPIN]TrD,3039,665,28,23,51,54.9%,19m
15385,1,[FSID]Bouriquet,3039,635,19,20,39,48.7%,5m
15385,3,[Kjerne]Steps,3039,411,16,8,24,66.7%,9m
15385,2,VetoKing,3039,204,6,1,7,85.7%,4m
15385,2,[H7]Pygma,3039,30,5,1,6,83.3%,14m
15385,1,FujisawaSC,3039,97,4,2,6,66.7%,14m
15385,1,Darkthor,3039,154,4,5,9,44.4%,11m
15385,2,[neuroW]DroneScout,3039,62,3,2,5,60.0%,4m
15385,1,Sam,3039,104,3,2,5,60.0%,12m
15385,1,[GG2020]MIKSER,3039,122,3,10,13,23.1%,8m
15385,3,jAy,3039,30,2,0,2,100.0%,7m
15385,2,IIIIIIIIIIII,3039,0,2,3,5,40.0%,5m
15385,2,Daisyk,3039,0,1,0,1,100.0%,16m
15385,1,thedickdans,3039,0,1,0,1,100.0%,13m
15385,2,[PTLc]smarty,3039,0,1,1,2,50.0%,5m
15385,1,[IBMS]Mangomera,3039,95,1,3,4,25.0%,20m
15385,2,inxs,3039,0,0,2,2,0.0%,7m
15406,3,mausl,3038,1571,165,164,329,50.2%,5m
15406,1,Kreket,3038,1364,66,49,115,57.4%,12m
15406,1,DamDam,3038,1533,63,47,110,57.3%,13m
15406,1,[zukaCo]Roakin,3038,547,37,30,67,55.2%,13m
15406,1,llllllllllll,3038,931,34,34,68,50.0%,19m
15406,2,yukecen,3038,722,31,17,48,64.6%,18m
15406,3,Loops,3038,209,26,34,60,43.3%,4m
15406,2,Kenny,3038,611,23,20,43,53.5%,10m
15406,1,[KerriS]Sireals,3038,683,22,22,44,50.0%,19m
15406,1,[Funky]ErisHope,3038,518,16,15,31,51.6%,2m
15406,1,GRIMM,3038,372,15,10,25,60.0%,30m
15406,2,HEETS,3038,122,5,5,10,50.0%,12m
15406,1,RamStein,3038,148,5,11,16,31.2%,15m
15406,2,Imperialist,3038,116,4,2,6,66.7%,17m
15406,2,[HZeS]Dream,3038,120,4,3,7,57.1%,15m
15406,2,[MWAF]SmokedTurtle,3038,0,1,1,2,50.0%,6m
15406,1,[YuWiPi]Arkanta,3038,40,1,4,5,20.0%,8m
15406,3,Laconnex,3038,0,0,1,1,0.0%,1h
15406,2,piertzale,3038,0,0,1,1,0.0%,12m
15406,3,llllllllllll,3038,0,0,1,1,0.0%,1h
15426,3,Dayan,3037,1570,153,150,303,50.5%,18m
15426,3,Vershok,3037,1205,112,111,223,50.2%,14m
15426,1,geschäft,3037,1022,93,82,175,53.1%,7m
15426,1,[C0cks]CaptainBanan,3037,1613,86,76,162,53.1%,30m
15426,3,[MSUSC2]Kirber,3037,656,85,80,165,51.5%,19m
15426,1,[SGMND]urbanstoke,3037,1687,82,79,161,50.9%,11m
15426,3,[lTpMl]KeeN,3037,510,73,69,142,51.4%,9m
15426,3,[АDV]NesCafe,3037,1558,59,74,133,44.4%,9m
15426,3,Darko,3037,1452,54,66,120,45.0%,14m
15426,1,[KRW]tviaptarlkks,3037,1273,50,43,93,53.8%,13m
15426,1,Deezy,3037,982,41,34,75,54.7%,4m
15426,3,[Peeps]Zeus,3037,963,36,37,73,49.3%,13m
15426,2,TassOneOfUs,3037,564,20,16,36,55.6%,12m
15426,2,[PROSTY]Темыч,3037,373,18,6,24,75.0%,13m
15426,1,HankScorpio,3037,309,16,9,25,64.0%,11m
15426,1,PunchLine,3037,169,15,8,23,65.2%,29m
15426,3,Ombra,3037,112,13,11,24,54.2%,18m
15426,2,bobo,3037,251,8,2,10,80.0%,6m
15426,2,toni,3037,218,8,7,15,53.3%,17m
15426,3,[FWLSP]Zronk,3037,30,6,3,9,66.7%,11m
15426,3,Misery,3037,97,5,2,7,71.4%,50m
15426,2,BerryBk,3037,58,5,3,8,62.5%,12m
15426,1,Jules,3037,102,5,3,8,62.5%,2m
15426,1,theconker,3037,0,2,4,6,33.3%,11m
15426,2,FrozenShadoW,3037,32,1,2,3,33.3%,4m
15426,2,[HITAGI]Senjougahara,3037,0,0,1,1,0.0%,10m
15426,2,xShaderW,3037,0,0,1,1,0.0%,15m
15426,2,KuDoS,3037,0,0,1,1,0.0%,15m
15426,2,Fartastic,3037,0,0,1,1,0.0%,16m
15455,1,Xss,3036,945,131,119,250,52.4%,4m
15455,1,Texomix,3036,1636,90,89,179,50.3%,6m
15455,1,IMinWorking,3036,1103,74,72,146,50.7%,16m
15455,3,[UAŦeam]Phobos,3036,401,15,16,31,48.4%,9m
15455,2,CuddleProby,3036,244,9,2,11,81.8%,6m
15455,1,Geekon,3036,277,9,7,16,56.2%,8m
15455,1,Noah,3036,96,5,3,8,62.5%,1h
15455,2,[CBot]RoadToElune,3036,92,4,1,5,80.0%,6m
15455,1,arnarn,3036,169,4,4,8,50.0%,1h
15455,2,Jont,3036,32,2,4,6,33.3%,5m
15455,1,sruuu,3036,78,2,9,11,18.2%,12m
15455,2,Kaasvlinder,3036,0,0,1,1,0.0%,51m
15455,2,[DIVM]Shiver,3036,0,0,2,2,0.0%,8m
15468,3,Whigger,3035,1315,142,129,271,52.4%,8m
15468,3,Limitless,3035,1519,139,157,296,47.0%,31m
15468,2,Jfk,3035,1371,65,60,125,52.0%,15m
15468,3,[NGJ]OverNice,3035,1241,61,60,121,50.4%,30m
15468,1,futurclassic,3035,987,45,36,81,55.6%,8m
15468,3,vandermond,3035,1036,43,66,109,39.4%,4m
15468,1,[cFADDA]Rikisixrax,3035,789,27,29,56,48.2%,12m
15468,1,bro,3035,800,26,30,56,46.4%,21m
15468,3,Zidan,3035,726,25,34,59,42.4%,13m
15468,1,OmarEightTwo,3035,552,20,19,39,51.3%,5m
15468,1,Raptor,3035,399,19,14,33,57.6%,17m
15468,1,Hybrid,3035,195,15,11,26,57.7%,6m
15468,2,Grosnaze,3035,60,6,2,8,75.0%,9m
15468,1,[NKQ]Zorus,3035,240,6,7,13,46.2%,12m
15468,1,[LsFxTh]RoKing,3035,156,5,7,12,41.7%,30m
15468,2,jqn,3035,198,5,7,12,41.7%,11m
15468,1,Fwiffo,3035,162,5,9,14,35.7%,19m
15468,2,[Айур]RostTsh,3035,92,3,3,6,50.0%,20m
15468,1,[U19]TerranNuke,3035,76,3,6,9,33.3%,20m
15468,2,[NWGD]Warrior,3035,62,2,2,4,50.0%,4m
15468,2,[75PSG]DMz,3035,60,2,3,5,40.0%,3m
15468,2,[AISC]DoctorJones,3035,0,1,0,1,100.0%,9m
15468,2,Testi,3035,0,1,0,1,100.0%,3m
15468,2,[uCHAD]Gadzila,3035,0,1,0,1,100.0%,31m
15468,2,Kharnis,3035,32,1,2,3,33.3%,9m
15468,3,[n3rd]Olek,3035,0,1,4,5,20.0%,30m
15468,1,Freedomflyer,3035,0,1,4,5,20.0%,11m
15495,1,LightBringer,3034,1528,118,114,232,50.9%,21m
15495,3,BossTweed,3034,1262,97,99,196,49.5%,8m
15495,3,[Medoed]sem,3034,1073,60,52,112,53.6%,19m
15495,1,Vasilion,3034,1245,45,45,90,50.0%,12m
15495,1,Art,3034,573,22,17,39,56.4%,16m
15495,1,[BScars]GERNICK,3034,247,9,9,18,50.0%,30m
15495,2,[OPsm]Lokomotive,3034,188,7,7,14,50.0%,51m
15495,1,Aircraft,3034,146,6,3,9,66.7%,45m
15495,2,[DoFu]HoboSeducer,3034,30,5,2,7,71.4%,31m
15495,2,rizukuu,3034,30,4,4,8,50.0%,7m
15495,1,AtHoUsAnD,3034,0,3,2,5,60.0%,49m
15495,2,Flow,3034,0,3,2,5,60.0%,16m
15495,3,UrinGelber,3034,96,2,0,2,100.0%,17m
15495,1,Nimrat,3034,34,2,4,6,33.3%,14m
15495,2,Stalk,3034,30,1,1,2,50.0%,10m
15495,3,[DeadDe]Madson,3034,30,1,5,6,16.7%,9m
15495,2,Asadsa,3034,0,0,1,1,0.0%,7m
15495,1,Андерсен,3034,0,0,1,1,0.0%,19m
15495,2,Matzethias,3034,0,0,2,2,0.0%,5m
15495,1,Lanyl,3034,0,0,7,7,0.0%,9m
15515,2,Draxx,3033,1282,89,81,170,52.4%,11m
15515,1,Velkor,3033,568,48,39,87,55.2%,8m
15515,1,madamepipi,3033,829,42,39,81,51.9%,9m
15515,1,[DieVi]SDC,3033,1023,39,35,74,52.7%,11m
15515,1,quarry,3033,1012,33,36,69,47.8%,12m
15515,1,[EBEMZ]BalanceTPLS,3033,839,29,28,57,50.9%,8m
15515,2,[JHE]RingDove,3033,384,19,14,33,57.6%,20m
15515,1,[УТочка]JustAFreak,3033,239,9,4,13,69.2%,5m
15515,2,[DthCon]McBlanc,3033,212,7,1,8,87.5%,13m
15515,3,SayNoToStim,3033,168,6,4,10,60.0%,14m
15515,2,Harrtuck,3033,30,4,2,6,66.7%,15m
15515,1,[СRAZY]Михеюшка,3033,97,4,2,6,66.7%,15m
15515,1,fckProtoss,3033,165,4,7,11,36.4%,1h
15515,1,BigT,3033,138,3,3,6,50.0%,6m
15515,1,ToT,3033,97,3,3,6,50.0%,11m
15515,1,KyRen,3033,125,3,4,7,42.9%,4m
15515,1,XiJinping,3033,179,3,6,9,33.3%,16m
15515,2,Dreadnought,3033,30,2,1,3,66.7%,13m
15515,2,Sniock,3033,116,2,2,4,50.0%,16m
15515,2,Kyoshiro,3033,0,1,0,1,100.0%,49m
15515,1,YoLaN,3033,40,1,5,6,16.7%,20m
15515,2,[ÆGlS]Knight,3033,0,0,1,1,0.0%,7m
15515,2,Dragonborn,3033,0,0,1,1,0.0%,1h
15515,1,muissio,3033,0,0,6,6,0.0%,20m
15539,3,Scotty,3032,1619,433,432,865,50.1%,11m
15539,3,[Cannоn]meincraft,3032,1513,103,72,175,58.9%,15m
15539,1,Fenominous,3032,850,35,31,66,53.0%,19m
15539,1,LaCroix,3032,670,27,21,48,56.2%,14m
15539,1,Vackjo,3032,608,24,29,53,45.3%,13m
15539,1,adenis,3032,639,21,18,39,53.8%,30m
15539,3,xaximov,3032,550,18,29,47,38.3%,21m
15539,1,Колдунопрыг,3032,465,16,14,30,53.3%,20m
15539,1,kesstarwars,3032,250,7,7,14,50.0%,30m
15539,3,[SIEA]Cebuano,3032,120,6,4,10,60.0%,14m
15539,1,vays,3032,142,4,7,11,36.4%,16m
15539,2,SashaBogova,3032,94,3,1,4,75.0%,3m
15539,2,atye,3032,162,3,9,12,25.0%,21m
15539,2,Justacheeser,3032,0,1,0,1,100.0%,31m
15539,2,JlEBIIIA,3032,89,1,2,3,33.3%,4m
15539,2,[PacMan]Lumirax,3032,0,0,3,3,0.0%,9m
15555,3,miko,3031,1600,245,238,483,50.7%,14m
15555,1,YoTaFxS,3031,1690,105,90,195,53.8%,4m
15555,1,Fegis,3031,1487,91,81,172,52.9%,15m
15555,1,Vital,3031,1446,67,71,138,48.6%,21m
15555,1,platzhalter,3031,926,42,39,81,51.9%,31m
15555,1,[TheRPW]Arkenstone,3031,440,23,20,43,53.5%,21m
15555,2,Vamis,3031,507,18,18,36,50.0%,4m
15555,1,TheCount,3031,252,10,7,17,58.8%,15m
15555,2,target,3031,133,7,6,13,53.8%,1h
15555,1,[dlgc]BeerKiller,3031,244,7,10,17,41.2%,10m
15555,2,Tintin,3031,196,6,6,12,50.0%,10m
15555,1,[MVV77]MVVRock,3031,40,5,3,8,62.5%,11m
15555,1,Minecraft,3031,167,5,3,8,62.5%,1h
15555,2,Juicen,3031,42,5,4,9,55.6%,48m
15555,2,[LMLQ]janei,3031,169,4,10,14,28.6%,1h
15555,1,[1GH1]Alfastigma,3031,90,2,2,4,50.0%,30m
15555,2,GenoaSalami,3031,0,1,0,1,100.0%,10m
15555,2,BubbleSheen,3031,0,0,1,1,0.0%,18m
15555,2,Felix,3031,0,0,1,1,0.0%,9m
15555,2,Star,3031,0,0,1,1,0.0%,1h
15555,2,mrscors,3031,0,0,2,2,0.0%,30m
15576,3,Ryshio,3030,1518,174,180,354,49.2%,18m
15576,1,IIIIIIIIIIII,3030,1705,65,64,129,50.4%,11m
15576,1,Hurtone,3030,1665,63,66,129,48.8%,4m
15576,1,[TeHaCe]luQ,3030,949,52,39,91,57.1%,30m
15576,1,Prometheus,3030,574,47,39,86,54.7%,21m
15576,3,Verderben,3030,770,33,28,61,54.1%,14m
15576,1,MPmp,3030,541,22,18,40,55.0%,11m
15576,3,StimAClick,3030,518,22,33,55,40.0%,7m
15576,2,Smartypantz,3030,248,9,8,17,52.9%,8m
15576,1,Eye,3030,253,6,11,17,35.3%,19m
15576,2,Rugwood,3030,116,4,2,6,66.7%,12m
15576,3,venatiC,3030,121,3,7,10,30.0%,30m
15576,1,[CØG]AsGArD,3030,40,2,4,6,33.3%,2m
15576,2,AweS,3030,0,1,1,2,50.0%,13m
15576,2,[Pandie]SeaCow,3030,0,0,1,1,0.0%,11m
15576,2,[iaMsK]LeGioN,3030,0,0,1,1,0.0%,15m
15576,2,beKind,3030,0,0,1,1,0.0%,8m
15593,3,mihanik,3029,1454,113,115,228,49.6%,12m
15593,2,Boorock,3029,1612,87,69,156,55.8%,18m
15593,1,Mihey,3029,1462,85,79,164,51.8%,4m
15593,1,Lenny,3029,1056,49,46,95,51.6%,8m
15593,3,Lorex,3029,1168,46,53,99,46.5%,4m
15593,1,alexey,3029,1064,45,36,81,55.6%,13m
15593,3,NuclearSim,3029,1062,43,46,89,48.3%,8m
15593,3,[RLZT]Mrex,3029,668,34,39,73,46.6%,11m
15593,3,VertigO,3029,748,28,35,63,44.4%,4m
15593,1,[sH33px]TheDeadSheep,3029,493,27,18,45,60.0%,29m
15593,1,Rikitikitavi,3029,723,23,25,48,47.9%,7m
15593,2,Pushkin,3029,264,15,12,27,55.6%,31m
15593,1,Snook,3029,377,14,12,26,53.8%,19m
15593,2,[Cooop]Буритовец,3029,382,14,12,26,53.8%,10m
15593,3,[BELOM]KLAsTER,3029,304,13,9,22,59.1%,18m
15593,1,Mark,3029,491,13,16,29,44.8%,19m
15593,2,GeanKule,3029,272,10,4,14,71.4%,16m
15593,1,Adaś,3029,189,9,5,14,64.3%,15m
15593,2,Balis,3029,220,7,5,12,58.3%,3m
15593,1,cuervo,3029,0,4,2,6,66.7%,48m
15593,1,Hiob,3029,97,4,2,6,66.7%,55m
15593,1,[696]ArchitecT,3029,89,3,4,7,42.9%,15m
15593,2,FroggyClyde,3029,0,2,3,5,40.0%,4m
15593,2,[IYB]Grim,3029,58,2,4,6,33.3%,3m
15593,1,rezac,3029,0,2,4,6,33.3%,21m
15593,1,Hydra,3029,94,2,6,8,25.0%,6m
15593,2,Emperor,3029,0,1,0,1,100.0%,8m
15593,3,IIIIIIIIIIII,3029,0,0,3,3,0.0%,7m
15621,3,[SPAINs]NoScriptDude,3028,1083,96,91,187,51.3%,4m
15621,1,Lashkatora,3028,1570,75,65,140,53.6%,16m
15621,1,lllllllll,3028,503,33,31,64,51.6%,21m
15621,1,[TYC3E]Poom,3028,757,25,27,52,48.1%,19m
15621,1,EVGENFTF,3028,620,21,19,40,52.5%,30m
15621,2,[CDLB]Gabz,3028,232,9,4,13,69.2%,18m
15621,2,CuberWarrior,3028,234,8,8,16,50.0%,6m
15621,2,SecretPotato,3028,159,8,9,17,47.1%,21m
15621,3,[Ulmaga]Stormtruppe,3028,189,7,11,18,38.9%,19m
15621,1,TheMadnessOn,3028,144,4,7,11,36.4%,29m
15621,2,Holidmar,3028,66,3,1,4,75.0%,6m
15621,3,fenix,3028,146,3,2,5,60.0%,50m
15621,2,[LSPs]XxKHENSUxX,3028,98,3,5,8,37.5%,11m
15621,3,Vinicius,3028,62,3,13,16,18.8%,3m
15621,1,Megalomania,3028,36,2,8,10,20.0%,4m
15621,3,Sector,3028,30,2,10,12,16.7%,20m
15621,1,[turtle]pallekuling,3028,40,1,6,7,14.3%,19m
15621,2,CroW,3028,0,0,1,1,0.0%,15m
15621,2,Raizenator,3028,0,0,1,1,0.0%,13m
15640,1,Lightofday,3027,1253,86,74,160,53.8%,10m
15640,3,CeeF,3027,1198,60,73,133,45.1%,12m
15640,1,albertt,3027,1233,47,42,89,52.8%,4m
15640,3,Taffen,3027,676,28,31,59,47.5%,29m
15640,1,Ksanch,3027,409,16,14,30,53.3%,11m
15640,3,[ElSuHu]GeneralGee,3027,206,7,24,31,22.6%,5m
15640,3,Lethal,3027,102,6,4,10,60.0%,50m
15640,2,Frenetic,3027,42,5,4,9,55.6%,1h
15640,3,[SAoN]SAK,3027,153,4,2,6,66.7%,9m
15640,1,[SEBULA]Terminus,3027,125,3,3,6,50.0%,31m
15640,2,Kerzerk,3027,30,2,0,2,100.0%,12m
15640,2,New,3027,34,2,2,4,50.0%,18m
15640,1,MarkF,3027,70,2,6,8,25.0%,14m
15640,2,HailToKing,3027,30,1,2,3,33.3%,18m
15640,2,Tom,3027,0,0,1,1,0.0%,6m
15640,2,Crafty,3027,0,0,1,1,0.0%,15m
15640,1,[Heroes]Knails,3027,0,0,6,6,0.0%,29m
15657,3,craftwars,3026,541,113,104,217,52.1%,3m
15657,2,GoOfY,3026,1341,56,48,104,53.8%,18m
15657,2,GunPower,3026,1182,49,37,86,57.0%,8m
15657,3,Brainshack,3026,634,47,54,101,46.5%,12m
15657,1,Jeffy,3026,863,37,28,65,56.9%,21m
15657,1,GOOFYGOOBER,3026,334,10,14,24,41.7%,29m
15657,1,AmigoOpossum,3026,276,9,5,14,64.3%,7m
15657,2,Atti,3026,166,8,3,11,72.7%,19m
15657,3,Kakashi,3026,166,6,11,17,35.3%,3m
15657,3,Clownbear,3026,0,5,2,7,71.4%,1h
15657,1,PadreWhiskey,3026,145,5,3,8,62.5%,1h
15657,2,[EESC]zzxbx,3026,92,4,2,6,66.7%,3m
15657,2,[Ogz]astrolabb,3026,159,4,3,7,57.1%,9m
15657,3,[Jail]TuJefe,3026,97,4,4,8,50.0%,56m
15657,1,Chrisman,3026,80,3,9,12,25.0%,30m
15657,1,[LSPs]timocius,3026,0,1,3,4,25.0%,13m
15673,1,CoffeeMilk,3025,1696,160,150,310,51.6%,30m
15673,3,[TuNa95]BiGxLebowski,3025,1561,148,151,299,49.5%,14m
15673,1,Nagibator,3025,1578,104,82,186,55.9%,14m
15673,1,[TEDF]Tagazox,3025,1695,90,71,161,55.9%,21m
15673,2,crazysky,3025,1632,74,63,137,54.0%,13m
15673,3,Kikifax,3025,844,60,61,121,49.6%,12m
15673,1,[aBrain]LETRiX,3025,1468,58,59,117,49.6%,30m
15673,2,Demerzel,3025,1116,47,33,80,58.8%,2m
15673,1,[Pïǥ]FakeDumpling,3025,1013,40,42,82,48.8%,4m
15673,1,ShadowEagle,3025,937,31,31,62,50.0%,15m
15673,1,XXAdiSS,3025,410,12,17,29,41.4%,13m
15673,1,Tibimk,3025,255,10,11,21,47.6%,46m
15673,1,Erlin,3025,238,8,8,16,50.0%,11m
15673,2,BioTerran,3025,114,5,2,7,71.4%,10m
15673,2,AUREON,3025,94,4,3,7,57.1%,20m
15673,2,ХитрыйКраб,3025,177,3,5,8,37.5%,44m
15673,2,Nadir,3025,0,2,3,5,40.0%,14m
15673,2,destroy,3025,94,1,1,2,50.0%,31m
15673,2,Skald,3025,0,0,1,1,0.0%,13m
15673,2,ChineMeilleu,3025,0,0,1,1,0.0%,7m
15673,1,BALLERN,3025,0,0,4,4,0.0%,19m
15694,3,Digger,3024,1483,395,386,781,50.6%,11m
15694,2,Skarphedinn,3024,1290,49,44,93,52.7%,13m
15694,1,Kevin,3024,875,49,45,94,52.1%,30m
15694,1,failzor,3024,426,35,24,59,59.3%,7m
15694,2,Heittis,3024,583,31,16,47,66.0%,12m
15694,2,ПростоЧел,3024,575,24,13,37,64.9%,6m
15694,2,carrera,3024,447,23,16,39,59.0%,4m
15694,1,Duglaz,3024,374,18,16,34,52.9%,10m
15694,1,LordTomicron,3024,562,17,21,38,44.7%,5m
15694,1,Chillmatho,3024,477,15,15,30,50.0%,12m
15694,3,WerWolf,3024,247,11,11,22,50.0%,15m
15694,2,[InBri]PolarBeeANG,3024,234,8,3,11,72.7%,4m
15694,2,Marinek,3024,192,7,4,11,63.6%,4m
15694,1,[FENIKS]Владимир,3024,116,6,3,9,66.7%,9m
15694,1,Regalius,3024,179,6,7,13,46.2%,16m
15694,3,[OAGSC]Ozzy,3024,0,5,2,7,71.4%,30m
15694,3,Taradorn,3024,97,5,2,7,71.4%,19m
15694,1,[FamT]haphri,3024,167,5,7,12,41.7%,16m
15694,1,StaltosS,3024,0,4,2,6,66.7%,21m
15694,2,badwolf,3024,132,3,1,4,75.0%,14m
15694,1,Diamand,3024,87,3,3,6,50.0%,20m
15694,2,Eldritch,3024,30,2,2,4,50.0%,15m
15694,2,Badrgatti,3024,0,1,0,1,100.0%,5m
15694,2,Starfox,3024,0,1,0,1,100.0%,14m
15694,2,Endorall,3024,0,1,0,1,100.0%,15m
15694,2,[ELB]Gimli,3024,30,1,1,2,50.0%,7m
15694,2,MaRa,3024,36,1,2,3,33.3%,9m
15694,2,[WBO]TentacleChad,3024,30,1,2,3,33.3%,13m
15694,2,NORTHKOR,3024,0,1,4,5,20.0%,48m
15694,1,modmoto,3024,0,0,1,1,0.0%,55m
15694,2,[MagicA]Nikex,3024,0,0,1,1,0.0%,20m
15694,2,YellowsonSOз,3024,0,0,1,1,0.0%,4m
15726,1,Jason,3023,1236,101,96,197,51.3%,14m
15726,3,Shathe,3023,1210,97,101,198,49.0%,4m
15726,2,Alonso,3023,914,71,67,138,51.4%,12m
15726,1,[ToXin]SternJumper,3023,874,34,30,64,53.1%,11m
15726,2,[lLiTl]SHIN,3023,540,20,14,34,58.8%,9m
15726,1,Egoista,3023,560,17,22,39,43.6%,4m
15726,3,BuBu,3023,407,16,3,19,84.2%,21m
15726,1,[ggEZI]Uneha,3023,402,15,12,27,55.6%,3m
15726,1,pit,3023,270,15,19,34,44.1%,16m
15726,1,vdoleg,3023,265,10,9,19,52.6%,17m
15726,2,decoy,3023,188,6,5,11,54.5%,13m
15726,2,neltharion,3023,210,6,16,22,27.3%,12m
15726,1,CrabMan,3023,97,4,2,6,66.7%,1h
15726,1,wowa,3023,88,4,3,7,57.1%,17m
15726,1,BioHazarD,3023,0,3,2,5,60.0%,1h
15726,2,Heretic,3023,95,3,3,6,50.0%,5m
15726,1,Hasajacy,3023,70,2,7,9,22.2%,30m
15726,2,Canarion,3023,0,1,1,2,50.0%,16m
15726,2,Rocket,3023,0,1,1,2,50.0%,5m
15726,2,Sehkraft,3023,94,1,3,4,25.0%,21m
15726,1,Zahr,3023,48,1,9,10,10.0%,14m
15747,3,[Zelos]Kitesurfer,3022,1611,612,612,1224,50.0%,10m
15747,3,kasskran,3022,1464,93,99,192,48.4%,14m
15747,1,bfg,3022,844,53,48,101,52.5%,13m
15747,2,LevenarK,3022,1068,41,39,80,51.2%,6m
15747,1,Absolom,3022,408,16,13,29,55.2%,5m
15747,1,rahan,3022,270,13,6,19,68.4%,47m
15747,1,HumaNsSouL,3022,339,13,9,22,59.1%,30m
15747,2,Inikoyi,3022,304,11,5,16,68.8%,20m
15747,1,Basik,3022,322,11,17,28,39.3%,20m
15747,2,katsumoto,3022,207,8,4,12,66.7%,3m
15747,2,Treyxnous,3022,226,8,6,14,57.1%,1h
15747,2,Usal,3022,152,7,2,9,77.8%,6m
15747,1,JimmyHendrix,3022,126,6,7,13,46.2%,14m
15747,1,Lightbringer,3022,185,5,4,9,55.6%,8m
15747,2,Shawshank,3022,58,3,0,3,100.0%,4m
15747,2,[BiKn]BigSmoke,3022,30,2,1,3,66.7%,9m
15747,2,BearLeG,3022,0,1,0,1,100.0%,12m
15747,2,[AP5]Kilucru,3022,30,1,2,3,33.3%,21m
15747,2,open,3022,30,1,2,3,33.3%,5m
15747,3,Vudurlak,3022,96,1,3,4,25.0%,3m
15747,2,LuckyTiger,3022,0,0,1,1,0.0%,18m
15747,2,AncientPower,3022,0,0,1,1,0.0%,14m
15769,3,[Chariz]Marfor,3021,1624,228,221,449,50.8%,14m
15769,3,[SY2G]ßcMc,3021,1505,182,177,359,50.7%,9m
15769,1,skycaptain,3021,1486,125,124,249,50.2%,5m
15769,1,Fab,3021,1699,98,100,198,49.5%,11m
15769,1,Toilet,3021,743,87,81,168,51.8%,4m
15769,1,CaptainCool,3021,810,42,36,78,53.8%,19m
15769,2,Starbuck,3021,798,36,29,65,55.4%,4m
15769,2,PINGVIN,3021,822,35,21,56,62.5%,13m
15769,2,Хрусткостей,3021,654,28,19,47,59.6%,3m
15769,3,[ECFeV]Blechfaust,3021,770,28,31,59,47.5%,18m
15769,1,Jaz,3021,600,19,27,46,41.3%,21m
15769,1,MuShu,3021,475,18,14,32,56.2%,21m
15769,2,super,3021,142,6,2,8,75.0%,9m
15769,1,Stewie,3021,258,6,9,15,40.0%,1h
15769,1,deathcuddler,3021,0,4,2,6,66.7%,19m
15769,1,SVIOO,3021,48,4,3,7,57.1%,8m
15769,2,Magicadam,3021,122,4,5,9,44.4%,11m
15769,2,Maxwell,3021,90,3,3,6,50.0%,30m
15769,1,Калмык,3021,114,3,5,8,37.5%,19m
15769,1,dir,3021,80,2,6,8,25.0%,9m
15769,1,dragonslick,3021,76,2,9,11,18.2%,7m
15769,2,shellschock,3021,0,1,0,1,100.0%,13m
15769,3,[theDHA]HeyBuddieJr,3021,0,1,2,3,33.3%,44m
15769,2,[XiOd]stefanffb,3021,32,1,2,3,33.3%,12m
15769,3,MakkO,3021,30,1,12,13,7.7%,3m
15769,2,[ToLOoZ]OdeJavel,3021,0,0,1,1,0.0%,10m
15769,1,[T4E]Flitzpiepe,3021,0,0,4,4,0.0%,11m
15796,3,spainvox,3020,1542,155,158,313,49.5%,18m
15796,3,NuStream,3020,1561,93,98,191,48.7%,16m
15796,1,Romchester,3020,1577,73,73,146,50.0%,12m
15796,2,[BecKRS]DrLoose,3020,1617,72,60,132,54.5%,14m
15796,1,[BWArmy]Slazy,3020,1212,53,39,92,57.6%,20m
15796,1,hamouche,3020,894,36,30,66,54.5%,12m
15796,3,[Gordi]Necromonger,3020,688,30,25,55,54.5%,13m
15796,2,[ǂIAMǂ]SetoKaiba,3020,362,18,5,23,78.3%,9m
15796,3,Phoenix,3020,373,16,15,31,51.6%,10m
15796,1,Troj,3020,440,16,19,35,45.7%,8m
15796,2,Apxe,3020,388,14,9,23,60.9%,8m
15796,2,InZaine,3020,166,8,5,13,61.5%,18m
15796,2,Javier,3020,195,8,5,13,61.5%,4m
15796,2,Warbringer,3020,114,4,4,8,50.0%,16m
15796,2,Teethtroll,3020,62,3,2,5,60.0%,8m
15796,1,[Kompis]Soren,3020,162,3,6,9,33.3%,17m
15796,2,[ZERGML]БейнлинЛингс,3020,30,1,1,2,50.0%,16m
15796,1,[1stGG]DrDanGerous,3020,20,1,5,6,16.7%,17m
15796,2,BattleBot,3020,0,0,1,1,0.0%,18m
15796,1,[FRAG]Faraday,3020,0,0,1,1,0.0%,1h
15796,2,[BNAs]DDart,3020,0,0,1,1,0.0%,10m
15796,2,PinaCollider,3020,0,0,2,2,0.0%,15m
15796,1,lauri,3020,0,0,7,7,0.0%,9m
15819,1,lawrence,3019,1655,294,279,573,51.3%,29m
15819,1,[NoMP]madsteph,3019,1376,283,266,549,51.5%,14m
15819,3,Mash,3019,1155,128,132,260,49.2%,8m
15819,1,Timon,3019,392,26,26,52,50.0%,6m
15819,1,Deyshan,3019,445,18,14,32,56.2%,15m
15819,2,Maximus,3019,458,16,17,33,48.5%,3m
15819,2,ProbeProcess,3019,408,15,12,27,55.6%,5m
15819,1,[KMSC]Guz,3019,404,15,19,34,44.1%,18m
15819,2,Starschenko,3019,216,10,6,16,62.5%,18m
15819,2,Allen,3019,228,8,8,16,50.0%,5m
15819,2,MariusVern,3019,121,5,4,9,55.6%,56m
15819,2,Neveziah,3019,92,5,6,11,45.5%,18m
15819,2,KalergiPlan,3019,185,5,10,15,33.3%,5m
15819,2,[EloHel]NickDiaz,3019,90,4,0,4,100.0%,6m
15819,2,balabala,3019,108,3,0,3,100.0%,18m
15819,1,Broodjekip,3019,0,3,2,5,60.0%,54m
15819,2,[SQEERE]Slavaraker,3019,30,2,0,2,100.0%,5m
15819,1,[NoAtk]Evilbob,3019,105,2,3,5,40.0%,21m
15819,2,mastergareen,3019,0,1,0,1,100.0%,15m
15819,2,PUTEN,3019,0,1,0,1,100.0%,15m
15819,2,Rezno,3019,32,1,3,4,25.0%,4m
15819,2,[Xa]Zyklon,3019,30,1,4,5,20.0%,7m
15819,1,Kenji,3019,0,0,3,3,0.0%,11m
15842,1,Mafloom,3018,1686,556,534,1090,51.0%,17m
15842,1,Oduvanchik,3018,945,133,122,255,52.2%,9m
15842,2,manchacouill,3018,1386,74,64,138,53.6%,14m
15842,3,LeSpeCtre,3018,1555,63,64,127,49.6%,9m
15842,1,ЯБазутчик,3018,944,34,35,69,49.3%,10m
15842,3,Rithulme,3018,728,25,35,60,41.7%,16m
15842,1,zmajko,3018,282,12,9,21,57.1%,19m
15842,1,Itachi,3018,206,9,7,16,56.2%,15m
15842,1,JTgalactica,3018,166,5,3,8,62.5%,21m
15842,2,[GSTAR]Pain,3018,98,3,3,6,50.0%,3m
15842,2,timon,3018,30,2,1,3,66.7%,13m
15842,1,Butteye,3018,118,2,4,6,33.3%,10m
15842,1,Apodarilli,3018,0,1,0,1,100.0%,59m
15842,2,Dahmm,3018,30,1,1,2,50.0%,10m
15842,1,Mishka,3018,89,1,3,4,25.0%,5m
15842,2,[AmphR]Andatr,3018,0,0,1,1,0.0%,7m
15842,2,[DМG]Gaiety,3018,0,0,1,1,0.0%,13m
15842,2,UrBraveness,3018,0,0,2,2,0.0%,9m
15842,1,SmilingAlone,3018,0,0,2,2,0.0%,60m
15861,1,ЗЛОСТЬ,3017,1692,304,280,584,52.1%,5m
15861,3,mzr,3017,1436,202,219,421,48.0%,2m
15861,1,Jon,3017,1055,94,93,187,50.3%,14m
15861,1,oSwAGo,3017,1099,59,59,118,50.0%,18m
15861,1,Goldilocks,3017,776,42,34,76,55.3%,4m
15861,1,[PPM]Greenghost,3017,644,30,23,53,56.6%,3m
15861,2,[SkeSS]JensDemens,3017,594,22,20,42,52.4%,3m
15861,1,[EV0C]Sar,3017,516,15,20,35,42.9%,20m
15861,2,NikProBG,3017,214,8,1,9,88.9%,3m
15861,3,Baldur,3017,169,6,5,11,54.5%,1h
15861,2,SmileRU,3017,116,5,3,8,62.5%,7m
15861,2,yNeris,3017,60,3,2,5,60.0%,19m
15861,1,Wiskas,3017,112,3,9,12,25.0%,4m
15861,2,[Valise]DAWE,3017,58,2,1,3,66.7%,13m
15861,1,BodyBag,3017,0,2,4,6,33.3%,14m
15861,3,Bismarck,3017,58,2,12,14,14.3%,6m
15861,2,DakkaDok,3017,0,1,0,1,100.0%,16m
15861,2,Lum,3017,0,1,1,2,50.0%,7m
15861,2,Predosa,3017,0,1,1,2,50.0%,4m
15861,2,realtrol,3017,0,1,2,3,33.3%,9m
15861,1,[БОДУН]Nekrosoon,3017,0,1,3,4,25.0%,14m
15861,2,LeMonLinK,3017,0,0,1,1,0.0%,12m
15883,3,Роман,3016,1284,150,158,308,48.7%,12m
15883,2,[ThFctr]BlackFactor,3016,1538,123,118,241,51.0%,13m
15883,1,Zeron,3016,951,47,38,85,55.3%,15m
15883,2,FireFlame,3016,909,37,35,72,51.4%,11m
15883,2,Agon,3016,727,35,30,65,53.8%,5m
15883,2,gor,3016,498,18,20,38,47.4%,21m
15883,1,Japhet,3016,345,15,10,25,60.0%,14m
15883,1,BarathBathum,3016,280,12,10,22,54.5%,29m
15883,1,CoyGodzilla,3016,237,9,9,18,50.0%,15m
15883,2,tdarovsky,3016,144,5,5,10,50.0%,31m
15883,2,[RIZY]Artvel,3016,154,5,5,10,50.0%,31m
15883,1,HansFasching,3016,137,3,5,8,37.5%,6m
15883,2,Jerry,3016,0,1,0,1,100.0%,9m
15883,3,Whowie,3016,0,1,0,1,100.0%,1h
15883,1,darkpopey,3016,0,1,2,3,33.3%,1h
15883,3,wintermute,3016,96,1,4,5,20.0%,4m
15883,2,bluemarine,3016,0,0,3,3,0.0%,5m
15900,1,Aaricia,3015,1510,232,214,446,52.0%,21m
15900,2,FearKillsYou,3015,1509,171,121,292,58.6%,3m
15900,1,pilotse,3015,1696,104,111,215,48.4%,10m
15900,2,Crazypowa,3015,1029,73,58,131,55.7%,16m
15900,3,AlexSib,3015,1231,54,51,105,51.4%,10m
15900,1,Arcji,3015,720,47,39,86,54.7%,20m
15900,1,[АDMIN]shvedov,3015,828,38,20,58,65.5%,3m
15900,1,Plantago,3015,886,28,33,61,45.9%,18m
15900,2,cbx,3015,194,8,4,12,66.7%,12m
15900,2,ToTologie,3015,228,8,4,12,66.7%,11m
15900,3,[OlDuck]Arud,3015,0,4,3,7,57.1%,20m
15900,2,[PRAWN]BigKahuna,3015,43,3,3,6,50.0%,8m
15900,2,Solve,3015,30,2,0,2,100.0%,20m
15900,2,[Pasol]Paskanus,3015,60,2,2,4,50.0%,18m
15900,2,Tsyme,3015,60,2,5,7,28.6%,18m
15900,1,[A0V]Isolation,3015,42,1,5,6,16.7%,20m
15900,2,Grizzly,3015,0,0,1,1,0.0%,9m
15917,3,strech,3014,1186,144,144,288,50.0%,31m
15917,2,sutlebalrush,3014,569,91,60,151,60.3%,17m
15917,3,Bulldozer,3014,1457,66,77,143,46.2%,21m
15917,2,Halim,3014,1207,50,38,88,56.8%,10m
15917,2,AndOneKN,3014,789,49,41,90,54.4%,15m
15917,1,FauSt,3014,738,47,50,97,48.5%,18m
15917,1,Tvard,3014,689,34,27,61,55.7%,7m
15917,2,Andrey,3014,607,30,20,50,60.0%,9m
15917,1,Mateipls,3014,515,25,26,51,49.0%,16m
15917,3,Dmitry,3014,608,24,32,56,42.9%,19m
15917,1,DarkTerran,3014,542,19,16,35,54.3%,8m
15917,1,[PDkit]Xeonicx,3014,473,17,15,32,53.1%,12m
15917,2,Nookie,3014,190,16,9,25,64.0%,12m
15917,1,zerg,3014,421,12,18,30,40.0%,29m
15917,3,daylight,3014,316,11,19,30,36.7%,4m
15917,1,KFanatic,3014,272,10,8,18,55.6%,4m
15917,2,RentFree,3014,228,9,8,17,52.9%,3m
15917,1,striker,3014,211,7,4,11,63.6%,15m
15917,2,Pepperoni,3014,170,6,3,9,66.7%,9m
15917,1,[THINK]NXT,3014,228,6,10,16,37.5%,8m
15917,3,Drogo,3014,198,5,8,13,38.5%,1h
15917,1,[AVSW]IceKiller,3014,78,3,4,7,42.9%,9m
15917,2,Sluthusky,3014,135,3,4,7,42.9%,1h
15917,1,Winter,3014,110,3,7,10,30.0%,4m
15917,2,sZoPeN,3014,88,2,1,3,66.7%,7m
15917,2,[BATG]Jahazzera,3014,30,2,2,4,50.0%,7m
15917,2,[eleec]jericho,3014,0,0,1,1,0.0%,1h
15917,2,Gips,3014,0,0,1,1,0.0%,7m
15917,2,John,3014,0,0,1,1,0.0%,13m
15917,2,LPD,3014,0,0,2,2,0.0%,31m
15917,2,[ialm]Kefaem,3014,0,0,2,2,0.0%,10m
15948,2,[Пеc0к]Varrkan,3013,1602,121,104,225,53.8%,7m
15948,3,fatbob,3013,1299,58,50,108,53.7%,16m
15948,2,Wizart,3013,875,46,36,82,56.1%,5m
15948,2,Hoggerita,3013,759,32,20,52,61.5%,10m
15948,3,OverNoob,3013,609,26,24,50,52.0%,12m
15948,2,ledertrexate,3013,485,21,18,39,53.8%,20m
15948,2,Zasada,3013,237,17,10,27,63.0%,17m
15948,2,BFGX,3013,406,15,12,27,55.6%,13m
15948,2,Jekenius,3013,228,10,7,17,58.8%,10m
15948,1,Karas,3013,329,10,15,25,40.0%,12m
15948,2,Malfunction,3013,174,6,4,10,60.0%,3m
15948,2,[FFaaN]CHIKYSPECYAL,3013,90,4,4,8,50.0%,17m
15948,2,[696]nilsragnar,3013,66,3,1,4,75.0%,13m
15948,2,kRz,3013,32,1,3,4,25.0%,10m
15962,3,Dicboy,3012,1550,96,90,186,51.6%,14m
15962,1,KNECHTER,3012,1682,93,86,179,52.0%,9m
15962,1,Бульбазавр,3012,1679,68,61,129,52.7%,2m
15962,2,CaptainNemo,3012,574,32,27,59,54.2%,9m
15962,1,LikerGames,3012,680,30,21,51,58.8%,3m
15962,1,bes,3012,663,22,24,46,47.8%,9m
15962,2,[1v1ez]Frolt,3012,256,9,7,16,56.2%,10m
15962,1,Kaelosa,3012,188,8,6,14,57.1%,5m
15962,2,Eschaton,3012,166,5,7,12,41.7%,1h
15962,2,[NerCC]Bennix,3012,90,4,3,7,57.1%,10m
15962,2,[TURB0]CrushHour,3012,120,4,5,9,44.4%,21m
15962,2,Dirgs,3012,0,3,2,5,60.0%,8m
15962,2,Jamaikata,3012,0,3,2,5,60.0%,5m
15962,2,Армен,3012,62,3,3,6,50.0%,10m
15962,3,ShaolinAmove,3012,38,2,0,2,100.0%,49m
15962,2,Dzeremaja,3012,32,2,0,2,100.0%,13m
15962,2,TareCaani,3012,0,1,0,1,100.0%,7m
15962,1,SupremeDadou,3012,0,1,0,1,100.0%,7m
15962,1,Olimary,3012,0,1,3,4,25.0%,5m
15962,2,[LeVaV]Borislav,3012,0,0,1,1,0.0%,21m
15962,2,Drago,3012,0,0,2,2,0.0%,16m
15962,1,mumum,3012,0,0,6,6,0.0%,16m
15984,1,Extractz,3011,1540,68,70,138,49.3%,12m
15984,3,vanady,3011,1196,61,70,131,46.6%,10m
15984,3,Maczongzaur,3011,676,50,48,98,51.0%,6m
15984,2,[ШиШаНы]Nyashka,3011,660,32,13,45,71.1%,13m
15984,1,[ChingC]BrentonTeran,3011,820,30,27,57,52.6%,30m
15984,1,[fu69z]pvtRYAN,3011,786,27,29,56,48.2%,30m
15984,2,kova,3011,210,11,9,20,55.0%,11m
15984,1,Drounet,3011,295,11,12,23,47.8%,5m
15984,2,[TTe]ItsAboutTime,3011,323,10,8,18,55.6%,13m
15984,2,darkfenix,3011,230,9,5,14,64.3%,9m
15984,2,Ben,3011,145,7,3,10,70.0%,18m
15984,2,[Dobro]Ivansai,3011,178,6,8,14,42.9%,7m
15984,2,Mopsi,3011,154,5,6,11,45.5%,6m
15984,2,VerseUni,3011,160,4,1,5,80.0%,11m
15984,1,Byun,3011,88,4,3,7,57.1%,19m
15984,2,[DAGW]greenloar,3011,30,2,1,3,66.7%,21m
15984,1,[SNMRTZ]Lieutenant,3011,0,1,0,1,100.0%,1h
15984,2,HUGO,3011,0,0,1,1,0.0%,30m
15984,2,[UAONE]shadowstorm,3011,0,0,1,1,0.0%,4m
15984,2,Sbirulino,3011,0,0,2,2,0.0%,15m
16004,3,Pyrus,3010,1603,247,251,498,49.6%,16m
16004,1,Toulk,3010,1588,184,168,352,52.3%,12m
16004,1,sponte,3010,1574,169,170,339,49.9%,15m
16004,1,Muszu,3010,1643,162,135,297,54.5%,19m
16004,2,DChocolate,3010,1674,148,142,290,51.0%,13m
16004,1,Pokebowl,3010,1611,69,57,126,54.8%,8m
16004,2,Green,3010,760,68,59,127,53.5%,14m
16004,2,YungTerran,3010,1464,68,67,135,50.4%,10m
16004,2,Sylar,3010,1545,64,55,119,53.8%,31m
16004,2,[HUNSP]Pat,3010,874,38,28,66,57.6%,16m
16004,1,[PiGPan]Marcus,3010,708,26,24,50,52.0%,12m
16004,2,dennisje,3010,452,25,1,26,96.2%,13m
16004,1,MyStick,3010,534,16,21,37,43.2%,16m
16004,2,Veto,3010,325,12,8,20,60.0%,10m
16004,1,eridon,3010,346,12,15,27,44.4%,30m
16004,1,[CNNB]Throne,3010,304,9,15,24,37.5%,16m
16004,2,Nalbum,3010,212,8,5,13,61.5%,12m
16004,2,[BELPA]CnalbErion,3010,272,8,7,15,53.3%,52m
16004,1,szwaj,3010,192,5,11,16,31.2%,17m
16004,1,[GGZERG]SantaKlous,3010,0,4,2,6,66.7%,1h
16004,2,DeiF,3010,88,4,2,6,66.7%,5m
16004,2,DAR,3010,58,3,1,4,75.0%,12m
16004,1,Rymygo,3010,0,3,2,5,60.0%,1h
16004,2,GoRo,3010,32,2,2,4,50.0%,3m
16004,2,Funkydrummer,3010,0,1,0,1,100.0%,14m
16004,2,[Trasch]Pico,3010,0,1,0,1,100.0%,9m
16004,2,BaJlePka,3010,0,1,1,2,50.0%,9m
16004,2,[NLTN]illilililili,3010,0,1,1,2,50.0%,14m
16004,2,olaKala,3010,0,1,1,2,50.0%,21m
16004,1,NAGIBATOR,3010,0,0,2,2,0.0%,3m
16004,2,samieboy,3010,0,0,3,3,0.0%,15m
16004,1,MasterTzu,3010,0,0,5,5,0.0%,8m
16036,1,Klaris,3009,1409,213,206,419,50.8%,30m
16036,3,SuperDragon,3009,1576,202,190,392,51.5%,2m
16036,3,IIIIIIIIIIII,3009,1501,63,59,122,51.6%,21m
16036,1,DenBro,3009,865,35,25,60,58.3%,19m
16036,2,Ray,3009,668,29,20,49,59.2%,11m
16036,1,Guidji,3009,710,24,28,52,46.2%,7m
16036,2,dixma,3009,563,22,22,44,50.0%,11m
16036,1,Tlaloc,3009,325,13,8,21,61.9%,1h
16036,1,Hïgara,3009,294,13,9,22,59.1%,5m
16036,2,Rob,3009,352,13,13,26,50.0%,5m
16036,2,[LOLscv]SCVrush,3009,284,11,2,13,84.6%,12m
16036,2,nazgul,3009,173,5,2,7,71.4%,4m
16036,2,Artu,3009,161,4,8,12,33.3%,53m
16036,2,AEC,3009,58,2,2,4,50.0%,13m
16036,1,ShadowEye,3009,96,2,2,4,50.0%,59m
16036,2,Einzelnkamf,3009,30,1,2,3,33.3%,32m
16036,3,Omarjuul,3009,38,1,2,3,33.3%,1h
16036,2,Baldr,3009,0,0,1,1,0.0%,21m
16036,2,ivk,3009,0,0,1,1,0.0%,15m
16036,2,[ICG]Bolino,3009,0,0,1,1,0.0%,2m
16036,2,shadow,3009,0,0,1,1,0.0%,16m
16057,2,OutlawGuru,3008,1634,290,268,558,52.0%,10m
16057,1,wIxXoR,3008,1428,61,51,112,54.5%,14m
16057,2,Erovraren,3008,1040,42,38,80,52.5%,10m
16057,1,Muhi,3008,831,39,37,76,51.3%,9m
16057,1,Сергей,3008,887,36,28,64,56.2%,29m
16057,1,[DumpD]Apokalyptik,3008,948,31,34,65,47.7%,6m
16057,2,SaulGoodman,3008,380,13,14,27,48.1%,4m
16057,1,Zety,3008,246,13,21,34,38.2%,21m
16057,1,[PrCd]MikaLokonen,3008,154,6,5,11,54.5%,14m
16057,1,[zballs]Tiberion,3008,140,4,12,16,25.0%,6m
16057,1,Tawerdef,3008,0,3,2,5,60.0%,1h
16057,2,[JediK]derJapaner,3008,38,2,1,3,66.7%,3m
16057,1,[CaZerg]Kjubaran,3008,40,2,6,8,25.0%,32m
16057,2,IIIIIIIIIIII,3008,30,1,4,5,20.0%,5m
16057,2,Avery,3008,0,0,1,1,0.0%,13m
16057,2,EliteWolf,3008,0,0,1,1,0.0%,15m
16057,2,CaMpeRcze,3008,0,0,3,3,0.0%,3m
16074,2,sunnywind,3007,1599,226,216,442,51.1%,20m
16074,2,Bair,3007,1310,223,189,412,54.1%,12m
16074,1,[FatKlD]JokE,3007,1682,193,190,383,50.4%,12m
16074,1,Knuff,3007,1606,154,151,305,50.5%,21m
16074,3,Metho,3007,411,105,120,225,46.7%,4m
16074,1,KingBelay,3007,619,60,62,122,49.2%,14m
16074,2,Leonidus,3007,824,51,46,97,52.6%,5m
16074,1,HelloBABS,3007,612,51,53,104,49.0%,20m
16074,2,fantom,3007,538,34,12,46,73.9%,21m
16074,2,[Unguad]gersn,3007,847,33,28,61,54.1%,19m
16074,1,[Senil]Wahrkraft,3007,684,23,26,49,46.9%,10m
16074,2,[fam1ly]ArtiDo,3007,508,22,17,39,56.4%,6m
16074,2,kamise,3007,520,21,13,34,61.8%,10m
16074,1,ayufan,3007,479,16,16,32,50.0%,10m
16074,2,CyberSoldier,3007,338,11,8,19,57.9%,3m
16074,1,dany,3007,285,11,10,21,52.4%,30m
16074,2,[TSNUZZ]SnuzzleBear,3007,209,8,9,17,47.1%,4m
16074,1,[LKŁHD]Bercik,3007,120,7,8,15,46.7%,21m
16074,3,piwko,3007,122,5,14,19,26.3%,15m
16074,1,Steffen,3007,0,4,1,5,80.0%,13m
16074,1,Greed,3007,0,3,2,5,60.0%,1h
16074,3,StarRRTeRRan,3007,66,2,26,28,7.1%,15m
16074,2,[MNGGTV]TYCHUS,3007,0,1,0,1,100.0%,13m
16074,1,REDalwaysHER,3007,97,1,3,4,25.0%,55m
16074,1,PocketDonkey,3007,88,1,4,5,20.0%,15m
16074,2,[Maciu]Smesca,3007,0,0,1,1,0.0%,10m
16074,2,Rohkar,3007,0,0,1,1,0.0%,13m
16074,2,MechMan,3007,0,0,1,1,0.0%,12m
16074,2,Aitor,3007,0,0,2,2,0.0%,8m
16103,2,Neodreamer,3006,1497,161,158,319,50.5%,3m
16103,1,GustavGhost,3006,1463,80,67,147,54.4%,5m
16103,3,TotalFail,3006,1398,73,90,163,44.8%,4m
16103,1,MAleks,3006,1036,62,58,120,51.7%,14m
16103,3,Endrew,3006,583,42,43,85,49.4%,4m
16103,2,Sergio,3006,695,37,28,65,56.9%,5m
16103,1,Kronus,3006,549,21,17,38,55.3%,12m
16103,2,bnage,3006,413,16,12,28,57.1%,13m
16103,2,jaimenak,3006,350,13,12,25,52.0%,14m
16103,1,MaRiO,3006,269,12,8,20,60.0%,10m
16103,1,[Trran]Commander,3006,293,11,9,20,55.0%,19m
16103,3,XueHaTa,3006,295,10,7,17,58.8%,6m
16103,1,Ragganmore,3006,301,8,8,16,50.0%,15m
16103,2,Angelina,3006,234,8,10,18,44.4%,4m
16103,1,Casic,3006,216,7,12,19,36.8%,20m
16103,2,vadimusan,3006,86,4,1,5,80.0%,32m
16103,2,Borgrdr,3006,88,4,2,6,66.7%,15m
16103,3,[HIYYYA]wildez,3006,121,3,7,10,30.0%,48m
16103,2,ElverGadura,3006,30,2,0,2,100.0%,16m
16103,1,[LRDP]LRPDCuv,3006,0,2,1,3,66.7%,57m
16103,2,Puxzl,3006,30,2,1,3,66.7%,7m
16103,2,Dworf,3006,0,1,0,1,100.0%,19m
16103,2,Jimi,3006,0,1,0,1,100.0%,13m
16103,1,[K9Unit]Hanayama,3006,95,1,1,2,50.0%,9m
16103,2,[Toons]YourMoms,3006,32,1,1,2,50.0%,18m
16103,2,WoKoOne,3006,30,1,1,2,50.0%,14m
16103,3,PewCrew,3006,0,1,1,2,50.0%,9m
16103,1,[MNGGTV]MaNNaGGia,3006,0,1,3,4,25.0%,10m
16103,2,[Z3D]FerNeo,3006,0,0,1,1,0.0%,1h
16103,2,dublyou,3006,0,0,1,1,0.0%,15m
16133,3,Ovidiu,3005,1418,458,455,913,50.2%,9m
16133,3,morph,3005,1539,333,321,654,50.9%,5m
16133,2,[GHFZ]GHFKeKine,3005,1528,118,112,230,51.3%,12m
16133,1,[RØFNEX]Gjerdebu,3005,1647,73,65,138,52.9%,8m
16133,1,danyalcoy,3005,1512,67,73,140,47.9%,8m
16133,1,Kussi,3005,938,37,34,71,52.1%,30m
16133,2,Emily,3005,385,17,11,28,60.7%,2m
16133,2,[loxi]Kurad,3005,350,14,5,19,73.7%,13m
16133,1,[T00D]Wittner,3005,353,14,11,25,56.0%,19m
16133,2,jjjj,3005,168,9,6,15,60.0%,19m
16133,1,HerojaK,3005,264,7,11,18,38.9%,13m
16133,2,Bob,3005,102,5,2,7,71.4%,14m
16133,2,Jimmy,3005,0,3,2,5,60.0%,7m
16133,1,[Yame]Froban,3005,38,2,5,7,28.6%,10m
16133,2,[DoPAde]Gabbagooba,3005,0,1,0,1,100.0%,16m
16133,1,DqkTh,3005,0,1,0,1,100.0%,1h
16133,2,KemoK,3005,0,1,0,1,100.0%,5m
16133,1,[iSAR]Argos,3005,0,1,1,2,50.0%,12m
16133,2,[Kablah]Forgeur,3005,0,0,1,1,0.0%,18m
16133,2,WoLveRiNe,3005,0,0,1,1,0.0%,13m
16133,1,BAKABobydody,3005,0,0,1,1,0.0%,1h
16154,3,andvar,3004,893,222,221,443,50.1%,31m
16154,2,sasisa,3004,1275,98,83,181,54.1%,14m
16154,2,Fox,3004,611,45,35,80,56.2%,5m
16154,1,[SOECES]BridoKiLLeR,3004,702,23,24,47,48.9%,4m
16154,2,kevin,3004,211,10,4,14,71.4%,1h
16154,1,Steelseer,3004,240,8,12,20,40.0%,8m
16154,2,[Petrиs]IIIIIIIIIIII,3004,146,6,3,9,66.7%,12m
16154,2,AspenCat,3004,195,5,5,10,50.0%,3m
16154,1,Zieziór,3004,96,4,2,6,66.7%,54m
16154,1,ZERIC,3004,108,4,6,10,40.0%,12m
16154,3,krik,3004,90,4,10,14,28.6%,18m
16154,2,TheStickyBun,3004,0,3,2,5,60.0%,14m
16154,1,Kalachick,3004,150,3,5,8,37.5%,12m
16154,1,Dimon,3004,48,2,3,5,40.0%,1h
16154,1,Maniolo,3004,46,2,4,6,33.3%,13m
16154,2,[OwOOwO]Krishn,3004,0,1,0,1,100.0%,18m
16154,2,TheKondzio,3004,30,1,1,2,50.0%,10m
16154,2,southwave,3004,0,1,3,4,25.0%,6m
16154,2,Slowpoke,3004,34,1,4,5,20.0%,12m
16154,2,[Hаsu]BiHiTRiLL,3004,0,0,1,1,0.0%,4m
16154,1,dreaded,3004,0,0,5,5,0.0%,30m
16175,1,[Mañas]Priapismo,3003,1685,283,271,554,51.1%,13m
16175,2,FlyingFish,3003,1625,218,199,417,52.3%,13m
16175,1,[EV0C]santino,3003,1641,195,190,385,50.6%,14m
16175,2,raven,3003,999,114,106,220,51.8%,15m
16175,1,Dreamer,3003,1355,95,78,173,54.9%,5m
16175,2,[RTD]PoL,3003,1364,65,47,112,58.0%,19m
16175,2,Spleanedo,3003,858,64,51,115,55.7%,19m
16175,3,Reiswind,3003,1113,55,61,116,47.4%,14m
16175,1,[MADLNK]GusGus,3003,970,37,39,76,48.7%,30m
16175,3,iamUnique,3003,917,34,40,74,45.9%,17m
16175,1,Cheval,3003,231,29,20,49,59.2%,8m
16175,2,Frosty,3003,714,26,25,51,51.0%,15m
16175,1,Sergio,3003,448,17,14,31,54.8%,7m
16175,2,HarleyQuinn,3003,219,8,7,15,53.3%,16m
16175,2,JaLlen,3003,140,6,3,9,66.7%,10m
16175,1,sasha,3003,186,6,9,15,40.0%,12m
16175,2,Antmez,3003,90,4,2,6,66.7%,18m
16175,2,JoeBane,3003,30,2,0,2,100.0%,19m
16175,2,[NiGR]Yngan,3003,36,1,2,3,33.3%,20m
16175,2,Tugarik,3003,30,1,2,3,33.3%,18m
16175,1,Wiedzmin,3003,89,1,3,4,25.0%,9m
16175,2,[JIH]Anomander,3003,0,0,1,1,0.0%,18m
16175,2,MrSmoking,3003,0,0,1,1,0.0%,17m
16175,2,StrangeThing,3003,0,0,1,1,0.0%,10m
16175,2,Rezzes,3003,0,0,2,2,0.0%,5m
16175,1,[YUP]UPsetUP,3003,0,0,6,6,0.0%,11m
16201,3,[EESC]ViDi,3002,1192,76,82,158,48.1%,13m
16201,2,[Batmen]PongLenis,3002,1021,75,71,146,51.4%,7m
16201,2,GameBross,3002,560,64,38,102,62.7%,21m
16201,3,LiquidZerg,3002,1159,58,66,124,46.8%,4m
16201,1,[Gøsu]ĐiamondĐrop,3002,703,35,16,51,68.6%,13m
16201,1,[ČUMPR]Vule,3002,690,27,23,50,54.0%,4m
16201,2,crazySocket,3002,576,20,21,41,48.8%,3m
16201,1,Mopsinator,3002,500,16,18,34,47.1%,30m
16201,1,[DODU]LimeJuicy,3002,0,5,1,6,83.3%,21m
16201,1,Gazdurabal,3002,131,5,3,8,62.5%,14m
16201,2,dernippels,3002,88,4,0,4,100.0%,14m
16201,2,dominion,3002,88,4,2,6,66.7%,11m
16201,2,Adrientoub,3002,114,4,4,8,50.0%,4m
16201,1,[PLANgg]Venator,3002,144,3,5,8,37.5%,53m
16201,1,sadkillah,3002,145,2,2,4,50.0%,7m
16201,2,kronkh,3002,30,1,1,2,50.0%,3m
16201,2,[Z3RGML]anRAGE,3002,44,1,5,6,16.7%,57m
16201,2,Stepback,3002,0,0,1,1,0.0%,15m
16201,2,BoumBoMagic,3002,0,0,1,1,0.0%,15m
16201,1,[Petrиs]aNOOBis,3002,0,0,1,1,0.0%,1h
16201,2,[OÐ]porromaster,3002,0,0,1,1,0.0%,31m
16201,2,HOGU,3002,0,0,1,1,0.0%,18m
16201,2,Veryhard,3002,0,0,1,1,0.0%,5m
16201,2,ZeroNimo,3002,0,0,2,2,0.0%,31m
16225,2,Vladimir,3001,1418,91,71,162,56.2%,12m
16225,2,tomcox,3001,1409,88,63,151,58.3%,8m
16225,1,eeleel,3001,1447,73,64,137,53.3%,4m
16225,2,LBFRAN,3001,1341,72,48,120,60.0%,9m
16225,2,Sammy,3001,1295,72,60,132,54.5%,7m
16225,1,vanoval,3001,1342,52,49,101,51.5%,4m
16225,1,JeRRy,3001,1002,39,37,76,51.3%,10m
16225,1,Lis,3001,685,32,30,62,51.6%,12m
16225,1,Troddler,3001,518,24,16,40,60.0%,17m
16225,3,Tgouned,3001,685,24,32,56,42.9%,12m
16225,1,Postman,3001,650,22,25,47,46.8%,9m
16225,1,Musan,3001,523,21,19,40,52.5%,5m
16225,3,MegaTeran,3001,267,11,11,22,50.0%,17m
16225,3,kamiGami,3001,246,9,3,12,75.0%,19m
16225,1,NightShade,3001,185,9,6,15,60.0%,19m
16225,1,[LtH]Utrotad,3001,246,7,8,15,46.7%,6m
16225,3,[BRSKR]Kuro,3001,220,6,3,9,66.7%,1h
16225,2,gggg,3001,50,4,4,8,50.0%,5m
16225,2,Пакувыцо,3001,90,3,3,6,50.0%,10m
16225,2,WhiteRa,3001,90,3,6,9,33.3%,5m
16225,1,[U20]hati,3001,101,3,9,12,25.0%,19m
16246,2,chuckyto,3000,1611,251,241,492,51.0%,19m
16246,3,Taogamer,3000,1386,239,233,472,50.6%,5m
16246,1,Argy,3000,1622,139,129,268,51.9%,13m
16246,2,[EasycH]bajanizd,3000,500,82,64,146,56.2%,4m
16246,1,[xNGSx]Rasputin,3000,1633,78,70,148,52.7%,14m
16246,1,ZakHooi,3000,1424,58,57,115,50.4%,30m
16246,1,[AgnG]LightRider,3000,746,32,26,58,55.2%,15m
16246,2,[MP1]JackieMIF,3000,658,24,21,45,53.3%,11m
16246,2,Юльчик,3000,376,14,12,26,53.8%,15m
16246,1,CrazyLiv,3000,338,11,10,21,52.4%,29m
16246,2,[PFrusH]Jacke,3000,237,10,3,13,76.9%,7m
16246,2,GreatToss,3000,267,10,8,18,55.6%,7m
16246,1,Keindsar,3000,320,10,16,26,38.5%,5m
16246,3,ennui,3000,300,10,20,30,33.3%,15m
16246,2,Cloud,3000,236,9,3,12,75.0%,17m
16246,1,TraNcEAnD,3000,166,8,5,13,61.5%,19m
16246,2,KaVa,3000,154,6,4,10,60.0%,4m
16246,1,[ADLC]mmoZ,3000,220,6,6,12,50.0%,1h
16246,2,[MBPG]IAMK,3000,182,6,7,13,46.2%,7m
16246,2,harU,3000,88,4,2,6,66.7%,13m
16246,2,[ImpeRL]yoshiro,3000,0,3,2,5,60.0%,18m
16246,3,Naamar,3000,95,2,1,3,66.7%,15m
16246,2,Shorken,3000,60,2,1,3,66.7%,12m
16246,2,CoopeySlona,3000,30,2,3,5,40.0%,3m
16246,2,MooseMan,3000,62,2,5,7,28.6%,10m
16246,2,UchMaNiA,3000,0,1,0,1,100.0%,17m
16246,1,Saze,3000,0,1,0,1,100.0%,54m
16246,2,RULIGUN,3000,0,1,1,2,50.0%,6m
16246,2,[K0RM2]DoKToR,3000,30,1,3,4,25.0%,15m
16246,2,Martishow,3000,0,0,2,2,0.0%,17m
16246,2,[KaaTri]TriX,3000,0,0,2,2,0.0%,1h
16277,1,Jarathor,2999,1670,353,353,706,50.0%,12m
16277,1,[SunGmr]eatmybro,2999,1382,296,285,581,50.9%,10m
16277,2,tim,2999,1630,118,105,223,52.9%,13m
16277,1,Paradise,2999,1499,56,59,115,48.7%,21m
16277,1,ImperiusWZRD,2999,1428,51,52,103,49.5%,21m
16277,1,Stalky,2999,1097,39,37,76,51.3%,30m
16277,2,SMA,2999,508,23,16,39,59.0%,11m
16277,1,[TAW]DuX,2999,645,21,23,44,47.7%,18m
16277,2,mybidisbig,2999,452,18,16,34,52.9%,5m
16277,1,Swiftdeath,2999,362,17,11,28,60.7%,3m
16277,1,Destrack,2999,322,14,11,25,56.0%,12m
16277,2,grushan,2999,228,8,5,13,61.5%,3m
16277,2,[IIE]Panzerr,2999,167,7,5,12,58.3%,5m
16277,3,Cendrac,2999,145,5,4,9,55.6%,1h
16277,1,DustZion,2999,192,5,10,15,33.3%,30m
16277,3,[Yakuza]JuZdOiT,2999,117,3,2,5,60.0%,3m
16277,2,[CAMW]Sandr,2999,60,3,2,5,60.0%,32m
16277,2,Spook,2999,60,3,2,5,60.0%,18m
16277,2,Draze,2999,42,3,4,7,42.9%,18m
16277,2,luk,2999,58,2,1,3,66.7%,13m
16277,2,check,2999,30,2,2,4,50.0%,10m
16277,2,[ULTX]Moritz,2999,60,2,2,4,50.0%,3m
16277,2,[SwiPP]Virus,2999,0,1,0,1,100.0%,10m
16277,1,Demoneus,2999,36,1,5,6,16.7%,8m
16277,2,Nudo,2999,0,0,1,1,0.0%,10m
16277,1,NateRiver,2999,0,0,3,3,0.0%,29m
16303,2,Trizet,2998,1322,235,208,443,53.0%,19m
16303,3,AtahualpA,2998,1354,200,203,403,49.6%,10m
16303,2,Index,2998,1308,115,87,202,56.9%,7m
16303,1,Malus,2998,1540,93,91,184,50.5%,10m
16303,2,IAtaman,2998,1603,71,59,130,54.6%,10m
16303,1,Zergling,2998,785,24,26,50,48.0%,30m
16303,2,[NDrT]Lelutin,2998,475,20,15,35,57.1%,10m
16303,3,Sugafor,2998,0,19,33,52,36.5%,4m
16303,2,zEN,2998,266,10,7,17,58.8%,13m
16303,2,SaRTeK,2998,210,7,3,10,70.0%,30m
16303,2,SBLI,2998,216,7,3,10,70.0%,3m
16303,1,[EmŦ]ArchangelLaw,2998,157,7,4,11,63.6%,15m
16303,1,SiKe,2998,225,7,7,14,50.0%,10m
16303,1,Bucher,2998,226,7,10,17,41.2%,15m
16303,2,Maximach,2998,172,6,7,13,46.2%,18m
16303,2,[SwSII]Meepo,2998,164,4,4,8,50.0%,1h
16303,1,alanmortier,2998,48,3,4,7,42.9%,16m
16303,2,Etern,2998,94,3,6,9,33.3%,15m
16303,1,[Mitya]adsumus,2998,100,3,8,11,27.3%,4m
16303,2,ARTORIAS,2998,30,2,0,2,100.0%,31m
16303,2,Henry,2998,30,2,0,2,100.0%,12m
16303,3,zhaar,2998,42,2,2,4,50.0%,1h
16303,2,[synTWD]Quartazar,2998,0,1,0,1,100.0%,5m
16303,1,[KTQ]Raynor,2998,0,1,0,1,100.0%,21m
16303,2,[MNSI]Lolan,2998,0,1,0,1,100.0%,3m
16303,1,Spiro,2998,0,1,0,1,100.0%,19m
16303,2,Redfild,2998,0,1,0,1,100.0%,9m
16303,2,TaNaToS,2998,0,1,0,1,100.0%,3m
16303,2,Barada,2998,30,1,2,3,33.3%,31m
16303,2,Simply,2998,0,0,2,2,0.0%,10m
16333,3,zibobabulo,2997,1493,239,239,478,50.0%,7m
16333,3,Zizou,2997,1515,239,249,488,49.0%,11m
16333,1,Mortarium,2997,1390,168,153,321,52.3%,17m
16333,3,Zordon,2997,1542,123,119,242,50.8%,5m
16333,3,Eclectik,2997,1017,93,117,210,44.3%,17m
16333,2,Tonimon,2997,1331,63,64,127,49.6%,2m
16333,2,ANTIGAN,2997,1384,54,51,105,51.4%,7m
16333,1,jojohnny,2997,1083,43,34,77,55.8%,8m
16333,1,[TaqT]Aadera,2997,749,34,39,73,46.6%,13m
16333,2,[KlMCHl]Vidamos,2997,594,31,25,56,55.4%,9m
16333,1,Rhohelix,2997,208,10,6,16,62.5%,10m
16333,2,ThaDeka,2997,232,8,7,15,53.3%,9m
16333,2,Cavador,2997,60,4,5,9,44.4%,17m
16333,2,[TheRPW]DarylTWD,2997,60,3,0,3,100.0%,18m
16333,1,Andy,2997,0,3,1,4,75.0%,13m
16333,3,UncleRoger,2997,145,3,4,7,42.9%,1h
16333,2,[530]jempierogi,2997,58,2,2,4,50.0%,21m
16333,3,[WADER]LittleDiablo,2997,36,2,2,4,50.0%,4m
16333,2,SMoRoZKo,2997,60,2,3,5,40.0%,3m
16333,1,Raiken,2997,80,2,7,9,22.2%,13m
16333,2,KonyBeton,2997,0,1,1,2,50.0%,53m
16333,2,gayver,2997,0,0,1,1,0.0%,7m
16333,2,BravoRagazzo,2997,0,0,1,1,0.0%,7m
16333,1,[I6s]Rob,2997,0,0,1,1,0.0%,45m
16333,2,[VanSyo]IIIIIIIIIIII,2997,0,0,1,1,0.0%,31m
16333,2,WESe,2997,0,0,3,3,0.0%,6m
16359,1,Bubu,2996,1671,143,128,271,52.8%,21m
16359,1,TheMachine,2996,1513,137,115,252,54.4%,30m
16359,1,Ogosa,2996,1172,66,63,129,51.2%,12m
16359,1,[usbr]Broformist,2996,1508,63,55,118,53.4%,6m
16359,3,SirCreeX,2996,1476,60,69,129,46.5%,21m
16359,1,Bufftin,2996,415,30,31,61,49.2%,6m
16359,1,raffael,2996,555,21,19,40,52.5%,17m
16359,1,Hectorion,2996,532,16,22,38,42.1%,17m
16359,1,Bee,2996,427,15,13,28,53.6%,3m
16359,1,FeldJäger,2996,464,14,20,34,41.2%,19m
16359,2,timi,2996,308,11,10,21,52.4%,31m
16359,2,[UTIL]Epsy,2996,124,5,6,11,45.5%,18m
16359,2,DonMatteo,2996,0,4,1,5,80.0%,14m
16359,1,Shiv,2996,0,4,2,6,66.7%,1h
16359,2,serral,2996,30,4,3,7,57.1%,7m
16359,2,[BRSKR]Fishy,2996,58,3,2,5,60.0%,6m
16359,2,[unƊeaƊ]jeanjean,2996,58,2,1,3,66.7%,9m
16359,2,[TSTG]RBking,2996,30,2,3,5,40.0%,5m
16359,2,Kamikaze,2996,62,2,4,6,33.3%,15m
16359,2,[Leake]MurlocJoe,2996,62,2,5,7,28.6%,3m
16359,2,neper,2996,114,2,6,8,25.0%,13m
16359,3,iLikeTea,2996,0,1,0,1,100.0%,54m
16359,2,Kaygik,2996,0,1,0,1,100.0%,15m
16359,2,Groot,2996,30,1,2,3,33.3%,13m
16359,2,Koteikozilla,2996,38,1,3,4,25.0%,13m
16359,2,[QaDo]GeloPerk,2996,30,1,5,6,16.7%,5m
16359,1,Vikus,2996,0,0,2,2,0.0%,1h
16386,3,Rafiki,2995,1147,47,45,92,51.1%,6m
16386,1,avey,2995,1084,39,41,80,48.8%,19m
16386,1,Chameleon,2995,452,25,21,46,54.3%,19m
16386,2,[ProveK]ЁбенБобен,2995,512,21,12,33,63.6%,3m
16386,3,[13NRV]Fear,2995,425,14,21,35,40.0%,19m
16386,3,Ago,2995,301,13,11,24,54.2%,17m
16386,2,BeterThatTea,2995,210,9,6,15,60.0%,32m
16386,2,Raymond,2995,257,9,9,18,50.0%,10m
16386,1,Sputnik,2995,262,9,12,21,42.9%,9m
16386,2,[пепега]suchAKrab,2995,226,8,8,16,50.0%,11m
16386,1,Tigereye,2995,216,7,7,14,50.0%,8m
16386,2,YNSDA,2995,0,3,2,5,60.0%,13m
16386,2,[DIYX]Septar,2995,0,3,2,5,60.0%,32m
16386,2,Paru,2995,90,3,5,8,37.5%,30m
16386,2,bluetears,2995,32,2,0,2,100.0%,19m
16386,2,Punisher,2995,0,2,4,6,33.3%,58m
16386,2,[webcam]nesthead,2995,44,2,9,11,18.2%,50m
16386,2,Krodin,2995,32,1,3,4,25.0%,14m
16386,2,[NaNii]zozolezebre,2995,0,0,1,1,0.0%,17m
16386,2,[FuCd]Mallyx,2995,0,0,1,1,0.0%,5m
16386,2,Polly,2995,0,0,2,2,0.0%,18m
16386,2,AnCiEnT,2995,0,0,2,2,0.0%,6m
16386,2,maleo,2995,0,0,3,3,0.0%,3m
16409,1,Intrc,2994,1646,240,220,460,52.2%,16m
16409,1,baldingmonke,2994,425,34,35,69,49.3%,30m
16409,2,[KrnBrs]Волшебник,2994,600,27,12,39,69.2%,7m
16409,2,[Dnina]ТорбенДаллос,2994,574,21,21,42,50.0%,7m
16409,3,Alex,2994,454,15,32,47,31.9%,30m
16409,2,[SMRMD]phisox,2994,336,14,5,19,73.7%,3m
16409,1,Theosx,2994,334,13,12,25,52.0%,19m
16409,1,Executioner,2994,195,9,7,16,56.2%,5m
16409,2,mati,2994,203,9,7,16,56.2%,58m
16409,1,millemille,2994,284,8,16,24,33.3%,30m
16409,2,[LickIT]Beobaka,2994,142,6,3,9,66.7%,31m
16409,2,VoidAbyss,2994,138,5,3,8,62.5%,20m
16409,2,Barbosser,2994,184,5,4,9,55.6%,17m
16409,1,Highmage,2994,0,4,1,5,80.0%,20m
16409,1,Handsome,2994,0,3,2,5,60.0%,1h
16409,2,GetRekt,2994,0,0,1,1,0.0%,7m
16409,2,WeedZ,2994,0,0,1,1,0.0%,12m
16409,2,Ddog,2994,0,0,3,3,0.0%,7m
16427,2,Prototype,2993,1623,169,154,323,52.3%,5m
16427,1,NinoFindlay,2993,1642,65,62,127,51.2%,30m
16427,2,Caduc,2993,1398,53,48,101,52.5%,8m
16427,1,Adrenalin,2993,1214,47,44,91,51.6%,12m
16427,2,Owl,2993,998,41,31,72,56.9%,14m
16427,2,WWWWWWWWWWWW,2993,390,15,12,27,55.6%,7m
16427,1,Mango,2993,336,13,12,25,52.0%,30m
16427,1,[rdfst]breggles,2993,333,12,11,23,52.2%,13m
16427,1,Kajun,2993,216,10,8,18,55.6%,30m
16427,2,МитичКрафтер,2993,202,7,7,14,50.0%,5m
16427,2,Nobody,2993,86,6,4,10,60.0%,17m
16427,1,Tslide,2993,88,5,2,7,71.4%,17m
16427,2,Odioznii,2993,96,5,4,9,55.6%,11m
16427,2,Betonhand,2993,30,2,0,2,100.0%,10m
16427,2,TonyMontana,2993,60,2,2,4,50.0%,9m
16427,2,HolzPirat,2993,32,2,3,5,40.0%,15m
16427,2,[4SALE]Netruner,2993,0,0,2,2,0.0%,14m
16427,2,[rtpc]RIP,2993,0,0,5,5,0.0%,13m
16445,1,[SDRV]ALCOLMAN,2992,1650,392,382,774,50.6%,14m
16445,1,gaaaaaaaaaaa,2992,1053,79,84,163,48.5%,9m
16445,2,NooblandWood,2992,1060,41,43,84,48.8%,18m
16445,2,Melrion,2992,1021,40,37,77,51.9%,20m
16445,2,[Kapt]Fery,2992,186,6,5,11,54.5%,1h
16445,1,[wedown]BloodySmoker,2992,97,5,1,6,83.3%,56m
16445,2,[F0B]snowFOX,2992,128,5,6,11,45.5%,32m
16445,2,[AKD2]XetroX,2992,0,4,1,5,80.0%,10m
16445,2,[EXGA]Toppa,2992,146,4,3,7,57.1%,18m
16445,2,ChipRR,2992,90,4,6,10,40.0%,8m
16445,1,Threatter,2992,96,3,1,4,75.0%,4m
16445,1,TitanTase,2992,137,3,8,11,27.3%,7m
16445,2,[GTM]Hobgobbi,2992,32,2,0,2,100.0%,9m
16445,2,DuPrix,2992,0,1,0,1,100.0%,10m
16445,2,Foad,2992,0,1,0,1,100.0%,15m
16445,2,Sleizer,2992,0,1,0,1,100.0%,11m
16445,2,DMZ,2992,30,1,2,3,33.3%,3m
16445,2,gvarok,2992,30,1,2,3,33.3%,15m
16445,2,[G52]Tigos,2992,32,1,4,5,20.0%,9m
16445,2,AsaLiaH,2992,0,0,1,1,0.0%,13m
16445,1,Zockerbabba,2992,0,0,1,1,0.0%,12m
16466,3,[SРID]IIIIIIIIIII,2991,1578,942,946,1888,49.9%,6m
16466,1,NSQ,2991,763,104,100,204,51.0%,21m
16466,2,MaxPower,2991,720,62,37,99,62.6%,9m
16466,2,[AiRǂ]Biscibasci,2991,1328,57,46,103,55.3%,15m
16466,2,OpTu,2991,1054,41,39,80,51.2%,10m
16466,2,MindBlues,2991,816,30,31,61,49.2%,7m
16466,2,[Р321]komander,2991,272,25,9,34,73.5%,7m
16466,1,[PaP1]BapS,2991,618,24,22,46,52.2%,21m
16466,1,ToonWhip,2991,467,20,16,36,55.6%,17m
16466,3,[bаd]soBADgirl,2991,309,14,70,84,16.7%,32m
16466,2,[Lowko]Pavonis,2991,214,8,8,16,50.0%,3m
16466,1,[Tibre]elkillogamer,2991,0,3,2,5,60.0%,15m
16466,2,Kingslayer,2991,32,2,4,6,33.3%,32m
16466,3,BadMazaFaka,2991,97,1,1,2,50.0%,19m
16466,2,Galileo,2991,30,1,3,4,25.0%,9m
16466,2,[yeiba]Taximan,2991,0,0,1,1,0.0%,15m
16466,2,[GhFr]iGIVcz,2991,0,0,1,1,0.0%,6m
16466,2,Mirtos,2991,0,0,1,1,0.0%,57m
16466,2,aandre,2991,0,0,2,2,0.0%,15m
16466,2,[FAZE69]WøŁf,2991,0,0,3,3,0.0%,10m
16466,1,WakaTRAP,2991,0,0,8,8,0.0%,13m
16487,1,MOHA,2990,1534,218,210,428,50.9%,30m
16487,3,DZSODZSO,2990,1322,118,122,240,49.2%,6m
16487,3,ionas,2990,488,116,110,226,51.3%,4m
16487,1,ZeUs,2990,1297,87,85,172,50.6%,12m
16487,1,eagle,2990,451,71,66,137,51.8%,15m
16487,1,LikeDevil,2990,567,60,61,121,49.6%,7m
16487,1,tokoinho,2990,692,27,22,49,55.1%,10m
16487,1,[BYOS]Phobos,2990,233,20,16,36,55.6%,9m
16487,1,Pixu,2990,517,17,18,35,48.6%,12m
16487,2,Муландир,2990,354,15,6,21,71.4%,17m
16487,2,IRONHIDE,2990,250,10,7,17,58.8%,11m
16487,2,NaOH,2990,167,9,10,19,47.4%,5m
16487,2,BadSolution,2990,191,8,8,16,50.0%,14m
16487,3,Rzhondkovsky,2990,118,7,3,10,70.0%,1h
16487,3,Shadow,2990,121,5,4,9,55.6%,4m
16487,2,[Brra]Chachou,2990,174,5,6,11,45.5%,14m
16487,2,[INAE]Danatic,2990,66,2,3,5,40.0%,15m
16487,2,AlejandroXXI,2990,58,2,4,6,33.3%,12m
16487,2,[FMDRS]Krube,2990,0,1,0,1,100.0%,9m
16487,2,HarryMudd,2990,0,1,0,1,100.0%,13m
16487,2,Striker,2990,30,1,1,2,50.0%,10m
16487,2,keavan,2990,0,0,2,2,0.0%,7m
16509,1,iBlagg,2989,547,49,55,104,47.1%,16m
16509,2,[АDMIN]LFIS,2989,950,36,33,69,52.2%,21m
16509,1,[NigTer]AlexdjEP,2989,583,24,26,50,48.0%,18m
16509,3,[MHACKS]Fenris,2989,646,22,31,53,41.5%,21m
16509,2,[SonAsg]Alpha,2989,578,21,24,45,46.7%,6m
16509,1,Bender,2989,464,20,25,45,44.4%,16m
16509,1,Балбес,2989,428,17,14,31,54.8%,10m
16509,2,[NaNii]Balrog,2989,255,11,6,17,64.7%,3m
16509,2,[Mattis]SameBoy,2989,232,7,5,12,58.3%,13m
16509,2,Amun,2989,115,5,3,8,62.5%,7m
16509,1,Niczek,2989,0,3,2,5,60.0%,1h
16509,1,[Дядя]Chayn,2989,152,3,6,9,33.3%,4m
16509,2,Kubovich,2989,30,2,1,3,66.7%,18m
16509,3,rakeyrakey,2989,0,1,0,1,100.0%,60m
16509,3,Magthepon,2989,97,1,2,3,33.3%,1h
16509,2,KlimenToS,2989,0,0,1,1,0.0%,9m
16525,2,GHOST,2988,1563,189,177,366,51.6%,32m
16525,1,[DZTK]Otti,2988,1459,93,93,186,50.0%,17m
16525,1,Freish,2988,661,90,48,138,65.2%,10m
16525,1,SypnijZwirem,2988,1678,85,83,168,50.6%,32m
16525,1,BICHO,2988,1093,59,59,118,50.0%,15m
16525,1,Overlord,2988,1283,52,50,102,51.0%,21m
16525,2,[zouave]Niethalf,2988,1228,50,41,91,54.9%,7m
16525,1,[DZ16]PREDATOR,2988,1291,44,52,96,45.8%,6m
16525,2,steve,2988,479,39,29,68,57.4%,18m
16525,1,[WАSD]fyrgood,2988,849,34,32,66,51.5%,21m
16525,2,PistolStar,2988,731,31,26,57,54.4%,13m
16525,2,Ragnar,2988,569,23,22,45,51.1%,7m
16525,2,Sileark,2988,448,19,8,27,70.4%,17m
16525,2,Murash,2988,474,18,13,31,58.1%,11m
16525,2,beastmaster,2988,416,17,13,30,56.7%,3m
16525,2,[ORteam]sorkingstar,2988,208,14,13,27,51.9%,21m
16525,1,handyman,2988,400,11,15,26,42.3%,5m
16525,2,[Heroes]PaxAeterna,2988,251,9,4,13,69.2%,7m
16525,2,GreyFox,2988,256,9,10,19,47.4%,7m
16525,1,gerard,2988,302,9,17,26,34.6%,9m
16525,3,Polipastman,2988,188,8,9,17,47.1%,19m
16525,2,[SGTA]Dodo,2988,162,4,2,6,66.7%,10m
16525,2,GregLepkie,2988,62,3,4,7,42.9%,6m
16525,2,beastyq,2988,30,1,2,3,33.3%,15m
16549,1,OckhamsRazor,2987,1653,430,407,837,51.4%,15m
16549,2,Skip,2987,1636,143,135,278,51.4%,14m
16549,1,citron,2987,1667,133,132,265,50.2%,6m
16549,1,axe,2987,1360,94,87,181,51.9%,20m
16549,1,ImbaTer,2987,1327,87,90,177,49.2%,5m
16549,2,Haimovich,2987,1099,51,52,103,49.5%,7m
16549,1,[lOoOl]HerBorisT,2987,1198,48,52,100,48.0%,9m
16549,2,[RedFmm]REDDEVIL,2987,813,32,36,68,47.1%,15m
16549,2,Cocycle,2987,698,30,26,56,53.6%,10m
16549,1,CCR,2987,806,28,27,55,50.9%,19m
16549,2,[TheER]Samix,2987,644,27,21,48,56.2%,10m
16549,1,Зверь,2987,695,26,26,52,50.0%,30m
16549,2,pesteralex,2987,439,18,10,28,64.3%,14m
16549,2,[QTcIub]LakiSRB,2987,191,8,0,8,100.0%,13m
16549,2,Spenouh,2987,180,7,10,17,41.2%,21m
16549,1,Futere,2987,148,5,5,10,50.0%,44m
16549,1,Monster,2987,156,5,10,15,33.3%,13m
16549,1,[ZЕRGТV]DennyFox,2987,97,4,2,6,66.7%,57m
16549,1,imbereinheit,2987,0,3,2,5,60.0%,9m
16549,2,[Tits]SkyRazznet,2987,62,3,4,7,42.9%,10m
16549,2,Nowliei,2987,60,2,2,4,50.0%,6m
16549,2,Conq,2987,0,2,3,5,40.0%,10m
16549,2,Pitfall,2987,30,1,2,3,33.3%,3m
16549,2,SCTitan,2987,0,1,3,4,25.0%,21m
16549,2,[Hаsu]Chipcilinkaa,2987,30,1,3,4,25.0%,10m
16549,2,[TROPBG]arlam,2987,0,0,1,1,0.0%,18m
16549,2,Jaden,2987,0,0,2,2,0.0%,10m
16576,1,ALEX,2986,1642,385,385,770,50.0%,15m
16576,2,Webghost,2986,1587,190,165,355,53.5%,7m
16576,1,Juhku,2986,1569,74,84,158,46.8%,14m
16576,2,ISanych,2986,1199,50,42,92,54.3%,6m
16576,2,sznycel,2986,983,41,32,73,56.2%,8m
16576,3,Piotr,2986,850,39,48,87,44.8%,11m
16576,2,elKato,2986,503,20,14,34,58.8%,14m
16576,1,peet,2986,318,17,13,30,56.7%,16m
16576,1,[FloPo]Estler,2986,384,14,14,28,50.0%,14m
16576,1,RedEyeDragon,2986,332,11,10,21,52.4%,30m
16576,1,zirko,2986,253,10,7,17,58.8%,4m
16576,3,JonnyZi,2986,217,8,6,14,57.1%,50m
16576,2,Numinex,2986,213,7,3,10,70.0%,17m
16576,2,Oevlen,2986,230,7,9,16,43.8%,52m
16576,1,medmed,2986,133,5,3,8,62.5%,3m
16576,3,[NHNL]Mazurik,2986,148,5,6,11,45.5%,1h
16576,2,argeitqu,2986,118,4,4,8,50.0%,3m
16576,3,Tritol,2986,173,4,4,8,50.0%,22m
16576,2,Gandalf,2986,116,3,0,3,100.0%,19m
16576,1,TitusPullo,2986,48,2,0,2,100.0%,9m
16576,2,oDogg,2986,58,2,2,4,50.0%,3m
16576,2,[WCKYLN]SeppSaft,2986,30,2,3,5,40.0%,10m
16576,2,[Ultrа]popochka,2986,0,2,3,5,40.0%,6m
16576,2,[DKLE]Stoei,2986,58,2,4,6,33.3%,32m
16576,2,Terry,2986,30,1,1,2,50.0%,10m
16576,2,Mokuke,2986,0,1,4,5,20.0%,13m
16576,2,[GoldM]PigeonWrench,2986,0,0,1,1,0.0%,16m
16603,3,MJSA,2985,1457,210,197,407,51.6%,9m
16603,1,[TheDOH]NoTBaD,2985,1236,179,174,353,50.7%,21m
16603,1,Grunthor,2985,1273,50,45,95,52.6%,18m
16603,1,exeQter,2985,913,46,39,85,54.1%,18m
16603,1,Genthz,2985,749,26,25,51,51.0%,30m
16603,1,nSlPindle,2985,548,24,33,57,42.1%,7m
16603,1,Eaty,2985,612,20,23,43,46.5%,11m
16603,1,Moha,2985,411,16,22,38,42.1%,5m
16603,1,NsevenN,2985,504,16,25,41,39.0%,20m
16603,2,OkizéM,2985,312,13,9,22,59.1%,7m
16603,1,XxMOBABOxX,2985,341,11,13,24,45.8%,21m
16603,2,mememan,2985,247,10,7,17,58.8%,50m
16603,1,[PTTO]network,2985,274,7,11,18,38.9%,14m
16603,3,VauVau,2985,121,5,4,9,55.6%,55m
16603,1,Agony,2985,192,5,9,14,35.7%,57m
16603,2,Rohlik,2985,0,3,2,5,60.0%,8m
16603,2,Сталин,2985,117,2,2,4,50.0%,6m
16603,2,[JaH]DjouLo,2985,0,1,0,1,100.0%,13m
16603,2,blzz,2985,0,1,1,2,50.0%,30m
16603,3,Izzard,2985,0,0,1,1,0.0%,45m
16603,1,mKw,2985,0,0,1,1,0.0%,18m
16603,2,[Heel]derBimbo,2985,0,0,1,1,0.0%,3m
16603,2,Yagelon,2985,0,0,2,2,0.0%,14m
16603,2,Caracalla,2985,0,0,2,2,0.0%,14m
16627,1,CTPAX,2984,1405,151,155,306,49.3%,21m
16627,1,oIIOIIOIIo,2984,983,129,120,249,51.8%,30m
16627,3,[ULTX]FeuerDrache,2984,1400,70,70,140,50.0%,8m
16627,2,BtWChan,2984,674,40,18,58,69.0%,13m
16627,2,MicroORMacro,2984,620,31,26,57,54.4%,10m
16627,2,EZFHO,2984,780,30,28,58,51.7%,3m
16627,2,DinozavrOB,2984,678,28,20,48,58.3%,6m
16627,2,Demi,2984,442,17,17,34,50.0%,17m
16627,3,Heaven,2984,275,14,10,24,58.3%,5m
16627,2,Rednoir,2984,322,11,14,25,44.0%,9m
16627,2,[SonGa]AntuBAnd,2984,248,10,5,15,66.7%,5m
16627,2,Yōkai,2984,230,8,9,17,47.1%,18m
16627,2,[khalas]Radovan,2984,214,7,8,15,46.7%,3m
16627,2,[GGGLHF]fxprochess,2984,146,6,8,14,42.9%,3m
16627,1,PrayForRay,2984,0,4,1,5,80.0%,11m
16627,2,MatsLennarth,2984,88,4,2,6,66.7%,14m
16627,2,hanbing,2984,30,2,2,4,50.0%,13m
16627,1,[DТ]Topa,2984,80,2,11,13,15.4%,17m
16627,2,Gree,2984,0,0,1,1,0.0%,20m
16627,1,Ranafein,2984,0,0,1,1,0.0%,13m
16627,2,zorkapa,2984,0,0,1,1,0.0%,18m
16627,2,DCP,2984,0,0,2,2,0.0%,12m
16627,2,ElDhoine,2984,0,0,2,2,0.0%,32m
16650,2,krapula,2983,1012,194,188,382,50.8%,6m
16650,1,SinGe,2983,1439,190,184,374,50.8%,10m
16650,2,[PluS40]freeagent,2983,1586,163,149,312,52.2%,18m
16650,2,Bla,2983,1606,114,96,210,54.3%,10m
16650,2,FoulBazar,2983,1426,104,103,207,50.2%,15m
16650,2,[lBSGl]Maksim,2983,524,103,89,192,53.6%,12m
16650,1,Ghost,2983,1619,71,61,132,53.8%,3m
16650,2,Kira,2983,891,42,34,76,55.3%,12m
16650,1,BrunostVikin,2983,638,30,27,57,52.6%,17m
16650,2,czajna,2983,660,29,26,55,52.7%,6m
16650,2,fùf,2983,406,19,12,31,61.3%,17m
16650,1,MaKC,2983,561,19,20,39,48.7%,13m
16650,1,Misanthrope,2983,510,19,20,39,48.7%,11m
16650,2,Yoghurt,2983,439,17,12,29,58.6%,7m
16650,2,сан,2983,141,14,13,27,51.9%,3m
16650,1,[KTQ]Uskhan,2983,361,14,15,29,48.3%,4m
16650,2,Shinigami,2983,172,10,7,17,58.8%,12m
16650,2,Warfist,2983,204,8,5,13,61.5%,12m
16650,2,SombreroPlz,2983,136,6,4,10,60.0%,12m
16650,1,[MG2K]awelase,2983,131,5,6,11,45.5%,20m
16650,1,Tengan,2983,183,5,11,16,31.2%,3m
16650,2,Dear,2983,0,4,1,5,80.0%,32m
16650,2,[LSKGS]MasterEC,2983,118,4,3,7,57.1%,19m
16650,2,Elissaios,2983,120,4,5,9,44.4%,5m
16650,3,shjOoR,2983,121,3,2,5,60.0%,9m
16650,1,JoseD,2983,0,3,2,5,60.0%,50m
16650,1,[lDl]Lance,2983,160,3,5,8,37.5%,14m
16650,1,Shellby,2983,46,2,0,2,100.0%,1h
16650,2,RedSwarm,2983,0,1,0,1,100.0%,13m
16650,2,[TAW]Alexandria,2983,0,1,2,3,33.3%,6m
16650,2,[0123]pavelo,2983,0,0,1,1,0.0%,12m
16681,2,StuckInBronz,2982,550,35,5,40,87.5%,13m
16681,2,KaoNashi,2982,803,31,28,59,52.5%,32m
16681,2,Corruption,2982,532,21,20,41,51.2%,10m
16681,2,Konvex,2982,464,18,16,34,52.9%,18m
16681,2,[113RUS]IIIIIIIIIIII,2982,152,14,14,28,50.0%,5m
16681,2,morph,2982,340,12,9,21,57.1%,15m
16681,2,Strannik,2982,346,12,15,27,44.4%,9m
16681,2,[Ximic]Mitrofan,2982,252,11,5,16,68.8%,10m
16681,1,DILDON,2982,248,7,9,16,43.8%,30m
16681,1,[PGP]ElSadre,2982,238,7,12,19,36.8%,30m
16681,2,Akaneron,2982,60,3,1,4,75.0%,15m
16681,1,stannie,2982,119,3,2,5,60.0%,12m
16681,2,Oman,2982,0,3,2,5,60.0%,18m
16681,2,IIIIIIIIIIII,2982,0,3,2,5,60.0%,15m
16681,2,Shya,2982,102,2,1,3,66.7%,32m
16681,2,illyasviel,2982,36,2,2,4,50.0%,5m
16681,2,[QTclub]Troggdorr,2982,95,1,1,2,50.0%,15m
16681,2,[ANGELL]paulhus,2982,0,0,2,2,0.0%,20m
16699,2,Oliv,2981,1606,112,105,217,51.6%,7m
16699,3,[TM]Hjersie,2981,1273,99,106,205,48.3%,11m
16699,1,madCenosha,2981,1661,82,80,162,50.6%,4m
16699,1,Bobrakon,2981,764,43,40,83,51.8%,18m
16699,2,[PUTIN]Sidorsp,2981,897,41,33,74,55.4%,4m
16699,1,IIIIIIIIIIII,2981,303,31,18,49,63.3%,13m
16699,2,Alex,2981,460,19,11,30,63.3%,21m
16699,2,Hebbes,2981,326,11,9,20,55.0%,7m
16699,2,Ayuone,2981,213,9,6,15,60.0%,21m
16699,1,FireWall,2981,186,7,5,12,58.3%,4m
16699,2,AiR,2981,174,7,6,13,53.8%,14m
16699,2,[Kurios]ChernoBill,2981,116,7,8,15,46.7%,10m
16699,1,osmi,2981,212,6,12,18,33.3%,16m
16699,2,[NVY]roger,2981,60,3,1,4,75.0%,15m
16699,1,iFlair,2981,0,2,2,4,50.0%,1h
16699,2,[COMMIE]Exolibris,2981,30,2,4,6,33.3%,7m
16699,1,Brocx,2981,0,1,0,1,100.0%,1h
16699,2,[EZPTS]Rizo,2981,0,1,0,1,100.0%,18m
16699,2,Mâlic,2981,0,1,0,1,100.0%,18m
16699,3,benny,2981,97,1,3,4,25.0%,52m
16699,2,IIIIIIIIIIII,2981,0,0,1,1,0.0%,18m
16720,1,[R1917]JohnBrown,2980,1355,282,255,537,52.5%,14m
16720,2,PipandPop,2980,1415,198,193,391,50.6%,21m
16720,1,Lars,2980,1667,153,149,302,50.7%,20m
16720,3,andr,2980,1520,150,155,305,49.2%,7m
16720,2,GastonLagaff,2980,1604,148,150,298,49.7%,16m
16720,1,ClayWaifu,2980,1407,116,114,230,50.4%,9m
16720,2,randomname,2980,1593,101,91,192,52.6%,14m
16720,1,[NoAPM]Lastiko,2980,1616,77,80,157,49.0%,4m
16720,3,[DZTK]Klippenpat,2980,683,72,78,150,48.0%,8m
16720,2,Valsoray,2980,521,38,32,70,54.3%,6m
16720,2,MadScientist,2980,887,36,30,66,54.5%,7m
16720,1,Westeros,2980,966,36,35,71,50.7%,11m
16720,2,Sinfool,2980,844,31,31,62,50.0%,13m
16720,2,[OHLT]Sapper,2980,671,30,24,54,55.6%,14m
16720,2,MayGo,2980,703,26,28,54,48.1%,13m
16720,1,DELOVOI,2980,620,25,20,45,55.6%,9m
16720,2,LightBetStrs,2980,484,24,19,43,55.8%,13m
16720,1,Bouhhhhhh,2980,602,24,20,44,54.5%,31m
16720,1,Glebchik,2980,571,17,20,37,45.9%,14m
16720,2,TaiwanNBOne,2980,252,11,7,18,61.1%,11m
16720,1,Perzival,2980,217,9,1,10,90.0%,9m
16720,2,Doragon,2980,210,7,4,11,63.6%,10m
16720,1,Heronimus,2980,256,7,15,22,31.8%,20m
16720,2,MacroJordan,2980,136,6,4,10,60.0%,9m
16720,2,FoulBazar,2980,138,4,1,5,80.0%,19m
16720,2,Trandi,2980,60,3,2,5,60.0%,12m
16720,2,KoshNaranek,2980,86,3,2,5,60.0%,8m
16720,1,ЛучикиДобра,2980,0,3,2,5,60.0%,1h
16720,2,[JDx]chapi,2980,86,3,3,6,50.0%,17m
16720,3,[StMzF]Leo,2980,96,2,1,3,66.7%,16m
16720,2,TooLazy,2980,0,1,1,2,50.0%,21m
16720,2,[Anlav]Uolupukkie,2980,30,1,1,2,50.0%,7m
16720,2,BeenLaden,2980,0,0,1,1,0.0%,17m
16753,1,Castelo,2979,1460,301,295,596,50.5%,13m
16753,1,Evilive,2979,1622,156,155,311,50.2%,10m
16753,2,METHUSALEM,2979,1319,137,127,264,51.9%,21m
16753,1,Terminal,2979,1501,133,125,258,51.6%,17m
16753,1,BlackBlyat,2979,581,35,34,69,50.7%,17m
16753,3,DrewShow,2979,309,35,41,76,46.1%,6m
16753,2,Bachelor,2979,642,26,16,42,61.9%,3m
16753,2,VonVlakas,2979,328,26,16,42,61.9%,13m
16753,2,PooopTroper,2979,479,24,8,32,75.0%,11m
16753,3,Passion,2979,286,19,27,46,41.3%,3m
16753,2,[NIXXX]PIZZABELLA,2979,268,10,9,19,52.6%,5m
16753,2,Mihawk,2979,206,8,9,17,47.1%,13m
16753,1,[BWArmy]ArrowCombo,2979,212,7,11,18,38.9%,20m
16753,1,Yayo,2979,145,5,3,8,62.5%,55m
16753,3,EndlessDream,2979,190,5,8,13,38.5%,22m
16753,1,[80er]Ravensdark,2979,0,3,2,5,60.0%,19m
16753,1,[Bizim]Thork,2979,100,3,7,10,30.0%,12m
16753,1,sixpool,2979,97,2,2,4,50.0%,60m
16753,2,sayes,2979,0,1,0,1,100.0%,10m
16753,2,wozuiji,2979,0,1,0,1,100.0%,9m
16753,2,Тревор,2979,0,1,0,1,100.0%,17m
16753,1,[L4Bit]Hermes,2979,0,1,4,5,20.0%,16m
16753,2,[xZero]DronDigiDon,2979,0,0,1,1,0.0%,12m
16753,2,LDG,2979,0,0,3,3,0.0%,12m
16753,2,Sweetoos,2979,0,0,4,4,0.0%,7m
16778,1,Robxley,2978,905,79,76,155,51.0%,16m
16778,2,[żubr92]ThorOfHeaven,2978,464,29,12,41,70.7%,21m
16778,2,locb,2978,641,25,19,44,56.8%,12m
16778,2,IrMa,2978,290,17,17,34,50.0%,13m
16778,1,[TRASHD]Anasha,2978,457,15,18,33,45.5%,20m
16778,1,huhu,2978,422,14,16,30,46.7%,10m
16778,1,[DeepT]sanconiglio,2978,320,12,15,27,44.4%,3m
16778,2,Nukezz,2978,87,5,5,10,50.0%,5m
16778,1,SaboteurKing,2978,48,4,3,7,57.1%,1h
16778,2,[OРДА]СТЕЖОК,2978,32,1,1,2,50.0%,18m
16778,2,Strife,2978,0,1,4,5,20.0%,7m
16778,1,Vladivostok,2978,0,0,1,1,0.0%,22m
16778,1,[Zara]AggReSSoR,2978,0,0,1,1,0.0%,11m
16791,1,Wyatt,2977,820,247,239,486,50.8%,12m
16791,1,Fafer,2977,1602,134,126,260,51.5%,21m
16791,1,NewChampion,2977,1339,85,72,157,54.1%,21m
16791,2,Snake,2977,568,66,42,108,61.1%,3m
16791,3,DgradSp,2977,1554,57,70,127,44.9%,17m
16791,2,[ClubR]Pet,2977,898,37,33,70,52.9%,15m
16791,2,llllllllllll,2977,459,18,13,31,58.1%,13m
16791,2,[NSJLM]Smidarok,2977,274,9,6,15,60.0%,10m
16791,1,Cloud,2977,326,9,18,27,33.3%,10m
16791,1,Трибанки,2977,256,8,15,23,34.8%,4m
16791,1,OlGrov,2977,30,6,2,8,75.0%,8m
16791,2,[Entrop]Heretic,2977,182,6,2,8,75.0%,17m
16791,1,[SOUPAP]Dokai,2977,218,6,9,15,40.0%,14m
16791,1,[BURIZA]poesh,2977,0,4,1,5,80.0%,18m
16791,2,Azimor,2977,58,2,1,3,66.7%,9m
16791,2,[PLA2N]чahka,2977,58,2,2,4,50.0%,6m
16791,2,Khatum,2977,0,1,0,1,100.0%,14m
16791,2,antonbutsan,2977,0,1,0,1,100.0%,11m
16791,2,[AchrK9]GenWilkins,2977,108,1,2,3,33.3%,4m
16791,3,[Fridge]Freezer,2977,97,1,2,3,33.3%,5m
16791,2,AntoNKaZino,2977,30,1,3,4,25.0%,15m
16791,2,[FHB]Gerwinn,2977,30,1,4,5,20.0%,10m
16791,2,[Cheats]MasterMind,2977,30,1,5,6,16.7%,6m
16791,2,Degenerał,2977,0,0,1,1,0.0%,6m
16791,2,koyek,2977,0,0,1,1,0.0%,14m
16791,2,Pejs,2977,0,0,1,1,0.0%,13m
16791,2,[ATRS]Supaserrin,2977,0,0,2,2,0.0%,14m
16791,2,GÖKTÜRK,2977,0,0,2,2,0.0%,18m
16819,1,remag,2976,1567,145,116,261,55.6%,14m
16819,2,Darkvedar,2976,1555,98,79,177,55.4%,3m
16819,1,Daedlypuppy,2976,1473,75,65,140,53.6%,10m
16819,3,DreamWave,2976,965,71,77,148,48.0%,31m
16819,2,Apostate,2976,1614,68,60,128,53.1%,4m
16819,1,[PiGPan]StefanS,2976,1523,65,49,114,57.0%,19m
16819,2,Kulgenm,2976,872,42,32,74,56.8%,3m
16819,2,Freedie,2976,643,39,26,65,60.0%,6m
16819,1,slowpilgrim,2976,850,34,30,64,53.1%,20m
16819,2,[VDKN]Lechameleos,2976,520,21,16,37,56.8%,4m
16819,2,[DSmd]Fred,2976,262,9,8,17,52.9%,19m
16819,1,HoplaGeiss,2976,222,9,11,20,45.0%,21m
16819,2,srac,2976,233,8,6,14,57.1%,18m
16819,1,arbok,2976,184,8,6,14,57.1%,15m
16819,2,Leprikon,2976,197,6,4,10,60.0%,1h
16819,1,Blam,2976,184,6,11,17,35.3%,11m
16819,2,Trusik,2976,88,4,2,6,66.7%,15m
16819,1,[RCBlin]MrEnigma,2976,148,4,10,14,28.6%,9m
16819,2,Standza,2976,58,3,1,4,75.0%,3m
16819,2,[2806]mRCtrlEscp,2976,102,3,5,8,37.5%,6m
16819,2,AnungUnRama,2976,90,3,5,8,37.5%,30m
16819,1,Rexxar,2976,76,3,8,11,27.3%,13m
16819,3,Spiral,2976,0,1,0,1,100.0%,17m
16819,2,[L1F4D]Phönix,2976,0,1,3,4,25.0%,14m
16819,1,[BornG]qlimax,2976,0,1,4,5,20.0%,12m
16819,2,[Prima]Majoren,2976,0,0,1,1,0.0%,15m
16819,2,Darth,2976,0,0,1,1,0.0%,12m
16819,2,tIoIxIa,2976,0,0,1,1,0.0%,10m
16819,2,Susanoo,2976,0,0,1,1,0.0%,7m
16819,1,[Clania]Noobalisk,2976,0,0,3,3,0.0%,5m
16849,2,DuttyCup,2975,1618,653,645,1298,50.3%,16m
16849,1,Zuky,2975,1671,401,398,799,50.2%,14m
16849,1,Flotilla,2975,1640,313,318,631,49.6%,7m
16849,2,Scarecrow,2975,1183,162,140,302,53.6%,9m
16849,1,[пдр]SpeedFire,2975,1571,136,136,272,50.0%,7m
16849,1,[OZERIS]Tullaris,2975,797,28,31,59,47.5%,8m
16849,2,[QUAKE]mdanshin,2975,520,27,11,38,71.1%,13m
16849,2,DaS,2975,514,22,12,34,64.7%,5m
16849,2,antizack,2975,454,18,12,30,60.0%,6m
16849,2,dnt,2975,178,11,11,22,50.0%,7m
16849,2,Tram,2975,286,10,6,16,62.5%,10m
16849,2,Benaab,2975,216,7,4,11,63.6%,21m
16849,2,Luthorius,2975,205,5,5,10,50.0%,1h
16849,2,Fleoh,2975,0,3,2,5,60.0%,17m
16849,1,Hobbel,2975,0,3,2,5,60.0%,9m
16849,2,[ShielD]Revain,2975,98,3,3,6,50.0%,15m
16849,2,[BCNE]MadMike,2975,102,3,5,8,37.5%,10m
16849,2,Maru,2975,88,2,1,3,66.7%,8m
16849,2,jerry,2975,30,2,2,4,50.0%,18m
16849,2,Gwen,2975,60,2,3,5,40.0%,13m
16849,1,drislio,2975,72,2,12,14,14.3%,20m
16849,2,Kyuriam,2975,0,1,0,1,100.0%,13m
16849,2,Refactor,2975,30,1,2,3,33.3%,21m
16849,2,[Teplay]Fuhio,2975,0,1,5,6,16.7%,18m
16849,2,Slawsh,2975,0,1,5,6,16.7%,8m
16849,2,Geeman,2975,0,0,1,1,0.0%,18m
16875,2,Rachiu,2974,1265,118,109,227,52.0%,19m
16875,1,Almaz,2974,1201,107,107,214,50.0%,13m
16875,2,[ДeRpy]DerpyThePony,2974,1404,98,88,186,52.7%,18m
16875,3,Ocedlagolova,2974,1233,58,67,125,46.4%,7m
16875,2,Warlord,2974,904,43,29,72,59.7%,17m
16875,1,MTALdrummeR,2974,1026,36,38,74,48.6%,30m
16875,2,Tukan,2974,569,27,17,44,61.4%,32m
16875,2,[maxdan]ObiWanKenobi,2974,496,21,15,36,58.3%,15m
16875,2,doc,2974,390,20,10,30,66.7%,21m
16875,2,Konma,2974,435,16,16,32,50.0%,15m
16875,2,Tevon,2974,400,15,11,26,57.7%,12m
16875,2,Bazyl,2974,367,12,11,23,52.2%,9m
16875,3,Darkavenger,2974,146,6,4,10,60.0%,46m
16875,2,[Stacho]Overus,2974,193,5,6,11,45.5%,10m
16875,1,[DF5]BudSpenzer,2974,114,4,8,12,33.3%,13m
16875,1,LEX,2974,158,4,12,16,25.0%,4m
16875,2,babamara,2974,88,3,3,6,50.0%,3m
16875,1,RubbinMaNips,2974,82,3,8,11,27.3%,14m
16875,2,[lOoOl]MaM,2974,42,3,8,11,27.3%,1h
16875,2,manarok,2974,30,2,0,2,100.0%,15m
16875,2,Oida,2974,30,1,1,2,50.0%,18m
16875,2,[DL2006]nagata,2974,30,1,1,2,50.0%,32m
16875,1,[Камрад]rimerzerg,2974,0,1,4,5,20.0%,11m
16898,2,Decade,2973,1442,116,99,215,54.0%,30m
16898,2,Kurdżypistan,2973,1606,115,90,205,56.1%,10m
16898,1,[TAW]equiNoxSC,2973,1626,68,64,132,51.5%,17m
16898,1,SunnyDee,2973,1263,63,66,129,48.8%,10m
16898,1,[Hitech]satrap,2973,936,44,31,75,58.7%,20m
16898,1,Strange,2973,1034,40,38,78,51.3%,12m
16898,3,Tacit,2973,846,30,41,71,42.3%,31m
16898,2,[WhoDa]Milonga,2973,451,16,13,29,55.2%,15m
16898,2,xeldoros,2973,233,9,7,16,56.2%,6m
16898,3,Викинг,2973,272,9,25,34,26.5%,16m
16898,2,Balder,2973,218,8,7,15,53.3%,13m
16898,1,Skat,2973,174,7,6,13,53.8%,15m
16898,2,[luxdd]Gupu,2973,149,6,3,9,66.7%,19m
16898,1,Dinkelzerg,2973,103,6,4,10,60.0%,9m
16898,2,Teyroks,2973,126,4,0,4,100.0%,7m
16898,2,askatasuna,2973,120,4,9,13,30.8%,19m
16898,1,feight,2973,144,4,12,16,25.0%,21m
16898,2,bombarbia,2973,58,3,1,4,75.0%,15m
16898,2,RoboDefender,2973,0,3,2,5,60.0%,11m
16898,1,ezerath,2973,0,3,2,5,60.0%,1h
16898,2,[BornG]DusK,2973,86,3,4,7,42.9%,9m
16898,1,[Buldog]egorka,2973,48,2,0,2,100.0%,18m
16898,2,[profit]HellothereXD,2973,58,2,1,3,66.7%,10m
16898,1,WannaBeClem,2973,0,1,0,1,100.0%,1h
16898,2,DésolateEra,2973,30,1,1,2,50.0%,32m
16898,1,Millbo,2973,0,1,5,6,16.7%,14m
16898,2,[JmEnBa]voodoopeople,2973,0,0,1,1,0.0%,13m
16898,2,Sideburns,2973,0,0,1,1,0.0%,9m
16898,2,[PLA2N]Leeroy,2973,0,0,1,1,0.0%,3m
16927,2,РезкийкексиК,2972,1090,121,112,233,51.9%,10m
16927,2,gagarin,2972,1544,89,75,164,54.3%,8m
16927,1,bob,2972,1208,75,61,136,55.1%,14m
16927,1,DeadWakEx,2972,1476,58,61,119,48.7%,17m
16927,2,MajorFraud,2972,306,14,13,27,51.9%,20m
16927,2,Grom,2972,322,12,8,20,60.0%,7m
16927,1,[Gawain]Odin,2972,272,11,9,20,55.0%,54m
16927,2,Saturn,2972,233,9,4,13,69.2%,17m
16927,2,Mob,2972,200,6,3,9,66.7%,10m
16927,2,LsS,2972,140,5,0,5,100.0%,15m
16927,1,VanVan,2972,179,5,12,17,29.4%,21m
16927,2,ANARCHIST,2972,147,4,2,6,66.7%,5m
16927,2,[CH33SE]thanandar,2972,98,3,5,8,37.5%,8m
16927,2,Ken,2972,60,3,5,8,37.5%,15m
16927,1,[subj]triploy,2972,143,3,7,10,30.0%,12m
16927,2,Mielec,2972,0,1,2,3,33.3%,18m
16927,2,BladeMaster,2972,0,0,1,1,0.0%,17m
16927,2,Kasio,2972,0,0,1,1,0.0%,49m
16927,2,РАСTAMAH,2972,0,0,1,1,0.0%,19m
16927,2,David,2972,0,0,1,1,0.0%,15m
16927,2,Humantarget,2972,0,0,4,4,0.0%,12m
16948,2,[tH]Shamrock,2971,1549,128,120,248,51.6%,32m
16948,3,[GAMI]santiego,2971,1037,90,73,163,55.2%,10m
16948,2,Thomusus,2971,793,34,32,66,51.5%,32m
16948,2,Pashtet,2971,585,26,25,51,51.0%,17m
16948,2,EvilPoney,2971,371,24,17,41,58.5%,5m
16948,1,[WHRS]DeepDaft,2971,764,24,28,52,46.2%,7m
16948,2,marioslayer,2971,262,11,9,20,55.0%,6m
16948,1,MrWashyHands,2971,326,10,16,26,38.5%,20m
16948,2,MrDarius,2971,149,9,1,10,90.0%,9m
16948,2,KingJzh,2971,235,7,7,14,50.0%,3m
16948,1,[GAME33]СТАЛКЕР,2971,168,4,9,13,30.8%,1h
16948,2,Meliodas,2971,0,3,2,5,60.0%,3m
16948,2,[Rebеls]кеша,2971,98,3,3,6,50.0%,7m
16948,2,skileet,2971,160,3,7,10,30.0%,17m
16948,1,Popcorn,2971,97,2,0,2,100.0%,1h
16948,2,SergioZi,2971,60,2,3,5,40.0%,15m
16948,1,Madmike,2971,136,2,4,6,33.3%,48m
16948,2,[STRLAD]Harrizard,2971,0,1,0,1,100.0%,13m
16948,1,[3ЕRGTV]sTimPack,2971,0,1,0,1,100.0%,16m
16948,2,AoWSuccess,2971,0,1,1,2,50.0%,22m
16948,2,[NSSR]Cyberhippi,2971,30,1,1,2,50.0%,17m
16948,1,[KaPD]skunkkk,2971,0,1,2,3,33.3%,1h
16948,2,Gabi,2971,30,1,2,3,33.3%,5m
16948,2,[CogSci]Stegemann,2971,0,0,3,3,0.0%,6m
16948,2,VLAT,2971,0,0,3,3,0.0%,7m
16973,1,HighRobot,2970,1590,228,227,455,50.1%,9m
16973,3,[666999]MadDorito,2970,1545,90,92,182,49.5%,9m
16973,2,partyboy,2970,1406,75,67,142,52.8%,13m
16973,2,[LDSC2]MrLechuza,2970,1588,75,69,144,52.1%,17m
16973,2,Chelmy,2970,1345,70,72,142,49.3%,16m
16973,2,TossSucks,2970,702,27,34,61,44.3%,13m
16973,2,zergislife,2970,244,13,7,20,65.0%,3m
16973,2,Homi,2970,318,13,10,23,56.5%,10m
16973,2,[HBGSJR]qwaqsha,2970,322,12,6,18,66.7%,10m
16973,2,zergos,2970,165,7,7,14,50.0%,1h
16973,2,Knots,2970,176,7,7,14,50.0%,15m
16973,2,Yeet,2970,166,6,1,7,85.7%,3m
16973,2,[QNTC7]Jomarine,2970,142,6,6,12,50.0%,6m
16973,2,[nB]Sun,2970,205,5,5,10,50.0%,49m
16973,1,[TExGG]Leonmlg,2970,76,2,9,11,18.2%,10m
16973,2,xXMorelXx,2970,0,1,0,1,100.0%,3m
16973,1,[Xy9lce]Ksv,2970,97,1,1,2,50.0%,11m
16973,2,[ASSAD]Drubman,2970,30,1,1,2,50.0%,8m
16973,1,keypromo,2970,48,1,2,3,33.3%,14m
16973,2,bakayaro,2970,0,0,1,1,0.0%,11m
16973,2,Flitter,2970,0,0,1,1,0.0%,10m
16973,2,qinyme,2970,0,0,2,2,0.0%,14m
16995,2,Thebutcher,2969,1616,132,130,262,50.4%,13m
16995,2,qwerty,2969,1468,71,57,128,55.5%,21m
16995,2,Blackhawk,2969,1352,59,56,115,51.3%,9m
16995,2,[KLUTZ]Krugessin,2969,1291,50,50,100,50.0%,4m
16995,2,TrusyEnota,2969,1120,42,40,82,51.2%,7m
16995,1,Sulya,2969,882,35,39,74,47.3%,7m
16995,2,cheeki,2969,722,28,40,68,41.2%,11m
16995,2,Stinger,2969,600,24,16,40,60.0%,15m
16995,1,[Petrus]ZWAttitude,2969,590,23,19,42,54.8%,15m
16995,1,toobadtowin,2969,449,19,17,36,52.8%,13m
16995,1,VReal,2969,322,12,13,25,48.0%,9m
16995,2,Consultant,2969,273,11,9,20,55.0%,11m
16995,2,PREDATOR,2969,298,11,13,24,45.8%,5m
16995,1,Arti,2969,38,6,3,9,66.7%,6m
16995,2,LukePayne,2969,147,6,5,11,54.5%,10m
16995,2,Amifz,2969,114,5,3,8,62.5%,12m
16995,1,BlecMajik,2969,157,4,4,8,50.0%,13m
16995,2,ChunchuMaru,2969,130,4,5,9,44.4%,7m
16995,2,Kirito,2969,112,3,0,3,100.0%,10m
16995,2,[MafiaM]KaliAkra,2969,60,3,1,4,75.0%,21m
16995,2,Lim,2969,116,3,1,4,75.0%,10m
16995,2,[DМG]GanzVlad,2969,64,3,4,7,42.9%,13m
16995,2,Morganfreema,2969,30,3,4,7,42.9%,10m
16995,2,uNreal,2969,30,2,1,3,66.7%,15m
16995,1,[ISIC]Blackcat,2969,96,2,4,6,33.3%,1h
16995,2,Tajej,2969,0,0,1,1,0.0%,13m
16995,2,[Peeps]ToSsGirL,2969,0,0,1,1,0.0%,13m
16995,2,[HYX]achilles,2969,0,0,2,2,0.0%,7m
17023,3,Anti,2968,1550,325,317,642,50.6%,11m
17023,1,Wimpex,2968,1530,99,86,185,53.5%,3m
17023,1,LouisKing,2968,909,38,46,84,45.2%,13m
17023,1,Jobi,2968,688,22,28,50,44.0%,21m
17023,2,MLDMNV,2968,472,18,18,36,50.0%,18m
17023,2,Partykeeper,2968,346,16,10,26,61.5%,20m
17023,1,[TAW]Roadhog,2968,472,15,20,35,42.9%,9m
17023,2,[NoSock]ZSTRANNIK,2968,276,9,8,17,52.9%,14m
17023,3,Kiki,2968,157,9,23,32,28.1%,6m
17023,2,[InitRu]Artanis,2968,171,6,3,9,66.7%,17m
17023,2,Salem,2968,152,5,1,6,83.3%,11m
17023,1,BAJIEPA,2968,145,5,3,8,62.5%,49m
17023,3,[DGG]Grimmen,2968,38,5,4,9,55.6%,19m
17023,1,DrohGT,2968,89,4,4,8,50.0%,21m
17023,1,Glyba,2968,0,3,2,5,60.0%,60m
17023,2,itchyrear,2968,0,3,2,5,60.0%,6m
17023,2,Phaser,2968,0,2,4,6,33.3%,6m
17023,2,MizterSawada,2968,0,1,0,1,100.0%,12m
17023,1,[Dobro]Shepard,2968,0,1,0,1,100.0%,52m
17023,2,Mirage,2968,30,1,1,2,50.0%,5m
17023,2,basad,2968,0,1,4,5,20.0%,20m
17023,2,[MRX]schreck,2968,0,0,1,1,0.0%,14m
17023,2,[MrReed]Antonio,2968,0,0,1,1,0.0%,19m
17023,2,Dreadnought,2968,0,0,1,1,0.0%,7m
17023,2,[EUww1]Chel,2968,0,0,2,2,0.0%,9m
17048,1,MatmaR,2967,1634,282,264,546,51.6%,19m
17048,1,TheEyeszlade,2967,504,76,47,123,61.8%,12m
17048,2,Murkit,2967,1031,62,58,120,51.7%,19m
17048,2,Qnugg,2967,1230,55,49,104,52.9%,19m
17048,1,Hit,2967,1130,42,48,90,46.7%,20m
17048,1,Stardu,2967,1202,42,52,94,44.7%,30m
17048,2,Morozzo,2967,931,38,29,67,56.7%,10m
17048,2,Symbule,2967,859,35,26,61,57.4%,15m
17048,2,LastGuard,2967,509,23,9,32,71.9%,6m
17048,2,Byggvir,2967,405,16,12,28,57.1%,18m
17048,1,llRAYOll,2967,439,15,15,30,50.0%,4m
17048,3,freedomfight,2967,205,7,4,11,63.6%,56m
17048,2,FearofDeath,2967,156,6,5,11,54.5%,32m
17048,1,[сSсǃ]BuRaTiLo,2967,237,6,13,19,31.6%,17m
17048,3,Roach,2967,114,3,0,3,100.0%,14m
17048,2,DonREone,2967,0,3,2,5,60.0%,6m
17048,2,bengbengezpz,2967,30,2,0,2,100.0%,32m
17048,2,[secure]bolek,2967,0,2,3,5,40.0%,5m
17048,2,krabator,2967,99,2,4,6,33.3%,12m
17048,1,[RaLaKn]ToMoKrOwA,2967,36,2,8,10,20.0%,30m
17048,2,Metebacsi,2967,0,0,1,1,0.0%,10m
17048,2,XFooLoR,2967,0,0,1,1,0.0%,5m
17048,2,Behelit,2967,0,0,1,1,0.0%,3m
17048,2,MamaMia,2967,0,0,1,1,0.0%,14m
17048,2,IIIIIIIII,2967,0,0,3,3,0.0%,7m
17073,2,[BornG]rainque,2966,1402,100,83,183,54.6%,5m
17073,2,SquadFox,2966,1366,98,82,180,54.4%,17m
17073,2,Zepic,2966,1104,52,35,87,59.8%,13m
17073,1,Phuschmaster,2966,497,47,53,100,47.0%,14m
17073,1,Linuel,2966,834,33,37,70,47.1%,20m
17073,2,pringls,2966,535,24,11,35,68.6%,5m
17073,1,[Heroes]Moes,2966,473,22,16,38,57.9%,13m
17073,2,[NetGG]ChernoAlpha,2966,529,21,14,35,60.0%,15m
17073,1,Zuko,2966,567,19,21,40,47.5%,7m
17073,3,Mădălin,2966,559,18,26,44,40.9%,9m
17073,1,[Clania]spir,2966,498,17,26,43,39.5%,30m
17073,2,[Howler]Rosero,2966,401,16,14,30,53.3%,21m
17073,2,Deadlysinner,2966,389,15,10,25,60.0%,7m
17073,1,GinderCat,2966,359,14,9,23,60.9%,22m
17073,2,Рестаратор,2966,293,13,3,16,81.2%,18m
17073,2,Laurana,2966,343,13,13,26,50.0%,19m
17073,1,TomTheLegacy,2966,273,11,10,21,52.4%,1h
17073,2,Chernomor,2966,252,8,7,15,53.3%,6m
17073,2,Terranized,2966,234,8,9,17,47.1%,21m
17073,1,Gryphon,2966,141,6,2,8,75.0%,52m
17073,3,Eintrag,2966,146,6,4,10,60.0%,53m
17073,2,[aDGa]Reaper,2966,0,4,1,5,80.0%,13m
17073,2,yogigr,2966,88,4,4,8,50.0%,18m
17073,2,Nindzua,2966,32,2,2,4,50.0%,5m
17073,3,MrBearmouse,2966,42,2,7,9,22.2%,17m
17073,1,TomRion,2966,0,1,0,1,100.0%,57m
17073,2,goreprotos,2966,52,1,1,2,50.0%,5m
17073,2,[StrdUK]StoredCris,2966,0,0,1,1,0.0%,19m
17101,2,Eon,2965,1574,309,289,598,51.7%,15m
17101,1,GicaSTAS,2965,1646,241,237,478,50.4%,11m
17101,2,babouc,2965,1540,107,90,197,54.3%,3m
17101,1,VladimirT,2965,1589,104,105,209,49.8%,14m
17101,3,ZahariGr,2965,1315,90,93,183,49.2%,3m
17101,2,Boxybrown,2965,1576,78,62,140,55.7%,21m
17101,2,DGeneration,2965,1592,78,71,149,52.3%,14m
17101,2,тоха,2965,1207,53,48,101,52.5%,5m
17101,1,Trak,2965,400,48,45,93,51.6%,5m
17101,2,Massa,2965,950,40,35,75,53.3%,10m
17101,2,NotEnough,2965,498,21,19,40,52.5%,9m
17101,1,shadow,2965,570,17,27,44,38.6%,16m
17101,2,[theTPL]LattinoBono,2965,316,14,7,21,66.7%,10m
17101,3,[VLDLOX]Bezbalkonnay,2965,232,7,2,9,77.8%,3m
17101,2,[0KIG0]Astartes,2965,176,7,7,14,50.0%,5m
17101,2,ALnoivmee,2965,95,5,5,10,50.0%,1h
17101,1,PipboyTwoK,2965,144,4,12,16,25.0%,13m
17101,2,Schutz,2965,128,3,3,6,50.0%,7m
17101,2,dimarus,2965,58,3,3,6,50.0%,10m
17101,1,Quirinus,2965,98,3,9,12,25.0%,18m
17101,2,YurisRevenge,2965,30,2,0,2,100.0%,21m
17101,1,[Dedeki]ooSEVEN,2965,74,2,11,13,15.4%,30m
17101,1,PWNemALL,2965,0,0,1,1,0.0%,1h
17101,2,GPD,2965,0,0,1,1,0.0%,3m
17101,2,Hunter,2965,0,0,3,3,0.0%,15m
17126,1,BimBamBude,2964,1659,166,163,329,50.5%,10m
17126,2,kiklopik,2964,1199,120,108,228,52.6%,17m
17126,2,ESPARTACO,2964,1598,76,74,150,50.7%,17m
17126,2,Maestro,2964,1456,66,53,119,55.5%,5m
17126,2,IDN,2964,295,56,55,111,50.5%,15m
17126,2,Realize,2964,451,49,38,87,56.3%,6m
17126,2,Wykwintny,2964,730,26,25,51,51.0%,14m
17126,2,[5433w]Goshaivanovo,2964,648,24,25,49,49.0%,6m
17126,2,[TDDK]Dunlop,2964,456,21,12,33,63.6%,32m
17126,2,Banzai,2964,364,16,14,30,53.3%,7m
17126,2,[ESGM]Barteq,2964,368,15,13,28,53.6%,17m
17126,2,Ohwee,2964,142,10,1,11,90.9%,15m
17126,2,johnny,2964,226,10,9,19,52.6%,4m
17126,2,Aliostro,2964,229,8,4,12,66.7%,4m
17126,1,Draddy,2964,244,8,12,20,40.0%,31m
17126,2,[EssA]stona,2964,240,8,12,20,40.0%,10m
17126,1,hawi,2964,286,8,15,23,34.8%,30m
17126,2,Nick,2964,144,7,3,10,70.0%,14m
17126,1,Valentinus,2964,192,5,3,8,62.5%,1h
17126,2,Infinity,2964,122,5,5,10,50.0%,14m
17126,1,StarTUM,2964,170,5,11,16,31.2%,17m
17126,1,Artik,2964,0,4,1,5,80.0%,20m
17126,2,PlyPanda,2964,138,4,1,5,80.0%,3m
17126,1,[Agara]Astalavista,2964,0,2,2,4,50.0%,59m
17126,3,[FonzǂD]KramerMcB,2964,36,2,3,5,40.0%,54m
17126,2,Ranger,2964,60,2,4,6,33.3%,12m
17126,2,Smithy,2964,0,0,1,1,0.0%,4m
17126,2,[BornG]Stormblessed,2964,0,0,2,2,0.0%,14m
17126,2,rudiii,2964,0,0,2,2,0.0%,10m
17126,2,HeaSteN,2964,0,0,5,5,0.0%,14m
17156,3,doblejota,2963,1538,470,472,942,49.9%,20m
17156,3,[xFRSx]YOMISMO,2963,1527,265,263,528,50.2%,5m
17156,3,OOSeven,2963,1280,78,87,165,47.3%,14m
17156,2,[369]BakedBeans,2963,1578,69,69,138,50.0%,11m
17156,2,Naczelny,2963,1111,45,44,89,50.6%,30m
17156,2,Struifi,2963,659,43,32,75,57.3%,19m
17156,1,Heero,2963,1196,41,47,88,46.6%,18m
17156,3,MWF,2963,658,39,52,91,42.9%,31m
17156,1,[ZERGSC]NikitA,2963,623,33,25,58,56.9%,16m
17156,2,UltraLord,2963,621,26,20,46,56.5%,17m
17156,1,Lukasix,2963,546,23,18,41,56.1%,9m
17156,2,Blink,2963,486,21,19,40,52.5%,13m
17156,1,Quaraz,2963,459,19,18,37,51.4%,9m
17156,2,BlokeX,2963,360,12,11,23,52.2%,17m
17156,2,[Cancro]Schipper,2963,280,11,3,14,78.6%,12m
17156,2,[Донный]SeriousKSM,2963,244,11,6,17,64.7%,10m
17156,2,Macheengun,2963,302,10,8,18,55.6%,7m
17156,2,Pinehas,2963,284,9,8,17,52.9%,14m
17156,2,[DFgs]Reva,2963,146,6,4,10,60.0%,5m
17156,1,Septimus,2963,117,5,2,7,71.4%,9m
17156,1,PVP,2963,74,5,13,18,27.8%,21m
17156,2,[iX]BKBStorMCroW,2963,94,3,6,9,33.3%,5m
17156,2,Ormos,2963,125,3,7,10,30.0%,19m
17156,2,Noob,2963,112,2,1,3,66.7%,16m
17156,2,Tiwi,2963,60,2,6,8,25.0%,17m
17156,2,Abies,2963,0,1,0,1,100.0%,15m
17156,1,[JurF]Gwynbleidd,2963,0,1,0,1,100.0%,20m
17156,2,AragakiAyase,2963,0,1,0,1,100.0%,20m
17156,2,Eiker,2963,0,1,1,2,50.0%,15m
17156,2,[K0mpis]Gejben,2963,30,1,2,3,33.3%,6m
17156,2,[Ирбис]TROLLZZZZZZ,2963,0,1,2,3,33.3%,10m
17156,1,Funnyway,2963,0,1,4,5,20.0%,13m
17156,2,samson,2963,0,0,1,1,0.0%,13m
17156,2,[isIMBА]OISI,2963,0,0,1,1,0.0%,10m
17156,2,Damkani,2963,0,0,2,2,0.0%,1h
17156,3,Blackfish,2963,0,0,2,2,0.0%,20m
17156,2,[TNSR]Recuperate,2963,0,0,2,2,0.0%,10m
17193,1,Naapukka,2962,1511,111,109,220,50.5%,30m
17193,2,DeSTROyer,2962,465,56,51,107,52.3%,18m
17193,2,LangesElend,2962,613,31,29,60,51.7%,21m
17193,2,ExTZeiKo,2962,543,27,11,38,71.1%,15m
17193,2,Medusa,2962,500,17,21,38,44.7%,9m
17193,2,Theven,2962,337,16,9,25,64.0%,10m
17193,2,[пдр]Maverick,2962,360,14,8,22,63.6%,17m
17193,2,[охота]YellowRuby,2962,346,14,14,28,50.0%,19m
17193,1,SaskeKaske,2962,273,10,3,13,76.9%,48m
17193,3,[SSC2]WelliosFTL,2962,232,9,6,15,60.0%,60m
17193,2,RevengeBoxer,2962,86,6,6,12,50.0%,22m
17193,2,ClimateZone,2962,152,6,6,12,50.0%,6m
17193,2,[fam1ly]Blank,2962,172,6,9,15,40.0%,7m
17193,3,XnProZob,2962,181,6,17,23,26.1%,3m
17193,2,Achtung,2962,18,4,3,7,57.1%,32m
17193,2,Halbateur,2962,0,3,2,5,60.0%,32m
17193,2,loxamol,2962,92,3,7,10,30.0%,21m
17193,2,SamLJackson,2962,30,2,1,3,66.7%,6m
17193,2,Bjorknes,2962,58,2,2,4,50.0%,21m
17193,2,afteryou,2962,30,2,3,5,40.0%,4m
17193,3,DEMON,2962,0,1,0,1,100.0%,55m
17193,2,cutecarp,2962,0,1,2,3,33.3%,13m
17193,2,[ZERGML]Alexeyder,2962,0,0,2,2,0.0%,5m
17216,1,Korp,2961,1415,92,89,181,50.8%,13m
17216,1,Лис,2961,802,85,87,172,49.4%,30m
17216,2,safetybeer,2961,1240,51,43,94,54.3%,5m
17216,3,ZuuR,2961,1517,51,73,124,41.1%,12m
17216,3,RitUga,2961,1216,46,53,99,46.5%,20m
17216,2,jasta,2961,757,33,21,54,61.1%,6m
17216,1,CptObvious,2961,786,32,31,63,50.8%,15m
17216,2,mcgui,2961,590,24,18,42,57.1%,16m
17216,2,GennGreymane,2961,392,18,12,30,60.0%,3m
17216,2,Andreich,2961,500,18,20,38,47.4%,10m
17216,1,[IRK138]KANONEXv,2961,282,14,19,33,42.4%,20m
17216,2,DDevill,2961,360,13,16,29,44.8%,5m
17216,1,[3MD]Disk,2961,297,10,12,22,45.5%,15m
17216,2,GhostNuke,2961,250,10,13,23,43.5%,9m
17216,3,TheAlonso,2961,110,7,7,14,50.0%,49m
17216,2,Manuel,2961,120,5,8,13,38.5%,9m
17216,2,[G2I]LonelyProbe,2961,86,4,2,6,66.7%,19m
17216,2,IrinaBruno,2961,126,4,6,10,40.0%,10m
17216,3,Life,2961,153,3,3,6,50.0%,4m
17216,2,[PiGPan]Susanoo,2961,88,2,0,2,100.0%,11m
17216,2,Cuthbert,2961,108,2,1,3,66.7%,5m
17216,2,spitfyre,2961,0,2,3,5,40.0%,13m
17216,2,thequickfox,2961,30,2,4,6,33.3%,4m
17216,2,ZXCdedINSIDE,2961,60,2,4,6,33.3%,21m
17216,1,[TedB]IIIDEHAKAIII,2961,0,2,5,7,28.6%,19m
17216,2,[MFclub]Alex,2961,0,1,0,1,100.0%,7m
17216,2,peterleitoni,2961,0,1,1,2,50.0%,11m
17216,2,[BroGic]AddMyRall,2961,0,0,1,1,0.0%,7m
17244,1,Trinity,2960,1629,154,151,305,50.5%,13m
17244,1,Braincrack,2960,1624,64,67,131,48.9%,31m
17244,2,Silke,2960,740,56,40,96,58.3%,14m
17244,1,WildWolf,2960,712,54,48,102,52.9%,16m
17244,1,Monsoon,2960,1058,35,42,77,45.5%,12m
17244,1,Dvaliin,2960,930,32,37,69,46.4%,13m
17244,1,whistle,2960,687,29,32,61,47.5%,11m
17244,2,grn,2960,668,26,22,48,54.2%,21m
17244,2,Marchal,2960,520,23,20,43,53.5%,17m
17244,2,djark,2960,556,22,20,42,52.4%,30m
17244,3,Furiouso,2960,273,13,9,22,59.1%,12m
17244,2,[IceHus]IceRai,2960,252,10,5,15,66.7%,4m
17244,2,FourmiCrowd,2960,0,3,2,5,60.0%,7m
17244,2,ScIIAvenger,2960,113,3,3,6,50.0%,22m
17244,1,[WOSCHD]Wizzo,2960,145,2,6,8,25.0%,1h
17244,2,Ducsachor,2960,0,1,0,1,100.0%,13m
17244,2,[21377]Mojito,2960,0,1,1,2,50.0%,11m
17244,2,Marlon,2960,30,1,2,3,33.3%,15m
17244,2,boyz,2960,0,1,3,4,25.0%,11m
17244,2,[239]SlasH,2960,0,0,1,1,0.0%,18m
17244,2,burak,2960,0,0,2,2,0.0%,6m
17265,1,Heinrich,2959,1637,121,116,237,51.1%,5m
17265,1,Nsal,2959,1256,77,62,139,55.4%,21m
17265,1,zidan,2959,192,35,29,64,54.7%,30m
17265,2,VersaLife,2959,480,32,18,50,64.0%,3m
17265,2,NaCl,2959,806,29,30,59,49.2%,32m
17265,3,Smeagorl,2959,519,17,26,43,39.5%,20m
17265,2,XaPyZaTnik,2959,352,14,12,26,53.8%,5m
17265,2,[J4E]iReve,2959,294,9,7,16,56.2%,7m
17265,1,Daxter,2959,170,8,6,14,57.1%,20m
17265,2,[LEAN]TheBrain,2959,196,8,8,16,50.0%,32m
17265,2,Flagadajønes,2959,90,4,3,7,57.1%,6m
17265,2,FGP,2959,138,3,2,5,60.0%,10m
17265,1,Terran,2959,48,3,2,5,60.0%,60m
17265,2,FerDeLance,2959,30,2,0,2,100.0%,5m
17265,2,Infiltration,2959,0,1,0,1,100.0%,13m
17265,2,Fidfav,2959,0,0,1,1,0.0%,9m
17281,3,matrixxx,2958,1498,840,854,1694,49.6%,4m
17281,1,Tinkywinky,2958,1609,167,159,326,51.2%,30m
17281,2,Alehei,2958,1547,146,138,284,51.4%,11m
17281,2,[Hаsu]LittleSerral,2958,893,38,32,70,54.3%,17m
17281,1,Auri,2958,908,30,37,67,44.8%,8m
17281,2,Ghost,2958,496,22,12,34,64.7%,12m
17281,1,Susake,2958,310,21,31,52,40.4%,8m
17281,2,RandomFerrum,2958,237,19,11,30,63.3%,4m
17281,2,gerianer,2958,469,19,18,37,51.4%,10m
17281,2,AttacFrmMars,2958,334,12,10,22,54.5%,13m
17281,2,IOIO,2958,242,9,9,18,50.0%,10m
17281,2,MadMan,2958,197,9,10,19,47.4%,10m
17281,2,Darkened,2958,141,7,4,11,63.6%,15m
17281,2,[RIPNA]riperino,2958,174,7,5,12,58.3%,7m
17281,2,scopulorum,2958,172,6,7,13,46.2%,15m
17281,2,llllllllllll,2958,208,6,9,15,40.0%,5m
17281,2,Samubtncrt,2958,102,5,3,8,62.5%,5m
17281,1,LazyMetroid,2958,167,5,3,8,62.5%,1h
17281,1,Terran,2958,154,5,14,19,26.3%,31m
17281,2,[lMMl]nunununununu,2958,180,4,4,8,50.0%,1h
17281,2,Joofy,2958,184,4,4,8,50.0%,14m
17281,2,BANOUN,2958,222,4,8,12,33.3%,7m
17281,2,[THST]Khelghar,2958,86,3,4,7,42.9%,5m
17281,1,RahGen,2958,0,2,5,7,28.6%,21m
17281,2,KakuIIIka,2958,0,1,0,1,100.0%,56m
17281,2,PIT,2958,0,1,1,2,50.0%,13m
17281,2,Cirvis,2958,0,0,1,1,0.0%,15m
17281,2,[инж]RaDy,2958,0,0,1,1,0.0%,10m
17281,1,ZumSieg,2958,0,0,1,1,0.0%,60m
17281,2,FROST,2958,0,0,1,1,0.0%,19m
17281,2,Dreamcatcher,2958,0,0,3,3,0.0%,6m
17312,3,Berkster,2957,839,90,91,181,49.7%,4m
17312,1,JjabOnOsO,2957,1658,89,87,176,50.6%,21m
17312,1,[Kripta]Зомби,2957,1617,59,72,131,45.0%,8m
17312,1,KapJlcoH,2957,1526,57,59,116,49.1%,20m
17312,2,rockmaxo,2957,347,25,21,46,54.3%,13m
17312,1,[8mylez]MagicN,2957,624,24,23,47,51.1%,15m
17312,1,[SMFS]teaz,2957,542,18,20,38,47.4%,9m
17312,2,MrCrackFox,2957,426,16,15,31,51.6%,7m
17312,2,Прочитано,2957,383,15,10,25,60.0%,14m
17312,1,Iron,2957,294,10,14,24,41.7%,9m
17312,1,[B13R]Xophy,2957,247,9,1,10,90.0%,16m
17312,2,Aha,2957,165,6,1,7,85.7%,18m
17312,2,IziDritz,2957,154,5,2,7,71.4%,14m
17312,2,AllSilentSky,2957,180,5,9,14,35.7%,14m
17312,1,[Kokuou]Erdnael,2957,97,4,2,6,66.7%,54m
17312,2,MrBlackWay,2957,112,3,0,3,100.0%,13m
17312,2,ydkme,2957,0,3,2,5,60.0%,1h
17312,2,Heavy,2957,30,2,0,2,100.0%,7m
17312,2,MGUH,2957,114,2,2,4,50.0%,17m
17312,2,RERE,2957,0,2,2,4,50.0%,10m
17312,3,PonJaulTwo,2957,97,2,3,5,40.0%,55m
17312,1,KalMbIK,2957,0,1,0,1,100.0%,11m
17312,2,HitSmoker,2957,30,1,2,3,33.3%,18m
17312,2,uran,2957,0,0,1,1,0.0%,15m
17312,2,Paso,2957,0,0,1,1,0.0%,5m
17312,2,NiKiTa,2957,0,0,1,1,0.0%,19m
17312,1,KRAKEN,2957,0,0,1,1,0.0%,1h
17339,2,Larsène,2956,1621,222,222,444,50.0%,5m
17339,2,SCV,2956,1628,209,202,411,50.9%,15m
17339,2,Zephyr,2956,1584,138,123,261,52.9%,21m
17339,1,kesha,2956,430,50,59,109,45.9%,20m
17339,2,Rigo,2956,238,10,5,15,66.7%,13m
17339,2,SoulsCatcher,2956,201,9,6,15,60.0%,12m
17339,2,[GoAtfr]Bane,2956,202,9,7,16,56.2%,6m
17339,1,LuTer,2956,172,6,11,17,35.3%,12m
17339,2,TSIRLIPIPIS,2956,188,5,5,10,50.0%,16m
17339,2,poulpoultime,2956,128,4,1,5,80.0%,32m
17339,3,[HHA1]TriggerMike,2956,146,4,3,7,57.1%,46m
17339,2,LeeRage,2956,0,3,2,5,60.0%,8m
17339,2,DiscoStu,2956,88,3,4,7,42.9%,5m
17339,2,[EECFR]shikamaru,2956,58,2,3,5,40.0%,10m
17339,2,Ingrimch,2956,88,2,4,6,33.3%,15m
17339,2,[FrRacl]Anuviel,2956,0,1,0,1,100.0%,9m
17339,2,Surdegsten,2956,0,0,1,1,0.0%,32m
17339,2,[Hrr]ЧудаПесик,2956,0,0,1,1,0.0%,4m
17339,2,starcode,2956,0,0,1,1,0.0%,17m
17339,2,ZIZOO,2956,0,0,1,1,0.0%,13m
17339,2,Kaisvap,2956,0,0,1,1,0.0%,19m
17339,2,barry,2956,0,0,3,3,0.0%,9m
17361,1,[FR1]Galbadia,2955,1344,55,48,103,53.4%,17m
17361,2,Matthew,2955,1112,47,40,87,54.0%,9m
17361,1,DrCoitus,2955,1051,45,47,92,48.9%,20m
17361,1,SCPROGAMING,2955,556,36,32,68,52.9%,11m
17361,1,llllllllllll,2955,918,30,36,66,45.5%,5m
17361,2,[GaMToX]TaKMashido,2955,643,26,20,46,56.5%,13m
17361,2,Kuroko,2955,395,17,7,24,70.8%,13m
17361,2,Morphosis,2955,492,17,20,37,45.9%,10m
17361,2,[LMBD]Crotorius,2955,256,12,6,18,66.7%,13m
17361,2,Siddhartha,2955,250,11,6,17,64.7%,6m
17361,3,Hwoarang,2955,230,10,4,14,71.4%,5m
17361,2,[TDOTK]Spiritueux,2955,230,9,10,19,47.4%,9m
17361,2,oddmarine,2955,150,6,4,10,60.0%,10m
17361,2,[KDV]Adamin,2955,182,6,8,14,42.9%,19m
17361,2,EkkiPateng,2955,111,5,3,8,62.5%,10m
17361,1,nnn,2955,96,4,4,8,50.0%,1h
17361,2,[lOoOl]DRAGOONSLAIR,2955,164,4,6,10,40.0%,54m
17361,2,[Harley]SemperFid,2955,94,3,6,9,33.3%,6m
17361,1,[UAŦeam]Widow,2955,70,3,8,11,27.3%,12m
17361,2,[E3elta]TusaBambasa,2955,30,2,1,3,66.7%,21m
17361,2,[TIRID]AlphaSputnik,2955,30,2,3,5,40.0%,15m
17361,1,[GGLose]SkeJIoF,2955,0,2,4,6,33.3%,1h
17361,2,Linjo,2955,0,1,0,1,100.0%,6m
17361,2,Crover,2955,0,1,0,1,100.0%,14m
17361,2,Anton,2955,30,1,4,5,20.0%,14m
17361,2,[VODKА]nnt,2955,0,0,1,1,0.0%,4m
17361,1,Gamjar,2955,0,0,6,6,0.0%,59m
17388,1,goaulD,2954,1574,124,128,252,49.2%,9m
17388,2,Majorana,2954,1345,86,74,160,53.8%,3m
17388,2,Bigdawgs,2954,1399,62,46,108,57.4%,16m
17388,2,Sibastian,2954,1007,42,35,77,54.5%,11m
17388,2,[75рус]НАГИБАТОР,2954,670,26,23,49,53.1%,6m
17388,2,Sjakieownz,2954,340,15,7,22,68.2%,5m
17388,2,Jorge,2954,340,12,10,22,54.5%,10m
17388,2,MrMonk,2954,295,12,13,25,48.0%,4m
17388,2,Funtik,2954,252,9,5,14,64.3%,12m
17388,2,[LIDAB]Xxpwnstar,2954,241,9,7,16,56.2%,31m
17388,3,REVELCON,2954,178,8,8,16,50.0%,20m
17388,2,IIIIIIIIIIII,2954,223,6,12,18,33.3%,6m
17388,3,[AMEA]Bekras,2954,97,5,3,8,62.5%,21m
17388,2,Jerolol,2954,146,5,5,10,50.0%,10m
17388,2,[MRZN]Dillgurke,2954,142,4,3,7,57.1%,9m
17388,1,ArToFZeRg,2954,116,4,6,10,40.0%,6m
17388,2,WarCoque,2954,0,3,2,5,60.0%,5m
17388,1,RizeN,2954,127,3,7,10,30.0%,18m
17388,2,Oleg,2954,30,2,1,3,66.7%,18m
17388,3,DrunkGamer,2954,121,2,2,4,50.0%,14m
17388,2,HangMAN,2954,30,2,3,5,40.0%,11m
17388,2,[xFRSx]Rafus,2954,0,2,3,5,40.0%,9m
17388,2,[BHN]sergoRU,2954,0,1,0,1,100.0%,15m
17388,2,Fabian,2954,30,1,1,2,50.0%,6m
17388,1,Alex,2954,97,1,1,2,50.0%,3m
17388,2,[PLOPI]Aston,2954,48,1,12,13,7.7%,59m
17388,1,Hans,2954,0,0,1,1,0.0%,53m
17388,2,[323GR]JOHN,2954,0,0,1,1,0.0%,15m
17388,2,[PGWS]madmax,2954,0,0,2,2,0.0%,5m
17417,1,DarkMout,2953,994,137,128,265,51.7%,20m
17417,2,ouki,2953,1495,112,81,193,58.0%,9m
17417,2,BANANA,2953,1420,74,54,128,57.8%,10m
17417,1,Libra,2953,819,53,39,92,57.6%,10m
17417,3,balin,2953,721,50,61,111,45.0%,13m
17417,2,[WANG]Solstafir,2953,805,44,43,87,50.6%,4m
17417,2,Catswhisker,2953,694,41,31,72,56.9%,15m
17417,2,Havalor,2953,436,26,28,54,48.1%,4m
17417,1,[P35]Spailer,2953,768,26,30,56,46.4%,12m
17417,2,FilthyCasual,2953,497,21,23,44,47.7%,9m
17417,2,[washed]UPhasBEEN,2953,395,18,12,30,60.0%,16m
17417,2,Kluras,2953,336,13,13,26,50.0%,4m
17417,2,HyperXCubeOS,2953,330,11,9,20,55.0%,3m
17417,1,TkachOK,2953,354,10,13,23,43.5%,31m
17417,2,Just,2953,268,9,10,19,47.4%,21m
17417,2,Takamet,2953,174,6,7,13,46.2%,7m
17417,2,HiRus,2953,130,5,0,5,100.0%,10m
17417,2,Skye,2953,0,3,1,4,75.0%,9m
17417,2,VAF,2953,86,3,3,6,50.0%,9m
17417,3,[SSSR]CARBON,2953,121,2,1,3,66.7%,1h
17417,2,[RekTzW]Szlachecki,2953,0,2,2,4,50.0%,1h
17417,2,SeeJah,2953,0,1,0,1,100.0%,22m
17417,1,[BHLS]AjihadCZ,2953,0,1,7,8,12.5%,18m
17417,1,[RoXY]hYtAkYtE,2953,0,0,1,1,0.0%,1h
17441,1,Olzu,2952,1132,137,132,269,50.9%,17m
17441,1,[R2811]FestisLime,2952,920,36,41,77,46.8%,17m
17441,2,Woutr,2952,488,19,18,37,51.4%,7m
17441,2,[HHW]Wumme,2952,448,17,19,36,47.2%,9m
17441,2,[yayo]zhorikluv,2952,418,16,14,30,53.3%,15m
17441,2,emoGarfield,2952,363,13,21,34,38.2%,20m
17441,3,NoxoN,2952,222,8,6,14,57.1%,50m
17441,2,[RsTb]kid,2952,144,5,11,16,31.2%,10m
17441,2,[MSUSC2]Khadgar,2952,152,4,3,7,57.1%,17m
17441,1,[EWW]Buba,2952,139,3,2,5,60.0%,1h
17441,1,rinGO,2952,122,3,2,5,60.0%,45m
17441,2,Jasmine,2952,0,3,2,5,60.0%,13m
17441,2,Karpfen,2952,140,3,3,6,50.0%,1h
17441,2,Anakin,2952,58,2,2,4,50.0%,8m
17441,2,PhAn,2952,58,2,3,5,40.0%,13m
17441,2,BEbnataGDeep,2952,0,0,2,2,0.0%,5m
17441,2,Saï,2952,0,0,2,2,0.0%,6m
17441,2,FriDriH,2952,0,0,3,3,0.0%,6m
17441,2,MhAuRg,2952,0,0,4,4,0.0%,5m
17460,1,Melancholia,2951,1589,185,180,365,50.7%,5m
17460,1,Ygi,2951,1587,105,106,211,49.8%,31m
17460,2,DanyOcean,2951,488,95,82,177,53.7%,19m
17460,2,Pedro,2951,1471,93,87,180,51.7%,10m
17460,3,data,2951,1312,92,89,181,50.8%,31m
17460,2,AxL,2951,1508,75,72,147,51.0%,12m
17460,2,ZaZ,2951,673,54,47,101,53.5%,21m
17460,2,ebick,2951,713,42,38,80,52.5%,7m
17460,2,ExoticSphere,2951,524,37,27,64,57.8%,5m
17460,2,[Birdy]EarlyBirdy,2951,630,29,19,48,60.4%,4m
17460,1,Hehehehehehe,2951,601,21,23,44,47.7%,20m
17460,2,Nederplebs,2951,410,19,11,30,63.3%,13m
17460,2,Дан,2951,316,13,9,22,59.1%,13m
17460,2,Fil,2951,368,12,12,24,50.0%,13m
17460,2,[SILeSp]AzeriX,2951,268,10,11,21,47.6%,7m
17460,1,SeNSei,2951,279,10,12,22,45.5%,15m
17460,1,Octopus,2951,274,10,15,25,40.0%,30m
17460,2,[FF10]jugarnaittt,2951,272,8,6,14,57.1%,1h
17460,2,zolax,2951,249,8,6,14,57.1%,19m
17460,2,Daggoth,2951,254,8,8,16,50.0%,20m
17460,1,pixel,2951,249,7,13,20,35.0%,20m
17460,2,Calibra,2951,178,6,3,9,66.7%,10m
17460,1,LetMeWinplz,2951,162,4,6,10,40.0%,55m
17460,2,Noche,2951,0,3,2,5,60.0%,58m
17460,2,[NvBa]Jackawaka,2951,30,2,0,2,100.0%,8m
17460,2,Alya,2951,114,2,2,4,50.0%,5m
17460,2,KillerPalle,2951,112,2,2,4,50.0%,1h
17460,3,VaRg,2951,0,1,0,1,100.0%,45m
17460,2,[CCMC]Blbtailazcz,2951,0,1,0,1,100.0%,15m
17460,2,[PiGPan]Gaara,2951,0,1,1,2,50.0%,7m
17460,1,FaNtik,2951,0,0,1,1,0.0%,1h
17460,2,Sieche,2951,0,0,2,2,0.0%,6m
17492,3,Cucurbito,2950,1465,238,238,476,50.0%,5m
17492,3,TerraNova,2950,1435,190,203,393,48.3%,15m
17492,2,[TOMK]MarineKing,2950,1616,148,136,284,52.1%,32m
17492,2,Noumz,2950,1379,115,89,204,56.4%,32m
17492,2,Yan,2950,1152,68,58,126,54.0%,10m
17492,1,Drake,2950,1242,62,52,114,54.4%,9m
17492,2,bopyx,2950,623,30,19,49,61.2%,13m
17492,2,destroyando,2950,547,22,14,36,61.1%,17m
17492,1,StevePS,2950,586,19,24,43,44.2%,5m
17492,2,moremgarem,2950,353,13,12,25,52.0%,5m
17492,2,autojeans,2950,350,13,14,27,48.1%,5m
17492,2,xxArenaMxx,2950,240,8,11,19,42.1%,15m
17492,2,willbe,2950,200,7,12,19,36.8%,19m
17492,2,FREON,2950,92,4,3,7,57.1%,20m
17492,2,yougi,2950,0,3,2,5,60.0%,15m
17492,2,Evseichik,2950,126,3,3,6,50.0%,14m
17492,2,Odin,2950,0,3,3,6,50.0%,16m
17492,2,IKAR,2950,30,2,5,7,28.6%,9m
17492,2,[Arrows]dikkkkkkkkkk,2950,38,2,7,9,22.2%,6m
17492,2,RDǂOlivaw,2950,30,1,4,5,20.0%,6m
17492,2,[xFRSx]coldjob,2950,0,1,4,5,20.0%,13m
17492,2,[KUKULZ]BlindShaman,2950,0,0,1,1,0.0%,14m
17492,2,Haxdelete,2950,0,0,1,1,0.0%,21m
17492,2,Arkadio,2950,0,0,1,1,0.0%,10m
17492,2,deseveryday,2950,0,0,1,1,0.0%,7m
17492,2,PhoenixFire,2950,0,0,2,2,0.0%,16m
17492,2,CHEMPOPO,2950,0,0,2,2,0.0%,10m
17519,3,Akme,2949,1459,240,260,500,48.0%,6m
17519,1,[mfxed]owner,2949,1261,182,181,363,50.1%,12m
17519,3,Rock,2949,1587,157,158,315,49.8%,10m
17519,1,Bumm,2949,1641,143,141,284,50.4%,3m
17519,2,KINGDOPAH,2949,1128,76,56,132,57.6%,6m
17519,2,miracle,2949,922,62,40,102,60.8%,17m
17519,1,xegorchikx,2949,634,61,58,119,51.3%,6m
17519,2,[LANP]MilshCop,2949,1384,56,52,108,51.9%,8m
17519,2,Grozamir,2949,462,41,21,62,66.1%,15m
17519,2,Serg,2949,432,19,9,28,67.9%,9m
17519,1,Skywalker,2949,361,14,12,26,53.8%,7m
17519,2,[SPCR]Hiryu,2949,208,7,11,18,38.9%,10m
17519,3,Goromthejakk,2949,182,6,6,12,50.0%,5m
17519,3,[thxbye]MarcFlowers,2949,157,4,4,8,50.0%,1h
17519,2,drunk,2949,0,2,0,2,100.0%,49m
17519,3,Mixackzer,2949,97,2,1,3,66.7%,1h
17519,2,[SproL]Sheik,2949,30,2,2,4,50.0%,11m
17519,2,LikeOfLings,2949,0,2,3,5,40.0%,32m
17519,2,[PuNcyN]Maćko,2949,0,1,0,1,100.0%,11m
17519,2,zyma,2949,0,1,0,1,100.0%,20m
17519,2,lEEgIInnAr,2949,88,1,1,2,50.0%,5m
17519,2,[mfixed]Mello,2949,0,1,3,4,25.0%,16m
17519,2,[WeGr]JIDEKO,2949,0,1,4,5,20.0%,8m
17519,2,knuttie,2949,0,0,1,1,0.0%,21m
17519,2,Slick,2949,0,0,1,1,0.0%,15m
17519,2,DontHurtMe,2949,0,0,1,1,0.0%,18m
17519,2,GriwMF,2949,0,0,1,1,0.0%,18m
17546,2,BYuN,2948,1519,93,73,166,56.0%,10m
17546,2,Reid,2948,1566,78,80,158,49.4%,19m
17546,2,Faust,2948,876,36,28,64,56.2%,5m
17546,1,Regis,2948,766,30,27,57,52.6%,30m
17546,2,EUGENE,2948,502,26,8,34,76.5%,9m
17546,2,Ich,2948,268,10,14,24,41.7%,12m
17546,2,AndrewJohn,2948,0,4,1,5,80.0%,19m
17546,1,Krotik,2948,97,4,2,6,66.7%,1h
17546,1,Toby,2948,97,4,3,7,57.1%,57m
17546,2,MEDAS,2948,96,4,4,8,50.0%,55m
17546,2,Andy,2948,58,2,4,6,33.3%,18m
17546,2,ZergKEBAB,2948,60,2,4,6,33.3%,12m
17546,2,ilovepizza,2948,62,2,4,6,33.3%,18m
17546,2,TiRexer,2948,0,1,0,1,100.0%,8m
17546,2,Toomuch,2948,0,1,0,1,100.0%,5m
17546,2,[OSgZ]eskimo,2948,0,1,0,1,100.0%,4m
17546,1,[TöVõ]IEQI,2948,36,1,8,9,11.1%,9m
17546,2,[Jail]TihiRabit,2948,0,0,1,1,0.0%,11m
17546,1,[alahak]MOLORIK,2948,0,0,1,1,0.0%,59m
17565,2,Pepino,2947,832,130,112,242,53.7%,13m
17565,2,Meyo,2947,1148,124,107,231,53.7%,9m
17565,2,[SHNOZ]Roscoe,2947,1502,67,60,127,52.8%,5m
17565,2,[MGK]Nicocotier,2947,1268,55,49,104,52.9%,17m
17565,1,EarthForever,2947,849,47,46,93,50.5%,18m
17565,2,XYZero,2947,962,40,33,73,54.8%,32m
17565,2,EQL,2947,1024,38,37,75,50.7%,22m
17565,1,[LES]snobz,2947,774,28,31,59,47.5%,8m
17565,2,Rambo,2947,688,25,26,51,49.0%,8m
17565,1,Levty,2947,609,21,21,42,50.0%,14m
17565,2,Gemcluster,2947,309,20,14,34,58.8%,4m
17565,1,[TTK]PunisHer,2947,604,19,23,42,45.2%,20m
17565,2,stick,2947,366,18,9,27,66.7%,21m
17565,2,LuckyOwl,2947,314,13,11,24,54.2%,18m
17565,2,pro,2947,322,13,12,25,52.0%,14m
17565,2,limonadniy,2947,365,12,14,26,46.2%,17m
17565,1,Alexei,2947,292,10,12,22,45.5%,6m
17565,2,Artem,2947,178,7,7,14,50.0%,10m
17565,2,BadBalance,2947,157,5,1,6,83.3%,21m
17565,2,CTElderman,2947,30,4,3,7,57.1%,21m
17565,2,Unassigned,2947,0,3,2,5,60.0%,1h
17565,2,glhfgg,2947,116,3,2,5,60.0%,13m
17565,2,RajinoC,2947,0,3,2,5,60.0%,13m
17565,2,HeyKappa,2947,60,3,2,5,60.0%,14m
17565,2,Twid,2947,0,3,2,5,60.0%,14m
17565,2,MCN,2947,0,3,2,5,60.0%,10m
17565,2,[Cannоn]BelaM,2947,0,1,2,3,33.3%,15m
17565,2,SCDelta,2947,0,0,4,4,0.0%,9m
17593,2,Neokrz,2946,1331,148,140,288,51.4%,4m
17593,2,МУЖИК,2946,1559,113,110,223,50.7%,10m
17593,1,DOMINION,2946,650,99,96,195,50.8%,31m
17593,2,abishell,2946,684,71,69,140,50.7%,32m
17593,2,PrettyFlacko,2946,807,58,24,82,70.7%,12m
17593,3,Zoo,2946,774,41,54,95,43.2%,6m
17593,1,[THP]Joey,2946,853,29,32,61,47.5%,21m
17593,2,mamoeb,2946,563,27,27,54,50.0%,19m
17593,2,Fbyson,2946,718,26,27,53,49.1%,13m
17593,2,DitarKnyaz,2946,426,20,8,28,71.4%,16m
17593,2,NastyHorse,2946,416,20,19,39,51.3%,7m
17593,2,Superinse,2946,272,12,6,18,66.7%,17m
17593,2,Volkodav,2946,218,8,11,19,42.1%,19m
17593,2,[A4J]ender,2946,214,8,12,20,40.0%,10m
17593,3,Khalid,2946,121,5,5,10,50.0%,1h
17593,1,GOODVIN,2946,132,4,7,11,36.4%,17m
17593,2,slidsolid,2946,0,3,2,5,60.0%,7m
17593,3,[RÆVVA]Fekt,2946,36,2,0,2,100.0%,1h
17593,2,Stormrage,2946,88,2,0,2,100.0%,11m
17593,2,[Side]inteam,2946,0,1,0,1,100.0%,6m
17593,2,[xX00Xx]Robyzucca,2946,88,1,1,2,50.0%,20m
17593,2,Haikou,2946,18,1,2,3,33.3%,11m
17593,3,Rikitikitavi,2946,30,1,4,5,20.0%,1h
17593,2,Odysseus,2946,30,1,6,7,14.3%,14m
17617,2,Neró,2945,892,52,46,98,53.1%,14m
17617,2,Smithski,2945,1196,48,48,96,50.0%,20m
17617,2,[TQT]Sauron,2945,972,37,38,75,49.3%,10m
17617,1,[K0mpis]Angelwhite,2945,278,36,41,77,46.8%,8m
17617,2,Orwen,2945,922,35,38,73,47.9%,13m
17617,2,CodeZ,2945,708,30,25,55,54.5%,7m
17617,2,ALEX,2945,581,24,20,44,54.5%,13m
17617,2,[RеG]CiZzyX,2945,556,22,14,36,61.1%,8m
17617,2,школьник,2945,448,19,10,29,65.5%,19m
17617,2,[isMVP]TerranImba,2945,373,18,9,27,66.7%,9m
17617,3,Mcfly,2945,252,9,14,23,39.1%,18m
17617,1,Ilya,2945,189,8,2,10,80.0%,47m
17617,1,lonlon,2945,144,6,5,11,54.5%,1h
17617,1,[Дядя]Darkness,2945,199,5,5,10,50.0%,1h
17617,3,[bo0n]Earlington,2945,0,4,4,8,50.0%,7m
17617,2,Ambulatory,2945,128,3,2,5,60.0%,14m
17617,2,hedGehog,2945,102,3,3,6,50.0%,16m
17617,2,[TTIS]Xamos,2945,86,3,4,7,42.9%,19m
17617,2,[SCLW]Denizel,2945,0,1,0,1,100.0%,14m
17617,2,Urael,2945,0,1,0,1,100.0%,21m
17617,2,JohnV,2945,88,1,1,2,50.0%,14m
17617,3,Kalyp,2945,97,1,2,3,33.3%,45m
17617,2,[SGSA]Fierce,2945,30,1,5,6,16.7%,15m
17617,2,aroitu,2945,0,0,1,1,0.0%,16m
17617,2,Freiheit,2945,0,0,2,2,0.0%,15m
17617,2,[Bruv]PickleRick,2945,0,0,2,2,0.0%,4m
17617,2,[TDOW]Trimer,2945,0,0,3,3,0.0%,19m
17644,2,NightLight,2944,1577,164,142,306,53.6%,7m
17644,1,FoxX,2944,849,60,45,105,57.1%,14m
17644,1,Валантис,2944,535,44,40,84,52.4%,22m
17644,2,[HZeS]VladShaman,2944,546,43,26,69,62.3%,19m
17644,2,comandant,2944,788,28,29,57,49.1%,10m
17644,2,SunGift,2944,490,23,20,43,53.5%,10m
17644,2,[sc2tm]Artunela,2944,341,16,12,28,57.1%,10m
17644,1,Squid,2944,504,15,24,39,38.5%,32m
17644,2,zuki,2944,378,14,15,29,48.3%,9m
17644,2,khan,2944,412,14,16,30,46.7%,11m
17644,2,[SyD]BigO,2944,253,11,9,20,55.0%,11m
17644,2,Khuul,2944,249,9,8,17,52.9%,1h
17644,2,eipts,2944,166,7,6,13,53.8%,16m
17644,3,[NOTGay]ÇĥøčøłåDkã,2944,147,6,5,11,54.5%,1h
17644,1,[сSсǃ]Александр,2944,96,5,5,10,50.0%,9m
17644,2,phenix,2944,119,3,5,8,37.5%,7m
17644,2,Goochem,2944,30,2,2,4,50.0%,20m
17644,2,[Arezar]Baloo,2944,58,2,6,8,25.0%,19m
17644,2,[Batia]moloko,2944,0,1,0,1,100.0%,14m
17644,2,CyberBurger,2944,0,1,0,1,100.0%,6m
17644,2,[HRDS]ZeroCooL,2944,0,0,1,1,0.0%,4m
17665,3,Luca,2943,1545,426,424,850,50.1%,6m
17665,2,[RvdS]Thorin,2943,1532,109,92,201,54.2%,7m
17665,2,Shaggy,2943,1556,66,66,132,50.0%,31m
17665,2,[eRZR]Harlekin,2943,825,59,54,113,52.2%,16m
17665,2,SHALFEY,2943,958,36,38,74,48.6%,11m
17665,2,[gFink]Ralphedh,2943,691,27,24,51,52.9%,14m
17665,2,GERG,2943,519,20,17,37,54.1%,5m
17665,2,Underbot,2943,526,20,19,39,51.3%,12m
17665,2,llllllllllll,2943,296,11,13,24,45.8%,19m
17665,2,Auguscht,2943,258,10,8,18,55.6%,4m
17665,3,Mex,2943,140,9,8,17,52.9%,31m
17665,3,asik,2943,84,5,7,12,41.7%,15m
17665,2,Alina,2943,88,4,3,7,57.1%,32m
17665,2,[MEME64]SuperAnders,2943,0,3,2,5,60.0%,4m
17665,2,[lMMl]Nikolordi,2943,30,2,2,4,50.0%,4m
17665,2,[H0C]iDrone,2943,30,2,2,4,50.0%,22m
17665,1,NedoFrost,2943,36,2,6,8,25.0%,9m
17665,2,Sunwoo,2943,0,1,0,1,100.0%,5m
17665,2,[WTTC]Окосфер,2943,88,1,1,2,50.0%,7m
17665,1,fear,2943,0,1,8,9,11.1%,7m
17665,3,[Heroes]BabyZergling,2943,0,0,1,1,0.0%,54m
17665,2,MRI,2943,0,0,1,1,0.0%,4m
17665,2,Grimlinks,2943,0,0,1,1,0.0%,10m
17665,3,[КАМ]Mukyma,2943,0,0,1,1,0.0%,13m
17665,2,Gweenblade,2943,0,0,1,1,0.0%,13m
17665,2,[BjwA]Puco,2943,0,0,2,2,0.0%,11m
17665,2,fakil,2943,0,0,2,2,0.0%,14m
17692,2,BoomerBTI,2942,985,83,67,150,55.3%,14m
17692,1,[Belgae]Ripper,2942,1294,76,82,158,48.1%,20m
17692,2,Matej,2942,933,67,49,116,57.8%,5m
17692,2,Snide,2942,967,64,61,125,51.2%,10m
17692,2,OnionKing,2942,1033,54,24,78,69.2%,9m
17692,2,berkistayn,2942,1150,49,40,89,55.1%,15m
17692,1,[Bruvas]maxi,2942,1152,49,49,98,50.0%,31m
17692,3,Countdeepa,2942,1066,44,52,96,45.8%,22m
17692,2,Niko,2942,372,35,32,67,52.2%,6m
17692,2,Forat,2942,490,26,27,53,49.1%,13m
17692,1,SKQRP,2942,412,18,5,23,78.3%,1h
17692,2,[zultra]Aschroft,2942,225,12,8,20,60.0%,14m
17692,2,VeloxFelidae,2942,220,7,5,12,58.3%,3m
17692,2,SHURIK,2942,210,7,8,15,46.7%,7m
17692,2,Sprinal,2942,136,6,4,10,60.0%,8m
17692,2,[5gb]iMoCKinGBirD,2942,214,6,6,12,50.0%,7m
17692,1,Akuma,2942,147,5,3,8,62.5%,1h
17692,2,Кирилл,2942,131,5,4,9,55.6%,20m
17692,1,[TQUILA]AvocadoSlyer,2942,163,5,8,13,38.5%,15m
17692,3,hlebushek,2942,146,5,15,20,25.0%,13m
17692,2,[DNARI]SoulBurner,2942,128,4,1,5,80.0%,11m
17692,2,OqopO,2942,88,4,3,7,57.1%,21m
17692,2,[M1L]SamSparkle,2942,114,4,7,11,36.4%,16m
17692,2,fastflow,2942,124,4,11,15,26.7%,21m
17692,2,Nanaki,2942,0,3,2,5,60.0%,1h
17692,2,Ksenja,2942,0,3,2,5,60.0%,21m
17692,3,FusRoDah,2942,131,3,5,8,37.5%,1h
17692,2,czR,2942,88,2,0,2,100.0%,10m
17692,2,PROteamart,2942,102,2,2,4,50.0%,12m
17692,2,Vamis,2942,30,2,2,4,50.0%,17m
17692,2,RabbitBird,2942,40,2,3,5,40.0%,1h
17692,2,lollif,2942,88,2,4,6,33.3%,6m
17692,1,DecMate,2942,74,2,9,11,18.2%,30m
17692,2,MihaiRomania,2942,0,1,1,2,50.0%,4m
17692,2,[G58]aZra,2942,0,1,2,3,33.3%,12m
17692,2,Xenser,2942,30,1,4,5,20.0%,6m
17692,2,[Eagls]Ocula,2942,0,0,1,1,0.0%,14m
17692,2,Demo,2942,0,0,1,1,0.0%,9m
17692,2,ZiciLol,2942,0,0,1,1,0.0%,10m
17692,2,PAINKILLER,2942,0,0,3,3,0.0%,11m
17692,2,tschuggide,2942,0,0,6,6,0.0%,19m
17733,2,maGNetar,2941,1563,98,81,179,54.7%,13m
17733,1,BanNardes,2941,1617,82,71,153,53.6%,30m
17733,3,Карантино,2941,1283,56,63,119,47.1%,9m
17733,2,Probius,2941,1011,51,48,99,51.5%,5m
17733,2,LazyTurtle,2941,1144,48,42,90,53.3%,11m
17733,2,neznaika,2941,766,45,29,74,60.8%,19m
17733,2,Yuino,2941,650,40,25,65,61.5%,16m
17733,2,Лёха,2941,842,40,29,69,58.0%,17m
17733,2,[ZGlot]Mirrorer,2941,615,26,17,43,60.5%,9m
17733,2,AlexisLionel,2941,592,24,19,43,55.8%,14m
17733,2,[A1MC]ChiefRocka,2941,268,12,9,21,57.1%,14m
17733,2,bratborodat,2941,239,9,5,14,64.3%,6m
17733,2,Stanisław,2941,254,9,10,19,47.4%,17m
17733,2,Maristokrat,2941,180,7,7,14,50.0%,7m
17733,2,Shalambala,2941,188,7,10,17,41.2%,22m
17733,2,iweasel,2941,164,5,3,8,62.5%,13m
17733,2,IIIIIIIIIIII,2941,190,5,6,11,45.5%,4m
17733,2,[JeeEmm]Ripsy,2941,124,5,9,14,35.7%,9m
17733,2,Naruto,2941,0,3,2,5,60.0%,7m
17733,2,BloodyNoob,2941,60,2,3,5,40.0%,14m
17733,2,[HaloRe]lorenzo,2941,30,2,3,5,40.0%,20m
17733,2,Zajcev,2941,0,1,0,1,100.0%,12m
17733,2,DaMs,2941,42,1,3,4,25.0%,1h
17733,2,HOTLINE,2941,30,1,3,4,25.0%,17m
17733,2,theXerathor,2941,0,1,4,5,20.0%,1h
17733,2,[Pitw]Vini,2941,0,0,1,1,0.0%,7m
17733,2,[Sabat]Lazarz,2941,0,0,3,3,0.0%,5m
17760,2,RaptorBUCA,2940,1038,265,249,514,51.6%,4m
17760,1,MRX,2940,1622,195,188,383,50.9%,18m
17760,2,Thanpren,2940,985,40,34,74,54.1%,4m
17760,2,Silentium,2940,476,30,25,55,54.5%,13m
17760,2,[GgWall]fetknol,2940,450,19,12,31,61.3%,11m
17760,2,Roks,2940,365,15,9,24,62.5%,15m
17760,2,Templar,2940,336,14,6,20,70.0%,5m
17760,2,Ale,2940,364,13,8,21,61.9%,7m
17760,1,GravyTrain,2940,354,13,10,23,56.5%,54m
17760,2,[ASS]Konrad,2940,236,9,6,15,60.0%,32m
17760,2,Number,2940,208,7,9,16,43.8%,8m
17760,1,Hoi,2940,255,7,10,17,41.2%,20m
17760,2,[5MG]Keonru,2940,183,5,6,11,45.5%,14m
17760,2,ZeNigmar,2940,90,4,5,9,44.4%,13m
17760,1,[KRice]nWaDemo,2940,185,4,13,17,23.5%,3m
17760,2,mArk,2940,0,3,2,5,60.0%,8m
17760,2,[lancon]ARITHON,2940,30,2,2,4,50.0%,4m
17760,2,MadProbe,2940,62,2,5,7,28.6%,13m
17760,2,Flexon,2940,30,1,2,3,33.3%,15m
17760,2,Groot,2940,30,1,3,4,25.0%,19m
17760,2,Europa,2940,30,1,4,5,20.0%,4m
17781,2,Helox,2939,1576,124,93,217,57.1%,32m
17781,2,BradSchmidt,2939,1027,41,34,75,54.7%,13m
17781,2,HeroH,2939,691,33,30,63,52.4%,9m
17781,2,Andrey,2939,733,29,24,53,54.7%,9m
17781,2,Windus,2939,540,29,31,60,48.3%,5m
17781,2,DrAngelicus,2939,608,27,15,42,64.3%,17m
17781,2,[kiler]Tidragon,2939,319,12,12,24,50.0%,16m
17781,1,MeThoD,2939,274,12,14,26,46.2%,16m
17781,2,Ayaya,2939,209,9,2,11,81.8%,19m
17781,2,KariBig,2939,219,9,9,18,50.0%,13m
17781,3,diller,2939,182,7,6,13,53.8%,52m
17781,2,diabolic,2939,174,6,8,14,42.9%,5m
17781,3,[SwiBel]TomDead,2939,169,5,9,14,35.7%,9m
17781,2,[NASI]Terminus,2939,230,5,10,15,33.3%,19m
17781,2,Omega,2939,88,4,2,6,66.7%,3m
17781,2,Ruslan,2939,112,3,1,4,75.0%,6m
17781,2,SleviN,2939,88,2,0,2,100.0%,19m
17781,1,Fleshwound,2939,38,2,7,9,22.2%,18m
17781,2,[RISKE]mistermaker,2939,0,1,0,1,100.0%,19m
17781,2,ANDRY,2939,0,1,0,1,100.0%,6m
17781,2,XpycT,2939,0,0,1,1,0.0%,12m
17781,2,ArgentSouL,2939,0,0,1,1,0.0%,8m
17781,2,juju,2939,0,0,1,1,0.0%,4m
17781,2,Fokusnik,2939,0,0,1,1,0.0%,16m
17781,1,Specx,2939,0,0,1,1,0.0%,1h
17781,1,Kojiro,2939,0,0,3,3,0.0%,16m
17807,1,ecclesiaste,2938,1605,126,135,261,48.3%,15m
17807,1,jigitto,2938,1537,115,110,225,51.1%,15m
17807,1,WarPath,2938,1571,80,69,149,53.7%,14m
17807,3,Wagnuz,2938,997,49,62,111,44.1%,12m
17807,2,LotarCitizen,2938,446,32,30,62,51.6%,14m
17807,1,COJIDAT,2938,798,32,32,64,50.0%,20m
17807,1,mahmoud,2938,291,31,34,65,47.7%,5m
17807,2,[EBoI]RogalDorn,2938,402,25,18,43,58.1%,18m
17807,2,Lum,2938,598,23,23,46,50.0%,12m
17807,2,Flofloflo,2938,432,22,11,33,66.7%,18m
17807,2,Протупея,2938,395,22,15,37,59.5%,7m
17807,2,Pellegri,2938,542,20,21,41,48.8%,8m
17807,1,Bwaaa,2938,560,18,27,45,40.0%,30m
17807,1,CarolusRex,2938,444,16,21,37,43.2%,10m
17807,1,NaughtyFrog,2938,314,14,11,25,56.0%,5m
17807,2,DonPajerin,2938,285,8,10,18,44.4%,32m
17807,2,Beuleu,2938,210,6,4,10,60.0%,48m
17807,2,[Stahl]VFZero,2938,30,4,3,7,57.1%,5m
17807,2,ShraSs,2938,0,1,0,1,100.0%,14m
17807,2,Snowdrop,2938,0,1,0,1,100.0%,19m
17807,2,SuperBod,2938,0,1,3,4,25.0%,11m
17807,2,improvisator,2938,0,0,1,1,0.0%,5m
17807,1,Shakur,2938,0,0,1,1,0.0%,1h
17830,1,[DELADO]Moimn,2937,1410,359,322,681,52.7%,20m
17830,1,JackBell,2937,1454,235,224,459,51.2%,13m
17830,1,Ertai,2937,1008,158,154,312,50.6%,11m
17830,2,[NevSur]nurFischer,2937,1630,111,102,213,52.1%,9m
17830,3,Megadeath,2937,887,78,82,160,48.8%,21m
17830,2,kim,2937,1036,57,49,106,53.8%,4m
17830,2,Corvojean,2937,802,35,28,63,55.6%,4m
17830,2,Bordie,2937,572,28,22,50,56.0%,9m
17830,2,TimDeTruth,2937,450,16,16,32,50.0%,32m
17830,2,thec,2937,426,16,20,36,44.4%,22m
17830,2,Nemesis,2937,282,12,5,17,70.6%,17m
17830,1,Jasont,2937,334,11,21,32,34.4%,22m
17830,1,sausageroll,2937,227,8,9,17,47.1%,7m
17830,2,dikij,2937,205,7,4,11,63.6%,20m
17830,2,Aklezmer,2937,89,5,4,9,55.6%,13m
17830,2,[TÆR]Raku,2937,200,5,13,18,27.8%,14m
17830,3,DIVERSANT,2937,153,4,3,7,57.1%,1h
17830,1,Ztar,2937,144,4,4,8,50.0%,1h
17830,2,Astartes,2937,90,4,6,10,40.0%,14m
17830,2,[SKi2]eSCape,2937,95,3,0,3,100.0%,5m
17830,2,[Zelos]GangstarTM,2937,128,3,2,5,60.0%,10m
17830,2,Patas,2937,0,3,2,5,60.0%,19m
17830,3,faridyrg,2937,36,2,0,2,100.0%,1h
17830,2,piketak,2937,107,2,2,4,50.0%,1h
17830,2,HavaNahila,2937,30,2,2,4,50.0%,13m
17830,2,DarkSaind,2937,60,2,4,6,33.3%,13m
17830,2,Marsas,2937,66,2,6,8,25.0%,15m
17830,2,Sukizu,2937,0,1,0,1,100.0%,17m
17830,2,[TTpom]Curare,2937,0,1,0,1,100.0%,11m
17830,2,zigaPRM,2937,0,1,0,1,100.0%,10m
17830,2,[EESC]Donday,2937,88,1,1,2,50.0%,4m
17830,2,Falcon,2937,30,1,2,3,33.3%,12m
17830,2,Assguard,2937,0,1,4,5,20.0%,15m
17830,2,Ilyater,2937,30,1,6,7,14.3%,16m
17830,1,Deverio,2937,0,0,1,1,0.0%,60m
17830,1,tempest,2937,0,0,1,1,0.0%,47m
17830,2,NordHelge,2937,0,0,2,2,0.0%,4m
17830,3,Feeserd,2937,0,0,2,2,0.0%,1h
17868,3,UglydrOne,2936,1351,336,327,663,50.7%,15m
17868,1,Starplatinum,2936,1326,252,251,503,50.1%,13m
17868,3,Impreza,2936,1486,192,188,380,50.5%,14m
17868,2,dffct,2936,1123,70,61,131,53.4%,14m
17868,2,Aramis,2936,899,51,39,90,56.7%,19m
17868,2,PanNorek,2936,900,44,23,67,65.7%,5m
17868,1,[0BO]Barbarossa,2936,512,16,25,41,39.0%,17m
17868,2,Vibe,2936,314,15,9,24,62.5%,6m
17868,2,Azamuz,2936,430,15,21,36,41.7%,4m
17868,2,MISA,2936,388,14,15,29,48.3%,12m
17868,2,Alex,2936,225,13,3,16,81.2%,16m
17868,2,[Büsi]Panis,2936,319,12,9,21,57.1%,4m
17868,2,IlIlIlIlIlIl,2936,324,11,10,21,52.4%,10m
17868,1,[PŖïMĄŁ]ExtreamFrost,2936,303,10,15,25,40.0%,5m
17868,3,[HIYYYA]Oxymoron,2936,226,8,6,14,57.1%,1h
17868,2,Knoch,2936,162,7,5,12,58.3%,15m
17868,2,Tishkez,2936,228,7,7,14,50.0%,5m
17868,2,Ariahsis,2936,141,6,4,10,60.0%,5m
17868,2,Vermilion,2936,115,6,6,12,50.0%,1h
17868,1,Fratergun,2936,214,6,8,14,42.9%,6m
17868,2,Cheesus,2936,88,4,2,6,66.7%,15m
17868,2,Рэмбо,2936,88,4,4,8,50.0%,11m
17868,2,swesais,2936,90,4,6,10,40.0%,7m
17868,3,[mfixed]Seniu,2936,180,4,9,13,30.8%,49m
17868,2,iceæprd,2936,0,3,2,5,60.0%,10m
17868,2,longren,2936,88,3,4,7,42.9%,21m
17868,2,Touk,2936,92,3,8,11,27.3%,19m
17868,2,Cryocks,2936,0,2,0,2,100.0%,17m
17868,2,[1DZ1]кексик,2936,0,2,1,3,66.7%,1h
17868,1,[SH1TY]DaWitchDokta,2936,0,2,5,7,28.6%,20m
17868,2,[ЛЯГУХА]prishtina,2936,88,1,1,2,50.0%,17m
17868,2,Murphy,2936,0,1,1,2,50.0%,6m
17868,2,[ZonTs]NTG,2936,30,1,3,4,25.0%,14m
17868,2,[CxCx]Kimyoungun,2936,0,0,1,1,0.0%,16m
17868,2,ShangTsung,2936,0,0,2,2,0.0%,8m
17903,1,Alexio,2935,1541,214,205,419,51.1%,16m
17903,1,Kytyzov,2935,917,69,72,141,48.9%,9m
17903,2,Yann,2935,1629,65,68,133,48.9%,10m
17903,1,anbecha,2935,773,47,45,92,51.1%,12m
17903,2,besubik,2935,988,42,33,75,56.0%,32m
17903,1,Hyakutake,2935,469,36,41,77,46.8%,31m
17903,2,IIIIIIIIIII,2935,840,34,28,62,54.8%,14m
17903,2,[N1TDA]Makila,2935,797,32,25,57,56.1%,19m
17903,3,Torino,2935,501,19,22,41,46.3%,31m
17903,2,Jez,2935,343,14,10,24,58.3%,12m
17903,2,Ultra,2935,316,12,9,21,57.1%,17m
17903,2,[HISSSS]VenomZA,2935,215,9,6,15,60.0%,6m
17903,2,[basdp]Mora,2935,219,8,6,14,57.1%,16m
17903,2,[Petite]Princesse,2935,235,8,8,16,50.0%,48m
17903,2,BloodCloud,2935,193,7,3,10,70.0%,6m
17903,1,DIFENZ,2935,167,6,3,9,66.7%,7m
17903,2,Tobart,2935,191,6,4,10,60.0%,17m
17903,1,gardemarin,2935,181,6,5,11,54.5%,48m
17903,2,[DIDLIN]ountzountz,2935,188,6,9,15,40.0%,4m
17903,2,[Bwolfs]Velinor,2935,130,5,0,5,100.0%,14m
17903,1,Damascenedge,2935,97,4,3,7,57.1%,1h
17903,2,GhostDog,2935,120,3,2,5,60.0%,13m
17903,2,Richie,2935,0,3,2,5,60.0%,1h
17903,2,Stargazer,2935,145,3,4,7,42.9%,8m
17903,1,Nagel,2935,0,1,0,1,100.0%,21m
17903,2,Program,2935,0,1,1,2,50.0%,59m
17903,2,Redfield,2935,30,1,3,4,25.0%,10m
17903,2,NLKroepoek,2935,0,1,4,5,20.0%,5m
17903,2,Hrust,2935,0,0,1,1,0.0%,18m
17932,2,AbelTitan,2934,1531,243,209,452,53.8%,8m
17932,1,DjPKPavel,2934,1384,187,177,364,51.4%,10m
17932,2,Lamus,2934,1476,181,183,364,49.7%,19m
17932,1,VeronikaZ,2934,1566,153,151,304,50.3%,5m
17932,1,RedHot,2934,1639,153,159,312,49.0%,31m
17932,2,Afterthought,2934,1294,80,68,148,54.1%,20m
17932,1,serega,2934,1256,53,59,112,47.3%,17m
17932,2,ShadowSword,2934,1155,52,33,85,61.2%,13m
17932,1,vvv,2934,304,40,40,80,50.0%,15m
17932,2,Mikka,2934,652,24,26,50,48.0%,6m
17932,2,Shev,2934,515,20,15,35,57.1%,7m
17932,2,Izzaqui,2934,572,20,20,40,50.0%,14m
17932,2,[EEA]dirtyela,2934,522,20,20,40,50.0%,15m
17932,2,Darkens,2934,346,13,16,29,44.8%,14m
17932,2,ANDROCK,2934,319,12,11,23,52.2%,6m
17932,1,NevrHadUrCar,2934,333,11,8,19,57.9%,45m
17932,2,[Roq4t]IAmFoggy,2934,192,8,4,12,66.7%,14m
17932,2,KrekeN,2934,156,7,2,9,77.8%,14m
17932,1,Androkles,2934,256,7,14,21,33.3%,31m
17932,1,llllllllllll,2934,120,6,2,8,75.0%,57m
17932,1,MINIJCW,2934,137,6,2,8,75.0%,18m
17932,2,GLUK,2934,142,6,5,11,54.5%,31m
17932,2,DAVINY,2934,192,6,6,12,50.0%,12m
17932,2,TombStone,2934,0,4,1,5,80.0%,20m
17932,2,Инквизитор,2934,30,4,4,8,50.0%,14m
17932,3,Solent,2934,121,3,0,3,100.0%,8m
17932,2,LELE,2934,0,3,2,5,60.0%,8m
17932,2,Gunna,2934,128,3,3,6,50.0%,4m
17932,1,[GODSSS]DirtyStar,2934,74,3,9,12,25.0%,11m
17932,1,[TFS1]Googleplex,2934,44,2,0,2,100.0%,4m
17932,2,Nelson,2934,60,2,5,7,28.6%,21m
17932,2,LeeroyV,2934,88,1,1,2,50.0%,7m
17932,2,RagnaRok,2934,0,1,2,3,33.3%,4m
17932,2,abs,2934,30,1,2,3,33.3%,9m
17932,2,KroliK,2934,30,1,2,3,33.3%,21m
17932,2,Guylon,2934,0,0,1,1,0.0%,7m
17932,2,Raven,2934,0,0,1,1,0.0%,6m
17932,2,[Lowko]Shadowhunter,2934,0,0,2,2,0.0%,11m
17932,1,jan,2934,0,0,2,2,0.0%,1h
17971,3,sim,2933,1475,608,617,1225,49.6%,31m
17971,1,[MUCNS]Baradur,2933,1270,153,149,302,50.7%,22m
17971,1,STEFANINOG,2933,1647,151,147,298,50.7%,9m
17971,2,Destillate,2933,904,149,135,284,52.5%,7m
17971,3,AKINCIBEYi,2933,1526,72,91,163,44.2%,12m
17971,2,TOXIC,2933,307,62,57,119,52.1%,5m
17971,2,Djecraft,2933,1249,52,49,101,51.5%,4m
17971,2,[Sylph]ijsisglat,2933,903,45,22,67,67.2%,15m
17971,2,GGZiiStreams,2933,954,39,37,76,51.3%,4m
17971,2,RukiKruki,2933,635,26,20,46,56.5%,10m
17971,1,Ritz,2933,581,19,26,45,42.2%,22m
17971,2,Lastbreath,2933,274,14,16,30,46.7%,19m
17971,2,Morznak,2933,336,13,15,28,46.4%,13m
17971,2,Renato,2933,294,10,10,20,50.0%,3m
17971,3,Slimus,2933,144,8,5,13,61.5%,31m
17971,1,Daedalus,2933,97,4,3,7,57.1%,1h
17971,1,[AngryP]Splice,2933,98,4,9,13,30.8%,15m
17971,1,WujuMen,2933,95,2,1,3,66.7%,4m
17971,2,BeDBoBeR,2933,58,2,3,5,40.0%,4m
17971,3,Imgrisch,2933,0,1,0,1,100.0%,18m
17971,1,Terradani,2933,0,1,1,2,50.0%,14m
17971,1,Tezzomio,2933,0,1,1,2,50.0%,1h
17971,2,loloboom,2933,88,1,2,3,33.3%,19m
17971,1,Dreier,2933,97,1,6,7,14.3%,9m
17971,3,DeepFantasy,2933,0,0,1,1,0.0%,31m
17971,2,QuBuS,2933,0,0,1,1,0.0%,13m
17971,2,GeneralPaddz,2933,0,0,3,3,0.0%,13m
17971,2,minatofun,2933,0,0,3,3,0.0%,12m
17999,2,[JOPAKK]HgAg,2932,1016,149,169,318,46.9%,6m
17999,2,[NoLF]Brutaller,2932,1600,136,135,271,50.2%,19m
17999,3,Spartacus,2932,1672,113,102,215,52.6%,16m
17999,2,Mechanic,2932,1549,79,72,151,52.3%,32m
17999,2,ZappA,2932,1285,75,65,140,53.6%,19m
17999,2,MassDonfel,2932,1551,66,52,118,55.9%,21m
17999,1,RaJames,2932,1438,60,52,112,53.6%,20m
17999,2,Enfrnhy,2932,1188,47,46,93,50.5%,13m
17999,3,Tayoda,2932,974,40,55,95,42.1%,9m
17999,2,JohnnyGroove,2932,637,30,15,45,66.7%,32m
17999,3,Fragga,2932,615,23,15,38,60.5%,8m
17999,1,Sergii,2932,730,22,32,54,40.7%,10m
17999,2,KovarnyEnot,2932,476,21,11,32,65.6%,4m
17999,2,GoYa,2932,334,12,16,28,42.9%,19m
17999,1,korsarz,2932,261,11,10,21,52.4%,7m
17999,2,Rodrigorok,2932,278,9,8,17,52.9%,14m
17999,2,Orix,2932,268,9,13,22,40.9%,31m
17999,2,[hf4X4]ArthurDent,2932,219,8,4,12,66.7%,14m
17999,1,SigmaFactor,2932,96,5,4,9,55.6%,8m
17999,1,bumbar,2932,193,4,2,6,66.7%,1h
17999,1,JooTm,2932,97,2,0,2,100.0%,22m
17999,2,[We3eD]BananaJoe,2932,0,2,1,3,66.7%,1h
17999,2,TvTiME,2932,30,2,5,7,28.6%,3m
17999,3,[USSR02]LoLiK,2932,0,1,0,1,100.0%,18m
17999,1,Terran,2932,0,1,0,1,100.0%,45m
17999,2,MilkPerson,2932,30,1,2,3,33.3%,17m
17999,2,[FrFrog]SlipMarron,2932,30,1,4,5,20.0%,8m
17999,3,RocknRoLL,2932,0,0,1,1,0.0%,19m
17999,3,GummyBear,2932,0,0,1,1,0.0%,19m
17999,2,[XUL]Hybra,2932,0,0,5,5,0.0%,57m
18029,3,Sedkov,2931,846,230,224,454,50.7%,11m
18029,1,[КЕКS]LuckyBastard,2931,1568,188,170,358,52.5%,9m
18029,2,MondayKiz,2931,806,187,176,363,51.5%,16m
18029,2,Goosboow,2931,1549,136,135,271,50.2%,8m
18029,2,Skorpi,2931,862,115,114,229,50.2%,7m
18029,1,feador,2931,965,106,104,210,50.5%,14m
18029,1,nakedhero,2931,1150,42,50,92,45.7%,18m
18029,2,Hrvat,2931,795,40,36,76,52.6%,11m
18029,2,MhK,2931,704,29,25,54,53.7%,9m
18029,2,МАТЮХА,2931,570,21,20,41,51.2%,14m
18029,2,Paeffgen,2931,162,20,22,42,47.6%,4m
18029,2,lumpy,2931,343,17,14,31,54.8%,32m
18029,3,Gladi,2931,478,17,16,33,51.5%,11m
18029,2,CScitrons,2931,324,11,18,29,37.9%,10m
18029,2,MCMech,2931,283,10,11,21,47.6%,15m
18029,2,Ksuvec,2931,119,7,6,13,53.8%,19m
18029,3,DrBleff,2931,118,5,3,8,62.5%,15m
18029,2,Ace,2931,150,5,7,12,41.7%,11m
18029,3,NarenKat,2931,0,3,2,5,60.0%,17m
18029,2,Sesarr,2931,30,2,1,3,66.7%,6m
18029,3,Shadow,2931,113,2,1,3,66.7%,12m
18029,3,MrCanoodler,2931,30,1,1,2,50.0%,10m
18029,3,[HRisk]MONARCH,2931,30,1,1,2,50.0%,13m
18029,2,Ppok,2931,0,1,3,4,25.0%,14m
18029,3,[соклан]Данила,2931,0,1,3,4,25.0%,7m
18029,1,BadKarDar,2931,32,1,12,13,7.7%,22m
18029,3,Vasilisck,2931,0,0,1,1,0.0%,32m
18029,3,[Azimut]Morgoth,2931,0,0,1,1,0.0%,13m
18029,3,Big,2931,0,0,1,1,0.0%,19m
18029,2,[JSC]MightyBeast,2931,0,0,5,5,0.0%,14m
18059,1,ЗаурМайкоп,2930,1605,107,114,221,48.4%,31m
18059,3,aaaaa,2930,970,45,24,69,65.2%,18m
18059,1,Shann,2930,745,26,37,63,41.3%,8m
18059,3,OutPlayeD,2930,459,16,11,27,59.3%,20m
18059,2,Krismat,2930,415,16,14,30,53.3%,10m
18059,1,AnthonyNev,2930,488,16,22,38,42.1%,15m
18059,2,Roflich,2930,393,15,14,29,51.7%,8m
18059,1,haos,2930,324,14,12,26,53.8%,3m
18059,1,[So0]ORANGERANGE,2930,283,13,9,22,59.1%,1h
18059,2,IIJIACTbIPb,2930,254,11,7,18,61.1%,11m
18059,3,laow,2930,272,10,0,10,100.0%,7m
18059,2,Viciouz,2930,254,10,8,18,55.6%,59m
18059,2,Rockstone,2930,262,10,11,21,47.6%,31m
18059,2,stronix,2930,232,8,15,23,34.8%,32m
18059,2,Dizzy,2930,156,6,5,11,54.5%,19m
18059,2,[Nvalny]Neksis,2930,116,5,5,10,50.0%,20m
18059,2,brotherhood,2930,0,4,1,5,80.0%,8m
18059,2,[SEWP]FrostLight,2930,174,4,8,12,33.3%,19m
18059,2,poputu,2930,128,3,3,6,50.0%,5m
18059,2,BamBam,2930,62,2,4,6,33.3%,9m
18059,3,[OLDbad]deesh,2930,0,1,0,1,100.0%,16m
18059,3,Baygon,2930,0,1,0,1,100.0%,20m
18059,1,paddy,2930,48,1,3,4,25.0%,1h
18059,1,Raven,2930,0,1,6,7,14.3%,22m
18059,3,Topimo,2930,0,0,1,1,0.0%,17m
18059,1,[FF4L]Jojo,2930,0,0,1,1,0.0%,1h
18059,3,[O2Ds]Fufel,2930,0,0,1,1,0.0%,32m
18086,2,[ViNeo]Vitota,2929,1600,164,146,310,52.9%,8m
18086,2,LucianS,2929,935,118,115,233,50.6%,5m
18086,2,MagicSfx,2929,1552,73,55,128,57.0%,17m
18086,2,Cezane,2929,1285,56,53,109,51.4%,5m
18086,1,Gillesie,2929,855,52,45,97,53.6%,6m
18086,2,Chill,2929,892,44,34,78,56.4%,19m
18086,1,TJLiu,2929,888,43,44,87,49.4%,30m
18086,1,IMakeLings,2929,934,32,41,73,43.8%,22m
18086,2,TrolololMan,2929,647,26,22,48,54.2%,15m
18086,2,[MEJAIS]NeeslolseeN,2929,583,24,20,44,54.5%,11m
18086,2,sisk,2929,524,20,18,38,52.6%,12m
18086,2,Stofilius,2929,315,14,7,21,66.7%,4m
18086,3,llllllllllll,2929,269,11,8,19,57.9%,16m
18086,2,Antimirus,2929,340,11,17,28,39.3%,8m
18086,2,GeoGeo,2929,288,10,11,21,47.6%,14m
18086,1,[NotEM]Edpayasugo,2929,197,5,8,13,38.5%,30m
18086,1,nik,2929,96,4,2,6,66.7%,23m
18086,2,Winters,2929,100,3,2,5,60.0%,15m
18086,2,CAMAC,2929,92,3,6,9,33.3%,4m
18086,3,[4GYM]OniChan,2929,30,2,0,2,100.0%,16m
18086,3,Fiury,2929,30,2,0,2,100.0%,5m
18086,3,ceko,2929,117,2,2,4,50.0%,19m
18086,3,fanteroo,2929,0,1,0,1,100.0%,4m
18086,1,Roberto,2929,0,1,0,1,100.0%,45m
18086,2,[Dobro]киритис,2929,0,1,3,4,25.0%,31m
18086,2,Kalziver,2929,0,1,4,5,20.0%,15m
18086,2,[b0O0n]Azirne,2929,30,1,6,7,14.3%,6m
18086,1,Hezzu,2929,0,0,1,1,0.0%,1h
18086,3,Юляша,2929,0,0,1,1,0.0%,31m
18086,3,Kuka,2929,0,0,1,1,0.0%,12m
18086,1,[CocoCo]Sillenoz,2929,0,0,2,2,0.0%,1h
18086,2,Walrus,2929,0,0,2,2,0.0%,16m
18118,1,[ULTX]Shadowflame,2928,1206,375,358,733,51.2%,12m
18118,2,[NLTN]LittlePrince,2928,1216,176,168,344,51.2%,10m
18118,2,BLANK,2928,1370,61,47,108,56.5%,14m
18118,2,[TlGd]SirConçis,2928,870,37,27,64,57.8%,7m
18118,2,ari,2928,606,20,26,46,43.5%,9m
18118,1,Specialiste,2928,194,5,16,21,23.8%,18m
18118,3,[OРДА]батя,2928,88,4,1,5,80.0%,5m
18118,1,Ярослав,2928,122,4,6,10,40.0%,18m
18118,2,Dancer,2928,0,3,2,5,60.0%,1h
18118,2,[EpiT]OttoPsy,2928,128,3,3,6,50.0%,14m
18118,2,FishNett,2928,86,3,7,10,30.0%,7m
18118,2,COMMANDER,2928,88,2,1,3,66.7%,16m
18118,3,RacoD,2928,0,1,0,1,100.0%,21m
18118,2,[ATOM]Yoshi,2928,30,1,4,5,20.0%,15m
18118,3,[HollоW]JohnPhoenix,2928,0,0,1,1,0.0%,18m
18118,3,VanDread,2928,0,0,1,1,0.0%,1h
18118,3,[DIWOG]SgTPander,2928,0,0,1,1,0.0%,18m
18118,3,[Taldar]AuRoRa,2928,0,0,1,1,0.0%,4m
18118,3,Zerrick,2928,0,0,1,1,0.0%,16m
18118,3,[TODOW]warzplaying,2928,0,0,1,1,0.0%,13m
18118,2,[5O1st]Orbitalbomb,2928,0,0,2,2,0.0%,19m
18139,2,yoanicius,2927,1281,168,158,326,51.5%,5m
18139,2,TurboVnuk,2927,1563,134,122,256,52.3%,19m
18139,1,Tranduil,2927,907,131,122,253,51.8%,17m
18139,2,rabiddios,2927,922,46,42,88,52.3%,6m
18139,3,DarkPingDuck,2927,380,30,22,52,57.7%,14m
18139,3,SteamRoller,2927,551,20,13,33,60.6%,12m
18139,3,[mMcH]MeleeKeeper,2927,406,15,8,23,65.2%,19m
18139,1,[P4TW]LUX,2927,314,13,9,22,59.1%,55m
18139,1,Horizon,2927,278,12,11,23,52.2%,14m
18139,2,Frostmourne,2927,234,10,8,18,55.6%,1h
18139,3,Coolguy,2927,191,7,0,7,100.0%,4m
18139,1,[TSB]Arjen,2927,170,6,4,10,60.0%,49m
18139,3,IIIIIIIIIIII,2927,30,5,1,6,83.3%,14m
18139,2,Philistine,2927,114,3,2,5,60.0%,4m
18139,1,[agadou]ChokeNorris,2927,0,2,3,5,40.0%,22m
18139,3,CNB,2927,0,2,3,5,40.0%,15m
18139,2,FluAx,2927,0,1,1,2,50.0%,19m
18139,3,[mOguy]TheBlue,2927,36,1,2,3,33.3%,19m
18139,3,Ragnaros,2927,0,0,1,1,0.0%,9m
18139,3,smartteus,2927,0,0,1,1,0.0%,15m
18139,2,Ythast,2927,0,0,6,6,0.0%,21m
18160,1,Spiff,2926,1557,161,148,309,52.1%,5m
18160,2,[DR4ST1]myrhev,2926,1406,103,94,197,52.3%,11m
18160,1,[NWGD]GraphpiTTV,2926,1516,83,86,169,49.1%,18m
18160,1,PapaOurs,2926,1314,73,76,149,49.0%,18m
18160,2,Chocapic,2926,578,23,24,47,48.9%,11m
18160,2,ElSe,2926,503,22,13,35,62.9%,21m
18160,3,Terprozer,2926,483,18,9,27,66.7%,19m
18160,3,LKNR,2926,499,18,16,34,52.9%,14m
18160,1,Computer,2926,446,17,19,36,47.2%,30m
18160,2,SmoothDigger,2926,355,14,10,24,58.3%,19m
18160,2,BeAnTer,2926,293,13,8,21,61.9%,6m
18160,2,Sephiro,2926,332,13,13,26,50.0%,19m
18160,3,Ellumination,2926,218,9,3,12,75.0%,19m
18160,1,[RBP3]GeScorpion,2926,254,7,16,23,30.4%,3m
18160,3,Overed,2926,116,5,1,6,83.3%,19m
18160,1,Schneizel,2926,184,5,10,15,33.3%,21m
18160,3,Zesty,2926,101,4,4,8,50.0%,20m
18160,3,Найвард,2926,58,3,0,3,100.0%,4m
18160,3,BDCaddict,2926,0,3,2,5,60.0%,11m
18160,3,[KNCHT]schaeff,2926,0,3,2,5,60.0%,13m
18160,2,DonCapitán,2926,0,3,2,5,60.0%,17m
18160,3,Demetris,2926,0,3,2,5,60.0%,7m
18160,1,krs,2926,168,3,3,6,50.0%,1h
18160,3,DrArtanis,2926,30,3,3,6,50.0%,21m
18160,2,[GDMK]sensemilla,2926,0,2,2,4,50.0%,8m
18160,2,Simps,2926,112,2,3,5,40.0%,17m
18160,2,[ayyyyy]Stormlight,2926,0,1,1,2,50.0%,16m
18160,2,[Zeggg]flindpark,2926,93,1,3,4,25.0%,13m
18160,3,Dekker,2926,0,0,1,1,0.0%,8m
18160,3,SokolDV,2926,0,0,1,1,0.0%,13m
18160,1,GGGLHF,2926,0,0,1,1,0.0%,55m
18160,2,aza,2926,0,0,2,2,0.0%,8m
18192,2,Toni,2925,1580,240,229,469,51.2%,16m
18192,2,Саня,2925,1562,151,126,277,54.5%,8m
18192,2,Mokuton,2925,800,95,81,176,54.0%,8m
18192,3,XiaoGe,2925,856,93,79,172,54.1%,7m
18192,1,Atadracula,2925,992,92,88,180,51.1%,11m
18192,2,Subzero,2925,1267,51,49,100,51.0%,14m
18192,2,Romuloyd,2925,677,34,37,71,47.9%,19m
18192,3,GodsWill,2925,420,23,16,39,59.0%,15m
18192,2,[GMSC]MasterBruce,2925,664,23,28,51,45.1%,19m
18192,2,[ATSEV]blux,2925,551,21,20,41,51.2%,20m
18192,2,Serp,2925,422,19,14,33,57.6%,10m
18192,1,[MarSto]angrycousin,2925,477,17,19,36,47.2%,18m
18192,2,MrMayhem,2925,343,12,10,22,54.5%,21m
18192,1,[HZeS]CheckLeds,2925,282,12,11,23,52.2%,31m
18192,1,JakalVK,2925,190,7,5,12,58.3%,13m
18192,2,defouy,2925,204,7,5,12,58.3%,15m
18192,2,Todoresste,2925,178,7,7,14,50.0%,8m
18192,1,JOSE,2925,183,6,4,10,60.0%,14m
18192,2,Basilios,2925,184,6,5,11,54.5%,19m
18192,2,[tDKe]NeON,2925,120,5,5,10,50.0%,11m
18192,3,[ForAut]Tosik,2925,88,4,2,6,66.7%,19m
18192,3,[IceCub]Meow,2925,114,4,3,7,57.1%,19m
18192,3,SADIST,2925,152,4,4,8,50.0%,18m
18192,1,lowIqProtoss,2925,106,4,11,15,26.7%,19m
18192,2,llllllll,2925,0,3,1,4,75.0%,16m
18192,2,Darkheaven,2925,0,3,2,5,60.0%,1h
18192,3,gglanaya,2925,0,3,2,5,60.0%,16m
18192,2,TheStig,2925,0,3,2,5,60.0%,56m
18192,2,mxp,2925,86,3,7,10,30.0%,15m
18192,2,[XYX21]tatamumu,2925,88,2,1,3,66.7%,11m
18192,2,[druPa]Bro,2925,34,2,6,8,25.0%,19m
18192,2,Green,2925,0,1,1,2,50.0%,4m
18192,3,rama,2925,18,1,1,2,50.0%,4m
18192,3,[TrouBå]Spacevinz,2925,30,1,2,3,33.3%,14m
18192,3,drkorte,2925,0,0,1,1,0.0%,12m
18192,3,Finata,2925,0,0,1,1,0.0%,9m
18192,1,YoRHa,2925,0,0,1,1,0.0%,52m
18192,2,[TSTG]Joshiso,2925,0,0,2,2,0.0%,17m
18192,2,VOLVO,2925,0,0,2,2,0.0%,15m
18192,2,Artemid,2925,0,0,4,4,0.0%,4m
18232,1,MoNsTeR,2924,951,284,264,548,51.8%,20m
18232,2,Loza,2924,1473,271,249,520,52.1%,19m
18232,2,Cracknut,2924,1010,57,54,111,51.4%,19m
18232,2,Florenden,2924,1003,53,57,110,48.2%,5m
18232,1,HillendBoa,2924,1138,42,47,89,47.2%,19m
18232,1,[G0A]Eleven,2924,796,33,31,64,51.6%,15m
18232,1,Vjuk,2924,361,29,28,57,50.9%,17m
18232,2,Erol,2924,630,28,17,45,62.2%,7m
18232,2,Driver,2924,736,26,29,55,47.3%,8m
18232,2,Gewurzbombe,2924,535,22,19,41,53.7%,17m
18232,2,Mytology,2924,283,11,7,18,61.1%,7m
18232,3,Alkyoon,2924,256,11,8,19,57.9%,16m
18232,2,xMordi,2924,274,10,10,20,50.0%,58m
18232,2,Billyboy,2924,150,10,13,23,43.5%,15m
18232,3,[Arrows]kooverkalo,2924,184,9,7,16,56.2%,32m
18232,3,[Arrows]Dmitry,2924,101,8,19,27,29.6%,32m
18232,2,Dgeo,2924,0,4,1,5,80.0%,1h
18232,1,[Fenzy]Humblegar,2924,90,3,6,9,33.3%,17m
18232,2,[DJ9000]pullthetrick,2924,88,2,1,3,66.7%,12m
18232,2,[EKC]Radactive,2924,102,2,3,5,40.0%,15m
18232,3,NannyState,2924,0,1,0,1,100.0%,4m
18232,3,Анатолий,2924,0,0,1,1,0.0%,5m
18232,3,TalTheNew,2924,0,0,1,1,0.0%,31m
18232,1,HaWK,2924,0,0,3,3,0.0%,60m
18232,1,[BigBof]psycopat,2924,0,0,3,3,0.0%,20m
18257,3,Hocus,2923,1312,61,34,95,64.2%,19m
18257,2,Niyaogouwoma,2923,1261,60,41,101,59.4%,4m
18257,1,elementmd,2923,1222,48,44,92,52.2%,20m
18257,2,DeleteProtos,2923,808,45,39,84,53.6%,32m
18257,3,Sven,2923,874,35,27,62,56.5%,15m
18257,3,KInGMArinE,2923,619,28,10,38,73.7%,6m
18257,2,Gendish,2923,586,22,22,44,50.0%,17m
18257,1,[G2C]Timmar,2923,489,21,20,41,51.2%,14m
18257,2,Peacedata,2923,394,15,18,33,45.5%,4m
18257,2,[BsG]Aria,2923,270,11,9,20,55.0%,15m
18257,2,Catch,2923,317,11,10,21,52.4%,15m
18257,2,Jaimevh,2923,241,10,10,20,50.0%,10m
18257,2,KARNAVAL,2923,204,9,7,16,56.2%,13m
18257,3,Mosya,2923,203,8,7,15,53.3%,18m
18257,3,[VXM]Darkness,2923,235,7,2,9,77.8%,13m
18257,1,[Xa]Asso,2923,48,6,2,8,75.0%,1h
18257,2,RayVA,2923,182,6,9,15,40.0%,22m
18257,3,Maxazac,2923,93,5,4,9,55.6%,9m
18257,2,DarkEvo,2923,167,5,4,9,55.6%,19m
18257,3,Yuve,2923,118,4,3,7,57.1%,32m
18257,1,[Gachi7]Bloodborn,2923,120,3,1,4,75.0%,1h
18257,2,Danos,2923,58,3,4,7,42.9%,14m
18257,2,[antkr]nirtz,2923,128,3,4,7,42.9%,4m
18257,2,Laertes,2923,58,3,5,8,37.5%,11m
18257,1,[UKRA1N]Aibek,2923,96,2,5,7,28.6%,58m
18257,3,Volodymyr,2923,30,1,1,2,50.0%,18m
18257,3,Platanov,2923,30,1,2,3,33.3%,19m
18257,1,snezhok,2923,0,1,3,4,25.0%,20m
18257,2,Roolin,2923,30,1,4,5,20.0%,10m
18257,1,qOOp,2923,0,0,2,2,0.0%,46m
18257,3,nosferatu,2923,0,0,5,5,0.0%,32m
18288,1,[GML]pilesmeker,2922,1619,167,156,323,51.7%,9m
18288,3,StarPlayer,2922,1616,95,72,167,56.9%,19m
18288,2,Ruslan,2922,1425,93,78,171,54.4%,16m
18288,1,[KEDR]Irji,2922,1637,61,67,128,47.7%,6m
18288,1,Pulse,2922,1471,57,56,113,50.4%,9m
18288,1,[OTLSS]WINDFIRE,2922,1223,54,54,108,50.0%,13m
18288,2,Protain,2922,983,48,35,83,57.8%,13m
18288,3,[Xa]shini,2922,908,43,38,81,53.1%,9m
18288,3,Timo,2922,1190,40,54,94,42.6%,19m
18288,2,[z666z]MakeMyWeapon,2922,836,31,35,66,47.0%,11m
18288,2,[BCM]Iceman,2922,780,30,27,57,52.6%,17m
18288,3,Alex,2922,565,25,18,43,58.1%,9m
18288,2,[mfixed]komarzycho,2922,332,14,9,23,60.9%,14m
18288,2,[S1NS]BarCodeKilla,2922,233,9,11,20,45.0%,9m
18288,1,wentastray,2922,215,9,15,24,37.5%,17m
18288,2,[PAHE]Cid,2922,214,7,13,20,35.0%,5m
18288,3,ZiKEpic,2922,148,6,3,9,66.7%,22m
18288,2,Polnikov,2922,130,5,1,6,83.3%,20m
18288,1,vadimjim,2922,102,5,5,10,50.0%,8m
18288,2,glhf,2922,116,4,3,7,57.1%,16m
18288,3,qsdqsd,2922,86,3,1,4,75.0%,16m
18288,3,JLG,2922,0,3,2,5,60.0%,20m
18288,3,Freddy,2922,0,3,2,5,60.0%,22m
18288,3,DiGiTALWiNG,2922,0,3,2,5,60.0%,11m
18288,3,Siven,2922,0,3,2,5,60.0%,6m
18288,2,Shokyu,2922,140,3,4,7,42.9%,32m
18288,2,Obliterator,2922,105,2,3,5,40.0%,16m
18288,2,netrom,2922,58,2,4,6,33.3%,7m
18288,2,[DSAS]darkice,2922,60,2,4,6,33.3%,20m
18288,3,Fboy,2922,93,2,5,7,28.6%,8m
18288,2,captainNEMO,2922,0,1,1,2,50.0%,17m
18288,3,llllllllllll,2922,0,1,2,3,33.3%,10m
18288,2,BobrBeta,2922,30,1,3,4,25.0%,9m
18288,3,[369]Regulus,2922,0,1,4,5,20.0%,5m
18288,3,Зетти,2922,0,0,1,1,0.0%,17m
18288,1,[K0RM2]ХмурыйМонах,2922,0,0,1,1,0.0%,1h
18288,2,Slayn,2922,0,0,2,2,0.0%,1h
18325,2,capsicum,2921,1628,521,502,1023,50.9%,11m
18325,1,Dvolkeen,2921,1601,381,346,727,52.4%,31m
18325,1,Performer,2921,1287,116,106,222,52.3%,15m
18325,2,voji,2921,1607,112,112,224,50.0%,11m
18325,1,Nero,2921,559,52,60,112,46.4%,10m
18325,3,Quip,2921,1143,46,34,80,57.5%,12m
18325,1,[SNBS]PeP,2921,370,34,44,78,43.6%,13m
18325,2,[HlvtG]RKnightxX,2921,734,32,21,53,60.4%,10m
18325,2,silver,2921,657,27,20,47,57.4%,31m
18325,2,[mfixed]Craft,2921,572,26,18,44,59.1%,14m
18325,2,iamzeus,2921,628,23,25,48,47.9%,3m
18325,2,SALCHICHÓN,2921,568,20,23,43,46.5%,14m
18325,3,llllllllllll,2921,424,18,4,22,81.8%,5m
18325,3,Lou,2921,355,14,11,25,56.0%,19m
18325,2,[QSPT]Marosato,2921,316,12,12,24,50.0%,32m
18325,1,LAV,2921,350,12,19,31,38.7%,6m
18325,2,Cronos,2921,150,10,4,14,71.4%,10m
18325,1,[NiN]NiNjadO,2921,281,10,14,24,41.7%,12m
18325,2,Murdoch,2921,212,7,11,18,38.9%,16m
18325,3,[MadKuy]Kita,2921,184,7,17,24,29.2%,9m
18325,3,[KLTS]Kaeltes,2921,144,6,3,9,66.7%,9m
18325,3,[xPCSx]IronHeart,2921,86,5,5,10,50.0%,7m
18325,3,Shinryu,2921,30,4,2,6,66.7%,22m
18325,3,[OBSCU]Loghost,2921,0,3,2,5,60.0%,18m
18325,1,PolderPloer,2921,48,2,1,3,66.7%,60m
18325,3,[ZERGTB]Lost,2921,30,2,1,3,66.7%,18m
18325,3,Amoralex,2921,0,2,2,4,50.0%,16m
18325,2,Kapo,2921,30,2,5,7,28.6%,31m
18325,2,BattleRap,2921,0,1,1,2,50.0%,10m
18325,2,llllllllllll,2921,30,1,3,4,25.0%,10m
18325,2,[BetAlf]BlackSheep,2921,0,1,4,5,20.0%,1h
18325,3,[laalal]Alexander,2921,0,0,1,1,0.0%,11m
18325,1,HeroZergling,2921,0,0,1,1,0.0%,22m
18325,3,KotoK,2921,0,0,1,1,0.0%,12m
18359,2,Ren,2920,1444,190,184,374,50.8%,4m
18359,3,SaintDX,2920,1600,110,68,178,61.8%,8m
18359,1,Sema,2920,1552,105,96,201,52.2%,16m
18359,3,Noora,2920,740,80,78,158,50.6%,19m
18359,1,fox,2920,1502,74,76,150,49.3%,13m
18359,2,ведьма,2920,1497,74,78,152,48.7%,11m
18359,1,[SunTry]беды,2920,1066,71,64,135,52.6%,5m
18359,2,DabOnExpand,2920,650,31,25,56,55.4%,16m
18359,2,pikAXE,2920,367,14,20,34,41.2%,17m
18359,1,[PLA2N]TiTan,2920,149,11,7,18,61.1%,10m
18359,2,[МŴŚ]Toto,2920,298,11,14,25,44.0%,12m
18359,3,KimYoungHo,2920,309,10,9,19,52.6%,16m
18359,2,Exodus,2920,219,9,4,13,69.2%,13m
18359,2,[HudraD]Omegon,2920,226,7,9,16,43.8%,11m
18359,3,blubblub,2920,146,6,18,24,25.0%,10m
18359,2,tachibana,2920,161,5,1,6,83.3%,15m
18359,2,Lyn,2920,0,3,2,5,60.0%,1h
18359,3,[Valise]skocakk,2920,137,3,3,6,50.0%,4m
18359,3,AranSIRE,2920,58,2,1,3,66.7%,12m
18359,2,Twister,2920,88,2,1,3,66.7%,10m
18359,2,Emixam,2920,0,1,0,1,100.0%,1h
18359,2,DIY,2920,0,1,1,2,50.0%,4m
18359,3,Performance,2920,0,0,1,1,0.0%,17m
18359,2,SuperBoy,2920,0,0,2,2,0.0%,4m
18359,2,Patibond,2920,0,0,4,4,0.0%,17m
18359,2,kisas,2920,0,0,5,5,0.0%,14m
18385,3,Fridge,2919,1306,100,76,176,56.8%,5m
18385,2,IIIIIIIIIIII,2919,1308,96,77,173,55.5%,19m
18385,2,RGǃXenon,2919,1362,57,51,108,52.8%,16m
18385,3,[RSH21]Ziltoid,2919,846,47,27,74,63.5%,19m
18385,2,Lovespoonx,2919,1224,46,52,98,46.9%,10m
18385,2,[RеG]Gas,2919,683,43,44,87,49.4%,5m
18385,1,MichalO,2919,1096,39,45,84,46.4%,19m
18385,2,Rins,2919,378,20,17,37,54.1%,19m
18385,1,PowMeow,2919,582,18,26,44,40.9%,20m
18385,1,llllllllllll,2919,280,9,10,19,47.4%,16m
18385,3,Cobumbo,2919,86,7,2,9,77.8%,15m
18385,2,Bullepower,2919,120,5,7,12,41.7%,19m
18385,2,Cash,2919,154,5,9,14,35.7%,19m
18385,1,Vagabond,2919,0,4,2,6,66.7%,1h
18385,1,Mishra,2919,97,4,3,7,57.1%,49m
18385,3,Bier,2919,0,3,2,5,60.0%,19m
18385,2,Forever,2919,78,3,6,9,33.3%,14m
18385,2,[xFRSx]Keketka,2919,58,3,7,10,30.0%,16m
18385,2,Pizza,2919,0,2,3,5,40.0%,53m
18385,2,Zulla,2919,0,1,5,6,16.7%,16m
18385,2,Rajzer,2919,30,1,5,6,16.7%,10m
18385,3,подчас,2919,0,0,1,1,0.0%,18m
18407,2,Fero,2918,1587,135,121,256,52.7%,22m
18407,3,Inxe,2918,922,67,68,135,49.6%,4m
18407,1,Vovik,2918,1048,63,63,126,50.0%,5m
18407,3,[6L6]pancakes,2918,1342,57,49,106,53.8%,14m
18407,2,slav,2918,753,34,23,57,59.6%,11m
18407,2,МеДвеДыЧ,2918,724,32,27,59,54.2%,8m
18407,3,[WCKYLN]Geschlossen,2918,674,27,19,46,58.7%,8m
18407,3,Rafa,2918,706,23,41,64,35.9%,22m
18407,2,Tubbe,2918,385,20,22,42,47.6%,14m
18407,3,Touba,2918,431,16,11,27,59.3%,19m
18407,2,Nissonite,2918,190,8,2,10,80.0%,17m
18407,2,infinitevoid,2918,240,8,5,13,61.5%,21m
18407,2,[Hawd]KRrum,2918,190,7,4,11,63.6%,4m
18407,1,ODViper,2918,163,5,4,9,55.6%,1h
18407,2,Fogs,2918,58,3,3,6,50.0%,13m
18407,2,Rcvtheninja,2918,60,3,4,7,42.9%,8m
18407,3,Fenor,2918,30,2,0,2,100.0%,6m
18407,1,spawnferkel,2918,94,2,0,2,100.0%,49m
18407,3,FaTaLiTy,2918,0,2,3,5,40.0%,22m
18407,3,[VitaE]DREDSTAR,2918,0,0,1,1,0.0%,4m
18407,2,[fische]CaptainFisch,2918,0,0,3,3,0.0%,4m
18428,2,feducio,2917,1634,265,246,511,51.9%,14m
18428,2,crazyman,2917,1530,141,130,271,52.0%,9m
18428,2,[OMGK]TchiTchi,2917,1398,90,84,174,51.7%,22m
18428,2,[2C]HEAVY,2917,863,54,49,103,52.4%,20m
18428,2,Nasty,2917,1109,47,43,90,52.2%,19m
18428,2,Echo,2917,784,44,22,66,66.7%,17m
18428,2,WixKrabbe,2917,1033,44,35,79,55.7%,32m
18428,2,Ipe,2917,931,35,35,70,50.0%,17m
18428,2,[DutchG]Deliciata,2917,964,35,40,75,46.7%,22m
18428,1,Shrunkai,2917,640,21,30,51,41.2%,15m
18428,2,Serega,2917,331,20,23,43,46.5%,32m
18428,1,Gautama,2917,294,10,12,22,45.5%,18m
18428,1,Jack,2917,150,9,7,16,56.2%,10m
18428,3,AllenDulles,2917,108,5,3,8,62.5%,19m
18428,2,MelonMint,2917,203,5,4,9,55.6%,22m
18428,2,Freakix,2917,0,3,2,5,60.0%,1h
18428,2,cRYZ,2917,140,3,8,11,27.3%,49m
18428,3,Xpomocoma,2917,0,1,0,1,100.0%,32m
18428,3,GeneralZod,2917,0,1,0,1,100.0%,13m
18428,3,Solvo,2917,0,1,0,1,100.0%,14m
18428,3,IIIIIIIIIIII,2917,0,1,0,1,100.0%,10m
18428,1,Hobson,2917,0,1,0,1,100.0%,1h
18428,2,[WYG]blitzkrieg,2917,0,1,1,2,50.0%,6m
18428,2,Shkologamer,2917,30,1,4,5,20.0%,6m
18428,3,Planetshaker,2917,0,0,1,1,0.0%,20m
18428,3,[Наште]HEHOF,2917,0,0,1,1,0.0%,16m
18428,3,[BIBO]SiriusFaris,2917,0,0,1,1,0.0%,17m
18428,2,Anatoliy,2917,0,0,1,1,0.0%,1h
18456,3,AlWahad,2916,1500,263,263,526,50.0%,7m
18456,2,despedudu,2916,836,55,45,100,55.0%,15m
18456,2,respect,2916,1027,40,39,79,50.6%,21m
18456,1,ALE,2916,928,37,38,75,49.3%,9m
18456,2,null,2916,878,33,33,66,50.0%,14m
18456,1,Niüt,2916,838,33,35,68,48.5%,9m
18456,1,[NG0ld]CarryPotter,2916,599,26,27,53,49.1%,18m
18456,1,Prevor,2916,594,26,30,56,46.4%,8m
18456,2,WanniX,2916,572,23,17,40,57.5%,16m
18456,1,Markowitz,2916,610,23,23,46,50.0%,30m
18456,2,Vendetta,2916,247,22,15,37,59.5%,11m
18456,3,[EMRS]Graps,2916,463,18,15,33,54.5%,22m
18456,2,JaooD,2916,385,15,14,29,51.7%,11m
18456,2,CoOons,2916,398,14,14,28,50.0%,6m
18456,3,ZeaL,2916,173,11,14,25,44.0%,32m
18456,3,[COXCO]Immortal,2916,288,10,7,17,58.8%,16m
18456,3,DABO,2916,232,9,8,17,52.9%,50m
18456,1,Skriming,2916,253,9,12,21,42.9%,54m
18456,2,PrudEnce,2916,194,8,4,12,66.7%,6m
18456,1,[GGZERG]Future,2916,230,8,16,24,33.3%,15m
18456,2,mastG,2916,168,6,4,10,60.0%,15m
18456,2,CheeseTown,2916,102,4,3,7,57.1%,5m
18456,3,Babo,2916,0,3,2,5,60.0%,31m
18456,1,Fearles,2916,68,3,5,8,37.5%,18m
18456,1,[DcksQ]Nor,2916,90,3,7,10,30.0%,12m
18456,3,LuSmile,2916,58,2,3,5,40.0%,14m
18456,3,RandomJoker,2916,0,1,0,1,100.0%,17m
18456,2,PROJECTAILED,2916,0,1,1,2,50.0%,12m
18456,2,UwU,2916,30,1,3,4,25.0%,32m
18456,3,Legoshi,2916,0,0,1,1,0.0%,33m
18456,3,Zeal,2916,0,0,1,1,0.0%,5m
18487,1,Titus,2915,1625,463,460,923,50.2%,16m
18487,2,Streamer,2915,728,90,79,169,53.3%,12m
18487,2,Fentazito,2915,1554,85,76,161,52.8%,18m
18487,1,MadFury,2915,1315,74,79,153,48.4%,22m
18487,3,Pumba,2915,825,40,33,73,54.8%,16m
18487,1,Mayreau,2915,1117,39,46,85,45.9%,16m
18487,2,[SkBG]CamBiX,2915,204,22,18,40,55.0%,6m
18487,2,choOkobOo,2915,414,19,13,32,59.4%,15m
18487,1,kaboombaby,2915,392,16,20,36,44.4%,15m
18487,1,serbzero,2915,488,15,25,40,37.5%,15m
18487,2,[WYV]Othello,2915,334,13,15,28,46.4%,17m
18487,2,koma,2915,368,13,17,30,43.3%,31m
18487,2,Cristi,2915,231,10,5,15,66.7%,15m
18487,3,Iowa,2915,169,8,7,15,53.3%,19m
18487,3,KiteU,2915,118,4,3,7,57.1%,18m
18487,2,llllllllllll,2915,190,4,9,13,30.8%,14m
18487,2,[Narnia]JustinReaper,2915,113,3,2,5,60.0%,19m
18487,2,[NoGy]Sisko,2915,60,3,5,8,37.5%,22m
18487,3,Romarik,2915,0,1,0,1,100.0%,22m
18487,3,GreGor,2915,0,1,0,1,100.0%,16m
18487,3,gosha,2915,0,1,0,1,100.0%,18m
18487,3,cоndomring,2915,30,1,1,2,50.0%,15m
18487,2,TrashPanda,2915,0,1,2,3,33.3%,11m
18487,1,exercios,2915,0,1,6,7,14.3%,30m
18487,3,[Krusti]Carma,2915,0,0,1,1,0.0%,15m
18487,3,Sherly,2915,0,0,1,1,0.0%,32m
18487,3,Onti,2915,0,0,1,1,0.0%,20m
18487,2,pryaniksex,2915,0,0,4,4,0.0%,1h
18487,2,Cap,2915,0,0,5,5,0.0%,1h
18516,3,AcidSmile,2914,1471,284,283,567,50.1%,6m
18516,2,RedPatrick,2914,1440,212,195,407,52.1%,16m
18516,3,[sormov]kyzma,2914,1527,122,124,246,49.6%,7m
18516,2,WarlorD,2914,1423,67,58,125,53.6%,7m
18516,1,BENDABAL,2914,1060,35,45,80,43.8%,13m
18516,2,RealJuice,2914,885,34,30,64,53.1%,8m
18516,2,ArjiMan,2914,720,29,25,54,53.7%,32m
18516,3,Robert,2914,529,28,20,48,58.3%,19m
18516,3,EndSuffering,2914,604,24,21,45,53.3%,14m
18516,3,Ledenec,2914,528,24,22,46,52.2%,6m
18516,2,MiNeDroppeR,2914,303,11,9,20,55.0%,14m
18516,2,NukeDeVandal,2914,151,9,13,22,40.9%,8m
18516,3,DaZiim,2914,211,8,4,12,66.7%,9m
18516,2,CityzeN,2914,219,8,6,14,57.1%,8m
18516,3,Furax,2914,182,7,4,11,63.6%,50m
18516,2,DerIch,2914,168,6,9,15,40.0%,4m
18516,3,swibberman,2914,149,5,3,8,62.5%,1h
18516,2,[DOKA2]СтарыйВолк,2914,130,4,2,6,66.7%,6m
18516,2,Hobtroll,2914,88,4,4,8,50.0%,5m
18516,2,goira,2914,92,4,8,12,33.3%,7m
18516,2,DrRudi,2914,30,3,5,8,37.5%,16m
18516,3,FaKeR,2914,30,2,0,2,100.0%,16m
18516,3,[dristГ]DarthVader,2914,0,1,0,1,100.0%,16m
18516,2,[QueenG]Жадная,2914,0,1,3,4,25.0%,8m
18516,2,OPOP,2914,30,1,4,5,20.0%,10m
18516,2,Sequoia,2914,30,1,5,6,16.7%,13m
18516,3,Jdot,2914,0,0,1,1,0.0%,10m
18516,3,[VAK]Visnia,2914,0,0,1,1,0.0%,20m
18516,3,Rimskiy,2914,0,0,1,1,0.0%,17m
18516,1,[VLDLOX]JackCollins,2914,0,0,1,1,0.0%,1h
18516,2,[Fen]LLynser,2914,0,0,3,3,0.0%,4m
18516,1,[ÆR]Shiro,2914,0,0,5,5,0.0%,1h
18548,1,Athen,2913,1497,272,270,542,50.2%,31m
18548,1,Snow,2913,1507,88,85,173,50.9%,19m
18548,2,SilverGM,2913,683,83,54,137,60.6%,13m
18548,1,lecarotte,2913,885,74,73,147,50.3%,22m
18548,3,Rich,2913,1106,46,46,92,50.0%,32m
18548,2,JustTerran,2913,638,45,34,79,57.0%,15m
18548,1,Limp,2913,472,17,16,33,51.5%,13m
18548,2,Ico,2913,450,16,20,36,44.4%,6m
18548,2,[VL0rds]VoidMax,2913,375,15,12,27,55.6%,17m
18548,2,Серега,2913,331,13,10,23,56.5%,15m
18548,2,Callum,2913,326,11,12,23,47.8%,14m
18548,3,[InitRu]ozrKeLL,2913,192,8,4,12,66.7%,8m
18548,2,BabiboB,2913,168,5,4,9,55.6%,13m
18548,2,SunLight,2913,120,5,6,11,45.5%,13m
18548,3,[BWArmy]Maxpgame,2913,0,4,1,5,80.0%,15m
18548,3,[BÄÄM]Schiggi,2913,0,3,2,5,60.0%,4m
18548,1,Ztee,2913,0,3,2,5,60.0%,10m
18548,2,[DERMID]DERICTOR,2913,88,2,1,3,66.7%,22m
18548,2,rainbowXK,2913,30,2,1,3,66.7%,15m
18548,2,Gravemind,2913,0,2,3,5,40.0%,20m
18548,2,Fede,2913,60,2,6,8,25.0%,5m
18548,3,Mark,2913,0,1,0,1,100.0%,19m
18548,1,[IDER]Grummy,2913,93,1,1,2,50.0%,49m
18548,1,[Zhig]Horton,2913,0,1,2,3,33.3%,1h
18548,2,Duke,2913,30,1,3,4,25.0%,14m
18548,2,[HHydra]BeKey,2913,0,1,5,6,16.7%,15m
18548,1,Loli,2913,0,1,6,7,14.3%,1h
18548,3,llllllllllll,2913,0,0,1,1,0.0%,4m
18548,3,Doorer,2913,0,0,1,1,0.0%,7m
18577,2,Evarist,2912,1276,99,80,179,55.3%,14m
18577,1,Cosmic,2912,1575,98,96,194,50.5%,9m
18577,2,Quentin,2912,300,49,43,92,53.3%,5m
18577,1,[2097]NTD,2912,208,31,34,65,47.7%,21m
18577,2,huitza,2912,610,24,21,45,53.3%,14m
18577,2,MelonLord,2912,576,20,24,44,45.5%,13m
18577,2,doidantonQ,2912,442,15,19,34,44.1%,13m
18577,2,JACKPWNS,2912,192,11,7,18,61.1%,10m
18577,3,[J4E]Golddragon,2912,246,9,2,11,81.8%,19m
18577,2,GreyNight,2912,260,9,11,20,45.0%,22m
18577,2,КотУбийца,2912,219,8,5,13,61.5%,19m
18577,1,[necron]Chuck,2912,190,6,16,22,27.3%,22m
18577,1,Ecchymose,2912,120,5,4,9,55.6%,22m
18577,2,[Bruk]TTk,2912,120,5,5,10,50.0%,19m
18577,1,Barmin,2912,169,5,5,10,50.0%,15m
18577,1,SLIULTRON,2912,176,4,6,10,40.0%,18m
18577,3,ZeroXALR,2912,86,3,2,5,60.0%,13m
18577,3,Endurance,2912,0,3,2,5,60.0%,6m
18577,3,[TAW]Pote,2912,58,2,1,3,66.7%,21m
18577,1,Stringset,2912,97,2,1,3,66.7%,9m
18577,2,Ragnar,2912,0,2,3,5,40.0%,9m
18577,1,[Herz]Isengrim,2912,97,2,5,7,28.6%,58m
18577,2,DevilBros,2912,128,2,10,12,16.7%,8m
18577,2,Rejendo,2912,0,1,0,1,100.0%,1h
18577,3,MacDi,2912,0,1,0,1,100.0%,9m
18577,2,[DaUz]PyuK,2912,0,1,1,2,50.0%,13m
18577,3,drugwonder,2912,30,1,1,2,50.0%,12m
18577,2,[ZYZ]Cíbanz,2912,88,1,3,4,25.0%,11m
18577,1,RDSSL,2912,0,0,1,1,0.0%,12m
18577,3,StarKillers,2912,0,0,1,1,0.0%,32m
18577,1,[BEVO]Arthurmaboul,2912,0,0,1,1,0.0%,8m
18577,3,StewGlue,2912,0,0,1,1,0.0%,18m
18577,2,Magase,2912,0,0,2,2,0.0%,59m
18577,2,MmAaXx,2912,0,0,2,2,0.0%,10m
18611,1,Ted,2911,1633,638,642,1280,49.8%,21m
18611,1,[UGeeks]magg,2911,1620,165,175,340,48.5%,20m
18611,3,laws,2911,891,123,105,228,53.9%,5m
18611,1,[ephia]renzosmz,2911,1540,61,68,129,47.3%,31m
18611,2,PINATA,2911,732,35,20,55,63.6%,15m
18611,2,malkontent,2911,729,29,34,63,46.0%,13m
18611,2,[SoLu]JONS,2911,610,26,22,48,54.2%,6m
18611,2,outbounder,2911,564,24,16,40,60.0%,8m
18611,2,herOS,2911,304,20,20,40,50.0%,8m
18611,3,Aspire,2911,334,15,11,26,57.7%,11m
18611,2,Feorianin,2911,432,15,14,29,51.7%,19m
18611,3,Viper,2911,319,14,16,30,46.7%,9m
18611,2,Kiarna,2911,375,13,13,26,50.0%,4m
18611,2,Ganon,2911,234,11,6,17,64.7%,7m
18611,2,[hungri]Snarf,2911,243,10,10,20,50.0%,9m
18611,1,Viktor,2911,244,7,17,24,29.2%,8m
18611,1,itybityzergy,2911,122,5,3,8,62.5%,1h
18611,2,Nobad,2911,148,5,8,13,38.5%,21m
18611,2,xFlake,2911,206,5,9,14,35.7%,6m
18611,3,[TIGER5]joe,2911,0,3,1,4,75.0%,19m
18611,3,DjekForser,2911,0,3,2,5,60.0%,33m
18611,3,KOXA,2911,0,3,2,5,60.0%,11m
18611,2,hitow,2911,30,2,4,6,33.3%,6m
18611,3,xXMeepXx,2911,30,1,1,2,50.0%,32m
18611,3,Distance,2911,30,1,2,3,33.3%,17m
18611,3,andrrejos,2911,30,1,2,3,33.3%,31m
18611,3,Mishaem,2911,0,0,1,1,0.0%,16m
18611,3,MACH,2911,0,0,1,1,0.0%,18m
18611,2,[WoodHd]GhostSR,2911,0,0,2,2,0.0%,19m
18611,2,nnn,2911,0,0,2,2,0.0%,19m
18641,1,Byron,2910,1612,150,159,309,48.5%,22m
18641,2,himmel,2910,749,86,88,174,49.4%,8m
18641,2,Desmild,2910,873,38,29,67,56.7%,18m
18641,2,IIIIIIIIIIII,2910,484,34,36,70,48.6%,32m
18641,1,MOKI,2910,714,28,27,55,50.9%,6m
18641,1,Werhunter,2910,571,20,27,47,42.6%,11m
18641,2,Glaucos,2910,459,18,14,32,56.2%,14m
18641,2,Ebukentiy,2910,386,14,14,28,50.0%,10m
18641,1,zergboi,2910,436,14,20,34,41.2%,15m
18641,2,siano,2910,323,11,9,20,55.0%,48m
18641,2,GeneraKenobi,2910,286,11,14,25,44.0%,11m
18641,3,[OMWTG]KeltWarrior,2910,218,8,9,17,47.1%,18m
18641,2,proshnik,2910,206,7,7,14,50.0%,15m
18641,1,cbt,2910,97,5,1,6,83.3%,1h
18641,3,sander,2910,117,4,3,7,57.1%,10m
18641,3,Qess,2910,119,3,1,4,75.0%,18m
18641,2,Mixha,2910,76,3,7,10,30.0%,4m
18641,3,katosviiru,2910,30,2,1,3,66.7%,18m
18641,2,[Hppl]Sørlandet,2910,0,2,3,5,40.0%,22m
18641,2,kamil,2910,102,2,3,5,40.0%,11m
18641,3,[brzzer]sergioandia,2910,0,1,0,1,100.0%,15m
18641,3,Bimball,2910,0,1,0,1,100.0%,6m
18641,3,Toymaker,2910,0,1,0,1,100.0%,4m
18641,3,Rainor,2910,0,1,1,2,50.0%,14m
18641,2,NoLogic,2910,88,1,3,4,25.0%,17m
18641,2,Nico,2910,0,1,3,4,25.0%,10m
18641,3,[IndyK]Magiszonek,2910,30,1,3,4,25.0%,19m
18641,2,IIIIIIIIIlll,2910,30,1,8,9,11.1%,31m
18641,3,Genkis,2910,0,0,1,1,0.0%,18m
18670,2,BInSubtle,2909,1574,243,228,471,51.6%,10m
18670,2,sKafandra,2909,1554,240,231,471,51.0%,14m
18670,3,Magic,2909,1611,198,169,367,54.0%,7m
18670,2,[LFF]jteping,2909,812,69,67,136,50.7%,15m
18670,2,MTJ,2909,973,41,38,79,51.9%,12m
18670,2,Alexader,2909,302,31,8,39,79.5%,7m
18670,2,[FD030]Megatron,2909,688,28,24,52,53.8%,20m
18670,1,Potato,2909,415,26,28,54,48.1%,8m
18670,2,Curlviv,2909,543,21,18,39,53.8%,19m
18670,3,Gelbrekt,2909,489,17,14,31,54.8%,15m
18670,2,EnOtIk,2909,220,16,9,25,64.0%,6m
18670,3,morda,2909,437,16,11,27,59.3%,7m
18670,2,[Pl0p]DidItForLulz,2909,205,11,12,23,47.8%,11m
18670,1,[BSkyT]LuKrO,2909,294,11,12,23,47.8%,4m
18670,3,Vadony,2909,165,7,5,12,58.3%,6m
18670,2,Simbarral,2909,125,6,5,11,54.5%,5m
18670,3,FunkY,2909,114,5,12,17,29.4%,7m
18670,3,[yлeй55]ПечальныйТОС,2909,92,4,3,7,57.1%,10m
18670,1,[Zwak]Pietro,2909,166,4,4,8,50.0%,8m
18670,3,[IWBF]Sten,2909,86,3,2,5,60.0%,21m
18670,3,Starzinger,2909,121,3,2,5,60.0%,8m
18670,3,Shiwer,2909,0,3,2,5,60.0%,5m
18670,3,[ReproT]ZyrO,2909,32,2,1,3,66.7%,54m
18670,3,torvaldd,2909,0,2,3,5,40.0%,14m
18670,3,[PHØMUI]MarinePrime,2909,0,1,0,1,100.0%,8m
18670,1,[Кусь]нуненадо,2909,0,1,0,1,100.0%,58m
18670,3,DomiNo,2909,0,1,0,1,100.0%,9m
18670,3,[MFGI]Mad,2909,0,1,1,2,50.0%,14m
18670,1,TopHi,2909,0,1,7,8,12.5%,15m
18670,2,civil,2909,0,0,3,3,0.0%,20m
18700,3,[ISSOVA]michaeliam,2908,912,94,83,177,53.1%,20m
18700,2,Chumbo,2908,774,72,75,147,49.0%,19m
18700,2,Buravchik,2908,869,55,53,108,50.9%,22m
18700,3,Lomic,2908,868,41,18,59,69.5%,14m
18700,2,Engineer,2908,957,39,34,73,53.4%,8m
18700,3,Kaiden,2908,462,17,13,30,56.7%,9m
18700,2,[RMM]Phoenix,2908,266,17,14,31,54.8%,15m
18700,2,Ascention,2908,427,16,15,31,51.6%,15m
18700,3,Flashboogie,2908,274,12,12,24,50.0%,11m
18700,1,jajaman,2908,341,11,11,22,50.0%,1h
18700,2,[PTLc]DerErzengel,2908,321,11,15,26,42.3%,11m
18700,2,Fripouille,2908,222,9,7,16,56.2%,14m
18700,3,[heah]Scilo,2908,170,6,7,13,46.2%,32m
18700,2,[SSC2]medved,2908,140,5,3,8,62.5%,18m
18700,2,[AofK]Bobo,2908,0,4,2,6,66.7%,10m
18700,1,BoBA,2908,97,4,3,7,57.1%,1h
18700,2,DemiurgeYF,2908,172,4,7,11,36.4%,11m
18700,2,Antho,2908,0,3,2,5,60.0%,1h
18700,3,Scrofula,2908,0,3,2,5,60.0%,19m
18700,2,april,2908,58,3,5,8,37.5%,18m
18700,1,chivapopchik,2908,0,2,4,6,33.3%,22m
18700,3,Dewderino,2908,30,1,1,2,50.0%,15m
18700,3,RIPHarambe,2908,30,1,1,2,50.0%,4m
18700,3,Mila,2908,96,1,4,5,20.0%,15m
18700,3,Cody,2908,0,0,1,1,0.0%,12m
18700,3,Ворюга,2908,0,0,1,1,0.0%,14m
18700,2,[lOoOl]KorBusan,2908,0,0,3,3,0.0%,7m
18700,2,Murexator,2908,0,0,4,4,0.0%,6m
18728,1,[TIGER5]Chris,2907,1612,215,209,424,50.7%,20m
18728,1,[SIC319]schulz,2907,1626,165,163,328,50.3%,21m
18728,3,Tizers,2907,1518,161,176,337,47.8%,19m
18728,2,Thisissteven,2907,1184,102,98,200,51.0%,4m
18728,1,[GKY]ZuZ,2907,1369,93,98,191,48.7%,13m
18728,1,Paco,2907,1476,75,80,155,48.4%,31m
18728,2,Kamy,2907,1010,42,43,85,49.4%,9m
18728,3,dreamworker,2907,521,34,31,65,52.3%,21m
18728,1,[TheShy]Galoschinio,2907,861,27,34,61,44.3%,15m
18728,2,Wild,2907,457,25,23,48,52.1%,10m
18728,2,BobMarley,2907,465,21,22,43,48.8%,19m
18728,3,Spychy,2907,208,9,5,14,64.3%,15m
18728,2,aghill,2907,190,8,3,11,72.7%,11m
18728,3,sabrE,2907,198,7,8,15,46.7%,46m
18728,2,TilyX,2907,180,6,1,7,85.7%,7m
18728,1,Работяга,2907,97,4,3,7,57.1%,22m
18728,1,OverLord,2907,96,4,3,7,57.1%,46m
18728,2,Meaty,2907,88,4,4,8,50.0%,4m
18728,2,Etenos,2907,0,3,2,5,60.0%,13m
18728,3,[MeDiT8]flOwZEn,2907,86,3,2,5,60.0%,10m
18728,2,xWagi,2907,92,3,6,9,33.3%,10m
18728,3,Grib,2907,30,2,1,3,66.7%,4m
18728,2,Tyrael,2907,116,2,4,6,33.3%,19m
18728,2,LogicBird,2907,30,2,4,6,33.3%,7m
18728,2,Che,2907,0,1,0,1,100.0%,53m
18728,3,[Ecoli]Dreon,2907,0,1,0,1,100.0%,31m
18728,1,DroneForever,2907,0,1,0,1,100.0%,1h
18728,3,Alexy,2907,0,1,0,1,100.0%,18m
18728,3,FireKaton,2907,0,1,0,1,100.0%,19m
18728,1,birambam,2907,0,1,1,2,50.0%,9m
18728,3,MericanChees,2907,0,1,1,2,50.0%,4m
18728,2,IIIIIIIIIIII,2907,34,1,5,6,16.7%,13m
18728,3,Hooven,2907,0,0,1,1,0.0%,4m
18728,3,[HBeS]Raynor,2907,0,0,1,1,0.0%,11m
18728,3,[3ЕRGTV]OraKuL,2907,0,0,1,1,0.0%,4m
18728,1,Veleno,2907,0,0,2,2,0.0%,58m
18728,1,[SidO]Owei,2907,0,0,3,3,0.0%,4m
18728,2,photogrammtr,2907,0,0,3,3,0.0%,11m
18766,2,[TFSC]FenRir,2906,539,100,97,197,50.8%,5m
18766,1,Misza,2906,1004,75,76,151,49.7%,13m
18766,3,[IIOGII]Sigfried,2906,819,68,54,122,55.7%,9m
18766,3,Yesterday,2906,1130,52,53,105,49.5%,21m
18766,2,academic,2906,1022,37,39,76,48.7%,16m
18766,3,Furiosa,2906,731,31,20,51,60.8%,15m
18766,3,[2Ta]WordZa,2906,696,30,20,50,60.0%,12m
18766,1,TerabiT,2906,684,30,36,66,45.5%,6m
18766,2,RoffeRuff,2906,420,16,13,29,55.2%,22m
18766,2,[OBY]shigeryu,2906,388,13,20,33,39.4%,8m
18766,2,Darkbait,2906,246,10,4,14,71.4%,17m
18766,3,Mirk,2906,228,9,8,17,52.9%,1h
18766,3,Nikitka,2906,216,8,5,13,61.5%,8m
18766,2,[Dragen]STERBANS,2906,228,8,10,18,44.4%,10m
18766,3,Keb,2906,160,6,4,10,60.0%,32m
18766,1,[TRLM]HasuObsCLS,2906,96,5,1,6,83.3%,47m
18766,3,[Gloves]AlexIG,2906,140,5,5,10,50.0%,13m
18766,1,[NetGam]Shakakak,2906,97,4,4,8,50.0%,57m
18766,1,[TeamPo]kimHJ,2906,48,4,4,8,50.0%,15m
18766,2,chuwanga,2906,11,4,7,11,36.4%,7m
18766,2,LAITCHO,2906,128,4,9,13,30.8%,22m
18766,3,[ABRUTI]Gloxybule,2906,0,3,2,5,60.0%,15m
18766,2,maksmus,2906,0,3,2,5,60.0%,12m
18766,1,Selur,2906,0,3,3,6,50.0%,60m
18766,2,Zakarax,2906,116,3,4,7,42.9%,7m
18766,3,Albertfour,2906,58,2,1,3,66.7%,16m
18766,3,PONIYA,2906,30,2,1,3,66.7%,11m
18766,3,Anim,2906,0,2,1,3,66.7%,11m
18766,1,Theffz,2906,48,2,7,9,22.2%,1h
18766,3,[WCKYLN]Mootek,2906,0,1,0,1,100.0%,7m
18766,3,JackFracas,2906,0,1,0,1,100.0%,8m
18766,2,atomic,2906,32,1,7,8,12.5%,10m
18766,1,RoboHunter,2906,0,0,1,1,0.0%,15m
18799,2,Sergggo,2905,1607,269,268,537,50.1%,19m
18799,2,Jah,2905,1145,187,178,365,51.2%,14m
18799,1,sHooK,2905,1386,115,107,222,51.8%,5m
18799,2,OLiX,2905,1288,66,62,128,51.6%,6m
18799,3,CommanderLeo,2905,1170,45,42,87,51.7%,19m
18799,2,Yurgen,2905,932,38,41,79,48.1%,7m
18799,2,Rendodo,2905,973,36,37,73,49.3%,11m
18799,3,nontrivial,2905,290,35,25,60,58.3%,22m
18799,2,DonburiChan,2905,504,35,27,62,56.5%,4m
18799,2,DarthEugen,2905,654,28,22,50,56.0%,13m
18799,2,Fin,2905,533,25,18,43,58.1%,13m
18799,2,[Zyrànn]Matschi,2905,449,19,10,29,65.5%,31m
18799,3,IIIIIIIIIIII,2905,392,14,9,23,60.9%,5m
18799,3,Cybaer,2905,287,9,5,14,64.3%,32m
18799,3,Fanthom,2905,200,8,5,13,61.5%,21m
18799,1,JudgeMike,2905,218,8,13,21,38.1%,31m
18799,2,BlackStar,2905,206,7,11,18,38.9%,6m
18799,2,SouldreamXe,2905,170,6,7,13,46.2%,11m
18799,1,Joker,2905,166,6,14,20,30.0%,22m
18799,2,GamePlan,2905,0,4,1,5,80.0%,1h
18799,3,[Chariz]Brusli,2905,0,2,1,3,66.7%,4m
18799,3,tigerdyret,2905,58,2,2,4,50.0%,31m
18799,3,[WRK]ShootMeAgain,2905,58,2,2,4,50.0%,22m
18799,3,pOvod,2905,0,0,1,1,0.0%,21m
18799,3,Gloomy,2905,0,0,1,1,0.0%,8m
18799,2,Apostol,2905,0,0,2,2,0.0%,8m
18825,3,[4Hacks]hallelujah,2904,1265,256,255,511,50.1%,15m
18825,3,Arthurius,2904,1567,164,177,341,48.1%,10m
18825,2,Hobbymetzger,2904,1537,148,145,293,50.5%,13m
18825,1,Aspartat,2904,1284,92,96,188,48.9%,20m
18825,2,Resistor,2904,1437,63,48,111,56.8%,8m
18825,3,PowerRanger,2904,468,20,11,31,64.5%,32m
18825,2,Greenhill,2904,308,12,12,24,50.0%,19m
18825,2,[ILGCI]CutSyOzZy,2904,301,10,11,21,47.6%,1h
18825,1,CutSyOzZy,2904,367,10,29,39,25.6%,13m
18825,2,German,2904,176,7,8,15,46.7%,19m
18825,1,Theta,2904,163,6,3,9,66.7%,22m
18825,2,[RuOC]GRISIS,2904,194,6,6,12,50.0%,19m
18825,2,Pinzon,2904,116,5,6,11,45.5%,16m
18825,3,[LGC]Shinobi,2904,197,5,9,14,35.7%,46m
18825,3,ESKEREEE,2904,30,4,3,7,57.1%,11m
18825,3,Stulejarz,2904,90,4,3,7,57.1%,10m
18825,2,ValteR,2904,0,3,2,5,60.0%,16m
18825,3,Tamplier,2904,30,2,0,2,100.0%,13m
18825,3,pivoWar,2904,0,1,0,1,100.0%,32m
18825,3,[Z3RGTV]Venom,2904,0,1,0,1,100.0%,7m
18825,3,Сайлед,2904,0,1,0,1,100.0%,32m
18825,3,[NLTHB]ReFruity,2904,0,0,1,1,0.0%,16m
18825,3,[Prista]FunReVenGer,2904,0,0,1,1,0.0%,4m
18848,2,chaman,2903,1519,248,238,486,51.0%,22m
18848,2,TenaciousD,2903,1568,162,157,319,50.8%,10m
18848,3,[Vepar]Cyclop,2903,1637,156,137,293,53.2%,19m
18848,1,JhonnyG,2903,1167,79,76,155,51.0%,14m
18848,3,ZED,2903,478,56,66,122,45.9%,4m
18848,1,[MLKSTK]evo,2903,458,19,17,36,52.8%,20m
18848,2,mrPipister,2903,439,18,17,35,51.4%,4m
18848,2,IWontSurrend,2903,391,17,14,31,54.8%,11m
18848,2,Wsen,2903,341,14,11,25,56.0%,4m
18848,2,Ayatsuru,2903,350,13,16,29,44.8%,19m
18848,2,[wedown]Jack,2903,326,12,11,23,52.2%,10m
18848,2,Boomz,2903,254,11,6,17,64.7%,1h
18848,3,Terra,2903,122,9,8,17,52.9%,14m
18848,2,General,2903,213,8,5,13,61.5%,8m
18848,1,James,2903,264,7,21,28,25.0%,10m
18848,2,bebel,2903,162,6,8,14,42.9%,8m
18848,3,[WRSHP]Mongoskar,2903,88,4,1,5,80.0%,33m
18848,3,dadou,2903,0,3,2,5,60.0%,7m
18848,2,MaxFun,2903,0,3,2,5,60.0%,16m
18848,3,serg,2903,0,3,2,5,60.0%,20m
18848,1,Stimpack,2903,0,3,3,6,50.0%,20m
18848,3,[Inval]Hisk,2903,30,2,0,2,100.0%,8m
18848,2,Petryshka,2903,30,2,2,4,50.0%,11m
18848,2,[MWorld]Alandar,2903,127,2,3,5,40.0%,49m
18848,2,Jolte,2903,60,2,8,10,20.0%,7m
18848,3,[Tahery]VADIM,2903,0,1,0,1,100.0%,6m
18848,2,[MoopyS]Nubsan,2903,30,1,4,5,20.0%,9m
18848,3,Fidell,2903,0,0,1,1,0.0%,7m
18848,2,Petiee,2903,0,0,3,3,0.0%,33m
18848,1,Zagreus,2903,0,0,5,5,0.0%,47m
18878,3,[LQV]ViX,2902,1579,194,208,402,48.3%,7m
18878,2,butch,2902,1524,140,136,276,50.7%,14m
18878,2,stack,2902,1476,134,132,266,50.4%,5m
18878,2,Lore,2902,1577,131,125,256,51.2%,9m
18878,2,ZadokinG,2902,1383,91,69,160,56.9%,6m
18878,2,Sierra,2902,1221,63,60,123,51.2%,13m
18878,2,StaSila,2902,856,40,32,72,55.6%,20m
18878,3,Какулька,2902,871,36,28,64,56.2%,16m
18878,3,Legnacra,2902,384,25,21,46,54.3%,13m
18878,1,Hola,2902,593,24,21,45,53.3%,17m
18878,2,[J4E]ACID,2902,252,22,25,47,46.8%,7m
18878,2,[VKY]RavenEffect,2902,360,12,13,25,48.0%,15m
18878,3,Nhiv,2902,202,8,6,14,57.1%,11m
18878,1,ipxZerg,2902,213,7,2,9,77.8%,45m
18878,2,[FxL]Sanda,2902,206,7,10,17,41.2%,18m
18878,3,Gropoto,2902,145,6,5,11,54.5%,4m
18878,2,[LaB]AinZ,2902,90,4,4,8,50.0%,33m
18878,2,Stormtrooper,2902,138,4,11,15,26.7%,1h
18878,3,haeikou,2902,48,3,2,5,60.0%,6m
18878,3,Mowgli,2902,114,3,2,5,60.0%,13m
18878,3,scøørn,2902,88,3,4,7,42.9%,31m
18878,3,Shatter,2902,30,2,0,2,100.0%,20m
18878,1,[HSKJ]MoonKnight,2902,97,2,3,5,40.0%,20m
18878,3,betatester,2902,60,2,3,5,40.0%,15m
18878,2,kamidze,2902,32,2,7,9,22.2%,14m
18878,1,Lock,2902,40,2,13,15,13.3%,31m
18878,3,[scp3]moussaka,2902,0,1,0,1,100.0%,19m
18878,3,Warbringer,2902,0,1,0,1,100.0%,19m
18878,2,Pandora,2902,88,1,2,3,33.3%,9m
18878,3,[LOTAL]Glef,2902,0,0,1,1,0.0%,12m
18878,3,VictorlePyro,2902,0,0,1,1,0.0%,9m
18878,2,AllysonNL,2902,0,0,1,1,0.0%,1h
18878,3,Foodmaker,2902,0,0,2,2,0.0%,9m
18911,2,[GdAT]Disaster,2901,1557,168,152,320,52.5%,6m
18911,2,LoneSurvivor,2901,1458,133,139,272,48.9%,17m
18911,1,ShiningZeon,2901,1053,128,135,263,48.7%,31m
18911,2,michio,2901,1457,120,113,233,51.5%,18m
18911,3,Kenin,2901,843,111,102,213,52.1%,9m
18911,2,Kabu,2901,1568,110,108,218,50.5%,14m
18911,2,SCVReady,2901,1466,102,95,197,51.8%,7m
18911,2,Iscream,2901,676,57,47,104,54.8%,10m
18911,2,[CHOPAA]Argonavt,2901,971,45,43,88,51.1%,8m
18911,2,[ZЕRGТV]Sirius,2901,1176,45,47,92,48.9%,19m
18911,2,SeaSharp,2901,777,32,27,59,54.2%,14m
18911,2,HzxByOnline,2901,812,31,30,61,50.8%,7m
18911,2,Jigsaw,2901,227,26,29,55,47.3%,19m
18911,2,Airblasted,2901,512,24,17,41,58.5%,9m
18911,1,redfox,2901,347,17,15,32,53.1%,6m
18911,3,wildzwijn,2901,206,14,11,25,56.0%,32m
18911,2,[FFF]Stolive,2901,258,12,10,22,54.5%,1h
18911,2,WhatAWaste,2901,163,7,7,14,50.0%,15m
18911,2,GEGTturbo,2901,253,7,7,14,50.0%,23m
18911,1,brooks,2901,146,6,6,12,50.0%,23m
18911,2,Bercheck,2901,144,5,8,13,38.5%,7m
18911,2,Gogo,2901,140,5,10,15,33.3%,13m
18911,3,[elCrab]Gazmyas,2901,147,4,3,7,57.1%,20m
18911,3,Andriez,2901,0,3,1,4,75.0%,7m
18911,1,[PChaos]Endzor,2901,139,3,1,4,75.0%,19m
18911,1,[P0W3RD]SuperTeej,2901,147,3,3,6,50.0%,1h
18911,3,[Witam]DobryTata,2901,30,2,1,3,66.7%,10m
18911,2,wodkaisgood,2901,58,2,7,9,22.2%,8m
18911,3,StormzBG,2901,0,1,0,1,100.0%,13m
18911,3,krashe,2901,0,1,0,1,100.0%,15m
18911,2,Mercurian,2901,0,1,1,2,50.0%,17m
18911,3,[MiNeR]Rage,2901,0,0,2,2,0.0%,19m
18911,3,IIIIIIIIIIII,2901,0,0,2,2,0.0%,6m
18944,1,geeko,2900,1617,476,465,941,50.6%,8m
18944,1,[Bochum]Lukas,2900,1589,83,83,166,50.0%,15m
18944,2,[EKG]TwaCool,2900,1359,67,65,132,50.8%,18m
18944,2,FatCat,2900,1384,52,52,104,50.0%,11m
18944,2,murTi,2900,598,33,32,65,50.8%,22m
18944,3,SoldierTriad,2900,785,30,24,54,55.6%,21m
18944,2,[PTSL]DARKBAME,2900,252,20,15,35,57.1%,20m
18944,2,JaKkals,2900,208,9,5,14,64.3%,4m
18944,1,Smucky,2900,203,9,8,17,52.9%,1h
18944,2,Rantave,2900,257,9,9,18,50.0%,15m
18944,1,[EXPANT]Mormegil,2900,286,8,21,29,27.6%,7m
18944,3,Bruainan,2900,174,7,5,12,58.3%,9m
18944,2,FoX,2900,128,5,6,11,45.5%,4m
18944,2,JosephBidens,2900,60,5,6,11,45.5%,11m
18944,1,IIIIIIIIIIII,2900,48,4,4,8,50.0%,1h
18944,3,SvetoyKresT,2900,0,3,2,5,60.0%,17m
18944,1,nelson,2900,97,3,5,8,37.5%,23m
18944,2,Serral,2900,60,3,5,8,37.5%,4m
18944,2,kiskatona,2900,66,3,7,10,30.0%,8m
18944,2,террАн,2900,80,3,7,10,30.0%,20m
18944,2,[SРID]ПеЧеНьКа,2900,88,3,8,11,27.3%,21m
18944,3,Octava,2900,58,2,1,3,66.7%,19m
18944,3,HugoxD,2900,0,2,1,3,66.7%,32m
18944,2,LebonFrancis,2900,0,2,1,3,66.7%,53m
18944,3,triggertoo,2900,58,2,4,6,33.3%,7m
18944,3,WeDestroyYou,2900,0,1,0,1,100.0%,9m
18944,2,techsiro,2900,34,1,5,6,16.7%,7m
18944,3,andre,2900,0,0,1,1,0.0%,32m
18944,3,RolandDupe,2900,0,0,1,1,0.0%,19m
18973,2,LoTo,2899,344,53,54,107,49.5%,22m
18973,3,JurajLv,2899,922,35,37,72,48.6%,19m
18973,2,UmFufu,2899,651,29,21,50,58.0%,18m
18973,3,DimonGold,2899,577,22,19,41,53.7%,7m
18973,3,[Нефрит]SilverPoldeX,2899,542,21,12,33,63.6%,16m
18973,3,CNM,2899,492,20,13,33,60.6%,20m
18973,3,[Дniще]Legioner,2899,521,19,15,34,55.9%,14m
18973,3,[N0obZz]Dericerona,2899,304,12,8,20,60.0%,11m
18973,2,sulfarafan,2899,194,8,6,14,57.1%,12m
18973,2,mAriCk,2899,140,6,5,11,54.5%,15m
18973,1,[BlgB]Darkangel,2899,48,5,3,8,62.5%,20m
18973,2,Mango,2899,0,4,1,5,80.0%,4m
18973,3,WaLiaN,2899,114,4,3,7,57.1%,32m
18973,3,AjaxRoofOut,2899,30,4,3,7,57.1%,21m
18973,3,llllllllllll,2899,0,3,2,5,60.0%,18m
18973,2,Lelik,2899,86,3,6,9,33.3%,15m
18973,2,[FLAX]DnBWicked,2899,0,2,2,4,50.0%,54m
18973,1,Yoann,2899,145,2,2,4,50.0%,1h
18973,2,Rakomkabana,2899,62,2,6,8,25.0%,8m
18973,3,Stormpants,2899,58,2,14,16,12.5%,17m
18973,3,[RaYak]FromHell,2899,0,1,0,1,100.0%,18m
18973,3,Jockmcplop,2899,0,1,0,1,100.0%,7m
18973,3,Slippy,2899,0,1,1,2,50.0%,11m
18973,1,Wanderer,2899,97,1,2,3,33.3%,1h
18973,2,GRANDMASTER,2899,30,1,7,8,12.5%,7m
18973,3,[Kompis]PlatinumYoda,2899,0,0,1,1,0.0%,20m
18973,3,[ZADR]Quonix,2899,0,0,1,1,0.0%,10m
18973,3,Hawk,2899,0,0,1,1,0.0%,4m
19001,2,Sixfeetunder,2898,1556,138,135,273,50.5%,14m
19001,2,MightyDuck,2898,1197,100,93,193,51.8%,11m
19001,1,[DƎI]Shabbyman,2898,378,92,80,172,53.5%,15m
19001,1,ydear,2898,1274,50,46,96,52.1%,16m
19001,2,kato,2898,1172,47,48,95,49.5%,6m
19001,3,Ras,2898,419,15,10,25,60.0%,20m
19001,3,Boubou,2898,338,12,11,23,52.2%,20m
19001,3,[ENV]Pandem,2898,312,12,11,23,52.2%,18m
19001,3,SandR,2898,287,11,12,23,47.8%,15m
19001,3,[LYFsc]rOmega,2898,207,8,6,14,57.1%,1h
19001,3,[Bong]LittleWilly,2898,224,8,9,17,47.1%,31m
19001,3,confirm,2898,203,7,2,9,77.8%,10m
19001,1,OozzE,2898,163,7,7,14,50.0%,4m
19001,2,[DFgsA]FKrisz,2898,171,4,6,10,40.0%,22m
19001,2,[ABRX]twistednose,2898,156,4,6,10,40.0%,8m
19001,3,Blueone,2898,86,3,1,4,75.0%,5m
19001,3,[CJFF]Jasper,2898,30,2,1,3,66.7%,20m
19001,3,Kotofey,2898,0,1,0,1,100.0%,12m
19001,2,[GCDIV]Manofhonor,2898,0,1,3,4,25.0%,54m
19001,3,[MkerIT]psicotico,2898,0,0,2,2,0.0%,17m
19021,2,zoolevel,2897,1553,200,194,394,50.8%,14m
19021,1,mizna,2897,1610,183,188,371,49.3%,19m
19021,2,AteBitHavoc,2897,1573,111,105,216,51.4%,11m
19021,2,jonanas,2897,909,39,29,68,57.4%,9m
19021,1,MRJM,2897,645,30,37,67,44.8%,10m
19021,2,Djédys,2897,491,26,31,57,45.6%,15m
19021,2,MVA,2897,597,23,23,46,50.0%,20m
19021,2,[xFRSx]PARMAX,2897,317,20,19,39,51.3%,11m
19021,2,[псина]KeenG,2897,230,8,12,20,40.0%,20m
19021,3,Synops,2897,202,7,7,14,50.0%,11m
19021,1,Kenarius,2897,0,5,2,7,71.4%,15m
19021,1,Dom,2897,48,5,3,8,62.5%,60m
19021,3,PsyBot,2897,114,5,15,20,25.0%,11m
19021,3,Cioppi,2897,86,4,3,7,57.1%,8m
19021,3,snaik,2897,100,4,4,8,50.0%,13m
19021,2,InfestBaboon,2897,118,4,8,12,33.3%,14m
19021,2,Рёв,2897,0,3,2,5,60.0%,53m
19021,1,PeterGalaxy,2897,48,3,5,8,37.5%,1h
19021,3,[suqdiq]DoggyFrost,2897,30,2,0,2,100.0%,11m
19021,3,[KARASI]Dzen,2897,30,2,2,4,50.0%,19m
19021,3,MadBoyScout,2897,40,2,9,11,18.2%,8m
19021,3,Antaniar,2897,0,1,0,1,100.0%,21m
19021,3,Yogin,2897,0,1,1,2,50.0%,16m
19021,2,KurtckoB,2897,0,0,1,1,0.0%,1h
19021,2,[IceCub]Призрак,2897,0,0,1,1,0.0%,19m
19021,3,Ger,2897,0,0,1,1,0.0%,20m
19047,1,STARNOOB,2896,1606,126,134,260,48.5%,15m
19047,2,azouldir,2896,1549,103,67,170,60.6%,33m
19047,3,shhhchizo,2896,1444,67,42,109,61.5%,16m
19047,3,Eddar,2896,1364,67,45,112,59.8%,16m
19047,1,adrian,2896,635,63,70,133,47.4%,17m
19047,3,LeGrandJojo,2896,958,43,25,68,63.2%,4m
19047,1,PolyBlack,2896,357,41,48,89,46.1%,17m
19047,3,[SMRC]ImperorObi,2896,510,21,16,37,56.8%,7m
19047,3,ChekPoint,2896,377,16,13,29,55.2%,7m
19047,1,cKr,2896,209,14,22,36,38.9%,21m
19047,2,DeMaN,2896,342,11,17,28,39.3%,16m
19047,2,EdGE,2896,322,11,18,29,37.9%,16m
19047,1,Dracco,2896,195,7,6,13,53.8%,1h
19047,1,DenVan,2896,100,4,14,18,22.2%,14m
19047,2,Spielman,2896,0,3,1,4,75.0%,1h
19047,2,tameremoche,2896,88,3,3,6,50.0%,14m
19047,3,[1FU2]Kizzmaul,2896,30,2,0,2,100.0%,10m
19047,3,[SR5]Mataleao,2896,30,2,0,2,100.0%,5m
19047,3,vita,2896,60,2,3,5,40.0%,12m
19047,1,Mackan,2896,0,2,6,8,25.0%,47m
19047,3,jacn,2896,0,1,0,1,100.0%,6m
19047,3,[ProRax]Carnage,2896,0,1,0,1,100.0%,32m
19047,3,juhlemanden,2896,0,1,2,3,33.3%,46m
19047,2,[Po420]Momme,2896,30,1,5,6,16.7%,22m
19047,3,AnyKey,2896,0,0,1,1,0.0%,12m
19072,1,FlopFlip,2895,1616,273,266,539,50.6%,19m
19072,2,Tulla,2895,1531,162,146,308,52.6%,7m
19072,3,Martin,2895,832,93,90,183,50.8%,17m
19072,2,Bilkenator,2895,559,54,48,102,52.9%,11m
19072,2,Matos,2895,778,33,30,63,52.4%,14m
19072,2,MishGun,2895,591,28,31,59,47.5%,13m
19072,2,woshinidie,2895,406,18,14,32,56.2%,19m
19072,3,Hasu,2895,417,16,15,31,51.6%,9m
19072,2,ubiuka,2895,341,15,16,31,48.4%,33m
19072,2,JoeChip,2895,252,10,8,18,55.6%,15m
19072,2,[C37224]GranPedrito,2895,280,10,9,19,52.6%,18m
19072,3,[Komada]Kahoolee,2895,234,9,6,15,60.0%,32m
19072,3,[DaAm]manino,2895,210,6,2,8,75.0%,15m
19072,2,[AiRǂ]Coboldo,2895,142,6,8,14,42.9%,16m
19072,3,[Hollow]Thomass,2895,30,4,3,7,57.1%,16m
19072,1,IIIIIIIIIIII,2895,0,4,4,8,50.0%,21m
19072,2,RuNNitRuNNit,2895,0,3,3,6,50.0%,15m
19072,2,HelloKitty,2895,30,1,4,5,20.0%,14m
19072,2,grrr,2895,0,1,5,6,16.7%,11m
19072,3,KeYf,2895,0,0,1,1,0.0%,17m
19072,3,[zadr0t]SnuperX,2895,0,0,1,1,0.0%,14m
19072,2,GrandMaster,2895,0,0,2,2,0.0%,33m
19094,1,[258]Cuirassier,2894,1615,187,182,369,50.7%,31m
19094,2,mauser,2894,1395,124,101,225,55.1%,12m
19094,2,finik,2894,1562,73,71,144,50.7%,11m
19094,2,apollon,2894,1577,63,64,127,49.6%,15m
19094,1,[Trolld]Naglfar,2894,1140,55,55,110,50.0%,19m
19094,3,Etostasik,2894,962,44,41,85,51.8%,10m
19094,2,Cive,2894,764,39,33,72,54.2%,10m
19094,2,[AFin]Burns,2894,780,36,35,71,50.7%,13m
19094,3,[Levit]Levitas,2894,868,33,30,63,52.4%,4m
19094,3,Kioal,2894,658,28,17,45,62.2%,15m
19094,1,[Tuning]Snuuffi,2894,638,20,29,49,40.8%,21m
19094,2,Steve,2894,345,15,8,23,65.2%,7m
19094,2,kikivakrozla,2894,238,14,12,26,53.8%,6m
19094,3,cuteburger,2894,347,12,10,22,54.5%,6m
19094,2,Soon,2894,206,8,13,21,38.1%,16m
19094,1,bokcvok,2894,108,7,6,13,53.8%,31m
19094,2,MacroBanana,2894,152,5,8,13,38.5%,7m
19094,2,Alitaforcer,2894,139,4,3,7,57.1%,1h
19094,3,[OG4]Chutz,2894,58,2,1,3,66.7%,17m
19094,2,George,2894,0,1,0,1,100.0%,12m
19094,3,zifan,2894,0,0,1,1,0.0%,12m
19094,3,[Ultrа]aquarius,2894,0,0,1,1,0.0%,18m
19094,2,Pawner,2894,0,0,3,3,0.0%,19m
19094,2,Pierrem,2894,0,0,7,7,0.0%,4m
19118,1,[L0L]KORTES,2893,1585,245,247,492,49.8%,17m
19118,1,George,2893,1594,169,153,322,52.5%,11m
19118,2,MATT,2893,1291,122,112,234,52.1%,4m
19118,1,Bezzakonnic,2893,1027,81,70,151,53.6%,31m
19118,2,Passchendael,2893,1094,75,68,143,52.4%,15m
19118,3,inoxia,2893,955,41,37,78,52.6%,32m
19118,3,[DELADO]Dova,2893,671,30,22,52,57.7%,15m
19118,3,Jake,2893,626,24,17,41,58.5%,7m
19118,2,Nook,2893,298,11,15,26,42.3%,5m
19118,3,Uram,2893,256,9,4,13,69.2%,17m
19118,3,MassZealot,2893,209,9,7,16,56.2%,50m
19118,2,galdomir,2893,204,7,6,13,53.8%,4m
19118,2,shaco,2893,163,7,7,14,50.0%,1h
19118,3,GacekDC,2893,104,5,4,9,55.6%,9m
19118,2,[UF2AC]Svereptopor,2893,155,5,5,10,50.0%,14m
19118,2,Malper,2893,0,4,1,5,80.0%,51m
19118,1,СложныйМем,2893,48,4,4,8,50.0%,6m
19118,2,[HOWR]Sideways,2893,102,2,3,5,40.0%,9m
19118,3,Kronos,2893,0,1,0,1,100.0%,16m
19118,3,Tina,2893,0,1,0,1,100.0%,20m
19118,3,MetallicA,2893,30,1,1,2,50.0%,20m
19118,1,DawidPL,2893,48,1,2,3,33.3%,22m
19118,2,[NVDRM]Romfly,2893,88,1,6,7,14.3%,20m
19118,3,РЕЙНОР,2893,0,0,2,2,0.0%,10m
19142,2,[xFRSx]tit,2892,1590,340,324,664,51.2%,20m
19142,2,Kropulu,2892,1566,259,256,515,50.3%,14m
19142,2,GaryBrewer,2892,1590,256,242,498,51.4%,15m
19142,1,cosmicbaby,2892,1536,151,152,303,49.8%,5m
19142,3,chatomic,2892,1511,137,112,249,55.0%,22m
19142,2,shai,2892,1301,132,105,237,55.7%,11m
19142,2,ToxicNim,2892,1215,77,76,153,50.3%,18m
19142,2,Neverlight,2892,895,57,39,96,59.4%,6m
19142,2,BlackForce,2892,1190,50,42,92,54.3%,14m
19142,2,jamislamb,2892,1128,47,44,91,51.6%,11m
19142,3,nanojimbo,2892,1003,46,32,78,59.0%,22m
19142,3,Chaos,2892,1029,46,41,87,52.9%,15m
19142,3,Sheila,2892,893,41,22,63,65.1%,11m
19142,2,JarJarWinks,2892,404,25,20,45,55.6%,6m
19142,2,VartV,2892,591,23,24,47,48.9%,14m
19142,3,HeCorJlaCeH,2892,415,18,10,28,64.3%,11m
19142,2,apez,2892,445,18,16,34,52.9%,6m
19142,3,BALANCANET,2892,366,13,9,22,59.1%,22m
19142,2,nightedition,2892,260,12,5,17,70.6%,19m
19142,2,DemiZe,2892,205,7,10,17,41.2%,1h
19142,2,Dreznak,2892,58,5,5,10,50.0%,12m
19142,2,IPFW,2892,152,5,11,16,31.2%,6m
19142,2,alex,2892,0,3,2,5,60.0%,18m
19142,3,Wielzewul,2892,38,3,4,7,42.9%,8m
19142,3,makintosh,2892,90,3,5,8,37.5%,18m
19142,3,Ptero,2892,58,2,1,3,66.7%,20m
19142,3,StreamZZang,2892,30,2,1,3,66.7%,11m
19142,2,Oxygen,2892,0,1,0,1,100.0%,1h
19142,3,[BigScv]FelixSteiner,2892,0,0,1,1,0.0%,22m
19171,3,Bore,2891,1270,514,519,1033,49.8%,11m
19171,1,Ferus,2891,1432,182,177,359,50.7%,11m
19171,1,shock,2891,1083,165,162,327,50.5%,15m
19171,2,ROPredaTOR,2891,1492,129,122,251,51.4%,20m
19171,1,[TDwtf]nox,2891,1501,106,110,216,49.1%,31m
19171,2,[SPGU]Drakaris,2891,1560,102,99,201,50.7%,14m
19171,1,RunForUrLyf,2891,1363,77,76,153,50.3%,8m
19171,2,Warhuva,2891,1544,74,62,136,54.4%,4m
19171,1,Slagathor,2891,620,18,34,52,34.6%,20m
19171,2,[ZgEgZ]Starius,2891,420,16,17,33,48.5%,13m
19171,2,[EUww1]CorvetteCorp,2891,392,13,12,25,52.0%,11m
19171,2,Surrao,2891,331,12,13,25,48.0%,8m
19171,1,Skendau,2891,342,11,13,24,45.8%,1h
19171,2,Function,2891,257,9,8,17,52.9%,11m
19171,3,TigIDigI,2891,114,5,2,7,71.4%,18m
19171,2,Yata,2891,0,4,1,5,80.0%,1h
19171,2,[aW]Spark,2891,48,4,3,7,57.1%,16m
19171,2,Pyro,2891,0,3,3,6,50.0%,11m
19171,3,морж,2891,0,1,0,1,100.0%,13m
19171,2,[shadly]Ironside,2891,88,1,2,3,33.3%,14m
19171,3,SieGeBreAcH,2891,30,1,2,3,33.3%,32m
19171,2,[UoSSR]FREKET,2891,0,1,3,4,25.0%,11m
19171,1,Marek,2891,46,1,9,10,10.0%,21m
19171,3,mydreny,2891,0,0,1,1,0.0%,21m
19171,3,JegJek,2891,0,0,1,1,0.0%,18m
19171,2,MelomaN,2891,0,0,1,1,0.0%,1h
19171,3,MrFoster,2891,0,0,2,2,0.0%,15m
19171,3,CLXIX,2891,0,0,2,2,0.0%,15m
19199,2,johnyt,2890,1587,210,207,417,50.4%,19m
19199,2,Pulsar,2890,1662,171,165,336,50.9%,6m
19199,2,WestWolf,2890,1498,65,65,130,50.0%,10m
19199,1,Plank,2890,1057,41,49,90,45.6%,10m
19199,2,[SPAINs]Pamperaso,2890,809,38,36,74,51.4%,6m
19199,3,[Cybro]bogar,2890,771,34,17,51,66.7%,3m
19199,3,DrSinork,2890,831,31,44,75,41.3%,7m
19199,3,[ExTr1m]valax,2890,493,20,20,40,50.0%,5m
19199,2,Polak,2890,366,15,13,28,53.6%,4m
19199,2,Genki,2890,253,13,12,25,52.0%,12m
19199,2,Ganjalf,2890,88,5,2,7,71.4%,19m
19199,2,[Hrr]Kado,2890,180,5,7,12,41.7%,15m
19199,2,Pirate,2890,46,4,3,7,57.1%,15m
19199,1,Пипец,2890,137,3,2,5,60.0%,1h
19199,2,Slaygon,2890,30,3,3,6,50.0%,19m
19199,3,Yiggdrasill,2890,97,2,1,3,66.7%,53m
19199,2,xan,2890,30,2,3,5,40.0%,17m
19199,2,greenZERG,2890,0,0,1,1,0.0%,1h
19199,3,LeRotatif,2890,0,0,3,3,0.0%,13m
19218,2,Artur,2889,1358,195,182,377,51.7%,10m
19218,1,totalbanal,2889,1592,179,174,353,50.7%,20m
19218,3,blubly,2889,1532,88,87,175,50.3%,14m
19218,2,SUSHi,2889,1125,61,63,124,49.2%,11m
19218,2,SimakinK,2889,1512,61,64,125,48.8%,16m
19218,2,HappyNewYear,2889,1524,59,61,120,49.2%,19m
19218,2,MCScenaRiO,2889,894,44,48,92,47.8%,20m
19218,2,[CSPP]Wink,2889,797,36,39,75,48.0%,19m
19218,2,[K0mpis]Robzki,2889,459,23,26,49,46.9%,19m
19218,3,[ЗИБиАГ]GaNGsTaR,2889,537,22,13,35,62.9%,14m
19218,3,Meras,2889,509,21,18,39,53.8%,6m
19218,3,veri,2889,553,21,23,44,47.7%,8m
19218,1,DsCpt,2889,469,18,15,33,54.5%,21m
19218,3,WhiskyPower,2889,289,14,9,23,60.9%,11m
19218,2,[1FU2]mbesso,2889,416,14,23,37,37.8%,9m
19218,3,Simorotw,2889,288,13,11,24,54.2%,22m
19218,2,prorok,2889,245,11,7,18,61.1%,8m
19218,2,shahong,2889,247,10,8,18,55.6%,11m
19218,2,waelh,2889,260,10,13,23,43.5%,9m
19218,2,mabibibite,2889,274,9,16,25,36.0%,4m
19218,2,Chcipak,2889,250,8,15,23,34.8%,7m
19218,3,[pépère]Raspoutine,2889,195,7,0,7,100.0%,4m
19218,1,Foxen,2889,129,7,5,12,58.3%,3m
19218,2,Baws,2889,154,7,6,13,53.8%,8m
19218,1,Larans,2889,241,7,6,13,53.8%,1h
19218,3,RykiPyki,2889,120,6,6,12,50.0%,19m
19218,1,[zzpg]Pugs,2889,121,5,4,9,55.6%,8m
19218,2,[TFSC]Nayour,2889,165,5,5,10,50.0%,15m
19218,3,Norwind,2889,142,5,5,10,50.0%,7m
19218,2,JoeBe,2889,88,4,3,7,57.1%,8m
19218,1,bebbe,2889,90,4,5,9,44.4%,14m
19218,3,Bassassin,2889,88,3,5,8,37.5%,10m
19218,2,Lance,2889,55,3,7,10,30.0%,4m
19218,3,xian,2889,30,2,0,2,100.0%,13m
19218,2,sowkony,2889,140,2,2,4,50.0%,59m
19218,2,Funkykong,2889,30,2,3,5,40.0%,19m
19218,2,Zenster,2889,62,2,6,8,25.0%,4m
19218,3,TheOrboy,2889,0,1,0,1,100.0%,21m
19218,1,lotak,2889,0,1,0,1,100.0%,21m
19218,3,Scrouji,2889,30,1,1,2,50.0%,8m
19218,3,[PiGPan]Emberck,2889,0,1,2,3,33.3%,21m
19218,3,[LetsG0]icee,2889,30,1,2,3,33.3%,8m
19218,3,jmut,2889,97,1,4,5,20.0%,2m
19218,3,[Rebеls]ethno,2889,0,0,2,2,0.0%,3m
19262,2,xeno,2888,1391,63,49,112,56.2%,9m
19262,2,NOK,2888,1308,49,53,102,48.0%,9m
19262,3,darkclay,2888,1166,43,39,82,52.4%,2m
19262,3,TheIcarus,2888,764,32,27,59,54.2%,22m
19262,2,Commie,2888,213,31,32,63,49.2%,13m
19262,2,megabom,2888,414,15,19,34,44.1%,16m
19262,1,Storm,2888,351,10,18,28,35.7%,8m
19262,2,RainTeller,2888,228,8,8,16,50.0%,16m
19262,2,Zaxarie,2888,110,4,8,12,33.3%,4m
19262,3,[AoTu]Pinkerton,2888,58,3,0,3,100.0%,13m
19262,3,MAKSIMUS,2888,60,3,1,4,75.0%,1m
19262,3,SWARM,2888,60,3,2,5,60.0%,19m
19262,2,Landgrave,2888,0,3,2,5,60.0%,60m
19262,3,[RGSC2]RARKA,2888,60,3,3,6,50.0%,19m
19262,3,Spagheet,2888,0,1,1,2,50.0%,1m
19262,3,[BRATVA]val,2888,91,1,2,3,33.3%,22m
19262,2,Haneikut,2888,88,1,4,5,20.0%,6m
19262,2,Ross,2888,30,1,4,5,20.0%,20m
19262,3,Predicate,2888,0,1,4,5,20.0%,20m
19262,3,[Cannоn]Raa,2888,0,0,1,1,0.0%,18m
19262,3,Bankyz,2888,0,0,1,1,0.0%,1m
19262,3,Elmosasaurio,2888,0,0,1,1,0.0%,12m
19262,3,[aDGa]Dominiator,2888,0,0,1,1,0.0%,7m
19262,3,[nB]Olways,2888,0,0,2,2,0.0%,22m
19262,2,Jax,2888,0,0,7,7,0.0%,12m
19287,2,ifurious,2887,1595,94,93,187,50.3%,4m
19287,2,bond,2887,876,31,38,69,44.9%,11m
19287,2,[BLDZH]DeekyDog,2887,702,29,27,56,51.8%,15m
19287,2,Narret,2887,553,28,28,56,50.0%,4m
19287,3,Chefer,2887,532,21,19,40,52.5%,17m
19287,3,MirM,2887,521,20,17,37,54.1%,10m
19287,3,IceDragon,2887,382,13,9,22,59.1%,6m
19287,3,Bothanical,2887,279,12,10,22,54.5%,1m
19287,1,Grim,2887,244,7,18,25,28.0%,12m
19287,3,[fam1ly]Steha,2887,144,5,4,9,55.6%,2m
19287,2,BuzzyNova,2887,88,4,2,6,66.7%,14m
19287,3,[Nbclb]Ernirinn,2887,118,4,5,9,44.4%,7m
19287,2,[OtES]GraineGivre,2887,0,3,2,5,60.0%,1h
19287,2,[ZETS]Wirnbo,2887,126,3,5,8,37.5%,10m
19287,3,YouWillDie,2887,30,2,2,4,50.0%,4m
19287,3,LastHero,2887,58,2,2,4,50.0%,18m
19287,3,DEathkNIghtS,2887,0,2,3,5,40.0%,8m
19287,3,Taurus,2887,0,0,1,1,0.0%,5m
19287,3,Maestro,2887,0,0,1,1,0.0%,2m
19306,1,Skytop,2886,1582,175,179,354,49.4%,7m
19306,2,PinBallMap,2886,1579,129,126,255,50.6%,7m
19306,2,EliteInvest,2886,1198,90,86,176,51.1%,10m
19306,3,Drop,2886,1503,66,53,119,55.5%,19m
19306,3,Goman,2886,1275,65,33,98,66.3%,19m
19306,1,Savlon,2886,1233,65,61,126,51.6%,18m
19306,3,kranouchine,2886,374,28,6,34,82.4%,15m
19306,3,ZORSTEP,2886,620,24,17,41,58.5%,8m
19306,3,Manrom,2886,491,20,12,32,62.5%,10m
19306,3,SMCWWMarF,2886,338,20,15,35,57.1%,2m
19306,2,Medhii,2886,356,16,16,32,50.0%,14m
19306,3,[ZBOUBB]defqon,2886,228,15,16,31,48.4%,2m
19306,2,Hadock,2886,106,13,15,28,46.4%,2m
19306,1,StinkyPanDa,2886,388,13,21,34,38.2%,19m
19306,3,FusilàPompe,2886,278,11,8,19,57.9%,3m
19306,2,HalvorseN,2886,271,11,11,22,50.0%,3m
19306,1,[Xa]MambaNero,2886,344,11,21,32,34.4%,18m
19306,1,Johnyu,2886,213,8,10,18,44.4%,21m
19306,2,Grizli,2886,248,8,17,25,32.0%,6m
19306,3,cssdom,2886,168,6,3,9,66.7%,2m
19306,3,[NiBBer]LoyalGuard,2886,170,6,7,13,46.2%,8m
19306,2,[LVXE]AƻC,2886,166,6,9,15,40.0%,14m
19306,1,[Draigo]wouinny,2886,144,5,7,12,41.7%,21m
19306,3,ipopotem,2886,116,4,7,11,36.4%,10m
19306,2,Qatra,2886,0,3,2,5,60.0%,1h
19306,3,Привет,2886,0,3,2,5,60.0%,18m
19306,2,Arnold,2886,92,3,6,9,33.3%,5m
19306,3,ARKUDA,2886,30,2,0,2,100.0%,7m
19306,1,CloudBoi,2886,92,2,0,2,100.0%,1h
19306,3,Whata,2886,30,2,1,3,66.7%,9m
19306,2,[D0N3]Pacselly,2886,30,2,5,7,28.6%,6m
19306,3,[Arrows]Maxplaycanal,2886,0,1,0,1,100.0%,6m
19306,2,Shimpanzee,2886,0,1,0,1,100.0%,3m
19306,3,Fano,2886,0,0,1,1,0.0%,2m
19306,3,CarolusRex,2886,0,0,1,1,0.0%,17m
19306,3,firefox,2886,0,0,1,1,0.0%,23m
19306,3,рейнор,2886,0,0,1,1,0.0%,1h
19306,3,[Erle]Oimel,2886,0,0,2,2,0.0%,10m
19344,3,[GeFury]RUS,2885,1557,79,71,150,52.7%,18m
19344,3,robertoaac,2885,1030,58,47,105,55.2%,19m
19344,2,jEsioN,2885,478,53,52,105,50.5%,22m
19344,2,[InitRu]Fellax,2885,585,51,37,88,58.0%,11m
19344,2,[fffs]Kerrah,2885,1071,44,38,82,53.7%,12m
19344,3,RamzesLive,2885,352,34,33,67,50.7%,19m
19344,2,Арториас,2885,661,26,24,50,52.0%,6m
19344,2,tpo,2885,680,25,30,55,45.5%,14m
19344,2,Kylar,2885,471,19,16,35,54.3%,13m
19344,2,[Ǽ1]Trex,2885,454,16,22,38,42.1%,11m
19344,3,DartTemekys,2885,241,8,6,14,57.1%,7m
19344,3,makeaturret,2885,216,8,6,14,57.1%,2m
19344,3,[сSсǃ]CuteTempest,2885,183,7,0,7,100.0%,2m
19344,2,[Schlab]zboubinet,2885,118,6,7,13,46.2%,14m
19344,2,FluXZerG,2885,148,6,9,15,40.0%,17m
19344,3,Maroxian,2885,160,5,0,5,100.0%,2m
19344,3,DenverTerran,2885,93,5,5,10,50.0%,14m
19344,2,GordonFBR,2885,177,4,6,10,40.0%,1h
19344,3,BlackBird,2885,58,3,2,5,60.0%,23m
19344,3,WisienMOD,2885,58,2,2,4,50.0%,13m
19344,3,Crazinezz,2885,0,2,3,5,40.0%,2m
19344,1,TaylorSwift,2885,145,2,3,5,40.0%,1h
19344,3,MeTaL,2885,0,1,0,1,100.0%,7m
19344,3,Bjarkecomman,2885,0,1,0,1,100.0%,11m
19344,3,QfifteeN,2885,0,1,0,1,100.0%,4m
19344,3,Inkarzero,2885,30,1,4,5,20.0%,15m
19344,3,[54D]CrusadeR,2885,0,0,1,1,0.0%,2m
19344,3,Fladag,2885,0,0,1,1,0.0%,17m
19344,2,Strucci,2885,0,0,1,1,0.0%,15m
19344,3,Qyoss,2885,0,0,3,3,0.0%,22m
19374,2,majkel,2884,1577,188,188,376,50.0%,14m
19374,1,Ermahgerd,2884,1329,138,140,278,49.6%,7m
19374,2,[SAKZ]Ossan,2884,1476,77,76,153,50.3%,6m
19374,1,bycraft,2884,1125,39,44,83,47.0%,11m
19374,2,BormanAZ,2884,658,35,35,70,50.0%,14m
19374,2,[EV0C]Saberius,2884,386,33,31,64,51.6%,7m
19374,2,VITgames,2884,642,26,23,49,53.1%,14m
19374,3,[N00B13]Murtagh,2884,523,22,19,41,53.7%,17m
19374,2,[SC2SPB]SiD,2884,382,14,18,32,43.8%,22m
19374,3,ezv,2884,252,9,8,17,52.9%,19m
19374,2,[Kazi]Yurgen,2884,238,8,14,22,36.4%,16m
19374,3,Cujo,2884,116,7,10,17,41.2%,2m
19374,3,Fasteee,2884,161,6,4,10,60.0%,22m
19374,3,StalinChan,2884,142,5,4,9,55.6%,2m
19374,2,Hemaka,2884,154,5,12,17,29.4%,14m
19374,1,DaEjakulator,2884,145,4,5,9,44.4%,1h
19374,3,dmit,2884,58,3,0,3,100.0%,13m
19374,3,JohnMadden,2884,0,3,2,5,60.0%,18m
19374,2,[ABidz]Hurenhubert,2884,62,3,4,7,42.9%,21m
19374,2,Lively,2884,66,3,7,10,30.0%,20m
19374,2,benji,2884,62,3,8,11,27.3%,7m
19374,3,[BHC]Hilliti,2884,30,2,0,2,100.0%,2m
19374,3,Shurido,2884,0,2,3,5,40.0%,4m
19374,2,Kronos,2884,60,2,5,7,28.6%,4m
19374,3,Griffon,2884,0,1,0,1,100.0%,7m
19374,3,Alexander,2884,30,1,1,2,50.0%,17m
19374,2,Muminpappa,2884,30,1,7,8,12.5%,9m
19374,3,TheWanderer,2884,0,0,1,1,0.0%,11m
19374,3,extravagant,2884,0,0,1,1,0.0%,7m
19374,3,[МLР]PrCelestia,2884,0,0,2,2,0.0%,9m
19374,1,Mexxn,2884,0,0,3,3,0.0%,23m
19374,3,MacroMarines,2884,0,0,3,3,0.0%,1m
19374,2,Kaito,2884,0,0,4,4,0.0%,23m
19407,2,CashBack,2883,1426,109,103,212,51.4%,10m
19407,3,theolord,2883,791,73,68,141,51.8%,14m
19407,2,alundracloud,2883,595,47,41,88,53.4%,19m
19407,3,sersergiu,2883,870,35,24,59,59.3%,2m
19407,1,[BktJ]Taikobo,2883,876,31,34,65,47.7%,22m
19407,2,[abffl]Britney,2883,556,25,20,45,55.6%,11m
19407,2,[ĦĦ]Nanuk,2883,546,18,24,42,42.9%,20m
19407,2,MrBurns,2883,402,17,14,31,54.8%,15m
19407,2,Bugrahan,2883,496,17,21,38,44.7%,16m
19407,2,[GODSSS]Fuzileiro,2883,340,11,15,26,42.3%,14m
19407,2,SgtBashDebel,2883,270,9,11,20,45.0%,1m
19407,3,[MAIDAN]Fransua,2883,260,8,7,15,53.3%,11m
19407,3,TheQuaine,2883,93,6,3,9,66.7%,19m
19407,2,ojim,2883,46,5,2,7,71.4%,6m
19407,3,ubilskap,2883,142,5,5,10,50.0%,20m
19407,2,[ReDo]MrWhite,2883,116,5,9,14,35.7%,22m
19407,2,Véktørs,2883,140,4,5,9,44.4%,11m
19407,3,Kinsel,2883,86,3,2,5,60.0%,15m
19407,3,[BZIG]fLEXX,2883,0,3,2,5,60.0%,18m
19407,3,Belzedar,2883,0,3,2,5,60.0%,23m
19407,3,IIIIIIIIIII,2883,0,3,2,5,60.0%,18m
19407,3,bokha,2883,30,2,0,2,100.0%,12m
19407,2,BlackBilly,2883,0,1,1,2,50.0%,15m
19407,3,IlIlIlIlIlIl,2883,30,1,2,3,33.3%,20m
19407,3,trent,2883,30,1,3,4,25.0%,14m
19407,3,[SÐ]Poulpator,2883,0,0,1,1,0.0%,6m
19407,3,Ishtar,2883,0,0,1,1,0.0%,8m
19407,3,[1FU2]FourTwenty,2883,0,0,2,2,0.0%,15m
19407,3,Constantine,2883,0,0,2,2,0.0%,17m
19436,3,FerretNipple,2882,1574,217,204,421,51.5%,6m
19436,3,[xFSRx]Erich,2882,1642,142,115,257,55.3%,13m
19436,3,Costel,2882,919,36,27,63,57.1%,18m
19436,3,possum,2882,452,20,23,43,46.5%,18m
19436,1,luC,2882,208,16,18,34,47.1%,21m
19436,2,Waldi,2882,363,15,12,27,55.6%,2m
19436,2,Steelsong,2882,370,15,13,28,53.6%,12m
19436,3,zwoom,2882,244,12,14,26,46.2%,5m
19436,3,[AsJRHD]Viggerboys,2882,275,10,4,14,71.4%,17m
19436,3,CanardSansTT,2882,280,10,11,21,47.6%,15m
19436,2,[NerCC]ArtemisFowl,2882,236,9,14,23,39.1%,17m
19436,3,Vestnik,2882,176,8,5,13,61.5%,14m
19436,3,[AMG42]ItsMax,2882,187,5,10,15,33.3%,1m
19436,3,Màmàdou,2882,0,4,1,5,80.0%,18m
19436,3,[FENIKS]Imbech,2882,90,4,2,6,66.7%,10m
19436,3,MojosSVK,2882,86,4,2,6,66.7%,18m
19436,3,qblizt,2882,109,4,3,7,57.1%,7m
19436,3,yoyo,2882,58,3,2,5,60.0%,2m
19436,3,[THESCV]WorstPlayer,2882,88,3,4,7,42.9%,21m
19436,1,defaultUser,2882,0,2,4,6,33.3%,1h
19436,3,[ЗЛО]catbert,2882,0,1,0,1,100.0%,18m
19436,3,[IAmBad]KYT,2882,0,1,0,1,100.0%,8m
19436,3,[GROF]Firestarter,2882,0,1,0,1,100.0%,20m
19436,1,Vitafit,2882,0,1,0,1,100.0%,1h
19436,3,[BATG]CrisuBobonet,2882,30,1,2,3,33.3%,18m
19436,1,[35BZH]BattleBoy,2882,0,0,1,1,0.0%,8m
19436,3,Revilen,2882,0,0,1,1,0.0%,21m
19436,3,Guinness,2882,0,0,2,2,0.0%,8m
19436,2,[KAOT]blaze,2882,0,0,4,4,0.0%,7m
19465,1,Dlyg,2881,1307,136,115,251,54.2%,16m
19465,3,[NCtk]Rage,2881,1461,97,92,189,51.3%,8m
19465,2,Nicolas,2881,617,88,92,180,48.9%,2m
19465,2,Wicked,2881,1539,82,80,162,50.6%,8m
19465,2,Pezz,2881,1375,69,61,130,53.1%,16m
19465,3,CaptainLoche,2881,1342,55,45,100,55.0%,21m
19465,2,BabaUB,2881,1197,52,42,94,55.3%,7m
19465,2,emmanuel,2881,831,36,33,69,52.2%,8m
19465,2,RUs,2881,972,34,42,76,44.7%,20m
19465,2,Noname,2881,675,27,24,51,52.9%,6m
19465,2,MIHYUN,2881,425,18,15,33,54.5%,7m
19465,2,Jaju,2881,276,9,16,25,36.0%,16m
19465,2,[PYHU]Пучахендза,2881,178,7,8,15,46.7%,10m
19465,2,иля,2881,131,6,12,18,33.3%,13m
19465,3,[2raxyo]discomaniac,2881,86,3,2,5,60.0%,2m
19465,3,Deathstroke,2881,90,3,3,6,50.0%,8m
19465,3,[alu]uvran,2881,0,2,3,5,40.0%,17m
19465,3,Rolex,2881,30,1,2,3,33.3%,10m
19483,2,yursiv,2880,1604,176,173,349,50.4%,6m
19483,2,bora,2880,1506,161,162,323,49.8%,13m
19483,2,rrroooaaa,2880,1536,115,112,227,50.7%,15m
19483,2,WildOwl,2880,1323,59,41,100,59.0%,14m
19483,1,[GPs57]Kamar,2880,1086,42,53,95,44.2%,8m
19483,2,Srstka,2880,493,24,23,47,51.1%,6m
19483,3,daniel,2880,674,24,25,49,49.0%,1m
19483,2,[CaGa]Jojo,2880,341,15,13,28,53.6%,16m
19483,3,[НОД17]VOLK,2880,253,9,13,22,40.9%,6m
19483,2,[IsraeI]AlonEven,2880,120,4,8,12,33.3%,4m
19483,3,Razihel,2880,0,3,2,5,60.0%,11m
19483,3,[Blatzs]Ezekiel,2880,0,3,2,5,60.0%,3m
19483,3,kolo,2880,0,3,2,5,60.0%,7m
19483,2,[EZee]Ori,2880,141,3,4,7,42.9%,1h
19483,3,[UF2AC]Rick,2880,30,2,1,3,66.7%,19m
19483,2,Rockz,2880,44,2,3,5,40.0%,14m
19483,3,artemido,2880,24,2,3,5,40.0%,2m
19483,2,Trensh,2880,0,2,4,6,33.3%,15m
19483,2,[WF31A]Apollo,2880,48,1,1,2,50.0%,1h
19483,3,Ready,2880,0,1,1,2,50.0%,2m
19483,3,Cold,2880,30,1,1,2,50.0%,23m
19483,3,[INCEL]Eix,2880,30,1,4,5,20.0%,19m
19483,3,Befe,2880,0,1,8,9,11.1%,1h
19506,2,Fuuschto,2879,1603,146,149,295,49.5%,16m
19506,2,JRa,2879,1555,126,110,236,53.4%,11m
19506,2,BronzeMaster,2879,1510,115,121,236,48.7%,20m
19506,2,Jimakos,2879,1334,68,69,137,49.6%,6m
19506,1,HellBoy,2879,1340,56,69,125,44.8%,21m
19506,2,SchoKoPanDa,2879,1014,42,38,80,52.5%,18m
19506,2,Moustachos,2879,259,30,30,60,50.0%,19m
19506,1,Ens,2879,471,16,17,33,48.5%,12m
19506,2,QpTheory,2879,325,13,11,24,54.2%,10m
19506,3,[Fluid]Praxx,2879,277,12,10,22,54.5%,23m
19506,2,[Waseda]IIIIIIIIIIII,2879,316,11,15,26,42.3%,17m
19506,1,[MAMAN]StickBuzz,2879,230,9,12,21,42.9%,8m
19506,3,[uKu]JeffNL,2879,169,7,5,12,58.3%,20m
19506,3,Anaesthesia,2879,171,6,4,10,60.0%,10m
19506,3,Ulian,2879,0,4,0,4,100.0%,19m
19506,2,GoatBeard,2879,127,4,1,5,80.0%,1h
19506,3,Indro,2879,86,4,2,6,66.7%,10m
19506,2,blacknerpa,2879,88,4,3,7,57.1%,5m
19506,2,Puperlords,2879,0,3,2,5,60.0%,19m
19506,3,myth,2879,30,2,0,2,100.0%,3m
19506,3,[DZTK]zergbräter,2879,30,2,0,2,100.0%,1m
19506,3,aquiles,2879,58,2,2,4,50.0%,13m
19506,3,Timba,2879,0,1,2,3,33.3%,20m
19506,1,[KDV]ZIMOL,2879,0,0,1,1,0.0%,4m
19506,3,Heskinator,2879,0,0,1,1,0.0%,2m
19506,3,Skazochnik,2879,0,0,1,1,0.0%,8m
19506,3,Demonssouls,2879,0,0,3,3,0.0%,21m
19506,3,toi,2879,0,0,5,5,0.0%,3m
19534,1,shinook,2878,1711,837,841,1678,49.9%,12m
19534,1,subzer,2878,1642,297,283,580,51.2%,3m
19534,3,Terral,2878,759,120,114,234,51.3%,10m
19534,2,Dende,2878,1190,44,45,89,49.4%,11m
19534,2,Storn,2878,662,24,29,53,45.3%,11m
19534,3,ANT,2878,507,18,14,32,56.2%,13m
19534,1,Baaam,2878,455,18,16,34,52.9%,1m
19534,2,MrGajuuu,2878,362,12,13,25,48.0%,13m
19534,3,unicorn,2878,251,9,2,11,81.8%,18m
19534,1,Axis,2878,182,7,5,12,58.3%,7m
19534,3,[GazeCR]HonkyOfDeath,2878,120,5,6,11,45.5%,20m
19534,3,walabiz,2878,58,5,10,15,33.3%,11m
19534,3,[Petrus]make,2878,114,4,2,6,66.7%,20m
19534,3,RoJoBa,2878,90,3,3,6,50.0%,18m
19534,3,[Dmntd]Bubble,2878,30,2,0,2,100.0%,4m
19534,3,IIIIIIIIIIII,2878,58,2,1,3,66.7%,21m
19534,3,Sectoid,2878,30,2,2,4,50.0%,9m
19534,1,Saffron,2878,119,2,3,5,40.0%,1h
19534,2,[CCSR]RONIN,2878,30,2,6,8,25.0%,13m
19534,2,RedDragon,2878,0,1,0,1,100.0%,1h
19534,2,Laghorn,2878,0,1,4,5,20.0%,15m
19534,2,ClamKing,2878,0,0,1,1,0.0%,3m
19534,3,spree,2878,0,0,2,2,0.0%,13m
19534,2,RomanWarrior,2878,0,0,4,4,0.0%,10m
19558,2,aleksandr,2877,1612,136,117,253,53.8%,10m
19558,2,Alexander,2877,1569,136,127,263,51.7%,10m
19558,2,EnErgyDRinK,2877,1262,101,105,206,49.0%,19m
19558,2,AboSalah,2877,1320,94,73,167,56.3%,18m
19558,1,CreepTech,2877,1513,84,83,167,50.3%,17m
19558,2,fuzzychild,2877,1095,81,64,145,55.9%,14m
19558,2,Notaruseton,2877,1500,63,60,123,51.2%,12m
19558,2,[FUSB]Samxtar,2877,808,57,43,100,57.0%,21m
19558,3,XXEpheneAXX,2877,746,40,5,45,88.9%,19m
19558,3,Flaku,2877,789,33,32,65,50.8%,20m
19558,2,ZombieQueen,2877,724,31,28,59,52.5%,13m
19558,3,Technoid,2877,462,27,19,46,58.7%,8m
19558,2,[leOS]Civolt,2877,440,20,11,31,64.5%,10m
19558,2,Satellizer,2877,287,12,9,21,57.1%,6m
19558,2,NoCheeseToss,2877,300,11,11,22,50.0%,4m
19558,2,[IceHus]Element,2877,106,11,12,23,47.8%,13m
19558,3,Koala,2877,175,8,3,11,72.7%,7m
19558,3,argthx,2877,246,7,9,16,43.8%,18m
19558,3,Hamza,2877,176,6,7,13,46.2%,1m
19558,3,Sky,2877,145,5,7,12,41.7%,15m
19558,3,[SDDDD]ОдинокийСтар,2877,118,4,4,8,50.0%,20m
19558,1,Mattywowlee,2877,0,3,3,6,50.0%,1h
19558,1,sceid,2877,122,3,3,6,50.0%,1h
19558,2,[WCKYLN]katzbalger,2877,88,3,4,7,42.9%,11m
19558,2,Robat,2877,0,2,3,5,40.0%,1h
19558,3,[SCF]DemonHunter,2877,0,1,0,1,100.0%,19m
19558,2,[ADBG3]nopain,2877,0,1,0,1,100.0%,3m
19558,3,JadranKrt,2877,0,1,0,1,100.0%,9m
19558,3,Rukin,2877,30,1,4,5,20.0%,2m
19558,2,IIlIIllIlIll,2877,30,1,7,8,12.5%,15m
19558,3,neo,2877,0,0,1,1,0.0%,19m
19558,3,KatariTari,2877,0,0,1,1,0.0%,2m
19558,3,Marxmen,2877,0,0,2,2,0.0%,13m
19591,3,[muilut]Fury,2876,1648,116,105,221,52.5%,11m
19591,2,[PiGPan]drabard,2876,533,34,37,71,47.9%,11m
19591,3,radu,2876,352,33,27,60,55.0%,16m
19591,2,Hazadar,2876,337,25,30,55,45.5%,11m
19591,2,sparton,2876,529,23,17,40,57.5%,12m
19591,2,[CocSac]вкусняшка,2876,612,23,24,47,48.9%,12m
19591,3,Saf,2876,520,22,18,40,55.0%,15m
19591,3,castorspart,2876,386,20,12,32,62.5%,21m
19591,3,benepaille,2876,516,19,17,36,52.8%,16m
19591,2,Chris,2876,371,18,12,30,60.0%,16m
19591,2,CaptainPM,2876,405,18,15,33,54.5%,12m
19591,2,[MXG]Bobbo,2876,375,18,24,42,42.9%,16m
19591,2,Samurai,2876,295,13,11,24,54.2%,12m
19591,1,biverVs,2876,274,9,15,24,37.5%,18m
19591,3,Himera,2876,141,6,5,11,54.5%,20m
19591,3,ArchEnemy,2876,144,6,6,12,50.0%,8m
19591,1,KaneZ,2876,182,6,12,18,33.3%,15m
19591,3,[Abdul]Vedro,2876,118,5,2,7,71.4%,7m
19591,1,nYkke,2876,121,5,4,9,55.6%,13m
19591,1,zza,2876,138,5,4,9,55.6%,15m
19591,2,rasimoyk,2876,30,4,4,8,50.0%,14m
19591,3,[CumBoy]Magnus,2876,0,3,2,5,60.0%,23m
19591,3,eRRoR,2876,30,2,1,3,66.7%,21m
19591,3,Indianadrone,2876,94,2,4,6,33.3%,18m
19591,2,ShiftyEyes,2876,116,2,5,7,28.6%,10m
19591,2,Roggenmehl,2876,30,2,6,8,25.0%,19m
19591,3,[BxFxV]Scal,2876,0,1,0,1,100.0%,4m
19591,3,cooper,2876,0,1,0,1,100.0%,8m
19591,3,Cal,2876,0,1,0,1,100.0%,17m
19591,3,Anakler,2876,0,1,1,2,50.0%,10m
19591,3,XICOATL,2876,94,1,1,2,50.0%,14m
19591,3,[UAONE]luckynoslevn,2876,30,1,3,4,25.0%,16m
19591,1,JunoReactor,2876,0,0,1,1,0.0%,1h
19591,3,Deumos,2876,0,0,1,1,0.0%,3m
19591,3,ovigomy,2876,0,0,2,2,0.0%,13m
19591,2,Twist,2876,0,0,2,2,0.0%,10m
19591,2,Fenix,2876,0,0,3,3,0.0%,7m
19628,2,Upadły,2875,1547,566,555,1121,50.5%,15m
19628,2,Taka,2875,1041,114,110,224,50.9%,14m
19628,2,[GDMAN]demonmerlin,2875,1096,71,72,143,49.7%,14m
19628,3,Beubeu,2875,424,46,36,82,56.1%,16m
19628,2,[Perm]protosek,2875,641,31,17,48,64.6%,10m
19628,3,Marku,2875,694,26,19,45,57.8%,10m
19628,2,DrViktor,2875,429,15,17,32,46.9%,10m
19628,3,[AiRǂ]Spocchio,2875,325,14,12,26,53.8%,8m
19628,3,Divorce,2875,352,14,15,29,48.3%,3m
19628,1,inSlowpoke,2875,297,13,12,25,52.0%,1m
19628,2,SokoleOko,2875,263,13,16,29,44.8%,19m
19628,3,BillyTK,2875,311,11,5,16,68.8%,9m
19628,3,Edmait,2875,241,10,7,17,58.8%,4m
19628,3,DesertFox,2875,270,9,11,20,45.0%,2m
19628,2,Quarksalat,2875,225,8,8,16,50.0%,12m
19628,2,ДолгВідьмак,2875,140,6,5,11,54.5%,15m
19628,3,Legato,2875,178,6,7,13,46.2%,5m
19628,3,[CuMo]Bastri,2875,114,5,3,8,62.5%,8m
19628,3,QuickFox,2875,60,5,4,9,55.6%,16m
19628,2,[Kodos]farba,2875,0,4,1,5,80.0%,1h
19628,3,Peon,2875,90,4,2,6,66.7%,11m
19628,3,[SQInc]JambonBeurre,2875,164,4,3,7,57.1%,4m
19628,3,prezet,2875,0,3,2,5,60.0%,7m
19628,2,zuukCZ,2875,0,3,3,6,50.0%,3m
19628,3,Einar,2875,0,1,0,1,100.0%,21m
19628,3,Meru,2875,0,1,0,1,100.0%,19m
19628,3,[Zhig]grimhak,2875,0,1,0,1,100.0%,10m
19628,3,[Mergel]Wigglos,2875,0,1,2,3,33.3%,17m
19628,3,[Olеg]Lexus,2875,30,1,2,3,33.3%,4m
19628,1,Eli,2875,38,1,12,13,7.7%,1m
19628,3,[ais]Mantra,2875,0,0,1,1,0.0%,3m
19628,3,Bonos,2875,0,0,1,1,0.0%,13m
19628,3,FunkyLord,2875,0,0,1,1,0.0%,9m
19628,3,Zyiann,2875,0,0,1,1,0.0%,18m
19628,3,[AltFF]Lars,2875,0,0,2,2,0.0%,14m
19628,2,Dan,2875,0,0,7,7,0.0%,20m
19664,1,Rookie,2874,1616,259,245,504,51.4%,3m
19664,2,[SMBs]MomIsOnFire,2874,1540,84,90,174,48.3%,6m
19664,2,Martinator,2874,1577,68,69,137,49.6%,11m
19664,3,Escapade,2874,1209,61,37,98,62.2%,15m
19664,2,HardMashina,2874,643,33,17,50,66.0%,8m
19664,2,KennyThaDaWg,2874,567,26,23,49,53.1%,5m
19664,2,Bullseye,2874,495,21,19,40,52.5%,2m
19664,2,Огнемнон,2874,242,15,19,34,44.1%,18m
19664,2,MYRZuLKA,2874,273,10,9,19,52.6%,2m
19664,3,Patoche,2874,126,9,9,18,50.0%,9m
19664,3,[ZZIz]Tommy,2874,199,8,4,12,66.7%,21m
19664,3,RedDwarf,2874,174,7,7,14,50.0%,58m
19664,3,IIICYIII,2874,168,6,4,10,60.0%,19m
19664,3,TooMuchSun,2874,164,6,5,11,54.5%,15m
19664,3,Cordador,2874,124,6,23,29,20.7%,15m
19664,1,Kapushon,2874,0,5,2,7,71.4%,16m
19664,2,фрост,2874,118,5,6,11,45.5%,8m
19664,2,[ØN]KIIIIN,2874,156,5,10,15,33.3%,7m
19664,3,Chris,2874,107,4,3,7,57.1%,15m
19664,3,[smile]oErMeNs,2874,118,4,4,8,50.0%,17m
19664,1,senpai,2874,48,4,4,8,50.0%,1h
19664,2,Panico,2874,0,3,0,3,100.0%,1h
19664,1,Alexzykeron,2874,97,3,1,4,75.0%,20m
19664,2,Orozz,2874,64,2,11,13,15.4%,7m
19664,3,[Torito]Punisher,2874,0,1,0,1,100.0%,23m
19664,3,Infinitum,2874,0,1,0,1,100.0%,21m
19664,2,[Croow]Ravecon,2874,48,1,1,2,50.0%,1h
19664,3,TerransHill,2874,0,1,1,2,50.0%,20m
19664,3,[TFoxy]Thor,2874,30,1,2,3,33.3%,2m
19664,2,Alex,2874,30,1,4,5,20.0%,7m
19664,2,MyLord,2874,30,1,7,8,12.5%,20m
19664,3,Tukaramm,2874,0,0,1,1,0.0%,20m
19664,3,[AlloyE]PhiliOne,2874,0,0,2,2,0.0%,18m
19664,1,publicNME,2874,0,0,2,2,0.0%,23m
19664,2,etxeberro,2874,0,0,4,4,0.0%,19m
19699,3,Marlboró,2873,1472,244,214,458,53.3%,14m
19699,2,DeadSwan,2873,1425,62,66,128,48.4%,11m
19699,3,[DOGF]LAMMETAK,2873,909,44,42,86,51.2%,9m
19699,1,Dyrak,2873,512,36,50,86,41.9%,19m
19699,2,nika,2873,726,33,26,59,55.9%,2m
19699,2,llllllllllll,2873,756,31,29,60,51.7%,14m
19699,2,skirge,2873,624,21,27,48,43.8%,5m
19699,3,[FakJU]jazda,2873,380,15,6,21,71.4%,7m
19699,3,KiViKat,2873,277,12,8,20,60.0%,17m
19699,2,Streethawk,2873,252,11,11,22,50.0%,55m
19699,2,derator,2873,241,10,8,18,55.6%,1h
19699,3,Apik,2873,284,9,6,15,60.0%,18m
19699,1,Izo,2873,291,8,18,26,30.8%,21m
19699,3,saver,2873,142,5,3,8,62.5%,10m
19699,2,antares,2873,106,5,3,8,62.5%,4m
19699,1,ricator,2873,121,5,4,9,55.6%,1h
19699,3,desty,2873,153,5,5,10,50.0%,2m
19699,2,Animal,2873,60,5,5,10,50.0%,13m
19699,2,Mad,2873,124,5,9,14,35.7%,16m
19699,3,Зелень,2873,113,3,0,3,100.0%,10m
19699,2,NeBomjik,2873,0,3,3,6,50.0%,2m
19699,3,Dewastator,2873,58,2,2,4,50.0%,10m
19699,3,ApricotJam,2873,30,2,2,4,50.0%,21m
19699,3,Mechwarrior,2873,31,2,3,5,40.0%,8m
19699,3,aboo,2873,0,1,0,1,100.0%,10m
19699,2,andy,2873,0,1,5,6,16.7%,5m
19699,3,BadRobot,2873,0,0,1,1,0.0%,1h
19699,3,oDiNe,2873,0,0,1,1,0.0%,9m
19699,3,[CSLD]Jonsc,2873,0,0,1,1,0.0%,10m
19699,3,Keron,2873,0,0,1,1,0.0%,19m
19729,2,jibOOm,2872,1566,148,142,290,51.0%,16m
19729,2,xPeté,2872,1535,114,73,187,61.0%,15m
19729,3,CHUB,2872,1419,104,3,107,97.2%,16m
19729,2,polymesh,2872,1456,62,65,127,48.8%,14m
19729,3,Butler,2872,860,33,28,61,54.1%,13m
19729,2,treke,2872,528,22,22,44,50.0%,2m
19729,2,Poulpi,2872,650,22,27,49,44.9%,11m
19729,3,Plusmacher,2872,409,15,10,25,60.0%,15m
19729,1,ZoLLinHo,2872,172,8,8,16,50.0%,4m
19729,1,BoozyB,2872,168,7,12,19,36.8%,15m
19729,1,[Gustav]FanaticSnail,2872,144,6,6,12,50.0%,60m
19729,2,KibeRChlen,2872,174,6,8,14,42.9%,18m
19729,1,palpatino,2872,165,5,2,7,71.4%,1h
19729,3,[MdbS]Abzaats,2872,112,4,3,7,57.1%,18m
19729,3,IINirvSpinIl,2872,114,4,8,12,33.3%,20m
19729,3,[FrSlip]Pangolin,2872,118,2,1,3,66.7%,18m
19729,2,Strato,2872,92,2,3,5,40.0%,15m
19729,3,[JGIC]Histvar,2872,58,2,3,5,40.0%,17m
19729,2,AvailingMist,2872,0,1,3,4,25.0%,1m
19729,2,Tarantulia,2872,34,1,3,4,25.0%,18m
19729,3,AVOCATO,2872,0,0,3,3,0.0%,9m
19750,3,[noods]TyrolGuschtl,2871,1641,405,395,800,50.6%,20m
19750,2,Gyro,2871,1540,333,327,660,50.5%,6m
19750,2,Tessellator,2871,1547,221,225,446,49.6%,6m
19750,2,RaUl,2871,1579,184,182,366,50.3%,18m
19750,2,Yeddi,2871,1586,95,101,196,48.5%,7m
19750,2,Jazzor,2871,795,34,34,68,50.0%,11m
19750,3,genghiskhan,2871,376,20,14,34,58.8%,19m
19750,2,[teges]HappyFeet,2871,430,18,28,46,39.1%,20m
19750,3,[FB3]emiltheman,2871,429,16,13,29,55.2%,21m
19750,3,SmirnOFF,2871,240,7,8,15,46.7%,23m
19750,2,DiVaN,2871,178,7,10,17,41.2%,7m
19750,2,BarackPyjama,2871,110,7,11,18,38.9%,19m
19750,3,invader,2871,116,5,4,9,55.6%,20m
19750,3,[OVNI]Saucisse,2871,92,4,3,7,57.1%,19m
19750,2,LUAP,2871,30,4,4,8,50.0%,10m
19750,2,IneedAnswers,2871,142,4,5,9,44.4%,9m
19750,3,[HAYTER]Pete,2871,140,4,13,17,23.5%,17m
19750,3,FarseerMaha,2871,110,3,0,3,100.0%,16m
19750,1,[sctrap]JungerPadawa,2871,120,3,0,3,100.0%,22m
19750,3,Matt,2871,90,3,7,10,30.0%,20m
19750,1,LeshaDelovoy,2871,96,2,2,4,50.0%,1h
19750,3,Reuq,2871,0,2,3,5,40.0%,18m
19750,3,Daloso,2871,0,0,1,1,0.0%,2m
19750,3,KillTheRich,2871,0,0,2,2,0.0%,1m
19750,2,[CsTr]chudatta,2871,0,0,5,5,0.0%,10m
19775,1,Artemesia,2870,1547,126,121,247,51.0%,9m
19775,3,karasik,2870,1288,103,82,185,55.7%,19m
19775,1,superman,2870,1287,91,86,177,51.4%,12m
19775,2,HEAT,2870,1078,71,64,135,52.6%,6m
19775,3,Pangstar,2870,1366,66,47,113,58.4%,8m
19775,3,mrLevan,2870,520,49,47,96,51.0%,10m
19775,2,[JET]DonFelice,2870,902,38,43,81,46.9%,17m
19775,3,[PSIGH]Kavnoy,2870,883,33,29,62,53.2%,12m
19775,3,GoatHorns,2870,351,13,5,18,72.2%,20m
19775,2,Eden,2870,246,12,9,21,57.1%,13m
19775,2,[TAW]artnquest,2870,267,11,0,11,100.0%,14m
19775,1,DaMeDaNe,2870,300,10,14,24,41.7%,21m
19775,1,Saibot,2870,88,7,7,14,50.0%,56m
19775,1,timehider,2870,185,6,6,12,50.0%,15m
19775,2,musial,2870,102,5,4,9,55.6%,18m
19775,2,Kontures,2870,140,4,5,9,44.4%,11m
19775,2,[Дуйте]Void,2870,46,3,1,4,75.0%,14m
19775,3,SwissKing,2870,0,3,2,5,60.0%,13m
19775,2,Garlok,2870,131,3,3,6,50.0%,20m
19775,2,Dogland,2870,94,3,10,13,23.1%,4m
19775,2,Мародер,2870,0,2,4,6,33.3%,1h
19775,3,RTOVain,2870,0,1,0,1,100.0%,20m
19775,3,Emilzills,2870,0,1,1,2,50.0%,17m
19775,3,Malte,2870,0,1,2,3,33.3%,7m
19775,1,[IVT]SiG,2870,0,0,1,1,0.0%,50m
19775,3,AlphaBravo,2870,0,0,1,1,0.0%,6m
19775,3,EcStaSyLoL,2870,0,0,1,1,0.0%,2m
19775,2,tuetenfrog,2870,0,0,1,1,0.0%,55m
19775,2,MechAntar,2870,0,0,4,4,0.0%,19m
19804,3,Wyczesany,2869,1588,114,106,220,51.8%,1m
19804,2,Smart,2869,870,111,110,221,50.2%,20m
19804,2,flopp,2869,1296,89,89,178,50.0%,22m
19804,3,Zermingore,2869,1607,83,72,155,53.5%,16m
19804,3,khenu,2869,1365,77,63,140,55.0%,14m
19804,3,Jonas,2869,637,65,53,118,55.1%,10m
19804,1,BlackIHunter,2869,1056,43,50,93,46.2%,16m
19804,2,ShaunJS,2869,1094,39,43,82,47.6%,9m
19804,3,IsoMurmeli,2869,733,28,27,55,50.9%,19m
19804,3,Ziggy,2869,567,24,12,36,66.7%,20m
19804,1,HaveANiceDay,2869,642,21,31,52,40.4%,14m
19804,3,IIIIIIIIIIII,2869,480,17,15,32,53.1%,7m
19804,3,[298K]Okarin,2869,283,9,5,14,64.3%,14m
19804,3,[EESC]TheFunnyRage,2869,255,8,4,12,66.7%,23m
19804,3,aAaTuZeR,2869,42,5,4,9,55.6%,58m
19804,1,McFly,2869,0,1,1,2,50.0%,23m
19804,3,Антон,2869,0,0,1,1,0.0%,7m
19804,3,Azamat,2869,0,0,1,1,0.0%,12m
19804,3,CuHoIITuK,2869,0,0,2,2,0.0%,16m
19823,3,kefan,2868,1551,220,232,452,48.7%,7m
19823,3,cast,2868,1296,162,147,309,52.4%,7m
19823,2,Legandir,2868,1523,98,99,197,49.7%,2m
19823,2,Anduril,2868,945,56,46,102,54.9%,7m
19823,3,Hoplitespear,2868,872,50,26,76,65.8%,14m
19823,2,Tartaucitron,2868,1120,44,43,87,50.6%,2m
19823,3,[Harley]Liberty,2868,906,35,33,68,51.5%,13m
19823,3,[Krabы]titanik,2868,712,33,21,54,61.1%,10m
19823,3,[LaggIT]Swexbe,2868,378,17,12,29,58.6%,17m
19823,3,JuJuUuBeEe,2868,400,12,30,42,28.6%,8m
19823,3,Traviktox,2868,316,11,6,17,64.7%,10m
19823,1,Poddradion,2868,187,8,2,10,80.0%,60m
19823,3,CatJWarrior,2868,236,8,3,11,72.7%,5m
19823,1,[Dronez]HZtaj,2868,96,3,3,6,50.0%,17m
19823,3,GhostStalker,2868,90,3,3,6,50.0%,17m
19823,3,Kanonex,2868,30,3,4,7,42.9%,17m
19823,3,DanilReyner,2868,30,2,0,2,100.0%,13m
19823,3,TheStrike,2868,30,2,1,3,66.7%,3m
19823,3,xzardaz,2868,58,2,2,4,50.0%,21m
19823,3,Xrust,2868,0,1,0,1,100.0%,19m
19823,3,ItAx,2868,0,1,0,1,100.0%,17m
19823,3,Tiberium,2868,0,1,1,2,50.0%,16m
19823,3,AnatolyM,2868,0,1,1,2,50.0%,21m
19823,3,PureWater,2868,0,0,1,1,0.0%,13m
19823,3,Stormranger,2868,0,0,1,1,0.0%,12m
19823,3,aRividergE,2868,0,0,1,1,0.0%,3m
19823,3,Teodice,2868,0,0,3,3,0.0%,20m
19823,3,[TOFG]DOOM,2868,0,0,3,3,0.0%,3m
19851,3,[Rol3kg]voldaus,2867,1443,378,383,761,49.7%,4m
19851,2,[iSAR]lARS,2867,1546,128,106,234,54.7%,15m
19851,2,Comet,2867,1112,106,104,210,50.5%,20m
19851,1,Robbog,2867,1604,104,102,206,50.5%,21m
19851,3,Raggnars,2867,1547,101,84,185,54.6%,18m
19851,2,Telkinn,2867,1240,68,71,139,48.9%,6m
19851,2,fantom,2867,1202,66,62,128,51.6%,11m
19851,3,veil,2867,842,37,25,62,59.7%,16m
19851,2,[DWTeam]Agent,2867,746,35,22,57,61.4%,14m
19851,2,[UHB]Panikkuddel,2867,700,31,36,67,46.3%,16m
19851,1,[WSJ]Xiana,2867,708,29,35,64,45.3%,10m
19851,2,EvolutioN,2867,583,23,26,49,46.9%,15m
19851,3,[GAMI]Trix,2867,367,20,17,37,54.1%,10m
19851,3,[QTcIub]Tudor,2867,389,15,35,50,30.0%,13m
19851,3,AcriDimmm,2867,342,14,16,30,46.7%,7m
19851,3,OliveOil,2867,344,13,7,20,65.0%,23m
19851,3,Fellows,2867,226,12,9,21,57.1%,14m
19851,3,HydrQ,2867,194,7,5,12,58.3%,2m
19851,3,[KAOTx]WhoseThat,2867,92,4,4,8,50.0%,7m
19851,1,Stealth,2867,144,3,1,4,75.0%,1h
19851,3,dopyou,2867,0,3,2,5,60.0%,2m
19851,3,[N1NJ4Z]MrKey,2867,58,3,2,5,60.0%,16m
19851,3,yeffa,2867,30,2,0,2,100.0%,13m
19851,3,FirstTime,2867,30,2,0,2,100.0%,17m
19851,3,Wistoka,2867,0,2,3,5,40.0%,4m
19851,3,[PompaE]stwr,2867,30,1,1,2,50.0%,9m
19851,3,McClane,2867,0,1,2,3,33.3%,9m
19878,1,BOOM,2866,1571,310,317,627,49.4%,10m
19878,2,[1NFEC7]Gandalf,2866,1552,300,302,602,49.8%,23m
19878,2,lucfelix,2866,1326,71,75,146,48.6%,3m
19878,2,TuffCustomer,2866,956,53,52,105,50.5%,16m
19878,3,JUliusCäsar,2866,1099,36,53,89,40.4%,15m
19878,3,HolyShown,2866,738,33,27,60,55.0%,18m
19878,3,DarthStellar,2866,752,27,29,56,48.2%,4m
19878,3,Rambo,2866,560,24,20,44,54.5%,21m
19878,2,Полковник,2866,610,22,28,50,44.0%,9m
19878,2,Jarekom,2866,417,20,19,39,51.3%,15m
19878,1,[Shado]Lunica,2866,368,12,23,35,34.3%,21m
19878,3,Anders,2866,269,10,8,18,55.6%,1h
19878,1,PanPan,2866,204,8,6,14,57.1%,1h
19878,3,[OРДА]CHUVACHOK,2866,174,7,7,14,50.0%,12m
19878,3,DunkelZwei,2866,114,5,4,9,55.6%,16m
19878,2,Razi,2866,148,5,11,16,31.2%,10m
19878,3,eXceS,2866,116,4,3,7,57.1%,8m
19878,2,[RyS]Born,2866,120,4,10,14,28.6%,16m
19878,3,gammis,2866,0,3,2,5,60.0%,10m
19878,2,[MDLeg]Fobos,2866,95,3,3,6,50.0%,23m
19878,3,Athelstan,2866,92,3,3,6,50.0%,2m
19878,3,Templar,2866,30,2,0,2,100.0%,21m
19878,1,Crudak,2866,97,2,1,3,66.7%,1h
19878,3,Urt,2866,46,2,2,4,50.0%,11m
19878,3,LocraftPrime,2866,30,2,2,4,50.0%,6m
19878,3,XzyrXos,2866,58,2,5,7,28.6%,6m
19878,3,[Mffins]Sharingan,2866,58,2,5,7,28.6%,6m
19878,3,[DLD14]dLdChesTaiR,2866,0,1,0,1,100.0%,22m
19878,2,AllForYou,2866,0,1,2,3,33.3%,11m
19878,3,Coiless,2866,30,1,4,5,20.0%,8m
19878,2,Fosvihar,2866,0,1,5,6,16.7%,15m
19878,3,[J4E]zAgOn,2866,0,0,1,1,0.0%,19m
19878,3,Vencetudo,2866,0,0,1,1,0.0%,18m
19911,2,ELIMINATOR,2865,1579,306,294,600,51.0%,19m
19911,2,[mfxed]PanKasztanPL,2865,745,93,72,165,56.4%,16m
19911,2,Sebo,2865,991,83,70,153,54.2%,8m
19911,1,Maestro,2865,514,80,81,161,49.7%,7m
19911,1,[bree]Petrol,2865,1505,77,68,145,53.1%,6m
19911,3,[obi1k]ASWD,2865,1135,68,44,112,60.7%,13m
19911,2,mecrom,2865,844,59,48,107,55.1%,5m
19911,2,Courtesy,2865,1472,56,66,122,45.9%,11m
19911,3,PokaPoka,2865,1119,48,32,80,60.0%,2m
19911,2,BlumBlum,2865,1105,43,52,95,45.3%,8m
19911,3,Holgerrr,2865,714,40,32,72,55.6%,11m
19911,1,Rakanishu,2865,699,30,31,61,49.2%,14m
19911,3,Neurogenesis,2865,454,28,15,43,65.1%,9m
19911,3,Huguenciorg,2865,554,27,8,35,77.1%,8m
19911,3,tudorkite,2865,611,24,22,46,52.2%,16m
19911,3,[мрази]Алинадурында,2865,522,22,15,37,59.5%,1m
19911,2,Aisord,2865,438,19,17,36,52.8%,9m
19911,2,Wrogashz,2865,408,15,18,33,45.5%,11m
19911,2,[Uttrig]Starborn,2865,400,14,19,33,42.4%,8m
19911,3,Zarzar,2865,340,13,11,24,54.2%,11m
19911,1,Capo,2865,265,8,6,14,57.1%,13m
19911,2,Reeked,2865,137,8,8,16,50.0%,13m
19911,3,Barryl,2865,214,7,3,10,70.0%,20m
19911,3,lukas,2865,114,5,4,9,55.6%,14m
19911,1,FJS,2865,145,5,5,10,50.0%,1h
19911,3,elvesCastle,2865,112,4,3,7,57.1%,18m
19911,3,Jerzy,2865,58,3,1,4,75.0%,18m
19911,3,KnackTwoBaby,2865,90,3,6,9,33.3%,20m
19911,3,Normeus,2865,60,2,3,5,40.0%,20m
19911,3,Cannonfodder,2865,0,1,0,1,100.0%,2m
19911,1,danik,2865,0,1,1,2,50.0%,1h
19911,3,EpyoN,2865,30,1,2,3,33.3%,1h
19911,3,Exidium,2865,30,1,2,3,33.3%,10m
19911,1,ChillNGrill,2865,97,1,3,4,25.0%,1h
19911,3,Freeman,2865,0,0,1,1,0.0%,10m
19911,3,Nekto,2865,0,0,1,1,0.0%,18m
19911,3,schabenRegen,2865,0,0,4,4,0.0%,18m
19948,2,Social,2864,1567,148,144,292,50.7%,8m
19948,2,MedivaC,2864,1381,139,136,275,50.5%,5m
19948,2,strogov,2864,1425,104,100,204,51.0%,7m
19948,2,cassereuse,2864,1337,76,84,160,47.5%,7m
19948,2,[Hehe]jcjs,2864,1453,62,49,111,55.9%,5m
19948,3,SeskisDU,2864,1087,43,59,102,42.2%,21m
19948,3,NineTails,2864,519,22,9,31,71.0%,16m
19948,2,Lemmy,2864,533,19,21,40,47.5%,23m
19948,2,[GNVR]Facejizz,2864,398,18,18,36,50.0%,22m
19948,3,WestViper,2864,442,16,20,36,44.4%,16m
19948,2,Radradmcrad,2864,322,12,12,24,50.0%,15m
19948,3,Ликвидатор,2864,291,11,3,14,78.6%,7m
19948,2,ShadoW,2864,300,10,17,27,37.0%,6m
19948,3,[αX]Shohei,2864,226,9,6,15,60.0%,10m
19948,3,bas,2864,197,6,5,11,54.5%,16m
19948,3,[AofK]Gromk,2864,0,4,1,5,80.0%,2m
19948,3,unreal,2864,58,3,1,4,75.0%,2m
19948,2,Aalexashka,2864,0,3,2,5,60.0%,23m
19948,3,[LEDS]Spartan,2864,30,2,1,3,66.7%,10m
19948,2,dominonzerg,2864,0,2,4,6,33.3%,1h
19948,3,Glenn,2864,58,2,5,7,28.6%,7m
19948,3,[zorg12]zorg,2864,0,1,0,1,100.0%,22m
19948,3,[GSLs]BioS,2864,0,1,0,1,100.0%,16m
19948,1,Darkzealot,2864,0,1,0,1,100.0%,50m
19948,3,[ClubL]MrFlaster,2864,0,1,1,2,50.0%,13m
19948,3,Harald,2864,30,1,2,3,33.3%,19m
19948,1,Redirts,2864,96,1,2,3,33.3%,24m
19948,2,otec,2864,0,1,4,5,20.0%,11m
19948,3,DaUnicheK,2864,0,1,4,5,20.0%,15m
19948,2,firoos,2864,30,1,5,6,16.7%,19m
19948,3,TiniStar,2864,0,0,1,1,0.0%,18m
19948,3,SpiderMonkey,2864,0,0,2,2,0.0%,1m
19980,1,gagarin,2863,1519,198,207,405,48.9%,22m
19980,2,FLTrichter,2863,1496,188,164,352,53.4%,11m
19980,1,Julio,2863,1088,92,93,185,49.7%,13m
19980,2,OrbitalPerio,2863,1530,89,63,152,58.6%,19m
19980,2,Raven,2863,1484,85,60,145,58.6%,19m
19980,3,Maud,2863,1129,85,78,163,52.1%,17m
19980,2,netukerme,2863,1262,68,67,135,50.4%,6m
19980,3,DoctorWho,2863,1612,66,67,133,49.6%,14m
19980,3,isk,2863,1071,42,37,79,53.2%,10m
19980,3,WhippingPipe,2863,790,33,26,59,55.9%,20m
19980,2,positive,2863,578,25,20,45,55.6%,11m
19980,3,prdz,2863,631,25,21,46,54.3%,20m
19980,2,Maxblue,2863,664,23,25,48,47.9%,5m
19980,3,Scorcher,2863,548,20,21,41,48.8%,21m
19980,3,Laucher,2863,446,18,13,31,58.1%,16m
19980,3,Morose,2863,380,17,10,27,63.0%,4m
19980,2,mglo,2863,354,16,11,27,59.3%,20m
19980,3,[HBAR1]Blackbear,2863,328,12,10,22,54.5%,15m
19980,2,Martin,2863,226,12,11,23,52.2%,5m
19980,3,[UGL]Espanolator,2863,140,8,9,17,47.1%,1h
19980,3,Battlestar,2863,142,6,4,10,60.0%,1m
19980,2,BlackLegacy,2863,180,6,11,17,35.3%,6m
19980,3,Baron,2863,134,5,3,8,62.5%,4m
19980,1,MMagic,2863,97,5,4,9,55.6%,1h
19980,2,[lTZ]Bretombre,2863,104,5,5,10,50.0%,3m
19980,1,Bonersoup,2863,159,5,5,10,50.0%,1h
19980,3,Scorcher,2863,86,4,3,7,57.1%,16m
19980,3,[Ǽ1]AGoatedPlat,2863,46,3,0,3,100.0%,11m
19980,2,TenzZ,2863,0,3,1,4,75.0%,1h
19980,3,[DcRP]Devoted,2863,0,3,2,5,60.0%,19m
19980,3,niph,2863,30,2,2,4,50.0%,18m
19980,3,Mikrorul,2863,0,2,2,4,50.0%,18m
19980,3,Mameduk,2863,114,2,3,5,40.0%,19m
19980,3,[daktnt]mrtnt,2863,124,2,4,6,33.3%,18m
19980,3,NKI,2863,0,1,0,1,100.0%,3m
19980,2,[bullD]WhySoSerious,2863,0,1,1,2,50.0%,19m
19980,3,[WeiK]Balerion,2863,30,1,1,2,50.0%,17m
19980,3,HappyRaccoon,2863,0,1,1,2,50.0%,21m
19980,2,Dennis,2863,0,0,1,1,0.0%,21m
19980,3,[SKUU]lecaribou,2863,0,0,1,1,0.0%,9m
19980,3,reusch,2863,0,0,1,1,0.0%,13m
20021,2,Marine,2862,1569,122,109,231,52.8%,17m
20021,2,DeathKill,2862,1491,101,102,203,49.8%,19m
20021,2,alexRF,2862,1581,91,83,174,52.3%,8m
20021,1,Slade,2862,1487,76,83,159,47.8%,13m
20021,2,Beloz,2862,1456,74,77,151,49.0%,21m
20021,2,caleb,2862,1117,60,63,123,48.8%,11m
20021,2,broukmoute,2862,645,44,44,88,50.0%,19m
20021,3,[AS90]JeeratRome,2862,914,36,30,66,54.5%,23m
20021,3,[sctrap]KarlMarxxx,2862,713,35,20,55,63.6%,11m
20021,3,[Run974]Mordoress,2862,494,27,25,52,51.9%,2m
20021,2,Deadend,2862,618,21,27,48,43.8%,19m
20021,3,Marcin,2862,468,17,12,29,58.6%,6m
20021,1,WolkadaW,2862,324,16,28,44,36.4%,12m
20021,3,elka,2862,336,11,8,19,57.9%,13m
20021,3,Gunnar,2862,200,8,8,16,50.0%,1h
20021,3,Kruger,2862,238,7,6,13,53.8%,16m
20021,3,Ost,2862,170,7,6,13,53.8%,20m
20021,3,AxyDoom,2862,134,6,3,9,66.7%,9m
20021,3,Ostrich,2862,185,5,2,7,71.4%,20m
20021,2,Opa,2862,162,5,14,19,26.3%,11m
20021,1,DNEPR,2862,137,4,3,7,57.1%,21m
20021,2,[ReSw]Muronordan,2862,60,4,6,10,40.0%,17m
20021,3,STYN,2862,142,3,2,5,60.0%,18m
20021,2,Eol,2862,95,3,3,6,50.0%,53m
20021,2,advlad,2862,0,3,4,7,42.9%,11m
20021,3,[Suomii]Earthling,2862,58,2,2,4,50.0%,16m
20021,3,Daniel,2862,30,2,3,5,40.0%,17m
20021,3,bosCruncher,2862,0,1,0,1,100.0%,21m
20021,2,[BHC]Flog,2862,30,1,6,7,14.3%,14m
20021,3,[2AMC]TalhosniT,2862,0,0,1,1,0.0%,18m
20021,3,Haron,2862,0,0,2,2,0.0%,20m
20052,2,nikolayglhf,2861,878,45,46,91,49.5%,10m
20052,3,TheWB,2861,539,41,34,75,54.7%,11m
20052,3,[NWGD]Крамбл,2861,316,27,12,39,69.2%,2m
20052,2,Greenbean,2861,607,26,20,46,56.5%,17m
20052,3,Minifutzi,2861,651,25,19,44,56.8%,14m
20052,2,Ticzme,2861,624,25,21,46,54.3%,15m
20052,3,Devil,2861,622,25,22,47,53.2%,5m
20052,3,ßlùdgódx,2861,508,22,18,40,55.0%,3m
20052,2,[FloRnC]armi,2861,496,17,21,38,44.7%,2m
20052,3,yaper,2861,340,12,7,19,63.2%,21m
20052,2,PekaPride,2861,279,11,10,21,52.4%,18m
20052,2,esdenk,2861,312,11,11,22,50.0%,22m
20052,3,[ZERGSC]MrZerg,2861,326,11,13,24,45.8%,16m
20052,2,killerrabbit,2861,241,9,5,14,64.3%,17m
20052,3,llllllllllll,2861,180,8,2,10,80.0%,19m
20052,2,WeKillForYou,2861,240,8,13,21,38.1%,14m
20052,3,[xFRSx]aNarCHy,2861,176,7,8,15,46.7%,16m
20052,3,[4DnC]vam,2861,140,5,6,11,45.5%,17m
20052,2,Orkan,2861,140,4,3,7,57.1%,17m
20052,3,[FSCOTB]tripleA,2861,119,4,4,8,50.0%,23m
20052,1,TSsixtyONE,2861,82,3,2,5,60.0%,1h
20052,3,Eiko,2861,0,3,2,5,60.0%,18m
20052,3,Михаил,2861,90,3,7,10,30.0%,11m
20052,2,[IIOGII]squall,2861,88,3,8,11,27.3%,8m
20052,3,Weaver,2861,30,2,1,3,66.7%,19m
20052,3,Treco,2861,58,2,1,3,66.7%,20m
20052,2,[NOMCRO]Donito,2861,88,2,2,4,50.0%,16m
20052,3,kruppaCZECH,2861,0,2,3,5,40.0%,18m
20052,3,[4PE]Robbelibob,2861,60,2,3,5,40.0%,18m
20052,3,Frontman,2861,0,1,0,1,100.0%,4m
20052,3,Madro,2861,0,1,2,3,33.3%,15m
20052,3,MoherX,2861,0,0,1,1,0.0%,20m
20052,3,[Deleam]WarLord,2861,0,0,1,1,0.0%,2m
20052,2,NotoriousBIG,2861,0,0,1,1,0.0%,14m
20052,1,[nbalm]Jumo,2861,0,0,1,1,0.0%,1h
20052,3,Strelok,2861,0,0,1,1,0.0%,7m
20052,3,[яєѕ]JesuKristus,2861,0,0,2,2,0.0%,20m
20089,2,WRW,2860,1518,267,234,501,53.3%,18m
20089,2,SalY,2860,1472,249,223,472,52.8%,20m
20089,1,[niice]Banashiro,2860,1062,121,132,253,47.8%,4m
20089,2,Mojin,2860,1419,76,66,142,53.5%,18m
20089,2,Hugin,2860,1321,66,73,139,47.5%,13m
20089,2,LeMarquis,2860,1570,59,64,123,48.0%,8m
20089,3,Relokate,2860,330,35,33,68,51.5%,2m
20089,3,OSUUSER,2860,765,32,25,57,56.1%,18m
20089,3,Wittcher,2860,533,26,18,44,59.1%,14m
20089,3,madsjl,2860,490,17,17,34,50.0%,9m
20089,3,[Navvy]Egon,2860,355,14,12,26,53.8%,10m
20089,3,Grigoriy,2860,264,11,5,16,68.8%,17m
20089,3,CnL,2860,290,11,7,18,61.1%,16m
20089,3,[wtw]WEITNOW,2860,258,9,11,20,45.0%,7m
20089,2,[RTrain]Maix,2860,164,8,17,25,32.0%,16m
20089,3,HirotoTakuma,2860,200,7,9,16,43.8%,16m
20089,2,LEON,2860,198,7,12,19,36.8%,13m
20089,1,Fanaric,2860,136,6,6,12,50.0%,17m
20089,2,[Hybrid]Sierra,2860,182,6,7,13,46.2%,20m
20089,2,ГИБКИЙВАЛЕРА,2860,144,6,10,16,37.5%,4m
20089,2,[GVOMI]Grosteq,2860,48,4,3,7,57.1%,1h
20089,2,Terminator,2860,0,1,0,1,100.0%,3m
20089,3,BLuRjr,2860,97,1,2,3,33.3%,10m
20089,3,Monster,2860,30,1,4,5,20.0%,8m
20089,3,sqooqle,2860,30,1,4,5,20.0%,19m
20089,2,[ІDDQD]BFG,2860,30,1,6,7,14.3%,15m
20089,2,[13g12p]reaverdrop,2860,0,0,1,1,0.0%,2m
20089,2,Skatik,2860,0,0,1,1,0.0%,1h
20089,3,Plikis,2860,0,0,1,1,0.0%,7m
20118,2,LrdLobster,2859,1042,190,177,367,51.8%,17m
20118,2,WarSpirit,2859,1558,91,84,175,52.0%,11m
20118,3,zidan,2859,1040,40,54,94,42.6%,14m
20118,2,Tireman,2859,738,27,31,58,46.6%,20m
20118,2,Fairlight,2859,489,21,17,38,55.3%,18m
20118,2,Argonis,2859,329,12,15,27,44.4%,16m
20118,3,[Пеtu4]vomyach,2859,318,11,6,17,64.7%,11m
20118,3,[BBCTV]BigBear,2859,282,10,10,20,50.0%,16m
20118,3,Petike,2859,227,8,8,16,50.0%,1h
20118,2,Шершень,2859,48,6,2,8,75.0%,20m
20118,2,undead,2859,206,6,4,10,60.0%,4m
20118,3,[SPRNS]Winil,2859,0,5,0,5,100.0%,7m
20118,1,Mouks,2859,139,3,2,5,60.0%,1h
20118,2,Mopho,2859,0,3,3,6,50.0%,11m
20118,1,[RSPD]denchik,2859,0,3,5,8,37.5%,6m
20118,2,Faron,2859,140,3,7,10,30.0%,3m
20118,3,Amsanity,2859,30,2,1,3,66.7%,12m
20118,3,DraganSLL,2859,58,2,2,4,50.0%,21m
20118,2,Shax,2859,115,2,3,5,40.0%,22m
20118,3,[ZERGSC]makosin,2859,0,2,3,5,40.0%,15m
20118,2,BigBig,2859,60,2,7,9,22.2%,20m
20118,3,MSM,2859,0,1,0,1,100.0%,11m
20118,3,Горох,2859,0,1,0,1,100.0%,3m
20118,3,KriK,2859,30,1,1,2,50.0%,10m
20118,2,enRaGe,2859,0,1,2,3,33.3%,1h
20118,3,Boyington,2859,30,1,2,3,33.3%,18m
20118,3,[RealEG]fabfab,2859,30,1,3,4,25.0%,13m
20118,3,Champloo,2859,0,0,1,1,0.0%,13m
20118,3,Terranboy,2859,0,0,2,2,0.0%,3m
20147,3,solo,2858,1566,228,222,450,50.7%,16m
20147,3,[SPAINs]madara,2858,1562,223,195,418,53.3%,11m
20147,2,Морпех,2858,1476,173,174,347,49.9%,5m
20147,3,Weteran,2858,1473,138,128,266,51.9%,23m
20147,1,Gremlins,2858,1576,118,125,243,48.6%,17m
20147,3,Jesaya,2858,1590,105,94,199,52.8%,19m
20147,2,Angleton,2858,1257,61,55,116,52.6%,2m
20147,2,[SPАRТА]Akixiro,2858,1002,52,49,101,51.5%,5m
20147,2,Diobrin,2858,1023,36,46,82,43.9%,11m
20147,2,OgreZerg,2858,732,35,36,71,49.3%,12m
20147,1,Myxomor,2858,767,30,31,61,49.2%,13m
20147,3,Krag,2858,371,14,15,29,48.3%,12m
20147,3,Coldbrant,2858,324,13,10,23,56.5%,7m
20147,1,[Sc2V]Maximus,2858,298,11,12,23,47.8%,17m
20147,3,LolYou,2858,266,10,2,12,83.3%,7m
20147,3,[P1W0]CinekV,2858,297,10,5,15,66.7%,3m
20147,2,simpson,2858,237,9,8,17,52.9%,18m
20147,3,Trusty,2858,214,7,6,13,53.8%,5m
20147,3,Rico,2858,163,5,1,6,83.3%,2m
20147,1,Доминион,2858,0,3,3,6,50.0%,24m
20147,2,ChristianKa,2858,0,3,3,6,50.0%,60m
20147,1,Dippo,2858,123,3,3,6,50.0%,17m
20147,3,Zakra,2858,30,2,1,3,66.7%,21m
20147,3,legalasca,2858,58,2,3,5,40.0%,17m
20147,3,henkuli,2858,58,2,4,6,33.3%,18m
20147,2,[FLDI]Sitixallion,2858,0,1,1,2,50.0%,19m
20147,3,Ignacio,2858,0,1,1,2,50.0%,16m
20147,3,RoodI,2858,30,1,2,3,33.3%,7m
20147,3,MCT,2858,95,1,3,4,25.0%,10m
20147,3,[leOS]Week,2858,0,0,1,1,0.0%,21m
20147,3,MrDeityZenit,2858,0,0,3,3,0.0%,21m
20178,3,TheDonOfGhaz,2857,1605,260,231,491,53.0%,16m
20178,2,BTC,2857,1094,167,161,328,50.9%,8m
20178,2,Rayreborned,2857,1338,135,132,267,50.6%,18m
20178,1,IIIIIIIIIIII,2857,1389,110,107,217,50.7%,8m
20178,2,Boitout,2857,1600,108,90,198,54.5%,5m
20178,2,Crusher,2857,1470,102,99,201,50.7%,23m
20178,2,AKmarcoes,2857,756,92,85,177,52.0%,13m
20178,3,fgvyjmvgbyki,2857,1500,60,55,115,52.2%,15m
20178,2,noumal,2857,1151,50,40,90,55.6%,11m
20178,3,Wolraad,2857,1039,46,32,78,59.0%,4m
20178,3,Fairlight,2857,876,43,28,71,60.6%,15m
20178,1,dedusmaximo,2857,737,33,41,74,44.6%,6m
20178,3,Tsunami,2857,744,27,25,52,51.9%,17m
20178,3,[PMMM]Ender,2857,294,26,7,33,78.8%,9m
20178,2,Aviso,2857,492,20,17,37,54.1%,11m
20178,3,Bleza,2857,377,13,13,26,50.0%,17m
20178,2,Mifico,2857,336,12,19,31,38.7%,11m
20178,3,Papasmurf,2857,276,9,7,16,56.2%,1h
20178,2,Arclite,2857,176,9,11,20,45.0%,11m
20178,2,Royal,2857,256,9,14,23,39.1%,16m
20178,1,PowerNap,2857,234,7,7,14,50.0%,1h
20178,3,[FuFAt]Jihaijoh,2857,183,6,1,7,85.7%,1h
20178,3,[MAKinG]lowberry,2857,146,6,3,9,66.7%,11m
20178,3,Cindom,2857,0,4,1,5,80.0%,12m
20178,3,БаРкОд,2857,30,4,4,8,50.0%,8m
20178,3,Shotl,2857,133,3,2,5,60.0%,8m
20178,2,RomanWin,2857,62,3,6,9,33.3%,15m
20178,3,Tcinq,2857,30,2,0,2,100.0%,5m
20178,3,Purifier,2857,0,2,3,5,40.0%,17m
20178,3,Алексей,2857,30,1,3,4,25.0%,3m
20178,2,TEREBON,2857,30,1,7,8,12.5%,17m
20178,3,[3Pen]Alex,2857,0,0,1,1,0.0%,5m
20178,3,[PTeam]Terminator,2857,0,0,1,1,0.0%,19m
20211,2,[daGrnd]Volkssport,2856,1604,138,140,278,49.6%,7m
20211,3,hmukos,2856,1605,126,98,224,56.2%,2m
20211,3,MiChAtLLO,2856,1522,76,63,139,54.7%,6m
20211,2,Vuko,2856,1328,68,64,132,51.5%,7m
20211,3,[CaRm]Isenhart,2856,1364,61,47,108,56.5%,11m
20211,3,Kris,2856,1459,60,59,119,50.4%,10m
20211,3,west,2856,702,27,24,51,52.9%,3m
20211,2,Карон,2856,345,24,27,51,47.1%,14m
20211,3,Dyrolom,2856,407,18,13,31,58.1%,19m
20211,3,FrozenFlame,2856,432,18,14,32,56.2%,4m
20211,2,Kriptonian,2856,409,18,23,41,43.9%,11m
20211,1,Jolty,2856,399,17,17,34,50.0%,17m
20211,3,[IODIS]FucUrMom,2856,404,16,11,27,59.3%,18m
20211,2,[xBCBx]christopher,2856,385,16,16,32,50.0%,12m
20211,2,Garvard,2856,324,12,15,27,44.4%,7m
20211,3,HeadChef,2856,315,11,9,20,55.0%,16m
20211,3,AcArd,2856,153,10,1,11,90.9%,5m
20211,3,ROA,2856,254,10,7,17,58.8%,9m
20211,2,Пограничник,2856,242,9,12,21,42.9%,15m
20211,1,Avilay,2856,153,6,5,11,54.5%,1h
20211,3,ARTANIS,2856,145,6,7,13,46.2%,24m
20211,3,IronMan,2856,194,6,7,13,46.2%,21m
20211,3,DirtyToss,2856,30,5,2,7,71.4%,7m
20211,3,[ECU]ecuYaz,2856,171,5,5,10,50.0%,20m
20211,3,TEMYP,2856,86,4,2,6,66.7%,18m
20211,2,lllllllllll,2856,46,4,3,7,57.1%,21m
20211,3,[ЧИcЯe4]Carlos,2856,119,4,4,8,50.0%,9m
20211,3,GoDFatheR,2856,92,4,5,9,44.4%,13m
20211,2,Itachi,2856,118,4,10,14,28.6%,20m
20211,2,Nawar,2856,0,3,1,4,75.0%,1h
20211,3,[SAKZ]Polidrap,2856,58,3,3,6,50.0%,13m
20211,3,Sirukal,2856,30,2,1,3,66.7%,6m
20211,3,[IRBD]kingwarde,2856,30,2,2,4,50.0%,19m
20211,2,Kotyara,2856,30,2,5,7,28.6%,18m
20211,2,[C0RE]Scrappy,2856,30,2,8,10,20.0%,17m
20211,3,[dumbfu]BlackJack,2856,0,1,0,1,100.0%,21m
20211,3,KannaKamui,2856,0,1,0,1,100.0%,12m
20211,2,[ZERGYT]BTCHunter,2856,0,1,1,2,50.0%,12m
20211,3,[Prvrs]phophy,2856,30,1,4,5,20.0%,12m
20211,3,[Karoko]Titus,2856,0,0,1,1,0.0%,20m
20211,3,[696]Fratterrain,2856,0,0,1,1,0.0%,12m
20252,3,MoonShine,2855,1499,185,158,343,53.9%,13m
20252,2,Eaton,2855,1070,94,95,189,49.7%,3m
20252,3,Finn,2855,1510,85,72,157,54.1%,18m
20252,2,Palindromic,2855,958,61,57,118,51.7%,10m
20252,2,lolcake,2855,1491,58,61,119,48.7%,2m
20252,2,fabi,2855,1052,39,44,83,47.0%,18m
20252,3,MassFly,2855,373,38,17,55,69.1%,13m
20252,3,Riptide,2855,643,31,31,62,50.0%,2m
20252,3,[SEWP]Dmitrij,2855,424,26,21,47,55.3%,10m
20252,2,[A0P]Tanatheld,2855,574,24,21,45,53.3%,15m
20252,3,[Arrows]LoMaster,2855,485,18,11,29,62.1%,13m
20252,3,Genka,2855,476,17,28,45,37.8%,23m
20252,3,CVDH,2855,396,16,10,26,61.5%,7m
20252,3,SuperSonics,2855,442,16,18,34,47.1%,11m
20252,2,ShadowDrop,2855,368,15,16,31,48.4%,10m
20252,3,Mortumnus,2855,262,12,9,21,57.1%,14m
20252,3,Cos,2855,226,9,6,15,60.0%,17m
20252,3,Inter,2855,148,6,6,12,50.0%,12m
20252,3,HavanaBanana,2855,114,5,2,7,71.4%,3m
20252,2,aim,2855,30,5,4,9,55.6%,6m
20252,3,brulaap,2855,136,5,5,10,50.0%,17m
20252,1,kevdhore,2855,96,5,6,11,45.5%,13m
20252,3,[PCon]PISTOLAxHERO,2855,0,4,1,5,80.0%,17m
20252,1,SkarrD,2855,97,4,3,7,57.1%,1h
20252,1,[SSFo]Voidprime,2855,146,4,4,8,50.0%,1h
20252,2,TIMTIM,2855,130,4,6,10,40.0%,8m
20252,1,Pharaon,2855,0,3,3,6,50.0%,10m
20252,3,[DTMERE]redsabre,2855,58,2,5,7,28.6%,10m
20252,2,[BoxerS]Slayer,2855,62,2,11,13,15.4%,8m
20252,3,[Frevo]blacknightHD,2855,0,1,0,1,100.0%,15m
20252,3,Loung,2855,0,1,1,2,50.0%,11m
20252,3,[H0tLV]DangO,2855,0,1,2,3,33.3%,17m
20252,3,Lapsonen,2855,30,1,2,3,33.3%,13m
20252,3,Borzya,2855,30,1,2,3,33.3%,12m
20252,3,Ehlron,2855,30,1,3,4,25.0%,19m
20252,3,rumel,2855,30,1,4,5,20.0%,19m
20252,3,[WALRUS]Cthulu,2855,0,0,1,1,0.0%,17m
20252,3,NeRoN,2855,0,0,4,4,0.0%,13m
20290,2,Yurek,2854,1592,99,102,201,49.3%,14m
20290,2,[noоb]BOBO,2854,1282,96,89,185,51.9%,17m
20290,2,[RETADO]Mads,2854,952,85,83,168,50.6%,5m
20290,2,zairax,2854,1247,55,51,106,51.9%,11m
20290,3,Crafter,2854,1295,53,43,96,55.2%,19m
20290,3,Maximus,2854,1025,49,36,85,57.6%,3m
20290,2,Funkyfingers,2854,265,31,28,59,52.5%,16m
20290,2,PuddleGum,2854,720,28,26,54,51.9%,13m
20290,3,OutoOlio,2854,607,27,19,46,58.7%,21m
20290,2,chobo,2854,560,25,21,46,54.3%,18m
20290,3,Romanticide,2854,329,11,7,18,61.1%,1h
20290,2,Szaky,2854,328,11,13,24,45.8%,20m
20290,2,ValsOgard,2854,254,10,9,19,52.6%,16m
20290,3,Mongopusher,2854,238,8,4,12,66.7%,7m
20290,2,Fudge,2854,230,8,9,17,47.1%,21m
20290,2,THEbUhOXxX,2854,250,7,10,17,41.2%,4m
20290,1,twardy,2854,162,7,13,20,35.0%,15m
20290,3,Franzi,2854,175,6,0,6,100.0%,17m
20290,3,VeLL,2854,32,5,5,10,50.0%,2m
20290,3,Alexei,2854,142,5,5,10,50.0%,10m
20290,3,afqsojdf,2854,52,5,7,12,41.7%,17m
20290,3,Vargavaka,2854,116,4,4,8,50.0%,4m
20290,3,Gyppokrat,2854,92,3,3,6,50.0%,2m
20290,3,Elenfall,2854,58,2,2,4,50.0%,17m
20290,3,RAYN,2854,30,2,3,5,40.0%,14m
20290,3,Echo,2854,0,1,1,2,50.0%,2m
20290,3,BlackSilver,2854,30,1,3,4,25.0%,12m
20290,3,Zet,2854,0,0,1,1,0.0%,18m
20290,2,Marliv,2854,0,0,1,1,0.0%,1h
20319,3,DOIMLER,2853,1325,302,293,595,50.8%,6m
20319,2,PsxYoshi,2853,1545,125,125,250,50.0%,11m
20319,2,[MADNSS]MugenKyoki,2853,1049,57,53,110,51.8%,21m
20319,2,IIIIIIIIIIII,2853,910,50,46,96,52.1%,20m
20319,1,Starfury,2853,333,48,59,107,44.9%,22m
20319,3,Awve,2853,548,22,21,43,51.2%,7m
20319,2,sevro,2853,507,21,18,39,53.8%,8m
20319,3,[BZEZs]icecreamboy,2853,613,21,21,42,50.0%,13m
20319,2,Werber,2853,408,15,21,36,41.7%,8m
20319,3,[OeSp]MajorRush,2853,324,14,12,26,53.8%,16m
20319,3,DarKLine,2853,304,13,9,22,59.1%,9m
20319,3,Telari,2853,227,9,7,16,56.2%,50m
20319,2,[hTChu]EvRaNoC,2853,268,9,15,24,37.5%,2m
20319,3,[1ndica]ZerO,2853,299,9,17,26,34.6%,23m
20319,1,Dino,2853,210,8,4,12,66.7%,1h
20319,3,LIXLIVLXXXIV,2853,114,7,5,12,58.3%,19m
20319,3,Pertinez,2853,202,7,8,15,46.7%,11m
20319,1,[axis]Benthe,2853,143,4,3,7,57.1%,23m
20319,3,FiLaPpA,2853,0,3,2,5,60.0%,17m
20319,3,[eSpB]Nep,2853,58,3,2,5,60.0%,18m
20319,3,OsmosLF,2853,86,3,4,7,42.9%,2m
20319,3,AdmiralAs,2853,90,3,5,8,37.5%,16m
20319,2,Tomas,2853,0,2,3,5,40.0%,1h
20319,3,[Pönös]TranneLRK,2853,30,1,3,4,25.0%,15m
20319,3,DaCruz,2853,30,1,3,4,25.0%,18m
20319,2,[NWGD]AXILES,2853,0,1,4,5,20.0%,23m
20319,3,Nachti,2853,0,0,1,1,0.0%,7m
20319,3,BoomShack,2853,0,0,1,1,0.0%,10m
20319,3,[palpal]AureoSniper,2853,0,0,1,1,0.0%,16m
20319,3,[SuaZL]HeyitsPg,2853,0,0,2,2,0.0%,19m
20319,3,Chuchxe,2853,0,0,2,2,0.0%,17m
20319,3,[BULB]MrDarkTesla,2853,0,0,2,2,0.0%,21m
20351,2,zadrim,2852,1498,180,177,357,50.4%,5m
20351,2,romin,2852,1502,127,102,229,55.5%,16m
20351,2,Frazl,2852,1523,97,92,189,51.3%,9m
20351,3,fky,2852,1587,96,82,178,53.9%,5m
20351,2,KoivunHerra,2852,890,43,36,79,54.4%,10m
20351,1,Neeko,2852,903,38,43,81,46.9%,21m
20351,3,VechnoOdinok,2852,633,24,17,41,58.5%,20m
20351,2,Pleidrup,2852,552,20,24,44,45.5%,3m
20351,2,Pilgrim,2852,530,18,27,45,40.0%,2m
20351,3,dereklq,2852,344,15,14,29,51.7%,20m
20351,1,PvtSnowball,2852,167,7,5,12,58.3%,50m
20351,3,Smoke,2852,200,7,7,14,50.0%,3m
20351,2,Dante,2852,0,5,2,7,71.4%,10m
20351,2,IVANPROTOS,2852,0,4,1,5,80.0%,14m
20351,3,Sodomie,2852,86,4,2,6,66.7%,6m
20351,2,IIIIIIIIIIII,2852,30,4,4,8,50.0%,6m
20351,2,InterBanana,2852,30,4,4,8,50.0%,17m
20351,2,[OCEANS]TriggerFish,2852,142,4,7,11,36.4%,8m
20351,2,afony,2852,60,2,6,8,25.0%,15m
20351,1,[Mo0o]TheAbsconder,2852,0,1,0,1,100.0%,6m
20351,1,артём,2852,97,1,2,3,33.3%,2m
20351,3,[CtStWs]WODZUMASTA,2852,0,0,1,1,0.0%,14m
20351,3,дима,2852,0,0,1,1,0.0%,7m
20351,1,Darkglasses,2852,0,0,8,8,0.0%,7m
20375,2,saracen,2851,1568,251,241,492,51.0%,14m
20375,3,mialinx,2851,1544,208,208,416,50.0%,11m
20375,3,Blitzfang,2851,1139,78,58,136,57.4%,13m
20375,1,Litago,2851,1312,63,79,142,44.4%,6m
20375,3,[KK57]Quasimodo,2851,1308,54,48,102,52.9%,7m
20375,2,fan,2851,197,28,30,58,48.3%,9m
20375,3,Kiskov,2851,291,25,20,45,55.6%,14m
20375,3,CWD,2851,514,20,12,32,62.5%,16m
20375,2,[DILIT]scorpion,2851,431,19,14,33,57.6%,18m
20375,2,FrostyFeet,2851,446,19,19,38,50.0%,20m
20375,3,ness,2851,404,16,9,25,64.0%,6m
20375,3,kres,2851,376,15,10,25,60.0%,3m
20375,3,Shadow,2851,291,15,12,27,55.6%,5m
20375,3,[NLTN]niko,2851,209,6,2,8,75.0%,6m
20375,2,gepardy,2851,150,6,9,15,40.0%,16m
20375,3,kanacraft,2851,0,4,1,5,80.0%,20m
20375,2,adidi,2851,0,4,1,5,80.0%,21m
20375,3,Антошка,2851,138,4,3,7,57.1%,13m
20375,3,slazy,2851,144,4,6,10,40.0%,9m
20375,3,[SZM]Sole,2851,72,4,9,13,30.8%,55m
20375,2,UltimateJJ,2851,0,3,3,6,50.0%,23m
20375,3,Bolkonskiy,2851,56,3,4,7,42.9%,13m
20375,3,[NWGD]MeguminSan,2851,30,2,0,2,100.0%,11m
20375,1,RHnegative,2851,97,2,0,2,100.0%,3m
20375,3,[SPSes]ivanrsz,2851,60,2,2,4,50.0%,9m
20375,3,Mura,2851,30,2,2,4,50.0%,17m
20375,1,Slava,2851,48,2,2,4,50.0%,1h
20375,2,Ambulanz,2851,0,1,2,3,33.3%,11m
20375,3,Ibz,2851,32,1,3,4,25.0%,9m
20375,2,cuteSCV,2851,0,0,1,1,0.0%,50m
20375,1,bbqsauce,2851,0,0,2,2,0.0%,18m
20375,3,Sylar,2851,0,0,2,2,0.0%,20m
20375,3,MrBigMac,2851,0,0,4,4,0.0%,19m
20408,1,ElGrEeEn,2850,1613,305,304,609,50.1%,2m
20408,3,MatStar,2850,880,183,167,350,52.3%,20m
20408,2,Yrrg,2850,1503,147,140,287,51.2%,22m
20408,3,joleclodo,2850,1597,97,91,188,51.6%,17m
20408,3,[Донный]GRIF,2850,1595,83,63,146,56.8%,16m
20408,2,Zeus,2850,1069,74,73,147,50.3%,23m
20408,3,Tergeist,2850,1325,72,61,133,54.1%,11m
20408,3,[hf4X4]Parapoomba,2850,950,41,27,68,60.3%,19m
20408,3,TpaXyXoJIb,2850,626,26,23,49,53.1%,7m
20408,2,Leer,2850,440,17,18,35,48.6%,10m
20408,2,[yedi]DirkDiggler,2850,170,16,21,37,43.2%,15m
20408,3,Balage,2850,205,11,10,21,52.4%,13m
20408,1,spite,2850,385,11,20,31,35.5%,2m
20408,1,[NIC]niclucky,2850,230,10,6,16,62.5%,24m
20408,3,vank,2850,255,8,5,13,61.5%,20m
20408,1,[8oD]dikkebeer,2850,223,8,6,14,57.1%,1h
20408,3,ARXONT,2850,192,7,8,15,46.7%,19m
20408,3,[CОS]abracadabra,2850,166,6,7,13,46.2%,5m
20408,2,chrispy,2850,216,6,10,16,37.5%,10m
20408,3,blaz,2850,119,4,3,7,57.1%,3m
20408,3,[RBlood]Heazeun,2850,58,3,1,4,75.0%,3m
20408,3,ToxyGen,2850,0,3,2,5,60.0%,23m
20408,2,BARS,2850,0,3,2,5,60.0%,17m
20408,3,BloodyTtime,2850,94,3,3,6,50.0%,2m
20408,3,Rhedone,2850,88,3,5,8,37.5%,10m
20408,1,cHL,2850,97,2,1,3,66.7%,23m
20408,3,[Farla]chiwendios,2850,0,1,0,1,100.0%,13m
20408,3,[Ewaldi]Dico,2850,93,1,1,2,50.0%,18m
20408,3,Ravnodushie,2850,30,1,1,2,50.0%,9m
20408,3,Pims,2850,0,1,2,3,33.3%,13m
20408,3,ChriSLinkz,2850,30,1,2,3,33.3%,17m
20408,3,[YLLUMA]DrZoidberg,2850,0,1,3,4,25.0%,21m
20408,3,[HOIHOI]Chadodaren,2850,0,0,1,1,0.0%,15m
20408,3,[RBlood]ChenZen,2850,0,0,1,1,0.0%,23m
20442,1,Dave,2849,1611,281,272,553,50.8%,23m
20442,2,Julian,2849,1497,210,199,409,51.3%,16m
20442,2,PRAPOR,2849,1415,82,68,150,54.7%,14m
20442,2,[xZero]astrolog,2849,1080,46,53,99,46.5%,3m
20442,3,Gud,2849,605,43,39,82,52.4%,20m
20442,3,[TTLM]SirshinSpyd,2849,728,28,27,55,50.9%,14m
20442,2,soldier,2849,460,19,18,37,51.4%,14m
20442,1,SaSSoN,2849,606,19,29,48,39.6%,21m
20442,3,[БУБУБ]DeadLine,2849,496,18,14,32,56.2%,17m
20442,1,LiquidClem,2849,425,18,20,38,47.4%,21m
20442,3,AndyNineNine,2849,350,16,13,29,55.2%,17m
20442,2,lIIlIIlIlllI,2849,362,13,20,33,39.4%,8m
20442,3,player,2849,323,11,10,21,52.4%,21m
20442,2,RunningmaN,2849,307,11,12,23,47.8%,20m
20442,3,toudi,2849,202,8,10,18,44.4%,2m
20442,1,Hierarch,2849,174,5,6,11,45.5%,2m
20442,2,[C1KK]Croc,2849,95,4,2,6,66.7%,50m
20442,2,[slayn]darckfail,2849,88,4,4,8,50.0%,13m
20442,1,Kocim,2849,145,3,2,5,60.0%,1h
20442,2,[SPy13]galaxy,2849,0,1,0,1,100.0%,1h
20442,3,Тусич,2849,0,1,1,2,50.0%,13m
20442,3,[OSgZ]KnowDespair,2849,0,0,1,1,0.0%,21m
20442,3,Erlaq,2849,0,0,2,2,0.0%,19m
20442,3,Arheon,2849,0,0,2,2,0.0%,17m
20442,3,MorroLord,2849,0,0,3,3,0.0%,6m
20467,2,igorgnedish,2848,1597,339,333,672,50.4%,14m
20467,1,Leon,2848,1576,266,261,527,50.5%,14m
20467,3,Nik,2848,1573,154,139,293,52.6%,19m
20467,2,Marci,2848,1532,98,93,191,51.3%,20m
20467,3,ftrMorri,2848,928,37,38,75,49.3%,17m
20467,2,SOOOOHAPPY,2848,660,34,33,67,50.7%,11m
20467,2,Fizi,2848,780,30,34,64,46.9%,20m
20467,2,ArquiRaVeN,2848,640,26,24,50,52.0%,9m
20467,3,dcj,2848,619,24,19,43,55.8%,5m
20467,3,[LLAP]Nostromo,2848,420,21,8,29,72.4%,20m
20467,3,LuggieCZ,2848,462,18,12,30,60.0%,20m
20467,3,Gfa,2848,552,18,41,59,30.5%,7m
20467,3,GRey,2848,441,17,12,29,58.6%,17m
20467,2,Habicht,2848,192,15,14,29,51.7%,6m
20467,3,Void,2848,376,14,11,25,56.0%,22m
20467,3,Godlike,2848,270,9,10,19,47.4%,4m
20467,3,[ExTr1m]goodbaker,2848,194,7,7,14,50.0%,15m
20467,3,[ZELNAG]Tigervic,2848,86,4,6,10,40.0%,19m
20467,3,Pashhar,2848,58,3,2,5,60.0%,20m
20467,2,Reoflex,2848,0,3,2,5,60.0%,9m
20467,2,WiKkee,2848,0,3,2,5,60.0%,50m
20467,2,Omni,2848,144,3,8,11,27.3%,11m
20467,3,Protosik,2848,94,2,0,2,100.0%,19m
20467,3,PumpeLaGarde,2848,30,2,1,3,66.7%,20m
20467,2,knallentin,2848,131,2,5,7,28.6%,17m
20467,3,[LSPs]Stimpack,2848,0,1,3,4,25.0%,2m
20467,3,[JBPs]saneb,2848,0,0,1,1,0.0%,10m
20467,3,[DDrago]BGW,2848,0,0,2,2,0.0%,13m
20467,1,[ZЕRGTV]дыдыдыр,2848,0,0,4,4,0.0%,7m
20496,1,PapaJ,2847,1579,255,249,504,50.6%,23m
20496,1,XOso,2847,1591,183,181,364,50.3%,12m
20496,2,Choko,2847,1599,113,108,221,51.1%,6m
20496,3,nacura,2847,1319,104,90,194,53.6%,17m
20496,3,Optimus,2847,1046,89,83,172,51.7%,17m
20496,3,Donys,2847,1409,83,70,153,54.2%,9m
20496,1,Abralias,2847,1249,83,86,169,49.1%,20m
20496,3,Orion,2847,1574,81,61,142,57.0%,2m
20496,3,Nicoco,2847,1161,49,39,88,55.7%,13m
20496,3,IntroSpirit,2847,705,36,26,62,58.1%,17m
20496,2,[ImAs]Nosferatu,2847,465,28,27,55,50.9%,4m
20496,2,сасика,2847,695,26,27,53,49.1%,15m
20496,2,FABZ,2847,582,22,21,43,51.2%,4m
20496,2,ganger,2847,530,20,23,43,46.5%,2m
20496,1,Даниил,2847,559,19,26,45,42.2%,2m
20496,3,TyrokMoskow,2847,296,10,11,21,47.6%,13m
20496,3,[doof]Presbyteros,2847,278,9,5,14,64.3%,5m
20496,3,[ZIN]Epizon,2847,142,6,4,10,60.0%,2m
20496,2,[Mercy1]Grumbleball,2847,169,6,6,12,50.0%,2m
20496,3,Starhansi,2847,180,6,10,16,37.5%,19m
20496,2,ApolloRO,2847,46,5,2,7,71.4%,1h
20496,3,llllllllllll,2847,118,5,4,9,55.6%,17m
20496,1,Executioner,2847,190,4,5,9,44.4%,10m
20496,3,[DrkShp]HuangZhong,2847,114,4,7,11,36.4%,9m
20496,3,llllllllllll,2847,118,3,0,3,100.0%,7m
20496,3,[KnK]WolVeRinE,2847,58,3,2,5,60.0%,17m
20496,3,[Vioc]ponky,2847,58,2,1,3,66.7%,20m
20496,3,Dasha,2847,60,2,3,5,40.0%,20m
20496,2,Glenfiddich,2847,0,1,0,1,100.0%,1h
20496,1,aye,2847,0,1,0,1,100.0%,3m
20496,3,darkforce,2847,0,0,1,1,0.0%,19m
20527,3,BrovarHoff,2846,1614,116,100,216,53.7%,10m
20527,2,drrtuy,2846,1189,65,67,132,49.2%,2m
20527,3,MiQuan,2846,1313,59,49,108,54.6%,17m
20527,2,Bone,2846,803,34,31,65,52.3%,16m
20527,3,[UNS]OmuVerde,2846,684,25,28,53,47.2%,5m
20527,3,[Bikok]Dushko,2846,369,23,20,43,53.5%,17m
20527,3,Seth,2846,616,22,28,50,44.0%,3m
20527,3,blademaster,2846,474,16,14,30,53.3%,17m
20527,3,Krzysztofeł,2846,379,14,12,26,53.8%,8m
20527,3,julaine,2846,228,11,5,16,68.8%,5m
20527,3,Arobein,2846,242,7,6,13,53.8%,13m
20527,1,[YLLUMA]martz,2846,174,6,18,24,25.0%,6m
20527,1,FOG,2846,143,5,4,9,55.6%,1h
20527,3,Azazel,2846,86,4,1,5,80.0%,3m
20527,2,Humongous,2846,142,4,1,5,80.0%,50m
20527,2,gasmeter,2846,114,4,3,7,57.1%,58m
20527,3,eddyee,2846,92,4,5,9,44.4%,7m
20527,1,Noah,2846,141,3,2,5,60.0%,23m
20527,3,Nook,2846,30,2,0,2,100.0%,8m
20527,3,Dieter,2846,30,2,0,2,100.0%,18m
20527,3,Lersu,2846,30,2,0,2,100.0%,3m
20527,3,KooKish,2846,30,2,2,4,50.0%,18m
20527,3,[013NL]Riffdoctor,2846,58,2,2,4,50.0%,16m
20527,3,artrose,2846,0,1,1,2,50.0%,3m
20527,1,Painful,2846,0,1,2,3,33.3%,12m
20527,3,TwilightFox,2846,30,1,4,5,20.0%,10m
20527,3,MrDurden,2846,0,0,1,1,0.0%,20m
20527,3,Asta,2846,0,0,1,1,0.0%,18m
20527,3,xyzxyz,2846,0,0,1,1,0.0%,16m
20527,3,slatyjonny,2846,0,0,1,1,0.0%,19m
20527,1,GrlFiauxe,2846,0,0,1,1,0.0%,5m
20527,3,Rahvin,2846,0,0,2,2,0.0%,3m
20527,3,[Gоld]Bonuz,2846,0,0,2,2,0.0%,3m
20527,3,BackToBronze,2846,0,0,2,2,0.0%,13m
20561,2,[MaSSS]ironcrack,2845,1529,116,118,234,49.6%,21m
20561,2,max,2845,1574,102,100,202,50.5%,7m
20561,3,MARINECoRps,2845,1480,72,43,115,62.6%,5m
20561,2,Retaliator,2845,1097,67,63,130,51.5%,20m
20561,3,[corpse]APPOLO,2845,493,37,29,66,56.1%,10m
20561,2,yipZman,2845,654,25,25,50,50.0%,20m
20561,3,Janzeer,2845,517,24,20,44,54.5%,14m
20561,1,IIIIIIIIIIII,2845,351,15,15,30,50.0%,7m
20561,3,[Yame]Christophe,2845,405,13,17,30,43.3%,20m
20561,2,ZuLuuuuuu,2845,319,12,10,22,54.5%,20m
20561,3,Lukey,2845,346,12,11,23,52.2%,6m
20561,3,CaptainSalt,2845,287,9,14,23,39.1%,2m
20561,3,Unkara,2845,206,8,5,13,61.5%,17m
20561,3,Aleks,2845,152,6,8,14,42.9%,2m
20561,2,[Svart]Lolpwnd,2845,119,5,4,9,55.6%,11m
20561,1,christoboule,2845,190,5,5,10,50.0%,1h
20561,3,[Iacbto]Dudley,2845,86,4,2,6,66.7%,16m
20561,2,[xFire]dumenekk,2845,0,3,2,5,60.0%,1h
20561,2,JohnDalton,2845,0,2,3,5,40.0%,1h
20561,3,[AKG]CaptainRex,2845,97,1,2,3,33.3%,1h
20561,3,Epimetheus,2845,0,1,4,5,20.0%,23m
20561,3,[1K1L]DextroyerXp,2845,0,0,1,1,0.0%,3m
20561,3,[ZeBa]Hansdampf,2845,0,0,1,1,0.0%,8m
20584,1,BelicoIII,2844,464,168,151,319,52.7%,4m
20584,3,Alkadia,2844,1510,92,74,166,55.4%,17m
20584,3,dminajevs,2844,1310,83,68,151,55.0%,15m
20584,2,nightwing,2844,998,59,63,122,48.4%,7m
20584,2,[BJRTS]Gimove,2844,1346,57,54,111,51.4%,13m
20584,1,wasteland,2844,1154,46,44,90,51.1%,3m
20584,3,[W4ifu]CocoNutz,2844,785,35,19,54,64.8%,17m
20584,3,Dody,2844,621,28,14,42,66.7%,16m
20584,3,Kotgrove,2844,411,28,24,52,53.8%,22m
20584,3,[WYG]DEX,2844,536,23,18,41,56.1%,10m
20584,3,VALET,2844,414,16,13,29,55.2%,4m
20584,3,[IndyK]rNs,2844,416,15,9,24,62.5%,9m
20584,2,Zoub,2844,425,13,18,31,41.9%,8m
20584,1,Yoo,2844,229,10,5,15,66.7%,3m
20584,3,Lasaqus,2844,232,10,7,17,58.8%,6m
20584,3,Siwaka,2844,174,8,4,12,66.7%,17m
20584,3,kurica,2844,233,7,4,11,63.6%,13m
20584,3,Xoronn,2844,182,5,10,15,33.3%,21m
20584,3,Polaris,2844,90,4,2,6,66.7%,9m
20584,3,Brensted,2844,120,4,7,11,36.4%,3m
20584,2,[Span]Bugsy,2844,160,3,2,5,60.0%,56m
20584,2,Mike,2844,0,3,2,5,60.0%,1h
20584,3,Lime,2844,94,3,3,6,50.0%,5m
20584,3,Коломбо,2844,119,2,1,3,66.7%,18m
20584,3,PtZpTz,2844,58,2,2,4,50.0%,20m
20584,3,Minemixers,2844,30,2,2,4,50.0%,18m
20584,3,CyTeHePMambI,2844,30,2,2,4,50.0%,16m
20584,3,Steve,2844,0,2,3,5,40.0%,6m
20584,3,MORITURI,2844,58,2,3,5,40.0%,10m
20584,2,Эжахж,2844,60,2,7,9,22.2%,4m
20584,3,[Hppl]Axezz,2844,0,1,0,1,100.0%,18m
20584,3,[1stGG]MachineHead,2844,0,1,0,1,100.0%,22m
20584,3,NoSurrender,2844,30,1,2,3,33.3%,7m
20584,3,Maxraynor,2844,0,0,1,1,0.0%,20m
20584,3,slv,2844,0,0,1,1,0.0%,2m
20584,3,ParaDice,2844,0,0,1,1,0.0%,8m
20584,3,[DeTK]DezPriest,2844,0,0,2,2,0.0%,12m
20584,3,Timofey,2844,0,0,2,2,0.0%,2m
20584,3,[Defeat]Svenling,2844,0,0,3,3,0.0%,19m
20623,3,kornikz,2843,1602,85,82,167,50.9%,17m
20623,2,Tsunami,2843,1446,75,72,147,51.0%,7m
20623,3,Sanders,2843,456,17,16,33,51.5%,14m
20623,3,Orlov,2843,247,15,10,25,60.0%,16m
20623,1,CHIMO,2843,444,14,25,39,35.9%,8m
20623,2,BUBALEH,2843,232,10,10,20,50.0%,16m
20623,3,TuPadre,2843,171,7,5,12,58.3%,16m
20623,3,[RBZ]Goblin,2843,174,7,7,14,50.0%,7m
20623,2,[Furya]Ziorko,2843,204,7,9,16,43.8%,9m
20623,2,[ФБК]Pentakl,2843,96,4,2,6,66.7%,52m
20623,3,Fox,2843,30,4,4,8,50.0%,21m
20623,3,[GOHELL]Anihilyator,2843,0,3,2,5,60.0%,19m
20623,3,[Iancu]Moloz,2843,0,3,2,5,60.0%,5m
20623,1,SanzeroBG,2843,0,3,4,7,42.9%,21m
20623,2,Urzaaf,2843,38,2,1,3,66.7%,50m
20623,2,[imb]SmokeHF,2843,0,2,3,5,40.0%,4m
20623,1,MegaDeath,2843,48,2,4,6,33.3%,20m
20623,3,Zennig,2843,0,1,0,1,100.0%,21m
20623,2,CruelZ,2843,0,1,1,2,50.0%,4m
20623,3,[Фаталя]SHABASH,2843,0,1,2,3,33.3%,20m
20623,3,Bluecloud,2843,30,1,3,4,25.0%,21m
20623,3,Snore,2843,30,1,4,5,20.0%,22m
20623,2,mimix,2843,30,1,9,10,10.0%,10m
20623,3,Legion,2843,0,0,2,2,0.0%,2m
20623,3,[FOG]Bloodplayer,2843,0,0,5,5,0.0%,23m
20623,2,Gurman,2843,0,0,6,6,0.0%,9m
20649,2,[PiGPan]GillsForPrem,2842,1621,188,176,364,51.6%,15m
20649,2,[RDCZ]nicobzz,2842,1595,152,140,292,52.1%,8m
20649,1,Corolla,2842,1552,120,114,234,51.3%,15m
20649,3,robinhook,2842,1580,87,77,164,53.0%,16m
20649,2,Limej,2842,1402,62,68,130,47.7%,5m
20649,2,TheLuggage,2842,1532,60,61,121,49.6%,13m
20649,3,Ormando,2842,1301,56,40,96,58.3%,10m
20649,2,GGz,2842,966,52,54,106,49.1%,10m
20649,2,MrYoghurt,2842,1034,48,50,98,49.0%,22m
20649,3,[КПCC]antich,2842,866,36,30,66,54.5%,17m
20649,3,ХитрыйКраб,2842,389,32,12,44,72.7%,9m
20649,3,PPO,2842,484,20,19,39,51.3%,20m
20649,2,GreatEmu,2842,370,19,15,34,55.9%,9m
20649,3,DigitalEnemy,2842,499,19,16,35,54.3%,16m
20649,3,Tvorobey,2842,400,15,10,25,60.0%,16m
20649,3,Draco,2842,354,13,8,21,61.9%,2m
20649,3,Hanurik,2842,370,13,10,23,56.5%,8m
20649,1,WANKPUFFIN,2842,287,10,10,20,50.0%,1h
20649,2,everystone,2842,280,9,14,23,39.1%,10m
20649,2,[jpeg]Octozane,2842,220,8,9,17,47.1%,20m
20649,3,Vers,2842,235,7,9,16,43.8%,5m
20649,2,Mexanizator,2842,198,7,17,24,29.2%,16m
20649,3,[SURN]Heledorn,2842,179,6,2,8,75.0%,18m
20649,3,JayB,2842,122,5,2,7,71.4%,10m
20649,2,eclipse,2842,126,4,11,15,26.7%,20m
20649,2,helininja,2842,114,3,2,5,60.0%,16m
20649,2,Фауст,2842,0,3,3,6,50.0%,16m
20649,2,maebs,2842,48,2,0,2,100.0%,1h
20649,3,[Мульт]smouk,2842,30,2,0,2,100.0%,5m
20649,3,Nüschel,2842,30,2,2,4,50.0%,2m
20649,3,Medardus,2842,60,2,6,8,25.0%,20m
20649,2,bromton,2842,62,2,8,10,20.0%,23m
20649,3,[MkerIT]Barbaro,2842,0,1,0,1,100.0%,17m
20649,3,ArcVico,2842,0,1,0,1,100.0%,13m
20649,3,Wajdolf,2842,30,1,2,3,33.3%,7m
20649,3,Sleepwalker,2842,30,1,4,5,20.0%,19m
20649,3,Cyprien,2842,0,0,1,1,0.0%,18m
20649,3,[Cens]axelteo,2842,0,0,2,2,0.0%,17m
20649,3,AlexDM,2842,0,0,2,2,0.0%,16m
20649,3,Omen,2842,0,0,2,2,0.0%,11m
20649,2,Xill,2842,0,0,2,2,0.0%,1h
20690,1,JamesFord,2841,1610,452,459,911,49.6%,16m
20690,3,Makalaka,2841,1287,107,96,203,52.7%,17m
20690,3,Xeriff,2841,1601,91,82,173,52.6%,2m
20690,3,Midgetlover,2841,1227,53,44,97,54.6%,5m
20690,3,izoterror,2841,627,31,23,54,57.4%,20m
20690,2,[stai]Серджо,2841,701,29,29,58,50.0%,5m
20690,2,niokr,2841,535,25,26,51,49.0%,23m
20690,3,[Godmod]SpaceX,2841,640,23,19,42,54.8%,20m
20690,3,martinez,2841,486,18,16,34,52.9%,10m
20690,3,EinaR,2841,397,17,12,29,58.6%,2m
20690,2,[KGBist]Pavlovich,2841,333,13,23,36,36.1%,20m
20690,3,Navhkrin,2841,321,12,7,19,63.2%,15m
20690,3,Dalm,2841,108,4,3,7,57.1%,22m
20690,3,Swip,2841,30,4,4,8,50.0%,3m
20690,1,PHOBOS,2841,97,4,5,9,44.4%,17m
20690,2,IIIIIIIIIIII,2841,104,3,3,6,50.0%,15m
20690,3,Hodggins,2841,71,3,3,6,50.0%,20m
20690,3,Winter,2841,94,3,7,10,30.0%,4m
20690,3,[696]Ammelon,2841,0,1,2,3,33.3%,3m
20690,3,aiam,2841,30,1,2,3,33.3%,15m
20690,3,waynewatson,2841,30,1,3,4,25.0%,6m
20690,3,[Hrr]Singer,2841,0,0,2,2,0.0%,21m
20690,3,[5APi]TeZArC,2841,0,0,3,3,0.0%,20m
20713,3,GegGigt,2840,1571,168,145,313,53.7%,2m
20713,2,ДитяДонбасса,2840,1411,148,124,272,54.4%,20m
20713,3,yonger,2840,1454,105,84,189,55.6%,16m
20713,2,slimgod,2840,1085,85,69,154,55.2%,5m
20713,1,LightWarrior,2840,617,83,93,176,47.2%,18m
20713,3,Tempent,2840,1316,79,70,149,53.0%,22m
20713,1,Stager,2840,995,71,80,151,47.0%,22m
20713,2,warmy,2840,510,60,52,112,53.6%,8m
20713,2,Major,2840,1243,59,55,114,51.8%,18m
20713,3,Autan,2840,844,52,48,100,52.0%,20m
20713,2,TruvrTinySun,2840,1123,43,45,88,48.9%,8m
20713,3,Garp,2840,999,41,30,71,57.7%,3m
20713,3,Predator,2840,420,33,26,59,55.9%,3m
20713,3,[Z1L]Inquisition,2840,435,17,9,26,65.4%,19m
20713,3,[IXXI]Rod,2840,460,17,13,30,56.7%,17m
20713,3,[InitRu]scorpion,2840,362,13,8,21,61.9%,20m
20713,2,KMM,2840,294,13,11,24,54.2%,11m
20713,2,[OoE]Spithas,2840,265,13,12,25,52.0%,5m
20713,3,[ShSq]Randomizer,2840,313,11,15,26,42.3%,6m
20713,3,MokeyBednykh,2840,271,10,3,13,76.9%,7m
20713,1,Opasmea,2840,230,10,11,21,47.6%,5m
20713,3,Orcosexi,2840,182,7,6,13,53.8%,12m
20713,2,BenSisko,2840,129,3,7,10,30.0%,55m
20713,3,Psycho,2840,0,2,2,4,50.0%,20m
20713,1,Ezagnaros,2840,0,1,0,1,100.0%,1h
20713,3,[BMDR]ItsLaura,2840,0,1,0,1,100.0%,6m
20713,3,Darook,2840,0,1,0,1,100.0%,7m
20713,3,ShadowScythe,2840,0,1,0,1,100.0%,14m
20713,3,stEVE,2840,0,1,1,2,50.0%,2m
20713,1,mondmeister,2840,0,1,2,3,33.3%,22m
20713,3,Idk,2840,0,1,2,3,33.3%,19m
20713,3,Jack,2840,93,1,5,6,16.7%,23m
20713,3,Avarail,2840,0,0,1,1,0.0%,52m
20713,3,Adama,2840,0,0,1,1,0.0%,17m
20713,1,TalTos,2840,0,0,1,1,0.0%,1h
20713,3,[Petrиs]Ravvager,2840,0,0,1,1,0.0%,1h
20713,3,jplgg,2840,0,0,1,1,0.0%,4m
20713,3,УсатыйКот,2840,0,0,1,1,0.0%,21m
20713,3,ChiefRyu,2840,0,0,1,1,0.0%,6m
20713,3,[Sarmat]Majkelrooshi,2840,0,0,2,2,0.0%,6m
20753,2,KingChill,2839,257,86,75,161,53.4%,23m
20753,3,Perun,2839,1654,82,76,158,51.9%,19m
20753,2,MaJIou,2839,1122,71,64,135,52.6%,7m
20753,3,DeathHaze,2839,1264,66,56,122,54.1%,19m
20753,3,Rhye,2839,1184,39,60,99,39.4%,21m
20753,3,steveXcz,2839,780,29,29,58,50.0%,16m
20753,3,[FMmkay]telkamp,2839,383,22,11,33,66.7%,17m
20753,3,Wildpants,2839,486,21,15,36,58.3%,15m
20753,3,GimBrother,2839,483,18,11,29,62.1%,6m
20753,2,TopKek,2839,546,18,22,40,45.0%,8m
20753,2,chRhythm,2839,447,17,18,35,48.6%,6m
20753,3,Alex,2839,363,14,13,27,51.9%,16m
20753,1,ThomGrimmar,2839,222,9,10,19,47.4%,19m
20753,2,[oooboy]black,2839,245,9,11,20,45.0%,15m
20753,3,[улей55]qwerty,2839,238,8,6,14,57.1%,9m
20753,1,dirtysyrikat,2839,189,5,6,11,45.5%,2m
20753,2,lucas,2839,46,4,4,8,50.0%,1h
20753,3,mruniversum,2839,114,4,6,10,40.0%,7m
20753,3,JonyChertov,2839,118,4,6,10,40.0%,20m
20753,3,Solomon,2839,97,3,3,6,50.0%,22m
20753,3,[KrnBrs]mik,2839,86,3,6,9,33.3%,17m
20753,3,NoxZet,2839,92,3,7,10,30.0%,21m
20753,2,procus,2839,114,2,5,7,28.6%,16m
20753,2,Scuby,2839,42,2,10,12,16.7%,16m
20753,3,[Fansaf]Skyre,2839,97,1,1,2,50.0%,14m
20753,3,[AciNoN]Yougurt,2839,30,1,2,3,33.3%,3m
20753,2,Shlamovoy,2839,30,1,10,11,9.1%,18m
20753,3,NORandom,2839,0,0,1,1,0.0%,17m
20753,3,ExyDos,2839,0,0,1,1,0.0%,17m
20753,3,Venom,2839,0,0,1,1,0.0%,20m
20753,1,HawkeHun,2839,0,0,2,2,0.0%,5m
20753,3,TAPAKAH,2839,0,0,2,2,0.0%,21m
20785,1,Blazar,2838,1613,419,420,839,49.9%,10m
20785,3,[BeerTm]TomatBlack,2838,1471,189,154,343,55.1%,15m
20785,2,Olappe,2838,913,125,117,242,51.7%,8m
20785,2,Schmarlo,2838,1353,97,103,200,48.5%,5m
20785,1,Greylag,2838,1548,83,89,172,48.3%,6m
20785,3,Janke,2838,900,46,45,91,50.5%,21m
20785,3,vorona,2838,621,38,29,67,56.7%,13m
20785,3,rabbagast,2838,664,25,21,46,54.3%,20m
20785,2,Strumpf,2838,489,22,19,41,53.7%,20m
20785,3,Jack,2838,285,19,16,35,54.3%,3m
20785,3,[WTSR]WTSMark,2838,432,18,9,27,66.7%,17m
20785,2,[mfxed]Animator,2838,500,18,19,37,48.6%,20m
20785,3,InFeRnO,2838,261,15,12,27,55.6%,2m
20785,3,Vanilla,2838,328,12,15,27,44.4%,9m
20785,3,[RTEBL]ZigmundFreid,2838,234,9,7,16,56.2%,3m
20785,3,Rafale,2838,219,8,6,14,57.1%,20m
20785,3,DVP,2838,191,7,2,9,77.8%,12m
20785,1,gfrntz,2838,241,7,7,14,50.0%,2m
20785,3,Osterzone,2838,160,6,5,11,54.5%,9m
20785,2,IIIIIIIIIIII,2838,84,5,4,9,55.6%,21m
20785,2,TraHan,2838,0,4,2,6,66.7%,9m
20785,3,KirillVV,2838,60,2,3,5,40.0%,16m
20785,3,[mfixed]Tyro,2838,30,2,3,5,40.0%,18m
20785,2,Perian,2838,118,2,6,8,25.0%,15m
20785,2,CuddleBunny,2838,30,2,9,11,18.2%,20m
20785,3,ASURA,2838,0,1,1,2,50.0%,20m
20785,2,Gorthaur,2838,94,1,2,3,33.3%,1h
20785,3,SixeS,2838,30,1,4,5,20.0%,20m
20785,3,Frosch,2838,0,1,4,5,20.0%,13m
20785,1,Asand,2838,0,0,1,1,0.0%,1h
20785,3,[XwzeX]Xoliper,2838,0,0,1,1,0.0%,20m
20785,3,Nyphang,2838,0,0,3,3,0.0%,21m
20817,3,HugBanelings,2837,1424,140,133,273,51.3%,5m
20817,3,rabbied,2837,636,103,88,191,53.9%,3m
20817,2,TAGDOESNTFIT,2837,1300,59,54,113,52.2%,13m
20817,3,Maximus,2837,1261,57,51,108,52.8%,8m
20817,2,Arnycro,2837,865,51,58,109,46.8%,19m
20817,3,PlayForSalt,2837,574,48,26,74,64.9%,4m
20817,3,yolosix,2837,1022,45,29,74,60.8%,17m
20817,2,SophieDee,2837,1025,38,42,80,47.5%,4m
20817,3,Luplus,2837,890,33,34,67,49.3%,13m
20817,3,Mal,2837,756,32,25,57,56.1%,18m
20817,3,Killlah,2837,542,22,21,43,51.2%,20m
20817,3,СепарДНР,2837,542,20,20,40,50.0%,12m
20817,3,MorganBleak,2837,220,10,10,20,50.0%,19m
20817,1,Boo,2837,245,9,5,14,64.3%,11m
20817,3,Sylvius,2837,252,9,9,18,50.0%,2m
20817,2,NoRro,2837,230,9,13,22,40.9%,22m
20817,2,[ThEleT]Arsenic,2837,128,7,4,11,63.6%,13m
20817,2,Nordland,2837,182,7,18,25,28.0%,11m
20817,3,[Znaesh]TerranUrAss,2837,190,6,6,12,50.0%,2m
20817,2,Chaico,2837,0,3,2,5,60.0%,17m
20817,3,[LagOP]Addy,2837,97,3,8,11,27.3%,21m
20817,3,BoXeR,2837,30,2,1,3,66.7%,7m
20817,3,Nog,2837,30,2,1,3,66.7%,4m
20817,3,Lujien,2837,0,1,0,1,100.0%,2m
20817,2,phantom,2837,0,1,0,1,100.0%,11m
20817,3,fogine,2837,0,1,1,2,50.0%,10m
20817,3,PipJkezOred,2837,0,0,1,1,0.0%,9m
20844,2,Thanos,2836,1558,352,345,697,50.5%,16m
20844,3,[Flaw]Inselaffe,2836,629,111,94,205,54.1%,19m
20844,3,sugardaddy,2836,1640,84,80,164,51.2%,21m
20844,3,player,2836,774,45,12,57,78.9%,3m
20844,3,[BloTi]paulusrules,2836,564,21,16,37,56.8%,18m
20844,3,Lutidza,2836,480,19,13,32,59.4%,11m
20844,1,VICTORscll,2836,322,15,15,30,50.0%,5m
20844,2,MasterMind,2836,383,14,24,38,36.8%,12m
20844,2,NimRoD,2836,274,11,6,17,64.7%,11m
20844,3,Exsorcist,2836,354,11,10,21,52.4%,5m
20844,3,Vinhouchou,2836,200,8,6,14,57.1%,5m
20844,3,[RToTD]Chirk,2836,208,8,10,18,44.4%,20m
20844,3,IIIIIIIIIIII,2836,184,7,3,10,70.0%,14m
20844,1,MateiBossul,2836,48,6,3,9,66.7%,16m
20844,3,[CoSmE]princeludo,2836,168,6,6,12,50.0%,22m
20844,3,[Tits]çasentpasbon,2836,150,6,7,13,46.2%,3m
20844,3,Pepe,2836,112,5,3,8,62.5%,7m
20844,3,[DTEK]Evranus,2836,171,5,8,13,38.5%,11m
20844,3,[THound]CHNO,2836,154,5,9,14,35.7%,9m
20844,3,neon,2836,0,3,2,5,60.0%,19m
20844,2,llllllllllll,2836,0,3,3,6,50.0%,9m
20844,3,[VSC2]TrozoMierdda,2836,30,2,1,3,66.7%,16m
20844,3,ДикаяСосиска,2836,122,2,3,5,40.0%,1h
20844,3,plonti,2836,60,2,7,9,22.2%,17m
20844,3,[888888]НаглыйТос,2836,0,1,0,1,100.0%,16m
20844,2,[Daelam]StArmax,2836,0,1,2,3,33.3%,22m
20844,3,meSSer,2836,38,1,4,5,20.0%,1h
20844,3,KapteeniBoom,2836,0,0,1,1,0.0%,7m
20844,3,TommiStachi,2836,0,0,1,1,0.0%,14m
20844,2,Rastafarai,2836,0,0,1,1,0.0%,24m
20844,3,[ligma]Veder,2836,0,0,1,1,0.0%,7m
20844,3,lille,2836,0,0,1,1,0.0%,17m
20844,3,Ezrael,2836,0,0,2,2,0.0%,6m
20844,3,[Kndoy]Gillan,2836,0,0,3,3,0.0%,19m
20844,3,PulseRB,2836,0,0,3,3,0.0%,22m
20879,3,[DEDAL]Eldacar,2835,1560,302,264,566,53.4%,18m
20879,3,notafish,2835,1572,183,143,326,56.1%,19m
20879,3,patator,2835,1453,128,124,252,50.8%,2m
20879,3,[OMNCOM]KissFire,2835,1052,82,78,160,51.2%,2m
20879,3,WillyWonka,2835,1582,75,62,137,54.7%,2m
20879,1,MiniNinja,2835,1601,74,88,162,45.7%,21m
20879,2,TIP,2835,1377,66,59,125,52.8%,8m
20879,2,[OMNCOM]Sos,2835,588,37,41,78,47.4%,15m
20879,3,[SRTS]schrecken,2835,622,32,24,56,57.1%,11m
20879,2,Dazzled,2835,796,30,38,68,44.1%,8m
20879,3,[ČSSR]Needle,2835,446,17,14,31,54.8%,17m
20879,3,MASSUKKAMURA,2835,348,14,9,23,60.9%,19m
20879,3,Schlupp,2835,333,11,9,20,55.0%,23m
20879,3,[HBGS]Borbet,2835,200,7,9,16,43.8%,21m
20879,3,[Tellus]Fargo,2835,183,6,4,10,60.0%,6m
20879,2,[ŁATWO]Skipper,2835,142,5,9,14,35.7%,14m
20879,3,Agge,2835,146,5,9,14,35.7%,13m
20879,3,snelp,2835,58,4,5,9,44.4%,19m
20879,2,Sebinald,2835,182,4,8,12,33.3%,1h
20879,2,Hapster,2835,94,4,13,17,23.5%,10m
20879,2,sashok,2835,0,3,3,6,50.0%,60m
20879,3,Kimbo,2835,86,3,5,8,37.5%,19m
20879,3,[DTBM]UhrU,2835,58,2,4,6,33.3%,9m
20879,3,Dyia,2835,60,2,5,7,28.6%,20m
20879,3,BanglaDezu,2835,0,1,1,2,50.0%,20m
20879,3,Wildlife,2835,30,1,2,3,33.3%,18m
20879,3,Angel,2835,0,1,2,3,33.3%,19m
20879,2,FrozenSw,2835,42,1,3,4,25.0%,5m
20879,3,[AiRǂ]Samus,2835,30,1,3,4,25.0%,16m
20879,1,YarSav,2835,0,0,1,1,0.0%,1h
20879,3,DumBFounDeaD,2835,0,0,1,1,0.0%,16m
20879,3,xxAdioSxx,2835,0,0,1,1,0.0%,22m
20879,3,Noob,2835,0,0,1,1,0.0%,19m
20879,3,RedTideoDawn,2835,0,0,5,5,0.0%,13m
20913,2,Dethkloker,2834,1535,297,286,583,50.9%,2m
20913,2,otcan,2834,931,82,75,157,52.2%,8m
20913,3,sensii,2834,1318,57,40,97,58.8%,8m
20913,3,fanon,2834,949,38,34,72,52.8%,17m
20913,3,Yoyo,2834,807,37,23,60,61.7%,2m
20913,3,prankroker,2834,748,34,20,54,63.0%,23m
20913,2,Shirogane,2834,676,31,21,52,59.6%,18m
20913,2,[glhf20]COBYRA,2834,589,24,23,47,51.1%,15m
20913,3,[R33]Damnight,2834,132,20,8,28,71.4%,19m
20913,3,MEGAPASH,2834,361,17,8,25,68.0%,13m
20913,3,[Hammer]Madtrax,2834,410,16,15,31,51.6%,23m
20913,3,Digitallogos,2834,253,16,17,33,48.5%,9m
20913,2,Pyszczak,2834,412,15,19,34,44.1%,8m
20913,2,[GBLITZ]GERHOFF,2834,274,12,9,21,57.1%,12m
20913,3,Navampa,2834,249,11,6,17,64.7%,6m
20913,3,Winger,2834,315,11,15,26,42.3%,4m
20913,3,[Tостер]Винипух,2834,258,10,9,19,52.6%,13m
20913,3,leopshef,2834,309,10,10,20,50.0%,19m
20913,3,Hurt,2834,131,8,8,16,50.0%,22m
20913,2,Buggy,2834,210,8,13,21,38.1%,16m
20913,1,TopGun,2834,48,4,4,8,50.0%,3m
20913,3,[НОД17]Overmind,2834,116,4,5,9,44.4%,5m
20913,3,LunaticFool,2834,58,3,1,4,75.0%,16m
20913,3,Derinord,2834,0,3,2,5,60.0%,18m
20913,3,NERFTERRAN,2834,115,3,2,5,60.0%,19m
20913,3,Beefy,2834,0,3,2,5,60.0%,2m
20913,1,ScottSan,2834,169,3,5,8,37.5%,1h
20913,3,[NEETS]maq,2834,90,3,6,9,33.3%,3m
20913,2,Smog,2834,94,2,2,4,50.0%,1h
20913,3,[КПCC]BrutaliskFan,2834,0,1,0,1,100.0%,18m
20913,3,justFun,2834,0,1,1,2,50.0%,15m
20913,2,[DarkEZ]Leprikon,2834,94,1,2,3,33.3%,13m
20913,3,Kira,2834,0,1,4,5,20.0%,17m
20913,3,Salo,2834,0,0,1,1,0.0%,13m
20913,3,Aze,2834,0,0,1,1,0.0%,16m
20913,1,Gourdinus,2834,0,0,1,1,0.0%,1h
20913,2,PistolProtos,2834,0,0,1,1,0.0%,19m
20913,3,[TMDM]Arcuturus,2834,0,0,2,2,0.0%,6m
20913,3,MESSIAH,2834,0,0,3,3,0.0%,15m
20952,3,Tuncay,2833,1412,178,157,335,53.1%,3m
20952,3,[НОД17]Eagle,2833,1398,149,130,279,53.4%,20m
20952,3,Pako,2833,1258,98,86,184,53.3%,8m
20952,2,[IceHus]SCVReady,2833,1379,93,98,191,48.7%,20m
20952,2,gama,2833,1351,52,55,107,48.6%,9m
20952,3,Sebus,2833,1023,44,37,81,54.3%,12m
20952,3,Captain,2833,1138,43,44,87,49.4%,22m
20952,2,Maxipocak,2833,876,36,37,73,49.3%,19m
20952,3,xxithappens,2833,391,24,21,45,53.3%,10m
20952,3,Slavin,2833,446,21,24,45,46.7%,11m
20952,3,Dica,2833,395,18,13,31,58.1%,4m
20952,3,Nezox,2833,436,17,14,31,54.8%,20m
20952,2,Grom,2833,360,14,14,28,50.0%,15m
20952,3,diabetesHERO,2833,219,11,4,15,73.3%,15m
20952,3,aaiun,2833,246,10,7,17,58.8%,16m
20952,3,[Pot]Bucóka,2833,226,9,7,16,56.2%,11m
20952,2,Synapse,2833,250,8,9,17,47.1%,23m
20952,3,Roesty,2833,154,7,5,12,58.3%,2m
20952,3,LeToïToï,2833,176,5,3,8,62.5%,3m
20952,2,Fredrik,2833,30,5,4,9,55.6%,13m
20952,3,Nasai,2833,137,3,2,5,60.0%,11m
20952,3,Faizoff,2833,30,2,1,3,66.7%,19m
20952,3,Don,2833,30,2,4,6,33.3%,22m
20952,3,Habok,2833,0,1,1,2,50.0%,1h
20952,3,Kapitoshka,2833,30,1,5,6,16.7%,3m
20952,1,CXD,2833,30,1,9,10,10.0%,12m
20952,3,Honesty,2833,0,0,1,1,0.0%,8m
20952,3,[ANREN]Libro,2833,0,0,1,1,0.0%,13m
20952,3,rinner,2833,0,0,2,2,0.0%,2m
20981,3,Flocanier,2832,1612,123,117,240,51.2%,9m
20981,3,NeX,2832,904,44,40,84,52.4%,18m
20981,3,[LOGS]Dodo,2832,757,33,24,57,57.9%,12m
20981,3,navy,2832,545,23,20,43,53.5%,21m
20981,3,AzimuthXeno,2832,397,19,18,37,51.4%,2m
20981,3,Dinosaur,2832,369,15,4,19,78.9%,13m
20981,2,aNdYmOngO,2832,265,12,7,19,63.2%,11m
20981,2,[RRRö]Hode,2832,243,9,12,21,42.9%,15m
20981,3,ArabCM,2832,233,8,4,12,66.7%,19m
20981,3,Temafey,2832,228,8,11,19,42.1%,2m
20981,3,EllieFingers,2832,208,7,3,10,70.0%,9m
20981,2,raF,2832,0,3,2,5,60.0%,1h
20981,3,power,2832,90,3,5,8,37.5%,19m
20981,2,dyrek,2832,88,3,5,8,37.5%,17m
20981,2,Kakabol,2832,90,3,10,13,23.1%,12m
20981,3,[WfGe]Montelus,2832,0,1,0,1,100.0%,11m
20981,3,[Sieral]BlackTeraner,2832,0,1,0,1,100.0%,5m
20981,1,[LIQUID]IgorZ,2832,0,1,0,1,100.0%,1h
20981,3,Anarelion,2832,0,1,0,1,100.0%,7m
20981,3,Valent,2832,92,1,1,2,50.0%,20m
20981,3,Mwimwits,2832,0,1,1,2,50.0%,9m
20981,3,KEKC,2832,30,1,2,3,33.3%,2m
20981,3,Richard,2832,30,1,6,7,14.3%,19m
20981,3,kira,2832,30,1,6,7,14.3%,10m
20981,3,OrHeBuK,2832,0,0,1,1,0.0%,20m
20981,3,Varandragon,2832,0,0,1,1,0.0%,16m
20981,3,IIIIIIIIIIII,2832,0,0,1,1,0.0%,18m
20981,3,[FLU5H]ArchonToilet,2832,0,0,1,1,0.0%,15m
20981,3,BastQyxi,2832,0,0,1,1,0.0%,10m
20981,2,LTa,2832,0,0,1,1,0.0%,1h
20981,3,Victor,2832,0,0,1,1,0.0%,18m
20981,3,[КПCC]FireZerg,2832,0,0,2,2,0.0%,14m
20981,1,[WurS]samdaskod,2832,0,0,3,3,0.0%,1h
21014,1,Foxer,2831,1600,261,259,520,50.2%,12m
21014,1,aleatorio,2831,1441,224,226,450,49.8%,4m
21014,2,[UNPC]calahan,2831,1614,198,188,386,51.3%,6m
21014,2,Rapace,2831,1629,171,162,333,51.4%,12m
21014,2,[J4E]IHateBugs,2831,1530,121,120,241,50.2%,8m
21014,2,BamBook,2831,1201,95,91,186,51.1%,9m
21014,3,Dallacost,2831,1566,85,70,155,54.8%,2m
21014,3,MonkeY,2831,1410,74,58,132,56.1%,21m
21014,3,MadMarine,2831,1087,47,37,84,56.0%,18m
21014,3,Pody,2831,1053,44,33,77,57.1%,13m
21014,1,СаняКаратель,2831,688,33,36,69,47.8%,18m
21014,2,[AiRǂ]RicoMacchina,2831,626,30,25,55,54.5%,14m
21014,2,[CUBITA]terrasalazar,2831,765,30,30,60,50.0%,14m
21014,3,InspektorKot,2831,605,26,22,48,54.2%,9m
21014,3,Bonjour,2831,621,26,23,49,53.1%,15m
21014,1,[JebaQ]Mutru,2831,665,26,31,57,45.6%,19m
21014,2,Ratero,2831,326,11,18,29,37.9%,9m
21014,3,LaXul,2831,247,9,5,14,64.3%,10m
21014,3,fooliodoolio,2831,234,9,8,17,52.9%,4m
21014,3,[300IQ]AverDroz,2831,220,8,2,10,80.0%,10m
21014,1,[Psys]PsychoGrof,2831,179,7,5,12,58.3%,1h
21014,3,[CCAV]Enro,2831,170,6,4,10,60.0%,9m
21014,3,[Resy]light,2831,121,5,6,11,45.5%,15m
21014,3,GaryChook,2831,154,5,9,14,35.7%,16m
21014,2,EiruJentZen,2831,154,4,1,5,80.0%,1h
21014,2,NickIvy,2831,0,3,3,6,50.0%,12m
21014,3,[IamCpt]Nemo,2831,94,3,6,9,33.3%,18m
21014,3,funkeymonkey,2831,118,2,2,4,50.0%,21m
21014,2,Vrkolakdlg,2831,0,2,3,5,40.0%,1h
21014,3,[F1N]Barracuda,2831,0,1,0,1,100.0%,19m
21014,3,KnockShot,2831,30,1,2,3,33.3%,16m
21014,2,kapten,2831,0,1,2,3,33.3%,7m
21014,3,[LEOTAL]MrWhitewhite,2831,0,0,1,1,0.0%,20m
21014,2,[NCtk]Bartimaeus,2831,0,0,1,1,0.0%,11m
21014,3,Trinelle,2831,0,0,2,2,0.0%,20m
21049,2,oldmannap,2830,1582,675,671,1346,50.1%,4m
21049,3,[MRRUSH]Dant,2830,1612,182,174,356,51.1%,13m
21049,3,sasha,2830,1412,113,99,212,53.3%,16m
21049,1,IdiSuda,2830,901,107,107,214,50.0%,6m
21049,3,[AqA]HariSeldon,2830,673,96,89,185,51.9%,16m
21049,2,MrZ,2830,1569,82,78,160,51.2%,20m
21049,2,[BYTCA]pit,2830,1538,78,83,161,48.4%,20m
21049,2,Dzigoro,2830,1270,68,67,135,50.4%,16m
21049,3,MarkRuffalo,2830,1350,61,42,103,59.2%,10m
21049,3,BloodMan,2830,1165,60,62,122,49.2%,3m
21049,2,[InitRu]Lambo,2830,452,49,37,86,57.0%,11m
21049,3,NightBaker,2830,676,28,23,51,54.9%,19m
21049,3,ArtDezy,2830,469,19,12,31,61.3%,23m
21049,3,NeferPitou,2830,409,15,19,34,44.1%,15m
21049,2,sanchez,2830,316,12,17,29,41.4%,22m
21049,3,Lipi,2830,210,8,7,15,53.3%,12m
21049,2,Reinhard,2830,254,8,9,17,47.1%,11m
21049,1,obZen,2830,204,7,9,16,43.8%,5m
21049,3,[Apei]Flingyman,2830,155,6,4,10,60.0%,8m
21049,1,[S0Y]MalaNeve,2830,145,6,5,11,54.5%,1h
21049,2,JInzhiyu,2830,195,6,7,13,46.2%,24m
21049,3,Atlas,2830,157,5,0,5,100.0%,3m
21049,1,[СCCР]SHEREPASHKA,2830,188,5,2,7,71.4%,10m
21049,2,Mauno,2830,130,5,8,13,38.5%,15m
21049,2,JustPhenomen,2830,30,4,5,9,44.4%,15m
21049,3,Efreet,2830,0,3,2,5,60.0%,22m
21049,2,saint,2830,0,3,3,6,50.0%,12m
21049,3,[PLwaw]TIGER,2830,30,2,1,3,66.7%,22m
21049,2,SkeleCore,2830,36,2,1,3,66.7%,14m
21049,3,Bit,2830,30,2,1,3,66.7%,2m
21049,3,[klanix]defibrylator,2830,30,2,3,5,40.0%,9m
21049,3,Hufflepuff,2830,30,2,4,6,33.3%,12m
21049,3,[Dytred]BoB,2830,0,1,1,2,50.0%,8m
21049,3,[DelRay]NoiLliM,2830,0,1,1,2,50.0%,16m
21049,3,Schnegge,2830,30,1,2,3,33.3%,17m
21049,3,Hellrider,2830,30,1,3,4,25.0%,20m
21049,3,[SGтv]logmist,2830,30,1,4,5,20.0%,10m
21049,1,Allerseelen,2830,0,1,9,10,10.0%,14m
21049,3,Ulfric,2830,0,0,1,1,0.0%,18m
21049,1,ВЛАСТЕЛИН,2830,0,0,1,1,0.0%,23m
21089,2,[KCTV]KimJongNuke,2829,1533,538,529,1067,50.4%,5m
21089,2,Morgul,2829,1594,233,223,456,51.1%,20m
21089,2,DarthMW,2829,1528,117,100,217,53.9%,20m
21089,3,KACKA,2829,1161,51,35,86,59.3%,16m
21089,3,Goryacho,2829,388,33,19,52,63.5%,9m
21089,3,Tulok,2829,722,32,18,50,64.0%,21m
21089,3,kopatch,2829,473,23,11,34,67.6%,10m
21089,2,[WHBO]Magulon,2829,424,15,19,34,44.1%,5m
21089,2,[GHFZ]KekeN,2829,338,10,32,42,23.8%,3m
21089,3,Paf,2829,224,8,4,12,66.7%,4m
21089,3,[hi5]geiLeN,2829,201,6,5,11,54.5%,23m
21089,1,[БУТЕР1]Ribolov,2829,189,5,2,7,71.4%,1h
21089,3,Akker,2829,0,4,1,5,80.0%,3m
21089,2,Pavel,2829,0,3,3,6,50.0%,12m
21089,3,Hardstem,2829,30,3,4,7,42.9%,20m
21089,3,ultraUMUT,2829,30,2,4,6,33.3%,20m
21089,3,[LTPX]EvilDuck,2829,60,2,8,10,20.0%,7m
21089,2,HEKPOMAHT,2829,0,1,0,1,100.0%,20m
21089,3,[KSN]DyxectoR,2829,0,1,0,1,100.0%,7m
21089,3,[QTcIub]phatvt,2829,0,1,0,1,100.0%,3m
21089,1,Hold,2829,0,1,1,2,50.0%,1h
21089,3,Agarvaen,2829,94,1,5,6,16.7%,19m
21089,3,[SAUI]DroneDaddy,2829,0,0,1,1,0.0%,10m
21089,3,Gramps,2829,0,0,1,1,0.0%,12m
21089,3,[canZeg]oscaridley,2829,0,0,1,1,0.0%,22m
21089,2,[AMIGOO]haster,2829,0,0,1,1,0.0%,19m
21089,3,Northerni,2829,0,0,2,2,0.0%,3m
21116,2,WarcoX,2828,1472,106,110,216,49.1%,8m
21116,3,QbA,2828,1287,72,48,120,60.0%,22m
21116,2,[TAW]Sulkosaurus,2828,1344,69,62,131,52.7%,7m
21116,3,Pyromancer,2828,1416,68,68,136,50.0%,8m
21116,1,[Tостер]Бирсиаль,2828,1083,67,74,141,47.5%,7m
21116,3,ElfeNirokois,2828,830,36,28,64,56.2%,22m
21116,3,Fenders,2828,777,34,27,61,55.7%,20m
21116,1,Rebel,2828,950,31,48,79,39.2%,11m
21116,3,Bazsa,2828,754,29,26,55,52.7%,18m
21116,3,zet,2828,577,28,16,44,63.6%,12m
21116,3,Potui,2828,548,26,12,38,68.4%,14m
21116,3,Grillzy,2828,371,15,11,26,57.7%,6m
21116,3,[PLTEAM]DeMoN,2828,129,9,2,11,81.8%,2m
21116,3,Anubis,2828,215,8,8,16,50.0%,16m
21116,1,DimKa,2828,262,6,4,10,60.0%,1h
21116,2,AsyncAwait,2828,168,4,7,11,36.4%,60m
21116,1,GigiX,2828,97,3,3,6,50.0%,1h
21116,3,[apeiro]Fraukenstein,2828,60,3,6,9,33.3%,9m
21116,3,DannyShow,2828,121,2,4,6,33.3%,1h
21116,3,GoSWBay,2828,0,1,0,1,100.0%,21m
21116,3,Azatoth,2828,0,1,0,1,100.0%,3m
21116,3,Laker,2828,30,1,1,2,50.0%,22m
21116,3,DeathGunPrO,2828,18,1,1,2,50.0%,2m
21116,3,[OBSCFR]Yokorichi,2828,30,1,4,5,20.0%,19m
21116,3,HyperFlex,2828,30,1,5,6,16.7%,14m
21116,3,bronzodia,2828,0,0,1,1,0.0%,23m
21116,2,[dolbo9]GameOver,2828,0,0,1,1,0.0%,1h
21116,3,TRENER,2828,0,0,3,3,0.0%,13m
21116,3,ChukNorris,2828,0,0,5,5,0.0%,7m
21145,2,VirtualState,2827,1566,266,268,534,49.8%,17m
21145,2,[GGLose]Separatists,2827,987,91,90,181,50.3%,20m
21145,3,drajz,2827,759,65,60,125,52.0%,16m
21145,2,TeckLord,2827,1284,63,66,129,48.8%,11m
21145,3,DummerSandro,2827,1125,58,25,83,69.9%,17m
21145,2,[EXPANT]Bratta,2827,985,41,41,82,50.0%,15m
21145,3,CoCos,2827,256,14,5,19,73.7%,5m
21145,3,[Cannоn]Lukas,2827,344,14,6,20,70.0%,18m
21145,3,[200P]Mike,2827,320,13,11,24,54.2%,7m
21145,3,ElectroMat,2827,292,11,5,16,68.8%,11m
21145,3,Zibbang,2827,251,10,5,15,66.7%,18m
21145,2,[NooK]Joniii,2827,304,10,13,23,43.5%,11m
21145,2,[brzzer]Alvaro,2827,300,9,12,21,42.9%,9m
21145,3,proDeWalT,2827,145,8,4,12,66.7%,2m
21145,3,[UAŦeam]SMILE,2827,235,8,6,14,57.1%,7m
21145,1,[Eiwit]Veekie,2827,245,8,8,16,50.0%,1h
21145,3,satisfaction,2827,174,6,6,12,50.0%,20m
21145,3,Podocarpo,2827,181,5,3,8,62.5%,17m
21145,3,Maly,2827,185,5,3,8,62.5%,5m
21145,1,Timme,2827,94,5,5,10,50.0%,23m
21145,3,DDDemon,2827,116,4,7,11,36.4%,23m
21145,3,Helunix,2827,144,3,2,5,60.0%,16m
21145,3,DiMiD,2827,58,3,2,5,60.0%,4m
21145,3,Rhyspect,2827,90,3,3,6,50.0%,5m
21145,3,[сSсǃ]PrinzOnFire,2827,60,3,3,6,50.0%,3m
21145,3,Jasper,2827,60,3,4,7,42.9%,20m
21145,2,Marafettiq,2827,58,3,5,8,37.5%,20m
21145,2,Poual,2827,30,3,7,10,30.0%,14m
21145,1,IlIlIlIlIlIl,2827,0,1,1,2,50.0%,22m
21145,2,Azazal,2827,0,1,1,2,50.0%,5m
21145,1,xubsbeat,2827,0,1,1,2,50.0%,1h
21145,3,DarkAdino,2827,30,1,4,5,20.0%,5m
21145,3,[UATeam]Yamaga,2827,0,0,1,1,0.0%,18m
21145,3,[Nudist]Golgotai,2827,0,0,1,1,0.0%,11m
21145,3,Cheesecake,2827,0,0,1,1,0.0%,7m
21180,2,LECOQ,2826,1518,263,250,513,51.3%,10m
21180,3,Sufferu,2826,1061,50,38,88,56.8%,21m
21180,3,James,2826,1043,46,31,77,59.7%,20m
21180,3,SpYcY,2826,1051,44,27,71,62.0%,19m
21180,2,Mezi,2826,592,32,40,72,44.4%,6m
21180,3,hyyy,2826,806,29,31,60,48.3%,3m
21180,3,ЯМашина,2826,630,28,14,42,66.7%,16m
21180,1,[HLFLMN]balka,2826,753,28,32,60,46.7%,12m
21180,3,SpaceSam,2826,511,22,16,38,57.9%,18m
21180,3,ThatGuy,2826,242,17,10,27,63.0%,20m
21180,1,Roshka,2826,361,14,11,25,56.0%,56m
21180,2,tehpwnrer,2826,333,13,17,30,43.3%,16m
21180,2,NFprobe,2826,298,11,15,26,42.3%,11m
21180,3,[ioStuN]Chronicles,2826,250,9,10,19,47.4%,4m
21180,3,prod,2826,254,8,7,15,53.3%,14m
21180,3,LionHeart,2826,141,7,4,11,63.6%,5m
21180,3,Aeon,2826,167,7,6,13,53.8%,22m
21180,2,[RekTzW]Wojtaszy,2826,144,6,6,12,50.0%,52m
21180,2,[C02133]noylander,2826,48,4,4,8,50.0%,2m
21180,3,Anx,2826,114,4,8,12,33.3%,21m
21180,3,Winner,2826,125,3,0,3,100.0%,3m
21180,3,Graphic,2826,60,3,1,4,75.0%,16m
21180,1,Diray,2826,121,2,2,4,50.0%,1h
21180,3,Metalhead,2826,58,2,3,5,40.0%,17m
21180,3,ULTRAKILL,2826,0,1,0,1,100.0%,23m
21180,3,Solbrain,2826,0,0,1,1,0.0%,7m
21180,3,[Bri]Phillipht,2826,0,0,3,3,0.0%,16m
21207,3,CDRvsr,2825,1597,210,198,408,51.5%,4m
21207,2,chemistree,2825,1427,127,113,240,52.9%,5m
21207,3,gigo,2825,793,73,68,141,51.8%,3m
21207,2,KION,2825,1238,68,51,119,57.1%,12m
21207,2,Sophia,2825,1280,62,71,133,46.6%,4m
21207,3,vahan,2825,972,60,55,115,52.2%,2m
21207,3,Jimmy,2825,1385,56,56,112,50.0%,13m
21207,3,[Zoub]pred,2825,954,55,49,104,52.9%,6m
21207,2,SickTrstanic,2825,628,52,54,106,49.1%,11m
21207,3,Buzz,2825,763,45,39,84,53.6%,22m
21207,1,[Lumen]Vipsern,2825,1122,41,52,93,44.1%,17m
21207,2,[HDTV]Cyfrost,2825,566,33,25,58,56.9%,5m
21207,2,Opponent,2825,245,27,26,53,50.9%,15m
21207,3,[Viva]HappyCrab,2825,445,20,19,39,51.3%,6m
21207,3,BlackJack,2825,574,20,22,42,47.6%,9m
21207,3,Biohazard,2825,501,18,15,33,54.5%,5m
21207,1,AltairEtoile,2825,375,13,19,32,40.6%,15m
21207,2,Dominator,2825,284,12,14,26,46.2%,12m
21207,3,cartman,2825,326,11,9,20,55.0%,6m
21207,1,harriboclonk,2825,144,7,3,10,70.0%,1h
21207,1,FauconNoir,2825,169,7,4,11,63.6%,1h
21207,2,Kieran,2825,141,6,2,8,75.0%,50m
21207,1,Goat,2825,171,6,7,13,46.2%,11m
21207,3,Zak,2825,130,5,4,9,55.6%,16m
21207,1,[EmŦ]Monta,2825,121,3,1,4,75.0%,1h
21207,2,FrozenFenix,2825,95,3,3,6,50.0%,1h
21207,3,Senn,2825,0,2,3,5,40.0%,23m
21207,1,[DRGN]QCFlamexzz,2825,118,2,7,9,22.2%,50m
21207,3,llllllllllll,2825,0,1,0,1,100.0%,9m
21207,3,Lyan,2825,0,1,0,1,100.0%,13m
21207,3,[EAU]SkrollkPfF,2825,0,1,4,5,20.0%,22m
21207,3,SizZLAR,2825,0,1,4,5,20.0%,12m
21207,3,[Qi]Quafel,2825,0,0,3,3,0.0%,13m
21207,3,DrDeath,2825,0,0,3,3,0.0%,17m
21241,2,manu,2824,1552,203,188,391,51.9%,20m
21241,2,skylord,2824,779,106,94,200,53.0%,14m
21241,3,Vasyl,2824,295,103,104,207,49.8%,9m
21241,1,Tobiatron,2824,1570,71,79,150,47.3%,9m
21241,2,Dolmen,2824,1257,71,82,153,46.4%,8m
21241,3,LAMAO,2824,1486,62,64,126,49.2%,11m
21241,3,[FDA]Mist,2824,434,17,16,33,51.5%,18m
21241,2,Vasiliauskas,2824,546,17,22,39,43.6%,9m
21241,1,SimpleLuke,2824,529,17,26,43,39.5%,15m
21241,2,Ivalice,2824,395,16,16,32,50.0%,21m
21241,3,hiroes,2824,149,14,14,28,50.0%,20m
21241,3,[MAV7]frostmure,2824,235,11,1,12,91.7%,3m
21241,3,Hugo,2824,211,9,9,18,50.0%,17m
21241,1,[BOOBS]talionL,2824,213,6,6,12,50.0%,1h
21241,1,NazgulF,2824,145,5,5,10,50.0%,1h
21241,3,Talbotstraat,2824,92,4,8,12,33.3%,14m
21241,2,[ßRUH]Tingwe,2824,95,3,3,6,50.0%,1h
21241,2,Seth,2824,46,3,4,7,42.9%,1h
21241,3,Osburn,2824,30,2,2,4,50.0%,15m
21241,3,Giannino,2824,122,2,4,6,33.3%,9m
21241,3,raskolnikov,2824,30,2,5,7,28.6%,21m
21241,3,Bean,2824,0,1,0,1,100.0%,15m
21241,3,konrad,2824,30,1,3,4,25.0%,19m
21241,2,RedBrick,2824,30,1,8,9,11.1%,9m
21241,2,[GerAM]Brdlmpft,2824,0,0,1,1,0.0%,5m
21241,3,Fadasds,2824,0,0,1,1,0.0%,4m
21241,3,Bizon,2824,0,0,1,1,0.0%,56m
21241,3,allucard,2824,0,0,2,2,0.0%,21m
21269,2,pingback,2823,1589,271,266,537,50.5%,11m
21269,2,DarKFaNToM,2823,871,187,175,362,51.7%,20m
21269,3,Roman,2823,1403,158,143,301,52.5%,16m
21269,2,jITO,2823,785,137,127,264,51.9%,11m
21269,2,hriuchzr,2823,858,137,136,273,50.2%,15m
21269,3,sHustriy,2823,1579,114,101,215,53.0%,19m
21269,2,Greed,2823,277,48,40,88,54.5%,5m
21269,3,RedRosa,2823,431,29,20,49,59.2%,20m
21269,2,Bryzheyka,2823,528,24,23,47,51.1%,20m
21269,3,Piotr,2823,504,21,22,43,48.8%,9m
21269,3,Kaofael,2823,387,18,13,31,58.1%,4m
21269,3,phantomas,2823,349,15,13,28,53.6%,5m
21269,2,BornToLose,2823,440,14,23,37,37.8%,20m
21269,3,Widowmaker,2823,316,12,11,23,52.2%,9m
21269,3,noncheeseacc,2823,264,11,3,14,78.6%,3m
21269,3,Jaffro,2823,285,10,6,16,62.5%,9m
21269,2,[M4nAAA]aNaRChiSt,2823,294,10,14,24,41.7%,2m
21269,3,BottleOfRum,2823,176,7,7,14,50.0%,22m
21269,2,mks,2823,167,7,7,14,50.0%,9m
21269,3,[Egreš]Glordi,2823,122,5,5,10,50.0%,12m
21269,3,DonPampa,2823,146,5,6,11,45.5%,9m
21269,3,jacki,2823,122,4,4,8,50.0%,22m
21269,3,[TheD]Ancorage,2823,88,4,5,9,44.4%,9m
21269,1,[Tg3]Hulli,2823,123,4,5,9,44.4%,10m
21269,3,nboypiatka,2823,86,4,6,10,40.0%,11m
21269,1,tass,2823,144,3,6,9,33.3%,1h
21269,2,Dorn,2823,92,3,15,18,16.7%,12m
21269,2,Slash,2823,0,2,6,8,25.0%,5m
21269,3,ArHangel,2823,0,1,0,1,100.0%,2m
21269,1,RandomDude,2823,0,1,0,1,100.0%,2m
21269,3,valenok,2823,0,1,0,1,100.0%,10m
21269,3,Stromcrow,2823,0,1,0,1,100.0%,3m
21269,3,Unzor,2823,0,1,1,2,50.0%,57m
21269,2,Striker,2823,30,1,8,9,11.1%,15m
21269,3,bbop,2823,0,0,1,1,0.0%,16m
21269,3,Auri,2823,0,0,4,4,0.0%,4m
21269,3,BarackBanana,2823,0,0,5,5,0.0%,9m
21306,3,[SPAINs]Pain,2822,1614,136,128,264,51.5%,22m
21306,2,Mentat,2822,1021,105,94,199,52.8%,15m
21306,3,Alex,2822,1578,69,61,130,53.1%,8m
21306,2,Sardukar,2822,865,53,63,116,45.7%,7m
21306,3,FLiegerFLY,2822,1052,46,37,83,55.4%,20m
21306,3,nofast,2822,683,29,33,62,46.8%,12m
21306,3,Stepbystep,2822,228,23,12,35,65.7%,3m
21306,2,[ErR]StroKe,2822,592,22,27,49,44.9%,22m
21306,3,Albertik,2822,428,19,18,37,51.4%,10m
21306,3,[n3wb13]SpookyFoxPL,2822,464,18,11,29,62.1%,6m
21306,3,Immortal,2822,404,16,12,28,57.1%,8m
21306,2,MisterFizzle,2822,275,11,11,22,50.0%,1h
21306,3,Szabee,2822,328,11,13,24,45.8%,19m
21306,3,Rhodium,2822,241,8,6,14,57.1%,13m
21306,3,Olex,2822,165,5,2,7,71.4%,20m
21306,3,[SJHD]KAMACI,2822,168,5,3,8,62.5%,20m
21306,2,[TOUCAN]FunkyDrood,2822,120,5,12,17,29.4%,1h
21306,3,QIMNairat,2822,113,4,2,6,66.7%,22m
21306,3,Frijs,2822,158,4,8,12,33.3%,23m
21306,3,Mde,2822,86,3,6,9,33.3%,22m
21306,3,[BBr0s]Spings,2822,30,2,5,7,28.6%,3m
21306,3,KraSkoS,2822,0,1,2,3,33.3%,4m
21306,3,Kucheryaxa,2822,30,1,4,5,20.0%,15m
21306,3,cobra,2822,0,0,1,1,0.0%,15m
21306,3,Rafix,2822,0,0,2,2,0.0%,9m
21331,2,[XxIIxX]SnAiL,2821,1502,116,117,233,49.8%,12m
21331,3,echO,2821,1493,80,79,159,50.3%,16m
21331,3,OXOTNIK,2821,828,60,36,96,62.5%,19m
21331,2,Amadeus,2821,856,60,36,96,62.5%,12m
21331,3,hawkk,2821,712,53,28,81,65.4%,19m
21331,3,WearyHeels,2821,815,51,48,99,51.5%,20m
21331,3,Flimflamfox,2821,395,49,25,74,66.2%,21m
21331,3,MaRa,2821,770,39,29,68,57.4%,5m
21331,3,Ragazzo,2821,392,15,13,28,53.6%,19m
21331,3,Creedy,2821,244,14,12,26,53.8%,5m
21331,3,blank,2821,205,6,4,10,60.0%,20m
21331,3,DimoNBro,2821,91,5,1,6,83.3%,23m
21331,3,MonkeyDDrago,2821,148,5,3,8,62.5%,20m
21331,3,flipke,2821,86,4,5,9,44.4%,17m
21331,2,salivan,2821,123,3,1,4,75.0%,6m
21331,3,notbnk,2821,0,3,2,5,60.0%,19m
21331,3,Zhalo,2821,0,3,2,5,60.0%,20m
21331,2,KSC,2821,141,3,4,7,42.9%,21m
21331,3,[IYOLOI]Cythraul,2821,92,3,9,12,25.0%,10m
21331,3,[4CB]GAMERSTAR,2821,94,2,0,2,100.0%,17m
21331,2,QRDEGRABARZ,2821,95,2,4,6,33.3%,1h
21331,3,CandyThief,2821,0,1,2,3,33.3%,17m
21331,3,[yN]Folco,2821,30,1,5,6,16.7%,16m
21331,3,DustALL,2821,0,0,1,1,0.0%,16m
21331,3,Vorex,2821,0,0,1,1,0.0%,5m
21331,3,[KORI]Haruka,2821,0,0,1,1,0.0%,11m
21331,3,[UGHAGH]Ugh,2821,0,0,1,1,0.0%,19m
21331,2,Goblin,2821,0,0,1,1,0.0%,1h
21331,3,Rise,2821,0,0,1,1,0.0%,1h
21331,1,Gektor,2821,0,0,2,2,0.0%,1h
21331,2,[lWHl]KlausPeter,2821,0,0,9,9,0.0%,15m
21362,3,YooSK,2820,1315,152,142,294,51.7%,21m
21362,3,[BCNE]Bendikov,2820,1337,141,123,264,53.4%,5m
21362,3,FluffyKitty,2820,1626,134,129,263,51.0%,17m
21362,3,DrDlPSHlT,2820,1366,83,53,136,61.0%,11m
21362,2,Leotard,2820,1162,78,78,156,50.0%,12m
21362,2,VLM,2820,1227,62,58,120,51.7%,15m
21362,3,Proxy,2820,1132,52,34,86,60.5%,20m
21362,3,Klitzipetel,2820,1303,52,50,102,51.0%,8m
21362,2,Satanas,2820,318,11,11,22,50.0%,1h
21362,3,Nico,2820,246,8,12,20,40.0%,19m
21362,2,Ludofico,2820,212,8,13,21,38.1%,7m
21362,3,anthoyoyofrr,2820,91,4,2,6,66.7%,3m
21362,3,Rhapsody,2820,109,4,3,7,57.1%,5m
21362,2,VeeONeGee,2820,90,4,13,17,23.5%,5m
21362,3,Theoden,2820,0,3,2,5,60.0%,18m
21362,2,[MRC]Robinet,2820,0,3,3,6,50.0%,2m
21362,3,[G3lb]Noah,2820,0,3,3,6,50.0%,19m
21362,2,zandR,2820,0,3,3,6,50.0%,14m
21362,1,Nash,2820,122,3,3,6,50.0%,58m
21362,3,[RBlood]ARTHUZ,2820,94,2,0,2,100.0%,12m
21362,3,Dwayne,2820,92,2,3,5,40.0%,6m
21362,2,Azerty,2820,119,2,5,7,28.6%,7m
21362,3,IAMKOREAN,2820,0,1,0,1,100.0%,12m
21362,3,[Yame]Ellik,2820,94,1,1,2,50.0%,5m
21362,3,Darkside,2820,30,1,3,4,25.0%,9m
21362,3,zZyZzZz,2820,30,1,4,5,20.0%,9m
21362,3,MarineMonroe,2820,30,1,7,8,12.5%,8m
21362,2,Dow,2820,0,0,1,1,0.0%,56m
21362,3,TraYan,2820,0,0,1,1,0.0%,19m
21391,2,Samplicio,2819,1546,117,96,213,54.9%,2m
21391,3,SerDalar,2819,1370,111,93,204,54.4%,17m
21391,3,RustR,2819,1238,90,86,176,51.1%,3m
21391,2,Nemo,2819,1446,85,82,167,50.9%,5m
21391,3,Ulverion,2819,221,45,34,79,57.0%,3m
21391,3,[eFikSZ]kszk,2819,439,44,24,68,64.7%,19m
21391,2,VVVVV,2819,461,32,38,70,45.7%,17m
21391,3,RONIN,2819,381,16,13,29,55.2%,19m
21391,1,llllllllllll,2819,362,13,12,25,52.0%,1h
21391,3,GeorgeAlex,2819,322,12,12,24,50.0%,19m
21391,2,Treparatone,2819,166,5,8,13,38.5%,4m
21391,3,[Batzn]Urubanczuk,2819,139,4,2,6,66.7%,22m
21391,3,[EgT]Mezzer,2819,90,4,5,9,44.4%,6m
21391,1,Phosa,2819,120,3,2,5,60.0%,20m
21391,3,Hiro,2819,30,3,4,7,42.9%,5m
21391,3,Tysd,2819,30,3,5,8,37.5%,8m
21391,3,[Alpha0]Merlin,2819,30,2,2,4,50.0%,14m
21391,3,Freekl,2819,0,1,0,1,100.0%,9m
21391,3,[ZIN]Chrysippe,2819,0,1,1,2,50.0%,12m
21391,3,AVetals,2819,0,1,1,2,50.0%,23m
21391,3,Liza,2819,0,1,4,5,20.0%,20m
21391,3,Danil,2819,30,1,4,5,20.0%,3m
21391,3,LLluqieboy,2819,0,0,1,1,0.0%,18m
21391,2,SchallvRauch,2819,0,0,1,1,0.0%,1h
21391,3,[530]APLOV,2819,0,0,1,1,0.0%,20m
21391,3,Koolk,2819,0,0,2,2,0.0%,16m
21391,3,gansgunshe,2819,0,0,3,3,0.0%,21m
21418,3,Yebak,2818,1543,460,430,890,51.7%,18m
21418,3,BlackEdition,2818,1003,64,60,124,51.6%,8m
21418,3,MisteR,2818,1265,57,43,100,57.0%,9m
21418,3,Sarmkadan,2818,444,50,32,82,61.0%,18m
21418,2,truetobetrue,2818,124,22,20,42,52.4%,9m
21418,2,[DIIF]Dillimaster,2818,452,21,26,47,44.7%,20m
21418,3,Yoghurt,2818,377,19,12,31,61.3%,16m
21418,3,Rokatansky,2818,526,19,22,41,46.3%,19m
21418,2,NDB,2818,440,17,17,34,50.0%,2m
21418,2,DiuDiuOR,2818,395,16,15,31,51.6%,12m
21418,2,[UWDIE]Khimi,2818,420,15,18,33,45.5%,7m
21418,1,tomatococo,2818,308,11,15,26,42.3%,17m
21418,2,Xenuxus,2818,176,10,18,28,35.7%,22m
21418,3,Sescenarius,2818,218,9,7,16,56.2%,13m
21418,3,[eseeHC]Royalwinner,2818,295,9,12,21,42.9%,14m
21418,3,Lama,2818,207,8,9,17,47.1%,23m
21418,3,Stefanitoss,2818,165,7,5,12,58.3%,24m
21418,3,[OSgZ]EatMyShorts,2818,155,4,3,7,57.1%,20m
21418,3,FHC,2818,0,3,2,5,60.0%,20m
21418,3,[havfun]noobkiller,2818,0,3,2,5,60.0%,20m
21418,3,miraal,2818,0,3,2,5,60.0%,14m
21418,3,noodlez,2818,0,3,3,6,50.0%,17m
21418,2,johndeere,2818,60,3,4,7,42.9%,9m
21418,3,RicharParker,2818,58,3,5,8,37.5%,4m
21418,3,BooM,2818,30,2,2,4,50.0%,9m
21418,3,[PAFn]Pougli,2818,0,1,0,1,100.0%,11m
21418,3,Marqudeur,2818,0,1,0,1,100.0%,18m
21418,3,Oshikuru,2818,30,1,2,3,33.3%,14m
21418,3,Lem,2818,0,0,1,1,0.0%,17m
21418,3,Hopihe,2818,0,0,1,1,0.0%,3m
21448,3,Belyy,2817,1576,124,109,233,53.2%,6m
21448,3,grangroll,2817,1163,121,114,235,51.5%,12m
21448,1,Rastuzio,2817,1548,79,78,157,50.3%,23m
21448,3,[DТ]gidroom,2817,1384,61,51,112,54.5%,3m
21448,3,kid,2817,1155,59,48,107,55.1%,8m
21448,2,[DscG]Milekki,2817,1196,58,45,103,56.3%,18m
21448,3,Evgen,2817,953,46,38,84,54.8%,14m
21448,2,[SoySoy]Lindberg,2817,905,42,32,74,56.8%,7m
21448,3,Immortan,2817,777,38,34,72,52.8%,21m
21448,2,RobinR,2817,760,28,34,62,45.2%,9m
21448,2,student,2817,479,20,18,38,52.6%,7m
21448,3,SsKiev,2817,490,17,15,32,53.1%,16m
21448,3,sergmax,2817,279,12,10,22,54.5%,5m
21448,3,Teg,2817,312,12,11,23,52.2%,16m
21448,3,Buba,2817,244,9,3,12,75.0%,16m
21448,2,PsYcO,2817,193,9,7,16,56.2%,7m
21448,2,[Кра6]Мастер,2817,223,8,8,16,50.0%,17m
21448,3,AKhmad,2817,110,4,3,7,57.1%,22m
21448,2,[AirS]RTool,2817,46,4,4,8,50.0%,21m
21448,3,PoliteElk,2817,0,3,3,6,50.0%,12m
21448,3,paraguayman,2817,92,2,1,3,66.7%,11m
21448,3,[BRock]EmpireZ,2817,0,1,2,3,33.3%,13m
21448,3,[STZK]Snack,2817,30,1,3,4,25.0%,4m
21448,2,DrunkMeister,2817,0,1,3,4,25.0%,1h
21448,3,TheSUN,2817,30,1,3,4,25.0%,13m
21448,3,[LCF1]Caesar,2817,0,0,1,1,0.0%,6m
21448,3,GeneralDuke,2817,0,0,1,1,0.0%,17m
21448,3,LeX,2817,0,0,5,5,0.0%,16m
21476,1,llllllllllll,2816,1578,490,491,981,49.9%,15m
21476,3,Briarey,2816,1567,129,103,232,55.6%,18m
21476,2,ultrastan,2816,942,101,94,195,51.8%,12m
21476,3,Rumus,2816,1550,76,52,128,59.4%,9m
21476,2,Drabadon,2816,983,54,51,105,51.4%,5m
21476,3,Dicey,2816,222,45,67,112,40.2%,6m
21476,3,[ЗИБиАГ]Talat,2816,810,33,29,62,53.2%,20m
21476,1,przemek,2816,665,22,31,53,41.5%,8m
21476,3,feistus,2816,598,21,26,47,44.7%,3m
21476,3,Parklife,2816,398,14,16,30,46.7%,12m
21476,3,StefTheGreat,2816,303,13,12,25,52.0%,7m
21476,3,[OLACH]Michajel,2816,271,11,3,14,78.6%,22m
21476,3,HawkyHawk,2816,304,11,12,23,47.8%,16m
21476,3,[PCDLux]твоймрак,2816,204,10,5,15,66.7%,22m
21476,3,[HelloD]SadKitty,2816,229,9,7,16,56.2%,19m
21476,3,ЛжеДмитрий,2816,153,5,2,7,71.4%,3m
21476,1,[IQ27]LtPrime,2816,97,5,3,8,62.5%,10m
21476,1,[F117]Nos,2816,173,5,5,10,50.0%,1h
21476,2,MrHurricane,2816,48,4,2,6,66.7%,19m
21476,1,[DOKA2]Enturill,2816,0,4,3,7,57.1%,1h
21476,2,Tarrasque,2816,183,4,7,11,36.4%,1h
21476,3,Fesch,2816,88,4,8,12,33.3%,9m
21476,2,NEXT,2816,46,3,3,6,50.0%,1h
21476,3,DeadLove,2816,146,3,3,6,50.0%,20m
21476,2,PSI,2816,0,3,3,6,50.0%,24m
21476,3,SparroW,2816,0,3,3,6,50.0%,2m
21476,3,Zinar,2816,114,2,2,4,50.0%,21m
21476,3,MagicDiamond,2816,0,2,3,5,40.0%,16m
21476,3,KaShvtaal,2816,0,1,0,1,100.0%,21m
21476,2,Chameleon,2816,0,0,1,1,0.0%,21m
21476,3,FoX,2816,0,0,6,6,0.0%,23m
21507,2,[RQ]EDUHEL,2815,1535,209,215,424,49.3%,8m
21507,2,[NxS]ptitpendit,2815,1519,206,192,398,51.8%,12m
21507,2,IIIIIIIIIIII,2815,1550,159,149,308,51.6%,14m
21507,2,Pepperoni,2815,1564,122,107,229,53.3%,13m
21507,3,MasterCatII,2815,1204,105,90,195,53.8%,17m
21507,2,Jester,2815,1111,81,77,158,51.3%,13m
21507,3,Melonmurder,2815,802,49,34,83,59.0%,17m
21507,2,[Orval]OrangeBudd,2815,1009,49,53,102,48.0%,20m
21507,3,FumSDM,2815,268,34,29,63,54.0%,21m
21507,2,MathhtaM,2815,712,33,36,69,47.8%,9m
21507,3,Zealot,2815,633,25,20,45,55.6%,3m
21507,3,[ESErl]Pyteax,2815,504,22,16,38,57.9%,15m
21507,3,Artem,2815,480,18,15,33,54.5%,19m
21507,3,Pakowa,2815,373,16,11,27,59.3%,17m
21507,3,Lumpii,2815,367,16,13,29,55.2%,9m
21507,1,lengyue,2815,454,15,29,44,34.1%,23m
21507,3,Czapa,2815,361,13,10,23,56.5%,21m
21507,3,Harrison,2815,330,12,8,20,60.0%,15m
21507,3,BengaminVDV,2815,310,12,13,25,48.0%,16m
21507,3,[WАSD]Gluck,2815,255,8,7,15,53.3%,3m
21507,3,Gabilin,2815,140,5,0,5,100.0%,11m
21507,2,[VFN]JLAMAR,2815,177,5,16,21,23.8%,2m
21507,3,[ProRax]WhiteGhost,2815,140,4,1,5,80.0%,5m
21507,2,Maverik,2815,88,4,4,8,50.0%,17m
21507,3,Amun,2815,93,4,6,10,40.0%,19m
21507,2,[ReproT]TheUnknown,2815,0,3,3,6,50.0%,20m
21507,3,Quentin,2815,30,2,2,4,50.0%,20m
21507,3,TheMarauder,2815,30,2,2,4,50.0%,2m
21507,2,htissiez,2815,0,2,3,5,40.0%,23m
21507,2,MMRtaxman,2815,0,2,3,5,40.0%,1h
21507,3,Clancedog,2815,0,1,0,1,100.0%,3m
21507,3,[WL706]WOLF,2815,0,1,1,2,50.0%,6m
21507,1,othroth,2815,48,1,3,4,25.0%,1h
21507,2,Chingizhan,2815,0,0,1,1,0.0%,9m
21507,2,Khazash,2815,0,0,1,1,0.0%,1h
21507,3,[INAE]Thunderblood,2815,0,0,1,1,0.0%,17m
21507,3,Hichhok,2815,0,0,2,2,0.0%,4m
21507,3,[JD38]Infernox,2815,0,0,4,4,0.0%,23m
21545,3,ANKSTREM,2814,1484,319,329,648,49.2%,6m
21545,2,redyarilo,2814,1602,231,238,469,49.3%,6m
21545,2,demiro,2814,1517,159,157,316,50.3%,21m
21545,3,DorianGray,2814,1449,110,99,209,52.6%,19m
21545,3,TASHKILL,2814,1576,99,86,185,53.5%,18m
21545,2,Jokvin,2814,1377,95,95,190,50.0%,23m
21545,3,GLHaveRun,2814,1258,79,71,150,52.7%,18m
21545,2,TomaszH,2814,1405,76,78,154,49.4%,15m
21545,2,STALKER,2814,1370,64,58,122,52.5%,5m
21545,3,Лирой,2814,1192,58,30,88,65.9%,4m
21545,3,Gylisan,2814,958,44,27,71,62.0%,16m
21545,3,[Tatava]Seleron,2814,653,30,24,54,55.6%,15m
21545,3,[DILIT]GHoST,2814,616,29,17,46,63.0%,5m
21545,2,mkrd,2814,584,24,24,48,50.0%,12m
21545,3,Bro,2814,460,23,7,30,76.7%,19m
21545,3,Laure,2814,108,11,12,23,47.8%,3m
21545,3,[BLOOD7]Wingwave,2814,236,9,3,12,75.0%,23m
21545,3,[MioInc]MioDrank,2814,222,9,6,15,60.0%,21m
21545,3,[PÂRłAH]DARK,2814,212,7,7,14,50.0%,9m
21545,3,Amazonxpress,2814,198,7,11,18,38.9%,23m
21545,3,IIIIIIIIIII,2814,146,6,8,14,42.9%,20m
21545,3,[SOGI]Emers,2814,148,6,9,15,40.0%,17m
21545,3,Tykxo,2814,136,5,2,7,71.4%,6m
21545,1,[MIELUL]Steff,2814,140,5,4,9,55.6%,24m
21545,3,Ратимир,2814,60,5,5,10,50.0%,2m
21545,3,Cichy,2814,137,4,1,5,80.0%,19m
21545,3,mrpena,2814,30,4,4,8,50.0%,7m
21545,3,Nerdking,2814,146,4,6,10,40.0%,18m
21545,3,Flamby,2814,109,3,0,3,100.0%,12m
21545,3,[HdO]CmdrT,2814,60,3,4,7,42.9%,20m
21545,2,[FST]Tecnoir,2814,94,2,0,2,100.0%,1h
21545,3,Jedi,2814,62,2,7,9,22.2%,4m
21545,1,valentynroot,2814,0,1,0,1,100.0%,1h
21545,3,[59APM]CaptFly,2814,30,1,2,3,33.3%,11m
21545,3,MrCrazy,2814,30,1,3,4,25.0%,22m
21545,3,OstrichO,2814,0,0,1,1,0.0%,6m
21545,2,Flip,2814,0,0,5,5,0.0%,1h
21582,3,SoWick,2813,1645,274,267,541,50.6%,22m
21582,2,Ростислав,2813,1408,141,138,279,50.5%,2m
21582,3,Barsfoxteam,2813,622,98,74,172,57.0%,18m
21582,2,HarryGelb,2813,528,91,83,174,52.3%,8m
21582,3,Spartacus,2813,935,88,78,166,53.0%,12m
21582,3,chkRrrRrRrrr,2813,827,72,59,131,55.0%,11m
21582,3,Amvrosy,2813,325,61,48,109,56.0%,14m
21582,3,[PowOw]SABCJayme,2813,903,51,32,83,61.4%,5m
21582,2,[Sinful]Toxicator,2813,1388,51,61,112,45.5%,7m
21582,3,[DrMa]Knuthansen,2813,820,47,40,87,54.0%,16m
21582,3,Rafoboy,2813,1221,47,42,89,52.8%,6m
21582,3,[VLAD25]ЛордВлад,2813,751,33,21,54,61.1%,23m
21582,3,Yakut,2813,255,25,9,34,73.5%,9m
21582,3,Miro,2813,462,21,10,31,67.7%,19m
21582,1,amnio,2813,350,11,15,26,42.3%,19m
21582,3,QuBuS,2813,236,10,6,16,62.5%,5m
21582,3,ForZion,2813,181,9,9,18,50.0%,1h
21582,3,Chronos,2813,236,7,8,15,46.7%,19m
21582,2,Alibande,2813,187,6,5,11,54.5%,1h
21582,3,[SyLöMu]BirkTheBrave,2813,174,6,7,13,46.2%,2m
21582,3,[dzv3rg]Ifak,2813,185,5,3,8,62.5%,11m
21582,1,Plumblum,2813,118,5,4,9,55.6%,11m
21582,2,Popper,2813,176,5,9,14,35.7%,11m
21582,3,Mahai,2813,154,4,2,6,66.7%,3m
21582,3,IronTrooper,2813,62,3,4,7,42.9%,21m
21582,3,VladOK,2813,94,2,0,2,100.0%,8m
21582,3,PAPA,2813,94,2,0,2,100.0%,5m
21582,3,Seoman,2813,60,2,3,5,40.0%,18m
21582,3,Flexar,2813,30,2,3,5,40.0%,19m
21582,3,Delly,2813,111,2,6,8,25.0%,13m
21582,3,TheGrappler,2813,0,1,4,5,20.0%,12m
21582,1,[TEZz]slenderstar,2813,0,1,7,8,12.5%,11m
21582,3,Spooner,2813,0,0,1,1,0.0%,21m
21582,3,Dzot,2813,0,0,1,1,0.0%,19m
21582,3,Todeshetzer,2813,0,0,2,2,0.0%,8m
21617,1,[PERRAS]Putito,2812,1567,212,214,426,49.8%,4m
21617,3,[GE1L]masterblower,2812,1480,170,171,341,49.9%,20m
21617,1,glhf,2812,1140,161,151,312,51.6%,2m
21617,1,UliN,2812,1560,133,142,275,48.4%,23m
21617,2,MKrol,2812,1240,91,96,187,48.7%,8m
21617,3,жабийкамень,2812,1184,58,34,92,63.0%,19m
21617,2,[iLost]feardragon,2812,561,37,32,69,53.6%,12m
21617,2,paltus,2812,1026,35,44,79,44.3%,17m
21617,3,Kremenko,2812,429,33,15,48,68.8%,20m
21617,3,Reckvus,2812,733,31,24,55,56.4%,23m
21617,3,[LNGBRR]jibbmn,2812,580,26,16,42,61.9%,11m
21617,2,[LIQUID]hahahahahaha,2812,434,24,19,43,55.8%,3m
21617,2,BulOx,2812,444,16,21,37,43.2%,12m
21617,3,[BlSn]tze,2812,299,13,12,25,52.0%,4m
21617,3,StonePark,2812,300,11,15,26,42.3%,21m
21617,3,ChriKre,2812,288,10,10,20,50.0%,19m
21617,3,Lox,2812,129,8,0,8,100.0%,3m
21617,1,Nazerot,2812,190,8,14,22,36.4%,9m
21617,3,ninetynine,2812,201,7,8,15,46.7%,1h
21617,3,titsup,2812,0,5,3,8,62.5%,1h
21617,1,Darkns,2812,120,5,5,10,50.0%,9m
21617,2,SirYesSir,2812,0,3,2,5,60.0%,18m
21617,3,ivan,2812,62,3,6,9,33.3%,10m
21617,1,zblob,2812,148,3,8,11,27.3%,22m
21617,2,MUKHMAJONCH,2812,0,2,2,4,50.0%,50m
21617,3,Sane,2812,97,2,4,6,33.3%,17m
21617,3,VeryGooD,2812,89,2,5,7,28.6%,23m
21617,3,SgrdIronfist,2812,94,1,1,2,50.0%,16m
21617,1,Slama,2812,92,1,3,4,25.0%,5m
21617,2,CapLuck,2812,0,0,5,5,0.0%,7m
21647,1,[SLNC]LeBaron,2811,1518,188,191,379,49.6%,9m
21647,3,Mercury,2811,1451,128,130,258,49.6%,22m
21647,2,Chunkie,2811,1121,114,119,233,48.9%,8m
21647,3,ExodiaBuild,2811,1213,87,67,154,56.5%,17m
21647,2,raa,2811,1549,85,85,170,50.0%,9m
21647,1,Pindaman,2811,1562,79,90,169,46.7%,13m
21647,2,[765ml]TanakaKotoha,2811,808,46,45,91,50.5%,9m
21647,3,[NINJ88]ImHbrow,2811,352,34,13,47,72.3%,13m
21647,3,lllllllIlllI,2811,520,27,7,34,79.4%,15m
21647,3,legend,2811,463,27,24,51,52.9%,21m
21647,2,jabushka,2811,709,26,28,54,48.1%,5m
21647,3,[xoxxoo]llllllllllll,2811,605,23,17,40,57.5%,21m
21647,3,SlykyerSAMA,2811,506,23,19,42,54.8%,17m
21647,3,[H0C]SandStorm,2811,466,19,14,33,57.6%,21m
21647,3,[Xtreme]Requiem,2811,475,18,14,32,56.2%,13m
21647,3,Zambrotta,2811,444,15,18,33,45.5%,4m
21647,3,[prxspr]MrQuaggot,2811,402,14,16,30,46.7%,3m
21647,2,Dremered,2811,395,13,17,30,43.3%,9m
21647,3,Riesengoofy,2811,177,10,6,16,62.5%,3m
21647,2,KalAzaar,2811,142,7,6,13,53.8%,9m
21647,2,[Sencor]crockargamer,2811,206,7,8,15,46.7%,23m
21647,3,Opposite,2811,180,6,2,8,75.0%,16m
21647,2,AndreyZ,2811,30,5,5,10,50.0%,2m
21647,3,Terion,2811,0,3,3,6,50.0%,14m
21647,3,[FBUNNY]eatmore,2811,93,2,0,2,100.0%,2m
21647,3,[UndCo]jackhaze,2811,60,2,3,5,40.0%,11m
21647,1,UnfOrGiVeN,2811,123,2,3,5,40.0%,1h
21647,3,NemavrSoc,2811,60,2,5,7,28.6%,7m
21647,3,[Ag47]Psametix,2811,0,1,0,1,100.0%,4m
21647,3,MkL,2811,94,1,1,2,50.0%,17m
21647,3,TheBulldozer,2811,94,1,1,2,50.0%,22m
21647,3,Enemy,2811,92,1,1,2,50.0%,13m
21647,3,Mystogan,2811,0,0,1,1,0.0%,22m
21647,2,Red,2811,0,0,1,1,0.0%,13m
21647,3,Hurz,2811,0,0,1,1,0.0%,11m
21647,2,[EAU]LouisDCLXVI,2811,0,0,8,8,0.0%,17m
21683,3,saintyura,2810,1539,152,142,294,51.7%,8m
21683,3,HowdyCowboy,2810,1196,95,74,169,56.2%,23m
21683,2,[GFQ]маринка,2810,1088,82,82,164,50.0%,13m
21683,2,Jakson,2810,866,77,77,154,50.0%,23m
21683,3,korid,2810,1233,63,46,109,57.8%,19m
21683,3,Pokerface,2810,631,57,53,110,51.8%,21m
21683,3,Hossein,2810,365,54,35,89,60.7%,22m
21683,3,perpetumkaif,2810,1022,52,46,98,53.1%,11m
21683,3,likonit,2810,630,43,28,71,60.6%,23m
21683,3,MuhammedF,2810,1098,42,47,89,47.2%,4m
21683,3,PaLu,2810,900,41,35,76,53.9%,7m
21683,3,ZLOPYHATEL,2810,435,29,31,60,48.3%,19m
21683,3,RWTHAachen,2810,541,24,22,46,52.2%,18m
21683,3,Polupoker,2810,638,24,23,47,51.1%,3m
21683,3,AllPlay,2810,372,20,5,25,80.0%,3m
21683,3,PetShip,2810,387,17,12,29,58.6%,19m
21683,2,Regnard,2810,317,13,11,24,54.2%,1h
21683,3,[JaPP]boriss,2810,178,6,8,14,42.9%,3m
21683,3,Marius,2810,0,4,2,6,66.7%,16m
21683,3,Skerrit,2810,116,4,4,8,50.0%,5m
21683,3,Bangers,2810,114,3,0,3,100.0%,20m
21683,2,testdetruc,2810,0,3,2,5,60.0%,15m
21683,3,ddw,2810,0,3,2,5,60.0%,5m
21683,3,JPRC,2810,0,3,2,5,60.0%,2m
21683,3,TinyMine,2810,93,3,3,6,50.0%,8m
21683,3,Reverent,2810,30,2,1,3,66.7%,20m
21683,3,Rootus,2810,62,2,8,10,20.0%,3m
21683,3,EvDoHa,2810,0,1,1,2,50.0%,3m
21683,3,Dracool,2810,0,1,3,4,25.0%,7m
21683,3,Pulsar,2810,0,0,1,1,0.0%,11m
21683,3,GlaiveTordu,2810,0,0,1,1,0.0%,10m
21683,1,[CocoCo]FishSangwich,2810,0,0,1,1,0.0%,59m
21683,3,KOHHOP,2810,0,0,2,2,0.0%,12m
21683,3,[Heroes]swagman,2810,0,0,5,5,0.0%,22m
21717,1,eGang,2809,1481,476,482,958,49.7%,11m
21717,2,[Harley]bobbiz,2809,1474,152,155,307,49.5%,7m
21717,3,boozy,2809,1391,111,85,196,56.6%,7m
21717,3,Pavlus,2809,827,55,27,82,67.1%,6m
21717,2,ZergAteYou,2809,1339,51,55,106,48.1%,7m
21717,2,RegularGuy,2809,1022,38,40,78,48.7%,20m
21717,3,[ZOMBY]GILA,2809,854,34,32,66,51.5%,8m
21717,3,[T0G]Ferret,2809,523,20,19,39,51.3%,7m
21717,3,Pyro,2809,393,16,11,27,59.3%,17m
21717,3,[Y26]Hit,2809,366,13,9,22,59.1%,3m
21717,2,Focus,2809,264,9,12,21,42.9%,6m
21717,3,[eSRT]Gespenst,2809,245,8,5,13,61.5%,21m
21717,3,SeanieTV,2809,218,8,10,18,44.4%,11m
21717,3,aLucaRd,2809,149,7,4,11,63.6%,2m
21717,3,Gravix,2809,236,7,7,14,50.0%,8m
21717,3,Eightmouse,2809,114,5,8,13,38.5%,3m
21717,3,SyncMaster,2809,146,5,10,15,33.3%,13m
21717,3,Architect,2809,146,4,2,6,66.7%,14m
21717,2,CannonFodder,2809,162,3,2,5,60.0%,54m
21717,3,seven,2809,138,3,2,5,60.0%,7m
21717,3,RaptorHavx,2809,94,2,0,2,100.0%,9m
21717,3,[TTIS]PoppZg,2809,0,2,3,5,40.0%,4m
21717,3,[x67x]ROHoZ,2809,0,1,0,1,100.0%,3m
21717,3,[AMFs]AMFGray,2809,0,1,0,1,100.0%,20m
21717,3,carlbror,2809,0,1,0,1,100.0%,13m
21717,1,[E1D]Malios,2809,0,1,0,1,100.0%,1h
21717,1,SerGoTo,2809,0,1,1,2,50.0%,51m
21717,2,NewOrder,2809,0,1,1,2,50.0%,6m
21717,3,[Deuss]PokerAce,2809,0,1,3,4,25.0%,12m
21717,2,[ATORS]Rangor,2809,0,1,4,5,20.0%,1h
21717,3,apaka,2809,0,0,1,1,0.0%,4m
21717,3,Peasant,2809,0,0,1,1,0.0%,17m
21717,3,[DarKsS]Andrew,2809,0,0,2,2,0.0%,8m
21750,3,lgnkv,2808,1543,165,157,322,51.2%,19m
21750,3,Red,2808,1614,131,122,253,51.8%,5m
21750,3,[TheDOH]Frostwolf,2808,1183,99,99,198,50.0%,20m
21750,3,WindUP,2808,1557,84,75,159,52.8%,19m
21750,2,[PFLM1N]VIT,2808,1246,60,65,125,48.0%,14m
21750,3,Alex,2808,807,43,40,83,51.8%,3m
21750,2,[SvTact]Glot,2808,718,27,38,65,41.5%,15m
21750,3,Granat,2808,540,23,22,45,51.1%,22m
21750,3,[NIK2]Cavman,2808,480,18,19,37,48.6%,16m
21750,3,clato,2808,389,17,9,26,65.4%,12m
21750,3,vinodel,2808,405,17,12,29,58.6%,11m
21750,2,CARLCRAFT,2808,266,12,12,24,50.0%,2m
21750,2,[SMF]Qminator,2808,285,11,13,24,45.8%,1h
21750,3,Faust,2808,237,10,2,12,83.3%,19m
21750,3,[ScanS]SlickVinny,2808,236,9,11,20,45.0%,7m
21750,1,Leonid,2808,213,7,6,13,53.8%,18m
21750,3,Derman,2808,194,7,7,14,50.0%,2m
21750,3,makita,2808,212,6,5,11,54.5%,19m
21750,2,[mutex]void,2808,88,6,6,12,50.0%,2m
21750,1,Kio,2808,213,5,2,7,71.4%,1h
21750,3,AmZBelin,2808,133,5,4,9,55.6%,2m
21750,3,Laura,2808,157,4,2,6,66.7%,18m
21750,3,Rackstar,2808,74,4,8,12,33.3%,7m
21750,3,Fortnite,2808,116,3,1,4,75.0%,21m
21750,1,greg,2808,121,3,1,4,75.0%,1h
21750,3,[SC7]wazzdaka,2808,30,2,1,3,66.7%,11m
21750,3,kiro,2808,30,2,2,4,50.0%,18m
21750,3,[НС]Zergling,2808,30,2,4,6,33.3%,15m
21750,3,Noxm,2808,104,2,5,7,28.6%,13m
21750,2,Nemesis,2808,102,2,8,10,20.0%,5m
21750,3,IIIIIIIIIIII,2808,0,1,0,1,100.0%,8m
21750,2,[DJ3]KoningMorp,2808,96,1,4,5,20.0%,50m
21750,3,BosmaTheNL,2808,30,1,5,6,16.7%,3m
21750,3,Irvine,2808,0,0,1,1,0.0%,19m
21750,3,LoDblrb,2808,0,0,1,1,0.0%,15m
21750,3,Fox,2808,0,0,1,1,0.0%,18m
21750,3,ElTomato,2808,0,0,1,1,0.0%,6m
21787,2,Wombat,2807,1501,263,247,510,51.6%,8m
21787,3,[CPTR]Romulus,2807,1499,165,154,319,51.7%,18m
21787,3,[FDADVF]marfab,2807,1600,75,77,152,49.3%,15m
21787,3,Conundrumz,2807,1354,71,64,135,52.6%,13m
21787,3,Alex,2807,1043,44,38,82,53.7%,11m
21787,3,Sogeking,2807,823,38,29,67,56.7%,8m
21787,3,bogshuter,2807,819,35,29,64,54.7%,17m
21787,3,[Buldog]Pleften,2807,423,19,16,35,54.3%,5m
21787,3,joooo,2807,419,18,15,33,54.5%,21m
21787,3,Sigfried,2807,345,15,10,25,60.0%,2m
21787,3,[TheSwE]Bogs,2807,382,14,9,23,60.9%,12m
21787,3,Noa,2807,348,14,16,30,46.7%,7m
21787,3,Scorn,2807,299,12,6,18,66.7%,14m
21787,2,[SSeiya]Kanon,2807,180,9,0,9,100.0%,12m
21787,3,[BeSC]Stormsurger,2807,229,7,5,12,58.3%,16m
21787,3,Star,2807,88,7,9,16,43.8%,6m
21787,3,BloodMood,2807,175,6,2,8,75.0%,21m
21787,1,Frolick,2807,214,6,16,22,27.3%,15m
21787,1,[IMoosI]Vinz,2807,121,3,2,5,60.0%,1h
21787,3,MarineHunter,2807,139,3,2,5,60.0%,22m
21787,3,[Nosda]Kiwi,2807,60,3,3,6,50.0%,20m
21787,3,Excel,2807,58,3,3,6,50.0%,3m
21787,3,[999999]Atomkraftfan,2807,91,2,2,4,50.0%,21m
21787,3,zzDONzz,2807,0,1,0,1,100.0%,9m
21787,3,HaGi,2807,0,1,2,3,33.3%,16m
21787,3,Marzhin,2807,30,1,3,4,25.0%,3m
21787,3,kyser,2807,93,1,4,5,20.0%,19m
21787,3,TheJangler,2807,0,1,4,5,20.0%,15m
21787,2,Menkar,2807,88,1,7,8,12.5%,21m
21787,3,Immazi,2807,0,0,1,1,0.0%,4m
21787,2,Soarer,2807,0,0,1,1,0.0%,20m
21787,3,Alatriste,2807,0,0,4,4,0.0%,24m
21787,3,[FABPLS]SeñorGopnik,2807,0,0,5,5,0.0%,5m
21820,3,Wein,2806,1341,198,168,366,54.1%,19m
21820,2,[PUAS]Ramzi,2806,983,134,136,270,49.6%,16m
21820,3,Sed,2806,1447,112,52,164,68.3%,3m
21820,3,BoyDozer,2806,1520,111,94,205,54.1%,14m
21820,3,necroix,2806,845,87,77,164,53.0%,6m
21820,3,FustySSG,2806,746,69,60,129,53.5%,9m
21820,1,Ionut,2806,884,49,56,105,46.7%,12m
21820,3,Toshimi,2806,1249,48,47,95,50.5%,3m
21820,2,decoch,2806,934,46,43,89,51.7%,20m
21820,3,TheEnd,2806,1112,41,47,88,46.6%,3m
21820,3,Silhouette,2806,889,35,33,68,51.5%,9m
21820,3,Gandoulfion,2806,676,34,16,50,68.0%,23m
21820,2,TerranUnit,2806,328,31,22,53,58.5%,7m
21820,3,[N1TDA]erbol,2806,565,25,22,47,53.2%,15m
21820,2,ProtonM,2806,596,22,25,47,46.8%,21m
21820,3,Vanger,2806,320,19,7,26,73.1%,16m
21820,3,Bunlock,2806,455,17,17,34,50.0%,8m
21820,3,Aspanovich,2806,390,15,10,25,60.0%,3m
21820,3,FREElancer,2806,404,15,11,26,57.7%,16m
21820,2,NeuYa,2806,460,15,18,33,45.5%,2m
21820,3,[PGCom]Cyberrevo,2806,277,14,10,24,58.3%,19m
21820,3,kimdoun,2806,322,14,11,25,56.0%,19m
21820,2,Qlesz,2806,285,11,11,22,50.0%,1h
21820,3,Energizer,2806,232,10,6,16,62.5%,6m
21820,3,Špekov,2806,250,9,6,15,60.0%,16m
21820,3,Schwifty,2806,237,8,6,14,57.1%,16m
21820,2,[SPRH]albinxx,2806,179,7,8,15,46.7%,18m
21820,3,Barka,2806,158,6,2,8,75.0%,3m
21820,1,BOSABI,2806,169,6,6,12,50.0%,51m
21820,2,Ascension,2806,166,6,11,17,35.3%,2m
21820,2,Nuggat,2806,58,5,6,11,45.5%,10m
21820,3,Chivas,2806,150,5,10,15,33.3%,8m
21820,2,macmac,2806,168,5,10,15,33.3%,20m
21820,3,MLGrusGamer,2806,58,3,2,5,60.0%,8m
21820,3,Tor,2806,0,3,3,6,50.0%,21m
21820,3,Gyrfalcon,2806,58,3,5,8,37.5%,4m
21820,2,xenos,2806,96,3,11,14,21.4%,14m
21820,3,BossTime,2806,30,2,1,3,66.7%,20m
21820,3,[DABUM]RaMBo,2806,60,2,3,5,40.0%,8m
21820,2,Autsch,2806,94,2,3,5,40.0%,23m
21820,2,DEFOUY,2806,0,2,3,5,40.0%,1h
21820,3,RoadKiLL,2806,30,2,6,8,25.0%,3m
21820,3,Monster,2806,30,1,2,3,33.3%,5m
21820,1,llets,2806,96,1,2,3,33.3%,1h
21820,2,SaergentHP,2806,0,0,1,1,0.0%,20m
21820,3,HellFrix,2806,0,0,2,2,0.0%,20m
21820,3,mroovy,2806,0,0,4,4,0.0%,2m
21867,2,[Papy]Boum,2805,1602,112,119,231,48.5%,14m
21867,2,[InitRu]uri,2805,486,47,52,99,47.5%,7m
21867,3,Maxim,2805,1046,44,34,78,56.4%,19m
21867,3,jrvq,2805,945,37,35,72,51.4%,24m
21867,3,[MPower]FBICIA,2805,395,15,17,32,46.9%,20m
21867,3,Renny,2805,448,15,18,33,45.5%,2m
21867,3,[Radium]ElinaRosle,2805,188,12,5,17,70.6%,1h
21867,2,YeZealver,2805,216,9,9,18,50.0%,7m
21867,3,[40APM]nOKi,2805,208,8,11,19,42.1%,16m
21867,3,[EpiCa]Adur,2805,218,7,4,11,63.6%,14m
21867,1,[НОД17]FerA,2805,148,7,4,11,63.6%,1h
21867,1,Space,2805,119,5,4,9,55.6%,1h
21867,3,llllllllllll,2805,144,5,5,10,50.0%,12m
21867,3,Tomasz,2805,93,4,2,6,66.7%,15m
21867,3,YukiFerner,2805,0,3,3,6,50.0%,8m
21867,3,Reichet,2805,135,3,3,6,50.0%,4m
21867,3,Sklass,2805,0,3,3,6,50.0%,21m
21867,3,[WАSD]scandium,2805,109,3,4,7,42.9%,20m
21867,3,ChaosBobek,2805,0,1,1,2,50.0%,3m
21867,3,AMT,2805,30,1,3,4,25.0%,20m
21867,3,luckystar,2805,0,0,1,1,0.0%,16m
21867,1,Morgul,2805,0,0,1,1,0.0%,16m
21867,1,SirThuzad,2805,0,0,1,1,0.0%,19m
21867,3,радриго,2805,0,0,1,1,0.0%,7m
21867,3,FMD,2805,0,0,3,3,0.0%,21m
21892,3,Markinhos,2804,1457,247,225,472,52.3%,19m
21892,3,depakl,2804,1054,211,182,393,53.7%,13m
21892,2,zartarr,2804,1229,131,128,259,50.6%,14m
21892,3,[Sieral]SunshineBean,2804,1255,75,61,136,55.1%,3m
21892,3,JeanLuc,2804,1487,72,55,127,56.7%,8m
21892,3,HollyRage,2804,1388,64,46,110,58.2%,3m
21892,3,EliteBowser,2804,531,58,45,103,56.3%,18m
21892,3,[DAHUS]Tom,2804,789,58,47,105,55.2%,7m
21892,3,[GLNMS]QbQb,2804,929,49,35,84,58.3%,18m
21892,3,Xakari,2804,513,36,24,60,60.0%,4m
21892,3,beber,2804,643,29,17,46,63.0%,3m
21892,3,[Buldog]Tiphon,2804,554,21,20,41,51.2%,22m
21892,3,MoeSTRo,2804,502,20,15,35,57.1%,17m
21892,3,zerstoerer,2804,375,18,6,24,75.0%,16m
21892,3,[FlFi]ZvezdaSevera,2804,333,17,5,22,77.3%,2m
21892,3,Mortimer,2804,247,17,14,31,54.8%,3m
21892,3,Tova,2804,417,14,12,26,53.8%,16m
21892,3,BeNjX,2804,339,12,8,20,60.0%,21m
21892,3,Twister,2804,258,10,12,22,45.5%,11m
21892,3,Murderface,2804,238,9,3,12,75.0%,20m
21892,1,Quest,2804,168,7,5,12,58.3%,5m
21892,3,Timka,2804,157,7,7,14,50.0%,52m
21892,3,Ollegg,2804,93,6,0,6,100.0%,19m
21892,3,[RahLuk]dorido,2804,176,6,1,7,85.7%,5m
21892,3,Matajus,2804,226,6,6,12,50.0%,17m
21892,2,suppedans,2804,164,5,9,14,35.7%,12m
21892,2,Alienu,2804,134,5,16,21,23.8%,20m
21892,2,DeMiZe,2804,0,4,2,6,66.7%,9m
21892,3,Abbendis,2804,90,4,4,8,50.0%,8m
21892,3,Grixx,2804,60,3,4,7,42.9%,9m
21892,3,[HZeS]ZedFunSize,2804,58,3,4,7,42.9%,21m
21892,3,TeknoSeyfo,2804,90,3,4,7,42.9%,16m
21892,3,Castral,2804,91,2,5,7,28.6%,8m
21892,3,[BioMec]ThoFly,2804,0,1,0,1,100.0%,3m
21892,2,[lLiTl]Arnas,2804,0,1,0,1,100.0%,56m
21892,3,TRoN,2804,0,1,0,1,100.0%,20m
21892,3,FeaRwOw,2804,0,1,1,2,50.0%,8m
21892,3,abntcs,2804,30,1,2,3,33.3%,2m
21892,3,Pipepurc,2804,30,1,3,4,25.0%,20m
21892,3,zeRa,2804,30,1,4,5,20.0%,3m
21892,2,[Kemi]Siska,2804,0,1,6,7,14.3%,1h
21892,3,Arach,2804,0,0,1,1,0.0%,3m
21892,3,NukeMarin,2804,0,0,4,4,0.0%,4m
21935,3,grangun,2803,1622,404,396,800,50.5%,9m
21935,2,AngelOfChaos,2803,1624,263,251,514,51.2%,6m
21935,2,Spîriit,2803,1100,233,217,450,51.8%,7m
21935,3,MissLaura,2803,1009,127,119,246,51.6%,5m
21935,3,GancteR,2803,1500,68,59,127,53.5%,21m
21935,3,[200P]Mattes,2803,855,41,20,61,67.2%,20m
21935,3,Mositown,2803,701,37,32,69,53.6%,12m
21935,3,Zott,2803,958,36,36,72,50.0%,2m
21935,3,[Dzen]konstantinos,2803,717,33,32,65,50.8%,12m
21935,3,magum,2803,502,29,23,52,55.8%,17m
21935,3,HoYaGa,2803,253,18,15,33,54.5%,3m
21935,3,Voilok,2803,461,17,14,31,54.8%,20m
21935,3,[snowBY]ChmokPypsik,2803,367,15,7,22,68.2%,18m
21935,3,Razorthin,2803,135,15,16,31,48.4%,9m
21935,3,Robinson,2803,310,11,9,20,55.0%,13m
21935,3,magejiTerran,2803,139,10,6,16,62.5%,3m
21935,3,Abdulos,2803,222,10,11,21,47.6%,7m
21935,3,CivilOwl,2803,208,8,10,18,44.4%,4m
21935,3,[1000]NiKus,2803,202,7,5,12,58.3%,4m
21935,3,KaarisDeter,2803,200,7,6,13,53.8%,19m
21935,2,Gansgeil,2803,157,6,9,15,40.0%,14m
21935,2,RedKery,2803,46,5,2,7,71.4%,58m
21935,1,Avgustin,2803,193,5,7,12,41.7%,1h
21935,1,Dane,2803,181,5,15,20,25.0%,2m
21935,3,Reuseup,2803,124,4,7,11,36.4%,22m
21935,2,Nikmilk,2803,95,3,3,6,50.0%,15m
21935,2,calibur,2803,0,3,3,6,50.0%,12m
21935,3,Zeldris,2803,0,3,3,6,50.0%,18m
21935,3,[zaordu]TIER,2803,90,3,4,7,42.9%,22m
21935,3,veloce,2803,120,2,2,4,50.0%,4m
21935,3,[TTe]markusi,2803,0,1,0,1,100.0%,2m
21935,3,[Destab]Foster,2803,91,1,2,3,33.3%,22m
21935,3,[ImWRs]gantua,2803,97,1,3,4,25.0%,54m
21935,3,cdecl,2803,0,1,4,5,20.0%,20m
21935,3,[xFRSx]Sherlock,2803,30,1,6,7,14.3%,15m
21935,2,[FPsl]RazielSaraf,2803,0,0,1,1,0.0%,11m
21935,3,koper,2803,0,0,1,1,0.0%,23m
21935,3,tkekahese,2803,0,0,1,1,0.0%,9m
21935,3,Aimie,2803,0,0,1,1,0.0%,12m
21935,3,IMWI,2803,0,0,2,2,0.0%,18m
21935,3,Edorock,2803,0,0,4,4,0.0%,7m
21976,3,Némésis,2802,1428,83,69,152,54.6%,3m
21976,3,Janus,2802,1479,65,60,125,52.0%,6m
21976,2,[Animе]Mrkvit,2802,1501,65,64,129,50.4%,17m
21976,2,Avi,2802,1518,65,72,137,47.4%,15m
21976,3,YoungLamia,2802,887,39,27,66,59.1%,20m
21976,3,[BHR]Khlint,2802,789,35,32,67,52.2%,19m
21976,3,Валуев,2802,946,35,34,69,50.7%,19m
21976,3,fourtwenty,2802,759,34,29,63,54.0%,11m
21976,3,MrT,2802,831,33,27,60,55.0%,19m
21976,2,Paxanb,2802,901,32,37,69,46.4%,7m
21976,3,DarkBerkut,2802,583,29,25,54,53.7%,19m
21976,3,Mia,2802,715,29,28,57,50.9%,3m
21976,3,Maxmager,2802,462,19,14,33,57.6%,3m
21976,3,Yarmaul,2802,408,18,7,25,72.0%,13m
21976,3,[1FU2]Shinobi,2802,424,15,17,32,46.9%,5m
21976,3,BinGoBOOOM,2802,291,12,4,16,75.0%,5m
21976,3,Mouche,2802,337,12,9,21,57.1%,2m
21976,3,[Heroes]immOrTaL,2802,291,11,6,17,64.7%,16m
21976,2,Влад,2802,298,11,12,23,47.8%,1h
21976,3,ElestraGOD,2802,291,10,8,18,55.6%,7m
21976,3,Diggahs,2802,245,9,10,19,47.4%,14m
21976,3,Kirov,2802,273,7,10,17,41.2%,3m
21976,3,[4Reich]Islero,2802,187,6,4,10,60.0%,8m
21976,3,[Kripta]САФАРИ,2802,165,5,3,8,62.5%,19m
21976,3,Faegyrae,2802,139,4,1,5,80.0%,7m
21976,3,dimchik,2802,120,4,11,15,26.7%,21m
21976,3,[Seti]CorranHorn,2802,112,3,1,4,75.0%,12m
21976,3,albasila,2802,0,3,3,6,50.0%,18m
21976,3,[3REIX]Brosras,2802,0,3,3,6,50.0%,19m
21976,3,[NLKAAS]poepbuddy,2802,30,2,2,4,50.0%,4m
21976,3,aiur,2802,97,1,2,3,33.3%,6m
21976,2,kdsqk,2802,90,1,3,4,25.0%,1h
21976,3,Zorg,2802,30,1,3,4,25.0%,3m
21976,2,Manwe,2802,0,1,4,5,20.0%,9m
21976,3,[NøT]Kirby,2802,0,1,4,5,20.0%,8m
21976,3,DartFrog,2802,30,1,5,6,16.7%,15m
21976,3,[KWe]haschy,2802,0,0,1,1,0.0%,18m
21976,3,[SLW]Varask,2802,0,0,1,1,0.0%,4m
21976,3,afartem,2802,0,0,1,1,0.0%,9m
21976,3,daracorne,2802,0,0,1,1,0.0%,2m
21976,3,MANTISBLADES,2802,0,0,2,2,0.0%,3m
21976,3,[hons]Shargath,2802,0,0,3,3,0.0%,15m
21976,1,[grgrgr]OTHON,2802,0,0,3,3,0.0%,11m
21976,3,doOD,2802,0,0,4,4,0.0%,8m
22020,2,gerigeri,2801,1505,147,126,273,53.8%,8m
22020,2,Gerardletail,2801,1491,99,107,206,48.1%,23m
22020,3,IIITITANIII,2801,1616,65,63,128,50.8%,8m
22020,3,Dar,2801,853,45,41,86,52.3%,16m
22020,3,Cunctator,2801,993,41,41,82,50.0%,5m
22020,3,erunky,2801,308,37,22,59,62.7%,12m
22020,3,[BISHOP]karambol,2801,750,31,21,52,59.6%,19m
22020,3,Zest,2801,727,30,22,52,57.7%,8m
22020,3,Beathoven,2801,630,25,20,45,55.6%,18m
22020,3,[CNNRDS]nekinox,2801,618,23,23,46,50.0%,14m
22020,3,Lutiy,2801,517,21,12,33,63.6%,3m
22020,3,Bunzirombolo,2801,468,16,16,32,50.0%,16m
22020,3,[TP4U]James,2801,437,15,14,29,51.7%,5m
22020,3,TroeP,2801,390,14,12,26,53.8%,17m
22020,3,Pikabuz,2801,219,13,8,21,61.9%,9m
22020,3,[snowsf]BNǂrayan,2801,344,12,14,26,46.2%,21m
22020,3,ЛысыйBRAZERS,2801,264,10,10,20,50.0%,4m
22020,3,[ODISO]igor,2801,208,6,7,13,46.2%,5m
22020,3,Cassadian,2801,114,5,6,11,45.5%,19m
22020,3,Bubka,2801,90,5,7,12,41.7%,18m
22020,3,[4SID]maksimkms,2801,0,4,2,6,66.7%,2m
22020,2,Onichi,2801,166,4,9,13,30.8%,12m
22020,3,NRWVERBOT,2801,92,3,3,6,50.0%,18m
22020,2,[lTSPX]nauren,2801,0,3,3,6,50.0%,23m
22020,3,Abaddon,2801,90,3,5,8,37.5%,18m
22020,3,[BloTi]AlwerZ,2801,30,2,1,3,66.7%,5m
22020,3,pOtvIskAk,2801,112,2,1,3,66.7%,12m
22020,3,VanDerKrinch,2801,118,2,2,4,50.0%,8m
22020,3,Phreo,2801,115,2,2,4,50.0%,19m
22020,2,Steleur,2801,30,2,5,7,28.6%,5m
22020,3,[TODOW]ipez,2801,30,1,2,3,33.3%,6m
22020,3,LobStrokk,2801,0,0,1,1,0.0%,1h
22020,3,SFliadd,2801,0,0,1,1,0.0%,9m
22020,3,AoPJoly,2801,0,0,1,1,0.0%,14m
22020,3,Madara,2801,0,0,4,4,0.0%,11m
22055,2,didi,2800,1614,270,274,544,49.6%,8m
22055,3,blaagi,2800,752,93,79,172,54.1%,15m
22055,2,КузькинаМать,2800,1260,58,60,118,49.2%,7m
22055,3,adamek,2800,1094,44,39,83,53.0%,3m
22055,2,Heykey,2800,349,35,31,66,53.0%,2m
22055,3,FlinkeMaus,2800,761,32,30,62,51.6%,3m
22055,3,nixom,2800,602,28,14,42,66.7%,4m
22055,3,Marine,2800,393,18,11,29,62.1%,8m
22055,3,beastus,2800,504,17,22,39,43.6%,3m
22055,3,MeNameIsBily,2800,412,15,11,26,57.7%,8m
22055,3,LordVader,2800,345,12,9,21,57.1%,16m
22055,2,Sasha,2800,273,11,11,22,50.0%,12m
22055,2,Dmitrich,2800,214,10,9,19,52.6%,51m
22055,2,DrygDwCh,2800,116,7,7,14,50.0%,14m
22055,3,[corp20]iDima,2800,202,6,6,12,50.0%,21m
22055,1,[kek34]irbis,2800,146,6,6,12,50.0%,1h
22055,1,MasterMo,2800,119,5,4,9,55.6%,1h
22055,2,Serge,2800,114,5,5,10,50.0%,11m
22055,1,TaBoo,2800,96,5,6,11,45.5%,1h
22055,3,Bazi,2800,56,4,6,10,40.0%,20m
22055,3,Karnaf,2800,167,4,7,11,36.4%,21m
22055,1,Асхат,2800,124,3,3,6,50.0%,50m
22055,3,[EviLMD]MeNe,2800,90,3,8,11,27.3%,16m
22055,1,[Heroes]WarpNate,2800,84,2,1,3,66.7%,5m
22055,2,Jeleoo,2800,116,2,8,10,20.0%,9m
22055,3,Yaroslav,2800,0,1,0,1,100.0%,20m
22055,2,[190]thechampion,2800,0,1,0,1,100.0%,50m
22055,1,[Bloro]Lestaron,2800,42,1,1,2,50.0%,4m
22055,3,FenriR,2800,0,1,2,3,33.3%,20m
22055,3,MikeL,2800,0,1,3,4,25.0%,18m
22055,3,benyus,2800,30,1,3,4,25.0%,4m
22055,3,[WNTBD]MatLePirat,2800,30,1,4,5,20.0%,22m
22055,3,Boss,2800,0,0,1,1,0.0%,14m
22055,2,[EZKBM]HeavensWolf,2800,0,0,1,1,0.0%,60m
22055,3,PurpleStar,2800,0,0,1,1,0.0%,15m
22055,3,Pashandr,2800,0,0,2,2,0.0%,11m
22055,3,Adventyра,2800,0,0,2,2,0.0%,18m
22055,2,Bobbee,2800,0,0,4,4,0.0%,9m
22093,3,Rabs,2799,1485,123,105,228,53.9%,19m
22093,1,[fam1ly]KinpachLordX,2799,981,63,58,121,52.1%,10m
22093,2,nicobi,2799,761,47,49,96,49.0%,12m
22093,3,KROKO,2799,784,32,29,61,52.5%,17m
22093,3,FireSheep,2799,592,23,20,43,53.5%,6m
22093,3,МосЛеро,2799,470,16,21,37,43.2%,5m
22093,3,ZaaKuu,2799,267,10,5,15,66.7%,8m
22093,1,Dema,2799,183,5,8,13,38.5%,9m
22093,3,ruphert,2799,114,4,6,10,40.0%,3m
22093,2,akFirstman,2799,0,3,2,5,60.0%,22m
22093,3,[PÂRłAH]Veeky,2799,58,3,2,5,60.0%,18m
22093,2,Vixu,2799,95,3,3,6,50.0%,56m
22093,3,[BR4VE]ShadowFox,2799,139,3,3,6,50.0%,6m
22093,1,JetSetWilly,2799,38,3,3,6,50.0%,58m
22093,3,[PÂRłAH]Millamber,2799,122,3,4,7,42.9%,10m
22093,3,AUREYWANNAB,2799,92,3,5,8,37.5%,20m
22093,1,TitanCrusade,2799,44,2,0,2,100.0%,56m
22093,2,[Antik]MahesVarra,2799,0,1,0,1,100.0%,52m
22093,1,Timberpank,2799,0,1,0,1,100.0%,18m
22093,3,VeNoM,2799,30,1,6,7,14.3%,17m
22093,3,[TeamUR]Aristocrat,2799,0,0,3,3,0.0%,21m
22114,3,TRIFON,2798,1511,218,239,457,47.7%,15m
22114,3,LiSiCin,2798,1611,216,198,414,52.2%,7m
22114,3,fred,2798,1399,135,139,274,49.3%,4m
22114,2,TomBombadil,2798,925,106,87,193,54.9%,17m
22114,3,Laczwit,2798,352,74,64,138,53.6%,18m
22114,3,Yohanimus,2798,1187,64,59,123,52.0%,7m
22114,3,MEGADRiVE,2798,1069,43,38,81,53.1%,6m
22114,1,nAMeMAn,2798,892,28,26,54,51.9%,1h
22114,3,Морадин,2798,170,22,8,30,73.3%,9m
22114,3,[SPEKTR]Ryrkera,2798,520,20,23,43,46.5%,7m
22114,3,TrashCan,2798,301,12,7,19,63.2%,15m
22114,3,[6PaTBa]HasuTony,2798,336,12,17,29,41.4%,22m
22114,3,[QMnewb]Gringotseru,2798,315,11,8,19,57.9%,18m
22114,2,Knohan,2798,338,11,24,35,31.4%,3m
22114,3,THAlLAND,2798,244,10,8,18,55.6%,15m
22114,3,Direxus,2798,218,7,6,13,53.8%,19m
22114,3,[isIMBА]Nikolayvodka,2798,172,6,8,14,42.9%,11m
22114,3,injinero,2798,155,5,3,8,62.5%,23m
22114,1,[TZGswe]Kalifen,2798,170,4,6,10,40.0%,1h
22114,1,Majky,2798,96,3,2,5,60.0%,18m
22114,3,PhonkX,2798,138,3,2,5,60.0%,10m
22114,3,OsOk,2798,0,3,3,6,50.0%,8m
22114,1,vladsaper,2798,0,3,5,8,37.5%,17m
22114,3,bravet,2798,0,1,1,2,50.0%,14m
22114,2,dkN,2798,0,0,1,1,0.0%,23m
22114,3,crazycake,2798,0,0,2,2,0.0%,18m
22114,1,mash,2798,0,0,2,2,0.0%,58m
22114,3,KRUT,2798,0,0,3,3,0.0%,12m
22114,1,GeneralPaton,2798,0,0,5,5,0.0%,1h
22143,3,Ouassif,2797,1137,97,86,183,53.0%,6m
22143,3,RaVen,2797,740,40,17,57,70.2%,16m
22143,2,itsdavid,2797,348,10,17,27,37.0%,15m
22143,3,Henan,2797,273,9,10,19,47.4%,3m
22143,2,Alarion,2797,221,6,5,11,54.5%,58m
22143,3,[ЭкcSC2]Durex,2797,131,5,3,8,62.5%,3m
22143,1,TheGrandNoob,2797,189,5,3,8,62.5%,1h
22143,2,germs,2797,88,4,4,8,50.0%,10m
22143,1,VeZeR,2797,0,3,2,5,60.0%,59m
22143,1,[DTCz]Doriane,2797,0,2,3,5,40.0%,18m
22143,3,SinSin,2797,0,1,1,2,50.0%,9m
22143,3,RafikosteFun,2797,95,1,2,3,33.3%,19m
22143,1,Hicuru,2797,0,0,1,1,0.0%,1h
22143,2,[xLuck]Eugene,2797,0,0,1,1,0.0%,1h
22143,2,[ialm]adelante,2797,0,0,1,1,0.0%,1h
22158,1,Darqivic,2796,1556,238,233,471,50.5%,19m
22158,3,DANchik,2796,1564,187,156,343,54.5%,18m
22158,1,NightKnight,2796,1535,137,145,282,48.6%,19m
22158,3,FitNoMore,2796,1326,136,134,270,50.4%,18m
22158,2,htfhere,2796,369,85,65,150,56.7%,3m
22158,2,Lummy,2796,834,30,35,65,46.2%,6m
22158,3,theUltimate,2796,469,18,12,30,60.0%,11m
22158,3,[TeamdB]dBǂWahesh,2796,390,16,14,30,53.3%,22m
22158,3,llllllllllll,2796,337,12,9,21,57.1%,16m
22158,3,[KIEL]PillowLava,2796,255,10,10,20,50.0%,21m
22158,1,LifeStyle,2796,239,7,8,15,46.7%,1h
22158,2,Alternativa,2796,190,6,10,16,37.5%,9m
22158,2,[QTcIub]leotar,2796,48,4,4,8,50.0%,1h
22158,2,mishash,2796,94,4,5,9,44.4%,1h
22158,3,Redompteur,2796,90,3,4,7,42.9%,22m
22158,1,[SZM]Schnubbi,2796,40,2,1,3,66.7%,1h
22158,3,[OaSa]Styxx,2796,30,2,2,4,50.0%,2m
22158,2,Detorre,2796,38,2,3,5,40.0%,1h
22158,3,Klimu,2796,0,1,2,3,33.3%,2m
22158,1,[1stGG]wurzelsepp,2796,0,0,1,1,0.0%,1h
22158,3,thedesertfox,2796,0,0,3,3,0.0%,10m
22158,3,Valdemar,2796,0,0,3,3,0.0%,19m
22180,2,povar,2795,1534,207,193,400,51.8%,13m
22180,2,Tim,2795,1404,180,171,351,51.3%,19m
22180,1,HeSSOlinO,2795,1328,162,147,309,52.4%,4m
22180,3,HeMan,2795,648,95,92,187,50.8%,12m
22180,3,Stalin,2795,508,37,31,68,54.4%,12m
22180,3,TaoElumina,2795,634,26,21,47,55.3%,19m
22180,3,Rocket,2795,577,25,19,44,56.8%,17m
22180,2,[S8]Paperback,2795,432,18,19,37,48.6%,11m
22180,2,bublik,2795,468,18,23,41,43.9%,20m
22180,3,Renegade,2795,406,17,11,28,60.7%,21m
22180,2,friski,2795,389,14,15,29,48.3%,17m
22180,3,mohavi,2795,381,13,13,26,50.0%,9m
22180,3,Tempest,2795,267,11,4,15,73.3%,22m
22180,1,[CBD420]Dejeuro,2795,237,8,7,15,53.3%,1h
22180,1,Spanyesz,2795,173,7,7,14,50.0%,51m
22180,3,joel,2795,209,6,5,11,54.5%,6m
22180,3,Xanth,2795,169,5,4,9,55.6%,8m
22180,2,Knugen,2795,112,4,4,8,50.0%,23m
22180,3,[JaPP]Komisar,2795,115,3,1,4,75.0%,10m
22180,1,[MMKing]MicroKing,2795,0,3,2,5,60.0%,5m
22180,1,Митяй,2795,40,3,3,6,50.0%,20m
22180,3,MasterIntima,2795,58,2,4,6,33.3%,4m
22180,2,catan,2795,0,2,5,7,28.6%,50m
22180,1,[PRLS]Johnny,2795,0,2,8,10,20.0%,5m
22180,3,[frruju]frido,2795,0,1,1,2,50.0%,21m
22180,3,Erebos,2795,30,1,3,4,25.0%,10m
22180,3,Leo,2795,30,1,3,4,25.0%,7m
22180,1,Saulpen,2795,0,0,1,1,0.0%,1h
22180,1,[BaPaBo]Erdgeist,2795,0,0,2,2,0.0%,1h
22209,1,valy,2794,1437,203,206,409,49.6%,7m
22209,2,BiosHazard,2794,1063,169,161,330,51.2%,5m
22209,3,JagHasie,2794,909,155,152,307,50.5%,20m
22209,3,Gubo,2794,1563,143,142,285,50.2%,4m
22209,3,MeXaNiK,2794,1349,79,55,134,59.0%,17m
22209,3,[k1raen]Cardinal,2794,375,42,44,86,48.8%,3m
22209,1,GROKA,2794,792,28,21,49,57.1%,13m
22209,3,[NMF]Cobalt,2794,571,27,22,49,55.1%,19m
22209,3,HotNicksUK,2794,557,23,14,37,62.2%,14m
22209,3,freeman,2794,410,19,19,38,50.0%,9m
22209,2,SUNSHINE,2794,428,15,21,36,41.7%,14m
22209,1,Fabian,2794,432,12,10,22,54.5%,1h
22209,3,Chadray,2794,283,11,13,24,45.8%,3m
22209,1,Gvriel,2794,224,9,5,14,64.3%,1h
22209,3,satiety,2794,200,7,1,8,87.5%,16m
22209,1,Dejsan,2794,159,7,3,10,70.0%,1h
22209,1,[DoT]Bigqt,2794,236,7,7,14,50.0%,1h
22209,1,EvilTerran,2794,190,7,7,14,50.0%,1h
22209,3,BlackFox,2794,182,6,8,14,42.9%,19m
22209,3,tonyj,2794,174,6,11,17,35.3%,8m
22209,1,dave,2794,0,4,1,5,80.0%,1h
22209,3,kordez,2794,88,4,5,9,44.4%,20m
22209,3,LoitneR,2794,116,4,7,11,36.4%,11m
22209,1,KikiOG,2794,145,3,2,5,60.0%,23m
22209,1,iamWARR,2794,30,3,3,6,50.0%,18m
22209,3,[3ЕRGTV]Vlad,2794,0,2,2,4,50.0%,10m
22209,3,DeAd,2794,58,2,6,8,25.0%,11m
22209,2,kradox,2794,0,1,0,1,100.0%,22m
22209,1,[SALKAN]SuperSheep,2794,44,1,1,2,50.0%,15m
22209,3,[oooboy]Blackshark,2794,30,1,5,6,16.7%,6m
22209,1,cos,2794,0,0,1,1,0.0%,1h
22209,1,Redwire,2794,0,0,1,1,0.0%,18m
22209,1,RpgFiftyNine,2794,0,0,1,1,0.0%,1h
22209,1,Rittaman,2794,0,0,2,2,0.0%,1h
22209,3,RoxD,2794,0,0,5,5,0.0%,4m
22244,2,[Funky]Titoune,2793,1549,155,151,306,50.7%,5m
22244,2,Dominion,2793,1555,153,143,296,51.7%,20m
22244,3,PeluZa,2793,1330,118,104,222,53.2%,8m
22244,3,[OJKSB]Kevin,2793,920,76,65,141,53.9%,16m
22244,2,[Pung]OSTRON,2793,1420,63,60,123,51.2%,22m
22244,2,badarty,2793,965,53,52,105,50.5%,11m
22244,3,Magician,2793,255,27,6,33,81.8%,10m
22244,3,Smveee,2793,485,19,19,38,50.0%,17m
22244,1,Moi,2793,542,16,12,28,57.1%,22m
22244,3,Sad,2793,354,15,12,27,55.6%,13m
22244,3,[TJA]HeKok,2793,397,15,13,28,53.6%,12m
22244,3,vShvartz,2793,297,14,17,31,45.2%,4m
22244,3,RANDOM,2793,309,12,7,19,63.2%,5m
22244,3,DNSoul,2793,217,9,9,18,50.0%,21m
22244,1,Elessar,2793,323,8,7,15,53.3%,1h
22244,3,Simas,2793,281,8,12,20,40.0%,11m
22244,3,Aklin,2793,105,7,9,16,43.8%,2m
22244,3,KpacyH,2793,182,6,2,8,75.0%,22m
22244,2,Crameg,2793,0,4,1,5,80.0%,21m
22244,1,[t0raSQ]NarkoMarine,2793,132,4,3,7,57.1%,20m
22244,2,CCA,2793,30,4,5,9,44.4%,17m
22244,1,[MJAUU]Srp,2793,0,3,1,4,75.0%,59m
22244,2,[LRXS]Aganna,2793,0,3,3,6,50.0%,1h
22244,1,[Sepuku]ruslan,2793,48,2,0,2,100.0%,9m
22244,1,hiroller,2793,80,2,1,3,66.7%,54m
22244,1,[JaPP]XachApuri,2793,40,2,1,3,66.7%,50m
22244,1,[RTT]LeSerbe,2793,46,2,4,6,33.3%,1h
22244,3,PinkiePie,2793,30,2,4,6,33.3%,1h
22244,3,Cnsbmkpsr,2793,120,2,5,7,28.6%,10m
22244,3,Wailreiz,2793,30,2,6,8,25.0%,21m
22244,2,Pentyshka,2793,95,1,1,2,50.0%,15m
22244,3,Newthinker,2793,0,1,1,2,50.0%,8m
22244,3,BAV,2793,0,1,2,3,33.3%,19m
22244,1,[ICCCPI]бмв,2793,0,0,1,1,0.0%,20m
22244,1,Hellscream,2793,0,0,1,1,0.0%,1h
22279,3,Клуд,2792,1528,219,199,418,52.4%,22m
22279,2,SazukeTakeo,2792,1351,166,143,309,53.7%,11m
22279,2,Rejoice,2792,1561,138,129,267,51.7%,22m
22279,3,Sicarius,2792,1531,119,124,243,49.0%,7m
22279,3,Wizzard,2792,1254,62,33,95,65.3%,16m
22279,3,[NANE]Ortsyd,2792,1226,59,56,115,51.3%,11m
22279,3,Svetoslav,2792,370,22,20,42,52.4%,20m
22279,3,[ALCAs]Troniak,2792,500,18,19,37,48.6%,14m
22279,3,[InvKit]SFoxner,2792,435,17,14,31,54.8%,3m
22279,3,Raven,2792,282,10,14,24,41.7%,6m
22279,2,Zion,2792,272,9,14,23,39.1%,17m
22279,1,Radagast,2792,206,5,2,7,71.4%,50m
22279,1,Ritho,2792,120,5,5,10,50.0%,16m
22279,1,AZAROTH,2792,96,5,6,11,45.5%,1h
22279,3,[Xa]Elgand,2792,113,5,7,12,41.7%,9m
22279,3,Loxley,2792,0,3,3,6,50.0%,15m
22279,1,Deer,2792,95,2,2,4,50.0%,15m
22279,3,ScottyBoom,2792,30,2,4,6,33.3%,7m
22279,3,[FMGF]FlorentinH,2792,30,2,4,6,33.3%,8m
22279,3,[lLiTl]DREDGE,2792,0,1,5,6,16.7%,18m
22279,1,[YMCAP]ViRUSAlexx,2792,0,0,1,1,0.0%,53m
22279,3,[MTTT]Pilsi,2792,0,0,3,3,0.0%,18m
22301,1,sanchoit,2791,1421,186,192,378,49.2%,22m
22301,2,tankgoboom,2791,1607,128,129,257,49.8%,10m
22301,1,[DBGS]JBronze,2791,1647,121,105,226,53.5%,1h
22301,2,Pierre,2791,1322,104,101,205,50.7%,12m
22301,3,[Mosaic]MosǂHybrid,2791,1190,77,71,148,52.0%,18m
22301,1,[GBCSC2]Maggy,2791,998,68,77,145,46.9%,12m
22301,3,Patrick,2791,1164,53,35,88,60.2%,19m
22301,3,BlueOcean,2791,1141,48,38,86,55.8%,7m
22301,1,patchencko,2791,1036,43,44,87,49.4%,2m
22301,2,Prometheus,2791,551,40,46,86,46.5%,8m
22301,3,Collaps,2791,935,35,37,72,48.6%,22m
22301,2,[22gg]Anthony,2791,904,31,38,69,44.9%,6m
22301,3,lyr,2791,522,20,19,39,51.3%,8m
22301,3,HrSpEgEpØlSe,2791,353,18,12,30,60.0%,10m
22301,1,RoyPydreel,2791,476,15,10,25,60.0%,5m
22301,3,FlashPoint,2791,240,10,8,18,55.6%,1h
22301,3,Mauer,2791,176,7,7,14,50.0%,3m
22301,1,Paradisum,2791,217,6,1,7,85.7%,4m
22301,2,Sathol,2791,96,5,2,7,71.4%,1h
22301,3,PiphPaph,2791,172,5,3,8,62.5%,10m
22301,3,CoolHand,2791,144,5,7,12,41.7%,20m
22301,3,Skitsystem,2791,114,4,7,11,36.4%,14m
22301,3,[voff]XpliT,2791,90,4,8,12,33.3%,13m
22301,2,superohm,2791,0,3,3,6,50.0%,60m
22301,3,[maximu]Player,2791,30,2,2,4,50.0%,18m
22301,3,Prokop,2791,30,2,2,4,50.0%,21m
22301,3,Dvoechka,2791,30,2,3,5,40.0%,10m
22301,1,Breakger,2791,40,2,4,6,33.3%,1h
22301,2,bebebe,2791,0,1,0,1,100.0%,12m
22301,1,[H0C]McBaine,2791,40,1,1,2,50.0%,1h
22301,3,Son,2791,0,1,2,3,33.3%,4m
22301,1,mangofarts,2791,96,1,2,3,33.3%,1h
22301,3,fudde,2791,0,1,3,4,25.0%,13m
22301,3,[JTRDs]StarGaté,2791,30,1,6,7,14.3%,10m
22301,1,[LiFe]Hronosa,2791,0,0,1,1,0.0%,58m
22301,3,[ESG1]LaPPis,2791,0,0,4,4,0.0%,13m
22337,2,CovidVava,2790,1251,258,259,517,49.9%,12m
22337,3,Percautus,2790,1413,132,131,263,50.2%,18m
22337,3,[ValidG]Kers,2790,796,88,85,173,50.9%,21m
22337,1,PusT,2790,1436,86,73,159,54.1%,1h
22337,1,marks,2790,1578,76,61,137,55.5%,12m
22337,1,Yosik,2790,1123,53,42,95,55.8%,24m
22337,3,Legendary,2790,562,41,30,71,57.7%,21m
22337,3,[SMID]MfkabSmid,2790,927,41,34,75,54.7%,9m
22337,1,Timurkin,2790,1103,39,30,69,56.5%,2m
22337,3,[Frntln]Mylor,2790,535,34,21,55,61.8%,14m
22337,3,Ripper,2790,562,29,23,52,55.8%,21m
22337,3,ViChed,2790,564,28,29,57,49.1%,19m
22337,3,ChudoSTaRiK,2790,492,19,15,34,55.9%,20m
22337,1,Саша,2790,418,18,11,29,62.1%,1h
22337,3,[Radium]DFG,2790,422,18,18,36,50.0%,22m
22337,2,Fantast,2790,488,18,24,42,42.9%,6m
22337,3,asd,2790,397,16,10,26,61.5%,5m
22337,3,NOVAYA,2790,307,15,9,24,62.5%,11m
22337,3,Excitle,2790,343,14,13,27,51.9%,20m
22337,1,DoCaCeBaL,2790,386,14,14,28,50.0%,59m
22337,3,DCater,2790,337,13,20,33,39.4%,6m
22337,3,Rexortom,2790,153,8,6,14,57.1%,13m
22337,3,finster,2790,224,8,7,15,53.3%,10m
22337,3,GhostDog,2790,206,8,8,16,50.0%,21m
22337,3,[LCT]PeyO,2790,266,8,12,20,40.0%,54m
22337,3,Lohmatuy,2790,232,8,14,22,36.4%,8m
22337,3,savonik,2790,212,7,6,13,53.8%,24m
22337,1,HydeShepard,2790,126,7,6,13,53.8%,5m
22337,1,Vystavkin,2790,215,6,3,9,66.7%,21m
22337,2,KCAnyoN,2790,152,4,1,5,80.0%,1h
22337,3,chaxva,2790,159,4,4,8,50.0%,21m
22337,3,Purpose,2790,109,3,3,6,50.0%,22m
22337,3,PRIMARCH,2790,0,3,3,6,50.0%,19m
22337,2,Abatur,2790,94,3,3,6,50.0%,1h
22337,2,wallball,2790,95,3,3,6,50.0%,50m
22337,1,Fedonator,2790,163,3,5,8,37.5%,1h
22337,3,[SmoooT]Helsing,2790,30,2,4,6,33.3%,12m
22337,3,Hawmed,2790,120,2,6,8,25.0%,14m
22337,1,SHIFTSPACEND,2790,0,1,0,1,100.0%,23m
22337,1,Prostrat,2790,0,1,0,1,100.0%,4m
22337,1,Laci,2790,42,1,1,2,50.0%,1h
22337,3,HAVEFAN,2790,0,1,4,5,20.0%,3m
22337,1,DimaH,2790,0,0,1,1,0.0%,23m
22337,1,GeniyEvgeniy,2790,0,0,1,1,0.0%,55m
22337,2,Aiur,2790,0,0,2,2,0.0%,1h
22382,2,Basenanji,2789,1616,120,117,237,50.6%,11m
22382,3,serjohnny,2789,1501,116,108,224,51.8%,22m
22382,2,[DoAII]Soulrazy,2789,1533,71,72,143,49.7%,18m
22382,2,synka,2789,1445,57,65,122,46.7%,15m
22382,3,EmilioZapata,2789,214,30,17,47,63.8%,21m
22382,3,MinDBlowN,2789,539,23,21,44,52.3%,11m
22382,2,TreantBG,2789,397,17,14,31,54.8%,17m
22382,1,[Vips]ErTorito,2789,426,17,17,34,50.0%,22m
22382,3,киберо,2789,241,8,7,15,53.3%,3m
22382,3,ReadySKP,2789,146,6,7,13,46.2%,18m
22382,1,[SUCMA]Zentren,2789,142,4,6,10,40.0%,14m
22382,2,[Sayron]димаста,2789,94,4,10,14,28.6%,8m
22382,3,Wawa,2789,118,3,6,9,33.3%,5m
22382,3,[SIPAIR]AndreyG,2789,30,2,2,4,50.0%,10m
22382,2,teddybear,2789,60,2,9,11,18.2%,18m
22382,1,Dittu,2789,0,1,1,2,50.0%,1h
22382,3,JAXX,2789,0,1,2,3,33.3%,10m
22382,3,[LURS]Zvenne,2789,30,1,4,5,20.0%,21m
22382,2,IsaacClarke,2789,0,0,1,1,0.0%,19m
22382,3,[Regnum]Senaattori,2789,0,0,4,4,0.0%,17m
22402,3,qwer,2788,1513,151,145,296,51.0%,4m
22402,2,Jazi,2788,1513,129,127,256,50.4%,16m
22402,3,skriinx,2788,818,61,51,112,54.5%,3m
22402,3,Hecc,2788,873,44,40,84,52.4%,17m
22402,3,Gorzym,2788,704,44,46,90,48.9%,11m
22402,3,gys,2788,684,27,24,51,52.9%,3m
22402,1,RTSAxo,2788,720,22,39,61,36.1%,11m
22402,3,LOBODEMAR,2788,434,17,12,29,58.6%,5m
22402,3,[AciNoN]Makentai,2788,260,9,14,23,39.1%,10m
22402,1,Darklight,2788,227,7,2,9,77.8%,1h
22402,3,Maxlin,2788,217,7,4,11,63.6%,1h
22402,3,Akamii,2788,176,6,9,15,40.0%,19m
22402,3,Wahrwolf,2788,184,5,5,10,50.0%,18m
22402,3,oma,2788,88,4,3,7,57.1%,11m
22402,3,GopStop,2788,88,4,4,8,50.0%,20m
22402,3,[CS1rus]Quasar,2788,118,4,7,11,36.4%,8m
22402,2,[PepeGs]HeDGeHoG,2788,0,3,3,6,50.0%,59m
22402,3,TrueSilver,2788,0,3,3,6,50.0%,4m
22402,1,Spitfire,2788,42,2,0,2,100.0%,1h
22402,3,Oliver,2788,93,2,1,3,66.7%,5m
22402,3,[PÂRłAH]VLKadlok,2788,0,2,2,4,50.0%,8m
22402,3,LSG,2788,0,1,0,1,100.0%,17m
22402,3,[ZHxPro]Kadoo,2788,30,1,3,4,25.0%,22m
22402,1,[iMiTV1]TohkaYatogam,2788,0,1,4,5,20.0%,8m
22402,3,Nize,2788,0,1,4,5,20.0%,3m
22402,3,zamor,2788,30,1,6,7,14.3%,12m
22402,1,gset,2788,0,0,1,1,0.0%,8m
22402,3,Basis,2788,0,0,3,3,0.0%,22m
22402,2,[BRACIF]Alex,2788,0,0,8,8,0.0%,23m
22431,2,Mati,2787,1559,466,448,914,51.0%,22m
22431,3,ThaRgoiD,2787,1325,127,133,260,48.8%,10m
22431,2,[CxCx]DrMarauder,2787,1554,104,104,208,50.0%,9m
22431,1,Max,2787,1506,94,92,186,50.5%,11m
22431,2,[bullD]Mishka,2787,1588,83,89,172,48.3%,11m
22431,3,bysiu,2787,1547,69,59,128,53.9%,4m
22431,3,Oldrich,2787,1006,56,46,102,54.9%,20m
22431,2,Xander,2787,608,23,24,47,48.9%,6m
22431,3,Maks,2787,506,21,18,39,53.8%,18m
22431,2,DrForex,2787,404,16,14,30,53.3%,12m
22431,3,Basurmanin,2787,292,10,8,18,55.6%,9m
22431,3,[HpT]termosCZ,2787,258,8,9,17,47.1%,17m
22431,1,Cheriss,2787,167,6,3,9,66.7%,54m
22431,2,Tarjuen,2787,135,6,5,11,54.5%,7m
22431,1,Terran,2787,122,5,5,10,50.0%,10m
22431,1,terZERprot,2787,144,3,1,4,75.0%,15m
22431,3,venox,2787,113,3,2,5,60.0%,15m
22431,3,Alexandr,2787,0,3,2,5,60.0%,12m
22431,3,maaaks,2787,60,3,3,6,50.0%,3m
22431,3,INFerno,2787,30,1,5,6,16.7%,22m
22431,1,[HDSC]Akterb,2787,0,0,1,1,0.0%,1h
22431,3,Zechevic,2787,0,0,2,2,0.0%,3m
22431,3,Baskervile,2787,0,0,2,2,0.0%,18m
22454,3,Creepuxx,2786,1550,137,106,243,56.4%,15m
22454,3,slem,2786,1256,112,108,220,50.9%,19m
22454,2,JonhyBleez,2786,1098,71,73,144,49.3%,11m
22454,3,Odium,2786,965,44,31,75,58.7%,10m
22454,3,Darkendoom,2786,988,41,41,82,50.0%,4m
22454,3,Goralden,2786,277,36,34,70,51.4%,19m
22454,3,SamsamFRANCE,2786,709,28,24,52,53.8%,5m
22454,3,anders,2786,461,21,12,33,63.6%,21m
22454,3,[теран]Древолаз,2786,394,18,13,31,58.1%,23m
22454,3,[shoot]Meteora,2786,377,15,16,31,48.4%,11m
22454,3,[RBlood]IkuriO,2786,359,13,10,23,56.5%,17m
22454,3,Strel,2786,344,13,18,31,41.9%,10m
22454,2,CapitanDroch,2786,148,12,11,23,52.2%,9m
22454,3,SHYTBIRD,2786,370,12,14,26,46.2%,8m
22454,3,[Dоbrо]AgentOF,2786,258,9,5,14,64.3%,1h
22454,1,Gades,2786,235,7,3,10,70.0%,1h
22454,3,[FLOTOZ]TopFivHotKys,2786,146,6,7,13,46.2%,4m
22454,2,JonStolt,2786,137,5,4,9,55.6%,12m
22454,3,kolka,2786,118,5,9,14,35.7%,4m
22454,2,yare,2786,0,3,3,6,50.0%,1h
22454,2,Kvapinson,2786,0,3,4,7,42.9%,12m
22454,1,Obilon,2786,0,3,4,7,42.9%,22m
22454,3,[Arrows]AID,2786,60,3,6,9,33.3%,8m
22454,3,Paradox,2786,0,1,2,3,33.3%,8m
22454,2,Reistry,2786,0,1,5,6,16.7%,14m
22454,1,WishUsh,2786,0,0,1,1,0.0%,20m
22454,1,[19OW22]Seweryn,2786,0,0,1,1,0.0%,1h
22454,2,Cherkes,2786,0,0,1,1,0.0%,15m
22482,3,Nottorius,2785,1417,198,196,394,50.3%,21m
22482,3,Tomás,2785,1557,128,129,257,49.8%,8m
22482,3,mkmk,2785,1584,123,117,240,51.2%,8m
22482,3,Electronaut,2785,959,82,60,142,57.7%,21m
22482,3,Balthazor,2785,1471,65,59,124,52.4%,19m
22482,2,JollyRoger,2785,468,55,62,117,47.0%,15m
22482,3,TofuAndBeans,2785,433,33,26,59,55.9%,21m
22482,2,Mentalist,2785,505,21,24,45,46.7%,21m
22482,3,Dimon,2785,224,8,5,13,61.5%,16m
22482,3,Benzin,2785,151,7,6,13,53.8%,1h
22482,3,KingOfNoob,2785,190,6,4,10,60.0%,16m
22482,2,[DoVV]AndEaD,2785,137,4,3,7,57.1%,1h
22482,3,RXX,2785,118,4,6,10,40.0%,18m
22482,3,[RPro]HAV,2785,58,3,3,6,50.0%,22m
22482,3,[mznx]ŚniadySmok,2785,0,3,3,6,50.0%,17m
22482,1,Cosmyn,2785,97,2,0,2,100.0%,8m
22482,3,Ramzas,2785,30,1,6,7,14.3%,22m
22482,1,[QLSS]DevoltN,2785,0,0,1,1,0.0%,20m
22482,3,McBride,2785,0,0,2,2,0.0%,13m
22482,3,Andrey,2785,0,0,3,3,0.0%,12m
22502,1,DRY,2784,1577,298,290,588,50.7%,22m
22502,3,Henrog,2784,1537,160,157,317,50.5%,24m
22502,2,Boecskota,2784,1377,144,142,286,50.3%,8m
22502,3,Aliken,2784,1218,63,63,126,50.0%,22m
22502,3,Funess,2784,547,56,32,88,63.6%,21m
22502,3,EsconsKam,2784,557,52,51,103,50.5%,19m
22502,3,[Seek]martin,2784,615,26,23,49,53.1%,17m
22502,1,Kazz,2784,617,25,13,38,65.8%,4m
22502,1,KPZ,2784,671,21,15,36,58.3%,21m
22502,2,Кайф,2784,561,21,28,49,42.9%,17m
22502,3,OmaeWaMou,2784,453,19,16,35,54.3%,10m
22502,3,InLove,2784,510,19,24,43,44.2%,16m
22502,1,Kaimera,2784,391,14,11,25,56.0%,53m
22502,2,Twijet,2784,388,14,19,33,42.4%,9m
22502,3,[BIEDA]duudley,2784,289,11,9,20,55.0%,51m
22502,1,nelumbo,2784,167,6,4,10,60.0%,20m
22502,3,BANANCZE,2784,200,6,5,11,54.5%,4m
22502,1,[SBV]Athtors,2784,95,5,2,7,71.4%,1h
22502,1,Hoho,2784,0,3,2,5,60.0%,4m
22502,2,juggernaut,2784,46,3,3,6,50.0%,25m
22502,1,[TǂH]kebra,2784,0,3,4,7,42.9%,1h
22502,1,IrelAzul,2784,122,2,3,5,40.0%,60m
22502,1,[0001]Bredator,2784,0,2,3,5,40.0%,59m
22502,3,Abathur,2784,120,2,3,5,40.0%,22m
22502,1,[0ff]HighContrast,2784,70,2,3,5,40.0%,1h
22502,3,[PLA2N]NelrOp,2784,60,2,4,6,33.3%,20m
22502,1,Powerfool,2784,0,1,0,1,100.0%,57m
22502,1,ZeroCool,2784,0,0,1,1,0.0%,1h
22502,1,[FHANU]Avokk,2784,0,0,1,1,0.0%,22m
22502,3,[QTclub]TriumphR,2784,0,0,2,2,0.0%,20m
22502,3,HATO,2784,0,0,5,5,0.0%,53m
22533,3,Razvanov,2783,1566,190,179,369,51.5%,4m
22533,3,ElTuzo,2783,1310,105,106,211,49.8%,8m
22533,3,StrAlex,2783,1545,96,89,185,51.9%,18m
22533,2,aston,2783,1484,81,79,160,50.6%,15m
22533,3,Malis,2783,1510,70,64,134,52.2%,11m
22533,2,DartVader,2783,1338,53,47,100,53.0%,6m
22533,3,[KEITH]Eikothan,2783,1292,47,51,98,48.0%,17m
22533,2,Erratic,2783,819,33,29,62,53.2%,3m
22533,3,spookzr,2783,262,25,15,40,62.5%,13m
22533,3,[ULTX]Orgismenos,2783,659,24,22,46,52.2%,11m
22533,3,zlzsheep,2783,549,22,23,45,48.9%,13m
22533,2,IngAngelo,2783,502,21,17,38,55.3%,9m
22533,3,xiozone,2783,423,17,20,37,45.9%,11m
22533,2,ЦиклоНяша,2783,422,16,7,23,69.6%,58m
22533,3,TeranoZavr,2783,283,10,8,18,55.6%,4m
22533,3,PooHolePirat,2783,239,9,11,20,45.0%,15m
22533,2,BadVadim,2783,224,8,16,24,33.3%,21m
22533,2,Gzimka,2783,30,5,4,9,55.6%,3m
22533,3,biig,2783,0,4,1,5,80.0%,1h
22533,3,[TDA]Zeratul,2783,174,4,5,9,44.4%,19m
22533,3,[M4574]dissipleduco,2783,0,3,3,6,50.0%,19m
22533,2,CrossStroke,2783,114,3,3,6,50.0%,1h
22533,1,Hen,2783,36,3,3,6,50.0%,21m
22533,1,fromTheStars,2783,80,2,1,3,66.7%,21m
22533,1,[javra]Angelo,2783,84,2,2,4,50.0%,11m
22533,1,lemon,2783,0,1,0,1,100.0%,23m
22533,2,Xyen,2783,0,1,1,2,50.0%,1h
22533,1,БабаБулочник,2783,0,0,1,1,0.0%,9m
22533,1,Flo,2783,0,0,1,1,0.0%,1h
22533,3,dexter,2783,0,0,2,2,0.0%,18m
22533,3,[wedown]SeppiaPigra,2783,0,0,2,2,0.0%,21m
22564,1,MarcoPolo,2782,1568,174,177,351,49.6%,5m
22564,1,robert,2782,1295,60,44,104,57.7%,8m
22564,1,[Taro]HastyLion,2782,1261,59,48,107,55.1%,1h
22564,3,SOLARIS,2782,1008,47,30,77,61.0%,12m
22564,3,LImE,2782,912,40,32,72,55.6%,14m
22564,3,WalterWhite,2782,806,30,29,59,50.8%,13m
22564,1,SPIRT,2782,738,25,17,42,59.5%,58m
22564,3,[WooD]KillEmAll,2782,559,25,25,50,50.0%,10m
22564,2,XENON,2782,452,23,31,54,42.6%,12m
22564,2,donkeyshot,2782,537,21,27,48,43.8%,8m
22564,3,milllka,2782,506,19,16,35,54.3%,19m
22564,3,[ZERGТV]FanVof,2782,409,18,15,33,54.5%,4m
22564,3,[ERIC]Shoes,2782,192,13,13,26,50.0%,22m
22564,3,ArtModz,2782,293,10,8,18,55.6%,25m
22564,2,ilusha,2782,301,10,13,23,43.5%,1h
22564,1,toothpick,2782,284,9,2,11,81.8%,1h
22564,3,VeTerran,2782,215,8,6,14,57.1%,20m
22564,3,Emmet,2782,148,6,7,13,46.2%,21m
22564,3,JeReX,2782,157,5,3,8,62.5%,7m
22564,3,Lauerto,2782,133,4,1,5,80.0%,7m
22564,1,[EGGGZ]Rian,2782,150,4,2,6,66.7%,21m
22564,1,[L2CC2E]nervgehring,2782,129,4,4,8,50.0%,1h
22564,1,[A1E]BinGe,2782,190,4,7,11,36.4%,25m
22564,1,HellStorm,2782,94,3,3,6,50.0%,16m
22564,2,Cafkadd,2782,0,3,3,6,50.0%,19m
22564,3,Oups,2782,134,3,4,7,42.9%,21m
22564,2,[HiR]Erath,2782,92,3,11,14,21.4%,6m
22564,3,[6ix]ExTikxX,2782,30,2,2,4,50.0%,7m
22564,1,Delta,2782,80,2,2,4,50.0%,20m
22564,3,MuPoBou,2782,30,2,4,6,33.3%,22m
22564,2,[SwaV]Leon,2782,58,2,11,13,15.4%,16m
22564,1,Patton,2782,0,0,1,1,0.0%,12m
22564,2,Сергей,2782,0,0,2,2,0.0%,1h
22597,2,var,2781,1539,91,93,184,49.5%,22m
22597,1,[PdGI]YoSh,2781,1391,86,73,159,54.1%,60m
22597,1,DrManhattan,2781,1625,60,55,115,52.2%,4m
22597,1,SnikerSnikS,2781,916,36,25,61,59.0%,50m
22597,1,Matu,2781,470,20,22,42,47.6%,22m
22597,2,Till,2781,551,20,23,43,46.5%,16m
22597,3,Gago,2781,428,15,18,33,45.5%,21m
22597,3,RangersStar,2781,372,14,16,30,46.7%,4m
22597,2,Maskiron,2781,154,8,6,14,57.1%,8m
22597,1,lel,2781,208,5,5,10,50.0%,23m
22597,3,Vallar,2781,88,4,7,11,36.4%,16m
22597,2,Ray,2781,124,3,3,6,50.0%,9m
22597,3,Froze,2781,94,2,1,3,66.7%,20m
22597,3,[lWHl]maxianno,2781,94,2,1,3,66.7%,9m
22597,1,Balook,2781,96,2,2,4,50.0%,1h
22597,1,[NotSQK]Vadick,2781,0,2,3,5,40.0%,1h
22597,3,[NOT1ME]soragons,2781,60,2,4,6,33.3%,17m
22597,3,[Mądry]Goldimaksvel,2781,60,2,5,7,28.6%,17m
22597,3,[BirdC]FeatherP,2781,0,1,0,1,100.0%,3m
22597,1,Печенька,2781,0,1,0,1,100.0%,21m
22597,1,боб,2781,0,1,0,1,100.0%,17m
22597,1,Belanya,2781,0,1,0,1,100.0%,1h
22597,2,[PLH]Baba,2781,0,0,1,1,0.0%,53m
22597,1,Tatzuya,2781,0,0,1,1,0.0%,6m
22597,1,[LCRF]bedsam,2781,0,0,1,1,0.0%,21m
22597,1,[MSUSC2]Tekorukite,2781,0,0,1,1,0.0%,2m
22597,1,[Izevsk]MountainMstr,2781,0,0,1,1,0.0%,21m
22597,3,nod,2781,0,0,2,2,0.0%,3m
22597,3,Fryster,2781,0,0,2,2,0.0%,8m
22597,3,[FNCD]DenzelKramer,2781,0,0,2,2,0.0%,16m
22597,3,[AXAIOI]AntiSocial,2781,0,0,3,3,0.0%,10m
22628,3,marcelo,2780,1590,661,655,1316,50.2%,10m
22628,3,gwendos,2780,1560,138,131,269,51.3%,3m
22628,3,Swrd,2780,1296,57,40,97,58.8%,16m
22628,3,luk,2780,1020,47,47,94,50.0%,9m
22628,3,Mica,2780,1169,46,45,91,50.5%,6m
22628,3,DVN,2780,1051,40,44,84,47.6%,17m
22628,1,SoRrY,2780,608,26,15,41,63.4%,53m
22628,3,ApexPredator,2780,145,25,11,36,69.4%,6m
22628,3,[jfcs]jules,2780,708,25,30,55,45.5%,20m
22628,2,Barnaky,2780,572,20,27,47,42.6%,7m
22628,3,GlassMoon,2780,470,16,17,33,48.5%,4m
22628,3,RaGe,2780,335,15,14,29,51.7%,19m
22628,1,[Витязи]Akbar,2780,272,10,6,16,62.5%,23m
22628,3,Parliament,2780,211,6,5,11,54.5%,59m
22628,1,Noobone,2780,220,5,1,6,83.3%,1h
22628,3,Überninja,2780,167,5,2,7,71.4%,22m
22628,1,[mfxed]Bananito,2780,0,4,1,5,80.0%,59m
22628,1,TripleRainbo,2780,73,4,5,9,44.4%,1h
22628,3,[vlast]mARIO,2780,60,3,3,6,50.0%,10m
22628,3,Teo,2780,0,3,3,6,50.0%,20m
22628,3,[SRoB]Gefest,2780,145,3,4,7,42.9%,17m
22628,1,TMay,2780,40,2,1,3,66.7%,1h
22628,1,[tVal]OctoValkyrie,2780,70,2,1,3,66.7%,50m
22628,3,Kirito,2780,58,2,5,7,28.6%,13m
22628,1,iluminati,2780,0,1,0,1,100.0%,60m
22628,1,[BYOS]CurlyBaboon,2780,0,1,1,2,50.0%,1h
22628,3,Dova,2780,0,1,1,2,50.0%,1h
22628,3,КрэйзиКот,2780,0,1,1,2,50.0%,8m
22628,3,MaXimum,2780,0,1,2,3,33.3%,57m
22628,1,dabo,2780,32,1,2,3,33.3%,1h
22628,2,Viak,2780,0,1,6,7,14.3%,21m
22628,1,[DCO]Moul,2780,0,0,1,1,0.0%,8m
22628,1,Meuzel,2780,0,0,1,1,0.0%,25m
22628,1,Fireballl,2780,0,0,1,1,0.0%,60m
22628,1,DofBanner,2780,0,0,3,3,0.0%,24m
22628,1,reynor,2780,0,0,3,3,0.0%,14m
22664,3,Otacon,2779,1566,111,99,210,52.9%,5m
22664,2,SkeletonCrew,2779,1369,108,106,214,50.5%,13m
22664,3,Jerome,2779,1129,73,69,142,51.4%,4m
22664,1,Luna,2779,851,68,53,121,56.2%,1h
22664,1,[Mavis]FireStarter,2779,1506,66,79,145,45.5%,14m
22664,3,[AFL]Murphy,2779,1151,51,44,95,53.7%,20m
22664,3,Curbitec,2779,691,48,50,98,49.0%,22m
22664,2,TOMAZI,2779,661,27,24,51,52.9%,18m
22664,2,elittho,2779,573,21,25,46,45.7%,9m
22664,1,Sverok,2779,335,11,14,25,44.0%,22m
22664,1,SnenzBaer,2779,279,8,8,16,50.0%,23m
22664,3,PixelTrooper,2779,142,6,6,12,50.0%,8m
22664,1,whxBrother,2779,171,5,1,6,83.3%,1h
22664,2,Singline,2779,154,5,2,7,71.4%,1h
22664,3,[FIHDVI]Krakataua,2779,121,5,3,8,62.5%,10m
22664,1,[Iria]TonnoVeloce,2779,169,5,3,8,62.5%,21m
22664,3,[tinmug]THCman,2779,118,5,4,9,55.6%,21m
22664,2,staticvoid,2779,164,5,4,9,55.6%,22m
22664,3,dezganchik,2779,0,4,2,6,66.7%,24m
22664,2,Xgen,2779,117,4,4,8,50.0%,50m
22664,2,Saoky,2779,144,4,6,10,40.0%,7m
22664,3,ZackmcHack,2779,147,4,6,10,40.0%,1h
22664,1,[Genoße]Officer,2779,80,3,0,3,100.0%,4m
22664,1,dio,2779,80,3,0,3,100.0%,1h
22664,2,Tvorobushek,2779,0,3,3,6,50.0%,16m
22664,3,AoGGloRy,2779,0,3,3,6,50.0%,17m
22664,2,BUCEFAL,2779,115,3,4,7,42.9%,19m
22664,3,Arcail,2779,60,3,4,7,42.9%,21m
22664,2,Broadhurst,2779,0,3,4,7,42.9%,19m
22664,2,SKip,2779,0,2,2,4,50.0%,60m
22664,2,Spacejunk,2779,0,1,0,1,100.0%,1h
22664,1,[TFSC]Fakeen,2779,40,1,1,2,50.0%,1h
22664,3,seagull,2779,0,1,1,2,50.0%,19m
22664,1,Manuel,2779,0,0,2,2,0.0%,11m
22698,2,edd,2778,1596,196,177,373,52.5%,13m
22698,1,[HQ31er]kottero,2778,1648,82,98,180,45.6%,19m
22698,1,zougoulou,2778,943,56,47,103,54.4%,1h
22698,2,SkOrM,2778,1294,52,49,101,51.5%,19m
22698,3,Sparky,2778,1201,51,43,94,54.3%,12m
22698,3,YKV,2778,714,26,26,52,50.0%,13m
22698,3,Kvothe,2778,289,19,14,33,57.6%,13m
22698,3,DNO,2778,520,19,26,45,42.2%,22m
22698,3,Jevelin,2778,496,18,15,33,54.5%,12m
22698,1,[BSG19]Carmine,2778,432,16,5,21,76.2%,56m
22698,2,Shugara,2778,357,13,16,29,44.8%,6m
22698,3,TheIcePrince,2778,243,12,11,23,52.2%,14m
22698,1,galaahuukhan,2778,357,10,8,18,55.6%,3m
22698,3,SandwichLord,2778,243,10,9,19,52.6%,17m
22698,3,Ivan,2778,230,9,9,18,50.0%,17m
22698,2,FrönchyFröy,2778,223,8,3,11,72.7%,1h
22698,3,[MDEv8]XxMARIOxX,2778,233,8,6,14,57.1%,18m
22698,2,[KåKåK]Katane,2778,223,8,12,20,40.0%,15m
22698,3,Fragik,2778,224,8,12,20,40.0%,10m
22698,1,Reaper,2778,210,7,4,11,63.6%,1h
22698,3,[PIKMN]UnPrisoned,2778,162,5,3,8,62.5%,18m
22698,2,Gaius,2778,160,5,15,20,25.0%,5m
22698,1,[NULOSS]darkside,2778,0,4,1,5,80.0%,58m
22698,1,[DÖRKH]StevenDerLUL,2778,152,4,3,7,57.1%,1h
22698,2,Zergolot,2778,46,4,4,8,50.0%,1h
22698,1,Jonsoload,2778,90,3,3,6,50.0%,60m
22698,3,Mitchellson,2778,62,3,5,8,37.5%,4m
22698,3,Lio,2778,60,2,5,7,28.6%,4m
22698,1,Moscow,2778,0,1,0,1,100.0%,1h
22698,1,sweetfood,2778,0,1,0,1,100.0%,25m
22698,3,Silomad,2778,30,1,9,10,10.0%,22m
22698,2,[SHT]Elvis,2778,0,0,1,1,0.0%,9m
22698,1,[OPFAR]Leviathan,2778,0,0,1,1,0.0%,1h
22698,1,killer,2778,0,0,1,1,0.0%,60m
22698,1,Mirkonia,2778,0,0,1,1,0.0%,1h
22698,3,DreAmZyY,2778,0,0,5,5,0.0%,6m
22734,3,HolodH,2777,1358,229,230,459,49.9%,11m
22734,2,RickiSpanish,2777,1591,228,233,461,49.5%,8m
22734,3,Smiler,2777,1140,72,61,133,54.1%,7m
22734,3,PAJAI,2777,1561,72,65,137,52.6%,12m
22734,3,Morroz,2777,1554,59,62,121,48.8%,3m
22734,2,[TheDOH]Moonkid,2777,1324,53,52,105,50.5%,18m
22734,3,DGENERATIONX,2777,491,42,20,62,67.7%,6m
22734,3,hank,2777,793,39,44,83,47.0%,22m
22734,2,templier,2777,767,35,26,61,57.4%,15m
22734,3,herak,2777,309,31,26,57,54.4%,21m
22734,2,[NLTN]жека,2777,816,29,33,62,46.8%,5m
22734,3,Gelikarnas,2777,213,28,30,58,48.3%,11m
22734,1,[ASNII]Cohanes,2777,620,19,36,55,34.5%,24m
22734,2,[Cebola]elementlight,2777,311,14,15,29,48.3%,8m
22734,3,CAva,2777,305,14,18,32,43.8%,10m
22734,2,maZya,2777,340,13,5,18,72.2%,1h
22734,3,deeew,2777,305,12,13,25,48.0%,9m
22734,3,Tituux,2777,264,11,9,20,55.0%,18m
22734,1,Stinger,2777,343,11,10,21,52.4%,1h
22734,3,Mattdamon,2777,260,10,12,22,45.5%,17m
22734,1,tim,2777,159,7,2,9,77.8%,1h
22734,2,[BiFeld]Hawkswings,2777,208,6,12,18,33.3%,21m
22734,1,Fenix,2777,155,5,2,7,71.4%,1h
22734,2,Flambix,2777,202,5,10,15,33.3%,1h
22734,1,[LGKBH]Khalodis,2777,108,4,2,6,66.7%,1h
22734,3,[PKTS]heizi,2777,170,4,3,7,57.1%,24m
22734,3,[Splend]Lathron,2777,165,4,4,8,50.0%,18m
22734,2,Egirl,2777,140,4,4,8,50.0%,1h
22734,2,bobwah,2777,94,3,3,6,50.0%,59m
22734,2,КольоКътмата,2777,0,3,3,6,50.0%,51m
22734,1,Rainir,2777,0,3,4,7,42.9%,1h
22734,3,[AralHQ]Hage,2777,94,2,1,3,66.7%,24m
22734,3,SCV,2777,94,2,2,4,50.0%,12m
22734,1,[Ape]FlexxxOr,2777,96,1,1,2,50.0%,16m
22734,1,[MaZ]AnT,2777,0,1,1,2,50.0%,4m
22734,1,[Uttrig]Hoef,2777,0,1,1,2,50.0%,1h
22734,3,StarChief,2777,0,1,2,3,33.3%,16m
22734,3,bodryachock,2777,30,1,4,5,20.0%,17m
22772,1,Vertiloo,2776,1496,274,261,535,51.2%,4m
22772,3,ASHOT,2776,1555,91,76,167,54.5%,16m
22772,3,Chalien,2776,1356,63,47,110,57.3%,4m
22772,1,PrFate,2776,959,60,44,104,57.7%,24m
22772,3,[PККA]ILYA,2776,1084,43,42,85,50.6%,22m
22772,3,Woody,2776,1002,40,39,79,50.6%,20m
22772,1,Whitenova,2776,862,36,22,58,62.1%,4m
22772,3,TonyStark,2776,228,32,16,48,66.7%,18m
22772,2,[MaxRax]NMedivax,2776,502,23,29,52,44.2%,23m
22772,1,MiniMaus,2776,260,21,21,42,50.0%,21m
22772,1,supertim,2776,416,17,19,36,47.2%,8m
22772,3,Unicellular,2776,347,16,6,22,72.7%,3m
22772,1,[CFeS]MilAgro,2776,422,16,8,24,66.7%,25m
22772,3,JimRakete,2776,396,13,15,28,46.4%,8m
22772,3,samtec,2776,360,13,17,30,43.3%,11m
22772,2,[Meyers]ELAKEDUCK,2776,142,8,9,17,47.1%,16m
22772,3,[10110]Bab,2776,289,8,14,22,36.4%,8m
22772,3,Pallada,2776,142,7,6,13,53.8%,20m
22772,3,llRYOll,2776,184,6,4,10,60.0%,4m
22772,1,juno,2776,181,6,5,11,54.5%,18m
22772,1,Sykai,2776,144,6,7,13,46.2%,59m
22772,3,[x313x]moi,2776,135,5,3,8,62.5%,21m
22772,1,[Cykabl]CarM,2776,156,5,4,9,55.6%,8m
22772,1,stardouf,2776,117,4,6,10,40.0%,14m
22772,1,Shift,2776,78,3,1,4,75.0%,4m
22772,2,BMC,2776,0,3,3,6,50.0%,56m
22772,2,Kevin,2776,115,3,6,9,33.3%,1h
22772,1,[OpSun]mAdmAze,2776,38,2,1,3,66.7%,58m
22772,1,Drews,2776,0,2,3,5,40.0%,1h
22772,1,Frozened,2776,0,0,1,1,0.0%,57m
22772,1,Mars,2776,0,0,1,1,0.0%,1h
22772,2,KingLammbi,2776,0,0,1,1,0.0%,1h
22772,3,[uloser]Egich,2776,0,0,3,3,0.0%,15m
22805,3,[RQ]glorymaker,2775,1506,130,128,258,50.4%,11m
22805,2,InqFridRU,2775,1349,61,60,121,50.4%,16m
22805,1,Thunder,2775,1232,49,52,101,48.5%,8m
22805,3,кротя,2775,495,44,36,80,55.0%,14m
22805,2,Waagheur,2775,418,16,20,36,44.4%,19m
22805,3,Zorro,2775,407,15,16,31,48.4%,11m
22805,3,[AciNoN]SaD,2775,288,14,7,21,66.7%,19m
22805,1,Bubl,2775,276,11,9,20,55.0%,18m
22805,3,TRIBUNAL,2775,324,11,13,24,45.8%,4m
22805,2,WranglerBG,2775,285,11,13,24,45.8%,14m
22805,1,MSPaint,2775,276,9,7,16,56.2%,4m
22805,1,BadGrandpa,2775,118,4,0,4,100.0%,1h
22805,1,[AHill]Wanze,2775,158,4,3,7,57.1%,1h
22805,3,kidwyw,2775,105,4,3,7,57.1%,6m
22805,3,[IndyK]KaaPII,2775,115,3,2,5,60.0%,14m
22805,1,Caín,2775,164,3,2,5,60.0%,1h
22805,2,[OFRO]Punishment,2775,0,3,4,7,42.9%,21m
22805,1,OkamiOz,2775,40,2,0,2,100.0%,15m
22805,1,[Nyde]Loke,2775,44,2,1,3,66.7%,16m
22805,1,shØut,2775,42,2,1,3,66.7%,1h
22805,3,Atalol,2775,0,2,3,5,40.0%,50m
22805,3,muscleTIM,2775,30,2,3,5,40.0%,8m
22805,1,max,2775,0,1,0,1,100.0%,1h
22805,1,[CHUJE]ORZEL,2775,0,1,0,1,100.0%,4m
22805,1,[ProZe]Phobos,2775,34,1,2,3,33.3%,1h
22805,2,Tham,2775,0,0,1,1,0.0%,7m
22805,1,russiaaa,2775,0,0,1,1,0.0%,4m
22805,2,PIKIPOKU,2775,0,0,4,4,0.0%,19m
22833,3,Gorik,2774,1504,103,106,209,49.3%,3m
22833,3,Adeich,2774,1226,67,67,134,50.0%,17m
22833,2,BigLebowski,2774,1275,53,53,106,50.0%,11m
22833,1,electrospeed,2774,928,42,25,67,62.7%,57m
22833,1,Malac,2774,914,38,28,66,57.6%,21m
22833,2,westo,2774,636,23,31,54,42.6%,11m
22833,3,czak,2774,469,19,19,38,50.0%,10m
22833,2,fAtbOyNooB,2774,142,19,24,43,44.2%,7m
22833,1,Minder,2774,416,14,6,20,70.0%,58m
22833,3,DujekOnearm,2774,324,12,12,24,50.0%,19m
22833,3,StarLord,2774,286,11,11,22,50.0%,2m
22833,2,Defeat,2774,246,10,11,21,47.6%,1h
22833,1,nico,2774,116,8,8,16,50.0%,9m
22833,3,Pepe,2774,174,6,10,16,37.5%,18m
22833,3,buzz,2774,122,4,8,12,33.3%,17m
22833,1,Mauzi,2774,0,3,2,5,60.0%,57m
22833,2,Freanki,2774,186,3,3,6,50.0%,1h
22833,3,Fluxation,2774,30,3,5,8,37.5%,13m
22833,3,tiger,2774,57,3,6,9,33.3%,3m
22833,1,vaprol,2774,42,2,0,2,100.0%,1h
22833,2,LuckyOwl,2774,58,2,11,13,15.4%,7m
22833,1,Ladord,2774,0,1,0,1,100.0%,14m
22833,1,Dayshark,2774,0,0,1,1,0.0%,18m
22833,2,Shelby,2774,0,0,2,2,0.0%,1h
22857,2,StarChild,2773,1555,317,319,636,49.8%,21m
22857,3,Flanker,2773,1448,254,224,478,53.1%,24m
22857,3,sett,2773,1420,234,231,465,50.3%,20m
22857,3,ICE,2773,1487,163,154,317,51.4%,18m
22857,3,Patrik,2773,1545,155,150,305,50.8%,21m
22857,2,SphInX,2773,1457,73,71,144,50.7%,16m
22857,3,[NWGD]Marcel,2773,716,47,39,86,54.7%,22m
22857,2,[UF2AC]Naryto,2773,987,43,52,95,45.3%,13m
22857,3,Ojama,2773,666,28,29,57,49.1%,22m
22857,3,DaSwarm,2773,490,21,14,35,60.0%,3m
22857,3,MrBig,2773,342,12,11,23,52.2%,21m
22857,2,Insomnia,2773,244,11,11,22,50.0%,13m
22857,3,vano,2773,275,9,8,17,52.9%,5m
22857,1,IIIIIIIIIIII,2773,259,8,8,16,50.0%,24m
22857,1,electrick,2773,48,6,3,9,66.7%,3m
22857,1,[Bald]Mamouth,2773,233,6,9,15,40.0%,6m
22857,3,noname,2773,156,6,12,18,33.3%,13m
22857,3,[HeMK]ÁnKH,2773,163,4,4,8,50.0%,2m
22857,2,[S8D]MFaith,2773,114,4,16,20,20.0%,11m
22857,2,ПапаКарло,2773,0,3,3,6,50.0%,1h
22857,3,Magaruis,2773,30,2,2,4,50.0%,20m
22857,1,бобр,2773,0,1,1,2,50.0%,1h
22857,1,Taril,2773,0,0,2,2,0.0%,1h
22880,1,[mltdcz]NickMcCloud,2772,1704,81,79,160,50.6%,1h
22880,3,Marsius,2772,1288,53,52,105,50.5%,16m
22880,3,[LutSch]CyberSid,2772,736,40,34,74,54.1%,22m
22880,3,gurke,2772,298,38,33,71,53.5%,12m
22880,3,Gonta,2772,962,38,34,72,52.8%,11m
22880,3,[WARP20]saibot,2772,590,21,24,45,46.7%,4m
22880,2,[CHPT]Ackimm,2772,460,20,23,43,46.5%,7m
22880,3,[торТВ]Serzhantik,2772,492,17,19,36,47.2%,3m
22880,2,prikson,2772,456,16,20,36,44.4%,11m
22880,3,[NukeZ]SargeSrum,2772,399,15,13,28,53.6%,19m
22880,3,MisterWhite,2772,236,12,13,25,48.0%,21m
22880,3,Axzess,2772,208,10,11,21,47.6%,19m
22880,3,Sorion,2772,189,9,16,25,36.0%,8m
22880,3,Blood,2772,232,8,15,23,34.8%,3m
22880,3,Shankal,2772,242,7,7,14,50.0%,20m
22880,1,Skag,2772,192,5,2,7,71.4%,22m
22880,1,WilyFox,2772,151,5,4,9,55.6%,3m
22880,2,Deeblock,2772,0,3,3,6,50.0%,23m
22880,1,evdosius,2772,122,3,4,7,42.9%,9m
22880,3,Glorback,2772,142,3,5,8,37.5%,22m
22880,1,Hammerstein,2772,0,2,1,3,66.7%,8m
22880,2,DamiPL,2772,30,1,12,13,7.7%,18m
22880,1,Triptamina,2772,0,0,1,1,0.0%,5m
22880,1,ITишник,2772,0,0,1,1,0.0%,1h
22880,3,[LudyNb]Koolwaad,2772,0,0,4,4,0.0%,51m
22905,3,Athmoless,2771,929,39,32,71,54.9%,7m
22905,1,Regan,2771,670,28,23,51,54.9%,5m
22905,1,[Sarma]odasiljac,2771,356,11,4,15,73.3%,1h
22905,1,Aweresis,2771,330,10,6,16,62.5%,57m
22905,1,DPP,2771,332,9,7,16,56.2%,18m
22905,1,[AciNoN]Ambrella,2771,186,6,2,8,75.0%,24m
22905,1,[PrtNbs]Raensul,2771,188,6,6,12,50.0%,56m
22905,1,[HST7]watsup,2771,0,3,2,5,60.0%,5m
22905,1,easyboi,2771,0,3,4,7,42.9%,19m
22905,1,Pasanosic,2771,38,2,1,3,66.7%,50m
22905,3,[JANEZI]Xeon,2771,30,2,1,3,66.7%,1h
22905,3,Louvrissa,2771,94,2,5,7,28.6%,9m
22905,3,[ACNJP]Skadi,2771,0,1,2,3,33.3%,59m
22905,1,Tamior,2771,42,1,3,4,25.0%,3m
22905,3,davidkiller,2771,94,1,4,5,20.0%,17m
22905,1,[KiKr]kieselbursch,2771,0,0,1,1,0.0%,1h
22905,1,Starssadar,2771,0,0,1,1,0.0%,1h
22905,1,Sherminator,2771,0,0,1,1,0.0%,1h
22905,1,Zerrith,2771,0,0,2,2,0.0%,58m
22924,2,[Sarmat]MatiKlok,2770,982,103,88,191,53.9%,12m
22924,3,Nameless,2770,914,33,34,67,49.3%,11m
22924,3,Alarric,2770,582,24,19,43,55.8%,2m
22924,1,Akmanah,2770,596,22,14,36,61.1%,1h
22924,2,Rokky,2770,491,17,29,46,37.0%,21m
22924,2,metty,2770,464,16,23,39,41.0%,24m
22924,1,Jast,2770,410,12,10,22,54.5%,16m
22924,1,[НТТ]ShameLess,2770,281,11,0,11,100.0%,25m
22924,3,BaT,2770,132,8,10,18,44.4%,59m
22924,1,Logarithme,2770,180,7,5,12,58.3%,52m
22924,3,DONTCRYBABY,2770,218,6,7,13,46.2%,13m
22924,2,EvilPenny,2770,180,5,13,18,27.8%,16m
22924,1,[eXøde]FLent,2770,116,4,2,6,66.7%,17m
22924,2,kyrtishman,2770,0,4,2,6,66.7%,1h
22924,1,Yarik,2770,76,2,2,4,50.0%,1h
22924,3,Riaxy,2770,30,2,6,8,25.0%,4m
22924,1,hunter,2770,93,1,5,6,16.7%,1h
22924,2,[SC4ALL]HegemoN,2770,0,0,1,1,0.0%,1h
22924,1,[Tank21]Mattias,2770,0,0,1,1,0.0%,1h
22924,1,Mischi,2770,0,0,1,1,0.0%,1h
22924,2,DoNotCare,2770,0,0,1,1,0.0%,14m
22924,1,Nyx,2770,0,0,2,2,0.0%,1h
22946,2,[gfor]Veritaz,2769,1419,212,210,422,50.2%,3m
22946,3,[MGME]nickidesert,2769,1588,118,98,216,54.6%,6m
22946,3,First,2769,648,71,56,127,55.9%,9m
22946,3,[DLTED]AnarQ,2769,1164,67,60,127,52.8%,19m
22946,1,Azazello,2769,1011,51,33,84,60.7%,1h
22946,2,Aslan,2769,1301,50,53,103,48.5%,18m
22946,3,[CRL]lioft,2769,1130,49,41,90,54.4%,4m
22946,3,ThoRN,2769,645,43,46,89,48.3%,21m
22946,1,sirMax,2769,1011,38,28,66,57.6%,53m
22946,3,Alveric,2769,813,31,30,61,50.8%,18m
22946,1,Сергей,2769,423,19,13,32,59.4%,15m
22946,2,CyberDreamer,2769,538,18,31,49,36.7%,11m
22946,1,skynik,2769,324,9,3,12,75.0%,1h
22946,2,Driskol,2769,206,9,8,17,52.9%,17m
22946,1,schtolz,2769,239,8,8,16,50.0%,19m
22946,1,Downfall,2769,192,7,10,17,41.2%,22m
22946,1,ureperf,2769,163,5,6,11,45.5%,1h
22946,3,[MTRUS]igoran,2769,176,4,8,12,33.3%,17m
22946,3,Vader,2769,94,4,9,13,30.8%,11m
22946,1,Velnyke,2769,80,3,2,5,60.0%,1h
22946,1,[TERIZM]wicic,2769,42,2,2,4,50.0%,1h
22946,3,AmarokWD,2769,127,2,3,5,40.0%,25m
22946,1,XElisTratX,2769,0,1,0,1,100.0%,23m
22946,3,JackRackham,2769,0,1,2,3,33.3%,9m
22946,1,SLOvan,2769,0,0,1,1,0.0%,1h
22946,1,valcilox,2769,0,0,2,2,0.0%,60m
22946,3,FinderSL,2769,0,0,4,4,0.0%,4m
22946,3,[Smok3r]Mauleypeach,2769,0,0,4,4,0.0%,10m
22974,3,Brainser,2768,1549,218,212,430,50.7%,21m
22974,2,Nemo,2768,1060,143,136,279,51.3%,18m
22974,3,KATIE,2768,1254,93,81,174,53.4%,7m
22974,3,ishemia,2768,884,63,49,112,56.2%,18m
22974,3,Dzjant,2768,1318,60,49,109,55.0%,20m
22974,3,Clement,2768,1001,43,42,85,50.6%,18m
22974,3,arcticHobo,2768,587,24,24,48,50.0%,23m
22974,3,[Alphas]WildChicken,2768,343,17,18,35,48.6%,11m
22974,2,SiberiaS,2768,460,16,27,43,37.2%,8m
22974,3,[ValidG]snusmumriken,2768,370,13,16,29,44.8%,20m
22974,3,[EUww1]Naku,2768,295,9,7,16,56.2%,53m
22974,1,Avellach,2768,292,8,6,14,57.1%,8m
22974,3,[Kovaci]Dzukadin,2768,195,6,7,13,46.2%,1h
22974,2,ElCapitano,2768,92,6,7,13,46.2%,17m
22974,1,Daylight,2768,80,2,2,4,50.0%,57m
22974,2,madbat,2768,0,1,0,1,100.0%,20m
22974,3,freya,2768,0,1,0,1,100.0%,12m
22974,1,ПРОЦЕССОРРРР,2768,97,1,3,4,25.0%,1h
22974,3,Rasezu,2768,0,0,1,1,0.0%,1h
22974,3,Киллер,2768,0,0,3,3,0.0%,16m
22994,3,Manatee,2767,1384,131,116,247,53.0%,24m
22994,3,[NoPa]niceone,2767,1103,100,88,188,53.2%,14m
22994,1,Bronco,2767,1050,86,73,159,54.1%,24m
22994,2,[FaCIaL]mqgmv,2767,989,65,65,130,50.0%,9m
22994,3,eaglesoarsup,2767,392,24,30,54,44.4%,22m
22994,1,llllllllllll,2767,522,21,34,55,38.2%,7m
22994,3,ЯсБорщаги,2767,422,18,20,38,47.4%,11m
22994,3,Fiskstim,2767,424,16,15,31,51.6%,4m
22994,2,Voltage,2767,355,15,16,31,48.4%,17m
22994,2,MisiAQ,2767,241,12,12,24,50.0%,12m
22994,1,[D0N3]UndaPressure,2767,206,9,16,25,36.0%,11m
22994,1,[PiMoK]HornYprobE,2767,189,6,5,11,54.5%,19m
22994,3,platzeins,2767,150,5,8,13,38.5%,16m
22994,1,[ZN]Manwe,2767,166,4,0,4,100.0%,1h
22994,2,AdequateMax,2767,130,4,4,8,50.0%,1h
22994,1,bedaqui,2767,119,3,2,5,60.0%,25m
22994,2,Iados,2767,158,3,6,9,33.3%,24m
22994,1,Mnty,2767,38,2,0,2,100.0%,1h
22994,1,Envit,2767,42,2,2,4,50.0%,5m
22994,3,IIIlllIllI,2767,0,2,3,5,40.0%,53m
22994,1,[SIPAIR]bananenko,2767,0,1,0,1,100.0%,1h
22994,2,[Сlеver]elikteny,2767,0,1,0,1,100.0%,1h
22994,1,Deor,2767,40,1,2,3,33.3%,1h
22994,3,DeLuxe,2767,30,1,6,7,14.3%,22m
22994,1,Elgreen,2767,0,0,1,1,0.0%,1h
22994,1,Chernomor,2767,0,0,2,2,0.0%,57m
23020,2,osa,2766,1578,290,291,581,49.9%,8m
23020,3,SSM,2766,1579,229,220,449,51.0%,18m
23020,2,pappo,2766,1517,166,172,338,49.1%,16m
23020,3,Anselmo,2766,1516,124,117,241,51.5%,23m
23020,3,magass,2766,1385,53,51,104,51.0%,7m
23020,3,NYO,2766,913,41,28,69,59.4%,6m
23020,3,Manticore,2766,626,26,25,51,51.0%,3m
23020,3,MSS,2766,420,16,17,33,48.5%,15m
23020,3,[BÄMM]underworld,2766,216,14,12,26,53.8%,21m
23020,1,MathyWay,2766,456,14,12,26,53.8%,9m
23020,3,NineOneOne,2766,379,14,14,28,50.0%,14m
23020,3,korail,2766,362,13,8,21,61.9%,1h
23020,1,sanchez,2766,162,5,3,8,62.5%,1h
23020,3,Groza,2766,114,5,7,12,41.7%,15m
23020,1,jakub,2766,120,4,2,6,66.7%,16m
23020,3,Hydrum,2766,30,4,4,8,50.0%,21m
23020,2,namoonk,2766,141,4,5,9,44.4%,1h
23020,2,Chouli,2766,106,4,5,9,44.4%,21m
23020,1,EuroStupid,2766,194,4,6,10,40.0%,18m
23020,3,brobi,2766,120,4,12,16,25.0%,22m
23020,3,[Alten]Rilic,2766,121,3,2,5,60.0%,1h
23020,3,Fred,2766,0,3,2,5,60.0%,51m
23020,3,ultra,2766,0,3,3,6,50.0%,20m
23020,3,DieMaschine,2766,92,3,8,11,27.3%,5m
23020,3,[BRSKR]Ratfizz,2766,30,2,2,4,50.0%,14m
23020,3,[LoLoLo]MechDonalds,2766,30,2,3,5,40.0%,10m
23020,3,Чек,2766,0,2,3,5,40.0%,1h
23020,3,goodchernov,2766,30,2,5,7,28.6%,8m
23020,3,Baptistebar,2766,0,1,0,1,100.0%,15m
23020,1,Nastoyashiy,2766,0,0,1,1,0.0%,9m
23020,1,[ARMALV]Razinoid,2766,0,0,1,1,0.0%,16m
23020,1,CorrelBrch,2766,0,0,1,1,0.0%,58m
23020,1,Decursive,2766,0,0,1,1,0.0%,1h
23053,3,DonKamillo,2765,1085,103,99,202,51.0%,11m
23053,3,Skit,2765,608,101,97,198,51.0%,3m
23053,1,zxcvbnm,2765,681,35,29,64,54.7%,3m
23053,3,GGNOWKISKILL,2765,695,31,30,61,50.8%,14m
23053,3,Ruslan,2765,543,24,13,37,64.9%,4m
23053,1,Yougloups,2765,672,22,18,40,55.0%,1h
23053,3,Nikolai,2765,580,22,24,46,47.8%,15m
23053,1,[КПCC]DeniasLom,2765,250,20,7,27,74.1%,1h
23053,1,[xFLF]KaanDaniel,2765,408,14,7,21,66.7%,21m
23053,2,Chasokin,2765,400,14,18,32,43.8%,6m
23053,3,xaverseltsam,2765,328,12,8,20,60.0%,17m
23053,3,scfenixxx,2765,305,9,12,21,42.9%,18m
23053,3,[FSO]Fenouil,2765,182,8,5,13,61.5%,10m
23053,1,august,2765,249,7,3,10,70.0%,3m
23053,1,[Leg1on]QpiTerranGOD,2765,237,7,7,14,50.0%,17m
23053,1,monki,2765,309,7,7,14,50.0%,14m
23053,3,Starck,2765,168,5,8,13,38.5%,16m
23053,3,Treadstoun,2765,114,5,9,14,35.7%,24m
23053,3,enice,2765,164,4,5,9,44.4%,3m
23053,1,Morphose,2765,0,3,2,5,60.0%,57m
23053,1,soad,2765,88,3,3,6,50.0%,4m
23053,3,Colichou,2765,0,3,3,6,50.0%,19m
23053,3,PayVayUA,2765,115,3,3,6,50.0%,12m
23053,1,glupcho,2765,89,3,3,6,50.0%,1h
23053,3,Sorastra,2765,62,3,4,7,42.9%,14m
23053,1,Zergin,2765,80,2,2,4,50.0%,1h
23053,3,GhalMaraz,2765,30,2,3,5,40.0%,18m
23053,1,[1C5]CocainCowboy,2765,0,1,0,1,100.0%,57m
23053,1,[KNAt]Max,2765,0,1,0,1,100.0%,1h
23053,3,[FreshD]Leuchtfix,2765,0,1,2,3,33.3%,18m
23053,1,Zegun,2765,73,1,2,3,33.3%,17m
23053,1,CoreScope,2765,0,0,1,1,0.0%,21m
23053,1,Aurinik,2765,0,0,1,1,0.0%,16m
23053,3,Myzone,2765,0,0,3,3,0.0%,16m
23087,2,СметанКа,2764,1461,229,231,460,49.8%,10m
23087,2,[TPS]ALMORRANA,2764,1556,195,197,392,49.7%,13m
23087,3,asd,2764,1580,153,147,300,51.0%,7m
23087,3,Tal,2764,1582,151,148,299,50.5%,22m
23087,2,Tywka,2764,1471,114,106,220,51.8%,12m
23087,1,Battledroid,2764,633,33,24,57,57.9%,1h
23087,3,Maxprime,2764,761,30,31,61,49.2%,11m
23087,3,bAzyl,2764,624,25,28,53,47.2%,17m
23087,1,[PowOw]TheDoctor,2764,415,19,2,21,90.5%,1h
23087,1,BlitzSteal,2764,405,15,8,23,65.2%,1h
23087,3,Cptprice,2764,244,13,12,25,52.0%,4m
23087,3,knowo,2764,295,10,10,20,50.0%,4m
23087,1,MoHaPx,2764,297,9,6,15,60.0%,1h
23087,2,root,2764,277,9,10,19,47.4%,1h
23087,3,Otzako,2764,276,9,16,25,36.0%,21m
23087,1,[ZERG7V]Sharkman,2764,306,8,11,19,42.1%,1h
23087,3,Benbigstick,2764,180,7,10,17,41.2%,7m
23087,1,BondEA,2764,165,6,6,12,50.0%,6m
23087,1,[SC2]TarPalantir,2764,124,5,6,11,45.5%,1h
23087,1,РашенМафия,2764,172,5,7,12,41.7%,6m
23087,1,[dLife]Destroyed,2764,118,4,2,6,66.7%,1h
23087,3,DeathFinger,2764,124,4,9,13,30.8%,4m
23087,3,Chillipepper,2764,0,3,3,6,50.0%,20m
23087,3,KOLOBOK,2764,0,2,3,5,40.0%,5m
23087,2,dopesolja,2764,42,2,6,8,25.0%,24m
23087,1,GenataBaby,2764,42,1,1,2,50.0%,58m
23087,1,Danja,2764,40,1,2,3,33.3%,21m
23114,1,Cyberdriver,2763,1509,110,113,223,49.3%,17m
23114,3,Andersen,2763,456,88,89,177,49.7%,10m
23114,3,zoro,2763,1341,66,62,128,51.6%,7m
23114,2,[FrcLn]Vary,2763,842,46,51,97,47.4%,22m
23114,3,Requiem,2763,836,33,28,61,54.1%,6m
23114,2,OpheliaCwal,2763,747,30,29,59,50.8%,12m
23114,2,Andrykha,2763,636,30,37,67,44.8%,9m
23114,3,Wingent,2763,658,26,21,47,55.3%,19m
23114,2,LuckyMeat,2763,572,22,28,50,44.0%,16m
23114,1,KalaKukko,2763,482,17,11,28,60.7%,1h
23114,3,ShadowSonic,2763,296,10,13,23,43.5%,18m
23114,1,davidaurus,2763,266,8,6,14,57.1%,1h
23114,1,Xykon,2763,212,6,4,10,60.0%,52m
23114,3,Davkaus,2763,97,6,11,17,35.3%,18m
23114,3,Reaper,2763,119,6,11,17,35.3%,16m
23114,3,[QUAKE]BlackGutsul,2763,122,5,7,12,41.7%,20m
23114,3,Ckorpionerrs,2763,0,4,1,5,80.0%,18m
23114,1,VIRTUS,2763,112,3,1,4,75.0%,1h
23114,1,Mourtag,2763,120,3,6,9,33.3%,56m
23114,1,primo,2763,82,2,2,4,50.0%,1h
23114,1,[HFR]tomtom,2763,0,2,3,5,40.0%,18m
23114,1,InstaLol,2763,98,2,3,5,40.0%,1h
23114,1,Kevlar,2763,0,1,0,1,100.0%,56m
23114,3,Xynomikols,2763,0,1,2,3,33.3%,9m
23114,1,[Click]CybOrk,2763,0,0,1,1,0.0%,1h
23114,1,WeedWizard,2763,0,0,1,1,0.0%,1h
23114,1,[Kngsmn]Ryssdani,2763,0,0,2,2,0.0%,1h
23141,3,HerrKaleun,2762,1566,412,404,816,50.5%,20m
23141,1,Kaban,2762,1755,334,329,663,50.4%,1h
23141,2,Erynnis,2762,1054,118,118,236,50.0%,22m
23141,3,San,2762,1592,105,97,202,52.0%,6m
23141,2,[ZnCeR]AstroLux,2762,1548,81,90,171,47.4%,16m
23141,3,Fenar,2762,961,78,66,144,54.2%,14m
23141,3,MpK,2762,1548,67,53,120,55.8%,21m
23141,3,Sightlyfan,2762,897,36,33,69,52.2%,24m
23141,3,[PiMoK]STONEDzealot,2762,370,27,20,47,57.4%,21m
23141,1,[Stary]FOSSOYEUR,2762,854,25,25,50,50.0%,10m
23141,2,sikvald,2762,255,13,12,25,52.0%,6m
23141,3,Takeshi,2762,285,12,9,21,57.1%,56m
23141,2,Szymko,2762,270,12,12,24,50.0%,9m
23141,3,RimruTempset,2762,319,11,13,24,45.8%,11m
23141,3,MrRomich,2762,245,10,10,20,50.0%,53m
23141,1,RECTOR,2762,261,9,10,19,47.4%,1h
23141,3,llllllllll,2762,133,9,10,19,47.4%,57m
23141,1,[dtOw]ScvNmbrOne,2762,254,8,7,15,53.3%,5m
23141,1,[Kicx]Sax,2762,228,7,4,11,63.6%,8m
23141,1,[LogL]Desdinova,2762,204,6,4,10,60.0%,1h
23141,3,DrAlexNone,2762,213,6,7,13,46.2%,10m
23141,1,Qwizzyx,2762,112,3,2,5,60.0%,5m
23141,1,[SPEZ]SchocK,2762,0,1,0,1,100.0%,9m
23141,1,SABCIO,2762,38,1,1,2,50.0%,58m
23141,1,ElonaGay,2762,38,1,2,3,33.3%,6m
23141,3,Reki,2762,0,0,1,1,0.0%,1h
23141,1,maksi,2762,0,0,1,1,0.0%,22m
23141,2,Suteneraka,2762,0,0,1,1,0.0%,17m
23141,3,EARLYRUSH,2762,0,0,1,1,0.0%,1h
23141,3,[UFOP]Link,2762,0,0,3,3,0.0%,3m
23141,1,Alex,2762,0,0,5,5,0.0%,3m
23172,2,DonMigue,2761,1532,251,242,493,50.9%,8m
23172,1,eyesburn,2761,1668,181,170,351,51.6%,1h
23172,3,CharlieSheen,2761,1576,115,106,221,52.0%,4m
23172,3,Snoey,2761,1351,109,95,204,53.4%,3m
23172,3,[STATUS]Player,2761,1195,61,44,105,58.1%,22m
23172,3,[IceHus]Pandosss,2761,1379,59,54,113,52.2%,3m
23172,2,[skh]flip,2761,1110,56,57,113,49.6%,17m
23172,2,Dexter,2761,735,36,42,78,46.2%,7m
23172,1,Arminius,2761,337,11,4,15,73.3%,16m
23172,3,SailorPorky,2761,306,11,17,28,39.3%,10m
23172,3,StormFall,2761,259,9,7,16,56.2%,14m
23172,1,[Оми]Аккерман,2761,254,8,5,13,61.5%,1h
23172,3,HLKnight,2761,217,7,8,15,46.7%,22m
23172,1,illmatic,2761,145,6,5,11,54.5%,57m
23172,1,Holzken,2761,192,6,6,12,50.0%,22m
23172,1,[SKIDT]KingFerck,2761,117,5,7,12,41.7%,9m
23172,3,Dannnnnnyu,2761,143,4,3,7,57.1%,14m
23172,3,Dreadnogh,2761,166,4,6,10,40.0%,17m
23172,3,Klimo,2761,137,3,3,6,50.0%,18m
23172,2,Ivanboard,2761,0,1,0,1,100.0%,22m
23172,1,SergeyOrion,2761,0,1,0,1,100.0%,1h
23172,2,Compgraf,2761,0,1,1,2,50.0%,1h
23172,3,NikoFM,2761,30,1,6,7,14.3%,16m
23172,2,[SSCfr]JED,2761,0,0,1,1,0.0%,51m
23172,3,[NGone]VindoViper,2761,0,0,2,2,0.0%,9m
23197,1,woomoort,2760,1239,175,150,325,53.8%,4m
23197,1,Kenny,2760,1765,155,148,303,51.2%,1h
23197,3,Maevius,2760,897,147,125,272,54.0%,21m
23197,1,FaFaN,2760,1764,124,116,240,51.7%,50m
23197,3,KregHEk,2760,1325,89,76,165,53.9%,7m
23197,3,BlackLord,2760,1557,86,82,168,51.2%,20m
23197,3,Busya,2760,524,85,83,168,50.6%,13m
23197,2,Victorius,2760,555,30,43,73,41.1%,17m
23197,3,Tzeench,2760,546,22,23,45,48.9%,17m
23197,3,[BULD0G]KalmeCavia,2760,177,6,5,11,54.5%,19m
23197,3,Phixion,2760,115,6,6,12,50.0%,20m
23197,1,SilentStorm,2760,169,6,7,13,46.2%,1h
23197,3,tazer,2760,178,6,11,17,35.3%,12m
23197,1,White,2760,65,4,2,6,66.7%,21m
23197,1,FantomJeriko,2760,48,4,5,9,44.4%,52m
23197,1,Alpha,2760,73,4,5,9,44.4%,4m
23197,1,SanctiRose,2760,120,3,0,3,100.0%,17m
23197,1,[ZPCS]DimonDych,2760,82,3,1,4,75.0%,1h
23197,1,[0Head]artur,2760,94,3,1,4,75.0%,17m
23197,1,Icehammer,2760,83,3,2,5,60.0%,9m
23197,1,Rri,2760,144,3,2,5,60.0%,1h
23197,3,Jack,2760,68,3,6,9,33.3%,9m
23197,1,Phylosor,2760,48,2,2,4,50.0%,1h
23197,2,Borkaman,2760,0,2,4,6,33.3%,11m
23197,3,[FAV1]MYSTADERRA,2760,120,2,4,6,33.3%,3m
23197,3,speezil,2760,0,1,1,2,50.0%,23m
23197,3,[sgЫ]vanyabasher,2760,30,1,4,5,20.0%,14m
23197,1,Pansar,2760,0,0,2,2,0.0%,5m
23197,1,mtoom,2760,0,0,2,2,0.0%,1h
23197,2,TKACH,2760,0,0,2,2,0.0%,16m
23197,3,[ZERGTV]CDS,2760,0,0,3,3,0.0%,13m
23197,3,Elkitz,2760,0,0,4,4,0.0%,17m
23197,1,ClamZou,2760,0,0,6,6,0.0%,1h
23230,2,chips,2759,1546,294,293,587,50.1%,17m
23230,1,SNV,2759,1529,125,146,271,46.1%,7m
23230,3,testerino,2759,809,111,111,222,50.0%,21m
23230,3,[üPol]Dave,2759,1004,110,90,200,55.0%,18m
23230,1,[WАSD]Starman,2759,1216,63,48,111,56.8%,22m
23230,2,AsaHentai,2759,957,57,48,105,54.3%,22m
23230,3,TastyTrout,2759,511,48,49,97,49.5%,18m
23230,3,Puntero,2759,1009,40,39,79,50.6%,12m
23230,2,Number,2759,667,28,30,58,48.3%,19m
23230,1,ErZzu,2759,545,20,16,36,55.6%,8m
23230,1,Mandus,2759,570,16,18,34,47.1%,1h
23230,3,[LoHub]WhiteBlaze,2759,301,15,16,31,48.4%,11m
23230,3,Lapputte,2759,426,15,17,32,46.9%,21m
23230,1,Mangeclous,2759,421,13,8,21,61.9%,1h
23230,3,Potte,2759,348,13,11,24,54.2%,20m
23230,1,Nathz,2759,122,10,14,24,41.7%,16m
23230,3,Bauerxx,2759,60,5,6,11,45.5%,24m
23230,3,HeEbashu,2759,142,5,8,13,38.5%,8m
23230,2,[CROWDY]monk,2759,97,4,3,7,57.1%,24m
23230,1,vova,2759,113,4,4,8,50.0%,5m
23230,3,wastaLORD,2759,114,4,9,13,30.8%,16m
23230,2,Brennus,2759,0,3,2,5,60.0%,7m
23230,1,Soh,2759,88,3,3,6,50.0%,1h
23230,3,Christar,2759,148,3,5,8,37.5%,6m
23230,1,Blame,2759,40,2,1,3,66.7%,6m
23230,1,SmauG,2759,0,2,3,5,40.0%,25m
23230,3,Sartsabi,2759,0,2,3,5,40.0%,51m
23230,3,Presto,2759,60,2,6,8,25.0%,17m
23230,1,Razarvater,2759,0,1,0,1,100.0%,57m
23230,1,[K0mpis]Kurre,2759,0,1,1,2,50.0%,1h
23230,1,[MCFire]Stormwar,2759,38,1,2,3,33.3%,1h
23230,1,JamesRamires,2759,0,1,2,3,33.3%,1h
23230,3,[LotHoL]Tea,2759,0,1,3,4,25.0%,23m
23230,1,[AiRǂ]UnicoTerran,2759,0,1,4,5,20.0%,8m
23230,3,BlueT,2759,0,1,4,5,20.0%,5m
23265,2,[Hаsu]Style,2758,1113,48,48,96,50.0%,21m
23265,1,[DOOGIE]pitch,2758,879,45,40,85,52.9%,1h
23265,1,Relgertan,2758,298,9,6,15,60.0%,1h
23265,2,Umoja,2758,226,7,20,27,25.9%,10m
23265,1,Stringset,2758,204,6,2,8,75.0%,50m
23265,2,Ghost,2758,182,6,5,11,54.5%,1h
23265,1,САНЯ,2758,93,5,1,6,83.3%,18m
23265,2,Bjorn,2758,138,5,4,9,55.6%,1h
23265,3,Kirovskiy,2758,174,5,5,10,50.0%,15m
23265,1,Liberta,2758,114,5,7,12,41.7%,20m
23265,3,[TSC2C]Тирион,2758,150,5,8,13,38.5%,18m
23265,3,DarKMaiK,2758,146,5,9,14,35.7%,20m
23265,2,Prédase,2758,116,4,3,7,57.1%,21m
23265,3,Disbeliver,2758,86,4,7,11,36.4%,11m
23265,1,[SóiCon]Wolf,2758,78,2,2,4,50.0%,18m
23265,1,paullec,2758,78,2,3,5,40.0%,13m
23265,3,[SiTFLY]ryeryerye,2758,54,2,5,7,28.6%,4m
23265,1,Elladan,2758,0,1,0,1,100.0%,17m
23265,3,Bjoern,2758,0,1,3,4,25.0%,14m
23265,3,Илья,2758,30,1,4,5,20.0%,20m
23265,1,sYne,2758,0,0,1,1,0.0%,1h
23265,2,Киборг,2758,0,0,1,1,0.0%,1h
23265,1,TobSucht,2758,0,0,2,2,0.0%,1h
23288,3,Delitant,2757,1527,130,128,258,50.4%,20m
23288,1,jachuu,2757,1482,119,130,249,47.8%,12m
23288,2,[K0mpis]Challenger,2757,1500,73,80,153,47.7%,17m
23288,2,TEDDYKILLERZ,2757,1150,60,65,125,48.0%,21m
23288,3,Easywiner,2757,1327,59,50,109,54.1%,21m
23288,2,Fonar,2757,852,32,32,64,50.0%,6m
23288,1,TeRRRaN,2757,848,28,26,54,51.9%,59m
23288,3,DuKong,2757,582,23,23,46,50.0%,21m
23288,1,Neepko,2757,477,20,7,27,74.1%,57m
23288,3,DarkSoul,2757,496,19,16,35,54.3%,18m
23288,1,Коматозник,2757,361,14,8,22,63.6%,1h
23288,3,KABLE,2757,226,14,21,35,40.0%,21m
23288,3,Ravager,2757,354,13,18,31,41.9%,21m
23288,3,[profSC]Yakudza,2757,341,12,14,26,46.2%,17m
23288,3,ATOMRUSH,2757,324,12,16,28,42.9%,4m
23288,1,[AiRǂ]Giovak,2757,374,10,10,20,50.0%,19m
23288,1,Strelok,2757,167,9,5,14,64.3%,1h
23288,1,Esprit,2757,228,7,4,11,63.6%,1h
23288,3,[INAE]RamZesKTS,2757,199,7,5,12,58.3%,3m
23288,2,CaelmBleidd,2757,144,6,6,12,50.0%,17m
23288,1,Freigeist,2757,220,6,7,13,46.2%,3m
23288,1,SudZero,2757,160,5,5,10,50.0%,57m
23288,3,paetrick,2757,94,3,9,12,25.0%,18m
23288,1,jappi,2757,40,2,1,3,66.7%,1h
23288,3,[Wasp7]amah,2757,0,2,3,5,40.0%,1h
23288,2,XXXXXXIIIIII,2757,95,2,3,5,40.0%,1h
23288,1,GottesErbe,2757,0,2,3,5,40.0%,51m
23288,2,[Still]MrMagOo,2757,0,2,4,6,33.3%,53m
23288,3,Upbeat,2757,60,2,4,6,33.3%,4m
23288,3,EML,2757,62,2,7,9,22.2%,21m
23288,1,Amazil,2757,40,1,1,2,50.0%,1h
23288,1,Дантес,2757,38,1,2,3,33.3%,1h
23288,1,Sbarabard,2757,0,0,1,1,0.0%,51m
23288,1,Gin,2757,0,0,1,1,0.0%,18m
23288,1,AlleXz,2757,0,0,3,3,0.0%,24m
23323,3,fromNucCity,2756,1563,114,112,226,50.4%,6m
23323,1,sheevpower,2756,1718,92,85,177,52.0%,17m
23323,3,Vodka,2756,1465,88,77,165,53.3%,4m
23323,3,bEarchZz,2756,842,50,49,99,50.5%,24m
23323,3,KupeRobie,2756,515,42,38,80,52.5%,11m
23323,3,varrnar,2756,498,21,16,37,56.8%,19m
23323,3,nicapotato,2756,522,21,19,40,52.5%,10m
23323,3,[espHB]Bang,2756,248,10,9,19,52.6%,21m
23323,3,Yossarian,2756,297,10,9,19,52.6%,7m
23323,3,[Hаsu]Galfind,2756,190,8,7,15,53.3%,24m
23323,1,Verdandi,2756,209,7,8,15,46.7%,13m
23323,1,AFCArt,2756,196,7,11,18,38.9%,8m
23323,1,Hose,2756,192,5,4,9,55.6%,60m
23323,1,[HBGSJR]aDago,2756,118,3,1,4,75.0%,22m
23323,1,Davor,2756,76,3,1,4,75.0%,60m
23323,1,[dQQb]PzKwk,2756,118,3,2,5,60.0%,1h
23323,1,Niro,2756,40,2,0,2,100.0%,1h
23323,1,Dakre,2756,40,2,0,2,100.0%,16m
23323,1,denchus,2756,42,2,1,3,66.7%,3m
23323,3,Shadow,2756,0,2,3,5,40.0%,1h
23323,1,Lulubalu,2756,0,2,3,5,40.0%,16m
23323,1,[FZoG]kompani,2756,0,2,3,5,40.0%,1h
23323,1,[HMB]GeneralSmith,2756,78,2,4,6,33.3%,6m
23323,3,[xFRSx]DarKWizarD,2756,30,2,5,7,28.6%,3m
23323,3,[PSD]SamuraiJack,2756,30,1,3,4,25.0%,24m
23323,3,[Olk]HORUS,2756,94,1,4,5,20.0%,10m
23323,3,ANGRY,2756,0,1,5,6,16.7%,3m
23323,1,BogvABW,2756,0,0,1,1,0.0%,60m
23323,1,RanRafi,2756,0,0,2,2,0.0%,18m
23323,1,[RuHuCo]AntonFl,2756,0,0,2,2,0.0%,1h
23323,2,NIKITA,2756,0,0,2,2,0.0%,1h
23354,2,UncleBens,2755,1397,164,158,322,50.9%,6m
23354,2,LongHands,2755,766,128,123,251,51.0%,22m
23354,2,Barnaba,2755,1638,103,102,205,50.2%,17m
23354,1,Ditr,2755,1101,79,87,166,47.6%,17m
23354,3,CapMan,2755,1318,77,67,144,53.5%,24m
23354,1,ProtossAnt,2755,1236,50,32,82,61.0%,1h
23354,1,[GG2020]Dragora,2755,1138,43,28,71,60.6%,6m
23354,1,zalupich,2755,829,35,15,50,70.0%,21m
23354,3,[TRÉBO]Oussam,2755,630,23,28,51,45.1%,21m
23354,1,[KVOID]AngrySCV,2755,541,20,10,30,66.7%,22m
23354,3,Mastodont,2755,505,19,24,43,44.2%,20m
23354,1,[3ЕRGTV]xxxFuSiOnxxx,2755,561,18,12,30,60.0%,20m
23354,1,Hev,2755,257,9,7,16,56.2%,1h
23354,2,XxTeMpEstxX,2755,254,8,18,26,30.8%,6m
23354,2,XXXXX,2755,182,5,5,10,50.0%,1h
23354,1,Kerdan,2755,120,5,5,10,50.0%,22m
23354,3,kush,2755,148,5,9,14,35.7%,3m
23354,2,Sergio,2755,119,3,2,5,60.0%,51m
23354,2,Draconiss,2755,0,3,3,6,50.0%,1h
23354,2,Coeurbrave,2755,88,2,2,4,50.0%,21m
23354,1,Nextezy,2755,44,2,2,4,50.0%,10m
23354,3,Mediterranea,2755,0,2,3,5,40.0%,1h
23354,2,dio,2755,0,1,0,1,100.0%,1h
23354,1,bond,2755,0,1,1,2,50.0%,1h
23354,3,[Dytred]MayorKirov,2755,93,1,2,3,33.3%,9m
23354,3,Vlad,2755,0,1,4,5,20.0%,23m
23354,3,Karamell,2755,0,0,3,3,0.0%,19m
23354,3,Kaszadragon,2755,0,0,4,4,0.0%,17m
23382,2,barcode,2754,1241,137,130,267,51.3%,17m
23382,3,[Dbcǂ]Zeuphagus,2754,1558,109,102,211,51.7%,19m
23382,2,ЕдкийГоблин,2754,893,88,85,173,50.9%,16m
23382,1,[Sp1n]jfa,2754,1725,80,75,155,51.6%,1h
23382,1,Aitis,2754,1191,51,37,88,58.0%,18m
23382,3,Tchoupi,2754,728,27,25,52,51.9%,13m
23382,3,skeryOne,2754,762,27,31,58,46.6%,19m
23382,1,[crtssr]patrusky,2754,649,26,11,37,70.3%,1h
23382,3,FIGARO,2754,331,25,21,46,54.3%,3m
23382,2,Holo,2754,428,14,24,38,36.8%,12m
23382,1,Dreamer,2754,270,8,7,15,53.3%,1h
23382,3,Nibbler,2754,268,8,8,16,50.0%,8m
23382,2,NiZe,2754,204,6,5,11,54.5%,12m
23382,3,PsychD,2754,197,5,9,14,35.7%,1h
23382,3,Ostrek,2754,156,5,12,17,29.4%,20m
23382,2,[FOKers]nagual,2754,154,5,19,24,20.8%,7m
23382,1,NzUmer,2754,0,4,0,4,100.0%,1h
23382,1,[MAIS]Maisi,2754,0,4,1,5,80.0%,18m
23382,3,razrock,2754,42,4,2,6,66.7%,1h
23382,1,KillerCourse,2754,192,4,2,6,66.7%,1h
23382,3,VolJang,2754,58,3,6,9,33.3%,10m
23382,1,stasiux,2754,78,2,3,5,40.0%,57m
23382,1,Kartofan,2754,0,2,3,5,40.0%,17m
23382,3,[BrCrft]SkySultan,2754,30,2,6,8,25.0%,22m
23382,3,user,2754,0,1,3,4,25.0%,3m
23382,1,TheBishop,2754,0,0,1,1,0.0%,16m
23382,1,[dling]tDuck,2754,0,0,1,1,0.0%,1h
23409,2,[RWG]Dmitresky,2753,1543,135,128,263,51.3%,12m
23409,3,dedok,2753,1417,85,81,166,51.2%,13m
23409,3,ATomCorp,2753,994,67,48,115,58.3%,18m
23409,1,IamLegend,2753,1355,54,52,106,50.9%,12m
23409,3,darknoob,2753,956,45,36,81,55.6%,17m
23409,1,Kashmar,2753,905,42,29,71,59.2%,57m
23409,1,Blacknes,2753,774,28,38,66,42.4%,24m
23409,3,[Penza]regar,2753,636,24,24,48,50.0%,3m
23409,2,PONEDELKUS,2753,497,19,31,50,38.0%,20m
23409,1,SpEnCeRcOmPh,2753,251,8,9,17,47.1%,1h
23409,1,Fedya,2753,174,7,8,15,46.7%,1h
23409,1,rubbishskata,2753,183,6,5,11,54.5%,55m
23409,3,Morro,2753,128,5,10,15,33.3%,3m
23409,1,[SHOSH]Schorsch,2753,160,4,4,8,50.0%,6m
23409,1,[STASFR]Pozitiv,2753,118,3,3,6,50.0%,24m
23409,3,Biscomar,2753,0,3,3,6,50.0%,6m
23409,1,[NOGod]donab,2753,40,2,0,2,100.0%,22m
23409,3,Max,2753,0,2,3,5,40.0%,51m
23409,1,oDwin,2753,0,2,3,5,40.0%,9m
23409,1,Maxxi,2753,76,2,4,6,33.3%,4m
23409,1,slipknotfx,2753,96,1,1,2,50.0%,1h
23409,3,GeoGodley,2753,94,1,2,3,33.3%,9m
23409,3,BloodyAtoms,2753,0,1,3,4,25.0%,55m
23409,1,Zerstörer,2753,42,1,4,5,20.0%,1h
23409,3,Constantine,2753,0,0,1,1,0.0%,1h
23409,1,robson,2753,0,0,1,1,0.0%,1h
23435,2,lars,2752,1578,221,231,452,48.9%,21m
23435,3,EnemyUnknown,2752,1547,163,148,311,52.4%,19m
23435,3,PikingSod,2752,385,84,80,164,51.2%,22m
23435,3,mega,2752,994,45,39,84,53.6%,6m
23435,1,[LdLT]zerocool,2752,1015,42,25,67,62.7%,25m
23435,3,NULL,2752,897,35,40,75,46.7%,14m
23435,1,MariahCarrey,2752,470,25,18,43,58.1%,1h
23435,2,JTSavior,2752,392,15,17,32,46.9%,3m
23435,3,[mTx]Acquaragia,2752,349,12,13,25,48.0%,5m
23435,3,CrustySA,2752,268,9,10,19,47.4%,3m
23435,3,[BRSKR]qpinkiq,2752,178,6,10,16,37.5%,21m
23435,3,[XZ]Chilibow,2752,148,6,11,17,35.3%,3m
23435,3,Jusifer,2752,150,5,7,12,41.7%,18m
23435,3,[2EZ4]Shorty,2752,118,5,8,13,38.5%,11m
23435,1,[GDA]WarDeer,2752,116,4,4,8,50.0%,4m
23435,1,TyshRenn,2752,153,4,5,9,44.4%,20m
23435,1,[DМG]battle,2752,112,3,1,4,75.0%,25m
23435,1,Dace,2752,116,3,5,8,37.5%,1h
23435,3,Repek,2752,121,2,2,4,50.0%,1h
23435,1,[TPKC]CZZPink,2752,0,2,3,5,40.0%,8m
23435,3,Pistch,2752,0,2,3,5,40.0%,1h
23435,1,[CrossX]VegaStarLine,2752,0,2,3,5,40.0%,1h
23435,3,vinovi,2752,30,2,4,6,33.3%,20m
23435,3,Tquila,2752,118,2,5,7,28.6%,20m
23435,2,tommyGun,2752,0,2,5,7,28.6%,51m
23435,1,Orb,2752,0,1,0,1,100.0%,1h
23435,3,Mogg,2752,0,1,0,1,100.0%,1h
23435,1,piushca,2752,40,1,2,3,33.3%,1h
23435,1,Kalenh,2752,0,0,1,1,0.0%,25m
23435,1,aavado,2752,0,0,3,3,0.0%,1h
23435,3,Racheengel,2752,0,0,8,8,0.0%,7m
23466,2,[HRisk]СуперМаг,2751,1500,251,210,461,54.4%,17m
23466,1,DukeLemond,2751,984,128,102,230,55.7%,1h
23466,2,Vniz,2751,1514,99,95,194,51.0%,8m
23466,1,SanyaJor,2751,1650,90,74,164,54.9%,51m
23466,1,LoWeSt,2751,692,56,61,117,47.9%,7m
23466,1,Pulse,2751,1329,52,45,97,53.6%,13m
23466,1,KillFirst,2751,1187,51,35,86,59.3%,1h
23466,1,SKYFALL,2751,1228,47,36,83,56.6%,1h
23466,1,Kai,2751,799,41,27,68,60.3%,16m
23466,2,aScDeadcam,2751,300,30,35,65,46.2%,16m
23466,1,Santiago,2751,745,25,18,43,58.1%,60m
23466,3,Rikos,2751,519,24,22,46,52.2%,21m
23466,1,Gereay,2751,609,20,13,33,60.6%,19m
23466,1,PepsiColaFan,2751,303,12,7,19,63.2%,24m
23466,2,Yarik,2751,360,12,19,31,38.7%,17m
23466,3,Капуста,2751,263,11,13,24,45.8%,8m
23466,1,Drikkou,2751,324,9,9,18,50.0%,22m
23466,3,Nikon,2751,266,9,13,22,40.9%,10m
23466,3,Bonjed,2751,149,7,8,15,46.7%,10m
23466,3,Maxu,2751,256,7,9,16,43.8%,18m
23466,2,[NODA]MarineManne,2751,223,6,6,12,50.0%,53m
23466,3,Banan,2751,94,4,6,10,40.0%,21m
23466,3,[Crafts]Merlin,2751,116,4,9,13,30.8%,8m
23466,2,Bandershtadt,2751,0,3,4,7,42.9%,15m
23466,3,AlexeyIL,2751,92,3,10,13,23.1%,20m
23466,3,BlackOwl,2751,82,2,3,5,40.0%,7m
23466,3,Phoenix,2751,0,2,3,5,40.0%,25m
23466,1,[ŁoT]Fukus,2751,0,1,0,1,100.0%,1h
23466,1,[TNBK]CsikAndris,2751,0,0,1,1,0.0%,9m
23466,1,Ulveraker,2751,0,0,1,1,0.0%,1h
23466,1,davidlg,2751,0,0,1,1,0.0%,1h
23466,2,KAGERER,2751,0,0,2,2,0.0%,1h
23466,3,FuuZz,2751,0,0,3,3,0.0%,59m
23466,1,dzpak,2751,0,0,5,5,0.0%,57m
23500,2,саша,2750,1598,149,150,299,49.8%,21m
23500,1,UnReaLitY,2750,1517,142,146,288,49.3%,13m
23500,1,Chakakazull,2750,1760,112,106,218,51.4%,1h
23500,1,RexSplode,2750,1669,96,83,179,53.6%,5m
23500,3,[OFocus]Alcubierre,2750,754,30,32,62,48.4%,3m
23500,2,FanTaSy,2750,446,21,18,39,53.8%,8m
23500,3,hOmie,2750,393,18,18,36,50.0%,8m
23500,1,IronLord,2750,452,14,12,26,53.8%,13m
23500,1,Camembert,2750,366,12,9,21,57.1%,17m
23500,1,[UNoobz]DPH,2750,150,5,2,7,71.4%,12m
23500,1,[Dobro]Trigger,2750,123,5,3,8,62.5%,21m
23500,3,Sokol,2750,94,5,12,17,29.4%,11m
23500,1,blackwolf,2750,78,3,2,5,60.0%,57m
23500,1,UrDoomedWoW,2750,0,3,2,5,60.0%,1h
23500,3,Danik,2750,58,3,4,7,42.9%,18m
23500,1,Glasidius,2750,0,2,3,5,40.0%,6m
23500,3,tjegan,2750,0,2,5,7,28.6%,9m
23500,1,TerranGT,2750,0,1,0,1,100.0%,57m
23500,3,Snaidy,2750,92,1,4,5,20.0%,3m
23500,3,Trey,2750,0,0,5,5,0.0%,1h
23520,1,Mega,2749,1210,177,160,337,52.5%,5m
23520,1,Probianer,2749,1410,81,63,144,56.2%,9m
23520,1,AntFromRus,2749,1106,58,39,97,59.8%,55m
23520,1,[ADKL]Swich,2749,1460,54,53,107,50.5%,1h
23520,3,[TSC2C]KlimovRI,2749,555,47,34,81,58.0%,14m
23520,1,Zebralol,2749,877,35,26,61,57.4%,1h
23520,1,GrTony,2749,428,34,30,64,53.1%,1h
23520,3,noza,2749,933,34,31,65,52.3%,22m
23520,1,yMe,2749,700,32,21,53,60.4%,19m
23520,3,Flesh,2749,874,32,34,66,48.5%,3m
23520,1,Chef,2749,842,29,26,55,52.7%,10m
23520,3,StrongBoy,2749,439,29,33,62,46.8%,10m
23520,3,Xerotu,2749,614,26,22,48,54.2%,18m
23520,1,PAVEL,2749,68,25,32,57,43.9%,23m
23520,3,llllllllllll,2749,511,21,25,46,45.7%,9m
23520,3,Boonya,2749,515,20,23,43,46.5%,21m
23520,3,[eli]Adam,2749,281,13,5,18,72.2%,17m
23520,1,Light,2749,452,13,14,27,48.1%,5m
23520,1,[ZERGTV]eXeZ,2749,393,12,8,20,60.0%,21m
23520,1,racistprobe,2749,300,9,8,17,52.9%,1h
23520,1,Lapuh,2749,230,6,2,8,75.0%,1h
23520,3,Pentarh,2749,178,6,9,15,40.0%,23m
23520,3,Theoor,2749,178,6,10,16,37.5%,3m
23520,3,JOKERR,2749,122,6,11,17,35.3%,10m
23520,1,Heyoxe,2749,219,5,3,8,62.5%,5m
23520,3,Garcea,2749,148,5,9,14,35.7%,13m
23520,3,Vince,2749,142,5,11,16,31.2%,14m
23520,3,Bushwacker,2749,132,4,3,7,57.1%,16m
23520,1,Neofitik,2749,108,4,4,8,50.0%,5m
23520,3,ModesT,2749,92,4,9,13,30.8%,12m
23520,1,zzz,2749,142,3,4,7,42.9%,4m
23520,1,Rusviets,2749,114,3,12,15,20.0%,21m
23520,3,Wysiwyg,2749,0,2,3,5,40.0%,1h
23520,2,[VFIP]ThoOor,2749,0,1,0,1,100.0%,15m
23520,1,Unbinilium,2749,88,1,1,2,50.0%,16m
23520,3,senpstrategy,2749,0,1,3,4,25.0%,10m
23520,1,[PlayPG]Shooter,2749,0,0,1,1,0.0%,4m
23520,1,[ǺŁǻşłđ]DEVOSTATOR,2749,0,0,1,1,0.0%,14m
23558,1,Yldechire,2748,630,21,16,37,56.8%,60m
23558,3,Funzzy,2748,443,19,15,34,55.9%,19m
23558,1,GriMariN,2748,491,17,9,26,65.4%,20m
23558,3,BARcode,2748,361,17,12,29,58.6%,23m
23558,2,[SCSh1t]Benchpress,2748,504,17,29,46,37.0%,8m
23558,3,Evgded,2748,234,12,17,29,41.4%,8m
23558,3,Woytas,2748,151,11,9,20,55.0%,18m
23558,1,blingbling,2748,330,9,4,13,69.2%,59m
23558,3,[HZeS]Deadanarchit,2748,206,8,3,11,72.7%,20m
23558,2,NasH,2748,218,8,12,20,40.0%,5m
23558,3,Mefvne,2748,171,7,8,15,46.7%,53m
23558,1,NoEloNoGirls,2748,236,6,3,9,66.7%,59m
23558,1,TSsixtyONE,2748,192,6,3,9,66.7%,19m
23558,3,kickmen,2748,142,6,9,15,40.0%,13m
23558,1,Pizdator,2748,196,5,6,11,45.5%,59m
23558,3,TheKid,2748,120,4,8,12,33.3%,17m
23558,2,[lg90]Thanos,2748,0,3,2,5,60.0%,5m
23558,3,XYZ,2748,147,3,4,7,42.9%,52m
23558,3,Niklos,2748,58,3,10,13,23.1%,20m
23558,2,Melkor,2748,94,2,0,2,100.0%,1h
23558,1,EnriquE,2748,44,2,2,4,50.0%,1h
23558,1,LifeisDance,2748,80,2,4,6,33.3%,1h
23558,3,StarLord,2748,60,2,7,9,22.2%,19m
23558,1,[Тагил]Тагил,2748,0,1,0,1,100.0%,1h
23558,2,SND,2748,0,1,0,1,100.0%,15m
23558,1,bruh,2748,0,1,0,1,100.0%,25m
23558,1,FanTik,2748,0,1,1,2,50.0%,1h
23558,1,[BuGG3R]Geri,2748,34,1,3,4,25.0%,54m
23558,1,EndJoyPain,2748,38,1,4,5,20.0%,1h
23587,1,[NLTN]GoodDad,2747,1627,212,211,423,50.1%,8m
23587,1,Icon,2747,1444,186,185,371,50.1%,12m
23587,2,senya,2747,1558,102,102,204,50.0%,10m
23587,3,Ocin,2747,1176,90,77,167,53.9%,17m
23587,3,[Tостер]Винипух,2747,1541,76,82,158,48.1%,15m
23587,3,Nikita,2747,764,28,31,59,47.5%,22m
23587,1,Robpolle,2747,652,22,18,40,55.0%,1h
23587,1,InSidE,2747,416,13,13,26,50.0%,1h
23587,3,[VARP]PUSTOTA,2747,382,13,15,28,46.4%,4m
23587,1,Frankoi,2747,323,11,13,24,45.8%,25m
23587,1,[Tales]Russltime,2747,316,10,6,16,62.5%,22m
23587,2,Kocour,2747,316,10,20,30,33.3%,18m
23587,3,[FTWWP]GoShoKoNq,2747,30,1,11,12,8.3%,10m
23587,1,SilverHaze,2747,0,0,1,1,0.0%,60m
23587,1,limha,2747,73,0,2,2,0.0%,57m
23587,2,DEKU,2747,0,0,2,2,0.0%,1h
23587,1,sukramk,2747,0,0,2,2,0.0%,1h
23604,3,Crazy,2746,1523,251,251,502,50.0%,12m
23604,1,StarTed,2746,1745,185,165,350,52.9%,1h
23604,1,IgorP,2746,1521,93,96,189,49.2%,16m
23604,1,MrMonkey,2746,1649,90,74,164,54.9%,1h
23604,1,saracin,2746,1016,61,58,119,51.3%,22m
23604,3,Django,2746,861,50,50,100,50.0%,3m
23604,3,AttilaHM,2746,967,49,37,86,57.0%,18m
23604,1,Virel,2746,995,40,35,75,53.3%,1h
23604,3,FuzziMaster,2746,696,28,23,51,54.9%,24m
23604,3,Konne,2746,451,19,18,37,51.4%,9m
23604,3,snickles,2746,489,18,19,37,48.6%,21m
23604,1,[GdAT]Ciclyde,2746,467,15,11,26,57.7%,1h
23604,1,[WWTG]ElNegrito,2746,179,5,0,5,100.0%,21m
23604,1,[Knopf]Murkilover,2746,138,4,3,7,57.1%,1h
23604,3,StarCaptain,2746,30,4,4,8,50.0%,24m
23604,1,[MIG]Brunis,2746,78,3,2,5,60.0%,20m
23604,1,fcolorz,2746,159,3,5,8,37.5%,5m
23604,3,battleking,2746,16,3,10,13,23.1%,18m
23604,1,[urEZ]Terror,2746,90,2,0,2,100.0%,19m
23604,3,Stephan,2746,30,2,3,5,40.0%,51m
23604,1,GrizzlyKtbR,2746,0,1,1,2,50.0%,5m
23604,1,Faint,2746,96,1,1,2,50.0%,1h
23604,3,[Mavis]iboga,2746,0,1,2,3,33.3%,1h
23604,3,ColdRevenge,2746,30,1,6,7,14.3%,19m
23604,1,[RüMBo]JoBro,2746,0,0,1,1,0.0%,1h
23604,1,[13221]Filip,2746,0,0,1,1,0.0%,60m
23604,1,Abrikakosik,2746,0,0,1,1,0.0%,1h
23604,1,Laziale,2746,0,0,5,5,0.0%,1h
23632,3,achil,2745,1573,259,250,509,50.9%,17m
23632,1,MasoSamurai,2745,1049,104,101,205,50.7%,25m
23632,1,ositoblanco,2745,1264,99,114,213,46.5%,23m
23632,1,[gogone]Unkh,2745,1708,96,80,176,54.5%,25m
23632,3,ThatVMike,2745,1484,69,68,137,50.4%,8m
23632,3,DogsGang,2745,1306,66,51,117,56.4%,13m
23632,3,charlotte,2745,850,65,53,118,55.1%,19m
23632,3,Tatyana,2745,1495,61,54,115,53.0%,24m
23632,1,hankdatank,2745,923,47,41,88,53.4%,51m
23632,3,NOOBER,2745,730,29,27,56,51.8%,23m
23632,2,MGK,2745,404,14,21,35,40.0%,6m
23632,2,BleedFast,2745,297,12,11,23,52.2%,1h
23632,1,NIck,2745,343,11,6,17,64.7%,9m
23632,3,Flavis,2745,264,11,10,21,52.4%,8m
23632,1,GREG,2745,343,10,8,18,55.6%,1h
23632,1,FoxPS,2745,241,8,7,15,53.3%,51m
23632,3,Nichois,2745,242,8,12,20,40.0%,4m
23632,1,Pukkancs,2745,176,5,3,8,62.5%,54m
23632,2,[WARBL]Kiéros,2745,139,5,4,9,55.6%,1h
23632,3,GhoSTSLON,2745,114,4,4,8,50.0%,19m
23632,2,AliseMadness,2745,48,4,5,9,44.4%,1h
23632,1,CutieBST,2745,93,3,3,6,50.0%,25m
23632,2,palindrome,2745,0,3,3,6,50.0%,20m
23632,3,[KLK]Josar,2745,0,2,3,5,40.0%,5m
23632,1,Dirtypeanuts,2745,40,2,5,7,28.6%,10m
23632,1,[Baise]Baise,2745,40,1,1,2,50.0%,54m
23632,2,zarak,2745,94,1,1,2,50.0%,17m
23632,1,[C0oL6]Coolgiaco,2745,0,1,2,3,33.3%,57m
23632,1,xyz,2745,0,1,2,3,33.3%,54m
23632,1,[PILarm]BITIandRENA,2745,48,1,4,5,20.0%,24m
23632,1,WHITEPANZA,2745,0,0,1,1,0.0%,1h
23632,1,Donar,2745,0,0,1,1,0.0%,14m
23632,1,DaXbentzx,2745,0,0,1,1,0.0%,12m
23632,1,eXeCutor,2745,0,0,2,2,0.0%,1h
23666,3,absolout,2744,1539,253,236,489,51.7%,20m
23666,1,chrisugru,2744,1469,123,136,259,47.5%,21m
23666,3,ZolaMcByrne,2744,1569,74,77,151,49.0%,5m
23666,3,МетельДуши,2744,1082,47,34,81,58.0%,7m
23666,1,Hornedal,2744,865,37,27,64,57.8%,1h
23666,3,Nagzul,2744,837,36,26,62,58.1%,9m
23666,3,Nik,2744,1003,36,37,73,49.3%,13m
23666,1,destroer,2744,497,14,11,25,56.0%,57m
23666,1,[z0o]Cow,2744,416,12,10,22,54.5%,22m
23666,2,thekiller,2744,314,10,22,32,31.2%,22m
23666,1,rapmaxter,2744,346,9,6,15,60.0%,4m
23666,2,ДИТМАР,2744,30,6,4,10,60.0%,16m
23666,1,RAGE,2744,97,4,5,9,44.4%,24m
23666,3,[oniz]Gentleman,2744,92,4,9,13,30.8%,21m
23666,3,[ArDoC]onelastkiss,2744,90,4,12,16,25.0%,16m
23666,3,JarJarBinx,2744,94,3,10,13,23.1%,13m
23666,3,Virtex,2744,62,3,10,13,23.1%,6m
23666,1,Graf,2744,80,2,1,3,66.7%,5m
23666,1,Hornet,2744,0,2,3,5,40.0%,1h
23666,1,Dischi,2744,0,1,0,1,100.0%,1h
23666,1,JackMoZ,2744,48,1,1,2,50.0%,52m
23666,1,DarKLeGioN,2744,40,1,1,2,50.0%,3m
23666,1,[Elimin]patalisk,2744,0,1,1,2,50.0%,19m
23666,1,Valhalla,2744,34,1,2,3,33.3%,1h
23666,1,ZEF,2744,42,1,2,3,33.3%,1h
23666,3,kid,2744,97,1,2,3,33.3%,1h
23666,3,GhoSt,2744,0,1,7,8,12.5%,20m
23666,1,ezMMR,2744,0,0,1,1,0.0%,10m
23666,3,[J4E]Rosebud,2744,0,0,5,5,0.0%,17m
23666,3,[EHET]LeChatVentru,2744,0,0,7,7,0.0%,20m
23696,3,joelka,2743,1537,315,303,618,51.0%,19m
23696,2,JIMBO,2743,1018,147,157,304,48.4%,12m
23696,3,LiquidKisya,2743,1003,127,110,237,53.6%,21m
23696,3,Hatrun,2743,1332,76,65,141,53.9%,20m
23696,3,komandaa,2743,951,63,53,116,54.3%,8m
23696,1,[WADER]RAMOBIL,2743,1074,48,24,72,66.7%,1h
23696,3,[esox]barcode,2743,1044,46,38,84,54.8%,19m
23696,3,[GаVnO]Alpheratz,2743,1036,39,39,78,50.0%,12m
23696,1,[Mouuz]FelixUwU,2743,848,38,24,62,61.3%,1h
23696,1,Sticky,2743,632,19,17,36,52.8%,6m
23696,3,OBrother,2743,330,11,9,20,55.0%,1h
23696,1,[B4EV]Cephero,2743,323,10,24,34,29.4%,23m
23696,1,Kira,2743,302,9,3,12,75.0%,56m
23696,3,LurryFan,2743,266,8,10,18,44.4%,1h
23696,3,Джо,2743,176,7,5,12,58.3%,17m
23696,3,Stapler,2743,176,6,12,18,33.3%,17m
23696,1,MukolaUA,2743,146,5,2,7,71.4%,19m
23696,1,Enzyme,2743,150,5,4,9,55.6%,1h
23696,1,MrFiasco,2743,154,5,6,11,45.5%,10m
23696,2,Lukysswek,2743,0,4,1,5,80.0%,1h
23696,2,Novagenetics,2743,0,4,2,6,66.7%,1h
23696,1,JustGo,2743,76,3,1,4,75.0%,21m
23696,1,PhOne,2743,88,3,3,6,50.0%,4m
23696,2,Bazuzu,2743,0,3,4,7,42.9%,13m
23696,1,EsKa,2743,48,2,3,5,40.0%,53m
23696,1,artanis,2743,0,1,1,2,50.0%,57m
23696,1,MEGaboss,2743,34,1,2,3,33.3%,60m
23696,1,[NINJ88]Ant,2743,0,1,2,3,33.3%,25m
23696,1,[iX]Robert,2743,73,1,4,5,20.0%,1h
23696,1,[LQV]Mike,2743,0,0,1,1,0.0%,4m
23696,2,Renholt,2743,0,0,2,2,0.0%,1h
23727,2,[BloTi]Tino,2742,1524,252,254,506,49.8%,6m
23727,3,[nagib7]pizzazz,2742,1563,163,156,319,51.1%,8m
23727,2,Derfee,2742,1459,139,136,275,50.5%,13m
23727,3,Twe,2742,1367,108,73,181,59.7%,17m
23727,3,Blakcat,2742,1183,57,43,100,57.0%,3m
23727,3,Nobody,2742,348,29,18,47,61.7%,12m
23727,3,ArkMan,2742,769,29,29,58,50.0%,20m
23727,1,ITACHI,2742,582,28,26,54,51.9%,1h
23727,1,[JCLM]Yomi,2742,740,23,21,44,52.3%,21m
23727,3,nefas,2742,547,20,21,41,48.8%,19m
23727,3,Benoit,2742,461,18,19,37,48.6%,17m
23727,1,Monocerus,2742,519,15,18,33,45.5%,55m
23727,1,[fFlags]zrn,2742,338,13,8,21,61.9%,1h
23727,1,LaSaK,2742,362,13,10,23,56.5%,4m
23727,2,[RIZY]attaka,2742,96,8,10,18,44.4%,1h
23727,3,[mCb]KAMIONČINA,2742,244,8,11,19,42.1%,12m
23727,1,help,2742,230,7,8,15,46.7%,1h
23727,1,flashscorer,2742,186,6,5,11,54.5%,1h
23727,1,Babai,2742,156,5,5,10,50.0%,1h
23727,2,[LVFRVR]ShdwComrade,2742,166,5,6,11,45.5%,16m
23727,3,Aangevinkt,2742,30,5,8,13,38.5%,12m
23727,3,Keyzx,2742,159,4,5,9,44.4%,7m
23727,1,crymo,2742,152,4,5,9,44.4%,56m
23727,1,[8DJ8]mhY,2742,148,4,7,11,36.4%,1h
23727,1,[Ar4ont]Сенко,2742,68,3,1,4,75.0%,16m
23727,1,Fedkil,2742,0,2,3,5,40.0%,1h
23727,3,Renan,2742,0,2,3,5,40.0%,13m
23727,2,null,2742,0,2,4,6,33.3%,1h
23727,2,[Jürgen]dani,2742,48,2,6,8,25.0%,1h
23727,3,Taïb,2742,30,2,6,8,25.0%,17m
23727,1,Carbon,2742,40,1,1,2,50.0%,51m
23727,1,BackPocket,2742,0,1,1,2,50.0%,60m
23727,3,BraKouZe,2742,0,1,4,5,20.0%,1h
23727,3,Valv,2742,0,0,1,1,0.0%,3m
23727,1,Sharlash,2742,0,0,1,1,0.0%,1h
23727,1,Thordran,2742,0,0,2,2,0.0%,10m
23727,1,gooogenot,2742,0,0,5,5,0.0%,60m
23764,2,Yohm,2741,1643,282,276,558,50.5%,10m
23764,3,ANAKO,2741,1544,278,273,551,50.5%,20m
23764,3,Makaveli,2741,1309,85,57,142,59.9%,14m
23764,3,[YPC]Federkick,2741,1547,69,74,143,48.3%,16m
23764,3,sanderxdxd,2741,1100,49,49,98,50.0%,13m
23764,2,medmark,2741,995,36,49,85,42.4%,15m
23764,1,victor,2741,1021,34,33,67,50.7%,1h
23764,2,LevhearttSun,2741,616,31,35,66,47.0%,21m
23764,3,ДоДиГы,2741,468,25,27,52,48.1%,18m
23764,1,Borat,2741,638,23,17,40,57.5%,3m
23764,3,Dols,2741,496,20,16,36,55.6%,18m
23764,3,[Cigar]TomRipley,2741,408,18,12,30,60.0%,9m
23764,3,khaz,2741,470,17,20,37,45.9%,4m
23764,3,Gaston,2741,379,12,17,29,41.4%,20m
23764,2,Broze,2741,249,12,18,30,40.0%,6m
23764,1,Frostyk,2741,272,8,3,11,72.7%,16m
23764,1,NEIO,2741,292,8,5,13,61.5%,1h
23764,1,Rekhorn,2741,232,8,7,15,53.3%,4m
23764,1,Icepick,2741,256,7,10,17,41.2%,21m
23764,1,Pix,2741,196,6,4,10,60.0%,8m
23764,3,Coagulator,2741,208,6,7,13,46.2%,23m
23764,3,Samnya,2741,146,6,8,14,42.9%,6m
23764,3,[VIGO14]sethone,2741,186,6,14,20,30.0%,5m
23764,3,Апкурыш,2741,188,5,3,8,62.5%,55m
23764,1,[Penile]Koetjeownz,2741,122,4,5,9,44.4%,1h
23764,1,Basic,2741,133,3,1,4,75.0%,1h
23764,1,Rancho,2741,32,2,3,5,40.0%,14m
23764,1,SteAltH,2741,72,2,3,5,40.0%,10m
23764,1,Agga,2741,0,1,0,1,100.0%,1h
23764,1,JACMOC,2741,38,1,1,2,50.0%,1h
23764,1,MostWanted,2741,48,1,2,3,33.3%,56m
23764,1,[8ASD8]MacInsch,2741,40,1,4,5,20.0%,5m
23764,3,demich,2741,0,1,4,5,20.0%,1h
23764,1,noxan,2741,0,1,4,5,20.0%,1h
23764,2,[BTCS]Pepy,2741,0,0,1,1,0.0%,51m
23764,2,steelllion,2741,0,0,3,3,0.0%,1h
23800,1,frank,2740,1536,339,317,656,51.7%,6m
23800,1,ElRey,2740,1536,337,321,658,51.2%,8m
23800,3,[NPGV]Grosmeuhmeuh,2740,1581,207,209,416,49.8%,23m
23800,3,Ice,2740,1505,188,173,361,52.1%,10m
23800,3,Pulcozyklon,2740,1532,116,114,230,50.4%,15m
23800,3,Link,2740,1001,81,70,151,53.6%,5m
23800,3,LUKAS,2740,1400,76,70,146,52.1%,20m
23800,1,Harry,2740,785,33,16,49,67.3%,60m
23800,1,[17RED]zelim,2740,744,26,19,45,57.8%,19m
23800,1,[glhf20]alexander,2740,758,24,21,45,53.3%,19m
23800,3,Fizif,2740,535,23,20,43,53.5%,3m
23800,1,Splicer,2740,488,19,20,39,48.7%,51m
23800,1,Wertyn,2740,363,16,5,21,76.2%,1h
23800,3,VIKINGR,2740,230,16,8,24,66.7%,4m
23800,2,SneakyGerri,2740,464,16,22,38,42.1%,21m
23800,1,[QTcIub]Supersamu,2740,400,13,11,24,54.2%,57m
23800,3,Kontent,2740,0,5,0,5,100.0%,16m
23800,2,Gorwin,2740,104,3,5,8,37.5%,16m
23800,1,eRUha,2740,0,2,3,5,40.0%,57m
23800,1,Serge,2740,0,1,0,1,100.0%,1h
23800,1,ALFML,2740,95,1,1,2,50.0%,6m
23800,1,Deadmike,2740,34,1,1,2,50.0%,8m
23800,2,[Tripin]SiCKO,2740,0,0,1,1,0.0%,1h
23800,3,Ilfirin,2740,0,0,3,3,0.0%,55m
23824,2,shama,2739,1563,145,152,297,48.8%,21m
23824,1,Tazz,2739,1398,98,86,184,53.3%,9m
23824,1,Nikolai,2739,1497,93,79,172,54.1%,25m
23824,1,[Wizar]GRifon,2739,1659,83,72,155,53.5%,6m
23824,3,Hoffloff,2739,512,35,28,63,55.6%,13m
23824,1,Nik,2739,542,25,12,37,67.6%,6m
23824,3,Nochnushka,2739,667,24,26,50,48.0%,8m
23824,1,[Degro]lel,2739,448,17,11,28,60.7%,4m
23824,3,Bober,2739,458,16,17,33,48.5%,22m
23824,1,[SCZA]Nihilim,2739,411,12,17,29,41.4%,59m
23824,3,Gurduk,2739,243,10,10,20,50.0%,20m
23824,1,DNNS,2739,214,7,8,15,46.7%,14m
23824,3,[bvbo9]painuser,2739,220,7,9,16,43.8%,4m
23824,3,Maskalin,2739,142,5,9,14,35.7%,21m
23824,2,leDJo,2739,23,3,11,14,21.4%,15m
23824,1,Copixgo,2739,78,2,1,3,66.7%,1h
23824,1,dawids,2739,42,2,3,5,40.0%,1h
23824,1,[QTcIub]DeltaPhoenix,2739,73,2,3,5,40.0%,16m
23824,1,JoWa,2739,0,1,0,1,100.0%,56m
23824,3,czeFish,2739,30,1,6,7,14.3%,5m
23824,1,LePheonix,2739,0,0,2,2,0.0%,10m
23845,1,BurnToHell,2738,1557,64,51,115,55.7%,53m
23845,1,Civvic,2738,587,29,23,52,55.8%,3m
23845,3,Haiwis,2738,404,26,24,50,52.0%,8m
23845,1,TrustNoOne,2738,548,18,17,35,51.4%,10m
23845,1,margincall,2738,414,17,16,33,51.5%,19m
23845,1,KeminSSHKG,2738,314,12,11,23,52.2%,1h
23845,1,NoobMagnet,2738,348,11,7,18,61.1%,1h
23845,3,Stoik,2738,288,11,9,20,55.0%,19m
23845,3,RUSSIA,2738,152,6,8,14,42.9%,4m
23845,3,Korchem,2738,120,5,7,12,41.7%,13m
23845,1,[Avngrs]Thor,2738,118,3,4,7,42.9%,21m
23845,1,sulu,2738,120,3,5,8,37.5%,1h
23845,1,supermurloc,2738,0,2,1,3,66.7%,21m
23845,3,HumHum,2738,30,2,4,6,33.3%,4m
23845,2,Anton,2738,0,1,0,1,100.0%,51m
23845,1,[Clakos]Sage,2738,0,1,0,1,100.0%,23m
23845,1,Ollowain,2738,0,1,0,1,100.0%,24m
23845,1,BadaBadMan,2738,0,1,0,1,100.0%,6m
23845,1,dot,2738,42,1,1,2,50.0%,1h
23845,3,Botsia,2738,0,1,5,6,16.7%,22m
23845,2,[BWArmy]Medianboard,2738,0,0,1,1,0.0%,4m
23845,2,Dimian,2738,0,0,1,1,0.0%,1h
23845,1,Gnaeus,2738,0,0,1,1,0.0%,52m
23845,2,skitoo,2738,0,0,1,1,0.0%,1h
23845,1,Fastigull,2738,0,0,3,3,0.0%,16m
23870,2,DuqueMDJ,2737,1557,310,310,620,50.0%,3m
23870,1,Touine,2737,1632,89,57,146,61.0%,1h
23870,1,insect,2737,925,53,2,55,96.4%,1h
23870,3,Whutai,2737,747,49,37,86,57.0%,17m
23870,1,BiggaPigga,2737,1076,40,34,74,54.1%,14m
23870,1,[TaMort]DontCryBaby,2737,675,27,15,42,64.3%,24m
23870,1,GWarZ,2737,703,24,36,60,40.0%,19m
23870,1,SalntDeVll,2737,430,23,15,38,60.5%,1h
23870,3,RatonLaveur,2737,563,21,20,41,51.2%,9m
23870,3,RayS,2737,408,17,16,33,51.5%,3m
23870,3,[MSUSC2]nJIeCeHb,2737,426,17,19,36,47.2%,7m
23870,2,Daliuxas,2737,390,15,15,30,50.0%,9m
23870,1,Szczur,2737,276,11,8,19,57.9%,59m
23870,3,[EASY]Guiz,2737,250,10,13,23,43.5%,10m
23870,1,gamadril,2737,261,8,8,16,50.0%,6m
23870,1,[TkcS]ZAGHOST,2737,264,8,9,17,47.1%,1h
23870,3,[NuBz]Jitsu,2737,49,6,15,21,28.6%,18m
23870,1,Nooby,2737,162,5,3,8,62.5%,24m
23870,1,Ajr,2737,124,4,4,8,50.0%,14m
23870,2,RiseofLambs,2737,178,4,8,12,33.3%,1h
23870,3,[ЗИБиАГ]BeTaL,2737,0,3,1,4,75.0%,24m
23870,1,[37ers]Biercarsten,2737,78,3,2,5,60.0%,1h
23870,3,Matterai,2737,0,3,4,7,42.9%,17m
23870,3,SnaiLy,2737,107,3,5,8,37.5%,4m
23870,1,Dorian,2737,0,1,0,1,100.0%,23m
23870,2,SGTJohnson,2737,46,1,1,2,50.0%,1h
23870,1,[GlNYU]Kakarot,2737,0,1,2,3,33.3%,1h
23870,1,Slava,2737,40,1,3,4,25.0%,19m
23870,1,tsunamiro,2737,40,1,4,5,20.0%,1h
23870,1,Shiner,2737,0,0,1,1,0.0%,1h
23870,1,[0G]Dynamic,2737,73,0,3,3,0.0%,5m
23870,3,edel,2737,0,0,5,5,0.0%,20m
23902,3,kREst,2736,1204,272,242,514,52.9%,13m
23902,3,Dimash,2736,1454,143,144,287,49.8%,7m
23902,3,Valett,2736,1316,105,96,201,52.2%,17m
23902,1,Limit,2736,1723,90,75,165,54.5%,9m
23902,3,[K0RM2]RobotGG,2736,1280,57,45,102,55.9%,24m
23902,3,BriVicShadow,2736,812,32,29,61,52.5%,22m
23902,3,[SanFam]Wrykut,2736,693,24,24,48,50.0%,19m
23902,1,JustaFan,2736,432,18,13,31,58.1%,20m
23902,1,breakworm,2736,364,11,11,22,50.0%,24m
23902,3,Гоал,2736,270,10,7,17,58.8%,16m
23902,2,jDtFesS,2736,277,7,14,21,33.3%,10m
23902,1,ApoK,2736,200,6,4,10,60.0%,10m
23902,1,cost,2736,136,6,5,11,54.5%,1h
23902,2,Notexist,2736,235,6,6,12,50.0%,10m
23902,3,Dragoda,2736,146,5,10,15,33.3%,21m
23902,1,NaP,2736,88,3,3,6,50.0%,1h
23902,3,Maximus,2736,40,3,3,6,50.0%,1h
23902,1,Manu,2736,78,3,4,7,42.9%,1h
23902,1,rozimbabwe,2736,86,3,7,10,30.0%,1h
23902,3,Jochem,2736,90,3,8,11,27.3%,24m
23902,3,badarty,2736,60,3,10,13,23.1%,4m
23902,1,[1FU2]kpax,2736,40,2,0,2,100.0%,3m
23902,3,DENDY,2736,0,2,3,5,40.0%,20m
23902,3,RukPro,2736,60,2,6,8,25.0%,13m
23902,3,Fogux,2736,62,2,11,13,15.4%,11m
23902,1,[ZERG7V]cmcm,2736,30,1,1,2,50.0%,3m
23902,1,Unleashed,2736,0,1,9,10,10.0%,3m
23902,3,Rheas,2736,0,0,1,1,0.0%,51m
23902,1,Волжанин,2736,0,0,4,4,0.0%,57m
23902,3,BlazerMan,2736,0,0,5,5,0.0%,16m
23902,3,[PiGPan]DAniilcola,2736,0,0,6,6,0.0%,13m
23933,3,NeoPaul,2735,1473,79,74,153,51.6%,6m
23933,1,Spork,2735,1585,63,55,118,53.4%,14m
23933,1,[wpwpwp]Positron,2735,1345,50,46,96,52.1%,1h
23933,1,BigPi,2735,1229,45,40,85,52.9%,1h
23933,2,Savinov,2735,262,44,35,79,55.7%,21m
23933,1,[DvX]Boroda,2735,1140,39,39,78,50.0%,1h
23933,1,blackout,2735,932,33,24,57,57.9%,1h
23933,2,[PøM]Cavalon,2735,798,31,34,65,47.7%,10m
23933,1,Krckoop,2735,640,25,29,54,46.3%,6m
23933,1,FuNdaMentaL,2735,624,18,16,34,52.9%,19m
23933,2,Alchemic,2735,416,18,17,35,51.4%,3m
23933,3,Lightning,2735,411,17,4,21,81.0%,1h
23933,2,Ooniki,2735,506,17,24,41,41.5%,21m
23933,1,Protothrope,2735,432,14,9,23,60.9%,3m
23933,3,ciceron,2735,356,13,15,28,46.4%,16m
23933,3,Fenixfallen,2735,255,12,17,29,41.4%,4m
23933,3,[HNG]Szymon,2735,330,11,11,22,50.0%,20m
23933,3,Zertung,2735,219,8,10,18,44.4%,1h
23933,1,iksdede,2735,229,7,10,17,41.2%,17m
23933,1,ExtraChasm,2735,195,6,8,14,42.9%,21m
23933,3,[DYPKA]Arhewarious,2735,114,5,7,12,41.7%,13m
23933,1,[wN5]Vanan,2735,114,4,2,6,66.7%,12m
23933,1,Ilie,2735,78,3,0,3,100.0%,9m
23933,2,Genrih,2735,106,3,6,9,33.3%,59m
23933,3,HeX,2735,145,3,6,9,33.3%,4m
23933,1,pomes,2735,74,2,3,5,40.0%,10m
23933,2,BakaSan,2735,60,2,10,12,16.7%,7m
23933,1,Brizzy,2735,0,1,0,1,100.0%,1h
23933,1,[GIKI]shaghab,2735,34,1,1,2,50.0%,1h
23933,1,[Swaagy]MelchChue,2735,0,1,1,2,50.0%,1h
23933,3,Dops,2735,95,1,5,6,16.7%,6m
23933,3,[sofas]vinni,2735,0,0,1,1,0.0%,1h
23933,1,Darun,2735,0,0,1,1,0.0%,1h
23933,1,Leeu,2735,0,0,1,1,0.0%,22m
23933,2,McLovin,2735,0,0,1,1,0.0%,5m
23933,2,MndCommander,2735,0,0,2,2,0.0%,22m
23933,2,[VaNa]DeeCeeCee,2735,0,0,3,3,0.0%,10m
23933,1,Mafyak,2735,0,0,6,6,0.0%,10m
23971,3,[xKillx]hairdie,2734,1491,113,109,222,50.9%,6m
23971,3,NoFtwoNoob,2734,1566,95,101,196,48.5%,20m
23971,2,Polishrider,2734,1447,92,84,176,52.3%,17m
23971,3,[Oupss]Padawan,2734,1000,91,88,179,50.8%,4m
23971,3,Rihtar,2734,1544,87,82,169,51.5%,5m
23971,3,tzchaplov,2734,1236,75,64,139,54.0%,18m
23971,3,Sugarfree,2734,400,53,46,99,53.5%,18m
23971,3,good,2734,827,50,33,83,60.2%,18m
23971,3,MrBunglee,2734,766,50,47,97,51.5%,12m
23971,3,CyberCutlet,2734,1162,49,45,94,52.1%,24m
23971,3,Refsuion,2734,927,34,33,67,50.7%,15m
23971,1,Faeton,2734,692,21,23,44,47.7%,24m
23971,1,one,2734,463,19,18,37,51.4%,5m
23971,1,[WHOOY]Hellraver,2734,504,15,15,30,50.0%,17m
23971,3,Sensei,2734,423,14,16,30,46.7%,8m
23971,3,Mendo,2734,260,12,12,24,50.0%,6m
23971,3,oui,2734,334,12,19,31,38.7%,7m
23971,2,domeyeah,2734,248,10,10,20,50.0%,16m
23971,3,ThreeA,2734,268,10,15,25,40.0%,12m
23971,3,[LRDP]Scrats,2734,218,8,10,18,44.4%,5m
23971,1,[DBr]Titou,2734,179,7,6,13,53.8%,1h
23971,1,[Due]Arteros,2734,196,6,5,11,54.5%,20m
23971,1,[APATOU]Caserne,2734,213,5,6,11,45.5%,1h
23971,1,Demion,2734,186,5,7,12,41.7%,1h
23971,3,[isIMBA]Escobar,2734,118,5,9,14,35.7%,14m
23971,3,HexepHaxep,2734,144,5,11,16,31.2%,19m
23971,3,Nory,2734,140,5,12,17,29.4%,3m
23971,3,Thelegionaer,2734,0,4,1,5,80.0%,22m
23971,1,Vypeer,2734,136,3,2,5,60.0%,60m
23971,3,[Hanz0]linonemas,2734,42,3,3,6,50.0%,25m
23971,1,[ZERG7V]ЛягушкаЛяга,2734,40,2,0,2,100.0%,3m
23971,1,[NuRe]Control,2734,42,2,3,5,40.0%,5m
23971,3,[CC4N]Finwecillo,2734,0,2,4,6,33.3%,21m
23971,3,Хомяк,2734,121,2,7,9,22.2%,12m
23971,1,BlindNoob,2734,38,1,2,3,33.3%,1h
23971,3,[QTclub]Rey,2734,0,1,2,3,33.3%,22m
23971,1,[AOTW]Blooddy,2734,0,0,1,1,0.0%,1h
23971,1,[Medoed]art,2734,0,0,3,3,0.0%,1h
23971,1,Franjesco,2734,0,0,3,3,0.0%,1h
24010,3,MicroondasR,2733,1347,151,155,306,49.3%,21m
24010,1,ReDDot,2733,1115,46,42,88,52.3%,23m
24010,2,BlackBeard,2733,1034,41,45,86,47.7%,15m
24010,1,Kamen,2733,1085,41,56,97,42.3%,22m
24010,1,Psychrolutes,2733,920,36,30,66,54.5%,1h
24010,3,Bocks,2733,658,29,28,57,50.9%,20m
24010,3,DrkSideotSun,2733,784,28,37,65,43.1%,11m
24010,1,[SKYBRS]Ianofc,2733,514,20,20,40,50.0%,16m
24010,1,LadderMan,2733,482,17,15,32,53.1%,4m
24010,3,berber,2733,452,16,20,36,44.4%,19m
24010,3,DonPiff,2733,390,14,15,29,48.3%,22m
24010,3,Victus,2733,229,8,6,14,57.1%,9m
24010,3,[TFSC]aaa,2733,210,7,11,18,38.9%,8m
24010,1,Starbloodman,2733,0,2,2,4,50.0%,19m
24010,3,[PF2]ScoobyDoo,2733,0,2,3,5,40.0%,5m
24010,1,jupi,2733,0,2,3,5,40.0%,21m
24010,3,[nyst]Marteen,2733,58,2,8,10,20.0%,11m
24010,3,Superbird,2733,0,1,0,1,100.0%,22m
24010,1,Thrax,2733,0,1,0,1,100.0%,6m
24010,2,SkipLegDay,2733,46,1,1,2,50.0%,1h
24010,1,[LI69]Anushunter,2733,38,1,2,3,33.3%,1h
24010,1,[Whizka]Hellcore,2733,0,1,3,4,25.0%,9m
24010,1,Ukropchik,2733,0,0,1,1,0.0%,21m
24010,1,[aDGa]inqisitorgfd,2733,0,0,1,1,0.0%,5m
24010,3,ololo,2733,0,0,5,5,0.0%,20m
24035,1,zombie,2732,1098,336,328,664,50.6%,20m
24035,1,Gogolacticot,2732,1720,128,111,239,53.6%,9m
24035,1,Atze,2732,865,77,64,141,54.6%,19m
24035,3,CryptoKittie,2732,1165,54,41,95,56.8%,17m
24035,3,demum,2732,1011,39,37,76,51.3%,18m
24035,1,idavid,2732,907,33,23,56,58.9%,24m
24035,1,GhostMarine,2732,718,30,16,46,65.2%,9m
24035,2,Ostkaka,2732,437,18,22,40,45.0%,6m
24035,3,Ares,2732,318,10,17,27,37.0%,17m
24035,3,IvO,2732,274,9,11,20,45.0%,23m
24035,2,MrDeagle,2732,173,8,18,26,30.8%,10m
24035,1,Chalik,2732,192,7,5,12,58.3%,1h
24035,1,[RBlood]Akinetsu,2732,152,5,4,9,55.6%,55m
24035,1,[hf4X4]Fix,2732,62,5,9,14,35.7%,5m
24035,1,KozmaPrutkov,2732,100,4,3,7,57.1%,53m
24035,2,Sysplex,2732,114,4,4,8,50.0%,5m
24035,1,maxclon,2732,144,4,5,9,44.4%,1h
24035,2,omgwtf,2732,139,4,5,9,44.4%,1h
24035,1,Cambrinus,2732,128,2,6,8,25.0%,51m
24035,1,[BaSpIn]DeusEx,2732,0,1,0,1,100.0%,16m
24035,1,Misquamacus,2732,40,1,1,2,50.0%,6m
24035,1,[KAT]Manflik,2732,0,1,2,3,33.3%,1h
24035,3,eCakes,2732,30,1,9,10,10.0%,4m
24035,1,WooWooKhan,2732,0,0,2,2,0.0%,9m
24035,1,Millimister,2732,0,0,4,4,0.0%,20m
24060,1,TakiZBlizna,2731,1398,117,100,217,53.9%,51m
24060,3,Koro,2731,908,86,67,153,56.2%,3m
24060,1,[ЕМPIRE]Ranger,2731,1354,61,48,109,56.0%,25m
24060,3,superariel,2731,1428,53,53,106,50.0%,10m
24060,2,Dzik,2731,617,24,27,51,47.1%,17m
24060,3,chern,2731,313,19,15,34,55.9%,22m
24060,3,Synti,2731,419,18,19,37,48.6%,7m
24060,1,Original,2731,470,14,13,27,51.9%,1h
24060,1,[HBGSJR]Taruviel,2731,319,12,0,12,100.0%,51m
24060,3,farbeyon,2731,145,5,6,11,45.5%,22m
24060,1,CoteDeBoeuf,2731,120,4,3,7,57.1%,24m
24060,1,xStream,2731,122,4,4,8,50.0%,25m
24060,3,BunkerRush,2731,92,3,4,7,42.9%,18m
24060,1,Kragoth,2731,0,2,3,5,40.0%,14m
24060,1,[LMBD]GRRRRRRRRRR,2731,0,2,3,5,40.0%,14m
24060,3,firstgame,2731,0,2,3,5,40.0%,4m
24060,2,Tomoprof,2731,48,2,7,9,22.2%,1h
24060,1,MistaEvil,2731,0,1,0,1,100.0%,1h
24060,1,Lokierin,2731,0,1,0,1,100.0%,19m
24060,1,damage,2731,0,1,1,2,50.0%,24m
24060,1,Taiga,2731,0,1,1,2,50.0%,1h
24060,3,letmefun,2731,0,1,11,12,8.3%,22m
24060,1,Johan,2731,0,0,1,1,0.0%,1h
24060,1,HunTRDMNK,2731,0,0,1,1,0.0%,10m
24060,1,Ataklos,2731,0,0,1,1,0.0%,14m
24085,3,[LOGS]Chinis,2730,1534,143,130,273,52.4%,20m
24085,1,rradu,2730,1504,55,50,105,52.4%,6m
24085,3,Dektral,2730,1057,42,38,80,52.5%,9m
24085,1,Merasmus,2730,608,26,13,39,66.7%,60m
24085,3,EveRag,2730,536,19,24,43,44.2%,4m
24085,1,Skroma,2730,435,17,6,23,73.9%,1h
24085,3,WhiteShadow,2730,393,14,16,30,46.7%,13m
24085,3,[SLW]NainPro,2730,358,13,21,34,38.2%,6m
24085,1,CountNumbers,2730,288,12,3,15,80.0%,12m
24085,3,crunck,2730,267,12,11,23,52.2%,59m
24085,1,testtest,2730,207,6,4,10,60.0%,4m
24085,1,Askios,2730,145,6,4,10,60.0%,5m
24085,2,Samurai,2730,141,5,5,10,50.0%,12m
24085,1,shmrckelzz,2730,156,4,1,5,80.0%,1h
24085,1,[RBTV3]DAWǂAlcatraz,2730,159,4,6,10,40.0%,3m
24085,3,Magemanne,2730,92,4,7,11,36.4%,19m
24085,2,гноммаг,2730,0,3,1,4,75.0%,21m
24085,3,curiosity,2730,40,3,3,6,50.0%,3m
24085,1,[SERBS]Edge,2730,74,3,5,8,37.5%,24m
24085,1,Nath,2730,42,2,2,4,50.0%,17m
24085,1,Marcassin,2730,0,1,0,1,100.0%,1h
24085,1,РодомизДоты,2730,40,1,2,3,33.3%,21m
24085,1,Michnek,2730,0,1,3,4,25.0%,6m
24085,1,plmario,2730,0,0,1,1,0.0%,17m
24085,1,Kunini,2730,0,0,1,1,0.0%,1h
24085,3,Oden,2730,0,0,7,7,0.0%,1h
24111,3,Gunslinger,2729,1580,164,161,325,50.5%,20m
24111,3,Herkruk,2729,1533,86,76,162,53.1%,3m
24111,1,[zuzia]Sigal,2729,708,64,37,101,63.4%,51m
24111,3,GGman,2729,902,34,40,74,45.9%,20m
24111,2,[HMB]Tydirius,2729,210,19,20,39,48.7%,21m
24111,1,StarLight,2729,319,14,13,27,51.9%,54m
24111,3,Gambuz,2729,382,14,18,32,43.8%,4m
24111,3,Ingeniator,2729,287,11,7,18,61.1%,21m
24111,3,winstrol,2729,177,10,18,28,35.7%,23m
24111,1,Alexander,2729,209,9,11,20,45.0%,17m
24111,1,[DRЕAM]Khael,2729,218,9,11,20,45.0%,1h
24111,3,Papus,2729,228,9,13,22,40.9%,20m
24111,2,RAZZER,2729,25,8,11,19,42.1%,1h
24111,3,RedMag,2729,190,7,8,15,46.7%,6m
24111,1,Cbastian,2729,118,6,7,13,46.2%,24m
24111,1,JustCasual,2729,102,5,6,11,45.5%,1h
24111,3,Budas,2729,60,5,6,11,45.5%,17m
24111,3,MigzR,2729,203,5,7,12,41.7%,18m
24111,1,[GWN]idanmenashes,2729,0,4,1,5,80.0%,1h
24111,1,[GAGO]Cookiss,2729,190,4,2,6,66.7%,24m
24111,1,[XGKS]PeCoRiNa,2729,74,3,3,6,50.0%,23m
24111,1,Exodia,2729,97,3,3,6,50.0%,1h
24111,1,Denain,2729,38,2,1,3,66.7%,54m
24111,1,Dragonjuni,2729,0,2,3,5,40.0%,1h
24111,1,Gonzo,2729,0,1,0,1,100.0%,1h
24111,1,wurth,2729,0,1,0,1,100.0%,1h
24111,1,ALEX,2729,38,1,1,2,50.0%,1h
24111,1,[3ЕRGTV]HoMyDoHell,2729,0,1,1,2,50.0%,6m
24111,1,terminator,2729,40,1,2,3,33.3%,25m
24111,1,[JRSC]KingNatsu,2729,0,1,2,3,33.3%,60m
24111,1,WOTHAN,2729,0,0,2,2,0.0%,1h
24111,1,knockyou,2729,73,0,3,3,0.0%,13m
24143,1,zottelkopp,2728,1751,279,266,545,51.2%,1h
24143,1,Tiberiy,2728,1676,124,123,247,50.2%,21m
24143,1,Jullyan,2728,1677,76,74,150,50.7%,1h
24143,3,aRoNwAr,2728,1331,57,44,101,56.4%,21m
24143,2,Krendel,2728,511,43,49,92,46.7%,16m
24143,1,Kyle,2728,517,17,11,28,60.7%,60m
24143,1,[Маньяк]llllllllllll,2728,240,10,3,13,76.9%,1h
24143,1,Flaknes,2728,261,8,9,17,47.1%,1h
24143,1,BKG,2728,214,7,4,11,63.6%,1h
24143,2,Max,2728,221,6,6,12,50.0%,1h
24143,1,Cyberwill,2728,118,4,3,7,57.1%,1h
24143,1,[WLE]freya,2728,76,3,2,5,60.0%,51m
24143,2,RemDor,2728,0,3,4,7,42.9%,19m
24143,2,[PKTS]maye,2728,114,2,2,4,50.0%,1h
24143,1,Cannonfodder,2728,0,1,0,1,100.0%,5m
24143,1,Woland,2728,0,0,1,1,0.0%,59m
24143,1,[EFEct]Blackrain,2728,0,0,1,1,0.0%,60m
24143,1,Fyodor,2728,0,0,1,1,0.0%,6m
24161,3,Nyachi,2727,1505,90,84,174,51.7%,12m
24161,1,Bleziior,2727,782,65,57,122,53.3%,1h
24161,1,neo,2727,1607,61,55,116,52.6%,25m
24161,1,csdemons,2727,1117,49,28,77,63.6%,1h
24161,3,Sinthoras,2727,604,26,22,48,54.2%,19m
24161,1,Nagato,2727,450,20,13,33,60.6%,19m
24161,1,BasperJruts,2727,573,19,15,34,55.9%,17m
24161,1,Majooo,2727,476,14,13,27,51.9%,3m
24161,3,filippk,2727,304,12,12,24,50.0%,6m
24161,1,DarkShiado,2727,448,12,17,29,41.4%,1h
24161,3,vaniljen,2727,282,11,11,22,50.0%,9m
24161,1,JamesBond,2727,212,7,6,13,53.8%,1h
24161,3,[SC2DES]PokerFace,2727,225,7,9,16,43.8%,17m
24161,3,[Pkr]CeLu,2727,170,7,11,18,38.9%,9m
24161,1,[1FU2]ДоставкаСуши,2727,173,5,0,5,100.0%,51m
24161,1,Borsti,2727,175,5,1,6,83.3%,51m
24161,2,LexxLutiy,2727,94,5,2,7,71.4%,51m
24161,1,УбийцаЛохов,2727,154,5,3,8,62.5%,51m
24161,1,DyOZ,2727,0,4,4,8,50.0%,5m
24161,1,hotti,2727,97,4,5,9,44.4%,4m
24161,1,sketch,2727,82,3,1,4,75.0%,16m
24161,2,Fanboi,2727,110,3,3,6,50.0%,52m
24161,1,Terak,2727,42,3,4,7,42.9%,1h
24161,3,Rice,2727,60,3,6,9,33.3%,14m
24161,1,TheKing,2727,0,2,3,5,40.0%,1h
24161,1,AcidCraft,2727,0,2,3,5,40.0%,1h
24161,1,АТРАНАХ,2727,0,1,1,2,50.0%,53m
24161,1,Emily,2727,40,1,2,3,33.3%,21m
24161,2,[CSJCSJ]skoddet,2727,0,0,1,1,0.0%,1h
24161,1,NightOwlvQ,2727,0,0,1,1,0.0%,1h
24191,2,Wrestl,2726,1273,141,152,293,48.1%,9m
24191,3,ВыШиБаТеЛь,2726,1244,89,81,170,52.4%,6m
24191,3,Avacs,2726,1615,82,78,160,51.2%,10m
24191,3,psi,2726,563,61,44,105,58.1%,22m
24191,2,OnlyFrans,2726,1166,60,57,117,51.3%,18m
24191,1,SickFish,2726,906,41,39,80,51.2%,24m
24191,1,EndIsNear,2726,595,30,19,49,61.2%,14m
24191,1,pit,2726,852,30,30,60,50.0%,1h
24191,3,Hummingbird,2726,718,28,28,56,50.0%,3m
24191,3,Raven,2726,769,27,29,56,48.2%,10m
24191,1,Serral,2726,400,13,7,20,65.0%,25m
24191,1,IvanDTrrible,2726,306,10,12,22,45.5%,56m
24191,2,Speeuser,2726,256,10,23,33,30.3%,5m
24191,1,лох,2726,228,7,3,10,70.0%,1h
24191,1,SamuraiJack,2726,156,4,1,5,80.0%,17m
24191,3,Lumbris,2726,149,4,3,7,57.1%,1h
24191,3,Dylan,2726,0,3,2,5,60.0%,1h
24191,3,lettor,2726,97,3,3,6,50.0%,1h
24191,3,StahanFX,2726,60,3,6,9,33.3%,12m
24191,3,GerhardsLV,2726,0,2,3,5,40.0%,1h
24191,3,Bowser,2726,0,2,3,5,40.0%,1h
24191,1,[MGNFL]Bisondou,2726,0,2,3,5,40.0%,59m
24191,1,[BPPS]MoltenPucki,2726,0,1,1,2,50.0%,51m
24191,1,SilkShadow,2726,0,1,3,4,25.0%,1h
24191,1,[Fnatik]Арсанис,2726,0,0,1,1,0.0%,1h
24216,1,MaximeTattoo,2725,1717,183,174,357,51.3%,9m
24216,3,IIIIIIIIIIII,2725,1372,119,117,236,50.4%,20m
24216,1,DIMASGANJU,2725,1742,71,64,135,52.6%,1h
24216,1,KokaDIY,2725,1445,55,52,107,51.4%,1h
24216,1,GreenGenyó,2725,1254,48,35,83,57.8%,1h
24216,3,mogulsport,2725,739,46,39,85,54.1%,9m
24216,1,mlem,2725,555,31,18,49,63.3%,21m
24216,1,ZeBigorno,2725,509,17,20,37,45.9%,1h
24216,1,MrAcidManiac,2725,356,10,10,20,50.0%,13m
24216,1,VAV,2725,358,9,12,21,42.9%,6m
24216,1,Meatpants,2725,183,6,6,12,50.0%,19m
24216,1,timoxa,2725,198,5,6,11,45.5%,58m
24216,3,[INCV]SPECAIL,2725,156,5,15,20,25.0%,16m
24216,3,Heppy,2725,151,4,6,10,40.0%,15m
24216,2,EugeneUkr,2725,154,4,7,11,36.4%,9m
24216,2,[owKho]Doyle,2725,96,3,4,7,42.9%,1h
24216,1,DarkLord,2725,121,2,7,9,22.2%,52m
24216,1,[Crews]MrSkiller,2725,0,1,0,1,100.0%,51m
24216,2,AsphyXia,2725,0,1,1,2,50.0%,1h
24216,2,[НH]Merdrim,2725,0,1,3,4,25.0%,20m
24216,1,Circlepit,2725,0,0,4,4,0.0%,19m
24237,1,MidiV,2724,1531,151,147,298,50.7%,1h
24237,1,MRT,2724,1511,86,81,167,51.5%,58m
24237,1,CultOfThree,2724,671,62,61,123,50.4%,3m
24237,1,CORONAVR,2724,1390,56,53,109,51.4%,16m
24237,1,Hakan,2724,1164,47,35,82,57.3%,17m
24237,2,BigStone,2724,1013,42,43,85,49.4%,4m
24237,1,softarn,2724,552,23,20,43,53.5%,16m
24237,3,Bantus,2724,427,17,16,33,51.5%,17m
24237,3,HandyR,2724,440,17,19,36,47.2%,10m
24237,1,sterejo,2724,431,14,13,27,51.9%,17m
24237,1,Pontorama,2724,216,7,7,14,50.0%,1h
24237,3,[BLAT]Camil,2724,152,5,13,18,27.8%,13m
24237,1,Captain,2724,148,4,4,8,50.0%,51m
24237,2,Kei,2724,0,3,4,7,42.9%,1h
24237,3,[0BO]Slowmotion,2724,58,3,8,11,27.3%,18m
24237,3,Ironhide,2724,86,3,9,12,25.0%,15m
24237,1,Кипятильник,2724,40,2,3,5,40.0%,1h
24237,1,Jupyter,2724,96,2,4,6,33.3%,1h
24237,1,Michael,2724,0,1,0,1,100.0%,5m
24237,1,Widow,2724,0,1,1,2,50.0%,10m
24237,3,Pruto,2724,38,1,4,5,20.0%,1h
24237,1,Elvesto,2724,48,1,5,6,16.7%,1h
24237,1,Rastafan,2724,0,0,1,1,0.0%,56m
24237,2,barisay,2724,0,0,1,1,0.0%,53m
24261,3,OneFootNinja,2723,1223,64,66,130,49.2%,9m
24261,3,Daemos,2723,1017,41,35,76,53.9%,6m
24261,3,llllllllllll,2723,486,39,40,79,49.4%,23m
24261,3,freedom,2723,729,31,28,59,52.5%,17m
24261,1,MarkoKMG,2723,811,30,25,55,54.5%,1h
24261,1,Wooper,2723,492,28,31,59,47.5%,21m
24261,3,jwe,2723,738,26,29,55,47.3%,10m
24261,1,duncan,2723,592,24,21,45,53.3%,5m
24261,3,Patates,2723,649,23,26,49,46.9%,19m
24261,1,MrRestless,2723,374,22,19,41,53.7%,54m
24261,3,[RuVoid]Predator,2723,365,21,6,27,77.8%,20m
24261,3,PoppelNase,2723,521,18,17,35,51.4%,21m
24261,2,sky,2723,410,17,17,34,50.0%,8m
24261,3,Marceline,2723,372,13,19,32,40.6%,10m
24261,1,[BTAG]Real,2723,416,12,13,25,48.0%,24m
24261,3,[Маньяк]llllllllllll,2723,213,9,3,12,75.0%,9m
24261,3,FluOw,2723,221,7,8,15,46.7%,9m
24261,1,VoltD,2723,199,5,3,8,62.5%,1h
24261,1,Sebo,2723,180,5,9,14,35.7%,1h
24261,1,Peppone,2723,169,4,1,5,80.0%,23m
24261,1,Chocio,2723,0,4,1,5,80.0%,54m
24261,1,Tomlifeepl,2723,183,4,7,11,36.4%,1h
24261,1,[Heroes]pavele,2723,108,3,3,6,50.0%,1h
24261,1,Bluntus,2723,140,3,5,8,37.5%,17m
24261,1,MikleOP,2723,38,2,0,2,100.0%,9m
24261,3,DrillLing,2723,0,2,3,5,40.0%,1h
24261,1,[sOv2]Abacus,2723,92,2,4,6,33.3%,5m
24261,3,Candleholder,2723,0,1,0,1,100.0%,1h
24261,1,[Gоld]dmGre,2723,0,1,1,2,50.0%,1h
24261,1,[TFIJ]miraculmix,2723,40,1,3,4,25.0%,1h
24261,1,Xerox,2723,0,0,1,1,0.0%,55m
24261,1,Shieldur,2723,0,0,1,1,0.0%,6m
24261,3,[xMDx]simonmnb,2723,0,0,1,1,0.0%,1h
24261,1,IIIIIII,2723,0,0,5,5,0.0%,21m
24261,3,[ЕхТ]EvilSS,2723,0,0,7,7,0.0%,1h
24296,1,Goodween,2722,851,75,71,146,51.4%,5m
24296,1,SELECT,2722,1239,43,37,80,53.8%,3m
24296,1,VOVAINUA,2722,1204,41,44,85,48.2%,1h
24296,3,WitchKing,2722,796,33,30,63,52.4%,20m
24296,1,[guilla]llunydecasa,2722,646,24,17,41,58.5%,57m
24296,1,[Br0k3n]Wingz,2722,377,15,12,27,55.6%,54m
24296,1,Votavic,2722,344,13,13,26,50.0%,6m
24296,1,STARrussher,2722,294,12,3,15,80.0%,1h
24296,1,Ravil,2722,398,12,14,26,46.2%,20m
24296,1,mezozou,2722,403,11,9,20,55.0%,21m
24296,3,GhostDragon,2722,281,11,9,20,55.0%,18m
24296,1,[J4E]Knochenkopf,2722,274,10,3,13,76.9%,54m
24296,1,Sean,2722,193,9,2,11,81.8%,1h
24296,1,gjp,2722,272,8,8,16,50.0%,1h
24296,1,[SunWu]moiultra,2722,190,7,7,14,50.0%,1h
24296,1,Pain,2722,236,6,4,10,60.0%,1h
24296,1,kinze,2722,132,4,3,7,57.1%,6m
24296,1,Mozart,2722,114,4,6,10,40.0%,58m
24296,2,Silvio,2722,117,3,3,6,50.0%,1h
24296,2,Maks,2722,136,3,5,8,37.5%,1h
24296,2,Norbert,2722,0,2,2,4,50.0%,1h
24296,3,Aluë,2722,0,2,3,5,40.0%,58m
24296,3,DawnStar,2722,36,2,8,10,20.0%,4m
24296,1,BiGCliCk,2722,0,1,1,2,50.0%,16m
24296,1,[TRGV]Juk,2722,40,1,2,3,33.3%,25m
24296,1,[LnRF]Stefnir,2722,40,1,3,4,25.0%,3m
24296,3,Ammko,2722,42,1,3,4,25.0%,22m
24296,3,[Kjell]mRandy,2722,0,0,1,1,0.0%,1h
24296,1,[MooooN]SIRMAX,2722,0,0,1,1,0.0%,19m
24296,2,[3DE]JOSHAN,2722,0,0,1,1,0.0%,56m
24296,1,Multikiller,2722,0,0,1,1,0.0%,1h
24296,1,sjaakbouw,2722,0,0,1,1,0.0%,6m
24296,1,Olivermars,2722,0,0,1,1,0.0%,6m
24296,1,[Łegend]GeshHoliday,2722,0,0,2,2,0.0%,6m
24296,3,Eric,2722,0,0,2,2,0.0%,8m
24296,1,Luckschaden,2722,0,0,2,2,0.0%,1h
24296,3,Yxo,2722,0,0,6,6,0.0%,23m
24296,3,Valgard,2722,0,0,13,13,0.0%,11m
24334,2,[YASSS]JOKER,2721,1564,232,228,460,50.4%,13m
24334,3,oarin,2721,1490,156,156,312,50.0%,20m
24334,1,[NLTN]StoneColdIKE,2721,1449,106,127,233,45.5%,18m
24334,1,[fade50]schützegarte,2721,1382,66,64,130,50.8%,18m
24334,3,Samojang,2721,479,63,58,121,52.1%,19m
24334,3,Necro,2721,1324,49,54,103,47.6%,15m
24334,1,EnsElEyici,2721,881,41,56,97,42.3%,10m
24334,1,Graabein,2721,847,34,26,60,56.7%,6m
24334,1,Tscherno,2721,846,33,28,61,54.1%,5m
24334,1,[Exiled]dale,2721,849,30,32,62,48.4%,1h
24334,3,ErikJanB,2721,734,25,29,54,46.3%,19m
24334,1,[kiborg]Ковказец,2721,740,23,20,43,53.5%,1h
24334,1,Lion,2721,419,18,12,30,60.0%,25m
24334,3,Bigmac,2721,284,10,15,25,40.0%,21m
24334,1,ERIKtheRED,2721,179,5,3,8,62.5%,6m
24334,1,QuBuS,2721,161,5,3,8,62.5%,1h
24334,3,Outzide,2721,0,3,2,5,60.0%,1h
24334,1,Elterven,2721,36,2,0,2,100.0%,56m
24334,1,Nekles,2721,42,2,0,2,100.0%,51m
24334,1,[MaGeOn]Geronimo,2721,40,2,2,4,50.0%,1h
24334,1,nEwRace,2721,0,2,3,5,40.0%,1h
24334,3,Lutrainsec,2721,0,2,3,5,40.0%,19m
24334,3,Nikolas,2721,0,2,3,5,40.0%,1h
24334,1,[KaMakt]Zeke,2721,0,1,1,2,50.0%,1h
24334,3,[POV3]masterstone,2721,30,1,6,7,14.3%,22m
24334,3,[TrZP]UnxstdMatter,2721,0,0,1,1,0.0%,1h
24334,1,Obiwan,2721,0,0,2,2,0.0%,5m
24361,2,Kida,2720,1560,201,196,397,50.6%,21m
24361,1,CarlsVerg,2720,1735,147,145,292,50.3%,1h
24361,3,glencore,2720,1219,136,122,258,52.7%,9m
24361,3,jizzgoood,2720,1476,131,122,253,51.8%,17m
24361,3,LeonGlanz,2720,1324,121,104,225,53.8%,17m
24361,1,SmuttZoR,2720,1593,88,68,156,56.4%,60m
24361,2,[3ЕRGTV]Toorka,2720,1323,85,75,160,53.1%,6m
24361,1,Jethro,2720,902,60,51,111,54.1%,60m
24361,3,Nide,2720,1230,44,52,96,45.8%,23m
24361,3,Mariusxxz,2720,713,41,40,81,50.6%,16m
24361,3,Caldazar,2720,912,38,41,79,48.1%,19m
24361,3,Tywka,2720,723,28,29,57,49.1%,15m
24361,2,Nitro,2720,584,20,32,52,38.5%,13m
24361,1,[sQnPL]DzikiWiesiek,2720,502,15,16,31,48.4%,15m
24361,3,Judicator,2720,320,13,13,26,50.0%,18m
24361,1,Noul,2720,321,12,3,15,80.0%,24m
24361,3,ItsWillie,2720,194,9,7,16,56.2%,21m
24361,1,bureLomwOw,2720,211,8,6,14,57.1%,19m
24361,2,MAloy,2720,201,8,10,18,44.4%,1h
24361,3,Butterkeks,2720,228,7,9,16,43.8%,4m
24361,3,Deadly,2720,146,7,10,17,41.2%,4m
24361,1,[BobSem]Shootingshy,2720,224,6,6,12,50.0%,1h
24361,1,[INCTS]QuillZel,2720,168,5,2,7,71.4%,6m
24361,2,Boniek,2720,158,5,5,10,50.0%,1h
24361,3,Cristi,2720,118,5,8,13,38.5%,18m
24361,3,[FF88]WhiteBear,2720,161,4,1,5,80.0%,1h
24361,3,FLASTIK,2720,96,4,9,13,30.8%,12m
24361,1,[Vipera]Aspis,2720,128,3,0,3,100.0%,51m
24361,2,Prataimaster,2720,136,3,0,3,100.0%,24m
24361,1,DoomGay,2720,0,2,4,6,33.3%,17m
24361,1,AHOHuCT,2720,0,1,0,1,100.0%,51m
24361,1,Faceguy,2720,0,1,2,3,33.3%,58m
24361,1,[1AFK1]LordMarcus,2720,0,0,2,2,0.0%,23m
24361,1,heeranz,2720,0,0,3,3,0.0%,17m
24361,1,iamsama,2720,0,0,4,4,0.0%,23m
24396,1,Tiny,2719,1410,331,315,646,51.2%,1h
24396,3,FinalDegree,2719,1105,239,213,452,52.9%,18m
24396,1,Fon,2719,1469,70,61,131,53.4%,1h
24396,2,Sergon,2719,1059,65,70,135,48.1%,8m
24396,1,Olen,2719,895,47,46,93,50.5%,1h
24396,1,Artanis,2719,1138,45,39,84,53.6%,5m
24396,1,Desperado,2719,835,42,20,62,67.7%,1h
24396,3,Pinch,2719,803,32,34,66,48.5%,9m
24396,1,[Alling]Gørdøn,2719,702,24,19,43,55.8%,1h
24396,1,ELMartinjo,2719,494,21,11,32,65.6%,1h
24396,1,ParadoxOn,2719,523,20,10,30,66.7%,3m
24396,1,Merser,2719,508,18,12,30,60.0%,3m
24396,3,GaToDiAz,2719,421,17,23,40,42.5%,11m
24396,1,Ginger,2719,240,15,8,23,65.2%,1h
24396,2,[p11k]marinebarveg,2719,452,15,28,43,34.9%,4m
24396,3,RobotNinja,2719,261,12,17,29,41.4%,21m
24396,1,David,2719,259,8,8,16,50.0%,53m
24396,1,NoClue,2719,266,7,9,16,43.8%,1h
24396,1,AaikOo,2719,160,5,6,11,45.5%,59m
24396,1,RyukoMatoi,2719,196,5,7,12,41.7%,1h
24396,1,ProCek,2719,76,3,2,5,60.0%,1h
24396,3,Ares,2719,44,3,3,6,50.0%,13m
24396,3,KimchiMan,2719,0,2,3,5,40.0%,1h
24396,3,Memsen,2719,0,2,3,5,40.0%,1h
24396,1,Shkvoren,2719,0,2,3,5,40.0%,15m
24396,1,philipp,2719,80,2,4,6,33.3%,1h
24396,3,Warchild,2719,30,2,6,8,25.0%,14m
24396,1,WishbonE,2719,0,0,1,1,0.0%,26m
24396,1,aliencash,2719,0,0,1,1,0.0%,1h
24396,1,Phil,2719,0,0,2,2,0.0%,3m
24396,1,[antkr]Holshok,2719,0,0,2,2,0.0%,22m
24396,2,chucknorris,2719,0,0,4,4,0.0%,52m
24428,3,isaew,2718,1176,97,99,196,49.5%,4m
24428,1,Raicer,2718,1193,46,37,83,55.4%,24m
24428,1,Crystalize,2718,823,44,31,75,58.7%,1h
24428,1,[Brest]TITAN,2718,1171,40,39,79,50.6%,10m
24428,1,Najash,2718,1016,39,36,75,52.0%,16m
24428,1,RamasChamas,2718,894,31,31,62,50.0%,1h
24428,3,Mengsk,2718,431,17,13,30,56.7%,7m
24428,1,HorrorGhost,2718,594,17,21,38,44.7%,1h
24428,1,Quadrix,2718,352,12,12,24,50.0%,1h
24428,1,Lozano,2718,316,11,10,21,52.4%,21m
24428,1,Lolikuh,2718,244,8,3,11,72.7%,1h
24428,3,xDontxCryx,2718,228,8,16,24,33.3%,8m
24428,1,Licorico,2718,111,7,5,12,58.3%,51m
24428,2,Vönz,2718,140,6,7,13,46.2%,18m
24428,2,denjoR,2718,62,5,7,12,41.7%,10m
24428,3,NaX,2718,55,5,9,14,35.7%,7m
24428,1,Partybreaker,2718,80,2,3,5,40.0%,1h
24428,1,[НТТ]DarkDay,2718,0,1,0,1,100.0%,1h
24428,3,Gill,2718,0,1,3,4,25.0%,18m
24428,2,[Zhig]MATru,2718,46,1,3,4,25.0%,1h
24428,1,MaD,2718,115,1,4,5,20.0%,1h
24428,1,RusSpirit,2718,38,1,4,5,20.0%,51m
24428,1,Haldadrin,2718,0,0,1,1,0.0%,5m
24428,1,domod,2718,0,0,1,1,0.0%,1h
24428,1,[Arrows]Limbo,2718,0,0,1,1,0.0%,1h
24453,1,IKSDE,2717,1741,167,152,319,52.4%,23m
24453,3,Longcraft,2717,1587,151,148,299,50.5%,20m
24453,1,танто,2717,1497,144,126,270,53.3%,14m
24453,1,WoHoOVERTIME,2717,1623,129,118,247,52.2%,26m
24453,2,[0tLb0]Aturo,2717,899,54,56,110,49.1%,6m
24453,3,Googulag,2717,984,36,39,75,48.0%,13m
24453,3,PsychoWizard,2717,537,21,18,39,53.8%,13m
24453,1,happymadmen,2717,282,11,7,18,61.1%,1h
24453,1,Ulfsaar,2717,276,11,9,20,55.0%,13m
24453,3,decto,2717,339,11,13,24,45.8%,20m
24453,3,MoeSzyslak,2717,172,8,8,16,50.0%,23m
24453,1,[ZhMi]BilektCZ,2717,264,7,4,11,63.6%,19m
24453,2,[MHK]Albatros,2717,172,7,8,15,46.7%,17m
24453,2,[Messy]Athena,2717,172,6,6,12,50.0%,1h
24453,3,MATEUSZ,2717,201,6,8,14,42.9%,9m
24453,1,kronk,2717,154,5,7,12,41.7%,16m
24453,3,Yeti,2717,124,5,11,16,31.2%,19m
24453,2,Aron,2717,161,4,4,8,50.0%,59m
24453,1,VLADiK,2717,114,3,3,6,50.0%,9m
24453,1,[Fxnadu]Harfang,2717,143,3,4,7,42.9%,55m
24453,1,Bob,2717,108,2,1,3,66.7%,1h
24453,1,[DL2006]Roithar,2717,36,2,1,3,66.7%,1h
24453,1,[50shds]Tol,2717,0,2,3,5,40.0%,1h
24453,1,AMarty,2717,0,2,3,5,40.0%,1h
24453,1,antisatsuma,2717,76,2,4,6,33.3%,1h
24453,3,[MDM4]Freshbread,2717,118,2,7,9,22.2%,9m
24453,3,shadowStorm,2717,62,2,7,9,22.2%,12m
24453,1,[Рачелы]Seesker,2717,0,1,0,1,100.0%,57m
24453,1,[Bádzsó]nerelf,2717,0,0,4,4,0.0%,1h
24482,1,[nepal]Kellahselai,2716,804,55,32,87,63.2%,25m
24482,3,shaMash,2716,1204,53,42,95,55.8%,9m
24482,1,VracaCity,2716,1132,38,42,80,47.5%,1h
24482,3,Bloodshot,2716,815,34,34,68,50.0%,7m
24482,1,PsychoSiS,2716,925,32,32,64,50.0%,10m
24482,1,ЛаО,2716,561,20,21,41,48.8%,5m
24482,1,LuckyTiger,2716,406,18,7,25,72.0%,1h
24482,1,jkeyser,2716,332,11,5,16,68.8%,1h
24482,3,rogana,2716,325,11,11,22,50.0%,11m
24482,3,Enlightened,2716,275,10,15,25,40.0%,20m
24482,1,Drezdensiti,2716,290,9,8,17,52.9%,1h
24482,1,Bleys,2716,163,6,5,11,54.5%,4m
24482,3,[NSc1]Kir,2716,195,5,7,12,41.7%,17m
24482,1,MAREKSHMEL,2716,146,4,4,8,50.0%,10m
24482,2,[ELO3]Gruqer,2716,117,4,4,8,50.0%,59m
24482,3,Hydromel,2716,163,4,7,11,36.4%,5m
24482,2,zawarud,2716,0,3,4,7,42.9%,20m
24482,3,[SEC31]Cryscha,2716,94,2,4,6,33.3%,17m
24482,3,Dorn,2716,122,2,6,8,25.0%,23m
24482,1,[k1raen]CorbenDallas,2716,0,1,0,1,100.0%,1h
24482,1,[NRVG]KillerAmy,2716,0,1,0,1,100.0%,20m
24482,1,Astrolord,2716,0,1,0,1,100.0%,1h
24482,1,[OwlNsk]SiberianOwls,2716,0,0,1,1,0.0%,57m
24482,1,[lCAJ]Majorproblem,2716,0,0,1,1,0.0%,1h
24482,1,CapitanVaims,2716,0,0,1,1,0.0%,6m
24482,3,[Hаsu]Brightfuture,2716,0,0,2,2,0.0%,22m
24508,2,husocan,2715,1589,402,404,806,49.9%,13m
24508,2,[UAŦeam]Bogdan,2715,1481,104,110,214,48.6%,24m
24508,2,Terranimo,2715,1165,96,103,199,48.2%,10m
24508,3,Drakers,2715,774,94,86,180,52.2%,21m
24508,3,lostone,2715,1081,68,60,128,53.1%,6m
24508,3,Exit,2715,280,38,41,79,48.1%,23m
24508,3,SadPanda,2715,816,30,35,65,46.2%,18m
24508,3,TYRevelation,2715,647,27,23,50,54.0%,19m
24508,3,LOL,2715,421,17,17,34,50.0%,15m
24508,3,Ruka,2715,292,11,17,28,39.3%,4m
24508,1,Stongolbest,2715,318,10,11,21,47.6%,10m
24508,1,Matrixar,2715,261,9,16,25,36.0%,1h
24508,3,xeno,2715,88,7,6,13,53.8%,20m
24508,2,ДЖАПАР,2715,108,7,8,15,46.7%,16m
24508,1,vlastilin,2715,120,5,2,7,71.4%,1h
24508,1,Bledge,2715,197,5,3,8,62.5%,57m
24508,1,Nebenhode,2715,122,4,4,8,50.0%,16m
24508,2,Verus,2715,123,4,4,8,50.0%,1h
24508,1,Starscream,2715,124,4,4,8,50.0%,5m
24508,3,Tejonte,2715,42,3,3,6,50.0%,19m
24508,2,Stuey,2715,94,3,4,7,42.9%,1h
24508,2,Moritz,2715,0,2,3,5,40.0%,23m
24508,1,AlexFranta,2715,0,2,3,5,40.0%,1h
24508,2,[Ob8G]IconicKnight,2715,0,1,3,4,25.0%,1h
24508,1,КРАБ,2715,40,1,4,5,20.0%,19m
24508,1,Voidmonger,2715,0,1,4,5,20.0%,1h
24508,1,Dionis,2715,0,0,1,1,0.0%,1h
24508,1,Baksay,2715,0,0,1,1,0.0%,1h
24508,1,phoenix,2715,0,0,1,1,0.0%,58m
24508,1,XXXRany,2715,0,0,2,2,0.0%,19m
24508,1,QuickBen,2715,0,0,5,5,0.0%,1h
24539,3,[QaQa]Quasar,2714,824,324,323,647,50.1%,17m
24539,3,Cypher,2714,1506,87,89,176,49.4%,20m
24539,3,LazyRush,2714,1580,86,82,168,51.2%,5m
24539,3,Schleicher,2714,1175,68,64,132,51.5%,16m
24539,3,[oAOPo]MAROILLES,2714,1362,67,64,131,51.1%,25m
24539,3,PERAL,2714,1366,54,48,102,52.9%,20m
24539,1,JCVD,2714,674,26,18,44,59.1%,1h
24539,3,[DiDZ]Czarny,2714,578,19,26,45,42.2%,21m
24539,1,Elyzea,2714,383,18,2,20,90.0%,55m
24539,1,Spurcius,2714,388,14,7,21,66.7%,51m
24539,2,Happytas,2714,279,11,13,24,45.8%,1h
24539,1,Ziko,2714,412,11,16,27,40.7%,1h
24539,1,OnionSoup,2714,207,9,5,14,64.3%,1h
24539,1,TMX,2714,226,8,3,11,72.7%,1h
24539,3,[BuCrew]masssterBiH,2714,256,8,10,18,44.4%,8m
24539,3,tikondrus,2714,167,7,6,13,53.8%,6m
24539,1,Shemhazai,2714,249,6,5,11,54.5%,4m
24539,1,VasaZaicev,2714,125,5,5,10,50.0%,1h
24539,2,Myn,2714,184,4,3,7,57.1%,16m
24539,1,Draren,2714,112,4,5,9,44.4%,1h
24539,1,BiniBan,2714,119,3,1,4,75.0%,25m
24539,1,NasikFury,2714,48,2,1,3,66.7%,12m
24539,3,Saint,2714,0,2,3,5,40.0%,1h
24539,1,Poof,2714,42,1,2,3,33.3%,1h
24539,1,Longable,2714,0,0,1,1,0.0%,1h
24539,3,TerranBroken,2714,0,0,4,4,0.0%,57m
24539,1,YLsIntoTanks,2714,0,0,5,5,0.0%,5m
24566,1,twocap,2713,1124,64,54,118,54.2%,20m
24566,3,YYds,2713,1107,43,44,87,49.4%,5m
24566,1,[DТ]BeelzeBul,2713,786,32,22,54,59.3%,1h
24566,3,[salvo]yoda,2713,817,31,32,63,49.2%,9m
24566,1,[RAYDOR]Eilysium,2713,630,25,18,43,58.1%,51m
24566,1,Autotret,2713,596,20,14,34,58.8%,6m
24566,3,LukiKing,2713,516,20,19,39,51.3%,4m
24566,2,[Miiik]crobe,2713,320,12,20,32,37.5%,16m
24566,1,[WCFAN]Schlitzer,2713,206,6,3,9,66.7%,1h
24566,3,[IGMRS]XivS,2713,176,6,15,21,28.6%,12m
24566,3,Philosopher,2713,0,3,4,7,42.9%,18m
24566,1,Pedro,2713,102,2,2,4,50.0%,5m
24566,3,COFFEEMAN,2713,0,2,3,5,40.0%,1h
24566,1,Bagdad,2713,0,2,3,5,40.0%,26m
24566,1,ElBrother,2713,0,2,3,5,40.0%,1h
24566,1,[Amant]Kofurea,2713,0,1,0,1,100.0%,1h
24566,1,NORA,2713,0,1,0,1,100.0%,1h
24566,1,UncleBricks,2713,0,1,0,1,100.0%,60m
24566,1,failamplatz,2713,0,0,1,1,0.0%,55m
24585,2,[abafer]abaferrovi,2712,1560,301,293,594,50.7%,20m
24585,1,Blood,2712,1725,138,132,270,51.1%,1h
24585,3,widdolmine,2712,1535,126,109,235,53.6%,9m
24585,2,[S548]VLAAAM,2712,1488,119,121,240,49.6%,8m
24585,3,KAPEC,2712,1380,110,91,201,54.7%,20m
24585,3,[WaCKi]MrMgr,2712,1477,67,66,133,50.4%,10m
24585,1,Павел,2712,1390,55,53,108,50.9%,1h
24585,3,[yoji]giant,2712,1423,55,59,114,48.2%,23m
24585,3,TRANCEMASTER,2712,766,46,36,82,56.1%,19m
24585,2,[Jøhn]Hokan,2712,1156,44,45,89,49.4%,8m
24585,3,[696]Daimiel,2712,521,43,42,85,50.6%,13m
24585,2,Wheresmyjack,2712,449,41,46,87,47.1%,15m
24585,3,Crowy,2712,585,25,26,51,49.0%,5m
24585,3,Pyro,2712,632,23,30,53,43.4%,23m
24585,1,Centipede,2712,420,21,16,37,56.8%,57m
24585,1,hLeBuShEk,2712,422,13,11,24,54.2%,5m
24585,3,SneakyMiron,2712,262,11,10,21,52.4%,1h
24585,3,Liranay,2712,201,8,7,15,53.3%,6m
24585,3,BlankSpace,2712,162,6,11,17,35.3%,11m
24585,1,Tatanium,2712,0,5,0,5,100.0%,18m
24585,3,Phillip,2712,122,4,13,17,23.5%,17m
24585,1,Rene,2712,131,3,5,8,37.5%,6m
24585,2,RoninBlade,2712,48,2,3,5,40.0%,7m
24585,1,[KTFsC]mVmMycenaean,2712,0,2,3,5,40.0%,57m
24585,2,Dennis,2712,96,1,3,4,25.0%,1h
24585,1,Longbow,2712,0,0,1,1,0.0%,1h
24585,1,[66666]CaesarS,2712,0,0,2,2,0.0%,1h
24585,1,Uberdryzz,2712,0,0,4,4,0.0%,1h
24613,2,MasterKris,2711,1553,308,297,605,50.9%,12m
24613,1,Nibelunge,2711,1729,149,140,289,51.6%,19m
24613,2,woefmeister,2711,1436,82,87,169,48.5%,14m
24613,1,Juggernaut,2711,1600,80,72,152,52.6%,19m
24613,1,[NOKOFF]OldYogurt,2711,742,72,76,148,48.6%,22m
24613,3,[roph]Manny,2711,1423,56,62,118,47.5%,23m
24613,1,Stiche,2711,759,44,39,83,53.0%,10m
24613,1,Dizaster,2711,544,22,15,37,59.5%,6m
24613,2,zero,2711,428,16,17,33,48.5%,13m
24613,1,WildPanda,2711,354,14,9,23,60.9%,25m
24613,3,[CNAK]Esgariel,2711,297,13,10,23,56.5%,1h
24613,1,GooDcAt,2711,355,11,6,17,64.7%,1h
24613,1,Tycyn,2711,227,9,8,17,52.9%,16m
24613,1,Zlodey,2711,246,8,8,16,50.0%,1h
24613,1,Yaroslav,2711,266,8,10,18,44.4%,1h
24613,1,[PNKS]Mehosran,2711,175,7,5,12,58.3%,1h
24613,1,DaffE,2711,250,7,8,15,46.7%,26m
24613,3,Naytup,2711,192,7,13,20,35.0%,9m
24613,1,caner,2711,159,4,1,5,80.0%,16m
24613,1,JenabeAsgari,2711,164,4,1,5,80.0%,1h
24613,2,Nikolas,2711,0,4,2,6,66.7%,1h
24613,1,llllllllllll,2711,180,4,3,7,57.1%,5m
24613,1,intherearw,2711,198,4,4,8,50.0%,18m
24613,1,RimmJob,2711,136,3,1,4,75.0%,9m
24613,2,ДворфЧихун,2711,95,3,4,7,42.9%,1h
24613,1,buyuan,2711,46,2,2,4,50.0%,1h
24613,1,[LMBD]Delidino,2711,0,2,3,5,40.0%,54m
24613,1,AAM,2711,96,1,1,2,50.0%,1h
24613,1,[RBadB]Smaug,2711,40,1,1,2,50.0%,1h
24613,1,DrBacik,2711,0,1,2,3,33.3%,9m
24613,1,Cookie,2711,0,1,2,3,33.3%,4m
24613,1,Ashimmu,2711,0,0,1,1,0.0%,21m
24613,1,[Colic]Kronik,2711,0,0,2,2,0.0%,6m
24646,3,[BLAT]Reaper,2710,1559,307,303,610,50.3%,17m
24646,2,RaiN,2710,1525,228,219,447,51.0%,7m
24646,1,Amrod,2710,1256,115,107,222,51.8%,1h
24646,2,baconpancake,2710,1002,42,50,92,45.7%,9m
24646,1,PACIFICATOR,2710,1092,37,52,89,41.6%,24m
24646,3,vaska,2710,460,22,24,46,47.8%,17m
24646,1,Commander,2710,688,21,26,47,44.7%,19m
24646,2,Julio,2710,550,18,25,43,41.9%,22m
24646,3,YourNeighbou,2710,386,13,21,34,38.2%,25m
24646,3,KOT,2710,218,9,16,25,36.0%,7m
24646,1,GeneralNoah,2710,104,5,4,9,55.6%,18m
24646,2,Kyozor,2710,163,5,4,9,55.6%,24m
24646,1,alexDBnUno,2710,102,3,6,9,33.3%,58m
24646,1,Shin,2710,38,2,2,4,50.0%,51m
24646,3,[veVevi]Vendetta,2710,0,2,3,5,40.0%,56m
24646,1,[run]serways,2710,0,1,0,1,100.0%,10m
24646,1,Zectro,2710,0,1,1,2,50.0%,60m
24646,3,[ККК]vitaleq,2710,0,1,4,5,20.0%,5m
24646,3,boes,2710,90,1,6,7,14.3%,21m
24646,3,sniper,2710,30,1,9,10,10.0%,12m
24646,1,GuiLermeTell,2710,0,0,1,1,0.0%,26m
24646,1,[HANYU]VanishingDol,2710,0,0,1,1,0.0%,1h
24646,1,Rage,2710,73,0,5,5,0.0%,6m
24669,3,JackBauer,2709,1532,367,352,719,51.0%,21m
24669,2,mars,2709,1507,207,214,421,49.2%,19m
24669,2,Kusa,2709,1057,134,132,266,50.4%,17m
24669,3,IIIIIIIIIII,2709,928,99,92,191,51.8%,5m
24669,3,Max,2709,1363,79,82,161,49.1%,19m
24669,2,IkorJefocur,2709,755,55,56,111,49.5%,23m
24669,1,Hushker,2709,716,52,33,85,61.2%,51m
24669,1,Schwifty,2709,807,35,19,54,64.8%,24m
24669,3,Dieman,2709,425,32,30,62,51.6%,20m
24669,3,Kidvento,2709,768,31,29,60,51.7%,21m
24669,3,ZoRKtheOrK,2709,809,29,31,60,48.3%,12m
24669,3,[Koent]JonkO,2709,550,22,24,46,47.8%,15m
24669,1,[Отаку]cobolpod,2709,394,17,8,25,68.0%,16m
24669,2,[O2Ds]Snezhinka,2709,508,17,31,48,35.4%,16m
24669,1,ZuKi,2709,503,14,13,27,51.9%,6m
24669,3,CHRISZ,2709,378,14,19,33,42.4%,16m
24669,1,awokenbear,2709,258,12,7,19,63.2%,19m
24669,1,Arrmagedon,2709,209,8,7,15,53.3%,1h
24669,3,Prophet,2709,224,8,13,21,38.1%,12m
24669,1,overlord,2709,273,7,6,13,53.8%,1h
24669,1,LARGEHADRON,2709,266,7,8,15,46.7%,10m
24669,3,vickthor,2709,212,7,14,21,33.3%,18m
24669,1,eLight,2709,121,5,3,8,62.5%,54m
24669,3,Ladiesnight,2709,122,5,13,18,27.8%,12m
24669,3,Przemeq,2709,42,3,0,3,100.0%,1h
24669,1,Dalan,2709,133,3,2,5,60.0%,1h
24669,2,NEO,2709,0,3,4,7,42.9%,1h
24669,3,OhDaeSu,2709,114,3,6,9,33.3%,7m
24669,3,Generaika,2709,151,3,6,9,33.3%,10m
24669,3,[NKW]Bionic,2709,30,2,0,2,100.0%,1h
24669,1,Devlik,2709,76,2,2,4,50.0%,1h
24669,1,Maler,2709,117,2,3,5,40.0%,4m
24669,1,Laimonas,2709,40,2,3,5,40.0%,9m
24669,1,Ushnark,2709,0,2,3,5,40.0%,18m
24669,1,Deskariot,2709,0,1,0,1,100.0%,1h
24669,1,[Dralag]StarCry,2709,0,1,0,1,100.0%,11m
24669,3,Hennry,2709,0,1,0,1,100.0%,58m
24669,3,haidi,2709,0,1,3,4,25.0%,1h
24669,1,Bright,2709,0,1,4,5,20.0%,1h
24669,1,Certh,2709,0,0,1,1,0.0%,1h
24669,1,StimMyRine,2709,0,0,2,2,0.0%,10m
24710,3,Blizerd,2708,1527,491,474,965,50.9%,4m
24710,3,CrazyMichi,2708,1540,159,159,318,50.0%,5m
24710,3,baros,2708,933,100,102,202,49.5%,11m
24710,3,GroHan,2708,1321,73,66,139,52.5%,20m
24710,1,Stadionwurst,2708,1597,71,61,132,53.8%,60m
24710,1,DREXLER,2708,1038,63,57,120,52.5%,5m
24710,3,Genocidik,2708,907,46,52,98,46.9%,11m
24710,2,Voland,2708,540,44,48,92,47.8%,7m
24710,1,RoboCop,2708,1104,42,38,80,52.5%,1h
24710,1,PhoeniX,2708,541,23,20,43,53.5%,23m
24710,1,nickmarca,2708,482,19,16,35,54.3%,18m
24710,1,[УТочка]DolivoSerg,2708,451,18,12,30,60.0%,25m
24710,3,BalanX,2708,341,18,16,34,52.9%,4m
24710,1,Клячкин,2708,486,17,12,29,58.6%,54m
24710,3,Mystic,2708,420,16,13,29,55.2%,5m
24710,3,DAJP,2708,450,16,19,35,45.7%,19m
24710,1,EazyE,2708,453,15,13,28,53.6%,1h
24710,1,magician,2708,430,12,10,22,54.5%,12m
24710,1,Mike,2708,385,11,9,20,55.0%,16m
24710,1,[ZERGTV]OxiDemi,2708,265,10,4,14,71.4%,1h
24710,3,[eisgä]sTaFFi,2708,202,10,10,20,50.0%,4m
24710,1,[HZeS]vitalii,2708,265,8,5,13,61.5%,12m
24710,1,Vlados,2708,280,8,6,14,57.1%,18m
24710,2,sandzahar,2708,192,7,3,10,70.0%,1h
24710,3,Candle,2708,120,7,8,15,46.7%,6m
24710,2,[KNFX]Kecires,2708,92,6,5,11,54.5%,4m
24710,3,ChaChet,2708,154,6,7,13,46.2%,21m
24710,1,KLX,2708,192,5,2,7,71.4%,1h
24710,1,ButPlug,2708,166,4,2,6,66.7%,51m
24710,1,[Woomy]mrgeneral,2708,148,4,5,9,44.4%,1h
24710,2,Cerberus,2708,0,3,3,6,50.0%,1h
24710,3,PapierWc,2708,0,3,4,7,42.9%,19m
24710,3,WiseFace,2708,0,2,5,7,28.6%,6m
24710,2,AlexeiStukov,2708,0,1,0,1,100.0%,21m
24710,1,iris,2708,0,0,1,1,0.0%,5m
24710,1,snakebite,2708,0,0,2,2,0.0%,1h
24710,1,Midmad,2708,0,0,2,2,0.0%,1h
24747,3,Ben,2707,1347,256,258,514,49.8%,19m
24747,2,paulotoss,2707,1060,101,97,198,51.0%,19m
24747,2,WlkaFenryka,2707,697,89,87,176,50.6%,16m
24747,1,MoominPlaya,2707,1359,68,70,138,49.3%,21m
24747,1,[PDNCVT]SoftBeard,2707,1234,55,39,94,58.5%,9m
24747,1,VertRum,2707,1226,46,40,86,53.5%,58m
24747,3,[HaoS]Exsempld,2707,991,39,40,79,49.4%,25m
24747,1,BiHorpaD,2707,800,36,16,52,69.2%,1h
24747,3,[Aléas]kylar,2707,870,32,38,70,45.7%,16m
24747,1,Han,2707,532,21,13,34,61.8%,1h
24747,3,Achilles,2707,490,20,18,38,52.6%,5m
24747,1,krj,2707,360,19,13,32,59.4%,58m
24747,3,vikror,2707,349,14,10,24,58.3%,10m
24747,1,Vodka,2707,153,10,7,17,58.8%,21m
24747,3,Jarrick,2707,238,9,11,20,45.0%,23m
24747,2,Cucumbersnch,2707,187,6,6,12,50.0%,1h
24747,1,lSnOwl,2707,138,5,5,10,50.0%,1h
24747,2,TOSA,2707,46,4,5,9,44.4%,1h
24747,2,SerEga,2707,88,4,5,9,44.4%,14m
24747,1,mumin,2707,82,3,6,9,33.3%,1h
24747,1,LTCUSDT,2707,72,3,7,10,30.0%,5m
24747,1,Snasher,2707,0,2,3,5,40.0%,18m
24747,2,DOC,2707,95,2,5,7,28.6%,1h
24747,1,ACE,2707,38,1,4,5,20.0%,58m
24747,1,Jack,2707,40,1,5,6,16.7%,9m
24747,1,Maxliger,2707,0,0,1,1,0.0%,1h
24747,3,malgat,2707,0,0,1,1,0.0%,8m
24747,1,yonduudonta,2707,0,0,2,2,0.0%,17m
24775,1,Aardman,2706,1680,304,278,582,52.2%,25m
24775,3,SVS,2706,936,38,46,84,45.2%,25m
24775,1,DIMAS,2706,447,30,20,50,60.0%,1h
24775,3,YostIeboy,2706,670,28,30,58,48.3%,11m
24775,1,[2KY]Keer,2706,710,27,20,47,57.4%,22m
24775,1,[TheDOH]Maxos,2706,545,25,13,38,65.8%,23m
24775,1,BELEROFONTE,2706,462,18,15,33,54.5%,55m
24775,3,JeremyIrons,2706,390,17,17,34,50.0%,24m
24775,3,Keeer,2706,374,16,21,37,43.2%,5m
24775,1,Toxic,2706,474,13,14,27,48.1%,21m
24775,1,[XXII]sly,2706,359,12,9,21,57.1%,1h
24775,3,Hoody,2706,320,10,18,28,35.7%,8m
24775,2,Käseee,2706,236,9,4,13,69.2%,15m
24775,1,Memphis,2706,160,6,5,11,54.5%,9m
24775,1,Maximo,2706,168,6,6,12,50.0%,1h
24775,1,TurboX,2706,157,5,5,10,50.0%,7m
24775,1,PREDATOR,2706,122,5,5,10,50.0%,52m
24775,3,ZuBy,2706,140,4,5,9,44.4%,5m
24775,1,[IceHus]законМерфи,2706,103,3,0,3,100.0%,5m
24775,1,[ZeCouZ]MaskENTITY,2706,111,3,0,3,100.0%,1h
24775,1,dumbo,2706,68,3,3,6,50.0%,1h
24775,1,Kaerlon,2706,74,3,4,7,42.9%,59m
24775,1,Pandaman,2706,118,3,5,8,37.5%,1h
24775,1,SEǂLussy,2706,102,2,1,3,66.7%,6m
24775,1,Bastinsky,2706,38,2,1,3,66.7%,12m
24775,2,UNKIND,2706,95,2,1,3,66.7%,1h
24775,3,Dratytu,2706,0,2,3,5,40.0%,1h
24775,3,ADS,2706,58,2,11,13,15.4%,5m
24775,1,[EfeM]Ålesundøye,2706,0,1,0,1,100.0%,51m
24775,1,[VRTAN]Reinor,2706,48,1,1,2,50.0%,1h
24775,1,hexorJr,2706,48,1,2,3,33.3%,4m
24775,1,Cranky,2706,0,0,1,1,0.0%,1h
24775,3,Onicks,2706,0,0,2,2,0.0%,58m
24775,3,WinterDog,2706,0,0,3,3,0.0%,1h
24775,1,[tetguy]higgs,2706,0,0,3,3,0.0%,21m
24810,3,Noclaf,2705,1542,110,108,218,50.5%,11m
24810,2,Bumblebee,2705,948,94,56,150,62.7%,22m
24810,3,FERNIR,2705,633,85,75,160,53.1%,13m
24810,1,[AciNoN]WERTEX,2705,685,31,16,47,66.0%,57m
24810,1,Glaedr,2705,731,28,27,55,50.9%,21m
24810,1,Erik,2705,183,8,7,15,53.3%,54m
24810,1,slipnote,2705,174,5,4,9,55.6%,51m
24810,1,[RBP3]Commander,2705,74,3,1,4,75.0%,1h
24810,1,[InitRu]жим,2705,76,3,2,5,60.0%,10m
24810,3,Blopak,2705,30,3,3,6,50.0%,1h
24810,1,Hitmonflee,2705,88,3,3,6,50.0%,6m
24810,3,rottenorange,2705,0,3,4,7,42.9%,9m
24810,2,Xantroid,2705,142,3,4,7,42.9%,1h
24810,1,AhzekAhriman,2705,40,2,1,3,66.7%,11m
24810,1,[Thána]Stranger,2705,0,2,3,5,40.0%,5m
24810,1,Гоша,2705,40,2,5,7,28.6%,15m
24810,3,EtiquetteMan,2705,129,2,5,7,28.6%,1h
24810,1,zetobelka,2705,0,1,1,2,50.0%,6m
24810,3,Prorok,2705,0,0,2,2,0.0%,1h
24810,2,Uzzywood,2705,0,0,2,2,0.0%,1h
24810,1,Sylva,2705,0,0,2,2,0.0%,58m
24831,1,vautren,2704,1691,506,491,997,50.8%,1h
24831,3,Raiden,2704,664,97,90,187,51.9%,14m
24831,1,CptEvil,2704,1690,76,61,137,55.5%,19m
24831,3,RomanArson,2704,1534,76,88,164,46.3%,12m
24831,1,SnowTime,2704,1429,72,49,121,59.5%,1h
24831,1,pineberry,2704,1477,65,65,130,50.0%,21m
24831,1,Pachichi,2704,1323,60,54,114,52.6%,19m
24831,3,kwerty,2704,608,29,22,51,56.9%,18m
24831,3,Karlipoil,2704,489,28,25,53,52.8%,13m
24831,3,diehard,2704,544,26,25,51,51.0%,23m
24831,1,Seingeschäft,2704,600,20,17,37,54.1%,25m
24831,1,Walter,2704,354,16,14,30,53.3%,58m
24831,2,RexArnel,2704,275,11,13,24,45.8%,18m
24831,3,[Traxen]Space,2704,230,7,13,20,35.0%,21m
24831,3,VeTerran,2704,190,6,15,21,28.6%,11m
24831,2,reret,2704,155,5,5,10,50.0%,19m
24831,1,Legolas,2704,102,4,4,8,50.0%,25m
24831,1,MadcuzBad,2704,122,4,5,9,44.4%,1h
24831,1,Gaex,2704,156,4,6,10,40.0%,19m
24831,1,[HZeS]Rachok,2704,112,3,0,3,100.0%,51m
24831,1,OneLOL,2704,0,3,2,5,60.0%,1h
24831,2,[TPUs]KyouMass,2704,94,3,4,7,42.9%,15m
24831,3,[TIAIA]Luxy,2704,0,3,4,7,42.9%,22m
24831,1,Kalyan,2704,38,2,1,3,66.7%,1h
24831,3,Joshphus,2704,0,2,3,5,40.0%,1h
24831,1,NIKANDR,2704,0,2,3,5,40.0%,1h
24831,1,ZeTTi,2704,0,0,1,1,0.0%,23m
24831,1,Bianchirock,2704,0,0,1,1,0.0%,10m
24859,3,excellence,2703,1555,135,139,274,49.3%,23m
24859,3,Jeric,2703,993,108,91,199,54.3%,25m
24859,1,[EDKH]Mrdopes,2703,1601,107,102,209,51.2%,22m
24859,1,Eldschie,2703,1316,103,101,204,50.5%,1h
24859,3,StupidBlonde,2703,838,61,62,123,49.6%,17m
24859,3,Atist,2703,1377,57,51,108,52.8%,22m
24859,3,RagnarTheRed,2703,1230,52,49,101,51.5%,10m
24859,3,fUnZilla,2703,1089,43,47,90,47.8%,13m
24859,1,[CHALGA]Qvorentiii,2703,881,38,24,62,61.3%,1h
24859,1,spartaco,2703,393,37,19,56,66.1%,21m
24859,3,Stuffy,2703,889,36,32,68,52.9%,4m
24859,1,MaruSucks,2703,576,27,12,39,69.2%,5m
24859,1,[Plenty]KaizerSoze,2703,273,14,15,29,48.3%,5m
24859,1,SPoTSepSiS,2703,257,13,8,21,61.9%,19m
24859,1,[TmFpt]NoNameNomad,2703,273,8,5,13,61.5%,55m
24859,1,Nikom,2703,274,8,9,17,47.1%,10m
24859,1,icks,2703,268,8,10,18,44.4%,58m
24859,1,Rastamon,2703,264,7,8,15,46.7%,1h
24859,3,[1ndica]elZablo,2703,114,6,8,14,42.9%,17m
24859,1,DznJackimilk,2703,114,5,4,9,55.6%,15m
24859,2,KIYAN,2703,0,3,3,6,50.0%,23m
24859,1,[IDSU]krader,2703,76,3,4,7,42.9%,4m
24859,2,Vincentime,2703,46,3,4,7,42.9%,1h
24859,1,Yiseba,2703,48,3,7,10,30.0%,1h
24859,3,Skiv,2703,144,3,8,11,27.3%,21m
24859,2,ivanko,2703,46,2,2,4,50.0%,7m
24859,1,Drobovik,2703,40,2,2,4,50.0%,23m
24859,3,[LV]TargeT,2703,42,2,5,7,28.6%,1h
24859,1,Walter,2703,145,2,7,9,22.2%,1h
24859,1,[Jöthem]Bergamot,2703,0,1,0,1,100.0%,1h
24859,3,[ÄoB]drofus,2703,42,1,1,2,50.0%,17m
24859,1,[AQR]AQRpogpog,2703,0,0,1,1,0.0%,1h
24859,3,Malak,2703,0,0,1,1,0.0%,1h
24859,1,[SoothK]Kurt,2703,0,0,5,5,0.0%,22m
24893,3,[UEFTNS]Acula,2702,1611,173,176,349,49.6%,23m
24893,3,[RBP3]Paveto,2702,1344,134,123,257,52.1%,15m
24893,3,Gajus,2702,1055,102,101,203,50.2%,4m
24893,3,Rantanplan,2702,1294,100,100,200,50.0%,12m
24893,3,Artalon,2702,1398,89,82,171,52.0%,19m
24893,3,[ToC]TOXYQ,2702,1141,53,35,88,60.2%,9m
24893,1,Nkl,2702,982,40,23,63,63.5%,1h
24893,1,[Uсhiha]KarmaIakb,2702,703,37,16,53,69.8%,22m
24893,1,joepunk,2702,747,32,21,53,60.4%,1h
24893,3,masiy,2702,662,22,30,52,42.3%,12m
24893,1,Tsalykval,2702,618,20,18,38,52.6%,6m
24893,2,Ziggy,2702,513,20,27,47,42.6%,15m
24893,3,Grostey,2702,538,19,25,44,43.2%,9m
24893,1,kid,2702,578,18,15,33,54.5%,1h
24893,1,serval,2702,357,12,9,21,57.1%,3m
24893,1,TheHumansLie,2702,203,9,2,11,81.8%,25m
24893,1,Tasadar,2702,281,9,6,15,60.0%,1h
24893,1,[J4E]Geronimus,2702,228,6,4,10,60.0%,1h
24893,1,kjen,2702,134,5,4,9,55.6%,60m
24893,2,Timido,2702,111,4,4,8,50.0%,17m
24893,1,[Torito]barzacampeon,2702,118,4,4,8,50.0%,60m
24893,3,Kinbel,2702,92,4,6,10,40.0%,15m
24893,2,VladimirXop,2702,138,3,2,5,60.0%,16m
24893,3,PocketMartin,2702,123,3,3,6,50.0%,1h
24893,3,AmyShen,2702,40,3,4,7,42.9%,20m
24893,1,Revers,2702,143,3,4,7,42.9%,10m
24893,1,Balaskin,2702,114,3,7,10,30.0%,1h
24893,2,Essar,2702,46,2,0,2,100.0%,4m
24893,1,noobIOII,2702,96,2,1,3,66.7%,1h
24893,1,filzvil,2702,78,2,2,4,50.0%,1h
24893,3,ibragimz,2702,0,2,3,5,40.0%,57m
24893,1,[FteamF]ОлегМонгол,2702,0,2,3,5,40.0%,57m
24893,1,Naupilus,2702,0,2,4,6,33.3%,26m
24893,3,WhoElse,2702,0,1,0,1,100.0%,54m
24893,1,hiimzaki,2702,42,1,5,6,16.7%,22m
24893,1,dmx,2702,0,1,5,6,16.7%,1h
24893,1,Nova,2702,0,0,1,1,0.0%,57m
24893,1,Lubomiro,2702,0,0,1,1,0.0%,1h
24893,1,radczak,2702,0,0,3,3,0.0%,1h
24932,3,[PARSE]Overmind,2701,1346,167,160,327,51.1%,22m
24932,3,MrWise,2701,1417,140,115,255,54.9%,20m
24932,1,CrimsonKing,2701,1666,96,72,168,57.1%,17m
24932,3,LenientToast,2701,1222,44,52,96,45.8%,16m
24932,1,Uzorpator,2701,955,31,29,60,51.7%,12m
24932,1,Slans,2701,721,30,23,53,56.6%,1h
24932,1,MattPwnYa,2701,447,28,24,52,53.8%,17m
24932,1,[prussr]Meytscher,2701,589,21,19,40,52.5%,17m
24932,1,AveTsezar,2701,492,17,16,33,51.5%,58m
24932,1,Major,2701,397,15,11,26,57.7%,1h
24932,3,MoreauCamus,2701,381,15,20,35,42.9%,5m
24932,1,Eltsengur,2701,210,8,8,16,50.0%,1h
24932,1,Teutone,2701,296,8,10,18,44.4%,23m
24932,2,iGynLoD,2701,94,5,9,14,35.7%,20m
24932,1,Eastone,2701,104,3,5,8,37.5%,5m
24932,2,Yao,2701,0,2,3,5,40.0%,1h
24932,1,Solklar,2701,0,2,3,5,40.0%,54m
24932,1,Rai,2701,0,1,0,1,100.0%,1h
24932,1,[KHrsn]popelbert,2701,0,1,0,1,100.0%,1h
24932,1,Sorand,2701,38,1,2,3,33.3%,55m
24932,3,Roger,2701,30,1,8,9,11.1%,18m
24932,1,AsTreL,2701,0,0,1,1,0.0%,13m
24932,1,Dastann,2701,0,0,1,1,0.0%,22m
24932,1,SlavBG,2701,0,0,1,1,0.0%,19m
24932,1,Semaka,2701,0,0,2,2,0.0%,60m
24932,1,BoyScout,2701,0,0,5,5,0.0%,25m
24958,2,Ultrasonique,2700,1606,522,514,1036,50.4%,20m
24958,3,iwoks,2700,1290,171,157,328,52.1%,5m
24958,1,Azunai,2700,1242,108,92,200,54.0%,6m
24958,3,Forsaken,2700,1345,60,64,124,48.4%,19m
24958,1,vdawg,2700,1525,59,51,110,53.6%,1h
24958,3,KingDijkstra,2700,1003,40,46,86,46.5%,4m
24958,3,Spector,2700,1079,39,42,81,48.1%,5m
24958,1,[TLNT]mYsterY,2700,930,35,31,66,53.0%,22m
24958,3,TARAS,2700,908,35,40,75,46.7%,5m
24958,1,joshua,2700,499,24,8,32,75.0%,1h
24958,1,StormCruel,2700,534,24,14,38,63.2%,19m
24958,1,Combain,2700,620,22,16,38,57.9%,15m
24958,1,Harry,2700,588,22,20,42,52.4%,23m
24958,2,[GCorps]Alltracks,2700,480,22,21,43,51.2%,22m
24958,1,Monkfish,2700,607,22,39,61,36.1%,16m
24958,3,Mindaugas,2700,582,21,29,50,42.0%,20m
24958,1,[XRaySX]Staricaft,2700,504,20,13,33,60.6%,51m
24958,1,Zalupiy,2700,496,20,19,39,51.3%,19m
24958,1,Epicure,2700,415,17,7,24,70.8%,51m
24958,3,Starblind,2700,424,16,20,36,44.4%,10m
24958,3,Defcrime,2700,249,10,11,21,47.6%,1h
24958,1,Jeetah,2700,314,9,11,20,45.0%,55m
24958,3,Ravens,2700,274,9,15,24,37.5%,9m
24958,1,romchikk,2700,300,8,8,16,50.0%,6m
24958,1,StoffeEVIL,2700,246,7,5,12,58.3%,59m
24958,1,Sevler,2700,162,6,7,13,46.2%,1h
24958,1,Storm,2700,196,6,8,14,42.9%,1h
24958,1,brulaap,2700,38,5,2,7,71.4%,1h
24958,1,Hunter,2700,102,4,6,10,40.0%,19m
24958,2,NicoMords,2700,0,3,4,7,42.9%,1h
24958,1,DidjeY,2700,88,2,0,2,100.0%,17m
24958,1,[SQSD]Flowerz,2700,40,2,2,4,50.0%,26m
24958,3,[Юнион]Кирилл,2700,30,2,3,5,40.0%,21m
24958,1,Switchback,2700,76,2,4,6,33.3%,51m
24958,1,DrSeedon,2700,0,1,0,1,100.0%,19m
24958,2,[ZDrag]iliko,2700,0,1,0,1,100.0%,1h
24958,1,[ExTr1m]DEHAKA,2700,0,1,5,6,16.7%,15m
24958,1,Smith,2700,0,0,1,1,0.0%,24m
24958,2,Cookie,2700,0,0,1,1,0.0%,1h
24958,1,MeHTaJLUCT,2700,0,0,1,1,0.0%,17m
24958,1,[CS0]niven,2700,0,0,2,2,0.0%,1h
24958,1,guntherhanzz,2700,0,0,3,3,0.0%,5m
24958,1,mike,2700,0,0,3,3,0.0%,57m
25001,2,CoolHeat,2699,1575,270,263,533,50.7%,22m
25001,3,[U19]Goodhell,2699,1541,207,196,403,51.4%,21m
25001,1,starlord,2699,1697,141,115,256,55.1%,26m
25001,1,[LeWin]TotalTalent,2699,1307,80,84,164,48.8%,6m
25001,1,Vulak,2699,940,49,50,99,49.5%,1h
25001,3,SpeZi,2699,168,21,24,45,46.7%,19m
25001,1,[RusTM]vintik,2699,511,17,21,38,44.7%,1h
25001,1,Vision,2699,489,14,13,27,51.9%,6m
25001,3,Sailorman,2699,402,14,20,34,41.2%,23m
25001,1,[PLOMO]BASISM,2699,286,8,9,17,47.1%,1h
25001,1,BadSaltyFish,2699,133,6,3,9,66.7%,23m
25001,1,[Nukeu]Xseros,2699,110,4,7,11,36.4%,7m
25001,1,[xX00Xx]Medard,2699,66,3,4,7,42.9%,23m
25001,3,GraybacK,2699,0,2,3,5,40.0%,1h
25001,1,Банкай,2699,0,2,3,5,40.0%,5m
25001,3,Hans,2699,0,2,3,5,40.0%,1h
25001,1,Feelthis,2699,0,1,0,1,100.0%,1h
25001,1,Insaneone,2699,0,1,1,2,50.0%,1h
25001,1,Moose,2699,0,1,2,3,33.3%,25m
25001,3,[NBK]PAPPO,2699,0,1,6,7,14.3%,9m
25001,3,Mimir,2699,30,1,7,8,12.5%,17m
25001,3,[DIVOC]Wodjee,2699,0,0,1,1,0.0%,22m
25001,1,[HEART]easyway,2699,0,0,1,1,0.0%,1h
25001,1,myZei,2699,0,0,1,1,0.0%,15m
25001,1,Tomas,2699,0,0,1,1,0.0%,20m
25001,2,[R4t3L]ChienEtagère,2699,0,0,2,2,0.0%,57m
25027,1,RaccooN,2698,1687,143,126,269,53.2%,57m
25027,3,Mattiqa,2698,1530,115,102,217,53.0%,19m
25027,1,Superstar,2698,880,60,68,128,46.9%,6m
25027,3,grablya,2698,1269,54,61,115,47.0%,5m
25027,1,Dietmar,2698,1429,51,48,99,51.5%,10m
25027,1,Merkur,2698,876,37,27,64,57.8%,58m
25027,1,Dreamlock,2698,858,37,27,64,57.8%,26m
25027,1,[CL0SE]Zedred,2698,998,34,37,71,47.9%,1h
25027,3,Otzelot,2698,798,32,35,67,47.8%,19m
25027,1,[ZERGTB]Domi,2698,685,27,22,49,55.1%,57m
25027,1,Sanitar,2698,521,23,16,39,59.0%,7m
25027,1,lupinglui,2698,562,23,17,40,57.5%,5m
25027,3,[LéKsos]AlleyOoooop,2698,514,21,17,38,55.3%,5m
25027,1,Awe,2698,401,19,8,27,70.4%,25m
25027,1,witcher,2698,347,15,13,28,53.6%,3m
25027,1,Andrei,2698,494,15,19,34,44.1%,51m
25027,1,RabbidLesbo,2698,289,12,6,18,66.7%,1h
25027,1,Michi,2698,337,11,7,18,61.1%,1h
25027,1,[SuDm]Inthehouse,2698,355,11,10,21,52.4%,19m
25027,3,sdf,2698,290,11,12,23,47.8%,13m
25027,1,luts,2698,330,10,7,17,58.8%,21m
25027,1,Loktai,2698,153,7,5,12,58.3%,1h
25027,1,guerero,2698,145,6,7,13,46.2%,15m
25027,1,[VNT4GE]zed,2698,228,6,9,15,40.0%,22m
25027,1,ManFromEarth,2698,72,5,4,9,55.6%,1h
25027,1,pkv,2698,232,5,5,10,50.0%,1h
25027,3,kim,2698,136,5,7,12,41.7%,11m
25027,1,SteelGoD,2698,0,4,1,5,80.0%,22m
25027,1,Leinad,2698,122,4,4,8,50.0%,5m
25027,2,Milosovich,2698,0,3,3,6,50.0%,1h
25027,2,Memory,2698,0,3,4,7,42.9%,51m
25027,1,AAP,2698,36,2,2,4,50.0%,51m
25027,1,Skrndelj,2698,0,2,3,5,40.0%,1h
25027,1,[berezi]Valyantin,2698,0,2,3,5,40.0%,55m
25027,2,linus,2698,0,1,0,1,100.0%,21m
25027,1,RikuoFarz,2698,0,1,0,1,100.0%,14m
25027,1,[Hardgg]Kaliostro,2698,0,1,0,1,100.0%,7m
25027,1,[Planek]Kvadrach,2698,0,1,1,2,50.0%,1h
25027,1,[Arker]Zkampy,2698,0,0,1,1,0.0%,6m
25027,1,БАЗУКА,2698,0,0,1,1,0.0%,1h
25027,1,[tofury]Kojrak,2698,0,0,2,2,0.0%,1h
25068,1,Lauren,2697,1560,269,308,577,46.6%,1h
25068,1,Apo,2697,967,72,72,144,50.0%,12m
25068,1,[ZERGSC]IRIandec,2697,1366,70,53,123,56.9%,1h
25068,2,Albert,2697,1054,66,70,136,48.5%,14m
25068,2,Tarin,2697,620,22,33,55,40.0%,9m
25068,1,Executor,2697,596,20,19,39,51.3%,11m
25068,1,Zunie,2697,377,15,13,28,53.6%,60m
25068,3,AndreiSirop,2697,329,12,10,22,54.5%,1h
25068,1,BeeMaster,2697,276,9,6,15,60.0%,6m
25068,3,DESiRE,2697,322,9,16,25,36.0%,22m
25068,2,Prince,2697,118,7,8,15,46.7%,14m
25068,1,ArhRaven,2697,114,6,4,10,60.0%,16m
25068,1,qazz,2697,139,5,3,8,62.5%,1h
25068,1,nagado,2697,187,5,7,12,41.7%,21m
25068,1,semyon,2697,74,3,2,5,60.0%,11m
25068,3,Sakugan,2697,0,3,4,7,42.9%,15m
25068,3,BlackNeutron,2697,30,3,9,12,25.0%,19m
25068,3,[R0]Ketodar,2697,32,3,11,14,21.4%,11m
25068,1,ulkor,2697,0,2,3,5,40.0%,1h
25068,3,ZLOW,2697,30,2,3,5,40.0%,20m
25068,3,Sendrom,2697,30,2,4,6,33.3%,14m
25068,1,zompin,2697,0,1,1,2,50.0%,7m
25068,1,[4Reich]Domashniy,2697,0,0,1,1,0.0%,26m
25068,3,Prophet,2697,0,0,1,1,0.0%,23m
25068,1,[Ричард]Herceg,2697,0,0,1,1,0.0%,12m
25068,1,[LoneD]Glenne,2697,0,0,5,5,0.0%,1h
25094,2,[II3II]alfadog,2696,1630,476,474,950,50.1%,23m
25094,2,oleg,2696,1405,107,100,207,51.7%,18m
25094,1,[TxPIOL]SwankyHoff,2696,642,73,61,134,54.5%,1h
25094,1,NICE,2696,633,47,36,83,56.6%,1h
25094,2,Seimir,2696,1132,40,52,92,43.5%,16m
25094,1,PacTeHue,2696,936,37,28,65,56.9%,1h
25094,1,CptKock,2696,523,34,23,57,59.6%,23m
25094,2,Procuror,2696,839,31,41,72,43.1%,17m
25094,1,BwA,2696,429,19,17,36,52.8%,60m
25094,3,RiGGs,2696,556,19,27,46,41.3%,25m
25094,3,[CОS]Масакада,2696,508,18,22,40,45.0%,22m
25094,1,EndlessRain,2696,366,13,12,25,52.0%,1h
25094,3,Yeuo,2696,370,13,20,33,39.4%,12m
25094,1,JanStar,2696,326,10,11,21,47.6%,26m
25094,1,EasyAI,2696,218,9,8,17,52.9%,1h
25094,1,atlant,2696,218,6,7,13,46.2%,1h
25094,3,Gruss,2696,106,5,12,17,29.4%,17m
25094,1,[GKTRK]Momik,2696,104,3,1,4,75.0%,1h
25094,3,WarMachine,2696,135,3,1,4,75.0%,53m
25094,1,yonka,2696,88,3,3,6,50.0%,5m
25094,1,[PARSE]Belzeebul,2696,0,3,3,6,50.0%,22m
25094,2,SilithuX,2696,0,3,4,7,42.9%,19m
25094,1,Steinkante,2696,88,2,0,2,100.0%,7m
25094,1,Кекс,2696,0,2,3,5,40.0%,19m
25094,1,MATbBGROBU,2696,76,2,4,6,33.3%,23m
25094,2,Vlo,2696,96,2,4,6,33.3%,1h
25094,3,Kozatylo,2696,0,2,4,6,33.3%,21m
25094,1,astaroth,2696,0,1,0,1,100.0%,1h
25094,1,ЛакиГрот,2696,0,1,0,1,100.0%,1h
25094,1,[Mulluc]qwatschel,2696,0,1,1,2,50.0%,58m
25094,2,[BSоD]Last,2696,46,1,2,3,33.3%,1h
25094,1,testhentai,2696,40,1,2,3,33.3%,1h
25094,1,SeBBo,2696,40,1,3,4,25.0%,5m
25094,2,FroxyFreak,2696,0,0,1,1,0.0%,17m
25094,1,HarryPotter,2696,0,0,1,1,0.0%,21m
25094,1,Satanademon,2696,0,0,1,1,0.0%,16m
25094,3,[BRMs]Nthan,2696,0,0,12,12,0.0%,5m
25131,1,tilapin,2695,1488,95,89,184,51.6%,12m
25131,3,[IceHus]Дурашка,2695,1311,81,77,158,51.3%,4m
25131,3,hutulong,2695,1213,71,71,142,50.0%,14m
25131,1,[G4YoU]Christiankir,2695,768,39,33,72,54.2%,1h
25131,1,JeanMiAulas,2695,472,23,9,32,71.9%,24m
25131,1,sanue,2695,463,21,12,33,63.6%,58m
25131,1,[APIPIS]RushB,2695,537,20,13,33,60.6%,26m
25131,1,Flooded,2695,589,17,15,32,53.1%,19m
25131,1,Indigo,2695,403,14,11,25,56.0%,17m
25131,1,[Юнион]montawLP,2695,356,13,13,26,50.0%,1h
25131,1,Winner,2695,235,7,4,11,63.6%,23m
25131,1,WatWatInDaBu,2695,167,6,2,8,75.0%,60m
25131,2,Joaquin,2695,193,6,6,12,50.0%,20m
25131,1,schokobaer,2695,145,6,6,12,50.0%,6m
25131,3,[Gauge]Jazz,2695,116,5,6,11,45.5%,14m
25131,3,Аларак,2695,0,4,1,5,80.0%,58m
25131,1,blademaster,2695,94,3,2,5,60.0%,1h
25131,1,Hunlahun,2695,0,1,0,1,100.0%,21m
25131,3,cthulhu,2695,18,1,1,2,50.0%,1h
25131,2,Gomesion,2695,0,1,2,3,33.3%,6m
25131,1,[31415]skvol,2695,0,1,3,4,25.0%,1h
25131,1,SirJim,2695,30,1,4,5,20.0%,17m
25131,3,Eternal,2695,0,0,1,1,0.0%,23m
25154,1,[ŚS6]PiraMID,2694,1590,199,177,376,52.9%,58m
25154,1,asaku,2694,1176,155,140,295,52.5%,1h
25154,1,SuperManer,2694,1443,93,75,168,55.4%,1h
25154,1,RaZzYer,2694,914,58,45,103,56.3%,5m
25154,1,Bizarro,2694,1207,48,44,92,52.2%,1h
25154,1,[FR1]Vlayd,2694,1104,43,37,80,53.8%,9m
25154,1,RaV,2694,750,35,27,62,56.5%,24m
25154,3,kirkannos,2694,781,33,30,63,52.4%,25m
25154,3,[Slakin]SslackSton,2694,898,33,36,69,47.8%,18m
25154,1,Aug,2694,801,31,28,59,52.5%,1h
25154,3,[НТТ]Kaiser,2694,665,30,33,63,47.6%,11m
25154,2,shadow,2694,840,29,40,69,42.0%,9m
25154,2,Remo,2694,185,23,33,56,41.1%,8m
25154,1,[TPAXEP]Avid,2694,390,20,7,27,74.1%,23m
25154,1,Виша,2694,422,15,10,25,60.0%,1h
25154,3,TEMPLARIO,2694,372,13,21,34,38.2%,19m
25154,1,Fransekaas,2694,275,11,10,21,52.4%,1h
25154,1,[PWV]Maidenu,2694,263,9,7,16,56.2%,1h
25154,1,Wigen,2694,232,7,11,18,38.9%,1h
25154,1,llllllllllll,2694,117,5,0,5,100.0%,1h
25154,1,MaCro,2694,199,5,4,9,55.6%,57m
25154,1,KhalSagan,2694,117,3,1,4,75.0%,10m
25154,1,[FAWorl]cliooilc,2694,104,2,1,3,66.7%,51m
25154,1,farmilken,2694,48,2,1,3,66.7%,15m
25154,3,vonFRAS,2694,0,2,3,5,40.0%,1h
25154,1,Greed,2694,0,2,3,5,40.0%,51m
25154,1,WellBloud,2694,0,1,0,1,100.0%,16m
25154,1,Stallion,2694,38,1,2,3,33.3%,1h
25154,1,Golum,2694,0,0,1,1,0.0%,1h
25154,1,Undertaker,2694,0,0,1,1,0.0%,58m
25154,1,Kotoffey,2694,0,0,2,2,0.0%,1h
25154,1,Michem,2694,0,0,2,2,0.0%,7m
25186,1,[GdAT]sansego,2693,1729,309,307,616,50.2%,1h
25186,1,[GGWin]RobSnydeR,2693,1409,175,182,357,49.0%,12m
25186,1,pinkPanther,2693,1160,73,64,137,53.3%,1h
25186,1,анр,2693,1253,71,58,129,55.0%,1h
25186,2,GHOST,2693,1065,68,68,136,50.0%,8m
25186,1,VersaltoDIO,2693,934,63,50,113,55.8%,1h
25186,3,hansCastorp,2693,1481,61,63,124,49.2%,21m
25186,1,DUSK,2693,754,34,21,55,61.8%,19m
25186,3,Hurson,2693,433,24,19,43,55.8%,14m
25186,1,SuperPower,2693,616,23,18,41,56.1%,25m
25186,1,[OmDi]skwalllllll,2693,347,14,14,28,50.0%,23m
25186,1,Nisha,2693,332,12,20,32,37.5%,58m
25186,1,Тихо,2693,313,10,8,18,55.6%,1h
25186,3,[NFX]ChuPA,2693,302,10,11,21,47.6%,5m
25186,1,Trumps,2693,342,9,10,19,47.4%,51m
25186,1,mariusac,2693,108,4,4,8,50.0%,1h
25186,1,KUB,2693,78,3,2,5,60.0%,16m
25186,1,[TeUn]Kai,2693,0,3,2,5,60.0%,22m
25186,2,CanardWC,2693,0,3,5,8,37.5%,4m
25186,1,ROACH,2693,105,2,2,4,50.0%,1h
25186,1,LanserMan,2693,0,2,3,5,40.0%,1h
25186,1,blik,2693,78,2,6,8,25.0%,23m
25186,3,Lukasz,2693,30,2,7,9,22.2%,12m
25186,1,Alone,2693,0,1,0,1,100.0%,24m
25186,2,ЧёрныйКот,2693,0,1,0,1,100.0%,20m
25186,1,Sharingan,2693,0,1,0,1,100.0%,13m
25212,2,Condor,2692,1549,401,384,785,51.1%,18m
25212,3,Pavel,2692,1608,341,331,672,50.7%,21m
25212,1,warsus,2692,1589,158,156,314,50.3%,58m
25212,3,[AciNoN]Viole,2692,1012,67,59,126,53.2%,23m
25212,3,Diradas,2692,909,45,42,87,51.7%,13m
25212,1,bloody,2692,752,27,24,51,52.9%,7m
25212,1,Rudgar,2692,651,26,24,50,52.0%,1h
25212,1,PINGALOKA,2692,457,20,14,34,58.8%,1h
25212,1,[HZeS]SanJ,2692,503,20,17,37,54.1%,1h
25212,3,Speed,2692,314,12,10,22,54.5%,5m
25212,1,XeNon,2692,212,11,6,17,64.7%,1h
25212,3,[MAKinG]Swift,2692,118,8,7,15,53.3%,21m
25212,3,[DIRSTK]Endorama,2692,220,8,13,21,38.1%,12m
25212,1,mortiga,2692,256,7,6,13,53.8%,5m
25212,3,williamgrg,2692,235,7,13,20,35.0%,19m
25212,1,Darkphoenix,2692,157,6,1,7,85.7%,26m
25212,1,[Jijua]Caste,2692,165,5,2,7,71.4%,1h
25212,1,Strelok,2692,0,4,1,5,80.0%,19m
25212,1,[24I7]KiNgStYeL,2692,0,3,2,5,60.0%,5m
25212,3,[581c]CNN,2692,97,3,3,6,50.0%,1h
25212,3,Wemko,2692,97,3,3,6,50.0%,1h
25212,1,Repentence,2692,91,1,1,2,50.0%,1h
25212,1,Ded,2692,0,1,1,2,50.0%,1h
25212,3,[šķūnī]napalmEye,2692,0,0,1,1,0.0%,16m
25212,1,[oooboy]TalJacob,2692,0,0,1,1,0.0%,19m
25212,3,astra,2692,0,0,7,7,0.0%,13m
25238,1,Toxim,2691,1437,124,109,233,53.2%,19m
25238,1,masterone,2691,453,83,93,176,47.2%,1h
25238,2,HarryDeHengs,2691,1480,71,86,157,45.2%,19m
25238,3,Samos,2691,1529,62,65,127,48.8%,5m
25238,3,ElRichards,2691,347,49,50,99,49.5%,5m
25238,1,Ragnar,2691,885,48,38,86,55.8%,1h
25238,2,NoAccess,2691,1085,44,42,86,51.2%,10m
25238,1,[HZeS]Наиль,2691,551,20,15,35,57.1%,59m
25238,1,ZiZ,2691,619,20,18,38,52.6%,51m
25238,1,VersalSTC,2691,434,18,11,29,62.1%,5m
25238,1,MasterLordi,2691,385,17,8,25,68.0%,19m
25238,2,Coestath,2691,260,12,14,26,46.2%,12m
25238,1,Меченый,2691,250,9,10,19,47.4%,1h
25238,3,AlinM,2691,200,6,2,8,75.0%,11m
25238,2,Vargen,2691,167,5,5,10,50.0%,1h
25238,2,[L4DYS]MissTake,2691,181,5,5,10,50.0%,22m
25238,1,NaSHx,2691,169,4,3,7,57.1%,1h
25238,1,[eFikSZ]Psyler,2691,97,4,6,10,40.0%,1h
25238,1,PrZrStalky,2691,105,3,0,3,100.0%,7m
25238,3,Russell,2691,143,3,6,9,33.3%,54m
25238,1,nvim,2691,90,2,0,2,100.0%,7m
25238,3,Jester,2691,0,2,2,4,50.0%,54m
25238,3,[TGZP]СталкерВорон,2691,0,2,3,5,40.0%,1h
25238,2,[NAHUY]Karolis,2691,90,2,8,10,20.0%,24m
25238,2,IMǂMoNsTeR,2691,0,1,0,1,100.0%,1h
25238,1,[FMDRS]Kraki,2691,0,1,0,1,100.0%,26m
25238,1,[Heroes]McMuffin,2691,0,1,0,1,100.0%,1h
25238,1,Franklin,2691,0,1,0,1,100.0%,6m
25238,1,[Nеcro]SKILET,2691,88,1,1,2,50.0%,17m
25238,1,TimeWork,2691,88,1,1,2,50.0%,60m
25238,2,Donbass,2691,46,1,3,4,25.0%,5m
25238,1,[BAces]JohnnyWins,2691,40,1,3,4,25.0%,1h
25238,3,GrimReaper,2691,0,0,1,1,0.0%,26m
25238,1,ФОЛСАД,2691,0,0,1,1,0.0%,57m
25238,3,stormknight,2691,0,0,1,1,0.0%,14m
25238,1,[mfxed]MrSzymon,2691,0,0,1,1,0.0%,10m
25238,1,Lillith,2691,0,0,2,2,0.0%,23m
25238,1,[bgzona]zorosas,2691,0,0,2,2,0.0%,1h
25276,3,[RVP]Akimfly,2690,1490,128,133,261,49.0%,20m
25276,3,MUXAZ,2690,1571,106,106,212,50.0%,18m
25276,1,Foxtrot,2690,932,95,87,182,52.2%,60m
25276,1,Krapiva,2690,1621,93,79,172,54.1%,58m
25276,1,[CОS]Hohol,2690,1182,45,46,91,49.5%,1h
25276,3,TTDeGym,2690,1015,44,34,78,56.4%,21m
25276,1,Max,2690,1040,37,34,71,52.1%,1h
25276,1,[Arrows]Nikita,2690,647,29,26,55,52.7%,51m
25276,1,NegatiV,2690,720,27,24,51,52.9%,58m
25276,3,[UrOP]petersilie,2690,121,26,21,47,55.3%,8m
25276,1,[AFК]sergio,2690,389,15,10,25,60.0%,23m
25276,1,KorbenDallas,2690,300,12,15,27,44.4%,1h
25276,1,Rinzler,2690,297,11,7,18,61.1%,22m
25276,1,Reaper,2690,249,10,5,15,66.7%,24m
25276,1,[MoDTR]Reck,2690,238,8,11,19,42.1%,6m
25276,3,Jacki,2690,219,7,6,13,53.8%,19m
25276,2,[BloTi]Dreamode,2690,218,7,6,13,53.8%,26m
25276,1,BandonBanshe,2690,194,7,8,15,46.7%,1h
25276,1,CINhd,2690,108,4,5,9,44.4%,6m
25276,2,Yrs,2690,30,4,6,10,40.0%,19m
25276,1,Rickmouth,2690,110,3,6,9,33.3%,16m
25276,1,[GACHII]Walker,2690,0,2,3,5,40.0%,1h
25276,1,IIIIIIIIIIII,2690,0,1,0,1,100.0%,54m
25276,1,Ruslan,2690,0,1,3,4,25.0%,1h
25276,3,smartmen,2690,30,1,9,10,10.0%,22m
25276,1,thijsvan,2690,0,0,1,1,0.0%,3m
25276,3,halgard,2690,0,0,8,8,0.0%,8m
25303,1,TVmadlarsk,2689,1654,96,88,184,52.2%,54m
25303,1,Facee,2689,1098,54,41,95,56.8%,4m
25303,1,iRréVersiBle,2689,857,50,30,80,62.5%,5m
25303,1,LeeroyMaxim,2689,574,47,42,89,52.8%,57m
25303,3,[CoCoHo]GnI,2689,649,43,48,91,47.3%,21m
25303,2,Buxman,2689,890,28,46,74,37.8%,7m
25303,3,even,2689,368,15,20,35,42.9%,15m
25303,1,zenmoment,2689,256,10,10,20,50.0%,6m
25303,2,[CHAX]PeriDan,2689,144,5,5,10,50.0%,17m
25303,2,Gary,2689,46,4,5,9,44.4%,17m
25303,2,noroc,2689,46,4,6,10,40.0%,1h
25303,1,Lynar,2689,48,4,6,10,40.0%,20m
25303,1,beno,2689,136,3,2,5,60.0%,1h
25303,1,sureära,2689,0,3,3,6,50.0%,18m
25303,2,Tapsicron,2689,0,3,4,7,42.9%,20m
25303,1,[HaSKo]Мага,2689,36,2,2,4,50.0%,58m
25303,1,Tzaria,2689,36,2,2,4,50.0%,7m
25303,2,[harald]CRiME,2689,115,2,3,5,40.0%,1h
25303,1,maRv,2689,0,2,3,5,40.0%,1h
25303,3,Danske,2689,0,2,3,5,40.0%,1h
25303,1,[Aggri]marlontel,2689,36,2,4,6,33.3%,21m
25303,1,Liuis,2689,0,1,2,3,33.3%,25m
25303,3,oldSport,2689,0,1,2,3,33.3%,19m
25303,1,[MAKinG]Speedy,2689,0,0,1,1,0.0%,1h
25303,1,Crowen,2689,0,0,1,1,0.0%,18m
25303,1,dalle,2689,0,0,2,2,0.0%,22m
25329,2,Grummelbär,2688,678,197,185,382,51.6%,7m
25329,1,voynap,2688,975,171,151,322,53.1%,1h
25329,1,Kampfer,2688,1102,77,70,147,52.4%,1h
25329,3,Cheneo,2688,853,73,77,150,48.7%,14m
25329,1,Diaboluss,2688,1285,61,44,105,58.1%,18m
25329,2,Victorious,2688,1243,61,60,121,50.4%,8m
25329,1,[BiGLoW]Charybdes,2688,1590,58,57,115,50.4%,1h
25329,1,[Дуйте]HvatitDutb,2688,795,33,27,60,55.0%,1h
25329,1,[N1TDA]GravityStilz,2688,739,30,24,54,55.6%,25m
25329,1,Mariachi,2688,541,21,15,36,58.3%,21m
25329,1,Byggsmurf,2688,542,18,21,39,46.2%,51m
25329,3,TheDuck,2688,416,17,19,36,47.2%,20m
25329,3,maxQ,2688,195,15,22,37,40.5%,4m
25329,1,Seiran,2688,302,11,9,20,55.0%,1h
25329,1,bdogstar,2688,265,8,6,14,57.1%,15m
25329,3,[NaEn]thelittleFlo,2688,236,8,15,23,34.8%,23m
25329,1,HellRaiser,2688,118,7,6,13,53.8%,22m
25329,1,[DsK2]Leñador,2688,205,5,6,11,45.5%,1h
25329,3,moid,2688,184,5,8,13,38.5%,15m
25329,1,Nimbuus,2688,102,4,4,8,50.0%,1h
25329,3,StarDuck,2688,30,4,5,9,44.4%,18m
25329,1,[RBTV2]sToneboy,2688,0,4,6,10,40.0%,9m
25329,1,DomPrats,2688,156,4,6,10,40.0%,1h
25329,1,Colorless,2688,40,2,2,4,50.0%,3m
25329,1,[Animoo]Leczez,2688,36,2,3,5,40.0%,1h
25329,3,[Ktfs]Metastone,2688,0,2,3,5,40.0%,1h
25329,1,Liara,2688,0,2,3,5,40.0%,1h
25329,1,VinayDU,2688,0,2,3,5,40.0%,5m
25329,1,AbraXus,2688,113,2,4,6,33.3%,1h
25329,1,BrandNewSCV,2688,76,2,5,7,28.6%,51m
25329,1,CallMeDerp,2688,0,1,0,1,100.0%,58m
25329,3,SCPipowitsch,2688,40,1,1,2,50.0%,1h
25329,1,slowSilver,2688,0,1,1,2,50.0%,1h
25329,1,Dimentor,2688,38,1,4,5,20.0%,51m
25329,2,Nazanimalle,2688,0,0,1,1,0.0%,54m
25329,1,nika,2688,0,0,2,2,0.0%,1h
25365,1,clacbec,2687,1568,219,234,453,48.3%,20m
25365,1,Folksaga,2687,1427,125,119,244,51.2%,19m
25365,1,ghenios,2687,1584,119,112,231,51.5%,22m
25365,3,руся,2687,1375,115,111,226,50.9%,25m
25365,3,FatherTed,2687,1539,86,87,173,49.7%,12m
25365,3,brucejim,2687,1415,54,60,114,47.4%,9m
25365,1,akendo,2687,970,38,33,71,53.5%,3m
25365,3,Teja,2687,855,30,36,66,45.5%,15m
25365,1,[Kuci]Maydanoz,2687,530,19,18,37,51.4%,18m
25365,3,Darkist,2687,424,15,21,36,41.7%,17m
25365,1,Damdam,2687,284,10,10,20,50.0%,1h
25365,3,[PerúES]TitaniumONE,2687,265,9,12,21,42.9%,17m
25365,3,Voin,2687,219,8,13,21,38.1%,22m
25365,1,Darius,2687,156,4,2,6,66.7%,19m
25365,1,Jonni,2687,112,4,8,12,33.3%,1h
25365,1,[IMFM]NectoMax,2687,146,4,9,13,30.8%,1h
25365,3,FAKER,2687,0,3,1,4,75.0%,51m
25365,3,GeneralWeedy,2687,97,3,3,6,50.0%,8m
25365,3,Zheka,2687,97,3,3,6,50.0%,16m
25365,2,mauthoxic,2687,94,3,5,8,37.5%,17m
25365,3,Ardan,2687,0,2,3,5,40.0%,1h
25365,1,Olmage,2687,0,2,3,5,40.0%,22m
25365,2,[XvFe]lehatop,2687,0,2,4,6,33.3%,52m
25365,3,enmuriau,2687,30,2,5,7,28.6%,10m
25365,1,NikSlaughter,2687,0,1,0,1,100.0%,55m
25365,1,[RuVoid]ЧереЧпоЧек,2687,0,1,1,2,50.0%,1h
25365,1,HaveFun,2687,48,1,2,3,33.3%,6m
25365,1,Gabiota,2687,40,1,2,3,33.3%,1h
25365,2,Opifex,2687,95,1,2,3,33.3%,1h
25365,1,Чешир,2687,48,1,4,5,20.0%,17m
25365,1,Moralex,2687,0,0,1,1,0.0%,10m
25365,1,[696]Aiur,2687,0,0,1,1,0.0%,20m
25365,1,lwieserce,2687,0,0,1,1,0.0%,5m
25365,1,sobolesnuy,2687,0,0,1,1,0.0%,18m
25365,3,[Albion]imzilot,2687,0,0,2,2,0.0%,19m
25365,1,Hellcon,2687,73,0,3,3,0.0%,1h
25365,1,Flurry,2687,0,0,4,4,0.0%,1h
25365,1,Swiit,2687,0,0,15,15,0.0%,8m
25403,3,[MARSS]Modejo,2686,1587,148,137,285,51.9%,16m
25403,1,Champa,2686,1707,128,113,241,53.1%,59m
25403,3,Spook,2686,490,33,41,74,44.6%,23m
25403,1,[900iq]veloci,2686,639,26,20,46,56.5%,58m
25403,1,madFUN,2686,452,17,14,31,54.8%,26m
25403,1,TicO,2686,280,13,4,17,76.5%,1h
25403,1,Giuseppe,2686,319,13,13,26,50.0%,1h
25403,3,cotheo,2686,238,11,12,23,47.8%,18m
25403,3,Rentine,2686,339,11,16,27,40.7%,16m
25403,1,Руслан,2686,210,8,8,16,50.0%,58m
25403,1,XDwarningXD,2686,184,6,6,12,50.0%,6m
25403,1,Stepll,2686,167,4,2,6,66.7%,1h
25403,1,JoeSventek,2686,191,4,4,8,50.0%,1h
25403,3,Wretch,2686,97,3,3,6,50.0%,1h
25403,2,denis,2686,0,3,4,7,42.9%,20m
25403,2,shpijt,2686,95,3,5,8,37.5%,1h
25403,1,Zannier,2686,102,3,6,9,33.3%,1h
25403,2,Джон,2686,48,3,6,9,33.3%,1h
25403,1,Mózes,2686,97,2,1,3,66.7%,1h
25403,1,Miraxle,2686,0,2,3,5,40.0%,1h
25403,1,PeterWest,2686,0,2,3,5,40.0%,13m
25403,3,KhalaiONE,2686,97,2,4,6,33.3%,1h
25403,1,[cat222]Blackcat,2686,0,1,0,1,100.0%,19m
25403,1,Mungo,2686,0,1,1,2,50.0%,1h
25403,1,GrumpyDwarf,2686,88,1,1,2,50.0%,1h
25403,1,Mikro,2686,0,0,1,1,0.0%,7m
25403,1,Ruskiy,2686,0,0,1,1,0.0%,9m
25403,1,[CLACK]Raiw,2686,0,0,1,1,0.0%,7m
25403,1,[oooboy]makfek,2686,0,0,1,1,0.0%,5m
25403,1,[PERU]CHOVI,2686,0,0,2,2,0.0%,1h
25403,1,ShadyKat,2686,0,0,2,2,0.0%,9m
25403,1,Angy,2686,0,0,2,2,0.0%,16m
25435,3,Mihanic,2685,1518,87,79,166,52.4%,22m
25435,3,[SPATEN]Ameh,2685,1300,53,53,106,50.0%,23m
25435,3,Novosib,2685,1135,50,54,104,48.1%,11m
25435,1,Leg,2685,1045,39,32,71,54.9%,55m
25435,1,alexios,2685,597,28,9,37,75.7%,1h
25435,1,DaEver,2685,548,26,18,44,59.1%,1h
25435,3,[CFeS]ThePatcher,2685,523,22,21,43,51.2%,25m
25435,3,VIPer,2685,464,21,19,40,52.5%,17m
25435,1,heyjoe,2685,716,21,24,45,46.7%,6m
25435,1,Napalm,2685,326,15,20,35,42.9%,22m
25435,3,Melkor,2685,212,8,12,20,40.0%,9m
25435,1,PsYcHoO,2685,114,7,2,9,77.8%,15m
25435,1,saxx,2685,176,7,9,16,43.8%,5m
25435,1,werann,2685,161,5,4,9,55.6%,1h
25435,1,Demonizer,2685,88,3,3,6,50.0%,7m
25435,2,Slimba,2685,92,3,4,7,42.9%,24m
25435,1,[CM4R]bakermir,2685,129,3,8,11,27.3%,19m
25435,3,[RSCLS]AirborneMark,2685,97,2,3,5,40.0%,59m
25435,3,conkid,2685,97,2,4,6,33.3%,8m
25435,1,[NoAir]SomeCake,2685,0,1,0,1,100.0%,1h
25435,1,sypchik,2685,40,1,4,5,20.0%,21m
25435,1,SexyCactus,2685,0,0,1,1,0.0%,1h
25435,1,Czunior,2685,0,0,1,1,0.0%,51m
25435,1,Malesiak,2685,0,0,2,2,0.0%,14m
25459,3,SaltAndPeppa,2684,1412,68,66,134,50.7%,12m
25459,1,[Grotte]krutovladce,2684,1435,53,47,100,53.0%,1h
25459,3,[DAVMAR]JOE,2684,770,52,46,98,53.1%,12m
25459,1,Yaretzky,2684,962,37,39,76,48.7%,21m
25459,1,Komrade,2684,1002,33,37,70,47.1%,6m
25459,1,Rassa,2684,872,31,28,59,52.5%,1h
25459,3,KKomrade,2684,660,22,29,51,43.1%,22m
25459,1,Yokozuna,2684,572,21,22,43,48.8%,6m
25459,1,artbil,2684,335,13,8,21,61.9%,1h
25459,1,MaxWhite,2684,313,11,7,18,61.1%,1h
25459,1,EliteHunter,2684,258,7,10,17,41.2%,1h
25459,1,Eozo,2684,156,6,6,12,50.0%,1h
25459,3,Trega,2684,177,5,7,12,41.7%,56m
25459,1,edenett,2684,141,5,7,12,41.7%,25m
25459,2,DaDDy,2684,135,3,1,4,75.0%,1h
25459,3,Krarnev,2684,0,3,3,6,50.0%,1h
25459,3,Saradius,2684,0,2,3,5,40.0%,1h
25459,3,[ZARG]ТЕРАН,2684,0,2,3,5,40.0%,26m
25459,1,BlackMada,2684,0,2,3,5,40.0%,5m
25459,1,Kobra,2684,0,2,3,5,40.0%,58m
25459,1,[ZЕRGTV]TheMontanyes,2684,0,0,1,1,0.0%,1h
25459,1,DireWolf,2684,0,0,3,3,0.0%,17m
25481,1,kdmKevin,2683,1630,229,214,443,51.7%,11m
25481,3,Tyrensor,2683,1172,200,196,396,50.5%,15m
25481,1,Ciriacus,2683,1028,87,81,168,51.8%,55m
25481,1,POKERGRIG,2683,1428,64,59,123,52.0%,25m
25481,3,Webaccess,2683,1285,48,53,101,47.5%,23m
25481,1,[VAonA]Zimtpflaume,2683,462,19,18,37,51.4%,22m
25481,1,[KievUA]Shtanina,2683,385,17,9,26,65.4%,25m
25481,1,RichFroning,2683,384,16,17,33,48.5%,23m
25481,1,DrJacek,2683,353,14,11,25,56.0%,1h
25481,2,utrator,2683,428,14,27,41,34.1%,4m
25481,1,IIIIIIIIIIII,2683,371,13,7,20,65.0%,14m
25481,1,SpaceJesus,2683,390,11,13,24,45.8%,1h
25481,3,CaroleBaskin,2683,303,10,14,24,41.7%,1h
25481,3,Рустам,2683,284,9,10,19,47.4%,7m
25481,1,Ecrusor,2683,215,8,2,10,80.0%,1h
25481,1,[8Сега8]сергей,2683,206,7,3,10,70.0%,22m
25481,3,KayKay,2683,118,7,9,16,43.8%,8m
25481,1,Peacestrike,2683,150,5,7,12,41.7%,51m
25481,1,Nazgul,2683,0,4,1,5,80.0%,1h
25481,2,[lokito]lokete,2683,0,4,2,6,66.7%,12m
25481,1,DedFura,2683,143,4,9,13,30.8%,25m
25481,1,teli,2683,105,2,2,4,50.0%,1h
25481,3,GeMyNy,2683,0,2,3,5,40.0%,1h
25481,2,rambomolf,2683,90,2,4,6,33.3%,17m
25481,1,Mrskinlol,2683,0,1,0,1,100.0%,1h
25481,1,Crusader,2683,0,0,1,1,0.0%,1h
25481,1,[2SG2]KOT,2683,0,0,1,1,0.0%,15m
25481,1,[Pollas]Garoth,2683,0,0,2,2,0.0%,1h
25481,1,ManBitesDoGG,2683,0,0,2,2,0.0%,17m
25510,1,Graf,2682,1123,94,94,188,50.0%,4m
25510,1,boozzee,2682,1158,48,41,89,53.9%,1h
25510,1,hault,2682,1308,45,45,90,50.0%,19m
25510,1,MEGODIEGO,2682,692,37,20,57,64.9%,58m
25510,1,Грыжа,2682,443,26,27,53,49.1%,10m
25510,1,Taserface,2682,414,17,12,29,58.6%,7m
25510,1,[SPQT]CPTMARCO,2682,215,11,5,16,68.8%,5m
25510,2,Arbiter,2682,203,8,3,11,72.7%,56m
25510,1,Duckjul,2682,258,7,8,15,46.7%,1h
25510,1,Alebrant,2682,154,6,4,10,60.0%,22m
25510,2,[T2020]donaldtrump,2682,185,5,6,11,45.5%,25m
25510,1,[UF2AC]Вермешелька,2682,146,4,2,6,66.7%,17m
25510,1,[яблоко]Bop,2682,118,4,5,9,44.4%,6m
25510,1,PANDA,2682,150,4,6,10,40.0%,51m
25510,1,EchizoLoviuf,2682,0,3,2,5,60.0%,1h
25510,1,[GymB]DocRabotyaga,2682,36,2,2,4,50.0%,1h
25510,2,BlackGod,2682,0,2,2,4,50.0%,20m
25510,1,CodeOfBars,2682,0,2,3,5,40.0%,4m
25510,1,tamerampire,2682,34,2,4,6,33.3%,11m
25510,1,Ralf,2682,119,2,4,6,33.3%,22m
25510,3,[xDniwe]Ether,2682,30,2,7,9,22.2%,19m
25510,1,[Павшие]ttttttt,2682,0,1,0,1,100.0%,1h
25510,3,Kameleon,2682,30,1,4,5,20.0%,18m
25510,3,Sigitang,2682,0,1,7,8,12.5%,22m
25510,1,Mandos,2682,0,0,1,1,0.0%,1h
25510,2,HeRo,2682,0,0,1,1,0.0%,19m
25510,1,[TacSp]ShadowDragon,2682,0,0,2,2,0.0%,1h
25510,2,BirNedFeniXx,2682,0,0,2,2,0.0%,1h
25510,1,ChangeCaps,2682,0,0,2,2,0.0%,1h
25510,3,Jack,2682,0,0,5,5,0.0%,5m
25540,3,Zero,2681,1631,148,143,291,50.9%,3m
25540,1,kanalizer,2681,1035,65,52,117,55.6%,1h
25540,1,Napoleon,2681,1052,53,37,90,58.9%,59m
25540,1,Vikz,2681,680,42,32,74,56.8%,1h
25540,3,vulfgar,2681,618,32,37,69,46.4%,8m
25540,3,[MaG6i]Visage,2681,800,27,38,65,41.5%,22m
25540,3,Curunir,2681,672,26,30,56,46.4%,4m
25540,1,QuarantinO,2681,528,16,17,33,48.5%,1h
25540,1,sagebeard,2681,370,10,10,20,50.0%,5m
25540,3,ClancyWiggum,2681,192,8,12,20,40.0%,22m
25540,1,[0860]Broxi,2681,188,6,3,9,66.7%,1h
25540,2,Gratwicke,2681,115,5,3,8,62.5%,59m
25540,1,JleLmeshek,2681,34,2,2,4,50.0%,1h
25540,1,[mmmeow]rollcat,2681,92,2,2,4,50.0%,1h
25540,1,Yoda,2681,48,2,2,4,50.0%,1h
25540,3,MagiK,2681,0,2,2,4,50.0%,1h
25540,1,Loke,2681,34,2,6,8,25.0%,18m
25540,1,Hoblin,2681,30,1,2,3,33.3%,1h
25540,3,DougSluggins,2681,0,1,6,7,14.3%,17m
25540,3,Vladisl,2681,0,0,1,1,0.0%,1h
25540,1,XvaT,2681,0,0,1,1,0.0%,1h
25540,1,Amirka,2681,0,0,2,2,0.0%,23m
25540,1,JunckMAn,2681,0,0,6,6,0.0%,1h
25563,3,Vorenus,2680,1635,530,521,1051,50.4%,11m
25563,3,Tiger,2680,1286,99,89,188,52.7%,19m
25563,2,weefatjimmy,2680,783,66,74,140,47.1%,22m
25563,1,FiltHOFApriL,2680,1394,54,51,105,51.4%,1h
25563,1,[SKYBRS]Nialllll,2680,884,51,25,76,67.1%,58m
25563,1,Satirio,2680,877,44,34,78,56.4%,1h
25563,3,PlanB,2680,788,30,30,60,50.0%,25m
25563,1,Charles,2680,551,19,17,36,52.8%,1h
25563,2,Biba,2680,496,17,17,34,50.0%,22m
25563,1,FoxTrot,2680,542,17,18,35,48.6%,5m
25563,1,quaz,2680,449,17,22,39,43.6%,6m
25563,1,hells,2680,361,15,9,24,62.5%,58m
25563,1,SmieCIU,2680,359,14,14,28,50.0%,1h
25563,3,[PNZ]Plague,2680,152,11,13,24,45.8%,5m
25563,3,ttoommyy,2680,350,10,17,27,37.0%,17m
25563,3,[mfxed]Imper,2680,228,9,11,20,45.0%,18m
25563,2,Anttwo,2680,88,8,2,10,80.0%,1h
25563,1,Sitahyn,2680,192,6,8,14,42.9%,6m
25563,3,NeO,2680,144,4,5,9,44.4%,23m
25563,2,Anomander,2680,0,4,5,9,44.4%,4m
25563,2,Croups,2680,48,4,6,10,40.0%,20m
25563,1,[Zehdis]GAYLORD,2680,112,4,6,10,40.0%,21m
25563,3,Obélix,2680,96,4,12,16,25.0%,12m
25563,2,[ScVigo]cabaGZ,2680,132,4,19,23,17.4%,22m
25563,2,mikus,2680,94,3,4,7,42.9%,24m
25563,1,[Blatzs]Morpheus,2680,89,2,0,2,100.0%,15m
25563,1,DaCheetah,2680,0,2,3,5,40.0%,1h
25563,2,Aleksrus,2680,0,1,0,1,100.0%,1h
25563,2,[NNcity]zmeika,2680,0,1,0,1,100.0%,57m
25563,1,Metropolit,2680,0,1,0,1,100.0%,15m
25563,2,Alex,2680,30,1,1,2,50.0%,1h
25563,2,SoulPred,2680,0,1,2,3,33.3%,1h
25563,1,lahamali,2680,40,1,4,5,20.0%,1h
25563,1,GordonCZ,2680,97,1,4,5,20.0%,6m
25563,2,[Candy1]Sanchez,2680,0,0,1,1,0.0%,1h
25563,1,GibLing,2680,0,0,2,2,0.0%,58m
25599,1,Rab,2679,1673,99,82,181,54.7%,1h
25599,2,coswalk,2679,1548,74,70,144,51.4%,51m
25599,3,Panoramix,2679,862,66,73,139,47.5%,7m
25599,1,Zzarp,2679,1438,65,45,110,59.1%,22m
25599,1,Lennox,2679,690,55,55,110,50.0%,51m
25599,3,Swetalian,2679,1232,53,44,97,54.6%,15m
25599,3,ObiWan,2679,132,32,30,62,51.6%,19m
25599,3,jihadxdeath,2679,696,30,39,69,43.5%,22m
25599,2,WackerPacker,2679,715,27,35,62,43.5%,17m
25599,3,ubi,2679,450,17,18,35,48.6%,8m
25599,1,[youy]PeaceWall,2679,243,9,6,15,60.0%,54m
25599,1,Gus,2679,323,9,11,20,45.0%,25m
25599,1,Ultra,2679,0,4,3,7,57.1%,19m
25599,2,GeraX,2679,114,4,4,8,50.0%,1h
25599,2,Lugal,2679,30,3,3,6,50.0%,26m
25599,1,[4SALE]Maxbot,2679,0,1,1,2,50.0%,1h
25599,1,Kaneda,2679,0,1,1,2,50.0%,23m
25599,1,Alkanooo,2679,0,1,2,3,33.3%,1h
25599,3,Foggsi,2679,97,1,5,6,16.7%,1h
25599,3,ECHOFOX,2679,30,1,12,13,7.7%,18m
25599,2,QaredBY,2679,0,0,1,1,0.0%,60m
25599,1,greedisgood,2679,0,0,3,3,0.0%,5m
25621,1,Vagabund,2678,1161,90,91,181,49.7%,51m
25621,1,Pawel,2678,1461,68,64,132,51.5%,22m
25621,2,Katerina,2678,428,47,35,82,57.3%,1h
25621,1,Elephant,2678,569,47,40,87,54.0%,7m
25621,1,Wolk,2678,976,35,36,71,49.3%,5m
25621,1,bestlover,2678,849,33,28,61,54.1%,19m
25621,1,ZZZergling,2678,680,29,35,64,45.3%,20m
25621,1,PlzStop,2678,780,27,29,56,48.2%,1h
25621,1,[VRVR]Coco,2678,309,22,24,46,47.8%,22m
25621,1,adi,2678,328,14,14,28,50.0%,1h
25621,3,nklzwei,2678,351,13,9,22,59.1%,17m
25621,2,NeverRush,2678,273,9,14,23,39.1%,15m
25621,3,FourTwentyLE,2678,216,8,7,15,53.3%,21m
25621,1,savionok,2678,202,7,4,11,63.6%,4m
25621,2,Skerelechuga,2678,76,5,6,11,45.5%,18m
25621,3,ROBOTIX,2678,180,5,9,14,35.7%,7m
25621,1,Hilps,2678,184,4,4,8,50.0%,54m
25621,2,[FAZE69]Eltigrethor,2678,142,3,3,6,50.0%,23m
25621,1,[xFire]Tssuki,2678,64,3,3,6,50.0%,1h
25621,3,[DMM]schindler,2678,38,3,4,7,42.9%,58m
25621,3,Castel,2678,120,2,2,4,50.0%,1h
25621,2,Chiddybang,2678,0,2,3,5,40.0%,1h
25621,2,Connectvl,2678,0,2,3,5,40.0%,24m
25621,2,Kristofer,2678,0,2,3,5,40.0%,9m
25621,3,ДядяСаша,2678,0,2,4,6,33.3%,6m
25621,3,RobDaBob,2678,97,2,4,6,33.3%,1h
25621,2,DICCTUCKERRR,2678,32,1,1,2,50.0%,1h
25621,2,Koevoet,2678,95,1,3,4,25.0%,19m
25621,1,Eldershot,2678,34,1,4,5,20.0%,23m
25621,2,BadBjarne,2678,0,0,1,1,0.0%,1h
25621,3,dezeaster,2678,0,0,1,1,0.0%,1h
25652,2,Kushtro,2677,1655,242,253,495,48.9%,14m
25652,3,Sigma,2677,1516,171,170,341,50.1%,21m
25652,3,Danduul,2677,1547,116,121,237,48.9%,11m
25652,1,OCMAK,2677,777,49,46,95,51.6%,56m
25652,1,[PANGOL]alvaro,2677,974,40,33,73,54.8%,58m
25652,2,[CREPES]Guideuz,2677,834,36,22,58,62.1%,51m
25652,1,AlexBusu,2677,595,25,17,42,59.5%,1h
25652,1,berismode,2677,671,22,20,42,52.4%,18m
25652,1,[VFN]RazvanBly,2677,555,20,13,33,60.6%,1h
25652,1,perdunamun,2677,346,14,8,22,63.6%,5m
25652,2,ramin,2677,399,14,13,27,51.9%,51m
25652,1,Demozor,2677,396,13,17,30,43.3%,1h
25652,1,[TTRaid]MoonSlicer,2677,329,12,7,19,63.2%,6m
25652,3,DonJosé,2677,324,11,16,27,40.7%,18m
25652,3,[BBTinc]Busparachute,2677,230,8,17,25,32.0%,4m
25652,2,Nohow,2677,83,7,5,12,58.3%,1h
25652,2,Гудвин,2677,94,4,2,6,66.7%,15m
25652,2,Teutonic,2677,88,4,2,6,66.7%,1h
25652,3,BladeRaynor,2677,94,4,4,8,50.0%,7m
25652,3,Altelion,2677,81,4,7,11,36.4%,22m
25652,1,[thEnd]DeadEnd,2677,141,3,0,3,100.0%,1h
25652,2,XLogic,2677,30,3,3,6,50.0%,1h
25652,2,BURNMOTO,2677,92,3,3,6,50.0%,1h
25652,1,Malma,2677,114,3,8,11,27.3%,1h
25652,1,nick,2677,42,2,2,4,50.0%,1h
25652,2,Дичь,2677,0,2,3,5,40.0%,14m
25652,2,Берия,2677,0,1,0,1,100.0%,1h
25652,2,[RuIT]Deamk,2677,0,1,0,1,100.0%,15m
25652,1,Yans,2677,0,1,1,2,50.0%,15m
25652,1,Жнец,2677,0,1,2,3,33.3%,1h
25652,1,[Jojо]Ennariel,2677,38,1,3,4,25.0%,4m
25652,3,ToroMonsu,2677,0,0,1,1,0.0%,1h
25652,2,BastiAKA,2677,0,0,1,1,0.0%,53m
25652,2,[TrHH]FlushGordon,2677,0,0,1,1,0.0%,1h
25652,2,ekatory,2677,0,0,1,1,0.0%,1h
25652,2,[KRATZA]TomRipley,2677,0,0,1,1,0.0%,1h
25688,3,SauronsPets,2676,799,42,47,89,47.2%,5m
25688,1,Connor,2676,346,39,39,78,50.0%,1h
25688,3,[XDN]lip,2676,680,24,35,59,40.7%,11m
25688,2,sirian,2676,425,16,20,36,44.4%,9m
25688,1,Vadoss,2676,440,14,16,30,46.7%,1h
25688,3,skyknight,2676,285,10,10,20,50.0%,21m
25688,3,kia,2676,144,8,9,17,47.1%,19m
25688,1,[Nеzukо]Stewano,2676,246,7,10,17,41.2%,1h
25688,2,[EXPANT]Drukaron,2676,220,6,7,13,46.2%,10m
25688,1,peaceprayer,2676,178,4,4,8,50.0%,9m
25688,2,TOnE,2676,58,4,4,8,50.0%,1h
25688,3,ZebraSteve,2676,120,3,1,4,75.0%,53m
25688,3,Whiskey,2676,64,3,14,17,17.6%,21m
25688,2,CrazyCat,2676,0,2,3,5,40.0%,57m
25688,2,[IsTcI]DANATH,2676,0,1,0,1,100.0%,11m
25688,1,tga,2676,73,1,4,5,20.0%,5m
25688,3,Cute,2676,0,1,5,6,16.7%,6m
25688,1,mrT,2676,40,1,7,8,12.5%,5m
25688,2,Pixar,2676,0,0,1,1,0.0%,51m
25688,1,corradolab,2676,0,0,2,2,0.0%,51m
25708,3,kit,2675,1549,142,147,289,49.1%,22m
25708,3,BroilerBear,2675,1581,71,82,153,46.4%,11m
25708,3,JesuQ,2675,746,40,38,78,51.3%,18m
25708,3,DORU,2675,557,28,27,55,50.9%,15m
25708,2,EvilKraM,2675,521,20,14,34,58.8%,22m
25708,2,szparo,2675,408,12,22,34,35.3%,14m
25708,2,cannonrusher,2675,248,8,7,15,53.3%,1h
25708,1,MoodSwings,2675,216,8,9,17,47.1%,54m
25708,1,Tret,2675,261,8,10,18,44.4%,24m
25708,2,SeapZeus,2675,30,4,2,6,66.7%,54m
25708,3,OliveOil,2675,155,4,4,8,50.0%,1h
25708,1,[3ЕRGTV]Narkom,2675,137,4,5,9,44.4%,1h
25708,1,Sorrko,2675,82,3,7,10,30.0%,1h
25708,2,kTWOmoz,2675,0,2,3,5,40.0%,20m
25708,3,Волк,2675,0,2,3,5,40.0%,1h
25708,2,[Advox]Wildrine,2675,0,1,0,1,100.0%,20m
25708,1,[SkCzM]Yogregator,2675,0,1,2,3,33.3%,1h
25708,2,Grimmjow,2675,0,1,4,5,20.0%,54m
25708,1,ShadowMaster,2675,34,1,5,6,16.7%,4m
25708,2,Berserck,2675,0,0,1,1,0.0%,1h
25708,2,smoog,2675,0,0,1,1,0.0%,16m
25708,1,Levka,2675,0,0,2,2,0.0%,1h
25730,3,Gulp,2674,1263,194,202,396,49.0%,4m
25730,1,Proctor,2674,1688,164,162,326,50.3%,17m
25730,3,Murchan,2674,1399,81,83,164,49.4%,16m
25730,2,BabaChimbo,2674,1522,63,52,115,54.8%,1h
25730,1,Elcarnefice,2674,1254,56,48,104,53.8%,1h
25730,2,sfs,2674,839,34,26,60,56.7%,8m
25730,1,batist,2674,993,33,32,65,50.8%,6m
25730,2,Artemopolus,2674,376,29,17,46,63.0%,60m
25730,3,TOMBULyürek,2674,662,27,33,60,45.0%,11m
25730,2,[D0N3]Tehdemonic,2674,542,21,13,34,61.8%,1h
25730,1,Dato,2674,573,20,14,34,58.8%,15m
25730,2,[Gayf]molocho,2674,374,17,2,19,89.5%,54m
25730,3,Macarena,2674,372,16,18,34,47.1%,13m
25730,1,tea,2674,409,14,16,30,46.7%,58m
25730,1,tiptop,2674,271,8,12,20,40.0%,1h
25730,1,kentang,2674,224,7,7,14,50.0%,1h
25730,1,DOLPHIN,2674,237,7,9,16,43.8%,1h
25730,1,Weeret,2674,180,5,7,12,41.7%,7m
25730,2,Nite,2674,134,5,9,14,35.7%,1h
25730,1,Rezek,2674,76,4,5,9,44.4%,1h
25730,3,STORM,2674,60,4,7,11,36.4%,22m
25730,2,NightKnight,2674,88,3,1,4,75.0%,12m
25730,1,Kucharro,2674,106,2,2,4,50.0%,26m
25730,3,Dwar,2674,0,2,2,4,50.0%,9m
25730,2,Teemcki,2674,0,2,3,5,40.0%,1h
25730,2,[KSRF]MaXTnT,2674,0,1,0,1,100.0%,1h
25730,2,[ClDlN]ChopperChuck,2674,0,1,0,1,100.0%,1h
25730,1,Solar,2674,0,1,0,1,100.0%,58m
25730,2,Random,2674,32,1,2,3,33.3%,1h
25730,2,ENEMY,2674,30,1,2,3,33.3%,1h
25730,1,[xVADEx]Heruion,2674,38,1,4,5,20.0%,1h
25730,1,JustusDark,2674,38,1,6,7,14.3%,4m
25730,1,[DHYD]Sziki,2674,0,0,2,2,0.0%,5m
25763,1,ErwinBanana,2673,1587,70,59,129,54.3%,5m
25763,2,Versus,2673,1532,69,56,125,55.2%,1h
25763,1,[Ebalay]llllllllllll,2673,1156,39,41,80,48.8%,4m
25763,1,Oldmarine,2673,875,33,36,69,47.8%,17m
25763,2,[SZM]SpectrumUnit,2673,518,21,26,47,44.7%,14m
25763,1,theconkerer,2673,487,18,15,33,54.5%,1h
25763,1,loo,2673,354,13,16,29,44.8%,22m
25763,3,Dogma,2673,298,12,10,22,54.5%,17m
25763,1,Copinou,2673,358,11,15,26,42.3%,23m
25763,2,[KyPe]PAPIRUS,2673,212,7,0,7,100.0%,1h
25763,1,[OPStar]Merciful,2673,195,6,5,11,54.5%,4m
25763,2,Skinski,2673,0,4,1,5,80.0%,25m
25763,1,Blitzer,2673,121,3,3,6,50.0%,20m
25763,3,JOfromLV,2673,0,2,3,5,40.0%,54m
25763,3,Censetor,2673,0,2,3,5,40.0%,17m
25763,3,Hanno,2673,0,2,3,5,40.0%,1h
25763,2,Luqin,2673,0,2,5,7,28.6%,25m
25763,1,bwlaren,2673,38,1,4,5,20.0%,20m
25763,1,Voodoo,2673,0,0,2,2,0.0%,9m
25763,1,HOCOK,2673,0,0,3,3,0.0%,5m
25763,1,Snigelsak,2673,0,0,5,5,0.0%,15m
25784,3,yzak,2672,1584,381,353,734,51.9%,14m
25784,1,[xNGSx]Donjohnson,2672,1146,68,67,135,50.4%,1h
25784,1,Taigabear,2672,1490,64,51,115,55.7%,58m
25784,3,stelim,2672,556,60,71,131,45.8%,6m
25784,3,Anton,2672,747,32,30,62,51.6%,8m
25784,1,[OHOHO]aronlimm,2672,499,15,15,30,50.0%,58m
25784,2,Petrishka,2672,373,11,12,23,47.8%,51m
25784,2,Flower,2672,222,7,2,9,77.8%,20m
25784,2,Keshtarr,2672,118,5,6,11,45.5%,14m
25784,1,Sekky,2672,186,5,10,15,33.3%,58m
25784,2,HYDRAPONIC,2672,0,4,1,5,80.0%,1h
25784,1,[6L6]Evoleno,2672,68,3,3,6,50.0%,5m
25784,1,Kallisto,2672,78,3,4,7,42.9%,1h
25784,1,hITECH,2672,156,3,4,7,42.9%,6m
25784,2,[AKD2]MoriTuri,2672,0,3,5,8,37.5%,22m
25784,2,Rjakazavr,2672,30,2,0,2,100.0%,1h
25784,1,LuckyFox,2672,89,2,1,3,66.7%,1h
25784,2,[Hybrid]GiantIguana,2672,0,2,3,5,40.0%,14m
25784,3,gCmax,2672,0,2,3,5,40.0%,60m
25784,2,AkhéNova,2672,32,1,2,3,33.3%,20m
25784,1,skiq,2672,38,1,3,4,25.0%,1h
25784,2,[IceN]Wibble,2672,0,1,8,9,11.1%,9m
25784,2,Sorim,2672,0,0,1,1,0.0%,51m
25784,2,[XOMЯKИ]Cristalpkey,2672,0,0,1,1,0.0%,1h
25784,1,DrLektor,2672,0,0,3,3,0.0%,6m
25809,1,AXASTOS,2671,1704,152,144,296,51.4%,1h
25809,1,Valco,2671,1479,151,149,300,50.3%,18m
25809,1,Lagartus,2671,1667,128,120,248,51.6%,1h
25809,3,[DeRpYH]DerpyHooves,2671,835,62,65,127,48.8%,11m
25809,1,[696]MishRqt,2671,1477,51,54,105,48.6%,17m
25809,3,SLAM,2671,1107,49,55,104,47.1%,11m
25809,1,Conman,2671,481,42,30,72,58.3%,1h
25809,3,Bootsvorz,2671,1063,38,40,78,48.7%,22m
25809,2,PongLenis,2671,547,28,18,46,60.9%,1h
25809,1,wiistriker,2671,550,24,30,54,44.4%,52m
25809,2,Palazzo,2671,462,20,30,50,40.0%,23m
25809,1,HeavyMetal,2671,268,16,18,34,47.1%,17m
25809,1,FunnyHawk,2671,235,11,7,18,61.1%,22m
25809,2,SVERHRAZUMMM,2671,242,9,8,17,52.9%,1h
25809,3,Triss,2671,182,6,1,7,85.7%,1h
25809,1,Awsky,2671,204,5,5,10,50.0%,1h
25809,2,Incendiis,2671,136,5,6,11,45.5%,1h
25809,1,SannyKrocket,2671,201,5,8,13,38.5%,11m
25809,2,[сSсǃ]MacroLee,2671,153,4,0,4,100.0%,18m
25809,2,Nesvop,2671,88,4,6,10,40.0%,11m
25809,1,WahWah,2671,148,4,7,11,36.4%,1h
25809,1,[xTSAx]Firuz,2671,100,3,6,9,33.3%,23m
25809,1,FeYzUlLaH,2671,143,3,6,9,33.3%,11m
25809,2,Antagonist,2671,0,2,3,5,40.0%,51m
25809,2,BigBug,2671,0,2,3,5,40.0%,1h
25809,1,Wicked,2671,78,2,4,6,33.3%,14m
25809,3,alexgordon,2671,0,2,4,6,33.3%,16m
25809,3,NoseMan,2671,105,2,5,7,28.6%,1h
25809,2,MindBreaK,2671,0,0,1,1,0.0%,1h
25838,1,Radagast,2670,1464,74,59,133,55.6%,18m
25838,3,Pirx,2670,1380,50,56,106,47.2%,20m
25838,1,coocoo,2670,859,35,27,62,56.5%,1h
25838,3,MORBAK,2670,546,23,31,54,42.6%,5m
25838,1,Eezzy,2670,532,21,12,33,63.6%,7m
25838,2,GuiltYCroWn,2670,548,20,20,40,50.0%,9m
25838,3,vanillah,2670,600,20,28,48,41.7%,11m
25838,1,Mauronz,2670,474,18,16,34,52.9%,1h
25838,2,[AFLG]simbilou,2670,540,18,24,42,42.9%,6m
25838,1,[DFwN]MrIcq,2670,438,15,15,30,50.0%,52m
25838,1,leshkasagit,2670,250,13,10,23,56.5%,1h
25838,3,Hartzenegger,2670,348,11,19,30,36.7%,10m
25838,2,Azazel,2670,253,8,7,15,53.3%,1h
25838,1,[IIuBo]KickOFF,2670,192,7,6,13,53.8%,22m
25838,2,iQNoX,2670,158,6,3,9,66.7%,14m
25838,2,Kam,2670,96,4,1,5,80.0%,1h
25838,3,[MtWd]Papa,2670,97,4,2,6,66.7%,1h
25838,3,ManniRumpel,2670,0,4,2,6,66.7%,21m
25838,1,Koma,2670,160,4,3,7,57.1%,11m
25838,3,[eisgä]Shadow,2670,97,3,3,6,50.0%,1h
25838,2,[ZERGSC]EgorPomidor,2670,0,1,0,1,100.0%,19m
25838,1,[ANUUS]Yahmacka,2670,0,1,1,2,50.0%,1h
25838,1,Concord,2670,36,1,3,4,25.0%,25m
25838,2,[NoMczZ]tontsa,2670,0,0,1,1,0.0%,6m
25838,2,TenYearsOld,2670,0,0,1,1,0.0%,1h
25838,1,[oooboy]Baron,2670,0,0,3,3,0.0%,14m
25838,1,[Hydrа]Kaspiec,2670,0,0,3,3,0.0%,1h
25865,3,[LEVATI]Maestral,2669,1526,258,233,491,52.5%,4m
25865,2,Bussova,2669,1726,94,86,180,52.2%,1h
25865,2,[RvlD]Pramuk,2669,1436,49,62,111,44.1%,11m
25865,1,ignis,2669,221,33,22,55,60.0%,10m
25865,3,Zaxon,2669,440,20,18,38,52.6%,6m
25865,2,xouma,2669,476,19,10,29,65.5%,1h
25865,1,Veugel,2669,293,12,10,22,54.5%,1h
25865,1,Одессит,2669,210,10,6,16,62.5%,20m
25865,1,Kokuszdió,2669,184,8,4,12,66.7%,1h
25865,3,MPlordmaster,2669,185,8,8,16,50.0%,14m
25865,2,IPviper,2669,94,4,1,5,80.0%,1h
25865,2,Oicnebur,2669,30,2,0,2,100.0%,18m
25865,1,Shatolllllll,2669,103,2,2,4,50.0%,1h
25865,2,TerrGun,2669,0,2,3,5,40.0%,20m
25865,2,[LTFBF]EagleInZen,2669,111,2,3,5,40.0%,1h
25865,1,[ŁATWO]Ubumsulwa,2669,0,1,1,2,50.0%,14m
25865,3,zzuper,2669,0,1,3,4,25.0%,14m
25865,2,BluENIght,2669,0,0,1,1,0.0%,1h
25865,2,[TOCC]Vendetta,2669,0,0,1,1,0.0%,1h
25865,3,ChlupChrup,2669,0,0,1,1,0.0%,1h
25865,1,leha,2669,0,0,2,2,0.0%,1h
25865,2,[DvX]RuggiFuma,2669,0,0,5,5,0.0%,9m
25887,1,Brukal,2668,1438,75,61,136,55.1%,25m
25887,1,LePtiTondu,2668,1430,68,69,137,49.6%,10m
25887,2,NAGIBATOR,2668,779,64,79,143,44.8%,15m
25887,1,thebenjifier,2668,1044,52,49,101,51.5%,52m
25887,1,Wolfram,2668,892,38,43,81,46.9%,10m
25887,1,dax,2668,733,24,24,48,50.0%,10m
25887,1,MashiMaro,2668,570,18,18,36,50.0%,1h
25887,1,Valplayer,2668,460,13,19,32,40.6%,1h
25887,3,[SPАСЕ]NoobStar,2668,404,13,25,38,34.2%,12m
25887,2,komarenko,2668,228,11,14,25,44.0%,9m
25887,1,zayaz,2668,315,8,15,23,34.8%,1h
25887,2,bzhbg,2668,161,6,6,12,50.0%,6m
25887,1,[QaDo]MMD,2668,151,5,2,7,71.4%,5m
25887,2,[nSjT]Wiman,2668,92,5,6,11,45.5%,1h
25887,1,[SeeLaw]Jordan,2668,155,4,4,8,50.0%,18m
25887,2,Blue,2668,0,2,3,5,40.0%,14m
25887,3,Silmarill,2668,0,2,3,5,40.0%,4m
25887,3,[TrMy]LisAnty,2668,0,2,3,5,40.0%,1h
25887,2,[Lidеr]Usual,2668,0,2,3,5,40.0%,1h
25887,1,Maloos,2668,36,2,4,6,33.3%,52m
25887,2,briedukas,2668,34,1,2,3,33.3%,18m
25887,2,marvelution,2668,0,1,2,3,33.3%,1h
25887,2,[IIIII]Conan,2668,30,1,15,16,6.2%,19m
25887,2,SheRe,2668,0,0,1,1,0.0%,25m
25887,2,Márko,2668,0,0,1,1,0.0%,1h
25887,1,ricochoutx,2668,0,0,2,2,0.0%,1h
25913,2,DASMAN,2667,1476,71,82,153,46.4%,7m
25913,1,Svoi,2667,1402,65,56,121,53.7%,18m
25913,2,Vanvren,2667,400,17,15,32,53.1%,1h
25913,2,Egos,2667,348,14,4,18,77.8%,1h
25913,3,Berias,2667,316,14,16,30,46.7%,21m
25913,2,attila,2667,272,11,7,18,61.1%,1h
25913,1,biscuit,2667,283,10,6,16,62.5%,1h
25913,2,dudg,2667,183,6,6,12,50.0%,1h
25913,1,CrasyStraus,2667,148,5,6,11,45.5%,1h
25913,1,Efo,2667,214,5,6,11,45.5%,1h
25913,3,KikoCeia,2667,109,4,5,9,44.4%,14m
25913,1,jakaba,2667,104,3,2,5,60.0%,1h
25913,3,Повелитель,2667,0,3,4,7,42.9%,21m
25913,3,[1830]GeperTrast,2667,114,3,7,10,30.0%,19m
25913,2,Pav,2667,32,2,0,2,100.0%,57m
25913,2,MsNetheMare,2667,58,2,1,3,66.7%,1h
25913,2,WujcioPapcio,2667,0,2,3,5,40.0%,24m
25913,2,muricacheese,2667,0,2,3,5,40.0%,20m
25913,1,JBlecoq,2667,76,2,8,10,20.0%,58m
25913,2,Anov,2667,0,1,0,1,100.0%,8m
25913,2,Akinovitch,2667,0,0,1,1,0.0%,1h
25913,3,[Igd]NATLER,2667,0,0,2,2,0.0%,1h
25913,1,zxpility,2667,0,0,2,2,0.0%,1h
25913,1,SuperO,2667,0,0,2,2,0.0%,9m
25937,2,[OmDi]Antei,2666,1331,313,302,615,50.9%,4m
25937,3,AferisT,2666,1597,131,127,258,50.8%,18m
25937,3,[KAZAN]Duy,2666,1293,123,127,250,49.2%,9m
25937,3,SovietUnion,2666,1141,111,106,217,51.2%,8m
25937,3,Cardan,2666,770,78,60,138,56.5%,15m
25937,1,Polymorph,2666,596,40,23,63,63.5%,55m
25937,1,NotAGift,2666,573,20,18,38,52.6%,1h
25937,3,[KAOTx]nizcO,2666,500,20,23,43,46.5%,24m
25937,2,Needled,2666,410,17,16,33,51.5%,1h
25937,1,KingAchilles,2666,379,16,15,31,51.6%,22m
25937,1,[BNSkor]laddegar,2666,202,13,14,27,48.1%,1h
25937,2,Schmutzfink,2666,320,11,11,22,50.0%,52m
25937,1,Hayk,2666,382,11,12,23,47.8%,58m
25937,1,Boozebeard,2666,268,10,6,16,62.5%,1h
25937,2,Andros,2666,228,8,5,13,61.5%,56m
25937,1,laowai,2666,244,8,12,20,40.0%,1h
25937,1,[khps]Cherembsha,2666,104,6,3,9,66.7%,26m
25937,2,Vena,2666,166,6,6,12,50.0%,11m
25937,3,Gulak,2666,0,3,4,7,42.9%,19m
25937,3,LeMmiT,2666,18,3,11,14,21.4%,13m
25937,3,Opax,2666,42,2,0,2,100.0%,1h
25937,3,nik,2666,0,2,4,6,33.3%,1h
25937,2,IDDQD,2666,0,1,0,1,100.0%,56m
25937,1,[StatsF]PashaF,2666,89,1,2,3,33.3%,22m
25937,1,[Daos]DaosStyX,2666,42,1,6,7,14.3%,54m
25937,2,[RFTW2k]Tardface,2666,0,0,1,1,0.0%,54m
25937,2,soliman,2666,0,0,1,1,0.0%,1h
25937,1,DEXTER,2666,0,0,2,2,0.0%,1h
25937,1,Чеб,2666,0,0,6,6,0.0%,1h
25966,3,TheBayesian,2665,1525,105,99,204,51.5%,18m
25966,1,NBdestorm,2665,1684,94,91,185,50.8%,25m
25966,1,[GTDK]Drocky,2665,1066,43,26,69,62.3%,1h
25966,1,[TATAT]Kurundir,2665,927,36,32,68,52.9%,1h
25966,3,ALEOLE,2665,795,30,32,62,48.4%,9m
25966,2,LordW,2665,270,20,38,58,34.5%,8m
25966,1,[3DE]HeckobA,2665,370,15,12,27,55.6%,1h
25966,2,[teksol]Fearta,2665,210,9,9,18,50.0%,1h
25966,2,[Scam]Sorryforthat,2665,235,7,8,15,46.7%,1h
25966,3,Maul,2665,0,3,2,5,60.0%,26m
25966,3,[WANG]Crookster,2665,94,3,6,9,33.3%,19m
25966,2,MiguelAngel,2665,0,2,2,4,50.0%,1h
25966,2,Dezu,2665,0,2,3,5,40.0%,51m
25966,2,MAESTRO,2665,0,2,3,5,40.0%,20m
25966,3,Alestraz,2665,30,2,7,9,22.2%,18m
25966,3,[TedB]LATAR,2665,0,1,0,1,100.0%,1h
25966,2,iiiiiiiiiii,2665,0,1,2,3,33.3%,20m
25966,1,[PLA2N]Psihosenser,2665,38,1,3,4,25.0%,26m
25966,2,Goggi,2665,0,1,4,5,20.0%,1h
25966,2,Slayer,2665,30,1,5,6,16.7%,14m
25966,3,Human,2665,0,1,6,7,14.3%,14m
25966,2,[1NFEC7]Noop,2665,0,0,1,1,0.0%,1h
25988,2,OldStudent,2664,1575,103,112,215,47.9%,13m
25988,1,MadShawarma,2664,1697,64,63,127,50.4%,7m
25988,1,masterbart,2664,1393,58,45,103,56.3%,1h
25988,1,[ETP]Nokem,2664,1247,48,45,93,51.6%,4m
25988,3,Alex,2664,894,46,48,94,48.9%,14m
25988,2,Libo,2664,1020,45,31,76,59.2%,18m
25988,3,DieHappy,2664,1050,42,37,79,53.2%,6m
25988,1,[RVT]FXBaBaHaHn,2664,451,17,16,33,51.5%,58m
25988,1,mak,2664,292,16,11,27,59.3%,1h
25988,2,BRONZEUR,2664,507,15,28,43,34.9%,11m
25988,3,rashad,2664,392,14,20,34,41.2%,16m
25988,1,Martoz,2664,215,8,6,14,57.1%,1h
25988,3,[M4GYK]OENSuperstar,2664,164,8,8,16,50.0%,15m
25988,1,BattleBob,2664,238,8,8,16,50.0%,23m
25988,1,[burrit]dafvid,2664,110,4,5,9,44.4%,22m
25988,1,Ilda,2664,116,4,6,10,40.0%,58m
25988,1,Jarvis,2664,169,4,8,12,33.3%,15m
25988,1,KaEmIks,2664,0,3,3,6,50.0%,26m
25988,3,HoBBeS,2664,38,3,4,7,42.9%,18m
25988,2,mcPeter,2664,34,2,0,2,100.0%,1h
25988,1,Koer,2664,72,2,4,6,33.3%,1h
25988,1,ASPAEJIb,2664,0,2,4,6,33.3%,22m
25988,1,[NANNA]NaTuRaL,2664,42,2,5,7,28.6%,1h
25988,1,Jannoir,2664,30,2,5,7,28.6%,1h
25988,1,CptVimes,2664,0,1,1,2,50.0%,58m
25988,2,DARTHKK,2664,32,1,1,2,50.0%,1h
25988,2,[QvQ]PODOBIE,2664,0,1,2,3,33.3%,11m
25988,1,DavidP,2664,38,1,3,4,25.0%,3m
25988,1,NGANNOU,2664,38,1,4,5,20.0%,17m
25988,2,Sedative,2664,0,0,1,1,0.0%,1h
25988,2,[RLN]MrGoldie,2664,0,0,1,1,0.0%,1h
25988,2,Noken,2664,0,0,1,1,0.0%,14m
26020,1,Affenplanet,2663,1674,88,84,172,51.2%,1h
26020,3,Durbala,2663,1272,53,50,103,51.5%,20m
26020,2,MiniPanda,2663,1012,46,37,83,55.4%,55m
26020,1,ShaDowNfav,2663,1015,36,37,73,49.3%,1h
26020,2,ОЧКОШНИК,2663,338,19,14,33,57.6%,16m
26020,3,Rozenberg,2663,341,17,14,31,54.8%,22m
26020,2,[corp20]Katara,2663,282,10,9,19,52.6%,25m
26020,2,Jinrob,2663,142,6,1,7,85.7%,1h
26020,2,Greugaan,2663,250,6,9,15,40.0%,54m
26020,1,Raven,2663,222,6,12,18,33.3%,11m
26020,2,Aquatech,2663,126,5,2,7,71.4%,18m
26020,2,loupstylé,2663,165,5,3,8,62.5%,3m
26020,2,Termi,2663,183,5,3,8,62.5%,16m
26020,1,slycooler,2663,164,4,2,6,66.7%,1h
26020,1,Cin,2663,155,4,3,7,57.1%,11m
26020,3,Kapybara,2663,0,2,4,6,33.3%,9m
26020,1,CoreX,2663,119,2,4,6,33.3%,1h
26020,2,PIER,2663,0,1,0,1,100.0%,3m
26020,2,YouNeedLube,2663,0,1,0,1,100.0%,1h
26020,1,Cyl,2663,0,1,1,2,50.0%,11m
26020,1,Lucash,2663,0,1,1,2,50.0%,11m
26020,1,[OLACH]mov,2663,0,1,2,3,33.3%,1h
26020,3,LazyTurtle,2663,0,1,3,4,25.0%,10m
26020,2,Mikebolou,2663,0,0,1,1,0.0%,2m
26020,2,Evgeni,2663,0,0,1,1,0.0%,1h
26020,3,McSwagger,2663,0,0,3,3,0.0%,21m
26046,2,BOKA,2662,1268,145,153,298,48.7%,10m
26046,3,Linksroyal,2662,1231,78,77,155,50.3%,24m
26046,3,Tombombadil,2662,807,48,47,95,50.5%,21m
26046,3,Lexa,2662,1070,47,51,98,48.0%,11m
26046,1,[N0IP]Elander,2662,937,41,30,71,57.7%,60m
26046,1,Аексей,2662,540,35,33,68,51.5%,1h
26046,1,Darudi,2662,1009,35,36,71,49.3%,1h
26046,1,Tserg,2662,788,32,26,58,55.2%,1h
26046,1,Joku,2662,476,30,24,54,55.6%,14m
26046,2,[Alling]Jackson,2662,602,22,21,43,51.2%,1h
26046,1,GhsT,2662,371,18,18,36,50.0%,1h
26046,3,EvilSoda,2662,512,18,22,40,45.0%,21m
26046,1,Synth,2662,554,17,20,37,45.9%,4m
26046,1,[HzR]spectator,2662,208,9,7,16,56.2%,1h
26046,3,Homelander,2662,283,9,9,18,50.0%,1h
26046,3,MrYan,2662,180,6,12,18,33.3%,22m
26046,1,Légionxx,2662,168,5,4,9,55.6%,1h
26046,2,Noob,2662,144,5,5,10,50.0%,1h
26046,2,[Twins]zapromant,2662,177,5,8,13,38.5%,3m
26046,2,[ZePi]friqo,2662,134,5,8,13,38.5%,16m
26046,2,Rodinia,2662,30,4,6,10,40.0%,11m
26046,3,MARKER,2662,138,4,6,10,40.0%,13m
26046,3,[EOCTH]DuDie,2662,97,3,3,6,50.0%,18m
26046,2,mirkoba,2662,88,3,3,6,50.0%,8m
26046,1,tuladansleq,2662,110,3,9,12,25.0%,1h
26046,2,ElChapo,2662,0,2,3,5,40.0%,14m
26046,2,[FRANZ]Endrox,2662,0,1,0,1,100.0%,1h
26046,2,[7ZIP]Bлaд,2662,0,1,0,1,100.0%,9m
26046,2,StarForce,2662,30,1,1,2,50.0%,1h
26046,2,[AnIM37]BlackFire,2662,0,1,1,2,50.0%,54m
26046,1,KwaZuluNatal,2662,0,1,1,2,50.0%,1h
26046,1,Apis,2662,89,1,2,3,33.3%,25m
26046,1,South,2662,86,1,3,4,25.0%,7m
26046,2,SwagBoiiii,2662,0,1,4,5,20.0%,1h
26046,2,Skank,2662,0,0,1,1,0.0%,1h
26046,2,szomonos,2662,0,0,1,1,0.0%,13m
26046,2,porter,2662,0,0,1,1,0.0%,18m
26046,3,Jarod,2662,0,0,1,1,0.0%,1h
26046,3,monkey,2662,0,0,3,3,0.0%,11m
26085,2,Jugendhaus,2661,1536,484,484,968,50.0%,2m
26085,1,VaasKasich,2661,1520,243,223,466,52.1%,1h
26085,3,Maksim,2661,1570,209,208,417,50.1%,6m
26085,3,DeliveryMan,2661,1538,149,156,305,48.9%,9m
26085,3,Qaytar,2661,829,63,56,119,52.9%,6m
26085,1,MoRom,2661,1030,48,52,100,48.0%,1h
26085,2,Voodoo,2661,878,46,41,87,52.9%,1h
26085,2,Bruchiana,2661,834,32,32,64,50.0%,1h
26085,1,zaBinga,2661,732,24,27,51,47.1%,11m
26085,1,CptLightyear,2661,522,22,14,36,61.1%,5m
26085,1,ArtofPvP,2661,285,20,12,32,62.5%,20m
26085,1,Bridgeburner,2661,578,18,23,41,43.9%,1h
26085,1,cocosik,2661,344,12,16,28,42.9%,1h
26085,1,Phoenicurus,2661,398,11,16,27,40.7%,1h
26085,1,Kielnia,2661,286,10,7,17,58.8%,6m
26085,1,lasha,2661,241,8,4,12,66.7%,1h
26085,1,[SCVL]Kerrigan,2661,208,6,5,11,54.5%,15m
26085,3,Koulx,2661,88,6,8,14,42.9%,5m
26085,2,Dorian,2661,114,5,1,6,83.3%,56m
26085,3,chaflas,2661,93,5,3,8,62.5%,10m
26085,2,Darkaaragon,2661,162,5,4,9,55.6%,1h
26085,1,Wes,2661,207,5,7,12,41.7%,1h
26085,2,Phylws,2661,30,3,0,3,100.0%,14m
26085,3,mikolka,2661,0,3,1,4,75.0%,23m
26085,2,Ciprian,2661,0,3,2,5,60.0%,1h
26085,1,xamante,2661,158,3,4,7,42.9%,9m
26085,1,[BiScA]PsychoPat,2661,76,3,5,8,37.5%,22m
26085,1,[Etna]Vulturne,2661,76,3,5,8,37.5%,1h
26085,3,SenseyGree,2661,0,2,3,5,40.0%,8m
26085,3,zazykin,2661,0,2,3,5,40.0%,4m
26085,1,walleout,2661,0,1,1,2,50.0%,1h
26085,1,[mfixed]Kondzixon,2661,0,1,3,4,25.0%,3m
26085,3,BRAT,2661,97,1,5,6,16.7%,3m
26085,1,Амра,2661,0,0,3,3,0.0%,58m
26085,1,LineAgeII,2661,0,0,4,4,0.0%,1h
26120,3,stiliaris,2660,1654,271,281,552,49.1%,5m
26120,1,RazorRamirez,2660,528,17,23,40,42.5%,1h
26120,2,Jorwa,2660,255,13,3,16,81.2%,8m
26120,1,VICIOUS,2660,213,11,1,12,91.7%,7m
26120,2,Spamspam,2660,260,9,4,13,69.2%,25m
26120,1,[AsMG]dannyRose,2660,246,9,9,18,50.0%,1h
26120,2,Bilyachenko,2660,240,9,13,22,40.9%,24m
26120,3,Akiyama,2660,189,9,18,27,33.3%,23m
26120,1,Pompom,2660,205,8,7,15,53.3%,24m
26120,2,Lessir,2660,144,6,4,10,60.0%,56m
26120,1,reqdafuNk,2660,160,5,7,12,41.7%,26m
26120,3,[PVDG]Psycho,2660,42,4,3,7,57.1%,1h
26120,1,Biomechanix,2660,63,4,4,8,50.0%,3m
26120,2,IIreS,2660,88,3,1,4,75.0%,18m
26120,1,LonelyOrenot,2660,140,3,3,6,50.0%,10m
26120,2,Алиночка,2660,0,3,5,8,37.5%,10m
26120,3,LarsMorten,2660,120,3,8,11,27.3%,18m
26120,1,monster,2660,97,2,3,5,40.0%,4m
26120,2,[Dytred]SayCheese,2660,0,2,3,5,40.0%,1h
26120,3,Братик,2660,0,2,3,5,40.0%,21m
26120,3,Xerxi,2660,0,2,3,5,40.0%,1h
26120,3,[KeKMax]TheWolf,2660,30,2,4,6,33.3%,6m
26120,1,Klein,2660,38,2,4,6,33.3%,1h
26120,1,Jirochgu,2660,0,2,4,6,33.3%,26m
26120,1,Skinkryttarn,2660,76,2,5,7,28.6%,1h
26120,1,[Nеcro]Rasty,2660,0,1,1,2,50.0%,18m
26120,1,[ИС]Aien,2660,30,1,3,4,25.0%,7m
26120,1,IIIIIIIIIIII,2660,36,1,4,5,20.0%,11m
26120,1,gianfranco,2660,0,0,1,1,0.0%,1h
26120,2,TheFury,2660,0,0,1,1,0.0%,3m
26120,1,TOSHETO,2660,0,0,1,1,0.0%,1h
26120,1,Advenne,2660,0,0,2,2,0.0%,1h
26152,2,notorix,2659,1490,118,112,230,51.3%,56m
26152,3,[ĦĦ]blockzwoa,2659,1522,69,73,142,48.6%,24m
26152,1,Emrys,2659,927,46,49,95,48.4%,1h
26152,1,Wellan,2659,668,31,25,56,55.4%,1h
26152,3,logonihiht,2659,647,28,24,52,53.8%,21m
26152,1,Troptox,2659,608,24,23,47,51.1%,1h
26152,1,Harvastum,2659,627,23,22,45,51.1%,3m
26152,1,SHEPARD,2659,366,14,14,28,50.0%,17m
26152,1,Maksoncheg,2659,458,14,22,36,38.9%,14m
26152,1,[WWBIER]BobbyBangs,2659,127,6,6,12,50.0%,17m
26152,2,Maksutka,2659,44,5,3,8,62.5%,1h
26152,2,Чайковский,2659,162,5,5,10,50.0%,25m
26152,1,UmaAaAa,2659,178,5,8,13,38.5%,24m
26152,1,llllllllllll,2659,133,4,2,6,66.7%,11m
26152,2,Ohrwurm,2659,102,4,3,7,57.1%,4m
26152,2,[Livaï]dadarkd,2659,143,4,4,8,50.0%,1h
26152,1,freeride,2659,110,4,7,11,36.4%,24m
26152,1,Anty,2659,132,3,3,6,50.0%,1h
26152,2,Eroxx,2659,0,2,3,5,40.0%,18m
26152,1,[grauu]TOMari,2659,120,2,3,5,40.0%,7m
26152,1,SCVREADY,2659,36,2,3,5,40.0%,17m
26152,1,Abacus,2659,106,2,4,6,33.3%,15m
26152,2,RouloKomP,2659,0,1,0,1,100.0%,16m
26152,1,[HОW]Slaan,2659,0,1,3,4,25.0%,7m
26152,2,Papoy,2659,0,0,1,1,0.0%,15m
26152,2,SeriousSam,2659,0,0,1,1,0.0%,6m
26152,3,biy,2659,0,0,1,1,0.0%,3m
26152,1,todan,2659,0,0,2,2,0.0%,15m
26152,1,ОпАСнАяЛаЛКа,2659,0,0,2,2,0.0%,1h
26152,2,SkyTossOP,2659,0,0,2,2,0.0%,1h
26152,2,Avantgarde,2659,0,0,2,2,0.0%,1h
26152,1,Dhaluva,2659,0,0,5,5,0.0%,60m
26184,2,[BWArmy]Toidak,2658,1178,178,185,363,49.0%,2m
26184,3,[YpT]sebbix,2658,1060,146,163,309,47.2%,16m
26184,2,kayfol,2658,1607,110,110,220,50.0%,11m
26184,1,Starcounter,2658,1224,100,80,180,55.6%,15m
26184,3,ПодПивасом,2658,662,65,53,118,55.1%,20m
26184,1,Terno,2658,1046,51,50,101,50.5%,1h
26184,3,tole,2658,742,31,38,69,44.9%,3m
26184,1,Mepple,2658,450,20,17,37,54.1%,1h
26184,1,[ICBW]санек,2658,487,18,13,31,58.1%,1h
26184,3,JimmyJuicer,2658,418,15,23,38,39.5%,19m
26184,1,toxas,2658,319,13,10,23,56.5%,22m
26184,1,Eevi,2658,453,13,15,28,46.4%,18m
26184,1,niemand,2658,257,12,7,19,63.2%,20m
26184,1,DimidrolRus,2658,286,12,10,22,54.5%,1h
26184,3,DavAng,2658,109,10,16,26,38.5%,4m
26184,1,[298K]Barsik,2658,232,8,8,16,50.0%,3m
26184,3,Zergart,2658,251,7,12,19,36.8%,11m
26184,1,DonSun,2658,196,6,8,14,42.9%,55m
26184,1,СтРаТеГ,2658,135,4,3,7,57.1%,21m
26184,2,Zalupsei,2658,30,4,6,10,40.0%,10m
26184,2,SmokedTurtle,2658,98,3,2,5,60.0%,1h
26184,1,Ahriman,2658,40,2,3,5,40.0%,58m
26184,3,Gonca,2658,0,2,3,5,40.0%,1h
26184,1,[Moisty]Latah,2658,123,2,3,5,40.0%,7m
26184,1,SunTzu,2658,74,2,4,6,33.3%,1h
26184,2,[Mañico]mique,2658,32,1,1,2,50.0%,1h
26184,2,void,2658,30,1,2,3,33.3%,1h
26184,1,[Raven6]JonatanJosta,2658,0,1,2,3,33.3%,58m
26184,1,Eremey,2658,0,1,2,3,33.3%,17m
26184,2,ScriptorisVI,2658,0,0,1,1,0.0%,11m
26184,2,Bluesman,2658,0,0,1,1,0.0%,56m
26184,2,[CZUMPI]Grodek,2658,0,0,1,1,0.0%,1h
26184,2,Goosey,2658,0,0,2,2,0.0%,1h
26217,1,Antferc,2657,1645,146,144,290,50.3%,58m
26217,1,SpecialK,2657,1710,112,110,222,50.5%,18m
26217,2,Zahoq,2657,811,66,50,116,56.9%,1h
26217,3,Spacecraft,2657,852,45,49,94,47.9%,12m
26217,3,LeFrançais,2657,301,43,44,87,49.4%,7m
26217,1,[ØC]BioFake,2657,971,32,33,65,49.2%,3m
26217,3,hellboy,2657,813,29,31,60,48.3%,11m
26217,3,Snub,2657,518,22,22,44,50.0%,22m
26217,2,Omon,2657,400,16,19,35,45.7%,10m
26217,1,[FR1]LiquidCurage,2657,306,11,23,34,32.4%,9m
26217,2,AZEANSEAN,2657,167,9,4,13,69.2%,1m
26217,1,Airblade,2657,306,9,11,20,45.0%,1h
26217,1,Honou,2657,260,7,12,19,36.8%,1h
26217,1,[mfxed]NigrumF,2657,205,6,5,11,54.5%,22m
26217,2,Teutomar,2657,92,4,3,7,57.1%,55m
26217,1,Zzenith,2657,141,4,3,7,57.1%,1h
26217,2,Karl,2657,0,2,2,4,50.0%,1h
26217,2,Мячик,2657,46,2,4,6,33.3%,56m
26217,1,Shwifty,2657,0,2,4,6,33.3%,1h
26217,1,adjjb,2657,141,2,6,8,25.0%,15m
26217,2,ZERG,2657,0,1,0,1,100.0%,8m
26217,3,elpietro,2657,0,1,2,3,33.3%,25m
26217,3,Snyper,2657,0,1,3,4,25.0%,1h
26217,2,Slayers,2657,40,1,3,4,25.0%,1h
26217,2,Lelouch,2657,0,0,1,1,0.0%,19m
26217,2,Natta,2657,0,0,2,2,0.0%,20m
26217,1,Rob,2657,0,0,3,3,0.0%,58m
26244,3,Paladin,2656,1500,176,152,328,53.7%,19m
26244,1,Arghalion,2656,1543,93,69,162,57.4%,15m
26244,2,DoviC,2656,1531,91,103,194,46.9%,5m
26244,1,uniSon,2656,1699,87,86,173,50.3%,26m
26244,1,Rebel,2656,944,65,55,120,54.2%,11m
26244,3,Blood,2656,765,48,59,107,44.9%,13m
26244,1,Irkles,2656,775,46,48,94,48.9%,13m
26244,1,ПРИЗРАК,2656,1051,39,41,80,48.8%,1h
26244,1,[ViFo]Yrik,2656,354,15,9,24,62.5%,1h
26244,1,[Nugket]Bonano,2656,378,14,7,21,66.7%,1h
26244,2,[YSRY]TerranTaran,2656,191,13,11,24,54.2%,25m
26244,1,CrushLP,2656,301,12,7,19,63.2%,1h
26244,2,fwe,2656,174,10,8,18,55.6%,8m
26244,1,[PLSD]astralny,2656,246,7,10,17,41.2%,5m
26244,2,Itachi,2656,188,6,0,6,100.0%,1h
26244,1,sssBARONsss,2656,287,6,13,19,31.6%,1h
26244,2,Рейнор,2656,149,4,3,7,57.1%,1h
26244,2,gorax,2656,124,4,5,9,44.4%,1h
26244,1,charlama,2656,148,4,10,14,28.6%,1h
26244,2,HexagonSun,2656,139,3,3,6,50.0%,1h
26244,1,Player,2656,78,3,7,10,30.0%,3m
26244,3,[IceHus]llllllllll,2656,36,3,7,10,30.0%,8m
26244,2,keomix,2656,0,2,3,5,40.0%,8m
26244,2,[CaGa]frittenfett,2656,0,2,3,5,40.0%,55m
26244,3,IIIIIIIIIIII,2656,44,2,5,7,28.6%,1h
26244,3,lakair,2656,0,1,1,2,50.0%,7m
26244,2,smiou,2656,0,1,2,3,33.3%,1h
26244,2,MrLipisey,2656,0,0,2,2,0.0%,24m
26272,1,[НОД17]TugW,2655,1257,74,60,134,55.2%,5m
26272,1,[5O1st]Davorc,2655,1434,71,71,142,50.0%,3m
26272,3,XYLON,2655,1007,67,76,143,46.9%,23m
26272,1,BlackDead,2655,1265,58,38,96,60.4%,19m
26272,1,[Waco]illo,2655,777,57,56,113,50.4%,1h
26272,3,[Чайник]AksKolyan,2655,558,55,61,116,47.4%,11m
26272,1,ksap,2655,458,37,25,62,59.7%,1h
26272,3,rushboxx,2655,951,37,40,77,48.1%,14m
26272,2,Azze,2655,684,31,20,51,60.8%,17m
26272,1,ProFide,2655,643,31,24,55,56.4%,26m
26272,1,[SoothK]Isso,2655,556,18,16,34,52.9%,9m
26272,2,hanny,2655,488,17,19,36,47.2%,1h
26272,2,Eres,2655,290,11,16,27,40.7%,14m
26272,1,Zedy,2655,234,10,7,17,58.8%,26m
26272,1,vadimar,2655,344,10,13,23,43.5%,1h
26272,1,[Anlav]AngryCrab,2655,318,8,7,15,53.3%,1h
26272,2,MonkeyDGobli,2655,212,8,12,20,40.0%,9m
26272,2,MMjDK,2655,152,5,5,10,50.0%,16m
26272,1,sooreen,2655,184,5,9,14,35.7%,58m
26272,2,Arthum,2655,0,4,1,5,80.0%,1h
26272,1,tikol,2655,106,4,4,8,50.0%,1h
26272,2,Calzifer,2655,167,4,5,9,44.4%,25m
26272,1,[ProbKA]pavel,2655,118,4,5,9,44.4%,17m
26272,2,Lee,2655,0,3,5,8,37.5%,5m
26272,2,narcissus,2655,32,2,1,3,66.7%,3m
26272,1,fournicator,2655,103,2,2,4,50.0%,17m
26272,2,blackroach,2655,48,2,2,4,50.0%,1h
26272,2,PolloLoco,2655,0,2,3,5,40.0%,14m
26272,3,ElMulo,2655,0,2,3,5,40.0%,1h
26272,2,EzeJohnny,2655,0,2,3,5,40.0%,55m
26272,2,[BMF]SID,2655,0,1,0,1,100.0%,1h
26272,1,Shruikan,2655,88,1,2,3,33.3%,5m
26272,2,[eHeArT]MonkeyDLuffy,2655,0,1,3,4,25.0%,7m
26272,3,Uchiha,2655,0,0,1,1,0.0%,6m
26272,2,SexParty,2655,0,0,2,2,0.0%,1h
26307,2,Roman,2654,1534,230,226,456,50.4%,2m
26307,3,Mewax,2654,1508,183,179,362,50.6%,14m
26307,2,Niet,2654,1618,140,122,262,53.4%,55m
26307,1,Niziur,2654,1147,74,49,123,60.2%,7m
26307,3,AuxiLeCookie,2654,1252,63,63,126,50.0%,2m
26307,1,MooM,2654,1311,58,56,114,50.9%,20m
26307,3,CooperUA,2654,548,40,43,83,48.2%,13m
26307,3,DSG,2654,428,15,27,42,35.7%,14m
26307,2,JohnnyUtah,2654,309,10,13,23,43.5%,1h
26307,1,[K1LL]DarkSoull,2654,368,10,17,27,37.0%,25m
26307,1,AceOne,2654,249,9,9,18,50.0%,1h
26307,2,Soren,2654,206,9,9,18,50.0%,1h
26307,3,Xenon,2654,195,8,7,15,53.3%,15m
26307,1,reinstorm,2654,198,8,8,16,50.0%,7m
26307,1,LittleKnight,2654,170,7,9,16,43.8%,1h
26307,3,Sadjared,2654,97,5,1,6,83.3%,23m
26307,2,Laar,2654,140,4,6,10,40.0%,1h
26307,2,JAVOKHU,2654,30,1,1,2,50.0%,58m
26307,1,Leszu,2654,0,1,2,3,33.3%,20m
26307,1,[Kompis]KYN,2654,85,1,3,4,25.0%,1h
26307,2,[Petrиs]Gogu,2654,34,1,3,4,25.0%,1h
26307,2,PurpleInc,2654,0,0,1,1,0.0%,16m
26307,2,fearlessOne,2654,0,0,2,2,0.0%,3m
26307,1,chris,2654,0,0,6,6,0.0%,19m
26331,1,Grödelmimpf,2653,1694,184,173,357,51.5%,15m
26331,1,Ruso,2653,1115,117,108,225,52.0%,1h
26331,1,Gabrio,2653,1687,66,67,133,49.6%,1h
26331,3,Alexandreabc,2653,1456,57,65,122,46.7%,19m
26331,1,PeL,2653,815,51,53,104,49.0%,1h
26331,1,TheSolution,2653,967,40,33,73,54.8%,1h
26331,3,[LLTeam]Briac,2653,855,32,37,69,46.4%,6m
26331,2,[KTMM]Ubkxv,2653,952,31,47,78,39.7%,22m
26331,1,Kory,2653,648,27,24,51,52.9%,17m
26331,1,Sensei,2653,351,20,18,38,52.6%,3m
26331,1,[BZerO]txtsxm,2653,215,18,18,36,50.0%,22m
26331,1,SxT,2653,341,14,14,28,50.0%,10m
26331,1,GMPLKP,2653,308,9,11,20,45.0%,1h
26331,1,gothnoire,2653,314,8,9,17,47.1%,4m
26331,2,Arsenicum,2653,194,7,5,12,58.3%,1h
26331,3,Jirry,2653,191,6,3,9,66.7%,1h
26331,1,AleDuddo,2653,140,5,6,11,45.5%,1h
26331,3,pWarior,2653,90,4,5,9,44.4%,1h
26331,2,Lotusss,2653,120,3,4,7,42.9%,1h
26331,3,Drewienko,2653,0,2,3,5,40.0%,14m
26331,1,[0142]WENGER,2653,123,2,4,6,33.3%,5m
26331,1,TheFOXY,2653,0,2,4,6,33.3%,1h
26331,1,JUSTiCE,2653,36,1,6,7,14.3%,1h
26331,1,Raijin,2653,36,1,8,9,11.1%,1h
26331,2,Asura,2653,0,0,1,1,0.0%,3m
26331,2,[KANNAK]Dustkicker,2653,0,0,1,1,0.0%,18m
26331,1,Maxeldr,2653,0,0,6,6,0.0%,1h
26358,2,danisius,2652,1553,304,306,610,49.8%,16m
26358,3,Cosya,2652,1478,271,264,535,50.7%,7m
26358,3,TheBoss,2652,1479,181,188,369,49.1%,19m
26358,2,Talisman,2652,1449,98,87,185,53.0%,25m
26358,3,xXstallickXx,2652,1209,95,88,183,51.9%,22m
26358,1,Axos,2652,1673,84,71,155,54.2%,6m
26358,1,TygriSila,2652,1388,77,78,155,49.7%,58m
26358,1,BabyFace,2652,1644,74,63,137,54.0%,15m
26358,1,Thanatos,2652,1349,65,57,122,53.3%,10m
26358,3,Hurrikan,2652,1036,42,43,85,49.4%,5m
26358,2,VictorianV,2652,455,24,16,40,60.0%,1h
26358,1,wannabe,2652,621,24,22,46,52.2%,25m
26358,1,IREFUSE,2652,737,24,25,49,49.0%,1h
26358,1,SECTORzzzUA,2652,566,19,19,38,50.0%,1h
26358,3,[tchü]sephiroth,2652,381,16,16,32,50.0%,21m
26358,1,[MCat]Rain,2652,258,12,12,24,50.0%,7m
26358,1,[MWAF]OMEGA,2652,388,12,14,26,46.2%,57m
26358,3,JOE,2652,316,11,23,34,32.4%,7m
26358,3,Derekus,2652,260,9,10,19,47.4%,25m
26358,3,EatMyPepe,2652,313,9,14,23,39.1%,16m
26358,2,[TPoT]TeaPotBruh,2652,252,8,3,11,72.7%,1h
26358,1,Powerente,2652,130,7,6,13,53.8%,14m
26358,1,[XEA]throw,2652,165,7,7,14,50.0%,13m
26358,2,SadMarine,2652,172,6,3,9,66.7%,58m
26358,1,Kami,2652,102,6,3,9,66.7%,1h
26358,2,NgocQuan,2652,210,6,6,12,50.0%,1h
26358,2,wowa,2652,145,5,5,10,50.0%,1h
26358,2,DarkChicken,2652,86,5,6,11,45.5%,23m
26358,2,MrBlue,2652,169,5,6,11,45.5%,1h
26358,1,Dasn,2652,118,5,6,11,45.5%,1h
26358,2,distenz,2652,114,3,2,5,60.0%,26m
26358,2,NoLimit,2652,40,2,0,2,100.0%,13m
26358,2,FrostyFeet,2652,0,2,3,5,40.0%,58m
26358,2,EKKO,2652,0,2,3,5,40.0%,1h
26358,1,MoBrO,2652,0,2,4,6,33.3%,19m
26358,2,Mantikor,2652,0,1,0,1,100.0%,17m
26358,2,Géno,2652,0,1,0,1,100.0%,24m
26358,2,GLISTA,2652,0,1,0,1,100.0%,1h
26358,2,Prostata,2652,0,0,1,1,0.0%,1h
26358,1,Pain,2652,0,0,2,2,0.0%,1h
26358,2,Wik,2652,0,0,2,2,0.0%,2m
26358,1,Camembert,2652,0,0,2,2,0.0%,26m
26400,1,pit,2651,931,104,93,197,52.8%,1h
26400,1,Gasan,2651,1371,70,65,135,51.9%,5m
26400,2,ChillyWilly,2651,1344,54,49,103,52.4%,20m
26400,1,Kampninja,2651,1130,46,33,79,58.2%,18m
26400,2,Bigdaddy,2651,1034,43,50,93,46.2%,4m
26400,1,CocainCowBoy,2651,743,42,44,86,48.8%,1h
26400,2,oneshot,2651,856,34,26,60,56.7%,1h
26400,1,Wing,2651,371,12,12,24,50.0%,1h
26400,1,MarcoPolo,2651,326,12,18,30,40.0%,24m
26400,2,НеБейтеПж,2651,230,9,12,21,42.9%,5m
26400,1,DoMuNatoR,2651,206,8,9,17,47.1%,11m
26400,1,eazY,2651,249,7,7,14,50.0%,1h
26400,1,JTR,2651,223,6,9,15,40.0%,26m
26400,1,TwistedTOoth,2651,186,6,12,18,33.3%,3m
26400,2,TrayStamp,2651,46,5,4,9,55.6%,13m
26400,1,EnigmaticMan,2651,117,3,0,3,100.0%,1h
26400,1,Wolfblack,2651,72,3,4,7,42.9%,25m
26400,3,Hunter,2651,0,2,3,5,40.0%,1h
26400,2,BlackMarley,2651,0,1,0,1,100.0%,21m
26400,2,Coral,2651,0,1,6,7,14.3%,1h
26400,3,CosmicPower,2651,0,0,1,1,0.0%,1h
26400,2,[ZERGSC]selfish,2651,0,0,1,1,0.0%,1h
26400,2,[N0Z]Андрей,2651,0,0,1,1,0.0%,55m
26400,2,Olanin,2651,0,0,1,1,0.0%,1h
26400,2,[UAŦeam]MorozDeD,2651,0,0,2,2,0.0%,19m
26400,2,[oooboy]prizma,2651,0,0,2,2,0.0%,1h
26400,1,[4GYM]Van,2651,0,0,3,3,0.0%,56m
26427,3,paly,2650,1501,460,458,918,50.1%,10m
26427,3,potap,2650,1653,399,409,808,49.4%,19m
26427,3,DVlad,2650,1137,255,256,511,49.9%,23m
26427,1,Kosinski,2650,1549,89,87,176,50.6%,24m
26427,2,[HappyN]Overclock,2650,1462,60,71,131,45.8%,2m
26427,1,[RuNOOB]Knayz,2650,321,53,54,107,49.5%,57m
26427,3,ghostnovy,2650,1299,50,55,105,47.6%,19m
26427,1,App,2650,649,27,21,48,56.2%,1h
26427,1,[Petrиs]Ricardo,2650,830,27,32,59,45.8%,20m
26427,2,NiniMae,2650,480,17,24,41,41.5%,14m
26427,2,JiMmYIIsHoEs,2650,292,11,9,20,55.0%,1h
26427,1,Frees,2650,330,11,14,25,44.0%,14m
26427,3,Zainali,2650,140,8,10,18,44.4%,22m
26427,3,Apteris,2650,242,8,17,25,32.0%,12m
26427,3,HMSTERROR,2650,115,6,4,10,60.0%,21m
26427,1,kopalych,2650,153,5,3,8,62.5%,1h
26427,1,LUCAS,2650,145,5,7,12,41.7%,24m
26427,2,Lucker,2650,60,4,1,5,80.0%,20m
26427,1,Vilgro,2650,97,2,2,4,50.0%,1h
26427,2,flash,2650,0,2,3,5,40.0%,1h
26427,3,Ungraceful,2650,121,2,4,6,33.3%,9m
26427,2,Фанатик,2650,0,1,0,1,100.0%,3m
26427,2,[GE4U]Dante,2650,0,1,0,1,100.0%,25m
26427,2,ARMATA,2650,0,1,0,1,100.0%,16m
26427,2,sensey,2650,0,1,1,2,50.0%,1h
26427,2,Roni,2650,30,1,1,2,50.0%,16m
26427,2,lamok,2650,0,1,4,5,20.0%,55m
26427,3,Ruso,2650,0,1,6,7,14.3%,26m
26427,2,[heavyM]kazzak,2650,0,0,1,1,0.0%,60m
26427,2,EMPstrajk,2650,0,0,1,1,0.0%,1h
26427,2,RUBASINA,2650,0,0,2,2,0.0%,1h
26458,3,[qqMF]ByuNAdams,2649,1061,215,211,426,50.5%,23m
26458,3,Mahac,2649,1301,144,130,274,52.6%,22m
26458,1,Andcol,2649,1643,111,107,218,50.9%,1h
26458,2,[GRWIII]QubthutAllah,2649,1317,110,96,206,53.4%,17m
26458,1,Rakit,2649,1653,90,66,156,57.7%,7m
26458,3,chudypakir,2649,1294,56,66,122,45.9%,8m
26458,1,dan,2649,865,33,29,62,53.2%,20m
26458,2,Rmasob,2649,581,23,16,39,59.0%,1h
26458,1,Bilbo,2649,414,16,14,30,53.3%,1h
26458,3,Metathron,2649,374,15,9,24,62.5%,5m
26458,2,RedBull,2649,163,13,15,28,46.4%,11m
26458,3,Stochastic,2649,402,13,21,34,38.2%,5m
26458,2,Agiro,2649,298,11,10,21,52.4%,1h
26458,1,[ǁTnTǁ]Bakthebiks,2649,288,10,8,18,55.6%,1h
26458,2,CruZze,2649,272,10,9,19,52.6%,25m
26458,2,SIN,2649,218,8,1,9,88.9%,24m
26458,2,[Dw4rfs]Mic,2649,0,4,1,5,80.0%,3m
26458,2,buczer,2649,119,4,5,9,44.4%,23m
26458,2,Смертоног,2649,133,3,1,4,75.0%,21m
26458,2,metaknight,2649,30,2,0,2,100.0%,18m
26458,2,[AKG]Princess,2649,62,2,1,3,66.7%,56m
26458,3,demidonjkee,2649,0,2,3,5,40.0%,21m
26458,1,StarKing,2649,70,2,4,6,33.3%,1h
26458,1,[JediK]MajorAl,2649,0,1,2,3,33.3%,24m
26458,2,Reptile,2649,0,1,4,5,20.0%,1h
26458,1,LonelySoul,2649,24,1,4,5,20.0%,23m
26458,2,Lars,2649,0,0,1,1,0.0%,20m
26458,1,[DLD]DocSnyder,2649,0,0,4,4,0.0%,1h
26458,3,SanoFi,2649,0,0,6,6,0.0%,1h
26487,1,VinnyJazz,2648,1637,157,148,305,51.5%,5m
26487,1,[scp3]bertnard,2648,841,126,108,234,53.8%,1h
26487,1,Phonecall,2648,879,126,124,250,50.4%,11m
26487,1,Timebully,2648,1508,105,93,198,53.0%,14m
26487,1,Hegeshak,2648,1647,103,89,192,53.6%,22m
26487,1,Chrisern,2648,1681,94,87,181,51.9%,1h
26487,2,Jblforce,2648,1615,85,58,143,59.4%,25m
26487,1,[TiaB]Icehowl,2648,1595,78,73,151,51.7%,23m
26487,1,xhermesx,2648,1601,65,60,125,52.0%,1h
26487,1,bouncybear,2648,560,46,44,90,51.1%,56m
26487,3,Fesser,2648,776,36,26,62,58.1%,22m
26487,1,Wszuwa,2648,869,31,31,62,50.0%,1h
26487,3,MiraX,2648,821,26,58,84,31.0%,5m
26487,1,AngelGames,2648,530,23,14,37,62.2%,56m
26487,2,[MFDP]MAF,2648,411,18,5,23,78.3%,17m
26487,1,Highrope,2648,276,15,15,30,50.0%,14m
26487,1,Lizzy,2648,390,12,12,24,50.0%,25m
26487,2,tyzpain,2648,288,11,7,18,61.1%,20m
26487,1,tamse,2648,368,11,11,22,50.0%,1h
26487,1,InsPhi,2648,157,8,11,19,42.1%,1h
26487,1,[TaMort]IIIIIIIIIIII,2648,216,7,6,13,53.8%,56m
26487,2,[Đodo]Mouloud,2648,0,4,1,5,80.0%,9m
26487,2,SCVSpdWagon,2648,58,3,1,4,75.0%,1h
26487,1,Wicked,2648,107,3,7,10,30.0%,1h
26487,2,[QTclub]hameck,2648,0,2,3,5,40.0%,1h
26487,3,AnimationDud,2648,0,2,3,5,40.0%,1h
26487,3,Valaren,2648,0,2,4,6,33.3%,57m
26487,2,Sushi,2648,36,1,2,3,33.3%,1h
26487,2,Petrovech,2648,0,0,2,2,0.0%,1h
26487,1,Alchemist,2648,0,0,3,3,0.0%,1h
26517,2,[TFSC]Jag,2647,1504,524,519,1043,50.2%,23m
26517,2,Jhon,2647,800,121,119,240,50.4%,22m
26517,1,TajniakTOP,2647,1531,115,108,223,51.6%,60m
26517,2,frol,2647,1045,48,32,80,60.0%,1h
26517,3,Sodastream,2647,1087,43,37,80,53.8%,21m
26517,1,JHONKRAKOSES,2647,721,29,26,55,52.7%,22m
26517,1,EpX,2647,483,20,14,34,58.8%,1h
26517,1,GenghisKhan,2647,548,17,21,38,44.7%,57m
26517,1,VidHartt,2647,246,9,8,17,52.9%,1h
26517,2,KbIM,2647,241,7,8,15,46.7%,1h
26517,2,DeeMM,2647,154,6,3,9,66.7%,1h
26517,1,Catworm,2647,152,4,7,11,36.4%,1h
26517,3,Black,2647,126,4,10,14,28.6%,13m
26517,2,[PÂRłAH]DanielCzech,2647,92,3,4,7,42.9%,19m
26517,1,[шаурм]нотище,2647,88,3,4,7,42.9%,60m
26517,1,[пепега]Farmacevt,2647,104,3,8,11,27.3%,3m
26517,1,[62]rznRaven,2647,88,2,1,3,66.7%,1h
26517,3,Wanderer,2647,0,2,3,5,40.0%,9m
26517,2,Vinstor,2647,0,2,3,5,40.0%,56m
26517,2,Zancudo,2647,0,1,0,1,100.0%,1h
26517,3,RandomStorY,2647,0,1,0,1,100.0%,1h
26517,1,Azagapp,2647,0,1,1,2,50.0%,1h
26517,1,Halman,2647,0,1,2,3,33.3%,1h
26517,2,[SRoB]Varangian,2647,0,0,1,1,0.0%,14m
26517,2,IGWXZ,2647,0,0,1,1,0.0%,1h
26517,2,Raasblaar,2647,0,0,1,1,0.0%,57m
26517,2,Жучарапрофи,2647,0,0,1,1,0.0%,6m
26517,2,Rage,2647,0,0,2,2,0.0%,1h
26517,2,[RBP3]ScorpionFire,2647,0,0,5,5,0.0%,1h
26546,1,loupio,2646,1560,171,153,324,52.8%,1h
26546,1,Amelin,2646,1566,157,132,289,54.3%,1h
26546,1,GekkooKuhan,2646,1666,131,127,258,50.8%,24m
26546,2,CozyPanda,2646,1490,64,55,119,53.8%,3m
26546,1,FireFox,2646,1457,58,57,115,50.4%,11m
26546,2,XCOM,2646,1071,50,47,97,51.5%,1h
26546,1,evo,2646,892,38,35,73,52.1%,1h
26546,1,Madman,2646,1010,35,34,69,50.7%,1h
26546,3,TexnO,2646,866,33,32,65,50.8%,14m
26546,2,[KIST]AseKaratel,2646,809,31,22,53,58.5%,26m
26546,1,Adi,2646,644,26,21,47,55.3%,57m
26546,1,[PARCE]Niloc,2646,610,24,34,58,41.4%,4m
26546,3,Tklz,2646,455,14,19,33,42.4%,22m
26546,2,DragonMaouss,2646,304,13,10,23,56.5%,1h
26546,2,nairolF,2646,320,12,10,22,54.5%,1h
26546,1,NieDzwiedz,2646,392,11,16,27,40.7%,1h
26546,2,lIllIlIIlIIl,2646,269,8,7,15,53.3%,18m
26546,1,iLLNino,2646,256,8,13,21,38.1%,1h
26546,3,TaLiBAN,2646,172,7,7,14,50.0%,5m
26546,3,MaxLangley,2646,120,6,5,11,54.5%,6m
26546,3,DanTe,2646,159,5,4,9,55.6%,1h
26546,1,Lucas,2646,184,5,11,16,31.2%,13m
26546,2,LilleVolD,2646,115,4,4,8,50.0%,17m
26546,1,bonifacy,2646,66,4,5,9,44.4%,1h
26546,3,IIIllIlIlIlI,2646,90,4,11,15,26.7%,23m
26546,3,Nanorock,2646,97,3,3,6,50.0%,1h
26546,2,Starzinger,2646,30,2,2,4,50.0%,1h
26546,3,Ventriloc,2646,36,1,1,2,50.0%,1h
26546,1,IvánMGMM,2646,0,1,3,4,25.0%,15m
26546,1,[NaOH]Térorus,2646,32,1,8,9,11.1%,1h
26546,2,LAA,2646,0,0,1,1,0.0%,1h
26546,2,Fox,2646,0,0,1,1,0.0%,19m
26546,2,[OrBeSo]MaD,2646,0,0,2,2,0.0%,58m
26546,2,Autophagy,2646,0,0,2,2,0.0%,3m
26546,1,[Kingz]Prozak,2646,0,0,3,3,0.0%,1h
26581,1,eversio,2645,1686,222,220,442,50.2%,25m
26581,2,[LMBD]Robinson,2645,1602,111,94,205,54.1%,1h
26581,1,[Pitw]FireDrogo,2645,1422,78,84,162,48.1%,1h
26581,1,barbysize,2645,1639,74,61,135,54.8%,5m
26581,2,mvo,2645,1509,70,57,127,55.1%,18m
26581,2,RobiRatlos,2645,1139,67,54,121,55.4%,14m
26581,1,Umbri,2645,1382,51,49,100,51.0%,1h
26581,1,LoreLord,2645,807,38,29,67,56.7%,14m
26581,1,Rostik,2645,871,35,29,64,54.7%,10m
26581,1,[SPAINs]TheRedPirate,2645,986,34,37,71,47.9%,1h
26581,1,WILLYG,2645,583,19,19,38,50.0%,6m
26581,1,tracking,2645,493,17,18,35,48.6%,26m
26581,1,Cyon,2645,455,14,15,29,48.3%,26m
26581,2,[COD]primeINDIA,2645,330,11,12,23,47.8%,1h
26581,1,Yoll,2645,340,9,12,21,42.9%,1h
26581,3,Hugmont,2645,286,9,18,27,33.3%,9m
26581,2,Tsubasa,2645,230,8,2,10,80.0%,14m
26581,1,Zwierzak,2645,244,8,9,17,47.1%,3m
26581,2,Turbinya,2645,262,8,26,34,23.5%,16m
26581,1,LeBigMac,2645,271,7,9,16,43.8%,1h
26581,3,[Teckno]Mahougnon,2645,256,7,12,19,36.8%,2m
26581,2,StellarFox,2645,146,6,5,11,54.5%,20m
26581,1,IIIIIIIIIIII,2645,136,6,8,14,42.9%,59m
26581,1,[HMarch]CiRkYl,2645,138,5,7,12,41.7%,11m
26581,3,Gaffie,2645,72,4,3,7,57.1%,19m
26581,1,Helysiel,2645,96,4,3,7,57.1%,1h
26581,2,StarklySansa,2645,141,4,5,9,44.4%,1h
26581,2,StashKa,2645,90,3,3,6,50.0%,21m
26581,3,TBFohtombo,2645,121,3,4,7,42.9%,26m
26581,3,wztvm,2645,154,3,11,14,21.4%,21m
26581,2,[KoaK]MyBanD,2645,44,2,0,2,100.0%,1h
26581,3,Evi,2645,0,2,3,5,40.0%,4m
26581,3,Sanya,2645,38,1,2,3,33.3%,6m
26581,1,KaKaShi,2645,36,1,5,6,16.7%,10m
26581,3,[FieNd]EnderTech,2645,42,1,6,7,14.3%,1h
26581,2,[K0RM2]Agrobot,2645,0,0,1,1,0.0%,27m
26581,2,Ygrno,2645,0,0,1,1,0.0%,56m
26618,1,Viktorio,2644,1445,88,74,162,54.3%,11m
26618,1,Enigma,2644,1355,72,61,133,54.1%,1h
26618,2,Berpos,2644,1216,47,42,89,52.8%,1h
26618,1,formreality,2644,610,24,23,47,51.1%,10m
26618,2,Васячечен,2644,443,23,25,48,47.9%,16m
26618,3,mrzdrva,2644,365,19,24,43,44.2%,3m
26618,2,logan,2644,311,14,11,25,56.0%,17m
26618,1,[qip]xxxBONDxxx,2644,390,14,29,43,32.6%,14m
26618,3,Kingkong,2644,338,13,13,26,50.0%,14m
26618,1,SpatOul,2644,283,10,11,21,47.6%,1h
26618,3,[StaTo]Merphidros,2644,166,9,16,25,36.0%,10m
26618,1,Ragnvald,2644,210,7,8,15,46.7%,1h
26618,1,khegay,2644,154,4,3,7,57.1%,20m
26618,1,Erex,2644,199,4,15,19,21.1%,6m
26618,2,Nova,2644,89,3,5,8,37.5%,1m
26618,2,[dDb]Överlord,2644,30,2,0,2,100.0%,1h
26618,3,[kek34]Большеногий,2644,40,2,0,2,100.0%,18m
26618,2,MrNiceGuy,2644,0,2,3,5,40.0%,55m
26618,1,СатанаМогила,2644,0,1,1,2,50.0%,6m
26618,2,[Niavir]maskmarat,2644,0,1,2,3,33.3%,17m
26618,2,mamba,2644,0,0,1,1,0.0%,1h
26618,1,educs,2644,0,0,2,2,0.0%,26m
26640,3,Hicks,2643,1563,217,205,422,51.4%,23m
26640,1,Shadow,2643,1351,197,177,374,52.7%,59m
26640,2,drash,2643,1300,130,127,257,50.6%,11m
26640,1,[Grund]Dnk,2643,1681,77,73,150,51.3%,10m
26640,1,agfhawk,2643,1615,59,62,121,48.8%,1h
26640,1,[VMPB]Mortarion,2643,856,44,45,89,49.4%,22m
26640,1,[LOGS]blacksheep,2643,390,13,12,25,52.0%,1h
26640,2,AnXieTy,2643,402,12,22,34,35.3%,19m
26640,2,[TRPZ]Rip,2643,304,11,6,17,64.7%,25m
26640,1,PogChimp,2643,221,6,8,14,42.9%,15m
26640,2,temon,2643,114,5,2,7,71.4%,60m
26640,1,Kaškavala,2643,166,4,5,9,44.4%,24m
26640,2,Faikert,2643,88,3,3,6,50.0%,3m
26640,3,[UpperD]TheLibrarian,2643,36,3,4,7,42.9%,23m
26640,2,Buggi,2643,0,3,5,8,37.5%,2m
26640,2,[LofAs]Flinch,2643,0,2,1,3,66.7%,55m
26640,2,Zivian,2643,30,2,1,3,66.7%,1h
26640,1,Straton,2643,38,2,3,5,40.0%,22m
26640,3,DPJBP,2643,0,2,3,5,40.0%,14m
26640,2,wolf,2643,0,2,3,5,40.0%,1h
26640,1,BENX,2643,32,2,6,8,25.0%,4m
26640,1,Spleter,2643,38,2,6,8,25.0%,20m
26640,1,HazarD,2643,78,2,6,8,25.0%,1h
26640,2,Martilium,2643,30,1,2,3,33.3%,1h
26640,1,[Alеx07]KacTuEJlb,2643,38,1,6,7,14.3%,1h
26640,2,Saurcroc,2643,0,0,2,2,0.0%,1h
26640,2,Concourd,2643,0,0,2,2,0.0%,1h
26667,3,[Liff]liffgarden,2642,1409,236,226,462,51.1%,19m
26667,1,Canttouchthi,2642,1593,99,87,186,53.2%,24m
26667,1,Горожанин,2642,652,96,89,185,51.9%,24m
26667,1,slake,2642,1223,48,47,95,50.5%,1h
26667,1,SW,2642,1118,47,37,84,56.0%,1h
26667,3,SuperMango,2642,677,44,54,98,44.9%,3m
26667,2,[Zguege]TeteDeMort,2642,841,39,26,65,60.0%,58m
26667,3,zmora,2642,968,39,42,81,48.1%,21m
26667,1,[EvGs]Greck,2642,954,35,37,72,48.6%,1h
26667,2,Maxim,2642,584,22,19,41,53.7%,56m
26667,3,BARCODE,2642,673,22,37,59,37.3%,14m
26667,2,Klotz,2642,552,20,18,38,52.6%,26m
26667,2,[Sc21]Hellvillage,2642,516,18,26,44,40.9%,1h
26667,3,Jason,2642,372,17,16,33,51.5%,2m
26667,1,NightFury,2642,538,17,18,35,48.6%,55m
26667,1,[iZeX]Arthurus,2642,498,15,23,38,39.5%,1h
26667,1,Доходяга,2642,344,10,15,25,40.0%,17m
26667,1,[БУБУБ]Virtuzo,2642,267,8,8,16,50.0%,1h
26667,1,ElCastagno,2642,237,8,8,16,50.0%,1h
26667,1,Erixxon,2642,215,8,10,18,44.4%,1h
26667,3,PIXarin,2642,226,8,11,19,42.1%,19m
26667,1,Andr,2642,163,7,3,10,70.0%,1h
26667,1,Jurgiz,2642,94,6,7,13,46.2%,1h
26667,1,Dunno,2642,127,6,7,13,46.2%,1h
26667,3,Farja,2642,156,6,13,19,31.6%,5m
26667,2,Raffaele,2642,120,5,4,9,55.6%,1h
26667,3,lyckegard,2642,0,4,1,5,80.0%,1h
26667,1,QStrifeQ,2642,76,3,7,10,30.0%,10m
26667,1,Adams,2642,104,3,11,14,21.4%,1h
26667,2,Vovchik,2642,32,2,1,3,66.7%,1h
26667,2,Djimi,2642,60,2,2,4,50.0%,1h
26667,3,JuppT,2642,0,2,3,5,40.0%,1h
26667,1,nekuJay,2642,68,2,6,8,25.0%,1h
26667,2,univox,2642,0,1,0,1,100.0%,25m
26667,2,[NVY]plsnofufu,2642,0,1,0,1,100.0%,8m
26667,3,Kolot,2642,0,1,4,5,20.0%,1h
26667,2,nikita,2642,0,0,1,1,0.0%,56m
26704,1,Ottokristus,2641,1661,118,102,220,53.6%,60m
26704,3,Kaotiques,2641,1526,98,85,183,53.6%,15m
26704,3,Dgc,2641,930,94,79,173,54.3%,20m
26704,2,Fabio,2641,943,45,35,80,56.2%,1h
26704,3,vicjens,2641,1020,43,46,89,48.3%,24m
26704,1,Robly,2641,1034,39,36,75,52.0%,7m
26704,1,ZUBILO,2641,594,36,30,66,54.5%,4m
26704,3,Pavel,2641,758,31,31,62,50.0%,19m
26704,3,Jimp,2641,684,30,28,58,51.7%,22m
26704,1,Iharthi,2641,604,24,19,43,55.8%,1h
26704,2,[VRB]michssen,2641,351,15,9,24,62.5%,11m
26704,1,[DEASY]Bubasetti,2641,394,15,12,27,55.6%,58m
26704,1,Grhmj,2641,291,9,9,18,50.0%,1h
26704,3,Valtor,2641,108,4,5,9,44.4%,21m
26704,2,SniffyBoyJo,2641,30,2,0,2,100.0%,1h
26704,2,ffii,2641,44,2,0,2,100.0%,21m
26704,2,Vivo,2641,62,2,2,4,50.0%,6m
26704,2,KeepUrReaper,2641,60,2,3,5,40.0%,1h
26704,2,ReD,2641,0,1,0,1,100.0%,1h
26704,1,TORETTO,2641,0,1,3,4,25.0%,1h
26704,2,[ImWRs]Pakiroo,2641,93,1,3,4,25.0%,1h
26704,2,MOLOTILA,2641,0,0,1,1,0.0%,1h
26704,1,[hf4X4]DrNoob,2641,0,0,3,3,0.0%,1h
26727,1,Shenkt,2640,1693,171,152,323,52.9%,1h
26727,1,darkness,2640,1461,108,119,227,47.6%,1h
26727,2,Edvinab,2640,1354,87,66,153,56.9%,1h
26727,1,ShowYourSkil,2640,712,64,51,115,55.7%,10m
26727,2,Missing,2640,837,38,30,68,55.9%,1h
26727,2,ArtSeven,2640,750,28,25,53,52.8%,23m
26727,1,DrAybolit,2640,622,23,21,44,52.3%,21m
26727,3,BrookXVll,2640,596,22,26,48,45.8%,6m
26727,2,МУЖИКАНУС,2640,465,18,12,30,60.0%,25m
26727,1,[JouMa]BloodyAgent,2640,382,17,16,33,51.5%,1h
26727,3,[D0N3]MANU,2640,531,17,27,44,38.6%,15m
26727,2,AndyTRAMBLEx,2640,419,15,19,34,44.1%,14m
26727,2,[sissis]reeetac,2640,368,14,11,25,56.0%,58m
26727,2,Flex,2640,385,13,13,26,50.0%,1h
26727,1,Dyo,2640,405,12,12,24,50.0%,17m
26727,3,Hiob,2640,298,12,16,28,42.9%,14m
26727,3,Rearden,2640,292,11,13,24,45.8%,1h
26727,3,AppleJuiceM,2640,242,8,19,27,29.6%,4m
26727,1,SeanLuc,2640,293,7,15,22,31.8%,1h
26727,2,vamos,2640,142,6,2,8,75.0%,3m
26727,1,[StRa]Edkinson,2640,150,5,9,14,35.7%,20m
26727,2,[TEMB]FettoPanda,2640,117,4,6,10,40.0%,1h
26727,3,[SUZUKI]Costin,2640,97,2,0,2,100.0%,1h
26727,2,XyJIiraH,2640,30,2,0,2,100.0%,20m
26727,3,[YsRG]Jankulovski,2640,0,2,3,5,40.0%,1h
26727,2,BlackBear,2640,60,2,3,5,40.0%,17m
26727,2,Whouaka,2640,0,2,3,5,40.0%,56m
26727,2,maersix,2640,0,2,3,5,40.0%,15m
26727,2,Deadwood,2640,88,2,4,6,33.3%,23m
26727,2,Nespresso,2640,95,2,4,6,33.3%,1h
26727,3,rave,2640,42,2,4,6,33.3%,5m
26727,1,Shadow,2640,76,2,5,7,28.6%,22m
26727,2,BBC,2640,0,1,0,1,100.0%,58m
26727,3,scSilver,2640,0,1,0,1,100.0%,1h
26727,1,[DrNost]MorOnTV,2640,0,1,1,2,50.0%,1h
26727,2,[GSSCRY]ХитрыйКраб,2640,30,1,1,2,50.0%,6m
26727,1,juanin,2640,48,1,2,3,33.3%,15m
26727,2,[Maitri]AryaTara,2640,0,1,4,5,20.0%,1h
26727,2,Ara,2640,0,0,1,1,0.0%,1h
26727,2,Creepling,2640,0,0,2,2,0.0%,2m
26727,2,Restyle,2640,0,0,2,2,0.0%,20m
26727,1,kouklamo,2640,0,0,2,2,0.0%,1h
26727,1,Zaval,2640,0,0,3,3,0.0%,26m
26727,2,[jfjggf]demnp,2640,0,0,5,5,0.0%,1h
26771,1,Butcher,2639,1677,198,180,378,52.4%,15m
26771,3,ArtyCat,2639,1520,130,135,265,49.1%,19m
26771,2,TuRocker,2639,714,114,127,241,47.3%,20m
26771,2,Cromwell,2639,1266,60,53,113,53.1%,1h
26771,2,[AOTW]Gaben,2639,970,43,24,67,64.2%,16m
26771,2,[Cannae]Zhukov,2639,808,32,27,59,54.2%,11m
26771,1,Bastich,2639,593,31,31,62,50.0%,57m
26771,2,DARKAKIRA,2639,483,19,15,34,55.9%,60m
26771,2,[RETADO]Retarded,2639,509,18,14,32,56.2%,3m
26771,3,pantelas,2639,412,14,24,38,36.8%,12m
26771,2,Furieux,2639,256,8,5,13,61.5%,1h
26771,1,[ПИCYN]OVERSEX,2639,173,7,6,13,53.8%,1h
26771,1,SEeE,2639,140,5,7,12,41.7%,1h
26771,2,josh,2639,30,4,6,10,40.0%,1m
26771,3,Kraton,2639,0,3,3,6,50.0%,18m
26771,2,HANNIBAL,2639,34,2,0,2,100.0%,1h
26771,2,Bart,2639,0,2,1,3,66.7%,24m
26771,2,HibridFeory,2639,62,2,1,3,66.7%,15m
26771,2,potda,2639,0,2,5,7,28.6%,20m
26771,2,[PLANgg]DRDEATH,2639,30,1,3,4,25.0%,15m
26771,2,Pegasus,2639,94,1,3,4,25.0%,1h
26771,2,CroufordPL,2639,0,0,1,1,0.0%,58m
26771,2,GumGum,2639,0,0,3,3,0.0%,1h
26771,2,MrEngin,2639,0,0,3,3,0.0%,1h
26795,2,[RBlood]BabyBelle,2638,1088,365,367,732,49.9%,2m
26795,1,Kikampas,2638,1012,108,113,221,48.9%,25m
26795,2,NickiSPB,2638,1620,69,61,130,53.1%,1h
26795,1,MARO,2638,703,23,24,47,48.9%,26m
26795,1,[SLW]speedyPifPaf,2638,433,20,12,32,62.5%,1h
26795,2,Newby,2638,358,16,3,19,84.2%,1h
26795,1,Cobaltic,2638,220,12,17,29,41.4%,11m
26795,1,Licht,2638,280,9,11,20,45.0%,1h
26795,2,schotokan,2638,218,8,7,15,53.3%,1h
26795,1,нуб,2638,209,7,8,15,46.7%,19m
26795,1,[epiXX]Ezai,2638,203,6,7,13,46.2%,14m
26795,2,WalterMax,2638,211,6,7,13,46.2%,60m
26795,3,[PARADX]Perssipicot,2638,181,5,1,6,83.3%,3m
26795,1,BAMBOOZLE,2638,111,5,14,19,26.3%,17m
26795,3,Vilyx,2638,159,4,4,8,50.0%,21m
26795,3,DEWIL,2638,0,3,5,8,37.5%,21m
26795,3,stark,2638,0,2,3,5,40.0%,1h
26795,1,CharleyMeen,2638,0,2,4,6,33.3%,6m
26795,3,[Bx2]Djaneezy,2638,80,2,7,9,22.2%,57m
26795,3,ttN,2638,0,0,1,1,0.0%,4m
26795,2,RiViWill,2638,0,0,1,1,0.0%,13m
26816,3,[DMOS]smoeker,2637,1468,162,160,322,50.3%,4m
26816,1,[GenGG]Zab,2637,1287,128,119,247,51.8%,20m
26816,3,[WYG]LePadre,2637,1334,116,115,231,50.2%,20m
26816,1,Dinchi,2637,674,70,66,136,51.5%,21m
26816,1,Caizoe,2637,772,63,59,122,51.6%,1h
26816,2,[PiPoU]Dreadrum,2637,994,55,43,98,56.1%,56m
26816,1,[Grump]MoMo,2637,919,54,49,103,52.4%,59m
26816,1,Sketch,2637,499,50,50,100,50.0%,22m
26816,1,invizMamulek,2637,505,17,16,33,51.5%,1h
26816,1,Danken,2637,348,16,12,28,57.1%,1h
26816,2,Brocken,2637,277,11,6,17,64.7%,19m
26816,1,[DILIT]MaXiNe,2637,240,11,6,17,64.7%,10m
26816,1,IIRobokopII,2637,148,5,5,10,50.0%,3m
26816,2,Eule,2637,0,3,4,7,42.9%,1h
26816,3,Crean,2637,97,2,5,7,28.6%,1h
26816,2,spiderpig,2637,32,1,1,2,50.0%,19m
26816,3,laper,2637,0,0,1,1,0.0%,17m
26816,2,RazoR,2637,0,0,1,1,0.0%,12m
26816,1,АрхЖигуил,2637,0,0,6,6,0.0%,1h
26835,2,korn,2636,1374,104,88,192,54.2%,1h
26835,1,frAp,2636,1452,96,86,182,52.7%,1h
26835,2,[WTFQ]RussiaRostov,2636,1567,89,77,166,53.6%,14m
26835,1,Gogogo,2636,1161,47,43,90,52.2%,3m
26835,1,[IDF48]Freeze,2636,927,41,27,68,60.3%,56m
26835,2,[JaBa]Sharkuras,2636,1031,40,36,76,52.6%,1h
26835,1,lolmot,2636,815,33,28,61,54.1%,6m
26835,1,Diesel,2636,807,32,29,61,52.5%,6m
26835,1,EHOT,2636,720,29,20,49,59.2%,58m
26835,2,PilouPilou,2636,597,23,20,43,53.5%,11m
26835,1,Uznik,2636,370,12,14,26,46.2%,57m
26835,2,SanyaLLLyka,2636,338,11,7,18,61.1%,56m
26835,2,[1NFEC7]GANMU,2636,229,8,6,14,57.1%,1h
26835,2,[wazzo]Nyu,2636,174,7,4,11,63.6%,1h
26835,1,[cGz]turneR,2636,228,7,9,16,43.8%,1h
26835,1,Sebrenag,2636,184,6,6,12,50.0%,1h
26835,2,Dan,2636,60,3,3,6,50.0%,16m
26835,1,Landstreiche,2636,94,3,4,7,42.9%,1h
26835,2,naratmalssa,2636,0,3,4,7,42.9%,23m
26835,2,empty,2636,0,3,5,8,37.5%,20m
26835,1,GuliveRTRV,2636,80,3,7,10,30.0%,1h
26835,2,laulau,2636,58,2,1,3,66.7%,1h
26835,1,[BTwins]PéchéMignon,2636,88,2,2,4,50.0%,1h
26835,2,[LegioV]Thor,2636,64,2,4,6,33.3%,1h
26835,1,PurpleAvatar,2636,42,2,6,8,25.0%,1h
26835,3,Sand,2636,0,1,0,1,100.0%,1h
26835,2,[RPGen]KiberKotleta,2636,0,1,0,1,100.0%,24m
26835,2,[Kboin]Othon,2636,0,1,1,2,50.0%,3m
26835,2,Devlo,2636,0,0,1,1,0.0%,1h
26864,2,Jan,2635,1622,211,211,422,50.0%,11m
26864,2,AlfaStar,2635,1566,165,164,329,50.2%,22m
26864,3,xXxDurexXx,2635,1381,129,125,254,50.8%,21m
26864,2,Echoes,2635,1562,111,103,214,51.9%,16m
26864,2,MazMan,2635,1392,92,90,182,50.5%,1h
26864,3,Tropiņš,2635,1130,66,70,136,48.5%,8m
26864,2,Yellowst,2635,1109,59,40,99,59.6%,1h
26864,2,Lamora,2635,905,55,47,102,53.9%,23m
26864,1,[drrsch]dxdy,2635,1321,53,44,97,54.6%,1h
26864,3,misterO,2635,1237,47,54,101,46.5%,9m
26864,3,Vasya,2635,1275,46,47,93,49.5%,21m
26864,2,mangara,2635,1067,42,36,78,53.8%,17m
26864,2,Bruskach,2635,676,40,27,67,59.7%,1h
26864,3,Diego,2635,908,30,44,74,40.5%,10m
26864,1,Asathor,2635,641,24,22,46,52.2%,1h
26864,2,Профсоюз,2635,402,18,10,28,64.3%,1h
26864,2,[NFever]Buddy,2635,263,12,1,13,92.3%,10m
26864,2,BoJack,2635,300,11,9,20,55.0%,1h
26864,1,Prusias,2635,310,9,12,21,42.9%,1h
26864,2,llllllllllll,2635,247,7,12,19,36.8%,1h
26864,3,[BRSKR]CaptainKirk,2635,0,4,1,5,80.0%,3m
26864,2,FURYCH,2635,92,4,2,6,66.7%,6m
26864,2,haikers,2635,129,3,0,3,100.0%,1h
26864,3,Orbitalforce,2635,138,3,1,4,75.0%,15m
26864,2,Zarrck,2635,146,3,3,6,50.0%,1h
26864,3,[WpG]NLK,2635,138,3,9,12,25.0%,8m
26864,3,[WARP20]TheOneWon,2635,0,2,3,5,40.0%,3m
26864,2,Schelest,2635,0,2,3,5,40.0%,1h
26864,2,potatogrill,2635,0,2,3,5,40.0%,25m
26864,2,желдровосекс,2635,0,2,3,5,40.0%,1h
26864,2,sabkingdz,2635,0,2,3,5,40.0%,1h
26864,1,[dæD]Keo,2635,0,1,1,2,50.0%,1h
26864,2,BaXToRjr,2635,0,0,1,1,0.0%,1h
26864,3,Chu,2635,0,0,1,1,0.0%,1h
26898,1,MarineMaster,2634,1552,118,111,229,51.5%,58m
26898,1,[XGpro]NciSdiego,2634,1092,78,64,142,54.9%,10m
26898,2,Lancer,2634,1108,71,56,127,55.9%,1h
26898,1,lord,2634,1423,57,52,109,52.3%,57m
26898,1,franz,2634,487,20,18,38,52.6%,23m
26898,1,jokerhead,2634,550,19,16,35,54.3%,1h
26898,2,qwoiqwa,2634,369,15,10,25,60.0%,1h
26898,2,[SaviOr]GhostKeeper,2634,410,15,15,30,50.0%,1h
26898,1,MrSan,2634,281,11,10,21,52.4%,22m
26898,2,Tomiris,2634,320,11,11,22,50.0%,1h
26898,2,[xFRSx]Nemesis,2634,210,7,10,17,41.2%,15m
26898,1,GhostRider,2634,272,7,13,20,35.0%,1h
26898,2,CuciFlash,2634,152,6,7,13,46.2%,26m
26898,2,[LBZ]ElAhui,2634,92,4,3,7,57.1%,1h
26898,3,Matheas,2634,121,3,5,8,37.5%,20m
26898,1,shaitan,2634,80,3,7,10,30.0%,1h
26898,3,[PrAy8T]ChetBaker,2634,58,3,9,12,25.0%,16m
26898,2,[НИШТЯК]tnt,2634,18,2,2,4,50.0%,1h
26898,2,LazyTitan,2634,48,2,2,4,50.0%,1h
26898,3,[WАSD]ALoginov,2634,42,1,1,2,50.0%,1h
26898,2,reptiloid,2634,0,1,1,2,50.0%,1h
26898,2,IIIIIIIIIII,2634,0,1,3,4,25.0%,1h
26898,2,tadzio,2634,0,0,1,1,0.0%,25m
26898,3,GACHIMUCHI,2634,0,0,1,1,0.0%,1h
26922,3,Asterocks,2633,1125,327,319,646,50.6%,16m
26922,3,Raven,2633,1530,233,225,458,50.9%,8m
26922,3,Hattori,2633,1574,178,167,345,51.6%,1m
26922,3,[1DELTA]Titus,2633,1491,118,106,224,52.7%,3m
26922,1,MacroPasha,2633,523,18,16,34,52.9%,7m
26922,1,[DZIKl]WuEm,2633,306,12,13,25,48.0%,1h
26922,1,Hanumon,2633,267,7,5,12,58.3%,24m
26922,1,[DHYD]SalyT,2633,202,7,6,13,53.8%,1h
26922,1,AndKis,2633,258,7,8,15,46.7%,1h
26922,2,Big,2633,172,6,4,10,60.0%,58m
26922,2,[4H]basmati,2633,181,6,6,12,50.0%,1h
26922,2,HiDik,2633,60,5,8,13,38.5%,9m
26922,3,QuardOfVoid,2633,162,4,4,8,50.0%,1h
26922,1,aha,2633,116,4,13,17,23.5%,4m
26922,2,TaNKerTANGO,2633,68,3,3,6,50.0%,8m
26922,1,KillerMarti,2633,142,3,4,7,42.9%,60m
26922,1,[Kans]Умник,2633,160,3,10,13,23.1%,5m
26922,1,Svudnik,2633,96,2,6,8,25.0%,1h
26922,2,Racer,2633,0,1,0,1,100.0%,9m
26922,2,Kreur,2633,0,1,0,1,100.0%,1h
26922,2,JARVIS,2633,0,1,0,1,100.0%,24m
26922,2,JerryKan,2633,30,1,1,2,50.0%,1h
26922,2,Carlos,2633,0,1,1,2,50.0%,1h
26922,1,АшотГургенов,2633,0,1,6,7,14.3%,1h
26922,2,SoupCatcher,2633,0,0,1,1,0.0%,2m
26922,2,[CORO]AntonusPrime,2633,0,0,1,1,0.0%,3m
26922,2,BattleDa,2633,0,0,1,1,0.0%,1h
26922,2,Lambda,2633,0,0,5,5,0.0%,25m
26922,1,jonicorn,2633,0,0,5,5,0.0%,25m
26922,3,War,2633,0,0,5,5,0.0%,1h
26952,2,Queadrauth,2632,1618,190,173,363,52.3%,4m
26952,3,[COvie]sekoja,2632,875,45,50,95,47.4%,24m
26952,1,[ZGON]SPECJAL,2632,1278,44,49,93,47.3%,58m
26952,1,lukibalboą,2632,929,41,24,65,63.1%,1h
26952,1,KamelMaaitah,2632,740,35,32,67,52.2%,3m
26952,2,[BroBo]upuntu,2632,646,24,22,46,52.2%,58m
26952,2,tsukuyomi,2632,460,18,25,43,41.9%,11m
26952,1,Zebulon,2632,423,15,15,30,50.0%,26m
26952,1,mychallenge,2632,398,15,15,30,50.0%,27m
26952,1,NonMetaL,2632,185,8,8,16,50.0%,1h
26952,1,IllIIlIlllIl,2632,295,8,9,17,47.1%,56m
26952,1,Angriff,2632,225,7,7,14,50.0%,1h
26952,2,DimonLimon,2632,267,7,9,16,43.8%,1h
26952,2,Flashblox,2632,115,7,10,17,41.2%,22m
26952,1,Erwodak,2632,275,7,10,17,41.2%,1h
26952,2,[2Ta]RegularAss,2632,176,6,5,11,54.5%,19m
26952,2,JollyRoger,2632,179,6,6,12,50.0%,1h
26952,2,RISKY,2632,102,5,2,7,71.4%,25m
26952,3,Dendé,2632,42,4,3,7,57.1%,4m
26952,2,[pÖJKON]Wodie,2632,46,4,5,9,44.4%,58m
26952,2,[OGR232]SkillEnota,2632,86,3,2,5,60.0%,1h
26952,2,Artanis,2632,90,3,3,6,50.0%,1h
26952,2,[GIMBO]aał,2632,0,2,3,5,40.0%,6m
26952,2,niklas,2632,0,1,0,1,100.0%,18m
26952,2,[213121]Darik,2632,30,1,1,2,50.0%,1h
26952,2,AlphaAsPuck,2632,0,1,2,3,33.3%,16m
26952,2,BrownMan,2632,30,1,2,3,33.3%,55m
26952,2,Rohadás,2632,30,1,4,5,20.0%,21m
26952,3,Quentin,2632,97,1,4,5,20.0%,1h
26952,1,HazeTribes,2632,34,1,4,5,20.0%,56m
26952,3,RoteJacke,2632,0,1,4,5,20.0%,4m
26952,2,CaptainMitt,2632,0,0,1,1,0.0%,1h
26984,2,Patrocle,2631,1645,244,231,475,51.4%,16m
26984,1,[BgAS]Moustaki,2631,1534,113,123,236,47.9%,6m
26984,3,dans,2631,1388,52,60,112,46.4%,11m
26984,2,NeoXx,2631,1314,49,47,96,51.0%,24m
26984,1,Ravil,2631,792,25,33,58,43.1%,56m
26984,2,Mickers,2631,535,23,14,37,62.2%,2m
26984,1,Crash,2631,163,14,15,29,48.3%,1h
26984,1,Ekmans,2631,424,12,19,31,38.7%,1h
26984,3,Arch,2631,216,11,11,22,50.0%,16m
26984,1,[EPMG]Rain,2631,291,11,12,23,47.8%,9m
26984,1,RareAssPePe,2631,356,11,16,27,40.7%,1h
26984,3,Adebisi,2631,359,11,18,29,37.9%,3m
26984,2,Unforeseen,2631,253,10,12,22,45.5%,14m
26984,2,KNAAAS,2631,254,10,15,25,40.0%,1h
26984,2,KAUTOCARRO,2631,174,7,6,13,53.8%,1h
26984,1,SemMA,2631,260,7,14,21,33.3%,1h
26984,3,DarkǂBlast,2631,216,7,18,25,28.0%,16m
26984,2,ExodusPrime,2631,179,4,3,7,57.1%,1h
26984,1,Ayren,2631,108,3,7,10,30.0%,58m
26984,3,ALUKARD,2631,0,2,3,5,40.0%,1h
26984,1,Rubens,2631,96,1,2,3,33.3%,16m
26984,1,Hauxner,2631,88,1,2,3,33.3%,7m
26984,2,Teshkul,2631,88,1,4,5,20.0%,21m
26984,3,[Havu]Arvola,2631,0,0,1,1,0.0%,19m
26984,2,[PLcreW]MiXiR,2631,0,0,1,1,0.0%,1h
26984,1,Goliat,2631,0,0,2,2,0.0%,26m
26984,2,Raziel,2631,0,0,2,2,0.0%,58m
26984,2,FrK,2631,0,0,2,2,0.0%,24m
26984,3,Patrask,2631,0,0,3,3,0.0%,1h
26984,1,stewie,2631,0,0,5,5,0.0%,11m
27014,2,Странник,2630,1538,677,677,1354,50.0%,23m
27014,2,jalle,2630,1095,50,49,99,50.5%,1h
27014,3,CIZUF,2630,927,33,39,72,45.8%,11m
27014,1,GGeryx,2630,674,21,29,50,42.0%,1h
27014,1,SayNoToStim,2630,577,20,17,37,54.1%,1h
27014,1,Requiem,2630,640,20,28,48,41.7%,1h
27014,3,Misha,2630,337,14,9,23,60.9%,1h
27014,2,[WAAR]MVALordSethi,2630,362,14,10,24,58.3%,16m
27014,2,[WPru]Click,2630,272,9,4,13,69.2%,1h
27014,1,[klanix]mamhinsyhn,2630,264,8,11,19,42.1%,26m
27014,2,BOBCAT,2630,126,7,4,11,63.6%,1h
27014,2,DarkRider,2630,199,7,6,13,53.8%,1h
27014,1,Kareful,2630,185,6,6,12,50.0%,55m
27014,2,petitepaille,2630,178,6,7,13,46.2%,27m
27014,1,GroMoBoy,2630,152,5,7,12,41.7%,1h
27014,2,PickerDenis,2630,166,4,2,6,66.7%,1h
27014,1,asb,2630,170,4,6,10,40.0%,1h
27014,2,PlayerAAA,2630,90,3,3,6,50.0%,18m
27014,3,akiRO,2630,121,3,6,9,33.3%,1h
27014,3,NinemanVGX,2630,121,3,10,13,23.1%,10m
27014,3,[WogGr]DragOn,2630,0,2,1,3,66.7%,1h
27014,2,Labrat,2630,0,2,3,5,40.0%,1h
27014,1,Drakab,2630,0,2,4,6,33.3%,1h
27014,1,MAIKROFT,2630,38,2,4,6,33.3%,1h
27014,2,Nop,2630,0,1,0,1,100.0%,1h
27014,3,ФдучУА,2630,0,1,0,1,100.0%,1h
27014,2,ZERG,2630,0,1,1,2,50.0%,58m
27014,2,Azdrubael,2630,0,1,1,2,50.0%,1h
27014,3,Lom,2630,97,1,5,6,16.7%,1h
27014,2,eljuan,2630,0,0,2,2,0.0%,20m
27014,2,Lacker,2630,0,0,2,2,0.0%,16m
27045,1,[AwTm]inDiGo,2629,1267,58,51,109,53.2%,7m
27045,3,seenager,2629,514,53,53,106,50.0%,12m
27045,1,Martinness,2629,1276,53,56,109,48.6%,1h
27045,2,bibthebolder,2629,622,43,39,82,52.4%,1h
27045,2,Sankai,2629,944,41,33,74,55.4%,1h
27045,2,Becky,2629,670,35,26,61,57.4%,1h
27045,3,FnH,2629,729,29,33,62,46.8%,10m
27045,3,Александр,2629,503,19,24,43,44.2%,5m
27045,2,Malmatiko,2629,386,16,19,35,45.7%,23m
27045,2,westbroekie,2629,408,15,13,28,53.6%,22m
27045,3,NipeL,2629,345,13,11,24,54.2%,7m
27045,1,febryd,2629,388,12,13,25,48.0%,56m
27045,2,BenZaL,2629,276,9,10,19,47.4%,1h
27045,1,[LMBD]LaZMariNE,2629,250,8,12,20,40.0%,4m
27045,1,norris,2629,262,7,12,19,36.8%,25m
27045,2,[GoGoG]SkyRunner,2629,148,6,7,13,46.2%,2m
27045,2,NemO,2629,244,6,9,15,40.0%,1h
27045,2,Legionaire,2629,148,5,4,9,55.6%,58m
27045,1,ZLAT,2629,140,4,8,12,33.3%,17m
27045,2,Highspirit,2629,90,3,4,7,42.9%,1h
27045,1,Faxanadu,2629,46,2,0,2,100.0%,1h
27045,2,[GPs57]Kzkh,2629,30,2,2,4,50.0%,1h
27045,2,ImSorryManGG,2629,30,2,4,6,33.3%,56m
27045,3,Aegoith,2629,97,2,4,6,33.3%,1h
27045,2,RayZen,2629,0,1,0,1,100.0%,1h
27045,2,Bizarre,2629,0,1,1,2,50.0%,1h
27045,1,Anticitizen,2629,0,1,4,5,20.0%,1h
27045,3,thepicpowner,2629,0,0,1,1,0.0%,1h
27045,3,[FOTBOT]KhunEdvahn,2629,0,0,2,2,0.0%,6m
27045,2,Manhunt,2629,0,0,3,3,0.0%,5m
27045,3,Ukyo,2629,0,0,6,6,0.0%,8m
27076,3,FrankDrebin,2628,1488,124,125,249,49.8%,22m
27076,1,spikebjj,2628,466,62,67,129,48.1%,1h
27076,3,DonPorolon,2628,1014,36,44,80,45.0%,5m
27076,1,RedChekenBur,2628,907,34,29,63,54.0%,1h
27076,1,DictatorJr,2628,786,25,32,57,43.9%,12m
27076,3,Acronym,2628,553,21,24,45,46.7%,15m
27076,2,mrd,2628,517,18,30,48,37.5%,15m
27076,1,[SKAT]Specialisti,2628,431,14,18,32,43.8%,4m
27076,1,tvoyasuchka,2628,353,13,12,25,52.0%,12m
27076,1,[RSPD]shadowstorm,2628,310,9,11,20,45.0%,6m
27076,1,Арториус,2628,209,6,12,18,33.3%,58m
27076,3,Dudecmon,2628,178,5,3,8,62.5%,23m
27076,3,Kotik,2628,151,4,10,14,28.6%,54m
27076,1,GeileJenny,2628,143,3,6,9,33.3%,1h
27076,2,EdemaRuh,2628,0,2,2,4,50.0%,1h
27076,2,torquemada,2628,96,2,3,5,40.0%,9m
27076,1,ObiJuan,2628,0,2,4,6,33.3%,25m
27076,1,FiAND,2628,68,2,8,10,20.0%,1h
27076,2,[lkgg]spider,2628,122,2,9,11,18.2%,24m
27076,2,easy,2628,32,1,1,2,50.0%,1h
27076,1,TroyStar,2628,48,1,2,3,33.3%,1h
27076,2,Lamama,2628,0,1,2,3,33.3%,1h
27076,1,SEGREY,2628,36,1,5,6,16.7%,1h
27076,2,Amigo,2628,0,0,1,1,0.0%,24m
27076,2,Balrog,2628,0,0,2,2,0.0%,1h
27076,1,Gimago,2628,0,0,2,2,0.0%,18m
27102,1,Smog,2627,548,118,119,237,49.8%,1h
27102,1,[XVIIII]VoidRayRush,2627,1551,68,63,131,51.9%,23m
27102,1,voldemar,2627,1075,60,41,101,59.4%,3m
27102,2,Arch,2627,1103,54,29,83,65.1%,1h
27102,1,Weffweef,2627,1047,54,47,101,53.5%,1h
27102,1,Anvarsky,2627,1092,53,48,101,52.5%,3m
27102,2,Rychard,2627,804,30,27,57,52.6%,1h
27102,2,Karamelka,2627,708,29,18,47,61.7%,1h
27102,1,bluecraker,2627,650,26,25,51,51.0%,60m
27102,1,BreakTouch,2627,456,19,18,37,51.4%,12m
27102,2,monoid,2627,332,14,4,18,77.8%,1h
27102,1,матвей,2627,359,14,10,24,58.3%,3m
27102,2,[XKot]XmuriyKot,2627,290,12,9,21,57.1%,1h
27102,1,Cooley,2627,336,12,16,28,42.9%,22m
27102,1,ILoveJuice,2627,396,11,16,27,40.7%,23m
27102,3,Aither,2627,179,9,12,21,42.9%,58m
27102,2,[Peeps]Mandarph,2627,228,8,3,11,72.7%,1h
27102,2,agaulier,2627,152,6,5,11,54.5%,1h
27102,2,Emmerson,2627,141,5,5,10,50.0%,16m
27102,3,TommiMaloi,2627,91,3,5,8,37.5%,21m
27102,2,[ZERGML]Even,2627,0,1,0,1,100.0%,1h
27102,2,Mudak,2627,0,1,0,1,100.0%,1h
27102,2,[Lusi]ZigaZaga,2627,0,1,2,3,33.3%,1h
27102,1,diidoxd,2627,30,1,4,5,20.0%,22m
27102,2,KAWA,2627,0,0,1,1,0.0%,10m
27102,2,[DGSQ]EmperiumObes,2627,0,0,1,1,0.0%,2m
27102,2,Vadim,2627,0,0,2,2,0.0%,55m
27129,2,Stolitantum,2626,1677,155,134,289,53.6%,1h
27129,1,[LMBD]ÜlkücüMarine,2626,1412,68,47,115,59.1%,1h
27129,1,[McWars]PeCkAtSwE,2626,1653,68,66,134,50.7%,25m
27129,2,bogiman,2626,982,59,55,114,51.8%,2m
27129,1,[Чай]Тигрёнок,2626,1395,56,57,113,49.6%,6m
27129,3,kapsas,2626,722,44,52,96,45.8%,12m
27129,2,Komi,2626,925,40,24,64,62.5%,21m
27129,1,poncho,2626,900,29,34,63,46.0%,18m
27129,1,AXIOM,2626,318,23,13,36,63.9%,1h
27129,2,AtruymCC,2626,504,23,16,39,59.0%,1h
27129,1,Shamm,2626,492,23,24,47,48.9%,1h
27129,2,josh,2626,497,22,8,30,73.3%,14m
27129,3,[ZZee]MURWELL,2626,504,17,22,39,43.6%,9m
27129,1,[Pinyát]Lurch,2626,444,13,19,32,40.6%,17m
27129,2,AGROHIM,2626,346,12,18,30,40.0%,1h
27129,2,[Altair]Reynor,2626,300,11,10,21,52.4%,2m
27129,3,sanhator,2626,264,10,13,23,43.5%,22m
27129,2,GeneralDSL,2626,216,9,12,21,42.9%,5m
27129,2,IIIIIIIIIIII,2626,180,6,7,13,46.2%,9m
27129,2,Gliniarz,2626,209,5,7,12,41.7%,1h
27129,3,Dartin,2626,42,3,4,7,42.9%,2m
27129,1,Dmon,2626,118,3,5,8,37.5%,27m
27129,2,west,2626,30,2,2,4,50.0%,21m
27129,2,bellator,2626,88,2,4,6,33.3%,55m
27129,1,teodor,2626,48,2,5,7,28.6%,1h
27129,2,NextDoor,2626,0,1,4,5,20.0%,19m
27129,1,[LFTW]XLoRD,2626,36,1,8,9,11.1%,26m
27129,2,Xpice,2626,0,0,1,1,0.0%,1h
27157,3,sjpxxy,2625,1575,185,181,366,50.5%,14m
27157,2,[Юнион]DEAD,2625,1295,128,121,249,51.4%,1h
27157,2,Halatlan,2625,1435,62,41,103,60.2%,1h
27157,2,Inko,2625,1280,56,42,98,57.1%,1h
27157,1,MERION,2625,1208,49,37,86,57.0%,58m
27157,1,Burnmaster,2625,778,26,28,54,48.1%,17m
27157,2,flycat,2625,357,13,11,24,54.2%,1h
27157,2,Sanekus,2625,305,12,13,25,48.0%,26m
27157,2,Braune,2625,291,11,5,16,68.8%,3m
27157,2,[MILOS]Dream,2625,254,8,4,12,66.7%,21m
27157,2,MikaTamni,2625,120,7,0,7,100.0%,24m
27157,2,Tistobal,2625,212,7,2,9,77.8%,55m
27157,1,[K1LL]OnE,2625,34,5,3,8,62.5%,17m
27157,3,wicket,2625,120,5,5,10,50.0%,23m
27157,1,[R4Time]Papatuu,2625,193,5,6,11,45.5%,56m
27157,2,Para,2625,58,3,0,3,100.0%,1h
27157,2,[DWLLS]Thornkiller,2625,96,3,2,5,60.0%,1h
27157,1,mycephei,2625,74,3,7,10,30.0%,17m
27157,2,[GRATL]bananananana,2625,0,2,3,5,40.0%,1h
27157,2,Gesichtzslos,2625,0,2,3,5,40.0%,1h
27157,3,KUKULULU,2625,0,2,3,5,40.0%,1h
27157,2,Pawel,2625,0,2,5,7,28.6%,5m
27157,2,Firelancer,2625,0,1,2,3,33.3%,1h
27157,2,KOS,2625,0,0,1,1,0.0%,25m
27157,1,Enigma,2625,0,0,2,2,0.0%,11m
27182,2,RealLife,2624,1603,427,447,874,48.9%,55m
27182,2,JUANANBOT,2624,1531,190,183,373,50.9%,9m
27182,2,Xandor,2624,1597,107,103,210,51.0%,25m
27182,1,Florentine,2624,1637,87,82,169,51.5%,4m
27182,1,Price,2624,1413,84,79,163,51.5%,56m
27182,3,[QStorm]badkido,2624,1544,69,81,150,46.0%,21m
27182,1,VanGorilla,2624,1223,58,46,104,55.8%,1h
27182,3,KNEjk,2624,1261,56,50,106,52.8%,5m
27182,2,Piko,2624,1074,53,49,102,52.0%,16m
27182,2,iMahila,2624,1057,45,35,80,56.2%,15m
27182,3,lllllllllll,2624,824,41,51,92,44.6%,20m
27182,1,MightyBlues,2624,874,38,23,61,62.3%,20m
27182,2,Kuka,2624,805,36,18,54,66.7%,56m
27182,2,Soul,2624,730,26,26,52,50.0%,1h
27182,2,TwoScvOneCup,2624,554,24,17,41,58.5%,1h
27182,2,MarieB,2624,638,23,18,41,56.1%,1h
27182,2,Tyranth,2624,670,23,29,52,44.2%,10m
27182,3,DigDingeBong,2624,491,19,21,40,47.5%,13m
27182,2,[Gremli]Zorrotul,2624,354,14,11,25,56.0%,20m
27182,2,Marvin,2624,254,12,4,16,75.0%,55m
27182,3,mkmarchelo,2624,335,12,21,33,36.4%,12m
27182,2,nakhti,2624,290,11,4,15,73.3%,57m
27182,1,Даниил,2624,223,9,5,14,64.3%,11m
27182,3,Delirius,2624,120,5,16,21,23.8%,6m
27182,2,Taldarim,2624,88,3,7,10,30.0%,23m
27182,2,[R4Time]PainSeller,2624,30,2,3,5,40.0%,1h
27182,2,WarlordWay,2624,58,2,4,6,33.3%,6m
27182,1,Nero,2624,96,1,2,3,33.3%,6m
27182,2,DarkWizzard,2624,0,0,1,1,0.0%,1h
27182,2,Kornilie,2624,0,0,1,1,0.0%,19m
27182,2,Bertalanffy,2624,0,0,1,1,0.0%,1h
27182,2,Serseri,2624,0,0,1,1,0.0%,55m
27182,3,YNW,2624,0,0,1,1,0.0%,21m
27182,2,MRW,2624,0,0,2,2,0.0%,1h
27216,3,chillax,2623,1562,173,168,341,50.7%,13m
27216,2,[2021]ZHAMANBAY,2623,1316,71,68,139,51.1%,11m
27216,2,VdeBellmont,2623,1137,57,50,107,53.3%,1h
27216,2,McBroody,2623,1039,38,34,72,52.8%,1h
27216,2,BinaryLynx,2623,822,37,25,62,59.7%,15m
27216,2,Warfield,2623,697,29,17,46,63.0%,19m
27216,2,[101101]Kindlund,2623,337,21,6,27,77.8%,1h
27216,2,EvilivE,2623,377,16,8,24,66.7%,1h
27216,2,[FLZG]CptFlow,2623,490,16,21,37,43.2%,1h
27216,1,meodigy,2623,325,13,11,24,54.2%,6m
27216,2,[Bumms]Split,2623,199,8,5,13,61.5%,22m
27216,1,Marlito,2623,204,7,9,16,43.8%,1h
27216,2,Awesomus,2623,118,4,7,11,36.4%,26m
27216,2,veter,2623,126,3,2,5,60.0%,1h
27216,1,Dude,2623,142,3,4,7,42.9%,15m
27216,2,Flamark,2623,96,3,5,8,37.5%,1h
27216,1,SpawN,2623,58,3,5,8,37.5%,58m
27216,2,TODD,2623,30,2,0,2,100.0%,1h
27216,1,FirstFallen,2623,42,2,3,5,40.0%,6m
27216,1,AlexeyAst,2623,81,2,5,7,28.6%,1h
27216,2,Dreyse,2623,0,1,0,1,100.0%,1h
27216,3,CowarS,2623,0,1,0,1,100.0%,1h
27216,2,micolaminsky,2623,0,1,2,3,33.3%,21m
27216,1,Computer,2623,93,1,3,4,25.0%,6m
27216,1,Exodus,2623,46,1,4,5,20.0%,26m
27216,2,kaboom,2623,0,0,1,1,0.0%,14m
27216,2,PrinceAslan,2623,0,0,1,1,0.0%,1h
27243,2,Levente,2622,1692,263,259,522,50.4%,7m
27243,1,Dani,2622,1683,175,164,339,51.6%,20m
27243,1,Dizzy,2622,1547,158,139,297,53.2%,4m
27243,1,Inthenameof,2622,880,91,83,174,52.3%,26m
27243,1,Teemon,2622,1236,84,78,162,51.9%,24m
27243,1,[KYB]BujajTorbe,2622,1112,42,39,81,51.9%,6m
27243,1,Planekiller,2622,991,42,46,88,47.7%,23m
27243,1,DrugAddict,2622,891,41,31,72,56.9%,58m
27243,1,[LMBD]marulovetea,2622,243,10,12,22,45.5%,5m
27243,1,Asteroid,2622,202,6,12,18,33.3%,6m
27243,3,diloeprase,2622,168,5,4,9,55.6%,1h
27243,3,JonnyTsunami,2622,58,5,6,11,45.5%,14m
27243,1,tsobalik,2622,220,5,8,13,38.5%,1h
27243,3,[Cacoon]Deluchi,2622,165,5,10,15,33.3%,13m
27243,3,MDK,2622,0,4,2,6,66.7%,59m
27243,2,naorat,2622,122,4,7,11,36.4%,11m
27243,2,Reedik,2622,90,3,2,5,60.0%,1h
27243,1,[GAS]Pipster,2622,135,3,5,8,37.5%,26m
27243,1,[IndVar]Ikvelebrium,2622,72,3,5,8,37.5%,1h
27243,1,MrK,2622,116,3,8,11,27.3%,1h
27243,2,RsTich,2622,44,2,0,2,100.0%,1h
27243,3,Woldi,2622,0,2,1,3,66.7%,1h
27243,2,hadsahar,2622,46,2,1,3,66.7%,58m
27243,3,thial,2622,0,2,3,5,40.0%,1h
27243,3,shadow,2622,0,2,3,5,40.0%,1h
27243,3,anmeilu,2622,0,2,3,5,40.0%,1h
27243,1,[Lowko]AgentKami,2622,0,2,4,6,33.3%,18m
27243,1,[Кусь]alisher,2622,0,1,1,2,50.0%,12m
27243,2,[SW69]Леонид,2622,30,1,1,2,50.0%,6m
27243,2,[aBueLo]ToGayLor,2622,0,1,1,2,50.0%,1h
27243,2,Bulan,2622,0,0,1,1,0.0%,1h
27243,3,frfloflo,2622,0,0,1,1,0.0%,1h
27243,2,Sergeuses,2622,0,0,1,1,0.0%,1h
27243,2,[BLRS]sypernova,2622,0,0,3,3,0.0%,1h
27277,3,retsam,2621,1528,258,249,507,50.9%,23m
27277,1,RAHITA,2621,1690,227,228,455,49.9%,1h
27277,3,sandro,2621,1572,109,116,225,48.4%,21m
27277,2,SharrazGhul,2621,1605,84,78,162,51.9%,8m
27277,1,Shwin,2621,1006,83,76,159,52.2%,1h
27277,2,lIlIlIlIlIlI,2621,1596,69,60,129,53.5%,15m
27277,2,DaNiLGGG,2621,861,43,39,82,52.4%,13m
27277,1,Magus,2621,546,29,27,56,51.8%,1h
27277,3,TenienteDan,2621,715,29,31,60,48.3%,10m
27277,3,KaKolaK,2621,709,27,32,59,45.8%,20m
27277,2,[BFME2]James,2621,497,18,15,33,54.5%,1h
27277,2,léo,2621,416,15,12,27,55.6%,1h
27277,2,[SPT123]Meymon,2621,244,12,5,17,70.6%,9m
27277,1,[PeEff]wizn,2621,252,10,10,20,50.0%,1h
27277,3,[CHCH]MstrOfDsastr,2621,272,9,19,28,32.1%,2m
27277,2,Gryphus,2621,172,7,5,12,58.3%,1h
27277,2,ageres,2621,118,4,6,10,40.0%,9m
27277,2,[PPGАNG]SGCrusader,2621,30,2,0,2,100.0%,1h
27277,2,KarateSorken,2621,58,2,1,3,66.7%,1h
27277,2,TYQ,2621,30,2,1,3,66.7%,1h
27277,3,MARCDARK,2621,0,2,3,5,40.0%,1h
27277,2,TittenDachs,2621,0,1,4,5,20.0%,55m
27277,1,michel,2621,42,1,8,9,11.1%,60m
27277,2,TDM,2621,0,0,1,1,0.0%,22m
27277,2,Belch,2621,0,0,2,2,0.0%,1h
27302,3,skvic,2620,1343,241,231,472,51.1%,22m
27302,1,NuKLeaR,2620,1451,145,129,274,52.9%,1h
27302,1,sosh,2620,1516,85,79,164,51.8%,58m
27302,1,KapoTkuu,2620,607,53,46,99,53.5%,22m
27302,3,[3DE]PromeTHeus,2620,1396,50,58,108,46.3%,24m
27302,1,Sektor,2620,958,47,44,91,51.6%,3m
27302,3,[7a8DAN]DanSolo,2620,703,45,48,93,48.4%,12m
27302,3,Tasek,2620,630,33,30,63,52.4%,3m
27302,3,[MAOLTE]Tungsten,2620,649,23,35,58,39.7%,21m
27302,1,HoBuчok,2620,270,9,10,19,47.4%,20m
27302,1,Neruos,2620,196,7,4,11,63.6%,1h
27302,2,IIIIIIIIIIII,2620,210,7,8,15,46.7%,1h
27302,3,clane,2620,208,7,18,25,28.0%,13m
27302,2,[StrPep]aWserp,2620,178,6,7,13,46.2%,17m
27302,3,MCALIK,2620,165,6,8,14,42.9%,13m
27302,1,Jarick,2620,131,6,9,15,40.0%,17m
27302,2,Drayfus,2620,0,4,4,8,50.0%,1h
27302,2,CyberCom,2620,116,3,2,5,60.0%,1h
27302,2,KornKolio,2620,58,3,3,6,50.0%,27m
27302,2,Forewer,2620,0,3,3,6,50.0%,58m
27302,1,Köversän,2620,118,3,4,7,42.9%,1h
27302,1,HotCoffeeDog,2620,70,3,6,9,33.3%,5m
27302,2,[Smthc]drFurryballs,2620,92,3,10,13,23.1%,1h
27302,1,Perpendiculo,2620,105,2,4,6,33.3%,1h
27302,2,JhonyGhost,2620,0,1,0,1,100.0%,1h
27302,2,[SLABAC]RDV,2620,0,1,1,2,50.0%,59m
27302,2,SirOk,2620,30,1,3,4,25.0%,1h
27302,2,Spike,2620,0,0,1,1,0.0%,23m
27302,3,killer,2620,0,0,1,1,0.0%,59m
27302,1,SealClubber,2620,0,0,1,1,0.0%,1h
27302,2,LrdSebastian,2620,0,0,2,2,0.0%,1h
27302,2,Bob,2620,0,0,2,2,0.0%,20m
27302,2,[BULB]AmPEPEre,2620,0,0,2,2,0.0%,1h
27335,1,ShouriNoUme,2619,1605,141,140,281,50.2%,1h
27335,2,[YoMamm]BoomShakalak,2619,1517,127,114,241,52.7%,24m
27335,2,[TMART]Poki,2619,644,39,35,74,52.7%,59m
27335,2,Lysios,2619,938,38,33,71,53.5%,19m
27335,3,Ullumafullu,2619,853,35,44,79,44.3%,2m
27335,1,Loss,2619,835,30,32,62,48.4%,1h
27335,1,LAFAUCHEUSE,2619,649,22,27,49,44.9%,3m
27335,2,shagi,2619,380,14,11,25,56.0%,1h
27335,2,JimiHendrix,2619,190,14,12,26,53.8%,9m
27335,2,[ALOCH]someone,2619,356,13,13,26,50.0%,1h
27335,1,Sanches,2619,332,10,12,22,45.5%,17m
27335,1,Geschlossen,2619,266,8,11,19,42.1%,6m
27335,1,baltazard,2619,268,8,14,22,36.4%,59m
27335,1,Pangolin,2619,200,7,5,12,58.3%,3m
27335,2,MrSweterek,2619,269,7,8,15,46.7%,6m
27335,2,Naughty,2619,180,6,6,12,50.0%,19m
27335,1,pasha,2619,188,5,12,17,29.4%,1h
27335,2,Poukie,2619,146,4,7,11,36.4%,1h
27335,2,[RvdS]Opinel,2619,116,4,7,11,36.4%,1h
27335,1,MAR,2619,146,4,8,12,33.3%,1h
27335,1,GoDKaRaKaN,2619,116,4,9,13,30.8%,1h
27335,1,AlexandrV,2619,68,3,3,6,50.0%,1h
27335,3,тим,2619,0,3,4,7,42.9%,14m
27335,2,Kirito,2619,72,3,6,9,33.3%,5m
27335,2,DarkVoid,2619,30,2,0,2,100.0%,55m
27335,3,Alexius,2619,0,2,3,5,40.0%,1h
27335,2,Rui,2619,0,1,1,2,50.0%,1h
27335,2,levas,2619,32,1,5,6,16.7%,25m
27335,1,[scam0]UnoCarb,2619,0,1,8,9,11.1%,17m
27335,2,Jazda,2619,0,0,2,2,0.0%,1h
27335,2,PablitoMan,2619,0,0,2,2,0.0%,1h
27366,2,Vanber,2618,1651,394,380,774,50.9%,1h
27366,2,BomgMaster,2618,1284,259,247,506,51.2%,8m
27366,3,Rdu,2618,1555,187,183,370,50.5%,9m
27366,1,scherif,2618,513,81,65,146,55.5%,1h
27366,1,Xéus,2618,909,43,45,88,48.9%,12m
27366,1,[xGUZx]Baron,2618,907,41,38,79,51.9%,3m
27366,1,out,2618,912,40,44,84,47.6%,11m
27366,3,[MeDuS]barauskas,2618,1124,39,52,91,42.9%,13m
27366,1,IgorCastle,2618,670,24,25,49,49.0%,7m
27366,1,Gabija,2618,657,24,26,50,48.0%,6m
27366,1,AlexMDCI,2618,460,21,23,44,47.7%,12m
27366,3,postal,2618,491,19,24,43,44.2%,10m
27366,2,Malmoe,2618,259,17,14,31,54.8%,6m
27366,1,Xiigo,2618,263,16,13,29,55.2%,12m
27366,2,[7wonde]impact,2618,281,12,11,23,52.2%,9m
27366,1,colossus,2618,281,11,17,28,39.3%,22m
27366,2,Magnum,2618,180,10,9,19,52.6%,1h
27366,2,zealk,2618,142,6,9,15,40.0%,21m
27366,2,Hatoshin,2618,114,5,8,13,38.5%,10m
27366,2,Limeef,2618,136,4,0,4,100.0%,19m
27366,2,aZZaZZeLL,2618,102,4,4,8,50.0%,4m
27366,2,AFenix,2618,90,4,4,8,50.0%,19m
27366,3,[LMB]Kalahad,2618,121,3,4,7,42.9%,23m
27366,2,ZeRo,2618,0,2,2,4,50.0%,55m
27366,3,SiGnUM,2618,0,2,3,5,40.0%,1h
27366,2,SmokyPaprika,2618,0,0,1,1,0.0%,58m
27366,2,Karakurt,2618,0,0,1,1,0.0%,1h
27366,2,[gokuB]tomukas,2618,0,0,1,1,0.0%,1h
27366,2,муун,2618,0,0,1,1,0.0%,16m
27395,1,[Phun]Opperhoofd,2617,1120,171,157,328,52.1%,24m
27395,2,[ICrash]iCorio,2617,1443,83,71,154,53.9%,56m
27395,3,quackDuck,2617,803,69,71,140,49.3%,16m
27395,1,iLoveProtoss,2617,1367,67,60,127,52.8%,3m
27395,1,EpicFail,2617,1215,58,64,122,47.5%,1h
27395,2,DarkTRade,2617,1020,43,30,73,58.9%,23m
27395,2,[iPain]Decrepifier,2617,889,38,40,78,48.7%,1h
27395,3,Weedindahood,2617,507,34,39,73,46.6%,15m
27395,2,NoSmoking,2617,384,33,26,59,55.9%,1h
27395,2,OldTerran,2617,759,31,23,54,57.4%,56m
27395,1,LiziKomaz,2617,616,28,26,54,51.9%,1h
27395,2,ZergPower,2617,271,9,10,19,47.4%,1h
27395,2,Terawatts,2617,176,6,1,7,85.7%,1h
27395,2,cienias,2617,174,5,4,9,55.6%,1h
27395,2,Sibbotine,2617,120,5,5,10,50.0%,14m
27395,2,Destroyer,2617,122,4,6,10,40.0%,6m
27395,3,pizu,2617,0,3,2,5,60.0%,1h
27395,1,Toadboii,2617,142,3,2,5,60.0%,22m
27395,2,Duffenzag,2617,94,2,0,2,100.0%,21m
27395,2,[sp1r1t]GOstVladO,2617,30,2,2,4,50.0%,1h
27395,1,Shury,2617,96,2,3,5,40.0%,58m
27395,2,StoobyGacks,2617,0,2,3,5,40.0%,9m
27395,3,Дарион,2617,0,2,3,5,40.0%,23m
27395,1,NightCrawler,2617,118,2,6,8,25.0%,1h
27395,2,[RuPro]Ryzen,2617,0,1,0,1,100.0%,1h
27395,2,TVister,2617,0,1,0,1,100.0%,1h
27395,2,LosLosLos,2617,0,1,0,1,100.0%,25m
27395,1,[KMarks]Maximus,2617,0,1,1,2,50.0%,3m
27395,1,PunkDelight,2617,0,1,1,2,50.0%,1h
27395,2,Walkyrie,2617,30,1,2,3,33.3%,55m
27395,1,СССP,2617,0,1,2,3,33.3%,11m
27395,1,bashkan,2617,34,1,10,11,9.1%,23m
27395,3,PanAdam,2617,0,0,1,1,0.0%,59m
27395,1,Prago,2617,0,0,4,4,0.0%,1h
27429,1,FortySecond,2616,1629,199,184,383,52.0%,27m
27429,3,CaptainWank,2616,1493,95,95,190,50.0%,16m
27429,1,rumbi,2616,1627,74,69,143,51.7%,1h
27429,2,mazila,2616,1143,66,38,104,63.5%,19m
27429,2,Underdog,2616,500,20,21,41,48.8%,1h
27429,2,[QTcIub]DarkPrelate,2616,436,17,11,28,60.7%,22m
27429,1,[G4YoU]LingKing,2616,335,13,14,27,48.1%,7m
27429,3,Farfocel,2616,316,13,15,28,46.4%,25m
27429,2,Vak,2616,253,12,14,26,46.2%,23m
27429,1,[Koffie]DrGertMan,2616,370,11,15,26,42.3%,21m
27429,3,[VetM]FloW,2616,206,6,11,17,35.3%,11m
27429,2,Зamай,2616,150,5,0,5,100.0%,25m
27429,2,GrimsDottir,2616,167,5,3,8,62.5%,1h
27429,1,[GayPWR]Brutor,2616,128,5,6,11,45.5%,1h
27429,2,Chudilka,2616,154,5,6,11,45.5%,1h
27429,1,Bacon,2616,220,5,8,13,38.5%,1h
27429,2,Yeray,2616,30,4,2,6,66.7%,15m
27429,2,Sortus,2616,60,4,5,9,44.4%,1h
27429,1,[TTBBLL]iximini,2616,138,3,4,7,42.9%,17m
27429,2,Sensei,2616,60,2,3,5,40.0%,1h
27429,3,RatonPoeta,2616,0,2,3,5,40.0%,57m
27429,2,Nanovydra,2616,88,2,4,6,33.3%,23m
27429,3,JohnDoe,2616,0,1,0,1,100.0%,1h
27429,3,Daffy,2616,0,1,1,2,50.0%,57m
27429,2,olsandan,2616,30,1,2,3,33.3%,1h
27429,1,bean,2616,0,1,3,4,25.0%,16m
27429,3,Fantom,2616,0,0,1,1,0.0%,13m
27429,2,Lanttiks,2616,0,0,1,1,0.0%,2m
27429,2,[lDarkl]Смерть,2616,0,0,1,1,0.0%,9m
27429,2,Dark,2616,0,0,1,1,0.0%,19m
27429,1,[BRose]Arkuen,2616,0,0,5,5,0.0%,7m
27460,2,MLyoube,2615,881,109,84,193,56.5%,8m
27460,2,CaroCaronte,2615,838,79,56,135,58.5%,8m
27460,1,JEly,2615,1437,69,66,135,51.1%,1h
27460,1,Devil,2615,1392,55,46,101,54.5%,1h
27460,1,SayNoToStim,2615,783,31,31,62,50.0%,1h
27460,2,[W00F]PuppyDog,2615,421,30,43,73,41.1%,4m
27460,2,GagamelsRage,2615,365,17,15,32,53.1%,20m
27460,1,Orgulthar,2615,444,15,15,30,50.0%,1h
27460,2,SokoLishka,2615,236,9,7,16,56.2%,58m
27460,2,[lolw0t]Harlequinok,2615,242,8,6,14,57.1%,1h
27460,1,frank,2615,238,8,11,19,42.1%,1h
27460,1,[HOMM3]sorinescoven,2615,227,7,6,13,53.8%,58m
27460,2,SicItur,2615,142,7,6,13,53.8%,1h
27460,1,WhoRlyCares,2615,189,5,9,14,35.7%,1h
27460,1,ccdrik,2615,64,4,3,7,57.1%,1h
27460,1,[Няшкa]Apollo,2615,114,4,5,9,44.4%,7m
27460,1,[5BC]PUDONG,2615,106,4,7,11,36.4%,1h
27460,2,[TBRow]Hussar,2615,86,3,5,8,37.5%,1h
27460,1,Dinkalo,2615,114,3,10,13,23.1%,1h
27460,2,Fritzzzz,2615,58,2,3,5,40.0%,1h
27460,3,Patrol,2615,0,2,3,5,40.0%,1h
27460,3,Nikas,2615,0,2,3,5,40.0%,6m
27460,1,uNiT,2615,118,2,4,6,33.3%,1h
27460,1,[prrr]MantisPrawn,2615,0,2,4,6,33.3%,6m
27460,2,BloodyLMate,2615,30,1,2,3,33.3%,1h
27460,2,Feanor,2615,30,1,2,3,33.3%,16m
27460,1,[AciNoN]HungrySnake,2615,38,1,6,7,14.3%,1h
27460,3,Ido,2615,0,0,1,1,0.0%,6m
27460,2,[GLTD]Kartoffe,2615,0,0,1,1,0.0%,1h
27460,2,QuEZz,2615,0,0,1,1,0.0%,5m
27460,2,Viktor,2615,0,0,1,1,0.0%,1h
27460,2,ChillWars,2615,0,0,1,1,0.0%,25m
27460,2,storm,2615,0,0,2,2,0.0%,1h
27460,3,Calt,2615,0,0,2,2,0.0%,6m
27460,1,DoDo,2615,0,0,5,5,0.0%,12m
27495,3,zeezdk,2614,1517,158,158,316,50.0%,5m
27495,3,KdM,2614,1349,113,110,223,50.7%,10m
27495,1,neurodeep,2614,1445,66,66,132,50.0%,55m
27495,1,Nashki,2614,482,25,31,56,44.6%,11m
27495,1,Tigris,2614,436,15,18,33,45.5%,20m
27495,2,Vovastr,2614,332,11,10,21,52.4%,14m
27495,2,Mithrandir,2614,212,9,6,15,60.0%,9m
27495,1,DevilPlague,2614,284,8,10,18,44.4%,1h
27495,1,Caracas,2614,237,8,11,19,42.1%,11m
27495,2,koboldmorder,2614,179,7,2,9,77.8%,58m
27495,1,Taxie,2614,196,6,5,11,54.5%,1h
27495,2,Vovvvvan,2614,149,6,7,13,46.2%,1h
27495,1,TGS,2614,214,6,11,17,35.3%,20m
27495,2,[AESC]TOANE,2614,0,4,8,12,33.3%,1h
27495,2,Arren,2614,88,3,3,6,50.0%,19m
27495,2,chanandalar,2614,0,3,6,9,33.3%,8m
27495,2,[Someth]GloveDart,2614,30,2,1,3,66.7%,1h
27495,2,[film]ghosten,2614,48,2,2,4,50.0%,1h
27495,2,Destroyer,2614,42,2,2,4,50.0%,1h
27495,1,Slâve,2614,0,2,3,5,40.0%,1h
27495,2,Alch,2614,60,2,5,7,28.6%,25m
27495,2,[БОДУН]Cemerset,2614,0,1,0,1,100.0%,1h
27495,2,matiBTC,2614,0,1,0,1,100.0%,16m
27495,2,nofa,2614,91,1,1,2,50.0%,25m
27495,3,frlswe,2614,0,1,4,5,20.0%,27m
27495,2,[Kpa6]HiLs,2614,0,0,1,1,0.0%,56m
27495,2,[INDSFT]NateTheRiver,2614,0,0,1,1,0.0%,16m
27495,2,[MSR]huebabbl,2614,0,0,2,2,0.0%,1h
27523,1,MAX,2613,1599,137,137,274,50.0%,14m
27523,2,JogusMagnus,2613,1323,85,71,156,54.5%,1h
27523,1,imba,2613,864,53,34,87,60.9%,8m
27523,1,[Moped]mostafarai,2613,808,42,31,73,57.5%,1h
27523,3,Ryper,2613,1057,41,50,91,45.1%,14m
27523,2,vaskooo,2613,873,39,28,67,58.2%,1h
27523,1,Mudalisk,2613,972,37,30,67,55.2%,23m
27523,2,[PolKot]Vieon,2613,749,34,33,67,50.7%,1h
27523,2,[Aslan]DeltaPhi,2613,796,30,31,61,49.2%,56m
27523,2,[Adlscø]Morpheam,2613,372,16,7,23,69.6%,56m
27523,2,[CØG]bouclier,2613,240,9,5,14,64.3%,1h
27523,1,Yanoo,2613,244,7,13,20,35.0%,25m
27523,2,Gosu,2613,188,6,3,9,66.7%,5m
27523,1,[PLA2N]LuckyFox,2613,206,6,13,19,31.6%,1h
27523,2,dam,2613,156,5,8,13,38.5%,23m
27523,3,Sourveg,2613,48,4,5,9,44.4%,18m
27523,1,OatlyToad,2613,129,4,6,10,40.0%,1h
27523,1,ckywill,2613,70,3,5,8,37.5%,4m
27523,2,HepHaistos,2613,86,3,5,8,37.5%,1h
27523,2,[DG5500]Maxiste,2613,114,3,5,8,37.5%,1h
27523,2,[Bknip]onCrystal,2613,95,3,5,8,37.5%,24m
27523,1,Bulan,2613,108,3,7,10,30.0%,1h
27523,1,JenKO,2613,140,3,11,14,21.4%,1h
27523,2,[SPHTRS]gabriel,2613,94,2,1,3,66.7%,3m
27523,2,DarknessLord,2613,0,2,5,7,28.6%,1h
27523,1,Akeem,2613,0,1,0,1,100.0%,17m
27523,2,Cha,2613,0,1,0,1,100.0%,55m
27523,2,[Keulen]EuroIVDiesel,2613,0,1,1,2,50.0%,1h
27523,2,RuBICoN,2613,32,1,2,3,33.3%,24m
27523,2,Jean,2613,46,1,6,7,14.3%,24m
27523,2,KinGGniK,2613,0,0,1,1,0.0%,1h
27523,2,ФАРАОН,2613,0,0,1,1,0.0%,14m
27523,1,spoke,2613,0,0,2,2,0.0%,15m
27556,2,Ben,2612,1330,60,53,113,53.1%,17m
27556,2,PsychoSRL,2612,688,49,48,97,50.5%,8m
27556,3,Dubydubsauce,2612,723,43,39,82,52.4%,3m
27556,3,[JJBZ]LawnMower,2612,791,43,55,98,43.9%,23m
27556,1,[GIS9]Rhizom,2612,534,17,26,43,39.5%,21m
27556,2,[TLGC]JiuZaa,2612,195,11,6,17,64.7%,14m
27556,1,jussQC,2612,268,10,10,20,50.0%,17m
27556,2,Bnkyo,2612,302,10,13,23,43.5%,2m
27556,2,Portlander,2612,206,8,5,13,61.5%,1h
27556,2,crusty,2612,180,7,6,13,53.8%,1h
27556,1,Silver,2612,106,5,7,12,41.7%,1h
27556,1,[GRobot]WERTY,2612,186,5,13,18,27.8%,1h
27556,2,barkley,2612,95,4,6,10,40.0%,1h
27556,2,FeAr,2612,151,4,8,12,33.3%,1h
27556,1,Mirda,2612,236,4,9,13,30.8%,2m
27556,2,Overlord,2612,58,3,1,4,75.0%,1h
27556,3,[gfxXx]Scharbe,2612,97,3,2,5,60.0%,7m
27556,3,Akashi,2612,0,3,3,6,50.0%,9m
27556,3,Makcint,2612,97,3,4,7,42.9%,1h
27556,3,AleX,2612,97,2,0,2,100.0%,1h
27556,3,Vertical,2612,133,2,1,3,66.7%,1h
27556,1,Verzila,2612,118,2,2,4,50.0%,1h
27556,3,emiliano,2612,0,2,2,4,50.0%,15m
27556,1,izzonu,2612,0,2,3,5,40.0%,55m
27556,2,Ricksanchez,2612,58,2,4,6,33.3%,1h
27556,2,[ЗИБиАГ]Shazum,2612,0,1,0,1,100.0%,1h
27556,2,Tbroco,2612,0,1,0,1,100.0%,1h
27556,2,[BounP]Sen,2612,0,1,1,2,50.0%,1h
27556,1,Pepinmalin,2612,0,1,3,4,25.0%,18m
27556,2,Sergey,2612,0,0,1,1,0.0%,1h
27556,3,Yalos,2612,0,0,1,1,0.0%,6m
27556,3,upijay,2612,0,0,1,1,0.0%,1h
27556,1,ilikeladies,2612,0,0,5,5,0.0%,1h
27589,2,lyra,2611,1442,248,230,478,51.9%,9m
27589,3,[PPF]Taz,2611,1094,205,199,404,50.7%,8m
27589,2,Евгений,2611,1318,133,130,263,50.6%,3m
27589,2,Shaddo,2611,1448,77,79,156,49.4%,1h
27589,2,[HZeS]vernov,2611,1047,55,44,99,55.6%,1h
27589,3,[CxCx]MARYNOMORE,2611,1280,49,59,108,45.4%,22m
27589,1,Strahu,2611,1180,39,45,84,46.4%,11m
27589,2,Durenord,2611,849,33,29,62,53.2%,2m
27589,2,SneakyAlex,2611,740,32,23,55,58.2%,55m
27589,2,Eran,2611,557,31,4,35,88.6%,1h
27589,1,[HoboMT]HappyIzrod,2611,502,20,19,39,51.3%,1h
27589,3,YurgenDnepr,2611,602,20,33,53,37.7%,5m
27589,1,Samoor,2611,401,17,20,37,45.9%,3m
27589,2,[NWGD]Aqua,2611,418,16,9,25,64.0%,1h
27589,2,Solevita,2611,354,15,6,21,71.4%,1h
27589,2,[TZD]ethEreal,2611,336,14,6,20,70.0%,14m
27589,1,DiGrizz,2611,430,13,14,27,48.1%,12m
27589,1,Mushu,2611,362,12,12,24,50.0%,6m
27589,2,Vadim,2611,253,11,5,16,68.8%,27m
27589,2,Slexis,2611,250,9,7,16,56.2%,1h
27589,1,Rathur,2611,208,7,8,15,46.7%,1h
27589,2,Superskills,2611,114,5,3,8,62.5%,58m
27589,2,[PT2X]Buell,2611,150,5,4,9,55.6%,1h
27589,2,JulHun,2611,46,3,6,9,33.3%,1h
27589,2,LittleYogik,2611,60,2,3,5,40.0%,20m
27589,2,akatsushi,2611,88,2,4,6,33.3%,8m
27589,2,mediasprawl,2611,0,1,0,1,100.0%,1h
27589,2,kamernyid,2611,88,1,1,2,50.0%,1h
27589,2,titanix,2611,30,1,2,3,33.3%,1h
27589,1,vladddddd,2611,0,1,3,4,25.0%,4m
27589,3,Lrawens,2611,0,1,5,6,16.7%,1h
27620,3,RedTea,2610,849,103,94,197,52.3%,23m
27620,2,RemyLacoste,2610,1315,82,66,148,55.4%,1h
27620,2,Andi,2610,808,57,54,111,51.4%,6m
27620,1,Fullliare,2610,886,52,45,97,53.6%,14m
27620,1,[FGYT]Wiviiides,2610,1151,44,41,85,51.8%,1h
27620,1,[Hаsu]Mazur,2610,1087,43,39,82,52.4%,1h
27620,2,Master,2610,512,21,23,44,47.7%,1h
27620,1,DappeR,2610,555,19,23,42,45.2%,20m
27620,2,Karsten,2610,432,17,17,34,50.0%,1h
27620,2,WurzelSepp,2610,278,11,5,16,68.8%,14m
27620,2,RayRayRay,2610,312,11,10,21,52.4%,1h
27620,1,Malady,2610,290,9,13,22,40.9%,3m
27620,3,Zimgrek,2610,193,7,10,17,41.2%,23m
27620,1,[EnGySC]aranarth,2610,255,6,11,17,35.3%,18m
27620,3,Kalko,2610,128,5,7,12,41.7%,4m
27620,2,[ThSons]STEEL,2610,90,4,3,7,57.1%,9m
27620,1,LNR,2610,211,4,6,10,40.0%,20m
27620,2,Konan,2610,0,3,2,5,60.0%,2m
27620,3,[CCN]pticul,2610,121,3,4,7,42.9%,59m
27620,1,[NvBD]Starwings,2610,0,3,6,9,33.3%,59m
27620,1,Zjawa,2610,154,3,7,10,30.0%,7m
27620,2,[MTI1]BjSabirov,2610,30,2,1,3,66.7%,20m
27620,1,KalanA,2610,36,2,3,5,40.0%,23m
27620,2,[PowerG]MatexSK,2610,32,1,1,2,50.0%,4m
27620,2,Glazz,2610,0,0,2,2,0.0%,1h
27620,2,Жекичан,2610,0,0,2,2,0.0%,25m
27620,2,DreadTrooper,2610,0,0,2,2,0.0%,22m
27620,1,[NOXs]Cloud,2610,0,0,5,5,0.0%,23m
27648,2,aksed,2609,1277,84,75,159,52.8%,1h
27648,1,Eldoratto,2609,1307,74,66,140,52.9%,1h
27648,3,CloudOctave,2609,1469,65,72,137,47.4%,11m
27648,2,[NLTN]wdrk,2609,1082,44,38,82,53.7%,25m
27648,2,SeBB,2609,282,39,34,73,53.4%,1h
27648,2,Dendis,2609,716,31,18,49,63.3%,55m
27648,1,Nick,2609,780,30,30,60,50.0%,1h
27648,1,Morgoth,2609,491,19,37,56,33.9%,20m
27648,2,Zahid,2609,420,14,12,26,53.8%,1h
27648,2,Heurys,2609,305,11,5,16,68.8%,15m
27648,3,[SCiE]LEOKA,2609,257,11,11,22,50.0%,14m
27648,2,fatfa,2609,239,10,8,18,55.6%,1h
27648,2,Callboy,2609,169,7,6,13,53.8%,5m
27648,2,Shoop,2609,202,6,4,10,60.0%,27m
27648,3,MohawK,2609,60,6,9,15,40.0%,1h
27648,3,kazik,2609,30,4,6,10,40.0%,4m
27648,2,LovkiZerg,2609,38,2,1,3,66.7%,11m
27648,2,[MoTeam]Ratshoot,2609,0,2,3,5,40.0%,1h
27648,2,[EUww1]FredrikUK,2609,62,2,3,5,40.0%,1h
27648,2,[SCSEU]BenBytes,2609,0,1,0,1,100.0%,1h
27648,1,zOne,2609,94,1,2,3,33.3%,1h
27648,1,RUSDDSS,2609,34,1,5,6,16.7%,3m
27648,1,[THINK]Eska,2609,40,1,8,9,11.1%,5m
27648,3,Khankki,2609,0,0,1,1,0.0%,1h
27648,2,[KGSC2]PrimeStar,2609,0,0,2,2,0.0%,1h
27648,2,[RIOJA]asusjames,2609,0,0,2,2,0.0%,1h
27648,2,Oniichan,2609,0,0,2,2,0.0%,1h
27648,2,Maarrk,2609,0,0,4,4,0.0%,1h
27648,2,Kinch,2609,0,0,4,4,0.0%,1h
27677,1,kate,2608,1518,136,112,248,54.8%,1h
27677,2,[MaSiYa]Othello,2608,1429,105,97,202,52.0%,1h
27677,1,Tomster,2608,1650,96,99,195,49.2%,1h
27677,3,Richie,2608,1510,81,76,157,51.6%,21m
27677,1,Skydiver,2608,1412,59,55,114,51.8%,4m
27677,2,[Z3nA]iDrA,2608,884,48,51,99,48.5%,4m
27677,2,Noname,2608,1009,47,35,82,57.3%,1h
27677,2,Marv,2608,651,26,26,52,50.0%,1h
27677,3,sash,2608,555,24,34,58,41.4%,3m
27677,2,Gerondil,2608,572,23,16,39,59.0%,1h
27677,1,Cirlu,2608,624,20,24,44,45.5%,58m
27677,2,Elijah,2608,419,19,7,26,73.1%,57m
27677,1,Warcloud,2608,363,15,19,34,44.1%,1h
27677,2,Hugo,2608,273,13,11,24,54.2%,2m
27677,2,zannall,2608,390,13,17,30,43.3%,1h
27677,1,TitoRobert,2608,356,12,11,23,52.2%,57m
27677,1,Odyssey,2608,294,10,10,20,50.0%,1h
27677,2,[C00I]Teron,2608,378,10,14,24,41.7%,19m
27677,1,VoidWanderer,2608,298,9,8,17,52.9%,1h
27677,2,TheRusher,2608,282,9,10,19,47.4%,23m
27677,1,Aaaaaaaaaaa,2608,256,8,14,22,36.4%,23m
27677,2,[GURKI]Homunculus,2608,154,6,7,13,46.2%,3m
27677,2,[BWArmy]GABY,2608,160,5,1,6,83.3%,26m
27677,1,DanteJusTesT,2608,209,5,5,10,50.0%,11m
27677,2,[RoxtaR]megavit,2608,90,4,3,7,57.1%,8m
27677,2,imnub,2608,86,4,3,7,57.1%,1h
27677,2,[InfTy]pahl,2608,58,3,2,5,60.0%,59m
27677,2,[qip]БогМикро,2608,96,3,2,5,60.0%,55m
27677,2,Leon,2608,32,2,3,5,40.0%,1h
27677,2,IIIIIIIIIIII,2608,0,2,3,5,40.0%,5m
27677,2,Deadline,2608,0,2,3,5,40.0%,25m
27677,1,Spartan,2608,0,2,6,8,25.0%,6m
27677,3,Londo,2608,0,1,0,1,100.0%,7m
27677,2,KRYack,2608,0,1,1,2,50.0%,1h
27711,3,Robotta,2607,1523,397,391,788,50.4%,2m
27711,2,[SSFR]Chronos,2607,1476,240,244,484,49.6%,8m
27711,3,SirLancevrot,2607,1383,163,149,312,52.2%,23m
27711,2,Marshakk,2607,1501,91,72,163,55.8%,58m
27711,1,pumpel,2607,1605,87,82,169,51.5%,59m
27711,2,SCVReady,2607,300,31,18,49,63.3%,16m
27711,2,Zedicus,2607,494,19,20,39,48.7%,1h
27711,2,[AGBF]Byrtoszz,2607,335,15,5,20,75.0%,14m
27711,2,Falmeer,2607,326,15,10,25,60.0%,1h
27711,1,Sapiens,2607,410,13,19,32,40.6%,1h
27711,1,lior,2607,247,11,8,19,57.9%,3m
27711,3,[ROFG]AnatoliyNoha,2607,251,8,8,16,50.0%,1h
27711,1,GOOSE,2607,280,8,14,22,36.4%,1h
27711,2,Berzingue,2607,142,6,4,10,60.0%,20m
27711,1,Misciu,2607,192,6,9,15,40.0%,19m
27711,2,[Казах]Bomberman,2607,150,5,5,10,50.0%,1h
27711,2,Alchemik,2607,137,4,5,9,44.4%,55m
27711,2,Kyorts,2607,86,4,5,9,44.4%,16m
27711,3,Maple,2607,0,3,3,6,50.0%,9m
27711,2,CanelaMolida,2607,0,2,5,7,28.6%,1h
27711,1,Piwey,2607,42,2,6,8,25.0%,23m
27711,2,gera,2607,0,1,1,2,50.0%,1h
27711,2,Atoss,2607,0,1,4,5,20.0%,1h
27711,3,SilentRain,2607,0,0,1,1,0.0%,1h
27711,2,[BloTi]Rengo,2607,0,0,1,1,0.0%,1h
27711,1,YoloXKoala,2607,0,0,2,2,0.0%,1h
27737,3,Orca,2606,695,132,135,267,49.4%,23m
27737,2,Parf,2606,1489,120,122,242,49.6%,13m
27737,1,Donnerherz,2606,1608,113,111,224,50.4%,23m
27737,2,[PParty]Plamenniy,2606,1624,98,83,181,54.1%,9m
27737,3,[Esply]EsplyEd,2606,1475,75,74,149,50.3%,8m
27737,1,Ephe,2606,1662,69,68,137,50.4%,1h
27737,1,dompiche,2606,1533,57,54,111,51.4%,23m
27737,2,SonicLaruth,2606,550,24,20,44,54.5%,1h
27737,1,Scorpio,2606,446,19,14,33,57.6%,12m
27737,1,RalfRübe,2606,505,19,19,38,50.0%,1h
27737,2,klocu,2606,393,16,13,29,55.2%,27m
27737,2,[Kaffee]Schimpanze,2606,331,12,8,20,60.0%,5m
27737,2,FasBenDeR,2606,293,11,5,16,68.8%,3m
27737,2,[DSMA]PetitLaurent,2606,208,7,3,10,70.0%,9m
27737,2,BrilleHankat,2606,150,6,7,13,46.2%,1h
27737,2,Shefutinskiy,2606,164,5,1,6,83.3%,1h
27737,3,alexlysikov,2606,30,5,5,10,50.0%,12m
27737,3,DadoTheKing,2606,120,4,6,10,40.0%,10m
27737,2,ILLICH,2606,58,3,0,3,100.0%,24m
27737,2,[MLFCG]fran,2606,86,3,3,6,50.0%,16m
27737,2,Mido,2606,88,3,5,8,37.5%,58m
27737,2,Gekson,2606,34,2,2,4,50.0%,1h
27737,1,Moriartik,2606,0,2,3,5,40.0%,5m
27737,2,Mamon,2606,0,1,0,1,100.0%,1h
27737,2,[TSC69]Comrade,2606,40,1,1,2,50.0%,24m
27737,1,Kuzziv,2606,95,1,3,4,25.0%,1h
27737,1,DVHDanii,2606,30,1,5,6,16.7%,60m
27737,2,Kerenos,2606,0,0,1,1,0.0%,1h
27737,2,AngryCroatia,2606,0,0,1,1,0.0%,19m
27737,2,SnowMonkey,2606,0,0,2,2,0.0%,11m
27737,2,Piopiotte,2606,0,0,3,3,0.0%,1h
27737,2,[PrimeC]AKpRo,2606,0,0,6,6,0.0%,1h
27769,2,Кейран,2605,1584,114,121,235,48.5%,1h
27769,2,лананечеч,2605,1361,110,104,214,51.4%,1h
27769,1,SaSsergeich,2605,1086,69,63,132,52.3%,1h
27769,1,KeuperMarlue,2605,1605,65,70,135,48.1%,1h
27769,2,Vaggos,2605,862,37,21,58,63.8%,55m
27769,2,Zephyrus,2605,565,36,32,68,52.9%,5m
27769,2,[Zhig]Cheif,2605,573,29,11,40,72.5%,1h
27769,1,[tetguy]Gamygym,2605,451,18,19,37,48.6%,10m
27769,1,Yigit,2605,455,14,16,30,46.7%,1h
27769,1,Dalus,2605,366,11,12,23,47.8%,1h
27769,1,mythos,2605,262,9,9,18,50.0%,26m
27769,2,MrSteelEggs,2605,235,6,5,11,54.5%,23m
27769,2,[ƮESacm]cabo,2605,154,6,9,15,40.0%,9m
27769,2,Graf,2605,172,5,5,10,50.0%,1h
27769,3,Raynor,2605,130,5,16,21,23.8%,19m
27769,2,MatYs,2605,128,4,4,8,50.0%,1h
27769,2,[MrKing]Mryarking,2605,129,3,0,3,100.0%,1h
27769,2,Raycor,2605,60,3,1,4,75.0%,1h
27769,1,Pleticosa,2605,104,3,3,6,50.0%,1h
27769,1,ToniRdz,2605,0,3,6,9,33.3%,1h
27769,2,Hugnettin,2605,30,2,3,5,40.0%,4m
27769,1,Negurk,2605,0,2,4,6,33.3%,1h
27769,1,[OAG]luckyluck,2605,0,1,1,2,50.0%,3m
27769,1,Ragnarson,2605,42,1,1,2,50.0%,3m
27769,2,Medium,2605,0,0,1,1,0.0%,1h
27769,2,xenocombo,2605,0,0,1,1,0.0%,16m
27769,1,[7wonde]Lithium,2605,0,0,7,7,0.0%,1h
27796,2,SierraSierra,2604,1589,171,158,329,52.0%,20m
27796,3,drCeucc,2604,1256,97,95,192,50.5%,20m
27796,1,snickersen,2604,1504,81,80,161,50.3%,1h
27796,2,[CОS]innoVation,2604,1330,68,23,91,74.7%,20m
27796,1,Basil,2604,1565,64,53,117,54.7%,16m
27796,3,[BjwA]prophet,2604,654,23,32,55,41.8%,19m
27796,2,[TmNVDA]DJaX,2604,321,15,1,16,93.8%,1h
27796,3,Wedzzz,2604,326,11,12,23,47.8%,15m
27796,2,Revi,2604,178,7,7,14,50.0%,23m
27796,3,MURZILKA,2604,272,7,18,25,28.0%,23m
27796,2,BigKIK,2604,154,6,6,12,50.0%,1h
27796,2,SweetCreator,2604,152,6,6,12,50.0%,1h
27796,1,GES,2604,212,6,12,18,33.3%,1h
27796,2,ALEXEY,2604,104,4,4,8,50.0%,1h
27796,2,Quimby,2604,125,3,4,7,42.9%,2m
27796,1,OhneHöschen,2604,94,3,5,8,37.5%,1h
27796,1,Lokvakor,2604,54,3,5,8,37.5%,1h
27796,2,IzIOne,2604,0,3,5,8,37.5%,1h
27796,1,jano,2604,66,3,8,11,27.3%,25m
27796,2,Frigate,2604,30,2,1,3,66.7%,1h
27796,2,GreatChief,2604,58,2,3,5,40.0%,6m
27796,2,Marec,2604,0,2,3,5,40.0%,17m
27796,3,[EliteX]Romanoos,2604,0,2,7,9,22.2%,2m
27796,2,[VetM]charoo,2604,0,1,0,1,100.0%,1h
27796,2,PrinceAli,2604,30,1,1,2,50.0%,1h
27796,1,Nicknamed,2604,0,1,5,6,16.7%,3m
27796,2,[THANOS]RAYMANKAPEEN,2604,0,0,1,1,0.0%,1h
27796,2,[ЛНС]люрр,2604,0,0,1,1,0.0%,1h
27796,2,Yuraya,2604,0,0,1,1,0.0%,16m
27796,1,Fenrir,2604,0,0,1,1,0.0%,21m
27796,3,Khyrek,2604,0,0,1,1,0.0%,1h
27796,2,NudeDude,2604,0,0,5,5,0.0%,19m
27828,2,hamilyon,2603,1305,150,148,298,50.3%,14m
27828,3,CameronPo,2603,1551,140,148,288,48.6%,16m
27828,2,[OmDi]ALShep,2603,1600,125,101,226,55.3%,2m
27828,1,Rogba,2603,1222,117,109,226,51.8%,1h
27828,1,ElusiVe,2603,1476,103,98,201,51.2%,1h
27828,1,[sacros]Jost,2603,1148,50,44,94,53.2%,5m
27828,2,[M4K]gravity,2603,991,42,32,74,56.8%,4m
27828,2,Flatulencio,2603,367,32,25,57,56.1%,1h
27828,2,XantiXae,2603,754,31,24,55,56.4%,1h
27828,1,kostorez,2603,565,29,32,61,47.5%,1h
27828,2,happyrouge,2603,725,28,21,49,57.1%,1h
27828,2,[БЕШУСЬ]amadeika,2603,582,21,17,38,55.3%,26m
27828,2,Vagonweel,2603,344,15,11,26,57.7%,1h
27828,2,Julo,2603,366,12,15,27,44.4%,1h
27828,1,Meech,2603,245,8,12,20,40.0%,10m
27828,2,PsyDuck,2603,172,7,9,16,43.8%,1h
27828,1,LazyWarlock,2603,220,7,11,18,38.9%,1h
27828,2,Freeks,2603,116,5,4,9,55.6%,1h
27828,2,[MST]MiksteR,2603,116,5,8,13,38.5%,4m
27828,2,MrExziST,2603,86,4,1,5,80.0%,57m
27828,2,Denteck,2603,168,4,3,7,57.1%,14m
27828,2,[TwoS]Klein,2603,0,3,2,5,60.0%,15m
27828,1,[Peeps]Noitcereon,2603,161,3,3,6,50.0%,26m
27828,3,[London]SlapTrick,2603,0,2,4,6,33.3%,1h
27828,1,[LQV]Sanguine,2603,82,2,11,13,15.4%,4m
27828,3,[FIB153]TartanComa,2603,0,1,0,1,100.0%,1h
27828,2,[KTQ]Lasvadril,2603,0,1,0,1,100.0%,17m
27828,1,Sanya,2603,0,0,1,1,0.0%,3m
27828,3,[ttd13]Archevêque,2603,0,0,1,1,0.0%,1h
27828,2,[Chocen]Feth,2603,0,0,3,3,0.0%,1h
27858,2,Rico,2602,1596,568,564,1132,50.2%,1h
27858,3,[xZero]joje,2602,1434,181,178,359,50.4%,12m
27858,1,[Petrиs]scargot,2602,1189,106,107,213,49.8%,21m
27858,1,misterpachis,2602,987,50,38,88,56.8%,1h
27858,1,[JINX]Macky,2602,954,47,37,84,56.0%,1h
27858,1,szewcu,2602,1179,45,48,93,48.4%,1h
27858,1,[KG312]Roy,2602,765,30,24,54,55.6%,12m
27858,2,NickR,2602,475,30,31,61,49.2%,2m
27858,1,[PiGPan]Conzy,2602,629,21,21,42,50.0%,18m
27858,3,Shortie,2602,480,19,24,43,44.2%,2m
27858,2,JetFire,2602,374,15,9,24,62.5%,15m
27858,1,[KEKSA]Wladca,2602,165,11,12,23,47.8%,21m
27858,1,blannti,2602,317,11,12,23,47.8%,1h
27858,2,[Sfi]AquaPhil,2602,238,9,12,21,42.9%,1h
27858,2,[IGSq]Wolverine,2602,174,7,7,14,50.0%,6m
27858,2,Karakondjol,2602,190,6,3,9,66.7%,1h
27858,2,OrtemEbosher,2602,146,5,8,13,38.5%,1h
27858,2,крабик,2602,140,4,4,8,50.0%,1h
27858,1,OOOOOOOOO,2602,94,3,5,8,37.5%,27m
27858,2,Xey,2602,48,3,6,9,33.3%,1h
27858,1,Marsik,2602,88,2,6,8,25.0%,20m
27858,2,Vancraft,2602,0,1,0,1,100.0%,58m
27858,2,George,2602,0,1,0,1,100.0%,20m
27858,2,[DET54]Batlegase,2602,0,1,0,1,100.0%,1h
27858,3,Skatje,2602,0,1,0,1,100.0%,2m
27858,2,Maxwell,2602,88,1,1,2,50.0%,1h
27858,1,[LCG]LCGBraveGAG,2602,40,1,4,5,20.0%,1h
27858,1,noLoki,2602,36,1,7,8,12.5%,20m
27858,1,MORPHINE,2602,0,0,1,1,0.0%,59m
27858,2,martin,2602,0,0,1,1,0.0%,1h
27888,3,Tigrit,2601,1441,190,195,385,49.4%,16m
27888,2,DaveDC,2601,1542,163,160,323,50.5%,26m
27888,2,Thep,2601,1405,153,129,282,54.3%,1h
27888,2,TheAlmighty,2601,1442,106,87,193,54.9%,1h
27888,3,spaermiosis,2601,802,99,81,180,55.0%,4m
27888,1,Yospartacus,2601,1617,74,68,142,52.1%,16m
27888,2,Alpejczyk,2601,1343,60,52,112,53.6%,25m
27888,2,Kianst,2601,603,53,45,98,54.1%,20m
27888,1,JoLaTenaille,2601,1348,51,49,100,51.0%,19m
27888,1,Artistic,2601,1202,49,41,90,54.4%,16m
27888,3,Tété,2601,975,37,48,85,43.5%,16m
27888,2,[ƈG]Tossah,2601,231,32,18,50,64.0%,1h
27888,1,TheZoher,2601,594,27,29,56,48.2%,1h
27888,2,[ConFed]voyTECH,2601,362,14,14,28,50.0%,1h
27888,1,Алекс,2601,452,13,19,32,40.6%,5m
27888,2,DTC,2601,387,12,18,30,40.0%,24m
27888,2,Pferdezahn,2601,263,10,10,20,50.0%,1h
27888,2,MrLoverLover,2601,292,10,10,20,50.0%,1h
27888,1,Sekz,2601,130,4,8,12,33.3%,20m
27888,2,Киригами,2601,92,3,6,9,33.3%,20m
27888,2,atreyu,2601,149,3,6,9,33.3%,20m
27888,2,[ZCORP]Brumlito,2601,38,2,1,3,66.7%,26m
27888,2,Тоха,2601,0,2,3,5,40.0%,16m
27888,2,turbotax,2601,88,2,4,6,33.3%,55m
27888,1,Mavco,2601,76,2,9,11,18.2%,1h
27888,2,Warden,2601,0,1,0,1,100.0%,25m
27888,3,Ripper,2601,0,1,0,1,100.0%,1h
27888,2,Motorolcka,2601,0,1,0,1,100.0%,15m
27888,2,JOHNBOY,2601,88,1,1,2,50.0%,4m
27888,2,[Jabol]Wodzu,2601,0,1,3,4,25.0%,1h
27888,2,[bqobd]nik,2601,0,0,1,1,0.0%,9m
27888,2,Missclick,2601,0,0,1,1,0.0%,1h
27888,2,Dragon,2601,0,0,1,1,0.0%,1h
27888,2,Bananaboy,2601,0,0,3,3,0.0%,1h
27922,1,BorisThBlade,2600,1660,127,132,259,49.0%,7m
27922,1,Mageguy,2600,618,112,93,205,54.6%,1h
27922,1,[8lllD]MrLemon,2600,818,59,82,141,41.8%,11m
27922,2,Bloodwake,2600,959,58,40,98,59.2%,1h
27922,1,Bliss,2600,1441,53,54,107,49.5%,1h
27922,3,[BIGGIE]piyuyo,2600,966,39,47,86,45.3%,6m
27922,2,[DiRE]YouRock,2600,675,30,23,53,56.6%,1h
27922,2,MacAndCheese,2600,454,19,23,42,45.2%,1h
27922,2,Hunken,2600,392,14,13,27,51.9%,1h
27922,2,Dsolarte,2600,231,10,2,12,83.3%,19m
27922,3,KungFlu,2600,243,9,13,22,40.9%,23m
27922,2,AleyTheFairy,2600,194,7,8,15,46.7%,55m
27922,2,Satellite,2600,174,6,2,8,75.0%,1h
27922,2,tovarm,2600,184,6,3,9,66.7%,1h
27922,2,Hellosveiki,2600,150,5,9,14,35.7%,1h
27922,2,Illumiknight,2600,86,4,4,8,50.0%,27m
27922,2,MSCINDER,2600,118,4,8,12,33.3%,58m
27922,3,Niki,2600,97,3,4,7,42.9%,1h
27922,2,npyt,2600,90,3,6,9,33.3%,4m
27922,1,nahLLL,2600,94,3,6,9,33.3%,7m
27922,1,Freshman,2600,0,3,9,12,25.0%,26m
27922,2,[SsRg]cloudlar,2600,32,2,2,4,50.0%,1h
27922,1,Plman,2600,97,2,4,6,33.3%,16m
27922,3,Katsuno,2600,42,1,4,5,20.0%,57m
27922,2,DeSmall,2600,0,1,5,6,16.7%,2m
27922,2,[SPAINs]Avefenix,2600,0,0,1,1,0.0%,1h
27922,2,Brooklyn,2600,0,0,2,2,0.0%,2m
27922,2,aurapanthere,2600,0,0,4,4,0.0%,1h
27950,3,trp,2599,1532,333,335,668,49.9%,11m
27950,2,[BOT27]TomiJJ,2599,1335,51,63,114,44.7%,15m
27950,2,[NO6F]Bushy,2599,1069,45,40,85,52.9%,4m
27950,1,Rabitibike,2599,875,35,30,65,53.8%,19m
27950,2,ironXVII,2599,611,23,25,48,47.9%,56m
27950,3,Monk,2599,664,23,30,53,43.4%,2m
27950,2,Damagaming,2599,556,21,18,39,53.8%,17m
27950,2,LLuisYK,2599,480,17,19,36,47.2%,1h
27950,2,tsramzay,2599,429,16,16,32,50.0%,14m
27950,3,Shopov,2599,427,16,20,36,44.4%,11m
27950,3,SanGoo,2599,374,13,26,39,33.3%,20m
27950,2,Cereal,2599,250,12,0,12,100.0%,1h
27950,2,Luke,2599,308,11,9,20,55.0%,3m
27950,1,Theo,2599,196,8,11,19,42.1%,1h
27950,2,[COMMIE]TheSamMiner,2599,186,6,10,16,37.5%,59m
27950,2,[mfixed]emilson,2599,201,5,4,9,55.6%,13m
27950,3,Liza,2599,121,3,0,3,100.0%,20m
27950,3,[FpO]Kajus,2599,97,3,4,7,42.9%,1h
27950,2,Phantom,2599,64,3,4,7,42.9%,27m
27950,3,DaFrostMorn,2599,0,3,5,8,37.5%,20m
27950,2,Ray,2599,30,2,1,3,66.7%,4m
27950,1,HommOursPorc,2599,0,2,2,4,50.0%,1h
27950,2,TobiShauYTub,2599,30,2,2,4,50.0%,15m
27950,1,SlipKOT,2599,0,2,3,5,40.0%,3m
27950,2,NiCoRoCa,2599,0,2,3,5,40.0%,1h
27950,2,Alpharius,2599,32,1,3,4,25.0%,25m
27950,2,polontus,2599,0,1,4,5,20.0%,4m
27950,2,Firesrest,2599,0,0,2,2,0.0%,1h
27950,1,[MKDK]Gontello,2599,0,0,3,3,0.0%,1h
27979,1,raduku,2598,1612,117,122,239,49.0%,1h
27979,3,Ham,2598,537,76,79,155,49.0%,23m
27979,2,gaggan,2598,1496,73,68,141,51.8%,1h
27979,3,Focus,2598,1413,73,79,152,48.0%,11m
27979,1,davidtoxa,2598,1373,61,56,117,52.1%,10m
27979,1,[nogang]Besigno,2598,1344,51,48,99,51.5%,1h
27979,1,Engeron,2598,1173,46,40,86,53.5%,1h
27979,1,NiceSpirit,2598,1133,41,44,85,48.2%,3m
27979,2,AgentSmith,2598,1070,39,41,80,48.8%,1h
27979,2,[RUMad]dim,2598,509,37,28,65,56.9%,57m
27979,1,Rezno,2598,826,36,31,67,53.7%,27m
27979,1,Franki,2598,639,24,23,47,51.1%,1h
27979,2,Antalic,2598,423,19,18,37,51.4%,19m
27979,2,meron,2598,334,13,11,24,54.2%,1h
27979,2,[SCSh1t]Vortexx,2598,377,13,15,28,46.4%,1h
27979,1,Korvinus,2598,261,6,13,19,31.6%,1h
27979,3,SwasoW,2598,147,4,9,13,30.8%,25m
27979,2,cCrazy,2598,58,3,3,6,50.0%,1h
27979,3,Terratron,2598,42,3,5,8,37.5%,1h
27979,2,Andrik,2598,0,3,6,9,33.3%,16m
27979,2,Hephaestus,2598,60,2,3,5,40.0%,14m
27979,3,[VlKu]PospiMil,2598,0,2,5,7,28.6%,1h
27979,2,Mantis,2598,0,1,1,2,50.0%,1h
27979,1,Laggg,2598,0,1,3,4,25.0%,1h
27979,2,TwixHappy,2598,93,1,3,4,25.0%,55m
27979,2,[ILR]Fenix,2598,0,1,4,5,20.0%,19m
27979,2,WarlckRS,2598,0,0,1,1,0.0%,2m
27979,2,MaTn,2598,0,0,3,3,0.0%,1h
27979,2,SBloser,2598,0,0,4,4,0.0%,11m
27979,1,Zavulon,2598,0,0,6,6,0.0%,1h
28009,2,Spartak,2597,1276,103,101,204,50.5%,23m
28009,2,[MIELUL]becalipleaca,2597,991,46,29,75,61.3%,16m
28009,1,Zulraggar,2597,1280,45,51,96,46.9%,1h
28009,1,[GGBF]TrenTRezniK,2597,981,43,41,84,51.2%,1h
28009,1,[3A]LordGurgeniy,2597,602,35,28,63,55.6%,1h
28009,1,aceofspades,2597,629,31,36,67,46.3%,1h
28009,1,Wiggy,2597,769,24,33,57,42.1%,1h
28009,1,Zorgar,2597,574,21,22,43,48.8%,18m
28009,1,hiway,2597,621,18,23,41,43.9%,26m
28009,2,Carma,2597,471,17,15,32,53.1%,21m
28009,1,Qpi,2597,361,14,17,31,45.2%,1h
28009,2,Vano,2597,218,9,12,21,42.9%,23m
28009,2,[AltReg]Little,2597,174,6,6,12,50.0%,12m
28009,2,motoros,2597,221,6,8,14,42.9%,1h
28009,2,Guytoux,2597,164,5,2,7,71.4%,1h
28009,1,KorObaKinari,2597,228,5,6,11,45.5%,1h
28009,2,Odarich,2597,230,5,7,12,41.7%,1h
28009,3,Chrillis,2597,157,4,0,4,100.0%,21m
28009,1,SupremPizza,2597,165,4,1,5,80.0%,1h
28009,2,Richard,2597,123,4,5,9,44.4%,16m
28009,2,Adzarus,2597,86,3,3,6,50.0%,1h
28009,1,Raynor,2597,121,3,5,8,37.5%,24m
28009,1,Cyberxsgt,2597,91,2,5,7,28.6%,10m
28009,1,Alsaj,2597,48,2,6,8,25.0%,1h
28009,2,Scarecrow,2597,0,1,0,1,100.0%,17m
28009,2,[154165]Scifisam,2597,0,1,0,1,100.0%,1h
28009,2,Gelo,2597,0,1,1,2,50.0%,1h
28009,2,[PSidee]DaEtoJeSmile,2597,0,1,1,2,50.0%,3m
28009,2,Karma,2597,46,1,2,3,33.3%,27m
28009,2,Shaimus,2597,30,1,3,4,25.0%,17m
28009,2,[MTFBWY]Oxido,2597,0,0,1,1,0.0%,56m
28009,2,FireKing,2597,0,0,1,1,0.0%,26m
28009,3,notime,2597,0,0,2,2,0.0%,27m
28009,2,[ICCT]Альфанашиб,2597,0,0,2,2,0.0%,4m
28009,2,Tioxti,2597,0,0,2,2,0.0%,23m
28009,2,SlavikUA,2597,0,0,3,3,0.0%,1h
28009,2,[HEАT]CHE,2597,0,0,4,4,0.0%,1h
28046,1,Tigibigi,2596,1651,168,171,339,49.6%,23m
28046,1,kalyosik,2596,1526,86,82,168,51.2%,8m
28046,2,Hermejs,2596,1506,83,91,174,47.7%,11m
28046,3,Thedirtycat,2596,1521,62,73,135,45.9%,23m
28046,2,jumeaux,2596,1272,59,58,117,50.4%,1h
28046,2,MauZZeR,2596,918,39,28,67,58.2%,25m
28046,2,Obosralsy,2596,850,38,31,69,55.1%,1h
28046,1,Elite,2596,321,38,33,71,53.5%,1h
28046,2,DimaBorsch,2596,421,19,6,25,76.0%,1h
28046,1,MarxCom,2596,268,18,12,30,60.0%,1h
28046,2,[aslick]Vito,2596,315,16,10,26,61.5%,17m
28046,2,[TR1HP]Catchy,2596,346,12,13,25,48.0%,23m
28046,1,Noob,2596,279,11,13,24,45.8%,56m
28046,1,Vivaldi,2596,366,11,19,30,36.7%,11m
28046,1,Maxpowerpro,2596,304,9,12,21,42.9%,26m
28046,1,Nitora,2596,94,7,6,13,53.8%,11m
28046,2,PeaceDuke,2596,148,6,8,14,42.9%,1h
28046,3,Zpikie,2596,62,5,7,12,41.7%,23m
28046,2,arros,2596,88,4,2,6,66.7%,1h
28046,3,VileIIINine,2596,32,4,4,8,50.0%,1h
28046,1,[Panin]Givi,2596,139,3,5,8,37.5%,5m
28046,2,Nick,2596,92,2,0,2,100.0%,1h
28046,1,Azagapp,2596,46,2,1,3,66.7%,1h
28046,1,LeDar,2596,0,2,3,5,40.0%,58m
28046,2,Nagibarius,2596,0,2,3,5,40.0%,2m
28046,3,НаГиБаТоР,2596,0,2,4,6,33.3%,1h
28046,1,MaXterDraw,2596,46,1,2,3,33.3%,2m
28046,1,Shaftpunk,2596,0,0,1,1,0.0%,18m
28046,1,ǂronMan,2596,0,0,1,1,0.0%,1h
28046,2,WePo,2596,0,0,1,1,0.0%,2m
28046,2,[šikula]Eagle,2596,0,0,1,1,0.0%,1h
28046,3,lossounet,2596,0,0,5,5,0.0%,23m
28078,2,NtcSamael,2595,1521,219,210,429,51.0%,8m
28078,2,[wFtan]baptistin,2595,1295,197,187,384,51.3%,56m
28078,2,[Moskva]Seeker,2595,1597,137,136,273,50.2%,2m
28078,3,ezicik,2595,1500,132,117,249,53.0%,21m
28078,1,[7IO]rorschach,2595,1168,68,60,128,53.1%,59m
28078,2,Punisher,2595,1601,66,62,128,51.6%,1h
28078,2,Terranist,2595,1437,56,57,113,49.6%,21m
28078,2,KorbenDallas,2595,777,54,49,103,52.4%,57m
28078,2,[Moskva]Rodnoy,2595,638,36,36,72,50.0%,1h
28078,2,[WeDoM]Onja,2595,272,10,9,19,52.6%,58m
28078,2,Arduriki,2595,200,8,6,14,57.1%,1h
28078,3,[FYBF]NikBac,2595,248,8,20,28,28.6%,22m
28078,2,FiftyBliss,2595,151,5,2,7,71.4%,1h
28078,2,Hanluk,2595,114,5,3,8,62.5%,56m
28078,2,Mitchel,2595,140,5,6,11,45.5%,1h
28078,3,SSO,2595,60,5,7,12,41.7%,19m
28078,3,[z666z]frace,2595,40,3,5,8,37.5%,7m
28078,3,Darkness,2595,130,3,9,12,25.0%,16m
28078,3,[WCB18]Miecio,2595,0,2,4,6,33.3%,1h
28078,1,Erzhan,2595,38,2,5,7,28.6%,4m
28078,2,Yannizel,2595,0,1,0,1,100.0%,4m
28078,2,Meshtera,2595,0,1,2,3,33.3%,8m
28078,1,SONTERA,2595,0,1,4,5,20.0%,1h
28078,2,Melorka,2595,0,0,1,1,0.0%,1h
28078,2,[TFIR]marke,2595,0,0,1,1,0.0%,1h
28078,2,LexoZoom,2595,0,0,1,1,0.0%,9m
28078,2,Justdoit,2595,0,0,1,1,0.0%,3m
28078,3,Denoid,2595,0,0,1,1,0.0%,1h
28078,1,tomcher,2595,0,0,2,2,0.0%,14m
28078,2,IseeTheGlow,2595,0,0,2,2,0.0%,1h
28108,3,Fayst,2594,1567,242,227,469,51.6%,20m
28108,2,спайдермен,2594,1533,200,195,395,50.6%,19m
28108,2,Atukir,2594,1606,114,106,220,51.8%,1h
28108,2,[JaPP]Diadohos,2594,984,110,100,210,52.4%,1h
28108,2,Stefuc,2594,1545,84,78,162,51.9%,16m
28108,1,justo,2594,1090,65,67,132,49.2%,18m
28108,2,shirunai,2594,1285,52,43,95,54.7%,19m
28108,2,[U19]Soldatich,2594,792,39,34,73,53.4%,1h
28108,2,[2M1B]WastedBorn,2594,885,38,33,71,53.5%,1h
28108,1,Yuriv,2594,798,32,31,63,50.8%,1h
28108,2,[DarKsS]fernandillo,2594,747,31,33,64,48.4%,16m
28108,1,OneOne,2594,828,27,37,64,42.2%,1h
28108,1,VYBZ,2594,702,24,30,54,44.4%,1h
28108,2,atletico,2594,431,16,17,33,48.5%,19m
28108,2,Pupius,2594,334,12,9,21,57.1%,27m
28108,2,MakiBaki,2594,260,10,7,17,58.8%,9m
28108,2,supertrashyn,2594,310,10,9,19,52.6%,14m
28108,1,Emka,2594,295,8,7,15,53.3%,13m
28108,2,andrei,2594,178,7,6,13,53.8%,1h
28108,2,ЭпичнаяМышь,2594,216,7,8,15,46.7%,1h
28108,1,Kuula,2594,232,7,12,19,36.8%,1h
28108,1,AdmiralRdnek,2594,263,6,4,10,60.0%,23m
28108,2,FooDog,2594,152,5,1,6,83.3%,57m
28108,2,SpawN,2594,140,5,6,11,45.5%,1h
28108,2,HonkyMonky,2594,206,5,10,15,33.3%,1h
28108,2,[Buldog]ElcetroWat,2594,129,4,0,4,100.0%,14m
28108,2,Stark,2594,165,4,4,8,50.0%,1h
28108,2,Logitek,2594,100,4,6,10,40.0%,21m
28108,2,OptimusRhyme,2594,62,3,4,7,42.9%,5m
28108,2,Crowling,2594,57,3,5,8,37.5%,16m
28108,1,[Ирбис]mdd,2594,0,2,2,4,50.0%,3m
28108,3,skywalker,2594,0,2,4,6,33.3%,4m
28108,2,SirVoles,2594,0,2,4,6,33.3%,1h
28108,1,Camouflage,2594,0,2,4,6,33.3%,1h
28108,2,DUM,2594,0,1,0,1,100.0%,16m
28108,2,BatPanda,2594,30,1,3,4,25.0%,1h
28108,1,SteinweR,2594,0,1,4,5,20.0%,1h
28108,2,[SWEBK]Tasso,2594,0,0,1,1,0.0%,14m
28108,2,YURGZ,2594,0,0,1,1,0.0%,1h
28108,2,Alex,2594,0,0,1,1,0.0%,26m
28108,2,ArtDKRook,2594,0,0,1,1,0.0%,16m
28108,3,LobzikSan,2594,0,0,1,1,0.0%,24m
28108,2,Blind,2594,0,0,1,1,0.0%,1h
28108,1,[nan]Insane,2594,0,0,3,3,0.0%,1h
28152,2,Ferus,2593,1147,98,81,179,54.7%,1h
28152,3,Topceon,2593,908,81,80,161,50.3%,20m
28152,2,prokaza,2593,1043,65,67,132,49.2%,17m
28152,3,naid,2593,1106,52,55,107,48.6%,19m
28152,2,Gafurus,2593,602,26,17,43,60.5%,9m
28152,1,molinaHa,2593,605,24,24,48,50.0%,8m
28152,2,CEthaNOOB,2593,556,19,23,42,45.2%,21m
28152,2,Freeqs,2593,410,17,15,32,53.1%,1h
28152,1,[EEBÄR]Monsta,2593,357,11,5,16,68.8%,15m
28152,1,SashaSheved,2593,349,11,13,24,45.8%,6m
28152,1,Ratezzy,2593,412,11,19,30,36.7%,4m
28152,2,[44139]Vexator,2593,178,9,8,17,52.9%,1h
28152,1,Mariusz,2593,218,9,9,18,50.0%,1h
28152,2,faker,2593,276,9,10,19,47.4%,9m
28152,2,KopabJIeB,2593,236,8,10,18,44.4%,1h
28152,1,[JaPP]JoKeR,2593,142,6,8,14,42.9%,23m
28152,2,Nikolaj,2593,155,5,2,7,71.4%,1h
28152,1,everadrone,2593,140,4,4,8,50.0%,26m
28152,1,[LMBD]Rastiel,2593,114,4,6,10,40.0%,1h
28152,2,УбивцаТоссов,2593,112,3,0,3,100.0%,1h
28152,2,llllllllllll,2593,30,3,4,7,42.9%,55m
28152,2,[CBot]Katzenlord,2593,30,2,1,3,66.7%,22m
28152,2,Moon,2593,0,1,1,2,50.0%,1h
28152,2,Dixu,2593,30,1,1,2,50.0%,1h
28152,2,Пеко,2593,88,1,1,2,50.0%,1h
28152,1,WaSaBiGaz,2593,0,1,1,2,50.0%,1h
28152,1,therock,2593,73,1,5,6,16.7%,6m
28152,3,deltafeatpka,2593,0,0,2,2,0.0%,7m
28152,3,[B7]Eldraim,2593,0,0,6,6,0.0%,1h
28181,3,Ruslanka,2592,1507,84,86,170,49.4%,9m
28181,2,EldarRadle,2592,822,42,44,86,48.8%,15m
28181,1,Chipeurchipe,2592,619,36,33,69,52.2%,22m
28181,1,testit,2592,850,33,35,68,48.5%,6m
28181,1,alex,2592,413,21,16,37,56.8%,12m
28181,2,Emmm,2592,370,16,6,22,72.7%,1h
28181,2,RoWaN,2592,416,16,16,32,50.0%,15m
28181,3,[RxxxD]hannelore,2592,438,16,22,38,42.1%,22m
28181,2,Volloxh,2592,338,14,16,30,46.7%,1h
28181,1,[SCGTR]Dmitrii,2592,240,11,3,14,78.6%,1h
28181,1,Mako,2592,271,9,5,14,64.3%,21m
28181,1,FoxAge,2592,234,8,10,18,44.4%,60m
28181,1,NotSaitama,2592,216,6,6,12,50.0%,8m
28181,2,Razvi,2592,138,4,1,5,80.0%,9m
28181,2,WinDriX,2592,152,4,2,6,66.7%,1h
28181,3,[BMFG]ProfeZzor,2592,122,3,5,8,37.5%,9m
28181,2,den,2592,30,2,1,3,66.7%,58m
28181,1,[HDLs]Krom,2592,47,2,2,4,50.0%,1h
28181,2,ESHELON,2592,58,2,2,4,50.0%,22m
28181,2,CarlJohnson,2592,126,2,3,5,40.0%,1h
28181,3,MaxiFyer,2592,44,1,1,2,50.0%,4m
28181,2,Райко,2592,0,1,3,4,25.0%,1h
28181,2,[DNTSQU]Duran,2592,0,0,1,1,0.0%,1h
28181,2,Makeshik,2592,0,0,2,2,0.0%,4m
28181,2,olegthunder,2592,0,0,3,3,0.0%,59m
28206,3,Lexotan,2591,1200,89,88,177,50.3%,10m
28206,2,Killsoftly,2591,1586,83,68,151,55.0%,59m
28206,1,Sarge,2591,1548,77,82,159,48.4%,57m
28206,2,reedemer,2591,1166,73,70,143,51.0%,1h
28206,2,Leonardo,2591,730,67,49,116,57.8%,21m
28206,3,[OutEst]KIJA,2591,910,60,68,128,46.9%,13m
28206,2,[LQV]lambdasquad,2591,1266,50,42,92,54.3%,1h
28206,1,DireWolf,2591,700,48,48,96,50.0%,18m
28206,2,Bushido,2591,858,31,30,61,50.8%,21m
28206,2,Hellbringer,2591,392,19,13,32,59.4%,24m
28206,1,[CRCLW]GeRoIN,2591,531,17,19,36,47.2%,58m
28206,1,Konaree,2591,524,17,22,39,43.6%,56m
28206,1,Ruslan,2591,482,16,22,38,42.1%,20m
28206,2,[BOTSI]KMX,2591,353,14,8,22,63.6%,1h
28206,1,Vace,2591,452,14,19,33,42.4%,1h
28206,1,[AbsA]FrozenBrain,2591,343,11,10,21,52.4%,5m
28206,2,Kaiser,2591,166,7,8,15,46.7%,22m
28206,2,Carls,2591,201,5,6,11,45.5%,23m
28206,2,[NoSepi]Antihero,2591,186,5,7,12,41.7%,21m
28206,2,[Фаталя]Daniillee,2591,142,4,1,5,80.0%,1h
28206,2,[WSKY]UnderDark,2591,60,3,2,5,60.0%,1h
28206,2,Chalousse,2591,62,2,4,6,33.3%,1h
28206,3,Iceman,2591,0,2,4,6,33.3%,1h
28206,2,Toor,2591,30,2,5,7,28.6%,1h
28206,2,[0K]asswolf,2591,0,1,0,1,100.0%,1h
28206,2,CloseYou,2591,30,1,3,4,25.0%,15m
28232,1,MechAniCs,2590,1142,236,237,473,49.9%,1h
28232,1,[LMBD]ObiWanJesely,2590,1286,104,80,184,56.5%,18m
28232,2,Kula,2590,1204,57,55,112,50.9%,16m
28232,1,Yonndu,2590,913,42,44,86,48.8%,1h
28232,2,MurphysLaw,2590,467,33,20,53,62.3%,59m
28232,2,alex,2590,660,24,24,48,50.0%,4m
28232,1,Quark,2590,684,23,28,51,45.1%,20m
28232,2,Swerox,2590,268,8,8,16,50.0%,9m
28232,1,DeadRoys,2590,220,7,9,16,43.8%,7m
28232,2,[МыХуи]red,2590,146,7,10,17,41.2%,1h
28232,1,[FilsDe]kitach,2590,88,5,3,8,62.5%,1h
28232,3,Dhash,2590,147,5,8,13,38.5%,23m
28232,1,[QTclub]YoAnSingSong,2590,152,5,8,13,38.5%,10m
28232,2,zNatury,2590,46,4,6,10,40.0%,1h
28232,1,IIReStArTII,2590,97,4,7,11,36.4%,1h
28232,2,Sapozhnik,2590,58,3,1,4,75.0%,1h
28232,2,[oooboy]werser,2590,58,3,1,4,75.0%,1h
28232,2,ExileTrooper,2590,0,3,3,6,50.0%,1h
28232,3,BlackMamba,2590,0,3,5,8,37.5%,6m
28232,2,bottox,2590,30,2,1,3,66.7%,1h
28232,2,DanMars,2590,62,2,3,5,40.0%,16m
28232,2,ТартаР,2590,58,2,3,5,40.0%,1h
28232,2,Battlepanda,2590,30,2,4,6,33.3%,2m
28232,2,IIIIIIIIIIII,2590,0,1,0,1,100.0%,26m
28232,2,ДедТукТук,2590,0,1,0,1,100.0%,17m
28232,2,sant,2590,0,1,0,1,100.0%,1h
28232,2,TINO,2590,30,1,2,3,33.3%,26m
28232,2,Dezman,2590,0,1,4,5,20.0%,27m
28260,2,jaddulyi,2589,1613,195,166,361,54.0%,16m
28260,3,ilagunovich,2589,1252,179,167,346,51.7%,22m
28260,2,[UHSF]Striker,2589,1562,170,145,315,54.0%,4m
28260,1,[LkrsBs]BelgianBull,2589,1539,99,100,199,49.7%,2m
28260,2,Voislav,2589,1576,93,79,172,54.1%,1h
28260,1,mit,2589,1117,58,56,114,50.9%,1h
28260,2,LES,2589,332,30,15,45,66.7%,1h
28260,3,kelix,2589,616,24,31,55,43.6%,22m
28260,3,[Kdo5]Komandoh,2589,410,17,18,35,48.6%,11m
28260,1,[DDaD]Karramba,2589,440,17,18,35,48.6%,21m
28260,3,ReILO,2589,508,16,27,43,37.2%,10m
28260,3,Blvemonkey,2589,476,15,23,38,39.5%,12m
28260,1,Atlas,2589,364,13,18,31,41.9%,1h
28260,1,DoubleBaRReL,2589,354,11,14,25,44.0%,1h
28260,1,Sirio,2589,193,6,10,16,37.5%,26m
28260,3,Polo,2589,40,5,5,10,50.0%,57m
28260,2,BoOMy,2589,126,4,0,4,100.0%,1h
28260,2,denisred,2589,126,4,1,5,80.0%,27m
28260,3,Zwackel,2589,82,4,6,10,40.0%,18m
28260,2,NoChanceForU,2589,114,3,1,4,75.0%,1h
28260,2,TopSAN,2589,62,3,3,6,50.0%,1h
28260,2,BohPus,2589,161,3,5,8,37.5%,58m
28260,2,danil,2589,88,2,0,2,100.0%,1h
28260,1,[SFight]Loki,2589,92,2,3,5,40.0%,1h
28260,2,Orci,2589,0,2,3,5,40.0%,1h
28260,2,[DSCPRO]Normandy,2589,0,2,3,5,40.0%,17m
28260,2,Saneythyk,2589,60,2,3,5,40.0%,1h
28260,1,Senpai,2589,0,2,3,5,40.0%,1h
28260,3,SegaELf,2589,0,2,4,6,33.3%,1h
28260,3,Flex,2589,97,2,4,6,33.3%,1h
28260,1,trainspăt,2589,1,2,8,10,20.0%,11m
28260,2,ZoViMeMaJkA,2589,0,1,0,1,100.0%,1h
28260,2,Gargamel,2589,0,1,0,1,100.0%,15m
28260,2,[xomяk3]dema,2589,0,1,0,1,100.0%,1h
28260,2,[BRSKR]Nomcrus,2589,0,1,1,2,50.0%,17m
28260,3,KingDragon,2589,0,1,2,3,33.3%,17m
28260,2,ezkill,2589,34,1,3,4,25.0%,1h
28260,2,Denne,2589,0,0,1,1,0.0%,1h
28260,2,PILMESHKA,2589,0,0,1,1,0.0%,9m
28260,2,Thisisboo,2589,0,0,1,1,0.0%,9m
28260,2,ketoumymy,2589,0,0,4,4,0.0%,1h
28301,3,smooth,2588,1593,297,293,590,50.3%,20m
28301,3,LurKer,2588,1084,56,65,121,46.3%,9m
28301,2,[FYBF]Pond,2588,1303,50,47,97,51.5%,1h
28301,2,Changy,2588,1251,49,48,97,50.5%,1h
28301,1,WOLF,2588,775,29,31,60,48.3%,1h
28301,2,Dragonguy,2588,822,28,30,58,48.3%,1h
28301,2,Sнoт,2588,653,25,18,43,58.1%,1h
28301,1,NiWzE,2588,520,23,18,41,56.1%,1h
28301,2,Hristo,2588,342,12,9,21,57.1%,1h
28301,2,ghostNiGHT,2588,245,11,1,12,91.7%,1h
28301,2,Vrikkie,2588,272,11,11,22,50.0%,1h
28301,2,Kolyanych,2588,280,11,12,23,47.8%,1h
28301,2,Berci,2588,260,9,6,15,60.0%,27m
28301,1,ppp,2588,327,9,13,22,40.9%,26m
28301,1,Haqila,2588,254,8,11,19,42.1%,7m
28301,2,Pyrrhus,2588,188,6,6,12,50.0%,4m
28301,3,DIEZMA,2588,42,4,3,7,57.1%,3m
28301,2,karter,2588,90,4,5,9,44.4%,26m
28301,1,McDowell,2588,112,4,9,13,30.8%,7m
28301,2,[YouMad]twopaxalive,2588,30,2,1,3,66.7%,1h
28301,2,Roistapoista,2588,58,2,2,4,50.0%,1h
28301,2,oGeTeNKs,2588,0,2,4,6,33.3%,1h
28301,2,jaweeeeel,2588,60,2,4,6,33.3%,1h
28301,1,[JKCNFT]niktank,2588,0,2,5,7,28.6%,9m
28301,2,[NÛL]Kratoslezerg,2588,0,1,0,1,100.0%,1h
28301,2,greengoby,2588,0,1,0,1,100.0%,1h
28301,2,[SUCELA]DMCE,2588,0,1,4,5,20.0%,1h
28301,2,QuaeZZ,2588,0,0,1,1,0.0%,26m
28301,2,ItsTrooper,2588,0,0,1,1,0.0%,57m
28301,2,[EXxX]Arq,2588,0,0,1,1,0.0%,1h
28301,3,TinTin,2588,0,0,2,2,0.0%,60m
28301,1,[6mm]Fragor,2588,0,0,4,4,0.0%,59m
28333,2,DonProm,2587,1445,105,108,213,49.3%,4m
28333,1,BlokkerMC,2587,1659,97,91,188,51.6%,1h
28333,2,[LightC]ReD,2587,693,47,39,86,54.7%,3m
28333,1,OMEGA,2587,943,40,27,67,59.7%,55m
28333,2,[xDMx]KamiKatze,2587,660,35,33,68,51.5%,1h
28333,1,Blade,2587,702,23,27,50,46.0%,1h
28333,2,Dekar,2587,528,21,15,36,58.3%,1h
28333,2,gudock,2587,384,17,23,40,42.5%,12m
28333,2,Xerath,2587,460,16,17,33,48.5%,1h
28333,1,stefan,2587,419,15,19,34,44.1%,1h
28333,2,Hipo,2587,287,13,4,17,76.5%,24m
28333,2,HAVOC,2587,259,8,7,15,53.3%,1h
28333,1,[NIARBI]Niarbitchkov,2587,232,7,7,14,50.0%,1h
28333,2,misterY,2587,58,6,7,13,46.2%,4m
28333,2,AmiGO,2587,140,5,0,5,100.0%,1h
28333,1,[AngorA]Империй,2587,168,5,13,18,27.8%,14m
28333,2,LemonenJäger,2587,126,4,0,4,100.0%,1h
28333,2,[PiGPan]xXReaPeRWeeD,2587,189,4,6,10,40.0%,24m
28333,2,teksla,2587,124,4,7,11,36.4%,9m
28333,1,[ZZT]Logistix,2587,0,3,4,7,42.9%,1h
28333,3,ObscureTiger,2587,40,3,5,8,37.5%,1h
28333,2,PepsiMax,2587,72,3,6,9,33.3%,1h
28333,2,GaNDoN,2587,30,2,0,2,100.0%,1h
28333,1,Heyek,2587,95,2,3,5,40.0%,1h
28333,1,ViktorBG,2587,0,2,3,5,40.0%,1h
28333,1,PPP,2587,0,2,3,5,40.0%,1h
28333,2,Apicis,2587,0,1,0,1,100.0%,1h
28333,2,[BCNG]Vanchesko,2587,0,1,0,1,100.0%,59m
28333,2,Рубик,2587,0,1,0,1,100.0%,16m
28333,2,Mystic,2587,34,1,2,3,33.3%,1h
28333,2,Minzent,2587,109,1,3,4,25.0%,19m
28333,3,FunizZ,2587,0,0,1,1,0.0%,4m
28333,2,[Лень]RGFirefly,2587,0,0,1,1,0.0%,12m
28333,3,MaX,2587,0,0,1,1,0.0%,9m
28367,3,Dodo,2586,826,86,76,162,53.1%,16m
28367,1,Pashtet,2586,1495,57,59,116,49.1%,26m
28367,1,Metamorph,2586,950,50,56,106,47.2%,21m
28367,2,яблоко,2586,1075,47,32,79,59.5%,21m
28367,1,Biiru,2586,1084,35,42,77,45.5%,1h
28367,2,Grybnyk,2586,894,32,32,64,50.0%,58m
28367,2,Serenity,2586,489,22,7,29,75.9%,55m
28367,2,kuku,2586,494,19,20,39,48.7%,1h
28367,2,OldMenHappy,2586,413,17,10,27,63.0%,25m
28367,1,[Petrиs]Alahel,2586,365,14,13,27,51.9%,7m
28367,3,Devil,2586,324,12,17,29,41.4%,14m
28367,1,Romenium,2586,301,11,13,24,45.8%,1h
28367,1,ЦАРЬ,2586,247,8,7,15,53.3%,26m
28367,3,[ODB]Yzarhia,2586,212,6,7,13,46.2%,23m
28367,2,ceix,2586,224,6,9,15,40.0%,18m
28367,2,Максrus,2586,152,5,1,6,83.3%,25m
28367,3,Mjolnir,2586,90,5,8,13,38.5%,20m
28367,2,MMM,2586,58,2,3,5,40.0%,1h
28367,2,Nistelbog,2586,30,2,3,5,40.0%,1h
28367,1,Johnny,2586,48,1,1,2,50.0%,1h
28367,2,Hellraiser,2586,0,1,2,3,33.3%,15m
28367,2,Default,2586,30,1,2,3,33.3%,1h
28367,1,boldxhead,2586,34,1,8,9,11.1%,5m
28367,2,duralex,2586,0,0,4,4,0.0%,1h
28391,1,arfar,2585,1648,103,102,205,50.2%,1h
28391,2,JeanGens,2585,1212,90,76,166,54.2%,22m
28391,2,жопорвун,2585,1388,74,50,124,59.7%,12m
28391,2,[GKR]Duran,2585,898,64,60,124,51.6%,16m
28391,3,Mykill,2585,1554,60,72,132,45.5%,7m
28391,1,ZergAxe,2585,822,52,50,102,51.0%,18m
28391,1,cooking,2585,942,40,38,78,51.3%,56m
28391,1,GeneralMorre,2585,963,33,37,70,47.1%,1h
28391,1,[Казах]Terran,2585,629,24,26,50,48.0%,1h
28391,1,[LCRF]Hаруто,2585,574,21,24,45,46.7%,1h
28391,3,[WNPB]Skillweers,2585,336,15,17,32,46.9%,4m
28391,2,Scalzofedda,2585,340,14,15,29,48.3%,16m
28391,2,[Kariba]Anatrox,2585,318,12,14,26,46.2%,8m
28391,2,bohmteone,2585,319,11,12,23,47.8%,1h
28391,1,[u7k2f5]Bigbonfit,2585,333,10,12,22,45.5%,1h
28391,3,bisounours,2585,271,10,14,24,41.7%,1h
28391,2,spacejumper,2585,165,9,2,11,81.8%,16m
28391,2,Cargobiker,2585,205,8,7,15,53.3%,20m
28391,3,[ZELT]Runner,2585,0,4,3,7,57.1%,19m
28391,1,Funkaps,2585,142,4,9,13,30.8%,1h
28391,1,Solomon,2585,148,4,9,13,30.8%,20m
28391,3,DieGrootBaas,2585,97,3,5,8,37.5%,18m
28391,1,Kavve,2585,92,3,5,8,37.5%,1h
28391,3,ilcapo,2585,98,3,17,20,15.0%,25m
28391,1,Tierel,2585,42,2,6,8,25.0%,21m
28391,2,Gverreiro,2585,0,1,0,1,100.0%,4m
28391,2,orion,2585,30,1,2,3,33.3%,19m
28391,1,MisterJager,2585,0,1,4,5,20.0%,5m
28391,1,twoclick,2585,0,1,4,5,20.0%,59m
28391,2,Abdullah,2585,0,0,1,1,0.0%,1h
28391,3,Gumble,2585,0,0,1,1,0.0%,18m
28391,2,Darwin,2585,0,0,1,1,0.0%,4m
28391,3,ImbaNoobAlex,2585,0,0,2,2,0.0%,18m
28391,1,Weresk,2585,0,0,4,4,0.0%,16m
28391,2,[Tosses]Dexter,2585,0,0,4,4,0.0%,1h
28426,1,[II3II]TurboPWNZ,2584,1384,330,328,658,50.2%,1h
28426,1,Blurlover,2584,1643,113,109,222,50.9%,20m
28426,2,fundo,2584,1395,87,83,170,51.2%,12m
28426,2,myway,2584,1143,70,62,132,53.0%,4m
28426,1,[TENRIX]Darktherion,2584,838,58,32,90,64.4%,1h
28426,2,Zaslot,2584,507,21,20,41,51.2%,4m
28426,2,Tamerlanedz,2584,396,16,18,34,47.1%,9m
28426,2,Grifex,2584,348,14,5,19,73.7%,1h
28426,3,[WCKYLN]Handke,2584,208,8,17,25,32.0%,5m
28426,2,ПопадалоВ,2584,138,7,3,10,70.0%,1h
28426,2,Tim,2584,210,7,4,11,63.6%,1h
28426,2,proBeHeaVy,2584,156,5,5,10,50.0%,55m
28426,2,MrProTest,2584,94,3,5,8,37.5%,1h
28426,3,[HOOLS]History,2584,0,1,0,1,100.0%,60m
28426,2,Jóker,2584,88,1,1,2,50.0%,1h
28426,2,Arkaelul,2584,0,1,3,4,25.0%,1h
28426,2,[Achtun]vadim,2584,30,1,4,5,20.0%,7m
28426,3,EsplyEd,2584,0,0,1,1,0.0%,10m
28426,2,Tazar,2584,0,0,2,2,0.0%,4m
28426,2,Vesperal,2584,0,0,2,2,0.0%,17m
28446,2,irimir,2583,1584,130,126,256,50.8%,20m
28446,2,Nuke,2583,1545,118,95,213,55.4%,26m
28446,2,astius,2583,1319,64,62,126,50.8%,2m
28446,2,LemonFreezer,2583,511,25,16,41,61.0%,1h
28446,2,zündholz,2583,424,19,17,36,52.8%,1h
28446,1,Voollien,2583,350,19,24,43,44.2%,1h
28446,2,[DpDF]SirPidoid,2583,417,18,9,27,66.7%,22m
28446,2,[nostrd]косой,2583,380,15,13,28,53.6%,3m
28446,2,kababik,2583,382,15,16,31,48.4%,5m
28446,2,mafiosi,2583,313,13,5,18,72.2%,55m
28446,2,[Poire]Pantalon,2583,325,12,9,21,57.1%,23m
28446,2,[LforA]fry,2583,298,10,7,17,58.8%,1h
28446,2,[ioStuN]FluffyKitten,2583,271,10,7,17,58.8%,56m
28446,2,idleHands,2583,289,10,16,26,38.5%,16m
28446,2,SoupOfBanana,2583,181,7,7,14,50.0%,1h
28446,2,[971]Corsair,2583,200,7,8,15,46.7%,1h
28446,1,Klonklion,2583,258,7,9,16,43.8%,1h
28446,1,CaptianFox,2583,186,6,13,19,31.6%,1h
28446,2,JohnR,2583,174,5,6,11,45.5%,1h
28446,2,DFox,2583,120,5,8,13,38.5%,57m
28446,2,micubisi,2583,128,4,1,5,80.0%,19m
28446,1,PiPoUBaBaS,2583,0,3,2,5,60.0%,16m
28446,1,Loccon,2583,88,3,4,7,42.9%,10m
28446,2,CuteKitten,2583,88,3,4,7,42.9%,57m
28446,2,BushBaby,2583,112,2,2,4,50.0%,1h
28446,1,[Böcke]HaraldKrull,2583,92,2,2,4,50.0%,1h
28446,3,massacreator,2583,0,2,4,6,33.3%,60m
28446,2,Kieightra,2583,0,1,0,1,100.0%,20m
28446,2,STALKERok,2583,0,1,0,1,100.0%,16m
28446,2,Melofmatix,2583,0,0,1,1,0.0%,1h
28476,3,Spaceman,2582,1492,268,260,528,50.8%,11m
28476,2,KyloXD,2582,1573,218,189,407,53.6%,58m
28476,2,Kuinji,2582,1604,189,174,363,52.1%,19m
28476,2,MaxPower,2582,1608,161,146,307,52.4%,56m
28476,2,Morfeus,2582,1586,82,72,154,53.2%,1h
28476,2,Mïta,2582,335,80,65,145,55.2%,1h
28476,1,callmedaddy,2582,774,71,79,150,47.3%,11m
28476,2,IlIlIlIIllII,2582,774,35,18,53,66.0%,1h
28476,2,Credenza,2582,922,32,45,77,41.6%,2m
28476,1,Pombur,2582,285,12,8,20,60.0%,19m
28476,2,HighNoon,2582,328,12,9,21,57.1%,1h
28476,1,Weave,2582,368,12,17,29,41.4%,12m
28476,2,Storm,2582,291,11,10,21,52.4%,20m
28476,2,Eden,2582,300,11,11,22,50.0%,1h
28476,1,Cimarrón,2582,360,11,17,28,39.3%,5m
28476,2,MarineIncHUN,2582,229,8,4,12,66.7%,1h
28476,1,verker,2582,220,7,6,13,53.8%,1h
28476,1,Kodo,2582,208,7,12,19,36.8%,8m
28476,2,EnderStim,2582,128,5,4,9,55.6%,22m
28476,2,MadNoob,2582,182,5,5,10,50.0%,15m
28476,2,Darchangel,2582,86,4,2,6,66.7%,21m
28476,2,[W0LFF]Mrakobes,2582,144,4,3,7,57.1%,1h
28476,1,HuRT,2582,120,4,7,11,36.4%,21m
28476,2,Ellorie,2582,0,3,3,6,50.0%,1h
28476,3,KebabowaDiet,2582,0,3,3,6,50.0%,60m
28476,1,Chris,2582,0,3,7,10,30.0%,12m
28476,3,Wilbranho,2582,127,2,3,5,40.0%,1h
28476,3,Xargor,2582,0,1,0,1,100.0%,1h
28476,1,[USSR02]NavalnyLive,2582,0,1,0,1,100.0%,23m
28476,2,[PolSku]DaveBearserk,2582,0,1,0,1,100.0%,1h
28476,2,Elennor,2582,0,1,0,1,100.0%,1h
28476,2,SasPotato,2582,0,0,1,1,0.0%,17m
28476,2,erce,2582,0,0,3,3,0.0%,24m
28476,1,Dark,2582,0,0,6,6,0.0%,1h
28510,1,DED,2581,1569,400,395,795,50.3%,8m
28510,1,Shakal,2581,1578,73,73,146,50.0%,1h
28510,1,Ender,2581,1026,60,62,122,49.2%,10m
28510,2,[CumA4]fourgeymer,2581,1228,57,35,92,62.0%,3m
28510,1,AJIoHzo,2581,1359,48,53,101,47.5%,1h
28510,1,Bltizo,2581,687,45,35,80,56.2%,1h
28510,2,peterwhie,2581,795,31,24,55,56.4%,1h
28510,1,Burgie,2581,612,23,21,44,52.3%,1h
28510,2,eints,2581,527,22,14,36,61.1%,1h
28510,2,[jajja]Alexandra,2581,367,14,10,24,58.3%,1h
28510,2,IIIllIllIIIl,2581,322,13,17,30,43.3%,18m
28510,2,llllllllllll,2581,310,12,7,19,63.2%,1h
28510,1,demigod,2581,338,10,17,27,37.0%,18m
28510,3,Amleo,2581,120,7,9,16,43.8%,25m
28510,3,llllllllllll,2581,121,5,3,8,62.5%,58m
28510,2,GrenKa,2581,86,4,3,7,57.1%,26m
28510,2,[LDS]Augenwurst,2581,123,4,5,9,44.4%,4m
28510,3,Suncho,2581,74,4,6,10,40.0%,10m
28510,1,[SoBM]Auditore,2581,0,3,2,5,60.0%,5m
28510,3,THERIM,2581,97,3,4,7,42.9%,24m
28510,2,maruderspam,2581,95,3,4,7,42.9%,24m
28510,2,WarLife,2581,96,3,6,9,33.3%,1h
28510,2,BattleTag,2581,92,2,0,2,100.0%,1h
28510,2,ROTORDEAD,2581,102,2,2,4,50.0%,1h
28510,2,Aseitas,2581,0,2,2,4,50.0%,1h
28510,2,HurrianKing,2581,58,2,4,6,33.3%,1h
28510,2,PhysoTronic,2581,0,1,4,5,20.0%,1h
28510,2,kkalmi,2581,32,1,4,5,20.0%,9m
28510,2,melo,2581,32,1,6,7,14.3%,1h
28510,2,[NOOBpl]anderido,2581,0,0,1,1,0.0%,1h
28510,2,Perseus,2581,0,0,3,3,0.0%,1h
28541,1,[Pushka]main,2580,1634,251,247,498,50.4%,1h
28541,1,noki,2580,1634,76,76,152,50.0%,27m
28541,3,Duuujk,2580,1061,75,83,158,47.5%,21m
28541,2,[C12760]elpothi,2580,924,34,31,65,52.3%,1h
28541,3,DennisKuhn,2580,688,26,35,61,42.6%,23m
28541,2,sterker,2580,373,16,11,27,59.3%,7m
28541,3,CybLord,2580,263,10,13,23,43.5%,9m
28541,1,[ĐoŁ]Masarykt,2580,300,10,18,28,35.7%,10m
28541,1,DevXCode,2580,201,9,18,27,33.3%,21m
28541,2,[Rebеls]ling,2580,215,8,9,17,47.1%,1h
28541,2,Kotlin,2580,200,7,3,10,70.0%,26m
28541,1,Mewys,2580,130,6,9,15,40.0%,8m
28541,2,jhonyleon,2580,0,3,3,6,50.0%,25m
28541,3,TAL,2580,97,3,4,7,42.9%,9m
28541,2,batush,2580,40,2,1,3,66.7%,1h
28541,2,[nfteam]Atilius,2580,0,2,3,5,40.0%,1h
28541,2,[UFOZ]MartyMcFly,2580,0,2,3,5,40.0%,58m
28541,2,[AcStFo]ASFlimbo,2580,0,2,3,5,40.0%,1h
28541,2,[IVöVI]MAXHE,2580,58,2,3,5,40.0%,17m
28541,1,Mac,2580,142,2,3,5,40.0%,56m
28541,1,Victormik,2580,0,2,3,5,40.0%,1h
28541,2,SuicideKing,2580,0,1,1,2,50.0%,27m
28541,2,Devil,2580,0,1,1,2,50.0%,1h
28541,2,Hype,2580,0,1,5,6,16.7%,3m
28541,1,Illu,2580,40,1,8,9,11.1%,1h
28541,2,Ciniyzayac,2580,0,0,1,1,0.0%,1h
28541,2,raz,2580,0,0,1,1,0.0%,1h
28541,1,[LiEtUs]CrazyCow,2580,0,0,3,3,0.0%,12m
28541,2,StonedKaze,2580,0,0,3,3,0.0%,1h
28570,1,DiMan,2579,1642,234,221,455,51.4%,8m
28570,1,YoShi,2579,1592,109,112,221,49.3%,12m
28570,1,eclipse,2579,953,78,70,148,52.7%,57m
28570,3,Lester,2579,1338,76,73,149,51.0%,20m
28570,2,SunKilMoon,2579,1144,55,45,100,55.0%,4m
28570,1,JEKHAMMER,2579,1359,49,56,105,46.7%,1h
28570,2,seantrollip,2579,1166,46,42,88,52.3%,56m
28570,2,fgg,2579,804,35,27,62,56.5%,1h
28570,1,POStishka,2579,474,20,19,39,51.3%,5m
28570,2,CigarlightR,2579,382,18,5,23,78.3%,19m
28570,2,Unrealfff,2579,378,16,9,25,64.0%,26m
28570,2,[Dahu]Aleksander,2579,359,15,10,25,60.0%,1h
28570,2,дИтонатор,2579,373,12,12,24,50.0%,1h
28570,2,Koala,2579,228,9,8,17,52.9%,1h
28570,2,serdjao,2579,234,9,9,18,50.0%,16m
28570,2,Cra,2579,230,9,12,21,42.9%,21m
28570,2,[O4FUN]Cyngiel,2579,46,4,7,11,36.4%,16m
28570,2,SpecialTea,2579,126,3,2,5,60.0%,1h
28570,2,Rendoom,2579,98,3,2,5,60.0%,9m
28570,1,[MeMi]Wolfman,2579,89,3,5,8,37.5%,1h
28570,3,happyfaceAR,2579,136,3,10,13,23.1%,4m
28570,2,[TTDK]Egon,2579,88,2,0,2,100.0%,27m
28570,2,DestroyerPL,2579,0,1,0,1,100.0%,1h
28570,2,kukruss,2579,0,1,1,2,50.0%,57m
28570,2,TPmanHD,2579,0,1,1,2,50.0%,1h
28570,1,Jocky,2579,32,1,7,8,12.5%,8m
28570,2,barCODE,2579,0,0,1,1,0.0%,25m
28570,2,[XET]Kayser,2579,0,0,4,4,0.0%,1h
28570,2,BabaYaga,2579,0,0,4,4,0.0%,18m
28599,3,Aathos,2578,1160,150,156,306,49.0%,13m
28599,3,Scorp,2578,1348,93,102,195,47.7%,11m
28599,3,FluffyTail,2578,1050,72,74,146,49.3%,23m
28599,2,MrRobot,2578,989,45,39,84,53.6%,1h
28599,1,rorog,2578,316,40,47,87,46.0%,12m
28599,1,memoöst,2578,918,31,37,68,45.6%,21m
28599,2,[FloFan]ferox,2578,332,12,9,21,57.1%,1h
28599,2,Bot,2578,289,12,12,24,50.0%,3m
28599,1,PUTIN,2578,331,10,13,23,43.5%,1h
28599,1,[2iq]Daniik,2578,250,8,4,12,66.7%,6m
28599,2,Kazael,2578,222,8,10,18,44.4%,1h
28599,3,[IG4]Masame,2578,244,8,18,26,30.8%,25m
28599,2,csalol,2578,117,4,0,4,100.0%,15m
28599,2,[FoRiGr]winer,2578,90,4,3,7,57.1%,18m
28599,2,SpaceRanger,2578,125,4,9,13,30.8%,1h
28599,2,Elivert,2578,0,2,4,6,33.3%,19m
28599,2,Ezio,2578,0,1,0,1,100.0%,1h
28599,2,[TSmash]Potato,2578,0,1,1,2,50.0%,1h
28599,2,NinjaStar,2578,88,1,1,2,50.0%,1h
28599,2,Triflest,2578,30,1,2,3,33.3%,8m
28599,2,astrobeglec,2578,0,1,3,4,25.0%,1h
28599,2,Vortsok,2578,0,1,4,5,20.0%,26m
28599,2,Убивец,2578,30,1,5,6,16.7%,1h
28599,2,MrMozaic,2578,0,0,1,1,0.0%,55m
28599,1,Solomon,2578,0,0,1,1,0.0%,1h
28599,2,Talento,2578,0,0,2,2,0.0%,1h
28599,3,Parzival,2578,0,0,2,2,0.0%,1h
28626,3,Zeus,2577,1540,268,257,525,51.0%,2m
28626,1,nonaps,2577,1570,165,156,321,51.4%,55m
28626,1,Beren,2577,1655,140,141,281,49.8%,21m
28626,1,Paul,2577,1172,119,119,238,50.0%,1h
28626,2,SvenGoonsen,2577,1365,67,71,138,48.6%,26m
28626,2,aiur,2577,724,40,8,48,83.3%,5m
28626,2,RTFM,2577,972,40,33,73,54.8%,19m
28626,2,fxxkYamato,2577,651,25,24,49,51.0%,16m
28626,2,[EV]Jabugo,2577,513,22,23,45,48.9%,1h
28626,2,fintadzija,2577,445,16,13,29,55.2%,1h
28626,2,Zasz,2577,189,15,14,29,51.7%,59m
28626,2,KillerQueen,2577,397,14,12,26,53.8%,1h
28626,1,Maison,2577,364,12,9,21,57.1%,26m
28626,2,Elpiafou,2577,151,12,15,27,44.4%,1h
28626,1,[C0cks]Martoni,2577,344,10,17,27,37.0%,1h
28626,1,Bandit,2577,236,8,11,19,42.1%,59m
28626,2,Анжелойд,2577,204,7,4,11,63.6%,4m
28626,2,fofful,2577,214,7,7,14,50.0%,21m
28626,2,[ISRI]Titano,2577,143,6,0,6,100.0%,22m
28626,3,Joker,2577,181,6,5,11,54.5%,1h
28626,1,kilouck,2577,192,5,2,7,71.4%,25m
28626,1,Geronimo,2577,184,5,12,17,29.4%,1h
28626,1,[7AR0]MadFace,2577,0,3,4,7,42.9%,1h
28626,3,MikeFromWork,2577,34,3,5,8,37.5%,1h
28626,2,Betrezen,2577,96,2,2,4,50.0%,58m
28626,2,Азазелло,2577,0,2,3,5,40.0%,55m
28626,2,[Z0diaX]LNentrix,2577,0,1,0,1,100.0%,1h
28626,2,[AnimeG]Onichan,2577,0,1,1,2,50.0%,1h
28626,2,brtk,2577,0,1,1,2,50.0%,25m
28626,2,[LoveYa]JoOLz,2577,30,1,2,3,33.3%,1h
28626,2,DiabloP,2577,30,1,3,4,25.0%,1h
28626,2,amondo,2577,0,0,3,3,0.0%,19m
28658,1,Zel,2576,1525,125,128,253,49.4%,11m
28658,3,Carl,2576,1406,93,90,183,50.8%,20m
28658,2,[cgn200]Tiger,2576,1557,65,60,125,52.0%,21m
28658,1,[ZgEgZ]Herwil,2576,1475,64,65,129,49.6%,1h
28658,2,[MPTS]axelrod,2576,1248,45,47,92,48.9%,1h
28658,2,[PPoRR]iMpAcT,2576,1000,44,30,74,59.5%,21m
28658,2,Telope,2576,245,34,23,57,59.6%,16m
28658,1,IVvoNation,2576,781,34,32,66,51.5%,1h
28658,3,darst,2576,427,13,22,35,37.1%,12m
28658,3,Mood,2576,315,12,14,26,46.2%,4m
28658,2,[Nagplz]JellyBear,2576,215,8,4,12,66.7%,1h
28658,1,Joefish,2576,252,8,11,19,42.1%,1h
28658,2,NaCly,2576,252,6,7,13,46.2%,1h
28658,1,BOTasd,2576,102,5,6,11,45.5%,27m
28658,2,Blairwitch,2576,128,4,1,5,80.0%,55m
28658,3,DéFéo,2576,97,4,3,7,57.1%,1h
28658,3,Alfegard,2576,74,4,6,10,40.0%,1h
28658,2,gambit,2576,0,3,2,5,60.0%,19m
28658,2,CRISTIAN,2576,94,3,2,5,60.0%,1h
28658,2,SEKİLSİNYA,2576,30,3,4,7,42.9%,5m
28658,2,cyrlau,2576,30,2,2,4,50.0%,3m
28658,2,Smasher,2576,107,2,2,4,50.0%,1h
28658,3,CONTAAAAACT,2576,0,2,3,5,40.0%,1h
28658,2,NUDEXxX,2576,32,2,4,6,33.3%,15m
28658,2,Bekele,2576,93,2,4,6,33.3%,1h
28658,3,NetSpociak,2576,0,2,4,6,33.3%,1h
28658,2,Chris,2576,0,2,4,6,33.3%,4m
28658,2,nomah,2576,40,2,6,8,25.0%,4m
28658,3,[7I0]baraXXobama,2576,30,2,15,17,11.8%,25m
28658,1,TSGXBOT,2576,0,1,0,1,100.0%,2m
28658,3,Bred,2576,42,1,2,3,33.3%,4m
28658,1,MEHTEC,2576,36,1,8,9,11.1%,7m
28658,2,[ŁBD]Outlander,2576,0,0,1,1,0.0%,1h
28658,3,Лейс,2576,0,0,1,1,0.0%,4m
28658,2,Tassadar,2576,0,0,2,2,0.0%,1h
28658,2,Yevhenii,2576,0,0,2,2,0.0%,26m
28658,2,rickstar,2576,0,0,3,3,0.0%,8m
28695,3,DIMES,2575,1448,161,158,319,50.5%,13m
28695,1,karwal,2575,1543,85,80,165,51.5%,1h
28695,2,McNuggets,2575,571,71,68,139,51.1%,15m
28695,2,Bacillus,2575,1509,65,62,127,51.2%,20m
28695,3,[ǂMWRǂ]GoOn,2575,1161,50,59,109,45.9%,16m
28695,2,RTS,2575,920,43,34,77,55.8%,2m
28695,1,vanturak,2575,979,36,40,76,47.4%,10m
28695,2,Anthony,2575,244,21,10,31,67.7%,16m
28695,2,AMFad,2575,550,21,22,43,48.8%,1h
28695,2,sarahpelle,2575,493,20,17,37,54.1%,1h
28695,1,Shango,2575,605,19,23,42,45.2%,14m
28695,2,IIIIIIIIIIII,2575,183,8,5,13,61.5%,1h
28695,2,дэнчик,2575,130,5,0,5,100.0%,55m
28695,2,[BELSCF]Ragavand,2575,141,5,1,6,83.3%,27m
28695,2,RushMeSlowly,2575,186,5,3,8,62.5%,16m
28695,2,Lukutus,2575,132,4,5,9,44.4%,1h
28695,2,Ymura,2575,60,3,3,6,50.0%,1h
28695,2,Yarrak,2575,64,3,3,6,50.0%,19m
28695,3,Quicly,2575,0,3,5,8,37.5%,11m
28695,1,JazzCatFunk,2575,32,3,6,9,33.3%,21m
28695,2,Highlander,2575,88,2,0,2,100.0%,23m
28695,2,Lane,2575,0,2,3,5,40.0%,56m
28695,3,[Inval]Betrezen,2575,0,1,0,1,100.0%,1h
28695,2,[SC22SC]Ptik,2575,88,1,1,2,50.0%,2m
28695,2,Qwert,2575,0,0,1,1,0.0%,1h
28720,2,GHOST,2574,1580,173,167,340,50.9%,1h
28720,2,Jim,2574,916,86,78,164,52.4%,57m
28720,2,[epiXX]DerDeutsche,2574,997,60,55,115,52.2%,14m
28720,2,[TExGG]Slitless,2574,659,48,37,85,56.5%,1h
28720,1,Keter,2574,958,42,34,76,55.3%,1h
28720,2,Liksio,2574,783,41,22,63,65.1%,8m
28720,1,saber,2574,873,34,38,72,47.2%,1h
28720,2,Белодух,2574,206,31,22,53,58.5%,1h
28720,2,KptPałkarz,2574,461,26,25,51,51.0%,4m
28720,2,[TGosuB]halcyonic,2574,606,25,27,52,48.1%,7m
28720,2,PinGponGnE,2574,374,15,17,32,46.9%,1h
28720,3,nikitosa,2574,393,15,20,35,42.9%,20m
28720,2,Maurice,2574,307,14,4,18,77.8%,15m
28720,3,[панда]zErLONG,2574,282,9,10,19,47.4%,1h
28720,3,MAJARIL,2574,210,8,11,19,42.1%,16m
28720,2,[mfxed]Onceinalife,2574,154,6,2,8,75.0%,1h
28720,2,Toninho,2574,182,6,7,13,46.2%,15m
28720,2,GOVOG,2574,0,4,1,5,80.0%,15m
28720,2,Ragnaro,2574,42,3,7,10,30.0%,4m
28720,1,MCG,2574,46,2,0,2,100.0%,26m
28720,2,Sager,2574,131,2,1,3,66.7%,1h
28720,2,Deluxo,2574,0,2,3,5,40.0%,26m
28720,2,Twiggy,2574,0,2,3,5,40.0%,1h
28720,2,shador,2574,0,1,0,1,100.0%,18m
28720,3,marKastrator,2574,0,1,0,1,100.0%,1h
28720,3,[I2x2I]SaSHko,2574,0,1,3,4,25.0%,58m
28720,2,Riptsuki,2574,0,0,2,2,0.0%,1h
28720,2,Set,2574,0,0,2,2,0.0%,57m
28720,2,[dlgc]Venom,2574,0,0,3,3,0.0%,1h
28720,1,Sergiiik,2574,0,0,3,3,0.0%,3m
28750,1,Varilite,2573,1643,595,603,1198,49.7%,1h
28750,2,Pho,2573,1594,116,110,226,51.3%,1h
28750,1,topwar,2573,1387,100,85,185,54.1%,1h
28750,1,SuNkolsh,2573,1223,100,103,203,49.3%,4m
28750,1,Rettenetes,2573,1627,90,87,177,50.8%,20m
28750,2,[Energy]Svenove,2573,1554,84,77,161,52.2%,20m
28750,1,Ozarsif,2573,1541,82,86,168,48.8%,16m
28750,2,MaSeGe,2573,1140,68,52,120,56.7%,1h
28750,2,ThomasYato,2573,825,52,34,86,60.5%,1h
28750,1,TheSpurge,2573,909,38,40,78,48.7%,27m
28750,2,IIIIIIIIIIII,2573,728,36,27,63,57.1%,27m
28750,2,OldStudent,2573,295,11,14,25,44.0%,58m
28750,1,[WАSD]Hasll,2573,288,10,9,19,52.6%,1h
28750,1,Dolphin,2573,358,10,19,29,34.5%,1h
28750,1,[WoLA]EKzyis,2573,256,9,11,20,45.0%,21m
28750,1,Alberts,2573,313,9,15,24,37.5%,11m
28750,2,[Freeze]Protec,2573,120,5,5,10,50.0%,4m
28750,2,FlaiM,2573,94,5,8,13,38.5%,24m
28750,2,JunSK,2573,102,4,3,7,57.1%,26m
28750,2,Rafik,2573,122,4,5,9,44.4%,15m
28750,2,YukiHyou,2573,138,3,3,6,50.0%,4m
28750,2,HoWercraft,2573,30,3,4,7,42.9%,1h
28750,2,[tagtag]ehd,2573,60,3,6,9,33.3%,1h
28750,2,Psyhomaster,2573,102,2,1,3,66.7%,1h
28750,3,Wojax,2573,0,2,4,6,33.3%,1h
28750,1,glhf,2573,72,2,10,12,16.7%,1h
28750,2,Guardian,2573,0,1,0,1,100.0%,59m
28750,2,NEUMANN,2573,0,1,0,1,100.0%,1h
28750,2,Yleesar,2573,0,1,3,4,25.0%,1h
28750,2,Youdas,2573,0,0,1,1,0.0%,1h
28750,1,Solyz,2573,0,0,1,1,0.0%,2m
28750,2,Nandi,2573,0,0,1,1,0.0%,10m
28750,2,Superoffi,2573,0,0,1,1,0.0%,1h
28750,2,Adam,2573,0,0,1,1,0.0%,1h
28750,2,Soldjah,2573,0,0,2,2,0.0%,1h
28750,2,stason,2573,0,0,3,3,0.0%,1h
28786,2,ilusha,2572,1549,177,165,342,51.8%,18m
28786,2,Skabad,2572,1102,69,60,129,53.5%,22m
28786,1,ValMar,2572,1443,69,64,133,51.9%,1h
28786,2,Timur,2572,1128,47,48,95,49.5%,1h
28786,2,[DL2006]Arturo,2572,408,29,27,56,51.8%,57m
28786,2,Dragonborn,2572,582,26,14,40,65.0%,1h
28786,2,Csuda,2572,564,25,19,44,56.8%,1h
28786,2,[ExTr1m]LeoN,2572,514,24,11,35,68.6%,15m
28786,3,Saric,2572,648,22,34,56,39.3%,22m
28786,1,Smr,2572,572,19,25,44,43.2%,15m
28786,2,DanTan,2572,392,12,19,31,38.7%,19m
28786,2,[HBeS]youngKami,2572,168,6,3,9,66.7%,7m
28786,2,ZZsuperZero,2572,141,4,3,7,57.1%,1h
28786,2,NonoW,2572,90,4,4,8,50.0%,7m
28786,2,Geloway,2572,60,4,5,9,44.4%,4m
28786,2,Revorm,2572,58,3,3,6,50.0%,26m
28786,2,[IBTC]sweetback,2572,0,3,6,9,33.3%,24m
28786,2,BlueberryYum,2572,58,2,5,7,28.6%,1h
28786,2,Auslander,2572,0,1,0,1,100.0%,21m
28786,2,exelica,2572,0,1,1,2,50.0%,1h
28786,2,Melfch,2572,30,1,2,3,33.3%,1h
28786,2,RuSH,2572,30,1,2,3,33.3%,15m
28786,2,jacklokki,2572,30,1,2,3,33.3%,1h
28786,1,VRdog,2572,36,1,8,9,11.1%,21m
28786,2,Ares,2572,0,0,1,1,0.0%,1h
28786,3,toss,2572,0,0,1,1,0.0%,1h
28786,1,[НК]Evgeny,2572,0,0,1,1,0.0%,1h
28786,2,[0eN0]Katzenkoenig,2572,0,0,5,5,0.0%,57m
28814,2,ChivasMan,2571,1635,103,99,202,51.0%,1h
28814,2,Tagger,2571,1481,84,80,164,51.2%,1h
28814,2,Jarnland,2571,1571,71,71,142,50.0%,12m
28814,2,FROSTLIBERTY,2571,1398,68,46,114,59.6%,1h
28814,2,Jogurt,2571,1153,56,51,107,52.3%,1h
28814,1,Naktul,2571,1379,48,51,99,48.5%,1h
28814,1,starkraftys,2571,1022,45,43,88,51.1%,1h
28814,2,MegaHuhn,2571,1000,42,30,72,58.3%,21m
28814,2,Motylia,2571,851,32,32,64,50.0%,1h
28814,2,Realterm,2571,904,32,33,65,49.2%,9m
28814,2,Bramoglot,2571,481,31,19,50,62.0%,15m
28814,2,[Pogo]Ecclebert,2571,756,30,24,54,55.6%,3m
28814,2,FetisoFF,2571,670,24,25,49,49.0%,23m
28814,2,Umbra,2571,390,21,14,35,60.0%,17m
28814,1,Teimceper,2571,560,19,23,42,45.2%,12m
28814,2,inexxt,2571,461,16,16,32,50.0%,4m
28814,1,[DWTeam]MeteorikDisk,2571,396,13,18,31,41.9%,59m
28814,2,Nicitel,2571,302,11,11,22,50.0%,1h
28814,2,ALkoNAfT,2571,292,11,13,24,45.8%,1h
28814,2,ЛизниКабана,2571,257,8,7,15,53.3%,18m
28814,3,Zerg,2571,146,6,3,9,66.7%,1h
28814,2,ApeIIIeK,2571,148,6,6,12,50.0%,9m
28814,2,klopereczek,2571,116,6,7,13,46.2%,25m
28814,2,[ESOT]TiMaN,2571,122,5,6,11,45.5%,1h
28814,1,Sateri,2571,94,5,12,17,29.4%,26m
28814,3,Cirpone,2571,159,4,6,10,40.0%,1h
28814,3,[TZCrew]Linkoulou,2571,0,3,4,7,42.9%,4m
28814,2,The,2571,58,2,3,5,40.0%,21m
28814,2,SantelYoung,2571,0,2,3,5,40.0%,56m
28814,2,Klovn,2571,0,2,4,6,33.3%,25m
28814,2,Artem,2571,0,1,1,2,50.0%,1h
28814,2,[Dralag]NeroDeath,2571,0,0,1,1,0.0%,1h
28814,2,LeBrush,2571,0,0,1,1,0.0%,1h
28847,2,JOHAN,2570,1568,96,102,198,48.5%,12m
28847,2,ivga,2570,1455,63,47,110,57.3%,59m
28847,2,LNANCN,2570,1305,61,33,94,64.9%,26m
28847,2,Bucket,2570,792,50,44,94,53.2%,1h
28847,2,KisSziszi,2570,899,39,34,73,53.4%,17m
28847,2,JaninaDefekt,2570,852,35,30,65,53.8%,2m
28847,1,SecdThought,2570,1012,35,39,74,47.3%,12m
28847,1,VACSS,2570,231,30,27,57,52.6%,1h
28847,1,Raynor,2570,849,29,32,61,47.5%,21m
28847,2,woocache,2570,547,21,17,38,55.3%,1h
28847,2,FAFICO,2570,471,20,10,30,66.7%,10m
28847,3,MrNoob,2570,447,20,24,44,45.5%,14m
28847,1,antichronia,2570,293,10,11,21,47.6%,1h
28847,2,OmniKai,2570,267,9,10,19,47.4%,26m
28847,2,thanel,2570,170,6,7,13,46.2%,1h
28847,2,LearnToPlay,2570,155,5,5,10,50.0%,1h
28847,2,Virgo,2570,132,4,7,11,36.4%,13m
28847,2,HolyPotato,2570,92,4,8,12,33.3%,8m
28847,3,Erri,2570,127,3,1,4,75.0%,10m
28847,1,Eljy,2570,30,3,6,9,33.3%,1h
28847,2,[AOWT]Starlight,2570,96,2,0,2,100.0%,1h
28847,2,Fakker,2570,0,2,5,7,28.6%,1h
28847,1,evgen,2570,34,2,5,7,28.6%,59m
28847,2,ReiVaX,2570,0,1,0,1,100.0%,1h
28847,2,[KrfnG]Divider,2570,0,1,0,1,100.0%,1h
28847,2,Farkal,2570,0,1,1,2,50.0%,24m
28847,2,Chiino,2570,0,1,1,2,50.0%,1h
28847,2,[ProRax]Heiligkeit,2570,42,1,2,3,33.3%,1h
28847,2,Blueice,2570,30,1,4,5,20.0%,1h
28847,2,Aizen,2570,30,1,4,5,20.0%,1h
28847,2,TheDolphin,2570,0,0,3,3,0.0%,1h
28878,1,masterofmen,2569,1549,155,152,307,50.5%,8m
28878,3,[B3ard]Dontyr,2569,857,76,81,157,48.4%,5m
28878,2,[TC58]xLuisitox,2569,1562,74,77,151,49.0%,1h
28878,2,filthyhero,2569,963,69,60,129,53.5%,1h
28878,1,[duKn0w]Rongemort,2569,1412,63,52,115,54.8%,1h
28878,2,Rafael,2569,1488,61,56,117,52.1%,1h
28878,2,Huang,2569,1013,45,43,88,51.1%,9m
28878,3,ТРЕНДЕ,2569,837,34,43,77,44.2%,23m
28878,1,WhiteSpirit,2569,782,29,29,58,50.0%,4m
28878,2,ogy,2569,430,26,22,48,54.2%,1h
28878,2,Amberman,2569,626,24,24,48,50.0%,1h
28878,2,Imperator,2569,412,21,16,37,56.8%,1h
28878,1,Рукожопище,2569,525,21,19,40,52.5%,1h
28878,1,boubiba,2569,429,16,20,36,44.4%,12m
28878,2,LebenAmLimes,2569,500,15,19,34,44.1%,1h
28878,1,[BLMSTR]Viking,2569,402,13,15,28,46.4%,1h
28878,2,Seniorritter,2569,324,13,15,28,46.4%,59m
28878,2,KeepCaIm,2569,266,7,9,16,43.8%,1h
28878,2,[AFFE]Casstig,2569,175,5,7,12,41.7%,8m
28878,2,Natural,2569,144,5,9,14,35.7%,1h
28878,2,Powerflower,2569,138,3,3,6,50.0%,1h
28878,3,Lex,2569,157,3,4,7,42.9%,27m
28878,2,Umbre,2569,93,3,5,8,37.5%,56m
28878,2,Ckitalec,2569,88,2,0,2,100.0%,1h
28878,1,[GtLcky]lotto,2569,0,2,3,5,40.0%,1h
28878,1,[Tonin]hazteunoya,2569,0,2,3,5,40.0%,5m
28878,2,pupamenuk,2569,30,2,3,5,40.0%,7m
28878,3,Kydraviy,2569,0,2,7,9,22.2%,3m
28878,1,bob,2569,0,1,2,3,33.3%,3m
28878,2,Чэмп,2569,0,0,1,1,0.0%,26m
28878,2,[VGW]Merako,2569,0,0,2,2,0.0%,1h
28878,1,Feuerfresser,2569,0,0,3,3,0.0%,1h
28910,2,TengriLetho,2568,1565,244,252,496,49.2%,12m
28910,3,FatTony,2568,1536,87,94,181,48.1%,13m
28910,2,Upallinsky,2568,821,67,50,117,57.3%,4m
28910,3,MayDayBear,2568,1404,56,66,122,45.9%,24m
28910,1,dimacell,2568,802,43,44,87,49.4%,26m
28910,2,kokopop,2568,814,30,27,57,52.6%,1h
28910,2,iHaTEChEESE,2568,308,26,26,52,50.0%,1h
28910,2,[LMBD]cderici,2568,502,25,6,31,80.6%,57m
28910,2,TevenSon,2568,236,21,17,38,55.3%,9m
28910,2,Tajor,2568,369,20,11,31,64.5%,57m
28910,2,Razor,2568,462,16,19,35,45.7%,1h
28910,1,Jason,2568,273,11,12,23,47.8%,1h
28910,2,zendelphi,2568,223,9,5,14,64.3%,1h
28910,1,[dankxD]Mestat,2568,217,7,11,18,38.9%,1h
28910,3,IBAK,2568,147,6,3,9,66.7%,27m
28910,3,Freeman,2568,181,5,6,11,45.5%,1h
28910,2,[LMBD]Arlen,2568,135,4,5,9,44.4%,4m
28910,2,ANIKI,2568,119,3,4,7,42.9%,1h
28910,3,Neo,2568,92,3,5,8,37.5%,12m
28910,2,gusak,2568,96,3,7,10,30.0%,6m
28910,3,frantic,2568,34,2,0,2,100.0%,1h
28910,2,Rayaxir,2568,88,2,0,2,100.0%,1h
28910,3,Stebulba,2568,0,2,4,6,33.3%,5m
28910,2,FlutterGuy,2568,60,2,4,6,33.3%,18m
28910,2,ElektroGrone,2568,0,1,0,1,100.0%,59m
28910,2,Asgazyl,2568,88,1,1,2,50.0%,1h
28910,2,Foosa,2568,0,1,1,2,50.0%,1h
28910,3,Dima,2568,0,1,1,2,50.0%,18m
28910,1,[P47]Exterminador,2568,40,1,8,9,11.1%,1h
28910,2,[Kboom]karkarak,2568,0,0,1,1,0.0%,1h
28940,3,Ozzy,2567,814,101,104,205,49.3%,25m
28940,2,Crowye,2567,1334,90,104,194,46.4%,10m
28940,1,Колдырь,2567,1385,51,52,103,49.5%,1h
28940,1,Fury,2567,1362,48,53,101,47.5%,1h
28940,2,WelcomtoHell,2567,922,42,39,81,51.9%,1h
28940,2,juanblas,2567,758,32,25,57,56.1%,19m
28940,2,[Heroes]CapnCrunch,2567,739,31,23,54,57.4%,3m
28940,1,DSRinger,2567,584,19,25,44,43.2%,56m
28940,1,Anubi,2567,432,17,18,35,48.6%,4m
28940,1,[EKB117]RhaTau,2567,114,4,13,17,23.5%,8m
28940,2,VladIsLove,2567,127,3,4,7,42.9%,21m
28940,3,[OBSCU]grimdor,2567,0,3,5,8,37.5%,22m
28940,2,analcarnaval,2567,0,2,1,3,66.7%,15m
28940,2,DenSun,2567,114,2,2,4,50.0%,4m
28940,1,herald,2567,48,2,4,6,33.3%,1h
28940,3,Porky,2567,0,2,4,6,33.3%,1h
28940,2,MyTrouble,2567,0,2,4,6,33.3%,57m
28940,2,[FILI]ulTraShoT,2567,0,1,0,1,100.0%,15m
28940,2,MistyMaster,2567,0,1,0,1,100.0%,1h
28940,2,BIGKINGWIN,2567,88,1,1,2,50.0%,9m
28940,3,meech,2567,0,1,1,2,50.0%,1h
28940,3,[ETU]Pololo,2567,40,1,2,3,33.3%,19m
28940,1,[MCAtk]Mcson,2567,0,1,3,4,25.0%,1h
28940,2,Manetere,2567,30,1,4,5,20.0%,7m
28940,2,KalendOr,2567,0,0,2,2,0.0%,1h
28940,2,KugOb,2567,0,0,2,2,0.0%,1h
28966,2,Magnum,2566,1505,89,56,145,61.4%,1h
28966,3,romanono,2566,369,56,59,115,48.7%,22m
28966,2,JayAtPlay,2566,888,34,33,67,50.7%,1h
28966,2,TriStaN,2566,450,25,20,45,55.6%,21m
28966,1,Conqueror,2566,697,23,28,51,45.1%,27m
28966,1,Zenker,2566,648,22,25,47,46.8%,59m
28966,1,MarineBaby,2566,392,19,20,39,48.7%,58m
28966,1,Kuber,2566,141,15,24,39,38.5%,4m
28966,2,Sanguinius,2566,353,13,11,24,54.2%,21m
28966,2,[Блэт]Ratchetggvp,2566,345,12,11,23,52.2%,1h
28966,2,Troop,2566,168,8,6,14,57.1%,1h
28966,2,губошлеп,2566,90,6,11,17,35.3%,6m
28966,2,DrunkPhysics,2566,135,3,4,7,42.9%,4m
28966,2,Kizo,2566,119,3,4,7,42.9%,1h
28966,1,Tattletale,2566,96,2,3,5,40.0%,1h
28966,2,Maverick,2566,30,2,4,6,33.3%,56m
28966,3,BACAPAKAL,2566,121,2,5,7,28.6%,1h
28966,2,BossaNova,2566,60,2,6,8,25.0%,24m
28966,3,[CJFF]Terror,2566,123,2,7,9,22.2%,1h
28966,1,[Ark]Dariox,2566,78,2,9,11,18.2%,1h
28966,2,tartusio,2566,0,1,0,1,100.0%,1h
28966,2,mkubjk,2566,0,1,0,1,100.0%,6m
28966,2,BadAdmin,2566,88,1,1,2,50.0%,21m
28966,2,стас,2566,0,1,1,2,50.0%,10m
28966,2,Gliese,2566,30,1,3,4,25.0%,1h
28966,2,Celofan,2566,0,1,4,5,20.0%,7m
28966,2,subserver,2566,88,1,6,7,14.3%,1h
28966,3,BaXToR,2566,0,0,1,1,0.0%,18m
28966,2,Jindříšek,2566,0,0,1,1,0.0%,14m
28966,2,[OU74]OnTuxyucT,2566,0,0,4,4,0.0%,27m
28996,2,PrЧ,2565,678,62,57,119,52.1%,1h
28996,1,TODMUK,2565,1187,45,56,101,44.6%,1h
28996,1,Ahrono,2565,958,35,36,71,49.3%,55m
28996,2,FNCJJ,2565,515,20,15,35,57.1%,1h
28996,2,carnuis,2565,460,15,19,34,44.1%,9m
28996,2,Akira,2565,259,12,5,17,70.6%,15m
28996,2,CapCommander,2565,252,12,14,26,46.2%,5m
28996,1,TAIMEZ,2565,158,7,10,17,41.2%,1h
28996,3,Qioh,2565,169,6,6,12,50.0%,19m
28996,2,[SLW]PIGNATA,2565,142,5,3,8,62.5%,1h
28996,2,Furiafelipe,2565,146,5,6,11,45.5%,1h
28996,1,Enato,2565,48,4,2,6,66.7%,20m
28996,2,Slava,2565,86,4,4,8,50.0%,1h
28996,2,[cArB0t]EleAnOr,2565,94,4,6,10,40.0%,12m
28996,2,Raijinshuu,2565,102,3,1,4,75.0%,1h
28996,2,Raush,2565,112,3,1,4,75.0%,1h
28996,2,[KrnBrs]Relax,2565,60,3,2,5,60.0%,1h
28996,2,[DBTav]arrassa,2565,90,3,7,10,30.0%,1h
28996,2,Mienski,2565,88,2,0,2,100.0%,1h
28996,1,JJD,2565,38,2,7,9,22.2%,1h
28996,2,GidraLisk,2565,0,1,0,1,100.0%,1h
28996,2,MercyHentai,2565,0,1,2,3,33.3%,26m
28996,2,cakal,2565,30,1,2,3,33.3%,1h
28996,2,Victor,2565,30,1,6,7,14.3%,26m
28996,2,Lokiknight,2565,0,0,1,1,0.0%,17m
28996,2,Marcel,2565,0,0,1,1,0.0%,17m
29022,1,kitrab,2564,1624,244,248,492,49.6%,1h
29022,1,Zebulon,2564,1629,210,204,414,50.7%,1h
29022,2,Rush,2564,1018,75,70,145,51.7%,12m
29022,2,Стрелок,2564,609,54,54,108,50.0%,1h
29022,2,[FKSD]Anakin,2564,1238,46,47,93,49.5%,24m
29022,3,SSF,2564,1180,42,53,95,44.2%,5m
29022,2,Vasyan,2564,938,37,35,72,51.4%,15m
29022,2,Zombie,2564,751,31,30,61,50.8%,20m
29022,2,[WINZ1]BirdRaymond,2564,505,25,17,42,59.5%,1h
29022,1,alko,2564,272,19,31,50,38.0%,16m
29022,1,DaRoach,2564,554,17,25,42,40.5%,22m
29022,1,Adolf,2564,564,17,26,43,39.5%,11m
29022,2,Blackfish,2564,449,14,20,34,41.2%,15m
29022,2,[ApKorv]Boorran,2564,315,13,11,24,54.2%,4m
29022,2,[MoLa]Moskito,2564,366,12,12,24,50.0%,26m
29022,2,Фадден,2564,283,10,10,20,50.0%,15m
29022,1,[SKRRR]Edv,2564,272,10,10,20,50.0%,1h
29022,2,[DUPAx]zzabakk,2564,302,9,9,18,50.0%,25m
29022,2,LosTime,2564,242,8,7,15,53.3%,1h
29022,2,zerf,2564,202,5,6,11,45.5%,21m
29022,2,AlohaDron,2564,86,5,7,12,41.7%,21m
29022,2,Krupek,2564,102,4,4,8,50.0%,1h
29022,3,zrood,2564,147,4,6,10,40.0%,20m
29022,1,[DBko]DiBi,2564,121,3,4,7,42.9%,3m
29022,1,Quaor,2564,121,3,4,7,42.9%,11m
29022,2,Stefananna,2564,58,3,5,8,37.5%,9m
29022,3,[D0N3]Paaasc,2564,97,2,0,2,100.0%,10m
29022,2,reaktor,2564,0,1,1,2,50.0%,1h
29022,2,Serjant,2564,0,1,1,2,50.0%,27m
29022,2,[KLINK]Toshiro,2564,30,1,4,5,20.0%,1h
29022,2,Kinkade,2564,96,1,4,5,20.0%,1h
29022,3,[ЧёрЛег]GiantDwarf,2564,0,1,4,5,20.0%,1h
29022,3,benji,2564,0,0,1,1,0.0%,21m
29022,2,Kyznec,2564,0,0,2,2,0.0%,1h
29056,1,[FUNTY]hbq,2563,1627,214,186,400,53.5%,22m
29056,3,Brice,2563,1642,194,212,406,47.8%,7m
29056,3,LEONIDAS,2563,1441,122,121,243,50.2%,24m
29056,3,daddyou,2563,1563,88,101,189,46.6%,20m
29056,2,Hanuman,2563,1648,79,71,150,52.7%,1h
29056,1,ganger,2563,1594,78,72,150,52.0%,12m
29056,2,Bogoslavsky,2563,1044,70,68,138,50.7%,1h
29056,2,Rock,2563,405,63,44,107,58.9%,4m
29056,3,ВеселыйБамбу,2563,1075,58,62,120,48.3%,22m
29056,1,JudyMoncada,2563,1263,46,58,104,44.2%,7m
29056,2,Tron,2563,990,39,32,71,54.9%,1h
29056,2,ZDN,2563,688,26,29,55,47.3%,15m
29056,3,Lucky,2563,597,20,26,46,43.5%,17m
29056,2,Tusko,2563,423,16,17,33,48.5%,19m
29056,2,Tsydypov,2563,373,12,12,24,50.0%,1h
29056,2,MakisG,2563,316,12,14,26,46.2%,1h
29056,3,Teradion,2563,200,9,12,21,42.9%,20m
29056,1,Barnytwoo,2563,258,8,15,23,34.8%,7m
29056,1,Noormania,2563,240,7,14,21,33.3%,19m
29056,1,geilhart,2563,194,6,16,22,27.3%,1h
29056,2,раф,2563,123,3,5,8,37.5%,15m
29056,2,[Hrr]FrIsTaYl,2563,147,3,8,11,27.3%,20m
29056,2,GrumpyOwl,2563,30,2,1,3,66.7%,16m
29056,1,Fire,2563,0,2,3,5,40.0%,10m
29056,2,Insomnia,2563,0,2,4,6,33.3%,4m
29056,2,Bly,2563,0,1,0,1,100.0%,1h
29056,2,CharlieOH,2563,88,1,1,2,50.0%,12m
29056,2,Bartek,2563,88,1,1,2,50.0%,17m
29056,1,Temeraire,2563,48,1,1,2,50.0%,55m
29056,2,xdarkryan,2563,0,1,3,4,25.0%,1h
29056,2,Killer,2563,0,0,1,1,0.0%,1h
29056,2,GID,2563,0,0,2,2,0.0%,14m
29056,2,Schwerthelm,2563,0,0,2,2,0.0%,9m
29089,2,elga,2562,1602,163,149,312,52.2%,1h
29089,1,Vino,2562,1654,146,135,281,52.0%,1h
29089,2,[DASOUL]Smoker,2562,1581,135,125,260,51.9%,9m
29089,2,Loki,2562,1588,92,91,183,50.3%,4m
29089,1,Paladin,2562,1545,86,94,180,47.8%,15m
29089,3,PanzerS,2562,1439,77,90,167,46.1%,24m
29089,2,AdamZ,2562,1598,71,63,134,53.0%,1h
29089,2,HotRod,2562,1251,54,44,98,55.1%,1h
29089,2,tarvota,2562,846,38,26,64,59.4%,1h
29089,2,starlord,2562,893,38,29,67,56.7%,1h
29089,3,Riders,2562,684,29,25,54,53.7%,17m
29089,2,Axyrion,2562,655,27,23,50,54.0%,19m
29089,2,[goll]cedricBe,2562,527,23,16,39,59.0%,2m
29089,1,exone,2562,578,18,28,46,39.1%,26m
29089,3,BlackDir,2562,368,13,23,36,36.1%,21m
29089,2,[Sw1tch]Switch,2562,242,9,7,16,56.2%,23m
29089,2,Protosexual,2562,278,8,10,18,44.4%,1h
29089,1,Berbecu,2562,242,7,12,19,36.8%,1h
29089,2,[Kaiza]DriftKing,2562,168,6,3,9,66.7%,1h
29089,2,SilentSpy,2562,174,6,10,16,37.5%,1h
29089,2,LavaPiranha,2562,156,5,2,7,71.4%,26m
29089,1,Certhas,2562,184,5,9,14,35.7%,1h
29089,2,[Jöthem]Indominus,2562,88,4,4,8,50.0%,26m
29089,2,wanderhund,2562,100,3,3,6,50.0%,9m
29089,2,Kirby,2562,148,3,5,8,37.5%,1h
29089,2,PAULET,2562,0,2,0,2,100.0%,1h
29089,2,[ZV1992]BEISEL,2562,60,2,3,5,40.0%,1h
29089,3,science,2562,0,2,4,6,33.3%,60m
29089,1,Enot,2562,48,2,4,6,33.3%,1h
29089,3,OctoGone,2562,0,2,4,6,33.3%,20m
29089,2,[ephia]Erbinsmn,2562,30,1,2,3,33.3%,17m
29089,2,Haker,2562,0,0,1,1,0.0%,23m
29089,1,VorToN,2562,0,0,1,1,0.0%,1h
29089,3,[NordB]Trustich,2562,0,0,2,2,0.0%,1h
29123,2,Dannny,2561,914,173,169,342,50.6%,1h
29123,2,[bäret]Halbthyr,2561,1567,107,100,207,51.7%,25m
29123,1,Cellistina,2561,1609,107,101,208,51.4%,1h
29123,1,Choped,2561,1304,79,84,163,48.5%,1h
29123,2,Fubar,2561,632,55,49,104,52.9%,1h
29123,1,Freediver,2561,1230,45,48,93,48.4%,22m
29123,2,Dazamato,2561,1066,41,41,82,50.0%,1h
29123,2,Esuges,2561,851,37,27,64,57.8%,1h
29123,1,[KOMKAL]serrano,2561,795,30,29,59,50.8%,1h
29123,2,Efem,2561,285,29,34,63,46.0%,23m
29123,2,Victoire,2561,301,12,10,22,54.5%,23m
29123,1,Mishap,2561,350,11,13,24,45.8%,27m
29123,2,Wanderlust,2561,246,9,11,20,45.0%,22m
29123,2,ƷzpZ,2561,190,8,4,12,66.7%,1h
29123,2,[SoSaGe]jorrrrris,2561,118,5,5,10,50.0%,1h
29123,3,[LBGD]Decma,2561,146,4,5,9,44.4%,4m
29123,2,Grischa,2561,128,4,9,13,30.8%,17m
29123,2,[boși]Surgical,2561,0,3,2,5,60.0%,16m
29123,1,vladki,2561,0,3,2,5,60.0%,58m
29123,2,Lagonikós,2561,128,3,3,6,50.0%,1h
29123,2,Elculo,2561,107,3,4,7,42.9%,16m
29123,2,Timondell,2561,0,3,6,9,33.3%,19m
29123,2,indigo,2561,88,2,0,2,100.0%,1h
29123,2,Odessa,2561,30,2,1,3,66.7%,1h
29123,1,Hoschi,2561,46,2,3,5,40.0%,7m
29123,1,Baxtanidze,2561,0,2,3,5,40.0%,1h
29123,2,[NLeS]Xianeth,2561,0,2,4,6,33.3%,26m
29123,2,lackluck,2561,64,2,26,28,7.1%,20m
29123,2,[lBBTl]LeBon,2561,0,1,0,1,100.0%,1h
29123,2,MadaraCZ,2561,0,1,1,2,50.0%,1h
29123,2,delarosa,2561,42,1,2,3,33.3%,1h
29123,2,Endoplast,2561,0,1,4,5,20.0%,26m
29123,1,Valro,2561,0,1,4,5,20.0%,3m
29123,2,Nynjamek,2561,0,0,1,1,0.0%,58m
29123,2,iKILLEROK,2561,0,0,1,1,0.0%,1h
29123,3,Reaper,2561,0,0,1,1,0.0%,18m
29123,2,Deilius,2561,0,0,2,2,0.0%,1h
29160,2,pollux,2560,1616,214,208,422,50.7%,1h
29160,1,WellingW,2560,1642,194,192,386,50.3%,18m
29160,2,[xFRSx]Zorak,2560,1643,150,153,303,49.5%,4m
29160,2,OMEGABOOM,2560,1034,51,29,80,63.8%,15m
29160,1,[Obq]EightyFourGO,2560,897,34,36,70,48.6%,1h
29160,2,Omni,2560,659,29,22,51,56.9%,1h
29160,2,[YSG]Avenger,2560,460,29,25,54,53.7%,9m
29160,3,Buzzy,2560,890,29,41,70,41.4%,17m
29160,2,antcom,2560,481,26,21,47,55.3%,1h
29160,1,Fredykrueger,2560,678,23,25,48,47.9%,1h
29160,1,EduardKell,2560,476,15,23,38,39.5%,22m
29160,2,sprut,2560,425,14,14,28,50.0%,26m
29160,2,[SG8]Cepter,2560,225,9,10,19,47.4%,1h
29160,2,Timpunkampun,2560,202,9,13,22,40.9%,16m
29160,3,[Bleam]Mako,2560,196,7,10,17,41.2%,24m
29160,3,[TERIZM]TERRARIST,2560,114,5,0,5,100.0%,56m
29160,2,VinylRaider,2560,119,3,0,3,100.0%,1h
29160,2,Racoonboi,2560,88,3,4,7,42.9%,3m
29160,2,GazTR,2560,0,3,4,7,42.9%,56m
29160,2,Jency,2560,90,3,5,8,37.5%,1h
29160,2,Flakhx,2560,0,2,2,4,50.0%,1h
29160,1,killernorbi,2560,0,2,3,5,40.0%,11m
29160,3,Karlos,2560,0,2,4,6,33.3%,20m
29160,2,storm,2560,116,2,5,7,28.6%,1h
29160,2,Delta,2560,121,2,5,7,28.6%,27m
29160,2,AtomePrime,2560,0,1,0,1,100.0%,15m
29160,3,Servo,2560,0,1,0,1,100.0%,1h
29160,2,[TempPL]Jagniątko,2560,0,1,1,2,50.0%,1h
29160,3,[BdV]BloodyGhost,2560,0,1,1,2,50.0%,1h
29160,2,Dhoompriest,2560,0,0,1,1,0.0%,17m
29160,3,[BESY]Beny,2560,0,0,1,1,0.0%,1h
29160,3,[skines]ideservehate,2560,0,0,1,1,0.0%,1h
29160,3,xPATTY,2560,0,0,1,1,0.0%,59m
29160,2,LeGrosLouis,2560,0,0,2,2,0.0%,18m
29160,2,Hoek,2560,0,0,4,4,0.0%,18m
29195,2,Хрусткостей,2559,1487,156,150,306,51.0%,1h
29195,2,stevyWNV,2559,1457,67,58,125,53.6%,1h
29195,3,boort,2559,1097,43,34,77,55.8%,1h
29195,3,[ConFed]roVer,2559,741,39,1,40,97.5%,1h
29195,2,Statoon,2559,579,26,21,47,55.3%,1h
29195,3,[RDDN]Tsyuko,2559,630,24,20,44,54.5%,24m
29195,1,bronzy,2559,656,22,30,52,42.3%,12m
29195,1,Morev,2559,351,15,15,30,50.0%,21m
29195,2,Quester,2559,323,12,9,21,57.1%,1h
29195,2,[GXalpH]Pokie,2559,150,11,9,20,55.0%,18m
29195,2,dandauganda,2559,230,10,3,13,76.9%,18m
29195,2,Hirich,2559,363,10,17,27,37.0%,1h
29195,2,Armgard,2559,156,7,2,9,77.8%,18m
29195,3,Quakerz,2559,114,4,2,6,66.7%,25m
29195,2,Господь,2559,128,4,2,6,66.7%,1h
29195,2,YourEnd,2559,94,4,5,9,44.4%,57m
29195,3,Serge,2559,30,4,6,10,40.0%,22m
29195,2,kaRIMus,2559,110,4,7,11,36.4%,59m
29195,2,[SHOUPI]Rastagreg,2559,86,3,7,10,30.0%,1h
29195,3,Lowcoum,2559,30,2,0,2,100.0%,1h
29195,2,[Invǂ]kirin,2559,30,2,2,4,50.0%,1h
29195,2,[CS0]ProTau,2559,102,2,3,5,40.0%,1h
29195,2,cmoi,2559,0,2,4,6,33.3%,26m
29195,1,Skorpion,2559,97,1,2,3,33.3%,1h
29195,3,[XzF]Radix,2559,0,0,1,1,0.0%,1h
29195,3,[CHOPAA]Blood,2559,0,0,1,1,0.0%,59m
29195,1,Ololoanonim,2559,0,0,1,1,0.0%,1h
29195,1,[ThReCl]Starkiller,2559,0,0,2,2,0.0%,1h
29195,2,CTPEJlOK,2559,0,0,3,3,0.0%,27m
29224,2,Domelandro,2558,1576,274,278,552,49.6%,20m
29224,3,Boba,2558,1462,191,196,387,49.4%,14m
29224,2,Jigs,2558,759,110,87,197,55.8%,11m
29224,1,[TSC2C]Gosha,2558,1555,98,97,195,50.3%,5m
29224,1,hulk,2558,1539,98,103,201,48.8%,1h
29224,1,Дмитрий,2558,1565,60,63,123,48.8%,57m
29224,3,[HYPNO]Weaver,2558,233,52,36,88,59.1%,59m
29224,2,Skorpion,2558,565,49,38,87,56.3%,4m
29224,1,theBEAN,2558,495,24,27,51,47.1%,1h
29224,2,BobBuilder,2558,217,22,17,39,56.4%,1h
29224,2,oLin,2558,473,18,19,37,48.6%,1h
29224,2,[ligma]DarthVader,2558,383,14,14,28,50.0%,25m
29224,3,Zagrobowiec,2558,312,12,6,18,66.7%,3m
29224,2,Darik,2558,308,12,8,20,60.0%,20m
29224,1,CosmicFlower,2558,305,10,14,24,41.7%,7m
29224,2,[2021]Tuchka,2558,241,8,10,18,44.4%,23m
29224,3,Feligion,2558,114,5,0,5,100.0%,60m
29224,1,Playsover,2558,110,4,6,10,40.0%,1h
29224,3,Strange,2558,58,3,0,3,100.0%,27m
29224,3,Atrox,2558,38,3,5,8,37.5%,24m
29224,3,TCrunk,2558,121,2,5,7,28.6%,1h
29224,1,RudolF,2558,0,1,0,1,100.0%,19m
29224,3,LanLanChas,2558,0,1,0,1,100.0%,1h
29224,2,Egoist,2558,0,1,1,2,50.0%,57m
29224,3,[10X]CakeWalker,2558,30,1,2,3,33.3%,1h
29224,2,Delete,2558,0,1,5,6,16.7%,1h
29224,3,[o666o]MrXyano,2558,97,1,5,6,16.7%,12m
29224,3,jason,2558,0,0,1,1,0.0%,1h
29224,3,DEATH,2558,0,0,5,5,0.0%,1h
29224,2,Miras,2558,0,0,5,5,0.0%,1h
29254,1,Jacklandrin,2557,1584,134,135,269,49.8%,1h
29254,3,Логан,2557,1340,130,131,261,49.8%,8m
29254,1,Takeo,2557,1264,102,91,193,52.8%,7m
29254,2,gäpyboy,2557,1339,94,83,177,53.1%,1h
29254,1,Emzaak,2557,1572,73,77,150,48.7%,8m
29254,2,ODDish,2557,1044,65,48,113,57.5%,1h
29254,1,Mengsk,2557,1321,59,55,114,51.8%,8m
29254,2,Fubert,2557,972,47,48,95,49.5%,1h
29254,2,louster,2557,500,20,15,35,57.1%,1h
29254,2,Alexx,2557,505,20,15,35,57.1%,27m
29254,2,Асасин,2557,482,18,18,36,50.0%,1h
29254,2,Intro,2557,470,18,19,37,48.6%,1h
29254,2,misekemitoko,2557,372,17,4,21,81.0%,17m
29254,2,DarkShadow,2557,348,12,10,22,54.5%,19m
29254,2,kubalonek,2557,261,9,11,20,45.0%,1h
29254,1,FeaKs,2557,206,8,8,16,50.0%,8m
29254,2,[StrKlr]Barbie,2557,227,7,7,14,50.0%,1h
29254,2,Zarock,2557,275,6,13,19,31.6%,1h
29254,3,Architekt,2557,157,5,6,11,45.5%,1h
29254,1,Wolve,2557,97,4,7,11,36.4%,1h
29254,2,Konsai,2557,161,3,4,7,42.9%,4m
29254,1,kelthor,2557,0,3,4,7,42.9%,24m
29254,3,Abxaz,2557,34,3,5,8,37.5%,13m
29254,2,SkarabCZ,2557,61,3,7,10,30.0%,1h
29254,3,[KZ05]Aidin,2557,0,2,3,5,40.0%,56m
29254,1,Tseken,2557,0,2,3,5,40.0%,8m
29254,1,СтаричОК,2557,34,2,4,6,33.3%,59m
29254,2,Spinnock,2557,0,2,5,7,28.6%,21m
29254,2,[TODOW]танкист,2557,112,2,5,7,28.6%,1h
29254,3,Makwein,2557,0,1,0,1,100.0%,56m
29254,3,ERGO,2557,92,1,2,3,33.3%,24m
29254,3,Генчик,2557,0,1,4,5,20.0%,13m
29254,3,[Vio]Jin,2557,0,0,1,1,0.0%,3m
29254,3,IIIIIIIIIIII,2557,0,0,1,1,0.0%,17m
29254,3,LingLing,2557,0,0,1,1,0.0%,27m
29254,2,Keldrogo,2557,0,0,1,1,0.0%,1h
29254,2,[kolins]OverLord,2557,0,0,2,2,0.0%,1h
29291,3,Axel,2556,1101,149,152,301,49.5%,17m
29291,1,TAENORN,2556,1570,108,109,217,49.8%,7m
29291,2,xLarGox,2556,1164,74,69,143,51.7%,3m
29291,2,ElCarnoso,2556,962,33,47,80,41.2%,10m
29291,2,kobra,2556,760,26,29,55,47.3%,12m
29291,3,BumBon,2556,575,23,18,41,56.1%,9m
29291,3,Tarass,2556,587,23,26,49,46.9%,20m
29291,2,DrBOO,2556,183,8,5,13,61.5%,19m
29291,2,SaN,2556,86,5,6,11,45.5%,1h
29291,2,KyrAnN,2556,142,4,3,7,57.1%,4m
29291,2,JaSZeK,2556,0,3,5,8,37.5%,59m
29291,2,[IQUMU]ToroViejo,2556,90,3,8,11,27.3%,1h
29291,3,JDR,2556,0,2,3,5,40.0%,1h
29291,2,mara,2556,0,1,1,2,50.0%,1h
29291,2,Heisenzerg,2556,0,1,1,2,50.0%,17m
29291,2,Slayman,2556,0,1,2,3,33.3%,57m
29291,2,Zealotas,2556,30,1,5,6,16.7%,17m
29291,3,Navara,2556,0,0,1,1,0.0%,1h
29291,3,[Colony]MacGyver,2556,0,0,1,1,0.0%,1h
29291,3,Arkell,2556,0,0,1,1,0.0%,1h
29291,2,[KAIBA]JanJanusz,2556,0,0,4,4,0.0%,59m
29312,3,Crispo,2555,1554,214,211,425,50.4%,9m
29312,2,Marinero,2555,1592,193,182,375,51.5%,56m
29312,3,HiVol,2555,563,111,118,229,48.5%,6m
29312,3,[EnBois]Cnetom,2555,1300,64,77,141,45.4%,10m
29312,3,TFM,2555,1276,45,55,100,45.0%,20m
29312,2,immelmanych,2555,343,42,31,73,57.5%,1h
29312,3,KrimiX,2555,685,29,16,45,64.4%,25m
29312,1,JUMPYWIZARD,2555,524,16,26,42,38.1%,12m
29312,2,sickboy,2555,360,14,22,36,38.9%,15m
29312,2,[Arenot]ГейБой,2555,280,12,6,18,66.7%,26m
29312,2,SULCA,2555,206,7,5,12,58.3%,1h
29312,2,spmarine,2555,202,7,8,15,46.7%,27m
29312,2,Monos,2555,196,7,8,15,46.7%,1h
29312,1,Nelio,2555,225,6,15,21,28.6%,4m
29312,2,gizMax,2555,152,5,11,16,31.2%,59m
29312,2,[Trkrs]Duke,2555,153,4,2,6,66.7%,1h
29312,2,ЗверяЗмейПРо,2555,86,4,4,8,50.0%,1h
29312,1,Barachiel,2555,154,4,8,12,33.3%,18m
29312,2,florian,2555,30,3,4,7,42.9%,6m
29312,1,BobbyMcmarly,2555,122,3,11,14,21.4%,1h
29312,1,CheetahBaris,2555,0,2,3,5,40.0%,1h
29312,3,Bane,2555,0,2,4,6,33.3%,1h
29312,2,NiniBouzouk,2555,60,2,5,7,28.6%,1h
29312,2,Belchir,2555,32,1,3,4,25.0%,1h
29312,3,LonelyDonut,2555,0,1,4,5,20.0%,10m
29312,2,NuclearK,2555,30,1,5,6,16.7%,20m
29312,2,ALEXEYG,2555,0,0,2,2,0.0%,1h
29312,2,[RUBE]Elaren,2555,0,0,5,5,0.0%,4m
29340,2,PapyDave,2554,1570,62,60,122,50.8%,15m
29340,2,leo,2554,906,34,35,69,49.3%,1h
29340,2,zerrix,2554,766,31,26,57,54.4%,57m
29340,2,Blaiize,2554,557,23,24,47,48.9%,1h
29340,1,DrunkOldFart,2554,640,20,31,51,39.2%,8m
29340,2,Zmajo,2554,267,11,5,16,68.8%,22m
29340,1,KingMike,2554,296,9,18,27,33.3%,1h
29340,2,EmoSnek,2554,205,6,6,12,50.0%,1h
29340,1,Uezo,2554,170,6,9,15,40.0%,1h
29340,2,SirGrecha,2554,219,6,10,16,37.5%,1h
29340,2,[HDTV]USax,2554,156,6,13,19,31.6%,9m
29340,2,Crall,2554,141,5,8,13,38.5%,57m
29340,2,Love,2554,116,4,2,6,66.7%,1h
29340,2,[SoS1]DontTouchMe,2554,108,3,1,4,75.0%,14m
29340,3,ShadowSev,2554,145,3,5,8,37.5%,1h
29340,3,smogiiiii,2554,0,2,3,5,40.0%,1h
29340,3,VYNDERVAFLA,2554,0,2,4,6,33.3%,4m
29340,3,LifeForAiur,2554,0,1,1,2,50.0%,1h
29340,2,[NTLA]Krzychu,2554,0,1,1,2,50.0%,59m
29340,3,ZaleksiZ,2554,30,1,2,3,33.3%,1h
29340,2,[YUGE]YUGE,2554,0,1,2,3,33.3%,15m
29340,1,Salty,2554,46,1,5,6,16.7%,6m
29340,3,iggy,2554,0,0,1,1,0.0%,10m
29363,1,aziz,2553,1247,88,87,175,50.3%,7m
29363,2,LarssoN,2553,1119,83,68,151,55.0%,18m
29363,3,[GP]AllanB,2553,1298,57,45,102,55.9%,1h
29363,2,Joesen,2553,1289,54,48,102,52.9%,1h
29363,1,JeanneHaZuKi,2553,899,46,53,99,46.5%,22m
29363,2,[KERNEL]Холодный,2553,1090,43,42,85,50.6%,1h
29363,2,Evilsmile,2553,1172,43,47,90,47.8%,6m
29363,2,Shaman,2553,908,33,35,68,48.5%,17m
29363,2,Parazoid,2553,760,28,31,59,47.5%,1h
29363,1,Aldebaran,2553,486,15,21,36,41.7%,22m
29363,2,pilotul,2553,244,8,7,15,53.3%,1h
29363,2,[SRPRZ]SimonIce,2553,221,7,5,12,58.3%,21m
29363,3,CapSand,2553,125,7,8,15,46.7%,59m
29363,2,ARZZAS,2553,174,7,10,17,41.2%,17m
29363,2,MiLaShKa,2553,237,7,10,17,41.2%,18m
29363,1,[TxM]EgRoJ,2553,246,7,16,23,30.4%,1h
29363,2,bakspace,2553,186,6,10,16,37.5%,2m
29363,2,Dominions,2553,154,5,4,9,55.6%,1h
29363,2,Ani,2553,74,4,5,9,44.4%,1h
29363,2,[Exists]GrumpyWhale,2553,90,3,5,8,37.5%,15m
29363,2,[RBTV2]berlauch,2553,0,2,4,6,33.3%,57m
29363,3,Tounkane,2553,0,1,0,1,100.0%,16m
29363,3,Vanger,2553,0,1,0,1,100.0%,1h
29363,3,Kujivunia,2553,0,1,0,1,100.0%,1h
29363,1,heme,2553,34,1,4,5,20.0%,25m
29363,3,[NLMF]kwors,2553,0,0,1,1,0.0%,1h
29363,3,OsiriSZ,2553,0,0,1,1,0.0%,12m
29363,2,[AUT15M]HiOnVespene,2553,0,0,2,2,0.0%,1h
29363,2,Лапушаня,2553,0,0,2,2,0.0%,1h
29363,2,psychonaft,2553,0,0,3,3,0.0%,1h
29393,2,redared,2552,510,69,67,136,50.7%,25m
29393,2,blopotchok,2552,1081,67,68,135,49.6%,1h
29393,2,[SpaCo]Stevie,2552,1467,61,51,112,54.5%,1h
29393,3,Maxtor,2552,1367,60,47,107,56.1%,22m
29393,3,MushroomX,2552,1574,57,64,121,47.1%,22m
29393,2,Karnak,2552,907,49,36,85,57.6%,26m
29393,2,Reverse,2552,1160,43,52,95,45.3%,21m
29393,2,Nemonef,2552,554,30,24,54,55.6%,12m
29393,2,YEYKO,2552,620,23,21,44,52.3%,5m
29393,3,psychkik,2552,508,22,16,38,57.9%,1h
29393,1,Starkiller,2552,580,22,26,48,45.8%,9m
29393,2,mrnice,2552,374,14,10,24,58.3%,57m
29393,3,äLgRemslem,2552,450,14,23,37,37.8%,13m
29393,2,Green,2552,375,12,15,27,44.4%,1h
29393,1,Dumbledore,2552,358,10,17,27,37.0%,8m
29393,2,Repton,2552,259,9,8,17,52.9%,1h
29393,2,[xWARx]INFERNALelf,2552,163,7,8,15,46.7%,16m
29393,2,Dioraks,2552,253,7,9,16,43.8%,15m
29393,2,EclectEel,2552,250,6,7,13,46.2%,1h
29393,3,Robix,2552,196,6,7,13,46.2%,14m
29393,2,[FASA]Bonersoup,2552,198,6,11,17,35.3%,1h
29393,3,kidfixo,2552,121,4,4,8,50.0%,1h
29393,2,OmegaCommand,2552,0,3,4,7,42.9%,1h
29393,3,[12MKs]GoldenMonkey,2552,36,3,5,8,37.5%,4m
29393,3,Vladimer,2552,30,2,1,3,66.7%,28m
29393,1,[TTGL]KingofWeebs,2552,0,2,3,5,40.0%,4m
29393,3,JUZO,2552,0,2,4,6,33.3%,5m
29393,2,Enik,2552,62,2,6,8,25.0%,1m
29393,3,[ЗЕRGТV]aiwusp,2552,30,1,2,3,33.3%,1h
29393,2,Kstyo,2552,0,1,2,3,33.3%,1h
29393,2,Festival,2552,30,1,3,4,25.0%,1m
29393,3,LSM,2552,0,1,4,5,20.0%,1h
29393,3,AngryRoach,2552,0,0,1,1,0.0%,3m
29393,3,Sergej,2552,0,0,1,1,0.0%,1h
29393,3,Денис,2552,0,0,1,1,0.0%,1h
29393,3,DROLER,2552,0,0,1,1,0.0%,1h
29393,3,DyRZylG,2552,0,0,1,1,0.0%,28m
29393,3,[Aralan]Chihiro,2552,0,0,1,1,0.0%,59m
29393,1,YourBestFan,2552,0,0,11,11,0.0%,1h
29432,1,Sander,2551,1627,224,227,451,49.7%,19m
29432,2,lsix,2551,1562,85,75,160,53.1%,1h
29432,1,ARIDOTA,2551,1146,43,48,91,47.3%,1h
29432,2,Pinball,2551,1059,40,38,78,51.3%,1h
29432,3,Energy,2551,704,40,48,88,45.5%,15m
29432,2,Assassin,2551,726,29,24,53,54.7%,1h
29432,2,huylkabum,2551,476,16,22,38,42.1%,26m
29432,3,Apygon,2551,343,14,13,27,51.9%,13m
29432,1,[ChBag]piter,2551,290,8,13,21,38.1%,4m
29432,2,Trizmo,2551,166,7,1,8,87.5%,25m
29432,2,[ITOTOI]Loup,2551,88,5,6,11,45.5%,5m
29432,3,NikolaS,2551,156,5,6,11,45.5%,23m
29432,2,badCore,2551,188,4,10,14,28.6%,21m
29432,2,frizer,2551,118,4,14,18,22.2%,2m
29432,3,OutOfReach,2551,0,3,8,11,27.3%,2m
29432,3,cmn,2551,0,2,4,6,33.3%,1h
29432,3,опеzдал,2551,0,1,0,1,100.0%,8m
29432,3,gianterrazza,2551,30,1,1,2,50.0%,1h
29432,1,Мринад,2551,0,0,3,3,0.0%,1h
29432,2,Kaeiser,2551,0,0,3,3,0.0%,1h
29432,2,Orange,2551,0,0,3,3,0.0%,1h
29432,2,Robek,2551,0,0,6,6,0.0%,27m
29454,1,FanFu,2550,1539,103,105,208,49.5%,1h
29454,3,MikeAM,2550,1371,89,78,167,53.3%,10m
29454,1,star,2550,959,35,37,72,48.6%,1h
29454,2,Dex,2550,705,33,23,56,58.9%,1h
29454,2,[RPG2]SaintMike,2550,764,32,22,54,59.3%,26m
29454,2,MADGAKKIN,2550,700,27,32,59,45.8%,9m
29454,1,Teach,2550,798,26,34,60,43.3%,23m
29454,3,КТОТО,2550,513,19,12,31,61.3%,1h
29454,1,XWORAG,2550,428,17,19,36,47.2%,1h
29454,2,UmadBro,2550,431,16,14,30,53.3%,27m
29454,2,[Няшкa]HardCode,2550,356,15,13,28,53.6%,3m
29454,2,Vagabond,2550,329,12,11,23,52.2%,59m
29454,2,[EDUCK]Malimon,2550,253,9,10,19,47.4%,1h
29454,2,cox,2550,205,7,8,15,46.7%,19m
29454,2,[LostCA]Panthone,2550,229,7,9,16,43.8%,4m
29454,2,filda,2550,182,6,12,18,33.3%,1h
29454,3,SuperHotFire,2550,110,5,7,12,41.7%,1h
29454,1,Zacha,2550,0,3,2,5,60.0%,20m
29454,3,Melkor,2550,0,2,1,3,66.7%,17m
29454,2,[AiRǂ]Rictal,2550,30,2,2,4,50.0%,1h
29454,3,Frody,2550,0,2,3,5,40.0%,1h
29454,2,Chernoboy,2550,0,2,4,6,33.3%,1h
29454,3,Dortimair,2550,0,1,0,1,100.0%,20m
29454,2,Guguinhas,2550,73,1,3,4,25.0%,24m
29478,2,Boewulf,2549,1490,99,80,179,55.3%,6m
29478,3,OneWay,2549,1151,60,61,121,49.6%,3m
29478,3,Conan,2549,1578,58,73,131,44.3%,9m
29478,2,marcopolo,2549,1242,48,47,95,50.5%,27m
29478,2,MinaMax,2549,465,26,28,54,48.1%,26m
29478,3,Battletou,2549,570,24,25,49,49.0%,10m
29478,2,Tanaku,2549,476,20,16,36,55.6%,26m
29478,1,ChocolateEYE,2549,622,20,27,47,42.6%,1h
29478,2,Oleshka,2549,324,11,11,22,50.0%,7m
29478,2,BlackAssasin,2549,300,10,10,20,50.0%,17m
29478,2,Вячеслав,2549,144,9,7,16,56.2%,7m
29478,1,Clay,2549,232,9,10,19,47.4%,25m
29478,2,Mistersleep,2549,237,8,6,14,57.1%,1h
29478,2,zoom,2549,200,7,9,16,43.8%,1h
29478,2,[7700]jayce,2549,184,6,10,16,37.5%,59m
29478,2,Ghola,2549,60,5,4,9,55.6%,18m
29478,3,Ivan,2549,30,5,5,10,50.0%,2m
29478,2,bbl,2549,122,5,6,11,45.5%,27m
29478,3,Oldo,2549,96,4,2,6,66.7%,14m
29478,2,TroudBâl,2549,128,4,3,7,57.1%,15m
29478,2,Joldas,2549,60,4,6,10,40.0%,26m
29478,3,Folk,2549,30,4,7,11,36.4%,15m
29478,2,Fry,2549,118,4,10,14,28.6%,1h
29478,3,alektokyl,2549,58,3,0,3,100.0%,17m
29478,3,BidBack,2549,119,3,4,7,42.9%,4m
29478,3,Bucifal,2549,135,2,2,4,50.0%,1h
29478,3,[ICCCPI]AllWHey,2549,30,2,4,6,33.3%,28m
29478,2,Stokes,2549,48,2,10,12,16.7%,18m
29478,3,Ежик,2549,0,1,0,1,100.0%,1h
29478,3,[SPAINs]brianmoxto,2549,0,1,1,2,50.0%,7m
29478,3,[SAG]speeder,2549,0,1,6,7,14.3%,4m
29478,1,AMBERLAMPS,2549,0,0,3,3,0.0%,1h
29510,1,vanstar,2548,1573,185,175,360,51.4%,1h
29510,2,vetpeter,2548,1561,142,130,272,52.2%,1h
29510,2,[isIMBА]Bezariys,2548,692,54,47,101,53.5%,26m
29510,3,Metamorfo,2548,673,38,8,46,82.6%,1h
29510,2,SlaI,2548,784,29,33,62,46.8%,24m
29510,2,Kapis,2548,708,27,24,51,52.9%,1h
29510,2,ZuRl,2548,347,15,14,29,51.7%,1h
29510,2,koutsoupasss,2548,206,6,5,11,54.5%,3m
29510,3,GEZsindHUSOS,2548,114,5,1,6,83.3%,1h
29510,3,Gold,2548,58,5,2,7,71.4%,22m
29510,2,Lyurax,2548,178,5,7,12,41.7%,1h
29510,2,[Boota]Penge,2548,126,4,2,6,66.7%,18m
29510,3,Slide,2548,121,3,5,8,37.5%,4m
29510,1,RooT,2548,0,2,3,5,40.0%,1h
29510,2,thorba,2548,88,2,5,7,28.6%,11m
29510,2,Scoobydoo,2548,0,1,5,6,16.7%,25m
29526,1,mazayus,2547,1307,103,95,198,52.0%,1h
29526,2,Lamma,2547,1460,55,58,113,48.7%,1h
29526,3,hola,2547,510,38,28,66,57.6%,1h
29526,1,RupeOase,2547,834,28,36,64,43.8%,18m
29526,2,[FARLIG]Terminator,2547,320,11,13,24,45.8%,1h
29526,1,[GSF]Synthesizer,2547,282,10,12,22,45.5%,59m
29526,2,Arash,2547,140,5,3,8,62.5%,1h
29526,3,Edocsil,2547,189,5,7,12,41.7%,1h
29526,3,[Pewds]alex,2547,86,3,2,5,60.0%,9m
29526,3,rominouchou,2547,38,3,5,8,37.5%,21m
29526,2,Pioneer,2547,0,3,6,9,33.3%,1h
29526,3,ZIELINSKI,2547,125,3,12,15,20.0%,14m
29526,3,jhon,2547,68,2,4,6,33.3%,1h
29526,2,sQe,2547,42,1,2,3,33.3%,1h
29526,1,KCK,2547,0,1,4,5,20.0%,58m
29526,3,[tysa]Jeto,2547,0,0,1,1,0.0%,6m
29526,2,Buddha,2547,0,0,1,1,0.0%,6m
29526,3,westren,2547,0,0,1,1,0.0%,10m
29526,2,Mistan,2547,0,0,2,2,0.0%,1h
29526,2,[rosen]rosensuppe,2547,0,0,4,4,0.0%,3m
29546,2,Bencel,2546,1539,103,98,201,51.2%,57m
29546,2,NoNo,2546,1346,73,62,135,54.1%,1h
29546,3,MrGhost,2546,605,73,63,136,53.7%,1h
29546,2,Balibalo,2546,1456,60,57,117,51.3%,26m
29546,2,Bazzie,2546,999,58,48,106,54.7%,1h
29546,2,СкиФакс,2546,853,50,43,93,53.8%,5m
29546,2,Skidjast,2546,842,37,31,68,54.4%,1h
29546,2,[SPF]LalkaPL,2546,653,35,37,72,48.6%,1h
29546,2,salemes,2546,668,33,22,55,60.0%,1h
29546,2,puf,2546,471,26,21,47,55.3%,57m
29546,2,[Virat]Globetrotter,2546,658,23,23,46,50.0%,23m
29546,2,Szymli,2546,610,22,22,44,50.0%,1h
29546,2,Kvothe,2546,481,19,22,41,46.3%,1h
29546,2,Mahiti,2546,366,15,16,31,48.4%,6m
29546,2,vadimhalo,2546,410,15,18,33,45.5%,5m
29546,1,Alex,2546,470,15,19,34,44.1%,1h
29546,2,dnspyralab,2546,426,14,18,32,43.8%,1h
29546,2,GreenLord,2546,341,13,14,27,48.1%,1h
29546,2,Aleksei,2546,404,13,16,29,44.8%,1h
29546,2,[BM3]BARRACUDAS,2546,330,12,13,25,48.0%,9m
29546,2,Shadowrun,2546,305,11,12,23,47.8%,20m
29546,2,[123RUS]TAHK,2546,152,5,8,13,38.5%,1h
29546,2,[GR0V]BobbyJoe,2546,86,4,8,12,33.3%,24m
29546,3,Зилок,2546,94,4,11,15,26.7%,7m
29546,3,[UKG]Ellii,2546,128,3,1,4,75.0%,18m
29546,1,DoomHamer,2546,0,3,2,5,60.0%,2m
29546,1,voltab,2546,0,3,2,5,60.0%,1h
29546,2,Флу,2546,88,2,1,3,66.7%,24m
29546,2,[LforA]MrNikitoSSS,2546,30,2,2,4,50.0%,3m
29546,2,TheMauler,2546,30,2,3,5,40.0%,17m
29546,1,[neuroW]Zwos,2546,48,2,4,6,33.3%,27m
29546,3,[ESOT]SuperIorni,2546,0,1,0,1,100.0%,1h
29546,2,Arex,2546,0,1,1,2,50.0%,57m
29546,2,ColdRain,2546,44,1,2,3,33.3%,1h
29546,2,ghostFredo,2546,30,1,4,5,20.0%,1h
29546,3,Polikok,2546,0,0,1,1,0.0%,1h
29546,3,патимейкер,2546,0,0,1,1,0.0%,4m
29546,1,Naccho,2546,0,0,2,2,0.0%,1h
29546,2,unamedjfw,2546,0,0,2,2,0.0%,1h
29546,3,Pietstyf,2546,0,0,2,2,0.0%,1h
29586,2,SvirepyBambr,2545,1448,111,96,207,53.6%,1h
29586,2,Ced,2545,1165,93,81,174,53.4%,1h
29586,2,cclife,2545,1391,92,87,179,51.4%,1h
29586,3,Schtirlitz,2545,1320,75,65,140,53.6%,10m
29586,2,[LMBD]AGJAJI,2545,1262,47,50,97,48.5%,15m
29586,2,[skh]BAT,2545,679,30,30,60,50.0%,22m
29586,2,Thorking,2545,784,27,32,59,45.8%,22m
29586,1,Falkener,2545,641,25,28,53,47.2%,1h
29586,2,Fraglee,2545,494,19,22,41,46.3%,18m
29586,2,Александр,2545,496,16,21,37,43.2%,22m
29586,2,ZarkousxD,2545,292,14,15,29,48.3%,17m
29586,1,Dwolin,2545,230,7,10,17,41.2%,1h
29586,1,[SddS]Drone,2545,240,7,14,21,33.3%,25m
29586,3,Adam,2545,30,5,4,9,55.6%,25m
29586,2,TBAG,2545,116,4,3,7,57.1%,57m
29586,3,eduard,2545,30,3,4,7,42.9%,1h
29586,2,daulaus,2545,102,3,5,8,37.5%,20m
29586,3,ich,2545,30,2,0,2,100.0%,18m
29586,3,DrOn,2545,30,2,0,2,100.0%,19m
29586,3,LorGamer,2545,30,2,0,2,100.0%,1h
29586,3,who,2545,58,2,1,3,66.7%,1h
29586,3,XuTPuK,2545,0,2,3,5,40.0%,19m
29586,3,ALIHANDRO,2545,0,2,4,6,33.3%,1h
29586,2,Proven,2545,120,2,5,7,28.6%,20m
29586,3,Faraon,2545,0,1,0,1,100.0%,1h
29586,2,Gonzo,2545,0,1,2,3,33.3%,1h
29586,2,[ZM]Wolfmdr,2545,44,1,2,3,33.3%,18m
29586,3,[Jürgen]andiS,2545,0,0,1,1,0.0%,1h
29586,3,KuBi,2545,0,0,1,1,0.0%,4m
29586,2,Lost,2545,0,0,2,2,0.0%,1h
29586,2,[J4E]dici,2545,0,0,2,2,0.0%,1h
29586,2,[Arrows]chiter,2545,0,0,6,6,0.0%,1h
29618,1,[TExGG]Schattenmagi,2544,1521,107,117,224,47.8%,4m
29618,2,Panoramic,2544,1103,44,41,85,51.8%,18m
29618,2,lohkar,2544,930,42,27,69,60.9%,1h
29618,2,Meczka,2544,791,34,26,60,56.7%,5m
29618,1,Late,2544,441,26,34,60,43.3%,1h
29618,2,BastienFR,2544,406,16,19,35,45.7%,1h
29618,2,Shorty,2544,298,11,13,24,45.8%,59m
29618,2,[Щитон]Solpik,2544,264,9,7,16,56.2%,1h
29618,2,Dzerduk,2544,232,9,9,18,50.0%,1h
29618,2,GESMER,2544,253,8,6,14,57.1%,22m
29618,2,IlIlIlIlIlIl,2544,135,7,4,11,63.6%,1h
29618,3,[Soldi]orami,2544,215,6,2,8,75.0%,15m
29618,3,Fareva,2544,165,5,6,11,45.5%,10m
29618,2,Starcruiser,2544,114,5,6,11,45.5%,1h
29618,2,EndNool,2544,169,5,9,14,35.7%,1h
29618,1,undertaker,2544,32,4,5,9,44.4%,1h
29618,2,[SkBG]GetRektNoob,2544,94,4,5,9,44.4%,1h
29618,3,LukasDMania,2544,30,4,7,11,36.4%,24m
29618,2,Schollifcb,2544,90,4,9,13,30.8%,1h
29618,2,мфтапрол,2544,115,3,1,4,75.0%,24m
29618,1,SerialKiller,2544,106,3,11,14,21.4%,1h
29618,3,enemy,2544,120,2,3,5,40.0%,14m
29618,1,[AvAni]centjeuh,2544,0,2,3,5,40.0%,1h
29618,3,Blogen,2544,0,2,3,5,40.0%,10m
29618,2,VentoSilente,2544,0,2,4,6,33.3%,15m
29618,3,CoaxyuM,2544,30,1,1,2,50.0%,1h
29618,3,BlackNeco,2544,30,1,1,2,50.0%,9m
29618,2,Neo,2544,0,1,2,3,33.3%,1h
29618,1,wukop,2544,34,1,4,5,20.0%,1h
29618,3,JustRush,2544,42,1,4,5,20.0%,4m
29618,3,Ritosan,2544,0,0,1,1,0.0%,6m
29618,3,[SРID]HappySlave,2544,0,0,1,1,0.0%,9m
29618,3,Vil,2544,0,0,1,1,0.0%,57m
29618,3,SupiTeuber,2544,0,0,1,1,0.0%,1h
29618,3,Nimidias,2544,0,0,2,2,0.0%,4m
29618,2,Demien,2544,0,0,3,3,0.0%,1h
29654,2,ZOM,2543,1214,115,88,203,56.7%,20m
29654,2,temach,2543,1601,79,73,152,52.0%,3m
29654,1,[ZЕRGТV]heave,2543,592,29,26,55,52.7%,4m
29654,1,[OtAg]Manchatz,2543,367,20,28,48,41.7%,18m
29654,1,[ZERG7V]MadBird,2543,560,19,21,40,47.5%,24m
29654,2,НюхайБэбру,2543,392,17,15,32,53.1%,1h
29654,2,Prippis,2543,447,17,18,35,48.6%,27m
29654,3,Sirtomw,2543,422,16,12,28,57.1%,1h
29654,2,ReefShrike,2543,330,15,12,27,55.6%,1h
29654,1,Fyntik,2543,446,14,20,34,41.2%,23m
29654,3,Drazak,2543,204,8,6,14,57.1%,6m
29654,2,SteveCook,2543,196,7,10,17,41.2%,26m
29654,3,Улькаир,2543,162,6,5,11,54.5%,16m
29654,3,[BCNG]goldeagleeee,2543,170,6,7,13,46.2%,3m
29654,1,PaukIgoryok,2543,151,4,2,6,66.7%,4m
29654,1,STARTERRAN,2543,48,4,9,13,30.8%,1h
29654,2,DestroZar,2543,107,3,2,5,60.0%,1h
29654,3,[raahhh]Flexi,2543,36,2,3,5,40.0%,27m
29654,1,Bebert,2543,0,2,4,6,33.3%,1h
29654,3,QueenP,2543,0,1,0,1,100.0%,2m
29654,3,Aldelloris,2543,0,1,0,1,100.0%,6m
29654,3,[LOXN]CaptainDave,2543,0,1,0,1,100.0%,7m
29654,1,rustek,2543,46,1,4,5,20.0%,1h
29654,3,Hawok,2543,0,1,4,5,20.0%,28m
29654,3,xuyvampo,2543,0,0,1,1,0.0%,7m
29654,3,[QEF]zzz,2543,0,0,1,1,0.0%,1h
29654,2,[Moze66]Moty,2543,0,0,2,2,0.0%,5m
29654,3,Schnuppel,2543,0,0,7,7,0.0%,4m
29682,2,[tagbag]georgi,2542,1005,59,61,120,49.2%,1h
29682,1,Skys,2542,645,54,52,106,50.9%,11m
29682,2,Romain,2542,660,51,47,98,52.0%,17m
29682,1,[Still]bleed,2542,427,30,17,47,63.8%,27m
29682,2,Shaodar,2542,712,28,28,56,50.0%,15m
29682,2,chocolaman,2542,669,25,24,49,51.0%,1h
29682,3,Скорпион,2542,383,21,29,50,42.0%,25m
29682,2,Supersoft,2542,467,17,16,33,51.5%,59m
29682,2,naeledro,2542,331,17,19,36,47.2%,1h
29682,2,pulse,2542,468,16,29,45,35.6%,1h
29682,2,[BGKC]minotaurusz,2542,228,9,9,18,50.0%,16m
29682,2,[ТКД]Melges,2542,204,7,7,14,50.0%,1h
29682,3,Belerafon,2542,181,6,5,11,54.5%,10m
29682,2,Luckу,2542,210,6,5,11,54.5%,1h
29682,2,[PLFS]Tarkes,2542,166,5,3,8,62.5%,26m
29682,3,ToNyM,2542,94,4,9,13,30.8%,24m
29682,2,DrEisenfaust,2542,30,3,5,8,37.5%,26m
29682,3,Ravdrien,2542,58,2,1,3,66.7%,1h
29682,1,Lichking,2542,95,2,2,4,50.0%,1h
29682,3,pgF,2542,60,2,2,4,50.0%,57m
29682,2,[U22U2]DarkMelonArm,2542,98,2,4,6,33.3%,1h
29682,2,Vukota,2542,60,2,5,7,28.6%,1h
29682,2,seasonsunny,2542,0,1,1,2,50.0%,17m
29682,2,DNSDOCTOR,2542,0,0,2,2,0.0%,1h
29682,2,Hide,2542,0,0,2,2,0.0%,3m
29682,3,toine,2542,0,0,4,4,0.0%,3m
29708,3,CidCampeador,2541,1565,140,133,273,51.3%,2m
29708,2,TenLetters,2541,1194,79,71,150,52.7%,57m
29708,1,JackpoT,2541,1567,65,68,133,48.9%,1h
29708,2,smilemniame,2541,988,47,45,92,51.1%,58m
29708,2,Unnamed,2541,1049,40,45,85,47.1%,22m
29708,3,Dennis,2541,574,23,11,34,67.6%,1h
29708,2,Mdehl,2541,508,23,13,36,63.9%,1h
29708,3,Pheonex,2541,502,18,15,33,54.5%,13m
29708,2,[GlNYU]datakille,2541,506,18,20,38,47.4%,1h
29708,3,[CrpZts]Icold,2541,447,17,14,31,54.8%,1h
29708,2,Kratos,2541,454,16,22,38,42.1%,1h
29708,2,Nastoych,2541,414,14,14,28,50.0%,1h
29708,2,alex,2541,308,11,16,27,40.7%,1h
29708,2,Mouillée,2541,162,9,4,13,69.2%,17m
29708,2,[MARSS]Tchapakan,2541,218,8,11,19,42.1%,1h
29708,1,dpajnic,2541,198,7,12,19,36.8%,9m
29708,1,Belphegor,2541,191,6,9,15,40.0%,1h
29708,1,Gaunt,2541,234,6,13,19,31.6%,1h
29708,2,marmorix,2541,189,5,5,10,50.0%,1h
29708,2,Bakuś,2541,148,5,7,12,41.7%,25m
29708,2,[OPANA]RoarOfProxy,2541,154,5,8,13,38.5%,1h
29708,2,Jvz,2541,128,4,2,6,66.7%,1h
29708,3,[Grunt]Medmex,2541,30,3,4,7,42.9%,22m
29708,2,Venture,2541,86,3,5,8,37.5%,7m
29708,3,LotkaKRK,2541,36,3,5,8,37.5%,1h
29708,1,der,2541,0,3,7,10,30.0%,1h
29708,1,kiyiy,2541,119,3,7,10,30.0%,14m
29708,3,Fmj,2541,0,2,5,7,28.6%,7m
29708,3,jonny,2541,0,1,2,3,33.3%,1h
29708,3,MAHO,2541,0,1,4,5,20.0%,14m
29708,2,Niklas,2541,30,1,6,7,14.3%,1h
29708,1,Kawa,2541,97,1,7,8,12.5%,1h
29708,3,JinLo,2541,0,0,1,1,0.0%,18m
29708,3,[SCCCC]KasperNeuzig,2541,0,0,1,1,0.0%,19m
29708,3,[SomeSB]Fütykös,2541,0,0,1,1,0.0%,1h
29743,1,MassiveFred,2540,1536,149,147,296,50.3%,1h
29743,1,Blitzkrig,2540,1573,142,136,278,51.1%,1h
29743,1,Wrath,2540,1534,137,115,252,54.4%,24m
29743,2,Ivan,2540,1275,98,81,179,54.7%,1h
29743,2,Sengski,2540,1067,67,60,127,52.8%,27m
29743,2,SrRobinBrave,2540,786,67,63,130,51.5%,15m
29743,2,ptr,2540,661,30,34,64,46.9%,1h
29743,2,BENAVE,2540,667,27,20,47,57.4%,5m
29743,2,Azeth,2540,102,13,14,27,48.1%,12m
29743,2,Pickonez,2540,301,12,11,23,52.2%,1h
29743,2,NoFlie,2540,282,11,7,18,61.1%,3m
29743,2,GDim,2540,241,9,14,23,39.1%,60m
29743,1,[Leg1on]Goody,2540,210,8,8,16,50.0%,1h
29743,1,Starwarrior,2540,186,5,7,12,41.7%,1h
29743,2,[TedB]Manzhe,2540,171,5,11,16,31.2%,1h
29743,3,ikL,2540,136,4,0,4,100.0%,12m
29743,2,MrSeledka,2540,128,4,3,7,57.1%,59m
29743,2,charl,2540,60,3,4,7,42.9%,59m
29743,2,[NWGD]GranAdmiral,2540,121,3,4,7,42.9%,1h
29743,2,[TheDOH]RSPOL,2540,62,3,5,8,37.5%,1h
29743,2,torades,2540,60,3,6,9,33.3%,1h
29743,2,uplimited,2540,102,2,2,4,50.0%,2m
29743,1,Zhigilevsk,2540,0,2,3,5,40.0%,22m
29743,1,Zébulon,2540,0,2,3,5,40.0%,20m
29743,2,kutusov,2540,118,2,4,6,33.3%,1h
29743,1,Codyaner,2540,48,2,4,6,33.3%,57m
29743,2,[BLZT]Devil,2540,70,2,6,8,25.0%,4m
29743,1,serjs,2540,46,1,1,2,50.0%,25m
29743,2,Voidead,2540,0,1,3,4,25.0%,1h
29743,2,jungleboogie,2540,0,0,1,1,0.0%,1h
29743,3,BIGMAK,2540,0,0,1,1,0.0%,13m
29743,1,MiniHusarz,2540,0,0,1,1,0.0%,60m
29743,3,СТАС,2540,0,0,2,2,0.0%,17m
29743,2,[Azimut]acetroneur,2540,0,0,4,4,0.0%,1h
29743,2,GETINTHEVAN,2540,0,0,7,7,0.0%,25m
29743,1,Leeadama,2540,0,0,10,10,0.0%,22m
29779,3,zockerever,2539,1631,107,99,206,51.9%,59m
29779,1,wiillo,2539,1440,79,71,150,52.7%,60m
29779,2,[Ǽ1]Impostor,2539,1024,67,49,116,57.8%,23m
29779,2,dendud,2539,545,54,55,109,49.5%,1h
29779,2,DCJoker,2539,768,30,28,58,51.7%,4m
29779,1,WKW,2539,700,28,32,60,46.7%,14m
29779,1,[Днищче]CyberGhost,2539,563,23,22,45,51.1%,1h
29779,1,KillerBee,2539,624,23,23,46,50.0%,6m
29779,3,[NucPus]PussуРusher,2539,468,17,21,38,44.7%,26m
29779,2,[FD69]GXTachtZWO,2539,286,11,12,23,47.8%,1h
29779,2,orpangandaro,2539,247,9,10,19,47.4%,21m
29779,1,Envy,2539,308,9,18,27,33.3%,1h
29779,1,privatemeta,2539,235,7,14,21,33.3%,1h
29779,3,HaHahHaHahHa,2539,181,6,6,12,50.0%,13m
29779,2,KaninFis,2539,141,6,8,14,42.9%,1h
29779,1,Luchito,2539,128,6,10,16,37.5%,1h
29779,2,[FABPLS]MrGopnik,2539,198,5,6,11,45.5%,1h
29779,1,Pridell,2539,181,5,9,14,35.7%,11m
29779,1,Croco,2539,0,3,2,5,60.0%,10m
29779,2,Lagfirst,2539,60,3,3,6,50.0%,17m
29779,1,Webi,2539,95,3,5,8,37.5%,16m
29779,2,MegejasLT,2539,96,3,6,9,33.3%,4m
29779,2,barnaki,2539,94,3,10,13,23.1%,27m
29779,3,Jannick,2539,30,2,2,4,50.0%,16m
29779,3,Seagull,2539,0,2,4,6,33.3%,58m
29779,2,[FrFrF]Jacques,2539,60,2,7,9,22.2%,1h
29779,3,[BeH]Dax,2539,0,1,0,1,100.0%,27m
29779,3,[NТB]BudBa,2539,30,1,1,2,50.0%,1h
29779,3,IvanOnTech,2539,30,1,2,3,33.3%,57m
29779,2,Darktempest,2539,46,1,5,6,16.7%,1h
29779,3,[Сold]ЯрЧ,2539,0,0,1,1,0.0%,2m
29810,1,Aldorora,2538,1611,121,119,240,50.4%,14m
29810,2,Saian,2538,1565,108,105,213,50.7%,18m
29810,2,Вантус,2538,647,86,72,158,54.4%,4m
29810,1,Manel,2538,1542,75,80,155,48.4%,1h
29810,2,promo,2538,894,73,70,143,51.0%,15m
29810,2,[Пидары]SiTeran,2538,1102,60,53,113,53.1%,1h
29810,1,[SNCL]GTCGeorge,2538,1398,50,58,108,46.3%,1h
29810,2,Акселератор,2538,989,39,41,80,48.8%,1h
29810,1,[1GROM2]Lett,2538,398,17,16,33,51.5%,1h
29810,1,sebeben,2538,426,16,19,35,45.7%,23m
29810,2,ZopAgent,2538,411,16,20,36,44.4%,57m
29810,1,Proxissimo,2538,430,15,21,36,41.7%,1h
29810,1,Owl,2538,407,14,18,32,43.8%,1h
29810,3,[theDH]Bamse,2538,123,12,28,40,30.0%,13m
29810,3,Stefan,2538,242,9,16,25,36.0%,5m
29810,2,Baggier,2538,265,8,7,15,53.3%,15m
29810,2,davkox,2538,156,7,5,12,58.3%,26m
29810,2,Teritor,2538,228,7,13,20,35.0%,1h
29810,1,Abus,2538,166,6,8,14,42.9%,1h
29810,1,Wave,2538,148,6,10,16,37.5%,1h
29810,3,kanrenjiudui,2538,120,5,3,8,62.5%,1h
29810,2,LootGoblin,2538,178,4,4,8,50.0%,11m
29810,2,Morjik,2538,0,3,6,9,33.3%,1h
29810,3,Zaar,2538,58,2,1,3,66.7%,1h
29810,3,exDragonborn,2538,30,2,1,3,66.7%,10m
29810,2,Órói,2538,86,2,2,4,50.0%,27m
29810,2,[nk44]oemer,2538,0,2,4,6,33.3%,1h
29810,3,DeMarco,2538,0,1,0,1,100.0%,1h
29810,3,Fredo,2538,97,1,2,3,33.3%,28m
29810,2,[765]RoBot,2538,0,1,2,3,33.3%,17m
29810,2,[uCHAD]dvsealwasl,2538,30,1,8,9,11.1%,1h
29810,3,[Reano]rePit,2538,0,0,1,1,0.0%,23m
29810,3,xKOTOVSKYx,2538,0,0,1,1,0.0%,10m
29810,3,NoCoMent,2538,0,0,1,1,0.0%,27m
29810,3,PAYMOUS,2538,0,0,1,1,0.0%,1h
29810,2,[Kuci]Keke,2538,0,0,1,1,0.0%,1h
29810,2,Misakusi,2538,0,0,2,2,0.0%,24m
29810,1,ITzjosh,2538,0,0,5,5,0.0%,1h
29848,1,SaschPasch,2537,1627,425,425,850,50.0%,4m
29848,2,Gungani,2537,1428,125,115,240,52.1%,1h
29848,2,[IXXI]Foon,2537,1364,106,104,210,50.5%,1h
29848,1,Karlotte,2537,1620,91,96,187,48.7%,9m
29848,2,KOPOBbEB,2537,1520,72,67,139,51.8%,1h
29848,2,TyЗ,2537,1347,72,72,144,50.0%,1h
29848,2,Ithaqua,2537,722,66,63,129,51.2%,1h
29848,2,CHEINS,2537,914,65,61,126,51.6%,58m
29848,3,grec,2537,1401,60,41,101,59.4%,4m
29848,2,Catfaarts,2537,1334,53,46,99,53.5%,1h
29848,2,[TeMpp]tochkata,2537,753,45,43,88,51.1%,1h
29848,2,firefox,2537,878,32,33,65,49.2%,17m
29848,2,Fnord,2537,362,25,33,58,43.1%,23m
29848,3,Joanito,2537,609,23,28,51,45.1%,22m
29848,2,RumosGrief,2537,322,16,3,19,84.2%,15m
29848,2,арти,2537,363,16,13,29,55.2%,1h
29848,3,[GGBF]Johndave,2537,419,16,16,32,50.0%,58m
29848,1,WolnyBrovar,2537,384,15,17,32,46.9%,1h
29848,2,nhabine,2537,292,13,7,20,65.0%,18m
29848,2,Brinziberfer,2537,332,12,13,25,48.0%,1h
29848,3,DoTank,2537,254,11,11,22,50.0%,13m
29848,3,pioneer,2537,257,9,4,13,69.2%,1h
29848,2,HappyHour,2537,184,8,6,14,57.1%,21m
29848,2,Blossom,2537,212,7,8,15,46.7%,20m
29848,3,MurlocHolmes,2537,98,7,13,20,35.0%,1h
29848,3,uineg,2537,244,7,25,32,21.9%,9m
29848,3,toube,2537,167,5,1,6,83.3%,12m
29848,2,[2iq]MacroLI,2537,130,5,2,7,71.4%,20m
29848,2,outsyder,2537,154,5,7,12,41.7%,1h
29848,2,madalex,2537,90,4,8,12,33.3%,1h
29848,3,Kimmino,2537,38,3,5,8,37.5%,4m
29848,2,loullou,2537,90,3,6,9,33.3%,1h
29848,2,RadicalAce,2537,102,2,3,5,40.0%,1h
29848,2,[ZUBS]DarkWraith,2537,112,2,4,6,33.3%,1h
29848,1,Tavil,2537,97,2,6,8,25.0%,12m
29848,2,LuckyFlower,2537,0,1,1,2,50.0%,5m
29848,3,Niclès,2537,30,1,1,2,50.0%,19m
29848,3,[CRA3]HappyPeter,2537,0,1,2,3,33.3%,7m
29848,3,FrogMasTeD,2537,0,1,4,5,20.0%,57m
29848,3,IceEyes,2537,0,1,5,6,16.7%,18m
29848,3,KENTAURUS,2537,0,0,1,1,0.0%,27m
29848,3,SnIpEr,2537,0,0,1,1,0.0%,2m
29848,2,[Monlit]HPG,2537,0,0,1,1,0.0%,27m
29848,3,gayver,2537,0,0,1,1,0.0%,14m
29892,1,shosh,2536,1530,427,418,845,50.5%,23m
29892,3,[SoothK]Kafk,2536,1509,224,217,441,50.8%,24m
29892,3,Sociologist,2536,1529,150,145,295,50.8%,1h
29892,3,Kosh,2536,924,113,112,225,50.2%,14m
29892,2,XxL,2536,843,34,33,67,50.7%,1h
29892,2,robertnevill,2536,691,26,26,52,50.0%,21m
29892,3,[NGEGNE]PsychoPlow,2536,666,24,22,46,52.2%,1h
29892,2,Poppy,2536,322,13,9,22,59.1%,1h
29892,2,BosBouter,2536,318,13,18,31,41.9%,20m
29892,2,SKJI,2536,303,11,13,24,45.8%,1h
29892,2,[NHT]CaptainFOX,2536,338,11,16,27,40.7%,1h
29892,3,skols,2536,178,5,6,11,45.5%,8m
29892,3,VadimGrig,2536,0,4,5,9,44.4%,25m
29892,3,[OD7]Flappejaques,2536,117,4,7,11,36.4%,13m
29892,3,[aTw]Ash,2536,58,3,0,3,100.0%,10m
29892,1,endBehavior,2536,97,2,2,4,50.0%,1h
29892,3,[TWCE]ElJefe,2536,0,2,3,5,40.0%,1h
29892,3,frank,2536,0,2,4,6,33.3%,1h
29892,1,Warock,2536,96,2,10,12,16.7%,23m
29892,3,Spoedvraat,2536,30,1,2,3,33.3%,1h
29892,3,[StarLg]Moonlight,2536,32,1,4,5,20.0%,19m
29892,2,baricool,2536,30,1,7,8,12.5%,25m
29892,3,qxfunny,2536,0,0,1,1,0.0%,8m
29892,2,[GTD]GTDbaLLer,2536,0,0,2,2,0.0%,25m
29892,2,[QMnewb]ANDERSX,2536,0,0,2,2,0.0%,26m
29917,3,Inquisitor,2535,996,76,58,134,56.7%,10m
29917,2,Staver,2535,639,60,56,116,51.7%,28m
29917,3,bGd,2535,1258,55,67,122,45.1%,22m
29917,3,vovich,2535,967,39,30,69,56.5%,1h
29917,3,FLORENCIO,2535,811,32,20,52,61.5%,1h
29917,3,[crabz]MauZeR,2535,846,30,32,62,48.4%,19m
29917,1,Durek,2535,436,25,31,56,44.6%,19m
29917,3,delazz,2535,521,19,15,34,55.9%,26m
29917,2,[CSJCSJ]Warchild,2535,424,17,12,29,58.6%,1h
29917,2,TomatoJoe,2535,488,14,21,35,40.0%,1h
29917,2,Varcan,2535,308,13,8,21,61.9%,1h
29917,2,DerTote,2535,358,13,13,26,50.0%,20m
29917,1,Mouche,2535,261,10,9,19,52.6%,1h
29917,2,David,2535,208,9,11,20,45.0%,1h
29917,3,Shyon,2535,192,7,10,17,41.2%,3m
29917,2,[DЕ]Dolphin,2535,208,6,8,14,42.9%,1h
29917,1,CrazyFox,2535,193,6,11,17,35.3%,3m
29917,3,Beonix,2535,88,4,2,6,66.7%,2m
29917,2,Mazepa,2535,0,4,4,8,50.0%,1h
29917,1,Kilo,2535,140,4,15,19,21.1%,1h
29917,3,FearLess,2535,58,3,1,4,75.0%,23m
29917,1,GuyFromLol,2535,0,3,2,5,60.0%,2m
29917,1,gekki,2535,109,3,4,7,42.9%,21m
29917,3,Demo,2535,34,3,5,8,37.5%,3m
29917,2,Florencio,2535,44,2,2,4,50.0%,4m
29917,3,kil,2535,97,2,3,5,40.0%,1h
29917,3,Ratь,2535,0,2,3,5,40.0%,1h
29917,2,Mihai,2535,0,2,4,6,33.3%,1h
29917,3,[Pifeur]Belo,2535,0,2,4,6,33.3%,4m
29917,1,ogpaul,2535,0,2,5,7,28.6%,6m
29917,3,[2RVLV]Rambo,2535,0,1,0,1,100.0%,1h
29917,3,neasi,2535,0,1,0,1,100.0%,1h
29917,2,Sind,2535,44,1,2,3,33.3%,1h
29917,3,karanas,2535,34,1,7,8,12.5%,4m
29917,2,[SBR42]eXtaZzy,2535,30,1,8,9,11.1%,1h
29917,1,Eneko,2535,0,0,1,1,0.0%,1h
29917,3,Cemen,2535,0,0,1,1,0.0%,4m
29917,2,LegoLaz,2535,0,0,2,2,0.0%,21m
29917,2,overkill,2535,0,0,2,2,0.0%,60m
29917,2,AizSeDai,2535,0,0,4,4,0.0%,1h
29957,3,Mexanik,2534,1593,159,149,308,51.6%,3m
29957,2,Turtle,2534,1026,159,151,310,51.3%,15m
29957,2,Crunch,2534,1451,101,100,201,50.2%,59m
29957,1,hawko,2534,1603,99,100,199,49.7%,1h
29957,2,Berserk,2534,1431,96,80,176,54.5%,1h
29957,2,StanyslassZ,2534,755,93,92,185,50.3%,26m
29957,2,[NEaG]TomoVeliki,2534,1153,56,51,107,52.3%,20m
29957,2,DoCEnT,2534,606,55,45,100,55.0%,5m
29957,2,KePaLLe,2534,587,29,24,53,54.7%,1h
29957,3,CulDèSac,2534,610,24,24,48,50.0%,1h
29957,3,[AAWW]Txustice,2534,493,19,9,28,67.9%,1h
29957,3,PoliteWhale,2534,496,19,16,35,54.3%,59m
29957,1,Pappajohan,2534,509,19,23,42,45.2%,1h
29957,3,IIIIII,2534,362,13,9,22,59.1%,1h
29957,2,franz,2534,232,9,12,21,42.9%,15m
29957,2,Jawas,2534,231,8,8,16,50.0%,1h
29957,1,Hampoz,2534,142,8,9,17,47.1%,24m
29957,1,[VzT]Dedech,2534,216,7,5,12,58.3%,1h
29957,3,Yamato,2534,135,4,6,10,40.0%,1h
29957,3,Mirus,2534,30,2,0,2,100.0%,1h
29957,3,gegedemeur,2534,0,2,1,3,66.7%,3m
29957,3,Gayство,2534,0,2,3,5,40.0%,1h
29957,2,MrCharqui,2534,0,2,4,6,33.3%,1h
29957,3,Nomkop,2534,95,2,4,6,33.3%,1h
29957,2,Сергей,2534,30,2,5,7,28.6%,1h
29957,2,[JaPP]Taburet,2534,0,1,0,1,100.0%,24m
29957,1,Streichzart,2534,0,1,0,1,100.0%,60m
29957,3,[NAHUY]Commander,2534,0,1,1,2,50.0%,13m
29957,2,blpblrBa,2534,0,1,4,5,20.0%,22m
29957,2,[BC01]Megatron,2534,34,1,5,6,16.7%,57m
29957,3,superdedupe,2534,0,0,1,1,0.0%,3m
29957,3,[kozaks]Pawlonyn,2534,0,0,1,1,0.0%,1h
29989,1,PsilosGR,2533,1625,236,242,478,49.4%,1h
29989,2,sasha,2533,1561,144,142,286,50.3%,21m
29989,1,Ilativ,2533,1548,118,120,238,49.6%,12m
29989,3,[1Rota]Tzunamee,2533,1071,81,75,156,51.9%,6m
29989,3,Zitz,2533,1058,46,31,77,59.7%,25m
29989,2,Selillo,2533,1188,43,46,89,48.3%,18m
29989,3,illuminatus,2533,932,37,41,78,47.4%,21m
29989,2,mosesI,2533,646,26,36,62,41.9%,3m
29989,1,BigHead,2533,726,22,36,58,37.9%,24m
29989,1,OtetsRodnoy,2533,532,18,26,44,40.9%,1h
29989,2,[IBIZA]Lagrangeson,2533,272,17,18,35,48.6%,12m
29989,3,[VoxX]sghjJR,2533,372,14,11,25,56.0%,6m
29989,2,Bob,2533,280,12,7,19,63.2%,14m
29989,3,Anathorne,2533,317,12,15,27,44.4%,20m
29989,2,RaZooM,2533,160,7,6,13,53.8%,24m
29989,1,Lothrick,2533,133,5,11,16,31.2%,1h
29989,1,Terry,2533,121,4,4,8,50.0%,23m
29989,1,БатькаТАРАН,2533,121,4,11,15,26.7%,27m
29989,2,Gaze,2533,102,3,5,8,37.5%,1h
29989,2,pebblS,2533,32,3,6,9,33.3%,5m
29989,1,SACHATTE,2533,0,2,3,5,40.0%,11m
29989,3,Grimmjow,2533,0,1,0,1,100.0%,1h
29989,3,BushBrain,2533,0,1,1,2,50.0%,23m
29989,3,Chaos,2533,0,1,1,2,50.0%,28m
29989,3,NumerusDuo,2533,0,0,1,1,0.0%,6m
29989,1,AlvisidKo,2533,0,0,1,1,0.0%,11m
29989,2,DerKaiser,2533,0,0,2,2,0.0%,2m
29989,2,kenda,2533,0,0,5,5,0.0%,1h
29989,1,Strixling,2533,0,0,7,7,0.0%,1h
30018,2,[LQSA]skruface,2532,1600,149,142,291,51.2%,28m
30018,1,[DrPlat]zurzly,2532,671,66,140,206,32.0%,15m
30018,3,KimLaN,2532,1377,65,59,124,52.4%,10m
30018,3,HolyVomit,2532,562,27,15,42,64.3%,13m
30018,2,Brutalisk,2532,742,26,26,52,50.0%,1h
30018,2,[Высший]mfert,2532,568,24,21,45,53.3%,1h
30018,2,ПсинаШлюхань,2532,491,23,12,35,65.7%,2m
30018,2,TpuKoTa,2532,651,23,24,47,48.9%,1h
30018,2,Wanderer,2532,403,14,16,30,46.7%,9m
30018,1,Nightmare,2532,432,13,19,32,40.6%,25m
30018,3,slavagolden,2532,348,12,14,26,46.2%,1h
30018,2,[NS2019]Alariy,2532,220,11,3,14,78.6%,1h
30018,3,MrBotka,2532,288,10,10,20,50.0%,1h
30018,2,pharmakot,2532,264,9,12,21,42.9%,1h
30018,2,rakot,2532,270,8,10,18,44.4%,1h
30018,3,zar,2532,192,7,16,23,30.4%,14m
30018,2,Euras,2532,88,5,6,11,45.5%,21m
30018,3,[FROP]azlecas,2532,114,4,6,10,40.0%,7m
30018,3,Clockwise,2532,88,3,2,5,60.0%,60m
30018,3,serg,2532,0,3,4,7,42.9%,7m
30018,3,Dox,2532,44,3,6,9,33.3%,24m
30018,2,[HaSKo]Den,2532,134,3,7,10,30.0%,1h
30018,3,[FXB1]Bosancero,2532,30,3,8,11,27.3%,2m
30018,1,Erwan,2532,78,3,11,14,21.4%,24m
30018,3,Puszek,2532,30,2,0,2,100.0%,1h
30018,2,[KiN9S]Samuraj,2532,104,2,2,4,50.0%,11m
30018,3,[PTLc]Pallas,2532,0,1,1,2,50.0%,26m
30018,2,[DTST]nilz,2532,0,1,2,3,33.3%,1h
30018,3,[BluzMT]Chewbacca,2532,30,1,3,4,25.0%,7m
30018,3,[MnrcK]CladFFVII,2532,0,0,1,1,0.0%,10m
30018,3,Uber,2532,0,0,1,1,0.0%,1h
30018,2,Gerbariu,2532,0,0,3,3,0.0%,10m
30018,2,Rufianman,2532,0,0,3,3,0.0%,18m
30051,2,ABCD,2531,1208,107,100,207,51.7%,3m
30051,3,[BCWolf]acmilan,2531,433,45,50,95,47.4%,11m
30051,3,ConChizdaTor,2531,794,31,22,53,58.5%,1h
30051,3,SeeMeNoMore,2531,626,23,17,40,57.5%,1h
30051,2,Aralax,2531,517,22,16,38,57.9%,1h
30051,3,Hades,2531,496,19,15,34,55.9%,6m
30051,3,SaigoDaito,2531,407,17,12,29,58.6%,3m
30051,1,[IFns]KeG,2531,421,17,17,34,50.0%,20m
30051,2,TOOLLLL,2531,371,16,17,33,48.5%,20m
30051,2,ALXfire,2531,378,13,14,27,48.1%,17m
30051,2,PJOZeus,2531,292,11,9,20,55.0%,10m
30051,1,DimonUA,2531,319,10,9,19,52.6%,7m
30051,2,lucster,2531,276,9,7,16,56.2%,18m
30051,3,[WWP]bybybyraguga,2531,200,7,4,11,63.6%,1h
30051,2,notPRO,2531,242,7,9,16,43.8%,17m
30051,2,Whsprs,2531,168,6,4,10,60.0%,1h
30051,3,OnePunchMan,2531,105,5,6,11,45.5%,22m
30051,1,[TQQG]Massacre,2531,146,5,7,12,41.7%,60m
30051,1,Suise,2531,48,4,3,7,57.1%,1h
30051,1,Пчела,2531,0,3,2,5,60.0%,1h
30051,3,[3DE]vossie,2531,0,2,4,6,33.3%,1h
30051,3,neo,2531,129,2,8,10,20.0%,15m
30051,3,ТронЛавр,2531,0,1,0,1,100.0%,13m
30051,1,[BigRat]SteelRat,2531,0,1,1,2,50.0%,1h
30051,2,JustDanil,2531,30,1,6,7,14.3%,18m
30051,3,Foxy,2531,0,0,1,1,0.0%,1h
30051,3,Bourbon,2531,0,0,1,1,0.0%,18m
30051,3,safasasha,2531,0,0,2,2,0.0%,1h
30051,2,Jamba,2531,0,0,3,3,0.0%,59m
30051,2,Curtice,2531,0,0,3,3,0.0%,1h
30051,2,Kessi,2531,0,0,4,4,0.0%,10m
30082,2,FeonwOw,2530,1176,203,173,376,54.0%,1h
30082,2,Krevan,2530,1386,160,152,312,51.3%,3m
30082,2,LastSoldier,2530,1647,116,115,231,50.2%,1h
30082,2,Flur,2530,1385,93,86,179,52.0%,1h
30082,1,[ZHxPro]RobotWizard,2530,1236,86,68,154,55.8%,1h
30082,2,IOregionKZ,2530,1572,67,67,134,50.0%,1h
30082,2,abubakir,2530,1088,60,62,122,49.2%,15m
30082,2,VeTerran,2530,872,44,48,92,47.8%,1h
30082,1,Stylefighter,2530,303,41,39,80,51.2%,1h
30082,3,HePBuK,2530,971,38,25,63,60.3%,1h
30082,3,AndriyJFA,2530,556,25,9,34,73.5%,14m
30082,3,Shukuchi,2530,606,24,22,46,52.2%,6m
30082,2,Packs,2530,553,20,18,38,52.6%,1h
30082,3,Prygames,2530,368,16,11,27,59.3%,1h
30082,2,Barth,2530,296,10,14,24,41.7%,1h
30082,2,SCVREADY,2530,207,7,6,13,53.8%,1h
30082,2,Рорик,2530,208,7,12,19,36.8%,3m
30082,3,judicaes,2530,117,5,4,9,55.6%,16m
30082,3,Raynor,2530,114,4,2,6,66.7%,13m
30082,2,sejermann,2530,116,4,2,6,66.7%,18m
30082,1,murstax,2530,131,4,2,6,66.7%,6m
30082,2,Shezu,2530,151,4,3,7,57.1%,28m
30082,3,[GGBOYZ]puckY,2530,120,4,4,8,50.0%,25m
30082,3,ShPoOnT,2530,60,3,2,5,60.0%,1h
30082,3,michk,2530,0,2,3,5,40.0%,10m
30082,3,Parabellum,2530,0,2,3,5,40.0%,1h
30082,3,BlackSparki,2530,58,2,6,8,25.0%,14m
30082,3,LemanMiracle,2530,0,1,1,2,50.0%,24m
30082,1,AlY,2530,32,1,10,11,9.1%,1h
30082,3,Firehawk,2530,0,0,1,1,0.0%,1h
30082,3,Bullet,2530,0,0,1,1,0.0%,19m
30082,3,Shu,2530,0,0,1,1,0.0%,3m
30082,1,Dredd,2530,0,0,1,1,0.0%,1h
30082,2,HellsAngel,2530,0,0,3,3,0.0%,1h
30082,2,Justdella,2530,0,0,8,8,0.0%,18m
30117,3,Влад,2529,1532,350,348,698,50.1%,3m
30117,1,DEStreuer,2529,1641,328,343,671,48.9%,1h
30117,1,[BARÇA]Rafastary,2529,1394,170,174,344,49.4%,5m
30117,2,RuFF,2529,1554,137,117,254,53.9%,1h
30117,1,LosTinWooDs,2529,1203,58,53,111,52.3%,6m
30117,3,Szymon,2529,1027,40,33,73,54.8%,1h
30117,2,Hasan,2529,327,29,23,52,55.8%,5m
30117,2,LuckyNoob,2529,505,22,20,42,52.4%,1h
30117,1,julio,2529,283,20,25,45,44.4%,8m
30117,2,BarinBarista,2529,434,18,21,39,46.2%,1h
30117,1,UndeadDragon,2529,420,15,20,35,42.9%,1h
30117,3,[хаус]LEV,2529,302,11,6,17,64.7%,26m
30117,3,NeuePflaume,2529,286,10,4,14,71.4%,15m
30117,2,Kallli,2529,230,10,6,16,62.5%,17m
30117,2,Grina,2529,241,8,1,9,88.9%,1h
30117,2,Джедай,2529,222,8,10,18,44.4%,1h
30117,1,Meridian,2529,244,8,14,22,36.4%,1h
30117,1,Gook,2529,156,7,13,20,35.0%,1h
30117,3,JustAPlayer,2529,224,6,6,12,50.0%,1h
30117,2,Cyclone,2529,146,4,4,8,50.0%,1h
30117,2,Pac,2529,88,4,5,9,44.4%,1h
30117,3,[BHM]Efelion,2529,36,4,5,9,44.4%,58m
30117,3,realfreshguy,2529,30,4,6,10,40.0%,23m
30117,2,[DINANT]SlaatjeBla,2529,150,3,4,7,42.9%,22m
30117,3,[TН]ThreeRaptors,2529,0,2,3,5,40.0%,14m
30117,1,Koger,2529,48,2,4,6,33.3%,1h
30117,2,Usul,2529,30,2,6,8,25.0%,22m
30117,3,Gladki,2529,0,1,0,1,100.0%,1h
30117,3,Игнезис,2529,0,1,1,2,50.0%,1h
30117,3,Odal,2529,0,1,1,2,50.0%,18m
30117,3,Zad,2529,0,1,4,5,20.0%,2m
30117,3,Fakk,2529,0,0,1,1,0.0%,2m
30117,3,Jdem,2529,0,0,2,2,0.0%,19m
30117,1,[noоb]KenioN,2529,0,0,3,3,0.0%,8m
30151,2,dawksawk,2528,1482,695,710,1405,49.5%,17m
30151,2,Zulik,2528,1534,226,223,449,50.3%,1h
30151,3,[KGÆ]Dörgn,2528,1553,186,180,366,50.8%,2m
30151,3,DarkWolf,2528,1590,135,120,255,52.9%,58m
30151,2,sotesh,2528,1596,132,126,258,51.2%,1h
30151,2,[BSG19]Zeratul,2528,1555,99,88,187,52.9%,1h
30151,3,PlusTick,2528,1162,45,40,85,52.9%,59m
30151,1,ptolingio,2528,931,31,39,70,44.3%,18m
30151,2,shadi,2528,664,26,23,49,53.1%,22m
30151,2,Flokis,2528,653,25,26,51,49.0%,15m
30151,2,[HmRö]Leikos,2528,732,25,31,56,44.6%,57m
30151,2,Mokujin,2528,662,24,27,51,47.1%,15m
30151,2,[DRTxd]Ferrandom,2528,676,24,28,52,46.2%,1h
30151,1,[101101]Lightning,2528,351,21,20,41,51.2%,1h
30151,1,[HHJung]Bennz,2528,600,21,27,48,43.8%,21m
30151,2,Hondlik,2528,568,20,25,45,44.4%,26m
30151,3,DonSanchos,2528,422,15,9,24,62.5%,1h
30151,2,Donot,2528,412,15,14,29,51.7%,1h
30151,1,Crossraiser,2528,385,15,16,31,48.4%,7m
30151,3,MagusAdptus,2528,362,14,9,23,60.9%,1h
30151,2,Zedized,2528,336,14,16,30,46.7%,58m
30151,2,[alle]alwin,2528,326,13,15,28,46.4%,60m
30151,2,noobz,2528,328,13,17,30,43.3%,58m
30151,3,murshroomik,2528,332,12,5,17,70.6%,23m
30151,3,Nitro,2528,269,9,4,13,69.2%,10m
30151,3,Minime,2528,234,9,15,24,37.5%,1h
30151,3,ImreKiss,2528,231,8,10,18,44.4%,26m
30151,2,Manogaroff,2528,154,7,5,12,58.3%,1h
30151,1,Evasar,2528,193,7,10,17,41.2%,1h
30151,2,Terrazerg,2528,147,6,7,13,46.2%,4m
30151,1,Hoodrych,2528,205,5,9,14,35.7%,2m
30151,3,Dominant,2528,0,4,3,7,57.1%,1h
30151,3,John,2528,0,4,4,8,50.0%,5m
30151,3,Saynd,2528,121,4,4,8,50.0%,19m
30151,3,ToMeeh,2528,165,4,5,9,44.4%,1h
30151,2,Den,2528,119,3,2,5,60.0%,2m
30151,2,MDRufy,2528,140,3,5,8,37.5%,58m
30151,2,Krest,2528,90,3,7,10,30.0%,1h
30151,3,[mfxed]MioFx,2528,30,2,0,2,100.0%,24m
30151,2,[696]Houkai,2528,88,2,2,4,50.0%,15m
30151,1,Raptor,2528,117,2,4,6,33.3%,1h
30151,2,[Comets]Tooshytel,2528,60,2,5,7,28.6%,1h
30151,3,blacktbh,2528,30,1,1,2,50.0%,27m
30151,2,TytoAlba,2528,34,1,8,9,11.1%,1h
30151,3,LeBreton,2528,0,0,1,1,0.0%,10m
30151,1,Drozdie,2528,0,0,1,1,0.0%,1h
30151,2,aleks,2528,0,0,3,3,0.0%,1h
30151,2,Epicnoob,2528,0,0,3,3,0.0%,1h
30199,3,elbaseh,2527,1575,356,392,748,47.6%,8m
30199,2,PerseoSpain,2527,1578,238,245,483,49.3%,10m
30199,3,tenax,2527,626,149,148,297,50.2%,1h
30199,2,[BMDR]alex,2527,1523,124,110,234,53.0%,27m
30199,3,KillerEngine,2527,1386,62,51,113,54.9%,1h
30199,1,MaNNeQuN,2527,935,62,70,132,47.0%,1h
30199,1,PinpinLeCon,2527,1328,54,59,113,47.8%,1h
30199,3,brigadis,2527,1032,44,38,82,53.7%,10m
30199,2,EmilioBandi,2527,1105,44,44,88,50.0%,1h
30199,1,Salameche,2527,403,37,33,70,52.9%,22m
30199,2,[PMMM]Alderonzzzo,2527,871,34,32,66,51.5%,16m
30199,3,VanQuish,2527,681,27,26,53,50.9%,27m
30199,1,Scalarfield,2527,613,25,21,46,54.3%,11m
30199,3,[R1RL]Siper,2527,258,12,9,21,57.1%,1h
30199,2,zjxpro,2527,366,12,19,31,38.7%,24m
30199,3,Tyll,2527,191,12,20,32,37.5%,13m
30199,2,radda,2527,312,11,11,22,50.0%,15m
30199,3,DelWin,2527,240,11,12,23,47.8%,22m
30199,3,PlatonLOL,2527,287,10,5,15,66.7%,59m
30199,2,skunkcloud,2527,205,9,9,18,50.0%,1h
30199,2,MrFlaky,2527,264,9,14,23,39.1%,20m
30199,2,Leckatall,2527,218,8,12,20,40.0%,1h
30199,1,heler,2527,262,6,12,18,33.3%,1h
30199,3,VeganBurrito,2527,193,5,4,9,55.6%,6m
30199,3,Mcx,2527,86,3,3,6,50.0%,60m
30199,3,PUH,2527,0,3,3,6,50.0%,11m
30199,3,zerjudung,2527,30,2,0,2,100.0%,58m
30199,3,AronOslo,2527,30,2,0,2,100.0%,6m
30199,1,Arnie,2527,48,2,0,2,100.0%,6m
30199,2,Vilkas,2527,30,2,3,5,40.0%,1h
30199,3,Beskvit,2527,0,2,5,7,28.6%,11m
30199,3,Galaxy,2527,0,1,0,1,100.0%,1h
30199,3,monster,2527,0,1,0,1,100.0%,15m
30199,3,BulletMagnet,2527,0,1,0,1,100.0%,1h
30199,3,PeterSchaque,2527,97,1,1,2,50.0%,10m
30199,3,Matzman,2527,0,1,1,2,50.0%,8m
30199,3,Wolf,2527,0,1,4,5,20.0%,1h
30199,3,Darguus,2527,0,0,1,1,0.0%,1h
30199,3,Tom,2527,0,0,2,2,0.0%,1h
30199,2,gigi,2527,0,0,4,4,0.0%,19m
30199,2,[PARSE]ANDrus,2527,0,0,4,4,0.0%,1h
30199,1,[drain]captaincuck,2527,0,0,6,6,0.0%,57m
30241,2,[Dobro]кром,2526,1476,470,489,959,49.0%,6m
30241,1,MoMo,2526,1193,70,73,143,49.0%,1h
30241,3,Ultraworg,2526,1187,58,53,111,52.3%,14m
30241,2,Lithium,2526,914,46,43,89,51.7%,1h
30241,2,Shakk,2526,767,33,29,62,53.2%,60m
30241,3,skumfidusen,2526,786,29,23,52,55.8%,13m
30241,3,Nemo,2526,674,26,25,51,51.0%,27m
30241,2,Ragschas,2526,288,14,19,33,42.4%,7m
30241,3,[NuCr]alol,2526,236,8,3,11,72.7%,22m
30241,1,neverfoldaq,2526,254,7,7,14,50.0%,60m
30241,2,[WCKYLN]Naradin,2526,208,7,12,19,36.8%,1h
30241,2,Edward,2526,118,6,4,10,60.0%,1h
30241,2,DuncanIdaho,2526,86,5,5,10,50.0%,17m
30241,2,ButchT,2526,185,5,10,15,33.3%,1h
30241,2,AvDominusNox,2526,154,4,5,9,44.4%,3m
30241,2,ZhukeZZlay,2526,94,4,6,10,40.0%,1h
30241,3,Borrs,2526,145,4,6,10,40.0%,15m
30241,1,kos,2526,189,4,9,13,30.8%,13m
30241,3,[SEWP]STALKER,2526,60,3,2,5,60.0%,19m
30241,3,FuzzyWuzzy,2526,0,3,3,6,50.0%,6m
30241,3,MMV,2526,86,3,3,6,50.0%,25m
30241,1,Mex,2526,145,3,4,7,42.9%,21m
30241,3,XMST,2526,30,2,1,3,66.7%,1h
30241,1,stormi,2526,0,2,4,6,33.3%,11m
30241,3,Fitz,2526,94,2,4,6,33.3%,16m
30241,2,Krutor,2526,60,2,5,7,28.6%,1h
30241,1,Alarion,2526,0,1,2,3,33.3%,1h
30241,2,[asuran]dylan,2526,30,1,4,5,20.0%,60m
30241,2,aya,2526,0,0,4,4,0.0%,1h
30241,2,BelRiose,2526,0,0,4,4,0.0%,10m
30271,1,Cedrik,2525,1618,291,292,583,49.9%,1h
30271,3,[FR1]TRUMP,2525,1483,267,261,528,50.6%,10m
30271,3,Taleo,2525,1532,193,192,385,50.1%,5m
30271,2,BellowYou,2525,1509,154,142,296,52.0%,27m
30271,2,vampa,2525,671,119,109,228,52.2%,1h
30271,1,Doc,2525,1319,78,71,149,52.3%,6m
30271,1,Astaroth,2525,1132,69,67,136,50.7%,1h
30271,1,[Pxyool]MMRSanta,2525,1272,60,36,96,62.5%,2m
30271,2,Leventa,2525,1230,59,53,112,52.7%,1h
30271,2,Andi,2525,1224,49,43,92,53.3%,21m
30271,1,Sorry,2525,1349,48,53,101,47.5%,27m
30271,1,[mfxed]Cisza,2525,1081,40,47,87,46.0%,1m
30271,2,igor,2525,950,36,34,70,51.4%,1h
30271,3,Mayday,2525,533,19,28,47,40.4%,9m
30271,3,magisthebest,2525,392,14,12,26,53.8%,2m
30271,2,komektomek,2525,266,9,13,22,40.9%,10m
30271,2,peghius,2525,139,6,5,11,54.5%,1h
30271,3,llllllllllll,2525,114,5,2,7,71.4%,13m
30271,2,[axis]Theo,2525,171,4,5,9,44.4%,28m
30271,3,Krip,2525,40,3,6,9,33.3%,1h
30271,2,Starley,2525,86,3,7,10,30.0%,27m
30271,3,Feshy,2525,135,2,4,6,33.3%,1h
30271,3,Minh,2525,96,2,4,6,33.3%,10m
30271,3,bmtc,2525,0,2,4,6,33.3%,1h
30271,3,sliwkajr,2525,0,2,4,6,33.3%,1h
30271,2,[SPAINs]aasdfggg,2525,42,1,1,2,50.0%,1h
30271,3,szczepek,2525,30,1,2,3,33.3%,15m
30271,3,[Heroes]Cinober,2525,0,0,1,1,0.0%,10m
30271,3,pwi,2525,0,0,2,2,0.0%,26m
30271,3,EyeOfJustice,2525,0,0,2,2,0.0%,16m
30301,3,Biber,2524,1637,146,144,290,50.3%,60m
30301,1,Sheldor,2524,438,53,55,108,49.1%,18m
30301,1,Dima,2524,1226,47,51,98,48.0%,58m
30301,2,[mfixed]Kargul,2524,858,42,36,78,53.8%,1h
30301,2,Seboulba,2524,944,37,31,68,54.4%,5m
30301,2,Aeternios,2524,203,31,27,58,53.4%,1h
30301,2,Last,2524,606,22,25,47,46.8%,1h
30301,3,[BVE]TöbbN,2524,436,19,8,27,70.4%,28m
30301,3,gamabunty,2524,214,10,15,25,40.0%,14m
30301,2,Traktarion,2524,176,9,15,24,37.5%,12m
30301,3,LaKalaSH,2524,219,7,3,10,70.0%,1h
30301,2,lovemengmeng,2524,281,7,13,20,35.0%,1h
30301,3,Peccattemon,2524,187,5,6,11,45.5%,1h
30301,2,jorko,2524,141,4,2,6,66.7%,21m
30301,2,[EBoI]MissKitty,2524,140,4,3,7,57.1%,1h
30301,2,CoolD,2524,154,4,5,9,44.4%,1h
30301,3,qpb,2524,129,3,6,9,33.3%,11m
30301,3,Funkyshift,2524,127,2,2,4,50.0%,1h
30301,3,Healthy,2524,120,2,3,5,40.0%,1h
30301,3,JackobK,2524,0,2,3,5,40.0%,1h
30301,2,Nikke,2524,0,2,4,6,33.3%,1h
30301,1,ShinyHippo,2524,48,2,4,6,33.3%,1h
30301,3,ReciProcity,2524,0,2,5,7,28.6%,1h
30301,2,Laboisg,2524,0,1,1,2,50.0%,1h
30301,3,Anatomic,2524,38,1,2,3,33.3%,1h
30301,2,[Chariz]AlpakaStar,2524,0,1,4,5,20.0%,1h
30301,3,Kozmogorov,2524,0,0,1,1,0.0%,1h
30301,1,tttatv,2524,0,0,1,1,0.0%,28m
30329,2,Aldebarán,2523,1592,150,145,295,50.8%,1h
30329,3,[Dae]Alnaée,2523,1541,92,66,158,58.2%,1h
30329,2,CIRO,2523,1470,64,58,122,52.5%,1h
30329,2,[cx]Mexx,2523,934,37,27,64,57.8%,3m
30329,1,MightyCD,2523,888,30,38,68,44.1%,19m
30329,2,Manra,2523,677,29,25,54,53.7%,1h
30329,3,[NWGD]benito,2523,680,28,17,45,62.2%,24m
30329,3,Ötschen,2523,552,24,7,31,77.4%,15m
30329,2,mehigh,2523,624,21,25,46,45.7%,1h
30329,2,[EEBÄR]Tarkin,2523,419,18,22,40,45.0%,3m
30329,3,giusetto,2523,333,12,7,19,63.2%,1h
30329,3,Ivan,2523,214,11,5,16,68.8%,59m
30329,1,Kirya,2523,278,11,11,22,50.0%,6m
30329,2,MiszorAlfa,2523,260,10,14,24,41.7%,18m
30329,2,[ICXC]JohnMc,2523,230,8,10,18,44.4%,7m
30329,2,дюша,2523,258,8,11,19,42.1%,7m
30329,3,[coors]coorsllte,2523,189,5,2,7,71.4%,1h
30329,2,[RÖÖV]Madish,2523,86,5,7,12,41.7%,15m
30329,3,Jezux,2523,0,4,3,7,57.1%,4m
30329,3,Cassius,2523,58,3,2,5,60.0%,2m
30329,3,krabs,2523,97,2,0,2,100.0%,18m
30329,3,alexprotasov,2523,30,2,1,3,66.7%,58m
30329,3,kkrava,2523,30,2,1,3,66.7%,1h
30329,3,Nervai,2523,0,2,3,5,40.0%,1h
30329,2,DrMaza,2523,60,2,6,8,25.0%,10m
30329,2,[pndjos]NukeMan,2523,46,2,6,8,25.0%,28m
30329,2,jenda,2523,62,2,7,9,22.2%,58m
30329,2,FreeZstile,2523,58,2,8,10,20.0%,1h
30329,3,Jeral,2523,97,1,2,3,33.3%,1h
30329,2,Abcent,2523,0,1,2,3,33.3%,15m
30329,1,Bimbomix,2523,0,1,4,5,20.0%,10m
30329,1,Luca,2523,48,1,9,10,10.0%,1h
30329,3,Boo,2523,0,0,1,1,0.0%,21m
30329,3,Nigg,2523,0,0,1,1,0.0%,1h
30329,3,zerzilot,2523,0,0,1,1,0.0%,1h
30364,3,[Minet]Tasavalta,2522,1416,89,77,166,53.6%,25m
30364,3,HerrBoe,2522,656,59,66,125,47.2%,24m
30364,3,Trump,2522,984,35,50,85,41.2%,24m
30364,3,[CubRub]Gymnopedie,2522,706,32,22,54,59.3%,27m
30364,2,reesemeister,2522,780,30,28,58,51.7%,1h
30364,2,antonskakun,2522,726,28,28,56,50.0%,1h
30364,3,QuestionGame,2522,634,26,22,48,54.2%,17m
30364,3,crane,2522,632,24,22,46,52.2%,18m
30364,3,Sparkless,2522,500,16,34,50,32.0%,15m
30364,2,Mactao,2522,330,12,10,22,54.5%,1h
30364,2,Alex,2522,318,12,10,22,54.5%,5m
30364,3,PSYKER,2522,321,11,6,17,64.7%,10m
30364,3,GrannyPanty,2522,280,11,9,20,55.0%,58m
30364,3,OraOra,2522,230,9,13,22,40.9%,22m
30364,2,[pndjos]spacegospod,2522,230,8,8,16,50.0%,19m
30364,2,Джесертеп,2522,157,8,8,16,50.0%,1h
30364,1,Pacifist,2522,230,8,16,24,33.3%,19m
30364,2,Adonis,2522,248,7,9,16,43.8%,28m
30364,3,[m333m]ProTivNik,2522,146,6,5,11,54.5%,1h
30364,2,[ECFeV]Czuppy,2522,191,6,6,12,50.0%,17m
30364,2,KasPer,2522,192,6,7,13,46.2%,1h
30364,2,rest,2522,60,5,5,10,50.0%,28m
30364,3,[SPAINs]jOseLiTorZ,2522,60,3,2,5,60.0%,1h
30364,1,[CIA]ValyS,2522,157,3,11,14,21.4%,1h
30364,2,Kamahl,2522,0,2,4,6,33.3%,1h
30364,2,TheArrzator,2522,0,2,4,6,33.3%,5m
30364,1,SEGA,2522,97,2,5,7,28.6%,27m
30364,3,OKSERIAN,2522,0,1,0,1,100.0%,23m
30364,3,ТвояПсихушка,2522,0,1,0,1,100.0%,1h
30364,2,SubaruXXX,2522,0,1,1,2,50.0%,2m
30364,2,Ares,2522,96,1,4,5,20.0%,1h
30364,2,NicoBellic,2522,0,1,6,7,14.3%,1h
30364,3,Hercule,2522,0,0,1,1,0.0%,2m
30364,3,Natic,2522,0,0,1,1,0.0%,17m
30364,3,[Трутни]RazarRiper,2522,0,0,2,2,0.0%,1h
30364,3,Rit,2522,0,0,2,2,0.0%,1h
30400,2,hellsquirrel,2521,1036,158,147,305,51.8%,1h
30400,2,DonConsti,2521,1484,92,90,182,50.5%,17m
30400,2,MiKola,2521,639,63,44,107,58.9%,1h
30400,2,Shia,2521,1284,58,47,105,55.2%,1h
30400,2,Swacha,2521,1323,58,63,121,47.9%,1h
30400,2,SCVready,2521,1185,53,51,104,51.0%,1h
30400,2,jegan,2521,462,16,39,55,29.1%,16m
30400,3,MataGet,2521,410,14,21,35,40.0%,10m
30400,2,Pavian,2521,322,11,14,25,44.0%,1h
30400,3,pashatexnik,2521,234,8,8,16,50.0%,1h
30400,3,excowboy,2521,223,6,4,10,60.0%,11m
30400,2,SixHunter,2521,192,6,6,12,50.0%,1h
30400,2,Devil,2521,168,6,8,14,42.9%,2m
30400,1,Anker,2521,168,6,13,19,31.6%,1h
30400,3,Flowcharted,2521,182,5,6,11,45.5%,1h
30400,3,BIGDADDY,2521,118,5,8,13,38.5%,1h
30400,3,[FTEII]FTElite,2521,86,4,3,7,57.1%,1h
30400,2,BrainEater,2521,60,3,5,8,37.5%,3m
30400,1,Awerest,2521,48,2,4,6,33.3%,4m
30400,2,bloodcyclone,2521,0,2,4,6,33.3%,6m
30400,3,Asterius,2521,38,2,5,7,28.6%,1h
30400,2,[SadW]AdventureAl,2521,60,2,5,7,28.6%,1h
30400,2,Anholio,2521,58,2,6,8,25.0%,57m
30400,1,QAB,2521,0,1,0,1,100.0%,1h
30400,3,Avral,2521,0,1,1,2,50.0%,1h
30400,3,LordIgnac,2521,30,1,1,2,50.0%,1h
30400,3,[xWOCx]ULTRA,2521,30,1,2,3,33.3%,28m
30400,3,torniki,2521,0,0,1,1,0.0%,12m
30400,3,[BULB]RED,2521,0,0,1,1,0.0%,1h
30400,3,Zacke,2521,0,0,2,2,0.0%,2m
30400,3,Hirokumata,2521,0,0,2,2,0.0%,1h
30400,2,SkyZesty,2521,0,0,3,3,0.0%,1h
30432,2,Gaer,2520,1549,232,229,461,50.3%,1h
30432,1,piko,2520,1653,120,121,241,49.8%,1h
30432,1,olivierdsm,2520,1392,58,67,125,46.4%,19m
30432,2,JohnRambo,2520,839,46,40,86,53.5%,1h
30432,3,SolDmi,2520,1032,37,37,74,50.0%,28m
30432,3,zlemrzlemr,2520,467,34,48,82,41.5%,9m
30432,3,karroni,2520,881,34,51,85,40.0%,3m
30432,3,Martin,2520,729,29,25,54,53.7%,1h
30432,2,ShinyPants,2520,666,27,24,51,52.9%,1h
30432,2,piko,2520,471,27,29,56,48.2%,57m
30432,3,Misza,2520,681,26,21,47,55.3%,59m
30432,1,VOTAKE,2520,273,21,31,52,40.4%,16m
30432,2,Filjunior,2520,191,6,9,15,40.0%,28m
30432,2,Tounakcars,2520,190,5,6,11,45.5%,9m
30432,2,Kabautz,2520,148,5,10,15,33.3%,1h
30432,3,Teimos,2520,0,4,1,5,80.0%,23m
30432,3,PaicCitron,2520,58,3,2,5,60.0%,1h
30432,1,THEOS,2520,30,3,5,8,37.5%,1h
30432,2,Дима,2520,0,2,6,8,25.0%,18m
30432,3,jace,2520,0,2,7,9,22.2%,25m
30432,3,ThaNoS,2520,0,1,0,1,100.0%,1h
30432,3,WhiteLotus,2520,0,1,1,2,50.0%,1h
30432,3,Duborg,2520,30,1,2,3,33.3%,1h
30432,3,[BDRV]Knarz,2520,0,0,1,1,0.0%,25m
30432,3,Ivan,2520,0,0,1,1,0.0%,19m
30432,2,Pady,2520,0,0,1,1,0.0%,1h
30432,2,[Leolan]MickiFan,2520,0,0,1,1,0.0%,1h
30432,3,[PPU]ромаsik,2520,0,0,1,1,0.0%,22m
30432,3,abba,2520,0,0,1,1,0.0%,25m
30432,3,[NWGD]Rainism,2520,0,0,1,1,0.0%,60m
30432,2,overlord,2520,0,0,4,4,0.0%,1h
30463,2,FeralRevive,2519,1551,213,188,401,53.1%,1h
30463,2,karapuz,2519,1555,142,129,271,52.4%,1h
30463,2,Giba,2519,1460,65,61,126,51.6%,1h
30463,1,Cyrill,2519,694,24,33,57,42.1%,7m
30463,2,Maarten,2519,546,19,18,37,51.4%,58m
30463,3,Daemos,2519,329,13,1,14,92.9%,59m
30463,2,[Rabbid]PinkCukorka,2519,335,13,11,24,54.2%,28m
30463,2,Élan,2519,374,13,12,25,52.0%,1h
30463,2,kokokiller,2519,364,13,15,28,46.4%,1h
30463,1,Conjuror,2519,338,11,22,33,33.3%,13m
30463,3,[PowOw]FluffyRSA,2519,339,10,14,24,41.7%,7m
30463,3,Xet,2519,193,8,7,15,53.3%,2m
30463,2,alimgiray,2519,171,6,5,11,54.5%,1h
30463,3,[EZBois]KoRnY,2519,171,6,10,16,37.5%,17m
30463,3,Loynis,2519,118,5,3,8,62.5%,1h
30463,3,Epps,2519,129,4,5,9,44.4%,25m
30463,3,[BIoIG]Irae,2519,72,4,7,11,36.4%,1h
30463,3,IIIIIIIIIIII,2519,58,3,0,3,100.0%,18m
30463,1,madnorman,2519,114,3,2,5,60.0%,1m
30463,3,MarkAurel,2519,0,3,3,6,50.0%,1h
30463,2,[Fast43]BUUUUNT,2519,114,3,4,7,42.9%,1h
30463,2,BuGG,2519,60,3,5,8,37.5%,21m
30463,3,Mikola,2519,92,3,5,8,37.5%,5m
30463,3,SkillToPlay,2519,30,2,0,2,100.0%,27m
30463,2,General,2519,88,2,2,4,50.0%,5m
30463,1,Rush,2519,0,2,3,5,40.0%,58m
30463,1,Lino,2519,0,2,4,6,33.3%,1h
30463,1,Kerotic,2519,0,1,0,1,100.0%,1h
30463,3,Бетрезен,2519,0,1,0,1,100.0%,3m
30463,3,NOVA,2519,0,1,0,1,100.0%,14m
30463,3,NuBiK,2519,0,1,0,1,100.0%,1h
30463,3,Hammerfaust,2519,30,1,1,2,50.0%,2m
30463,1,Daddy,2519,97,1,6,7,14.3%,58m
30463,2,[CloudX]nidoking,2519,0,0,1,1,0.0%,7m
30463,3,[ESP1]Legislador,2519,0,0,1,1,0.0%,1h
30463,3,Ramses,2519,0,0,2,2,0.0%,19m
30499,2,Nikech,2518,1630,69,73,142,48.6%,1h
30499,2,Żołnierz,2518,1129,45,47,92,48.9%,18m
30499,2,Shiansu,2518,1056,41,47,88,46.6%,1h
30499,3,PANDANOIR,2518,1157,40,48,88,45.5%,25m
30499,1,[C0LG]ЗtonColl,2518,686,37,35,72,51.4%,6m
30499,2,Daniel,2518,807,31,32,63,49.2%,1h
30499,2,Kahe,2518,642,26,24,50,52.0%,18m
30499,1,Googler,2518,686,23,30,53,43.4%,5m
30499,3,Usbwarrior,2518,241,12,6,18,66.7%,1h
30499,2,Kerrigan,2518,326,12,13,25,48.0%,22m
30499,3,equinox,2518,233,7,2,9,77.8%,1h
30499,2,Rak,2518,192,6,3,9,66.7%,1h
30499,3,Lhuq,2518,120,5,3,8,62.5%,1h
30499,1,Realist,2518,36,5,5,10,50.0%,28m
30499,3,Инфэстос,2518,148,5,7,12,41.7%,13m
30499,2,mangojooce,2518,152,5,10,15,33.3%,59m
30499,3,TheZodiac,2518,86,4,6,10,40.0%,1h
30499,3,FitMonser,2518,130,4,7,11,36.4%,1h
30499,2,ВоваВист,2518,92,4,9,13,30.8%,9m
30499,3,ROMAN,2518,0,3,0,3,100.0%,1h
30499,3,Alexis,2518,115,3,4,7,42.9%,23m
30499,2,DestraM,2518,64,3,5,8,37.5%,1h
30499,3,LightVader,2518,145,3,6,9,33.3%,8m
30499,1,Ludoman,2518,128,3,16,19,15.8%,23m
30499,3,kesha,2518,58,2,2,4,50.0%,1h
30499,3,[skizo]VDZboby,2518,42,2,7,9,22.2%,19m
30499,3,Lebedun,2518,0,1,0,1,100.0%,1h
30499,2,[LoveU]SnaKeDeViL,2518,0,1,1,2,50.0%,22m
30499,1,LilaEismann,2518,48,1,1,2,50.0%,25m
30499,3,Jerles,2518,30,1,1,2,50.0%,1h
30499,2,Andy,2518,42,1,4,5,20.0%,19m
30499,3,Animan,2518,0,1,4,5,20.0%,10m
30499,3,FIM,2518,0,0,1,1,0.0%,19m
30499,3,leo,2518,0,0,1,1,0.0%,2m
30499,3,[Шизоид]Diktator,2518,0,0,1,1,0.0%,1h
30499,1,Anovaku,2518,0,0,1,1,0.0%,58m
30499,2,ваня,2518,0,0,4,4,0.0%,22m
30536,1,NOOBFRISE,2517,1611,300,302,602,49.8%,1h
30536,2,Latos,2517,1524,233,210,443,52.6%,1h
30536,2,MrTigr,2517,1583,193,182,375,51.5%,1h
30536,2,VasoBobinata,2517,1600,149,142,291,51.2%,7m
30536,2,HugMePls,2517,1220,56,57,113,49.6%,17m
30536,2,Zaur,2517,766,28,30,58,48.3%,1h
30536,2,SilveR,2517,545,24,20,44,54.5%,16m
30536,2,Thurenmyr,2517,628,24,24,48,50.0%,1h
30536,2,[Unguad]MatontheMoon,2517,237,24,29,53,45.3%,1h
30536,1,[45silm]tamadCZ,2517,576,20,28,48,41.7%,1h
30536,2,CoronaVirus,2517,466,18,16,34,52.9%,22m
30536,3,[Rennet]mangustmgeli,2517,395,15,15,30,50.0%,28m
30536,3,Laggy,2517,262,11,15,26,42.3%,28m
30536,2,CeytNot,2517,294,10,10,20,50.0%,1h
30536,1,GaaraAD,2517,261,10,12,22,45.5%,1h
30536,3,Arashtoi,2517,206,8,13,21,38.1%,4m
30536,2,SvarmGost,2517,191,6,7,13,46.2%,59m
30536,3,GSXR,2517,154,5,6,11,45.5%,1h
30536,2,[SDDDD]Muchahos,2517,150,4,4,8,50.0%,25m
30536,2,leonardus,2517,88,4,8,12,33.3%,17m
30536,3,[xDADEx]Prumos,2517,86,3,3,6,50.0%,60m
30536,1,ОлЁшка,2517,48,3,3,6,50.0%,28m
30536,3,Solar,2517,86,3,4,7,42.9%,14m
30536,2,yelpHD,2517,142,3,7,10,30.0%,10m
30536,1,ViktOR,2517,0,2,3,5,40.0%,25m
30536,1,[widow]glaude,2517,0,2,3,5,40.0%,60m
30536,3,neqweud,2517,0,2,3,5,40.0%,23m
30536,3,Sacredz,2517,0,2,4,6,33.3%,1h
30536,3,skic,2517,94,2,4,6,33.3%,4m
30536,2,[RYKS]ghost,2517,32,2,8,10,20.0%,17m
30536,3,Alex,2517,0,1,0,1,100.0%,1h
30536,1,[TDPSM]silentkiller,2517,0,1,0,1,100.0%,1h
30536,2,Rolzediser,2517,0,1,1,2,50.0%,16m
30536,3,zpa,2517,30,1,2,3,33.3%,59m
30536,3,[ADKL]BeGemot,2517,30,1,2,3,33.3%,1h
30536,2,Cristi,2517,30,1,5,6,16.7%,2m
30536,1,MatNat,2517,0,0,1,1,0.0%,60m
30536,1,WooDLee,2517,0,0,1,1,0.0%,1h
30536,3,Bioschock,2517,0,0,2,2,0.0%,28m
30536,2,[NoMczZ]KäseKarl,2517,0,0,5,5,0.0%,3m
30576,1,HSX,2516,1609,171,175,346,49.4%,1h
30576,3,Артем,2516,1254,150,133,283,53.0%,3m
30576,2,Noliferxx,2516,1570,146,125,271,53.9%,1h
30576,3,Nosorogh,2516,1675,137,132,269,50.9%,6m
30576,3,Konrad,2516,1432,98,72,170,57.6%,24m
30576,2,HEZHitag,2516,858,96,72,168,57.1%,17m
30576,3,KaRLoS,2516,1039,40,35,75,53.3%,4m
30576,3,RaVeR,2516,910,36,25,61,59.0%,1h
30576,2,Cruzaders,2516,770,31,27,58,53.4%,16m
30576,3,Hadesadric,2516,587,22,20,42,52.4%,23m
30576,2,Martux,2516,552,21,24,45,46.7%,1h
30576,2,Rurouni,2516,307,14,7,21,66.7%,1h
30576,2,Ashafir,2516,297,12,15,27,44.4%,5m
30576,3,Gza,2516,294,9,6,15,60.0%,1h
30576,2,[RGSC2]MONSTER,2516,258,9,9,18,50.0%,18m
30576,1,tagga,2516,274,9,15,24,37.5%,6m
30576,2,Yama,2516,184,7,3,10,70.0%,10m
30576,3,ChaosTheory,2516,140,6,2,8,75.0%,1h
30576,3,YamahaFazer,2516,148,6,6,12,50.0%,1h
30576,2,TombFox,2516,218,6,8,14,42.9%,1h
30576,2,[ZERGТV]BooksKings,2516,168,5,2,7,71.4%,21m
30576,2,MORTIFER,2516,117,5,3,8,62.5%,1h
30576,2,Frenkiart,2516,88,4,3,7,57.1%,21m
30576,2,Ragnarok,2516,80,4,5,9,44.4%,1h
30576,1,proil,2516,163,3,10,13,23.1%,17m
30576,3,Daquan,2516,0,2,4,6,33.3%,2m
30576,1,ZVZisthebest,2516,0,1,0,1,100.0%,1h
30576,3,[BULB]Faraday,2516,0,1,0,1,100.0%,2m
30576,1,Morkalion,2516,46,1,1,2,50.0%,1h
30576,2,МирнаяУтка,2516,0,1,2,3,33.3%,1h
30576,3,[taude]MrHonter,2516,30,1,3,4,25.0%,1h
30576,2,Mecax,2516,0,1,4,5,20.0%,8m
30576,2,zjinder,2516,0,1,5,6,16.7%,1h
30576,3,[No0opE]Mutsue,2516,0,0,1,1,0.0%,1h
30576,3,Цепеш,2516,0,0,1,1,0.0%,10m
30576,3,adapt,2516,0,0,1,1,0.0%,19m
30576,3,Freddy,2516,0,0,2,2,0.0%,1h
30576,3,Evilsend,2516,0,0,3,3,0.0%,28m
30576,2,ccc,2516,0,0,3,3,0.0%,4m
30615,2,Tonsi,2515,1565,210,217,427,49.2%,5m
30615,2,ImmaNvEl,2515,1455,144,138,282,51.1%,1h
30615,1,Janmaret,2515,1616,143,143,286,50.0%,21m
30615,2,SilentFart,2515,1483,136,131,267,50.9%,58m
30615,1,Taurus,2515,373,45,56,101,44.6%,19m
30615,3,Max,2515,892,37,23,60,61.7%,1h
30615,2,Icehammer,2515,802,34,26,60,56.7%,18m
30615,1,Narg,2515,336,14,22,36,38.9%,13m
30615,3,Tunedbyf,2515,251,10,10,20,50.0%,1h
30615,2,hook,2515,198,8,10,18,44.4%,27m
30615,2,DanniWoof,2515,184,5,6,11,45.5%,15m
30615,2,duk,2515,154,5,10,15,33.3%,59m
30615,3,PandaSlander,2515,86,4,2,6,66.7%,18m
30615,3,NoodSaibot,2515,118,3,0,3,100.0%,1h
30615,3,Nebo,2515,58,3,1,4,75.0%,15m
30615,3,[StWill]Izgoi,2515,30,2,1,3,66.7%,19m
30615,3,hAmerOne,2515,30,2,2,4,50.0%,16m
30615,3,[SoLu]Svante,2515,96,2,4,6,33.3%,1h
30615,3,NIghtRaven,2515,0,1,0,1,100.0%,2m
30615,3,Poulpy,2515,0,1,1,2,50.0%,6m
30615,3,DimosS,2515,38,1,1,2,50.0%,1h
30615,3,aeiu,2515,30,1,2,3,33.3%,4m
30615,3,iiiiiiiiiiii,2515,0,1,4,5,20.0%,1h
30615,3,KingMetal,2515,0,1,4,5,20.0%,2m
30615,3,Godbrazer,2515,0,0,1,1,0.0%,4m
30615,3,Aiglederome,2515,0,0,1,1,0.0%,2m
30641,2,Saigonara,2514,1143,184,174,358,51.4%,23m
30641,3,AksMax,2514,1511,99,94,193,51.3%,10m
30641,2,tricstar,2514,1417,91,91,182,50.0%,57m
30641,2,hannireborn,2514,1066,56,55,111,50.5%,26m
30641,2,Troliberator,2514,611,54,50,104,51.9%,1h
30641,2,TomasoCapone,2514,819,50,50,100,50.0%,18m
30641,1,SkewTheWise,2514,923,50,55,105,47.6%,28m
30641,3,Hator,2514,704,30,28,58,51.7%,17m
30641,1,Walhy,2514,645,29,22,51,56.9%,60m
30641,3,SmokyStyle,2514,762,28,25,53,52.8%,28m
30641,3,BitchBuild,2514,622,26,18,44,59.1%,27m
30641,1,Superduke,2514,630,24,22,46,52.2%,21m
30641,3,[ZealZz]Millam,2514,556,21,24,45,46.7%,16m
30641,2,Icy,2514,293,10,17,27,37.0%,18m
30641,3,[MousM]Louie,2514,238,8,11,19,42.1%,1h
30641,2,zoOz,2514,222,8,16,24,33.3%,3m
30641,3,LuckyShot,2514,231,7,2,9,77.8%,11m
30641,2,BattleOoze,2514,209,7,7,14,50.0%,1h
30641,2,[stem]deniska,2514,180,7,13,20,35.0%,16m
30641,3,Htennek,2514,195,6,3,9,66.7%,1h
30641,3,Mahmax,2514,146,6,6,12,50.0%,1h
30641,3,CompleteNoob,2514,169,5,2,7,71.4%,19m
30641,3,Ace,2514,146,4,5,9,44.4%,1h
30641,2,[Tchang]Snoosers,2514,88,3,3,6,50.0%,1h
30641,2,BlackSnow,2514,0,3,6,9,33.3%,28m
30641,1,LuckyPute,2514,0,3,7,10,30.0%,9m
30641,1,DALSTRANEUGL,2514,0,2,1,3,66.7%,5m
30641,1,[PWA]hybrider,2514,48,2,4,6,33.3%,9m
30641,1,[БУБУБ]somebdysm,2514,97,2,4,6,33.3%,1h
30641,2,Joé,2514,42,2,5,7,28.6%,1h
30641,1,[GachiL]саня,2514,60,2,5,7,28.6%,1h
30641,2,СынСКхХх,2514,60,2,6,8,25.0%,16m
30641,3,CypriAAn,2514,30,1,1,2,50.0%,9m
30641,3,canonmaster,2514,0,1,1,2,50.0%,1h
30641,2,XpycTuK,2514,0,1,2,3,33.3%,2m
30641,2,Lionin,2514,0,1,3,4,25.0%,1h
30641,1,Kaizar,2514,0,1,4,5,20.0%,1h
30641,2,SGoodman,2514,0,1,5,6,16.7%,1h
30641,2,[Lore]ПаучёкАлёша,2514,0,1,5,6,16.7%,1h
30641,3,Qawert,2514,0,0,1,1,0.0%,28m
30641,3,ЗлаяКурица,2514,0,0,2,2,0.0%,24m
30641,1,scott,2514,0,0,3,3,0.0%,1h
30683,2,Kaftanza,2513,1525,294,288,582,50.5%,20m
30683,3,TomGeddes,2513,1552,186,187,373,49.9%,11m
30683,1,Tobajas,2513,1210,99,109,208,47.6%,19m
30683,2,EchoSierra,2513,883,73,61,134,54.5%,27m
30683,2,[WOMAN]BigGirl,2513,1569,60,62,122,49.2%,57m
30683,2,[LanVG]Lich,2513,516,44,39,83,53.0%,60m
30683,3,zimnePIWKO,2513,1059,41,29,70,58.6%,13m
30683,3,[R4Time]KinGCOCkROaC,2513,907,40,20,60,66.7%,1h
30683,3,Guest,2513,889,39,26,65,60.0%,10m
30683,3,[АСС]ILvIR,2513,680,25,25,50,50.0%,25m
30683,3,Talamasca,2513,536,19,15,34,55.9%,11m
30683,2,Hizashik,2513,415,16,13,29,55.2%,57m
30683,3,[H2OKT]kuzan,2513,312,15,4,19,78.9%,2m
30683,1,REALbestname,2513,447,15,17,32,46.9%,1h
30683,2,Nestro,2513,368,14,15,29,48.3%,1h
30683,3,Darkness,2513,359,14,17,31,45.2%,4m
30683,3,Tatara,2513,318,12,8,20,60.0%,6m
30683,2,AsmoniX,2513,334,12,14,26,46.2%,58m
30683,2,MWKill,2513,271,11,16,27,40.7%,1h
30683,1,Hexag,2513,276,9,9,18,50.0%,1h
30683,2,[RIZY]ЗлойПингвин,2513,296,9,11,20,45.0%,1h
30683,2,Александр,2513,165,5,6,11,45.5%,25m
30683,3,[RedFmm]Zilord,2513,116,5,7,12,41.7%,1h
30683,2,Phiras,2513,96,4,3,7,57.1%,1h
30683,2,[NNcity]nosochek,2513,107,3,2,5,60.0%,1h
30683,2,Shkolonik,2513,0,1,0,1,100.0%,1h
30683,3,TomecK,2513,30,1,1,2,50.0%,1h
30683,3,Dmitrov,2513,30,1,1,2,50.0%,7m
30683,3,Нагибатор,2513,0,1,1,2,50.0%,1h
30683,3,spbb,2513,30,1,3,4,25.0%,7m
30683,3,WTF,2513,0,0,1,1,0.0%,14m
30714,3,alfredmomo,2512,1482,268,263,531,50.5%,23m
30714,2,radi,2512,734,197,192,389,50.6%,1h
30714,1,Rams,2512,1562,111,118,229,48.5%,1h
30714,3,[KDV]Bisu,2512,528,23,15,38,60.5%,10m
30714,2,[WPru]DTC,2512,550,20,23,43,46.5%,10m
30714,2,fussy,2512,309,17,15,32,53.1%,1h
30714,3,HotShot,2512,458,16,17,33,48.5%,6m
30714,2,[TdZ]Mulder,2512,466,16,24,40,40.0%,1h
30714,3,[BloTi]barcode,2512,364,13,14,27,48.1%,1h
30714,3,Remedy,2512,303,12,4,16,75.0%,11m
30714,3,TntDan,2512,234,10,6,16,62.5%,59m
30714,2,[aDGa]Fabian,2512,176,7,10,17,41.2%,59m
30714,2,Hatten,2512,146,5,8,13,38.5%,10m
30714,3,BattleCat,2512,60,3,1,4,75.0%,19m
30714,3,hAba,2512,147,3,3,6,50.0%,1h
30714,3,Tomskee,2512,44,3,6,9,33.3%,58m
30714,3,SanekMarkov,2512,30,2,1,3,66.7%,59m
30714,3,KungMarco,2512,30,2,2,4,50.0%,2m
30714,3,zolton,2512,58,2,2,4,50.0%,1h
30714,2,Fantomas,2512,88,2,3,5,40.0%,26m
30714,3,SuperAlex,2512,0,2,3,5,40.0%,1h
30714,3,TOBCYXOB,2512,94,2,4,6,33.3%,14m
30714,1,IntoTheAbyss,2512,0,1,1,2,50.0%,1h
30714,3,Nabulak,2512,30,1,1,2,50.0%,13m
30714,2,Zest,2512,42,1,2,3,33.3%,5m
30714,2,Zoulzy,2512,30,1,6,7,14.3%,18m
30714,3,Blâtz,2512,0,0,1,1,0.0%,1h
30714,3,[Sarmat]MissCaVeiRa,2512,0,0,1,1,0.0%,1h
30714,1,namaste,2512,0,0,2,2,0.0%,14m
30714,2,MOON,2512,0,0,5,5,0.0%,1h
30744,2,[GoGGG]Zulluss,2511,1432,199,200,399,49.9%,11m
30744,1,Xabyka,2511,1354,155,150,305,50.8%,9m
30744,2,Dragibus,2511,1299,109,104,213,51.2%,1h
30744,3,Алекс,2511,971,108,102,210,51.4%,7m
30744,2,NaCl,2511,731,63,66,129,48.8%,1h
30744,2,Parmenio,2511,1544,59,63,122,48.4%,16m
30744,3,mrCannibal,2511,562,26,25,51,51.0%,25m
30744,2,Precious,2511,684,26,33,59,44.1%,10m
30744,2,[Kagune]Bartimeus,2511,458,25,16,41,61.0%,1h
30744,3,AllenStorm,2511,655,25,34,59,42.4%,24m
30744,3,Frogshmuckbe,2511,623,24,22,46,52.2%,3m
30744,3,Angel,2511,460,17,11,28,60.7%,1h
30744,3,[ULTX]Sleath,2511,303,17,14,31,54.8%,7m
30744,2,twice,2511,380,14,16,30,46.7%,28m
30744,3,[TRPo]Adam,2511,336,13,15,28,46.4%,1h
30744,3,DeathRiter,2511,345,12,7,19,63.2%,1h
30744,3,Zaur,2511,274,11,13,24,45.8%,1h
30744,2,Thanos,2511,322,11,14,25,44.0%,17m
30744,2,taren,2511,218,10,8,18,55.6%,1h
30744,2,borgius,2511,189,5,2,7,71.4%,1h
30744,2,SABALKOREAN,2511,88,4,3,7,57.1%,22m
30744,2,hiimsorry,2511,120,4,6,10,40.0%,1h
30744,2,Viperon,2511,116,4,8,12,33.3%,1h
30744,1,WayLander,2511,48,3,5,8,37.5%,5m
30744,3,VocxoD,2511,58,2,1,3,66.7%,23m
30744,2,ImyourQueen,2511,30,2,2,4,50.0%,1h
30744,2,Kerya,2511,88,2,2,4,50.0%,1h
30744,3,Allone,2511,95,2,4,6,33.3%,1h
30744,3,Hitman,2511,0,1,0,1,100.0%,1h
30744,3,[ХЛАЗ]хозяинстас,2511,0,0,1,1,0.0%,59m
30744,3,NeuroUlt,2511,0,0,1,1,0.0%,2m
30744,3,[kobr]dannyh,2511,0,0,2,2,0.0%,13m
30744,3,Saken,2511,0,0,2,2,0.0%,1h
30744,2,Rav,2511,0,0,2,2,0.0%,5m
30744,3,Twinsane,2511,0,0,2,2,0.0%,1h
30779,3,IVLEGION,2510,1596,357,339,696,51.3%,6m
30779,2,Psøøm,2510,993,202,186,388,52.1%,1h
30779,3,[SkBG]buratin,2510,1557,146,133,279,52.3%,4m
30779,3,BugsBunnYYY,2510,1115,104,111,215,48.4%,7m
30779,2,HariSeldon,2510,945,57,55,112,50.9%,22m
30779,1,Salamander,2510,952,47,56,103,45.6%,1h
30779,3,[Ctlo]itsme,2510,1048,40,33,73,54.8%,1h
30779,3,ParamValue,2510,738,31,19,50,62.0%,4m
30779,3,Sanepid,2510,731,29,23,52,55.8%,2m
30779,2,Yooda,2510,526,19,20,39,48.7%,1h
30779,2,Nexdra,2510,376,16,19,35,45.7%,1h
30779,2,Solek,2510,376,14,13,27,51.9%,24m
30779,1,bullet,2510,228,10,13,23,43.5%,6m
30779,2,egorka,2510,235,9,4,13,69.2%,60m
30779,3,Freedomland,2510,183,6,6,12,50.0%,19m
30779,3,Andreus,2510,174,5,7,12,41.7%,1h
30779,2,Frangipeti,2510,147,3,2,5,60.0%,20m
30779,3,Mejor,2510,97,3,5,8,37.5%,1h
30779,3,Eevee,2510,0,2,3,5,40.0%,2m
30779,3,[ExTr1m]pinkers,2510,0,1,0,1,100.0%,11m
30779,3,[Catory]Kacpeross,2510,0,1,1,2,50.0%,58m
30779,1,CyalloN,2510,0,1,5,6,16.7%,17m
30779,2,NsǂBbflo,2510,0,1,5,6,16.7%,13m
30779,1,CUCKOLDIK,2510,0,1,5,6,16.7%,5m
30779,3,Даня,2510,0,0,1,1,0.0%,4m
30779,3,chiave,2510,0,0,3,3,0.0%,1h
30779,2,Maier,2510,0,0,6,6,0.0%,1h
30806,3,vaskooo,2509,678,80,85,165,48.5%,4m
30806,2,CapitanKakao,2509,727,33,21,54,61.1%,1h
30806,3,Pete,2509,525,24,23,47,51.1%,6m
30806,3,NaitSpeed,2509,390,15,12,27,55.6%,13m
30806,2,[NINJ88]berserger,2509,261,14,10,24,58.3%,16m
30806,3,Электрик,2509,327,12,7,19,63.2%,1h
30806,3,chippR,2509,284,11,11,22,50.0%,1h
30806,1,[C1u1W]Sniper,2509,307,10,12,22,45.5%,2m
30806,3,Kubanoid,2509,156,6,7,13,46.2%,1h
30806,1,Kuinji,2509,189,6,7,13,46.2%,1h
30806,3,Flash,2509,193,6,10,16,37.5%,3m
30806,2,Fermi,2509,179,5,7,12,41.7%,1h
30806,1,JlевыйНосок,2509,0,3,2,5,60.0%,1h
30806,3,FarmerBilly,2509,97,3,5,8,37.5%,25m
30806,3,NARUD,2509,0,2,3,5,40.0%,6m
30806,3,rasadix,2509,0,2,3,5,40.0%,13m
30806,2,Greyvor,2509,30,2,4,6,33.3%,22m
30806,2,Anarshavin,2509,0,2,4,6,33.3%,18m
30806,3,eTWIIIN,2509,0,2,5,7,28.6%,1h
30806,3,Neyo,2509,30,1,2,3,33.3%,25m
30806,3,AmonRUS,2509,0,0,1,1,0.0%,11m
30806,3,LokkiZzz,2509,0,0,1,1,0.0%,1h
30828,2,vaitl,2508,1644,416,404,820,50.7%,1h
30828,2,benizakura,2508,1310,146,136,282,51.8%,27m
30828,2,leboi,2508,1446,79,64,143,55.2%,20m
30828,3,chris,2508,360,67,71,138,48.6%,23m
30828,3,[RoPRO]shockux,2508,803,53,48,101,52.5%,20m
30828,2,AsaP,2508,802,37,35,72,51.4%,25m
30828,1,[FtSIC]Heron,2508,860,30,39,69,43.5%,1h
30828,3,vallikus,2508,645,26,26,52,50.0%,27m
30828,3,[Profix]LARS,2508,531,22,10,32,68.8%,1h
30828,3,[SURN]MicKey,2508,497,20,13,33,60.6%,5m
30828,2,BigPutotoy,2508,476,19,16,35,54.3%,57m
30828,1,[TBCEP]Ralex,2508,350,18,20,38,47.4%,1h
30828,3,[KBomb]Mantizzla,2508,288,11,7,18,61.1%,19m
30828,3,GhostPepper,2508,322,11,13,24,45.8%,59m
30828,3,Greekdriver,2508,292,10,5,15,66.7%,9m
30828,1,Luigi,2508,276,10,15,25,40.0%,5m
30828,3,Kutagen,2508,252,8,5,13,61.5%,7m
30828,2,ilya,2508,62,6,6,12,50.0%,5m
30828,2,exe,2508,154,6,9,15,40.0%,1h
30828,1,darkpredator,2508,48,5,2,7,71.4%,1h
30828,3,sabastocrato,2508,116,4,5,9,44.4%,1h
30828,3,bogdan,2508,146,4,7,11,36.4%,1h
30828,2,[WNB]gonnabe,2508,0,3,6,9,33.3%,1h
30828,2,Terminator,2508,92,3,9,12,25.0%,1h
30828,3,ThundaHawK,2508,36,2,1,3,66.7%,16m
30828,3,FangVik,2508,121,2,3,5,40.0%,14m
30828,2,[TeamLB]Anomalia,2508,0,2,3,5,40.0%,19m
30828,3,IIIIIIIIIIII,2508,94,2,4,6,33.3%,25m
30828,2,щрып,2508,58,2,6,8,25.0%,1h
30828,3,[voff]Thalaski,2508,0,1,0,1,100.0%,58m
30828,2,SenshiPL,2508,0,1,1,2,50.0%,18m
30828,2,Timbo,2508,0,1,2,3,33.3%,1h
30828,1,AMUN,2508,97,1,2,3,33.3%,1h
30828,3,MMmarc,2508,0,0,1,1,0.0%,5m
30828,3,antonio,2508,0,0,1,1,0.0%,25m
30828,2,zEd,2508,0,0,1,1,0.0%,58m
30828,3,Scrapy,2508,0,0,1,1,0.0%,13m
30828,3,Wertrop,2508,0,0,2,2,0.0%,1h
30866,1,kilu,2507,1605,227,222,449,50.6%,13m
30866,3,[SHGer]SHGxZwirbel,2507,1491,211,209,420,50.2%,18m
30866,1,Hallelujah,2507,1012,42,35,77,54.5%,60m
30866,3,Księciunio,2507,712,34,20,54,63.0%,7m
30866,2,[PANDR1]pao,2507,774,32,27,59,54.2%,18m
30866,3,ICA,2507,588,24,16,40,60.0%,1h
30866,3,Hapide,2507,566,23,15,38,60.5%,2m
30866,3,Matxi,2507,540,23,19,42,54.8%,1h
30866,3,reloco,2507,570,20,30,50,40.0%,6m
30866,2,Ktulhe,2507,492,19,18,37,51.4%,17m
30866,2,Pasgen,2507,416,17,18,35,48.6%,1h
30866,3,UnseenShadow,2507,392,14,13,27,51.9%,18m
30866,1,Snowy,2507,410,13,22,35,37.1%,24m
30866,2,[WWF]Wicked,2507,312,12,10,22,54.5%,28m
30866,2,[BEUW]Voltuxx,2507,358,12,22,34,35.3%,1h
30866,2,Neogen,2507,328,11,18,29,37.9%,1h
30866,3,handkante,2507,185,5,5,10,50.0%,5m
30866,2,Kucmins,2507,150,5,10,15,33.3%,1h
30866,3,Shefry,2507,76,4,7,11,36.4%,19m
30866,1,[KRUNK]Grandma,2507,134,4,13,17,23.5%,5m
30866,3,GogetaSSJ,2507,0,3,2,5,60.0%,1h
30866,3,[TheCIS]Actor,2507,0,3,2,5,60.0%,1h
30866,3,Minorca,2507,118,3,5,8,37.5%,13m
30866,3,KOWIS,2507,30,2,0,2,100.0%,11m
30866,3,CRuser,2507,30,2,0,2,100.0%,14m
30866,3,FelixFelicis,2507,34,2,7,9,22.2%,60m
30866,1,polli,2507,86,2,9,11,18.2%,27m
30866,3,MrTeaTime,2507,30,1,2,3,33.3%,23m
30866,3,Sabbat,2507,0,0,1,1,0.0%,1h
30866,3,Jester,2507,0,0,1,1,0.0%,1h
30866,3,erby,2507,0,0,1,1,0.0%,1h
30866,3,[GnnnN]Xnat,2507,0,0,2,2,0.0%,1h
30866,3,kazim,2507,0,0,2,2,0.0%,16m
30866,3,Soulery,2507,0,0,2,2,0.0%,19m
30900,2,[NFSH]DontPlayToss,2506,1578,699,698,1397,50.0%,18m
30900,1,SEXton,2506,1596,458,452,910,50.3%,1h
30900,2,Praetorian,2506,1258,162,152,314,51.6%,27m
30900,2,лёлик,2506,1351,127,121,248,51.2%,4m
30900,1,GACHIped,2506,793,31,34,65,47.7%,60m
30900,3,XaoCCoaX,2506,486,24,19,43,55.8%,1h
30900,1,Tav,2506,632,24,28,52,46.2%,8m
30900,3,Freakshot,2506,240,12,4,16,75.0%,1h
30900,3,Shurf,2506,326,11,7,18,61.1%,17m
30900,1,RidingSolo,2506,284,9,14,23,39.1%,1h
30900,2,[Foxize]Vad,2506,214,8,11,19,42.1%,1h
30900,2,machinehead,2506,220,8,12,20,40.0%,58m
30900,2,Zertzustr,2506,202,6,9,15,40.0%,1h
30900,2,LeMaterie,2506,224,6,9,15,40.0%,4m
30900,3,Szwejko,2506,92,6,9,15,40.0%,7m
30900,2,[Laki]PhantomKI,2506,174,6,11,17,35.3%,1h
30900,2,Evolution,2506,180,6,11,17,35.3%,10m
30900,3,ShooTer,2506,169,5,1,6,83.3%,1h
30900,2,DasBrot,2506,151,5,8,13,38.5%,18m
30900,3,ArchBshTurpn,2506,146,5,8,13,38.5%,1h
30900,2,Skaice,2506,90,4,6,10,40.0%,1h
30900,1,Zaharel,2506,0,3,2,5,60.0%,1h
30900,2,LOL,2506,30,3,6,9,33.3%,16m
30900,3,Лулу,2506,30,2,0,2,100.0%,11m
30900,3,Gorec,2506,30,2,1,3,66.7%,1h
30900,3,Davion,2506,0,2,1,3,66.7%,13m
30900,3,Enitu,2506,0,2,4,6,33.3%,1h
30900,3,Borja,2506,0,1,0,1,100.0%,27m
30900,3,survivor,2506,0,1,0,1,100.0%,1h
30900,3,Alundra,2506,30,1,1,2,50.0%,14m
30900,3,Purkkiv,2506,30,1,2,3,33.3%,1h
30900,3,BrightLord,2506,30,1,4,5,20.0%,1h
30900,3,[NoSa]Metanoia,2506,0,0,1,1,0.0%,1h
30900,3,Ssnowman,2506,0,0,1,1,0.0%,15m
30900,3,Daxus,2506,0,0,1,1,0.0%,1h
30900,2,pilotPirks,2506,0,0,2,2,0.0%,8m
30936,1,nebukadnezar,2505,1622,259,265,524,49.4%,60m
30936,1,valensy,2505,1563,163,142,305,53.4%,17m
30936,2,[F3cK]CrazyMarine,2505,1046,106,94,200,53.0%,1h
30936,3,kosder,2505,1242,86,96,182,47.3%,24m
30936,3,Quuentin,2505,851,53,49,102,52.0%,1h
30936,1,Sandmann,2505,917,53,65,118,44.9%,5m
30936,3,BravoXVI,2505,1137,51,38,89,57.3%,14m
30936,1,LUICHI,2505,1168,51,43,94,54.3%,19m
30936,3,Draxo,2505,550,50,28,78,64.1%,1h
30936,3,Shuter,2505,524,50,47,97,51.5%,1h
30936,2,lorinc,2505,983,41,41,82,50.0%,1h
30936,3,Ziffa,2505,923,38,28,66,57.6%,15m
30936,2,Mitko,2505,986,37,42,79,46.8%,10m
30936,2,GoGotz,2505,475,21,14,35,60.0%,1h
30936,2,Darkur,2505,466,15,23,38,39.5%,1h
30936,3,[VSPG]uberfish,2505,293,14,11,25,56.0%,1h
30936,2,SHAITANblCH,2505,355,13,10,23,56.5%,1h
30936,3,KoTeDo,2505,320,11,20,31,35.5%,22m
30936,3,EvilDevil,2505,291,10,11,21,47.6%,28m
30936,2,PuzzleInk,2505,176,10,17,27,37.0%,11m
30936,1,asper,2505,268,9,20,29,31.0%,1h
30936,2,LoveULobster,2505,223,8,10,18,44.4%,1h
30936,3,[Bidjo]ZSV,2505,196,7,6,13,53.8%,58m
30936,2,[XNOT]MAXIMUS,2505,164,6,8,14,42.9%,11m
30936,1,Wolverine,2505,148,6,15,21,28.6%,24m
30936,3,[IrFi]Kroton,2505,161,5,8,13,38.5%,16m
30936,1,Paschy,2505,0,4,1,5,80.0%,1h
30936,1,Blackroro,2505,48,4,4,8,50.0%,5m
30936,3,[SBHAWK]Iggy,2505,146,4,6,10,40.0%,16m
30936,3,BrightDROYD,2505,97,3,4,7,42.9%,19m
30936,1,Zikaël,2505,145,3,5,8,37.5%,5m
30936,2,Jelly,2505,30,3,5,8,37.5%,26m
30936,3,[CRAYZE]Адунтеридас,2505,58,2,1,3,66.7%,1h
30936,3,LeMarian,2505,30,2,3,5,40.0%,59m
30936,3,[ClSq]Ислам,2505,0,2,3,5,40.0%,1h
30936,3,Graviton,2505,97,2,4,6,33.3%,19m
30936,2,long,2505,30,2,6,8,25.0%,16m
30936,3,Michael,2505,0,1,0,1,100.0%,1h
30936,3,iliyakrop,2505,0,1,0,1,100.0%,19m
30936,3,LikaBOT,2505,0,1,0,1,100.0%,13m
30936,3,kiskecske,2505,0,1,1,2,50.0%,16m
30936,2,wurzelberto,2505,88,1,2,3,33.3%,2m
30936,2,DINON,2505,30,1,7,8,12.5%,25m
30936,3,Xera,2505,0,0,1,1,0.0%,58m
30936,3,[pLine]fûtonrasenga,2505,0,0,1,1,0.0%,1h
30936,1,[W0N]BaX,2505,0,0,5,5,0.0%,1h
30982,1,Kris,2504,1598,288,292,580,49.7%,1h
30982,2,Peacekeeper,2504,1566,116,123,239,48.5%,10m
30982,2,aratap,2504,1416,71,71,142,50.0%,22m
30982,2,TotoAllstar,2504,513,47,48,95,49.5%,1h
30982,2,kevins,2504,914,37,32,69,53.6%,28m
30982,2,[SOPCA]DraSon,2504,428,32,20,52,61.5%,1h
30982,1,WIND,2504,784,31,36,67,46.3%,20m
30982,3,Rollo,2504,760,30,31,61,49.2%,1h
30982,2,[LJW]Casharel,2504,615,23,23,46,50.0%,1h
30982,2,Dovhakiin,2504,436,14,22,36,38.9%,10m
30982,3,BabaYaga,2504,318,13,12,25,52.0%,13m
30982,3,Tim,2504,337,12,5,17,70.6%,11m
30982,1,KFChrille,2504,297,11,14,25,44.0%,1h
30982,2,savako,2504,274,10,13,23,43.5%,1h
30982,3,AlexL,2504,224,9,8,17,52.9%,8m
30982,2,Clam,2504,218,8,7,15,53.3%,1h
30982,2,Excel,2504,185,8,8,16,50.0%,1h
30982,3,iRumba,2504,178,7,6,13,53.8%,15m
30982,2,Minister,2504,227,6,7,13,46.2%,1h
30982,2,[xzw12]arkushewsky,2504,166,4,7,11,36.4%,28m
30982,3,Eurotrash,2504,60,3,1,4,75.0%,1h
30982,3,James,2504,122,3,2,5,60.0%,21m
30982,3,Kubson,2504,58,2,2,4,50.0%,1h
30982,1,Bro,2504,0,2,5,7,28.6%,20m
30982,3,Goliath,2504,0,1,0,1,100.0%,1h
30982,3,ausg,2504,0,1,0,1,100.0%,14m
30982,3,денчик,2504,0,1,1,2,50.0%,1h
30982,3,[iR3B]Stankezz,2504,0,1,1,2,50.0%,1h
30982,3,zealot,2504,0,1,3,4,25.0%,14m
30982,2,megal,2504,44,1,6,7,14.3%,1h
30982,3,Ciki,2504,0,0,1,1,0.0%,59m
30982,3,Metros,2504,0,0,1,1,0.0%,2m
30982,3,Antropoff,2504,0,0,1,1,0.0%,23m
30982,3,HANZO,2504,0,0,1,1,0.0%,3m
30982,3,Belindaka,2504,0,0,3,3,0.0%,1h
30982,1,Nixonexe,2504,0,0,5,5,0.0%,1h
30982,2,[APAB]Buturinnn,2504,0,0,5,5,0.0%,57m
31019,3,qoop,2503,1036,68,62,130,52.3%,1h
31019,3,pLeHN,2503,746,68,66,134,50.7%,9m
31019,3,Checkit,2503,1118,41,42,83,49.4%,1h
31019,2,Aion,2503,869,36,30,66,54.5%,5m
31019,2,damgel,2503,152,33,32,65,50.8%,13m
31019,3,Koba,2503,435,31,31,62,50.0%,18m
31019,3,varatron,2503,574,21,19,40,52.5%,10m
31019,3,FiRePhaNtOm,2503,315,12,10,22,54.5%,1h
31019,1,[AlienR]Macromaster,2503,320,11,19,30,36.7%,22m
31019,3,Ditmir,2503,151,6,1,7,85.7%,59m
31019,3,dimanoid,2503,148,5,7,12,41.7%,1h
31019,3,bushmen,2503,88,3,6,9,33.3%,1h
31019,3,IIIIIIIIIIII,2503,30,2,1,3,66.7%,1h
31019,2,[MCKH]xädis,2503,0,2,4,6,33.3%,26m
31019,3,Splinterjack,2503,118,2,5,7,28.6%,1h
31019,2,Oakenshield,2503,114,2,5,7,28.6%,1h
31019,3,Adri,2503,0,1,0,1,100.0%,10m
31019,3,Mates,2503,30,1,1,2,50.0%,14m
31019,3,[lGIANT]iMorTalESP,2503,0,1,4,5,20.0%,1h
31019,2,moogly,2503,0,1,4,5,20.0%,27m
31019,3,bpopescu,2503,0,1,4,5,20.0%,23m
31019,3,Darius,2503,0,0,1,1,0.0%,20m
31019,3,Skytoss,2503,0,0,1,1,0.0%,1h
31019,2,RONALD,2503,0,0,4,4,0.0%,18m
31043,3,Grandpac,2502,1436,114,107,221,51.6%,20m
31043,1,SJWJukov,2502,1600,108,102,210,51.4%,1h
31043,1,FANTOM,2502,251,60,59,119,50.4%,16m
31043,3,[VVPE]Lyxa,2502,954,51,15,66,77.3%,1h
31043,3,Colli,2502,1098,50,49,99,50.5%,13m
31043,3,ДантеС,2502,388,15,12,27,55.6%,8m
31043,1,kastamer,2502,336,11,18,29,37.9%,1h
31043,3,RoTK,2502,202,8,5,13,61.5%,28m
31043,1,FLInT,2502,286,8,18,26,30.8%,1h
31043,2,NeroNex,2502,116,4,6,10,40.0%,1h
31043,2,Slaves,2502,84,3,4,7,42.9%,23m
31043,3,Valtum,2502,0,3,5,8,37.5%,23m
31043,1,rafaelazra,2502,48,2,1,3,66.7%,25m
31043,3,нытик,2502,64,2,1,3,66.7%,3m
31043,3,Debellum,2502,30,1,2,3,33.3%,2m
31043,3,Sylvanior,2502,36,1,2,3,33.3%,8m
31043,3,[АУЕШКИ]Egor,2502,30,1,4,5,20.0%,1h
31043,1,krolik,2502,0,0,1,1,0.0%,1h
31043,3,Jose,2502,0,0,1,1,0.0%,1h
31043,3,[Dogies]Crazyabid,2502,0,0,2,2,0.0%,2m
31063,3,Vlad,2501,1500,105,92,197,53.3%,20m
31063,3,[BigFN]YayouZou,2501,1537,105,108,213,49.3%,2m
31063,2,Yamabushi,2501,1326,51,48,99,51.5%,1h
31063,2,Mistic,2501,812,44,48,92,47.8%,27m
31063,2,Jayminator,2501,938,38,35,73,52.1%,27m
31063,3,Maverick,2501,842,35,25,60,58.3%,1h
31063,3,[Obz]Yéthylique,2501,1000,35,39,74,47.3%,1h
31063,2,Davilion,2501,524,21,21,42,50.0%,57m
31063,3,[3Macro]MOT,2501,405,16,20,36,44.4%,9m
31063,2,kamil,2501,352,13,20,33,39.4%,8m
31063,3,Twopic,2501,308,12,8,20,60.0%,1h
31063,3,Wandal,2501,315,11,5,16,68.8%,16m
31063,1,ANTOX,2501,228,8,16,24,33.3%,13m
31063,3,Dreamslayer,2501,118,7,10,17,41.2%,22m
31063,3,Msdok,2501,118,6,8,14,42.9%,1h
31063,2,Automato,2501,178,6,10,16,37.5%,18m
31063,2,Natsukiii,2501,171,5,9,14,35.7%,1h
31063,2,Leslomon,2501,0,4,2,6,66.7%,2m
31063,1,Namerullah,2501,0,4,3,7,57.1%,21m
31063,3,Srad,2501,120,4,7,11,36.4%,19m
31063,1,[xBBCx]LonelyDroner,2501,48,3,5,8,37.5%,1h
31063,2,massiveAtack,2501,30,3,5,8,37.5%,22m
31063,3,Ballrock,2501,0,1,1,2,50.0%,21m
31063,2,[MINAI]boris,2501,30,1,10,11,9.1%,1h
31063,3,Astranger,2501,0,0,1,1,0.0%,1h
31063,3,SpaceDump,2501,0,0,1,1,0.0%,59m
31063,1,Tvorobushek,2501,0,0,4,4,0.0%,7m
31090,2,[WАSD]BenBrown,2500,1223,95,83,178,53.4%,9m
31090,3,Max,2500,1506,85,89,174,48.9%,22m
31090,2,[Mechs]Imperator,2500,902,32,37,69,46.4%,24m
31090,2,[AK47]HOH,2500,615,23,25,48,47.9%,1h
31090,1,shkim,2500,690,23,32,55,41.8%,20m
31090,3,[КПCC]анскилл,2500,497,22,9,31,71.0%,11m
31090,2,Vojtesla,2500,512,19,18,37,51.4%,21m
31090,2,Koz,2500,299,19,22,41,46.3%,1h
31090,2,Chimney,2500,368,12,13,25,48.0%,1h
31090,2,[BoShak]Thatassadar,2500,298,11,15,26,42.3%,1h
31090,2,HedgehogCZ,2500,271,10,13,23,43.5%,16m
31090,2,[KUJD]Damianuś,2500,254,9,13,22,40.9%,1h
31090,3,Goose,2500,218,8,8,16,50.0%,1h
31090,2,LimitLesS,2500,224,8,10,18,44.4%,59m
31090,2,SaintC,2500,84,7,9,16,43.8%,1h
31090,2,stardog,2500,216,7,13,20,35.0%,59m
31090,2,spazmyy,2500,116,6,7,13,46.2%,16m
31090,2,ramirez,2500,190,6,10,16,37.5%,1h
31090,3,Brewsinker,2500,112,5,8,13,38.5%,1h
31090,1,[XDE12]TheTrj,2500,48,4,4,8,50.0%,59m
31090,3,Gluteq,2500,117,3,0,3,100.0%,13m
31090,1,Agarius,2500,145,3,1,4,75.0%,13m
31090,1,desant,2500,0,3,2,5,60.0%,1h
31090,2,Tselest,2500,58,3,5,8,37.5%,24m
31090,3,Rotate,2500,117,2,1,3,66.7%,6m
31090,3,strikersito,2500,0,2,4,6,33.3%,5m
31090,2,Magicharry,2500,0,2,4,6,33.3%,17m
31090,1,Aliaksei,2500,0,2,5,7,28.6%,1h
31090,3,dagahan,2500,0,1,0,1,100.0%,3m
31090,1,TchoY,2500,0,0,1,1,0.0%,7m
31090,3,AppleSauce,2500,0,0,1,1,0.0%,5m
31090,3,AlbatrosssCA,2500,0,0,1,1,0.0%,1h
31090,3,[Dobro]OneHandor,2500,0,0,1,1,0.0%,28m
31090,2,Nver,2500,0,0,3,3,0.0%,1h
31090,1,RElIquIe,2500,0,0,4,4,0.0%,27m
31090,2,Shadowkiller,2500,0,0,8,8,0.0%,5m
31126,3,Stuxie,2499,1552,344,352,696,49.4%,4m
31126,3,LJACK,2499,1541,106,98,204,52.0%,11m
31126,3,rattenplan,2499,1561,81,85,166,48.8%,13m
31126,3,[JaPP]Notorious,2499,1168,80,66,146,54.8%,1h
31126,1,fredophil,2499,706,49,58,107,45.8%,13m
31126,2,[BUND]IhorStalker,2499,1007,45,32,77,58.4%,1h
31126,2,[ExTr1m]sashaTopGg,2499,973,43,31,74,58.1%,16m
31126,1,Golduck,2499,825,41,74,115,35.7%,15m
31126,3,Drakor,2499,793,33,26,59,55.9%,13m
31126,3,hydralongre,2499,637,30,11,41,73.2%,1h
31126,3,Аларак,2499,645,25,32,57,43.9%,9m
31126,3,ArKan,2499,603,24,16,40,60.0%,6m
31126,3,yaykagovna,2499,564,21,19,40,52.5%,3m
31126,2,[Zelos]hummerrr,2499,320,14,18,32,43.8%,1h
31126,3,Strache,2499,337,11,13,24,45.8%,1h
31126,3,LilMax,2499,271,9,10,19,47.4%,2m
31126,2,Philadelphia,2499,258,9,11,20,45.0%,2m
31126,3,ELKAPO,2499,211,8,4,12,66.7%,59m
31126,2,Fish,2499,202,8,6,14,57.1%,1h
31126,2,XROYALxRAGEX,2499,224,8,10,18,44.4%,5m
31126,1,[Connor]Atlantis,2499,251,8,13,21,38.1%,17m
31126,3,AKTIOR,2499,241,7,5,12,58.3%,10m
31126,2,Exmer,2499,218,7,13,20,35.0%,17m
31126,2,Legion,2499,168,5,6,11,45.5%,1h
31126,3,Eltarax,2499,170,5,6,11,45.5%,1h
31126,3,[PLA2N]Titanych,2499,114,4,4,8,50.0%,1h
31126,3,CROKnight,2499,58,3,0,3,100.0%,1h
31126,3,BlackSaiyan,2499,58,3,1,4,75.0%,1h
31126,3,ArmaQ,2499,131,3,2,5,60.0%,5m
31126,1,[CoH]NightWolf,2499,48,3,4,7,42.9%,11m
31126,3,Viszlat,2499,0,3,6,9,33.3%,7m
31126,2,SAM,2499,0,3,6,9,33.3%,26m
31126,3,Mac,2499,30,2,2,4,50.0%,2m
31126,3,Ponchik,2499,0,2,3,5,40.0%,1h
31126,3,Conquistador,2499,0,2,3,5,40.0%,1h
31126,3,Konstantine,2499,38,2,3,5,40.0%,23m
31126,3,TorTiLLo,2499,0,1,0,1,100.0%,1h
31126,3,itsseven,2499,0,1,0,1,100.0%,2m
31126,3,Fjun,2499,0,1,1,2,50.0%,11m
31126,3,GHouL,2499,0,1,1,2,50.0%,1h
31126,1,Lerealaruun,2499,48,1,2,3,33.3%,20m
31126,1,[PRAIM]LingKing,2499,48,1,5,6,16.7%,19m
31126,3,Локи,2499,0,0,1,1,0.0%,58m
31126,3,GradobiciePL,2499,0,0,1,1,0.0%,1h
31126,3,gloc,2499,0,0,1,1,0.0%,1h
31171,2,Zar,2498,1445,90,79,169,53.3%,11m
31171,2,RichardStark,2498,1397,63,63,126,50.0%,6m
31171,1,Kalinator,2498,1022,62,74,136,45.6%,1h
31171,3,Slash,2498,1227,55,42,97,56.7%,1h
31171,1,teren,2498,1466,51,61,112,45.5%,1h
31171,2,[КПCC]sargas,2498,789,42,45,87,48.3%,3m
31171,3,Maden,2498,896,36,28,64,56.2%,13m
31171,2,hWceo,2498,764,33,34,67,49.3%,18m
31171,1,ChocMoS,2498,880,29,38,67,43.3%,19m
31171,1,[DKVT]somyjoe,2498,728,28,30,58,48.3%,1h
31171,2,Patrik,2498,483,20,20,40,50.0%,1h
31171,2,[Despon]zikaz,2498,431,15,17,32,46.9%,5m
31171,2,Sparrow,2498,271,11,10,21,52.4%,1h
31171,3,RaGnArOk,2498,302,11,12,23,47.8%,58m
31171,2,[APNos]Konkachila,2498,250,9,15,24,37.5%,1h
31171,3,[Богов]Gans,2498,190,8,8,16,50.0%,13m
31171,3,MehrRettich,2498,118,5,3,8,62.5%,1h
31171,3,WhiteTiger,2498,88,4,2,6,66.7%,20m
31171,3,Zzimm,2498,171,4,4,8,50.0%,7m
31171,1,Blackwell,2498,0,3,2,5,60.0%,1h
31171,3,Homer,2498,30,2,0,2,100.0%,1h
31171,3,stylz,2498,30,1,1,2,50.0%,1h
31171,3,ICON,2498,94,1,2,3,33.3%,60m
31171,3,SchatziBu,2498,36,1,3,4,25.0%,1h
31171,3,[Ddinsd]Nezhit,2498,30,1,4,5,20.0%,1h
31171,3,[AntiZ]Sicarius,2498,0,0,1,1,0.0%,60m
31171,3,[Hordes]kolanddr,2498,0,0,2,2,0.0%,10m
31171,3,PeeOnPoo,2498,0,0,2,2,0.0%,60m
31171,3,llllllllllll,2498,0,0,3,3,0.0%,2m
31200,2,BlackBW,2497,1548,110,105,215,51.2%,5m
31200,2,paprikaro,2497,1471,62,71,133,46.6%,11m
31200,2,TnT,2497,1045,55,55,110,50.0%,1h
31200,2,Bandidas,2497,673,46,37,83,55.4%,1h
31200,2,[PUoL]ThSwaffelen,2497,917,45,47,92,48.9%,28m
31200,1,wahrschein,2497,1049,43,42,85,50.6%,13m
31200,3,[Rakii]tosun,2497,924,38,29,67,56.7%,24m
31200,3,veretskii,2497,772,32,30,62,51.6%,1h
31200,3,Ermn,2497,710,27,22,49,55.1%,1h
31200,2,StaryKomuch,2497,672,26,29,55,47.3%,1h
31200,3,[G4VR]LUGOZZI,2497,133,9,5,14,64.3%,27m
31200,3,[WIRNIX]Kapaus,2497,218,8,7,15,53.3%,1h
31200,3,[PXLD]Tronzi,2497,172,7,5,12,58.3%,8m
31200,3,[Dondon]Florchan,2497,216,7,10,17,41.2%,3m
31200,2,Libertarian,2497,176,7,11,18,38.9%,5m
31200,2,[SCCZ]MartinTyler,2497,214,7,17,24,29.2%,18m
31200,3,JOSEmalaga,2497,189,6,2,8,75.0%,1h
31200,3,OldmanAdwai,2497,145,4,1,5,80.0%,19m
31200,2,Midnt,2497,120,4,8,12,33.3%,4m
31200,1,Marius,2497,116,3,2,5,60.0%,1h
31200,2,Kay,2497,0,3,6,9,33.3%,9m
31200,2,[Testi]Horschd,2497,97,3,6,9,33.3%,1h
31200,3,Reginald,2497,30,2,2,4,50.0%,17m
31200,3,[PAPss]DrpeppeR,2497,0,2,3,5,40.0%,1h
31200,1,DimonA,2497,0,2,4,6,33.3%,1h
31200,2,Migalhas,2497,0,2,5,7,28.6%,59m
31200,3,[WARHED]WseeDRAGon,2497,97,2,5,7,28.6%,1h
31200,3,Harlekyn,2497,0,1,0,1,100.0%,1h
31200,3,Teno,2497,0,1,0,1,100.0%,1h
31200,3,MikeyMike,2497,30,1,1,2,50.0%,59m
31200,2,Beast,2497,0,1,3,4,25.0%,1h
31200,3,BlackPrince,2497,0,0,1,1,0.0%,4m
31200,3,Keelo,2497,0,0,1,1,0.0%,25m
31200,3,DrWhyte,2497,0,0,1,1,0.0%,1h
31200,3,AuthorBlitz,2497,0,0,1,1,0.0%,6m
31200,2,LeonTer,2497,0,0,5,5,0.0%,1h
31236,3,Alphamale,2496,1288,292,296,588,49.7%,13m
31236,1,Sanity,2496,1529,92,92,184,50.0%,5m
31236,1,bämJay,2496,1062,47,42,89,52.8%,9m
31236,3,[quæck]blackeagle,2496,1169,46,41,87,52.9%,6m
31236,2,jodead,2496,519,31,35,66,47.0%,1h
31236,2,Tatthwa,2496,488,26,28,54,48.1%,1h
31236,2,PrincessSora,2496,379,15,12,27,55.6%,1h
31236,2,cenman,2496,139,15,12,27,55.6%,1h
31236,1,Funfzer,2496,278,8,22,30,26.7%,5m
31236,3,[7I0]Cheesus,2496,178,6,7,13,46.2%,1h
31236,2,Sosalo,2496,144,5,7,12,41.7%,1h
31236,3,JohnMalynsky,2496,90,5,7,12,41.7%,6m
31236,2,Warrior,2496,0,4,3,7,57.1%,25m
31236,3,Barrel,2496,90,4,4,8,50.0%,59m
31236,3,[PÂRłAH]Fangate,2496,123,3,3,6,50.0%,6m
31236,2,DroX,2496,30,3,5,8,37.5%,4m
31236,2,Ludwig,2496,144,3,6,9,33.3%,1h
31236,1,[Bifire]Larviter,2496,105,3,8,11,27.3%,60m
31236,3,Felix,2496,30,2,1,3,66.7%,1h
31236,3,Pitiku,2496,58,2,3,5,40.0%,18m
31236,1,JACHU,2496,88,2,3,5,40.0%,13m
31236,2,jfrey,2496,58,2,4,6,33.3%,10m
31236,1,[KaHa]Tamylas,2496,0,2,4,6,33.3%,18m
31236,3,Leisha,2496,0,2,6,8,25.0%,1h
31236,1,[EGC]invAsion,2496,46,1,1,2,50.0%,17m
31236,3,Rozgonyator,2496,0,1,3,4,25.0%,28m
31236,2,edward,2496,0,1,3,4,25.0%,24m
31236,2,Kruuuk,2496,0,1,9,10,10.0%,6m
31236,3,SageBurn,2496,0,0,1,1,0.0%,1h
31236,1,[Heroes]Rane,2496,0,0,1,1,0.0%,1h
31236,3,ASTARION,2496,0,0,1,1,0.0%,1h
31236,1,SkuLLwArrior,2496,0,0,1,1,0.0%,59m
31236,3,Ginko,2496,0,0,2,2,0.0%,4m
31269,3,Mozystar,2495,1574,254,249,503,50.5%,7m
31269,2,DAle,2495,1542,95,101,196,48.5%,10m
31269,2,[nFc]Cukorfalat,2495,1144,59,57,116,50.9%,1h
31269,2,BarackObama,2495,630,53,45,98,54.1%,27m
31269,2,CryptoMan,2495,1190,49,47,96,51.0%,1h
31269,2,[WАSD]lXXXWASDXXXl,2495,430,35,25,60,58.3%,1h
31269,1,Sorry,2495,879,33,35,68,48.5%,28m
31269,1,Pjerketti,2495,701,26,30,56,46.4%,1h
31269,3,Kordzis,2495,591,25,21,46,54.3%,1h
31269,2,Sooner,2495,529,21,18,39,53.8%,1h
31269,2,Андрей,2495,390,17,12,29,58.6%,1h
31269,2,Tornack,2495,383,13,16,29,44.8%,26m
31269,2,Assasin,2495,286,11,10,21,52.4%,59m
31269,3,[xPAPPA]Generalen,2495,250,11,11,22,50.0%,1h
31269,3,Tigi,2495,92,6,10,16,37.5%,25m
31269,3,DerSchotter,2495,131,4,7,11,36.4%,28m
31269,3,Artmun,2495,0,3,2,5,60.0%,1h
31269,1,Create,2495,0,3,2,5,60.0%,1h
31269,3,Papylapeur,2495,0,3,5,8,37.5%,1h
31269,3,ricoupat,2495,121,3,5,8,37.5%,1h
31269,3,Katsuhiko,2495,0,2,3,5,40.0%,19m
31269,3,СвятоСаша,2495,30,2,4,6,33.3%,15m
31269,2,[DHBY]RobRoyHK,2495,0,2,4,6,33.3%,1h
31269,3,Compramiser,2495,0,1,0,1,100.0%,1h
31269,3,[АУЕШКИ]CEKTAHT,2495,0,1,1,2,50.0%,6m
31269,3,Narek,2495,30,1,1,2,50.0%,4m
31269,1,TOMag,2495,0,1,1,2,50.0%,58m
31269,2,[MERBAL]Grunder,2495,88,1,3,4,25.0%,1h
31269,3,Nero,2495,0,1,4,5,20.0%,1h
31269,1,Neronfapper,2495,0,1,5,6,16.7%,4m
31269,3,pavloo,2495,97,1,5,6,16.7%,6m
31269,2,Draigero,2495,30,1,6,7,14.3%,22m
31269,3,Shonzu,2495,0,0,1,1,0.0%,10m
31269,3,kibo,2495,0,0,2,2,0.0%,19m
31269,2,[ADDR]Feekjo,2495,0,0,5,5,0.0%,15m
31304,2,Nebis,2494,936,119,114,233,51.1%,17m
31304,2,Naonack,2494,1267,87,79,166,52.4%,1h
31304,3,ARCADE,2494,1128,79,66,145,54.5%,19m
31304,2,AVCToday,2494,740,64,56,120,53.3%,10m
31304,2,PapinoPL,2494,818,57,78,135,42.2%,5m
31304,1,AlexTiger,2494,1162,56,62,118,47.5%,8m
31304,3,isakso,2494,1378,53,51,104,51.0%,2m
31304,2,[LMyLF]Grimes,2494,1172,49,39,88,55.7%,1h
31304,2,Teratoma,2494,509,37,35,72,51.4%,3m
31304,2,[RLPX]Wayfarer,2494,500,18,24,42,42.9%,19m
31304,3,iampig,2494,389,16,12,28,57.1%,1h
31304,2,XEROBOEC,2494,346,12,13,25,48.0%,1h
31304,3,tivoli,2494,188,8,9,17,47.1%,24m
31304,3,STALKER,2494,202,7,7,14,50.0%,1h
31304,2,[DNOser]GeteRo,2494,184,6,7,13,46.2%,58m
31304,2,Vectorfox,2494,204,6,10,16,37.5%,1h
31304,3,TheDream,2494,145,4,6,10,40.0%,18m
31304,3,lotsman,2494,60,3,4,7,42.9%,1h
31304,3,schlafmuetze,2494,124,3,5,8,37.5%,4m
31304,3,schuhregal,2494,0,3,6,9,33.3%,9m
31304,3,MiniMe,2494,30,2,1,3,66.7%,11m
31304,2,[Cheel]ЕбуныйУголь,2494,30,2,3,5,40.0%,1h
31304,2,Norfleet,2494,0,1,3,4,25.0%,16m
31304,3,[FrcLn]SzobiPetya,2494,0,0,1,1,0.0%,7m
31304,2,[TCFD]Growlanser,2494,0,0,1,1,0.0%,1h
31304,3,Komarov,2494,0,0,1,1,0.0%,15m
31304,3,meletresteg,2494,0,0,3,3,0.0%,1h
31304,2,Razor,2494,0,0,5,5,0.0%,1h
31304,1,[FKSD]Fearless,2494,0,0,6,6,0.0%,1h
31333,3,[ssev]XMasterMaxX,2493,784,73,54,127,57.5%,25m
31333,3,Salty,2493,601,41,39,80,51.2%,1h
31333,3,Danchik,2493,578,22,20,42,52.4%,28m
31333,2,Zox,2493,220,19,17,36,52.8%,1h
31333,2,andromopa,2493,488,18,16,34,52.9%,1h
31333,3,SPG,2493,297,17,15,32,53.1%,6m
31333,2,Nik,2493,468,17,16,33,51.5%,4m
31333,3,[Ximic]МрачныйВорон,2493,404,15,8,23,65.2%,7m
31333,3,Jimmy,2493,392,15,18,33,45.5%,25m
31333,2,[FBDY]Loial,2493,351,12,17,29,41.4%,1h
31333,1,[PowerG]MasterMind,2493,333,9,18,27,33.3%,11m
31333,3,RemyJack,2493,228,8,8,16,50.0%,1h
31333,2,Atilla,2493,218,7,14,21,33.3%,1h
31333,3,Sebtue,2493,111,6,5,11,54.5%,1h
31333,1,[XxOnX]Kazaran,2493,186,6,9,15,40.0%,1h
31333,2,Esseker,2493,156,6,12,18,33.3%,9m
31333,3,kvas,2493,190,5,2,7,71.4%,13m
31333,2,Thevil,2493,175,5,5,10,50.0%,6m
31333,3,Eagle,2493,88,4,1,5,80.0%,1h
31333,1,soll,2493,0,3,2,5,60.0%,1h
31333,3,MosovD,2493,157,3,3,6,50.0%,5m
31333,2,Tyvo,2493,128,3,7,10,30.0%,27m
31333,3,[NuF]Grubenhubert,2493,30,2,1,3,66.7%,59m
31333,3,bigbasterd,2493,60,2,2,4,50.0%,2m
31333,1,Critical,2493,0,2,3,5,40.0%,1h
31333,3,Fopsik,2493,0,2,3,5,40.0%,11m
31333,2,ogotai,2493,30,2,4,6,33.3%,58m
31333,1,Raph,2493,0,2,4,6,33.3%,4m
31333,3,Shiinka,2493,0,2,5,7,28.6%,20m
31333,1,dimedrol,2493,0,1,4,5,20.0%,1h
31363,1,[LKDSC2]Tacata,2492,861,156,149,305,51.1%,1h
31363,2,VulcanHwi,2492,1477,95,96,191,49.7%,4m
31363,1,[BigDad]WarTC,2492,435,76,64,140,54.3%,58m
31363,1,OverlordUA,2492,1124,76,79,155,49.0%,24m
31363,2,апав,2492,912,43,44,87,49.4%,1h
31363,2,diegotrap,2492,833,33,31,64,51.6%,28m
31363,3,[dddrag]DRAGoon,2492,782,32,19,51,62.7%,9m
31363,2,Qxr,2492,711,28,31,59,47.5%,1h
31363,2,боб,2492,393,22,17,39,56.4%,58m
31363,2,helloworld,2492,549,21,20,41,51.2%,5m
31363,2,Reshetov,2492,482,18,21,39,46.2%,1h
31363,3,MadGik,2492,424,15,15,30,50.0%,1h
31363,3,NeCroBox,2492,311,11,9,20,55.0%,1h
31363,3,Rallist,2492,258,8,5,13,61.5%,1h
31363,3,BirzhanIM,2492,142,6,3,9,66.7%,19m
31363,3,IakovBoy,2492,155,6,6,12,50.0%,4m
31363,1,Kazik,2492,36,5,5,10,50.0%,24m
31363,3,[RSDikk]FeelinIt,2492,122,4,5,9,44.4%,8m
31363,1,[SuPi]BuaMan,2492,0,3,3,6,50.0%,1h
31363,3,Rediska,2492,97,3,5,8,37.5%,1h
31363,2,[CovPar]Cyrialkiller,2492,13,3,6,9,33.3%,19m
31363,2,Sparky,2492,0,3,6,9,33.3%,1h
31363,2,nxXxh,2492,62,2,10,12,16.7%,10m
31363,3,[Барсик]абатур,2492,0,1,0,1,100.0%,1h
31363,3,DasFranck,2492,0,1,3,4,25.0%,28m
31363,3,Ryusaki,2492,0,0,1,1,0.0%,25m
31363,3,Feindflug,2492,0,0,2,2,0.0%,18m
31363,3,Asfaltatore,2492,0,0,2,2,0.0%,11m
31391,2,oneshot,2491,1594,252,247,499,50.5%,20m
31391,3,meety,2491,1019,136,137,273,49.8%,11m
31391,2,gigo,2491,1527,90,77,167,53.9%,11m
31391,3,Stvhh,2491,1361,78,59,137,56.9%,13m
31391,3,Slam,2491,1311,48,62,110,43.6%,7m
31391,2,SpaceMarine,2491,877,47,50,97,48.5%,17m
31391,3,Snap,2491,800,33,35,68,48.5%,10m
31391,3,Denver,2491,411,25,16,41,61.0%,20m
31391,3,[GOAMPU]BlackViper,2491,523,20,14,34,58.8%,1h
31391,3,ZergMan,2491,372,13,12,25,52.0%,2m
31391,3,Atuin,2491,288,12,6,18,66.7%,1h
31391,3,[NLTN]Wokram,2491,162,5,2,7,71.4%,5m
31391,3,xXBenja,2491,141,5,4,9,55.6%,11m
31391,3,Drakdödaren,2491,159,5,6,11,45.5%,1h
31391,1,Grizelbrand,2491,145,3,5,8,37.5%,1h
31391,2,Barbogio,2491,60,3,6,9,33.3%,26m
31391,2,smilekg,2491,100,3,11,14,21.4%,10m
31391,3,TriXFox,2491,58,2,1,3,66.7%,1h
31391,3,[Zgeeg]Appollo,2491,30,2,1,3,66.7%,1h
31391,1,[DUB42]GuRrilLA,2491,0,2,2,4,50.0%,6m
31391,3,Atom,2491,119,2,2,4,50.0%,1h
31391,3,Asskalltoss,2491,30,2,2,4,50.0%,15m
31391,1,Rastafr,2491,0,2,4,6,33.3%,6m
31391,1,[NJoke]SpaceMarine,2491,0,1,0,1,100.0%,3m
31391,3,anusPizza,2491,0,1,0,1,100.0%,1h
31391,3,Schmock,2491,30,1,1,2,50.0%,1h
31391,3,Nexus,2491,0,1,3,4,25.0%,14m
31391,2,[ББОХ]Racer,2491,42,1,5,6,16.7%,18m
31419,3,CyberTooth,2490,1531,259,245,504,51.4%,23m
31419,1,SgtSlapaho,2490,1555,182,182,364,50.0%,1h
31419,2,Mudi,2490,1603,152,146,298,51.0%,5m
31419,1,CoffeeOK,2490,1554,134,132,266,50.4%,1h
31419,3,ErsatzZ,2490,440,60,63,123,48.8%,19m
31419,2,lethik,2490,858,35,40,75,46.7%,27m
31419,3,[3ЕRGTV]unster,2490,446,17,8,25,68.0%,2m
31419,2,Life,2490,364,13,19,32,40.6%,1h
31419,1,InfWeaker,2490,218,9,14,23,39.1%,8m
31419,2,[BROWAR]Thernobyl,2490,246,8,8,16,50.0%,20m
31419,3,Slvaman,2490,145,4,2,6,66.7%,13m
31419,1,Wzzzup,2490,48,4,9,13,30.8%,13m
31419,3,Kaizoku,2490,0,3,2,5,60.0%,1h
31419,2,SilverDrake,2490,0,2,4,6,33.3%,20m
31419,3,korigien,2490,0,1,2,3,33.3%,1h
31419,3,[cosset]МнеЧГода,2490,0,0,1,1,0.0%,60m
31419,3,[Mavis]Infection,2490,0,0,2,2,0.0%,4m
31419,3,vodyanoy,2490,0,0,3,3,0.0%,3m
31437,3,Alexsandr,2489,1157,56,52,108,51.9%,19m
31437,2,zwei,2489,1323,54,53,107,50.5%,17m
31437,1,[mfixed]DziabTenToP,2489,606,46,45,91,50.5%,20m
31437,1,Staross,2489,996,43,41,84,51.2%,1h
31437,2,Tank,2489,998,38,44,82,46.3%,1h
31437,3,Mantis,2489,605,26,24,50,52.0%,1h
31437,3,[Chonky]Effigy,2489,443,22,18,40,55.0%,1h
31437,3,[SC22SC]Kseno,2489,574,22,20,42,52.4%,24m
31437,2,Derk,2489,504,20,20,40,50.0%,1h
31437,1,friedchicken,2489,240,8,12,20,40.0%,21m
31437,3,[2P]VYSSH,2489,179,6,5,11,54.5%,1h
31437,3,[Teror]Fok,2489,144,6,6,12,50.0%,60m
31437,2,Krisinox,2489,142,6,6,12,50.0%,8m
31437,3,Naruto,2489,82,5,5,10,50.0%,5m
31437,3,[KH4ZIX]jungceaser,2489,154,5,8,13,38.5%,1h
31437,2,Lvcian,2489,201,5,12,17,29.4%,19m
31437,3,noid,2489,74,4,7,11,36.4%,22m
31437,3,Akma,2489,58,3,0,3,100.0%,8m
31437,3,[DHCP]Hiderow,2489,122,2,2,4,50.0%,10m
31437,3,CeoEasyCo,2489,30,2,2,4,50.0%,13m
31437,1,[CHKO]Puncocha,2489,145,2,2,4,50.0%,21m
31437,2,XAXOL,2489,30,2,3,5,40.0%,1h
31437,1,TheOrangeGuy,2489,0,2,4,6,33.3%,1h
31437,1,Alexanik,2489,0,2,5,7,28.6%,24m
31437,1,terafly,2489,48,2,5,7,28.6%,13m
31437,3,TimEY,2489,0,1,0,1,100.0%,11m
31437,3,[tofury]victor,2489,0,1,1,2,50.0%,1h
31437,3,[SVG221]SimlPro,2489,0,1,1,2,50.0%,1h
31437,1,qpo,2489,97,1,2,3,33.3%,4m
31437,3,DarkSeid,2489,30,1,2,3,33.3%,1h
31437,1,Monster,2489,0,1,4,5,20.0%,1h
31437,3,Izolda,2489,0,0,1,1,0.0%,1h
31437,3,VoidHunter,2489,0,0,1,1,0.0%,1h
31437,3,Bodybag,2489,0,0,2,2,0.0%,14m
31437,2,[CxCx]Mercilla,2489,0,0,2,2,0.0%,28m
31437,3,Rofo,2489,0,0,3,3,0.0%,28m
31437,3,Karunun,2489,0,0,4,4,0.0%,1h
31474,1,BlackSynergy,2488,1531,123,125,248,49.6%,1h
31474,1,Segment,2488,1320,62,68,130,47.7%,1h
31474,3,Mirco,2488,1272,55,38,93,59.1%,25m
31474,2,Kinimod,2488,818,31,32,63,49.2%,57m
31474,3,GERT,2488,440,17,14,31,54.8%,28m
31474,1,Den,2488,332,12,21,33,36.4%,1h
31474,2,[SanFam]JLS,2488,328,11,20,31,35.5%,1h
31474,2,[VBP]smellybrie,2488,202,9,11,20,45.0%,16m
31474,2,JegouGo,2488,127,8,4,12,66.7%,8m
31474,2,Blance,2488,258,7,11,18,38.9%,1h
31474,2,topkek,2488,208,7,13,20,35.0%,20m
31474,2,Azrev,2488,182,6,8,14,42.9%,27m
31474,3,[RSPCT]scout,2488,170,5,6,11,45.5%,5m
31474,3,Skald,2488,116,4,3,7,57.1%,1h
31474,3,superdario,2488,116,4,4,8,50.0%,14m
31474,3,AstraDrail,2488,97,3,5,8,37.5%,1h
31474,2,azubiek,2488,30,3,5,8,37.5%,1h
31474,2,Hazi,2488,58,3,6,9,33.3%,22m
31474,3,FriZzMF,2488,42,3,6,9,33.3%,1h
31474,2,EvgenVV,2488,145,3,7,10,30.0%,4m
31474,3,[OuaiBB]SǂDukiduck,2488,58,2,2,4,50.0%,1h
31474,2,DaKid,2488,0,2,4,6,33.3%,5m
31474,3,MasliozE,2488,118,2,4,6,33.3%,1h
31474,1,Lancevroot,2488,48,2,5,7,28.6%,18m
31474,2,Cinesino,2488,58,2,7,9,22.2%,16m
31474,2,Gambinok,2488,44,2,7,9,22.2%,8m
31474,3,INSOLID,2488,0,1,0,1,100.0%,1h
31474,3,Zemik,2488,40,1,2,3,33.3%,1h
31474,3,Vereno,2488,0,1,4,5,20.0%,1h
31474,3,Jstore,2488,0,1,5,6,16.7%,1h
31474,3,coLLider,2488,0,0,1,1,0.0%,21m
31474,2,[MSUSC2]JoDSolo,2488,0,0,5,5,0.0%,1h
31506,2,Pios,2487,822,207,203,410,50.5%,15m
31506,3,SHMOKEKUSH,2487,1234,67,66,133,50.4%,4m
31506,2,[LMBD]Lanu,2487,1279,47,61,108,43.5%,18m
31506,3,alfice,2487,724,32,21,53,60.4%,3m
31506,3,bossk,2487,367,29,22,51,56.9%,1h
31506,3,Woody,2487,672,28,21,49,57.1%,1h
31506,3,Khadgar,2487,444,28,25,53,52.8%,1h
31506,3,IIIIIIIIIIII,2487,518,27,7,34,79.4%,9m
31506,3,alexkiller,2487,468,25,9,34,73.5%,1h
31506,3,sserg,2487,632,25,17,42,59.5%,1h
31506,3,elmasmalo,2487,607,24,15,39,61.5%,1h
31506,3,QTMAN,2487,391,15,12,27,55.6%,1h
31506,3,Alakir,2487,384,15,16,31,48.4%,11m
31506,2,Raven,2487,352,13,17,30,43.3%,1h
31506,3,oZF,2487,202,7,7,14,50.0%,1h
31506,3,[ĦĦ]xmiio,2487,172,6,2,8,75.0%,19m
31506,2,Monteiga,2487,132,4,6,10,40.0%,13m
31506,3,[TopSD]MrPilot,2487,128,4,7,11,36.4%,1h
31506,1,Serwort,2487,145,3,4,7,42.9%,12m
31506,3,[RA]Vasman,2487,34,2,4,6,33.3%,1h
31506,1,Zergitop,2487,0,2,5,7,28.6%,28m
31506,3,heliosfire,2487,0,1,0,1,100.0%,1h
31506,3,krasoto,2487,0,1,1,2,50.0%,18m
31506,1,Garantin,2487,48,1,1,2,50.0%,1h
31506,3,Untamo,2487,0,1,2,3,33.3%,15m
31506,3,Abstaubear,2487,36,1,2,3,33.3%,19m
31506,3,Карума,2487,34,1,4,5,20.0%,5m
31506,3,[FuNcp]FuNEcLiPsE,2487,0,1,4,5,20.0%,1h
31506,3,Gazboom,2487,0,0,1,1,0.0%,4m
31506,2,LizaKhvan,2487,0,0,2,2,0.0%,6m
31506,3,Godspeed,2487,0,0,3,3,0.0%,1h
31537,3,VolkorenBroo,2486,1545,149,139,288,51.7%,20m
31537,2,UhberPussay,2486,1528,79,68,147,53.7%,1h
31537,3,Aisuviz,2486,1476,78,61,139,56.1%,11m
31537,2,IIIIIIIIIIII,2486,1086,78,67,145,53.8%,25m
31537,3,Rockoreal,2486,1579,76,67,143,53.1%,5m
31537,2,Kakasoul,2486,561,63,62,125,50.4%,1h
31537,1,BadAssApone,2486,1516,53,67,120,44.2%,13m
31537,1,СТАЛИН,2486,1145,44,45,89,49.4%,1h
31537,3,cookielord,2486,817,32,24,56,57.1%,1h
31537,3,CHEESE,2486,561,24,17,41,58.5%,11m
31537,3,Medusa,2486,624,23,27,50,46.0%,2m
31537,3,Genyl,2486,417,17,9,26,65.4%,1h
31537,1,Tyrant,2486,394,16,17,33,48.5%,9m
31537,3,Nyador,2486,451,15,19,34,44.1%,1h
31537,2,RatiboR,2486,332,11,18,29,37.9%,58m
31537,3,[hruska]supervisor,2486,264,10,10,20,50.0%,27m
31537,3,CartoFunMan,2486,89,4,6,10,40.0%,1h
31537,3,LastSamurai,2486,68,4,7,11,36.4%,1h
31537,2,[x1337x]butch,2486,152,4,7,11,36.4%,10m
31537,3,pphi,2486,58,2,1,3,66.7%,18m
31537,3,Copperhead,2486,93,2,4,6,33.3%,28m
31537,2,[Shinе]Tanya,2486,30,2,4,6,33.3%,1h
31537,1,ibalmetall,2486,0,2,5,7,28.6%,24m
31537,3,KuduVoodoo,2486,125,2,6,8,25.0%,1h
31537,3,llIIlIIlI,2486,0,1,0,1,100.0%,5m
31537,3,Kadrenko,2486,0,1,0,1,100.0%,28m
31537,3,[VLHLM]Habkinson,2486,97,1,1,2,50.0%,8m
31537,2,kanibalas,2486,0,1,1,2,50.0%,27m
31537,1,politis,2486,0,1,1,2,50.0%,10m
31537,1,RaMiiii,2486,0,1,2,3,33.3%,27m
31537,3,[mMcH]Альбиус,2486,0,0,1,1,0.0%,26m
31537,3,Zel,2486,0,0,1,1,0.0%,8m
31537,3,BlackRaven,2486,0,0,1,1,0.0%,8m
31537,1,SHblSHKA,2486,0,0,2,2,0.0%,1h
31571,3,GrumpyKitten,2485,1071,71,30,101,70.3%,1h
31571,1,MrDr,2485,1200,43,56,99,43.4%,1h
31571,3,MisterPoop,2485,589,30,8,38,78.9%,20m
31571,2,[Нога]Bash,2485,467,28,30,58,48.3%,28m
31571,2,Мухосранск,2485,648,24,27,51,47.1%,1h
31571,3,[nasse]Planschkuh,2485,514,19,15,34,55.9%,18m
31571,1,KaterKarlo,2485,572,18,29,47,38.3%,21m
31571,3,Zwieback,2485,422,17,15,32,53.1%,1h
31571,3,CENATRA,2485,354,13,14,27,48.1%,1h
31571,2,Ando,2485,335,12,15,27,44.4%,7m
31571,3,bushwakko,2485,297,11,16,27,40.7%,3m
31571,2,[Slaped]Cayloc,2485,240,8,9,17,47.1%,59m
31571,3,atu,2485,164,7,7,14,50.0%,58m
31571,2,AimieW,2485,242,7,10,17,41.2%,13m
31571,3,Lamborghini,2485,172,6,5,11,54.5%,2m
31571,3,Snowen,2485,114,5,3,8,62.5%,1h
31571,2,[KFSRus]IIIIIIIIIIII,2485,172,5,6,11,45.5%,1h
31571,3,Cheshir,2485,146,5,6,11,45.5%,24m
31571,3,zpa,2485,160,5,6,11,45.5%,1h
31571,3,JokeR,2485,168,5,7,12,41.7%,1h
31571,2,[TLKES]Loganolt,2485,146,5,11,16,31.2%,27m
31571,2,Potato,2485,165,4,5,9,44.4%,16m
31571,3,Ranajay,2485,146,4,6,10,40.0%,3m
31571,2,BloXCoCo,2485,120,4,6,10,40.0%,26m
31571,3,Twinsen,2485,58,3,3,6,50.0%,20m
31571,1,[BWD]JohnCoffey,2485,0,1,1,2,50.0%,1h
31571,1,[LaB]Sleepy,2485,97,1,1,2,50.0%,58m
31571,3,CLAVDIVS,2485,0,1,1,2,50.0%,13m
31571,3,[OPANA]ЗDCAT,2485,95,1,1,2,50.0%,1h
31571,3,ckvbp,2485,30,1,2,3,33.3%,1h
31571,1,cannington,2485,0,1,4,5,20.0%,26m
31571,3,raggsocken,2485,0,0,1,1,0.0%,13m
31571,3,[Teckno]Magicwill,2485,0,0,2,2,0.0%,19m
31604,3,EbonyMaw,2484,1582,188,175,363,51.8%,1h
31604,3,BoxAndOne,2484,1462,83,74,157,52.9%,1h
31604,2,[Mering]Meringa,2484,982,61,73,134,45.5%,18m
31604,3,[MagFiC]Larke,2484,760,47,0,47,100.0%,8m
31604,3,[INCELS]ELLIODOR,2484,1036,42,32,74,56.8%,11m
31604,2,alexdi,2484,1099,41,43,84,48.8%,4m
31604,3,timur,2484,790,31,29,60,51.7%,1h
31604,3,asfasd,2484,549,30,26,56,53.6%,26m
31604,3,Brocolie,2484,674,29,19,48,60.4%,24m
31604,3,Ressehc,2484,699,27,19,46,58.7%,11m
31604,2,[RVodka]SaGe,2484,642,25,23,48,52.1%,1h
31604,2,Avicenna,2484,444,23,32,55,41.8%,1h
31604,2,Pupsik,2484,184,18,22,40,45.0%,19m
31604,3,BristleBack,2484,439,16,17,33,48.5%,60m
31604,3,VRdog,2484,251,14,8,22,63.6%,58m
31604,1,Automotion,2484,315,10,14,24,41.7%,13m
31604,2,Ычь,2484,219,9,13,22,40.9%,1h
31604,3,[Listic]Oxid,2484,146,6,5,11,54.5%,20m
31604,3,Arkord,2484,191,6,6,12,50.0%,1h
31604,3,Oleksandr,2484,172,5,7,12,41.7%,8m
31604,3,[MMRape]MaTT,2484,92,4,4,8,50.0%,1h
31604,3,[FBON]Nakami,2484,90,4,5,9,44.4%,60m
31604,2,Naaya,2484,130,3,7,10,30.0%,1h
31604,1,Womble,2484,97,2,2,4,50.0%,1h
31604,3,Zloyd,2484,0,2,5,7,28.6%,8m
31604,3,NukeDukem,2484,30,1,1,2,50.0%,26m
31604,3,[SUKC]Yondibus,2484,30,1,5,6,16.7%,1h
31604,3,[NTIG]Seezz,2484,0,0,1,1,0.0%,1h
31604,3,lobster,2484,0,0,1,1,0.0%,5m
31604,3,[ULTX]schorsch,2484,0,0,2,2,0.0%,6m
31604,1,Batya,2484,0,0,4,4,0.0%,28m
31635,2,Gabriel,2483,1285,300,303,603,49.8%,22m
31635,3,AcidFlow,2483,1057,139,131,270,51.5%,1h
31635,3,SHETKATAPULT,2483,1280,138,152,290,47.6%,24m
31635,3,[Rsport]rafiesprt,2483,1487,91,72,163,55.8%,8m
31635,3,Juanito,2483,1565,70,63,133,52.6%,1h
31635,3,Neal,2483,433,16,11,27,59.3%,1h
31635,3,Леонел,2483,412,16,14,30,53.3%,21m
31635,1,Leopard,2483,313,11,14,25,44.0%,25m
31635,3,[MMRis]ArchonDrops,2483,317,10,9,19,52.6%,1h
31635,2,NorenBlack,2483,266,9,11,20,45.0%,24m
31635,2,Menver,2483,278,9,16,25,36.0%,1h
31635,3,IvaN,2483,216,8,9,17,47.1%,19m
31635,3,DJartie,2483,116,6,7,13,46.2%,1h
31635,2,bullet,2483,199,5,7,12,41.7%,19m
31635,1,Milziade,2483,122,3,5,8,37.5%,15m
31635,3,ViniVinci,2483,121,3,7,10,30.0%,1h
31635,1,Potapchups,2483,96,3,9,12,25.0%,1h
31635,3,Mendelson,2483,30,2,1,3,66.7%,13m
31635,3,Wisi,2483,30,2,1,3,66.7%,15m
31635,3,Вечный,2483,30,2,2,4,50.0%,1h
31635,3,[ThDaLe]Dravos,2483,0,2,3,5,40.0%,1h
31635,1,BrusLee,2483,0,2,4,6,33.3%,9m
31635,3,SilkyJohnson,2483,60,2,5,7,28.6%,19m
31635,3,Mahinder,2483,0,1,1,2,50.0%,2m
31635,3,Dantes,2483,30,1,4,5,20.0%,19m
31635,3,[Tchang]Flouky,2483,0,0,1,1,0.0%,1h
31635,3,Lorris,2483,0,0,1,1,0.0%,1h
31635,2,[MHACKS]kenji,2483,0,0,5,5,0.0%,1h
31663,3,ottoman,2482,1611,193,193,386,50.0%,10m
31663,1,Trexbuca,2482,1431,169,168,337,50.1%,7m
31663,2,LIPKASS,2482,1310,128,118,246,52.0%,1h
31663,3,Tavronch,2482,1369,109,101,210,51.9%,9m
31663,3,Dejeezify,2482,1386,59,52,111,53.2%,25m
31663,3,Darth,2482,267,50,50,100,50.0%,58m
31663,1,SoHLo,2482,1272,50,51,101,49.5%,17m
31663,1,mno,2482,1302,49,56,105,46.7%,27m
31663,3,[Prsite]Matteus,2482,839,32,27,59,54.2%,24m
31663,3,Ahilles,2482,643,30,11,41,73.2%,1h
31663,2,Madsinner,2482,758,27,32,59,45.8%,1h
31663,2,Voffka,2482,586,23,22,45,51.1%,1h
31663,3,SomeOldDude,2482,459,18,16,34,52.9%,1h
31663,3,darkNUNO,2482,458,17,17,34,50.0%,15m
31663,2,maksibi,2482,200,11,13,24,45.8%,60m
31663,3,[230ММ]IronKerya,2482,170,7,5,12,58.3%,1h
31663,3,Fire,2482,142,5,6,11,45.5%,5m
31663,3,[2EZ4]DooMbringer,2482,170,5,8,13,38.5%,1h
31663,3,killer,2482,62,4,6,10,40.0%,25m
31663,2,bujaka,2482,122,4,11,15,26.7%,1h
31663,3,kanadi,2482,60,3,5,8,37.5%,6m
31663,3,[RavB]ZeratUl,2482,0,2,2,4,50.0%,59m
31663,1,kdkdk,2482,48,2,2,4,50.0%,21m
31663,2,Kampen,2482,30,2,4,6,33.3%,16m
31663,1,Alex,2482,116,2,6,8,25.0%,1h
31663,3,Katysak,2482,0,1,0,1,100.0%,27m
31663,3,[Zara]YouSoLame,2482,0,1,0,1,100.0%,11m
31663,3,yggoon,2482,0,1,2,3,33.3%,25m
31663,1,Lokir,2482,0,1,2,3,33.3%,9m
31663,1,[БУБУБ]jokolak,2482,97,1,7,8,12.5%,1h
31663,3,Kancler,2482,0,0,1,1,0.0%,4m
31663,3,pipito,2482,0,0,1,1,0.0%,23m
31663,3,[ProRax]RailGun,2482,0,0,1,1,0.0%,23m
31696,2,Tonyknight,2481,1397,177,174,351,50.4%,1h
31696,3,[DECIMA]Dimanp,2481,1571,136,127,263,51.7%,13m
31696,3,Zorg,2481,1456,110,106,216,50.9%,3m
31696,3,DarkMarine,2481,1569,78,66,144,54.2%,1h
31696,3,ПатриархКрлл,2481,1367,74,70,144,51.4%,9m
31696,2,Mitkoo,2481,707,55,41,96,57.3%,25m
31696,3,HUNTER,2481,918,34,38,72,47.2%,10m
31696,3,Jigslol,2481,790,32,27,59,54.2%,20m
31696,2,[SS2208]SergZerg,2481,706,27,37,64,42.2%,7m
31696,3,Andy,2481,494,16,32,48,33.3%,23m
31696,3,[iNCEPT]DougWells,2481,412,15,17,32,46.9%,9m
31696,2,superfil,2481,302,10,15,25,40.0%,1h
31696,3,JackiiKon,2481,243,9,9,18,50.0%,19m
31696,3,supercookie,2481,176,7,7,14,50.0%,1h
31696,3,Musus,2481,193,7,7,14,50.0%,14m
31696,2,GiaoGiao,2481,158,7,8,15,46.7%,17m
31696,3,[KAOTx]zergses,2481,168,6,9,15,40.0%,14m
31696,3,[БУБУБ]Глеб,2481,114,5,3,8,62.5%,20m
31696,3,MuadDib,2481,88,4,3,7,57.1%,1h
31696,3,ESV,2481,97,4,4,8,50.0%,21m
31696,2,Asdad,2481,96,3,13,16,18.8%,1h
31696,3,[улей55]растреляйте,2481,97,2,0,2,100.0%,25m
31696,1,Gerahrd,2481,96,2,2,4,50.0%,23m
31696,2,[D210]WotanFinrod,2481,0,2,4,6,33.3%,7m
31696,2,SoulGhost,2481,0,2,4,6,33.3%,11m
31696,2,Kietai,2481,0,2,5,7,28.6%,20m
31696,3,Alik,2481,62,2,6,8,25.0%,14m
31696,2,Suki,2481,80,2,6,8,25.0%,10m
31696,3,Шпинат,2481,0,1,2,3,33.3%,1h
31696,3,Tresseder,2481,30,1,5,6,16.7%,13m
31696,3,TitanJarvis,2481,0,0,1,1,0.0%,1h
31696,3,MementoMori,2481,0,0,2,2,0.0%,1h
31728,2,Maroch,2480,1456,85,80,165,51.5%,1h
31728,1,wexcom,2480,1275,77,78,155,49.7%,8m
31728,2,[I3W]DonVitto,2480,1493,67,67,134,50.0%,2m
31728,2,Wormie,2480,1129,44,46,90,48.9%,16m
31728,1,Максимус,2480,1044,44,49,93,47.3%,1h
31728,1,ItsBehindYou,2480,1250,44,54,98,44.9%,20m
31728,3,MuratT,2480,965,41,34,75,54.7%,1h
31728,2,Teleno,2480,673,28,25,53,52.8%,21m
31728,2,Dieval,2480,536,28,25,53,52.8%,18m
31728,3,MiniPeludin,2480,598,21,18,39,53.8%,1h
31728,2,ConstantSin,2480,537,19,23,42,45.2%,1h
31728,3,Abraxas,2480,317,18,20,38,47.4%,1h
31728,3,Chaqual,2480,470,17,19,36,47.2%,1h
31728,3,[TRVMP]dobispr,2480,340,12,7,19,63.2%,11m
31728,2,BlackGad,2480,362,12,19,31,38.7%,13m
31728,3,Ames,2480,254,10,11,21,47.6%,4m
31728,3,Performer,2480,226,9,7,16,56.2%,11m
31728,2,SunCanRock,2480,290,9,12,21,42.9%,16m
31728,3,Lokhir,2480,271,8,7,15,53.3%,1h
31728,2,[Freya]have,2480,236,8,10,18,44.4%,5m
31728,3,Eldores,2480,230,8,11,19,42.1%,4m
31728,3,MAKTRAXER,2480,86,7,2,9,77.8%,2m
31728,2,Spezza,2480,122,6,10,16,37.5%,27m
31728,2,[Arrows]MorpehMaksim,2480,152,5,13,18,27.8%,1h
31728,3,[RetroM]carmonetti,2480,120,4,8,12,33.3%,27m
31728,2,steregucshiy,2480,110,3,2,5,60.0%,1h
31728,3,unluckyguy,2480,120,3,5,8,37.5%,1h
31728,3,[тьма]multosss,2480,30,2,1,3,66.7%,21m
31728,3,adriano,2480,122,2,7,9,22.2%,1h
31728,1,snob,2480,0,1,0,1,100.0%,5m
31728,1,Armageddom,2480,48,1,2,3,33.3%,1h
31728,3,Richinathor,2480,0,1,4,5,20.0%,1h
31728,1,[KN0s]alegs,2480,0,0,1,1,0.0%,3m
31728,3,yacare,2480,0,0,1,1,0.0%,1h
31728,3,phoenix,2480,0,0,1,1,0.0%,24m
31728,3,[Nezuko]Gearoid,2480,0,0,1,1,0.0%,1h
31728,3,[BHN]Славик,2480,0,0,1,1,0.0%,1h
31728,3,[RuVoid]Arrow,2480,0,0,2,2,0.0%,1h
31728,3,fRANELI,2480,0,0,2,2,0.0%,19m
31728,2,ADSR,2480,0,0,4,4,0.0%,60m
31728,3,LisAndrew,2480,0,0,4,4,0.0%,23m
31769,3,DaniBrillant,2479,1577,122,100,222,55.0%,1h
31769,1,Bulat,2479,1602,116,116,232,50.0%,19m
31769,3,НУБ,2479,1470,95,68,163,58.3%,19m
31769,3,JonnyCoolGuy,2479,984,40,42,82,48.8%,1h
31769,3,[ПИВ0]Gale,2479,1024,38,37,75,50.7%,1h
31769,2,ChrysT,2479,648,33,37,70,47.1%,10m
31769,2,NaFianna,2479,523,32,30,62,51.6%,1h
31769,3,Alex,2479,506,21,16,37,56.8%,4m
31769,3,FreezeXJ,2479,500,19,17,36,52.8%,60m
31769,3,Magellan,2479,370,13,13,26,50.0%,14m
31769,2,CannonCoward,2479,232,9,10,19,47.4%,58m
31769,3,MargariN,2479,242,8,10,18,44.4%,1h
31769,3,Reverse,2479,108,5,8,13,38.5%,1h
31769,3,[pdrz]Massa,2479,119,3,0,3,100.0%,1h
31769,3,Magicl,2479,58,3,1,4,75.0%,18m
31769,3,Goblin,2479,86,3,3,6,50.0%,3m
31769,2,[ADPM]ScarletFox,2479,107,3,5,8,37.5%,1h
31769,2,Fleshmonster,2479,32,3,6,9,33.3%,1h
31769,3,blasé,2479,60,3,7,10,30.0%,59m
31769,3,[LOGS]rookie,2479,30,2,1,3,66.7%,6m
31769,1,BItReit,2479,0,2,3,5,40.0%,1h
31769,3,Baikal,2479,0,1,0,1,100.0%,58m
31769,3,CocoBobo,2479,30,1,1,2,50.0%,1h
31769,3,[Brink]RoyalPudding,2479,0,1,3,4,25.0%,1h
31769,1,Lyudmiliks,2479,0,1,4,5,20.0%,1h
31769,3,bdfg,2479,0,0,1,1,0.0%,60m
31769,3,insider,2479,0,0,2,2,0.0%,1h
31796,2,Vistor,2478,1576,554,556,1110,49.9%,1h
31796,1,BigSwaggyBoi,2478,1554,301,290,591,50.9%,9m
31796,2,Sobermen,2478,1519,112,111,223,50.2%,1h
31796,3,Moga,2478,1536,111,107,218,50.9%,25m
31796,2,alex,2478,549,97,81,178,54.5%,18m
31796,3,MaxiBraDa,2478,1464,63,55,118,53.4%,7m
31796,2,Diogenas,2478,1532,59,66,125,47.2%,19m
31796,3,Booger,2478,495,20,18,38,52.6%,23m
31796,2,Zörg,2478,548,20,25,45,44.4%,26m
31796,2,wrede,2478,486,19,18,37,51.4%,19m
31796,3,[STMS]Krosis,2478,473,18,12,30,60.0%,13m
31796,2,Iga,2478,154,17,16,33,51.5%,13m
31796,3,Legion,2478,394,17,18,35,48.6%,4m
31796,3,SrakaLove,2478,361,14,14,28,50.0%,23m
31796,1,Prometheus,2478,317,13,15,28,46.4%,27m
31796,3,Sven,2478,276,10,6,16,62.5%,1h
31796,3,Jokowi,2478,296,10,14,24,41.7%,19m
31796,1,JuliusCaesar,2478,189,7,10,17,41.2%,1h
31796,3,cptCaptain,2478,189,6,2,8,75.0%,1h
31796,2,[Lab14]Rhadamanthys,2478,78,5,6,11,45.5%,11m
31796,3,[MMR4K]CPUidleDK,2478,168,4,2,6,66.7%,15m
31796,2,FROXi,2478,80,4,8,12,33.3%,2m
31796,3,HerFriend,2478,141,3,1,4,75.0%,1h
31796,3,Vovarus,2478,30,2,5,7,28.6%,19m
31796,3,PtoW,2478,0,1,2,3,33.3%,1h
31796,3,HAL,2478,0,1,4,5,20.0%,5m
31796,3,SuperMichel,2478,0,0,1,1,0.0%,1h
31796,2,and,2478,0,0,5,5,0.0%,1h
31824,1,Souk,2477,1263,175,170,345,50.7%,1h
31824,2,David,2477,1091,91,96,187,48.7%,5m
31824,2,Alllllll,2477,221,69,70,139,49.6%,1h
31824,2,Dexter,2477,507,64,53,117,54.7%,1h
31824,2,Werock,2477,907,51,57,108,47.2%,1h
31824,3,caltrop,2477,905,40,30,70,57.1%,60m
31824,3,MrKaizi,2477,811,32,26,58,55.2%,25m
31824,1,palindrom,2477,556,17,30,47,36.2%,9m
31824,2,SulfuricAcid,2477,171,14,19,33,42.4%,8m
31824,2,[N1NJ4Z]bendito,2477,330,13,16,29,44.8%,5m
31824,3,[JotC]Calamitavia,2477,322,12,5,17,70.6%,1h
31824,3,Spambot,2477,234,8,10,18,44.4%,13m
31824,3,[cnit]NesCafe,2477,118,5,5,10,50.0%,1h
31824,2,[KerriS]VirusTotal,2477,162,4,4,8,50.0%,1h
31824,2,Persey,2477,30,4,4,8,50.0%,1h
31824,1,ELDELBAR,2477,140,4,5,9,44.4%,1h
31824,1,[GLbro]ReLoADeD,2477,88,2,1,3,66.7%,25m
31824,3,Katalizator,2477,123,2,2,4,50.0%,5m
31824,3,Lemyrka,2477,0,2,3,5,40.0%,28m
31824,3,Brausekopf,2477,60,2,6,8,25.0%,23m
31824,3,Nag,2477,0,1,1,2,50.0%,27m
31824,3,cdd,2477,0,1,3,4,25.0%,1h
31824,1,Viki,2477,0,1,4,5,20.0%,1h
31824,2,Grynt,2477,0,1,6,7,14.3%,1h
31824,3,VanKri,2477,34,1,9,10,10.0%,1h
31824,3,TomBigCat,2477,0,0,1,1,0.0%,1h
31824,3,poi,2477,0,0,1,1,0.0%,11m
31824,3,Trent,2477,0,0,2,2,0.0%,58m
31824,3,[STMS]Nayoko,2477,0,0,4,4,0.0%,11m
31853,1,CraftStar,2476,1421,1088,1114,2202,49.4%,1h
31853,2,yanayita,2476,1606,270,260,530,50.9%,8m
31853,2,[Ctlo]Sauti,2476,1542,185,169,354,52.3%,1h
31853,1,Ximik,2476,994,180,174,354,50.8%,27m
31853,2,nick,2476,1561,173,166,339,51.0%,7m
31853,3,BadDancer,2476,1357,63,57,120,52.5%,15m
31853,2,MusliM,2476,1212,54,53,107,50.5%,20m
31853,2,Bzzzik,2476,995,42,56,98,42.9%,1h
31853,2,Badack,2476,113,40,41,81,49.4%,13m
31853,3,Loota,2476,643,35,49,84,41.7%,26m
31853,3,Woo,2476,580,29,9,38,76.3%,15m
31853,2,[CS0]FatalBritchs,2476,560,29,25,54,53.7%,3m
31853,2,Legacy,2476,364,13,17,30,43.3%,1h
31853,3,Mamimo,2476,317,12,18,30,40.0%,7m
31853,2,Zarek,2476,239,9,10,19,47.4%,24m
31853,2,Nikolas,2476,227,8,11,19,42.1%,1h
31853,3,БешеныйГлист,2476,118,5,4,9,55.6%,13m
31853,3,Buba,2476,183,5,6,11,45.5%,13m
31853,3,Alex,2476,122,5,6,11,45.5%,1h
31853,3,[SWE8AT]JohnDöe,2476,92,5,11,16,31.2%,22m
31853,3,IIIIIIIIIIII,2476,86,4,2,6,66.7%,1h
31853,1,ArHam,2476,48,4,4,8,50.0%,6m
31853,1,Schulzï,2476,122,4,7,11,36.4%,8m
31853,3,Serafimzik,2476,60,3,3,6,50.0%,3m
31853,2,MindelVK,2476,128,3,4,7,42.9%,1h
31853,3,Kalimos,2476,58,2,3,5,40.0%,14m
31853,1,Kacper,2476,46,2,4,6,33.3%,18m
31853,2,Genji,2476,30,2,5,7,28.6%,1h
31853,3,[SworD3]ZergANgeL,2476,0,1,1,2,50.0%,1h
31853,3,PhantomSnake,2476,0,1,1,2,50.0%,1h
31853,3,Zizou,2476,97,1,2,3,33.3%,6m
31853,3,BassToad,2476,0,0,1,1,0.0%,8m
31853,3,DivatD,2476,0,0,1,1,0.0%,5m
31853,1,[SC22SC]ЗлыеНоски,2476,0,0,5,5,0.0%,27m
31887,2,[Izual]togy,2475,1510,449,457,906,49.6%,58m
31887,3,rik,2475,1229,296,284,580,51.0%,1h
31887,2,pinniwini,2475,1573,150,146,296,50.7%,20m
31887,2,[TSBS]progamer,2475,1595,64,62,126,50.8%,1h
31887,3,KingPuling,2475,1209,52,45,97,53.6%,3m
31887,1,[POLon]powro,2475,1075,38,45,83,45.8%,13m
31887,3,Flizzi,2475,739,31,32,63,49.2%,1h
31887,1,Trykester,2475,352,31,40,71,43.7%,24m
31887,3,pyjamashark,2475,788,30,28,58,51.7%,13m
31887,3,Леденец,2475,539,23,21,44,52.3%,24m
31887,3,Yoloska,2475,359,14,10,24,58.3%,1h
31887,2,Ironman,2475,232,10,10,20,50.0%,17m
31887,3,StevenSeagal,2475,234,8,5,13,61.5%,1h
31887,2,[2D2Д]Chan,2475,204,7,12,19,36.8%,27m
31887,3,PrinzBobaFat,2475,42,5,5,10,50.0%,1h
31887,3,Ego,2475,189,5,6,11,45.5%,22m
31887,3,[Çipet]MUSTY,2475,127,4,6,10,40.0%,21m
31887,2,HellTos,2475,170,4,8,12,33.3%,1h
31887,3,[tofury]wwow,2475,58,3,4,7,42.9%,11m
31887,2,[VZON]Frisk,2475,44,3,6,9,33.3%,1h
31887,3,SnowPatrol,2475,30,2,3,5,40.0%,3m
31887,2,Skuno,2475,0,2,4,6,33.3%,1h
31887,3,[Bask]BloodRaven,2475,0,1,0,1,100.0%,28m
31887,3,IOWA,2475,0,1,0,1,100.0%,1h
31887,3,markus,2475,0,0,1,1,0.0%,1h
31887,3,mingnjjue,2475,0,0,1,1,0.0%,5m
31887,3,Phone,2475,0,0,2,2,0.0%,15m
31914,1,Potato,2474,1411,234,227,461,50.8%,27m
31914,2,LtShniperson,2474,1385,71,58,129,55.0%,1h
31914,3,DarkHydra,2474,1259,69,60,129,53.5%,8m
31914,3,Wickers,2474,455,53,40,93,57.0%,1h
31914,3,Lubo,2474,1385,53,54,107,49.5%,1h
31914,1,CARTMAN,2474,450,27,33,60,45.0%,1h
31914,2,drykerbeng,2474,226,24,25,49,49.0%,1h
31914,3,shz,2474,397,19,23,42,45.2%,1h
31914,2,[Tobago]Suter,2474,520,18,26,44,40.9%,4m
31914,2,Chamberlin,2474,464,17,22,39,43.6%,1h
31914,2,[LMBD]Talha,2474,299,16,7,23,69.6%,1h
31914,3,SlotMachine,2474,291,10,9,19,52.6%,58m
31914,2,Ashenari,2474,258,9,11,20,45.0%,1h
31914,1,DrunkenFist,2474,270,8,9,17,47.1%,1h
31914,2,HarenderHorn,2474,272,8,12,20,40.0%,1h
31914,3,Vandet,2474,84,6,7,13,46.2%,1h
31914,2,Aza,2474,88,4,8,12,33.3%,15m
31914,3,[SGame]CyberBAN,2474,86,3,3,6,50.0%,1h
31914,3,Танк,2474,37,3,3,6,50.0%,1h
31914,2,FRIZua,2474,30,3,5,8,37.5%,5m
31914,1,[JaPP]EikFrost,2474,97,2,1,3,66.7%,1h
31914,2,Claona,2474,0,2,5,7,28.6%,1h
31914,1,Kuroneko,2474,48,2,5,7,28.6%,21m
31914,2,grooompy,2474,30,2,6,8,25.0%,1h
31914,1,SpaceDonkey,2474,0,1,0,1,100.0%,59m
31914,3,Maylow,2474,97,1,1,2,50.0%,11m
31914,3,[FAJAS]myks,2474,0,1,1,2,50.0%,18m
31914,3,MrAner,2474,30,1,3,4,25.0%,60m
31914,1,crazysheep,2474,0,1,4,5,20.0%,1h
31914,3,[FrSlip]Leopard,2474,0,0,1,1,0.0%,15m
31914,3,IoannSahin,2474,0,0,2,2,0.0%,60m
31914,3,[vlad79]errorsans,2474,0,0,2,2,0.0%,3m
31946,1,Fishermen,2473,1230,153,162,315,48.6%,1h
31946,3,IskroMan,2473,1259,120,107,227,52.9%,1h
31946,2,Rumidek,2473,1122,47,46,93,50.5%,1h
31946,3,Itachi,2473,1150,45,43,88,51.1%,1h
31946,2,bloodthor,2473,876,34,35,69,49.3%,1h
31946,2,Zinat,2473,566,22,24,46,47.8%,1h
31946,1,TheLegion,2473,426,18,19,37,48.6%,3m
31946,3,kwahaha,2473,354,15,21,36,41.7%,12m
31946,3,Schildkrtek,2473,392,14,11,25,56.0%,25m
31946,3,GoVbon,2473,383,14,18,32,43.8%,1h
31946,3,vlad,2473,303,11,15,26,42.3%,18m
31946,3,haidi,2473,307,10,7,17,58.8%,20m
31946,2,RMF,2473,249,10,9,19,52.6%,2m
31946,1,Loki,2473,293,9,14,23,39.1%,4m
31946,3,[lancon]Timbandit,2473,208,8,9,17,47.1%,20m
31946,3,tonestarcraf,2473,53,6,10,16,37.5%,24m
31946,2,Badboy,2473,60,4,13,17,23.5%,12m
31946,3,JhonGoodboy,2473,90,3,5,8,37.5%,1h
31946,1,DRONxBOT,2473,96,2,3,5,40.0%,1h
31946,2,baxtrrrr,2473,0,2,6,8,25.0%,1h
31946,1,Phebus,2473,87,2,12,14,14.3%,1h
31946,3,Bronzo,2473,0,1,2,3,33.3%,1h
31946,1,Next,2473,0,0,1,1,0.0%,1h
31946,1,Decain,2473,0,0,2,2,0.0%,1h
31946,1,[tofury]Ядренбатон,2473,0,0,2,2,0.0%,1h
31971,2,[ARGUAL]phantonpain,2472,1439,98,87,185,53.0%,18m
31971,3,Bugcrusher,2472,558,24,18,42,57.1%,13m
31971,3,yranium,2472,229,23,14,37,62.2%,3m
31971,3,ItsTyr,2472,322,14,12,26,53.8%,1h
31971,3,[SngR]gargamel,2472,385,14,15,29,48.3%,1h
31971,3,Cucumber,2472,276,10,12,22,45.5%,1h
31971,1,[mrcoh]Deeew,2472,321,10,15,25,40.0%,1h
31971,3,[wpwpwp]Const,2472,254,9,10,19,47.4%,27m
31971,3,[RBP3]Bidon,2472,114,5,7,12,41.7%,1h
31971,1,Lodka,2472,148,5,8,13,38.5%,22m
31971,3,denisik,2472,88,4,2,6,66.7%,27m
31971,1,nodelynk,2472,88,4,5,9,44.4%,1h
31971,3,deez,2472,116,4,6,10,40.0%,1h
31971,3,KaeL,2472,115,3,5,8,37.5%,1h
31971,1,Zhark,2472,48,2,0,2,100.0%,1h
31971,3,Geo,2472,30,2,2,4,50.0%,8m
31971,3,Lolekk,2472,95,2,4,6,33.3%,1h
31971,3,Keasium,2472,0,1,0,1,100.0%,6m
31971,3,[MH]gabiki,2472,0,1,0,1,100.0%,2m
31971,3,MisterKot,2472,96,1,1,2,50.0%,1h
31971,2,Glitch,2472,30,1,5,6,16.7%,1h
31971,3,Wynand,2472,0,0,1,1,0.0%,1h
31971,3,Sasay,2472,0,0,1,1,0.0%,1h
31971,3,farid,2472,0,0,1,1,0.0%,3m
31971,3,Mentos,2472,0,0,1,1,0.0%,1h
31971,3,Tomi,2472,0,0,2,2,0.0%,1h
31971,1,Martin,2472,0,0,2,2,0.0%,58m
31971,3,MasterRalll,2472,0,0,2,2,0.0%,28m
31971,2,HughDoongus,2472,0,0,7,7,0.0%,1h
32000,2,CaptnCratos,2471,1560,120,110,230,52.2%,4m
32000,2,DoOm,2471,1520,92,96,188,48.9%,1h
32000,3,danieledu,2471,1501,71,67,138,51.4%,1h
32000,2,BOSS,2471,1334,51,49,100,51.0%,4m
32000,2,Clouddigger,2471,1287,48,52,100,48.0%,19m
32000,2,Alta,2471,744,29,30,59,49.2%,60m
32000,3,[ZUBS]RAIDAGE,2471,691,28,23,51,54.9%,1h
32000,3,Makar,2471,614,23,23,46,50.0%,21m
32000,3,Wescraft,2471,469,18,20,38,47.4%,1h
32000,2,[AdRiX]DOBRYS,2471,433,17,19,36,47.2%,22m
32000,2,Suslik,2471,498,17,20,37,45.9%,60m
32000,3,Lenny,2471,366,13,9,22,59.1%,3m
32000,3,TheNeo,2471,0,4,3,7,57.1%,1h
32000,3,[nuks]SPARTANA,2471,60,3,1,4,75.0%,60m
32000,2,VonTorro,2471,146,3,6,9,33.3%,18m
32000,1,Kubaman,2471,82,2,17,19,10.5%,1h
32000,3,Lanff,2471,0,1,0,1,100.0%,1h
32000,3,[MakS7]MakS,2471,0,1,0,1,100.0%,1h
32000,3,xfort,2471,30,1,2,3,33.3%,21m
32000,3,TrakaisSuns,2471,36,1,5,6,16.7%,23m
32000,3,[MvN]MvNǂLucky,2471,0,0,1,1,0.0%,21m
32000,3,KrisKodi,2471,0,0,1,1,0.0%,1h
32000,3,[SODS]samikilator,2471,0,0,1,1,0.0%,11m
32000,3,[FISKOR]Loggebob,2471,0,0,1,1,0.0%,29m
32024,3,irasstar,2470,1566,134,117,251,53.4%,15m
32024,2,DESTRUCTOR,2470,1564,110,114,224,49.1%,8m
32024,3,Chroma,2470,836,48,47,95,50.5%,1h
32024,3,Azik,2470,1016,44,37,81,54.3%,1h
32024,3,[1830]SCV,2470,806,35,34,69,50.7%,5m
32024,3,Kadaf,2470,750,28,28,56,50.0%,21m
32024,1,KenGor,2470,288,19,28,47,40.4%,13m
32024,1,kalmal,2470,367,12,13,25,48.0%,13m
32024,3,strusel,2470,221,11,4,15,73.3%,11m
32024,1,BigAsHaze,2470,295,11,11,22,50.0%,1h
32024,2,[FaPe]faceless,2470,300,10,10,20,50.0%,1h
32024,3,[DLOK]Deadly,2470,156,5,3,8,62.5%,10m
32024,3,Patamon,2470,195,5,4,9,55.6%,60m
32024,3,minotoro,2470,169,5,6,11,45.5%,1h
32024,1,tohha,2470,0,4,1,5,80.0%,1h
32024,3,serega,2470,86,4,2,6,66.7%,5m
32024,3,Swobi,2470,88,4,3,7,57.1%,1h
32024,3,LONGSTRIKE,2470,148,4,5,9,44.4%,20m
32024,2,Dac,2470,120,4,7,11,36.4%,5m
32024,2,Mindflayer,2470,130,3,7,10,30.0%,1h
32024,3,sebzore,2470,30,2,0,2,100.0%,1h
32024,3,SaXaRok,2470,60,2,3,5,40.0%,1h
32024,1,elka,2470,0,2,3,5,40.0%,21m
32024,2,Tecron,2470,0,2,5,7,28.6%,1h
32024,3,[KREVAR]Fardoche,2470,60,2,7,9,22.2%,1h
32024,3,devil,2470,0,1,0,1,100.0%,7m
32024,1,zjecia,2470,0,1,0,1,100.0%,1h
32024,3,Leon,2470,0,1,1,2,50.0%,1h
32024,3,yoginski,2470,0,1,1,2,50.0%,10m
32024,2,Frizzy,2470,0,1,2,3,33.3%,5m
32024,3,VikingQuest,2470,0,0,1,1,0.0%,28m
32024,3,DarkProject,2470,0,0,1,1,0.0%,1h
32024,3,Armageddon,2470,0,0,1,1,0.0%,23m
32024,3,Valras,2470,0,0,1,1,0.0%,15m
32024,3,[HMarch]KNOBODYIKNOW,2470,0,0,1,1,0.0%,1h
32024,3,Качинский,2470,0,0,1,1,0.0%,15m
32060,3,Kylar,2469,1619,228,227,455,50.1%,3m
32060,1,heemskerka,2469,1490,113,121,234,48.3%,9m
32060,2,trillking,2469,634,48,35,83,57.8%,23m
32060,2,Padlock,2469,420,34,31,65,52.3%,1h
32060,1,[UK1]Wilko,2469,908,32,42,74,43.2%,16m
32060,3,rotn,2469,564,23,11,34,67.6%,1h
32060,3,Kakarot,2469,143,17,7,24,70.8%,1h
32060,3,[SeVenV]Tamamo,2469,468,17,11,28,60.7%,1h
32060,3,romanovich,2469,507,17,15,32,53.1%,11m
32060,3,Delriver,2469,401,15,9,24,62.5%,18m
32060,3,Badr,2469,336,12,13,25,48.0%,1h
32060,3,Chris,2469,312,12,15,27,44.4%,5m
32060,3,Fosh,2469,346,11,9,20,55.0%,26m
32060,3,Оляпыч,2469,290,10,8,18,55.6%,1h
32060,3,GuitarGuitar,2469,200,8,8,16,50.0%,1h
32060,3,angelofdeath,2469,205,7,12,19,36.8%,2m
32060,1,xtrabo,2469,118,6,10,16,37.5%,1h
32060,3,Dominion,2469,122,4,6,10,40.0%,14m
32060,3,[HRD]Lukotas,2469,0,2,3,5,40.0%,10m
32060,1,Илья,2469,97,2,4,6,33.3%,6m
32060,1,Shaheèn,2469,0,2,5,7,28.6%,1h
32060,3,Rutigan,2469,0,1,0,1,100.0%,1h
32060,3,[Tyзик]МилордМопс,2469,0,1,0,1,100.0%,11m
32060,3,TXK,2469,0,1,1,2,50.0%,1h
32060,1,PabloPepito,2469,0,0,1,1,0.0%,1h
32060,3,[WWOGU]RAVEN,2469,0,0,1,1,0.0%,1h
32060,3,MatrixRonny,2469,0,0,1,1,0.0%,1h
32087,2,samil,2468,1601,235,248,483,48.7%,60m
32087,3,[OmDi]Matulo,2468,1499,109,98,207,52.7%,11m
32087,2,Kaurus,2468,907,63,68,131,48.1%,1h
32087,1,TitanHero,2468,1137,59,70,129,45.7%,22m
32087,3,Darnayan,2468,802,30,25,55,54.5%,1h
32087,3,Noobling,2468,343,29,13,42,69.0%,10m
32087,3,[DomPre]Garagok,2468,431,29,30,59,49.2%,8m
32087,2,[JDis]Cosmo,2468,645,25,28,53,47.2%,1h
32087,2,Poutch,2468,257,24,22,46,52.2%,1h
32087,2,xuzero,2468,156,16,14,30,53.3%,6m
32087,3,PlagueDoctor,2468,331,12,11,23,52.2%,15m
32087,2,Fonyas,2468,290,11,17,28,39.3%,60m
32087,3,iNTER,2468,287,9,8,17,52.9%,26m
32087,2,Zigluz,2468,160,6,8,14,42.9%,27m
32087,3,Matys,2468,142,5,6,11,45.5%,29m
32087,2,jefemax,2468,60,4,4,8,50.0%,1h
32087,3,[HeiTim]Schokobubi,2468,118,2,2,4,50.0%,9m
32087,3,SadNesquiK,2468,60,2,3,5,40.0%,1h
32087,3,[ZLOBOZ]Impaler,2468,0,2,5,7,28.6%,19m
32087,3,NoBrain,2468,0,1,0,1,100.0%,27m
32087,1,Andrey,2468,0,1,0,1,100.0%,3m
32087,3,[Makkie]GekkeMarki,2468,0,1,0,1,100.0%,1h
32087,3,[CieNT]BotEllis,2468,0,1,1,2,50.0%,13m
32087,3,BeBeZiaNa,2468,0,1,1,2,50.0%,15m
32087,3,GibonesQ,2468,30,1,2,3,33.3%,1h
32087,3,Madara,2468,30,1,3,4,25.0%,1h
32087,3,Zukk,2468,30,1,4,5,20.0%,1h
32087,3,[PARADX]OkumaZ,2468,0,1,7,8,12.5%,1h
32087,3,Conu,2468,0,0,1,1,0.0%,21m
32087,3,SSNIZ,2468,0,0,1,1,0.0%,7m
32087,2,[SСPs]Slanderman,2468,0,0,1,1,0.0%,1h
32087,3,Marti,2468,0,0,2,2,0.0%,1h
32087,2,[eXsO]AssKicker,2468,0,0,7,7,0.0%,1h
32120,1,lordssv,2467,600,113,109,222,50.9%,5m
32120,2,[IWD]lIlIlIl,2467,1392,97,97,194,50.0%,1h
32120,2,Galaga,2467,349,64,62,126,50.8%,60m
32120,3,Fruitkiller,2467,1208,63,63,126,50.0%,27m
32120,3,Timo,2467,1176,48,39,87,55.2%,1h
32120,2,Badger,2467,1032,38,40,78,48.7%,23m
32120,3,Evergreen,2467,610,32,19,51,62.7%,26m
32120,3,misioc,2467,713,25,28,53,47.2%,3m
32120,1,kralle,2467,758,24,35,59,40.7%,1h
32120,3,[WE420]fedeskier,2467,414,20,23,43,46.5%,24m
32120,3,TheKing,2467,484,18,18,36,50.0%,1h
32120,2,virtu,2467,316,11,12,23,47.8%,1h
32120,2,Isi,2467,198,7,15,22,31.8%,60m
32120,3,Test,2467,121,4,5,9,44.4%,8m
32120,2,SunNinja,2467,120,4,10,14,28.6%,1h
32120,3,RoyMilli,2467,60,3,1,4,75.0%,1h
32120,3,Pineapple,2467,60,3,3,6,50.0%,1h
32120,2,[PiChEL]MaDeRo,2467,149,3,5,8,37.5%,1h
32120,1,Artur,2467,78,3,7,10,30.0%,1h
32120,3,Jaygoun,2467,60,2,2,4,50.0%,1h
32120,3,Rafferek,2467,30,2,2,4,50.0%,11m
32120,3,[MeXI]LIMB,2467,32,2,3,5,40.0%,1h
32120,2,Laternenmann,2467,0,2,4,6,33.3%,1h
32120,1,Butkus,2467,0,2,6,8,25.0%,28m
32120,3,[CFrag]ExTreem,2467,0,1,2,3,33.3%,58m
32120,2,Noobik,2467,0,1,7,8,12.5%,1h
32120,1,[INFiRe]Troi,2467,107,1,12,13,7.7%,13m
32120,3,GastorTroy,2467,0,0,1,1,0.0%,28m
32120,3,Equalizer,2467,0,0,1,1,0.0%,1h
32120,3,marozenoe,2467,0,0,1,1,0.0%,1h
32120,3,Microwave,2467,0,0,1,1,0.0%,5m
32120,1,wolfi,2467,0,0,1,1,0.0%,11m
32120,3,Pastrav,2467,0,0,2,2,0.0%,20m
32120,3,[UAŦeam]LingMisha,2467,0,0,2,2,0.0%,1h
32120,3,LeDarkin,2467,0,0,3,3,0.0%,13m
32120,1,tomfoolery,2467,0,0,4,4,0.0%,1h
32156,2,Sheepling,2466,1623,300,296,596,50.3%,23m
32156,3,THEBEST,2466,344,59,42,101,58.4%,13m
32156,2,Shang,2466,942,41,44,85,48.2%,1h
32156,3,Салоед,2466,749,39,28,67,58.2%,1h
32156,1,senya,2466,1020,34,47,81,42.0%,26m
32156,3,[RomanV]Roman,2466,509,18,24,42,42.9%,58m
32156,3,hobibit,2466,394,17,6,23,73.9%,21m
32156,3,Grimfiend,2466,327,12,7,19,63.2%,4m
32156,1,OBWV,2466,318,12,14,26,46.2%,25m
32156,2,QuirkyToss,2466,269,9,9,18,50.0%,1h
32156,3,[RBP3]KOVALSKI,2466,216,8,2,10,80.0%,1h
32156,2,slavqa,2466,173,7,8,15,46.7%,15m
32156,3,Radjamaki,2466,177,6,8,14,42.9%,7m
32156,2,HawK,2466,170,5,8,13,38.5%,1h
32156,2,lllllllll,2466,176,5,14,19,26.3%,2m
32156,3,MOH,2466,88,4,3,7,57.1%,29m
32156,3,AnZilla,2466,120,4,6,10,40.0%,1h
32156,3,Tomus,2466,145,4,7,11,36.4%,1h
32156,2,Foks,2466,90,4,8,12,33.3%,4m
32156,3,umaler,2466,60,3,2,5,60.0%,29m
32156,3,Draz,2466,141,3,2,5,60.0%,1h
32156,3,Väinämöinen,2466,127,3,5,8,37.5%,1h
32156,2,rick,2466,30,3,6,9,33.3%,23m
32156,1,LUREKER,2466,122,3,6,9,33.3%,1h
32156,2,[BenBil]benoo,2466,0,2,3,5,40.0%,27m
32156,3,[GSSCRY]Zorg,2466,0,1,0,1,100.0%,7m
32156,3,GoodMasterMG,2466,0,1,0,1,100.0%,1h
32156,2,Fantomas,2466,88,1,5,6,16.7%,1h
32156,3,Tassadare,2466,0,0,1,1,0.0%,1h
32156,3,Azirov,2466,0,0,1,1,0.0%,1h
32156,3,[NOOBS1]Pagafantes,2466,0,0,1,1,0.0%,1h
32156,3,Pierre,2466,0,0,1,1,0.0%,1h
32156,3,Noddy,2466,0,0,1,1,0.0%,1h
32156,3,Nub,2466,0,0,1,1,0.0%,5m
32156,3,Greendonkey,2466,0,0,3,3,0.0%,5m
32191,3,nomorestress,2465,1531,228,214,442,51.6%,4m
32191,2,xxzxcuzxMe,2465,1459,221,220,441,50.1%,18m
32191,2,skripakk,2465,921,106,88,194,54.6%,1h
32191,1,starlion,2465,1563,104,106,210,49.5%,1h
32191,3,Mougdefre,2465,1403,96,89,185,51.9%,1h
32191,3,chris,2465,1470,91,83,174,52.3%,14m
32191,2,Cohen,2465,1573,90,90,180,50.0%,22m
32191,3,Sampam,2465,887,56,41,97,57.7%,20m
32191,2,Aston,2465,1231,51,51,102,50.0%,1h
32191,2,DrDapson,2465,942,43,41,84,51.2%,1h
32191,3,Mrack,2465,644,23,23,46,50.0%,1h
32191,3,SENTINEL,2465,452,18,16,34,52.9%,6m
32191,3,Kaiser,2465,400,17,8,25,68.0%,8m
32191,3,Kiki,2465,410,17,12,29,58.6%,15m
32191,2,Wyrwiflak,2465,397,17,20,37,45.9%,21m
32191,3,fragnatik,2465,446,16,20,36,44.4%,10m
32191,1,Endurance,2465,249,16,26,42,38.1%,8m
32191,3,Denico,2465,436,15,14,29,51.7%,1h
32191,3,Etermal,2465,340,13,13,26,50.0%,1h
32191,3,TaiTa,2465,324,12,14,26,46.2%,7m
32191,3,virtuoso,2465,329,11,8,19,57.9%,6m
32191,1,sherzod,2465,246,9,13,22,40.9%,25m
32191,3,veleye,2465,206,7,7,14,50.0%,7m
32191,3,Hatty,2465,210,6,2,8,75.0%,14m
32191,3,Gouda,2465,169,5,1,6,83.3%,1h
32191,1,DaBaua,2465,193,5,4,9,55.6%,1h
32191,3,xGooF,2465,86,3,4,7,42.9%,1h
32191,1,pizza,2465,48,3,5,8,37.5%,9m
32191,2,[Lo3]Pornflakes,2465,114,2,2,4,50.0%,1h
32191,3,Timolientje,2465,30,2,2,4,50.0%,1h
32191,3,[Oarsch]UbootUwe,2465,97,2,4,6,33.3%,26m
32191,3,dronsis,2465,38,2,5,7,28.6%,3m
32191,3,Olvigera,2465,0,1,0,1,100.0%,24m
32191,3,CrookedoorZ,2465,0,0,1,1,0.0%,1h
32191,3,Blad,2465,0,0,1,1,0.0%,1h
32191,3,ZoMBIe,2465,0,0,1,1,0.0%,16m
32191,2,MOLURUS,2465,0,0,10,10,0.0%,1h
32228,1,Keth,2464,1025,173,180,353,49.0%,1h
32228,3,Dyps,2464,1434,131,108,239,54.8%,1h
32228,1,Vice,2464,1463,66,69,135,48.9%,9m
32228,2,Admrl,2464,1123,64,37,101,63.4%,1h
32228,2,Xzaivan,2464,591,48,45,93,51.6%,1h
32228,3,VollkornNoob,2464,975,41,37,78,52.6%,1h
32228,2,Ktaron,2464,340,35,27,62,56.5%,1h
32228,2,bagdanish,2464,286,28,25,53,52.8%,1h
32228,2,Scruff,2464,567,23,26,49,46.9%,9m
32228,2,Gluhar,2464,580,22,22,44,50.0%,1h
32228,3,Chafuk,2464,262,19,13,32,59.4%,60m
32228,3,Zaurito,2464,475,18,16,34,52.9%,58m
32228,3,CorolJab,2464,311,13,6,19,68.4%,5m
32228,3,[NWGD]КотБаюн,2464,278,10,4,14,71.4%,28m
32228,3,Каратель,2464,278,10,12,22,45.5%,4m
32228,2,Skapidea,2464,357,10,16,26,38.5%,1h
32228,3,[Börks]Tim,2464,246,9,10,19,47.4%,1h
32228,3,Keish,2464,219,8,13,21,38.1%,1h
32228,3,[ISRI]zaEBENIGRAD,2464,168,6,6,12,50.0%,26m
32228,3,[NaShou]Mayday,2464,214,6,7,13,46.2%,5m
32228,3,ChillPanda,2464,137,5,3,8,62.5%,11m
32228,3,Toalett,2464,185,5,4,9,55.6%,1h
32228,2,SvanriakDGT,2464,143,5,8,13,38.5%,1h
32228,3,tyz,2464,142,3,2,5,60.0%,1h
32228,3,nonomad,2464,60,3,4,7,42.9%,3m
32228,3,CloneY,2464,97,2,1,3,66.7%,59m
32228,1,DArc,2464,0,2,3,5,40.0%,1h
32228,1,FiftyFiveMid,2464,48,2,3,5,40.0%,1h
32228,1,Markusha,2464,0,2,3,5,40.0%,28m
32228,3,[IBE]pHILBABA,2464,0,1,0,1,100.0%,1h
32228,3,wizardry,2464,0,1,1,2,50.0%,1h
32228,3,[VEFY]gorkius,2464,97,1,1,2,50.0%,1h
32228,3,OZZI,2464,0,1,1,2,50.0%,7m
32228,3,Wroblik,2464,0,1,2,3,33.3%,4m
32228,3,[Draft]aZZtec,2464,0,0,1,1,0.0%,60m
32228,1,FireSkull,2464,0,0,1,1,0.0%,11m
32228,2,Otuz,2464,0,0,2,2,0.0%,1h
32228,1,[RoleP]Sheigar,2464,0,0,4,4,0.0%,1h
32228,1,Strong,2464,0,0,11,11,0.0%,1h
32267,2,danif,2463,1446,109,98,207,52.7%,28m
32267,3,AnK,2463,1479,100,86,186,53.8%,29m
32267,2,Strawng,2463,1406,53,53,106,50.0%,23m
32267,2,Tomahawk,2463,1137,43,47,90,47.8%,60m
32267,3,Agenttroll,2463,736,29,23,52,55.8%,60m
32267,3,Zimmek,2463,756,28,30,58,48.3%,1h
32267,2,Serg,2463,730,28,33,61,45.9%,4m
32267,3,[HyCl]polyglot,2463,380,27,28,55,49.1%,1h
32267,2,frayas,2463,710,26,31,57,45.6%,1h
32267,2,[Heroes]Minas,2463,474,17,20,37,45.9%,1h
32267,3,IIIIIIIIIIII,2463,392,14,8,22,63.6%,9m
32267,3,Carnage,2463,311,13,14,27,48.1%,1h
32267,3,TripleO,2463,277,11,5,16,68.8%,1h
32267,1,aduniis,2463,392,11,20,31,35.5%,8m
32267,3,danjah,2463,271,9,6,15,60.0%,9m
32267,3,Maximus,2463,208,8,2,10,80.0%,1h
32267,1,loganjoe,2463,125,5,5,10,50.0%,1h
32267,3,connor,2463,133,4,1,5,80.0%,15m
32267,3,Ternehall,2463,162,4,1,5,80.0%,11m
32267,3,KingWish,2463,169,4,2,6,66.7%,1h
32267,3,Beigecarpet,2463,78,4,5,9,44.4%,1h
32267,2,AmOrFeU,2463,114,4,9,13,30.8%,1h
32267,1,Lidke,2463,145,3,4,7,42.9%,1h
32267,2,Spikkel,2463,120,2,3,5,40.0%,1h
32267,1,alexhu,2463,97,2,4,6,33.3%,5m
32267,3,Бульба,2463,58,2,4,6,33.3%,1h
32267,1,LineS,2463,48,2,5,7,28.6%,1h
32267,3,Gabrielbuth,2463,0,2,5,7,28.6%,1h
32267,3,Pablo,2463,0,2,5,7,28.6%,1h
32267,3,Kain,2463,121,2,6,8,25.0%,1h
32267,3,[литрпг]Ансирал,2463,0,1,0,1,100.0%,1h
32267,3,CybergASP,2463,0,1,1,2,50.0%,1h
32267,3,INSYGG,2463,30,1,1,2,50.0%,3m
32267,2,[Долг]фанатфеса,2463,0,1,1,2,50.0%,27m
32267,3,[Medik]Cyp,2463,30,1,3,4,25.0%,4m
32267,3,Saty,2463,0,1,4,5,20.0%,5m
32267,1,DzikiCox,2463,0,0,1,1,0.0%,1h
32267,3,mortadelayor,2463,0,0,1,1,0.0%,27m
32267,2,кот,2463,0,0,4,4,0.0%,1h
32306,2,Brupomme,2462,1220,128,123,251,51.0%,1h
32306,3,qwerty,2462,1600,120,106,226,53.1%,1h
32306,2,Tarjan,2462,1512,96,97,193,49.7%,27m
32306,3,elcrapul,2462,1632,89,82,171,52.0%,59m
32306,2,ThePriest,2462,1474,68,68,136,50.0%,1h
32306,2,LifeTryer,2462,928,37,41,78,47.4%,11m
32306,3,[URANGG]Kunde,2462,377,15,17,32,46.9%,1h
32306,1,Evergreen,2462,406,15,19,34,44.1%,1h
32306,2,Quartermastr,2462,434,15,23,38,39.5%,1h
32306,3,BlumeCorp,2462,386,14,17,31,45.2%,1h
32306,3,Maximus,2462,313,11,7,18,61.1%,23m
32306,3,Danilaa,2462,341,11,12,23,47.8%,15m
32306,3,святославови,2462,267,9,7,16,56.2%,18m
32306,2,destroyer,2462,220,9,9,18,50.0%,29m
32306,3,[ČSSR]Invizible,2462,182,7,9,16,43.8%,29m
32306,2,BUGOR,2462,172,6,9,15,40.0%,1h
32306,3,generalJK,2462,144,4,1,5,80.0%,1h
32306,3,UnderNight,2462,88,4,3,7,57.1%,1h
32306,3,manokanaka,2462,145,4,7,11,36.4%,22m
32306,3,Patsee,2462,152,4,9,13,30.8%,29m
32306,3,Acestriker,2462,117,3,0,3,100.0%,1h
32306,3,AzeR,2462,60,3,2,5,60.0%,1h
32306,2,Salader,2462,109,3,2,5,60.0%,4m
32306,1,Evgenii,2462,0,3,2,5,60.0%,1h
32306,3,DarthRobin,2462,36,3,5,8,37.5%,22m
32306,3,robs,2462,121,2,2,4,50.0%,1h
32306,3,fdas,2462,58,2,3,5,40.0%,1h
32306,3,PLM,2462,0,1,0,1,100.0%,1h
32306,3,[GERGG]koonst,2462,0,1,1,2,50.0%,59m
32306,3,Fumi,2462,30,1,2,3,33.3%,1h
32306,3,KdgForgiven,2462,0,1,3,4,25.0%,14m
32306,3,[IMPASS]Naraas,2462,30,1,4,5,20.0%,1h
32306,3,Pumuckl,2462,30,1,5,6,16.7%,29m
32306,3,IvSpiryn,2462,0,0,1,1,0.0%,28m
32306,1,[LFR]ataifa,2462,0,0,1,1,0.0%,1h
32306,2,Dmitry,2462,0,0,1,1,0.0%,1h
32306,3,Romantiks,2462,0,0,1,1,0.0%,59m
32306,3,JimmyNeutron,2462,0,0,1,1,0.0%,1h
32306,3,bakteria,2462,0,0,1,1,0.0%,13m
32306,1,getaway,2462,0,0,1,1,0.0%,1h
32306,1,Newpeople,2462,0,0,5,5,0.0%,1h
32347,2,Empire,2461,1562,263,248,511,51.5%,29m
32347,1,lko,2461,1678,158,159,317,49.8%,26m
32347,3,[SC2SA]cRaZyEyEs,2461,1280,144,139,283,50.9%,4m
32347,1,Kostey,2461,1582,113,113,226,50.0%,1h
32347,3,[BFME2]Bones,2461,1640,77,80,157,49.0%,27m
32347,1,PainKiller,2461,1200,74,81,155,47.7%,1h
32347,3,Zhabi,2461,696,69,41,110,62.7%,21m
32347,2,shuman,2461,912,67,70,137,48.9%,8m
32347,2,CestLaVie,2461,632,58,60,118,49.2%,60m
32347,2,Macno,2461,1166,48,41,89,53.9%,23m
32347,3,[SchamR]daGriech,2461,849,36,25,61,59.0%,1h
32347,2,[STDES]Krucjata,2461,700,28,29,57,49.1%,1h
32347,1,CrAsHbOy,2461,608,20,31,51,39.2%,24m
32347,2,Khaleesi,2461,592,19,23,42,45.2%,18m
32347,3,DeepSleep,2461,337,14,13,27,51.9%,14m
32347,3,kwekcreeper,2461,242,11,13,24,45.8%,3m
32347,3,Kuroishikei,2461,258,11,14,25,44.0%,24m
32347,3,TupoeBidlo,2461,287,9,6,15,60.0%,59m
32347,3,[2iq]THETROOPER,2461,260,9,11,20,45.0%,11m
32347,3,RandomPlayer,2461,266,8,8,16,50.0%,27m
32347,1,Chainsoflawl,2461,188,8,10,18,44.4%,25m
32347,2,Cillij,2461,198,7,11,18,38.9%,26m
32347,3,Marvell,2461,171,6,6,12,50.0%,6m
32347,3,SAESAB,2461,86,4,3,7,57.1%,1h
32347,3,Dokles,2461,86,3,4,7,42.9%,1h
32347,3,[MWorld]poligirinos,2461,121,3,4,7,42.9%,1h
32347,3,Dorimugosuto,2461,118,2,1,3,66.7%,20m
32347,2,[xĐяeaм]Faker,2461,42,2,2,4,50.0%,8m
32347,3,ToxKayzer,2461,0,2,4,6,33.3%,1h
32347,2,Mioel,2461,138,2,5,7,28.6%,13m
32347,3,WeeWeeRNA,2461,124,2,7,9,22.2%,3m
32347,1,Cristal,2461,0,1,0,1,100.0%,1h
32347,3,Onyx,2461,0,1,1,2,50.0%,1h
32347,1,FairHaven,2461,0,1,1,2,50.0%,1h
32347,1,KatopaktA,2461,0,1,4,5,20.0%,5m
32347,3,Knes,2461,0,1,4,5,20.0%,1h
32347,3,AkanThor,2461,30,1,5,6,16.7%,1h
32347,2,[ULTX]alshaytan,2461,30,1,7,8,12.5%,1h
32347,3,Gio,2461,0,0,1,1,0.0%,20m
32347,3,Diskap,2461,0,0,1,1,0.0%,1h
32387,3,BogdanSimion,2460,1493,78,64,142,54.9%,1h
32387,3,KRybar,2460,743,76,68,144,52.8%,24m
32387,1,izmaylav,2460,1243,52,59,111,46.8%,24m
32387,3,ETL,2460,290,45,21,66,68.2%,1h
32387,2,Mefisto,2460,1218,43,50,93,46.2%,1h
32387,1,Kraken,2460,1044,39,46,85,45.9%,1h
32387,2,Tamnor,2460,784,32,28,60,53.3%,7m
32387,2,ebban,2460,816,29,34,63,46.0%,1h
32387,1,Spaøwn,2460,642,28,38,66,42.4%,13m
32387,3,GigabyteHU,2460,388,26,25,51,51.0%,10m
32387,3,Raven,2460,690,26,25,51,51.0%,1h
32387,2,RastaRockett,2460,752,25,36,61,41.0%,1h
32387,2,Mobi,2460,578,22,23,45,48.9%,1h
32387,3,Ultrawork,2460,370,20,20,40,50.0%,3m
32387,2,Dunpeal,2460,532,19,20,39,48.7%,1h
32387,1,Legion,2460,292,19,24,43,44.2%,1h
32387,3,RoyBamboo,2460,378,15,10,25,60.0%,1h
32387,3,ScanC,2460,393,15,18,33,45.5%,4m
32387,3,[PiGPan]JackTheFunk,2460,379,13,14,27,48.1%,14m
32387,3,Soareboi,2460,294,11,6,17,64.7%,29m
32387,3,acekris,2460,251,11,8,19,57.9%,1h
32387,3,AGrumpyPig,2460,305,11,8,19,57.9%,9m
32387,2,shpet,2460,291,11,14,25,44.0%,5m
32387,3,Mahony,2460,338,11,16,27,40.7%,58m
32387,3,camper,2460,294,10,4,14,71.4%,1h
32387,3,krypton,2460,291,9,6,15,60.0%,25m
32387,2,[GGmc2]ChristFist,2460,221,8,8,16,50.0%,1h
32387,3,Amusonsnous,2460,140,6,8,14,42.9%,25m
32387,2,[RofIer]Obsidien,2460,60,5,7,12,41.7%,1h
32387,3,[krdo]Mertojack,2460,138,3,2,5,60.0%,18m
32387,1,Wisdow,2460,97,3,3,6,50.0%,28m
32387,1,terim,2460,145,3,5,8,37.5%,26m
32387,2,ReVan,2460,60,3,9,12,25.0%,18m
32387,2,MilkaOnFire,2460,94,3,10,13,23.1%,1h
32387,3,[IBSC]oTTcelvin,2460,102,2,2,4,50.0%,24m
32387,3,Ziga,2460,90,2,4,6,33.3%,15m
32387,3,Lac,2460,0,2,5,7,28.6%,1h
32387,3,Golgren,2460,0,1,1,2,50.0%,1h
32387,1,BlackVision,2460,0,1,4,5,20.0%,1h
32387,3,Violeta,2460,30,1,6,7,14.3%,58m
32387,3,gandzafamer,2460,0,0,3,3,0.0%,5m
32428,3,Corize,2459,464,218,213,431,50.6%,22m
32428,3,frq,2459,407,97,83,180,53.9%,26m
32428,3,DeathTheKid,2459,1284,90,78,168,53.6%,1h
32428,2,RIDER,2459,1536,90,91,181,49.7%,6m
32428,1,Reverend,2459,1263,61,71,132,46.2%,1h
32428,3,miles,2459,1266,58,42,100,58.0%,1h
32428,2,PickleJuice,2459,1287,58,53,111,52.3%,1h
32428,2,Fulliron,2459,509,39,40,79,49.4%,19m
32428,1,alex,2459,985,39,46,85,45.9%,28m
32428,2,Orcusdominus,2459,947,36,45,81,44.4%,1h
32428,1,WhoCares,2459,462,35,43,78,44.9%,17m
32428,3,KillerDonut,2459,902,33,34,67,49.3%,60m
32428,3,wonderking,2459,497,23,9,32,71.9%,1h
32428,3,BloodRaven,2459,412,17,8,25,68.0%,28m
32428,3,seven,2459,344,12,10,22,54.5%,15m
32428,3,FalkE,2459,281,10,11,21,47.6%,59m
32428,3,бма,2459,263,8,7,15,53.3%,59m
32428,3,Travis,2459,172,6,6,12,50.0%,1h
32428,3,[S3X3]Taz,2459,111,5,4,9,55.6%,1h
32428,2,Antoniadis,2459,131,5,8,13,38.5%,58m
32428,2,vladd,2459,178,5,9,14,35.7%,10m
32428,1,[Bulke]Cerb,2459,96,4,6,10,40.0%,1h
32428,3,gronichon,2459,114,4,6,10,40.0%,60m
32428,1,AlexEgiI,2459,0,3,0,3,100.0%,9m
32428,3,Daniel,2459,121,3,1,4,75.0%,1h
32428,3,APM,2459,140,3,1,4,75.0%,7m
32428,2,Damianex,2459,108,3,6,9,33.3%,27m
32428,3,[KolKo]Ravenghast,2459,117,2,1,3,66.7%,1h
32428,3,bigbang,2459,58,2,2,4,50.0%,28m
32428,3,[mfixed]Konrados,2459,30,2,4,6,33.3%,8m
32428,3,IILLILIIL,2459,0,2,5,7,28.6%,19m
32428,2,SKILLENN,2459,0,1,0,1,100.0%,10m
32428,2,ttaaddeekk,2459,0,1,0,1,100.0%,1h
32428,3,AlterSamurai,2459,0,1,4,5,20.0%,60m
32428,3,FALCO,2459,0,0,1,1,0.0%,1h
32428,3,keker,2459,0,0,1,1,0.0%,19m
32428,3,[3Mz]Strog,2459,0,0,2,2,0.0%,20m
32428,3,Pojebaniec,2459,0,0,2,2,0.0%,60m
32428,3,RedJohn,2459,0,0,3,3,0.0%,1h
32467,3,DDGms,2458,1429,265,243,508,52.2%,10m
32467,1,Terranvtc,2458,1579,122,135,257,47.5%,1h
32467,1,RsK,2458,1490,80,82,162,49.4%,24m
32467,3,catfalcon,2458,1530,68,53,121,56.2%,29m
32467,3,[RioF]oettn,2458,1488,63,65,128,49.2%,1h
32467,1,[OK238]BurnHeart,2458,1234,55,53,108,50.9%,1h
32467,2,Uich,2458,1277,50,50,100,50.0%,18m
32467,3,TuiMau,2458,444,20,21,41,48.8%,16m
32467,2,Aladar,2458,470,17,21,38,44.7%,1h
32467,3,AlfaSammeC,2458,330,16,9,25,64.0%,28m
32467,3,babanius,2458,372,13,17,30,43.3%,3m
32467,3,[Именно]Liss,2458,297,11,5,16,68.8%,3m
32467,2,mdjelf,2458,310,10,20,30,33.3%,18m
32467,3,Zilmer,2458,286,9,6,15,60.0%,1h
32467,3,sdOrange,2458,238,8,3,11,72.7%,6m
32467,3,[TRNSP]Velkata,2458,148,8,7,15,53.3%,1h
32467,1,herbstkind,2458,290,8,23,31,25.8%,5m
32467,3,МАСТЕР,2458,157,7,9,16,43.8%,19m
32467,3,[THANOS]Euphrate,2458,162,4,2,6,66.7%,1h
32467,3,Gurke,2458,169,4,5,9,44.4%,1h
32467,3,Ady,2458,170,4,7,11,36.4%,3m
32467,3,AscSephi,2458,0,3,2,5,60.0%,1h
32467,3,Deus,2458,90,3,5,8,37.5%,14m
32467,1,ANDOS,2458,88,3,5,8,37.5%,9m
32467,3,XyLiGan,2458,91,2,0,2,100.0%,29m
32467,3,NemesisXIII,2458,30,2,1,3,66.7%,29m
32467,3,[Moobs]Rimsplitter,2458,30,2,2,4,50.0%,1h
32467,3,NOX,2458,30,2,2,4,50.0%,8m
32467,3,LeoZealot,2458,58,2,4,6,33.3%,5m
32467,2,Snusmumrik,2458,62,2,9,11,18.2%,27m
32467,2,Sokolof,2458,62,2,11,13,15.4%,3m
32467,3,DaPenetrator,2458,0,1,1,2,50.0%,1h
32467,3,Бернак,2458,30,1,2,3,33.3%,1h
32467,3,lanvo,2458,0,0,1,1,0.0%,19m
32467,3,[TeamKy]KryroK,2458,0,0,1,1,0.0%,8m
32467,3,Tracoun,2458,0,0,4,4,0.0%,7m
32503,3,hobbyquaker,2457,1533,83,73,156,53.2%,18m
32503,2,[НОД17]AnonimZero,2457,1370,56,66,122,45.9%,58m
32503,1,jodbalance,2457,1294,51,50,101,50.5%,7m
32503,3,Cwazon,2457,1123,45,40,85,52.9%,1h
32503,3,ZealOk,2457,176,44,32,76,57.9%,1h
32503,3,ciprionut,2457,1143,42,41,83,50.6%,60m
32503,3,JOHNWICK,2457,860,37,39,76,48.7%,11m
32503,3,Azazel,2457,194,8,7,15,53.3%,1h
32503,2,Anom,2457,212,8,11,19,42.1%,1h
32503,2,centauro,2457,212,8,13,21,38.1%,7m
32503,3,cacapornXD,2457,224,7,2,9,77.8%,24m
32503,3,CostanzA,2457,189,6,9,15,40.0%,1h
32503,3,[SƬǂ]PogoTheClown,2457,170,5,3,8,62.5%,1h
32503,3,Rappty,2457,199,5,9,14,35.7%,13m
32503,3,Виталий,2457,80,4,8,12,33.3%,1h
32503,3,[VBR]PrinceDeath,2457,0,3,2,5,60.0%,1h
32503,3,Aeca,2457,30,3,4,7,42.9%,4m
32503,3,rovermarkiz,2457,30,3,6,9,33.3%,1h
32503,2,BruceWillis,2457,94,3,7,10,30.0%,1h
32503,2,benet,2457,30,2,4,6,33.3%,1h
32503,3,Ekonomist,2457,0,2,4,6,33.3%,1h
32503,3,KSX,2457,0,2,5,7,28.6%,1h
32503,3,[NLTN]onetouchligh,2457,97,1,1,2,50.0%,59m
32503,3,baralgin,2457,0,0,1,1,0.0%,1h
32503,2,[Copl]skylineg,2457,0,0,4,4,0.0%,1h
32528,3,RoYkin,2456,1584,177,171,348,50.9%,11m
32528,2,Razor,2456,1578,176,197,373,47.2%,10m
32528,3,MoFoBAMF,2456,1206,75,64,139,54.0%,1h
32528,3,gremelin,2456,1543,73,73,146,50.0%,20m
32528,1,DrunkenTiGer,2456,1433,58,68,126,46.0%,1h
32528,3,roastbeef,2456,924,46,25,71,64.8%,1h
32528,3,Catte,2456,827,33,27,60,55.0%,1h
32528,2,Nevermore,2456,700,28,44,72,38.9%,18m
32528,1,libre,2456,420,18,27,45,40.0%,1h
32528,3,Karnaval,2456,477,17,16,33,51.5%,1h
32528,3,Artum,2456,225,7,7,14,50.0%,59m
32528,3,Prist,2456,148,5,7,12,41.7%,1h
32528,3,[TFABII]MeisterRevan,2456,123,4,6,10,40.0%,1h
32528,3,Kaido,2456,145,4,7,11,36.4%,11m
32528,2,Slavovich,2456,88,4,8,12,33.3%,4m
32528,3,WildKraut,2456,144,3,2,5,60.0%,24m
32528,3,DarkWarrior,2456,0,3,2,5,60.0%,1h
32528,3,[mfixed]Odlot,2456,60,3,4,7,42.9%,9m
32528,3,Oxosuxu,2456,0,2,3,5,40.0%,15m
32528,3,eazzymdfc,2456,60,2,5,7,28.6%,1h
32528,3,KingFu,2456,0,2,5,7,28.6%,1h
32528,3,ChatonBrutal,2456,30,1,2,3,33.3%,22m
32528,3,Hip,2456,0,0,1,1,0.0%,9m
32528,3,danilka,2456,0,0,3,3,0.0%,1h
32528,2,danskyck,2456,0,0,4,4,0.0%,1h
32553,1,[AciNoN]BloomingDead,2455,1567,528,531,1059,49.9%,1h
32553,2,[NBESPT]GRO,2455,1526,242,245,487,49.7%,6m
32553,2,[SPAINs]pabloblack,2455,1578,115,98,213,54.0%,1h
32553,3,Romart,2455,1628,104,91,195,53.3%,11m
32553,1,danypata,2455,1287,95,107,202,47.0%,1h
32553,1,Deny,2455,1390,54,63,117,46.2%,25m
32553,3,ELKAPO,2455,1129,48,42,90,53.3%,11m
32553,2,phalanx,2455,1244,45,53,98,45.9%,1h
32553,3,Zeratul,2455,833,39,34,73,53.4%,15m
32553,3,MMGMcGuppy,2455,828,26,45,71,36.6%,8m
32553,3,грандмастер,2455,366,17,18,35,48.6%,1h
32553,3,Manych,2455,189,16,10,26,61.5%,1h
32553,3,AndyTret,2455,387,14,18,32,43.8%,1h
32553,3,PeddalToft,2455,343,13,12,25,52.0%,1h
32553,2,[EnFi]orlando,2455,348,13,16,29,44.8%,23m
32553,3,[basdp]Dobro,2455,352,12,9,21,57.1%,1h
32553,1,RAVEN,2455,292,11,12,23,47.8%,1h
32553,3,Sova,2455,306,10,7,17,58.8%,4m
32553,3,JachzoiD,2455,204,7,1,8,87.5%,15m
32553,3,pedrito,2455,144,6,6,12,50.0%,1h
32553,2,Angel,2455,196,6,10,16,37.5%,1h
32553,2,Menos,2455,44,5,6,11,45.5%,1h
32553,3,[ProRax]TheAftor,2455,120,4,3,7,57.1%,3m
32553,1,[CAG1]YpnOse,2455,100,4,14,18,22.2%,1h
32553,2,KEN,2455,124,3,1,4,75.0%,7m
32553,3,Kindaro,2455,127,3,2,5,60.0%,1h
32553,3,KAMIL,2455,0,3,2,5,60.0%,1h
32553,3,BulletRider,2455,121,3,8,11,27.3%,1h
32553,3,Safe,2455,30,2,2,4,50.0%,3m
32553,3,eXi,2455,96,1,1,2,50.0%,20m
32553,3,ready,2455,95,1,1,2,50.0%,1h
32553,1,CLOUZE,2455,0,1,4,5,20.0%,1h
32553,1,ebbisaya,2455,0,1,4,5,20.0%,1h
32553,1,Gamma,2455,48,1,5,6,16.7%,1h
32553,2,Raspa,2455,30,1,6,7,14.3%,1h
32553,3,[StarrT]Doe,2455,0,0,1,1,0.0%,22m
32553,3,Call,2455,0,0,1,1,0.0%,1h
32553,3,[drrsch]Oliverinspac,2455,0,0,1,1,0.0%,1h
32591,3,[Lndsrd]Janru,2454,1223,100,84,184,54.3%,28m
32591,2,Frosty,2454,1260,96,94,190,50.5%,59m
32591,3,Kotofey,2454,1463,86,73,159,54.1%,1h
32591,3,NeverMind,2454,368,81,69,150,54.0%,1h
32591,3,Роман,2454,1443,71,48,119,59.7%,19m
32591,3,алексей,2454,1172,45,44,89,50.6%,6m
32591,2,faraday,2454,767,44,48,92,47.8%,18m
32591,3,Killerfridge,2454,758,33,27,60,55.0%,15m
32591,2,[AVR]Scorpius,2454,646,23,25,48,47.9%,18m
32591,3,Hero,2454,527,19,17,36,52.8%,11m
32591,3,Faust,2454,488,17,14,31,54.8%,1h
32591,3,[PsF]Gery,2454,325,12,18,30,40.0%,7m
32591,1,Kidd,2454,337,12,19,31,38.7%,12m
32591,3,CneKTP,2454,291,10,7,17,58.8%,13m
32591,1,Pirks,2454,270,10,22,32,31.2%,20m
32591,3,Unhuman,2454,234,8,3,11,72.7%,25m
32591,2,eXten,2454,182,8,8,16,50.0%,28m
32591,3,[Teslik]Refugee,2454,232,7,4,11,63.6%,5m
32591,3,Nosfearatu,2454,174,7,6,13,53.8%,1h
32591,3,pinkie,2454,219,7,8,15,46.7%,5m
32591,2,Aronakss,2454,225,6,5,11,54.5%,1h
32591,3,Andrejqo,2454,120,6,6,12,50.0%,23m
32591,1,Simple,2454,146,6,6,12,50.0%,58m
32591,1,Gombo,2454,151,5,9,14,35.7%,22m
32591,3,MadeOrk,2454,134,5,9,14,35.7%,23m
32591,3,Jedi,2454,169,4,3,7,57.1%,6m
32591,1,Клюква,2454,193,4,3,7,57.1%,59m
32591,3,[RNNyee]farlael,2454,125,3,1,4,75.0%,1h
32591,1,Cata,2454,0,3,2,5,60.0%,1h
32591,2,[AuRu0]charly,2454,0,3,3,6,50.0%,1h
32591,3,[AmFo]Garrus,2454,58,3,4,7,42.9%,1h
32591,1,[LifeTV]IOOOOOO,2454,96,3,7,10,30.0%,14m
32591,3,spark,2454,95,2,0,2,100.0%,60m
32591,3,dax,2454,96,2,0,2,100.0%,5m
32591,3,DMaxian,2454,119,2,2,4,50.0%,11m
32591,3,CsutkaFishy,2454,0,2,3,5,40.0%,1h
32591,2,[DFQ1]UcHa,2454,0,2,5,7,28.6%,1h
32591,3,[HGmZ]Bzz,2454,0,2,6,8,25.0%,1h
32591,1,Digy,2454,40,1,1,2,50.0%,1h
32591,3,takerman,2454,0,1,2,3,33.3%,3m
32591,3,[VdP]Goldorak,2454,0,0,1,1,0.0%,20m
32591,3,Robotbo,2454,0,0,1,1,0.0%,21m
32591,3,[Clyd]RotoMif,2454,0,0,1,1,0.0%,1h
32591,3,Kohbo,2454,0,0,2,2,0.0%,26m
32591,3,ERSH,2454,0,0,2,2,0.0%,1h
32591,1,Joe,2454,0,0,2,2,0.0%,22m
32637,2,Jardemor,2453,1495,479,486,965,49.6%,60m
32637,1,CIUBO,2453,1512,146,153,299,48.8%,9m
32637,3,[XxXxXw]SoobyPL,2453,1390,79,69,148,53.4%,29m
32637,1,kickBrain,2453,1625,76,77,153,49.7%,18m
32637,3,FakerFox,2453,1049,38,42,80,47.5%,24m
32637,2,[SMID]Mikozza,2453,918,37,36,73,50.7%,1h
32637,1,lehach,2453,806,31,35,66,47.0%,14m
32637,2,BTKCEPIOL,2453,912,31,37,68,45.6%,1h
32637,3,ULAFS,2453,769,27,27,54,50.0%,17m
32637,3,[elCls]eCsDarKRush,2453,693,25,24,49,51.0%,1h
32637,3,Babel,2453,612,23,25,48,47.9%,25m
32637,3,pab,2453,600,23,27,50,46.0%,59m
32637,3,Unity,2453,580,22,22,44,50.0%,1h
32637,3,Collie,2453,497,19,14,33,57.6%,11m
32637,3,[Cheas]БогиняНаоми,2453,349,12,11,23,52.2%,1h
32637,3,GrZ,2453,245,11,12,23,47.8%,13m
32637,2,[NSJLM]XeQiu,2453,236,7,6,13,53.8%,8m
32637,3,NightKnight,2453,195,6,6,12,50.0%,1h
32637,2,[OTK]BulldoKing,2453,132,6,7,13,46.2%,1h
32637,2,Meliodas,2453,171,6,9,15,40.0%,1h
32637,1,Клеопатра,2453,0,5,1,6,83.3%,27m
32637,2,Leo,2453,141,5,8,13,38.5%,1h
32637,3,Battleoooze,2453,86,3,4,7,42.9%,1h
32637,3,Ivex,2453,86,3,5,8,37.5%,1h
32637,3,ZoNoS,2453,95,2,0,2,100.0%,1h
32637,3,vlad,2453,121,2,2,4,50.0%,1h
32637,1,kempes,2453,0,2,2,4,50.0%,1h
32637,3,пипи,2453,58,2,3,5,40.0%,1h
32637,2,[UscHi]nigelpeach,2453,82,2,4,6,33.3%,1h
32637,1,gwynbleidd,2453,48,2,5,7,28.6%,58m
32637,3,Adenok,2453,0,1,0,1,100.0%,9m
32637,3,fedqa,2453,0,1,0,1,100.0%,3m
32637,3,НебесныйЛИС,2453,0,1,0,1,100.0%,9m
32637,1,relanpago,2453,0,1,0,1,100.0%,1h
32637,3,DLT,2453,40,1,4,5,20.0%,1h
32637,1,ohmy,2453,0,0,1,1,0.0%,1h
32637,3,NikiXyiki,2453,0,0,1,1,0.0%,1h
32637,3,[LPKT]LPKTLispenin,2453,0,0,1,1,0.0%,1h
32637,2,[beggas]sakopolmenta,2453,0,0,6,6,0.0%,18m
32676,3,Shark,2452,1509,69,59,128,53.9%,26m
32676,2,uberjeff,2452,1592,68,70,138,49.3%,21m
32676,3,Techmate,2452,1119,61,57,118,51.7%,13m
32676,2,[E2F]Arsenic,2452,913,52,53,105,49.5%,28m
32676,3,IvanKolyada,2452,1017,39,34,73,53.4%,1h
32676,2,[NVRFGT]kingSYROhacf,2452,1038,39,41,80,48.8%,1h
32676,3,Hedgehog,2452,988,38,40,78,48.7%,1h
32676,3,Bash,2452,848,32,28,60,53.3%,3m
32676,3,kirill,2452,734,31,21,52,59.6%,1h
32676,3,fair,2452,539,24,15,39,61.5%,3m
32676,2,ПoTpoWuTeJl,2452,400,17,19,36,47.2%,26m
32676,3,Deidara,2452,311,12,12,24,50.0%,15m
32676,3,LAKATOS,2452,311,12,17,29,41.4%,24m
32676,2,[SW69]LyciaN,2452,235,8,11,19,42.1%,1h
32676,2,King,2452,208,7,9,16,43.8%,5m
32676,3,Olegch,2452,148,6,6,12,50.0%,9m
32676,3,[Grr2]Schmik,2452,210,6,9,15,40.0%,3m
32676,2,LeHorla,2452,136,6,11,17,35.3%,25m
32676,3,[ENU]DarthMikey,2452,159,5,1,6,83.3%,11m
32676,3,Scrofula,2452,170,5,3,8,62.5%,1h
32676,3,Котяка,2452,120,5,8,13,38.5%,9m
32676,2,OzcV,2452,156,4,6,10,40.0%,11m
32676,1,izGROMor,2452,141,4,9,13,30.8%,7m
32676,1,rbfi,2452,129,4,9,13,30.8%,1h
32676,3,nOskiL,2452,58,3,2,5,60.0%,3m
32676,3,Azazel,2452,62,2,3,5,40.0%,1h
32676,1,ThisIsASteak,2452,0,2,4,6,33.3%,5m
32676,3,xanix,2452,80,2,6,8,25.0%,4m
32676,3,arcuan,2452,0,1,0,1,100.0%,26m
32676,3,IIIIIIIIIIII,2452,95,1,1,2,50.0%,11m
32676,3,[BAPEN]INnoVation,2452,0,1,1,2,50.0%,1h
32676,1,Brotha,2452,0,1,4,5,20.0%,1h
32676,1,IngeniusSoul,2452,0,0,1,1,0.0%,18m
32676,2,TheplayerDeg,2452,0,0,1,1,0.0%,1h
32710,3,Kylon,2451,1660,245,237,482,50.8%,7m
32710,3,maciekuk,2451,1055,141,128,269,52.4%,16m
32710,2,[MAGOA]Beekeeper,2451,1358,133,125,258,51.6%,1h
32710,3,[Kous]Benny,2451,982,56,46,102,54.9%,24m
32710,3,[kill2u]Jimiasty,2451,1039,55,19,74,74.3%,16m
32710,3,[NMSQ]Fullar,2451,1029,41,37,78,52.6%,1h
32710,3,Cosmopoly,2451,1015,38,40,78,48.7%,1h
32710,3,Darth,2451,702,36,13,49,73.5%,24m
32710,1,[RoCr]superkaito,2451,774,26,35,61,42.6%,10m
32710,3,QuelDorei,2451,598,25,21,46,54.3%,1h
32710,2,ЗлойФотончик,2451,520,20,20,40,50.0%,1h
32710,3,Fight,2451,390,14,12,26,53.8%,4m
32710,3,Bazaar,2451,272,11,12,23,47.8%,1h
32710,2,[G4R3N]FratiiSoca,2451,219,8,10,18,44.4%,17m
32710,3,[vAfHv]UncleBuzljer,2451,146,6,5,11,54.5%,1h
32710,3,Ivory,2451,183,6,6,12,50.0%,1h
32710,3,[BeNob]Failure,2451,160,5,0,5,100.0%,1h
32710,3,Polyk,2451,71,4,6,10,40.0%,3m
32710,3,Magna,2451,122,4,7,11,36.4%,29m
32710,3,CommanderMKK,2451,30,4,7,11,36.4%,18m
32710,1,off,2451,48,3,3,6,50.0%,3m
32710,3,alvaro,2451,96,3,4,7,42.9%,5m
32710,2,SirCus,2451,94,3,10,13,23.1%,1h
32710,3,[tCCom]Pumuggl,2451,0,2,6,8,25.0%,5m
32710,2,Danghx,2451,30,2,8,10,20.0%,1h
32710,2,Kumba,2451,0,1,1,2,50.0%,24m
32710,3,Eyzor,2451,30,1,3,4,25.0%,8m
32710,1,TheFlexOne,2451,0,1,4,5,20.0%,14m
32738,2,[DL2006]Dioniso,2450,1505,173,159,332,52.1%,1h
32738,2,Timmi,2450,1523,157,163,320,49.1%,1h
32738,3,Destructeur,2450,1572,114,94,208,54.8%,1h
32738,3,Jamuno,2450,1458,106,95,201,52.7%,1h
32738,2,Mizeri,2450,1329,95,81,176,54.0%,58m
32738,3,Сифон,2450,1414,93,83,176,52.8%,4m
32738,2,BackLanJan,2450,884,56,57,113,49.6%,6m
32738,1,Schmerlz,2450,1539,55,67,122,45.1%,26m
32738,2,HALK,2450,431,42,44,86,48.8%,1h
32738,3,Ionus,2450,313,34,18,52,65.4%,3m
32738,3,MyasnikDI,2450,659,27,23,50,54.0%,1h
32738,3,OpenAI,2450,559,24,27,51,47.1%,1h
32738,3,kazuma,2450,570,23,14,37,62.2%,1h
32738,3,Dezember,2450,499,19,18,37,51.4%,60m
32738,2,[WCSCCZ]mariko,2450,282,9,11,20,45.0%,28m
32738,3,Sincityflip,2450,229,8,3,11,72.7%,59m
32738,3,[MISTO]Beacon,2450,210,8,7,15,53.3%,3m
32738,2,necrodome,2450,116,7,7,14,50.0%,23m
32738,3,Rivz,2450,197,6,7,13,46.2%,1h
32738,1,KNEZ,2450,164,5,17,22,22.7%,9m
32738,2,[Лапка]DariZz,2450,114,4,5,9,44.4%,1h
32738,3,Khan,2450,116,4,10,14,28.6%,1h
32738,3,Atlan,2450,134,3,1,4,75.0%,1h
32738,3,Enrique,2450,30,3,8,11,27.3%,17m
32738,3,Einigmacher,2450,95,2,0,2,100.0%,1h
32738,1,ZakUK,2450,0,2,3,5,40.0%,59m
32738,3,Praefect,2450,58,2,4,6,33.3%,1h
32738,2,Ostbullen,2450,0,2,5,7,28.6%,1h
32738,3,DanZZya,2450,0,1,0,1,100.0%,1h
32738,2,ilyakion,2450,0,1,0,1,100.0%,1h
32738,3,hariton,2450,0,1,4,5,20.0%,1h
32738,3,aquarius,2450,0,0,1,1,0.0%,1h
32738,1,[tkos]tobi,2450,0,0,1,1,0.0%,14m
32738,3,Waraangel,2450,0,0,1,1,0.0%,1h
32738,3,Hallucinacio,2450,0,0,1,1,0.0%,3m
32738,3,WizardOZ,2450,0,0,3,3,0.0%,5m
32738,3,Calderon,2450,0,0,4,4,0.0%,1h
32775,3,FANTASTIC,2449,333,64,57,121,52.9%,20m
32775,3,alex,2449,926,38,32,70,54.3%,3m
32775,1,Saturnus,2449,952,34,49,83,41.0%,8m
32775,3,Sprudel,2449,552,24,12,36,66.7%,59m
32775,3,[RO2020]DonEnzone,2449,699,24,27,51,47.1%,1h
32775,1,[PowOw]BeatMeGoPLat,2449,646,22,31,53,41.5%,1h
32775,2,DTWD,2449,222,21,15,36,58.3%,1h
32775,3,FallenAngel,2449,414,15,17,32,46.9%,1h
32775,3,[PLA2N]Cruiser,2449,280,9,9,18,50.0%,3m
32775,2,Tinners,2449,218,7,8,15,46.7%,1h
32775,2,Cyz,2449,176,7,13,20,35.0%,28m
32775,2,STORMYru,2449,114,5,10,15,33.3%,1h
32775,2,zoizoi,2449,133,4,3,7,57.1%,24m
32775,3,Swuder,2449,96,4,7,11,36.4%,3m
32775,3,ank,2449,144,4,7,11,36.4%,1h
32775,2,przo,2449,144,4,8,12,33.3%,58m
32775,3,Erasmus,2449,30,4,8,12,33.3%,27m
32775,3,kalashnicov,2449,30,3,5,8,37.5%,5m
32775,2,Spiritoftime,2449,60,3,5,8,37.5%,28m
32775,3,BART,2449,30,2,3,5,40.0%,1h
32775,2,layronne,2449,125,2,8,10,20.0%,11m
32775,3,[EliteJ]Schnitzel,2449,0,1,0,1,100.0%,7m
32775,3,NihilBaxter,2449,0,1,0,1,100.0%,6m
32775,1,Madsos,2449,0,1,5,6,16.7%,1h
32775,1,Pars,2449,0,0,1,1,0.0%,1h
32775,1,Jahkin,2449,0,0,1,1,0.0%,1h
32775,3,[NWGD]scotty,2449,0,0,2,2,0.0%,29m
32775,3,TheMaxim,2449,0,0,3,3,0.0%,1h
32775,3,James,2449,0,0,3,3,0.0%,1h
32804,1,ZERO,2448,1577,379,381,760,49.9%,1h
32804,2,[TgK]YaDaG,2448,583,202,202,404,50.0%,1h
32804,2,redhotman,2448,1398,129,126,255,50.6%,21m
32804,3,Ripper,2448,1568,103,88,191,53.9%,24m
32804,2,Waldemar,2448,1557,97,93,190,51.1%,11m
32804,3,Шумерля,2448,1612,73,61,134,54.5%,1h
32804,3,[StarLg]Chuxulub,2448,1264,68,53,121,56.2%,18m
32804,3,Hairukan,2448,1235,48,49,97,49.5%,1h
32804,2,Necronomicon,2448,566,22,22,44,50.0%,16m
32804,3,[AtrK]MaverickS,2448,527,21,13,34,61.8%,1h
32804,3,[uCHAD]KolesławCh,2448,335,12,9,21,57.1%,27m
32804,3,Turdinson,2448,255,9,7,16,56.2%,1h
32804,2,MeAndr,2448,199,7,17,24,29.2%,1h
32804,2,Midgard,2448,122,6,10,16,37.5%,1h
32804,2,[Tride]Savannah,2448,36,5,6,11,45.5%,1h
32804,3,[demenn]Tim,2448,143,4,2,6,66.7%,1h
32804,3,ваня,2448,147,3,3,6,50.0%,1h
32804,3,[IYOLOI]Malozabdo,2448,95,2,0,2,100.0%,1h
32804,3,[GGWPGO]Vashta,2448,95,2,0,2,100.0%,1h
32804,3,[Актив]serega,2448,0,1,0,1,100.0%,26m
32804,1,Ayonarendis,2448,0,1,0,1,100.0%,1h
32804,3,Krabic,2448,0,1,0,1,100.0%,14m
32804,3,IncomElisey,2448,0,1,1,2,50.0%,27m
32804,3,BloodyMurder,2448,97,1,2,3,33.3%,7m
32804,2,koshara,2448,0,0,1,1,0.0%,15m
32804,3,[FNDL]Amon,2448,0,0,2,2,0.0%,6m
32804,3,Zanderzon,2448,0,0,2,2,0.0%,7m
32804,3,spacecobra,2448,0,0,2,2,0.0%,26m
32804,3,RockEater,2448,0,0,2,2,0.0%,1h
32804,3,Yoda,2448,0,0,2,2,0.0%,7m
32834,1,GipnoHelper,2447,1593,210,216,426,49.3%,1h
32834,1,Dimus,2447,1567,139,145,284,48.9%,18m
32834,2,[BADBAO]Kassad,2447,530,89,95,184,48.4%,18m
32834,3,jorge,2447,1583,70,64,134,52.2%,1h
32834,1,StormraideR,2447,935,65,63,128,50.8%,1h
32834,3,[MKBO]BeBOP,2447,1381,59,49,108,54.6%,1h
32834,1,Axel,2447,255,40,44,84,47.6%,9m
32834,3,[SPQT]David,2447,618,25,31,56,44.6%,2m
32834,2,[TopEU]VUZE,2447,580,22,23,45,48.9%,1h
32834,2,Ester,2447,339,18,18,36,50.0%,1h
32834,2,KillyEkFael,2447,419,16,20,36,44.4%,18m
32834,3,vlpro,2447,383,15,17,32,46.9%,1h
32834,3,GrandMom,2447,282,14,6,20,70.0%,22m
32834,3,Szwab,2447,373,14,16,30,46.7%,1h
32834,3,Invictus,2447,169,12,8,20,60.0%,60m
32834,1,[Свин]Assasin,2447,288,11,16,27,40.7%,22m
32834,1,ArchieDzhan,2447,365,11,21,32,34.4%,1h
32834,3,ДедБородед,2447,247,9,2,11,81.8%,24m
32834,1,Anditronik,2447,214,7,14,21,33.3%,10m
32834,3,Broinstkopf,2447,86,6,6,12,50.0%,6m
32834,2,[OUUH]Charogne,2447,145,4,0,4,100.0%,1h
32834,3,[Chomps]TheChompy,2447,141,4,1,5,80.0%,14m
32834,3,CheBurator,2447,58,3,2,5,60.0%,18m
32834,3,Elgar,2447,60,3,5,8,37.5%,20m
32834,3,Lazycow,2447,0,2,5,7,28.6%,1h
32834,1,Dopeaf,2447,97,1,1,2,50.0%,1h
32834,3,SugarPuff,2447,30,1,2,3,33.3%,1h
32834,3,Typhus,2447,0,1,3,4,25.0%,25m
32834,2,Heomji,2447,0,0,1,1,0.0%,1h
32834,3,Priest,2447,0,0,1,1,0.0%,21m
32834,3,GitoMouche,2447,0,0,2,2,0.0%,24m
32834,2,УгрюмыйПилон,2447,0,0,7,7,0.0%,1h
32866,3,iAx,2446,1503,403,405,808,49.9%,4m
32866,2,zTpzTp,2446,1089,194,193,387,50.1%,1h
32866,3,DrivRRR,2446,1447,65,59,124,52.4%,1h
32866,3,LittleDemon,2446,632,35,31,66,53.0%,7m
32866,3,[N1NJ4Z]Patilan,2446,800,31,32,63,49.2%,13m
32866,3,Cris,2446,709,26,23,49,53.1%,16m
32866,3,Artp,2446,608,22,25,47,46.8%,1h
32866,2,Satoren,2446,511,21,23,44,47.7%,59m
32866,2,Catherine,2446,593,21,25,46,45.7%,17m
32866,3,[DOKA2]Ваня,2446,220,19,15,34,55.9%,14m
32866,3,Youfousan,2446,410,14,16,30,46.7%,1h
32866,3,Miaska,2446,352,13,7,20,65.0%,1h
32866,2,SaCk,2446,237,8,12,20,40.0%,18m
32866,3,Liosnse,2446,226,7,5,12,58.3%,1h
32866,3,Prokium,2446,176,7,10,17,41.2%,21m
32866,3,Slap,2446,144,5,3,8,62.5%,24m
32866,1,KelmasGV,2446,179,5,5,10,50.0%,1h
32866,3,ntl,2446,171,5,8,13,38.5%,1h
32866,3,[THound]Skyy,2446,135,4,2,6,66.7%,26m
32866,3,ShadowStorm,2446,160,4,3,7,57.1%,29m
32866,3,Makii,2446,122,4,6,10,40.0%,1h
32866,3,RacheEngel,2446,68,4,7,11,36.4%,9m
32866,3,purgen,2446,145,3,3,6,50.0%,25m
32866,3,Madbonya,2446,141,3,7,10,30.0%,1h
32866,3,Gtcharlton,2446,30,2,2,4,50.0%,26m
32866,3,EthanStross,2446,58,2,3,5,40.0%,1h
32866,2,[J4C]Danul,2446,0,2,5,7,28.6%,1h
32866,3,Pergaña,2446,0,2,5,7,28.6%,1h
32866,2,[Змлн]Vortex,2446,60,2,10,12,16.7%,1h
32866,3,[killU]Marineder,2446,94,1,1,2,50.0%,15m
32866,2,Amoxi,2446,0,1,3,4,25.0%,25m
32866,3,[Socky]vozi,2446,0,1,4,5,20.0%,1h
32866,3,klink,2446,30,1,4,5,20.0%,1h
32866,1,avelan,2446,0,0,1,1,0.0%,28m
32866,1,DIYXFedastre,2446,0,0,1,1,0.0%,12m
32866,2,maxOxff,2446,0,0,4,4,0.0%,17m
32866,3,[MkerIT]ChuChu,2446,0,0,4,4,0.0%,25m
32903,3,jimmigi,2445,1532,180,186,366,49.2%,1h
32903,2,SexSexich,2445,1323,138,134,272,50.7%,60m
32903,3,SpartanG,2445,1560,99,98,197,50.3%,1h
32903,3,Blackarea,2445,1479,58,55,113,51.3%,1h
32903,3,Terrany,2445,744,31,24,55,56.4%,10m
32903,2,Paralax,2445,417,29,36,65,44.6%,1h
32903,3,[IaGMI]Lechoupastek,2445,497,21,12,33,63.6%,9m
32903,3,SuperJeww,2445,485,19,16,35,54.3%,1h
32903,3,axleterrible,2445,471,16,14,30,53.3%,1h
32903,3,BlastySpice,2445,370,14,17,31,45.2%,11m
32903,3,SiMulat,2445,235,7,7,14,50.0%,1h
32903,3,mpofaria,2445,219,6,6,12,50.0%,1h
32903,3,SGBetelgeuse,2445,165,5,2,7,71.4%,1h
32903,3,Slavik,2445,88,4,3,7,57.1%,1h
32903,1,MeDoK,2445,144,4,6,10,40.0%,15m
32903,3,Bidjo,2445,66,4,9,13,30.8%,1h
32903,3,Leeroy,2445,143,3,2,5,60.0%,60m
32903,3,KIR,2445,60,3,2,5,60.0%,17m
32903,3,[LIТN]Pikaling,2445,58,3,3,6,50.0%,6m
32903,3,TlpegaTeJlb,2445,30,2,1,3,66.7%,3m
32903,3,MapcMopuc,2445,0,1,1,2,50.0%,3m
32903,3,[PОRN]Miner,2445,30,1,2,3,33.3%,1h
32903,3,lazerr,2445,0,1,2,3,33.3%,6m
32903,3,Риул,2445,30,1,3,4,25.0%,1h
32903,1,leosard,2445,0,1,4,5,20.0%,10m
32903,3,Gneus,2445,30,1,7,8,12.5%,20m
32903,3,[яєѕ]RoyalFlush,2445,0,0,1,1,0.0%,1h
32903,3,Maksim,2445,0,0,1,1,0.0%,1h
32903,3,VOO,2445,0,0,1,1,0.0%,16m
32903,3,ggwpez,2445,0,0,1,1,0.0%,25m
32903,3,Densimet,2445,0,0,1,1,0.0%,1h
32934,3,WishYouLuckk,2444,1429,141,135,276,51.1%,1h
32934,3,КрутойПоц,2444,1437,117,116,233,50.2%,1h
32934,3,[tgysel]Thies,2444,1387,102,106,208,49.0%,1h
32934,3,Pacuizu,2444,1590,93,90,183,50.8%,1h
32934,2,Konkord,2444,1197,78,72,150,52.0%,29m
32934,3,Buch,2444,1588,65,56,121,53.7%,14m
32934,2,[RAKF]Hassa,2444,840,47,41,88,53.4%,19m
32934,3,CandyClub,2444,643,42,2,44,95.5%,1h
32934,2,BloodThorn,2444,345,42,52,94,44.7%,1h
32934,3,ник,2444,587,36,30,66,54.5%,1h
32934,3,Solorien,2444,530,35,25,60,58.3%,29m
32934,3,infestor,2444,559,34,30,64,53.1%,26m
32934,2,sirBatman,2444,207,31,32,63,49.2%,6m
32934,3,[iGRD]Spacedog,2444,722,28,29,57,49.1%,1h
32934,3,tachanka,2444,578,21,27,48,43.8%,13m
32934,3,vojta,2444,415,18,12,30,60.0%,1h
32934,2,Вестгейр,2444,183,11,15,26,42.3%,6m
32934,2,PashaCrazy,2444,253,9,12,21,42.9%,1h
32934,1,Sebastyan,2444,96,7,8,15,46.7%,1h
32934,3,Shanks,2444,90,4,6,10,40.0%,59m
32934,3,FioletUltra,2444,167,4,6,10,40.0%,4m
32934,3,Beatmaster,2444,127,4,7,11,36.4%,23m
32934,2,[lOoOl]andrei,2444,40,2,1,3,66.7%,7m
32934,3,max,2444,30,2,2,4,50.0%,16m
32934,3,Krokodil,2444,30,2,2,4,50.0%,11m
32934,3,Zbibi,2444,0,2,4,6,33.3%,1h
32934,3,baklava,2444,0,2,5,7,28.6%,23m
32934,2,Timy,2444,0,2,5,7,28.6%,1h
32934,1,Angon,2444,0,1,0,1,100.0%,1h
32934,3,ТраТаТа,2444,0,1,1,2,50.0%,1h
32934,3,SkannaIV,2444,0,1,4,5,20.0%,1h
32934,3,Monk,2444,0,0,1,1,0.0%,1h
32934,3,[ExTr1m]Dehaka,2444,0,0,1,1,0.0%,1h
32934,3,NaMeLeSs,2444,0,0,3,3,0.0%,6m
32968,2,[nk44]Kreuzberg,2443,1584,146,153,299,48.8%,1h
32968,3,[orbita]smoke,2443,1173,54,40,94,57.4%,16m
32968,3,jenoH,2443,485,44,31,75,58.7%,1h
32968,3,[HZeS]ТайноТролль,2443,615,28,20,48,58.3%,29m
32968,3,naibuleuse,2443,699,27,24,51,52.9%,59m
32968,3,Kyobai,2443,600,23,19,42,54.8%,59m
32968,3,OnePunch,2443,609,23,21,44,52.3%,7m
32968,3,Happy,2443,265,23,21,44,52.3%,1h
32968,3,[Genoa]Nureldin,2443,536,21,15,36,58.3%,1h
32968,2,JasonPine,2443,612,20,27,47,42.6%,1h
32968,3,AlexOOI,2443,453,19,12,31,61.3%,24m
32968,3,metallfrank,2443,437,18,16,34,52.9%,1h
32968,3,ChickenKing,2443,420,16,24,40,40.0%,15m
32968,3,Swarbyboy,2443,313,13,3,16,81.2%,1h
32968,3,Defekator,2443,304,10,10,20,50.0%,1h
32968,2,[FSMD88]Mailman,2443,298,10,19,29,34.5%,17m
32968,1,[liisks]galacticspy,2443,151,9,8,17,52.9%,1h
32968,2,grampp,2443,242,8,12,20,40.0%,11m
32968,2,bananas,2443,174,7,12,19,36.8%,1h
32968,2,Ingo,2443,179,6,9,15,40.0%,1h
32968,3,Cranius,2443,136,4,1,5,80.0%,1h
32968,3,guardrose,2443,172,4,4,8,50.0%,59m
32968,3,Crocs,2443,90,4,6,10,40.0%,11m
32968,3,Erlkonig,2443,114,4,6,10,40.0%,19m
32968,3,BlaueBirne,2443,34,2,0,2,100.0%,1h
32968,3,KarapuZ,2443,95,2,0,2,100.0%,14m
32968,1,Fundim,2443,48,2,1,3,66.7%,21m
32968,3,Verest,2443,30,2,2,4,50.0%,3m
32968,1,[Pub77]Pub,2443,103,2,9,11,18.2%,1h
32968,3,Nattvasen,2443,95,1,1,2,50.0%,1h
32968,1,unseen,2443,0,1,2,3,33.3%,1h
32968,3,JuiceKeg,2443,93,1,3,4,25.0%,3m
32968,3,Evilhunter,2443,30,1,3,4,25.0%,1h
32968,1,Kamchak,2443,0,1,4,5,20.0%,23m
32968,3,Armenius,2443,0,1,4,5,20.0%,16m
32968,1,GoriorPL,2443,0,1,5,6,16.7%,26m
32968,2,Kremnitzky,2443,88,1,7,8,12.5%,1h
32968,1,Pekson,2443,0,0,1,1,0.0%,5m
32968,3,replayRTW,2443,0,0,1,1,0.0%,1h
32968,1,tomylv,2443,0,0,1,1,0.0%,1h
32968,2,Equalizer,2443,0,0,1,1,0.0%,1h
32968,3,ImMoRtAl,2443,0,0,2,2,0.0%,1h
32968,1,NoobRace,2443,0,0,2,2,0.0%,11m
32968,3,[RvT02]Rabvallato,2443,0,0,3,3,0.0%,27m
33012,2,FRO,2442,1570,364,344,708,51.4%,1h
33012,2,Lormak,2442,1518,76,70,146,52.1%,1h
33012,3,ERDEM,2442,678,64,62,126,50.8%,26m
33012,3,Holo,2442,726,53,46,99,53.5%,4m
33012,3,iGGotchu,2442,937,53,47,100,53.0%,1h
33012,3,Mstyz,2442,649,48,59,107,44.9%,25m
33012,3,Latik,2442,955,41,39,80,51.2%,3m
33012,2,sanya,2442,842,37,26,63,58.7%,22m
33012,3,angrymidget,2442,586,22,21,43,51.2%,25m
33012,3,Maurice,2442,530,22,21,43,51.2%,16m
33012,3,[BAAR]bare,2442,305,14,6,20,70.0%,14m
33012,2,Maksiu,2442,392,13,21,34,38.2%,1h
33012,3,[3Dǃ]kitsune,2442,236,10,4,14,71.4%,1h
33012,3,SpookyGhost,2442,253,8,10,18,44.4%,20m
33012,3,HikariChan,2442,146,5,7,12,41.7%,9m
33012,2,[DSGH]DonaldTrump,2442,86,5,9,14,35.7%,25m
33012,3,DenBercut,2442,157,4,6,10,40.0%,15m
33012,3,jopalor,2442,94,4,8,12,33.3%,1h
33012,3,anton,2442,95,2,0,2,100.0%,24m
33012,3,YanoT,2442,96,2,0,2,100.0%,14m
33012,2,Hogfather,2442,97,2,5,7,28.6%,1h
33012,3,Rehsur,2442,116,2,5,7,28.6%,1h
33012,3,Sebi,2442,0,1,0,1,100.0%,4m
33012,3,zen,2442,94,1,1,2,50.0%,1h
33012,3,[JaPP]Hammerfate,2442,0,1,1,2,50.0%,1h
33012,3,[EZSDHK]Ceesi,2442,30,1,3,4,25.0%,11m
33012,1,davkee,2442,0,1,4,5,20.0%,1h
33012,1,Jornwer,2442,0,1,4,5,20.0%,5m
33012,1,Barbar,2442,0,1,4,5,20.0%,12m
33012,3,VormKrieg,2442,0,1,4,5,20.0%,1h
33012,3,Виктор,2442,0,0,1,1,0.0%,1h
33012,3,DuKec,2442,0,0,1,1,0.0%,13m
33012,2,Myer,2442,0,0,3,3,0.0%,1h
33012,3,[Arkhan]kardmantel,2442,0,0,3,3,0.0%,1h
33046,3,eyeq,2441,1511,123,141,264,46.6%,3m
33046,3,Snail,2441,1428,109,101,210,51.9%,29m
33046,2,Mikko,2441,1460,97,101,198,49.0%,28m
33046,2,kosmaster,2441,884,92,72,164,56.1%,13m
33046,3,Starksword,2441,326,48,42,90,53.3%,1h
33046,3,Amihan,2441,611,34,28,62,54.8%,1h
33046,1,Radbit,2441,920,31,45,76,40.8%,10m
33046,3,[TAKAS]Misiol,2441,530,29,26,55,52.7%,26m
33046,2,IkeaBoy,2441,784,28,31,59,47.5%,1h
33046,3,[iX]TornadoVape,2441,522,19,23,42,45.2%,7m
33046,1,FrostScarlet,2441,447,19,24,43,44.2%,1h
33046,3,[пепега]RSM,2441,471,17,14,31,54.8%,25m
33046,3,Hydra,2441,288,10,12,22,45.5%,1h
33046,3,Plutobelom,2441,263,9,6,15,60.0%,15m
33046,2,DrakePerseus,2441,204,8,9,17,47.1%,25m
33046,3,[HFR]Bitman,2441,71,8,10,18,44.4%,1h
33046,3,pasunmouton,2441,155,8,13,21,38.1%,1h
33046,3,merc,2441,169,7,1,8,87.5%,8m
33046,2,[ProVZ]Stax,2441,146,5,13,18,27.8%,25m
33046,3,SiK,2441,95,4,3,7,57.1%,29m
33046,3,Azrael,2441,118,4,6,10,40.0%,14m
33046,3,[Пуцка]DarkMonah,2441,122,4,8,12,33.3%,1h
33046,3,Liam,2441,97,3,6,9,33.3%,1h
33046,3,[ThZe]Ramires,2441,95,2,0,2,100.0%,4m
33046,2,[Cheel]BMorge,2441,88,2,0,2,100.0%,11m
33046,2,milski,2441,88,2,0,2,100.0%,1h
33046,3,Kiroin,2441,30,2,3,5,40.0%,25m
33046,3,Calaga,2441,58,2,4,6,33.3%,4m
33046,3,Agronovich,2441,0,1,0,1,100.0%,29m
33046,3,[SAoN]nightknight,2441,0,1,0,1,100.0%,19m
33046,3,[MEKU]фанатик,2441,0,1,0,1,100.0%,1h
33046,3,unfaithful,2441,0,1,1,2,50.0%,1h
33046,3,[OPNDOR]omg,2441,0,1,1,2,50.0%,22m
33046,1,[Freeze]Rewind,2441,0,1,4,5,20.0%,1h
33046,3,[MOFFIN]Adamer,2441,0,1,4,5,20.0%,1h
33046,3,Yurii,2441,0,1,4,5,20.0%,11m
33046,1,Molot,2441,0,1,4,5,20.0%,1h
33046,3,ligmalarva,2441,0,0,1,1,0.0%,4m
33046,1,[SZIG]Ilúvatar,2441,0,0,1,1,0.0%,3m
33046,3,Кьюди,2441,0,0,1,1,0.0%,5m
33046,1,Judzulfaq,2441,0,0,1,1,0.0%,6m
33046,3,BraveNipple,2441,0,0,2,2,0.0%,8m
33046,1,DocBrown,2441,0,0,2,2,0.0%,1h
33046,3,Orion,2441,0,0,3,3,0.0%,1h
33090,3,SuMBiD,2440,1554,164,156,320,51.2%,20m
33090,2,LaMaGrA,2440,1361,161,146,307,52.4%,27m
33090,1,McSuicide,2440,1515,108,116,224,48.2%,1h
33090,3,Hayalet,2440,1528,90,77,167,53.9%,1h
33090,3,Garbanzo,2440,1602,88,91,179,49.2%,1h
33090,3,Fox,2440,830,59,54,113,52.2%,19m
33090,2,Кровосисий,2440,1269,53,49,102,52.0%,22m
33090,2,Kuto,2440,884,36,34,70,51.4%,21m
33090,3,SirPoopins,2440,817,35,27,62,56.5%,5m
33090,3,pirmin,2440,740,30,28,58,51.7%,15m
33090,3,Captp,2440,730,26,30,56,46.4%,1h
33090,3,ich,2440,606,23,17,40,57.5%,1h
33090,3,[43rus]Bot,2440,300,10,20,30,33.3%,1h
33090,3,Asper,2440,230,9,4,13,69.2%,1h
33090,2,Servex,2440,324,9,13,22,40.9%,29m
33090,1,[Kompis]devall,2440,231,9,17,26,34.6%,20m
33090,3,[RNKS]SÄÄTÄJÄ,2440,190,5,4,9,55.6%,1h
33090,3,Crâshley,2440,169,5,7,12,41.7%,11m
33090,3,strichOr,2440,175,5,9,14,35.7%,1h
33090,3,Chef,2440,60,3,3,6,50.0%,1h
33090,3,Lyzel,2440,62,3,4,7,42.9%,1h
33090,1,Jumpy,2440,109,3,6,9,33.3%,1h
33090,1,Sasha,2440,90,3,8,11,27.3%,25m
33090,3,Dagato,2440,78,2,4,6,33.3%,19m
33090,3,depedio,2440,0,2,5,7,28.6%,1h
33090,1,Yarichek,2440,48,2,5,7,28.6%,11m
33090,3,Nilz,2440,60,2,5,7,28.6%,1h
33090,1,JavierHV,2440,97,2,5,7,28.6%,26m
33090,1,[SqBolt]TOM,2440,0,1,0,1,100.0%,25m
33090,1,Acctank,2440,115,1,4,5,20.0%,60m
33090,1,FREEzy,2440,0,1,4,5,20.0%,27m
33090,2,[DeepT]alex,2440,0,1,6,7,14.3%,6m
33090,1,BaTien,2440,0,0,1,1,0.0%,20m
33090,1,andrewrose,2440,0,0,1,1,0.0%,23m
33090,3,[Incm]KrYoxZ,2440,0,0,2,2,0.0%,11m
33090,1,OPchicken,2440,0,0,2,2,0.0%,1h
33090,3,apoo,2440,0,0,2,2,0.0%,7m
33090,3,Banad,2440,0,0,2,2,0.0%,26m
33090,1,Zédward,2440,0,0,5,5,0.0%,14m
33129,3,Warrior,2439,1579,95,91,186,51.1%,5m
33129,3,robotdeha,2439,1287,88,88,176,50.0%,1h
33129,3,MeAsH,2439,926,40,40,80,50.0%,1h
33129,2,Нуб,2439,786,34,38,72,47.2%,1h
33129,2,Dooza,2439,698,30,21,51,58.8%,1h
33129,2,SurvivedInTs,2439,245,19,20,39,48.7%,1h
33129,3,Muxa,2439,468,17,17,34,50.0%,1h
33129,3,aki,2439,366,13,11,24,54.2%,1h
33129,2,thunderbird,2439,286,12,12,24,50.0%,1h
33129,1,Heroes,2439,224,10,13,23,43.5%,1h
33129,1,Rainbow,2439,320,8,3,11,72.7%,1h
33129,2,sergykTT,2439,238,7,13,20,35.0%,1h
33129,1,[Vck]Qun,2439,0,4,2,6,66.7%,1h
33129,3,replots,2439,119,3,2,5,60.0%,1h
33129,2,llllllllllll,2439,88,2,0,2,100.0%,1h
33129,3,Brutus,2439,60,2,3,5,40.0%,25m
33129,2,[MrCSC]Pipou,2439,124,2,4,6,33.3%,1h
33129,3,cestLaVie,2439,60,2,5,7,28.6%,7m
33129,1,ZLM,2439,121,2,5,7,28.6%,4m
33129,3,[400apm]Stain,2439,97,2,6,8,25.0%,14m
33129,1,zkod,2439,0,1,0,1,100.0%,9m
33129,1,[GTMNG]patadedouce,2439,0,1,0,1,100.0%,1h
33129,1,bulbasour,2439,0,1,0,1,100.0%,28m
33129,3,[Ihanri]ThanderKnigh,2439,0,1,1,2,50.0%,1h
33129,1,Baked,2439,44,1,2,3,33.3%,18m
33129,1,AlexME,2439,73,1,3,4,25.0%,59m
33129,1,TEYMENCX,2439,0,0,1,1,0.0%,11m
33129,1,Osurac,2439,0,0,1,1,0.0%,21m
33129,3,SpyglassTF,2439,0,0,2,2,0.0%,1h
33158,1,Tembou,2438,1563,263,255,518,50.8%,9m
33158,1,[OK238]Orbitalwave,2438,1578,173,179,352,49.1%,1h
33158,3,Winterstein,2438,1524,89,97,186,47.8%,1h
33158,3,mrAngel,2438,860,80,65,145,55.2%,4m
33158,3,Krelian,2438,1595,79,67,146,54.1%,18m
33158,3,Groot,2438,1411,59,54,113,52.2%,1h
33158,3,LETSPLAY,2438,1039,50,51,101,49.5%,1h
33158,3,totor,2438,574,46,29,75,61.3%,7m
33158,3,Thiasar,2438,330,43,36,79,54.4%,1h
33158,1,Jeka,2438,1252,43,37,80,53.8%,58m
33158,3,Shenlong,2438,696,40,32,72,55.6%,60m
33158,3,stoobart,2438,557,38,30,68,55.9%,1h
33158,2,neoedo,2438,811,33,34,67,49.3%,10m
33158,3,Curious,2438,534,20,18,38,52.6%,19m
33158,3,[Gremli]УшлыйКролик,2438,412,16,14,30,53.3%,1h
33158,3,LongHot,2438,350,12,11,23,52.2%,12m
33158,3,Ragnatar,2438,146,6,7,13,46.2%,19m
33158,1,MİLLER,2438,128,4,1,5,80.0%,23m
33158,3,vova,2438,117,3,1,4,75.0%,11m
33158,1,SeizeTheMeme,2438,145,3,5,8,37.5%,1h
33158,3,Volrath,2438,60,3,5,8,37.5%,26m
33158,1,Pawlak,2438,86,2,1,3,66.7%,27m
33158,1,methodman,2438,88,2,2,4,50.0%,1h
33158,3,[SSOO]JimRaynor,2438,60,2,4,6,33.3%,11m
33158,1,HobiD,2438,0,2,4,6,33.3%,28m
33158,1,Serega,2438,0,1,0,1,100.0%,7m
33158,1,xthanathos,2438,0,0,1,1,0.0%,1h
33158,1,mciek,2438,0,0,1,1,0.0%,21m
33158,1,mocarzPL,2438,0,0,1,1,0.0%,1h
33158,3,Насяльника,2438,0,0,2,2,0.0%,1h
33158,2,JokkePokke,2438,0,0,22,22,0.0%,27m
33189,1,Gkilix,2437,1507,164,156,320,51.2%,1h
33189,3,kpcastro,2437,1535,80,80,160,50.0%,11m
33189,1,VladT,2437,980,79,77,156,50.6%,27m
33189,3,grimin,2437,1425,72,50,122,59.0%,5m
33189,3,ArtBitter,2437,1037,67,50,117,57.3%,60m
33189,3,xseelz,2437,952,66,59,125,52.8%,5m
33189,3,Студент,2437,846,64,51,115,55.7%,18m
33189,3,CedBenglez,2437,1182,50,46,96,52.1%,1h
33189,2,SeppiaOmbra,2437,801,43,49,92,46.7%,19m
33189,1,[Falkon]Scofield,2437,994,36,50,86,41.9%,1h
33189,3,TECHSTAR,2437,852,33,34,67,49.3%,8m
33189,1,mcgregor,2437,752,29,43,72,40.3%,20m
33189,3,mozzx,2437,776,25,45,70,35.7%,17m
33189,3,[II3II]Agsel,2437,485,20,13,33,60.6%,1h
33189,2,Olafson,2437,318,16,13,29,55.2%,22m
33189,3,IIIIIIIIIIII,2437,322,13,4,17,76.5%,14m
33189,3,LeonTrotsky,2437,310,11,7,18,61.1%,1h
33189,1,Odasity,2437,442,11,8,19,57.9%,1h
33189,3,Fadz,2437,331,11,11,22,50.0%,1h
33189,2,Tizoi,2437,238,7,13,20,35.0%,4m
33189,3,Twixmaniak,2437,169,5,2,7,71.4%,1h
33189,2,Smarog,2437,134,5,8,13,38.5%,17m
33189,3,Loadinshoot,2437,177,5,8,13,38.5%,23m
33189,1,[SODF]staion,2437,100,4,14,18,22.2%,1h
33189,1,Farinha,2437,84,3,0,3,100.0%,1h
33189,1,DarkSpirit,2437,48,3,4,7,42.9%,4m
33189,3,Azdil,2437,30,3,5,8,37.5%,4m
33189,3,HafforS,2437,88,3,7,10,30.0%,7m
33189,3,AimKeks,2437,48,3,7,10,30.0%,1h
33189,1,cospevo,2437,112,2,1,3,66.7%,1h
33189,1,КОТЭ,2437,147,2,2,4,50.0%,4m
33189,3,Zloi,2437,95,2,5,7,28.6%,1h
33189,3,[7ThCo]THARN,2437,30,2,6,8,25.0%,11m
33189,1,[ĦvĦ]DrPhimose,2437,0,1,0,1,100.0%,12m
33189,1,RezedaSexual,2437,0,1,0,1,100.0%,1h
33189,3,SAMED,2437,0,1,1,2,50.0%,1h
33189,3,IsaacPetrell,2437,30,1,2,3,33.3%,1h
33189,1,sabcio,2437,73,1,2,3,33.3%,11m
33189,3,telmarin,2437,0,1,2,3,33.3%,1h
33189,1,Popov,2437,0,1,4,5,20.0%,26m
33189,1,[BJK]Cdrbti,2437,0,0,1,1,0.0%,1h
33189,1,Efco,2437,0,0,1,1,0.0%,18m
33189,3,Sanek,2437,0,0,2,2,0.0%,6m
33189,3,sinox,2437,0,0,5,5,0.0%,3m
33233,3,Screaminel,2436,1551,134,139,273,49.1%,25m
33233,3,[LosTG]Zachi,2436,1393,67,68,135,49.6%,8m
33233,2,mag,2436,1503,64,66,130,49.2%,28m
33233,3,LEKSO,2436,399,16,9,25,64.0%,1h
33233,2,Ichi,2436,446,14,21,35,40.0%,1h
33233,1,semetey,2436,394,12,10,22,54.5%,27m
33233,1,Slyy,2436,193,4,6,10,40.0%,18m
33233,2,desudesudesu,2436,0,2,5,7,28.6%,1h
33233,3,Schumi,2436,0,2,6,8,25.0%,1h
33233,1,IIIIIIIIIIII,2436,0,1,0,1,100.0%,27m
33233,1,[Панки]DrCarlo,2436,44,1,1,2,50.0%,15m
33233,1,[qwee]YOURDAD,2436,0,1,4,5,20.0%,1h
33233,1,VicorAmely,2436,0,1,4,5,20.0%,1h
33233,1,Pelmenium,2436,0,1,4,5,20.0%,1h
33233,1,AlexBro,2436,0,0,1,1,0.0%,1h
33233,1,SerraAngel,2436,0,0,1,1,0.0%,1h
33233,2,Dimebag,2436,0,0,2,2,0.0%,1h
33250,1,BCRUSH,2435,1140,161,160,321,50.2%,8m
33250,3,ponkicha,2435,828,135,126,261,51.7%,8m
33250,3,Soul,2435,706,61,44,105,58.1%,5m
33250,3,[over1]MrPerez,2435,751,36,33,69,52.2%,1h
33250,2,SanSan,2435,919,36,40,76,47.4%,19m
33250,3,куркума,2435,562,24,26,50,48.0%,1h
33250,2,POR,2435,520,17,22,39,43.6%,17m
33250,3,reavowed,2435,179,13,5,18,72.2%,1h
33250,1,Done,2435,430,10,10,20,50.0%,15m
33250,3,[DRTxd]KillerFCB,2435,292,10,14,24,41.7%,11m
33250,1,[WowSpy]ZeroNet,2435,365,9,5,14,64.3%,1h
33250,2,[Bro007]Lightning,2435,280,9,19,28,32.1%,1h
33250,2,GennadyZT,2435,232,8,10,18,44.4%,9m
33250,3,[BNDSTR]Rilian,2435,210,7,11,18,38.9%,59m
33250,2,IRONGRINDER,2435,186,7,11,18,38.9%,26m
33250,1,KobA,2435,206,6,6,12,50.0%,60m
33250,3,[ZЕRGTV]sakyra,2435,144,6,8,14,42.9%,1h
33250,3,ловкий,2435,160,6,10,16,37.5%,24m
33250,1,REDDAK,2435,220,5,2,7,71.4%,1h
33250,3,[SWE4TY]Styx,2435,172,5,8,13,38.5%,29m
33250,3,Snow,2435,143,3,4,7,42.9%,13m
33250,1,[Gnomed]Oxygenboy,2435,44,2,0,2,100.0%,1h
33250,1,[GSSCRY]Infest,2435,0,1,0,1,100.0%,1h
33250,3,Rieska,2435,96,1,2,3,33.3%,28m
33250,3,EvilSquirrel,2435,0,1,3,4,25.0%,1h
33250,1,[DDHIV]Terminator,2435,0,1,4,5,20.0%,1h
33250,1,Lupetalo,2435,0,1,4,5,20.0%,10m
33250,1,Sosio,2435,0,1,4,5,20.0%,60m
33250,1,BroodjeWorst,2435,97,1,8,9,11.1%,1h
33250,3,look,2435,0,0,3,3,0.0%,1h
33280,3,Napalm,2434,1595,152,150,302,50.3%,14m
33280,3,Windfurious,2434,375,48,38,86,55.8%,1h
33280,3,niazko,2434,1155,47,40,87,54.0%,29m
33280,1,Sindyr,2434,942,42,51,93,45.2%,25m
33280,3,[NBV]DoctorKot,2434,804,38,20,58,65.5%,15m
33280,3,прк,2434,268,9,7,16,56.2%,1h
33280,2,Venom,2434,289,7,15,22,31.8%,1h
33280,3,[KoaK]DoonDragoon,2434,207,6,4,10,60.0%,1h
33280,3,[Fe1t]Фелт,2434,154,4,3,7,57.1%,29m
33280,3,Humades,2434,88,3,6,9,33.3%,16m
33280,1,Pol,2434,44,2,1,3,66.7%,9m
33280,3,[JGRU]Papamix,2434,30,2,2,4,50.0%,60m
33280,1,NEXIS,2434,42,2,4,6,33.3%,1h
33280,1,toastedfear,2434,97,2,4,6,33.3%,1h
33280,3,Tomiboy,2434,0,2,5,7,28.6%,6m
33280,3,bodopi,2434,0,2,5,7,28.6%,26m
33280,3,BlackWolf,2434,30,2,5,7,28.6%,15m
33280,1,Magmusus,2434,0,1,1,2,50.0%,3m
33280,3,Lacplesis,2434,96,1,2,3,33.3%,60m
33280,1,Wiffy,2434,0,1,4,5,20.0%,1h
33280,1,Warhammer,2434,0,1,4,5,20.0%,28m
33280,1,BeardedHare,2434,0,1,4,5,20.0%,1h
33280,1,Molnar,2434,0,1,4,5,20.0%,1h
33280,3,ReDot,2434,30,1,6,7,14.3%,1h
33280,1,LeMechanT,2434,0,0,1,1,0.0%,20m
33280,1,[RNKS]Toniza,2434,0,0,1,1,0.0%,1h
33280,1,[Tiznao]Bauer,2434,0,0,2,2,0.0%,7m
33307,2,herzoin,2433,1527,99,98,197,50.3%,6m
33307,1,KrsFreem,2433,1517,88,80,168,52.4%,8m
33307,3,Apostol,2433,978,44,40,84,52.4%,1h
33307,3,Hypnogorilla,2433,686,28,26,54,51.9%,22m
33307,3,rino,2433,800,28,35,63,44.4%,16m
33307,3,doctor,2433,479,22,15,37,59.5%,59m
33307,3,ЛовкиеПальцы,2433,553,22,24,46,47.8%,1h
33307,3,[PiGPan]Nahkrix,2433,523,20,17,37,54.1%,3m
33307,2,yavaus,2433,434,18,17,35,51.4%,21m
33307,3,[Fansaf]Kvihant,2433,426,15,16,31,48.4%,4m
33307,3,Zbang,2433,444,14,33,47,29.8%,3m
33307,3,[BeGa]Moppebart,2433,348,12,16,28,42.9%,7m
33307,1,danto,2433,371,11,8,19,57.9%,1h
33307,1,metzo,2433,260,7,4,11,63.6%,1h
33307,2,Hoplita,2433,184,7,7,14,50.0%,60m
33307,1,knyazdmv,2433,122,6,3,9,66.7%,11m
33307,3,Lev,2433,86,6,6,12,50.0%,60m
33307,1,llllllllllll,2433,34,4,6,10,40.0%,3m
33307,1,budilon,2433,97,3,3,6,50.0%,15m
33307,1,Flex,2433,137,3,3,6,50.0%,1h
33307,3,Hydrius,2433,90,3,7,10,30.0%,22m
33307,3,[Dobro]PunisherJ,2433,96,2,1,3,66.7%,14m
33307,1,Light,2433,0,2,2,4,50.0%,1h
33307,1,Colonist,2433,97,2,4,6,33.3%,1h
33307,2,[FXs]Devitca,2433,136,2,4,6,33.3%,1h
33307,3,Jackyd,2433,58,2,5,7,28.6%,1h
33307,1,Zed,2433,0,1,1,2,50.0%,18m
33307,3,Krouw,2433,30,1,6,7,14.3%,12m
33307,3,DanielRa,2433,0,0,2,2,0.0%,11m
33307,3,ВАСЯ,2433,0,0,6,6,0.0%,3m
33337,3,IronTerran,2432,1538,143,145,288,49.7%,1h
33337,2,SilentFear,2432,1550,103,110,213,48.4%,1h
33337,2,[spbila]Kirk,2432,1461,75,69,144,52.1%,24m
33337,3,[Herosi]Czareski,2432,1489,67,51,118,56.8%,1h
33337,3,[KFF]Nemesis,2432,1198,66,69,135,48.9%,1h
33337,3,jOuEuR,2432,1208,63,41,104,60.6%,1h
33337,3,Otaking,2432,843,58,61,119,48.7%,1h
33337,3,Biseptold,2432,243,55,70,125,44.0%,25m
33337,3,ColonelWolf,2432,1072,39,39,78,50.0%,1h
33337,3,Newton,2432,966,36,40,76,47.4%,1h
33337,2,Pushkar,2432,625,23,29,52,44.2%,1h
33337,1,Lofen,2432,540,18,12,30,60.0%,1h
33337,1,Master,2432,512,14,11,25,56.0%,26m
33337,3,TheBS,2432,359,13,16,29,44.8%,1h
33337,3,[FatKlD]inso,2432,237,8,6,14,57.1%,1h
33337,2,Babek,2432,143,5,8,13,38.5%,5m
33337,2,[Debil]Kinggg,2432,0,4,2,6,66.7%,6m
33337,3,AlkhasovUA,2432,147,4,3,7,57.1%,21m
33337,3,zieciuP,2432,116,4,7,11,36.4%,1h
33337,1,SandraKrause,2432,137,3,7,10,30.0%,14m
33337,3,EDGreaven,2432,0,2,2,4,50.0%,1h
33337,1,Yristark,2432,0,2,3,5,40.0%,14m
33337,1,Fawby,2432,38,2,4,6,33.3%,24m
33337,3,[Zhig]FED,2432,0,1,1,2,50.0%,1h
33337,1,MarSiv,2432,95,1,6,7,14.3%,5m
33337,1,[STVL]StivAle,2432,0,0,1,1,0.0%,1h
33337,1,damoaddin,2432,0,0,1,1,0.0%,1h
33337,3,Styx,2432,0,0,2,2,0.0%,3m
33337,3,[TedB]Veseluxa,2432,0,0,3,3,0.0%,16m
33337,1,[JnduGG]LookiDZ,2432,0,0,3,3,0.0%,1h
33337,1,Chames,2432,0,0,5,5,0.0%,28m
33337,1,UninstallPlz,2432,0,0,5,5,0.0%,21m
33369,3,Milkyway,2431,1554,206,192,398,51.8%,28m
33369,3,Romario,2431,1597,159,150,309,51.5%,25m
33369,3,beemo,2431,1229,73,65,138,52.9%,7m
33369,1,Morgoth,2431,1192,54,64,118,45.8%,1h
33369,3,Crow,2431,814,35,27,62,56.5%,1h
33369,3,[BSG19]Bazinga,2431,707,29,23,52,55.8%,1h
33369,3,flipang,2431,554,25,18,43,58.1%,20m
33369,3,Guardz,2431,313,16,15,31,51.6%,1h
33369,3,LanCuster,2431,288,11,12,23,47.8%,59m
33369,1,[DHYD]Priest,2431,364,10,4,14,71.4%,1h
33369,3,Romulus,2431,302,10,9,19,52.6%,1h
33369,1,TIM,2431,304,9,15,24,37.5%,1h
33369,3,BannedSCV,2431,200,8,10,18,44.4%,1h
33369,2,PlamIX,2431,30,5,4,9,55.6%,17m
33369,3,[SkBG]RMER,2431,137,4,6,10,40.0%,6m
33369,3,[Jürgen]ManuelW,2431,152,4,7,11,36.4%,1h
33369,1,Isrrak,2431,84,3,1,4,75.0%,1h
33369,3,EvAn,2431,145,3,3,6,50.0%,26m
33369,1,Detonator,2431,44,2,0,2,100.0%,1h
33369,3,Halvard,2431,95,2,1,3,66.7%,7m
33369,1,Sunnygirl,2431,44,2,1,3,66.7%,1h
33369,1,NiNeu,2431,0,2,3,5,40.0%,1h
33369,1,RashidJAN,2431,48,2,3,5,40.0%,1h
33369,1,ReBah,2431,0,2,3,5,40.0%,1h
33369,1,Guicciardini,2431,0,2,4,6,33.3%,21m
33369,1,dedkill,2431,0,1,4,5,20.0%,28m
33369,2,klinik,2431,0,0,1,1,0.0%,18m
33369,1,[Trasch]SorryBud,2431,0,0,1,1,0.0%,1h
33369,1,Markar,2431,0,0,1,1,0.0%,25m
33369,3,Noscoper,2431,0,0,2,2,0.0%,1h
33369,3,[antkr]lynx,2431,0,0,2,2,0.0%,3m
33400,3,DrLuke,2430,1556,165,152,317,52.1%,11m
33400,2,Huku,2430,1537,121,120,241,50.2%,1h
33400,2,typhontitan,2430,816,35,41,76,46.1%,17m
33400,2,Silent,2430,481,18,22,40,45.0%,1h
33400,3,Frank,2430,252,12,15,27,44.4%,1h
33400,1,DESOL,2430,339,11,4,15,73.3%,20m
33400,1,lllllllll,2430,380,11,15,26,42.3%,1h
33400,3,MaxBeast,2430,289,10,13,23,43.5%,1h
33400,1,[TAW]cantouchthis,2430,259,9,8,17,52.9%,1h
33400,3,Tamerlan,2430,214,7,5,12,58.3%,1h
33400,2,[ЗИБиАГ]SonorBodya,2430,191,6,10,16,37.5%,1h
33400,3,[L5A]EzworldII,2430,130,5,9,14,35.7%,1h
33400,3,bill,2430,144,4,7,11,36.4%,1h
33400,1,FlawlessFido,2430,0,2,5,7,28.6%,1h
33400,3,Hyperlighter,2430,119,2,5,7,28.6%,20m
33400,3,Noxxl,2430,0,2,5,7,28.6%,26m
33400,3,[NsAǂ]NsAǂTheWorld,2430,0,2,6,8,25.0%,1h
33400,3,Derpy,2430,30,1,3,4,25.0%,3m
33400,1,[LitCru]sergeEBURG,2430,0,1,4,5,20.0%,1h
33400,1,[BCHG]TaikusFinli,2430,0,1,4,5,20.0%,3m
33400,1,КиберСпорт,2430,0,1,4,5,20.0%,28m
33400,3,Kayan,2430,30,1,5,6,16.7%,28m
33400,3,Starkiller,2430,0,0,1,1,0.0%,1h
33400,3,mou,2430,0,0,2,2,0.0%,59m
33400,3,DOGGYSLEAZE,2430,0,0,3,3,0.0%,1h
33400,3,MADCAT,2430,0,0,3,3,0.0%,1h
33426,3,VVV,2429,1530,189,182,371,50.9%,3m
33426,2,[LIQUID]Roden,2429,1486,156,145,301,51.8%,5m
33426,2,[SPAINs]Agnos,2429,1418,64,53,117,54.7%,1h
33426,2,ElvisTek,2429,1169,48,49,97,49.5%,1h
33426,2,Paladinius,2429,676,45,41,86,52.3%,1h
33426,3,Stefan,2429,380,33,39,72,45.8%,11m
33426,3,Blender,2429,800,30,28,58,51.7%,11m
33426,2,DJsHIBBY,2429,830,28,36,64,43.8%,1h
33426,1,BazzaBaker,2429,753,24,19,43,55.8%,1h
33426,1,[eOXIDE]NERGUL,2429,720,24,19,43,55.8%,21m
33426,1,rom,2429,592,19,8,27,70.4%,24m
33426,1,wotter,2429,560,18,27,45,40.0%,6m
33426,3,nemsis,2429,486,17,19,36,47.2%,1h
33426,1,EgoriuZ,2429,457,12,12,24,50.0%,28m
33426,3,Lima,2429,353,12,13,25,48.0%,20m
33426,2,[3301]MrBooze,2429,315,11,14,25,44.0%,19m
33426,1,onoffon,2429,298,10,10,20,50.0%,1h
33426,3,Chaklun,2429,200,9,6,15,60.0%,1h
33426,1,IIIIIIIIIIII,2429,305,9,10,19,47.4%,1h
33426,1,Ztyxx,2429,178,8,14,22,36.4%,20m
33426,3,WIDOWMAKER,2429,144,3,2,5,60.0%,9m
33426,3,IIIIIIIIIIII,2429,130,3,5,8,37.5%,1h
33426,2,ideolog,2429,0,3,7,10,30.0%,1h
33426,2,Leckerchen,2429,107,2,3,5,40.0%,1h
33426,1,Hipplax,2429,48,2,5,7,28.6%,27m
33426,1,ShadowVoid,2429,0,1,1,2,50.0%,1h
33426,3,WINDERR,2429,0,1,1,2,50.0%,4m
33426,3,[Heroes]ToonDragon,2429,0,1,2,3,33.3%,9m
33426,1,[5vor12]Sentino,2429,0,0,1,1,0.0%,26m
33426,1,[MDTFBG]Pääät,2429,0,0,1,1,0.0%,10m
33426,1,kakaxa,2429,0,0,1,1,0.0%,1h
33426,1,Azure,2429,0,0,1,1,0.0%,17m
33426,3,Masi,2429,0,0,2,2,0.0%,24m
33426,3,GegenDenWind,2429,0,0,2,2,0.0%,1h
33426,3,Chehante,2429,0,0,3,3,0.0%,14m
33426,3,[CNC3]ifurr,2429,0,0,3,3,0.0%,9m
33462,2,vtmati,2428,1524,197,186,383,51.4%,21m
33462,3,Subaru,2428,1375,76,71,147,51.7%,6m
33462,3,unity,2428,1291,60,54,114,52.6%,1h
33462,3,Shtani,2428,1272,57,43,100,57.0%,6m
33462,3,[НОД17]eHoT,2428,882,48,41,89,53.9%,5m
33462,3,NoEffort,2428,870,41,38,79,51.9%,28m
33462,3,Farell,2428,938,31,45,76,40.8%,11m
33462,3,TakT,2428,828,30,29,59,50.8%,1h
33462,1,FERTOS,2428,452,14,3,17,82.4%,29m
33462,1,pomalaNca,2428,508,13,10,23,56.5%,16m
33462,2,dwwwwww,2428,342,13,17,30,43.3%,1h
33462,3,Mathibx,2428,324,11,9,20,55.0%,1h
33462,3,FapaThor,2428,294,10,9,19,52.6%,60m
33462,2,BloodMoon,2428,289,8,13,21,38.1%,1h
33462,1,Sìca,2428,215,7,5,12,58.3%,58m
33462,3,DragonSlayer,2428,146,4,2,6,66.7%,1h
33462,3,чувак,2428,129,4,5,9,44.4%,26m
33462,1,[топ4ик]Hommunkulus,2428,42,3,2,5,60.0%,11m
33462,1,Fraktisied,2428,48,3,4,7,42.9%,12m
33462,1,[LifeTV]MatteoZo,2428,0,2,3,5,40.0%,1h
33462,3,[G0UDA]nhutton,2428,121,2,4,6,33.3%,17m
33462,1,PetrKK,2428,44,2,4,6,33.3%,23m
33462,3,Kratos,2428,66,2,7,9,22.2%,7m
33462,2,deni,2428,42,2,7,9,22.2%,1h
33462,1,[LöK]KrazyKlown,2428,0,1,0,1,100.0%,1h
33462,1,Grantica,2428,0,1,4,5,20.0%,1h
33462,1,Marcolight,2428,0,1,4,5,20.0%,27m
33462,1,Hintennei,2428,0,1,4,5,20.0%,59m
33462,1,[ККП]kenseichmp,2428,0,0,1,1,0.0%,1h
33462,1,FazaDzika,2428,0,0,1,1,0.0%,1h
33462,1,[DTBMII]Vivacious,2428,0,0,1,1,0.0%,25m
33462,1,HDØ,2428,0,0,1,1,0.0%,29m
33462,3,[laugh]furious,2428,0,0,2,2,0.0%,5m
33462,3,Synbourne,2428,0,0,3,3,0.0%,1h
33462,1,Julemanden,2428,0,0,5,5,0.0%,4m
33497,3,LARGO,2427,1566,99,85,184,53.8%,24m
33497,3,[HZeS]JINGLEJANGLE,2427,1107,60,41,101,59.4%,1h
33497,3,[buyu]NoCivilWar,2427,827,30,24,54,55.6%,29m
33497,2,Deorg,2427,474,30,28,58,51.7%,26m
33497,3,[LAIROF]AndroiD,2427,688,26,22,48,54.2%,5m
33497,2,BlitzKrieG,2427,432,26,31,57,45.6%,1h
33497,3,[FMC8]NAVITEM,2427,417,15,13,28,53.6%,1h
33497,2,Vyrus,2427,458,15,27,42,35.7%,1h
33497,3,[HPBL]simonctnr,2427,317,13,11,24,54.2%,1h
33497,3,Rosen,2427,310,12,15,27,44.4%,14m
33497,3,Jørdmannson,2427,191,9,7,16,56.2%,59m
33497,2,sumrak,2427,293,9,7,16,56.2%,26m
33497,1,wipeOut,2427,294,8,2,10,80.0%,17m
33497,1,PikPok,2427,288,8,4,12,66.7%,18m
33497,1,SuicideFrog,2427,309,8,14,22,36.4%,8m
33497,1,[2day]SamusChamus,2427,292,7,7,14,50.0%,18m
33497,1,[DvX22]Bersagliere,2427,183,7,11,18,38.9%,28m
33497,2,[PsyDem]Manchou,2427,271,7,14,21,33.3%,17m
33497,3,GenJerome,2427,146,6,8,14,42.9%,19m
33497,3,Fantomstrike,2427,86,4,6,10,40.0%,9m
33497,1,Nooky,2427,157,4,7,11,36.4%,27m
33497,1,Поэт,2427,96,3,0,3,100.0%,1h
33497,1,Outsider,2427,0,3,2,5,60.0%,1h
33497,2,Bombenregen,2427,152,3,8,11,27.3%,1h
33497,3,Joapie,2427,0,1,1,2,50.0%,1h
33497,1,doson,2427,38,1,1,2,50.0%,1h
33497,1,good,2427,0,1,1,2,50.0%,60m
33497,1,Nephelim,2427,0,1,3,4,25.0%,59m
33497,1,[P3ND0R]Leon,2427,0,0,1,1,0.0%,1h
33497,3,John,2427,0,0,2,2,0.0%,1h
33497,3,BANSHEE,2427,0,0,2,2,0.0%,1h
33497,3,soare,2427,0,0,4,4,0.0%,1h
33529,3,tuchka,2426,1066,308,308,616,50.0%,15m
33529,3,NFO,2426,1569,177,179,356,49.7%,1h
33529,3,Macharius,2426,765,30,24,54,55.6%,1h
33529,1,zerg,2426,944,28,28,56,50.0%,1h
33529,1,Papir,2426,848,24,21,45,53.3%,22m
33529,3,Zalhfire,2426,560,21,24,45,46.7%,1h
33529,3,Robert,2426,415,16,18,34,47.1%,12m
33529,2,Moriarty,2426,452,14,24,38,36.8%,1h
33529,3,kirillko,2426,193,5,3,8,62.5%,59m
33529,2,Lodum,2426,173,5,6,11,45.5%,1h
33529,3,Khaelth,2426,175,5,9,14,35.7%,17m
33529,2,Ulrezaj,2426,131,4,4,8,50.0%,1h
33529,3,DrHoernchen,2426,120,4,8,12,33.3%,11m
33529,2,Neverend,2426,91,2,2,4,50.0%,11m
33529,3,DaniilReznov,2426,119,2,3,5,40.0%,1h
33529,3,BakteR,2426,0,2,4,6,33.3%,25m
33529,3,Nathan,2426,121,2,5,7,28.6%,15m
33529,3,ijitus,2426,30,2,5,7,28.6%,4m
33529,2,katkiukas,2426,0,2,5,7,28.6%,6m
33529,1,[КПCC]KOLAPIDR,2426,0,1,0,1,100.0%,1h
33529,1,Maengda,2426,42,1,2,3,33.3%,28m
33529,3,Fakidoki,2426,40,1,4,5,20.0%,1h
33529,1,Mayota,2426,0,1,4,5,20.0%,1h
33529,1,Creeping,2426,0,0,1,1,0.0%,1h
33529,3,Bloober,2426,0,0,2,2,0.0%,7m
33529,3,setygur,2426,0,0,2,2,0.0%,21m
33529,3,Rokoko,2426,0,0,4,4,0.0%,29m
33556,2,Kryos,2425,1493,115,113,228,50.4%,23m
33556,2,Fereg,2425,1462,102,102,204,50.0%,1h
33556,2,[jo]Beckxxx,2425,1499,98,100,198,49.5%,59m
33556,2,Вкусный,2425,1471,76,81,157,48.4%,11m
33556,3,[Grotte]Jonacid,2425,1456,74,62,136,54.4%,6m
33556,3,Matthewrud,2425,1377,74,83,157,47.1%,1h
33556,2,Notti,2425,920,58,56,114,50.9%,1h
33556,3,[SMSM]DanyTv,2425,373,56,46,102,54.9%,1h
33556,2,VanillaFace,2425,1147,42,43,85,49.4%,1h
33556,2,Thrawn,2425,920,41,33,74,55.4%,5m
33556,3,[VoGoNs]MrKukac,2425,862,30,34,64,46.9%,21m
33556,1,BUH,2425,619,19,9,28,67.9%,1h
33556,1,[NWGD]MirayGee,2425,418,12,6,18,66.7%,21m
33556,1,InOutLake,2425,172,5,7,12,41.7%,26m
33556,3,[WhPd]FunkeyMonkey,2425,172,5,9,14,35.7%,1h
33556,1,[mtl]meteorcrash,2425,170,4,3,7,57.1%,24m
33556,1,MARATILIUS,2425,132,3,1,4,75.0%,1h
33556,3,Wlolosha,2425,38,3,7,10,30.0%,1h
33556,3,Pyrokar,2425,145,3,8,11,27.3%,1h
33556,1,Sarkany,2425,0,2,3,5,40.0%,7m
33556,1,llllllllllll,2425,38,2,3,5,40.0%,1h
33556,3,Scar,2425,0,2,4,6,33.3%,21m
33556,3,[MiAzGa]IIIIIIII,2425,60,2,4,6,33.3%,7m
33556,2,kotxyenlet,2425,0,2,5,7,28.6%,58m
33556,2,XyLiGAniK,2425,0,2,8,10,20.0%,25m
33556,3,[RBadB]GoldenCat,2425,0,1,0,1,100.0%,12m
33556,3,malaka,2425,0,1,2,3,33.3%,1h
33556,1,Rodef,2425,0,0,1,1,0.0%,1h
33556,1,zergmus,2425,0,0,1,1,0.0%,1h
33556,1,AlleBalle,2425,0,0,2,2,0.0%,21m
33586,3,hamerhead,2424,1501,124,115,239,51.9%,9m
33586,3,petrovych,2424,1587,115,112,227,50.7%,16m
33586,3,SlaveEater,2424,1554,80,75,155,51.6%,6m
33586,3,Zero,2424,985,65,48,113,57.5%,1h
33586,2,London,2424,767,60,63,123,48.8%,1h
33586,1,Goriliol,2424,1283,46,56,102,45.1%,14m
33586,2,FINGERK,2424,1095,42,44,86,48.8%,21m
33586,1,[ПOHHИ]Serega,2424,1050,40,51,91,44.0%,1h
33586,1,partial,2424,887,34,29,63,54.0%,14m
33586,3,СockSxcker,2424,415,25,13,38,65.8%,1h
33586,2,[BN44]nieux,2424,624,21,30,51,41.2%,1h
33586,3,lojeck,2424,235,18,8,26,69.2%,1h
33586,3,maxformer,2424,397,16,12,28,57.1%,3m
33586,2,Lord,2424,440,15,21,36,41.7%,5m
33586,3,Uldun,2424,332,12,16,28,42.9%,1h
33586,1,trafalgar,2424,265,9,12,21,42.9%,1h
33586,2,[NW0]Avenger,2424,236,9,14,23,39.1%,6m
33586,1,ilya,2424,97,4,2,6,66.7%,14m
33586,3,elderscrolls,2424,58,3,3,6,50.0%,1h
33586,1,[YoiPop]DEN,2424,124,3,3,6,50.0%,1h
33586,3,KingJames,2424,30,3,6,9,33.3%,17m
33586,1,[Blacer]Ashlade,2424,42,2,0,2,100.0%,1h
33586,1,HarryB,2424,44,2,1,3,66.7%,1h
33586,1,RaDoN,2424,0,1,0,1,100.0%,1h
33586,1,[HRDS]Ozelot,2424,44,1,1,2,50.0%,18m
33586,3,asmasla,2424,0,1,1,2,50.0%,1h
33586,2,[IBIF]Pat,2424,0,1,2,3,33.3%,27m
33586,1,[KoxySC]Nightmere,2424,0,1,4,5,20.0%,60m
33586,1,[OnDack]MrSmile,2424,0,0,1,1,0.0%,1h
33586,1,DeDmopoЗ,2424,0,0,5,5,0.0%,5m
33616,1,ducky,2423,1542,289,290,579,49.9%,3m
33616,2,evalna,2423,1533,159,163,322,49.4%,1h
33616,3,coldstone,2423,1577,155,155,310,50.0%,12m
33616,1,Raff,2423,1419,141,137,278,50.7%,1h
33616,3,Steppenwolf,2423,1006,87,81,168,51.8%,21m
33616,1,Patan,2423,1494,70,85,155,45.2%,1h
33616,2,Judgement,2423,1572,69,77,146,47.3%,28m
33616,3,KINGKONG,2423,1332,51,61,112,45.5%,5m
33616,1,Frojdy,2423,954,30,23,53,56.6%,1h
33616,2,AlexPUA,2423,676,23,28,51,45.1%,1h
33616,3,Lluls,2423,572,22,17,39,56.4%,6m
33616,3,[0BO]Griselbrand,2423,532,21,17,38,55.3%,1h
33616,1,ERGIN,2423,552,17,13,30,56.7%,60m
33616,3,Betaninha,2423,184,10,11,21,47.6%,1h
33616,3,lllMDlll,2423,214,6,6,12,50.0%,1h
33616,3,yuugen,2423,118,5,8,13,38.5%,16m
33616,1,Martin,2423,97,4,2,6,66.7%,1h
33616,2,ZloiNinja,2423,60,4,7,11,36.4%,1h
33616,3,drapishka,2423,118,3,2,5,60.0%,1h
33616,3,Gordo,2423,66,3,4,7,42.9%,1h
33616,1,[TNZC]socca,2423,84,3,5,8,37.5%,1h
33616,1,Payasson,2423,115,3,10,13,23.1%,1h
33616,1,Ratazey,2423,30,2,1,3,66.7%,1h
33616,1,[QaDo]WARPOZ,2423,44,2,2,4,50.0%,1h
33616,2,IonLionZion,2423,0,2,5,7,28.6%,1h
33616,3,DaB,2423,0,1,1,2,50.0%,1h
33616,3,cavo,2423,0,1,1,2,50.0%,1h
33616,3,retroCZ,2423,0,1,1,2,50.0%,1h
33616,1,ClikMan,2423,0,1,4,5,20.0%,1h
33616,1,ElOso,2423,0,1,4,5,20.0%,1h
33616,3,Marshmello,2423,0,1,5,6,16.7%,1h
33616,1,[Tblue]Mateboer,2423,0,0,1,1,0.0%,1h
33616,1,Automorf,2423,0,0,1,1,0.0%,1h
33616,1,RitalBanal,2423,0,0,1,1,0.0%,1h
33616,3,Hozogg,2423,0,0,2,2,0.0%,15m
33616,3,REKT,2423,0,0,2,2,0.0%,3m
33616,3,[ProAwe]sajid,2423,0,0,3,3,0.0%,60m
33616,3,Nikariam,2423,0,0,3,3,0.0%,1h
33654,2,HuHaHanZ,2422,1536,175,172,347,50.4%,1h
33654,1,JadedBonobo,2422,1668,69,59,128,53.9%,1h
33654,3,ElSupeee,2422,1249,62,51,113,54.9%,15m
33654,2,AVANZ,2422,1397,60,61,121,49.6%,1h
33654,3,xavier,2422,680,59,42,101,58.4%,28m
33654,3,MrWhite,2422,1100,47,47,94,50.0%,1h
33654,3,willy,2422,833,35,28,63,55.6%,1h
33654,3,universe,2422,867,34,35,69,49.3%,25m
33654,3,Zoloman,2422,791,30,28,58,51.7%,1h
33654,3,drumcode,2422,625,23,19,42,54.8%,1h
33654,3,FREE,2422,531,19,17,36,52.8%,29m
33654,1,Namor,2422,606,16,12,28,57.1%,28m
33654,2,Snorky,2422,425,16,23,39,41.0%,28m
33654,3,GukiKOkd,2422,319,13,5,18,72.2%,12m
33654,3,Marles,2422,291,12,14,26,46.2%,29m
33654,1,[FMU]PROROKson,2422,308,10,1,11,90.9%,1h
33654,2,AirBorne,2422,262,9,11,20,45.0%,1h
33654,1,MiniWitti,2422,325,9,16,25,36.0%,1h
33654,2,[KiII]Shata,2422,216,7,3,10,70.0%,1h
33654,3,Timi,2422,149,7,8,15,46.7%,1h
33654,2,[AKD2]AKDHeimschei,2422,58,5,10,15,33.3%,26m
33654,3,Schwaben,2422,173,4,9,13,30.8%,4m
33654,1,[Elva]Luna,2422,84,3,0,3,100.0%,26m
33654,1,StlnSixNine,2422,99,3,0,3,100.0%,1h
33654,3,TyrKhan,2422,120,3,4,7,42.9%,12m
33654,1,Ionic,2422,48,3,6,9,33.3%,27m
33654,3,KimKardashyn,2422,95,2,1,3,66.7%,1h
33654,2,[утка]миша,2422,128,2,3,5,40.0%,1h
33654,3,CubiS,2422,32,2,8,10,20.0%,24m
33654,3,Водомер,2422,96,1,2,3,33.3%,1h
33654,3,FERTOS,2422,96,1,3,4,25.0%,24m
33654,1,udi,2422,0,1,4,5,20.0%,1h
33654,1,Shamil,2422,0,1,4,5,20.0%,10m
33654,1,Pafnutiy,2422,0,1,4,5,20.0%,10m
33654,1,pissji,2422,0,0,1,1,0.0%,26m
33654,1,Monolit,2422,0,0,1,1,0.0%,1h
33654,3,Deadnis,2422,0,0,4,4,0.0%,1h
33691,2,ТвояМамка,2421,997,296,311,607,48.8%,24m
33691,3,Kwoter,2421,1577,152,148,300,50.7%,4m
33691,3,Recio,2421,1465,106,105,211,50.2%,59m
33691,3,kcoclemac,2421,936,48,44,92,52.2%,25m
33691,3,[FukJap]TGP,2421,1100,44,43,87,50.6%,1h
33691,2,[WАSD]SimulacraTos,2421,745,29,25,54,53.7%,1h
33691,1,Abalone,2421,700,26,36,62,41.9%,29m
33691,1,Raider,2421,757,23,23,46,50.0%,60m
33691,3,Lulu,2421,560,21,23,44,47.7%,1h
33691,3,Bobacus,2421,547,18,23,41,43.9%,9m
33691,3,[Kant]Monpower,2421,469,16,15,31,51.6%,60m
33691,3,Андрейка,2421,321,12,9,21,57.1%,24m
33691,1,ПЕРВОПРЕДОК,2421,324,12,16,28,42.9%,6m
33691,1,Benzitler,2421,268,11,17,28,39.3%,1h
33691,3,Clausewitz,2421,303,9,10,19,47.4%,19m
33691,2,BatmanQB,2421,322,8,18,26,30.8%,59m
33691,3,Säthan,2421,213,7,4,11,63.6%,1h
33691,1,Mtechnology,2421,298,7,8,15,46.7%,1h
33691,1,Thieums,2421,0,4,1,5,80.0%,13m
33691,1,фоб,2421,30,3,5,8,37.5%,1h
33691,3,[132]PHOENIX,2421,96,2,1,3,66.7%,29m
33691,3,valshmel,2421,30,2,3,5,40.0%,7m
33691,3,Adrian,2421,0,2,4,6,33.3%,4m
33691,3,Kvinto,2421,95,1,2,3,33.3%,1h
33691,1,kuznec,2421,0,1,4,5,20.0%,21m
33691,3,Stan,2421,30,1,5,6,16.7%,20m
33691,1,[XNoob]SilverWings,2421,0,0,1,1,0.0%,16m
33691,1,StormVoid,2421,0,0,1,1,0.0%,1h
33691,1,троль,2421,0,0,2,2,0.0%,1h
33691,1,anemerk,2421,0,0,3,3,0.0%,1h
33691,1,[ASRLAP]LRSAD,2421,0,0,12,12,0.0%,27m
33722,1,sefsef,2420,1545,118,124,242,48.8%,1h
33722,1,GOBSEK,2420,1580,83,94,177,46.9%,1h
33722,3,bumer,2420,762,66,75,141,46.8%,3m
33722,2,Helbaal,2420,1510,60,59,119,50.4%,12m
33722,3,TumanZ,2420,948,40,36,76,52.6%,12m
33722,3,MäxPower,2420,918,35,36,71,49.3%,1h
33722,2,[RBMK]Fernando,2420,930,32,41,73,43.8%,1h
33722,3,Ainatar,2420,497,19,23,42,45.2%,3m
33722,1,Копченый,2420,632,18,13,31,58.1%,1h
33722,3,Daroude,2420,422,16,25,41,39.0%,29m
33722,3,Soultaker,2420,212,13,13,26,50.0%,11m
33722,3,[BRС]ROACH,2420,322,12,15,27,44.4%,25m
33722,3,[ZappaZ]JimiHendrix,2420,307,10,11,21,47.6%,20m
33722,3,[Tостер]KzFantomKz,2420,251,8,6,14,57.1%,29m
33722,3,[IceHus]КоролеваРоя,2420,204,8,9,17,47.1%,19m
33722,2,Gula,2420,244,8,15,23,34.8%,1h
33722,2,[lUEDl]Lixe,2420,190,7,14,21,33.3%,1h
33722,1,Alexxx,2420,210,6,3,9,66.7%,5m
33722,2,PGuijarroV,2420,184,6,10,16,37.5%,1h
33722,1,Light,2420,48,5,3,8,62.5%,1h
33722,2,ShinichiT,2420,173,5,10,15,33.3%,1h
33722,3,Ybyn,2420,60,3,3,6,50.0%,1h
33722,3,Tarantul,2420,142,3,5,8,37.5%,26m
33722,2,KuroFox,2420,38,2,1,3,66.7%,29m
33722,3,Prosper,2420,95,2,2,4,50.0%,16m
33722,3,BigEZ,2420,30,2,6,8,25.0%,1h
33722,1,Sacredik,2420,0,1,0,1,100.0%,25m
33722,3,[Taruv]DarkDevil,2420,0,1,0,1,100.0%,1h
33722,2,Wasilich,2420,38,1,1,2,50.0%,21m
33722,1,ArkturMengsk,2420,48,1,1,2,50.0%,1h
33722,1,Lelouch,2420,0,1,4,5,20.0%,28m
33722,3,Iwan,2420,0,1,4,5,20.0%,7m
33722,3,[БУТЕР1]Gabella,2420,30,1,5,6,16.7%,59m
33722,1,Marschall,2420,0,0,1,1,0.0%,60m
33722,1,WallaS,2420,0,0,1,1,0.0%,18m
33722,3,LightElfTank,2420,0,0,2,2,0.0%,14m
33722,3,MaJorRU,2420,0,0,3,3,0.0%,3m
33722,3,abcde,2420,0,0,3,3,0.0%,1h
33760,2,arlecchino,2419,1612,148,158,306,48.4%,28m
33760,2,marcus,2419,1128,84,91,175,48.0%,1h
33760,1,MTi,2419,990,29,30,59,49.2%,27m
33760,3,Demppis,2419,348,22,15,37,59.5%,24m
33760,2,arzack,2419,544,19,26,45,42.2%,1h
33760,2,Mongo,2419,358,13,12,25,52.0%,1h
33760,3,totoman,2419,282,10,14,24,41.7%,15m
33760,2,DorytФ,2419,264,9,7,16,56.2%,1h
33760,3,Death,2419,234,9,10,19,47.4%,59m
33760,1,[Harley]Nelate,2419,278,7,1,8,87.5%,25m
33760,3,Hitler,2419,118,7,11,18,38.9%,8m
33760,3,chery,2419,145,6,4,10,60.0%,11m
33760,3,Ippokanthars,2419,168,6,14,20,30.0%,21m
33760,3,dorik,2419,146,5,6,11,45.5%,1h
33760,1,Durlug,2419,94,5,9,14,35.7%,1h
33760,3,PatBalkany,2419,146,5,10,15,33.3%,1h
33760,1,Turan,2419,130,4,2,6,66.7%,24m
33760,1,Jktulord,2419,132,4,2,6,66.7%,19m
33760,2,owner,2419,122,4,8,12,33.3%,24m
33760,3,Luktim,2419,62,3,4,7,42.9%,12m
33760,1,NocRyceszTer,2419,120,3,4,7,42.9%,28m
33760,1,SuckMyHuge,2419,44,2,0,2,100.0%,1h
33760,1,Karpfen,2419,90,2,3,5,40.0%,28m
33760,1,kamoonx,2419,0,2,4,6,33.3%,1h
33760,1,edgarcrack,2419,96,2,4,6,33.3%,1h
33760,2,oscar,2419,58,2,7,9,22.2%,22m
33760,1,[McWeed]hoot,2419,0,1,0,1,100.0%,3m
33760,1,[boiko]soldierbg,2419,0,1,0,1,100.0%,16m
33760,3,Demon,2419,96,1,3,4,25.0%,25m
33760,3,Lerhish,2419,95,1,3,4,25.0%,1h
33760,1,DeathNick,2419,0,1,4,5,20.0%,1h
33760,1,Yvesvzla,2419,0,1,4,5,20.0%,1h
33760,1,SEZUS,2419,0,1,4,5,20.0%,1h
33760,1,lebensraum,2419,0,1,4,5,20.0%,26m
33760,3,[PEKLO]Traged,2419,30,1,5,6,16.7%,28m
33760,3,Jim,2419,0,1,5,6,16.7%,1h
33760,1,[voodtr]XeForcex,2419,0,0,1,1,0.0%,1h
33797,3,Ashkeef,2418,1575,173,170,343,50.4%,29m
33797,3,[PiGPan]CJV,2418,235,58,39,97,59.8%,1h
33797,3,MirrorMan,2418,864,58,59,117,49.6%,1h
33797,2,Nerevarin,2418,1275,53,52,105,50.5%,1h
33797,3,MatThomSA,2418,1035,44,41,85,51.8%,3m
33797,3,Beast,2418,1004,39,43,82,47.6%,29m
33797,1,DuCharles,2418,1122,35,33,68,51.5%,1h
33797,3,ZeenDR,2418,712,31,36,67,46.3%,1h
33797,2,[Gоld]Samara,2418,740,30,27,57,52.6%,1h
33797,2,Stian,2418,599,25,27,52,48.1%,28m
33797,3,Kamikazykid,2418,527,20,19,39,51.3%,28m
33797,2,[RZMS]IntroductiO,2418,513,19,22,41,46.3%,1h
33797,1,palact,2418,543,16,20,36,44.4%,14m
33797,3,[chaton]Gap,2418,342,15,19,34,44.1%,13m
33797,3,Serejenka,2418,327,12,6,18,66.7%,1h
33797,2,aneAngel,2418,176,12,9,21,57.1%,16m
33797,1,SpanierDev,2418,410,11,2,13,84.6%,60m
33797,3,[Od1n]GeTuAbuser,2418,179,10,7,17,58.8%,1h
33797,3,Senu,2418,145,5,5,10,50.0%,1h
33797,2,[FCSMRW]Lion,2418,198,5,7,12,41.7%,1h
33797,3,deathmode,2418,58,4,5,9,44.4%,9m
33797,2,guzma,2418,62,4,8,12,33.3%,3m
33797,1,Array,2418,86,3,0,3,100.0%,20m
33797,1,Philox,2418,0,3,2,5,60.0%,1h
33797,3,OldBaldBallz,2418,113,3,5,8,37.5%,11m
33797,2,gunner,2418,94,3,7,10,30.0%,6m
33797,2,[WITCHs]Muckitos,2418,94,3,12,15,20.0%,1h
33797,1,mrCapMor,2418,44,2,1,3,66.7%,1h
33797,2,SuperIceRat,2418,88,2,7,9,22.2%,1h
33797,1,Maksimka,2418,0,1,0,1,100.0%,1h
33797,1,macen,2418,0,1,4,5,20.0%,29m
33797,3,Temuch,2418,30,1,5,6,16.7%,1h
33797,1,ScarneX,2418,0,0,1,1,0.0%,8m
33797,1,Zkill,2418,0,0,1,1,0.0%,1h
33797,1,vorterus,2418,0,0,4,4,0.0%,59m
33832,1,[НОД17]Delonge,2417,1661,83,82,165,50.3%,1h
33832,3,ArrrrC,2417,817,62,48,110,56.4%,28m
33832,3,Ralin,2417,629,56,52,108,51.9%,8m
33832,1,[cwars]Resakh,2417,268,54,67,121,44.6%,14m
33832,3,Overloved,2417,986,41,42,83,49.4%,19m
33832,3,FEGY,2417,588,23,25,48,47.9%,7m
33832,3,[Nothin]DarkFoxsk,2417,540,20,18,38,52.6%,3m
33832,3,[11121]JimmyJoe,2417,404,16,15,31,51.6%,1h
33832,1,Felikovsky,2417,434,16,19,35,45.7%,14m
33832,1,[NEONK]FraDiavolo,2417,411,12,4,16,75.0%,20m
33832,1,МрАкОбеС,2417,337,11,5,16,68.8%,14m
33832,1,Nullafides,2417,300,10,5,15,66.7%,1h
33832,3,DonMimimi,2417,202,8,9,17,47.1%,1h
33832,1,Kaje,2417,212,5,4,9,55.6%,24m
33832,1,RigilKent,2417,147,5,6,11,45.5%,24m
33832,3,[hf4X4]Alew,2417,30,5,7,12,41.7%,26m
33832,3,[llMFll]DJRob,2417,146,4,4,8,50.0%,1h
33832,1,HotkeyKing,2417,185,4,6,10,40.0%,1h
33832,1,[C2E]Edweed,2417,100,4,8,12,33.3%,22m
33832,1,ARTANIS,2417,0,3,1,4,75.0%,1h
33832,1,[GoTerr]QuirkyTurtle,2417,130,3,3,6,50.0%,19m
33832,3,humvee,2417,148,3,5,8,37.5%,21m
33832,3,Domestos,2417,62,3,6,9,33.3%,1h
33832,3,KURGAN,2417,58,2,5,7,28.6%,1h
33832,1,Vovander,2417,0,1,0,1,100.0%,14m
33832,1,Untake,2417,0,1,0,1,100.0%,27m
33832,1,Attu,2417,0,1,4,5,20.0%,28m
33832,3,adem,2417,0,1,7,8,12.5%,1h
33832,1,plusspeed,2417,0,0,1,1,0.0%,1h
33832,1,ZxZ,2417,0,0,1,1,0.0%,4m
33832,1,MatCar,2417,0,0,1,1,0.0%,59m
33832,1,Sergent,2417,0,0,2,2,0.0%,1h
33864,3,Jarek,2416,1475,108,109,217,49.8%,1h
33864,1,Makina,2416,1383,100,102,202,49.5%,6m
33864,3,darkphoenix,2416,1046,68,64,132,51.5%,1h
33864,3,Panasratic,2416,837,62,55,117,53.0%,28m
33864,3,[BRPD]HitPlicT,2416,1186,48,47,95,50.5%,14m
33864,3,Diesel,2416,985,41,41,82,50.0%,16m
33864,1,[Hаsu]Lapki,2416,1146,40,51,91,44.0%,1h
33864,3,Eltchou,2416,558,19,22,41,46.3%,19m
33864,2,ActiveDK,2416,520,19,28,47,40.4%,1h
33864,3,[RBMS]Fenrir,2416,440,15,17,32,46.9%,14m
33864,1,SirVival,2416,330,12,25,37,32.4%,15m
33864,3,Микола,2416,211,9,6,15,60.0%,6m
33864,2,Madorro,2416,202,6,11,17,35.3%,1h
33864,1,[elCrab]ЯaТaмahaтТa,2416,0,5,0,5,100.0%,27m
33864,3,LcShadow,2416,95,5,2,7,71.4%,6m
33864,2,SamGamesCz,2416,181,5,3,8,62.5%,1h
33864,1,cabinetul,2416,44,4,2,6,66.7%,16m
33864,1,Tazforpres,2416,207,4,3,7,57.1%,1h
33864,1,Cryogenic,2416,132,3,3,6,50.0%,28m
33864,1,Heroegg,2416,97,2,5,7,28.6%,1h
33864,1,charly,2416,0,1,0,1,100.0%,1h
33864,1,Azr,2416,0,1,1,2,50.0%,1h
33864,1,[Ultm]TXK,2416,42,1,2,3,33.3%,1h
33864,1,DeusRa,2416,89,1,2,3,33.3%,16m
33864,3,Ares,2416,48,1,3,4,25.0%,9m
33864,1,Zoro,2416,0,1,4,5,20.0%,1h
33864,1,Nio,2416,0,0,2,2,0.0%,1h
33864,3,[CROCHI]Drochi,2416,0,0,4,4,0.0%,24m
33892,1,fanpic,2415,1869,104,103,207,50.2%,1h
33892,3,kaptajnkalle,2415,1359,95,97,192,49.5%,8m
33892,1,GARY,2415,1845,84,70,154,54.5%,28m
33892,2,SirCezar,2415,1230,77,80,157,49.0%,1h
33892,3,MrFishman,2415,818,33,35,68,48.5%,22m
33892,1,BryHimSelf,2415,382,16,25,41,39.0%,10m
33892,1,[Hakate]Phonemix,2415,426,15,10,25,60.0%,1h
33892,3,ParrisHilton,2415,390,15,20,35,42.9%,7m
33892,2,Palkid,2415,434,14,26,40,35.0%,1h
33892,2,Kunglosman,2415,226,8,12,20,40.0%,6m
33892,3,Alshain,2415,219,7,6,13,53.8%,21m
33892,3,Öööö,2415,206,6,10,16,37.5%,26m
33892,3,Chudik,2415,117,3,2,5,60.0%,24m
33892,1,[Batia]JIoбoToMuT,2415,44,2,0,2,100.0%,20m
33892,1,driss,2415,46,2,1,3,66.7%,1h
33892,1,novaky,2415,0,2,3,5,40.0%,1h
33892,3,[улей55]WolfCub,2415,90,2,3,5,40.0%,29m
33892,1,wert,2415,48,2,5,7,28.6%,28m
33892,3,tamtams,2415,95,2,5,7,28.6%,1h
33892,1,Antorsom,2415,0,1,0,1,100.0%,59m
33892,1,Zayd,2415,0,1,1,2,50.0%,24m
33892,1,Odin,2415,0,1,1,2,50.0%,20m
33892,1,[ЕGО]Dementro,2415,0,1,1,2,50.0%,1h
33892,1,[ToWaSt]Assazhi,2415,0,1,2,3,33.3%,1h
33892,3,Chams,2415,36,1,4,5,20.0%,1h
33892,1,[TOPER]marribas,2415,0,1,4,5,20.0%,1h
33892,1,soDa,2415,0,1,4,5,20.0%,10m
33892,1,Svinny,2415,0,1,4,5,20.0%,1h
33892,3,soroushholo,2415,30,1,5,6,16.7%,1h
33892,1,[NeCriN]Shigi,2415,0,0,1,1,0.0%,20m
33892,1,[Snаkеs]SaltSnake,2415,0,0,1,1,0.0%,28m
33892,3,Antonyk,2415,0,0,1,1,0.0%,1h
33892,3,atapidriver,2415,0,0,2,2,0.0%,26m
33892,3,[PROTV]pidorok,2415,0,0,2,2,0.0%,8m
33892,1,Gain,2415,0,0,2,2,0.0%,19m
33892,1,Koldy,2415,0,0,2,2,0.0%,1h
33892,3,[MCat]Alex,2415,0,0,2,2,0.0%,14m
33892,1,MatveiZver,2415,0,0,3,3,0.0%,6m
33892,3,WindMind,2415,0,0,5,5,0.0%,29m
33931,3,[Zbój]Majkutini,2414,929,40,34,74,54.1%,24m
33931,3,underdog,2414,617,29,21,50,58.0%,1h
33931,3,Noobman,2414,620,26,19,45,57.8%,26m
33931,1,kalt,2414,512,21,3,24,87.5%,6m
33931,1,Yulloa,2414,552,15,11,26,57.7%,10m
33931,1,REDIR,2414,301,11,12,23,47.8%,1h
33931,2,Terzatel,2414,300,11,19,30,36.7%,27m
33931,1,MaxiKing,2414,330,9,8,17,52.9%,16m
33931,2,[123212]кирилл,2414,119,6,6,12,50.0%,27m
33931,1,Litosh,2414,122,6,9,15,40.0%,10m
33931,3,XRayD,2414,30,5,3,8,62.5%,1h
33931,2,pepece,2414,197,5,5,10,50.0%,22m
33931,3,[TFR]Asaldaric,2414,173,5,8,13,38.5%,20m
33931,1,masso,2414,106,5,10,15,33.3%,1h
33931,1,[EeBeBe]Mikhail,2414,42,3,4,7,42.9%,21m
33931,3,korably,2414,92,3,8,11,27.3%,20m
33931,1,Blindar,2414,44,2,1,3,66.7%,19m
33931,1,PsychDeer,2414,44,2,1,3,66.7%,1h
33931,2,[Xpl0dE]vitez,2414,90,2,2,4,50.0%,1h
33931,1,OmNomRarg,2414,48,2,4,6,33.3%,19m
33931,1,Nomak,2414,44,1,2,3,33.3%,1h
33931,3,SaintieL,2414,0,1,2,3,33.3%,1h
33931,1,BadboyVLG,2414,97,1,3,4,25.0%,26m
33931,1,Bulborg,2414,0,1,4,5,20.0%,25m
33931,1,MrNobody,2414,0,1,4,5,20.0%,6m
33931,1,Ptidel,2414,0,0,1,1,0.0%,1h
33931,1,kupso,2414,0,0,1,1,0.0%,1h
33931,2,Данияр,2414,0,0,1,1,0.0%,1h
33931,1,ванёк,2414,0,0,2,2,0.0%,1h
33931,3,[BBXT]Azuvaal,2414,0,0,2,2,0.0%,6m
33931,3,[hexOr]насоксудьбы,2414,0,0,4,4,0.0%,28m
33931,3,sergo,2414,0,0,4,4,0.0%,7m
33931,1,GitHburn,2414,0,0,6,6,0.0%,1h
33964,3,jujufighter,2413,487,68,54,122,55.7%,29m
33964,2,gegoran,2413,574,19,28,47,40.4%,1h
33964,1,MrPrO,2413,570,15,16,31,48.4%,1h
33964,1,DiletantBuch,2413,508,14,13,27,51.9%,1h
33964,3,Grim,2413,204,6,6,12,50.0%,11m
33964,1,[CeGeTe]UnKnown,2413,229,6,6,12,50.0%,1h
33964,1,LiquidAdri,2413,262,6,6,12,50.0%,1h
33964,1,Sckøør,2413,96,5,4,9,55.6%,1h
33964,1,Kowalski,2413,170,5,5,10,50.0%,1h
33964,3,Sammlerjosh,2413,145,4,3,7,57.1%,1h
33964,3,TheManOskar,2413,0,4,4,8,50.0%,3m
33964,2,[Mañas]Espatha,2413,72,4,7,11,36.4%,1h
33964,1,Lamko,2413,203,4,10,14,28.6%,1h
33964,2,Auswahlliste,2413,60,3,10,13,23.1%,14m
33964,2,Ктулху,2413,98,3,11,14,21.4%,1h
33964,1,Albertmorder,2413,0,1,0,1,100.0%,23m
33964,1,Nosfer,2413,44,1,1,2,50.0%,1h
33964,3,[NINDUD]JayHage,2413,0,1,3,4,25.0%,1h
33964,1,Tork,2413,0,1,4,5,20.0%,1h
33964,1,BARTSTERBOY,2413,0,1,4,5,20.0%,59m
33964,2,GoatPuncher,2413,0,1,10,11,9.1%,9m
33964,1,[SovC]Gathering,2413,0,0,1,1,0.0%,1h
33964,1,Kuzmich,2413,0,0,1,1,0.0%,59m
33964,1,KiithTeron,2413,0,0,1,1,0.0%,11m
33964,2,DonalTrump,2413,0,0,2,2,0.0%,9m
33989,2,Пан,2412,1447,192,186,378,50.8%,21m
33989,1,[БАЗА45]колян,2412,1368,86,94,180,47.8%,12m
33989,2,Ghost,2412,1508,65,73,138,47.1%,1h
33989,2,sVarog,2412,1244,59,58,117,50.4%,5m
33989,3,FrostyDog,2412,962,44,31,75,58.7%,1h
33989,1,Jackal,2412,983,40,11,51,78.4%,1h
33989,3,Gelos,2412,859,35,27,62,56.5%,29m
33989,1,RoYaL,2412,787,32,24,56,57.1%,1h
33989,3,MissingLink,2412,443,19,14,33,57.6%,5m
33989,1,рнк,2412,489,19,25,44,43.2%,1h
33989,1,Zerbekes,2412,464,14,5,19,73.7%,27m
33989,1,Phantom,2412,264,10,6,16,62.5%,60m
33989,3,Potowy,2412,301,10,8,18,55.6%,1h
33989,1,[TLDN]kinder,2412,318,9,2,11,81.8%,1h
33989,2,Pissmypantsu,2412,218,9,10,19,47.4%,12m
33989,1,XedOsS,2412,253,8,14,22,36.4%,1h
33989,1,kev,2412,250,7,6,13,53.8%,29m
33989,3,Chainik,2412,172,6,4,10,60.0%,24m
33989,1,JOSÉ,2412,140,6,11,17,35.3%,23m
33989,2,Tandow,2412,99,5,7,12,41.7%,1h
33989,3,DsTAmarok,2412,106,5,9,14,35.7%,1h
33989,3,Иван,2412,141,4,6,10,40.0%,15m
33989,3,Ремесленник,2412,58,3,8,11,27.3%,20m
33989,1,bloodlestat,2412,44,2,0,2,100.0%,1h
33989,1,Tibone,2412,93,2,2,4,50.0%,1h
33989,1,Fobostar,2412,97,2,2,4,50.0%,1h
33989,1,Baituri,2412,97,2,3,5,40.0%,13m
33989,1,PPP,2412,97,2,5,7,28.6%,7m
33989,2,[YouGay]MrTwister,2412,121,2,7,9,22.2%,1h
33989,1,Snovvee,2412,0,1,0,1,100.0%,27m
33989,1,salomon,2412,46,1,2,3,33.3%,1h
33989,3,Artem,2412,94,1,2,3,33.3%,1h
33989,1,Haazh,2412,0,1,4,5,20.0%,60m
33989,1,[714]Alex,2412,0,0,2,2,0.0%,1h
33989,3,Wtonilveg,2412,0,0,3,3,0.0%,1h
33989,3,[Hybrid]Boboklatttt,2412,0,0,4,4,0.0%,14m
34025,3,Donuts,2411,1530,216,213,429,50.3%,1h
34025,3,Nighthawk,2411,1564,61,58,119,51.3%,1h
34025,1,captainchaos,2411,802,58,55,113,51.3%,6m
34025,3,[Аоуэйя]zajebioza,2411,1269,50,47,97,51.5%,14m
34025,2,Kyron,2411,808,34,44,78,43.6%,26m
34025,3,efro,2411,360,18,12,30,60.0%,1h
34025,3,Bahlanth,2411,246,15,13,28,53.6%,12m
34025,3,TwoPizza,2411,311,15,15,30,50.0%,4m
34025,3,DanSport,2411,406,15,18,33,45.5%,59m
34025,2,[KNUS]SnowMan,2411,278,11,5,16,68.8%,1h
34025,2,Zinjo,2411,258,11,16,27,40.7%,10m
34025,3,Venetica,2411,352,11,18,29,37.9%,1h
34025,3,Nightmare,2411,234,10,11,21,47.6%,1h
34025,2,KagaNova,2411,266,10,16,26,38.5%,1h
34025,1,mario,2411,321,9,12,21,42.9%,1h
34025,1,Fireenfer,2411,216,9,13,22,40.9%,1h
34025,3,[EXOS]Kgeri,2411,224,6,6,12,50.0%,28m
34025,3,Maanesyume,2411,119,5,4,9,55.6%,18m
34025,3,FrostsBite,2411,124,5,4,9,55.6%,1h
34025,3,[2iq]XUI,2411,191,5,6,11,45.5%,1h
34025,1,Gniewosz,2411,132,4,0,4,100.0%,29m
34025,1,Fedor,2411,126,4,1,5,80.0%,20m
34025,3,[Arrows]GOLDY,2411,168,4,2,6,66.7%,1h
34025,3,Rocinante,2411,86,4,4,8,50.0%,1h
34025,3,PhillyJilly,2411,138,4,6,10,40.0%,1h
34025,3,Altaran,2411,118,4,8,12,33.3%,6m
34025,3,sanna,2411,86,4,8,12,33.3%,1h
34025,2,IIIIIIIIIIII,2411,114,4,13,17,23.5%,1h
34025,3,Slavomír,2411,0,2,4,6,33.3%,14m
34025,3,QuanDam,2411,0,2,4,6,33.3%,1h
34025,1,Caradhras,2411,42,2,5,7,28.6%,26m
34025,1,Discobär,2411,0,1,0,1,100.0%,1h
34025,1,DuDValerka,2411,0,1,1,2,50.0%,1h
34025,1,EpickiTrol,2411,0,1,4,5,20.0%,7m
34025,1,Dante,2411,0,1,4,5,20.0%,7m
34025,3,Rust,2411,30,1,4,5,20.0%,11m
34025,1,mueninja,2411,0,1,4,5,20.0%,1h
34025,1,loci,2411,0,1,4,5,20.0%,26m
34025,1,DoReMe,2411,0,0,1,1,0.0%,1h
34025,1,AgentKingsma,2411,0,0,1,1,0.0%,1h
34025,3,TodesJoker,2411,0,0,2,2,0.0%,4m
34025,1,OptimusPrime,2411,73,0,4,4,0.0%,11m
34067,2,[Raa]Palladium,2410,1567,144,149,293,49.1%,1h
34067,3,Rooster,2410,1487,113,111,224,50.4%,9m
34067,3,anfaini,2410,1366,99,85,184,53.8%,3m
34067,3,[OLT]GENGIU,2410,675,37,32,69,53.6%,29m
34067,3,Dyb,2410,953,36,36,72,50.0%,1h
34067,2,Patécroute,2410,784,31,43,74,41.9%,1h
34067,3,Goodman,2410,235,26,33,59,44.1%,11m
34067,2,apocc,2410,374,15,16,31,48.4%,1h
34067,3,Yacon,2410,390,14,17,31,45.2%,1h
34067,3,Coldblood,2410,313,10,8,18,55.6%,16m
34067,2,knyzmishgan,2410,349,10,18,28,35.7%,1h
34067,3,Evil,2410,182,6,9,15,40.0%,1h
34067,3,NUNU,2410,185,5,5,10,50.0%,1h
34067,3,prdx,2410,171,5,5,10,50.0%,5m
34067,1,Opalq,2410,128,4,1,5,80.0%,1h
34067,3,[FAR2]vodius,2410,169,4,4,8,50.0%,1h
34067,1,thessail,2410,143,4,5,9,44.4%,22m
34067,3,exploit,2410,60,3,4,7,42.9%,12m
34067,3,Paxton,2410,97,2,0,2,100.0%,1h
34067,3,MERCEDES,2410,60,2,4,6,33.3%,1h
34067,1,DoctorGrail,2410,0,1,0,1,100.0%,10m
34067,1,DmC,2410,0,1,0,1,100.0%,1h
34067,1,чунгачанга,2410,44,1,1,2,50.0%,4m
34067,1,Fatters,2410,0,1,4,5,20.0%,1h
34067,1,ForTheSwarm,2410,0,1,4,5,20.0%,1h
34067,1,TheJack,2410,0,1,4,5,20.0%,1h
34093,1,EZMoney,2409,1075,112,110,222,50.5%,1h
34093,2,KRISCHKE,2409,1525,90,94,184,48.9%,13m
34093,2,HamsterNet,2409,519,72,59,131,55.0%,18m
34093,2,Anakin,2409,800,58,54,112,51.8%,1h
34093,3,XMU,2409,698,29,34,63,46.0%,60m
34093,2,Sonic,2409,594,27,27,54,50.0%,1h
34093,1,NEO,2409,744,27,36,63,42.9%,6m
34093,3,cosmic,2409,435,19,15,34,55.9%,22m
34093,1,HTLV,2409,468,12,12,24,50.0%,1h
34093,1,[069FFM]geekay,2409,446,11,13,24,45.8%,4m
34093,3,Trasig,2409,167,6,6,12,50.0%,3m
34093,2,Wendit,2409,179,6,12,18,33.3%,1h
34093,2,Makaboeloe,2409,156,4,3,7,57.1%,27m
34093,1,ChickeN,2409,132,4,3,7,57.1%,25m
34093,1,Vomil,2409,78,3,0,3,100.0%,24m
34093,3,Lama,2409,58,3,2,5,60.0%,9m
34093,1,Ghost,2409,163,3,11,14,21.4%,29m
34093,1,BrownBear,2409,44,2,1,3,66.7%,1h
34093,1,takiinbor,2409,44,2,1,3,66.7%,1h
34093,1,sssss,2409,44,2,5,7,28.6%,20m
34093,1,ShellShock,2409,133,2,5,7,28.6%,60m
34093,3,Erdi,2409,97,1,3,4,25.0%,12m
34093,3,Eteist,2409,0,1,4,5,20.0%,1h
34093,3,Jose,2409,30,1,4,5,20.0%,1h
34093,1,Mattyleus,2409,0,1,4,5,20.0%,1h
34093,3,machoseks,2409,32,1,6,7,14.3%,1h
34093,1,ZuperMario,2409,0,0,1,1,0.0%,24m
34093,3,wysupreme,2409,0,0,1,1,0.0%,1h
34121,1,Bollandus,2408,1774,112,104,216,51.9%,16m
34121,3,SiSKOTRON,2408,1607,75,78,153,49.0%,1h
34121,3,krakuseus,2408,1234,42,64,106,39.6%,17m
34121,3,GRUDGE,2408,569,38,37,75,50.7%,29m
34121,3,ggLike,2408,650,26,29,55,47.3%,1h
34121,3,[IOWT]Knoy,2408,395,22,6,28,78.6%,1h
34121,3,Volta,2408,560,20,23,43,46.5%,5m
34121,3,[ISS2]Nanin,2408,419,18,17,35,51.4%,1h
34121,1,Ninja,2408,628,17,12,29,58.6%,1h
34121,1,[GangDa]SieGe,2408,422,12,8,20,60.0%,25m
34121,3,Starpolo,2408,315,12,18,30,40.0%,14m
34121,2,xBosna,2408,210,8,13,21,38.1%,1h
34121,3,Коражёр,2408,105,6,9,15,40.0%,1h
34121,1,LusorAmorum,2408,120,4,6,10,40.0%,1h
34121,1,ХОРОНЯКА,2408,88,3,1,4,75.0%,12m
34121,1,Wantoo,2408,88,3,3,6,50.0%,1h
34121,2,Gnida,2408,112,3,7,10,30.0%,1h
34121,1,Gerumvido,2408,145,2,2,4,50.0%,1h
34121,3,[TIREL]Escalibur,2408,118,2,4,6,33.3%,6m
34121,1,kansbar,2408,48,2,5,7,28.6%,1h
34121,1,zachiel,2408,48,2,5,7,28.6%,1h
34121,3,luchok,2408,58,2,7,9,22.2%,24m
34121,1,Freddy,2408,0,1,0,1,100.0%,21m
34121,3,димоооон,2408,0,1,1,2,50.0%,1h
34121,1,TRON,2408,0,1,4,5,20.0%,1h
34121,1,HAZARD,2408,0,1,4,5,20.0%,1h
34121,1,HeroSecreT,2408,0,1,4,5,20.0%,1h
34121,1,Vlkn,2408,0,1,4,5,20.0%,1h
34121,1,tawerka,2408,0,1,4,5,20.0%,1h
34121,3,[HBeS]BlackReaper,2408,30,1,5,6,16.7%,1h
34121,2,Makavenko,2408,0,0,1,1,0.0%,1h
34121,1,lis,2408,0,0,1,1,0.0%,24m
34121,1,[CSGB]BigWater,2408,0,0,2,2,0.0%,1h
34121,3,Baderling,2408,0,0,3,3,0.0%,1h
34121,3,Nero,2408,0,0,5,5,0.0%,1h
34156,2,adenmark,2407,1510,104,103,207,50.2%,1h
34156,2,BACOON,2407,922,42,41,83,50.6%,1h
34156,3,LiDLdude,2407,384,41,44,85,48.2%,19m
34156,2,Sedativ,2407,776,37,32,69,53.6%,18m
34156,3,fruntik,2407,483,36,22,58,62.1%,7m
34156,3,Obiron,2407,804,36,24,60,60.0%,21m
34156,2,Elior,2407,880,34,37,71,47.9%,1h
34156,3,[DaBoiz]Sticky,2407,817,31,30,61,50.8%,16m
34156,1,Forthepeople,2407,634,18,17,35,51.4%,16m
34156,1,Stein,2407,482,17,4,21,81.0%,1h
34156,1,FUTURA,2407,264,12,18,30,40.0%,18m
34156,2,McPallediPus,2407,292,11,12,23,47.8%,1h
34156,3,Sauerteig,2407,297,11,18,29,37.9%,1h
34156,1,Сволота,2407,204,7,14,21,33.3%,1h
34156,3,Phil,2407,180,6,11,17,35.3%,1h
34156,3,[ZERGSC]Aragorn,2407,122,5,7,12,41.7%,20m
34156,3,Wolf,2407,185,5,8,13,38.5%,1h
34156,3,TaupeVelue,2407,90,3,5,8,37.5%,1h
34156,3,[SРID]KeDbIbI,2407,58,2,7,9,22.2%,22m
34156,1,Dufrain,2407,0,1,0,1,100.0%,18m
34156,1,[AFK1]пюрешка,2407,0,1,1,2,50.0%,28m
34156,3,deadspase,2407,0,1,1,2,50.0%,1h
34156,3,cocoloco,2407,0,1,2,3,33.3%,1h
34156,3,André,2407,0,1,3,4,25.0%,19m
34156,2,[12]fredo,2407,30,1,4,5,20.0%,1h
34156,1,mak,2407,0,1,4,5,20.0%,1h
34156,1,HackaDoll,2407,0,1,4,5,20.0%,24m
34156,1,spadiK,2407,0,1,5,6,16.7%,27m
34156,2,[FYBF]Archstefesis,2407,40,1,5,6,16.7%,1h
34156,1,Dambo,2407,0,0,1,1,0.0%,24m
34156,1,darklodyo,2407,0,0,1,1,0.0%,28m
34156,1,iitaxa,2407,0,0,1,1,0.0%,26m
34156,1,Hefo,2407,0,0,1,1,0.0%,1h
34156,2,GrafSpee,2407,0,0,1,1,0.0%,1h
34156,1,таварищ,2407,0,0,1,1,0.0%,22m
34156,2,qbA,2407,0,0,2,2,0.0%,20m
34192,1,[N1K]Fly,2406,1552,267,273,540,49.4%,1h
34192,2,Blik,2406,1604,252,249,501,50.3%,1h
34192,2,Xsiolite,2406,1305,152,146,298,51.0%,59m
34192,2,Skaarup,2406,1523,141,139,280,50.4%,22m
34192,2,Dominik,2406,1533,135,139,274,49.3%,17m
34192,1,[GML]МиниТитан,2406,1788,119,114,233,51.1%,1h
34192,1,Ezio,2406,1741,83,69,152,54.6%,5m
34192,2,creator,2406,1438,71,76,147,48.3%,1h
34192,3,[BRSKR]Jay,2406,1549,69,67,136,50.7%,1h
34192,2,Origin,2406,1190,52,51,103,50.5%,13m
34192,3,Sicario,2406,987,44,44,88,50.0%,1h
34192,1,MafusalemRex,2406,1065,41,36,77,53.2%,25m
34192,1,Пацанчик,2406,761,23,21,44,52.3%,26m
34192,3,ildark,2406,538,20,20,40,50.0%,1h
34192,3,[KMET]Fifi,2406,197,14,13,27,51.9%,1h
34192,3,FeeL,2406,273,13,8,21,61.9%,1h
34192,1,[SyperS]Repzpank,2406,365,11,9,20,55.0%,1h
34192,1,Gosho,2406,362,10,7,17,58.8%,1h
34192,2,Frisk,2406,276,9,18,27,33.3%,16m
34192,1,Korto,2406,192,8,15,23,34.8%,8m
34192,3,Nis,2406,156,6,8,14,42.9%,1h
34192,1,offside,2406,219,6,11,17,35.3%,1h
34192,3,SSB,2406,161,5,2,7,71.4%,1h
34192,1,Feencreg,2406,48,3,1,4,75.0%,1h
34192,3,shadowwolf,2406,122,3,2,5,60.0%,1h
34192,1,SPAWN,2406,134,3,3,6,50.0%,8m
34192,1,Granate,2406,48,3,4,7,42.9%,59m
34192,3,Joukov,2406,30,3,6,9,33.3%,26m
34192,3,Trollvrål,2406,0,2,4,6,33.3%,1h
34192,1,Aurelius,2406,0,1,0,1,100.0%,1h
34192,1,[Gruzim]trollhacker,2406,0,1,0,1,100.0%,1h
34192,1,LPG,2406,44,1,2,3,33.3%,29m
34192,1,[РПО]BELMAK,2406,0,1,4,5,20.0%,27m
34192,1,Kotgewitter,2406,0,1,4,5,20.0%,6m
34192,1,ADMIRALXPOM,2406,0,1,5,6,16.7%,1h
34192,3,[Ww]Quezalcoalt,2406,0,1,6,7,14.3%,1h
34192,1,Technology,2406,0,0,2,2,0.0%,28m
34229,3,terminaferd,2405,1576,158,144,302,52.3%,1h
34229,3,Zboub,2405,557,109,96,205,53.2%,11m
34229,2,Stevennus,2405,1140,100,86,186,53.8%,1h
34229,3,вонючийносок,2405,1480,76,69,145,52.4%,15m
34229,3,[BliTau]Octane,2405,1358,51,55,106,48.1%,30m
34229,3,DarkCrusader,2405,734,27,30,57,47.4%,6m
34229,3,Alesh,2405,578,22,21,43,51.2%,26m
34229,1,Sven,2405,738,20,22,42,47.6%,1h
34229,3,Unlumi,2405,182,7,9,16,43.8%,1h
34229,1,Tat,2405,86,4,5,9,44.4%,1h
34229,3,Dave,2405,158,4,6,10,40.0%,59m
34229,3,Barbariska,2405,120,4,11,15,26.7%,1h
34229,3,LotharWolf,2405,86,3,6,9,33.3%,11m
34229,2,фантик,2405,0,2,6,8,25.0%,16m
34229,3,redshark,2405,30,1,4,5,20.0%,1h
34229,1,Brotty,2405,0,1,4,5,20.0%,1h
34229,1,imbajuk,2405,0,1,4,5,20.0%,4m
34229,1,scorpions,2405,0,0,1,1,0.0%,1h
34229,1,Jason,2405,0,0,1,1,0.0%,1h
34229,2,Yohxne,2405,0,0,1,1,0.0%,1h
34229,1,Pat,2405,0,0,1,1,0.0%,1h
34229,1,RaMZeS,2405,0,0,1,1,0.0%,1h
34229,1,grodgom,2405,0,0,2,2,0.0%,1h
34229,3,Matt,2405,0,0,2,2,0.0%,1h
34229,3,DznWiggel,2405,0,0,2,2,0.0%,1h
34229,3,Repli,2405,0,0,3,3,0.0%,24m
34255,1,InkogNico,2404,1512,167,175,342,48.8%,29m
34255,2,POLIAK,2404,1541,103,109,212,48.6%,1h
34255,2,PichosCoach,2404,1065,92,86,178,51.7%,1h
34255,2,Sllow,2404,1222,89,91,180,49.4%,6m
34255,3,XYZ,2404,1560,68,63,131,51.9%,1h
34255,3,apollo,2404,1080,53,51,104,51.0%,29m
34255,3,adsv,2404,1125,43,43,86,50.0%,60m
34255,1,Barcode,2404,1019,40,41,81,49.4%,1h
34255,3,Mars,2404,925,39,36,75,52.0%,15m
34255,1,YHG,2404,815,26,20,46,56.5%,13m
34255,3,NaHell,2404,597,26,23,49,53.1%,1h
34255,3,EncOre,2404,546,19,23,42,45.2%,4m
34255,2,Roamer,2404,450,18,21,39,46.2%,1h
34255,1,LeonaFires,2404,386,14,17,31,45.2%,23m
34255,3,Halestorm,2404,256,11,9,20,55.0%,1h
34255,3,Gurk,2404,150,8,14,22,36.4%,10m
34255,3,WilliamW,2404,222,7,9,16,43.8%,5m
34255,1,[GGTOP]Zlodei,2404,144,5,4,9,55.6%,60m
34255,1,GramsciGang,2404,210,5,9,14,35.7%,1h
34255,1,AmegaX,2404,145,3,0,3,100.0%,1h
34255,3,BNEE,2404,116,2,2,4,50.0%,21m
34255,3,[StrHon]Vega,2404,96,2,5,7,28.6%,1h
34255,3,lazarit,2404,0,2,5,7,28.6%,6m
34255,1,[DEWEY]AceUltra,2404,0,1,1,2,50.0%,6m
34255,1,LiQnis,2404,0,1,2,3,33.3%,1h
34255,1,[MGWTF]daïko,2404,0,1,3,4,25.0%,1h
34255,3,mEgAmArInE,2404,30,1,4,5,20.0%,1h
34255,1,RPX,2404,0,1,4,5,20.0%,7m
34255,1,GloriousGibs,2404,0,1,4,5,20.0%,1h
34255,1,GoPaRiCk,2404,0,0,1,1,0.0%,27m
34255,1,Arkveeri,2404,0,0,2,2,0.0%,1h
34255,2,Thruzt,2404,0,0,3,3,0.0%,1h
34287,3,Mavirk,2403,1567,228,231,459,49.7%,11m
34287,2,Solid,2403,1305,48,50,98,49.0%,1h
34287,2,Jonathan,2403,1225,46,50,96,47.9%,1h
34287,3,matriktof,2403,1077,44,44,88,50.0%,1h
34287,2,DERF,2403,798,29,33,62,46.8%,4m
34287,3,[grimgr]icedregon,2403,504,18,18,36,50.0%,1h
34287,1,Mates,2403,356,13,16,29,44.8%,1h
34287,3,Joker,2403,356,12,15,27,44.4%,4m
34287,3,Pencala,2403,251,9,13,22,40.9%,19m
34287,3,PRobi,2403,208,9,13,22,40.9%,1h
34287,1,McSushi,2403,180,7,6,13,53.8%,20m
34287,1,ventario,2403,252,6,6,12,50.0%,59m
34287,3,IamBOB,2403,152,6,8,14,42.9%,60m
34287,1,Helwist,2403,166,5,0,5,100.0%,28m
34287,2,[OF]MrDessolator,2403,122,4,1,5,80.0%,11m
34287,1,SPY,2403,122,4,2,6,66.7%,1h
34287,1,boitandmg,2403,174,4,3,7,57.1%,1h
34287,3,Raz,2403,94,4,8,12,33.3%,26m
34287,1,Tomasberkut,2403,48,2,3,5,40.0%,24m
34287,1,Demonix,2403,97,2,4,6,33.3%,1h
34287,1,Fantast,2403,40,2,5,7,28.6%,1h
34287,3,elxan,2403,96,2,5,7,28.6%,1h
34287,1,BROJAGA,2403,0,1,1,2,50.0%,1h
34287,2,SEGAN,2403,0,1,1,2,50.0%,11m
34287,1,ActionK,2403,0,1,1,2,50.0%,1h
34287,1,SilentSword,2403,44,1,2,3,33.3%,20m
34287,1,LuluSL,2403,0,1,4,5,20.0%,1h
34287,3,аУзунпокЬски,2403,30,1,6,7,14.3%,4m
34287,1,USSR,2403,0,0,1,1,0.0%,1h
34287,1,Kostirov,2403,0,0,1,1,0.0%,1h
34287,1,cungfuzerg,2403,0,0,2,2,0.0%,1h
34287,1,djidjibiji,2403,0,0,2,2,0.0%,1h
34287,3,Ierron,2403,0,0,4,4,0.0%,24m
34320,3,Maxilitien,2402,1599,105,103,208,50.5%,15m
34320,3,bezpal,2402,1541,104,98,202,51.5%,1h
34320,1,Grifdrim,2402,1016,71,76,147,48.3%,1h
34320,3,Sikici,2402,1311,70,57,127,55.1%,1h
34320,2,Threpwood,2402,1311,55,65,120,45.8%,1h
34320,3,[VGW]Jokerman,2402,1235,52,59,111,46.8%,1h
34320,3,biloup,2402,639,49,51,100,49.0%,22m
34320,2,[VPSK]ernoke,2402,532,20,19,39,51.3%,1h
34320,3,Zakilegs,2402,407,17,9,26,65.4%,1h
34320,1,waneksx,2402,406,11,8,19,57.9%,1h
34320,1,[xFRSx]HySteriX,2402,304,9,9,18,50.0%,20m
34320,1,Plato,2402,169,7,4,11,63.6%,1h
34320,1,[HellG]Sidorovich,2402,286,7,4,11,63.6%,1h
34320,1,guimelo,2402,180,6,6,12,50.0%,6m
34320,3,forser,2402,166,4,6,10,40.0%,60m
34320,1,Felix,2402,88,3,2,5,60.0%,25m
34320,3,bqkt,2402,96,3,2,5,60.0%,15m
34320,1,SAINT,2402,42,3,3,6,50.0%,18m
34320,1,Elmerll,2402,132,3,4,7,42.9%,1h
34320,3,DrFunkson,2402,138,3,4,7,42.9%,1h
34320,1,Shoran,2402,0,3,4,7,42.9%,28m
34320,1,KompetenzPhi,2402,48,3,5,8,37.5%,13m
34320,2,Kodysses,2402,90,3,6,9,33.3%,59m
34320,1,Azzulla,2402,44,2,0,2,100.0%,1h
34320,3,XeroX,2402,96,2,3,5,40.0%,21m
34320,1,[CremPI]beCoN,2402,0,2,6,8,25.0%,1h
34320,1,Хомяк,2402,0,1,0,1,100.0%,60m
34320,1,DemaGorgone,2402,44,1,1,2,50.0%,29m
34320,1,BlueAlc,2402,48,1,2,3,33.3%,1h
34320,1,DoDo,2402,0,1,4,5,20.0%,9m
34320,1,keyErr,2402,0,0,1,1,0.0%,60m
34320,1,jca,2402,0,0,1,1,0.0%,18m
34320,1,grizzly,2402,0,0,1,1,0.0%,18m
34320,1,Чертила,2402,0,0,1,1,0.0%,60m
34320,3,StarSchwarf,2402,0,0,3,3,0.0%,16m
34355,3,Superpoulpe,2401,793,174,170,344,50.6%,4m
34355,2,Maru,2401,903,41,35,76,53.9%,1h
34355,3,TanocaCocok,2401,843,39,35,74,52.7%,1h
34355,1,Sparkleknigh,2401,710,25,13,38,65.8%,7m
34355,3,bKL,2401,287,12,10,22,54.5%,6m
34355,1,Prasicaa,2401,268,12,12,24,50.0%,16m
34355,3,Capablanca,2401,266,10,11,21,47.6%,4m
34355,2,Nameless,2401,336,10,16,26,38.5%,1h
34355,1,ale,2401,330,9,6,15,60.0%,9m
34355,3,[LaggIT]Vidde,2401,210,8,13,21,38.1%,21m
34355,1,ViktorII,2401,215,7,6,13,53.8%,1h
34355,3,[ШиШаНы]BomBersem,2401,233,7,9,16,43.8%,24m
34355,1,IronLove,2401,158,7,12,19,36.8%,1h
34355,1,ActiveDK,2401,254,6,7,13,46.2%,1h
34355,1,partizan,2401,174,4,2,6,66.7%,23m
34355,1,iLLusion,2401,187,4,6,10,40.0%,6m
34355,1,Topaze,2401,118,3,4,7,42.9%,1h
34355,1,[Koffie]privateHenk,2401,0,1,1,2,50.0%,1h
34355,1,ChefZealot,2401,0,1,1,2,50.0%,1h
34355,1,[AiurRO]Aquasonic,2401,48,1,2,3,33.3%,1h
34355,1,Roni,2401,0,1,4,5,20.0%,7m
34355,1,FatLenny,2401,0,1,4,5,20.0%,60m
34355,1,Askibi,2401,0,1,4,5,20.0%,29m
34355,3,WEST,2401,30,1,6,7,14.3%,1h
34355,1,Spetswolf,2401,0,0,5,5,0.0%,22m
34380,3,Borchernator,2400,1541,89,84,173,51.4%,1h
34380,3,MichaelBlue,2400,969,60,58,118,50.8%,11m
34380,3,GEOgreEMe,2400,676,26,29,55,47.3%,1h
34380,1,ХитрыйСтраус,2400,615,16,13,29,55.2%,25m
34380,1,emre,2400,477,12,6,18,66.7%,5m
34380,2,RAMBI,2400,286,10,5,15,66.7%,59m
34380,3,[Hаsu]HazeOne,2400,280,10,7,17,58.8%,1h
34380,1,pOgO,2400,216,9,15,24,37.5%,1h
34380,1,FireStarter,2400,206,6,23,29,20.7%,14m
34380,1,asdfasdf,2400,166,5,3,8,62.5%,28m
34380,1,jihun,2400,103,4,7,11,36.4%,29m
34380,2,PuhoOP,2400,134,4,13,17,23.5%,1h
34380,1,DelMits,2400,120,3,2,5,60.0%,1h
34380,3,jessto,2400,30,2,3,5,40.0%,11m
34380,1,Grevling,2400,48,2,5,7,28.6%,1h
34380,3,Deus,2400,95,2,6,8,25.0%,19m
34380,3,Dentistul,2400,30,2,7,9,22.2%,24m
34380,2,SHADOWDRAGON,2400,0,1,0,1,100.0%,1h
34380,1,Snipars,2400,0,1,1,2,50.0%,60m
34380,3,Macco,2400,0,1,2,3,33.3%,4m
34380,1,arcibaldo,2400,44,1,2,3,33.3%,27m
34380,1,wingman,2400,0,1,4,5,20.0%,1h
34380,1,Tino,2400,0,1,4,5,20.0%,5m
34380,1,Popolebouche,2400,0,1,4,5,20.0%,1h
34380,1,MadDemon,2400,0,1,4,5,20.0%,59m
34380,1,invalid,2400,0,1,4,5,20.0%,11m
34380,3,amko,2400,30,1,7,8,12.5%,1h
34380,1,Noobasik,2400,0,0,1,1,0.0%,19m
34380,1,FERzEc,2400,0,0,1,1,0.0%,27m
34380,1,jim,2400,0,0,2,2,0.0%,11m
34410,2,Styx,2399,1641,455,468,923,49.3%,1h
34410,2,Happyminy,2399,787,90,93,183,49.2%,13m
34410,1,Psychophobe,2399,1846,85,79,164,51.8%,10m
34410,1,Lion,2399,1170,53,42,95,55.8%,10m
34410,1,URAN,2399,1043,52,29,81,64.2%,1h
34410,2,juli,2399,1045,43,40,83,51.8%,1h
34410,1,BlazejJagge,2399,1207,42,39,81,51.9%,16m
34410,1,Odisej,2399,1088,42,60,102,41.2%,1h
34410,3,[NSSC2]NeoSab,2399,829,36,24,60,60.0%,1h
34410,3,blackshadow,2399,338,14,14,28,50.0%,1h
34410,3,[DRG]kostyanIOII,2399,336,13,15,28,46.4%,1h
34410,3,SerAlfred,2399,276,11,15,26,42.3%,1h
34410,3,sixsevan,2399,230,9,10,19,47.4%,11m
34410,3,milanko,2399,260,9,15,24,37.5%,10m
34410,3,[HATE]keule,2399,140,8,8,16,50.0%,1h
34410,3,Nyanta,2399,182,7,11,18,38.9%,1h
34410,1,romkapazifis,2399,128,4,2,6,66.7%,5m
34410,3,Revol,2399,142,4,7,11,36.4%,1h
34410,3,Vador,2399,114,4,9,13,30.8%,59m
34410,3,Kotoslon,2399,86,3,6,9,33.3%,1h
34410,3,korkers,2399,86,3,6,9,33.3%,27m
34410,1,Кирилл,2399,44,2,1,3,66.7%,1h
34410,3,Morkkis,2399,116,2,5,7,28.6%,4m
34410,1,LYES,2399,44,2,5,7,28.6%,1h
34410,3,osman,2399,60,2,5,7,28.6%,14m
34410,2,nuo,2399,131,2,6,8,25.0%,1h
34410,1,[RlSKQQ]Shadow,2399,123,2,7,9,22.2%,29m
34410,1,Plautz,2399,0,1,1,2,50.0%,1h
34410,3,MIKIKALS,2399,0,1,1,2,50.0%,21m
34410,1,notcEpO,2399,48,1,1,2,50.0%,1h
34410,1,[NWGD]illia,2399,44,1,2,3,33.3%,5m
34410,3,Freakdog,2399,0,1,3,4,25.0%,11m
34410,1,OhGodWhy,2399,0,1,4,5,20.0%,4m
34410,1,FDxGOD,2399,0,1,4,5,20.0%,6m
34410,1,Bob,2399,0,1,4,5,20.0%,4m
34410,1,kyber,2399,0,0,1,1,0.0%,16m
34446,3,CARLITO,2398,1595,141,143,284,49.6%,28m
34446,1,[ouaf]Martoni,2398,1723,92,79,171,53.8%,1h
34446,2,Ghost,2398,1452,77,70,147,52.4%,1h
34446,3,IlIIIIllllll,2398,1545,74,85,159,46.5%,5m
34446,2,MORPHEUS,2398,1602,73,71,144,50.7%,22m
34446,1,Smoox,2398,708,72,64,136,52.9%,1h
34446,1,Joker,2398,1043,36,33,69,52.2%,1h
34446,1,hybride,2398,562,15,11,26,57.7%,1h
34446,3,Interstellar,2398,342,13,9,22,59.1%,28m
34446,2,WooDoo,2398,314,11,19,30,36.7%,59m
34446,2,[ExTr1m]NekRoMen,2398,149,6,6,12,50.0%,17m
34446,2,Wargle,2398,132,6,9,15,40.0%,1h
34446,1,alex,2398,178,5,5,10,50.0%,1h
34446,3,zbyszex,2398,201,5,8,13,38.5%,1h
34446,1,Andrew,2398,168,4,2,6,66.7%,1h
34446,3,GOGI,2398,147,4,4,8,50.0%,19m
34446,3,damnlife,2398,177,4,6,10,40.0%,1h
34446,1,Quert,2398,82,3,2,5,60.0%,25m
34446,1,DomSniperX,2398,0,3,2,5,60.0%,1h
34446,1,LiberalCuck,2398,0,3,2,5,60.0%,59m
34446,1,Rabbit,2398,42,2,0,2,100.0%,18m
34446,1,pinty,2398,48,2,3,5,40.0%,1h
34446,1,Starbat,2398,97,2,4,6,33.3%,14m
34446,1,IIIIIIIIII,2398,40,1,1,2,50.0%,1h
34446,2,chibi,2398,0,1,3,4,25.0%,1h
34446,3,Shadow,2398,0,1,5,6,16.7%,12m
34446,1,NotDeepmind,2398,0,0,1,1,0.0%,1h
34446,3,DISCARDED,2398,0,0,1,1,0.0%,17m
34446,1,[sLLsTT]Humsterkiler,2398,0,0,2,2,0.0%,16m
34475,1,Ехоу,2397,1864,220,216,436,50.5%,1h
34475,3,Prometheus,2397,1549,218,222,440,49.5%,27m
34475,3,Hellinios,2397,1540,121,113,234,51.7%,1h
34475,3,[minire]rexpower,2397,1522,106,91,197,53.8%,1h
34475,2,[Bulg]lubo,2397,1552,98,106,204,48.0%,1h
34475,2,[scvvcs]nautilus,2397,1573,93,89,182,51.1%,1h
34475,3,Kostuumkat,2397,1581,92,99,191,48.2%,1h
34475,1,Mentatus,2397,872,37,35,72,51.4%,1h
34475,3,[CøsaN]Dzeus,2397,651,25,32,57,43.9%,1h
34475,3,Agros,2397,370,15,16,31,48.4%,1h
34475,1,ImDavid,2397,406,10,9,19,52.6%,9m
34475,3,TerranLoL,2397,228,8,11,19,42.1%,1h
34475,1,[ERION]killermill,2397,128,4,1,5,80.0%,1h
34475,1,HwangShin,2397,193,4,6,10,40.0%,6m
34475,1,Sergun,2397,73,4,7,11,36.4%,1h
34475,3,[LokiXX]DanniPlayBoy,2397,94,4,8,12,33.3%,29m
34475,1,Mangoost,2397,128,3,4,7,42.9%,1h
34475,1,[ESMC]Пивас,2397,88,2,2,4,50.0%,1h
34475,1,obZen,2397,97,2,4,6,33.3%,6m
34475,3,Viktor,2397,64,2,5,7,28.6%,22m
34475,3,[Albion]Zhoust,2397,0,2,6,8,25.0%,16m
34475,2,Alexey,2397,74,2,10,12,16.7%,1h
34475,1,[CLMOB]Archijevny,2397,0,1,4,5,20.0%,1h
34475,1,Marchello,2397,0,1,4,5,20.0%,9m
34475,1,BadMar,2397,0,0,1,1,0.0%,7m
34475,1,Koshelevych,2397,0,0,2,2,0.0%,18m
34501,3,[Waste]Blume,2396,894,109,99,208,52.4%,59m
34501,3,Ankylos,2396,1494,104,99,203,51.2%,1h
34501,2,[ULTW]DOOMBRINGER,2396,1495,103,114,217,47.5%,1h
34501,2,Tokyojoe,2396,441,71,67,138,51.4%,19m
34501,3,Greenee,2396,1321,61,51,112,54.5%,29m
34501,3,[NINJ88]Fostaliga,2396,638,23,26,49,46.9%,22m
34501,3,megatoster,2396,459,16,17,33,48.5%,27m
34501,2,Nookie,2396,468,16,24,40,40.0%,19m
34501,3,Florian,2396,334,12,11,23,52.2%,1h
34501,3,[LMLQ]DasChajasie,2396,116,12,14,26,46.2%,14m
34501,2,Кемпиль,2396,226,8,12,20,40.0%,28m
34501,1,zzHencozz,2396,244,6,7,13,46.2%,24m
34501,3,ImbaAlik,2396,180,5,4,9,55.6%,1h
34501,3,Spud,2396,165,5,6,11,45.5%,20m
34501,3,FunkyMonk,2396,195,5,8,13,38.5%,21m
34501,3,MahaCarrier,2396,90,4,6,10,40.0%,1h
34501,3,[БОДУН]Дух,2396,132,3,3,6,50.0%,6m
34501,1,HowlingMad,2396,94,3,12,15,20.0%,29m
34501,3,Muffinsan,2396,95,2,5,7,28.6%,1h
34501,1,Wander,2396,0,1,0,1,100.0%,1h
34501,3,[KAESPE]ArtShpiller,2396,0,1,1,2,50.0%,1h
34501,1,[сSсǃ]vehugo,2396,97,1,1,2,50.0%,21m
34501,1,mafkirn,2396,48,1,1,2,50.0%,1h
34501,1,LiQuiDN,2396,0,1,2,3,33.3%,20m
34501,1,Zilaff,2396,0,0,1,1,0.0%,5m
34501,3,[FFLEXX]Reybey,2396,0,0,4,4,0.0%,1h
34527,3,Trehh,2395,1337,141,149,290,48.6%,11m
34527,1,Skan,2395,656,56,48,104,53.8%,1h
34527,3,TyPidor,2395,800,36,25,61,59.0%,12m
34527,1,Zenit,2395,716,33,5,38,86.8%,4m
34527,2,giantschrimp,2395,752,27,38,65,41.5%,59m
34527,3,kpectohoceu,2395,552,25,14,39,64.1%,1h
34527,3,UberHunter,2395,513,23,27,50,46.0%,1h
34527,3,Damika,2395,594,21,22,43,48.8%,6m
34527,3,Wel,2395,376,19,15,34,55.9%,1h
34527,1,Doter,2395,428,17,27,44,38.6%,1h
34527,1,dzBAN,2395,536,15,9,24,62.5%,1h
34527,3,Ralf,2395,441,15,24,39,38.5%,22m
34527,3,rabada,2395,242,9,13,22,40.9%,16m
34527,3,[HDPL]Chronus,2395,255,8,12,20,40.0%,5m
34527,1,[3GBU]Gruyere,2395,284,7,4,11,63.6%,1h
34527,3,BigChau,2395,180,6,5,11,54.5%,20m
34527,3,[BforM]Terminator,2395,120,5,6,11,45.5%,19m
34527,1,Rick,2395,130,4,3,7,57.1%,23m
34527,3,notyou,2395,118,3,3,6,50.0%,26m
34527,1,JollyRoGeR,2395,168,3,7,10,30.0%,1h
34527,2,Evgeniy,2395,60,3,11,14,21.4%,10m
34527,2,KuSpa,2395,124,2,1,3,66.7%,21m
34527,1,Ðundra,2395,92,2,5,7,28.6%,1h
34527,1,Harribert,2395,82,2,7,9,22.2%,1h
34527,1,JymRaynor,2395,0,1,0,1,100.0%,21m
34527,1,poporlich,2395,0,1,0,1,100.0%,1h
34527,1,Original,2395,0,1,4,5,20.0%,12m
34527,1,MeisterÖlig,2395,0,0,1,1,0.0%,1h
34527,1,Antonf,2395,0,0,2,2,0.0%,9m
34556,3,Ender,2394,1388,142,134,276,51.4%,1h
34556,3,Maiwaifu,2394,1466,101,105,206,49.0%,11m
34556,3,Vad,2394,1176,55,60,115,47.8%,11m
34556,2,[Нrr]Shepard,2394,1164,48,48,96,50.0%,1h
34556,3,Kira,2394,1078,44,35,79,55.7%,59m
34556,3,GunJacks,2394,1088,39,42,81,48.1%,1h
34556,2,VladDTerran,2394,1080,38,49,87,43.7%,1h
34556,1,Lightning,2394,927,30,22,52,57.7%,1h
34556,1,Gilli,2394,638,29,19,48,60.4%,1h
34556,3,Bleach,2394,619,23,28,51,45.1%,14m
34556,3,Jabba,2394,364,13,10,23,56.5%,1h
34556,1,vovaigrok,2394,251,10,9,19,52.6%,1h
34556,3,Кабан,2394,195,5,2,7,71.4%,4m
34556,3,[N1TDA]fINCLIVER,2394,0,4,4,8,50.0%,1h
34556,3,Eridanus,2394,116,4,9,13,30.8%,14m
34556,2,Overlord,2394,148,3,7,10,30.0%,1h
34556,2,Purplewolf,2394,114,3,8,11,27.3%,3m
34556,1,PavelSpade,2394,84,2,2,4,50.0%,21m
34556,1,Raaijin,2394,48,2,5,7,28.6%,1h
34556,3,rubenpoli,2394,60,2,6,8,25.0%,1h
34556,1,Sød,2394,0,2,7,9,22.2%,13m
34556,1,[DoA]Manga,2394,40,1,4,5,20.0%,1h
34556,1,Hivemind,2394,0,1,4,5,20.0%,4m
34556,1,Zergdoktor,2394,0,1,4,5,20.0%,1h
34556,1,[LFDC]Cochonou,2394,0,1,4,5,20.0%,27m
34556,3,spaceaidz,2394,30,1,9,10,10.0%,1h
34556,1,vetal,2394,0,0,1,1,0.0%,1h
34556,1,Griffin,2394,0,0,1,1,0.0%,1h
34556,1,Вова,2394,0,0,1,1,0.0%,9m
34556,1,nico,2394,0,0,1,1,0.0%,20m
34556,1,ShhsEhd,2394,0,0,1,1,0.0%,6m
34556,3,Kraszczak,2394,0,0,2,2,0.0%,1h
34556,3,worpheus,2394,0,0,3,3,0.0%,1h
34589,2,[woooff]Wothan,2393,1509,217,223,440,49.3%,1h
34589,2,Zergey,2393,1531,101,105,206,49.0%,16m
34589,3,DYSTREX,2393,1423,92,90,182,50.5%,4m
34589,1,MadDoc,2393,1333,71,58,129,55.0%,1h
34589,3,jetking,2393,1265,63,57,120,52.5%,14m
34589,3,TPK,2393,567,45,54,99,45.5%,4m
34589,3,Majkicccc,2393,927,40,42,82,48.8%,15m
34589,3,makhach,2393,922,39,37,76,51.3%,1h
34589,2,Peregrin,2393,983,37,40,77,48.1%,5m
34589,3,gambino,2393,895,35,30,65,53.8%,1h
34589,2,Nighthawk,2393,970,33,42,75,44.0%,1h
34589,1,kakiw,2393,681,29,27,56,51.8%,1h
34589,3,Leadership,2393,723,29,27,56,51.8%,16m
34589,3,Jacob,2393,535,22,20,42,52.4%,24m
34589,3,Folkmen,2393,369,13,14,27,48.1%,16m
34589,3,[NILE]Jöket,2393,278,10,15,25,40.0%,16m
34589,1,STYKE,2393,356,9,2,11,81.8%,3m
34589,3,[Сеть]Мистик,2393,246,9,11,20,45.0%,1h
34589,1,Heromarine,2393,314,8,5,13,61.5%,1h
34589,3,Unknowz,2393,171,7,15,22,31.8%,1h
34589,1,[RMF]RKLSK,2393,207,5,2,7,71.4%,1h
34589,2,Vadimka,2393,154,5,13,18,27.8%,16m
34589,1,Zufl,2393,96,4,6,10,40.0%,14m
34589,1,[CxCx]kokee,2393,128,3,2,5,60.0%,10m
34589,1,[Amons]Ares,2393,42,2,0,2,100.0%,1h
34589,1,Iris,2393,0,1,2,3,33.3%,1h
34589,3,[Héoh]Eltitou,2393,97,1,3,4,25.0%,20m
34589,1,Nicolas,2393,0,1,4,5,20.0%,1h
34589,1,danila,2393,0,1,4,5,20.0%,7m
34589,1,JohnWick,2393,0,1,4,5,20.0%,26m
34589,3,SASHA,2393,0,0,3,3,0.0%,1h
34620,1,DRSDK,2392,1365,115,113,228,50.4%,1h
34620,1,Jeronimo,2392,1830,101,93,194,52.1%,1h
34620,2,Paul,2392,1117,82,70,152,53.9%,1h
34620,3,Lukas,2392,650,77,83,160,48.1%,19m
34620,2,Nightmind,2392,609,45,44,89,50.6%,1h
34620,3,[DaRaBa]FoxMouldy,2392,987,37,38,75,49.3%,1h
34620,1,sHEPT,2392,641,24,31,55,43.6%,1h
34620,3,[EZKBM]handypoter,2392,398,23,20,43,53.5%,28m
34620,3,Sagan,2392,416,14,15,29,48.3%,1h
34620,3,havindier,2392,185,12,18,30,40.0%,4m
34620,2,GachiMaster,2392,206,9,13,22,40.9%,27m
34620,1,Однокнопочны,2392,197,6,7,13,46.2%,1h
34620,1,iiiserj,2392,78,3,2,5,60.0%,25m
34620,3,КрЕАтив,2392,145,3,5,8,37.5%,1h
34620,3,RaVEX,2392,90,3,8,11,27.3%,16m
34620,1,Bangau,2392,97,2,0,2,100.0%,1h
34620,1,LIPelmeshki,2392,88,2,2,4,50.0%,1h
34620,1,Royod,2392,86,2,3,5,40.0%,28m
34620,3,Vollcod,2392,30,2,3,5,40.0%,21m
34620,2,nario,2392,36,2,3,5,40.0%,1h
34620,3,Yukianesa,2392,0,2,6,8,25.0%,1h
34620,2,[oO]Maloghigno,2392,62,2,11,13,15.4%,1h
34620,1,dukE,2392,0,1,1,2,50.0%,25m
34620,2,LeiTog,2392,0,1,3,4,25.0%,29m
34620,3,Comix,2392,0,1,4,5,20.0%,1h
34620,1,infected,2392,0,1,4,5,20.0%,10m
34620,1,[GroGs]Greaks,2392,0,0,1,1,0.0%,14m
34620,1,Frefghter,2392,0,0,1,1,0.0%,19m
34620,1,Mobacca,2392,0,0,1,1,0.0%,1h
34620,1,Trololo,2392,0,0,1,1,0.0%,27m
34620,2,Kalooo,2392,0,0,3,3,0.0%,1h
34620,1,Alex,2392,0,0,4,4,0.0%,28m
34652,1,LaughinBubba,2391,1598,222,223,445,49.9%,1h
34652,1,shaddow,2391,1372,51,40,91,56.0%,1h
34652,1,SneakyMouse,2391,740,41,37,78,52.6%,28m
34652,1,MajkelMM,2391,948,34,32,66,51.5%,1h
34652,2,DoWePlayLike,2391,965,33,43,76,43.4%,28m
34652,1,[OorloG]YsterVuis,2391,873,30,18,48,62.5%,1h
34652,1,[TFSC]XxDERECKXx,2391,658,26,13,39,66.7%,1h
34652,2,NaGiB,2391,602,24,25,49,49.0%,5m
34652,3,Iamaman,2391,460,17,17,34,50.0%,1h
34652,3,Malacoda,2391,386,14,19,33,42.4%,21m
34652,1,SerJey,2391,308,11,8,19,57.9%,1h
34652,1,DeaDushkaL,2391,206,8,14,22,36.4%,1h
34652,3,RuslanJur,2391,220,7,10,17,41.2%,15m
34652,3,popug,2391,216,7,13,20,35.0%,28m
34652,1,HellLord,2391,238,6,5,11,54.5%,21m
34652,1,comertone,2391,282,6,5,11,54.5%,5m
34652,1,AntiToxic,2391,218,6,9,15,40.0%,1h
34652,3,CaptainFeed,2391,132,6,10,16,37.5%,1h
34652,1,nelomalko,2391,170,5,4,9,55.6%,10m
34652,3,OrangeJuice,2391,114,5,7,12,41.7%,5m
34652,3,Vasilevs,2391,193,5,8,13,38.5%,1h
34652,1,Lepetitfurax,2391,90,3,0,3,100.0%,19m
34652,1,Peacemaker,2391,144,3,6,9,33.3%,14m
34652,1,PlayerOne,2391,44,2,2,4,50.0%,20m
34652,1,Andrei,2391,66,2,3,5,40.0%,1h
34652,1,Tokipok,2391,0,2,3,5,40.0%,1h
34652,3,JohnnyRockR,2391,0,2,6,8,25.0%,1h
34652,3,Makkemias,2391,0,1,1,2,50.0%,1h
34652,1,muky,2391,0,0,1,1,0.0%,1h
34652,1,ibimsarthur,2391,0,0,1,1,0.0%,12m
34682,1,RmasteR,2390,1819,204,188,392,52.0%,1h
34682,2,RamaII,2390,1503,136,143,279,48.7%,1h
34682,3,cazeg,2390,1431,126,108,234,53.8%,14m
34682,3,LIJACOM,2390,1551,109,89,198,55.1%,16m
34682,1,Жук,2390,1674,86,75,161,53.4%,9m
34682,1,Marinad,2390,964,58,55,113,51.3%,1h
34682,2,darkmaster,2390,1323,54,65,119,45.4%,16m
34682,1,[ENV]Mylny,2390,1229,52,43,95,54.7%,28m
34682,1,Stapelkiste,2390,1351,49,46,95,51.6%,9m
34682,3,marijane,2390,876,46,49,95,48.4%,59m
34682,3,Alderaane,2390,628,35,40,75,46.7%,1h
34682,1,[L0L]KrakenPL,2390,873,28,19,47,59.6%,15m
34682,3,[OLPD]Mukhtari,2390,653,25,30,55,45.5%,16m
34682,3,KryG,2390,149,17,18,35,48.6%,22m
34682,1,citrus,2390,418,13,25,38,34.2%,1h
34682,1,[Анiме]гoвнотpax,2390,218,7,5,12,58.3%,1h
34682,1,CharlieFace,2390,194,7,6,13,53.8%,7m
34682,1,LoNzrEt,2390,148,4,2,6,66.7%,16m
34682,3,Dert,2390,171,4,4,8,50.0%,1h
34682,1,johnybill,2390,156,4,8,12,33.3%,1h
34682,1,ТОР,2390,62,4,9,13,30.8%,26m
34682,1,NoName,2390,0,3,2,5,60.0%,10m
34682,3,DevilSpeed,2390,62,3,5,8,37.5%,19m
34682,1,VISPA,2390,163,3,5,8,37.5%,14m
34682,1,[ЗЕRGТV]KOMARanezi,2390,42,2,2,4,50.0%,1h
34682,3,Robot,2390,64,2,3,5,40.0%,60m
34682,1,Монгол,2390,97,2,5,7,28.6%,19m
34682,2,paunx,2390,0,2,5,7,28.6%,14m
34682,3,Ceravid,2390,0,1,1,2,50.0%,1h
34682,1,Azairog,2390,0,1,3,4,25.0%,22m
34682,1,Den,2390,0,1,4,5,20.0%,1h
34682,3,PuMBa,2390,30,1,6,7,14.3%,25m
34682,1,DanceManiac,2390,109,1,7,8,12.5%,1h
34682,1,Blanco,2390,0,0,1,1,0.0%,1h
34682,1,Kampfkarpfn,2390,0,0,3,3,0.0%,7m
34717,1,Lexx,2389,1243,176,178,354,49.7%,17m
34717,1,simtel,2389,1168,136,144,280,48.6%,1h
34717,3,Firedog,2389,1545,75,74,149,50.3%,18m
34717,1,Bricox,2389,1501,67,82,149,45.0%,24m
34717,2,Sabaken,2389,174,47,33,80,58.8%,19m
34717,1,bencik,2389,725,24,14,38,63.2%,15m
34717,3,fernando,2389,397,15,17,32,46.9%,18m
34717,2,HSDoobie,2389,358,13,23,36,36.1%,1h
34717,1,Siutch,2389,261,12,13,25,48.0%,18m
34717,1,Bugs,2389,440,11,14,25,44.0%,1h
34717,2,Kokoň,2389,207,7,12,19,36.8%,1h
34717,2,ManP,2389,196,6,9,15,40.0%,1h
34717,1,vait,2389,174,4,7,11,36.4%,1h
34717,1,hal,2389,130,3,3,6,50.0%,1h
34717,1,Saknodt,2389,0,3,3,6,50.0%,1h
34717,3,KroNax,2389,58,3,7,10,30.0%,19m
34717,1,norstar,2389,0,2,3,5,40.0%,1h
34717,1,ЯСВ,2389,88,2,3,5,40.0%,25m
34717,3,szubaka,2389,94,2,5,7,28.6%,1h
34717,1,KillerBunny,2389,0,1,4,5,20.0%,25m
34717,3,rein,2389,30,1,5,6,16.7%,28m
34717,1,[BBGY]Gajardo,2389,0,0,1,1,0.0%,29m
34717,1,Hannibal,2389,0,0,1,1,0.0%,22m
34717,1,JDrondan,2389,0,0,2,2,0.0%,59m
34741,2,Queen,2388,1564,502,512,1014,49.5%,1h
34741,3,skorp,2388,1583,188,184,372,50.5%,1h
34741,2,Inzaghi,2388,1359,112,114,226,49.6%,1h
34741,3,FIREBLADESTR,2388,1307,72,67,139,51.8%,1h
34741,3,aumshanti,2388,1461,72,68,140,51.4%,9m
34741,1,Stava,2388,1326,43,46,89,48.3%,10m
34741,2,PeterPanini,2388,901,32,40,72,44.4%,19m
34741,3,RobotWorgen,2388,472,29,27,56,51.8%,27m
34741,1,TheBoss,2388,458,27,28,55,49.1%,9m
34741,2,Vise,2388,784,26,33,59,44.1%,26m
34741,2,HoldTheDoor,2388,780,26,37,63,41.3%,1h
34741,3,DUMBsixnine,2388,604,21,20,41,51.2%,10m
34741,3,Nikod,2388,389,13,13,26,50.0%,4m
34741,1,[ДН7485]KRONOS,2388,449,11,7,18,61.1%,10m
34741,2,Xirodian,2388,232,9,10,19,47.4%,1h
34741,3,[ZatupA]DAvinch,2388,272,9,14,23,39.1%,21m
34741,3,DiamondJane,2388,238,9,20,29,31.0%,8m
34741,1,Phizzler,2388,214,7,7,14,50.0%,1h
34741,1,atom,2388,164,5,1,6,83.3%,1h
34741,1,Роман,2388,174,4,3,7,57.1%,1h
34741,1,Skippy,2388,146,3,4,7,42.9%,60m
34741,2,[OGCC]CHAZAK,2388,0,3,5,8,37.5%,19m
34741,1,Deus,2388,96,3,6,9,33.3%,1h
34741,3,[xXQXx]Meatbag,2388,32,3,7,10,30.0%,1h
34741,1,Alex,2388,138,2,1,3,66.7%,12m
34741,1,miegs,2388,145,2,6,8,25.0%,6m
34741,3,[ExTr1m]qBRybc,2388,120,2,6,8,25.0%,1h
34741,3,CoreOfGamer,2388,97,2,7,9,22.2%,6m
34741,1,electrowiz,2388,0,1,0,1,100.0%,1h
34741,1,[DEDAL]featboy,2388,0,1,0,1,100.0%,16m
34741,3,aliensgame,2388,0,1,0,1,100.0%,12m
34741,1,stifler,2388,0,1,1,2,50.0%,1h
34741,3,Anearion,2388,30,1,4,5,20.0%,6m
34741,1,RedKira,2388,0,1,4,5,20.0%,1h
34741,1,BattleFrog,2388,0,1,4,5,20.0%,4m
34741,1,Маxim,2388,0,1,4,5,20.0%,1h
34741,2,Yashmariman,2388,30,1,10,11,9.1%,1h
34741,1,Alex,2388,0,0,1,1,0.0%,7m
34741,1,general,2388,0,0,1,1,0.0%,1h
34780,3,Dropbear,2387,1212,103,104,207,49.8%,19m
34780,3,Night,2387,995,71,60,131,54.2%,9m
34780,1,ScorpionSMK,2387,1714,65,56,121,53.7%,29m
34780,3,хрень,2387,751,62,65,127,48.8%,19m
34780,3,Hellpepper,2387,793,32,23,55,58.2%,29m
34780,2,BlaSco,2387,800,29,42,71,40.8%,28m
34780,3,[2vs2v3]Blagovest,2387,634,28,19,47,59.6%,1h
34780,3,Saturn,2387,556,22,23,45,48.9%,28m
34780,3,[WTFvck]Natka,2387,545,21,19,40,52.5%,14m
34780,3,FARSH,2387,416,15,15,30,50.0%,1h
34780,1,Darknova,2387,502,14,16,30,46.7%,60m
34780,1,JDDDDDD,2387,354,14,24,38,36.8%,1h
34780,3,ComissaR,2387,292,10,15,25,40.0%,1h
34780,3,JujuTrue,2387,152,8,13,21,38.1%,7m
34780,2,PLNekro,2387,250,8,15,23,34.8%,6m
34780,2,lerad,2387,190,6,10,16,37.5%,1h
34780,3,JQdarck,2387,211,6,10,16,37.5%,20m
34780,1,Frank,2387,211,6,12,18,33.3%,1h
34780,1,Kingfear,2387,121,3,5,8,37.5%,1h
34780,1,weakling,2387,128,3,5,8,37.5%,27m
34780,1,[FMG]Sturm,2387,0,3,5,8,37.5%,1h
34780,1,[GLHFv2]CLOFt,2387,132,3,6,9,33.3%,28m
34780,3,Silmarillko,2387,0,2,6,8,25.0%,26m
34780,1,Philadelphia,2387,0,1,0,1,100.0%,8m
34780,1,ElCastigador,2387,0,1,0,1,100.0%,1h
34780,3,WOLFROAR,2387,0,1,4,5,20.0%,1h
34780,1,IIIIIIIIIIII,2387,0,1,4,5,20.0%,59m
34780,1,GaZZaRoL,2387,0,1,4,5,20.0%,1h
34780,1,[соклан]Денис,2387,0,1,4,5,20.0%,1h
34780,3,Anxious,2387,0,1,6,7,14.3%,24m
34780,1,Fandilo,2387,0,0,1,1,0.0%,16m
34780,1,VVMRiper,2387,0,0,1,1,0.0%,25m
34780,3,Артем,2387,0,0,1,1,0.0%,1h
34780,1,Turri,2387,0,0,2,2,0.0%,1h
34814,3,Mériok,2386,1590,167,164,331,50.5%,1h
34814,3,eurobelix,2386,1507,113,116,229,49.3%,12m
34814,1,Aliq,2386,1739,89,88,177,50.3%,1h
34814,3,NikoGeG,2386,1528,62,60,122,50.8%,3m
34814,3,ClaxiBaxi,2386,1229,56,60,116,48.3%,1h
34814,1,PaVeLK,2386,1120,56,68,124,45.2%,17m
34814,2,Pash,2386,1324,47,60,107,43.9%,8m
34814,2,Thuemper,2386,929,44,50,94,46.8%,1h
34814,2,artur,2386,957,35,41,76,46.1%,1h
34814,1,Titus,2386,952,32,45,77,41.6%,13m
34814,1,yogurt,2386,642,18,13,31,58.1%,14m
34814,1,Batools,2386,560,18,16,34,52.9%,59m
34814,3,CuiCui,2386,436,16,19,35,45.7%,19m
34814,1,[EGcz]Johnyroot,2386,496,13,6,19,68.4%,1h
34814,1,Vivi,2386,480,13,8,21,61.9%,1h
34814,1,Goran,2386,438,11,11,22,50.0%,1h
34814,1,IDAssasin,2386,288,8,3,11,72.7%,1h
34814,1,SkiLL,2386,320,8,8,16,50.0%,1h
34814,3,MGD,2386,215,7,6,13,53.8%,12m
34814,3,Atlas,2386,210,7,11,18,38.9%,19m
34814,3,[Dae]GulLeNecro,2386,172,6,9,15,40.0%,1h
34814,3,AnonyPadouer,2386,170,5,5,10,50.0%,10m
34814,2,ПластмассМир,2386,58,4,8,12,33.3%,17m
34814,3,zerginator,2386,141,3,4,7,42.9%,1h
34814,3,Vesiperä,2386,38,3,7,10,30.0%,1h
34814,1,[nr40]gracken,2386,130,2,1,3,66.7%,29m
34814,1,Joel,2386,44,2,2,4,50.0%,9m
34814,2,[CWCD]вапыапмивчам,2386,0,2,5,7,28.6%,1h
34814,1,Bloodwolf,2386,48,2,5,7,28.6%,1h
34814,1,CubanHermes,2386,73,2,6,8,25.0%,59m
34814,1,zagor,2386,0,1,1,2,50.0%,1h
34814,1,[CaLu]ericleloup,2386,44,1,1,2,50.0%,1h
34814,1,Jominathor,2386,44,1,3,4,25.0%,1h
34814,1,AnalniMaster,2386,0,1,4,5,20.0%,1h
34814,1,[Funke1]KEFOU,2386,48,1,4,5,20.0%,1h
34814,1,женя,2386,0,1,4,5,20.0%,1h
34814,1,haniv,2386,0,1,4,5,20.0%,59m
34814,1,Arpangor,2386,40,1,5,6,16.7%,26m
34814,1,oliviermrs,2386,0,0,1,1,0.0%,14m
34814,1,slvmpk,2386,0,0,3,3,0.0%,5m
34814,1,Praetor,2386,0,0,3,3,0.0%,10m
34814,1,Felix,2386,0,0,3,3,0.0%,1h
34814,3,Antiste,2386,0,0,4,4,0.0%,10m
34857,1,Naviester,2385,1600,62,70,132,47.0%,1h
34857,3,Rick,2385,1245,57,59,116,49.1%,59m
34857,1,SimplyGregor,2385,1122,54,11,65,83.1%,21m
34857,3,Gabriel,2385,902,54,51,105,51.4%,26m
34857,1,Oayder,2385,1392,53,47,100,53.0%,1h
34857,1,Dorifon,2385,1448,49,54,103,47.6%,16m
34857,3,Predator,2385,1006,46,45,91,50.5%,1h
34857,1,warpig,2385,1006,30,27,57,52.6%,1h
34857,3,jet,2385,458,17,25,42,40.5%,1h
34857,1,GBosh,2385,460,13,6,19,68.4%,18m
34857,1,qwertyokey,2385,333,12,17,29,41.4%,5m
34857,3,momo,2385,312,11,10,21,52.4%,15m
34857,3,[pubEU]Naiwato,2385,238,8,12,20,40.0%,12m
34857,1,xWhite,2385,242,7,6,13,53.8%,1h
34857,3,NitsahoN,2385,200,6,5,11,54.5%,1h
34857,2,Skyqa,2385,197,6,10,16,37.5%,1h
34857,1,RedFox,2385,208,5,4,9,55.6%,7m
34857,2,[CRA3]Pedro,2385,158,5,8,13,38.5%,25m
34857,3,JeppeLagge,2385,146,4,7,11,36.4%,26m
34857,1,GosuAppa,2385,193,4,7,11,36.4%,1h
34857,1,[GnF]vicmasta,2385,121,4,9,13,30.8%,9m
34857,2,[ExTr1m]Bruccie,2385,94,4,11,15,26.7%,1h
34857,1,ДжеймсБолт,2385,97,2,1,3,66.7%,10m
34857,2,destructor,2385,38,2,3,5,40.0%,1h
34857,3,iIiIiIiIi,2385,0,2,5,7,28.6%,22m
34857,1,[Тут]Smertnik,2385,0,1,0,1,100.0%,1h
34857,1,ArchI,2385,44,1,1,2,50.0%,1h
34857,1,SpoveQ,2385,0,1,1,2,50.0%,1h
34857,1,Gewürzgurke,2385,0,1,2,3,33.3%,1h
34857,1,Criminal,2385,46,1,3,4,25.0%,19m
34857,1,Archangel,2385,0,1,4,5,20.0%,59m
34857,1,[TRKH]Luffy,2385,0,1,4,5,20.0%,29m
34857,1,ryan,2385,0,1,4,5,20.0%,1h
34857,1,nada,2385,0,1,4,5,20.0%,1h
34857,3,Periq,2385,30,1,7,8,12.5%,1h
34857,1,TinMan,2385,0,0,1,1,0.0%,1h
34893,2,[AiRǂ]ReBianco,2384,1558,167,178,345,48.4%,12m
34893,1,Nininc,2384,1802,139,136,275,50.5%,1h
34893,1,ShowerFrench,2384,1665,134,116,250,53.6%,14m
34893,2,[PiChEL]Nxebre,2384,1488,90,89,179,50.3%,22m
34893,2,APride,2384,1224,83,86,169,49.1%,17m
34893,1,Muhuli,2384,1090,58,48,106,54.7%,1h
34893,2,Auron,2384,1131,56,64,120,46.7%,19m
34893,3,BOOMER,2384,1257,55,46,101,54.5%,5m
34893,3,sari,2384,565,45,50,95,47.4%,1h
34893,1,ТОПСКИЙПАВЕЛ,2384,1136,41,34,75,54.7%,1h
34893,1,Evg,2384,1142,38,30,68,55.9%,59m
34893,1,[PrTons]RedAngel,2384,1038,31,30,61,50.8%,20m
34893,3,Idicious,2384,681,25,25,50,50.0%,1h
34893,3,Amwas,2384,671,23,24,47,48.9%,21m
34893,3,Arbot,2384,469,17,18,35,48.6%,1h
34893,1,Doublekiller,2384,572,16,8,24,66.7%,1h
34893,1,[GTTGF]Ouhellouder,2384,474,12,12,24,50.0%,1h
34893,3,Agamemnon,2384,339,12,13,25,48.0%,30m
34893,1,DmitriusVII,2384,400,10,9,19,52.6%,1h
34893,3,[31Baka]Silver,2384,176,7,11,18,38.9%,1h
34893,1,[Flaw]SHiiNoBii,2384,207,7,14,21,33.3%,1h
34893,3,elgringo,2384,146,6,9,15,40.0%,28m
34893,1,[PRWNS]Royal,2384,128,4,3,7,57.1%,19m
34893,1,Soul,2384,96,3,2,5,60.0%,1h
34893,1,HuitSix,2384,141,3,5,8,37.5%,1h
34893,3,Dislokaynt,2384,0,3,6,9,33.3%,26m
34893,1,ToxicMan,2384,137,3,6,9,33.3%,59m
34893,1,Revolt,2384,48,3,6,9,33.3%,4m
34893,1,Manstein,2384,96,3,6,9,33.3%,1h
34893,1,[HaoS]Ghost,2384,40,2,0,2,100.0%,25m
34893,1,FTFTXH,2384,90,2,2,4,50.0%,1h
34893,1,leori,2384,132,2,5,7,28.6%,1h
34893,1,mozazord,2384,0,1,0,1,100.0%,1h
34893,1,NucleuS,2384,44,1,1,2,50.0%,59m
34893,1,[Какуля]andyNicon,2384,0,1,1,2,50.0%,11m
34893,3,Кикита,2384,0,1,1,2,50.0%,1h
34893,1,Jimmy,2384,48,1,4,5,20.0%,60m
34893,1,Yassine,2384,0,1,4,5,20.0%,60m
34893,1,Atagan,2384,0,1,4,5,20.0%,1h
34893,1,NikerGuns,2384,0,0,1,1,0.0%,26m
34893,1,irrational,2384,0,0,1,1,0.0%,19m
34893,3,JeanLuc,2384,0,0,2,2,0.0%,15m
34893,1,nekotrap,2384,0,0,3,3,0.0%,1h
34936,3,[ЭтоНе]Озабоченный,2383,1474,125,114,239,52.3%,12m
34936,2,[TyDud]Lentin,2383,1439,102,101,203,50.2%,1h
34936,1,[Zhig]остап,2383,1663,83,75,158,52.5%,1h
34936,3,effeM,2383,1255,82,79,161,50.9%,30m
34936,3,PinkMeth,2383,1027,62,53,115,53.9%,15m
34936,2,aleksey,2383,1103,41,45,86,47.7%,10m
34936,1,MerlinT,2383,915,30,27,57,52.6%,1h
34936,3,EyeCan,2383,700,28,28,56,50.0%,22m
34936,1,GLaDOS,2383,794,22,23,45,48.9%,10m
34936,1,[BWArmy]Iricommi,2383,414,10,10,20,50.0%,1h
34936,2,[ZELT]Venom,2383,332,10,18,28,35.7%,20m
34936,1,Massaraksh,2383,334,9,5,14,64.3%,25m
34936,1,CorvusCorax,2383,196,6,1,7,85.7%,23m
34936,3,SolidSnute,2383,218,6,9,15,40.0%,15m
34936,3,bubics,2383,177,6,11,17,35.3%,1h
34936,2,[wizurd]Teusku,2383,193,6,12,18,33.3%,1h
34936,3,BabYlone,2383,169,5,8,13,38.5%,23m
34936,1,OhtarFinrod,2383,116,4,2,6,66.7%,1h
34936,1,Sputnik,2383,125,4,8,12,33.3%,59m
34936,2,[JOG]Peelinator,2383,40,4,8,12,33.3%,26m
34936,3,[Inval]ПростоPony,2383,88,3,10,13,23.1%,1h
34936,1,BlackBaron,2383,0,1,0,1,100.0%,1h
34936,1,[AciNoN]ОДОРЕННЫЙ,2383,0,1,0,1,100.0%,59m
34936,1,paolo,2383,0,1,1,2,50.0%,1h
34936,1,Lurkerman,2383,42,1,2,3,33.3%,1h
34936,3,HellRacer,2383,0,1,3,4,25.0%,8m
34936,3,DIMON,2383,0,1,3,4,25.0%,6m
34936,1,Chiefo,2383,0,1,4,5,20.0%,1h
34936,1,Berkyt,2383,0,1,4,5,20.0%,28m
34936,2,Rakot,2383,0,0,1,1,0.0%,1h
34936,1,Marlon,2383,0,0,1,1,0.0%,1h
34936,1,[10Ping]IceStorm,2383,0,0,1,1,0.0%,8m
34936,1,vesel,2383,0,0,2,2,0.0%,9m
34936,1,meegyx,2383,0,0,3,3,0.0%,1h
34936,3,[keke]klesk,2383,0,0,8,8,0.0%,1h
34971,1,vanDeveloper,2382,1707,88,86,174,50.6%,1h
34971,1,Vovan,2382,821,51,47,98,52.0%,1h
34971,3,brand,2382,838,49,53,102,48.0%,1h
34971,3,Superbogee,2382,637,29,26,55,52.7%,15m
34971,1,LaPolitesse,2382,618,26,33,59,44.1%,7m
34971,1,[M4GYK]Konikonar,2382,562,15,17,32,46.9%,1h
34971,3,Dandelion,2382,367,13,18,31,41.9%,1h
34971,3,[RеG]Hunblee,2382,246,8,8,16,50.0%,1h
34971,2,Dagon,2382,228,8,19,27,29.6%,1h
34971,1,Cybernetics,2382,288,7,6,13,53.8%,21m
34971,3,MrFreemanRUS,2382,228,6,4,10,60.0%,29m
34971,2,rsh,2382,217,6,9,15,40.0%,1h
34971,3,[Heroes]sempie,2382,58,5,6,11,45.5%,1h
34971,1,HiPPOLOVE,2382,126,4,1,5,80.0%,9m
34971,1,TeaMoe,2382,156,4,10,14,28.6%,25m
34971,3,pov,2382,0,3,5,8,37.5%,1h
34971,3,Serabil,2382,62,3,8,11,27.3%,4m
34971,1,Declarance,2382,0,1,1,2,50.0%,5m
34971,3,byc,2382,97,1,4,5,20.0%,1h
34971,2,[zik]ale,2382,0,1,4,5,20.0%,1h
34971,2,[I3W]Linxsys,2382,0,1,4,5,20.0%,1h
34971,2,[RuRush]Romys,2382,0,0,1,1,0.0%,1h
34971,1,clio,2382,0,0,2,2,0.0%,1h
34994,1,haZZard,2381,1452,170,164,334,50.9%,10m
34994,3,jonyuomul,2381,1476,103,99,202,51.0%,4m
34994,1,racok,2381,900,83,94,177,46.9%,6m
34994,3,mnsov,2381,1421,75,76,151,49.7%,1h
34994,3,[UF2AC]Грач,2381,926,33,35,68,48.5%,10m
34994,3,jijikong,2381,689,26,26,52,50.0%,1h
34994,1,[TLDN]Pidoudoux,2381,808,23,20,43,53.5%,27m
34994,2,MiKaMoRe,2381,400,20,28,48,41.7%,1h
34994,3,RussianNoob,2381,355,14,12,26,53.8%,30m
34994,3,StarViking,2381,278,10,8,18,55.6%,1h
34994,1,CVS,2381,162,8,9,17,47.1%,1h
34994,3,vicodin,2381,232,7,7,14,50.0%,1h
34994,3,phoenix,2381,197,6,6,12,50.0%,1h
34994,3,FoozyWoozy,2381,204,6,6,12,50.0%,1h
34994,3,iksman,2381,118,6,10,16,37.5%,23m
34994,1,Vigo,2381,162,4,3,7,57.1%,1h
34994,1,[BDF]Belgi,2381,140,3,1,4,75.0%,1h
34994,1,Weetal,2381,132,3,3,6,50.0%,1h
34994,1,Alex,2381,97,2,0,2,100.0%,1h
34994,1,joge,2381,40,2,1,3,66.7%,28m
34994,1,BlackKevinS,2381,46,2,1,3,66.7%,1h
34994,2,RUMDUM,2381,0,2,6,8,25.0%,23m
34994,1,SirMarc,2381,122,2,6,8,25.0%,1h
34994,3,BLANK,2381,0,2,6,8,25.0%,1h
34994,3,terranID,2381,58,2,9,11,18.2%,16m
34994,3,destinyisall,2381,0,2,10,12,16.7%,16m
34994,3,ManlyBruno,2381,0,1,1,2,50.0%,20m
34994,3,Lukasz,2381,0,1,3,4,25.0%,1h
34994,2,Ashlaban,2381,0,1,4,5,20.0%,5m
34994,1,Igorka,2381,0,1,4,5,20.0%,28m
34994,3,Archeleos,2381,30,1,7,8,12.5%,1h
34994,1,[Pume]poskok,2381,0,0,2,2,0.0%,1h
34994,1,LinKendel,2381,0,0,5,5,0.0%,1h
34994,1,JFree,2381,0,0,5,5,0.0%,1h
34994,1,Borres,2381,0,0,6,6,0.0%,29m
35029,2,EricCatala,2380,1558,269,270,539,49.9%,9m
35029,2,Uladzimir,2380,1343,80,75,155,51.6%,1h
35029,1,SVA,2380,1449,58,58,116,50.0%,20m
35029,1,Garfunkel,2380,1500,49,48,97,50.5%,1h
35029,3,IAmStoned,2380,811,36,31,67,53.7%,1h
35029,2,[PCCCP]pcccp,2380,868,31,38,69,44.9%,1h
35029,2,ChakSobchak,2380,882,31,43,74,41.9%,1h
35029,1,Sibastion,2380,791,29,19,48,60.4%,1h
35029,1,smertinet,2380,822,26,24,50,52.0%,22m
35029,1,Eisenhower,2380,711,25,12,37,67.6%,1h
35029,3,[N00beh]Bubba,2380,642,23,22,45,51.1%,25m
35029,3,Kameleon,2380,586,21,25,46,45.7%,1h
35029,3,Roman,2380,384,13,13,26,50.0%,1h
35029,1,MaxOrk,2380,429,11,14,25,44.0%,59m
35029,1,Yoryix,2380,278,9,6,15,60.0%,1h
35029,3,Ifjúcsallád,2380,214,8,7,15,53.3%,7m
35029,3,Bloddyelbow,2380,211,7,5,12,58.3%,1h
35029,3,HELLSING,2380,193,6,5,11,54.5%,15m
35029,1,Sovic,2380,170,5,4,9,55.6%,27m
35029,1,Darus,2380,156,4,3,7,57.1%,5m
35029,3,Djskull,2380,97,4,4,8,50.0%,26m
35029,2,xixi,2380,173,4,9,13,30.8%,9m
35029,1,mikisim,2380,128,3,4,7,42.9%,1h
35029,1,[PTCLAN]TigaP,2380,42,2,0,2,100.0%,1h
35029,1,makrogol,2380,121,2,1,3,66.7%,1h
35029,1,Mentos,2380,97,2,4,6,33.3%,14m
35029,2,nikssa,2380,30,2,7,9,22.2%,12m
35029,1,Androne,2380,0,1,0,1,100.0%,28m
35029,1,Ronsemd,2380,0,1,1,2,50.0%,27m
35029,1,Дима,2380,96,1,2,3,33.3%,1h
35029,1,YNe,2380,0,1,2,3,33.3%,5m
35029,1,Techstar,2380,0,1,3,4,25.0%,25m
35029,1,[UnCoAr]Raynor,2380,0,1,4,5,20.0%,1h
35029,1,[BSKGa]Naghmart,2380,0,1,4,5,20.0%,25m
35029,3,Ninja,2380,42,1,6,7,14.3%,1h
35029,1,Mithrandir,2380,0,0,1,1,0.0%,29m
35065,1,SolidState,2379,1577,446,430,876,50.9%,20m
35065,1,Elrond,2379,1567,319,323,642,49.7%,26m
35065,2,Burrito,2379,1392,143,141,284,50.4%,1h
35065,3,[KANNAK]Fragmint,2379,1246,95,103,198,48.0%,23m
35065,3,meGs,2379,608,70,54,124,56.5%,4m
35065,3,[OSB]xiba,2379,1064,67,70,137,48.9%,12m
35065,1,Miki,2379,831,32,18,50,64.0%,26m
35065,2,Юрий,2379,716,25,31,56,44.6%,1h
35065,3,ShadowStorm,2379,286,23,24,47,48.9%,20m
35065,1,Tryfonus,2379,768,22,15,37,59.5%,1h
35065,1,Manos,2379,376,11,11,22,50.0%,16m
35065,3,WideEye,2379,170,8,9,17,47.1%,1h
35065,3,Дмитрий,2379,198,6,6,12,50.0%,11m
35065,1,[DKBrew]Riposte,2379,172,5,2,7,71.4%,1h
35065,1,Нопекас,2379,170,4,3,7,57.1%,1h
35065,3,Sky,2379,146,4,4,8,50.0%,1h
35065,2,[K0RM2]hunk,2379,134,4,6,10,40.0%,8m
35065,1,IIIIIIIIIIII,2379,96,4,7,11,36.4%,13m
35065,2,ZigZagudachi,2379,132,4,8,12,33.3%,1h
35065,2,MeyrP,2379,130,4,9,13,30.8%,1h
35065,1,lahciMx,2379,80,2,3,5,40.0%,1h
35065,1,абатур,2379,0,1,1,2,50.0%,7m
35065,1,Comi,2379,44,1,4,5,20.0%,1h
35065,1,BobMain,2379,0,1,4,5,20.0%,1h
35065,3,tigerac,2379,0,1,5,6,16.7%,1h
35065,2,LordDrako,2379,30,1,12,13,7.7%,17m
35091,3,Lauodamus,2378,1567,172,159,331,52.0%,1h
35091,3,tichef,2378,1538,109,110,219,49.8%,1h
35091,2,EKA,2378,792,82,77,159,51.6%,1h
35091,3,Alex,2378,640,42,38,80,52.5%,1h
35091,3,Darbo,2378,929,40,42,82,48.8%,1h
35091,1,Karpik,2378,988,35,40,75,46.7%,27m
35091,1,Ibsen,2378,626,18,11,29,62.1%,1h
35091,1,nosoypan,2378,495,17,10,27,63.0%,25m
35091,1,MGL,2378,499,14,11,25,56.0%,1h
35091,1,Namaste,2378,490,13,15,28,46.4%,1h
35091,3,NvX,2378,375,13,15,28,46.4%,4m
35091,3,SaucereR,2378,294,10,7,17,58.8%,1h
35091,3,Hesiodor,2378,260,10,16,26,38.5%,14m
35091,3,Arminius,2378,295,9,13,22,40.9%,1h
35091,2,timon,2378,231,9,13,22,40.9%,1h
35091,2,[Entеr]Dominus,2378,234,9,15,24,37.5%,17m
35091,3,[ЗИБиАГ]DimirSpybug,2378,192,8,7,15,53.3%,16m
35091,1,ABCD,2378,332,8,10,18,44.4%,15m
35091,1,Zapan,2378,256,7,3,10,70.0%,1h
35091,3,dilaudid,2378,220,7,12,19,36.8%,1h
35091,1,fringant,2378,172,5,4,9,55.6%,1h
35091,2,Sandman,2378,171,5,10,15,33.3%,4m
35091,1,Adrien,2378,0,4,4,8,50.0%,30m
35091,1,Wilson,2378,0,3,3,6,50.0%,1h
35091,3,[TGCH]CheekyC,2378,112,3,5,8,37.5%,22m
35091,1,RXL,2378,40,2,0,2,100.0%,1h
35091,1,серега,2378,70,2,1,3,66.7%,1h
35091,1,kriis,2378,40,2,4,6,33.3%,60m
35091,3,ChikiPuki,2378,95,2,5,7,28.6%,4m
35091,3,Boandlcramer,2378,97,2,8,10,20.0%,27m
35091,1,HagenSmL,2378,0,1,0,1,100.0%,8m
35091,1,TRENETE,2378,0,1,0,1,100.0%,1h
35091,1,Metal,2378,0,1,0,1,100.0%,29m
35091,1,[Hrѓ]KamyshevSV,2378,44,1,3,4,25.0%,26m
35091,2,[MrCl]Camerius,2378,0,1,6,7,14.3%,1h
35091,3,Misael,2378,0,0,1,1,0.0%,60m
35091,1,AlexNSK,2378,0,0,1,1,0.0%,1h
35091,1,Barm,2378,0,0,2,2,0.0%,1h
35091,3,Фаербат,2378,0,0,2,2,0.0%,1h
35091,1,tgvmax,2378,0,0,3,3,0.0%,19m
35091,3,Roedie,2378,0,0,6,6,0.0%,1h
35091,3,Fepippuz,2378,0,0,7,7,0.0%,29m
35133,2,Romcom,2377,1497,157,153,310,50.6%,18m
35133,2,Zumbalalla,2377,1515,96,109,205,46.8%,1h
35133,3,Busat,2377,1305,69,67,136,50.7%,5m
35133,3,Namiro,2377,1318,64,67,131,48.9%,1h
35133,3,BigStacks,2377,552,52,55,107,48.6%,9m
35133,1,BeatMeGoGold,2377,1049,44,45,89,49.4%,1h
35133,1,[OPStar]Vadim,2377,1097,42,26,68,61.8%,25m
35133,1,Ratsistis,2377,858,33,29,62,53.2%,16m
35133,1,Iwan,2377,1028,32,24,56,57.1%,1h
35133,3,SundayNight,2377,111,12,9,21,57.1%,9m
35133,3,ULTRAARNE,2377,272,9,14,23,39.1%,21m
35133,2,Areii,2377,220,9,15,24,37.5%,1h
35133,2,DarkEthanX,2377,86,7,5,12,58.3%,1h
35133,1,Roker,2377,97,5,2,7,71.4%,6m
35133,1,Qortex,2377,154,4,5,9,44.4%,9m
35133,3,lukiduki,2377,49,4,8,12,33.3%,12m
35133,3,MerKnife,2377,123,3,3,6,50.0%,1h
35133,1,Kaihjaker,2377,122,3,4,7,42.9%,26m
35133,3,[EGcz]GenieCZ,2377,145,3,5,8,37.5%,29m
35133,3,yellow,2377,30,3,7,10,30.0%,1h
35133,1,[BZIG]coupe,2377,48,2,1,3,66.7%,10m
35133,3,Rasslabuha,2377,0,1,0,1,100.0%,23m
35133,2,babok,2377,0,1,0,1,100.0%,25m
35133,1,DunkanZmey,2377,42,1,1,2,50.0%,1h
35133,3,Vper,2377,0,1,2,3,33.3%,1h
35133,2,ALHK,2377,0,1,2,3,33.3%,1h
35133,3,Bogus,2377,95,1,3,4,25.0%,1h
35133,1,Reidan,2377,44,1,4,5,20.0%,20m
35133,1,ManDron,2377,0,0,1,1,0.0%,1h
35133,1,Afinjer,2377,0,0,1,1,0.0%,1h
35133,3,Seosasha,2377,0,0,1,1,0.0%,60m
35133,1,Juggernaut,2377,0,0,1,1,0.0%,1h
35133,3,Dimetrodon,2377,0,0,6,6,0.0%,15m
35166,1,zotov,2376,1846,112,109,221,50.7%,1h
35166,3,Sneik,2376,1221,79,81,160,49.4%,4m
35166,2,Narrator,2376,838,65,76,141,46.1%,20m
35166,3,Yelf,2376,971,43,45,88,48.9%,1h
35166,1,CaptainLippy,2376,835,32,24,56,57.1%,1h
35166,2,[Горцы]blue,2376,846,32,41,73,43.8%,1h
35166,3,[BigRat]qZilot,2376,579,26,18,44,59.1%,29m
35166,1,Juan,2376,813,24,19,43,55.8%,29m
35166,3,[GiRLgg]CuteKitty,2376,442,18,14,32,56.2%,28m
35166,2,MrJarod,2376,522,18,25,43,41.9%,1h
35166,3,Hammer,2376,354,14,18,32,43.8%,16m
35166,1,vitos,2376,273,10,15,25,40.0%,1h
35166,3,Slepoy,2376,267,9,13,22,40.9%,15m
35166,1,Макс,2376,254,9,16,25,36.0%,1h
35166,2,Alex,2376,194,8,36,44,18.2%,19m
35166,1,Правоверный,2376,300,7,7,14,50.0%,1h
35166,3,FellowCitize,2376,230,7,11,18,38.9%,1h
35166,1,Rhagnar,2376,246,7,24,31,22.6%,14m
35166,2,Justin,2376,30,5,4,9,55.6%,8m
35166,3,apolyon,2376,86,4,4,8,50.0%,1h
35166,3,[Svin4]DragonPig,2376,173,4,6,10,40.0%,14m
35166,1,Капитан,2376,160,4,7,11,36.4%,1h
35166,3,Ulan,2376,88,4,8,12,33.3%,19m
35166,2,GoodMonstr,2376,0,3,2,5,60.0%,1h
35166,3,efkeney,2376,38,3,5,8,37.5%,1h
35166,1,forfad,2376,44,2,0,2,100.0%,1h
35166,1,phantom,2376,42,2,1,3,66.7%,1h
35166,2,Mayday,2376,0,2,3,5,40.0%,1h
35166,1,MISHI,2376,0,1,0,1,100.0%,1h
35166,2,Hellein,2376,0,1,4,5,20.0%,1h
35166,1,[InitRu]НаглыйКЫС,2376,0,0,1,1,0.0%,1h
35166,3,Sayano,2376,0,0,1,1,0.0%,16m
35166,1,sid,2376,0,0,1,1,0.0%,5m
35166,1,[RofIer]SkilleT,2376,0,0,2,2,0.0%,1h
35166,1,smith,2376,0,0,2,2,0.0%,23m
35166,3,анд,2376,0,0,4,4,0.0%,1h
35202,3,Leonidas,2375,1579,138,127,265,52.1%,1h
35202,3,kroops,2375,1561,111,107,218,50.9%,11m
35202,1,Iarba,2375,1384,43,41,84,51.2%,5m
35202,2,Sibanac,2375,263,38,38,76,50.0%,1h
35202,3,Nevermind,2375,739,28,29,57,49.1%,27m
35202,3,OrngOrngOrng,2375,616,26,24,50,52.0%,1h
35202,1,[P0W3RD]Adolphus,2375,489,14,12,26,53.8%,1h
35202,1,[Ash3s]Geofke,2375,482,13,11,24,54.2%,1h
35202,1,[NOOBpl]PiewcaBurzy,2375,415,13,15,28,46.4%,1h
35202,1,Krasty,2375,326,12,7,19,63.2%,1h
35202,2,[XKROOG]Kajmak,2375,346,12,21,33,36.4%,1h
35202,3,[WАSD]SOFT,2375,298,11,14,25,44.0%,1h
35202,1,Celestant,2375,286,10,8,18,55.6%,60m
35202,3,Falham,2375,257,10,11,21,47.6%,1h
35202,2,churkini,2375,137,6,12,18,33.3%,60m
35202,1,RaRaRasputin,2375,206,5,5,10,50.0%,9m
35202,1,llllllllllll,2375,126,4,2,6,66.7%,1h
35202,3,[OPMFS]ashakni,2375,141,4,4,8,50.0%,1h
35202,1,[BloTi]KinderPingui,2375,166,4,4,8,50.0%,1h
35202,2,akadeMikk,2375,0,2,1,3,66.7%,16m
35202,1,Gamebreaker,2375,44,2,2,4,50.0%,16m
35202,1,[RBlood]icare,2375,84,2,3,5,40.0%,1h
35202,1,pacijent,2375,0,1,0,1,100.0%,1h
35202,3,SIL,2375,0,1,3,4,25.0%,1h
35202,2,oursous,2375,0,1,4,5,20.0%,1h
35202,2,PutinisJesus,2375,0,1,4,5,20.0%,1h
35202,1,lunaflower,2375,0,1,4,5,20.0%,28m
35202,1,[Белшир]BlackNinja,2375,90,1,5,6,16.7%,28m
35202,2,XEF,2375,44,1,8,9,11.1%,10m
35202,1,Azoth,2375,0,0,1,1,0.0%,1h
35202,1,[Moobs]Jackinatorz,2375,0,0,1,1,0.0%,1h
35202,1,Rus,2375,0,0,1,1,0.0%,1h
35202,3,[3GBY]Kyrachkoka,2375,0,0,2,2,0.0%,15m
35202,1,[Xenor]DarkStorm,2375,73,0,2,2,0.0%,5m
35236,2,Toran,2374,1490,91,89,180,50.6%,6m
35236,3,lefty,2374,1533,88,84,172,51.2%,1h
35236,1,abce,2374,1025,33,33,66,50.0%,25m
35236,1,Byoz,2374,650,28,27,55,50.9%,5m
35236,1,iLiLiLiLiLiL,2374,864,27,26,53,50.9%,1h
35236,3,Jungleice,2374,472,16,21,37,43.2%,60m
35236,3,Wonziu,2374,304,13,17,30,43.3%,15m
35236,3,GeneralSkimp,2374,398,13,23,36,36.1%,1h
35236,3,Barryslav,2374,313,11,13,24,45.8%,6m
35236,1,Kuras,2374,366,9,8,17,52.9%,60m
35236,1,llllllllll,2374,208,6,4,10,60.0%,29m
35236,2,LEGGEONS,2374,114,6,5,11,54.5%,1h
35236,3,[WTFRUS]IIIIIII,2374,163,4,5,9,44.4%,1h
35236,3,[Sencor]Leguan,2374,156,4,6,10,40.0%,1h
35236,3,theJeSTeR,2374,114,4,10,14,28.6%,11m
35236,1,[LEZZO]parafinìco,2374,166,3,1,4,75.0%,1h
35236,1,[eRZGEb]CommanderFun,2374,96,3,1,4,75.0%,1h
35236,1,ZeAvenger,2374,90,3,2,5,60.0%,14m
35236,1,[DaFF]MOISTLING,2374,42,2,0,2,100.0%,1h
35236,1,Simonster,2374,84,2,2,4,50.0%,9m
35236,1,[LöK]Handfast,2374,145,2,3,5,40.0%,13m
35236,1,Tengu,2374,0,2,5,7,28.6%,1h
35236,1,SABER,2374,97,2,5,7,28.6%,6m
35236,2,BezDnB,2374,0,2,6,8,25.0%,1h
35236,1,DrKisel,2374,0,1,0,1,100.0%,1h
35236,1,[izako]BoarsKratos,2374,0,1,0,1,100.0%,1h
35236,1,Blinchik,2374,40,1,1,2,50.0%,14m
35236,1,Wyatt,2374,0,1,1,2,50.0%,20m
35236,1,Doniklek,2374,0,1,1,2,50.0%,24m
35236,1,MrSkapsen,2374,0,0,1,1,0.0%,1h
35236,1,Banana,2374,0,0,2,2,0.0%,1h
35236,1,LinaRia,2374,0,0,2,2,0.0%,12m
35268,3,Saiyan,2373,1594,232,230,462,50.2%,22m
35268,3,RedPhoenix,2373,1463,153,162,315,48.6%,1h
35268,2,Claw,2373,786,63,64,127,49.6%,1h
35268,1,GARMELIO,2373,1629,58,51,109,53.2%,60m
35268,1,Arespartano,2373,1512,53,50,103,51.5%,28m
35268,1,niemand,2373,711,35,48,83,42.2%,10m
35268,3,Atomiusz,2373,665,24,24,48,50.0%,27m
35268,1,Kneusje,2373,520,20,23,43,46.5%,19m
35268,1,ThisIdiot,2373,281,18,36,54,33.3%,1h
35268,1,starterran,2373,515,15,8,23,65.2%,1h
35268,3,YOUSHIiTNOOB,2373,374,14,18,32,43.8%,28m
35268,2,grishman,2373,269,10,16,26,38.5%,29m
35268,3,Giverlet,2373,266,9,15,24,37.5%,1h
35268,2,Status,2373,64,7,9,16,43.8%,6m
35268,3,mediaoffline,2373,176,7,10,17,41.2%,1h
35268,1,ignatsan,2373,173,5,8,13,38.5%,1h
35268,1,misa,2373,198,4,7,11,36.4%,29m
35268,1,[WÓDKA1]PIOTER,2373,44,2,1,3,66.7%,30m
35268,1,[RoWaR]Luci,2373,70,2,2,4,50.0%,1h
35268,3,Spiridon,2373,30,2,6,8,25.0%,1h
35268,1,HoraTpyna,2373,0,1,2,3,33.3%,5m
35268,1,[zergxp]michael,2373,44,1,4,5,20.0%,60m
35268,2,BalD,2373,0,1,4,5,20.0%,1h
35268,2,Andys,2373,0,1,4,5,20.0%,19m
35268,2,gamerOx,2373,0,1,4,5,20.0%,13m
35268,1,[Chariz]ШтаныУдачи,2373,99,1,7,8,12.5%,1h
35268,1,DaBerBer,2373,0,0,1,1,0.0%,1h
35268,1,ShaiTanchik,2373,0,0,1,1,0.0%,1h
35268,2,Manolotron,2373,0,0,1,1,0.0%,1h
35268,1,Moin,2373,0,0,3,3,0.0%,19m
35268,1,RUINICALE,2373,0,0,3,3,0.0%,1h
35299,3,KMC,2372,1134,147,138,285,51.6%,5m
35299,3,Tetard,2372,1536,145,130,275,52.7%,1h
35299,3,Sympak,2372,1602,131,130,261,50.2%,4m
35299,3,LOW,2372,543,44,54,98,44.9%,1h
35299,3,Stalker,2372,722,26,34,60,43.3%,26m
35299,3,Eol,2372,638,22,29,51,43.1%,1h
35299,3,BigC,2372,538,18,20,38,47.4%,60m
35299,1,soszkers,2372,414,11,8,19,57.9%,1h
35299,1,Lucas,2372,420,11,9,20,55.0%,29m
35299,1,[AviaN]Berserker,2372,236,10,14,24,41.7%,22m
35299,1,oliverkush,2372,265,8,5,13,61.5%,1h
35299,1,ГрАл,2372,212,7,3,10,70.0%,1h
35299,1,WarHound,2372,142,5,10,15,33.3%,29m
35299,1,[MGT]Srague,2372,124,4,4,8,50.0%,29m
35299,3,MAMOHT,2372,139,4,5,9,44.4%,1h
35299,1,[RstE]Bibow,2372,179,4,8,12,33.3%,14m
35299,2,aidaxxxoyt,2372,0,3,2,5,60.0%,1h
35299,1,[PH4L]Blaze,2372,169,3,4,7,42.9%,1h
35299,1,[Goldi]GoldDieb,2372,48,3,4,7,42.9%,1h
35299,2,[13Rätt]Sweadde,2372,125,3,5,8,37.5%,1h
35299,3,Ivacomrad,2372,58,3,5,8,37.5%,4m
35299,1,[БАНДА]PIONEER,2372,92,2,1,3,66.7%,1h
35299,1,Ванелин,2372,86,2,2,4,50.0%,60m
35299,3,PapaMonkei,2372,93,2,3,5,40.0%,1h
35299,1,StimPackZerg,2372,48,2,6,8,25.0%,6m
35299,1,[AnGaSt]Пепячник,2372,48,2,6,8,25.0%,1h
35299,1,pingvin,2372,40,1,1,2,50.0%,1h
35299,1,puchy,2372,0,1,4,5,20.0%,20m
35299,1,Cocojambo,2372,0,1,4,5,20.0%,12m
35299,1,[Profix]Unikum,2372,0,0,1,1,0.0%,1h
35299,1,Fenrir,2372,0,0,1,1,0.0%,11m
35299,2,Fllo,2372,0,0,2,2,0.0%,1h
35331,3,Goran,2371,1530,181,178,359,50.4%,19m
35331,1,RubenWarrior,2371,1565,96,94,190,50.5%,14m
35331,3,[BUND]WorkerRash,2371,952,56,47,103,54.4%,4m
35331,1,Vuk,2371,1494,55,55,110,50.0%,16m
35331,3,[RRQ]DoOla,2371,383,15,17,32,46.9%,15m
35331,3,George,2371,426,15,18,33,45.5%,19m
35331,2,robair,2371,388,11,20,31,35.5%,19m
35331,1,Zohan,2371,261,9,4,13,69.2%,1h
35331,1,ElKomendante,2371,278,8,4,12,66.7%,1h
35331,1,[Lab14]Mihailovescu,2371,183,6,12,18,33.3%,1h
35331,3,Astral,2371,169,5,8,13,38.5%,9m
35331,3,WildPants,2371,179,4,7,11,36.4%,1h
35331,2,leonpapanoel,2371,60,4,8,12,33.3%,1h
35331,1,Military,2371,88,3,3,6,50.0%,26m
35331,1,Warford,2371,97,2,4,6,33.3%,1h
35331,1,[RuRø]Mitaxius,2371,97,2,5,7,28.6%,1h
35331,1,Hardy,2371,48,2,6,8,25.0%,6m
35331,3,Sobolinko,2371,62,2,20,22,9.1%,16m
35331,1,valerraTV,2371,0,1,0,1,100.0%,26m
35331,1,Bizzzon,2371,0,1,0,1,100.0%,8m
35331,3,[UbS]Smoople,2371,32,1,4,5,20.0%,23m
35331,1,warofblood,2371,0,0,1,1,0.0%,1h
35331,1,HarmfulLife,2371,0,0,1,1,0.0%,1h
35331,1,xgremlinx,2371,0,0,2,2,0.0%,14m
35331,1,Victoriox,2371,0,0,2,2,0.0%,1h
35331,1,floghju,2371,0,0,2,2,0.0%,1h
35331,2,wolf,2371,0,0,2,2,0.0%,12m
35331,2,[CthKs]Devilsock,2371,0,0,4,4,0.0%,1h
35359,2,oldboy,2370,1566,233,240,473,49.3%,1h
35359,2,Spitamenes,2370,1521,138,142,280,49.3%,1h
35359,3,englishfox,2370,1544,127,118,245,51.8%,7m
35359,3,sunlight,2370,1367,86,68,154,55.8%,17m
35359,2,Optimus,2370,913,59,63,122,48.4%,1h
35359,1,Geniusua,2370,1000,57,45,102,55.9%,1h
35359,3,JonSilver,2370,1197,54,56,110,49.1%,12m
35359,1,Sheparde,2370,1202,39,39,78,50.0%,3m
35359,2,UPYR,2370,598,23,26,49,46.9%,1h
35359,1,fedrix,2370,185,6,12,18,33.3%,6m
35359,3,[Shteum]WilouGhost,2370,157,4,3,7,57.1%,1h
35359,1,JeanJulian,2370,174,4,6,10,40.0%,12m
35359,3,[MSII]Alti,2370,169,4,6,10,40.0%,19m
35359,1,RomUluS,2370,82,2,2,4,50.0%,14m
35359,3,Arrie,2370,107,2,4,6,33.3%,27m
35359,1,[NSJLM]Yangchou,2370,0,2,5,7,28.6%,29m
35359,3,Dubchak,2370,97,2,6,8,25.0%,20m
35359,3,BORMASHINKA,2370,24,2,6,8,25.0%,1h
35359,2,[LIQUID]Jacob,2370,30,2,8,10,20.0%,1h
35359,3,CGeneral,2370,0,1,0,1,100.0%,1h
35359,1,Rafale,2370,44,1,1,2,50.0%,9m
35359,1,[Habibs]Dhulqarnain,2370,0,1,1,2,50.0%,1h
35359,1,[PS23]TheMagicCoin,2370,0,1,4,5,20.0%,9m
35359,1,Шакир,2370,44,1,5,6,16.7%,1h
35359,1,Varatharg,2370,0,1,6,7,14.3%,1h
35359,3,alexzzx,2370,0,0,2,2,0.0%,7m
35359,2,major,2370,0,0,2,2,0.0%,26m
35386,3,potesmok,2369,940,121,122,243,49.8%,1h
35386,1,CovidTonsac,2369,1680,99,92,191,51.8%,21m
35386,1,Kulgan,2369,1825,92,90,182,50.5%,1h
35386,1,Eidrift,2369,502,57,58,115,49.6%,1h
35386,2,[DomPre]КРУШИНКА,2369,825,48,55,103,46.6%,19m
35386,3,HozHun,2369,350,14,18,32,43.8%,1h
35386,1,punisher,2369,222,8,8,16,50.0%,24m
35386,1,ELNER,2369,246,8,10,18,44.4%,1h
35386,1,Teropl,2369,217,7,10,17,41.2%,5m
35386,3,[SC2T4K]Porcinerate,2369,251,7,11,18,38.9%,15m
35386,1,pyrospk,2369,240,6,8,14,42.9%,5m
35386,3,Poh,2369,177,4,8,12,33.3%,1h
35386,1,Feel,2369,0,3,3,6,50.0%,1h
35386,3,John,2369,0,3,3,6,50.0%,1h
35386,1,Chubaka,2369,48,2,2,4,50.0%,1h
35386,1,TamIIJIueP,2369,48,2,3,5,40.0%,1h
35386,1,ZeroPlay,2369,48,2,6,8,25.0%,1h
35386,1,Julian,2369,97,2,6,8,25.0%,25m
35386,1,wonddak,2369,0,1,0,1,100.0%,28m
35386,1,[Aorus]IIStrongerII,2369,0,1,1,2,50.0%,9m
35386,1,BobSnot,2369,42,1,3,4,25.0%,1h
35386,1,Rolferen,2369,44,1,3,4,25.0%,15m
35386,1,utu,2369,44,1,3,4,25.0%,1h
35386,3,Mdpommes,2369,0,1,5,6,16.7%,4m
35386,1,Argandios,2369,0,0,1,1,0.0%,12m
35386,1,[Fonta]thepussyman,2369,0,0,1,1,0.0%,19m
35386,1,Sonecas,2369,0,0,3,3,0.0%,1h
35386,1,kuroca,2369,0,0,3,3,0.0%,1h
35386,1,LeGeNda,2369,73,0,5,5,0.0%,1h
35415,3,kalokalo,2368,1486,227,220,447,50.8%,20m
35415,3,Knight,2368,1545,191,196,387,49.4%,9m
35415,3,Soseji,2368,1570,172,168,340,50.6%,1h
35415,3,ZED,2368,1497,83,79,162,51.2%,18m
35415,1,[Olney]Skeletor,2368,1248,44,33,77,57.1%,1h
35415,3,okletspartyE,2368,828,30,34,64,46.9%,6m
35415,1,DeepWeb,2368,771,28,17,45,62.2%,9m
35415,1,iLoVeYoUaloT,2368,567,27,6,33,81.8%,28m
35415,2,jaguartordu,2368,544,20,27,47,42.6%,6m
35415,3,[TTTT]Albert,2368,339,12,12,24,50.0%,27m
35415,1,Hook,2368,216,11,13,24,45.8%,4m
35415,3,[Peeps]RickyTheDoom,2368,322,11,21,32,34.4%,1h
35415,1,Apare,2368,359,10,3,13,76.9%,25m
35415,1,[Dz1ady]Murgfulk,2368,204,6,5,11,54.5%,28m
35415,1,Рентген,2368,162,5,1,6,83.3%,1h
35415,3,Solhatten,2368,117,5,6,11,45.5%,1h
35415,3,Vezzlan,2368,175,4,7,11,36.4%,1h
35415,1,[NerCC]DerKnecker,2368,166,4,8,12,33.3%,1h
35415,3,TheTRUTH,2368,92,3,8,11,27.3%,12m
35415,3,[Fonta]DarkDod,2368,48,3,9,12,25.0%,10m
35415,3,QuickBen,2368,0,2,5,7,28.6%,1h
35415,3,obican,2368,0,2,6,8,25.0%,23m
35415,3,rafii,2368,36,1,4,5,20.0%,21m
35415,3,[DonMar]TimurЧикЧик,2368,0,1,6,7,14.3%,23m
35415,1,[CTO]Jakob,2368,0,0,1,1,0.0%,26m
35415,3,Viix,2368,0,0,1,1,0.0%,6m
35415,1,vadya,2368,0,0,1,1,0.0%,26m
35415,1,Finnosaurus,2368,0,0,2,2,0.0%,1h
35443,2,Naruto,2367,1428,122,120,242,50.4%,1h
35443,3,Zmarcaz,2367,1462,112,103,215,52.1%,30m
35443,3,MAX,2367,1511,102,94,196,52.0%,30m
35443,2,Bajula,2367,1466,68,79,147,46.3%,1h
35443,1,feduzgero,2367,1410,50,45,95,52.6%,1h
35443,1,krikrecord,2367,993,40,23,63,63.5%,27m
35443,3,IceCreamSell,2367,796,35,39,74,47.3%,9m
35443,3,killer,2367,360,15,12,27,55.6%,22m
35443,1,LordTorpeda,2367,452,12,11,23,52.2%,21m
35443,3,Kalaidr,2367,244,8,10,18,44.4%,4m
35443,1,[1nTeaM]Bonew,2367,290,7,6,13,53.8%,1h
35443,1,BBZ,2367,250,7,7,14,50.0%,1h
35443,1,[ImbaG]Vladimir,2367,246,6,4,10,60.0%,28m
35443,3,[ROMN]CACINAA,2367,186,6,12,18,33.3%,7m
35443,1,[ZERGTV]NeelPride,2367,166,5,2,7,71.4%,28m
35443,2,[Ascool]Storhävdarn,2367,152,5,17,22,22.7%,1h
35443,1,Pick,2367,172,4,7,11,36.4%,9m
35443,1,dacolo,2367,96,3,6,9,33.3%,1h
35443,1,[GRWIII]Meckill,2367,48,2,2,4,50.0%,1h
35443,1,Rygel,2367,0,2,4,6,33.3%,1h
35443,3,Andersson,2367,0,2,6,8,25.0%,10m
35443,1,lasys,2367,48,2,6,8,25.0%,12m
35443,1,[4672]Metron,2367,0,2,6,8,25.0%,4m
35443,3,GangstaNupe,2367,58,2,7,9,22.2%,1h
35443,2,trelled,2367,0,1,0,1,100.0%,12m
35443,1,Akella,2367,0,1,1,2,50.0%,19m
35443,1,Roli,2367,0,1,1,2,50.0%,1h
35443,1,HellNoob,2367,0,1,1,2,50.0%,1h
35443,1,maidhros,2367,0,1,2,3,33.3%,1h
35443,3,[Un00bz]SpecOps,2367,0,1,2,3,33.3%,25m
35443,2,Niskanen,2367,0,1,4,5,20.0%,1h
35443,1,[LSPs]EiGzEiZeLL,2367,0,0,1,1,0.0%,27m
35443,1,[D3Q]dGraW,2367,0,0,1,1,0.0%,12m
35443,1,IncisivJaune,2367,0,0,1,1,0.0%,5m
35443,1,[бобр]egir,2367,0,0,2,2,0.0%,1h
35443,2,[2580]Raimas,2367,0,0,5,5,0.0%,22m
35479,1,Petrovich,2366,1556,83,81,164,50.6%,1h
35479,3,Valokordin,2366,963,49,46,95,51.6%,8m
35479,2,[OmDi]Hashlael,2366,1229,49,52,101,48.5%,1h
35479,1,Eveee,2366,1174,39,34,73,53.4%,1h
35479,1,Michmant,2366,1094,35,32,67,52.2%,19m
35479,3,Bollock,2366,568,24,28,52,46.2%,8m
35479,3,Soodyyoshi,2366,454,18,20,38,47.4%,17m
35479,3,BigTo,2366,510,18,22,40,45.0%,1h
35479,2,VVladanVV,2366,502,18,27,45,40.0%,1h
35479,1,Inger,2366,499,17,13,30,56.7%,1h
35479,3,Zecater,2366,352,12,13,25,48.0%,15m
35479,1,Kerrigan,2366,404,10,11,21,47.6%,1h
35479,3,[darhal]Emandarx,2366,279,9,10,19,47.4%,17m
35479,3,Exupéry,2366,183,6,9,15,40.0%,6m
35479,1,Gerferen,2366,206,5,0,5,100.0%,17m
35479,1,DrSceern,2366,130,5,3,8,62.5%,1h
35479,3,TheWizard,2366,122,4,9,13,30.8%,5m
35479,1,PaniC,2366,0,3,2,5,60.0%,27m
35479,1,DeDMoIIeD,2366,130,3,6,9,33.3%,12m
35479,1,JOHNT,2366,44,2,0,2,100.0%,29m
35479,1,Prophet,2366,44,2,2,4,50.0%,21m
35479,1,diamond,2366,82,2,3,5,40.0%,1h
35479,2,Aleratorz,2366,0,2,3,5,40.0%,14m
35479,1,[LCGmen]TBird,2366,97,2,4,6,33.3%,1h
35479,3,SuchY,2366,30,2,8,10,20.0%,21m
35479,1,jeanpipi,2366,0,1,0,1,100.0%,1h
35479,2,Глеб,2366,0,1,4,5,20.0%,1h
35479,2,SuuB,2366,0,1,4,5,20.0%,19m
35479,1,ELJey,2366,42,1,5,6,16.7%,5m
35479,3,KillerMaster,2366,0,1,5,6,16.7%,1h
35479,1,Gromgt,2366,0,0,1,1,0.0%,29m
35479,1,notsogood,2366,0,0,2,2,0.0%,1h
35511,3,stefanzovski,2365,1533,126,107,233,54.1%,1h
35511,3,picatrix,2365,1594,120,124,244,49.2%,7m
35511,3,TomJack,2365,1525,104,105,209,49.8%,1h
35511,3,ГетьманГроза,2365,1542,91,87,178,51.1%,1h
35511,3,german,2365,1384,90,91,181,49.7%,1h
35511,1,Lukasar,2365,1625,72,70,142,50.7%,1h
35511,1,KarakoS,2365,1408,48,45,93,51.6%,21m
35511,3,Ragnarson,2365,1073,46,52,98,46.9%,1h
35511,1,Amos,2365,887,36,32,68,52.9%,11m
35511,3,SemiGhoul,2365,583,24,22,46,52.2%,8m
35511,3,SAMURAIVAAJA,2365,416,22,14,36,61.1%,22m
35511,1,[лунааа]starkiller,2365,422,14,12,26,53.8%,20m
35511,1,Ashkarhemk,2365,272,9,9,18,50.0%,1h
35511,1,Маноберн,2365,263,8,4,12,66.7%,1h
35511,3,Brines,2365,215,7,7,14,50.0%,1h
35511,1,Lochnes,2365,168,5,2,7,71.4%,12m
35511,1,Pavel,2365,120,4,4,8,50.0%,29m
35511,3,Spoiler,2365,118,4,9,13,30.8%,1h
35511,3,IIIIIIIIII,2365,121,3,1,4,75.0%,1h
35511,1,Xdream,2365,88,3,4,7,42.9%,1h
35511,3,Spawn,2365,40,3,8,11,27.3%,1h
35511,2,FiremanSam,2365,0,3,8,11,27.3%,20m
35511,2,persraiskari,2365,66,3,17,20,15.0%,1h
35511,1,aspotashev,2365,44,2,2,4,50.0%,1h
35511,1,cescmn,2365,86,2,3,5,40.0%,1h
35511,1,niknikitin,2365,0,2,3,5,40.0%,60m
35511,3,OneStepClosr,2365,30,2,4,6,33.3%,29m
35511,1,TNTan,2365,84,2,5,7,28.6%,1h
35511,3,Hethron,2365,0,1,1,2,50.0%,16m
35511,1,TaSeAn,2365,0,1,1,2,50.0%,3m
35511,1,MHaddami,2365,0,1,3,4,25.0%,25m
35511,2,Daren,2365,0,1,4,5,20.0%,1h
35511,3,[Nouset]Ivan,2365,0,1,4,5,20.0%,21m
35511,2,Leon,2365,0,1,4,5,20.0%,1h
35511,2,ZuperZ,2365,0,1,4,5,20.0%,8m
35511,1,LongJohnson,2365,42,1,5,6,16.7%,1h
35511,3,hutkiz,2365,0,1,5,6,16.7%,1h
35511,3,bastiboy,2365,0,1,5,6,16.7%,1h
35511,1,duejj,2365,0,0,2,2,0.0%,1h
35511,1,[MadKuy]GachiVanya,2365,0,0,3,3,0.0%,11m
35551,2,mados,2364,1466,191,190,381,50.1%,1h
35551,2,Hiorumarou,2364,1495,173,172,345,50.1%,18m
35551,3,estaponk,2364,1622,76,76,152,50.0%,15m
35551,1,Matrix,2364,1654,54,55,109,49.5%,1h
35551,3,Mike,2364,940,38,33,71,53.5%,26m
35551,3,Zardoz,2364,994,36,42,78,46.2%,26m
35551,1,TheDon,2364,861,32,21,53,60.4%,8m
35551,3,Brambora,2364,551,25,26,51,49.0%,14m
35551,1,Destiny,2364,634,24,17,41,58.5%,6m
35551,3,clvwfj,2364,573,24,21,45,53.3%,1h
35551,1,lennart,2364,544,15,15,30,50.0%,14m
35551,1,BEAST,2364,558,15,16,31,48.4%,11m
35551,3,Dschingis,2364,433,15,19,34,44.1%,1h
35551,1,ColorWolf,2364,314,8,2,10,80.0%,27m
35551,1,Methusalam,2364,280,8,13,21,38.1%,16m
35551,2,Orckhal,2364,280,8,13,21,38.1%,1h
35551,3,[Gand]Starfury,2364,235,8,16,24,33.3%,4m
35551,1,[17RED]SmokeFlash,2364,190,7,4,11,63.6%,1h
35551,2,Yavdolix,2364,88,7,6,13,53.8%,1h
35551,1,lusifer,2364,261,6,2,8,75.0%,28m
35551,1,BuBuFR,2364,210,6,4,10,60.0%,27m
35551,1,HYDRA,2364,124,4,5,9,44.4%,1h
35551,1,Akrobat,2364,170,4,6,10,40.0%,5m
35551,1,CZengineerCZ,2364,149,3,4,7,42.9%,28m
35551,1,Astronafs,2364,46,2,1,3,66.7%,1h
35551,1,Nebuar,2364,97,2,4,6,33.3%,4m
35551,3,MorbidDesire,2364,96,2,5,7,28.6%,6m
35551,1,Yammamotosan,2364,0,2,6,8,25.0%,30m
35551,1,Garet,2364,94,1,1,2,50.0%,24m
35551,1,RuneSykoz,2364,42,1,1,2,50.0%,1h
35551,1,kill,2364,36,1,2,3,33.3%,11m
35551,1,Taedriel,2364,0,1,2,3,33.3%,1h
35551,2,Cuzzini,2364,0,1,4,5,20.0%,1h
35551,1,EpicDoodle,2364,0,1,4,5,20.0%,5m
35551,1,Thrawn,2364,0,1,4,5,20.0%,1h
35551,1,MIKe,2364,0,0,1,1,0.0%,27m
35551,1,[AciNoN]Aza,2364,0,0,1,1,0.0%,1h
35551,1,stalin,2364,0,0,2,2,0.0%,60m
35551,3,Nassmer,2364,0,0,5,5,0.0%,22m
35590,2,Dekachin,2363,1508,214,223,437,49.0%,1h
35590,2,Andra,2363,1529,175,183,358,48.9%,6m
35590,3,Rushmore,2363,1586,162,161,323,50.2%,13m
35590,3,[AQFOBQ]Prime,2363,1318,115,116,231,49.8%,1h
35590,3,Mszczuj,2363,1215,111,122,233,47.6%,1h
35590,3,[Medoеd]BeRGOmoY,2363,1464,61,60,121,50.4%,1h
35590,3,lazyturtle,2363,963,39,35,74,52.7%,1h
35590,3,jonitomato,2363,721,32,40,72,44.4%,1h
35590,1,Kastor,2363,788,31,13,44,70.5%,1h
35590,1,spekkyo,2363,692,25,24,49,51.0%,29m
35590,1,NeYson,2363,812,25,31,56,44.6%,1h
35590,1,MrDruck,2363,732,25,33,58,43.1%,1h
35590,1,[Petrиs]JusttheKeL,2363,485,17,8,25,68.0%,1h
35590,1,mentos,2363,412,13,7,20,65.0%,1h
35590,1,azuel,2363,468,13,12,25,52.0%,16m
35590,3,DerStu,2363,392,13,15,28,46.4%,17m
35590,3,Wice,2363,326,12,9,21,57.1%,1h
35590,2,Mithradtes,2363,278,12,17,29,41.4%,17m
35590,1,Bengen,2363,395,10,11,21,47.6%,29m
35590,1,CyberCSAK,2363,179,8,11,19,42.1%,1h
35590,1,HAPPYGOOSE,2363,268,7,7,14,50.0%,22m
35590,3,TheMaxFun,2363,94,7,7,14,50.0%,1h
35590,1,tunnuz,2363,248,6,3,9,66.7%,17m
35590,3,Sinless,2363,138,5,5,10,50.0%,1h
35590,1,[STFS]VASka,2363,128,3,1,4,75.0%,1h
35590,1,user,2363,88,3,2,5,60.0%,11m
35590,3,[NW]SemDestroyer,2363,97,3,6,9,33.3%,20m
35590,2,Brink,2363,72,3,9,12,25.0%,1h
35590,1,tof,2363,96,2,4,6,33.3%,6m
35590,1,kaszek,2363,48,2,5,7,28.6%,28m
35590,1,Eclips,2363,0,1,0,1,100.0%,1h
35590,1,GOBY,2363,44,1,1,2,50.0%,28m
35590,1,AntoineC,2363,97,1,1,2,50.0%,13m
35590,3,Nicinic,2363,97,1,3,4,25.0%,1h
35590,1,[SSquаd]ghch,2363,0,1,4,5,20.0%,1h
35590,1,[А3tRA]Deliverance,2363,0,0,2,2,0.0%,1h
35590,3,Viperon,2363,0,0,5,5,0.0%,1h
35627,3,Lillo,2362,1374,84,89,173,48.6%,22m
35627,3,whateverIDC,2362,493,78,73,151,51.7%,1h
35627,2,Drinkgin,2362,930,66,79,145,45.5%,7m
35627,3,Olivier,2362,1273,52,55,107,48.6%,12m
35627,3,PLAY,2362,636,46,54,100,46.0%,1h
35627,1,Rex,2362,893,38,31,69,55.1%,16m
35627,3,[HeClub]MrKatelva,2362,685,36,43,79,45.6%,13m
35627,3,Lewpen,2362,846,32,38,70,45.7%,1h
35627,1,SKILL,2362,600,18,10,28,64.3%,14m
35627,3,[Burla]Starvind,2362,505,18,18,36,50.0%,1h
35627,3,[JXGG]emptywolf,2362,329,12,14,26,46.2%,5m
35627,3,Victorian,2362,310,11,19,30,36.7%,1h
35627,3,[Heroes]Arcon,2362,261,9,5,14,64.3%,18m
35627,1,KaranD,2362,208,8,8,16,50.0%,26m
35627,2,djedje,2362,243,8,13,21,38.1%,22m
35627,1,Wrothbows,2362,245,7,10,17,41.2%,1h
35627,2,ptrkZOnaZ,2362,192,7,18,25,28.0%,30m
35627,3,Kikilicious,2362,156,6,13,19,31.6%,12m
35627,3,NosDa,2362,170,5,8,13,38.5%,1h
35627,3,Viranchi,2362,60,4,9,13,30.8%,1h
35627,3,dix,2362,86,4,11,15,26.7%,4m
35627,1,АзогСеквар,2362,0,3,1,4,75.0%,1h
35627,3,Armstrong,2362,0,3,3,6,50.0%,6m
35627,1,helpme,2362,122,3,6,9,33.3%,5m
35627,1,dime,2362,42,2,0,2,100.0%,1h
35627,1,zEx,2362,44,2,2,4,50.0%,21m
35627,1,KaTok,2362,0,2,3,5,40.0%,1h
35627,1,Fiselano,2362,0,2,4,6,33.3%,1h
35627,1,DavidA,2362,97,2,5,7,28.6%,1h
35627,3,[0BBF0]DayWalker,2362,129,2,5,7,28.6%,7m
35627,1,Lama,2362,48,2,6,8,25.0%,29m
35627,3,YURA,2362,123,2,6,8,25.0%,5m
35627,3,Andrei,2362,30,2,6,8,25.0%,1h
35627,1,akaNaka,2362,42,1,1,2,50.0%,21m
35627,1,[OGMFR]baba,2362,42,1,2,3,33.3%,20m
35627,3,Darklord,2362,0,1,2,3,33.3%,1h
35627,1,SotiG,2362,38,1,3,4,25.0%,1h
35627,1,ForeverNoob,2362,44,1,4,5,20.0%,29m
35627,1,NoPainNoGain,2362,0,1,4,5,20.0%,28m
35627,2,SatanaLSD,2362,0,1,4,5,20.0%,1h
35627,3,Ixonius,2362,97,1,6,7,14.3%,1h
35627,1,Sleck,2362,0,0,1,1,0.0%,1h
35627,1,Starnerf,2362,0,0,1,1,0.0%,1h
35627,2,[ZЕRG7V]АнтихрисТ,2362,0,0,1,1,0.0%,9m
35627,1,MOnster,2362,0,0,1,1,0.0%,1h
35627,1,CroZz,2362,0,0,1,1,0.0%,19m
35627,1,VAI,2362,0,0,1,1,0.0%,1h
35627,1,Spectress,2362,0,0,2,2,0.0%,29m
35627,2,[Stim]Tor,2362,0,0,5,5,0.0%,1h
35676,3,Zarathustra,2361,1546,246,245,491,50.1%,60m
35676,2,Iban,2361,1396,165,171,336,49.1%,20m
35676,3,flosam,2361,1518,145,150,295,49.2%,1h
35676,3,djdemo,2361,1526,114,100,214,53.3%,1h
35676,1,Kefir,2361,1849,102,92,194,52.6%,1h
35676,2,Aldebaran,2361,1575,90,97,187,48.1%,5m
35676,3,PhiLLoOne,2361,1165,73,71,144,50.7%,17m
35676,1,Benthamite,2361,836,50,36,86,58.1%,23m
35676,1,[VDA]Bepitti,2361,1069,49,40,89,55.1%,1h
35676,1,WildWolf,2361,1282,49,40,89,55.1%,25m
35676,2,Terrano,2361,714,44,44,88,50.0%,13m
35676,1,[Arrows]Vitako,2361,284,40,30,70,57.1%,1h
35676,1,LiberTy,2361,604,25,13,38,65.8%,1h
35676,1,ThePeoshow,2361,716,25,22,47,53.2%,1h
35676,1,Zvirbulis,2361,345,15,7,22,68.2%,24m
35676,1,Maxi,2361,440,11,11,22,50.0%,1h
35676,3,[ÖsiBua]roguff,2361,330,11,19,30,36.7%,1h
35676,1,voland,2361,170,5,2,7,71.4%,1h
35676,2,Marco,2361,102,5,7,12,41.7%,7m
35676,2,Gladiateur,2361,64,5,11,16,31.2%,11m
35676,3,[xZero]KOLLIKA,2361,88,4,9,13,30.8%,1h
35676,1,Chak,2361,80,3,0,3,100.0%,1h
35676,2,FizzyElf,2361,30,3,7,10,30.0%,12m
35676,1,BloOdǂSoun,2361,48,2,0,2,100.0%,1h
35676,3,Somsiadinio,2361,0,2,4,6,33.3%,1h
35676,3,Glaken,2361,119,2,5,7,28.6%,30m
35676,2,PEKKA,2361,0,2,5,7,28.6%,1h
35676,3,[DH]Algaron,2361,97,2,6,8,25.0%,1h
35676,1,Mopitzits,2361,0,1,0,1,100.0%,1h
35676,2,Arman,2361,0,1,3,4,25.0%,1h
35676,1,SilverSurfer,2361,0,1,4,5,20.0%,1h
35676,1,Kalisto,2361,0,1,4,5,20.0%,1h
35676,1,Woady,2361,0,0,1,1,0.0%,1h
35676,1,Spetsura,2361,0,0,1,1,0.0%,8m
35676,1,DIMESS,2361,0,0,1,1,0.0%,1h
35676,1,Stijfhoer,2361,0,0,2,2,0.0%,3m
35676,1,Molsga,2361,0,0,4,4,0.0%,28m
35676,2,Muumbaba,2361,0,0,11,11,0.0%,1h
35714,3,nemo,2360,1303,114,114,228,50.0%,1h
35714,1,WOLF,2360,1855,86,91,177,48.6%,24m
35714,2,[1FU2]Neo,2360,1527,74,78,152,48.7%,6m
35714,2,OmegaRed,2360,752,26,37,63,41.3%,22m
35714,1,Гончар,2360,664,20,14,34,58.8%,1h
35714,3,Nindan,2360,510,18,22,40,45.0%,1h
35714,3,Khriss,2360,412,15,20,35,42.9%,1h
35714,1,Wolfovsky,2360,446,13,11,24,54.2%,11m
35714,3,PREDATOR,2360,294,10,9,19,52.6%,19m
35714,2,ZeroXiz,2360,233,8,12,20,40.0%,26m
35714,1,AmigoPlay,2360,147,5,3,8,62.5%,11m
35714,1,[soldat]Adelante,2360,169,4,4,8,50.0%,1h
35714,1,Akai,2360,116,4,7,11,36.4%,1h
35714,1,[WvK]Hokaido,2360,100,3,8,11,27.3%,1h
35714,3,cybertooth,2360,60,3,8,11,27.3%,30m
35714,2,[zukaCo]benjamin,2360,0,2,6,8,25.0%,29m
35714,1,david,2360,0,2,8,10,20.0%,1h
35714,1,Kawar,2360,0,1,2,3,33.3%,13m
35714,1,Flavi,2360,44,1,3,4,25.0%,1h
35714,1,radioROCKS,2360,0,0,1,1,0.0%,8m
35714,2,Prolegomenon,2360,0,0,2,2,0.0%,16m
35714,1,Patatemaster,2360,0,0,3,3,0.0%,29m
35714,1,DarkHorst,2360,73,0,5,5,0.0%,1h
35737,1,DriesP,2359,1725,176,169,345,51.0%,24m
35737,3,Atu,2359,1359,88,83,171,51.5%,9m
35737,2,Enki,2359,1177,68,79,147,46.3%,5m
35737,3,StarWings,2359,970,56,52,108,51.9%,11m
35737,3,Escanor,2359,1233,53,50,103,51.5%,30m
35737,3,skia,2359,1166,52,58,110,47.3%,1h
35737,1,[PLA2N]DenverXP,2359,1483,49,46,95,51.6%,16m
35737,2,AldoRaine,2359,603,23,25,48,47.9%,1h
35737,1,Cabal,2359,402,17,26,43,39.5%,1h
35737,1,Skye,2359,411,14,11,25,56.0%,27m
35737,3,Sade,2359,371,14,14,28,50.0%,1h
35737,1,OmegaOdie,2359,478,12,15,27,44.4%,1h
35737,1,Ralph,2359,222,9,15,24,37.5%,1h
35737,1,Danikray,2359,290,8,5,13,61.5%,11m
35737,3,[MiAzGa]MarcinMullER,2359,253,7,11,18,38.9%,26m
35737,2,[Glenn]GanjáBob,2359,218,7,12,19,36.8%,1h
35737,2,Gigel,2359,150,6,10,16,37.5%,1h
35737,1,KingOfGanja,2359,172,5,1,6,83.3%,1h
35737,1,noname,2359,130,4,3,7,57.1%,1h
35737,3,[ZERGTV]jsx,2359,90,4,8,12,33.3%,1h
35737,1,Tuber,2359,0,3,2,5,60.0%,5m
35737,1,Sane,2359,86,3,2,5,60.0%,1h
35737,1,PLATUS,2359,38,3,3,6,50.0%,1h
35737,1,elmanoloXD,2359,124,3,4,7,42.9%,1h
35737,3,Linked,2359,108,3,6,9,33.3%,1h
35737,3,Prikzz,2359,145,3,6,9,33.3%,21m
35737,1,Рагнар,2359,48,3,6,9,33.3%,1h
35737,3,Александр,2359,122,3,7,10,30.0%,18m
35737,1,[Kboin]Faarox,2359,111,3,7,10,30.0%,29m
35737,2,TheNoobizer,2359,32,3,7,10,30.0%,1h
35737,1,DogBog,2359,88,2,3,5,40.0%,12m
35737,1,Demetrius,2359,97,2,4,6,33.3%,19m
35737,1,Ähnen,2359,0,2,4,6,33.3%,1h
35737,1,greenHOOD,2359,90,2,4,6,33.3%,8m
35737,2,zmeh,2359,0,2,6,8,25.0%,28m
35737,1,Sefule,2359,0,1,1,2,50.0%,27m
35737,1,DaGGi,2359,0,1,1,2,50.0%,9m
35737,3,Laitpox,2359,0,1,2,3,33.3%,10m
35737,1,cookie,2359,42,1,3,4,25.0%,20m
35737,3,CaptainD,2359,30,1,4,5,20.0%,1h
35737,1,CustomX,2359,0,1,4,5,20.0%,20m
35737,1,DorianXIII,2359,0,1,4,5,20.0%,1h
35737,1,aherly,2359,42,1,5,6,16.7%,30m
35737,3,Spiff,2359,30,1,8,9,11.1%,4m
35737,1,Tappsi,2359,0,0,1,1,0.0%,7m
35737,1,[D0N3]WarPig,2359,0,0,2,2,0.0%,1h
35737,1,CarlEl,2359,0,0,2,2,0.0%,1h
35737,3,Rixelur,2359,0,0,2,2,0.0%,6m
35737,1,VanCleef,2359,73,0,2,2,0.0%,1h
35737,3,shurupkin,2359,0,0,4,4,0.0%,1h
35737,1,Ielassamuraj,2359,0,0,7,7,0.0%,1h
35788,3,Dovla,2358,1573,515,523,1038,49.6%,60m
35788,3,GooGolSmiles,2358,1375,76,64,140,54.3%,9m
35788,1,Merja,2358,1312,52,41,93,55.9%,27m
35788,1,Qualia,2358,953,51,49,100,51.0%,1h
35788,2,Pookielood,2358,1182,44,47,91,48.4%,26m
35788,1,MaxHimself,2358,1061,43,42,85,50.6%,1h
35788,3,Новичог,2358,710,38,44,82,46.3%,1h
35788,1,Skrol,2358,446,32,34,66,48.5%,14m
35788,1,[SGтv]MisteriuS,2358,931,28,24,52,53.8%,28m
35788,3,[Gremli]УшлыйОРК,2358,591,27,18,45,60.0%,15m
35788,3,Gatskopper,2358,372,21,21,42,50.0%,20m
35788,3,casperoN,2358,203,19,24,43,44.2%,12m
35788,3,Ruby,2358,451,18,19,37,48.6%,30m
35788,1,Shammman,2358,373,12,9,21,57.1%,10m
35788,2,wenger,2358,272,12,11,23,52.2%,1h
35788,3,[kastru]Spid,2358,291,10,8,18,55.6%,30m
35788,1,[Cuackk]Lobogris,2358,210,8,7,15,53.3%,21m
35788,1,Zilast,2358,276,7,9,16,43.8%,28m
35788,3,Cartezz,2358,214,7,14,21,33.3%,15m
35788,1,[DPCcat]CapitanSpirt,2358,206,6,6,12,50.0%,60m
35788,1,Fenix,2358,97,5,1,6,83.3%,21m
35788,1,cozblade,2358,163,5,11,16,31.2%,26m
35788,1,[foots]blackarrow,2358,151,3,6,9,33.3%,1h
35788,1,Kraver,2358,62,3,13,16,18.8%,13m
35788,2,Chilla,2358,96,3,14,17,17.6%,24m
35788,1,raelaj,2358,42,2,0,2,100.0%,1h
35788,1,soody,2358,84,2,2,4,50.0%,1h
35788,1,[WldCaT]YummyDead,2358,42,1,1,2,50.0%,1h
35788,1,JockSVIL,2358,40,1,3,4,25.0%,1h
35788,1,Funckie,2358,0,1,4,5,20.0%,1h
35788,2,Richter,2358,0,1,4,5,20.0%,1h
35788,1,GeneralZukov,2358,0,1,5,6,16.7%,4m
35788,1,Nick,2358,0,1,6,7,14.3%,1h
35788,1,GATESJAM,2358,0,0,1,1,0.0%,1h
35788,1,VikiR,2358,0,0,1,1,0.0%,1h
35788,1,Выживающий,2358,0,0,1,1,0.0%,1h
35788,2,Tediforworld,2358,0,0,1,1,0.0%,8m
35788,1,anonimus,2358,0,0,2,2,0.0%,11m
35788,1,Skald,2358,0,0,3,3,0.0%,1h
35788,3,putinhuylo,2358,0,0,4,4,0.0%,1h
35788,1,Naze,2358,0,0,6,6,0.0%,1h
35829,3,Dude,2357,1518,80,87,167,47.9%,60m
35829,3,Arneweise,2357,1412,68,71,139,48.9%,1h
35829,3,Gagarin,2357,1560,63,69,132,47.7%,18m
35829,1,[FAMAS]ostrava,2357,1507,62,54,116,53.4%,60m
35829,3,madrol,2357,714,57,49,106,53.8%,22m
35829,3,Raintlex,2357,785,35,33,68,51.5%,20m
35829,1,Bifidus,2357,954,33,22,55,60.0%,1h
35829,1,Robinius,2357,992,29,29,58,50.0%,25m
35829,3,Jeniakus,2357,594,26,39,65,40.0%,25m
35829,1,Habi,2357,814,24,20,44,54.5%,1h
35829,1,Fitzpleasure,2357,682,20,21,41,48.8%,1h
35829,1,Pippeli,2357,580,19,36,55,34.5%,1h
35829,3,Robbi,2357,189,18,16,34,52.9%,1h
35829,3,Deadcandance,2357,451,17,23,40,42.5%,21m
35829,1,muszyna,2357,421,13,22,35,37.1%,1h
35829,1,OpixOnFIre,2357,319,11,10,21,52.4%,1h
35829,1,[PDDP]SpartaRulez,2357,324,8,9,17,47.1%,1h
35829,1,Hahi,2357,204,6,5,11,54.5%,1h
35829,1,nightdancer,2357,240,6,5,11,54.5%,1h
35829,3,[GR77]NickSouvlas,2357,103,4,2,6,66.7%,21m
35829,1,Jekko,2357,147,3,2,5,60.0%,1h
35829,2,[CОS]Ailas,2357,88,3,7,10,30.0%,1h
35829,3,[RRQ]DaveO,2357,123,3,7,10,30.0%,1h
35829,1,[Heroes]StragaSevera,2357,0,1,0,1,100.0%,21m
35829,2,neocre,2357,0,1,3,4,25.0%,1h
35829,2,BloKun,2357,0,1,4,5,20.0%,19m
35829,3,Demetrio,2357,30,1,8,9,11.1%,12m
35829,1,SuHuitSixDR,2357,0,0,1,1,0.0%,12m
35829,1,Liusun,2357,0,0,1,1,0.0%,1h
35829,3,oemet,2357,0,0,8,8,0.0%,4m
35859,2,Maish,2356,1516,174,175,349,49.9%,22m
35859,3,boogeyman,2356,1177,81,63,144,56.2%,4m
35859,1,Frezzze,2356,918,56,49,105,53.3%,29m
35859,1,Bandee,2356,1045,38,31,69,55.1%,1h
35859,3,TheLordwrath,2356,611,30,34,64,46.9%,8m
35859,2,[CRAB3]timerkhan,2356,900,30,63,93,32.3%,18m
35859,2,yof,2356,428,29,34,63,46.0%,1h
35859,1,ATONY,2356,410,14,20,34,41.2%,1h
35859,3,Vendrus,2356,378,13,22,35,37.1%,28m
35859,1,Nelson,2356,328,8,11,19,42.1%,1h
35859,1,kaRapyz,2356,274,8,20,28,28.6%,1h
35859,1,Briz,2356,297,7,9,16,43.8%,1h
35859,1,[Dagon]sath,2356,204,7,9,16,43.8%,5m
35859,3,eddav,2356,254,7,11,18,38.9%,5m
35859,3,BASB,2356,154,6,9,15,40.0%,18m
35859,3,EnemyDeluxe,2356,176,5,9,14,35.7%,1h
35859,1,[Лакерс]Рик,2356,182,4,3,7,57.1%,1h
35859,1,Paul,2356,222,4,6,10,40.0%,21m
35859,2,dark,2356,30,4,10,14,28.6%,18m
35859,1,[ANREN]КаменщикЖора,2356,133,3,3,6,50.0%,1h
35859,1,sharkan,2356,130,3,6,9,33.3%,29m
35859,3,cfpa,2356,62,3,6,9,33.3%,4m
35859,1,IVANUS,2356,42,2,2,4,50.0%,1h
35859,2,lioha,2356,0,2,6,8,25.0%,29m
35859,1,corvusarpa,2356,0,1,0,1,100.0%,1h
35859,2,MarineRusher,2356,0,1,3,4,25.0%,13m
35859,2,xrey,2356,0,1,4,5,20.0%,1h
35859,2,Tiammat,2356,0,1,4,5,20.0%,14m
35859,1,legertes,2356,0,0,1,1,0.0%,1h
35859,1,adamP,2356,0,0,1,1,0.0%,1h
35889,2,TulakHord,2355,1577,155,168,323,48.0%,29m
35889,3,Fear,2355,1514,84,80,164,51.2%,1h
35889,3,Starlord,2355,549,51,49,100,51.0%,30m
35889,2,Sebalubu,2355,763,34,36,70,48.6%,7m
35889,1,MagMa,2355,966,32,27,59,54.2%,21m
35889,1,SwarmGost,2355,711,29,14,43,67.4%,7m
35889,2,PeriZat,2355,273,10,11,21,47.6%,1h
35889,3,[TGTGTG]darkantoine,2355,246,10,15,25,40.0%,1h
35889,1,Savichev,2355,218,7,10,17,41.2%,1h
35889,2,ADDER,2355,146,7,11,18,38.9%,1h
35889,1,Smaug,2355,215,6,9,15,40.0%,28m
35889,2,JoKeR,2355,116,5,6,11,45.5%,28m
35889,3,Tharadon,2355,142,5,6,11,45.5%,1h
35889,3,[ZeRgg]Arseniy,2355,30,4,5,9,44.4%,17m
35889,1,tnqordjr,2355,84,3,6,9,33.3%,8m
35889,1,spinogryz,2355,0,2,3,5,40.0%,1h
35889,1,Vladonator,2355,0,2,4,6,33.3%,60m
35889,2,Elmermouth,2355,128,2,5,7,28.6%,1h
35889,3,[FFT2]Fuchs,2355,0,2,6,8,25.0%,4m
35889,1,shade,2355,0,2,6,8,25.0%,60m
35889,1,[7BEST7]artemmomet,2355,0,1,0,1,100.0%,1h
35889,1,Mirek,2355,0,1,2,3,33.3%,1h
35889,1,BloodSuga,2355,0,1,5,6,16.7%,1h
35889,1,RabidShrimp,2355,0,0,1,1,0.0%,1h
35889,1,Zingo,2355,0,0,1,1,0.0%,1h
35889,1,[BloTi]PräsChulz,2355,0,0,2,2,0.0%,1h
35889,1,kepgo,2355,0,0,2,2,0.0%,29m
35889,1,Баклажан,2355,0,0,2,2,0.0%,1h
35917,1,MathScience,2354,1633,104,94,198,52.5%,11m
35917,1,guga,2354,879,45,54,99,45.5%,26m
35917,1,Wolkogenos,2354,832,29,25,54,53.7%,60m
35917,1,energyCEBA,2354,936,29,29,58,50.0%,1h
35917,2,[FR1]flipolytoxic,2354,607,24,27,51,47.1%,1h
35917,1,ARTSIVI,2354,550,19,18,37,51.4%,26m
35917,3,Fox,2354,388,14,14,28,50.0%,1h
35917,3,[NBJB]ASPIRYNA,2354,425,14,16,30,46.7%,1h
35917,1,Edd,2354,416,14,16,30,46.7%,60m
35917,1,ЖорикМощный,2354,235,6,6,12,50.0%,11m
35917,1,Agrozel,2354,202,5,3,8,62.5%,1h
35917,1,Rokas,2354,162,3,1,4,75.0%,1h
35917,3,DirtLeague,2354,116,3,2,5,60.0%,1h
35917,1,DonCastoro,2354,97,3,6,9,33.3%,1h
35917,1,[CxCx]NoobKiller,2354,44,2,1,3,66.7%,25m
35917,1,StepToSpace,2354,44,2,2,4,50.0%,1h
35917,1,Bash,2354,97,2,5,7,28.6%,1h
35917,1,elsimulator,2354,97,2,5,7,28.6%,1h
35917,3,Basstowel,2354,0,2,6,8,25.0%,10m
35917,1,MSG,2354,0,1,0,1,100.0%,25m
35917,1,Alwayshappy,2354,0,1,0,1,100.0%,1h
35917,1,Tester,2354,0,1,1,2,50.0%,6m
35917,1,AntonGosu,2354,34,1,3,4,25.0%,5m
35917,2,SirDiesAlot,2354,0,1,4,5,20.0%,14m
35917,1,GefGanty,2354,0,1,4,5,20.0%,26m
35917,1,tAHI,2354,0,1,5,6,16.7%,1h
35917,2,STan,2354,0,1,5,6,16.7%,27m
35917,1,Яков,2354,0,1,5,6,16.7%,1h
35917,1,Turbo,2354,0,0,1,1,0.0%,1h
35917,1,Бабай,2354,0,0,1,1,0.0%,1h
35917,2,SpaceApple,2354,0,0,2,2,0.0%,8m
35917,1,martius,2354,0,0,2,2,0.0%,12m
35949,3,tayz,2353,1137,117,112,229,51.1%,15m
35949,1,Giannetti,2353,1815,96,82,178,53.9%,1h
35949,3,RUBIRAMOS,2353,1340,92,94,186,49.5%,4m
35949,1,tyggis,2353,1303,66,55,121,54.5%,4m
35949,3,MonsterHook,2353,1580,60,67,127,47.2%,7m
35949,1,Andrew,2353,966,49,34,83,59.0%,29m
35949,3,BearPaw,2353,780,32,31,63,50.8%,15m
35949,1,charnoe,2353,1032,31,29,60,51.7%,1h
35949,1,Superroboter,2353,785,23,18,41,56.1%,1h
35949,3,johnNATAN,2353,620,21,25,46,45.7%,1h
35949,3,Gibbon,2353,550,19,20,39,48.7%,27m
35949,1,Relt,2353,568,15,18,33,45.5%,1h
35949,3,UglyKidJoe,2353,328,13,13,26,50.0%,5m
35949,1,kyarkov,2353,399,13,17,30,43.3%,17m
35949,1,[H0C]ssele,2353,302,8,12,20,40.0%,20m
35949,1,aliocha,2353,254,7,4,11,63.6%,15m
35949,1,[БАЗА45]shkedebe,2353,168,5,2,7,71.4%,1h
35949,1,GreenNK,2353,241,5,3,8,62.5%,1h
35949,1,trollkarl,2353,231,5,7,12,41.7%,1h
35949,1,[ЕМPIRE]Lethe,2353,186,4,3,7,57.1%,1h
35949,3,Flaco,2353,68,3,8,11,27.3%,60m
35949,3,Dioni,2353,42,3,8,11,27.3%,1h
35949,1,[Gionny]Kesh,2353,97,2,5,7,28.6%,29m
35949,2,Bkozz,2353,0,2,6,8,25.0%,1h
35949,1,Snaipaz,2353,0,1,1,2,50.0%,29m
35949,2,PlayerFive,2353,0,1,1,2,50.0%,14m
35949,1,[Listic]Traktobu,2353,42,1,1,2,50.0%,1h
35949,1,[13NRV]robingood,2353,0,1,1,2,50.0%,11m
35949,2,Spacemaster,2353,0,1,4,5,20.0%,8m
35949,1,[PDrago]Faffy,2353,0,1,5,6,16.7%,7m
35949,1,[RMF]Ферыч,2353,93,1,6,7,14.3%,27m
35949,1,KlausPH,2353,0,0,1,1,0.0%,1h
35949,2,Karasu,2353,0,0,1,1,0.0%,29m
35949,1,PiTon,2353,0,0,2,2,0.0%,1h
35949,1,DjVetalProff,2353,73,0,4,4,0.0%,11m
35949,1,Dreamweaver,2353,0,0,5,5,0.0%,1h
35949,1,Incatime,2353,0,0,5,5,0.0%,1h
35986,3,Krpvksprv,2352,1463,74,73,147,50.3%,1h
35986,3,Immortal,2352,1060,41,40,81,50.6%,26m
35986,1,zerg,2352,814,23,20,43,53.5%,1h
35986,3,KATALLIS,2352,632,23,36,59,39.0%,17m
35986,1,jtotheb,2352,420,13,20,33,39.4%,1h
35986,1,klaatu,2352,184,11,10,21,52.4%,24m
35986,3,OnlyFlans,2352,249,10,17,27,37.0%,1h
35986,1,JohnWayne,2352,286,7,6,13,53.8%,1h
35986,1,Michher,2352,217,7,9,16,43.8%,1h
35986,1,Corpuso,2352,174,5,4,9,55.6%,29m
35986,1,tiziano,2352,206,5,5,10,50.0%,1h
35986,3,Joeyjojo,2352,90,5,8,13,38.5%,1h
35986,2,Ovenom,2352,118,5,11,16,31.2%,12m
35986,1,Agriotes,2352,187,4,1,5,80.0%,20m
35986,1,Lerner,2352,96,3,2,5,60.0%,1h
35986,1,HaiiryBeaans,2352,120,3,3,6,50.0%,1h
35986,1,[KOtics]Ramsch,2352,118,3,4,7,42.9%,1h
35986,1,Antaares,2352,128,3,6,9,33.3%,17m
35986,2,Milord,2352,0,3,8,11,27.3%,1h
35986,1,[IndyK]kwazi,2352,44,2,1,3,66.7%,1h
35986,1,Randolph,2352,42,2,1,3,66.7%,29m
35986,1,перевал,2352,0,2,3,5,40.0%,20m
35986,3,Belgrade,2352,0,2,7,9,22.2%,1h
35986,1,ramon,2352,38,1,1,2,50.0%,1h
35986,1,Sanguinius,2352,0,1,4,5,20.0%,1h
35986,1,mordor,2352,44,1,4,5,20.0%,12m
35986,2,OldKuresente,2352,0,1,4,5,20.0%,1h
35986,2,[ROSS]ManJimaru,2352,0,1,4,5,20.0%,1h
35986,1,RuskiOkupant,2352,0,1,5,6,16.7%,5m
35986,1,[WoMe]TAOCORTEX,2352,0,0,1,1,0.0%,1h
35986,2,Starkiller,2352,0,0,1,1,0.0%,1h
35986,1,ishkitiev,2352,0,0,2,2,0.0%,1h
36018,3,Geniy,2351,1065,40,36,76,52.6%,29m
36018,2,acernine,2351,470,18,29,47,38.3%,28m
36018,1,[BIGGHK]MMile,2351,412,15,17,32,46.9%,1h
36018,2,Highlander,2351,166,9,17,26,34.6%,1h
36018,1,Ghost,2351,236,7,26,33,21.2%,1h
36018,3,Jey,2351,235,6,19,25,24.0%,19m
36018,1,iosa,2351,192,5,6,11,45.5%,1h
36018,2,[xBaTx]Frenzen,2351,94,5,7,12,41.7%,4m
36018,2,Pasha,2351,48,4,2,6,66.7%,14m
36018,3,Szef,2351,177,4,8,12,33.3%,1h
36018,2,Frenci,2351,133,4,8,12,33.3%,1h
36018,1,[twerps]Darkmaster,2351,42,2,1,3,66.7%,17m
36018,1,ProtectedOne,2351,42,2,2,4,50.0%,1h
36018,1,Hunter,2351,84,2,4,6,33.3%,22m
36018,1,Stroessner,2351,48,2,6,8,25.0%,1h
36018,1,diego,2351,48,2,6,8,25.0%,1h
36018,3,Владыка,2351,0,1,0,1,100.0%,1h
36018,1,[TLGC]HeXagOn,2351,42,1,5,6,16.7%,22m
36018,3,[Kdo5]SirHenry,2351,30,1,6,7,14.3%,7m
36018,1,Tatsuro,2351,0,0,1,1,0.0%,30m
36018,1,MiJa,2351,0,0,1,1,0.0%,11m
36039,1,Dozer,2350,1708,161,167,328,49.1%,1h
36039,1,Mur,2350,1618,89,78,167,53.3%,29m
36039,1,[DioBr]IndShock,2350,1403,70,50,120,58.3%,1h
36039,3,TheDoctor,2350,795,70,63,133,52.6%,1h
36039,3,LIrpOON,2350,1112,51,47,98,52.0%,22m
36039,1,Strateg,2350,1326,46,63,109,42.2%,19m
36039,1,YUKINE,2350,1154,37,35,72,51.4%,1h
36039,2,Calbe,2350,632,37,43,80,46.2%,20m
36039,1,golfStream,2350,1045,33,34,67,49.3%,1h
36039,3,Withcracker,2350,415,32,38,70,45.7%,1h
36039,3,GOD,2350,844,32,41,73,43.8%,1h
36039,1,Merlin,2350,896,27,28,55,49.1%,1h
36039,1,IDen,2350,738,26,20,46,56.5%,1h
36039,3,[DSwtf]Mummyk,2350,395,13,15,28,46.4%,1h
36039,1,exterminator,2350,450,13,32,45,28.9%,7m
36039,1,[Чуваши]Юра,2350,451,12,8,20,60.0%,1h
36039,1,аббо,2350,268,11,8,19,57.9%,1h
36039,1,türk,2350,428,11,13,24,45.8%,17m
36039,1,Jimmy,2350,236,7,5,12,58.3%,1h
36039,1,iDoctor,2350,196,6,4,10,60.0%,15m
36039,1,[CIU2]JackTheLord,2350,205,5,1,6,83.3%,22m
36039,1,Pandemon,2350,166,5,4,9,55.6%,1h
36039,3,[WRZero]SCV,2350,122,5,9,14,35.7%,7m
36039,1,Maru,2350,86,3,1,4,75.0%,25m
36039,2,DreerTV,2350,0,3,2,5,60.0%,25m
36039,1,Trigrrre,2350,147,3,2,5,60.0%,1h
36039,1,minecraft,2350,42,2,0,2,100.0%,10m
36039,1,ArtTeam,2350,96,2,1,3,66.7%,10m
36039,1,[Rooar]Amethyste,2350,36,2,5,7,28.6%,1h
36039,1,[яєѕ]Morpheus,2350,0,1,0,1,100.0%,15m
36039,1,DirtySkytoss,2350,0,1,0,1,100.0%,1h
36039,1,[KrebSt]Thomas,2350,0,1,4,5,20.0%,1h
36039,2,ApfelKuchen,2350,0,1,4,5,20.0%,1h
36039,2,Pata,2350,0,0,1,1,0.0%,1h
36039,1,CHACAL,2350,0,0,1,1,0.0%,1h
36039,1,Caedere,2350,0,0,1,1,0.0%,14m
36039,1,Caveman,2350,0,0,1,1,0.0%,1h
36039,1,Darkblack,2350,0,0,1,1,0.0%,1h
36039,1,Kaerto,2350,0,0,2,2,0.0%,1h
36039,2,[RATTIG]Uncoro,2350,0,0,5,5,0.0%,13m
36079,3,Masherdeluxe,2349,1560,132,134,266,49.6%,1h
36079,1,Koldobina,2349,1701,72,65,137,52.6%,1h
36079,1,TheAlcorian,2349,1332,52,50,102,51.0%,1h
36079,3,lukaplusx,2349,1019,43,41,84,51.2%,1h
36079,2,oblakat,2349,826,28,37,65,43.1%,15m
36079,1,KUBA,2349,770,21,23,44,47.7%,1h
36079,1,[TeamUR]FusTup,2349,542,15,18,33,45.5%,6m
36079,1,NazGul,2349,424,14,11,25,56.0%,1h
36079,1,ForgedWolf,2349,450,14,13,27,51.9%,1h
36079,1,PLaytOster,2349,490,13,11,24,54.2%,1h
36079,1,NonDreams,2349,418,11,9,20,55.0%,1h
36079,3,Shearsky,2349,175,9,15,24,37.5%,4m
36079,3,nnm,2349,278,9,16,25,36.0%,15m
36079,2,Olenevod,2349,181,8,8,16,50.0%,28m
36079,2,Kabo,2349,251,8,12,20,40.0%,1h
36079,3,somebody,2349,61,8,13,21,38.1%,1h
36079,3,crossbow,2349,244,8,20,28,28.6%,15m
36079,1,SasNiYMVK,2349,246,7,3,10,70.0%,28m
36079,3,Alexus,2349,142,7,7,14,50.0%,1h
36079,2,xous,2349,30,4,6,10,40.0%,8m
36079,1,aethion,2349,0,3,3,6,50.0%,11m
36079,1,Чезаре,2349,48,3,6,9,33.3%,15m
36079,1,DerankUwU,2349,120,3,7,10,30.0%,1h
36079,2,MrSaltyWhite,2349,62,3,14,17,17.6%,1h
36079,1,Stepa,2349,48,2,0,2,100.0%,27m
36079,1,DooMMen,2349,48,2,6,8,25.0%,15m
36079,3,ELECTRO,2349,30,2,6,8,25.0%,1h
36079,1,Hydropic,2349,0,1,1,2,50.0%,1h
36079,1,RomBo,2349,38,1,1,2,50.0%,5m
36079,2,Lluvazo,2349,0,1,1,2,50.0%,1h
36079,2,Hardcore,2349,0,1,4,5,20.0%,1h
36079,1,Алексей,2349,0,1,4,5,20.0%,1h
36079,1,psychedelic,2349,0,0,1,1,0.0%,1h
36079,1,[DL2006]Jech,2349,0,0,1,1,0.0%,1h
36079,1,anter,2349,0,0,3,3,0.0%,19m
36114,3,COVID,2348,1376,70,77,147,47.6%,1h
36114,1,Fruchtfliege,2348,1504,66,62,128,51.6%,4m
36114,3,EkZit,2348,836,63,55,118,53.4%,5m
36114,1,SpootNik,2348,749,42,31,73,57.5%,1h
36114,1,Alik,2348,787,42,32,74,56.8%,20m
36114,1,Popes,2348,868,40,37,77,51.9%,1h
36114,1,TheQuiET,2348,905,39,20,59,66.1%,27m
36114,3,Telemail,2348,990,39,38,77,50.6%,1h
36114,1,DartPrime,2348,912,29,23,52,55.8%,19m
36114,1,NucBuck,2348,676,18,16,34,52.9%,1h
36114,1,Nikrator,2348,432,11,13,24,45.8%,1h
36114,3,Thunder,2348,243,7,6,13,53.8%,1h
36114,1,Overlord,2348,250,7,9,16,43.8%,1h
36114,1,Costhares,2348,246,6,6,12,50.0%,1h
36114,2,[nWss]GreuXer,2348,167,5,5,10,50.0%,30m
36114,1,Hamagon,2348,198,5,5,10,50.0%,10m
36114,1,Slice,2348,147,5,8,13,38.5%,1h
36114,1,PHANTOM,2348,122,4,0,4,100.0%,1h
36114,1,Nikzu,2348,120,4,4,8,50.0%,21m
36114,1,BattleFox,2348,162,4,9,13,30.8%,25m
36114,1,[Magnet]DieByMySword,2348,86,3,1,4,75.0%,1h
36114,1,[AciNoN]ImmUnd,2348,84,3,2,5,60.0%,21m
36114,1,Nosichek,2348,96,3,7,10,30.0%,7m
36114,3,Ceder,2348,156,3,11,14,21.4%,1h
36114,1,SIREX,2348,44,2,1,3,66.7%,11m
36114,2,Andruxa,2348,34,2,1,3,66.7%,1h
36114,1,DoomstronG,2348,115,2,6,8,25.0%,1h
36114,1,FoBoS,2348,0,1,0,1,100.0%,10m
36114,1,IIIIIIIII,2348,0,1,2,3,33.3%,60m
36114,1,[LNDD]Bol,2348,73,1,3,4,25.0%,1h
36114,2,ziemek,2348,0,1,4,5,20.0%,1h
36114,2,Rousseau,2348,0,1,4,5,20.0%,1h
36114,1,Levi,2348,0,1,4,5,20.0%,1h
36114,1,Paddy,2348,0,1,4,5,20.0%,1h
36114,1,RAMSIIS,2348,0,1,5,6,16.7%,29m
36114,1,SyIvester,2348,0,1,5,6,16.7%,1h
36114,1,Giganter,2348,0,0,2,2,0.0%,1h
36114,2,Безымянный,2348,0,0,2,2,0.0%,17m
36152,3,Jack,2347,1029,160,161,321,49.8%,1h
36152,1,Kipras,2347,1830,150,126,276,54.3%,21m
36152,3,Nurshat,2347,1573,107,110,217,49.3%,1h
36152,3,GeneralFrost,2347,1513,95,79,174,54.6%,17m
36152,1,[DIAHN]MarraPush,2347,1679,87,73,160,54.4%,1h
36152,1,dundundundun,2347,1462,50,49,99,50.5%,29m
36152,3,Max,2347,369,14,14,28,50.0%,29m
36152,3,Selmo,2347,338,13,15,28,46.4%,30m
36152,1,CoRtEZz,2347,378,12,18,30,40.0%,1h
36152,1,mixas,2347,381,11,6,17,64.7%,29m
36152,1,[RIP007]iTo,2347,308,8,6,14,57.1%,1h
36152,1,Rovenant,2347,322,8,11,19,42.1%,1h
36152,1,Asisa,2347,266,7,5,12,58.3%,60m
36152,1,ZsSta,2347,282,7,6,13,53.8%,1h
36152,3,TrooperTi,2347,196,7,15,22,31.8%,10m
36152,1,leopolt,2347,208,5,8,13,38.5%,1h
36152,1,randomizer,2347,240,5,8,13,38.5%,1h
36152,1,roda,2347,150,5,8,13,38.5%,1h
36152,3,Starkus,2347,120,5,12,17,29.4%,1h
36152,3,MANDRIK,2347,171,4,9,13,30.8%,1h
36152,3,Reaven,2347,30,3,7,10,30.0%,1h
36152,1,Karasik,2347,168,3,7,10,30.0%,60m
36152,1,[CRUDE]Crafty,2347,0,2,6,8,25.0%,1h
36152,2,xAlienx,2347,0,2,6,8,25.0%,4m
36152,2,Ocelot,2347,88,2,7,9,22.2%,4m
36152,1,FrostyNova,2347,0,1,0,1,100.0%,1h
36152,1,Wedengart,2347,0,1,0,1,100.0%,1h
36152,1,Wicked,2347,0,1,1,2,50.0%,1h
36152,1,[Mavis]wochaonimabi,2347,0,1,1,2,50.0%,1h
36152,1,[OMiD]LarvaCreEp,2347,48,1,6,7,14.3%,24m
36152,2,Killjoy,2347,0,1,8,9,11.1%,1h
36152,1,Mayday,2347,0,0,1,1,0.0%,20m
36152,3,xox,2347,0,0,1,1,0.0%,30m
36152,1,BRV,2347,0,0,2,2,0.0%,1h
36152,3,AmartuvshinJ,2347,0,0,3,3,0.0%,10m
36187,2,[AHA]Hanniboy,2346,915,205,212,417,49.2%,1h
36187,2,Mahoney,2346,1393,151,166,317,47.6%,5m
36187,3,flexroad,2346,1610,101,101,202,50.0%,20m
36187,3,Gallileon,2346,1269,60,53,113,53.1%,1h
36187,3,sander,2346,613,26,27,53,49.1%,7m
36187,1,[wedown]kirie,2346,590,16,18,34,47.1%,1h
36187,3,Heidö,2346,382,13,15,28,46.4%,13m
36187,1,вульф,2346,356,10,8,18,55.6%,1h
36187,3,[VDN]Zorn,2346,228,7,10,17,41.2%,1h
36187,3,Furneyes,2346,182,7,14,21,33.3%,1h
36187,1,Vyvich,2346,170,5,4,9,55.6%,11m
36187,1,BillyH,2346,210,5,8,13,38.5%,13m
36187,1,Ivan,2346,164,4,7,11,36.4%,1h
36187,1,Light,2346,84,3,3,6,50.0%,1h
36187,1,[JCLM]Daweed,2346,120,3,5,8,37.5%,29m
36187,1,[TQQ]Crashfry,2346,145,3,6,9,33.3%,1h
36187,1,SERG,2346,96,3,7,10,30.0%,1h
36187,2,Gemmer,2346,0,2,1,3,66.7%,1h
36187,3,[52RUS]JaZ,2346,108,2,3,5,40.0%,1h
36187,1,Moritzdg,2346,88,2,4,6,33.3%,29m
36187,1,Pitch,2346,0,2,4,6,33.3%,1h
36187,1,[JaPP]EMAE,2346,0,1,0,1,100.0%,8m
36187,1,ElerGard,2346,0,1,2,3,33.3%,8m
36187,1,Suleiman,2346,0,1,4,5,20.0%,1h
36187,3,Dokomaxi,2346,0,1,5,6,16.7%,1h
36187,1,badboy,2346,0,0,1,1,0.0%,14m
36187,1,[NLTN]Tri,2346,0,0,2,2,0.0%,1h
36187,1,[EUisOK]WEEBRATOR,2346,73,0,5,5,0.0%,1h
36215,3,ShuraEX,2345,1493,242,247,489,49.5%,29m
36215,1,[BoS213]Woody,2345,1741,140,140,280,50.0%,10m
36215,1,mattia,2345,1749,108,96,204,52.9%,25m
36215,1,Python,2345,1764,87,90,177,49.2%,10m
36215,1,pybnen,2345,1817,69,67,136,50.7%,1h
36215,3,TaNkisT,2345,1073,63,67,130,48.5%,1h
36215,1,HerOoO,2345,978,42,30,72,58.3%,1h
36215,2,bobby,2345,462,15,21,36,41.7%,19m
36215,3,UnNameD,2345,378,14,19,33,42.4%,15m
36215,1,MKrash,2345,330,9,5,14,64.3%,1h
36215,3,Roger,2345,269,9,9,18,50.0%,12m
36215,1,Mailog,2345,148,5,7,12,41.7%,1h
36215,2,Smoczek,2345,86,5,10,15,33.3%,1h
36215,2,[dVsT]Carrock,2345,162,5,10,15,33.3%,1h
36215,3,RAGE,2345,60,4,7,11,36.4%,10m
36215,1,Net,2345,42,2,1,3,66.7%,1h
36215,1,MNS,2345,84,2,3,5,40.0%,15m
36215,1,Black,2345,0,2,3,5,40.0%,21m
36215,1,Kuolleille,2345,0,2,4,6,33.3%,1h
36215,1,скорпион,2345,0,1,0,1,100.0%,60m
36215,1,uniqa,2345,0,1,2,3,33.3%,1h
36215,2,xFeldMasterQ,2345,0,1,3,4,25.0%,25m
36215,1,Onell,2345,0,1,4,5,20.0%,23m
36215,1,murmur,2345,0,0,1,1,0.0%,22m
36215,1,VooDoo,2345,0,0,1,1,0.0%,21m
36215,1,Kosada,2345,0,0,1,1,0.0%,1h
36215,1,мармаджикал,2345,0,0,2,2,0.0%,21m
36215,1,pizhon,2345,0,0,2,2,0.0%,1h
36215,1,Bro,2345,0,0,2,2,0.0%,29m
36215,1,Juns,2345,0,0,2,2,0.0%,1h
36245,3,VroomVroom,2344,1417,89,91,180,49.4%,5m
36245,1,JimmyVoltage,2344,843,60,59,119,50.4%,1h
36245,1,ХОЛОДЕЦ,2344,711,26,19,45,57.8%,29m
36245,3,Saveliy,2344,462,23,14,37,62.2%,1h
36245,2,MeSzeS,2344,72,12,19,31,38.7%,15m
36245,2,[MSK77]Greyfox,2344,226,10,15,25,40.0%,1h
36245,1,AndreiDragon,2344,340,9,10,19,47.4%,17m
36245,3,Vitalferox,2344,195,6,9,15,40.0%,1h
36245,3,HummeL,2344,182,6,13,19,31.6%,1h
36245,1,ATLAS,2344,30,5,6,11,45.5%,1h
36245,1,Chamber,2344,111,2,2,4,50.0%,6m
36245,1,artE,2344,86,2,3,5,40.0%,10m
36245,3,Sharpblade,2344,97,2,6,8,25.0%,30m
36245,1,keffir,2344,0,1,0,1,100.0%,6m
36245,2,Stalkaid,2344,0,1,1,2,50.0%,1h
36245,1,Kirushic,2344,97,1,1,2,50.0%,1h
36245,1,Demonic,2344,0,1,2,3,33.3%,1h
36245,2,Sovka,2344,0,0,1,1,0.0%,24m
36245,1,[Olеg]SazZaks,2344,0,0,1,1,0.0%,1h
36245,3,Serg,2344,0,0,2,2,0.0%,1h
36245,3,[GIS9]Saito,2344,0,0,3,3,0.0%,1h
36266,3,gtm,2343,1602,157,150,307,51.1%,15m
36266,1,Рыжая,2343,1834,127,128,255,49.8%,1h
36266,3,[antkr]yoma,2343,1518,118,113,231,51.1%,7m
36266,1,[HCrab]ALFUPE,2343,1841,110,102,212,51.9%,1h
36266,2,[HWN]Karêdhíumn,2343,1348,87,85,172,50.6%,1h
36266,3,kfir,2343,1110,74,77,151,49.0%,10m
36266,1,zns,2343,1170,61,65,126,48.4%,1h
36266,3,Aliquid,2343,1156,57,51,108,52.8%,1h
36266,1,[TKP3]LeeQuid,2343,1382,49,45,94,52.1%,1h
36266,1,SquishyXP,2343,1316,49,56,105,46.7%,30m
36266,3,VoodooDolls,2343,705,48,56,104,46.2%,29m
36266,1,yagmort,2343,1038,35,33,68,51.5%,1h
36266,1,zhakey,2343,861,27,28,55,49.1%,1h
36266,3,pinpin,2343,758,25,33,58,43.1%,26m
36266,1,Miru,2343,777,24,17,41,58.5%,14m
36266,1,caveslider,2343,406,10,10,20,50.0%,1h
36266,1,IIIIIIIIII,2343,267,9,10,19,47.4%,1h
36266,3,lucco,2343,236,9,15,24,37.5%,1h
36266,1,elserralfake,2343,221,8,19,27,29.6%,22m
36266,1,WTF,2343,121,7,3,10,70.0%,1h
36266,1,HugluBuglu,2343,177,6,8,14,42.9%,1h
36266,3,Killfor,2343,173,6,8,14,42.9%,27m
36266,1,AndreySt,2343,194,5,0,5,100.0%,1h
36266,1,Reinoff,2343,164,5,5,10,50.0%,1h
36266,3,ŻryjGruz,2343,194,5,5,10,50.0%,25m
36266,1,[Ирбис]alex,2343,159,3,2,5,60.0%,21m
36266,1,MonsieurT,2343,0,3,3,6,50.0%,11m
36266,1,[ExTr1m]ERRORЗOЗ,2343,48,2,1,3,66.7%,1h
36266,1,LIfeLover,2343,44,2,2,4,50.0%,19m
36266,1,XMANN,2343,42,2,3,5,40.0%,1h
36266,1,Jugo,2343,44,2,3,5,40.0%,13m
36266,1,haoran,2343,40,2,3,5,40.0%,26m
36266,1,[RYL]TriffniX,2343,44,2,4,6,33.3%,11m
36266,1,lilsad,2343,0,2,4,6,33.3%,11m
36266,1,MagicOne,2343,97,2,5,7,28.6%,1h
36266,1,Retrage,2343,0,2,7,9,22.2%,1h
36266,1,Billkong,2343,73,1,1,2,50.0%,1h
36266,1,Tik,2343,0,1,4,5,20.0%,1h
36266,1,CREATOR,2343,44,1,4,5,20.0%,1h
36266,2,Mumbles,2343,48,1,5,6,16.7%,1h
36266,1,SupCrusader,2343,0,1,5,6,16.7%,1h
36266,3,Dimon,2343,0,1,6,7,14.3%,10m
36266,1,Zinsbock,2343,0,0,1,1,0.0%,27m
36266,1,[Prsite]Null,2343,0,0,1,1,0.0%,12m
36266,1,WhiteStorm,2343,0,0,2,2,0.0%,25m
36266,1,MACHCASAURIO,2343,0,0,2,2,0.0%,1h
36266,3,[K1F]FraqFink,2343,0,0,7,7,0.0%,1h
36313,3,[MSII]goewolf,2342,1596,299,301,600,49.8%,1h
36313,3,Nikos,2342,1339,163,165,328,49.7%,4m
36313,1,sthlikeelvis,2342,1639,94,87,181,51.9%,5m
36313,3,Moin,2342,1569,58,62,120,48.3%,1h
36313,2,Ghost,2342,839,49,51,100,49.0%,1h
36313,3,Léon,2342,698,42,37,79,53.2%,1h
36313,3,TheMadWizard,2342,272,19,22,41,46.3%,26m
36313,1,[NoMIC]Loki,2342,334,14,10,24,58.3%,1h
36313,3,[DINANT]Matthijs,2342,403,14,18,32,43.8%,17m
36313,1,Piepo,2342,319,10,15,25,40.0%,1h
36313,3,[Xrush]ipriver,2342,247,9,9,18,50.0%,1h
36313,3,[JazzZZ]Filimons,2342,261,9,12,21,42.9%,13m
36313,3,ErlikDeFox,2342,126,6,11,17,35.3%,13m
36313,3,Wildhunt,2342,169,5,7,12,41.7%,5m
36313,1,[ZЕRGТV]Greenkrolik,2342,166,4,4,8,50.0%,27m
36313,1,BELIAL,2342,134,4,7,11,36.4%,11m
36313,1,Immortal,2342,36,2,1,3,66.7%,1h
36313,1,[APFB]anteac,2342,84,2,3,5,40.0%,1h
36313,1,SUSEJ,2342,42,2,3,5,40.0%,1h
36313,3,GrrrMaker,2342,90,2,5,7,28.6%,6m
36313,1,[BadPun]Bop,2342,0,1,0,1,100.0%,1h
36313,1,Дима,2342,0,1,0,1,100.0%,25m
36313,1,BRASS,2342,48,1,4,5,20.0%,1h
36313,1,RazorBlade,2342,0,1,4,5,20.0%,1h
36313,1,Nikitos,2342,0,1,5,6,16.7%,11m
36313,1,BazingaThor,2342,0,0,1,1,0.0%,29m
36313,1,Antotiy,2342,0,0,1,1,0.0%,60m
36313,1,mik,2342,0,0,1,1,0.0%,1h
36313,1,LLIaMaH,2342,0,0,2,2,0.0%,8m
36313,1,darthcyril,2342,0,0,2,2,0.0%,1h
36313,1,Single,2342,0,0,2,2,0.0%,1h
36313,2,MarquexSire,2342,0,0,3,3,0.0%,19m
36313,1,Ромка,2342,0,0,4,4,0.0%,20m
36346,1,TJMAN,2341,1392,199,204,403,49.4%,7m
36346,1,NickSC,2341,1679,114,110,224,50.9%,1h
36346,3,Bartozor,2341,1437,102,94,196,52.0%,1h
36346,2,korteelko,2341,1443,74,65,139,53.2%,7m
36346,1,Pelmenishe,2341,1583,62,55,117,53.0%,1h
36346,3,[rkkd]Swaheeli,2341,1127,46,47,93,49.5%,1h
36346,1,Incognita,2341,1117,38,37,75,50.7%,6m
36346,1,PinballWiz,2341,882,25,30,55,45.5%,1h
36346,1,Pilmeshka,2341,524,23,11,34,67.6%,21m
36346,3,BandiX,2341,617,22,23,45,48.9%,10m
36346,3,[BLINtv]DungeonMastr,2341,394,17,14,31,54.8%,19m
36346,1,CrazyCat,2341,463,13,14,27,48.1%,22m
36346,1,OneOneSeven,2341,407,11,10,21,52.4%,15m
36346,1,Spazzmo,2341,254,7,9,16,43.8%,9m
36346,1,Rewa,2341,144,6,6,12,50.0%,29m
36346,3,tho,2341,180,5,10,15,33.3%,1h
36346,2,PromNight,2341,102,3,0,3,100.0%,9m
36346,1,ProWilku,2341,135,3,3,6,50.0%,6m
36346,1,КОМАР,2341,0,3,3,6,50.0%,1h
36346,1,Bicky,2341,145,3,6,9,33.3%,1h
36346,1,[VodkaM]Galactik,2341,48,2,0,2,100.0%,1h
36346,1,BellVolk,2341,40,2,3,5,40.0%,1h
36346,1,[fafan]Swalopai,2341,0,2,3,5,40.0%,27m
36346,1,[HÖDAN]zeWole,2341,152,2,6,8,25.0%,1h
36346,3,Tchudesnik,2341,62,2,9,11,18.2%,60m
36346,1,DonaldDrug,2341,0,1,0,1,100.0%,6m
36346,1,[BRRR]Skandibal,2341,44,1,1,2,50.0%,24m
36346,1,eggag,2341,0,1,1,2,50.0%,1h
36346,3,[420Inc]Vazon,2341,0,1,2,3,33.3%,1h
36346,3,Creven,2341,48,1,4,5,20.0%,27m
36346,1,Empire,2341,0,1,4,5,20.0%,1h
36346,1,Matcho,2341,113,1,4,5,20.0%,1h
36346,3,Reyz,2341,0,1,4,5,20.0%,30m
36346,1,Palc,2341,0,1,4,5,20.0%,5m
36346,2,HarryCane,2341,0,0,1,1,0.0%,1h
36346,3,Octavius,2341,0,0,1,1,0.0%,1h
36346,1,Lorik,2341,0,0,3,3,0.0%,1h
36383,1,JointForces,2340,1677,210,200,410,51.2%,1h
36383,3,ShadowCT,2340,931,179,161,340,52.6%,8m
36383,3,AlfaTrion,2340,1519,120,121,241,49.8%,1h
36383,3,KillerKretow,2340,1546,105,112,217,48.4%,1h
36383,3,[SvNooB]MadSwede,2340,1544,93,100,193,48.2%,1h
36383,3,ЗлойГусь,2340,1474,92,97,189,48.7%,1h
36383,2,[74Rus]ДиКиЙнУбАсИк,2340,1447,78,84,162,48.1%,60m
36383,1,LivingForce,2340,1459,75,76,151,49.7%,9m
36383,3,Glenelg,2340,1287,56,49,105,53.3%,5m
36383,3,FiLiN,2340,741,27,33,60,45.0%,1h
36383,1,WizKhalifa,2340,746,22,20,42,52.4%,21m
36383,1,SirGutz,2340,431,18,16,34,52.9%,1h
36383,3,[pushik]Svecha,2340,289,15,22,37,40.5%,1h
36383,3,RealFalse,2340,336,13,17,30,43.3%,1h
36383,1,JimTonic,2340,418,12,17,29,41.4%,15m
36383,2,Cheburashka,2340,266,11,16,27,40.7%,6m
36383,2,Yetey,2340,271,9,13,22,40.9%,21m
36383,1,FegKay,2340,224,9,15,24,37.5%,11m
36383,3,Sergey,2340,170,5,2,7,71.4%,7m
36383,1,ordWeist,2340,241,5,10,15,33.3%,1h
36383,2,Harmakhis,2340,174,5,14,19,26.3%,1h
36383,1,roanes,2340,124,4,0,4,100.0%,1h
36383,1,Deadlock,2340,116,4,4,8,50.0%,1h
36383,1,[НОД17]MenronVoque,2340,196,4,5,9,44.4%,1h
36383,1,Habrax,2340,193,4,6,10,40.0%,1h
36383,1,Arcranum,2340,82,2,2,4,50.0%,1h
36383,1,Martinus,2340,0,2,5,7,28.6%,1h
36383,1,[420ZA]RevolT,2340,0,1,0,1,100.0%,1h
36383,1,eriCON,2340,0,0,1,1,0.0%,4m
36383,2,Ганнибал,2340,0,0,1,1,0.0%,19m
36383,1,[Stoog]RuMnCokE,2340,0,0,1,1,0.0%,29m
36383,1,PinkJelly,2340,0,0,4,4,0.0%,1h
36383,2,enricbr,2340,0,0,5,5,0.0%,1h
36416,3,SALAZOR,2339,1571,155,150,305,50.8%,16m
36416,3,Romarain,2339,1103,92,89,181,50.8%,12m
36416,1,Rambo,2339,1839,91,88,179,50.8%,7m
36416,3,Simon,2339,1268,51,50,101,50.5%,1h
36416,1,Chapchui,2339,1108,45,32,77,58.4%,1h
36416,3,Lightning,2339,914,32,38,70,45.7%,1h
36416,1,skywalker,2339,560,28,19,47,59.6%,1h
36416,3,AleX,2339,587,22,25,47,46.8%,30m
36416,1,Haakyn,2339,653,19,23,42,45.2%,12m
36416,1,[BoEin]Teslon,2339,580,18,11,29,62.1%,4m
36416,3,Shogun,2339,379,14,16,30,46.7%,1h
36416,1,[ExTr1m]LUX,2339,542,14,18,32,43.8%,1h
36416,2,[CABA]JCaballero,2339,405,14,22,36,38.9%,1h
36416,1,RageFull,2339,378,11,7,18,61.1%,28m
36416,1,cHiQuiToO,2339,424,11,12,23,47.8%,1h
36416,1,[UndeD]Under,2339,286,7,5,12,58.3%,1h
36416,1,seiros,2339,284,7,7,14,50.0%,1h
36416,2,Barkas,2339,207,7,7,14,50.0%,17m
36416,1,BiGFooT,2339,222,6,7,13,46.2%,10m
36416,1,alve,2339,208,6,7,13,46.2%,21m
36416,3,IIIIIIIIIIII,2339,112,6,9,15,40.0%,29m
36416,3,Enduriath,2339,181,6,12,18,33.3%,20m
36416,1,FanagoS,2339,216,5,8,13,38.5%,5m
36416,1,[bäret]WaxDog,2339,210,5,10,15,33.3%,28m
36416,1,Владимир,2339,144,4,8,12,33.3%,1h
36416,3,riverboy,2339,90,4,8,12,33.3%,1h
36416,1,Syco,2339,76,4,10,14,28.6%,1h
36416,3,Zandercat,2339,97,3,6,9,33.3%,1h
36416,1,hanys,2339,30,2,0,2,100.0%,1h
36416,1,WujekTomek,2339,120,2,4,6,33.3%,7m
36416,1,[MLPRar]NeNECron,2339,0,1,0,1,100.0%,1h
36416,1,Hornet,2339,0,1,0,1,100.0%,30m
36416,1,surgutvit,2339,0,1,0,1,100.0%,25m
36416,1,Alex,2339,0,1,1,2,50.0%,30m
36416,1,[i512]Zabrakahn,2339,97,1,1,2,50.0%,5m
36416,1,Sergey,2339,38,1,2,3,33.3%,1h
36416,1,CeramicBowl,2339,0,1,2,3,33.3%,1h
36416,1,donpaloma,2339,0,1,4,5,20.0%,17m
36416,3,ЮрийДонецк,2339,0,0,1,1,0.0%,10m
36416,1,battleking,2339,0,0,1,1,0.0%,25m
36416,1,Lorg,2339,73,0,2,2,0.0%,1h
36416,1,Povar,2339,0,0,4,4,0.0%,1h
36458,3,Ferelpis,2338,1506,72,70,142,50.7%,1h
36458,3,not,2338,1589,69,75,144,47.9%,10m
36458,3,andrey,2338,947,47,41,88,53.4%,1h
36458,1,HUNNU,2338,671,41,31,72,56.9%,1h
36458,3,[ScHb3R]Grogu,2338,1072,40,42,82,48.8%,12m
36458,2,ThanosSnap,2338,1002,36,46,82,43.9%,7m
36458,1,MrPlay,2338,950,31,27,58,53.4%,22m
36458,3,[MTPL]TeutonicWall,2338,834,29,30,59,49.2%,16m
36458,1,EGO,2338,1038,29,39,68,42.6%,6m
36458,1,Козяпки,2338,722,28,25,53,52.8%,29m
36458,1,Niko,2338,596,20,13,33,60.6%,1h
36458,1,Aligot,2338,542,17,13,30,56.7%,1h
36458,2,Mizrilsunset,2338,451,17,22,39,43.6%,18m
36458,1,ObsidianX,2338,522,15,14,29,51.7%,15m
36458,1,brunocznv,2338,562,15,22,37,40.5%,13m
36458,1,Архиирей,2338,318,10,13,23,43.5%,17m
36458,3,delallioui,2338,272,9,17,26,34.6%,1h
36458,3,[OvdM]derPapa,2338,156,6,14,20,30.0%,16m
36458,1,RainDrow,2338,74,3,3,6,50.0%,1h
36458,1,Proco,2338,126,3,3,6,50.0%,1h
36458,1,[GGP]TexWiller,2338,48,3,5,8,37.5%,60m
36458,2,ski,2338,30,2,14,16,12.5%,1h
36458,1,ByDedokOk,2338,0,1,0,1,100.0%,19m
36458,1,ГладВалакас,2338,0,1,0,1,100.0%,28m
36458,1,Avantasius,2338,44,1,4,5,20.0%,1h
36458,2,[TAW]PforPizza,2338,0,1,4,5,20.0%,1h
36458,1,Fumin,2338,0,0,1,1,0.0%,1h
36458,1,Death,2338,0,0,1,1,0.0%,1h
36458,3,Ambrosio,2338,0,0,1,1,0.0%,1h
36458,1,FoxLinerons,2338,0,0,2,2,0.0%,5m
36458,1,LOTIVUK,2338,0,0,2,2,0.0%,1h
36458,3,[Azzkik]AngelRipper,2338,0,0,6,6,0.0%,1h
36490,2,MuSH,2337,1583,95,109,204,46.6%,1h
36490,3,[wfolks]Electrician,2337,819,92,96,188,48.9%,20m
36490,3,GingerNinja,2337,1539,70,77,147,47.6%,15m
36490,1,[xNSax]Felis,2337,1600,61,44,105,58.1%,1h
36490,1,AnGeJI,2337,1156,40,30,70,57.1%,12m
36490,3,StrYkeR,2337,252,37,41,78,47.4%,1h
36490,1,Knusken,2337,642,21,42,63,33.3%,1h
36490,1,[ЗИБиАГ]QWERTY,2337,373,11,4,15,73.3%,1h
36490,1,guvenen,2337,361,11,18,29,37.9%,30m
36490,1,jack,2337,356,10,13,23,43.5%,1h
36490,2,SlinUA,2337,250,9,12,21,42.9%,1h
36490,1,Randero,2337,276,7,11,18,38.9%,19m
36490,2,limfostar,2337,168,7,11,18,38.9%,1h
36490,1,jammyget,2337,213,6,7,13,46.2%,1h
36490,2,Azeo,2337,192,5,13,18,27.8%,1h
36490,3,dredknight,2337,150,4,8,12,33.3%,1h
36490,1,Rundvogel,2337,126,3,6,9,33.3%,7m
36490,1,Meric,2337,86,2,4,6,33.3%,1h
36490,3,Jeile,2337,0,2,5,7,28.6%,1h
36490,1,[ArtOf]proxity,2337,0,1,4,5,20.0%,9m
36490,1,Styx,2337,0,0,2,2,0.0%,15m
36490,3,KexDurex,2337,0,0,4,4,0.0%,1h
36512,2,[DirStr]Stahor,2336,1275,101,109,210,48.1%,1h
36512,1,boss,2336,1099,53,57,110,48.2%,1h
36512,3,johnnie,2336,1091,48,51,99,48.5%,11m
36512,1,Sexinant,2336,1325,45,42,87,51.7%,20m
36512,1,Exosome,2336,793,31,23,54,57.4%,1h
36512,2,Escuder,2336,640,22,32,54,40.7%,23m
36512,1,rsaZodiak,2336,560,20,12,32,62.5%,1h
36512,3,GlTRON,2336,457,19,20,39,48.7%,1h
36512,1,One,2336,630,17,17,34,50.0%,1h
36512,1,DarkWarrior,2336,363,11,11,22,50.0%,1h
36512,3,JarnGames,2336,246,8,12,20,40.0%,21m
36512,1,[ead]Ryan,2336,254,7,1,8,87.5%,21m
36512,3,NUKE,2336,266,7,17,24,29.2%,6m
36512,3,Zeroci,2336,156,6,11,17,35.3%,1h
36512,1,Stołker,2336,48,5,4,9,55.6%,1h
36512,1,MegaMan,2336,208,5,6,11,45.5%,10m
36512,1,[BOAE]Bandit,2336,172,4,8,12,33.3%,1h
36512,1,Serega,2336,82,3,1,4,75.0%,15m
36512,1,sten,2336,128,3,3,6,50.0%,1h
36512,1,Killagedon,2336,86,3,3,6,50.0%,1h
36512,1,astana,2336,116,3,6,9,33.3%,22m
36512,2,Wolfguard,2336,30,3,8,11,27.3%,7m
36512,1,Nogan,2336,44,2,2,4,50.0%,1h
36512,1,DED,2336,90,2,3,5,40.0%,15m
36512,1,Foerster,2336,96,2,5,7,28.6%,3m
36512,1,Blackfrozt,2336,38,1,1,2,50.0%,1h
36512,1,Mou,2336,0,1,3,4,25.0%,17m
36512,3,Ibonak,2336,30,1,3,4,25.0%,6m
36512,2,Same,2336,0,1,4,5,20.0%,1h
36512,1,OldDirtyBug,2336,0,1,6,7,14.3%,1h
36512,1,SomEhoW,2336,0,0,3,3,0.0%,21m
36512,1,[0wawa0]WGAMEHD,2336,0,0,4,4,0.0%,1h
36512,1,Rambosz,2336,0,0,5,5,0.0%,1h
36545,1,[ExTr1m]iMUSE,2335,1148,204,206,410,49.8%,1h
36545,1,SilentPork,2335,1457,90,77,167,53.9%,1h
36545,3,[blur]Bugman,2335,1459,65,67,132,49.2%,7m
36545,3,RyanGiggs,2335,1308,51,51,102,50.0%,1h
36545,1,GodArease,2335,592,20,20,40,50.0%,1h
36545,1,FMNSBarrier,2335,489,16,20,36,44.4%,30m
36545,3,HerrLich,2335,386,14,18,32,43.8%,28m
36545,1,EJOA,2335,356,13,7,20,65.0%,26m
36545,3,HeadHunteR,2335,304,11,15,26,42.3%,5m
36545,3,Aotling,2335,302,11,15,26,42.3%,9m
36545,3,Peccatum,2335,296,10,19,29,34.5%,5m
36545,1,Сапёр,2335,276,8,11,19,42.1%,1h
36545,2,McVccM,2335,172,8,11,19,42.1%,1h
36545,3,ARMAN,2335,239,8,12,20,40.0%,8m
36545,1,USUL,2335,212,7,4,11,63.6%,1m
36545,1,Chris,2335,162,7,13,20,35.0%,1h
36545,1,[Tuning]Tenwors,2335,212,5,6,11,45.5%,15m
36545,1,sNOOBidou,2335,102,4,4,8,50.0%,1h
36545,1,netwenty,2335,132,4,7,11,36.4%,1h
36545,1,secilian,2335,82,3,3,6,50.0%,1h
36545,1,ExEcRiP,2335,130,3,5,8,37.5%,13m
36545,1,[UnstoP]Dimonlemon,2335,122,3,5,8,37.5%,1h
36545,1,BULDOG,2335,116,3,5,8,37.5%,1h
36545,3,Selmac,2335,79,3,8,11,27.3%,12m
36545,2,OddWarrior,2335,48,2,0,2,100.0%,29m
36545,1,jellyfish,2335,48,2,1,3,66.7%,1h
36545,1,Yapik,2335,76,2,4,6,33.3%,8m
36545,1,xMONALx,2335,96,2,5,7,28.6%,30m
36545,1,Maninarko,2335,66,2,5,7,28.6%,1h
36545,1,Palm,2335,40,2,5,7,28.6%,1h
36545,3,[Smisk]Jokke,2335,0,2,7,9,22.2%,27m
36545,1,СуМраК,2335,0,1,4,5,20.0%,1h
36545,2,Krieg,2335,0,1,4,5,20.0%,1h
36545,3,Ainat,2335,0,1,5,6,16.7%,31m
36545,2,[Users]DuckPower,2335,0,0,1,1,0.0%,1h
36545,2,PrinceMedo,2335,0,0,1,1,0.0%,24m
36545,3,[HDNKBL]sebinger,2335,0,0,1,1,0.0%,13m
36545,1,Fertus,2335,0,0,1,1,0.0%,1h
36545,1,Vorian,2335,0,0,2,2,0.0%,6m
36584,3,Kovalexius,2334,1587,124,118,242,51.2%,8m
36584,1,GOGOMX,2334,479,39,28,67,58.2%,1h
36584,1,Eschatolo,2334,1037,36,34,70,51.4%,26m
36584,1,[xUfax]Rzhevsky,2334,822,30,45,75,40.0%,14m
36584,1,FARF,2334,783,25,26,51,49.0%,1h
36584,1,MrSalamandr,2334,627,21,15,36,58.3%,30m
36584,3,Emptiness,2334,470,20,24,44,45.5%,2m
36584,1,Левославный,2334,443,17,9,26,65.4%,17m
36584,1,Iskandar,2334,426,12,11,23,52.2%,1h
36584,1,bapa,2334,223,6,2,8,75.0%,2m
36584,2,ALZhir,2334,90,5,8,13,38.5%,1h
36584,3,Beaubeste,2334,132,5,10,15,33.3%,1h
36584,1,[wdps]CobraEffect,2334,144,4,5,9,44.4%,5m
36584,1,GoodDog,2334,160,4,7,11,36.4%,17m
36584,1,RUM,2334,40,2,2,4,50.0%,27m
36584,1,[xEVOx]ArTaX,2334,86,2,4,6,33.3%,1h
36584,3,Bohni,2334,0,2,7,9,22.2%,1h
36584,1,[LawDa]REINOR,2334,0,1,0,1,100.0%,1h
36584,2,[VENGam]BadNexusYT,2334,0,1,4,5,20.0%,1h
36584,2,IceFlowers,2334,0,1,4,5,20.0%,14m
36584,2,[БАЗА45]хлебушек,2334,0,1,4,5,20.0%,1h
36584,1,JKyllandHyde,2334,0,1,5,6,16.7%,25m
36584,1,zorphix,2334,0,0,1,1,0.0%,1h
36584,1,Azuros,2334,0,0,1,1,0.0%,30m
36584,1,Hrust,2334,0,0,1,1,0.0%,1h
36609,3,agnirabio,2333,1239,212,209,421,50.4%,15m
36609,2,EnPlator,2333,1538,134,124,258,51.9%,1h
36609,3,BattleTag,2333,608,114,114,228,50.0%,6m
36609,1,QUEPUEG,2333,1834,69,66,135,51.1%,1h
36609,1,[0TSK0]Trail,2333,1141,58,53,111,52.3%,1h
36609,1,Meatman,2333,930,47,35,82,57.3%,25m
36609,1,[121323]Spartan,2333,940,28,32,60,46.7%,22m
36609,1,ToTeaTrouT,2333,422,18,21,39,46.2%,24m
36609,3,ilyalucas,2333,470,16,21,37,43.2%,20m
36609,3,смет,2333,149,12,2,14,85.7%,7m
36609,1,[CdNRO]Dane,2333,464,12,11,23,52.2%,1h
36609,3,Ganimede,2333,170,5,3,8,62.5%,1h
36609,3,DIMON,2333,142,4,4,8,50.0%,1h
36609,2,Zeleon,2333,48,3,3,6,50.0%,1h
36609,1,jimduyolo,2333,126,3,4,7,42.9%,26m
36609,2,[pUky]Bandris,2333,0,1,1,2,50.0%,1h
36609,1,[FMG]shadowknight,2333,40,1,1,2,50.0%,1h
36609,1,BouncyPoo,2333,73,1,2,3,33.3%,1h
36609,1,Grzesław,2333,42,1,4,5,20.0%,13m
36609,1,Aix,2333,0,0,1,1,0.0%,1h
36609,1,Impressio,2333,0,0,2,2,0.0%,27m
36609,1,Izballs,2333,0,0,3,3,0.0%,17m
36631,2,[lOoOl]Ftmch,2332,1517,107,119,226,47.3%,2m
36631,2,Brabuschka,2332,1298,102,97,199,51.3%,21m
36631,3,alex,2332,1535,77,78,155,49.7%,7m
36631,1,Папус,2332,364,71,62,133,53.4%,1h
36631,1,[Seek]Getayr,2332,786,43,47,90,47.8%,1h
36631,1,NochnoiZefir,2332,818,36,24,60,60.0%,1h
36631,1,WhiteWark,2332,666,27,13,40,67.5%,8m
36631,3,IIIIIIIIIIII,2332,592,25,32,57,43.9%,1h
36631,1,LordVampire,2332,403,15,12,27,55.6%,1h
36631,3,[sort]ZikZak,2332,504,15,21,36,41.7%,15m
36631,3,VLRPIX,2332,329,13,17,30,43.3%,1h
36631,3,[DZTK]Armageddon,2332,248,11,17,28,39.3%,15m
36631,1,MarkP,2332,310,10,11,21,47.6%,1h
36631,3,Nightmare,2332,246,9,11,20,45.0%,1h
36631,1,Wordsquirrel,2332,332,9,11,20,45.0%,13m
36631,1,oldway,2332,86,7,3,10,70.0%,10m
36631,1,Jackaching,2332,238,6,4,10,60.0%,26m
36631,3,ИванМихалыч,2332,169,4,5,9,44.4%,25m
36631,1,[lNN]MrHoney,2332,70,3,0,3,100.0%,1h
36631,3,Linutz,2332,30,3,7,10,30.0%,13m
36631,1,Fremo,2332,48,3,7,10,30.0%,5m
36631,3,Leroy,2332,30,2,6,8,25.0%,1h
36631,3,fhas,2332,94,2,6,8,25.0%,7m
36631,1,Беркумбаев,2332,0,1,0,1,100.0%,1h
36631,1,FiOXiO,2332,0,1,0,1,100.0%,1h
36631,1,zain,2332,42,1,1,2,50.0%,1h
36631,1,Communistyyy,2332,0,1,2,3,33.3%,1h
36631,1,GoblinTVT,2332,44,1,3,4,25.0%,13m
36631,1,sensoNOKami,2332,0,1,4,5,20.0%,3m
36631,2,creeek,2332,0,1,4,5,20.0%,13m
36631,2,sean,2332,0,0,1,1,0.0%,1h
36631,2,Syl,2332,0,0,1,1,0.0%,15m
36631,3,alfie,2332,0,0,1,1,0.0%,21m
36631,1,esqesqq,2332,0,0,1,1,0.0%,1h
36631,1,Fireball,2332,0,0,2,2,0.0%,28m
36631,1,advanka,2332,0,0,2,2,0.0%,2m
36631,1,Phoenix,2332,0,0,2,2,0.0%,1h
36631,1,Midoriya,2332,0,0,3,3,0.0%,1h
36631,1,arneweise,2332,0,0,4,4,0.0%,15m
36670,1,Steelstorm,2331,1576,99,118,217,45.6%,1h
36670,1,СРОМАС,2331,1678,91,71,162,56.2%,29m
36670,1,Niju,2331,1692,84,78,162,51.9%,15m
36670,1,danil,2331,1673,80,74,154,51.9%,1h
36670,1,killerjohnny,2331,1464,48,50,98,49.0%,26m
36670,1,[638252]Skywalker,2331,773,42,46,88,47.7%,1h
36670,3,Nemerion,2331,859,32,33,65,49.2%,1h
36670,1,COUSIIL,2331,800,27,22,49,55.1%,1h
36670,1,[Pulpo]KRW,2331,845,26,19,45,57.8%,1h
36670,1,USSR,2331,696,21,22,43,48.8%,8m
36670,3,Voom,2331,324,12,16,28,42.9%,10m
36670,1,Taurus,2331,362,9,14,23,39.1%,21m
36670,1,[ungh]Flewog,2331,322,8,8,16,50.0%,1h
36670,1,Predjamski,2331,164,8,8,16,50.0%,1h
36670,2,QueenOfRoses,2331,146,8,11,19,42.1%,1h
36670,1,dexaps,2331,144,6,6,12,50.0%,28m
36670,1,LorneMalvo,2331,192,5,9,14,35.7%,28m
36670,3,Afrikaner,2331,94,4,9,13,30.8%,31m
36670,2,[NICHE]KingFloyd,2331,170,4,9,13,30.8%,30m
36670,3,[Лучшие]Вонила,2331,88,4,9,13,30.8%,27m
36670,1,Shadow,2331,34,2,2,4,50.0%,17m
36670,1,lipschitz,2331,109,2,5,7,28.6%,1h
36670,2,Joronac,2331,88,2,7,9,22.2%,1h
36670,1,niTle,2331,0,1,0,1,100.0%,1h
36670,2,hanibal,2331,0,1,0,1,100.0%,1h
36670,1,Tartararam,2331,46,1,4,5,20.0%,1h
36670,1,MasterRacoon,2331,0,1,5,6,16.7%,1h
36670,1,mattait,2331,0,0,1,1,0.0%,29m
36670,1,PROTOS,2331,0,0,1,1,0.0%,1h
36670,1,Barmaley,2331,0,0,1,1,0.0%,1h
36670,1,Problemative,2331,0,0,2,2,0.0%,1m
36670,1,[stulj]Mare,2331,0,0,2,2,0.0%,4m
36702,1,scv,2330,1402,98,100,198,49.5%,19m
36702,3,Gurgel,2330,941,88,93,181,48.6%,1h
36702,3,смеховор,2330,1553,60,66,126,47.6%,1h
36702,3,iZeQuAlRaGe,2330,1373,56,56,112,50.0%,30m
36702,3,марат,2330,734,48,45,93,51.6%,1h
36702,1,Kratos,2330,1137,42,42,84,50.0%,26m
36702,1,Licbez,2330,900,30,33,63,47.6%,6m
36702,1,Punker,2330,956,27,30,57,47.4%,1h
36702,3,DarthPedro,2330,658,24,26,50,48.0%,31m
36702,1,Karapuz,2330,344,22,15,37,59.5%,1h
36702,1,DlARRHEAcube,2330,724,22,19,41,53.7%,4m
36702,1,AGROSHKILA,2330,358,21,20,41,51.2%,15m
36702,1,mobAKA,2330,499,20,20,40,50.0%,1h
36702,3,Ander,2330,429,15,24,39,38.5%,20m
36702,1,[PdTus]Vogul,2330,431,14,17,31,45.2%,28m
36702,2,RaketenBär,2330,360,13,17,30,43.3%,9m
36702,1,Scolopendra,2330,251,10,16,26,38.5%,6m
36702,1,artem,2330,346,8,5,13,61.5%,21m
36702,1,GamexOverPL,2330,258,8,9,17,47.1%,6m
36702,1,Cris,2330,296,8,12,20,40.0%,1h
36702,2,margolnak,2330,212,7,13,20,35.0%,1h
36702,1,tize,2330,162,6,3,9,66.7%,9m
36702,3,BaTTlePet,2330,195,6,11,17,35.3%,5m
36702,1,[JediK]Chewbacca,2330,124,3,2,5,60.0%,1h
36702,1,Mergil,2330,146,3,4,7,42.9%,3m
36702,3,butlust,2330,121,3,6,9,33.3%,1h
36702,1,assassin,2330,122,3,7,10,30.0%,1h
36702,3,RunBabyRun,2330,62,2,10,12,16.7%,5m
36702,1,Vladislav,2330,0,1,0,1,100.0%,29m
36702,1,[TBKH]iCykaAtZH,2330,0,1,2,3,33.3%,1h
36702,2,SebastianeK,2330,0,1,4,5,20.0%,1h
36702,1,pipper,2330,0,1,5,6,16.7%,7m
36702,1,vlad,2330,0,1,5,6,16.7%,1h
36702,3,Dev,2330,0,1,6,7,14.3%,23m
36702,3,LostLukas,2330,0,0,1,1,0.0%,28m
36737,2,CRUZ,2329,1587,274,287,561,48.8%,1h
36737,3,Badabing,2329,1560,255,262,517,49.3%,15m
36737,1,Dark,2329,1440,75,68,143,52.4%,26m
36737,1,GRoBoLoSS,2329,1213,65,58,123,52.8%,1h
36737,3,Khelgan,2329,1481,61,69,130,46.9%,1h
36737,3,Fang,2329,1057,51,53,104,49.0%,1h
36737,1,Pileofshiit,2329,1213,49,31,80,61.2%,1h
36737,1,visio,2329,511,23,19,42,54.8%,20m
36737,1,Magus,2329,540,19,28,47,40.4%,24m
36737,1,Drey,2329,422,12,12,24,50.0%,11m
36737,3,Anakin,2329,221,7,6,13,53.8%,1h
36737,3,Mario,2329,201,7,7,14,50.0%,28m
36737,3,cesarferlo,2329,62,6,9,15,40.0%,5m
36737,1,Brainbug,2329,134,6,14,20,30.0%,30m
36737,2,Eddy,2329,0,3,7,10,30.0%,1h
36737,2,Moskuz,2329,0,3,9,12,25.0%,1h
36737,1,Shaman,2329,0,1,0,1,100.0%,26m
36737,1,[XTCLol]DominiDivini,2329,42,1,1,2,50.0%,1h
36737,2,[CGOW]Grimaldus,2329,0,1,3,4,25.0%,1h
36737,2,Zezzpls,2329,0,1,4,5,20.0%,1h
36737,1,iko,2329,0,1,4,5,20.0%,1h
36737,2,Winbar,2329,88,1,5,6,16.7%,28m
36737,1,Tehendyy,2329,0,1,5,6,16.7%,7m
36737,1,armandinho,2329,0,1,5,6,16.7%,21m
36737,2,шумахер,2329,0,0,1,1,0.0%,1h
36737,1,AnticAntic,2329,0,0,1,1,0.0%,1h
36737,1,XALK,2329,0,0,1,1,0.0%,9m
36764,3,Marubozu,2328,1008,201,197,398,50.5%,6m
36764,3,Druschba,2328,1217,120,120,240,50.0%,16m
36764,1,TallChalk,2328,1639,70,72,142,49.3%,1h
36764,1,JezzJezz,2328,1184,69,70,139,49.6%,1h
36764,1,[KKFL]Lokus,2328,1157,46,37,83,55.4%,1h
36764,2,CEORF,2328,966,35,51,86,40.7%,3m
36764,1,chingis,2328,812,26,22,48,54.2%,1h
36764,3,Muzi,2328,567,25,29,54,46.3%,1h
36764,1,SirJames,2328,710,20,22,42,47.6%,1h
36764,1,SmokeID,2328,660,18,21,39,46.2%,1h
36764,1,Guggi,2328,510,14,16,30,46.7%,20m
36764,1,[TrApex]Apex,2328,442,13,8,21,61.9%,1h
36764,2,Monarch,2328,314,13,10,23,56.5%,1h
36764,3,GreenLightKO,2328,304,11,20,31,35.5%,16m
36764,1,sustav,2328,319,8,9,17,47.1%,1h
36764,1,WhiteLizard,2328,229,8,11,19,42.1%,1h
36764,1,pikipanda,2328,204,6,4,10,60.0%,1h
36764,1,MANU,2328,200,5,1,6,83.3%,1h
36764,3,Half,2328,30,5,4,9,55.6%,1h
36764,3,tararim,2328,196,5,10,15,33.3%,1h
36764,3,Vlados,2328,152,5,16,21,23.8%,12m
36764,1,[NUL2]LiquidGoofy,2328,96,3,1,4,75.0%,30m
36764,1,Denning,2328,0,3,3,6,50.0%,4m
36764,1,latvis,2328,84,2,2,4,50.0%,11m
36764,1,Heraklit,2328,0,2,3,5,40.0%,1h
36764,1,[VCa]Phantom,2328,0,1,0,1,100.0%,24m
36764,1,Stukov,2328,0,1,5,6,16.7%,27m
36764,1,[kikiri]Lokeoni,2328,0,1,5,6,16.7%,1h
36764,1,Sheferstoun,2328,96,1,6,7,14.3%,11m
36793,1,Darkbeast,2327,1575,249,261,510,48.8%,30m
36793,1,DemonPsyche,2327,1303,215,219,434,49.5%,1h
36793,3,fortyseven,2327,1580,132,123,255,51.8%,6m
36793,1,Stive,2327,1432,99,94,193,51.3%,1h
36793,3,[Фаталя]ауетатары,2327,1519,89,86,175,50.9%,16m
36793,1,мстислав,2327,1589,78,91,169,46.2%,15m
36793,2,Гот,2327,1048,56,61,117,47.9%,1h
36793,1,Madman,2327,1242,49,38,87,56.3%,1h
36793,1,ADRIAN,2327,927,47,53,100,47.0%,26m
36793,1,gentle,2327,1245,42,41,83,50.6%,1h
36793,1,Pirotehnik,2327,931,37,31,68,54.4%,26m
36793,3,MayDay,2327,616,32,26,58,55.2%,1h
36793,1,Prestor,2327,620,26,30,56,46.4%,20m
36793,1,LVE,2327,670,21,17,38,55.3%,1h
36793,1,Flor,2327,654,21,22,43,48.8%,4m
36793,1,DevilMayCry,2327,672,20,21,41,48.8%,1h
36793,3,Typo,2327,537,19,26,45,42.2%,7m
36793,1,jacouille,2327,367,15,7,22,68.2%,28m
36793,1,Baal,2327,566,15,16,31,48.4%,6m
36793,1,Pasha,2327,506,14,14,28,50.0%,26m
36793,2,vavl,2327,338,12,18,30,40.0%,1h
36793,1,tolikT,2327,379,12,18,30,40.0%,11m
36793,1,rect,2327,456,12,20,32,37.5%,7m
36793,1,FoksRot,2327,310,11,6,17,64.7%,1h
36793,1,Kycher,2327,360,10,10,20,50.0%,1h
36793,1,[CuriO]CuriosityO,2327,344,9,14,23,39.1%,1h
36793,3,BroExembal,2327,174,6,9,15,40.0%,10m
36793,1,Unicorn,2327,191,5,4,9,55.6%,1h
36793,2,Lesaw,2327,160,5,9,14,35.7%,1h
36793,3,Ancalagon,2327,151,5,10,15,33.3%,21m
36793,1,Goliath,2327,132,4,8,12,33.3%,1h
36793,1,bircules,2327,172,4,10,14,28.6%,1h
36793,1,[CОS]лёха,2327,48,2,1,3,66.7%,29m
36793,1,CyberPhantom,2327,96,2,4,6,33.3%,7m
36793,1,Szymenix,2327,97,2,5,7,28.6%,1h
36793,1,LeZoru,2327,0,1,4,5,20.0%,17m
36793,1,[JOKER]elloco,2327,0,0,1,1,0.0%,24m
36793,1,TroughSTER,2327,0,0,1,1,0.0%,1h
36793,1,VivaIlDuce,2327,0,0,2,2,0.0%,1h
36793,1,Formanden,2327,0,0,3,3,0.0%,1h
36793,1,Данила,2327,0,0,3,3,0.0%,19m
36793,1,[Sages]Haribold,2327,0,0,5,5,0.0%,1h
36835,1,SerKar,2326,1735,92,73,165,55.8%,5m
36835,3,AlexKolonits,2326,1184,89,84,173,51.4%,10m
36835,1,efoincflcefc,2326,1288,77,78,155,49.7%,29m
36835,2,Migo,2326,1139,62,65,127,48.8%,3m
36835,1,BBL,2326,560,50,38,88,56.8%,24m
36835,1,bigdildo,2326,1081,48,46,94,51.1%,1h
36835,1,Averon,2326,1145,46,40,86,53.5%,2m
36835,2,COBECTb,2326,1244,46,52,98,46.9%,1h
36835,1,malanake,2326,1276,43,42,85,50.6%,26m
36835,2,Watts,2326,1076,40,43,83,48.2%,1h
36835,1,[FuсkUU]Player,2326,765,26,17,43,60.5%,11m
36835,3,Bodya,2326,600,23,27,50,46.0%,3m
36835,3,Hasenfote,2326,546,20,24,44,45.5%,20m
36835,3,HiImOgisa,2326,315,20,25,45,44.4%,1h
36835,3,åååååå,2326,529,20,30,50,40.0%,7m
36835,3,Cannibal,2326,475,17,21,38,44.7%,1h
36835,1,Ahtum,2326,358,11,7,18,61.1%,1h
36835,1,Brillenpuzer,2326,205,11,12,23,47.8%,1m
36835,1,Mannie,2326,382,10,10,20,50.0%,17m
36835,1,SPARTANEC,2326,288,8,6,14,57.1%,1h
36835,3,IIIIIIIIIIII,2326,186,7,10,17,41.2%,1h
36835,3,Vei,2326,241,7,12,19,36.8%,4m
36835,1,ChildOfALord,2326,272,6,5,11,54.5%,1h
36835,1,Bohnanza,2326,194,6,23,29,20.7%,7m
36835,3,kosmokalli,2326,171,5,10,15,33.3%,1h
36835,3,najch,2326,201,5,11,16,31.2%,1h
36835,2,[LKVRS]убийца,2326,160,4,8,12,33.3%,1h
36835,1,Lapa,2326,66,3,0,3,100.0%,1h
36835,1,Kuni,2326,0,3,3,6,50.0%,23m
36835,1,Грин,2326,0,2,1,3,66.7%,1h
36835,1,MrBorodist,2326,144,2,1,3,66.7%,11m
36835,1,[1277]Begemot,2326,44,2,3,5,40.0%,1h
36835,1,XTAZ,2326,0,1,4,5,20.0%,4m
36835,2,PepperJohn,2326,89,1,4,5,20.0%,24m
36835,1,AgentIZain,2326,0,1,4,5,20.0%,1h
36835,1,TobikGG,2326,0,0,1,1,0.0%,2m
36871,1,Franwy,2325,1825,148,141,289,51.2%,1h
36871,1,LegoYoda,2325,1828,124,125,249,49.8%,1h
36871,3,LeChatBach,2325,1470,112,115,227,49.3%,29m
36871,1,cwZerro,2325,1682,104,93,197,52.8%,30m
36871,3,AgentJonson,2325,1142,93,90,183,50.8%,1h
36871,1,Soichiro,2325,1289,51,38,89,57.3%,1h
36871,1,FelixRA,2325,1384,47,51,98,48.0%,1h
36871,1,Sani,2325,910,46,36,82,56.1%,9m
36871,1,langenpg,2325,1212,43,44,87,49.4%,15m
36871,1,Bogus,2325,679,39,38,77,50.6%,15m
36871,1,[HBRG]ForAiur,2325,1045,38,31,69,55.1%,1h
36871,2,Artur,2325,990,33,45,78,42.3%,1h
36871,3,wascraft,2325,712,29,30,59,49.2%,1h
36871,3,DmitryShogun,2325,636,22,30,52,42.3%,20m
36871,1,[CruZe]Marian,2325,452,15,7,22,68.2%,11m
36871,1,[NVBG]rotary,2325,454,13,11,24,54.2%,29m
36871,1,FRENK,2325,229,12,12,24,50.0%,21m
36871,1,[6Starz]GreGY,2325,253,9,7,16,56.2%,3m
36871,3,Teax,2325,180,7,12,19,36.8%,16m
36871,1,Grimmdall,2325,148,5,8,13,38.5%,17m
36871,1,[K0ZAKI]Bluerec,2325,118,4,1,5,80.0%,1h
36871,1,longslim,2325,167,4,2,6,66.7%,13m
36871,3,[MatFac]SlonicZverj,2325,138,4,6,10,40.0%,1h
36871,1,Xandrios,2325,146,3,1,4,75.0%,21m
36871,1,[XIIIX]Check,2325,88,3,5,8,37.5%,7m
36871,1,Velenmaru,2325,40,2,0,2,100.0%,1h
36871,1,ShamanKirduk,2325,78,2,7,9,22.2%,1h
36871,1,AleksAleks,2325,0,1,0,1,100.0%,1h
36871,1,ARKANJO,2325,0,1,0,1,100.0%,1h
36871,1,Rudeboyrowe,2325,0,1,2,3,33.3%,1h
36871,2,paladin,2325,0,1,3,4,25.0%,13m
36871,1,[TН]Only,2325,0,1,3,4,25.0%,1h
36871,1,TGIshib,2325,0,1,4,5,20.0%,28m
36871,1,CAD,2325,0,0,1,1,0.0%,1h
36871,1,kempes,2325,0,0,1,1,0.0%,1h
36871,1,Taldarimian,2325,0,0,1,1,0.0%,26m
36871,2,Rolo,2325,0,0,1,1,0.0%,26m
36871,3,[Sk1K]Ghh,2325,0,0,1,1,0.0%,30m
36871,1,BREAKSTUFF,2325,0,0,3,3,0.0%,1h
36871,1,nosok,2325,0,0,3,3,0.0%,28m
36871,3,Спутник,2325,0,0,4,4,0.0%,21m
36912,2,VITYAZ,2324,1394,215,209,424,50.7%,27m
36912,1,Grinch,2324,1620,73,66,139,52.5%,11m
36912,1,namsoft,2324,711,35,28,63,55.6%,2m
36912,2,[300gas]ZLEEzz,2324,577,24,28,52,46.2%,1h
36912,2,[DNGs]Frontela,2324,677,22,33,55,40.0%,28m
36912,1,Leprosorium,2324,348,20,18,38,52.6%,1h
36912,1,[CMArmy]PoyZone,2324,672,19,19,38,50.0%,26m
36912,2,jrkinator,2324,428,16,28,44,36.4%,1h
36912,1,Ahbahoui,2324,435,14,18,32,43.8%,1h
36912,2,Jooe,2324,242,8,14,22,36.4%,1h
36912,1,Beson,2324,192,6,3,9,66.7%,20m
36912,3,Lumor,2324,178,6,11,17,35.3%,1h
36912,1,Gelo,2324,200,5,6,11,45.5%,6m
36912,1,Einar,2324,211,5,8,13,38.5%,2m
36912,1,Juls,2324,166,4,7,11,36.4%,1h
36912,1,Zeratsio,2324,168,4,8,12,33.3%,25m
36912,1,Danielsun,2324,42,2,0,2,100.0%,31m
36912,1,[mfixed]Qba,2324,99,2,2,4,50.0%,1h
36912,1,[COSMA]Mondalorian,2324,88,2,4,6,33.3%,6m
36912,1,Werrel,2324,0,2,5,7,28.6%,1h
36912,3,SiCKO,2324,96,2,6,8,25.0%,29m
36912,1,TOnOTyH,2324,0,1,0,1,100.0%,1h
36912,1,Lumis,2324,0,1,1,2,50.0%,1h
36912,2,Romchik,2324,0,1,3,4,25.0%,9m
36912,1,Roman,2324,0,1,4,5,20.0%,12m
36912,1,MrPrizrak,2324,0,1,5,6,16.7%,6m
36912,1,GROM,2324,0,1,5,6,16.7%,19m
36912,1,[HZeS]Dyllarian,2324,0,0,1,1,0.0%,1h
36912,1,Emptiness,2324,0,0,1,1,0.0%,17m
36912,3,EHOTpoloskun,2324,0,0,1,1,0.0%,1h
36912,1,[DFYJTU]ALEXSSS,2324,0,0,2,2,0.0%,28m
36943,1,UDB,2323,1520,118,121,239,49.4%,28m
36943,3,AMIRALNICOR,2323,1338,56,63,119,47.1%,1h
36943,3,Goliat,2323,254,34,38,72,47.2%,2m
36943,1,malex,2323,780,28,21,49,57.1%,1h
36943,3,[CSAHF]Ariest,2323,706,27,36,63,42.9%,3m
36943,3,Bsan,2323,614,22,28,50,44.0%,1h
36943,3,EarlyBird,2323,560,19,30,49,38.8%,16m
36943,1,Joker,2323,478,18,19,37,48.6%,1h
36943,1,Andrew,2323,592,17,17,34,50.0%,1h
36943,3,EGYGamer,2323,462,16,22,38,42.1%,2m
36943,1,NoFear,2323,510,15,18,33,45.5%,29m
36943,1,Chardassaut,2323,319,9,15,24,37.5%,1h
36943,1,Zeal,2323,130,4,6,10,40.0%,1h
36943,1,Maneken,2323,96,3,4,7,42.9%,15m
36943,1,JACOB,2323,97,3,6,9,33.3%,4m
36943,1,ValhallAKZ,2323,0,2,3,5,40.0%,1h
36943,3,[Marqis]DeGuenerat,2323,60,2,5,7,28.6%,7m
36943,3,[CDPM]Ghenda,2323,64,2,10,12,16.7%,15m
36943,1,Zheton,2323,0,1,0,1,100.0%,1h
36943,1,Alpha,2323,0,1,0,1,100.0%,19m
36943,1,KADINSKY,2323,89,1,1,2,50.0%,1h
36943,1,Ruslan,2323,0,1,5,6,16.7%,6m
36943,1,Longer,2323,0,0,1,1,0.0%,3m
36943,1,Eagl,2323,0,0,1,1,0.0%,10m
36967,3,Zutnas,2322,520,93,91,184,50.5%,1h
36967,2,bro,2322,1455,55,64,119,46.2%,4m
36967,1,[Genoa]Molen,2322,918,27,30,57,47.4%,1h
36967,3,[WYK]wYse,2322,648,25,31,56,44.6%,1h
36967,1,DGGRAF,2322,541,22,12,34,64.7%,10m
36967,1,[62rusR]WinterAlarm,2322,452,18,20,38,47.4%,17m
36967,1,zlodei,2322,342,14,6,20,70.0%,1h
36967,1,Zeclone,2322,430,12,12,24,50.0%,1h
36967,1,Maciek,2322,361,9,5,14,64.3%,6m
36967,1,iPam,2322,192,7,13,20,35.0%,1h
36967,1,Nom,2322,124,6,8,14,42.9%,10m
36967,3,hiuhito,2322,115,6,9,15,40.0%,13m
36967,3,[DYR]SentImperior,2322,179,5,2,7,71.4%,1h
36967,1,Carthias,2322,162,4,4,8,50.0%,24m
36967,3,[VVing]Biboow,2322,123,4,8,12,33.3%,1h
36967,2,[696]NearEdge,2322,48,3,3,6,50.0%,1h
36967,1,Mikounetor,2322,126,3,7,10,30.0%,1h
36967,1,KIRILLL,2322,135,2,2,4,50.0%,1h
36967,2,banderas,2322,0,2,6,8,25.0%,14m
36967,1,Евгений,2322,48,2,8,10,20.0%,5m
36967,1,Moustachio,2322,0,1,0,1,100.0%,3m
36967,1,koRn,2322,0,1,1,2,50.0%,28m
36967,1,TobbiSlobbi,2322,44,1,2,3,33.3%,1h
36967,1,[GS3B]Stanley,2322,48,1,3,4,25.0%,1h
36967,2,[AoD]Falcon,2322,0,1,4,5,20.0%,1h
36967,2,[NTD]Daniel,2322,0,1,4,5,20.0%,1h
36967,1,xavierdb,2322,0,1,5,6,16.7%,1h
36967,1,Santchos,2322,0,0,1,1,0.0%,1h
36967,1,Buon,2322,0,0,1,1,0.0%,30m
36967,1,[20ЛетO]rafa,2322,0,0,1,1,0.0%,1h
36997,2,Solar,2321,1564,287,300,587,48.9%,1h
36997,3,RDiamond,2321,1549,190,185,375,50.7%,6m
36997,3,kavalacity,2321,1518,120,125,245,49.0%,1h
36997,2,pochin,2321,1384,116,119,235,49.4%,24m
36997,3,Quaiker,2321,881,69,48,117,59.0%,6m
36997,1,pedrotex,2321,1466,56,49,105,53.3%,17m
36997,1,mirko,2321,488,21,23,44,47.7%,29m
36997,3,FriedEgg,2321,476,18,23,41,43.9%,22m
36997,1,dave,2321,578,16,16,32,50.0%,1h
36997,1,Bill,2321,304,9,7,16,56.2%,31m
36997,3,ZorPit,2321,278,9,16,25,36.0%,1m
36997,2,[GRATL]SIEX,2321,164,7,13,20,35.0%,27m
36997,1,Panem,2321,176,5,8,13,38.5%,1h
36997,1,Milenios,2321,118,4,1,5,80.0%,4m
36997,3,WhenYou,2321,129,4,20,24,16.7%,7m
36997,1,KOZA,2321,86,3,0,3,100.0%,30m
36997,3,JanWaine,2321,0,2,7,9,22.2%,9m
36997,1,Cranium,2321,0,1,0,1,100.0%,10m
36997,1,[KLPAW]pawel,2321,0,1,0,1,100.0%,21m
36997,1,rambold,2321,0,1,2,3,33.3%,3m
36997,1,[PACA]Yam,2321,0,1,5,6,16.7%,21m
36997,3,BitMaker,2321,0,1,5,6,16.7%,18m
36997,2,NumberSix,2321,0,0,1,1,0.0%,1h
37020,1,Set,2320,1818,151,149,300,50.3%,17m
37020,1,[BeP]RekaBull,2320,1758,90,75,165,54.5%,26m
37020,1,Balalaev,2320,1722,71,60,131,54.2%,21m
37020,3,Maks,2320,872,68,78,146,46.6%,22m
37020,1,Apoleo,2320,1616,62,54,116,53.4%,1h
37020,1,Hamedtj,2320,1408,52,48,100,52.0%,1h
37020,1,Сахарок,2320,1020,34,36,70,48.6%,1h
37020,3,Malman,2320,187,11,15,26,42.3%,29m
37020,3,[ZЕRGTV]pitip,2320,323,10,16,26,38.5%,1h
37020,1,Gutbuster,2320,229,8,10,18,44.4%,11m
37020,1,WildWolf,2320,158,5,4,9,55.6%,1h
37020,1,Bumbac,2320,144,5,7,12,41.7%,3m
37020,2,[CasiCH]FinoTop,2320,152,5,10,15,33.3%,19m
37020,3,ElCampeador,2320,148,5,14,19,26.3%,1h
37020,3,Predator,2320,0,3,3,6,50.0%,22m
37020,3,Woosch,2320,153,3,5,8,37.5%,1h
37020,1,[urzerg]Anna,2320,44,2,2,4,50.0%,1h
37020,1,Azov,2320,72,2,5,7,28.6%,1h
37020,1,SineeNebo,2320,73,2,7,9,22.2%,1h
37020,1,[1FU2]Bisk,2320,0,1,1,2,50.0%,1h
37020,1,Сверхразум,2320,0,1,2,3,33.3%,7m
37020,3,GHK,2320,0,0,2,2,0.0%,16m
37020,1,leonid,2320,0,0,3,3,0.0%,1h
37043,2,батлщет,2319,1525,218,228,446,48.9%,15m
37043,1,inan,2319,1779,85,79,164,51.8%,1h
37043,1,STARSKY,2319,1417,49,53,102,48.0%,29m
37043,3,Rigle,2319,853,49,55,104,47.1%,1h
37043,1,[kupka]MagicSock,2319,1328,46,44,90,51.1%,20m
37043,1,Hell,2319,880,28,46,74,37.8%,11m
37043,1,PRIMEX,2319,392,14,18,32,43.8%,1h
37043,1,magicmckenna,2319,430,11,12,23,47.8%,10m
37043,1,[ПИCYN]MihanySEX,2319,207,6,2,8,75.0%,1h
37043,1,ferz,2319,196,6,6,12,50.0%,1h
37043,1,[KCKNB]llllllllllll,2319,208,4,6,10,40.0%,4m
37043,3,minatokai,2319,191,4,8,12,33.3%,8m
37043,3,[ZLOBOZ]Dafs,2319,117,3,3,6,50.0%,22m
37043,3,Сoolscar,2319,46,3,8,11,27.3%,1h
37043,1,FGGSP,2319,46,2,1,3,66.7%,1h
37043,1,[SPAINs]Fiktorr,2319,48,2,6,8,25.0%,1h
37043,2,Fusil,2319,0,2,7,9,22.2%,1h
37043,3,MasterChief,2319,0,1,0,1,100.0%,1h
37043,1,[СвИнКи]RuFF,2319,42,1,1,2,50.0%,6m
37043,1,Coffee,2319,0,1,2,3,33.3%,7m
37043,1,Vitcox,2319,97,1,2,3,33.3%,29m
37043,1,AlvaroDestro,2319,0,1,2,3,33.3%,1h
37043,1,Silvar,2319,42,1,3,4,25.0%,1h
37043,1,CodeZ,2319,0,1,4,5,20.0%,6m
37043,1,[IFns]Aleksandr,2319,0,1,4,5,20.0%,1h
37043,2,tjox,2319,0,1,5,6,16.7%,1h
37043,1,Polo,2319,0,0,1,1,0.0%,1h
37043,2,BroodFather,2319,0,0,1,1,0.0%,1h
37043,1,Romasik,2319,0,0,1,1,0.0%,1h
37043,1,ЧАЙКА,2319,0,0,2,2,0.0%,15m
37043,2,PepoAudi,2319,0,0,9,9,0.0%,23m
37074,2,Lostconos,2318,1430,100,114,214,46.7%,12m
37074,1,Gerish,2318,1332,74,62,136,54.4%,1h
37074,1,SirVlad,2318,1024,32,28,60,53.3%,25m
37074,1,Cramycnanos,2318,986,30,31,61,49.2%,1h
37074,2,mark,2318,482,28,28,56,50.0%,13m
37074,1,LeProtoseque,2318,734,20,22,42,47.6%,15m
37074,1,RaiJmH,2318,407,14,6,20,70.0%,30m
37074,1,Liquidator,2318,398,10,12,22,45.5%,13m
37074,3,ADW,2318,304,10,17,27,37.0%,1h
37074,1,BVTTYBXTTER,2318,313,9,7,16,56.2%,7m
37074,1,Yul,2318,314,9,8,17,52.9%,13m
37074,1,StupidZelot,2318,228,9,13,22,40.9%,1h
37074,3,Ghostwarrior,2318,131,7,11,18,38.9%,1h
37074,1,[SPАRТА]Данил,2318,230,6,5,11,54.5%,7m
37074,1,Zerg,2318,128,6,13,19,31.6%,1h
37074,1,slycer,2318,164,5,8,13,38.5%,15m
37074,1,IntosRuss,2318,120,4,1,5,80.0%,1h
37074,1,[1AAA1]DRED,2318,160,4,2,6,66.7%,17m
37074,1,Leggy,2318,168,4,7,11,36.4%,4m
37074,1,[TAWK]Gonzo,2318,99,3,2,5,60.0%,1h
37074,1,[LMB]Amra,2318,34,2,5,7,28.6%,3m
37074,1,KanNonRushky,2318,0,1,0,1,100.0%,2m
37074,1,Bamood,2318,0,1,0,1,100.0%,30m
37074,1,HanSolo,2318,0,1,0,1,100.0%,29m
37074,1,Irongrinder,2318,0,1,0,1,100.0%,10m
37074,1,dont,2318,0,1,0,1,100.0%,29m
37074,2,Urizellius,2318,0,1,4,5,20.0%,17m
37074,1,[DLTED]Tokoloshe,2318,0,1,4,5,20.0%,1h
37074,2,Bisdo,2318,0,0,1,1,0.0%,1h
37074,1,AutismAndy,2318,0,0,1,1,0.0%,1h
37074,2,Dan,2318,0,0,1,1,0.0%,1h
37074,1,Logixyz,2318,0,0,2,2,0.0%,11m
37074,1,[ReBrG]Durruti,2318,0,0,3,3,0.0%,12m
37074,1,Oger,2318,0,0,5,5,0.0%,1h
37108,1,Axoneway,2317,1143,81,72,153,52.9%,9m
37108,1,Sprucesoup,2317,1485,54,50,104,51.9%,1h
37108,1,[aBueLo]LightBusterX,2317,1064,44,46,90,48.9%,10m
37108,1,Mosco,2317,1198,40,41,81,49.4%,1h
37108,1,Delos,2317,1044,35,31,66,53.0%,29m
37108,3,DARKhouse,2317,209,30,26,56,53.6%,1h
37108,2,Fragholt,2317,724,24,35,59,40.7%,1h
37108,1,[DBTav]Douleur,2317,409,16,20,36,44.4%,17m
37108,1,dsded,2317,354,14,5,19,73.7%,1h
37108,1,Kotlyar,2317,420,12,10,22,54.5%,1h
37108,1,Papay,2317,289,10,3,13,76.9%,1h
37108,1,[SmackB]PekЗl,2317,315,9,8,17,52.9%,1h
37108,1,SashaFT,2317,214,7,7,14,50.0%,1h
37108,1,Abdess,2317,203,5,5,10,50.0%,11m
37108,1,FiRrskal,2317,124,5,7,12,41.7%,1h
37108,3,Rusart,2317,144,5,12,17,29.4%,1h
37108,1,Mich,2317,168,4,6,10,40.0%,1h
37108,1,spot,2317,150,4,6,10,40.0%,21m
37108,1,cerseixd,2317,126,3,3,6,50.0%,25m
37108,3,галилим,2317,97,3,7,10,30.0%,1h
37108,1,Lullen,2317,44,2,2,4,50.0%,6m
37108,3,[GamerX]Whanos,2317,121,2,2,4,50.0%,1h
37108,1,HeroMarine,2317,89,2,4,6,33.3%,1h
37108,1,GliRoaMutHyd,2317,0,1,0,1,100.0%,28m
37108,1,clegane,2317,42,1,1,2,50.0%,21m
37108,1,[HPWZ]Robeson,2317,97,1,1,2,50.0%,1h
37108,1,GuessWho,2317,44,1,2,3,33.3%,21m
37108,1,Defardo,2317,0,1,5,6,16.7%,7m
37108,1,Cerber,2317,0,0,2,2,0.0%,17m
37108,1,Pafestivo,2317,0,0,2,2,0.0%,10m
37108,1,Mrxray,2317,0,0,2,2,0.0%,1h
37139,2,Slajfa,2316,1552,278,261,539,51.6%,1h
37139,1,Fistman,2316,1796,135,130,265,50.9%,1h
37139,3,DrMaster,2316,1315,53,52,105,50.5%,8m
37139,1,BangBang,2316,908,43,22,65,66.2%,1h
37139,3,nesergey,2316,1044,43,39,82,52.4%,1h
37139,2,doppleGG,2316,781,38,48,86,44.2%,1h
37139,1,[DHYD]Sanya,2316,1028,36,25,61,59.0%,1h
37139,1,[NOOBpl]cptArab,2316,950,31,29,60,51.7%,1h
37139,1,sajbend,2316,815,30,25,55,54.5%,1h
37139,1,Gigi,2316,906,30,31,61,49.2%,1h
37139,1,[NWGD]GAx,2316,683,26,24,50,52.0%,11m
37139,1,[SET07]Callaghan,2316,748,24,25,49,49.0%,1h
37139,1,einstein,2316,686,22,17,39,56.4%,1h
37139,3,aspid,2316,507,21,21,42,50.0%,1h
37139,1,[IHBtI]Redguard,2316,622,18,20,38,47.4%,3m
37139,1,Eithan,2316,453,18,20,38,47.4%,1h
37139,1,Wmuellix,2316,274,11,6,17,64.7%,19m
37139,3,[Spek]Harris,2316,300,11,18,29,37.9%,3m
37139,1,SkyWalker,2316,276,9,3,12,75.0%,1h
37139,1,xAngeLx,2316,264,8,12,20,40.0%,1h
37139,1,[Mastr]killers,2316,213,5,5,10,50.0%,28m
37139,1,kookoniki,2316,48,3,2,5,60.0%,1h
37139,1,Syl,2316,84,3,3,6,50.0%,6m
37139,1,stap,2316,0,3,4,7,42.9%,7m
37139,1,[AFKI]МеханоПесюн,2316,68,3,6,9,33.3%,28m
37139,1,paelle,2316,40,2,4,6,33.3%,17m
37139,1,UAP,2316,133,2,5,7,28.6%,2m
37139,1,Mulch,2316,40,2,5,7,28.6%,3m
37139,1,LokiLann,2316,0,2,6,8,25.0%,30m
37139,1,Ngasta,2316,0,1,0,1,100.0%,1h
37139,1,skyloog,2316,44,1,1,2,50.0%,21m
37139,1,Jan,2316,0,1,5,6,16.7%,1h
37139,1,Termal,2316,0,1,5,6,16.7%,8m
37139,1,Viktorr,2316,0,0,1,1,0.0%,30m
37139,1,Dron,2316,0,0,1,1,0.0%,1h
37139,1,LoudDelta,2316,0,0,3,3,0.0%,1h
37139,2,Nightraven,2316,0,0,4,4,0.0%,14m
37176,1,More,2315,1761,275,282,557,49.4%,15m
37176,1,jiri,2315,1744,191,204,395,48.4%,9m
37176,1,[OnaCHe]aaren,2315,1814,147,141,288,51.0%,28m
37176,3,AntikPrisadk,2315,632,121,121,242,50.0%,13m
37176,1,Starman,2315,1756,72,71,143,50.3%,16m
37176,1,Vandál,2315,1738,65,62,127,51.2%,30m
37176,1,Ciprian,2315,1640,63,52,115,54.8%,1h
37176,1,Edmond,2315,1672,59,60,119,49.6%,1h
37176,1,Ezir,2315,1157,43,40,83,51.8%,1m
37176,1,aporiano,2315,926,33,37,70,47.1%,26m
37176,1,IIIIIIIIIIII,2315,783,31,18,49,63.3%,1h
37176,1,TheDuke,2315,767,24,26,50,48.0%,1h
37176,1,[N003S]Iros,2315,256,22,12,34,64.7%,1h
37176,1,[EoAF]Squinookle,2315,370,16,2,18,88.9%,1h
37176,1,Vergil,2315,495,13,14,27,48.1%,1h
37176,1,OnlyBronz,2315,444,12,14,26,46.2%,21m
37176,2,jaZZ,2315,370,12,22,34,35.3%,20m
37176,1,[FauG]noSan,2315,300,11,3,14,78.6%,1h
37176,1,BigButin,2315,307,11,16,27,40.7%,28m
37176,1,дихака,2315,352,10,8,18,55.6%,16m
37176,1,Diego,2315,304,9,8,17,52.9%,1h
37176,1,Vandreads,2315,202,6,4,10,60.0%,3m
37176,1,wrach,2315,178,6,6,12,50.0%,17m
37176,1,[kaffDK]MortenDK,2315,124,4,2,6,66.7%,1h
37176,2,[SPT2]Malgacro,2315,30,3,8,11,27.3%,29m
37176,3,[Gondon]Imagination,2315,40,3,8,11,27.3%,1h
37176,1,KVAZAR,2315,82,2,2,4,50.0%,30m
37176,2,nathekiller,2315,0,2,2,4,50.0%,1h
37176,1,Snuff,2315,0,2,3,5,40.0%,1h
37176,3,[VRTAN]Matveybu,2315,121,2,3,5,40.0%,13m
37176,1,LiveStock,2315,84,2,5,7,28.6%,1h
37176,1,LSHD,2315,0,2,6,8,25.0%,3m
37176,3,NeeO,2315,0,2,7,9,22.2%,1h
37176,3,[ADKL]AnnihilatioN,2315,58,2,10,12,16.7%,9m
37176,1,[Hird]HansGeering,2315,0,1,1,2,50.0%,1h
37176,1,Gasha,2315,0,1,1,2,50.0%,20m
37176,1,KaptOrtega,2315,40,1,2,3,33.3%,29m
37176,1,SanchopeS,2315,44,1,3,4,25.0%,23m
37176,1,Alliage,2315,42,1,4,5,20.0%,6m
37176,1,Riddarvarg,2315,48,1,5,6,16.7%,1h
37176,1,[Zhig]Killtech,2315,113,1,5,6,16.7%,7m
37176,1,BenAi,2315,0,1,5,6,16.7%,1h
37176,1,legcyofthevo,2315,0,1,6,7,14.3%,27m
37176,2,hoooze,2315,0,0,1,1,0.0%,26m
37176,1,[HGeezy]Claudio,2315,0,0,3,3,0.0%,15m
37176,1,[H2O]Syphilis,2315,0,0,4,4,0.0%,24m
37222,1,Swearengen,2314,1605,110,100,210,52.4%,1h
37222,1,[Lolers]Kaizerai,2314,1577,91,84,175,52.0%,1h
37222,1,Deterok,2314,1040,57,53,110,51.8%,28m
37222,3,[Klownz]FlyingSirkus,2314,463,49,47,96,51.0%,1h
37222,1,illusioN,2314,765,45,36,81,55.6%,24m
37222,3,holderoger,2314,1051,38,48,86,44.2%,7m
37222,1,Fireffin,2314,532,16,15,31,51.6%,1h
37222,1,Oots,2314,430,12,12,24,50.0%,4m
37222,1,obikenobi,2314,269,10,16,26,38.5%,22m
37222,1,BORYTORY,2314,196,7,3,10,70.0%,1h
37222,1,MehdiByn,2314,218,6,7,13,46.2%,1h
37222,1,Holmgren,2314,192,5,4,9,55.6%,6m
37222,1,ReturnValue,2314,203,5,7,12,41.7%,5m
37222,1,aresnov,2314,149,5,7,12,41.7%,1h
37222,1,Multislayer,2314,204,5,11,16,31.2%,23m
37222,1,[Домик]карлсон,2314,132,4,3,7,57.1%,24m
37222,3,Helmov,2314,121,3,1,4,75.0%,1h
37222,3,MysteryRo,2314,32,3,9,12,25.0%,1h
37222,2,bloodelf,2314,0,2,2,4,50.0%,1h
37222,1,Zorak,2314,44,1,1,2,50.0%,6m
37222,1,Tornadostar,2314,0,1,1,2,50.0%,17m
37222,1,Verixon,2314,42,1,1,2,50.0%,2m
37222,1,Tomahawk,2314,44,1,2,3,33.3%,1h
37222,1,verreterrus,2314,0,1,4,5,20.0%,2m
37222,3,barcod,2314,40,1,5,6,16.7%,1h
37222,1,fieter,2314,0,1,5,6,16.7%,1h
37222,1,Plestin,2314,0,0,1,1,0.0%,1h
37222,2,NiKSViR,2314,0,0,1,1,0.0%,1h
37222,1,Example,2314,0,0,3,3,0.0%,31m
37222,1,Xprime,2314,0,0,5,5,0.0%,1h
37222,1,Alfa,2314,0,0,6,6,0.0%,1h
37253,3,Intasigs,2313,1317,67,72,139,48.2%,8m
37253,3,Revan,2313,1512,66,66,132,50.0%,1h
37253,3,Jeronimo,2313,1158,47,41,88,53.4%,5m
37253,1,Alexander,2313,933,35,20,55,63.6%,6m
37253,1,Terran,2313,749,25,19,44,56.8%,7m
37253,1,Sahem,2313,522,21,17,38,55.3%,1h
37253,1,MrAlexWhite,2313,738,21,22,43,48.8%,4m
37253,3,SDSting,2313,204,16,22,38,42.1%,2m
37253,1,Roman,2313,402,14,6,20,70.0%,1h
37253,1,VapeL,2313,400,13,6,19,68.4%,1h
37253,1,[LéKsos]BIGMATT,2313,452,11,10,21,52.4%,1h
37253,3,ssoipi,2313,224,9,14,23,39.1%,1m
37253,3,garlik,2313,120,5,10,15,33.3%,1h
37253,1,SirGodfrid,2313,126,4,2,6,66.7%,12m
37253,1,AndrBeb,2313,48,4,5,9,44.4%,1h
37253,1,BEN,2313,130,3,6,9,33.3%,1h
37253,1,kozik,2313,80,2,2,4,50.0%,2m
37253,1,КирюшаБледны,2313,88,2,2,4,50.0%,1h
37253,3,THORKJAMSON,2313,123,2,8,10,20.0%,1h
37253,1,Neftepanda,2313,0,1,5,6,16.7%,1h
37253,2,[PTEOC]Communist,2313,0,0,1,1,0.0%,17m
37253,1,ГейПорно,2313,0,0,1,1,0.0%,29m
37253,1,ПОХ,2313,0,0,3,3,0.0%,1h
37276,3,Adlay,2312,1295,143,141,284,50.4%,1h
37276,3,[UnstoP]AleksKobi,2312,1335,82,83,165,49.7%,1h
37276,2,SanyaReaper,2312,1434,58,64,122,47.5%,1h
37276,3,wandtapete,2312,1157,54,43,97,55.7%,19m
37276,1,oskar,2312,1064,33,37,70,47.1%,23m
37276,1,Alex,2312,849,27,30,57,47.4%,30m
37276,3,STALIN,2312,515,21,23,44,47.7%,5m
37276,1,WhatEverRU,2312,389,12,6,18,66.7%,10m
37276,3,babadoockk,2312,300,10,15,25,40.0%,24m
37276,1,[fpros]Gabbo,2312,281,9,7,16,56.2%,1h
37276,1,Ondrey,2312,276,9,25,34,26.5%,1h
37276,1,Chipolyno,2312,264,7,7,14,50.0%,1h
37276,3,Wekert,2312,195,6,3,9,66.7%,5m
37276,3,redwhite,2312,146,4,5,9,44.4%,1h
37276,1,[Wurm]Danitäter,2312,114,3,2,5,60.0%,1h
37276,1,serGo,2312,42,2,0,2,100.0%,1h
37276,1,GORN,2312,97,2,1,3,66.7%,1h
37276,1,[Mupfel]BlubberBall,2312,0,1,0,1,100.0%,1h
37276,1,Investigator,2312,97,1,2,3,33.3%,1h
37276,1,Miracles,2312,0,1,2,3,33.3%,31m
37276,2,Jailbird,2312,97,1,3,4,25.0%,1h
37276,2,Panayi,2312,0,1,4,5,20.0%,1h
37276,1,Alkor,2312,0,1,4,5,20.0%,1h
37276,1,Robypie,2312,0,1,5,6,16.7%,7m
37276,1,Arambo,2312,0,1,5,6,16.7%,3m
37276,1,Antoin,2312,0,1,5,6,16.7%,5m
37276,1,FLOFLOFLUFFY,2312,0,1,5,6,16.7%,1h
37276,1,Egzorcysta,2312,0,0,1,1,0.0%,28m
37276,1,Domin,2312,0,0,2,2,0.0%,30m
37276,1,Andariel,2312,0,0,3,3,0.0%,1h
37306,1,MonteFighter,2311,1251,96,78,174,55.2%,28m
37306,3,sola,2311,1123,47,50,97,48.5%,30m
37306,3,wickedkrel,2311,1002,36,38,74,48.6%,1h
37306,2,JPS,2311,910,32,44,76,42.1%,1h
37306,1,Tankist,2311,690,25,25,50,50.0%,1h
37306,1,AlexGoneMad,2311,441,15,15,30,50.0%,27m
37306,1,IceFire,2311,486,14,19,33,42.4%,1h
37306,1,DasPanda,2311,438,12,13,25,48.0%,1h
37306,3,HUNsanyi,2311,288,11,14,25,44.0%,1h
37306,1,Kreeks,2311,342,10,13,23,43.5%,1h
37306,2,GHOST,2311,292,9,13,22,40.9%,18m
37306,1,ChocoFruit,2311,274,8,13,21,38.1%,1h
37306,1,RECRY,2311,236,7,10,17,41.2%,1h
37306,3,kamic,2311,192,6,14,20,30.0%,1h
37306,3,[XOTWX]Isaac,2311,197,5,6,11,45.5%,1h
37306,3,CalexQQwZ,2311,140,5,10,15,33.3%,22m
37306,2,Iman,2311,136,5,15,20,25.0%,1h
37306,1,Nub,2311,166,4,6,10,40.0%,1h
37306,1,Ghafar,2311,170,4,6,10,40.0%,1h
37306,1,PanicMarine,2311,144,4,9,13,30.8%,7m
37306,1,Sewip,2311,121,4,9,13,30.8%,1h
37306,1,Zjawxer,2311,86,3,3,6,50.0%,1h
37306,1,ElwynAce,2311,48,3,6,9,33.3%,30m
37306,1,ИЗакацке,2311,146,3,8,11,27.3%,3m
37306,1,[OuC]Crabman,2311,40,2,1,3,66.7%,1h
37306,1,[I12DR]FilypW,2311,132,2,1,3,66.7%,13m
37306,3,NAGILUM,2311,30,2,8,10,20.0%,1h
37306,1,Tortel,2311,0,2,8,10,20.0%,2m
37306,1,ываыфауке,2311,0,1,1,2,50.0%,29m
37306,1,BloodyFury,2311,40,1,2,3,33.3%,29m
37306,2,[NRMD]bagdad,2311,0,1,4,5,20.0%,1h
37306,1,Moe,2311,40,1,4,5,20.0%,1h
37306,1,MaxiGor,2311,44,1,5,6,16.7%,1h
37306,1,SirRobertuz,2311,0,1,5,6,16.7%,3m
37306,1,sheeby,2311,0,1,5,6,16.7%,5m
37306,1,[VoidDr]HangmanЯр,2311,0,0,1,1,0.0%,13m
37306,1,MadJohn,2311,0,0,1,1,0.0%,29m
37343,2,immortal,2310,1492,149,158,307,48.5%,20m
37343,3,ЛОКТАРоГАР,2310,1535,115,117,232,49.6%,9m
37343,1,[1FU2]mikado,2310,1743,69,76,145,47.6%,1h
37343,1,[NZO]KiLiug,2310,1510,50,52,102,49.0%,27m
37343,2,[Oliv]Nufiol,2310,1332,50,61,111,45.0%,12m
37343,1,maroder,2310,1386,47,40,87,54.0%,3m
37343,1,кериш,2310,1204,46,38,84,54.8%,1h
37343,3,Givic,2310,511,45,56,101,44.6%,21m
37343,3,Защитник,2310,877,32,36,68,47.1%,5m
37343,1,MMRines,2310,781,28,25,53,52.8%,1h
37343,1,maxson,2310,814,26,29,55,47.3%,1h
37343,1,[КРН]Ibrik,2310,762,24,19,43,55.8%,3m
37343,1,garus,2310,815,24,22,46,52.2%,29m
37343,1,Ronin,2310,669,19,22,41,46.3%,12m
37343,1,[IIOGII]Stach,2310,570,16,23,39,41.0%,1h
37343,3,женя,2310,414,14,18,32,43.8%,1h
37343,1,[DAHUS]Jerem,2310,397,11,12,23,47.8%,29m
37343,1,Polkrom,2310,230,8,2,10,80.0%,9m
37343,1,Mediocrema,2310,198,7,9,16,43.8%,3m
37343,2,RoiserV,2310,184,7,19,26,26.9%,1h
37343,3,[Aoz]CptJack,2310,138,6,13,19,31.6%,1h
37343,2,Flash,2310,175,5,5,10,50.0%,30m
37343,1,Spyge,2310,189,4,2,6,66.7%,6m
37343,1,[DKSCII]Khira,2310,110,4,6,10,40.0%,1h
37343,1,Matski,2310,126,3,0,3,100.0%,1h
37343,1,sleepfighter,2310,82,3,2,5,60.0%,30m
37343,1,qwert,2310,144,3,7,10,30.0%,1h
37343,1,Tilou,2310,0,2,3,5,40.0%,5m
37343,1,Widowmaker,2310,88,2,4,6,33.3%,1h
37343,1,Szczotek,2310,97,2,5,7,28.6%,1h
37343,3,PPX,2310,62,2,9,11,18.2%,2m
37343,3,Derity,2310,125,2,11,13,15.4%,1h
37343,1,Borg,2310,42,1,1,2,50.0%,1h
37343,3,WooMan,2310,0,1,2,3,33.3%,5m
37343,1,burjui,2310,88,1,3,4,25.0%,1h
37343,1,ElFrancisco,2310,0,1,4,5,20.0%,2m
37343,1,biOwOrm,2310,0,1,5,6,16.7%,14m
37343,1,Voldermars,2310,0,0,1,1,0.0%,1h
37343,1,ALIENRLZ,2310,0,0,1,1,0.0%,20m
37343,1,Madlib,2310,0,0,1,1,0.0%,1h
37343,2,llllllllllll,2310,0,0,1,1,0.0%,1h
37343,1,[ЦарскТ]Antipaladin,2310,0,0,1,1,0.0%,1h
37343,2,xaros,2310,0,0,1,1,0.0%,1h
37343,1,Natu,2310,0,0,2,2,0.0%,9m
37387,1,ThracusRO,2309,1397,202,199,401,50.4%,1h
37387,1,kyobai,2309,1533,133,144,277,48.0%,1h
37387,1,NotMaru,2309,1351,58,47,105,55.2%,12m
37387,1,mce,2309,1686,58,62,120,48.3%,1m
37387,2,SEER,2309,1058,37,51,88,42.0%,20m
37387,1,DaMac,2309,745,33,29,62,53.2%,1h
37387,1,advokat,2309,728,29,15,44,65.9%,1h
37387,2,FacePuff,2309,672,25,33,58,43.1%,30m
37387,1,Artsivi,2309,291,11,11,22,50.0%,1h
37387,1,RotesAuto,2309,268,8,8,16,50.0%,1h
37387,3,Stef,2309,222,8,16,24,33.3%,1h
37387,1,[Exprt]SamLeSerpent,2309,224,7,7,14,50.0%,1h
37387,1,[OcК]VadikXXLELDA,2309,280,7,9,16,43.8%,1h
37387,2,Alvar,2309,128,6,13,19,31.6%,2m
37387,1,Raka,2309,159,5,7,12,41.7%,2m
37387,3,[hf4X4]GlitchMaster,2309,198,5,11,16,31.2%,22m
37387,1,[топ1]SUPERSTARS,2309,185,4,2,6,66.7%,1h
37387,1,Liveno,2309,177,4,7,11,36.4%,3m
37387,1,[Hаsu]vitekes,2309,169,3,2,5,60.0%,28m
37387,2,Mabbru,2309,30,3,7,10,30.0%,1h
37387,1,Ragalie,2309,40,2,0,2,100.0%,1h
37387,3,[ADMEN]Xaero,2309,30,2,0,2,100.0%,11m
37387,1,[OGXIII]Darkhell,2309,44,2,0,2,100.0%,13m
37387,1,poumtica,2309,48,2,1,3,66.7%,7m
37387,2,Incarnate,2309,0,1,1,2,50.0%,14m
37387,1,Brandy,2309,97,1,3,4,25.0%,1h
37387,1,[RuVoid]FriskCerber,2309,40,1,3,4,25.0%,1h
37387,1,[42069]RagnarDOOM,2309,42,1,3,4,25.0%,1h
37387,1,engessa,2309,0,1,4,5,20.0%,2m
37387,1,scarfi,2309,0,1,4,5,20.0%,1h
37387,2,[Rafi]Lord,2309,46,1,5,6,16.7%,1h
37387,3,[HollоW]Hiten,2309,30,1,6,7,14.3%,13m
37387,1,Mako,2309,0,0,1,1,0.0%,23m
37387,3,Astramast,2309,0,0,2,2,0.0%,22m
37387,3,Nongrata,2309,0,0,4,4,0.0%,24m
37387,1,Chamois,2309,0,0,5,5,0.0%,3m
37423,3,JohnSnow,2308,1512,92,98,190,48.4%,7m
37423,1,Brissou,2308,1438,53,48,101,52.5%,17m
37423,1,SyndromHelix,2308,888,49,38,87,56.3%,1h
37423,1,VORON,2308,1050,49,46,95,51.6%,1h
37423,3,Legheon,2308,934,34,43,77,44.2%,1h
37423,1,FabulousSean,2308,937,33,30,63,52.4%,1h
37423,1,kedibasi,2308,889,28,29,57,49.1%,1h
37423,1,Gelya,2308,661,26,19,45,57.8%,25m
37423,1,Niviroth,2308,831,25,29,54,46.3%,1h
37423,1,[TERIZM]Familiya,2308,507,16,17,33,48.5%,1h
37423,1,DerGameKing,2308,471,14,12,26,53.8%,30m
37423,1,Jimmy,2308,464,13,14,27,48.1%,30m
37423,1,ivskay,2308,408,11,13,24,45.8%,1h
37423,1,zergling,2308,320,9,12,21,42.9%,1h
37423,1,Blackoser,2308,193,5,8,13,38.5%,1h
37423,3,MoRk,2308,146,5,13,18,27.8%,12m
37423,1,AngeIDust,2308,160,4,7,11,36.4%,1h
37423,1,GreenTea,2308,192,4,7,11,36.4%,16m
37423,1,GoldFish,2308,84,3,2,5,60.0%,1h
37423,1,[DS24]Alavardov,2308,121,3,2,5,60.0%,20m
37423,2,iloveyou,2308,0,3,2,5,60.0%,1h
37423,1,Waldi,2308,126,3,4,7,42.9%,1h
37423,2,MaDMaNssS,2308,88,2,0,2,100.0%,9m
37423,2,rttn,2308,0,2,7,9,22.2%,5m
37423,1,zhora,2308,0,1,0,1,100.0%,27m
37423,3,vox,2308,0,1,0,1,100.0%,1h
37423,1,[CameO]Dexter,2308,0,1,1,2,50.0%,4m
37423,1,Uglen,2308,0,1,1,2,50.0%,1h
37423,1,skelA,2308,42,1,3,4,25.0%,1h
37423,1,honiboi,2308,0,1,7,8,12.5%,1h
37423,1,BUX,2308,0,0,2,2,0.0%,30m
37454,3,Xelnalgas,2307,1599,213,213,426,50.0%,1h
37454,1,ALEX,2307,1611,139,141,280,49.6%,24m
37454,3,MrShoot,2307,923,96,91,187,51.3%,13m
37454,3,[2bgr2]Sumrak,2307,1139,90,90,180,50.0%,22m
37454,2,MatTheGenius,2307,1447,65,74,139,46.8%,18m
37454,1,eretic,2307,680,41,41,82,50.0%,1h
37454,1,LickerDaPuss,2307,1107,41,51,92,44.6%,2m
37454,1,komyna,2307,1011,38,30,68,55.9%,27m
37454,1,MadGodEater,2307,346,18,5,23,78.3%,1h
37454,1,Ali,2307,542,18,18,36,50.0%,29m
37454,1,nabstar,2307,331,13,5,18,72.2%,19m
37454,1,Kirw,2307,320,11,9,20,55.0%,1h
37454,1,RiJiK,2307,326,9,23,32,28.1%,1h
37454,1,JONNY,2307,272,8,7,15,53.3%,23m
37454,1,[HTAED]Eichhörnchen,2307,212,7,2,9,77.8%,1h
37454,1,chaOs,2307,272,7,6,13,53.8%,2m
37454,3,LorTarbos,2307,197,7,11,18,38.9%,21m
37454,1,Sneaky,2307,175,4,3,7,57.1%,9m
37454,1,[IPPNNH]Tauri,2307,132,4,9,13,30.8%,1h
37454,3,DakotaGold,2307,70,4,9,13,30.8%,1h
37454,3,richards,2307,86,4,10,14,28.6%,20m
37454,1,FPO,2307,62,3,6,9,33.3%,1h
37454,1,Sergey,2307,0,2,6,8,25.0%,1h
37454,2,ednar,2307,0,1,4,5,20.0%,9m
37454,1,Zmeev,2307,0,1,5,6,16.7%,4m
37454,1,NoGameNC,2307,0,0,1,1,0.0%,1h
37454,1,Ottelo,2307,0,0,1,1,0.0%,29m
37454,1,Dormancymind,2307,0,0,1,1,0.0%,1h
37454,1,Makaciolas,2307,0,0,2,2,0.0%,4m
37454,1,[2Pizzа]Nordry,2307,0,0,8,8,0.0%,30m
37484,2,Darknight,2306,1257,200,198,398,50.3%,25m
37484,1,Kamikaze,2306,1059,77,74,151,51.0%,1h
37484,3,Idds,2306,1065,66,53,119,55.5%,1h
37484,3,Tsipa,2306,1060,47,49,96,49.0%,2m
37484,1,[123rar]LaurAZA,2306,716,21,22,43,48.8%,20m
37484,2,Shikaren,2306,384,15,21,36,41.7%,1h
37484,1,Robotwizard,2306,368,9,12,21,42.9%,27m
37484,1,[842703]Jacek,2306,295,8,6,14,57.1%,22m
37484,3,ricci,2306,238,7,12,19,36.8%,1h
37484,1,LovemyLady,2306,274,7,12,19,36.8%,1h
37484,1,Гай,2306,154,5,3,8,62.5%,1h
37484,1,[EUww1]LABADIENA,2306,202,5,5,10,50.0%,1h
37484,1,Reaper,2306,204,5,8,13,38.5%,13m
37484,1,bordimsov,2306,48,2,1,3,66.7%,11m
37484,1,TadaPro,2306,42,2,2,4,50.0%,1h
37484,1,Azares,2306,145,2,4,6,33.3%,11m
37484,1,StormStriker,2306,0,1,0,1,100.0%,3m
37484,1,GreandKT,2306,0,1,1,2,50.0%,17m
37484,2,sapog,2306,48,1,2,3,33.3%,1h
37484,1,Web,2306,44,1,3,4,25.0%,2m
37484,1,[PrimeU]arturogrimm,2306,0,1,4,5,20.0%,1h
37484,1,zitreezy,2306,0,1,5,6,16.7%,12m
37484,1,[GB86]PigSage,2306,0,1,5,6,16.7%,1h
37484,1,faerFOL,2306,0,0,1,1,0.0%,1h
37508,1,радж,2305,1708,95,92,187,50.8%,2m
37508,1,BRUCER,2305,1376,55,46,101,54.5%,30m
37508,1,[NTsa]Pommedeterre,2305,1057,39,41,80,48.8%,26m
37508,1,Bombaren,2305,819,31,25,56,55.4%,30m
37508,1,BilGeytZ,2305,351,17,13,30,56.7%,29m
37508,3,MrMammolius,2305,371,15,17,32,46.9%,5m
37508,1,Petko,2305,400,11,13,24,45.8%,1h
37508,1,Keishora,2305,208,5,4,9,55.6%,1h
37508,1,Cbass,2305,134,4,6,10,40.0%,22m
37508,1,Vano,2305,118,3,3,6,50.0%,1h
37508,1,ForlornSky,2305,160,3,8,11,27.3%,2m
37508,1,[DL2006]Exdar,2305,46,2,1,3,66.7%,7m
37508,1,[4EK]ewanleboss,2305,48,2,2,4,50.0%,1h
37508,1,[HARPIA]Doncy,2305,82,2,3,5,40.0%,1h
37508,1,Anubirnabis,2305,97,2,6,8,25.0%,23m
37508,1,Індюк,2305,0,1,0,1,100.0%,9m
37508,1,Santa,2305,0,1,4,5,20.0%,5m
37508,1,Тимофей,2305,0,1,5,6,16.7%,2m
37508,1,shadowslicer,2305,0,0,1,1,0.0%,6m
37508,1,[AntiZ]Ashaan,2305,0,0,1,1,0.0%,1h
37508,1,Byteit,2305,0,0,2,2,0.0%,1h
37529,1,nerhzull,2304,1260,173,174,347,49.9%,5m
37529,1,EvgenXava,2304,1656,90,85,175,51.4%,6m
37529,3,akela,2304,1355,69,72,141,48.9%,1h
37529,3,Zacken,2304,1156,66,63,129,51.2%,1h
37529,1,Lars,2304,1308,55,43,98,56.1%,1h
37529,3,Lesshii,2304,930,53,50,103,51.5%,9m
37529,3,Hasacz,2304,927,51,50,101,50.5%,13m
37529,3,Blaze,2304,171,32,27,59,54.2%,2m
37529,1,blizz,2304,735,26,22,48,54.2%,1h
37529,1,CombatPilot,2304,746,23,24,47,48.9%,23m
37529,1,ustes,2304,421,19,21,40,47.5%,27m
37529,1,MonsieurDee,2304,496,18,13,31,58.1%,30m
37529,1,Lokrantz,2304,354,12,7,19,63.2%,9m
37529,1,Sanya,2304,298,10,7,17,58.8%,1h
37529,3,Седой,2304,226,8,16,24,33.3%,16m
37529,1,HaNkYn,2304,242,7,11,18,38.9%,9m
37529,1,KerRayNis,2304,194,6,7,13,46.2%,1h
37529,1,Onun,2304,166,5,5,10,50.0%,29m
37529,1,FARtGAR,2304,192,5,9,14,35.7%,20m
37529,1,Toby,2304,188,4,6,10,40.0%,1h
37529,1,Goth,2304,149,4,7,11,36.4%,1h
37529,3,Gilles,2304,121,3,8,11,27.3%,13m
37529,1,Astat,2304,121,2,2,4,50.0%,1h
37529,1,Goca,2304,145,2,3,5,40.0%,5m
37529,1,TarakanoLov,2304,0,2,3,5,40.0%,2m
37529,2,KLim,2304,0,2,5,7,28.6%,4m
37529,1,GUN,2304,0,1,0,1,100.0%,9m
37529,1,happyfoxy,2304,40,1,1,2,50.0%,4m
37529,1,RisenDeath,2304,40,1,3,4,25.0%,1h
37529,1,[Учиха]Itachi,2304,42,1,4,5,20.0%,1h
37529,1,DerFlo,2304,0,1,5,6,16.7%,1h
37529,1,Master,2304,0,0,1,1,0.0%,1h
37529,1,EATDAOLEPpoo,2304,0,0,2,2,0.0%,20m
37529,1,angrypanda,2304,0,0,2,2,0.0%,1h
37563,1,OptimusKid,2303,1761,196,185,381,51.4%,1h
37563,3,[FHTCLB]Panther,2303,1333,64,66,130,49.2%,11m
37563,2,Remigiusz,2303,988,36,51,87,41.4%,30m
37563,1,ArturG,2303,1016,29,31,60,48.3%,1h
37563,3,Ansvider,2303,838,27,39,66,40.9%,1h
37563,2,maxx,2303,147,19,27,46,41.3%,13m
37563,1,garrot,2303,326,14,11,25,56.0%,28m
37563,1,Jejes,2303,429,14,19,33,42.4%,1h
37563,2,[B0oBz]neekToO,2303,348,13,18,31,41.9%,1h
37563,3,Commander,2303,298,12,19,31,38.7%,18m
37563,3,[fam1ly]NOOBDekA,2303,265,8,14,22,36.4%,15m
37563,1,Thanatos,2303,216,7,10,17,41.2%,26m
37563,1,GoodVibes,2303,261,6,10,16,37.5%,1h
37563,1,portoslemac,2303,160,5,6,11,45.5%,1h
37563,3,[Mаrs]MrLevi,2303,168,4,7,11,36.4%,8m
37563,1,Silencerx,2303,96,4,8,12,33.3%,2m
37563,2,React,2303,48,3,3,6,50.0%,1h
37563,3,Rokehn,2303,146,3,5,8,37.5%,1h
37563,1,theeg,2303,97,2,4,6,33.3%,27m
37563,1,craYons,2303,0,1,0,1,100.0%,1h
37563,1,Dador,2303,44,1,2,3,33.3%,1h
37563,1,bobcrusher,2303,42,1,2,3,33.3%,1h
37563,1,Bespal,2303,97,1,2,3,33.3%,1h
37563,3,[LRteam]Del,2303,95,1,4,5,20.0%,1h
37563,1,Snakelord,2303,0,1,4,5,20.0%,1h
37563,1,supernamnam,2303,0,1,5,6,16.7%,1h
37563,1,Elektroman,2303,92,1,6,7,14.3%,1h
37563,1,Alkhatraze,2303,0,0,1,1,0.0%,2m
37563,1,[NukeZ]ThAPm,2303,0,0,1,1,0.0%,17m
37563,1,Zavarzin,2303,0,0,4,4,0.0%,1h
37593,1,Franchesco,2302,1787,95,91,186,51.1%,1h
37593,1,StarR,2302,1137,64,49,113,56.6%,1h
37593,1,AurelioMax,2302,1028,37,27,64,57.8%,1h
37593,1,Holevovka,2302,963,30,35,65,46.2%,17m
37593,3,LUKCAR,2302,493,27,30,57,47.4%,1h
37593,1,Marcux,2302,578,24,21,45,53.3%,1h
37593,1,CATKILs,2302,454,17,17,34,50.0%,4m
37593,1,[JMPK]asdPeti,2302,458,16,23,39,41.0%,23m
37593,1,[BURIZA]AlexKoks,2302,336,10,5,15,66.7%,1h
37593,1,ahnevskiy,2302,361,10,14,24,41.7%,1h
37593,3,NCK,2302,254,8,9,17,47.1%,1h
37593,1,FREEDSK,2302,188,5,6,11,45.5%,15m
37593,2,[Nugket]Marmotte,2302,0,4,1,5,80.0%,1h
37593,1,UncleMrAbbo,2302,122,4,3,7,57.1%,12m
37593,1,Mando,2302,149,4,9,13,30.8%,1h
37593,1,Noel,2302,194,4,9,13,30.8%,1h
37593,1,Fduch,2302,189,4,13,17,23.5%,1h
37593,3,cheery,2302,30,2,1,3,66.7%,11m
37593,1,Nikolay,2302,84,2,2,4,50.0%,1h
37593,3,[TExGG]Akkarin,2302,0,1,0,1,100.0%,1h
37593,1,[TAW]Xyrox,2302,44,1,2,3,33.3%,13m
37593,1,LemonSoda,2302,44,1,6,7,14.3%,19m
37593,1,Loge,2302,0,0,1,1,0.0%,2m
37593,1,koprulu,2302,0,0,1,1,0.0%,1h
37593,1,Speakman,2302,0,0,1,1,0.0%,15m
37593,1,[ZERGSC]krovyfalcon,2302,0,0,2,2,0.0%,10m
37593,1,данил,2302,0,0,2,2,0.0%,2m
37593,3,[NlGE]BobRoss,2302,0,0,5,5,0.0%,25m
37593,3,stich,2302,0,0,6,6,0.0%,8m
37622,1,kolyashh,2301,1725,154,141,295,52.2%,1h
37622,1,Ziku,2301,1740,116,113,229,50.7%,1h
37622,2,Billaki,2301,1435,62,67,129,48.1%,24m
37622,1,Gurzon,2301,696,51,47,98,52.0%,1h
37622,1,император,2301,1088,40,30,70,57.1%,6m
37622,1,fafaf,2301,945,32,31,63,50.8%,1h
37622,1,Szicsu,2301,912,29,32,61,47.5%,30m
37622,1,Tyrannoexo,2301,499,18,11,29,62.1%,1h
37622,3,[LalkuX]серёга,2301,461,17,20,37,45.9%,5m
37622,1,Valexico,2301,432,11,13,24,45.8%,30m
37622,1,Jarec,2301,294,9,17,26,34.6%,1h
37622,1,Macmep,2301,276,8,4,12,66.7%,30m
37622,3,Theupah,2301,261,8,13,21,38.1%,6m
37622,1,Ckrols,2301,244,7,7,14,50.0%,1h
37622,1,DenChik,2301,270,7,10,17,41.2%,1h
37622,3,DeathCPT,2301,209,6,11,17,35.3%,1h
37622,1,OneWay,2301,164,5,7,12,41.7%,1h
37622,1,InoRus,2301,42,4,3,7,57.1%,6m
37622,1,Darkspark,2301,143,4,6,10,40.0%,1h
37622,1,freakykeyb,2301,167,4,9,13,30.8%,1h
37622,3,Molotow,2301,60,4,10,14,28.6%,1h
37622,2,SakisGr,2301,0,3,2,5,60.0%,26m
37622,1,Stukov,2301,82,3,2,5,60.0%,3m
37622,1,[SCGGA]Paul,2301,38,2,1,3,66.7%,1h
37622,1,Пушкин,2301,40,2,1,3,66.7%,1h
37622,1,Cerberus,2301,82,2,5,7,28.6%,22m
37622,1,TrollOfJom,2301,127,2,5,7,28.6%,1h
37622,1,samcio,2301,95,2,5,7,28.6%,26m
37622,1,immortal,2301,97,2,6,8,25.0%,1h
37622,3,hanter,2301,96,2,6,8,25.0%,1h
37622,1,doron,2301,0,1,0,1,100.0%,16m
37622,1,[ГеРоИИ]Герой,2301,0,1,0,1,100.0%,1h
37622,1,Mystos,2301,48,1,3,4,25.0%,6m
37622,2,Esteban,2301,0,1,4,5,20.0%,14m
37622,1,shnobbi,2301,0,0,1,1,0.0%,1h
37657,1,BrightHammer,2300,1763,125,122,247,50.6%,1h
37657,1,ROVA,2300,1789,82,80,162,50.6%,24m
37657,1,yorick,2300,1031,78,83,161,48.4%,1h
37657,1,[goldmn]roudoudoufou,2300,1188,49,33,82,59.8%,1h
37657,1,Corenbaine,2300,856,27,27,54,50.0%,24m
37657,1,[MUTANG]malgojaviro,2300,442,16,8,24,66.7%,6m
37657,1,vonpups,2300,437,14,10,24,58.3%,1h
37657,1,FunnyFox,2300,281,11,10,21,52.4%,1h
37657,2,[AsAg]Stepa,2300,345,10,23,33,30.3%,28m
37657,3,TotalCreep,2300,270,9,2,11,81.8%,1h
37657,3,Garry,2300,240,9,13,22,40.9%,16m
37657,1,TAPOK,2300,232,7,7,14,50.0%,17m
37657,2,Alex,2300,90,5,9,14,35.7%,1h
37657,1,[Gmod]Kdesys,2300,86,3,3,6,50.0%,31m
37657,1,Vaso,2300,84,3,4,7,42.9%,1h
37657,1,Abrakadabra,2300,167,3,21,24,12.5%,1h
37657,1,YourFala,2300,0,2,7,9,22.2%,2m
37657,1,PhilosOFF,2300,0,1,0,1,100.0%,17m
37657,2,starming,2300,46,1,1,2,50.0%,6m
37657,1,Dámonische,2300,0,1,1,2,50.0%,17m
37657,2,SolidQuentin,2300,48,1,5,6,16.7%,1h
37657,1,DeepSix,2300,0,1,5,6,16.7%,14m
37657,1,Barty,2300,0,0,1,1,0.0%,1h
37657,1,neVrag,2300,0,0,1,1,0.0%,3m
37681,2,[DLKZ]IoI,2299,1595,645,646,1291,50.0%,14m
37681,3,kwas,2299,1205,106,110,216,49.1%,31m
37681,1,AloraS,2299,1133,57,46,103,55.3%,13m
37681,1,booboos,2299,833,45,41,86,52.3%,1h
37681,1,SAYgg,2299,1249,41,47,88,46.6%,1h
37681,1,Dirtywizard,2299,968,40,38,78,51.3%,1h
37681,3,[1WN1]elconejo,2299,947,37,39,76,48.7%,6m
37681,1,MSK,2299,1005,34,33,67,50.7%,1h
37681,3,Nookie,2299,374,15,24,39,38.5%,14m
37681,1,AntonBBS,2299,335,13,14,27,48.1%,1h
37681,1,[ARTAS]Eeroladan,2299,247,12,2,14,85.7%,7m
37681,1,LaFayette,2299,436,12,15,27,44.4%,18m
37681,1,Spawnyara,2299,464,12,16,28,42.9%,1h
37681,1,johan,2299,372,11,9,20,55.0%,1h
37681,3,Carsaab,2299,148,8,11,19,42.1%,16m
37681,2,Gamusino,2299,182,8,14,22,36.4%,20m
37681,1,[TedB]Ninja,2299,217,6,2,8,75.0%,6m
37681,1,Viper,2299,242,6,8,14,42.9%,1h
37681,1,mannco,2299,144,5,4,9,55.6%,20m
37681,1,puCKBoi,2299,146,3,1,4,75.0%,1h
37681,3,TOTE,2299,122,3,8,11,27.3%,7m
37681,1,[DarkTI]FreeMush,2299,40,2,0,2,100.0%,1h
37681,2,[Ikar0s]ExecutorFil,2299,139,2,5,7,28.6%,17m
37681,1,Weardz,2299,44,2,6,8,25.0%,21m
37681,1,MCS,2299,0,1,0,1,100.0%,1h
37681,1,BORI,2299,0,1,0,1,100.0%,1h
37681,1,leleu,2299,42,1,1,2,50.0%,1h
37681,1,[NAICHA]smarton,2299,0,1,1,2,50.0%,1h
37681,1,Adam,2299,44,1,2,3,33.3%,18m
37681,1,PsiGoesBrrrr,2299,0,0,1,1,0.0%,1h
37681,1,Erevos,2299,0,0,1,1,0.0%,1h
37712,3,thug,2298,403,74,66,140,52.9%,5m
37712,1,винтик,2298,794,64,60,124,51.6%,1h
37712,1,[C12760]Peacemaker,2298,1321,58,54,112,51.8%,27m
37712,2,Kulning,2298,478,54,69,123,43.9%,1h
37712,3,Ghost,2298,821,37,40,77,48.1%,29m
37712,1,İnFeruu,2298,819,35,29,64,54.7%,1h
37712,1,Майки,2298,1018,33,37,70,47.1%,25m
37712,1,[GG2020]Neverdimka,2298,846,32,24,56,57.1%,1h
37712,1,NigaBrein,2298,896,32,28,60,53.3%,2m
37712,1,[TBUE]Florin,2298,432,17,15,32,53.1%,1h
37712,1,Vlad,2298,430,13,8,21,61.9%,1h
37712,1,viktoroven,2298,301,10,11,21,47.6%,12m
37712,1,RedWord,2298,310,9,7,16,56.2%,1h
37712,3,камин,2298,142,7,11,18,38.9%,8m
37712,3,flacon,2298,250,7,15,22,31.8%,2m
37712,1,Amigos,2298,42,6,3,9,66.7%,1h
37712,1,Alwerik,2298,154,4,1,5,80.0%,10m
37712,1,[Izual]VeryEasy,2298,118,4,2,6,66.7%,1h
37712,1,Wracker,2298,126,3,6,9,33.3%,1h
37712,1,Elizer,2298,96,3,7,10,30.0%,8m
37712,1,Paweł,2298,42,2,1,3,66.7%,6m
37712,1,Rocksteady,2298,120,2,3,5,40.0%,1h
37712,1,classic,2298,36,2,6,8,25.0%,1h
37712,3,Dusty,2298,0,1,4,5,20.0%,31m
37712,1,[Laki]DimaGG,2298,0,1,5,6,16.7%,10m
37712,1,PorpoiseXQ,2298,0,1,6,7,14.3%,5m
37712,1,Kitsunebi,2298,0,1,6,7,14.3%,1h
37712,1,[HACKZ]HappyGMR,2298,0,0,1,1,0.0%,9m
37712,1,[NIHED]CrazyPeti,2298,0,0,2,2,0.0%,30m
37712,1,[Đrink]péélóó,2298,0,0,3,3,0.0%,1h
37742,1,IDsDaddy,2297,1493,97,86,183,53.0%,1h
37742,3,Breke,2297,633,53,59,112,47.3%,30m
37742,2,TSG,2297,1307,49,54,103,47.6%,8m
37742,2,[Petrus]Mike,2297,564,22,26,48,45.8%,1h
37742,1,[J4E]Bergdoktor,2297,447,20,22,42,47.6%,1h
37742,1,AgeOfBlood,2297,203,13,8,21,61.9%,1h
37742,1,ibitq,2297,275,10,16,26,38.5%,1h
37742,1,Julbut,2297,278,7,7,14,50.0%,3m
37742,3,Uzym,2297,231,7,13,20,35.0%,1h
37742,1,[Cookes]GarryTonoff,2297,192,6,7,13,46.2%,3m
37742,1,nightwolf,2297,225,5,12,17,29.4%,1h
37742,1,Fyr,2297,183,3,3,6,50.0%,1h
37742,1,[hf4X4]anior,2297,88,3,7,10,30.0%,1h
37742,1,RavisS,2297,96,3,8,11,27.3%,1h
37742,3,MajorPatouf,2297,133,3,9,12,25.0%,1h
37742,1,[Arrows]iDax,2297,42,2,1,3,66.7%,1h
37742,1,Vash,2297,0,1,0,1,100.0%,2m
37742,1,[ExTr1m]CanadianRus,2297,0,1,0,1,100.0%,1h
37742,1,Killerparty,2297,0,1,0,1,100.0%,11m
37742,1,Morgana,2297,0,1,3,4,25.0%,1h
37742,1,Eichhörnchen,2297,48,1,3,4,25.0%,18m
37742,1,Tascobo,2297,0,1,4,5,20.0%,1h
37742,1,Dandi,2297,0,1,5,6,16.7%,1h
37742,1,oct,2297,94,1,5,6,16.7%,1h
37742,1,caser,2297,0,1,5,6,16.7%,30m
37742,1,Sideshow,2297,0,1,5,6,16.7%,17m
37742,3,Aiur,2297,0,0,1,1,0.0%,22m
37742,1,ThePowerPuff,2297,0,0,1,1,0.0%,25m
37742,1,UETIX,2297,0,0,2,2,0.0%,26m
37742,1,Pampam,2297,73,0,3,3,0.0%,1h
37772,2,Szepi,2296,1591,279,279,558,50.0%,1h
37772,1,Androns,2296,1402,171,162,333,51.4%,1h
37772,2,zenit,2296,523,101,96,197,51.3%,10m
37772,1,Кобра,2296,1760,82,86,168,48.8%,1h
37772,1,Klimov,2296,1405,76,68,144,52.8%,1h
37772,1,Laneron,2296,1632,61,60,121,50.4%,2m
37772,3,Tyranicide,2296,1147,55,58,113,48.7%,21m
37772,1,orsosoro,2296,943,54,55,109,49.5%,1h
37772,1,[1NO2]cayegranada,2296,1148,48,37,85,56.5%,29m
37772,1,MrShemsa,2296,1360,44,52,96,45.8%,7m
37772,1,EhrmanMat,2296,1110,34,37,71,47.9%,1h
37772,1,Adora,2296,764,25,28,53,47.2%,1h
37772,1,TheWarDoctor,2296,460,15,16,31,48.4%,1h
37772,1,Kubik,2296,336,10,9,19,52.6%,1h
37772,1,ThickCamille,2296,207,9,5,14,64.3%,27m
37772,1,TiiviTaavi,2296,290,8,10,18,44.4%,12m
37772,3,SATI,2296,117,5,4,9,55.6%,23m
37772,2,Madao,2296,88,5,12,17,29.4%,20m
37772,1,Maxeros,2296,117,4,6,10,40.0%,6m
37772,1,daddy,2296,154,4,9,13,30.8%,1h
37772,3,[SVB04]DAvEX,2296,164,4,10,14,28.6%,23m
37772,1,[Tripa]BestNoobEver,2296,166,3,5,8,37.5%,22m
37772,1,KennyPelmeny,2296,42,2,3,5,40.0%,1h
37772,1,mmorl,2296,48,2,6,8,25.0%,1h
37772,1,Paulik,2296,0,1,0,1,100.0%,30m
37772,1,festDispex,2296,0,1,0,1,100.0%,25m
37772,1,Arcanit,2296,0,1,1,2,50.0%,17m
37772,1,suslik,2296,42,1,2,3,33.3%,7m
37772,1,Samhain,2296,97,1,2,3,33.3%,1h
37772,1,Romby,2296,0,1,2,3,33.3%,1h
37772,1,[Ptit]Балиас,2296,42,1,3,4,25.0%,1h
37772,1,JEZU,2296,0,1,4,5,20.0%,13m
37772,2,TonkoUwU,2296,0,1,5,6,16.7%,9m
37772,1,IMay,2296,0,0,1,1,0.0%,30m
37772,1,evgeniy,2296,0,0,2,2,0.0%,1h
37807,3,GrandDad,2295,1541,250,258,508,49.2%,1h
37807,1,poduluboq,2295,1343,184,189,373,49.3%,12m
37807,1,Ali,2295,1618,179,186,365,49.0%,1h
37807,1,Hypokrassus,2295,1768,134,135,269,49.8%,1h
37807,1,Invader,2295,1372,84,75,159,52.8%,1h
37807,3,[r161om]KosinusUA,2295,1059,69,63,132,52.3%,1h
37807,1,FleX,2295,875,58,51,109,53.2%,1h
37807,1,drellaz,2295,1423,56,50,106,52.8%,28m
37807,1,Libris,2295,1261,45,40,85,52.9%,21m
37807,1,[firstb]Sahrteck,2295,1255,43,43,86,50.0%,17m
37807,1,Bouibouys,2295,991,32,41,73,43.8%,27m
37807,1,Apzhukin,2295,756,27,26,53,50.9%,1h
37807,1,Ranger,2295,457,20,10,30,66.7%,2m
37807,1,Rick,2295,644,19,16,35,54.3%,1h
37807,1,SCOMPEYROLS,2295,489,16,15,31,51.6%,17m
37807,1,RaWge,2295,344,13,5,18,72.2%,12m
37807,2,kalifax,2295,320,13,20,33,39.4%,14m
37807,1,Phrox,2295,230,12,4,16,75.0%,1h
37807,3,BASON,2295,228,9,12,21,42.9%,1h
37807,3,HorroRist,2295,246,8,12,20,40.0%,28m
37807,3,[KillMe]MadHorsey,2295,226,7,11,18,38.9%,1h
37807,1,Blackend,2295,143,5,4,9,55.6%,1h
37807,1,Zarathustra,2295,182,4,8,12,33.3%,15m
37807,1,SalatsosseHD,2295,0,3,3,6,50.0%,7m
37807,1,GURKA,2295,106,2,2,4,50.0%,27m
37807,1,Tenthor,2295,40,2,2,4,50.0%,29m
37807,1,Vodachka,2295,0,2,3,5,40.0%,1h
37807,1,[c3n]genjo,2295,42,2,5,7,28.6%,6m
37807,1,[DАRK]papka,2295,97,2,5,7,28.6%,30m
37807,1,liara,2295,112,2,6,8,25.0%,12m
37807,1,[ADMEN]Dimas,2295,0,1,0,1,100.0%,1h
37807,1,Pilou,2295,0,1,1,2,50.0%,13m
37807,2,Заратустра,2295,0,1,4,5,20.0%,1h
37807,1,PumaAal,2295,42,1,4,5,20.0%,2m
37807,1,KidneycAmper,2295,42,1,5,6,16.7%,20m
37807,1,samboets,2295,0,0,1,1,0.0%,1h
37807,1,[NGNL]CaptAwesome,2295,0,0,2,2,0.0%,1h
37807,1,Jim,2295,0,0,5,5,0.0%,21m
37845,1,BezpredelYT,2294,1434,55,48,103,53.4%,1h
37845,3,Mensey,2294,800,36,46,82,43.9%,15m
37845,1,Adii,2294,716,21,19,40,52.5%,1h
37845,1,[STF71]DNCR,2294,542,18,16,34,52.9%,26m
37845,1,Bogun,2294,398,11,10,21,52.4%,1h
37845,3,[EoNabs]theDude,2294,224,7,6,13,53.8%,28m
37845,1,CmT,2294,196,6,9,15,40.0%,1h
37845,3,MiniekPL,2294,146,4,3,7,57.1%,1h
37845,1,BlikBlouk,2294,56,3,1,4,75.0%,1h
37845,1,Мужикица,2294,122,3,3,6,50.0%,27m
37845,1,Chomik,2294,30,3,8,11,27.3%,25m
37845,2,DREDD,2294,48,2,4,6,33.3%,25m
37845,1,DeIetant,2294,0,2,4,6,33.3%,29m
37845,1,SSq,2294,143,2,6,8,25.0%,9m
37845,1,[Schrat]HöhlenSchrat,2294,111,2,6,8,25.0%,1h
37845,1,Koteyka,2294,0,1,1,2,50.0%,1h
37845,2,tschaul,2294,0,1,4,5,20.0%,29m
37845,1,Insane,2294,0,1,4,5,20.0%,1h
37845,1,SPY,2294,0,1,5,6,16.7%,1h
37845,1,Viola,2294,48,1,7,8,12.5%,14m
37845,2,bifidock,2294,38,1,8,9,11.1%,15m
37845,2,SilverKnight,2294,0,0,1,1,0.0%,1h
37845,1,Pikabctch,2294,0,0,1,1,0.0%,13m
37845,1,heavyloper,2294,0,0,1,1,0.0%,1h
37845,1,luluriko,2294,0,0,3,3,0.0%,1h
37870,2,Haaaaaans,2293,1088,118,113,231,51.1%,30m
37870,1,CharlieBrown,2293,1635,103,84,187,55.1%,27m
37870,2,[ZERGTB]Bahek,2293,780,30,42,72,41.7%,15m
37870,1,becalm,2293,477,25,25,50,50.0%,27m
37870,3,Tyrega,2293,539,20,22,42,47.6%,1h
37870,1,klasikmaster,2293,562,17,19,36,47.2%,30m
37870,1,Nico,2293,341,13,7,20,65.0%,1h
37870,1,BINDONG,2293,406,11,13,24,45.8%,1h
37870,1,Esip,2293,236,10,18,28,35.7%,23m
37870,3,MAREKMYCROFT,2293,58,6,7,13,46.2%,1h
37870,1,MotherGreen,2293,121,5,3,8,62.5%,1h
37870,1,WasteOfTime,2293,120,4,5,9,44.4%,1h
37870,1,Mira,2293,193,3,9,12,25.0%,1h
37870,1,[SunTry]PylonSlayer,2293,36,2,0,2,100.0%,7m
37870,1,Pazda,2293,136,2,3,5,40.0%,29m
37870,1,lins,2293,76,2,4,6,33.3%,1h
37870,1,МудрыйСокол,2293,38,2,4,6,33.3%,27m
37870,1,[4THC]DragonFist,2293,0,1,0,1,100.0%,1h
37870,1,[SC2GB]Dexter,2293,90,1,1,2,50.0%,1h
37870,1,IIIIIIIIIIII,2293,0,1,1,2,50.0%,23m
37870,1,Neimen,2293,42,1,3,4,25.0%,1h
37870,1,piotrusw,2293,42,1,5,6,16.7%,1h
37870,1,dvk,2293,0,1,5,6,16.7%,1h
37870,1,ǂßẫŊąŊƏǂ,2293,0,0,1,1,0.0%,1h
37870,1,GoodGames,2293,0,0,1,1,0.0%,3m
37870,1,Бродяга,2293,0,0,1,1,0.0%,1h
37870,1,[Podpol]AlexAlexAlex,2293,0,0,2,2,0.0%,1h
37897,3,Zethouron,2292,1301,179,167,346,51.7%,31m
37897,2,Goooper,2292,1081,42,44,86,48.8%,1h
37897,1,Garfild,2292,875,40,31,71,56.3%,1h
37897,1,Nightmare,2292,904,36,34,70,51.4%,30m
37897,3,Tim,2292,845,35,33,68,51.5%,31m
37897,3,BambooCrashr,2292,757,28,37,65,43.1%,1h
37897,1,DieOnMySight,2292,567,22,17,39,56.4%,1h
37897,1,OdinochkA,2292,533,17,13,30,56.7%,7m
37897,1,Zhulik,2292,553,16,19,35,45.7%,17m
37897,1,Crevette,2292,425,14,19,33,42.4%,29m
37897,2,[WDYA]Roblix,2292,401,11,24,35,31.4%,7m
37897,2,Blackstar,2292,263,10,13,23,43.5%,1h
37897,1,HomerSimpson,2292,250,7,7,14,50.0%,12m
37897,1,Tetanos,2292,126,6,2,8,75.0%,1h
37897,1,[FDAY]Ratchoulback,2292,241,5,9,14,35.7%,1h
37897,1,REDvolution,2292,147,4,6,10,40.0%,13m
37897,1,[xrym]LifeForAiur,2292,193,4,9,13,30.8%,1h
37897,3,CFG,2292,96,2,7,9,22.2%,16m
37897,2,copoiu,2292,0,1,0,1,100.0%,1h
37897,1,pdphun,2292,42,1,1,2,50.0%,1h
37897,1,Evgenii,2292,40,1,2,3,33.3%,27m
37897,1,ifoundalover,2292,40,1,2,3,33.3%,1h
37897,1,[MP4L]bashendriks,2292,0,1,5,6,16.7%,1h
37897,1,WhiteAngel,2292,0,1,5,6,16.7%,1h
37897,1,[qwertz]Timo,2292,0,0,1,1,0.0%,1h
37897,1,[TTVM]Peanut,2292,0,0,2,2,0.0%,7m
37897,1,JetpackCat,2292,0,0,2,2,0.0%,1h
37924,1,Zinken,2291,1670,85,74,159,53.5%,28m
37924,1,Silvio,2291,955,37,32,69,53.6%,6m
37924,3,Maxime,2291,748,27,29,56,48.2%,6m
37924,3,[APOCx]DANIELZAN,2291,163,23,22,45,51.1%,1h
37924,1,Benassi,2291,790,22,28,50,44.0%,1h
37924,1,PROGAYMER,2291,349,21,23,44,47.7%,1h
37924,1,[ATOM]Apan,2291,524,15,18,33,45.5%,17m
37924,1,SirJon,2291,360,11,6,17,64.7%,1h
37924,1,Swarm,2291,279,11,11,22,50.0%,9m
37924,1,snaake,2291,288,8,8,16,50.0%,1h
37924,1,Cardano,2291,268,7,4,11,63.6%,1h
37924,1,IDemoNII,2291,196,6,4,10,60.0%,7m
37924,3,shadow,2291,209,6,5,11,54.5%,1h
37924,1,Wookiee,2291,206,6,7,13,46.2%,1h
37924,1,MorphiXette,2291,188,5,3,8,62.5%,1h
37924,3,Sosk,2291,147,4,3,7,57.1%,1h
37924,1,Chocobo,2291,130,3,5,8,37.5%,18m
37924,1,BackFire,2291,42,2,2,4,50.0%,1h
37924,3,[XvFe]Sacke,2291,97,2,2,4,50.0%,1h
37924,2,Hansen,2291,0,2,3,5,40.0%,1h
37924,1,torlien,2291,82,2,4,6,33.3%,1h
37924,1,RebelDragon,2291,42,1,3,4,25.0%,1h
37924,1,Alkado,2291,42,1,4,5,20.0%,1h
37924,1,MIHA,2291,0,1,4,5,20.0%,1h
37924,1,vovan,2291,0,0,1,1,0.0%,20m
37924,1,Sagitarium,2291,0,0,4,4,0.0%,1h
37950,1,DasinBBB,2290,1806,220,211,431,51.0%,26m
37950,1,Mirko,2290,1766,196,197,393,49.9%,29m
37950,1,Vegas,2290,994,195,181,376,51.9%,19m
37950,1,cefiro,2290,1124,44,43,87,50.6%,28m
37950,1,powercell,2290,652,19,28,47,40.4%,17m
37950,3,Mips,2290,238,14,20,34,41.2%,1h
37950,1,Karadig,2290,474,13,20,33,39.4%,1h
37950,1,Sunriser,2290,323,11,17,28,39.3%,27m
37950,1,Jonrock,2290,264,8,7,15,53.3%,1h
37950,1,lolololololo,2290,249,8,7,15,53.3%,9m
37950,1,[CYOSK]flöwrilège,2290,242,7,11,18,38.9%,1h
37950,3,wieverrueckt,2290,210,7,18,25,28.0%,10m
37950,1,Joachim,2290,172,5,5,10,50.0%,1h
37950,1,Rainy,2290,172,4,7,11,36.4%,1h
37950,1,zakkez,2290,162,4,8,12,33.3%,12m
37950,2,ARAVIS,2290,48,2,6,8,25.0%,1h
37950,1,[wlm]dawidmo,2290,0,1,0,1,100.0%,1h
37950,1,[KKGGBB]odiseo,2290,44,1,2,3,33.3%,17m
37950,2,Ardreg,2290,0,1,4,5,20.0%,1h
37950,3,Alfons,2290,32,1,5,6,16.7%,1h
37950,1,Zaballa,2290,0,1,5,6,16.7%,1h
37950,1,PeioMax,2290,0,0,1,1,0.0%,3m
37950,1,JanSolo,2290,0,0,2,2,0.0%,21m
37950,2,Spider,2290,0,0,5,5,0.0%,29m
37974,1,Talon,2289,1445,121,114,235,51.5%,4m
37974,1,[UAŦeam]pacific,2289,1283,57,43,100,57.0%,1h
37974,3,Drunk,2289,933,55,63,118,46.6%,2m
37974,3,[YoMamm]Spoiler,2289,796,52,50,102,51.0%,26m
37974,1,[SEBULA]iti,2289,1199,38,45,83,45.8%,2m
37974,2,HeRo,2289,872,33,44,77,42.9%,14m
37974,1,thunderbear,2289,872,27,31,58,46.6%,3m
37974,1,gruby,2289,888,26,29,55,47.3%,1h
37974,1,TheFan,2289,617,24,25,49,49.0%,7m
37974,3,Alex,2289,551,19,23,42,45.2%,1h
37974,1,Geurty,2289,302,18,17,35,51.4%,11m
37974,1,bdfg,2289,662,18,23,41,43.9%,22m
37974,3,iceberg,2289,560,17,25,42,40.5%,9m
37974,1,Skorgior,2289,306,9,13,22,40.9%,17m
37974,3,Gefallen,2289,272,9,13,22,40.9%,24m
37974,2,[C0M]Nickelicious,2289,126,8,21,29,27.6%,12m
37974,1,[SiGaMi]Starlord,2289,193,7,5,12,58.3%,6m
37974,1,Lucho,2289,291,7,11,18,38.9%,1h
37974,3,NainMaboule,2289,146,6,6,12,50.0%,2m
37974,2,Limfouzel,2289,98,4,11,15,26.7%,30m
37974,1,hagen,2289,124,3,8,11,27.3%,17m
37974,2,Furthacc,2289,0,2,0,2,100.0%,29m
37974,2,Crazynico,2289,48,2,3,5,40.0%,1h
37974,1,[Megal]BATIMoArtem,2289,79,2,3,5,40.0%,1h
37974,1,heisenzerg,2289,78,2,6,8,25.0%,1h
37974,2,Zarkram,2289,123,2,8,10,20.0%,1h
37974,1,Raven,2289,0,1,0,1,100.0%,12m
37974,1,Aloryan,2289,0,1,0,1,100.0%,28m
37974,3,[Aie]MASTER,2289,0,1,1,2,50.0%,1h
37974,1,RuFF,2289,38,1,3,4,25.0%,23m
37974,2,Slip,2289,0,1,4,5,20.0%,14m
37974,1,[R2GrMa]Gaudi,2289,96,1,5,6,16.7%,31m
37974,2,Hakuda,2289,0,0,1,1,0.0%,1h
37974,1,stupidFrog,2289,0,0,1,1,0.0%,16m
37974,1,RAILGUN,2289,0,0,3,3,0.0%,4m
37974,1,андрэ,2289,0,0,3,3,0.0%,22m
38010,1,MoonWalker,2288,1671,252,256,508,49.6%,1h
38010,3,macus,2288,1461,128,130,258,49.6%,23m
38010,1,gorec,2288,733,78,78,156,50.0%,1h
38010,1,NightWolf,2288,1711,71,69,140,50.7%,1h
38010,3,Грейсон,2288,1204,46,56,102,45.1%,2m
38010,1,кот,2288,940,34,33,67,50.7%,1h
38010,3,[PrTons]SpooneyKnify,2288,742,27,33,60,45.0%,15m
38010,1,hamdik,2288,792,22,28,50,44.0%,1h
38010,1,Foil,2288,704,21,23,44,47.7%,1h
38010,1,Eugene,2288,334,12,11,23,52.2%,30m
38010,3,[Haszon]Farmaholélek,2288,304,11,18,29,37.9%,5m
38010,3,bravo,2288,275,9,15,24,37.5%,1h
38010,1,Glücksfuß,2288,224,8,10,18,44.4%,1h
38010,1,CHEESE,2288,242,7,6,13,53.8%,1h
38010,1,Rihtar,2288,178,5,7,12,41.7%,1h
38010,1,[WZ1]Ray,2288,104,4,2,6,66.7%,1h
38010,1,RicardoMilos,2288,169,4,3,7,57.1%,1h
38010,1,NoTrueAcc,2288,121,4,4,8,50.0%,1h
38010,1,emue,2288,74,3,6,9,33.3%,1h
38010,1,[AFLG]Guigui,2288,64,3,7,10,30.0%,1h
38010,3,Atsipo,2288,30,3,8,11,27.3%,1h
38010,1,nijwons,2288,48,2,2,4,50.0%,1h
38010,1,KaptainRSA,2288,76,2,7,9,22.2%,1h
38010,1,ImJoker,2288,0,1,0,1,100.0%,4m
38010,1,Лягушка,2288,0,1,3,4,25.0%,1h
38010,1,Marmitako,2288,0,1,4,5,20.0%,21m
38010,1,Freedom,2288,0,1,4,5,20.0%,1h
38010,2,Hans,2288,48,1,5,6,16.7%,14m
38038,1,Gandalf,2287,1599,135,132,267,50.6%,25m
38038,1,[ExTr1m]Scorpion,2287,852,41,24,65,63.1%,1h
38038,1,kope,2287,978,32,27,59,54.2%,2m
38038,1,Warlord,2287,754,25,32,57,43.9%,1h
38038,2,Becool,2287,588,22,35,57,38.6%,1h
38038,3,kohle,2287,459,18,27,45,40.0%,13m
38038,1,Davidpops,2287,370,13,9,22,59.1%,6m
38038,1,KANCHITA,2287,375,12,14,26,46.2%,27m
38038,1,malacszor,2287,229,9,4,13,69.2%,6m
38038,1,Mehannick,2287,304,8,10,18,44.4%,29m
38038,1,Zenimaks,2287,324,8,15,23,34.8%,23m
38038,1,Voll,2287,232,6,9,15,40.0%,17m
38038,1,NecroPheonix,2287,257,6,16,22,27.3%,1h
38038,1,Sinario,2287,121,4,5,9,44.4%,1h
38038,3,ValikIXVIII,2287,64,4,9,13,30.8%,9m
38038,1,[Fib8]Duster,2287,88,2,0,2,100.0%,4m
38038,1,llllllllllll,2287,0,2,3,5,40.0%,10m
38038,1,[1NS1]Tkach,2287,0,2,5,7,28.6%,1h
38038,2,thekiller,2287,0,2,7,9,22.2%,14m
38038,1,Suntra,2287,0,1,0,1,100.0%,22m
38038,1,Borniuus,2287,42,1,3,4,25.0%,2m
38038,1,Daniel,2287,42,1,5,6,16.7%,30m
38038,2,Mihai,2287,0,1,5,6,16.7%,1h
38038,2,Crisis,2287,0,1,17,18,5.6%,30m
38038,2,[NCCLP]FxCKxLOVE,2287,0,0,1,1,0.0%,1h
38038,1,HoPE,2287,0,0,1,1,0.0%,10m
38038,1,Fritz,2287,0,0,1,1,0.0%,1h
38038,2,Hanakine,2287,0,0,4,4,0.0%,25m
38066,1,[iality]Bergy,2286,1166,107,100,207,51.7%,1h
38066,1,Sedris,2286,1709,61,63,124,49.2%,20m
38066,1,Niputaidea,2286,605,51,50,101,50.5%,1h
38066,2,STFighter,2286,1167,45,58,103,43.7%,1h
38066,3,miki,2286,648,28,25,53,52.8%,1h
38066,3,Жириновский,2286,632,20,31,51,39.2%,28m
38066,1,NIMCblue,2286,494,18,13,31,58.1%,7m
38066,2,KILIK,2286,450,16,25,41,39.0%,26m
38066,1,[JaPP]Infestorrr,2286,392,14,16,30,46.7%,1h
38066,1,MORINOS,2286,476,12,16,28,42.9%,29m
38066,3,SpaceMarine,2286,278,11,16,27,40.7%,26m
38066,1,Siwy,2286,350,9,11,20,45.0%,1h
38066,1,Alex,2286,289,9,16,25,36.0%,1h
38066,3,shirohige,2286,247,8,12,20,40.0%,1h
38066,2,Derjik,2286,214,7,3,10,70.0%,1h
38066,1,Struct,2286,248,6,9,15,40.0%,29m
38066,1,ANDERA,2286,130,4,2,6,66.7%,1h
38066,1,Mando,2286,40,4,3,7,57.1%,21m
38066,1,[Harepa]Krantzo,2286,156,4,5,9,44.4%,22m
38066,1,Danner,2286,96,4,8,12,33.3%,29m
38066,1,LBA,2286,0,3,2,5,60.0%,1h
38066,3,neondragon,2286,66,3,5,8,37.5%,1h
38066,3,[Tassar]Aeternant,2286,117,3,7,10,30.0%,1h
38066,1,HuFFnerr,2286,107,2,1,3,66.7%,1h
38066,1,Permafrost,2286,82,2,4,6,33.3%,16m
38066,3,Russian,2286,97,2,6,8,25.0%,1h
38066,1,woychoy,2286,97,2,6,8,25.0%,1h
38066,1,LarsBos,2286,0,1,0,1,100.0%,30m
38066,1,Tamriel,2286,42,1,3,4,25.0%,3m
38066,1,Alben,2286,48,1,3,4,25.0%,1h
38066,1,Schwietzi,2286,0,1,3,4,25.0%,1h
38066,1,Tedbod,2286,97,1,4,5,20.0%,1h
38066,1,Heinrich,2286,0,1,5,6,16.7%,29m
38066,1,ELGodyro,2286,0,0,2,2,0.0%,1h
38100,3,Smerty,2285,1488,556,551,1107,50.2%,16m
38100,1,TheQ,2285,1796,241,234,475,50.7%,1h
38100,3,HyperSonic,2285,1113,73,86,159,45.9%,31m
38100,1,kseroys,2285,793,33,22,55,60.0%,1h
38100,1,Tofuga,2285,666,28,17,45,62.2%,30m
38100,2,neverovvvvvv,2285,526,21,28,49,42.9%,21m
38100,3,НеЭтоНеЯ,2285,554,19,29,48,39.6%,1h
38100,1,Andrey,2285,407,17,9,26,65.4%,30m
38100,2,KanjaTHAI,2285,381,11,23,34,32.4%,6m
38100,3,Ptitpaulo,2285,201,8,9,17,47.1%,1h
38100,2,Nod,2285,209,7,13,20,35.0%,1h
38100,1,Cliffjumper,2285,181,6,6,12,50.0%,1h
38100,1,Necro,2285,120,4,4,8,50.0%,8m
38100,1,Traject,2285,126,3,6,9,33.3%,28m
38100,1,[SqBolt]BlackAdderDK,2285,66,2,2,4,50.0%,1h
38100,1,QuelBail,2285,0,1,5,6,16.7%,1h
38100,1,BattleSilvan,2285,0,0,1,1,0.0%,1h
38100,1,[Юнион]Gucci,2285,0,0,1,1,0.0%,1h
38100,3,[CОS]zaurs,2285,0,0,1,1,0.0%,11m
38100,1,HANSOLO,2285,73,0,2,2,0.0%,17m
38100,1,bohemiaz,2285,0,0,6,6,0.0%,9m
38121,3,[VuV]Jones,2284,1416,101,107,208,48.6%,22m
38121,1,ZerggyDoggy,2284,1721,84,84,168,50.0%,28m
38121,1,bigshakey,2284,1480,68,81,149,45.6%,31m
38121,1,NighTy,2284,1147,43,33,76,56.6%,1h
38121,1,Pascal,2284,756,31,23,54,57.4%,2m
38121,3,dziobson,2284,678,29,26,55,52.7%,12m
38121,1,eomerr,2284,766,24,23,47,51.1%,4m
38121,1,Ragnar,2284,475,20,14,34,58.8%,18m
38121,1,MrFish,2284,374,17,8,25,68.0%,1h
38121,1,ASTE,2284,431,14,12,26,53.8%,17m
38121,2,NCP,2284,372,12,28,40,30.0%,9m
38121,1,[xVdMx]Coeppi,2284,240,8,11,19,42.1%,1h
38121,1,Kitty,2284,290,8,13,21,38.1%,1h
38121,3,Herbidikie,2284,214,7,14,21,33.3%,4m
38121,1,Fojak,2284,212,6,3,9,66.7%,1h
38121,1,[BCNG]Uporn,2284,180,6,7,13,46.2%,1h
38121,1,Cure,2284,146,5,4,9,55.6%,11m
38121,2,Sneakysquid,2284,213,5,15,20,25.0%,29m
38121,3,hlrplfh,2284,123,4,9,13,30.8%,1h
38121,1,Szakallo,2284,42,2,4,6,33.3%,1h
38121,1,CheesePlayer,2284,155,2,6,8,25.0%,17m
38121,1,DenZ,2284,97,2,6,8,25.0%,1h
38121,3,plahdenchik,2284,30,2,7,9,22.2%,1h
38121,1,Warhammer,2284,0,1,0,1,100.0%,1h
38121,1,repio,2284,88,1,1,2,50.0%,1h
38121,1,Kaos,2284,38,1,3,4,25.0%,6m
38121,1,Jasonat,2284,0,1,3,4,25.0%,2m
38121,1,anders,2284,0,0,1,1,0.0%,1h
38121,1,TEHb,2284,0,0,1,1,0.0%,10m
38121,1,Bogdan,2284,0,0,1,1,0.0%,25m
38121,1,[Папик]РэперНотМи,2284,0,0,1,1,0.0%,1h
38121,1,[FCxAKW]sfoster,2284,0,0,2,2,0.0%,21m
38121,1,Kizel,2284,0,0,2,2,0.0%,3m
38121,1,RoadToGrandM,2284,0,0,2,2,0.0%,1h
38121,1,[8G]Shinobi,2284,0,0,3,3,0.0%,6m
38156,3,PeRKeLeS,2283,1324,54,66,120,45.0%,16m
38156,1,Nochiyaya,2283,1340,47,45,92,51.1%,2m
38156,1,[рейд]crazymassa,2283,916,28,26,54,51.9%,8m
38156,1,arturklm,2283,870,27,28,55,49.1%,24m
38156,1,Mortiferr,2283,850,25,31,56,44.6%,1h
38156,1,denzl,2283,552,24,17,41,58.5%,24m
38156,1,Danil,2283,227,17,17,34,50.0%,1h
38156,1,[ExTr1m]MaverickClaw,2283,406,16,6,22,72.7%,1h
38156,1,hayusunny,2283,505,14,14,28,50.0%,11m
38156,1,pornostar,2283,432,13,11,24,54.2%,22m
38156,1,Shrek,2283,204,11,1,12,91.7%,1h
38156,1,falsett,2283,407,11,10,21,52.4%,12m
38156,1,COMPOglobal,2283,196,6,6,12,50.0%,23m
38156,1,[Kwan]Unbreakable,2283,236,6,10,16,37.5%,1h
38156,1,ksv,2283,206,6,10,16,37.5%,27m
38156,1,Teddy,2283,240,5,5,10,50.0%,29m
38156,1,FeLemonTM,2283,209,4,9,13,30.8%,1h
38156,1,Palach,2283,84,3,2,5,60.0%,1h
38156,1,Scyphozoa,2283,127,3,6,9,33.3%,27m
38156,1,IIIIIIII,2283,70,3,7,10,30.0%,11m
38156,1,Chava,2283,48,3,7,10,30.0%,7m
38156,1,Gulman,2283,82,3,9,12,25.0%,20m
38156,3,ptgodz,2283,90,3,12,15,20.0%,1h
38156,2,Ahren,2283,0,2,6,8,25.0%,6m
38156,1,Tobsen,2283,48,2,7,9,22.2%,12m
38156,3,MrSmith,2283,66,2,15,17,11.8%,10m
38156,3,Baikal,2283,97,1,4,5,20.0%,24m
38156,1,[3DEN]Nust,2283,0,1,4,5,20.0%,1h
38156,1,Ryoh,2283,0,1,5,6,16.7%,2m
38156,1,[YPS]DerGroßeMaxi,2283,0,0,1,1,0.0%,26m
38156,1,sorek,2283,0,0,1,1,0.0%,1h
38156,2,Ptaha,2283,0,0,1,1,0.0%,26m
38156,1,[Rus2]Zombie,2283,0,0,1,1,0.0%,1h
38156,1,[BeB]Marsyan,2283,0,0,2,2,0.0%,1h
38156,1,Asasin,2283,0,0,5,5,0.0%,1h
38156,2,[D7]DSevenMick,2283,0,0,9,9,0.0%,19m
38192,1,Mojo,2282,1764,138,137,275,50.2%,4m
38192,2,Rock,2282,1090,67,72,139,48.2%,21m
38192,1,Viktor,2282,1520,54,53,107,50.5%,25m
38192,3,straszyk,2282,1211,50,60,110,45.5%,1h
38192,3,Phil,2282,510,19,24,43,44.2%,13m
38192,1,McBlack,2282,604,16,19,35,45.7%,1h
38192,1,JOHNCRAFT,2282,470,14,15,29,48.3%,22m
38192,1,докторЛешый,2282,320,13,6,19,68.4%,23m
38192,1,AlkrV,2282,271,11,17,28,39.3%,31m
38192,3,heyzuez,2282,294,10,13,23,43.5%,9m
38192,1,hideaki,2282,217,9,10,19,47.4%,1h
38192,1,JAKEJAMES,2282,370,9,13,22,40.9%,1h
38192,1,qweasdzxczxc,2282,124,7,6,13,53.8%,1h
38192,3,Gurrinho,2282,155,7,9,16,43.8%,1h
38192,1,melkisedek,2282,225,5,10,15,33.3%,30m
38192,3,insociable,2282,150,5,16,21,23.8%,1h
38192,1,Drakmor,2282,124,4,1,5,80.0%,1h
38192,2,[LMBD]Sesy,2282,48,4,2,6,66.7%,1h
38192,1,Tassartanis,2282,128,4,5,9,44.4%,30m
38192,1,Natsu,2282,143,3,2,5,60.0%,1h
38192,2,[F117]shark,2282,0,3,18,21,14.3%,16m
38192,1,Dennisel,2282,104,2,2,4,50.0%,1h
38192,1,stas,2282,60,2,4,6,33.3%,1h
38192,2,Grishap,2282,0,2,4,6,33.3%,1h
38192,3,Ramzes,2282,93,2,6,8,25.0%,1h
38192,1,wen,2282,66,2,10,12,16.7%,1h
38192,1,[bgzona]PlayerSC,2282,0,1,2,3,33.3%,1h
38192,1,Slava,2282,40,1,4,5,20.0%,1h
38192,2,LuissPedro,2282,0,1,5,6,16.7%,1h
38192,1,Anderlay,2282,0,0,1,1,0.0%,27m
38192,1,shasuR,2282,0,0,2,2,0.0%,13m
38223,1,DAMOLECHO,2281,1799,198,195,393,50.4%,1h
38223,1,peW,2281,1663,118,108,226,52.2%,1h
38223,1,teatree,2281,1737,110,112,222,49.5%,1h
38223,1,Mechanizen,2281,1506,106,94,200,53.0%,6m
38223,1,Bonfaya,2281,579,46,41,87,52.9%,1h
38223,1,Artem,2281,1050,35,35,70,50.0%,2m
38223,1,MCTitel,2281,985,35,37,72,48.6%,1h
38223,1,DeadmeatEst,2281,992,33,26,59,55.9%,27m
38223,1,[CNSPRC]Chicken,2281,891,29,32,61,47.5%,1h
38223,1,MaudeVarnaes,2281,713,26,20,46,56.5%,30m
38223,1,Nesis,2281,560,23,20,43,53.5%,28m
38223,1,sudoVoid,2281,538,18,14,32,56.2%,1h
38223,1,Bely,2281,526,16,14,30,53.3%,29m
38223,1,MethBerg,2281,365,14,9,23,60.9%,4m
38223,1,OLEG,2281,522,13,18,31,41.9%,2m
38223,1,Bettastar,2281,356,10,7,17,58.8%,7m
38223,2,thunder,2281,254,9,13,22,40.9%,30m
38223,1,Sergio,2281,200,7,10,17,41.2%,1h
38223,1,[bisdak]iRonMarine,2281,219,6,6,12,50.0%,1h
38223,2,[ЕМPIRE]Ебалай,2281,136,5,18,23,21.7%,25m
38223,1,Altayka,2281,102,4,3,7,57.1%,26m
38223,1,saipfer,2281,114,4,4,8,50.0%,1h
38223,2,[1NO2]Rot,2281,30,3,7,10,30.0%,1h
38223,1,Raczy,2281,86,2,4,6,33.3%,11m
38223,2,[Uсhiha]Джотароо,2281,0,2,4,6,33.3%,1h
38223,1,Смертоин,2281,0,2,6,8,25.0%,13m
38223,2,Axoap,2281,0,2,6,8,25.0%,29m
38223,2,fabs,2281,88,2,7,9,22.2%,20m
38223,1,PokiZ,2281,0,1,2,3,33.3%,1h
38223,1,EGORER,2281,0,1,3,4,25.0%,3m
38223,1,Valerion,2281,48,1,5,6,16.7%,1h
38223,1,LoBsTaR,2281,0,0,1,1,0.0%,31m
38255,2,Grethe,2280,1381,150,149,299,50.2%,25m
38255,3,Vegas,2280,1499,116,112,228,50.9%,31m
38255,3,Bullman,2280,1370,116,123,239,48.5%,3m
38255,1,MrEver,2280,1660,86,74,160,53.8%,30m
38255,1,Манго,2280,700,24,23,47,51.1%,1h
38255,1,Denman,2280,738,21,21,42,50.0%,17m
38255,1,Danio,2280,463,13,15,28,46.4%,1h
38255,1,Smerti,2280,234,12,4,16,75.0%,1h
38255,1,PINKiller,2280,439,12,12,24,50.0%,7m
38255,1,Xeras,2280,149,7,5,12,58.3%,1h
38255,3,elonelon,2280,205,7,13,20,35.0%,8m
38255,1,agathorn,2280,48,4,5,9,44.4%,1h
38255,3,Brattmosh,2280,0,4,6,10,40.0%,23m
38255,2,Carras,2280,134,4,19,23,17.4%,19m
38255,2,GoliaTH,2280,0,3,2,5,60.0%,1h
38255,2,hanz,2280,0,3,2,5,60.0%,1h
38255,1,xbaumbo,2280,44,2,2,4,50.0%,1h
38255,2,JohnLennon,2280,0,2,4,6,33.3%,14m
38255,1,Alien,2280,74,2,5,7,28.6%,28m
38255,1,llllllllll,2280,119,2,5,7,28.6%,23m
38255,1,[OSTEN]Craccow,2280,84,2,6,8,25.0%,1h
38255,3,[EZPR]Crea,2280,0,2,6,8,25.0%,1h
38255,1,[SРID]SpiTFiRe,2280,0,1,0,1,100.0%,1h
38255,1,MrHeisenber,2280,0,1,0,1,100.0%,1h
38255,1,Orna,2280,40,1,5,6,16.7%,1h
38255,2,HarterHarald,2280,48,1,5,6,16.7%,6m
38255,1,Fuzaa,2280,0,1,5,6,16.7%,26m
38255,2,Gustlik,2280,0,0,1,1,0.0%,1h
38255,1,Taldo,2280,0,0,4,4,0.0%,1h
38284,3,Jerry,2279,1546,252,261,513,49.1%,28m
38284,3,[LeNi3]KoRnELpl,2279,1509,80,91,171,46.8%,31m
38284,1,galakos,2279,1712,69,64,133,51.9%,18m
38284,1,ВОЛОСАТЫЙ,2279,1708,63,63,126,50.0%,1h
38284,1,Marve,2279,807,25,30,55,45.5%,1h
38284,1,MasterBardo,2279,730,21,21,42,50.0%,26m
38284,1,Overlod,2279,447,17,9,26,65.4%,1h
38284,1,Strixie,2279,474,16,18,34,47.1%,1h
38284,3,Arkadiusz,2279,224,16,24,40,40.0%,1h
38284,1,Wally,2279,528,15,16,31,48.4%,1h
38284,1,[LifeTV]Dimon,2279,272,9,11,20,45.0%,15m
38284,1,[DTXCL]PanJapa,2279,241,8,5,13,61.5%,30m
38284,3,AINTON,2279,121,5,11,16,31.2%,1h
38284,1,VEz,2279,213,4,5,9,44.4%,27m
38284,1,freerider,2279,163,4,7,11,36.4%,4m
38284,1,JohnCena,2279,131,3,1,4,75.0%,29m
38284,1,kurten,2279,82,3,2,5,60.0%,1h
38284,1,Cretu,2279,72,3,6,9,33.3%,1h
38284,1,Reaper,2279,48,3,6,9,33.3%,14m
38284,3,RastaMan,2279,122,3,7,10,30.0%,1h
38284,1,Arhangel,2279,48,2,1,3,66.7%,1h
38284,1,ente,2279,48,2,4,6,33.3%,12m
38284,2,Nuvi,2279,0,2,4,6,33.3%,1h
38284,1,Imperial,2279,40,2,6,8,25.0%,3m
38284,2,[ZiPx]Scitz,2279,78,2,11,13,15.4%,1h
38284,1,DIABLOLMG,2279,0,1,0,1,100.0%,16m
38284,1,player,2279,90,1,1,2,50.0%,27m
38284,2,nicchenicche,2279,0,1,4,5,20.0%,6m
38284,1,stemer,2279,0,1,5,6,16.7%,1h
38284,1,Kamaz,2279,0,0,1,1,0.0%,1h
38284,1,Proton,2279,0,0,2,2,0.0%,16m
38284,1,Panda,2279,0,0,2,2,0.0%,1h
38284,1,Salem,2279,0,0,2,2,0.0%,1h
38284,1,[M13]MRJoe,2279,0,0,4,4,0.0%,1h
38284,1,hearthdragon,2279,0,0,4,4,0.0%,1h
38319,1,Mikelin,2278,1731,247,240,487,50.7%,3m
38319,1,Altai,2278,1509,77,62,139,55.4%,1h
38319,3,Veronica,2278,855,50,59,109,45.9%,28m
38319,1,[RusMoo]Vencendor,2278,843,34,24,58,58.6%,1h
38319,3,Knackwurst,2278,858,34,40,74,45.9%,18m
38319,1,[RofIer]Bogdan,2278,676,30,13,43,69.8%,1h
38319,1,retartedforu,2278,713,29,32,61,47.5%,1h
38319,1,Marcel,2278,771,24,25,49,49.0%,1h
38319,1,Disaster,2278,387,17,8,25,68.0%,10m
38319,1,[1FU2]Grapes,2278,452,14,12,26,53.8%,2m
38319,1,promsky,2278,258,10,6,16,62.5%,1h
38319,2,Terminator,2278,206,9,14,23,39.1%,7m
38319,1,[Wensze]Johny,2278,266,8,7,15,53.3%,22m
38319,3,televizor,2278,226,8,12,20,40.0%,1h
38319,1,PavlovsDog,2278,161,7,0,7,100.0%,29m
38319,3,vTScar,2278,215,7,11,18,38.9%,5m
38319,1,[TaqT]Mio,2278,164,6,7,13,46.2%,29m
38319,1,[FUJKA]Bober,2278,122,4,5,9,44.4%,11m
38319,1,[FlyGos]SergeantZ,2278,145,3,7,10,30.0%,16m
38319,1,Katsuryoku,2278,32,2,6,8,25.0%,1h
38319,3,Warman,2278,0,2,8,10,20.0%,1h
38319,3,Shotti,2278,0,1,0,1,100.0%,31m
38319,1,stralend,2278,40,1,2,3,33.3%,16m
38319,1,jockey,2278,38,1,2,3,33.3%,1h
38319,1,Barbosix,2278,40,1,5,6,16.7%,9m
38319,1,Sasha,2278,0,1,5,6,16.7%,17m
38319,1,[PNKS]tyz,2278,0,1,6,7,14.3%,1h
38319,3,Víktór,2278,0,0,1,1,0.0%,1h
38319,1,[BHH030]JohnD,2278,0,0,1,1,0.0%,1h
38319,1,[ЗЕRGТV]xMISAx,2278,0,0,1,1,0.0%,17m
38319,1,[DNGR]Jemeul,2278,0,0,1,1,0.0%,21m
38319,1,Vanger,2278,0,0,1,1,0.0%,1h
38319,1,LORDOFWAR,2278,0,0,1,1,0.0%,2m
38319,1,[MASTRO]XANFOU,2278,0,0,2,2,0.0%,2m
38319,1,Hunter,2278,73,0,3,3,0.0%,1h
38319,1,Xdmn,2278,0,0,3,3,0.0%,1h
38319,2,Luke,2278,0,0,3,3,0.0%,1h
38319,1,Alias,2278,0,0,4,4,0.0%,15m
38319,1,PvpAxe,2278,0,0,4,4,0.0%,16m
38319,2,RomanTMG,2278,0,0,4,4,0.0%,1h
38359,1,Hanzo,2277,1075,95,96,191,49.7%,1h
38359,1,Gravityx,2277,1790,86,92,178,48.3%,12m
38359,1,[FL4PS]FINGU,2277,1217,76,69,145,52.4%,1h
38359,2,[M406]Rod,2277,334,63,75,138,45.7%,8m
38359,1,Stephane,2277,1649,57,60,117,48.7%,28m
38359,3,steypho,2277,920,50,53,103,48.5%,1h
38359,3,Whiitee,2277,1075,40,46,86,46.5%,7m
38359,1,[OmDi]Mafio,2277,949,31,32,63,49.2%,30m
38359,1,Sphinx,2277,748,24,24,48,50.0%,1h
38359,1,qvalda,2277,574,16,23,39,41.0%,28m
38359,1,Lalas,2277,514,15,13,28,53.6%,30m
38359,1,MeisterFips,2277,514,14,14,28,50.0%,1h
38359,2,momo,2277,342,13,21,34,38.2%,19m
38359,1,Spaiik,2277,390,11,9,20,55.0%,7m
38359,1,[SLGH]IIIIIIIIIIII,2277,222,8,3,11,72.7%,22m
38359,1,Thib,2277,197,8,3,11,72.7%,27m
38359,1,rino,2277,213,7,7,14,50.0%,1h
38359,1,Михаил,2277,249,7,8,15,46.7%,1h
38359,1,Boncroissant,2277,222,7,11,18,38.9%,22m
38359,1,mamai,2277,230,6,4,10,60.0%,1h
38359,1,[DET54]DimonLimON,2277,230,6,9,15,40.0%,9m
38359,1,Arkad,2277,217,5,9,14,35.7%,1h
38359,1,Nebula,2277,92,5,11,16,31.2%,10m
38359,3,Lluke,2277,150,4,9,13,30.8%,14m
38359,1,BetaKongen,2277,136,3,3,6,50.0%,9m
38359,1,IIIIIIIIIIII,2277,152,3,3,6,50.0%,30m
38359,1,IIII,2277,97,3,6,9,33.3%,29m
38359,1,Smoker,2277,113,3,8,11,27.3%,1h
38359,3,ServietSky,2277,125,3,11,14,21.4%,17m
38359,1,hsync,2277,88,2,0,2,100.0%,1h
38359,1,[Floren]ACR,2277,92,2,0,2,100.0%,1h
38359,1,TrueDespair,2277,129,2,2,4,50.0%,6m
38359,2,Panzerbaer,2277,48,2,4,6,33.3%,26m
38359,1,GrosCanard,2277,80,2,5,7,28.6%,13m
38359,1,[LoL4ik]SeekerGame,2277,0,1,2,3,33.3%,1h
38359,1,MorAnd,2277,30,1,3,4,25.0%,1h
38359,2,GALACTUS,2277,0,1,4,5,20.0%,25m
38359,1,XTGeneral,2277,0,1,4,5,20.0%,10m
38359,2,[PPMA]BIGLIDOU,2277,0,0,1,1,0.0%,1h
38359,2,Superninja,2277,0,0,1,1,0.0%,1h
38399,1,FINCH,2276,1777,124,117,241,51.5%,17m
38399,1,NoobMaster,2276,1721,115,115,230,50.0%,1h
38399,2,NoobSayBot,2276,1119,74,77,151,49.0%,1h
38399,3,Langred,2276,508,56,75,131,42.7%,18m
38399,3,Uvex,2276,1040,37,43,80,46.2%,1h
38399,1,MrComrade,2276,673,24,20,44,54.5%,30m
38399,1,NokrimOZ,2276,435,21,9,30,70.0%,2m
38399,1,Take,2276,503,15,17,32,46.9%,1h
38399,1,morn,2276,544,15,19,34,44.1%,1h
38399,1,Максимилиан,2276,287,14,7,21,66.7%,3m
38399,1,[ClDlN]Langeweile,2276,374,10,9,19,52.6%,1h
38399,1,[scMAUI]Jayden,2276,280,9,6,15,60.0%,3m
38399,2,[SPAINs]chemi,2276,248,9,14,23,39.1%,1h
38399,1,TrigoZeta,2276,159,6,7,13,46.2%,1h
38399,1,Rondo,2276,164,5,5,10,50.0%,28m
38399,1,CollinCobra,2276,190,4,4,8,50.0%,1h
38399,1,Ghost,2276,164,4,7,11,36.4%,24m
38399,1,Omega,2276,166,4,10,14,28.6%,1h
38399,1,Woulver,2276,82,3,2,5,60.0%,1h
38399,1,Vencelito,2276,0,3,2,5,60.0%,1h
38399,3,syntagma,2276,36,3,8,11,27.3%,1h
38399,1,toka,2276,88,2,0,2,100.0%,1h
38399,1,[AnQ]Oldie,2276,82,2,3,5,40.0%,31m
38399,3,[R88lol]MilkyWay,2276,121,2,3,5,40.0%,1h
38399,1,Nicetolk,2276,40,2,5,7,28.6%,18m
38399,1,Manu,2276,44,2,6,8,25.0%,7m
38399,1,buhlorak,2276,88,1,2,3,33.3%,1h
38399,1,UncleBogdan,2276,42,1,3,4,25.0%,1h
38399,1,Neverhood,2276,0,1,4,5,20.0%,29m
38399,1,cheday,2276,73,1,4,5,20.0%,1h
38399,1,Chyvak,2276,0,1,5,6,16.7%,1h
38399,1,Elweir,2276,0,0,4,4,0.0%,1h
38399,2,[IceCub]EГОР,2276,0,0,5,5,0.0%,1h
38399,1,[5NSK4]BOSSLOL,2276,0,0,6,6,0.0%,1h
38433,1,[OPStar]lkmcl,2275,1499,173,181,354,48.9%,1h
38433,1,Nanoc,2275,1170,43,41,84,51.2%,30m
38433,1,HWR,2275,795,30,24,54,55.6%,4m
38433,1,Viper,2275,794,23,25,48,47.9%,28m
38433,1,[KGBist]termitFOvlad,2275,418,22,18,40,55.0%,18m
38433,3,BlackCat,2275,498,18,23,41,43.9%,12m
38433,1,ВаняПетечел,2275,581,17,22,39,43.6%,28m
38433,1,Draniu,2275,446,13,14,27,48.1%,15m
38433,1,Graztor,2275,391,12,17,29,41.4%,28m
38433,1,KazaK,2275,243,8,5,13,61.5%,1h
38433,3,Psyrotic,2275,234,8,13,21,38.1%,1h
38433,1,unkown,2275,215,7,8,15,46.7%,1h
38433,1,mergingFalls,2275,166,5,7,12,41.7%,16m
38433,1,Maxexmax,2275,105,4,4,8,50.0%,20m
38433,1,Dark,2275,160,4,11,15,26.7%,25m
38433,1,Renegade,2275,86,3,6,9,33.3%,1h
38433,1,Ruslan,2275,124,3,10,13,23.1%,1h
38433,1,Solon,2275,40,2,7,9,22.2%,1h
38433,1,JayPay,2275,0,1,0,1,100.0%,28m
38433,1,YoWantSum,2275,88,1,2,3,33.3%,1h
38433,1,Sleep,2275,38,1,3,4,25.0%,18m
38433,1,aaeveom,2275,0,0,1,1,0.0%,22m
38433,1,Barabulka,2275,0,0,2,2,0.0%,1h
38433,1,MIROILLL,2275,0,0,2,2,0.0%,1h
38433,1,AirAbdul,2275,0,0,4,4,0.0%,1h
38458,1,[ATAMIZ]Gelday,2274,1511,271,273,544,49.8%,1h
38458,3,Kezus,2274,1544,192,181,373,51.5%,1h
38458,1,kewin,2274,1026,83,81,164,50.6%,1h
38458,1,[13g12p]brny,2274,1623,62,63,125,49.6%,9m
38458,1,[EDKH]htlrdnwrng,2274,1339,45,45,90,50.0%,1h
38458,1,llllllllll,2274,1113,41,36,77,53.2%,15m
38458,1,BloodYStaR,2274,904,39,45,84,46.4%,22m
38458,1,Worlapim,2274,1015,35,30,65,53.8%,8m
38458,1,[Chariz]KSK,2274,618,30,16,46,65.2%,1h
38458,1,BurryProtos,2274,780,28,23,51,54.9%,1h
38458,3,[EPGs]CARLOS,2274,733,24,33,57,42.1%,1h
38458,3,Kostello,2274,547,22,24,46,47.8%,3m
38458,3,[13NRV]Zemlianin,2274,615,21,27,48,43.8%,1h
38458,1,done,2274,480,18,17,35,51.4%,1h
38458,1,Homey,2274,453,16,18,34,47.1%,31m
38458,1,[FoxC]Никча,2274,460,12,15,27,44.4%,1h
38458,1,Anur,2274,346,12,21,33,36.4%,27m
38458,3,Innopet,2274,319,11,5,16,68.8%,1h
38458,2,kill,2274,316,10,10,20,50.0%,17m
38458,1,Jorgon,2274,133,8,2,10,80.0%,1h
38458,1,noRulez,2274,214,7,4,11,63.6%,4m
38458,1,[pushik]kgbkradetsy,2274,231,6,8,14,42.9%,9m
38458,1,Jetflie,2274,123,5,4,9,55.6%,5m
38458,2,vlad,2274,147,5,6,11,45.5%,1h
38458,1,Pilote,2274,200,5,7,12,41.7%,16m
38458,1,zivil,2274,241,5,10,15,33.3%,1h
38458,3,Nex,2274,62,4,11,15,26.7%,1h
38458,1,Rocky,2274,80,3,2,5,60.0%,1h
38458,1,DarkSector,2274,104,2,1,3,66.7%,4m
38458,1,andreyZ,2274,76,2,5,7,28.6%,1h
38458,1,[dudeki]DJKukky,2274,121,2,5,7,28.6%,25m
38458,1,Patrick,2274,0,1,0,1,100.0%,1h
38458,1,Кратосс,2274,0,1,0,1,100.0%,12m
38458,1,[IRLA]TheFinalBoss,2274,0,1,1,2,50.0%,29m
38458,1,JESALMGRA,2274,0,1,2,3,33.3%,22m
38458,2,pelusi,2274,0,1,5,6,16.7%,1h
38458,1,saot,2274,0,0,1,1,0.0%,7m
38458,1,[FteamF]Aynn,2274,0,0,4,4,0.0%,11m
38496,1,Fenics,2273,1777,300,290,590,50.8%,1h
38496,3,[QaDo]Neversmile,2273,1269,120,128,248,48.4%,1h
38496,3,[DTSA]Pietman,2273,1088,77,72,149,51.7%,27m
38496,1,[FIAMMA]Tulas,2273,1181,53,33,86,61.6%,9m
38496,1,Cromart,2273,654,20,28,48,41.7%,30m
38496,1,Scarecrow,2273,438,19,19,38,50.0%,27m
38496,1,jennerj,2273,493,17,11,28,60.7%,1h
38496,1,[DTXCL]Szakal,2273,334,16,7,23,69.6%,6m
38496,1,Gandalfchris,2273,380,16,10,26,61.5%,1h
38496,1,Shadow,2273,336,16,16,32,50.0%,3m
38496,3,Avert,2273,221,9,9,18,50.0%,31m
38496,1,Jochen,2273,198,5,8,13,38.5%,1h
38496,3,Berilii,2273,186,4,6,10,40.0%,6m
38496,3,Ander,2273,147,4,8,12,33.3%,14m
38496,1,Skel,2273,129,3,1,4,75.0%,1h
38496,1,Prokiller,2273,143,3,4,7,42.9%,1h
38496,2,RHUM,2273,30,3,8,11,27.3%,1h
38496,3,[LCTP]BeeHaniwro,2273,30,3,8,11,27.3%,1h
38496,1,Scorpiontank,2273,68,2,4,6,33.3%,1h
38496,1,logkadegtya,2273,108,2,6,8,25.0%,1h
38496,3,[Acvila]Decebal,2273,123,2,9,11,18.2%,1h
38496,1,Illusion,2273,0,1,0,1,100.0%,3m
38496,3,bhBand,2273,0,1,0,1,100.0%,5m
38496,3,[D4NI5H]SNPer,2273,30,1,1,2,50.0%,25m
38496,1,lIIiiiiiilll,2273,40,1,4,5,20.0%,1h
38496,1,perry,2273,0,0,1,1,0.0%,1h
38496,1,[UKill]dangerdanya,2273,0,0,1,1,0.0%,26m
38496,1,[BELING]BrIMoN,2273,0,0,2,2,0.0%,1h
38496,3,MATYAS,2273,0,0,3,3,0.0%,1h
38525,2,alexia,2272,1445,350,351,701,49.9%,28m
38525,1,StarfightrBG,2272,1762,77,76,153,50.3%,1h
38525,1,[ISRI]sol,2272,1361,57,58,115,49.6%,18m
38525,1,Jek,2272,1535,53,59,112,47.3%,22m
38525,1,[zezozo]foolishmerc,2272,1225,47,36,83,56.6%,31m
38525,1,ilespanyiol,2272,989,35,40,75,46.7%,9m
38525,1,Bajekon,2272,641,21,20,41,51.2%,1h
38525,1,kolia,2272,405,16,10,26,61.5%,31m
38525,1,hammerhansi,2272,358,10,11,21,47.6%,1h
38525,3,sascha,2272,270,10,12,22,45.5%,5m
38525,1,Interstellar,2272,200,10,17,27,37.0%,1h
38525,1,Draxies,2272,320,9,10,19,47.4%,1h
38525,1,Стаканчик,2272,287,9,10,19,47.4%,30m
38525,1,DaNiLkA,2272,143,5,3,8,62.5%,1h
38525,1,[llBGll]thExpendable,2272,192,5,7,12,41.7%,1h
38525,1,BlackCmD,2272,241,5,9,14,35.7%,1h
38525,2,Benja,2272,46,4,1,5,80.0%,1h
38525,1,LiMoN,2272,169,4,3,7,57.1%,1h
38525,2,[Poufe]StrutPlayer,2272,170,4,10,14,28.6%,6m
38525,1,SolidRockTR,2272,105,2,2,4,50.0%,2m
38525,1,[SYRNI]STMBUL,2272,41,2,2,4,50.0%,1h
38525,2,Evgenij,2272,48,2,6,8,25.0%,1h
38525,1,kosmos,2272,42,1,2,3,33.3%,1h
38525,1,Ahriman,2272,0,1,2,3,33.3%,30m
38525,2,HecyCBeT,2272,0,1,4,5,20.0%,1h
38525,1,nestos,2272,0,0,1,1,0.0%,1h
38551,1,Veter,2271,1637,150,138,288,52.1%,1h
38551,1,Xtremekillz,2271,1575,95,79,174,54.6%,9m
38551,1,[мурзик]OLEGEKAT,2271,1198,66,59,125,52.8%,1h
38551,1,mamapapa,2271,1267,45,41,86,52.3%,3m
38551,1,EsAnderst,2271,1030,43,38,81,53.1%,2m
38551,3,Ainulindale,2271,819,30,36,66,45.5%,14m
38551,1,mrERASER,2271,752,29,25,54,53.7%,1h
38551,1,Llpol,2271,618,28,20,48,58.3%,1h
38551,1,ini,2271,684,20,27,47,42.6%,14m
38551,1,Rocinante,2271,448,15,25,40,37.5%,23m
38551,1,chody,2271,402,12,12,24,50.0%,31m
38551,1,Hello,2271,341,12,18,30,40.0%,29m
38551,1,Bobo,2271,318,11,14,25,44.0%,1h
38551,1,Амиадзе,2271,384,10,19,29,34.5%,1h
38551,1,Ashenari,2271,128,9,2,11,81.8%,11m
38551,1,СНЕГОВИК,2271,144,4,10,14,28.6%,13m
38551,1,Harmless,2271,120,3,7,10,30.0%,29m
38551,1,DKCZ,2271,76,2,4,6,33.3%,9m
38551,1,Nixon,2271,97,2,6,8,25.0%,3m
38551,1,IntosUkr,2271,0,1,0,1,100.0%,1h
38551,1,IIIIIIIIIIII,2271,0,1,0,1,100.0%,1h
38551,2,Albatre,2271,0,1,0,1,100.0%,1h
38551,2,[xTLSx]Maciej,2271,0,1,1,2,50.0%,23m
38551,1,Karnifex,2271,0,1,4,5,20.0%,1h
38551,1,reTeiD,2271,97,1,4,5,20.0%,11m
38551,2,Shagrat,2271,0,1,4,5,20.0%,15m
38551,1,Strider,2271,0,1,5,6,16.7%,1h
38551,1,[dLake]RoadRunner,2271,0,0,1,1,0.0%,13m
38551,1,nikodim,2271,0,0,1,1,0.0%,7m
38551,1,DarkArt,2271,0,0,3,3,0.0%,1h
38581,1,maximunae,2270,1699,139,138,277,50.2%,30m
38581,1,Khampton,2270,1279,66,62,128,51.6%,1h
38581,1,Juraj,2270,1028,38,43,81,46.9%,10m
38581,3,Falconer,2270,752,36,37,73,49.3%,3m
38581,1,Hero,2270,782,24,23,47,51.1%,16m
38581,1,Leps,2270,718,23,22,45,51.1%,1h
38581,1,ZaVDV,2270,498,21,17,38,55.3%,1h
38581,1,Overmind,2270,730,21,25,46,45.7%,1h
38581,1,Heddwyng,2270,494,13,17,30,43.3%,23m
38581,1,[TuRki]BigTesty,2270,362,9,13,22,40.9%,20m
38581,1,Лаяс,2270,285,6,7,13,46.2%,1h
38581,1,[ДУРКА]kykymbanet,2270,177,5,5,10,50.0%,2m
38581,3,WhiteCrown,2270,95,4,4,8,50.0%,31m
38581,1,Bendewer,2270,147,4,8,12,33.3%,1h
38581,1,JohnSilver,2270,124,4,10,14,28.6%,22m
38581,1,Lorn,2270,124,3,7,10,30.0%,11m
38581,1,DRED,2270,96,3,8,11,27.3%,5m
38581,1,SilentGhost,2270,96,3,8,11,27.3%,1h
38581,3,Kerking,2270,154,3,9,12,25.0%,1h
38581,1,DarkRaveN,2270,105,2,6,8,25.0%,11m
38581,1,tommy,2270,0,1,0,1,100.0%,22m
38581,1,mufuffu,2270,91,1,1,2,50.0%,1h
38581,1,jason,2270,0,1,1,2,50.0%,14m
38581,1,Glurak,2270,97,1,1,2,50.0%,1h
38581,2,spitfire,2270,0,1,4,5,20.0%,1h
38581,2,alexelite,2270,0,1,5,6,16.7%,26m
38581,1,Caurex,2270,0,1,5,6,16.7%,13m
38581,1,CAO,2270,0,1,6,7,14.3%,1h
38581,1,Mathias,2270,42,1,8,9,11.1%,1h
38581,3,ggg,2270,0,0,1,1,0.0%,26m
38581,1,дикийлось,2270,0,0,1,1,0.0%,1h
38581,3,Skills,2270,0,0,2,2,0.0%,1h
38613,3,Arxparon,2269,1181,194,200,394,49.2%,16m
38613,3,roribreaker,2269,1447,179,165,344,52.0%,1h
38613,2,Vadim,2269,1383,138,152,290,47.6%,10m
38613,1,[Chonky]DrDestructo,2269,1781,102,101,203,50.2%,28m
38613,3,Arcater,2269,1409,62,68,130,47.7%,21m
38613,1,[X1X2]Ziolek,2269,1282,52,49,101,51.5%,1h
38613,1,Schorre,2269,1270,48,41,89,53.9%,28m
38613,1,Molok,2269,1083,44,38,82,53.7%,21m
38613,1,generalY,2269,1216,44,39,83,53.0%,1h
38613,1,Lonti,2269,1084,43,36,79,54.4%,1h
38613,1,CHEMA,2269,944,31,31,62,50.0%,8m
38613,1,zerroo,2269,904,27,34,61,44.3%,1h
38613,1,Rodewas,2269,678,24,25,49,49.0%,1h
38613,1,prokolgotki,2269,706,22,21,43,51.2%,29m
38613,1,Schwamm,2269,585,20,17,37,54.1%,1h
38613,3,KingRollo,2269,554,19,23,42,45.2%,1h
38613,1,СТРЭЙК,2269,312,11,10,21,52.4%,1h
38613,1,Just,2269,227,8,12,20,40.0%,1h
38613,1,Remarque,2269,220,6,4,10,60.0%,30m
38613,2,GIVEMEACAGE,2269,206,6,10,16,37.5%,26m
38613,3,JBrexa,2269,182,6,15,21,28.6%,1h
38613,1,Egork,2269,126,3,3,6,50.0%,1h
38613,3,[Zhig]Dart,2269,97,2,0,2,100.0%,22m
38613,1,joker,2269,96,2,0,2,100.0%,4m
38613,1,gregor,2269,48,2,6,8,25.0%,4m
38613,3,Currahee,2269,0,2,8,10,20.0%,1h
38613,1,Elam,2269,76,2,8,10,20.0%,1h
38613,1,Klaus,2269,82,2,8,10,20.0%,21m
38613,1,bolshak,2269,0,1,0,1,100.0%,16m
38613,1,Fulgrim,2269,92,1,1,2,50.0%,26m
38613,1,HaterZero,2269,0,1,1,2,50.0%,1h
38613,1,Dimaski,2269,40,1,3,4,25.0%,11m
38613,1,[ISWAGl]Landogar,2269,0,0,1,1,0.0%,7m
38613,2,STARTAPOK,2269,0,0,1,1,0.0%,9m
38613,1,YOUNG,2269,0,0,1,1,0.0%,1h
38613,3,[CZxX]DayRay,2269,0,0,1,1,0.0%,1h
38613,1,SanchesAL,2269,0,0,1,1,0.0%,1h
38613,1,KraKor,2269,0,0,7,7,0.0%,22m
38651,3,mischa,2268,1520,192,192,384,50.0%,1h
38651,3,Goplit,2268,1510,179,184,363,49.3%,1h
38651,1,kitso,2268,1184,176,160,336,52.4%,1h
38651,1,PROdoom,2268,1772,151,154,305,49.5%,9m
38651,3,RantingLad,2268,1568,137,150,287,47.7%,21m
38651,1,kakef,2268,1766,135,141,276,48.9%,18m
38651,3,rasl,2268,1421,59,75,134,44.0%,1h
38651,1,nikki,2268,916,48,45,93,51.6%,6m
38651,3,God,2268,1043,41,46,87,47.1%,1h
38651,1,Relax,2268,1147,38,41,79,48.1%,26m
38651,1,[mfixed]Tellos,2268,959,30,32,62,48.4%,31m
38651,2,drfab,2268,324,13,19,32,40.6%,25m
38651,1,TeG,2268,356,11,7,18,61.1%,1h
38651,3,NaNome,2268,342,11,25,36,30.6%,16m
38651,1,fenixsigfrid,2268,282,9,13,22,40.9%,1h
38651,3,btester,2268,276,9,20,29,31.0%,6m
38651,1,Skrudg,2268,311,8,8,16,50.0%,1h
38651,1,[Sewer]Dynamite,2268,326,8,14,22,36.4%,1h
38651,3,ARSHAVA,2268,238,8,18,26,30.8%,9m
38651,1,SirOnenaGro,2268,225,7,11,18,38.9%,1h
38651,1,Ryzin,2268,266,7,13,20,35.0%,1h
38651,1,JackLigting,2268,219,7,14,21,33.3%,1h
38651,1,ПроАртёмПро,2268,211,6,6,12,50.0%,1h
38651,1,Tepsel,2268,158,5,2,7,71.4%,1h
38651,1,Crazycrawler,2268,180,5,9,14,35.7%,18m
38651,1,Gurvan,2268,123,4,4,8,50.0%,1h
38651,2,PUTEYPIE,2268,48,4,4,8,50.0%,1h
38651,1,LEOKA,2268,107,2,1,3,66.7%,2m
38651,1,Iligiar,2268,96,2,6,8,25.0%,1h
38651,1,MaphLionXIV,2268,97,2,8,10,20.0%,9m
38651,1,ALPJUAN,2268,0,1,0,1,100.0%,7m
38651,1,dontlikebeer,2268,89,1,1,2,50.0%,1h
38651,1,wurzlhans,2268,0,0,1,1,0.0%,18m
38651,2,Smirky,2268,0,0,1,1,0.0%,30m
38651,1,EZBELNG,2268,0,0,1,1,0.0%,1h
38651,1,Thoren,2268,0,0,1,1,0.0%,3m
38651,1,SeresD,2268,0,0,2,2,0.0%,1h
38651,1,wks,2268,0,0,3,3,0.0%,1h
38689,2,MadCap,2267,1544,190,190,380,50.0%,23m
38689,1,MarcSS,2267,1634,136,140,276,49.3%,1h
38689,1,[Coiosh]liviutz,2267,1517,95,89,184,51.6%,10m
38689,1,хищник,2267,1561,69,74,143,48.3%,1h
38689,1,Vorken,2267,1311,68,63,131,51.9%,12m
38689,1,Achileas,2267,787,55,55,110,50.0%,1h
38689,1,VTTT,2267,1242,51,40,91,56.0%,7m
38689,1,DaniElx,2267,1140,48,41,89,53.9%,1h
38689,1,TYPHOON,2267,1365,46,50,96,47.9%,3m
38689,1,sERAphim,2267,488,22,13,35,62.9%,30m
38689,1,RugessNome,2267,552,21,24,45,46.7%,7m
38689,1,Superheld,2267,608,18,20,38,47.4%,6m
38689,1,BOgdan,2267,462,12,11,23,52.2%,1h
38689,1,Novel,2267,326,11,9,20,55.0%,18m
38689,1,toto,2267,181,5,3,8,62.5%,1h
38689,1,Alessandro,2267,202,5,7,12,41.7%,10m
38689,1,Aleksey,2267,177,4,5,9,44.4%,1h
38689,1,[RP1]Ksamilion,2267,0,1,0,1,100.0%,18m
38689,2,Mercenary,2267,0,1,0,1,100.0%,17m
38689,1,ALeksLich,2267,0,1,1,2,50.0%,15m
38689,2,Galef,2267,0,1,4,5,20.0%,7m
38689,2,LeToine,2267,0,1,5,6,16.7%,15m
38689,1,ArkanDeath,2267,0,1,5,6,16.7%,1h
38689,1,[LCN]BossEscuDero,2267,0,0,1,1,0.0%,11m
38689,1,Khrajsy,2267,0,0,1,1,0.0%,1h
38689,1,[Святой]ПожилойГриша,2267,0,0,1,1,0.0%,16m
38715,3,[1NFEC7]LoneRider,2266,1582,273,282,555,49.2%,2m
38715,3,Pufick,2266,748,92,100,192,47.9%,6m
38715,1,[OmDi]VAR,2266,1578,77,81,158,48.7%,1h
38715,3,VeGas,2266,1065,46,45,91,50.5%,1h
38715,3,FrauHeinrich,2266,255,36,42,78,46.2%,22m
38715,1,PKBOSS,2266,665,32,26,58,55.2%,1h
38715,1,Дух,2266,508,28,19,47,59.6%,1h
38715,3,DarkVictory,2266,522,25,27,52,48.1%,11m
38715,2,ant,2266,569,22,14,36,61.1%,26m
38715,1,[S3ise]Catalin,2266,726,22,29,51,43.1%,1h
38715,1,ZION,2266,542,19,15,34,55.9%,1h
38715,3,GaEsEx,2266,344,13,20,33,39.4%,1h
38715,1,Vonix,2266,340,12,6,18,66.7%,1h
38715,1,Pincho,2266,388,12,14,26,46.2%,1h
38715,1,эпичнаямышь,2266,360,10,10,20,50.0%,1h
38715,1,[ZDrag]Dante,2266,242,9,7,16,56.2%,29m
38715,1,vodolazov,2266,380,9,9,18,50.0%,1h
38715,3,Neow,2266,229,8,11,19,42.1%,9m
38715,1,Sparkwood,2266,139,4,7,11,36.4%,3m
38715,1,HonzoBonzo,2266,122,3,5,8,37.5%,1h
38715,3,DeineMuddaa,2266,88,3,10,13,23.1%,1h
38715,1,Dekian,2266,74,2,3,5,40.0%,11m
38715,2,Nezorf,2266,0,2,3,5,40.0%,1h
38715,1,[Ewaldi]Vesaya,2266,110,2,7,9,22.2%,1h
38715,2,Guile,2266,0,1,0,1,100.0%,1h
38715,2,[2Pizzа]Polaris,2266,0,1,0,1,100.0%,30m
38715,1,RyaN,2266,42,1,3,4,25.0%,16m
38715,2,[Toons]StarLord,2266,0,1,4,5,20.0%,1h
38715,2,Dvn,2266,0,1,4,5,20.0%,1h
38715,1,MNMAkoor,2266,0,1,5,6,16.7%,28m
38715,1,outstaff,2266,0,1,6,7,14.3%,8m
38715,2,Joker,2266,0,0,2,2,0.0%,14m
38715,1,BigBossPL,2266,0,0,7,7,0.0%,23m
38748,3,fabio,2265,1513,124,131,255,48.6%,27m
38748,3,Mrlonely,2265,1543,112,118,230,48.7%,1h
38748,1,thl,2265,1505,93,95,188,49.5%,21m
38748,1,BorisBritva,2265,1770,88,84,172,51.2%,14m
38748,3,BLOOR,2265,1572,68,75,143,47.6%,1h
38748,1,AlfaCentauri,2265,702,38,33,71,53.5%,1h
38748,1,NEO,2265,996,36,41,77,46.8%,1h
38748,1,ustyanmurad,2265,695,31,28,59,52.5%,1h
38748,1,[AnReal]deni,2265,732,29,22,51,56.9%,1h
38748,1,Rajotah,2265,581,16,17,33,48.5%,9m
38748,2,[Rofler]Fagotti,2265,228,9,2,11,81.8%,1h
38748,1,Vazec,2265,353,9,17,26,34.6%,22m
38748,1,Karuzo,2265,232,9,17,26,34.6%,11m
38748,1,Skude,2265,209,6,10,16,37.5%,24m
38748,2,ROMEODELYON,2265,98,4,2,6,66.7%,1h
38748,1,Johnnybambam,2265,122,3,1,4,75.0%,28m
38748,1,DerMarshall,2265,135,3,4,7,42.9%,18m
38748,1,kinqzon,2265,120,3,6,9,33.3%,30m
38748,1,GlobalDJ,2265,70,3,6,9,33.3%,12m
38748,3,Pyksell,2265,30,3,8,11,27.3%,1h
38748,1,SuperTudor,2265,76,3,10,13,23.1%,1h
38748,2,WOLVERINE,2265,94,2,5,7,28.6%,9m
38748,2,Bladez,2265,126,2,6,8,25.0%,1h
38748,2,Nekai,2265,0,1,0,1,100.0%,1h
38748,1,angor,2265,97,1,6,7,14.3%,1h
38748,2,Yuthirla,2265,0,0,1,1,0.0%,23m
38748,2,Platzhirsch,2265,0,0,1,1,0.0%,18m
38775,1,MOOCT,2264,1336,52,46,98,53.1%,1h
38775,1,alvinsimba,2264,596,22,23,45,48.9%,31m
38775,1,MamaSchlumpf,2264,561,20,23,43,46.5%,30m
38775,1,texmex,2264,249,11,13,24,45.8%,1h
38775,3,Yarven,2264,232,8,10,18,44.4%,1h
38775,1,Anonimen,2264,178,6,6,12,50.0%,1h
38775,2,gabrey,2264,100,4,4,8,50.0%,16m
38775,1,Petimaci,2264,42,4,4,8,50.0%,4m
38775,1,Vakula,2264,162,4,8,12,33.3%,1h
38775,1,VbKaK,2264,103,3,1,4,75.0%,1h
38775,1,Чизер,2264,116,3,5,8,37.5%,1h
38775,1,Shalidor,2264,144,3,6,9,33.3%,29m
38775,2,[Goya]Lelouch,2264,34,2,0,2,100.0%,11m
38775,1,Tincanman,2264,0,2,5,7,28.6%,4m
38775,1,SeriousMilk,2264,101,2,6,8,25.0%,1h
38775,1,TommyEisbaer,2264,40,1,3,4,25.0%,1h
38775,2,Carlos,2264,0,1,4,5,20.0%,28m
38775,1,Zatara,2264,0,1,5,6,16.7%,4m
38775,2,adriancik,2264,0,0,1,1,0.0%,1h
38775,1,Janekxxxx,2264,0,0,2,2,0.0%,1h
38775,2,Luddoslav,2264,0,0,2,2,0.0%,20m
38775,2,macao,2264,0,0,3,3,0.0%,1h
38775,1,Oxygenium,2264,0,0,6,6,0.0%,1h
38798,3,TOPH,2263,1532,156,163,319,48.9%,1h
38798,1,[1Pack]Calculon,2263,1647,60,65,125,48.0%,12m
38798,1,labelbleu,2263,961,38,37,75,50.7%,12m
38798,1,nava,2263,726,36,24,60,60.0%,2m
38798,1,MrK,2263,921,32,32,64,50.0%,1h
38798,1,[BoShak]Rykket,2263,654,29,20,49,59.2%,1h
38798,1,hunterHUN,2263,675,27,21,48,56.2%,1h
38798,1,ludoleader,2263,614,25,26,51,49.0%,28m
38798,1,Ergeveda,2263,586,23,23,46,50.0%,1h
38798,1,Itinerant,2263,442,16,22,38,42.1%,6m
38798,3,Kole,2263,270,12,22,34,35.3%,9m
38798,2,LoLKicK,2263,331,11,14,25,44.0%,1h
38798,1,Nazarka,2263,303,10,7,17,58.8%,6m
38798,1,[Petrиs]Kiranos,2263,310,8,14,22,36.4%,1h
38798,1,PlatiNalogi,2263,155,5,2,7,71.4%,28m
38798,1,[OverX]Стронг,2263,182,5,6,11,45.5%,1h
38798,1,SeRioGa,2263,174,5,9,14,35.7%,6m
38798,2,winlocker,2263,96,4,0,4,100.0%,1h
38798,1,Zelax,2263,96,4,8,12,33.3%,1h
38798,2,[ReLa]MrGeeSix,2263,48,3,3,6,50.0%,1h
38798,1,[TeWu]BodDaH,2263,130,3,4,7,42.9%,14m
38798,1,ZergMachine,2263,82,3,5,8,37.5%,1h
38798,2,NilCrow,2263,30,2,1,3,66.7%,1h
38798,3,Gasseklopper,2263,30,2,3,5,40.0%,1h
38798,3,Syn,2263,0,2,5,7,28.6%,1h
38798,1,Sonozaki,2263,82,2,10,12,16.7%,1h
38798,2,modjo,2263,0,1,0,1,100.0%,1h
38798,2,OyKa,2263,0,1,0,1,100.0%,29m
38798,3,asuia,2263,30,1,1,2,50.0%,28m
38798,2,[Narco]runo,2263,46,1,2,3,33.3%,1h
38798,1,Darsoitu,2263,0,0,1,1,0.0%,1h
38798,2,skinsid,2263,0,0,1,1,0.0%,1h
38798,1,[skank]Elleshar,2263,0,0,2,2,0.0%,1h
38798,1,Diarg,2263,0,0,6,6,0.0%,1h
38832,1,ComradGenery,2262,1573,144,144,288,50.0%,28m
38832,3,Caos,2262,1463,77,77,154,50.0%,8m
38832,1,Vag,2262,1373,51,55,106,48.1%,1h
38832,1,Acco,2262,1009,41,34,75,54.7%,1h
38832,1,[RÖÖV]Yorgro,2262,876,39,27,66,59.1%,4m
38832,3,FoksRot,2262,274,36,34,70,51.4%,1h
38832,1,maru,2262,808,25,33,58,43.1%,29m
38832,1,Math,2262,532,15,15,30,50.0%,13m
38832,1,[Apoka1]Sergo,2262,297,9,7,16,56.2%,18m
38832,1,yunito,2262,240,5,2,7,71.4%,2m
38832,1,Oberwolf,2262,206,5,11,16,31.2%,1h
38832,2,ATOMsv,2262,59,3,0,3,100.0%,13m
38832,1,geo,2262,0,3,3,6,50.0%,23m
38832,1,Chris,2262,144,3,7,10,30.0%,1h
38832,1,[VENDET]LuisMiguel,2262,42,2,2,4,50.0%,1h
38832,1,ФрауАрика,2262,42,2,2,4,50.0%,5m
38832,1,[TTL]Gabriel,2262,42,2,2,4,50.0%,1h
38832,2,LorrdPicollo,2262,0,2,3,5,40.0%,3m
38832,1,Grediat,2262,72,2,5,7,28.6%,28m
38832,1,PplzSht,2262,0,1,1,2,50.0%,28m
38832,2,vidger,2262,30,1,2,3,33.3%,22m
38832,1,Sven,2262,0,1,5,6,16.7%,1h
38832,2,Uldanianin,2262,0,0,1,1,0.0%,1h
38832,1,UrexTheGreat,2262,0,0,1,1,0.0%,1h
38832,1,Trase,2262,0,0,1,1,0.0%,9m
38832,2,SgtBrian,2262,0,0,1,1,0.0%,18m
38832,1,COVID,2262,0,0,1,1,0.0%,1h
38832,1,[SkBG]BojowyRopuch,2262,0,0,2,2,0.0%,14m
38832,3,Efreet,2262,0,0,3,3,0.0%,1h
38832,1,Yaho,2262,0,0,3,3,0.0%,8m
38862,3,tronisto,2261,857,126,133,259,48.6%,28m
38862,1,NTech,2261,1599,75,66,141,53.2%,9m
38862,3,Masterplex,2261,1590,61,69,130,46.9%,18m
38862,3,JZBlade,2261,865,57,52,109,52.3%,21m
38862,2,FortniteFan,2261,776,28,40,68,41.2%,29m
38862,1,Misu,2261,470,14,15,29,48.3%,1h
38862,1,nimf,2261,192,8,8,16,50.0%,1h
38862,1,Bogdan,2261,252,7,10,17,41.2%,23m
38862,1,Yirka,2261,225,6,5,11,54.5%,1h
38862,3,HackForLife,2261,169,5,0,5,100.0%,1h
38862,1,Molodoy,2261,156,5,3,8,62.5%,13m
38862,1,Blockster,2261,194,5,8,13,38.5%,1h
38862,2,BEM,2261,98,4,2,6,66.7%,1h
38862,1,TheLetterM,2261,172,4,5,9,44.4%,1h
38862,2,Zulthei,2261,72,3,1,4,75.0%,11m
38862,2,RAA,2261,60,2,6,8,25.0%,8m
38862,1,nautilus,2261,0,1,2,3,33.3%,6m
38862,1,marsko,2261,42,1,3,4,25.0%,1h
38862,2,MiniNija,2261,0,1,5,6,16.7%,26m
38862,1,bibilbo,2261,0,1,5,6,16.7%,1h
38862,1,Infern,2261,0,1,5,6,16.7%,29m
38862,1,[LawDa]DenUA,2261,0,0,2,2,0.0%,31m
38884,1,Mitya,2260,1740,196,189,385,50.9%,1h
38884,1,Ulrikator,2260,1778,184,173,357,51.5%,9m
38884,3,boysynting,2260,1554,105,125,230,45.7%,16m
38884,3,Welder,2260,1333,84,89,173,48.6%,14m
38884,2,ADOK,2260,1293,66,65,131,50.4%,1h
38884,1,Marum,2260,1416,47,46,93,50.5%,29m
38884,1,Peacekeeper,2260,885,29,29,58,50.0%,8m
38884,2,Bybear,2260,586,21,19,40,52.5%,2m
38884,1,[Xa]Anubi,2260,582,17,25,42,40.5%,14m
38884,1,overdrive,2260,595,16,24,40,40.0%,1h
38884,1,Tairz,2260,470,13,13,26,50.0%,1h
38884,1,Phoenix,2260,265,8,8,16,50.0%,11m
38884,3,srs,2260,190,8,12,20,40.0%,1h
38884,2,MacroLi,2260,176,7,0,7,100.0%,26m
38884,1,Hyperviktor,2260,272,7,13,20,35.0%,28m
38884,2,Jenko,2260,177,6,3,9,66.7%,1h
38884,1,wladislau,2260,116,4,6,10,40.0%,1h
38884,1,[TSMMM]MaddaFakka,2260,124,2,9,11,18.2%,1h
38884,3,stantrooper,2260,97,1,1,2,50.0%,8m
38884,2,DoZYy,2260,46,1,1,2,50.0%,18m
38884,1,dots,2260,48,1,3,4,25.0%,29m
38884,2,DevilBat,2260,0,1,4,5,20.0%,1h
38884,1,TONIOrangina,2260,0,1,5,6,16.7%,3m
38884,2,[zhuds]Кот,2260,0,0,1,1,0.0%,2m
38884,2,Levente,2260,0,0,3,3,0.0%,14m
38909,1,Tobsong,2259,1746,112,112,224,50.0%,1h
38909,1,Reflex,2259,1571,88,88,176,50.0%,27m
38909,1,endor,2259,1713,81,79,160,50.6%,25m
38909,1,RaZVaN,2259,1747,80,80,160,50.0%,1h
38909,1,RexFelix,2259,1699,71,77,148,48.0%,1h
38909,3,Нефариан,2259,1580,68,73,141,48.2%,14m
38909,1,KNLord,2259,1125,48,43,91,52.7%,31m
38909,1,Тахтамыш,2259,622,41,40,81,50.6%,1h
38909,1,Crayzibear,2259,529,25,33,58,43.1%,22m
38909,1,UNIKUM,2259,765,23,29,52,44.2%,31m
38909,1,zemaljko,2259,822,23,30,53,43.4%,21m
38909,1,Petroslav,2259,483,22,12,34,64.7%,1h
38909,1,ILLaizer,2259,255,11,10,21,52.4%,21m
38909,2,LtnLeodan,2259,268,11,13,24,45.8%,1h
38909,1,alex,2259,270,7,12,19,36.8%,1h
38909,1,SuperNoob,2259,181,5,10,15,33.3%,1h
38909,3,NejniyPatrul,2259,195,5,11,16,31.2%,1h
38909,2,Kolonialist,2259,126,4,1,5,80.0%,19m
38909,2,[S5RTA]PaulaMamdouh,2259,92,3,2,5,60.0%,23m
38909,2,gostik,2259,139,3,3,6,50.0%,20m
38909,1,flamingo,2259,76,3,7,10,30.0%,22m
38909,1,Perec,2259,114,3,11,14,21.4%,1h
38909,2,Art,2259,64,2,3,5,40.0%,11m
38909,2,DMC,2259,0,1,0,1,100.0%,1h
38909,1,Igor,2259,91,1,2,3,33.3%,5m
38909,2,Nusky,2259,0,0,1,1,0.0%,1h
38909,1,Neckutrek,2259,0,0,2,2,0.0%,26m
38936,1,Miha,2258,911,73,71,144,50.7%,28m
38936,2,DesNanteuil,2258,1104,51,60,111,45.9%,1h
38936,3,CAMIL,2258,1201,45,51,96,46.9%,2m
38936,1,Synchi,2258,927,42,31,73,57.5%,1h
38936,1,batstef,2258,737,31,29,60,51.7%,1h
38936,1,Dany,2258,594,17,19,36,47.2%,25m
38936,1,Dozia,2258,512,14,17,31,45.2%,1h
38936,1,[PowerT]Royal,2258,399,13,17,30,43.3%,8m
38936,3,[SSGUK]DalyLaCow,2258,330,11,15,26,42.3%,8m
38936,1,Sigmar,2258,314,10,16,26,38.5%,1h
38936,2,shadowclone,2258,197,5,7,12,41.7%,27m
38936,1,blanelka,2258,98,5,14,19,26.3%,1h
38936,3,BuBu,2258,34,3,9,12,25.0%,1h
38936,1,DiamoXL,2258,40,2,2,4,50.0%,1h
38936,1,McBency,2258,82,2,6,8,25.0%,1h
38936,1,nolichou,2258,111,2,7,9,22.2%,8m
38936,1,GanzO,2258,48,2,7,9,22.2%,1h
38936,1,Paramoor,2258,0,2,7,9,22.2%,1h
38936,2,[Drkgme]ESD,2258,0,1,0,1,100.0%,25m
38936,2,Stanlej,2258,0,1,2,3,33.3%,1h
38936,2,METECUL,2258,48,1,3,4,25.0%,1h
38936,2,TiMMy,2258,30,1,5,6,16.7%,26m
38936,1,Unknownf,2258,0,1,5,6,16.7%,1h
38936,3,LateTuho,2258,0,0,1,1,0.0%,6m
38936,1,RospoCattivo,2258,0,0,2,2,0.0%,1h
38936,1,[Y2AeoN]BuD,2258,0,0,2,2,0.0%,16m
38936,1,[GxUxC]FEARme,2258,0,0,2,2,0.0%,6m
38936,1,Gilevra,2258,0,0,3,3,0.0%,2m
38936,1,Zanpakuto,2258,0,0,5,5,0.0%,22m
38936,2,kratossando,2258,0,0,5,5,0.0%,1h
38966,3,[lBBTl]BBTtruan,2257,1552,134,131,265,50.6%,1h
38966,1,[RRQ]HaitiFox,2257,1160,89,91,180,49.4%,29m
38966,2,[MAMAN]ghostrider,2257,1484,73,67,140,52.1%,1h
38966,3,EndGame,2257,764,39,45,84,46.4%,1h
38966,2,Klaren,2257,443,28,37,65,43.1%,21m
38966,1,pffkmzyc,2257,908,27,29,56,48.2%,1h
38966,2,Piiba,2257,549,23,9,32,71.9%,1h
38966,3,Zolphi,2257,549,22,33,55,40.0%,1h
38966,1,[6ui9]piti,2257,454,13,13,26,50.0%,18m
38966,1,Darunjia,2257,409,13,18,31,41.9%,12m
38966,1,daRkJke,2257,364,13,21,34,38.2%,1h
38966,1,[TKoKs]gustoso,2257,381,12,12,24,50.0%,22m
38966,2,Snipex,2257,204,8,3,11,72.7%,19m
38966,1,nechik,2257,230,8,4,12,66.7%,1h
38966,3,[Katz]KrisFerein,2257,223,8,10,18,44.4%,1h
38966,2,Murk,2257,204,7,3,10,70.0%,26m
38966,2,Faust,2257,130,5,4,9,55.6%,1h
38966,1,zaylord,2257,179,5,4,9,55.6%,7m
38966,1,fobi,2257,230,5,6,11,45.5%,1h
38966,1,Flekz,2257,169,5,6,11,45.5%,1h
38966,1,Slimper,2257,121,3,1,4,75.0%,1h
38966,1,Brassmonkey,2257,141,3,3,6,50.0%,1h
38966,1,Shiv,2257,88,3,4,7,42.9%,1h
38966,3,Fufickulick,2257,147,3,5,8,37.5%,1h
38966,2,min,2257,182,3,6,9,33.3%,14m
38966,2,Moldavo,2257,64,2,1,3,66.7%,29m
38966,2,Mamaju,2257,58,2,1,3,66.7%,17m
38966,2,ImAgine,2257,62,2,1,3,66.7%,1h
38966,1,[KMarks]maks,2257,42,2,3,5,40.0%,3m
38966,2,Predator,2257,131,2,10,12,16.7%,1h
38966,2,Django,2257,0,1,0,1,100.0%,1h
38966,2,[PGYT]Retamik,2257,0,1,0,1,100.0%,1h
38966,2,[GgWall]Zoidberg,2257,0,1,0,1,100.0%,19m
38966,2,Hartsia,2257,0,1,2,3,33.3%,1h
38966,2,fedd,2257,48,1,2,3,33.3%,1h
38966,1,Leshkovich,2257,0,1,5,6,16.7%,1h
38966,2,[RSTR]loalf,2257,0,0,1,1,0.0%,26m
38966,2,Ciciarampa,2257,0,0,1,1,0.0%,1h
38966,2,Hallibut,2257,0,0,1,1,0.0%,1h
38966,2,Baptiste,2257,0,0,1,1,0.0%,1h
38966,2,TrajanoV,2257,0,0,1,1,0.0%,1h
38966,1,Timir,2257,0,0,3,3,0.0%,1h
39008,3,LinkFly,2256,1396,359,355,714,50.3%,18m
39008,1,Andoni,2256,1733,93,96,189,49.2%,30m
39008,1,MARCELO,2256,1235,47,56,103,45.6%,10m
39008,1,[mfxed]jasina,2256,1117,43,38,81,53.1%,23m
39008,2,NoRi,2256,542,19,22,41,46.3%,1h
39008,3,Kijanach,2256,288,12,21,33,36.4%,11m
39008,1,VELNS,2256,340,11,16,27,40.7%,3m
39008,1,PoloHC,2256,377,10,10,20,50.0%,13m
39008,1,tima,2256,202,6,11,17,35.3%,1h
39008,1,[OFuT]Max,2256,217,5,8,13,38.5%,1h
39008,1,ArtzCoffe,2256,193,5,11,16,31.2%,1h
39008,1,[MRoz]DrVic,2256,119,3,7,10,30.0%,1h
39008,2,Oskilla,2256,34,3,8,11,27.3%,1h
39008,2,cocokrench,2256,32,2,0,2,100.0%,1h
39008,3,Hdzsi,2256,0,1,0,1,100.0%,1h
39008,1,hammerHQ,2256,48,1,1,2,50.0%,1h
39008,1,adiutant,2256,0,1,2,3,33.3%,28m
39008,1,ZachsPeen,2256,0,1,5,6,16.7%,1h
39008,1,benvladan,2256,42,1,7,8,12.5%,1h
39008,1,Safranek,2256,0,0,1,1,0.0%,4m
39008,2,[Nz4L]Kwosie,2256,0,0,1,1,0.0%,1h
39008,2,klmseo,2256,0,0,1,1,0.0%,1h
39008,2,SkyLark,2256,0,0,1,1,0.0%,16m
39008,1,WindWalker,2256,0,0,6,6,0.0%,27m
39032,1,Coconut,2255,1731,74,72,146,50.7%,1h
39032,1,damien,2255,1610,67,60,127,52.8%,1h
39032,1,Miner,2255,996,55,47,102,53.9%,27m
39032,1,pooh,2255,1078,50,52,102,49.0%,12m
39032,2,CullenTrey,2255,1137,47,41,88,53.4%,1h
39032,1,Jonny,2255,869,37,28,65,56.9%,23m
39032,1,Aldenelius,2255,546,22,25,47,46.8%,30m
39032,1,bastag,2255,554,21,16,37,56.8%,25m
39032,1,EccioHD,2255,590,18,24,42,42.9%,15m
39032,1,Bäminator,2255,564,17,18,35,48.6%,1h
39032,2,Nikolovski,2255,354,14,6,20,70.0%,1h
39032,2,Hatiman,2255,406,13,10,23,56.5%,22m
39032,2,Doronex,2255,233,10,3,13,76.9%,16m
39032,2,moroni,2255,90,5,4,9,55.6%,1h
39032,1,ElHeredero,2255,126,3,9,12,25.0%,1h
39032,1,[JaPP]Владимир,2255,90,2,1,3,66.7%,15m
39032,1,SMHRMN,2255,42,2,2,4,50.0%,1h
39032,1,LaBlatte,2255,48,2,3,5,40.0%,6m
39032,1,hohlokit,2255,38,2,6,8,25.0%,7m
39032,2,RosRj,2255,0,1,0,1,100.0%,1h
39032,1,IBAN,2255,97,1,2,3,33.3%,16m
39032,2,Hludwig,2255,34,1,2,3,33.3%,32m
39032,1,[odSC]Firewing,2255,0,1,4,5,20.0%,1h
39032,1,DubstePC,2255,0,1,6,7,14.3%,29m
39032,1,federal,2255,0,1,6,7,14.3%,1h
39032,2,[AchrK9]Anders,2255,0,0,1,1,0.0%,1h
39032,2,[Саваны]KrinDar,2255,0,0,3,3,0.0%,1h
39032,1,ork,2255,0,0,4,4,0.0%,1h
39032,1,tecno,2255,0,0,4,4,0.0%,31m
39032,1,milese,2255,0,0,6,6,0.0%,9m
39062,2,steffen,2254,1497,130,137,267,48.7%,1h
39062,1,Igorek,2254,898,41,37,78,52.6%,1h
39062,1,Tito,2254,910,37,27,64,57.8%,1h
39062,2,[ЭЩКЕРЕ]Mihals,2254,749,34,14,48,70.8%,19m
39062,1,ThiefofFate,2254,695,33,39,72,45.8%,21m
39062,1,Gwuw,2254,628,20,17,37,54.1%,25m
39062,1,[play45]IIIIIIIIIIII,2254,519,17,14,31,54.8%,22m
39062,1,NemoOudeis,2254,351,13,17,30,43.3%,1h
39062,3,[ProbKA]ДухКомунизма,2254,334,12,21,33,36.4%,1h
39062,3,[BCHR]AceKuk,2254,287,11,7,18,61.1%,28m
39062,1,Koz,2254,212,7,11,18,38.9%,31m
39062,3,[sCork]cagli,2254,148,7,12,19,36.8%,2m
39062,3,PicNicK,2254,222,7,12,19,36.8%,24m
39062,1,[STONKS]BrAiN,2254,176,6,7,13,46.2%,31m
39062,1,iwtsm,2254,122,4,8,12,33.3%,1h
39062,2,SweaTizZ,2254,48,2,4,6,33.3%,24m
39062,1,Stalin,2254,113,2,6,8,25.0%,29m
39062,1,Lenny,2254,124,2,6,8,25.0%,8m
39062,1,mutya,2254,0,2,7,9,22.2%,1h
39062,1,danya,2254,0,1,1,2,50.0%,1h
39062,2,Mielniking,2254,32,1,6,7,14.3%,1h
39062,3,Omarshiko,2254,0,1,6,7,14.3%,14m
39062,1,[Rofler]kraxpl,2254,0,0,3,3,0.0%,29m
39062,1,sniper,2254,0,0,5,5,0.0%,1h
39086,2,[OmDi]bensu,2253,1046,343,353,696,49.3%,1h
39086,1,БонииКлайд,2253,1491,118,113,231,51.1%,30m
39086,1,Rvach,2253,1657,116,102,218,53.2%,1h
39086,1,asdfsadf,2253,1566,58,63,121,47.9%,1h
39086,3,zaGogz,2253,1041,51,56,107,47.7%,1h
39086,1,Eloysss,2253,1355,47,46,93,50.5%,12m
39086,1,Nikc,2253,1286,43,45,88,48.9%,1h
39086,1,Violet,2253,638,29,27,56,51.8%,1h
39086,3,Pistopp,2253,676,24,37,61,39.3%,1h
39086,1,AllArmyAMove,2253,404,15,13,28,53.6%,2m
39086,2,Antichrist,2253,418,14,15,29,48.3%,25m
39086,1,ScottishHunt,2253,240,12,6,18,66.7%,1h
39086,1,Stalker,2253,399,12,21,33,36.4%,1h
39086,1,SHADOWDRAGON,2253,211,11,14,25,44.0%,1h
39086,1,RedDaron,2253,302,9,12,21,42.9%,1h
39086,2,starbuck,2253,225,7,5,12,58.3%,28m
39086,2,Kreuzer,2253,158,6,2,8,75.0%,1h
39086,2,Zorg,2253,192,6,6,12,50.0%,1h
39086,3,Unreal,2253,60,4,10,14,28.6%,25m
39086,1,AHA,2253,167,3,3,6,50.0%,24m
39086,1,SDanya,2253,86,3,5,8,37.5%,1h
39086,1,CnpuHTEP,2253,110,3,7,10,30.0%,10m
39086,1,Koulaks,2253,137,3,7,10,30.0%,18m
39086,2,[SoNaYo]SkillZero,2253,30,2,0,2,100.0%,22m
39086,1,entardio,2253,48,2,2,4,50.0%,1h
39086,2,RichiMat,2253,0,2,3,5,40.0%,1h
39086,1,[DEAD2R]SLAY,2253,44,2,3,5,40.0%,5m
39086,1,pioona,2253,128,2,3,5,40.0%,1h
39086,1,Nicosaurus,2253,0,2,3,5,40.0%,1h
39086,1,Specaye,2253,36,2,7,9,22.2%,16m
39086,2,FAllEN,2253,0,1,0,1,100.0%,32m
39086,2,[Hrѓ]maximys,2253,0,1,0,1,100.0%,1h
39086,1,TERRANMIX,2253,91,1,2,3,33.3%,11m
39086,2,EDU,2253,0,1,4,5,20.0%,1h
39086,1,[BTSM]canee,2253,40,1,5,6,16.7%,1h
39086,2,AttackFish,2253,0,1,5,6,16.7%,1h
39086,1,PROXMEN,2253,0,1,6,7,14.3%,1h
39086,2,ШУХЕР,2253,0,0,1,1,0.0%,21m
39086,2,LOLтакНельзя,2253,0,0,1,1,0.0%,18m
39086,2,Sety,2253,0,0,1,1,0.0%,22m
39086,2,emperor,2253,0,0,1,1,0.0%,1h
39086,1,Alterana,2253,0,0,2,2,0.0%,1h
39086,1,Morgen,2253,0,0,3,3,0.0%,1h
39129,3,Raczo,2252,1192,49,53,102,48.0%,8m
39129,1,Vytautokas,2252,1125,48,37,85,56.5%,1h
39129,1,вампир,2252,1210,38,43,81,46.9%,1h
39129,1,Mepulsor,2252,703,27,18,45,60.0%,1h
39129,1,midolg,2252,462,20,28,48,41.7%,1h
39129,1,StörstaKuken,2252,401,13,19,32,40.6%,1h
39129,3,Isilidur,2252,319,12,11,23,52.2%,1h
39129,1,Morganaft,2252,414,11,15,26,42.3%,1h
39129,2,Hilly,2252,154,9,11,20,45.0%,1h
39129,2,[PIZIKS]DarkVenumMMA,2252,200,7,5,12,58.3%,1h
39129,3,Andromelech,2252,170,5,2,7,71.4%,1h
39129,3,Archimedian,2252,122,3,5,8,37.5%,28m
39129,1,Pixel,2252,96,3,8,11,27.3%,1h
39129,3,Archont,2252,30,2,2,4,50.0%,10m
39129,3,[bKass]Weshmen,2252,0,2,7,9,22.2%,11m
39129,2,[Айур]zix,2252,0,1,0,1,100.0%,1h
39129,1,[ZenDex]JloMaHyTblu,2252,0,1,1,2,50.0%,1h
39129,2,vita,2252,30,1,2,3,33.3%,32m
39129,2,KurtCocaine,2252,0,1,4,5,20.0%,1h
39129,2,Shroom,2252,0,1,4,5,20.0%,1h
39129,2,Korei,2252,0,1,4,5,20.0%,12m
39129,2,Daantes,2252,0,1,5,6,16.7%,1h
39129,1,Tomthefreak,2252,0,0,3,3,0.0%,14m
39152,1,Miro,2251,1767,219,207,426,51.4%,1h
39152,1,Elbridas,2251,1422,85,73,158,53.8%,26m
39152,3,[KES]LostDay,2251,1469,70,71,141,49.6%,6m
39152,1,[H4L4]Zwim,2251,885,38,46,84,45.2%,1h
39152,1,felix,2251,1014,34,37,71,47.9%,1h
39152,1,rki,2251,923,28,35,63,44.4%,11m
39152,1,Andrey,2251,427,18,11,29,62.1%,31m
39152,1,uGod,2251,481,18,15,33,54.5%,1h
39152,1,[NICHE]Bluesoul,2251,528,16,15,31,51.6%,1h
39152,1,Adep,2251,503,16,22,38,42.1%,18m
39152,2,tomendes,2251,354,13,10,23,56.5%,1h
39152,1,dyc,2251,494,13,21,34,38.2%,1h
39152,1,RedLord,2251,333,12,16,28,42.9%,1h
39152,1,Kłapouchy,2251,277,11,10,21,52.4%,1h
39152,1,TETRACTUS,2251,340,9,13,22,40.9%,1h
39152,1,DarkStar,2251,135,6,3,9,66.7%,1h
39152,1,kastell,2251,237,6,13,19,31.6%,6m
39152,2,jihun,2251,88,5,10,15,33.3%,1h
39152,1,Mawaleba,2251,226,5,10,15,33.3%,2m
39152,1,xsmart,2251,123,4,8,12,33.3%,1h
39152,1,oXCTHULHUXo,2251,97,4,12,16,25.0%,10m
39152,1,Tapple,2251,74,3,3,6,50.0%,12m
39152,2,CracKers,2251,0,3,4,7,42.9%,1h
39152,1,niamgrez,2251,132,3,10,13,23.1%,1h
39152,2,[Kultur]kastanjeg,2251,64,2,3,5,40.0%,3m
39152,2,[MEDAH]handstyler,2251,64,2,3,5,40.0%,1h
39152,1,[1979]Kingofkings,2251,0,2,5,7,28.6%,1h
39152,2,Asterianne,2251,0,1,0,1,100.0%,29m
39152,1,Timetosmoke,2251,0,1,1,2,50.0%,8m
39152,1,Tknight,2251,0,1,2,3,33.3%,1h
39152,1,Freeman,2251,0,1,2,3,33.3%,1h
39152,1,GamingMike,2251,40,1,3,4,25.0%,1h
39152,2,Убицин,2251,0,1,5,6,16.7%,1h
39152,1,Maru,2251,0,1,5,6,16.7%,1h
39152,2,Данте,2251,0,0,1,1,0.0%,1h
39152,1,BLACK,2251,0,0,2,2,0.0%,1h
39188,1,[SodsLV]billydominos,2250,1767,144,132,276,52.2%,1h
39188,1,govnojed,2250,1524,129,144,273,47.3%,1h
39188,3,ProstoNoob,2250,1429,61,58,119,51.3%,18m
39188,1,Max,2250,1359,54,50,104,51.9%,10m
39188,2,Tobi,2250,961,38,36,74,51.4%,1h
39188,2,GangStalking,2250,741,30,18,48,62.5%,1h
39188,1,lazY,2250,587,19,17,36,52.8%,1h
39188,1,[Gwings]KinguinPing,2250,382,14,16,30,46.7%,1h
39188,1,Miandro,2250,335,12,12,24,50.0%,25m
39188,2,Blue,2250,287,11,14,25,44.0%,1h
39188,1,Coukas,2250,370,10,11,21,47.6%,1h
39188,2,Popper,2250,300,10,15,25,40.0%,26m
39188,1,[Moskva]EOS,2250,239,9,6,15,60.0%,27m
39188,1,otd,2250,180,8,2,10,80.0%,1h
39188,3,Jhoni,2250,223,7,12,19,36.8%,1h
39188,3,Acoma,2250,222,7,12,19,36.8%,1h
39188,3,[zZztTt]POPPA,2250,169,6,12,18,33.3%,1h
39188,3,[FoRst]EmysAndi,2250,179,6,12,18,33.3%,3m
39188,1,Shurik,2250,163,4,4,8,50.0%,1h
39188,1,Restrepo,2250,122,4,5,9,44.4%,1h
39188,2,Kuromaru,2250,127,4,5,9,44.4%,1h
39188,2,[morg]Legeon,2250,0,3,2,5,60.0%,1h
39188,1,Karlos,2250,0,3,4,7,42.9%,20m
39188,3,[RmpR]MastaRasta,2250,97,2,1,3,66.7%,22m
39188,1,DrBorgal,2250,116,2,3,5,40.0%,21m
39188,2,Zargnaza,2250,0,2,3,5,40.0%,27m
39188,1,Smartyy,2250,42,2,6,8,25.0%,9m
39188,1,Zack,2250,48,2,7,9,22.2%,1h
39188,1,FROL,2250,0,2,8,10,20.0%,31m
39188,1,[AnQ]Mars,2250,88,1,2,3,33.3%,30m
39188,1,Eradicator,2250,96,1,3,4,25.0%,10m
39188,1,макс,2250,42,1,3,4,25.0%,20m
39188,3,LaLaLog,2250,0,1,3,4,25.0%,1h
39188,2,Bonecrusher,2250,0,1,5,6,16.7%,1h
39188,1,WooDoo,2250,0,1,5,6,16.7%,16m
39188,1,Макаров,2250,0,1,11,12,8.3%,10m
39188,1,FAKAS,2250,0,0,1,1,0.0%,1h
39188,2,kolo,2250,0,0,1,1,0.0%,25m
39188,3,SpONgE,2250,0,0,1,1,0.0%,29m
39188,1,Lightarrow,2250,0,0,3,3,0.0%,16m
39188,1,AbuMoritz,2250,0,0,3,3,0.0%,9m
39188,1,venicereturn,2250,0,0,4,4,0.0%,1h
39230,1,gle,2249,1795,313,317,630,49.7%,1h
39230,3,Etircopyh,2249,384,69,76,145,47.6%,1h
39230,1,Shadowalker,2249,1501,67,72,139,48.2%,1h
39230,1,Lantan,2249,1396,61,56,117,52.1%,4m
39230,1,Kamtek,2249,795,57,69,126,45.2%,1h
39230,1,RASL,2249,847,51,52,103,49.5%,25m
39230,1,Piątek,2249,521,25,29,54,46.3%,22m
39230,2,Noob,2249,409,15,9,24,62.5%,1h
39230,1,neituede,2249,469,14,15,29,48.3%,16m
39230,1,ZIOMKRIS,2249,311,11,6,17,64.7%,31m
39230,1,Aljehine,2249,344,10,12,22,45.5%,1h
39230,1,Zerght,2249,334,10,14,24,41.7%,22m
39230,2,Bdlong,2249,224,8,8,16,50.0%,1h
39230,1,[amk666]JoKeR,2249,193,7,8,15,46.7%,1h
39230,3,Earthling,2249,149,5,5,10,50.0%,1h
39230,1,svinsane,2249,30,5,13,18,27.8%,12m
39230,1,Arrows,2249,191,4,3,7,57.1%,29m
39230,1,cent,2249,80,4,7,11,36.4%,1h
39230,3,Kimjoa,2249,142,4,8,12,33.3%,10m
39230,1,ЕРЕКЕ,2249,145,3,5,8,37.5%,21m
39230,1,Айаал,2249,125,3,7,10,30.0%,1h
39230,1,[59APM]gameover,2249,145,3,11,14,21.4%,1h
39230,2,kwaaaaa,2249,0,1,0,1,100.0%,1h
39230,2,Kotlett,2249,0,1,2,3,33.3%,1h
39230,2,ShadowStorm,2249,48,1,2,3,33.3%,1h
39230,1,brztbrzt,2249,0,1,3,4,25.0%,1h
39230,3,kiwi,2249,95,1,4,5,20.0%,1h
39230,2,Jak,2249,0,1,4,5,20.0%,15m
39230,2,wertyr,2249,0,0,1,1,0.0%,1h
39230,2,DaerusDastis,2249,0,0,1,1,0.0%,28m
39230,2,LtPineapple,2249,0,0,1,1,0.0%,16m
39230,2,Bell,2249,0,0,1,1,0.0%,27m
39230,2,MeshoK,2249,0,0,1,1,0.0%,23m
39230,1,[FGuys]Master,2249,0,0,1,1,0.0%,1h
39230,1,[PHENOM]GCFTpoland,2249,0,0,2,2,0.0%,1h
39230,1,zeus,2249,0,0,2,2,0.0%,21m
39230,1,darkboss,2249,0,0,2,2,0.0%,3m
39230,1,nomercyro,2249,0,0,2,2,0.0%,1h
39230,1,StuntS,2249,0,0,2,2,0.0%,10m
39230,2,KamilSoLoL,2249,0,0,5,5,0.0%,2m
39270,3,Slotare,2248,778,27,33,60,45.0%,1h
39270,1,HansDampf,2248,768,25,22,47,53.2%,1h
39270,1,[BooMKK]Novina,2248,571,19,24,43,44.2%,1h
39270,1,Shadow,2248,457,16,19,35,45.7%,31m
39270,2,MaZe,2248,434,15,14,29,51.7%,3m
39270,1,MacLeod,2248,230,9,3,12,75.0%,6m
39270,3,Tranques,2248,276,9,15,24,37.5%,1h
39270,2,Perseo,2248,214,7,4,11,63.6%,1h
39270,3,Battlecruise,2248,184,7,12,19,36.8%,14m
39270,3,BezS,2248,152,5,15,20,25.0%,1h
39270,2,[RGG]TheOutlaw,2248,151,4,5,9,44.4%,19m
39270,1,duckduck,2248,76,3,3,6,50.0%,20m
39270,1,NITRO,2248,48,2,6,8,25.0%,31m
39270,2,[NukeZ]AirToss,2248,0,1,0,1,100.0%,7m
39270,3,Chobo,2248,0,1,1,2,50.0%,1h
39270,2,[lPKTl]OVER,2248,97,1,3,4,25.0%,1h
39270,1,KaptnCat,2248,97,1,4,5,20.0%,3m
39270,1,[Hybrid]Babov,2248,0,1,4,5,20.0%,7m
39270,2,Tegemea,2248,30,1,5,6,16.7%,1h
39270,2,Gogen,2248,96,1,6,7,14.3%,1h
39270,1,[LOBBYM]weeewwww,2248,0,0,2,2,0.0%,1h
39291,1,Becjon,2247,1770,187,184,371,50.4%,1h
39291,1,SISERA,2247,1772,85,83,168,50.6%,21m
39291,1,AVTALYON,2247,1119,77,75,152,50.7%,22m
39291,1,Dominik,2247,1298,56,46,102,54.9%,18m
39291,1,DeepFree,2247,1239,53,50,103,51.5%,29m
39291,1,sony,2247,628,48,46,94,51.1%,1h
39291,1,[20CMz]TawZaw,2247,1432,48,53,101,47.5%,1h
39291,2,Igor,2247,657,26,21,47,55.3%,18m
39291,1,POWST,2247,543,16,25,41,39.0%,1h
39291,2,[PLBG]Kamillobeta,2247,241,14,16,30,46.7%,22m
39291,3,KennY,2247,377,14,20,34,41.2%,21m
39291,3,Nevernet,2247,372,14,21,35,40.0%,3m
39291,1,flesh,2247,271,11,7,18,61.1%,31m
39291,1,MajorAwesome,2247,383,11,10,21,52.4%,7m
39291,1,vasman,2247,389,11,17,28,39.3%,7m
39291,1,Neo,2247,275,10,8,18,55.6%,1h
39291,1,Brainslug,2247,312,9,8,17,52.9%,21m
39291,1,Sharm,2247,185,6,12,18,33.3%,1h
39291,1,MentalJimmy,2247,150,5,7,12,41.7%,1h
39291,1,PanRudzik,2247,168,5,7,12,41.7%,1h
39291,2,toybox,2247,62,3,2,5,60.0%,19m
39291,3,gooliatpl,2247,0,3,4,7,42.9%,1h
39291,1,skillz,2247,111,3,4,7,42.9%,1h
39291,1,Dima,2247,97,3,5,8,37.5%,1h
39291,2,HorstSpaaten,2247,88,3,6,9,33.3%,1h
39291,1,Barik,2247,114,3,9,12,25.0%,18m
39291,1,[BeLeg]BlizzWavre,2247,97,2,1,3,66.7%,15m
39291,2,Ren,2247,0,1,0,1,100.0%,1h
39291,1,[DeThXD]klose,2247,88,1,2,3,33.3%,1h
39291,2,Maximusalex,2247,88,1,3,4,25.0%,18m
39291,1,protossderp,2247,0,1,6,7,14.3%,1h
39291,2,KentaOK,2247,0,0,1,1,0.0%,11m
39291,2,Hotshot,2247,0,0,5,5,0.0%,1h
39324,1,[Deduli]Forecast,2246,1648,136,133,269,50.6%,28m
39324,1,vydvladimir,2246,1638,135,135,270,50.0%,1h
39324,3,[basdp]OLDBOY,2246,1361,79,88,167,47.3%,1h
39324,3,goodguyPL,2246,1560,73,83,156,46.8%,17m
39324,1,lamaking,2246,992,55,44,99,55.6%,1h
39324,3,Centurion,2246,435,33,39,72,45.8%,3m
39324,1,CarloYbanez,2246,527,26,25,51,51.0%,1h
39324,1,ERAGON,2246,593,21,21,42,50.0%,1h
39324,1,EgorGreek,2246,579,20,27,47,42.6%,1h
39324,1,andrioso,2246,489,19,26,45,42.2%,1h
39324,1,[Jail]Poseidonswat,2246,439,18,11,29,62.1%,1h
39324,2,[SuPi]Philipp,2246,354,15,18,33,45.5%,5m
39324,1,Baccardi,2246,180,7,6,13,53.8%,20m
39324,1,ady,2246,276,7,12,19,36.8%,3m
39324,1,veiuj,2246,196,6,7,13,46.2%,1h
39324,1,[FiU]Tschilo,2246,122,4,4,8,50.0%,7m
39324,1,[RuCrew]Mozart,2246,179,4,11,15,26.7%,29m
39324,1,owmy,2246,48,3,6,9,33.3%,20m
39324,2,RunnerMan,2246,30,3,8,11,27.3%,1h
39324,2,[ZeRgg]Blender,2246,102,3,9,12,25.0%,1h
39324,1,Rosy,2246,38,2,2,4,50.0%,30m
39324,2,ХмурыйМакс,2246,66,2,3,5,40.0%,1h
39324,2,YuriusGreat,2246,0,1,0,1,100.0%,1h
39324,2,[2ПУПСА]GGchat,2246,0,1,0,1,100.0%,3m
39324,2,[LOGS]Jylle,2246,0,1,1,2,50.0%,30m
39324,1,KekSlayer,2246,0,1,2,3,33.3%,29m
39324,1,Sem,2246,30,1,3,4,25.0%,1h
39324,1,Tankomen,2246,40,1,4,5,20.0%,1h
39324,2,Borjax,2246,0,1,5,6,16.7%,26m
39324,1,Cerebeus,2246,0,1,5,6,16.7%,1h
39324,3,gorkalabaza,2246,97,1,5,6,16.7%,1h
39324,2,Dziubek,2246,0,0,1,1,0.0%,19m
39324,1,Noob,2246,0,0,1,1,0.0%,6m
39357,1,[OmDi]drexjor,2245,1510,69,66,135,51.1%,30m
39357,2,ДОРОГА,2245,728,31,13,44,70.5%,29m
39357,1,Balin,2245,583,20,20,40,50.0%,7m
39357,1,Jenno,2245,613,18,19,37,48.6%,1h
39357,1,shroom,2245,158,15,11,26,57.7%,1h
39357,1,[FRTYG]WarBasterd,2245,389,15,14,29,51.7%,22m
39357,1,hellei,2245,303,10,7,17,58.8%,1h
39357,1,erikHP,2245,202,5,8,13,38.5%,4m
39357,1,DOMMMBD,2245,192,5,10,15,33.3%,1h
39357,2,cryptix,2245,124,4,3,7,57.1%,3m
39357,1,ssss,2245,107,3,2,5,60.0%,10m
39357,2,MrWhippy,2245,88,3,13,16,18.8%,1h
39357,2,[Jail]Arturiatus,2245,48,2,1,3,66.7%,1h
39357,1,КотКокос,2245,92,2,2,4,50.0%,1h
39357,2,Deoksin,2245,0,1,0,1,100.0%,1h
39357,2,вышедший,2245,0,1,0,1,100.0%,18m
39357,2,wqed,2245,30,1,1,2,50.0%,32m
39357,2,Zealot,2245,0,1,1,2,50.0%,1h
39357,2,DreikP,2245,0,1,1,2,50.0%,1h
39357,2,[BRATVA]WARKIRILL,2245,0,0,1,1,0.0%,1h
39357,1,Виктор,2245,0,0,1,1,0.0%,16m
39357,1,[HaoS]pggprgprggs,2245,0,0,1,1,0.0%,16m
39357,2,GianluT,2245,0,0,1,1,0.0%,1h
39357,1,OloHans,2245,0,0,2,2,0.0%,1h
39381,3,tesnick,2244,1524,211,207,418,50.5%,28m
39381,1,[nWss]Razz,2244,1767,205,215,420,48.8%,1h
39381,1,Marduk,2244,1640,168,167,335,50.1%,27m
39381,1,Uranhön,2244,1716,156,152,308,50.6%,1h
39381,1,Kudum,2244,1486,113,110,223,50.7%,27m
39381,2,Thybril,2244,1628,108,100,208,51.9%,27m
39381,1,[S0L1D]curnalpanic,2244,1699,107,109,216,49.5%,11m
39381,1,[HMarch]Loleki,2244,1542,59,50,109,54.1%,29m
39381,1,bednarz,2244,1587,56,63,119,47.1%,30m
39381,1,Beboopp,2244,1247,52,45,97,53.6%,1h
39381,3,TonyMontana,2244,1257,48,49,97,49.5%,1h
39381,1,[DaFF]xopxsicox,2244,946,40,36,76,52.6%,1h
39381,2,ancient,2244,955,34,36,70,48.6%,6m
39381,1,[lZornG]Rambazamba,2244,613,30,28,58,51.7%,22m
39381,3,Remoniy,2244,536,19,32,51,37.3%,23m
39381,1,Birman,2244,397,16,14,30,53.3%,1h
39381,3,LowSkill,2244,396,14,18,32,43.8%,1h
39381,1,Сворок,2244,266,13,14,27,48.1%,1h
39381,2,pokoritel,2244,334,11,13,24,45.8%,1h
39381,1,[NoTaV]DanyBoy,2244,308,11,16,27,40.7%,1h
39381,1,satellite,2244,406,11,21,32,34.4%,1h
39381,2,GroM,2244,158,5,5,10,50.0%,13m
39381,2,[WNB]Dionis,2244,88,4,4,8,50.0%,8m
39381,1,Harokku,2244,128,4,4,8,50.0%,1h
39381,2,fratz,2244,38,2,0,2,100.0%,26m
39381,1,SEABIZKIT,2244,42,2,3,5,40.0%,1h
39381,1,Navodhik,2244,106,2,3,5,40.0%,1h
39381,2,[НОД17]Poker,2244,97,2,4,6,33.3%,1h
39381,2,[GNOUTU]Exkillnight,2244,142,2,6,8,25.0%,1h
39381,2,Устин,2244,46,2,6,8,25.0%,1h
39381,3,Feuerklaue,2244,0,2,9,11,18.2%,22m
39381,1,[5BC]Marchelo,2244,0,1,1,2,50.0%,15m
39381,1,stiflerxd,2244,0,1,1,2,50.0%,1h
39381,2,AlexRUSH,2244,30,1,2,3,33.3%,26m
39381,2,leviathan,2244,0,1,4,5,20.0%,1h
39381,2,dizer,2244,0,1,5,6,16.7%,31m
39381,2,PMZ,2244,0,0,1,1,0.0%,1h
39381,1,[OOST]gayslyna,2244,0,0,1,1,0.0%,1h
39381,2,teuquof,2244,0,0,3,3,0.0%,1h
39381,3,Whitepill,2244,0,0,3,3,0.0%,22m
39421,1,spartax,2243,1535,380,390,770,49.4%,1h
39421,1,[LaÑ2]LeopollicK,2243,1547,334,340,674,49.6%,22m
39421,3,Bruz,2243,1542,200,198,398,50.3%,1h
39421,1,Alex,2243,1520,99,85,184,53.8%,14m
39421,3,Lion,2243,1071,55,56,111,49.5%,17m
39421,1,ZloePechenie,2243,1354,54,49,103,52.4%,28m
39421,1,пупсик,2243,1012,40,33,73,54.8%,1h
39421,2,Opex,2243,721,40,40,80,50.0%,1h
39421,1,Ybipbip,2243,640,25,22,47,53.2%,14m
39421,3,Veleren,2243,676,23,35,58,39.7%,17m
39421,1,Magowan,2243,642,18,22,40,45.0%,5m
39421,3,iceman,2243,314,11,16,27,40.7%,1h
39421,1,LittleChief,2243,295,8,15,23,34.8%,4m
39421,1,Хорадрим,2243,226,7,9,16,43.8%,1h
39421,3,zodon,2243,181,6,8,14,42.9%,1h
39421,2,Vlado,2243,248,6,9,15,40.0%,26m
39421,3,[zhuds]gostik,2243,58,5,7,12,41.7%,7m
39421,2,MKIIVO,2243,180,5,8,13,38.5%,1h
39421,1,[TT52]Mifinor,2243,122,4,5,9,44.4%,1h
39421,1,Lemon,2243,195,4,7,11,36.4%,8m
39421,3,Sardukar,2243,117,2,8,10,20.0%,8m
39421,1,[AOTW]Gaben,2243,0,1,0,1,100.0%,1h
39421,2,[PTWTM]Raven,2243,0,1,1,2,50.0%,19m
39421,2,Twister,2243,0,1,4,5,20.0%,1h
39421,2,[GasNub]laba,2243,0,1,4,5,20.0%,18m
39421,2,Jawa,2243,0,1,4,5,20.0%,27m
39421,1,Gomstor,2243,0,1,5,6,16.7%,29m
39421,3,Proctor,2243,0,1,6,7,14.3%,1h
39421,1,[DiBuS]Begastor,2243,0,1,8,9,11.1%,7m
39421,2,lbvf,2243,0,0,1,1,0.0%,26m
39451,1,Tiziano,2242,1757,186,200,386,48.2%,11m
39451,1,[Gülden]RustyManfred,2242,1281,173,179,352,49.1%,1h
39451,1,[RaaGaA]niko,2242,1761,104,112,216,48.1%,1h
39451,2,Шеф,2242,1411,78,77,155,50.3%,24m
39451,2,SoulReaper,2242,1118,51,33,84,60.7%,2m
39451,1,TheSaskia,2242,1430,50,55,105,47.6%,18m
39451,3,Stygi,2242,807,41,49,90,45.6%,1h
39451,1,Kraklenain,2242,886,29,34,63,46.0%,1h
39451,1,Blink,2242,735,28,28,56,50.0%,3m
39451,3,AlanThéo,2242,660,26,31,57,45.6%,5m
39451,1,NeckBeard,2242,410,25,19,44,56.8%,1h
39451,1,krystian,2242,870,25,33,58,43.1%,1h
39451,1,Xuupi,2242,476,19,18,37,51.4%,1h
39451,3,xiCe,2242,470,17,25,42,40.5%,6m
39451,3,Vadinoy,2242,350,16,20,36,44.4%,31m
39451,3,SERG,2242,408,16,28,44,36.4%,1h
39451,2,sneakySquid,2242,360,13,14,27,48.1%,1h
39451,1,marateyka,2242,398,10,16,26,38.5%,18m
39451,1,pluto,2242,248,8,10,18,44.4%,20m
39451,1,JlasSik,2242,333,8,15,23,34.8%,1h
39451,1,blorg,2242,298,8,16,24,33.3%,30m
39451,1,michael,2242,232,7,9,16,43.8%,27m
39451,1,matt,2242,211,6,5,11,54.5%,10m
39451,3,ValeX,2242,196,6,6,12,50.0%,1h
39451,1,Prezident,2242,218,6,8,14,42.9%,11m
39451,2,[DsFnC]Palladium,2242,116,5,0,5,100.0%,2m
39451,1,Alfred,2242,186,5,13,18,27.8%,23m
39451,3,WedbeR,2242,30,4,5,9,44.4%,18m
39451,1,[CHIBRE]Fseven,2242,241,4,6,10,40.0%,1h
39451,1,DYDOI,2242,120,3,2,5,60.0%,4m
39451,1,minion,2242,145,3,3,6,50.0%,29m
39451,1,littlebird,2242,163,3,8,11,27.3%,1h
39451,2,LTZ,2242,110,3,8,11,27.3%,22m
39451,3,tumbak,2242,60,3,10,13,23.1%,5m
39451,3,speedUp,2242,62,3,10,13,23.1%,8m
39451,3,Рейнор,2242,123,2,2,4,50.0%,1h
39451,3,BelugaBob,2242,95,2,7,9,22.2%,1h
39451,1,RomsiI,2242,48,2,8,10,20.0%,1h
39451,2,Bartol,2242,0,1,0,1,100.0%,25m
39451,1,[CОS]Heretic,2242,0,1,0,1,100.0%,1h
39451,1,aylakfare,2242,0,1,2,3,33.3%,1h
39451,1,Dasego,2242,0,1,2,3,33.3%,1h
39451,1,ritz,2242,0,1,2,3,33.3%,1h
39451,1,Stoutlager,2242,40,1,3,4,25.0%,3m
39451,1,Miner,2242,40,1,4,5,20.0%,1h
39451,2,Radek,2242,0,0,2,2,0.0%,8m
39451,2,Bazyl,2242,0,0,2,2,0.0%,11m
39451,1,BotTitLiquid,2242,0,0,2,2,0.0%,30m
39451,1,Madara,2242,0,0,3,3,0.0%,18m
39500,2,TheMoor,2241,1660,215,228,443,48.5%,1h
39500,1,RUSBEK,2241,1654,159,154,313,50.8%,1h
39500,3,asfalanas,2241,1126,124,126,250,49.6%,1h
39500,1,Foss,2241,1459,91,96,187,48.7%,1h
39500,1,Axtrix,2241,1416,81,79,160,50.6%,27m
39500,1,Alfredinho,2241,928,34,43,77,44.2%,1h
39500,2,SirOboldui,2241,388,17,5,22,77.3%,19m
39500,1,[004]Dave,2241,538,17,19,36,47.2%,30m
39500,1,Meini,2241,547,16,17,33,48.5%,1h
39500,1,Piraat,2241,329,11,20,31,35.5%,1h
39500,2,Alex,2241,292,10,8,18,55.6%,1h
39500,2,Zerg,2241,30,3,3,6,50.0%,12m
39500,1,DROOJ,2241,40,2,3,5,40.0%,28m
39500,2,HeDoBoDKa,2241,66,2,4,6,33.3%,11m
39500,1,[4453]Ganzyll,2241,88,2,5,7,28.6%,1h
39500,3,Waswasde,2241,109,2,6,8,25.0%,1h
39500,1,commander,2241,42,2,6,8,25.0%,1h
39500,1,Mishany,2241,73,2,9,11,18.2%,18m
39500,2,majorJan,2241,0,1,0,1,100.0%,1h
39500,1,Chmeetwo,2241,0,1,1,2,50.0%,14m
39500,1,[Дniще]MRandrei,2241,0,1,3,4,25.0%,31m
39500,1,Zelnidrix,2241,0,1,5,6,16.7%,1h
39500,1,CloneClone,2241,0,1,5,6,16.7%,1h
39500,2,Accoundelar,2241,0,0,1,1,0.0%,15m
39500,2,[НОД17]SCII,2241,73,0,4,4,0.0%,19m
39525,2,PPN,2240,1586,89,87,176,50.6%,1h
39525,1,tema,2240,1572,74,67,141,52.5%,1h
39525,3,Querios,2240,411,70,71,141,49.6%,21m
39525,1,[BATG]samory,2240,1147,61,58,119,51.3%,11m
39525,1,Nekto,2240,1458,59,58,117,50.4%,1h
39525,2,TvoySempay,2240,1096,44,44,88,50.0%,1h
39525,1,[UNPE]Kcrook,2240,921,35,41,76,46.1%,24m
39525,1,[SPCs]Tyrael,2240,380,31,33,64,48.4%,1h
39525,1,reidersha,2240,854,28,26,54,51.9%,25m
39525,3,Vlad,2240,635,21,29,50,42.0%,1h
39525,2,JhonBoss,2240,528,18,14,32,56.2%,28m
39525,2,david,2240,278,10,7,17,58.8%,1h
39525,2,chponchik,2240,306,10,9,19,52.6%,1h
39525,1,SashaMaster,2240,250,9,7,16,56.2%,30m
39525,1,blais,2240,276,7,17,24,29.2%,1h
39525,1,[AIUR15]FAKE,2240,160,6,10,16,37.5%,1h
39525,1,Gilgamesh,2240,144,4,6,10,40.0%,1h
39525,1,FanFan,2240,239,4,9,13,30.8%,29m
39525,2,Djomla,2240,0,2,3,5,40.0%,1h
39525,2,mrbrown,2240,0,2,7,9,22.2%,9m
39525,2,[AnhE1]Hubert,2240,0,1,4,5,20.0%,1h
39525,1,javimmor,2240,0,1,5,6,16.7%,7m
39525,2,BoBudowniczy,2240,0,1,5,6,16.7%,1h
39525,2,huberjosef,2240,0,0,1,1,0.0%,1h
39525,1,Pjolder,2240,0,0,3,3,0.0%,6m
39550,1,sinkelis,2239,1571,69,54,123,56.1%,29m
39550,1,imYourFather,2239,1006,35,35,70,50.0%,5m
39550,2,Kaizen,2239,984,34,35,69,49.3%,16m
39550,1,pabloav,2239,274,11,6,17,64.7%,31m
39550,1,[13NRV]CanUSee,2239,302,8,11,19,42.1%,23m
39550,1,Hellos,2239,247,7,3,10,70.0%,3m
39550,1,Johnnywalks,2239,162,6,9,15,40.0%,1h
39550,1,Hannez,2239,0,5,1,6,83.3%,31m
39550,1,[1FU2]Minae,2239,204,5,11,16,31.2%,1h
39550,2,Forward,2239,64,3,2,5,60.0%,4m
39550,1,SlothTiger,2239,110,3,6,9,33.3%,1h
39550,1,Oneofffly,2239,114,3,6,9,33.3%,1h
39550,2,terminator,2239,30,2,0,2,100.0%,26m
39550,1,Panominon,2239,0,2,4,6,33.3%,9m
39550,1,RiseDenise,2239,97,2,7,9,22.2%,4m
39550,1,BaadnewZ,2239,78,2,8,10,20.0%,26m
39550,2,FatPigeon,2239,0,1,0,1,100.0%,1h
39550,1,PIskatella,2239,97,1,3,4,25.0%,1h
39550,2,SnOwDuSt,2239,0,1,4,5,20.0%,10m
39550,2,kirspacemar,2239,0,1,5,6,16.7%,24m
39550,1,Patrick,2239,0,1,5,6,16.7%,1h
39550,1,Sablewood,2239,73,1,6,7,14.3%,1h
39550,1,[комча]lordtopgg,2239,42,1,6,7,14.3%,29m
39550,3,[radiol]ifmg,2239,0,1,6,7,14.3%,1h
39550,2,George,2239,0,0,1,1,0.0%,31m
39550,2,Alexandrew,2239,0,0,2,2,0.0%,26m
39550,2,[4Winds]CoveredOops,2239,0,0,2,2,0.0%,30m
39550,1,Skillerz,2239,0,0,3,3,0.0%,29m
39578,1,DarkFire,2238,1687,105,101,206,51.0%,1h
39578,1,Ajdam,2238,1626,96,89,185,51.9%,27m
39578,1,Lec,2238,975,76,66,142,53.5%,1h
39578,1,toWan,2238,1613,75,82,157,47.8%,18m
39578,1,Rémi,2238,1198,73,63,136,53.7%,13m
39578,1,[FYBF]Koprican,2238,1734,64,61,125,51.2%,1h
39578,3,Roy,2238,969,48,47,95,50.5%,6m
39578,1,Anarchy,2238,710,47,47,94,50.0%,25m
39578,1,severus,2238,1338,47,48,95,49.5%,1h
39578,1,reg,2238,931,33,31,64,51.6%,7m
39578,1,Archie,2238,745,27,25,52,51.9%,8m
39578,2,Tim,2238,672,22,29,51,43.1%,1h
39578,1,AZAROTH,2238,495,21,16,37,56.8%,9m
39578,1,EvilKing,2238,427,17,15,32,53.1%,1h
39578,1,Вавилон,2238,326,13,10,23,56.5%,1h
39578,1,bLackened,2238,290,8,11,19,42.1%,9m
39578,2,RustyDog,2238,132,7,4,11,63.6%,19m
39578,1,Zatsep,2238,250,7,7,14,50.0%,29m
39578,1,AurskogMafia,2238,220,7,8,15,46.7%,1h
39578,2,xdkssc,2238,172,5,5,10,50.0%,26m
39578,1,gogometria,2238,122,4,6,10,40.0%,7m
39578,1,kiloYOle,2238,48,4,8,12,33.3%,1h
39578,1,Bookworm,2238,102,3,1,4,75.0%,1h
39578,1,Bambix,2238,91,3,4,7,42.9%,1h
39578,1,Ilya,2238,134,3,8,11,27.3%,1h
39578,1,Catz,2238,111,2,2,4,50.0%,7m
39578,1,milanovich,2238,40,2,3,5,40.0%,8m
39578,2,Exostron,2238,0,2,3,5,40.0%,1h
39578,1,kenobi,2238,40,2,3,5,40.0%,1h
39578,1,greatguy,2238,40,2,6,8,25.0%,12m
39578,2,Avalon,2238,0,2,7,9,22.2%,24m
39578,1,Matvey,2238,0,1,1,2,50.0%,1h
39578,1,grandpa,2238,38,1,4,5,20.0%,1h
39578,2,Flintomat,2238,0,1,5,6,16.7%,1h
39578,2,TheCrusader,2238,0,0,1,1,0.0%,1h
39578,2,[Heets]timbik,2238,0,0,1,1,0.0%,1h
39578,2,[Mooи]kubasjtCZ,2238,0,0,1,1,0.0%,29m
39578,2,Philby,2238,0,0,1,1,0.0%,1h
39578,1,Pio,2238,0,0,1,1,0.0%,1h
39617,1,euskal,2237,1663,129,129,258,50.0%,1h
39617,1,tilox,2237,1243,99,101,200,49.5%,18m
39617,1,SaLEm,2237,1373,96,84,180,53.3%,8m
39617,2,Cactus,2237,1193,52,37,89,58.4%,17m
39617,1,Filin,2237,1371,52,48,100,52.0%,1h
39617,1,PLOVETS,2237,1219,49,57,106,46.2%,16m
39617,2,[kek34]Fireice,2237,1125,48,42,90,53.3%,1h
39617,2,Letus,2237,1021,37,40,77,48.1%,17m
39617,1,RatKingSoury,2237,618,30,18,48,62.5%,1h
39617,1,Ernst,2237,904,27,36,63,42.9%,1h
39617,1,MonkeyMagic,2237,742,21,30,51,41.2%,1h
39617,1,OoNnEeSs,2237,326,17,10,27,63.0%,1h
39617,1,Galleta,2237,262,9,9,18,50.0%,7m
39617,1,Mikhael,2237,259,8,10,18,44.4%,1h
39617,2,War,2237,232,8,11,19,42.1%,14m
39617,2,Iman,2237,122,4,1,5,80.0%,1h
39617,1,Dawid,2237,176,4,10,14,28.6%,1h
39617,2,NICO,2237,164,4,10,14,28.6%,17m
39617,2,tucsok,2237,42,3,4,7,42.9%,1h
39617,3,Александр,2237,30,3,4,7,42.9%,32m
39617,1,Holy,2237,127,3,7,10,30.0%,5m
39617,2,Davide,2237,99,3,8,11,27.3%,22m
39617,2,Malacoda,2237,46,2,0,2,100.0%,10m
39617,2,anakin,2237,0,2,3,5,40.0%,1h
39617,3,[LC666]Querfahrer,2237,0,2,6,8,25.0%,32m
39617,1,CheatCode,2237,84,2,6,8,25.0%,1h
39617,1,gruzer,2237,0,1,0,1,100.0%,6m
39617,1,Nova,2237,36,1,3,4,25.0%,1h
39617,3,Tudoratorul,2237,0,0,1,1,0.0%,28m
39617,2,[CLAB]soberlols,2237,0,0,2,2,0.0%,27m
39617,2,VLADIMIR,2237,0,0,2,2,0.0%,29m
39648,1,Pixel,2236,1750,162,173,335,48.4%,17m
39648,1,Bumblebee,2236,1488,97,96,193,50.3%,30m
39648,1,bistoufly,2236,1064,43,38,81,53.1%,2m
39648,3,KYLOGRAM,2236,892,32,41,73,43.8%,12m
39648,1,Dragonio,2236,732,22,32,54,40.7%,29m
39648,1,firebug,2236,537,18,15,33,54.5%,1h
39648,2,Ggoo,2236,406,14,11,25,56.0%,28m
39648,1,Mateusz,2236,386,11,13,24,45.8%,1h
39648,1,javecouse,2236,215,7,2,9,77.8%,1h
39648,1,ТЕМА,2236,266,6,12,18,33.3%,5m
39648,3,Meedyuk,2236,30,4,6,10,40.0%,6m
39648,1,stjeka,2236,150,4,7,11,36.4%,1h
39648,2,trety,2236,58,3,4,7,42.9%,1h
39648,2,[Gоld]twentYSeven,2236,120,2,3,5,40.0%,30m
39648,1,danik,2236,104,2,4,6,33.3%,1h
39648,2,DarovskikhYY,2236,0,1,0,1,100.0%,1h
39648,2,Hiwett,2236,0,1,0,1,100.0%,31m
39648,2,narutoko,2236,0,1,1,2,50.0%,1h
39648,1,thanos,2236,0,1,2,3,33.3%,1h
39648,1,Dezz,2236,0,1,2,3,33.3%,30m
39648,1,[OGR232]DarkSide,2236,0,1,2,3,33.3%,27m
39648,2,Emre,2236,0,1,4,5,20.0%,10m
39648,1,MrDuden,2236,42,1,4,5,20.0%,1h
39648,2,Serhii,2236,0,1,4,5,20.0%,1h
39648,1,MrJonas,2236,0,1,5,6,16.7%,4m
39648,1,AMIAK,2236,40,1,6,7,14.3%,25m
39648,1,MCMWOW,2236,42,1,6,7,14.3%,1h
39648,3,vlad,2236,0,1,6,7,14.3%,1h
39648,2,schasi,2236,0,0,1,1,0.0%,1h
39648,2,danielex,2236,0,0,1,1,0.0%,1h
39648,1,vuko,2236,0,0,4,4,0.0%,1h
39679,2,hidalgo,2235,1425,127,122,249,51.0%,21m
39679,1,vashik,2235,1757,113,114,227,49.8%,10m
39679,1,hipolit,2235,624,41,42,83,49.4%,1h
39679,1,Craco,2235,812,34,36,70,48.6%,30m
39679,2,Eduard,2235,814,31,25,56,55.4%,1h
39679,1,Effect,2235,803,30,24,54,55.6%,26m
39679,1,[chah]prometheus,2235,417,18,8,26,69.2%,1h
39679,1,Dwayne,2235,578,17,24,41,41.5%,18m
39679,2,fifflaren,2235,432,16,22,38,42.1%,21m
39679,1,[Znaesh]EKaradjov,2235,307,16,23,39,41.0%,1h
39679,3,Ben,2235,359,12,20,32,37.5%,10m
39679,1,Sammy,2235,338,9,16,25,36.0%,11m
39679,1,LaMar,2235,272,9,17,26,34.6%,11m
39679,3,[ULTX]Bavor,2235,252,7,11,18,38.9%,1h
39679,2,moshe,2235,152,5,7,12,41.7%,28m
39679,2,Евгений,2235,172,5,9,14,35.7%,29m
39679,2,Imago,2235,86,4,2,6,66.7%,1h
39679,1,alozarito,2235,48,2,0,2,100.0%,3m
39679,1,CBU,2235,68,2,5,7,28.6%,16m
39679,2,Mcgubbins,2235,0,1,0,1,100.0%,21m
39679,2,AncientGrey,2235,0,1,1,2,50.0%,22m
39679,2,Докеби,2235,34,1,3,4,25.0%,18m
39679,2,FerQP,2235,0,1,4,5,20.0%,1h
39679,2,[BHDes]SurpriseMF,2235,0,0,1,1,0.0%,18m
39679,2,kramptame,2235,0,0,1,1,0.0%,1h
39679,2,Cristianx,2235,0,0,1,1,0.0%,19m
39705,1,Deadpresiden,2234,1154,46,44,90,51.1%,8m
39705,1,xWEEDGEx,2234,718,28,42,70,40.0%,1h
39705,1,[Rakia]MindStorm,2234,664,26,31,57,45.6%,1h
39705,1,NGOLOYOLO,2234,615,25,18,43,58.1%,7m
39705,1,Yordix,2234,434,24,27,51,47.1%,1h
39705,2,CheGuevara,2234,663,22,26,48,45.8%,6m
39705,1,RELAX,2234,533,16,22,38,42.1%,1h
39705,1,КвасныйДварф,2234,521,16,22,38,42.1%,1h
39705,1,PedroMRF,2234,402,11,17,28,39.3%,1h
39705,1,Snowtagh,2234,277,9,13,22,40.9%,1h
39705,2,Gradionic,2234,208,7,5,12,58.3%,14m
39705,1,[CHOPAA]EOD,2234,193,6,4,10,60.0%,30m
39705,3,GrG,2234,90,5,11,16,31.2%,1h
39705,2,inquisitor,2234,134,4,8,12,33.3%,31m
39705,2,AngeloS,2234,125,3,4,7,42.9%,1h
39705,1,BabaYAga,2234,0,3,4,7,42.9%,1h
39705,2,PlankTon,2234,66,2,2,4,50.0%,25m
39705,1,Smirolio,2234,38,2,3,5,40.0%,1h
39705,2,Ragnarock,2234,102,2,6,8,25.0%,21m
39705,2,speNcer,2234,44,2,6,8,25.0%,15m
39705,3,Retromen,2234,0,2,7,9,22.2%,23m
39705,2,mib,2234,0,1,4,5,20.0%,13m
39705,2,[Wick]IronHand,2234,0,0,1,1,0.0%,28m
39705,2,Panic,2234,0,0,1,1,0.0%,1h
39705,2,WoolyBugger,2234,0,0,1,1,0.0%,1h
39705,2,Молочник,2234,0,0,1,1,0.0%,10m
39705,3,ILya,2234,0,0,1,1,0.0%,14m
39705,1,Kiorn,2234,0,0,3,3,0.0%,10m
39705,2,Aaron,2234,0,0,4,4,0.0%,1h
39705,2,myDanielM,2234,0,0,5,5,0.0%,13m
39735,1,STARTEM,2233,1583,161,155,316,50.9%,18m
39735,3,Joba,2233,939,155,154,309,50.2%,4m
39735,1,Kerrigan,2233,806,25,29,54,46.3%,1h
39735,1,zaga,2233,421,22,27,49,44.9%,30m
39735,1,AvaturiusII,2233,509,21,14,35,60.0%,7m
39735,1,Erien,2233,584,18,23,41,43.9%,27m
39735,1,[OverX]maxx,2233,269,16,19,35,45.7%,1h
39735,1,FUNKYBUDHA,2233,338,15,12,27,55.6%,1h
39735,2,Trey,2233,386,14,16,30,46.7%,28m
39735,2,[BNest]Jedi,2233,368,13,10,23,56.5%,1h
39735,1,Makedonija,2233,234,9,7,16,56.2%,29m
39735,1,Crit,2233,366,9,15,24,37.5%,1h
39735,3,GreyMonk,2233,260,9,19,28,32.1%,4m
39735,1,Ikeran,2233,175,6,10,16,37.5%,1h
39735,2,Mithrandir,2233,86,4,2,6,66.7%,9m
39735,2,[Rus2]RussianMean,2233,90,4,5,9,44.4%,13m
39735,1,[z666z]Бетрезэн,2233,159,4,7,11,36.4%,1h
39735,1,MixaiJl,2233,215,4,9,13,30.8%,29m
39735,2,ErjiDeLaRosa,2233,66,3,2,5,60.0%,29m
39735,1,Jomaro,2233,123,3,3,6,50.0%,29m
39735,2,KSB,2233,96,3,4,7,42.9%,25m
39735,2,yava,2233,92,3,7,10,30.0%,1h
39735,3,Bidzz,2233,115,3,7,10,30.0%,1h
39735,2,LeGenDarySea,2233,109,2,1,3,66.7%,13m
39735,2,Xavpres,2233,60,2,2,4,50.0%,1h
39735,1,Stringer,2233,89,2,3,5,40.0%,16m
39735,1,Heltox,2233,0,2,8,10,20.0%,1h
39735,2,Enigma,2233,46,1,2,3,33.3%,15m
39735,1,Ryuzaki,2233,40,1,5,6,16.7%,21m
39735,2,Honza,2233,0,1,5,6,16.7%,30m
39735,2,Hydra,2233,30,1,5,6,16.7%,1h
39735,2,SER,2233,0,0,1,1,0.0%,21m
39735,2,IIIIIIIIII,2233,0,0,5,5,0.0%,1h
39768,1,BraveMan,2232,1753,244,255,499,48.9%,30m
39768,1,Merqury,2232,1619,187,194,381,49.1%,21m
39768,1,Android,2232,1570,87,88,175,49.7%,24m
39768,1,RemaCRO,2232,1453,85,80,165,51.5%,1h
39768,1,waldor,2232,799,76,81,157,48.4%,1h
39768,1,Dannette,2232,617,48,53,101,47.5%,5m
39768,2,VAVA,2232,1148,44,41,85,51.8%,8m
39768,2,cheraoff,2232,1047,38,41,79,48.1%,1h
39768,1,Tazius,2232,632,24,23,47,51.1%,28m
39768,1,jmracher,2232,740,24,29,53,45.3%,4m
39768,1,aDastrA,2232,593,23,18,41,56.1%,1h
39768,1,vorobei,2232,355,12,13,25,48.0%,14m
39768,2,AsPMaSsAkEr,2232,273,10,13,23,43.5%,9m
39768,1,tanknl,2232,299,9,7,16,56.2%,1h
39768,2,HoobНУБ,2232,311,9,8,17,52.9%,31m
39768,2,froleshnik,2232,176,7,3,10,70.0%,28m
39768,1,Thierry,2232,276,7,16,23,30.4%,7m
39768,2,TEZz,2232,100,4,3,7,57.1%,1h
39768,1,Dogtopus,2232,98,4,4,8,50.0%,1h
39768,2,[BArCo]Sakura,2232,0,3,2,5,60.0%,8m
39768,3,KoBaNcHiK,2232,97,2,3,5,40.0%,1h
39768,1,Priest,2232,80,2,5,7,28.6%,1h
39768,2,[KoSt44]Давид,2232,0,1,1,2,50.0%,18m
39768,1,boesan,2232,0,1,2,3,33.3%,4m
39768,1,Fuff,2232,0,1,2,3,33.3%,1h
39768,1,AlphaPrey,2232,0,1,5,6,16.7%,1h
39768,1,Lyk,2232,0,1,5,6,16.7%,9m
39768,1,pumpkins,2232,0,1,6,7,14.3%,1h
39768,1,ENIGMA,2232,0,1,6,7,14.3%,8m
39768,2,[TBIRRA]Dave,2232,0,0,2,2,0.0%,1h
39768,2,CaptFliege,2232,0,0,2,2,0.0%,17m
39768,3,Deadkarre,2232,0,0,3,3,0.0%,1h
39800,1,IOB,2231,1633,66,66,132,50.0%,1h
39800,1,OLDXXI,2231,794,32,27,59,54.2%,28m
39800,2,igor,2231,520,19,16,35,54.3%,1h
39800,1,[Terraz]marcus,2231,537,17,16,33,51.5%,29m
39800,1,doubrechka,2231,429,15,25,40,37.5%,1h
39800,3,Alok,2231,346,12,23,35,34.3%,1h
39800,2,Irbis,2231,302,11,10,21,52.4%,25m
39800,2,DarkDevil,2231,252,9,6,15,60.0%,1h
39800,3,Sheriff,2231,156,8,15,23,34.8%,6m
39800,1,Rathalos,2231,190,7,3,10,70.0%,20m
39800,2,Balantos,2231,116,5,2,7,71.4%,1h
39800,2,veener,2231,195,5,2,7,71.4%,22m
39800,1,[коммск]CinemaL,2231,162,5,8,13,38.5%,1h
39800,1,[OПГ]ArtDark,2231,189,4,4,8,50.0%,1h
39800,1,RomanKRSK,2231,76,3,4,7,42.9%,23m
39800,1,[ECF]Skarto,2231,82,3,8,11,27.3%,1h
39800,1,Timerox,2231,48,2,1,3,66.7%,1h
39800,2,[HMarch]Gerlex,2231,60,2,2,4,50.0%,23m
39800,1,DoSs,2231,32,2,3,5,40.0%,17m
39800,1,Mrc,2231,126,2,4,6,33.3%,31m
39800,2,[SsC]Duce,2231,46,1,3,4,25.0%,1h
39800,3,Lam,2231,0,1,3,4,25.0%,1h
39800,2,sdentatovic,2231,36,1,3,4,25.0%,26m
39800,2,OOPS,2231,0,1,3,4,25.0%,31m
39800,1,Bados,2231,0,0,3,3,0.0%,10m
39800,3,Zarubin,2231,0,0,3,3,0.0%,25m
39800,2,[Pu238]ChrisBPM,2231,0,0,5,5,0.0%,11m
39827,1,[БАЗА45]Vital,2230,1755,142,137,279,50.9%,13m
39827,1,DireRaven,2230,1643,119,123,242,49.2%,29m
39827,1,Petepanama,2230,1408,76,82,158,48.1%,25m
39827,1,Duden,2230,1185,44,48,92,47.8%,21m
39827,1,diegladeitor,2230,990,38,33,71,53.5%,7m
39827,2,DarkSerg,2230,628,23,21,44,52.3%,13m
39827,1,Legion,2230,245,22,19,41,53.7%,1h
39827,1,[1FCG]nexas,2230,500,14,15,29,48.3%,31m
39827,1,Bendera,2230,410,13,17,30,43.3%,1h
39827,1,joseisamurai,2230,396,12,18,30,40.0%,1h
39827,1,Aksel,2230,398,11,16,27,40.7%,24m
39827,1,luisito,2230,246,7,7,14,50.0%,21m
39827,1,SoulAsS,2230,144,5,9,14,35.7%,6m
39827,2,Bluesky,2230,100,3,4,7,42.9%,1h
39827,2,Energodar,2230,32,2,1,3,66.7%,29m
39827,1,ERROR,2230,126,2,4,6,33.3%,11m
39827,1,diegozama,2230,40,2,4,6,33.3%,1h
39827,3,TheLotoKing,2230,30,2,8,10,20.0%,1h
39827,2,SpoterStar,2230,30,2,9,11,18.2%,1h
39827,2,[Scarer]Ossa,2230,0,1,0,1,100.0%,12m
39827,2,DeNNiS,2230,0,1,4,5,20.0%,11m
39827,1,Plydar,2230,48,1,4,5,20.0%,1h
39827,2,pop,2230,0,1,4,5,20.0%,1h
39827,1,Sluggy,2230,0,1,6,7,14.3%,1h
39827,1,BARTOSZEK,2230,0,1,6,7,14.3%,30m
39827,1,BabyShark,2230,0,0,2,2,0.0%,3m
39827,1,Totlii,2230,73,0,4,4,0.0%,7m
39854,3,Willem,2229,1557,148,144,292,50.7%,1h
39854,1,PandaRoux,2229,1469,135,142,277,48.7%,1h
39854,1,Тиенам,2229,1008,130,155,285,45.6%,1h
39854,2,Ryrik,2229,1346,56,47,103,54.4%,18m
39854,1,[Dose]AbdulLachmal,2229,1654,56,63,119,47.1%,1h
39854,1,Yberman,2229,907,39,38,77,50.6%,1h
39854,3,Track,2229,613,22,28,50,44.0%,6m
39854,3,wush,2229,425,19,35,54,35.2%,17m
39854,1,ИСКРАИВЕТЕР,2229,543,16,17,33,48.5%,13m
39854,2,Iconoclast,2229,280,15,14,29,51.7%,1h
39854,2,SiSiFliegen,2229,472,15,16,31,48.4%,27m
39854,1,Arrun,2229,376,13,22,35,37.1%,1h
39854,1,RiGGzR,2229,444,12,18,30,40.0%,1h
39854,2,Varcor,2229,264,10,7,17,58.8%,1h
39854,1,[AoTu]BelovedJouw,2229,263,10,9,19,52.6%,1h
39854,2,mati,2229,354,10,10,20,50.0%,1h
39854,1,Lazurasjones,2229,278,8,11,19,42.1%,1h
39854,1,Bratan,2229,228,8,16,24,33.3%,25m
39854,2,InkVisitor,2229,166,6,15,21,28.6%,1h
39854,1,Ferry,2229,181,5,10,15,33.3%,7m
39854,2,Jarko,2229,94,4,5,9,44.4%,1h
39854,2,FakeIIIIIIII,2229,206,4,9,13,30.8%,1h
39854,1,Waaager,2229,82,3,9,12,25.0%,27m
39854,3,Lightman,2229,36,3,9,12,25.0%,1h
39854,2,[WWOGU]Zero,2229,121,2,2,4,50.0%,1h
39854,2,Андрей,2229,62,2,3,5,40.0%,1h
39854,1,DiMA,2229,32,2,4,6,33.3%,8m
39854,2,[Sw1tch]ars,2229,0,1,5,6,16.7%,1h
39854,1,TheSheep,2229,0,1,5,6,16.7%,1h
39854,2,SergiusUA,2229,0,0,1,1,0.0%,14m
39884,1,RIM,2228,1715,182,186,368,49.5%,1h
39884,3,[xolf]THOR,2228,1571,74,82,156,47.4%,1h
39884,1,help,2228,1380,57,65,122,46.7%,1h
39884,1,Странник,2228,946,40,42,82,48.8%,28m
39884,1,BalHamon,2228,1004,30,37,67,44.8%,1h
39884,1,Prlme,2228,589,22,21,43,51.2%,1h
39884,1,BladHeBamnip,2228,559,16,16,32,50.0%,1h
39884,1,[Naissu]DrOctO,2228,441,14,13,27,51.9%,30m
39884,3,Muerte,2228,358,12,23,35,34.3%,1h
39884,3,ProtosAdy,2228,290,10,4,14,71.4%,1h
39884,2,[RITB]Senpai,2228,321,10,7,17,58.8%,1h
39884,1,[RusGay]Тетриандох,2228,121,9,7,16,56.2%,30m
39884,3,kell,2228,225,7,12,19,36.8%,8m
39884,1,chubyzealot,2228,144,4,4,8,50.0%,30m
39884,2,[HAKS]BLACKALIROSE,2228,96,4,4,8,50.0%,8m
39884,2,batbekh,2228,66,4,5,9,44.4%,30m
39884,1,[OIDA]prinzxxl,2228,160,4,7,11,36.4%,1h
39884,1,flintovich,2228,155,4,10,14,28.6%,26m
39884,2,Adamisek,2228,48,3,4,7,42.9%,25m
39884,1,Eugen,2228,96,3,4,7,42.9%,1h
39884,1,EugeneSky,2228,138,3,5,8,37.5%,29m
39884,1,Nomisarache,2228,89,2,2,4,50.0%,31m
39884,2,goatLover,2228,30,2,2,4,50.0%,1h
39884,1,PrinzArthas,2228,34,2,6,8,25.0%,1h
39884,2,Baneling,2228,125,2,6,8,25.0%,1h
39884,1,SWDmitry,2228,36,2,6,8,25.0%,1h
39884,2,[D0N3]DARKBLADE,2228,0,1,3,4,25.0%,30m
39884,2,YTS,2228,30,1,5,6,16.7%,1h
39884,2,ThisIsMeMeee,2228,0,0,1,1,0.0%,28m
39884,2,[8Pool]Asfodel,2228,0,0,2,2,0.0%,1h
39884,2,Chess,2228,0,0,2,2,0.0%,13m
39884,1,ahangar,2228,0,0,3,3,0.0%,1h
39884,2,Goodseallah,2228,0,0,5,5,0.0%,31m
39917,1,Slalit,2227,1736,147,154,301,48.8%,23m
39917,1,MadSCV,2227,1748,104,113,217,47.9%,1h
39917,1,NaImieP,2227,1360,59,68,127,46.5%,30m
39917,1,[xZero]Plaiman,2227,1148,53,47,100,53.0%,1h
39917,2,GranCapitan,2227,795,44,3,47,93.6%,13m
39917,1,Legion,2227,820,37,37,74,50.0%,13m
39917,1,Vagabond,2227,625,26,22,48,54.2%,1h
39917,3,Luquick,2227,433,25,35,60,41.7%,12m
39917,2,[OG8]ewgen,2227,360,14,11,25,56.0%,18m
39917,1,John,2227,245,12,8,20,60.0%,1h
39917,1,Aquarone,2227,304,8,16,24,33.3%,22m
39917,1,Pigher,2227,288,7,12,19,36.8%,13m
39917,1,Евгений,2227,44,6,3,9,66.7%,1h
39917,1,Christov,2227,264,6,8,14,42.9%,1h
39917,3,WuTanG,2227,199,6,12,18,33.3%,1m
39917,3,deniolo,2227,194,5,6,11,45.5%,1h
39917,3,[BIAE]frääääänk,2227,173,4,8,12,33.3%,29m
39917,1,[chaton]dessoudeur,2227,89,2,2,4,50.0%,1h
39917,1,stavr,2227,42,2,3,5,40.0%,1h
39917,1,KMB,2227,78,2,6,8,25.0%,30m
39917,2,[UAFire]Raffer,2227,0,1,0,1,100.0%,1h
39917,2,Райдер,2227,0,1,1,2,50.0%,24m
39917,1,[RushBC]EnginE,2227,48,1,1,2,50.0%,1h
39917,3,Lazeh,2227,0,1,1,2,50.0%,1m
39917,2,AlanKvAzA,2227,0,1,3,4,25.0%,1h
39917,2,Ssvlad,2227,0,1,5,6,16.7%,10m
39917,1,Scypther,2227,97,1,7,8,12.5%,4m
39917,2,SinKz,2227,0,0,1,1,0.0%,1h
39917,2,Tozer,2227,0,0,1,1,0.0%,1h
39946,1,Brutos,2226,1358,172,174,346,49.7%,18m
39946,3,Hard,2226,1343,134,140,274,48.9%,1h
39946,1,gekyd,2226,1733,90,88,178,50.6%,11m
39946,1,Oldie,2226,1750,74,72,146,50.7%,16m
39946,1,RomanooOOoo,2226,1473,66,42,108,61.1%,7m
39946,1,[Rooar]Jack,2226,517,39,38,77,50.6%,29m
39946,2,Qronaz,2226,786,28,45,73,38.4%,19m
39946,1,MvShoTzz,2226,564,24,24,48,50.0%,1h
39946,2,UbaNawak,2226,562,21,14,35,60.0%,28m
39946,1,MrBrightside,2226,516,18,20,38,47.4%,31m
39946,3,LupaJr,2226,525,18,27,45,40.0%,10m
39946,3,kvothe,2226,436,16,21,37,43.2%,23m
39946,2,kps,2226,374,13,12,25,52.0%,10m
39946,2,Адель,2226,282,10,8,18,55.6%,4m
39946,3,[MANGE]Satchel,2226,224,7,12,19,36.8%,28m
39946,2,TerminaThor,2226,178,6,6,12,50.0%,31m
39946,1,nitram,2226,178,6,8,14,42.9%,14m
39946,1,LazyTitan,2226,190,6,8,14,42.9%,1h
39946,1,UnlimiteD,2226,208,6,10,16,37.5%,1h
39946,1,[LOOOOS]RobotVegan,2226,178,5,9,14,35.7%,1h
39946,1,BetterThMaik,2226,60,4,12,16,25.0%,32m
39946,3,[CPin]CabaNoche,2226,115,3,7,10,30.0%,1h
39946,2,[CVT]Nemesis,2226,30,2,0,2,100.0%,12m
39946,3,Xerxes,2226,30,2,0,2,100.0%,4m
39946,1,ejojer,2226,44,2,3,5,40.0%,28m
39946,1,SuperMage,2226,44,2,6,8,25.0%,1h
39946,1,ramstien,2226,97,2,6,8,25.0%,1h
39946,2,Nidhogg,2226,0,1,0,1,100.0%,1h
39946,2,LoveLife,2226,0,1,3,4,25.0%,14m
39946,2,MrChe,2226,30,1,5,6,16.7%,1h
39946,2,wITEK,2226,30,1,7,8,12.5%,1h
39946,2,loli,2226,0,0,1,1,0.0%,1h
39946,1,[KROK]DRGazeton,2226,0,0,2,2,0.0%,8m
39946,2,Name,2226,0,0,5,5,0.0%,18m
39980,2,Zod,2225,1542,97,89,186,52.2%,8m
39980,2,Yomofreak,2225,1267,48,42,90,53.3%,11m
39980,1,Vaga,2225,1028,33,38,71,46.5%,21m
39980,1,TYLERZ,2225,880,31,28,59,52.5%,1h
39980,2,otzi,2225,614,24,19,43,55.8%,1h
39980,2,Sandor,2225,411,12,15,27,44.4%,25m
39980,1,Klagmar,2225,320,9,13,22,40.9%,23m
39980,2,Ares,2225,34,5,3,8,62.5%,1h
39980,2,Кузян,2225,96,4,1,5,80.0%,1h
39980,2,Lucathor,2225,30,3,8,11,27.3%,28m
39980,3,zeot,2225,62,3,10,13,23.1%,8m
39980,1,RobRaj,2225,128,2,4,6,33.3%,1h
39980,2,Yarrakhasan,2225,48,2,6,8,25.0%,1h
39980,1,nuke,2225,97,2,7,9,22.2%,8m
39980,2,Nikusz,2225,32,2,16,18,11.1%,26m
39980,2,Tim,2225,32,1,1,2,50.0%,1h
39980,2,gringio,2225,0,1,1,2,50.0%,1h
39980,2,[FlyDt]XeON,2225,38,1,2,3,33.3%,28m
39980,2,Pixel,2225,0,1,4,5,20.0%,28m
39980,2,[GT1Y]ZeRAsK,2225,0,0,1,1,0.0%,1h
40000,1,SNorthWood,2224,1743,245,249,494,49.6%,17m
40000,1,Don,2224,1640,157,161,318,49.4%,1h
40000,1,danu,2224,1710,138,146,284,48.6%,1h
40000,3,Mcannin,2224,891,82,92,174,47.1%,14m
40000,2,TheLegendary,2224,1658,68,65,133,51.1%,28m
40000,2,[NeCriN]BJabJu,2224,742,58,74,132,43.9%,22m
40000,3,NagasauR,2224,804,27,40,67,40.3%,1h
40000,1,[kastru]Гриша,2224,449,20,12,32,62.5%,1h
40000,1,Knollbaer,2224,468,14,17,31,45.2%,5m
40000,1,StarlinkOK,2224,258,11,14,25,44.0%,1h
40000,1,straiker,2224,356,11,16,27,40.7%,11m
40000,1,[scp3]Rylavein,2224,226,8,6,14,57.1%,31m
40000,2,Andrey,2224,170,7,1,8,87.5%,12m
40000,3,anndend,2224,192,5,11,16,31.2%,1h
40000,2,Plagegeist,2224,96,4,4,8,50.0%,23m
40000,1,WanweY,2224,96,4,11,15,26.7%,2m
40000,1,[0MGz]pandocha,2224,107,3,2,5,60.0%,1h
40000,1,[HACK3R]MatsuPro,2224,130,3,4,7,42.9%,1h
40000,2,SirMax,2224,76,2,3,5,40.0%,26m
40000,1,[DEI]Flobur,2224,97,2,6,8,25.0%,24m
40000,1,Vorhautmade,2224,76,2,6,8,25.0%,1h
40000,1,иван,2224,0,1,2,3,33.3%,12m
40000,2,Arturchan,2224,88,1,4,5,20.0%,10m
40000,2,Neikma,2224,0,0,5,5,0.0%,30m
40024,2,CaptainHicks,2223,1052,143,137,280,51.1%,1h
40024,1,[FPu]ALEKS,2223,1257,108,109,217,49.8%,1h
40024,1,setio,2223,1520,92,91,183,50.3%,1h
40024,1,Mariusz,2223,1345,64,69,133,48.1%,1h
40024,2,MrTitan,2223,806,30,26,56,53.6%,1h
40024,2,[lBSGl]KotBegemot,2223,691,25,28,53,47.2%,13m
40024,1,[oooboy]pindolek,2223,513,24,15,39,61.5%,1h
40024,2,[from]YoMister,2223,676,23,27,50,46.0%,27m
40024,1,TheCrow,2223,632,18,23,41,43.9%,12m
40024,1,Fabricio,2223,374,11,21,32,34.4%,1h
40024,2,Wojto,2223,258,9,8,17,52.9%,1h
40024,3,ErbiumRage,2223,273,9,13,22,40.9%,1h
40024,1,vio,2223,272,8,7,15,53.3%,1h
40024,1,Alexx,2223,287,8,10,18,44.4%,16m
40024,2,INSIDIOUS,2223,62,6,3,9,66.7%,1h
40024,1,Gorchan,2223,185,6,8,14,42.9%,1h
40024,2,Jamside,2223,118,5,1,6,83.3%,26m
40024,1,myke,2223,230,5,7,12,41.7%,14m
40024,1,Marbel,2223,172,5,7,12,41.7%,7m
40024,1,Blaze,2223,182,5,7,12,41.7%,1h
40024,2,swissGuy,2223,88,5,13,18,27.8%,10m
40024,1,[лампа]саша,2223,112,4,6,10,40.0%,7m
40024,2,[tofury]TollerName,2223,70,3,1,4,75.0%,1h
40024,1,Zendre,2223,137,3,8,11,27.3%,28m
40024,1,leonard,2223,88,2,1,3,66.7%,1h
40024,2,[LAGY]Rabyan,2223,60,2,2,4,50.0%,1h
40024,2,Khazmodan,2223,0,2,3,5,40.0%,1h
40024,2,ClipoPL,2223,0,1,5,6,16.7%,1h
40024,1,TITTO,2223,0,1,5,6,16.7%,28m
40024,2,deimosnight,2223,0,1,5,6,16.7%,1h
40024,2,Rumato,2223,0,0,1,1,0.0%,18m
40024,2,EvilZerg,2223,0,0,1,1,0.0%,32m
40024,2,ŚwiatłyKieł,2223,0,0,2,2,0.0%,1h
40024,2,[ThAs]Tòmmeh,2223,0,0,4,4,0.0%,26m
40024,3,Tuman,2223,0,0,4,4,0.0%,14m
40059,1,Virus,2222,1723,163,153,316,51.6%,25m
40059,1,Encio,2222,1704,141,131,272,51.8%,8m
40059,1,Alex,2222,1512,87,91,178,48.9%,27m
40059,2,HappyCola,2222,1481,79,74,153,51.6%,23m
40059,2,SpaceTitan,2222,613,23,17,40,57.5%,1h
40059,3,MutantMass,2222,656,23,34,57,40.4%,7m
40059,1,Tommiknoker,2222,604,20,20,40,50.0%,11m
40059,3,Jimanju,2222,586,20,24,44,45.5%,1h
40059,1,javibox,2222,604,18,24,42,42.9%,1h
40059,2,sever,2222,373,15,12,27,55.6%,11m
40059,1,[RusWar]Танкарик,2222,550,15,22,37,40.5%,1h
40059,1,LEMBREX,2222,318,13,12,25,52.0%,30m
40059,2,Capominatore,2222,210,12,12,24,50.0%,18m
40059,1,jcmd,2222,318,12,16,28,42.9%,29m
40059,2,alexandre,2222,283,9,13,22,40.9%,29m
40059,2,Nevo,2222,209,7,14,21,33.3%,30m
40059,1,Dionysos,2222,166,7,17,24,29.2%,28m
40059,2,Clicker,2222,156,5,5,10,50.0%,1h
40059,1,WarPriCe,2222,42,4,5,9,44.4%,11m
40059,1,Vozyk,2222,165,4,6,10,40.0%,18m
40059,1,tdyk,2222,119,4,10,14,28.6%,1h
40059,1,Ariman,2222,146,4,12,16,25.0%,21m
40059,2,noks,2222,60,3,1,4,75.0%,1h
40059,2,AgentSmith,2222,0,3,2,5,60.0%,3m
40059,2,matras,2222,64,3,2,5,60.0%,1h
40059,1,IIpobeJI,2222,0,3,4,7,42.9%,3m
40059,2,Npozite,2222,92,3,6,9,33.3%,22m
40059,2,swole,2222,0,2,3,5,40.0%,1h
40059,1,Rainor,2222,135,2,8,10,20.0%,1h
40059,1,Ung,2222,0,1,2,3,33.3%,1h
40059,1,Mefisto,2222,0,1,2,3,33.3%,29m
40059,2,dangernk,2222,34,1,2,3,33.3%,23m
40059,1,FenrirLeFou,2222,36,1,3,4,25.0%,1h
40059,2,Borney,2222,0,1,5,6,16.7%,1h
40059,1,KZZZ,2222,38,1,6,7,14.3%,1h
40059,2,sin,2222,0,0,1,1,0.0%,31m
40059,2,Rana,2222,0,0,1,1,0.0%,15m
40059,1,Vikastorm,2222,0,0,2,2,0.0%,8m
40059,2,LuchokGame,2222,0,0,2,2,0.0%,24m
40098,2,Teamyates,2221,1349,311,311,622,50.0%,2m
40098,1,denissava,2221,1082,96,101,197,48.7%,18m
40098,2,Mrakk,2221,1062,39,48,87,44.8%,1h
40098,1,muctertrup,2221,768,36,25,61,59.0%,1h
40098,1,Trapper,2221,1042,31,41,72,43.1%,1h
40098,1,BETLEROK,2221,718,21,24,45,46.7%,1h
40098,2,NowyFolder,2221,453,17,10,27,63.0%,28m
40098,3,Celta,2221,206,8,10,18,44.4%,1h
40098,1,smfly,2221,259,7,16,23,30.4%,27m
40098,3,Артём,2221,215,6,6,12,50.0%,22m
40098,1,Mtths,2221,134,6,10,16,37.5%,22m
40098,3,Furyan,2221,198,6,12,18,33.3%,15m
40098,1,letsplayer,2221,236,6,13,19,31.6%,1h
40098,1,Silence,2221,184,5,7,12,41.7%,1h
40098,2,Alex,2221,112,4,2,6,66.7%,1h
40098,2,[Gozoub]DodinouGeek,2221,157,3,4,7,42.9%,17m
40098,1,Serg,2221,84,3,6,9,33.3%,1h
40098,1,Mafo,2221,0,2,7,9,22.2%,30m
40098,2,PROPHET,2221,0,1,0,1,100.0%,30m
40098,2,SocjoŚwir,2221,0,1,2,3,33.3%,1h
40098,2,Lith,2221,96,1,5,6,16.7%,1h
40098,2,Радик,2221,0,1,5,6,16.7%,7m
40098,1,Namele,2221,32,1,7,8,12.5%,1h
40098,2,[Dzikii]Apink,2221,0,0,1,1,0.0%,18m
40122,1,Bukachu,2220,960,49,42,91,53.8%,1h
40122,1,RoyalPurple,2220,975,41,42,83,49.4%,8m
40122,1,Bayesd,2220,949,37,26,63,58.7%,1h
40122,1,Vertrag,2220,1011,34,35,69,49.3%,1h
40122,1,НОКЛЫЧ,2220,662,21,27,48,43.8%,1h
40122,1,ekliptika,2220,674,19,28,47,40.4%,1h
40122,1,Петрович,2220,456,15,16,31,48.4%,1h
40122,2,Zergley,2220,352,13,8,21,61.9%,12m
40122,1,ImmerEssen,2220,364,11,15,26,42.3%,1h
40122,1,Deker,2220,253,10,9,19,52.6%,7m
40122,2,Drathnick,2220,262,9,6,15,60.0%,23m
40122,1,UrNammu,2220,229,9,15,24,37.5%,16m
40122,2,AsiRis,2220,214,8,3,11,72.7%,1h
40122,2,WeedGangGuy,2220,202,6,8,14,42.9%,1h
40122,1,[Newton]newton,2220,240,6,11,17,35.3%,1m
40122,1,Mattyhyde,2220,125,5,8,13,38.5%,2m
40122,1,Pewdiepie,2220,175,4,5,9,44.4%,1h
40122,2,BrainStudio,2220,130,4,5,9,44.4%,3m
40122,1,Somebody,2220,120,4,7,11,36.4%,11m
40122,1,OSCARBLEU,2220,140,3,7,10,30.0%,1h
40122,2,SnowFire,2220,88,2,0,2,100.0%,1h
40122,2,needles,2220,30,2,0,2,100.0%,1h
40122,2,Istvan,2220,58,2,1,3,66.7%,25m
40122,1,Delp,2220,48,2,2,4,50.0%,14m
40122,2,Revane,2220,0,1,0,1,100.0%,1h
40122,1,VaraZZdat,2220,38,1,5,6,16.7%,1h
40122,1,Keller,2220,0,1,6,7,14.3%,1h
40122,2,nsbd,2220,0,0,1,1,0.0%,22m
40122,2,RoGaSapien,2220,0,0,1,1,0.0%,24m
40122,2,PASHOK,2220,0,0,5,5,0.0%,1h
40152,1,Pronzy,2219,1735,201,206,407,49.4%,10m
40152,3,jodlafazema,2219,1372,63,73,136,46.3%,1h
40152,2,Shadowko,2219,1365,55,44,99,55.6%,28m
40152,1,[FanGG]Rusty,2219,1182,45,55,100,45.0%,7m
40152,1,Keddex,2219,665,26,28,54,48.1%,16m
40152,1,Lizardstorm,2219,868,26,29,55,47.3%,30m
40152,1,Eowomakin,2219,558,15,18,33,45.5%,16m
40152,1,Wittano,2219,387,11,13,24,45.8%,1h
40152,2,master,2219,274,10,5,15,66.7%,23m
40152,2,[YLLUMA]Abominus,2219,232,9,5,14,64.3%,31m
40152,2,Povstanets,2219,204,8,4,12,66.7%,1h
40152,2,Zpapaone,2219,208,5,10,15,33.3%,17m
40152,3,[накой]саня,2219,130,4,2,6,66.7%,1h
40152,2,Ketnez,2219,161,4,4,8,50.0%,1h
40152,2,Olezazur,2219,124,4,5,9,44.4%,1h
40152,2,WOZBUHATEL,2219,169,4,8,12,33.3%,18m
40152,1,Rezník,2219,82,3,6,9,33.3%,1h
40152,3,Oskar,2219,30,3,7,10,30.0%,1m
40152,2,Körst,2219,0,1,0,1,100.0%,12m
40152,2,Bobbysox,2219,0,1,1,2,50.0%,1h
40152,2,Elishail,2219,30,1,5,6,16.7%,1h
40152,1,DellDaoLi,2219,42,1,6,7,14.3%,1h
40152,3,Antar,2219,0,0,1,1,0.0%,1h
40152,2,shindlerscat,2219,0,0,2,2,0.0%,1h
40152,2,Peaky,2219,0,0,2,2,0.0%,1h
40152,1,Grisza,2219,0,0,3,3,0.0%,1h
40152,1,Toss,2219,0,0,4,4,0.0%,1h
40152,3,metallimax,2219,0,0,5,5,0.0%,1h
40180,1,Polar,2218,1633,179,179,358,50.0%,4m
40180,1,Goods,2218,1740,149,159,308,48.4%,1h
40180,1,kurtwagnar,2218,1164,98,97,195,50.3%,1h
40180,1,PPC,2218,1328,49,50,99,49.5%,1h
40180,1,moTo,2218,866,48,42,90,53.3%,31m
40180,1,Google,2218,1232,44,50,94,46.8%,28m
40180,1,Valou,2218,1244,42,44,86,48.8%,1h
40180,3,глазктулху,2218,280,11,17,28,39.3%,1h
40180,2,Mingus,2218,316,10,23,33,30.3%,1h
40180,1,Efil,2218,233,8,16,24,33.3%,6m
40180,1,[Heroes]DrBram,2218,219,7,9,16,43.8%,1h
40180,1,Миша,2218,222,6,7,13,46.2%,11m
40180,3,stinnistuð,2218,207,6,11,17,35.3%,17m
40180,2,scoon,2218,140,5,2,7,71.4%,1h
40180,2,BLAD,2218,120,4,4,8,50.0%,21m
40180,2,Polikarpov,2218,64,3,0,3,100.0%,28m
40180,2,Анку,2218,60,3,0,3,100.0%,6m
40180,2,Likeyou,2218,64,3,1,4,75.0%,1h
40180,2,StarshipJoe,2218,98,3,4,7,42.9%,1h
40180,1,Badwolf,2218,116,3,8,11,27.3%,1h
40180,2,RandomRacePH,2218,125,2,3,5,40.0%,1h
40180,3,SAMUPAL,2218,123,2,5,7,28.6%,1h
40180,3,yackerforeve,2218,0,2,10,12,16.7%,1h
40180,3,pantycrapper,2218,0,1,0,1,100.0%,1h
40180,2,Facepalm,2218,30,1,1,2,50.0%,1h
40180,2,drbax,2218,30,1,2,3,33.3%,4m
40180,2,Rezigfan,2218,30,1,2,3,33.3%,10m
40180,2,[Nova11]Justitius,2218,88,1,5,6,16.7%,12m
40180,2,Danila,2218,0,1,5,6,16.7%,1h
40180,1,[6077]SkinnyZerg,2218,0,1,5,6,16.7%,1h
40180,1,Kinsya,2218,0,1,6,7,14.3%,17m
40180,2,yungmulahBUL,2218,0,0,1,1,0.0%,4m
40180,2,karax,2218,0,0,1,1,0.0%,1h
40180,2,Neals,2218,0,0,1,1,0.0%,22m
40180,1,JPiX,2218,0,0,1,1,0.0%,17m
40180,2,Pasajir,2218,0,0,2,2,0.0%,18m
40180,2,LazyTitan,2218,0,0,5,5,0.0%,1h
40217,1,blaf,2217,1339,110,94,204,53.9%,22m
40217,2,ALPHONSE,2217,1078,47,45,92,51.1%,18m
40217,1,Nailthesnail,2217,1055,37,42,79,46.8%,1h
40217,1,ZebbzeN,2217,1044,34,35,69,49.3%,1h
40217,2,plandemia,2217,672,23,24,47,48.9%,1h
40217,2,Wild,2217,577,23,29,52,44.2%,17m
40217,1,Kormorin,2217,512,15,16,31,48.4%,1h
40217,2,[daodao]ramein,2217,260,14,5,19,73.7%,1h
40217,2,Zaurayz,2217,408,13,12,25,52.0%,1h
40217,2,Rain,2217,144,9,5,14,64.3%,1h
40217,1,[БИЗНЕС]VOLKAR,2217,207,5,5,10,50.0%,13m
40217,2,Pyth,2217,87,5,6,11,45.5%,1h
40217,1,ozy,2217,238,5,9,14,35.7%,1h
40217,1,Clarence,2217,88,4,3,7,57.1%,1h
40217,3,Fätze,2217,114,4,7,11,36.4%,23m
40217,1,[4LF]Ancor,2217,48,3,7,10,30.0%,6m
40217,3,Galio,2217,145,3,8,11,27.3%,20m
40217,1,Pedro,2217,173,3,9,12,25.0%,11m
40217,1,Erguden,2217,99,3,9,12,25.0%,22m
40217,1,Banzola,2217,126,3,11,14,21.4%,24m
40217,2,android,2217,30,2,2,4,50.0%,19m
40217,2,Vlados,2217,0,2,3,5,40.0%,22m
40217,2,Scion,2217,68,2,3,5,40.0%,1h
40217,1,RuttenRanny,2217,0,1,2,3,33.3%,1h
40217,2,Stalkan,2217,32,1,3,4,25.0%,32m
40217,1,Громиль,2217,89,1,4,5,20.0%,1h
40217,2,[ViBErs]Marek,2217,0,1,4,5,20.0%,1h
40217,1,HNUM,2217,0,1,5,6,16.7%,1h
40217,1,Etreus,2217,0,1,5,6,16.7%,1h
40217,3,Pff,2217,0,0,1,1,0.0%,14m
40217,1,drunkboy,2217,0,0,2,2,0.0%,1h
40217,2,KUZIA,2217,0,0,2,2,0.0%,1h
40249,1,Blenk,2216,801,123,130,253,48.6%,1h
40249,1,KingCarrot,2216,1661,97,100,197,49.2%,7m
40249,1,[Abrssc]FtwoAClick,2216,1153,96,97,193,49.7%,17m
40249,2,IllIIllIIllI,2216,1590,61,68,129,47.3%,1h
40249,1,Seli,2216,1160,46,43,89,51.7%,1h
40249,1,VIRUCIDES,2216,784,33,31,64,51.6%,22m
40249,2,Troels,2216,745,32,18,50,64.0%,1h
40249,2,[AC2020]Arcanos,2216,645,31,21,52,59.6%,10m
40249,1,EoS,2216,502,14,22,36,38.9%,23m
40249,1,eRalaIII,2216,238,6,12,18,33.3%,4m
40249,1,Merlin,2216,165,5,8,13,38.5%,1h
40249,2,Kerrigan,2216,161,4,2,6,66.7%,1h
40249,1,Kleso,2216,108,4,8,12,33.3%,1h
40249,3,MrMith,2216,109,3,4,7,42.9%,1h
40249,2,Lev,2216,60,2,4,6,33.3%,1h
40249,1,Koks,2216,74,2,6,8,25.0%,1h
40249,1,[SZM]PulverKurt,2216,46,2,7,9,22.2%,11m
40249,1,Van,2216,48,2,7,9,22.2%,29m
40249,2,MasterBam,2216,0,1,0,1,100.0%,1h
40249,2,qiwi,2216,0,1,0,1,100.0%,1h
40249,2,Krishna,2216,30,1,1,2,50.0%,11m
40249,1,FerRemanent,2216,48,1,4,5,20.0%,1h
40249,1,Madrolling,2216,0,1,5,6,16.7%,1h
40249,2,EasyAI,2216,0,0,1,1,0.0%,1h
40249,2,TohishPlay,2216,0,0,1,1,0.0%,24m
40249,1,Zifer,2216,0,0,1,1,0.0%,1m
40249,2,Pol,2216,0,0,2,2,0.0%,1h
40249,2,EggMan,2216,0,0,3,3,0.0%,13m
40249,2,[v1tf]Rubelino,2216,0,0,6,6,0.0%,1h
40249,3,pilotkill,2216,0,0,14,14,0.0%,22m
40279,1,rENtabITch,2215,1674,82,85,167,49.1%,1h
40279,3,foox,2215,1066,71,76,147,48.3%,32m
40279,2,Fedos,2215,1414,64,65,129,49.6%,32m
40279,2,Scientist,2215,1388,53,51,104,51.0%,31m
40279,2,Rouaialex,2215,901,41,27,68,60.3%,31m
40279,2,Halo,2215,850,32,28,60,53.3%,1h
40279,1,Slavon,2215,672,27,36,63,42.9%,16m
40279,2,Spidou,2215,258,10,7,17,58.8%,1h
40279,1,makambuzio,2215,374,10,18,28,35.7%,1h
40279,1,Maxheadroom,2215,242,8,9,17,47.1%,3m
40279,1,dezz,2215,113,4,4,8,50.0%,1h
40279,1,Kannone,2215,144,4,8,12,33.3%,30m
40279,1,Adelmann,2215,114,4,10,14,28.6%,11m
40279,1,swelf,2215,168,4,11,15,26.7%,21m
40279,1,SAN,2215,0,3,3,6,50.0%,28m
40279,3,Karandamon,2215,60,3,7,10,30.0%,1h
40279,2,Trrrrnzzzz,2215,62,2,1,3,66.7%,1h
40279,2,DAN,2215,66,2,1,3,66.7%,12m
40279,2,LEVSHA,2215,0,2,3,5,40.0%,14m
40279,2,Nuno,2215,139,2,6,8,25.0%,26m
40279,2,Wepix,2215,76,2,7,9,22.2%,1h
40279,2,Juankar,2215,0,1,1,2,50.0%,1h
40279,2,Doomkingleo,2215,0,1,1,2,50.0%,12m
40279,1,malurite,2215,0,1,2,3,33.3%,1h
40279,2,[RBP3]KostoF,2215,0,1,2,3,33.3%,1h
40279,1,BattleChris,2215,0,1,5,6,16.7%,7m
40279,2,Patton,2215,0,0,1,1,0.0%,1h
40279,2,Jaite,2215,0,0,2,2,0.0%,13m
40279,2,AurélieN,2215,0,0,3,3,0.0%,1h
40279,2,CaptainRARAA,2215,0,0,5,5,0.0%,1h
40309,3,DannyKiller,2214,1576,249,259,508,49.0%,1h
40309,3,SuperCow,2214,1515,131,138,269,48.7%,15m
40309,1,[clan25]Magidon,2214,1723,83,82,165,50.3%,23m
40309,1,Badmanjam,2214,1610,68,73,141,48.2%,1h
40309,1,abdelfattah,2214,1073,67,67,134,50.0%,1h
40309,2,Light,2214,1078,37,54,91,40.7%,21m
40309,1,Focktor,2214,804,32,33,65,49.2%,1h
40309,1,Rine,2214,518,24,26,50,48.0%,1h
40309,2,lofstraker,2214,572,21,21,42,50.0%,14m
40309,1,BIGJIMMY,2214,622,21,25,46,45.7%,1h
40309,3,Maciek,2214,306,13,17,30,43.3%,12m
40309,3,MAHAX,2214,150,7,12,19,36.8%,6m
40309,2,Kourosh,2214,150,6,6,12,50.0%,10m
40309,3,Mateja,2214,140,6,15,21,28.6%,1h
40309,3,[РСФРС]ZorTuL,2214,148,4,6,10,40.0%,1h
40309,2,Darkblink,2214,0,3,2,5,60.0%,22m
40309,1,Rokiko,2214,116,3,6,9,33.3%,1h
40309,1,anc,2214,136,3,7,10,30.0%,1h
40309,1,Omnislash,2214,116,3,8,11,27.3%,23m
40309,2,Casper,2214,30,2,1,3,66.7%,1h
40309,1,timm,2214,80,2,6,8,25.0%,26m
40309,3,Шкрек,2214,0,2,8,10,20.0%,12m
40309,2,LilyRae,2214,0,1,5,6,16.7%,15m
40309,1,Tasher,2214,44,1,6,7,14.3%,29m
40309,2,Zacharinho,2214,0,0,1,1,0.0%,1h
40309,2,RahmatBAE,2214,0,0,2,2,0.0%,1h
40335,1,Jaskier,2213,1745,140,141,281,49.8%,1h
40335,2,Wortspiel,2213,1224,83,68,151,55.0%,1h
40335,1,Spoutnik,2213,724,47,52,99,47.5%,27m
40335,2,kwas,2213,794,33,24,57,57.9%,1h
40335,3,maxGüeL,2213,583,22,33,55,40.0%,3m
40335,1,alealeks,2213,538,16,20,36,44.4%,1h
40335,2,Snyper,2213,416,14,13,27,51.9%,18m
40335,1,Saybork,2213,332,11,7,18,61.1%,17m
40335,1,[em66]daniel,2213,154,7,15,22,31.8%,1h
40335,2,IIIIIIIIIIII,2213,114,5,2,7,71.4%,22m
40335,3,raynor,2213,183,5,11,16,31.2%,1h
40335,2,DrLector,2213,88,4,1,5,80.0%,1h
40335,2,Toniiio,2213,145,4,3,7,57.1%,1h
40335,2,Burzum,2213,128,4,6,10,40.0%,27m
40335,1,Sokimer,2213,62,4,12,16,25.0%,11m
40335,2,Angel,2213,88,2,1,3,66.7%,1h
40335,1,MadMax,2213,76,2,7,9,22.2%,13m
40335,1,lvil,2213,0,2,7,9,22.2%,1h
40335,2,ИДУФОТОНИТЬ,2213,0,1,1,2,50.0%,1h
40335,2,[LIQUID]Goa,2213,32,1,2,3,33.3%,29m
40335,2,DrunkAccount,2213,0,1,4,5,20.0%,15m
40335,1,Doc,2213,0,1,5,6,16.7%,22m
40335,2,[MC2SC2]emilelechat,2213,0,0,1,1,0.0%,29m
40335,2,xxHarcace,2213,0,0,2,2,0.0%,2m
40359,1,Vallar,2212,1593,94,86,180,52.2%,16m
40359,1,Sekan,2212,1577,79,77,156,50.6%,1h
40359,1,Pascal,2212,1054,34,40,74,45.9%,13m
40359,2,Millenium,2212,255,12,9,21,57.1%,10m
40359,2,Raph,2212,324,11,11,22,50.0%,10m
40359,2,Olegkv,2212,250,10,7,17,58.8%,16m
40359,3,[HZeS]nicci,2212,251,8,13,21,38.1%,1h
40359,1,Bone,2212,141,4,4,8,50.0%,14m
40359,1,[GfG]Bilbo,2212,175,4,6,10,40.0%,1h
40359,2,RobotWizard,2212,116,4,6,10,40.0%,19m
40359,2,Salakis,2212,30,2,0,2,100.0%,28m
40359,2,nayze,2212,30,2,1,3,66.7%,19m
40359,1,silenthorror,2212,42,2,10,12,16.7%,13m
40359,2,ibrahim,2212,0,1,0,1,100.0%,1h
40359,2,Spectr,2212,0,1,1,2,50.0%,8m
40359,2,[Hassa]patrick,2212,48,1,3,4,25.0%,1h
40359,2,Xandral,2212,30,1,3,4,25.0%,1h
40359,2,Shuricat,2212,0,1,6,7,14.3%,1h
40359,2,neoflo,2212,0,0,2,2,0.0%,1h
40359,2,strelok,2212,0,0,2,2,0.0%,30m
40359,2,Сид,2212,0,0,2,2,0.0%,1h
40359,2,[Mel0n]beast,2212,0,0,2,2,0.0%,1h
40359,2,Dominik,2212,0,0,4,4,0.0%,21m
40382,3,lazypig,2211,1528,171,186,357,47.9%,12m
40382,1,Bararide,2211,1324,90,77,167,53.9%,1h
40382,3,Novrex,2211,518,81,94,175,46.3%,4m
40382,1,JAKES,2211,1517,78,76,154,50.6%,18m
40382,2,meem,2211,1476,62,51,113,54.9%,1h
40382,1,Corvinus,2211,1566,57,60,117,48.7%,26m
40382,1,piton,2211,1126,41,41,82,50.0%,30m
40382,1,FoxyRUS,2211,247,33,27,60,55.0%,12m
40382,1,Czochuu,2211,789,25,34,59,42.4%,1h
40382,1,Pretorian,2211,510,23,34,57,40.4%,1h
40382,1,Saytori,2211,714,22,25,47,46.8%,25m
40382,2,kmadhad,2211,444,19,13,32,59.4%,9m
40382,3,Tonic,2211,596,18,28,46,39.1%,1h
40382,1,Duskbringer,2211,357,14,15,29,48.3%,1h
40382,1,RockYou,2211,394,14,23,37,37.8%,27m
40382,2,TIGER,2211,312,11,17,28,39.3%,31m
40382,3,NPC,2211,285,9,13,22,40.9%,1h
40382,2,Askiras,2211,248,8,4,12,66.7%,1h
40382,2,hellacrazy,2211,144,6,3,9,66.7%,1h
40382,2,Barabashka,2211,94,6,4,10,60.0%,1h
40382,2,Dylan,2211,221,6,7,13,46.2%,1h
40382,1,UnHoly,2211,240,6,9,15,40.0%,1h
40382,3,Zeus,2211,168,5,1,6,83.3%,1h
40382,3,TACKLEBERRY,2211,177,5,10,15,33.3%,1h
40382,2,Ramzes,2211,201,4,7,11,36.4%,1h
40382,2,жека,2211,114,3,3,6,50.0%,17m
40382,2,[PаK]Terran,2211,66,2,3,5,40.0%,1h
40382,1,BananchiK,2211,0,2,7,9,22.2%,7m
40382,1,Critly,2211,0,1,3,4,25.0%,10m
40382,2,Lucos,2211,44,1,6,7,14.3%,1h
40382,1,[LOVlaw]CAT,2211,73,1,6,7,14.3%,1h
40382,2,Melperon,2211,0,0,1,1,0.0%,1h
40382,1,mtld,2211,0,0,3,3,0.0%,8m
40382,2,Vano,2211,0,0,5,5,0.0%,1h
40416,1,HASHR,2210,1723,219,210,429,51.0%,18m
40416,1,Berg,2210,1747,123,126,249,49.4%,1h
40416,1,[lK9l]CaseyRyback,2210,1033,83,82,165,50.3%,31m
40416,1,[ATC28]pusztulat,2210,1483,54,48,102,52.9%,1h
40416,2,Karaluch,2210,582,21,18,39,53.8%,30m
40416,2,BlackHole,2210,510,19,15,34,55.9%,9m
40416,1,[NINJ88]Nameless,2210,417,15,17,32,46.9%,1h
40416,1,LeaderUSSR,2210,485,14,16,30,46.7%,1h
40416,1,Halmator,2210,315,13,7,20,65.0%,24m
40416,2,SpookyeManRO,2210,130,5,2,7,71.4%,1h
40416,1,IoIoIoI,2210,135,5,3,8,62.5%,27m
40416,1,ДенАкс,2210,170,5,9,14,35.7%,1h
40416,1,[KOINK]Hykiu,2210,144,4,5,9,44.4%,1m
40416,1,[Arrows]llllllllllll,2210,147,4,5,9,44.4%,13m
40416,1,YalikeJAZZ,2210,140,4,8,12,33.3%,1h
40416,2,ham,2210,38,3,3,6,50.0%,1h
40416,2,[zCCCPz]diedmoon,2210,94,3,3,6,50.0%,30m
40416,2,yuos,2210,111,3,4,7,42.9%,1h
40416,2,Deky,2210,46,3,4,7,42.9%,1h
40416,1,Todbinger,2210,60,3,14,17,17.6%,6m
40416,1,Ourdvuk,2210,48,2,4,6,33.3%,14m
40416,1,Zbychu,2210,80,2,7,9,22.2%,26m
40416,2,[S3ise]Sorin,2210,0,1,0,1,100.0%,3m
40416,2,ClareBear,2210,0,1,0,1,100.0%,13m
40416,2,ЯркийМолот,2210,30,1,1,2,50.0%,28m
40416,2,Griesheimer,2210,0,1,4,5,20.0%,22m
40416,1,BenderTHEred,2210,0,1,6,7,14.3%,24m
40416,1,Acidjunky,2210,0,1,7,8,12.5%,32m
40416,1,VitalAnal,2210,0,0,3,3,0.0%,15m
40416,2,realtor,2210,0,0,5,5,0.0%,1h
40446,1,sergey,2209,1752,205,204,409,50.1%,8m
40446,3,[DTXCL]Rolek,2209,1518,89,82,171,52.0%,24m
40446,1,Koco,2209,1701,86,88,174,49.4%,22m
40446,2,Dramida,2209,600,65,68,133,48.9%,1h
40446,2,kOrsarz,2209,473,48,48,96,50.0%,1h
40446,1,TerranGirl,2209,693,21,23,44,47.7%,32m
40446,1,Woodybush,2209,502,15,24,39,38.5%,8m
40446,2,gorlash,2209,334,12,14,26,46.2%,1h
40446,1,Condor,2209,367,10,13,23,43.5%,27m
40446,2,boots,2209,230,8,7,15,53.3%,1h
40446,1,[VBP]Mozzarella,2209,243,6,7,13,46.2%,1h
40446,1,ŁUSZCZYN,2209,192,6,12,18,33.3%,1h
40446,2,GREEN,2209,122,5,2,7,71.4%,1h
40446,2,LethKharchez,2209,164,5,9,14,35.7%,9m
40446,2,Арка,2209,62,4,10,14,28.6%,1h
40446,2,BayKonsantre,2209,0,3,2,5,60.0%,19m
40446,2,Achilles,2209,0,3,3,6,50.0%,1h
40446,3,TheBOSS,2209,0,3,5,8,37.5%,1h
40446,1,Mugge,2209,30,3,5,8,37.5%,1h
40446,2,frenkmartin,2209,60,2,4,6,33.3%,1h
40446,1,Avramos,2209,0,2,4,6,33.3%,1h
40446,1,[PLDM]Immotion,2209,0,1,0,1,100.0%,3m
40446,2,Twinkie,2209,0,1,0,1,100.0%,28m
40446,2,WingsTV,2209,30,1,2,3,33.3%,17m
40446,2,SCV,2209,34,1,3,4,25.0%,1h
40446,1,WiseKaa,2209,42,1,5,6,16.7%,4m
40446,2,Monoid,2209,0,1,5,6,16.7%,30m
40446,2,MurdoX,2209,0,0,1,1,0.0%,1h
40446,2,DanSamIr,2209,0,0,1,1,0.0%,24m
40446,1,DonPabloRO,2209,0,0,2,2,0.0%,1h
40446,2,Pode,2209,0,0,6,6,0.0%,19m
40477,1,axer,2208,1729,232,240,472,49.2%,8m
40477,2,Spanier,2208,1473,94,95,189,49.7%,29m
40477,1,Epigen,2208,1342,85,85,170,50.0%,1h
40477,1,luminiq,2208,633,69,72,141,48.9%,1h
40477,2,[beaste]Storm,2208,1645,65,65,130,50.0%,30m
40477,2,Arxs,2208,717,30,26,56,53.6%,1h
40477,1,Marekano,2208,402,11,17,28,39.3%,1h
40477,1,Maxximo,2208,334,11,17,28,39.3%,1h
40477,1,sava,2208,296,10,9,19,52.6%,1h
40477,1,irakli,2208,307,10,11,21,47.6%,1h
40477,2,Dimmex,2208,323,10,12,22,45.5%,25m
40477,3,wizard,2208,261,9,5,14,64.3%,1h
40477,1,Kacper,2208,264,7,9,16,43.8%,1h
40477,2,Baiania,2208,166,6,1,7,85.7%,1h
40477,2,mustahsen,2208,116,6,5,11,54.5%,3m
40477,2,malhito,2208,142,5,5,10,50.0%,8m
40477,1,JonasDT,2208,179,5,10,15,33.3%,22m
40477,2,QueenOfCreep,2208,118,4,3,7,57.1%,8m
40477,2,[nuuuuu]MasterSniper,2208,58,2,1,3,66.7%,25m
40477,2,Airen,2208,30,2,2,4,50.0%,1h
40477,2,bifficus,2208,32,2,2,4,50.0%,1h
40477,2,Borsuk,2208,34,2,7,9,22.2%,10m
40477,1,WorkerRush,2208,0,1,0,1,100.0%,1m
40477,2,[НИШТЯК]danytro,2208,46,1,1,2,50.0%,1h
40477,2,Firefly,2208,34,1,1,2,50.0%,1h
40477,2,Alchemist,2208,0,1,1,2,50.0%,1h
40477,2,[SupprM]SupremCC,2208,0,1,4,5,20.0%,1h
40477,2,marcelo,2208,88,1,5,6,16.7%,1h
40477,1,darkiz,2208,96,1,6,7,14.3%,28m
40477,2,MorderKaizer,2208,0,0,2,2,0.0%,22m
40477,2,JOKER,2208,0,0,2,2,0.0%,1h
40477,1,Misha,2208,0,0,4,4,0.0%,1h
40477,2,OliTee,2208,0,0,5,5,0.0%,1h
40477,2,[POLIMI]Contedaz,2208,0,0,5,5,0.0%,1h
40511,1,erty,2207,1721,158,167,325,48.6%,1h
40511,1,adler,2207,1058,132,121,253,52.2%,29m
40511,2,raju,2207,1303,125,114,239,52.3%,1h
40511,2,Bogos,2207,1615,98,100,198,49.5%,13m
40511,1,[CS0]Cineman,2207,1355,74,70,144,51.4%,1h
40511,1,iiieeee,2207,758,44,52,96,45.8%,1h
40511,2,Muhammet,2207,794,32,22,54,59.3%,9m
40511,3,[BZSS]Lazard,2207,810,30,38,68,44.1%,15m
40511,2,Venum,2207,396,14,13,27,51.9%,23m
40511,2,AloneMOON,2207,439,14,18,32,43.8%,19m
40511,1,[firstb]maorlak,2207,486,13,26,39,33.3%,1h
40511,1,Light,2207,368,11,14,25,44.0%,21m
40511,2,BestChampion,2207,274,10,12,22,45.5%,30m
40511,1,CRiMiSoN,2207,298,9,13,22,40.9%,13m
40511,2,Darek,2207,154,8,14,22,36.4%,1h
40511,1,Мощный,2207,263,7,11,18,38.9%,1h
40511,2,VeDen,2207,192,5,2,7,71.4%,1h
40511,2,Вафелька,2207,175,5,9,14,35.7%,25m
40511,2,Zhelan,2207,0,3,3,6,50.0%,1h
40511,1,[Stunt]Sonic,2207,78,3,6,9,33.3%,1h
40511,2,Cvile,2207,142,3,7,10,30.0%,1h
40511,2,TheSupreming,2207,30,2,1,3,66.7%,1h
40511,1,Tomahawk,2207,97,2,6,8,25.0%,16m
40511,1,hulk,2207,97,2,7,9,22.2%,1h
40511,1,Ilija,2207,42,2,7,9,22.2%,1h
40511,3,UNDERLORD,2207,97,2,9,11,18.2%,1h
40511,2,Heredir,2207,0,1,0,1,100.0%,1h
40511,2,sanandi,2207,30,1,1,2,50.0%,30m
40511,2,Dempsei,2207,30,1,4,5,20.0%,4m
40511,1,RRR,2207,0,1,6,7,14.3%,1m
40511,1,Maki,2207,0,1,6,7,14.3%,1h
40511,1,Centurion,2207,91,1,6,7,14.3%,4m
40511,2,MrGreen,2207,0,0,1,1,0.0%,1h
40511,2,Rick,2207,0,0,1,1,0.0%,3m
40511,2,bloodwolff,2207,0,0,1,1,0.0%,1h
40511,1,ЛоЛЛоЛыЧ,2207,0,0,2,2,0.0%,14m
40511,1,Apryto,2207,0,0,2,2,0.0%,1h
40548,1,ALEXEI,2206,1619,170,176,346,49.1%,5m
40548,2,jhfhgdhgfhjg,2206,1384,99,99,198,50.0%,1h
40548,1,LUX,2206,1724,82,79,161,50.9%,1h
40548,2,Martagar,2206,877,72,63,135,53.3%,29m
40548,1,Maxour,2206,1509,55,66,121,45.5%,1h
40548,2,regtemarmot,2206,340,52,65,117,44.4%,1h
40548,3,mseven,2206,388,48,63,111,43.2%,3m
40548,1,sturgeon,2206,812,31,29,60,51.7%,18m
40548,1,tankanza,2206,589,17,26,43,39.5%,1h
40548,1,[VRND]rotemj,2206,256,13,16,29,44.8%,1h
40548,3,Valdor,2206,90,13,21,34,38.2%,3m
40548,2,stargate,2206,212,8,7,15,53.3%,1h
40548,1,[SrFt]Сардар,2206,240,8,12,20,40.0%,1h
40548,2,Halakost,2206,288,6,13,19,31.6%,1h
40548,1,Denezz,2206,190,5,7,12,41.7%,1h
40548,2,Flee,2206,30,2,0,2,100.0%,11m
40548,2,[zukaCo]Ghost,2206,64,2,3,5,40.0%,1h
40548,2,[UF2AC]werus,2206,0,1,0,1,100.0%,1h
40548,2,[PEFEDU]OSCURINATY,2206,34,1,1,2,50.0%,1h
40548,2,[SLPRY]HGbeatnik,2206,0,1,4,5,20.0%,19m
40548,2,lolo,2206,0,1,4,5,20.0%,19m
40548,2,Achilles,2206,94,1,5,6,16.7%,7m
40548,1,[findus]DjoKO,2206,46,1,7,8,12.5%,26m
40548,2,OlezhekGhost,2206,0,0,1,1,0.0%,10m
40548,2,АНДРЕЙ,2206,0,0,1,1,0.0%,19m
40548,1,azazazazazaz,2206,0,0,6,6,0.0%,1h
40574,1,ЦЫГА,2205,1520,157,150,307,51.1%,27m
40574,1,skifgr,2205,1395,98,93,191,51.3%,1h
40574,1,Marcos,2205,1310,60,60,120,50.0%,1h
40574,1,[Crows]cero,2205,1580,53,60,113,46.9%,1h
40574,2,Suobrut,2205,986,36,49,85,42.4%,6m
40574,2,karjuho,2205,882,33,31,64,51.6%,18m
40574,3,Heronas,2205,665,24,36,60,40.0%,10m
40574,2,[Meavv]BNA,2205,588,22,27,49,44.9%,5m
40574,1,Oxwalt,2205,490,15,23,38,39.5%,1h
40574,2,ichich,2205,364,12,27,39,30.8%,1h
40574,1,MarineRush,2205,348,10,14,24,41.7%,1h
40574,1,ericfoissac,2205,344,10,14,24,41.7%,3m
40574,2,jurgen,2205,234,9,13,22,40.9%,1h
40574,1,GazMan,2205,262,8,11,19,42.1%,23m
40574,1,Michseplay,2205,276,8,13,21,38.1%,1h
40574,1,JéjéMG,2205,214,7,11,18,38.9%,1h
40574,1,Dumaghedon,2205,121,3,2,5,60.0%,10m
40574,2,Балмат,2205,90,3,5,8,37.5%,23m
40574,2,Julien,2205,96,3,8,11,27.3%,1h
40574,2,ORZ,2205,38,2,1,3,66.7%,1h
40574,1,kyle,2205,145,2,3,5,40.0%,1h
40574,1,Frutto,2205,97,2,6,8,25.0%,7m
40574,1,onea,2205,0,1,1,2,50.0%,1h
40574,2,РоботКалдун,2205,0,1,5,6,16.7%,18m
40574,2,[75рус]SADRON,2205,0,0,1,1,0.0%,1h
40574,2,[NINJ88]Dako,2205,0,0,1,1,0.0%,1h
40574,2,serg,2205,0,0,2,2,0.0%,9m
40574,2,halker,2205,0,0,2,2,0.0%,30m
40574,3,Cornholio,2205,0,0,5,5,0.0%,10m
40603,2,Aytal,2204,1278,49,48,97,50.5%,31m
40603,3,Qerets,2204,771,26,37,63,41.3%,32m
40603,1,Imre,2204,628,25,31,56,44.6%,29m
40603,2,[PaniC]scnightfire,2204,566,21,19,40,52.5%,26m
40603,1,gongduruo,2204,674,20,29,49,40.8%,26m
40603,1,[ZCrew]ZCGiraffe,2204,533,16,25,41,39.0%,1h
40603,1,Rhotababe,2204,417,11,18,29,37.9%,19m
40603,1,roger,2204,306,10,11,21,47.6%,18m
40603,2,[widma]Kerrigan,2204,269,9,5,14,64.3%,28m
40603,3,sbo,2204,222,7,6,13,53.8%,12m
40603,1,sergei,2204,158,5,7,12,41.7%,1h
40603,2,llucke,2204,100,3,5,8,37.5%,1h
40603,2,scorpion,2204,30,2,2,4,50.0%,12m
40603,1,Keno,2204,96,2,4,6,33.3%,9m
40603,2,[GdTCx]Ladrix,2204,30,2,5,7,28.6%,1h
40603,1,GodStopMe,2204,68,2,8,10,20.0%,1h
40603,2,Shaytan,2204,0,1,0,1,100.0%,1h
40603,2,[PFGC]AnotherNoob,2204,30,1,2,3,33.3%,1h
40603,2,Grizzly,2204,0,1,2,3,33.3%,1h
40603,2,TeffynCream,2204,0,1,5,6,16.7%,24m
40603,2,Bioniclucas,2204,0,0,1,1,0.0%,1h
40603,2,Pejeperro,2204,0,0,2,2,0.0%,1h
40603,2,Nakovv,2204,0,0,2,2,0.0%,18m
40603,2,haNix,2204,0,0,2,2,0.0%,1h
40603,1,lamia,2204,0,0,4,4,0.0%,1h
40628,1,[SkBG]LEOREGGIE,2203,1687,169,173,342,49.4%,16m
40628,2,Pampos,2203,815,40,36,76,52.6%,1h
40628,1,MareanHeheXD,2203,778,37,39,76,48.7%,1h
40628,1,brendan,2203,727,30,29,59,50.8%,10m
40628,1,Adventure,2203,716,23,27,50,46.0%,1h
40628,1,рэпернотми,2203,554,20,21,41,48.8%,1h
40628,1,TOtron,2203,380,12,16,28,42.9%,25m
40628,1,gero,2203,372,10,16,26,38.5%,1h
40628,2,ELCAB,2203,284,9,5,14,64.3%,12m
40628,1,Alphajoker,2203,200,9,16,25,36.0%,24m
40628,2,dharmist,2203,243,7,12,19,36.8%,18m
40628,1,tjdgk,2203,182,5,10,15,33.3%,1h
40628,2,MAY,2203,64,3,2,5,60.0%,28m
40628,1,CAPAX,2203,48,2,0,2,100.0%,1h
40628,2,ZleH,2203,30,2,1,3,66.7%,1h
40628,1,SwarmKing,2203,118,2,4,6,33.3%,6m
40628,1,kirk,2203,84,2,11,13,15.4%,1h
40628,2,Stilgarr,2203,32,1,2,3,33.3%,24m
40628,1,vegetable,2203,0,1,2,3,33.3%,1h
40628,1,[Achtun]Vanya,2203,0,1,2,3,33.3%,30m
40628,1,KillerKyle,2203,0,1,2,3,33.3%,1h
40628,2,salabria,2203,32,1,3,4,25.0%,22m
40628,1,Rebel,2203,0,1,6,7,14.3%,7m
40628,2,romceg,2203,0,0,1,1,0.0%,31m
40628,2,zinky,2203,0,0,1,1,0.0%,1h
40628,2,[ЯlСосу]Mypka,2203,0,0,1,1,0.0%,1h
40628,2,TerRazit,2203,0,0,1,1,0.0%,18m
40628,2,crazhyouse,2203,0,0,2,2,0.0%,1h
40628,1,Archon,2203,0,0,3,3,0.0%,9m
40628,1,Blackratt,2203,0,0,4,4,0.0%,21m
40658,1,SANDR,2202,1668,252,245,497,50.7%,26m
40658,1,BalticOak,2202,1683,134,125,259,51.7%,3m
40658,1,SDS,2202,1659,124,132,256,48.4%,3m
40658,1,[kek34]nega,2202,1463,105,114,219,47.9%,22m
40658,1,APOLLO,2202,1647,80,74,154,51.9%,5m
40658,1,Seyfar,2202,1739,77,81,158,48.7%,1h
40658,1,archVillain,2202,1632,63,66,129,48.8%,4m
40658,1,Dwarf,2202,1142,51,44,95,53.7%,1h
40658,1,ender,2202,808,25,31,56,44.6%,14m
40658,2,темай,2202,542,19,17,36,52.8%,25m
40658,1,winboss,2202,530,16,20,36,44.4%,1h
40658,2,TheLeon,2202,302,12,7,19,63.2%,1h
40658,2,fROSTIesOX,2202,276,12,19,31,38.7%,20m
40658,1,[xxzz]BDIH,2202,430,11,15,26,42.3%,32m
40658,1,Nakhttoter,2202,320,9,16,25,36.0%,1h
40658,1,Turchin,2202,280,8,13,21,38.1%,1h
40658,2,Gladiator,2202,120,4,5,9,44.4%,25m
40658,2,ShredDude,2202,180,4,8,12,33.3%,13m
40658,3,bobannaskali,2202,121,3,0,3,100.0%,1h
40658,2,Sereti,2202,139,2,4,6,33.3%,1h
40658,1,Freezy,2202,80,2,6,8,25.0%,1h
40658,2,wismoo,2202,46,2,7,9,22.2%,1h
40658,2,timdreier,2202,32,1,3,4,25.0%,17m
40658,2,Sebastian,2202,0,0,1,1,0.0%,13m
40658,2,skyh,2202,0,0,1,1,0.0%,1h
40658,2,[русРУС]Владик,2202,0,0,4,4,0.0%,1h
40684,1,Dimst,2201,1349,77,72,149,51.7%,1h
40684,2,bratwurst,2201,622,27,25,52,51.9%,4m
40684,2,Solar,2201,655,24,35,59,40.7%,1h
40684,1,[Cheas]Tuff,2201,746,23,30,53,43.4%,1h
40684,1,Leonard,2201,443,12,16,28,42.9%,31m
40684,2,Syllasie,2201,244,10,10,20,50.0%,10m
40684,3,Maximusarmo,2201,276,9,10,19,47.4%,1h
40684,1,Apollo,2201,312,9,15,24,37.5%,25m
40684,1,Teufelskreis,2201,264,8,11,19,42.1%,11m
40684,1,[asqw]Viktor,2201,264,8,12,20,40.0%,3m
40684,2,baca,2201,227,8,12,20,40.0%,30m
40684,2,thomashop,2201,146,5,3,8,62.5%,1h
40684,2,[NSCW]Качински,2201,128,4,3,7,57.1%,1h
40684,2,Profondbronz,2201,94,4,4,8,50.0%,1h
40684,2,[fFlags]MattyVita,2201,88,3,2,5,60.0%,1h
40684,2,Suigensu,2201,60,3,5,8,37.5%,1h
40684,2,Talon,2201,60,3,8,11,27.3%,28m
40684,2,SaStalker,2201,74,2,2,4,50.0%,27m
40684,1,Aimbro,2201,97,2,7,9,22.2%,1h
40684,1,BadaBadaBoom,2201,96,2,7,9,22.2%,30m
40684,3,Tryzzer,2201,0,2,8,10,20.0%,1h
40684,2,Ithriel,2201,0,1,1,2,50.0%,1h
40684,1,[NS2019]PhoenixNS,2201,48,1,1,2,50.0%,13m
40684,2,Tailtrain,2201,0,1,4,5,20.0%,22m
40684,1,[S06R]kiwiarmand,2201,48,1,5,6,16.7%,8m
40684,2,dikiu,2201,30,1,5,6,16.7%,28m
40684,2,Mightyowl,2201,0,0,1,1,0.0%,1h
40684,2,vulfke,2201,0,0,1,1,0.0%,1h
40684,1,Massy,2201,0,0,2,2,0.0%,5m
40713,1,Mikel,2200,1701,103,111,214,48.1%,1h
40713,2,nonick,2200,1511,94,94,188,50.0%,17m
40713,1,Yerusalem,2200,644,53,47,100,53.0%,1h
40713,1,Alex,2200,550,42,36,78,53.8%,23m
40713,1,Fama,2200,1042,36,37,73,49.3%,1h
40713,2,Адмирал,2200,490,34,21,55,61.8%,1h
40713,1,Roujizi,2200,725,33,33,66,50.0%,1h
40713,2,Corner,2200,596,21,24,45,46.7%,1h
40713,1,SilverHaze,2200,405,19,21,40,47.5%,26m
40713,3,Pentax,2200,420,14,18,32,43.8%,1h
40713,1,Gorthrax,2200,359,12,16,28,42.9%,3m
40713,3,Kusuluka,2200,276,8,13,21,38.1%,31m
40713,2,PsyKita,2200,249,8,15,23,34.8%,25m
40713,2,nasum,2200,174,7,6,13,53.8%,26m
40713,2,CousinViolet,2200,156,5,8,13,38.5%,1h
40713,2,[kahvel]Wookie,2200,104,3,1,4,75.0%,1h
40713,1,[ETF]Francogian,2200,155,3,6,9,33.3%,23m
40713,1,[late]Süchtling,2200,48,3,7,10,30.0%,16m
40713,3,Febrelost,2200,58,3,8,11,27.3%,1h
40713,2,ImBlue,2200,30,2,2,4,50.0%,1h
40713,2,[Erle]mostwanted,2200,0,1,0,1,100.0%,31m
40713,2,Spacemarine,2200,30,1,1,2,50.0%,1h
40713,2,EarlGT,2200,30,1,2,3,33.3%,13m
40713,2,Nagval,2200,0,1,2,3,33.3%,1h
40713,1,Steelkenny,2200,0,1,6,7,14.3%,4m
40713,2,Doru,2200,0,0,1,1,0.0%,19m
40713,2,[HASTER]EvenFast,2200,0,0,2,2,0.0%,11m
40713,2,CIZO,2200,0,0,5,5,0.0%,1h
40713,1,EiTiRu,2200,0,0,7,7,0.0%,8m
40742,1,BARBATRUK,2199,1737,174,186,360,48.3%,31m
40742,1,DeadLenin,2199,898,27,37,64,42.2%,1h
40742,3,Araelf,2199,674,25,34,59,42.4%,1h
40742,1,JonnyD,2199,635,23,29,52,44.2%,16m
40742,1,edward,2199,742,22,29,51,43.1%,1h
40742,2,Ciceron,2199,378,17,9,26,65.4%,1h
40742,2,[GIMIK]Buczek,2199,426,16,15,31,51.6%,1h
40742,1,Alex,2199,361,12,17,29,41.4%,1h
40742,1,Rodzynek,2199,298,9,15,24,37.5%,13m
40742,2,[TExGG]Brink,2199,212,8,7,15,53.3%,3m
40742,2,QUEPO,2199,164,6,4,10,60.0%,1h
40742,2,Kurec,2199,172,6,4,10,60.0%,4m
40742,1,BaRcOdE,2199,212,6,8,14,42.9%,1h
40742,2,SleepyBoar,2199,217,5,1,6,83.3%,10m
40742,1,[NINJ88]iliyanpetrov,2199,195,4,11,15,26.7%,13m
40742,2,Eldoritto,2199,60,3,1,4,75.0%,3m
40742,3,[PLA2N]KingConsole,2199,30,2,1,3,66.7%,15m
40742,2,superkelle,2199,60,2,5,7,28.6%,29m
40742,1,LevelUP,2199,40,2,7,9,22.2%,1h
40742,1,XRay,2199,36,2,7,9,22.2%,14m
40742,2,IRuinYouNow,2199,0,1,0,1,100.0%,31m
40742,2,patriots,2199,97,1,6,7,14.3%,27m
40742,1,DeadShoT,2199,0,1,6,7,14.3%,30m
40742,2,mostak,2199,0,0,1,1,0.0%,1h
40742,2,Favst,2199,0,0,1,1,0.0%,1h
40742,1,LemanRuss,2199,0,0,1,1,0.0%,5m
40742,2,Adachi,2199,0,0,6,6,0.0%,1h
40769,1,tigorv,2198,1718,133,143,276,48.2%,1h
40769,2,Dew,2198,1174,113,103,216,52.3%,23m
40769,2,KomandoPilon,2198,1039,56,69,125,44.8%,19m
40769,1,emeralder,2198,963,36,37,73,49.3%,1h
40769,1,[GOLDPL]Lancelot,2198,716,30,29,59,50.8%,1h
40769,1,mavo,2198,522,23,36,59,39.0%,21m
40769,1,[Zhig]Starc,2198,614,21,20,41,51.2%,1h
40769,2,DocLolo,2198,508,18,15,33,54.5%,19m
40769,2,Hell,2198,494,18,16,34,52.9%,27m
40769,2,EmperorGG,2198,360,12,7,19,63.2%,30m
40769,3,Olf,2198,308,12,19,31,38.7%,6m
40769,2,DaryanLynch,2198,234,9,7,16,56.2%,1h
40769,2,[ELFDM]Littleplum,2198,272,9,7,16,56.2%,12m
40769,3,PinkyPanda,2198,242,8,11,19,42.1%,6m
40769,3,Zunder,2198,265,8,12,20,40.0%,7m
40769,1,scatman,2198,270,7,15,22,31.8%,11m
40769,2,Chezs,2198,191,6,2,8,75.0%,1h
40769,2,PeaceNLove,2198,150,6,6,12,50.0%,1h
40769,1,Marcelcrack,2198,192,5,12,17,29.4%,1h
40769,2,Chuzhik,2198,88,4,1,5,80.0%,24m
40769,1,Spodah,2198,187,4,6,10,40.0%,14m
40769,1,Инквизитор,2198,160,4,6,10,40.0%,29m
40769,2,InFlame,2198,113,3,3,6,50.0%,1h
40769,3,Dany,2198,0,2,8,10,20.0%,1h
40769,2,Вершитель,2198,34,2,8,10,20.0%,32m
40769,1,Bladerunner,2198,97,2,8,10,20.0%,23m
40769,2,Veroci,2198,0,1,0,1,100.0%,1h
40769,2,alisandro,2198,0,1,1,2,50.0%,32m
40769,1,Kartofelek,2198,0,1,1,2,50.0%,1h
40769,2,RomanRd,2198,0,1,4,5,20.0%,21m
40769,2,SaFiR,2198,88,1,5,6,16.7%,18m
40769,1,[GR0V]Jolitourax,2198,0,1,6,7,14.3%,1h
40769,1,qsen,2198,0,1,6,7,14.3%,29m
40769,2,Zeradadich,2198,0,0,1,1,0.0%,1h
40769,2,Artemis,2198,0,0,1,1,0.0%,1h
40769,2,LEV,2198,0,0,2,2,0.0%,26m
40805,1,moyubaojia,2197,1747,186,186,372,50.0%,1h
40805,2,[OmDi]yuraxa,2197,1540,108,101,209,51.7%,1h
40805,2,maximepmr,2197,826,100,92,192,52.1%,1h
40805,1,Aleks,2197,1651,89,95,184,48.4%,31m
40805,2,diable,2197,1279,46,45,91,50.5%,29m
40805,2,trastar,2197,1109,44,45,89,49.4%,1h
40805,2,GrMagister,2197,633,29,27,56,51.8%,11m
40805,1,deligan,2197,845,26,35,61,42.6%,26m
40805,2,Aisolon,2197,582,22,27,49,44.9%,29m
40805,1,[SPAINs]FeniX,2197,476,20,26,46,43.5%,6m
40805,2,Goody,2197,290,17,11,28,60.7%,17m
40805,2,rabiot,2197,304,12,14,26,46.2%,28m
40805,2,inzhenerD,2197,356,11,8,19,57.9%,1h
40805,1,Doxxx,2197,307,10,9,19,52.6%,5m
40805,1,BigBoyKaz,2197,197,7,6,13,53.8%,21m
40805,2,GFG,2197,172,6,5,11,54.5%,13m
40805,1,Virruss,2197,126,4,3,7,57.1%,29m
40805,2,CRUSADOR,2197,60,2,3,5,40.0%,1h
40805,2,[FMG]SgtShake,2197,0,1,0,1,100.0%,1h
40805,2,[Ihanri]Егор,2197,0,1,0,1,100.0%,18m
40805,2,DRLulu,2197,0,1,0,1,100.0%,1h
40805,2,Welovitz,2197,0,1,0,1,100.0%,19m
40805,2,[357mag]benek,2197,30,1,2,3,33.3%,23m
40805,2,DENIS,2197,32,1,2,3,33.3%,1h
40805,2,Blaarslaai,2197,32,1,2,3,33.3%,11m
40805,2,Лохнемамонт,2197,0,1,4,5,20.0%,1h
40805,2,PapiChulo,2197,0,1,4,5,20.0%,31m
40805,2,Yaroslav,2197,97,1,6,7,14.3%,1h
40805,2,keivan,2197,0,1,6,7,14.3%,1h
40805,2,[batPT]Daxter,2197,0,0,1,1,0.0%,27m
40805,2,ClementR,2197,0,0,1,1,0.0%,18m
40805,2,аларак,2197,0,0,1,1,0.0%,1h
40805,2,[Аtomic]Данька,2197,0,0,1,1,0.0%,23m
40805,1,Lukas,2197,0,0,2,2,0.0%,1h
40805,2,Zoltan,2197,0,0,5,5,0.0%,1h
40805,1,Esexe,2197,0,0,6,6,0.0%,31m
40841,3,[N2OB]BALDUR,2196,1478,161,167,328,49.1%,23m
40841,1,WildWold,2196,1577,109,116,225,48.4%,32m
40841,1,AkretUA,2196,1633,86,83,169,50.9%,1h
40841,2,Leszczu,2196,1385,64,44,108,59.3%,22m
40841,1,kotkirik,2196,684,21,22,43,48.8%,1h
40841,1,[CHOPAA]serega,2196,413,20,20,40,50.0%,1h
40841,2,Faterboy,2196,273,10,15,25,40.0%,1h
40841,3,Veta,2196,265,9,6,15,60.0%,1h
40841,1,kamax,2196,290,9,14,23,39.1%,10m
40841,1,LilButtDaddy,2196,226,7,13,20,35.0%,11m
40841,2,Matt,2196,128,5,0,5,100.0%,1h
40841,1,NightKnight,2196,178,5,4,9,55.6%,1h
40841,1,[FR1]Banba,2196,106,5,4,9,55.6%,1h
40841,1,Diamant,2196,120,3,2,5,60.0%,29m
40841,2,BbIDP,2196,92,3,5,8,37.5%,5m
40841,2,Волк,2196,58,2,2,4,50.0%,25m
40841,2,Batlakruta,2196,62,2,5,7,28.6%,10m
40841,2,LanaFiriat,2196,0,1,6,7,14.3%,1h
40841,2,kelahcim,2196,0,0,3,3,0.0%,1h
40860,1,KamiKafre,2195,1653,349,354,703,49.6%,28m
40860,3,Deo,2195,1338,258,270,528,48.9%,3m
40860,1,Rog,2195,1708,206,217,423,48.7%,1h
40860,1,Killdozer,2195,1620,115,115,230,50.0%,1h
40860,2,Picard,2195,1583,86,87,173,49.7%,1h
40860,1,[ODISO]Granité,2195,974,37,42,79,46.8%,4m
40860,1,Ghost,2195,992,30,37,67,44.8%,25m
40860,2,[LSsc2]Genata,2195,524,19,23,42,45.2%,31m
40860,2,[FSTM]FireStar,2195,472,17,14,31,54.8%,22m
40860,1,ZioSav,2195,288,17,25,42,40.5%,19m
40860,2,pppppppppppp,2195,400,15,18,33,45.5%,20m
40860,1,BookerDewitt,2195,224,9,18,27,33.3%,1h
40860,1,Marvel,2195,172,8,10,18,44.4%,27m
40860,1,Veldinar,2195,311,8,12,20,40.0%,29m
40860,1,Cality,2195,60,6,7,13,46.2%,12m
40860,1,HavocDog,2195,218,6,10,16,37.5%,1h
40860,1,Winkii,2195,208,5,13,18,27.8%,1h
40860,2,Protoxin,2195,48,4,5,9,44.4%,27m
40860,2,Gandi,2195,62,3,3,6,50.0%,1h
40860,3,Ganeto,2195,40,3,10,13,23.1%,1h
40860,2,IKA,2195,0,1,1,2,50.0%,1h
40860,2,[ADLN]AlexDelete,2195,0,1,2,3,33.3%,13m
40860,2,[DPS]Jawrk,2195,0,1,5,6,16.7%,1h
40860,2,Kvazar,2195,94,1,5,6,16.7%,27m
40860,3,StarDada,2195,0,1,6,7,14.3%,1h
40860,2,Ric,2195,0,0,1,1,0.0%,3m
40860,2,NenoZ,2195,0,0,2,2,0.0%,22m
40860,2,[TPONCH]krooz,2195,0,0,3,3,0.0%,11m
40860,1,[SEI]vicvic,2195,0,0,6,6,0.0%,1h
40889,1,jayjajayjajy,2194,1702,113,117,230,49.1%,1h
40889,1,Patronis,2194,1717,113,117,230,49.1%,1h
40889,1,Kirily,2194,1614,101,100,201,50.2%,28m
40889,2,[EliteX]Peti,2194,1174,47,44,91,51.6%,17m
40889,2,dragonlord,2194,981,38,30,68,55.9%,29m
40889,2,Cykron,2194,850,34,35,69,49.3%,29m
40889,2,Lixus,2194,876,33,28,61,54.1%,23m
40889,1,[InitRu]kinim,2194,609,27,18,45,60.0%,1h
40889,3,BabaAndante,2194,501,27,44,71,38.0%,10m
40889,1,ananasoed,2194,441,15,24,39,38.5%,1h
40889,2,[Fever]Xerta,2194,354,12,16,28,42.9%,1h
40889,1,[Bould]Crambu,2194,474,12,16,28,42.9%,31m
40889,2,MJX,2194,292,10,10,20,50.0%,1h
40889,2,[STF71]Raspop,2194,311,10,16,26,38.5%,1h
40889,1,RuFFF,2194,258,9,9,18,50.0%,1h
40889,1,Madnek,2194,132,6,6,12,50.0%,14m
40889,1,Devil,2194,261,6,11,17,35.3%,1h
40889,2,raymondbty,2194,116,4,5,9,44.4%,1h
40889,2,Berg,2194,97,4,6,10,40.0%,13m
40889,1,AlanWolker,2194,48,2,1,3,66.7%,1h
40889,1,Zokkanir,2194,74,2,11,13,15.4%,1h
40889,2,Ostmann,2194,0,1,0,1,100.0%,1h
40889,2,ShadoW,2194,0,1,1,2,50.0%,18m
40889,2,OneWolf,2194,0,1,2,3,33.3%,1h
40889,3,Morlokki,2194,30,1,2,3,33.3%,1h
40889,2,PoisonIvy,2194,0,0,3,3,0.0%,1h
40889,2,Hadgehog,2194,0,0,5,5,0.0%,1h
40916,1,blond,2193,1560,780,807,1587,49.1%,9m
40916,3,ANTON,2193,1303,281,278,559,50.3%,32m
40916,1,Bob,2193,1716,234,236,470,49.8%,31m
40916,1,ммммкккккккк,2193,1470,171,175,346,49.4%,1h
40916,1,muk,2193,1400,96,77,173,55.5%,1h
40916,1,Snake,2193,1551,62,68,130,47.7%,1h
40916,3,PuPsik,2193,1459,51,65,116,44.0%,22m
40916,1,Boro,2193,835,39,42,81,48.1%,8m
40916,1,minameispapa,2193,930,32,36,68,47.1%,1h
40916,2,Dragment,2193,546,23,17,40,57.5%,9m
40916,2,EnDOrFIncHIC,2193,548,20,21,41,48.8%,20m
40916,2,ptflea,2193,325,13,16,29,44.8%,6m
40916,2,Cqgyerek,2193,304,12,12,24,50.0%,19m
40916,2,alpha,2193,251,10,8,18,55.6%,1h
40916,2,Ravenlord,2193,264,10,9,19,52.6%,9m
40916,2,Marcus,2193,114,4,1,5,80.0%,20m
40916,1,CookieMonstr,2193,158,4,9,13,30.8%,21m
40916,1,Wolf,2193,96,3,9,12,25.0%,14m
40916,2,ukuROCK,2193,62,2,5,7,28.6%,13m
40916,3,[PLA2N]Medvedev,2193,0,1,0,1,100.0%,25m
40916,1,Acto,2193,0,1,1,2,50.0%,7m
40916,2,Ravi,2193,0,1,3,4,25.0%,1h
40916,1,Maasie,2193,0,1,4,5,20.0%,1h
40916,2,hemibaba,2193,0,1,4,5,20.0%,1h
40916,2,albrecht,2193,0,1,5,6,16.7%,16m
40916,1,krabs,2193,0,1,6,7,14.3%,26m
40916,2,Bernstroem,2193,0,0,1,1,0.0%,1h
40916,2,Segelfourfun,2193,0,0,1,1,0.0%,3m
40916,2,[Сold]спартазерга,2193,0,0,1,1,0.0%,1h
40916,2,Payday,2193,0,0,2,2,0.0%,3m
40946,1,todor,2192,1687,101,108,209,48.3%,1h
40946,2,Miky,2192,907,48,48,96,50.0%,1h
40946,2,Drab,2192,1010,44,31,75,58.7%,18m
40946,3,Demyan,2192,556,22,27,49,44.9%,28m
40946,2,Arshia,2192,399,16,17,33,48.5%,1h
40946,3,roatch,2192,463,15,23,38,39.5%,18m
40946,1,meanmachine,2192,353,11,11,22,50.0%,1h
40946,1,lithidious,2192,361,11,13,24,45.8%,31m
40946,1,[mfixed]KUBICEq,2192,366,10,15,25,40.0%,7m
40946,1,KubuDrinker,2192,40,4,7,11,36.4%,5m
40946,1,TaldeeR,2192,221,4,10,14,28.6%,14m
40946,2,fdh,2192,62,3,2,5,60.0%,1h
40946,2,Reve,2192,30,2,0,2,100.0%,20m
40946,1,Трогваар,2192,102,2,4,6,33.3%,1h
40946,2,Malo,2192,0,1,0,1,100.0%,11m
40946,2,Azirog,2192,32,1,2,3,33.3%,21m
40946,2,MarxNotDead,2192,0,1,4,5,20.0%,28m
40946,2,[ANTIQ]Wargaf,2192,32,1,5,6,16.7%,3m
40946,1,Gigggi,2192,0,1,6,7,14.3%,1h
40946,1,LiQuIDNoX,2192,0,1,6,7,14.3%,1h
40946,2,[NorthG]Jodyhateyou,2192,0,0,1,1,0.0%,22m
40946,2,LeCailloux,2192,0,0,1,1,0.0%,1h
40946,2,[PÂRłAH]KUMI,2192,0,0,1,1,0.0%,18m
40946,2,Valladares,2192,0,0,1,1,0.0%,1h
40946,2,RushMonster,2192,0,0,2,2,0.0%,20m
40946,2,[Nxv]Deceive,2192,0,0,2,2,0.0%,1h
40946,1,PietGer,2192,0,0,4,4,0.0%,8m
40973,1,RedPikachu,2191,1723,88,83,171,51.5%,1h
40973,1,Lee,2191,1693,76,72,148,51.4%,1h
40973,1,[ForAut]severk,2191,875,47,47,94,50.0%,1h
40973,1,thorius,2191,1033,33,40,73,45.2%,2m
40973,2,Komar,2191,702,25,24,49,51.0%,1h
40973,1,guigui,2191,792,24,35,59,40.7%,1h
40973,2,buha,2191,310,19,18,37,51.4%,23m
40973,1,BKay,2191,622,18,27,45,40.0%,27m
40973,1,Schnuddel,2191,423,14,22,36,38.9%,19m
40973,2,[ПКЛПО]RussianCat,2191,360,13,13,26,50.0%,29m
40973,2,Maze,2191,236,9,7,16,56.2%,1h
40973,2,renji,2191,204,7,8,15,46.7%,1h
40973,2,Hazamun,2191,92,5,4,9,55.6%,26m
40973,2,Dodel,2191,57,5,5,10,50.0%,13m
40973,2,[NeCriN]Emigrabass,2191,68,3,4,7,42.9%,12m
40973,2,DmitryCravt,2191,102,3,5,8,37.5%,32m
40973,2,Numitor,2191,32,1,4,5,20.0%,1h
40973,2,Avocadonis,2191,0,1,4,5,20.0%,1h
40973,1,LéDovahkiin,2191,0,1,5,6,16.7%,1h
40973,3,Sly,2191,0,1,7,8,12.5%,32m
40973,2,öälüähiöönüp,2191,0,0,1,1,0.0%,12m
40973,2,lurstarck,2191,0,0,1,1,0.0%,10m
40973,2,[2AMC]saifalhosni,2191,0,0,1,1,0.0%,13m
40973,2,[SibOPG]SiberianOPG,2191,0,0,2,2,0.0%,3m
40973,2,DavidE,2191,0,0,5,5,0.0%,27m
40998,1,Maiq,2190,1698,179,195,374,47.9%,1h
40998,1,[CxCx]karakancolos,2190,1687,177,171,348,50.9%,1h
40998,1,SuperKiap,2190,1196,39,44,83,47.0%,13m
40998,2,Akavir,2190,281,20,21,41,48.8%,21m
40998,2,MrGoodbars,2190,400,14,17,31,45.2%,9m
40998,2,Konstwnst,2190,364,13,13,26,50.0%,1h
40998,1,pelle,2190,329,10,13,23,43.5%,1h
40998,2,rrr,2190,241,9,1,10,90.0%,1h
40998,3,Sir,2190,281,9,14,23,39.1%,1h
40998,3,XAM,2190,260,7,11,18,38.9%,9m
40998,3,MGalactic,2190,141,7,14,21,33.3%,1h
40998,2,Niafront,2190,86,4,1,5,80.0%,1h
40998,1,Innocent,2190,34,4,6,10,40.0%,1h
40998,2,Kelvincomrat,2190,58,3,0,3,100.0%,1h
40998,1,Алексей,2190,144,3,3,6,50.0%,24m
40998,1,HooCee,2190,126,3,5,8,37.5%,1h
40998,1,Rafas,2190,121,3,7,10,30.0%,1h
40998,1,dinerlo,2190,122,3,8,11,27.3%,31m
40998,1,Tarmacshrimp,2190,90,2,2,4,50.0%,1h
40998,2,Erenet,2190,0,2,4,6,33.3%,7m
40998,2,Cilgal,2190,60,2,4,6,33.3%,10m
40998,2,Gnidus,2190,0,1,0,1,100.0%,2m
40998,2,xZKx,2190,0,1,1,2,50.0%,1h
40998,2,[Dytred]kiwifruit,2190,30,1,3,4,25.0%,28m
40998,2,Skarvid,2190,0,1,5,6,16.7%,10m
40998,2,HONZA,2190,44,1,6,7,14.3%,10m
40998,1,[BdPǂ]Giumbolizer,2190,97,1,9,10,10.0%,3m
40998,1,iNji,2190,0,0,2,2,0.0%,26m
40998,1,Corrious,2190,0,0,2,2,0.0%,1h
40998,2,calmstork,2190,0,0,3,3,0.0%,1h
40998,2,Shadowtonny,2190,0,0,5,5,0.0%,1h
40998,1,Tuubi,2190,0,0,6,6,0.0%,22m
41030,1,Qlex,2189,1318,76,86,162,46.9%,1h
41030,2,laurent,2189,1616,72,69,141,51.1%,1h
41030,1,Xandr,2189,1066,43,39,82,52.4%,31m
41030,2,[BWArmy]IIIIIIII,2189,914,40,30,70,57.1%,1h
41030,2,chaotix,2189,990,35,37,72,48.6%,1h
41030,1,KridgiGames,2189,639,33,45,78,42.3%,28m
41030,1,[Hammer]Balaur,2189,810,28,25,53,52.8%,1h
41030,1,wernexper,2189,742,26,28,54,48.1%,10m
41030,1,KraKeN,2189,650,21,26,47,44.7%,7m
41030,1,Femex,2189,559,20,28,48,41.7%,1h
41030,1,Achille,2189,481,15,22,37,40.5%,2m
41030,2,Viridovics,2189,358,14,13,27,51.9%,1h
41030,2,Siecinianin,2189,404,14,16,30,46.7%,12m
41030,2,[G4VR]Sardzilla,2189,224,8,7,15,53.3%,17m
41030,2,Matoriv,2189,170,5,12,17,29.4%,28m
41030,3,xyzcharger,2189,149,3,5,8,37.5%,1h
41030,1,Starpav,2189,97,2,0,2,100.0%,10m
41030,2,Jedi,2189,0,2,1,3,66.7%,1h
41030,2,Kookadu,2189,68,2,3,5,40.0%,1h
41030,1,Kreso,2189,0,1,0,1,100.0%,17m
41030,2,Ulric,2189,0,0,2,2,0.0%,3m
41051,1,luni,2188,1527,194,195,389,49.9%,1h
41051,1,orujo,2188,1198,74,69,143,51.7%,1h
41051,1,joOIDA,2188,1143,38,44,82,46.3%,1h
41051,1,ПАН,2188,646,21,24,45,46.7%,1h
41051,2,Tepa,2188,427,19,15,34,55.9%,1h
41051,1,Chinzilla,2188,549,19,22,41,46.3%,22m
41051,2,[FDAY]Cryllax,2188,388,13,19,32,40.6%,5m
41051,1,xXDimka,2188,232,9,7,16,56.2%,1h
41051,3,VneMoraly,2188,269,8,12,20,40.0%,9m
41051,1,[J4E]Snehulko,2188,250,7,11,18,38.9%,19m
41051,2,Strangeman,2188,116,4,2,6,66.7%,1h
41051,2,Pawel,2188,122,4,7,11,36.4%,3m
41051,1,kdsep,2188,76,3,8,11,27.3%,5m
41051,1,Fanis,2188,84,3,8,11,27.3%,7m
41051,1,HeavyDeath,2188,96,3,9,12,25.0%,1h
41051,1,[KCDQ]BakaKiller,2188,90,3,10,13,23.1%,10m
41051,2,ToPoirrot,2188,30,2,0,2,100.0%,1h
41051,2,Salami,2188,131,2,1,3,66.7%,1h
41051,1,Banjo,2188,96,2,6,8,25.0%,5m
41051,1,OrkaOrk,2188,103,2,7,9,22.2%,7m
41051,1,Dysfunction,2188,48,2,7,9,22.2%,16m
41051,3,wintik,2188,30,2,8,10,20.0%,1h
41051,2,KingCrash,2188,0,1,0,1,100.0%,1h
41051,2,gogo,2188,0,1,0,1,100.0%,16m
41051,2,[VALET]ERETIK,2188,30,1,1,2,50.0%,1h
41051,2,JIeB,2188,0,1,1,2,50.0%,1h
41051,1,lyxx,2188,0,1,3,4,25.0%,7m
41051,2,SilentSword,2188,0,1,6,7,14.3%,1h
41051,2,[VGSC]Jakhals,2188,0,0,1,1,0.0%,20m
41051,1,Тару,2188,0,0,1,1,0.0%,4m
41051,2,Nedug,2188,0,0,2,2,0.0%,1h
41051,2,Basilisk,2188,0,0,2,2,0.0%,1h
41051,2,Sadek,2188,0,0,3,3,0.0%,26m
41051,2,[iR3B]VeskZ,2188,0,0,3,3,0.0%,1h
41051,3,Stylker,2188,0,0,3,3,0.0%,12m
41086,1,LAPKA,2187,1587,168,173,341,49.3%,2m
41086,2,Friendly,2187,1665,138,149,287,48.1%,1h
41086,1,[OЗД]AnimesKun,2187,910,33,42,75,44.0%,1h
41086,2,Rakanishyu,2187,668,28,27,55,50.9%,1h
41086,2,JebanyFiltr,2187,314,11,10,21,52.4%,30m
41086,2,Lenny,2187,281,11,16,27,40.7%,1h
41086,2,MrWallytof,2187,254,10,7,17,58.8%,1h
41086,2,[holki]Madle,2187,259,9,5,14,64.3%,1h
41086,1,ALien,2187,318,9,11,20,45.0%,1h
41086,1,cynepnaxa,2187,306,9,25,34,26.5%,32m
41086,1,RedMeat,2187,336,8,12,20,40.0%,9m
41086,2,[Chariz]chrZZ,2187,118,5,4,9,55.6%,1h
41086,1,Obichan,2187,192,5,10,15,33.3%,13m
41086,1,kostek,2187,142,5,11,16,31.2%,31m
41086,1,ридик,2187,158,4,10,14,28.6%,1h
41086,2,teramus,2187,30,2,2,4,50.0%,1h
41086,2,BobMarley,2187,0,2,5,7,28.6%,1h
41086,2,[L3oS]SKiillerKEK,2187,0,1,0,1,100.0%,1h
41086,2,linkz,2187,0,1,0,1,100.0%,27m
41086,2,Militium,2187,0,1,5,6,16.7%,21m
41086,1,capadonna,2187,0,1,6,7,14.3%,30m
41086,2,[RPTeam]ToxicStray,2187,0,0,1,1,0.0%,1h
41086,1,holdeFee,2187,0,0,2,2,0.0%,1h
41086,2,Legion,2187,0,0,3,3,0.0%,32m
41110,2,Rixi,2186,1646,200,199,399,50.1%,12m
41110,1,Волкодав,2186,1564,100,92,192,52.1%,1h
41110,2,ISubMarinerI,2186,1213,47,41,88,53.4%,26m
41110,1,Kelstman,2186,1196,44,41,85,51.8%,17m
41110,1,Simpl,2186,874,28,34,62,45.2%,28m
41110,1,MovieStar,2186,654,27,30,57,47.4%,7m
41110,2,[NoVin]Vakidos,2186,465,26,21,47,55.3%,1h
41110,2,azerty,2186,458,19,9,28,67.9%,27m
41110,1,Mrakobes,2186,632,19,26,45,42.2%,30m
41110,1,Ricky,2186,398,12,17,29,41.4%,1h
41110,2,Starfish,2186,197,11,11,22,50.0%,14m
41110,2,[Кон]Valses,2186,291,10,11,21,47.6%,19m
41110,3,Klervy,2186,151,6,12,18,33.3%,20m
41110,1,laurer,2186,144,5,7,12,41.7%,1h
41110,2,rolodex,2186,124,4,4,8,50.0%,1h
41110,1,Ascet,2186,132,4,6,10,40.0%,1h
41110,1,FriedCheese,2186,108,4,7,11,36.4%,1h
41110,3,Smoyker,2186,123,3,2,5,60.0%,27m
41110,3,REX,2186,89,3,4,7,42.9%,1h
41110,2,Korzhik,2186,0,2,0,2,100.0%,29m
41110,2,[4267]Montyhuhn,2186,30,2,1,3,66.7%,24m
41110,2,ilanki,2186,138,2,2,4,50.0%,1h
41110,1,[R4Time]Alisher,2186,119,2,4,6,33.3%,24m
41110,1,laguz,2186,102,2,6,8,25.0%,1h
41110,1,UnknownHero,2186,96,2,7,9,22.2%,2m
41110,1,Paffnut,2186,97,1,3,4,25.0%,22m
41110,2,piko,2186,0,0,1,1,0.0%,1h
41110,2,sergeiminsky,2186,0,0,1,1,0.0%,1h
41110,1,[SRF]bounes,2186,0,0,2,2,0.0%,1h
41110,2,Maniaplayer,2186,0,0,4,4,0.0%,31m
41110,2,[DISW]Duriel,2186,0,0,5,5,0.0%,1h
41141,3,Sequent,2185,1507,242,239,481,50.3%,6m
41141,2,MAINBEAT,2185,1634,229,236,465,49.2%,30m
41141,1,ZEVS,2185,1666,115,113,228,50.4%,28m
41141,1,TitAn,2185,1034,96,94,190,50.5%,1h
41141,1,Volkano,2185,1507,90,100,190,47.4%,1h
41141,2,Ivan,2185,1354,81,78,159,50.9%,1h
41141,1,Andronmaghe,2185,1479,60,66,126,47.6%,31m
41141,2,orel,2185,1454,55,60,115,47.8%,1h
41141,1,[EMCs]TomTom,2185,937,37,35,72,51.4%,30m
41141,2,DavidK,2185,992,37,38,75,49.3%,1h
41141,1,Dominion,2185,943,35,31,66,53.0%,30m
41141,1,[Сold]Fix,2185,1066,35,41,76,46.1%,23m
41141,3,PAVELUK,2185,503,30,41,71,42.3%,27m
41141,1,[3A]Хищник,2185,422,13,18,31,41.9%,27m
41141,2,Behlulefendi,2185,308,11,8,19,57.9%,1h
41141,1,Lumiel,2185,137,10,7,17,58.8%,1h
41141,1,kolibriuke,2185,310,10,12,22,45.5%,1h
41141,1,[AiRǂ]Citrus,2185,316,10,20,30,33.3%,7m
41141,2,poliulitan,2185,238,9,8,17,52.9%,9m
41141,2,Yannick,2185,224,7,5,12,58.3%,29m
41141,2,ten,2185,272,7,10,17,41.2%,26m
41141,2,Adjutant,2185,192,4,13,17,23.5%,9m
41141,2,[ØC]Noxylum,2185,60,3,4,7,42.9%,31m
41141,1,Niitra,2185,96,3,5,8,37.5%,6m
41141,2,BreakPunk,2185,0,2,3,5,40.0%,13m
41141,3,redriver,2185,95,2,8,10,20.0%,1m
41141,1,Anarchus,2185,44,2,8,10,20.0%,27m
41141,3,Loosing,2185,30,2,10,12,16.7%,1h
41141,2,[12345S]АРТЁМКА,2185,0,1,0,1,100.0%,1h
41141,2,Real,2185,0,1,0,1,100.0%,1h
41141,2,Cheburek,2185,30,1,2,3,33.3%,1h
41141,2,light,2185,30,1,3,4,25.0%,1h
41141,2,FILIN,2185,0,1,5,6,16.7%,24m
41141,2,[II3II]DIMONpRo,2185,0,0,1,1,0.0%,27m
41141,2,SilverActive,2185,0,0,1,1,0.0%,1h
41141,2,Tapadókorong,2185,0,0,1,1,0.0%,1h
41141,2,Adveturerr,2185,0,0,2,2,0.0%,19m
41141,2,Shewornadze,2185,0,0,4,4,0.0%,3m
41141,2,GERION,2185,0,0,5,5,0.0%,1h
41180,1,Cedric,2184,1743,126,129,255,49.4%,1h
41180,1,aurelambroz,2184,1156,97,114,211,46.0%,1h
41180,1,Sam,2184,1224,89,98,187,47.6%,4m
41180,2,OlgaSchwanz,2184,923,56,61,117,47.9%,23m
41180,1,narkoteq,2184,1029,53,54,107,49.5%,1h
41180,2,TheGammie,2184,703,30,28,58,51.7%,1h
41180,3,SuliaSan,2184,521,19,30,49,38.8%,17m
41180,2,ToughKnight,2184,456,15,17,32,46.9%,1h
41180,3,BobG,2184,410,15,26,41,36.6%,1h
41180,3,Blonde,2184,113,14,23,37,37.8%,1h
41180,2,Snuskprutt,2184,122,5,3,8,62.5%,1h
41180,1,TÜRKİŞPOWER,2184,72,5,5,10,50.0%,16m
41180,2,PATAFON,2184,96,3,5,8,37.5%,1h
41180,2,YakPanther,2184,60,2,3,5,40.0%,15m
41180,2,PruegelPaul,2184,36,2,4,6,33.3%,1h
41180,2,ehgaming,2184,32,1,2,3,33.3%,12m
41180,2,SASHA,2184,0,0,1,1,0.0%,1h
41197,1,chema,2183,1720,856,910,1766,48.5%,1h
41197,3,Igord,2183,1499,244,238,482,50.6%,11m
41197,1,Madi,2183,1467,93,94,187,49.7%,8m
41197,1,Thor,2183,1146,82,78,160,51.2%,19m
41197,1,SteinerX,2183,1412,47,60,107,43.9%,1h
41197,3,Aether,2183,1075,39,42,81,48.1%,1h
41197,2,Lynx,2183,411,34,36,70,48.6%,1h
41197,2,Roas,2183,676,32,21,53,60.4%,17m
41197,2,[AiRǂ]ATHOR,2183,752,26,31,57,45.6%,1h
41197,2,Przerax,2183,464,17,18,35,48.6%,19m
41197,2,xMerkulx,2183,466,16,17,33,48.5%,31m
41197,1,[DzMob]Idea,2183,326,8,19,27,29.6%,22m
41197,1,[EYQTPI]Dincht,2183,167,7,7,14,50.0%,1m
41197,1,[guppi]SKW,2183,250,7,14,21,33.3%,24m
41197,1,pampadores,2183,137,4,7,11,36.4%,7m
41197,1,celmer,2183,148,4,9,13,30.8%,1h
41197,3,Toxic,2183,60,4,10,14,28.6%,23m
41197,3,[RuCrew]iloveyourmom,2183,123,3,3,6,50.0%,1h
41197,3,Сашок,2183,121,3,9,12,25.0%,1h
41197,2,[Batia]papirusk,2183,0,2,2,4,50.0%,1h
41197,2,[Zguege]cockieland,2183,32,2,3,5,40.0%,19m
41197,1,vkkkk,2183,84,2,9,11,18.2%,1h
41197,2,Heznzu,2183,44,1,2,3,33.3%,1h
41197,1,Wazaaaaaaaaa,2183,48,1,5,6,16.7%,7m
41197,1,Olsen,2183,0,1,6,7,14.3%,1h
41197,2,Xaira,2183,0,0,1,1,0.0%,4m
41197,2,[SlowG]OGKush,2183,0,0,1,1,0.0%,1h
41197,2,ClojureDev,2183,0,0,1,1,0.0%,32m
41197,2,Svinopres,2183,0,0,1,1,0.0%,32m
41197,2,WannaCry,2183,0,0,1,1,0.0%,27m
41197,2,[proto3]shrek,2183,0,0,1,1,0.0%,1h
41197,2,Henrique,2183,0,0,1,1,0.0%,13m
41197,2,Maksim,2183,0,0,1,1,0.0%,10m
41197,1,[59APM]Cepera,2183,0,0,3,3,0.0%,30m
41197,2,ДайКачество,2183,0,0,4,4,0.0%,1h
41197,2,Криг,2183,0,0,5,5,0.0%,13m
41233,2,SanktMartin,2182,902,39,29,68,57.4%,1h
41233,1,Farenheit,2182,683,39,31,70,55.7%,13m
41233,2,UnderGround,2182,752,30,30,60,50.0%,1h
41233,1,Farse,2182,576,21,19,40,52.5%,1h
41233,2,Viennus,2182,353,21,22,43,48.8%,10m
41233,2,[KBai]FermerMEN,2182,307,12,6,18,66.7%,4m
41233,2,JazzMan,2182,381,11,12,23,47.8%,1h
41233,2,Leandrito,2182,263,9,8,17,52.9%,28m
41233,1,CuRuBa,2182,213,6,9,15,40.0%,16m
41233,2,GOHAR,2182,0,3,2,5,60.0%,9m
41233,1,Iain,2182,32,2,7,9,22.2%,28m
41233,1,WanLoo,2182,0,1,1,2,50.0%,1h
41233,2,ADVOKAT,2182,46,1,5,6,16.7%,1h
41233,2,niganwer,2182,0,1,5,6,16.7%,27m
41233,2,Maaks,2182,30,1,5,6,16.7%,31m
41233,1,StreLock,2182,0,1,6,7,14.3%,30m
41233,2,[CtE]snigel,2182,0,0,1,1,0.0%,1h
41233,2,arkhamrambo,2182,0,0,1,1,0.0%,1h
41233,2,[SCCZ]Thak,2182,0,0,1,1,0.0%,1h
41233,1,Sandro,2182,0,0,1,1,0.0%,15m
41233,2,[Kunu]warriorYTB,2182,0,0,1,1,0.0%,31m
41233,2,MrNice,2182,0,0,2,2,0.0%,1h
41233,1,Barsilion,2182,0,0,3,3,0.0%,1h
41256,2,sirl,2181,1619,289,295,584,49.5%,1h
41256,1,Illospillos,2181,1653,110,106,216,50.9%,12m
41256,1,Remake,2181,1422,104,85,189,55.0%,10m
41256,2,respiner,2181,1534,77,79,156,49.4%,24m
41256,1,zadrotyarik,2181,881,63,54,117,53.8%,29m
41256,2,Tyfoon,2181,439,17,13,30,56.7%,19m
41256,1,Devil,2181,386,12,20,32,37.5%,1h
41256,2,[DJ3]Vegeta,2181,294,11,10,21,52.4%,15m
41256,2,[run]maddoctor,2181,310,10,13,23,43.5%,32m
41256,1,Shved,2181,366,10,17,27,37.0%,8m
41256,2,Serdjo,2181,234,8,2,10,80.0%,21m
41256,2,Robin,2181,110,6,14,20,30.0%,27m
41256,2,Nikolai,2181,118,5,8,13,38.5%,20m
41256,2,Servus,2181,92,5,12,17,29.4%,1h
41256,2,bratik,2181,168,4,9,13,30.8%,1h
41256,1,[Pastor]edgalduuuuu,2181,136,4,10,14,28.6%,1h
41256,2,Jagoda,2181,30,3,3,6,50.0%,13m
41256,2,HOSENKRIEGER,2181,60,2,2,4,50.0%,1h
41256,1,[CLMOB]Hodor,2181,97,2,7,9,22.2%,5m
41256,1,Ghenya,2181,0,1,0,1,100.0%,9m
41256,2,[Z3RG7V]Злой,2181,30,1,2,3,33.3%,27m
41256,2,Ultimatule,2181,32,1,3,4,25.0%,1h
41256,2,Aleksey,2181,0,1,4,5,20.0%,26m
41256,2,[22asw1]BENIS,2181,0,0,1,1,0.0%,26m
41256,2,Kratos,2181,0,0,2,2,0.0%,1h
41256,2,Nachokun,2181,0,0,2,2,0.0%,1h
41256,2,DerKeks,2181,0,0,2,2,0.0%,15m
41256,1,EdeMos,2181,0,0,4,4,0.0%,1h
41284,1,Eniac,2180,755,32,56,88,36.4%,28m
41284,2,CorOhNoooh,2180,486,17,20,37,45.9%,21m
41284,2,daemon,2180,336,13,9,22,59.1%,5m
41284,2,HHRaw,2180,337,12,16,28,42.9%,1h
41284,3,Mito,2180,307,11,10,21,52.4%,1h
41284,3,НКРмаппер,2180,233,9,12,21,42.9%,1h
41284,2,[RеG]MaximiliaN,2180,337,9,14,23,39.1%,1h
41284,1,Nath,2180,170,8,6,14,57.1%,1m
41284,2,sandi,2180,186,7,6,13,53.8%,1h
41284,3,Leonid,2180,209,6,14,20,30.0%,1h
41284,1,Jourdonnais,2180,150,5,4,9,55.6%,1h
41284,2,[GGVPD]Bud,2180,62,3,4,7,42.9%,28m
41284,3,Gversace,2180,121,3,12,15,20.0%,17m
41284,1,luxepower,2180,110,2,7,9,22.2%,1h
41284,2,[Pxyool]MSK,2180,46,1,1,2,50.0%,1h
41284,2,Manuelusgra,2180,0,1,1,2,50.0%,1h
41284,3,Player,2180,97,1,3,4,25.0%,1h
41284,2,MarComX,2180,0,0,2,2,0.0%,1h
41284,1,Darkchrille,2180,0,0,2,2,0.0%,4m
41284,1,Ichi,2180,0,0,4,4,0.0%,1h
41304,2,ColTrain,2179,1581,80,80,160,50.0%,20m
41304,1,PlacerAc,2179,1177,49,61,110,44.5%,1h
41304,1,Txuster,2179,895,42,41,83,50.6%,1h
41304,2,Ellimac,2179,825,35,27,62,56.5%,17m
41304,2,Jalp,2179,710,31,26,57,54.4%,32m
41304,2,Sergebozz,2179,742,28,22,50,56.0%,14m
41304,3,Munchies,2179,663,27,31,58,46.6%,27m
41304,1,Maple,2179,656,25,28,53,47.2%,5m
41304,1,NEEDALIGHT,2179,739,24,23,47,51.1%,23m
41304,2,Totowipeout,2179,487,17,19,36,47.2%,1h
41304,1,Foreach,2179,465,16,18,34,47.1%,1h
41304,1,[13Rätt]Virkler,2179,398,11,17,28,39.3%,32m
41304,2,Hestetyven,2179,294,10,6,16,62.5%,1h
41304,2,maddin,2179,174,6,6,12,50.0%,17m
41304,2,TRkadir,2179,120,5,3,8,62.5%,10m
41304,1,dreamer,2179,223,5,10,15,33.3%,3m
41304,1,Ximik,2179,159,4,8,12,33.3%,9m
41304,2,[PSSZ]doofanshmirt,2179,64,3,2,5,60.0%,1h
41304,2,[SRKY]alsibiate,2179,30,2,1,3,66.7%,9m
41304,2,Fabien,2179,58,2,4,6,33.3%,12m
41304,2,MANDONIO,2179,34,2,4,6,33.3%,12m
41304,1,Mike,2179,38,2,9,11,18.2%,21m
41304,2,[PioD]UnGer,2179,88,2,9,11,18.2%,32m
41304,1,NeroBlood,2179,88,1,2,3,33.3%,1h
41304,2,[krdo]Soulseeker,2179,73,1,3,4,25.0%,1h
41304,1,SpaceMarine,2179,0,1,6,7,14.3%,1h
41330,3,Левый,2178,898,65,68,133,48.9%,22m
41330,2,laborantkata,2178,1408,63,53,116,54.3%,1h
41330,2,ocococ,2178,643,25,20,45,55.6%,26m
41330,1,blackjack,2178,399,17,26,43,39.5%,1h
41330,1,[TULEN]samurakavkaz,2178,408,15,14,29,51.7%,1h
41330,2,Spider,2178,146,6,6,12,50.0%,1h
41330,1,ricardor,2178,184,5,13,18,27.8%,8m
41330,2,jas,2178,0,3,2,5,60.0%,1h
41330,1,Jimtrenor,2178,78,3,6,9,33.3%,31m
41330,2,[k1raen]ALISHER,2178,32,2,0,2,100.0%,1h
41330,2,WINTER,2178,30,2,1,3,66.7%,14m
41330,2,wodzu,2178,30,2,3,5,40.0%,17m
41330,2,Araneus,2178,0,2,3,5,40.0%,13m
41330,2,[ATOMS]gzzz,2178,88,1,1,2,50.0%,28m
41330,2,[AL0E]Chrystl,2178,34,1,2,3,33.3%,30m
41330,1,Wakido,2178,48,1,3,4,25.0%,1h
41330,2,Sugarcult,2178,0,1,4,5,20.0%,1h
41330,1,Ozooo,2178,0,1,6,7,14.3%,1h
41330,1,mcabe,2178,0,0,4,4,0.0%,2m
41330,2,Halysard,2178,0,0,4,4,0.0%,1h
41330,2,pvh,2178,0,0,5,5,0.0%,1h
41351,2,Raven,2177,1138,83,91,174,47.7%,1h
41351,1,[ŞỮҜǺ]ĘĿvįŖḀ,2177,1341,56,64,120,46.7%,32m
41351,3,matrash,2177,1205,45,51,96,46.9%,6m
41351,2,Terminator,2177,816,32,30,62,51.6%,19m
41351,2,Zoe,2177,758,31,24,55,56.4%,1h
41351,1,starmen,2177,525,20,25,45,44.4%,1h
41351,2,Empresslilyy,2177,350,13,13,26,50.0%,1h
41351,2,mrfox,2177,159,11,9,20,55.0%,1h
41351,1,ilo,2177,318,10,15,25,40.0%,15m
41351,2,ZeroQube,2177,250,9,4,13,69.2%,1h
41351,2,[1DTOA]ilya,2177,260,8,12,20,40.0%,1h
41351,2,ChapperSRI,2177,203,7,3,10,70.0%,19m
41351,1,[BoBF]MiniMart,2177,222,7,15,22,31.8%,1h
41351,2,wml,2177,170,6,2,8,75.0%,1h
41351,3,SHBJR,2177,207,5,10,15,33.3%,7m
41351,2,antoine,2177,134,4,5,9,44.4%,24m
41351,1,Чех,2177,110,4,7,11,36.4%,1h
41351,2,[TCC974]MisterVahiné,2177,34,2,1,3,66.7%,24m
41351,2,Bellwoman,2177,0,2,3,5,40.0%,3m
41351,1,PrivateLow,2177,82,2,5,7,28.6%,3m
41351,2,Skuall,2177,62,2,5,7,28.6%,4m
41351,1,Ioan,2177,42,2,7,9,22.2%,1h
41351,2,[PÂRłAH]VevercakCZ,2177,0,1,1,2,50.0%,23m
41351,1,Raptor,2177,97,1,1,2,50.0%,2m
41351,1,ClodPupon,2177,34,1,6,7,14.3%,1h
41351,2,[РАЙ]Freedom,2177,0,0,1,1,0.0%,1h
41351,3,[Пот]Asermora,2177,0,0,1,1,0.0%,1h
41351,2,Martin,2177,0,0,1,1,0.0%,29m
41351,1,SleepyHead,2177,0,0,6,6,0.0%,1h
41351,1,[SURV]Arkos,2177,0,0,6,6,0.0%,1h
41381,1,Yim,2176,1515,213,221,434,49.1%,1h
41381,3,XYHTA,2176,1532,134,139,273,49.1%,2m
41381,1,MIGNOLA,2176,1702,92,106,198,46.5%,26m
41381,2,[II3II]Ozoun,2176,1180,62,60,122,50.8%,1h
41381,1,Genesequasss,2176,1522,51,57,108,47.2%,1h
41381,2,BurebistaEu,2176,366,21,4,25,84.0%,1h
41381,1,[mfxed]Adamoz,2176,617,21,23,44,47.7%,1h
41381,2,Бурбон,2176,290,18,10,28,64.3%,11m
41381,2,Clay,2176,389,15,18,33,45.5%,1h
41381,2,Pettersony,2176,212,7,8,15,46.7%,1h
41381,1,RassadnikoV,2176,243,7,10,17,41.2%,1h
41381,2,Mans,2176,214,6,5,11,54.5%,1h
41381,1,Zotmund,2176,192,6,6,12,50.0%,32m
41381,1,Flitsmeiser,2176,132,6,8,14,42.9%,1h
41381,2,Evgi,2176,160,4,1,5,80.0%,27m
41381,2,[HsZ]xSweeperx,2176,130,4,7,11,36.4%,21m
41381,2,AlexSchelvis,2176,138,4,9,13,30.8%,1h
41381,1,Rockeskyll,2176,108,4,9,13,30.8%,1h
41381,1,ZeroG,2176,192,4,10,14,28.6%,1h
41381,2,Axefighter,2176,92,3,6,9,33.3%,1h
41381,3,MetalGod,2176,169,3,8,11,27.3%,29m
41381,1,Träskpaddan,2176,48,3,9,12,25.0%,1h
41381,1,Griboed,2176,102,3,14,17,17.6%,1h
41381,1,lokofunk,2176,48,2,4,6,33.3%,1h
41381,2,erews,2176,30,2,5,7,28.6%,19m
41381,3,Hovi,2176,0,2,7,9,22.2%,24m
41381,2,Alexp,2176,0,1,0,1,100.0%,1h
41381,2,darklink,2176,0,1,0,1,100.0%,2m
41381,2,cheg,2176,30,1,1,2,50.0%,32m
41381,2,lewie,2176,46,1,2,3,33.3%,1h
41381,2,Morcoveata,2176,30,1,6,7,14.3%,29m
41381,2,Mane,2176,95,1,6,7,14.3%,26m
41381,1,Imperija,2176,0,1,6,7,14.3%,1h
41381,1,mithiades,2176,38,1,10,11,9.1%,1h
41381,2,NymaNo,2176,0,0,1,1,0.0%,1h
41381,2,misterp,2176,0,0,1,1,0.0%,1h
41381,2,Nediog,2176,0,0,1,1,0.0%,1h
41381,2,ragequit,2176,0,0,3,3,0.0%,1h
41381,1,Dark,2176,0,0,5,5,0.0%,17m
41420,2,kufargery,2175,1641,216,220,436,49.5%,1h
41420,2,Blümchen,2175,1434,178,186,364,48.9%,1h
41420,1,Frags,2175,1657,110,125,235,46.8%,11m
41420,2,Vizor,2175,1550,102,97,199,51.3%,1h
41420,2,ElGringo,2175,702,27,25,52,51.9%,29m
41420,2,lillofix,2175,588,21,21,42,50.0%,1h
41420,2,Flowachild,2175,352,14,7,21,66.7%,1h
41420,2,МАКСигркас,2175,318,12,9,21,57.1%,21m
41420,1,Nataly,2175,248,10,12,22,45.5%,1h
41420,2,MisterSweet,2175,196,8,4,12,66.7%,27m
41420,2,SpokI,2175,230,8,13,21,38.1%,19m
41420,2,ДраконТеней,2175,178,8,15,23,34.8%,17m
41420,3,Thorn,2175,198,6,13,19,31.6%,1h
41420,1,danul,2175,141,4,6,10,40.0%,31m
41420,2,wes,2175,92,3,3,6,50.0%,1h
41420,1,sheinweng,2175,0,3,6,9,33.3%,5m
41420,1,[SaGo]Atyrus,2175,48,2,7,9,22.2%,17m
41420,1,Sans,2175,0,1,0,1,100.0%,13m
41420,2,Тасвлисан,2175,0,1,0,1,100.0%,1h
41420,2,puzo,2175,30,1,3,4,25.0%,1h
41420,2,[Z3RG7V]Delbros,2175,0,1,4,5,20.0%,1h
41420,2,Apøphis,2175,0,0,5,5,0.0%,1h
41420,1,DONAZ,2175,0,0,6,6,0.0%,1h
41443,1,[nosexx]BrokenAss,2174,952,208,205,413,50.4%,1h
41443,2,[D0N3]yamahandrea,2174,1605,100,100,200,50.0%,1h
41443,3,zloyBOBER,2174,981,67,78,145,46.2%,1h
41443,2,MARKUS,2174,1638,66,68,134,49.3%,12m
41443,1,Eva,2174,885,37,35,72,51.4%,1h
41443,1,Davange,2174,627,24,32,56,42.9%,1h
41443,2,jebaks,2174,518,20,15,35,57.1%,1h
41443,1,Sparta,2174,548,19,22,41,46.3%,1h
41443,3,Rafert,2174,535,19,31,50,38.0%,23m
41443,2,[fackme]борода,2174,484,18,16,34,52.9%,1h
41443,1,MiniMaxi,2174,629,17,25,42,40.5%,1h
41443,1,Artem,2174,550,16,22,38,42.1%,1h
41443,1,vanLudo,2174,484,15,23,38,39.5%,30m
41443,2,Legatee,2174,479,14,16,30,46.7%,1h
41443,2,Dmail,2174,304,13,7,20,65.0%,14m
41443,2,[Kosh]CharlesX,2174,274,11,8,19,57.9%,1h
41443,1,Murphy,2174,348,9,17,26,34.6%,7m
41443,2,MAXIMYS,2174,136,5,1,6,83.3%,15m
41443,1,Jonathan,2174,239,5,7,12,41.7%,9m
41443,2,ARYEN,2174,158,5,10,15,33.3%,1h
41443,2,Kelvin,2174,138,5,12,17,29.4%,25m
41443,1,[beebop]Bloubi,2174,176,5,13,18,27.8%,23m
41443,2,TheCoon,2174,106,4,7,11,36.4%,1h
41443,1,YOUEN,2174,144,4,11,15,26.7%,28m
41443,1,elbufa,2174,89,3,5,8,37.5%,32m
41443,2,Maksimioi,2174,92,3,6,9,33.3%,10m
41443,2,Lukason,2174,102,3,8,11,27.3%,24m
41443,2,rPj,2174,58,2,7,9,22.2%,1h
41443,2,Vladimir,2174,92,1,1,2,50.0%,19m
41443,1,Raiden,2174,0,1,3,4,25.0%,7m
41443,1,GoHo,2174,0,1,5,6,16.7%,1h
41443,1,sanek,2174,0,1,6,7,14.3%,2m
41443,1,Marco,2174,0,1,6,7,14.3%,13m
41443,2,Dimon,2174,0,0,1,1,0.0%,1h
41443,2,CosmicBanna,2174,0,0,1,1,0.0%,1h
41443,2,resident,2174,0,0,2,2,0.0%,30m
41443,2,Heotke,2174,0,0,2,2,0.0%,13m
41443,1,Spolonic,2174,0,0,2,2,0.0%,9m
41443,2,Aleksandar,2174,0,0,3,3,0.0%,1h
41482,1,TheCrow,2173,1587,87,93,180,48.3%,31m
41482,2,drak,2173,1566,75,76,151,49.7%,1h
41482,1,temnotorax,2173,1397,71,69,140,50.7%,31m
41482,1,[Petrиs]nenesjc,2173,1166,46,42,88,52.3%,3m
41482,1,astraninza,2173,1046,34,41,75,45.3%,23m
41482,2,Dawid,2173,681,28,25,53,52.8%,23m
41482,2,[ProbKA]kasik,2173,650,26,19,45,57.8%,23m
41482,2,Zealot,2173,500,20,13,33,60.6%,1h
41482,2,GOB,2173,255,10,15,25,40.0%,1h
41482,2,Xantos,2173,208,8,6,14,57.1%,1h
41482,1,SDanny,2173,261,8,15,23,34.8%,24m
41482,2,Lauwie,2173,236,7,5,12,58.3%,1h
41482,1,BodyaRA,2173,100,7,7,14,50.0%,2m
41482,2,LuckyPig,2173,178,5,1,6,83.3%,11m
41482,2,[KoWo]Henning,2173,161,3,5,8,37.5%,1h
41482,2,MGJTERRAN,2173,184,3,7,10,30.0%,1h
41482,3,JeanClaude,2173,36,3,11,14,21.4%,18m
41482,2,[ALOBRE]Giganthrax,2173,38,2,6,8,25.0%,1h
41482,3,MaRsO,2173,0,2,11,13,15.4%,25m
41482,2,TiTo,2173,0,1,1,2,50.0%,25m
41482,2,JustEugene,2173,0,1,1,2,50.0%,17m
41482,1,[Silius]Leisterford,2173,0,1,6,7,14.3%,1h
41482,1,nikoskar,2173,0,1,7,8,12.5%,1h
41482,2,drwoswaa,2173,0,0,1,1,0.0%,1h
41482,1,BrotherGunny,2173,0,0,1,1,0.0%,1h
41482,2,Alderun,2173,0,0,2,2,0.0%,30m
41482,2,[VoiDTS]HeatedDragon,2173,0,0,5,5,0.0%,1h
41509,1,Slaintje,2172,1714,222,225,447,49.7%,2m
41509,1,Keav,2172,1389,73,64,137,53.3%,31m
41509,1,Reddi,2172,1141,60,61,121,49.6%,1h
41509,2,[FGEsc]WhoCares,2172,564,48,50,98,49.0%,1h
41509,2,JoDalton,2172,974,45,46,91,49.5%,1h
41509,2,Samuel,2172,984,43,32,75,57.3%,27m
41509,2,loicmidy,2172,587,40,41,81,49.4%,24m
41509,2,Duncan,2172,628,35,32,67,52.2%,1h
41509,1,parabeumknl,2172,690,24,32,56,42.9%,1h
41509,1,Uplinkk,2172,640,20,24,44,45.5%,22m
41509,1,[Teror]GreeD,2172,599,19,22,41,46.3%,1h
41509,2,DarkTurtle,2172,432,17,12,29,58.6%,1h
41509,2,momoh,2172,502,17,23,40,42.5%,31m
41509,1,Bullet,2172,344,14,12,26,53.8%,1h
41509,2,Allowman,2172,338,13,19,32,40.6%,33m
41509,1,[PROSTA]ГрандАдмирал,2172,326,12,7,19,63.2%,1h
41509,2,[псина]АндрейПёс,2172,268,10,7,17,58.8%,1h
41509,2,Elias,2172,141,8,8,16,50.0%,1h
41509,2,Croutonbobo,2172,245,7,9,16,43.8%,3m
41509,1,Фродо,2172,254,7,12,19,36.8%,1h
41509,3,Misha,2172,126,6,15,21,28.6%,16m
41509,2,[CyTron]LikeyourcutG,2172,170,5,4,9,55.6%,1h
41509,1,[RBlood]Epyks,2172,116,4,13,17,23.5%,1h
41509,2,[PrTons]kelesha,2172,90,3,5,8,37.5%,1h
41509,1,[MOLON]CFreeman,2172,0,2,8,10,20.0%,1h
41509,2,[BuRaGe]Silverhawk,2172,0,1,2,3,33.3%,23m
41509,2,Ingwarr,2172,30,1,2,3,33.3%,1h
41509,2,Oshim,2172,30,1,3,4,25.0%,1h
41509,2,Ryuk,2172,32,1,3,4,25.0%,14m
41509,1,Pretoriano,2172,38,1,4,5,20.0%,5m
41509,2,RoiHeenok,2172,0,0,1,1,0.0%,1h
41509,2,Pipin,2172,0,0,2,2,0.0%,1h
41509,3,lepsy,2172,0,0,5,5,0.0%,1h
41542,1,[OSB98]GOODMAN,2171,1629,184,179,363,50.7%,1h
41542,1,Ataraxic,2171,1639,82,75,157,52.2%,1h
41542,1,pavuch,2171,1428,55,52,107,51.4%,1h
41542,1,Txejoski,2171,1226,42,48,90,46.7%,24m
41542,1,BohdanFreedo,2171,577,30,28,58,51.7%,12m
41542,2,ptiden,2171,625,24,18,42,57.1%,1h
41542,2,Reno,2171,592,23,32,55,41.8%,1h
41542,1,Zoomeek,2171,187,18,27,45,40.0%,1h
41542,1,Craytos,2171,163,14,15,29,48.3%,1h
41542,1,CsakTerran,2171,173,14,17,31,45.2%,23m
41542,1,[АРМАДА]доминат,2171,331,11,22,33,33.3%,1h
41542,2,Baltazar,2171,208,10,4,14,71.4%,4m
41542,2,Speedster,2171,258,10,9,19,52.6%,11m
41542,1,[607]НИКИТА,2171,271,8,11,19,42.1%,1h
41542,2,[ZЕRGML]antonslah,2171,214,7,1,8,87.5%,1h
41542,2,куськумыс,2171,174,5,2,7,71.4%,1h
41542,2,AlexeyMega,2171,140,3,2,5,60.0%,32m
41542,2,ido,2171,0,3,2,5,60.0%,8m
41542,2,PoProstu,2171,92,3,5,8,37.5%,14m
41542,2,Andrra,2171,100,3,6,9,33.3%,1h
41542,2,summeraxel,2171,0,1,0,1,100.0%,1h
41542,2,Зигрейн,2171,32,1,1,2,50.0%,1h
41542,2,MightyBeast,2171,30,1,2,3,33.3%,1h
41542,2,Jaidan,2171,48,1,2,3,33.3%,1h
41542,2,Shockwave,2171,0,1,5,6,16.7%,27m
41542,2,Draki,2171,46,1,6,7,14.3%,1h
41542,2,TheNorweigan,2171,46,1,6,7,14.3%,13m
41542,2,[AiRǂ]Mick,2171,0,0,1,1,0.0%,1h
41542,2,[BasTep]GRANDmasTer,2171,0,0,1,1,0.0%,1h
41542,1,BlooM,2171,0,0,1,1,0.0%,1h
41542,2,Fuu,2171,0,0,2,2,0.0%,4m
41542,2,Anorak,2171,0,0,2,2,0.0%,1h
41574,1,neuch,2170,1555,205,217,422,48.6%,24m
41574,1,Monkey,2170,1434,201,279,480,41.9%,32m
41574,1,Implanted,2170,1707,173,167,340,50.9%,1h
41574,3,danloos,2170,1536,127,136,263,48.3%,1h
41574,2,Nutari,2170,1281,109,101,210,51.9%,1h
41574,2,SIKERziq,2170,1607,88,87,175,50.3%,17m
41574,1,[AhAh]Dertaq,2170,1066,74,74,148,50.0%,22m
41574,1,[Ninjas]Prodigy,2170,579,24,25,49,49.0%,1h
41574,1,Snappa,2170,780,24,30,54,44.4%,1h
41574,1,KorZeuSe,2170,749,24,30,54,44.4%,1h
41574,2,[OssGC]Saillemone,2170,544,21,20,41,51.2%,1h
41574,1,alechuga,2170,568,19,19,38,50.0%,1h
41574,2,Chepaev,2170,488,17,14,31,54.8%,5m
41574,2,Vodynoi,2170,404,17,23,40,42.5%,1h
41574,1,Kantoraketti,2170,578,16,23,39,41.0%,30m
41574,2,mrTimmy,2170,380,15,13,28,53.6%,12m
41574,2,ДимаGSpot,2170,353,12,7,19,63.2%,27m
41574,2,Anukaki,2170,285,12,14,26,46.2%,1h
41574,3,NarThalos,2170,360,12,25,37,32.4%,1h
41574,2,Bear,2170,307,10,12,22,45.5%,27m
41574,2,LeoLejon,2170,291,9,9,18,50.0%,1h
41574,2,chris,2170,236,8,4,12,66.7%,1h
41574,2,[SHTORM]Shaman,2170,154,6,3,9,66.7%,1h
41574,1,Drfinch,2170,192,6,11,17,35.3%,30m
41574,2,MDAsh,2170,158,5,5,10,50.0%,1h
41574,1,Alvis,2170,144,4,8,12,33.3%,7m
41574,2,iccctepika,2170,0,3,2,5,60.0%,1h
41574,1,DELTAFORCE,2170,0,3,3,6,50.0%,1h
41574,2,ЖЕНЯ,2170,30,2,0,2,100.0%,1h
41574,2,[mineXD]Bumbi,2170,60,2,2,4,50.0%,1h
41574,2,nangni,2170,115,2,5,7,28.6%,2m
41574,1,MOULIN,2170,40,2,7,9,22.2%,3m
41574,1,Atreides,2170,48,2,7,9,22.2%,21m
41574,2,Incremus,2170,0,1,1,2,50.0%,19m
41574,2,[SPTAC]NDcobra,2170,0,1,2,3,33.3%,1h
41574,2,Galactica,2170,32,1,3,4,25.0%,14m
41574,1,Zeratul,2170,0,1,6,7,14.3%,8m
41574,1,[TAW]Celtic,2170,30,1,14,15,6.7%,32m
41574,2,[bonx]Remix,2170,0,0,1,1,0.0%,1h
41574,2,Apollo,2170,0,0,1,1,0.0%,27m
41574,2,RepoorT,2170,0,0,5,5,0.0%,14m
41574,1,iloiloiloilo,2170,0,0,5,5,0.0%,1h
41574,2,imnoob,2170,0,0,5,5,0.0%,28m
41574,1,dert,2170,0,0,9,9,0.0%,30m
41618,2,Gang,2169,1372,79,93,172,45.9%,1h
41618,2,suomiy,2169,1502,63,55,118,53.4%,1h
41618,2,noone,2169,1281,52,49,101,51.5%,33m
41618,2,Bananakin,2169,646,36,11,47,76.6%,1h
41618,2,Arih,2169,836,31,33,64,48.4%,1h
41618,1,Secondchance,2169,792,24,31,55,43.6%,1h
41618,1,Alchem,2169,747,24,34,58,41.4%,11m
41618,1,Gnaaaarg,2169,553,20,22,42,47.6%,1h
41618,1,Dannerg,2169,487,16,21,37,43.2%,27m
41618,3,Maurokun,2169,415,14,22,36,38.9%,12m
41618,2,Respayn,2169,246,11,6,17,64.7%,22m
41618,2,Ydderf,2169,346,11,14,25,44.0%,1h
41618,1,IcyDuck,2169,336,9,17,26,34.6%,1h
41618,1,Mowahauk,2169,241,6,11,17,35.3%,9m
41618,3,Machine,2169,198,6,13,19,31.6%,15m
41618,1,LeChefs,2169,0,4,5,9,44.4%,25m
41618,2,Makaroni,2169,88,3,5,8,37.5%,1h
41618,3,mycelium,2169,97,3,10,13,23.1%,15m
41618,2,Krkanin,2169,62,2,4,6,33.3%,19m
41618,2,Rodro,2169,48,2,7,9,22.2%,1h
41618,2,NautiluS,2169,140,2,7,9,22.2%,1h
41618,2,DerMeister,2169,48,1,3,4,25.0%,1h
41618,2,Bashta,2169,0,1,4,5,20.0%,32m
41618,2,shepa,2169,0,1,5,6,16.7%,1h
41618,2,ToRTiLLo,2169,46,1,6,7,14.3%,16m
41618,1,Wyrd,2169,0,1,6,7,14.3%,5m
41618,2,ShadowStorm,2169,0,0,3,3,0.0%,1h
41618,2,custodier,2169,0,0,3,3,0.0%,1h
41618,1,Miranee,2169,0,0,4,4,0.0%,1h
41618,2,Jmika,2169,0,0,4,4,0.0%,1h
41618,2,Aschenbecher,2169,0,0,5,5,0.0%,21m
41618,2,joelanouille,2169,0,0,5,5,0.0%,1h
41650,1,yurasan,2168,1639,215,223,438,49.1%,1h
41650,1,Alex,2168,1275,126,127,253,49.8%,1h
41650,2,comod,2168,1402,68,64,132,51.5%,29m
41650,2,Herb,2168,1363,64,61,125,51.2%,1h
41650,1,ThatScrub,2168,940,58,60,118,49.2%,1h
41650,1,Firstblood,2168,1123,53,57,110,48.2%,1h
41650,1,aleshka,2168,1233,49,47,96,51.0%,1h
41650,2,jobbie,2168,977,48,48,96,50.0%,24m
41650,2,xpom,2168,1113,46,38,84,54.8%,1h
41650,2,TheYoungPope,2168,814,34,35,69,49.3%,1h
41650,1,JenSI,2168,412,15,18,33,45.5%,1h
41650,2,Wagnis,2168,362,13,8,21,61.9%,1h
41650,2,JustFox,2168,321,10,15,25,40.0%,18m
41650,2,Bubuka,2168,207,6,4,10,60.0%,23m
41650,2,moimeme,2168,118,6,7,13,46.2%,14m
41650,2,slv,2168,180,5,3,8,62.5%,1h
41650,2,LCOD,2168,166,5,3,8,62.5%,27m
41650,1,kacper,2168,100,4,8,12,33.3%,13m
41650,2,[UUGG]Shadowplasm,2168,30,2,2,4,50.0%,19m
41650,2,[7STAR]reinonatural,2168,46,2,3,5,40.0%,26m
41650,1,Innova,2168,144,2,3,5,40.0%,1h
41650,2,танк,2168,60,2,3,5,40.0%,20m
41650,2,Pigouse,2168,0,2,4,6,33.3%,1h
41650,2,starleader,2168,30,1,1,2,50.0%,1h
41650,2,SoulGuard,2168,0,1,4,5,20.0%,2m
41650,2,Thetheth,2168,0,0,1,1,0.0%,22m
41650,2,MrJack,2168,0,0,1,1,0.0%,1h
41650,2,goga,2168,0,0,1,1,0.0%,1h
41650,2,antonio,2168,0,0,4,4,0.0%,1h
41679,1,Sujuho,2167,1730,323,338,661,48.9%,29m
41679,1,Frisbald,2167,1724,197,198,395,49.9%,24m
41679,1,buck,2167,1645,170,180,350,48.6%,13m
41679,1,Starz,2167,1714,150,159,309,48.5%,6m
41679,2,kas,2167,1604,147,146,293,50.2%,1h
41679,1,kikadas,2167,1562,118,127,245,48.2%,1h
41679,1,jerkopederko,2167,1669,114,118,232,49.1%,28m
41679,2,Bab,2167,1619,111,115,226,49.1%,28m
41679,2,Fartovbiu,2167,1597,99,101,200,49.5%,1h
41679,3,ItzakStern,2167,1219,88,98,186,47.3%,1h
41679,1,goder,2167,451,52,59,111,46.8%,1h
41679,2,lionarik,2167,1316,50,51,101,49.5%,1h
41679,1,Danya,2167,597,20,25,45,44.4%,1h
41679,2,setermo,2167,218,7,7,14,50.0%,29m
41679,1,dansaev,2167,132,7,7,14,50.0%,1h
41679,2,Papay,2167,237,7,10,17,41.2%,11m
41679,1,ElectronChik,2167,232,6,8,14,42.9%,30m
41679,2,brave,2167,145,3,0,3,100.0%,1h
41679,2,Davide,2167,58,3,1,4,75.0%,13m
41679,2,Metag,2167,62,3,2,5,60.0%,1h
41679,1,Den,2167,145,3,3,6,50.0%,1h
41679,2,Quatorze,2167,96,3,8,11,27.3%,31m
41679,1,Remus,2167,96,3,9,12,25.0%,1h
41679,1,Vaf,2167,96,3,9,12,25.0%,16m
41679,2,[A100]prototer,2167,30,2,1,3,66.7%,1h
41679,2,Gordy,2167,46,2,1,3,66.7%,19m
41679,2,Gannik,2167,32,2,2,4,50.0%,32m
41679,2,Weltenfisch,2167,122,2,3,5,40.0%,27m
41679,3,Pamnek,2167,121,2,4,6,33.3%,8m
41679,2,Kuglys,2167,97,2,7,9,22.2%,1h
41679,1,vincent,2167,74,2,8,10,20.0%,1h
41679,1,Mindwalker,2167,42,2,9,11,18.2%,1h
41679,3,Pandaboy,2167,0,1,0,1,100.0%,26m
41679,1,jalibu,2167,48,1,4,5,20.0%,1h
41679,2,[СБ]vZASADE,2167,30,1,5,6,16.7%,32m
41679,2,skywalker,2167,0,1,6,7,14.3%,25m
41679,2,[MIDGF]KampfKiffer,2167,0,0,1,1,0.0%,20m
41679,2,[ZERGSC]GovnaKusok,2167,0,0,1,1,0.0%,26m
41679,2,drk,2167,0,0,1,1,0.0%,1h
41679,2,Lmb,2167,0,0,1,1,0.0%,1h
41679,2,maddogsg,2167,0,0,2,2,0.0%,28m
41679,2,Timur,2167,0,0,3,3,0.0%,1h
41679,2,REMBUSTA,2167,0,0,5,5,0.0%,28m
41679,2,ertooo,2167,0,0,5,5,0.0%,30m
41723,2,Azog,2166,815,62,62,124,50.0%,1h
41723,1,raynor,2166,1176,42,50,92,45.7%,33m
41723,1,krlom,2166,998,34,46,80,42.5%,5m
41723,2,Sinisius,2166,743,30,24,54,55.6%,1h
41723,1,Dorin,2166,785,28,29,57,49.1%,1h
41723,2,[CABA]Abelard,2166,558,19,39,58,32.8%,4m
41723,2,MrHungry,2166,402,12,15,27,44.4%,20m
41723,2,Ali,2166,294,11,6,17,64.7%,23m
41723,1,FoxWaffle,2166,355,10,13,23,43.5%,1h
41723,2,Badaraizator,2166,338,10,29,39,25.6%,11m
41723,2,zelia,2166,220,9,7,16,56.2%,17m
41723,2,Johnex,2166,214,7,10,17,41.2%,27m
41723,1,aleks,2166,237,6,6,12,50.0%,32m
41723,2,NeyroN,2166,180,6,8,14,42.9%,1h
41723,2,Nelturion,2166,205,6,11,17,35.3%,30m
41723,2,Jospin,2166,118,5,5,10,50.0%,1h
41723,2,Tomek,2166,86,4,2,6,66.7%,23m
41723,2,GertPerd,2166,137,4,4,8,50.0%,2m
41723,1,Bolggrom,2166,36,4,4,8,50.0%,1h
41723,2,DriverW,2166,96,4,7,11,36.4%,1h
41723,2,Imjim,2166,182,4,7,11,36.4%,1h
41723,2,KUMO,2166,0,2,8,10,20.0%,28m
41723,2,MEXANIK,2166,0,1,6,7,14.3%,1h
41723,1,vicio,2166,0,1,6,7,14.3%,1h
41723,2,zhelezniy,2166,0,0,1,1,0.0%,19m
41723,2,Devillion,2166,0,0,5,5,0.0%,3m
41723,2,Sem,2166,0,0,5,5,0.0%,30m
41750,2,ThZair,2165,1576,197,217,414,47.6%,1h
41750,1,NAZARBOR,2165,1627,84,87,171,49.1%,22m
41750,3,KapetanKosti,2165,907,76,102,178,42.7%,21m
41750,2,fikumiku,2165,363,32,34,66,48.5%,27m
41750,2,Destroyer,2165,807,27,36,63,42.9%,1h
41750,1,Smanu,2165,310,12,11,23,52.2%,2m
41750,1,RedEye,2165,245,9,11,20,45.0%,10m
41750,1,Kaspartacus,2165,264,8,10,18,44.4%,13m
41750,2,Fanatik,2165,232,6,5,11,54.5%,10m
41750,1,Max,2165,114,4,12,16,25.0%,28m
41750,1,Serg,2165,48,2,4,6,33.3%,17m
41750,2,bigdipper,2165,138,2,6,8,25.0%,2m
41750,2,defox,2165,0,1,0,1,100.0%,1h
41750,2,ondrin,2165,94,1,1,2,50.0%,27m
41750,1,Wicket,2165,0,1,1,2,50.0%,1h
41750,2,hawzeh,2165,46,1,6,7,14.3%,10m
41750,2,DredMZFC,2165,32,1,6,7,14.3%,29m
41750,1,Nuvoka,2165,0,1,6,7,14.3%,8m
41750,1,uka,2165,0,1,6,7,14.3%,1h
41750,1,Bazz,2165,40,1,9,10,10.0%,12m
41750,2,Djoory,2165,0,0,1,1,0.0%,3m
41750,2,DASFlagman,2165,0,0,1,1,0.0%,20m
41750,2,iXPacenko,2165,0,0,2,2,0.0%,19m
41750,2,Ganymed,2165,0,0,3,3,0.0%,21m
41774,1,TANK,2164,1416,239,252,491,48.7%,1h
41774,1,blacksmoke,2164,1655,80,79,159,50.3%,9m
41774,2,Smerch,2164,814,29,31,60,48.3%,1h
41774,2,Adya,2164,794,28,28,56,50.0%,4m
41774,1,loaquellogam,2164,508,15,23,38,39.5%,4m
41774,1,Zander,2164,346,12,11,23,52.2%,19m
41774,2,Sylvesteri,2164,290,11,12,23,47.8%,1h
41774,2,Omega,2164,276,10,6,16,62.5%,1h
41774,2,wemon,2164,172,9,7,16,56.2%,23m
41774,2,[JYD]Gwildor,2164,232,8,8,16,50.0%,1h
41774,1,Tusco,2164,270,8,10,18,44.4%,3m
41774,1,[BLINtv]Жиган,2164,255,7,10,17,41.2%,1h
41774,1,rty,2164,140,5,11,16,31.2%,29m
41774,1,Skipper,2164,192,4,2,6,66.7%,7m
41774,2,SashaWarlord,2164,120,4,6,10,40.0%,1h
41774,2,SkOrPy,2164,60,3,2,5,60.0%,31m
41774,2,dolce,2164,94,3,5,8,37.5%,1h
41774,2,MadBoy,2164,0,1,0,1,100.0%,1h
41774,2,[OTK2]mariner,2164,88,1,3,4,25.0%,1h
41774,2,GeraltOutlaw,2164,48,1,3,4,25.0%,1h
41774,2,[typbIe]vampiruhbif,2164,88,1,5,6,16.7%,1h
41774,3,Pecat,2164,0,1,5,6,16.7%,1h
41774,1,Bonnie,2164,0,1,6,7,14.3%,13m
41774,2,[Scvs]CyberDog,2164,30,1,7,8,12.5%,1h
41774,2,ninja,2164,0,0,1,1,0.0%,30m
41774,2,sven,2164,0,0,1,1,0.0%,3m
41774,1,Trianon,2164,0,0,2,2,0.0%,1h
41801,1,Dragoshel,2163,1544,455,494,949,47.9%,19m
41801,1,Infinity,2163,1596,181,192,373,48.5%,1h
41801,2,consuela,2163,942,35,39,74,47.3%,15m
41801,2,matr,2163,894,33,33,66,50.0%,1h
41801,1,harthos,2163,608,24,30,54,44.4%,29m
41801,2,fed,2163,638,22,23,45,48.9%,32m
41801,2,[Rusia]ASID,2163,364,15,15,30,50.0%,14m
41801,1,PsicoCat,2163,510,15,26,41,36.6%,1h
41801,1,Rusl,2163,331,13,16,29,44.8%,4m
41801,1,Vovanchik,2163,287,10,14,24,41.7%,17m
41801,1,AndreyPYV,2163,324,10,15,25,40.0%,23m
41801,1,Andy,2163,380,9,21,30,30.0%,1h
41801,1,geolog,2163,220,7,16,23,30.4%,8m
41801,3,Акелла,2163,221,6,8,14,42.9%,20m
41801,1,Pecius,2163,202,6,9,15,40.0%,16m
41801,2,dominio,2163,94,4,3,7,57.1%,1h
41801,1,JhosuaSuren,2163,96,3,9,12,25.0%,1h
41801,2,[LOGS]bEaR,2163,0,2,3,5,40.0%,1h
41801,1,doctorvenom,2163,0,2,6,8,25.0%,8m
41801,2,Tazar,2163,0,1,0,1,100.0%,3m
41801,2,Odblask,2163,32,1,1,2,50.0%,29m
41801,2,SMOKYBANDIT,2163,0,1,1,2,50.0%,1h
41801,2,MachineHead,2163,0,1,1,2,50.0%,26m
41801,2,Rytir,2163,0,1,4,5,20.0%,15m
41801,2,Pip,2163,0,0,1,1,0.0%,1h
41801,1,SirDarb,2163,0,0,2,2,0.0%,1h
41827,1,kasi,2162,957,64,69,133,48.1%,22m
41827,2,ПЕНДАЛЬФ,2162,770,29,26,55,52.7%,1h
41827,1,cometa,2162,464,21,13,34,61.8%,1h
41827,2,Čuchoprd,2162,465,18,9,27,66.7%,1h
41827,2,[Arrows]Klemst,2162,353,15,7,22,68.2%,1h
41827,1,[Poofff]HxCKid,2162,312,10,13,23,43.5%,1h
41827,2,Uthroy,2162,216,6,10,16,37.5%,1h
41827,2,Regular,2162,118,5,3,8,62.5%,27m
41827,2,Regis,2162,154,5,8,13,38.5%,1h
41827,2,Blastex,2162,0,4,7,11,36.4%,1h
41827,2,Gama,2162,32,4,12,16,25.0%,24m
41827,2,[1crt1]Mateo,2162,58,3,0,3,100.0%,1h
41827,2,csreaper,2162,60,2,4,6,33.3%,22m
41827,2,FireStorm,2162,0,1,0,1,100.0%,9m
41827,2,sackes,2162,0,1,2,3,33.3%,1h
41827,1,Henrik,2162,0,1,7,8,12.5%,9m
41827,1,[ValidG]Pinoester,2162,0,0,1,1,0.0%,15m
41827,2,eran,2162,0,0,1,1,0.0%,12m
41827,2,WDFazik,2162,0,0,2,2,0.0%,1h
41846,2,MARIXYANA,2161,1392,93,102,195,47.7%,28m
41846,1,Индеец,2161,1647,93,103,196,47.4%,1h
41846,1,SJK,2161,1527,60,62,122,49.2%,1h
41846,2,kaban,2161,956,42,32,74,56.8%,1h
41846,2,nosmo,2161,902,38,39,77,49.4%,28m
41846,2,[LMBD]Akerpoker,2161,765,32,22,54,59.3%,1h
41846,2,[LMBD]QuiGonJinn,2161,846,30,34,64,46.9%,1h
41846,2,RedJuiceBoy,2161,394,16,13,29,55.2%,17m
41846,2,Boec,2161,321,11,8,19,57.9%,1h
41846,2,[OSgZ]Kiliman,2161,222,9,6,15,60.0%,1h
41846,2,Nemelis,2161,188,7,2,9,77.8%,1h
41846,2,Aleks,2161,229,7,5,12,58.3%,14m
41846,2,Мандалорец,2161,132,5,5,10,50.0%,24m
41846,1,Lukas,2161,239,5,11,16,31.2%,1h
41846,2,[ImbaG]Putin,2161,129,4,7,11,36.4%,20m
41846,1,BigD,2161,146,4,10,14,28.6%,1h
41846,2,Shadow,2161,94,3,7,10,30.0%,1h
41846,2,Racso,2161,38,2,1,3,66.7%,11m
41846,2,[OdinVK]Nightform,2161,112,2,1,3,66.7%,20m
41846,2,Infighter,2161,30,2,5,7,28.6%,1h
41846,1,Mishas,2161,85,2,7,9,22.2%,12m
41846,1,[DaFF]Delusion,2161,40,2,8,10,20.0%,27m
41846,2,Elcorniv,2161,0,1,1,2,50.0%,9m
41846,2,MRdeath,2161,0,1,5,6,16.7%,19m
41846,1,Mnheia,2161,38,1,7,8,12.5%,4m
41846,2,YoutubeМЕМАС,2161,0,0,1,1,0.0%,1h
41846,2,RedOrDead,2161,0,0,1,1,0.0%,1h
41846,2,[ETESG]Rayker,2161,0,0,1,1,0.0%,11m
41846,2,[MASPA]BODRI,2161,0,0,1,1,0.0%,1h
41846,2,Fargossa,2161,0,0,1,1,0.0%,1h
41846,2,Valazera,2161,0,0,2,2,0.0%,1h
41846,1,Player,2161,0,0,3,3,0.0%,4m
41846,2,AntonT,2161,0,0,7,7,0.0%,26m
41879,2,[SPAINs]Jagoer,2160,1624,248,255,503,49.3%,1h
41879,1,Squatter,2160,1668,193,199,392,49.2%,1h
41879,1,Dimitry,2160,538,59,64,123,48.0%,1h
41879,1,[TNZs]GUYGO,2160,1191,49,40,89,55.1%,31m
41879,1,Krushtak,2160,448,46,60,106,43.4%,28m
41879,2,Leon,2160,650,38,35,73,52.1%,1h
41879,1,Liebert,2160,357,18,16,34,52.9%,4m
41879,2,DisneyKiller,2160,451,18,23,41,43.9%,19m
41879,1,Worchyn,2160,270,17,16,33,51.5%,23m
41879,1,StarComanRU,2160,384,15,15,30,50.0%,28m
41879,2,sMMAshzilla,2160,322,11,12,23,47.8%,1h
41879,1,MIke,2160,354,11,16,27,40.7%,6m
41879,2,[xFRSx]kartofel,2160,236,8,7,15,53.3%,1h
41879,2,Jonny,2160,114,5,1,6,83.3%,4m
41879,2,Miron,2160,108,5,7,12,41.7%,14m
41879,2,Lavliett,2160,177,5,12,17,29.4%,1h
41879,1,Manio,2160,188,5,15,20,25.0%,27m
41879,2,[IIII17]Artefact,2160,76,3,6,9,33.3%,1h
41879,1,mrGrinch,2160,139,3,10,13,23.1%,28m
41879,1,[mfxed]igor,2160,152,3,11,14,21.4%,5m
41879,2,Gio,2160,86,2,3,5,40.0%,2m
41879,2,SupesTKD,2160,58,2,3,5,40.0%,1h
41879,2,Danjer,2160,0,2,3,5,40.0%,10m
41879,2,[PNC]Drufus,2160,0,1,0,1,100.0%,1h
41879,2,vigorsol,2160,0,1,0,1,100.0%,1h
41879,2,Superzoix,2160,0,1,1,2,50.0%,1h
41879,2,Sander,2160,0,1,2,3,33.3%,1h
41879,1,Oyrad,2160,48,1,5,6,16.7%,9m
41879,1,FireFox,2160,0,1,5,6,16.7%,28m
41879,2,Wiksa,2160,0,0,1,1,0.0%,1h
41879,2,Loyolo,2160,0,0,1,1,0.0%,1h
41879,2,aarroyoc,2160,0,0,1,1,0.0%,1h
41879,2,[BGBKBR]Neeb,2160,0,0,1,1,0.0%,1h
41879,2,MrTwister,2160,0,0,3,3,0.0%,1h
41879,1,kingbejk,2160,0,0,3,3,0.0%,16m
41879,2,Syrus,2160,0,0,5,5,0.0%,1h
41915,1,TEM,2159,1718,122,120,242,50.4%,1h
41915,2,supi,2159,1615,78,81,159,49.1%,19m
41915,1,Codvi,2159,910,52,60,112,46.4%,1h
41915,2,Mami,2159,513,19,18,37,51.4%,20m
41915,2,[NazeTo]DreamLTN,2159,336,15,12,27,55.6%,22m
41915,1,PietSkiet,2159,271,11,15,26,42.3%,1h
41915,2,LoupOutaouai,2159,222,8,9,17,47.1%,14m
41915,1,Votvad,2159,300,8,11,19,42.1%,1h
41915,2,Xelmoona,2159,172,6,7,13,46.2%,1h
41915,1,surrender,2159,245,6,11,17,35.3%,33m
41915,2,Basil,2159,243,6,16,22,27.3%,24m
41915,2,Totmato,2159,197,5,4,9,55.6%,1h
41915,1,Ixam,2159,188,5,8,13,38.5%,1h
41915,1,Smoolijkeee,2159,113,4,7,11,36.4%,19m
41915,2,KRUTOR,2159,114,4,9,13,30.8%,9m
41915,1,prokion,2159,136,4,11,15,26.7%,31m
41915,1,Kadlitox,2159,144,4,11,15,26.7%,1h
41915,2,Elaminer,2159,96,3,5,8,37.5%,1h
41915,2,amateus,2159,88,3,6,9,33.3%,29m
41915,2,[ölig]Foureyes,2159,32,2,0,2,100.0%,1h
41915,2,piratejenjen,2159,58,2,2,4,50.0%,26m
41915,2,Zykko,2159,0,1,1,2,50.0%,1h
41915,1,boultan,2159,36,1,8,9,11.1%,1h
41915,1,ricoshet,2159,0,0,1,1,0.0%,1h
41915,2,Antas,2159,0,0,1,1,0.0%,10m
41915,2,deep,2159,0,0,1,1,0.0%,23m
41915,1,[GGro]GGRoIOs,2159,0,0,2,2,0.0%,1h
41915,2,[Хакеры]Ушкуйник,2159,0,0,2,2,0.0%,32m
41915,2,[Gate13]Nikk,2159,0,0,2,2,0.0%,32m
41915,2,LordDron,2159,0,0,4,4,0.0%,12m
41915,2,Zeta,2159,0,0,5,5,0.0%,1h
41946,1,Lizardburn,2158,1392,128,132,260,49.2%,1h
41946,1,fandrik,2158,1241,116,113,229,50.7%,1h
41946,2,SpaceTrucker,2158,1403,64,62,126,50.8%,14m
41946,2,Greeniigames,2158,913,61,53,114,53.5%,4m
41946,1,Koteyka,2158,512,47,44,91,51.6%,1h
41946,1,[Csélör]Kukulkan,2158,1119,42,45,87,48.3%,9m
41946,1,BRETLEON,2158,738,24,32,56,42.9%,1h
41946,2,МаКаРКа,2158,481,17,20,37,45.9%,1h
41946,2,Maeglin,2158,417,16,12,28,57.1%,9m
41946,2,[GLNMS]TayzwarD,2158,330,12,13,25,48.0%,30m
41946,3,[SwashB]kovo,2158,379,12,18,30,40.0%,9m
41946,2,imba,2158,322,12,19,31,38.7%,10m
41946,2,[OGPP]Theundermind,2158,254,11,3,14,78.6%,1h
41946,1,Skanky,2158,121,11,13,24,45.8%,1h
41946,1,skiff,2158,322,9,17,26,34.6%,1h
41946,3,GiantBalls,2158,235,7,13,20,35.0%,1h
41946,2,ReallyBadDoc,2158,266,7,14,21,33.3%,1h
41946,2,[PLA2N]deathNote,2158,190,6,1,7,85.7%,3m
41946,2,NIK,2158,114,5,2,7,71.4%,1h
41946,2,kiLLmapls,2158,144,5,4,9,55.6%,1h
41946,2,TarteTatin,2158,200,5,7,12,41.7%,1h
41946,1,[M13X]Aytac,2158,188,5,12,17,29.4%,31m
41946,2,[ArNaQu]mathieu,2158,118,4,6,10,40.0%,12m
41946,1,Sskifff,2158,171,4,10,14,28.6%,30m
41946,2,CaptainRex,2158,0,1,0,1,100.0%,31m
41946,2,pigg,2158,30,1,3,4,25.0%,27m
41946,2,cruellimits,2158,88,1,5,6,16.7%,11m
41946,1,Tofu,2158,0,1,8,9,11.1%,22m
41946,3,lilute,2158,0,1,8,9,11.1%,1h
41946,2,Crasher,2158,0,0,1,1,0.0%,22m
41946,2,Alecay,2158,0,0,1,1,0.0%,1h
41946,2,Ashfro,2158,0,0,1,1,0.0%,1h
41946,2,edfed,2158,0,0,3,3,0.0%,19m
41946,2,catag,2158,0,0,3,3,0.0%,1h
41946,2,Elias,2158,0,0,3,3,0.0%,1h
41981,1,EquipoA,2157,1531,151,152,303,49.8%,1h
41981,1,Gut,2157,1326,82,74,156,52.6%,1h
41981,1,jessterm,2157,1193,58,71,129,45.0%,1h
41981,2,Ezios,2157,735,30,26,56,53.6%,1h
41981,1,[TAW]Ultra,2157,313,24,30,54,44.4%,1h
41981,2,Marsruben,2157,638,21,23,44,47.7%,1h
41981,1,Gleb,2157,478,14,20,34,41.2%,1h
41981,2,SBI,2157,343,12,7,19,63.2%,5m
41981,1,Boemz,2157,370,12,17,29,41.4%,1h
41981,1,Flamindm,2157,288,11,10,21,52.4%,28m
41981,2,Nio,2157,260,10,10,20,50.0%,28m
41981,2,grzesiek,2157,232,8,12,20,40.0%,29m
41981,1,Optizerg,2157,258,8,15,23,34.8%,1h
41981,3,[RuRø]Kamura,2157,239,7,10,17,41.2%,15m
41981,2,Draper,2157,197,6,12,18,33.3%,24m
41981,2,MendocinoMtr,2157,90,5,4,9,55.6%,1h
41981,2,Tizedes,2157,156,5,7,12,41.7%,1h
41981,1,Pelli,2157,163,4,8,12,33.3%,1h
41981,2,zulu,2157,68,3,1,4,75.0%,27m
41981,2,bjornels,2157,60,3,2,5,60.0%,19m
41981,3,Theunis,2157,145,3,4,7,42.9%,9m
41981,2,MonsieurMax,2157,123,3,6,9,33.3%,22m
41981,3,OVOSCH,2157,109,3,9,12,25.0%,9m
41981,2,Adrian,2157,30,2,1,3,66.7%,1h
41981,1,Notan,2157,30,2,10,12,16.7%,1h
41981,2,Sozornast,2157,0,1,1,2,50.0%,26m
41981,2,[SCSM]ToolTime,2157,32,1,3,4,25.0%,1h
41981,2,Vasya,2157,30,1,4,5,20.0%,30m
41981,1,[FVF]женя,2157,48,1,4,5,20.0%,9m
41981,2,Saler,2157,0,1,6,7,14.3%,1h
41981,1,kumarmontana,2157,0,1,6,7,14.3%,31m
41981,2,[Monlit]LoLNetKlip,2157,0,0,1,1,0.0%,23m
41981,2,valy,2157,0,0,1,1,0.0%,1h
41981,1,Gerc,2157,0,0,2,2,0.0%,8m
41981,2,zet,2157,0,0,3,3,0.0%,27m
41981,2,Tingeling,2157,0,0,5,5,0.0%,1h
42017,1,Zeus,2156,1357,248,263,511,48.5%,32m
42017,2,Gilead,2156,1634,133,137,270,49.3%,14m
42017,2,mhmtbt,2156,1146,65,63,128,50.8%,4m
42017,2,Starzinger,2156,1243,46,61,107,43.0%,1h
42017,2,nono,2156,453,21,17,38,55.3%,1h
42017,1,Lebang,2156,608,20,26,46,43.5%,17m
42017,1,Etraud,2156,596,17,31,48,35.4%,1h
42017,3,XELLOSSYNC,2156,459,14,31,45,31.1%,1h
42017,2,igla,2156,386,13,18,31,41.9%,29m
42017,2,Slider,2156,322,11,9,20,55.0%,1h
42017,2,Saga,2156,231,8,8,16,50.0%,30m
42017,1,Outworld,2156,177,7,6,13,53.8%,1h
42017,2,Johnyproo,2156,164,6,6,12,50.0%,17m
42017,1,SuperStas,2156,201,6,11,17,35.3%,19m
42017,2,Raznik,2156,114,5,3,8,62.5%,1h
42017,2,Naro,2156,123,5,3,8,62.5%,20m
42017,2,Matlysak,2156,133,4,1,5,80.0%,23m
42017,2,skynet,2156,141,4,3,7,57.1%,28m
42017,2,евгений,2156,92,4,4,8,50.0%,1h
42017,1,[MmS]iep,2156,147,4,11,15,26.7%,4m
42017,1,[BENNE]Lendedikt,2156,193,4,11,15,26.7%,13m
42017,2,yannraptor,2156,90,3,3,6,50.0%,14m
42017,1,kubelczyk,2156,193,3,4,7,42.9%,2m
42017,1,NickNaylor,2156,80,3,8,11,27.3%,23m
42017,2,[ZERGТV]zonder,2156,30,1,5,6,16.7%,12m
42017,2,Poiples,2156,0,0,1,1,0.0%,1h
42017,2,llewy,2156,0,0,2,2,0.0%,9m
42017,2,Forca,2156,0,0,2,2,0.0%,27m
42017,2,Тридцатый,2156,0,0,2,2,0.0%,1h
42017,2,DoanHiep,2156,0,0,2,2,0.0%,1h
42047,1,Vitalyer,2155,1663,177,175,352,50.3%,30m
42047,1,Gar,2155,1056,81,89,170,47.6%,27m
42047,2,AJIeLLIKa,2155,798,72,83,155,46.5%,26m
42047,2,bjorndjuret,2155,1660,71,75,146,48.6%,22m
42047,1,micki,2155,1303,59,66,125,47.2%,22m
42047,1,elektrik,2155,699,51,54,105,48.6%,17m
42047,1,marsou,2155,907,43,38,81,53.1%,24m
42047,1,Kaiji,2155,1120,42,49,91,46.2%,1h
42047,1,RodrigoReis,2155,493,22,27,49,44.9%,24m
42047,2,eyal,2155,511,21,16,37,56.8%,1h
42047,2,[SKORM]AvoSkorm,2155,470,19,17,36,52.8%,1h
42047,1,Lexaria,2155,500,15,26,41,36.6%,1h
42047,2,LyrikM,2155,229,13,9,22,59.1%,14m
42047,2,Daedroth,2155,390,13,9,22,59.1%,31m
42047,3,syko,2155,254,9,13,22,40.9%,1h
42047,1,[ncotic]BlackBoar,2155,358,9,21,30,30.0%,9m
42047,2,gITLERkAPUT,2155,220,8,4,12,66.7%,1h
42047,1,Mocoma,2155,237,7,13,20,35.0%,6m
42047,3,Saitama,2155,193,6,5,11,54.5%,1h
42047,1,DeChardin,2155,190,6,12,18,33.3%,19m
42047,2,Владос,2155,152,4,3,7,57.1%,28m
42047,1,stecik,2155,169,3,2,5,60.0%,1h
42047,1,Carnage,2155,142,3,14,17,17.6%,9m
42047,1,tom,2155,114,2,5,7,28.6%,1h
42047,2,[lGGI]Redbeard,2155,46,2,5,7,28.6%,1h
42047,2,Peacemaker,2155,0,1,0,1,100.0%,1h
42047,2,losstroginos,2155,0,1,0,1,100.0%,1h
42047,2,Amadeus,2155,30,1,1,2,50.0%,10m
42047,2,eSeS,2155,0,1,3,4,25.0%,1h
42047,1,Cloni,2155,0,1,7,8,12.5%,2m
42047,1,lmstar,2155,0,0,1,1,0.0%,1h
42047,1,Martin,2155,0,0,1,1,0.0%,1h
42047,2,Nogard,2155,0,0,2,2,0.0%,15m
42047,2,[B3yond]DarkPapaya,2155,0,0,2,2,0.0%,1h
42047,2,rabar,2155,0,0,2,2,0.0%,11m
42047,2,Zeibi,2155,0,0,5,5,0.0%,26m
42047,3,[PIAIC]Wridem,2155,0,0,5,5,0.0%,24m
42084,2,Starlord,2154,1588,383,438,821,46.7%,1h
42084,1,JALL,2154,1482,75,86,161,46.6%,1h
42084,2,[KPot]Allister,2154,798,38,43,81,46.9%,33m
42084,1,One,2154,972,31,41,72,43.1%,1h
42084,2,Rosson,2154,650,23,23,46,50.0%,22m
42084,3,Ronin,2154,402,14,28,42,33.3%,1h
42084,2,Jarril,2154,371,13,17,30,43.3%,1h
42084,3,StralkAgar,2154,260,10,17,27,37.0%,2m
42084,2,ArsenStrus,2154,174,8,8,16,50.0%,3m
42084,2,NoGasPlease,2154,256,8,9,17,47.1%,1h
42084,2,Pintman,2154,218,6,12,18,33.3%,27m
42084,1,Hellstaff,2154,192,4,2,6,66.7%,17m
42084,1,schupalla,2154,163,4,8,12,33.3%,13m
42084,3,yarin,2154,62,4,10,14,28.6%,1h
42084,2,OOOTTOOO,2154,88,3,4,7,42.9%,33m
42084,3,Dédé,2154,122,3,8,11,27.3%,19m
42084,3,Occupant,2154,97,2,1,3,66.7%,21m
42084,2,Khyber,2154,30,2,2,4,50.0%,22m
42084,2,Ezachs,2154,58,2,2,4,50.0%,32m
42084,1,LeoGenuardi,2154,119,2,2,4,50.0%,7m
42084,2,IIIIIIIIIIII,2154,92,2,3,5,40.0%,31m
42084,1,Ostwind,2154,46,2,5,7,28.6%,15m
42084,2,potatoonpota,2154,48,2,6,8,25.0%,1h
42084,1,TOMY,2154,97,2,9,11,18.2%,1h
42084,2,JANUS,2154,0,1,2,3,33.3%,5m
42084,2,VANDER,2154,30,1,4,5,20.0%,1h
42084,2,Ksardrey,2154,0,1,5,6,16.7%,1h
42084,2,chitaury,2154,0,1,5,6,16.7%,28m
42084,1,ArturMengsk,2154,0,1,8,9,11.1%,25m
42084,2,KAZAK,2154,0,0,1,1,0.0%,1h
42084,2,Oladka,2154,0,0,1,1,0.0%,32m
42084,2,Bastek,2154,0,0,2,2,0.0%,1h
42084,2,BaRuTeKu,2154,0,0,2,2,0.0%,21m
42084,2,eminor,2154,0,0,4,4,0.0%,1h
42084,2,zub,2154,0,0,5,5,0.0%,14m
42084,2,TheFunnyMan,2154,0,0,5,5,0.0%,1h
42120,1,[Fire]boulbar,2153,1684,346,353,699,49.5%,3m
42120,1,saskeeeeee,2153,1691,155,153,308,50.3%,1h
42120,2,Miki,2153,1436,87,92,179,48.6%,1h
42120,1,Sisko,2153,1518,59,65,124,47.6%,6m
42120,1,WaveRider,2153,651,22,23,45,48.9%,33m
42120,2,moondogvoice,2153,448,19,13,32,59.4%,18m
42120,1,Blade,2153,356,13,24,37,35.1%,28m
42120,2,AquilaVince,2153,370,12,20,32,37.5%,1h
42120,1,BeautifulRUS,2153,235,10,9,19,52.6%,1h
42120,2,panama,2153,284,10,11,21,47.6%,12m
42120,1,Yandrak,2153,334,10,18,28,35.7%,1h
42120,2,BlueYoshy,2153,200,6,9,15,40.0%,1h
42120,2,[Актив]Kriont,2153,110,4,3,7,57.1%,1h
42120,1,Джокер,2153,138,3,9,12,25.0%,1h
42120,1,Arsackkk,2153,0,2,5,7,28.6%,25m
42120,2,Daramos,2153,94,2,6,8,25.0%,1h
42120,1,OsowiecBR,2153,0,2,8,10,20.0%,31m
42120,1,Uragan,2153,38,2,8,10,20.0%,8m
42120,2,KelloxSmaxs,2153,0,1,0,1,100.0%,9m
42120,2,Flynn,2153,30,1,1,2,50.0%,33m
42120,3,Owndragon,2153,0,1,7,8,12.5%,32m
42120,2,[tagNCT]nlogax,2153,149,1,10,11,9.1%,1h
42120,2,ZebraPower,2153,0,0,2,2,0.0%,1h
42120,2,queenwarrior,2153,0,0,5,5,0.0%,3m
42144,2,Арчиссс,2152,1156,69,71,140,49.3%,20m
42144,2,ketch,2152,820,56,48,104,53.8%,1h
42144,1,Emergy,2152,927,48,52,100,48.0%,1h
42144,2,Kirteezy,2152,1174,45,45,90,50.0%,10m
42144,2,argor,2152,926,35,34,69,50.7%,1h
42144,2,JOJO,2152,856,33,34,67,49.3%,1h
42144,2,Topikana,2152,209,20,23,43,46.5%,12m
42144,3,Mro,2152,269,10,12,22,45.5%,1h
42144,2,Salvo,2152,280,10,14,24,41.7%,27m
42144,1,[OmDi]Diego,2152,362,10,14,24,41.7%,12m
42144,1,AlastorM,2152,282,10,15,25,40.0%,1h
42144,2,[SeVenV]Mengsk,2152,242,9,6,15,60.0%,1h
42144,2,Boroda,2152,208,8,7,15,53.3%,1h
42144,3,PKmonze,2152,271,8,9,17,47.1%,10m
42144,3,[BarKin]Misha,2152,213,7,16,23,30.4%,12m
42144,2,[PLyGoN]Royan,2152,204,6,3,9,66.7%,20m
42144,2,Kord,2152,150,6,5,11,54.5%,10m
42144,1,tatrdaslayer,2152,190,6,10,16,37.5%,1h
42144,2,KingLeQwer,2152,185,5,2,7,71.4%,28m
42144,2,Hjalte,2152,58,3,0,3,100.0%,17m
42144,2,VanG,2152,32,2,2,4,50.0%,1h
42144,1,BronzeHero,2152,97,2,4,6,33.3%,17m
42144,1,DINO,2152,114,2,6,8,25.0%,4m
42144,1,[Yoga]MissEffie,2152,44,2,8,10,20.0%,1h
42144,2,Xytos,2152,0,1,1,2,50.0%,1h
42144,2,DarkAvenger,2152,44,1,3,4,25.0%,30m
42144,2,[Foton]безротый,2152,0,1,3,4,25.0%,1h
42144,2,Bloodeyy,2152,30,1,4,5,20.0%,1h
42144,2,КОМИНТЕРН,2152,30,1,4,5,20.0%,1h
42144,1,Argus,2152,48,1,6,7,14.3%,1h
42144,2,helpilot,2152,0,0,1,1,0.0%,15m
42144,2,Xatlad,2152,0,0,1,1,0.0%,18m
42144,2,DokHudson,2152,0,0,1,1,0.0%,9m
42144,2,Online,2152,0,0,1,1,0.0%,31m
42144,2,Mrghost,2152,0,0,1,1,0.0%,1h
42144,2,DiDoK,2152,0,0,2,2,0.0%,1h
42144,2,lCarlitos,2152,0,0,3,3,0.0%,4m
42144,2,Lloyd,2152,0,0,5,5,0.0%,1h
42182,1,Maximus,2151,1631,144,134,278,51.8%,1h
42182,3,BlikingoV,2151,949,78,93,171,45.6%,1h
42182,2,Zee,2151,766,27,27,54,50.0%,1h
42182,1,Кирилл,2151,550,24,23,47,51.1%,26m
42182,2,Crazy,2151,592,22,21,43,51.2%,12m
42182,2,naget,2151,496,17,13,30,56.7%,33m
42182,1,angryANT,2151,421,11,15,26,42.3%,1h
42182,2,ArtKing,2151,200,7,5,12,58.3%,24m
42182,2,dyango,2151,224,7,10,17,41.2%,1h
42182,2,biodanne,2151,102,3,9,12,25.0%,12m
42182,2,Jhappi,2151,30,3,10,13,23.1%,26m
42182,2,[GWYT]Grey,2151,0,1,1,2,50.0%,1h
42182,2,[ZP777]DikiiDavid,2151,0,1,2,3,33.3%,1h
42182,2,[DEASY]Piotrasek,2151,0,1,2,3,33.3%,24m
42182,3,glab,2151,0,1,2,3,33.3%,24m
42182,1,Vall,2151,0,1,6,7,14.3%,1h
42182,2,Akosha,2151,0,0,1,1,0.0%,31m
42182,1,nekek,2151,0,0,2,2,0.0%,1h
42182,2,Kaisro,2151,0,0,3,3,0.0%,27m
42201,2,[mfixed]redPL,2150,1621,113,113,226,50.0%,33m
42201,2,Sztandar,2150,1614,80,67,147,54.4%,31m
42201,2,Gornes,2150,1029,67,67,134,50.0%,33m
42201,1,Bromisch,2150,842,28,32,60,46.7%,19m
42201,1,HattonS,2150,802,26,35,61,42.6%,1h
42201,1,Рекрут,2150,404,14,21,35,40.0%,29m
42201,3,Vruecken,2150,246,8,15,23,34.8%,1h
42201,3,Luis,2150,147,5,11,16,31.2%,24m
42201,2,Floris,2150,134,2,5,7,28.6%,1h
42201,1,VatanBayrak,2150,40,2,7,9,22.2%,1h
42201,1,Harold,2150,48,2,8,10,20.0%,22m
42201,1,Available,2150,36,2,8,10,20.0%,3m
42201,2,MagJIOJI,2150,30,1,1,2,50.0%,1h
42201,2,psichi,2150,30,1,2,3,33.3%,1h
42201,1,KRISTIAN,2150,0,1,4,5,20.0%,7m
42201,2,JanNaj,2150,30,1,6,7,14.3%,1h
42201,3,Mastapetz,2150,0,0,5,5,0.0%,6m
42201,3,nikew,2150,0,0,5,5,0.0%,25m
42201,2,EDRH,2150,0,0,5,5,0.0%,19m
42220,1,ismael,2149,1694,112,132,244,45.9%,32m
42220,2,Dibeuv,2149,745,37,26,63,58.7%,32m
42220,3,Kostos,2149,619,36,47,83,43.4%,24m
42220,2,emjas,2149,782,35,21,56,62.5%,1h
42220,1,Shinigami,2149,1014,34,43,77,44.2%,25m
42220,2,Albert,2149,501,21,13,34,61.8%,28m
42220,2,McDonkey,2149,534,19,18,37,51.4%,1h
42220,2,Upstart,2149,432,15,25,40,37.5%,1h
42220,1,christoforos,2149,427,14,17,31,45.2%,6m
42220,2,Carlozipopof,2149,252,8,13,21,38.1%,29m
42220,1,Carcass,2149,243,7,10,17,41.2%,19m
42220,2,Artanis,2149,156,5,10,15,33.3%,1h
42220,2,JMafia,2149,128,4,6,10,40.0%,1h
42220,1,duckduckgo,2149,144,4,9,13,30.8%,19m
42220,2,KaOz,2149,34,4,12,16,25.0%,9m
42220,2,Kutya,2149,58,3,1,4,75.0%,1h
42220,2,Sylo,2149,95,3,4,7,42.9%,31m
42220,2,Simajl,2149,30,2,0,2,100.0%,33m
42220,2,Roedtnes,2149,60,2,2,4,50.0%,33m
42220,3,moilen,2149,0,2,8,10,20.0%,26m
42220,2,CptMclovin,2149,0,1,1,2,50.0%,19m
42220,2,Chepa,2149,0,1,2,3,33.3%,1h
42220,2,Sirlight,2149,44,1,6,7,14.3%,3m
42220,1,MishGaN,2149,0,1,7,8,12.5%,9m
42220,2,tisu,2149,0,0,1,1,0.0%,1h
42220,2,bongakill,2149,0,0,1,1,0.0%,1h
42220,2,Connor,2149,0,0,1,1,0.0%,1h
42220,3,[QX9650]angel,2149,0,0,5,5,0.0%,1h
42248,1,[метал]Alex,2148,1685,246,258,504,48.8%,1h
42248,2,[Chewie]ShadowStorm,2148,1081,45,50,95,47.4%,1h
42248,2,Suki,2148,926,37,41,78,47.4%,15m
42248,1,SnowManGo,2148,1141,36,46,82,43.9%,1h
42248,1,DaN,2148,924,29,41,70,41.4%,8m
42248,2,Happy,2148,558,20,19,39,51.3%,1h
42248,2,[VdpV]PloKoon,2148,478,17,17,34,50.0%,1h
42248,1,Armagen,2148,548,17,24,41,41.5%,31m
42248,3,FROL,2148,333,15,16,31,48.4%,32m
42248,1,gomez,2148,388,14,20,34,41.2%,1h
42248,2,CCCP,2148,303,11,6,17,64.7%,12m
42248,1,WeakPinkpig,2148,307,11,15,26,42.3%,30m
42248,1,MVN,2148,404,11,16,27,40.7%,1h
42248,2,KapsMan,2148,302,10,14,24,41.7%,1h
42248,2,Beibars,2148,242,10,20,30,33.3%,1h
42248,2,Blushven,2148,260,9,6,15,60.0%,1h
42248,2,Fly,2148,270,9,9,18,50.0%,9m
42248,2,PtiZiZi,2148,196,7,6,13,53.8%,1h
42248,2,NikDevil,2148,220,7,10,17,41.2%,1h
42248,2,[MUIZE]Wolfdogcat,2148,120,5,4,9,55.6%,1h
42248,1,lotdog,2148,144,4,11,15,26.7%,7m
42248,2,GUILHEM,2148,109,2,2,4,50.0%,9m
42248,2,[74RU]shredor,2148,0,1,1,2,50.0%,27m
42248,2,Rar,2148,0,1,2,3,33.3%,1h
42248,2,fndare,2148,0,0,1,1,0.0%,1h
42248,2,dron,2148,0,0,1,1,0.0%,19m
42248,2,TestUser,2148,73,0,2,2,0.0%,1h
42248,1,Arakulf,2148,0,0,6,6,0.0%,10m
42276,2,Oleh,2147,1600,127,127,254,50.0%,1h
42276,2,OdaMaeBrown,2147,1551,88,83,171,51.5%,1h
42276,2,Lilit,2147,1016,39,37,76,51.3%,3m
42276,1,ZboutsaDis,2147,785,39,42,81,48.1%,1h
42276,1,Maestro,2147,1142,37,46,83,44.6%,32m
42276,2,[SPAINs]Danichu,2147,891,33,31,64,51.6%,1h
42276,2,Feszes,2147,868,32,31,63,50.8%,29m
42276,2,Diamant,2147,559,28,23,51,54.9%,1h
42276,2,fredyfred,2147,642,22,24,46,47.8%,1h
42276,2,Антоша,2147,491,20,20,40,50.0%,22m
42276,1,KlerikVoo,2147,464,14,24,38,36.8%,1h
42276,1,Greshnik,2147,366,11,17,28,39.3%,1h
42276,2,Butcher,2147,295,10,7,17,58.8%,18m
42276,1,FejkoAjkula,2147,304,10,11,21,47.6%,1h
42276,1,Argoniel,2147,342,10,17,27,37.0%,32m
42276,1,sniplit,2147,284,9,9,18,50.0%,28m
42276,1,Windwalker,2147,178,5,7,12,41.7%,17m
42276,3,Shathae,2147,179,5,13,18,27.8%,15m
42276,2,Alexis,2147,172,4,3,7,57.1%,19m
42276,2,BlueBerry,2147,90,4,3,7,57.1%,1h
42276,2,Terminator,2147,116,4,5,9,44.4%,32m
42276,2,Sceleminator,2147,122,3,3,6,50.0%,31m
42276,2,sunglassdog,2147,92,3,8,11,27.3%,1h
42276,3,Bhaalspawn,2147,102,3,10,13,23.1%,24m
42276,2,Duffy,2147,30,2,1,3,66.7%,23m
42276,2,WhoOne,2147,30,2,2,4,50.0%,1h
42276,2,Rufi,2147,99,2,7,9,22.2%,1h
42276,2,Wario,2147,92,2,8,10,20.0%,1h
42276,3,LordGE,2147,95,2,8,10,20.0%,28m
42276,2,tTireAuCoeur,2147,0,1,0,1,100.0%,19m
42276,2,[SaZ]MaXiMus,2147,46,1,1,2,50.0%,31m
42276,2,Modather,2147,30,1,3,4,25.0%,1h
42276,1,KOOLSAN,2147,0,1,6,7,14.3%,1h
42276,2,Michy,2147,0,1,6,7,14.3%,28m
42276,2,Pavlovna,2147,0,0,1,1,0.0%,22m
42276,2,[Aw3]Purelight,2147,0,0,1,1,0.0%,31m
42276,2,Mario,2147,0,0,1,1,0.0%,1h
42276,2,PsewDoKnight,2147,0,0,1,1,0.0%,4m
42276,2,BleaK,2147,0,0,1,1,0.0%,22m
42276,2,Imperator,2147,0,0,5,5,0.0%,1h
42316,1,pastisao,2146,1326,90,100,190,47.4%,12m
42316,1,wandius,2146,1646,72,80,152,47.4%,1h
42316,3,VBR,2146,936,67,74,141,47.5%,5m
42316,1,Amou,2146,1134,40,46,86,46.5%,3m
42316,2,[220AC]Manu,2146,923,39,35,74,52.7%,1h
42316,2,Zoblar,2146,438,25,24,49,51.0%,13m
42316,2,BattleStar,2146,403,19,17,36,52.8%,14m
42316,2,MorFlings,2146,365,18,4,22,81.8%,28m
42316,2,[ayф]slava,2146,416,17,14,31,54.8%,1h
42316,2,Samppanja,2146,261,15,19,34,44.1%,1h
42316,2,Gideon,2146,288,9,7,16,56.2%,1h
42316,3,Гром,2146,130,6,14,20,30.0%,1h
42316,2,[FunFR]Iken,2146,128,5,7,12,41.7%,16m
42316,2,Aranog,2146,124,5,9,14,35.7%,20m
42316,2,[N2SN]TylerDurden,2146,98,4,7,11,36.4%,1h
42316,2,TasteOfLife,2146,46,2,0,2,100.0%,1h
42316,1,Manuel,2146,48,2,1,3,66.7%,4m
42316,1,Sultanius,2146,119,2,2,4,50.0%,31m
42316,1,gvardeezVK,2146,0,1,0,1,100.0%,1h
42316,2,[Dobro]TEW,2146,0,1,1,2,50.0%,23m
42316,2,kseroys,2146,30,1,1,2,50.0%,4m
42316,2,Nikfinson,2146,0,1,2,3,33.3%,1h
42316,2,Furia,2146,30,1,2,3,33.3%,33m
42316,1,tijgerketwee,2146,96,1,3,4,25.0%,1h
42316,2,[Kopf]Paulkunze,2146,30,1,6,7,14.3%,1h
42316,1,[BLSS]Melancholion,2146,0,0,1,1,0.0%,31m
42316,2,Smetanka,2146,0,0,4,4,0.0%,29m
42316,3,Alone,2146,0,0,5,5,0.0%,1h
42316,3,Holland,2146,0,0,5,5,0.0%,1h
42316,1,BobbyLapoint,2146,0,0,7,7,0.0%,1h
42346,1,spellsong,2145,1274,73,87,160,45.6%,1h
42346,2,PeaceAndLove,2145,1414,63,59,122,51.6%,7m
42346,2,Paranoid,2145,1393,59,56,115,51.3%,1h
42346,2,Castagueule,2145,478,53,50,103,51.5%,14m
42346,2,WingNut,2145,968,38,34,72,52.8%,29m
42346,1,Daniiiiiiii,2145,953,33,36,69,47.8%,30m
42346,2,MrFreeman,2145,919,33,37,70,47.1%,31m
42346,2,PinkMonkey,2145,750,27,32,59,45.8%,27m
42346,2,ТеСей,2145,528,22,14,36,61.1%,19m
42346,2,Krovav,2145,466,19,14,33,57.6%,1h
42346,2,DarkKing,2145,482,18,16,34,52.9%,31m
42346,2,Davide,2145,472,17,17,34,50.0%,29m
42346,2,Kibbicer,2145,413,14,23,37,37.8%,1h
42346,2,IIIIIIIIIIII,2145,252,9,9,18,50.0%,1h
42346,1,DaiOmmA,2145,326,9,20,29,31.0%,4m
42346,2,EBayOR,2145,254,8,8,16,50.0%,1h
42346,3,Подлимир,2145,271,8,10,18,44.4%,33m
42346,2,Bzz,2145,292,8,13,21,38.1%,1h
42346,2,MiniTitan,2145,151,6,8,14,42.9%,1h
42346,1,JornSnow,2145,189,5,4,9,55.6%,33m
42346,2,zeratul,2145,126,3,2,5,60.0%,15m
42346,2,[Ahmed]Rumblefish,2145,49,3,2,5,60.0%,1h
42346,1,ultraviolisk,2145,114,3,10,13,23.1%,1h
42346,2,EvGT,2145,30,2,1,3,66.7%,1h
42346,2,madrobert,2145,0,2,4,6,33.3%,1h
42346,2,MrWorleg,2145,119,2,5,7,28.6%,30m
42346,2,Rouky,2145,0,1,4,5,20.0%,3m
42346,2,Odin,2145,0,1,5,6,16.7%,1h
42346,1,[ПРОбка]menyflaffin,2145,0,1,6,7,14.3%,4m
42346,1,Armmartin,2145,32,1,8,9,11.1%,1h
42346,1,LilProbius,2145,0,0,1,1,0.0%,7m
42346,2,MikeloCrick,2145,0,0,2,2,0.0%,1h
42346,2,Kostalap,2145,0,0,2,2,0.0%,1h
42346,2,Zuber,2145,0,0,3,3,0.0%,1h
42346,2,DredDoyg,2145,0,0,3,3,0.0%,1h
42346,2,arcoswat,2145,0,0,4,4,0.0%,23m
42346,2,Xavis,2145,0,0,5,5,0.0%,1h
42346,2,samurai,2145,0,0,5,5,0.0%,9m
42384,1,Jempa,2144,1657,211,213,424,49.8%,1h
42384,1,MWSURFER,2144,1692,152,161,313,48.6%,1h
42384,1,Zoul,2144,977,98,112,210,46.7%,19m
42384,2,trip,2144,1500,60,64,124,48.4%,1h
42384,2,Энергетик,2144,592,32,37,69,46.4%,11m
42384,2,Marcinos,2144,512,23,19,42,54.8%,1h
42384,2,MaggotDream,2144,365,22,21,43,51.2%,24m
42384,2,RinatST,2144,208,7,11,18,38.9%,1h
42384,2,[4or5t]pWaHn,2144,142,5,9,14,35.7%,1h
42384,2,Leizu,2144,30,3,5,8,37.5%,19m
42384,3,TaBi,2144,97,2,0,2,100.0%,32m
42384,2,Kvant,2144,34,2,1,3,66.7%,1h
42384,1,BloodyRusk,2144,143,2,2,4,50.0%,1h
42384,2,Soxc,2144,62,2,6,8,25.0%,32m
42384,2,GunO,2144,134,2,6,8,25.0%,1h
42384,3,ohnezahn,2144,93,2,8,10,20.0%,15m
42384,2,Zerg,2144,0,1,0,1,100.0%,1h
42384,2,[sksksk]starspl,2144,30,1,2,3,33.3%,1h
42384,2,Sunzy,2144,0,1,5,6,16.7%,1h
42384,1,Bulka,2144,0,1,7,8,12.5%,8m
42384,1,liquidMaNa,2144,48,1,21,22,4.5%,28m
42384,2,[OMiD]OUBLANK,2144,0,0,1,1,0.0%,1h
42384,2,sugus,2144,0,0,3,3,0.0%,8m
42384,2,Dynamo,2144,0,0,3,3,0.0%,33m
42384,3,Fumety,2144,0,0,5,5,0.0%,1h
42409,1,CRIMSONDEATH,2143,1709,445,495,940,47.3%,1h
42409,2,Kreminauta,2143,1498,77,79,156,49.4%,13m
42409,1,BrakusEST,2143,1690,69,69,138,50.0%,1h
42409,2,ssksk,2143,1020,57,56,113,50.4%,11m
42409,2,Kemi,2143,1255,53,54,107,49.5%,12m
42409,2,jiji,2143,906,37,28,65,56.9%,33m
42409,2,Mashinel,2143,706,24,24,48,50.0%,4m
42409,2,weler,2143,500,17,21,38,44.7%,1h
42409,2,sirgio,2143,356,13,9,22,59.1%,31m
42409,2,Petrie,2143,322,12,13,25,48.0%,32m
42409,2,Kira,2143,287,10,7,17,58.8%,24m
42409,1,corallus,2143,287,9,9,18,50.0%,1h
42409,2,FRIEND,2143,252,8,4,12,66.7%,1h
42409,1,[21377]AwaryK,2143,167,4,2,6,66.7%,1h
42409,2,KTIGANAAR,2143,60,4,7,11,36.4%,1h
42409,2,Spawninho,2143,94,3,3,6,50.0%,23m
42409,1,Adrien,2143,145,3,6,9,33.3%,31m
42409,1,pietrzyk,2143,145,3,9,12,25.0%,1h
42409,2,BigAl,2143,124,2,1,3,66.7%,8m
42409,2,Konradoziom,2143,102,2,1,3,66.7%,1h
42409,1,huguer,2143,120,2,3,5,40.0%,22m
42409,2,Captain,2143,0,1,0,1,100.0%,1h
42409,2,EgroX,2143,0,1,0,1,100.0%,1h
42409,2,VelvetyMoose,2143,0,1,4,5,20.0%,14m
42409,2,[tYOSHI]silver,2143,30,1,6,7,14.3%,4m
42409,3,hAWk,2143,0,0,1,1,0.0%,1h
42409,2,[ESLPro]Solar,2143,0,0,1,1,0.0%,20m
42409,2,llllllllllll,2143,0,0,1,1,0.0%,11m
42409,2,EvilTankKeks,2143,0,0,1,1,0.0%,1h
42409,2,ggg,2143,0,0,5,5,0.0%,1h
42439,1,pelican,2142,1596,194,199,393,49.4%,13m
42439,1,barza,2142,1685,186,184,370,50.3%,1h
42439,2,SANFROIX,2142,1501,117,117,234,50.0%,4m
42439,2,Caligula,2142,1456,93,100,193,48.2%,29m
42439,1,Ironmelter,2142,1402,81,74,155,52.3%,1h
42439,1,Faralife,2142,939,62,71,133,46.6%,1h
42439,2,Underground,2142,451,39,38,77,50.6%,1h
42439,1,Kulebyaka,2142,603,27,27,54,50.0%,4m
42439,1,DarkRonin,2142,725,26,34,60,43.3%,1h
42439,1,Atar,2142,591,25,28,53,47.2%,17m
42439,1,[Dralag]FatCocк,2142,447,17,15,32,53.1%,1h
42439,2,[VuV]AiGiL,2142,488,15,20,35,42.9%,1h
42439,2,Varg,2142,420,13,20,33,39.4%,1h
42439,2,Stockish,2142,116,5,3,8,62.5%,1h
42439,2,ClutchMaster,2142,112,5,4,9,55.6%,14m
42439,2,MassivePOES,2142,122,5,8,13,38.5%,9m
42439,3,sailor,2142,175,5,13,18,27.8%,1h
42439,1,[FC1]Francesco,2142,237,4,3,7,57.1%,5m
42439,2,Alex,2142,164,4,8,12,33.3%,19m
42439,1,[GTDK]Korrox,2142,144,3,3,6,50.0%,18m
42439,2,[ZUA]monochrom,2142,108,3,6,9,33.3%,1h
42439,2,[BKEG]MarkoDeHans,2142,30,2,1,3,66.7%,1h
42439,2,pertur,2142,0,2,5,7,28.6%,1h
42439,3,RunOver,2142,0,2,8,10,20.0%,2m
42439,2,Барон,2142,0,2,8,10,20.0%,6m
42439,2,[LE3]Versus,2142,0,1,0,1,100.0%,1h
42439,2,HeKTiKTiMeS,2142,0,1,0,1,100.0%,24m
42439,2,scooter,2142,0,1,5,6,16.7%,29m
42439,2,NeonWolf,2142,0,1,6,7,14.3%,15m
42439,1,MarceliD,2142,0,1,6,7,14.3%,1h
42439,2,loxa,2142,0,0,1,1,0.0%,1h
42439,2,Istifater,2142,0,0,1,1,0.0%,13m
42471,2,[OmDi]BeAver,2141,1215,125,126,251,49.8%,1h
42471,2,normanbeats,2141,1552,121,128,249,48.6%,22m
42471,1,covid,2141,1556,105,111,216,48.6%,19m
42471,1,kramis,2141,1395,71,61,132,53.8%,28m
42471,1,Judofson,2141,1118,54,54,108,50.0%,32m
42471,1,Fakirio,2141,1097,39,38,77,50.6%,12m
42471,2,Nico,2141,777,31,26,57,54.4%,1h
42471,2,Paultergaist,2141,864,31,33,64,48.4%,1h
42471,2,Kens,2141,541,21,22,43,48.8%,15m
42471,2,TONY,2141,298,10,7,17,58.8%,29m
42471,2,Omaewa,2141,234,9,9,18,50.0%,18m
42471,2,Shmelll,2141,254,9,13,22,40.9%,4m
42471,1,Xardas,2141,311,8,13,21,38.1%,30m
42471,1,ultimus,2141,272,8,13,21,38.1%,6m
42471,2,MPaK,2141,240,7,6,13,53.8%,1h
42471,1,TheYinn,2141,236,6,18,24,25.0%,1h
42471,3,Egat,2141,106,5,13,18,27.8%,21m
42471,2,RedWolf,2141,88,4,5,9,44.4%,24m
42471,2,[OGCC]Lua,2141,130,4,9,13,30.8%,1h
42471,2,Robert,2141,30,2,0,2,100.0%,1h
42471,2,[Khemor]warpietro,2141,30,2,1,3,66.7%,1h
42471,2,[TC212]TerrorWolf,2141,48,1,4,5,20.0%,1h
42471,2,erenzy,2141,32,1,5,6,16.7%,1h
42471,2,PavianMobutu,2141,0,0,1,1,0.0%,4m
42471,1,softreform,2141,0,0,5,5,0.0%,1h
42471,3,Dolthran,2141,0,0,5,5,0.0%,1h
42471,3,Kamenia,2141,0,0,5,5,0.0%,27m
42498,1,anjin,2140,1644,207,231,438,47.3%,31m
42498,3,muhojuck,2140,1352,72,90,162,44.4%,22m
42498,1,akurilo,2140,1206,43,44,87,49.4%,4m
42498,1,RanL,2140,638,27,23,50,54.0%,31m
42498,2,VoiDDD,2140,602,24,21,45,53.3%,1h
42498,2,Corky,2140,519,19,16,35,54.3%,1h
42498,2,Masuga,2140,438,16,12,28,57.1%,1h
42498,2,Axer,2140,156,12,12,24,50.0%,29m
42498,2,NoodleDoodle,2140,346,10,17,27,37.0%,1h
42498,2,shatoo,2140,254,9,13,22,40.9%,1h
42498,2,Bloon,2140,250,9,13,22,40.9%,20m
42498,1,Gaborul,2140,189,8,6,14,57.1%,30m
42498,3,GaPJIuK,2140,207,6,14,20,30.0%,30m
42498,2,Accendant,2140,99,5,5,10,50.0%,15m
42498,2,Erik,2140,60,4,5,9,44.4%,29m
42498,2,SpongeMan,2140,64,4,7,11,36.4%,1h
42498,1,Пашка,2140,116,4,9,13,30.8%,1h
42498,2,Niroog,2140,62,3,2,5,60.0%,30m
42498,2,[Papsou]Fern,2140,46,3,6,9,33.3%,1h
42498,1,Schorschi,2140,155,3,9,12,25.0%,32m
42498,2,RassBroKZ,2140,58,2,2,4,50.0%,1h
42498,2,Purivan,2140,60,2,3,5,40.0%,30m
42498,2,[MdbS]NeverGind,2140,64,2,4,6,33.3%,4m
42498,2,Kusanagi,2140,34,2,5,7,28.6%,1h
42498,1,Waddofok,2140,48,2,8,10,20.0%,2m
42498,1,Siarc,2140,48,1,1,2,50.0%,5m
42498,2,Flonsus,2140,30,1,2,3,33.3%,1h
42498,2,MaxBlack,2140,0,0,1,1,0.0%,23m
42498,2,Xamik,2140,0,0,1,1,0.0%,1h
42498,2,Alfa,2140,0,0,3,3,0.0%,11m
42498,2,Gromflomite,2140,0,0,4,4,0.0%,26m
42498,3,Harvax,2140,0,0,4,4,0.0%,1h
42498,3,Arvels,2140,0,0,5,5,0.0%,10m
42498,3,Jugien,2140,0,0,5,5,0.0%,31m
42498,2,AwesomNelson,2140,0,0,5,5,0.0%,27m
42533,1,Zathras,2139,1680,204,212,416,49.0%,27m
42533,2,GANGSTOONER,2139,1433,144,147,291,49.5%,30m
42533,2,TasCareaga,2139,1549,122,119,241,50.6%,24m
42533,2,Arzi,2139,898,37,29,66,56.1%,1h
42533,2,Nides,2139,731,32,26,58,55.2%,1h
42533,2,[GachiL]IHackMan,2139,860,32,32,64,50.0%,1h
42533,2,rivermora,2139,418,16,15,31,51.6%,19m
42533,1,FoXiK,2139,433,15,24,39,38.5%,31m
42533,1,Midzenis,2139,412,13,21,34,38.2%,1h
42533,2,Patucho,2139,248,10,8,18,55.6%,1h
42533,1,EnyBreezz,2139,310,8,11,19,42.1%,18m
42533,1,sergeif,2139,235,8,13,21,38.1%,32m
42533,2,Chicken,2139,90,5,6,11,45.5%,13m
42533,2,xin,2139,177,5,15,20,25.0%,1h
42533,1,NightRaven,2139,193,4,5,9,44.4%,1h
42533,2,Megam,2139,0,3,3,6,50.0%,1h
42533,2,Aaron,2139,90,3,5,8,37.5%,1h
42533,1,Lucy,2139,104,2,3,5,40.0%,4m
42533,1,LevDraiv,2139,48,2,8,10,20.0%,14m
42533,3,Pater,2139,0,1,4,5,20.0%,1h
42533,2,Ifndef,2139,0,0,1,1,0.0%,11m
42533,3,RMG,2139,0,0,1,1,0.0%,1h
42533,3,CeBuK,2139,0,0,1,1,0.0%,1h
42533,1,Begemot,2139,0,0,2,2,0.0%,1h
42533,3,[рейнор]буба,2139,0,0,4,4,0.0%,8m
42533,3,GameReclaim,2139,0,0,5,5,0.0%,1h
42533,3,Matys,2139,0,0,5,5,0.0%,1h
42533,3,AdviiPlays,2139,0,0,5,5,0.0%,1h
42561,1,swazy,2138,1507,116,111,227,51.1%,11m
42561,2,Glivi,2138,1240,55,58,113,48.7%,1h
42561,1,ghaelen,2138,643,34,33,67,50.7%,1h
42561,1,[SC2SA]BlayiD,2138,633,31,31,62,50.0%,1h
42561,1,Ivanv,2138,564,18,27,45,40.0%,1h
42561,2,[Tuur]Ярослав,2138,428,16,10,26,61.5%,1h
42561,2,Vladimir,2138,262,11,3,14,78.6%,1h
42561,1,[mfxed]DzikaPralka,2138,349,11,23,34,32.4%,33m
42561,1,lunnterik,2138,283,10,15,25,40.0%,1h
42561,1,ChillyWilly,2138,147,6,8,14,42.9%,1h
42561,2,ADANRO,2138,167,5,3,8,62.5%,23m
42561,2,JoSj,2138,118,5,5,10,50.0%,1h
42561,2,[GGGLHF]noah,2138,144,4,3,7,57.1%,1h
42561,2,Limonchik,2138,88,3,2,5,60.0%,24m
42561,1,Emil,2138,0,3,3,6,50.0%,1h
42561,2,Mamai,2138,123,2,6,8,25.0%,20m
42561,3,Sergey,2138,30,2,10,12,16.7%,1h
42561,2,Feomer,2138,0,1,0,1,100.0%,1h
42561,2,Catanelu,2138,30,1,2,3,33.3%,1h
42561,2,[FeaZy]IceArd,2138,30,1,3,4,25.0%,1h
42561,1,Доминеон,2138,0,1,4,5,20.0%,1h
42561,2,peterb,2138,30,1,6,7,14.3%,14m
42561,1,Kozwix,2138,0,1,7,8,12.5%,1h
42561,1,KOLOSSDAN,2138,0,1,7,8,12.5%,18m
42561,2,[PLA2N]Menorik,2138,0,0,1,1,0.0%,1h
42561,2,Rumrie,2138,0,0,1,1,0.0%,24m
42561,2,CmIschariot,2138,0,0,2,2,0.0%,1h
42561,2,Todsen,2138,0,0,2,2,0.0%,13m
42561,2,sloffenjager,2138,0,0,2,2,0.0%,13m
42561,2,kmaster,2138,0,0,3,3,0.0%,1h
42561,2,PinkPanther,2138,0,0,4,4,0.0%,17m
42561,3,Vandalheart,2138,0,0,5,5,0.0%,1h
42561,1,[Corpo]Royxade,2138,0,0,5,5,0.0%,13m
42594,1,Pitrs,2137,1699,335,352,687,48.8%,1h
42594,1,JAM,2137,1646,180,178,358,50.3%,1h
42594,2,StoneCutter,2137,1134,99,100,199,49.7%,1h
42594,2,Gretsky,2137,1421,94,92,186,50.5%,18m
42594,2,Mogwai,2137,1597,87,94,181,48.1%,30m
42594,1,Ivan,2137,1657,85,90,175,48.6%,15m
42594,2,[iLOSE]karabatic,2137,1582,58,63,121,47.9%,1h
42594,2,jmenya,2137,1464,52,69,121,43.0%,1h
42594,2,Korn,2137,1281,50,53,103,48.5%,23m
42594,1,Morpherrer,2137,650,33,27,60,55.0%,14m
42594,1,badukone,2137,690,20,35,55,36.4%,29m
42594,2,[TPZGG]Metalhead,2137,324,18,17,35,51.4%,15m
42594,2,DimazKamaz,2137,427,15,14,29,51.7%,23m
42594,2,[MOFFO]EmanueleITA,2137,297,12,5,17,70.6%,1h
42594,2,hangoverRR,2137,328,11,10,21,52.4%,25m
42594,1,Hasir,2137,288,9,11,20,45.0%,4m
42594,2,SnakeHips,2137,158,5,9,14,35.7%,1h
42594,2,ESTERMINADOR,2137,58,4,3,7,57.1%,11m
42594,1,Sibiryak,2137,144,4,10,14,28.6%,6m
42594,2,GhosT,2137,0,3,2,5,60.0%,32m
42594,2,Willknite,2137,0,3,2,5,60.0%,1h
42594,2,StarLord,2137,74,3,3,6,50.0%,1h
42594,2,Bell,2137,32,2,3,5,40.0%,1h
42594,1,Linart,2137,145,2,3,5,40.0%,5m
42594,2,Exodo,2137,0,2,3,5,40.0%,1h
42594,2,FOUDRE,2137,0,1,0,1,100.0%,31m
42594,2,[LawDa]Джим,2137,0,1,1,2,50.0%,1h
42594,2,ATARI,2137,30,1,1,2,50.0%,1h
42594,2,SleepyAF,2137,0,1,1,2,50.0%,1h
42594,2,Edy,2137,94,1,6,7,14.3%,8m
42594,1,[liPG]NeonNAX,2137,0,0,1,1,0.0%,16m
42594,2,AmiralIce,2137,0,0,1,1,0.0%,31m
42594,2,ICY,2137,0,0,1,1,0.0%,1h
42594,2,redv,2137,0,0,2,2,0.0%,19m
42628,1,timsah,2136,1670,131,134,265,49.4%,1h
42628,1,Kula,2136,1685,82,81,163,50.3%,6m
42628,1,Kess,2136,1248,54,50,104,51.9%,1h
42628,1,Imperator,2136,808,37,40,77,48.1%,13m
42628,2,ajslan,2136,980,37,42,79,46.8%,1h
42628,2,[RusGG]Pol,2136,590,20,24,44,45.5%,1h
42628,1,Lev,2136,611,19,22,41,46.3%,1h
42628,2,Cambreden,2136,416,15,17,32,46.9%,1h
42628,1,Evgeshka,2136,454,14,23,37,37.8%,1h
42628,3,Radu,2136,443,14,33,47,29.8%,1h
42628,2,Flavi,2136,322,13,12,25,52.0%,11m
42628,2,Sampsunator,2136,410,13,20,33,39.4%,26m
42628,1,CHURCHILL,2136,192,7,12,19,36.8%,8m
42628,2,Sairs,2136,0,4,1,5,80.0%,4m
42628,2,AronWinner,2136,150,4,3,7,57.1%,23m
42628,2,bigstarnik,2136,86,3,3,6,50.0%,31m
42628,2,MaxMocelot,2136,88,3,3,6,50.0%,11m
42628,2,Halesy,2136,0,2,3,5,40.0%,29m
42628,1,iesth,2136,88,2,11,13,15.4%,3m
42628,2,Maladus,2136,0,1,0,1,100.0%,1h
42628,1,Dark,2136,48,1,2,3,33.3%,26m
42628,2,HeroDG,2136,0,1,2,3,33.3%,29m
42628,3,Billy,2136,0,1,4,5,20.0%,31m
42628,2,Carlson,2136,88,1,6,7,14.3%,1h
42628,1,Jay,2136,0,1,7,8,12.5%,1h
42628,2,Marksman,2136,0,1,9,10,10.0%,22m
42628,1,Elymas,2136,0,0,1,1,0.0%,31m
42628,2,Zarman,2136,0,0,1,1,0.0%,1h
42628,1,Maniaty,2136,0,0,2,2,0.0%,1h
42628,1,Puschi,2136,0,0,4,4,0.0%,7m
42658,2,scs,2135,1613,128,128,256,50.0%,1h
42658,1,GANIBBAL,2135,1238,95,94,189,50.3%,1h
42658,2,RoboWizard,2135,1601,74,74,148,50.0%,1h
42658,1,Baronshake,2135,1631,73,75,148,49.3%,22m
42658,1,SemGold,2135,984,47,48,95,49.5%,1h
42658,1,MeteoGhost,2135,1086,37,48,85,43.5%,1h
42658,2,Dormedont,2135,711,34,14,48,70.8%,9m
42658,2,Gyoza,2135,527,19,20,39,48.7%,9m
42658,3,Hexet,2135,507,17,22,39,43.6%,25m
42658,1,Starlords,2135,292,14,9,23,60.9%,1h
42658,1,aGaResorT,2135,512,14,25,39,35.9%,13m
42658,2,BoomBoomBoom,2135,348,11,16,27,40.7%,23m
42658,1,pabl,2135,372,11,21,32,34.4%,1h
42658,1,Bungalowbul,2135,209,7,12,19,36.8%,1h
42658,2,Katisha,2135,146,6,3,9,66.7%,1h
42658,1,dark,2135,162,5,9,14,35.7%,1h
42658,2,[FR1]ShahKaal,2135,94,4,9,13,30.8%,25m
42658,2,КОБА,2135,62,3,5,8,37.5%,1h
42658,2,Lucho,2135,86,3,7,10,30.0%,19m
42658,2,WhiteWidow,2135,157,3,7,10,30.0%,11m
42658,1,TROMPETUS,2135,97,3,7,10,30.0%,5m
42658,2,cnon,2135,30,2,0,2,100.0%,15m
42658,2,BorshNah,2135,46,2,1,3,66.7%,1h
42658,3,SebProo,2135,97,2,8,10,20.0%,1h
42658,1,Hierons,2135,48,2,8,10,20.0%,22m
42658,2,Roussetman,2135,0,1,1,2,50.0%,1h
42658,2,EMark,2135,30,1,4,5,20.0%,23m
42658,2,Shadnax,2135,0,1,6,7,14.3%,1h
42658,1,VmPzdC,2135,0,1,6,7,14.3%,1h
42658,3,BigSmoke,2135,0,1,7,8,12.5%,1h
42658,2,Smallkoii,2135,0,0,1,1,0.0%,1h
42658,2,wolfy,2135,0,0,1,1,0.0%,1h
42658,2,Greshnik,2135,0,0,1,1,0.0%,20m
42658,2,tdxev,2135,0,0,1,1,0.0%,1h
42658,3,чебурек,2135,0,0,1,1,0.0%,1h
42658,2,Istrildiar,2135,0,0,2,2,0.0%,19m
42658,2,Darkno,2135,0,0,3,3,0.0%,1h
42658,1,[GodEmp]max,2135,0,0,4,4,0.0%,19m
42658,1,Antszkol,2135,0,0,5,5,0.0%,4m
42697,2,Perecsz,2134,991,79,79,158,50.0%,32m
42697,2,Bombadillo,2134,607,56,59,115,48.7%,18m
42697,1,BlackWolf,2134,1259,49,56,105,46.7%,1h
42697,2,YuGin,2134,1147,42,47,89,47.2%,1h
42697,2,SirDeejo,2134,745,29,24,53,54.7%,1h
42697,2,maksimkla,2134,348,16,19,35,45.7%,14m
42697,1,andy,2134,346,12,21,33,36.4%,1h
42697,1,Happy,2134,298,9,14,23,39.1%,18m
42697,2,[mfxed]Faldhir,2134,186,6,22,28,21.4%,25m
42697,2,Prdak,2134,68,3,3,6,50.0%,1h
42697,2,OLIWIER,2134,48,3,4,7,42.9%,1h
42697,3,WINGS,2134,0,2,8,10,20.0%,1h
42697,2,[MaCCrO]MarshakSC,2134,0,1,0,1,100.0%,1h
42697,2,Protocelular,2134,0,1,0,1,100.0%,1h
42697,2,Jack,2134,30,1,2,3,33.3%,1h
42697,2,Dragos,2134,30,1,2,3,33.3%,23m
42697,2,Stocker,2134,30,1,6,7,14.3%,1h
42697,2,TROINYAK,2134,30,1,6,7,14.3%,5m
42697,1,Barbur,2134,0,1,7,8,12.5%,16m
42697,1,FIFer,2134,0,0,1,1,0.0%,30m
42697,3,gloubiboulga,2134,0,0,3,3,0.0%,1h
42697,3,kronos,2134,0,0,5,5,0.0%,1h
42697,3,Raptor,2134,0,0,5,5,0.0%,26m
42697,3,Turamir,2134,0,0,5,5,0.0%,1h
42721,1,discoursemon,2133,1546,59,56,115,51.3%,31m
42721,1,[DOKA2]Thunderstorm,2133,1537,58,68,126,46.0%,1h
42721,2,KissRem,2133,1107,47,39,86,54.7%,1h
42721,2,[mfxed]WitchHammer,2133,1063,43,33,76,56.6%,1h
42721,1,Ramaz,2133,665,34,38,72,47.2%,1h
42721,1,[NASDAQ]PeaWeedLoveM,2133,460,17,31,48,35.4%,31m
42721,2,LysaRs,2133,456,15,22,37,40.5%,30m
42721,1,wend,2133,334,13,5,18,72.2%,1h
42721,2,OvidiuA,2133,326,12,15,27,44.4%,1h
42721,2,Max,2133,300,10,12,22,45.5%,1h
42721,2,Maxwelll,2133,280,9,18,27,33.3%,1h
42721,2,[nbalm]Terran,2133,144,6,5,11,54.5%,22m
42721,2,limbowaltez,2133,58,5,4,9,55.6%,1h
42721,3,max,2133,127,4,11,15,26.7%,1h
42721,1,NexXxus,2133,0,3,4,7,42.9%,4m
42721,2,CaptPekkinen,2133,136,3,6,9,33.3%,1h
42721,2,xMihak,2133,30,2,1,3,66.7%,1h
42721,2,Stegnuti,2133,60,2,6,8,25.0%,30m
42721,2,Spoorey,2133,0,2,9,11,18.2%,1h
42721,2,InConflict,2133,90,1,1,2,50.0%,11m
42721,2,svitoi,2133,97,1,2,3,33.3%,1h
42721,2,Smeden,2133,0,0,1,1,0.0%,11m
42721,2,Lou,2133,0,0,1,1,0.0%,9m
42721,2,sztinka,2133,0,0,1,1,0.0%,26m
42721,2,SPECTRA,2133,0,0,1,1,0.0%,1h
42721,3,GADver,2133,0,0,5,5,0.0%,26m
42747,2,SolarCielo,2132,1600,250,253,503,49.7%,5m
42747,2,abalelsamim,2132,1599,195,200,395,49.4%,19m
42747,2,LuckyPanda,2132,1626,93,97,190,48.9%,1h
42747,1,Kardok,2132,1222,89,94,183,48.6%,8m
42747,2,[MEGA02]RamilR,2132,1549,77,86,163,47.2%,19m
42747,1,[HaSKo]DVA,2132,1189,48,51,99,48.5%,25m
42747,2,Gavba,2132,952,35,39,74,47.3%,13m
42747,2,KeepITcool,2132,810,34,32,66,51.5%,26m
42747,1,[TB02]Moskit,2132,904,33,34,67,49.3%,19m
42747,1,prometheus,2132,913,33,38,71,46.5%,12m
42747,2,PatLOrD,2132,504,19,17,36,52.8%,1h
42747,1,Goyim,2132,567,19,22,41,46.3%,8m
42747,2,Asker,2132,432,17,13,30,56.7%,25m
42747,2,TwixArmy,2132,346,12,13,25,48.0%,1h
42747,2,Vektor,2132,304,11,11,22,50.0%,1h
42747,2,Kapsha,2132,209,8,3,11,72.7%,1h
42747,3,BroiduKrane,2132,229,7,15,22,31.8%,13m
42747,2,Flipster,2132,114,2,2,4,50.0%,1h
42747,2,[CIU2]pierugo,2132,70,2,3,5,40.0%,14m
42747,2,Afon,2132,0,2,3,5,40.0%,1h
42747,2,drschmidt,2132,0,2,4,6,33.3%,13m
42747,2,Gruumer,2132,30,2,6,8,25.0%,4m
42747,2,Nissepistol,2132,0,1,0,1,100.0%,1h
42747,3,DaiTo,2132,0,1,4,5,20.0%,1h
42747,1,Sawawa,2132,0,1,10,11,9.1%,1h
42747,1,nach,2132,0,0,1,1,0.0%,25m
42747,2,Spetsnaz,2132,0,0,1,1,0.0%,1h
42747,2,keimip,2132,0,0,1,1,0.0%,29m
42747,2,MarćinIIIPL,2132,0,0,2,2,0.0%,5m
42747,2,GChomik,2132,0,0,2,2,0.0%,1h
42747,1,Futon,2132,0,0,3,3,0.0%,1h
42747,3,Razer,2132,0,0,5,5,0.0%,1h
42779,2,akos,2131,1501,289,297,586,49.3%,1h
42779,1,Egbert,2131,1682,166,175,341,48.7%,12m
42779,2,MANU,2131,1557,140,154,294,47.6%,1h
42779,1,ShAkA,2131,1659,114,114,228,50.0%,4m
42779,1,pOtInCk,2131,1377,63,69,132,47.7%,1h
42779,1,ineedajob,2131,937,50,58,108,46.3%,1h
42779,2,Koraitem,2131,963,47,43,90,52.2%,11m
42779,1,Cloudbob,2131,828,35,30,65,53.8%,8m
42779,2,TreeLoys,2131,632,23,27,50,46.0%,10m
42779,1,Lars,2131,620,22,28,50,44.0%,1h
42779,1,quakeboss,2131,583,19,30,49,38.8%,19m
42779,2,MAH,2131,400,16,21,37,43.2%,1h
42779,1,Domon,2131,541,16,24,40,40.0%,4m
42779,2,Bazil,2131,256,8,12,20,40.0%,1h
42779,2,Lazy,2131,178,6,2,8,75.0%,26m
42779,1,Nafan,2131,178,5,12,17,29.4%,6m
42779,2,vanek,2131,165,4,7,11,36.4%,29m
42779,1,lazar,2131,140,3,9,12,25.0%,9m
42779,2,Invizzy,2131,30,2,3,5,40.0%,17m
42779,2,[canZeg]AlcalaCR,2131,30,2,4,6,33.3%,28m
42779,2,AlexRebel,2131,0,1,0,1,100.0%,13m
42779,2,Fejuu,2131,0,1,3,4,25.0%,32m
42779,2,Gabrielos,2131,99,1,4,5,20.0%,9m
42779,2,KrausePlenka,2131,0,1,5,6,16.7%,1h
42779,2,goodkat,2131,90,1,6,7,14.3%,1h
42779,1,[AchrK9]Paul,2131,0,1,7,8,12.5%,31m
42779,1,Xexu,2131,0,1,7,8,12.5%,1h
42779,1,liorivan,2131,0,1,7,8,12.5%,1h
42779,2,[ORM]TiSunstrider,2131,0,0,2,2,0.0%,32m
42779,3,Buck,2131,0,0,2,2,0.0%,27m
42809,3,haagendazs,2130,1592,379,404,783,48.4%,1h
42809,1,jpsbiggles,2130,1691,206,221,427,48.2%,1h
42809,2,KAKAKkia,2130,1070,154,161,315,48.9%,1h
42809,2,OttoRolf,2130,1436,59,53,112,52.7%,1h
42809,3,Kepi,2130,1316,54,74,128,42.2%,23m
42809,1,MrTree,2130,988,50,60,110,45.5%,27m
42809,1,Wachowski,2130,1012,40,45,85,47.1%,1h
42809,2,maks,2130,1001,39,43,82,47.6%,31m
42809,2,qKarloSp,2130,949,37,32,69,53.6%,19m
42809,2,Uncledave,2130,757,36,27,63,57.1%,1h
42809,2,Bloodybadger,2130,997,36,40,76,47.4%,18m
42809,1,IIIIIIIIIIII,2130,559,30,42,72,41.7%,1h
42809,2,MisterCoco,2130,652,27,17,44,61.4%,1h
42809,2,DeMoNiAc,2130,644,23,24,47,48.9%,19m
42809,2,IIIIIIIIIIII,2130,575,21,28,49,42.9%,32m
42809,2,Lorium,2130,540,20,19,39,51.3%,5m
42809,2,Toddyboy,2130,398,18,20,38,47.4%,19m
42809,2,Hydralisk,2130,394,16,18,34,47.1%,29m
42809,1,MOFFTARKIN,2130,372,13,31,44,29.5%,25m
42809,2,Chort,2130,278,11,5,16,68.8%,1h
42809,2,Lip,2130,294,11,6,17,64.7%,5m
42809,2,Pasha,2130,318,11,13,24,45.8%,1h
42809,3,GyroZeppeli,2130,251,9,15,24,37.5%,7m
42809,2,deimik,2130,204,8,6,14,57.1%,1h
42809,2,DooFi,2130,134,7,7,14,50.0%,23m
42809,1,DBFJ,2130,213,6,4,10,60.0%,1h
42809,2,Pushkinboy,2130,142,6,4,10,60.0%,23m
42809,2,Красимир,2130,188,6,12,18,33.3%,31m
42809,2,Ghost,2130,86,4,2,6,66.7%,14m
42809,2,Geks,2130,88,4,4,8,50.0%,1h
42809,2,Dalpa,2130,118,4,9,13,30.8%,1h
42809,3,Zeratul,2130,0,3,6,9,33.3%,1h
42809,1,hglff,2130,74,3,9,12,25.0%,11m
42809,1,Seyton,2130,97,2,5,7,28.6%,1h
42809,3,DarkSouter,2130,0,2,6,8,25.0%,2m
42809,1,aether,2130,125,2,9,11,18.2%,1h
42809,2,piratesman,2130,38,1,3,4,25.0%,29m
42809,2,Stalin,2130,0,1,3,4,25.0%,1h
42809,2,kowo,2130,0,0,1,1,0.0%,27m
42809,1,MMAzerg,2130,0,0,1,1,0.0%,8m
42809,1,KapustaMen,2130,0,0,1,1,0.0%,18m
42809,2,Macrameu,2130,0,0,2,2,0.0%,11m
42809,2,Hännes,2130,0,0,5,5,0.0%,25m
42809,2,Machtschluck,2130,0,0,5,5,0.0%,1h
42809,2,Rider,2130,0,0,6,6,0.0%,1h
42809,2,Auirz,2130,0,0,6,6,0.0%,8m
42855,1,Petkam,2129,1634,310,322,632,49.1%,20m
42855,2,Ader,2129,1568,268,301,569,47.1%,1h
42855,1,Atumba,2129,1295,127,136,263,48.3%,1h
42855,2,nipnap,2129,1624,126,129,255,49.4%,1h
42855,1,HangmanSmile,2129,1435,63,73,136,46.3%,8m
42855,2,[ZeRgg]SHKALKER,2129,755,28,30,58,48.3%,1h
42855,2,llllllllllll,2129,489,23,5,28,82.1%,1h
42855,2,Seppl,2129,260,20,14,34,58.8%,1h
42855,2,[AnSa]Wereseno,2129,379,18,19,37,48.6%,13m
42855,2,Titouan,2129,368,16,13,29,55.2%,1h
42855,2,Eitan,2129,334,12,10,22,54.5%,9m
42855,1,MrLoid,2129,323,10,14,24,41.7%,11m
42855,2,battleFly,2129,150,6,4,10,60.0%,1h
42855,2,realllko,2129,58,6,10,16,37.5%,11m
42855,2,robert,2129,120,5,4,9,55.6%,30m
42855,2,[FAJ]Crusher,2129,88,4,2,6,66.7%,14m
42855,2,MiXtap,2129,118,4,4,8,50.0%,25m
42855,2,Mammouth,2129,139,2,1,3,66.7%,15m
42855,2,Norfolks,2129,30,2,1,3,66.7%,32m
42855,2,AdmiralMrT,2129,141,2,7,9,22.2%,1h
42855,2,[DvX]Paperino,2129,109,2,8,10,20.0%,1h
42855,1,Artemiyd,2129,0,1,0,1,100.0%,7m
42855,2,SlinkyBoii,2129,0,1,0,1,100.0%,1h
42855,2,BadChinese,2129,0,1,1,2,50.0%,1h
42855,2,[PandS]Hellstorm,2129,0,1,1,2,50.0%,1h
42855,2,PharAoniC,2129,0,1,4,5,20.0%,1h
42855,2,Sarge,2129,30,1,4,5,20.0%,26m
42855,2,AlexPravoved,2129,0,0,1,1,0.0%,1h
42855,2,Sakayami,2129,0,0,2,2,0.0%,1h
42884,2,SashOK,2128,1513,125,130,255,49.0%,1h
42884,2,Gerolsteiner,2128,1068,63,72,135,46.7%,32m
42884,1,mcoder,2128,683,42,45,87,48.3%,20m
42884,2,Klekko,2128,805,32,32,64,50.0%,28m
42884,2,thebesttouft,2128,638,28,23,51,54.9%,1h
42884,2,KUDRYAVTSEV,2128,552,23,20,43,53.5%,29m
42884,2,GeorgiL,2128,598,23,25,48,47.9%,13m
42884,2,Bogfoot,2128,524,20,23,43,46.5%,1h
42884,1,Azgard,2128,308,9,15,24,37.5%,1h
42884,1,Ardan,2128,158,5,12,17,29.4%,1h
42884,2,ApostaL,2128,86,3,5,8,37.5%,19m
42884,2,Deadpool,2128,30,2,10,12,16.7%,11m
42884,2,Medax,2128,0,1,0,1,100.0%,1h
42884,2,EgaBy,2128,0,1,0,1,100.0%,1h
42884,2,[AusGam]evic,2128,0,1,0,1,100.0%,19m
42884,2,Bordun,2128,0,1,1,2,50.0%,1h
42884,2,Liikestar,2128,93,1,6,7,14.3%,28m
42884,2,liberador,2128,0,0,2,2,0.0%,1h
42902,2,Aalac,2127,1600,152,158,310,49.0%,30m
42902,2,[ULTX]Sieben,2127,1593,149,147,296,50.3%,1h
42902,2,[BHIT]Sherios,2127,1592,148,151,299,49.5%,1h
42902,3,Boba,2127,1385,93,104,197,47.2%,19m
42902,1,NoMaam,2127,1670,88,100,188,46.8%,24m
42902,3,ThomasGee,2127,789,32,37,69,46.4%,1h
42902,2,Ginkgobil,2127,539,31,23,54,57.4%,26m
42902,2,Petrolio,2127,668,24,27,51,47.1%,1h
42902,1,filipMKD,2127,654,20,26,46,43.5%,1h
42902,2,Hispano,2127,248,11,9,20,55.0%,13m
42902,2,DerGeraet,2127,172,7,10,17,41.2%,1h
42902,2,Zenton,2127,160,6,8,14,42.9%,1h
42902,2,Kaosboss,2127,118,5,7,12,41.7%,1h
42902,1,Schua,2127,104,5,10,15,33.3%,1h
42902,1,Khaldar,2127,140,3,1,4,75.0%,1h
42902,2,luczefer,2127,86,3,3,6,50.0%,1h
42902,2,DobpbIuPaBok,2127,70,2,4,6,33.3%,27m
42902,2,laguna,2127,0,2,7,9,22.2%,1h
42902,2,[Soldi]Ziv,2127,0,1,0,1,100.0%,14m
42902,3,Laocoon,2127,0,1,0,1,100.0%,1h
42902,2,Cuse,2127,89,1,5,6,16.7%,1h
42902,2,[TAQUEN]Steffen,2127,0,1,5,6,16.7%,1h
42902,3,huh,2127,0,1,8,9,11.1%,1h
42902,2,Tirodyn,2127,0,0,1,1,0.0%,4m
42902,2,[ALKM]kungfusnake,2127,0,0,1,1,0.0%,31m
42902,2,Ктовсехврот,2127,0,0,1,1,0.0%,11m
42902,2,Brainstorm,2127,0,0,1,1,0.0%,1h
42902,1,PanMaciek,2127,0,0,1,1,0.0%,16m
42902,2,LOPUH,2127,0,0,2,2,0.0%,1h
42902,3,CHOSEN,2127,0,0,2,2,0.0%,1h
42902,2,Bertl,2127,0,0,5,5,0.0%,30m
42902,2,Searcher,2127,0,0,5,5,0.0%,1h
42902,2,Viperfist,2127,0,0,5,5,0.0%,32m
42935,3,SOSA,2126,1514,273,279,552,49.5%,1h
42935,2,sergeo,2126,1458,98,102,200,49.0%,1h
42935,2,origion,2126,1527,88,92,180,48.9%,1h
42935,2,Alvaro,2126,1370,67,64,131,51.1%,18m
42935,2,TsunTsun,2126,1453,61,53,114,53.5%,23m
42935,2,SUN,2126,1328,51,57,108,47.2%,5m
42935,1,[laugh]Scan,2126,1228,42,47,89,47.2%,11m
42935,1,ARTHAS,2126,878,33,43,76,43.4%,1h
42935,2,eos,2126,414,17,21,38,44.7%,1h
42935,2,Maksimus,2126,258,11,6,17,64.7%,12m
42935,2,[Zhig]Nova,2126,280,10,7,17,58.8%,31m
42935,2,[aNNa]JeanneOscour,2126,256,9,12,21,42.9%,1h
42935,2,Noxus,2126,48,3,7,10,30.0%,1h
42935,2,[Cheel]oler,2126,154,3,10,13,23.1%,11m
42935,3,ZiS,2126,0,2,3,5,40.0%,30m
42935,2,GaviS,2126,73,2,9,11,18.2%,19m
42935,2,MoistLord,2126,0,1,1,2,50.0%,1h
42935,1,Moeruhasu,2126,48,1,2,3,33.3%,7m
42935,2,[COTV]Rambo,2126,30,1,5,6,16.7%,1h
42935,2,Pankrat,2126,30,1,5,6,16.7%,1h
42935,2,diman,2126,0,1,7,8,12.5%,1h
42935,2,Zumbaos,2126,30,1,8,9,11.1%,1h
42935,2,[zultra]mathias,2126,0,0,1,1,0.0%,28m
42935,2,Maksim,2126,0,0,1,1,0.0%,1h
42935,2,kIRa,2126,0,0,1,1,0.0%,1h
42935,2,CRAZYCAT,2126,0,0,1,1,0.0%,14m
42935,2,[GGVPD]LitchKing,2126,0,0,1,1,0.0%,1h
42935,2,Sepp,2126,0,0,1,1,0.0%,1h
42935,2,snnnik,2126,73,0,2,2,0.0%,7m
42935,1,jonika,2126,0,0,3,3,0.0%,7m
42965,2,Sesalin,2125,1588,183,203,386,47.4%,32m
42965,2,zelg,2125,1648,105,106,211,49.8%,5m
42965,2,Georgelly,2125,920,88,90,178,49.4%,11m
42965,1,MineOrgasm,2125,1080,75,82,157,47.8%,13m
42965,2,Skor,2125,1508,63,61,124,50.8%,29m
42965,1,Bellomortal,2125,727,54,68,122,44.3%,1h
42965,1,ChinnyNouNou,2125,1117,46,44,90,51.1%,1h
42965,2,[Bjj]Resciamenna,2125,1072,39,38,77,50.6%,1h
42965,2,Accusativus,2125,780,30,31,61,49.2%,1h
42965,1,[Zergal]Serene,2125,613,20,29,49,40.8%,14m
42965,2,[lOoOl]NoobyDoo,2125,438,15,19,34,44.1%,1h
42965,2,Djpredator,2125,334,12,13,25,48.0%,1h
42965,2,Sloker,2125,338,9,17,26,34.6%,18m
42965,1,Dorinush,2125,228,8,12,20,40.0%,1h
42965,2,узбек,2125,240,7,5,12,58.3%,1h
42965,2,Katsuranis,2125,229,7,17,24,29.2%,1h
42965,2,Alchem,2125,128,6,3,9,66.7%,1h
42965,1,MARSSON,2125,142,5,7,12,41.7%,23m
42965,2,Edmaker,2125,156,4,1,5,80.0%,1h
42965,2,Tankir,2125,118,4,7,11,36.4%,1h
42965,2,Ozzy,2125,142,4,9,13,30.8%,1h
42965,2,dymok,2125,46,2,2,4,50.0%,19m
42965,3,Arahmid,2125,0,2,3,5,40.0%,1h
42965,2,Awthur,2125,0,2,4,6,33.3%,1h
42965,2,NicoZ,2125,36,1,6,7,14.3%,1h
42965,1,evan,2125,0,1,9,10,10.0%,22m
42965,3,Крапива,2125,0,1,10,11,9.1%,33m
42965,2,eagle,2125,0,0,1,1,0.0%,4m
42965,2,Dolas,2125,0,0,1,1,0.0%,29m
42965,2,makspaghetti,2125,0,0,1,1,0.0%,1h
42995,2,Genri,2124,1421,55,54,109,50.5%,1h
42995,2,BoUbOuRsS,2124,1145,52,42,94,55.3%,1h
42995,2,HeLBerG,2124,1177,50,45,95,52.6%,1h
42995,2,Gambit,2124,989,38,41,79,48.1%,1h
42995,2,PREDATOR,2124,628,23,28,51,45.1%,19m
42995,2,SANTEY,2124,301,17,27,44,38.6%,1h
42995,2,EniGer,2124,420,15,13,28,53.6%,1h
42995,2,[WAR7]Manu,2124,327,12,10,22,54.5%,1h
42995,2,Arakin,2124,340,11,13,24,45.8%,11m
42995,1,HeavyDrinker,2124,206,8,14,22,36.4%,1h
42995,1,cuddlycub,2124,225,8,15,23,34.8%,1h
42995,1,Guzlishe,2124,240,6,14,20,30.0%,1h
42995,2,instasamka,2124,156,5,2,7,71.4%,1h
42995,1,Omega,2124,82,3,8,11,27.3%,1h
42995,1,Enrombus,2124,139,3,10,13,23.1%,1h
42995,2,Milan,2124,112,2,1,3,66.7%,26m
42995,1,chenandyk,2124,89,2,2,4,50.0%,1h
42995,1,Krabi,2124,0,2,7,9,22.2%,1h
42995,2,BTV,2124,62,2,8,10,20.0%,19m
42995,1,[ToolGG]Dethnought,2124,48,2,9,11,18.2%,7m
42995,2,HedgeHog,2124,0,1,0,1,100.0%,1h
42995,1,Vagulik,2124,0,1,1,2,50.0%,1h
42995,2,[skuft]toipo,2124,94,1,6,7,14.3%,20m
42995,2,Maximatey,2124,0,0,1,1,0.0%,31m
42995,2,nicco,2124,0,0,3,3,0.0%,1h
42995,2,[LQV]SupinPOL,2124,0,0,3,3,0.0%,11m
42995,3,LivingKING,2124,0,0,5,5,0.0%,1h
42995,3,Глеб,2124,0,0,5,5,0.0%,27m
43023,3,NOX,2123,615,128,147,275,46.5%,23m
43023,1,tib,2123,1674,121,130,251,48.2%,1h
43023,2,Störenfried,2123,1529,102,108,210,48.6%,24m
43023,3,EnsignSerj,2123,559,74,80,154,48.1%,17m
43023,1,Mega,2123,1346,51,55,106,48.1%,20m
43023,2,lolli,2123,1326,49,53,102,48.0%,26m
43023,2,OneEyed,2123,1018,40,41,81,49.4%,1h
43023,1,drobleur,2123,1234,39,46,85,45.9%,13m
43023,1,DSrus,2123,720,26,27,53,49.1%,4m
43023,2,Starman,2123,685,25,24,49,51.0%,1h
43023,2,jackherer,2123,301,23,29,52,44.2%,29m
43023,2,piotrek,2123,473,20,12,32,62.5%,30m
43023,1,Zaltoi,2123,422,15,26,41,36.6%,1h
43023,1,[em66]Stef,2123,295,12,17,29,41.4%,1h
43023,2,diamondlors,2123,308,11,12,23,47.8%,1h
43023,2,Shephiró,2123,272,9,15,24,37.5%,1h
43023,2,EnZ,2123,214,8,5,13,61.5%,1h
43023,2,netrix,2123,318,8,16,24,33.3%,4m
43023,2,mafiozo,2123,172,7,7,14,50.0%,9m
43023,2,Loris,2123,150,5,7,12,41.7%,1h
43023,2,Enem,2123,46,4,5,9,44.4%,4m
43023,2,Comunix,2123,144,4,6,10,40.0%,1h
43023,2,[CH70]Gargoyle,2123,93,2,4,6,33.3%,1h
43023,1,MarkoLeon,2123,42,2,4,6,33.3%,1h
43023,1,Medea,2123,96,2,4,6,33.3%,1h
43023,2,HelishShoman,2123,141,2,8,10,20.0%,16m
43023,2,LUISXV,2123,32,1,2,3,33.3%,1h
43023,2,maksim,2123,30,1,2,3,33.3%,6m
43023,2,Mocster,2123,30,1,2,3,33.3%,23m
43023,1,MaxProTTT,2123,94,1,2,3,33.3%,1h
43023,2,[CIU2]Nhio,2123,42,1,2,3,33.3%,1h
43023,1,LilSheep,2123,97,1,4,5,20.0%,1h
43023,2,mufka,2123,121,1,6,7,14.3%,4m
43023,2,[mcB0ng]niVoque,2123,0,1,7,8,12.5%,22m
43023,2,[сюда]DarkCookie,2123,0,0,1,1,0.0%,28m
43023,3,perepel,2123,0,0,2,2,0.0%,1h
43059,2,Laidyn,2122,965,52,16,68,76.5%,33m
43059,2,McN,2122,822,28,25,53,52.8%,10m
43059,2,Kralovna,2122,620,22,26,48,45.8%,1h
43059,1,ArACApOeirA,2122,623,21,27,48,43.8%,1h
43059,2,[CAI]Careear,2122,461,19,13,32,59.4%,1h
43059,2,Saadam,2122,500,19,29,48,39.6%,1h
43059,1,Silasdalion,2122,316,14,16,30,46.7%,1h
43059,1,zoldbeka,2122,387,9,22,31,29.0%,20m
43059,2,FalorRu,2122,334,8,14,22,36.4%,1h
43059,2,[Bouzeu]HenriRene,2122,147,6,10,16,37.5%,33m
43059,3,Mirodasc,2122,60,5,8,13,38.5%,1h
43059,2,[n1]BuRneR,2122,136,3,2,5,60.0%,1h
43059,2,GarikWolf,2122,92,3,4,7,42.9%,1h
43059,2,Niko,2122,88,1,3,4,25.0%,1h
43059,2,iDanny,2122,30,1,4,5,20.0%,1h
43059,2,Milflover,2122,0,0,1,1,0.0%,1h
43059,2,NAUTICER,2122,0,0,1,1,0.0%,23m
43059,2,VoidSlash,2122,0,0,1,1,0.0%,1h
43059,2,PowerNinja,2122,0,0,1,1,0.0%,32m
43059,2,FarAvay,2122,0,0,2,2,0.0%,1h
43059,1,голубь,2122,0,0,2,2,0.0%,7m
43059,2,МАРКС,2122,0,0,3,3,0.0%,13m
43059,2,[TrueMe]Dragonrider,2122,0,0,5,5,0.0%,11m
43082,3,JCM,2121,1406,199,210,409,48.7%,30m
43082,1,[nWss]gutbuster,2121,1027,156,155,311,50.2%,19m
43082,1,bnbarkas,2121,1633,73,75,148,49.3%,1h
43082,3,PseudoNERD,2121,1156,70,76,146,47.9%,1h
43082,2,StormForce,2121,872,32,35,67,47.8%,33m
43082,3,Billster,2121,800,32,41,73,43.8%,1h
43082,2,meng,2121,498,29,1,30,96.7%,1h
43082,2,[SergAt]ZELMAN,2121,461,18,12,30,60.0%,1h
43082,2,Driver,2121,328,12,12,24,50.0%,24m
43082,1,xefon,2121,245,11,17,28,39.3%,1h
43082,2,Merdock,2121,176,9,9,18,50.0%,29m
43082,2,JDOG,2121,277,6,10,16,37.5%,29m
43082,2,Disonda,2121,88,5,9,14,35.7%,4m
43082,2,CaseOfChaos,2121,175,5,12,17,29.4%,17m
43082,2,[DRÖM]Zentiic,2121,32,3,5,8,37.5%,14m
43082,2,Joel,2121,129,2,3,5,40.0%,1h
43082,2,ribki,2121,30,1,2,3,33.3%,13m
43082,2,BoBObOLIciU,2121,0,0,2,2,0.0%,27m
43082,3,Jaegar,2121,0,0,5,5,0.0%,1h
43101,2,Phobos,2120,1583,198,201,399,49.6%,19m
43101,1,Ronagon,2120,1456,147,144,291,50.5%,1h
43101,1,Kollioid,2120,1677,73,74,147,49.7%,1h
43101,2,karaburak,2120,1106,47,40,87,54.0%,13m
43101,2,юра,2120,479,20,14,34,58.8%,19m
43101,2,[Clewer]ZarTeen,2120,340,16,8,24,66.7%,1h
43101,2,Muldhog,2120,391,16,19,35,45.7%,1h
43101,1,Necha,2120,469,14,23,37,37.8%,31m
43101,2,mamenkoUaRu,2120,312,11,13,24,45.8%,29m
43101,2,William,2120,276,9,7,16,56.2%,18m
43101,1,BladeZK,2120,262,8,10,18,44.4%,1h
43101,2,[13NRV]Nerf,2120,207,7,4,11,63.6%,1h
43101,2,CArTON,2120,190,6,4,10,60.0%,1h
43101,2,kazmakishan,2120,194,6,9,15,40.0%,19m
43101,1,MacWaldspast,2120,239,5,4,9,55.6%,18m
43101,1,RedrippeЯ,2120,38,3,8,11,27.3%,1h
43101,1,ladyemmaham,2120,96,3,9,12,25.0%,1h
43101,2,syrus,2120,45,2,1,3,66.7%,1h
43101,2,Thyrno,2120,58,2,8,10,20.0%,28m
43101,2,DeStorus,2120,0,1,1,2,50.0%,20m
43101,1,Winston,2120,48,1,2,3,33.3%,30m
43101,2,MONGREL,2120,46,1,2,3,33.3%,1h
43101,2,Allahforever,2120,30,1,4,5,20.0%,13m
43101,3,сергей,2120,0,1,5,6,16.7%,13m
43101,2,[Ratson]holoduke,2120,91,1,6,7,14.3%,1h
43101,1,sacromento,2120,0,0,1,1,0.0%,1h
43101,2,Aqualung,2120,0,0,3,3,0.0%,1h
43101,3,BLACKBOSS,2120,0,0,5,5,0.0%,16m
43129,2,Crude,2119,821,58,58,116,50.0%,32m
43129,1,CzViktor,2119,1451,56,73,129,43.4%,1h
43129,1,daveballant,2119,1178,42,45,87,48.3%,1h
43129,1,GnrlFailure,2119,877,40,36,76,52.6%,1h
43129,2,kemosabe,2119,678,30,25,55,54.5%,1h
43129,2,[PARSE]abc,2119,634,26,24,50,52.0%,1h
43129,2,Mohky,2119,678,23,31,54,42.6%,18m
43129,2,Murlocninja,2119,432,15,18,33,45.5%,1h
43129,2,Bremerdon,2119,369,14,11,25,56.0%,32m
43129,1,Dhs,2119,432,14,21,35,40.0%,1h
43129,2,Laurie,2119,352,14,23,37,37.8%,3m
43129,1,neural,2119,314,12,12,24,50.0%,1h
43129,1,[OmDi]VampireV,2119,424,12,24,36,33.3%,1h
43129,3,rewolwerow,2119,246,9,17,26,34.6%,4m
43129,1,[Додик]UFOS,2119,285,8,9,17,47.1%,9m
43129,1,LazyTitan,2119,238,7,14,21,33.3%,10m
43129,2,Distristem,2119,138,6,6,12,50.0%,1h
43129,2,Erika,2119,144,5,0,5,100.0%,1h
43129,2,rabadan,2119,80,5,9,14,35.7%,13m
43129,2,Romario,2119,90,4,4,8,50.0%,1h
43129,1,martyros,2119,100,4,9,13,30.8%,1h
43129,2,[OXIGUN]benramiin,2119,30,2,7,9,22.2%,1h
43129,3,[ApeG]Fractal,2119,0,1,4,5,20.0%,1h
43129,2,Aloulou,2119,0,0,4,4,0.0%,1h
43129,2,[scp3]Gracaarl,2119,0,0,5,5,0.0%,12m
43129,3,SPARTAN,2119,0,0,5,5,0.0%,28m
43155,1,Dodokiller,2118,753,72,75,147,49.0%,21m
43155,2,Salo,2118,993,35,44,79,44.3%,1h
43155,1,[üPol]Keelnaai,2118,871,31,37,68,45.6%,11m
43155,2,UhNova,2118,782,30,35,65,46.2%,1h
43155,2,Bobra,2118,599,20,25,45,44.4%,1h
43155,2,[HuNBhD]LeslieRye,2118,544,18,23,41,43.9%,1h
43155,1,Borber,2118,522,15,26,41,36.6%,1h
43155,3,SEB,2118,414,14,29,43,32.6%,26m
43155,1,Bagdaddy,2118,352,12,14,26,46.2%,12m
43155,2,Spacefly,2118,272,10,13,23,43.5%,1h
43155,2,ReMango,2118,310,9,15,24,37.5%,1h
43155,1,Hucky,2118,342,8,14,22,36.4%,1h
43155,2,BLAZE,2118,172,7,6,13,53.8%,1h
43155,1,[4Gas]Rooney,2118,280,7,13,20,35.0%,27m
43155,2,georgij,2118,126,5,9,14,35.7%,1h
43155,2,IgzzzJet,2118,150,5,11,16,31.2%,25m
43155,2,svchost,2118,200,5,14,19,26.3%,26m
43155,2,[IFns]Amon,2118,161,4,4,8,50.0%,1h
43155,2,[UHSF]HarGrifJons,2118,176,4,5,9,44.4%,1h
43155,2,артём,2118,120,4,6,10,40.0%,29m
43155,3,Pawlus,2118,60,4,11,15,26.7%,1h
43155,2,Dimus,2118,46,1,3,4,25.0%,1h
43155,2,[JediK]samuellegend,2118,30,1,3,4,25.0%,1h
43155,2,Latrell,2118,0,1,4,5,20.0%,20m
43155,2,quisdom,2118,0,1,4,5,20.0%,1h
43155,2,Evg,2118,95,1,6,7,14.3%,1h
43155,2,dirtyoetker,2118,0,0,1,1,0.0%,31m
43155,2,Finne,2118,0,0,1,1,0.0%,10m
43155,2,uurdmc,2118,0,0,2,2,0.0%,1h
43155,2,Kilowat,2118,0,0,5,5,0.0%,1h
43155,2,kikirazor,2118,0,0,5,5,0.0%,14m
43186,3,[CG1508]KoreTech,2117,1521,278,292,570,48.8%,1h
43186,2,[mfxed]awatar,2117,1398,91,89,180,50.6%,30m
43186,2,brisket,2117,1457,72,55,127,56.7%,1h
43186,2,Fess,2117,756,66,59,125,52.8%,32m
43186,2,vpower,2117,1353,56,64,120,46.7%,1h
43186,2,BärenJude,2117,720,29,32,61,47.5%,18m
43186,2,Пиписинка,2117,202,10,8,18,55.6%,1h
43186,2,KorolInsult,2117,202,8,3,11,72.7%,28m
43186,2,[UF2AC]Anonimus,2117,174,6,7,13,46.2%,1h
43186,2,Hokage,2117,202,4,6,10,40.0%,1h
43186,3,бэимекс,2117,141,4,13,17,23.5%,10m
43186,1,CornPrime,2117,145,3,8,11,27.3%,1h
43186,2,[AciNoN]Skill,2117,88,2,0,2,100.0%,14m
43186,2,Дима,2117,0,1,1,2,50.0%,1h
43186,2,[Tuur]kornax,2117,0,1,1,2,50.0%,1h
43186,2,gonzo,2117,30,1,4,5,20.0%,1h
43186,2,Cerberus,2117,30,1,5,6,16.7%,5m
43186,2,NovaLeader,2117,30,1,6,7,14.3%,19m
43186,2,juju,2117,0,0,1,1,0.0%,18m
43186,2,[görli]Boncukovic,2117,0,0,2,2,0.0%,1h
43186,2,[Jail]VIctorDestro,2117,0,0,2,2,0.0%,19m
43186,2,ARCLight,2117,0,0,2,2,0.0%,17m
43186,1,Masich,2117,0,0,3,3,0.0%,2m
43186,2,ivomagus,2117,0,0,4,4,0.0%,1h
43186,3,Hannibal,2117,0,0,5,5,0.0%,1h
43186,2,Fresh,2117,0,0,5,5,0.0%,31m
43212,2,StarOne,2116,1548,106,101,207,51.2%,29m
43212,1,Kemanaves,2116,1194,85,89,174,48.9%,20m
43212,1,Scarymonster,2116,1501,74,77,151,49.0%,20m
43212,2,alma,2116,983,43,32,75,57.3%,18m
43212,2,swiper,2116,889,35,34,69,50.7%,1h
43212,2,Crytek,2116,654,22,24,46,47.8%,1h
43212,2,Garvil,2116,404,20,19,39,51.3%,1h
43212,3,Roberts,2116,488,18,25,43,41.9%,15m
43212,2,HCl,2116,436,15,17,32,46.9%,25m
43212,2,Grimux,2116,403,12,14,26,46.2%,1h
43212,2,SerafinStw,2116,328,11,13,24,45.8%,1h
43212,1,Melkor,2116,313,9,13,22,40.9%,1h
43212,2,Fibo,2116,202,7,4,11,63.6%,11m
43212,2,MagicPants,2116,190,6,3,9,66.7%,1h
43212,2,Tigerallied,2116,152,5,12,17,29.4%,1h
43212,2,DruiD,2116,132,3,8,11,27.3%,1h
43212,1,DrLk,2116,142,3,9,12,25.0%,31m
43212,1,Colloc,2116,106,3,13,16,18.8%,31m
43212,2,DaronFox,2116,92,2,6,8,25.0%,1h
43212,2,PPish,2116,97,2,8,10,20.0%,1h
43212,3,[OPStar]RomanD,2116,68,2,10,12,16.7%,33m
43212,2,Frenky,2116,68,2,10,12,16.7%,28m
43212,2,[НасРат]MorionRus,2116,0,1,1,2,50.0%,1h
43212,2,[VGW]JoeCamel,2116,0,1,1,2,50.0%,1h
43212,2,attom,2116,30,1,2,3,33.3%,29m
43212,2,Rotzenplotz,2116,30,1,3,4,25.0%,18m
43212,2,Wufftonsson,2116,32,1,4,5,20.0%,1h
43212,2,Voros,2116,95,1,4,5,20.0%,1h
43212,2,Nairda,2116,30,1,4,5,20.0%,14m
43212,2,[ANONIM]Ilyas,2116,0,0,1,1,0.0%,1h
43212,2,StardaxPrime,2116,0,0,1,1,0.0%,1h
43212,2,Horejan,2116,0,0,1,1,0.0%,1h
43212,2,StarCetnik,2116,0,0,2,2,0.0%,1h
43212,2,osahasan,2116,0,0,2,2,0.0%,1h
43212,2,stonewing,2116,73,0,3,3,0.0%,1h
43212,1,tobence,2116,0,0,3,3,0.0%,27m
43212,2,ogur,2116,0,0,3,3,0.0%,1h
43212,3,tgr,2116,0,0,5,5,0.0%,1h
43250,2,Don,2115,1585,147,146,293,50.2%,1h
43250,2,Robken,2115,1575,130,129,259,50.2%,1h
43250,1,DivineWolf,2115,1050,98,105,203,48.3%,1h
43250,2,FFF,2115,1218,45,53,98,45.9%,32m
43250,2,Cobas,2115,917,38,40,78,48.7%,13m
43250,2,Mircea,2115,692,27,25,52,51.9%,12m
43250,2,Titirasou,2115,375,14,19,33,42.4%,1h
43250,2,Schlammi,2115,394,13,17,30,43.3%,13m
43250,2,LuckyPig,2115,269,11,6,17,64.7%,6m
43250,2,Sleepy,2115,336,9,16,25,36.0%,1h
43250,2,Leshka,2115,175,8,8,16,50.0%,1h
43250,2,Joost,2115,175,7,5,12,58.3%,29m
43250,1,Pikiki,2115,287,6,12,18,33.3%,1h
43250,2,DMKIIITIME,2115,132,5,8,13,38.5%,29m
43250,2,Neico,2115,158,4,3,7,57.1%,26m
43250,2,diepocke,2115,114,4,8,12,33.3%,30m
43250,2,george,2115,88,3,6,9,33.3%,1h
43250,2,Istvan,2115,47,3,7,10,30.0%,33m
43250,1,ErtHalf,2115,48,2,7,9,22.2%,1h
43250,2,Zloikloun,2115,0,1,1,2,50.0%,1h
43250,2,AlbertoGP,2115,88,1,1,2,50.0%,11m
43250,1,[CaSCuT]kkaras,2115,48,1,2,3,33.3%,14m
43250,1,QWST,2115,0,1,7,8,12.5%,1h
43250,1,Hargard,2115,0,1,7,8,12.5%,1h
43250,2,[Sepuku]ЯКРУТ,2115,0,0,1,1,0.0%,4m
43250,2,Ferdi,2115,0,0,1,1,0.0%,8m
43250,2,[plCake]GumaZ,2115,0,0,2,2,0.0%,1h
43250,2,Labamba,2115,0,0,2,2,0.0%,1h
43250,2,Randall,2115,0,0,5,5,0.0%,1h
43279,1,joinvader,2114,1645,118,132,250,47.2%,11m
43279,2,[N1TDA]HarryCover,2114,1581,111,121,232,47.8%,5m
43279,1,Skaleuh,2114,1280,50,53,103,48.5%,1h
43279,2,Nanierzer,2114,742,33,21,54,61.1%,1h
43279,1,nuelltz,2114,456,31,33,64,48.4%,1h
43279,2,Kaoru,2114,517,23,27,50,46.0%,1h
43279,1,EZDIM,2114,496,16,22,38,42.1%,7m
43279,2,diabezdemona,2114,339,14,17,31,45.2%,31m
43279,2,JGapes,2114,358,13,16,29,44.8%,1h
43279,1,Mafiakiller,2114,152,7,8,15,46.7%,20m
43279,1,[AngorA]Баха,2114,228,6,10,16,37.5%,1h
43279,2,Ghost,2114,180,5,2,7,71.4%,8m
43279,2,[MASTRO]Oriun,2114,152,4,3,7,57.1%,33m
43279,2,Milkcruiser,2114,114,4,5,9,44.4%,25m
43279,2,[LNDD]BleckStalker,2114,102,3,1,4,75.0%,1h
43279,1,Curao,2114,0,3,4,7,42.9%,1h
43279,1,Sas,2114,0,3,4,7,42.9%,1h
43279,2,DarkMatter,2114,135,3,6,9,33.3%,31m
43279,3,KILLER,2114,147,3,6,9,33.3%,1h
43279,3,Bulwark,2114,0,2,8,10,20.0%,2m
43279,2,Nyolcas,2114,0,1,0,1,100.0%,1h
43279,2,mazaTRoll,2114,0,1,0,1,100.0%,23m
43279,2,[Lambro]Subwaytrain,2114,0,1,1,2,50.0%,15m
43279,2,aurelienduf,2114,97,1,2,3,33.3%,1h
43279,2,Faucheur,2114,0,1,5,6,16.7%,1h
43279,2,denchic,2114,88,1,5,6,16.7%,11m
43279,1,machdruff,2114,0,1,7,8,12.5%,1h
43279,2,MalukuVssn,2114,0,0,1,1,0.0%,22m
43279,2,Norskmann,2114,0,0,1,1,0.0%,1h
43279,2,Lucius,2114,0,0,1,1,0.0%,1h
43279,2,Hamekas,2114,0,0,1,1,0.0%,4m
43279,2,Sarek,2114,0,0,2,2,0.0%,1h
43279,2,Serge,2114,0,0,3,3,0.0%,1h
43279,2,Ares,2114,0,0,3,3,0.0%,22m
43279,2,Leloss,2114,0,0,4,4,0.0%,1h
43279,2,Youlidante,2114,0,0,5,5,0.0%,14m
43279,3,Rzytu,2114,0,0,5,5,0.0%,1h
43279,2,Elvis,2114,0,0,5,5,0.0%,1h
43279,2,BIGBOYKILLER,2114,0,0,5,5,0.0%,14m
43318,2,miletsky,2113,1042,96,111,207,46.4%,13m
43318,1,TrollBaby,2113,1474,48,65,113,42.5%,32m
43318,2,XStrange,2113,909,44,46,90,48.9%,26m
43318,2,AlphaA,2113,707,27,30,57,47.4%,1h
43318,2,[BlackX]Kendatchi,2113,520,20,20,40,50.0%,30m
43318,2,макентош,2113,448,16,21,37,43.2%,12m
43318,2,hunter,2113,434,16,30,46,34.8%,18m
43318,2,canard,2113,347,14,14,28,50.0%,32m
43318,2,Kokosik,2113,303,12,11,23,52.2%,1h
43318,2,werso,2113,362,12,18,30,40.0%,20m
43318,2,Lodrop,2113,290,10,8,18,55.6%,6m
43318,2,maciejek,2113,178,7,13,20,35.0%,1h
43318,2,Prohor,2113,130,4,2,6,66.7%,1h
43318,2,Frol,2113,90,4,3,7,57.1%,32m
43318,2,[BWArmy]mamamimi,2113,166,4,4,8,50.0%,25m
43318,2,Bigsam,2113,86,4,5,9,44.4%,24m
43318,1,CRYSYS,2113,96,4,11,15,26.7%,1h
43318,2,NeverMInd,2113,112,3,1,4,75.0%,18m
43318,2,Recenescu,2113,88,3,2,5,60.0%,4m
43318,2,[TFJR]SysShock,2113,30,3,5,8,37.5%,14m
43318,2,BiTi,2113,64,2,3,5,40.0%,10m
43318,2,Naruto,2113,0,1,0,1,100.0%,20m
43318,2,[SAKS]BeladonnaTea,2113,0,1,1,2,50.0%,1h
43318,1,FearSWE,2113,48,1,3,4,25.0%,6m
43318,1,JokerWasHere,2113,0,1,6,7,14.3%,1h
43318,2,teuton,2113,0,0,1,1,0.0%,1h
43318,2,ZEVI,2113,0,0,1,1,0.0%,1h
43318,2,ТрусыУдачи,2113,0,0,5,5,0.0%,1h
43318,2,jedichchch,2113,0,0,5,5,0.0%,25m
43318,1,nuwave,2113,0,0,8,8,0.0%,30m
43348,2,[Ptit]Fly,2112,1560,94,99,193,48.7%,12m
43348,1,BISHOP,2112,1679,76,84,160,47.5%,1h
43348,1,ZOHB,2112,548,24,21,45,53.3%,1h
43348,2,qwqrwere,2112,458,18,12,30,60.0%,10m
43348,2,[рейд]Bulava,2112,466,18,21,39,46.2%,18m
43348,2,Nitsu,2112,251,13,3,16,81.2%,14m
43348,2,[AiRǂ]Carogna,2112,374,13,14,27,48.1%,1h
43348,2,VVALTER,2112,230,8,12,20,40.0%,21m
43348,2,MrDeyyu,2112,172,6,9,15,40.0%,1h
43348,1,Ser,2112,180,6,12,18,33.3%,11m
43348,2,funny,2112,166,5,3,8,62.5%,18m
43348,3,Eclipsej,2112,145,4,10,14,28.6%,8m
43348,2,BruderJO,2112,102,3,3,6,50.0%,33m
43348,1,piv,2112,96,2,2,4,50.0%,1h
43348,1,Rouge,2112,48,2,3,5,40.0%,1h
43348,1,Ezekielo,2112,96,2,7,9,22.2%,1h
43348,2,Pedro,2112,46,2,7,9,22.2%,19m
43348,1,ANTONIADE,2112,0,1,2,3,33.3%,6m
43348,2,[Prsite]JotaroKujo,2112,30,1,3,4,25.0%,1h
43348,2,GOPNIK,2112,30,1,4,5,20.0%,32m
43348,2,OverDose,2112,46,1,6,7,14.3%,1h
43348,1,SAUCE,2112,0,1,6,7,14.3%,4m
43348,2,Thadox,2112,0,0,1,1,0.0%,1h
43348,3,llllllllll,2112,0,0,2,2,0.0%,1h
43348,2,tappotopi,2112,0,0,3,3,0.0%,23m
43348,1,Нил,2112,0,0,4,4,0.0%,1h
43348,2,ixTrustME,2112,0,0,4,4,0.0%,1h
43348,3,shprot,2112,0,0,5,5,0.0%,1h
43348,2,Szczypior,2112,0,0,5,5,0.0%,1h
43348,2,смертохвост,2112,0,0,7,7,0.0%,1h
43378,3,[ЕМPIRE]MichaelKing,2111,1574,402,416,818,49.1%,33m
43378,2,Zoltri,2111,1574,179,210,389,46.0%,4m
43378,1,Mrmagic,2111,1505,142,138,280,50.7%,1h
43378,2,GaSpy,2111,1540,83,93,176,47.2%,1h
43378,2,IronTrow,2111,355,78,70,148,52.7%,6m
43378,1,KanBopobeu,2111,1449,56,57,113,49.6%,1h
43378,1,Chip,2111,1057,42,45,87,48.3%,1h
43378,2,Rocu,2111,912,34,41,75,45.3%,1h
43378,2,CII,2111,666,33,30,63,52.4%,29m
43378,2,ТРАМАДООЛ,2111,729,31,27,58,53.4%,1h
43378,1,Paulot,2111,956,30,44,74,40.5%,27m
43378,2,Niko,2111,559,26,34,60,43.3%,1h
43378,2,Huskarl,2111,553,19,26,45,42.2%,31m
43378,2,przem,2111,346,13,13,26,50.0%,11m
43378,2,Sodzisan,2111,376,13,16,29,44.8%,13m
43378,1,Zan,2111,376,11,21,32,34.4%,1h
43378,2,[ctrll]SirEnglsmith,2111,242,9,11,20,45.0%,13m
43378,3,Anakin,2111,179,6,13,19,31.6%,10m
43378,2,Xenomorph,2111,182,4,5,9,44.4%,1h
43378,2,МЭТР,2111,62,3,5,8,37.5%,6m
43378,2,TwentySeven,2111,90,3,6,9,33.3%,1h
43378,2,Hahn,2111,74,2,4,6,33.3%,27m
43378,2,DoOrBeDid,2111,114,2,6,8,25.0%,1h
43378,2,[MGP]warthog,2111,60,2,7,9,22.2%,10m
43378,2,Micro,2111,0,1,0,1,100.0%,31m
43378,2,Homa,2111,0,1,0,1,100.0%,5m
43378,2,ТоПчИп,2111,0,1,0,1,100.0%,31m
43378,2,Artemko,2111,88,1,1,2,50.0%,28m
43378,2,libra,2111,0,1,4,5,20.0%,20m
43378,2,Daniel,2111,0,0,1,1,0.0%,18m
43378,2,suphek,2111,0,0,1,1,0.0%,1h
43378,2,Metastasio,2111,0,0,2,2,0.0%,21m
43378,2,[G6AS]karlis,2111,0,0,3,3,0.0%,1h
43378,2,guss,2111,0,0,3,3,0.0%,1h
43378,3,LofeLG,2111,0,0,5,5,0.0%,1h
43378,2,Amasko,2111,0,0,5,5,0.0%,1h
43414,2,Pirata,2110,1551,179,183,362,49.4%,30m
43414,1,kicsipower,2110,1658,93,93,186,50.0%,3m
43414,2,Mercii,2110,940,89,97,186,47.8%,10m
43414,2,bogvAFG,2110,1614,79,75,154,51.3%,30m
43414,2,joanet,2110,1542,73,70,143,51.0%,27m
43414,2,Клim,2110,1520,56,64,120,46.7%,33m
43414,2,StaRFoX,2110,1296,48,49,97,49.5%,1h
43414,2,[MFGCUK]Snooze,2110,1126,45,46,91,49.5%,1h
43414,2,ZAR,2110,574,23,25,48,47.9%,1h
43414,2,jake,2110,551,20,18,38,52.6%,1h
43414,2,vyrdalak,2110,418,19,8,27,70.4%,1h
43414,2,Annihilator,2110,521,18,23,41,43.9%,1h
43414,2,RagingBadger,2110,428,15,20,35,42.9%,4m
43414,2,IsoPropyl,2110,370,14,7,21,66.7%,1h
43414,2,AkkuAkku,2110,380,14,9,23,60.9%,13m
43414,2,pahis,2110,330,13,8,21,61.9%,1h
43414,2,Richard,2110,322,13,12,25,52.0%,29m
43414,2,kasius,2110,306,9,13,22,40.9%,1h
43414,2,peterminus,2110,276,9,13,22,40.9%,15m
43414,2,[KOMKAL]goodman,2110,163,6,10,16,37.5%,1h
43414,2,Kamchak,2110,77,6,12,18,33.3%,13m
43414,2,[Zhig]arturrium,2110,168,5,4,9,55.6%,1h
43414,1,frugele,2110,168,4,10,14,28.6%,1h
43414,1,tzaren,2110,96,3,9,12,25.0%,18m
43414,1,Hardek,2110,48,3,10,13,23.1%,1h
43414,1,HimmelsSturm,2110,36,3,11,14,21.4%,4m
43414,3,Pavel,2110,38,2,4,6,33.3%,28m
43414,2,[ЛДПР]Dragster,2110,88,1,1,2,50.0%,1h
43414,3,gutek,2110,0,1,2,3,33.3%,1h
43414,1,DcG,2110,38,1,5,6,16.7%,1h
43414,2,[ZERG55]dimaigromak,2110,0,0,1,1,0.0%,1h
43414,1,UFOalien,2110,0,0,1,1,0.0%,1h
43414,2,vidu,2110,0,0,1,1,0.0%,1h
43414,2,AlienShark,2110,0,0,2,2,0.0%,1h
43414,1,Jimbo,2110,0,0,4,4,0.0%,1h
43414,3,Taliésin,2110,0,0,5,5,0.0%,1h
43414,3,Tesla,2110,0,0,5,5,0.0%,16m
43414,2,SirHeinz,2110,0,0,7,7,0.0%,1h
43452,2,Pincity,2109,1584,172,188,360,47.8%,4m
43452,2,DANIDAN,2109,1461,86,78,164,52.4%,31m
43452,1,Dzhuma,2109,1506,73,73,146,50.0%,1h
43452,2,Jyagler,2109,735,45,38,83,54.2%,10m
43452,1,Exfiltration,2109,998,37,45,82,45.1%,33m
43452,1,NkWd,2109,1012,36,35,71,50.7%,6m
43452,1,powermaatz,2109,823,28,43,71,39.4%,1h
43452,1,Leninlive,2109,526,17,22,39,43.6%,1h
43452,2,FLICKstrot,2109,296,11,26,37,29.7%,14m
43452,2,nightraven,2109,208,8,13,21,38.1%,1h
43452,1,Légions,2109,103,6,12,18,33.3%,1h
43452,2,panik,2109,90,4,5,9,44.4%,29m
43452,2,rikx,2109,60,2,3,5,40.0%,1h
43452,2,[zXY]RodSteward,2109,36,2,4,6,33.3%,4m
43452,2,Nix,2109,30,1,3,4,25.0%,10m
43452,1,Jacobrules,2109,48,1,5,6,16.7%,3m
43452,2,mourou,2109,0,1,5,6,16.7%,1h
43452,2,POLO,2109,93,1,6,7,14.3%,8m
43452,3,PiriaLRUSss,2109,0,0,1,1,0.0%,1h
43452,2,satisfaction,2109,0,0,1,1,0.0%,22m
43452,3,SCII,2109,0,0,5,5,0.0%,4m
43452,3,GOZARANEE,2109,0,0,5,5,0.0%,15m
43452,2,logossi,2109,0,0,5,5,0.0%,33m
43452,2,Jerome,2109,0,0,5,5,0.0%,1h
43452,1,ozdemirasaf,2109,0,0,9,9,0.0%,6m
43477,2,konstantin,2108,1582,93,87,180,51.7%,33m
43477,1,FOK,2108,1283,76,82,158,48.1%,1h
43477,2,verman,2108,808,50,59,109,45.9%,10m
43477,2,Turan,2108,963,47,30,77,61.0%,19m
43477,2,[PeEff]Dry,2108,728,28,27,55,50.9%,12m
43477,2,Урукхай,2108,614,23,25,48,47.9%,18m
43477,2,Rihart,2108,559,21,23,44,47.7%,28m
43477,2,Ramonick,2108,453,18,19,37,48.6%,19m
43477,2,Tudor,2108,366,16,8,24,66.7%,14m
43477,2,Troutslayer,2108,399,13,20,33,39.4%,1h
43477,2,ZlatyBazant,2108,172,9,10,19,47.4%,20m
43477,1,PraiD,2108,322,9,25,34,26.5%,23m
43477,1,Roci,2108,247,5,10,15,33.3%,27m
43477,2,Wolman,2108,133,4,4,8,50.0%,1h
43477,2,Valahius,2108,102,4,10,14,28.6%,20m
43477,2,Deathitself,2108,30,3,5,8,37.5%,4m
43477,2,XxXD,2108,22,2,1,3,66.7%,20m
43477,2,Denamen,2108,46,2,2,4,50.0%,1h
43477,2,Chris,2108,30,2,3,5,40.0%,1h
43477,2,АНТОХА,2108,116,2,3,5,40.0%,14m
43477,2,jimmimak,2108,78,2,5,7,28.6%,1h
43477,1,dyablobody,2108,145,2,6,8,25.0%,1h
43477,2,VimanA,2108,0,1,0,1,100.0%,32m
43477,3,dstajoxa,2108,0,1,4,5,20.0%,1h
43477,2,Tailer,2108,0,0,1,1,0.0%,1h
43477,2,[SiHr]Kantor,2108,0,0,1,1,0.0%,27m
43477,2,[KysXdd]Leemao,2108,0,0,1,1,0.0%,30m
43477,1,Mammut,2108,0,0,1,1,0.0%,1h
43477,1,[OUUH]leo,2108,0,0,4,4,0.0%,1h
43477,2,PickledKoi,2108,0,0,5,5,0.0%,1h
43507,1,[BounP]ДОДЖ,2107,1616,319,326,645,49.5%,1h
43507,1,Olympiacos,2107,1670,117,120,237,49.4%,16m
43507,1,Tabberas,2107,1537,95,99,194,49.0%,5m
43507,3,Jannik,2107,1573,89,98,187,47.6%,9m
43507,2,mirowan,2107,1124,44,49,93,47.3%,13m
43507,2,Kirito,2107,556,23,26,49,46.9%,30m
43507,2,[ANREN]Yaross,2107,303,10,20,30,33.3%,1h
43507,2,Toxichof,2107,246,9,5,14,64.3%,1h
43507,2,domnuldavid,2107,194,6,8,14,42.9%,14m
43507,2,SalmonSushi,2107,179,5,7,12,41.7%,29m
43507,1,Coimao,2107,185,5,11,16,31.2%,32m
43507,1,Ruffneck,2107,62,3,8,11,27.3%,1h
43507,2,supra,2107,60,2,5,7,28.6%,31m
43507,2,ameyas,2107,48,2,8,10,20.0%,1h
43507,1,sharik,2107,0,2,10,12,16.7%,13m
43507,2,Bretzel,2107,0,1,0,1,100.0%,1h
43507,2,PoWeRDRisH,2107,88,1,1,2,50.0%,23m
43507,2,Josh,2107,88,1,1,2,50.0%,27m
43507,3,AbrisjediHUN,2107,0,1,3,4,25.0%,1h
43507,2,PSEVDONIM,2107,0,1,5,6,16.7%,17m
43507,1,Tireon,2107,0,1,7,8,12.5%,4m
43507,2,Stfn,2107,0,0,1,1,0.0%,1h
43507,2,[Tic2]lynx,2107,0,0,1,1,0.0%,1h
43507,2,Elipilz,2107,0,0,2,2,0.0%,1h
43507,3,Aloxadance,2107,0,0,2,2,0.0%,1h
43507,2,XeVo,2107,0,0,5,5,0.0%,1h
43533,2,ziomal,2106,1577,106,97,203,52.2%,1h
43533,2,SleepyNinja,2106,1547,86,89,175,49.1%,1h
43533,2,Kowal,2106,1588,65,63,128,50.8%,23m
43533,2,Темимурл,2106,803,32,26,58,55.2%,5m
43533,1,noob,2106,733,32,42,74,43.2%,22m
43533,2,ILEZ,2106,714,25,25,50,50.0%,4m
43533,2,Spylkaks,2106,588,21,22,43,48.8%,31m
43533,2,Dovahkïn,2106,614,21,24,45,46.7%,18m
43533,2,TonyStark,2106,186,8,7,15,53.3%,19m
43533,2,[TLOAWS]XARSES,2106,170,6,11,17,35.3%,10m
43533,2,hackerman,2106,104,5,1,6,83.3%,1h
43533,2,RoaringWrath,2106,148,5,7,12,41.7%,30m
43533,1,osavir,2106,0,3,4,7,42.9%,23m
43533,1,Ondrej,2106,0,1,1,2,50.0%,17m
43533,2,Hyd,2106,30,1,2,3,33.3%,25m
43533,2,Relax,2106,0,1,5,6,16.7%,1h
43533,2,Magnasakar,2106,0,1,5,6,16.7%,1h
43533,2,Zellion,2106,0,0,1,1,0.0%,1h
43533,2,Spyre,2106,0,0,1,1,0.0%,20m
43533,2,orbitus,2106,0,0,2,2,0.0%,18m
43533,2,[isIMBА]DazayPozitiv,2106,0,0,2,2,0.0%,1h
43533,2,СУДЗИН,2106,0,0,2,2,0.0%,1h
43533,2,cosmowarrior,2106,0,0,3,3,0.0%,31m
43556,1,SecaAdegas,2105,1320,98,107,205,47.8%,24m
43556,1,ChikiPuki,2105,1131,81,79,160,50.6%,27m
43556,1,Astro,2105,1219,58,58,116,50.0%,1h
43556,3,valkar,2105,1216,46,51,97,47.4%,1h
43556,2,Gamerlolly,2105,860,43,34,77,55.8%,1h
43556,2,CyrusThe,2105,946,37,37,74,50.0%,6m
43556,2,SkiM,2105,617,31,30,61,50.8%,1h
43556,2,Simsisamstar,2105,702,27,27,54,50.0%,23m
43556,1,zigimaszyna,2105,684,21,35,56,37.5%,4m
43556,2,JustNuts,2105,368,12,23,35,34.3%,29m
43556,1,Kotetsust,2105,233,6,7,13,46.2%,1h
43556,2,Arkhan,2105,231,6,9,15,40.0%,32m
43556,2,Ushoy,2105,168,6,12,18,33.3%,32m
43556,3,dante,2105,30,4,7,11,36.4%,16m
43556,2,[sonic1]Archon,2105,60,3,3,6,50.0%,1h
43556,2,Gendernator,2105,86,3,5,8,37.5%,1h
43556,3,ToPiK,2105,30,3,10,13,23.1%,26m
43556,1,Savior,2105,116,2,4,6,33.3%,8m
43556,2,tothun,2105,60,2,6,8,25.0%,10m
43556,1,Helga,2105,48,2,9,11,18.2%,1h
43556,2,jaanonim,2105,0,1,0,1,100.0%,1h
43556,1,ДраконТеней,2105,48,1,3,4,25.0%,23m
43556,1,MrMurphy,2105,0,1,5,6,16.7%,1h
43556,1,TenToes,2105,0,1,7,8,12.5%,1h
43556,2,[dylan]Dragondor,2105,0,0,1,1,0.0%,1h
43556,2,IlIlIlIlIlIl,2105,0,0,2,2,0.0%,4m
43556,2,Jonasz,2105,0,0,2,2,0.0%,6m
43556,2,[GELG]DerNxGPlayer,2105,0,0,3,3,0.0%,21m
43556,1,Happyliar,2105,0,0,3,3,0.0%,1h
43556,1,[okere]Adricool,2105,0,0,5,5,0.0%,1h
43556,3,Tuckos,2105,0,0,5,5,0.0%,1h
43556,2,Dralnu,2105,0,0,5,5,0.0%,28m
43556,2,Bandwuermche,2105,0,0,5,5,0.0%,28m
43589,2,OnlyTvsT,2104,1650,1231,1336,2567,48.0%,15m
43589,1,JohnSilver,2104,1674,84,89,173,48.6%,1h
43589,2,GoldenSwift,2104,1225,81,75,156,51.9%,1h
43589,1,CopUkrop,2104,1652,70,75,145,48.3%,20m
43589,1,[Dralag]sMall,2104,1301,52,55,107,48.6%,32m
43589,3,DedKoloon,2104,1048,46,64,110,41.8%,7m
43589,2,SlikRæven,2104,248,33,21,54,61.1%,1h
43589,2,tribality,2104,497,17,22,39,43.6%,4m
43589,1,[ISV]Scorpio,2104,452,12,23,35,34.3%,1h
43589,2,Rubin,2104,290,10,6,16,62.5%,18m
43589,1,suplex,2104,326,8,6,14,57.1%,1h
43589,2,LoveAndPeace,2104,242,8,15,23,34.8%,11m
43589,1,cpkenneth,2104,244,8,15,23,34.8%,5m
43589,3,politolog,2104,200,5,11,16,31.2%,21m
43589,1,sarkofa,2104,231,5,11,16,31.2%,1h
43589,2,LAVRON,2104,128,4,1,5,80.0%,27m
43589,2,splash,2104,140,4,2,6,66.7%,1h
43589,2,GermanErd,2104,146,3,3,6,50.0%,32m
43589,2,Tako,2104,0,3,3,6,50.0%,1h
43589,2,Brunier,2104,92,3,4,7,42.9%,1h
43589,3,Lobo,2104,0,3,5,8,37.5%,16m
43589,1,Evandros,2104,72,3,9,12,25.0%,24m
43589,1,SilliN,2104,48,2,0,2,100.0%,25m
43589,1,Skodan,2104,0,1,0,1,100.0%,1h
43589,2,ZACATICK,2104,0,1,4,5,20.0%,24m
43589,2,Montgisard,2104,0,1,6,7,14.3%,1h
43589,2,Silchas,2104,0,0,1,1,0.0%,1h
43589,2,Anonymus,2104,0,0,1,1,0.0%,14m
43589,2,RagerSK,2104,0,0,1,1,0.0%,25m
43589,2,voodoking,2104,0,0,3,3,0.0%,4m
43589,2,Gaqua,2104,0,0,3,3,0.0%,18m
43620,3,Ken,2103,1422,183,185,368,49.7%,8m
43620,2,SteelRain,2103,1466,139,166,305,45.6%,4m
43620,2,WastlKastl,2103,1573,85,96,181,47.0%,1h
43620,2,Monian,2103,851,74,73,147,50.3%,1h
43620,1,kot,2103,1272,68,66,134,50.7%,31m
43620,2,Samy,2103,1280,40,63,103,38.8%,1h
43620,2,Faktor,2103,816,38,34,72,52.8%,1h
43620,2,Life,2103,544,18,26,44,40.9%,32m
43620,2,kshuk,2103,332,14,10,24,58.3%,1h
43620,2,Sundmay,2103,319,11,17,28,39.3%,10m
43620,3,TARK,2103,283,10,8,18,55.6%,27m
43620,2,Griftarr,2103,278,10,10,20,50.0%,1h
43620,2,ЧайИЗZилота,2103,296,10,10,20,50.0%,7m
43620,2,Radikal,2103,276,10,11,21,47.6%,20m
43620,2,Garik,2103,268,9,7,16,56.2%,1h
43620,2,theavenger,2103,174,6,8,14,42.9%,1h
43620,1,VLAD,2103,156,5,12,17,29.4%,1h
43620,2,shiuk,2103,98,4,7,11,36.4%,21m
43620,2,KaMMaZ,2103,153,4,7,11,36.4%,1h
43620,2,Vanirsha,2103,165,3,7,10,30.0%,1h
43620,3,Meinplayer,2103,32,3,8,11,27.3%,28m
43620,1,YXN,2103,97,2,8,10,20.0%,31m
43620,1,HARLEM,2103,0,2,9,11,18.2%,32m
43620,2,Qraphis,2103,93,1,1,2,50.0%,1h
43620,2,Maicce,2103,0,1,5,6,16.7%,6m
43620,1,[DFgsA]dadomon,2103,0,1,7,8,12.5%,5m
43620,2,[TedB]DarkSunGwyn,2103,0,1,7,8,12.5%,1h
43620,2,InFoTuR,2103,0,0,1,1,0.0%,1h
43620,2,TrickyHunter,2103,0,0,1,1,0.0%,1h
43620,2,VKaz,2103,0,0,2,2,0.0%,24m
43620,2,[1NFEC7]caillou,2103,0,0,2,2,0.0%,1h
43620,1,SteppenWolf,2103,0,0,3,3,0.0%,1h
43620,3,dooguette,2103,0,0,5,5,0.0%,1h
43620,2,WoobsGaming,2103,0,0,6,6,0.0%,26m
43654,2,PooBear,2102,1586,135,141,276,48.9%,11m
43654,2,alesusan,2102,1532,108,108,216,50.0%,1h
43654,2,Adde,2102,1573,90,94,184,48.9%,23m
43654,1,enk,2102,1331,49,55,104,47.1%,1h
43654,2,Rublev,2102,910,47,54,101,46.5%,32m
43654,2,Ravageur,2102,508,39,41,80,48.8%,1h
43654,2,DiamondDog,2102,912,33,38,71,46.5%,1h
43654,2,krexa,2102,564,25,18,43,58.1%,1h
43654,2,crococo,2102,509,19,16,35,54.3%,1h
43654,2,[voodtr]Vincent,2102,256,9,11,20,45.0%,1h
43654,1,[SVOR]tiger,2102,212,6,12,18,33.3%,8m
43654,1,HikaruSorano,2102,190,5,11,16,31.2%,6m
43654,2,Dash,2102,124,4,8,12,33.3%,24m
43654,2,Holo,2102,119,3,4,7,42.9%,1h
43654,1,[KPZA]kirill,2102,153,3,9,12,25.0%,24m
43654,1,[oVDMo]Rayden,2102,80,3,10,13,23.1%,1h
43654,2,Nadrak,2102,0,2,5,7,28.6%,26m
43654,2,Sam,2102,0,1,0,1,100.0%,4m
43654,2,ElipsiS,2102,88,1,1,2,50.0%,29m
43654,1,FairCry,2102,0,1,1,2,50.0%,1h
43654,2,Muffin,2102,0,1,2,3,33.3%,11m
43654,2,flint,2102,0,1,2,3,33.3%,25m
43654,2,Flo,2102,0,1,2,3,33.3%,1h
43654,2,moha,2102,0,1,3,4,25.0%,19m
43654,2,DekresPL,2102,30,1,4,5,20.0%,24m
43654,2,IGoodLikerI,2102,0,0,1,1,0.0%,28m
43654,2,Zartro,2102,0,0,1,1,0.0%,1h
43654,2,Ghost,2102,0,0,1,1,0.0%,32m
43654,2,kolyasik,2102,0,0,2,2,0.0%,1h
43654,3,Miguel,2102,0,0,2,2,0.0%,1h
43654,2,DIO,2102,0,0,2,2,0.0%,20m
43654,2,[NoHead]Zorkan,2102,0,0,5,5,0.0%,20m
43654,3,Demonii,2102,0,0,5,5,0.0%,4m
43654,3,SynFusion,2102,0,0,5,5,0.0%,1h
43654,2,ViLeKe,2102,0,0,5,5,0.0%,1h
43689,3,Arnak,2101,818,191,202,393,48.6%,1h
43689,2,skimeur,2101,1458,93,86,179,52.0%,11m
43689,2,Bugman,2101,1451,84,87,171,49.1%,1h
43689,1,JoHn,2101,708,81,95,176,46.0%,1h
43689,2,Works,2101,1531,65,57,122,53.3%,10m
43689,2,Alfa,2101,794,33,32,65,50.8%,1h
43689,3,ZeroLegend,2101,921,32,44,76,42.1%,1h
43689,2,KirAzuK,2101,553,20,21,41,48.8%,15m
43689,2,GamePirate,2101,409,16,25,41,39.0%,1h
43689,2,TowersRambo,2101,338,13,24,37,35.1%,1h
43689,2,[SDrop]TIT,2101,304,12,9,21,57.1%,11m
43689,2,[Тир]Снэкри,2101,412,12,22,34,35.3%,1h
43689,2,Zeron,2101,258,11,6,17,64.7%,16m
43689,2,[VGZR]Swaffeln,2101,330,10,18,28,35.7%,7m
43689,2,Duckin,2101,242,9,6,15,60.0%,7m
43689,2,[ЭЩКЕРЕ]Korish,2101,250,8,10,18,44.4%,1h
43689,2,GhostDragon,2101,90,4,6,10,40.0%,12m
43689,2,Blakmoumoune,2101,164,4,9,13,30.8%,27m
43689,1,Charliezhu,2101,140,4,12,16,25.0%,17m
43689,2,Куражёвый,2101,88,3,7,10,30.0%,11m
43689,2,aleksej,2101,159,3,8,11,27.3%,1h
43689,1,Мачеха,2101,126,3,8,11,27.3%,1h
43689,1,Logan,2101,32,2,7,9,22.2%,1h
43689,1,Joopig,2101,0,1,5,6,16.7%,1h
43689,1,Varron,2101,0,1,7,8,12.5%,7m
43689,2,aleks,2101,0,0,1,1,0.0%,28m
43689,2,blouffzl,2101,0,0,1,1,0.0%,4m
43689,2,ivanwi,2101,0,0,1,1,0.0%,1h
43689,2,[SEMEN]Sapog,2101,0,0,1,1,0.0%,18m
43689,1,[fndtn]Rockless,2101,0,0,1,1,0.0%,14m
43689,2,krls,2101,0,0,1,1,0.0%,13m
43689,3,Patroll,2101,0,0,4,4,0.0%,28m
43721,3,zwung,2100,1517,737,759,1496,49.3%,1h
43721,2,Artem,2100,1565,153,153,306,50.0%,32m
43721,1,Hellstrum,2100,1232,139,146,285,48.8%,1h
43721,2,Surrealm,2100,1532,89,88,177,50.3%,1h
43721,2,ParadoX,2100,1131,57,42,99,57.6%,21m
43721,2,[GLNMS]deathrice,2100,1093,42,49,91,46.2%,30m
43721,1,IrisiaIsley,2100,680,27,37,64,42.2%,22m
43721,2,JayTi,2100,414,15,20,35,42.9%,4m
43721,2,DiVH,2100,250,14,12,26,53.8%,24m
43721,2,moodmanager,2100,331,11,20,31,35.5%,11m
43721,2,shaaad,2100,208,8,10,18,44.4%,7m
43721,1,Nibble,2100,224,8,11,19,42.1%,5m
43721,2,Xibur,2100,128,7,2,9,77.8%,21m
43721,2,noe,2100,130,5,0,5,100.0%,1h
43721,2,[GGro]LucheSSe,2100,92,4,5,9,44.4%,1h
43721,1,Cavalian,2100,185,3,4,7,42.9%,16m
43721,1,Rexen,2100,168,3,9,12,25.0%,11m
43721,2,Icenice,2100,30,2,1,3,66.7%,1h
43721,2,[Друг]ХОТТАБЫЧ,2100,30,2,3,5,40.0%,1h
43721,2,[MdMvs]detlefdisos,2100,0,1,0,1,100.0%,28m
43721,2,MarknütRösti,2100,96,1,1,2,50.0%,1h
43721,1,Борис,2100,0,1,7,8,12.5%,1h
43721,2,CharlieBravo,2100,30,1,8,9,11.1%,1h
43721,2,megolodon,2100,0,0,1,1,0.0%,1h
43721,2,grif,2100,0,0,2,2,0.0%,29m
43721,3,Jay,2100,0,0,4,4,0.0%,1h
43721,2,[DaFF]AlunaLumax,2100,0,0,7,7,0.0%,1h
43748,1,DarkAngel,2099,1674,175,184,359,48.7%,31m
43748,2,Sterillium,2099,1370,142,138,280,50.7%,28m
43748,3,Berrurier,2099,1393,74,85,159,46.5%,13m
43748,2,ЛЕПТОС,2099,957,60,60,120,50.0%,1h
43748,2,Look,2099,757,57,58,115,49.6%,1h
43748,2,alexxxeeeyyy,2099,1153,56,53,109,51.4%,1h
43748,2,Simaster,2099,782,29,29,58,50.0%,13m
43748,2,Фраерок,2099,661,27,37,64,42.2%,1h
43748,1,Pjevs,2099,762,23,33,56,41.1%,13m
43748,2,MyrAyan,2099,434,18,16,34,52.9%,30m
43748,2,Kurczak,2099,583,18,21,39,46.2%,32m
43748,1,Sentenx,2099,535,17,24,41,41.5%,18m
43748,2,luchyk,2099,414,14,18,32,43.8%,1h
43748,2,Leodiruk,2099,288,13,4,17,76.5%,1h
43748,2,Newton,2099,317,10,17,27,37.0%,10m
43748,2,Rahlen,2099,247,9,8,17,52.9%,18m
43748,2,Robby,2099,246,9,11,20,45.0%,20m
43748,3,GoodMan,2099,230,9,14,23,39.1%,1h
43748,2,[TFSC]Néo,2099,234,8,7,15,53.3%,18m
43748,2,stalker,2099,215,7,5,12,58.3%,1h
43748,2,Chotkiy,2099,269,7,7,14,50.0%,1h
43748,2,bojan,2099,134,5,8,13,38.5%,25m
43748,2,Witt,2099,126,4,2,6,66.7%,4m
43748,1,Hawk,2099,70,4,9,13,30.8%,1h
43748,1,Leonus,2099,168,4,11,15,26.7%,30m
43748,2,Partanus,2099,59,3,7,10,30.0%,1h
43748,1,EineGabel,2099,48,2,5,7,28.6%,1h
43748,2,WetBeaver,2099,88,1,2,3,33.3%,1h
43748,2,SHAMBERD,2099,0,1,3,4,25.0%,18m
43748,2,Toronto,2099,0,0,1,1,0.0%,1h
43748,3,Jazz,2099,0,0,2,2,0.0%,1h
43748,2,PrOvIdEr,2099,0,0,3,3,0.0%,1h
43748,3,[P00T]Вович,2099,0,0,5,5,0.0%,1h
43748,2,marean,2099,0,0,6,6,0.0%,21m
43782,3,rakka,2098,1562,530,546,1076,49.3%,15m
43782,2,Vit,2098,654,165,172,337,49.0%,32m
43782,2,Rasinnen,2098,1580,146,142,288,50.7%,24m
43782,1,Miranda,2098,1488,91,90,181,50.3%,1h
43782,2,[STOBAG]RISKYRISK,2098,1340,53,59,112,47.3%,1h
43782,2,[RVodka]Nikon,2098,510,49,46,95,51.6%,24m
43782,1,tbang,2098,660,22,32,54,40.7%,1h
43782,1,ДариН,2098,562,20,28,48,41.7%,1h
43782,2,hellminthes,2098,464,15,23,38,39.5%,31m
43782,2,Adrixis,2098,316,11,9,20,55.0%,33m
43782,2,[NoMøre]ObTortoCollo,2098,220,9,3,12,75.0%,1h
43782,2,catmaster,2098,297,9,17,26,34.6%,1h
43782,2,Oldax,2098,208,8,12,20,40.0%,10m
43782,2,Pol,2098,194,6,6,12,50.0%,23m
43782,2,[оОо0]EFEM,2098,135,6,11,17,35.3%,13m
43782,2,CMaster,2098,102,3,0,3,100.0%,13m
43782,1,donotAttack,2098,97,2,6,8,25.0%,6m
43782,2,Владян,2098,0,1,0,1,100.0%,1h
43782,2,[Olk]COMBNOVA,2098,94,1,2,3,33.3%,1h
43782,2,Alexterran,2098,30,1,2,3,33.3%,32m
43782,2,MaxxeN,2098,0,1,3,4,25.0%,24m
43782,2,Hasu,2098,88,1,5,6,16.7%,29m
43782,2,willy,2098,93,1,6,7,14.3%,1h
43782,2,MarsSeven,2098,0,0,1,1,0.0%,13m
43782,3,[Раки]OhOneRogue,2098,0,0,5,5,0.0%,31m
43807,1,Xstar,2097,1593,173,193,366,47.3%,1h
43807,2,Jheid,2097,1469,61,61,122,50.0%,33m
43807,2,Libertarian,2097,1239,54,57,111,48.6%,1h
43807,2,[OmDi]JOHNY,2097,771,46,49,95,48.4%,1h
43807,2,UMIO,2097,269,17,11,28,60.7%,25m
43807,2,[DIS]MarineKingPR,2097,480,17,14,31,54.8%,1h
43807,2,MuscleFlower,2097,386,16,10,26,61.5%,1h
43807,3,[BZTeam]PgmTriope,2097,228,10,13,23,43.5%,23m
43807,1,Bigdvae,2097,352,9,12,21,42.9%,8m
43807,2,[CHAWA]Tenshipøp,2097,280,9,13,22,40.9%,1h
43807,2,gevrek,2097,166,8,6,14,57.1%,11m
43807,1,ReDcOOl,2097,177,8,12,20,40.0%,1h
43807,2,Rossaf,2097,178,7,8,15,46.7%,25m
43807,2,almak,2097,216,6,10,16,37.5%,1h
43807,2,JABASS,2097,152,5,7,12,41.7%,1h
43807,2,[998373]виталя,2097,114,4,6,10,40.0%,5m
43807,2,Bragajiini,2097,118,4,12,16,25.0%,1h
43807,2,TuxTok,2097,58,3,2,5,60.0%,1h
43807,2,Parsifal,2097,94,3,4,7,42.9%,1h
43807,3,Zajebatsu,2097,0,2,3,5,40.0%,26m
43807,2,Zaraziteli,2097,60,2,3,5,40.0%,1h
43807,2,Toere,2097,0,1,0,1,100.0%,5m
43807,3,Davix,2097,42,1,5,6,16.7%,16m
43807,2,Rostovskii,2097,0,1,5,6,16.7%,14m
43807,3,SilentStorm,2097,0,0,2,2,0.0%,25m
43807,2,FerniMiguel,2097,0,0,5,5,0.0%,4m
43807,3,Harrigan,2097,0,0,5,5,0.0%,13m
43807,2,chabal,2097,0,0,6,6,0.0%,28m
43835,3,[RsTb]Red,2096,1541,330,349,679,48.6%,1h
43835,2,[aBueLo]Rob,2096,1615,177,183,360,49.2%,1h
43835,2,Manne,2096,1606,123,133,256,48.0%,20m
43835,2,Equido,2096,1439,110,109,219,50.2%,1h
43835,1,Keff,2096,633,68,87,155,43.9%,25m
43835,2,runorion,2096,1136,46,42,88,52.3%,1h
43835,2,JustPro,2096,594,34,34,68,50.0%,24m
43835,2,Newby,2096,543,26,22,48,54.2%,12m
43835,1,Masler,2096,708,24,29,53,45.3%,28m
43835,2,Pagani,2096,277,11,8,19,57.9%,1h
43835,1,медоед,2096,179,6,11,17,35.3%,28m
43835,2,сергей,2096,154,4,3,7,57.1%,1h
43835,2,Kratoss,2096,135,2,8,10,20.0%,1h
43835,2,Diligenter,2096,0,1,0,1,100.0%,1h
43835,2,Vichik,2096,88,1,6,7,14.3%,1h
43835,2,DragoSasha,2096,0,0,1,1,0.0%,19m
43835,2,GiannGreek,2096,0,0,1,1,0.0%,25m
43835,2,Flori,2096,0,0,3,3,0.0%,1h
43835,3,[NMTJ]KQsa,2096,0,0,5,5,0.0%,15m
43835,3,smokrasyzerg,2096,0,0,5,5,0.0%,1h
43835,3,[fumete]fealming,2096,0,0,5,5,0.0%,1h
43856,1,polenkao,2095,999,111,117,228,48.7%,10m
43856,2,CEKI,2095,907,80,65,145,55.2%,30m
43856,2,fegade,2095,1372,56,55,111,50.5%,11m
43856,2,Mads,2095,193,30,23,53,56.6%,13m
43856,1,[luxorx]xLUXORx,2095,492,16,24,40,40.0%,24m
43856,2,[HZeS]Lexus,2095,378,13,16,29,44.8%,1h
43856,2,Noob,2095,205,8,4,12,66.7%,1h
43856,2,Abormotrnd,2095,217,8,6,14,57.1%,32m
43856,3,[r32]Борщевик,2095,242,8,7,15,53.3%,25m
43856,2,davedabravee,2095,220,8,9,17,47.1%,1h
43856,2,Octopus,2095,291,8,18,26,30.8%,1h
43856,2,zafiroka,2095,162,4,10,14,28.6%,19m
43856,2,Ragnarok,2095,109,2,1,3,66.7%,1h
43856,3,JSTooth,2095,36,2,5,7,28.6%,25m
43856,1,karubu,2095,97,2,7,9,22.2%,5m
43856,1,upuaut,2095,48,2,9,11,18.2%,1h
43856,2,TubeDog,2095,0,1,1,2,50.0%,29m
43856,1,Hainex,2095,48,1,5,6,16.7%,1h
43856,1,Sakear,2095,0,0,1,1,0.0%,1h
43856,3,Грешник,2095,0,0,2,2,0.0%,7m
43856,2,Itherael,2095,0,0,3,3,0.0%,19m
43856,3,DEBGAME,2095,0,0,5,5,0.0%,1h
43856,3,FuturClassic,2095,0,0,5,5,0.0%,31m
43879,1,SxualChcolat,2094,1672,358,379,737,48.6%,33m
43879,2,stardust,2094,1587,262,268,530,49.4%,1h
43879,1,Vitaly,2094,1632,167,177,344,48.5%,28m
43879,3,Sanyi,2094,1470,132,140,272,48.5%,1h
43879,2,pomidor,2094,1562,92,98,190,48.4%,1h
43879,1,Karde,2094,1528,61,66,127,48.0%,3m
43879,2,samo,2094,525,46,37,83,55.4%,5m
43879,2,Neexs,2094,956,36,37,73,49.3%,1h
43879,2,[MGME]KappaClappa,2094,844,31,28,59,52.5%,29m
43879,2,Ruel,2094,762,28,28,56,50.0%,18m
43879,2,Dima,2094,373,14,11,25,56.0%,1h
43879,2,[GgWp9]leo,2094,314,12,7,19,63.2%,33m
43879,2,Revo,2094,231,9,5,14,64.3%,1h
43879,2,BroBarney,2094,266,9,15,24,37.5%,16m
43879,2,CoKoJI,2094,218,8,6,14,57.1%,1h
43879,2,SkyStar,2094,229,8,13,21,38.1%,13m
43879,3,RombVL,2094,272,8,15,23,34.8%,10m
43879,2,static,2094,180,7,3,10,70.0%,1h
43879,1,LongStroke,2094,190,6,10,16,37.5%,1h
43879,2,Chronos,2094,128,4,2,6,66.7%,1h
43879,2,[B00M4]DeafToAll,2094,64,3,3,6,50.0%,33m
43879,2,[4vD]WolfBlooded,2094,0,3,4,7,42.9%,3m
43879,3,ShinyPigeon,2094,66,3,4,7,42.9%,31m
43879,2,Sartori,2094,88,2,1,3,66.7%,15m
43879,2,Gonfaloner,2094,0,2,3,5,40.0%,20m
43879,2,Poison,2094,0,1,2,3,33.3%,1h
43879,3,chemist,2094,44,1,3,4,25.0%,1h
43879,1,alex,2094,48,1,3,4,25.0%,1h
43879,2,sovyx,2094,0,1,5,6,16.7%,1h
43879,2,Dimon,2094,0,0,1,1,0.0%,28m
43879,1,SilE,2094,0,0,1,1,0.0%,17m
43879,2,Mfezi,2094,0,0,2,2,0.0%,1h
43879,3,ForceOne,2094,0,0,2,2,0.0%,16m
43879,3,Foster,2094,0,0,4,4,0.0%,31m
43879,2,Daniel,2094,0,0,5,5,0.0%,32m
43879,2,Bence,2094,0,0,5,5,0.0%,25m
43915,2,semekh,2093,1553,110,101,211,52.1%,25m
43915,2,axelius,2093,1559,90,91,181,49.7%,1h
43915,2,scriptacc,2093,1310,54,56,110,49.1%,21m
43915,2,Macelix,2093,1224,49,55,104,47.1%,1h
43915,2,xixoterremot,2093,1142,40,45,85,47.1%,31m
43915,2,WerePenguin,2093,881,38,40,78,48.7%,20m
43915,2,Chernogled,2093,984,38,47,85,44.7%,1h
43915,2,[DТ]Accelerator,2093,626,24,26,50,48.0%,1h
43915,3,cigaHckiy,2093,329,22,33,55,40.0%,20m
43915,2,Yokoo,2093,368,13,16,29,44.8%,1h
43915,2,JaNo,2093,212,9,4,13,69.2%,27m
43915,2,Mefodys,2093,203,8,9,17,47.1%,1h
43915,2,[LoGiN]fraer,2093,211,7,6,13,53.8%,20m
43915,3,DrakonRe,2093,158,5,5,10,50.0%,1h
43915,2,Skull,2093,0,2,8,10,20.0%,12m
43915,3,Nacho,2093,30,2,10,12,16.7%,28m
43915,3,Ierifan,2093,0,1,0,1,100.0%,10m
43915,2,Пахан,2093,30,1,2,3,33.3%,1h
43915,1,Angelieux,2093,30,1,7,8,12.5%,31m
43915,2,Lolkass,2093,0,0,1,1,0.0%,1h
43915,2,PodguZZZnik,2093,0,0,2,2,0.0%,25m
43915,3,Derdan,2093,0,0,5,5,0.0%,26m
43915,2,Shuffle,2093,0,0,5,5,0.0%,1h
43938,2,APOLLO,2092,1395,127,123,250,50.8%,1h
43938,2,Pogha,2092,1313,65,65,130,50.0%,19m
43938,2,NAZGUL,2092,720,26,29,55,47.3%,7m
43938,3,pad,2092,400,14,10,24,58.3%,13m
43938,2,Borstol,2092,370,12,20,32,37.5%,18m
43938,2,Nifuro,2092,238,8,10,18,44.4%,5m
43938,3,Heeman,2092,218,7,8,15,46.7%,1h
43938,1,[zhuds]Саня,2092,152,6,14,20,30.0%,24m
43938,3,MrBavaria,2092,146,6,15,21,28.6%,1h
43938,1,PurpleBroly,2092,240,6,16,22,27.3%,17m
43938,2,Lex,2092,120,5,7,12,41.7%,27m
43938,1,LordPterax,2092,240,5,11,16,31.2%,23m
43938,2,ProTayToe,2092,88,3,2,5,60.0%,5m
43938,3,Beussey,2092,60,2,2,4,50.0%,3m
43938,2,DarkArthur,2092,30,2,4,6,33.3%,10m
43938,3,Ведьмак,2092,0,2,9,11,18.2%,1h
43938,3,[54D]GvozdukRU,2092,0,1,0,1,100.0%,1h
43938,3,Перфоратор,2092,0,1,0,1,100.0%,1h
43938,3,viktor,2092,0,1,0,1,100.0%,33m
43938,3,Shark,2092,0,1,0,1,100.0%,1h
43938,2,Барион,2092,0,1,1,2,50.0%,11m
43938,1,ANB,2092,48,1,3,4,25.0%,6m
43938,2,Flydor,2092,30,1,3,4,25.0%,24m
43938,3,[IMoGsP]trollman,2092,0,1,4,5,20.0%,1h
43938,2,Ambers,2092,30,1,7,8,12.5%,14m
43938,3,[Myrth]LoP,2092,0,0,1,1,0.0%,1h
43938,3,Skif,2092,0,0,1,1,0.0%,30m
43938,3,Moe,2092,0,0,1,1,0.0%,1h
43938,3,MaddoxMB,2092,0,0,1,1,0.0%,1h
43938,2,Idzi,2092,0,0,2,2,0.0%,1h
43938,3,[УЗУ]yar,2092,0,0,3,3,0.0%,1h
43938,3,Artemitol,2092,0,0,5,5,0.0%,16m
43938,3,Craco,2092,0,0,5,5,0.0%,12m
43971,2,RTD,2091,1545,134,142,276,48.6%,13m
43971,1,Opsys,2091,807,58,67,125,46.4%,23m
43971,2,PrimeGate,2091,489,35,40,75,46.7%,1h
43971,2,MasterFireSi,2091,376,13,10,23,56.5%,1h
43971,1,dzejkop,2091,350,9,19,28,32.1%,1h
43971,2,[WpG]WildWolf,2091,194,7,4,11,63.6%,1h
43971,2,Bargel,2091,118,5,4,9,55.6%,1h
43971,3,Eremak,2091,142,5,4,9,55.6%,1h
43971,2,Hamster,2091,128,4,1,5,80.0%,1h
43971,2,Gunthi,2091,164,4,5,9,44.4%,22m
43971,2,Bonesawed,2091,140,3,2,5,60.0%,1h
43971,2,[LOOOOS]MeatRoBot,2091,90,3,7,10,30.0%,23m
43971,3,Mexaformio,2091,0,1,0,1,100.0%,1h
43971,3,nuTTsik,2091,0,1,0,1,100.0%,28m
43971,1,materdeter,2091,0,1,7,8,12.5%,4m
43971,3,Maverick,2091,0,0,1,1,0.0%,28m
43971,2,PulauProst,2091,0,0,1,1,0.0%,27m
43971,2,Arcane,2091,0,0,3,3,0.0%,16m
43971,2,Sem,2091,0,0,5,5,0.0%,1h
43971,2,Skilles,2091,0,0,6,6,0.0%,1h
43991,2,Ricky,2090,1594,136,149,285,47.7%,1h
43991,2,[PTVru]Fatality,2090,1561,62,67,129,48.1%,1h
43991,2,alecs,2090,833,48,50,98,49.0%,6m
43991,2,Jonny,2090,1123,47,37,84,56.0%,1h
43991,2,XmuriyNik,2090,974,36,41,77,46.8%,1h
43991,2,Alysme,2090,816,30,39,69,43.5%,1h
43991,2,Helios,2090,683,29,23,52,55.8%,1h
43991,2,Balafre,2090,558,29,28,57,50.9%,27m
43991,3,Neelix,2090,725,23,38,61,37.7%,1h
43991,2,tobiu,2090,633,22,31,53,41.5%,1h
43991,2,Exhouster,2090,572,19,23,42,45.2%,13m
43991,1,Cyprine,2090,526,18,21,39,46.2%,31m
43991,3,ZERO,2090,267,16,10,26,61.5%,1h
43991,2,[Zhig]VICTOR,2090,217,12,8,20,60.0%,1h
43991,2,Apokalipsis,2090,157,6,0,6,100.0%,1h
43991,2,NoRiLL,2090,178,6,7,13,46.2%,31m
43991,1,[228822]Sparky,2090,139,4,0,4,100.0%,31m
43991,1,lipiciu,2090,36,2,8,10,20.0%,5m
43991,2,Pechept,2090,72,2,10,12,16.7%,32m
43991,3,Боров,2090,0,1,0,1,100.0%,26m
43991,3,[ffffhj]DiAbEtIk,2090,0,1,0,1,100.0%,5m
43991,2,kartalm,2090,46,1,3,4,25.0%,20m
43991,2,Spawn,2090,30,1,3,4,25.0%,1h
43991,2,Nickname,2090,48,1,3,4,25.0%,1h
43991,2,[blizou]darkAz,2090,0,1,4,5,20.0%,1h
43991,2,Nivada,2090,0,1,7,8,12.5%,29m
43991,1,pragib,2090,0,1,7,8,12.5%,9m
43991,3,Deathnar,2090,0,0,1,1,0.0%,24m
43991,2,Archalia,2090,0,0,1,1,0.0%,1h
43991,2,Lyxsh,2090,0,0,2,2,0.0%,1h
43991,2,дракон,2090,0,0,4,4,0.0%,1h
43991,3,Новик,2090,0,0,5,5,0.0%,28m
43991,2,DJFK,2090,0,0,6,6,0.0%,22m
44024,1,Kettle,2089,1610,668,722,1390,48.1%,24m
44024,2,illyuzionist,2089,1253,66,63,129,51.2%,28m
44024,2,Varrient,2089,914,38,45,83,45.8%,8m
44024,2,Juniper,2089,950,35,39,74,47.3%,1h
44024,2,MonsieurB,2089,836,29,30,59,49.2%,16m
44024,2,pexotinec,2089,623,24,22,46,52.2%,1h
44024,2,Rushlappen,2089,574,22,22,44,50.0%,28m
44024,1,DaniiXeto,2089,596,18,28,46,39.1%,1h
44024,2,[WP]BlaueZitrone,2089,470,16,24,40,40.0%,1h
44024,2,Gadger,2089,210,11,11,22,50.0%,13m
44024,2,Sylla,2089,290,11,14,25,44.0%,1h
44024,2,Deceneu,2089,232,9,7,16,56.2%,1h
44024,2,Emildquity,2089,208,8,9,17,47.1%,13m
44024,2,SolArgenti,2089,174,5,4,9,55.6%,1h
44024,2,[abffl]Rant,2089,146,5,11,16,31.2%,23m
44024,3,Laitius,2089,147,4,3,7,57.1%,12m
44024,1,makc,2089,144,3,1,4,75.0%,1h
44024,2,ZAmonolit,2089,126,3,2,5,60.0%,12m
44024,2,Syl,2089,30,3,4,7,42.9%,8m
44024,3,Lamabanana,2089,86,3,8,11,27.3%,21m
44024,1,Mester,2089,86,3,10,13,23.1%,10m
44024,3,Lazio,2089,30,2,0,2,100.0%,11m
44024,2,CosaNostra,2089,30,2,6,8,25.0%,21m
44024,2,Frentano,2089,62,2,6,8,25.0%,5m
44024,3,[RIAW]cityzenkane,2089,30,1,1,2,50.0%,24m
44024,2,[OmDi]Filemazio,2089,88,1,2,3,33.3%,34m
44024,3,[HYÐRA]Lixn,2089,30,1,3,4,25.0%,1h
44024,2,Zébrax,2089,0,1,4,5,20.0%,1h
44024,1,Rykk,2089,0,1,6,7,14.3%,1h
44024,2,RedDevil,2089,0,1,7,8,12.5%,16m
44024,3,schnarphooo,2089,0,0,1,1,0.0%,1h
44024,3,[RxCh]AnalnyCherv,2089,0,0,1,1,0.0%,1h
44024,3,MehanizaTor,2089,0,0,5,5,0.0%,1h
44024,3,pindes,2089,0,0,5,5,0.0%,1h
44024,2,oatmilk,2089,0,0,6,6,0.0%,20m
44059,2,Barin,2088,879,285,286,571,49.9%,34m
44059,2,aspeed,2088,551,72,72,144,50.0%,1h
44059,1,navodchik,2088,1582,67,61,128,52.3%,1h
44059,2,AMNIBAL,2088,563,36,40,76,47.4%,34m
44059,3,Pestilla,2088,619,26,17,43,60.5%,22m
44059,3,Rosomak,2088,468,21,15,36,58.3%,1h
44059,2,broken,2088,438,17,20,37,45.9%,34m
44059,2,alexeich,2088,382,14,18,32,43.8%,18m
44059,2,LittleLion,2088,381,14,23,37,37.8%,29m
44059,2,FreeDoc,2088,391,13,18,31,41.9%,25m
44059,2,Serg,2088,288,12,15,27,44.4%,16m
44059,2,МалышKid,2088,174,7,10,17,41.2%,18m
44059,2,alexKILLER,2088,190,6,5,11,54.5%,24m
44059,2,[sxm97]elflaco,2088,190,6,13,19,31.6%,1h
44059,2,[Lowko]Airneanach,2088,116,4,6,10,40.0%,31m
44059,1,Satellite,2088,74,4,9,13,30.8%,1h
44059,2,Henrik,2088,62,3,2,5,60.0%,20m
44059,2,Rattoros,2088,0,3,3,6,50.0%,34m
44059,2,VVV,2088,85,3,4,7,42.9%,13m
44059,1,Oznerol,2088,121,3,10,13,23.1%,4m
44059,3,SKROPZ,2088,58,2,2,4,50.0%,1h
44059,3,[Listic]Jeppsson,2088,0,2,3,5,40.0%,11m
44059,3,ТихийМеч,2088,30,2,4,6,33.3%,20m
44059,1,Waggy,2088,78,2,6,8,25.0%,15m
44059,2,lapindu,2088,143,2,7,9,22.2%,27m
44059,3,[ZiCh]Алукард,2088,0,1,0,1,100.0%,1h
44059,3,IIIIIIIIIIII,2088,0,1,0,1,100.0%,1h
44059,3,[Kicx]Merong,2088,30,1,1,2,50.0%,30m
44059,2,Michirenn,2088,88,1,2,3,33.3%,25m
44059,2,[widma]DominikO,2088,30,1,7,8,12.5%,1h
44059,2,Rasti,2088,0,0,2,2,0.0%,1h
44059,3,Rincecochon,2088,0,0,5,5,0.0%,15m
44091,1,[Petrиs]weshdjé,2087,1556,70,73,143,49.0%,1h
44091,2,LINCOLN,2087,1467,60,54,114,52.6%,1h
44091,3,felipe,2087,1419,57,59,116,49.1%,13m
44091,2,Kristina,2087,422,39,44,83,47.0%,31m
44091,2,DmitriyY,2087,987,38,40,78,48.7%,1h
44091,2,oshik,2087,738,29,31,60,48.3%,1h
44091,3,seizd,2087,468,18,6,24,75.0%,1h
44091,1,Stéphano,2087,427,17,23,40,42.5%,1h
44091,3,DYSNEY,2087,372,13,8,21,61.9%,24m
44091,2,rysiek,2087,262,11,12,23,47.8%,20m
44091,2,Bersi,2087,252,9,20,29,31.0%,20m
44091,1,Adam,2087,293,9,22,31,29.0%,1h
44091,2,bourdonne,2087,210,8,8,16,50.0%,1h
44091,2,kalabaha,2087,146,3,5,8,37.5%,1h
44091,2,MajorAndy,2087,30,2,3,5,40.0%,22m
44091,3,[FinSc2]Tesla,2087,0,1,0,1,100.0%,1h
44091,2,Zadrok,2087,0,1,3,4,25.0%,1h
44091,2,Fandango,2087,30,1,7,8,12.5%,1h
44091,2,Kenshi,2087,0,0,1,1,0.0%,1h
44091,3,Sergik,2087,0,0,5,5,0.0%,25m
44091,3,Aldoris,2087,0,0,5,5,0.0%,1h
44091,3,Avi,2087,0,0,5,5,0.0%,16m
44113,2,Nytro,2086,1570,130,131,261,49.8%,1h
44113,2,Dvg,2086,1383,89,94,183,48.6%,4m
44113,1,justejp,2086,1064,55,54,109,50.5%,33m
44113,2,Gilloux,2086,860,45,39,84,53.6%,1h
44113,2,Фантом,2086,709,25,27,52,48.1%,1h
44113,1,[9HNT9]Trofim,2086,634,23,24,47,48.9%,1h
44113,2,[EE]EEǂBarnex,2086,566,21,20,41,51.2%,14m
44113,2,Vaflandiy,2086,578,20,27,47,42.6%,14m
44113,2,[666999]IsoldMySoul,2086,351,14,15,29,48.3%,31m
44113,2,Джон,2086,326,13,26,39,33.3%,1h
44113,3,[Eiwit]Sabre,2086,242,10,5,15,66.7%,12m
44113,2,Mossel,2086,292,10,14,24,41.7%,15m
44113,2,Papashka,2086,281,9,10,19,47.4%,24m
44113,2,Asgi,2086,234,9,11,20,45.0%,10m
44113,1,KeKCuk,2086,303,7,8,15,46.7%,17m
44113,3,NerV,2086,247,7,13,20,35.0%,24m
44113,2,Slyth,2086,122,5,4,9,55.6%,14m
44113,1,Lakal,2086,149,4,9,13,30.8%,1h
44113,2,[HellFi]Gybet,2086,118,4,10,14,28.6%,15m
44113,2,nzak,2086,115,3,2,5,60.0%,1h
44113,1,Taac,2086,62,3,9,12,25.0%,6m
44113,2,OIOIIOOI,2086,0,2,5,7,28.6%,9m
44113,2,rInaS,2086,46,2,7,9,22.2%,1h
44113,1,Endy,2086,36,2,8,10,20.0%,1h
44113,3,Biggie,2086,0,2,11,13,15.4%,27m
44113,1,Madstico,2086,48,1,2,3,33.3%,1h
44113,2,DiviNalex,2086,30,1,4,5,20.0%,1h
44113,3,Thawn,2086,40,1,6,7,14.3%,7m
44113,1,ThomV,2086,0,1,8,9,11.1%,8m
44113,3,[DWOO]Casmira,2086,0,0,1,1,0.0%,1h
44113,3,Awksom,2086,0,0,1,1,0.0%,33m
44113,3,[Dadgar]gyzelote,2086,0,0,1,1,0.0%,13m
44113,3,Marcko,2086,0,0,1,1,0.0%,30m
44113,2,Anko,2086,0,0,2,2,0.0%,1h
44113,2,Korvalis,2086,0,0,3,3,0.0%,1h
44113,3,Dimesh,2086,0,0,4,4,0.0%,12m
44113,3,bowbac,2086,0,0,5,5,0.0%,25m
44113,3,MurmelZahn,2086,0,0,5,5,0.0%,1h
44113,3,karpenich,2086,0,0,5,5,0.0%,21m
44113,2,Fatnub,2086,0,0,6,6,0.0%,28m
44153,2,ballsnroll,2085,1593,115,122,237,48.5%,13m
44153,2,dan,2085,884,74,73,147,50.3%,25m
44153,2,Zeratul,2085,1542,69,76,145,47.6%,1h
44153,2,SoloLeveling,2085,530,35,39,74,47.3%,4m
44153,1,[EXPANT]Splayn,2085,705,30,28,58,51.7%,33m
44153,2,thanos,2085,748,29,29,58,50.0%,1h
44153,2,Albert,2085,614,24,24,48,50.0%,1h
44153,3,YCS,2085,556,21,17,38,55.3%,1h
44153,2,Wyndigo,2085,343,16,19,35,45.7%,1h
44153,1,Cillij,2085,358,11,19,30,36.7%,28m
44153,2,[HVSR]NUFE,2085,182,7,10,17,41.2%,1h
44153,3,lolmaster,2085,209,6,13,19,31.6%,1h
44153,3,Alcaudon,2085,163,4,4,8,50.0%,6m
44153,2,Interaction,2085,86,4,4,8,50.0%,1h
44153,3,[Iperyt]Лизонька,2085,165,4,5,9,44.4%,15m
44153,3,НОЧНОЙ,2085,58,2,1,3,66.7%,24m
44153,1,[ViaN]Mexico,2085,95,2,1,3,66.7%,10m
44153,2,[31337Ъ]albert,2085,60,2,6,8,25.0%,1h
44153,2,TheDavidTM,2085,46,2,7,9,22.2%,1h
44153,2,Brockwell,2085,48,2,7,9,22.2%,1h
44153,2,Zerg,2085,48,1,3,4,25.0%,1h
44153,2,coldghost,2085,0,1,3,4,25.0%,21m
44153,3,[15]Valtudo,2085,30,1,4,5,20.0%,1h
44153,2,skykontra,2085,0,1,4,5,20.0%,5m
44153,1,tano,2085,97,1,6,7,14.3%,1h
44153,3,Bubaj,2085,0,1,8,9,11.1%,20m
44153,3,zalupa,2085,0,0,1,1,0.0%,1h
44153,3,Bodó,2085,0,0,1,1,0.0%,1h
44153,2,Masqu,2085,0,0,2,2,0.0%,1h
44153,2,RAdamP,2085,0,0,2,2,0.0%,1h
44153,2,[nWss]Overlord,2085,0,0,3,3,0.0%,1h
44153,2,Kauto,2085,0,0,4,4,0.0%,1h
44153,1,[Tesese]NinJaDiMs,2085,0,0,4,4,0.0%,10m
44153,3,volc,2085,0,0,5,5,0.0%,1h
44153,2,George,2085,0,0,5,5,0.0%,31m
44188,2,DarkBenJ,2084,1525,113,119,232,48.7%,1h
44188,2,[31zig]SaltyPeaCy,2084,1358,54,57,111,48.6%,1h
44188,2,Triskelion,2084,805,31,29,60,51.7%,33m
44188,2,GUIWILLY,2084,600,21,23,44,47.7%,10m
44188,2,ASH,2084,554,18,20,38,47.4%,1h
44188,2,SirDuke,2084,321,15,21,36,41.7%,34m
44188,1,[UDIE]falangista,2084,484,14,26,40,35.0%,1h
44188,2,АртёмБаг,2084,333,11,21,32,34.4%,1h
44188,2,gleb,2084,148,6,5,11,54.5%,1h
44188,2,Aurenen,2084,206,6,6,12,50.0%,1h
44188,3,GreenViz,2084,121,3,1,4,75.0%,30m
44188,2,Apelsinchik,2084,116,2,3,5,40.0%,1h
44188,2,Kobe,2084,30,1,3,4,25.0%,1h
44188,2,Danny,2084,95,1,5,6,16.7%,29m
44188,2,Amosanda,2084,94,1,6,7,14.3%,1h
44188,2,Fildacz,2084,30,1,7,8,12.5%,1h
44188,1,хмурыйкот,2084,0,1,7,8,12.5%,1h
44188,3,Winnere,2084,0,0,1,1,0.0%,21m
44188,1,Shader,2084,0,0,2,2,0.0%,1h
44188,2,andrei,2084,0,0,2,2,0.0%,4m
44188,3,Ghoustrider,2084,0,0,2,2,0.0%,25m
44188,3,[Bottom]Houston,2084,0,0,5,5,0.0%,9m
44188,1,Daniel,2084,0,0,6,6,0.0%,1h
44188,3,[VFN]Maradöner,2084,0,0,6,6,0.0%,1h
44212,3,[OGCC]zorro,2083,1517,456,472,928,49.1%,18m
44212,1,FatAlbert,2083,1587,185,191,376,49.2%,1h
44212,2,NEBUCH,2083,1625,182,191,373,48.8%,5m
44212,1,MihaiMD,2083,1533,89,98,187,47.6%,1h
44212,1,Славян,2083,1382,82,80,162,50.6%,10m
44212,1,Lovpalek,2083,1033,35,48,83,42.2%,24m
44212,2,Pieter,2083,694,26,32,58,44.8%,12m
44212,2,xDisaster,2083,478,18,21,39,46.2%,1h
44212,2,Felix,2083,329,13,20,33,39.4%,1h
44212,3,[DDiv]SpeedyFrog,2083,300,11,7,18,61.1%,1h
44212,2,kallen,2083,282,9,16,25,36.0%,11m
44212,1,Getman,2083,264,8,12,20,40.0%,17m
44212,1,MathiAss,2083,196,7,13,20,35.0%,1h
44212,2,Siempre,2083,187,6,10,16,37.5%,1h
44212,1,DragonTank,2083,186,6,12,18,33.3%,12m
44212,2,jamax,2083,136,4,6,10,40.0%,16m
44212,2,NoSkyvisible,2083,68,3,5,8,37.5%,8m
44212,1,Silver,2083,183,3,6,9,33.3%,1h
44212,2,Charlemagne,2083,0,2,5,7,28.6%,1h
44212,2,Saimyr,2083,0,1,6,7,14.3%,1h
44212,2,Nuke,2083,0,1,7,8,12.5%,1h
44212,1,ХмурыйМонах,2083,0,1,8,9,11.1%,1h
44212,3,tyrann,2083,0,0,1,1,0.0%,1h
44212,2,lager,2083,0,0,2,2,0.0%,1h
44212,3,[N3VADA]NEON,2083,0,0,2,2,0.0%,1h
44212,3,AwesomeWolf,2083,0,0,4,4,0.0%,7m
44212,1,MѦҲҲҲMIR,2083,0,0,4,4,0.0%,23m
44212,3,SilverT,2083,0,0,5,5,0.0%,1h
44212,3,husky,2083,0,0,5,5,0.0%,31m
44212,3,Уланар,2083,0,0,5,5,0.0%,1h
44212,3,LUGOBOY,2083,0,0,5,5,0.0%,15m
44212,2,[OTW6]Float,2083,0,0,6,6,0.0%,31m
44244,2,DeuX,2082,1633,322,368,690,46.7%,12m
44244,2,Артур,2082,1531,139,144,283,49.1%,31m
44244,2,MerzigEU,2082,1351,51,51,102,50.0%,6m
44244,2,Teaman,2082,782,28,31,59,47.5%,1h
44244,2,jmdr,2082,674,25,34,59,42.4%,1h
44244,2,Jorge,2082,499,17,19,36,47.2%,1h
44244,1,MirFak,2082,490,15,24,39,38.5%,1h
44244,2,uzy,2082,229,8,7,15,53.3%,1h
44244,1,Rogue,2082,274,7,20,27,25.9%,20m
44244,2,[spmahc]Constinie,2082,130,5,1,6,83.3%,31m
44244,1,Anthopas,2082,191,5,13,18,27.8%,1h
44244,3,Kismiska,2082,88,4,1,5,80.0%,1h
44244,1,BoyNextDoor,2082,120,4,8,12,33.3%,1h
44244,2,Hugbjo,2082,140,3,4,7,42.9%,1h
44244,2,käptnkirk,2082,60,2,6,8,25.0%,29m
44244,2,Link,2082,30,1,7,8,12.5%,27m
44244,3,Eduard,2082,0,0,2,2,0.0%,31m
44244,3,lightnokami,2082,0,0,3,3,0.0%,1h
44244,2,[Deg0tr]DimosikoG,2082,0,0,7,7,0.0%,1h
44263,1,LockdownNL,2081,1610,73,75,148,49.3%,6m
44263,2,GladioBAB,2081,1553,72,81,153,47.1%,19m
44263,2,VitorNeto,2081,762,28,29,57,49.1%,13m
44263,2,Андр,2081,758,27,33,60,45.0%,1h
44263,2,Tofa,2081,445,20,14,34,58.8%,1h
44263,2,Akkan,2081,503,18,25,43,41.9%,1h
44263,2,DeltaPL,2081,178,6,10,16,37.5%,1h
44263,1,migue,2081,160,6,11,17,35.3%,20m
44263,2,Anubis,2081,0,4,3,7,57.1%,19m
44263,3,ikane,2081,163,4,14,18,22.2%,24m
44263,2,TabAK,2081,122,3,5,8,37.5%,10m
44263,1,Proximo,2081,96,3,11,14,21.4%,18m
44263,3,calcatoghju,2081,24,3,11,14,21.4%,1h
44263,2,Teisu,2081,30,2,7,9,22.2%,1h
44263,2,persefonya,2081,30,1,7,8,12.5%,1h
44263,3,gramikSp,2081,0,0,1,1,0.0%,1h
44263,2,человвек,2081,0,0,2,2,0.0%,1h
44263,3,[1DZ1]пИДоИТЕР,2081,0,0,4,4,0.0%,1h
44281,2,KrAnd,2080,754,68,61,129,52.7%,1h
44281,2,FENIX,2080,1494,58,61,119,48.7%,1h
44281,2,iDealMys,2080,965,39,39,78,50.0%,1h
44281,2,Qubutus,2080,974,38,45,83,45.8%,1h
44281,3,[SS13]ASD,2080,721,29,16,45,64.4%,12m
44281,3,[NICHE]Safarda,2080,655,24,20,44,54.5%,1h
44281,2,Potato,2080,481,23,21,44,52.3%,13m
44281,3,[AlDS]Skipper,2080,376,13,12,25,52.0%,1h
44281,2,Sick,2080,239,9,8,17,52.9%,1h
44281,1,Marvin,2080,317,9,17,26,34.6%,1h
44281,1,Olivcrer,2080,222,9,17,26,34.6%,1h
44281,3,Lev,2080,170,7,3,10,70.0%,1h
44281,2,KibepBEDPO,2080,141,7,5,12,58.3%,1h
44281,1,Promix,2080,138,6,11,17,35.3%,16m
44281,3,Ediakar,2080,30,5,2,7,71.4%,1h
44281,3,HiveSphere,2080,140,5,8,13,38.5%,1h
44281,1,dje,2080,239,5,12,17,29.4%,1h
44281,1,Voynoy,2080,160,5,12,17,29.4%,25m
44281,3,camardon,2080,86,4,3,7,57.1%,28m
44281,2,Sem,2080,94,4,4,8,50.0%,1h
44281,1,[Sc2V]SmokeEyes,2080,48,4,7,11,36.4%,31m
44281,1,NeyerStokken,2080,191,4,8,12,33.3%,3m
44281,2,SLim,2080,124,4,8,12,33.3%,31m
44281,2,[Ɖŕąĩǵǿ]DuneRunner,2080,138,3,4,7,42.9%,10m
44281,1,Guhhok,2080,193,3,7,10,30.0%,1h
44281,2,Lightselect,2080,92,3,8,11,27.3%,29m
44281,2,Tabati,2080,30,2,3,5,40.0%,1h
44281,1,duzy,2080,48,2,5,7,28.6%,10m
44281,1,Radu,2080,82,2,8,10,20.0%,6m
44281,2,Bilal,2080,88,2,8,10,20.0%,16m
44281,2,sava,2080,60,2,8,10,20.0%,1h
44281,3,Siperhitter,2080,0,1,0,1,100.0%,24m
44281,3,Lascul,2080,0,0,1,1,0.0%,33m
44281,2,CrazyCat,2080,0,0,1,1,0.0%,1h
44281,3,Deadlife,2080,0,0,1,1,0.0%,1h
44281,3,Maximax,2080,0,0,5,5,0.0%,1h
44317,1,[FYBF]NEVEN,2079,1485,62,75,137,45.3%,29m
44317,2,IMPcrunchie,2079,1159,45,54,99,45.5%,31m
44317,2,Zarouss,2079,768,31,30,61,50.8%,31m
44317,2,Valkyr,2079,689,23,28,51,45.1%,1h
44317,2,Birdyves,2079,374,14,18,32,43.8%,1h
44317,2,isipollokill,2079,349,13,19,32,40.6%,29m
44317,2,McNinja,2079,296,10,13,23,43.5%,15m
44317,2,bimmbalas,2079,174,6,3,9,66.7%,1h
44317,1,swedikok,2079,234,6,5,11,54.5%,18m
44317,2,IMS,2079,97,5,8,13,38.5%,1h
44317,1,[uui]CoZeroG,2079,112,5,10,15,33.3%,1h
44317,3,Exmiar,2079,183,5,15,20,25.0%,27m
44317,2,Tasche,2079,90,3,8,11,27.3%,1h
44317,1,Killersmail,2079,48,3,9,12,25.0%,17m
44317,3,Letrik,2079,60,2,3,5,40.0%,26m
44317,3,Kortik,2079,0,2,3,5,40.0%,15m
44317,3,DeathKnight,2079,121,2,5,7,28.6%,9m
44317,1,Regolit,2079,46,2,8,10,20.0%,1h
44317,2,Echelon,2079,30,1,5,6,16.7%,1h
44317,2,DARREN,2079,0,1,5,6,16.7%,1h
44317,3,[DarkV]Vempajer,2079,0,0,1,1,0.0%,1h
44317,3,proworx,2079,0,0,1,1,0.0%,1h
44317,3,MrBingoBongo,2079,0,0,1,1,0.0%,7m
44317,3,JBJ,2079,0,0,1,1,0.0%,27m
44317,3,dredgos,2079,0,0,5,5,0.0%,1h
44317,3,Cloaker,2079,0,0,5,5,0.0%,13m
44317,3,Vadimation,2079,0,0,5,5,0.0%,1h
44317,3,rmaron,2079,0,0,5,5,0.0%,1h
44317,3,PANOSDIM,2079,0,0,5,5,0.0%,7m
44346,2,Animissimo,2078,1209,102,109,211,48.3%,1h
44346,2,Artemis,2078,1040,95,106,201,47.3%,31m
44346,2,Olympiacos,2078,1474,57,60,117,48.7%,12m
44346,2,MisterED,2078,1132,48,47,95,50.5%,11m
44346,2,Retro,2078,473,21,14,35,60.0%,1h
44346,2,Petredo,2078,599,20,26,46,43.5%,28m
44346,2,theoryofmind,2078,415,19,22,41,46.3%,1h
44346,2,IBRA,2078,499,17,24,41,41.5%,31m
44346,1,Doggy,2078,226,10,13,23,43.5%,3m
44346,2,lfybkf,2078,306,10,15,25,40.0%,1h
44346,2,[MATMAR]ZergvanZyl,2078,229,7,8,15,46.7%,10m
44346,2,Stasdoc,2078,227,4,7,11,36.4%,29m
44346,2,Franky,2078,102,3,7,10,30.0%,1h
44346,2,Devourer,2078,30,2,3,5,40.0%,28m
44346,3,[64GROT]CapRuiner,2078,0,1,0,1,100.0%,10m
44346,3,МрачныйВорон,2078,0,1,4,5,20.0%,27m
44346,2,Luber,2078,0,1,5,6,16.7%,5m
44346,1,[LycHSE]WolfRage,2078,0,1,7,8,12.5%,3m
44346,2,ironyeu,2078,34,1,7,8,12.5%,8m
44346,2,GCoN,2078,0,0,4,4,0.0%,21m
44346,3,Emir,2078,0,0,5,5,0.0%,28m
44346,2,[Hivе]maxis,2078,0,0,6,6,0.0%,24m
44368,2,Jadrak,2077,1298,131,136,267,49.1%,1h
44368,2,NTK,2077,1179,99,93,192,51.6%,1h
44368,1,MARCOS,2077,1490,77,85,162,47.5%,29m
44368,2,серый,2077,1259,62,60,122,50.8%,1h
44368,2,Rusenshtein,2077,1144,49,39,88,55.7%,14m
44368,2,Demonik,2077,857,47,56,103,45.6%,33m
44368,3,Knorri,2077,373,13,4,17,76.5%,30m
44368,3,DarkWolfS,2077,271,8,8,16,50.0%,33m
44368,2,Maestro,2077,164,7,16,23,30.4%,1h
44368,1,TimirXan,2077,200,6,17,23,26.1%,1h
44368,2,nissew,2077,150,5,12,17,29.4%,1h
44368,1,[Zakel]Danarion,2077,214,5,12,17,29.4%,26m
44368,1,[Тянки]Nikollya,2077,193,4,6,10,40.0%,14m
44368,3,Kirillious,2077,90,3,3,6,50.0%,1h
44368,2,Epinitril,2077,86,3,6,9,33.3%,1h
44368,2,kjelles,2077,104,3,9,12,25.0%,11m
44368,3,Alexspoison,2077,58,2,1,3,66.7%,3m
44368,2,Deawoolf,2077,58,2,4,6,33.3%,25m
44368,1,Timur,2077,97,2,4,6,33.3%,1h
44368,3,[Ejine]Cleaner,2077,0,2,10,12,16.7%,6m
44368,3,[Allakh]Sauge,2077,44,1,2,3,33.3%,4m
44368,1,imkiss,2077,0,1,2,3,33.3%,17m
44368,2,Juri,2077,30,1,3,4,25.0%,1h
44368,3,[HaTaMB]CommanderEm,2077,0,1,4,5,20.0%,31m
44368,3,Snaider,2077,0,0,1,1,0.0%,1h
44368,3,[GlNYU]Onlineritter,2077,0,0,1,1,0.0%,1h
44368,3,Lamia,2077,0,0,5,5,0.0%,28m
44368,3,truspp,2077,0,0,5,5,0.0%,27m
44368,3,shane,2077,0,0,5,5,0.0%,1h
44397,2,Tubbs,2076,1056,54,63,117,46.2%,29m
44397,2,Trypochek,2076,763,52,52,104,50.0%,1h
44397,2,skAt,2076,789,44,46,90,48.9%,10m
44397,2,berti,2076,668,24,27,51,47.1%,1h
44397,3,Groovyboy,2076,407,14,10,24,58.3%,12m
44397,3,Мишаня,2076,365,12,10,22,54.5%,16m
44397,2,Vasilevich,2076,324,10,18,28,35.7%,23m
44397,2,trilliAn,2076,246,9,12,21,42.9%,31m
44397,1,[ExTr1m]Gor,2076,158,5,12,17,29.4%,26m
44397,1,rocko,2076,169,4,9,13,30.8%,22m
44397,1,Danielo,2076,96,4,11,15,26.7%,1h
44397,2,[MLL]Dunder,2076,0,1,5,6,16.7%,23m
44397,1,[LMBD]demci,2076,97,1,5,6,16.7%,1h
44397,1,strateg,2076,0,1,6,7,14.3%,27m
44397,3,Atilius,2076,0,0,1,1,0.0%,34m
44397,2,Hovo,2076,0,0,2,2,0.0%,1h
44397,2,[FUNCS]Sójka,2076,0,0,2,2,0.0%,1h
44397,3,Gazvezir,2076,0,0,3,3,0.0%,1h
44415,2,[nWss]Dragos,2075,1542,140,134,274,51.1%,1h
44415,2,cutu,2075,1569,100,103,203,49.3%,28m
44415,2,Vondonnie,2075,1282,96,96,192,50.0%,34m
44415,2,zdanakas,2075,1304,73,58,131,55.7%,29m
44415,2,Killer,2075,1442,71,72,143,49.7%,10m
44415,2,[LFBro]StarLord,2075,1288,50,52,102,49.0%,20m
44415,2,mathias,2075,869,48,39,87,55.2%,20m
44415,2,SigisCraft,2075,1177,48,49,97,49.5%,33m
44415,2,ManiAnfo,2075,688,26,25,51,51.0%,5m
44415,1,IIIIIIIIII,2075,823,26,40,66,39.4%,1h
44415,2,Dudu,2075,550,21,20,41,51.2%,1h
44415,3,sjorsw,2075,501,18,10,28,64.3%,16m
44415,2,Domanoid,2075,455,15,16,31,48.4%,1h
44415,2,Visionrage,2075,360,15,18,33,45.5%,1h
44415,3,usALar,2075,306,11,9,20,55.0%,1h
44415,2,GoodWood,2075,295,11,18,29,37.9%,1h
44415,3,Grziwi,2075,297,10,17,27,37.0%,1h
44415,1,[MGNFL]MegaBob,2075,309,9,19,28,32.1%,1h
44415,1,demiurg,2075,166,4,11,15,26.7%,1h
44415,2,DOMINATOR,2075,88,3,5,8,37.5%,1h
44415,2,Mechoka,2075,88,3,8,11,27.3%,5m
44415,3,sosin,2075,30,3,9,12,25.0%,1h
44415,1,machi,2075,145,2,6,8,25.0%,6m
44415,2,Eratosthenes,2075,0,1,6,7,14.3%,1h
44415,3,bkv,2075,0,0,1,1,0.0%,1h
44415,3,RegularStrat,2075,0,0,1,1,0.0%,10m
44415,2,InfestedZerg,2075,0,0,3,3,0.0%,1h
44415,3,sdG,2075,0,0,5,5,0.0%,31m
44415,3,markelovdn,2075,0,0,5,5,0.0%,12m
44415,3,eugenyyy,2075,0,0,5,5,0.0%,1h
44415,2,[KOIDS]Ares,2075,0,0,6,6,0.0%,13m
44415,2,DynamiX,2075,0,0,6,6,0.0%,28m
44447,2,ISONOVA,2074,968,36,41,77,46.8%,1h
44447,1,GLHF,2074,906,32,37,69,46.4%,29m
44447,3,[SFK77]Secret,2074,688,26,36,62,41.9%,6m
44447,2,[TSC2C]Osoko,2074,756,25,28,53,47.2%,27m
44447,1,mishuz,2074,420,14,29,43,32.6%,1h
44447,2,Sultan,2074,222,7,7,14,50.0%,1h
44447,1,[sTarTA]URInDanger,2074,290,7,8,15,46.7%,1h
44447,2,TimFire,2074,180,6,4,10,60.0%,23m
44447,3,[2GAZ]MacaRonan,2074,154,6,11,17,35.3%,9m
44447,2,kef,2074,30,4,4,8,50.0%,15m
44447,3,MrKindman,2074,151,4,11,15,26.7%,28m
44447,1,Smoxe,2074,161,3,2,5,60.0%,10m
44447,1,CyboPat,2074,46,3,9,12,25.0%,32m
44447,3,ЯнеизРоссии,2074,30,2,1,3,66.7%,1h
44447,1,BoneBreaker,2074,0,1,0,1,100.0%,1h
44447,3,Tavi,2074,30,1,1,2,50.0%,10m
44447,3,ArdronDryker,2074,30,1,1,2,50.0%,13m
44447,3,Protoss,2074,48,1,3,4,25.0%,1h
44447,2,RoY,2074,30,1,3,4,25.0%,1h
44447,2,Malevih,2074,0,1,6,7,14.3%,28m
44447,2,Predator,2074,95,1,7,8,12.5%,1h
44447,3,Neisan,2074,0,0,1,1,0.0%,1h
44447,3,GRYNIU,2074,0,0,2,2,0.0%,1h
44447,3,MasterLom,2074,0,0,2,2,0.0%,1h
44447,3,Nassim,2074,0,0,5,5,0.0%,7m
44447,3,[CUMR]Stepanich,2074,0,0,5,5,0.0%,1h
44447,3,orochisam,2074,0,0,5,5,0.0%,1h
44447,2,dynamojoe,2074,0,0,6,6,0.0%,32m
44475,2,Rubiogoe,2073,643,46,43,89,51.7%,29m
44475,2,[vandal]Rob,2073,520,22,16,38,57.9%,20m
44475,2,Nimrod,2073,327,12,9,21,57.1%,1h
44475,2,FifioZyzz,2073,286,10,15,25,40.0%,1h
44475,2,DeNnIsTa,2073,347,10,19,29,34.5%,30m
44475,2,teculescumar,2073,270,9,16,25,36.0%,23m
44475,2,Stown,2073,287,8,9,17,47.1%,29m
44475,3,SDS,2073,266,8,13,21,38.1%,1h
44475,2,Friday,2073,142,7,20,27,25.9%,4m
44475,3,Paladinio,2073,88,3,3,6,50.0%,15m
44475,1,Нивавод,2073,68,3,10,13,23.1%,1h
44475,2,Kris,2073,60,2,5,7,28.6%,1h
44475,3,KingArrows,2073,0,1,0,1,100.0%,1h
44475,3,DUSI,2073,30,1,1,2,50.0%,1h
44475,1,redi,2073,0,1,1,2,50.0%,1h
44475,3,JeeZooS,2073,30,1,1,2,50.0%,1h
44475,3,Cyberaf,2073,30,1,5,6,16.7%,16m
44475,3,jack,2073,40,1,6,7,14.3%,28m
44475,3,Devildog,2073,0,0,2,2,0.0%,28m
44475,2,[deers]DERMAN,2073,0,0,3,3,0.0%,13m
44475,3,Иудушка,2073,0,0,5,5,0.0%,1h
44475,3,Lindsey,2073,0,0,5,5,0.0%,4m
44497,2,Bertinio,2072,1616,229,238,467,49.0%,1h
44497,2,PaoloRock,2072,793,80,77,157,51.0%,4m
44497,2,NAKAMACHIDAI,2072,395,36,45,81,44.4%,1h
44497,2,PETSGOOD,2072,979,35,41,76,46.1%,1h
44497,2,Superbeb,2072,914,34,39,73,46.6%,15m
44497,2,Леон,2072,527,23,20,43,53.5%,1h
44497,3,Witzbold,2072,599,22,21,43,51.2%,1h
44497,2,Parfe,2072,594,22,24,46,47.8%,1h
44497,3,Keon,2072,317,12,6,18,66.7%,24m
44497,2,slashLEE,2072,267,12,12,24,50.0%,1h
44497,2,BattleTurtle,2072,291,9,10,19,47.4%,32m
44497,3,KotEnot,2072,263,9,15,24,37.5%,1h
44497,1,Blacklisted,2072,216,5,13,18,27.8%,1h
44497,3,[Tic2]Alikarrak,2072,90,3,5,8,37.5%,16m
44497,1,Delakar,2072,0,2,8,10,20.0%,1h
44497,2,Esvedra,2072,62,2,9,11,18.2%,5m
44497,2,forfiter,2072,0,1,2,3,33.3%,33m
44497,2,Artamiel,2072,0,1,5,6,16.7%,22m
44497,3,ElCuCo,2072,0,0,1,1,0.0%,4m
44497,3,CptnSmllSize,2072,0,0,2,2,0.0%,1h
44497,2,Raden,2072,0,0,2,2,0.0%,1h
44497,2,humter,2072,0,0,2,2,0.0%,17m
44497,3,KillerLev,2072,0,0,5,5,0.0%,1h
44520,2,Farik,2071,1551,128,127,255,50.2%,28m
44520,2,Paweł,2071,1599,108,115,223,48.4%,1h
44520,2,Phvost,2071,1556,100,96,196,51.0%,25m
44520,2,MASOBIN,2071,1582,96,96,192,50.0%,1h
44520,2,VOTASTAR,2071,1600,92,102,194,47.4%,29m
44520,3,AkélaIV,2071,1600,92,103,195,47.2%,1h
44520,1,Avatarrr,2071,1265,80,83,163,49.1%,16m
44520,2,kfiref,2071,1578,72,76,148,48.6%,1h
44520,2,[SREDA]Trillioner,2071,1152,43,43,86,50.0%,25m
44520,2,Sim,2071,938,41,43,84,48.8%,1h
44520,2,Pull,2071,973,38,39,77,49.4%,1h
44520,2,Haafingar,2071,902,34,37,71,47.9%,1h
44520,2,Xname,2071,413,15,12,27,55.6%,28m
44520,2,[Ronins]Virus,2071,209,12,16,28,42.9%,1h
44520,2,Zsáki,2071,372,12,16,28,42.9%,24m
44520,3,morpalcxir,2071,340,11,17,28,39.3%,6m
44520,2,IKC,2071,210,7,11,18,38.9%,13m
44520,3,JoArmy,2071,118,5,14,19,26.3%,1h
44520,2,Lenkon,2071,92,4,4,8,50.0%,29m
44520,2,Karasich,2071,146,4,6,10,40.0%,1h
44520,1,IMkarlo,2071,159,4,13,17,23.5%,27m
44520,3,Luchouski,2071,60,3,1,4,75.0%,8m
44520,2,aiur,2071,112,3,2,5,60.0%,25m
44520,1,Selva,2071,147,3,6,9,33.3%,23m
44520,2,beginnere,2071,46,1,5,6,16.7%,20m
44520,3,blackpilled,2071,0,0,1,1,0.0%,1h
44520,3,[isIMBА]илья,2071,0,0,2,2,0.0%,22m
44520,3,Тайдж,2071,0,0,5,5,0.0%,30m
44520,2,Zuko,2071,0,0,6,6,0.0%,1h
44520,2,Oziel,2071,0,0,6,6,0.0%,9m
44550,2,LekiR,2070,1331,141,158,299,47.2%,18m
44550,2,DECIMOTERCER,2070,1381,59,50,109,54.1%,33m
44550,2,Dynamiterr,2070,812,52,50,102,51.0%,24m
44550,1,Skalien,2070,756,47,53,100,47.0%,15m
44550,2,МодныйТигр,2070,890,37,29,66,56.1%,21m
44550,2,MarineX,2070,982,37,38,75,49.3%,25m
44550,2,Steenf,2070,723,27,27,54,50.0%,34m
44550,3,Andrey,2070,585,19,27,46,41.3%,23m
44550,1,Jenkhvost,2070,386,13,22,35,37.1%,11m
44550,1,Чича,2070,428,13,23,36,36.1%,3m
44550,3,Jakob,2070,332,12,8,20,60.0%,1h
44550,2,STYPLA,2070,366,12,18,30,40.0%,16m
44550,3,[SeVenV]Tormozko,2070,309,12,29,41,29.3%,1h
44550,2,Centurion,2070,326,11,15,26,42.3%,23m
44550,2,Илья,2070,232,9,9,18,50.0%,1h
44550,2,smurf,2070,221,8,8,16,50.0%,1h
44550,3,dub,2070,168,7,7,14,50.0%,4m
44550,2,[Bulca]SlaiDeR,2070,220,7,15,22,31.8%,34m
44550,2,Proebshik,2070,176,6,9,15,40.0%,20m
44550,1,ProztoChydo,2070,96,3,0,3,100.0%,8m
44550,1,therfouf,2070,166,3,4,7,42.9%,14m
44550,2,OssinatorK,2070,114,2,3,5,40.0%,4m
44550,2,JohnnyBlaze,2070,62,2,7,9,22.2%,29m
44550,3,xDjaGeRnauTx,2070,0,1,0,1,100.0%,3m
44550,3,Wolfgard,2070,0,1,0,1,100.0%,1h
44550,3,[DeaDNB]BLACKSTAR,2070,30,1,1,2,50.0%,1h
44550,3,WulfyTL,2070,30,1,1,2,50.0%,1h
44550,1,Андрей,2070,48,1,2,3,33.3%,3m
44550,2,MeneLutor,2070,0,1,5,6,16.7%,1h
44550,1,Jimbo,2070,0,1,6,7,14.3%,5m
44550,3,linkeniffo,2070,40,1,6,7,14.3%,32m
44550,3,lIon,2070,0,0,1,1,0.0%,3m
44550,3,IiiiiiiiiGAR,2070,0,0,5,5,0.0%,1h
44550,1,Arthasacafé,2070,0,0,6,6,0.0%,1h
44584,1,Anustart,2069,1392,236,249,485,48.7%,1h
44584,2,Tom,2069,817,84,92,176,47.7%,1h
44584,2,wscieklychom,2069,1130,41,47,88,46.6%,1h
44584,2,Nekronus,2069,815,31,38,69,44.9%,28m
44584,2,NNT,2069,470,18,13,31,58.1%,30m
44584,2,BlackEDP,2069,204,18,22,40,45.0%,1h
44584,2,DunderAnus,2069,342,13,27,40,32.5%,1h
44584,3,RICO,2069,334,11,15,26,42.3%,12m
44584,3,Ishak,2069,297,10,9,19,52.6%,1h
44584,2,nibeon,2069,217,9,8,17,52.9%,1h
44584,3,Kitokaro,2069,273,9,12,21,42.9%,25m
44584,2,RDR,2069,144,6,6,12,50.0%,29m
44584,3,FasTFanTom,2069,177,5,9,14,35.7%,27m
44584,2,Sparco,2069,86,3,3,6,50.0%,29m
44584,2,[FTK2]MrShusrtik,2069,114,2,3,5,40.0%,24m
44584,2,[1stGG]MiKa,2069,108,2,6,8,25.0%,1h
44584,2,[IIOII]Filionelius,2069,60,2,8,10,20.0%,27m
44584,3,Skywalker,2069,0,1,0,1,100.0%,1h
44584,3,Zenec,2069,0,1,0,1,100.0%,1h
44584,3,Hunter,2069,0,1,1,2,50.0%,6m
44584,3,FrostEagle,2069,30,1,1,2,50.0%,10m
44584,2,Wanderer,2069,0,1,4,5,20.0%,33m
44584,3,[KYB]PlackarD,2069,48,1,5,6,16.7%,15m
44584,3,[S88]Orangina,2069,30,1,5,6,16.7%,33m
44584,2,[BE4ST]Conrad,2069,30,1,6,7,14.3%,1h
44584,3,[krest]Azthurano,2069,0,0,1,1,0.0%,1h
44584,3,Спасокукоцки,2069,0,0,1,1,0.0%,24m
44584,3,PrawleR,2069,0,0,2,2,0.0%,22m
44584,2,[Rusia]turbobanana,2069,0,0,2,2,0.0%,1h
44584,2,xusataco,2069,0,0,4,4,0.0%,1h
44584,3,Астенкен,2069,0,0,4,4,0.0%,1h
44584,3,Spajiana,2069,0,0,5,5,0.0%,1h
44584,2,Void,2069,0,0,5,5,0.0%,1h
44617,2,krambo,2068,1609,178,179,357,49.9%,1h
44617,1,supersosix,2068,1625,166,170,336,49.4%,23m
44617,2,Yakas,2068,1202,49,52,101,48.5%,1h
44617,2,Plutarch,2068,419,32,33,65,49.2%,1h
44617,2,NRT,2068,366,13,12,25,52.0%,21m
44617,3,Narrai,2068,202,8,0,8,100.0%,3m
44617,2,Talos,2068,181,8,10,18,44.4%,13m
44617,1,[NLTN]nik,2068,240,5,10,15,33.3%,1h
44617,3,AbsolutZerro,2068,141,5,14,19,26.3%,25m
44617,3,Nightfall,2068,60,2,2,4,50.0%,4m
44617,2,ВасяКоробко,2068,48,2,8,10,20.0%,1h
44617,3,taigeur,2068,30,1,1,2,50.0%,1h
44617,3,Oyunterbyecs,2068,0,1,1,2,50.0%,4m
44617,3,Ipack,2068,38,1,6,7,14.3%,1h
44617,2,derluke,2068,96,1,7,8,12.5%,1h
44617,3,[SubZer]Kalvi,2068,0,0,1,1,0.0%,27m
44617,3,HighpE,2068,0,0,1,1,0.0%,15m
44617,3,DruidaLoco,2068,0,0,1,1,0.0%,5m
44617,2,LomKek,2068,0,0,2,2,0.0%,24m
44617,3,Schnuckel,2068,0,0,5,5,0.0%,22m
44617,2,ImamMahtab,2068,0,0,5,5,0.0%,1h
44617,2,chris,2068,0,0,6,6,0.0%,15m
44639,2,Elhyaban,2067,1565,188,194,382,49.2%,1h
44639,1,Ruibbbb,2067,623,89,105,194,45.9%,1h
44639,2,Victoriuss,2067,1454,83,82,165,50.3%,1h
44639,2,BendeR,2067,1296,74,68,142,52.1%,8m
44639,2,Paylis,2067,811,58,53,111,52.3%,25m
44639,1,HoBa,2067,1422,56,66,122,45.9%,1h
44639,3,WİLDWolf,2067,1082,44,38,82,53.7%,1h
44639,2,[pipicl]Treja,2067,917,35,35,70,50.0%,32m
44639,2,ccw,2067,710,27,34,61,44.3%,1h
44639,1,[БУБУБ]fidger,2067,751,24,31,55,43.6%,10m
44639,3,DonFelice,2067,576,21,20,41,51.2%,16m
44639,3,alienware,2067,536,19,18,37,51.4%,1h
44639,2,Remirus,2067,268,10,8,18,55.6%,31m
44639,2,Homyakman,2067,198,7,5,12,58.3%,28m
44639,1,Lobbymain,2067,213,6,11,17,35.3%,3m
44639,2,onDDASSS,2067,182,5,8,13,38.5%,1h
44639,2,NOMADIC,2067,164,4,5,9,44.4%,1h
44639,2,WhiteAppa,2067,193,4,8,12,33.3%,1h
44639,1,[LITF]Radagast,2067,70,4,9,13,30.8%,13m
44639,2,MacGillery,2067,78,3,9,12,25.0%,12m
44639,3,LeshiyKit,2067,0,1,0,1,100.0%,34m
44639,2,TheLIghtning,2067,0,1,1,2,50.0%,1h
44639,2,[1435]UnagiBator,2067,30,1,3,4,25.0%,25m
44639,2,NIPkRÄSCH,2067,0,1,5,6,16.7%,20m
44639,3,Serge,2067,0,0,1,1,0.0%,7m
44639,3,Kinte,2067,0,0,1,1,0.0%,1h
44639,3,DrAsiato,2067,0,0,5,5,0.0%,1h
44639,2,Kürbisfreak,2067,0,0,6,6,0.0%,32m
44667,2,SADUTI,2066,986,47,37,84,56.0%,1h
44667,1,HaiHo,2066,694,34,33,67,50.7%,5m
44667,2,oggo,2066,896,31,35,66,47.0%,1h
44667,1,DobryKot,2066,939,30,40,70,42.9%,1h
44667,3,Roman,2066,556,20,18,38,52.6%,20m
44667,2,NottNott,2066,411,17,22,39,43.6%,1h
44667,2,nuFASKER,2066,396,13,20,33,39.4%,23m
44667,2,Liess,2066,146,8,17,25,32.0%,1h
44667,3,Riyzaki,2066,144,7,7,14,50.0%,22m
44667,3,zitfoo,2066,148,6,5,11,54.5%,10m
44667,2,[J4E]Machtiern,2066,184,6,11,17,35.3%,1h
44667,2,[Hyper1]Rocket,2066,167,5,5,10,50.0%,1h
44667,2,Fallen,2066,88,4,5,9,44.4%,1h
44667,3,bigstalker,2066,30,2,0,2,100.0%,12m
44667,3,[1488ZT]ЖОРЖ,2066,0,2,3,5,40.0%,1h
44667,2,[ILR]TheKING,2066,62,2,8,10,20.0%,1h
44667,1,xena,2066,42,2,9,11,18.2%,32m
44667,2,Макар,2066,0,1,1,2,50.0%,28m
44667,2,DIKAR,2066,0,1,3,4,25.0%,1h
44667,2,samy,2066,30,1,5,6,16.7%,1h
44667,1,Bellato,2066,0,1,7,8,12.5%,6m
44667,2,marco,2066,0,0,2,2,0.0%,28m
44667,3,IGROCK,2066,0,0,2,2,0.0%,1h
44667,2,Jürgen,2066,0,0,4,4,0.0%,20m
44667,3,TAWEP,2066,0,0,4,4,0.0%,13m
44667,3,Witchesrave,2066,0,0,5,5,0.0%,22m
44693,2,Spartano,2065,1604,476,509,985,48.3%,1h
44693,2,[CRLTNS]Marti,2065,1554,106,106,212,50.0%,28m
44693,2,Aytek,2065,1245,92,106,198,46.5%,31m
44693,1,Mozza,2065,573,73,71,144,50.7%,24m
44693,3,Huiputtalo,2065,1390,57,61,118,48.3%,1h
44693,2,motil,2065,1009,41,38,79,51.9%,1h
44693,3,Yuriy,2065,420,18,16,34,52.9%,25m
44693,2,chua,2065,498,18,19,37,48.6%,10m
44693,3,Tarasyo,2065,310,11,19,30,36.7%,14m
44693,2,mantaslash,2065,320,9,12,21,42.9%,1h
44693,3,mip,2065,0,4,1,5,80.0%,34m
44693,3,[ProRax]Maksimys,2065,58,3,0,3,100.0%,1h
44693,3,Freedom,2065,58,3,1,4,75.0%,21m
44693,2,[PS23]REALISM,2065,30,3,9,12,25.0%,1h
44693,1,Narew,2065,144,3,10,13,23.1%,1h
44693,1,Biop,2065,73,2,10,12,16.7%,1h
44693,3,Vorob,2065,0,1,0,1,100.0%,10m
44693,2,IIIIIIIIIIII,2065,0,1,1,2,50.0%,14m
44693,3,ondree,2065,40,1,6,7,14.3%,1h
44693,3,ShterenbergS,2065,0,0,1,1,0.0%,1h
44693,2,feraiur,2065,0,0,1,1,0.0%,4m
44693,3,crz,2065,0,0,1,1,0.0%,31m
44693,3,Lexximus,2065,0,0,3,3,0.0%,1h
44693,3,марадор,2065,0,0,3,3,0.0%,34m
44717,1,dbnm,2064,1612,233,239,472,49.4%,1h
44717,2,Valkata,2064,1567,217,240,457,47.5%,1h
44717,2,ColdBoy,2064,1539,66,53,119,55.5%,1h
44717,2,potol,2064,413,41,38,79,51.9%,1h
44717,2,Pavel,2064,1042,40,46,86,46.5%,1h
44717,1,Frostyfeet,2064,979,39,44,83,47.0%,1h
44717,2,santanas,2064,1207,38,58,96,39.6%,1h
44717,2,[Atik]Destroyer,2064,807,32,41,73,43.8%,24m
44717,1,Bilal,2064,610,18,33,51,35.3%,19m
44717,2,PONKO,2064,489,17,27,44,38.6%,1h
44717,2,krot,2064,367,16,14,30,53.3%,1h
44717,1,Nandor,2064,214,5,12,17,29.4%,32m
44717,3,[lgdjn]Shibumi,2064,111,4,2,6,66.7%,20m
44717,3,Natalichev,2064,0,4,2,6,66.7%,31m
44717,3,Yisas,2064,90,3,4,7,42.9%,22m
44717,1,indartzu,2064,60,3,8,11,27.3%,1h
44717,3,Zhift,2064,30,2,0,2,100.0%,24m
44717,2,Kreatywny,2064,0,1,2,3,33.3%,28m
44717,3,iKnowYourMom,2064,0,0,1,1,0.0%,1h
44717,3,Sirus,2064,0,0,2,2,0.0%,12m
44717,1,[TheDOH]miko,2064,0,0,3,3,0.0%,9m
44717,2,[2DNeko]Artorias,2064,0,0,3,3,0.0%,28m
44717,3,[LLFs]Natsury,2064,0,0,5,5,0.0%,1h
44717,2,Alon,2064,0,0,6,6,0.0%,16m
44741,2,Tars,2063,1093,239,254,493,48.5%,15m
44741,2,SanczOSan,2063,1553,121,131,252,48.0%,6m
44741,3,MaliMarko,2063,1542,65,71,136,47.8%,1h
44741,1,Nastir,2063,564,57,65,122,46.7%,1h
44741,2,stadivarus,2063,1230,51,50,101,50.5%,1h
44741,2,golian,2063,934,42,39,81,51.9%,1h
44741,2,Benny,2063,598,22,26,48,45.8%,6m
44741,2,VooDooN,2063,495,18,21,39,46.2%,10m
44741,2,Banan,2063,350,17,25,42,40.5%,30m
44741,3,ToBeSTC,2063,257,10,18,28,35.7%,1h
44741,3,RightSector,2063,256,9,7,16,56.2%,1h
44741,3,sinaps,2063,235,8,6,14,57.1%,21m
44741,3,Killermen,2063,221,7,2,9,77.8%,1h
44741,3,Wolfer,2063,116,4,3,7,57.1%,1h
44741,1,Ted,2063,156,4,6,10,40.0%,20m
44741,2,SasaTANG,2063,88,3,6,9,33.3%,12m
44741,2,ironcris,2063,183,3,9,12,25.0%,5m
44741,2,angryFlo,2063,72,2,8,10,20.0%,29m
44741,3,Root,2063,0,1,0,1,100.0%,31m
44741,2,Heero,2063,30,1,6,7,14.3%,15m
44741,3,[0ldMen]RaKeToS,2063,0,0,1,1,0.0%,11m
44741,2,Trainee,2063,0,0,1,1,0.0%,1h
44741,3,kbot,2063,0,0,1,1,0.0%,10m
44741,3,sootruebyul,2063,0,0,1,1,0.0%,1h
44741,2,GraZy,2063,0,0,2,2,0.0%,14m
44741,3,vzarmo,2063,0,0,5,5,0.0%,1h
44741,3,Victorious,2063,0,0,5,5,0.0%,32m
44768,2,Sudano,2062,1481,118,127,245,48.2%,21m
44768,1,ZergEatYou,2062,1535,95,108,203,46.8%,1h
44768,1,СуперЗалупа,2062,1148,66,73,139,47.5%,1h
44768,1,MiNiTeRrAnMi,2062,1418,53,66,119,44.5%,6m
44768,2,Pegasus,2062,787,41,48,89,46.1%,27m
44768,1,Svara,2062,751,31,35,66,47.0%,1h
44768,3,HunterMobs,2062,260,11,11,22,50.0%,1h
44768,3,WiceWyr,2062,287,9,7,16,56.2%,25m
44768,2,kgray,2062,270,8,18,26,30.8%,1h
44768,3,Gottlob,2062,178,7,6,13,53.8%,1h
44768,3,перс,2062,208,7,7,14,50.0%,13m
44768,2,RoachRush,2062,158,6,3,9,66.7%,29m
44768,2,xShtyxnexii,2062,138,6,5,11,54.5%,32m
44768,3,JJSquare,2062,178,6,8,14,42.9%,10m
44768,2,Kyaze,2062,98,5,8,13,38.5%,1h
44768,2,COBRA,2062,151,5,14,19,26.3%,30m
44768,1,TakSiakStef,2062,165,4,4,8,50.0%,16m
44768,1,Simonkey,2062,193,4,11,15,26.7%,17m
44768,3,[IceCub]davidoskaa,2062,58,3,2,5,60.0%,1h
44768,2,Alex,2062,30,2,3,5,40.0%,34m
44768,3,Vadim,2062,0,2,3,5,40.0%,1h
44768,1,[Tuur]кофе,2062,78,2,8,10,20.0%,7m
44768,1,[CoB]stelios,2062,97,2,9,11,18.2%,1h
44768,3,[SeVenV]kreker,2062,0,1,0,1,100.0%,24m
44768,3,afaosien,2062,30,1,3,4,25.0%,27m
44768,2,[ExTr1m]BOCHETUNMAY,2062,0,0,1,1,0.0%,1h
44768,3,OFsaID,2062,0,0,1,1,0.0%,1h
44768,3,Pozitiv,2062,0,0,2,2,0.0%,1h
44768,3,Cyclone,2062,0,0,2,2,0.0%,1h
44768,3,Nevervideo,2062,0,0,3,3,0.0%,1h
44768,3,Fantom,2062,0,0,5,5,0.0%,6m
44768,3,Tolozan,2062,0,0,5,5,0.0%,22m
44800,3,itsaruck,2061,1448,81,91,172,47.1%,1h
44800,1,Baricade,2061,1463,64,70,134,47.8%,1h
44800,1,malxac,2061,1152,55,63,118,46.6%,27m
44800,1,ййй,2061,1204,41,49,90,45.6%,1h
44800,2,LuckY,2061,505,28,31,59,47.5%,20m
44800,3,Psychol,2061,656,27,21,48,56.2%,26m
44800,2,gothic,2061,311,13,12,25,52.0%,1h
44800,1,Polestor,2061,324,12,11,23,52.2%,18m
44800,1,Technoleeon,2061,283,11,11,22,50.0%,15m
44800,3,Dirici,2061,222,10,7,17,58.8%,1h
44800,3,Veisou,2061,195,7,15,22,31.8%,1h
44800,3,Kragsk,2061,194,6,10,16,37.5%,1h
44800,1,Arthoth,2061,135,5,10,15,33.3%,9m
44800,3,Leksan,2061,70,4,2,6,66.7%,20m
44800,2,eljajuar,2061,130,4,13,17,23.5%,31m
44800,2,yobagg,2061,90,3,7,10,30.0%,32m
44800,1,JoeCube,2061,48,3,9,12,25.0%,1h
44800,3,Trociu,2061,0,1,0,1,100.0%,24m
44800,3,Triduza,2061,0,1,4,5,20.0%,1h
44800,2,IADOLARUUUUU,2061,30,1,5,6,16.7%,12m
44800,2,MorDuc,2061,0,0,1,1,0.0%,1h
44800,3,Sezari,2061,0,0,4,4,0.0%,1h
44800,3,Atrox,2061,0,0,5,5,0.0%,1h
44800,2,korvin,2061,0,0,6,6,0.0%,1h
44800,2,Itineris,2061,0,0,6,6,0.0%,15m
44825,1,RichieStar,2060,1183,104,108,212,49.1%,1h
44825,2,[SPAINs]DJL,2060,1224,95,94,189,50.3%,1h
44825,2,DOBERARA,2060,830,79,72,151,52.3%,1h
44825,1,Nykhös,2060,1300,79,84,163,48.5%,1h
44825,2,MarcoZO,2060,1484,70,62,132,53.0%,13m
44825,2,Lorry,2060,425,31,26,57,54.4%,1h
44825,2,Бибурат,2060,298,16,14,30,53.3%,20m
44825,3,FeRMeR,2060,327,13,7,20,65.0%,1h
44825,2,[CBTW]HDTV,2060,399,12,24,36,33.3%,1h
44825,1,GoldOmasz,2060,360,11,17,28,39.3%,31m
44825,3,РУССКИЙ,2060,228,8,6,14,57.1%,28m
44825,2,[LMS974]Ollon,2060,222,7,7,14,50.0%,11m
44825,2,lopesu,2060,182,7,10,17,41.2%,18m
44825,2,davegamer,2060,195,6,7,13,46.2%,1h
44825,1,[RLing]MaeLSTroM,2060,216,5,14,19,26.3%,31m
44825,1,SchumanBernd,2060,36,2,9,11,18.2%,1h
44825,3,[SLGH]sova,2060,0,1,0,1,100.0%,1h
44825,2,Dehomag,2060,0,1,2,3,33.3%,34m
44825,1,Johan,2060,0,1,2,3,33.3%,1h
44825,3,[Amir]sergio,2060,46,1,6,7,14.3%,31m
44825,2,Bot,2060,95,1,7,8,12.5%,12m
44825,2,camichon,2060,48,1,8,9,11.1%,16m
44825,3,llllllllllll,2060,0,0,1,1,0.0%,10m
44825,3,zergys,2060,0,0,1,1,0.0%,16m
44825,3,NEO,2060,0,0,2,2,0.0%,5m
44825,3,RedVeider,2060,0,0,5,5,0.0%,1h
44851,1,Jolma,2059,1475,232,251,483,48.0%,20m
44851,2,Ionuutt,2059,1452,215,241,456,47.1%,32m
44851,3,Rubix,2059,1133,50,53,103,48.5%,1h
44851,3,Samuel,2059,803,44,48,92,47.8%,34m
44851,2,[BOMBO]Madmaxxx,2059,824,28,34,62,45.2%,1h
44851,2,RAIMISlll,2059,546,19,23,42,45.2%,1h
44851,3,STORM,2059,346,12,12,24,50.0%,27m
44851,3,Caravan,2059,349,11,19,30,36.7%,20m
44851,2,Nemo,2059,288,10,9,19,52.6%,25m
44851,2,LittlePanik,2059,176,10,9,19,52.6%,11m
44851,2,Idaho,2059,235,8,8,16,50.0%,32m
44851,2,sOstOked,2059,240,8,10,18,44.4%,1h
44851,2,whitebetter,2059,250,8,17,25,32.0%,20m
44851,2,Claude,2059,166,6,8,14,42.9%,23m
44851,1,[bisdak]AiAiCaptain,2059,219,5,11,16,31.2%,10m
44851,2,[KON]HammerFall,2059,88,4,5,9,44.4%,16m
44851,2,[SR5]Wolfwood,2059,118,4,7,11,36.4%,1h
44851,3,PAUL,2059,100,3,12,15,20.0%,28m
44851,2,Bricou,2059,116,2,4,6,33.3%,31m
44851,2,Stels,2059,97,2,7,9,22.2%,1h
44851,3,[NaNii]TOF,2059,30,1,1,2,50.0%,21m
44851,3,Zolotoy,2059,0,1,1,2,50.0%,15m
44851,2,zefire,2059,46,1,2,3,33.3%,26m
44851,3,Zeus,2059,30,1,2,3,33.3%,1h
44851,3,Henrikzon,2059,30,1,6,7,14.3%,1h
44851,2,Flow,2059,88,1,6,7,14.3%,1h
44851,2,Zippy,2059,0,0,1,1,0.0%,20m
44851,3,siopsys,2059,0,0,1,1,0.0%,1h
44851,3,ZaAiur,2059,0,0,1,1,0.0%,1h
44851,3,Jum,2059,0,0,5,5,0.0%,30m
44881,1,Tavito,2058,1568,144,161,305,47.2%,1h
44881,2,[Fansaf]eldar,2058,1217,123,127,250,49.2%,14m
44881,1,ced,2058,1574,107,112,219,48.9%,1h
44881,3,PavelX,2058,1515,75,70,145,51.7%,1h
44881,2,darkwhisper,2058,557,23,32,55,41.8%,30m
44881,3,SpartakVS,2058,582,21,18,39,53.8%,3m
44881,1,XNK,2058,376,12,21,33,36.4%,1h
44881,2,Yuuto,2058,174,7,8,15,46.7%,27m
44881,1,Ryuuzaki,2058,144,6,9,15,40.0%,1h
44881,3,Bogdan,2058,116,5,2,7,71.4%,1h
44881,2,DreamLink,2058,150,5,8,13,38.5%,24m
44881,2,NVM,2058,144,4,5,9,44.4%,28m
44881,2,MadMan,2058,130,3,4,7,42.9%,23m
44881,3,PeTRoviCh,2058,147,3,6,9,33.3%,1h
44881,2,max,2058,30,2,3,5,40.0%,16m
44881,2,YLITKA,2058,112,2,3,5,40.0%,27m
44881,2,justJ,2058,108,2,7,9,22.2%,1h
44881,1,[ReVoL]навигатор,2058,97,2,8,10,20.0%,10m
44881,2,[XPLcX]Carlo,2058,88,1,2,3,33.3%,1h
44881,1,[ExMen]Gambit,2058,0,0,2,2,0.0%,1h
44881,1,maciuoo,2058,0,0,3,3,0.0%,5m
44881,3,Nar,2058,0,0,3,3,0.0%,1h
44881,2,Weelzevul,2058,0,0,4,4,0.0%,20m
44881,3,Alkrava,2058,0,0,5,5,0.0%,1h
44881,3,FSF,2058,0,0,5,5,0.0%,7m
44881,3,Zedd,2058,0,0,5,5,0.0%,25m
44907,2,angrymonk,2057,1490,151,155,306,49.3%,8m
44907,1,DKlAcidViper,2057,1140,54,64,118,45.8%,1h
44907,2,EssenceStrng,2057,931,35,41,76,46.1%,20m
44907,2,Hollow,2057,788,33,30,63,52.4%,13m
44907,3,Spillouz,2057,815,33,30,63,52.4%,1h
44907,2,Archi,2057,512,31,30,61,50.8%,29m
44907,3,Khazeo,2057,528,21,17,38,55.3%,1h
44907,2,Goliathak,2057,410,19,15,34,55.9%,11m
44907,3,XcreenS,2057,405,13,20,33,39.4%,1h
44907,1,qpADLERqp,2057,213,9,9,18,50.0%,3m
44907,3,[Arrows]Qwerty,2057,168,7,3,10,70.0%,3m
44907,2,[AMBHXI]Vlad,2057,184,6,9,15,40.0%,1h
44907,3,kot,2057,128,6,14,20,30.0%,1h
44907,2,Yoshi,2057,92,3,6,9,33.3%,17m
44907,2,agurdek,2057,24,2,5,7,28.6%,1h
44907,1,Gotchaa,2057,30,2,8,10,20.0%,1h
44907,1,Dinli,2057,48,2,8,10,20.0%,9m
44907,1,[oooboy]BattlePatrik,2057,48,1,3,4,25.0%,34m
44907,2,Rubinschtein,2057,46,1,4,5,20.0%,1h
44907,2,nymeria,2057,0,1,7,8,12.5%,1h
44907,2,solist,2057,30,1,7,8,12.5%,20m
44907,3,Moloko,2057,0,0,1,1,0.0%,11m
44929,2,Szach,2056,1426,61,62,123,49.6%,16m
44929,2,nikoune,2056,477,33,36,69,47.8%,1h
44929,2,NeXuS,2056,786,30,37,67,44.8%,1h
44929,2,Did,2056,761,25,30,55,45.5%,1h
44929,2,ERMAK,2056,558,20,27,47,42.6%,1h
44929,2,Kitsunedie,2056,440,19,24,43,44.2%,1h
44929,2,Чломбир,2056,531,17,23,40,42.5%,20m
44929,2,[0110]Kanima,2056,418,16,16,32,50.0%,1h
44929,2,[NOOBpl]Simus,2056,444,16,16,32,50.0%,1h
44929,2,Cloud,2056,95,12,12,24,50.0%,20m
44929,1,NiteEnd,2056,331,11,29,40,27.5%,1h
44929,3,MaxBanjo,2056,222,9,5,14,64.3%,31m
44929,3,SyNcZ,2056,270,9,6,15,60.0%,11m
44929,3,Jérémie,2056,252,9,16,25,36.0%,10m
44929,2,[1BR1]MORFrus,2056,195,7,5,12,58.3%,20m
44929,1,eAZyANDsLow,2056,242,7,13,20,35.0%,1h
44929,2,Zorg,2056,133,6,17,23,26.1%,1h
44929,2,leboss,2056,172,4,11,15,26.7%,1h
44929,2,Alivin,2056,62,3,7,10,30.0%,1h
44929,2,rtrer,2056,156,3,9,12,25.0%,1h
44929,3,mxl,2056,0,2,3,5,40.0%,1h
44929,2,DaTcH,2056,0,1,3,4,25.0%,1h
44929,3,ariansan,2056,0,1,4,5,20.0%,1h
44929,1,silent,2056,0,0,1,1,0.0%,10m
44929,2,Emmanuel,2056,0,0,4,4,0.0%,1h
44929,2,DACEDY,2056,0,0,6,6,0.0%,1h
44929,2,nightukraine,2056,0,0,6,6,0.0%,14m
44956,2,Fyshyman,2055,1561,96,105,201,47.8%,21m
44956,2,AxCraft,2055,753,55,57,112,49.1%,1h
44956,2,nicchenicche,2055,1076,40,45,85,47.1%,1h
44956,3,Psolokopanos,2055,546,36,18,54,66.7%,1h
44956,1,yumuru,2055,884,31,41,72,43.1%,1h
44956,2,IamLegend,2055,613,25,36,61,41.0%,1h
44956,3,Schwarz,2055,576,22,21,43,51.2%,1h
44956,2,[WH2D]Eschus,2055,466,18,25,43,41.9%,30m
44956,2,ABI,2055,342,13,17,30,43.3%,30m
44956,2,ElyGreen,2055,263,8,17,25,32.0%,1h
44956,1,Ламанчский,2055,274,7,15,22,31.8%,26m
44956,2,Isildur,2055,86,3,7,10,30.0%,32m
44956,3,syxoi,2055,30,2,0,2,100.0%,5m
44956,3,DemiGORgon,2055,0,2,3,5,40.0%,15m
44956,2,AreYouReal,2055,91,2,9,11,18.2%,1h
44956,3,Fada,2055,0,1,0,1,100.0%,10m
44956,3,kecaj,2055,0,1,1,2,50.0%,1h
44956,3,MAXIMYS,2055,92,1,7,8,12.5%,1h
44956,3,SzPilaPL,2055,0,0,1,1,0.0%,24m
44956,2,MiniTitan,2055,0,0,2,2,0.0%,1h
44956,3,TuLuHu,2055,0,0,5,5,0.0%,1h
44977,2,juju,2054,1515,170,176,346,49.1%,15m
44977,1,ITALYnec,2054,1595,119,124,243,49.0%,29m
44977,2,scar,2054,1475,98,100,198,49.5%,1h
44977,3,GROM,2054,1607,91,94,185,49.2%,1h
44977,2,Sergio,2054,1571,80,82,162,49.4%,1h
44977,2,vajniy,2054,1282,78,81,159,49.1%,1h
44977,2,sensil,2054,1406,60,61,121,49.6%,1h
44977,2,[LMBD]UseLite,2054,850,41,38,79,51.9%,30m
44977,2,VVZ,2054,673,36,31,67,53.7%,1h
44977,3,Kos,2054,774,28,27,55,50.9%,28m
44977,2,Fleasis,2054,542,19,30,49,38.8%,28m
44977,3,Genos,2054,394,17,15,32,53.1%,1h
44977,2,ARGOS,2054,184,13,13,26,50.0%,13m
44977,1,HighWisnia,2054,120,6,9,15,40.0%,1h
44977,2,[G6AS]Tyrok,2054,154,6,13,19,31.6%,1h
44977,3,KOBUBAKO,2054,86,4,0,4,100.0%,16m
44977,3,pinik,2054,121,3,6,9,33.3%,1h
44977,2,pheoniks,2054,104,2,2,4,50.0%,1h
44977,3,ShiFu,2054,0,2,3,5,40.0%,1h
44977,1,SilentOne,2054,0,2,6,8,25.0%,1h
44977,3,Limker,2054,0,1,1,2,50.0%,21m
44977,2,FrostyCZ,2054,0,1,2,3,33.3%,1h
44977,3,Krzysiek,2054,0,1,3,4,25.0%,1h
44977,3,WildOstin,2054,0,1,4,5,20.0%,1h
44977,3,max,2054,0,0,1,1,0.0%,11m
44977,1,Pancras,2054,0,0,1,1,0.0%,1h
44977,3,[лампа]DFR,2054,0,0,1,1,0.0%,1h
44977,3,démoniack,2054,0,0,2,2,0.0%,1h
44977,3,[FCGP]MRterminator,2054,0,0,2,2,0.0%,22m
44977,3,Yojimbo,2054,0,0,5,5,0.0%,31m
44977,3,MadNoob,2054,0,0,5,5,0.0%,16m
44977,2,Zart,2054,0,0,6,6,0.0%,1h
44977,3,tohin,2054,0,0,6,6,0.0%,1h
45010,2,XaleX,2053,1547,110,114,224,49.1%,1h
45010,3,wutwutwutwut,2053,1583,90,93,183,49.2%,1h
45010,2,gawliniak,2053,1588,67,76,143,46.9%,30m
45010,3,[kill0]MrMarmalade,2053,974,48,48,96,50.0%,16m
45010,3,Lewis,2053,669,46,29,75,61.3%,25m
45010,3,Costi,2053,737,42,40,82,51.2%,27m
45010,2,Krasapet,2053,792,28,33,61,45.9%,19m
45010,2,aunshi,2053,742,28,35,63,44.4%,10m
45010,3,Roisen,2053,457,25,22,47,53.2%,1h
45010,3,DHauskaxxx,2053,730,23,45,68,33.8%,1h
45010,1,[SPAINs]Madox,2053,606,20,32,52,38.5%,1h
45010,2,DragonHollow,2053,411,15,21,36,41.7%,1h
45010,2,[пепегa]пепега,2053,302,11,17,28,39.3%,1h
45010,2,БУЛОЧКА,2053,302,10,8,18,55.6%,1h
45010,2,Padrik,2053,250,10,15,25,40.0%,1h
45010,2,Arkadio,2053,196,8,12,20,40.0%,16m
45010,3,Kremita,2053,140,6,1,7,85.7%,1h
45010,2,weshwesh,2053,179,6,6,12,50.0%,15m
45010,1,ZibelBobel,2053,198,6,7,13,46.2%,1h
45010,2,Dinabit,2053,220,6,11,17,35.3%,5m
45010,3,NikGreat,2053,118,5,5,10,50.0%,1h
45010,1,[VOLKI]romatolmach,2053,195,5,6,11,45.5%,1h
45010,2,Хочуха,2053,170,4,6,10,40.0%,24m
45010,3,bitethemango,2053,86,3,2,5,60.0%,25m
45010,2,twnielsen,2053,90,3,6,9,33.3%,25m
45010,2,Laou,2053,92,1,6,7,14.3%,1h
45010,2,toxicdonkey,2053,97,1,7,8,12.5%,1h
45010,3,MrHyde,2053,0,0,1,1,0.0%,1h
45010,3,serg,2053,0,0,1,1,0.0%,12m
45010,3,VlaDFoX,2053,0,0,1,1,0.0%,1h
45010,3,[TSC2C]ZAGAR,2053,0,0,2,2,0.0%,1h
45010,3,СмертоМышь,2053,0,0,5,5,0.0%,1h
45010,1,Xagula,2053,0,0,6,6,0.0%,3m
45043,2,Toshlic,2052,1606,131,140,271,48.3%,23m
45043,3,Ludo,2052,1093,90,86,176,51.1%,9m
45043,2,Харасмэнт,2052,1124,44,44,88,50.0%,1h
45043,2,Pernika,2052,737,29,32,61,47.5%,1h
45043,2,lxxBENDERxxl,2052,258,12,25,37,32.4%,1h
45043,3,WhiteMatter,2052,164,7,9,16,43.8%,31m
45043,2,Zeratul,2052,176,6,10,16,37.5%,1h
45043,2,Sssilez,2052,120,5,6,11,45.5%,19m
45043,2,User,2052,96,3,4,7,42.9%,12m
45043,1,Faker,2052,97,3,10,13,23.1%,32m
45043,3,Mazoute,2052,66,2,3,5,40.0%,1h
45043,3,sedogriv,2052,0,1,0,1,100.0%,1h
45043,1,tom,2052,0,1,4,5,20.0%,16m
45043,2,HankTheTank,2052,0,1,5,6,16.7%,1h
45043,1,[HYG]Uxux,2052,0,1,8,9,11.1%,12m
45043,3,DesertRose,2052,0,0,5,5,0.0%,1h
45043,2,TRON,2052,0,0,6,6,0.0%,1h
45060,3,PUNISCHERSEE,2051,1582,87,98,185,47.0%,22m
45060,2,Honzik,2051,1473,63,71,134,47.0%,1h
45060,1,[TZF]Griffin,2051,1285,60,79,139,43.2%,1h
45060,2,Vitaly,2051,1361,49,56,105,46.7%,24m
45060,1,AndreiAra,2051,1213,43,55,98,43.9%,1h
45060,2,[ICE5]OLONGJOHNSON,2051,1022,38,45,83,45.8%,30m
45060,2,HeroWalk,2051,846,30,35,65,46.2%,1h
45060,3,Arjan,2051,469,19,20,39,48.7%,1h
45060,1,fergusf,2051,558,17,29,46,37.0%,1h
45060,2,PhoenixLord,2051,398,15,15,30,50.0%,1h
45060,2,slon,2051,366,12,23,35,34.3%,23m
45060,2,shura,2051,264,10,18,28,35.7%,1h
45060,1,Yurok,2051,281,9,10,19,47.4%,1h
45060,2,pringle,2051,275,9,16,25,36.0%,1h
45060,3,WILFI,2051,173,7,14,21,33.3%,9m
45060,2,[z666z]Nevis,2051,140,5,9,14,35.7%,5m
45060,3,Darinan,2051,58,3,1,4,75.0%,12m
45060,3,pandorgo,2051,30,2,1,3,66.7%,1h
45060,1,argewolen,2051,42,2,8,10,20.0%,1h
45060,3,vandeshin,2051,96,2,11,13,15.4%,1h
45060,1,[Kboin]Letty,2051,0,1,3,4,25.0%,16m
45060,2,Minoterror,2051,44,1,8,9,11.1%,1h
45060,3,Raynor,2051,0,0,1,1,0.0%,11m
45060,3,Arnas,2051,0,0,1,1,0.0%,31m
45060,2,Seidly,2051,0,0,2,2,0.0%,1h
45060,2,Pāvests,2051,0,0,4,4,0.0%,1h
45060,3,OkanMiller,2051,0,0,5,5,0.0%,23m
45087,2,NEMESIS,2050,1593,97,105,202,48.0%,1h
45087,1,ton,2050,1593,92,87,179,51.4%,1h
45087,3,PadreVini,2050,1511,82,85,167,49.1%,16m
45087,2,PsYkLpWn,2050,917,49,45,94,52.1%,1h
45087,3,WOLFSBLUT,2050,440,16,14,30,53.3%,3m
45087,2,fleshCQ,2050,158,10,8,18,55.6%,1h
45087,2,[PTTian]GOOSE,2050,318,10,12,22,45.5%,16m
45087,2,FutakuchiOG,2050,300,10,13,23,43.5%,33m
45087,3,Ubiquitous,2050,276,10,16,26,38.5%,1h
45087,1,[AresG]king,2050,211,8,1,9,88.9%,31m
45087,2,Bence,2050,155,5,7,12,41.7%,1h
45087,1,Mokie,2050,0,3,4,7,42.9%,1h
45087,2,MAI,2050,123,3,10,13,23.1%,28m
45087,1,dgeril,2050,96,2,2,4,50.0%,1h
45087,1,mukivonmoria,2050,48,2,6,8,25.0%,6m
45087,3,Toastedhead,2050,0,1,0,1,100.0%,1h
45087,3,Lipitung,2050,30,1,1,2,50.0%,23m
45087,1,[SISF]Basi,2050,0,1,8,9,11.1%,17m
45087,3,Robert,2050,0,0,1,1,0.0%,1h
45087,3,Seryivtanke,2050,0,0,1,1,0.0%,1h
45087,3,DJoker,2050,0,0,1,1,0.0%,1h
45087,3,Maurits,2050,0,0,5,5,0.0%,7m
45109,3,Oleg,2049,1626,208,212,420,49.5%,14m
45109,3,GpoachedG,2049,1520,184,193,377,48.8%,1h
45109,3,trits,2049,1602,115,130,245,46.9%,1h
45109,2,UkSrAaIsNty,2049,1283,59,69,128,46.1%,1h
45109,2,superfanf,2049,1258,50,50,100,50.0%,1h
45109,2,piton,2049,558,37,44,81,45.7%,1h
45109,2,kwe,2049,1006,36,39,75,48.0%,1h
45109,3,kart,2049,722,26,32,58,44.8%,1h
45109,1,[CaLe]Snowkills,2049,604,21,31,52,40.4%,1h
45109,2,DenS,2049,544,18,26,44,40.9%,30m
45109,3,BACHHHFORCE,2049,410,15,7,22,68.2%,9m
45109,1,chester,2049,256,7,12,19,36.8%,1h
45109,1,barsik,2049,224,6,7,13,46.2%,16m
45109,1,subMARINE,2049,228,6,15,21,28.6%,1h
45109,2,PandaDrill,2049,173,5,6,11,45.5%,1h
45109,1,SmackBollins,2049,78,3,11,14,21.4%,1h
45109,3,vivelepoulet,2049,58,2,1,3,66.7%,1h
45109,2,Mechoshi,2049,30,2,4,6,33.3%,30m
45109,2,Dzumi,2049,127,2,8,10,20.0%,24m
45109,2,gabab,2049,0,1,1,2,50.0%,1h
45109,1,EvilEvan,2049,0,1,7,8,12.5%,10m
45109,1,Canalet,2049,0,1,8,9,11.1%,6m
45131,2,Fury,2048,1430,102,96,198,51.5%,27m
45131,2,ELMAGO,2048,1191,50,60,110,45.5%,1h
45131,2,Atronfiss,2048,764,46,51,97,47.4%,10m
45131,2,FaerVover,2048,871,34,38,72,47.2%,1h
45131,2,Jey,2048,533,22,32,54,40.7%,27m
45131,2,ivan,2048,499,18,22,40,45.0%,1h
45131,2,Stas,2048,422,16,15,31,51.6%,21m
45131,1,endofin,2048,367,8,15,23,34.8%,1h
45131,3,Golem,2048,172,7,4,11,63.6%,9m
45131,2,[OFSA]Owerumer,2048,214,6,12,18,33.3%,16m
45131,1,Geraldx,2048,188,6,14,20,30.0%,1h
45131,3,ALGAZAR,2048,92,4,4,8,50.0%,1h
45131,3,Andy,2048,30,2,1,3,66.7%,15m
45131,2,Sanjarinho,2048,76,2,7,9,22.2%,14m
45131,2,cocico,2048,46,2,8,10,20.0%,1h
45131,3,[EUTeam]DraK,2048,0,1,0,1,100.0%,27m
45131,2,cowellme,2048,0,0,3,3,0.0%,6m
45148,2,Wolfie,2047,1525,72,73,145,49.7%,20m
45148,2,BroKir,2047,1407,65,66,131,49.6%,25m
45148,3,seax,2047,961,46,37,83,55.4%,1h
45148,3,Sargeras,2047,885,42,44,86,48.8%,3m
45148,3,Archon,2047,514,26,8,34,76.5%,1h
45148,2,grutgrut,2047,664,23,31,54,42.6%,24m
45148,2,Улитыч,2047,592,22,23,45,48.9%,1h
45148,2,Кот,2047,580,21,22,43,48.8%,1h
45148,2,KAin,2047,415,17,20,37,45.9%,20m
45148,2,Beast,2047,284,12,13,25,48.0%,19m
45148,2,volderm,2047,182,7,9,16,43.8%,14m
45148,3,boldika,2047,98,6,7,13,46.2%,31m
45148,2,LOLтакНельзя,2047,60,5,7,12,41.7%,10m
45148,3,Sedokiro,2047,58,2,1,3,66.7%,34m
45148,3,darkplayer,2047,0,1,0,1,100.0%,16m
45148,3,Azlan,2047,0,1,2,3,33.3%,34m
45148,3,FreemaN,2047,30,1,2,3,33.3%,16m
45148,3,Toothless,2047,0,1,4,5,20.0%,16m
45148,3,MaybNextTime,2047,0,0,2,2,0.0%,16m
45148,2,bqbq,2047,0,0,3,3,0.0%,20m
45148,2,Syte,2047,0,0,3,3,0.0%,1h
45148,3,Tobi,2047,0,0,5,5,0.0%,1h
45148,3,Kuroyukihime,2047,0,0,5,5,0.0%,31m
45171,2,Okocim,2046,1405,253,261,514,49.2%,14m
45171,2,Kishar,2046,823,96,99,195,49.2%,1h
45171,2,Kiux,2046,649,29,25,54,53.7%,1h
45171,2,FAZORDASH,2046,701,27,27,54,50.0%,20m
45171,2,[Tuur]Fair,2046,760,27,33,60,45.0%,1h
45171,2,[RBP3]Nevvergrim,2046,353,25,28,53,47.2%,1h
45171,2,Gönndalf,2046,379,19,13,32,59.4%,34m
45171,3,Rubén,2046,424,17,16,33,51.5%,27m
45171,1,кокс,2046,193,10,14,24,41.7%,1h
45171,2,VVS,2046,327,10,22,32,31.2%,24m
45171,2,Roni,2046,116,4,6,10,40.0%,1h
45171,3,kempacy,2046,58,3,2,5,60.0%,1h
45171,3,XMGM,2046,58,2,2,4,50.0%,1h
45171,2,[iR3B]SPAGHETTI,2046,0,1,0,1,100.0%,1h
45171,3,cinay,2046,30,1,1,2,50.0%,1h
45171,2,Jguchka,2046,95,1,8,9,11.1%,29m
45171,3,Mysskas,2046,0,0,1,1,0.0%,1h
45171,3,ADEPT,2046,0,0,1,1,0.0%,12m
45171,2,gos,2046,0,0,6,6,0.0%,30m
45171,2,DUMMSDEI,2046,0,0,6,6,0.0%,20m
45171,3,Lancaster,2046,0,0,6,6,0.0%,28m
45171,2,Simei,2046,0,0,6,6,0.0%,20m
45193,1,khunshiwa,2045,1195,88,89,177,49.7%,1h
45193,3,CORPA,2045,914,33,34,67,49.3%,22m
45193,2,[ANREN]GGZerg,2045,757,31,33,64,48.4%,18m
45193,2,Dimok,2045,802,31,35,66,47.0%,1h
45193,1,ylboo,2045,608,18,27,45,40.0%,16m
45193,3,Mikdelive,2045,450,17,11,28,60.7%,25m
45193,2,pirate,2045,302,12,16,28,42.9%,21m
45193,3,heisenberg,2045,202,8,7,15,53.3%,34m
45193,2,chrmander,2045,289,8,13,21,38.1%,1h
45193,2,elcoronel,2045,212,7,8,15,46.7%,1h
45193,2,PartyHard,2045,193,6,10,16,37.5%,34m
45193,2,Natsu,2045,178,6,11,17,35.3%,14m
45193,2,Aivengo,2045,133,5,4,9,55.6%,1h
45193,1,Direwolf,2045,179,5,14,19,26.3%,33m
45193,3,Dvorf,2045,86,3,2,5,60.0%,12m
45193,3,Star,2045,115,3,12,15,20.0%,1h
45193,1,AdvreX,2045,168,3,13,16,18.8%,15m
45193,3,Firewalks,2045,58,2,3,5,40.0%,1h
45193,2,Jakubator,2045,0,2,4,6,33.3%,1h
45193,3,XXXNicoXXX,2045,97,1,1,2,50.0%,1h
45193,2,xXmhtsosXx,2045,30,1,5,6,16.7%,15m
45193,2,Sebitasproo,2045,48,1,6,7,14.3%,17m
45193,2,гопник,2045,94,1,6,7,14.3%,1h
45193,2,Mariosertic,2045,30,1,7,8,12.5%,1h
45193,2,[BIFT]Sid,2045,30,1,7,8,12.5%,1h
45193,1,antoni,2045,0,1,8,9,11.1%,5m
45193,3,moito,2045,0,0,1,1,0.0%,1h
45193,1,[SWLO]sanoJ,2045,0,0,6,6,0.0%,6m
45193,3,Aposthle,2045,0,0,6,6,0.0%,1h
45193,3,PAnDA,2045,0,0,6,6,0.0%,16m
45193,1,Johnny,2045,0,0,7,7,0.0%,4m
45224,3,Folletto,2044,1479,243,259,502,48.4%,26m
45224,3,KamusheK,2044,1614,159,174,333,47.7%,10m
45224,2,Det,2044,1558,74,79,153,48.4%,1h
45224,3,Adaś,2044,1572,73,79,152,48.0%,14m
45224,3,JumiGumi,2044,1537,60,59,119,50.4%,14m
45224,3,[EUC]cypdonmen,2044,1342,59,65,124,47.6%,20m
45224,1,gorrilakos,2044,1504,56,65,121,46.3%,10m
45224,2,Tetsuo,2044,1115,50,55,105,47.6%,16m
45224,2,XMEN,2044,723,29,24,53,54.7%,1h
45224,3,Vanguard,2044,495,26,28,54,48.1%,1h
45224,2,Василь,2044,352,14,21,35,40.0%,13m
45224,3,SlowNLow,2044,310,11,7,18,61.1%,1h
45224,3,Seyonne,2044,324,11,9,20,55.0%,25m
45224,1,Octopus,2044,335,11,20,31,35.5%,24m
45224,3,[K700]ветеран,2044,266,10,10,20,50.0%,1h
45224,3,[ANREN]Ravzan,2044,232,8,10,18,44.4%,22m
45224,3,MarineHorDe,2044,140,6,1,7,85.7%,15m
45224,3,knivok,2044,126,5,2,7,71.4%,34m
45224,2,Razmenchic,2044,30,4,8,12,33.3%,33m
45224,1,MightyHare,2044,141,3,0,3,100.0%,26m
45224,2,Astrello,2044,46,2,1,3,66.7%,1h
45224,1,[StSta]Budgerigan,2044,97,2,2,4,50.0%,10m
45224,2,Reload,2044,114,2,4,6,33.3%,27m
45224,3,Kazan,2044,0,1,0,1,100.0%,1h
45224,2,[Рrobe]KostiaKot,2044,0,0,4,4,0.0%,6m
45249,1,Turtleterran,2043,818,228,244,472,48.3%,1h
45249,2,Axtvonthor,2043,1222,94,100,194,48.5%,1h
45249,2,Mirage,2043,1173,51,55,106,48.1%,16m
45249,3,Arhanghel,2043,868,30,29,59,50.8%,11m
45249,2,Crusty,2043,232,20,20,40,50.0%,1h
45249,2,ThomasCBS,2043,450,15,21,36,41.7%,13m
45249,2,aeKold,2043,487,15,23,38,39.5%,21m
45249,3,Trooper,2043,147,9,6,15,60.0%,1h
45249,3,storm,2043,218,9,7,16,56.2%,1h
45249,1,Leo,2043,186,8,14,22,36.4%,31m
45249,3,DrNifario,2043,148,6,6,12,50.0%,1h
45249,1,Fantagec,2043,218,6,13,19,31.6%,1h
45249,3,[DL2006]Tonytag,2043,210,5,8,13,38.5%,12m
45249,3,testtest,2043,88,4,3,7,57.1%,1h
45249,2,Slayer,2043,98,3,10,13,23.1%,1h
45249,1,Manann,2043,102,3,11,14,21.4%,1h
45249,2,Haze,2043,48,2,8,10,20.0%,1h
45249,2,[BlaStZ]POlcah,2043,97,2,10,12,16.7%,30m
45249,3,neferfabi,2043,0,1,0,1,100.0%,34m
45249,2,Зоберман,2043,0,1,0,1,100.0%,9m
45249,3,bigos,2043,30,1,2,3,33.3%,1h
45249,3,[N1TDA]Riyaiky,2043,36,1,2,3,33.3%,1h
45249,1,Pedro,2043,0,1,7,8,12.5%,31m
45249,1,[FIAMMA]Balrogreveng,2043,0,1,9,10,10.0%,20m
45249,3,VALIK,2043,0,0,1,1,0.0%,1h
45249,3,PAVT,2043,0,0,2,2,0.0%,12m
45249,3,Hero,2043,0,0,5,5,0.0%,1h
45276,2,Zarhad,2042,1415,142,147,289,49.1%,1h
45276,2,redtigerr,2042,1531,134,144,278,48.2%,33m
45276,2,Zkydive,2042,826,50,54,104,48.1%,34m
45276,2,Jarsonic,2042,883,39,36,75,52.0%,1h
45276,3,powersfax,2042,388,14,24,38,36.8%,11m
45276,2,Gazzaloddi,2042,268,10,16,26,38.5%,18m
45276,2,Atadracula,2042,193,7,7,14,50.0%,19m
45276,2,monsuta,2042,221,7,14,21,33.3%,28m
45276,1,Accelerator,2042,163,5,3,8,62.5%,1h
45276,3,quellflynn,2042,120,5,5,10,50.0%,12m
45276,2,FiveKm,2042,130,4,14,18,22.2%,6m
45276,2,Elzndyl,2042,0,3,4,7,42.9%,17m
45276,2,ArdoMelnikov,2042,0,2,7,9,22.2%,20m
45276,2,Nixxx,2042,0,1,0,1,100.0%,17m
45276,3,[NOSV]Nosferatul,2042,30,1,1,2,50.0%,14m
45276,1,NoFormat,2042,0,1,5,6,16.7%,31m
45276,3,[GhRa]LümmelLörres,2042,0,0,1,1,0.0%,27m
45276,3,DERESPECT,2042,0,0,1,1,0.0%,11m
45276,3,RescueSnake,2042,0,0,2,2,0.0%,1h
45276,3,[NeCriN]ZizouLarson,2042,0,0,2,2,0.0%,34m
45276,3,JohnJo,2042,0,0,2,2,0.0%,6m
45276,3,Amnam,2042,0,0,5,5,0.0%,1h
45276,3,Chrïstian,2042,0,0,5,5,0.0%,1h
45299,2,killingtime,2041,1523,123,130,253,48.6%,1h
45299,2,BOBWILLSAVEU,2041,1545,90,86,176,51.1%,33m
45299,1,Danchoto,2041,1125,51,70,121,42.1%,34m
45299,3,captadrianus,2041,827,41,39,80,51.2%,1h
45299,2,Kelte,2041,941,35,39,74,47.3%,26m
45299,1,Maksimys,2041,518,16,30,46,34.8%,1h
45299,3,Dunthil,2041,204,10,19,29,34.5%,25m
45299,3,TIME,2041,260,9,5,14,64.3%,1h
45299,2,MMM,2041,170,9,8,17,52.9%,32m
45299,2,AnimeN,2041,226,8,7,15,53.3%,10m
45299,3,[SDO]Mengsk,2041,102,7,9,16,43.8%,1h
45299,1,mitarao,2041,185,5,6,11,45.5%,6m
45299,2,waiter,2041,85,4,6,10,40.0%,34m
45299,1,THEKILLER,2041,147,4,7,11,36.4%,1h
45299,2,Veleyo,2041,120,4,9,13,30.8%,32m
45299,3,Zapupa,2041,0,3,2,5,60.0%,1h
45299,1,GardeMarine,2041,58,3,9,12,25.0%,33m
45299,2,KDJB,2041,44,1,1,2,50.0%,1h
45299,3,Bomber,2041,30,1,2,3,33.3%,1h
45299,1,Itmof,2041,96,1,3,4,25.0%,15m
45299,3,JohnnyBravo,2041,30,1,3,4,25.0%,8m
45299,3,[Z666Zx]zorg,2041,0,1,5,6,16.7%,6m
45299,2,Khyron,2041,0,1,6,7,14.3%,1h
45299,1,слава,2041,0,1,7,8,12.5%,5m
45299,3,Andi,2041,0,0,1,1,0.0%,24m
45299,3,protossico,2041,0,0,2,2,0.0%,34m
45299,3,CrazyNeo,2041,0,0,2,2,0.0%,1h
45299,3,tidusgr,2041,0,0,5,5,0.0%,26m
45299,3,Xarcrom,2041,0,0,6,6,0.0%,16m
45328,2,costhorror,2040,1500,85,92,177,48.0%,12m
45328,2,crocdecroc,2040,911,53,55,108,49.1%,16m
45328,1,Nesco,2040,925,35,36,71,49.3%,5m
45328,2,ZARK,2040,361,28,16,44,63.6%,26m
45328,2,[Spehx]Anerad,2040,498,18,16,34,52.9%,1h
45328,3,Meriodasu,2040,420,16,15,31,51.6%,6m
45328,1,SafriDu,2040,427,14,27,41,34.1%,1h
45328,3,lmap,2040,323,13,27,40,32.5%,1h
45328,2,AdmAvoCado,2040,168,4,9,13,30.8%,1h
45328,3,asl,2040,79,3,3,6,50.0%,1h
45328,3,holtby,2040,30,3,11,14,21.4%,13m
45328,1,PURPLEFLUFF,2040,95,2,2,4,50.0%,17m
45328,1,Bers,2040,32,2,8,10,20.0%,1h
45328,3,SevenAnt,2040,0,2,8,10,20.0%,11m
45328,3,bessarabov,2040,30,1,4,5,20.0%,1h
45328,3,doom,2040,96,1,4,5,20.0%,10m
45328,3,DrGonzo,2040,91,1,4,5,20.0%,1h
45328,1,ZaEkTaHkucT,2040,0,1,5,6,16.7%,30m
45328,2,MariusWAS,2040,30,1,6,7,14.3%,13m
45328,3,SYKAYAKTO,2040,30,1,6,7,14.3%,1h
45328,1,Blito,2040,0,1,8,9,11.1%,1h
45328,2,broc,2040,0,0,1,1,0.0%,1h
45328,3,Flash,2040,0,0,1,1,0.0%,1h
45328,3,NOOB,2040,0,0,1,1,0.0%,34m
45328,3,EnnumaEllish,2040,0,0,1,1,0.0%,1h
45328,3,Darfeyn,2040,0,0,1,1,0.0%,1h
45328,3,kratos,2040,0,0,2,2,0.0%,1h
45355,2,[IFAI]Narvallo,2039,1488,245,292,537,45.6%,18m
45355,1,achik,2039,1402,190,187,377,50.4%,9m
45355,2,HunterG,2039,1342,120,126,246,48.8%,28m
45355,2,[TSC2C]JamesCradock,2039,1559,115,122,237,48.5%,1h
45355,2,Sirius,2039,1353,77,81,158,48.7%,5m
45355,2,alien,2039,1025,40,41,81,49.4%,1h
45355,3,durca,2039,823,38,44,82,46.3%,24m
45355,2,Octoginta,2039,481,18,19,37,48.6%,23m
45355,2,Nyél,2039,553,18,21,39,46.2%,1h
45355,3,Candle,2039,294,10,10,20,50.0%,1h
45355,3,Dimanche,2039,288,9,16,25,36.0%,34m
45355,3,Fra,2039,150,5,6,11,45.5%,3m
45355,2,Ylmz,2039,158,5,10,15,33.3%,23m
45355,3,Kavinsky,2039,124,5,13,18,27.8%,1h
45355,2,Sheldon,2039,154,4,7,11,36.4%,21m
45355,1,[UAFire]Tayz,2039,156,4,36,40,10.0%,30m
45355,3,Marcin,2039,88,3,4,7,42.9%,1h
45355,2,Tedian,2039,92,3,7,10,30.0%,1h
45355,2,[Meavv]lkdfhui,2039,144,3,7,10,30.0%,1h
45355,1,SoeinZufall,2039,142,3,15,18,16.7%,3m
45355,2,Privatemax,2039,88,2,5,7,28.6%,28m
45355,2,enkhee,2039,121,2,8,10,20.0%,1h
45355,3,AvtoSud,2039,0,1,0,1,100.0%,20m
45355,2,[Сold]IIIIIIIIIIII,2039,91,1,1,2,50.0%,1h
45355,3,OXXXYMORON,2039,30,1,3,4,25.0%,1h
45355,2,aburaas,2039,95,1,7,8,12.5%,1h
45355,3,DANON,2039,0,0,1,1,0.0%,22m
45355,3,Snoopy,2039,0,0,1,1,0.0%,8m
45355,3,Тандыров,2039,0,0,2,2,0.0%,14m
45355,2,Mag,2039,0,0,6,6,0.0%,14m
45385,2,Sherhan,2038,1483,91,96,187,48.7%,14m
45385,2,SpaceSeal,2038,769,30,34,64,46.9%,1h
45385,3,pierhana,2038,732,27,23,50,54.0%,1h
45385,2,Neerlisk,2038,433,16,22,38,42.1%,1h
45385,1,pic,2038,488,16,27,43,37.2%,5m
45385,1,Nestor,2038,451,15,26,41,36.6%,25m
45385,3,FonLegat,2038,355,12,17,29,41.4%,29m
45385,3,[Аоуэйя]FelixS,2038,150,9,12,21,42.9%,1h
45385,3,PeupS,2038,301,9,17,26,34.6%,28m
45385,2,Evo,2038,216,9,19,28,32.1%,1h
45385,2,troki,2038,244,8,10,18,44.4%,1h
45385,2,TRAFKA,2038,255,8,11,19,42.1%,15m
45385,2,perekaz,2038,110,3,2,5,60.0%,1h
45385,3,MaGnum,2038,86,3,4,7,42.9%,10m
45385,3,[xZero]Kubura,2038,30,2,2,4,50.0%,1h
45385,3,Hubert,2038,0,2,3,5,40.0%,1h
45385,1,DarenG,2038,96,2,4,6,33.3%,4m
45385,2,Сталкер,2038,0,1,7,8,12.5%,20m
45385,3,Eruantale,2038,0,0,1,1,0.0%,1h
45385,2,[Laröd]Hobbleknee,2038,0,0,1,1,0.0%,1h
45385,2,SupraStrong,2038,0,0,1,1,0.0%,20m
45385,2,RangerRyan,2038,0,0,1,1,0.0%,1h
45385,3,[Sw0rm]DarkZergling,2038,0,0,1,1,0.0%,1h
45385,2,DMHHH,2038,0,0,1,1,0.0%,1h
45385,3,Szili,2038,0,0,1,1,0.0%,5m
45385,3,Samy,2038,0,0,5,5,0.0%,9m
45385,3,Tiemes,2038,0,0,6,6,0.0%,1h
45412,2,GarryOZ,2037,1622,77,83,160,48.1%,1h
45412,3,nikotin,2037,1362,48,63,111,43.2%,25m
45412,2,minato,2037,474,42,44,86,48.8%,1h
45412,3,MELT,2037,898,32,32,64,50.0%,1h
45412,2,kustman,2037,859,32,34,66,48.5%,1h
45412,2,Просто,2037,690,27,30,57,47.4%,33m
45412,2,NantX,2037,546,23,24,47,48.9%,15m
45412,2,Warsa,2037,344,13,20,33,39.4%,32m
45412,1,MeowNine,2037,416,13,25,38,34.2%,13m
45412,3,PATRICKstar,2037,190,8,8,16,50.0%,25m
45412,2,Deddmitrich,2037,178,5,7,12,41.7%,24m
45412,2,Maxuse,2037,80,5,8,13,38.5%,18m
45412,3,Megyminimba,2037,86,3,1,4,75.0%,29m
45412,1,Virus,2037,116,3,4,7,42.9%,1h
45412,1,ptrmarvel,2037,97,3,11,14,21.4%,20m
45412,1,Joachim,2037,48,2,9,11,18.2%,3m
45412,3,Сvaruna,2037,0,1,0,1,100.0%,25m
45412,3,sairos,2037,0,1,0,1,100.0%,1h
45412,2,EUSIK,2037,88,1,3,4,25.0%,1h
45412,2,[lolxdx]kezdo,2037,6,1,7,8,12.5%,28m
45412,2,[WE420]TiSpundu,2037,0,0,1,1,0.0%,1h
45412,3,DonDiego,2037,0,0,3,3,0.0%,1h
45412,3,kontrobas,2037,0,0,5,5,0.0%,1h
45435,1,Derkoarl,2036,759,37,42,79,46.8%,14m
45435,2,bariccade,2036,880,35,31,66,53.0%,20m
45435,2,svetislaw,2036,697,30,26,56,53.6%,33m
45435,2,PuskasPeti,2036,375,15,17,32,46.9%,12m
45435,2,JoE,2036,444,15,19,34,44.1%,24m
45435,3,CannonRusher,2036,422,14,17,31,45.2%,34m
45435,2,Зинго,2036,349,13,9,22,59.1%,16m
45435,1,Highlandcrow,2036,337,7,16,23,30.4%,1h
45435,1,Glutołaz,2036,228,6,7,13,46.2%,19m
45435,3,luftig,2036,168,5,1,6,83.3%,28m
45435,3,Cieniu,2036,113,5,4,9,55.6%,20m
45435,1,Fighter,2036,154,5,13,18,27.8%,31m
45435,2,[Rokk]Frain,2036,161,4,6,10,40.0%,26m
45435,2,Sinner,2036,90,3,8,11,27.3%,1h
45435,2,Petrik,2036,90,3,8,11,27.3%,1h
45435,2,sallad,2036,162,3,9,12,25.0%,1h
45435,3,Dzhimax,2036,126,3,10,13,23.1%,1h
45435,3,MolZoor,2036,30,2,0,2,100.0%,11m
45435,3,[GOONI]Fixxx,2036,30,1,3,4,25.0%,22m
45435,1,Andreyka,2036,0,1,4,5,20.0%,15m
45435,2,[утка]ZERGPEK,2036,0,1,4,5,20.0%,1h
45435,3,KSzab,2036,0,1,4,5,20.0%,1h
45457,2,TJR,2035,1366,52,55,107,48.6%,20m
45457,2,[TBAS]Rataraula,2035,1138,38,42,80,47.5%,15m
45457,3,[FR1]BABA,2035,583,20,29,49,40.8%,30m
45457,1,Bietzsche,2035,555,18,30,48,37.5%,20m
45457,3,Kolyan,2035,510,14,52,66,21.2%,10m
45457,3,ada,2035,373,11,20,31,35.5%,11m
45457,2,Anakeim,2035,240,8,15,23,34.8%,1h
45457,2,lIlIlIIlIllI,2035,216,7,11,18,38.9%,24m
45457,2,Namcep,2035,158,6,13,19,31.6%,13m
45457,2,segun,2035,108,4,9,13,30.8%,20m
45457,2,DIMON,2035,116,3,5,8,37.5%,1h
45457,3,[UNBR]shveiser,2035,30,1,4,5,20.0%,27m
45457,3,FlexBeier,2035,0,0,1,1,0.0%,15m
45457,2,Motumbo,2035,0,0,4,4,0.0%,1h
45471,2,skiff,2034,1388,71,73,144,49.3%,1h
45471,3,Starfighter,2034,542,68,66,134,50.7%,31m
45471,3,bysha,2034,1482,54,57,111,48.6%,29m
45471,1,hball,2034,1359,49,63,112,43.8%,1h
45471,2,Gerolsteiner,2034,653,25,31,56,44.6%,24m
45471,3,Gilbert,2034,496,20,31,51,39.2%,1h
45471,2,Zarco,2034,393,18,13,31,58.1%,12m
45471,3,HusAfro,2034,447,15,16,31,48.4%,1h
45471,2,ауе,2034,442,15,21,36,41.7%,16m
45471,3,Corpsman,2034,104,5,3,8,62.5%,28m
45471,3,VITZEN,2034,116,4,5,9,44.4%,24m
45471,2,mopolita,2034,90,2,6,8,25.0%,29m
45471,1,OlegHueg,2034,42,2,8,10,20.0%,1h
45471,3,wangbigcool,2034,0,2,10,12,16.7%,1h
45471,3,Masutatsu,2034,30,2,10,12,16.7%,9m
45471,3,YRK,2034,0,1,0,1,100.0%,11m
45471,2,MamsB,2034,0,1,0,1,100.0%,1h
45471,2,AlTheGeneral,2034,0,1,0,1,100.0%,1h
45471,1,TrykzZ,2034,48,1,5,6,16.7%,1h
45471,2,SpacerX,2034,30,1,7,8,12.5%,1h
45471,3,Maciej,2034,0,0,1,1,0.0%,1h
45471,3,Sentry,2034,0,0,2,2,0.0%,1h
45471,3,[черепо]РыбаКапля,2034,0,0,2,2,0.0%,1h
45471,2,Nylasz,2034,0,0,3,3,0.0%,1h
45471,3,TheBattleL,2034,0,0,3,3,0.0%,1h
45471,2,Akella,2034,0,0,7,7,0.0%,26m
45497,2,BRASS,2033,446,64,68,132,48.5%,1h
45497,3,Apacyte,2033,1250,46,45,91,50.5%,14m
45497,3,CLOUD,2033,876,31,37,68,45.6%,11m
45497,2,Almogaver,2033,705,30,31,61,49.2%,21m
45497,3,Altair,2033,638,26,19,45,57.8%,1h
45497,1,SkrrtSkrrt,2033,722,24,37,61,39.3%,1h
45497,1,reloaded,2033,706,22,36,58,37.9%,33m
45497,3,PedrolitoBE,2033,536,19,28,47,40.4%,5m
45497,3,tasmany,2033,413,16,20,36,44.4%,26m
45497,2,WillBeSick,2033,425,16,25,41,39.0%,15m
45497,3,Fuсker,2033,354,12,14,26,46.2%,11m
45497,3,Dschadir,2033,202,7,8,15,46.7%,1h
45497,3,NightFury,2033,141,4,2,6,66.7%,1h
45497,2,Tom,2033,90,4,11,15,26.7%,33m
45497,3,Wolf,2033,97,3,3,6,50.0%,1h
45497,3,Malder,2033,58,2,2,4,50.0%,31m
45497,2,Sid,2033,22,2,8,10,20.0%,14m
45497,2,avalon,2033,88,1,2,3,33.3%,28m
45497,2,oldbob,2033,91,1,3,4,25.0%,1h
45497,2,Kratos,2033,30,1,5,6,16.7%,15m
45497,2,caveman,2033,88,1,7,8,12.5%,33m
45497,2,McLaugh,2033,44,1,8,9,11.1%,17m
45497,1,boeberking,2033,0,1,8,9,11.1%,1h
45497,1,Vovchik,2033,0,1,9,10,10.0%,11m
45497,1,Rob,2033,40,1,10,11,9.1%,31m
45497,3,[ECP19]AntonyLazer,2033,0,0,1,1,0.0%,1h
45497,3,[6STYL6]Antibiotik,2033,0,0,1,1,0.0%,31m
45497,3,iliajefre,2033,0,0,1,1,0.0%,3m
45497,3,MrPickles,2033,0,0,6,6,0.0%,11m
45526,2,Yaro,2032,1429,143,154,297,48.1%,1h
45526,2,zaichik,2032,1556,99,104,203,48.8%,18m
45526,3,CrazyHorse,2032,1598,82,81,163,50.3%,1h
45526,1,Universar,2032,1494,79,96,175,45.1%,33m
45526,2,Terrasimo,2032,1488,67,72,139,48.2%,15m
45526,3,jattra,2032,1105,40,43,83,48.2%,1h
45526,2,GhaylortIII,2032,1070,38,46,84,45.2%,8m
45526,3,CaptainPrice,2032,805,29,36,65,44.6%,34m
45526,3,Steese,2032,400,17,26,43,39.5%,3m
45526,3,Keona,2032,408,16,32,48,33.3%,20m
45526,2,XanthiX,2032,274,10,13,23,43.5%,15m
45526,2,Skellet,2032,225,9,11,20,45.0%,30m
45526,3,DenzVlad,2032,232,7,4,11,63.6%,1h
45526,3,MarTime,2032,197,6,3,9,66.7%,1h
45526,2,[TFSC]Helitacker,2032,114,4,8,12,33.3%,1h
45526,2,starcraf,2032,179,4,11,15,26.7%,33m
45526,3,Maras,2032,98,3,6,9,33.3%,9m
45526,2,iiiiiiiiiiii,2032,0,3,8,11,27.3%,1h
45526,3,Flash,2032,62,2,6,8,25.0%,1h
45526,2,Floco,2032,107,2,8,10,20.0%,1h
45526,3,VACON,2032,95,2,9,11,18.2%,19m
45526,1,Amoc,2032,0,1,5,6,16.7%,31m
45526,3,Brian,2032,42,1,5,6,16.7%,1h
45526,1,DEC,2032,0,1,7,8,12.5%,1h
45526,3,HulkHogan,2032,0,0,1,1,0.0%,1h
45526,3,Консул,2032,0,0,1,1,0.0%,1h
45526,3,Raynar,2032,0,0,1,1,0.0%,27m
45526,2,[BArCo]Strelok,2032,0,0,4,4,0.0%,1h
45526,2,krust,2032,0,0,5,5,0.0%,1h
45555,1,Alexeichua,2031,1510,103,110,213,48.4%,1h
45555,3,martitagada,2031,874,29,34,63,46.0%,1h
45555,2,Ninjakeks,2031,582,24,21,45,53.3%,33m
45555,2,Tommyknocker,2031,696,24,35,59,40.7%,7m
45555,2,Hytox,2031,524,19,26,45,42.2%,1h
45555,2,Necrom,2031,242,17,9,26,65.4%,12m
45555,1,AfkMan,2031,312,11,20,31,35.5%,23m
45555,3,Burzumer,2031,194,7,3,10,70.0%,30m
45555,1,heroes,2031,142,7,12,19,36.8%,15m
45555,2,nikolay,2031,168,4,9,13,30.8%,1h
45555,3,[X4N4X]chichoix,2031,86,3,2,5,60.0%,6m
45555,3,JSanchez,2031,0,1,0,1,100.0%,30m
45555,3,sverre,2031,0,1,1,2,50.0%,15m
45555,2,COhido,2031,48,1,8,9,11.1%,1h
45555,3,CountDrugula,2031,0,0,1,1,0.0%,27m
45555,2,Boldone,2031,0,0,6,6,0.0%,1h
45555,2,ArcyAdam,2031,0,0,7,7,0.0%,1h
45572,1,FreeSYR,2030,585,66,71,137,48.2%,1h
45572,1,[bullD]forZeJericho,2030,1420,65,78,143,45.5%,14m
45572,2,Gaja,2030,1544,55,73,128,43.0%,1h
45572,2,DrKepler,2030,1341,53,55,108,49.1%,1h
45572,2,Mtt,2030,546,36,40,76,47.4%,15m
45572,1,LARISHERBET,2030,712,30,32,62,48.4%,1h
45572,2,bocanof,2030,822,29,33,62,46.8%,24m
45572,2,Bbqer,2030,422,17,18,35,48.6%,28m
45572,2,Mithrandir,2030,402,16,15,31,51.6%,10m
45572,3,Woplex,2030,359,14,17,31,45.2%,1h
45572,3,phildee,2030,284,10,8,18,55.6%,6m
45572,1,DueSt,2030,208,10,12,22,45.5%,1h
45572,2,[MWorld]sweatyduck,2030,278,10,14,24,41.7%,12m
45572,2,Gimka,2030,298,10,16,26,38.5%,8m
45572,3,Limon,2030,232,9,6,15,60.0%,28m
45572,2,ZTC,2030,124,9,7,16,56.2%,28m
45572,3,ipoopandpee,2030,274,9,13,22,40.9%,1h
45572,3,GoodNight,2030,251,9,18,27,33.3%,3m
45572,3,DENERGAR,2030,292,8,11,19,42.1%,10m
45572,2,KPSS,2030,294,8,15,23,34.8%,14m
45572,2,Taco,2030,156,7,3,10,70.0%,33m
45572,1,[1NO2]molotov,2030,236,6,13,19,31.6%,7m
45572,1,Transformers,2030,237,4,9,13,30.8%,4m
45572,3,MSW,2030,60,3,1,4,75.0%,1h
45572,3,Coincoin,2030,58,3,4,7,42.9%,22m
45572,3,jefe,2030,64,3,4,7,42.9%,11m
45572,3,Serrql,2030,30,2,1,3,66.7%,24m
45572,3,SHIKIMARU,2030,0,2,11,13,15.4%,1h
45572,3,Varzy,2030,0,1,0,1,100.0%,34m
45572,3,Xeto,2030,0,1,0,1,100.0%,31m
45572,2,soulbros,2030,46,1,3,4,25.0%,18m
45572,3,Maru,2030,0,1,4,5,20.0%,1h
45572,1,Noam,2030,0,1,6,7,14.3%,1h
45572,3,koudak,2030,0,0,1,1,0.0%,15m
45572,2,RadioactiveD,2030,0,0,4,4,0.0%,1h
45607,1,BanGhir,2029,1612,128,137,265,48.3%,1h
45607,1,veterinar,2029,714,72,82,154,46.8%,1h
45607,2,Havk,2029,1255,44,60,104,42.3%,28m
45607,3,Diak,2029,355,16,10,26,61.5%,1h
45607,2,[TeUn]Gabriel,2029,351,13,18,31,41.9%,1h
45607,1,Nigale,2029,281,10,11,21,47.6%,26m
45607,3,ApOlLOL,2029,248,8,10,18,44.4%,1h
45607,3,SATHRACE,2029,238,7,2,9,77.8%,24m
45607,3,Pochan,2029,114,4,2,6,66.7%,16m
45607,3,Veter,2029,122,4,6,10,40.0%,15m
45607,2,Intuit,2029,159,4,7,11,36.4%,1h
45607,3,Duk,2029,122,3,5,8,37.5%,23m
45607,3,Spartacus,2029,0,1,0,1,100.0%,1h
45607,3,SilverDragon,2029,30,1,1,2,50.0%,1h
45607,2,Vania,2029,46,1,1,2,50.0%,1h
45607,2,andromath,2029,0,1,6,7,14.3%,12m
45607,2,Hypnotize,2029,46,1,8,9,11.1%,20m
45607,3,[Fr]MaxbrigdSlow,2029,0,0,1,1,0.0%,1h
45607,3,Wojtek,2029,0,0,1,1,0.0%,34m
45626,3,Palagos,2028,1188,59,48,107,55.1%,1h
45626,3,Florans,2028,1319,55,70,125,44.0%,1h
45626,2,[bisdak]StarLord,2028,870,33,41,74,44.6%,34m
45626,3,NoxicQ,2028,704,26,34,60,43.3%,15m
45626,2,MrMem,2028,560,23,23,46,50.0%,21m
45626,2,onuff,2028,572,20,22,42,47.6%,1h
45626,3,zimi,2028,418,15,20,35,42.9%,12m
45626,3,Restupn,2028,299,10,11,21,47.6%,29m
45626,3,Mistrzakos,2028,214,9,11,20,45.0%,1h
45626,2,Mantis,2028,153,8,8,16,50.0%,1h
45626,3,Avo,2028,218,8,11,19,42.1%,12m
45626,2,[GSP]thesenario,2028,82,5,6,11,45.5%,1h
45626,1,KingOnur,2028,162,4,10,14,28.6%,28m
45626,1,Rico,2028,133,3,9,12,25.0%,1h
45626,1,KapitanBOMBA,2028,0,2,5,7,28.6%,7m
45626,2,HopefulAlien,2028,60,2,7,9,22.2%,1h
45626,3,PandaSamurai,2028,0,1,0,1,100.0%,31m
45626,3,Didi,2028,0,1,1,2,50.0%,1h
45626,3,hirschMeista,2028,30,1,5,6,16.7%,26m
45626,2,Ejbuc,2028,121,1,6,7,14.3%,15m
45626,1,JacKParrow,2028,0,1,6,7,14.3%,8m
45626,3,CrissCross,2028,0,0,1,1,0.0%,1h
45626,3,[Apoka1]тимофей,2028,0,0,1,1,0.0%,1h
45626,2,GavixJam,2028,0,0,1,1,0.0%,23m
45626,3,callvin,2028,0,0,2,2,0.0%,30m
45626,2,Nooby,2028,0,0,2,2,0.0%,1h
45626,3,Иван,2028,0,0,2,2,0.0%,14m
45653,2,thejackal,2027,1522,65,66,131,49.6%,31m
45653,2,raggnar,2027,1304,55,55,110,50.0%,1h
45653,2,Jocovitj,2027,1264,49,50,99,49.5%,1h
45653,3,Cole,2027,1231,46,53,99,46.5%,13m
45653,2,nari,2027,1063,43,44,87,49.4%,23m
45653,2,Bender,2027,273,42,45,87,48.3%,1h
45653,2,graч,2027,866,40,39,79,50.6%,16m
45653,2,[YOMAMA]Koroextreme,2027,872,32,37,69,46.4%,1h
45653,3,Aiven,2027,732,29,20,49,59.2%,26m
45653,2,mclane,2027,680,27,26,53,50.9%,26m
45653,2,Math,2027,676,23,33,56,41.1%,34m
45653,2,Furia,2027,529,21,27,48,43.8%,33m
45653,2,Schattenwolf,2027,386,16,16,32,50.0%,28m
45653,2,MeNGanSSS,2027,414,15,24,39,38.5%,6m
45653,1,[Ba2c]Ragdeimerde,2027,469,15,29,44,34.1%,1h
45653,3,QuickSort,2027,308,11,9,20,55.0%,1h
45653,3,LanSung,2027,252,10,7,17,58.8%,24m
45653,3,Märk,2027,144,3,1,4,75.0%,1h
45653,3,Corvax,2027,119,3,6,9,33.3%,1h
45653,1,KoMbaTiK,2027,117,3,9,12,25.0%,1h
45653,3,[fam1ly]Kebabnxtdoor,2027,120,3,12,15,20.0%,1h
45653,3,drstrange,2027,60,2,6,8,25.0%,3m
45653,3,[ISV]robert,2027,0,1,2,3,33.3%,1h
45653,2,TheStormRage,2027,0,1,4,5,20.0%,1h
45653,2,Regonzu,2027,44,1,7,8,12.5%,1h
45653,3,SEBASTIAN,2027,0,0,1,1,0.0%,34m
45653,2,Thore,2027,0,0,1,1,0.0%,1h
45653,3,[Wamaj]DrakoaoKakao,2027,0,0,2,2,0.0%,11m
45653,2,GUGUMAN,2027,0,0,3,3,0.0%,17m
45653,2,inafo,2027,0,0,3,3,0.0%,28m
45653,3,моргенштерн,2027,0,0,3,3,0.0%,1h
45653,2,pluvianox,2027,0,0,6,6,0.0%,1h
45653,2,Laker,2027,0,0,6,6,0.0%,20m
45653,2,Karrkerras,2027,0,0,9,9,0.0%,29m
45687,2,Gillosor,2026,1427,53,62,115,46.1%,15m
45687,2,LeDuc,2026,1279,49,56,105,46.7%,1h
45687,2,кивин,2026,1167,45,45,90,50.0%,1h
45687,2,RAOS,2026,713,32,30,62,51.6%,33m
45687,2,Diego,2026,769,32,33,65,49.2%,32m
45687,2,dimon,2026,327,30,36,66,45.5%,34m
45687,2,Uno,2026,639,27,33,60,45.0%,1h
45687,3,Bidule,2026,740,27,34,61,44.3%,16m
45687,2,МистерСмерть,2026,757,26,40,66,39.4%,1h
45687,2,Doberka,2026,425,15,26,41,36.6%,20m
45687,1,Phoenix,2026,373,14,26,40,35.0%,1h
45687,2,Didok,2026,138,7,3,10,70.0%,29m
45687,2,[RMM]SuperStein,2026,198,7,12,19,36.8%,1h
45687,3,[AA36]GoLLum,2026,146,6,4,10,60.0%,24m
45687,2,WiThErOsE,2026,146,6,9,15,40.0%,1h
45687,2,Homie,2026,194,6,12,18,33.3%,7m
45687,1,Boiar,2026,60,3,10,13,23.1%,32m
45687,3,[SryPod]Стол,2026,30,2,1,3,66.7%,29m
45687,2,[KSMH]KeSeMeKa,2026,0,1,1,2,50.0%,1h
45687,3,[OGiK]AlexAnal,2026,30,1,4,5,20.0%,8m
45687,3,[boysGS]uZzZver,2026,0,1,5,6,16.7%,1h
45687,3,Metos,2026,0,0,1,1,0.0%,1h
45687,3,palka,2026,0,0,1,1,0.0%,27m
45687,2,Brammanyn,2026,0,0,1,1,0.0%,29m
45687,1,[1DELTA]echtlol,2026,0,0,2,2,0.0%,10m
45687,3,димоооон,2026,0,0,4,4,0.0%,8m
45687,2,Gunter,2026,0,0,7,7,0.0%,1h
45714,2,xarisghost,2025,1581,682,776,1458,46.8%,1h
45714,1,jeelie,2025,1566,121,128,249,48.6%,1h
45714,1,Max,2025,1615,96,98,194,49.5%,33m
45714,3,BlackVolf,2025,1068,44,46,90,48.9%,5m
45714,2,Лютик,2025,676,31,29,60,51.7%,1h
45714,2,[OmDi]MicRloiN,2025,679,29,24,53,54.7%,1h
45714,2,BamBa,2025,249,21,23,44,47.7%,16m
45714,3,Wizya,2025,404,16,14,30,53.3%,11m
45714,2,[2iq]Shizoid,2025,418,14,21,35,40.0%,13m
45714,1,GioC,2025,340,12,14,26,46.2%,1h
45714,1,KaitoKid,2025,240,7,15,22,31.8%,1h
45714,2,TheIrishBear,2025,154,7,16,23,30.4%,11m
45714,1,Vladimir,2025,241,5,13,18,27.8%,9m
45714,3,AHSPWR,2025,120,4,6,10,40.0%,25m
45714,1,SimXgaminG,2025,190,4,11,15,26.7%,33m
45714,2,smallbulldog,2025,130,3,3,6,50.0%,1h
45714,3,Indy,2025,58,3,6,9,33.3%,34m
45714,1,Sam,2025,143,2,3,5,40.0%,8m
45714,2,yazik,2025,30,2,6,8,25.0%,23m
45714,3,Misel,2025,40,1,6,7,14.3%,5m
45714,3,[674]dominox,2025,0,0,1,1,0.0%,1h
45714,3,Ovnia,2025,0,0,1,1,0.0%,27m
45714,3,Vll,2025,0,0,3,3,0.0%,11m
45714,2,Nallu,2025,0,0,6,6,0.0%,1h
45738,2,bReal,2024,1505,139,154,293,47.4%,33m
45738,1,Шиари,2024,1423,116,140,256,45.3%,1h
45738,2,Bladestorm,2024,1529,114,128,242,47.1%,1h
45738,2,Rage,2024,930,71,56,127,55.9%,33m
45738,1,PasutusI,2024,557,58,64,122,47.5%,1h
45738,2,SofTBitE,2024,827,32,44,76,42.1%,1h
45738,2,Eliitaliano,2024,726,25,36,61,41.0%,21m
45738,3,newbie,2024,466,17,12,29,58.6%,24m
45738,2,PaLm,2024,489,17,24,41,41.5%,24m
45738,2,trevpather,2024,363,13,13,26,50.0%,1h
45738,3,kekko,2024,376,13,14,27,48.1%,4m
45738,3,shark,2024,306,9,12,21,42.9%,23m
45738,2,VankoFan,2024,178,6,13,19,31.6%,21m
45738,3,Ghostez,2024,90,4,5,9,44.4%,1h
45738,2,Nawciongany,2024,114,4,7,11,36.4%,1h
45738,2,Maciejo,2024,126,3,11,14,21.4%,15m
45738,2,lastofalex,2024,60,2,8,10,20.0%,1h
45738,3,DLF,2024,30,1,3,4,25.0%,29m
45738,2,Paulax,2024,88,1,7,8,12.5%,5m
45738,1,DarkVoid,2024,0,1,9,10,10.0%,17m
45738,3,Азимут,2024,0,0,1,1,0.0%,20m
45738,1,[lTpMl]ISAF,2024,0,0,1,1,0.0%,23m
45760,1,АлексД,2023,1610,77,85,162,47.5%,1h
45760,3,MAXUS,2023,1425,59,52,111,53.2%,1h
45760,3,Flo,2023,1374,55,52,107,51.4%,1h
45760,2,Zerantoss,2023,896,35,33,68,51.5%,24m
45760,3,Qayomb,2023,809,32,30,62,51.6%,25m
45760,3,STAR,2023,340,29,26,55,52.7%,27m
45760,1,MIXAIL,2023,685,23,40,63,36.5%,1h
45760,3,yoelwin,2023,497,20,17,37,54.1%,1h
45760,2,ShadowStorm,2023,444,16,23,39,41.0%,1h
45760,2,Panasonic,2023,306,11,17,28,39.3%,31m
45760,3,Majo,2023,175,8,4,12,66.7%,20m
45760,1,hellad,2023,287,6,14,20,30.0%,34m
45760,2,ZurgFcker,2023,116,3,4,7,42.9%,21m
45760,3,Joosele,2023,30,2,0,2,100.0%,27m
45760,1,APOSTOL,2023,90,2,4,6,33.3%,32m
45760,2,iop,2023,46,1,3,4,25.0%,28m
45760,3,giperhyilo,2023,0,0,1,1,0.0%,1h
45760,1,BlyTung,2023,0,0,1,1,0.0%,10m
45760,3,JimmyMcGood,2023,0,0,1,1,0.0%,31m
45760,3,desant,2023,0,0,2,2,0.0%,1h
45760,2,ruton,2023,0,0,6,6,0.0%,1h
45781,2,Misterx,2022,1532,119,133,252,47.2%,1h
45781,3,tommdelong,2022,1350,72,72,144,50.0%,1h
45781,3,Rage,2022,1390,69,69,138,50.0%,11m
45781,3,Adam,2022,1371,59,63,122,48.4%,1h
45781,3,FrancisHoare,2022,608,42,44,86,48.8%,1h
45781,3,homeris,2022,974,35,35,70,50.0%,6m
45781,3,[Corbi]Eracle,2022,559,22,21,43,51.2%,1h
45781,3,[СТРАТ]WhiteGal,2022,374,13,15,28,46.4%,1h
45781,2,MasterLee,2022,241,7,12,19,36.8%,1h
45781,2,[LawDa]Andruha,2022,118,5,10,15,33.3%,1h
45781,1,Simbax,2022,98,4,2,6,66.7%,1h
45781,2,bibitbobot,2022,156,4,8,12,33.3%,16m
45781,3,Vlad,2022,86,3,2,5,60.0%,34m
45781,1,marco,2022,90,2,0,2,100.0%,1h
45781,3,Armageddon,2022,30,2,1,3,66.7%,31m
45781,3,zerozux,2022,38,1,1,2,50.0%,1h
45781,1,MaskedMonkey,2022,0,1,7,8,12.5%,1h
45781,3,KOT,2022,0,0,1,1,0.0%,29m
45781,1,WARRIOR,2022,0,0,5,5,0.0%,6m
45781,3,Lotos,2022,0,0,5,5,0.0%,1h
45781,3,Eppendorf,2022,0,0,6,6,0.0%,1h
45802,3,SKULI,2021,1572,274,297,571,48.0%,1h
45802,2,Joska,2021,1577,181,195,376,48.1%,1h
45802,2,MADGIMBLI,2021,1552,58,70,128,45.3%,16m
45802,1,Heradaton,2021,1499,57,68,125,45.6%,32m
45802,2,SkiSurfer,2021,1436,56,63,119,47.1%,1h
45802,2,wildgarri,2021,1386,51,66,117,43.6%,1h
45802,3,ArutyunSWAG,2021,904,34,32,66,51.5%,22m
45802,2,KwaKiGna,2021,830,30,36,66,45.5%,30m
45802,1,MrLife,2021,353,21,36,57,36.8%,25m
45802,2,AzKhaRix,2021,274,8,12,20,40.0%,1h
45802,3,alpinum,2021,120,7,8,15,46.7%,8m
45802,2,Cancun,2021,236,7,13,20,35.0%,31m
45802,2,[6IKEA9]YaponeC,2021,118,5,8,13,38.5%,1h
45802,2,LILIX,2021,114,4,9,13,30.8%,33m
45802,3,Isti,2021,30,3,3,6,50.0%,31m
45802,3,KostikH,2021,30,2,0,2,100.0%,25m
45802,3,[ZЕRGТV]Sovushka,2021,30,2,1,3,66.7%,14m
45802,3,LEOKUBENswe,2021,121,2,2,4,50.0%,5m
45802,3,[971]Braximus,2021,0,1,2,3,33.3%,24m
45802,3,FrimenMr,2021,0,1,2,3,33.3%,1h
45802,1,RuSSeL,2021,0,1,8,9,11.1%,1h
45802,3,[iMDK]DevastatoR,2021,0,0,1,1,0.0%,6m
45802,3,[monstr]hercules,2021,0,0,1,1,0.0%,1h
45802,1,Taiipz,2021,0,0,2,2,0.0%,10m
45802,3,Foxi,2021,0,0,6,6,0.0%,1h
45802,2,Adelai,2021,0,0,7,7,0.0%,1h
45828,1,Paul,2020,1622,395,419,814,48.5%,1h
45828,3,TheOldGamer,2020,1326,96,134,230,41.7%,13m
45828,2,ВаньЧуньг,2020,1522,95,101,196,48.5%,1h
45828,2,ninjhigh,2020,1537,69,58,127,54.3%,5m
45828,2,House,2020,1122,41,45,86,47.7%,1h
45828,2,ZSkyWalker,2020,329,40,47,87,46.0%,1h
45828,2,генерал,2020,831,32,36,68,47.1%,1h
45828,2,HandsofTitan,2020,693,24,34,58,41.4%,19m
45828,2,Skyfall,2020,568,20,33,53,37.7%,27m
45828,1,HADERfc,2020,487,14,29,43,32.6%,1h
45828,2,Maxj,2020,268,11,14,25,44.0%,1h
45828,3,Vimer,2020,244,9,7,16,56.2%,25m
45828,3,mecos,2020,248,9,8,17,52.9%,1h
45828,3,Yoghurtpost,2020,290,9,17,26,34.6%,1h
45828,3,Hyps,2020,130,6,9,15,40.0%,31m
45828,2,feliuarro,2020,186,6,14,20,30.0%,14m
45828,2,Fiskesuppe,2020,166,6,16,22,27.3%,28m
45828,1,StoneBreaker,2020,140,5,13,18,27.8%,9m
45828,3,jouss,2020,118,4,7,11,36.4%,24m
45828,3,GENJIF,2020,175,4,9,13,30.8%,11m
45828,3,xQuakx,2020,62,3,5,8,37.5%,1h
45828,1,Морпех,2020,96,3,12,15,20.0%,1h
45828,3,anumat,2020,30,2,0,2,100.0%,26m
45828,3,BadDUCK,2020,0,1,1,2,50.0%,1h
45828,3,malice,2020,38,1,7,8,12.5%,1h
45828,3,Locutus,2020,0,0,1,1,0.0%,1h
45828,3,Freaker,2020,0,0,1,1,0.0%,1h
45828,3,AlexMarine,2020,0,0,1,1,0.0%,15m
45828,3,Musashi,2020,0,0,5,5,0.0%,1h
45857,1,disbalance,2019,1608,144,149,293,49.1%,1h
45857,2,SRT,2019,1592,97,97,194,50.0%,1h
45857,2,Enigma,2019,1312,75,84,159,47.2%,6m
45857,2,nowas,2019,242,34,35,69,49.3%,21m
45857,2,[LMBD]gLoiNN,2019,754,30,38,68,44.1%,1h
45857,1,XenoM,2019,670,24,38,62,38.7%,1h
45857,2,Skeiler,2019,194,10,7,17,58.8%,1h
45857,3,siebmacher,2019,148,6,6,12,50.0%,1h
45857,2,Eraxou,2019,167,5,8,13,38.5%,19m
45857,2,Rocco,2019,203,5,12,17,29.4%,5m
45857,3,ПОБЕЖДУ,2019,0,4,1,5,80.0%,1h
45857,1,LotF,2019,104,4,12,16,25.0%,1h
45857,1,Tornac,2019,145,3,5,8,37.5%,1h
45857,1,Richter,2019,76,3,11,14,21.4%,1h
45857,2,Koshi,2019,0,2,9,11,18.2%,10m
45857,2,Gregz,2019,44,2,9,11,18.2%,18m
45857,3,[mfixed]KUBIX,2019,0,1,0,1,100.0%,1h
45857,2,Francesco,2019,88,1,3,4,25.0%,1h
45857,1,[k1raen]Neo,2019,48,1,7,8,12.5%,1h
45857,3,Rodi,2019,0,0,1,1,0.0%,27m
45857,2,ProtEctoR,2019,0,0,2,2,0.0%,1h
45857,3,Lozadam,2019,0,0,3,3,0.0%,1h
45857,2,Pacothor,2019,73,0,8,8,0.0%,1h
45880,2,McHan,2018,1532,376,392,768,49.0%,1h
45880,1,AngryGirl,2018,1194,261,277,538,48.5%,1h
45880,2,Star,2018,1489,154,162,316,48.7%,1h
45880,2,ddt,2018,281,12,11,23,52.2%,21m
45880,1,Tixobzdeev,2018,242,8,16,24,33.3%,1h
45880,3,[EliteW]ECHOZIEGE,2018,176,6,6,12,50.0%,31m
45880,3,Dobrusha,2018,198,6,15,21,28.6%,1h
45880,3,oparmus,2018,146,5,8,13,38.5%,1h
45880,3,фффйы,2018,152,5,9,14,35.7%,20m
45880,3,[fubb]angiant,2018,62,3,5,8,37.5%,24m
45880,3,МегаЛевин,2018,92,3,7,10,30.0%,27m
45880,3,Tofisowa,2018,60,2,3,5,40.0%,1h
45880,3,predateur,2018,30,2,11,13,15.4%,9m
45880,2,Тобирама,2018,0,1,1,2,50.0%,1h
45880,2,GetRektSon,2018,0,1,2,3,33.3%,24m
45880,3,Rokoltira,2018,30,1,2,3,33.3%,3m
45880,3,OlD,2018,30,1,2,3,33.3%,14m
45880,3,Barbarossa,2018,0,0,1,1,0.0%,22m
45880,3,genistar,2018,0,0,1,1,0.0%,5m
45880,3,TERRAkiller,2018,0,0,2,2,0.0%,15m
45900,1,ZerGutt,2017,1379,124,137,261,47.5%,23m
45900,2,lex,2017,842,79,74,153,51.6%,1h
45900,2,Quinas,2017,1298,76,91,167,45.5%,34m
45900,2,deathsky,2017,802,30,30,60,50.0%,1h
45900,2,DrFranky,2017,348,25,23,48,52.1%,16m
45900,2,[PrTer]Srg,2017,386,13,15,28,46.4%,19m
45900,3,Kazah,2017,320,11,12,23,47.8%,31m
45900,2,Feketevölgy,2017,395,11,16,27,40.7%,1h
45900,3,Fede,2017,266,10,10,20,50.0%,25m
45900,3,Starfleet,2017,228,8,10,18,44.4%,31m
45900,2,Joelito,2017,197,6,7,13,46.2%,1h
45900,3,[LOGS]Doofy,2017,145,3,6,9,33.3%,1h
45900,2,Brani,2017,142,3,8,11,27.3%,32m
45900,3,Zipp,2017,58,2,1,3,66.7%,1h
45900,3,[кроссы]Riddie,2017,30,2,1,3,66.7%,13m
45900,3,Rodin,2017,0,1,0,1,100.0%,34m
45900,3,Centurion,2017,0,1,0,1,100.0%,29m
45900,3,deadarrow,2017,0,1,1,2,50.0%,1h
45900,3,Electricfish,2017,30,1,1,2,50.0%,1h
45900,3,[XYZ123]MarkusT,2017,30,1,5,6,16.7%,26m
45900,2,Janey,2017,0,1,7,8,12.5%,29m
45900,2,CrolenStone,2017,0,1,7,8,12.5%,18m
45900,2,BajBajGnidko,2017,0,1,7,8,12.5%,1h
45900,2,ikalamidas,2017,0,0,1,1,0.0%,1h
45900,2,roman,2017,0,0,2,2,0.0%,1h
45900,2,FiniteState,2017,0,0,3,3,0.0%,30m
45900,2,SoKoJI,2017,0,0,3,3,0.0%,1h
45900,2,Henris,2017,0,0,6,6,0.0%,21m
45900,3,Varenik,2017,0,0,6,6,0.0%,17m
45900,2,Antool,2017,0,0,6,6,0.0%,1h
45900,3,Alekstr,2017,0,0,6,6,0.0%,34m
45900,2,flavor,2017,0,0,7,7,0.0%,12m
45932,1,Cobalt,2016,1438,271,281,552,49.1%,26m
45932,3,[Эщкер]deeen,2016,979,47,39,86,54.7%,1h
45932,2,[UYourS]CJP,2016,806,31,32,63,49.2%,1h
45932,3,devastatore,2016,542,25,25,50,50.0%,1h
45932,3,Central,2016,656,25,25,50,50.0%,27m
45932,2,[FISI]Krypet,2016,574,20,31,51,39.2%,26m
45932,2,InStable,2016,494,19,23,42,45.2%,1h
45932,3,Dwan,2016,306,13,5,18,72.2%,23m
45932,3,Elzob,2016,220,12,5,17,70.6%,34m
45932,2,ksbiv,2016,230,9,10,19,47.4%,14m
45932,1,[StrCo]Hedgehog,2016,298,8,19,27,29.6%,25m
45932,2,Donbassovec,2016,170,6,7,13,46.2%,1h
45932,3,Kwézi,2016,150,6,10,16,37.5%,26m
45932,2,[BAWIE]Manana,2016,160,5,7,12,41.7%,1h
45932,2,Charly,2016,129,5,7,12,41.7%,15m
45932,3,Пёс,2016,191,5,8,13,38.5%,1h
45932,3,sergo,2016,86,4,1,5,80.0%,1h
45932,3,Donny,2016,58,4,5,9,44.4%,17m
45932,2,Ioannis,2016,115,4,9,13,30.8%,17m
45932,3,DemonCock,2016,0,3,2,5,60.0%,1h
45932,3,[MCKH]Dab,2016,30,3,4,7,42.9%,1h
45932,1,Kurty,2016,96,3,7,10,30.0%,1h
45932,3,DevilsFinger,2016,60,2,4,6,33.3%,12m
45932,3,hodigol,2016,30,1,3,4,25.0%,31m
45932,3,LitleBeastBG,2016,30,1,3,4,25.0%,1h
45932,3,FlowerPot,2016,0,1,4,5,20.0%,29m
45932,3,kimy,2016,30,1,5,6,16.7%,5m
45932,2,cAnAdA,2016,0,1,6,7,14.3%,29m
45932,3,щщшш,2016,46,1,6,7,14.3%,26m
45932,3,Gangsta,2016,0,0,1,1,0.0%,1h
45932,2,GENY,2016,0,0,3,3,0.0%,1h
45932,3,adriano,2016,0,0,7,7,0.0%,1h
45964,2,Jazzah,2015,614,76,81,157,48.4%,7m
45964,2,max,2015,1490,70,82,152,46.1%,33m
45964,3,Ggiuglio,2015,1418,55,58,113,48.7%,1h
45964,2,GoukenSama,2015,1138,41,50,91,45.1%,12m
45964,2,ardee,2015,572,33,35,68,48.5%,6m
45964,2,alexvey,2015,647,26,19,45,57.8%,33m
45964,3,Lichi,2015,499,16,22,38,42.1%,6m
45964,1,Cezary,2015,480,16,28,44,36.4%,12m
45964,2,Apollo,2015,399,13,25,38,34.2%,1h
45964,3,imja,2015,241,8,3,11,72.7%,1h
45964,3,dan,2015,232,7,8,15,46.7%,11m
45964,3,Crono,2015,148,6,8,14,42.9%,22m
45964,2,Raider,2015,167,4,4,8,50.0%,32m
45964,2,Razkal,2015,58,4,13,17,23.5%,11m
45964,3,NickWrecks,2015,30,3,12,15,20.0%,17m
45964,2,CommAnder,2015,30,2,6,8,25.0%,5m
45964,2,Madvion,2015,145,2,9,11,18.2%,23m
45964,3,Slowpokeplay,2015,0,1,0,1,100.0%,1h
45964,3,BryanFury,2015,30,1,1,2,50.0%,1h
45964,3,Фартовый,2015,97,1,6,7,14.3%,15m
45964,2,Callistra,2015,0,0,1,1,0.0%,1h
45964,2,Adil,2015,0,0,2,2,0.0%,1h
45964,3,Matze,2015,0,0,6,6,0.0%,1h
45987,2,CyberpunkVx,2014,1242,77,93,170,45.3%,30m
45987,3,Roland,2014,1236,57,54,111,51.4%,1h
45987,3,Evomosk,2014,951,52,49,101,51.5%,1h
45987,1,Dimasia,2014,920,33,42,75,44.0%,33m
45987,2,OisyMcCain,2014,862,31,36,67,46.3%,1h
45987,2,ILX,2014,576,20,28,48,41.7%,21m
45987,2,Rutek,2014,450,16,21,37,43.2%,26m
45987,2,Amit,2014,447,16,25,41,39.0%,32m
45987,2,Daliat,2014,315,14,12,26,53.8%,30m
45987,3,[zsír]hukkle,2014,364,13,10,23,56.5%,1h
45987,3,[AhAh]Clemenceau,2014,172,7,6,13,53.8%,15m
45987,1,Kost,2014,346,7,11,18,38.9%,17m
45987,3,STARBUCKS,2014,0,4,1,5,80.0%,1h
45987,2,[FMGF]Niko,2014,92,3,4,7,42.9%,1h
45987,2,Wowka,2014,158,3,6,9,33.3%,20m
45987,3,[Specii]Samurai,2014,58,2,1,3,66.7%,16m
45987,1,[ch0b0]ambidexi,2014,94,2,7,9,22.2%,1h
45987,1,seryscvarc,2014,97,2,8,10,20.0%,1h
45987,2,Nexus,2014,111,2,8,10,20.0%,1h
45987,2,Aurumъ,2014,62,2,11,13,15.4%,15m
45987,3,Tetriz,2014,0,1,0,1,100.0%,1h
45987,3,joNu,2014,36,1,1,2,50.0%,26m
45987,3,DarkMatter,2014,30,1,2,3,33.3%,29m
45987,2,Cosa,2014,0,1,5,6,16.7%,1h
45987,3,Nokieka,2014,38,1,6,7,14.3%,29m
45987,2,ArLuksus,2014,0,1,7,8,12.5%,1h
45987,3,[DTCz]altéra,2014,0,0,1,1,0.0%,1h
45987,3,[OmDi]Erd,2014,0,0,2,2,0.0%,1h
45987,3,lone,2014,0,0,4,4,0.0%,1h
45987,3,JanOve,2014,0,0,6,6,0.0%,8m
46017,2,ТвойБатя,2013,1561,491,509,1000,49.1%,34m
46017,1,Soedjono,2013,1330,338,347,685,49.3%,1h
46017,1,Hummusider,2013,1605,296,315,611,48.4%,1h
46017,2,DrRoots,2013,1476,121,126,247,49.0%,26m
46017,3,Inda,2013,1245,90,100,190,47.4%,1h
46017,3,Rogan,2013,1378,59,61,120,49.2%,14m
46017,2,Diplomaster,2013,945,42,45,87,48.3%,1h
46017,3,Skrise,2013,482,30,31,61,49.2%,20m
46017,2,CrovidXX,2013,750,28,30,58,48.3%,1h
46017,3,DarkFire,2013,608,26,20,46,56.5%,20m
46017,2,dsded,2013,483,20,16,36,55.6%,15m
46017,3,SilverFox,2013,476,18,8,26,69.2%,34m
46017,2,LePhallusdOr,2013,380,14,24,38,36.8%,1h
46017,3,Marculius,2013,335,12,17,29,41.4%,24m
46017,1,[ATOM]stekviktor,2013,348,11,14,25,44.0%,1h
46017,1,Shelby,2013,302,8,18,26,30.8%,7m
46017,3,RoscanAlex,2013,200,7,8,15,46.7%,1h
46017,3,HideOnVoid,2013,216,7,11,18,38.9%,1h
46017,1,SnegoBOB,2013,239,6,5,11,54.5%,5m
46017,3,CheesyChees,2013,148,6,8,14,42.9%,25m
46017,1,Jack,2013,149,5,1,6,83.3%,26m
46017,3,viganauser,2013,194,5,7,12,41.7%,1h
46017,2,RICO,2013,90,3,11,14,21.4%,28m
46017,2,lelemento,2013,99,2,8,10,20.0%,29m
46017,3,Madmanny,2013,42,1,7,8,12.5%,29m
46017,2,PinscherKill,2013,88,1,7,8,12.5%,15m
46017,2,ShnecK,2013,30,1,7,8,12.5%,5m
46017,2,biofitis,2013,94,1,7,8,12.5%,1h
46017,2,Refa,2013,0,1,7,8,12.5%,23m
46017,3,[NBLTY]ULTBadass,2013,0,0,1,1,0.0%,14m
46017,3,pankracy,2013,0,0,1,1,0.0%,1h
46017,3,nndps,2013,0,0,2,2,0.0%,1h
46017,3,mufafa,2013,0,0,2,2,0.0%,17m
46017,3,Родион,2013,0,0,3,3,0.0%,1h
46051,2,Стикс,2012,1619,195,204,399,48.9%,1h
46051,3,Pierre,2012,1549,79,73,152,52.0%,1h
46051,2,mortarion,2012,607,43,43,86,50.0%,31m
46051,2,[RеG]diablaid,2012,925,34,41,75,45.3%,1h
46051,3,Claudio,2012,876,31,34,65,47.7%,29m
46051,2,SideraITAG,2012,664,29,22,51,56.9%,1h
46051,2,CheeseLord,2012,404,25,29,54,46.3%,28m
46051,3,gromoshot,2012,623,24,21,45,53.3%,1h
46051,3,Dementer,2012,582,20,30,50,40.0%,13m
46051,1,noTuesday,2012,536,18,29,47,38.3%,1h
46051,2,Goshavlk,2012,394,14,23,37,37.8%,1h
46051,3,Jasiek,2012,268,10,11,21,47.6%,1h
46051,3,Hadji,2012,270,10,15,25,40.0%,27m
46051,3,Azazel,2012,224,7,7,14,50.0%,16m
46051,3,stalker,2012,138,6,4,10,60.0%,1h
46051,1,Brinkmann,2012,244,5,15,20,25.0%,9m
46051,3,[DUSH]POTNEX,2012,90,4,4,8,50.0%,25m
46051,2,Vibo,2012,116,3,5,8,37.5%,1h
46051,2,Zmar,2012,106,3,9,12,25.0%,1h
46051,3,Juggernaut,2012,42,2,4,6,33.3%,1h
46051,3,Ninjamuse,2012,0,1,0,1,100.0%,1h
46051,2,Bebert,2012,46,1,3,4,25.0%,29m
46051,1,ToniMontana,2012,0,0,1,1,0.0%,1h
46051,2,Micman,2012,0,0,2,2,0.0%,1h
46051,3,nano,2012,0,0,6,6,0.0%,1h
46076,2,Milek,2011,1539,184,186,370,49.7%,1h
46076,2,Lulu,2011,1542,92,99,191,48.2%,5m
46076,3,yogsototh,2011,1430,57,69,126,45.2%,12m
46076,3,Médivac,2011,1313,54,73,127,42.5%,1h
46076,3,MelchiorLord,2011,340,13,10,23,56.5%,31m
46076,3,Robert,2011,310,11,14,25,44.0%,9m
46076,3,kokonotz,2011,244,9,19,28,32.1%,1h
46076,3,Анвар,2011,206,8,10,18,44.4%,1h
46076,1,[BNCREW]Civa,2011,303,8,15,23,34.8%,11m
46076,1,PrehDathoR,2011,170,6,14,20,30.0%,21m
46076,3,spacegoat,2011,104,5,4,9,55.6%,1h
46076,2,ketjow,2011,90,5,8,13,38.5%,32m
46076,1,patriOt,2011,168,4,6,10,40.0%,1h
46076,3,[VP33]MACA,2011,88,3,3,6,50.0%,4m
46076,3,SockPuppets,2011,94,2,10,12,16.7%,24m
46076,2,Krusty,2011,46,2,10,12,16.7%,1h
46076,2,Atmos,2011,97,1,5,6,16.7%,1h
46076,3,Olgon,2011,97,1,7,8,12.5%,1h
46076,3,Charaz,2011,0,0,1,1,0.0%,12m
46076,2,irkezik,2011,0,0,1,1,0.0%,18m
46076,2,zazvsp,2011,0,0,1,1,0.0%,5m
46076,3,Nysumo,2011,0,0,2,2,0.0%,1h
46076,2,BOROC,2011,0,0,3,3,0.0%,15m
46076,3,[хмкт]ХмурыйКот,2011,0,0,5,5,0.0%,1h
46076,2,Basajev,2011,0,0,6,6,0.0%,1h
46101,1,shubbydoo,2010,1136,74,74,148,50.0%,1h
46101,3,Ivan,2010,1171,69,71,140,49.3%,20m
46101,3,alin,2010,1534,68,68,136,50.0%,34m
46101,2,Diablos,2010,1539,62,66,128,48.4%,24m
46101,2,[HEROX]Jleyher,2010,1092,52,60,112,46.4%,1h
46101,3,Dagobert,2010,1102,41,41,82,50.0%,1h
46101,3,NoName,2010,730,26,26,52,50.0%,1h
46101,2,SPOWN,2010,548,19,20,39,48.7%,1h
46101,3,[JaPP]Астарот,2010,418,16,15,31,51.6%,1h
46101,1,[NVRGUP]Miziq,2010,440,16,24,40,40.0%,14m
46101,3,Destroyer,2010,272,14,5,19,73.7%,31m
46101,1,Palmeya,2010,383,12,27,39,30.8%,1h
46101,2,Uniqwind,2010,194,9,23,32,28.1%,12m
46101,3,Danatol,2010,138,5,5,10,50.0%,1h
46101,2,ToppeR,2010,90,4,8,12,33.3%,32m
46101,2,DAYAD,2010,60,2,8,10,20.0%,1h
46101,2,Kaos,2010,0,1,0,1,100.0%,20m
46101,3,Whitest,2010,0,1,0,1,100.0%,27m
46101,3,Drizzel,2010,34,1,2,3,33.3%,14m
46101,2,rochal,2010,0,1,6,7,14.3%,18m
46101,3,Schuffie,2010,34,1,7,8,12.5%,1h
46101,1,PriceWoods,2010,0,1,8,9,11.1%,15m
46101,3,Algatron,2010,0,0,1,1,0.0%,1h
46101,3,cyril,2010,0,0,1,1,0.0%,16m
46101,3,[99999]димон,2010,0,0,1,1,0.0%,11m
46126,2,petak,2009,1582,102,110,212,48.1%,6m
46126,2,RedViper,2009,1346,102,115,217,47.0%,1h
46126,2,[Torba]Hunter,2009,622,100,118,218,45.9%,5m
46126,3,Nhektor,2009,806,28,45,73,38.4%,16m
46126,3,DeathMEat,2009,584,24,25,49,49.0%,24m
46126,3,admiraalbeer,2009,405,14,9,23,60.9%,1h
46126,3,Pulsar,2009,297,9,5,14,64.3%,1h
46126,3,sandwich,2009,216,7,11,18,38.9%,11m
46126,3,[xEvilx]svwer,2009,146,6,10,16,37.5%,22m
46126,3,[OmDi]Nabak,2009,150,5,7,12,41.7%,22m
46126,1,Fallen,2009,0,1,0,1,100.0%,8m
46126,3,evrIka,2009,30,1,1,2,50.0%,31m
46126,1,Danielord,2009,0,1,7,8,12.5%,12m
46126,2,[ZUBS]Freedge,2009,0,0,1,1,0.0%,1h
46126,3,[N7TKKD]Dimidrol,2009,0,0,1,1,0.0%,11m
46126,2,Warden,2009,0,0,1,1,0.0%,4m
46126,2,Alex,2009,0,0,1,1,0.0%,20m
46126,3,NOD,2009,0,0,1,1,0.0%,16m
46126,2,Тима,2009,0,0,3,3,0.0%,27m
46145,2,[ANREN]maruda,2008,1565,171,185,356,48.0%,1h
46145,3,[palats]Orry,2008,637,23,25,48,47.9%,11m
46145,2,[4323]posA,2008,402,13,23,36,36.1%,11m
46145,3,MrShon,2008,291,12,8,20,60.0%,1h
46145,3,[JaPP]XaZoR,2008,405,12,13,25,48.0%,12m
46145,1,Voo,2008,266,8,15,23,34.8%,10m
46145,3,Fakron,2008,100,3,3,6,50.0%,1h
46145,2,VIGITAL,2008,60,3,13,16,18.8%,32m
46145,1,Remman,2008,48,1,6,7,14.3%,1h
46145,2,Мэй,2008,0,1,6,7,14.3%,1h
46145,1,Corvin,2008,0,1,8,9,11.1%,1h
46145,2,lakerson,2008,97,1,11,12,8.3%,1h
46145,2,Bigbaby,2008,0,0,1,1,0.0%,1h
46145,3,[nWss]КОЛУН,2008,0,0,1,1,0.0%,1h
46145,2,GITSL,2008,0,0,2,2,0.0%,1h
46145,2,каратель,2008,0,0,3,3,0.0%,1h
46145,2,Artorios,2008,0,0,6,6,0.0%,1h
46162,3,freshmeat,2007,1611,233,258,491,47.5%,1h
46162,3,zoix,2007,1546,151,153,304,49.7%,25m
46162,2,GromozeKa,2007,583,58,66,124,46.8%,14m
46162,1,Василий,2007,1514,53,70,123,43.1%,1h
46162,2,Ovid,2007,954,34,40,74,45.9%,1h
46162,2,Unico,2007,524,19,23,42,45.2%,20m
46162,3,JROBA,2007,396,13,11,24,54.2%,22m
46162,2,Boro,2007,272,13,17,30,43.3%,1h
46162,3,Eduviteri,2007,228,12,8,20,60.0%,28m
46162,1,Tiromir,2007,330,10,14,24,41.7%,33m
46162,2,Schweppes,2007,289,10,17,27,37.0%,29m
46162,2,[0MGz]YTOP,2007,235,7,10,17,41.2%,1h
46162,1,AquilaGold,2007,146,7,10,17,41.2%,1h
46162,3,AlexanderIII,2007,140,5,3,8,62.5%,9m
46162,3,Coen,2007,0,4,2,6,66.7%,32m
46162,2,Honza,2007,140,4,15,19,21.1%,26m
46162,3,Maff,2007,60,3,5,8,37.5%,1h
46162,3,Neko,2007,92,3,6,9,33.3%,1h
46162,2,[CGEO]Tirorero,2007,92,3,9,12,25.0%,21m
46162,3,Peter,2007,60,2,4,6,33.3%,1h
46162,3,jannu,2007,95,2,9,11,18.2%,1h
46162,2,pharrukh,2007,138,2,9,11,18.2%,1h
46162,2,Xavv,2007,123,2,11,13,15.4%,14m
46162,3,[Мульт]макс,2007,92,1,1,2,50.0%,24m
46162,3,DuRo,2007,38,1,1,2,50.0%,1h
46162,3,TudorBot,2007,30,1,6,7,14.3%,1h
46162,2,Вася,2007,0,1,8,9,11.1%,29m
46162,3,[Wowz]Hemp,2007,0,0,1,1,0.0%,1h
46162,3,Dajegianni,2007,0,0,1,1,0.0%,1h
46162,2,[MG2K]AVGadmin,2007,0,0,4,4,0.0%,1h
46192,1,AzzieElbub,2006,1308,69,89,158,43.7%,1h
46192,3,FlorisSaurus,2006,497,59,69,128,46.1%,1h
46192,2,zoidberg,2006,1365,51,53,104,49.0%,1h
46192,3,ЕСКАДРОНБГ,2006,1182,45,41,86,52.3%,15m
46192,3,DeZeRtiR,2006,994,37,42,79,46.8%,1h
46192,2,dibji,2006,611,21,29,50,42.0%,1h
46192,3,Cronos,2006,290,20,20,40,50.0%,15m
46192,3,Kwad,2006,526,18,24,42,42.9%,1h
46192,3,Mik,2006,443,15,20,35,42.9%,26m
46192,3,[Smarty]SeregaL,2006,284,11,11,22,50.0%,1h
46192,3,Santimeters,2006,305,10,19,29,34.5%,1h
46192,3,Renexxx,2006,252,7,15,22,31.8%,1h
46192,2,lagwal,2006,212,7,16,23,30.4%,14m
46192,1,Merzh,2006,190,6,6,12,50.0%,1h
46192,3,Haosit,2006,175,4,9,13,30.8%,9m
46192,2,Демон,2006,60,3,5,8,37.5%,1h
46192,1,Kazaam,2006,145,3,10,13,23.1%,1h
46192,2,Dillinger,2006,92,3,10,13,23.1%,23m
46192,3,Timetoshine,2006,30,2,0,2,100.0%,1h
46192,3,Tib,2006,60,2,5,7,28.6%,12m
46192,3,Lorenzo,2006,30,1,1,2,50.0%,34m
46192,3,inferno,2006,0,0,1,1,0.0%,4m
46192,3,Master,2006,0,0,1,1,0.0%,1h
46192,3,muffin,2006,0,0,2,2,0.0%,17m
46216,2,HuberTuss,2005,1597,386,413,799,48.3%,1h
46216,3,Bigcsaba,2005,664,25,25,50,50.0%,29m
46216,2,druzaza,2005,500,18,21,39,46.2%,31m
46216,2,Wooden,2005,174,9,11,20,45.0%,1h
46216,2,XPretorian,2005,242,8,15,23,34.8%,1h
46216,2,[SkyB]RohbauReiner,2005,210,7,14,21,33.3%,1h
46216,1,[HyCl]LAsT,2005,60,5,12,17,29.4%,1h
46216,2,Гримм,2005,90,4,8,12,33.3%,34m
46216,3,KORKYNOV,2005,88,3,4,7,42.9%,14m
46216,3,nashaRUSSIA,2005,88,3,5,8,37.5%,17m
46216,3,Maiden,2005,119,3,6,9,33.3%,13m
46216,2,[SPFE]FreeDyc,2005,88,2,0,2,100.0%,17m
46216,3,[зерно]KibeRPanc,2005,60,2,5,7,28.6%,1h
46216,2,Breeze,2005,94,2,10,12,16.7%,20m
46216,3,JDB,2005,124,2,11,13,15.4%,1h
46216,3,LibertyChimp,2005,0,1,0,1,100.0%,1h
46216,3,[CHOPAA]SEMENKORNEEV,2005,0,1,0,1,100.0%,11m
46216,3,[Pisyn]KROMSATEL,2005,30,1,1,2,50.0%,1h
46216,3,XoOTTOoX,2005,34,1,1,2,50.0%,1h
46216,3,tag,2005,0,1,2,3,33.3%,31m
46216,3,Yoka,2005,0,0,2,2,0.0%,6m
46216,2,Sevil,2005,0,0,2,2,0.0%,1h
46216,3,Fuel,2005,0,0,2,2,0.0%,8m
46216,3,[dddd3]Lordan,2005,0,0,2,2,0.0%,1h
46216,3,Voiddd,2005,0,0,5,5,0.0%,1h
46216,3,DeadNinjaX,2005,0,0,6,6,0.0%,1h
46242,3,KosKillGR,2004,569,32,40,72,44.4%,11m
46242,2,Blast,2004,433,15,20,35,42.9%,19m
46242,2,ArtesFog,2004,304,13,13,26,50.0%,1h
46242,2,KRHHHHHHH,2004,390,13,22,35,37.1%,1h
46242,3,eisschock,2004,242,9,10,19,47.4%,1h
46242,3,[C00I]AKCoolo,2004,246,7,16,23,30.4%,34m
46242,3,OniXX,2004,171,4,7,11,36.4%,34m
46242,2,SleepyGaunt,2004,114,4,8,12,33.3%,30m
46242,3,ХАН,2004,116,4,9,13,30.8%,1h
46242,2,[Папик]РэперНотМи,2004,275,4,30,34,11.8%,1h
46242,3,AlexRo,2004,58,3,1,4,75.0%,1h
46242,1,ChilliWilli,2004,142,3,5,8,37.5%,1h
46242,3,MrBreaker,2004,30,2,3,5,40.0%,1h
46242,3,ChinChopa,2004,60,2,7,9,22.2%,11m
46242,1,XhyroFalcon,2004,0,1,7,8,12.5%,1h
46242,3,Аюр,2004,0,0,6,6,0.0%,1h
46258,3,Ajka,2003,1579,88,100,188,46.8%,1h
46258,2,ergol,2003,1060,38,41,79,48.1%,29m
46258,3,Dreamno,2003,418,15,12,27,55.6%,1h
46258,3,RitterSport,2003,331,13,9,22,59.1%,26m
46258,2,[telka]telka,2003,321,11,14,25,44.0%,1h
46258,2,TsekNaaiers,2003,318,11,19,30,36.7%,26m
46258,3,alsid,2003,214,8,10,18,44.4%,6m
46258,3,[MynFre]Panzerbille,2003,146,5,6,11,45.5%,28m
46258,1,Cookie,2003,236,5,10,15,33.3%,26m
46258,2,Salmo,2003,116,4,5,9,44.4%,1h
46258,3,Sharu,2003,88,3,2,5,60.0%,1h
46258,3,Fire,2003,152,3,8,11,27.3%,1h
46258,3,Livinator,2003,60,2,7,9,22.2%,1h
46258,2,KobraKai,2003,137,2,8,10,20.0%,20m
46258,3,ZAKLEPAN,2003,0,1,0,1,100.0%,1h
46258,2,[NukeZ]DarkenersNEO,2003,0,1,3,4,25.0%,1h
46258,2,wip,2003,0,0,1,1,0.0%,17m
46258,2,Uga,2003,0,0,1,1,0.0%,1h
46258,3,Furio,2003,0,0,2,2,0.0%,1h
46258,1,Thibthib,2003,0,0,4,4,0.0%,1h
46278,1,vavache,2002,1602,72,88,160,45.0%,15m
46278,2,Armendino,2002,1101,64,76,140,45.7%,1h
46278,3,[Jail]MarkoCRO,2002,920,58,72,130,44.6%,1h
46278,2,MagaDEF,2002,1167,52,63,115,45.2%,33m
46278,3,Gaston,2002,1162,43,45,88,48.9%,1h
46278,3,DIMAPIDORASS,2002,1051,40,40,80,50.0%,4m
46278,2,[СИЛА]puspikt,2002,702,26,31,57,45.6%,28m
46278,2,baloo,2002,334,14,13,27,51.9%,14m
46278,2,SNiTE,2002,198,8,14,22,36.4%,12m
46278,3,inkvizitor,2002,178,6,9,15,40.0%,1h
46278,3,Nicholas,2002,178,6,10,16,37.5%,1h
46278,3,Theq,2002,152,5,5,10,50.0%,1h
46278,2,Odium,2002,156,5,11,16,31.2%,12m
46278,1,Bixi,2002,187,4,2,6,66.7%,27m
46278,3,Crach,2002,114,4,4,8,50.0%,1h
46278,3,Legba,2002,90,4,6,10,40.0%,25m
46278,1,HellbirdIV,2002,104,3,14,17,17.6%,1h
46278,3,Vladweider,2002,0,2,4,6,33.3%,31m
46278,3,Lanfear,2002,0,1,1,2,50.0%,11m
46278,3,Monk,2002,96,1,3,4,25.0%,1h
46278,3,Nemesis,2002,30,1,4,5,20.0%,1h
46278,1,[Cubers]Деффка,2002,0,1,5,6,16.7%,14m
46278,3,ThatTommyM,2002,0,0,1,1,0.0%,22m
46278,2,Jupiter,2002,0,0,1,1,0.0%,20m
46302,1,BobJones,2001,1422,161,190,351,45.9%,1h
46302,1,[13NRV]xXJIMBOXx,2001,989,72,72,144,50.0%,17m
46302,2,dantess,2001,1545,62,71,133,46.6%,34m
46302,1,stelinkov,2001,679,34,41,75,45.3%,1h
46302,2,Oleja,2001,476,19,20,39,48.7%,29m
46302,2,[SanPL]crq,2001,543,18,23,41,43.9%,14m
46302,1,AboutTime,2001,474,15,26,41,36.6%,16m
46302,1,MrTauri,2001,346,12,15,27,44.4%,4m
46302,3,Atheh,2001,306,11,13,24,45.8%,7m
46302,3,Vakh,2001,324,10,8,18,55.6%,1h
46302,3,DedBulachnik,2001,257,9,3,12,75.0%,31m
46302,2,MroźnyGnat,2001,193,6,9,15,40.0%,1h
46302,1,ödu,2001,219,5,8,13,38.5%,15m
46302,2,[Derpt]трататашка,2001,96,4,5,9,44.4%,17m
46302,3,Stahlhoden,2001,90,4,6,10,40.0%,1h
46302,3,ForTac,2001,122,4,9,13,30.8%,17m
46302,3,BrokenHeart,2001,60,3,3,6,50.0%,20m
46302,3,Nano,2001,90,3,8,11,27.3%,22m
46302,1,dogadaysya,2001,48,2,2,4,50.0%,12m
46302,1,Furan,2001,42,2,10,12,16.7%,1h
46302,2,YouLifeForSC,2001,44,1,1,2,50.0%,1h
46302,3,mulaka,2001,0,1,1,2,50.0%,1h
46302,3,MuadDib,2001,0,1,4,5,20.0%,12m
46302,3,[Pulco]zeratul,2001,0,0,1,1,0.0%,34m
46302,2,MTC,2001,0,0,1,1,0.0%,1h
46302,3,[Renega]Padeko,2001,0,0,1,1,0.0%,1h
46302,3,[Аоуэйя]kok,2001,0,0,2,2,0.0%,1h
46302,3,[AlDS]MegaTerra,2001,0,0,2,2,0.0%,1h
46302,3,bourbon,2001,0,0,2,2,0.0%,34m
46302,3,lauri,2001,0,0,3,3,0.0%,29m
46302,2,NIKOLA,2001,0,0,3,3,0.0%,1h
46302,2,Nallen,2001,0,0,5,5,0.0%,1h
46302,3,ДИАБЛО,2001,0,0,5,5,0.0%,8m
46335,3,Ice,2000,1169,49,51,100,49.0%,1h
46335,3,jonathanb,2000,422,18,19,37,48.6%,5m
46335,3,JBL,2000,502,18,20,38,47.4%,1h
46335,1,[xBBCx]Plato,2000,470,17,23,40,42.5%,1h
46335,2,unitslost,2000,500,17,30,47,36.2%,19m
46335,3,SneakyMidget,2000,248,16,19,35,45.7%,11m
46335,1,WOLVARINE,2000,367,11,18,29,37.9%,1h
46335,3,SwissDart,2000,116,4,3,7,57.1%,4m
46335,2,GhostDog,2000,30,4,5,9,44.4%,14m
46335,3,[SNAV]xena,2000,118,4,6,10,40.0%,15m
46335,2,GRANDMAX,2000,0,3,6,9,33.3%,1h
46335,2,[ZBANI]ERAY,2000,143,3,9,12,25.0%,13m
46335,2,TheTestedOne,2000,90,3,11,14,21.4%,21m
46335,2,AHGformatC,2000,0,1,0,1,100.0%,1h
46335,3,Dogwar,2000,0,1,1,2,50.0%,29m
46335,2,[Aple]AmilyStoun,2000,97,1,2,3,33.3%,12m
46335,2,EazyVillain,2000,88,1,6,7,14.3%,15m
46335,2,Marielemili,2000,48,1,9,10,10.0%,29m
46335,3,stefk,2000,0,0,1,1,0.0%,26m
46335,3,larsschnin,2000,0,0,3,3,0.0%,1h
46335,3,Snyx,2000,0,0,6,6,0.0%,5m
46356,2,SirJuri,1999,1362,104,113,217,47.9%,30m
46356,2,Maegar,1999,1540,99,106,205,48.3%,1h
46356,1,[GROF]hellas,1999,1610,74,87,161,46.0%,1h
46356,2,epsilon,1999,926,65,71,136,47.8%,19m
46356,2,[O4FUN]Rafcio,1999,1010,38,40,78,48.7%,1h
46356,2,dizzel,1999,236,8,13,21,38.1%,1h
46356,1,iadaci,1999,130,7,9,16,43.8%,1h
46356,3,Noirazan,1999,124,5,7,12,41.7%,12m
46356,3,NaZGuL,1999,114,4,2,6,66.7%,1h
46356,1,артём,1999,0,3,4,7,42.9%,21m
46356,1,[GsAUEt]ragnaros,1999,145,3,8,11,27.3%,12m
46356,1,darkSpirits,1999,48,2,2,4,50.0%,1h
46356,1,[Foki]НЕозабоченый,1999,144,2,6,8,25.0%,18m
46356,3,Chestnut,1999,118,2,7,9,22.2%,16m
46356,3,Pletzer,1999,0,1,1,2,50.0%,1h
46356,1,[qul1]Vacci,1999,36,1,4,5,20.0%,1h
46356,3,PitFiend,1999,30,1,5,6,16.7%,11m
46356,3,inSame,1999,0,0,1,1,0.0%,25m
46356,2,моралес,1999,0,0,2,2,0.0%,1h
46356,3,Amadeusz,1999,0,0,5,5,0.0%,1h
46376,3,BrownWing,1998,1582,267,294,561,47.6%,1h
46376,3,CadIOOO,1998,1601,129,134,263,49.0%,1h
46376,2,[mfxed]Mistrzakos,1998,1523,88,94,182,48.4%,1h
46376,2,CCN,1998,1222,66,71,137,48.2%,19m
46376,2,еммДрасте,1998,785,34,27,61,55.7%,1h
46376,2,Kichou,1998,909,31,36,67,46.3%,31m
46376,3,OMEGANxOFFIC,1998,652,29,23,52,55.8%,7m
46376,2,Chronos,1998,874,29,37,66,43.9%,21m
46376,3,Griv,1998,733,27,29,56,48.2%,14m
46376,3,Mawaro,1998,510,23,19,42,54.8%,11m
46376,2,EvenLonger,1998,290,13,19,32,40.6%,1h
46376,3,Kazeroo,1998,134,12,11,23,52.2%,20m
46376,3,drollShark,1998,328,11,7,18,61.1%,11m
46376,3,Rompek,1998,279,9,11,20,45.0%,34m
46376,1,Osiris,1998,162,6,14,20,30.0%,1h
46376,1,Rixifox,1998,172,5,10,15,33.3%,7m
46376,3,DeadPoulp,1998,88,4,7,11,36.4%,31m
46376,3,sergiwin,1998,94,4,14,18,22.2%,14m
46376,3,[Wylew]SMQ,1998,88,3,6,9,33.3%,1h
46376,1,Wirmat,1998,48,2,1,3,66.7%,11m
46376,2,retuil,1998,114,2,8,10,20.0%,1h
46376,1,Baselisque,1998,0,1,8,9,11.1%,1h
46376,3,EDDDDDDDDDDD,1998,0,0,1,1,0.0%,1h
46376,3,Realoner,1998,0,0,1,1,0.0%,25m
46376,2,GeneralPffft,1998,0,0,2,2,0.0%,1h
46376,3,kostyakan,1998,0,0,5,5,0.0%,14m
46376,2,Busterenko,1998,0,0,6,6,0.0%,34m
46403,3,Alexyno,1997,1424,91,96,187,48.7%,29m
46403,2,Вадим,1997,836,37,50,87,42.5%,13m
46403,2,Recoba,1997,716,27,39,66,40.9%,1h
46403,3,[Cancro]snoopiu,1997,505,21,17,38,55.3%,1h
46403,2,Dio,1997,338,15,16,31,48.4%,28m
46403,2,caribenyo,1997,310,14,13,27,51.9%,1h
46403,2,NeolYx,1997,240,9,17,26,34.6%,28m
46403,3,Pyre,1997,238,7,4,11,63.6%,12m
46403,2,Dark,1997,234,7,10,17,41.2%,1h
46403,1,NinjaRobot,1997,213,7,11,18,38.9%,15m
46403,3,[4EK]Robotix,1997,148,6,4,10,60.0%,14m
46403,3,Marloon,1997,58,2,1,3,66.7%,12m
46403,2,okulist,1997,30,2,11,13,15.4%,25m
46403,3,zerggoter,1997,30,1,3,4,25.0%,31m
46403,2,Palpatin,1997,44,1,3,4,25.0%,1h
46403,2,Gustaff,1997,0,1,4,5,20.0%,15m
46403,3,Zauner,1997,96,1,5,6,16.7%,1h
46403,3,JotaroKujo,1997,42,1,7,8,12.5%,1h
46403,1,ViRuoSe,1997,0,1,10,11,9.1%,1h
46403,3,bobo,1997,0,0,1,1,0.0%,1h
46403,3,technetium,1997,0,0,1,1,0.0%,1h
46403,3,Makkalistre,1997,0,0,1,1,0.0%,1h
46403,3,Nesstk,1997,0,0,4,4,0.0%,1h
46403,2,rizo,1997,0,0,5,5,0.0%,28m
46403,3,TATTOOS,1997,0,0,5,5,0.0%,29m
46403,2,barnus,1997,0,0,6,6,0.0%,1h
46403,2,Haleem,1997,0,0,8,8,0.0%,1h
46430,3,LemonTree,1996,1569,143,164,307,46.6%,1h
46430,3,HappyPilot,1996,1209,47,52,99,47.5%,1h
46430,2,SaberRider,1996,1012,37,46,83,44.6%,1h
46430,2,BRO,1996,900,31,36,67,46.3%,1h
46430,3,DennyBoy,1996,692,22,30,52,42.3%,31m
46430,1,[Eryth]TacticalCat,1996,522,19,30,49,38.8%,8m
46430,3,KiNGSHiGEN,1996,130,6,18,24,25.0%,1h
46430,3,Icomeinpeace,1996,58,4,2,6,66.7%,1h
46430,1,[krishu]Shadow,1996,96,3,13,16,18.8%,1h
46430,3,enigma,1996,30,2,1,3,66.7%,1h
46430,3,Purzel,1996,48,2,4,6,33.3%,25m
46430,3,макс,1996,60,2,6,8,25.0%,1h
46430,2,Dry,1996,142,2,9,11,18.2%,1h
46430,2,Zambonie,1996,129,2,10,12,16.7%,1h
46430,3,Puffpin,1996,30,1,2,3,33.3%,14m
46430,2,ggt,1996,30,1,8,9,11.1%,30m
46430,3,Dzunior,1996,0,0,1,1,0.0%,1h
46430,3,YagamiLaght,1996,0,0,1,1,0.0%,29m
46430,3,MaximusB,1996,0,0,6,6,0.0%,1h
46430,2,Agoraht,1996,0,0,6,6,0.0%,21m
46430,3,Santiago,1996,0,0,7,7,0.0%,1h
46451,3,Max,1995,1260,48,48,96,50.0%,4m
46451,3,slaidsilver,1995,933,31,46,77,40.3%,31m
46451,2,Ostrog,1995,726,24,31,55,43.6%,11m
46451,3,kros,1995,567,22,20,42,52.4%,16m
46451,3,[Fansaf]Дед,1995,254,13,6,19,68.4%,6m
46451,2,jorge,1995,387,11,19,30,36.7%,29m
46451,3,Clown,1995,168,6,3,9,66.7%,1h
46451,1,adrleg,1995,252,6,14,20,30.0%,10m
46451,3,SilentStorm,1995,96,2,9,11,18.2%,16m
46451,1,RedNoise,1995,48,2,10,12,16.7%,4m
46451,2,AtiQs,1995,48,1,9,10,10.0%,12m
46451,3,Tutumortel,1995,0,0,1,1,0.0%,1h
46451,3,Enigma,1995,0,0,6,6,0.0%,1h
46464,2,ILIANDRO,1994,1528,67,64,131,51.1%,1h
46464,3,Einherjer,1994,1149,43,37,80,53.8%,34m
46464,3,[svinik]ArmoredRaven,1994,605,25,20,45,55.6%,26m
46464,3,[ERIC]Antiphrost,1994,348,14,12,26,53.8%,20m
46464,3,ApMǂTonton,1994,178,6,6,12,50.0%,1h
46464,2,Sebastian,1994,143,6,6,12,50.0%,33m
46464,3,Bensasa,1994,170,6,7,13,46.2%,1h
46464,3,Headbang,1994,90,4,4,8,50.0%,1h
46464,3,[CREPES]Loïc,1994,122,4,9,13,30.8%,1h
46464,3,DEstroyer,1994,58,3,2,5,60.0%,11m
46464,3,[OSB98]Gouda,1994,88,3,4,7,42.9%,1h
46464,3,[idntcr]happyt,1994,30,2,6,8,25.0%,1h
46464,3,GoLdsWiM,1994,0,1,0,1,100.0%,29m
46464,3,MOH,1994,0,1,0,1,100.0%,17m
46464,3,LoserCoolYT,1994,30,1,1,2,50.0%,17m
46464,3,[M62]Arasher,1994,0,1,2,3,33.3%,27m
46464,2,ElToro,1994,36,1,2,3,33.3%,1h
46464,2,MImi,1994,0,1,6,7,14.3%,1h
46464,2,Töminator,1994,0,1,6,7,14.3%,1h
46464,3,jompcore,1994,0,0,1,1,0.0%,1h
46464,3,DYAGILEV,1994,0,0,1,1,0.0%,16m
46464,3,McFly,1994,0,0,6,6,0.0%,29m
46486,2,[mfxed]teodozjusz,1993,1291,87,87,174,50.0%,1h
46486,3,Forgo,1993,1028,36,48,84,42.9%,5m
46486,2,merlin,1993,917,35,42,77,45.5%,21m
46486,2,SanczO,1993,522,35,43,78,44.9%,26m
46486,2,Efiox,1993,440,19,29,48,39.6%,11m
46486,3,Mateo,1993,401,18,24,42,42.9%,11m
46486,3,Virux,1993,309,13,9,22,59.1%,25m
46486,2,[BL79]Milkman,1993,231,13,14,27,48.1%,30m
46486,3,Shadow,1993,369,13,14,27,48.1%,1h
46486,3,UggOR,1993,293,10,6,16,62.5%,7m
46486,3,Bazil,1993,38,4,4,8,50.0%,14m
46486,3,Komar,1993,88,3,2,5,60.0%,1h
46486,3,Staś,1993,30,1,1,2,50.0%,9m
46486,3,NuBaRaXD,1993,30,1,3,4,25.0%,1h
46486,3,DozyRaccoon,1993,30,1,4,5,20.0%,1h
46486,3,Krolist,1993,0,0,1,1,0.0%,1h
46486,2,MEMO,1993,0,0,1,1,0.0%,1h
46486,3,Jeicoo,1993,0,0,3,3,0.0%,1h
46486,2,delatroch,1993,0,0,5,5,0.0%,33m
46505,1,NewB,1992,1616,290,307,597,48.6%,1h
46505,1,Gogamoor,1992,807,39,56,95,41.1%,11m
46505,2,Max,1992,801,37,42,79,46.8%,25m
46505,2,maverick,1992,604,20,32,52,38.5%,32m
46505,3,waze,1992,506,19,17,36,52.8%,1h
46505,2,SiloJopov,1992,380,12,18,30,40.0%,25m
46505,3,Sorin,1992,250,8,14,22,36.4%,1h
46505,1,TUNGUZ,1992,288,8,15,23,34.8%,6m
46505,2,Omni,1992,204,7,10,17,41.2%,26m
46505,1,LEDUP,1992,180,6,13,19,31.6%,6m
46505,1,Aleks,1992,279,6,14,20,30.0%,27m
46505,1,AlexanderK,1992,187,5,13,18,27.8%,26m
46505,3,ror,1992,146,4,2,6,66.7%,4m
46505,2,SystemError,1992,148,3,9,12,25.0%,1h
46505,3,sos,1992,58,2,2,4,50.0%,5m
46505,3,forgotten,1992,30,2,3,5,40.0%,1h
46505,3,Keks,1992,0,1,1,2,50.0%,1h
46505,2,Rammstein,1992,0,1,4,5,20.0%,29m
46505,2,drifthawk,1992,42,1,8,9,11.1%,21m
46505,2,[DiRE]ANTITROL,1992,46,1,10,11,9.1%,21m
46505,3,AnImAl,1992,0,0,1,1,0.0%,1h
46505,3,Stolt,1992,0,0,2,2,0.0%,1h
46505,3,Boris,1992,0,0,2,2,0.0%,1h
46505,3,Kuba,1992,0,0,6,6,0.0%,1h
46505,2,Aximas,1992,0,0,6,6,0.0%,1h
46530,2,Sinaps,1991,1412,161,172,333,48.3%,11m
46530,3,prohelari,1991,911,54,53,107,50.5%,31m
46530,1,Jacekaks,1991,1216,42,53,95,44.2%,1h
46530,2,cseigabe,1991,1043,38,38,76,50.0%,7m
46530,3,mrDIGriz,1991,894,30,45,75,40.0%,1h
46530,2,Gorillaz,1991,516,15,25,40,37.5%,19m
46530,2,ZERO,1991,442,14,25,39,35.9%,12m
46530,1,TheOldCrock,1991,184,6,14,20,30.0%,1h
46530,3,supernik,1991,30,3,10,13,23.1%,31m
46530,2,CheEzy,1991,86,2,1,3,66.7%,1h
46530,3,Ant,1991,0,1,0,1,100.0%,25m
46530,3,SteveG,1991,0,1,3,4,25.0%,17m
46530,2,Mattchaos,1991,0,1,7,8,12.5%,1h
46530,1,Fox,1991,0,1,7,8,12.5%,1h
46530,3,Edvaldas,1991,0,0,1,1,0.0%,16m
46530,3,Flip,1991,0,0,1,1,0.0%,4m
46530,3,ArtCraft,1991,0,0,1,1,0.0%,25m
46530,3,Denari,1991,0,0,1,1,0.0%,1h
46530,3,LichKing,1991,0,0,1,1,0.0%,1h
46530,3,SJW,1991,0,0,1,1,0.0%,11m
46530,3,MaLoU,1991,0,0,2,2,0.0%,27m
46530,3,Wegi,1991,0,0,5,5,0.0%,1h
46530,3,Phoenixkdd,1991,0,0,6,6,0.0%,8m
46530,3,Max,1991,0,0,6,6,0.0%,10m
46554,2,PeteyDeLacy,1990,1551,131,140,271,48.3%,15m
46554,2,Piedro,1990,485,40,46,86,46.5%,14m
46554,2,tonimarc,1990,876,34,41,75,45.3%,1h
46554,3,KaVeSMaN,1990,664,24,29,53,45.3%,1h
46554,2,Ketsa,1990,616,24,33,57,42.1%,29m
46554,3,Scuzzle,1990,490,15,16,31,48.4%,25m
46554,3,FavaroLeone,1990,384,14,18,32,43.8%,1h
46554,2,ShereRa,1990,204,10,12,22,45.5%,1h
46554,1,Багротирран,1990,269,8,16,24,33.3%,3m
46554,1,stefan,1990,212,6,13,19,31.6%,1h
46554,3,[Medan]Inyoka,1990,172,5,13,18,27.8%,1h
46554,3,Flap,1990,124,4,8,12,33.3%,28m
46554,3,Marmota,1990,0,3,1,4,75.0%,5m
46554,3,WArch,1990,58,2,3,5,40.0%,1h
46554,1,artemmm,1990,30,2,8,10,20.0%,6m
46554,1,Shootnik,1990,48,2,10,12,16.7%,1h
46554,3,ultima,1990,0,1,0,1,100.0%,1h
46554,3,[DR187]Pat,1990,0,1,0,1,100.0%,16m
46554,3,Lexx,1990,30,1,5,6,16.7%,23m
46554,3,[SProt]barcislaw,1990,34,1,7,8,12.5%,29m
46554,2,Wickerman,1990,97,1,8,9,11.1%,1h
46554,3,BlueBear,1990,0,0,1,1,0.0%,26m
46554,3,Vlad,1990,0,0,1,1,0.0%,29m
46554,3,FAUCHEUR,1990,0,0,5,5,0.0%,1h
46554,3,pitone,1990,0,0,6,6,0.0%,32m
46554,2,Destroyer,1990,0,0,6,6,0.0%,1h
46580,2,[WARPA2]CCCP,1989,1480,128,140,268,47.8%,32m
46580,2,adejongh,1989,1210,84,100,184,45.7%,31m
46580,2,Gossel,1989,1082,44,41,85,51.8%,1h
46580,3,metalika,1989,609,24,20,44,54.5%,1h
46580,3,MikeLitoris,1989,590,19,25,44,43.2%,20m
46580,3,xilluks,1989,408,15,13,28,53.6%,11m
46580,3,REfrigerator,1989,266,10,7,17,58.8%,23m
46580,3,Keiser,1989,277,10,16,26,38.5%,28m
46580,3,Trixta,1989,218,6,3,9,66.7%,1h
46580,3,Sakulainen,1989,85,5,4,9,55.6%,1h
46580,3,VAKLIC,1989,120,5,7,12,41.7%,1h
46580,3,Moons,1989,158,5,10,15,33.3%,1h
46580,3,Starik,1989,114,4,2,6,66.7%,1h
46580,3,Ganiball,1989,86,4,3,7,57.1%,15m
46580,2,redarmy,1989,94,4,10,14,28.6%,8m
46580,3,[EoNabs]NJim,1989,86,3,2,5,60.0%,20m
46580,3,ELWILY,1989,95,3,3,6,50.0%,1h
46580,1,Telephonist,1989,145,3,10,13,23.1%,1h
46580,3,[NWAro]Tavi,1989,97,2,0,2,100.0%,15m
46580,3,Akrum,1989,60,2,4,6,33.3%,29m
46580,2,[Тетере]Падре,1989,117,2,6,8,25.0%,1h
46580,2,FANTOM,1989,94,2,9,11,18.2%,1h
46580,3,[чух]Oxo,1989,0,1,0,1,100.0%,25m
46580,2,Mastercheff,1989,0,0,1,1,0.0%,6m
46580,3,proxyd,1989,0,0,1,1,0.0%,1h
46580,1,GanGen,1989,0,0,4,4,0.0%,9m
46580,3,mytheas,1989,0,0,6,6,0.0%,26m
46607,2,[BIllIG]JoeBlack,1988,1397,90,101,191,47.1%,1h
46607,3,[II3II]ххх,1988,1178,52,56,108,48.1%,17m
46607,2,boulickjr,1988,499,20,23,43,46.5%,32m
46607,3,TomTom,1988,517,16,26,42,38.1%,34m
46607,3,Grommash,1988,310,11,13,24,45.8%,26m
46607,3,Frederick,1988,324,11,16,27,40.7%,1h
46607,3,Thinh,1988,230,11,21,32,34.4%,11m
46607,3,DRONOXXX,1988,264,10,9,19,52.6%,1h
46607,2,Tatar,1988,290,10,17,27,37.0%,11m
46607,3,Bull,1988,298,9,9,18,50.0%,4m
46607,1,andruha,1988,170,7,15,22,31.8%,9m
46607,3,Ivanu,1988,114,5,1,6,83.3%,10m
46607,2,JoeDalton,1988,150,4,6,10,40.0%,18m
46607,2,Илья,1988,78,3,4,7,42.9%,1h
46607,2,CoolCod,1988,92,3,6,9,33.3%,1h
46607,3,Dorphus,1988,119,2,1,3,66.7%,26m
46607,3,dim,1988,58,2,3,5,40.0%,25m
46607,3,[GGZERG]BeshinyKot,1988,58,2,7,9,22.2%,1h
46607,1,Zengő,1988,48,2,10,12,16.7%,1h
46607,2,EUNF,1988,64,2,13,15,13.3%,34m
46607,3,Мирослав,1988,30,1,1,2,50.0%,11m
46607,2,EmuOcelot,1988,0,1,1,2,50.0%,1h
46607,2,saint,1988,48,1,6,7,14.3%,6m
46607,3,[ШОУМЕН]ЛюбительЧая,1988,0,0,1,1,0.0%,31m
46607,3,MMH,1988,0,0,1,1,0.0%,27m
46607,3,EvilUncle,1988,0,0,1,1,0.0%,1h
46607,3,[lOoKer]Max,1988,0,0,2,2,0.0%,31m
46607,3,PORSHE,1988,0,0,6,6,0.0%,8m
46635,2,Vulture,1987,1591,124,126,250,49.6%,32m
46635,1,stepsikMAG,1987,1334,117,118,235,49.8%,33m
46635,2,CatID,1987,1232,47,52,99,47.5%,29m
46635,3,[PowerG]MrWhocares,1987,483,19,11,30,63.3%,26m
46635,1,Impulsive,1987,502,14,26,40,35.0%,29m
46635,3,[MODRR]Pipol,1987,308,11,12,23,47.8%,1h
46635,2,Laci,1987,300,11,13,24,45.8%,1h
46635,3,CanBKN,1987,189,8,10,18,44.4%,29m
46635,3,Kain,1987,196,5,7,12,41.7%,22m
46635,3,CptSkipper,1987,122,5,7,12,41.7%,1h
46635,2,korbapa,1987,154,5,17,22,22.7%,1h
46635,1,Coockie,1987,66,3,11,14,21.4%,24m
46635,2,[SCRTV]BatON,1987,98,3,17,20,15.0%,22m
46635,3,Raferty,1987,30,2,0,2,100.0%,13m
46635,3,lagrunge,1987,30,2,4,6,33.3%,29m
46635,2,teer,1987,99,2,6,8,25.0%,23m
46635,1,[PGMR]Boltec,1987,0,2,10,12,16.7%,34m
46635,3,cylon,1987,36,1,3,4,25.0%,1h
46635,3,reCaRd,1987,0,0,1,1,0.0%,1h
46635,1,Nadziratel,1987,0,0,6,6,0.0%,1h
46635,3,JanoRDZ,1987,0,0,6,6,0.0%,1h
46635,3,Massive,1987,0,0,7,7,0.0%,32m
46657,3,Doomster,1986,607,22,26,48,45.8%,1h
46657,3,futrzak,1986,327,18,12,30,60.0%,1h
46657,2,[NucLea]ExperT,1986,514,18,23,41,43.9%,1h
46657,3,Manolo,1986,482,17,17,34,50.0%,1h
46657,2,Zifo,1986,494,17,19,36,47.2%,28m
46657,2,MulansFlame,1986,369,14,20,34,41.2%,1h
46657,1,rorodouze,1986,330,11,21,32,34.4%,9m
46657,2,DOOM,1986,254,8,12,20,40.0%,1h
46657,3,SergeyUA,1986,172,7,5,12,58.3%,1h
46657,2,ZEK,1986,182,7,10,17,41.2%,1h
46657,1,Shinix,1986,200,7,18,25,28.0%,31m
46657,3,Dork,1986,142,5,6,11,45.5%,1h
46657,1,[lkgg]MOMO,1986,144,4,12,16,25.0%,4m
46657,3,[K0RM2]Nidus,1986,58,3,2,5,60.0%,1h
46657,3,king,1986,0,2,1,3,66.7%,35m
46657,1,[AlDS]TheTryBay,1986,48,2,3,5,40.0%,27m
46657,3,[k1raen]Squiq,1986,0,1,2,3,33.3%,11m
46657,2,Kirill,1986,34,1,2,3,33.3%,17m
46657,3,Тимон,1986,30,1,2,3,33.3%,1h
46657,3,virginia,1986,0,0,1,1,0.0%,25m
46657,3,infiernon,1986,0,0,1,1,0.0%,1h
46657,1,Mordigan,1986,0,0,2,2,0.0%,15m
46657,3,Skykilla,1986,0,0,2,2,0.0%,1h
46657,2,[FTWWP]IVaNPaMuKa,1986,0,0,6,6,0.0%,1h
46681,2,Muadib,1985,1570,320,346,666,48.0%,1h
46681,2,Jonathan,1985,1363,84,89,173,48.6%,14m
46681,3,DarkRix,1985,1088,44,39,83,53.0%,10m
46681,3,bygdadyret,1985,832,33,34,67,49.3%,21m
46681,3,Valenok,1985,878,32,33,65,49.2%,9m
46681,3,Zabor,1985,862,32,39,71,45.1%,1h
46681,2,vad,1985,617,25,39,64,39.1%,1h
46681,3,robilad,1985,635,22,26,48,45.8%,34m
46681,3,Георгий,1985,556,21,21,42,50.0%,16m
46681,3,MACK,1985,420,17,17,34,50.0%,11m
46681,2,[oooboy]Krasser,1985,356,12,19,31,38.7%,19m
46681,3,Manfo,1985,247,12,21,33,36.4%,1h
46681,3,[XMAN]Odbee,1985,340,11,14,25,44.0%,1h
46681,3,ErImOtt,1985,214,8,6,14,57.1%,6m
46681,3,Asha,1985,38,3,3,6,50.0%,17m
46681,3,REDLINE,1985,62,2,5,7,28.6%,5m
46681,3,chromesxl,1985,62,2,5,7,28.6%,1h
46681,1,deadstar,1985,30,2,9,11,18.2%,1h
46681,3,Dan,1985,48,1,1,2,50.0%,1h
46681,3,Dworken,1985,30,1,7,8,12.5%,26m
46681,2,Mcgregor,1985,46,1,9,10,10.0%,21m
46681,3,[Eagle1]TheSplinter,1985,0,0,1,1,0.0%,31m
46681,3,Pops,1985,0,0,1,1,0.0%,1h
46681,3,Hati,1985,0,0,6,6,0.0%,1h
46681,2,Greenjuan,1985,0,0,6,6,0.0%,16m
46706,3,Paul,1984,997,57,63,120,47.5%,1h
46706,2,mero,1984,448,50,57,107,46.7%,17m
46706,2,Sergg,1984,560,19,28,47,40.4%,1h
46706,1,SvantE,1984,450,17,25,42,40.5%,1h
46706,1,Luidro,1984,181,5,11,16,31.2%,1h
46706,2,Sintorred,1984,132,3,9,12,25.0%,1h
46706,3,cruzer,1984,44,2,0,2,100.0%,1h
46706,2,Wortex,1984,130,2,7,9,22.2%,1h
46706,1,Mrszrak,1984,0,1,3,4,25.0%,1h
46706,1,Necro,1984,0,1,8,9,11.1%,16m
46706,3,Magnus,1984,0,0,1,1,0.0%,16m
46706,3,Victor,1984,0,0,1,1,0.0%,1h
46706,3,abro,1984,0,0,5,5,0.0%,26m
46706,3,Hache,1984,0,0,6,6,0.0%,1h
46706,3,rosied,1984,0,0,7,7,0.0%,12m
46721,2,Trip,1983,1384,83,86,169,49.1%,1h
46721,3,[galler]Tranch,1983,1590,63,74,137,46.0%,25m
46721,2,[Rus48]AlexTiger,1983,1234,44,55,99,44.4%,14m
46721,3,MrMiniMo,1983,640,23,23,46,50.0%,1h
46721,2,Hackezieher,1983,536,19,28,47,40.4%,1h
46721,2,maxonia,1983,432,16,21,37,43.2%,9m
46721,3,ROSTOHEKNUKI,1983,413,15,12,27,55.6%,34m
46721,1,Enx,1983,267,6,16,22,27.3%,17m
46721,1,sparrow,1983,140,5,12,17,29.4%,32m
46721,3,BenHun,1983,90,3,7,10,30.0%,4m
46721,3,MRT,1983,128,3,10,13,23.1%,14m
46721,2,Oxaanova,1983,92,3,10,13,23.1%,20m
46721,3,Viktorious,1983,116,3,10,13,23.1%,35m
46721,1,lukaszeden,1983,48,2,10,12,16.7%,1h
46721,3,[Днепр]Foebos,1983,30,1,1,2,50.0%,1h
46721,1,nobru,1983,97,1,2,3,33.3%,1h
46721,2,JakJu,1983,30,1,5,6,16.7%,21m
46721,3,Zockertiger,1983,44,1,7,8,12.5%,1h
46721,3,johnsonone,1983,0,0,1,1,0.0%,6m
46721,3,fitagor,1983,0,0,1,1,0.0%,12m
46721,3,Lalinek,1983,0,0,2,2,0.0%,1h
46721,3,Anton,1983,0,0,2,2,0.0%,14m
46721,1,Sentenza,1983,0,0,4,4,0.0%,34m
46721,3,PoWeR,1983,0,0,5,5,0.0%,14m
46721,3,Nikola,1983,0,0,6,6,0.0%,28m
46721,3,Anthagonist,1983,0,0,6,6,0.0%,13m
46747,2,[T3RLiB]WörstKäis,1982,1576,113,120,233,48.5%,1h
46747,2,Zerg,1982,1618,80,95,175,45.7%,28m
46747,3,Andryha,1982,1187,64,73,137,46.7%,1h
46747,3,thrasher,1982,1317,63,74,137,46.0%,1h
46747,2,[WUIL]Ovaron,1982,789,27,36,63,42.9%,25m
46747,2,Evgenii,1982,282,26,31,57,45.6%,14m
46747,3,SubaroVOD,1982,602,23,27,50,46.0%,1h
46747,3,MisterFresh,1982,584,21,27,48,43.8%,17m
46747,3,Sartubor,1982,516,18,22,40,45.0%,34m
46747,3,DemonWolf,1982,433,17,13,30,56.7%,1h
46747,2,WCas,1982,511,15,29,44,34.1%,1h
46747,2,KapJIeR,1982,332,14,13,27,51.9%,1h
46747,2,LORD,1982,352,12,21,33,36.4%,9m
46747,3,[AltReg]Loky,1982,317,10,21,31,32.3%,13m
46747,2,Viriatus,1982,175,8,5,13,61.5%,1h
46747,3,DedNoob,1982,251,8,17,25,32.0%,4m
46747,2,robert,1982,148,7,10,17,41.2%,24m
46747,3,Djoomba,1982,131,6,5,11,54.5%,1h
46747,2,Kildedal,1982,120,5,8,13,38.5%,21m
46747,2,джокер,1982,188,5,14,19,26.3%,1h
46747,2,Kyu,1982,88,4,10,14,28.6%,12m
46747,2,bombergamer,1982,132,4,12,16,25.0%,1h
46747,3,BARRAS,1982,88,3,3,6,50.0%,1h
46747,3,Florian,1982,90,3,4,7,42.9%,25m
46747,3,Bfourg,1982,86,3,9,12,25.0%,31m
46747,3,popcorn,1982,30,2,1,3,66.7%,27m
46747,3,Martin,1982,60,2,7,9,22.2%,9m
46747,1,Aquila,1982,44,2,10,12,16.7%,10m
46747,3,SilentSword,1982,0,1,1,2,50.0%,31m
46747,3,Suicide,1982,0,1,2,3,33.3%,1h
46747,3,MihailPrise,1982,0,1,2,3,33.3%,1h
46747,3,messia,1982,30,1,5,6,16.7%,25m
46747,3,[ANREN]anton,1982,0,0,1,1,0.0%,14m
46747,3,vladvolk,1982,0,0,2,2,0.0%,11m
46747,3,Dimriy,1982,0,0,6,6,0.0%,1h
46747,3,Nostro,1982,0,0,6,6,0.0%,1h
46783,2,Rehkt,1981,1507,193,205,398,48.5%,12m
46783,1,tonyvegas,1981,964,127,142,269,47.2%,1h
46783,3,Silvertass,1981,1246,48,56,104,46.2%,1h
46783,3,GLHF,1981,1046,39,34,73,53.4%,1h
46783,3,Prorok,1981,550,20,22,42,47.6%,1h
46783,3,Awerkwar,1981,354,13,11,24,54.2%,13m
46783,3,Fluctuoser,1981,237,8,6,14,57.1%,13m
46783,3,Priliand,1981,140,7,16,23,30.4%,9m
46783,2,[OkTM]MAJI,1981,88,3,6,9,33.3%,1h
46783,2,FireMan,1981,126,3,8,11,27.3%,1h
46783,3,garras,1981,30,2,2,4,50.0%,1h
46783,3,MaxAnd,1981,58,2,2,4,50.0%,22m
46783,3,PalleKuling,1981,30,2,5,7,28.6%,1h
46783,3,acidmetaltek,1981,30,1,1,2,50.0%,11m
46783,3,WarMan,1981,40,1,1,2,50.0%,1h
46783,3,NalydTG,1981,0,1,1,2,50.0%,1h
46783,2,rakso,1981,0,1,2,3,33.3%,1h
46783,1,Ironman,1981,0,1,2,3,33.3%,17m
46783,3,comandersex,1981,30,1,5,6,16.7%,22m
46783,3,Swarley,1981,97,1,5,6,16.7%,21m
46783,2,rAdcaL,1981,88,1,8,9,11.1%,1h
46783,3,gil,1981,0,0,1,1,0.0%,1h
46783,3,Megalovania,1981,0,0,1,1,0.0%,25m
46783,3,ItalianOil,1981,0,0,1,1,0.0%,13m
46783,3,afifou,1981,0,0,3,3,0.0%,1h
46783,3,GalaxyOnFire,1981,0,0,3,3,0.0%,1h
46783,3,Herpestes,1981,0,0,6,6,0.0%,1h
46783,2,PAULUS,1981,0,0,7,7,0.0%,1h
46811,2,vldvip,1980,1518,294,315,609,48.3%,1h
46811,3,Kitaby,1980,1350,55,54,109,50.5%,1h
46811,3,MAKMENDE,1980,1433,55,55,110,50.0%,29m
46811,2,decooos,1980,620,39,32,71,54.9%,1h
46811,3,CLON,1980,690,37,35,72,51.4%,13m
46811,1,DavidMajik,1980,1142,37,57,94,39.4%,1h
46811,3,[MSNTRP]Hexos,1980,730,36,35,71,50.7%,6m
46811,3,Electrozer,1980,714,25,34,59,42.4%,29m
46811,3,Denders,1980,627,21,34,55,38.2%,11m
46811,2,[SETAS]Javidralisco,1980,508,19,30,49,38.8%,11m
46811,3,Убица,1980,345,13,9,22,59.1%,14m
46811,3,Pumuckl,1980,318,12,17,29,41.4%,26m
46811,3,Silenther,1980,298,10,12,22,45.5%,1h
46811,3,ELFERP,1980,284,10,14,24,41.7%,14m
46811,1,[HUNSR]Doofface,1980,232,7,17,24,29.2%,1m
46811,3,KingDave,1980,197,5,4,9,55.6%,15m
46811,3,mobil,1980,117,5,8,13,38.5%,1h
46811,3,cstnn,1980,118,4,6,10,40.0%,1m
46811,3,[panno]human,1980,0,2,3,5,40.0%,29m
46811,3,[MayDie]Nekromant,1980,0,1,0,1,100.0%,1h
46811,3,PAXeke,1980,30,1,2,3,33.3%,14m
46811,1,Kinoman,1980,46,1,6,7,14.3%,15m
46811,3,Shneck,1980,21,1,6,7,14.3%,1h
46811,2,christopher,1980,30,1,8,9,11.1%,1h
46811,3,Rozkurwiacz,1980,0,0,1,1,0.0%,21m
46811,3,[Сold]Gleb,1980,0,0,1,1,0.0%,1h
46811,3,PPPPPPPPP,1980,0,0,1,1,0.0%,1h
46811,2,Maxd,1980,0,0,3,3,0.0%,26m
46811,2,mullumuhullu,1980,0,0,7,7,0.0%,1h
46840,3,Hope,1979,304,41,43,84,48.8%,1m
46840,2,MaxX,1979,981,39,50,89,43.8%,30m
46840,3,CILE,1979,547,22,22,44,50.0%,11m
46840,3,jan,1979,503,17,32,49,34.7%,1h
46840,3,SERG,1979,426,15,10,25,60.0%,1h
46840,3,asilylmz,1979,422,15,17,32,46.9%,1h
46840,3,hugh,1979,380,14,8,22,63.6%,32m
46840,2,Delby,1979,364,14,25,39,35.9%,1h
46840,3,EuhhInternet,1979,362,12,16,28,42.9%,1h
46840,3,[sonic1]фаталтактик,1979,289,9,8,17,52.9%,1h
46840,3,DAA,1979,232,9,8,17,52.9%,1h
46840,1,boalord,1979,192,5,17,22,22.7%,1h
46840,3,yalissea,1979,122,4,7,11,36.4%,25m
46840,3,[noоb]GappeR,1979,92,3,7,10,30.0%,1h
46840,1,kamyan,1979,97,2,10,12,16.7%,1h
46840,3,GrEEdy,1979,0,1,0,1,100.0%,28m
46840,3,steve,1979,0,1,0,1,100.0%,1h
46840,3,Pfanne,1979,30,1,6,7,14.3%,1h
46840,3,Daniel,1979,0,0,1,1,0.0%,12m
46840,3,killerbee,1979,0,0,2,2,0.0%,14m
46840,3,Gruntard,1979,0,0,2,2,0.0%,1h
46840,3,[Vizzor]ManiekŁowca,1979,0,0,4,4,0.0%,22m
46840,3,nicolas,1979,0,0,4,4,0.0%,1h
46840,2,[CDIR]Bumhorn,1979,0,0,6,6,0.0%,32m
46840,2,илья,1979,0,0,6,6,0.0%,22m
46865,2,Guix,1978,1565,136,135,271,50.2%,31m
46865,2,Lestar,1978,1136,53,48,101,52.5%,13m
46865,2,NOD,1978,1231,46,64,110,41.8%,34m
46865,2,grjgrj,1978,1140,44,53,97,45.4%,1h
46865,3,василий,1978,514,19,22,41,46.3%,1h
46865,2,ziajka,1978,544,19,32,51,37.3%,1h
46865,3,[Дошик1]Rocknik,1978,376,13,14,27,48.1%,1h
46865,2,manro,1978,293,12,12,24,50.0%,24m
46865,3,yoyokill,1978,372,12,20,32,37.5%,1h
46865,2,Pencea,1978,248,9,14,23,39.1%,1h
46865,2,abeliense,1978,96,7,16,23,30.4%,1h
46865,3,AlterEgo,1978,116,5,2,7,71.4%,1h
46865,3,xavinux,1978,191,5,4,9,55.6%,34m
46865,2,wildwolf,1978,136,5,12,17,29.4%,1h
46865,3,Bartuzzo,1978,68,4,4,8,50.0%,15m
46865,1,goshaka,1978,145,3,11,14,21.4%,1h
46865,2,Pobba,1978,86,2,1,3,66.7%,1h
46865,3,styler,1978,0,1,1,2,50.0%,31m
46865,1,HERETIC,1978,48,1,3,4,25.0%,19m
46865,2,Anoman,1978,30,1,7,8,12.5%,21m
46865,3,Deathspada,1978,0,0,1,1,0.0%,21m
46865,3,Dany,1978,0,0,6,6,0.0%,1h
46887,2,ТОР,1977,1528,354,387,741,47.8%,1h
46887,2,chizzlerr,1977,1534,110,119,229,48.0%,1h
46887,2,ShugaHill,1977,1534,92,92,184,50.0%,1h
46887,2,феникс,1977,1581,77,88,165,46.7%,32m
46887,2,drasc,1977,953,62,57,119,52.1%,6m
46887,1,Caeon,1977,1256,57,66,123,46.3%,1h
46887,3,SaJin,1977,1165,45,41,86,52.3%,11m
46887,3,Geiser,1977,769,33,41,74,44.6%,17m
46887,3,[DomPre]lantrixsoof,1977,424,32,40,72,44.4%,1h
46887,3,AXXIS,1977,649,25,23,48,52.1%,1h
46887,3,ZerOShiftY,1977,362,13,12,25,52.0%,23m
46887,3,Salsax,1977,360,12,20,32,37.5%,13m
46887,3,[GDZg]KOJIbIBAH,1977,280,8,11,19,42.1%,34m
46887,2,DanceJunkie,1977,130,5,6,11,45.5%,1h
46887,3,WeedYeeter,1977,144,4,0,4,100.0%,1h
46887,3,AlelCraft,1977,53,4,7,11,36.4%,1h
46887,2,тихийМЕЧ,1977,142,4,8,12,33.3%,1h
46887,3,luckoluke,1977,115,3,9,12,25.0%,1h
46887,3,zurlaz,1977,130,3,11,14,21.4%,17m
46887,3,TANKist,1977,91,2,8,10,20.0%,1h
46887,3,ShadowWalker,1977,0,1,0,1,100.0%,1h
46887,3,PAPIIII,1977,0,0,1,1,0.0%,1h
46887,3,sadry,1977,0,0,1,1,0.0%,1h
46887,3,TuberG,1977,0,0,1,1,0.0%,1h
46887,3,AlaRack,1977,0,0,4,4,0.0%,8m
46887,2,Marko,1977,0,0,5,5,0.0%,27m
46887,3,jeonda,1977,0,0,6,6,0.0%,1h
46887,3,saimon,1977,0,0,6,6,0.0%,25m
46915,1,Jroch,1976,1555,220,229,449,49.0%,1h
46915,3,Bob,1976,1220,197,209,406,48.5%,1h
46915,3,Zeevonk,1976,1557,114,132,246,46.3%,25m
46915,3,Krawcowy,1976,1523,71,85,156,45.5%,11m
46915,3,Seonic,1976,1101,68,75,143,47.6%,1h
46915,3,Derticom,1976,898,57,64,121,47.1%,1h
46915,3,Shadow,1976,1060,42,54,96,43.8%,34m
46915,3,[beaste]TheSwarmLead,1976,774,40,38,78,51.3%,28m
46915,3,Hubusxz,1976,357,23,17,40,57.5%,1h
46915,3,Horst,1976,418,18,29,47,38.3%,13m
46915,1,[8307]GoVoR,1976,508,14,42,56,25.0%,11m
46915,2,WNL,1976,342,13,23,36,36.1%,20m
46915,3,iskaimin,1976,330,12,14,26,46.2%,1h
46915,2,[pooo]Pajory,1976,350,12,16,28,42.9%,1h
46915,3,Carmachy,1976,244,9,9,18,50.0%,14m
46915,3,VassiSkansa,1976,315,9,9,18,50.0%,11m
46915,1,almoggabay,1976,140,8,15,23,34.8%,3m
46915,3,wilo,1976,182,7,7,14,50.0%,1h
46915,3,AmfoRobot,1976,202,7,10,17,41.2%,29m
46915,1,[DNTs]Inferno,1976,164,5,5,10,50.0%,15m
46915,3,ВоронЗет,1976,88,4,3,7,57.1%,26m
46915,3,StevenGomman,1976,124,4,6,10,40.0%,28m
46915,2,AssaultX,1976,211,4,8,12,33.3%,6m
46915,2,[StSta]SaGiMan,1976,48,2,10,12,16.7%,13m
46915,3,ilsid,1976,30,1,2,3,33.3%,6m
46915,3,[Vityaz]den,1976,0,1,5,6,16.7%,1h
46915,3,olics,1976,0,0,1,1,0.0%,5m
46915,3,TITAN,1976,0,0,6,6,0.0%,29m
46915,3,ForestAir,1976,0,0,6,6,0.0%,1h
46915,3,TimurRUS,1976,0,0,6,6,0.0%,1h
46945,3,Selcuk,1975,1191,48,43,91,52.7%,16m
46945,2,ALPHA,1975,1256,43,51,94,45.7%,1h
46945,2,[TSC]BigDaddy,1975,872,38,36,74,51.4%,1h
46945,2,EuclidDeos,1975,918,34,40,74,45.9%,14m
46945,3,Fiddolas,1975,593,25,26,51,49.0%,26m
46945,3,gugushka,1975,522,20,17,37,54.1%,1h
46945,2,ugly,1975,308,12,15,27,44.4%,31m
46945,2,EMan,1975,312,11,15,26,42.3%,1h
46945,3,ImposterJR,1975,236,9,10,19,47.4%,16m
46945,3,BaronBaba,1975,287,8,14,22,36.4%,13m
46945,3,[kGk]Norsken,1975,171,7,8,15,46.7%,1h
46945,3,NagibatorXXL,1975,173,5,12,17,29.4%,13m
46945,3,Ripley,1975,170,4,4,8,50.0%,14m
46945,2,Newton,1975,124,4,14,18,22.2%,21m
46945,3,Sedmin,1975,30,2,1,3,66.7%,10m
46945,1,Yachio,1975,92,2,4,6,33.3%,19m
46945,3,LimNylon,1975,62,2,4,6,33.3%,1h
46945,3,stom,1975,0,1,0,1,100.0%,1h
46945,3,Babashkin,1975,30,1,1,2,50.0%,1h
46945,3,vinnier,1975,0,1,2,3,33.3%,1h
46945,3,Kjonen,1975,0,0,1,1,0.0%,29m
46945,3,marios,1975,0,0,1,1,0.0%,28m
46945,3,[MCat]Zmilllzzz,1975,0,0,6,6,0.0%,1h
46945,2,ERNIERUSH,1975,0,0,7,7,0.0%,1h
46969,2,Zyon,1974,1270,116,116,232,50.0%,21m
46969,2,Warrior,1974,1385,54,65,119,45.4%,1h
46969,2,Nightigale,1974,1060,39,48,87,44.8%,25m
46969,3,miki,1974,822,31,31,62,50.0%,17m
46969,3,Quentinozor,1974,658,29,28,57,50.9%,25m
46969,2,prosega,1974,362,24,36,60,40.0%,1h
46969,2,SivkaXL,1974,173,8,5,13,61.5%,33m
46969,1,Snayperat,1974,244,8,18,26,30.8%,1h
46969,2,Kalakosta,1974,192,8,18,26,30.8%,1h
46969,2,Emilut,1974,188,6,19,25,24.0%,1h
46969,3,Rinat,1974,155,5,7,12,41.7%,1h
46969,3,Logikoff,1974,97,3,10,13,23.1%,11m
46969,2,Montbag,1974,46,2,4,6,33.3%,1h
46969,3,karkas,1974,30,2,5,7,28.6%,5m
46969,3,MLCK,1974,48,1,7,8,12.5%,1h
46969,3,TillTerran,1974,0,0,1,1,0.0%,1h
46969,3,nooblegend,1974,0,0,6,6,0.0%,28m
46986,2,oskar,1973,1551,89,99,188,47.3%,1h
46986,3,[MODRR]Vulalo,1973,1520,85,90,175,48.6%,7m
46986,3,biophase,1973,787,30,37,67,44.8%,26m
46986,3,[Тянки]Reaper,1973,532,21,22,43,48.8%,4m
46986,2,Birksoe,1973,506,20,29,49,40.8%,29m
46986,2,semkiert,1973,403,16,14,30,53.3%,33m
46986,3,Fliegetier,1973,281,11,15,26,42.3%,13m
46986,3,Haradrim,1973,234,9,19,28,32.1%,1h
46986,3,manulepilote,1973,220,9,20,29,31.0%,23m
46986,3,eddi,1973,184,7,11,18,38.9%,34m
46986,2,Demon,1973,248,6,16,22,27.3%,1h
46986,2,XXX,1973,204,6,18,24,25.0%,26m
46986,1,Schamane,1973,255,5,14,19,26.3%,1h
46986,2,MOOSEKNUCKLE,1973,166,4,11,15,26.7%,1h
46986,1,KingJohnII,1973,80,3,11,14,21.4%,11m
46986,3,Amiterak,1973,58,2,2,4,50.0%,1h
46986,3,HalfChance,1973,60,2,4,6,33.3%,11m
46986,3,[SPAINs]lightnight,1973,0,2,4,6,33.3%,1h
46986,3,llllllllllll,1973,30,1,1,2,50.0%,17m
46986,3,[BIRB]bluesyfluesy,1973,32,1,1,2,50.0%,29m
46986,3,HardCore,1973,0,1,1,2,50.0%,4m
46986,2,Spvolk,1973,44,1,4,5,20.0%,1h
46986,3,Domio,1973,0,0,1,1,0.0%,29m
46986,2,[дошик]ВертуалСопля,1973,0,0,2,2,0.0%,3m
47010,2,Mazinger,1972,1496,165,177,342,48.2%,28m
47010,2,SayGon,1972,1137,154,160,314,49.0%,1h
47010,2,HITMAN,1972,700,34,42,76,44.7%,19m
47010,2,Centrinar,1972,838,33,44,77,42.9%,1h
47010,3,Rookie,1972,504,19,24,43,44.2%,1h
47010,3,MareKa,1972,513,18,29,47,38.3%,1h
47010,2,NilugeKiWi,1972,507,17,28,45,37.8%,1h
47010,3,[LDF]aHacPaTb,1972,338,13,15,28,46.4%,1h
47010,3,Зашибиь,1972,267,8,13,21,38.1%,1h
47010,3,majk,1972,176,6,9,15,40.0%,1h
47010,1,fragalit,1972,259,6,15,21,28.6%,11m
47010,3,Mason,1972,142,5,6,11,45.5%,28m
47010,2,Buia,1972,137,5,7,12,41.7%,1h
47010,2,EvilCow,1972,169,5,8,13,38.5%,30m
47010,3,[HMarch]Larrs,1972,207,5,8,13,38.5%,16m
47010,3,WarHuman,1972,220,5,13,18,27.8%,14m
47010,1,HacaII,1972,167,5,14,19,26.3%,1h
47010,3,[WARPA2]Kater,1972,86,4,2,6,66.7%,1h
47010,3,Bill,1972,100,3,3,6,50.0%,1h
47010,1,Icarion,1972,96,2,3,5,40.0%,1h
47010,2,DOGFISHWAR,1972,46,2,9,11,18.2%,1h
47010,2,Raven,1972,142,2,11,13,15.4%,1h
47010,3,Meullz,1972,0,1,0,1,100.0%,1h
47010,3,FFIGROKOT,1972,0,1,2,3,33.3%,1h
47010,3,terrorxocita,1972,0,1,3,4,25.0%,5m
47010,1,Golden,1972,95,1,3,4,25.0%,1h
47010,3,[BPX]Blacksaw,1972,0,1,4,5,20.0%,4m
47010,3,Gosydarenkov,1972,38,1,8,9,11.1%,1h
47010,3,NIKITOS,1972,0,0,1,1,0.0%,1h
47010,1,MagicPylon,1972,0,0,2,2,0.0%,1h
47040,3,HECTTAR,1971,1575,193,219,412,46.8%,4m
47040,3,DroidB,1971,583,52,45,97,53.6%,1h
47040,3,Josikito,1971,1106,39,46,85,45.9%,11m
47040,2,corsar,1971,870,31,39,70,44.3%,30m
47040,3,Pain,1971,704,24,25,49,49.0%,27m
47040,1,Monkey,1971,690,24,38,62,38.7%,28m
47040,2,Infineon,1971,379,17,29,46,37.0%,1h
47040,2,Radiant,1971,351,11,25,36,30.6%,30m
47040,3,JKTitor,1971,0,4,1,5,80.0%,16m
47040,3,EveryDayUser,1971,171,4,7,11,36.4%,4m
47040,2,Phoenix,1971,166,4,10,14,28.6%,29m
47040,1,FlyingMoose,1971,0,3,6,9,33.3%,19m
47040,2,BRONSON,1971,127,3,7,10,30.0%,1h
47040,3,LieAbleitung,1971,30,2,0,2,100.0%,16m
47040,3,[logds]Sakkie,1971,121,2,1,3,66.7%,11m
47040,2,[ME1]Melancholy,1971,92,2,7,9,22.2%,18m
47040,2,Vad,1971,58,2,8,10,20.0%,13m
47040,2,[FCSInc]Steamboy,1971,62,2,14,16,12.5%,1h
47040,3,алим,1971,0,1,0,1,100.0%,32m
47040,3,QFalt,1971,0,1,1,2,50.0%,1h
47040,3,Foxdude,1971,30,1,7,8,12.5%,17m
47040,3,CleverPRO,1971,0,0,1,1,0.0%,13m
47040,2,MrPluton,1971,0,0,3,3,0.0%,1h
47040,3,[DBGS]Antikiro,1971,0,0,5,5,0.0%,13m
47040,3,[BrClw]Fenicskiller,1971,0,0,6,6,0.0%,1h
47040,3,phoenix,1971,0,0,6,6,0.0%,6m
47040,2,moonlight,1971,0,0,7,7,0.0%,10m
47067,3,Roscoe,1970,1574,197,219,416,47.4%,1h
47067,2,Snozzledan,1970,1522,165,179,344,48.0%,34m
47067,3,mka,1970,1574,117,138,255,45.9%,14m
47067,2,[zergxp]МайорВихрь,1970,1357,64,69,133,48.1%,1h
47067,2,ThePitou,1970,1291,49,56,105,46.7%,1h
47067,3,Peter,1970,1002,46,45,91,50.5%,1h
47067,3,CatS,1970,1060,39,42,81,48.1%,15m
47067,2,Bumblebee,1970,443,22,31,53,41.5%,21m
47067,3,Sarah,1970,524,17,25,42,40.5%,21m
47067,3,[ULTX]Kargo,1970,450,15,21,36,41.7%,1h
47067,3,scuser,1970,262,10,11,21,47.6%,1h
47067,3,Zsansaran,1970,245,7,5,12,58.3%,26m
47067,1,Ardelos,1970,217,7,14,21,33.3%,1h
47067,2,CallaCharran,1970,276,7,18,25,28.0%,25m
47067,3,Oliver,1970,94,4,3,7,57.1%,9m
47067,3,alexsev,1970,30,2,1,3,66.7%,28m
47067,3,Sage,1970,30,1,4,5,20.0%,26m
47067,2,yahway,1970,92,1,4,5,20.0%,33m
47067,2,Bobross,1970,0,0,1,1,0.0%,1h
47067,2,[CtE]SneakySnake,1970,0,0,2,2,0.0%,18m
47067,3,COBRA,1970,0,0,5,5,0.0%,1h
47088,2,PabliTO,1969,1493,145,171,316,45.9%,14m
47088,1,Pittuka,1969,1580,129,146,275,46.9%,1h
47088,1,Luminous,1969,1586,122,135,257,47.5%,33m
47088,2,tduty,1969,1536,97,116,213,45.5%,1h
47088,3,serik,1969,707,30,23,53,56.6%,25m
47088,3,indy,1969,639,26,31,57,45.6%,11m
47088,3,WilliWinzig,1969,627,25,26,51,49.0%,11m
47088,3,CashDimon,1969,601,24,20,44,54.5%,6m
47088,3,Remad,1969,454,17,20,37,45.9%,1h
47088,3,[z666z]Хабаровск,1969,355,12,10,22,54.5%,1h
47088,2,Аласстр,1969,364,12,20,32,37.5%,17m
47088,3,[BlaSH]JeBlackHole,1969,248,9,13,22,40.9%,17m
47088,3,Dranor,1969,180,7,8,15,46.7%,29m
47088,2,Pausenbrot,1969,140,6,7,13,46.2%,14m
47088,3,ShakaZoulu,1969,0,4,3,7,57.1%,23m
47088,3,XXXXXXXXXXX,1969,30,2,0,2,100.0%,1h
47088,3,Dimanist,1969,60,2,3,5,40.0%,4m
47088,2,Griffin,1969,115,2,9,11,18.2%,1h
47088,3,[Ginf]batmolive,1969,0,1,2,3,33.3%,16m
47088,3,LordOfClay,1969,30,1,2,3,33.3%,11m
47088,3,rinat,1969,30,1,3,4,25.0%,1h
47088,2,Vlad,1969,30,1,4,5,20.0%,9m
47088,3,[2500]Корсар,1969,30,1,6,7,14.3%,1h
47088,2,Osniortiga,1969,93,1,8,9,11.1%,1h
47088,3,Jaskóła,1969,0,0,1,1,0.0%,1h
47088,1,Хрустик,1969,0,0,4,4,0.0%,1h
47088,3,Fleshmeat,1969,0,0,5,5,0.0%,1h
47088,3,[sympa]rainor,1969,0,0,6,6,0.0%,1h
47088,1,Daan,1969,0,0,7,7,0.0%,4m
47117,2,WardStar,1968,1545,273,292,565,48.3%,35m
47117,3,[win2]DJANGOROD,1968,1444,109,114,223,48.9%,1h
47117,3,Kitss,1968,1597,67,95,162,41.4%,29m
47117,3,joker,1968,1204,47,50,97,48.5%,1h
47117,2,MrBozzo,1968,1097,44,52,96,45.8%,1h
47117,3,GarriPodolsk,1968,825,32,43,75,42.7%,14m
47117,2,Ansar,1968,452,17,31,48,35.4%,1h
47117,3,MajorChop,1968,337,11,20,31,35.5%,1h
47117,2,Trypa,1968,347,10,24,34,29.4%,11m
47117,3,leone,1968,208,8,11,19,42.1%,1h
47117,3,Commander,1968,235,7,5,12,58.3%,1h
47117,3,Eipieti,1968,120,5,6,11,45.5%,1h
47117,3,Sheogorath,1968,78,5,7,12,41.7%,1h
47117,1,PhilM,1968,232,4,7,11,36.4%,1h
47117,3,Gleufdier,1968,0,3,7,10,30.0%,7m
47117,3,Krasiolet,1968,66,2,4,6,33.3%,1h
47117,3,Владичара,1968,0,1,3,4,25.0%,34m
47117,3,FullHous,1968,30,1,3,4,25.0%,29m
47117,1,teeso,1968,46,1,3,4,25.0%,33m
47117,1,[КПCC]Roman,1968,0,0,1,1,0.0%,6m
47117,3,[Aмун]Romanslis,1968,0,0,2,2,0.0%,16m
47117,3,[Goldin]taily,1968,0,0,5,5,0.0%,32m
47117,3,IIIIIIIIIIII,1968,0,0,6,6,0.0%,27m
47140,3,GhstRprtng,1967,1539,189,207,396,47.7%,17m
47140,1,ArtemAlmaz,1967,1511,138,167,305,45.2%,32m
47140,3,Carotto,1967,1576,133,139,272,48.9%,15m
47140,2,Lyet,1967,1539,106,119,225,47.1%,1h
47140,3,SteelTribe,1967,1570,95,105,200,47.5%,1h
47140,3,heuretk,1967,1062,66,69,135,48.9%,1h
47140,2,Parasite,1967,1411,57,50,107,53.3%,1h
47140,2,senza,1967,657,44,51,95,46.3%,16m
47140,3,mikitoni,1967,830,32,27,59,54.2%,11m
47140,3,Espiritu,1967,806,30,57,87,34.5%,25m
47140,3,Alexandru,1967,643,22,25,47,46.8%,1h
47140,3,kros,1967,502,17,19,36,47.2%,1h
47140,3,Valaric,1967,428,16,15,31,51.6%,29m
47140,3,Nicknac,1967,339,15,11,26,57.7%,31m
47140,2,player,1967,374,13,20,33,39.4%,17m
47140,3,[Rooar]MisterNuke,1967,254,9,14,23,39.1%,26m
47140,3,[TedB]NEV,1967,242,8,3,11,72.7%,17m
47140,3,Skullhunter,1967,238,8,14,22,36.4%,28m
47140,3,Feolmo,1967,192,7,8,15,46.7%,1h
47140,2,Brest,1967,212,7,16,23,30.4%,1h
47140,2,[KPZA]ILoveDi,1967,268,7,16,23,30.4%,19m
47140,2,Morty,1967,189,5,10,15,33.3%,1h
47140,3,Ars,1967,30,4,2,6,66.7%,14m
47140,3,Greedy,1967,90,4,6,10,40.0%,1h
47140,3,den,1967,47,3,6,9,33.3%,32m
47140,2,vld,1967,86,3,9,12,25.0%,1h
47140,3,Toto,1967,62,2,8,10,20.0%,1h
47140,2,Karnauhov,1967,0,0,1,1,0.0%,1h
47140,3,Роланд,1967,0,0,2,2,0.0%,16m
47140,2,[oO]Leviatano,1967,0,0,3,3,0.0%,26m
47170,1,Bully,1966,1580,359,379,738,48.6%,10m
47170,3,[MC54]Croustibat,1966,1496,119,137,256,46.5%,7m
47170,1,kapitanbomba,1966,1593,100,118,218,45.9%,25m
47170,2,jps,1966,1395,65,73,138,47.1%,6m
47170,2,chris,1966,833,47,51,98,48.0%,1h
47170,3,NotACat,1966,849,44,54,98,44.9%,1h
47170,3,ПУПСback,1966,893,32,42,74,43.2%,13m
47170,3,NoTAiR,1966,756,26,33,59,44.1%,1h
47170,2,MrBeefy,1966,651,25,25,50,50.0%,1h
47170,2,Кирбор,1966,633,25,30,55,45.5%,21m
47170,1,Monochrome,1966,547,19,36,55,34.5%,1h
47170,2,fpawel,1966,411,18,32,50,36.0%,30m
47170,1,RayLoko,1966,370,16,20,36,44.4%,17m
47170,3,phantomkill,1966,374,15,22,37,40.5%,1h
47170,3,merli,1966,355,13,15,28,46.4%,1h
47170,3,Skullion,1966,356,12,14,26,46.2%,11m
47170,2,[star34]Dranser,1966,340,11,22,33,33.3%,7m
47170,3,SpringKerrik,1966,270,10,12,22,45.5%,1h
47170,3,ManoNegra,1966,258,9,14,23,39.1%,35m
47170,2,лиля,1966,174,6,13,19,31.6%,15m
47170,1,Pomazanka,1966,241,5,15,20,25.0%,1h
47170,2,XPOiL,1966,136,4,7,11,36.4%,1h
47170,3,[100PSC]Laila,1966,58,3,5,8,37.5%,1h
47170,2,trains,1966,90,3,7,10,30.0%,3m
47170,3,Balu,1966,97,2,3,5,40.0%,14m
47170,3,[JYD]jpoha,1966,0,2,4,6,33.3%,1h
47170,3,Xyntia,1966,60,2,5,7,28.6%,15m
47170,3,GabbaGandalf,1966,60,2,5,7,28.6%,25m
47170,2,NeoGeek,1966,48,2,8,10,20.0%,1h
47170,3,WARG,1966,30,2,11,13,15.4%,1h
47170,3,[ganten]Felix,1966,30,1,1,2,50.0%,1h
47170,3,robertFG,1966,0,1,1,2,50.0%,9m
47170,3,Noez,1966,95,1,1,2,50.0%,1h
47170,1,Zonke,1966,0,1,9,10,10.0%,18m
47170,3,woodHero,1966,0,0,1,1,0.0%,28m
47170,3,MarcelONE,1966,0,0,2,2,0.0%,12m
47170,3,Yugz,1966,0,0,3,3,0.0%,25m
47170,3,Schlandmann,1966,0,0,3,3,0.0%,1h
47170,3,Leo,1966,0,0,6,6,0.0%,35m
47209,1,SergNast,1965,1390,171,189,360,47.5%,11m
47209,3,ArtorikS,1965,1288,81,88,169,47.9%,28m
47209,3,RuBot,1965,1025,67,73,140,47.9%,26m
47209,3,Saltinbanqui,1965,1169,56,62,118,47.5%,1h
47209,3,[KWIDZ]DjHorbi,1965,1017,45,42,87,51.7%,1h
47209,2,Etienne,1965,1086,42,52,94,44.7%,1h
47209,2,Learyt,1965,848,32,46,78,41.0%,33m
47209,3,[HDOG]cksteelo,1965,506,18,15,33,54.5%,1h
47209,2,Igor,1965,310,11,16,27,40.7%,33m
47209,3,NIK,1965,302,10,16,26,38.5%,7m
47209,3,LIKMIJNBALLE,1965,166,4,7,11,36.4%,35m
47209,1,HonestLiar,1965,97,2,8,10,20.0%,1h
47209,2,Kangaxx,1965,66,2,9,11,18.2%,12m
47209,3,Eridanis,1965,30,1,5,6,16.7%,1h
47209,3,[WARL]Nasreldeen,1965,30,1,7,8,12.5%,4m
47209,1,[HOMIE]Stafin,1965,0,0,2,2,0.0%,19m
47209,3,Karel,1965,0,0,6,6,0.0%,1h
47226,1,tasty,1964,1571,154,175,329,46.8%,30m
47226,2,Riri,1964,1570,131,143,274,47.8%,1h
47226,3,Atros,1964,1584,93,107,200,46.5%,1h
47226,2,Netnika,1964,707,27,38,65,41.5%,14m
47226,3,[MODRR]LUCIFER,1964,488,21,20,41,51.2%,1h
47226,2,Foxtrot,1964,528,19,32,51,37.3%,17m
47226,3,[ZerusZ]Alavardo,1964,512,17,26,43,39.5%,1h
47226,2,kirku,1964,484,16,25,41,39.0%,1h
47226,3,vlad,1964,388,14,16,30,46.7%,4m
47226,3,KlikoBoom,1964,324,10,8,18,55.6%,34m
47226,3,sasara,1964,290,10,9,19,52.6%,34m
47226,3,[SC2LE]ASTROG,1964,257,9,3,12,75.0%,31m
47226,2,Crowbar,1964,196,7,22,29,24.1%,17m
47226,3,smeilk,1964,116,5,4,9,55.6%,1h
47226,1,[TZF]Sharka,1964,94,3,11,14,21.4%,34m
47226,2,[MRaven]Zampakuto,1964,60,3,12,15,20.0%,1h
47226,3,iia,1964,30,2,3,5,40.0%,3m
47226,3,[SaloXD]WHAT,1964,0,1,0,1,100.0%,4m
47226,3,Milifarn,1964,93,1,2,3,33.3%,7m
47226,3,[TsVg]Bencsy,1964,30,1,3,4,25.0%,25m
47226,3,Dragoman,1964,0,0,1,1,0.0%,1h
47226,2,[K0RM2]Domonicant,1964,0,0,1,1,0.0%,28m
47226,3,[tnt]bytethunder,1964,0,0,2,2,0.0%,1h
47226,2,MnschnFressr,1964,0,0,2,2,0.0%,1h
47226,3,Madmax,1964,0,0,6,6,0.0%,17m
47251,2,FABELOUZ,1963,1518,194,211,405,47.9%,1h
47251,3,Titix,1963,1561,156,191,347,45.0%,17m
47251,3,HeroOfHeroes,1963,1509,94,94,188,50.0%,35m
47251,2,Fakver,1963,830,47,51,98,48.0%,1h
47251,2,Mike,1963,1222,43,50,93,46.2%,1h
47251,2,[RBCOMM]GeNiUSssS,1963,818,36,35,71,50.7%,1h
47251,2,seraf,1963,866,35,40,75,46.7%,24m
47251,2,Ronan,1963,268,18,32,50,36.0%,1h
47251,2,QuiGone,1963,330,10,10,20,50.0%,27m
47251,1,TTPUKOJL,1963,144,6,6,12,50.0%,1h
47251,3,atcBaboon,1963,176,6,7,13,46.2%,11m
47251,3,KRIN,1963,114,4,3,7,57.1%,1h
47251,3,BaldCapDude,1963,34,3,5,8,37.5%,29m
47251,2,Marco,1963,144,3,10,13,23.1%,1h
47251,3,DrFunnY,1963,30,2,0,2,100.0%,1h
47251,3,[БГТ]IMPERATOR,1963,30,2,0,2,100.0%,23m
47251,3,AkKa,1963,30,2,3,5,40.0%,1m
47251,2,bnk,1963,113,2,4,6,33.3%,28m
47251,3,Vinegredinka,1963,97,2,7,9,22.2%,1h
47251,3,Tolia,1963,0,1,0,1,100.0%,1h
47251,3,[NCT]Lakhamu,1963,30,1,3,4,25.0%,1h
47251,2,FisherGang,1963,96,1,8,9,11.1%,13m
47251,3,Serijant,1963,0,0,6,6,0.0%,13m
47251,2,Isaia,1963,0,0,7,7,0.0%,5m
47275,3,Mandalorian,1962,1603,81,84,165,49.1%,1h
47275,2,[LOGS]Thomas,1962,910,37,40,77,48.1%,1h
47275,2,Nitrogen,1962,878,32,38,70,45.7%,17m
47275,3,MajorTom,1962,290,10,12,22,45.5%,1h
47275,3,kashtan,1962,242,8,11,19,42.1%,1h
47275,3,Gorian,1962,219,6,13,19,31.6%,11m
47275,3,Valerio,1962,149,4,2,6,66.7%,31m
47275,3,RaulRoCre,1962,145,3,2,5,60.0%,3m
47275,2,dallars,1962,114,2,9,11,18.2%,33m
47275,3,DOC,1962,30,1,2,3,33.3%,1h
47275,3,Злоубийца,1962,0,1,5,6,16.7%,6m
47275,3,[ICUNLD]Regz,1962,0,0,6,6,0.0%,8m
47275,3,Ябадабаду,1962,0,0,6,6,0.0%,29m
47275,3,MedomXaf,1962,0,0,6,6,0.0%,1h
47275,2,yeetdHamster,1962,0,0,7,7,0.0%,7m
47290,2,MrGlock,1961,674,138,163,301,45.8%,1h
47290,2,israker,1961,614,133,145,278,47.8%,30m
47290,2,momchil,1961,1009,43,48,91,47.3%,3m
47290,3,Doofy,1961,620,37,44,81,45.7%,1h
47290,3,caz,1961,625,28,29,57,49.1%,1h
47290,3,sairon,1961,556,20,22,42,47.6%,1h
47290,3,ZNikita,1961,505,20,26,46,43.5%,35m
47290,3,lewl,1961,223,16,16,32,50.0%,28m
47290,2,Justas,1961,308,16,29,45,35.6%,1h
47290,2,Alligattor,1961,334,14,24,38,36.8%,1h
47290,3,PeacefulUA,1961,378,12,10,22,54.5%,32m
47290,2,fraise,1961,340,12,19,31,38.7%,1h
47290,3,CatWalk,1961,330,11,15,26,42.3%,1h
47290,3,Catkats,1961,234,8,5,13,61.5%,1h
47290,2,Scarecrow,1961,176,7,12,19,36.8%,34m
47290,3,SuperMan,1961,206,6,3,9,66.7%,4m
47290,3,IonJiga,1961,114,4,3,7,57.1%,25m
47290,3,врсмло,1961,58,2,3,5,40.0%,1h
47290,3,KILLOFF,1961,0,2,3,5,40.0%,7m
47290,3,Kmet,1961,58,2,4,6,33.3%,1h
47290,3,Bryn,1961,40,2,6,8,25.0%,1h
47290,3,Jolenemo,1961,96,2,8,10,20.0%,21m
47290,1,PoNchiK,1961,40,2,10,12,16.7%,34m
47290,2,Marat,1961,0,1,0,1,100.0%,1h
47290,3,googlechrome,1961,0,1,3,4,25.0%,25m
47290,3,Acar,1961,0,0,2,2,0.0%,27m
47290,3,Aleksey,1961,0,0,3,3,0.0%,1h
47290,2,xmexcikx,1961,0,0,4,4,0.0%,1h
47318,1,Cyclone,1960,1478,228,242,470,48.5%,20m
47318,3,MrGena,1960,1371,92,105,197,46.7%,1h
47318,3,[TBGeV]Bitspyde,1960,1105,46,46,92,50.0%,7m
47318,2,Highvoid,1960,532,19,26,45,42.2%,16m
47318,3,[GhOsTh]Ganymede,1960,390,14,15,29,48.3%,1h
47318,3,вася,1960,378,14,19,33,42.4%,28m
47318,3,[GOCA]PlasticEye,1960,316,11,14,25,44.0%,17m
47318,1,Hörnchen,1960,181,8,9,17,47.1%,24m
47318,3,ABBADON,1960,126,8,12,20,40.0%,20m
47318,3,ISSACLEE,1960,123,3,4,7,42.9%,13m
47318,2,DouxPanda,1960,91,3,9,12,25.0%,1h
47318,3,toxic,1960,58,2,3,5,40.0%,7m
47318,3,Диманион,1960,114,2,3,5,40.0%,1h
47318,3,AverieAutumn,1960,0,1,4,5,20.0%,28m
47318,3,EniK,1960,0,1,4,5,20.0%,10m
47318,3,TerraNova,1960,0,0,4,4,0.0%,29m
47318,3,Danisle,1960,0,0,5,5,0.0%,29m
47318,2,Gramdler,1960,0,0,7,7,0.0%,16m
47336,2,thander,1959,1564,247,255,502,49.2%,28m
47336,2,BALOOGRAND,1959,1575,133,144,277,48.0%,30m
47336,3,Zheldor,1959,800,31,26,57,54.4%,3m
47336,2,Jamesd,1959,841,29,43,72,40.3%,3m
47336,3,yannis,1959,662,23,28,51,45.1%,3m
47336,2,[RBlood]jdFAN,1959,458,16,24,40,40.0%,30m
47336,3,GoodBoiPat,1959,441,13,19,32,40.6%,1h
47336,3,Olevonpoff,1959,111,7,8,15,46.7%,1h
47336,3,Libor,1959,214,7,13,20,35.0%,7m
47336,3,ZaUrodinu,1959,192,6,12,18,33.3%,1h
47336,2,OldSnipzubik,1959,177,4,11,15,26.7%,1h
47336,1,Picaasso,1959,92,4,12,16,25.0%,6m
47336,2,[1NFEC7]MeHigh,1959,108,3,11,14,21.4%,25m
47336,1,Silentd,1959,90,3,13,16,18.8%,1h
47336,3,[CHOPAA]ART,1959,30,1,2,3,33.3%,1h
47336,3,Triatonix,1959,0,1,4,5,20.0%,4m
47336,3,Matreya,1959,0,0,3,3,0.0%,1h
47336,3,Anti,1959,0,0,3,3,0.0%,25m
47336,3,[VS2017]iMozg,1959,0,0,3,3,0.0%,1h
47336,3,RainZx,1959,0,0,6,6,0.0%,1h
47356,3,[BARHUR]BARHUR,1958,1547,75,73,148,50.7%,1h
47356,1,Задов,1958,1012,37,56,93,39.8%,1h
47356,3,iustin,1958,958,36,38,74,48.6%,11m
47356,3,[ABDI]Sacha,1958,439,16,13,29,55.2%,4m
47356,3,DNox,1958,340,12,8,20,60.0%,4m
47356,3,[CxCx]димидролл,1958,264,10,12,22,45.5%,1h
47356,3,TORDEN,1958,251,8,12,20,40.0%,4m
47356,3,medalex,1958,240,7,5,12,58.3%,1h
47356,3,Renkin,1958,196,6,7,13,46.2%,1h
47356,3,Ragnos,1958,214,5,8,13,38.5%,1h
47356,2,Luke,1958,116,4,4,8,50.0%,6m
47356,2,LeonidWOLF,1958,158,3,6,9,33.3%,1h
47356,2,Sopan,1958,0,2,5,7,28.6%,30m
47356,3,токсикипорук,1958,30,2,6,8,25.0%,1h
47356,2,Zubakick,1958,94,1,8,9,11.1%,1h
47356,2,CleverAlexAU,1958,46,1,9,10,10.0%,22m
47356,1,kofeinik,1958,73,1,18,19,5.3%,33m
47356,2,Trasher,1958,0,0,1,1,0.0%,21m
47356,2,hollowknight,1958,0,0,7,7,0.0%,15m
47375,2,SKIF,1957,1541,147,145,292,50.3%,6m
47375,3,Wartune,1957,1581,114,127,241,47.3%,1h
47375,3,Charlene,1957,576,22,19,41,53.7%,9m
47375,3,Wybawiciel,1957,435,18,21,39,46.2%,1h
47375,3,[SNENS]Bjørn,1957,406,14,17,31,45.2%,6m
47375,3,AlainAquebar,1957,391,13,18,31,41.9%,1h
47375,2,grasp,1957,386,13,19,32,40.6%,30m
47375,3,TanTo,1957,172,7,8,15,46.7%,1h
47375,3,Hawk,1957,176,6,7,13,46.2%,4m
47375,3,[D3L]JJxDUB,1957,172,6,8,14,42.9%,26m
47375,2,Riel,1957,222,6,13,19,31.6%,26m
47375,2,RPG,1957,90,3,4,7,42.9%,1h
47375,3,Jomolungma,1957,30,3,5,8,37.5%,1m
47375,3,Andrey,1957,0,1,0,1,100.0%,1h
47375,2,ZergRush,1957,0,1,2,3,33.3%,21m
47375,2,FEITAN,1957,0,1,8,9,11.1%,28m
47375,2,Strypkeroz,1957,88,1,8,9,11.1%,1h
47375,3,Soyputa,1957,0,0,1,1,0.0%,25m
47375,3,Andy,1957,0,0,2,2,0.0%,1h
47375,3,SCCHRabbit,1957,0,0,4,4,0.0%,1h
47375,3,han,1957,0,0,5,5,0.0%,28m
47375,3,Pedja,1957,0,0,6,6,0.0%,1h
47375,3,YKARS,1957,0,0,6,6,0.0%,24m
47375,3,vagusbr,1957,0,0,7,7,0.0%,1h
47375,3,Blowyourface,1957,0,0,7,7,0.0%,17m
47400,2,NainFéroce,1956,1337,102,115,217,47.0%,1h
47400,2,[ROGwar]JENAAL,1956,486,63,66,129,48.8%,1h
47400,3,bob,1956,1219,47,47,94,50.0%,27m
47400,2,Joshua,1956,876,31,46,77,40.3%,27m
47400,3,Bofi,1956,641,27,22,49,55.1%,1h
47400,3,ben,1956,663,25,27,52,48.1%,1h
47400,2,alb,1956,224,13,17,30,43.3%,13m
47400,3,luckytiger,1956,80,5,5,10,50.0%,1h
47400,2,МАКС,1956,223,5,7,12,41.7%,1h
47400,1,Cerihar,1956,231,5,12,17,29.4%,3m
47400,3,Vlastelinka,1956,156,5,14,19,26.3%,1m
47400,3,BlackRaven,1956,118,4,7,11,36.4%,1h
47400,2,Sawel,1956,209,4,11,15,26.7%,28m
47400,3,KadHarrelson,1956,118,3,2,5,60.0%,1h
47400,3,CHeloVecHeK,1956,30,3,5,8,37.5%,1h
47400,3,MooN,1956,0,1,3,4,25.0%,17m
47400,1,[SUD34]Shinoda,1956,0,1,8,9,11.1%,24m
47400,3,HuluMulu,1956,0,1,8,9,11.1%,10m
47400,3,Maestrochef,1956,0,0,1,1,0.0%,27m
47400,3,Favi,1956,0,0,1,1,0.0%,27m
47420,2,Basek,1955,1324,45,62,107,42.1%,3m
47420,3,Viento,1955,921,43,45,88,48.9%,28m
47420,2,[synTWD]Pavel,1955,495,29,37,66,43.9%,1h
47420,3,Asmodey,1955,461,19,25,44,43.2%,15m
47420,2,[BwnZwn]Isatai,1955,231,19,28,47,40.4%,17m
47420,3,Nanuk,1955,432,16,15,31,51.6%,31m
47420,3,Winterz,1955,381,15,24,39,38.5%,26m
47420,3,Okorok,1955,383,13,23,36,36.1%,1h
47420,1,RacerX,1955,175,6,22,28,21.4%,31m
47420,2,RuiNeR,1955,114,5,10,15,33.3%,1h
47420,3,lyterogas,1955,174,4,8,12,33.3%,1h
47420,3,AlphaEva,1955,158,3,2,5,60.0%,17m
47420,3,vofvendetta,1955,0,1,1,2,50.0%,21m
47420,3,Sedoi,1955,30,1,1,2,50.0%,14m
47420,3,LuigisPasta,1955,0,1,3,4,25.0%,1h
47420,3,[Дру9я]Эдвард,1955,30,1,8,9,11.1%,35m
47420,3,Econogeorge,1955,0,0,1,1,0.0%,32m
47420,1,Stasovij,1955,0,0,1,1,0.0%,3m
47420,2,Valentin,1955,0,0,8,8,0.0%,3m
47439,3,Goga,1954,1570,87,112,199,43.7%,31m
47439,3,Hichko,1954,943,36,35,71,50.7%,24m
47439,2,[SwgBoi]Nanuuki,1954,901,30,42,72,41.7%,14m
47439,2,ker,1954,459,26,28,54,48.1%,29m
47439,3,McFit,1954,523,20,19,39,51.3%,1m
47439,3,[2Ta]ARESERA,1954,350,14,6,20,70.0%,1h
47439,3,Spartan,1954,187,10,5,15,66.7%,1h
47439,3,[clavak]Alexua,1954,277,9,7,16,56.2%,11m
47439,3,GoldenGambas,1954,250,7,6,13,53.8%,35m
47439,3,CzMaRa,1954,196,6,4,10,60.0%,4m
47439,3,siza,1954,124,5,9,14,35.7%,1h
47439,3,KestorN,1954,144,4,2,6,66.7%,24m
47439,2,rocketboot,1954,182,4,13,17,23.5%,1h
47439,3,warior,1954,123,3,4,7,42.9%,25m
47439,3,lilas,1954,95,2,1,3,66.7%,21m
47439,3,bömböldár,1954,58,2,7,9,22.2%,1h
47439,1,mikdellangel,1954,0,1,8,9,11.1%,7m
47439,3,fepz,1954,0,0,1,1,0.0%,13m
47439,1,[oOrni]DonMwanou,1954,0,0,5,5,0.0%,1h
47439,3,картошка,1954,0,0,7,7,0.0%,8m
47459,3,Dobbi,1953,919,37,43,80,46.2%,21m
47459,2,Hezha,1953,789,27,40,67,40.3%,29m
47459,3,CatNarcet,1953,430,16,15,31,51.6%,13m
47459,3,Silverblest,1953,450,16,30,46,34.8%,3m
47459,3,Koosie,1953,328,11,13,24,45.8%,1h
47459,3,[258]Alexzed,1953,268,10,12,22,45.5%,1h
47459,3,Duke,1953,272,10,12,22,45.5%,1h
47459,3,Noobibi,1953,295,9,19,28,32.1%,1h
47459,3,[АРМАДА]Носочек,1953,219,7,2,9,77.8%,32m
47459,3,SpartanRider,1953,202,7,10,17,41.2%,3m
47459,3,saccomanno,1953,154,5,5,10,50.0%,15m
47459,2,xXxMoinker,1953,150,5,12,17,29.4%,32m
47459,3,MrCorp,1953,144,4,1,5,80.0%,28m
47459,1,Baio,1953,46,2,11,13,15.4%,10m
47459,3,Master,1953,0,1,1,2,50.0%,22m
47459,3,[290720]ComanderFabi,1953,93,1,1,2,50.0%,11m
47459,3,ХанХатет,1953,0,0,1,1,0.0%,13m
47459,3,Skyraptor,1953,0,0,1,1,0.0%,26m
47459,3,Bexrami,1953,0,0,1,1,0.0%,12m
47459,1,[basdp]Metalpunker,1953,0,0,4,4,0.0%,10m
47459,3,Conqueror,1953,0,0,5,5,0.0%,1h
47459,3,Znatodar,1953,0,0,6,6,0.0%,1h
47481,3,FREN,1952,938,37,40,77,48.1%,13m
47481,3,[45454]wutanglaon,1952,638,21,30,51,41.2%,35m
47481,1,HarryPotatis,1952,484,16,26,42,38.1%,27m
47481,2,ShejTWOud,1952,148,15,18,33,45.5%,1h
47481,3,RoughNeck,1952,321,14,11,25,56.0%,1h
47481,2,TheJakub,1952,257,8,10,18,44.4%,22m
47481,1,wildpants,1952,288,8,16,24,33.3%,6m
47481,3,rekdgom,1952,194,6,2,8,75.0%,24m
47481,3,greymon,1952,144,6,4,10,60.0%,24m
47481,3,seven,1952,88,4,3,7,57.1%,1h
47481,3,Gamer,1952,171,4,7,11,36.4%,1h
47481,2,honi,1952,130,3,11,14,21.4%,13m
47481,2,KamiNari,1952,138,3,13,16,18.8%,1h
47481,3,Alcarent,1952,30,2,1,3,66.7%,4m
47481,3,Pazuzu,1952,30,2,5,7,28.6%,1h
47481,3,цербер,1952,95,2,5,7,28.6%,1h
47481,3,Pawel,1952,30,2,6,8,25.0%,4m
47481,2,danielrm,1952,66,2,14,16,12.5%,1h
47481,1,FlyTrox,1952,0,1,1,2,50.0%,27m
47481,3,[OPMFS]adrian,1952,30,1,7,8,12.5%,11m
47481,3,cfiffi,1952,30,1,7,8,12.5%,24m
47481,3,Joke,1952,0,0,1,1,0.0%,10m
47481,3,Akryon,1952,0,0,1,1,0.0%,1h
47481,3,roadkill,1952,0,0,1,1,0.0%,31m
47481,3,furious,1952,0,0,6,6,0.0%,32m
47481,3,JonyRico,1952,0,0,6,6,0.0%,27m
47507,3,Waldorf,1951,1604,136,175,311,43.7%,1h
47507,2,kobarb,1951,974,35,43,78,44.9%,15m
47507,3,Alialo,1951,662,23,32,55,41.8%,1h
47507,3,Abansaban,1951,359,13,4,17,76.5%,24m
47507,3,Gabounch,1951,380,13,21,34,38.2%,1h
47507,3,[BZs]Eaglearchie,1951,277,11,13,24,45.8%,21m
47507,3,KASZA,1951,220,6,10,16,37.5%,1h
47507,3,LRD,1951,152,6,11,17,35.3%,26m
47507,2,Zin,1951,144,5,8,13,38.5%,1h
47507,3,arakkee,1951,0,4,1,5,80.0%,13m
47507,1,RazemouzeN,1951,168,3,12,15,20.0%,1h
47507,3,arsénne,1951,30,2,3,5,40.0%,1h
47507,1,frantimir,1951,0,2,9,11,18.2%,8m
47507,1,Kiaurutis,1951,38,2,9,11,18.2%,33m
47507,3,Madcow,1951,30,1,4,5,20.0%,32m
47507,3,lampa,1951,42,1,4,5,20.0%,1h
47507,3,darkdragon,1951,0,0,4,4,0.0%,1h
47507,3,TPanda,1951,0,0,6,6,0.0%,32m
47507,3,Aspasia,1951,0,0,6,6,0.0%,35m
47507,2,mrgrunge,1951,0,0,7,7,0.0%,21m
47507,3,PeacDato,1951,0,0,7,7,0.0%,29m
47507,2,Cronous,1951,0,0,8,8,0.0%,1h
47507,1,hbnpc,1951,0,0,8,8,0.0%,1h
47530,3,oilused,1950,1408,53,59,112,47.3%,1h
47530,3,БыдЛорд,1950,227,14,15,29,48.3%,21m
47530,3,[PTVru]BigD,1950,348,13,13,26,50.0%,1h
47530,3,LARO,1950,297,11,22,33,33.3%,35m
47530,3,BooMBorG,1950,214,7,9,16,43.8%,1h
47530,3,WindCent,1950,213,6,4,10,60.0%,25m
47530,3,ssz,1950,120,5,8,13,38.5%,1h
47530,3,WiljamKayn,1950,148,5,10,15,33.3%,1h
47530,3,AzA,1950,100,3,5,8,37.5%,28m
47530,2,sSKILLSs,1950,0,3,5,8,37.5%,30m
47530,3,zele,1950,30,1,1,2,50.0%,1h
47530,3,elias,1950,30,1,4,5,20.0%,1h
47530,3,obiksus,1950,0,0,3,3,0.0%,28m
47530,3,Otstoy,1950,0,0,4,4,0.0%,1h
47530,3,oldskul,1950,0,0,6,6,0.0%,1h
47545,3,vili,1949,1431,107,127,234,45.7%,9m
47545,3,bala,1949,1564,99,96,195,50.8%,27m
47545,2,Yolandi,1949,566,39,40,79,49.4%,21m
47545,3,zef,1949,854,33,43,76,43.4%,4m
47545,3,trimontcium,1949,766,29,33,62,46.8%,31m
47545,3,[shlk]Andy,1949,507,17,18,35,48.6%,1h
47545,3,ArLeg,1949,374,16,8,24,66.7%,31m
47545,3,MicxyDough,1949,400,16,13,29,55.2%,1h
47545,2,surfpirat,1949,420,14,25,39,35.9%,26m
47545,3,[Nastуa]NARIMAN,1949,271,9,10,19,47.4%,10m
47545,2,Miaumiau,1949,252,9,19,28,32.1%,26m
47545,3,lamba,1949,291,8,15,23,34.8%,1h
47545,3,Pharell,1949,180,6,8,14,42.9%,11m
47545,2,teubise,1949,178,6,12,18,33.3%,1h
47545,1,Marko,1949,275,5,9,14,35.7%,10m
47545,3,Logos,1949,136,4,8,12,33.3%,28m
47545,3,SpeXX,1949,144,3,2,5,60.0%,13m
47545,2,CHEKOPATO,1949,0,3,4,7,42.9%,1h
47545,3,Reflexion,1949,30,2,1,3,66.7%,1h
47545,3,iTzVodka,1949,119,2,1,3,66.7%,1h
47545,2,Supermarine,1949,0,2,6,8,25.0%,1h
47545,3,Rori,1949,0,1,4,5,20.0%,1h
47545,3,[DCtrl]KillerKalle,1949,0,0,1,1,0.0%,31m
47545,3,lemarineroya,1949,0,0,1,1,0.0%,9m
47545,3,matt,1949,0,0,2,2,0.0%,29m
47570,3,Lordes,1948,1571,158,198,356,44.4%,1h
47570,3,Sgarnica,1948,1546,104,105,209,49.8%,23m
47570,2,Fermer,1948,1551,55,75,130,42.3%,13m
47570,2,[RonSwn]SalTFrog,1948,687,28,36,64,43.8%,1m
47570,3,DINDALUS,1948,523,27,25,52,51.9%,1h
47570,3,BronzeMaster,1948,552,26,7,33,78.8%,1h
47570,2,[Hrѓ]mahmedin,1948,628,24,37,61,39.3%,1h
47570,3,BrentheGreat,1948,500,20,7,27,74.1%,13m
47570,3,thd,1948,484,18,24,42,42.9%,1h
47570,3,Poostie,1948,197,12,9,21,57.1%,1h
47570,1,BazingaPwndU,1948,259,8,16,24,33.3%,1h
47570,3,BLOWYABITCH,1948,90,7,6,13,53.8%,13m
47570,3,[nWss]llllllllllRa,1948,147,4,2,6,66.7%,1h
47570,3,Torgor,1948,0,4,3,7,57.1%,1h
47570,3,[HMarch]CyberKNIGHT,1948,122,4,8,12,33.3%,1h
47570,3,ROBAQ,1948,119,3,6,9,33.3%,35m
47570,3,Hitlerjugend,1948,121,2,1,3,66.7%,21m
47570,2,Algi,1948,76,2,9,11,18.2%,21m
47570,1,Wave,1948,97,2,11,13,15.4%,2m
47570,3,[8kg]GERoyal,1948,0,1,0,1,100.0%,23m
47570,3,magicseaweed,1948,0,1,0,1,100.0%,3m
47570,3,Banderovets,1948,30,1,1,2,50.0%,1h
47570,2,Solomon,1948,44,1,1,2,50.0%,30m
47570,3,Perelshtein,1948,30,1,2,3,33.3%,15m
47570,3,vladaecа,1948,30,1,4,5,20.0%,13m
47570,3,sim,1948,0,0,1,1,0.0%,27m
47570,3,CREAM,1948,0,0,1,1,0.0%,27m
47570,3,Vovarussia,1948,0,0,1,1,0.0%,1h
47570,3,WrEcKiT,1948,0,0,2,2,0.0%,17m
47570,2,SyncroOKW,1948,0,0,3,3,0.0%,1h
47600,3,Solaina,1947,1553,254,302,556,45.7%,1h
47600,3,pmc,1947,1598,68,75,143,47.6%,35m
47600,3,FERCAN,1947,863,44,47,91,48.4%,17m
47600,3,Geisterhund,1947,712,27,23,50,54.0%,23m
47600,3,MatsGrin,1947,628,22,28,50,44.0%,15m
47600,2,bango,1947,516,20,26,46,43.5%,1h
47600,2,MAJORNICO,1947,479,19,29,48,39.6%,1h
47600,1,svoloch,1947,408,18,20,38,47.4%,1h
47600,2,рейнор,1947,454,17,27,44,38.6%,2m
47600,3,Цезарь,1947,376,14,26,40,35.0%,23m
47600,3,Flashheart,1947,220,12,12,24,50.0%,1h
47600,2,Zpapa,1947,332,12,20,32,37.5%,1h
47600,3,Chupakabra,1947,256,10,9,19,52.6%,1h
47600,2,Indelion,1947,262,9,18,27,33.3%,13m
47600,1,BaloAwp,1947,238,8,16,24,33.3%,6m
47600,3,toretore,1947,171,5,2,7,71.4%,1h
47600,2,JustLearning,1947,184,5,7,12,41.7%,1h
47600,3,VIS,1947,90,4,6,10,40.0%,17m
47600,3,DiMON,1947,58,3,2,5,60.0%,1h
47600,2,Barcode,1947,90,3,7,10,30.0%,11m
47600,3,gouns,1947,0,1,0,1,100.0%,32m
47600,3,[BierG]MainRANDOM,1947,0,1,1,2,50.0%,21m
47600,3,raven,1947,30,1,4,5,20.0%,23m
47600,3,Itsotgaydude,1947,30,1,4,5,20.0%,25m
47600,3,RENOX,1947,30,1,7,8,12.5%,1h
47625,3,novichok,1946,1456,68,74,142,47.9%,1h
47625,1,ministruu,1946,1224,64,77,141,45.4%,14m
47625,3,whitelight,1946,1010,35,43,78,44.9%,1h
47625,3,JawaProg,1946,750,27,37,64,42.2%,31m
47625,3,[HCCB]Heimdall,1946,327,16,24,40,40.0%,1h
47625,3,theboxghost,1946,434,15,19,34,44.1%,1h
47625,2,Woongda,1946,210,7,17,24,29.2%,1m
47625,1,coolSnake,1946,142,6,13,19,31.6%,1h
47625,3,Destructor,1946,116,5,4,9,55.6%,1h
47625,3,panix,1946,139,4,4,8,50.0%,32m
47625,3,Dolf,1946,121,3,0,3,100.0%,27m
47625,3,AcTePuu,1946,58,3,2,5,60.0%,1h
47625,3,Gravity,1946,68,2,6,8,25.0%,16m
47625,3,[SNheta]Magellan,1946,0,1,1,2,50.0%,1h
47625,2,[Catory]Kychcio,1946,0,0,3,3,0.0%,1h
47625,2,[OneLov]Kartman,1946,0,0,8,8,0.0%,21m
47641,2,Strachu,1945,1586,192,207,399,48.1%,1h
47641,3,Rudey,1945,1355,55,63,118,46.6%,1h
47641,3,SonicRim,1945,622,22,25,47,46.8%,32m
47641,3,daarkflofloo,1945,572,19,26,45,42.2%,32m
47641,3,DrCholman,1945,464,16,24,40,40.0%,21m
47641,2,Devillos,1945,280,10,22,32,31.2%,11m
47641,1,HCMTR,1945,252,9,18,27,33.3%,34m
47641,3,Moulos,1945,155,4,12,16,25.0%,13m
47641,1,llllllllllll,1945,190,4,12,16,25.0%,11m
47641,3,limolion,1945,123,2,6,8,25.0%,35m
47641,2,Kaiser,1945,30,2,7,9,22.2%,17m
47641,3,GgWpMarsWF,1945,0,1,0,1,100.0%,15m
47641,3,MAX,1945,30,1,1,2,50.0%,1h
47641,1,smeini,1945,0,1,9,10,10.0%,1h
47641,1,Dakar,1945,0,0,3,3,0.0%,1h
47641,3,Enfer,1945,0,0,5,5,0.0%,11m
47641,3,Ponyalone,1945,0,0,6,6,0.0%,9m
47658,2,лысыЙЙожыг,1944,1509,67,76,143,46.9%,1h
47658,2,tal,1944,1074,53,65,118,44.9%,1h
47658,3,Alex,1944,1306,50,49,99,50.5%,1h
47658,3,ramzes,1944,912,38,30,68,55.9%,1h
47658,2,Idogor,1944,1068,37,48,85,43.5%,14m
47658,3,BradToys,1944,843,30,37,67,44.8%,6m
47658,2,troyou,1944,137,6,8,14,42.9%,15m
47658,2,Analog,1944,106,4,11,15,26.7%,1h
47658,3,life,1944,58,3,3,6,50.0%,21m
47658,3,InSanguinum,1944,90,3,6,9,33.3%,27m
47658,3,ROCKETxSPUDZ,1944,76,3,6,9,33.3%,35m
47658,3,TioPaco,1944,48,2,0,2,100.0%,27m
47658,2,вцук,1944,34,2,10,12,16.7%,33m
47658,2,frosty,1944,0,1,0,1,100.0%,1h
47658,3,Fatality,1944,30,1,7,8,12.5%,3m
47658,3,lelynx,1944,0,0,1,1,0.0%,1h
47658,3,СекторГаза,1944,0,0,1,1,0.0%,1h
47658,3,Seva,1944,0,0,2,2,0.0%,30m
47658,3,[TWO]FlexK,1944,0,0,3,3,0.0%,23m
47658,1,Гущин,1944,0,0,3,3,0.0%,1m
47678,2,[C12760]River,1943,1471,90,97,187,48.1%,31m
47678,2,IoanTM,1943,1573,67,72,139,48.2%,21m
47678,3,ShadowDragon,1943,1197,48,48,96,50.0%,1h
47678,3,Filippo,1943,1111,45,49,94,47.9%,1h
47678,3,[ROTSe]DukE,1943,1077,41,44,85,48.2%,15m
47678,3,tothur,1943,514,15,23,38,39.5%,32m
47678,3,[RedPen]Salamiwurst,1943,334,12,15,27,44.4%,29m
47678,3,[Moskva]Андрей,1943,292,9,9,18,50.0%,1h
47678,1,Silverdeer,1943,204,8,18,26,30.8%,31m
47678,3,sss,1943,236,7,9,16,43.8%,13m
47678,1,KAKUbro,1943,203,7,22,29,24.1%,1h
47678,3,[mfxed]Pixel,1943,146,5,9,14,35.7%,15m
47678,2,Dantees,1943,156,5,15,20,25.0%,13m
47678,1,cTepBoчКа,1943,110,4,12,16,25.0%,3m
47678,3,zovir,1943,149,3,9,12,25.0%,1h
47678,3,ккв,1943,30,2,1,3,66.7%,3m
47678,3,[SRAM]WhiskeyJack,1943,30,2,7,9,22.2%,21m
47678,3,[Preyin]Kuraj,1943,66,2,14,16,12.5%,1h
47678,3,[SPAINs]Turel,1943,92,1,1,2,50.0%,28m
47678,3,Bancocoman,1943,0,1,4,5,20.0%,32m
47678,3,Mojo,1943,0,1,5,6,16.7%,1h
47678,3,MatWayQ,1943,0,0,1,1,0.0%,1h
47678,3,BiNgO,1943,0,0,2,2,0.0%,11m
47678,3,Austra,1943,0,0,2,2,0.0%,29m
47678,3,Nicolas,1943,0,0,2,2,0.0%,15m
47678,3,assasinsdude,1943,0,0,7,7,0.0%,17m
47704,3,erzhan,1942,684,43,59,102,42.2%,1h
47704,2,Paha,1942,718,33,35,68,48.5%,25m
47704,3,Chaika,1942,669,25,30,55,45.5%,1h
47704,3,[mfixed]TYTY,1942,437,17,13,30,56.7%,16m
47704,3,Rollmops,1942,476,17,22,39,43.6%,26m
47704,3,Melkior,1942,432,17,26,43,39.5%,31m
47704,3,Xanax,1942,363,12,8,20,60.0%,1h
47704,3,guguen,1942,278,10,12,22,45.5%,1h
47704,2,kola,1942,228,9,16,25,36.0%,3m
47704,3,claylord,1942,174,7,7,14,50.0%,1h
47704,3,WaszKu,1942,163,5,7,12,41.7%,1h
47704,1,stas,1942,124,5,15,20,25.0%,1h
47704,2,Barbarian,1942,88,4,9,13,30.8%,24m
47704,3,deredez,1942,182,4,12,16,25.0%,1h
47704,3,SilentSword,1942,30,3,5,8,37.5%,9m
47704,3,Winters,1942,97,3,13,16,18.8%,15m
47704,3,SuperAK,1942,0,1,0,1,100.0%,1h
47704,3,WoldLine,1942,30,1,2,3,33.3%,13m
47704,3,SucharL,1942,0,0,1,1,0.0%,17m
47704,3,Truta,1942,0,0,4,4,0.0%,1h
47704,3,Tanglydrop,1942,0,0,5,5,0.0%,32m
47704,3,[Zavood]Talupoeg,1942,0,0,5,5,0.0%,1h
47726,3,Alex,1941,1500,57,73,130,43.8%,1h
47726,3,White,1941,1028,46,50,96,47.9%,1h
47726,3,Kaos,1941,902,33,39,72,45.8%,26m
47726,3,LOLLOEFEDE,1941,990,33,53,86,38.4%,20m
47726,3,lol,1941,773,28,32,60,46.7%,24m
47726,3,Freshness,1941,338,22,23,45,48.9%,26m
47726,3,MamonTsS,1941,354,22,31,53,41.5%,1h
47726,2,[G4R3N]zero,1941,560,20,32,52,38.5%,1h
47726,3,Gyoxi,1941,485,17,16,33,51.5%,28m
47726,3,Vodka,1941,440,15,19,34,44.1%,1h
47726,3,Jormungandr,1941,268,9,14,23,39.1%,1h
47726,3,LisaPi,1941,251,7,17,24,29.2%,16m
47726,3,aso,1941,86,3,4,7,42.9%,1h
47726,3,IVAR,1941,30,2,4,6,33.3%,1h
47726,3,[aDGa]Kai,1941,58,2,8,10,20.0%,35m
47726,2,DARYL,1941,0,1,0,1,100.0%,1h
47726,3,Hestus,1941,30,1,4,5,20.0%,12m
47726,2,ZiRox,1941,0,1,7,8,12.5%,1h
47726,3,Hed,1941,88,1,8,9,11.1%,16m
47726,3,ginetto,1941,0,0,2,2,0.0%,3m
47726,3,Genodius,1941,0,0,3,3,0.0%,1h
47726,3,trilllkill,1941,0,0,6,6,0.0%,1h
47748,2,Kyriakos,1940,1512,80,93,173,46.2%,2m
47748,3,Voland,1940,674,24,30,54,44.4%,12m
47748,3,rubaxaNadeta,1940,390,13,22,35,37.1%,1h
47748,2,Territoriya,1940,412,13,24,37,35.1%,1h
47748,3,Skiller,1940,256,9,19,28,32.1%,35m
47748,3,HORUS,1940,203,8,11,19,42.1%,1h
47748,3,Pedrox,1940,164,7,18,25,28.0%,3m
47748,3,Ыштынгыздр,1940,90,4,4,8,50.0%,21m
47748,3,Cazdale,1940,30,3,3,6,50.0%,32m
47748,2,GRaider,1940,88,3,16,19,15.8%,27m
47748,3,artemch,1940,110,2,1,3,66.7%,4m
47748,2,[TeeK]MajorLeo,1940,46,2,10,12,16.7%,29m
47748,3,[IRvGI]vladosibl,1940,97,1,1,2,50.0%,1h
47748,2,jcccc,1940,0,1,2,3,33.3%,1h
47748,3,Areion,1940,30,1,5,6,16.7%,31m
47748,3,stacrafter,1940,0,0,7,7,0.0%,29m
47764,2,SubUrban,1939,950,163,182,345,47.2%,11m
47764,3,Youps,1939,716,47,41,88,53.4%,1h
47764,2,MicroFraud,1939,692,38,45,83,45.8%,1m
47764,2,AsA,1939,518,18,27,45,40.0%,31m
47764,3,monter,1939,339,12,10,22,54.5%,21m
47764,3,Vila,1939,290,9,9,18,50.0%,1h
47764,3,Baayo,1939,144,5,8,13,38.5%,26m
47764,3,KnightValmir,1939,148,5,17,22,22.7%,35m
47764,2,Lon,1939,44,3,8,11,27.3%,1h
47764,3,slegka,1939,0,2,2,4,50.0%,16m
47764,2,Lichtwangof,1939,0,1,0,1,100.0%,22m
47764,3,Loosey,1939,0,1,0,1,100.0%,1h
47764,3,Noir,1939,95,1,8,9,11.1%,1h
47764,2,[SPAINs]Mazakrador,1939,0,0,4,4,0.0%,5m
47778,2,APAN,1938,1424,140,153,293,47.8%,1h
47778,3,Krieg,1938,1503,93,92,185,50.3%,3m
47778,2,Grechkin,1938,923,39,47,86,45.3%,27m
47778,3,arterran,1938,953,32,35,67,47.8%,35m
47778,3,Captainkikou,1938,102,5,5,10,50.0%,1h
47778,3,Midas,1938,156,5,8,13,38.5%,9m
47778,3,kakitexnis,1938,167,4,8,12,33.3%,1h
47778,2,GeoCraft,1938,143,3,10,13,23.1%,1h
47778,3,ErelDin,1938,94,3,13,16,18.8%,1h
47778,1,[Kompis]Skaidragon,1938,123,2,5,7,28.6%,6m
47778,3,mazafaka,1938,60,2,8,10,20.0%,24m
47778,1,[Buddys]Demic,1938,40,2,12,14,14.3%,1h
47778,3,MicroWienver,1938,96,1,1,2,50.0%,29m
47778,2,Redshadow,1938,0,1,3,4,25.0%,3m
47778,3,Spajklsons,1938,0,0,1,1,0.0%,25m
47778,3,Gemachter,1938,0,0,1,1,0.0%,10m
47778,3,Cronos,1938,0,0,1,1,0.0%,13m
47778,3,АдскаяКухня,1938,0,0,1,1,0.0%,1h
47778,3,warhammer,1938,0,0,4,4,0.0%,1h
47797,3,gameshoot,1937,1098,49,51,100,49.0%,17m
47797,2,[II3II]SñrFuixench,1937,737,27,36,63,42.9%,19m
47797,3,[epc73]RichiTheLion,1937,719,25,33,58,43.1%,1h
47797,3,[NINJ88]Ragman,1937,580,21,25,46,45.7%,1h
47797,1,Žan,1937,376,13,22,35,37.1%,1h
47797,1,Cedchar,1937,344,10,15,25,40.0%,1h
47797,1,Zivcimen,1937,36,5,10,15,33.3%,22m
47797,2,britneyspear,1937,86,5,10,15,33.3%,16m
47797,3,servinaty,1937,122,4,7,11,36.4%,30m
47797,3,jejeff,1937,30,2,1,3,66.7%,31m
47797,3,nik,1937,120,2,1,3,66.7%,21m
47797,3,Warper,1937,62,2,5,7,28.6%,26m
47797,2,NUKESHIP,1937,30,1,6,7,14.3%,1h
47797,2,hristodjolev,1937,96,1,8,9,11.1%,1h
47811,3,[АNIМЕ]AleksA,1936,1112,70,82,152,46.1%,1h
47811,3,Spacetrooper,1936,1008,54,55,109,49.5%,1m
47811,3,Jens,1936,743,51,63,114,44.7%,1h
47811,3,Givingcube,1936,674,26,34,60,43.3%,1h
47811,3,даниил,1936,502,22,24,46,47.8%,7m
47811,3,Underworld,1936,500,19,27,46,41.3%,1h
47811,3,Zimity,1936,384,13,16,29,44.8%,1h
47811,3,Lazami,1936,326,11,18,29,37.9%,1h
47811,1,Zzz,1936,265,7,15,22,31.8%,1h
47811,3,JackKarver,1936,135,5,6,11,45.5%,12m
47811,3,kariestiger,1936,199,5,8,13,38.5%,1h
47811,3,[LIQUID]Giamo,1936,118,4,11,15,26.7%,1h
47811,3,JimmyNoodlez,1936,120,4,11,15,26.7%,28m
47811,2,Zmajmun,1936,80,3,19,22,13.6%,1h
47811,2,Konrad,1936,0,2,7,9,22.2%,1h
47811,3,Derek,1936,96,1,1,2,50.0%,1h
47811,3,[PSTLN]Wolko,1936,0,0,1,1,0.0%,13m
47811,2,Danisahne,1936,0,0,1,1,0.0%,1h
47811,3,Kamilostar,1936,0,0,1,1,0.0%,1h
47811,3,[HEIM]Symmetric,1936,0,0,3,3,0.0%,4m
47811,3,zloj,1936,0,0,6,6,0.0%,6m
47811,3,sportblr,1936,0,0,7,7,0.0%,1h
47833,2,DolceVita,1935,1391,87,90,177,49.2%,1h
47833,2,jummbo,1935,1152,39,52,91,42.9%,1h
47833,3,sckiller,1935,773,38,48,86,44.2%,1h
47833,3,ttoniax,1935,795,32,34,66,48.5%,24m
47833,3,LeBoss,1935,484,20,35,55,36.4%,30m
47833,3,Starling,1935,452,16,16,32,50.0%,13m
47833,3,KISS,1935,192,16,28,44,36.4%,29m
47833,3,MASTER,1935,257,11,9,20,55.0%,1h
47833,2,Alex,1935,214,8,10,18,44.4%,1h
47833,1,FeeLD,1935,216,7,15,22,31.8%,24m
47833,3,IcM,1935,188,6,13,19,31.6%,1h
47833,2,LOLIKHP,1935,208,5,5,10,50.0%,1h
47833,3,[NINJ88]Angel,1935,88,4,4,8,50.0%,16m
47833,1,CagaBlea,1935,90,4,13,17,23.5%,1h
47833,2,[N1TDA]pokara,1935,34,2,0,2,100.0%,1h
47833,3,snowwulf,1935,0,1,4,5,20.0%,29m
47833,3,Imperator,1935,30,1,4,5,20.0%,4m
47833,3,Кирил,1935,0,0,1,1,0.0%,1h
47833,2,CancelALEX,1935,0,0,7,7,0.0%,7m
47852,1,Leoniduss,1934,1528,54,71,125,43.2%,31m
47852,2,llllllllllll,1934,1183,49,67,116,42.2%,7m
47852,1,GwackMan,1934,848,29,43,72,40.3%,34m
47852,2,Loulou,1934,553,18,26,44,40.9%,25m
47852,3,kishin,1934,251,10,6,16,62.5%,1h
47852,2,Ringoman,1934,233,9,11,20,45.0%,14m
47852,3,sHArkeH,1934,209,7,5,12,58.3%,32m
47852,3,BLgamer,1934,245,7,18,25,28.0%,1h
47852,1,rex,1934,148,4,12,16,25.0%,1h
47852,3,nZee,1934,140,3,2,5,60.0%,35m
47852,3,[Magpie]Mariculus,1934,94,3,10,13,23.1%,3m
47852,2,Davenstein,1934,48,2,10,12,16.7%,1h
47852,2,kwoWRO,1934,0,1,0,1,100.0%,6m
47852,3,seeyaa,1934,0,1,5,6,16.7%,10m
47852,3,Kropot,1934,0,1,6,7,14.3%,1h
47852,3,DarkLicht,1934,30,1,7,8,12.5%,10m
47852,3,ТихийШторм,1934,0,0,1,1,0.0%,27m
47869,3,[OmDi]coc,1933,1563,134,149,283,47.3%,23m
47869,2,SUBZERO,1933,1515,128,137,265,48.3%,1h
47869,2,HITAME,1933,807,92,104,196,46.9%,16m
47869,3,roland,1933,1517,55,68,123,44.7%,1h
47869,3,TTJleyBoy,1933,1449,50,69,119,42.0%,6m
47869,3,Todos,1933,1016,39,37,76,51.3%,1h
47869,2,[HAVTT]arthos,1933,629,28,30,58,48.3%,1h
47869,1,[ZEDR]Calista,1933,464,15,24,39,38.5%,1h
47869,2,[AnGoSt]DanyaPyccom,1933,311,12,23,35,34.3%,33m
47869,3,Shiren,1933,279,10,10,20,50.0%,12m
47869,3,Taroline,1933,126,4,10,14,28.6%,12m
47869,3,Eduard,1933,141,3,4,7,42.9%,23m
47869,1,superbtr,1933,46,2,4,6,33.3%,1h
47869,2,Feri,1933,88,2,7,9,22.2%,1h
47869,2,Rebelle,1933,30,2,7,9,22.2%,17m
47869,3,PostMan,1933,97,1,1,2,50.0%,15m
47869,1,McCrank,1933,93,1,3,4,25.0%,10m
47869,1,maxDraco,1933,0,1,8,9,11.1%,1h
47869,3,Eli,1933,0,0,1,1,0.0%,1h
47869,1,Yushin,1933,0,0,2,2,0.0%,7m
47869,2,Oxer,1933,0,0,3,3,0.0%,1h
47869,3,bankai,1933,0,0,4,4,0.0%,1h
47869,2,hamatamna,1933,0,0,4,4,0.0%,1h
47892,3,adim,1932,1581,126,141,267,47.2%,1h
47892,2,Vlad,1932,1374,66,70,136,48.5%,31m
47892,2,Жора,1932,1177,61,52,113,54.0%,25m
47892,3,kury,1932,1016,58,63,121,47.9%,1h
47892,3,SeRCaNiGMa,1932,1128,44,47,91,48.4%,6m
47892,3,Pupsik,1932,445,42,42,84,50.0%,26m
47892,2,tytan,1932,1016,37,51,88,42.0%,32m
47892,3,FENIXTAN,1932,308,11,13,24,45.8%,1h
47892,3,Asmodei,1932,248,9,19,28,32.1%,1h
47892,3,Mamél,1932,309,9,23,32,28.1%,26m
47892,1,LennyPro,1932,194,5,6,11,45.5%,6m
47892,3,Cassperr,1932,146,5,7,12,41.7%,1h
47892,3,edulanarf,1932,171,5,10,15,33.3%,14m
47892,1,DuoPepsi,1932,102,5,14,19,26.3%,13m
47892,3,AlexsusD,1932,90,4,5,9,44.4%,1h
47892,3,Gottfridd,1932,0,2,3,5,40.0%,35m
47892,3,Eugene,1932,0,2,4,6,33.3%,24m
47892,3,Lukaz,1932,30,2,5,7,28.6%,23m
47892,3,Serj,1932,0,1,1,2,50.0%,1h
47892,3,Jannie,1932,0,1,4,5,20.0%,1h
47892,1,Ducke,1932,0,1,4,5,20.0%,1h
47892,3,Hellody,1932,30,1,6,7,14.3%,28m
47892,3,Tumis,1932,34,1,7,8,12.5%,33m
47892,3,[ЗИБиАГ]ЛукЗеленый,1932,0,0,1,1,0.0%,24m
47892,3,nordsee,1932,0,0,2,2,0.0%,1h
47892,3,[Dnmt]goalkeeper,1932,0,0,5,5,0.0%,26m
47892,3,Владислав,1932,0,0,6,6,0.0%,28m
47919,3,Manze,1931,1514,92,101,193,47.7%,1h
47919,3,Max,1931,1134,76,91,167,45.5%,3m
47919,3,barthss,1931,1586,64,68,132,48.5%,1h
47919,3,Parzao,1931,674,24,32,56,42.9%,31m
47919,3,[mfixed]stal,1931,514,20,14,34,58.8%,1h
47919,2,BarnacleBOY,1931,441,16,29,45,35.6%,11m
47919,3,SirSasi,1931,446,15,16,31,48.4%,3m
47919,3,[ST2SAS]kirkland,1931,233,7,8,15,46.7%,23m
47919,3,Howy,1931,148,5,8,13,38.5%,21m
47919,2,mike,1931,161,4,11,15,26.7%,13m
47919,2,Alcksore,1931,137,3,10,13,23.1%,1h
47919,2,sayurealboi,1931,72,3,11,14,21.4%,1h
47919,3,sonix,1931,119,2,5,7,28.6%,35m
47919,3,HerrDentist,1931,118,2,10,12,16.7%,1h
47919,3,Titom,1931,30,2,13,15,13.3%,9m
47919,3,WolfKey,1931,0,1,0,1,100.0%,1h
47919,1,[GenGG]Mamba,1931,30,1,32,33,3.0%,9m
47919,3,Luceat,1931,0,0,2,2,0.0%,1h
47919,2,hatrix,1931,0,0,3,3,0.0%,25m
47919,3,техас,1931,0,0,6,6,0.0%,30m
47939,2,Dimka,1930,676,73,70,143,51.0%,1h
47939,2,Luca,1930,1488,56,71,127,44.1%,6m
47939,3,Alfor,1930,1135,42,43,85,49.4%,1h
47939,3,Schorle,1930,1092,41,40,81,50.6%,1h
47939,3,Даве,1930,847,33,33,66,50.0%,21m
47939,2,[mfxed]JARU,1930,411,28,32,60,46.7%,13m
47939,3,[ccraft]EnneDue,1930,612,23,33,56,41.1%,31m
47939,3,TafT,1930,347,14,20,34,41.2%,1h
47939,1,PhiliPL,1930,386,14,22,36,38.9%,33m
47939,3,Starlight,1930,190,8,12,20,40.0%,21m
47939,3,Ruzzia,1930,120,5,4,9,55.6%,24m
47939,3,Claul,1930,140,4,0,4,100.0%,1h
47939,1,Joeshipday,1930,96,2,2,4,50.0%,1h
47939,3,LUPOIDEO,1930,30,2,7,9,22.2%,1h
47939,2,luntik,1930,0,1,2,3,33.3%,5m
47939,3,Tassadar,1930,46,1,4,5,20.0%,1h
47939,3,[TeamLB]тамплиер,1930,97,1,4,5,20.0%,17m
47939,1,lebac,1930,0,1,9,10,10.0%,1h
47939,3,Georgos,1930,0,0,1,1,0.0%,1h
47939,3,Merkan,1930,0,0,6,6,0.0%,1h
47959,2,vagos,1929,568,94,106,200,47.0%,1h
47959,3,Deve,1929,1269,49,52,101,48.5%,1h
47959,3,[Нrr]МИШКА,1929,778,29,31,60,48.3%,12m
47959,3,Naitan,1929,626,25,24,49,51.0%,26m
47959,3,Varyag,1929,532,19,27,46,41.3%,4m
47959,3,Boomer,1929,411,15,14,29,51.7%,3m
47959,3,SpeedRacer,1929,457,15,26,41,36.6%,16m
47959,3,[mpsi19]koteika,1929,363,13,17,30,43.3%,9m
47959,3,ualex,1929,364,13,18,31,41.9%,27m
47959,3,Raphy,1929,248,10,15,25,40.0%,24m
47959,3,Hiei,1929,212,9,21,30,30.0%,15m
47959,2,silver,1929,244,7,14,21,33.3%,13m
47959,3,Kaplan,1929,119,5,2,7,71.4%,26m
47959,3,Wolfen,1929,217,5,11,16,31.2%,35m
47959,2,Raid,1929,115,2,8,10,20.0%,27m
47959,3,[WMPA]Elronmcbong,1929,97,1,1,2,50.0%,15m
47959,3,laotemujeneu,1929,0,1,1,2,50.0%,1h
47959,3,Clark,1929,30,1,3,4,25.0%,15m
47959,3,Lommeboken,1929,0,1,4,5,20.0%,1h
47959,2,DaDi,1929,0,1,8,9,11.1%,1h
47959,3,Sasury,1929,0,0,2,2,0.0%,32m
47959,2,SiriuSnag,1929,0,0,7,7,0.0%,15m
47981,2,DaddyDeath,1928,1407,103,115,218,47.2%,29m
47981,3,Kablys,1928,1456,51,62,113,45.1%,1h
47981,3,Neumann,1928,856,34,34,68,50.0%,1h
47981,3,Isaenko,1928,625,24,24,48,50.0%,11m
47981,3,TanZZzzz,1928,578,22,25,47,46.8%,1h
47981,3,Stv,1928,452,16,25,41,39.0%,26m
47981,3,kamiel,1928,222,8,19,27,29.6%,1h
47981,2,CeleryBear,1928,168,5,12,17,29.4%,24m
47981,3,HERETIK,1928,137,4,9,13,30.8%,27m
47981,1,[spain8]ODIN,1928,70,3,11,14,21.4%,1h
47981,1,CkviLL,1928,48,2,11,13,15.4%,1h
47981,3,[SPAINs]Mmet,1928,0,1,6,7,14.3%,1h
47981,3,adingo,1928,0,0,1,1,0.0%,1h
47981,2,lasane,1928,0,0,3,3,0.0%,18m
47981,3,[masivv]sav,1928,0,0,8,8,0.0%,9m
47996,2,ardobabus,1927,1404,106,120,226,46.9%,21m
47996,2,drawkcab,1927,1534,63,79,142,44.4%,21m
47996,2,lihatskiy,1927,1456,59,65,124,47.6%,29m
47996,2,aticraft,1927,1361,58,68,126,46.0%,1h
47996,3,UDAV,1927,959,40,44,84,47.6%,1h
47996,3,Pszemek,1927,857,39,43,82,47.6%,23m
47996,3,Scojitsu,1927,712,36,51,87,41.4%,1h
47996,3,FCa,1927,691,27,25,52,51.9%,15m
47996,3,Sebter,1927,647,24,28,52,46.2%,35m
47996,3,сайнед,1927,588,22,28,50,44.0%,1h
47996,3,[ANREN]dimontas,1927,402,15,17,32,46.9%,21m
47996,3,[Goumag]GOUMANGE,1927,234,8,14,22,36.4%,1h
47996,1,Jotaspp,1927,236,7,15,22,31.8%,34m
47996,3,David,1927,239,6,13,19,31.6%,35m
47996,3,KANTUSA,1927,154,6,17,23,26.1%,17m
47996,3,Kraker,1927,96,5,1,6,83.3%,1h
47996,3,NoUpgrades,1927,144,5,6,11,45.5%,1h
47996,3,[ыв]Космос,1927,96,2,0,2,100.0%,3m
47996,2,Coffeemaker,1927,0,2,11,13,15.4%,1h
47996,3,ercanyahsi,1927,0,1,2,3,33.3%,12m
47996,3,пук,1927,0,1,2,3,33.3%,1h
47996,3,danogano,1927,0,1,4,5,20.0%,7m
47996,2,brodyaga,1927,46,1,9,10,10.0%,4m
47996,3,srečko,1927,0,0,1,1,0.0%,13m
47996,2,ŁysyXD,1927,0,0,1,1,0.0%,30m
47996,3,Kondratjuk,1927,0,0,3,3,0.0%,1h
47996,3,andy,1927,0,0,3,3,0.0%,1h
47996,3,shurkyj,1927,0,0,4,4,0.0%,1h
48024,2,Arkan,1926,1560,149,176,325,45.8%,16m
48024,3,[UYourS]Rahlok,1926,1479,60,77,137,43.8%,35m
48024,3,classic,1926,793,57,65,122,46.7%,1h
48024,2,Skakiller,1926,1049,40,48,88,45.5%,32m
48024,2,PraetorShane,1926,865,30,43,73,41.1%,16m
48024,3,[HMB666]Nightmare,1926,581,20,20,40,50.0%,1h
48024,3,[AMN]LorenzCraft,1926,554,19,25,44,43.2%,12m
48024,2,[OmDi]ThePriest,1926,528,18,30,48,37.5%,1h
48024,3,Keshloshka,1926,404,15,13,28,53.6%,10m
48024,3,[B76]Zorg,1926,443,14,29,43,32.6%,13m
48024,3,Kéno,1926,318,11,20,31,35.5%,1h
48024,3,Kupixer,1926,124,2,6,8,25.0%,32m
48024,2,Kavlitsa,1926,0,1,4,5,20.0%,1h
48024,2,IngvarRai,1926,44,1,4,5,20.0%,1h
48024,3,[Petruc]Charu,1926,0,0,1,1,0.0%,1h
48024,3,dawcanerki,1926,0,0,3,3,0.0%,1h
48024,3,StarShine,1926,0,0,5,5,0.0%,1h
48024,3,[SD2014]Wolfi,1926,0,0,7,7,0.0%,1h
48042,3,evgeny,1925,1561,69,82,151,45.7%,1h
48042,2,Romanello,1925,1066,60,70,130,46.2%,21m
48042,2,pikou,1925,540,39,53,92,42.4%,17m
48042,3,VeryEasyAI,1925,559,28,19,47,59.6%,35m
48042,3,Dark,1925,634,25,27,52,48.1%,1h
48042,3,xirux,1925,526,21,15,36,58.3%,1h
48042,2,mordred,1925,534,18,24,42,42.9%,15m
48042,3,YourSenpai,1925,199,6,11,17,35.3%,1h
48042,2,Eve,1925,298,6,13,19,31.6%,6m
48042,3,kingcarc,1925,150,5,10,15,33.3%,25m
48042,2,[man1]Stranghost,1925,132,4,12,16,25.0%,1h
48042,3,IIIIIIIIIIII,1925,58,3,2,5,60.0%,1h
48042,2,Paddy,1925,97,2,2,4,50.0%,1h
48042,3,Shpanit,1925,60,2,6,8,25.0%,32m
48042,3,ALEX,1925,96,1,1,2,50.0%,1h
48042,3,maks,1925,0,1,2,3,33.3%,18m
48042,3,fabibi,1925,0,1,4,5,20.0%,1h
48042,3,[MODRR]Botikario,1925,30,1,4,5,20.0%,29m
48042,3,jayjay,1925,0,0,1,1,0.0%,29m
48042,3,[ĦĦ]blackbrain,1925,0,0,3,3,0.0%,25m
48042,3,Серый,1925,0,0,3,3,0.0%,17m
48063,1,[SHTTP]BeautifulGG,1924,855,209,225,434,48.2%,32m
48063,3,Tapani,1924,1568,159,166,325,48.9%,1h
48063,3,Meralas,1924,1558,77,91,168,45.8%,23m
48063,3,WalterHelss,1924,1357,53,64,117,45.3%,18m
48063,3,[APMM]AidedColt,1924,791,45,41,86,52.3%,1h
48063,3,kiki,1924,610,34,36,70,48.6%,1h
48063,3,baladani,1924,668,26,31,57,45.6%,1h
48063,3,rumpsss,1924,560,20,24,44,45.5%,1h
48063,3,AMETIST,1924,360,17,19,36,47.2%,1h
48063,1,[Hairy]Chtulu,1924,442,17,26,43,39.5%,6m
48063,1,majestic,1924,318,11,23,34,32.4%,30m
48063,3,RiesterRente,1924,184,6,12,18,33.3%,1h
48063,3,FIDI,1924,168,5,2,7,71.4%,1h
48063,3,[DRTxd]TRYPPIX,1924,120,4,7,11,36.4%,14m
48063,3,Revoltatul,1924,90,3,5,8,37.5%,7m
48063,3,DerLauch,1924,30,2,2,4,50.0%,13m
48063,3,[NWGD]mrgamerasd,1924,117,2,3,5,40.0%,24m
48063,1,Madmex,1924,130,2,4,6,33.3%,6m
48063,1,Promarine,1924,48,2,6,8,25.0%,1h
48063,3,Alex,1924,30,1,2,3,33.3%,1h
48063,3,artik,1924,30,1,2,3,33.3%,1h
48063,3,TaXcoLleToR,1924,30,1,7,8,12.5%,1h
48063,3,Joël,1924,0,0,7,7,0.0%,1h
48086,3,Engineer,1923,1062,39,43,82,47.6%,1h
48086,3,Younes,1923,806,28,36,64,43.8%,13m
48086,2,Прыскин,1923,704,26,35,61,42.6%,33m
48086,2,jozsef,1923,735,26,43,69,37.7%,13m
48086,3,Kannabis,1923,536,18,32,50,36.0%,1h
48086,3,MorganSaturn,1923,220,8,14,22,36.4%,1h
48086,3,MazeX,1923,276,8,15,23,34.8%,1h
48086,3,KAMIKAZE,1923,156,7,21,28,25.0%,7m
48086,2,Blackbird,1923,218,5,13,18,27.8%,1h
48086,3,KADETUSHKA,1923,60,3,2,5,60.0%,1h
48086,3,Wizard,1923,154,3,11,14,21.4%,14m
48086,3,Alfredo,1923,30,2,2,4,50.0%,1h
48086,3,sleepybear,1923,58,2,3,5,40.0%,1h
48086,3,[HBGG]TheSwarm,1923,30,2,6,8,25.0%,17m
48086,3,[Kach96]KipisH,1923,0,1,0,1,100.0%,1h
48086,3,pepeboi,1923,0,0,1,1,0.0%,12m
48086,3,[VoiDTS]Elytra,1923,0,0,7,7,0.0%,1h
48086,2,Noja,1923,0,0,7,7,0.0%,15m
48104,3,[FR1]solarisapien,1922,1179,140,210,350,40.0%,1h
48104,3,[MrPe]yoeloy,1922,1548,100,113,213,46.9%,1h
48104,3,packer,1922,924,35,37,72,48.6%,2m
48104,3,ufx,1922,468,16,25,41,39.0%,14m
48104,3,Giray,1922,258,7,11,18,38.9%,1h
48104,1,Medz,1922,146,4,13,17,23.5%,13m
48104,3,HeyNaz,1922,153,3,6,9,33.3%,26m
48104,2,SasNyi,1922,90,3,12,15,20.0%,1h
48104,3,[ALO]Altayr,1922,0,1,1,2,50.0%,1h
48104,3,[Falka]Mark,1922,0,1,3,4,25.0%,12m
48104,3,simon,1922,0,0,1,1,0.0%,3m
48104,3,Doner,1922,0,0,1,1,0.0%,1h
48104,3,Кароль,1922,0,0,5,5,0.0%,1h
48104,3,BESHANYI,1922,0,0,6,6,0.0%,1h
48118,2,manu,1921,381,59,58,117,50.4%,1h
48118,3,Efffgen,1921,992,40,43,83,48.2%,7m
48118,3,Sheeweluch,1921,645,20,36,56,35.7%,6m
48118,3,[Gordi]Mike,1921,394,14,13,27,51.9%,28m
48118,1,[XOCHO]moverie,1921,176,9,14,23,39.1%,30m
48118,3,Redafalt,1921,30,5,11,16,31.2%,1h
48118,3,CyberOttoman,1921,102,5,16,21,23.8%,1h
48118,3,kekdambaz,1921,122,4,8,12,33.3%,1h
48118,3,kacbi,1921,36,2,2,4,50.0%,32m
48118,3,pavel,1921,97,2,10,12,16.7%,1h
48118,2,[NepSAO]Rubin,1921,0,1,0,1,100.0%,27m
48118,3,[2427]FisTo,1921,96,1,1,2,50.0%,35m
48118,2,BLAZE,1921,30,1,11,12,8.3%,22m
48118,3,danibuj,1921,0,0,1,1,0.0%,32m
48118,3,sard,1921,0,0,2,2,0.0%,1h
48118,3,Грин,1921,0,0,7,7,0.0%,27m
48134,2,Willhelm,1920,1170,49,51,100,49.0%,2m
48134,3,ObeOne,1920,843,37,25,62,59.7%,27m
48134,3,Ignacio,1920,606,22,22,44,50.0%,15m
48134,3,Mac,1920,482,17,20,37,45.9%,18m
48134,2,Atlas,1920,295,12,15,27,44.4%,22m
48134,3,Alien,1920,94,4,11,15,26.7%,15m
48134,3,yeti,1920,112,3,5,8,37.5%,4m
48134,3,URIUS,1920,30,2,2,4,50.0%,32m
48134,3,DNice,1920,68,2,6,8,25.0%,17m
48134,1,Flitzi,1920,30,2,9,11,18.2%,1h
48134,3,ThunderStef,1920,96,1,1,2,50.0%,23m
48134,1,Jhonn,1920,0,1,8,9,11.1%,1h
48134,3,[InTime]WarParadigm,1920,0,0,1,1,0.0%,1h
48134,1,[Смэрть]NeaxtiGame,1920,0,0,1,1,0.0%,4m
48148,3,Christina,1919,1320,56,60,116,48.3%,1h
48148,1,WhySoSerious,1919,1334,47,64,111,42.3%,24m
48148,2,DougieB,1919,1001,35,49,84,41.7%,27m
48148,2,Xurisso,1919,694,28,37,65,43.1%,15m
48148,2,[PGYT]LiquidClem,1919,498,17,29,46,37.0%,20m
48148,1,Allexus,1919,484,16,19,35,45.7%,16m
48148,2,МАN,1919,424,13,21,34,38.2%,20m
48148,3,volk,1919,311,10,7,17,58.8%,1h
48148,3,[54D]doni,1919,226,7,15,22,31.8%,27m
48148,1,rubick,1919,258,7,15,22,31.8%,1m
48148,1,ASahlin,1919,194,7,16,23,30.4%,25m
48148,3,darkstar,1919,120,5,6,11,45.5%,28m
48148,3,enigma,1919,122,5,12,17,29.4%,1h
48148,1,Haba,1919,224,5,15,20,25.0%,3m
48148,1,mootoo,1919,110,4,5,9,44.4%,5m
48148,3,Panda,1919,0,3,2,5,60.0%,1h
48148,3,dertkaes,1919,94,3,10,13,23.1%,16m
48148,3,Sparkle,1919,0,2,3,5,40.0%,6m
48148,2,pacack,1919,0,2,6,8,25.0%,1h
48148,3,gigafreak,1919,34,1,8,9,11.1%,27m
48148,3,Гудзон,1919,0,0,1,1,0.0%,1h
48148,2,LuckyMen,1919,0,0,4,4,0.0%,1h
48170,3,Karatel,1918,1562,163,192,355,45.9%,24m
48170,3,MARIO,1918,772,67,80,147,45.6%,27m
48170,2,sasou,1918,1156,60,60,120,50.0%,33m
48170,2,Horstine,1918,408,53,46,99,53.5%,6m
48170,3,Dimonpokimon,1918,790,34,32,66,51.5%,1h
48170,3,IIkar,1918,593,20,28,48,41.7%,1h
48170,3,nerazim,1918,466,17,19,36,47.2%,1h
48170,3,dernor,1918,298,10,15,25,40.0%,28m
48170,3,gamlet,1918,273,9,4,13,69.2%,16m
48170,3,hlop,1918,208,6,14,20,30.0%,14m
48170,3,maesking,1918,58,3,3,6,50.0%,2m
48170,3,EGOR,1918,145,3,3,6,50.0%,15m
48170,3,ViroS,1918,120,3,6,9,33.3%,23m
48170,1,pofigy,1918,193,3,9,12,25.0%,1h
48170,3,kruiz,1918,97,2,1,3,66.7%,1h
48170,3,Stranken,1918,0,2,4,6,33.3%,13m
48170,2,Ivronens,1918,46,2,9,11,18.2%,1h
48170,3,[LMBD]Dynamıc,1918,96,1,2,3,33.3%,32m
48170,3,FuZZiX,1918,30,1,4,5,20.0%,28m
48170,3,[черепо]клоунпадре,1918,0,0,1,1,0.0%,28m
48170,1,Элик,1918,0,0,1,1,0.0%,1h
48170,2,Дмитрий,1918,0,0,2,2,0.0%,19m
48170,2,Brzozaty,1918,0,0,8,8,0.0%,18m
48170,2,DinorD,1918,0,0,10,10,0.0%,22m
48194,2,Ghostwriter,1917,1395,125,132,257,48.6%,1h
48194,3,Numbridge,1917,1354,59,67,126,46.8%,26m
48194,3,RamsesII,1917,840,30,38,68,44.1%,13m
48194,3,rufy,1917,693,27,39,66,40.9%,1h
48194,3,smok,1917,617,21,26,47,44.7%,1h
48194,3,ToniPetroChi,1917,458,17,20,37,45.9%,1h
48194,3,Mariño,1917,471,16,19,35,45.7%,1h
48194,1,pingouino,1917,440,13,19,32,40.6%,27m
48194,3,Miszardmta,1917,329,11,22,33,33.3%,1h
48194,1,JuanRam,1917,264,9,7,16,56.2%,13m
48194,3,FlaVaNche,1917,206,7,10,17,41.2%,1h
48194,3,Emfit,1917,249,7,14,21,33.3%,14m
48194,1,lolpeep,1917,232,5,11,16,31.2%,19m
48194,1,Jest,1917,92,3,0,3,100.0%,6m
48194,3,VOID,1917,30,2,2,4,50.0%,29m
48194,2,Don,1917,119,2,9,11,18.2%,22m
48194,2,BlaCKinbom,1917,90,2,11,13,15.4%,18m
48194,2,Mors,1917,0,1,1,2,50.0%,1h
48194,3,Buerebista,1917,30,1,3,4,25.0%,32m
48194,2,Sieiro,1917,46,1,10,11,9.1%,32m
48194,1,FasTuber,1917,48,1,10,11,9.1%,1h
48194,1,[TDGF]MrEisenhauer,1917,0,0,1,1,0.0%,25m
48194,3,Seraphim,1917,0,0,1,1,0.0%,18m
48194,1,STRELOK,1917,73,0,7,7,0.0%,1h
48194,3,Decikus,1917,0,0,7,7,0.0%,17m
48219,3,fxPavel,1916,576,20,32,52,38.5%,12m
48219,3,Swallowtail,1916,308,11,13,24,45.8%,1h
48219,3,NazarMarlinn,1916,146,7,10,17,41.2%,7m
48219,2,YaldiBA,1916,116,3,7,10,30.0%,14m
48219,3,Mike,1916,0,1,2,3,33.3%,1h
48219,3,Aemyl,1916,34,1,3,4,25.0%,1h
48219,3,Usiobrzusio,1916,36,1,7,8,12.5%,33m
48219,3,Saervak,1916,0,0,3,3,0.0%,1h
48219,2,gagge,1916,0,0,3,3,0.0%,5m
48228,2,Fhiligranhas,1915,1502,55,76,131,42.0%,1h
48228,1,EnVill,1915,1122,39,56,95,41.1%,2m
48228,1,Caroline,1915,847,25,19,44,56.8%,34m
48228,3,Spleenfloyd,1915,651,24,35,59,40.7%,1h
48228,3,IamDanielV,1915,427,19,13,32,59.4%,1h
48228,3,trash,1915,328,17,28,45,37.8%,1h
48228,3,BlueFox,1915,424,15,14,29,51.7%,1h
48228,3,Manore,1915,357,11,16,27,40.7%,1h
48228,3,Mikkunen,1915,300,10,13,23,43.5%,28m
48228,3,MIKO,1915,172,6,10,16,37.5%,4m
48228,3,[Furios]Feqir,1915,185,5,5,10,50.0%,15m
48228,1,мастер,1915,191,4,8,12,33.3%,1h
48228,1,Pukabuk,1915,140,3,12,15,20.0%,34m
48228,3,Pfau,1915,30,2,2,4,50.0%,29m
48228,3,tyoma,1915,0,1,1,2,50.0%,1h
48228,3,adato,1915,30,1,4,5,20.0%,7m
48228,3,Anduril,1915,0,0,1,1,0.0%,1h
48228,3,daeeeee,1915,0,0,2,2,0.0%,1h
48228,3,Kryalx,1915,0,0,3,3,0.0%,11m
48228,1,IIIIIIIII,1915,73,0,3,3,0.0%,1h
48228,1,Diegochung,1915,0,0,4,4,0.0%,29m
48228,2,Samsamuel,1915,0,0,4,4,0.0%,27m
48250,2,Mario,1914,1108,100,116,216,46.3%,1h
48250,3,empowered,1914,1371,94,112,206,45.6%,27m
48250,3,Mannfort,1914,1242,92,102,194,47.4%,12m
48250,1,netfox,1914,1234,86,112,198,43.4%,5m
48250,1,OvO,1914,817,40,52,92,43.5%,20m
48250,3,[Snаkеs]Cobalt,1914,949,36,40,76,47.4%,23m
48250,3,antony,1914,652,24,27,51,47.1%,1h
48250,3,Craisedx,1914,470,17,16,33,51.5%,23m
48250,3,[lPKTl]SENTINEL,1914,325,11,15,26,42.3%,1h
48250,3,Robert,1914,228,7,20,27,25.9%,13m
48250,3,CCCPRussia,1914,92,4,7,11,36.4%,1h
48250,2,Luxck,1914,133,3,3,6,50.0%,1h
48250,3,ragnarok,1914,94,3,7,10,30.0%,1h
48250,3,Zag,1914,117,2,3,5,40.0%,2m
48250,2,Ironsnake,1914,0,2,12,14,14.3%,1h
48250,1,KWASI,1914,0,1,3,4,25.0%,25m
48250,2,saske,1914,96,1,10,11,9.1%,25m
48250,3,[NGEGNE]Xeno,1914,0,0,1,1,0.0%,32m
48250,3,ponyraider,1914,0,0,3,3,0.0%,13m
48250,1,Leonidas,1914,73,0,8,8,0.0%,2m
48270,2,RonZ,1913,1207,51,45,96,53.1%,1h
48270,3,oMan,1913,779,38,46,84,45.2%,15m
48270,3,Jason,1913,574,20,25,45,44.4%,18m
48270,3,shakur,1913,582,20,27,47,42.6%,1h
48270,3,Ajiexsia,1913,355,12,14,26,46.2%,11m
48270,3,makotek,1913,248,10,17,27,37.0%,14m
48270,3,ThoodTheNoOb,1913,249,9,8,17,52.9%,1h
48270,3,javierson,1913,154,5,11,16,31.2%,1h
48270,1,PEDRITO,1913,132,4,3,7,57.1%,4m
48270,1,Solei,1913,44,2,4,6,33.3%,1h
48270,3,Michael,1913,0,0,2,2,0.0%,14m
48270,3,NightSkyy,1913,0,0,2,2,0.0%,17m
48270,3,MonsterKevin,1913,0,0,4,4,0.0%,16m
48270,2,[МЕD0ED]Ekranial,1913,0,0,5,5,0.0%,17m
48284,2,red,1912,1598,288,322,610,47.2%,1h
48284,3,wickedMihai,1912,936,50,53,103,48.5%,1h
48284,3,marinebig,1912,1006,40,41,81,49.4%,29m
48284,1,Kagayaga,1912,646,21,26,47,44.7%,1h
48284,3,Отчаяный,1912,474,18,15,33,54.5%,17m
48284,3,GiveSmile,1912,394,14,20,34,41.2%,1h
48284,1,[Foki]Nutcase,1912,282,6,5,11,54.5%,1h
48284,1,NoName,1912,218,6,10,16,37.5%,1h
48284,2,Stifler,1912,76,5,8,13,38.5%,1h
48284,3,Baw,1912,115,3,3,6,50.0%,32m
48284,3,SadBanjo,1912,46,1,2,3,33.3%,18m
48284,1,Diniskoff,1912,94,1,3,4,25.0%,1h
48284,1,Dukehugo,1912,0,0,1,1,0.0%,1h
48284,2,sirjohnne,1912,0,0,4,4,0.0%,1h
48284,3,OperCWALL,1912,0,0,5,5,0.0%,12m
48284,2,BestManOverW,1912,0,0,7,7,0.0%,12m
48284,2,Grivius,1912,0,0,8,8,0.0%,1h
48301,3,Speld,1911,1495,91,105,196,46.4%,1h
48301,3,Sarek,1911,1224,61,64,125,48.8%,15m
48301,3,littlepanda,1911,516,18,21,39,46.2%,7m
48301,3,KAST,1911,182,6,12,18,33.3%,7m
48301,2,[OTLSS]wyvernheart,1911,130,4,9,13,30.8%,1h
48301,2,Bobo,1911,58,2,10,12,16.7%,1h
48301,1,Sofus,1911,48,1,1,2,50.0%,18m
48301,1,Leo,1911,0,1,1,2,50.0%,8m
48301,3,Espen,1911,30,1,7,8,12.5%,1h
48301,1,[SD420]zoro,1911,0,0,1,1,0.0%,1h
48301,3,кирилл,1911,0,0,1,1,0.0%,32m
48301,2,[wpwpwp]TEMBINP,1911,0,0,2,2,0.0%,1h
48301,2,[nWss]CRONOS,1911,0,0,4,4,0.0%,1h
48301,3,[TDRUS]PhonkOneLove,1911,0,0,5,5,0.0%,1h
48301,3,Evonick,1911,0,0,7,7,0.0%,17m
48316,3,CheggersII,1910,1465,62,71,133,46.6%,1h
48316,2,Pippi,1910,866,32,39,71,45.1%,34m
48316,3,Alpha,1910,655,25,35,60,41.7%,1h
48316,3,Kraken,1910,431,14,22,36,38.9%,29m
48316,3,JimmO,1910,366,12,12,24,50.0%,28m
48316,3,Часовой,1910,254,8,7,15,53.3%,1h
48316,3,ХодячийЖаль,1910,158,7,9,16,43.8%,30m
48316,2,RAZUM,1910,252,6,6,12,50.0%,10m
48316,3,Defllorator,1910,188,5,18,23,21.7%,35m
48316,3,MaximUA,1910,30,1,2,3,33.3%,17m
48316,1,physicist,1910,0,0,1,1,0.0%,28m
48316,1,BMoT,1910,0,0,1,1,0.0%,1h
48316,3,silver,1910,0,0,3,3,0.0%,1h
48316,3,DrBooooM,1910,0,0,3,3,0.0%,1h
48316,3,[DeVu]BorisChan,1910,0,0,5,5,0.0%,30m
48316,3,Samueloin,1910,0,0,8,8,0.0%,17m
48332,3,Jamesvf,1909,624,24,27,51,47.1%,1h
48332,3,NIKFIRE,1909,418,15,12,27,55.6%,1h
48332,3,[CrBd]ALittleBit,1909,360,13,21,34,38.2%,1h
48332,3,LolDom,1909,299,10,9,19,52.6%,18m
48332,3,Граф,1909,203,6,5,11,54.5%,9m
48332,3,IЭnwer,1909,187,5,19,24,20.8%,28m
48332,3,THUMBA,1909,90,3,5,8,37.5%,32m
48332,3,Shurvivor,1909,0,3,7,10,30.0%,11m
48332,3,Lehabes,1909,0,2,3,5,40.0%,12m
48332,3,Twiniti,1909,60,2,8,10,20.0%,9m
48332,3,[GK27]Darkblade,1909,0,1,0,1,100.0%,1h
48332,3,Tomtom,1909,42,1,6,7,14.3%,1h
48332,3,[FR1]Mikay,1909,30,1,7,8,12.5%,11m
48332,2,Baaane,1909,0,1,9,10,10.0%,27m
48332,1,StIIIGEXII,1909,0,0,1,1,0.0%,12m
48332,3,DAMNED,1909,0,0,2,2,0.0%,1h
48348,2,[EzD]ikar,1908,561,51,68,119,42.9%,1h
48348,3,tournevis,1908,795,44,54,98,44.9%,2m
48348,3,Kurial,1908,907,31,35,66,47.0%,32m
48348,3,Alin,1908,672,24,41,65,36.9%,3m
48348,3,Samcrow,1908,266,21,14,35,60.0%,1h
48348,3,XBRAKER,1908,316,10,12,22,45.5%,12m
48348,2,[IomgI]Gent,1908,228,9,10,19,47.4%,30m
48348,1,Anabol,1908,294,9,17,26,34.6%,32m
48348,1,злаякурица,1908,310,8,2,10,80.0%,11m
48348,1,FatalError,1908,316,7,8,15,46.7%,1h
48348,3,sadis,1908,36,6,4,10,60.0%,1h
48348,3,DilduLover,1908,147,6,4,10,60.0%,24m
48348,2,OverLord,1908,150,5,13,18,27.8%,1h
48348,3,latinos,1908,58,3,7,10,30.0%,7m
48348,3,Justiceman,1908,30,2,2,4,50.0%,5m
48348,3,dhlcraft,1908,123,2,3,5,40.0%,5m
48348,3,lochistloch,1908,97,2,7,9,22.2%,1h
48348,1,MER,1908,89,2,11,13,15.4%,31m
48348,3,Saman,1908,97,1,2,3,33.3%,18m
48348,2,Simo,1908,0,1,2,3,33.3%,29m
48348,3,KingSlayer,1908,30,1,3,4,25.0%,12m
48348,3,SaarSoldsier,1908,0,0,1,1,0.0%,33m
48348,1,jimbo,1908,0,0,1,1,0.0%,1h
48371,2,cophill,1907,1563,221,235,456,48.5%,35m
48371,3,PSV,1907,1187,45,49,94,47.9%,1h
48371,2,siłacz,1907,542,20,28,48,41.7%,33m
48371,3,MorganProtos,1907,440,16,22,38,42.1%,1h
48371,3,xanawaro,1907,327,11,22,33,33.3%,17m
48371,1,VOID,1907,322,8,19,27,29.6%,1h
48371,3,Boomer,1907,192,5,11,16,31.2%,35m
48371,3,TukiiTukii,1907,136,5,13,18,27.8%,1h
48371,3,yazuro,1907,116,4,6,10,40.0%,1h
48371,3,смехоровный,1907,58,2,5,7,28.6%,11m
48371,2,Nomad,1907,44,2,10,12,16.7%,1h
48371,1,Leko,1907,0,1,9,10,10.0%,17m
48371,2,Alfirionfirs,1907,48,1,10,11,9.1%,1h
48371,3,MaffinMan,1907,0,0,1,1,0.0%,33m
48371,2,[niCOno]kakachiSAN,1907,0,0,3,3,0.0%,18m
48386,3,SCF,1906,1323,62,63,125,49.6%,23m
48386,2,Čenda,1906,1405,61,61,122,50.0%,1h
48386,2,THORAX,1906,1348,61,83,144,42.4%,1h
48386,3,mav,1906,650,23,23,46,50.0%,30m
48386,3,[LEXXI]Mante,1906,552,22,18,40,55.0%,1h
48386,3,LESOMMELIER,1906,654,22,31,53,41.5%,7m
48386,2,безжалостный,1906,382,20,38,58,34.5%,13m
48386,3,psicot,1906,398,13,21,34,38.2%,1h
48386,2,falco,1906,417,13,23,36,36.1%,1h
48386,3,[НОД17]error,1906,345,11,10,21,52.4%,13m
48386,3,Lunoto,1906,279,10,18,28,35.7%,26m
48386,2,WagoN,1906,316,10,22,32,31.2%,12m
48386,2,TpasUnKdo,1906,350,10,23,33,30.3%,21m
48386,1,zorglub,1906,266,8,13,21,38.1%,2m
48386,3,Илья,1906,150,7,16,23,30.4%,35m
48386,1,HaseBaer,1906,96,3,9,12,25.0%,1h
48386,2,Yudin,1906,80,2,6,8,25.0%,21m
48386,1,remark,1906,73,2,8,10,20.0%,1h
48386,1,joppazlobna,1906,0,1,0,1,100.0%,9m
48386,3,ChezLeon,1906,0,0,2,2,0.0%,1h
48386,3,Romadorio,1906,0,0,2,2,0.0%,12m
48386,3,Egorka,1906,0,0,4,4,0.0%,15m
48408,3,Lasse,1905,945,35,49,84,41.7%,1h
48408,3,Neptune,1905,802,31,37,68,45.6%,5m
48408,3,Eder,1905,179,29,35,64,45.3%,1h
48408,2,ДемонРок,1905,521,19,25,44,43.2%,1h
48408,3,Скот,1905,403,19,26,45,42.2%,1h
48408,2,Liryc,1905,153,17,20,37,45.9%,27m
48408,3,CBR,1905,328,11,10,21,52.4%,5m
48408,1,Groenock,1905,404,9,7,16,56.2%,1h
48408,1,[SW69]Uchiha,1905,183,6,10,16,37.5%,34m
48408,3,Kobay,1905,120,5,5,10,50.0%,27m
48408,3,Stoke,1905,88,3,9,12,25.0%,1h
48408,2,LtFlyer,1905,97,2,5,7,28.6%,1h
48408,3,[SUDA]Волчара,1905,123,2,6,8,25.0%,25m
48408,3,pchamrower,1905,0,1,2,3,33.3%,1h
48408,1,Ciryl,1905,0,1,3,4,25.0%,1h
48408,2,КуТуЗоВ,1905,97,1,8,9,11.1%,25m
48408,1,Kronos,1905,0,0,1,1,0.0%,1h
48408,3,[ATY]sniperyavuz,1905,0,0,4,4,0.0%,14m
48408,3,Stefanenkov,1905,0,0,5,5,0.0%,30m
48427,1,[SDW2]Viktorier,1904,1447,322,353,675,47.7%,1h
48427,3,kramp,1904,1263,71,76,147,48.3%,15m
48427,3,Ulukay,1904,428,21,27,48,43.8%,1h
48427,3,Olko,1904,311,15,13,28,53.6%,28m
48427,3,ghost,1904,236,7,7,14,50.0%,2m
48427,3,art,1904,198,5,6,11,45.5%,12m
48427,3,КалибрИ,1904,115,5,6,11,45.5%,13m
48427,3,Aik,1904,96,4,3,7,57.1%,24m
48427,3,[LOGS]wazzzuuuupp,1904,62,4,7,11,36.4%,23m
48427,3,xakepok,1904,120,2,2,4,50.0%,1h
48427,3,Roman,1904,30,2,5,7,28.6%,7m
48427,3,[godgg]PARSIFAL,1904,30,2,7,9,22.2%,14m
48427,3,Gaui,1904,0,1,0,1,100.0%,30m
48427,1,NexTimeS,1904,0,1,0,1,100.0%,5m
48427,3,spongebob,1904,0,1,1,2,50.0%,27m
48427,3,[SUDA]Alim,1904,40,1,2,3,33.3%,1h
48427,3,Dicky,1904,97,1,2,3,33.3%,32m
48427,2,Imbirek,1904,0,1,7,8,12.5%,2m
48427,3,NekoMeow,1904,0,1,9,10,10.0%,1h
48427,2,Lucenzo,1904,30,1,9,10,10.0%,1h
48427,2,mar,1904,0,1,9,10,10.0%,24m
48427,3,espeon,1904,0,0,1,1,0.0%,1h
48427,3,[CRLTNS]ilCello,1904,0,0,3,3,0.0%,27m
48427,3,MisterGrek,1904,0,0,7,7,0.0%,1h
48427,1,idivpopu,1904,73,0,8,8,0.0%,9m
48427,2,Step,1904,0,0,8,8,0.0%,1h
48453,1,VVNTRP,1903,1560,314,328,642,48.9%,22m
48453,2,Leech,1903,1564,104,121,225,46.2%,33m
48453,3,Foundation,1903,440,14,24,38,36.8%,5m
48453,3,[CED7]CedVII,1903,268,10,13,23,43.5%,1h
48453,1,[reykil]Behemot,1903,266,9,17,26,34.6%,1h
48453,1,Piche,1903,247,7,17,24,29.2%,28m
48453,1,Praetor,1903,111,3,3,6,50.0%,1h
48453,2,[SPARK]joluc,1903,140,2,10,12,16.7%,1h
48453,2,Frawks,1903,46,2,10,12,16.7%,1h
48453,1,Yomsson,1903,0,1,0,1,100.0%,1h
48453,3,Troncher,1903,0,0,1,1,0.0%,1h
48453,3,Lenar,1903,0,0,8,8,0.0%,6m
48465,3,Materoxloo,1902,914,35,39,74,47.3%,1h
48465,3,Interstellar,1902,832,33,36,69,47.8%,16m
48465,2,CatarroSporc,1902,816,26,37,63,41.3%,17m
48465,2,Belikser,1902,554,18,28,46,39.1%,1h
48465,3,Tarrasque,1902,423,16,15,31,51.6%,32m
48465,3,Niggo,1902,322,11,16,27,40.7%,1h
48465,3,Zuuugooor,1902,301,10,23,33,30.3%,1h
48465,2,Silvan,1902,291,9,15,24,37.5%,35m
48465,3,Feanor,1902,140,5,8,13,38.5%,27m
48465,3,Trollhunter,1902,143,4,1,5,80.0%,1h
48465,1,Perpedon,1902,138,4,2,6,66.7%,1h
48465,1,SaintEvgeniy,1902,46,3,5,8,37.5%,33m
48465,2,eGR,1902,141,3,11,14,21.4%,10m
48465,1,Hades,1902,144,3,11,14,21.4%,1h
48465,1,Reyuu,1902,159,2,4,6,33.3%,24m
48465,2,ПаДж,1902,88,1,7,8,12.5%,34m
48465,3,Parker,1902,0,0,3,3,0.0%,30m
48465,3,[HACKZ]gdude,1902,0,0,5,5,0.0%,1h
48483,2,Papagal,1901,1285,81,91,172,47.1%,1h
48483,3,sergeu,1901,1213,44,58,102,43.1%,25m
48483,3,rainSeeker,1901,1035,38,48,86,44.2%,30m
48483,3,IGOR,1901,760,32,39,71,45.1%,5m
48483,1,Михаил,1901,691,28,34,62,45.2%,1h
48483,3,МрачныйВорон,1901,458,17,25,42,40.5%,1h
48483,2,Emperor,1901,323,12,21,33,36.4%,34m
48483,3,[Duvel]MiaoMiao,1901,322,11,16,27,40.7%,7m
48483,3,Prash,1901,144,6,8,14,42.9%,17m
48483,1,MrNoBody,1901,106,4,14,18,22.2%,4m
48483,1,Zergood,1901,122,3,2,5,60.0%,1h
48483,3,Killerdose,1901,123,2,3,5,40.0%,27m
48483,1,RoGhost,1901,46,2,6,8,25.0%,1h
48483,3,Eterib,1901,62,2,9,11,18.2%,33m
48483,2,VoidWalker,1901,0,1,1,2,50.0%,1h
48483,3,[SPAINs]Jordi,1901,95,1,2,3,33.3%,29m
48483,3,[Kokuou]DroL,1901,0,1,4,5,20.0%,1h
48483,1,GRoMvЗ,1901,0,0,1,1,0.0%,1h
48483,1,[GNORI]Fich,1901,0,0,1,1,0.0%,1h
48483,3,WooXTeR,1901,0,0,1,1,0.0%,1h
48483,1,Artarron,1901,0,0,1,1,0.0%,11m
48483,2,Кучерявый,1901,0,0,9,9,0.0%,1h
48505,3,Fer,1900,1609,125,146,271,46.1%,30m
48505,3,КОСТЯ,1900,1452,118,128,246,48.0%,1h
48505,3,GloomDaemon,1900,1058,59,54,113,52.2%,1h
48505,3,SilverEagle,1900,954,47,54,101,46.5%,25m
48505,3,KaporalBonjo,1900,778,45,45,90,50.0%,32m
48505,3,StyrianTower,1900,532,19,22,41,46.3%,17m
48505,1,JOKI,1900,306,12,9,21,57.1%,24m
48505,1,DarthVader,1900,413,10,20,30,33.3%,1h
48505,2,Master,1900,143,6,8,14,42.9%,1h
48505,3,[оо]Gleb,1900,167,5,5,10,50.0%,1h
48505,3,DREZZED,1900,152,5,7,12,41.7%,32m
48505,2,RockFever,1900,94,3,13,16,18.8%,15m
48505,1,DreadLord,1900,151,2,7,9,22.2%,4m
48505,3,dryRun,1900,0,1,0,1,100.0%,12m
48505,3,realfat,1900,97,1,2,3,33.3%,1h
48505,3,FailSC,1900,0,1,4,5,20.0%,15m
48505,1,[ICCCPI]Юрион,1900,0,0,1,1,0.0%,1h
48505,1,Forestcat,1900,0,0,1,1,0.0%,6m
48505,1,miky,1900,0,0,1,1,0.0%,16m
48524,3,cosminliviu,1899,1298,225,262,487,46.2%,1h
48524,1,qunn,1899,1560,201,225,426,47.2%,30m
48524,2,meepmeep,1899,1494,104,121,225,46.2%,16m
48524,1,[OmDi]supervener,1899,1573,61,83,144,42.4%,34m
48524,2,pop,1899,566,60,76,136,44.1%,3m
48524,3,andréas,1899,1076,38,51,89,42.7%,1h
48524,3,[Ультра]Retro,1899,472,16,22,38,42.1%,1h
48524,3,[БИЗНЕС]Фатонщик,1899,366,15,27,42,35.7%,1h
48524,3,Noobot,1899,394,14,14,28,50.0%,1h
48524,3,Iri,1899,416,14,19,33,42.4%,1h
48524,2,MattiuNinja,1899,424,14,22,36,38.9%,1h
48524,3,[valdaa]Valda,1899,408,13,19,32,40.6%,5m
48524,3,stuff,1899,303,10,21,31,32.3%,1h
48524,3,Lio,1899,190,7,10,17,41.2%,26m
48524,3,Marchello,1899,184,6,9,15,40.0%,1h
48524,3,Ledus,1899,165,5,4,9,55.6%,4m
48524,1,CatEater,1899,0,1,8,9,11.1%,1h
48524,1,siekiera,1899,0,0,1,1,0.0%,24m
48524,3,Insaybr,1899,0,0,5,5,0.0%,1h
48524,2,Tribe,1899,0,0,7,7,0.0%,1h
48524,2,ДенМастер,1899,0,0,7,7,0.0%,33m
48545,3,Schwifty,1898,1046,261,296,557,46.9%,1h
48545,2,SilentKill,1898,1426,153,175,328,46.6%,32m
48545,3,Bura,1898,778,42,51,93,45.2%,1h
48545,3,САНЕК,1898,405,31,35,66,47.0%,32m
48545,3,ALBERTA,1898,799,29,43,72,40.3%,1h
48545,2,Sjokola,1898,602,23,31,54,42.6%,1h
48545,3,JeanPlisse,1898,434,17,31,48,35.4%,1h
48545,3,[TB02]Stachu,1898,376,14,11,25,56.0%,1h
48545,3,RUSMarkuel,1898,376,13,19,32,40.6%,9m
48545,2,jonny,1898,417,13,22,35,37.1%,25m
48545,3,HrumecCZ,1898,212,7,11,18,38.9%,24m
48545,2,фырфырфыр,1898,0,4,6,10,40.0%,13m
48545,1,leoken,1898,76,2,15,17,11.8%,12m
48545,1,[HgrC]makkapakka,1898,0,1,0,1,100.0%,5m
48545,1,[sort]Troldeper,1898,0,0,1,1,0.0%,1h
48545,3,Морковка,1898,0,0,1,1,0.0%,33m
48545,3,RMMD,1898,0,0,2,2,0.0%,1h
48562,3,BlitzkreigU,1897,1516,157,185,342,45.9%,1h
48562,3,Bejulo,1897,1561,65,75,140,46.4%,35m
48562,3,Alexandr,1897,1392,62,70,132,47.0%,1h
48562,3,nesopun,1897,994,38,42,80,47.5%,32m
48562,3,[OLIM]Mauro,1897,642,28,27,55,50.9%,17m
48562,3,CalebLee,1897,414,15,19,34,44.1%,1h
48562,3,Masachristus,1897,384,13,19,32,40.6%,26m
48562,3,Beginner,1897,124,5,20,25,20.0%,12m
48562,1,ilMousTro,1897,46,2,1,3,66.7%,2m
48562,3,Tomasz,1897,30,2,3,5,40.0%,1h
48562,3,[Сучкак]ДАНОНЕТ,1897,0,1,0,1,100.0%,1h
48562,3,[Niggle]Skye,1897,0,1,1,2,50.0%,1h
48562,3,[PR0uT]KiwiKekette,1897,96,1,3,4,25.0%,1h
48562,3,TheC,1897,30,1,4,5,20.0%,35m
48562,1,Mess,1897,0,1,10,11,9.1%,1h
48562,3,motivator,1897,0,0,1,1,0.0%,1h
48562,1,Crayon,1897,0,0,2,2,0.0%,35m
48562,3,Жека,1897,0,0,2,2,0.0%,12m
48562,3,Valkorion,1897,0,0,3,3,0.0%,1h
48562,3,[Egold]Rurik,1897,0,0,7,7,0.0%,35m
48582,2,Marax,1896,658,67,84,151,44.4%,22m
48582,1,lion,1896,1530,47,47,94,50.0%,1h
48582,3,blackstorm,1896,492,24,29,53,45.3%,18m
48582,1,Kochanich,1896,697,20,12,32,62.5%,34m
48582,3,IQQI,1896,206,18,31,49,36.7%,5m
48582,1,[Sande]Frog,1896,486,12,13,25,48.0%,1h
48582,3,HellHappel,1896,319,12,15,27,44.4%,13m
48582,1,Lotezzz,1896,325,11,7,18,61.1%,6m
48582,3,Victor,1896,250,8,18,26,30.8%,18m
48582,1,[nWss]Vizard,1896,300,7,8,15,46.7%,1h
48582,2,[HOTS3]BoneCrusher,1896,76,4,6,10,40.0%,34m
48582,3,kxq,1896,126,4,12,16,25.0%,1h
48582,1,kirok,1896,94,2,2,4,50.0%,28m
48582,1,[BARHUR]BabaYaga,1896,90,2,2,4,50.0%,1h
48582,2,piotrsta,1896,44,2,3,5,40.0%,1h
48582,2,Winter,1896,46,2,10,12,16.7%,1h
48582,3,krzysgg,1896,0,1,0,1,100.0%,1h
48582,1,DironModys,1896,46,1,2,3,33.3%,16m
48582,3,asheZ,1896,0,0,1,1,0.0%,1h
48582,3,[Тимон]Legeon,1896,0,0,3,3,0.0%,1h
48582,1,kercak,1896,0,0,5,5,0.0%,4m
48603,3,DiabloK,1895,899,30,45,75,40.0%,1h
48603,3,JJustice,1895,299,12,14,26,46.2%,1h
48603,3,[BCNG]george,1895,328,11,20,31,35.5%,5m
48603,3,DuranDuran,1895,180,6,10,16,37.5%,28m
48603,3,левыйчел,1895,167,5,8,13,38.5%,28m
48603,1,Robert,1895,130,3,1,4,75.0%,11m
48603,1,[РусЭл]roboji,1895,46,2,2,4,50.0%,1h
48603,1,[KAOTx]ExoDoX,1895,0,2,3,5,40.0%,1h
48603,1,[2a2]jeferey,1895,0,1,0,1,100.0%,1h
48603,1,[DGERT]wario,1895,44,1,1,2,50.0%,2m
48603,2,buihungsmt,1895,0,1,1,2,50.0%,1h
48603,3,[mfixed]PieRun,1895,30,1,3,4,25.0%,1h
48603,2,Noculator,1895,48,1,4,5,20.0%,1h
48603,2,SallahDin,1895,44,1,4,5,20.0%,1h
48603,1,xDragonBlade,1895,0,1,4,5,20.0%,1h
48603,3,Tishoo,1895,0,1,5,6,16.7%,14m
48603,1,Nemorax,1895,0,0,1,1,0.0%,28m
48603,1,[GdAT]TOLAR,1895,0,0,1,1,0.0%,16m
48621,3,darkviper,1894,1563,127,147,274,46.4%,1h
48621,3,xTriMeEe,1894,1354,109,123,232,47.0%,1h
48621,2,Rampo,1894,975,98,115,213,46.0%,12m
48621,3,Ramses,1894,806,29,34,63,46.0%,1h
48621,3,[36RUS]Killer,1894,768,28,31,59,47.5%,1h
48621,2,mimi,1894,620,21,36,57,36.8%,18m
48621,3,[Zhig]TinebrisElv,1894,423,16,7,23,69.6%,1h
48621,2,JokeR,1894,484,16,22,38,42.1%,6m
48621,3,[Muist]RaresD,1894,332,11,14,25,44.0%,1h
48621,3,vhlam,1894,280,11,15,26,42.3%,1h
48621,3,wegeve,1894,283,9,8,17,52.9%,2m
48621,1,ReidarDahlén,1894,305,9,18,27,33.3%,33m
48621,3,TimDrake,1894,90,4,5,9,44.4%,1h
48621,3,[JFKKen]ProtosLife,1894,60,3,9,12,25.0%,2m
48621,3,[iSport]Kwaśny,1894,32,2,2,4,50.0%,33m
48621,3,Alsim,1894,0,1,3,4,25.0%,1h
48621,1,James,1894,0,0,1,1,0.0%,7m
48621,1,[OvmpO]Vedovonero,1894,0,0,1,1,0.0%,8m
48621,2,Basste,1894,0,0,1,1,0.0%,10m
48621,3,BarbaroR,1894,0,0,2,2,0.0%,32m
48621,3,Gagarin,1894,0,0,3,3,0.0%,1h
48621,3,[GRODUR]minhthu,1894,0,0,5,5,0.0%,1h
48643,2,Costin,1893,612,22,31,53,41.5%,1h
48643,3,PhoenixAsh,1893,211,15,16,31,48.4%,1h
48643,3,wastlbastl,1893,232,8,10,18,44.4%,1h
48643,3,Zerkaliy,1893,108,7,8,15,46.7%,1h
48643,3,MICKEYmOuse,1893,144,3,4,7,42.9%,1h
48643,3,RomaXa,1893,60,3,5,8,37.5%,1h
48643,1,Nareda,1893,94,3,15,18,16.7%,1h
48643,3,Moshu,1893,0,2,6,8,25.0%,1h
48643,3,GRUUL,1893,60,2,7,9,22.2%,27m
48643,3,Zorph,1893,30,2,12,14,14.3%,18m
48643,3,MakutaXarxas,1893,0,1,1,2,50.0%,26m
48643,3,DrRand,1893,97,1,6,7,14.3%,1h
48643,1,assasyn,1893,0,1,11,12,8.3%,34m
48643,1,[OvmpO]Maestro,1893,0,0,1,1,0.0%,12m
48643,2,[IPSI]Chrischan,1893,0,0,2,2,0.0%,1h
48658,3,Biggels,1892,1273,74,79,153,48.4%,1h
48658,2,DShlepenhund,1892,792,63,70,133,47.4%,1h
48658,3,Strimler,1892,926,35,33,68,51.5%,32m
48658,3,Rodeons,1892,404,13,15,28,46.4%,27m
48658,3,[Kaizar]CommanderZ,1892,332,12,10,22,54.5%,32m
48658,1,Sanshe,1892,429,11,19,30,36.7%,1h
48658,3,Starlight,1892,280,8,10,18,44.4%,1h
48658,3,[N1TDA]zeratul,1892,233,7,11,18,38.9%,32m
48658,1,galick,1892,270,6,8,14,42.9%,8m
48658,2,Lifebtrippin,1892,120,6,14,20,30.0%,33m
48658,1,OVERSUN,1892,218,5,5,10,50.0%,1h
48658,3,DonKKosa,1892,153,4,6,10,40.0%,1h
48658,3,PoZitiv,1892,58,3,7,10,30.0%,4m
48658,2,Sagoos,1892,93,3,7,10,30.0%,1h
48658,3,Neo,1892,60,2,10,12,16.7%,1h
48658,2,Egon,1892,58,2,12,14,14.3%,23m
48658,1,Arsek,1892,46,1,1,2,50.0%,8m
48658,3,Ежидзе,1892,0,1,2,3,33.3%,26m
48658,3,Lilou,1892,97,1,3,4,25.0%,30m
48658,3,ИЛЛИДАН,1892,0,0,1,1,0.0%,1h
48658,3,[NSCSC]Kirill,1892,0,0,2,2,0.0%,1h
48658,3,[SРID]artem,1892,0,0,4,4,0.0%,16m
48658,3,[137228]piopeleSS,1892,0,0,6,6,0.0%,1h
48658,2,Bozont,1892,0,0,7,7,0.0%,26m
48682,1,[Chariz]FLOOBAROO,1891,1490,55,72,127,43.3%,1h
48682,3,Trewidant,1891,1231,45,55,100,45.0%,1h
48682,3,taurinkill,1891,485,21,23,44,47.7%,1h
48682,3,RoyMorrison,1891,456,15,25,40,37.5%,26m
48682,1,Palen,1891,536,13,10,23,56.5%,1h
48682,3,Juan,1891,391,13,16,29,44.8%,17m
48682,3,leonidas,1891,321,10,17,27,37.0%,1h
48682,1,KingAkul,1891,336,9,19,28,32.1%,1h
48682,2,FRIENDS,1891,155,6,8,14,42.9%,24m
48682,2,Иван,1891,0,3,9,12,25.0%,1h
48682,3,Fomfelomfen,1891,121,2,4,6,33.3%,35m
48682,3,vicentexd,1891,30,1,2,3,33.3%,1h
48682,3,Yseult,1891,0,1,4,5,20.0%,30m
48682,1,[Gespu]Finoel,1891,0,0,2,2,0.0%,1h
48696,2,SLTnVNGR,1890,961,71,91,162,43.8%,1h
48696,2,GENERAL,1890,1317,63,82,145,43.4%,32m
48696,3,PanZonkil,1890,896,33,47,80,41.2%,1h
48696,1,MichelG,1890,394,12,10,22,54.5%,4m
48696,1,DOOM,1890,201,4,3,7,57.1%,16m
48696,2,SpeeFak,1890,203,4,13,17,23.5%,7m
48696,1,val,1890,80,3,12,15,20.0%,34m
48696,1,LAKSAMANA,1890,0,1,0,1,100.0%,1h
48696,3,[MoonTr]katatsu,1890,30,1,4,5,20.0%,1h
48696,3,Sraka,1890,30,1,5,6,16.7%,12m
48696,3,vlad,1890,0,0,1,1,0.0%,1h
48696,1,sbs,1890,0,0,1,1,0.0%,19m
48708,3,jamiejames,1889,1118,86,101,187,46.0%,28m
48708,3,dimaris,1889,1393,61,58,119,51.3%,1h
48708,3,[DECIMA]kierantodds,1889,1159,51,64,115,44.3%,1h
48708,3,ermian,1889,965,39,49,88,44.3%,1h
48708,3,fin,1889,812,32,38,70,45.7%,1h
48708,1,Meatmap,1889,549,13,11,24,54.2%,6m
48708,3,varoml,1889,276,11,13,24,45.8%,1h
48708,1,SerTorX,1889,188,6,14,20,30.0%,4m
48708,3,Guma,1889,30,2,4,6,33.3%,1h
48708,3,[НЕТУДА]Doshik,1889,0,1,4,5,20.0%,1h
48708,1,[geym]Zeratul,1889,0,0,1,1,0.0%,1h
48719,3,Alx,1888,1484,70,80,150,46.7%,30m
48719,1,sliceoflife,1888,983,58,65,123,47.2%,34m
48719,3,EeeViLFloW,1888,944,33,46,79,41.8%,1h
48719,3,Kilkus,1888,516,18,23,41,43.9%,27m
48719,2,Winsitoo,1888,278,9,19,28,32.1%,16m
48719,3,Paidamcz,1888,60,2,8,10,20.0%,1h
48719,3,Lightning,1888,0,0,1,1,0.0%,1h
48719,1,Joshuaswanep,1888,73,0,7,7,0.0%,27m
48727,3,[kek34]Summatr,1887,1454,174,220,394,44.2%,2m
48727,3,krambalkis,1887,1480,78,82,160,48.8%,23m
48727,2,JAN,1887,1372,46,67,113,40.7%,13m
48727,2,Pablo,1887,582,22,32,54,40.7%,1h
48727,3,Евгений,1887,134,20,22,42,47.6%,26m
48727,3,[LØV2B3]Chatou,1887,587,20,34,54,37.0%,1h
48727,3,sentenza,1887,262,9,15,24,37.5%,1h
48727,3,warvar,1887,148,6,8,14,42.9%,23m
48727,3,Anatoly,1887,222,6,13,19,31.6%,4m
48727,1,VARVAR,1887,225,6,17,23,26.1%,1h
48727,3,Lin,1887,34,4,5,9,44.4%,6m
48727,2,prosad,1887,58,4,14,18,22.2%,1h
48727,1,Boldi,1887,140,3,3,6,50.0%,1h
48727,1,BobHuricane,1887,134,3,5,8,37.5%,1h
48727,1,Minos,1887,58,3,13,16,18.8%,5m
48727,1,[K0mpis]Schteen,1887,48,1,6,7,14.3%,28m
48743,1,Vodoley,1886,392,10,7,17,58.8%,1h
48743,3,PrimeGride,1886,197,8,12,20,40.0%,1h
48743,3,Halion,1886,88,4,1,5,80.0%,33m
48743,3,[ESPION]Askorbik,1886,149,4,9,13,30.8%,27m
48743,1,Alaric,1886,121,3,4,7,42.9%,1h
48743,3,[Lumen]Ace,1886,62,2,5,7,28.6%,1h
48743,3,Gedi,1886,0,2,5,7,28.6%,1h
48743,1,dImOn,1886,0,1,0,1,100.0%,33m
48743,1,garrik,1886,46,1,1,2,50.0%,7m
48743,2,Tøklane,1886,48,1,5,6,16.7%,21m
48743,3,moonlight,1886,0,1,5,6,16.7%,1h
48743,3,agentFox,1886,30,1,5,6,16.7%,1h
48743,1,Spaceon,1886,73,1,5,6,16.7%,33m
48743,2,фуфнырик,1886,93,1,9,10,10.0%,1h
48743,1,[EzpzZ]papugar,1886,0,0,1,1,0.0%,33m
48743,3,Cozmoz,1886,0,0,7,7,0.0%,1h
48759,2,Dude,1885,1361,94,115,209,45.0%,31m
48759,3,Urulith,1885,1533,85,88,173,49.1%,1h
48759,3,Aura,1885,1429,55,65,120,45.8%,1h
48759,2,NoonienSoong,1885,1424,49,63,112,43.8%,16m
48759,2,monster,1885,1040,36,49,85,42.4%,1h
48759,3,gornbiy,1885,474,19,19,38,50.0%,35m
48759,2,Player,1885,554,19,32,51,37.3%,1h
48759,3,Zippo,1885,465,16,26,42,38.1%,1h
48759,3,Boshev,1885,422,14,21,35,40.0%,29m
48759,3,[SC2L]Snake,1885,381,13,24,37,35.1%,1h
48759,3,enginar,1885,162,6,13,19,31.6%,6m
48759,1,Klarky,1885,86,3,6,9,33.3%,8m
48759,2,MapHacker,1885,58,3,10,13,23.1%,6m
48759,2,Gelomyr,1885,170,3,11,14,21.4%,3m
48759,3,tomy,1885,0,2,6,8,25.0%,1h
48759,3,Xentos,1885,0,1,2,3,33.3%,1h
48759,3,Teo,1885,30,1,4,5,20.0%,1h
48759,2,MurlloKK,1885,0,0,1,1,0.0%,11m
48759,3,arad,1885,0,0,1,1,0.0%,1h
48759,1,[GG1sec]lSDl,1885,0,0,3,3,0.0%,10m
48759,2,Fambar,1885,0,0,8,8,0.0%,1h
48759,2,[Kuruma]Cosmo,1885,0,0,9,9,0.0%,1h
48781,3,Sushi,1884,670,24,32,56,42.9%,1h
48781,1,NoKyogin,1884,424,14,6,20,70.0%,1h
48781,1,[zurt]zurtmaster,1884,494,13,14,27,48.1%,4m
48781,2,Perses,1884,339,10,22,32,31.2%,33m
48781,1,Dubliners,1884,356,9,8,17,52.9%,33m
48781,3,DOUDOU,1884,185,5,14,19,26.3%,18m
48781,2,Awink,1884,150,3,5,8,37.5%,29m
48781,1,erem,1884,46,2,1,3,66.7%,1h
48781,1,Sandman,1884,46,2,1,3,66.7%,2m
48781,3,Thorgal,1884,96,2,11,13,15.4%,1h
48781,2,artur,1884,0,1,1,2,50.0%,7m
48781,1,[НОД17]Dima,1884,89,1,1,2,50.0%,4m
48781,2,Megadudik,1884,0,1,2,3,33.3%,28m
48781,3,[ройZ]DOLORENOS,1884,0,0,1,1,0.0%,6m
48781,1,iamnotgay,1884,0,0,1,1,0.0%,12m
48781,1,[TGSM]Alex,1884,73,0,2,2,0.0%,6m
48781,3,megagen,1884,0,0,3,3,0.0%,32m
48781,3,Kilebor,1884,0,0,5,5,0.0%,1h
48781,3,GEARFOX,1884,0,0,7,7,0.0%,30m
48800,3,Starconkeror,1883,1326,56,66,122,45.9%,15m
48800,3,BURGER,1883,715,48,56,104,46.2%,1h
48800,1,Juwe,1883,1087,37,49,86,43.0%,1h
48800,1,doMert,1883,1000,26,30,56,46.4%,3m
48800,3,bumber,1883,417,14,19,33,42.4%,1h
48800,1,AngeloMerte,1883,496,13,10,23,56.5%,34m
48800,3,Sandiego,1883,314,13,18,31,41.9%,1h
48800,1,XXMATEG,1883,371,11,9,20,55.0%,1h
48800,2,SEDANIX,1883,196,4,17,21,19.0%,23m
48800,2,HANN,1883,154,3,11,14,21.4%,1h
48800,1,ghost,1883,48,1,2,3,33.3%,1h
48800,3,Agimond,1883,0,1,3,4,25.0%,1h
48800,1,billyfresh,1883,0,0,2,2,0.0%,1h
48800,3,[SPAINs]AttakeTitan,1883,0,0,6,6,0.0%,1h
48800,3,ksidme,1883,0,0,8,8,0.0%,1h
48815,2,bountyknight,1882,1519,125,126,251,49.8%,1h
48815,3,[LQV]flammen,1882,1488,61,68,129,47.3%,24m
48815,3,JohnKiller,1882,1325,56,60,116,48.3%,1h
48815,1,Nero,1882,1366,41,40,81,50.6%,10m
48815,1,AkairaAki,1882,775,21,19,40,52.5%,28m
48815,3,Molfar,1882,403,21,25,46,45.7%,1h
48815,2,Andrio,1882,344,16,28,44,36.4%,36m
48815,1,BaumGott,1882,285,8,7,15,53.3%,25m
48815,3,[CRLTNS]Alberto,1882,192,6,12,18,33.3%,1h
48815,1,FALCON,1882,241,5,10,15,33.3%,2m
48815,2,BadLuckBird,1882,200,5,13,18,27.8%,34m
48815,2,Bolat,1882,147,3,10,13,23.1%,3m
48815,3,Meikoah,1882,123,2,8,10,20.0%,1h
48815,1,Aydin,1882,104,2,9,11,18.2%,1h
48815,2,Leonidas,1882,118,2,10,12,16.7%,6m
48815,1,Firsty,1882,0,0,1,1,0.0%,1h
48815,1,[SryPod]Стул,1882,73,0,3,3,0.0%,1h
48832,2,DeeJay,1881,1538,66,74,140,47.1%,4m
48832,3,Sorrow,1881,300,18,24,42,42.9%,21m
48832,2,Ivor,1881,372,16,29,45,35.6%,15m
48832,2,Nedlloyd,1881,428,15,27,42,35.7%,16m
48832,1,DomovoiUL,1881,126,3,5,8,37.5%,1h
48832,3,Krafter,1881,94,2,6,8,25.0%,1h
48832,1,BatlleAnt,1881,46,1,1,2,50.0%,33m
48832,1,GRaptor,1881,48,1,2,3,33.3%,20m
48832,3,[Aple]DENTRON,1881,0,0,1,1,0.0%,1h
48832,3,Mikasa,1881,0,0,1,1,0.0%,17m
48832,3,[Conatu]Smasher,1881,0,0,2,2,0.0%,1h
48832,3,YoSsSuA,1881,0,0,4,4,0.0%,1h
48844,2,RVS,1880,1525,171,188,359,47.6%,1h
48844,3,ГАЛСТАРКРАФ,1880,1223,80,114,194,41.2%,1h
48844,3,gyom,1880,1104,48,49,97,49.5%,1h
48844,3,Darkcrazypan,1880,358,12,9,21,57.1%,18m
48844,1,Droplook,1880,292,10,7,17,58.8%,1h
48844,3,Tomás,1880,147,8,15,23,34.8%,21m
48844,3,Rüdiger,1880,240,7,10,17,41.2%,1h
48844,1,phadros,1880,120,3,3,6,50.0%,30m
48844,3,[ANREN]Graf,1880,70,2,4,6,33.3%,28m
48844,1,seriyronin,1880,0,1,0,1,100.0%,27m
48844,3,Joebar,1880,38,1,8,9,11.1%,1h
48844,1,Slatos,1880,0,0,2,2,0.0%,1h
48844,2,Remork,1880,0,0,3,3,0.0%,1h
48844,3,[svinik]MineralWalk,1880,0,0,6,6,0.0%,9m
48858,3,[13NRV]ManoliX,1879,1538,443,481,924,47.9%,30m
48858,2,alniktim,1879,1501,120,124,244,49.2%,1h
48858,3,RuneMaster,1879,578,24,21,45,53.3%,2m
48858,3,Izayoi,1879,408,14,22,36,38.9%,13m
48858,3,[OmDi]dwdtox,1879,359,12,19,31,38.7%,32m
48858,2,BUBS,1879,170,7,11,18,38.9%,1h
48858,3,TheKarsian,1879,30,1,3,4,25.0%,1h
48858,2,[RBadB]TimGP,1879,32,1,3,4,25.0%,4m
48858,2,lozerg,1879,96,1,7,8,12.5%,25m
48858,1,xFF,1879,0,1,11,12,8.3%,7m
48858,1,[CaLe]Subotay,1879,0,0,1,1,0.0%,12m
48858,2,centfroid,1879,0,0,1,1,0.0%,1h
48858,3,TyPaKloVn,1879,0,0,2,2,0.0%,28m
48858,3,Edelweiss,1879,0,0,7,7,0.0%,33m
48872,2,[БИЗНЕС]ORCODION,1878,1543,288,305,593,48.6%,1h
48872,3,Salarandr,1878,902,36,36,72,50.0%,28m
48872,1,ssr,1878,875,25,21,46,54.3%,1h
48872,3,RedNinja,1878,176,5,7,12,41.7%,1h
48872,3,Litrillo,1878,117,5,12,17,29.4%,26m
48872,1,[Сlеver]GUTENBERG,1878,182,4,6,10,40.0%,2m
48872,2,Exodus,1878,116,2,9,11,18.2%,1h
48872,1,jonas,1878,0,0,1,1,0.0%,1h
48872,1,masterstyle,1878,0,0,1,1,0.0%,1h
48872,3,Sasha,1878,0,0,1,1,0.0%,12m
48872,1,DeathPlayer,1878,0,0,2,2,0.0%,1h
48872,3,VOLiMBUREK,1878,0,0,4,4,0.0%,6m
48872,1,[SCSh1t]Soki,1878,73,0,7,7,0.0%,10m
48872,3,Komani,1878,0,0,7,7,0.0%,1h
48886,2,DougMortimer,1877,1338,185,224,409,45.2%,1h
48886,3,stimpack,1877,1106,142,163,305,46.6%,7m
48886,3,fonso,1877,1456,76,83,159,47.8%,35m
48886,3,[Horst]pansenatzeto,1877,1337,60,64,124,48.4%,10m
48886,1,Drachenkrieg,1877,758,19,33,52,36.5%,28m
48886,3,Thamkrabok,1877,528,17,30,47,36.2%,1h
48886,3,Flet,1877,296,10,16,26,38.5%,1h
48886,2,owen,1877,182,8,10,18,44.4%,13m
48886,3,Anders,1877,257,8,10,18,44.4%,30m
48886,1,Abed,1877,272,7,3,10,70.0%,34m
48886,1,[1м2м3п]MaxQROI,1877,310,7,10,17,41.2%,1h
48886,3,Эдуард,1877,234,7,13,20,35.0%,1h
48886,1,Lukisz,1877,186,4,6,10,40.0%,1h
48886,2,wildwolf,1877,159,3,12,15,20.0%,1h
48886,2,Hajo,1877,48,2,5,7,28.6%,1h
48886,3,Macfdfed,1877,72,2,9,11,18.2%,32m
48886,3,PantsOnFire,1877,34,1,9,10,10.0%,1h
48886,1,pokemon,1877,0,0,1,1,0.0%,1h
48886,1,[BuBä]Orbert,1877,0,0,1,1,0.0%,18m
48886,3,teulgreg,1877,0,0,2,2,0.0%,33m
48886,3,Habib,1877,0,0,7,7,0.0%,12m
48886,3,[ChaOma]Omalabar,1877,0,0,7,7,0.0%,36m
48886,2,łysyśledź,1877,0,0,8,8,0.0%,6m
48909,3,Chris,1876,1534,56,67,123,45.5%,26m
48909,3,Komain,1876,1174,43,47,90,47.8%,1h
48909,2,AragonHaKlos,1876,281,10,12,22,45.5%,1h
48909,3,Nicer,1876,291,9,9,18,50.0%,36m
48909,3,CionDruuTa,1876,52,8,13,21,38.1%,1h
48909,1,[GAMI]Valounours,1876,226,5,7,12,41.7%,11m
48909,3,Igor,1876,30,5,8,13,38.5%,24m
48909,1,benuts,1876,94,3,3,6,50.0%,1h
48909,2,DELOG,1876,90,3,13,16,18.8%,16m
48909,1,Blanqui,1876,90,2,3,5,40.0%,1h
48909,3,Kim,1876,0,1,3,4,25.0%,10m
48909,1,jclegend,1876,46,1,6,7,14.3%,13m
48909,3,LosT,1876,0,0,1,1,0.0%,17m
48909,1,Garinich,1876,73,0,7,7,0.0%,12m
48923,1,AhmadQ,1875,1862,74,81,155,47.7%,1h
48923,2,Gaël,1875,890,39,60,99,39.4%,26m
48923,2,KHAM,1875,790,29,36,65,44.6%,12m
48923,1,MrPickles,1875,1025,27,27,54,50.0%,11m
48923,1,Dweezil,1875,916,25,28,53,47.2%,1h
48923,3,[RDevil]Pascal,1875,542,21,25,46,45.7%,26m
48923,3,LebovskI,1875,292,11,15,26,42.3%,23m
48923,1,Witalij,1875,402,10,12,22,45.5%,12m
48923,2,PIKURINATOR,1875,324,9,20,29,31.0%,29m
48923,3,BaHo,1875,133,7,11,18,38.9%,12m
48923,3,Монарх,1875,120,4,5,9,44.4%,1h
48923,3,XJIЗB,1875,88,4,7,11,36.4%,30m
48923,3,mouggy,1875,118,4,11,15,26.7%,30m
48923,3,LlyNotLie,1875,111,3,3,6,50.0%,1h
48923,1,tanenberg,1875,46,1,1,2,50.0%,18m
48923,3,fix,1875,0,0,7,7,0.0%,36m
48939,3,DarkVid,1874,1538,69,78,147,46.9%,15m
48939,1,Александр,1874,1258,35,50,85,41.2%,20m
48939,3,neiji,1874,362,12,21,33,36.4%,1h
48939,2,NightKnight,1874,196,6,15,21,28.6%,1h
48939,1,IIIIIIIIIIII,1874,124,4,16,20,20.0%,1h
48939,3,Bellerofonte,1874,0,3,4,7,42.9%,1h
48939,3,Zeratul,1874,0,0,2,2,0.0%,1h
48939,1,Crusader,1874,0,0,5,5,0.0%,33m
48947,3,VVVkEstik,1873,728,24,37,61,39.3%,15m
48947,1,Albertpia,1873,504,19,19,38,50.0%,1h
48947,1,caragnido,1873,688,17,16,33,51.5%,20m
48947,1,minipanic,1873,314,10,16,26,38.5%,1h
48947,1,Alega,1873,308,7,5,12,58.3%,12m
48947,1,[Temeri]zorg,1873,276,6,10,16,37.5%,33m
48947,2,квбегемот,1873,220,5,8,13,38.5%,1h
48947,3,ivd,1873,138,5,10,15,33.3%,27m
48947,1,[DRÖM]Guldvarg,1873,122,5,16,21,23.8%,1h
48947,2,Wrona,1873,120,3,10,13,23.1%,13m
48947,2,DarkUnity,1873,0,1,0,1,100.0%,7m
48947,1,Foufou,1873,0,1,1,2,50.0%,28m
48947,3,ШурикАур,1873,0,1,4,5,20.0%,18m
48947,2,staspro,1873,0,0,1,1,0.0%,34m
48947,1,pisimisi,1873,0,0,1,1,0.0%,13m
48947,1,Ian,1873,0,0,1,1,0.0%,19m
48947,1,Granmastil,1873,0,0,2,2,0.0%,1h
48947,2,Александр,1873,0,0,2,2,0.0%,11m
48947,2,ProductUboja,1873,0,0,2,2,0.0%,22m
48947,1,VICTOR,1873,0,0,2,2,0.0%,1h
48947,1,[Catory]Bricker,1873,0,0,2,2,0.0%,25m
48947,2,Chouby,1873,0,0,7,7,0.0%,18m
48969,3,IlllIIIlIIII,1872,1037,57,70,127,44.9%,30m
48969,3,Thorius,1872,1369,53,59,112,47.3%,1h
48969,3,Sante,1872,842,29,46,75,38.7%,1h
48969,1,Bzikeroff,1872,778,19,26,45,42.2%,12m
48969,2,qpax,1872,248,8,19,27,29.6%,1h
48969,2,supbapt,1872,156,6,21,27,22.2%,1h
48969,3,Tomash,1872,88,3,6,9,33.3%,1h
48969,3,Zayne,1872,30,3,6,9,33.3%,36m
48969,3,Weretrang,1872,46,2,5,7,28.6%,1h
48969,3,RLT,1872,0,1,0,1,100.0%,1h
48969,1,qdqdq,1872,0,1,1,2,50.0%,19m
48969,1,Benmorc,1872,0,1,1,2,50.0%,12m
48969,3,[AntLYF]Royal,1872,32,1,2,3,33.3%,1h
48969,1,Andriy,1872,0,0,2,2,0.0%,1h
48969,2,rinatgad,1872,0,0,9,9,0.0%,25m
48984,3,Doni,1871,873,32,36,68,47.1%,1h
48984,3,Killair,1871,460,20,26,46,43.5%,32m
48984,3,Luzgar,1871,385,15,27,42,35.7%,3m
48984,3,Toy,1871,339,12,13,25,48.0%,1h
48984,3,[MATMAR]WolfMage,1871,270,8,8,16,50.0%,8m
48984,3,multpit,1871,180,6,6,12,50.0%,7m
48984,3,DJGulaz,1871,172,5,6,11,45.5%,14m
48984,1,parakrama,1871,139,4,3,7,57.1%,1h
48984,3,zibu,1871,60,2,6,8,25.0%,27m
48984,2,BaZinGa,1871,138,2,10,12,16.7%,1h
48984,1,[NJoke]MOnsoon,1871,0,1,0,1,100.0%,1h
48984,1,ufo,1871,97,1,1,2,50.0%,33m
48984,3,Perets,1871,42,1,4,5,20.0%,1h
48984,2,Kenny,1871,0,1,5,6,16.7%,19m
48984,3,Depredador,1871,0,0,1,1,0.0%,6m
48984,1,Wolf,1871,0,0,3,3,0.0%,1h
48984,3,SmellYan,1871,0,0,7,7,0.0%,28m
49001,3,DSS,1870,1549,94,117,211,44.5%,26m
49001,3,Schiano,1870,696,30,36,66,45.5%,29m
49001,3,DaGOAT,1870,671,26,21,47,55.3%,1h
49001,2,Hexagon,1870,542,26,40,66,39.4%,24m
49001,3,Какасик,1870,634,21,26,47,44.7%,26m
49001,3,mcdave,1870,442,16,31,47,34.0%,1h
49001,1,FITZ,1870,444,10,8,18,55.6%,1h
49001,3,Marshal,1870,162,8,8,16,50.0%,1h
49001,1,Bukker,1870,205,4,14,18,22.2%,1h
49001,1,legoh,1870,132,3,2,5,60.0%,30m
49001,3,CrazyBatya,1870,0,2,4,6,33.3%,26m
49001,3,THEBIGBOSS,1870,125,2,7,9,22.2%,13m
49001,1,LOL,1870,48,2,10,12,16.7%,1h
49001,1,VASYA,1870,0,1,1,2,50.0%,34m
49001,1,LINK,1870,0,1,2,3,33.3%,8m
49001,1,[Naamyz]LAQUENNELLE,1870,46,1,2,3,33.3%,12m
49001,1,Hmz,1870,0,1,2,3,33.3%,8m
49001,2,tuy,1870,0,1,2,3,33.3%,3m
49001,3,Miro,1870,0,0,1,1,0.0%,1h
49001,3,[keups]Marcel,1870,0,0,2,2,0.0%,18m
49001,3,Romanooo,1870,0,0,5,5,0.0%,27m
49022,1,[Muist]MateiT,1869,828,21,18,39,53.8%,1h
49022,1,[34glhf]CCsCq,1869,337,9,5,14,64.3%,28m
49022,3,OverlordArc,1869,295,9,15,24,37.5%,1h
49022,3,Slayzer,1869,231,8,14,22,36.4%,27m
49022,2,[Нrr]Ruleezzz,1869,206,6,25,31,19.4%,15m
49022,3,AZIK,1869,118,5,10,15,33.3%,13m
49022,1,attila,1869,128,3,5,8,37.5%,4m
49022,2,Nazarii,1869,176,3,5,8,37.5%,29m
49022,2,Arantyr,1869,132,3,12,15,20.0%,1h
49022,1,[SC22SC]RUNO,1869,48,2,6,8,25.0%,2m
49022,1,Reaperdom,1869,46,1,3,4,25.0%,33m
49022,3,YOUNES,1869,30,1,8,9,11.1%,1h
49022,3,Romulus,1869,0,0,1,1,0.0%,1h
49022,1,Михаил,1869,0,0,3,3,0.0%,30m
49036,3,Mogge,1868,908,34,38,72,47.2%,1h
49036,3,myAss,1868,629,23,23,46,50.0%,17m
49036,3,cazoubiz,1868,245,8,20,28,28.6%,15m
49036,3,zeratul,1868,137,4,5,9,44.4%,36m
49036,1,Devx,1868,48,2,2,4,50.0%,16m
49036,1,djipi,1868,48,1,1,2,50.0%,1h
49036,3,Foxvyvy,1868,48,1,4,5,20.0%,17m
49036,3,LMM,1868,48,1,9,10,10.0%,1h
49036,3,Croker,1868,0,0,1,1,0.0%,17m
49036,3,искромэн,1868,0,0,1,1,0.0%,28m
49036,3,Курицын,1868,0,0,2,2,0.0%,32m
49036,2,Kwentein,1868,0,0,4,4,0.0%,5m
49048,2,Mac,1867,1454,61,76,137,44.5%,1h
49048,1,vin,1867,873,29,41,70,41.4%,1h
49048,2,Rayback,1867,136,18,32,50,36.0%,26m
49048,1,minebroNF,1867,268,7,3,10,70.0%,19m
49048,1,LLIMEJIb,1867,318,7,11,18,38.9%,3m
49048,3,Assassin,1867,110,2,10,12,16.7%,1h
49048,2,BronzeHero,1867,40,1,2,3,33.3%,1h
49048,2,Bob,1867,30,1,13,14,7.1%,1h
49048,1,criterrus,1867,0,0,2,2,0.0%,7m
49048,1,OnLink,1867,0,0,2,2,0.0%,3m
49048,2,operixon,1867,0,0,7,7,0.0%,26m
49059,3,JimVlad,1866,1497,440,506,946,46.5%,1h
49059,2,BattleMauler,1866,1470,333,342,675,49.3%,14m
49059,3,Shirkan,1866,974,61,71,132,46.2%,12m
49059,3,DJkrugger,1866,510,46,55,101,45.5%,1h
49059,3,Foxbone,1866,1030,36,46,82,43.9%,29m
49059,3,ALEX,1866,934,34,43,77,44.2%,27m
49059,3,JEF,1866,916,32,46,78,41.0%,32m
49059,3,khan,1866,748,27,43,70,38.6%,8m
49059,1,[VéGaNo]Lopi,1866,489,14,20,34,41.2%,4m
49059,3,Dulk,1866,324,12,20,32,37.5%,1h
49059,3,Bonny,1866,247,8,9,17,47.1%,4m
49059,3,Asmadiva,1866,136,4,9,13,30.8%,27m
49059,1,Pintman,1866,177,3,8,11,27.3%,33m
49059,1,noobtactics,1866,105,3,9,12,25.0%,33m
49059,3,GREY,1866,58,2,7,9,22.2%,1h
49059,3,JanPower,1866,0,0,4,4,0.0%,30m
49059,1,[10swrm]Callmehenry,1866,0,0,5,5,0.0%,16m
49076,3,AYA,1865,1585,145,179,324,44.8%,29m
49076,2,Titan,1865,1199,46,53,99,46.5%,1h
49076,1,Sasha,1865,874,38,46,84,45.2%,30m
49076,3,WERGAS,1865,1077,38,50,88,43.2%,1h
49076,3,Хлюп,1865,660,25,38,63,39.7%,7m
49076,2,Migol,1865,299,19,25,44,43.2%,1h
49076,1,Krypto,1865,554,15,27,42,35.7%,10m
49076,3,cripsoo,1865,397,13,16,29,44.8%,27m
49076,3,Nash,1865,250,9,18,27,33.3%,1h
49076,3,AITH,1865,270,9,22,31,29.0%,23m
49076,3,NotAydee,1865,228,8,18,26,30.8%,1h
49076,3,[Baise]Loðbrók,1865,226,7,14,21,33.3%,1h
49076,3,HAKKAR,1865,168,6,13,19,31.6%,32m
49076,2,[KrrFC]DaniOfDeath,1865,168,5,14,19,26.3%,1h
49076,1,mlodyknapik,1865,139,3,3,6,50.0%,1h
49076,1,DerHenker,1865,46,2,2,4,50.0%,1h
49076,3,Thoor,1865,78,2,10,12,16.7%,33m
49076,1,Rodos,1865,30,1,10,11,9.1%,1h
49076,3,frabouil,1865,0,0,6,6,0.0%,24m
49095,3,SERHAT,1864,1274,133,161,294,45.2%,7m
49095,1,Pandemio,1864,1987,98,114,212,46.2%,1h
49095,3,buduumnee,1864,550,32,41,73,43.8%,10m
49095,3,Warmecanic,1864,813,30,31,61,49.2%,1h
49095,3,Robiux,1864,626,22,26,48,45.8%,1h
49095,3,YtKa,1864,342,17,14,31,54.8%,18m
49095,3,leoM,1864,416,16,13,29,55.2%,10m
49095,1,Orange,1864,452,11,14,25,44.0%,33m
49095,1,Optem,1864,342,8,5,13,61.5%,1h
49095,2,RoccoBRUTALL,1864,182,7,19,26,26.9%,1h
49095,1,[VOLKI]Браттвоего,1864,229,6,7,13,46.2%,1h
49095,3,delovoy,1864,225,6,10,16,37.5%,12m
49095,1,TAHA,1864,46,1,4,5,20.0%,8m
49095,1,Aapdo,1864,0,0,1,1,0.0%,10m
49095,2,thunderz,1864,0,0,3,3,0.0%,1h
49110,3,PUTIN,1863,768,26,40,66,39.4%,1h
49110,1,Tosondr,1863,729,18,13,31,58.1%,11m
49110,1,[Sc2V]joaquin,1863,516,13,11,24,54.2%,1h
49110,1,DOM,1863,450,11,13,24,45.8%,7m
49110,3,Elkanijo,1863,293,9,15,24,37.5%,14m
49110,3,ShiMaN,1863,100,5,6,11,45.5%,1h
49110,1,Maverick,1863,94,3,2,5,60.0%,5m
49110,3,Star,1863,152,3,11,14,21.4%,14m
49110,3,Miguelsd,1863,30,2,4,6,33.3%,1h
49110,2,MEN,1863,0,2,7,9,22.2%,31m
49110,1,smart,1863,80,2,8,10,20.0%,1h
49110,1,iZapp,1863,46,1,4,5,20.0%,1h
49110,2,Эльфри,1863,95,1,9,10,10.0%,1h
49110,2,umarus,1863,46,1,9,10,10.0%,1h
49110,1,dervovan,1863,0,0,1,1,0.0%,5m
49110,1,TonyMontana,1863,0,0,2,2,0.0%,10m
49110,3,bananaboi,1863,0,0,4,4,0.0%,1h
49110,2,Hiszti,1863,0,0,8,8,0.0%,15m
49128,2,MadMax,1862,1504,104,120,224,46.4%,1h
49128,3,Hellboy,1862,1506,55,67,122,45.1%,16m
49128,3,[HHT]bttnkd,1862,702,24,35,59,40.7%,11m
49128,1,Slonopotam,1862,825,21,15,36,58.3%,1h
49128,1,jojo,1862,399,10,7,17,58.8%,1h
49128,2,panBobak,1862,283,9,16,25,36.0%,1h
49128,3,Robloxian,1862,228,8,15,23,34.8%,1h
49128,2,Observator,1862,180,7,9,16,43.8%,1h
49128,3,luke,1862,170,7,10,17,41.2%,23m
49128,1,terrorcop,1862,48,2,0,2,100.0%,5m
49128,1,Snowgunner,1862,0,1,0,1,100.0%,8m
49128,1,LILACBOB,1862,46,1,1,2,50.0%,10m
49128,1,Aleaiactaest,1862,48,1,3,4,25.0%,1h
49128,3,LLIOKEP,1862,0,1,5,6,16.7%,24m
49128,3,Blitz,1862,0,1,7,8,12.5%,1h
49128,1,DimaVnukov,1862,0,0,1,1,0.0%,1h
49128,1,Adriano,1862,0,0,2,2,0.0%,1h
49145,3,MrKnister,1861,1454,79,81,160,49.4%,12m
49145,3,GrinGo,1861,1176,69,79,148,46.6%,28m
49145,3,cardinal,1861,789,30,44,74,40.5%,23m
49145,3,[C12760]Ranger,1861,404,14,20,34,41.2%,1h
49145,3,porpu,1861,182,7,12,19,36.8%,1h
49145,1,Martess,1861,176,5,15,20,25.0%,1h
49145,2,SleepyBear,1861,143,3,2,5,60.0%,1h
49145,2,Øebele,1861,88,3,11,14,21.4%,5m
49145,1,yrchilxx,1861,106,2,5,7,28.6%,8m
49145,2,ocds,1861,60,2,9,11,18.2%,22m
49145,1,[diseas]Коронавирус,1861,0,1,1,2,50.0%,16m
49145,1,[FR1]KaltenCPN,1861,46,1,3,4,25.0%,7m
49145,1,GoldHavk,1861,73,1,12,13,7.7%,1h
49145,1,alexzizu,1861,0,0,3,3,0.0%,6m
49145,2,John,1861,0,0,6,6,0.0%,34m
49145,3,StErBeN,1861,0,0,7,7,0.0%,1h
49145,2,ANGELRCXD,1861,0,0,8,8,0.0%,32m
49162,3,MrNemo,1860,1512,228,252,480,47.5%,18m
49162,3,Arty,1860,1503,69,80,149,46.3%,32m
49162,3,Федор,1860,1052,59,64,123,48.0%,13m
49162,3,BambarbiaKir,1860,1450,52,68,120,43.3%,14m
49162,3,ceni,1860,1021,38,47,85,44.7%,12m
49162,1,Secured,1860,641,19,22,41,46.3%,11m
49162,3,[OKW1]Leon,1860,519,18,18,36,50.0%,26m
49162,3,PsychoCraft,1860,367,14,20,34,41.2%,1h
49162,2,andrey,1860,390,14,26,40,35.0%,32m
49162,2,KoTeu,1860,293,8,9,17,47.1%,1h
49162,3,JohnDoe,1860,194,6,13,19,31.6%,36m
49162,3,MaelegVonH,1860,145,4,3,7,57.1%,17m
49162,1,Maddog,1860,126,3,5,8,37.5%,1h
49162,3,[Gr4X4]Иван,1860,0,1,1,2,50.0%,32m
49162,3,ALEKSANDR,1860,0,0,7,7,0.0%,12m
49177,1,TriManXx,1859,750,19,16,35,54.3%,1h
49177,2,Hitane,1859,610,18,36,54,33.3%,12m
49177,2,KubasRubas,1859,382,12,22,34,35.3%,1h
49177,3,Belochka,1859,261,9,10,19,47.4%,2m
49177,2,ROOMTOOM,1859,146,3,7,10,30.0%,34m
49177,2,erbulan,1859,0,2,5,7,28.6%,22m
49177,2,CroProGaming,1859,46,2,9,11,18.2%,11m
49177,1,Psina,1859,139,2,15,17,11.8%,20m
49177,3,SpringWind,1859,91,1,8,9,11.1%,5m
49177,1,kele,1859,0,0,1,1,0.0%,34m
49177,3,LonelyIWP,1859,0,0,3,3,0.0%,28m
49177,1,[HRD]Hasherino,1859,73,0,7,7,0.0%,6m
49189,1,[Darks1]Cory,1858,1815,77,92,169,45.6%,1h
49189,1,RagnarKiyv,1858,1982,77,98,175,44.0%,17m
49189,3,Rulsan,1858,1264,60,63,123,48.8%,1h
49189,1,Vanerd,1858,499,12,13,25,48.0%,5m
49189,3,SHIVA,1858,258,10,14,24,41.7%,29m
49189,3,ELRinya,1858,279,9,21,30,30.0%,1h
49189,1,Hammerhans,1858,92,2,2,4,50.0%,1h
49189,3,jujules,1858,122,2,5,7,28.6%,26m
49189,3,Traagon,1858,30,2,5,7,28.6%,12m
49189,1,Maxim,1858,73,2,6,8,25.0%,1h
49189,1,andreas,1858,0,1,1,2,50.0%,1h
49189,3,blauweranger,1858,0,1,4,5,20.0%,1h
49189,3,giculescu,1858,46,1,7,8,12.5%,27m
49202,3,MarcoD,1857,1483,106,131,237,44.7%,12m
49202,3,PETREL,1857,1513,65,75,140,46.4%,14m
49202,1,DarkKain,1857,666,18,14,32,56.2%,19m
49202,1,emoli,1857,584,16,25,41,39.0%,1h
49202,1,Chickenhands,1857,226,7,8,15,46.7%,6m
49202,3,Omega,1857,176,6,9,15,40.0%,6m
49202,1,PanMIM,1857,118,3,7,10,30.0%,19m
49202,1,HANSI,1857,76,3,14,17,17.6%,8m
49202,3,Xcalibur,1857,60,2,7,9,22.2%,3m
49202,1,Rabotyaga,1857,125,2,10,12,16.7%,24m
49202,2,Code,1857,82,2,10,12,16.7%,4m
49202,3,Bebjo,1857,64,2,11,13,15.4%,18m
49202,1,GeneralOPA,1857,0,1,10,11,9.1%,1h
49202,2,[TPZGG]Max,1857,0,0,2,2,0.0%,19m
49202,1,[SEBULA]Pokemaster,1857,73,0,3,3,0.0%,5m
49202,2,Bubel,1857,0,0,4,4,0.0%,1h
49218,3,lexxxa,1856,1042,62,71,133,46.6%,12m
49218,2,Бориска,1856,692,26,41,67,38.8%,1h
49218,1,Alpha,1856,471,17,22,39,43.6%,17m
49218,2,maccoy,1856,382,14,28,42,33.3%,22m
49218,2,Sudia,1856,359,12,20,32,37.5%,10m
49218,1,Maximus,1856,242,9,7,16,56.2%,1h
49218,3,PREDATOR,1856,275,9,17,26,34.6%,5m
49218,1,ric,1856,365,8,20,28,28.6%,8m
49218,1,tot,1856,252,6,9,15,40.0%,7m
49218,1,Swayzomad,1856,232,5,7,12,41.7%,1h
49218,1,Imborger,1856,213,4,13,17,23.5%,10m
49218,1,hsm,1856,88,2,1,3,66.7%,1h
49218,1,Deraskos,1856,0,1,1,2,50.0%,1h
49218,1,anber,1856,42,1,5,6,16.7%,1h
49218,2,MouloudleKV,1856,0,0,2,2,0.0%,7m
49233,1,Egorushka,1855,636,20,18,38,52.6%,12m
49233,2,david,1855,359,11,30,41,26.8%,10m
49233,3,MRtraitor,1855,178,6,15,21,28.6%,15m
49233,2,сало,1855,120,4,11,15,26.7%,2m
49233,2,sanes,1855,44,2,10,12,16.7%,1h
49233,1,YouRDreaM,1855,92,2,14,16,12.5%,1h
49233,3,[EWEN]youtube,1855,88,1,2,3,33.3%,5m
49233,1,[IXtrme]GrandMaster,1855,48,1,3,4,25.0%,1h
49233,1,AlphaKing,1855,0,1,10,11,9.1%,2m
49233,1,Kevin,1855,0,0,1,1,0.0%,1h
49233,3,Simone,1855,0,0,5,5,0.0%,24m
49233,1,IIIIIIIIIIII,1855,73,0,6,6,0.0%,1h
49245,3,Chronophage,1854,1385,146,163,309,47.2%,26m
49245,3,Boss,1854,1438,53,59,112,47.3%,1h
49245,3,Nekros,1854,929,47,60,107,43.9%,1h
49245,3,FIN,1854,555,41,44,85,48.2%,13m
49245,1,Mornie,1854,700,17,30,47,36.2%,6m
49245,1,Marshal,1854,643,15,29,44,34.1%,1h
49245,1,Fighter,1854,356,9,13,22,40.9%,28m
49245,3,Lowrider,1854,118,7,4,11,63.6%,15m
49245,3,MrShep,1854,30,1,1,2,50.0%,15m
49245,3,UncleSam,1854,0,0,1,1,0.0%,1h
49245,3,Serg,1854,0,0,1,1,0.0%,1h
49256,3,IIIIIIIIIIII,1853,563,20,31,51,39.2%,27m
49256,1,SirTobi,1853,277,6,16,22,27.3%,33m
49256,3,Parallax,1853,94,3,7,10,30.0%,1h
49256,1,Джекирман,1853,48,2,5,7,28.6%,34m
49256,2,rasX,1853,0,1,10,11,9.1%,1h
49256,1,klepek,1853,0,0,1,1,0.0%,34m
49256,1,IriPlush,1853,0,0,11,11,0.0%,10m
49263,2,GameRespect,1852,929,119,135,254,46.9%,6m
49263,2,[ASS100]TrunkMonkey,1852,1491,97,116,213,45.5%,32m
49263,3,РезвыйМишка,1852,1479,59,71,130,45.4%,36m
49263,1,EVIL,1852,608,16,20,36,44.4%,1h
49263,1,KOBE,1852,455,10,24,34,29.4%,1h
49263,1,[998373]max,1852,138,4,3,7,57.1%,1h
49263,3,TurtulTerran,1852,116,4,7,11,36.4%,1h
49263,3,Stran,1852,144,3,7,10,30.0%,30m
49263,1,grosced,1852,92,2,2,4,50.0%,19m
49263,2,SCLEROS,1852,0,1,0,1,100.0%,1h
49263,1,Coucool,1852,46,1,1,2,50.0%,3m
49263,3,hallonspelar,1852,30,1,8,9,11.1%,1h
49275,1,Cube,1851,1232,35,36,71,49.3%,8m
49275,1,Lebrali,1851,780,21,26,47,44.7%,24m
49275,3,Kingslayer,1851,575,19,29,48,39.6%,14m
49275,1,Flomaster,1851,660,17,17,34,50.0%,30m
49275,2,TheMilitant,1851,334,12,23,35,34.3%,15m
49275,2,KILL,1851,152,4,4,8,50.0%,1h
49275,3,NARUTO,1851,170,4,5,9,44.4%,12m
49275,3,Nikorax,1851,68,4,7,11,36.4%,27m
49275,2,Марат,1851,30,2,8,10,20.0%,1h
49275,1,ВОМП,1851,0,1,4,5,20.0%,1h
49275,1,Red,1851,0,0,2,2,0.0%,1h
49275,3,eyes,1851,0,0,2,2,0.0%,11m
49275,3,Bacterio,1851,0,0,9,9,0.0%,1h
49288,1,jackhammer,1850,1116,104,169,273,38.1%,1h
49288,3,[PLKurw]Obahh,1850,587,26,24,50,52.0%,14m
49288,1,Aealo,1850,938,24,25,49,49.0%,5m
49288,3,Suplicek,1850,140,8,2,10,80.0%,1h
49288,2,BoDyBaLSaM,1850,300,8,20,28,28.6%,1h
49288,1,HzUBEYDULLA,1850,266,7,11,18,38.9%,1h
49288,2,Naruto,1850,201,5,9,14,35.7%,1h
49288,3,smino,1850,38,2,7,9,22.2%,1h
49288,1,Dardasa,1850,0,1,0,1,100.0%,16m
49288,1,Иван,1850,0,0,1,1,0.0%,5m
49298,3,geva,1849,1204,42,56,98,42.9%,26m
49298,1,pablo,1849,906,27,33,60,45.0%,1h
49298,2,Atlantis,1849,372,13,18,31,41.9%,29m
49298,1,Panda,1849,518,12,12,24,50.0%,1h
49298,2,ALEKPOS,1849,366,12,19,31,38.7%,1h
49298,1,KriegKorps,1849,332,8,18,26,30.8%,6m
49298,1,Potato,1849,347,7,8,15,46.7%,6m
49298,1,НЗХ,1849,184,7,17,24,29.2%,1h
49298,1,StarJunkie,1849,193,6,17,23,26.1%,10m
49298,2,sonofatto,1849,40,2,0,2,100.0%,7m
49298,1,Petro,1849,48,2,1,3,66.7%,1h
49298,1,beardygeek,1849,73,1,2,3,33.3%,2m
49298,2,timurka,1849,94,1,4,5,20.0%,1h
49298,3,lachsinc,1849,30,1,6,7,14.3%,15m
49298,1,Raoul,1849,0,0,1,1,0.0%,1h
49298,1,WaitMe,1849,0,0,3,3,0.0%,1h
49298,3,jer,1849,0,0,7,7,0.0%,1h
49315,3,[ScSg]DerKiller,1848,1127,40,45,85,47.1%,18m
49315,3,PLUUUTO,1848,1075,39,57,96,40.6%,1h
49315,3,VIXUSNET,1848,458,15,26,41,36.6%,12m
49315,3,NaPatyku,1848,304,11,19,30,36.7%,1h
49315,2,[Сold]даникпро,1848,194,6,13,19,31.6%,33m
49315,3,NitroWheels,1848,225,6,15,21,28.6%,8m
49315,3,smoooth,1848,194,5,9,14,35.7%,1h
49315,1,SirArcadius,1848,34,2,11,13,15.4%,1h
49315,3,Hartur,1848,0,1,4,5,20.0%,15m
49324,3,[10RuS]papasan,1847,1531,71,87,158,44.9%,15m
49324,3,Luke,1847,1265,51,54,105,48.6%,1h
49324,3,Morty,1847,1020,34,49,83,41.0%,1h
49324,1,TEX,1847,919,24,24,48,50.0%,1h
49324,3,SZNT,1847,234,7,16,23,30.4%,1h
49324,1,Rastoman,1847,226,5,8,13,38.5%,1h
49324,1,Mahelf,1847,0,4,1,5,80.0%,10m
49324,2,[AciNoN]Elngdraveln,1847,144,4,7,11,36.4%,33m
49324,2,[Ryskar]nikitaqqq,1847,124,3,6,9,33.3%,34m
49324,1,Neron,1847,100,2,8,10,20.0%,13m
49324,3,Grey,1847,123,2,11,13,15.4%,1h
49324,1,[AZaT]Runa,1847,46,1,1,2,50.0%,33m
49324,1,Giggio,1847,115,1,3,4,25.0%,35m
49324,3,Andreas,1847,0,1,7,8,12.5%,3m
49324,2,Yeashay,1847,0,1,10,11,9.1%,19m
49324,1,den,1847,0,0,1,1,0.0%,10m
49324,1,Acceton,1847,0,0,2,2,0.0%,5m
49324,1,[SpStub]Sani,1847,0,0,3,3,0.0%,1h
49342,3,SpaceFox,1846,1131,66,71,137,48.2%,12m
49342,3,gassolino,1846,1271,52,70,122,42.6%,15m
49342,2,Fitnesspuff,1846,961,38,44,82,46.3%,1h
49342,3,bvrx,1846,642,19,40,59,32.2%,1h
49342,3,zmeysin,1846,229,13,11,24,54.2%,1h
49342,1,AndrianIavn,1846,512,13,17,30,43.3%,1h
49342,3,Asterix,1846,60,2,9,11,18.2%,12m
49342,1,RogiNagvod,1846,46,1,2,3,33.3%,33m
49342,2,[Tambor]хитрый,1846,40,1,2,3,33.3%,1h
49342,2,Fenny,1846,0,1,9,10,10.0%,1h
49342,1,[animch]animecheniy,1846,0,0,1,1,0.0%,11m
49353,1,xispado,1845,1192,33,40,73,45.2%,1h
49353,3,JackSaimon,1845,898,33,44,77,42.9%,14m
49353,2,BlackFire,1845,730,23,39,62,37.1%,20m
49353,3,Dancygar,1845,528,17,29,46,37.0%,15m
49353,1,Coekie,1845,90,3,2,5,60.0%,1h
49353,1,WhiteEagle,1845,81,2,5,7,28.6%,24m
49353,1,шафи,1845,48,1,2,3,33.3%,13m
49353,3,conque,1845,97,1,4,5,20.0%,1h
49353,3,Istvan,1845,32,1,8,9,11.1%,18m
49353,2,Shinoda,1845,0,1,8,9,11.1%,14m
49353,2,Ekain,1845,30,1,9,10,10.0%,1h
49353,1,SASISKA,1845,0,0,1,1,0.0%,5m
49353,3,Kobold,1845,0,0,2,2,0.0%,1h
49366,1,Fumo,1844,1555,198,221,419,47.3%,1h
49366,3,Wojo,1844,1558,188,208,396,47.5%,18m
49366,3,Pretorian,1844,1435,75,84,159,47.2%,16m
49366,3,DoLwaKurma,1844,920,37,41,78,47.4%,4m
49366,3,Sargas,1844,744,29,39,68,42.6%,1h
49366,1,izanagi,1844,475,13,22,35,37.1%,12m
49366,3,[MASTOR]ThelwKrepes,1844,250,9,11,20,45.0%,35m
49366,1,AREX,1844,164,5,4,9,55.6%,1h
49366,2,Ilya,1844,243,5,14,19,26.3%,18m
49366,2,Камандор,1844,168,4,3,7,57.1%,1h
49366,1,LeoTerribile,1844,84,2,4,6,33.3%,1h
49366,1,[SergAt]SergBas,1844,0,1,0,1,100.0%,1h
49366,1,tiago,1844,44,1,2,3,33.3%,2m
49366,1,Димовров,1844,73,1,2,3,33.3%,8m
49366,1,Hummel,1844,0,0,1,1,0.0%,1h
49366,1,WEREHELE,1844,0,0,5,5,0.0%,12m
49366,3,QwerAntropod,1844,0,0,7,7,0.0%,29m
49383,1,Butchie,1843,1828,88,106,194,45.4%,1h
49383,3,HANNIBAL,1843,1044,37,50,87,42.5%,18m
49383,3,KrieK,1843,434,14,21,35,40.0%,27m
49383,3,colar,1843,304,10,18,28,35.7%,29m
49383,3,StarYohan,1843,203,6,16,22,27.3%,16m
49383,3,WiroX,1843,122,5,15,20,25.0%,1h
49383,3,BigSice,1843,158,4,8,12,33.3%,32m
49383,2,DimonVoinKSM,1843,88,4,14,18,22.2%,23m
49383,3,HenryThree,1843,122,2,10,12,16.7%,35m
49383,3,Глеб,1843,38,1,3,4,25.0%,33m
49383,1,Dorsa,1843,107,1,10,11,9.1%,1h
49383,1,NoboLulu,1843,0,0,2,2,0.0%,28m
49383,3,logic,1843,0,0,8,8,0.0%,18m
49396,3,Evo,1842,976,51,66,117,43.6%,1h
49396,3,Alto,1842,1356,50,65,115,43.5%,1h
49396,3,bob,1842,952,38,49,87,43.7%,10m
49396,1,SergioPolo,1842,1049,34,33,67,50.7%,1h
49396,3,joy,1842,258,9,19,28,32.1%,1h
49396,3,Jealca,1842,184,7,8,15,46.7%,1h
49396,2,DCeres,1842,136,7,11,18,38.9%,16m
49396,1,VoinCom,1842,187,6,13,19,31.6%,33m
49396,2,alexfaini,1842,114,4,14,18,22.2%,1h
49396,2,Mastadoc,1842,109,3,10,13,23.1%,1h
49396,2,[kikiri]Drakul,1842,90,3,12,15,20.0%,12m
49396,3,Alooky,1842,106,3,13,16,18.8%,1h
49396,1,[minire]Amarinta,1842,46,2,0,2,100.0%,1h
49396,1,Champiman,1842,96,2,4,6,33.3%,1h
49396,2,IIIIIIIIIIII,1842,0,1,0,1,100.0%,1h
49396,3,[SeVenV]ElderBear,1842,30,1,7,8,12.5%,33m
49396,1,[Gurkie]Midnor,1842,73,1,7,8,12.5%,12m
49396,2,Lizardo,1842,30,1,9,10,10.0%,22m
49396,1,MadDOG,1842,0,1,11,12,8.3%,1h
49396,1,LEOPARDI,1842,73,1,11,12,8.3%,1h
49396,1,[DBear]matfried,1842,0,0,2,2,0.0%,1h
49396,1,Acronix,1842,73,0,4,4,0.0%,1h
49418,2,Vinda,1841,1523,72,98,170,42.4%,18m
49418,3,[Gasu]alien,1841,1066,44,47,91,48.4%,24m
49418,3,BIGPAPI,1841,603,39,43,82,47.6%,15m
49418,2,kikejb,1841,362,24,38,62,38.7%,1h
49418,1,Mercus,1841,745,20,26,46,43.5%,5m
49418,1,Vadiaev,1841,706,19,16,35,54.3%,1h
49418,1,KräuterTroll,1841,533,16,13,29,55.2%,1h
49418,1,starcraf,1841,538,13,14,27,48.1%,1h
49418,1,mrbublik,1841,463,12,14,26,46.2%,1h
49418,3,FabriceB,1841,86,3,9,12,25.0%,17m
49418,1,Zaniah,1841,106,3,18,21,14.3%,1h
49418,1,ZioRufo,1841,0,1,10,11,9.1%,8m
49418,1,Stophorus,1841,0,0,1,1,0.0%,10m
49418,3,ten,1841,0,0,1,1,0.0%,30m
49432,3,LordPri,1840,353,10,16,26,38.5%,32m
49432,3,WarLordKai,1840,224,9,21,30,30.0%,12m
49432,1,johnyfast,1840,218,6,4,10,60.0%,33m
49432,1,Rick,1840,82,2,2,4,50.0%,1h
49432,1,DALLER,1840,135,2,6,8,25.0%,1h
49432,1,[hgdiy6]eol,1840,0,0,1,1,0.0%,10m
49432,1,IIIIIIIIIIII,1840,0,0,1,1,0.0%,6m
49432,1,vaco,1840,0,0,2,2,0.0%,8m
49432,1,Lucian,1840,0,0,3,3,0.0%,34m
49432,2,дллдрплдоолд,1840,0,0,4,4,0.0%,1h
49432,3,Zube,1840,0,0,8,8,0.0%,17m
49443,3,Arno,1839,1505,120,143,263,45.6%,18m
49443,3,kush,1839,221,29,28,57,50.9%,1h
49443,2,Manitou,1839,599,21,41,62,33.9%,1h
49443,3,DragoOscuro,1839,526,19,33,52,36.5%,1h
49443,1,giotto,1839,719,18,24,42,42.9%,1h
49443,1,cemehob,1839,558,16,17,33,48.5%,10m
49443,3,GIGROBOT,1839,260,10,13,23,43.5%,35m
49443,3,[ALPM]agentCAT,1839,175,6,8,14,42.9%,11m
49443,1,mrPro,1839,183,3,11,14,21.4%,1h
49443,2,Jaybo,1839,135,2,7,9,22.2%,29m
49443,2,незламний,1839,97,1,4,5,20.0%,11m
49443,1,zakru,1839,0,0,1,1,0.0%,1h
49455,3,mizo,1838,1538,111,123,234,47.4%,2m
49455,3,trollur,1838,703,29,34,63,46.0%,2m
49455,1,Layoye,1838,914,23,28,51,45.1%,33m
49455,3,EcaneM,1838,357,12,17,29,41.4%,5m
49455,1,[HBGSJR]vladozerg,1838,90,2,4,6,33.3%,1h
49455,1,Obstruktor,1838,44,1,2,3,33.3%,3m
49455,3,ROBSSON,1838,0,0,8,8,0.0%,26m
49462,3,jenslinkopin,1837,1291,114,142,256,44.5%,1h
49462,2,ZeliBoba,1837,1105,107,117,224,47.8%,1h
49462,3,LIO,1837,1564,63,66,129,48.8%,1h
49462,3,Raygorn,1837,752,41,60,101,40.6%,5m
49462,3,XIMIK,1837,528,22,25,47,46.8%,1h
49462,1,DULEPA,1837,418,11,22,33,33.3%,10m
49462,1,[BiFeld]Skeleton,1837,426,10,10,20,50.0%,18m
49462,1,DeadlyCoon,1837,245,8,6,14,57.1%,33m
49462,3,BlackHoleIII,1837,177,5,16,21,23.8%,27m
49462,1,madman,1837,215,4,4,8,50.0%,28m
49462,3,xCCCPx,1837,155,4,16,20,20.0%,36m
49462,3,Skrem,1837,125,3,6,9,33.3%,1h
49462,1,DarkWing,1837,92,2,5,7,28.6%,20m
49462,1,Simon,1837,0,0,3,3,0.0%,30m
49476,1,[CruZe]RealBenza,1836,944,30,46,76,39.5%,19m
49476,1,KON,1836,647,18,14,32,56.2%,8m
49476,1,MrAnderson,1836,273,8,19,27,29.6%,10m
49476,2,NvmMe,1836,225,6,14,20,30.0%,1h
49476,3,[mfxed]DOMEN,1836,170,4,9,13,30.8%,1h
49476,1,Артём,1836,130,4,10,14,28.6%,5m
49476,3,StarManuel,1836,154,4,11,15,26.7%,1h
49476,3,Jobbus,1836,58,2,10,12,16.7%,1h
49476,1,SausageNinja,1836,0,0,1,1,0.0%,25m
49476,3,Ariakas,1836,0,0,6,6,0.0%,13m
49476,3,wukonglee,1836,0,0,8,8,0.0%,28m
49487,3,Lex,1835,1537,111,145,256,43.4%,1h
49487,1,артём,1835,899,24,27,51,47.1%,5m
49487,1,CaYpouTest,1835,624,17,26,43,39.5%,1h
49487,1,[SPAINs]mon,1835,640,16,18,34,47.1%,34m
49487,3,Ozzino,1835,400,15,15,30,50.0%,1h
49487,2,Xeran,1835,222,8,18,26,30.8%,36m
49487,3,Pchel,1835,140,6,13,19,31.6%,15m
49487,3,ниндзя,1835,102,4,5,9,44.4%,13m
49487,1,koula,1835,48,2,3,5,40.0%,7m
49487,1,Crunklulu,1835,42,2,13,15,13.3%,3m
49487,1,WielkiTopór,1835,0,1,9,10,10.0%,27m
49487,3,ƁѺҲǃŅĢҁạƞƞѻƞ,1835,0,0,1,1,0.0%,1h
49487,1,tikhonovegor,1835,0,0,2,2,0.0%,18m
49487,3,Stome,1835,0,0,7,7,0.0%,1h
49487,3,Vadmeggy,1835,0,0,7,7,0.0%,1h
49487,3,SurfinSulo,1835,0,0,9,9,0.0%,28m
49503,3,Arok,1834,1451,53,66,119,44.5%,15m
49503,1,Blackdolphin,1834,1560,47,62,109,43.1%,13m
49503,3,ScOuT,1834,544,44,56,100,44.0%,10m
49503,1,[KOIDS]Thomas,1834,837,29,44,73,39.7%,6m
49503,1,Ekel,1834,864,27,32,59,45.8%,1h
49503,3,теран,1834,561,21,35,56,37.5%,1h
49503,1,AlperTunga,1834,266,7,7,14,50.0%,1h
49503,1,xXTSkyaTXx,1834,228,6,6,12,50.0%,1h
49503,3,Kylo,1834,68,4,7,11,36.4%,34m
49503,1,Kingmorc,1834,182,4,9,13,30.8%,1h
49503,2,[2135]Tapor,1834,103,2,3,5,40.0%,28m
49503,1,mat,1834,0,2,11,13,15.4%,1h
49503,1,[MVV77]Hero,1834,46,1,2,3,33.3%,1h
49503,1,HarryB,1834,0,0,1,1,0.0%,6m
49503,1,Piotr,1834,0,0,2,2,0.0%,25m
49503,3,Basher,1834,0,0,8,8,0.0%,1h
49519,1,DimaL,1833,1748,91,122,213,42.7%,1h
49519,3,Redmist,1833,1258,41,62,103,39.8%,14m
49519,3,shadowdanil,1833,843,37,35,72,51.4%,29m
49519,3,OverLord,1833,742,25,34,59,42.4%,1h
49519,1,CyberKnight,1833,842,23,22,45,51.1%,5m
49519,1,DMITRY,1833,350,9,8,17,52.9%,1h
49519,1,deMichel,1833,277,5,1,6,83.3%,3m
49519,1,ilya,1833,222,5,10,15,33.3%,1h
49519,2,kristian,1833,118,3,11,14,21.4%,34m
49519,2,OYVKRI,1833,94,3,13,16,18.8%,1h
49519,2,IIIIIIIIIIII,1833,30,3,15,18,16.7%,13m
49519,2,Expect,1833,139,2,11,13,15.4%,3m
49519,1,DidoMetro,1833,0,1,0,1,100.0%,11m
49519,1,[InkInc]Trolololo,1833,0,1,0,1,100.0%,1h
49519,1,xxKaelxx,1833,46,1,2,3,33.3%,1h
49519,2,UrkeBoss,1833,97,1,3,4,25.0%,1h
49519,3,Jusseff,1833,0,0,7,7,0.0%,30m
49536,3,BeachFlow,1832,529,81,85,166,48.8%,1h
49536,3,ComanderTom,1832,1057,43,49,92,46.7%,18m
49536,1,rimon,1832,436,18,32,50,36.0%,25m
49536,1,[Ogz]tof,1832,602,15,22,37,40.5%,1h
49536,3,Sniper,1832,324,14,13,27,51.9%,1h
49536,3,JabbaElJack,1832,471,14,21,35,40.0%,4m
49536,1,Fisken,1832,499,12,11,23,52.2%,1h
49536,1,павлик,1832,348,7,4,11,63.6%,12m
49536,1,[3ЕRGTV]Kaori,1832,274,7,14,21,33.3%,7m
49536,2,[LifeTV]SmerchKZ,1832,146,6,13,19,31.6%,1h
49536,1,RainMaker,1832,146,5,5,10,50.0%,1h
49536,1,Alvxro,1832,46,2,1,3,66.7%,1h
49536,1,ZerO,1832,34,2,1,3,66.7%,1h
49536,1,NagisaSkrid,1832,0,1,0,1,100.0%,19m
49536,1,[MrLord]вак,1832,42,1,1,2,50.0%,3m
49536,1,fagh,1832,46,1,2,3,33.3%,13m
49536,3,Bhaine,1832,0,0,6,6,0.0%,29m
49536,3,Darnbull,1832,0,0,7,7,0.0%,1h
49554,2,[HARTO]jooh,1831,1212,91,115,206,44.2%,1h
49554,1,HERVE,1831,1823,86,117,203,42.4%,1h
49554,3,Klausi,1831,653,22,37,59,37.3%,1h
49554,3,InSiteCom,1831,248,19,28,47,40.4%,12m
49554,1,kemo,1831,744,18,26,44,40.9%,25m
49554,3,[NWGD]Terrantes,1831,193,9,13,22,40.9%,7m
49554,3,OberstBreit,1831,94,5,19,24,20.8%,18m
49554,1,Dedpool,1831,0,1,1,2,50.0%,33m
49554,1,Tochka,1831,0,1,2,3,33.3%,1h
49554,3,PrawnCracker,1831,0,0,2,2,0.0%,29m
49554,2,Killerboy,1831,0,0,5,5,0.0%,24m
49554,3,TuTucse,1831,0,0,5,5,0.0%,34m
49554,3,[MAdeMa]diagen,1831,0,0,7,7,0.0%,1h
49554,3,COOLPANDA,1831,0,0,7,7,0.0%,1h
49568,3,AturoWar,1830,960,45,61,106,42.5%,1h
49568,3,Mélicia,1830,747,40,50,90,44.4%,1h
49568,3,Bullymong,1830,449,15,19,34,44.1%,1h
49568,1,Chechundra,1830,413,11,16,27,40.7%,1h
49568,1,OnurD,1830,304,7,8,15,46.7%,10m
49568,2,RaGdE,1830,131,2,11,13,15.4%,1h
49568,1,[PS23]IVirtual,1830,0,1,3,4,25.0%,1h
49568,1,Leoneld,1830,0,0,3,3,0.0%,1h
49568,3,kolch,1830,0,0,7,7,0.0%,17m
49577,2,PREDATOR,1829,318,11,19,30,36.7%,26m
49577,1,mogur,1829,448,10,14,24,41.7%,18m
49577,1,MSZ,1829,322,8,4,12,66.7%,1h
49577,3,Spawn,1829,154,5,14,19,26.3%,14m
49577,3,Taruls,1829,106,4,0,4,100.0%,33m
49577,1,[BobiK]Bobik,1829,92,3,1,4,75.0%,20m
49577,3,Khartas,1829,120,3,4,7,42.9%,1h
49577,1,Roberto,1829,0,1,1,2,50.0%,8m
49577,2,Larrkbug,1829,0,1,5,6,16.7%,1h
49577,1,PastyPatrol,1829,0,1,12,13,7.7%,10m
49577,3,ANTONIORUS,1829,0,0,2,2,0.0%,1h
49577,1,kapuch,1829,0,0,5,5,0.0%,1h
49577,3,CastorTroy,1829,0,0,8,8,0.0%,28m
49577,2,KaFo,1829,0,0,8,8,0.0%,1h
49591,3,[palats]Teo,1828,1502,83,95,178,46.6%,5m
49591,3,Кровавый,1828,1479,83,98,181,45.9%,1h
49591,1,NOSTRO,1828,1579,46,54,100,46.0%,30m
49591,3,smily,1828,649,25,30,55,45.5%,24m
49591,3,Snow,1828,486,18,17,35,51.4%,14m
49591,1,IvenTV,1828,344,8,11,19,42.1%,33m
49591,1,vsp,1828,274,7,7,14,50.0%,1h
49591,2,genar,1828,156,5,17,22,22.7%,31m
49591,3,cedar,1828,64,4,7,11,36.4%,1h
49591,1,rossi,1828,136,3,6,9,33.3%,18m
49591,3,Slava,1828,0,2,5,7,28.6%,16m
49591,1,Puppet,1828,0,1,2,3,33.3%,4m
49591,3,furyjen,1828,0,0,1,1,0.0%,13m
49591,3,Rafcio,1828,0,0,2,2,0.0%,1h
49605,3,lowAPM,1827,1231,127,156,283,44.9%,4m
49605,3,PAH,1827,1534,88,112,200,44.0%,1h
49605,1,Metamorf,1827,1479,46,50,96,47.9%,1h
49605,3,Просиратор,1827,480,18,25,43,41.9%,13m
49605,3,Magnus,1827,294,16,21,37,43.2%,1h
49605,1,Komick,1827,433,13,18,31,41.9%,2m
49605,1,SkyWan,1827,478,12,18,30,40.0%,10m
49605,1,ТРАМПЕЦ,1827,350,9,21,30,30.0%,1h
49605,2,AlfSanz,1827,122,6,12,18,33.3%,1h
49605,3,Огонек,1827,92,4,12,16,25.0%,29m
49605,3,TheVibe,1827,134,4,17,21,19.0%,18m
49605,2,Nightrunner,1827,0,1,0,1,100.0%,18m
49605,1,Quadro,1827,46,1,4,5,20.0%,5m
49605,3,pidor,1827,0,1,8,9,11.1%,9m
49619,1,mergo,1826,1730,54,76,130,41.5%,6m
49619,1,lolo,1826,1581,50,54,104,48.1%,1h
49619,3,MorpheusPest,1826,893,34,44,78,43.6%,7m
49619,1,Fabrizio,1826,790,20,24,44,45.5%,1h
49619,1,Ulyse,1826,746,19,17,36,52.8%,33m
49619,3,Regoobud,1826,475,16,27,43,37.2%,27m
49619,3,[XZ3R0X]BeHappyyy,1826,279,9,19,28,32.1%,1h
49619,1,huddeltoddel,1826,248,8,20,28,28.6%,1h
49619,1,Vince,1826,226,5,7,12,41.7%,12m
49619,1,Sylvain,1826,224,5,8,13,38.5%,18m
49619,1,Feveci,1826,193,4,5,9,44.4%,20m
49619,3,Jag,1826,48,3,5,8,37.5%,1h
49619,3,BAKTOV,1826,0,1,6,7,14.3%,1h
49619,1,ИмяПерсонаж,1826,0,1,10,11,9.1%,8m
49619,1,[LDvx]SNAIPER,1826,0,0,1,1,0.0%,1h
49619,1,[RO2020]Boogdan,1826,0,0,1,1,0.0%,1h
49619,1,[MODRR]PORSCHETUN,1826,0,0,3,3,0.0%,18m
49636,1,Naedix,1825,648,17,31,48,35.4%,1h
49636,1,Gandalf,1825,316,7,7,14,50.0%,18m
49636,1,Catalin,1825,182,4,6,10,40.0%,12m
49636,3,RUBENSELFO,1825,119,3,7,10,30.0%,16m
49636,1,Charasa,1825,44,2,0,2,100.0%,11m
49636,1,Yonisbnladen,1825,94,2,1,3,66.7%,28m
49636,1,Alfarius,1825,44,2,8,10,20.0%,1h
49636,1,Zak,1825,0,1,0,1,100.0%,1h
49636,1,Курунг,1825,117,1,3,4,25.0%,1h
49636,2,supermago,1825,94,1,9,10,10.0%,16m
49636,1,SCRIBPIC,1825,0,1,11,12,8.3%,34m
49636,2,psk,1825,0,0,1,1,0.0%,1h
49648,3,MagicianTom,1824,732,25,43,68,36.8%,36m
49648,1,fasststrike,1824,918,24,26,50,48.0%,1h
49648,1,TreJAM,1824,542,17,15,32,53.1%,18m
49648,1,Farron,1824,400,10,11,21,47.6%,25m
49648,3,Venum,1824,275,10,19,29,34.5%,7m
49648,1,антон,1824,304,7,5,12,58.3%,1h
49648,1,Naomak,1824,268,7,19,26,26.9%,1h
49648,1,frost,1824,155,5,10,15,33.3%,6m
49648,3,SANJEY,1824,30,2,3,5,40.0%,5m
49648,3,cesar,1824,0,0,1,1,0.0%,34m
49648,1,WuzIK,1824,0,0,3,3,0.0%,25m
49648,3,Thornes,1824,0,0,4,4,0.0%,1h
49660,3,[mfixed]gupihuj,1823,650,85,100,185,45.9%,29m
49660,3,gozgoz,1823,1460,79,103,182,43.4%,11m
49660,3,Eldermann,1823,408,42,53,95,44.2%,1h
49660,1,MiesKE,1823,1382,41,49,90,45.6%,1h
49660,2,ZiZou,1823,714,25,33,58,43.1%,34m
49660,1,JorgeXIII,1823,848,23,29,52,44.2%,13m
49660,1,SMcG,1823,698,18,22,40,45.0%,1h
49660,1,ghost,1823,46,2,0,2,100.0%,10m
49660,2,akapest,1823,34,2,4,6,33.3%,11m
49660,1,Rico,1823,108,1,8,9,11.1%,1h
49670,1,VETER,1822,1206,33,53,86,38.4%,16m
49670,3,Surrender,1822,404,32,37,69,46.4%,1h
49670,1,Finnnn,1822,538,17,9,26,65.4%,11m
49670,3,Текс,1822,221,12,19,31,38.7%,33m
49670,3,vini,1822,251,9,12,21,42.9%,16m
49670,1,JoNinja,1822,255,6,8,14,42.9%,12m
49670,3,[шаурм]PIGERROR,1822,141,4,6,10,40.0%,14m
49670,2,Strikestar,1822,0,1,1,2,50.0%,24m
49670,1,[1FU2]Hitch,1822,0,1,2,3,33.3%,1h
49670,1,SeeMeFall,1822,73,0,2,2,0.0%,1h
49670,3,TNTtero,1822,0,0,3,3,0.0%,1h
49681,3,Bensakul,1821,1282,59,71,130,45.4%,24m
49681,1,Puffolotto,1821,1580,57,70,127,44.9%,32m
49681,1,Chris,1821,1313,40,52,92,43.5%,12m
49681,1,Casti,1821,1122,31,35,66,47.0%,6m
49681,1,[EREKT]Mat,1821,746,20,31,51,39.2%,30m
49681,1,kazio,1821,578,17,18,35,48.6%,10m
49681,1,Lifeman,1821,606,15,20,35,42.9%,6m
49681,1,Christel,1821,526,13,10,23,56.5%,1h
49681,2,mrage,1821,447,13,21,34,38.2%,22m
49681,1,kawazx,1821,408,10,17,27,37.0%,11m
49681,1,[EliteX]jpomalaga,1821,182,4,5,9,44.4%,12m
49681,3,[Yedaz]grumpyelf,1821,60,3,9,12,25.0%,17m
49681,1,RyDos,1821,118,3,14,17,17.6%,18m
49681,3,ichbingutdv,1821,0,1,1,2,50.0%,1h
49681,1,Maryo,1821,0,1,2,3,33.3%,25m
49681,1,Vazon,1821,0,1,5,6,16.7%,11m
49697,2,[GGTGV]EkoW,1820,1144,484,907,1391,34.8%,20m
49697,3,ПутлерКАПУТ,1820,1553,94,118,212,44.3%,1h
49697,3,davcrash,1820,1331,53,68,121,43.8%,1h
49697,1,dma,1820,296,8,11,19,42.1%,5m
49697,3,zeus,1820,196,6,19,25,24.0%,36m
49697,1,Capybara,1820,198,6,33,39,15.4%,19m
49697,1,AleksPryanik,1820,176,5,6,11,45.5%,20m
49697,1,Eisenfuß,1820,0,4,1,5,80.0%,12m
49697,1,PunicaDrink,1820,151,4,5,9,44.4%,19m
49697,3,Skywalker,1820,34,2,0,2,100.0%,1h
49697,1,KING,1820,0,2,1,3,66.7%,1h
49697,1,Hellson,1820,92,2,3,5,40.0%,1h
49697,1,EastGuest,1820,90,2,5,7,28.6%,1h
49697,2,Dannii,1820,122,2,11,13,15.4%,6m
49697,1,Vortas,1820,0,1,1,2,50.0%,1h
49697,1,Myway,1820,0,0,2,2,0.0%,33m
49697,1,[DL2006]Hybrid,1820,0,0,2,2,0.0%,1h
49714,1,Pierrick,1819,1156,32,37,69,46.4%,19m
49714,1,Vilhelm,1819,822,21,22,43,48.8%,5m
49714,3,MOI,1819,446,16,19,35,45.7%,24m
49714,1,[Mastr]cooollmomins,1819,373,10,11,21,47.6%,7m
49714,1,[NRCH]crezy,1819,224,8,13,21,38.1%,1h
49714,3,FANAT,1819,217,8,13,21,38.1%,7m
49714,1,MstarTERROR,1819,262,8,23,31,25.8%,8m
49714,1,BIBA,1819,222,5,7,12,41.7%,1h
49714,3,xhi,1819,76,3,0,3,100.0%,1h
49714,3,Симач,1819,0,2,5,7,28.6%,1h
49714,1,MrPerfect,1819,46,1,1,2,50.0%,1h
49714,1,husoo,1819,0,0,1,1,0.0%,1h
49726,3,[LOGS]RynoWNell,1818,1156,47,57,104,45.2%,16m
49726,1,Valteh,1818,1328,38,43,81,46.9%,30m
49726,1,Baddleboi,1818,708,21,23,44,47.7%,11m
49726,1,СолоМон,1818,416,17,8,25,68.0%,16m
49726,1,Alphar,1818,474,12,13,25,48.0%,1h
49726,1,простоЛис,1818,400,11,16,27,40.7%,1h
49726,2,IronFenix,1818,372,10,22,32,31.2%,22m
49726,1,Sandmaker,1818,202,6,11,17,35.3%,28m
49726,2,exolothrefti,1818,294,6,12,18,33.3%,19m
49726,3,LOLO,1818,60,4,8,12,33.3%,1h
49726,1,[IISSII]Xerxis,1818,0,0,1,1,0.0%,1h
49726,3,Parmesan,1818,0,0,1,1,0.0%,1h
49726,3,[Olеg]Goblin,1818,0,0,1,1,0.0%,1h
49726,1,Deni,1818,0,0,1,1,0.0%,16m
49740,1,Bendor,1817,1244,40,45,85,47.1%,25m
49740,1,Mehrande,1817,1289,39,47,86,45.3%,1h
49740,1,GhorghorBey,1817,864,23,28,51,45.1%,5m
49740,1,Hvasnpure,1817,140,4,14,18,22.2%,2m
49740,1,[JaDiJo]Metachumb,1817,154,3,4,7,42.9%,1h
49740,3,Harim,1817,0,2,4,6,33.3%,1h
49740,2,BranislavR,1817,30,2,10,12,16.7%,1h
49740,1,[GSBLol]ogonek,1817,30,2,11,13,15.4%,34m
49740,2,Herou,1817,34,1,10,11,9.1%,34m
49740,1,SilentSword,1817,0,0,2,2,0.0%,5m
49740,1,BorisFen,1817,0,0,2,2,0.0%,2m
49740,3,SimpaTillas,1817,0,0,8,8,0.0%,1h
49752,3,Perle,1816,1570,373,476,849,43.9%,18m
49752,3,Amans,1816,1123,42,50,92,45.7%,12m
49752,1,Methba,1816,944,26,29,55,47.3%,25m
49752,3,LorenzKenobi,1816,756,26,34,60,43.3%,1h
49752,1,Fiodor,1816,586,17,16,33,51.5%,25m
49752,1,Ruzmat,1816,658,16,26,42,38.1%,4m
49752,3,Nardàrù,1816,212,6,7,13,46.2%,1h
49752,1,Hydro,1816,120,6,13,19,31.6%,30m
49752,2,пчёлка,1816,220,6,17,23,26.1%,1h
49752,1,fabry,1816,206,5,6,11,45.5%,1h
49752,1,Rolord,1816,134,5,17,22,22.7%,7m
49752,1,stef,1816,136,4,7,11,36.4%,8m
49752,1,KorowaNaHaip,1816,80,3,1,4,75.0%,33m
49752,1,SAYAN,1816,93,2,2,4,50.0%,35m
49752,1,Darce,1816,0,2,4,6,33.3%,1h
49752,3,bigboz,1816,62,2,12,14,14.3%,1h
49752,3,JimKnopf,1816,0,1,4,5,20.0%,1h
49752,1,mat,1816,44,1,6,7,14.3%,16m
49752,3,ZEL,1816,0,1,8,9,11.1%,36m
49752,3,TCA,1816,18,1,9,10,10.0%,1h
49772,2,Beiyan,1815,1495,141,170,311,45.3%,4m
49772,1,Sabian,1815,1957,101,123,224,45.1%,1h
49772,3,[N1TDA]DavCarc,1815,1536,71,82,153,46.4%,1h
49772,3,Denderik,1815,975,37,47,84,44.0%,1h
49772,1,Whiteman,1815,1045,32,37,69,46.4%,1h
49772,1,Игорь,1815,934,23,31,54,42.6%,33m
49772,3,Zule,1815,518,19,29,48,39.6%,1h
49772,3,Ragnar,1815,523,18,26,44,40.9%,12m
49772,1,sas,1815,248,8,21,29,27.6%,33m
49772,3,Jcasmed,1815,193,7,13,20,35.0%,14m
49772,1,JohnLocke,1815,220,6,7,13,46.2%,25m
49772,2,Branc,1815,130,4,15,19,21.1%,1h
49772,1,JayFoochee,1815,155,3,12,15,20.0%,1h
49772,1,Rodik,1815,133,2,6,8,25.0%,11m
49772,1,ambroz,1815,0,1,1,2,50.0%,3m
49772,1,Koquatrix,1815,0,1,1,2,50.0%,1h
49772,3,[GymBoy]EGA,1815,0,0,1,1,0.0%,34m
49789,3,павел,1814,1519,66,79,145,45.5%,5m
49789,1,Sparx,1814,1101,39,49,88,44.3%,1h
49789,1,Javi,1814,623,14,13,27,51.9%,8m
49789,1,Nenerial,1814,212,10,15,25,40.0%,1h
49789,2,[ALPis]RoyBaer,1814,180,6,14,20,30.0%,1h
49789,1,[SPAINs]caymansitojr,1814,115,2,12,14,14.3%,1h
49789,3,skydreamfall,1814,30,1,8,9,11.1%,13m
49789,2,Sercapy,1814,92,1,9,10,10.0%,1h
49789,1,Thundersky,1814,0,0,3,3,0.0%,30m
49789,1,PXL,1814,0,0,3,3,0.0%,35m
49789,3,[PPPS]karma,1814,0,0,3,3,0.0%,9m
49800,1,MANOUCH,1813,1543,602,696,1298,46.4%,35m
49800,2,SuNtZi,1813,1163,160,194,354,45.2%,1h
49800,3,LionHart,1813,1260,103,130,233,44.2%,14m
49800,3,Mina,1813,1520,53,74,127,41.7%,22m
49800,1,GhostDog,1813,1156,32,39,71,45.1%,1h
49800,1,KappaX,1813,991,30,34,64,46.9%,1h
49800,3,Laci,1813,789,29,34,63,46.0%,17m
49800,1,Sargeras,1813,486,11,17,28,39.3%,28m
49800,1,ODC,1813,316,8,8,16,50.0%,19m
49800,1,JohnFurie,1813,178,4,4,8,50.0%,1h
49800,2,JacobX,1813,134,3,9,12,25.0%,19m
49800,2,Raider,1813,109,2,12,14,14.3%,1h
49800,3,PTYTb,1813,0,1,6,7,14.3%,1h
49800,3,Кря,1813,0,0,1,1,0.0%,1h
49800,3,Nevermind,1813,0,0,8,8,0.0%,15m
49815,3,Zentauri,1812,1186,43,54,97,44.3%,7m
49815,1,Visored,1812,1005,34,48,82,41.5%,1h
49815,2,Mauro,1812,750,26,36,62,41.9%,7m
49815,3,Crandon,1812,523,17,29,46,37.0%,12m
49815,1,Yzzin,1812,180,6,1,7,85.7%,25m
49815,1,Urf,1812,136,3,3,6,50.0%,1h
49815,2,Evkakiy,1812,88,3,13,16,18.8%,3m
49815,1,Tazmania,1812,96,2,5,7,28.6%,1h
49815,3,Koethe,1812,62,2,7,9,22.2%,30m
49815,1,КЛИЧКО,1812,0,0,1,1,0.0%,7m
49815,1,stalker,1812,0,0,1,1,0.0%,10m
49815,3,Icey,1812,0,0,3,3,0.0%,1h
49815,3,TRekt,1812,0,0,5,5,0.0%,7m
49815,1,[kluni]Evilprotos,1812,73,0,6,6,0.0%,1h
49829,3,SAU,1811,487,17,28,45,37.8%,18m
49829,1,Pitto,1811,593,16,17,33,48.5%,18m
49829,1,cmtKARMA,1811,348,10,9,19,52.6%,4m
49829,2,GenzGame,1811,148,6,15,21,28.6%,1h
49829,3,Dani,1811,126,4,3,7,57.1%,1h
49829,3,DhaliLama,1811,68,3,6,9,33.3%,34m
49829,2,HiQ,1811,38,2,5,7,28.6%,1h
49829,1,kalimoto,1811,96,2,7,9,22.2%,36m
49829,1,BalckSheep,1811,48,2,13,15,13.3%,1h
49829,1,dimaua,1811,0,1,0,1,100.0%,35m
49829,1,витя,1811,0,0,1,1,0.0%,1h
49829,2,[PNKS]ПерекотиПоле,1811,0,0,9,9,0.0%,1h
49841,1,Adihasz,1810,554,14,28,42,33.3%,4m
49841,1,Malditamow,1810,350,9,5,14,64.3%,4m
49841,2,bob,1810,221,5,6,11,45.5%,1h
49841,1,Blackboar,1810,120,5,13,18,27.8%,1h
49841,1,KOKOKUN,1810,126,3,6,9,33.3%,8m
49841,1,krystian,1810,48,2,1,3,66.7%,14m
49841,2,Bobit,1810,46,1,6,7,14.3%,6m
49841,1,WielkiBUM,1810,0,0,1,1,0.0%,1h
49849,3,Renard,1809,1179,43,59,102,42.2%,12m
49849,1,Kristache,1809,1212,33,50,83,39.8%,1h
49849,1,SNOWPATROL,1809,714,18,23,41,43.9%,1h
49849,3,WildCatling,1809,248,12,19,31,38.7%,35m
49849,1,Executioner,1809,292,10,9,19,52.6%,1h
49849,3,[EPSI]jbplay,1809,288,9,17,26,34.6%,1h
49849,1,[OmDi]BaustoBlack,1809,260,7,7,14,50.0%,1h
49849,3,Stalker,1809,244,7,15,22,31.8%,14m
49849,2,Bravo,1809,275,7,16,23,30.4%,29m
49849,3,AlexOfSweden,1809,58,4,8,12,33.3%,14m
49849,1,VladZZ,1809,46,2,1,3,66.7%,36m
49849,3,Twitch,1809,0,2,5,7,28.6%,29m
49849,1,bod,1809,46,1,8,9,11.1%,1h
49849,3,Neptune,1809,0,0,1,1,0.0%,1h
49849,1,Blackforest,1809,0,0,1,1,0.0%,1h
49849,3,Nomadicsoul,1809,0,0,4,4,0.0%,1h
49865,3,Kalchak,1808,1556,83,100,183,45.4%,27m
49865,3,Teddy,1808,1115,39,48,87,44.8%,1h
49865,1,Lemonade,1808,613,17,22,39,43.6%,8m
49865,3,hayalet,1808,308,11,26,37,29.7%,18m
49865,1,Knampf,1808,207,6,17,23,26.1%,35m
49865,1,[НОД17]Sergey,1808,179,3,10,13,23.1%,1h
49865,3,Dinin,1808,98,3,12,15,20.0%,14m
49865,1,[yedi]rastarules,1808,48,1,4,5,20.0%,1h
49865,3,pioceanic,1808,0,1,6,7,14.3%,36m
49865,2,donddave,1808,0,0,1,1,0.0%,1h
49875,3,Peti,1807,1485,71,80,151,47.0%,1h
49875,3,picachulon,1807,328,11,16,27,40.7%,1h
49875,2,FreddyKreuge,1807,338,10,19,29,34.5%,23m
49875,3,DutchMartijn,1807,313,10,28,38,26.3%,16m
49875,1,KERGULDU,1807,254,9,20,29,31.0%,34m
49875,1,DeadEuclid,1807,46,2,1,3,66.7%,1h
49875,2,CombasKnight,1807,34,1,10,11,9.1%,27m
49875,1,[Энтаро]Alzadar,1807,0,0,1,1,0.0%,11m
49875,3,Stoun,1807,0,0,1,1,0.0%,1h
49875,1,RainbowStar,1807,0,0,2,2,0.0%,3m
49875,2,[BBN]Tic,1807,0,0,3,3,0.0%,22m
49886,1,Jeff,1806,300,8,9,17,47.1%,33m
49886,1,alka,1806,292,8,11,19,42.1%,28m
49886,1,moldoweanu,1806,94,5,19,24,20.8%,32m
49886,1,Milko,1806,88,2,7,9,22.2%,12m
49886,1,Apatia,1806,0,1,0,1,100.0%,7m
49886,1,Deadtrap,1806,0,1,5,6,16.7%,1h
49886,3,HeyDen,1806,0,0,1,1,0.0%,1h
49886,1,Roцker,1806,0,0,1,1,0.0%,14m
49886,3,Aquarius,1806,0,0,3,3,0.0%,1h
49886,3,tingho,1806,0,0,8,8,0.0%,1h
49896,3,Duke,1805,980,37,63,100,37.0%,4m
49896,1,Rumatius,1805,1129,31,40,71,43.7%,6m
49896,1,jjluffy,1805,172,6,5,11,54.5%,1h
49896,1,Lama,1805,44,2,5,7,28.6%,21m
49896,2,[DeaDhi]старккравт,1805,0,1,5,6,16.7%,22m
49896,2,Potato,1805,0,0,1,1,0.0%,6m
49896,2,Aeriatal,1805,0,0,3,3,0.0%,29m
49903,1,tyttt,1804,965,52,62,114,45.6%,19m
49903,1,Simsasimi,1804,1391,44,52,96,45.8%,10m
49903,1,Grifter,1804,1160,31,38,69,44.9%,8m
49903,1,Maliko,1804,653,28,44,72,38.9%,1h
49903,1,claudiupet,1804,618,17,29,46,37.0%,9m
49903,1,Adoil,1804,403,11,7,18,61.1%,1h
49903,3,amntdm,1804,272,9,16,25,36.0%,5m
49903,3,[GNORI]Oguretrix,1804,224,7,14,21,33.3%,4m
49903,1,florib,1804,60,3,13,16,18.8%,14m
49903,1,wafel,1804,0,0,1,1,0.0%,11m
49903,1,DerCasanova,1804,0,0,3,3,0.0%,5m
49903,3,[ККК]ГлаваККК,1804,0,0,3,3,0.0%,18m
49915,1,BaradDur,1803,386,10,6,16,62.5%,8m
49915,1,Steel,1803,242,8,21,29,27.6%,1h
49915,3,Kretcht,1803,166,4,10,14,28.6%,16m
49915,2,ZAVA,1803,46,2,12,14,14.3%,31m
49915,1,[Poneyd]Spark,1803,44,1,5,6,16.7%,10m
49915,1,freshus,1803,0,0,1,1,0.0%,11m
49915,1,Artanis,1803,0,0,1,1,0.0%,1h
49915,1,ArgentiSol,1803,0,0,5,5,0.0%,4m
49915,2,Microporo,1803,0,0,9,9,0.0%,1h
49924,3,Spektra,1802,898,35,39,74,47.3%,1h
49924,1,Tropper,1802,718,18,19,37,48.6%,9m
49924,1,xqtr,1802,196,5,7,12,41.7%,1h
49924,1,[1ftg]lessaim,1802,267,5,15,20,25.0%,16m
49924,2,BASILE,1802,76,2,12,14,14.3%,26m
49924,1,Deno,1802,42,1,3,4,25.0%,1h
49924,3,punti,1802,0,0,2,2,0.0%,1h
49924,1,Hypno,1802,73,0,5,5,0.0%,1h
49924,3,Domciaa,1802,0,0,9,9,0.0%,1h
49933,1,Redan,1801,1097,35,45,80,43.8%,10m
49933,1,Elvis,1801,395,12,23,35,34.3%,36m
49933,2,mzed,1801,157,5,19,24,20.8%,1h
49933,1,Ottoman,1801,133,2,2,4,50.0%,10m
49933,1,Daywalker,1801,48,1,2,3,33.3%,1h
49933,1,Kamuffel,1801,0,1,3,4,25.0%,4m
49933,1,kaneki,1801,44,1,5,6,16.7%,34m
49933,1,lanmy,1801,114,1,11,12,8.3%,3m
49933,3,[xCrüe]Strykker,1801,0,0,1,1,0.0%,1h
49933,1,[Ningen]Dugog,1801,0,0,1,1,0.0%,25m
49943,3,thebart,1800,653,26,34,60,43.3%,11m
49943,2,Vulkan,1800,254,12,8,20,60.0%,4m
49943,1,Hakha,1800,148,8,8,16,50.0%,19m
49943,1,Hispano,1800,312,7,14,21,33.3%,29m
49943,1,Hurpy,1800,307,7,15,22,31.8%,19m
49943,3,Sander,1800,72,2,6,8,25.0%,1h
49943,3,AlexXxus,1800,0,0,1,1,0.0%,1h
49943,1,[Y8U]Babeel,1800,0,0,1,1,0.0%,20m
49951,3,Spacefly,1799,1530,74,90,164,45.1%,1h
49951,3,TryHard,1799,236,13,19,32,40.6%,7m
49951,1,Balla,1799,218,11,13,24,45.8%,2m
49951,1,rambojonx,1799,254,9,23,32,28.1%,8m
49951,3,Lazerturken,1799,224,6,11,17,35.3%,1h
49951,3,[HAVTT]NSC,1799,68,3,1,4,75.0%,16m
49951,1,Zelus,1799,0,1,2,3,33.3%,1h
49951,1,Zene,1799,0,0,2,2,0.0%,3m
49951,2,JARY,1799,0,0,5,5,0.0%,1h
49960,3,TEXproROI,1798,1483,167,216,383,43.6%,15m
49960,2,leo,1798,1508,112,147,259,43.2%,26m
49960,3,nicocab,1798,960,53,77,130,40.8%,32m
49960,3,[PRBJC]Leewaa,1798,879,45,60,105,42.9%,1h
49960,1,barky,1798,550,18,14,32,56.2%,33m
49960,1,JZMD,1798,436,11,10,21,52.4%,18m
49960,3,DVxa,1798,354,10,21,31,32.3%,12m
49960,3,Arvaruc,1798,142,9,6,15,60.0%,30m
49960,3,OneTooFar,1798,234,7,9,16,43.8%,5m
49960,1,ZergRanger,1798,149,3,10,13,23.1%,6m
49960,1,Leonardo,1798,48,2,13,15,13.3%,1h
49960,3,oldmustache,1798,30,1,10,11,9.1%,24m
49960,1,Heimdal,1798,0,0,1,1,0.0%,35m
49960,1,Архимаг,1798,0,0,1,1,0.0%,1h
49960,1,BornToKill,1798,0,0,2,2,0.0%,1h
49960,3,CarlosSpicy,1798,0,0,7,7,0.0%,1h
49976,1,robotninja,1797,1685,92,114,206,44.7%,36m
49976,1,[MrPe]Mrpelotillas,1797,1140,29,37,66,43.9%,10m
49976,3,Alers,1797,156,21,21,42,50.0%,1h
49976,3,[mfxed]LegendaVoidu,1797,419,14,21,35,40.0%,18m
49976,1,NCHSııLøukid,1797,470,11,19,30,36.7%,35m
49976,1,Akson,1797,445,10,24,34,29.4%,10m
49976,2,GarryWolf,1797,206,7,12,19,36.8%,28m
49976,1,VVinMan,1797,258,6,7,13,46.2%,33m
49976,3,Alekey,1797,94,5,8,13,38.5%,1h
49976,2,hystrix,1797,226,5,15,20,25.0%,22m
49976,1,tauri,1797,141,4,14,18,22.2%,5m
49976,1,Doudou,1797,0,1,0,1,100.0%,10m
49976,1,UralGrower,1797,94,1,8,9,11.1%,1h
49976,1,Alcalde,1797,0,0,1,1,0.0%,18m
49976,3,wilon,1797,0,0,2,2,0.0%,9m
49976,3,ППП,1797,0,0,8,8,0.0%,1h
49992,1,selarom,1796,1270,35,42,77,45.5%,18m
49992,1,Patchthefish,1796,521,19,18,37,51.4%,1h
49992,1,drspartnil,1796,346,8,10,18,44.4%,1h
49992,1,[умри]хреножук,1796,327,6,15,21,28.6%,12m
49992,2,Nico,1796,136,4,13,17,23.5%,15m
49992,3,feiwel,1796,94,4,15,19,21.1%,1h
49992,1,xenon,1796,82,3,1,4,75.0%,1h
49992,1,DesmondMiles,1796,167,3,13,16,18.8%,21m
49992,3,moskiri,1796,0,2,5,7,28.6%,1h
49992,1,[XeTeX]naeu,1796,88,2,7,9,22.2%,9m
49992,1,Boninissimo,1796,48,2,13,15,13.3%,1h
49992,1,PolRusBoy,1796,104,1,9,10,10.0%,7m
49992,1,ALTAIR,1796,0,0,3,3,0.0%,18m
50005,3,[CxCx]Amine,1795,320,10,15,25,40.0%,1h
50005,1,midship,1795,212,6,1,7,85.7%,1h
50005,2,Molodoi,1795,142,5,14,19,26.3%,32m
50005,1,LORDDANIELE,1795,184,4,8,12,33.3%,19m
50005,3,алекс,1795,30,2,7,9,22.2%,13m
50005,3,end,1795,0,0,5,5,0.0%,1h
50005,3,Tsarine,1795,0,0,6,6,0.0%,30m
50012,1,Bodugo,1794,437,11,12,23,47.8%,21m
50012,3,prizrak,1794,287,10,22,32,31.2%,1h
50012,1,AleksKalin,1794,344,8,7,15,53.3%,34m
50012,1,Stefano,1794,236,6,4,10,60.0%,30m
50012,2,rds,1794,123,6,19,25,24.0%,23m
50012,1,Kissit,1794,96,3,1,4,75.0%,11m
50012,3,ALINUSH,1794,30,3,8,11,27.3%,36m
50012,3,[OLIM]IceRob,1794,123,3,8,11,27.3%,10m
50012,1,СерпИмолот,1794,0,2,10,12,16.7%,1h
50012,1,ZombieMince,1794,0,1,0,1,100.0%,21m
50012,2,Dpika,1794,88,1,9,10,10.0%,1h
50012,1,[Pr8xy]BobaFett,1794,0,0,1,1,0.0%,29m
50012,1,Nighteagle,1794,0,0,1,1,0.0%,18m
50012,1,[K0RM2]толян,1794,0,0,2,2,0.0%,30m
50026,3,tartarin,1793,1177,63,79,142,44.4%,1h
50026,1,Tolik,1793,1876,62,81,143,43.4%,9m
50026,1,Kosteko,1793,178,4,3,7,57.1%,36m
50026,1,[DaFF]Blutschwert,1793,90,3,5,8,37.5%,18m
50026,1,[minire]BeepSheep,1793,46,3,5,8,37.5%,21m
50026,1,stéfano,1793,80,2,6,8,25.0%,1h
50026,2,VALENTOR,1793,48,1,14,15,6.7%,25m
50026,1,madmat,1793,0,0,1,1,0.0%,1h
50026,3,[TBIRRA]javidr,1793,0,0,2,2,0.0%,1h
50035,3,TMAE,1792,941,56,73,129,43.4%,32m
50035,1,Jumpman,1792,781,23,31,54,42.6%,1h
50035,1,CHAKALAN,1792,440,13,10,23,56.5%,11m
50035,1,Jellipino,1792,330,11,17,28,39.3%,18m
50035,3,NIKKACM,1792,186,6,14,20,30.0%,12m
50035,2,Makkkish,1792,126,4,9,13,30.8%,1h
50035,2,IAMNOOB,1792,90,3,14,17,17.6%,1h
50035,3,tenvteni,1792,30,1,2,3,33.3%,1h
50035,1,Nizi,1792,0,1,4,5,20.0%,33m
50035,1,Maciej,1792,0,0,2,2,0.0%,16m
50035,1,DarkDynastie,1792,0,0,3,3,0.0%,1h
50046,1,Ben,1791,1669,75,96,171,43.9%,30m
50046,3,[OmDi]RobertD,1791,722,58,63,121,47.9%,29m
50046,1,GhostDragon,1791,1358,41,43,84,48.8%,19m
50046,1,Aly,1791,571,18,41,59,30.5%,22m
50046,1,Lucky,1791,329,12,17,29,41.4%,1h
50046,1,TrogWAR,1791,367,10,15,25,40.0%,25m
50046,1,hashmalator,1791,132,4,5,9,44.4%,5m
50046,1,BlizzBrazz,1791,122,3,9,12,25.0%,8m
50046,1,PYJIb,1791,0,1,0,1,100.0%,10m
50046,3,stan,1791,0,0,1,1,0.0%,29m
50046,1,Gomer,1791,0,0,1,1,0.0%,1h
50046,2,Grzegorz,1791,0,0,2,2,0.0%,1h
50046,3,kholio,1791,0,0,6,6,0.0%,1h
50059,1,[TGZP]Nik,1790,904,26,34,60,43.3%,33m
50059,1,Каратель,1790,758,22,35,57,38.6%,1h
50059,2,maxka,1790,645,21,35,56,37.5%,1h
50059,3,IIIIIIIIIIII,1790,138,13,17,30,43.3%,26m
50059,3,Arthur,1790,357,11,20,31,35.5%,1h
50059,1,[JaPP]jeleyka,1790,321,8,18,26,30.8%,21m
50059,3,emdor,1790,148,5,14,19,26.3%,1h
50059,1,DENIS,1790,218,4,9,13,30.8%,36m
50059,2,Linebeck,1790,166,3,5,8,37.5%,29m
50059,1,Keonops,1790,136,3,8,11,27.3%,17m
50059,3,MocnyGnat,1790,0,1,0,1,100.0%,1h
50059,3,GOLD,1790,0,1,3,4,25.0%,1h
50059,1,DarkFenris,1790,0,0,1,1,0.0%,1h
50059,3,FENY,1790,0,0,1,1,0.0%,1h
50059,3,skaliburch,1790,0,0,4,4,0.0%,1h
50074,3,Alexey,1789,1503,147,170,317,46.4%,24m
50074,1,Gaston,1789,1089,36,45,81,44.4%,1h
50074,1,tytus,1789,754,30,12,42,71.4%,21m
50074,3,TTRtrentHuit,1789,838,29,43,72,40.3%,1h
50074,1,kossa,1789,864,23,23,46,50.0%,1h
50074,1,GhostDog,1789,474,12,17,29,41.4%,1h
50074,1,[SPAINs]matrizzxx,1789,234,6,6,12,50.0%,35m
50074,1,erikeriksson,1789,208,5,8,13,38.5%,36m
50074,1,Antares,1789,190,4,5,9,44.4%,8m
50074,3,[Cafard]Monsterfire,1789,58,3,6,9,33.3%,9m
50074,1,Amez,1789,123,2,7,9,22.2%,7m
50074,3,Severus,1789,30,1,9,10,10.0%,1h
50074,1,гандурас,1789,0,0,6,6,0.0%,1h
50087,3,zibivip,1788,1492,117,146,263,44.5%,33m
50087,3,OTTO,1788,349,11,15,26,42.3%,17m
50087,1,tofred,1788,346,9,10,19,47.4%,1h
50087,1,Chris,1788,249,5,9,14,35.7%,4m
50087,3,[Clixx]Dankillio,1788,0,4,11,15,26.7%,1h
50087,1,Лабус,1788,0,1,2,3,33.3%,6m
50087,1,Astratex,1788,0,0,1,1,0.0%,4m
50087,1,Zapho,1788,0,0,2,2,0.0%,11m
50087,2,guiemekebab,1788,0,0,6,6,0.0%,23m
50087,1,Elprimo,1788,73,0,9,9,0.0%,1h
50087,3,Nskbaks,1788,0,0,10,10,0.0%,7m
50098,1,MarkocEUrus,1787,1924,69,88,157,43.9%,1h
50098,1,Stetet,1787,1101,47,58,105,44.8%,35m
50098,3,Ciaintrainer,1787,1214,45,57,102,44.1%,5m
50098,3,powerryder,1787,867,33,40,73,45.2%,25m
50098,1,Nivile,1787,590,14,20,34,41.2%,8m
50098,1,[gairt]Gainullin,1787,338,8,11,19,42.1%,1h
50098,1,Deltach,1787,0,5,1,6,83.3%,1h
50098,2,Ste,1787,174,4,15,19,21.1%,1h
50098,1,ivan,1787,134,3,4,7,42.9%,1h
50098,3,[FAJAS]berecikpl,1787,106,3,8,11,27.3%,29m
50098,1,sXV,1787,46,2,5,7,28.6%,4m
50098,1,RECTOR,1787,46,1,1,2,50.0%,1h
50098,1,[DL2006]CoNtRoL,1787,0,0,1,1,0.0%,25m
50098,1,Gallifan,1787,0,0,1,1,0.0%,1h
50098,3,protas,1787,0,0,1,1,0.0%,1h
50098,2,gaua,1787,0,0,5,5,0.0%,1h
50114,2,Alex,1786,1399,61,74,135,45.2%,1h
50114,3,Torberg,1786,1028,38,55,93,40.9%,1h
50114,1,ilyxa,1786,445,11,16,27,40.7%,6m
50114,1,SapoArmado,1786,278,10,8,18,55.6%,5m
50114,1,ReAnimator,1786,48,2,2,4,50.0%,4m
50114,1,luc,1786,90,2,4,6,33.3%,18m
50114,1,MineSweeper,1786,48,1,1,2,50.0%,8m
50114,1,egorstarkraw,1786,0,1,11,12,8.3%,1h
50114,3,JiDoO,1786,0,0,3,3,0.0%,34m
50123,3,vicomte,1785,499,16,24,40,40.0%,2m
50123,1,rohz,1785,413,13,24,37,35.1%,1h
50123,3,Melmacer,1785,318,11,16,27,40.7%,26m
50123,1,Necro,1785,350,10,10,20,50.0%,36m
50123,2,skolm,1785,186,6,16,22,27.3%,1h
50123,1,Orion,1785,193,4,6,10,40.0%,1h
50123,1,Arty,1785,0,1,2,3,33.3%,2m
50123,1,LINK,1785,0,0,2,2,0.0%,1h
50131,1,Rubens,1784,1918,106,132,238,44.5%,1h
50131,1,GGZ,1784,754,18,26,44,40.9%,6m
50131,1,TerminaL,1784,253,10,3,13,76.9%,21m
50131,1,[3ЕRGTV]Kot,1784,308,8,9,17,47.1%,17m
50131,1,Tobexz,1784,190,5,4,9,55.6%,4m
50131,1,Arguthray,1784,218,5,15,20,25.0%,1h
50131,2,[ZupH]patriic,1784,58,3,5,8,37.5%,6m
50131,2,Mastermind,1784,90,2,10,12,16.7%,14m
50131,2,Lüftli,1784,89,1,1,2,50.0%,22m
50131,1,Dianondo,1784,0,1,1,2,50.0%,5m
50131,2,[chww]swd,1784,30,1,9,10,10.0%,1h
50131,3,Ronladniho,1784,0,0,9,9,0.0%,1h
50143,3,HEC,1783,1498,110,137,247,44.5%,29m
50143,3,[прас]Nikita,1783,1399,75,84,159,47.2%,14m
50143,3,Beppe,1783,813,31,50,81,38.3%,27m
50143,2,makar,1783,360,16,23,39,41.0%,32m
50143,1,Rosheen,1783,405,10,19,29,34.5%,7m
50143,1,Giulio,1783,442,10,20,30,33.3%,2m
50143,1,OZONIZE,1783,107,3,10,13,23.1%,25m
50143,3,XAKERbelarus,1783,0,1,0,1,100.0%,1h
50143,1,Malcador,1783,0,1,2,3,33.3%,1h
50143,3,ThunderAlex,1783,34,1,7,8,12.5%,1h
50143,2,Razgeldaei,1783,0,1,8,9,11.1%,1h
50143,1,Marcazs,1783,0,0,1,1,0.0%,1h
50143,3,Polskipies,1783,0,0,1,1,0.0%,29m
50156,3,MOMIOXXI,1782,1434,75,90,165,45.5%,1h
50156,1,Camyo,1782,652,20,27,47,42.6%,1h
50156,3,ShinyEvil,1782,94,7,5,12,58.3%,1h
50156,1,Terranova,1782,182,7,19,26,26.9%,11m
50156,1,ZaPa,1782,242,6,7,13,46.2%,1h
50156,1,MRKSArthY,1782,248,6,23,29,20.7%,17m
50156,1,fatcok,1782,224,5,7,12,41.7%,1h
50156,1,котик,1782,86,3,5,8,37.5%,21m
50156,1,[Kunca]illu,1782,0,1,0,1,100.0%,2m
50156,1,Anton,1782,0,0,1,1,0.0%,34m
50156,1,[TUONAT]Aries,1782,0,0,3,3,0.0%,8m
50156,3,Oneil,1782,0,0,3,3,0.0%,28m
50156,2,KariczRol,1782,0,0,5,5,0.0%,1h
50169,1,jOHNYFAST,1781,1021,28,41,69,40.6%,25m
50169,1,Kryzer,1781,490,15,14,29,51.7%,12m
50169,1,phoenix,1781,504,14,18,32,43.8%,16m
50169,3,swifty,1781,242,10,26,36,27.8%,1h
50169,3,Monkeypol,1781,280,9,12,21,42.9%,26m
50169,1,Matzeee,1781,204,6,18,24,25.0%,12m
50169,2,Waldemar,1781,124,4,14,18,22.2%,4m
50169,3,sem,1781,0,1,1,2,50.0%,29m
50169,3,jacqueski,1781,0,0,1,1,0.0%,1h
50169,1,Faber,1781,0,0,3,3,0.0%,12m
50179,2,nightswing,1780,402,14,27,41,34.1%,16m
50179,3,kaizoku,1780,384,13,21,34,38.2%,1h
50179,3,бобер,1780,34,2,9,11,18.2%,29m
50179,1,whisper,1780,48,1,6,7,14.3%,1h
50179,3,glenj,1780,0,1,7,8,12.5%,1h
50179,1,inquisitor,1780,0,0,1,1,0.0%,12m
50179,3,женя,1780,0,0,1,1,0.0%,29m
50179,1,[EnFi]DeZZoRix,1780,0,0,4,4,0.0%,1h
50179,1,Yogi,1780,0,0,6,6,0.0%,2m
50179,2,FijianKngZus,1780,0,0,10,10,0.0%,1h
50189,1,[Furer]Pifagor,1779,966,26,31,57,45.6%,7m
50189,1,Broplopz,1779,703,18,20,38,47.4%,10m
50189,3,BaB,1779,483,17,29,46,37.0%,1h
50189,3,[ARRG]raymckein,1779,128,4,12,16,25.0%,4m
50189,1,Thunder,1779,132,3,9,12,25.0%,2m
50189,3,vince,1779,30,2,8,10,20.0%,7m
50189,1,burjui,1779,0,1,2,3,33.3%,7m
50189,2,Darkexellion,1779,0,0,5,5,0.0%,18m
50197,1,[C12760]papaGrey,1778,1543,425,468,893,47.6%,1h
50197,1,xmann,1778,1112,36,62,98,36.7%,1h
50197,3,poLi,1778,894,32,47,79,40.5%,1h
50197,3,Treviz,1778,298,11,20,31,35.5%,1h
50197,1,Rababio,1778,507,11,20,31,35.5%,1h
50197,1,fitz,1778,353,9,15,24,37.5%,5m
50197,1,INoShotI,1778,117,1,5,6,16.7%,25m
50197,1,Harlok,1778,0,0,1,1,0.0%,7m
50205,1,ZeD,1777,616,25,28,53,47.2%,35m
50205,1,Мишелин,1777,467,12,11,23,52.2%,10m
50205,2,[Fuoco3]laidascamorz,1777,388,11,23,34,32.4%,12m
50205,1,Demon,1777,343,8,14,22,36.4%,8m
50205,3,[P00T]CMETAHA,1777,124,4,12,16,25.0%,1h
50205,1,Youngmoon,1777,128,3,10,13,23.1%,7m
50205,1,Kontr,1777,0,1,0,1,100.0%,30m
50205,2,asasina,1777,44,1,7,8,12.5%,1h
50205,2,ALIEN,1777,30,1,11,12,8.3%,1h
50205,2,SeñorCogollo,1777,0,0,6,6,0.0%,11m
50215,3,[Buśki]Kagawa,1776,1233,61,75,136,44.9%,1h
50215,1,Grisou,1776,271,10,13,23,43.5%,1h
50215,1,Yanro,1776,185,6,1,7,85.7%,1h
50215,1,DarkBeaver,1776,230,5,7,12,41.7%,1h
50215,1,GIZMO,1776,134,3,15,18,16.7%,21m
50215,1,DonDrautz,1776,0,1,1,2,50.0%,1h
50221,1,LeoBuffel,1775,1402,47,62,109,43.1%,1h
50221,1,DexteRMorgan,1775,534,17,33,50,34.0%,1h
50221,3,[РусЭл]MrKot,1775,348,14,21,35,40.0%,14m
50221,1,alin,1775,172,5,9,14,35.7%,1h
50221,3,LoKuSt,1775,36,2,0,2,100.0%,7m
50221,3,nuyorica,1775,58,2,10,12,16.7%,17m
50221,1,ФилаТ,1775,0,1,0,1,100.0%,1h
50221,1,Xeton,1775,0,1,2,3,33.3%,1h
50221,1,also,1775,121,1,4,5,20.0%,2m
50221,2,Ruslan,1775,0,1,7,8,12.5%,34m
50221,1,[sI7]Skater,1775,0,0,1,1,0.0%,1h
50221,1,vdg,1775,0,0,1,1,0.0%,1h
50221,2,Дмитриус,1775,0,0,1,1,0.0%,25m
50221,1,RafWarrior,1775,0,0,1,1,0.0%,5m
50235,1,DuncanIdaho,1774,1132,30,40,70,42.9%,34m
50235,1,Soldeoro,1774,846,22,33,55,40.0%,19m
50235,3,nik,1774,236,8,17,25,32.0%,27m
50235,2,Nicduch,1774,160,7,17,24,29.2%,25m
50235,1,Vallo,1774,184,5,19,24,20.8%,2m
50235,2,PuppyArmz,1774,114,4,11,15,26.7%,1h
50235,1,DarkderPRO,1774,96,2,2,4,50.0%,1h
50235,1,Trup,1774,93,1,4,5,20.0%,1h
50235,3,superCKAYT,1774,0,0,5,5,0.0%,1h
50235,1,Profimetzger,1774,0,0,5,5,0.0%,34m
50245,1,Terminator,1773,456,19,29,48,39.6%,11m
50245,1,MGerh,1773,527,12,14,26,46.2%,17m
50245,2,Bulator,1773,294,9,26,35,25.7%,3m
50245,2,[Friенд]qweq,1773,160,8,27,35,22.9%,1h
50245,1,Drakene,1773,228,5,5,10,50.0%,9m
50245,1,KREON,1773,153,4,10,14,28.6%,33m
50245,1,rafacraft,1773,132,3,8,11,27.3%,1h
50245,1,Nykterstein,1773,44,1,6,7,14.3%,18m
50245,3,[R4Time]Zeratul,1773,0,0,1,1,0.0%,1h
50245,3,hosmar,1773,0,0,1,1,0.0%,1h
50245,1,stef,1773,0,0,2,2,0.0%,18m
50245,1,[Repu]SUPERRAYNOR,1773,0,0,2,2,0.0%,1h
50245,2,Noniusz,1773,0,0,5,5,0.0%,30m
50258,1,WriBazimba,1772,1793,76,91,167,45.5%,8m
50258,2,DonkeyKonGG,1772,296,10,21,31,32.3%,1h
50258,1,[КРН]Prometheus,1772,318,8,13,21,38.1%,1h
50258,1,RocketMan,1772,268,8,25,33,24.2%,3m
50258,2,Jhai,1772,195,4,14,18,22.2%,1h
50258,1,magic,1772,88,2,3,5,40.0%,1h
50258,1,Chiefgogo,1772,73,0,3,3,0.0%,13m
50258,1,Maurone,1772,0,0,4,4,0.0%,34m
50266,3,MaiCel,1771,1340,104,130,234,44.4%,16m
50266,3,MIIXXIIM,1771,1508,77,86,163,47.2%,1h
50266,1,Bomje,1771,1348,40,42,82,48.8%,1h
50266,1,BroTomasz,1771,705,26,50,76,34.2%,9m
50266,3,aloe,1771,365,22,29,51,43.1%,27m
50266,2,marcio,1771,420,17,26,43,39.5%,1h
50266,1,kuzima,1771,417,10,15,25,40.0%,36m
50266,1,Kupson,1771,296,10,23,33,30.3%,1h
50266,1,Димон,1771,44,1,1,2,50.0%,2m
50266,3,EchoCZ,1771,48,1,1,2,50.0%,30m
50266,1,PassivPVP,1771,0,0,1,1,0.0%,33m
50266,3,RoberPower,1771,0,0,1,1,0.0%,7m
50278,3,гриша,1770,357,12,18,30,40.0%,1h
50278,1,Cabo,1770,408,10,14,24,41.7%,33m
50278,1,Erko,1770,395,10,22,32,31.2%,1h
50278,1,marcopolo,1770,174,4,9,13,30.8%,4m
50278,2,MiśPushap,1770,38,4,9,13,30.8%,1h
50278,2,[NINJ88]DRM,1770,122,4,14,18,22.2%,13m
50278,3,MeanMutha,1770,30,2,13,15,13.3%,1h
50278,1,Minick,1770,0,0,1,1,0.0%,14m
50278,3,IIIIIIIIIIII,1770,0,0,9,9,0.0%,1h
50278,2,BROKOT,1770,0,0,9,9,0.0%,35m
50288,3,Raynor,1769,1186,42,50,92,45.7%,1h
50288,1,Babylove,1769,1371,41,47,88,46.6%,1h
50288,3,JonGalindo,1769,370,14,18,32,43.8%,1h
50288,1,graig,1769,478,12,13,25,48.0%,1h
50288,3,LUXUS,1769,172,4,10,14,28.6%,1h
50288,1,Prosvet,1769,178,4,11,15,26.7%,1h
50288,1,Ferranscio,1769,161,4,11,15,26.7%,12m
50288,2,EastGroup,1769,100,3,13,16,18.8%,1h
50288,3,TheWaterdrop,1769,0,1,8,9,11.1%,30m
50288,3,momchev,1769,30,1,10,11,9.1%,25m
50288,1,SIR,1769,0,0,1,1,0.0%,28m
50299,1,Monni,1768,318,10,12,22,45.5%,21m
50299,2,Pman,1768,156,7,22,29,24.1%,1h
50299,2,DAavidekhaha,1768,118,2,11,13,15.4%,2m
50299,1,Blackhornet,1768,42,1,1,2,50.0%,30m
50299,1,Tsuki,1768,0,1,1,2,50.0%,10m
50299,1,achil,1768,36,1,2,3,33.3%,19m
50299,3,Hernest,1768,0,0,1,1,0.0%,28m
50306,1,ugovic,1767,376,9,12,21,42.9%,1h
50306,1,[Reano]stealthplays,1767,259,6,10,16,37.5%,1h
50306,1,bratkom,1767,42,2,3,5,40.0%,1h
50306,3,[Chaven]Jirnnobruh,1767,0,2,3,5,40.0%,7m
50306,3,NikMoro,1767,30,2,4,6,33.3%,1h
50306,1,Мракобес,1767,0,1,1,2,50.0%,12m
50306,1,bibikus,1767,42,1,1,2,50.0%,1h
50306,2,JimmyRaynor,1767,0,1,3,4,25.0%,1h
50306,1,Abdou,1767,0,1,4,5,20.0%,19m
50306,1,flairix,1767,0,0,1,1,0.0%,28m
50316,1,fumanchu,1766,1665,87,114,201,43.3%,10m
50316,1,DRANIK,1766,306,11,10,21,52.4%,1h
50316,3,Semik,1766,384,11,29,40,27.5%,16m
50316,2,blizok,1766,182,6,19,25,24.0%,7m
50316,1,Staszko,1766,162,5,9,14,35.7%,4m
50316,1,Jumido,1766,196,4,4,8,50.0%,29m
50316,1,JaegerKorp,1766,28,2,0,2,100.0%,1h
50316,2,uStgMQYVdetJ,1766,30,1,10,11,9.1%,1m
50316,1,Nova,1766,0,0,3,3,0.0%,10m
50316,1,zimek,1766,0,0,5,5,0.0%,4m
50316,3,[1FU2]EmE,1766,0,0,8,8,0.0%,1h
50327,1,ciacco,1765,1932,142,185,327,43.4%,12m
50327,1,[BFG9K]Top,1765,1358,44,48,92,47.8%,36m
50327,1,iCookie,1765,379,19,9,28,67.9%,10m
50327,1,Petrelli,1765,408,9,15,24,37.5%,7m
50327,1,Pegasus,1765,44,2,5,7,28.6%,1h
50327,1,MonteValium,1765,149,2,12,14,14.3%,9m
50327,3,TOMAS,1765,0,0,1,1,0.0%,18m
50327,1,maxarik,1765,0,0,2,2,0.0%,36m
50327,1,Slipstream,1765,0,0,5,5,0.0%,1h
50336,1,Mistek,1764,1919,103,122,225,45.8%,21m
50336,1,Victy,1764,1130,32,37,69,46.4%,18m
50336,1,Ryder,1764,1203,32,44,76,42.1%,18m
50336,1,jel,1764,460,14,16,30,46.7%,30m
50336,3,MasAgus,1764,350,13,15,28,46.4%,1h
50336,1,ZecheTop,1764,172,4,6,10,40.0%,5m
50336,2,XersesBreak,1764,30,1,11,12,8.3%,16m
50336,3,alxgrb,1764,0,0,1,1,0.0%,1h
50336,3,ZeuS,1764,0,0,2,2,0.0%,11m
50336,1,DedIvan,1764,0,0,3,3,0.0%,1h
50336,1,DhiseTea,1764,0,0,6,6,0.0%,3m
50347,2,СердеЧкО,1763,1513,155,196,351,44.2%,12m
50347,2,Celebrimbor,1763,1291,54,85,139,38.8%,34m
50347,1,miki,1763,512,14,20,34,41.2%,9m
50347,1,[iSucks]Honik,1763,318,9,5,14,64.3%,7m
50347,3,Marsattack,1763,228,7,10,17,41.2%,1h
50347,1,[AseDS]parcival,1763,220,5,13,18,27.8%,1h
50347,3,Damjan,1763,58,4,16,20,20.0%,2m
50347,1,Falko,1763,42,2,2,4,50.0%,29m
50347,1,[Stro4]HappyRush,1763,73,2,5,7,28.6%,1h
50347,1,CenLogis,1763,0,0,1,1,0.0%,34m
50357,1,Nightforce,1762,515,16,42,58,27.6%,35m
50357,3,DrXanax,1762,383,13,28,41,31.7%,2m
50357,1,tibonum,1762,121,2,8,10,20.0%,1h
50357,1,SEWAROSTIK,1762,48,1,2,3,33.3%,1h
50357,3,CTEFAN,1762,42,1,2,3,33.3%,1h
50357,1,TheBusDriver,1762,32,1,23,24,4.2%,32m
50357,3,[Nf80]dika,1762,0,0,1,1,0.0%,1h
50357,1,Cesareus,1762,0,0,2,2,0.0%,1h
50357,1,Ragneton,1762,0,0,3,3,0.0%,2m
50357,3,Bernhard,1762,0,0,6,6,0.0%,1h
50367,1,Gimmick,1761,1938,209,269,478,43.7%,1h
50367,3,Lemillion,1761,1306,62,73,135,45.9%,1h
50367,2,[ITmani]isoka,1761,755,27,49,76,35.5%,1h
50367,1,Gorazathot,1761,709,18,30,48,37.5%,10m
50367,1,RYDER,1761,248,7,13,20,35.0%,25m
50367,3,Totmacher,1761,0,4,1,5,80.0%,1h
50367,3,AkaAtso,1761,66,2,3,5,40.0%,1h
50367,1,idontspekeng,1761,0,1,1,2,50.0%,1h
50375,1,Distruttivo,1760,1912,101,138,239,42.3%,28m
50375,1,qwerty,1760,247,6,3,9,66.7%,1h
50375,1,[SPSes]EspaRraGO,1760,132,4,2,6,66.7%,19m
50375,1,Melaka,1760,122,3,8,11,27.3%,1h
50375,1,SkyFalling,1760,0,2,3,5,40.0%,17m
50375,2,Magoo,1760,78,2,11,13,15.4%,5m
50375,1,Xexulooo,1760,0,1,3,4,25.0%,6m
50375,1,SpaceWolf,1760,44,1,7,8,12.5%,11m
50375,1,Prometheuscz,1760,0,0,1,1,0.0%,10m
50384,3,KSIX,1759,1549,82,95,177,46.3%,1h
50384,1,meteo,1759,1552,47,63,110,42.7%,7m
50384,1,jean,1759,795,22,33,55,40.0%,2m
50384,1,UsadaPekora,1759,760,21,32,53,39.6%,10m
50384,1,Mar,1759,589,15,31,46,32.6%,17m
50384,1,Jim,1759,330,9,8,17,52.9%,1h
50384,2,MonGoose,1759,259,7,15,22,31.8%,20m
50384,1,Veroniiae,1759,42,1,3,4,25.0%,1h
50384,2,Rage,1759,97,1,10,11,9.1%,1h
50393,1,ChatonBrutal,1758,840,26,44,70,37.1%,9m
50393,3,Shaftwannabe,1758,337,20,31,51,39.2%,5m
50393,1,[OUUH]LuxBrumalis,1758,515,18,14,32,56.2%,10m
50393,1,kazak,1758,260,6,9,15,40.0%,36m
50393,3,[zpn3]TrollToll,1758,58,3,9,12,25.0%,26m
50393,3,Maxlo,1758,0,0,1,1,0.0%,1h
50393,3,Ermolay,1758,0,0,2,2,0.0%,1h
50400,1,[SCEng]NewA,1757,1790,66,88,154,42.9%,25m
50400,1,Nebrot,1757,1014,26,35,61,42.6%,1h
50400,1,Puck,1757,551,16,20,36,44.4%,25m
50400,1,bandit,1757,472,15,16,31,48.4%,1h
50400,1,[ЮФО]fastman,1757,550,13,17,30,43.3%,17m
50400,1,[drain]assplay,1757,231,6,15,21,28.6%,12m
50400,1,Edwin,1757,73,3,7,10,30.0%,4m
50400,3,bayard,1757,90,3,19,22,13.6%,30m
50400,3,NazmoX,1757,0,1,0,1,100.0%,7m
50400,1,[RGSC2]MrLEzOffFire,1757,44,1,1,2,50.0%,1h
50400,1,JGanivet,1757,100,1,6,7,14.3%,35m
50411,1,Flash,1756,1057,105,129,234,44.9%,11m
50411,1,john,1756,1328,42,52,94,44.7%,5m
50411,1,juanmi,1756,704,24,44,68,35.3%,1h
50411,1,LePresident,1756,310,8,11,19,42.1%,18m
50411,3,egzekutor,1756,163,5,16,21,23.8%,1h
50411,1,Alarak,1756,157,4,7,11,36.4%,1h
50411,3,Eliran,1756,0,1,0,1,100.0%,1h
50411,1,illzack,1756,44,1,4,5,20.0%,1h
50411,1,chrischan,1756,0,0,2,2,0.0%,10m
50411,1,Lamouche,1756,0,0,3,3,0.0%,1h
50421,1,Johnnyboy,1755,477,12,28,40,30.0%,4m
50421,2,darkknight,1755,128,5,19,24,20.8%,8m
50421,2,Sany,1755,132,4,17,21,19.0%,22m
50421,3,seven,1755,58,2,5,7,28.6%,25m
50421,1,[TTF]HDnova,1755,113,2,7,9,22.2%,7m
50421,1,Pollofdl,1755,0,1,1,2,50.0%,34m
50421,3,Lokkee,1755,0,1,1,2,50.0%,1h
50421,1,gips,1755,0,0,1,1,0.0%,1h
50421,1,Affliction,1755,0,0,5,5,0.0%,1h
50421,3,yolo,1755,0,0,7,7,0.0%,10m
50431,1,magnusss,1754,962,30,31,61,49.2%,28m
50431,3,TrojaN,1754,714,24,40,64,37.5%,1h
50431,2,SIcme,1754,544,18,33,51,35.3%,4m
50431,3,КОТ,1754,472,15,22,37,40.5%,1h
50431,3,jose,1754,404,13,20,33,39.4%,7m
50431,2,[ChBoyz]Tireje,1754,328,11,25,36,30.6%,35m
50431,1,gachiboy,1754,376,8,21,29,27.6%,10m
50431,1,ViktorROK,1754,0,1,0,1,100.0%,3m
50431,1,steel,1754,42,1,2,3,33.3%,1h
50440,1,[SPAINs]Sven,1753,1906,116,157,273,42.5%,18m
50440,1,Paris,1753,1535,56,68,124,45.2%,18m
50440,3,ThonyRitz,1753,1152,39,66,105,37.1%,10m
50440,1,RyBo,1753,228,5,8,13,38.5%,21m
50440,3,akakiy,1753,126,4,5,9,44.4%,1h
50440,1,Matt,1753,166,4,7,11,36.4%,1h
50440,1,OneForYou,1753,174,4,11,15,26.7%,29m
50440,3,SmallRock,1753,74,2,9,11,18.2%,26m
50440,1,Zombiakkk,1753,0,1,0,1,100.0%,1h
50440,2,Narazzar,1753,0,1,10,11,9.1%,1h
50440,3,josestarcraf,1753,30,1,10,11,9.1%,36m
50440,1,Zhnec,1753,0,0,1,1,0.0%,5m
50440,3,DOBERMAN,1753,0,0,1,1,0.0%,1h
50440,3,DxDmEn,1753,0,0,2,2,0.0%,19m
50440,3,StugFourLife,1753,0,0,5,5,0.0%,1h
50440,1,Traian,1753,73,0,8,8,0.0%,30m
50456,1,Ahmed,1752,1712,88,113,201,43.8%,2m
50456,3,Lotzi,1752,1220,40,57,97,41.2%,14m
50456,3,KostyaRu,1752,831,33,43,76,43.4%,27m
50456,3,Grifin,1752,654,24,36,60,40.0%,16m
50456,1,Nonos,1752,685,21,23,44,47.7%,7m
50456,1,FadMaggot,1752,764,21,93,114,18.4%,16m
50456,1,bedangel,1752,677,18,32,50,36.0%,1h
50456,1,KASPERNIP,1752,447,10,9,19,52.6%,17m
50456,1,AbdelGZA,1752,193,4,8,12,33.3%,1h
50456,1,AlanBis,1752,168,4,10,14,28.6%,25m
50456,1,[L2CM]Bouléto,1752,126,2,6,8,25.0%,21m
50456,3,MasTrE,1752,0,0,4,4,0.0%,1h
50456,3,minileipä,1752,0,0,8,8,0.0%,8m
50469,1,ARTO,1751,778,19,32,51,37.3%,1h
50469,1,DoctorWho,1751,328,8,9,17,47.1%,9m
50469,1,[ELFDM]playerone,1751,0,1,0,1,100.0%,1h
50469,1,Jeff,1751,40,1,2,3,33.3%,8m
50469,1,circuitchase,1751,0,0,1,1,0.0%,4m
50469,2,pete,1751,0,0,9,9,0.0%,1h
50469,2,Злобыня,1751,0,0,10,10,0.0%,20m
50476,2,macrOn,1750,1035,156,171,327,47.7%,26m
50476,3,windorzwolte,1750,135,54,68,122,44.3%,1h
50476,1,[MF5]Stengo,1750,326,9,10,19,47.4%,7m
50476,2,Fayo,1750,228,8,25,33,24.2%,1h
50476,3,gladziu,1750,146,6,8,14,42.9%,1h
50476,2,[CREPES]leo,1750,178,4,10,14,28.6%,4m
50476,1,[AKMP]akanostresss,1750,0,1,10,11,9.1%,35m
50476,1,Komosikus,1750,0,0,1,1,0.0%,11m
50484,3,Pigouchet,1749,1202,93,112,205,45.4%,2m
50484,3,Yanou,1749,684,24,37,61,39.3%,10m
50484,3,Kabardinec,1749,348,10,20,30,33.3%,32m
50484,1,XCalibur,1749,90,3,2,5,60.0%,7m
50484,2,SplasH,1749,0,1,1,2,50.0%,25m
50484,1,Alex,1749,0,0,3,3,0.0%,7m
50484,1,[WAR7]Raul,1749,73,0,4,4,0.0%,1h
50491,1,DARKLORD,1748,1150,32,54,86,37.2%,30m
50491,1,DJAKOH,1748,706,25,31,56,44.6%,1h
50491,1,ACER,1748,134,4,7,11,36.4%,17m
50491,1,[DTC789]Joker,1748,46,2,1,3,66.7%,18m
50491,1,thesun,1748,126,2,10,12,16.7%,35m
50491,1,Knud,1748,0,1,0,1,100.0%,1h
50491,1,Fred,1748,46,1,3,4,25.0%,1h
50498,3,IvanMal,1747,963,39,48,87,44.8%,14m
50498,1,JiriKohout,1747,774,20,24,44,45.5%,1h
50498,1,TAHIP,1747,191,5,8,13,38.5%,1h
50498,1,luki,1747,157,3,2,5,60.0%,20m
50498,1,Royd,1747,92,2,7,9,22.2%,1h
50498,1,Rodriyeich,1747,73,1,1,2,50.0%,21m
50498,2,Rublo,1747,34,1,10,11,9.1%,1h
50498,1,Talon,1747,0,0,1,1,0.0%,18m
50506,3,MOTANU,1746,382,16,26,42,38.1%,1h
50506,1,Aleks,1746,285,10,9,19,52.6%,6m
50506,1,Will,1746,390,10,17,27,37.0%,2m
50506,1,deathstar,1746,216,6,6,12,50.0%,1h
50506,1,GkK,1746,213,5,18,23,21.7%,1h
50506,1,ppom,1746,184,4,8,12,33.3%,1h
50506,2,[USKL]Альторн,1746,106,3,11,14,21.4%,30m
50506,1,ehehrawr,1746,46,2,8,10,20.0%,10m
50514,3,Tiger,1745,1537,95,132,227,41.9%,26m
50514,1,Эквалайзер,1745,1261,37,57,94,39.4%,11m
50514,1,Monkeyz,1745,485,13,20,33,39.4%,25m
50514,1,[Gÿa]Shaihulud,1745,0,1,0,1,100.0%,11m
50514,1,[LCN]Francisco,1745,0,1,0,1,100.0%,5m
50514,3,Wojtek,1745,0,0,1,1,0.0%,31m
50520,1,dannylarsen,1744,1921,100,167,267,37.5%,9m
50520,1,YFEX,1744,460,14,20,34,41.2%,1h
50520,1,hesienberg,1744,128,3,5,8,37.5%,1h
50520,1,Matrixxx,1744,0,1,1,2,50.0%,1h
50520,1,Marcixus,1744,0,0,1,1,0.0%,5m
50520,3,solo,1744,0,0,1,1,0.0%,29m
50520,3,afinapallada,1744,0,0,7,7,0.0%,1h
50520,3,ant,1744,0,0,10,10,0.0%,13m
50528,1,Résistance,1743,1000,31,44,75,41.3%,1h
50528,3,Zalder,1743,770,29,35,64,45.3%,5m
50528,1,sebu,1743,466,14,20,34,41.2%,19m
50528,1,Fitzi,1743,250,8,12,20,40.0%,1h
50528,1,zajic,1743,257,8,18,26,30.8%,28m
50528,1,[INFTS]SCouTAnK,1743,0,1,1,2,50.0%,12m
50528,3,Vadym,1743,0,0,2,2,0.0%,29m
50528,3,MorningStar,1743,0,0,8,8,0.0%,8m
50536,1,Pekas,1742,370,13,19,32,40.6%,7m
50536,2,SeBsOnYc,1742,298,12,31,43,27.9%,1h
50536,1,Avanguardia,1742,284,7,10,17,41.2%,1h
50536,1,Heinz,1742,0,1,1,2,50.0%,1h
50536,1,alexward,1742,0,1,1,2,50.0%,21m
50536,3,Marco,1742,0,1,4,5,20.0%,1h
50542,1,lupus,1741,1770,71,83,154,46.1%,2m
50542,1,SpacialRonin,1741,952,27,27,54,50.0%,17m
50542,1,[Dytred]cooper,1741,951,26,33,59,44.1%,5m
50542,1,DezGar,1741,778,20,27,47,42.6%,13m
50542,1,veter,1741,530,12,22,34,35.3%,17m
50542,1,Vhart,1741,274,6,15,21,28.6%,1h
50542,2,raknas,1741,279,6,18,24,25.0%,23m
50542,2,denly,1741,259,5,17,22,22.7%,22m
50542,3,[OmDi]xXxDiabloxXx,1741,70,2,11,13,15.4%,13m
50542,2,NightLive,1741,86,2,12,14,14.3%,20m
50542,1,EddieEdwards,1741,0,1,1,2,50.0%,17m
50542,1,fboban,1741,0,0,1,1,0.0%,8m
50542,3,BadgerrOne,1741,0,0,6,6,0.0%,30m
50555,1,[getric]ArXXX,1740,1894,80,118,198,40.4%,12m
50555,2,Kossos,1740,1062,37,53,90,41.1%,1h
50555,1,Renom,1740,220,8,21,29,27.6%,1h
50555,1,Turner,1740,0,1,2,3,33.3%,1h
50555,3,dan,1740,0,0,1,1,0.0%,19m
50560,3,Alias,1739,1456,74,94,168,44.0%,1h
50560,1,triest,1739,1337,44,53,97,45.4%,18m
50560,1,WingsOfFire,1739,192,5,19,24,20.8%,1h
50560,3,KeroLegend,1739,60,3,11,14,21.4%,1h
50560,3,kasper,1739,46,2,0,2,100.0%,31m
50560,3,[KingA]LVEAI,1739,0,1,1,2,50.0%,1h
50560,1,Nela,1739,88,1,3,4,25.0%,1h
50560,3,Babayega,1739,0,0,1,1,0.0%,33m
50560,3,DEN,1739,0,0,7,7,0.0%,1h
50569,1,ZrogLog,1738,294,6,7,13,46.2%,20m
50569,1,Roman,1738,208,5,7,12,41.7%,2m
50569,1,BOBO,1738,128,3,11,14,21.4%,20m
50569,1,Akieem,1738,100,3,17,20,15.0%,31m
50569,2,younes,1738,0,1,5,6,16.7%,1h
50569,2,[0SlS0]SaturniO,1738,0,1,5,6,16.7%,1h
50569,1,przem,1738,0,0,1,1,0.0%,2m
50576,1,ergydj,1737,1902,78,116,194,40.2%,1h
50576,3,Zeo,1737,1032,61,68,129,47.3%,5m
50576,1,Swizzly,1737,408,10,9,19,52.6%,34m
50576,1,[STOKED]Skrull,1737,273,8,7,15,53.3%,7m
50576,2,DefenseMode,1737,110,3,48,51,5.9%,21m
50576,3,SnowZ,1737,0,1,2,3,33.3%,1h
50576,1,CptNemo,1737,0,0,2,2,0.0%,18m
50576,3,juanramon,1737,0,0,5,5,0.0%,1h
50584,1,ARKOS,1736,1805,71,104,175,40.6%,25m
50584,1,Jazz,1736,715,18,25,43,41.9%,10m
50584,1,[ZonTs]elmo,1736,308,9,25,34,26.5%,5m
50584,1,Lucky,1736,389,8,14,22,36.4%,2m
50584,1,TopoT,1736,120,5,8,13,38.5%,18m
50584,1,Salmanistan,1736,138,3,9,12,25.0%,1h
50584,3,ILOoOLI,1736,30,2,7,9,22.2%,28m
50591,1,max,1735,882,25,35,60,41.7%,5m
50591,1,Drake,1735,776,21,33,54,38.9%,18m
50591,3,Vampy,1735,70,2,13,15,13.3%,25m
50591,3,Arti,1735,30,1,6,7,14.3%,1h
50591,1,sandomoto,1735,44,1,8,9,11.1%,1h
50596,1,Jedezejek,1734,252,11,9,20,55.0%,5m
50596,1,HedgeTerran,1734,275,9,12,21,42.9%,1h
50596,1,[Harley]bezon,1734,225,6,7,13,46.2%,1h
50596,3,Boven,1734,98,5,11,16,31.2%,1h
50596,3,[КЮ]Cklewerr,1734,58,3,4,7,42.9%,29m
50596,1,creker,1734,138,3,7,10,30.0%,10m
50596,1,Jigsaw,1734,88,2,7,9,22.2%,1h
50596,3,[starBf]Bofa,1734,0,1,0,1,100.0%,1h
50596,1,bizkit,1734,0,1,0,1,100.0%,4m
50596,3,[EliteX]IlllIllllI,1734,30,1,14,15,6.7%,1h
50596,1,Superlupo,1734,0,0,1,1,0.0%,12m
50596,1,GrafVadim,1734,0,0,1,1,0.0%,30m
50596,1,oppps,1734,73,0,7,7,0.0%,1h
50609,1,Elma,1733,1675,69,96,165,41.8%,25m
50609,1,StarM,1733,1063,32,36,68,47.1%,1h
50609,1,Aawons,1733,924,26,33,59,44.1%,5m
50609,1,DrMorgi,1733,594,19,23,42,45.2%,1h
50609,1,NISSARD,1733,698,17,27,44,38.6%,25m
50609,1,Samul,1733,276,7,18,25,28.0%,17m
50609,3,Wolverine,1733,149,3,14,17,17.6%,8m
50609,3,[ISK]Derzelis,1733,30,2,5,7,28.6%,1h
50609,3,Blackmer,1733,0,1,4,5,20.0%,1h
50609,3,PBAC,1733,0,1,5,6,16.7%,1h
50609,3,[PraCc]kohaa,1733,0,0,1,1,0.0%,1h
50609,3,Rosenlind,1733,0,0,1,1,0.0%,1h
50609,3,djococe,1733,0,0,3,3,0.0%,1h
50609,3,GoldeProtoss,1733,0,0,3,3,0.0%,1h
50609,1,dimavydrin,1733,0,0,4,4,0.0%,19m
50624,1,Katana,1732,1083,35,42,77,45.5%,34m
50624,1,den,1732,419,13,7,20,65.0%,1h
50624,1,[a2p]Elken,1732,486,12,22,34,35.3%,10m
50624,3,FAFABOY,1732,283,9,15,24,37.5%,1h
50624,1,BudSpencer,1732,196,6,8,14,42.9%,1h
50624,1,[Prrrt]LePelvin,1732,30,2,1,3,66.7%,10m
50624,1,Devel,1732,118,2,3,5,40.0%,33m
50624,1,Imperator,1732,0,0,1,1,0.0%,1h
50624,3,Heisemberg,1732,0,0,3,3,0.0%,1h
50633,1,drDoom,1731,765,24,23,47,51.1%,2m
50633,1,GetOnMyLvL,1731,342,9,16,25,36.0%,1h
50633,3,Panimoni,1731,305,8,22,30,26.7%,1h
50633,1,Spleyn,1731,223,4,7,11,36.4%,20m
50633,3,PlastikEsat,1731,147,4,12,16,25.0%,36m
50633,3,David,1731,120,4,13,17,23.5%,34m
50633,1,Dirk,1731,44,1,1,2,50.0%,11m
50633,3,VituBjj,1731,42,1,10,11,9.1%,1h
50641,2,Dave,1730,1549,122,193,315,38.7%,26m
50641,1,Raff,1730,1615,53,71,124,42.7%,1h
50641,1,lekhabut,1730,836,22,30,52,42.3%,1h
50641,2,serral,1730,243,7,19,26,26.9%,1h
50641,1,serzlo,1730,117,3,12,15,20.0%,10m
50641,3,[JÖREG]HagMag,1730,0,2,6,8,25.0%,1h
50641,3,BlackRack,1730,30,1,2,3,33.3%,34m
50641,2,andy,1730,0,1,10,11,9.1%,1h
50641,1,[DEDAL]Gargor,1730,0,0,1,1,0.0%,9m
50641,1,GachiProton,1730,0,0,1,1,0.0%,1h
50641,1,ssurf,1730,0,0,1,1,0.0%,1h
50641,1,Dron,1730,0,0,3,3,0.0%,17m
50641,1,[CØG]ZangetsuKuro,1730,73,0,9,9,0.0%,28m
50654,1,itzoo,1729,1256,38,52,90,42.2%,1h
50654,3,[UnniT]juanitoo,1729,628,31,45,76,40.8%,1h
50654,1,breadman,1729,875,30,31,61,49.2%,1h
50654,1,Batek,1729,830,21,31,52,40.4%,11m
50654,1,[GSP1]ALZAR,1729,346,10,14,24,41.7%,1h
50654,2,craynorr,1729,60,2,11,13,15.4%,23m
50654,3,Fedgdn,1729,0,1,4,5,20.0%,1h
50654,1,SirGraczus,1729,0,0,1,1,0.0%,1h
50654,1,OlesiaYur,1729,73,0,6,6,0.0%,29m
50663,1,memories,1728,1242,55,77,132,41.7%,1h
50663,2,Pticecril,1728,1221,42,58,100,42.0%,32m
50663,1,sellingmoms,1728,297,11,9,20,55.0%,17m
50663,1,gogolneuf,1728,245,5,10,15,33.3%,1h
50667,3,Kauli,1727,1369,65,102,167,38.9%,30m
50667,1,pollivinix,1727,948,33,60,93,35.5%,10m
50667,1,Vlucas,1727,594,16,17,33,48.5%,17m
50667,1,WhiteGG,1727,0,0,1,1,0.0%,8m
50667,1,Pit,1727,0,0,1,1,0.0%,1h
50667,2,Telepyzik,1727,0,0,9,9,0.0%,35m
50673,1,ACTARUS,1726,1258,37,52,89,41.6%,34m
50673,1,PBR,1726,75,7,32,39,17.9%,1h
50673,1,GuyNeo,1726,117,4,7,11,36.4%,19m
50673,3,snamikot,1726,123,3,10,13,23.1%,25m
50673,2,Arsen,1726,106,3,15,18,16.7%,35m
50673,1,mazterfulnes,1726,36,2,2,4,50.0%,1h
50679,1,[Panger]Bambatant,1725,1462,92,102,194,47.4%,33m
50679,1,mobetter,1725,1887,83,107,190,43.7%,29m
50679,3,Zausel,1725,1539,63,89,152,41.4%,1h
50679,3,Rasl,1725,635,24,31,55,43.6%,1h
50679,1,FishA,1725,328,16,3,19,84.2%,1h
50679,3,Phoenix,1725,128,2,11,13,15.4%,15m
50679,1,TITO,1725,42,1,2,3,33.3%,1h
50679,3,Averon,1725,30,1,4,5,20.0%,1h
50679,2,SirElClariso,1725,30,1,7,8,12.5%,7m
50679,3,NinjaNut,1725,30,1,10,11,9.1%,31m
50679,1,Rombes,1725,0,1,12,13,7.7%,34m
50679,3,Racke,1725,0,0,1,1,0.0%,16m
50691,3,cloud,1724,1512,131,157,288,45.5%,27m
50691,1,bob,1724,876,24,27,51,47.1%,1h
50691,1,TSIMUR,1724,447,13,18,31,41.9%,5m
50691,2,Romanovagent,1724,0,2,8,10,20.0%,17m
50691,1,Ozark,1724,0,1,4,5,20.0%,5m
50691,3,Alex,1724,30,1,11,12,8.3%,16m
50691,1,Xander,1724,0,0,2,2,0.0%,33m
50698,1,крутов,1723,714,25,21,46,54.3%,1h
50698,1,Maddinthemin,1723,459,11,18,29,37.9%,5m
50698,1,Hammer,1723,224,4,7,11,36.4%,1h
50698,1,Armakis,1723,120,3,13,16,18.8%,34m
50698,3,Stormtrooper,1723,30,2,0,2,100.0%,34m
50698,3,REGIS,1723,0,0,7,7,0.0%,31m
50698,3,Juanjo,1723,0,0,10,10,0.0%,1h
50705,1,[PutinL]memora,1722,464,13,16,29,44.8%,1h
50705,1,Vai,1722,46,2,9,11,18.2%,10m
50705,3,Ярослав,1722,30,1,6,7,14.3%,29m
50705,3,onmymind,1722,0,0,6,6,0.0%,1h
50709,2,wako,1721,1549,167,228,395,42.3%,28m
50709,1,Doofrex,1721,1879,92,119,211,43.6%,6m
50709,1,IgorNick,1721,609,21,24,45,46.7%,36m
50709,1,Hench,1721,275,7,18,25,28.0%,11m
50709,1,чек,1721,212,6,7,13,46.2%,1h
50709,1,aquarkHUN,1721,220,5,10,15,33.3%,10m
50709,1,Nitros,1721,82,2,3,5,40.0%,1h
50709,3,Ulrik,1721,62,2,3,5,40.0%,1h
50709,1,Stepan,1721,48,1,1,2,50.0%,1h
50709,1,[EnFi]Jakubsek,1721,0,0,2,2,0.0%,21m
50709,3,ktd,1721,0,0,9,9,0.0%,1h
50720,1,Oasis,1720,1128,34,60,94,36.2%,1h
50720,1,Mitzy,1720,608,18,27,45,40.0%,12m
50720,3,хмурыймонах,1720,58,5,4,9,55.6%,1h
50720,1,Влад,1720,131,2,13,15,13.3%,3m
50720,3,battleflo,1720,0,0,5,5,0.0%,1h
50725,2,[IWOLFI]Gillette,1719,1449,55,62,117,47.0%,1h
50725,1,ToRR,1719,1346,40,51,91,44.0%,2m
50725,1,Chlebak,1719,740,26,35,61,42.6%,6m
50725,3,[SPAINs]Sergiohulkie,1719,417,14,22,36,38.9%,1h
50725,1,Arm,1719,232,7,5,12,58.3%,1h
50725,1,Roman,1719,268,7,12,19,36.8%,1h
50725,3,Jeka,1719,38,4,9,13,30.8%,1h
50725,3,Mhorax,1719,44,1,6,7,14.3%,13m
50733,3,Gyuleks,1718,874,72,102,174,41.4%,18m
50733,1,CricketArsen,1718,209,6,20,26,23.1%,2m
50733,1,DaRealest,1718,188,4,15,19,21.1%,34m
50733,1,Destroyer,1718,42,2,2,4,50.0%,25m
50737,1,Frank,1717,1411,43,68,111,38.7%,1h
50737,1,LuckyFortune,1717,1149,38,53,91,41.8%,1h
50737,1,Andrew,1717,1157,33,47,80,41.2%,30m
50737,1,Misiu,1717,826,27,29,56,48.2%,34m
50737,1,Knedlo,1717,802,22,30,52,42.3%,1h
50737,1,lord,1717,44,2,0,2,100.0%,11m
50737,1,Dzs,1717,0,1,0,1,100.0%,17m
50737,3,guiosteo,1717,30,1,12,13,7.7%,1h
50737,3,Rares,1717,0,0,1,1,0.0%,1h
50737,1,flogart,1717,0,0,2,2,0.0%,10m
50747,3,Trotyl,1716,1459,67,86,153,43.8%,1h
50747,1,[Fansaf]Alexey,1716,781,24,34,58,41.4%,36m
50747,1,Setar,1716,542,17,29,46,37.0%,18m
50747,1,willessss,1716,438,13,16,29,44.8%,10m
50747,1,Tiaaa,1716,322,12,12,24,50.0%,1h
50747,1,kraga,1716,386,9,14,23,39.1%,34m
50747,1,scarpia,1716,271,7,15,22,31.8%,1h
50747,1,Gleboncer,1716,239,4,16,20,20.0%,19m
50747,1,zeratul,1716,0,1,0,1,100.0%,18m
50747,3,lukolik,1716,0,0,3,3,0.0%,28m
50747,1,Atex,1716,0,0,5,5,0.0%,3m
50747,1,Серега,1716,0,0,7,7,0.0%,21m
50747,2,Spartacus,1716,0,0,10,10,0.0%,1h
50760,1,Rattaplan,1715,1879,76,93,169,45.0%,12m
50760,2,Allexander,1715,1212,39,68,107,36.4%,1h
50760,2,CEKO,1715,30,5,9,14,35.7%,17m
50760,1,Mortex,1715,73,0,3,3,0.0%,1h
50760,3,Croco,1715,0,0,4,4,0.0%,1h
50765,3,[mfxed]Kaddafi,1714,468,14,31,45,31.1%,1h
50765,1,Zuzya,1714,128,4,7,11,36.4%,1h
50765,1,DutchDestiny,1714,158,4,8,12,33.3%,11m
50765,1,mellybeeme,1714,120,3,1,4,75.0%,1h
50765,1,GDI,1714,124,3,6,9,33.3%,2m
50765,3,minisep,1714,60,2,12,14,14.3%,31m
50765,3,Amira,1714,0,1,1,2,50.0%,1h
50765,3,Andreyfort,1714,0,0,1,1,0.0%,16m
50773,1,teco,1713,512,17,32,49,34.7%,28m
50773,1,Cunundrum,1713,234,7,9,16,43.8%,1h
50773,1,cederico,1713,255,6,15,21,28.6%,1h
50773,1,starhant,1713,174,5,6,11,45.5%,1h
50773,1,Manuelweiss,1713,94,2,8,10,20.0%,12m
50773,3,Death,1713,0,1,3,4,25.0%,19m
50773,1,ooooo,1713,0,0,1,1,0.0%,1h
50773,1,DinDjarin,1713,0,0,1,1,0.0%,35m
50781,1,slkboy,1712,1097,52,72,124,41.9%,1h
50781,3,EmperorW,1712,81,8,17,25,32.0%,6m
50781,1,gohstdragon,1712,270,7,9,16,43.8%,21m
50781,2,endSADboy,1712,88,3,14,17,17.6%,5m
50781,1,oxiflore,1712,97,1,1,2,50.0%,14m
50781,1,[RO2020]ionut,1712,0,1,2,3,33.3%,18m
50781,1,TurnItUp,1712,0,0,1,1,0.0%,26m
50781,3,hugo,1712,0,0,1,1,0.0%,28m
50781,3,Cronjob,1712,0,0,1,1,0.0%,34m
50790,1,Colin,1711,1430,41,57,98,41.8%,26m
50790,1,Yoghy,1711,1058,28,45,73,38.4%,1h
50790,3,Darius,1711,314,13,35,48,27.1%,6m
50790,1,liph,1711,274,10,6,16,62.5%,1h
50790,3,philippe,1711,182,7,24,31,22.6%,21m
50790,3,[achko]Interscope,1711,121,4,7,11,36.4%,31m
50790,3,Neomag,1711,153,4,10,14,28.6%,36m
50790,1,RaVeN,1711,90,2,12,14,14.3%,25m
50798,1,HiddenSquid,1710,990,34,51,85,40.0%,13m
50798,1,Kekc,1710,1171,32,53,85,37.6%,7m
50798,1,Udarnik,1710,1013,31,37,68,45.6%,30m
50798,1,Elemuss,1710,816,26,29,55,47.3%,12m
50798,1,[TFSC]LittleCaZo,1710,520,19,21,40,47.5%,8m
50798,1,Adonne,1710,286,7,14,21,33.3%,29m
50798,1,InterGRATOR,1710,310,7,18,25,28.0%,1h
50805,3,faildoryne,1709,1220,43,61,104,41.3%,1h
50805,1,Warrior,1709,265,10,11,21,47.6%,5m
50805,1,Ksas,1709,360,9,13,22,40.9%,1h
50805,1,BGWARRIOR,1709,278,7,19,26,26.9%,35m
50805,1,timati,1709,0,4,10,14,28.6%,10m
50805,2,Baattl,1709,0,1,2,3,33.3%,31m
50805,3,kukleks,1709,0,0,1,1,0.0%,13m
50805,1,[nwby]XenoKing,1709,0,0,3,3,0.0%,10m
50805,1,smexonog,1709,73,0,4,4,0.0%,1h
50814,1,Vegasjack,1708,1117,62,101,163,38.0%,26m
50814,1,jimmy,1708,1158,44,47,91,48.4%,1h
50814,1,Ronald,1708,256,7,13,20,35.0%,2m
50814,1,leoni,1708,144,4,20,24,16.7%,1h
50814,1,Mundus,1708,93,1,11,12,8.3%,1h
50819,1,DimirVla,1707,492,12,16,28,42.9%,1h
50819,3,fury,1707,78,3,10,13,23.1%,1h
50819,1,Андрей,1707,88,1,1,2,50.0%,10m
50819,3,Moreno,1707,30,1,4,5,20.0%,1h
50823,1,rufi,1706,1312,81,126,207,39.1%,5m
50823,1,evgen,1706,328,19,26,45,42.2%,8m
50823,1,EnterAName,1706,394,11,14,25,44.0%,1h
50823,3,[Kandis]Necrophagia,1706,0,1,1,2,50.0%,16m
50827,1,WARRIOR,1705,1825,116,169,285,40.7%,1h
50827,1,Weel,1705,598,25,32,57,43.9%,1h
50827,1,JackKnifeUK,1705,692,24,32,56,42.9%,18m
50827,1,Tester,1705,309,8,26,34,23.5%,1h
50827,2,IIIIIIIIIIII,1705,198,7,20,27,25.9%,1h
50827,3,tijojo,1705,100,6,22,28,21.4%,8m
50827,1,Диссертация,1705,46,2,7,9,22.2%,1h
50827,3,Fightscanner,1705,129,2,16,18,11.1%,1h
50827,1,RompiOssa,1705,0,1,5,6,16.7%,1h
50827,2,KazukiHime,1705,0,0,9,9,0.0%,21m
50837,1,PLogroW,1704,1680,52,72,124,41.9%,1h
50837,1,джедай,1704,970,26,38,64,40.6%,19m
50837,3,Spacemonkey,1704,484,16,23,39,41.0%,18m
50837,2,Dezzert,1704,172,3,14,17,17.6%,28m
50837,1,[SbrDst]Celiwan,1704,42,1,5,6,16.7%,17m
50837,2,[Саваны]ilor,1704,0,0,2,2,0.0%,20m
50843,3,Сильверблу,1703,1372,72,125,197,36.5%,33m
50843,1,JohnnyBlazee,1703,418,11,12,23,47.8%,5m
50843,1,Tweedy,1703,164,4,10,14,28.6%,1h
50843,1,rams,1703,128,3,7,10,30.0%,3m
50843,3,Куклус,1703,0,2,4,6,33.3%,1h
50843,1,ghostdragon,1703,0,0,2,2,0.0%,8m
50843,1,denisimus,1703,0,0,3,3,0.0%,4m
50850,1,Kraga,1702,726,19,28,47,40.4%,26m
50850,1,maxquattro,1702,702,19,31,50,38.0%,3m
50850,1,kauciuc,1702,380,15,17,32,46.9%,8m
50850,1,UralCenk,1702,338,8,13,21,38.1%,2m
50850,1,Polus,1702,214,5,13,18,27.8%,1h
50850,3,bzyqmyq,1702,66,2,7,9,22.2%,10m
50850,2,Artico,1702,92,1,11,12,8.3%,1h
50857,2,CIPOTBJE,1701,1307,284,351,635,44.7%,33m
50857,3,MiniNinja,1701,484,24,35,59,40.7%,33m
50857,1,TipTop,1701,537,18,31,49,36.7%,17m
50857,3,salem,1701,86,5,5,10,50.0%,1h
50857,1,Ulfbert,1701,0,1,2,3,33.3%,1h
50857,2,подмышка,1701,30,1,11,12,8.3%,22m
50863,1,imitep,1700,1776,58,82,140,41.4%,1h
50863,1,ElDoopa,1700,899,29,41,70,41.4%,25m
50863,1,papuas,1700,506,16,23,39,41.0%,12m
50863,1,Threlgor,1700,424,10,15,25,40.0%,1h
50863,1,AlexUA,1700,210,5,11,16,31.2%,10m
50863,2,gggggggg,1700,116,4,15,19,21.1%,1h
50863,1,westindyz,1700,152,4,17,21,19.0%,1h
50863,3,RED,1700,30,1,3,4,25.0%,18m
50863,3,xxxfrixxx,1700,38,1,4,5,20.0%,1h
50863,3,Punkie,1700,0,1,8,9,11.1%,33m
50863,3,IHNM,1700,0,0,10,10,0.0%,31m
50863,2,PaiK,1700,0,0,11,11,0.0%,1h
50875,3,KPOBOCOC,1699,1420,110,136,246,44.7%,1h
50875,1,Scotch,1699,288,10,27,37,27.0%,15m
50875,1,InYourFace,1699,93,2,0,2,100.0%,1h
50875,1,RomanPo,1699,0,1,2,3,33.3%,25m
50875,3,SilentSword,1699,0,0,1,1,0.0%,10m
50875,3,ҪąƞƞǫƞƦŲŞḨ,1699,0,0,1,1,0.0%,19m
50881,1,Братишка,1698,418,12,25,37,32.4%,1h
50881,1,Lait,1698,146,6,4,10,60.0%,1h
50881,3,Takel,1698,120,6,19,25,24.0%,13m
50881,1,Мурлок,1698,228,6,21,27,22.2%,1h
50881,2,PoorlyDrawn,1698,126,5,17,22,22.7%,3m
50881,1,ariciu,1698,125,3,14,17,17.6%,9m
50881,2,Antonulan,1698,30,2,9,11,18.2%,32m
50888,2,StiflersDad,1697,543,35,53,88,39.8%,1h
50888,1,Avis,1697,414,11,18,29,37.9%,1h
50888,1,Aunrad,1697,270,7,22,29,24.1%,14m
50888,1,Smirnayga,1697,178,5,8,13,38.5%,10m
50888,2,Sempiternal,1697,209,4,16,20,20.0%,25m
50888,3,BìoníC,1697,45,3,9,12,25.0%,18m
50888,1,azerty,1697,46,2,9,11,18.2%,1h
50888,1,skyclasher,1697,73,0,8,8,0.0%,19m
50896,1,wise,1696,1790,57,78,135,42.2%,10m
50896,1,JuveTif,1696,1786,50,74,124,40.3%,1h
50896,1,Tanis,1696,40,1,2,3,33.3%,11m
50896,1,[CIU2]walla,1696,44,1,5,6,16.7%,1h
50900,1,утк,1695,869,24,31,55,43.6%,3m
50900,1,MNFX,1695,537,15,17,32,46.9%,21m
50900,1,FRIGO,1695,172,4,10,14,28.6%,1h
50900,1,muchomorek,1695,138,4,17,21,19.0%,1h
50900,3,Magic,1695,0,1,4,5,20.0%,1h
50900,1,Pacifist,1695,99,1,6,7,14.3%,6m
50900,3,budiak,1695,0,0,6,6,0.0%,13m
50907,1,ROCKI,1694,1743,55,78,133,41.4%,20m
50907,3,Stanley,1694,1520,49,85,134,36.6%,3m
50907,1,Kingofwars,1694,716,22,32,54,40.7%,8m
50907,1,Daniil,1694,267,5,16,21,23.8%,1h
50907,1,Lyle,1694,78,3,4,7,42.9%,17m
50907,1,ColMARKO,1694,0,1,5,6,16.7%,1h
50907,3,MahinexPL,1694,0,0,1,1,0.0%,19m
50914,3,Sebsok,1693,301,10,18,28,35.7%,24m
50914,1,propolis,1693,226,7,12,19,36.8%,5m
50914,1,Veter,1693,303,5,12,17,29.4%,1h
50914,1,Didaquatre,1693,111,2,3,5,40.0%,1h
50914,1,CatLev,1693,0,1,1,2,50.0%,28m
50919,1,DOC,1692,1752,74,87,161,46.0%,1h
50919,3,ZetekAntares,1692,129,3,19,22,13.6%,1h
50919,1,mil,1692,126,2,2,4,50.0%,1h
50919,3,Omnipotence,1692,64,2,12,14,14.3%,10m
50919,1,TopCat,1692,0,0,4,4,0.0%,8m
50924,1,Каа,1691,674,24,28,52,46.2%,2m
50924,1,[IRMGZ]Irmandiño,1691,0,1,1,2,50.0%,11m
50924,1,nicktheman,1691,0,1,2,3,33.3%,2m
50924,3,DBDome,1691,30,1,6,7,14.3%,1h
50924,2,HotGrill,1691,36,1,12,13,7.7%,23m
50924,1,Pulsar,1691,0,0,3,3,0.0%,8m
50930,1,Mikael,1690,0,1,1,2,50.0%,10m
50930,3,PeterDr,1690,0,0,3,3,0.0%,1h
50930,2,Hyperion,1690,0,0,11,11,0.0%,1h
50933,1,Shorty,1689,502,16,28,44,36.4%,1h
50933,1,[PCAS]Brutalage,1689,229,8,10,18,44.4%,1h
50933,1,tyrion,1689,178,4,7,11,36.4%,1h
50933,1,otto,1689,136,3,6,9,33.3%,29m
50933,1,Bestpedro,1689,0,1,0,1,100.0%,10m
50933,1,[kek34]DEMON,1689,0,0,3,3,0.0%,1h
50939,1,picaban,1688,1436,43,60,103,41.7%,6m
50939,1,HajimeZ,1688,978,30,49,79,38.0%,21m
50939,1,Proteo,1688,822,24,29,53,45.3%,1h
50939,3,Francisco,1688,243,24,39,63,38.1%,1h
50939,1,[Coop00]Nazar,1688,496,12,20,32,37.5%,1h
50939,1,marguzzio,1688,293,9,19,28,32.1%,1h
50939,1,SANYA,1688,170,4,7,11,36.4%,12m
50939,1,Sskiks,1688,154,4,8,12,33.3%,19m
50939,1,НИКИТА,1688,0,1,1,2,50.0%,1h
50939,2,kirito,1688,0,1,1,2,50.0%,1h
50939,1,ЮркаШмаровоз,1688,0,1,3,4,25.0%,1h
50939,2,watershroom,1688,0,0,1,1,0.0%,22m
50939,3,GTownLocal,1688,0,0,3,3,0.0%,29m
50952,1,Roman,1687,182,4,12,16,25.0%,20m
50952,1,wuzi,1687,90,1,2,3,33.3%,1h
50952,1,gappa,1687,0,0,2,2,0.0%,1h
50955,2,Simon,1686,680,21,45,66,31.8%,1h
50955,2,ramiipariis,1686,422,15,15,30,50.0%,1h
50955,1,IvanSelick,1686,116,2,2,4,50.0%,1h
50955,1,[BMDR]Kinder,1686,94,1,2,3,33.3%,1h
50955,1,[mfxed]KELPI,1686,0,1,3,4,25.0%,1h
50955,2,[BMDR]Yarik,1686,0,0,1,1,0.0%,20m
50961,1,fretendrete,1685,1882,155,238,393,39.4%,25m
50961,1,WolfBlooD,1685,1495,102,140,242,42.1%,18m
50961,1,Grusin,1685,868,24,40,64,37.5%,4m
50961,1,VoVmx,1685,305,11,11,22,50.0%,36m
50961,1,Schleuse,1685,364,9,17,26,34.6%,34m
50961,1,ANTONIO,1685,222,5,12,17,29.4%,19m
50961,3,kaplan,1685,92,5,23,28,17.9%,1h
50961,1,Zerg,1685,166,4,7,11,36.4%,26m
50961,1,[STRNG]Zephyr,1685,160,4,9,13,30.8%,26m
50961,3,TrofBogdan,1685,0,2,10,12,16.7%,14m
50961,1,ZEWS,1685,44,2,15,17,11.8%,12m
50961,3,Вырвиглаз,1685,48,1,6,7,14.3%,34m
50961,3,Pumeo,1685,0,0,1,1,0.0%,1h
50961,3,[АГР]SHALUN,1685,0,0,2,2,0.0%,18m
50961,1,Ductitou,1685,0,0,3,3,0.0%,3m
50976,1,Frency,1684,1566,107,162,269,39.8%,9m
50976,1,Nannack,1684,468,13,18,31,41.9%,1h
50976,1,MAGICLORD,1684,358,9,10,19,47.4%,36m
50976,1,Predy,1684,273,8,15,23,34.8%,10m
50976,1,DredRed,1684,228,6,11,17,35.3%,7m
50976,1,Dason,1684,124,2,3,5,40.0%,28m
50976,1,Andy,1684,142,2,5,7,28.6%,9m
50976,1,FejuXxX,1684,73,0,11,11,0.0%,12m
50984,1,[MRaven]Return,1683,237,9,6,15,60.0%,2m
50985,1,Chewy,1682,673,22,26,48,45.8%,20m
50985,1,[HeRoiC]TERRYJAM,1682,680,17,32,49,34.7%,1h
50985,1,kal,1682,508,15,14,29,51.7%,7m
50985,1,[GAMI]OlivFR,1682,480,14,14,28,50.0%,33m
50985,1,Meow,1682,229,7,9,16,43.8%,1h
50985,1,lapinou,1682,218,5,15,20,25.0%,1h
50985,1,SinH,1682,82,3,3,6,50.0%,1h
50985,2,umr,1682,74,2,6,8,25.0%,1h
50985,1,[Qwеrty]MasterZnatok,1682,156,2,11,13,15.4%,1h
50985,3,некит,1682,0,1,1,2,50.0%,16m
50985,2,jawsbite,1682,73,0,7,7,0.0%,1h
50996,1,SpaceMarine,1681,503,14,27,41,34.1%,11m
50996,1,Alsi,1681,396,8,26,34,23.5%,29m
50996,3,Player,1681,74,5,7,12,41.7%,1h
50996,2,destroit,1681,124,3,16,19,15.8%,1h
50996,1,PROpotato,1681,46,2,6,8,25.0%,8m
50996,3,Crynch,1681,0,1,4,5,20.0%,28m
50996,1,JebieUkraine,1681,0,1,8,9,11.1%,19m
51003,3,ucrania,1680,125,4,9,13,30.8%,1h
51003,1,[PUNTIS]Avatar,1680,0,1,3,4,25.0%,1h
51005,2,Kukinbob,1679,900,34,60,94,36.2%,14m
51005,1,Топер,1679,694,20,35,55,36.4%,7m
51005,1,Maguen,1679,82,3,14,17,17.6%,1h
51005,1,[NorWP]JelleP,1679,0,1,1,2,50.0%,4m
51009,1,SimplyBest,1678,1653,135,164,299,45.2%,21m
51009,2,DJPrisma,1678,294,31,55,86,36.0%,1h
51009,2,Tomi,1678,460,14,28,42,33.3%,16m
51009,1,kkurek,1678,364,13,22,35,37.1%,13m
51009,2,Jab,1678,354,12,16,28,42.9%,1h
51009,3,darioyannis,1678,241,7,17,24,29.2%,1h
51009,1,[WiClan]Zheltopuz,1678,144,4,5,9,44.4%,20m
51009,1,epic,1678,90,2,7,9,22.2%,1h
51009,3,Serendipity,1678,42,1,7,8,12.5%,1h
51009,3,Tatoo,1678,30,1,10,11,9.1%,1h
51009,2,Voltec,1678,0,0,1,1,0.0%,1h
51020,1,Dango,1677,343,11,19,30,36.7%,9m
51020,1,Reptil,1677,0,1,1,2,50.0%,1h
51022,2,док,1676,170,6,6,12,50.0%,4m
51022,1,Corol,1676,120,3,8,11,27.3%,2m
51022,1,Nima,1676,94,2,2,4,50.0%,4m
51022,1,Panart,1676,0,1,5,6,16.7%,14m
51022,3,Pandarus,1676,0,0,1,1,0.0%,1h
51027,1,Kaslékouil,1675,518,13,27,40,32.5%,1h
51027,3,adalio,1675,30,3,1,4,75.0%,1h
51027,3,NOMAR,1675,0,1,2,3,33.3%,31m
51030,3,Javi,1674,1385,134,164,298,45.0%,28m
51030,1,ZHAN,1674,1211,42,69,111,37.8%,1h
51030,1,Minddiver,1674,425,11,16,27,40.7%,12m
51030,3,KrütliKriegr,1674,30,1,7,8,12.5%,13m
51030,2,Arogorn,1674,0,1,13,14,7.1%,1h
51030,2,Sunshinegirl,1674,0,0,1,1,0.0%,23m
51036,1,Jesulin,1673,770,31,42,73,42.5%,6m
51036,1,PlayBeagle,1673,877,27,48,75,36.0%,21m
51036,1,demoneSKILL,1673,717,23,28,51,45.1%,1h
51036,1,Fran,1673,309,12,10,22,54.5%,1h
51036,1,Diego,1673,252,6,14,20,30.0%,6m
51036,1,Анисим,1673,0,1,6,7,14.3%,7m
51036,1,TRUX,1673,0,0,4,4,0.0%,1h
51043,3,MelHomann,1672,665,28,47,75,37.3%,27m
51043,1,calie,1672,864,23,35,58,39.7%,9m
51043,1,FraGelIO,1672,604,19,40,59,32.2%,1h
51043,1,berinhard,1672,300,7,16,23,30.4%,1h
51043,2,Island,1672,202,5,24,29,17.2%,29m
51043,1,optimusprime,1672,133,4,3,7,57.1%,1h
51043,2,Kostoy,1672,130,2,6,8,25.0%,22m
51043,1,mangodehuey,1672,48,1,5,6,16.7%,3m
51051,2,Danille,1671,773,68,110,178,38.2%,24m
51051,1,[LE4VE]anorganic,1671,459,12,26,38,31.6%,1h
51051,1,Fonz,1671,298,8,15,23,34.8%,21m
51051,2,Ivy,1671,194,8,19,27,29.6%,1h
51051,2,Jouma,1671,124,6,4,10,60.0%,20m
51051,1,Minchenlord,1671,116,4,6,10,40.0%,5m
51051,2,Ervin,1671,96,1,8,9,11.1%,2m
51051,2,eismeer,1671,0,0,3,3,0.0%,1h
51059,1,BENC,1670,510,13,23,36,36.1%,1h
51059,2,Meowoholic,1670,104,4,3,7,57.1%,35m
51059,2,aspide,1670,0,1,0,1,100.0%,1h
51059,1,fortheKing,1670,0,1,6,7,14.3%,13m
51059,3,nekit,1670,0,0,2,2,0.0%,1h
51059,2,Tyca,1670,0,0,9,9,0.0%,1h
51065,3,Bob,1669,610,40,58,98,40.8%,27m
51065,2,Frollo,1669,0,1,0,1,100.0%,1h
51065,2,Tervel,1669,0,0,1,1,0.0%,2m
51068,2,Argol,1668,368,11,15,26,42.3%,1h
51068,1,mrwoops,1668,228,5,8,13,38.5%,1h
51068,1,Zorack,1668,188,4,5,9,44.4%,1h
51068,2,[NCRZ]BarbeBlonde,1668,30,2,1,3,66.7%,1h
51072,1,Nabkho,1667,1170,65,92,157,41.4%,1h
51072,3,Mikstray,1667,60,4,10,14,28.6%,25m
51074,3,yunus,1666,1501,65,117,182,35.7%,28m
51074,3,Finli,1666,234,10,12,22,45.5%,1h
51074,1,AleFA,1666,203,4,18,22,18.2%,1h
51074,1,[Waha40]AbaddonDest,1666,84,3,3,6,50.0%,1h
51074,2,klim,1666,0,3,6,9,33.3%,1h
51074,1,[Spongo]Carsten,1666,91,1,3,4,25.0%,9m
51080,1,ghiaurii,1665,1110,40,54,94,42.6%,33m
51080,3,ЕЬТИГНР,1665,0,2,4,6,33.3%,31m
51080,2,Knotsgek,1665,0,1,0,1,100.0%,1h
51083,1,павилитель,1664,278,8,9,17,47.1%,26m
51083,2,Typhlosis,1664,0,1,0,1,100.0%,22m
51083,1,Feniks,1664,44,1,10,11,9.1%,1h
51083,3,marumaru,1664,0,0,1,1,0.0%,1h
51083,2,ronen,1664,73,0,3,3,0.0%,1h
51088,1,istanbultrip,1663,729,21,35,56,37.5%,1h
51088,1,Antihrist,1663,604,15,29,44,34.1%,13m
51088,1,Derron,1663,123,2,13,15,13.3%,34m
51088,2,Snapshot,1663,48,1,12,13,7.7%,1h
51092,1,Creative,1662,130,3,8,11,27.3%,30m
51092,2,blattnoobi,1662,0,1,4,5,20.0%,29m
51092,3,Berggnom,1662,0,1,8,9,11.1%,1h
51095,1,QawaS,1661,786,21,37,58,36.2%,6m
51095,1,[FAL1]Annotate,1661,140,3,10,13,23.1%,8m
51095,1,drosophila,1661,106,3,11,14,21.4%,1h
51095,3,Zealot,1661,30,2,19,21,9.5%,8m
51095,3,san,1661,0,1,5,6,16.7%,13m
51095,1,Fredynator,1661,0,0,4,4,0.0%,35m
51095,2,[PITYX]Lisi,1661,0,0,4,4,0.0%,6m
51102,1,viper,1660,942,28,39,67,41.8%,6m
51102,1,Manwë,1660,306,9,22,31,29.0%,6m
51102,2,Guizmo,1660,274,9,23,32,28.1%,17m
51102,2,Middgard,1660,76,3,3,6,50.0%,14m
51102,3,zotov,1660,30,2,9,11,18.2%,18m
51102,3,Pepe,1660,0,0,9,9,0.0%,19m
51108,1,PABLO,1659,889,25,34,59,42.4%,6m
51108,1,Arzach,1659,417,13,33,46,28.3%,16m
51108,1,Putyu,1659,163,4,11,15,26.7%,1h
51108,1,TeslaWarrior,1659,143,3,4,7,42.9%,6m
51108,2,iiDomination,1659,0,0,1,1,0.0%,1h
51108,3,CTL,1659,0,0,11,11,0.0%,1h
51114,1,АросПрага,1658,858,25,35,60,41.7%,1h
51114,1,Aronson,1658,727,20,34,54,37.0%,3m
51114,1,MaDzone,1658,407,17,23,40,42.5%,29m
51114,2,NikoKLP,1658,266,7,9,16,43.8%,35m
51114,2,TheGreatOne,1658,153,3,17,20,15.0%,7m
51114,1,егор,1658,0,1,2,3,33.3%,26m
51114,3,MrSwob,1658,30,1,6,7,14.3%,7m
51114,3,killersimo,1658,0,0,1,1,0.0%,16m
51114,3,Hideyoshi,1658,0,0,6,6,0.0%,1h
51123,2,hannistar,1657,216,7,9,16,43.8%,1h
51123,1,Moszczur,1657,88,2,9,11,18.2%,12m
51123,3,CherT,1657,0,1,4,5,20.0%,13m
51123,1,Warso,1657,0,0,6,6,0.0%,34m
51123,3,Vialar,1657,0,0,8,8,0.0%,1h
51128,2,Samokat,1656,160,6,9,15,40.0%,7m
51128,2,Antrofogo,1656,82,2,5,7,28.6%,1h
51128,3,[2D2Д]Аэрадан,1656,0,2,5,7,28.6%,31m
51128,1,Hanmandu,1656,0,1,8,9,11.1%,18m
51128,1,Harun,1656,73,0,12,12,0.0%,29m
51133,2,Reuke,1655,1567,197,387,584,33.7%,28m
51133,2,VORONI,1655,0,4,1,5,80.0%,1h
51133,3,evgenix,1655,0,0,1,1,0.0%,1h
51133,1,Guillaume,1655,0,0,3,3,0.0%,1h
51137,1,pbn,1654,478,11,21,32,34.4%,1h
51137,3,[TNÜ]Watch,1654,0,0,8,8,0.0%,1h
51139,1,germar,1653,698,17,29,46,37.0%,36m
51139,3,Shadowlord,1653,237,9,12,21,42.9%,28m
51139,1,LeoValdez,1653,312,8,18,26,30.8%,21m
51139,1,Seratul,1653,162,3,5,8,37.5%,10m
51139,1,[DOSDOS]MrBlitzkrieg,1653,86,2,6,8,25.0%,7m
51144,1,AnkSeb,1652,268,6,20,26,23.1%,13m
51144,1,Alex,1652,184,4,19,23,17.4%,1h
51144,1,silvano,1652,88,2,10,12,16.7%,33m
51144,2,МёрзлыйПес,1652,0,1,0,1,100.0%,1h
51148,2,CHARLIE,1651,616,25,26,51,49.0%,22m
51148,1,beduin,1651,854,25,42,67,37.3%,1h
51148,1,Bart,1651,106,2,5,7,28.6%,1h
51148,1,kma,1651,102,1,4,5,20.0%,1h
51148,1,Алекс,1651,48,1,7,8,12.5%,1h
51148,2,thePlankfish,1651,0,0,5,5,0.0%,1h
51148,3,Frostmourne,1651,0,0,6,6,0.0%,1h
51155,1,ademp,1650,1852,70,107,177,39.5%,5m
51155,3,Strashnyipa,1650,279,9,24,33,27.3%,1h
51155,2,Vazymolo,1650,90,1,13,14,7.1%,5m
51158,1,maniglus,1649,1689,57,70,127,44.9%,7m
51158,1,MKTheKing,1649,305,12,16,28,42.9%,20m
51158,1,[CMM]CaptainWhite,1649,178,4,5,9,44.4%,8m
51158,3,[tospro]Dragoncat,1649,34,1,5,6,16.7%,1h
51158,3,Giraffe,1649,0,0,1,1,0.0%,1h
51163,2,BlackNalym,1648,108,3,16,19,15.8%,23m
51163,3,JNEB,1648,0,0,2,2,0.0%,7m
51163,2,Stels,1648,0,0,5,5,0.0%,1h
51163,3,Eddy,1648,0,0,6,6,0.0%,18m
51167,2,replikant,1647,1494,86,143,229,37.6%,23m
51167,1,[porra]MrRef,1647,1065,36,60,96,37.5%,11m
51167,2,Andre,1647,978,32,49,81,39.5%,2m
51167,1,cris,1647,701,18,28,46,39.1%,20m
51167,1,inkerman,1647,162,5,21,26,19.2%,5m
51167,1,MarcoCM,1647,44,2,16,18,11.1%,20m
51173,1,tyrion,1646,248,6,12,18,33.3%,1h
51173,1,Becker,1646,178,5,8,13,38.5%,6m
51173,1,PlatonT,1646,131,3,4,7,42.9%,4m
51173,2,Caxarok,1646,0,1,4,5,20.0%,1h
51173,2,ToiletDive,1646,0,0,1,1,0.0%,1h
51178,3,[N0V]Dariosky,1645,1084,36,71,107,33.6%,27m
51178,1,KingDennis,1645,662,17,28,45,37.8%,1h
51178,1,Nesta,1645,260,6,10,16,37.5%,1h
51178,2,TRIPLELIFE,1645,68,3,2,5,60.0%,1h
51178,2,YoshikiKano,1645,0,1,0,1,100.0%,1h
51178,3,ASD,1645,30,1,4,5,20.0%,10m
51178,3,Hudson,1645,0,0,2,2,0.0%,1h
51178,3,darkangel,1645,0,0,4,4,0.0%,1h
51186,1,Alex,1644,1853,101,141,242,41.7%,1h
51186,1,bekk,1644,1676,60,80,140,42.9%,11m
51186,1,DATA,1644,1512,47,68,115,40.9%,21m
51186,3,hamudi,1644,234,8,15,23,34.8%,31m
51186,1,Umberto,1644,102,3,3,6,50.0%,1h
51186,2,SiapJoe,1644,78,2,2,4,50.0%,1h
51186,1,ERNST,1644,94,2,7,9,22.2%,1h
51186,2,Dartes,1644,46,1,2,3,33.3%,1h
51194,1,Sandeman,1643,344,9,21,30,30.0%,1h
51194,2,Carlito,1643,0,1,0,1,100.0%,31m
51196,1,Magik,1642,392,16,29,45,35.6%,1h
51196,1,Skorpio,1642,467,12,21,33,36.4%,11m
51196,2,robstar,1642,46,1,14,15,6.7%,23m
51196,1,Schleicher,1642,73,0,5,5,0.0%,1h
51200,1,Abimaelus,1641,1689,74,108,182,40.7%,13m
51200,1,Nichois,1641,183,5,20,25,20.0%,35m
51200,2,[АУЕШКИ]Cobainkillme,1641,114,3,2,5,60.0%,1h
51200,2,Stud,1641,88,3,3,6,50.0%,1h
51200,1,Biwan,1641,0,1,6,7,14.3%,13m
51200,2,Tronblon,1641,30,1,9,10,10.0%,1h
51200,2,jirkajirka,1641,0,0,1,1,0.0%,8m
51207,2,Badabum,1640,1568,50,86,136,36.8%,1h
51207,1,GhostDog,1640,644,23,27,50,46.0%,21m
51207,2,Shadow,1640,464,15,13,28,53.6%,1h
51207,1,Marcus,1640,471,14,26,40,35.0%,11m
51207,3,Károly,1640,356,11,22,33,33.3%,27m
51207,1,MAT,1640,317,7,12,19,36.8%,20m
51207,2,Funaky,1640,72,3,8,11,27.3%,1h
51207,2,BeN,1640,0,1,4,5,20.0%,1h
51207,2,Londoneyes,1640,103,1,11,12,8.3%,1h
51216,1,cornus,1639,1118,51,72,123,41.5%,1h
51216,3,Killerbiene,1639,498,18,27,45,40.0%,1h
51216,2,MOFLY,1639,124,4,3,7,57.1%,20m
51216,1,FlyingTyger,1639,97,4,11,15,26.7%,1h
51216,1,JOHNJOHN,1639,48,2,8,10,20.0%,1h
51216,2,InfoDecision,1639,0,0,1,1,0.0%,2m
51222,1,DJADRIAN,1638,638,24,35,59,40.7%,36m
51222,1,krapiva,1638,510,14,29,43,32.6%,20m
51222,1,Adam,1638,0,1,12,13,7.7%,33m
51225,2,Funny,1637,58,3,1,4,75.0%,14m
51225,2,ChopChop,1637,95,1,2,3,33.3%,20m
51225,1,rizuisannin,1637,73,1,15,16,6.2%,34m
51225,3,Howl,1637,30,1,43,44,2.3%,21m
51225,2,byloo,1637,0,0,7,7,0.0%,2m
51225,2,ElricScII,1637,0,0,7,7,0.0%,34m
51231,2,PlushSamurai,1636,404,11,21,32,34.4%,1h
51231,1,Nantes,1636,257,6,11,17,35.3%,1h
51231,3,MajorTom,1636,60,3,7,10,30.0%,34m
51231,2,AJones,1636,62,2,13,15,13.3%,14m
51235,1,[DLIFT]WildWolf,1635,1076,34,50,84,40.5%,17m
51235,1,Spidi,1635,814,21,45,66,31.8%,34m
51235,2,northern,1635,268,7,21,28,25.0%,1h
51235,3,Kajus,1635,30,1,1,2,50.0%,7m
51239,1,bilbelte,1634,1404,41,73,114,36.0%,10m
51239,2,druid,1634,979,38,47,85,44.7%,1h
51239,2,LizaSolnceva,1634,833,27,85,112,24.1%,9m
51239,1,[minire]SASAMAN,1634,842,23,48,71,32.4%,1h
51239,1,DelMatt,1634,402,11,32,43,25.6%,4m
51239,1,infarh,1634,247,6,26,32,18.8%,29m
51239,1,LittleLion,1634,132,3,12,15,20.0%,1h
51239,2,Ans,1634,0,2,3,5,40.0%,5m
51239,2,DaFerstDi,1634,46,1,2,3,33.3%,1h
51239,1,gyrnyak,1634,0,1,6,7,14.3%,1h
51239,3,Travochka,1634,30,1,12,13,7.7%,1h
51250,1,CalvinS,1633,884,47,78,125,37.6%,1h
51250,1,slywa,1633,707,22,24,46,47.8%,1h
51250,1,Raikal,1633,317,8,24,32,25.0%,1h
51250,2,jimjohanson,1633,30,1,2,3,33.3%,29m
51250,2,Киуска,1633,0,0,1,1,0.0%,23m
51255,1,НЕРВНЫЙ,1632,482,13,19,32,40.6%,1h
51255,2,Nazym,1632,120,4,18,22,18.2%,1h
51255,2,ThanosSk,1632,90,3,15,18,16.7%,4m
51255,3,sledhehammer,1632,0,0,4,4,0.0%,13m
51259,2,SoTek,1631,68,2,2,4,50.0%,22m
51259,3,Colliejjj,1631,0,0,1,1,0.0%,28m
51261,1,dvr,1630,1092,30,46,76,39.5%,11m
51261,3,yezzzzz,1630,0,1,0,1,100.0%,19m
51261,3,xropi,1630,0,0,1,1,0.0%,19m
51261,2,DESTROYER,1630,0,0,1,1,0.0%,1h
51265,1,BoogiE,1629,420,24,35,59,40.7%,1h
51265,1,SchwillTiger,1629,543,16,27,43,37.2%,6m
51265,3,Sherkhaan,1629,64,2,5,7,28.6%,10m
51265,3,sgs,1629,36,1,2,3,33.3%,1h
51269,2,Dutch,1628,562,15,26,41,36.6%,1h
51269,2,vicemas,1628,239,9,6,15,60.0%,1h
51269,1,[shoo]muldrothaEDH,1628,104,1,8,9,11.1%,19m
51272,1,Jose,1627,1361,59,90,149,39.6%,1h
51272,1,[gold1]Theodosios,1627,1122,40,60,100,40.0%,19m
51272,1,бриангур,1627,815,28,43,71,39.4%,31m
51272,2,Dyno,1627,727,19,34,53,35.8%,19m
51272,3,Laopin,1627,362,11,28,39,28.2%,30m
51277,3,Draculius,1626,162,5,20,25,20.0%,4m
51277,2,Ottoman,1626,170,4,1,5,80.0%,1h
51277,2,bsbaxxter,1626,30,4,9,13,30.8%,1h
51277,1,Atreus,1626,0,0,5,5,0.0%,1h
51277,3,Fear,1626,0,0,5,5,0.0%,1h
51282,3,Squall,1625,170,7,14,21,33.3%,31m
51282,2,dreifimisi,1625,143,5,10,15,33.3%,1h
51282,2,Swaggosaurus,1625,132,4,19,23,17.4%,1h
51282,2,Gildat,1625,36,2,0,2,100.0%,14m
51282,1,MaksMV,1625,76,2,13,15,13.3%,2m
51282,1,IronFalcon,1625,40,1,4,5,20.0%,11m
51288,1,SanchoS,1624,491,13,19,32,40.6%,20m
51288,1,Canaristory,1624,400,13,33,46,28.3%,13m
51288,1,pirojok,1624,510,12,22,34,35.3%,1h
51288,1,ANTIzerg,1624,284,8,14,22,36.4%,1h
51292,1,AtomicBetty,1623,1720,65,103,168,38.7%,1h
51292,1,bitcoin,1623,1382,50,71,121,41.3%,1h
51292,2,[prosy9]eryk,1623,416,12,19,31,38.7%,1h
51292,1,Rommel,1623,110,4,18,22,18.2%,1h
51292,2,AHAB,1623,128,3,16,19,15.8%,1h
51292,3,Heiko,1623,38,1,11,12,8.3%,1h
51292,3,миша,1623,0,0,3,3,0.0%,1h
51299,2,[CNKRT]Onur,1622,142,5,1,6,83.3%,1h
51299,2,[JaPP]Konstagreen,1622,151,2,5,7,28.6%,1h
51299,3,TOFU,1622,0,0,1,1,0.0%,13m
51302,1,[KAPAd]Nibbana,1621,366,13,16,29,44.8%,1h
51302,2,DLGSISO,1621,391,12,19,31,38.7%,19m
51302,1,Centori,1621,210,5,10,15,33.3%,2m
51302,2,Florin,1621,92,4,6,10,40.0%,1h
51302,2,auror,1621,166,3,15,18,16.7%,1h
51302,1,tomasgalki,1621,119,2,9,11,18.2%,11m
51302,1,Francoisss,1621,0,0,8,8,0.0%,6m
51309,2,Bubayilo,1620,210,5,22,27,18.5%,30m
51309,2,Paolino,1620,143,3,2,5,60.0%,1h
51309,2,JANNY,1620,0,1,3,4,25.0%,20m
51309,2,BoiIiiIIiIII,1620,0,0,1,1,0.0%,1h
51309,3,storm,1620,0,0,9,9,0.0%,18m
51314,1,EddyStortion,1619,327,8,21,29,27.6%,11m
51314,2,[xzw12]szymiqq,1619,40,2,1,3,66.7%,1h
51314,2,[AniME6]ToBi,1619,0,0,1,1,0.0%,29m
51314,3,gtr,1619,0,0,1,1,0.0%,16m
51314,2,ggg,1619,0,0,2,2,0.0%,1h
51319,2,Fabry,1618,284,5,22,27,18.5%,29m
51319,2,bumfluff,1618,76,2,2,4,50.0%,1h
51321,1,Cybersoldier,1617,440,12,19,31,38.7%,18m
51321,2,ThorsHammer,1617,174,4,12,16,25.0%,1h
51321,2,SpaceInvader,1617,0,0,2,2,0.0%,1h
51324,3,Endriu,1616,210,8,15,23,34.8%,1h
51324,2,MAD,1616,0,0,1,1,0.0%,1h
51326,1,buba,1615,1680,88,126,214,41.1%,20m
51326,1,Ingenieur,1615,860,74,108,182,40.7%,1h
51326,1,necrobutcher,1615,622,16,25,41,39.0%,11m
51326,2,BlackMoore,1615,106,4,5,9,44.4%,1h
51326,1,Aiexia,1615,161,4,7,11,36.4%,14m
51326,1,MahakalaPL,1615,195,4,9,13,30.8%,1h
51326,3,макс,1615,58,2,3,5,40.0%,1h
51333,2,Attar,1614,0,0,2,2,0.0%,20m
51334,1,Tuberer,1613,1483,59,84,143,41.3%,1h
51334,1,kitsune,1613,289,10,23,33,30.3%,20m
51334,1,KENINSEGGOST,1613,30,1,13,14,7.1%,25m
51334,2,SFrenchie,1613,0,0,2,2,0.0%,1h
51338,2,Боб,1612,57,3,16,19,15.8%,20m
51338,1,Yamaraj,1612,0,2,5,7,28.6%,11m
51338,2,TheWillis,1612,0,0,1,1,0.0%,20m
51341,2,Luca,1611,1605,83,163,246,33.7%,23m
51341,1,RockNRoll,1611,97,4,7,11,36.4%,11m
51341,2,EnTaro,1611,0,0,1,1,0.0%,1h
51344,1,Olektietz,1610,1747,143,241,384,37.2%,1h
51344,2,Alexus,1610,70,3,17,20,15.0%,1h
51344,2,[Ogz]Starshooter,1610,62,2,8,10,20.0%,1h
51344,3,aDropOfInk,1610,48,1,13,14,7.1%,13m
51344,3,Max,1610,0,0,6,6,0.0%,19m
51349,1,RAW,1609,46,1,6,7,14.3%,5m
51349,1,Brubacker,1609,0,1,12,13,7.7%,11m
51349,2,Хлыст,1609,0,0,5,5,0.0%,1h
51352,1,Sailing,1608,966,33,47,80,41.2%,12m
51352,2,zkiller,1608,178,6,6,12,50.0%,31m
51352,3,Überheld,1608,180,6,10,16,37.5%,1h
51352,1,AlexDM,1608,106,5,22,27,18.5%,4m
51352,3,DANTE,1608,0,1,6,7,14.3%,28m
51352,2,hawkeye,1608,0,0,1,1,0.0%,1h
51352,3,LaViK,1608,0,0,2,2,0.0%,1h
51359,1,vakman,1607,1033,32,58,90,35.6%,3m
51359,1,sven,1607,413,13,21,34,38.2%,36m
51359,2,пика,1607,134,7,14,21,33.3%,29m
51359,2,Bebquid,1607,68,2,15,17,11.8%,1h
51359,3,Ganmor,1607,0,0,12,12,0.0%,29m
51364,1,BryanEllis,1606,1246,45,63,108,41.7%,1h
51364,3,Kelevra,1606,142,6,5,11,54.5%,7m
51364,2,[lkgg]ДЕШЁФФКА,1606,0,0,1,1,0.0%,1h
51367,1,JAVIERA,1605,388,10,20,30,33.3%,2m
51368,2,Fabster,1604,142,7,9,16,43.8%,1h
51368,3,ProkPRG,1604,0,0,1,1,0.0%,10m
51370,3,gabipro,1603,0,0,3,3,0.0%,1h
51371,1,francesco,1602,1750,78,115,193,40.4%,1h
51371,2,Jacobie,1602,414,16,19,35,45.7%,29m
51371,1,[Cancro]NightMareCPU,1602,214,4,12,16,25.0%,1h
51371,3,Arseniy,1602,128,4,16,20,20.0%,31m
51371,3,DUBRAVKO,1602,0,0,2,2,0.0%,1h
51371,2,Rajko,1602,0,0,12,12,0.0%,1h
51377,2,Manos,1601,1256,71,107,178,39.9%,2m
51377,1,Cale,1601,525,31,47,78,39.7%,1h
51377,1,TaUrUsXXL,1601,430,12,24,36,33.3%,1h
51377,1,Nirvanko,1601,0,3,5,8,37.5%,11m
51377,1,Rizon,1601,179,3,21,24,12.5%,1h
51377,2,jorgeras,1601,92,2,5,7,28.6%,29m
51377,3,Sergei,1601,0,0,3,3,0.0%,1h
51384,1,papyrus,1600,181,4,18,22,18.2%,6m
51384,3,BlaCkCruNk,1600,58,3,10,13,23.1%,34m
51384,1,viki,1600,139,2,8,10,20.0%,34m
51384,3,IceEnigma,1600,0,1,0,1,100.0%,1h
51384,2,GDRAGONS,1600,32,1,6,7,14.3%,4m
51384,3,[DERMID]MYAGKII,1600,0,0,1,1,0.0%,31m
51384,3,[SEBULA]mixedmix,1600,0,0,4,4,0.0%,1h
51384,2,incaff,1600,0,0,11,11,0.0%,1h
51392,1,SilentSword,1599,340,8,21,29,27.6%,1h
51392,3,Drazi,1599,242,7,23,30,23.3%,1h
51392,1,JayDzei,1599,97,3,11,14,21.4%,29m
51392,2,robotninga,1599,0,0,1,1,0.0%,20m
51392,2,Damian,1599,0,0,11,11,0.0%,35m
51397,1,YuG,1598,729,20,35,55,36.4%,11m
51397,1,LilleFlamme,1598,44,1,5,6,16.7%,34m
51399,2,[BSG19]tiziano,1597,148,5,9,14,35.7%,30m
51399,2,Vadrugir,1597,36,3,11,14,21.4%,22m
51399,2,Dimich,1597,0,0,1,1,0.0%,1h
51399,3,Brunix,1597,0,0,11,11,0.0%,1h
51403,2,AlvaroNinja,1596,76,2,5,7,28.6%,31m
51403,2,[NLLO]Alexoss,1596,40,1,3,4,25.0%,1h
51405,2,KVNG,1595,1077,88,219,307,28.7%,1h
51405,2,[JaDiJo]Diegotecno,1595,70,3,3,6,50.0%,1h
51407,2,cleanerbosch,1594,902,30,54,84,35.7%,6m
51407,2,max,1594,146,4,10,14,28.6%,1h
51407,3,Snupx,1594,36,2,4,6,33.3%,1h
51407,1,mariad,1594,46,2,16,18,11.1%,21m
51411,1,Cøteaz,1593,165,2,11,13,15.4%,4m
51411,2,azazel,1593,0,1,0,1,100.0%,1h
51413,2,panic,1592,226,13,29,42,31.0%,23m
51413,1,flevour,1592,217,6,12,18,33.3%,29m
51413,2,silkr,1592,74,2,1,3,66.7%,19m
51413,1,Apollonius,1592,124,2,14,16,12.5%,34m
51413,3,fataморгана,1592,0,1,1,2,50.0%,13m
51418,2,PurmanSA,1591,110,2,8,10,20.0%,31m
51418,3,CrustyCrab,1591,58,2,13,15,13.3%,13m
51418,3,Garfield,1591,0,0,1,1,0.0%,28m
51418,2,[Ph1GM]BlindFOX,1591,0,0,2,2,0.0%,1h
51422,1,Oprichnik,1590,296,7,16,23,30.4%,13m
51422,1,GACELA,1590,96,1,5,6,16.7%,8m
51422,2,tom,1590,42,1,11,12,8.3%,35m
51425,1,DouglasW,1589,1714,247,377,624,39.6%,9m
51425,3,ExodiiaK,1589,80,2,14,16,12.5%,1h
51427,1,Jack,1588,939,30,41,71,42.3%,1h
51427,2,tirsus,1588,622,20,29,49,40.8%,35m
51427,2,Ghost,1588,202,8,10,18,44.4%,1h
51427,2,kerim,1588,72,4,8,12,33.3%,1h
51431,3,Math,1587,1484,114,188,302,37.7%,1h
51431,3,Asiya,1587,1467,56,86,142,39.4%,14m
51431,1,Anz,1587,955,28,41,69,40.6%,13m
51431,2,BeardStone,1587,148,2,9,11,18.2%,1h
51431,3,WildChessRu,1587,0,0,1,1,0.0%,1h
51436,2,AlphaEngine,1586,114,5,10,15,33.3%,1h
51436,2,DrunkPanda,1586,135,4,7,11,36.4%,29m
51436,3,[oooboy]вадим,1586,0,0,6,6,0.0%,1h
51439,2,face,1585,448,13,32,45,28.9%,31m
51439,2,Macika,1585,157,3,8,11,27.3%,1h
51439,2,Artem,1585,0,1,1,2,50.0%,1h
51442,2,BlueSystem,1584,250,7,12,19,36.8%,1h
51442,2,Anderson,1584,0,1,8,9,11.1%,2m
51442,2,DACO,1584,0,0,2,2,0.0%,22m
51445,1,[DECIMA]Dragon,1583,1110,37,63,100,37.0%,2m
51445,2,DemOnLorD,1583,288,10,17,27,37.0%,23m
51445,2,[CAI]Clem,1583,148,4,9,13,30.8%,1h
51445,2,[TXRio7]Erik,1583,46,2,1,3,66.7%,6m
51445,2,StreetKid,1583,42,1,2,3,33.3%,31m
51445,2,Taliodent,1583,0,1,5,6,16.7%,20m
51445,3,Lev,1583,0,0,2,2,0.0%,1h
51445,2,xan,1583,0,0,2,2,0.0%,1h
51453,1,Jerome,1582,1630,81,133,214,37.9%,19m
51453,2,DRAKON,1582,1557,53,74,127,41.7%,1h
51453,2,PeterPan,1582,258,8,9,17,47.1%,6m
51456,2,DOUDA,1581,900,27,62,89,30.3%,4m
51456,2,MASTER,1581,297,7,15,22,31.8%,1h
51456,2,[xcczc]БАРС,1581,222,6,8,14,42.9%,1h
51456,3,hari,1581,86,3,6,9,33.3%,1h
51456,3,alexfrise,1581,0,0,1,1,0.0%,1h
51461,1,Xorgx,1580,529,16,35,51,31.4%,9m
51461,3,lihetavi,1580,30,2,2,4,50.0%,29m
51461,3,Lumpus,1580,0,0,1,1,0.0%,1h
51461,2,[Harley]AlexS,1580,0,0,2,2,0.0%,1h
51465,3,Online,1579,234,9,12,21,42.9%,34m
51465,2,Hunter,1579,58,3,1,4,75.0%,1h
51467,2,MegaDude,1578,30,2,4,6,33.3%,1h
51467,2,MazalBoy,1578,62,2,14,16,12.5%,1h
51467,3,[woron]Троцкий,1578,0,0,1,1,0.0%,1h
51470,2,deathcore,1577,30,1,1,2,50.0%,1h
51470,3,[VoidSa]DEMON,1577,0,0,1,1,0.0%,1h
51472,2,Gighen,1576,640,21,48,69,30.4%,1h
51472,1,Max,1576,248,8,16,24,33.3%,6m
51474,1,[SPAINs]Aimarace,1575,721,26,33,59,44.1%,7m
51474,1,[1NFEC7]Kish,1575,534,14,27,41,34.1%,1h
51474,2,[21789]JoshuaM,1575,30,1,1,2,50.0%,1h
51474,1,KAPPO,1575,0,1,18,19,5.3%,13m
51478,1,EgJedi,1574,1550,47,87,134,35.1%,1h
51478,3,Ega,1574,0,1,0,1,100.0%,31m
51478,2,РусLan,1574,0,0,1,1,0.0%,1h
51478,2,Hellius,1574,0,0,1,1,0.0%,1h
51478,2,[WIN10]RAMBO,1574,73,0,7,7,0.0%,1h
51483,2,Gorynych,1573,364,11,21,32,34.4%,20m
51483,2,Kolonel,1573,88,4,18,22,18.2%,31m
51483,2,stefan,1573,44,1,5,6,16.7%,1h
51483,3,ҪąƞƞǫƞCLOWN,1573,0,0,1,1,0.0%,1h
51487,1,nemox,1572,1805,185,297,482,38.4%,1h
51487,1,Sigma,1572,756,26,39,65,40.0%,29m
51487,3,matthias,1572,262,8,29,37,21.6%,27m
51487,2,PLLacek,1572,226,5,22,27,18.5%,4m
51487,3,motodoshi,1572,55,2,6,8,25.0%,18m
51492,2,SonD,1571,817,25,36,61,41.0%,31m
51492,3,starlove,1571,34,1,15,16,6.2%,10m
51492,3,MIRO,1571,0,0,1,1,0.0%,1h
51492,3,PSYCHIATRIST,1571,0,0,1,1,0.0%,31m
51492,3,RunRobot,1571,0,0,5,5,0.0%,1h
51497,2,johnrex,1570,1275,62,129,191,32.5%,1h
51497,1,SternenNinja,1570,185,6,12,18,33.3%,20m
51497,2,[Leffe]koffen,1570,187,5,3,8,62.5%,1h
51500,2,MMD,1569,1002,32,47,79,40.5%,1h
51500,2,Markos,1569,624,19,35,54,35.2%,1h
51500,2,совфор,1569,73,0,2,2,0.0%,31m
51500,3,Snuskgreger,1569,0,0,5,5,0.0%,1h
51504,2,Nivroc,1568,186,3,9,12,25.0%,1h
51504,1,гонзик,1568,86,3,20,23,13.0%,33m
51504,2,JamesRaynor,1568,0,1,1,2,50.0%,1h
51507,2,gin,1567,0,0,3,3,0.0%,1h
51508,2,MrMaximus,1566,0,0,1,1,0.0%,29m
51509,1,ruslan,1565,412,11,26,37,29.7%,13m
51509,2,Asheras,1565,170,6,8,14,42.9%,1h
51509,1,joeski,1565,206,6,14,20,30.0%,20m
51512,1,jhb,1564,1773,93,134,227,41.0%,31m
51512,2,sisturix,1564,128,5,12,17,29.4%,31m
51512,2,timeglitcher,1564,78,3,11,14,21.4%,1h
51512,3,bikinilord,1564,0,0,5,5,0.0%,14m
51516,2,tcp,1563,36,2,3,5,40.0%,1h
51516,2,Nowator,1563,0,1,1,2,50.0%,1h
51518,2,LackofRex,1562,73,1,1,2,50.0%,20m
51518,3,twistedi,1562,0,0,2,2,0.0%,1h
51520,2,Zurabob,1561,197,10,30,40,25.0%,2m
51521,2,sssssssss,1560,356,14,19,33,42.4%,31m
51521,2,kokalos,1560,142,2,17,19,10.5%,1h
51521,2,porrnstar,1560,0,0,1,1,0.0%,1h
51521,3,Disturbed,1560,0,0,5,5,0.0%,18m
51525,1,lachin,1559,424,13,30,43,30.2%,1h
51525,1,Altheas,1559,162,4,13,17,23.5%,1h
51525,2,APT,1559,0,0,1,1,0.0%,2m
51528,1,RYP,1558,1608,63,107,170,37.1%,1h
51528,2,Costel,1558,156,4,7,11,36.4%,1h
51530,2,lesha,1557,415,12,22,34,35.3%,31m
51530,2,Butch,1557,0,1,5,6,16.7%,1h
51530,2,EbsStaRR,1557,0,0,5,5,0.0%,6m
51533,3,nerveg,1556,126,5,16,21,23.8%,1h
51533,2,Artemexe,1556,102,5,24,29,17.2%,1h
51533,2,deutschland,1556,0,0,1,1,0.0%,6m
51533,2,siriuss,1556,0,0,3,3,0.0%,29m
51537,3,makc,1555,0,0,2,2,0.0%,31m
51537,2,WMB,1555,0,0,4,4,0.0%,1h
51537,1,NET,1555,73,0,13,13,0.0%,3m
51540,2,JonnyD,1554,460,13,29,42,31.0%,35m
51540,2,Alex,1554,46,2,1,3,66.7%,1h
51540,2,ЗлаяБронза,1554,0,0,1,1,0.0%,1h
51540,2,Hemme,1554,0,0,1,1,0.0%,31m
51544,1,Phenex,1553,899,39,78,117,33.3%,35m
51544,2,Zveky,1553,256,8,17,25,32.0%,8m
51544,1,rockperu,1553,248,7,29,36,19.4%,9m
51547,2,SAIX,1552,693,23,34,57,40.4%,14m
51547,3,Zero,1552,30,4,2,6,66.7%,1h
51547,3,Chris,1552,124,3,15,18,16.7%,19m
51550,1,TUĞRANLI,1551,86,2,14,16,12.5%,1h
51550,3,[HCrab]HelloJenkis,1551,0,0,1,1,0.0%,1h
51552,1,Brags,1550,848,25,46,71,35.2%,6m
51552,2,meneldil,1550,0,1,13,14,7.1%,5m
51554,1,FACE,1549,540,17,40,57,29.8%,1h
51554,2,gter,1549,62,3,3,6,50.0%,1h
51554,2,Mago,1549,0,0,2,2,0.0%,1h
51557,1,asht,1548,1033,59,108,167,35.3%,1h
51557,1,[P0683]Bigboz,1548,1488,51,83,134,38.1%,1h
51557,2,MageCZE,1548,371,14,25,39,35.9%,1h
51557,2,Ggamnol,1548,294,6,20,26,23.1%,31m
51557,2,[ShDg]Steigen,1548,30,2,6,8,25.0%,20m
51562,3,zandwitch,1547,144,8,12,20,40.0%,7m
51562,3,Tomcat,1547,0,2,7,9,22.2%,1h
51562,2,alex,1547,0,0,1,1,0.0%,2m
51565,1,jgueabr,1546,260,9,22,31,29.0%,1h
51565,2,Aldo,1546,134,4,10,14,28.6%,32m
51565,2,Cosmodesant,1546,0,0,3,3,0.0%,1h
51568,1,ROC,1545,1391,43,81,124,34.7%,1h
51568,2,HACHE,1545,154,5,24,29,17.2%,1h
51568,3,Justin,1545,142,4,14,18,22.2%,1h
51568,2,Ares,1545,98,3,5,8,37.5%,20m
51572,2,ДТРОН,1544,552,17,37,54,31.5%,29m
51572,2,manson,1544,141,3,13,16,18.8%,31m
51572,3,Sparviero,1544,30,1,6,7,14.3%,1h
51575,2,kod,1543,1621,74,131,205,36.1%,1h
51575,2,Numengaard,1543,304,8,26,34,23.5%,5m
51575,1,Yami,1543,284,6,21,27,22.2%,1h
51575,1,qwerty,1543,84,2,11,13,15.4%,34m
51575,2,Laz,1543,30,1,1,2,50.0%,1h
51575,1,kaminoite,1543,40,1,9,10,10.0%,31m
51581,2,GeneralF,1542,1245,41,63,104,39.4%,6m
51581,1,Gudmen,1542,152,5,24,29,17.2%,3m
51581,2,Mafiaboss,1542,189,4,9,13,30.8%,1h
51584,2,PHOENIX,1541,760,70,136,206,34.0%,20m
51584,2,NickBald,1541,840,28,43,71,39.4%,35m
51584,2,[ANREN]Stalex,1541,154,4,5,9,44.4%,1h
51587,2,Verrez,1540,289,8,19,27,29.6%,4m
51587,2,joseantonio,1540,0,0,2,2,0.0%,6m
51587,2,varrion,1540,0,0,7,7,0.0%,29m
51590,2,[Кумыс]Великолепный,1537,42,1,2,3,33.3%,2m
51590,2,[202068]Bartek,1537,36,1,4,5,20.0%,1h
51590,2,Плэктэр,1537,0,0,1,1,0.0%,35m
51593,2,Pakosky,1536,114,4,3,7,57.1%,1h
51593,2,MrVikis,1536,156,3,12,15,20.0%,1h
51593,1,[FR1]cuaterback,1536,139,2,16,18,11.1%,12m
51596,2,JEDREK,1535,628,21,33,54,38.9%,1h
51596,1,Miracle,1535,563,16,38,54,29.6%,1h
51596,1,aaaaaa,1535,426,10,32,42,23.8%,9m
51596,2,zeratul,1535,0,0,2,2,0.0%,1h
51600,2,[luchik]михмиханик,1534,232,6,10,16,37.5%,1h
51600,2,fiutek,1534,76,3,9,12,25.0%,1h
51600,2,MikeSauce,1534,0,2,5,7,28.6%,1h
51603,2,IlikeLoli,1533,1132,34,77,111,30.6%,1h
51603,1,Gashman,1533,500,12,31,43,27.9%,2m
51603,2,Tiberiu,1533,186,5,9,14,35.7%,6m
51603,2,ТошноВар,1533,58,3,3,6,50.0%,35m
51603,3,azrael,1533,0,0,3,3,0.0%,1h
51608,2,ChadKnom,1532,344,12,22,34,35.3%,23m
51608,1,омлет,1532,120,5,12,17,29.4%,14m
51608,2,dovchar,1532,126,3,7,10,30.0%,1h
51608,2,lilsandwich,1532,71,1,13,14,7.1%,1h
51608,2,BISMARK,1532,0,0,1,1,0.0%,1h
51613,1,morgan,1531,129,3,20,23,13.0%,6m
51613,1,Uwe,1531,0,1,5,6,16.7%,7m
51613,2,Tombstone,1531,0,0,1,1,0.0%,4m
51613,2,cygan,1531,0,0,3,3,0.0%,31m
51617,2,claude,1530,30,1,3,4,25.0%,29m
51617,3,RaketenKarli,1530,0,0,12,12,0.0%,1h
51619,1,[ANREN]Перун,1529,384,11,38,49,22.4%,9m
51619,3,Jesmago,1529,0,0,6,6,0.0%,34m
51621,2,KuBBaCZ,1528,158,5,5,10,50.0%,2m
51621,2,Fiveblaster,1528,30,2,2,4,50.0%,1h
51621,2,Илька,1528,30,1,4,5,20.0%,20m
51621,2,kirk,1528,0,1,9,10,10.0%,2m
51621,2,sole,1528,0,0,1,1,0.0%,1h
51621,2,Imperator,1528,0,0,2,2,0.0%,1h
51627,2,Fryc,1527,468,16,37,53,30.2%,1h
51627,1,cmvpolska,1527,496,13,37,50,26.0%,11m
51627,1,JOXIS,1527,184,6,11,17,35.3%,7m
51627,2,aniilashongo,1527,135,4,14,18,22.2%,20m
51627,2,Rabitrage,1527,147,1,12,13,7.7%,4m
51627,3,Kobrettie,1527,0,0,1,1,0.0%,1h
51627,2,HankyPanky,1527,0,0,2,2,0.0%,1h
51634,2,KingGrunn,1526,462,14,32,46,30.4%,5m
51634,2,Ninarts,1526,95,1,2,3,33.3%,5m
51634,3,Catato,1526,36,1,3,4,25.0%,16m
51634,2,Dony,1526,0,0,1,1,0.0%,1h
51634,2,deathgods,1526,73,0,4,4,0.0%,1h
51634,3,pedro,1526,0,0,11,11,0.0%,1h
51640,1,florian,1525,620,18,32,50,36.0%,2m
51640,2,EDUARDIK,1525,180,5,8,13,38.5%,1h
51640,2,Thaloon,1525,60,2,3,5,40.0%,1h
51640,2,AdamSith,1525,0,0,1,1,0.0%,12m
51644,2,[TESIL]IBUPROFENO,1524,436,14,19,33,42.4%,6m
51644,2,[ABDI]Dadane,1524,0,1,5,6,16.7%,1h
51644,2,gleb,1524,0,0,2,2,0.0%,1h
51647,2,carlosmiranm,1522,180,5,13,18,27.8%,20m
51648,3,Sid,1521,128,6,9,15,40.0%,34m
51648,2,BadMeetsEvil,1521,206,6,14,20,30.0%,1h
51648,3,ARHANGEL,1521,144,4,12,16,25.0%,29m
51648,2,УчусьИграть,1521,112,2,3,5,40.0%,1h
51648,2,Crysser,1521,30,1,14,15,6.7%,1h
51653,2,Viper,1520,30,1,2,3,33.3%,12m
51653,2,Marco,1520,0,0,2,2,0.0%,1h
51655,1,Chupi,1519,672,17,44,61,27.9%,1h
51655,2,Baahll,1519,96,4,15,19,21.1%,25m
51657,2,joginzhor,1518,306,9,26,35,25.7%,30m
51657,2,[kill2u]Hesusiasty,1518,30,1,7,8,12.5%,1h
51659,2,Лео,1517,223,5,21,26,19.2%,1h
51659,3,Mat,1517,48,1,17,18,5.6%,28m
51659,3,ulanovka,1517,0,0,1,1,0.0%,28m
51662,1,MetalBrain,1516,600,17,32,49,34.7%,6m
51662,2,TITAN,1516,0,0,1,1,0.0%,8m
51664,1,kjjjjjj,1515,832,24,62,86,27.9%,12m
51664,2,goalpepsi,1515,748,22,48,70,31.4%,19m
51666,2,КОННОР,1514,64,2,15,17,11.8%,1h
51666,1,[FIGHTR]Fatidic,1514,0,1,12,13,7.7%,36m
51668,1,Adrix,1513,1105,32,54,86,37.2%,11m
51668,2,Reaven,1513,38,2,16,18,11.1%,31m
51668,2,EasyAI,1513,0,0,5,5,0.0%,1h
51671,1,Jeff,1512,237,5,29,34,14.7%,20m
51671,2,AlicePopova,1512,30,1,2,3,33.3%,4m
51673,2,armageddon,1511,122,3,20,23,13.0%,14m
51674,2,RUPERTKING,1510,242,7,16,23,30.4%,2m
51674,2,[Famlly]FirezzBoyz,1510,130,4,5,9,44.4%,30m
51674,2,Bruckhausen,1510,44,2,0,2,100.0%,1h
51677,2,Hendrik,1509,932,33,63,96,34.4%,1h
51677,2,PrYaNik,1509,0,1,4,5,20.0%,1h
51677,2,Hikko,1509,0,0,1,1,0.0%,12m
51677,2,ЧудоГоблин,1509,0,0,1,1,0.0%,12m
51677,3,RawHide,1509,0,0,2,2,0.0%,1h
51682,2,Трор,1508,160,7,8,15,46.7%,1h
51682,2,Andrijan,1508,150,6,9,15,40.0%,8m
51682,2,www,1508,220,6,11,17,35.3%,20m
51682,1,smog,1508,220,6,32,38,15.8%,1h
51686,2,АлексейVDL,1507,308,9,26,35,25.7%,1h
51686,2,bobo,1507,134,4,5,9,44.4%,23m
51686,2,Physio,1507,0,1,1,2,50.0%,12m
51689,2,luktatinator,1506,478,14,33,47,29.8%,1h
51690,2,KenanD,1505,230,10,11,21,47.6%,1h
51691,2,MokkadEdE,1503,73,0,8,8,0.0%,20m
51692,2,TYWa,1501,694,22,40,62,35.5%,2m
51692,1,Devitor,1501,574,14,53,67,20.9%,1h
51692,2,jibi,1501,30,4,10,14,28.6%,17m
51695,2,HVXVI,1500,740,47,92,139,33.8%,1h
51695,2,[StarMA]sam,1500,1188,45,108,153,29.4%,23m
51695,2,IgorPrka,1500,1089,39,56,95,41.1%,1h
51695,2,hbhbh,1500,716,26,40,66,39.4%,1h
51695,1,ironfighter,1500,155,2,16,18,11.1%,1h
51695,3,Denis,1500,0,1,9,10,10.0%,14m
51695,2,Cicero,1500,73,0,2,2,0.0%,1h
51702,2,altervi,1499,346,11,40,51,21.6%,20m
51702,2,bobaegis,1499,195,4,6,10,40.0%,1h
51702,2,[1111]Dfyz,1499,66,3,18,21,14.3%,1h
51702,3,Obrubok,1499,30,1,17,18,5.6%,1h
51706,2,kpk,1498,420,12,28,40,30.0%,1h
51706,2,Zaqdoun,1498,0,0,1,1,0.0%,1h
51708,2,Degree,1497,294,10,26,36,27.8%,13m
51709,1,Батонимба,1496,0,1,8,9,11.1%,13m
51710,3,Yuriy,1495,86,3,4,7,42.9%,16m
51711,2,ronado,1494,188,4,7,11,36.4%,1h
51712,2,Michal,1493,0,4,1,5,80.0%,1h
51713,3,Tiberius,1492,0,0,5,5,0.0%,7m
51714,1,Андрей,1491,560,14,35,49,28.6%,7m
51714,2,SilentStorm,1491,0,0,6,6,0.0%,1h
51716,2,SVERIGE,1490,362,13,25,38,34.2%,1h
51717,3,DrizztDoForm,1489,30,2,2,4,50.0%,1h
51718,2,prinz,1484,1064,31,77,108,28.7%,31m
51718,1,[VEI]seblom,1484,795,25,41,66,37.9%,3m
51720,1,trickyhunter,1483,697,18,51,69,26.1%,1h
51720,1,Tomawak,1483,578,17,34,51,33.3%,1h
51720,2,VaskecarSRB,1483,270,9,7,16,56.2%,1h
51720,2,Ars,1483,88,3,14,17,17.6%,20m
51720,2,NitramGA,1483,73,0,2,2,0.0%,1h
51725,2,goose,1482,162,5,14,19,26.3%,1h
51725,2,кирилл,1482,40,1,2,3,33.3%,1h
51725,2,Adrian,1482,0,0,4,4,0.0%,8m
51728,3,llGhostDogll,1479,134,4,19,23,17.4%,1h
51728,2,puxxxe,1479,92,3,9,12,25.0%,20m
51730,2,Boose,1476,104,3,22,25,12.0%,1h
51730,2,trao,1476,0,1,1,2,50.0%,23m
51732,3,ITO,1475,1402,50,151,201,24.9%,4m
51732,2,[kek34]рассия,1475,0,0,1,1,0.0%,1h
51734,2,kazak,1473,116,1,16,17,5.9%,1h
51734,3,Pninja,1473,0,0,2,2,0.0%,16m
51736,2,mortanius,1471,30,1,16,17,5.9%,18m
51737,2,super,1470,127,9,17,26,34.6%,1h
51737,2,Метрокепочка,1470,0,0,3,3,0.0%,5m
51739,2,Treydor,1469,694,19,51,70,27.1%,8m
51740,2,ripgun,1468,1012,33,67,100,33.0%,1h
51740,3,LOGAN,1468,0,2,6,8,25.0%,1h
51740,3,Zephrenic,1468,0,0,5,5,0.0%,7m
51743,2,PoolShark,1467,334,9,29,38,23.7%,30m
51743,2,ItayR,1467,83,3,13,16,18.8%,6m
51743,2,mattrac,1467,157,3,24,27,11.1%,1h
51743,3,Corbo,1467,0,0,8,8,0.0%,1h
51747,2,Wmonster,1466,430,13,22,35,37.1%,1h
51747,2,TicTac,1466,48,2,6,8,25.0%,8m
51749,2,Carreiro,1465,102,2,10,12,16.7%,1h
51750,1,Eyetech,1464,246,9,21,30,30.0%,9m
51750,2,LanderZX,1464,220,7,18,25,28.0%,1h
51752,2,[45IQ]DRED,1463,296,11,7,18,61.1%,1h
51752,3,dominik,1463,0,2,4,6,33.3%,1h
51752,3,Lamback,1463,0,1,6,7,14.3%,1h
51755,2,TRONKO,1462,1583,71,198,269,26.4%,1h
51755,2,WILL,1462,199,6,8,14,42.9%,1h
51755,2,Daeliavan,1462,271,6,19,25,24.0%,1h
51758,3,Luffygames,1461,176,8,10,18,44.4%,1h
51759,1,victor,1459,94,4,20,24,16.7%,15m
51759,3,TZec,1459,0,2,9,11,18.2%,15m
51759,2,AmsterDan,1459,0,1,4,5,20.0%,1h
51762,2,adamaitiss,1458,98,1,7,8,12.5%,23m
51763,2,Gamsi,1456,377,10,26,36,27.8%,1h
51764,2,SHLA,1455,1184,33,64,97,34.0%,14m
51764,1,[KoSII]XIPHIOIDES,1455,271,10,25,35,28.6%,11m
51764,3,Liao,1455,0,0,5,5,0.0%,1h
51767,1,Davout,1454,1157,37,76,113,32.7%,5m
51767,2,aras,1454,88,2,3,5,40.0%,12m
51767,3,OSBORN,1454,0,0,10,10,0.0%,16m
51770,3,BAU,1453,302,11,20,31,35.5%,1h
51770,3,Speda,1453,30,1,5,6,16.7%,12m
51772,2,BGhosts,1452,1002,34,98,132,25.8%,1h
51772,3,akalexus,1452,228,7,10,17,41.2%,19m
51774,2,Khary,1451,66,3,11,14,21.4%,1h
51774,3,[23ewf]Hochlord,1451,0,0,1,1,0.0%,1h
51774,3,Mino,1451,0,0,8,8,0.0%,7m
51777,2,Killer,1449,344,10,22,32,31.2%,23m
51777,2,dieDose,1449,0,2,7,9,22.2%,29m
51779,3,[JOG]Shiiggyy,1448,46,2,2,4,50.0%,1h
51780,2,banboux,1447,1477,219,439,658,33.3%,1h
51781,2,franksch,1446,88,1,17,18,5.6%,34m
51781,3,Gorjeck,1446,0,0,5,5,0.0%,12m
51783,3,карлисончик,1444,0,0,3,3,0.0%,14m
51784,1,DagoSK,1443,90,3,21,24,12.5%,1h
51784,3,Condor,1443,52,2,19,21,9.5%,33m
51784,3,Lenox,1443,0,0,1,1,0.0%,16m
51784,2,ase,1443,0,0,5,5,0.0%,1h
51788,2,[7STAR]Prejudice,1442,1148,36,78,114,31.6%,31m
51788,3,Печенка,1442,0,0,1,1,0.0%,1h
51790,1,malekarmen,1441,156,4,14,18,22.2%,1h
51790,2,sokol,1441,156,4,17,21,19.0%,1h
51790,3,Predator,1441,30,2,4,6,33.3%,12m
51790,3,NOOB,1441,0,0,1,1,0.0%,18m
51794,3,joblack,1440,0,1,2,3,33.3%,31m
51795,2,vital,1437,222,7,9,16,43.8%,23m
51795,2,Madsen,1437,251,5,22,27,18.5%,1h
51795,2,Kostya,1437,104,4,11,15,26.7%,1h
51798,2,francois,1436,46,1,6,7,14.3%,29m
51799,2,Drek,1433,0,1,2,3,33.3%,23m
51799,1,MaSTerQ,1433,0,1,9,10,10.0%,34m
51801,2,Endymion,1432,887,28,48,76,36.8%,6m
51801,3,Aiur,1432,0,0,2,2,0.0%,18m
51803,1,DRAGONDAR,1431,98,4,19,23,17.4%,1h
51804,2,HelmutPerchu,1428,586,16,43,59,27.1%,6m
51805,2,[krotSC]jom,1427,214,6,15,21,28.6%,14m
51806,3,Deferasa,1426,0,0,1,1,0.0%,1h
51807,1,Xelaxo,1423,310,8,32,40,20.0%,26m
51808,3,Ttt,1422,0,1,4,5,20.0%,12m
51809,2,GhostDragon,1421,72,2,16,18,11.1%,1h
51810,2,Pacis,1420,552,18,34,52,34.6%,1h
51810,2,CrazyBoss,1420,260,7,23,30,23.3%,1h
51812,3,BREAD,1419,0,0,1,1,0.0%,1h
51812,2,Wraith,1419,0,0,5,5,0.0%,5m
51814,2,Модный,1418,94,4,14,18,22.2%,19m
51815,3,superstrike,1417,240,10,2,12,83.3%,12m
51816,3,campet,1415,58,2,4,6,33.3%,14m
51817,3,klingen,1414,0,0,1,1,0.0%,34m
51818,3,housten,1413,1088,31,88,119,26.1%,34m
51819,3,[прас]Dyus,1412,200,7,12,19,36.8%,1h
51820,1,mortecara,1410,224,8,21,29,27.6%,5m
51821,3,слава,1409,0,1,0,1,100.0%,18m
51821,3,Crsr,1409,0,0,2,2,0.0%,31m
51821,3,Snormossel,1409,0,0,3,3,0.0%,34m
51824,3,[Фаталя]тигрфортуны,1408,0,0,3,3,0.0%,1h
51825,3,davidrisko,1402,58,3,5,8,37.5%,1h
51825,3,SniperSander,1402,0,1,2,3,33.3%,1h
51825,3,Hichkok,1402,0,0,2,2,0.0%,31m
51828,3,Merlin,1401,476,21,10,31,67.7%,12m
51828,2,Arash,1401,434,21,45,66,31.8%,35m
51830,2,FloW,1399,30,2,20,22,9.1%,32m
51831,1,dalsecconiko,1397,60,2,9,11,18.2%,6m
51832,3,[Аоуэйя]pimousse,1396,100,4,7,11,36.4%,1h
51833,2,ANTIKILLERvs,1395,675,28,52,80,35.0%,8m
51833,2,Olga,1395,974,28,77,105,26.7%,20m
51833,3,Адвенчу,1395,48,1,3,4,25.0%,1h
51836,3,matcampi,1394,0,0,1,1,0.0%,12m
51837,1,MAryANC,1393,1067,44,84,128,34.4%,21m
51837,1,Mailis,1393,0,1,22,23,4.3%,6m
51837,3,[EnFi]HotBlueSky,1393,0,0,1,1,0.0%,1h
51840,2,LaserOptic,1391,266,5,25,30,16.7%,1h
51840,2,Rus,1391,30,3,11,14,21.4%,1h
51840,2,Meowkuu,1391,126,2,20,22,9.1%,1h
51840,3,Sanches,1391,0,0,5,5,0.0%,1h
51844,2,Meliodas,1389,444,12,38,50,24.0%,1h
51844,3,Turambar,1389,60,2,8,10,20.0%,1h
51846,3,Ernesto,1386,72,2,6,8,25.0%,1h
51847,2,Slapper,1383,44,3,9,12,25.0%,1h
51848,2,MeGaFuN,1382,30,1,9,10,10.0%,20m
51848,3,Gotfrid,1382,0,0,1,1,0.0%,12m
51850,3,ANCHAN,1380,314,10,30,40,25.0%,19m
51851,3,LoraGBG,1379,58,2,11,13,15.4%,16m
51851,3,azlaker,1379,0,0,4,4,0.0%,19m
51853,2,Silverdragon,1378,30,1,19,20,5.0%,1h
51854,3,[CREPES]PhiphiClash,1375,58,2,8,10,20.0%,1h
51855,3,[AgresU]Владимир,1374,0,0,1,1,0.0%,19m
51856,3,Marat,1372,125,2,17,19,10.5%,15m
51857,3,принц,1369,0,0,7,7,0.0%,18m
51858,2,Sunitrams,1368,234,7,31,38,18.4%,19m
51859,2,hansjee,1367,179,7,31,38,18.4%,1h
51860,2,frankpistac,1363,524,19,48,67,28.4%,29m
51861,3,Jurrow,1361,0,0,5,5,0.0%,1h
51862,3,qwest,1359,102,4,19,23,17.4%,1h
51862,3,Rollo,1359,30,2,6,8,25.0%,30m
51864,2,Leizergean,1358,64,2,20,22,9.1%,1h
51865,3,[CS0]harken,1357,30,1,6,7,14.3%,1h
51866,2,PETRO,1355,588,21,36,57,36.8%,1h
51867,2,loisttflowis,1354,131,2,23,25,8.0%,4m
51868,2,zana,1349,251,6,15,21,28.6%,29m
51869,2,FonKrain,1348,472,16,54,70,22.9%,35m
51869,3,gouzzy,1348,30,1,21,22,4.5%,1h
51871,2,Trollux,1346,223,4,26,30,13.3%,1h
51871,3,Ustas,1346,108,3,22,25,12.0%,1h
51873,3,[I1I]lilijj,1343,14,1,5,6,16.7%,1h
51874,1,Redevor,1342,1438,50,120,170,29.4%,33m
51874,3,feketelovag,1342,30,1,8,9,11.1%,7m
51876,3,LucTheTerror,1341,0,0,7,7,0.0%,1h
51877,1,[BuO]OmentumMajus,1339,854,90,182,272,33.1%,1h
51877,2,Troufignon,1339,202,4,29,33,12.1%,1h
51877,3,taharounalli,1339,58,2,4,6,33.3%,1h
51880,3,SeventyOne,1337,74,2,17,19,10.5%,7m
51880,3,Bertus,1337,30,1,4,5,20.0%,28m
51882,2,slslslslslsl,1332,0,0,16,16,0.0%,30m
51883,2,Nenve,1328,96,3,21,24,12.5%,4m
51884,3,KrzysiekPL,1324,110,3,10,13,23.1%,1h
51885,2,sever,1321,192,6,24,30,20.0%,6m
51886,3,Sosoturfu,1320,32,3,6,9,33.3%,14m
51887,2,EVE,1318,554,17,61,78,21.8%,1h
51888,2,spawn,1317,1253,114,248,362,31.5%,1h
51889,3,adelheit,1316,748,23,52,75,30.7%,7m
51890,1,Hróðvitnisso,1312,206,7,27,34,20.6%,13m
51891,2,MrChe,1308,895,24,77,101,23.8%,12m
51892,3,Tachannnnnn,1302,30,2,8,10,20.0%,1h
51893,2,ozymandias,1300,254,8,30,38,21.1%,1h
51894,2,[VOVA]TonyStark,1298,30,4,20,24,16.7%,20m
51895,3,Bastian,1297,176,5,18,23,21.7%,1h
51896,1,meepmeep,1291,1056,67,139,206,32.5%,13m
51896,2,cyclohexane,1291,1072,31,93,124,25.0%,1h
51898,3,LilJacob,1287,0,2,6,8,25.0%,1h
51899,3,SolacoMan,1276,226,7,17,24,29.2%,1h
51900,2,ALPHAZEALOT,1270,1013,31,68,99,31.3%,1h
51900,3,bus,1270,432,13,35,48,27.1%,1h
51902,3,Spanner,1266,732,22,59,81,27.2%,1h
51903,1,[OKW1]ARES,1261,120,4,25,29,13.8%,1h
51904,3,silenstorm,1256,60,2,9,11,18.2%,10m
51905,2,Skywalker,1254,194,6,39,45,13.3%,1h
51906,3,GameOn,1251,242,7,38,45,15.6%,1h
51907,3,Triforce,1246,0,2,3,5,40.0%,1h
51908,2,Zedzed,1242,692,21,61,82,25.6%,1h
51909,1,[v8ZX7h]PATRON,1239,299,6,32,38,15.8%,17m
51910,2,vigan,1236,0,0,6,6,0.0%,1h
51911,3,CAYILO,1235,30,1,6,7,14.3%,7m
51912,3,Makar,1234,0,0,2,2,0.0%,31m
51913,3,Falciu,1231,30,1,8,9,11.1%,1h
51914,3,Pasman,1229,30,1,7,8,12.5%,1h
51915,1,Discount,1217,80,2,25,27,7.4%,1h
51916,1,knightrider,1215,109,1,24,25,4.0%,1h
51917,3,ALI,1212,100,3,6,9,33.3%,1h
51918,2,[Gregg]EscherBacon,1211,0,0,20,20,0.0%,34m
51919,3,Митяй,1209,0,0,23,23,0.0%,1h
51920,3,ShotInjectio,1207,116,5,18,23,21.7%,1h
51921,3,NUMERA,1205,0,0,1,1,0.0%,19m
51922,3,[Burla]Sebastijan,1203,125,8,35,43,18.6%,18m
51923,3,ĐENERALE,1185,104,3,22,25,12.0%,1h
51924,3,Allerdings,1183,0,0,6,6,0.0%,12m
51925,2,[Kicx]ƔiƦus,1180,836,318,386,704,45.2%,1h
51926,3,hitmanttv,1175,288,9,33,42,21.4%,1h
51927,3,Morgling,1164,0,0,1,1,0.0%,29m
51928,3,lupar,1152,60,3,22,25,12.0%,1h
51929,3,Samir,1139,505,24,107,131,18.3%,31m
51930,3,JudahPaul,1130,0,0,2,2,0.0%,1h
51931,3,BERAUDO,1117,30,2,18,20,10.0%,1h
51932,3,вайфочка,1111,36,2,11,13,15.4%,12m
51933,3,IIIIIIIIIIII,1083,244,8,31,39,20.5%,1h
51934,3,[LoTVPL]Sauron,1058,220,7,50,57,12.3%,1h
51935,3,Slangen,1055,58,2,5,7,28.6%,1h
51936,2,adminko,1053,218,7,40,47,14.9%,8m
51937,3,leif,1051,0,0,2,2,0.0%,12m
51938,3,APOLLO,806,0,0,26,26,0.0%,7m
