rank,tier,name,mmr,points,wins,losses,played,winrate,age
1,1,[ENCE]Serral,7424,2233,93,14,107,86.9%,4m
2,1,simphunter,7193,1296,28,5,33,84.8%,6m
3,1,IIIIIIIIIIII,6946,2868,94,36,130,72.3%,3m
4,1,[QLASH]Reynor,6932,240,5,3,8,62.5%,24m
5,1,[Lambro]Lambo,6913,4288,205,96,301,68.1%,3m
6,1,[xkom]AGOElazer,6837,96,3,0,3,100.0%,8m
7,1,Denver,6652,2203,178,102,280,63.6%,4m
8,1,PressDToWiN,6615,1485,86,46,132,65.2%,10m
9,1,[Ex0n]SouLeer,6508,3355,106,56,162,65.4%,3m
10,1,Ronaldinho,6499,48,2,0,2,100.0%,10m
11,1,GOStephano,6494,1698,110,66,176,62.5%,3m
12,1,[b100sc]Vanya,6490,505,9,10,19,47.4%,3m
13,1,[ArGGEU]SortOf,6466,1954,53,30,83,63.9%,20m
14,1,[Potati]MrPotato,6458,1223,49,22,71,69.0%,25m
15,1,БогданКозар,6439,1008,21,10,31,67.7%,12m
16,1,[Wooky]HateMe,6390,288,7,9,16,43.8%,9m
17,1,[AIB]BlyOnFire,6365,1934,48,43,91,52.7%,3m
18,1,[CSN]TLO,6332,2146,137,105,242,56.6%,20m
19,1,[PSISTM]Namshar,6303,2275,110,88,198,55.6%,38m
20,1,llllllllllll,6301,48,2,0,2,100.0%,16m
21,1,IIIIIIIIIIII,6285,48,1,2,3,33.3%,12m
22,1,llllllllllll,6272,240,6,4,10,60.0%,38m
23,1,[Ex0n]Cham,6231,0,1,0,1,100.0%,20m
24,1,IIIIIIIIIIII,6212,432,10,7,17,58.8%,24m
25,1,Marmeladka,6210,96,3,4,7,42.9%,24m
26,1,[3Dǃ]ƎDǃBee,6201,2060,96,80,176,54.5%,4m
27,1,IIIIIIIIIIII,6195,554,116,49,165,70.3%,16m
28,1,[lMMl]PuPu,6141,908,20,7,27,74.1%,6m
29,1,[Цвет]ПесняРадуги,6134,240,5,6,11,45.5%,10m
30,1,[Gurson]GuruVirus,6128,0,1,0,1,100.0%,7m
31,1,[CS0]YoungYakov,6113,678,17,15,32,53.1%,3m
32,1,Euphoria,6095,768,17,4,21,81.0%,16m
33,1,IIIIIIIII,6087,3536,121,83,204,59.3%,3m
34,1,llllllllllll,6075,0,1,0,1,100.0%,8m
35,1,Laydown,6057,0,1,0,1,100.0%,12m
36,1,llllllllllll,6056,432,9,4,13,69.2%,10m
37,1,[ArGGEU]rotab,6053,3422,297,243,540,55.0%,3m
38,1,lIlIlIlIlIl,6048,0,1,0,1,100.0%,6m
39,1,[WTEu]DIMAGA,6044,3485,259,211,470,55.1%,3m
40,1,[3Dǃ]Basset,6033,1656,140,104,244,57.4%,24m
41,1,[DéKá]TomikuS,6020,0,1,0,1,100.0%,23m
42,1,EoliticK,5998,192,5,8,13,38.5%,24m
43,1,[Sarmat]Snoxtar,5980,358,21,0,21,100.0%,9m
44,1,LetItFlow,5957,459,29,34,63,46.0%,8m
45,1,IIIIIIIIIIII,5940,336,8,1,9,88.9%,10m
46,1,[SƬǂ]MaLiBu,5939,0,1,0,1,100.0%,6m
47,1,[0Team]RiSky,5923,432,10,13,23,43.5%,38m
48,1,[BRSKR]Spazymazy,5897,867,32,34,66,48.5%,38m
49,1,Erik,5891,3548,240,198,438,54.8%,3m
49,1,LiquidClem,5891,802,18,9,27,66.7%,6m
51,1,Mementomori,5864,48,1,5,6,16.7%,10m
52,1,[LamboF]OreoFan,5857,808,33,24,57,57.9%,4m
52,1,[n33b]PeterPan,5857,0,2,3,5,40.0%,6m
54,1,[KOVA]ZhuGeLiang,5853,1145,51,51,102,50.0%,7m
55,1,[Sarmat]Aristori,5852,340,27,6,33,81.8%,3m
56,1,ShoWTimE,5851,764,17,18,35,48.6%,24m
57,1,llllllllllll,5846,347,12,18,30,40.0%,9m
57,1,llllllllllll,5846,122,3,1,4,75.0%,3m
59,1,[IBeAŚI]Forescene,5833,1652,63,56,119,52.9%,7m
60,1,[ArGGEU]SoulSpirit,5829,1434,147,58,205,71.7%,14m
61,1,guapo,5827,875,35,34,69,50.7%,3m
62,1,[ReZero]Echidna,5826,2775,317,278,595,53.3%,3m
63,1,Yggdrasil,5821,478,11,7,18,61.1%,10m
64,1,SouLeer,5818,0,1,0,1,100.0%,8m
65,1,llllllllllll,5816,2389,225,186,411,54.7%,3m
66,1,Pororoca,5807,702,25,37,62,40.3%,23m
67,1,[xGenGx]Monogatari,5800,0,1,0,1,100.0%,10m
68,1,IIIIIIIIIIII,5797,3054,106,73,179,59.2%,3m
69,1,[сSсǃ]SKILLOUS,5792,3067,101,88,189,53.4%,3m
70,1,[DFgs]Shatsy,5784,0,0,1,1,0.0%,6m
71,1,MiNiMaTh,5783,430,10,10,20,50.0%,3m
72,1,[ePunks]Garitos,5777,3183,277,253,530,52.3%,3m
73,1,[OGTV]Baguette,5765,144,3,3,6,50.0%,9m
74,1,LeFaucheur,5758,624,13,22,35,37.1%,10m
74,1,[QTcIub]Beastyqt,5758,0,0,2,2,0.0%,14m
76,1,[GXalpH]nerfHydra,5748,430,10,3,13,76.9%,24m
77,1,Trifax,5746,2918,133,114,247,53.8%,3m
78,1,Canwillmust,5742,3105,199,177,376,52.9%,3m
78,1,Jhon,5742,0,1,0,1,100.0%,12m
80,1,[CJIABA]MEDOED,5724,614,13,16,29,44.8%,10m
81,1,[HBGS]Nikich,5721,3024,127,109,236,53.8%,3m
82,1,IIIIIIIIIIII,5716,616,14,7,21,66.7%,9m
83,1,[HBGS]Minatoeh,5714,1137,48,31,79,60.8%,7m
84,1,llllllllllll,5695,1127,61,40,101,60.4%,10m
85,1,llllllllllll,5682,0,0,1,1,0.0%,23m
85,1,IllllIIllllI,5682,0,0,1,1,0.0%,38m
87,1,llllllllllll,5681,85,2,7,9,22.2%,9m
88,1,Hydra,5672,192,4,4,8,50.0%,25m
89,1,[FrostG]Mixu,5670,144,4,2,6,66.7%,9m
89,1,Nyu,5670,94,3,4,7,42.9%,10m
91,1,sYz,5668,3169,452,390,842,53.7%,3m
92,1,[WinX]Progamer,5664,747,30,22,52,57.7%,3m
93,1,[Bonj]Dehin,5658,190,4,2,6,66.7%,38m
94,1,IIIIIIIIII,5651,0,1,0,1,100.0%,4m
95,1,[CocoCo]SradeLife,5649,673,26,12,38,68.4%,24m
96,1,[RGAN]Railgan,5647,1941,56,57,113,49.6%,3m
97,1,[αX]hinO,5640,2659,83,67,150,55.3%,3m
98,1,[PÂRłAH]Argon,5633,1448,114,114,228,50.0%,25m
99,1,llllllllllll,5632,1357,116,84,200,58.0%,38m
100,1,[5minGG]Twelfpoolt,5631,140,3,7,10,30.0%,38m
101,1,Mutahard,5622,378,9,3,12,75.0%,10m
102,1,[PÂRłAH]Nolimit,5621,2304,74,78,152,48.7%,3m
103,1,llllllllllll,5619,0,1,1,2,50.0%,6m
104,1,IIIIIIIIIIII,5613,96,2,1,3,66.7%,12m
105,1,BlondeJoseph,5611,2952,113,98,211,53.6%,3m
106,1,IIIllIIIllII,5609,520,11,6,17,64.7%,10m
107,1,Dreynaren,5608,3328,541,457,998,54.2%,3m
108,1,Lyrk,5606,1096,43,32,75,57.3%,3m
108,1,[Twytch]Annykiller,5606,924,37,28,65,56.9%,23m
108,1,[ArGGEU]AaRaSs,5606,566,12,10,22,54.5%,12m
111,1,[DemuCl]demuLarva,5605,2786,103,79,182,56.6%,3m
112,1,takoyaki,5602,318,8,0,8,100.0%,24m
113,1,Lalo,5599,236,6,7,13,46.2%,12m
114,1,syberia,5594,521,19,11,30,63.3%,20m
115,1,LilyPichu,5589,785,33,20,53,62.3%,10m
115,1,DOMINATOR,5589,476,11,6,17,64.7%,20m
115,1,React,5589,0,0,1,1,0.0%,23m
118,1,IlIlIlIlIlI,5588,1096,24,28,52,46.2%,12m
119,1,[HBeS]ibimsJDfan,5587,2132,100,73,173,57.8%,20m
120,1,Megunor,5580,328,7,7,14,50.0%,24m
121,1,XixaLover,5578,295,12,18,30,40.0%,14m
121,1,yuese,5578,334,8,5,13,61.5%,8m
123,1,[ÆR]Freeman,5572,526,12,9,21,57.1%,20m
123,1,[DRGno1]LobsterBrain,5572,96,3,1,4,75.0%,6m
125,1,[TSVB]Aelith,5570,192,4,1,5,80.0%,6m
126,1,SpoilFortune,5568,446,16,14,30,53.3%,12m
127,1,[KOVA]Mixu,5567,860,30,34,64,46.9%,3m
128,1,[BRSKR]Fallenger,5565,1781,63,44,107,58.9%,3m
129,1,[KTF1]BastaLaPool,5560,0,1,0,1,100.0%,10m
130,1,robotikov,5558,355,10,16,26,38.5%,22m
131,1,[PÂRłAH]robotikov,5557,2006,56,45,101,55.4%,3m
132,1,llllllllllll,5555,336,8,2,10,80.0%,8m
132,1,IIIIIIIIIIII,5555,96,3,0,3,100.0%,14m
134,1,BumBleBee,5551,3230,175,153,328,53.4%,3m
135,1,[ArGGEU]ADIBOU,5550,476,17,16,33,51.5%,24m
135,1,[HBGS]Irbis,5550,0,0,2,2,0.0%,16m
137,1,IIIIIIIIIIII,5549,3042,193,192,385,50.1%,3m
137,1,[GoeS]Cammelot,5549,14,2,2,4,50.0%,23m
139,1,lIlIlIlIlIlI,5547,1643,64,62,126,50.8%,9m
140,1,[ØC]lapinou,5544,0,0,1,1,0.0%,24m
141,1,IIIIIIIIIIII,5542,1162,27,22,49,55.1%,10m
142,1,AsTeR,5537,0,1,0,1,100.0%,14m
142,1,ZERGLINGS,5537,0,1,0,1,100.0%,25m
144,1,IIIIIIIIIIII,5536,571,21,12,33,63.6%,12m
145,1,SunSet,5534,691,15,13,28,53.6%,3m
146,1,llllllllllll,5533,2651,404,294,698,57.9%,3m
147,1,IlIlIlllIIll,5530,748,42,1,43,97.7%,3m
148,1,llllIIIlllII,5526,48,1,4,5,20.0%,6m
149,1,Joker,5522,48,1,1,2,50.0%,4m
150,1,IlIlIlIlIlIl,5510,818,47,33,80,58.8%,12m
150,1,IIIIIIIIIIII,5510,412,18,12,30,60.0%,20m
152,1,[TDKpro]Yuzuru,5509,602,25,11,36,69.4%,8m
153,1,Marulord,5508,0,3,2,5,60.0%,4m
154,1,[BjwA]ReDPanDa,5507,0,1,3,4,25.0%,3m
155,1,[PLA2N]SakaR,5504,0,1,0,1,100.0%,6m
156,1,IIIIIIIIIIII,5502,347,10,11,21,47.6%,10m
157,1,[VFish]Aelith,5497,48,1,2,3,33.3%,10m
158,1,[KhalD]YoGo,5493,2636,329,301,630,52.2%,3m
158,1,[Ex0n]Srade,5493,1502,183,163,346,52.9%,10m
160,1,RataChepuda,5483,752,46,2,48,95.8%,3m
161,1,LiquidMaNa,5480,284,6,6,12,50.0%,8m
162,1,robotikov,5479,0,0,5,5,0.0%,16m
163,1,BongCloud,5475,0,1,0,1,100.0%,20m
163,1,Nerazim,5475,0,0,1,1,0.0%,10m
165,1,[Dw4rfs]HaNfy,5474,713,27,26,53,50.9%,3m
166,1,KiToO,5473,0,0,2,2,0.0%,12m
167,1,GYMAHOLIC,5469,0,1,2,3,33.3%,4m
168,1,[Ex0n]StekepaNNe,5467,1991,171,158,329,52.0%,14m
168,1,Taci,5467,144,4,2,6,66.7%,20m
168,1,[ICGl]Össy,5467,0,1,0,1,100.0%,12m
171,1,IIIIIIIIIIII,5465,851,33,41,74,44.6%,23m
172,1,IIIIIIIIII,5461,2463,175,127,302,57.9%,13m
173,1,Mumpitz,5458,528,15,15,30,50.0%,25m
174,1,IIIIIlIIlIII,5453,458,10,12,22,45.5%,20m
175,1,[PŖïMĄŁ]Dronehard,5450,1221,44,39,83,53.0%,38m
176,1,HabiboBaggin,5449,0,0,1,1,0.0%,9m
177,1,[сSсǃ]memOryfreak,5443,1894,76,77,153,49.7%,9m
178,1,Partygandalf,5442,0,0,3,3,0.0%,4m
179,1,LllllJllllD,5439,220,5,7,12,41.7%,20m
180,1,[Oath]DasDuelon,5438,2279,108,93,201,53.7%,20m
181,1,Brenda,5435,48,2,4,6,33.3%,25m
181,1,Entropic,5435,0,0,1,1,0.0%,23m
183,1,Korone,5434,144,3,4,7,42.9%,10m
184,1,LOSER,5433,886,40,15,55,72.7%,20m
185,1,NameMeLegion,5428,2650,224,181,405,55.3%,38m
186,1,llllllllllll,5425,508,12,8,20,60.0%,23m
187,1,llllllllllll,5420,0,1,0,1,100.0%,25m
188,1,ZPR,5417,1675,70,58,128,54.7%,20m
189,1,Zythus,5414,0,0,1,1,0.0%,23m
190,1,[SqAUT]Tactyle,5413,1374,37,32,69,53.6%,13m
190,1,IIIIIIIIIII,5413,326,8,4,12,66.7%,20m
192,1,[foado]GoForBroke,5410,0,0,1,1,0.0%,3m
193,1,nxcharisma,5409,46,1,1,2,50.0%,12m
194,1,DrowRanger,5408,188,4,1,5,80.0%,8m
195,1,Creed,5407,1300,36,28,64,56.2%,23m
196,1,Blåapa,5401,2327,161,120,281,57.3%,8m
196,1,lIIIIllIIIIl,5401,94,3,0,3,100.0%,4m
198,1,RIPToss,5400,1546,262,234,496,52.8%,6m
199,1,[RnGpro]Prototype,5397,0,1,0,1,100.0%,23m
200,1,IIIIIIIIIIII,5396,0,0,1,1,0.0%,12m
201,1,[TROPBG]ZBelin,5388,96,2,4,6,33.3%,3m
201,1,TGS,5388,0,1,0,1,100.0%,6m
203,1,TKroos,5383,144,4,2,6,66.7%,13m
204,1,IIIIIIIIIII,5382,1902,58,49,107,54.2%,10m
205,1,Tiya,5381,1207,48,49,97,49.5%,20m
205,1,[РУИНА]Zodiachishe,5381,0,0,2,2,0.0%,3m
207,1,llllllllllll,5380,956,82,74,156,52.6%,23m
208,1,[PMǂ]Keiras,5378,3134,226,226,452,50.0%,6m
209,1,robotikov,5377,1036,25,16,41,61.0%,22m
210,1,[αX]Matiz,5375,2868,126,121,247,51.0%,10m
211,1,IIIIIIIIIIII,5373,0,0,2,2,0.0%,20m
212,1,IIIIIIIIIIII,5372,48,2,3,5,40.0%,38m
213,1,[IP5]mAth,5366,0,0,2,2,0.0%,20m
214,1,IIIIIIIIIIII,5360,1538,39,46,85,45.9%,9m
214,1,ZLATAN,5360,0,0,3,3,0.0%,6m
216,1,[ROOT]Mackintac,5359,718,17,19,36,47.2%,9m
217,1,[3Dǃ]SubZero,5355,322,7,5,12,58.3%,3m
218,1,[αX]Mamba,5353,1638,49,37,86,57.0%,10m
219,1,[CYG]Alpha,5350,2581,185,160,345,53.6%,9m
219,1,[αXi]Hyren,5350,2397,101,98,199,50.8%,12m
221,1,[TheDOH]Mathis,5349,1576,43,34,77,55.8%,12m
221,1,ZXCVZXCSDSD,5349,0,0,1,1,0.0%,12m
223,1,polskizyrg,5346,1660,40,48,88,45.5%,14m
224,1,DroneZzZ,5341,1887,95,86,181,52.5%,9m
225,1,[woahhh]KABOOMER,5332,236,6,3,9,66.7%,10m
226,1,[GoldM]Blackwidow,5328,1882,68,65,133,51.1%,9m
226,1,Nyjah,5328,48,1,4,5,20.0%,14m
228,1,Adrenaline,5327,1089,34,36,70,48.6%,7m
228,1,sLivko,5327,1234,30,38,68,44.1%,12m
230,1,[LIAR]pèredeDraigo,5326,0,0,1,1,0.0%,6m
231,1,[CRUX]Lancel,5325,1574,48,27,75,64.0%,7m
231,1,[Xa]azarot,5325,240,6,15,21,28.6%,8m
231,1,GameOfDrones,5325,190,5,4,9,55.6%,12m
234,1,IIIIIIIIIIII,5324,2939,351,337,688,51.0%,20m
234,1,[PŖïMĄŁ]Pico,5324,1735,54,39,93,58.1%,23m
234,1,Share,5324,860,26,13,39,66.7%,23m
237,1,ViBE,5323,48,2,0,2,100.0%,13m
238,1,llIlIIlllIIl,5321,1560,143,120,263,54.4%,13m
238,1,[αX]Rodzyn,5321,1042,26,28,54,48.1%,3m
240,1,[PLA2N]Ink,5318,2188,65,73,138,47.1%,8m
241,1,[xGenGx]NYK,5316,526,12,9,21,57.1%,20m
242,1,[aW]Papaours,5311,2751,122,114,236,51.7%,25m
242,2,[vgdunk]BEEGYOSHI,5311,94,4,6,10,40.0%,10m
242,1,Flood,5311,94,3,5,8,37.5%,10m
245,1,ZergKnight,5309,1508,100,76,176,56.8%,23m
245,1,Lucia,5309,190,4,11,15,26.7%,9m
245,1,[Hаsu]Shame,5309,136,3,3,6,50.0%,24m
248,1,[ArGGEU]Davbond,5307,3315,265,251,516,51.4%,10m
249,1,HânTattoo,5303,0,1,4,5,20.0%,9m
250,1,[UATeam]Grets,5300,2856,263,230,493,53.3%,6m
250,1,Vince,5300,254,22,14,36,61.1%,10m
252,1,[aW]MoOkaShade,5294,2545,148,142,290,51.0%,16m
253,1,OldBenoni,5292,1183,37,10,47,78.7%,12m
254,1,[PMǂ]nExt,5291,1098,29,24,53,54.7%,24m
255,1,[ReRise]JaKeN,5289,702,16,17,33,48.5%,12m
256,1,IIIIIIIIIIII,5282,144,3,9,12,25.0%,12m
257,1,llllllllllll,5277,48,1,1,2,50.0%,23m
258,1,Uchiha,5276,860,21,15,36,58.3%,20m
258,1,[boredx]NoobHunter,5276,0,0,1,1,0.0%,38m
260,1,mustiMONKEY,5271,866,23,17,40,57.5%,4m
261,1,IIIIIIIIIIII,5270,0,4,1,5,80.0%,6m
261,1,Jello,5270,180,4,3,7,57.1%,24m
263,1,[SFight]KisSame,5268,0,0,1,1,0.0%,9m
264,1,kel,5264,0,1,0,1,100.0%,4m
264,1,LeMiche,5264,44,1,3,4,25.0%,38m
266,1,IlllIIIIllll,5263,2208,186,175,361,51.5%,16m
267,1,TheCowboy,5261,2508,109,88,197,55.3%,38m
268,1,Adam,5260,335,17,18,35,48.6%,9m
269,1,[SquafN]PaCTom,5252,756,36,21,57,63.2%,20m
270,1,[GoldM]Zenith,5249,2983,217,218,435,49.9%,23m
270,1,Avekatten,5249,938,37,6,43,86.0%,12m
272,1,[RÐ]ElNathador,5248,452,11,1,12,91.7%,20m
272,1,shy,5248,490,11,25,36,30.6%,9m
272,1,[ÆR]Psz,5248,0,2,4,6,33.3%,24m
275,1,[Oath]SantaSam,5246,0,0,1,1,0.0%,22m
276,1,Goncourt,5245,1887,69,67,136,50.7%,24m
277,1,stakimaN,5243,418,10,9,19,52.6%,23m
278,1,zarmanpg,5242,3188,555,518,1073,51.7%,10m
279,1,SenseiKanye,5239,614,15,4,19,78.9%,4m
280,1,[PLA2N]Torasaki,5238,332,9,6,15,60.0%,23m
281,1,ÐuriaN,5237,1691,90,83,173,52.0%,23m
282,1,[VFN]IlIlIllIIlIl,5235,240,17,13,30,56.7%,9m
283,1,IIIIIIIIIIII,5234,0,0,1,1,0.0%,23m
284,1,llllllllllll,5233,2647,180,167,347,51.9%,20m
285,1,MasterMarine,5232,0,1,0,1,100.0%,13m
286,1,IIIIIIIIII,5229,94,2,1,3,66.7%,7m
286,1,[VFN]IIIlllIlIIl,5229,0,0,1,1,0.0%,13m
288,1,IlyaBrave,5226,2062,65,57,122,53.3%,10m
288,1,IIIIIIIIIIII,5226,254,8,8,16,50.0%,8m
290,1,Temperance,5224,1616,53,43,96,55.2%,10m
291,1,IIIIIIIIIIII,5223,48,2,0,2,100.0%,8m
292,1,[TheDOH]FightingFrog,5222,138,4,2,6,66.7%,12m
293,1,[Hаsu]IRoH,5221,1135,41,27,68,60.3%,14m
294,1,Europalle,5214,0,1,0,1,100.0%,9m
295,1,IIIIIIIIIIII,5212,1590,81,64,145,55.9%,24m
295,1,TLHarstem,5212,1178,34,24,58,58.6%,6m
295,1,IIIIIIIIIIII,5212,662,17,13,30,56.7%,6m
295,1,Yasuo,5212,274,6,4,10,60.0%,9m
299,1,[ĦRZ]Arbitter,5211,48,1,12,13,7.7%,9m
300,1,Brillenbär,5208,0,1,0,1,100.0%,13m
301,1,Nevermore,5205,1006,27,18,45,60.0%,24m
302,1,Scheuch,5203,432,34,37,71,47.9%,9m
302,1,[IndyK]LaussPompka,5203,834,21,12,33,63.6%,7m
304,1,[aW]Yuhmo,5200,1252,34,28,62,54.8%,13m
305,1,[LESeV]Össy,5195,1942,59,60,119,49.6%,22m
306,1,[3Dǃ]RusZerg,5193,388,11,9,20,55.0%,24m
307,1,IIIIIIIIIIll,5190,46,1,1,2,50.0%,21m
308,1,[PÂRłAH]Raddow,5187,1246,34,26,60,56.7%,13m
309,1,[ROOT]Bravery,5186,254,6,8,14,42.9%,9m
309,1,[MAFIAA]Kfry,5186,80,3,2,5,60.0%,6m
311,1,[GoldM]Axios,5184,2592,101,89,190,53.2%,8m
312,1,NapTime,5182,2667,627,564,1191,52.6%,22m
313,1,IIIIIIIIIIII,5181,1282,60,54,114,52.6%,9m
314,1,Niedźwiedź,5179,646,15,22,37,40.5%,13m
315,1,[3Dǃ]yoroshiku,5178,0,0,1,1,0.0%,9m
316,1,[Іаm]TheSenate,5177,0,1,0,1,100.0%,9m
317,1,IIlIIlIIlIIl,5175,2808,140,125,265,52.8%,10m
317,1,SanHolo,5175,430,10,7,17,58.8%,4m
319,1,[Нasu]upakowka,5174,48,3,3,6,50.0%,23m
320,1,MEMEME,5173,204,5,3,8,62.5%,14m
320,1,[Axi]CranK,5173,48,1,4,5,20.0%,23m
322,1,[LOGS]robotikov,5172,3133,172,146,318,54.1%,9m
322,1,Carnage,5172,0,0,1,1,0.0%,8m
324,1,[7x]Evgen,5169,1082,30,18,48,62.5%,23m
325,1,Faras,5168,2431,227,232,459,49.5%,20m
325,1,[404IQ]BsK,5168,2768,144,129,273,52.7%,8m
325,1,IIIIIIIIIIII,5168,92,3,0,3,100.0%,10m
328,1,starry,5166,2613,149,129,278,53.6%,9m
329,1,BeatrixKiddo,5165,516,49,3,52,94.2%,23m
329,1,llllllllllll,5165,376,11,7,18,61.1%,20m
331,1,Daloze,5162,1212,31,31,62,50.0%,10m
332,1,Grogu,5161,502,32,6,38,84.2%,10m
333,1,[HBGS]BravO,5160,0,1,0,1,100.0%,10m
334,1,[RavenZ]Frutiger,5155,820,23,15,38,60.5%,10m
334,1,Prebs,5155,220,7,6,13,53.8%,24m
336,1,[LOMZA]JonSnow,5154,272,6,2,8,75.0%,6m
337,1,IIIIIIIIIIII,5153,1508,45,43,88,51.1%,23m
338,1,[VFN]ZealotGoon,5148,1546,67,26,93,72.0%,9m
339,1,[aW]LIGHT,5146,2539,110,91,201,54.7%,10m
340,1,HappyZerG,5144,406,10,4,14,71.4%,22m
340,1,[MnrcK]Hirano,5144,0,1,0,1,100.0%,9m
342,1,smurf,5143,732,21,10,31,67.7%,21m
343,1,LGBTRights,5140,256,7,1,8,87.5%,7m
343,1,sad,5140,46,2,0,2,100.0%,38m
345,1,llllllllllll,5139,1036,28,19,47,59.6%,9m
346,1,Nuffy,5133,0,1,0,1,100.0%,6m
346,1,[NoGy]PaNkake,5133,0,0,1,1,0.0%,12m
348,1,KLC,5131,0,0,1,1,0.0%,7m
349,1,[Mkers]Mark,5130,1908,73,66,139,52.5%,9m
350,1,[QLASH]HellraiseR,5129,0,1,0,1,100.0%,10m
351,1,[Maegis]MoonRise,5127,48,1,1,2,50.0%,38m
352,1,TheTossEateR,5126,626,15,18,33,45.5%,23m
353,1,Ourk,5121,1940,68,59,127,53.5%,38m
353,1,[RAUDER]OmgHackerWOW,5121,178,5,2,7,71.4%,13m
355,1,Lauchzelot,5119,1086,29,20,49,59.2%,24m
356,1,AdAstra,5116,1172,31,30,61,50.8%,9m
357,1,kze,5114,1843,96,89,185,51.9%,3m
357,1,Imposter,5114,2039,62,76,138,44.9%,10m
359,1,Adrian,5113,0,0,1,1,0.0%,38m
360,1,[HBGS]Starfish,5112,3091,371,335,706,52.5%,20m
360,1,Borrex,5112,0,0,1,1,0.0%,22m
362,1,Jona,5111,1506,145,127,272,53.3%,9m
362,1,[сSсǃ]GunGFuBanDa,5111,472,11,13,24,45.8%,9m
364,1,[GoldM]Aeryeris,5108,1108,33,22,55,60.0%,24m
365,1,[Oath]Roon,5106,3191,445,424,869,51.2%,9m
366,1,LULU,5105,262,6,8,14,42.9%,24m
367,1,BlackBeast,5101,3161,225,219,444,50.7%,22m
367,3,llllllllllll,5101,0,3,1,4,75.0%,5m
367,1,[Blacer]Krystianer,5101,48,1,1,2,50.0%,7m
370,1,[aW]Oripe,5100,2767,163,152,315,51.7%,6m
371,1,Hunta,5099,1441,67,33,100,67.0%,21m
372,1,[lMMl]Mirzo,5098,3034,251,252,503,49.9%,13m
373,1,Tohru,5095,1172,33,41,74,44.6%,24m
373,1,[DAorDA]YESorYES,5095,86,3,3,6,50.0%,21m
373,1,[Trulli]ItzInvestor,5095,0,1,0,1,100.0%,6m
376,1,[Peeps]Neko,5090,3164,235,219,454,51.8%,10m
376,1,ShamveyG,5090,3080,218,211,429,50.8%,10m
376,1,BangFish,5090,548,16,10,26,61.5%,10m
376,1,TheilOo,5090,0,1,1,2,50.0%,24m
380,1,robotikov,5088,2270,80,67,147,54.4%,24m
380,1,[InBri]Munzerg,5088,0,0,1,1,0.0%,3m
382,1,Shuvi,5086,223,6,4,10,60.0%,13m
383,1,IIIIIIIIIIII,5085,0,0,2,2,0.0%,9m
384,1,[НТТ]San,5082,198,5,8,13,38.5%,10m
385,1,[αX]Damrud,5081,308,7,9,16,43.8%,6m
386,1,[K0mpis]whitefenix,5080,722,19,11,30,63.3%,9m
387,1,[NuF]Braunbär,5078,0,1,0,1,100.0%,3m
388,1,CARRIERS,5076,42,2,0,2,100.0%,23m
389,1,[IceUp]Gredu,5075,2753,263,240,503,52.3%,22m
390,1,[GAMI]YellowFox,5071,2229,103,96,199,51.8%,25m
390,1,[BFeS]SnoW,5071,0,0,1,1,0.0%,7m
392,1,bab,5070,2651,101,102,203,49.8%,22m
392,1,[HWA]Zerghamdi,5070,730,18,19,37,48.6%,24m
392,1,IlIIlIlIIlIl,5070,0,1,0,1,100.0%,22m
395,1,[foad]foad,5069,816,25,12,37,67.6%,14m
396,1,wwwwwwwvv,5068,774,19,21,40,47.5%,9m
397,1,IIIIIIIIIIII,5067,614,15,23,38,39.5%,9m
398,1,yeong,5065,1290,62,17,79,78.5%,3m
399,1,JakeÐðng,5063,48,2,1,3,66.7%,23m
400,1,[BFeS]Joel,5062,665,23,20,43,53.5%,22m
401,1,[LOMZA]ruthless,5061,1396,44,34,78,56.4%,13m
402,1,[Lowko]Lowko,5058,477,16,16,32,50.0%,10m
403,1,[ArGGEU]FrisK,5057,46,2,5,7,28.6%,14m
404,1,hasAdream,5056,0,0,1,1,0.0%,10m
405,1,[Trulli]Haru,5055,942,25,27,52,48.1%,6m
405,1,FireflyHugs,5055,92,2,4,6,33.3%,9m
407,1,[PŖïMĄŁ]CristoDorado,5052,3060,447,429,876,51.0%,23m
407,1,Suisei,5052,214,6,0,6,100.0%,9m
407,1,SergeantMeow,5052,94,2,3,5,40.0%,16m
410,1,Areanlid,5047,1348,199,183,382,52.1%,8m
411,1,[HBGS]Hushy,5046,868,24,23,47,51.1%,9m
412,1,[Invǂ]Davdou,5045,3109,369,367,736,50.1%,23m
413,1,imPLATonNA,5044,1193,59,18,77,76.6%,4m
414,1,MMRGrubber,5042,832,86,76,162,53.1%,24m
415,1,[Lambro]IBA,5040,3077,438,400,838,52.3%,9m
416,1,Hamood,5038,1501,53,41,94,56.4%,3m
417,1,Pixel,5036,560,14,12,26,53.8%,10m
417,1,SandwichPls,5036,0,0,3,3,0.0%,6m
419,1,[cSс]монеточка,5035,286,8,4,12,66.7%,12m
420,1,vippe,5033,0,1,0,1,100.0%,8m
421,1,[WBO]Mello,5031,856,23,18,41,56.1%,6m
422,1,[APER0]SmelC,5030,2840,140,137,277,50.5%,13m
422,1,[CYC]lllllIIIllll,5030,2038,71,66,137,51.8%,9m
424,1,llllllllllll,5029,2238,78,75,153,51.0%,8m
425,1,IIIIIIIIIIII,5028,1823,78,71,149,52.3%,6m
425,1,[aW]Eald,5028,0,0,2,2,0.0%,25m
427,1,GanjiMain,5027,302,8,5,13,61.5%,13m
428,1,[ArGGEU]BsK,5024,682,17,15,32,53.1%,24m
428,1,[TRotti]OpTiMiStC,5024,46,1,4,5,20.0%,21m
430,1,[3Dǃ]CASPER,5022,0,0,1,1,0.0%,8m
430,1,IlIlIlIlIlIl,5022,0,0,2,2,0.0%,22m
432,1,[GoldM]Aeryeris,5021,1432,47,32,79,59.5%,24m
432,1,[ArGGEU]JaCkal,5021,48,1,4,5,20.0%,12m
434,1,Progress,5020,0,0,1,1,0.0%,25m
435,1,Inarizaki,5019,2661,121,71,192,63.0%,38m
435,1,[LifeS]AspireBarcod,5019,0,1,0,1,100.0%,23m
437,1,likedontknow,5018,1101,53,50,103,51.5%,14m
437,1,[7x]Krash,5018,882,26,29,55,47.3%,25m
439,1,[3Dǃ]SunRise,5017,332,9,10,19,47.4%,20m
440,1,BattleMage,5016,30,6,0,6,100.0%,13m
441,1,Jibril,5015,178,6,1,7,85.7%,10m
441,1,[ǂnG]Cereal,5015,0,0,1,1,0.0%,4m
443,1,[UATeam]BraneloB,5012,1948,62,65,127,48.8%,12m
444,1,[НТТ]Zanter,5010,2421,93,97,190,48.9%,13m
444,1,PacmaN,5010,92,3,1,4,75.0%,13m
446,1,[ixix]Aldi,5009,46,1,2,3,33.3%,24m
447,2,RnmN,5007,260,12,6,18,66.7%,11m
447,1,IIllIlIlllIl,5007,306,9,7,16,56.2%,20m
449,1,[iX]Meditail,5006,1897,64,63,127,50.4%,12m
450,1,[ArGGEJ]Fjant,5005,2807,189,180,369,51.2%,10m
450,1,jdawgs,5005,1520,49,51,100,49.0%,9m
452,1,ZipperTheFly,5004,232,6,13,19,31.6%,23m
452,1,[ArGGEU]SlyCrab,5004,0,0,1,1,0.0%,10m
454,1,KKonaW,5003,2093,89,49,138,64.5%,4m
454,1,llllllllll,5003,283,17,8,25,68.0%,9m
456,1,IIIIIIIIIIII,5002,1317,56,22,78,71.8%,7m
457,1,[lMMl]SacredCoco,5000,48,2,0,2,100.0%,6m
458,1,Loki,4999,86,2,2,4,50.0%,9m
459,1,MrPörfekt,4997,2191,296,283,579,51.1%,10m
459,1,Alex,4997,1912,73,60,133,54.9%,14m
459,1,[Oath]LogiC,4997,711,25,12,37,67.6%,22m
462,1,CarstenStahl,4995,224,7,12,19,36.8%,9m
463,1,[ØC]Inkisiteur,4993,0,0,2,2,0.0%,23m
464,1,[PiCrab]Kovalskiy,4991,0,0,1,1,0.0%,23m
465,1,ZergLing,4989,372,9,20,29,31.0%,4m
466,1,elamaunt,4985,1017,41,39,80,51.2%,23m
467,1,[waxxa]Blume,4984,0,0,1,1,0.0%,6m
468,1,[JAREK]Miszu,4983,0,0,3,3,0.0%,25m
469,1,[Xa]MadLife,4982,2900,246,201,447,55.0%,23m
470,1,[Oxia]OgolCromgog,4981,1037,60,52,112,53.6%,22m
470,1,Insanity,4981,514,12,25,37,32.4%,6m
470,1,[PRОTОS]OPERATOR,4981,86,3,2,5,60.0%,3m
473,1,[TSI]Aicy,4980,1067,84,72,156,53.8%,24m
474,1,[ENV]Xaoras,4979,0,1,1,2,50.0%,12m
474,1,KeyHey,4979,0,0,1,1,0.0%,38m
476,1,yabda,4978,48,5,1,6,83.3%,21m
477,1,BulletTrain,4976,1110,42,36,78,53.8%,6m
478,1,IIIIIIIIIIII,4975,2994,128,134,262,48.9%,6m
479,1,Bolo,4969,0,1,1,2,50.0%,9m
480,1,[ǂǂǂǂǂ]LaVa,4968,2571,208,206,414,50.2%,16m
481,1,IIIIIIIIIIII,4967,1556,64,77,141,45.4%,9m
481,2,IIIIIIIIIIII,4967,150,5,13,18,27.8%,14m
483,1,llllllllllll,4963,592,27,8,35,77.1%,6m
483,1,Dronefart,4963,120,4,2,6,66.7%,10m
485,1,redpilled,4962,304,8,10,18,44.4%,20m
486,1,BOOOOOOOOOoM,4957,820,48,24,72,66.7%,9m
487,1,IlIlIIIIllll,4955,2770,392,354,746,52.5%,14m
488,1,elamaunt,4954,90,2,1,3,66.7%,3m
488,1,IIIIIIIIIII,4954,0,0,1,1,0.0%,4m
490,1,TheGalbenDuc,4953,3029,298,291,589,50.6%,9m
490,1,FarasRG,4953,1720,56,59,115,48.7%,21m
492,1,Nara,4952,2522,109,75,184,59.2%,6m
493,1,[FdCo]Turil,4951,228,5,6,11,45.5%,12m
494,1,mrSweet,4950,40,2,2,4,50.0%,25m
495,1,[αX]DojoGamer,4949,368,11,5,16,68.8%,8m
496,1,zavix,4948,1236,39,39,78,50.0%,22m
497,1,Pouch,4946,62,2,4,6,33.3%,20m
498,1,[WBO]imbAllard,4945,3022,135,133,268,50.4%,24m
498,1,[TSO1]TheSilentOne,4945,555,16,10,26,61.5%,10m
500,1,Saiph,4944,1388,96,80,176,54.5%,9m
501,1,UkraineStar,4943,140,3,5,8,37.5%,20m
502,1,hello,4941,404,17,16,33,51.5%,9m
502,1,llllllllllll,4941,516,16,12,28,57.1%,6m
502,1,SalamiPizza,4941,46,2,0,2,100.0%,25m
505,1,[ArGGEU]Areff,4939,977,106,111,217,48.8%,9m
505,1,[Dinn3r]NoSauce,4939,2141,82,67,149,55.0%,23m
507,1,BigDusty,4938,674,20,24,44,45.5%,6m
507,1,[PiGPan]ElmerFudd,4938,90,2,2,4,50.0%,14m
509,1,САСАГЕО,4935,847,35,30,65,53.8%,22m
509,1,yes,4935,124,3,4,7,42.9%,22m
511,1,[Pw]Syo,4934,0,0,1,1,0.0%,38m
512,1,Alien,4933,2912,203,176,379,53.6%,13m
513,1,[ArGGEU]AnySoSex,4931,3047,355,353,708,50.1%,10m
513,1,[PLA2N]GULIVER,4931,1913,80,60,140,57.1%,4m
515,1,Plaisi,4929,2791,159,166,325,48.9%,22m
515,1,Impostor,4929,0,1,0,1,100.0%,9m
517,1,Omega,4928,2394,207,183,390,53.1%,20m
518,1,Cattivissimo,4927,2726,107,100,207,51.7%,20m
519,1,[PаndаZ]PandAscHibA,4926,2410,141,131,272,51.8%,14m
520,1,IIIIIIIIIIII,4924,370,9,14,23,39.1%,38m
520,1,PGnem,4924,0,1,0,1,100.0%,13m
522,1,[INFED]KindaBug,4923,1826,65,55,120,54.2%,16m
522,1,[OSgZ]Timothy,4923,0,0,1,1,0.0%,20m
524,1,Ember,4922,902,33,22,55,60.0%,10m
525,1,[ArGGEU]EnigmA,4921,958,28,34,62,45.2%,10m
525,1,[BrawL]SteadfastSC,4921,40,1,3,4,25.0%,6m
527,1,PierreBzrd,4920,483,25,2,27,92.6%,21m
527,1,[aW]PlayLikeMaru,4920,314,8,6,14,57.1%,13m
529,1,[αX]synd,4919,696,28,17,45,62.2%,23m
529,1,llllllllllll,4919,492,14,11,25,56.0%,24m
529,1,Albinski,4919,376,11,7,18,61.1%,20m
529,1,Riverstone,4919,286,8,8,16,50.0%,25m
529,3,[aW]SlayersYoga,4919,0,1,1,2,50.0%,3m
534,1,Stendec,4917,2946,521,517,1038,50.2%,12m
534,1,SmaSh,4917,0,1,0,1,100.0%,13m
536,1,PixelPerfect,4916,1900,173,175,348,49.7%,23m
537,1,[GOSU69]Raphtor,4915,1697,89,82,171,52.0%,10m
538,1,[aW]Akuseru,4914,2728,506,483,989,51.2%,23m
538,1,[FxL]CatporN,4914,0,1,0,1,100.0%,7m
540,1,IDGAF,4913,1684,69,43,112,61.6%,10m
540,1,Roger,4913,1551,66,32,98,67.3%,22m
542,1,feczor,4911,2965,313,303,616,50.8%,6m
542,1,Ember,4911,439,21,7,28,75.0%,38m
542,1,llllllllllll,4911,168,5,2,7,71.4%,10m
542,1,Malvorio,4911,0,1,0,1,100.0%,6m
546,1,FunK,4910,2971,360,355,715,50.3%,10m
546,1,RMP,4910,2696,95,98,193,49.2%,3m
546,1,[НТТ]NeGaN,4910,0,1,3,4,25.0%,5m
546,1,Sapphire,4910,0,0,1,1,0.0%,3m
550,1,Solidmore,4909,3016,251,249,500,50.2%,16m
550,1,[BFeS]RainmaNǂ,4909,2629,111,102,213,52.1%,7m
552,1,IIIIIIIIIIII,4907,2989,161,155,316,50.9%,24m
552,1,DRG,4907,154,5,6,11,45.5%,23m
552,1,PatchZerg,4907,46,2,0,2,100.0%,38m
555,1,llllllllllll,4906,0,0,1,1,0.0%,10m
556,1,IIIIIIIIIIII,4905,2947,260,256,516,50.4%,22m
557,1,[aW]darox,4904,2021,278,286,564,49.3%,9m
557,1,[isIMBA]IndeX,4904,44,2,0,2,100.0%,16m
559,1,ivangnom,4903,1270,41,41,82,50.0%,6m
560,1,Oden,4902,46,1,3,4,25.0%,9m
561,1,Frank,4901,86,2,2,4,50.0%,20m
561,1,BaKa,4901,44,1,1,2,50.0%,10m
563,1,Obfuscation,4900,0,1,0,1,100.0%,9m
564,1,[Heroes]Newton,4897,2838,309,233,542,57.0%,21m
565,1,[Oath]Vengeance,4896,2757,168,156,324,51.9%,23m
565,1,Pandemic,4896,0,0,1,1,0.0%,23m
567,1,DreeN,4894,1604,51,61,112,45.5%,25m
568,1,TheViper,4893,626,18,27,45,40.0%,10m
568,1,[IBeAŚI]MaWiMain,4893,114,4,7,11,36.4%,25m
570,1,[PÂRłAH]Ling,4891,302,9,2,11,81.8%,6m
571,1,MouthFeel,4890,198,6,4,10,60.0%,25m
571,1,mjwFoG,4890,0,0,1,1,0.0%,10m
573,1,what,4887,1063,120,77,197,60.9%,3m
574,1,MrPotato,4886,2377,93,83,176,52.8%,23m
574,1,iRespectThat,4886,1934,68,71,139,48.9%,6m
574,1,[EESC]ElPezon,4886,0,0,1,1,0.0%,23m
574,1,[EESC]Markeloff,4886,0,0,2,2,0.0%,10m
578,1,[HGay]Dnopy,4885,42,1,6,7,14.3%,14m
579,1,Solar,4884,148,4,0,4,100.0%,9m
580,1,[UATeam]JETRON,4882,0,0,1,1,0.0%,6m
581,1,[GoldM]Carbine,4881,2949,311,303,614,50.7%,25m
582,1,[MangoM]MangoMosh,4879,1256,319,289,608,52.5%,13m
582,1,[Kjerne]MacroHeggy,4879,0,0,1,1,0.0%,3m
584,1,[perish]Katsu,4878,2865,190,187,377,50.4%,23m
585,1,[DeThXD]Gaffle,4877,158,4,4,8,50.0%,9m
586,1,[PMǂ]devz,4876,902,30,29,59,50.8%,16m
586,1,[MÄHH]ShEEp,4876,66,2,1,3,66.7%,24m
588,1,Rockyracucky,4874,1338,58,55,113,51.3%,4m
588,3,CamryPower,4874,145,3,1,4,75.0%,21m
590,1,Calvin,4873,2944,278,270,548,50.7%,14m
591,1,sLaiz,4872,216,6,1,7,85.7%,6m
592,1,[cl0udM]DemonPrince,4871,260,7,9,16,43.8%,16m
593,1,[ENGNS]Mechanics,4869,2888,282,268,550,51.3%,13m
593,1,Amca,4869,1750,85,46,131,64.9%,7m
593,1,[DatCat]Kerbikiller,4869,0,0,1,1,0.0%,14m
596,1,[AiRǂ]Purce,4867,2626,172,163,335,51.3%,13m
596,1,MajorOcelot,4867,2594,151,148,299,50.5%,20m
598,1,Rescue,4865,76,3,2,5,60.0%,10m
598,1,goofygoober,4865,0,1,0,1,100.0%,16m
600,1,[IBeAŚI]Bene,4864,2398,182,165,347,52.4%,21m
600,1,[GoldM]sLaiz,4864,681,51,51,102,50.0%,22m
602,1,[LifeS]CmeTanKa,4863,979,34,28,62,54.8%,9m
602,1,Crackling,4863,167,4,1,5,80.0%,3m
604,1,Terran,4862,88,5,1,6,83.3%,22m
605,1,[Arrows]Salty,4859,0,1,0,1,100.0%,9m
606,1,[LifeS]KINGDRAIGO,4858,0,0,1,1,0.0%,13m
606,1,Pressure,4858,0,0,1,1,0.0%,24m
608,1,[3Dǃ]SmoKeShEEp,4856,726,21,23,44,47.7%,6m
608,1,SkTea,4856,274,8,9,17,47.1%,10m
608,1,Amazonic,4856,266,7,8,15,46.7%,12m
611,1,Insane,4853,575,26,16,42,61.9%,7m
611,1,[Sn1p3d]Wade,4853,0,1,0,1,100.0%,4m
613,1,Antiorest,4852,2942,351,340,691,50.8%,10m
614,1,[5HEADS]SCout,4851,2973,581,538,1119,51.9%,13m
615,1,llllllllllll,4849,1959,249,164,413,60.3%,23m
616,1,[VFish]LegendKiller,4848,32,1,1,2,50.0%,9m
617,1,OwlYellow,4847,44,2,1,3,66.7%,6m
617,1,[HBGSJR]vladozerg,4847,0,0,2,2,0.0%,4m
619,1,jimmymicro,4846,850,31,39,70,44.3%,13m
620,1,Monster,4843,2937,697,696,1393,50.0%,10m
620,1,Nuguri,4843,525,19,21,40,47.5%,22m
622,1,heavyiron,4842,2143,234,215,449,52.1%,38m
622,1,[Hаsu]ElstPizarro,4842,1501,116,107,223,52.0%,8m
622,1,BaKaA,4842,241,8,5,13,61.5%,23m
622,1,FireLord,4842,0,0,1,1,0.0%,25m
626,1,mrtea,4841,185,7,8,15,46.7%,22m
627,1,Drakonomor,4840,0,1,0,1,100.0%,9m
628,1,robotikov,4839,2792,156,147,303,51.5%,25m
628,1,Duke,4839,886,27,28,55,49.1%,20m
630,1,[GGzzZ]RoDoS,4838,1307,61,51,112,54.5%,9m
630,1,[APeC]Ramses,4838,758,41,14,55,74.5%,21m
630,1,ChillgoChill,4838,209,12,8,20,60.0%,13m
630,1,lllllll,4838,328,8,7,15,53.3%,9m
634,1,[XYFAN]INcuBo,4837,976,29,24,53,54.7%,24m
634,1,Tyler,4837,83,2,0,2,100.0%,9m
636,1,Ollowain,4836,358,18,11,29,62.1%,21m
636,1,BZT,4836,449,17,16,33,51.5%,13m
636,1,Ice,4836,74,2,12,14,14.3%,24m
636,1,[FATDEB]WolloB,4836,0,0,3,3,0.0%,23m
640,1,ŢØҲïĈ,4835,0,0,1,1,0.0%,13m
641,1,[NOTAEM]BimBoom,4834,1028,67,52,119,56.3%,24m
641,1,[PMǂ]freizy,4834,124,4,3,7,57.1%,7m
643,1,[PLA2N]RazvaZAR,4833,0,0,5,5,0.0%,10m
644,1,Pupkin,4832,91,2,0,2,100.0%,6m
644,1,[MiA]Pajack,4832,0,0,2,2,0.0%,23m
646,1,[TSATSA]Kinkyy,4831,270,12,6,18,66.7%,9m
647,1,[ЯD]eXit,4829,519,33,12,45,73.3%,10m
647,1,[ØC]VacSaint,4829,88,2,0,2,100.0%,10m
647,1,[PGODs]Thimius,4829,0,1,2,3,33.3%,6m
650,1,Antoha,4828,430,12,18,30,40.0%,3m
650,1,[Archøn]dIM,4828,150,4,9,13,30.8%,22m
652,1,Sin,4827,2923,325,330,655,49.6%,10m
652,1,Ronyer,4827,238,53,4,57,93.0%,6m
652,1,Srga,4827,805,39,28,67,58.2%,25m
652,1,Matt,4827,0,0,1,1,0.0%,38m
656,1,Loke,4826,1068,57,29,86,66.3%,23m
656,1,[PŖïMĄŁ]ŞҚцŁŁўĢдИ,4826,0,0,1,1,0.0%,3m
658,1,Elegance,4825,439,14,10,24,58.3%,23m
658,1,Feral,4825,83,4,1,5,80.0%,38m
658,1,[SpagLo]Phoman,4825,0,1,0,1,100.0%,10m
658,1,[BRSKR]Kwasey,4825,0,1,1,2,50.0%,10m
662,1,[UATeam]RATM,4824,0,1,0,1,100.0%,38m
662,1,Hyuna,4824,0,1,0,1,100.0%,23m
662,1,kyuubi,4824,0,0,2,2,0.0%,23m
665,1,max,4823,1012,33,30,63,52.4%,22m
665,1,IlIlIlIlIlIl,4823,359,22,10,32,68.8%,13m
665,1,GinKurosawa,4823,98,3,0,3,100.0%,22m
665,1,[w3c]Petros,4823,0,1,2,3,33.3%,7m
669,1,Medievel,4822,2477,107,74,181,59.1%,4m
670,1,llllllllllll,4819,2487,304,306,610,49.8%,3m
670,1,[PŖïMĄŁ]Mantis,4819,0,1,2,3,33.3%,15m
670,1,llllllllllll,4819,0,1,4,5,20.0%,13m
670,2,SuperSaiyan,4819,0,0,1,1,0.0%,11m
674,2,IIIIIIIIIIII,4815,0,0,1,1,0.0%,11m
675,1,llllllllllll,4814,93,2,1,3,66.7%,16m
676,1,Tyler,4812,261,6,8,14,42.9%,10m
676,2,IIIIIIIIIIII,4812,0,0,1,1,0.0%,5m
678,1,[PÂRłAH]Satik,4811,992,46,38,84,54.8%,7m
678,2,[ICGl]React,4811,0,0,1,1,0.0%,10m
680,1,hypnotoad,4810,1275,132,126,258,51.2%,9m
681,2,[ReRise]Zeromar,4809,308,11,10,21,52.4%,7m
681,2,WarGreymon,4809,0,1,0,1,100.0%,14m
683,1,[Li3]Levon,4808,1534,63,72,135,46.7%,9m
683,1,[Gassy]zUP,4808,0,0,3,3,0.0%,38m
685,2,Shine,4807,348,17,5,22,77.3%,11m
685,2,CheeseOr,4807,0,0,1,1,0.0%,6m
687,1,Raxxes,4806,78,2,4,6,33.3%,24m
687,2,OliveiRa,4806,30,1,1,2,50.0%,17m
689,2,[Cannоn]Tütenkralle,4805,2452,212,192,404,52.5%,14m
690,1,Serral,4804,522,14,19,33,42.4%,9m
691,1,[BxFǂ]lagis,4803,1112,40,45,85,47.1%,9m
691,2,[Blacer]PAPI,4803,430,15,17,32,46.9%,38m
693,1,[Wø]AǂMitch,4802,2050,83,84,167,49.7%,13m
693,2,Strapi,4802,0,0,1,1,0.0%,7m
695,1,TiKoz,4801,2661,460,449,909,50.6%,9m
695,1,IIIIIIIIIIII,4801,184,5,12,17,29.4%,9m
695,2,[Gothiz]Chrząszcz,4801,24,1,1,2,50.0%,10m
695,2,[Hаsu]monsterkake,4801,0,0,1,1,0.0%,16m
699,1,IlIlIlIlIlIl,4800,2712,189,194,383,49.3%,9m
700,1,[ЯD]ScIIWoL,4799,1164,39,35,74,52.7%,10m
700,1,Cyrano,4799,149,6,2,8,75.0%,9m
700,1,ProFart,4799,0,1,6,7,14.3%,7m
700,2,llllllllllll,4799,0,0,1,1,0.0%,38m
704,1,BlackGoku,4798,156,4,10,14,28.6%,3m
705,1,llllllllllll,4797,2170,102,71,173,59.0%,4m
705,2,[3Dǃ]Blissful,4797,300,11,12,23,47.8%,14m
705,2,[BRSKR]schmokmok,4797,0,0,2,2,0.0%,5m
708,2,[ncotic]Owl,4796,652,26,26,52,50.0%,17m
708,2,ProxyRflexX,4796,0,1,0,1,100.0%,11m
710,2,[GdAT]OldManSlum,4795,632,34,9,43,79.1%,14m
710,1,BiggySama,4795,623,25,21,46,54.3%,24m
710,1,IIIIIIIIIIII,4795,87,2,1,3,66.7%,21m
713,1,[BriT]boubi,4793,2285,191,175,366,52.2%,4m
713,2,IIIIIIIIIIII,4793,452,22,11,33,66.7%,7m
713,2,[Olney]Skeletor,4793,0,0,1,1,0.0%,5m
716,1,[iX]DERASTAT,4792,2381,109,96,205,53.2%,24m
717,1,Arjael,4789,374,11,30,41,26.8%,25m
718,1,[RGSC2]LifeForAiur,4788,2299,198,167,365,54.2%,25m
719,1,[DutchG]imfaded,4784,2347,108,103,211,51.2%,6m
719,1,[HBGS]EXP,4784,546,16,18,34,47.1%,9m
721,2,Smorkin,4782,216,23,9,32,71.9%,9m
721,1,MustiSuckt,4782,28,1,3,4,25.0%,24m
723,1,SCARLXRD,4781,0,1,3,4,25.0%,6m
723,2,[RÐ]Nath,4781,0,0,1,1,0.0%,7m
723,2,BaNaNa,4781,0,0,2,2,0.0%,9m
726,2,[ENV]Machetos,4780,0,0,1,1,0.0%,5m
727,1,IlIlIlIlIlIl,4779,1685,222,215,437,50.8%,10m
727,1,BeamBoom,4779,1818,110,72,182,60.4%,23m
727,1,Nightmare,4779,2341,109,111,220,49.5%,16m
727,2,[bcat]bobschi,4779,36,1,1,2,50.0%,14m
731,1,dddmel,4778,2569,208,116,324,64.2%,6m
731,2,Velox,4778,0,0,1,1,0.0%,38m
733,1,InTA,4777,1392,156,131,287,54.4%,24m
733,2,Player,4777,0,0,2,2,0.0%,16m
735,2,SMK,4776,0,0,1,1,0.0%,11m
736,1,Gerd,4775,2901,165,181,346,47.7%,16m
736,1,[PMǂ]JustLikeFire,4775,344,10,13,23,43.5%,13m
738,1,[Kicx]Milvio,4774,1361,59,62,121,48.8%,13m
739,2,Strigidae,4773,1013,56,19,75,74.7%,14m
739,2,kyle,4773,0,0,2,2,0.0%,38m
741,2,[RnGpro]Prototype,4772,416,24,2,26,92.3%,38m
741,2,[LBCR]MogA,4772,0,1,0,1,100.0%,23m
743,2,KupaTrupa,4770,0,0,1,1,0.0%,11m
744,1,[KDV]Nephyr,4769,694,24,25,49,49.0%,23m
744,2,SolKing,4769,0,0,1,1,0.0%,9m
746,1,NeverCheese,4768,2865,251,254,505,49.7%,13m
746,1,[FOX]Jakilau,4768,1130,61,51,112,54.5%,15m
746,3,Naxxramas,4768,97,1,5,6,16.7%,13m
749,2,[HBGSJR]Provornuk,4767,212,8,5,13,61.5%,16m
750,1,[aW]Dasana,4764,2896,350,338,688,50.9%,13m
750,1,RyanRyanRyan,4764,1358,78,74,152,51.3%,16m
750,1,Nomad,4764,1238,43,49,92,46.7%,38m
753,2,[RGAN]MrBurns,4763,26,1,1,2,50.0%,11m
754,1,Uniq,4761,2762,166,127,293,56.7%,4m
754,2,[Blacer]Ziomek,4761,98,4,4,8,50.0%,11m
754,2,memoryyy,4761,0,1,0,1,100.0%,9m
757,1,[isIMBA]GLADIATOR,4760,1679,343,333,676,50.7%,10m
758,2,llllllllllll,4759,2197,224,212,436,51.4%,38m
759,1,DeathKick,4758,736,21,29,50,42.0%,15m
760,1,Stalker,4757,1388,63,51,114,55.3%,12m
760,1,Lactel,4757,659,34,12,46,73.9%,7m
760,1,IIIIIIIIIIII,4757,244,6,14,20,30.0%,9m
760,2,Kami,4757,0,1,1,2,50.0%,9m
760,2,Kamyh,4757,34,1,3,4,25.0%,7m
765,1,theglml,4756,2868,312,329,641,48.7%,24m
765,2,[ValidG]Simmen,4756,564,23,18,41,56.1%,38m
765,1,JoJo,4756,28,2,5,7,28.6%,20m
765,2,TrustItOrNot,4756,0,1,0,1,100.0%,9m
765,2,[ENV]Malcolm,4756,0,0,1,1,0.0%,9m
770,1,[PÂRłAH]bArtH,4755,328,14,17,31,45.2%,25m
770,2,[InBri]KrokDerGar,4755,0,1,0,1,100.0%,10m
772,2,[POTEAU]jeipy,4754,943,132,123,255,51.8%,9m
772,1,Xelan,4754,84,2,7,9,22.2%,25m
774,2,Simon,4753,0,2,3,5,40.0%,5m
775,2,KupilDivan,4752,0,1,0,1,100.0%,9m
776,1,FinalBoss,4751,2826,1072,1033,2105,50.9%,16m
776,2,[HBGS]Licemer,4751,1628,68,61,129,52.7%,10m
776,2,[PŖïMĄŁ]BattoSai,4751,28,1,4,5,20.0%,16m
779,2,noodlewalger,4750,219,15,0,15,100.0%,5m
779,2,Julia,4750,26,2,3,5,40.0%,9m
781,1,lllllllll,4749,104,2,6,8,25.0%,38m
782,1,Pianist,4747,605,37,14,51,72.5%,7m
783,1,Mérodoc,4746,2228,82,91,173,47.4%,38m
783,2,IlIlIlIlIlIl,4746,0,1,0,1,100.0%,14m
785,2,libidas,4745,1184,49,50,99,49.5%,11m
785,3,[GoldM]Bromaria,4745,0,1,0,1,100.0%,16m
787,2,Kassadin,4744,36,1,2,3,33.3%,17m
788,2,[EESC]WaKa,4743,0,0,1,1,0.0%,9m
789,2,Scylzahr,4740,0,0,1,1,0.0%,16m
789,2,Rudolf,4740,0,0,3,3,0.0%,17m
791,1,Randomizer,4737,2102,143,145,288,49.7%,13m
791,1,LarDonG,4737,468,13,31,44,29.5%,12m
791,2,Pixel,4737,132,4,4,8,50.0%,6m
791,2,starrrman,4737,10,1,2,3,33.3%,17m
795,2,[PnP]boyboyluV,4734,0,1,0,1,100.0%,16m
795,2,ShqKa,4734,32,1,1,2,50.0%,6m
797,1,Newt,4732,364,12,12,24,50.0%,4m
797,2,MentalMimic,4732,0,0,1,1,0.0%,17m
799,1,[TAW]Zgredek,4731,652,20,30,50,40.0%,13m
799,2,Smotis,4731,64,2,4,6,33.3%,7m
799,2,Draxes,4731,0,0,1,1,0.0%,7m
802,2,Yoyo,4730,568,31,4,35,88.6%,23m
802,2,Zenith,4730,154,13,7,20,65.0%,38m
802,2,[ƮesXG]Kronos,4730,0,1,0,1,100.0%,16m
802,1,Mekar,4730,0,0,1,1,0.0%,9m
806,2,OwlHootHoot,4729,2661,251,242,493,50.9%,11m
806,2,SacredCocos,4729,94,4,4,8,50.0%,6m
806,2,llllllllllll,4729,58,3,0,3,100.0%,11m
809,1,[CYC]StimToWin,4728,97,2,0,2,100.0%,7m
809,2,[PLA2N]Cyxaruck,4728,0,0,2,2,0.0%,5m
811,2,[Ex0n]MaxPax,4727,0,0,1,1,0.0%,7m
812,2,QwerelL,4726,0,1,1,2,50.0%,7m
813,1,[HBGS]Panerai,4725,839,41,43,84,48.8%,9m
813,2,[łŻerø]Mordred,4725,20,1,3,4,25.0%,14m
815,2,Helio,4723,0,0,2,2,0.0%,10m
816,1,Daniel,4721,2877,315,298,613,51.4%,15m
816,2,[RøckeT]ElKassos,4721,1891,85,73,158,53.8%,11m
818,1,Tilt,4720,644,51,30,81,63.0%,15m
818,2,[UATeam]nodrama,4720,396,18,13,31,58.1%,38m
818,1,ieatzergs,4720,96,3,3,6,50.0%,23m
821,1,billis,4719,142,3,7,10,30.0%,13m
822,2,[FxL]Cheel,4718,0,0,1,1,0.0%,9m
823,1,[сSсǃ]DjeKi,4717,1322,64,66,130,49.2%,13m
824,1,Khmel,4716,2840,238,240,478,49.8%,22m
824,2,[isIMBA]BigBoy,4716,22,2,3,5,40.0%,7m
826,1,LemonLyman,4712,2854,124,132,256,48.4%,9m
826,2,IvanDurak,4712,646,39,9,48,81.2%,6m
828,1,[Ex0n]Cellsidus,4711,1788,74,86,160,46.2%,9m
828,2,WoLF,4711,580,32,10,42,76.2%,14m
828,2,[Rafi]John,4711,102,7,1,8,87.5%,38m
828,2,lllIIIllIIIl,4711,56,3,5,8,37.5%,17m
832,1,[mCon]VeNi,4710,2803,204,199,403,50.6%,9m
833,2,Rova,4708,0,0,1,1,0.0%,10m
834,1,[3Dǃ]kazim,4707,2251,120,118,238,50.4%,23m
835,1,Ben,4705,2860,398,392,790,50.4%,15m
836,1,akmal,4704,2538,214,206,420,51.0%,7m
837,2,Bronzemaster,4703,0,0,1,1,0.0%,11m
838,1,ElezraLucker,4702,1739,287,277,564,50.9%,9m
838,2,quaZa,4702,32,2,1,3,66.7%,7m
838,2,Разрывалус,4702,0,1,0,1,100.0%,7m
841,2,[NuF]mylo,4701,62,3,0,3,100.0%,5m
842,2,IIIIIIIIIIII,4700,236,11,10,21,52.4%,5m
842,2,[GoldM]Speckops,4700,0,1,0,1,100.0%,6m
844,1,[NuF]Fishhorse,4698,2123,236,238,474,49.8%,15m
844,1,zergouner,4698,1403,102,97,199,51.3%,20m
846,2,Lasttray,4697,56,7,5,12,58.3%,14m
846,2,MacroNoob,4697,199,6,5,11,54.5%,11m
846,2,Depeche,4697,0,1,0,1,100.0%,11m
849,2,[ncotic]Lion,4696,2622,173,169,342,50.6%,5m
850,1,[Хобот]Hellion,4694,619,25,23,48,52.1%,38m
851,2,[TFNB]ClimbeR,4691,928,52,51,103,50.5%,11m
851,2,HeelHooker,4691,0,1,0,1,100.0%,5m
851,2,Zini,4691,0,0,1,1,0.0%,7m
851,2,Drasour,4691,0,0,1,1,0.0%,7m
851,2,IIIIIIIIIIII,4691,0,0,1,1,0.0%,23m
851,2,lVlagic,4691,0,0,1,1,0.0%,9m
857,1,[NAeu]Wizzle,4690,1939,107,115,222,48.2%,10m
857,2,NiRak,4690,0,1,0,1,100.0%,14m
859,2,Ninze,4689,948,41,36,77,53.2%,6m
859,2,Annie,4689,0,0,1,1,0.0%,6m
861,2,Smorkin,4688,133,19,20,39,48.7%,11m
861,2,Dùlin,4688,0,0,5,5,0.0%,17m
863,2,[ProRAT]Lovet,4686,0,0,1,1,0.0%,9m
864,1,[VFish]Heggy,4685,826,26,42,68,38.2%,22m
864,1,dropBabulek,4685,0,0,6,6,0.0%,23m
866,2,[VsCast]Vasa,4684,0,0,1,1,0.0%,11m
867,2,[NWGD]Hippotamus,4683,10,2,0,2,100.0%,7m
867,2,Meistair,4683,0,0,1,1,0.0%,9m
869,1,TeKniQ,4682,1603,127,114,241,52.7%,12m
869,1,IIIIIIIIIIII,4682,2709,123,99,222,55.4%,8m
871,1,Zarini,4681,197,7,13,20,35.0%,20m
871,2,RCselloutEG,4681,68,4,6,10,40.0%,17m
873,2,Tool,4680,2634,359,361,720,49.9%,5m
873,2,OkAsiOO,4680,275,34,18,52,65.4%,7m
873,2,Meowerdoom,4680,56,2,3,5,40.0%,16m
873,2,IIIIIIIIIIII,4680,20,1,2,3,33.3%,6m
877,2,[IBeAŚI]wannaBe,4679,72,3,3,6,50.0%,11m
877,2,[duсks]aikrash,4679,0,1,0,1,100.0%,7m
879,2,QtAnimeGirl,4678,72,4,2,6,66.7%,16m
879,2,Nine,4678,86,4,6,10,40.0%,7m
879,2,TraViS,4678,0,0,1,1,0.0%,14m
882,2,Enfury,4677,1067,126,83,209,60.3%,17m
882,2,[ESErl]Anextacy,4677,740,45,42,87,51.7%,5m
882,1,[Heroes]CptHindsight,4677,96,3,6,9,33.3%,6m
885,3,[Li3]MrMiyagi,4676,38,1,11,12,8.3%,21m
885,2,Tree,4676,0,0,1,1,0.0%,11m
885,1,[PioC]Käsebrot,4676,0,0,2,2,0.0%,17m
888,1,DasH,4675,2828,178,172,350,50.9%,20m
888,2,Ace,4675,62,4,2,6,66.7%,38m
888,2,DNIWE,4675,0,0,1,1,0.0%,7m
891,1,KafKa,4674,2754,597,602,1199,49.8%,15m
891,3,Morrigan,4674,344,17,3,20,85.0%,38m
891,2,[PaniC]BlackEagle,4674,24,2,1,3,66.7%,11m
894,1,[INAE]TAUREN,4673,632,18,30,48,37.5%,7m
895,2,scout,4671,323,12,13,25,48.0%,10m
895,2,[xMiCx]Zad,4671,98,5,3,8,62.5%,23m
897,2,MineralRGood,4670,788,46,15,61,75.4%,14m
897,2,[lCXl]JoyBoy,4670,0,0,1,1,0.0%,17m
899,2,llllllllllll,4669,0,1,0,1,100.0%,14m
900,1,[OoE]BigChief,4668,2615,119,107,226,52.7%,21m
900,2,GPF,4668,0,0,1,1,0.0%,7m
902,1,GGI,4667,1870,278,285,563,49.4%,20m
902,2,[iX]Unknown,4667,1246,62,50,112,55.4%,7m
902,2,[Wendy]Fruitsbasket,4667,432,21,16,37,56.8%,16m
905,1,[PLA2N]gSChelser,4665,2350,207,206,413,50.1%,16m
906,2,[ØC]Sparrow,4664,1773,78,70,148,52.7%,9m
906,2,IIIIIIIIIIII,4664,0,1,0,1,100.0%,38m
906,2,IIIIIIIIIIII,4664,0,0,1,1,0.0%,11m
909,2,TeamMorons,4663,443,52,48,100,52.0%,5m
910,2,BlackouT,4662,1098,62,59,121,51.2%,9m
910,2,Marciner,4662,162,8,7,15,53.3%,16m
910,2,TheStupidOne,4662,0,0,2,2,0.0%,7m
913,1,[TOBBY]Tobby,4661,225,5,14,19,26.3%,6m
913,2,[xNGSx]Rykuu,4661,0,1,0,1,100.0%,10m
915,2,[ValidG]Simmen,4659,0,0,1,1,0.0%,11m
916,2,Juicy,4656,123,4,0,4,100.0%,6m
916,2,[K0mpis]Sannen,4656,0,1,0,1,100.0%,9m
916,2,[LegVI]SpookyJudas,4656,0,0,1,1,0.0%,14m
919,2,[PLA2N]Kaydara,4655,82,4,9,13,30.8%,17m
920,1,[TTSD]Marre,4654,1473,93,93,186,50.0%,13m
920,2,robotikov,4654,0,0,1,1,0.0%,9m
922,2,[АDV]CraZyPinGuiN,4653,1818,84,80,164,51.2%,7m
922,2,PlayLikeMaru,4653,0,1,0,1,100.0%,14m
924,2,[ØC]Phyrsos,4652,136,5,10,15,33.3%,7m
924,2,[orKsB]TimZer,4652,8,1,2,3,33.3%,7m
926,2,xem,4650,641,29,27,56,51.8%,5m
926,2,MilkyAlien,4650,150,7,7,14,50.0%,7m
928,1,SepeSusi,4648,0,0,1,1,0.0%,17m
929,2,[PaniC]Johnnie,4647,2677,239,226,465,51.4%,9m
929,2,Imbalex,4647,0,1,0,1,100.0%,11m
929,2,[brazа]IIIIIIIIIII,4647,30,1,1,2,50.0%,9m
929,2,[xRtG]MacUseR,4647,46,1,5,6,16.7%,23m
929,2,[Kompi]BigBadBob,4647,0,0,1,1,0.0%,9m
934,2,FlashDave,4646,129,40,34,74,54.1%,38m
934,2,[BRSKR]GipsyDanger,4646,0,2,0,2,100.0%,14m
934,2,[FM420]Freke,4646,0,0,1,1,0.0%,11m
937,2,Luffy,4645,0,1,0,1,100.0%,10m
937,2,Kayser,4645,0,0,1,1,0.0%,23m
939,1,[ЯD]Bobicus,4644,1636,63,70,133,47.4%,23m
939,2,[ncotic]Malice,4644,0,0,1,1,0.0%,11m
939,2,Scars,4644,0,0,2,2,0.0%,5m
942,1,Motor,4643,2776,212,209,421,50.4%,25m
942,2,Nylio,4643,500,32,29,61,52.5%,16m
942,2,Death,4643,78,4,4,8,50.0%,9m
942,2,[Kompis]Riksosten,4643,0,1,0,1,100.0%,7m
942,2,[BMMore]NerO,4643,38,1,3,4,25.0%,23m
947,1,suicideisez,4642,2384,134,117,251,53.4%,9m
947,2,SomeGuy,4642,278,21,11,32,65.6%,7m
947,2,Whistler,4642,16,3,0,3,100.0%,14m
950,2,[EWSS]Cephale,4641,0,1,0,1,100.0%,10m
950,2,ReAP,4641,0,0,1,1,0.0%,7m
952,2,BakhmetoS,4640,1620,96,91,187,51.3%,16m
952,2,KingDoom,4640,279,15,15,30,50.0%,38m
954,2,[K0mpis]Hex,4639,70,3,4,7,42.9%,5m
954,2,drizzler,4639,0,1,0,1,100.0%,9m
956,2,[aW]Poucky,4638,95,6,4,10,60.0%,11m
957,2,llllllllllll,4636,0,1,0,1,100.0%,6m
957,2,[Li3]Elbbar,4636,0,0,2,2,0.0%,16m
959,2,[MSUSC2]Sombra,4635,958,41,42,83,49.4%,38m
959,2,Alecto,4635,398,20,21,41,48.8%,9m
961,2,iarFury,4634,172,12,3,15,80.0%,9m
961,2,IIIIIIIIIIII,4634,0,1,7,8,12.5%,7m
963,2,[Blacer]MarineKing,4633,335,16,11,27,59.3%,7m
963,2,Zyzz,4633,30,2,0,2,100.0%,7m
963,2,DRASOR,4633,98,2,1,3,66.7%,10m
963,2,Golanchik,4633,0,1,0,1,100.0%,7m
963,2,[Ex0n]Hønsking,4633,0,1,1,2,50.0%,11m
968,2,[ÆR]WiNtER,4632,0,1,3,4,25.0%,21m
968,2,[xBrDx]UberRushung,4632,0,0,1,1,0.0%,17m
970,2,Biosif,4631,331,20,11,31,64.5%,7m
970,1,[НТТ]Power,4631,144,6,5,11,54.5%,8m
970,2,[MkersA]WasBak,4631,0,0,1,1,0.0%,11m
973,1,[Wolven]SeksyZerg,4630,2706,329,331,660,49.8%,9m
973,2,[ICGl]SonOfKorhal,4630,871,66,61,127,52.0%,11m
973,2,[Heroes]Cheoklate,4630,1064,42,47,89,47.2%,5m
973,2,Everence,4630,208,8,9,17,47.1%,5m
977,2,[aW]DonDada,4628,1109,71,61,132,53.8%,16m
978,2,[BRSKR]Illustrated,4627,1639,72,61,133,54.1%,11m
978,2,IIIIIIIIIIII,4627,0,2,4,6,33.3%,16m
978,2,[Draigo]SayMyName,4627,0,1,0,1,100.0%,14m
978,2,llllllllllll,4627,26,1,3,4,25.0%,17m
982,2,EBLOMESHATEL,4625,175,8,4,12,66.7%,6m
982,2,Burnedgoat,4625,0,0,1,1,0.0%,9m
982,2,[EmpKas]Rakerion,4625,0,0,2,2,0.0%,14m
985,2,[GdAT]Napolcochon,4623,2597,153,156,309,49.5%,11m
986,2,[EESC]ShaDow,4621,1197,91,100,191,47.6%,16m
986,2,JauchePeter,4621,0,1,0,1,100.0%,16m
988,2,IllIllllIIll,4620,187,16,15,31,51.6%,38m
988,2,Pinu,4620,0,1,0,1,100.0%,10m
990,2,[ValidG]FifthRom,4619,116,7,2,9,77.8%,38m
990,2,Wanderer,4619,34,3,4,7,42.9%,11m
992,2,Aina,4618,397,16,4,20,80.0%,17m
992,2,[HBeS]Zhunima,4618,0,1,1,2,50.0%,7m
992,2,Kaitlyn,4618,0,0,1,1,0.0%,6m
995,2,[LoCarb]Microroni,4617,750,42,26,68,61.8%,7m
995,2,llllllllllll,4617,0,1,1,2,50.0%,5m
997,2,KanyeBest,4616,685,33,23,56,58.9%,14m
997,2,IIIIIIIIIIII,4616,325,16,10,26,61.5%,6m
997,2,IIIIIIIIIIII,4616,160,7,9,16,43.8%,23m
997,1,FrogMaster,4616,218,5,7,12,41.7%,9m
997,2,[MAKinG]daisydaisyxo,4616,0,0,1,1,0.0%,9m
1002,2,[SEMPAY]AKIRO,4615,198,26,2,28,92.9%,8m
1003,2,[IBeAŚI]Rhoust,4614,36,3,2,5,60.0%,8m
1003,2,[EmScTv]Emil,4614,0,0,1,1,0.0%,14m
1003,1,ЧудоПёс,4614,0,0,1,1,0.0%,23m
1003,2,Fiorano,4614,0,0,1,1,0.0%,8m
1007,2,Bash,4613,0,1,0,1,100.0%,9m
1008,2,[wIw]MegaBite,4612,1601,136,127,263,51.7%,16m
1008,2,TeaAge,4612,0,1,4,5,20.0%,14m
1010,2,FifthRom,4611,154,11,3,14,78.6%,9m
1010,2,AlphaStar,4611,66,3,5,8,37.5%,23m
1012,2,AfterDark,4610,0,0,2,2,0.0%,5m
1013,2,OhRIP,4609,1356,132,65,197,67.0%,23m
1013,2,GrindMaster,4609,81,2,0,2,100.0%,11m
1013,2,[TheDOH]Flubz,4609,42,2,9,11,18.2%,8m
1016,2,[Bambi2]Amir,4608,1801,143,134,277,51.6%,9m
1016,2,MoMoRoXx,4608,0,1,0,1,100.0%,14m
1018,2,VembersSimp,4607,2168,108,97,205,52.7%,6m
1018,2,[DoS98]Larogue,4607,80,2,0,2,100.0%,5m
1018,2,ByuN,4607,0,1,2,3,33.3%,14m
1021,1,[PŖïMĄŁ]Complex,4606,2320,183,183,366,50.0%,13m
1021,2,[Teor]probeX,4606,2384,136,114,250,54.4%,7m
1021,2,piodd,4606,595,68,63,131,51.9%,11m
1021,2,MonkeyDragon,4606,42,2,3,5,40.0%,11m
1021,2,[Ǽ1]Terminator,4606,0,1,1,2,50.0%,5m
1026,2,Eisgold,4605,0,0,6,6,0.0%,11m
1027,2,[PaniC]Muse,4604,16,1,3,4,25.0%,23m
1027,2,[YRAGAN]ZERG,4604,0,0,1,1,0.0%,6m
1029,2,[R33]Ansopedi,4603,297,54,24,78,69.2%,10m
1029,2,[SqAUT]Thunderle,4603,116,4,9,13,30.8%,23m
1029,2,[CrypEU]SlooTh,4603,80,2,1,3,66.7%,6m
1029,2,MindsOfXCIX,4603,0,1,0,1,100.0%,14m
1033,2,[SafeG]PDizzle,4602,2272,116,111,227,51.1%,23m
1033,2,[K9Unit]Stronger,4602,76,1,1,2,50.0%,23m
1035,1,MIXRISH,4601,1661,194,184,378,51.3%,12m
1035,2,[WCKYLN]HackePeter,4601,600,29,21,50,58.0%,7m
1035,2,[CCAV]Usubeni,4601,77,1,1,2,50.0%,10m
1035,2,[FrostG]Xayad,4601,18,1,2,3,33.3%,5m
1035,2,Grandclicker,4601,0,0,1,1,0.0%,9m
1035,1,[isIMBA]CBuPKATA,4601,0,0,1,1,0.0%,6m
1041,2,[K0mpis]numberJ,4600,1354,68,69,137,49.6%,11m
1041,2,syn,4600,1017,51,39,90,56.7%,23m
1043,2,[NMSQ]Kazaro,4599,82,4,6,10,40.0%,5m
1044,1,nTla,4598,1838,73,76,149,49.0%,11m
1044,2,KonekoNoHasu,4598,621,57,47,104,54.8%,10m
1044,2,Guinness,4598,187,7,4,11,63.6%,11m
1044,2,HauteCuisine,4598,0,1,0,1,100.0%,16m
1044,2,eloyn,4598,0,0,1,1,0.0%,14m
1049,2,[ØC]Codex,4596,114,5,7,12,41.7%,16m
1049,2,BubbaGump,4596,80,2,2,4,50.0%,38m
1049,2,[StalkZ]Cheesus,4596,0,0,1,1,0.0%,11m
1049,2,[TFSC]mOOn,4596,0,0,1,1,0.0%,14m
1049,2,llllllllllll,4596,0,0,5,5,0.0%,10m
1054,2,TheSchiebung,4595,335,17,12,29,58.6%,14m
1054,2,pilzkeim,4595,206,8,15,23,34.8%,38m
1054,2,[VBM]Frammer,4595,0,1,0,1,100.0%,5m
1054,2,Feleks,4595,0,1,1,2,50.0%,8m
1058,2,Milfhunter,4594,505,45,29,74,60.8%,9m
1058,2,Charoisaur,4594,34,2,3,5,40.0%,23m
1058,2,[ToAl]Knusper,4594,0,0,2,2,0.0%,16m
1058,2,[PLA2N]Useyourbrain,4594,0,0,2,2,0.0%,38m
1062,1,[aW]darox,4593,2726,186,196,382,48.7%,4m
1062,2,СырМясоХлеб,4593,202,8,6,14,57.1%,10m
1062,2,[LawB]Adik,4593,90,4,11,15,26.7%,38m
1062,2,[SEWP]Serenchanter,4593,54,3,5,8,37.5%,7m
1066,2,Hula,4592,579,104,100,204,51.0%,9m
1066,2,[TheDOH]Gator,4592,221,10,6,16,62.5%,9m
1068,1,[сSсǃ]GooDCat,4591,1396,96,95,191,50.3%,6m
1068,3,[NatiV]okhydra,4591,12,1,1,2,50.0%,8m
1068,3,[Sprd]Fienter,4591,0,0,1,1,0.0%,16m
1071,3,[Lmnbgl]POGGERSdude,4590,204,18,10,28,64.3%,22m
1071,2,Pütschern,4590,86,3,5,8,37.5%,11m
1071,3,Tschagg,4590,0,0,1,1,0.0%,8m
1074,3,Dune,4589,0,0,1,1,0.0%,13m
1075,2,[PLA2N]Shinobi,4588,2090,191,180,371,51.5%,7m
1075,2,Pingvinyashk,4588,2614,155,158,313,49.5%,14m
1075,2,[FIow]Ronski,4588,295,15,10,25,60.0%,10m
1075,3,Proton,4588,0,1,0,1,100.0%,15m
1075,2,Tachyon,4588,0,0,3,3,0.0%,17m
1080,1,llllllllllll,4587,1038,38,48,86,44.2%,16m
1080,2,[Zelos]DemeGer,4587,124,6,7,13,46.2%,11m
1080,2,DeeL,4587,24,1,3,4,25.0%,10m
1083,2,[НТТ]Spear,4586,610,85,85,170,50.0%,11m
1083,3,Вика,4586,423,25,5,30,83.3%,13m
1083,2,[KarenV]Ulfmand,4586,334,13,15,28,46.4%,8m
1083,3,MaEstrO,4586,0,1,0,1,100.0%,24m
1083,3,[TSVB]JCGamer,4586,0,0,1,1,0.0%,9m
1083,2,[animuh]Carl,4586,0,0,2,2,0.0%,17m
1089,2,[GОVNО]DOBROED,4585,162,7,6,13,53.8%,9m
1090,1,Nanowi,4584,2026,91,102,193,47.2%,25m
1091,2,Balbitor,4583,0,0,3,3,0.0%,14m
1092,1,ogogo,4581,2251,308,323,631,48.8%,13m
1093,2,bussi,4580,2572,290,293,583,49.7%,14m
1094,2,[αX]Blisk,4579,1927,118,114,232,50.9%,9m
1094,3,[ØC]Aérius,4579,0,1,0,1,100.0%,17m
1096,2,[RÐ]daresse,4578,2547,163,154,317,51.4%,14m
1096,2,kauP,4578,250,12,13,25,48.0%,17m
1096,2,BowelMovemnt,4578,0,0,2,2,0.0%,38m
1099,1,MrHase,4577,2753,239,255,494,48.4%,22m
1099,2,[ReaI]zMk,4577,0,1,4,5,20.0%,23m
1101,3,MikeHock,4576,0,0,1,1,0.0%,26m
1102,3,[CocoCo]Djorjx,4575,0,1,1,2,50.0%,16m
1103,2,dicdix,4574,2063,205,211,416,49.3%,17m
1103,2,[IceHus]Zero,4574,2592,119,114,233,51.1%,14m
1103,2,Nordres,4574,638,32,22,54,59.3%,6m
1103,2,[BPink]Jennie,4574,0,4,2,6,66.7%,17m
1103,3,[ICGl]MeMo,4574,0,0,1,1,0.0%,22m
1108,2,Cyllene,4573,370,20,21,41,48.8%,16m
1108,3,[YITB]Macimoz,4573,0,5,0,5,100.0%,22m
1110,2,IlIlIlIlIlIl,4572,592,27,24,51,52.9%,11m
1111,2,yukee,4571,816,61,66,127,48.0%,38m
1112,2,PajackOP,4570,165,8,7,15,53.3%,9m
1112,3,iZikk,4570,0,0,1,1,0.0%,26m
1112,3,[KDV]Marcino,4570,0,0,3,3,0.0%,26m
1115,2,Fatz,4569,2429,200,182,382,52.4%,14m
1116,1,KLÜFT,4567,1013,36,44,80,45.0%,6m
1116,3,Apocalypse,4567,0,0,1,1,0.0%,9m
1116,3,Mazzuka,4567,0,0,1,1,0.0%,16m
1116,2,[CHTU]MaT,4567,0,0,2,2,0.0%,14m
1120,2,[HAIGH]Haighstrom,4566,2299,118,115,233,50.6%,16m
1120,3,IIIIIIIIIIII,4566,337,17,7,24,70.8%,3m
1120,2,[xGenGx]WoodedMicrob,4566,92,3,7,10,30.0%,10m
1120,3,ZemmourLove,4566,0,0,1,1,0.0%,14m
1124,3,Cheesus,4565,4,2,0,2,100.0%,22m
1124,2,[hBǂ]VireNtes,4565,2,1,2,3,33.3%,16m
1124,2,GwailJangSu,4565,16,1,4,5,20.0%,16m
1127,2,[Wolven]yeg,4563,2516,146,142,288,50.7%,17m
1127,2,Tyler,4563,207,7,11,18,38.9%,8m
1129,2,llllllllllll,4562,844,41,36,77,53.2%,11m
1129,2,Alesao,4562,219,28,24,52,53.8%,16m
1129,3,llllllllllll,4562,119,5,1,6,83.3%,12m
1129,2,Staris,4562,54,3,7,10,30.0%,10m
1133,2,Gadz,4561,280,21,20,41,51.2%,16m
1133,3,Boubou,4561,0,0,1,1,0.0%,16m
1133,3,exeNagib,4561,0,0,1,1,0.0%,26m
1136,3,Wilk,4560,423,42,29,71,59.2%,4m
1137,3,[SY2G]Swarm,4559,0,1,0,1,100.0%,13m
1138,2,Fubar,4558,2052,88,97,185,47.6%,5m
1138,3,HuangGai,4558,48,4,3,7,57.1%,13m
1140,2,IIIIIIIIIIII,4557,1590,74,79,153,48.4%,9m
1140,3,Rose,4557,0,1,0,1,100.0%,14m
1142,2,Kane,4556,68,4,7,11,36.4%,14m
1142,3,Coccolino,4556,12,2,0,2,100.0%,22m
1144,1,MORDOR,4555,665,66,63,129,51.2%,10m
1144,3,[КХЕ]ComradeArtem,4555,94,10,7,17,58.8%,13m
1144,2,TheThinG,4555,158,7,14,21,33.3%,9m
1144,3,[DArch]TarEllendil,4555,0,0,1,1,0.0%,16m
1144,3,CrioZola,4555,0,0,1,1,0.0%,13m
1144,3,[xAngry]AngryShark,4555,0,0,1,1,0.0%,12m
1144,3,Goslir,4555,0,0,1,1,0.0%,8m
1151,3,[OSgZ]temilian,4554,0,0,1,1,0.0%,22m
1152,2,Kilieyn,4553,1520,217,212,429,50.6%,17m
1152,1,[Draigo]Komodo,4553,48,2,0,2,100.0%,6m
1152,2,Flashover,4553,0,0,1,1,0.0%,26m
1155,2,[UATeam]Eos,4552,1621,79,91,170,46.5%,9m
1155,3,Grunch,4552,226,13,13,26,50.0%,17m
1155,3,[SKR]Cheebah,4552,0,0,2,2,0.0%,26m
1158,3,Sjors,4551,1691,90,66,156,57.7%,16m
1159,3,Player,4550,72,8,5,13,61.5%,14m
1159,3,[Razvan]Razvan,4550,0,0,1,1,0.0%,13m
1161,3,someAphX,4549,54,4,4,8,50.0%,16m
1162,2,sammuelmumm,4547,1272,59,58,117,50.4%,11m
1162,1,[jjjjj]Ryuu,4547,1102,42,53,95,44.2%,11m
1162,3,[ICL]frugs,4547,4,1,1,2,50.0%,23m
1165,3,[36484]ŔRRŘÕÒÖØÓØØƠ,4546,14,5,6,11,45.5%,22m
1165,2,[FxL]KajDoubleJ,4546,27,4,16,20,20.0%,9m
1167,3,Daz,4545,820,51,24,75,68.0%,13m
1167,3,[LIQUID]DreaM,4545,0,1,0,1,100.0%,3m
1169,3,Ronan,4544,16,2,1,3,66.7%,8m
1170,3,IamWeasel,4543,441,24,3,27,88.9%,26m
1170,3,[Hrr]NotEnoughSCV,4543,0,0,1,1,0.0%,8m
1172,3,RuegenWalder,4541,415,22,3,25,88.0%,17m
1172,3,[EXPANT]Gazou,4541,0,0,1,1,0.0%,8m
1172,3,IIIIIIIIIIII,4541,0,0,1,1,0.0%,26m
1175,2,[Hаsu]Makunouchi,4540,105,5,4,9,55.6%,11m
1175,3,[DFgs]AtomicWolf,4540,0,1,0,1,100.0%,9m
1177,3,iomismo,4538,48,5,9,14,35.7%,13m
1177,3,Nuss,4538,20,2,3,5,40.0%,14m
1179,2,Darkseall,4537,202,10,14,24,41.7%,11m
1180,3,TylerDurden,4536,0,0,1,1,0.0%,26m
1180,3,[Hаsu]crew,4536,0,0,1,1,0.0%,3m
1182,2,kingofbox,4535,1269,63,59,122,51.6%,5m
1182,3,Nuffy,4535,444,26,3,29,89.7%,9m
1182,3,[UATeam]Regis,4535,68,8,8,16,50.0%,5m
1185,2,[ToLǂ]Soey,4534,196,9,16,25,36.0%,11m
1185,2,[PMǂ]LadderManRon,4534,54,3,8,11,27.3%,14m
1185,3,[MagFiC]Larke,4534,0,0,2,2,0.0%,21m
1188,2,Neitos,4533,2253,96,109,205,46.8%,10m
1188,3,[BAKUGO]Katsuki,4533,0,1,0,1,100.0%,12m
1188,3,[ZTLT]Shorty,4533,12,1,3,4,25.0%,12m
1191,2,llllllllllll,4532,76,3,9,12,25.0%,6m
1191,3,[nDiie]Saske,4532,12,1,1,2,50.0%,38m
1191,3,ẕѧұø,4532,0,0,1,1,0.0%,3m
1194,2,[Remtic]mcderfreak,4531,1479,67,75,142,47.2%,16m
1194,3,Smoothie,4531,202,18,12,30,60.0%,13m
1194,2,Shiny,4531,48,3,3,6,50.0%,22m
1194,3,llllllllllll,4531,24,2,2,4,50.0%,12m
1194,2,Tactyw,4531,0,2,2,4,50.0%,16m
1199,3,[CYC]hansi,4529,215,14,7,21,66.7%,12m
1199,3,[Mkers]baduer,4529,0,1,0,1,100.0%,5m
1201,2,PonySS,4528,340,15,19,34,44.1%,10m
1201,3,Jarekk,4528,0,1,0,1,100.0%,38m
1203,3,Zargothrax,4527,1567,114,94,208,54.8%,16m
1203,3,MagwaY,4527,1025,61,62,123,49.6%,23m
1203,3,BILICH,4527,415,35,27,62,56.5%,12m
1203,3,Kuckuck,4527,317,25,4,29,86.2%,14m
1203,3,[PÂRłAH]robotikov,4527,8,1,2,3,33.3%,12m
1208,3,[Brain]PiggySteer,4526,0,0,1,1,0.0%,9m
1208,2,Дымоходец,4526,0,0,11,11,0.0%,7m
1210,3,[RnGpro]Prototype,4525,315,22,3,25,88.0%,26m
1211,2,Destroy,4524,0,0,5,5,0.0%,10m
1212,2,HoXo,4523,2554,219,185,404,54.2%,14m
1212,2,calm,4523,294,18,20,38,47.4%,6m
1214,2,[3A]luckeri,4522,2176,91,101,192,47.4%,5m
1214,2,zxcqweruiop,4522,384,47,36,83,56.6%,5m
1214,3,[RøckeT]ElDringo,4522,32,3,3,6,50.0%,26m
1214,2,gerdi,4522,0,1,6,7,14.3%,17m
1218,3,[REIP00]GoodVibes,4521,0,1,0,1,100.0%,9m
1218,3,llllllllllll,4521,0,1,0,1,100.0%,12m
1220,3,Urameshi,4520,0,1,0,1,100.0%,4m
1220,3,Haathum,4520,0,1,0,1,100.0%,23m
1222,1,[c9]FrashQ,4519,122,2,9,11,18.2%,8m
1222,3,[BROSER]Kurgan,4519,0,1,0,1,100.0%,8m
1224,3,Jonny,4518,0,1,0,1,100.0%,26m
1224,2,[NetG]Adimax,4518,0,0,5,5,0.0%,8m
1226,3,TeamRocket,4517,450,26,7,33,78.8%,38m
1226,2,Life,4517,493,26,33,59,44.1%,11m
1226,3,Wexford,4517,0,1,0,1,100.0%,23m
1226,3,[xNGSx]Becksaw,4517,0,0,2,2,0.0%,26m
1230,3,[Ǽ1]Trex,4516,58,9,9,18,50.0%,26m
1230,3,Entropy,4516,10,2,2,4,50.0%,13m
1230,2,[TWIM]Mangomati,4516,24,2,5,7,28.6%,10m
1230,3,Sparta,4516,0,0,1,1,0.0%,12m
1230,3,gag,4516,0,0,1,1,0.0%,16m
1230,3,BestNameEver,4516,0,0,4,4,0.0%,9m
1236,1,[Hаsu]Chipcilinkaa,4514,1713,103,108,211,48.8%,13m
1236,3,Dampfhammer,4514,0,0,1,1,0.0%,23m
1238,2,[EZfor]Justice,4513,1148,62,56,118,52.5%,38m
1238,2,AbbaOCTO,4513,786,45,34,79,57.0%,14m
1240,1,jeongsin,4512,48,2,4,6,33.3%,17m
1241,2,[5up]Corw,4511,1661,117,125,242,48.3%,8m
1242,2,[PÂRłAH]SolusRex,4510,528,21,29,50,42.0%,5m
1242,3,[FTeS]Duke,4510,0,0,1,1,0.0%,13m
1244,3,Donkey,4509,391,21,4,25,84.0%,26m
1244,3,[TFSC]Keysar,4509,0,0,1,1,0.0%,12m
1246,2,[RevoGG]Jehuty,4508,81,3,4,7,42.9%,9m
1247,1,JeanCastex,4507,444,20,1,21,95.2%,6m
1247,3,[UATeam]Proximo,4507,20,1,7,8,12.5%,22m
1247,3,[NXT]MiqueeNa,4507,0,0,1,1,0.0%,16m
1250,2,[Донный]Днище,4506,128,6,8,14,42.9%,6m
1250,3,DarkMinions,4506,0,1,0,1,100.0%,14m
1250,3,[Ǽ1]XeRaNa,4506,0,0,1,1,0.0%,16m
1253,2,[FZ1]TePEmHatop,4505,160,8,9,17,47.1%,6m
1253,3,[isIMBA]Parathix,4505,30,4,4,8,50.0%,17m
1253,3,ImissU,4505,2,2,1,3,66.7%,16m
1253,3,Sneak,4505,18,2,3,5,40.0%,12m
1257,3,WrestleMania,4504,0,1,0,1,100.0%,13m
1257,3,FaNTaSy,4504,38,1,4,5,20.0%,15m
1257,3,[ДРИЩИ]ЧёрныйБатя,4504,0,0,1,1,0.0%,24m
1260,2,[CWL]Mahaaaadeen,4503,2451,496,506,1002,49.5%,14m
1260,2,PanSy,4503,828,38,45,83,45.8%,11m
1260,3,IIIIIIIIIIII,4503,0,0,2,2,0.0%,21m
1263,3,[Cannоn]Timo,4502,179,7,3,10,70.0%,16m
1264,2,dfgdgdfhg,4501,57,3,6,9,33.3%,11m
1265,2,[TSVB]LeComplete,4499,93,4,5,9,44.4%,9m
1265,1,dolan,4499,44,2,0,2,100.0%,16m
1265,3,quaZa,4499,0,0,1,1,0.0%,12m
1265,3,IIIIIIIIIIII,4499,0,0,1,1,0.0%,22m
1269,2,[DSCPRO]XVIIMini,4498,2405,205,194,399,51.4%,8m
1269,2,Lyakusha,4498,2029,109,107,216,50.5%,6m
1269,3,[ECFeV]Havior,4498,0,1,0,1,100.0%,12m
1269,3,Seki,4498,0,1,0,1,100.0%,9m
1273,2,lllllllllll,4497,129,17,22,39,43.6%,8m
1273,3,Orpiment,4497,0,1,0,1,100.0%,26m
1275,3,Issou,4496,703,57,6,63,90.5%,24m
1275,3,Zardan,4496,0,1,2,3,33.3%,23m
1277,2,[Ex0n]Kulka,4495,192,15,20,35,42.9%,10m
1278,3,[WYG]Cenatrice,4494,14,2,3,5,40.0%,17m
1278,3,[Wolven]WolfFire,4494,0,0,1,1,0.0%,5m
1280,3,BlueScreen,4493,609,44,32,76,57.9%,16m
1280,3,Latteless,4493,6,9,6,15,60.0%,16m
1280,2,MassReaper,4493,0,0,3,3,0.0%,4m
1283,3,[PÂRłAH]Crow,4492,837,52,41,93,55.9%,13m
1283,3,Lasha,4492,498,30,23,53,56.6%,14m
1283,3,[PandaT]CaptainPanda,4492,0,1,1,2,50.0%,21m
1283,3,[A0D]Depulsor,4492,0,0,1,1,0.0%,13m
1287,3,Barcode,4491,78,9,12,21,42.9%,16m
1287,2,[ISWAGl]Uber,4491,0,3,2,5,60.0%,4m
1289,3,HerpDerp,4490,524,28,10,38,73.7%,26m
1289,3,[SƬǂ]Zefiro,4490,0,0,1,1,0.0%,12m
1291,3,ДiдПанас,4489,534,45,28,73,61.6%,5m
1291,2,[Hаsu]Evih,4489,192,9,15,24,37.5%,9m
1291,3,Reign,4489,0,0,1,1,0.0%,13m
1294,2,CRONOS,4488,2177,162,156,318,50.9%,11m
1294,3,Dormin,4488,62,5,6,11,45.5%,13m
1296,3,NiceOne,4487,36,4,4,8,50.0%,12m
1297,1,siao,4486,2480,130,122,252,51.6%,7m
1297,2,oTrolly,4486,352,20,19,39,51.3%,16m
1297,2,[XBM]Sabaka,4486,144,8,17,25,32.0%,11m
1297,3,[LMBD]Bwonsamdi,4486,44,6,7,13,46.2%,8m
1297,3,[EZBois]Padierfind,4486,0,2,2,4,50.0%,17m
1297,3,[BluS]loginn,4486,38,2,6,8,25.0%,12m
1297,3,[HBGSJR]StanleyHodos,4486,0,1,0,1,100.0%,9m
1304,3,stevistoned,4485,2271,305,293,598,51.0%,16m
1304,3,Venturi,4485,1372,69,74,143,48.3%,4m
1304,3,TimeBones,4485,334,51,8,59,86.4%,8m
1304,3,Remember,4485,0,1,1,2,50.0%,5m
1308,3,mobo,4484,596,31,8,39,79.5%,8m
1308,3,Livesey,4484,50,6,10,16,37.5%,13m
1308,3,[CS0]TeaAge,4484,42,3,9,12,25.0%,13m
1308,3,hoshyN,4484,0,0,2,2,0.0%,23m
1312,2,Ithor,4483,1211,65,63,128,50.8%,16m
1312,3,Knack,4483,311,19,12,31,61.3%,16m
1312,3,[ØC]Rysor,4483,0,0,1,1,0.0%,24m
1315,3,[ЕМPIRE]InSTALINg,4482,0,0,1,1,0.0%,4m
1315,2,[EмŦ]MarkSucaPini,4482,0,0,5,5,0.0%,10m
1317,3,[evi1]fulgertuney,4481,151,13,5,18,72.2%,23m
1317,3,[KDV]MCU,4481,106,9,12,21,42.9%,13m
1317,3,llllllllllll,4481,92,8,10,18,44.4%,16m
1317,2,NoPressure,4481,155,7,14,21,33.3%,8m
1317,3,[WBO]Moon,4481,54,5,6,11,45.5%,23m
1322,2,[ViBErs]MrMacro,4479,2216,146,146,292,50.0%,11m
1322,3,Стомский,4479,36,4,7,11,36.4%,16m
1322,3,Tenemo,4479,0,0,1,1,0.0%,13m
1325,1,Begin,4478,2376,378,358,736,51.4%,23m
1325,3,llllllllllll,4478,0,1,0,1,100.0%,9m
1325,3,[ATI]SleepyDronE,4478,0,0,1,1,0.0%,24m
1328,3,[TRotti]Valkyrae,4477,64,9,5,14,64.3%,13m
1329,3,Penrose,4475,16,3,3,6,50.0%,24m
1329,2,Sintiya,4475,0,0,2,2,0.0%,14m
1331,3,[CBTH]Jpus,4474,6,2,3,5,40.0%,9m
1331,3,[PaniC]Kronaz,4474,0,1,0,1,100.0%,26m
1331,3,[WøS]Šçórpíøñ,4474,0,0,1,1,0.0%,14m
1334,2,roken,4473,444,21,26,47,44.7%,23m
1334,3,[MoFiTO]seriously,4473,12,2,4,6,33.3%,16m
1334,3,[Anon]HaRT,4473,0,0,1,1,0.0%,9m
1334,3,Loading,4473,0,0,1,1,0.0%,16m
1338,3,EmoLing,4472,30,3,2,5,60.0%,13m
1338,1,[mCon]Genix,4472,0,0,2,2,0.0%,13m
1340,3,[HongK]YEEZY,4471,366,21,3,24,87.5%,13m
1340,3,Abrissbirne,4471,161,12,7,19,63.2%,9m
1340,1,KEKW,4471,97,2,3,5,40.0%,6m
1343,3,Fonzy,4470,1050,59,57,116,50.9%,16m
1343,3,Flow,4470,72,6,10,16,37.5%,9m
1343,3,[ЯD]quiverling,4470,10,1,1,2,50.0%,13m
1346,3,swarmCore,4469,741,46,33,79,58.2%,13m
1346,3,llllllllllll,4469,212,7,15,22,31.8%,13m
1346,3,[PÂRłAH]robotikov,4469,0,1,0,1,100.0%,13m
1346,3,Luzaki,4469,0,0,1,1,0.0%,13m
1350,2,DonDiego,4468,214,11,14,25,44.0%,10m
1350,2,[BlaDia]granitor,4468,64,3,12,15,20.0%,7m
1352,3,Coffey,4467,0,0,1,1,0.0%,9m
1352,3,[AMZ]FOX,4467,0,0,1,1,0.0%,14m
1354,2,Joker,4466,2320,101,98,199,50.8%,14m
1354,3,gamdar,4466,433,23,5,28,82.1%,13m
1354,3,Senio,4466,0,0,2,2,0.0%,9m
1357,3,Jonas,4465,439,33,8,41,80.5%,26m
1357,3,[EXPANT]LePascu,4465,92,12,9,21,57.1%,9m
1359,3,Julian,4464,890,56,52,108,51.9%,12m
1359,2,Harrybo,4464,578,26,36,62,41.9%,12m
1361,3,[Li3]Tsanibus,4463,0,0,1,1,0.0%,8m
1361,3,[CDLB]TIMBA,4463,0,0,5,5,0.0%,24m
1363,3,Unknown,4461,426,31,12,43,72.1%,4m
1363,3,Starkiller,4461,56,9,8,17,52.9%,8m
1365,2,ArdoR,4460,124,5,19,24,20.8%,8m
1365,3,[GG]Axel,4460,32,4,6,10,40.0%,22m
1365,3,Shinycarrier,4460,0,0,1,1,0.0%,4m
1368,3,[FR1]Hurricane,4459,0,2,3,5,40.0%,9m
1368,3,Vedi,4459,8,1,7,8,12.5%,26m
1370,3,[RGSC2]RARKA,4458,2290,199,187,386,51.6%,13m
1370,3,[Wø]Equinox,4458,6,1,1,2,50.0%,24m
1370,3,[EmŦ]MagnuM,4458,0,0,1,1,0.0%,8m
1373,3,[Lambro]edominator,4457,2202,200,200,400,50.0%,13m
1373,3,DRUCKstar,4457,24,3,5,8,37.5%,26m
1375,3,Skallepär,4456,520,33,9,42,78.6%,17m
1375,3,[qcRTS]Descape,4456,16,2,3,5,40.0%,13m
1377,3,FFFFFFFFFFFF,4455,218,19,23,42,45.2%,4m
1377,3,CruiseR,4455,115,4,3,7,57.1%,13m
1377,3,[ЯD]RazerBlader,4455,0,1,0,1,100.0%,8m
1377,3,Crayon,4455,0,0,1,1,0.0%,12m
1377,3,OldPCgamer,4455,0,0,1,1,0.0%,24m
1382,1,[Hаsu]DraconicDoom,4454,2414,528,498,1026,51.5%,23m
1382,2,[bArbrA]DeMega,4454,2450,232,231,463,50.1%,5m
1382,3,[CPHW]Sonder,4454,0,0,1,1,0.0%,9m
1382,3,[ƔƟƪƟ]Night,4454,0,0,1,1,0.0%,9m
1382,3,[DFgs]AtomicGhost,4454,0,0,1,1,0.0%,23m
1382,3,[BRSKR]Lithium,4454,0,0,2,2,0.0%,26m
1388,3,DeeN,4452,426,22,8,30,73.3%,13m
1388,3,Leorio,4452,36,4,12,16,25.0%,12m
1388,3,PuTiN,4452,2,1,2,3,33.3%,22m
1388,3,Kiri,4452,0,0,1,1,0.0%,5m
1392,3,[aW]PousStache,4451,2259,165,175,340,48.5%,4m
1392,2,MrJNano,4451,2072,121,124,245,49.4%,6m
1392,2,[LJai]AiSaranG,4451,2018,100,78,178,56.2%,14m
1392,3,Perfectman,4451,8,1,3,4,25.0%,4m
1392,3,Inferno,4451,0,0,1,1,0.0%,12m
1397,3,[AiRǂ]lorimbo,4450,1127,129,118,247,52.2%,13m
1397,3,tEzE,4450,0,1,0,1,100.0%,13m
1397,3,WujekStefan,4450,0,0,1,1,0.0%,15m
1400,3,[WTFSC2]Vanni,4449,163,31,21,52,59.6%,23m
1400,2,ShadowLight,4449,134,3,1,4,75.0%,6m
1400,3,[RGn]FeniX,4449,0,1,0,1,100.0%,26m
1403,3,VirusRC,4448,1846,248,240,488,50.8%,8m
1403,3,[PiGPan]TripleHelix,4448,0,1,0,1,100.0%,15m
1403,3,[SoyBoy]SerralsDad,4448,0,0,1,1,0.0%,9m
1403,3,[G3O]ShenaniGans,4448,0,0,1,1,0.0%,12m
1407,3,Grivious,4447,1447,140,130,270,51.9%,13m
1407,3,Tyr,4447,826,49,52,101,48.5%,9m
1407,2,[DyWmP]MSIMakouni,4447,360,17,23,40,42.5%,9m
1407,3,[PLA2N]GuilleVGX,4447,88,10,9,19,52.6%,12m
1411,2,Moskito,4446,1734,160,169,329,48.6%,11m
1411,3,Williamallas,4446,38,5,4,9,55.6%,5m
1411,3,[50x]Breaker,4446,12,3,3,6,50.0%,16m
1411,3,Atomicdomb,4446,0,1,0,1,100.0%,13m
1411,3,[13g12p]TheRex,4446,0,0,3,3,0.0%,13m
1416,3,StifleR,4445,114,7,13,20,35.0%,4m
1416,3,[BitS]esow,4445,88,7,15,22,31.8%,23m
1416,3,FredTiffo,4445,12,2,3,5,40.0%,16m
1416,3,[KDV]Dzik,4445,4,1,1,2,50.0%,13m
1416,3,Zodiak,4445,6,1,3,4,25.0%,13m
1416,3,[ArsB]Kikero,4445,0,0,1,1,0.0%,12m
1422,2,Pinou,4444,2011,92,98,190,48.4%,5m
1422,3,[MHACKS]Gizmo,4444,1264,67,72,139,48.2%,23m
1422,3,StanFrey,4444,54,6,10,16,37.5%,9m
1422,3,orcnOOb,4444,0,0,1,1,0.0%,26m
1426,3,Manray,4443,268,21,22,43,48.8%,9m
1427,3,[ArGGEJ]River,4442,394,43,23,66,65.2%,26m
1427,3,Eagle,4442,0,0,1,1,0.0%,4m
1427,3,[ArsB]kiwiking,4442,0,0,1,1,0.0%,12m
1427,3,[aW]MrTrixouille,4442,0,0,1,1,0.0%,26m
1431,2,[PMIP]johnRB,4441,2299,289,300,589,49.1%,5m
1431,3,[EESC]DUFO,4441,408,26,30,56,46.4%,12m
1431,3,Alpha,4441,0,0,1,1,0.0%,13m
1434,3,[sfc]Pandazam,4440,44,7,7,14,50.0%,8m
1434,3,FishStickz,4440,0,1,0,1,100.0%,17m
1436,3,Dillinger,4439,0,1,0,1,100.0%,22m
1436,3,Heisenberg,4439,0,0,2,2,0.0%,9m
1438,3,[PLA2N]MihaEGO,4438,119,19,15,34,55.9%,12m
1438,3,llllllllllll,4438,20,5,0,5,100.0%,12m
1440,3,Tork,4437,842,40,27,67,59.7%,9m
1440,2,[IIE]deadlypatate,4437,878,40,49,89,44.9%,10m
1440,3,Iksf,4437,370,29,26,55,52.7%,15m
1443,3,[IT]Mahtarion,4436,0,0,1,1,0.0%,23m
1444,1,Hyrot,4435,1872,227,239,466,48.7%,15m
1444,3,[BriT]Mout,4435,1389,219,190,409,53.5%,13m
1444,3,llllllllllll,4435,958,50,17,67,74.6%,13m
1444,3,IIIIIIIIIIII,4435,576,38,39,77,49.4%,14m
1444,3,[Hаsu]Hutt,4435,46,5,3,8,62.5%,22m
1444,3,Mengnan,4435,16,2,1,3,66.7%,24m
1444,3,Stoic,4435,4,2,2,4,50.0%,4m
1444,3,GoRocK,4435,0,1,0,1,100.0%,17m
1452,2,[AiRǂ]DemoN,4434,837,115,115,230,50.0%,10m
1452,3,Shibbxyz,4434,22,4,5,9,44.4%,8m
1452,3,[LøS]BlueJohn,4434,4,1,2,3,33.3%,23m
1455,3,Isabella,4433,10,4,3,7,57.1%,9m
1455,3,[RTO]IIIIIIIIIIII,4433,0,0,1,1,0.0%,26m
1455,3,Revolver,4433,0,0,6,6,0.0%,22m
1458,3,Exottic,4432,6,1,4,5,20.0%,8m
1459,3,[Arrows]DarKKnightSC,4431,10,4,1,5,80.0%,22m
1460,3,CheepCheep,4430,2258,118,116,234,50.4%,9m
1460,3,chund,4430,0,1,0,1,100.0%,12m
1462,3,Carcajadas,4429,1058,82,68,150,54.7%,8m
1462,3,IIIIIIIIIIII,4429,406,17,7,24,70.8%,22m
1462,3,decemvre,4429,0,0,1,1,0.0%,38m
1465,3,Fuda,4428,6,1,4,5,20.0%,4m
1465,3,[Zguege]naincraft,4428,0,0,1,1,0.0%,12m
1465,3,[ƮesXG]Tacky,4428,0,0,1,1,0.0%,8m
1465,3,[lMMl]Jusba,4428,0,0,7,7,0.0%,13m
1469,3,Kyuubi,4427,418,27,19,46,58.7%,26m
1469,3,[SY2G]xZeiiden,4427,52,5,5,10,50.0%,26m
1469,1,[ICGl]MrJones,4427,164,4,5,9,44.4%,6m
1469,3,[PLA2N]skillraiser,4427,0,0,1,1,0.0%,26m
1469,3,MaddeLisk,4427,0,0,3,3,0.0%,23m
1474,2,IlIlIlIlIlIl,4426,1576,70,89,159,44.0%,9m
1474,3,melC,4426,97,3,3,6,50.0%,16m
1474,3,[ArGGEU]Mangokopf,4426,0,1,3,4,25.0%,38m
1474,3,spireet,4426,0,0,1,1,0.0%,26m
1478,3,[НТТ]set,4425,766,50,44,94,53.2%,38m
1478,3,Gemic,4425,84,10,12,22,45.5%,9m
1478,3,Lowruks,4425,18,3,2,5,60.0%,13m
1481,2,[CpL]KrOk,4424,2429,266,275,541,49.2%,24m
1481,3,Noodled,4424,2238,175,161,336,52.1%,13m
1481,3,[αX]Banana,4424,247,17,15,32,53.1%,13m
1481,2,[IBeAŚI]GUMGUMRuFFy,4424,284,11,21,32,34.4%,38m
1481,3,[ICGl]BeatFlitz,4424,60,6,9,15,40.0%,23m
1486,3,[Peeps]Gaz,4423,0,1,0,1,100.0%,12m
1486,3,[7BINKS]Honey,4423,6,1,1,2,50.0%,26m
1486,3,[ØC5]dad,4423,0,0,2,2,0.0%,15m
1489,3,[NAnum1]USAUSAUSAUSA,4422,186,17,16,33,51.5%,22m
1489,3,Saturated,4422,0,0,1,1,0.0%,15m
1489,2,RedPanda,4422,0,0,10,10,0.0%,17m
1492,3,IIIIIIIIIIII,4421,136,11,19,30,36.7%,12m
1492,3,[RBlood]bigmonster,4421,149,5,1,6,83.3%,38m
1492,3,AIFOX,4421,6,1,3,4,25.0%,4m
1495,3,[EPSEPS]yungdavid,4420,1009,154,133,287,53.7%,13m
1495,3,AltinAdam,4420,535,42,38,80,52.5%,12m
1495,2,DonCalone,4420,226,12,22,34,35.3%,8m
1495,3,[Wolven]sehriyar,4420,82,8,10,18,44.4%,12m
1495,3,Artstyle,4420,4,2,2,4,50.0%,24m
1495,2,ace,4420,0,1,6,7,14.3%,15m
1501,3,PeterPan,4419,10,3,1,4,75.0%,26m
1502,3,bloke,4418,1085,142,125,267,53.2%,23m
1502,3,[RGAN]Quasar,4418,334,29,22,51,56.9%,12m
1502,3,[7x]Ravengg,4418,345,15,8,23,65.2%,26m
1502,3,HornOfGondor,4418,30,5,7,12,41.7%,26m
1502,3,Ulargg,4418,48,5,12,17,29.4%,12m
1502,3,[AMZNEU]meTzelmaTz,4418,101,2,1,3,66.7%,22m
1508,3,Kagrenac,4417,324,11,11,22,50.0%,8m
1508,3,[ØC]ParaBelluM,4417,4,1,4,5,20.0%,13m
1510,3,spelzu,4416,2145,327,275,602,54.3%,5m
1510,3,Peporinho,4416,141,30,19,49,61.2%,12m
1510,2,Darling,4416,398,20,28,48,41.7%,8m
1510,3,UpsAper,4416,361,17,14,31,54.8%,13m
1510,3,Jumper,4416,61,12,11,23,52.2%,13m
1510,3,IIIIIIIIIIII,4416,6,3,1,4,75.0%,22m
1510,3,[WCKYLN]iBimsFritz,4416,16,2,3,5,40.0%,13m
1510,3,[Zguege]TortueALeo,4416,0,0,2,2,0.0%,8m
1518,3,Brani,4415,383,66,58,124,53.2%,39m
1518,3,IIIIIIIIIIII,4415,416,23,6,29,79.3%,13m
1518,3,[HBGSJR]Hayasaka,4415,8,3,1,4,75.0%,24m
1518,3,[D0N3]Kelj,4415,0,1,0,1,100.0%,4m
1522,2,JustKillHim,4414,856,41,50,91,45.1%,9m
1522,3,[D0WN]Jnk,4414,248,21,11,32,65.6%,9m
1522,3,Noraf,4414,20,3,3,6,50.0%,26m
1522,3,[RBlood]YupLa,4414,0,0,1,1,0.0%,14m
1522,3,toR,4414,0,0,1,1,0.0%,8m
1522,3,[КОНЧА]Loboque,4414,0,0,5,5,0.0%,12m
1528,3,fireballkid,4413,1030,138,141,279,49.5%,15m
1528,3,WildWolf,4413,1670,105,83,188,55.9%,14m
1528,3,zeppy,4413,212,44,37,81,54.3%,12m
1528,3,[ISAOI]sershhka,4413,0,1,0,1,100.0%,4m
1528,3,[boomer]depression,4413,0,0,1,1,0.0%,14m
1528,3,[LikSug]SirNeckbeard,4413,0,0,1,1,0.0%,8m
1534,2,[Li3]Manny,4412,2445,242,242,484,50.0%,38m
1534,3,Serla,4412,961,125,103,228,54.8%,5m
1534,2,[ncotic]AtZe,4412,714,31,43,74,41.9%,16m
1534,3,[Peeps]BUFOR,4412,305,25,20,45,55.6%,8m
1534,3,[1CY]BoO,4412,32,4,4,8,50.0%,4m
1534,3,Tomus,4412,0,1,0,1,100.0%,16m
1534,2,[AISC]Dunmer,4412,0,0,2,2,0.0%,26m
1541,3,WendteBassen,4411,1132,59,67,126,46.8%,23m
1541,3,[TheDOH]Rookie,4411,193,19,21,40,47.5%,9m
1541,3,[TV]CobraTV,4411,168,15,20,35,42.9%,12m
1541,3,[Sinful]EXILED,4411,6,2,2,4,50.0%,22m
1541,3,[RLA]LeNooB,4411,0,0,1,1,0.0%,26m
1546,3,[TAW]Jeddrix,4410,1819,180,178,358,50.3%,4m
1546,3,IDobbyI,4410,642,53,49,102,52.0%,14m
1546,3,IronMan,4410,338,13,3,16,81.2%,5m
1546,3,Bloodsword,4410,8,1,3,4,25.0%,12m
1550,3,[R33]Time,4409,98,11,13,24,45.8%,9m
1550,3,MAESTRO,4409,16,2,4,6,33.3%,13m
1550,3,[EAU]OgAgAl,4409,0,1,0,1,100.0%,23m
1550,3,Fruitality,4409,6,1,4,5,20.0%,22m
1554,2,[TheDOH]Rædwulf,4408,828,44,50,94,46.8%,9m
1554,3,[LaggIT]FlexTerror,4408,0,1,0,1,100.0%,9m
1556,3,yar,4407,811,154,135,289,53.3%,22m
1556,3,Unique,4407,40,4,5,9,44.4%,16m
1556,3,[Draigo]Harius,4407,0,1,0,1,100.0%,12m
1556,3,[INAE]ĐoubleCC,4407,0,1,0,1,100.0%,23m
1560,3,[hängA]Shiva,4406,2217,327,331,658,49.7%,39m
1560,3,[WBO]Mars,4406,540,187,159,346,54.0%,5m
1560,3,llllllllllll,4406,262,19,24,43,44.2%,8m
1560,1,meatyourbeat,4406,322,13,6,19,68.4%,18m
1560,3,Groodo,4406,187,10,5,15,66.7%,16m
1560,3,Anok,4406,0,0,1,1,0.0%,24m
1566,3,Mandalorian,4405,0,1,0,1,100.0%,17m
1566,3,JarBaX,4405,0,0,1,1,0.0%,24m
1568,3,Lampan,4404,2236,157,150,307,51.1%,14m
1568,3,[HIYYYA]WASSUP,4404,1355,67,64,131,51.1%,14m
1568,3,[ArGGEU]MoonBeam,4404,16,3,3,6,50.0%,14m
1568,3,Kartulipuder,4404,0,1,0,1,100.0%,39m
1568,3,IIIIIIIIIIII,4404,0,1,0,1,100.0%,22m
1568,3,Reverse,4404,0,0,1,1,0.0%,15m
1568,3,Schtievo,4404,0,0,1,1,0.0%,8m
1575,3,[YlKES]Nat,4403,155,9,7,16,56.2%,9m
1575,3,IIIIIIIIIIII,4403,28,2,2,4,50.0%,26m
1575,3,Taimyr,4403,4,2,3,5,40.0%,13m
1578,3,iga,4402,2088,165,152,317,52.1%,9m
1578,3,[EBEMZ]WarFare,4402,72,8,15,23,34.8%,12m
1578,3,[Dobro]Dobro,4402,145,7,4,11,63.6%,26m
1578,2,BrokenGlass,4402,138,3,5,8,37.5%,6m
1578,3,Ben,4402,0,1,0,1,100.0%,12m
1578,3,RaMPaGe,4402,14,1,11,12,8.3%,22m
1578,3,MonkeyMan,4402,0,0,1,1,0.0%,8m
1585,3,AcidRain,4401,435,19,13,32,59.4%,22m
1585,3,RatGonzalez,4401,10,3,1,4,75.0%,9m
1585,3,Flowerboy,4401,0,0,1,1,0.0%,24m
1585,3,AtomicHost,4401,0,0,1,1,0.0%,13m
1589,3,[ncotic]Käsekuchen,4400,142,17,14,31,54.8%,4m
1590,3,ActivE,4399,121,3,0,3,100.0%,13m
1590,3,[CU84]Pepega,4399,6,2,1,3,66.7%,13m
1590,3,xGMTx,4399,0,0,1,1,0.0%,9m
1590,3,[Rofler]RuLeR,4399,0,0,1,1,0.0%,13m
1594,3,[PÂRłAH]siso,4398,94,10,11,21,47.6%,15m
1594,3,Strife,4398,8,2,4,6,33.3%,16m
1594,3,Dormin,4398,0,0,1,1,0.0%,26m
1597,2,Sentik,4397,22,3,12,15,20.0%,12m
1597,3,Heacy,4397,0,0,2,2,0.0%,9m
1599,3,Grimlot,4396,404,15,7,22,68.2%,24m
1599,3,Beel,4396,0,1,0,1,100.0%,12m
1599,3,[Furet]eAzy,4396,0,0,1,1,0.0%,26m
1602,2,[RSK]GrumpyRoach,4395,2438,306,307,613,49.9%,7m
1602,3,[RstE]NicoStar,4395,28,6,6,12,50.0%,5m
1602,3,Serral,4395,30,5,6,11,45.5%,22m
1602,3,TYRBOMAX,4395,10,1,1,2,50.0%,24m
1606,3,[GdAT]Anticore,4394,1444,75,73,148,50.7%,4m
1606,3,[AppSha]NeoWave,4394,566,32,16,48,66.7%,22m
1606,3,TrevorLahey,4394,542,31,38,69,44.9%,14m
1606,2,[SLD]Pixelbuddha,4394,0,1,1,2,50.0%,25m
1610,3,ÐeLiRiuM,4393,64,5,13,18,27.8%,26m
1610,3,[ISSC]LehAloha,4393,0,1,0,1,100.0%,4m
1610,3,DontPlayT,4393,0,0,1,1,0.0%,26m
1613,3,TestDrive,4392,286,37,39,76,48.7%,16m
1613,3,[Xa]LEONARDO,4392,8,3,1,4,75.0%,39m
1613,3,[TAY]Akriman,4392,0,0,1,1,0.0%,13m
1613,2,WhiteTomer,4392,0,0,1,1,0.0%,9m
1617,3,IIIIIIIIIIII,4391,1146,86,95,181,47.5%,13m
1617,3,[HBGSJR]psychosocial,4391,548,40,25,65,61.5%,24m
1619,2,Aehnn,4390,2422,249,264,513,48.5%,8m
1619,3,[TR2PRO]Lillepus,4390,2039,117,105,222,52.7%,5m
1619,3,MadCatMKII,4390,1419,104,77,181,57.5%,24m
1619,3,JetStream,4390,1375,86,84,170,50.6%,13m
1619,2,wlfz,4390,1986,83,104,187,44.4%,8m
1619,3,[DisES]Squall,4390,840,49,43,92,53.3%,13m
1619,3,asamari,4390,291,22,19,41,53.7%,26m
1626,3,LaMacroCaPue,4389,1062,57,49,106,53.8%,13m
1626,3,LuPiN,4389,198,7,1,8,87.5%,14m
1626,3,UedSoldier,4389,22,3,7,10,30.0%,5m
1629,3,ReunioN,4388,1428,133,147,280,47.5%,16m
1629,3,[PŖïMĄŁ]Raffa,4388,28,4,6,10,40.0%,13m
1629,3,[hBǂ]halfBrain,4388,20,3,6,9,33.3%,16m
1629,3,[SeTeH]MoCu,4388,10,1,1,2,50.0%,16m
1633,3,[OoE]VeniVidiVici,4387,746,38,29,67,56.7%,24m
1633,2,[VFish]Nimzo,4387,615,30,39,69,43.5%,9m
1633,3,[ǂǂǂǂǂ]Mefistofeles,4387,104,11,16,27,40.7%,9m
1633,3,TossQuiteOP,4387,105,4,1,5,80.0%,17m
1637,3,Yukz,4386,992,147,120,267,55.1%,26m
1637,2,Loosie,4386,729,39,29,68,57.4%,24m
1637,3,IIIIIIIIIIII,4386,225,24,7,31,77.4%,26m
1637,3,IIIIIIIIIIII,4386,48,6,7,13,46.2%,12m
1637,3,[IndyK]Fly,4386,18,4,5,9,44.4%,39m
1637,3,GuGu,4386,4,2,0,2,100.0%,22m
1637,3,[Serral]deep,4386,0,1,0,1,100.0%,5m
1644,3,[CBTH]dream,4385,157,10,10,20,50.0%,9m
1644,3,Insolence,4385,0,0,1,1,0.0%,9m
1644,3,IlIlIlIlIlIl,4385,0,0,1,1,0.0%,24m
1647,2,Mizu,4384,2417,196,194,390,50.3%,14m
1647,3,[KDV]DrZerg,4384,253,14,7,21,66.7%,22m
1647,3,JDMan,4384,16,3,5,8,37.5%,16m
1647,3,Gonharch,4384,0,1,0,1,100.0%,13m
1647,3,Echoes,4384,0,1,2,3,33.3%,12m
1647,3,[boomer]blowMYlings,4384,0,0,1,1,0.0%,14m
1653,3,[CYC]NerO,4383,2201,222,238,460,48.3%,5m
1653,1,[PŖïMĄŁ]SupReMMorTy,4383,2618,189,212,401,47.1%,24m
1653,3,Tempi,4383,1455,90,65,155,58.1%,26m
1653,3,[Lort]MonkeyMan,4383,683,32,13,45,71.1%,26m
1653,3,Padparadscha,4383,182,5,4,9,55.6%,14m
1653,3,Blood,4383,0,0,1,1,0.0%,23m
1659,3,[AISC]Ludus,4382,264,25,24,49,51.0%,16m
1659,3,shadowlight,4382,170,4,2,6,66.7%,4m
1659,3,sticKTrick,4382,4,1,2,3,33.3%,24m
1662,3,llllllllllll,4381,253,16,12,28,57.1%,16m
1662,3,Ragnar,4381,0,1,0,1,100.0%,14m
1664,2,Tomeus,4380,1184,63,70,133,47.4%,5m
1664,3,[bod]Projectile,4380,451,17,4,21,81.0%,24m
1664,3,DragoN,4380,317,11,6,17,64.7%,9m
1664,3,[DøA]SadRay,4380,0,1,1,2,50.0%,16m
1668,3,Alexisonfire,4379,517,100,86,186,53.8%,5m
1668,3,[Maegis]Anthodeus,4379,980,46,29,75,61.3%,16m
1668,3,Clownfiesta,4379,592,35,18,53,66.0%,8m
1668,3,Okimuk,4379,102,4,0,4,100.0%,4m
1672,3,GLHFGG,4378,491,30,10,40,75.0%,16m
1672,3,Rises,4378,473,19,10,29,65.5%,22m
1672,3,[SEWP]ЛЕВ,4378,26,6,7,13,46.2%,8m
1672,3,Волшебник,4378,0,1,1,2,50.0%,13m
1676,2,[Hаsu]Ajax,4377,923,46,48,94,48.9%,5m
1676,3,llllllllllll,4377,76,8,12,20,40.0%,4m
1676,3,[PŖïMĄŁ]iNveiN,4377,0,0,1,1,0.0%,13m
1679,3,ElfeFarci,4376,402,238,218,456,52.2%,14m
1679,3,[RealEG]Aguirre,4376,533,145,131,276,52.5%,16m
1679,3,[DisES]pitivier,4376,1370,75,79,154,48.7%,17m
1679,1,[GoldM]sLaiz,4376,1108,48,70,118,40.7%,24m
1679,3,Dutes,4376,802,36,24,60,60.0%,17m
1679,3,IlIlIlIlIlIl,4376,10,3,7,10,30.0%,16m
1679,3,Minerva,4376,121,2,1,3,66.7%,22m
1679,3,[thrax]thrax,4376,0,1,0,1,100.0%,12m
1679,3,[Arrows]Russalka,4376,97,1,1,2,50.0%,24m
1679,2,llllllllllll,4376,22,1,16,17,5.9%,38m
1689,3,[Lambro]BigBrother,4375,1007,124,101,225,55.1%,4m
1689,3,Pvtbryan,4375,1364,76,78,154,49.4%,26m
1689,3,Apfelsau,4375,628,43,43,86,50.0%,8m
1689,3,[BøZø]LtDan,4375,0,3,3,6,50.0%,5m
1689,3,[marcW]Daffe,4375,0,0,1,1,0.0%,8m
1694,3,Sweet,4374,834,103,80,183,56.3%,13m
1694,3,VoodooPeople,4374,773,70,43,113,61.9%,14m
1694,3,Player,4374,545,20,10,30,66.7%,26m
1694,3,[FXs]Devitca,4374,0,0,1,1,0.0%,16m
1694,3,schtig,4374,0,0,2,2,0.0%,14m
1699,3,Muskul,4373,2220,398,391,789,50.4%,13m
1699,3,LifeIVs,4373,394,19,13,32,59.4%,26m
1699,3,[ZeTePr]MicroMelon,4373,136,16,17,33,48.5%,16m
1699,2,[SqAUT]Aldoros,4373,236,12,23,35,34.3%,5m
1699,3,[RÐ]CuréCalin,4373,66,9,11,20,45.0%,4m
1699,3,Isaac,4373,235,8,2,10,80.0%,22m
1699,3,Truestory,4373,12,3,4,7,42.9%,16m
1699,3,Kaileen,4373,121,2,2,4,50.0%,13m
1699,3,[websla]IIIIIIIIIIII,4373,0,1,0,1,100.0%,12m
1699,3,Gordeath,4373,0,0,1,1,0.0%,4m
1699,3,BigBlackCat,4373,0,0,1,1,0.0%,14m
1710,3,ArmaG,4372,1577,140,116,256,54.7%,22m
1710,3,[EESC]LXrandom,4372,1101,109,109,218,50.0%,22m
1710,3,FunkyPants,4372,1293,86,31,117,73.5%,17m
1710,3,[CrøkeT]EIkeutard,4372,489,29,13,42,69.0%,26m
1710,3,[laVsl]IIIGGGxIII,4372,219,7,2,9,77.8%,12m
1710,3,PaxRoft,4372,243,7,3,10,70.0%,22m
1710,3,Yax,4372,121,2,1,3,66.7%,22m
1710,3,[RGBCn]Mzdora,4372,97,1,1,2,50.0%,26m
1710,3,[ObG1]SpasmMan,4372,0,0,1,1,0.0%,9m
1719,3,Hidan,4371,1035,210,194,404,52.0%,5m
1719,3,[duсks]maniachillo,4371,1582,158,144,302,52.3%,22m
1719,3,[PLA2N]SlyBeetle,4371,1410,71,42,113,62.8%,26m
1719,3,FrostMage,4371,573,28,26,54,51.9%,22m
1719,3,FavorProud,4371,292,16,0,16,100.0%,22m
1719,3,TCh,4371,0,0,1,1,0.0%,8m
1725,3,[MVPeu]AoWLuXus,4370,1277,64,37,101,63.4%,24m
1725,3,[KpaБ]kerriGan,4370,97,1,1,2,50.0%,12m
1725,3,llllllllllll,4370,83,1,1,2,50.0%,16m
1725,3,[ІDDQD]BFG,4370,0,0,1,1,0.0%,13m
1729,3,Gungnir,4369,1267,155,154,309,50.2%,9m
1729,3,LeRollier,4369,1963,99,102,201,49.3%,13m
1729,3,[RnGpro]Prototype,4369,618,33,8,41,80.5%,26m
1729,3,Rinsei,4369,189,8,4,12,66.7%,12m
1729,3,LOKIAN,4369,32,6,6,12,50.0%,4m
1729,3,[LEVARP]ДевочкаМошер,4369,99,3,3,6,50.0%,4m
1729,3,fMMplz,4369,0,1,0,1,100.0%,8m
1729,3,Kastle,4369,0,1,0,1,100.0%,8m
1729,2,[Ɛï3]ƅĩǥпợŋşҭƹг,4369,48,1,1,2,50.0%,14m
1729,3,[GEGT]Tuddi,4369,0,0,3,3,0.0%,8m
1739,3,Apendix,4368,698,69,58,127,54.3%,23m
1739,3,[2VR]twissel,4368,764,48,49,97,49.5%,39m
1739,3,BobToss,4368,0,4,1,5,80.0%,13m
1739,2,[TVÐ]mumming,4368,0,1,1,2,50.0%,14m
1739,3,Saïmon,4368,0,0,1,1,0.0%,9m
1744,3,Aquali,4367,655,65,52,117,55.6%,24m
1744,3,Calmo,4367,97,4,1,5,80.0%,4m
1746,3,RichardToss,4366,748,46,23,69,66.7%,8m
1746,3,Gambeulin,4366,454,42,36,78,53.8%,26m
1746,3,AlephZero,4366,591,39,28,67,58.2%,22m
1746,3,Quib,4366,199,20,11,31,64.5%,16m
1746,3,[ArGGEU]alfi,4366,175,10,12,22,45.5%,24m
1746,3,[WaCKi]krzychacz,4366,24,4,5,9,44.4%,12m
1746,3,DoctorWho,4366,12,3,4,7,42.9%,9m
1746,3,[ЯD]RedKeys,4366,101,2,2,4,50.0%,23m
1746,3,GameOfProbes,4366,0,1,0,1,100.0%,26m
1746,3,WooX,4366,97,1,1,2,50.0%,4m
1746,3,[TKAP]Okaneby,4366,8,1,3,4,25.0%,14m
1746,3,[WBO]McGregor,4366,0,0,1,1,0.0%,26m
1758,3,Turin,4365,1275,227,202,429,52.9%,9m
1758,3,[PŖïMĄŁ]BØØØØØØØØØØM,4365,1062,43,29,72,59.7%,22m
1758,3,[aW]Deuxcentonze,4365,453,16,11,27,59.3%,8m
1758,3,Slender,4365,8,3,4,7,42.9%,8m
1758,3,Golo,4365,0,0,1,1,0.0%,26m
1763,3,Eclipse,4364,412,34,34,68,50.0%,14m
1763,3,[lMMl]Fagballs,4364,131,22,8,30,73.3%,23m
1763,3,Fleoh,4364,337,21,23,44,47.7%,16m
1763,3,descara,4364,74,7,14,21,33.3%,23m
1763,3,ghostface,4364,28,6,7,13,46.2%,13m
1763,3,Erebos,4364,0,4,1,5,80.0%,12m
1763,3,[VFish]XCet,4364,24,4,8,12,33.3%,4m
1763,3,[ArGGEU]Dennery,4364,0,1,0,1,100.0%,13m
1771,2,[Animoo]Ronski,4363,2229,185,195,380,48.7%,10m
1771,3,[sGeeks]zettick,4363,785,113,101,214,52.8%,12m
1771,3,IIIIIIIIIIII,4363,245,8,4,12,66.7%,17m
1771,3,Zodin,4363,26,3,6,9,33.3%,22m
1771,3,SugarDaddy,4363,97,1,1,2,50.0%,4m
1771,3,llllllllllll,4363,97,1,1,2,50.0%,14m
1771,3,[MeloMa]ldrA,4363,0,1,1,2,50.0%,12m
1771,3,braiN,4363,0,0,1,1,0.0%,13m
1779,3,[JDJDJD]Cyklopata,4362,660,34,20,54,63.0%,5m
1779,3,[VuV]Jidduu,4362,369,13,10,23,56.5%,39m
1779,3,[q3d]GWS,4362,307,10,13,23,43.5%,16m
1779,3,DeadLine,4362,0,0,1,1,0.0%,23m
1779,3,Noitec,4362,0,0,1,1,0.0%,12m
1784,2,Sezja,4361,2340,198,119,317,62.5%,5m
1784,3,REAPER,4361,1491,146,133,279,52.3%,26m
1784,3,Apfelmus,4361,1424,137,102,239,57.3%,13m
1784,3,[nB]Benkro,4361,1813,90,84,174,51.7%,12m
1784,3,Похоронный,4361,1392,82,72,154,53.2%,8m
1784,3,NUDGE,4361,459,23,5,28,82.1%,26m
1784,3,[ÆR]Zentis,4361,457,17,11,28,60.7%,26m
1784,1,Guje,4361,291,9,4,13,69.2%,22m
1784,3,[AnD]JuMper,4361,193,6,1,7,85.7%,26m
1784,3,[Dae]HyuMan,4361,194,5,2,7,71.4%,22m
1784,3,Snakeman,4361,0,0,1,1,0.0%,14m
1784,3,[PŖïMĄŁ]Azi,4361,0,0,3,3,0.0%,4m
1796,3,asurn,4360,2191,579,599,1178,49.2%,12m
1796,3,Lazare,4360,1669,97,76,173,56.1%,9m
1796,3,Crixus,4360,664,77,68,145,53.1%,24m
1796,3,Improving,4360,700,30,19,49,61.2%,13m
1796,3,Roxy,4360,40,13,19,32,40.6%,14m
1796,3,[DFgs]yNOT,4360,34,5,9,14,35.7%,17m
1796,3,[ECR20]Skip,4360,0,1,1,2,50.0%,8m
1796,3,[PÂRłAH]Funny,4360,6,1,3,4,25.0%,14m
1796,3,KhalDrogo,4360,0,1,4,5,20.0%,14m
1796,1,Antiquity,4360,0,0,1,1,0.0%,8m
1806,1,[IceHus]INnoVation,4359,0,0,1,1,0.0%,13m
1806,3,[Hаsu]ErmakVRN,4359,0,0,2,2,0.0%,23m
1808,3,NewbRevenge,4358,1888,364,364,728,50.0%,26m
1808,2,llllllllllll,4358,428,22,37,59,37.3%,11m
1808,3,Jeggi,4358,153,6,4,10,60.0%,22m
1808,3,ricepaper,4358,4,2,2,4,50.0%,16m
1808,2,[MFclub]makoz,4358,0,1,1,2,50.0%,23m
1813,3,CollinCobra,4357,841,37,17,54,68.5%,9m
1813,3,MagicPT,4357,628,36,32,68,52.9%,24m
1813,1,[lMMl]Ike,4357,0,1,0,1,100.0%,15m
1813,1,NoobMaster,4357,48,1,2,3,33.3%,6m
1817,3,[ISSC]JerrodCole,4356,252,14,4,18,77.8%,4m
1817,1,[lOoOl]TGNP,4356,96,2,3,5,40.0%,22m
1819,3,[Kompis]Schmuuu,4355,105,2,3,5,40.0%,26m
1820,3,[3M1]Danjuw,4354,484,39,38,77,50.6%,8m
1820,3,[GoBrr]RoachPrinter,4354,22,8,17,25,32.0%,4m
1820,1,[yhy]IIIIIIIIIIII,4354,144,4,0,4,100.0%,5m
1820,3,barcode,4354,4,2,4,6,33.3%,8m
1820,3,Briik,4354,0,0,2,2,0.0%,12m
1825,3,[LożaP]AlexMacedon,4352,1484,79,73,152,52.0%,13m
1825,1,[Hchor]Johnny,4352,0,0,1,1,0.0%,6m
1827,3,[IBeAŚI]Schmelzkäse,4351,1507,181,179,360,50.3%,13m
1827,3,Snippsnapp,4351,589,122,125,247,49.4%,8m
1827,1,[FSeS]Rebellion,4351,240,5,6,11,45.5%,4m
1827,1,[WRG]Thunderball,4351,48,1,1,2,50.0%,8m
1827,3,Ruffy,4351,0,0,8,8,0.0%,24m
1832,3,[R0]Andrusca,4350,1094,117,95,212,55.2%,22m
1833,3,IIIIIIIIIIII,4349,0,3,4,7,42.9%,39m
1834,1,JernJan,4348,2498,143,154,297,48.1%,9m
1834,3,AkadOk,4348,18,4,4,8,50.0%,9m
1834,2,Helios,4348,44,3,8,11,27.3%,22m
1834,1,[Sc2Gms]pħĭłĭpp,4348,0,1,0,1,100.0%,8m
1838,1,PizeriaZorba,4347,330,14,0,14,100.0%,22m
1838,3,Bugsy,4347,253,8,9,17,47.1%,23m
1838,3,Diamanthai,4347,10,2,4,6,33.3%,26m
1838,1,WhosSly,4347,48,1,6,7,14.3%,39m
1842,3,[FR1]BadBorz,4346,2178,263,272,535,49.2%,12m
1842,1,Skrinki,4346,192,5,2,7,71.4%,6m
1842,1,[RoBotS]lNnoVation,4346,0,0,1,1,0.0%,4m
1845,2,[EESC]Kellermann,4345,2027,179,189,368,48.6%,38m
1845,3,Weon,4345,170,4,3,7,57.1%,9m
1847,3,NoFriend,4344,127,11,18,29,37.9%,4m
1847,1,[Sarmat]PogChamp,4344,472,10,3,13,76.9%,10m
1847,3,[DN3N]Square,4344,94,10,15,25,40.0%,12m
1847,3,Ulz,4344,0,0,5,5,0.0%,5m
1851,3,[Sarmat]NataszPL,4343,463,34,32,66,51.5%,26m
1851,3,WannaBeBly,4343,121,3,2,5,60.0%,26m
1853,3,Percefal,4342,721,29,11,40,72.5%,22m
1853,1,moki,4342,0,0,1,1,0.0%,13m
1853,3,SevenOfNine,4342,0,0,2,2,0.0%,5m
1856,1,[eXøde]MFingerUp,4341,2558,598,599,1197,50.0%,5m
1856,3,BeuSnu,4341,1035,63,50,113,55.8%,8m
1856,2,WhiteWolf,4341,1171,56,67,123,45.5%,38m
1856,1,[GrGmls]sweetbitch,4341,144,3,3,6,50.0%,17m
1860,3,[PaniC]ДжохниПрогей,4340,2198,236,249,485,48.7%,14m
1860,3,Healy,4340,1303,115,121,236,48.7%,23m
1860,3,[TAW]MarsBar,4340,778,72,63,135,53.3%,26m
1860,2,Dekernet,4340,484,19,39,58,32.8%,14m
1860,3,[MkersA]Nomisking,4340,0,1,1,2,50.0%,12m
1860,1,Jolatis,4340,0,0,1,1,0.0%,39m
1860,2,IIIIIIIIIIII,4340,0,0,2,2,0.0%,6m
1867,3,[mejmej]Bubler,4339,532,61,71,132,46.2%,12m
1867,3,Pobble,4339,0,1,1,2,50.0%,22m
1869,3,headd,4337,785,58,28,86,67.4%,16m
1869,3,YouAnimal,4337,570,38,26,64,59.4%,24m
1871,3,[xGenGx]Hellontoast,4336,4,1,4,5,20.0%,9m
1872,3,[GdAT]Unhealthy,4335,90,8,16,24,33.3%,8m
1873,3,Angelus,4334,228,13,8,21,61.9%,12m
1873,3,Cooskoo,4334,201,8,6,14,57.1%,26m
1873,2,JohanLiebert,4334,0,0,1,1,0.0%,9m
1873,1,Nephilim,4334,0,0,2,2,0.0%,8m
1877,3,[QQPls]FosKi,4333,2020,318,321,639,49.8%,22m
1877,1,Wantan,4333,96,3,2,5,60.0%,13m
1879,3,xXNoScOpeXx,4332,1218,62,30,92,67.4%,9m
1879,1,[CuWoǂ]Toast,4332,0,1,0,1,100.0%,10m
1881,3,Poggers,4331,205,21,15,36,58.3%,4m
1881,3,[AiRǂ]SuperNova,4331,296,21,28,49,42.9%,26m
1881,1,newbie,4331,240,6,4,10,60.0%,23m
1881,3,DrBoje,4331,122,3,2,5,60.0%,17m
1885,3,BIGmuzzy,4330,236,28,31,59,47.5%,26m
1885,1,Crocodile,4330,192,4,2,6,66.7%,39m
1887,3,[FvR]ShOckWavE,4329,56,8,12,20,40.0%,16m
1887,1,GaMbit,4329,144,3,2,5,60.0%,6m
1887,1,IIIIIIIIIIII,4329,0,2,2,4,50.0%,12m
1890,3,[NISHOD]SkiLongLion,4328,101,2,4,6,33.3%,26m
1891,3,[ANGRYM]ProfFoppa,4327,1725,151,150,301,50.2%,39m
1891,3,TylerDurden,4327,545,40,49,89,44.9%,9m
1891,3,Nasste,4327,334,35,27,62,56.5%,22m
1891,1,CptWitterel,4327,668,15,15,30,50.0%,4m
1891,1,ZurbaTopova,4327,240,9,2,11,81.8%,22m
1891,1,reklemhuk,4327,428,9,7,16,56.2%,4m
1891,3,IIIIIIIIIIII,4327,38,6,9,15,40.0%,22m
1891,1,SirAspiC,4327,0,1,4,5,20.0%,4m
1899,1,PaLoaLTo,4326,689,17,10,27,63.0%,22m
1899,3,peterra,4326,190,16,26,42,38.1%,16m
1899,3,skipper,4326,319,11,7,18,61.1%,26m
1899,3,Chiller,4326,198,6,6,12,50.0%,4m
1899,3,llllllllllll,4326,4,5,4,9,55.6%,8m
1899,2,Bobbbbbbbbbb,4326,96,3,3,6,50.0%,39m
1899,3,BabinHood,4326,97,3,4,7,42.9%,26m
1906,3,Asteadus,4325,0,1,3,4,25.0%,22m
1907,1,Sayso,4324,0,0,1,1,0.0%,5m
1908,1,XIbe,4323,48,1,1,2,50.0%,14m
1908,3,IlIIllllllII,4323,0,0,5,5,0.0%,17m
1910,3,LunaticMonk,4322,177,6,5,11,54.5%,16m
1910,2,IIIIIIIIIIII,4322,46,2,3,5,40.0%,7m
1912,3,[AKALLA]Zuttbrobba,4321,658,39,51,90,43.3%,4m
1912,3,Fedak,4321,818,36,36,72,50.0%,22m
1912,3,[yubm]Eyþór,4321,76,9,14,23,39.1%,23m
1912,3,ZeeK,4321,97,3,2,5,60.0%,17m
1916,3,IamDrizzt,4320,16,1,7,8,12.5%,16m
1916,1,[ƮesXG]Tacki,4320,0,0,2,2,0.0%,12m
1916,2,[FxL]supreme,4320,0,0,4,4,0.0%,8m
1919,3,Kubex,4319,2167,671,651,1322,50.8%,22m
1919,1,[FxL]montecapute,4319,2078,116,93,209,55.5%,6m
1919,2,Sholip,4319,848,37,53,90,41.1%,8m
1919,1,[МД86]Moldovanin,4319,96,3,0,3,100.0%,39m
1919,1,Omitted,4319,48,2,1,3,66.7%,7m
1919,1,Jeezaam,4319,0,0,2,2,0.0%,7m
1925,3,[ЯD]RosscO,4318,179,9,10,19,47.4%,8m
1926,3,LorTirius,4317,1519,193,175,368,52.4%,26m
1926,2,[ĦRZ]Nowado,4317,0,0,1,1,0.0%,11m
1928,1,mouzCCbiGs,4316,380,9,7,16,56.2%,12m
1929,1,iOnlyCheeseU,4315,378,9,3,12,75.0%,16m
1930,3,cHimera,4314,8,3,6,9,33.3%,26m
1930,1,[7x]Uroba,4314,0,0,5,5,0.0%,8m
1932,3,SwarmCore,4313,1192,90,57,147,61.2%,9m
1932,3,[Babes]drainjab,4313,142,17,23,40,42.5%,12m
1934,1,IIlllIllIIll,4312,1676,163,176,339,48.1%,10m
1934,3,IIIIIIIIIIII,4312,898,53,40,93,57.0%,12m
1934,1,[Wø]SynPoO,4312,0,0,1,1,0.0%,22m
1937,3,HappyFiit,4311,496,25,10,35,71.4%,9m
1937,3,[NMSQ]DraGo,4311,331,18,18,36,50.0%,16m
1937,1,[ZestCP]INnVocation,4311,192,5,10,15,33.3%,10m
1937,1,[nB]XeNo,4311,96,3,2,5,60.0%,6m
1937,1,pepi,4311,0,1,2,3,33.3%,6m
1937,1,[TAW]storakles,4311,0,0,1,1,0.0%,39m
1943,2,BuffZerg,4310,364,19,31,50,38.0%,11m
1943,3,TIM,4310,34,6,10,16,37.5%,16m
1943,1,[Nzth]Xrestos,4310,0,0,2,2,0.0%,8m
1946,3,Calçot,4309,1123,187,162,349,53.6%,13m
1946,1,[StalkZ]Grrrr,4309,614,14,7,21,66.7%,16m
1946,1,БулкаКорицы,4309,0,0,1,1,0.0%,39m
1949,1,Evolution,4308,1315,45,14,59,76.3%,22m
1949,3,[0BO]Nilius,4308,656,40,50,90,44.4%,13m
1949,3,[ACe]Tight,4308,124,20,22,42,47.6%,16m
1949,1,FǂAbo,4308,0,1,0,1,100.0%,15m
1953,3,soniCSysteM,4307,0,1,4,5,20.0%,26m
1954,3,DaeJong,4306,2161,325,343,668,48.7%,14m
1954,2,flamender,4306,1107,107,104,211,50.7%,7m
1956,3,Doosty,4305,1260,109,91,200,54.5%,5m
1956,1,PetrolisK,4305,0,1,1,2,50.0%,15m
1958,1,[696]PraDraGoN,4304,287,8,3,11,72.7%,12m
1958,1,[Cladoq]Shard,4304,48,1,4,5,20.0%,13m
1960,3,func,4302,1161,160,155,315,50.8%,9m
1960,1,[MSUSC2]Temir,4302,1025,40,28,68,58.8%,5m
1960,1,TheLaw,4302,96,3,0,3,100.0%,22m
1963,2,[PiGPan]Bulya,4301,1639,98,113,211,46.4%,17m
1963,3,[aW]FawZi,4301,499,73,59,132,55.3%,16m
1963,3,Slowbro,4301,46,8,13,21,38.1%,16m
1966,3,Sephiroth,4300,960,40,38,78,51.3%,14m
1966,3,llllllllllll,4300,387,22,27,49,44.9%,16m
1966,1,[BRSKR]MasterK,4300,0,1,0,1,100.0%,8m
1969,1,AlienHand,4299,2279,214,219,433,49.4%,21m
1969,1,Yoyo,4299,280,9,0,9,100.0%,22m
1969,1,Miko,4299,48,1,1,2,50.0%,8m
1972,1,StaticX,4298,428,9,7,16,56.2%,22m
1972,3,[illGG]Fusher,4298,60,8,13,21,38.1%,13m
1974,3,BigDaddyDean,4297,222,26,38,64,40.6%,12m
1974,1,oSKSaka,4297,0,0,1,1,0.0%,6m
1974,1,[isIMBA]TheShrimp,4297,0,0,1,1,0.0%,4m
1977,3,[dRai]GUNDAM,4296,1700,223,233,456,48.9%,13m
1977,3,[ValidG]loganpaul,4296,612,100,37,137,73.0%,22m
1977,3,[clwz]astrapilot,4296,128,13,17,30,43.3%,23m
1980,3,UKDaza,4295,529,102,85,187,54.5%,26m
1980,3,Taeyeon,4295,1068,58,69,127,45.7%,9m
1980,1,[GoldM]DerZerFetzer,4295,1399,41,33,74,55.4%,22m
1980,3,[Sarmat]HaPe,4295,338,31,35,66,47.0%,14m
1984,3,[iX]Winnie,4294,1263,120,120,240,50.0%,4m
1984,1,[АNIME]Agumon,4294,0,1,0,1,100.0%,12m
1984,1,[ArGGEU]Ladabaz,4294,48,1,2,3,33.3%,6m
1984,1,BotoxBeeBomb,4294,0,0,1,1,0.0%,22m
1988,3,Erlin,4293,396,103,100,203,50.7%,16m
1988,1,Pigargue,4293,1382,55,10,65,84.6%,5m
1988,1,[FUNS]Drizzt,4293,83,2,5,7,28.6%,21m
1988,1,silver,4293,0,1,0,1,100.0%,6m
1992,3,Ƶarßon,4292,104,8,8,16,50.0%,13m
1993,1,[MAYEK]gabtro,4291,2240,175,165,340,51.5%,13m
1993,3,Warember,4291,1629,168,170,338,49.7%,12m
1993,1,tsakis,4291,733,23,13,36,63.9%,12m
1993,3,[VFish]VoiceOfFall,4291,148,4,6,10,40.0%,16m
1993,1,iZinHo,4291,0,0,4,4,0.0%,4m
1998,3,microchelick,4290,1970,176,181,357,49.3%,22m
1999,3,QuadIQ,4289,896,96,91,187,51.3%,5m
1999,3,Penguiner,4289,324,30,37,67,44.8%,26m
2001,1,Maestro,4288,96,3,3,6,50.0%,12m
2002,3,yar,4287,1605,462,439,901,51.3%,8m
2002,1,noFreeWill,4287,437,12,5,17,70.6%,22m
2004,1,DMJ,4286,1454,154,123,277,55.6%,4m
2004,3,Zboøby,4286,48,5,20,25,20.0%,8m
2004,1,Daggoth,4286,96,2,5,7,28.6%,12m
2004,1,[PiTi]Анунаки,4286,0,0,1,1,0.0%,14m
2008,3,Pete,4285,2148,202,216,418,48.3%,8m
2008,1,[K0mpis]Henrik,4285,1874,113,97,210,53.8%,12m
2008,1,[TBone]Blaze,4285,0,1,0,1,100.0%,8m
2008,1,[EBIG]Eiger,4285,0,0,2,2,0.0%,16m
2008,1,DICE,4285,0,0,3,3,0.0%,10m
2013,1,Gamji,4284,693,31,33,64,48.4%,6m
2013,1,Xairax,4284,0,1,0,1,100.0%,12m
2015,1,[Hrr]Tetris,4283,2147,196,190,386,50.8%,6m
2015,3,[ESOSG]PrinzZ,4283,832,47,45,92,51.1%,14m
2015,1,pAnatiC,4283,387,12,5,17,70.6%,18m
2015,2,[Blacer]Mira,4283,246,8,9,17,47.1%,14m
2015,1,BuzZer,4283,48,1,2,3,33.3%,10m
2020,1,Aliby,4282,1555,54,39,93,58.1%,13m
2020,1,Saint,4282,0,1,0,1,100.0%,10m
2022,1,CheckUrNat,4281,192,4,2,6,66.7%,24m
2022,3,Evilbrood,4281,16,4,11,15,26.7%,8m
2024,3,TuKi,4280,380,125,105,230,54.3%,39m
2024,1,Giratina,4280,518,19,9,28,67.9%,5m
2024,1,[ØC]Dicet,4280,654,14,11,25,56.0%,23m
2024,1,[ECV]Madara,4280,0,1,2,3,33.3%,17m
2024,1,Skipper,4280,48,1,2,3,33.3%,12m
2024,1,Delilah,4280,0,0,2,2,0.0%,21m
2030,3,coni,4279,1453,86,73,159,54.1%,26m
2030,3,Revival,4279,257,17,23,40,42.5%,22m
2030,1,ImBaHacK,4279,48,1,1,2,50.0%,13m
2030,1,[Afreca]Izual,4279,0,0,1,1,0.0%,4m
2030,1,TsuBeerus,4279,0,0,2,2,0.0%,8m
2030,1,[MSII]succersn,4279,0,0,2,2,0.0%,17m
2036,1,Terranosaure,4278,2072,166,165,331,50.2%,6m
2036,1,FlacidFAP,4278,2228,149,114,263,56.7%,39m
2036,3,[DHiWe]MightyThor,4278,20,5,12,17,29.4%,14m
2036,3,Mioga,4278,36,4,14,18,22.2%,23m
2036,1,Cutlery,4278,0,0,2,2,0.0%,22m
2041,3,Iamdude,4277,2130,180,159,339,53.1%,14m
2041,1,Ultimat,4277,1404,34,28,62,54.8%,18m
2041,1,llllllllllll,4277,357,14,3,17,82.4%,6m
2041,3,esfrost,4277,64,13,21,34,38.2%,23m
2041,3,Upgrayedd,4277,215,11,14,25,44.0%,26m
2041,1,Andural,4277,96,2,4,6,33.3%,23m
2047,3,БоеваяБорода,4276,1715,151,151,302,50.0%,9m
2047,1,Nice,4276,706,15,14,29,51.7%,14m
2049,3,[Batmen]ActionJaxon,4275,620,44,50,94,46.8%,23m
2049,1,Jascaw,4275,714,27,24,51,52.9%,7m
2049,1,IIIIIIIIIIII,4275,240,5,6,11,45.5%,8m
2049,3,[OSgZ]Euweb,4275,123,5,11,16,31.2%,9m
2049,1,Revenger,4275,0,0,5,5,0.0%,13m
2054,1,Thraundil,4274,1815,135,121,256,52.7%,7m
2054,3,Teardrop,4274,265,19,21,40,47.5%,14m
2054,3,[aW]VVV,4274,74,9,18,27,33.3%,8m
2054,1,IIIIIIIIIIII,4274,144,3,11,14,21.4%,8m
2058,1,[ExCS]XoRanger,4273,144,3,1,4,75.0%,12m
2059,1,[Peeps]FckVwls,4272,48,2,0,2,100.0%,4m
2059,1,[Spec]SKAÐI,4272,0,1,1,2,50.0%,15m
2061,1,Hydra,4271,2201,97,93,190,51.1%,10m
2061,3,MXuser,4271,142,17,22,39,43.6%,26m
2063,1,[jCr]TriXxx,4270,1215,74,70,144,51.4%,10m
2063,1,Maix,4270,96,3,4,7,42.9%,23m
2065,1,TiltWizard,4268,286,7,1,8,87.5%,12m
2065,3,YoiNk,4268,34,4,10,14,28.6%,26m
2065,1,SayGG,4268,96,2,1,3,66.7%,13m
2065,1,[TLRü]Annyeong,4268,96,2,6,8,25.0%,10m
2065,1,Spida,4268,0,0,2,2,0.0%,12m
2065,1,[ExTeS]WOjna,4268,0,0,4,4,0.0%,7m
2071,3,KazoO,4267,541,144,127,271,53.1%,5m
2071,3,[K0mpis]Boomer,4267,1694,81,99,180,45.0%,23m
2071,1,[MSUSC2]Panarh,4267,334,8,8,16,50.0%,7m
2071,1,IlIlIlIlIllI,4267,144,4,3,7,57.1%,10m
2071,1,[EESC]JoaN,4267,0,0,5,5,0.0%,8m
2076,1,Lego,4266,2124,69,47,116,59.5%,39m
2076,3,SIMOZ,4266,170,10,13,23,43.5%,16m
2076,3,[PŖïMĄŁ]InTotheSky,4266,12,4,9,13,30.8%,5m
2076,3,Terran,4266,0,0,1,1,0.0%,9m
2080,1,shtdisturban,4265,941,57,34,91,62.6%,16m
2080,1,Sashamon,4265,0,0,1,1,0.0%,4m
2082,1,Atomie,4264,1026,71,50,121,58.7%,12m
2082,3,shuggles,4264,3,13,16,29,44.8%,14m
2082,1,Narcelo,4264,0,1,4,5,20.0%,39m
2085,3,Tesselhoff,4263,611,40,42,82,48.8%,26m
2085,1,ZERGPREDIGT,4263,144,4,6,10,40.0%,4m
2085,1,Vince,4263,48,2,2,4,50.0%,8m
2085,1,kiru,4263,0,0,2,2,0.0%,17m
2089,1,Zenislev,4262,590,20,12,32,62.5%,12m
2089,1,ElbowBump,4262,744,16,14,30,53.3%,8m
2089,1,[RеG]PPower,4262,192,5,2,7,71.4%,6m
2089,1,PKBoy,4262,48,2,1,3,66.7%,16m
2089,1,MadJack,4262,48,2,2,4,50.0%,22m
2089,1,Zergling,4262,0,0,1,1,0.0%,39m
2095,3,last,4261,337,26,28,54,48.1%,8m
2095,1,Shirrak,4261,445,21,6,27,77.8%,6m
2095,1,IlIlIlIlIIII,4261,144,4,1,5,80.0%,8m
2098,1,Aydyn,4260,1796,117,106,223,52.5%,5m
2098,3,[OXF]Richielol,4260,431,77,70,147,52.4%,4m
2098,1,[DМG]Specnazko,4260,547,13,13,26,50.0%,13m
2098,1,RageQuit,4260,376,8,7,15,53.3%,12m
2098,1,Demah,4260,0,0,1,1,0.0%,10m
2103,1,Demaxo,4259,866,19,15,34,55.9%,16m
2103,3,[JAREK]Gumkomen,4259,169,5,6,11,45.5%,39m
2103,1,Russkiy,4259,0,1,0,1,100.0%,22m
2106,1,HelloGLHF,4258,426,9,3,12,75.0%,16m
2106,1,elise,4258,48,1,1,2,50.0%,4m
2106,1,llllllllllll,4258,48,1,5,6,16.7%,22m
2109,1,OoO,4257,1529,142,83,225,63.1%,21m
2109,1,Anomaly,4257,144,4,3,7,57.1%,25m
2109,1,MadDog,4257,144,4,4,8,50.0%,6m
2109,1,IIIIIII,4257,96,2,7,9,22.2%,12m
2113,1,[RBP3]kOliO,4256,332,7,13,20,35.0%,24m
2114,3,PolyMorpH,4255,907,99,93,192,51.6%,14m
2114,1,Elecom,4255,592,14,10,24,58.3%,13m
2114,3,Neura,4255,80,9,18,27,33.3%,14m
2114,1,Rainesy,4255,0,1,1,2,50.0%,17m
2118,1,[HBGS]MasterVasya,4254,0,1,0,1,100.0%,17m
2119,3,Meatbeaterx,4253,346,18,19,37,48.6%,8m
2119,1,Kittystalker,4253,48,2,0,2,100.0%,12m
2121,3,iSMajcioch,4252,1180,101,98,199,50.8%,39m
2121,3,[bitoQ2]charlix,4252,185,17,31,48,35.4%,16m
2121,1,HanK,4252,48,1,1,2,50.0%,10m
2121,1,[KMWTW]EarendIL,4252,0,0,2,2,0.0%,16m
2125,1,JohannesR,4251,1743,176,174,350,50.3%,18m
2125,3,GgMachineSC,4251,449,20,25,45,44.4%,26m
2125,1,Scales,4251,398,9,12,21,42.9%,21m
2125,1,[ARK88]Eman,4251,240,5,8,13,38.5%,13m
2129,1,BigBouncingB,4250,1437,69,50,119,58.0%,8m
2129,1,[ОВOЩ]Player,4250,1123,33,22,55,60.0%,12m
2129,3,[RÐ]Mazrok,4250,125,3,9,12,25.0%,22m
2132,3,[TUPL]Vulcan,4249,2120,161,171,332,48.5%,12m
2132,2,logang,4249,203,8,4,12,66.7%,9m
2132,1,[SIayer]KiRa,4249,144,4,2,6,66.7%,39m
2132,1,NoBrainPlay,4249,0,0,1,1,0.0%,13m
2136,1,Zubex,4248,733,19,13,32,59.4%,12m
2136,1,BabouLeFou,4248,724,17,16,33,51.5%,22m
2136,1,[HypC]TheSun,4248,382,9,6,15,60.0%,21m
2136,2,General,4248,46,1,5,6,16.7%,8m
2136,1,IIIIIIIIIIII,4248,0,0,4,4,0.0%,12m
2141,3,[Sarmat]SaoriKimura,4247,1276,67,74,141,47.5%,14m
2141,1,DirkGently,4247,310,14,0,14,100.0%,18m
2141,1,IIIIIIIIIIII,4247,258,6,6,12,50.0%,13m
2141,1,IlIlIlIlIlIl,4247,119,3,5,8,37.5%,6m
2141,1,Scarlatti,4247,0,0,1,1,0.0%,15m
2146,3,Alcx,4246,1381,130,132,262,49.6%,12m
2147,1,IIIIIIIIIIII,4245,140,6,4,10,60.0%,23m
2147,1,[BHESS]LeBregognon,4245,121,2,1,3,66.7%,23m
2147,1,[dziova]IIIIIIIIIIII,4245,0,1,1,2,50.0%,23m
2150,1,SuperMeatBoy,4244,240,5,8,13,38.5%,6m
2150,3,LazyTown,4244,8,4,7,11,36.4%,12m
2150,1,TrustMe,4244,0,0,1,1,0.0%,12m
2153,3,TeilobRUN,4243,1026,243,222,465,52.3%,26m
2153,3,[FIow]Crovea,4243,2062,204,186,390,52.3%,8m
2153,3,IIIIIIIIIIII,4243,611,24,13,37,64.9%,24m
2153,3,Fredde,4243,312,19,25,44,43.2%,8m
2153,1,[GNOMY]Nizioł,4243,0,1,0,1,100.0%,12m
2153,1,[H0C]JarJarBinks,4243,0,1,0,1,100.0%,6m
2153,1,IceFluffy,4243,48,1,1,2,50.0%,15m
2153,2,[HFXX]Humfluxx,4243,0,1,7,8,12.5%,15m
2161,3,WinnieThePoo,4242,2012,269,288,557,48.3%,39m
2161,1,ShadyDealer,4242,762,18,12,30,60.0%,6m
2161,1,[ØC]Beurp,4242,0,0,3,3,0.0%,16m
2164,3,Nilsson,4241,2109,295,298,593,49.7%,14m
2164,3,[LVPN]Zazar,4241,69,34,38,72,47.2%,23m
2164,3,LegendAlive,4241,20,2,11,13,15.4%,16m
2164,1,[GAMI]RIP,4241,0,1,2,3,33.3%,23m
2168,1,[bod]bernus,4240,48,2,1,3,66.7%,6m
2168,1,SilverFox,4240,96,2,4,6,33.3%,10m
2170,3,ShadowGhost,4239,2137,187,194,381,49.1%,4m
2170,3,Stone,4239,1166,149,162,311,47.9%,4m
2170,1,Macrowave,4239,2202,89,100,189,47.1%,10m
2170,1,[ePunks]Wok,4239,1314,36,33,69,52.2%,12m
2170,2,IIIIIIIIIIII,4239,251,13,0,13,100.0%,5m
2170,1,Relinquish,4239,514,12,14,26,46.2%,12m
2170,1,PriceYouPay,4239,0,1,0,1,100.0%,4m
2177,1,Andrius,4238,48,1,4,5,20.0%,5m
2178,3,BabySteps,4237,78,8,17,25,32.0%,5m
2178,1,Buggsy,4237,144,3,2,5,60.0%,15m
2180,1,Minoda,4236,1182,70,75,145,48.3%,24m
2180,1,Zeer,4236,96,3,3,6,50.0%,6m
2180,1,[BornG]AsheN,4236,0,0,1,1,0.0%,23m
2183,1,[Kompis]YourMajesty,4235,1004,46,40,86,53.5%,7m
2183,1,CarryGun,4235,570,12,13,25,48.0%,13m
2183,1,[PLA2N]rom,4235,192,4,8,12,33.3%,7m
2186,3,Grumpy,4234,1791,273,261,534,51.1%,17m
2186,3,exbugs,4234,1199,120,111,231,51.9%,14m
2186,1,[RPJC]Kata,4234,760,23,17,40,57.5%,6m
2186,1,Loirid,4234,300,16,10,26,61.5%,16m
2186,1,[MkersA]Tiwie,4234,0,0,3,3,0.0%,8m
2191,3,[NMSQ]Sareth,4233,643,88,85,173,50.9%,22m
2192,3,Siegemajster,4232,1598,81,90,171,47.4%,26m
2192,3,[NoMczZ]Tokkie,4232,124,14,25,39,35.9%,14m
2192,1,llllllllllll,4232,48,2,1,3,66.7%,4m
2195,3,Dukuso,4231,1691,99,80,179,55.3%,9m
2195,1,StrongBronze,4231,841,31,15,46,67.4%,6m
2195,1,LastDray,4231,0,0,1,1,0.0%,8m
2198,3,xdxdxdxdxdxd,4230,505,138,141,279,49.5%,16m
2198,1,[nKnown]Schizophren,4230,192,4,2,6,66.7%,8m
2200,1,LabCoatLarry,4229,1006,22,20,42,52.4%,12m
2200,1,Valdemar,4229,334,7,10,17,41.2%,22m
2200,1,Mytyc,4229,48,1,4,5,20.0%,23m
2203,1,Masterz,4228,1098,25,24,49,51.0%,4m
2203,1,Snakeair,4228,0,0,1,1,0.0%,24m
2203,1,WannaBeЯкЯк,4228,0,0,1,1,0.0%,16m
2206,1,[ProRax]WhiteGhost,4227,2106,125,134,259,48.3%,7m
2206,3,Bayan,4227,1501,119,125,244,48.8%,8m
2208,1,[BeSC]BlackBoX,4226,96,2,6,8,25.0%,18m
2209,3,[Heroes]NoControl,4225,1071,284,226,510,55.7%,4m
2209,1,NOOBER,4225,1937,274,242,516,53.1%,21m
2209,1,Seco,4225,1730,219,220,439,49.9%,6m
2209,1,Xufe,4225,1462,35,39,74,47.3%,7m
2209,1,[LLFF]Hydroxi,4225,742,16,21,37,43.2%,18m
2209,1,[АDV]JSon,4225,562,12,8,20,60.0%,8m
2209,1,Sam,4225,192,5,7,12,41.7%,8m
2209,2,ExpressImba,4225,0,0,1,1,0.0%,39m
2217,3,LinuxUser,4223,1100,177,156,333,53.2%,14m
2217,1,Potemkin,4223,2198,157,124,281,55.9%,23m
2217,1,Takeiteasy,4223,1076,51,30,81,63.0%,6m
2217,1,noobforever,4223,941,23,8,31,74.2%,12m
2217,1,ChaTLaHiH,4223,1042,23,27,50,46.0%,5m
2217,1,BlueDevil,4223,96,3,5,8,37.5%,22m
2223,3,[neuroW]Avatron,4222,1096,53,57,110,48.2%,8m
2223,1,[SLB]ScReaM,4222,420,9,10,19,47.4%,22m
2225,3,Case,4221,2070,488,485,973,50.2%,14m
2226,1,spArk,4220,1268,40,18,58,69.0%,23m
2226,1,[Xa]Cerambice,4220,1151,38,29,67,56.7%,22m
2226,1,[TKAP]Koka,4220,900,20,20,40,50.0%,7m
2226,1,[HBGSJR]SkAyTOnFire,4220,380,8,14,22,36.4%,12m
2226,1,[ArGGEU]JustNUKE,4220,0,1,0,1,100.0%,39m
2226,1,MenTor,4220,0,1,4,5,20.0%,7m
2226,1,[IƆG]Paōn,4220,0,0,5,5,0.0%,6m
2233,1,Discourage,4219,1648,48,40,88,54.5%,25m
2233,1,[PŖïMĄŁ]Euron,4219,932,22,13,35,62.9%,5m
2233,1,[KUG]Kane,4219,0,1,0,1,100.0%,6m
2233,1,[CPSLCK]Eule,4219,0,0,2,2,0.0%,8m
2237,1,OnLine,4218,0,0,1,1,0.0%,22m
2237,1,IIIIIIIIIIII,4218,0,0,2,2,0.0%,8m
2237,1,MxL,4218,0,0,5,5,0.0%,17m
2240,3,ZeratulsBud,4217,2055,604,611,1215,49.7%,14m
2240,1,CaptainTruel,4217,1289,31,21,52,59.6%,13m
2240,3,Ibanez,4217,4,1,10,11,9.1%,18m
2243,3,[IDLK]jasben,4216,1952,403,414,817,49.3%,16m
2243,3,Flu,4216,2053,386,398,784,49.2%,12m
2243,3,[ØC]yukimurahhh,4216,803,50,56,106,47.2%,26m
2243,3,[GRNSKN]Sadist,4216,495,31,39,70,44.3%,39m
2243,1,AkaburRules,4216,965,24,12,36,66.7%,22m
2243,1,llllllllllll,4216,0,3,2,5,60.0%,6m
2243,1,AlTresTeVoy,4216,96,2,2,4,50.0%,39m
2243,1,Tren,4216,0,1,1,2,50.0%,23m
2243,1,[VFN]SharkBait,4216,48,1,2,3,33.3%,25m
2252,1,HTD,4215,2215,573,529,1102,52.0%,8m
2252,1,Cleo,4215,1176,221,195,416,53.1%,17m
2252,3,[AiRǂ]rIpSatomi,4215,1159,96,117,213,45.1%,14m
2252,1,Eliphas,4215,1076,30,26,56,53.6%,12m
2252,1,RataChepuda,4215,192,7,0,7,100.0%,6m
2252,1,Skeptic,4215,0,0,1,1,0.0%,6m
2258,3,[LøL]JiKu,4214,1737,205,200,405,50.6%,5m
2258,1,[ĦRZ]mindjames,4214,1465,53,55,108,49.1%,17m
2258,1,TerenZ,4214,236,5,5,10,50.0%,15m
2258,3,YogSottoth,4214,16,5,13,18,27.8%,14m
2258,1,shadowofmich,4214,48,2,2,4,50.0%,15m
2258,3,[Hack]Kyliane,4214,2,1,9,10,10.0%,26m
2264,1,GeitStar,4213,854,25,19,44,56.8%,10m
2265,3,UnGemm,4212,1090,74,66,140,52.9%,14m
2265,3,[SY2G]Nath,4212,6,1,9,10,10.0%,22m
2267,1,Lostway,4211,2220,141,143,284,49.6%,12m
2267,1,LearnToScout,4211,835,29,17,46,63.0%,6m
2267,1,[WeYuCo]Crunch,4211,1122,26,18,44,59.1%,18m
2267,1,[nyya]MeOw,4211,0,1,2,3,33.3%,17m
2267,1,Schrikdraad,4211,48,1,2,3,33.3%,22m
2272,1,[KoyBee]TROTSKY,4210,1761,75,43,118,63.6%,4m
2273,1,[Dobro]RubRub,4209,1450,36,31,67,53.7%,22m
2273,1,LuNe,4209,334,7,4,11,63.6%,25m
2273,1,mrf,4209,0,0,1,1,0.0%,23m
2276,3,[MuE]Creepy,4208,501,122,89,211,57.8%,26m
2276,3,IIIIIIIIIIII,4208,875,52,66,118,44.1%,26m
2276,1,Malicious,4208,94,2,2,4,50.0%,17m
2276,1,Sam,4208,96,2,4,6,33.3%,13m
2276,1,Rukin,4208,0,1,0,1,100.0%,12m
2276,1,[PLA2N]Lisara,4208,0,0,1,1,0.0%,25m
2282,1,[TmVsn]obi,4207,2173,98,95,193,50.8%,17m
2282,1,TheCrane,4207,916,79,64,143,55.2%,12m
2282,1,JauneD,4207,1557,58,56,114,50.9%,6m
2282,1,Arcticus,4207,144,3,6,9,33.3%,4m
2282,1,Smile,4207,48,2,0,2,100.0%,22m
2282,1,Nsya,4207,48,1,1,2,50.0%,8m
2282,1,RnG,4207,48,1,2,3,33.3%,16m
2282,1,MacroMonster,4207,48,1,3,4,25.0%,6m
2290,1,ShowKhan,4206,997,52,40,92,56.5%,5m
2290,3,[JILLZ]Cyber,4206,67,29,41,70,41.4%,4m
2290,1,[HRoP]dmcRO,4206,48,1,3,4,25.0%,4m
2293,2,jonk,4205,1506,140,153,293,47.8%,17m
2293,1,[PaniC]MaximaLCrazY,4205,48,2,4,6,33.3%,4m
2295,3,Rocky,4204,1278,121,120,241,50.2%,12m
2295,1,почтиМС,4204,426,10,6,16,62.5%,5m
2295,1,[KRAKOT]Wiztek,4204,374,9,2,11,81.8%,12m
2295,1,[ƮesXG]MästareN,4204,0,0,2,2,0.0%,13m
2299,1,Awin,4203,2093,80,72,152,52.6%,7m
2299,1,droku,4203,1016,23,23,46,50.0%,18m
2299,1,HissigFuru,4203,0,0,1,1,0.0%,6m
2302,1,MVPSniper,4202,498,24,9,33,72.7%,4m
2302,1,[GoldM]KhalDrono,4202,604,13,17,30,43.3%,23m
2304,1,FleckenZwerg,4201,1816,105,108,213,49.3%,16m
2304,3,CheesusChrst,4201,978,83,86,169,49.1%,4m
2304,3,[SEWP]Aeterno,4201,1136,55,54,109,50.5%,14m
2304,1,Anni,4201,794,31,18,49,63.3%,17m
2304,1,kerry,4201,834,26,25,51,51.0%,25m
2304,1,[Wolven]Jhiaxus,4201,831,20,21,41,48.8%,4m
2304,1,[R33]Damnight,4201,392,12,6,18,66.7%,13m
2304,1,ФанатЛопатки,4201,327,7,3,10,70.0%,23m
2304,1,[TV]GreedyTV,4201,286,7,4,11,63.6%,16m
2304,1,[PLA2N]Tokyo,4201,284,6,9,15,40.0%,10m
2304,1,HoeFNeHoeF,4201,0,0,1,1,0.0%,15m
2315,1,[xp]Parttom,4200,828,18,27,45,40.0%,6m
2315,1,SONNY,4200,0,0,1,1,0.0%,16m
2317,1,GaliX,4199,2029,337,314,651,51.8%,10m
2317,3,lymF,4199,217,10,14,24,41.7%,39m
2317,3,zoidberg,4199,8,2,10,12,16.7%,14m
2317,2,[2izi]TrqR,4199,0,1,0,1,100.0%,6m
2321,1,[WBO]iloveyou,4197,2070,152,122,274,55.5%,8m
2321,1,NoWeHere,4197,1146,59,22,81,72.8%,23m
2321,1,Change,4197,915,26,9,35,74.3%,15m
2321,3,[ProRAT]InSiJa,4197,140,19,31,50,38.0%,14m
2321,1,IIIIIIIIII,4197,0,1,0,1,100.0%,8m
2326,1,imba,4196,708,20,13,33,60.6%,15m
2326,1,Candy,4196,515,12,13,25,48.0%,12m
2326,1,RDBTheOne,4196,48,1,4,5,20.0%,7m
2329,1,IIIIIIIIIIII,4195,2172,130,116,246,52.8%,10m
2329,1,[RBlood]Fotylex,4195,1107,45,44,89,50.6%,8m
2329,1,Svagu,4195,0,1,8,9,11.1%,21m
2329,1,[AiRǂ]Tommaso,4195,0,0,1,1,0.0%,16m
2333,1,[MACLUL]Pharai,4194,48,1,9,10,10.0%,12m
2334,1,[HeZe]LennyTheLing,4193,1612,91,94,185,49.2%,12m
2334,1,nommnommnomm,4193,284,6,4,10,60.0%,21m
2334,1,[ENV]DarkSoul,4193,96,2,3,5,40.0%,14m
2334,3,Sindyr,4193,16,1,17,18,5.6%,12m
2334,3,[GAMI]Wejdene,4193,0,0,5,5,0.0%,21m
2339,1,Arek,4192,1158,155,135,290,53.4%,18m
2339,1,KupaTrupa,4192,2090,141,135,276,51.1%,25m
2339,3,FishyFetus,4192,2058,97,108,205,47.3%,17m
2339,1,[RecoN]Rams,4192,958,23,26,49,46.9%,17m
2339,1,[EXPANT]JarBaX,4192,382,8,7,15,53.3%,18m
2339,1,[TrshTm]Skilerlet,4192,96,2,7,9,22.2%,6m
2339,1,[HBGS]leon,4192,73,0,2,2,0.0%,22m
2346,1,[NGk]DeadGame,4191,1490,67,50,117,57.3%,12m
2346,1,[TheDOH]Daniello,4191,96,2,5,7,28.6%,17m
2346,2,[Heroes]Xylophone,4191,0,0,1,1,0.0%,5m
2349,1,ZerlingKing,4190,1354,32,32,64,50.0%,22m
2349,1,Protosex,4190,329,11,4,15,73.3%,18m
2349,1,[ǂHD]Aura,4190,192,4,3,7,57.1%,10m
2352,1,Phaon,4189,1070,59,64,123,48.0%,15m
2352,1,[IceHus]IIIIIIIIIII,4189,433,17,11,28,60.7%,5m
2352,1,Spartan,4189,0,0,7,7,0.0%,8m
2355,1,DHB,4188,0,0,1,1,0.0%,8m
2356,1,Jaystar,4187,469,17,4,21,81.0%,23m
2356,1,[3Tp]Ray,4187,0,0,1,1,0.0%,8m
2358,1,[HBGSJR]HoldTight,4186,1250,42,34,76,55.3%,10m
2358,1,[Hrr]Tonyslark,4186,0,0,1,1,0.0%,23m
2360,1,Moqq,4185,1812,55,53,108,50.9%,6m
2360,1,[Dlck]Varkosh,4185,884,19,28,47,40.4%,4m
2360,1,[UATeam]NtStreamline,4185,836,18,20,38,47.4%,4m
2360,1,[BRSKR]Restform,4185,692,15,24,39,38.5%,4m
2360,1,granati,4185,286,6,6,12,50.0%,13m
2360,3,llllllllllll,4185,0,5,0,5,100.0%,15m
2360,1,natSukiSocks,4185,0,1,0,1,100.0%,21m
2367,3,Zaja,4184,2060,160,171,331,48.3%,4m
2367,3,[PŖïMĄŁ]BlueS,4184,1083,57,38,95,60.0%,23m
2367,1,[dDb]Halalkött,4184,192,4,2,6,66.7%,8m
2370,1,Magnet,4183,879,41,23,64,64.1%,7m
2370,1,[GTD]xyCz,4183,48,1,4,5,20.0%,15m
2370,1,[NISC]VoiDz,4183,0,0,3,3,0.0%,23m
2373,1,[AlIin]EUez,4182,192,4,1,5,80.0%,4m
2374,2,[EmŦ]Taru,4181,1997,236,256,492,48.0%,5m
2374,3,XyroN,4181,890,147,144,291,50.5%,14m
2374,1,leo,4181,1565,101,63,164,61.6%,8m
2377,1,têtedepioche,4180,2196,185,156,341,54.3%,22m
2377,1,KEKW,4180,360,11,9,20,55.0%,18m
2377,1,Bladgier,4180,48,1,2,3,33.3%,13m
2377,1,KimJongNuke,4180,0,0,1,1,0.0%,23m
2381,1,Jigsaw,4179,0,0,1,1,0.0%,5m
2382,3,Oula,4178,2053,189,200,389,48.6%,24m
2382,1,BamBigelow,4178,424,9,10,19,47.4%,6m
2384,1,ZloiGad,4177,2192,535,523,1058,50.6%,22m
2384,1,[aW]Sminse,4177,1452,38,33,71,53.5%,13m
2384,1,[gaiboi]Nero,4177,1072,26,27,53,49.1%,5m
2387,3,Convict,4176,1536,296,280,576,51.4%,9m
2387,3,Delevingne,4176,612,101,126,227,44.5%,17m
2389,3,Bondekonge,4175,1029,267,280,547,48.8%,16m
2389,1,Breakdown,4175,634,15,14,29,51.7%,23m
2389,2,[Hаsu]Ajukreizi,4175,276,14,2,16,87.5%,5m
2389,1,DOEBY,4175,459,10,8,18,55.6%,24m
2389,1,[FSeS]VOID,4175,0,1,0,1,100.0%,15m
2389,2,[Blacer]Cobra,4175,0,0,1,1,0.0%,7m
2389,1,Eyeballers,4175,0,0,4,4,0.0%,17m
2389,1,[EESC]NuRoad,4175,0,0,5,5,0.0%,22m
2397,1,PoulpeMalade,4174,331,16,1,17,94.1%,39m
2397,1,Consultant,4174,288,10,6,16,62.5%,39m
2397,1,[zzzzup]ChaosMind,4174,284,6,2,8,75.0%,23m
2400,1,[IceHus]законМерфи,4173,2105,213,206,419,50.8%,18m
2400,1,Gatsby,4173,0,1,0,1,100.0%,18m
2400,1,discordgf,4173,48,1,8,9,11.1%,12m
2400,1,SnipeFive,4173,0,0,1,1,0.0%,21m
2404,1,[Obl]Salade,4172,1926,109,97,206,52.9%,25m
2404,1,[PÂRłAH]robotikov,4172,734,17,10,27,63.0%,16m
2404,1,[Sn1p3d]brokkoli,4172,142,6,5,11,54.5%,15m
2404,1,[PŖïMĄŁ]Lysander,4172,144,3,7,10,30.0%,13m
2404,1,Kawa,4172,0,0,1,1,0.0%,4m
2409,1,Darwin,4171,1368,37,33,70,52.9%,7m
2410,3,soratanobaka,4170,1479,437,460,897,48.7%,4m
2410,1,dcare,4170,2169,168,128,296,56.8%,17m
2410,3,Mojoadam,4170,909,149,138,287,51.9%,17m
2410,3,[DisES]Sylfaen,4170,185,23,30,53,43.4%,23m
2410,1,[MD86]AlexeiMD,4170,282,6,9,15,40.0%,22m
2410,1,[HTY]LOL,4170,190,5,5,10,50.0%,12m
2410,2,[AnD]llllllllllll,4170,90,3,0,3,100.0%,26m
2410,2,[HBGS]Bazamba,4170,0,1,0,1,100.0%,18m
2410,1,[FUPS]Drogi,4170,0,1,0,1,100.0%,15m
2410,1,[CocoCo]KillerSteel,4170,0,1,0,1,100.0%,8m
2420,1,[1NO2]FaTa,4169,2069,64,55,119,53.8%,6m
2420,1,Fathra,4169,583,15,8,23,65.2%,7m
2422,1,[AoTu]Yellowio,4168,2107,172,172,344,50.0%,12m
2422,1,blessed,4168,451,34,14,48,70.8%,10m
2422,2,Phive,4168,86,2,1,3,66.7%,6m
2422,1,Vortex,4168,46,1,2,3,33.3%,15m
2426,1,Finngail,4167,1413,64,19,83,77.1%,39m
2426,1,Euforia,4167,1248,59,38,97,60.8%,10m
2426,1,InnKeepeR,4167,48,4,2,6,66.7%,15m
2426,1,[LV]zichus,4167,96,3,1,4,75.0%,13m
2430,1,[FxL]Bojan,4166,1606,44,35,79,55.7%,39m
2430,1,[HBGS]JEROS,4166,989,28,17,45,62.2%,15m
2430,1,[R33]Cocò,4166,359,11,4,15,73.3%,12m
2433,1,[PaniC]Gongilimb,4165,1422,33,40,73,45.2%,25m
2433,1,llllllllllll,4165,594,14,8,22,63.6%,22m
2433,1,simozor,4165,660,14,16,30,46.7%,15m
2436,1,Whooper,4164,2174,371,380,751,49.4%,24m
2436,1,kjpeans,4164,2166,77,74,151,51.0%,6m
2436,1,[Litty]StackedGamer,4164,1404,35,40,75,46.7%,23m
2436,1,[CYC]SooThSayeR,4164,938,21,22,43,48.8%,12m
2436,1,[NetGG]Antlko,4164,776,18,14,32,56.2%,4m
2436,3,[HBGSJR]Rise,4164,221,13,24,37,35.1%,14m
2436,1,ponchato,4164,0,0,2,2,0.0%,16m
2443,1,[TAGG]PowerPaul,4163,980,37,20,57,64.9%,6m
2443,1,[FATDEB]Peski,4163,48,2,3,5,40.0%,7m
2443,1,[opFaiL]danischu,4163,0,0,1,1,0.0%,21m
2446,1,Rage,4162,370,19,6,25,76.0%,12m
2446,1,llllllllll,4162,291,16,9,25,64.0%,12m
2446,1,[GRONOT]Ohad,4162,420,15,16,31,48.4%,25m
2446,1,Loy,4162,0,1,0,1,100.0%,5m
2446,1,[VuV]Teage,4162,46,1,2,3,33.3%,8m
2451,1,[SCiE]TinToon,4161,652,14,18,32,43.8%,4m
2451,1,MǂLalush,4161,240,5,11,16,31.2%,13m
2453,3,[Dlbt]Dalabete,4160,1438,78,89,167,46.7%,14m
2453,1,[PÂRłAH]Heli,4160,284,6,3,9,66.7%,25m
2453,1,[FxL]Lapin,4160,192,4,7,11,36.4%,12m
2456,1,Bethowen,4159,286,6,9,15,40.0%,22m
2456,1,Ronny,4159,48,2,3,5,40.0%,15m
2458,1,Ptato,4158,240,7,8,15,46.7%,23m
2458,1,DarkRaven,4158,0,1,0,1,100.0%,23m
2458,1,llllllllllll,4158,0,0,2,2,0.0%,22m
2461,1,[MoopyS]Eternity,4157,1193,40,37,77,51.9%,24m
2461,1,rexy,4157,62,3,1,4,75.0%,13m
2463,1,Dinosaur,4155,670,18,6,24,75.0%,8m
2463,1,[APeC]Typhon,4155,330,7,14,21,33.3%,22m
2463,1,Urnec,4155,238,5,13,18,27.8%,17m
2463,1,JacobGayCop,4155,144,4,4,8,50.0%,12m
2463,1,[slayn]Rainbowdream,4155,48,2,4,6,33.3%,14m
2468,3,[ClassA]arifin,4153,1301,71,79,150,47.3%,18m
2468,1,Peporinho,4153,880,32,35,67,47.8%,12m
2468,1,Ceraldor,4153,755,30,19,49,61.2%,13m
2468,1,tidusff,4153,144,3,8,11,27.3%,17m
2468,2,IngSoc,4153,0,1,0,1,100.0%,22m
2473,3,michi,4152,1365,91,79,170,53.5%,9m
2473,1,llllllllllll,4152,1037,40,29,69,58.0%,6m
2473,1,[R0]MosteniK,4152,144,4,7,11,36.4%,23m
2473,1,KNUCKLEHEAD,4152,96,3,2,5,60.0%,7m
2473,1,[TeamDE]anubis,4152,48,2,2,4,50.0%,7m
2473,1,DaniDinBanat,4152,0,0,2,2,0.0%,13m
2479,3,[ESS]petitpoussin,4151,116,16,26,42,38.1%,26m
2480,3,[ĦRZ]Ewayx,4150,1496,200,195,395,50.6%,23m
2480,1,[QTp2T]Zoxx,4150,1151,34,33,67,50.7%,6m
2480,3,[MiFiS]Persephal,4150,593,27,28,55,49.1%,25m
2480,1,IIIIIIIIIIII,4150,192,5,1,6,83.3%,14m
2480,1,[ØC]DiaBolo,4150,96,2,6,8,25.0%,8m
2480,1,[kogt]And,4150,0,0,1,1,0.0%,16m
2486,1,IIIIIIIIIIII,4149,1090,57,51,108,52.8%,15m
2486,1,JWors,4149,709,20,9,29,69.0%,17m
2486,1,[Cannоn]HotGirl,4149,0,1,4,5,20.0%,15m
2486,1,[AwFK]Hellalive,4149,48,1,10,11,9.1%,22m
2490,1,DayDream,4148,461,14,15,29,48.3%,17m
2490,1,KillerWhale,4148,240,5,1,6,83.3%,16m
2490,1,robotter,4148,120,4,6,10,40.0%,10m
2493,1,vasilig,4147,2133,161,159,320,50.3%,12m
2493,1,meti,4147,502,15,14,29,51.7%,7m
2493,1,ToadSage,4147,628,14,11,25,56.0%,39m
2493,1,[NJF]Psyduck,4147,96,3,4,7,42.9%,12m
2493,3,[BRSKR]TeaCup,4147,2,3,7,10,30.0%,26m
2498,3,[JDМ]SlotH,4146,1073,53,57,110,48.2%,23m
2498,2,Galneryus,4146,158,10,1,11,90.9%,5m
2498,1,[IceHus]IceRai,4146,380,9,20,29,31.0%,5m
2498,1,siBeling,4146,142,3,2,5,60.0%,12m
2502,1,Xill,4145,1557,159,153,312,51.0%,17m
2502,1,Tesla,4145,48,1,5,6,16.7%,22m
2502,1,Swejke,4145,0,0,1,1,0.0%,7m
2502,1,Dark,4145,0,0,2,2,0.0%,13m
2502,1,WALLE,4145,0,0,5,5,0.0%,39m
2507,1,Hiroshi,4144,869,62,60,122,50.8%,10m
2507,1,Stebbins,4144,783,20,13,33,60.6%,10m
2507,1,prodi,4144,718,18,18,36,50.0%,8m
2507,1,Frost,4144,0,0,1,1,0.0%,18m
2511,1,kanal,4143,192,7,4,11,63.6%,23m
2511,1,epoch,4143,133,4,1,5,80.0%,7m
2511,1,Tzin,4143,46,2,5,7,28.6%,4m
2514,1,Vipersting,4142,1493,319,297,616,51.8%,13m
2514,2,Pengy,4142,229,13,1,14,92.9%,6m
2514,2,FarMoR,4142,44,2,1,3,66.7%,39m
2517,1,[NerCC]Nerzgul,4141,2065,164,145,309,53.1%,5m
2517,1,DeadInside,4141,1441,123,112,235,52.3%,18m
2517,1,CAOCAO,4141,892,39,27,66,59.1%,15m
2517,1,[vMAIv]ReDZerg,4141,330,7,6,13,53.8%,4m
2517,1,miwa,4141,0,1,0,1,100.0%,15m
2522,3,Xaaros,4140,2045,162,181,343,47.2%,14m
2522,3,rodent,4140,1210,80,81,161,49.7%,25m
2522,1,[IceHus]llllllllllll,4140,1103,42,28,70,60.0%,8m
2522,1,General,4140,1076,31,16,47,66.0%,23m
2522,3,YooZ,4140,245,17,28,45,37.8%,23m
2522,1,IlIllIlllIlI,4140,536,15,4,19,78.9%,22m
2522,1,WonderWorker,4140,144,4,2,6,66.7%,4m
2522,1,[FxL]DrDragon,4140,0,0,1,1,0.0%,4m
2530,1,Thenix,4139,2096,141,146,287,49.1%,10m
2530,1,[SaneGG]Rednax,4139,96,6,3,9,66.7%,23m
2530,1,HaviLing,4139,48,1,4,5,20.0%,12m
2530,1,[Xa]Fantasy,4139,0,0,3,3,0.0%,25m
2534,1,[ÆR]CacoS,4138,96,2,2,4,50.0%,7m
2534,1,[SLover]WinteR,4138,0,1,7,8,12.5%,12m
2536,1,[Maegis]SherKhan,4137,476,11,18,29,37.9%,17m
2536,3,[isIMBA]Silvisor,4137,0,0,5,5,0.0%,14m
2538,1,[TAW]Pote,4136,2148,591,581,1172,50.4%,13m
2538,1,IIIIIIIIIIII,4136,1979,194,190,384,50.5%,8m
2538,1,Killborne,4136,240,5,7,12,41.7%,4m
2538,2,Plumeria,4136,80,2,8,10,20.0%,10m
2538,1,Zecrum,4136,0,1,0,1,100.0%,39m
2538,1,FDGoodVX,4136,0,1,0,1,100.0%,18m
2538,1,YoungSoul,4136,48,1,3,4,25.0%,8m
2538,3,kkthxbye,4136,0,1,4,5,20.0%,17m
2538,1,[сSсǃ]skymaybe,4136,0,0,1,1,0.0%,12m
2547,1,ponal,4135,1409,68,63,131,51.9%,12m
2547,1,GHOST,4135,728,17,21,38,44.7%,8m
2547,1,[NNK]Kabanos,4135,0,0,1,1,0.0%,22m
2550,1,Interactive,4134,635,22,24,46,47.8%,15m
2551,1,SmokieMacPot,4133,227,20,7,27,74.1%,13m
2551,1,Pzzz,4133,656,16,17,33,48.5%,23m
2551,1,[R3IGN]BurnheadPhD,4133,192,5,3,8,62.5%,7m
2551,2,llllllllllll,4133,0,0,3,3,0.0%,9m
2551,3,MystiH,4133,0,0,5,5,0.0%,4m
2556,1,Muli,4132,2033,97,79,176,55.1%,6m
2556,1,DePuce,4132,1810,93,69,162,57.4%,8m
2556,1,othroth,4132,1812,93,70,163,57.1%,39m
2556,1,Maix,4132,337,10,4,14,71.4%,6m
2556,3,[Luten]Saixy,4132,30,3,3,6,50.0%,6m
2556,1,OpenZoo,4132,48,2,2,4,50.0%,6m
2556,1,Plutarch,4132,0,1,0,1,100.0%,8m
2563,2,pusssySlayer,4131,285,11,3,14,78.6%,14m
2563,1,[JAFFE]tonnis,4131,522,11,18,29,37.9%,8m
2563,1,[CH1337]Newhill,4131,468,10,10,20,50.0%,13m
2563,1,Akuretari,4131,363,10,14,24,41.7%,8m
2563,1,LoXeS,4131,234,6,6,12,50.0%,8m
2563,1,PuMa,4131,48,1,2,3,33.3%,16m
2569,1,Wortie,4130,2113,237,216,453,52.3%,8m
2569,1,ChikoSATAN,4130,0,0,2,2,0.0%,8m
2571,1,Grimm,4129,1307,62,45,107,57.9%,8m
2571,1,[AG]BlueBlood,4129,954,22,24,46,47.8%,10m
2571,1,[DoS98]yantis,4129,176,4,3,7,57.1%,12m
2571,1,wookieechckn,4129,0,1,0,1,100.0%,25m
2571,2,ChillOutDude,4129,36,1,1,2,50.0%,39m
2576,1,Xepharis,4128,1831,137,131,268,51.1%,4m
2576,1,[ArGGEU]Highscribe,4128,2106,76,66,142,53.5%,10m
2576,1,[MaMoGl]RASK,4128,1159,45,20,65,69.2%,16m
2576,1,FrogZodiak,4128,1299,44,42,86,51.2%,25m
2576,1,Reiyon,4128,0,0,2,2,0.0%,8m
2581,1,[3Dǃ]QTeeY,4127,2157,156,136,292,53.4%,7m
2581,1,[ValidG]AmandaGoats,4127,2153,107,114,221,48.4%,22m
2581,1,blanka,4127,586,13,20,33,39.4%,23m
2581,1,[115Par]Drone,4127,0,0,1,1,0.0%,17m
2585,1,[Kompis]eNJi,4126,286,6,12,18,33.3%,23m
2585,1,[RBlood]DVNWeak,4126,96,3,2,5,60.0%,12m
2587,1,[LSPs]Wiji,4125,2120,115,91,206,55.8%,39m
2587,1,SOLrEUnder,4125,555,16,7,23,69.6%,39m
2587,1,Mubbies,4125,0,1,0,1,100.0%,18m
2590,1,Sygard,4124,1564,57,56,113,50.4%,22m
2590,1,[αX]wilmaus,4124,1145,47,44,91,51.6%,15m
2590,1,[НТТ]DonLingo,4124,990,26,29,55,47.3%,23m
2590,1,zpt,4124,525,12,13,25,48.0%,13m
2590,2,NooBNooB,4124,0,1,0,1,100.0%,5m
2590,1,MEDIV,4124,0,0,3,3,0.0%,12m
2590,1,[HsDL]TheCrow,4124,0,0,8,8,0.0%,15m
2597,3,KendreeamTV,4123,655,63,69,132,47.7%,16m
2597,1,[TuSG]Shuuragksh,4123,48,2,0,2,100.0%,17m
2597,1,Potet,4123,0,1,5,6,16.7%,8m
2600,3,THAmarx,4122,2022,365,360,725,50.3%,9m
2600,3,[Hybr1d]ADG,4122,1897,97,101,198,49.0%,18m
2600,1,[3Dǃ]WInght,4122,1764,56,44,100,56.0%,16m
2600,1,Bartholomaus,4122,564,13,16,29,44.8%,10m
2600,1,[213123]HumanScum,4122,322,6,5,11,54.5%,16m
2600,1,TerranUApart,4122,240,6,6,12,50.0%,21m
2600,1,llllllllllll,4122,0,0,3,3,0.0%,13m
2607,1,Mapusan,4121,1843,48,56,104,46.2%,15m
2607,1,[Kingz]Gram,4121,1033,36,18,54,66.7%,17m
2607,1,LetsLearn,4121,713,28,10,38,73.7%,12m
2607,1,red,4121,313,9,10,19,47.4%,7m
2607,1,[simon]Simon,4121,232,5,8,13,38.5%,8m
2607,1,NineOutOfTen,4121,48,1,3,4,25.0%,23m
2607,1,scДВАmhТЧКru,4121,0,0,2,2,0.0%,15m
2614,1,NotSoGood,4120,1159,38,21,59,64.4%,24m
2614,1,Jastedong,4120,48,2,1,3,66.7%,8m
2616,1,MiniGazou,4119,1097,34,23,57,59.6%,7m
2616,1,[LESeV]NotEnoughSpd,4119,734,26,24,50,52.0%,25m
2616,1,kirilop,4119,0,1,1,2,50.0%,25m
2616,1,[ÖRRR]Whaittis,4119,0,1,2,3,33.3%,4m
2616,1,STRlKER,4119,48,1,2,3,33.3%,39m
2616,1,[ƬC]bordbonen,4119,48,1,5,6,16.7%,8m
2622,1,OneDirection,4118,1487,143,117,260,55.0%,23m
2622,1,XenoSlimE,4118,1827,47,55,102,46.1%,10m
2622,3,Religion,4118,0,1,0,1,100.0%,23m
2625,2,spark,4117,2154,482,504,986,48.9%,24m
2625,1,llllllllllll,4117,1235,62,49,111,55.9%,6m
2625,1,Dreamer,4117,819,23,12,35,65.7%,22m
2625,1,[KirD]smarrigrotta,4117,0,0,3,3,0.0%,12m
2629,1,[RGSC2]MrLEzOffFire,4116,2120,129,105,234,55.1%,39m
2629,1,Liquid,4116,48,2,0,2,100.0%,15m
2629,1,hurz,4116,46,1,4,5,20.0%,8m
2629,1,NereoS,4116,48,1,4,5,20.0%,5m
2633,1,Maillon,4115,1384,43,42,85,50.6%,13m
2633,2,чвпвпвр,4115,438,18,5,23,78.3%,24m
2633,1,StepO,4115,362,9,12,21,42.9%,15m
2633,1,festyr,4115,96,2,6,8,25.0%,13m
2633,1,[UATeam]LFRSergey,4115,0,0,1,1,0.0%,21m
2638,3,[RSCB]RODRIGO,4114,1603,77,90,167,46.1%,39m
2638,1,MattThePie,4114,895,47,51,98,48.0%,7m
2638,1,Lokikette,4114,0,0,2,2,0.0%,39m
2638,1,[SLAAAP]LoadBlaster,4114,0,0,3,3,0.0%,25m
2642,2,StreamZZang,4113,200,12,0,12,100.0%,15m
2642,3,Ecstasy,4113,0,1,0,1,100.0%,22m
2644,1,Euphoria,4112,2156,251,218,469,53.5%,4m
2644,1,lousa,4112,1246,29,32,61,47.5%,8m
2644,1,Swarley,4112,280,7,9,16,43.8%,13m
2644,1,SaltyWaters,4112,94,6,1,7,85.7%,8m
2648,1,IncoGnitO,4111,933,31,16,47,66.0%,13m
2648,1,SillyStorm,4111,653,28,40,68,41.2%,7m
2648,1,[PÄR]Katten,4111,245,6,11,17,35.3%,7m
2648,1,Ksyper,4111,239,6,11,17,35.3%,12m
2648,1,[ШОУМЕН]StereoClub,4111,192,4,5,9,44.4%,6m
2648,1,ArkonoM,4111,190,4,7,11,36.4%,4m
2648,1,Doc,4111,94,3,2,5,60.0%,39m
2655,1,[GoldM]Sparkyy,4110,238,5,4,9,55.6%,22m
2656,1,[InBri]Arphaz,4109,1045,26,29,55,47.3%,10m
2656,1,[IIIII]IIIIIScanner,4109,0,1,1,2,50.0%,25m
2658,3,United,4108,30,6,20,26,23.1%,4m
2658,1,FailArazul,4108,180,4,6,10,40.0%,16m
2658,1,[Reymor]aLamew,4108,0,0,1,1,0.0%,8m
2661,1,Remain,4107,2049,176,169,345,51.0%,22m
2661,1,[VFN]MajinBoo,4107,1986,58,66,124,46.8%,6m
2661,1,veysiii,4107,723,20,12,32,62.5%,16m
2661,1,nKarje,4107,752,17,12,29,58.6%,39m
2661,1,Gaston,4107,263,11,1,12,91.7%,10m
2661,1,[CASS]Cassidy,4107,422,10,5,15,66.7%,13m
2661,1,[Schmus]SaulGodmann,4107,0,1,3,4,25.0%,22m
2668,1,WonderJ,4106,1794,54,45,99,54.5%,7m
2668,1,[ØC]GatsbY,4106,274,8,6,14,57.1%,8m
2668,1,[MgSt]MgSgnoffl,4106,0,0,1,1,0.0%,6m
2671,3,MarcellDavis,4105,58,3,0,3,100.0%,9m
2671,1,BorBox,4105,0,1,0,1,100.0%,15m
2671,1,[TitanV]NEVERgiveUP,4105,46,1,1,2,50.0%,15m
2671,3,[2M1B]ZIBAR,4105,30,1,1,2,50.0%,4m
2671,1,[PŖïMĄŁ]GgMaChine,4105,0,0,1,1,0.0%,23m
2671,1,[aW]Nib,4105,0,0,3,3,0.0%,15m
2677,3,[Peeps]SpiderPig,4104,511,24,24,48,50.0%,17m
2677,1,acher,4104,584,17,17,34,50.0%,7m
2677,1,[IBeAŚI]Windsurfer,4104,0,1,0,1,100.0%,5m
2680,1,TheBreaker,4103,1508,150,151,301,49.8%,24m
2680,1,Verbannter,4103,1042,51,40,91,56.0%,8m
2680,1,Levi,4103,605,47,7,54,87.0%,12m
2680,1,Limitless,4103,96,2,3,5,40.0%,6m
2680,1,llllllllllll,4103,0,1,0,1,100.0%,39m
2685,1,[PŖïMĄŁ]Primal,4102,1456,44,41,85,51.8%,39m
2685,1,Rikitikitavi,4102,1088,37,33,70,52.9%,5m
2685,1,Rokys,4102,0,1,0,1,100.0%,23m
2685,1,PotatoHerO,4102,48,1,1,2,50.0%,12m
2685,1,[ENV]NeHe,4102,0,0,2,2,0.0%,12m
2690,1,Bug,4101,236,6,4,10,60.0%,4m
2690,1,Knalle,4101,142,3,5,8,37.5%,13m
2690,1,Strawberry,4101,96,3,8,11,27.3%,18m
2693,2,[AGing]Zergislife,4100,44,2,1,3,66.7%,4m
2694,1,[eW0lfz]Xil,4099,2135,160,171,331,48.3%,13m
2694,1,[Cruxis]headcrusher,4099,0,0,1,1,0.0%,6m
2696,1,[pLine]EpSyLoN,4098,2045,119,120,239,49.8%,17m
2696,1,Revolver,4098,539,23,7,30,76.7%,8m
2696,1,Evenride,4098,96,2,15,17,11.8%,7m
2696,1,FUismyGG,4098,0,1,0,1,100.0%,39m
2696,1,[aW]IIIIIIIIIIII,4098,0,0,1,1,0.0%,12m
2701,1,[RеG]removeprotos,4097,0,0,1,1,0.0%,6m
2702,1,Snail,4096,1425,47,48,95,49.5%,13m
2702,1,mortyfeo,4096,220,7,5,12,58.3%,39m
2702,1,[HnX]DJjo,4096,0,1,0,1,100.0%,24m
2702,1,[ArGGEU]Tozis,4096,48,1,1,2,50.0%,6m
2702,1,ASsAsSiNEETO,4096,0,1,1,2,50.0%,13m
2702,1,[RKZS]llllllll,4096,48,1,2,3,33.3%,39m
2702,1,GamerForEver,4096,0,0,1,1,0.0%,11m
2702,1,Doomer,4096,0,0,1,1,0.0%,14m
2710,2,IIIIIIIIIIII,4095,154,8,5,13,61.5%,5m
2710,1,Imbalance,4095,190,5,7,12,41.7%,4m
2710,1,[ISWAGl]sQuare,4095,238,5,8,13,38.5%,4m
2710,1,Quasar,4095,94,2,2,4,50.0%,23m
2710,1,[isIMBA]ṬȑȉŤØØŃ,4095,0,0,1,1,0.0%,4m
2715,1,[Hаsu]FirstBee,4094,1655,114,120,234,48.7%,4m
2715,3,[NMSQ]FaJeReDDDDDD,4094,766,71,69,140,50.7%,4m
2715,1,Hank,4094,1517,44,33,77,57.1%,39m
2715,1,[lMMl]Haspe,4094,142,4,8,12,33.3%,12m
2719,3,Jacob,4093,1959,307,320,627,49.0%,14m
2719,1,Andrew,4093,1021,64,53,117,54.7%,15m
2719,2,[Kicx]simtom,4093,285,15,3,18,83.3%,18m
2719,1,zane,4093,142,3,10,13,23.1%,4m
2719,1,BigBadBert,4093,48,2,0,2,100.0%,10m
2719,1,[PLA2N]чahka,4093,0,1,0,1,100.0%,9m
2725,1,vladbaros,4092,2117,250,229,479,52.2%,18m
2725,1,[Mysa]Bambi,4092,1695,53,58,111,47.7%,13m
2725,1,Broketoss,4092,689,29,10,39,74.4%,39m
2725,1,Lubacca,4092,906,21,29,50,42.0%,39m
2725,1,[KrnBrs]Axis,4092,724,17,23,40,42.5%,18m
2725,1,Damon,4092,138,4,5,9,44.4%,22m
2725,1,Bauer,4092,0,0,1,1,0.0%,39m
2725,1,NomaD,4092,0,0,3,3,0.0%,24m
2733,3,Kamon,4091,58,3,2,5,60.0%,7m
2733,1,[KeWa]Makarios,4091,137,2,5,7,28.6%,8m
2733,1,Rudtrack,4091,0,1,4,5,20.0%,17m
2733,1,Troizza,4091,0,0,6,6,0.0%,23m
2737,1,NOOBEATER,4090,1943,208,204,412,50.5%,9m
2737,1,lllllllllll,4090,1151,142,140,282,50.4%,15m
2737,3,[E1X]ExTenZ,4090,1968,136,159,295,46.1%,4m
2737,1,[HsDL]Domius,4090,668,15,19,34,44.1%,18m
2737,1,[HBGS]Neowolf,4090,284,7,8,15,46.7%,24m
2737,1,DFireee,4090,169,3,3,6,50.0%,13m
2737,1,[JAREK]Qartet,4090,0,0,1,1,0.0%,18m
2744,1,[PickH]Joel,4089,2133,156,137,293,53.2%,17m
2744,1,[BadLam]Henraisse,4089,1872,104,88,192,54.2%,5m
2744,1,VerDun,4089,644,42,15,57,73.7%,5m
2744,2,ТайныйКраб,4089,597,35,47,82,42.7%,8m
2744,1,wojak,4089,280,6,5,11,54.5%,4m
2744,1,KirillVolkov,4089,0,2,6,8,25.0%,23m
2744,2,BzH,4089,42,1,1,2,50.0%,10m
2751,1,[ULT1MA]Vandrad,4088,334,7,12,19,36.8%,6m
2751,1,DarkBulba,4088,94,2,4,6,33.3%,16m
2751,1,[DFgs]GuMihu,4088,0,1,0,1,100.0%,23m
2751,1,[Dobro]FARD,4088,0,0,1,1,0.0%,15m
2755,1,JAckie,4087,1321,51,29,80,63.8%,6m
2755,1,[ArGGEU]DarknessK,4087,48,1,7,8,12.5%,8m
2757,1,Terrick,4086,1308,46,34,80,57.5%,18m
2757,1,[SigV]Metikha,4086,1150,38,43,81,46.9%,25m
2757,1,NoBraphouX,4086,1126,35,24,59,59.3%,39m
2757,1,[Stix]Anomaly,4086,419,21,3,24,87.5%,16m
2757,1,Zerg,4086,646,17,8,25,68.0%,18m
2757,3,[AiRǂ]Gialluca,4086,0,0,4,4,0.0%,16m
2763,1,[eli]girlgamerxD,4085,48,2,1,3,66.7%,8m
2764,1,[Blacer]babatounet,4084,1480,38,43,81,46.9%,13m
2764,1,IIIIIIIIIIII,4084,615,12,14,26,46.2%,23m
2764,1,Okeydoke,4084,366,8,11,19,42.1%,10m
2764,3,[AFCN]Flomotion,4084,116,5,1,6,83.3%,26m
2764,1,[Pw]Mamzi,4084,144,3,10,13,23.1%,4m
2764,1,[OrPix]banu,4084,48,1,1,2,50.0%,17m
2764,1,Bartimeus,4084,48,1,1,2,50.0%,7m
2771,1,djakette,4083,2111,176,184,360,48.9%,25m
2771,1,zelehaist,4083,234,6,1,7,85.7%,24m
2771,1,[XYFAN]Wanderer,4083,0,1,0,1,100.0%,11m
2771,1,DrunkenSCV,4083,0,0,3,3,0.0%,18m
2775,3,[Oath]NoMercy,4082,1304,147,142,289,50.9%,14m
2775,3,GoPlayTetris,4082,442,29,44,73,39.7%,14m
2775,1,cdar,4082,96,3,9,12,25.0%,13m
2778,1,Lakai,4081,1049,30,22,52,57.7%,39m
2778,1,IIIIIll,4081,94,2,1,3,66.7%,6m
2780,1,Prestige,4080,664,34,17,51,66.7%,12m
2780,1,JWors,4080,686,20,12,32,62.5%,23m
2780,1,[sc2swa]xazcaz,4080,639,17,9,26,65.4%,16m
2780,1,[APER0]NiNesTmdrr,4080,48,1,3,4,25.0%,23m
2784,1,Chocov,4079,2079,113,100,213,53.1%,24m
2784,1,[FBad]Hope,4079,1635,59,44,103,57.3%,16m
2784,1,[Dae]Abou,4079,1378,35,42,77,45.5%,7m
2784,1,LeviafaN,4079,48,2,2,4,50.0%,25m
2784,1,[2FaSt]ChrisP,4079,94,2,11,13,15.4%,13m
2784,1,Eliasson,4079,0,1,0,1,100.0%,9m
2790,1,crazypants,4078,391,19,6,25,76.0%,9m
2790,1,[R33]DemoN,4078,280,6,9,15,40.0%,13m
2790,1,Robute,4078,96,2,3,5,40.0%,15m
2790,1,[GoldM]sulzbard,4078,48,1,8,9,11.1%,39m
2794,1,CrazyZ,4077,332,7,12,19,36.8%,17m
2794,1,[DvX]WhiteDiamonD,4077,0,1,1,2,50.0%,11m
2794,1,[αX]ThiasHP,4077,0,0,1,1,0.0%,10m
2794,1,Mériok,4077,0,0,3,3,0.0%,22m
2798,1,KiwiThief,4076,670,16,19,35,45.7%,39m
2798,1,Chilli,4076,0,0,1,1,0.0%,4m
2800,1,WaSiD,4075,144,3,2,5,60.0%,11m
2801,3,Saruman,4073,368,43,58,101,42.6%,13m
2801,1,StyX,4073,336,14,6,20,70.0%,4m
2801,1,RICH,4073,48,2,0,2,100.0%,11m
2801,1,Jackdapo,4073,94,2,3,5,40.0%,8m
2801,1,Gorilla,4073,46,1,1,2,50.0%,23m
2801,1,monyan,4073,0,0,1,1,0.0%,21m
2801,1,Chevelle,4073,0,0,2,2,0.0%,8m
2801,1,Hoàng,4073,0,0,5,5,0.0%,13m
2809,1,NoCoMent,4072,1752,138,125,263,52.5%,12m
2809,1,vladimislav,4072,48,2,1,3,66.7%,11m
2811,1,Norlen,4071,1915,213,191,404,52.7%,6m
2812,1,Normas,4070,1394,59,32,91,64.8%,9m
2812,1,BARTOMEU,4070,918,21,23,44,47.7%,23m
2812,2,IIIIIIIII,4070,368,11,8,19,57.9%,5m
2815,1,Госятый,4069,1899,215,207,422,50.9%,10m
2815,1,Xaenor,4069,1754,163,151,314,51.9%,4m
2815,1,Noctis,4069,666,15,12,27,55.6%,7m
2815,1,CreepingFear,4069,0,0,1,1,0.0%,23m
2819,1,[ЯD]Righteous,4068,144,3,5,8,37.5%,15m
2820,1,[Oath]Neku,4067,1653,47,45,92,51.1%,6m
2820,3,[MEvil]PraiseTheSun,4067,498,31,50,81,38.3%,26m
2820,1,[veni]Veni,4067,93,1,2,3,33.3%,39m
2820,1,[GHFZ]KekeN,4067,0,0,1,1,0.0%,18m
2824,1,[ENVOL]boTUIHok,4066,1532,40,44,84,47.6%,4m
2824,1,[PuSl]BaGGeRTeaM,4066,46,2,0,2,100.0%,17m
2824,1,JoJo,4066,96,2,2,4,50.0%,25m
2824,1,DrunkClawn,4066,0,1,2,3,33.3%,4m
2828,1,[DadBod]PeopleImages,4065,2061,131,132,263,49.8%,7m
2828,1,srbs,4065,1388,121,121,242,50.0%,22m
2828,1,[RеG]LeYsi,4065,1958,54,57,111,48.6%,13m
2828,1,[CxCx]Froenk,4065,310,8,1,9,88.9%,7m
2828,1,Rua,4065,48,3,3,6,50.0%,16m
2828,1,[MATI]czarny,4065,0,0,1,1,0.0%,24m
2834,1,Arados,4064,1801,124,95,219,56.6%,9m
2834,1,Geronimo,4064,1762,94,75,169,55.6%,15m
2834,1,PPAP,4064,187,11,0,11,100.0%,8m
2834,1,[Картош]Oldwizard,4064,291,8,5,13,61.5%,15m
2834,1,[INAE]MrGrumpy,4064,334,8,10,18,44.4%,13m
2839,1,klitman,4063,1945,203,200,403,50.4%,17m
2839,1,Vex,4063,1744,72,67,139,51.8%,7m
2839,1,[IBeAŚI]Luga,4063,880,45,45,90,50.0%,23m
2839,1,Blackjack,4063,482,15,5,20,75.0%,17m
2843,1,Origami,4062,1969,285,293,578,49.3%,14m
2843,1,Hola,4062,174,6,2,8,75.0%,25m
2843,1,[Chariz]gazza,4062,0,0,1,1,0.0%,39m
2846,1,HowToFly,4061,1594,52,37,89,58.4%,16m
2846,1,[CSM]TORBEN,4061,924,22,30,52,42.3%,14m
2846,1,[J0KER]Storstark,4061,470,11,15,26,42.3%,6m
2846,1,[PiGPan]Akoo,4061,94,2,3,5,40.0%,13m
2846,1,Cromm,4061,0,2,3,5,40.0%,39m
2846,1,[HeFi]MonkeyBallz,4061,96,2,11,13,15.4%,16m
2846,2,[FMG]StarLuk,4061,0,0,1,1,0.0%,9m
2853,1,[aW]Jazz,4060,2082,187,183,370,50.5%,10m
2853,3,Shadow,4060,1926,147,160,307,47.9%,13m
2853,1,[Mobius]guilhem,4060,2053,72,63,135,53.3%,6m
2853,1,yaboi,4060,723,29,11,40,72.5%,12m
2853,1,jean,4060,456,24,18,42,57.1%,7m
2853,1,[ØC]Bekoj,4060,0,1,0,1,100.0%,15m
2853,1,sPeRgLoRd,4060,0,0,1,1,0.0%,13m
2853,1,Vollmilch,4060,0,0,2,2,0.0%,16m
2861,1,[ÆR]Cerkof,4059,1952,250,240,490,51.0%,10m
2861,1,SchminguS,4059,702,69,49,118,58.5%,8m
2861,1,Achilles,4059,557,23,13,36,63.9%,5m
2861,2,HeisenZerg,4059,145,5,2,7,71.4%,8m
2861,1,[HsDL]MiaNonna,4059,0,0,2,2,0.0%,9m
2866,1,[DutchG]AgLunae,4058,2095,131,133,264,49.6%,13m
2866,1,[SZ]Sussi,4058,2096,91,90,181,50.3%,5m
2866,1,MindGrapes,4058,1864,78,75,153,51.0%,18m
2866,1,[αX]Victor,4058,1044,34,26,60,56.7%,8m
2866,1,[EAU]Shure,4058,1200,30,38,68,44.1%,39m
2866,1,[MST]Warden,4058,655,22,34,56,39.3%,11m
2866,1,NewPlayer,4058,514,11,6,17,64.7%,13m
2866,1,[Xa]GenGaR,4058,188,5,3,8,62.5%,18m
2866,3,[Dae]Strade,4058,30,2,4,6,33.3%,22m
2875,1,[Лoльки]Спелый,4057,144,3,5,8,37.5%,7m
2875,1,RoxyYxor,4057,48,2,3,5,40.0%,15m
2875,1,Azepartik,4057,94,2,5,7,28.6%,8m
2875,1,Libba,4057,0,0,1,1,0.0%,13m
2879,1,Stormpants,4056,1520,534,536,1070,49.9%,18m
2879,1,oGhydra,4056,1506,59,61,120,49.2%,10m
2879,1,Rudy,4056,232,5,3,8,62.5%,23m
2879,1,EmiliePaige,4056,228,5,6,11,45.5%,13m
2879,1,illdomybest,4056,96,3,3,6,50.0%,12m
2879,1,Soleet,4056,96,2,6,8,25.0%,4m
2879,1,[K0mpis]WeRiano,4056,0,1,4,5,20.0%,8m
2886,1,[ICGl]Jonesy,4055,2097,155,149,304,51.0%,8m
2886,1,PatchRace,4055,2081,130,142,272,47.8%,13m
2886,1,BamBa,4055,965,126,95,221,57.0%,4m
2886,1,[PIGEY]Pigenator,4055,1037,57,48,105,54.3%,4m
2886,1,Hell,4055,1162,41,23,64,64.1%,16m
2886,1,[ICG]Brute,4055,48,1,1,2,50.0%,9m
2886,1,[BBS123]FyrA,4055,0,1,2,3,33.3%,7m
2886,1,StimAddict,4055,0,0,1,1,0.0%,25m
2894,1,Smiddo,4054,1689,460,460,920,50.0%,4m
2894,1,zzz,4054,1531,71,64,135,52.6%,5m
2894,1,Babiboul,4054,414,9,11,20,45.0%,39m
2894,1,fshhsdhf,4054,0,1,0,1,100.0%,18m
2898,1,[IWDRI]Domian,4053,177,4,6,10,40.0%,4m
2898,1,llllllllllll,4053,0,1,0,1,100.0%,39m
2898,1,[CSM]CosmicGus,4053,0,0,2,2,0.0%,22m
2901,1,FlygarN,4052,1287,89,71,160,55.6%,6m
2901,1,[EESC]Hemlock,4052,1974,65,67,132,49.2%,6m
2901,2,BoNeS,4052,299,16,4,20,80.0%,14m
2901,1,Anosan,4052,0,1,0,1,100.0%,1m
2905,1,[HFR]AsTro,4051,1215,180,167,347,51.9%,11m
2905,3,Andrei,4051,1665,166,165,331,50.2%,16m
2905,1,[APER0]rakhnam,4051,1312,35,34,69,50.7%,25m
2905,1,Protazer,4051,1132,27,29,56,48.2%,18m
2905,1,Mellow,4051,46,1,2,3,33.3%,18m
2905,2,MariaCurie,4051,0,0,1,1,0.0%,8m
2905,1,[PÂRłAH]robotikov,4051,0,0,1,1,0.0%,3m
2912,1,KIKL,4050,1902,131,112,243,53.9%,7m
2912,1,GlinTrue,4050,1470,40,41,81,49.4%,10m
2912,1,llllllllllll,4050,904,23,17,40,57.5%,1m
2912,1,[DutchG]Free,4050,547,13,10,23,56.5%,7m
2912,1,TossAMuleTYT,4050,236,6,8,14,42.9%,18m
2912,1,krytalisk,4050,0,0,1,1,0.0%,17m
2918,1,greatdemon,4049,2037,183,176,359,51.0%,4m
2918,1,[DNARI]KIrpich,4049,0,0,1,1,0.0%,3m
2920,1,[RstE]JahNesta,4048,140,3,1,4,75.0%,16m
2921,1,exe,4047,1997,65,59,124,52.4%,15m
2921,1,BossMarine,4047,0,0,2,2,0.0%,39m
2923,1,[BGThot]MiQ,4046,632,14,19,33,42.4%,7m
2923,1,[DN3N]Ardn,4046,46,1,2,3,33.3%,25m
2925,1,[CIGANY]Choya,4045,1305,70,76,146,47.9%,4m
2925,1,[UATeam]HighHopes,4045,1298,34,36,70,48.6%,4m
2925,1,IIIIIIIIIIII,4045,839,31,18,49,63.3%,16m
2925,1,[RBP3]WaRaX,4045,766,18,25,43,41.9%,25m
2925,1,Mage,4045,238,5,8,13,38.5%,16m
2925,1,Droco,4045,0,3,2,5,60.0%,11m
2925,1,Eyeballz,4045,96,2,3,5,40.0%,4m
2932,1,[Arrows]Frozen,4044,1987,88,93,181,48.6%,7m
2932,1,[NetGG]Gwun,4044,1038,49,34,83,59.0%,14m
2932,1,Staskesensei,4044,928,24,27,51,47.1%,5m
2932,1,[DFgs]TreaT,4044,240,6,6,12,50.0%,15m
2936,1,MatsumoBot,4043,2076,460,456,916,50.2%,7m
2936,1,[Fr]Dune,4043,1866,99,97,196,50.5%,11m
2936,1,[lMMl]Moreal,4043,416,9,11,20,45.0%,13m
2936,1,[AiRǂ]AirstrikeITA,4043,48,2,5,7,28.6%,15m
2936,1,[ƮesXG]EffecT,4043,0,0,1,1,0.0%,7m
2941,1,WombaWomba,4042,332,7,13,20,35.0%,13m
2941,1,EnDenDino,4042,0,1,0,1,100.0%,13m
2941,2,Efes,4042,38,1,1,2,50.0%,15m
2941,1,Stepback,4042,0,0,1,1,0.0%,3m
2941,1,Henno,4042,0,0,1,1,0.0%,7m
2941,1,[MikC]OlysseGG,4042,0,0,2,2,0.0%,15m
2947,1,Romance,4041,1962,98,103,201,48.8%,5m
2947,1,ЛордКиберПес,4041,315,12,5,17,70.6%,25m
2947,1,[BarKot]summerlemur,4041,0,1,0,1,100.0%,13m
2947,1,[HBGSJR]tea,4041,0,1,0,1,100.0%,4m
2947,3,BlaizeSwords,4041,0,0,2,2,0.0%,7m
2952,3,Tiger,4040,1963,670,705,1375,48.7%,14m
2952,1,[aW]mingo,4040,807,21,24,45,46.7%,7m
2952,1,EctoPlasm,4040,362,7,4,11,63.6%,14m
2952,1,[TRQǂ]jlobart,4040,0,0,1,1,0.0%,18m
2956,1,[TePop]Fasy,4039,1824,447,453,900,49.7%,9m
2956,1,FullBuster,4039,2075,90,91,181,49.7%,18m
2956,1,[Lyserg]EsMiBarrio,4039,2019,74,74,148,50.0%,7m
2956,1,GusoMazud,4039,833,60,49,109,55.0%,18m
2956,1,mateo,4039,666,16,18,34,47.1%,5m
2956,1,MrHobbers,4039,0,0,3,3,0.0%,1m
2962,1,IIIIIIIIIIII,4038,991,44,23,67,65.7%,16m
2962,1,[TeDa]TechnoFreak,4038,543,14,8,22,63.6%,5m
2962,1,Xenakis,4038,46,1,3,4,25.0%,39m
2965,1,PhAnTøm,4037,1531,96,85,181,53.0%,7m
2965,1,[PИD]ClockWise,4037,1208,77,61,138,55.8%,11m
2965,1,Nkl,4037,882,36,27,63,57.1%,16m
2965,1,[HEROV]HeroMandarin,4037,950,31,18,49,63.3%,6m
2965,1,Ari,4037,633,26,14,40,65.0%,18m
2965,1,Smash,4037,464,11,17,28,39.3%,9m
2965,1,AggReSSive,4037,376,8,14,22,36.4%,14m
2965,1,asmo,4037,234,5,10,15,33.3%,18m
2973,1,[C37224]Nevosis,4036,1382,69,64,133,51.9%,18m
2973,1,IIIIIIIIIIII,4036,619,29,11,40,72.5%,7m
2973,1,Raze,4036,772,20,19,39,51.3%,25m
2973,3,[Hаsu]TbIrEnИй,4036,116,4,3,7,57.1%,2m
2973,1,Jaraxus,4036,46,2,0,2,100.0%,10m
2973,1,[TFSC]Wormms,4036,0,0,1,1,0.0%,10m
2973,1,Berny,4036,0,0,3,3,0.0%,15m
2980,1,Ocebe,4035,2105,129,110,239,54.0%,39m
2980,1,Quri,4035,1321,96,100,196,49.0%,15m
2980,1,HoldMyLings,4035,94,3,3,6,50.0%,18m
2980,1,Zang,4035,48,1,5,6,16.7%,15m
2980,1,[PŖïMĄŁ]LeTsGoBiLLy,4035,0,0,1,1,0.0%,18m
2985,1,EuroBarks,4034,2063,216,198,414,52.2%,1m
2985,1,[hoj]pomidorszado,4034,2113,169,170,339,49.9%,13m
2985,1,MRaMOR,4034,2091,114,110,224,50.9%,2m
2985,1,IIIIIIIIIIII,4034,498,11,18,29,37.9%,17m
2985,1,DanMaster,4034,96,2,7,9,22.2%,13m
2985,2,JustForFun,4034,0,1,2,3,33.3%,11m
2985,1,Маэстро,4034,48,1,5,6,16.7%,9m
2992,1,Idletime,4033,1853,253,237,490,51.6%,1m
2992,1,Sterbehilfe,4033,1073,208,183,391,53.2%,11m
2992,1,[ArsB]NapoléonsD,4033,1627,117,97,214,54.7%,15m
2992,1,PotatoHerO,4033,500,23,10,33,69.7%,5m
2992,1,BeepBoop,4033,200,12,1,13,92.3%,9m
2992,1,IIIIIIIIIIII,4033,0,0,1,1,0.0%,7m
2998,1,Fundamentals,4032,1706,65,45,110,59.1%,18m
2998,1,contremaitre,4032,1396,39,50,89,43.8%,11m
2998,1,[RøckeT]ElTwingo,4032,643,29,12,41,70.7%,25m
2998,1,Kimo,4032,46,1,6,7,14.3%,7m
3002,1,Tendo,4031,2078,676,695,1371,49.3%,3m
3002,1,HeLt,4031,1152,30,27,57,52.6%,8m
3002,1,[1LeftA]IIHyBriDII,4031,251,13,3,16,81.2%,16m
3002,1,[Arrows]Bourbon,4031,450,11,11,22,50.0%,10m
3006,1,vanderlokken,4030,1906,492,487,979,50.3%,1m
3006,1,absinthfee,4030,2073,240,214,454,52.9%,9m
3006,1,Spudnik,4030,497,73,64,137,53.3%,10m
3006,1,HiO,4030,1080,50,36,86,58.1%,7m
3006,1,fat,4030,685,35,13,48,72.9%,39m
3006,1,Cosmobrother,4030,418,10,15,25,40.0%,11m
3006,1,CrazyTrain,4030,48,2,1,3,66.7%,16m
3006,1,Tyrion,4030,0,0,3,3,0.0%,1m
3014,1,[BYTCA]Arthas,4029,1280,57,57,114,50.0%,6m
3014,1,[PsiVan]SlyOstrich,4029,861,26,29,55,47.3%,3m
3014,1,dVisioN,4029,778,21,16,37,56.8%,6m
3014,1,ANGEL,4029,843,20,24,44,45.5%,15m
3014,1,[xSUCCx]SaroX,4029,372,9,13,22,40.9%,1m
3014,1,IIIIIIIIIIII,4029,274,7,4,11,63.6%,6m
3014,3,[FLTY]BGǂTheJC,4029,58,3,5,8,37.5%,8m
3014,1,TOGO,4029,0,1,0,1,100.0%,15m
3014,1,Zékékette,4029,0,0,2,2,0.0%,8m
3023,1,ssgta,4028,2031,179,153,332,53.9%,2m
3023,1,[УТочка]JustAFreak,4028,2060,138,119,257,53.7%,1m
3023,1,Aryal,4028,1889,59,61,120,49.2%,6m
3023,1,Fireman,4028,380,11,13,24,45.8%,2m
3023,1,Perman,4028,372,8,11,19,42.1%,7m
3023,1,Klein,4028,48,1,4,5,20.0%,4m
3023,3,Bizork,4028,0,0,3,3,0.0%,15m
3030,1,stormer,4027,724,23,13,36,63.9%,4m
3030,1,LimeMoscow,4027,746,22,20,42,52.4%,1m
3030,1,UncleRuckus,4027,249,19,7,26,73.1%,17m
3030,1,vladplav,4027,330,7,13,20,35.0%,11m
3030,1,TeknoZerg,4027,217,6,1,7,85.7%,11m
3030,1,[voff]SerpaN,4027,48,2,3,5,40.0%,18m
3030,1,EWfania,4027,0,1,1,2,50.0%,10m
3030,1,Janush,4027,0,0,1,1,0.0%,6m
3038,1,[Oupss]HeK,4026,2045,244,235,479,50.9%,14m
3038,1,fleisch,4026,1790,102,109,211,48.3%,1m
3038,1,malytse,4026,628,14,18,32,43.8%,7m
3038,1,[RBlood]Zéké,4026,322,7,9,16,43.8%,8m
3038,3,LInok,4026,193,5,1,6,83.3%,1m
3038,1,[αX]Protiselaos,4026,48,1,1,2,50.0%,25m
3038,1,[tMnrd]mrDarcy,4026,0,0,1,1,0.0%,7m
3038,1,Siegfried,4026,0,0,6,6,0.0%,7m
3046,1,Draknar,4025,2034,354,341,695,50.9%,25m
3046,2,[ЯD]NEEK,4025,1406,127,160,287,44.3%,8m
3046,3,THEZT,4025,476,31,52,83,37.3%,6m
3046,1,Nebose,4025,394,14,3,17,82.4%,14m
3046,1,[Фаталя]PitsaMan,4025,142,4,4,8,50.0%,18m
3046,1,addChetigol,4025,142,3,7,10,30.0%,3m
3046,1,AGSlave,4025,0,0,1,1,0.0%,18m
3046,1,mysteryH,4025,0,0,3,3,0.0%,13m
3054,1,electricity,4024,1477,76,66,142,53.5%,15m
3054,1,[HBGSJR]mchoma,4024,847,22,15,37,59.5%,5m
3054,1,[LESeV]Cado,4024,369,19,5,24,79.2%,16m
3054,1,Саша,4024,0,1,0,1,100.0%,15m
3054,1,NoOne,4024,0,1,0,1,100.0%,1m
3054,1,[ǂMWRǂ]LiGhT,4024,0,0,1,1,0.0%,9m
3060,1,crofa,4023,1080,52,22,74,70.3%,39m
3060,1,Fiskmat,4023,712,36,25,61,59.0%,14m
3060,1,Rayder,4023,696,33,26,59,55.9%,25m
3060,1,[ОБЗМ]WannaBeVan,4023,603,23,10,33,69.7%,1m
3060,1,Rowene,4023,96,2,2,4,50.0%,14m
3060,3,notgood,4023,0,1,0,1,100.0%,3m
3060,1,MoreGG,4023,0,0,1,1,0.0%,6m
3067,1,CoCa,4022,848,64,36,100,64.0%,1m
3067,1,MendaDrog,4022,1653,54,44,98,55.1%,2m
3067,1,[Monik]AdesHeLL,4022,1001,26,20,46,56.5%,16m
3067,1,[HBGSJR]CeazaR,4022,798,19,26,45,42.2%,8m
3067,1,[DBr]omnicid,4022,0,0,1,1,0.0%,16m
3067,1,[Wø]Azimov,4022,0,0,1,1,0.0%,5m
3073,1,mYself,4021,689,159,142,301,52.8%,14m
3073,1,Gina,4021,316,12,7,19,63.2%,25m
3073,1,Jett,4021,0,1,0,1,100.0%,16m
3073,1,bonta,4021,0,1,0,1,100.0%,13m
3073,1,[K0mpis]ExpletoryOrb,4021,0,0,1,1,0.0%,18m
3073,1,CompleteMyNa,4021,0,0,5,5,0.0%,1m
3079,1,Redd,4020,1825,372,361,733,50.8%,8m
3079,1,kingdom,4020,2072,119,118,237,50.2%,25m
3079,1,[Voll]Quma,4020,738,18,18,36,50.0%,6m
3079,2,SaberAthena,4020,295,15,3,18,83.3%,16m
3079,1,Swimming,4020,455,9,8,17,52.9%,15m
3079,3,Kabooom,4020,0,3,3,6,50.0%,17m
3079,1,MatisS,4020,92,2,3,5,40.0%,7m
3086,1,[Doink]TheClown,4019,1645,149,161,310,48.1%,3m
3086,1,Quagmire,4019,853,55,53,108,50.9%,4m
3086,1,[5623]skystar,4019,584,13,18,31,41.9%,17m
3086,1,WhiteOwl,4019,94,3,1,4,75.0%,14m
3086,1,EMx,4019,144,3,10,13,23.1%,7m
3086,1,[AnD]missHakerica,4019,0,0,1,1,0.0%,3m
3092,1,Bax,4018,2071,180,179,359,50.1%,18m
3093,1,Glamodrama,4017,1595,237,220,457,51.9%,16m
3093,1,Malygos,4017,1676,191,195,386,49.5%,13m
3093,1,IIIIIIIIIIII,4017,1045,42,38,80,52.5%,13m
3093,1,[Kompis]Soren,4017,426,9,20,29,31.0%,14m
3093,2,llllllllllll,4017,218,7,2,9,77.8%,5m
3093,1,Plusmacher,4017,276,6,8,14,42.9%,4m
3093,1,[сSсǃ]BabyProbe,4017,0,1,0,1,100.0%,8m
3093,1,[RWE]ǂPulsarǂ,4017,48,1,5,6,16.7%,13m
3093,1,Mero,4017,0,0,1,1,0.0%,13m
3102,1,Peptar,4016,766,195,156,351,55.6%,7m
3102,1,devastator,4016,200,5,0,5,100.0%,4m
3102,1,Noobgam,4016,184,4,6,10,40.0%,7m
3102,1,Akiraa,4016,48,2,2,4,50.0%,1m
3102,1,[THRLLA]Randaban,4016,94,2,8,10,20.0%,25m
3107,1,MadB,4015,1924,125,130,255,49.0%,2m
3107,1,[URNOOB]Lukareon,4015,711,59,50,109,54.1%,8m
3107,1,ilikebananas,4015,316,10,9,19,52.6%,13m
3107,1,Select,4015,48,2,3,5,40.0%,14m
3107,1,[TAW]EntityParadx,4015,0,1,0,1,100.0%,5m
3112,1,[Acte]Ladidum,4014,1472,140,143,283,49.5%,7m
3112,1,MAVERICK,4014,1378,34,52,86,39.5%,8m
3112,1,[BRSKR]Tropic,4014,0,1,1,2,50.0%,3m
3112,1,ǂTenshiǂ,4014,0,0,3,3,0.0%,5m
3116,3,[K0mpis]Gleidrist,4013,1951,294,311,605,48.6%,25m
3116,1,[ViBErs]MacroSir,4013,2045,293,300,593,49.4%,7m
3116,1,Nils,4013,1262,32,32,64,50.0%,18m
3116,3,[SneK]Morgurth,4013,374,28,47,75,37.3%,17m
3116,1,IIIIIIIIIIII,4013,177,12,1,13,92.3%,7m
3116,1,Thorgrim,4013,498,12,15,27,44.4%,1m
3116,1,[ЯD]Florujin,4013,0,1,1,2,50.0%,12m
3123,1,Charlie,4012,2094,245,243,488,50.2%,7m
3123,1,llllllllllll,4012,593,28,30,58,48.3%,13m
3123,1,dumè,4012,858,20,21,41,48.8%,14m
3123,1,LeChocapic,4012,196,10,1,11,90.9%,1m
3127,1,Akatjan,4011,2027,241,258,499,48.3%,7m
3127,1,Icu,4011,1639,200,195,395,50.6%,4m
3127,1,[ØC]Hoshi,4011,2021,188,193,381,49.3%,6m
3127,1,[PlAr]Rageling,4011,720,103,69,172,59.9%,4m
3127,3,[SCMate]AlexeyZ,4011,415,77,78,155,49.7%,39m
3127,1,Algeroth,4011,514,23,10,33,69.7%,18m
3127,1,dubbledub,4011,550,12,15,27,44.4%,14m
3127,1,[IGvI]GrootPower,4011,0,1,0,1,100.0%,9m
3127,1,Alucard,4011,48,1,1,2,50.0%,25m
3127,1,[bTsC]tHeTeaTcheR,4011,48,1,3,4,25.0%,7m
3137,1,[nº1]Infestor,4010,1997,86,77,163,52.8%,14m
3137,1,[FxL]SharkFinn,4010,648,19,14,33,57.6%,7m
3137,1,Cindar,4010,707,19,16,35,54.3%,7m
3137,1,[Logic]LogicStriker,4010,550,13,15,28,46.4%,13m
3137,1,Hubris,4010,446,11,9,20,55.0%,13m
3137,1,[Vodo]MagiCmaN,4010,445,11,11,22,50.0%,5m
3137,1,[Ahegаo]Frakish,4010,446,11,14,25,44.0%,5m
3137,1,xzoid,4010,408,9,11,20,45.0%,13m
3137,2,VolanD,4010,0,1,0,1,100.0%,25m
3137,1,Gumo,4010,0,0,1,1,0.0%,18m
3147,1,[UATeam]Right,4009,1459,100,54,154,64.9%,7m
3147,1,LeifGWPerson,4009,2044,75,69,144,52.1%,15m
3147,1,[OAC]Grizzly,4009,1411,68,60,128,53.1%,15m
3147,1,CryStun,4009,497,14,21,35,40.0%,10m
3147,3,Trump,4009,120,7,5,12,58.3%,27m
3147,1,[VFN]TrialTerror,4009,46,2,4,6,33.3%,7m
3147,1,Leecher,4009,0,1,0,1,100.0%,1m
3147,1,[GiDi]Kras,4009,0,0,6,6,0.0%,15m
3155,1,EBALOLOM,4008,1991,153,113,266,57.5%,6m
3155,1,[Coward]Rohan,4008,1212,31,37,68,45.6%,7m
3155,1,IIIIIIIIIIII,4008,631,27,19,46,58.7%,18m
3155,1,[AnD]ArChViLe,4008,545,16,9,25,64.0%,39m
3155,1,JeanPaul,4008,46,2,0,2,100.0%,4m
3155,1,Roasted,4008,0,0,1,1,0.0%,39m
3161,1,rand,4007,2082,102,115,217,47.0%,25m
3161,1,Insector,4007,1062,97,86,183,53.0%,17m
3161,1,Ponitsata,4007,435,11,12,23,47.8%,25m
3164,1,[RevoGG]iSy,4006,1763,62,50,112,55.4%,9m
3164,1,Kharyb,4006,899,33,22,55,60.0%,14m
3164,1,kOtelEmiLA,4006,603,26,15,41,63.4%,10m
3164,1,singapyrchik,4006,500,11,16,27,40.7%,7m
3164,1,[CaBaL]nGp,4006,337,8,8,16,50.0%,1m
3164,1,[TеS]mens,4006,230,6,9,15,40.0%,18m
3164,1,[MSUSC2]mibig,4006,187,5,1,6,83.3%,6m
3164,1,[GoldM]Bumbz,4006,142,3,5,8,37.5%,5m
3164,1,[GP]Terric,4006,92,2,3,5,40.0%,15m
3164,1,[B1M]Enhörning,4006,0,1,1,2,50.0%,12m
3164,1,BeHappy,4006,0,0,3,3,0.0%,4m
3175,3,pioneer,4005,1550,241,248,489,49.3%,2m
3175,1,NBØ,4005,1202,170,160,330,51.5%,18m
3175,1,StarLord,4005,2049,88,97,185,47.6%,1m
3175,1,[ZisDED]RIPzerg,4005,1230,45,59,104,43.3%,3m
3175,1,[AofK]LuckyPhoenix,4005,645,39,33,72,54.2%,1m
3175,1,bonny,4005,789,23,25,48,47.9%,1m
3175,1,[SSC2]Aleksandr,4005,348,13,5,18,72.2%,6m
3175,1,[Minet]TheTututu,4005,121,4,2,6,66.7%,1m
3175,1,[Fanta4]Hamster,4005,48,1,2,3,33.3%,39m
3175,1,SayonaraSckr,4005,0,0,1,1,0.0%,16m
3185,1,LarryDavid,4004,2042,702,686,1388,50.6%,9m
3185,1,PeterLax,4004,1962,171,172,343,49.9%,6m
3185,1,Magicwit,4004,1378,82,70,152,53.9%,4m
3185,1,LeGazou,4004,540,26,12,38,68.4%,6m
3185,1,[Ahegаo]ElonMaks,4004,537,22,9,31,71.0%,17m
3185,2,mORE,4004,355,17,3,20,85.0%,4m
3185,1,hqbrutal,4004,368,14,11,25,56.0%,4m
3185,1,GoLeM,4004,48,2,0,2,100.0%,14m
3185,1,LandAquaman,4004,0,1,0,1,100.0%,17m
3185,1,Deathbringer,4004,48,1,4,5,20.0%,6m
3185,1,[zerg0]Yonyks,4004,48,1,7,8,12.5%,13m
3196,1,Rikitikitavi,4003,1081,29,25,54,53.7%,39m
3196,1,MementoMori,4003,824,27,16,43,62.8%,4m
3196,1,hukku,4003,192,6,0,6,100.0%,16m
3196,1,[AISC]Surge,4003,199,6,1,7,85.7%,13m
3196,1,[іmba]mateAce,4003,0,1,0,1,100.0%,18m
3201,1,PriDe,4002,974,112,90,202,55.4%,18m
3201,1,[LøS]LoXoR,4002,568,13,13,26,50.0%,12m
3201,1,LastCell,4002,0,1,1,2,50.0%,13m
3201,1,BarCode,4002,0,0,1,1,0.0%,7m
3201,1,MrFancyPants,4002,0,0,1,1,0.0%,39m
3201,3,Dexter,4002,0,0,1,1,0.0%,26m
3207,1,llllllllllll,4001,855,28,17,45,62.2%,1m
3207,1,Kirill,4001,48,2,2,4,50.0%,4m
3207,1,[IceHus]Global,4001,0,1,1,2,50.0%,13m
3210,1,Ichkannwas,4000,1139,71,55,126,56.3%,14m
3210,1,[BeSC]Mayne,4000,92,3,7,10,30.0%,15m
3210,1,[MiMs]Gonzo,4000,0,0,1,1,0.0%,11m
3210,1,DeutschZerg,4000,0,0,3,3,0.0%,18m
3214,1,noname,3999,1167,98,103,201,48.8%,7m
3214,1,[aStalk]FluffyKitten,3999,222,11,5,16,68.8%,13m
3214,1,Mike,3999,94,3,3,6,50.0%,6m
3214,1,[АMOVE]ELENTOS,3999,0,0,1,1,0.0%,18m
3218,1,WildPants,3998,1139,75,14,89,84.3%,14m
3218,2,CoOkiEbytEs,3998,273,12,4,16,75.0%,5m
3218,1,[Blacer]Malik,3998,236,6,10,16,37.5%,8m
3218,3,Ström,3998,0,1,0,1,100.0%,27m
3218,1,Poobels,3998,0,0,1,1,0.0%,4m
3223,1,Bud,3997,1648,126,125,251,50.2%,18m
3223,1,[Vladik]AndrewBW,3997,1506,45,40,85,52.9%,4m
3223,1,[Lambro]redflashBG,3997,1417,45,43,88,51.1%,40m
3223,1,Senpuden,3997,384,16,5,21,76.2%,15m
3223,1,JackSparrow,3997,157,11,0,11,100.0%,18m
3223,1,Ergopro,3997,402,10,11,21,47.6%,7m
3223,3,[xRtG]vOluMe,3997,168,9,0,9,100.0%,6m
3230,1,Globus,3996,1932,137,130,267,51.3%,16m
3230,1,Deflow,3996,968,76,52,128,59.4%,4m
3230,1,IIIIIIIIIIII,3996,207,8,3,11,72.7%,12m
3230,1,SerraAngelDK,3996,0,0,1,1,0.0%,1m
3234,1,STRAYKER,3995,2045,73,74,147,49.7%,7m
3234,1,PargeLennis,3995,548,27,14,41,65.9%,4m
3234,1,Omega,3995,90,5,1,6,83.3%,15m
3234,1,IIIIIIIIIllI,3995,0,1,1,2,50.0%,7m
3234,1,darealxp,3995,0,0,4,4,0.0%,10m
3239,1,[BenP]Ironhide,3994,1869,324,290,614,52.8%,7m
3239,1,[SiTio]Raistlin,3994,1934,250,213,463,54.0%,13m
3239,1,Rasto,3994,1371,60,36,96,62.5%,39m
3239,1,[5up]Swisstox,3994,1852,57,57,114,50.0%,25m
3239,1,EZERGit,3994,367,17,6,23,73.9%,9m
3239,1,lexa,3994,341,16,6,22,72.7%,40m
3239,1,llllllllllll,3994,205,8,14,22,36.4%,7m
3239,1,Chadoboy,3994,92,2,4,6,33.3%,18m
3239,1,Rikudou,3994,0,0,1,1,0.0%,4m
3239,1,Keenetic,3994,0,0,1,1,0.0%,2m
3249,3,GaminGringo,3993,1719,382,399,781,48.9%,26m
3249,1,obelus,3993,218,17,16,33,51.5%,7m
3249,3,llllllllllll,3993,135,10,0,10,100.0%,6m
3249,1,Keen,3993,324,9,14,23,39.1%,14m
3249,1,[Cannоn]RoadToDako,3993,202,6,2,8,75.0%,14m
3249,1,Anakin,3993,274,6,9,15,40.0%,7m
3255,1,[НТТ]Machpella,3992,2050,316,311,627,50.4%,11m
3255,1,[IndyK]Flexy,3992,1277,77,53,130,59.2%,18m
3255,1,Urshnak,3992,795,70,47,117,59.8%,11m
3255,1,NieMamNicku,3992,864,40,32,72,55.6%,13m
3255,1,[Fridge]gezellig,3992,377,15,7,22,68.2%,15m
3255,1,Interesting,3992,268,12,4,16,75.0%,13m
3255,1,LuckyStar,3992,492,11,14,25,44.0%,9m
3255,1,Анатолий,3992,271,5,4,9,55.6%,9m
3255,1,Deadlyblow,3992,142,3,11,14,21.4%,9m
3255,1,[BATG]SnipeFive,3992,94,2,0,2,100.0%,16m
3255,1,RobRT,3992,0,1,0,1,100.0%,13m
3255,1,Cielo,3992,46,1,2,3,33.3%,5m
3255,1,[FRZS]Troizza,3992,46,1,3,4,25.0%,18m
3255,1,[ZERGML]Seva,3992,0,0,1,1,0.0%,11m
3255,1,uspik,3992,0,0,1,1,0.0%,7m
3270,1,MasterSoon,3991,2033,493,502,995,49.5%,5m
3270,1,DrBunhead,3991,2039,393,378,771,51.0%,4m
3270,1,[RTrain]Maix,3991,1373,148,162,310,47.7%,13m
3270,1,[MoonR]astrodroid,3991,1528,100,95,195,51.3%,7m
3270,1,NMSL,3991,896,22,34,56,39.3%,5m
3270,1,TheGleam,3991,518,20,11,31,64.5%,9m
3270,1,[PaniC]Xлебушек,3991,0,0,1,1,0.0%,1m
3277,1,Lobo,3990,2027,156,147,303,51.5%,16m
3277,1,[сSсǃ]Мороженко,3990,992,61,17,78,78.2%,1m
3277,1,Slafs,3990,899,51,53,104,49.0%,6m
3277,1,[AiRǂ]Rommel,3990,1683,49,48,97,50.5%,9m
3277,1,majic,3990,1170,31,37,68,45.6%,13m
3277,1,[CHALGA]ZxCidi,3990,231,27,16,43,62.8%,7m
3277,1,[lMMl]cyper,3990,371,19,5,24,79.2%,39m
3277,1,THERIPPER,3990,0,1,1,2,50.0%,40m
3277,2,bege,3990,0,0,1,1,0.0%,14m
3286,1,Bradders,3989,2002,76,60,136,55.9%,40m
3286,1,Owlrazum,3989,1473,51,40,91,56.0%,4m
3286,2,Legendlarkin,3989,251,9,6,15,60.0%,18m
3286,1,Gergi,3989,0,0,1,1,0.0%,4m
3290,1,[НТТ]Unwished,3988,1613,55,52,107,51.4%,4m
3290,1,[PŖïMĄŁ]tayron,3988,1420,38,43,81,46.9%,15m
3290,1,LGZelniq,3988,221,12,2,14,85.7%,7m
3290,1,[SpCI]RAMZESPL,3988,147,5,1,6,83.3%,16m
3290,1,IIIIIIIIIIII,3988,186,5,6,11,45.5%,16m
3290,1,[HsDL]Mæma,3988,46,1,2,3,33.3%,2m
3290,1,Mercurious,3988,0,0,1,1,0.0%,11m
3290,1,[краbы]YoungYakov,3988,0,0,1,1,0.0%,7m
3298,1,[dfrent]Sides,3987,1938,114,107,221,51.6%,11m
3298,1,venatiC,3987,648,52,49,101,51.5%,13m
3298,1,[Evins]NokiAntares,3987,622,23,20,43,53.5%,4m
3298,3,[TFSC]CaZo,3987,182,23,41,64,35.9%,14m
3298,1,ADAMBOS,3987,444,11,12,23,47.8%,18m
3298,1,Lowscribe,3987,311,6,5,11,54.5%,13m
3298,1,[зерно]StreetPie,3987,70,3,4,7,42.9%,9m
3305,1,[MSUSC2]Belgan,3986,1817,95,108,203,46.8%,3m
3305,1,Time,3986,411,16,18,34,47.1%,16m
3305,1,Manderda,3986,582,13,18,31,41.9%,9m
3305,1,[TFSC]LeGenTleMan,3986,111,2,1,3,66.7%,7m
3305,3,Ray,3986,0,1,2,3,33.3%,14m
3310,1,CryptoSC,3985,930,47,24,71,66.2%,2m
3310,1,MrGoZu,3985,843,25,20,45,55.6%,4m
3310,1,[WEEDfr]scizoFoxY,3985,228,5,9,14,35.7%,7m
3310,1,IceWallOComb,3985,71,3,2,5,60.0%,16m
3314,1,[сSсǃ]BuRaTiLo,3984,2028,322,324,646,49.8%,16m
3314,1,IntrinsiCat,3984,1508,98,101,199,49.2%,1m
3314,1,Yuki,3984,772,19,21,40,47.5%,2m
3314,1,Blackshade,3984,447,17,12,29,58.6%,7m
3314,1,CHiPi,3984,0,1,0,1,100.0%,3m
3314,2,[AplZi]RegandwyZ,3984,0,0,1,1,0.0%,5m
3320,1,PommesFritz,3983,2023,114,118,232,49.1%,13m
3320,1,CrappyCoco,3983,662,29,39,68,42.6%,1m
3320,1,[EnTar0]Aiur,3983,1014,27,29,56,48.2%,15m
3320,3,ǂKaraxǂ,3983,238,12,1,13,92.3%,5m
3320,1,Paxters,3983,161,5,1,6,83.3%,14m
3320,1,[WxN]NuTCrAcK,3983,157,5,2,7,71.4%,7m
3320,1,SneakySnake,3983,0,0,2,2,0.0%,17m
3320,1,[TheDOH]secretspace,3983,0,0,14,14,0.0%,26m
3328,1,[Xa]Carloschi,3982,2042,177,177,354,50.0%,14m
3328,1,[ZERG7V]IAmWhiteBear,3982,1266,98,65,163,60.1%,14m
3328,1,[Lames]Robot,3982,1228,62,38,100,62.0%,18m
3328,1,MAPElites,3982,343,21,6,27,77.8%,15m
3328,2,Mìsashì,3982,358,17,5,22,77.3%,26m
3328,1,[henD]Cerberi,3982,138,4,6,10,40.0%,12m
3328,1,Rtdcndyeight,3982,92,2,3,5,40.0%,1m
3328,1,Blaze,3982,0,1,4,5,20.0%,8m
3336,1,[MWAF]aNerdsDen,3981,1016,170,177,347,49.0%,13m
3336,1,tesked,3981,1526,129,120,249,51.8%,17m
3336,1,BronzeStyle,3981,1221,38,34,72,52.8%,2m
3336,1,RiKo,3981,1001,28,29,57,49.1%,13m
3336,1,Softisch,3981,701,17,15,32,53.1%,8m
3336,1,[TerBHD]Klarius,3981,499,14,12,26,53.8%,7m
3336,1,IIIIIIIIIIII,3981,46,1,3,4,25.0%,5m
3343,1,Bauer,3980,2052,166,177,343,48.4%,13m
3343,1,nocheesepls,3980,675,27,13,40,67.5%,18m
3343,1,Mad,3980,178,6,2,8,75.0%,14m
3343,1,[НТТ]Mangaka,3980,126,4,0,4,100.0%,26m
3343,1,Magnanik,3980,159,3,3,6,50.0%,8m
3343,1,Fall,3980,46,1,2,3,33.3%,13m
3349,1,buldog,3979,1085,122,92,214,57.0%,2m
3349,1,Tom,3979,519,48,22,70,68.6%,13m
3349,1,Hidra,3979,94,2,6,8,25.0%,1m
3352,1,ProPirks,3978,2016,919,936,1855,49.5%,1m
3352,1,Lovriko,3978,562,24,9,33,72.7%,18m
3352,1,panic,3978,92,3,2,5,60.0%,10m
3352,1,Heisenberg,3978,94,2,11,13,15.4%,18m
3356,1,[pooooo]GrosSacASac,3977,228,5,8,13,38.5%,2m
3356,1,Furious,3977,110,3,0,3,100.0%,10m
3358,1,Adrenaline,3976,168,5,4,9,55.6%,1m
3359,1,[AFCN]Preisenor,3975,1180,85,82,167,50.9%,5m
3359,1,Shinersen,3975,1814,59,65,124,47.6%,1m
3359,3,[QcSubs]SlayerQc,3975,192,6,1,7,85.7%,4m
3359,1,[1POL]BaKsORO,3975,0,0,2,2,0.0%,7m
3363,1,[K0mpis]Draco,3974,1987,111,99,210,52.9%,2m
3363,1,Wilk,3974,1838,72,74,146,49.3%,13m
3363,1,Zorba,3974,649,46,41,87,52.9%,6m
3363,1,TacoTruck,3974,733,32,26,58,55.2%,1m
3363,1,Bratz,3974,291,12,6,18,66.7%,39m
3363,1,BabySchlumpf,3974,152,6,0,6,100.0%,5m
3363,1,Kaivu,3974,184,5,6,11,45.5%,16m
3363,1,[jonasi]LYHxAlucard,3974,144,5,8,13,38.5%,40m
3363,1,DodonMyHero,3974,88,3,1,4,75.0%,1m
3363,1,Croe,3974,0,1,0,1,100.0%,39m
3363,1,[RIPZrg]Suriel,3974,90,1,1,2,50.0%,13m
3363,1,ruinone,3974,0,1,3,4,25.0%,1m
3363,1,[SZH]INFERNAL,3974,0,0,2,2,0.0%,9m
3363,1,spiRa,3974,0,0,3,3,0.0%,5m
3377,1,NumberTh,3973,734,57,56,113,50.4%,13m
3377,2,Reign,3973,0,3,2,5,60.0%,39m
3377,1,[WOODYS]Korzan,3973,0,0,2,2,0.0%,2m
3380,1,Dampth,3972,1618,70,63,133,52.6%,7m
3380,1,Mason,3972,147,4,5,9,44.4%,5m
3380,2,FondilMabols,3972,38,2,1,3,66.7%,15m
3380,1,[6MP]Zeo,3972,46,1,5,6,16.7%,9m
3384,1,mcbrungus,3971,768,19,23,42,45.2%,26m
3384,1,[BRSKR]Morghan,3971,450,12,10,22,54.5%,18m
3384,1,TrixXxa,3971,334,7,17,24,29.2%,7m
3384,1,MrSuidAfrika,3971,226,6,5,11,54.5%,7m
3384,1,Kunieda,3971,255,4,7,11,36.4%,13m
3384,2,[Kerma]Ose,3971,34,1,1,2,50.0%,12m
3384,2,[BRSKR]KamaKwasi,3971,30,1,1,2,50.0%,4m
3384,2,PriNce,3971,0,0,1,1,0.0%,7m
3392,1,[SEEXXY]DragonFire,3970,1687,79,57,136,58.1%,39m
3392,1,Lucidium,3970,328,32,15,47,68.1%,7m
3392,1,MothMonkey,3970,108,3,1,4,75.0%,18m
3395,1,Teva,3969,2002,201,197,398,50.5%,7m
3395,1,Vision,3969,197,8,4,12,66.7%,40m
3395,2,[aW]Chinkashtook,3969,78,2,2,4,50.0%,15m
3395,1,Klayar,3969,46,1,5,6,16.7%,12m
3395,1,Blazkowicz,3969,46,1,13,14,7.1%,9m
3395,2,CazimirGuFFa,3969,0,0,1,1,0.0%,6m
3401,1,krach,3968,1917,194,183,377,51.5%,7m
3401,1,QQQQQQQQQQQQ,3968,415,18,11,29,62.1%,2m
3401,1,Рыжебород,3968,213,5,10,15,33.3%,7m
3401,1,Ruldane,3968,138,3,2,5,60.0%,11m
3401,2,[isIMBA]RespectDVoid,3968,0,0,1,1,0.0%,6m
3406,1,Breem,3967,1993,158,150,308,51.3%,17m
3406,1,[TheDOH]TheLilith,3967,1510,44,49,93,47.3%,17m
3406,1,VBHustler,3967,769,32,16,48,66.7%,16m
3406,1,[GZerO]Sanguor,3967,897,32,29,61,52.5%,17m
3406,2,[NWGD]Monkey,3967,0,1,0,1,100.0%,2m
3406,1,[LawB]maitiky,3967,91,1,2,3,33.3%,18m
3412,1,martin,3966,638,20,27,47,42.6%,13m
3412,3,PtitZerg,3966,217,8,4,12,66.7%,17m
3412,1,Iceman,3966,177,4,11,15,26.7%,7m
3412,2,reactive,3966,0,1,0,1,100.0%,10m
3416,1,ZergPower,3965,1803,178,138,316,56.3%,9m
3416,2,Feedtha,3965,346,13,4,17,76.5%,5m
3416,3,[CRL]Freeman,3965,0,1,0,1,100.0%,8m
3419,1,[KMNDX]RectalProbe,3964,2028,395,387,782,50.5%,13m
3419,1,Watcher,3964,1319,163,157,320,50.9%,11m
3419,3,[ValidG]NeverMind,3964,971,82,90,172,47.7%,15m
3419,1,[uT]Kly,3964,1580,44,50,94,46.8%,2m
3419,1,Roms,3964,231,18,14,32,56.2%,11m
3419,2,Troggenir,3964,232,13,3,16,81.2%,4m
3419,3,Taryban,3964,171,5,6,11,45.5%,11m
3419,2,Yamn,3964,0,1,0,1,100.0%,6m
3419,1,Hugo,3964,40,1,6,7,14.3%,3m
3419,3,GodOfMacro,3964,0,0,2,2,0.0%,16m
3429,1,DucKster,3963,1743,152,154,306,49.7%,10m
3429,2,[xDADEx]Orrakel,3963,0,0,1,1,0.0%,9m
3429,2,Lyric,3963,0,0,1,1,0.0%,26m
3432,1,Ktatos,3962,725,26,17,43,60.5%,9m
3432,1,David,3962,94,1,2,3,33.3%,39m
3432,2,[gronk]CAVEMAN,3962,0,0,1,1,0.0%,1m
3432,1,Trivein,3962,0,0,2,2,0.0%,7m
3436,1,BigCheese,3961,1332,141,134,275,51.3%,4m
3436,1,[IndyK]Wawszyn,3961,1390,42,53,95,44.2%,7m
3436,1,MauZ,3961,603,14,20,34,41.2%,3m
3436,1,Fini,3961,266,5,6,11,45.5%,16m
3436,2,ReV,3961,34,1,2,3,33.3%,18m
3441,1,maurimu,3960,1440,355,347,702,50.6%,13m
3441,1,[A1MC]McMentor,3960,1619,189,187,376,50.3%,6m
3441,1,[QTclub]Sprite,3960,453,102,71,173,59.0%,5m
3441,1,[DeAs]Busfahrer,3960,1231,96,81,177,54.2%,4m
3441,1,Geno,3960,775,74,55,129,57.4%,9m
3441,1,[BuxBux]Stahl,3960,0,0,2,2,0.0%,18m
3447,1,Horiu,3959,751,97,99,196,49.5%,3m
3447,1,Stabvil,3959,1109,74,64,138,53.6%,2m
3447,1,nnn,3959,674,29,22,51,56.9%,39m
3450,2,miomaMo,3958,1156,79,53,132,59.8%,5m
3450,1,[ValidG]CppMaster,3958,1188,54,44,98,55.1%,14m
3450,1,Garnor,3958,1136,43,29,72,59.7%,17m
3450,1,DAA,3958,511,18,13,31,58.1%,2m
3450,1,Koman,3958,318,8,12,20,40.0%,14m
3450,1,[lOoOl]Vader,3958,0,1,1,2,50.0%,9m
3450,2,[lQl]Mirror,3958,0,0,1,1,0.0%,4m
3450,1,XIII,3958,0,0,2,2,0.0%,2m
3458,1,[lightt]light,3957,2013,337,332,669,50.4%,12m
3458,1,RXX,3957,1585,71,62,133,53.4%,18m
3458,1,[4X4]JonasMcRaven,3957,246,9,5,14,64.3%,2m
3458,3,Arzo,3957,114,5,1,6,83.3%,40m
3458,1,[sfc]MateParlov,3957,0,1,2,3,33.3%,14m
3463,1,Fiodor,3956,1972,344,342,686,50.1%,13m
3463,1,ZeroPlay,3956,1234,103,50,153,67.3%,18m
3465,1,flep,3955,1998,107,111,218,49.1%,6m
3465,1,loganjake,3955,449,19,12,31,61.3%,8m
3465,1,Sora,3955,136,2,3,5,40.0%,13m
3465,2,FLamer,3955,0,0,1,1,0.0%,10m
3465,2,IIIIIIIIIIII,3955,0,0,5,5,0.0%,18m
3470,1,[DМG]Azarel,3954,1761,125,130,255,49.0%,5m
3470,1,[AoT]gray,3954,93,1,3,4,25.0%,9m
3470,2,[BN]Tikou,3954,0,0,1,1,0.0%,5m
3473,1,[VFN]JLAMAR,3953,1726,189,185,374,50.5%,8m
3473,2,LilGranny,3953,44,1,5,6,16.7%,15m
3473,2,[llBGll]INvinCiBLe,3953,0,0,2,2,0.0%,4m
3476,1,[lWHl]Destro,3952,788,32,21,53,60.4%,39m
3476,1,saufnagel,3952,575,14,13,27,51.9%,13m
3476,3,abcdefg,3952,188,10,0,10,100.0%,9m
3479,1,[НТТ]notsche,3951,2015,251,259,510,49.2%,14m
3479,1,Stormvill,3951,913,115,119,234,49.1%,13m
3479,1,[PLA2N]KOT,3951,1296,36,39,75,48.0%,2m
3479,1,Funky,3951,1382,35,42,77,45.5%,5m
3479,1,[IceHus]Джохнипрогей,3951,912,21,35,56,37.5%,11m
3479,1,[VFN]Sonny,3951,460,18,16,34,52.9%,39m
3479,2,[HBGSJR]Magicall,3951,136,4,5,9,44.4%,27m
3479,2,Rapwnzel,3951,0,1,0,1,100.0%,2m
3479,3,[FiT]KaiSeR,3951,0,1,4,5,20.0%,14m
3479,2,[ahaha1]Stars,3951,0,0,1,1,0.0%,18m
3479,2,[CUTY]JayDee,3951,0,0,2,2,0.0%,10m
3490,1,Trockeneis,3950,2011,197,199,396,49.7%,13m
3490,1,hydrerouge,3950,844,43,35,78,55.1%,9m
3490,1,[NuF]SeeD,3950,892,21,31,52,40.4%,13m
3490,2,Rezolventa,3950,368,12,11,23,52.2%,5m
3490,2,Daydee,3950,210,7,3,10,70.0%,3m
3495,1,Lahms,3949,1524,108,103,211,51.2%,26m
3495,2,[BRSKR]Hexe,3949,1386,55,41,96,57.3%,11m
3495,1,Moreover,3949,1039,41,46,87,47.1%,5m
3495,1,theFork,3949,452,19,22,41,46.3%,3m
3495,2,Fresh,3949,364,15,8,23,65.2%,5m
3495,2,MuT,3949,286,10,3,13,76.9%,14m
3495,2,IIIIIIIIIIII,3949,274,8,9,17,47.1%,11m
3495,2,TylerDurden,3949,68,3,2,5,60.0%,11m
3495,1,Midgard,3949,44,1,5,6,16.7%,7m
3504,1,[RÐG]Dynamic,3948,1848,269,269,538,50.0%,7m
3504,1,Revenge,3948,1861,168,160,328,51.2%,7m
3504,3,[VuV]ElGarno,3948,832,49,70,119,41.2%,10m
3504,2,Tyty,3948,140,5,4,9,55.6%,12m
3504,1,YungAfterNyt,3948,166,5,4,9,55.6%,4m
3504,1,Pecueca,3948,48,1,4,5,20.0%,4m
3504,2,[ENV]AtoMic,3948,0,0,1,1,0.0%,1m
3511,1,[Dae]Skoll,3947,2016,148,156,304,48.7%,14m
3511,1,dfine,3947,1302,51,51,102,50.0%,18m
3511,1,Rookie,3947,558,48,20,68,70.6%,14m
3511,2,PacquiaO,3947,285,13,11,24,54.2%,12m
3511,2,MostlyRegreT,3947,186,10,0,10,100.0%,10m
3511,1,[3Dǃ]ƎDǃBee,3947,320,7,14,21,33.3%,18m
3511,2,EXTRAMÖNCH,3947,134,4,2,6,66.7%,6m
3511,1,[eXǂ]NeoW,3947,90,3,5,8,37.5%,10m
3519,1,Jane,3946,1044,32,27,59,54.2%,6m
3519,2,JustInSane,3946,574,22,13,35,62.9%,6m
3519,1,[INAE]Kronos,3946,773,21,19,40,52.5%,4m
3519,3,Infestor,3946,137,21,44,65,32.3%,15m
3519,1,BlazerHazer,3946,160,6,5,11,54.5%,13m
3519,2,rejko,3946,0,1,0,1,100.0%,5m
3519,2,[EAU]InSeCaToR,3946,0,1,0,1,100.0%,39m
3519,2,Azelea,3946,40,1,1,2,50.0%,10m
3519,2,Buddy,3946,0,0,1,1,0.0%,14m
3519,2,[TLAG]Auk,3946,0,0,2,2,0.0%,9m
3529,1,juri,3945,2010,423,413,836,50.6%,18m
3529,2,HolyJoseph,3945,986,164,143,307,53.4%,27m
3529,1,[RÆ]HysteresiS,3945,2010,93,84,177,52.5%,11m
3529,1,salt,3945,1117,92,75,167,55.1%,1m
3529,2,Korzh,3945,1698,75,50,125,60.0%,3m
3529,1,Storky,3945,848,47,34,81,58.0%,2m
3529,2,JustInSane,3945,514,23,9,32,71.9%,17m
3529,2,SCIIMacro,3945,282,10,9,19,52.6%,8m
3529,2,CoronaVirus,3945,76,3,0,3,100.0%,2m
3529,3,RAGEeXs,3945,60,3,2,5,60.0%,4m
3529,2,[TirolA]Urono,3945,0,1,0,1,100.0%,4m
3529,2,Wersi,3945,36,1,1,2,50.0%,5m
3541,1,[WАSD]MadMax,3944,92,3,9,12,25.0%,17m
3541,1,[RеG]papastreck,3944,94,2,2,4,50.0%,5m
3543,1,AvoKaDO,3943,685,21,17,38,55.3%,5m
3543,2,[NsAǂ]SushiBalboha,3943,298,10,6,16,62.5%,12m
3543,2,IIIIIIIIIIII,3943,238,8,5,13,61.5%,18m
3543,2,rex,3943,162,5,3,8,62.5%,1m
3543,1,poichiche,3943,93,1,3,4,25.0%,14m
3543,1,llllllllllll,3943,0,0,6,6,0.0%,4m
3549,1,[DaGOAT]Sinus,3942,1403,188,181,369,50.9%,11m
3549,1,Sensiskunk,3942,736,129,134,263,49.0%,3m
3549,1,Jonz,3942,1870,60,67,127,47.2%,16m
3549,1,StephaTron,3942,874,39,29,68,57.4%,7m
3549,2,Ajax,3942,190,10,1,11,90.9%,18m
3549,1,[IPW]NiceBiT,3942,420,9,19,28,32.1%,15m
3549,1,iKnowKungFu,3942,48,2,4,6,33.3%,10m
3549,1,[TerBHD]Tamior,3942,91,1,3,4,25.0%,12m
3549,2,Xellon,3942,0,0,1,1,0.0%,2m
3558,1,[ValidG]Poofpoo,3941,1551,92,85,177,52.0%,15m
3558,1,[WPki]Hiro,3941,1550,43,49,92,46.7%,10m
3558,1,[TAW]Tompann,3941,1174,29,33,62,46.8%,13m
3558,1,ChadQueen,3941,360,16,8,24,66.7%,1m
3562,1,Epixaa,3940,702,36,19,55,65.5%,7m
3562,1,Melydron,3940,796,20,22,42,47.6%,7m
3562,3,CupOfTea,3940,0,4,1,5,80.0%,25m
3562,2,Nightmare,3940,0,3,2,5,60.0%,8m
3566,1,Trancendence,3939,1987,134,127,261,51.3%,7m
3566,1,Deveron,3939,887,30,24,54,55.6%,13m
3566,2,[MeIina]UndeadGirl,3939,680,23,22,45,51.1%,7m
3566,1,PULO,3939,386,11,10,21,52.4%,13m
3566,3,IIIIIIIIIIII,3939,197,10,2,12,83.3%,17m
3566,1,Madara,3939,46,2,3,5,40.0%,11m
3566,1,IIIIIIIIIIII,3939,139,2,4,6,33.3%,3m
3566,1,theloopa,3939,0,0,8,8,0.0%,39m
3574,1,IIIIIIIIIIII,3938,1957,91,96,187,48.7%,2m
3574,1,Nighthawk,3938,1994,89,94,183,48.6%,7m
3574,1,boseqc,3938,1752,84,85,169,49.7%,15m
3574,1,[ŋǤ]Calamaro,3938,561,32,49,81,39.5%,3m
3574,1,sdlgkjewrn,3938,651,29,34,63,46.0%,2m
3574,2,Goty,3938,78,3,3,6,50.0%,11m
3580,1,IIIIIIIIIIII,3937,910,32,23,55,58.2%,7m
3580,3,llllllllllll,3937,283,13,1,14,92.9%,40m
3580,1,[lMMl]Speedymaza,3937,316,7,7,14,50.0%,13m
3580,1,LasTSamurai,3937,46,1,5,6,16.7%,18m
3584,1,Hydrenoire,3936,1692,100,87,187,53.5%,9m
3584,3,[IceUp]Woodrose,3936,714,56,87,143,39.2%,27m
3584,1,MaxiMal,3936,1238,37,44,81,45.7%,9m
3584,2,MJHolland,3936,464,21,7,28,75.0%,5m
3584,1,Addict,3936,440,9,11,20,45.0%,12m
3584,2,JaaZ,3936,112,3,4,7,42.9%,8m
3584,1,chocsam,3936,136,2,4,6,33.3%,16m
3584,2,Addie,3936,42,1,3,4,25.0%,5m
3584,2,[GURKI]tuberculum,3936,0,0,1,1,0.0%,10m
3584,1,[EESC]Torru,3936,0,0,4,4,0.0%,7m
3594,1,Calvity,3935,1280,43,30,73,58.9%,18m
3594,2,llllllllllll,3935,166,6,4,10,60.0%,15m
3594,2,Odin,3935,0,0,1,1,0.0%,14m
3594,2,MiPo,3935,0,0,1,1,0.0%,15m
3594,2,[C84]skiLLet,3935,0,0,1,1,0.0%,8m
3599,1,OOOOOOOOOOOO,3934,625,50,37,87,57.5%,18m
3599,1,Mihawk,3934,504,12,16,28,42.9%,25m
3599,1,[QTclub]DarkLord,3934,184,6,5,11,54.5%,2m
3599,1,[ZERGML]Alexeyder,3934,109,3,2,5,60.0%,5m
3599,2,[Aziz]Senn,3934,88,2,2,4,50.0%,5m
3599,3,ReFleXioN,3934,30,1,1,2,50.0%,13m
3599,2,Byakush,3934,36,1,1,2,50.0%,3m
3599,1,Samonier,3934,46,1,4,5,20.0%,10m
3599,2,[duсks]upakowka,3934,0,0,2,2,0.0%,6m
3608,2,Jiraiya,3933,252,8,6,14,57.1%,7m
3608,1,Kotzbrocken,3933,232,6,10,16,37.5%,6m
3608,2,[F42]Nuklearwurst,3933,64,3,2,5,60.0%,7m
3608,2,[OSgZ]Cinderella,3933,0,1,1,2,50.0%,10m
3612,1,llllllll,3932,1028,173,174,347,49.9%,7m
3612,2,Eye,3932,1449,66,65,131,50.4%,26m
3612,1,Crucible,3932,650,45,25,70,64.3%,14m
3612,1,[ЯD]EmTee,3932,1104,41,42,83,49.4%,6m
3612,1,CarpeBM,3932,402,32,15,47,68.1%,7m
3612,2,Woolley,3932,543,23,19,42,54.8%,14m
3612,2,Roxy,3932,222,8,4,12,66.7%,12m
3612,2,[Ðucky]Pie,3932,0,1,1,2,50.0%,10m
3620,1,cadenza,3931,1997,661,632,1293,51.1%,18m
3620,2,Inject,3931,751,56,44,100,56.0%,2m
3620,2,MadMan,3931,640,24,17,41,58.5%,13m
3620,2,Nymphetamine,3931,0,0,2,2,0.0%,18m
3624,1,[illGG]Jin,3930,1557,116,110,226,51.3%,5m
3624,1,[CIB]malcomix,3930,1987,97,104,201,48.3%,13m
3624,2,SCMVP,3930,78,3,4,7,42.9%,10m
3624,3,Midnight,3930,86,3,4,7,42.9%,11m
3624,1,AliDeluxe,3930,48,2,9,11,18.2%,15m
3624,3,[Fridge]Shiro,3930,0,1,1,2,50.0%,11m
3624,2,Poisson,3930,34,1,1,2,50.0%,4m
3624,2,iCampsYou,3930,0,0,1,1,0.0%,2m
3632,1,[ETIB]suistrop,3929,1832,140,135,275,50.9%,15m
3632,2,iVer,3929,1389,113,62,175,64.6%,17m
3632,1,[TgK]CubeCow,3929,1021,110,56,166,66.3%,2m
3632,1,[just]IsakZeN,3929,963,83,66,149,55.7%,2m
3636,1,Potofiou,3928,1969,310,326,636,48.7%,1m
3636,1,BigKaA,3928,1968,300,281,581,51.6%,18m
3636,1,Buster,3928,412,9,21,30,30.0%,13m
3636,2,[TGCrew]Relentless,3928,60,3,2,5,60.0%,11m
3636,2,Joan,3928,0,1,0,1,100.0%,3m
3636,2,[Ymer]Ringbind,3928,0,0,1,1,0.0%,5m
3636,2,Hornuvore,3928,0,0,1,1,0.0%,18m
3636,2,Jeemix,3928,0,0,1,1,0.0%,3m
3644,2,Quakeman,3927,303,37,21,58,63.8%,27m
3645,1,[ncotic]Doctor,3926,766,19,20,39,48.7%,4m
3645,2,Zergzwerg,3926,132,4,3,7,57.1%,4m
3645,2,Roma,3926,74,2,5,7,28.6%,14m
3648,1,Kampfgurke,3925,1966,64,63,127,50.4%,7m
3648,2,Milie,3925,847,38,18,56,67.9%,17m
3648,2,nocheesepls,3925,792,35,20,55,63.6%,10m
3648,1,Grumpy,3925,1208,30,41,71,42.3%,2m
3648,2,MrJEJUS,3925,341,14,4,18,77.8%,18m
3648,2,Timoko,3925,340,12,6,18,66.7%,9m
3648,2,[LOGG]belsazer,3925,0,4,1,5,80.0%,3m
3648,2,Milan,3925,134,4,3,7,57.1%,7m
3648,3,[0Head]SmurfGranate,3925,0,2,3,5,40.0%,3m
3657,2,[LSPs]SeñorPepino,3924,670,23,24,47,48.9%,16m
3657,1,[Xa]OldWhiteRabb,3924,711,17,19,36,47.2%,13m
3657,2,[Gwakfr]Noodles,3924,0,1,0,1,100.0%,4m
3657,2,[Cacino]odd,3924,0,0,1,1,0.0%,7m
3657,2,[CS02]Ace,3924,0,0,1,1,0.0%,17m
3662,3,Ocebe,3923,1241,736,754,1490,49.4%,14m
3662,1,Insideme,3923,1983,275,270,545,50.5%,10m
3662,2,michary,3923,712,30,27,57,52.6%,6m
3662,3,[eloelo]Shakur,3923,0,1,0,1,100.0%,18m
3662,2,[THP]Nunnent,3923,40,1,1,2,50.0%,15m
3662,3,[FlyPy]joonTerror,3923,0,0,1,1,0.0%,6m
3662,2,Goubix,3923,0,0,1,1,0.0%,10m
3662,2,[scp3]MrPoulpe,3923,0,0,1,1,0.0%,3m
3670,1,dashet,3922,1969,219,218,437,50.1%,14m
3670,1,[BKKJS]bayerju,3922,1801,159,158,317,50.2%,25m
3670,1,Tea,3922,1662,121,113,234,51.7%,25m
3670,1,privacyAnnul,3922,588,25,17,42,59.5%,16m
3670,1,[Graps]Gimme,3922,348,10,10,20,50.0%,17m
3670,2,QuamfyBrah,3922,70,2,2,4,50.0%,39m
3670,1,[A0]JulianHow,3922,93,1,4,5,20.0%,15m
3670,2,Frosthand,3922,0,0,1,1,0.0%,8m
3678,1,[SƿG]Izuni,3921,1327,100,89,189,52.9%,18m
3678,1,Molu,3921,332,11,25,36,30.6%,2m
3678,2,IIIIIIIIIIII,3921,0,1,0,1,100.0%,10m
3678,2,Appelschrapp,3921,0,1,0,1,100.0%,10m
3682,1,[EmŦ]ForEver,3920,1654,58,66,124,46.8%,14m
3682,2,hihihihihihi,3920,200,6,7,13,46.2%,10m
3682,1,[EseEse]EseEseEse,3920,218,6,21,27,22.2%,13m
3682,2,[сSсǃ]August,3920,138,4,3,7,57.1%,6m
3682,2,[TSNAG]Zaurq,3920,0,1,0,1,100.0%,9m
3682,2,Skabbi,3920,0,0,1,1,0.0%,5m
3682,3,IIIIIIIIIIII,3920,0,0,3,3,0.0%,11m
3689,1,[ĦRZ]MeistrVasqus,3919,1445,88,93,181,48.6%,14m
3689,3,farSight,3919,30,1,2,3,33.3%,6m
3689,2,[2iG]Dewoy,3919,0,0,1,1,0.0%,9m
3692,2,[ECE]DarKnighT,3918,1000,38,34,72,52.8%,12m
3692,1,sqrset,3918,540,35,19,54,64.8%,11m
3692,2,[GoldM]Pain,3918,258,10,2,12,83.3%,7m
3692,1,ADTank,3918,92,1,4,5,20.0%,16m
3696,2,Priism,3917,756,122,107,229,53.3%,10m
3696,1,[Hrr]GlobaL,3917,304,19,11,30,63.3%,3m
3696,2,IIIIIIIIIIII,3917,337,11,13,24,45.8%,8m
3696,2,Echizen,3917,192,6,4,10,60.0%,5m
3696,2,Monor,3917,36,2,3,5,40.0%,8m
3701,1,Tutyi,3916,1957,165,150,315,52.4%,13m
3701,1,[Kings]bugiiiii,3916,1893,82,80,162,50.6%,18m
3701,1,[LL]hellkama,3916,349,25,15,40,62.5%,17m
3701,1,Isurus,3916,574,23,24,47,48.9%,15m
3701,2,Jamies,3916,34,2,1,3,66.7%,4m
3701,2,[RYDA]aLx,3916,0,1,2,3,33.3%,1m
3707,2,aDri,3915,959,41,23,64,64.1%,27m
3707,2,Denkisuperi,3915,694,28,19,47,59.6%,15m
3707,1,[nB]DreinarK,3915,1044,25,34,59,42.4%,7m
3707,1,Luppa,3915,321,19,7,26,73.1%,40m
3707,2,llllllllllll,3915,30,2,1,3,66.7%,3m
3707,2,Temos,3915,34,1,1,2,50.0%,3m
3707,3,Vorgoth,3915,30,1,1,2,50.0%,2m
3707,2,[Kurios]SaAr,3915,0,1,1,2,50.0%,11m
3707,2,kFog,3915,0,0,1,1,0.0%,7m
3707,2,SeTBe,3915,0,0,2,2,0.0%,5m
3717,1,CalypsO,3914,1653,191,186,377,50.7%,13m
3717,2,[Lab001]MadScientist,3914,496,29,15,44,65.9%,5m
3717,2,Triggered,3914,409,22,3,25,88.0%,18m
3717,2,зерг,3914,0,1,2,3,33.3%,5m
3717,3,MrWednesday,3914,0,0,1,1,0.0%,1m
3717,2,[iööi]Öhi,3914,0,0,1,1,0.0%,9m
3717,2,castelu,3914,0,0,1,1,0.0%,27m
3717,2,DollarsCZ,3914,0,0,2,2,0.0%,25m
3725,2,Cap,3913,1704,311,302,613,50.7%,2m
3725,1,budasty,3913,1160,224,220,444,50.5%,13m
3725,2,JustLasse,3913,1018,128,123,251,51.0%,6m
3725,1,[BBSC]Sequency,3913,988,51,36,87,58.6%,9m
3725,2,[VUK]Packman,3913,324,11,12,23,47.8%,5m
3725,2,[µ31]lyml,3913,0,1,0,1,100.0%,2m
3725,1,Hamster,3913,0,0,4,4,0.0%,9m
3732,1,crazyBunny,3912,2021,290,284,574,50.5%,4m
3732,1,Eorkern,3912,1679,76,81,157,48.4%,15m
3732,1,Sertorius,3912,1262,75,73,148,50.7%,7m
3732,1,dAsHiN,3912,892,32,38,70,45.7%,3m
3732,1,Ame,3912,716,18,25,43,41.9%,14m
3732,1,Pharaun,3912,465,14,15,29,48.3%,13m
3732,2,KingArthur,3912,272,9,10,19,47.4%,15m
3732,2,[Triolo]Kourkz,3912,0,0,1,1,0.0%,4m
3732,2,[Coșmar]Miezu,3912,0,0,1,1,0.0%,16m
3741,1,[Whut]Mark,3911,1980,461,462,923,49.9%,16m
3741,2,Epsilon,3911,1369,271,256,527,51.4%,1m
3741,1,Ferz,3911,978,28,29,57,49.1%,6m
3741,1,hubdra,3911,186,4,9,13,30.8%,9m
3741,2,[FARLIG]neiS,3911,0,0,1,1,0.0%,6m
3746,1,badabudaba,3910,1359,132,126,258,51.2%,18m
3746,2,[PSlSTC]Minimoog,3910,1279,55,43,98,56.1%,15m
3746,1,BigBen,3910,478,10,13,23,43.5%,7m
3746,2,[ĦRZ]Banti,3910,0,0,1,1,0.0%,5m
3750,1,Fenechka,3909,1859,152,161,313,48.6%,5m
3750,1,IIIIIIIIIIII,3909,987,63,65,128,49.2%,1m
3750,3,[PÂRłAH]robotikov,3909,0,0,1,1,0.0%,12m
3753,2,nicetry,3908,881,184,172,356,51.7%,7m
3753,1,[HFR]Xhris,3908,1261,71,90,161,44.1%,3m
3753,1,HushHush,3908,546,13,19,32,40.6%,3m
3753,2,bigxxx,3908,208,11,8,19,57.9%,27m
3753,2,llllllllllll,3908,212,8,4,12,66.7%,11m
3758,1,Foxy,3907,1872,143,137,280,51.1%,2m
3758,2,SayCheese,3907,1207,50,48,98,51.0%,39m
3758,2,Dyshe,3907,503,35,19,54,64.8%,2m
3758,1,IIIIIIIIIIII,3907,678,16,29,45,35.6%,6m
3758,2,zeldarom,3907,0,1,0,1,100.0%,7m
3758,2,GoooD,3907,0,1,0,1,100.0%,4m
3758,2,Batcat,3907,0,0,2,2,0.0%,10m
3758,2,[ANTl]Matter,3907,0,0,3,3,0.0%,6m
3766,3,Кварк,3906,420,210,214,424,49.5%,6m
3766,2,[YHWH]Vigoda,3906,352,16,14,30,53.3%,25m
3766,2,[WCGtop]SenFx,3906,196,7,5,12,58.3%,2m
3766,1,[oudini]MrAlais,3906,264,6,11,17,35.3%,18m
3770,1,[EWW]ElemenT,3905,694,64,55,119,53.8%,18m
3770,2,[tepia]tepia,3905,828,32,22,54,59.3%,9m
3770,1,ZeroBrain,3905,1022,25,30,55,45.5%,9m
3770,3,sONEg,3905,294,14,4,18,77.8%,7m
3770,2,heat,3905,290,11,5,16,68.8%,14m
3770,1,KernelPanic,3905,112,3,4,7,42.9%,18m
3770,2,SorSy,3905,38,1,1,2,50.0%,4m
3770,2,Duggi,3905,40,1,4,5,20.0%,5m
3778,2,BadFatWilly,3904,1127,105,90,195,53.8%,6m
3778,2,[shenan]Rabbit,3904,1188,80,80,160,50.0%,27m
3778,2,PandTforDaun,3904,836,35,20,55,63.6%,14m
3778,1,[ØC]Pandalord,3904,900,21,27,48,43.8%,9m
3778,1,[IndyK]Zwyrolek,3904,362,14,15,29,48.3%,2m
3778,2,Burger,3904,152,5,6,11,45.5%,14m
3784,2,Fenrir,3903,1677,211,190,401,52.6%,18m
3784,3,Rainbow,3903,219,11,2,13,84.6%,18m
3784,2,Sanguinario,3903,166,5,6,11,45.5%,2m
3784,2,SoralARaison,3903,0,1,0,1,100.0%,18m
3784,2,[BRSKR]BeWater,3903,0,0,2,2,0.0%,4m
3789,1,DeadMonster,3902,1693,123,122,245,50.2%,18m
3789,1,GoodFella,3902,1437,81,82,163,49.7%,2m
3789,2,[RBlood]biboui,3902,622,27,13,40,67.5%,2m
3789,1,EstebanOcon,3902,398,9,11,20,45.0%,6m
3789,1,[TheDOH]stikky,3902,184,4,14,18,22.2%,10m
3789,2,Indezart,3902,0,0,1,1,0.0%,15m
3789,2,[Xa]Zyklon,3902,0,0,1,1,0.0%,18m
3789,2,[BolosC]Dems,3902,0,0,4,4,0.0%,18m
3789,2,Fire,3902,0,0,5,5,0.0%,2m
3798,2,[NxS]souf,3901,1492,55,57,112,49.1%,27m
3798,2,[LEB]Happy,3901,1284,49,45,94,52.1%,15m
3798,2,TobeJBR,3901,312,27,10,37,73.0%,4m
3801,1,[skate]helpy,3900,1971,646,664,1310,49.3%,25m
3801,3,Ambi,3900,1693,341,362,703,48.5%,2m
3801,2,[Sarmat]DocTor,3900,1468,84,80,164,51.2%,27m
3801,2,[sCion]AiRboRnE,3900,1252,43,47,90,47.8%,12m
3801,1,[BRSKR]Wookiemonsta,3900,866,41,35,76,53.9%,7m
3801,1,FrozenCoke,3900,1084,27,37,64,42.2%,18m
3801,1,Reaverk,3900,842,25,22,47,53.2%,5m
3801,2,ПриветОтОпти,3900,469,18,15,33,54.5%,15m
3801,2,gurky,3900,193,8,3,11,72.7%,3m
3801,3,Mivix,3900,30,4,4,8,50.0%,18m
3801,1,AminoX,3900,93,1,4,5,20.0%,2m
3801,2,VLAD,3900,0,0,1,1,0.0%,4m
3813,1,wickedest,3899,776,168,166,334,50.3%,14m
3813,1,[0BO]Deva,3899,1950,126,128,254,49.6%,5m
3813,1,TheVISioNer,3899,1361,46,39,85,54.1%,2m
3813,1,NeOz,3899,1049,40,39,79,50.6%,5m
3813,1,Fullbringer,3899,798,19,24,43,44.2%,2m
3813,2,toolegit,3899,339,18,6,24,75.0%,6m
3813,2,Dopenoodle,3899,486,17,11,28,60.7%,14m
3813,2,[ImKing]Jools,3899,304,10,27,37,27.0%,7m
3813,2,tesszero,3899,202,7,10,17,41.2%,5m
3813,2,Rumshack,3899,72,2,4,6,33.3%,6m
3823,1,Tromex,3898,912,111,114,225,49.3%,15m
3823,2,[Kozaky]Nifler,3898,908,36,27,63,57.1%,5m
3823,1,Yalos,3898,858,34,19,53,64.2%,2m
3823,1,[DZTK]TheMaster,3898,561,31,26,57,54.4%,13m
3823,2,[RеG]YoungDRG,3898,224,7,7,14,50.0%,18m
3823,2,Freesky,3898,80,3,3,6,50.0%,10m
3823,2,Grace,3898,40,2,1,3,66.7%,3m
3823,2,NeOfAcE,3898,118,2,3,5,40.0%,5m
3831,1,Zend,3897,1988,183,187,370,49.5%,13m
3831,2,Jaesung,3897,360,18,5,23,78.3%,4m
3831,1,[ICA]Muckles,3897,216,6,11,17,35.3%,3m
3831,1,BERBERECHOS,3897,92,3,7,10,30.0%,9m
3831,1,[Invǂ]SaNTaSaN,3897,92,2,10,12,16.7%,2m
3836,1,EnerVation,3896,1751,109,106,215,50.7%,39m
3836,2,[TUPL]McDoudles,3896,482,21,11,32,65.6%,1m
3836,2,Grimforce,3896,178,10,5,15,66.7%,5m
3836,2,Midnight,3896,34,1,1,2,50.0%,18m
3836,2,Nox,3896,0,0,1,1,0.0%,6m
3836,2,Varus,3896,0,0,3,3,0.0%,8m
3842,1,[PaniC]xxMVGNUMxx,3895,889,23,27,50,46.0%,10m
3842,2,IIIIIIIIIIII,3895,162,6,3,9,66.7%,19m
3842,2,[RBMK]UncleCedrov,3895,0,0,1,1,0.0%,3m
3842,2,TonySoprano,3895,0,0,1,1,0.0%,15m
3842,2,DinDomino,3895,0,0,2,2,0.0%,15m
3842,2,TraXxX,3895,0,0,3,3,0.0%,18m
3848,1,[illGG]KhalEZ,3894,1074,30,36,66,45.5%,3m
3848,2,llllllllllll,3894,504,17,15,32,53.1%,15m
3848,2,april,3894,280,14,11,25,56.0%,14m
3848,1,cYclopYze,3894,555,13,18,31,41.9%,17m
3848,2,Edraxima,3894,227,12,5,17,70.6%,18m
3848,2,Odin,3894,172,5,5,10,50.0%,2m
3848,2,[PÄR]Koter,3894,0,1,1,2,50.0%,11m
3848,2,[яєѕ]DroneKing,3894,0,0,2,2,0.0%,5m
3856,1,[HERP]Fourleaf,3893,1982,381,383,764,49.9%,3m
3856,2,[PD]IMNesTea,3893,1659,100,46,146,68.5%,6m
3856,2,Riyoshima,3893,234,7,8,15,46.7%,2m
3856,2,IIIIIIIIIIII,3893,0,1,0,1,100.0%,11m
3856,2,LOBstah,3893,0,1,1,2,50.0%,15m
3861,1,[TRNA]sorill,3892,1402,66,62,128,51.6%,7m
3861,2,Squall,3892,68,3,0,3,100.0%,8m
3863,2,[ICYFAR]Blodzil,3891,647,28,9,37,75.7%,5m
3863,3,Burst,3891,194,6,4,10,60.0%,7m
3865,1,BrendaSesel,3890,1966,278,271,549,50.6%,13m
3865,1,[0mg]Sroljo,3890,1967,139,158,297,46.8%,14m
3865,2,FroGGyStylE,3890,1603,91,64,155,58.7%,10m
3865,1,Peert,3890,1180,54,61,115,47.0%,3m
3865,2,Eythor,3890,734,26,23,49,53.1%,27m
3865,2,ChatRoach,3890,34,1,2,3,33.3%,3m
3865,2,SirAnneau,3890,0,0,1,1,0.0%,2m
3872,1,[PLA2N]tommygun,3889,1652,64,60,124,51.6%,18m
3872,1,ASvool,3889,862,33,43,76,43.4%,2m
3872,2,MiLiTanTe,3889,352,13,6,19,68.4%,5m
3872,2,ConnyDuck,3889,184,7,3,10,70.0%,1m
3872,1,звезда,3889,181,6,5,11,54.5%,11m
3872,2,[Ex0n]Spii,3889,0,1,0,1,100.0%,4m
3878,1,[EseEse]Ese,3888,686,45,33,78,57.7%,2m
3878,2,fibric,3888,30,2,0,2,100.0%,16m
3878,2,Burbn,3888,0,0,1,1,0.0%,4m
3881,1,BigBrain,3887,299,8,6,14,57.1%,13m
3881,2,Bragi,3887,0,1,0,1,100.0%,3m
3881,3,[Castpl]michus,3887,30,1,1,2,50.0%,8m
3881,2,[MiMs]Zarbula,3887,0,0,1,1,0.0%,4m
3881,1,[ValouR]WoODY,3887,0,0,2,2,0.0%,6m
3881,2,[4SL]aZookies,3887,0,0,2,2,0.0%,2m
3887,1,LittleStorm,3886,274,9,11,20,45.0%,13m
3887,3,deama,3886,0,1,0,1,100.0%,8m
3887,2,[WhiteX]Tymmox,3886,0,1,0,1,100.0%,10m
3890,1,BigMuzzi,3885,1962,457,474,931,49.1%,14m
3890,1,[UATeam]bigbeat,3885,985,28,33,61,45.9%,1m
3890,2,[PAHE]YasOKuUhL,3885,175,4,3,7,57.1%,5m
3890,2,єМагвітер,3885,0,0,1,1,0.0%,9m
3894,1,Thrall,3884,1958,279,289,568,49.1%,6m
3894,2,llllllllllll,3884,689,29,20,49,59.2%,3m
3894,2,[HOTFIR]AIphaStar,3884,0,1,0,1,100.0%,25m
3894,2,Ryuma,3884,36,1,2,3,33.3%,25m
3898,1,[SAX]LoveMachine,3883,1950,218,213,431,50.6%,18m
3898,2,iPeX,3883,1318,54,41,95,56.8%,25m
3900,2,Viktor,3882,1654,164,162,326,50.3%,27m
3900,2,Tassaross,3882,274,10,7,17,58.8%,16m
3900,3,AntiiWani,3882,97,6,0,6,100.0%,6m
3900,2,Hansinaquak,3882,106,4,4,8,50.0%,27m
3900,2,Fayx,3882,34,2,1,3,66.7%,2m
3905,1,EagerDrone,3881,1551,71,68,139,51.1%,18m
3905,2,New,3881,359,14,7,21,66.7%,14m
3905,2,[omnce]NazmoX,3881,256,9,6,15,60.0%,9m
3905,2,AuntIrma,3881,0,0,3,3,0.0%,5m
3909,1,Excited,3880,1688,412,413,825,49.9%,16m
3909,2,yoda,3880,1418,99,39,138,71.7%,2m
3909,2,dajmi,3880,1252,46,44,90,51.1%,16m
3909,1,JoyRider,3880,884,22,25,47,46.8%,6m
3909,2,Bumbler,3880,392,14,9,23,60.9%,6m
3909,2,[CøS]Gunrell,3880,128,7,3,10,70.0%,27m
3909,2,Quinter,3880,162,6,4,10,60.0%,4m
3909,2,[SmB]casshernD,3880,140,5,4,9,55.6%,2m
3909,1,UnknowN,3880,204,4,10,14,28.6%,7m
3909,2,[ILGBI]Nuktsuko,3880,0,1,0,1,100.0%,25m
3919,1,[Ǽ1]ЙôŠŠťęḞ,3879,1900,100,106,206,48.5%,1m
3919,2,sebs,3879,1628,83,73,156,53.2%,39m
3919,2,Maumau,3879,1019,58,46,104,55.8%,14m
3919,2,BlackHole,3879,926,44,24,68,64.7%,4m
3919,2,[69420]Juggernug,3879,952,35,35,70,50.0%,5m
3919,2,KanIaCle,3879,590,26,14,40,65.0%,15m
3919,1,[KoyBee]Koy,3879,890,23,28,51,45.1%,19m
3919,2,IIIIIIIIII,3879,470,22,9,31,71.0%,6m
3919,2,[3A]StrikE,3879,0,1,0,1,100.0%,6m
3919,3,FrozenPizza,3879,30,1,7,8,12.5%,2m
3919,2,[0BO]Mogat,3879,0,0,1,1,0.0%,26m
3919,1,Fantasma,3879,0,0,6,6,0.0%,6m
3931,1,foxypie,3878,761,138,144,282,48.9%,7m
3931,2,BaseUnit,3878,678,28,14,42,66.7%,27m
3931,2,Swarm,3878,450,16,11,27,59.3%,4m
3931,3,nonono,3878,307,12,7,19,63.2%,26m
3931,1,Rickoshet,3878,371,9,14,23,39.1%,18m
3931,2,[LAWINE]TheAnswer,3878,108,4,6,10,40.0%,6m
3931,2,Wixz,3878,34,1,1,2,50.0%,40m
3931,2,MulTTitask,3878,0,1,1,2,50.0%,17m
3931,2,[EAU]Spirit,3878,0,0,2,2,0.0%,16m
3940,3,ElFleischo,3877,237,9,1,10,90.0%,27m
3940,2,[XDN]noStress,3877,34,1,2,3,33.3%,7m
3940,2,George,3877,0,0,3,3,0.0%,11m
3940,2,scaarZ,3877,0,0,3,3,0.0%,6m
3944,2,Hulk,3876,1463,148,142,290,51.0%,2m
3944,2,nirsoXD,3876,280,10,8,18,55.6%,39m
3944,2,[αX]BushZk,3876,98,4,2,6,66.7%,10m
3944,2,[BND]Myrion,3876,186,4,6,10,40.0%,8m
3944,2,EungGa,3876,0,0,1,1,0.0%,2m
3949,1,[DNARI]SoulBurner,3875,1667,157,154,311,50.5%,8m
3949,2,Oink,3875,436,14,16,30,46.7%,5m
3949,1,CancelCult,3875,390,14,16,30,46.7%,7m
3949,1,[HayCe]Mazicho,3875,222,5,10,15,33.3%,15m
3949,2,[AmW1]NeonRa,3875,34,2,2,4,50.0%,2m
3949,2,Artick,3875,36,1,1,2,50.0%,40m
3949,1,[UATeam]CruelHamster,3875,0,0,6,6,0.0%,9m
3956,1,Bartek,3874,1712,189,184,373,50.7%,19m
3956,1,Azalima,3874,1063,63,64,127,49.6%,6m
3956,2,Niven,3874,255,14,5,19,73.7%,16m
3956,3,IIIIIIIIIIII,3874,261,8,2,10,80.0%,3m
3956,2,[biglol]marvel,3874,150,5,6,11,45.5%,25m
3956,3,langesMESSER,3874,121,3,0,3,100.0%,27m
3956,2,quadiq,3874,0,1,2,3,33.3%,9m
3956,2,Cobra,3874,0,0,1,1,0.0%,8m
3956,2,Sage,3874,0,0,3,3,0.0%,8m
3965,2,Gnomister,3873,360,16,5,21,76.2%,14m
3965,2,Wolfhanter,3873,0,1,0,1,100.0%,4m
3965,2,Mick,3873,0,0,1,1,0.0%,9m
3965,2,Jackalen,3873,0,0,1,1,0.0%,18m
3965,2,Fusebot,3873,0,0,1,1,0.0%,18m
3970,1,DLNevS,3872,551,118,117,235,50.2%,18m
3970,2,ZaraBiceps,3872,755,27,20,47,57.4%,6m
3970,1,[B1G]Slacker,3872,493,16,15,31,51.6%,9m
3970,2,[mfixed]ProFarT,3872,160,6,4,10,60.0%,8m
3970,2,MidOrFeed,3872,88,4,4,8,50.0%,11m
3970,3,PapaDragon,3872,0,0,1,1,0.0%,27m
3970,2,[HBGSJR]Smiley,3872,0,0,1,1,0.0%,2m
3977,1,Rotnacum,3871,1749,290,268,558,52.0%,2m
3977,2,[Xa]niko,3871,1584,96,89,185,51.9%,2m
3977,1,nklzwei,3871,1328,53,43,96,55.2%,18m
3977,2,[RstE]Témelios,3871,362,13,10,23,56.5%,14m
3977,2,Zeratuss,3871,64,3,2,5,60.0%,39m
3977,2,ZinK,3871,0,0,1,1,0.0%,8m
3983,1,[FRxFR]CREEDxd,3870,1696,246,241,487,50.5%,7m
3983,2,[IBA]Skyld,3870,1112,60,55,115,52.2%,14m
3983,2,Clom,3870,742,31,22,53,58.5%,5m
3983,2,Zergasm,3870,0,0,1,1,0.0%,18m
3983,2,EnDenDino,3870,0,0,1,1,0.0%,17m
3983,2,[WITCHs]Monky,3870,0,0,1,1,0.0%,4m
3983,2,[ESNE]Zelock,3870,0,0,1,1,0.0%,12m
3990,1,[Oursbl]Kuberaz,3869,1799,123,117,240,51.2%,18m
3990,1,Stups,3869,1443,67,76,143,46.9%,10m
3990,1,Xephos,3869,246,10,5,15,66.7%,14m
3990,2,llllllllllll,3869,60,3,2,5,60.0%,6m
3990,2,[Invǂ]DXM,3869,99,1,3,4,25.0%,39m
3990,2,[Cannоn]LebRaKaeSe,3869,34,1,3,4,25.0%,7m
3990,1,[1TNS1]Jamasman,3869,0,1,4,5,20.0%,5m
3997,1,sarcasme,3868,1228,51,65,116,44.0%,9m
3997,1,Azke,3868,732,30,20,50,60.0%,2m
3997,2,EconDude,3868,64,3,3,6,50.0%,3m
3997,1,steveXcz,3868,90,2,11,13,15.4%,18m
3997,2,Longer,3868,0,1,0,1,100.0%,26m
3997,2,Erberack,3868,40,1,4,5,20.0%,14m
4003,1,Zmora,3867,1602,107,92,199,53.8%,40m
4003,2,[4KROOT]misery,3867,490,45,36,81,55.6%,8m
4003,2,[KDV]kowallosu,3867,293,16,14,30,53.3%,10m
4003,1,[ENCEE]serral,3867,361,14,12,26,53.8%,2m
4003,2,[Animе]BastBasket,3867,0,1,0,1,100.0%,9m
4003,2,Misaki,3867,36,1,3,4,25.0%,6m
4003,2,[PSlSTC]MyLifeFrAiur,3867,0,0,1,1,0.0%,12m
4010,1,[BRSKR]SnapCast,3866,1759,68,77,145,46.9%,13m
4010,2,[Zelos]Zersandet,3866,314,11,4,15,73.3%,10m
4010,2,Rastafury,3866,56,3,4,7,42.9%,10m
4010,2,ShiznGiggz,3866,38,2,5,7,28.6%,4m
4010,2,iNVICTUS,3866,0,0,1,1,0.0%,8m
4015,2,Yos,3865,792,28,29,57,49.1%,2m
4015,2,IIIIIIIIIIII,3865,32,1,1,2,50.0%,16m
4017,1,llllllllllll,3864,1434,281,257,538,52.2%,9m
4017,1,[Камрад]Muchacho,3864,1740,176,186,362,48.6%,3m
4017,1,ThirtySixYO,3864,1189,117,112,229,51.1%,9m
4017,2,EnergiyaZerg,3864,118,5,0,5,100.0%,2m
4017,2,Explosion,3864,144,5,4,9,55.6%,27m
4017,2,[sbNDR]sim,3864,0,1,0,1,100.0%,2m
4017,2,[tH]Thor,3864,0,0,1,1,0.0%,8m
4017,2,gameinn,3864,0,0,1,1,0.0%,15m
4017,2,Arabacha,3864,0,0,2,2,0.0%,26m
4026,2,Longneko,3863,1629,189,190,379,49.9%,27m
4026,2,TrapMan,3863,156,6,5,11,54.5%,9m
4026,2,Dream,3863,124,4,6,10,40.0%,40m
4026,2,[NMF]NiamoR,3863,0,0,1,1,0.0%,15m
4026,2,Kelhoan,3863,0,0,1,1,0.0%,16m
4031,1,Chucke,3862,1965,412,420,832,49.5%,5m
4031,2,phenix,3862,1257,63,54,117,53.8%,6m
4031,2,FistBruh,3862,981,38,34,72,52.8%,10m
4031,1,Bishop,3862,391,10,20,30,33.3%,11m
4031,2,Sundava,3862,106,3,8,11,27.3%,15m
4031,1,FunkyGnomo,3862,92,2,9,11,18.2%,11m
4037,2,[Phaseo]Xolocotzii,3861,514,19,14,33,57.6%,15m
4037,2,[IndyK]CaesarTymon,3861,68,3,2,5,60.0%,15m
4037,2,EcoRI,3861,0,1,0,1,100.0%,8m
4037,2,[Cosmic]MadMaestro,3861,38,1,2,3,33.3%,5m
4037,3,Nodus,3861,0,0,1,1,0.0%,13m
4037,2,[RemRam]Ram,3861,0,0,2,2,0.0%,13m
4043,2,immortalz,3860,1600,183,176,359,51.0%,8m
4043,2,Celestial,3860,360,21,22,43,48.8%,27m
4043,2,GreenTea,3860,60,3,0,3,100.0%,11m
4043,2,Armatrix,3860,30,2,0,2,100.0%,10m
4043,2,Airlord,3860,0,0,5,5,0.0%,10m
4048,1,ioiomojo,3859,1850,142,138,280,50.7%,2m
4048,1,[DМG]GanzVlad,3859,1437,45,50,95,47.4%,26m
4048,2,Frutos,3859,544,20,19,39,51.3%,17m
4048,2,[RedPG]Vickhoff,3859,572,19,17,36,52.8%,26m
4048,2,zzWade,3859,337,12,18,30,40.0%,10m
4048,1,Lex,3859,280,6,16,22,27.3%,13m
4048,2,FengTimo,3859,132,5,6,11,45.5%,6m
4048,2,Thiano,3859,166,4,1,5,80.0%,15m
4048,2,BamMargera,3859,98,4,3,7,57.1%,8m
4048,2,Parzival,3859,40,2,3,5,40.0%,16m
4048,2,XRG,3859,0,0,4,4,0.0%,9m
4059,1,[OPLA]Zou,3858,1425,74,80,154,48.1%,2m
4059,1,Kenshin,3858,1541,54,52,106,50.9%,2m
4059,1,Vorck,3858,1143,36,38,74,48.6%,25m
4059,1,[Heroes]Harokku,3858,1238,31,46,77,40.3%,26m
4059,2,Onoes,3858,92,3,1,4,75.0%,6m
4059,2,Misato,3858,68,3,3,6,50.0%,11m
4059,3,[TerrBS]Hichigo,3858,0,1,0,1,100.0%,27m
4059,2,Stewie,3858,0,1,2,3,33.3%,4m
4059,3,HungryShark,3858,30,1,2,3,33.3%,18m
4059,2,Arialkz,3858,0,0,1,1,0.0%,4m
4069,1,[ḾǂḰ]Mikifor,3857,1543,63,77,140,45.0%,6m
4069,2,Rugi,3857,348,11,16,27,40.7%,2m
4069,2,Veasharr,3857,34,2,1,3,66.7%,7m
4069,2,[CirKus]Gallus,3857,0,0,2,2,0.0%,15m
4073,1,OtTer,3856,846,30,43,73,41.1%,16m
4073,2,BlackRa,3856,0,2,3,5,40.0%,18m
4073,2,Mastalord,3856,36,2,5,7,28.6%,39m
4076,2,[PaniC]MarineKing,3855,38,2,4,6,33.3%,25m
4076,2,[DrGNT]DRAGONPIOU,3855,0,1,0,1,100.0%,25m
4076,3,[KREU]KimKunhee,3855,0,1,2,3,33.3%,16m
4076,2,[Side]SCIV,3855,0,0,1,1,0.0%,4m
4076,1,llllllllllll,3855,0,0,8,8,0.0%,17m
4081,2,BossTerran,3853,835,70,54,124,56.5%,16m
4081,2,Cheese,3853,768,34,17,51,66.7%,18m
4081,2,March,3853,469,22,24,46,47.8%,2m
4081,2,[SBeZ]Teufel,3853,236,7,12,19,36.8%,6m
4081,2,Andrew,3853,64,2,1,3,66.7%,17m
4081,2,[Zx1]Zenmed,3853,0,1,0,1,100.0%,10m
4081,2,LoGG,3853,0,1,0,1,100.0%,6m
4088,2,Shock,3852,1274,169,149,318,53.1%,2m
4088,1,[BUPO]ZerCules,3852,1953,148,163,311,47.6%,6m
4088,2,[SCSde]Crossi,3852,516,33,26,59,55.9%,2m
4088,1,Ahsoka,3852,429,32,31,63,50.8%,9m
4088,2,najdy,3852,668,30,11,41,73.2%,7m
4088,2,Nervas,3852,150,13,17,30,43.3%,14m
4088,2,Dream,3852,176,6,8,14,42.9%,2m
4088,2,[BTwins]Croword,3852,0,1,0,1,100.0%,15m
4096,2,Maelstrom,3851,1647,97,100,197,49.2%,14m
4096,2,Keter,3851,1076,40,44,84,47.6%,3m
4096,2,[lOoKer]DrAxelroose,3851,927,35,35,70,50.0%,16m
4096,2,mumnum,3851,265,32,34,66,48.5%,10m
4096,2,[GerW]flyhigh,3851,444,16,15,31,51.6%,10m
4096,2,Trylock,3851,228,7,10,17,41.2%,6m
4096,2,[ǂMG]DasDingRules,3851,58,3,0,3,100.0%,15m
4096,1,[HFI]pookie,3851,48,2,9,11,18.2%,6m
4096,2,[voff]SpiderPig,3851,0,0,1,1,0.0%,6m
4105,1,Disharmonist,3850,1941,469,457,926,50.6%,2m
4105,1,Bidouloux,3850,1795,114,111,225,50.7%,5m
4105,1,[eXøde]FLent,3850,1882,103,95,198,52.0%,17m
4105,2,[CuCuMo]Apex,3850,1538,90,77,167,53.9%,19m
4105,1,[НТТ]dEspAiR,3850,134,7,3,10,70.0%,16m
4105,2,[VetM]Garush,3850,32,1,1,2,50.0%,6m
4111,1,[PaniC]Gedeon,3849,1935,256,265,521,49.1%,18m
4111,1,[CYC]Tim,3849,1037,227,225,452,50.2%,3m
4111,1,Piliskner,3849,1949,217,236,453,47.9%,2m
4111,2,Behnrow,3849,1644,157,141,298,52.7%,14m
4111,1,Zairo,3849,1886,138,131,269,51.3%,16m
4111,1,[Sacred]iiiiiiiiiiii,3849,1804,68,61,129,52.7%,3m
4111,2,Scrubb,3849,598,25,12,37,67.6%,12m
4111,2,[TirolA]bodia,3849,540,21,17,38,55.3%,10m
4111,2,Skeeter,3849,246,9,8,17,52.9%,4m
4111,3,Edouard,3849,172,7,3,10,70.0%,12m
4111,2,[Sarmat]Tomstar,3849,70,2,3,5,40.0%,6m
4111,2,InTheNameOf,3849,30,1,2,3,33.3%,10m
4111,2,SKILLENN,3849,0,0,3,3,0.0%,10m
4124,1,[XYFAN]hanxin,3848,1534,584,576,1160,50.3%,40m
4124,1,[SxS]Radio,3848,1498,113,112,225,50.2%,5m
4124,1,Player,3848,729,47,39,86,54.7%,14m
4124,1,valera,3848,729,28,34,62,45.2%,5m
4124,3,[Reapa]FoxSergeant,3848,6,3,34,37,8.1%,2m
4124,2,[SCRAB]PaRa,3848,34,2,1,3,66.7%,4m
4124,2,[4KROOT]Notasmurf,3848,0,1,0,1,100.0%,26m
4124,2,Bugz,3848,0,0,1,1,0.0%,2m
4132,2,Мухосранск,3847,1675,298,292,590,50.5%,6m
4132,2,Ghremdal,3847,1627,89,83,172,51.7%,27m
4132,2,Fårikål,3847,400,14,12,26,53.8%,5m
4132,2,[75рус]DeadRabbit,3847,272,10,8,18,55.6%,39m
4132,2,Evenfin,3847,126,4,6,10,40.0%,14m
4132,2,Apex,3847,66,2,3,5,40.0%,11m
4132,2,[8TaO8]Avalon,3847,0,1,0,1,100.0%,5m
4139,1,Живчик,3846,1707,116,113,229,50.7%,40m
4139,1,Krutoy,3846,274,7,13,20,35.0%,18m
4139,2,FckTeran,3846,140,5,7,12,41.7%,6m
4139,2,BPCKrystian,3846,176,5,12,17,29.4%,27m
4139,2,Kipi,3846,136,3,2,5,60.0%,9m
4139,1,Mint,3846,0,3,2,5,60.0%,5m
4139,2,[KrnBrs]Chuckles,3846,30,1,1,2,50.0%,2m
4139,2,[aW]Destro,3846,0,0,2,2,0.0%,3m
4147,1,sdu,3845,1821,139,129,268,51.9%,2m
4147,2,[НТТ]asmot,3845,274,18,19,37,48.6%,8m
4147,2,nyla,3845,30,2,0,2,100.0%,25m
4147,2,KillemAll,3845,40,2,2,4,50.0%,12m
4151,1,Banx,3844,1930,304,305,609,49.9%,26m
4151,1,[EZY]Raziel,3844,1777,107,92,199,53.8%,5m
4151,1,[twOm]FutuCZE,3844,742,68,54,122,55.7%,5m
4151,2,[PLA2N]Zerash,3844,244,8,12,20,40.0%,6m
4151,2,Drugan,3844,62,3,1,4,75.0%,27m
4151,2,[BNFC]SouPeuRMaN,3844,0,1,0,1,100.0%,17m
4151,2,fastr,3844,0,1,1,2,50.0%,4m
4151,2,Cardinal,3844,0,0,1,1,0.0%,19m
4159,2,Babayaga,3843,1462,87,79,166,52.4%,6m
4159,2,Alxs,3843,786,29,28,57,50.9%,1m
4159,1,Zumwalazi,3843,920,24,33,57,42.1%,17m
4159,2,FingerMeDady,3843,297,14,7,21,66.7%,18m
4159,2,Chuckie,3843,412,14,16,30,46.7%,4m
4159,2,AryaStark,3843,216,9,2,11,81.8%,14m
4159,2,HOng,3843,138,8,0,8,100.0%,15m
4159,2,Syzaq,3843,30,1,1,2,50.0%,4m
4159,2,Fleya,3843,0,0,1,1,0.0%,6m
4168,1,Gibbs,3842,1356,86,69,155,55.5%,11m
4168,2,Surm,3842,734,48,24,72,66.7%,9m
4168,1,[DarkAG]Yoshi,3842,300,11,9,20,55.0%,40m
4168,2,SmellyFace,3842,40,2,1,3,66.7%,14m
4168,2,[ZЕRGTV]Qwan,3842,0,0,1,1,0.0%,2m
4173,1,[TheDOH]RockLobster,3841,1320,162,171,333,48.6%,7m
4173,2,Cybernetic,3841,641,35,33,68,51.5%,27m
4173,2,Fighter,3841,212,12,3,15,80.0%,5m
4173,2,Chosen,3841,0,0,1,1,0.0%,9m
4177,1,Segway,3840,1591,267,230,497,53.7%,18m
4177,2,Ozymandias,3840,906,33,34,67,49.3%,7m
4177,2,TAOZ,3840,283,12,4,16,75.0%,27m
4177,2,[IRKPRO]SanyaDV,3840,66,3,3,6,50.0%,5m
4177,2,[GROPOR]Pogomais,3840,30,1,1,2,50.0%,2m
4177,3,EMPIRE,3840,0,1,4,5,20.0%,11m
4177,2,SoulSmith,3840,0,0,1,1,0.0%,17m
4184,1,Tarantula,3839,1940,106,116,222,47.7%,2m
4184,2,Korago,3839,280,10,5,15,66.7%,2m
4184,2,SjKitchen,3839,182,6,7,13,46.2%,17m
4184,2,GøsuSiLenT,3839,132,5,4,9,55.6%,19m
4184,2,[ICGl]KrackIsBack,3839,68,2,2,4,50.0%,9m
4184,2,fark,3839,32,2,6,8,25.0%,15m
4184,1,Dikoobrazz,3839,46,2,8,10,20.0%,9m
4184,2,Andrius,3839,0,0,1,1,0.0%,6m
4184,2,Blackflash,3839,0,0,2,2,0.0%,7m
4193,2,chicken,3838,1011,46,50,96,47.9%,8m
4193,2,[2P2a]Yokonisos,3838,721,35,37,72,48.6%,5m
4193,2,Dvak,3838,216,8,6,14,57.1%,15m
4193,3,[ePunks]Srilo,3838,243,7,3,10,70.0%,3m
4193,2,Thaenthor,3838,108,4,6,10,40.0%,3m
4193,2,Alpo,3838,34,1,5,6,16.7%,4m
4193,2,LemonGreeN,3838,0,0,1,1,0.0%,5m
4193,2,[BRSKR]PseudoMorgan,3838,0,0,1,1,0.0%,6m
4193,2,[w2w]zoidzerg,3838,0,0,2,2,0.0%,2m
4202,1,Strawhat,3837,1555,89,84,173,51.4%,2m
4202,1,Cambronne,3837,1210,84,71,155,54.2%,5m
4202,2,Crytech,3837,1157,67,30,97,69.1%,2m
4202,2,Luko,3837,754,25,31,56,44.6%,10m
4202,3,WeDz,3837,0,0,1,1,0.0%,18m
4202,2,TMT,3837,0,0,1,1,0.0%,26m
4208,2,Buggy,3836,474,21,24,45,46.7%,6m
4208,3,CRISTALO,3836,162,9,0,9,100.0%,12m
4208,2,llllllllllll,3836,216,7,7,14,50.0%,15m
4208,2,Ursus,3836,0,1,0,1,100.0%,4m
4212,2,DraklampaN,3835,100,6,3,9,66.7%,27m
4212,3,Gargamel,3835,0,0,1,1,0.0%,14m
4214,2,Opp,3834,1285,115,110,225,51.1%,27m
4214,2,[PaniC]Freezard,3834,730,68,75,143,47.6%,19m
4214,1,[HBGSJR]Isten,3834,1513,63,69,132,47.7%,40m
4214,2,[7IMBA7]MAKSIMUS,3834,738,34,15,49,69.4%,11m
4214,2,XpL,3834,700,26,22,48,54.2%,18m
4214,2,[JebPiS]Sasin,3834,274,10,10,20,50.0%,5m
4214,2,Ziran,3834,152,5,4,9,55.6%,10m
4214,2,Zeus,3834,32,2,0,2,100.0%,4m
4214,2,ReStartZerg,3834,0,1,0,1,100.0%,27m
4214,2,MileyNydus,3834,0,1,1,2,50.0%,2m
4224,1,JeffJohnson,3833,1928,173,161,334,51.8%,3m
4224,2,llllllllllll,3833,323,16,5,21,76.2%,12m
4224,2,xrom,3833,352,13,11,24,54.2%,2m
4224,2,[DZTK]Keys,3833,318,11,9,20,55.0%,19m
4224,2,[HZRD]Rondariel,3833,166,6,7,13,46.2%,10m
4224,3,[ChTe]TTurRedSheEp,3833,30,2,1,3,66.7%,26m
4224,2,SnFeeK,3833,38,2,1,3,66.7%,6m
4224,2,pillow,3833,66,2,8,10,20.0%,5m
4224,2,Atomfrosch,3833,0,0,3,3,0.0%,9m
4233,2,Isi,3832,1641,303,289,592,51.2%,12m
4233,1,Yos,3832,1656,113,119,232,48.7%,16m
4233,2,[HBGSJR]Dranikon,3832,795,33,32,65,50.8%,4m
4233,2,[VFN]LittleZ,3832,164,9,1,10,90.0%,6m
4233,2,Song,3832,142,8,4,12,66.7%,19m
4233,2,Vinuel,3832,58,3,0,3,100.0%,8m
4233,2,Argaz,3832,62,2,5,7,28.6%,15m
4233,2,Puffball,3832,32,1,1,2,50.0%,11m
4233,2,IcePanda,3832,36,1,3,4,25.0%,2m
4242,2,[Li3]NoThx,3831,1571,126,123,249,50.6%,11m
4242,1,[DRUUCK]DRUCKzepp,3831,1614,51,65,116,44.0%,2m
4242,2,[lOoKer]Werewolf,3831,367,42,13,55,76.4%,15m
4242,2,[ORRO]jul,3831,868,37,29,66,56.1%,10m
4242,2,Flipper,3831,870,35,35,70,50.0%,39m
4242,2,IIIIIIIIIIII,3831,596,24,25,49,49.0%,3m
4242,2,[Worms]Yellowman,3831,656,21,25,46,45.7%,27m
4242,2,HongKongFan,3831,242,12,9,21,57.1%,9m
4242,3,[iX]Qgelfich,3831,142,8,0,8,100.0%,16m
4242,2,HAN,3831,128,4,4,8,50.0%,9m
4242,2,[AISC]Kiwipie,3831,0,1,0,1,100.0%,6m
4242,2,[QTclub]JackDeRipper,3831,0,0,1,1,0.0%,11m
4254,2,Glustrod,3830,1641,271,253,524,51.7%,17m
4254,2,[IAFM]DieFieseKatz,3830,807,152,138,290,52.4%,10m
4254,1,[TAW]Alexandria,3830,697,26,28,54,48.1%,2m
4254,1,romvesen,3830,150,7,21,28,25.0%,2m
4254,2,TempleWorld,3830,130,4,5,9,44.4%,18m
4259,2,VodkOo,3829,1006,40,39,79,50.6%,5m
4259,2,SKTrashCan,3829,1072,39,40,79,49.4%,19m
4259,1,[SciN]Southpaw,3829,1168,32,52,84,38.1%,5m
4259,2,Potefant,3829,650,24,21,45,53.3%,18m
4259,2,bAbAyAgA,3829,220,8,8,16,50.0%,9m
4259,2,Adresant,3829,0,1,1,2,50.0%,26m
4259,2,StaSila,3829,34,1,1,2,50.0%,14m
4259,2,krabator,3829,38,1,1,2,50.0%,17m
4259,2,dajanto,3829,34,1,5,6,16.7%,15m
4259,1,[Oath]zokkerIƎ,3829,0,0,3,3,0.0%,17m
4269,2,[Hrr]Singer,3828,672,24,23,47,51.1%,3m
4269,1,Leaf,3828,725,22,33,55,40.0%,18m
4269,2,Default,3828,190,7,3,10,70.0%,6m
4269,1,exePriMe,3828,130,3,11,14,21.4%,17m
4269,2,[Sm0Q]Maracai,3828,0,1,0,1,100.0%,9m
4269,2,dahtroop,3828,30,1,3,4,25.0%,15m
4269,2,AcQ,3828,0,0,1,1,0.0%,9m
4276,2,Rusviets,3827,1577,105,107,212,49.5%,6m
4276,2,[Kingz]Mondragon,3827,368,15,7,22,68.2%,18m
4276,2,Ghost,3827,292,9,13,22,40.9%,6m
4276,2,[TFSC]CitronVert,3827,94,3,3,6,50.0%,5m
4276,2,[WBO]RokietFjueL,3827,0,1,6,7,14.3%,26m
4276,2,NanMarine,3827,34,1,9,10,10.0%,19m
4276,2,Fryk,3827,0,0,4,4,0.0%,14m
4283,2,szeweningen,3826,1204,47,42,89,52.8%,6m
4283,2,Froning,3826,0,1,2,3,33.3%,6m
4283,2,Asuka,3826,0,0,1,1,0.0%,2m
4283,2,Breedlove,3826,0,0,1,1,0.0%,6m
4283,2,[BBx2]Tremere,3826,0,0,4,4,0.0%,5m
4288,2,Antaru,3825,1530,569,545,1114,51.1%,26m
4288,1,Gata,3825,826,32,34,66,48.5%,7m
4288,2,[H0C]NoFrx,3825,861,31,33,64,48.4%,8m
4288,2,Bergère,3825,736,30,26,56,53.6%,8m
4288,2,Kuszi,3825,384,19,4,23,82.6%,12m
4288,3,NagibatorIMB,3825,245,10,6,16,62.5%,11m
4288,2,[IBeAŚI]MariK,3825,352,10,17,27,37.0%,5m
4288,2,[ØC]AzZix,3825,250,9,6,15,60.0%,25m
4288,3,[ggBDC]ThePatriot,3825,97,2,6,8,25.0%,7m
4297,1,beennneeee,3824,1354,174,165,339,51.3%,6m
4297,1,[GLTD]Raevar,3824,1911,135,147,282,47.9%,26m
4297,1,BananKing,3824,1899,108,96,204,52.9%,7m
4297,2,cruelguy,3824,1142,62,40,102,60.8%,5m
4297,2,Dramol,3824,58,2,1,3,66.7%,19m
4302,2,Marbet,3823,1388,53,50,103,51.5%,7m
4302,1,[DAC98]KidCroft,3823,1280,38,47,85,44.7%,17m
4302,2,[mfixed]Seniu,3823,351,16,10,26,61.5%,6m
4302,2,[BotN]CptPolarBear,3823,244,8,9,17,47.1%,26m
4302,2,[GR0M]MicroPixel,3823,152,5,8,13,38.5%,27m
4302,2,JaqBsoN,3823,0,1,0,1,100.0%,26m
4302,1,[UATeam]BlackVelvet,3823,48,1,4,5,20.0%,13m
4302,2,[cellul]AcerPrince,3823,0,0,2,2,0.0%,16m
4310,2,KaneZ,3822,703,67,46,113,59.3%,18m
4310,2,[Zelos]Theila,3822,517,31,26,57,54.4%,2m
4310,2,[4Everr]KingOfLing,3822,452,30,22,52,57.7%,14m
4310,2,Xclusive,3822,336,13,6,19,68.4%,10m
4310,1,root,3822,159,4,5,9,44.4%,9m
4310,2,[RIP007]iTo,3822,90,3,2,5,60.0%,18m
4316,1,Limit,3821,1916,193,178,371,52.0%,15m
4316,2,[WF31A]WiseMan,3821,1568,126,117,243,51.9%,18m
4316,2,[1830]Mainzerg,3821,1470,64,56,120,53.3%,6m
4316,1,[EGIdra]Enjo,3821,976,26,35,61,42.6%,14m
4316,2,[HsDL]Zero,3821,642,23,21,44,52.3%,2m
4316,2,[αX]Onigami,3821,414,16,11,27,59.3%,10m
4316,2,[FETTIS]xSanGuisx,3821,122,4,5,9,44.4%,16m
4316,2,jongleur,3821,36,2,3,5,40.0%,3m
4316,2,FullCollapse,3821,0,1,0,1,100.0%,40m
4316,2,[Arrows]Samer,3821,0,1,0,1,100.0%,7m
4316,2,WeirdAngeluz,3821,0,0,5,5,0.0%,10m
4327,1,Cheeeeeeeese,3820,1908,269,272,541,49.7%,11m
4327,1,[OrPix]Maximus,3820,821,34,25,59,57.6%,9m
4327,1,Twyhl,3820,520,28,26,54,51.9%,18m
4327,2,Synns,3820,382,15,8,23,65.2%,27m
4327,3,rvbr,3820,141,8,0,8,100.0%,27m
4332,2,Blackddude,3819,865,60,43,103,58.3%,4m
4332,2,[blizou]yultan,3819,886,32,32,64,50.0%,2m
4332,3,marus,3819,140,10,2,12,83.3%,2m
4332,2,[xFUD]Araken,3819,198,6,4,10,60.0%,15m
4332,1,RATIX,3819,210,5,7,12,41.7%,17m
4332,2,Fremen,3819,34,2,2,4,50.0%,10m
4332,3,Slagathor,3819,58,2,3,5,40.0%,2m
4332,2,[ZЕRGТV]Aslan,3819,0,1,0,1,100.0%,18m
4332,2,[Islay]PeatyZzz,3819,32,1,1,2,50.0%,6m
4332,2,Chroma,3819,30,1,3,4,25.0%,10m
4342,2,[Kingz]Prymuh,3818,1325,71,57,128,55.5%,5m
4342,2,kentin,3818,1083,48,34,82,58.5%,6m
4342,2,MiguelPérez,3818,702,29,17,46,63.0%,6m
4342,2,yuKo,3818,630,24,18,42,57.1%,10m
4342,2,[Dziabo]Handelson,3818,270,14,14,28,50.0%,5m
4342,2,PrimeMarine,3818,348,13,10,23,56.5%,6m
4342,2,WhiteBison,3818,311,13,14,27,48.1%,39m
4342,2,[TAW]DeathyreX,3818,428,13,19,32,40.6%,2m
4342,1,[TheDOH]NeraDraed,3818,558,13,28,41,31.7%,2m
4342,2,Sputko,3818,62,3,3,6,50.0%,6m
4352,2,[TSVB]Nesquik,3817,102,3,2,5,60.0%,6m
4352,2,Lim,3817,0,1,0,1,100.0%,2m
4352,2,[LSPs]Zaladriel,3817,0,0,1,1,0.0%,15m
4355,1,Grey,3816,1127,99,108,207,47.8%,2m
4355,2,[ЯD]Unknown,3816,438,19,12,31,61.3%,11m
4355,2,Limba,3816,182,6,6,12,50.0%,10m
4355,2,lIlIlIlIlIlI,3816,96,3,6,9,33.3%,2m
4355,2,TheSun,3816,0,1,0,1,100.0%,6m
4355,2,IlIlIlIlIlIl,3816,0,0,2,2,0.0%,18m
4361,1,Magic,3815,1316,196,195,391,50.1%,13m
4361,2,[Minet]TheTu,3815,469,19,15,34,55.9%,16m
4361,2,iLLum,3815,277,11,11,22,50.0%,11m
4361,3,Hood,3815,142,8,0,8,100.0%,14m
4361,2,[KOMKAL]Kerrigan,3815,118,5,2,7,71.4%,40m
4361,2,aTaN,3815,0,0,1,1,0.0%,16m
4361,2,[FrC]Mackiavel,3815,0,0,2,2,0.0%,6m
4368,1,[Lambro]Lucid,3814,1906,288,291,579,49.7%,9m
4368,2,tilapin,3814,1625,231,223,454,50.9%,8m
4368,1,Insomniac,3814,361,10,14,24,41.7%,16m
4368,2,Pengalo,3814,187,8,6,14,57.1%,27m
4368,3,[WSB]GosuHaube,3814,0,1,0,1,100.0%,27m
4368,2,[iX]Aerocool,3814,0,1,1,2,50.0%,18m
4368,2,[HBGSJR]Maxvel,3814,0,0,1,1,0.0%,10m
4375,1,[EESC]Sego,3813,1062,39,44,83,47.0%,14m
4375,1,Niconicopoi,3813,0,1,0,1,100.0%,16m
4375,2,Vap,3813,0,1,1,2,50.0%,10m
4378,2,[AGI]Liberty,3812,613,34,25,59,57.6%,10m
4378,3,[TEEMOS]galgtonold,3812,282,28,44,72,38.9%,10m
4378,2,[SKYBRS]Ianofc,3812,228,9,3,12,75.0%,2m
4378,1,next,3812,48,1,5,6,16.7%,17m
4378,2,[ZERGTV]CaMCa,3812,0,0,1,1,0.0%,6m
4383,2,Tsogi,3811,582,32,7,39,82.1%,18m
4383,2,Delece,3811,514,18,19,37,48.6%,6m
4383,2,[ZERGML]ViPTonari,3811,368,14,8,22,63.6%,16m
4383,3,[4EYES]DasAuto,3811,0,1,0,1,100.0%,27m
4383,2,[1984]TheBigPeaT,3811,0,1,1,2,50.0%,8m
4383,2,Maxmenace,3811,0,0,1,1,0.0%,10m
4383,2,[Fanta4]Lavundi,3811,0,0,3,3,0.0%,19m
4390,1,fzmr,3810,1898,614,629,1243,49.4%,7m
4390,1,[iX]FoREIGNeR,3810,1924,508,513,1021,49.8%,13m
4390,1,Djenster,3810,1897,241,234,475,50.7%,9m
4390,2,[RеG]Rostok,3810,1094,47,34,81,58.0%,25m
4390,2,aaaaaaaaab,3810,159,4,4,8,50.0%,4m
4390,2,Cycle,3810,0,0,2,2,0.0%,19m
4396,1,Astrapilot,3809,1902,175,174,349,50.1%,8m
4396,1,SippShip,3809,1841,117,122,239,49.0%,3m
4396,2,[wedown]DiVuS,3809,450,22,8,30,73.3%,5m
4396,2,[ОБЗМ]WhoIAm,3809,166,6,10,16,37.5%,10m
4396,3,МОРОЖЕНКО,3809,30,2,1,3,66.7%,2m
4396,2,Dreams,3809,64,2,5,7,28.6%,14m
4396,2,Ent,3809,0,1,0,1,100.0%,18m
4396,2,MozartIRL,3809,0,0,1,1,0.0%,2m
4404,1,Voljin,3808,1791,143,121,264,54.2%,18m
4404,2,Hitchhiker,3808,1095,47,36,83,56.6%,5m
4404,2,VLADIUSLAV,3808,86,3,2,5,60.0%,18m
4407,1,Pilot,3807,580,159,164,323,49.2%,11m
4407,2,CantSmile,3807,1532,144,113,257,56.0%,12m
4407,2,Michal,3807,1668,133,107,240,55.4%,4m
4407,2,[Сlеvеr]Swarm,3807,1174,46,39,85,54.1%,26m
4407,1,FALLIN,3807,1124,29,37,66,43.9%,18m
4407,1,[QTcIub]jackie,3807,404,9,21,30,30.0%,13m
4407,3,NesTea,3807,0,4,2,6,66.7%,40m
4407,2,Sobo,3807,96,3,6,9,33.3%,2m
4407,2,[ROOT]SolO,3807,34,2,1,3,66.7%,15m
4407,2,IIIIIIIIIIII,3807,72,2,8,10,20.0%,2m
4407,2,[Serral]suko,3807,0,1,0,1,100.0%,18m
4407,2,[SAX]Phoq,3807,0,0,3,3,0.0%,6m
4419,1,laksonen,3806,1705,320,324,644,49.7%,25m
4419,1,NoCheeseToss,3806,1875,207,204,411,50.4%,11m
4419,2,[Rubic]Desaster,3806,658,27,25,52,51.9%,5m
4419,2,[ØC]iceman,3806,138,4,10,14,28.6%,16m
4419,1,Order,3806,46,2,10,12,16.7%,11m
4419,2,[ARC4]MoleAir,3806,30,1,3,4,25.0%,5m
4419,2,agExxit,3806,0,0,1,1,0.0%,13m
4419,1,[TheRPW]Arkenstone,3806,0,0,5,5,0.0%,8m
4427,1,DareTex,3805,1857,234,240,474,49.4%,7m
4427,1,Deq,3805,1492,113,115,228,49.6%,8m
4427,2,[PLA2N]чебупеля,3805,1274,80,74,154,51.9%,5m
4427,2,RobotDanse,3805,1581,70,48,118,59.3%,2m
4427,2,CheeseInc,3805,1456,65,46,111,58.6%,15m
4427,2,Pokegeodude,3805,850,39,33,72,54.2%,8m
4427,2,llllllllllll,3805,190,6,9,15,40.0%,39m
4427,2,BaNaNa,3805,92,3,8,11,27.3%,40m
4427,2,[APES]CaptainAPE,3805,32,2,2,4,50.0%,15m
4436,2,Reaper,3804,168,8,2,10,80.0%,9m
4436,2,Punk,3804,146,5,4,9,55.6%,25m
4436,2,Nuffie,3804,30,2,0,2,100.0%,19m
4436,2,Cash,3804,0,1,6,7,14.3%,6m
4440,1,hello,3803,1838,288,294,582,49.5%,11m
4440,2,Echinococcus,3803,1643,158,160,318,49.7%,12m
4440,2,OlviC,3803,918,40,28,68,58.8%,40m
4440,2,MidPlatinium,3803,112,7,0,7,100.0%,3m
4440,2,NanoW,3803,90,3,6,9,33.3%,7m
4440,2,pachenko,3803,0,0,1,1,0.0%,11m
4440,2,Zwiback,3803,0,0,1,1,0.0%,5m
4447,2,Logic,3802,1152,180,175,355,50.7%,8m
4447,2,[CORUN]Sabril,3802,249,27,17,44,61.4%,27m
4447,1,[Дядя]BARRISTA,3802,900,25,34,59,42.4%,2m
4447,2,Green,3802,622,20,27,47,42.6%,27m
4447,2,Spun,3802,399,19,19,38,50.0%,15m
4447,2,[ValidG]Darkez,3802,358,13,14,27,48.1%,16m
4447,2,helloRJ,3802,170,5,9,14,35.7%,3m
4447,2,MuhKuh,3802,96,4,4,8,50.0%,8m
4447,2,llllIIIIllll,3802,48,3,2,5,60.0%,27m
4456,2,Kristall,3801,1258,45,48,93,48.4%,26m
4456,2,[Rct]dujambongril,3801,914,40,25,65,61.5%,15m
4456,1,Heller,3801,165,7,0,7,100.0%,8m
4456,2,RFDiMka,3801,34,1,6,7,14.3%,10m
4456,2,[Nawak]shadownight,3801,0,0,1,1,0.0%,9m
4461,1,DekkuTree,3800,1895,179,166,345,51.9%,40m
4461,2,[Obz]Dust,3800,1488,123,121,244,50.4%,2m
4461,2,BabaYaga,3800,256,17,5,22,77.3%,6m
4461,2,[BZZ]Rahl,3800,162,5,2,7,71.4%,6m
4461,2,[Nawak]TOTO,3800,120,4,7,11,36.4%,8m
4461,2,[PwnSc]GeneralSvart,3800,0,1,1,2,50.0%,40m
4467,2,RrAeZza,3799,1022,37,38,75,49.3%,9m
4467,2,easy,3799,329,16,5,21,76.2%,3m
4467,2,Akai,3799,94,3,8,11,27.3%,3m
4467,2,Shinddo,3799,30,2,1,3,66.7%,8m
4467,2,MMOrrissette,3799,0,0,1,1,0.0%,3m
4472,1,kykyna,3798,1357,251,253,504,49.8%,2m
4472,2,Turambarchik,3798,639,76,62,138,55.1%,8m
4472,1,[VoGoNs]peynir,3798,631,63,69,132,47.7%,13m
4472,2,Tsunami,3798,236,11,3,14,78.6%,19m
4472,2,LucasArt,3798,268,10,9,19,52.6%,12m
4472,1,Timekiller,3798,430,9,18,27,33.3%,13m
4472,2,[Trtl]ViolentVik,3798,174,7,5,12,58.3%,19m
4472,2,Warrior,3798,0,0,1,1,0.0%,8m
4480,1,CptRespect,3797,1881,157,155,312,50.3%,11m
4480,2,MenBati,3797,1646,120,109,229,52.4%,3m
4480,2,Extacid,3797,1308,107,94,201,53.2%,27m
4480,2,Teypo,3797,374,13,11,24,54.2%,10m
4480,3,Cogg,3797,194,7,2,9,77.8%,8m
4480,2,iliya,3797,152,6,5,11,54.5%,16m
4480,2,DemonHeart,3797,124,5,5,10,50.0%,16m
4480,2,PeLLy,3797,140,5,10,15,33.3%,8m
4480,2,[LMBD]ByuNJr,3797,62,2,3,5,40.0%,16m
4480,2,Alarak,3797,72,2,4,6,33.3%,18m
4480,2,Dawnerz,3797,0,0,2,2,0.0%,8m
4491,1,Madarnann,3796,1827,366,360,726,50.4%,11m
4491,2,Avalorn,3796,1484,201,183,384,52.3%,8m
4491,2,[Wolven]ClientZero,3796,1437,172,178,350,49.1%,10m
4491,2,klObÜrstE,3796,1249,142,132,274,51.8%,2m
4491,2,[VFish]yellow,3796,539,106,82,188,56.4%,10m
4491,2,[CCAV]desperater,3796,1245,70,51,121,57.9%,19m
4491,2,Glückspilz,3796,774,28,26,54,51.9%,4m
4491,1,nKo,3796,687,18,25,43,41.9%,2m
4491,2,[NoBugs]NerfZerg,3796,226,11,13,24,45.8%,27m
4491,3,Parasyte,3796,145,6,3,9,66.7%,27m
4491,2,MyThOs,3796,172,6,6,12,50.0%,12m
4491,2,[WBO]Parabelitano,3796,60,4,5,9,44.4%,6m
4491,2,[SaneGG]SilverFang,3796,0,0,2,2,0.0%,3m
4504,2,orastem,3795,1568,163,161,324,50.3%,6m
4504,2,Nathaniel,3795,1117,72,59,131,55.0%,15m
4504,2,[adR]rdmZoo,3795,464,23,18,41,56.1%,3m
4504,3,FruitEater,3795,305,13,4,17,76.5%,17m
4504,2,[K0mpis]Mange,3795,90,3,7,10,30.0%,26m
4504,2,desant,3795,0,1,1,2,50.0%,6m
4504,2,[ioStuN]Eddy,3795,0,1,1,2,50.0%,7m
4511,1,Bananensaft,3794,1872,286,270,556,51.4%,9m
4511,2,[lWHl]ThnGamises,3794,1008,39,41,80,48.8%,6m
4511,1,[nB]Addon,3794,1080,28,44,72,38.9%,11m
4511,3,root,3794,166,9,1,10,90.0%,13m
4511,2,IIIIIIIIII,3794,136,8,0,8,100.0%,13m
4511,3,[SGZARM]Arthur,3794,0,0,1,1,0.0%,19m
4517,2,Ethereal,3793,134,4,1,5,80.0%,4m
4517,2,[0Dfeat]Probe,3793,32,2,2,4,50.0%,15m
4517,2,[InBri]AlGor,3793,60,2,5,7,28.6%,2m
4517,2,Megawayne,3793,0,1,2,3,33.3%,27m
4517,2,[LSPs]Bloody,3793,0,0,1,1,0.0%,5m
4517,2,Hospak,3793,0,0,2,2,0.0%,6m
4517,2,Lihnessar,3793,0,0,3,3,0.0%,10m
4524,2,Rawwk,3792,666,26,19,45,57.8%,11m
4524,2,Last,3792,570,20,20,40,50.0%,8m
4524,2,jeanairoldi,3792,60,3,3,6,50.0%,6m
4524,2,llllll,3792,70,3,6,9,33.3%,6m
4524,2,Nightmare,3792,30,2,0,2,100.0%,6m
4524,1,point,3792,0,2,3,5,40.0%,2m
4524,2,IIIIIIIIIIII,3792,0,2,3,5,40.0%,18m
4524,2,Vincent,3792,0,0,2,2,0.0%,3m
4532,2,[MaSiYa]Hercules,3791,658,23,25,48,47.9%,9m
4532,2,corsica,3791,0,0,1,1,0.0%,5m
4532,2,JDSoap,3791,0,0,2,2,0.0%,12m
4535,2,NerdCracker,3790,1307,55,42,97,56.7%,6m
4535,2,Reschi,3790,422,18,9,27,66.7%,16m
4535,2,Krilian,3790,282,9,9,18,50.0%,4m
4535,2,[xMiCx]Kmiras,3790,166,5,11,16,31.2%,12m
4535,2,Bane,3790,88,4,1,5,80.0%,8m
4535,2,[GC]KingOfQueenS,3790,64,3,6,9,33.3%,26m
4535,2,[CU84]PepitoAlcazr,3790,0,1,0,1,100.0%,25m
4535,2,Gaard,3790,0,0,2,2,0.0%,3m
4535,2,Kys,3790,73,0,3,3,0.0%,12m
4544,2,MING,3789,1626,73,54,127,57.5%,5m
4544,2,sTeF,3789,1382,63,60,123,51.2%,5m
4544,2,mTe,3789,174,6,7,13,46.2%,2m
4544,2,assassin,3789,70,3,7,10,30.0%,16m
4544,2,[FearEU]Snake,3789,62,2,6,8,25.0%,3m
4544,2,IlIlIllI,3789,32,2,6,8,25.0%,2m
4544,2,[RuOC]Kartoshka,3789,0,1,1,2,50.0%,2m
4544,2,Cell,3789,0,1,1,2,50.0%,4m
4544,2,KnoeperKalle,3789,0,0,2,2,0.0%,2m
4553,2,Mureke,3788,983,177,164,341,51.9%,4m
4553,1,sTARdasH,3788,1709,85,93,178,47.8%,5m
4553,2,dasdwas,3788,908,60,62,122,49.2%,2m
4553,1,LostReaper,3788,97,5,1,6,83.3%,5m
4553,2,Basher,3788,40,2,7,9,22.2%,7m
4553,2,BNDS,3788,0,1,0,1,100.0%,10m
4553,2,[PlayGG]yGaByGa,3788,0,0,1,1,0.0%,9m
4553,2,[HellSD]Unfug,3788,0,0,1,1,0.0%,7m
4561,1,Sclera,3787,1888,326,334,660,49.4%,14m
4561,2,PitLord,3787,529,45,36,81,55.6%,6m
4561,1,Neront,3787,756,40,46,86,46.5%,3m
4561,2,Kharyb,3787,464,22,11,33,66.7%,8m
4561,2,[TAW]Baker,3787,513,21,11,32,65.6%,6m
4561,2,[Ris3n]Eleven,3787,274,10,9,19,52.6%,18m
4561,2,WeWa,3787,154,6,6,12,50.0%,6m
4561,3,Jelme,3787,97,2,0,2,100.0%,10m
4561,2,SayNoToZion,3787,0,1,0,1,100.0%,3m
4561,2,buffy,3787,0,0,1,1,0.0%,10m
4561,2,Uiblar,3787,0,0,1,1,0.0%,40m
4561,2,[greedy]Nikouze,3787,0,0,3,3,0.0%,40m
4573,1,[Mealen]Doombringer,3786,1862,165,173,338,48.8%,17m
4573,2,Desperado,3786,684,31,9,40,77.5%,6m
4573,2,Bubi,3786,647,31,18,49,63.3%,9m
4573,2,Praetorian,3786,137,16,21,37,43.2%,27m
4573,2,[Troupe]Bebop,3786,60,2,2,4,50.0%,6m
4573,2,Fearless,3786,0,0,2,2,0.0%,11m
4579,2,Pegu,3785,1552,108,105,213,50.7%,5m
4579,2,MalK,3785,1338,88,88,176,50.0%,27m
4579,2,Plupp,3785,1129,51,50,101,50.5%,16m
4579,2,qqq,3785,1066,38,43,81,46.9%,14m
4579,1,[PTLc]smarty,3785,949,26,37,63,41.3%,13m
4579,2,VoidRay,3785,598,23,19,42,54.8%,5m
4579,2,Balder,3785,242,13,3,16,81.2%,16m
4579,3,nazgul,3785,194,10,2,12,83.3%,12m
4579,2,WillyWanker,3785,178,7,9,16,43.8%,5m
4579,2,Lost,3785,92,3,4,7,42.9%,6m
4579,2,JeeTee,3785,0,1,0,1,100.0%,8m
4590,2,YoLaN,3784,1602,166,165,331,50.2%,2m
4590,2,Olmo,3784,586,25,12,37,67.6%,10m
4590,2,Ayoeme,3784,255,13,3,16,81.2%,12m
4590,2,гидрочка,3784,58,3,0,3,100.0%,15m
4590,2,Autorunboga,3784,30,2,1,3,66.7%,19m
4590,2,BlackWolve,3784,32,2,2,4,50.0%,2m
4590,2,[BornG]DusK,3784,36,1,7,8,12.5%,9m
4597,1,oleh,3783,1288,145,144,289,50.2%,5m
4597,2,llllllllllll,3783,566,107,106,213,50.2%,8m
4597,2,[0BO]StarFox,3783,1020,37,41,78,47.4%,15m
4597,2,[6m30]PhilAngel,3783,769,36,22,58,62.1%,5m
4597,2,billoudE,3783,573,23,11,34,67.6%,18m
4597,2,MCDisciple,3783,183,10,9,19,52.6%,6m
4597,2,[Psyc]Naz,3783,290,10,11,21,47.6%,18m
4597,1,[сSсǃ]XumKO,3783,245,10,20,30,33.3%,3m
4597,2,[MiA]Evuser,3783,90,6,4,10,60.0%,8m
4597,1,NeoShAggy,3783,0,1,0,1,100.0%,8m
4597,3,useyourbrain,3783,0,1,0,1,100.0%,14m
4597,2,llllllllllll,3783,0,0,1,1,0.0%,18m
4609,2,MatchMakingg,3782,1473,110,99,209,52.6%,8m
4609,1,ahomar,3782,1872,90,109,199,45.2%,11m
4609,2,[qwerh]PrinceAdam,3782,1074,71,65,136,52.2%,8m
4609,2,[Sents]ThorsPanzer,3782,0,1,4,5,20.0%,16m
4609,2,YourMotherXD,3782,0,0,2,2,0.0%,5m
4614,1,Jetix,3781,1389,119,119,238,50.0%,15m
4614,1,Veclada,3781,1819,77,104,181,42.5%,13m
4614,2,baM,3781,511,50,39,89,56.2%,26m
4614,2,[KENDEK]Kaylan,3781,378,14,17,31,45.2%,17m
4614,2,[СRAZY]Михеюшка,3781,144,8,1,9,88.9%,26m
4614,2,[MASTRO]Cowabünga,3781,134,7,10,17,41.2%,5m
4614,2,[RSK]Charldegol,3781,92,4,5,9,44.4%,6m
4614,1,WarrenBuffet,3781,156,4,13,17,23.5%,19m
4614,2,[COOPM]Kleinkram,3781,32,1,5,6,16.7%,8m
4623,2,ArnoldRimmer,3780,1598,85,62,147,57.8%,6m
4623,2,Kera,3780,995,77,60,137,56.2%,8m
4623,2,Kszys,3780,667,33,39,72,45.8%,8m
4623,1,bonj,3780,832,33,43,76,43.4%,17m
4623,2,nardex,3780,790,31,25,56,55.4%,3m
4623,3,ImBaToSS,3780,166,9,1,10,90.0%,5m
4623,2,[1GH1]Alfastigma,3780,178,7,5,12,58.3%,5m
4623,2,Techmaster,3780,58,6,4,10,60.0%,6m
4623,1,[AISC]PinkBlood,3780,0,1,0,1,100.0%,11m
4623,2,Perceval,3780,0,0,3,3,0.0%,8m
4633,1,BlackBoozom,3779,1889,226,222,448,50.4%,8m
4633,2,zup,3779,1230,45,50,95,47.4%,2m
4633,2,Argentum,3779,87,3,4,7,42.9%,40m
4633,2,RushB,3779,0,1,0,1,100.0%,5m
4633,3,[UPW]Numa,3779,0,0,1,1,0.0%,4m
4633,1,SoNice,3779,0,0,5,5,0.0%,10m
4639,1,[EmŦ]Mobius,3778,1506,130,146,276,47.1%,3m
4639,2,[Heroes]MegaStar,3778,724,31,18,49,63.3%,15m
4639,2,[MSUSC2]Raskol,3778,760,31,29,60,51.7%,18m
4639,2,[Evins]EmilyEnif,3778,561,22,16,38,57.9%,6m
4639,2,[ESOSG]Monxz,3778,345,17,7,24,70.8%,3m
4639,2,llllllllllll,3778,434,15,16,31,48.4%,7m
4639,2,[KDV]Raindbow,3778,0,0,1,1,0.0%,8m
4646,1,Brainoff,3777,1684,52,64,116,44.8%,3m
4646,2,BARCODE,3777,880,33,32,65,50.8%,9m
4646,2,Drakezul,3777,816,28,34,62,45.2%,10m
4646,2,idod,3777,303,19,14,33,57.6%,27m
4646,2,Kutus,3777,150,6,8,14,42.9%,16m
4646,3,[JINX]Deimos,3777,165,4,1,5,80.0%,12m
4646,2,[RSPCT]Foooxxx,3777,90,3,8,11,27.3%,8m
4646,2,[ǂRSǂ]HotS,3777,0,0,1,1,0.0%,6m
4646,2,[SLNTCH]rMo,3777,0,0,1,1,0.0%,16m
4655,2,ZloBOYzeRRR,3776,1392,155,141,296,52.4%,6m
4655,2,Bat,3776,1434,56,51,107,52.3%,6m
4655,2,PSYCHOOOOOMG,3776,569,41,0,41,100.0%,9m
4655,2,IIIIIIIIIIII,3776,373,24,21,45,53.3%,27m
4655,3,SamaR,3776,268,13,4,17,76.5%,16m
4655,2,[DandA]Lechife,3776,226,8,12,20,40.0%,14m
4655,2,FreakMeBob,3776,162,5,10,15,33.3%,2m
4655,1,Orkis,3776,0,3,5,8,37.5%,2m
4655,2,Sacatar,3776,97,2,3,5,40.0%,19m
4655,2,[TWIM]NSK,3776,30,1,3,4,25.0%,9m
4655,2,[FIXi]Мася,3776,0,0,6,6,0.0%,5m
4666,1,stuart,3775,1773,117,120,237,49.4%,16m
4666,2,TobiasKoster,3775,1168,44,42,86,51.2%,40m
4666,3,jujunouf,3775,328,12,5,17,70.6%,7m
4666,2,[ZERGSC]llllllllllll,3775,216,7,10,17,41.2%,27m
4666,2,LiMeCH,3775,30,2,0,2,100.0%,6m
4666,2,Коронный,3775,0,1,0,1,100.0%,26m
4666,2,Larvita,3775,0,1,1,2,50.0%,9m
4666,2,[Hrr]SmarsA,3775,0,0,2,2,0.0%,18m
4674,2,Fatal,3774,1595,83,69,152,54.6%,17m
4674,2,[Froz]FrOzeNDuDe,3774,422,14,18,32,43.8%,16m
4674,1,NoName,3774,335,12,13,25,48.0%,40m
4674,2,OneUp,3774,148,6,7,13,46.2%,8m
4674,2,Kvothe,3774,0,1,0,1,100.0%,40m
4674,2,[FSeS]Emin,3774,73,1,5,6,16.7%,17m
4674,3,MonkeyIsland,3774,0,0,1,1,0.0%,15m
4681,2,JabRoNI,3773,597,60,11,71,84.5%,15m
4681,2,[DPYT]TimonAr,3773,1031,38,40,78,48.7%,7m
4681,2,[R1X]Minto,3773,530,18,25,43,41.9%,7m
4681,2,Tokio,3773,32,6,1,7,85.7%,9m
4681,2,Dav,3773,174,6,6,12,50.0%,10m
4681,2,[ChZeal]Arsonist,3773,144,5,4,9,55.6%,11m
4681,2,IlIlIIIIIIII,3773,0,1,0,1,100.0%,10m
4681,2,[AlienR]Kiriforce,3773,30,1,3,4,25.0%,4m
4681,2,[SVRO]AirBlaze,3773,26,1,6,7,14.3%,14m
4690,2,[JXL]Kam,3772,1653,282,276,558,50.5%,27m
4690,1,GRIMM,3772,1879,163,158,321,50.8%,7m
4690,2,[pØuce]Socks,3772,559,161,145,306,52.6%,5m
4690,2,Teecon,3772,1247,48,58,106,45.3%,5m
4690,2,[INCV]UTLRA,3772,930,38,28,66,57.6%,6m
4690,2,Scran,3772,268,30,28,58,51.7%,4m
4690,2,PiPappaParap,3772,600,25,13,38,65.8%,5m
4690,2,[6RD4]admr,3772,622,20,28,48,41.7%,5m
4690,2,Logy,3772,90,3,6,9,33.3%,9m
4699,2,Seejay,3771,1585,220,215,435,50.6%,12m
4699,2,[75рус]НАГИБАТОР,3771,1079,96,64,160,60.0%,40m
4699,2,TheBestEver,3771,975,94,70,164,57.3%,8m
4699,2,TheDarkOne,3771,677,85,76,161,52.8%,12m
4699,2,[Blacer]InnosGothic,3771,1569,70,61,131,53.4%,14m
4699,1,NoTwitchKid,3771,1337,50,49,99,50.5%,11m
4699,2,[GoldM]Scales,3771,830,31,29,60,51.7%,27m
4699,2,[TAOKIT]Razzag,3771,313,17,24,41,41.5%,11m
4699,1,[RISKE]ALLin,3771,0,2,3,5,40.0%,6m
4699,2,Goplit,3771,0,1,0,1,100.0%,14m
4699,2,Soul,3771,0,0,1,1,0.0%,40m
4710,2,JKL,3770,1604,220,218,438,50.2%,10m
4710,2,Kraelog,3770,1019,45,34,79,57.0%,17m
4710,2,[Dralag]FullMaster,3770,610,23,21,44,52.3%,40m
4710,2,[EAU]AgentKiller,3770,94,3,7,10,30.0%,26m
4714,2,[NONAMЕ]Glacier,3769,1478,91,82,173,52.6%,12m
4714,2,Leinad,3769,811,89,65,154,57.8%,16m
4714,2,[αXi]SniperSC,3769,1304,52,45,97,53.6%,27m
4714,2,[RеG]дядяСаня,3769,58,2,2,4,50.0%,6m
4714,2,[HMSU]Xorda,3769,58,2,3,5,40.0%,12m
4714,2,skerda,3769,58,2,4,6,33.3%,5m
4714,2,[THRLLA]Jiiiiu,3769,0,0,1,1,0.0%,9m
4721,2,Hamza,3768,1172,61,47,108,56.5%,40m
4721,2,mrPipister,3768,583,26,16,42,61.9%,18m
4721,2,[CocoCo]ugly,3768,330,13,10,23,56.5%,27m
4721,3,TheAcordeon,3768,30,2,0,2,100.0%,7m
4721,2,ChiefArbiter,3768,30,1,3,4,25.0%,2m
4721,2,Mirrari,3768,0,0,1,1,0.0%,10m
4721,2,FIZMAT,3768,0,0,1,1,0.0%,10m
4721,2,alex,3768,0,0,1,1,0.0%,3m
4721,2,Fynn,3768,0,0,4,4,0.0%,26m
4730,2,RefoH,3767,1606,80,84,164,48.8%,5m
4730,2,Walle,3767,1376,53,53,106,50.0%,8m
4730,2,[AoTu]happydrops,3767,380,16,16,32,50.0%,13m
4730,2,[oSsOP]Morciera,3767,342,13,10,23,56.5%,9m
4730,2,gerax,3767,202,8,7,15,53.3%,13m
4730,2,Ехала,3767,198,7,4,11,63.6%,15m
4730,2,mOOdY,3767,0,0,1,1,0.0%,6m
4737,2,Michael,3766,1286,287,294,581,49.4%,8m
4737,2,MlekoBoze,3766,737,120,110,230,52.2%,10m
4737,2,McButterpant,3766,918,91,72,163,55.8%,16m
4737,2,trotsky,3766,1493,63,58,121,52.1%,10m
4737,2,[RеG]CiZzyX,3766,1070,43,41,84,51.2%,3m
4737,2,MorroLord,3766,592,29,26,55,52.7%,6m
4737,2,[Convoy]Jakke,3766,522,21,20,41,51.2%,40m
4737,2,Schreihals,3766,328,11,14,25,44.0%,2m
4737,2,ZapeTouch,3766,0,0,3,3,0.0%,5m
4746,2,Wenny,3765,1158,189,176,365,51.8%,9m
4746,2,KeeZ,3765,384,14,16,30,46.7%,6m
4746,3,DRGS,3765,188,9,1,10,90.0%,40m
4746,2,dunkelheit,3765,169,3,7,10,30.0%,26m
4746,2,[CS0]XPA,3765,30,2,1,3,66.7%,16m
4746,2,Ziiim,3765,30,2,6,8,25.0%,18m
4746,2,[NWGD]IIIIIIIIIIII,3765,0,0,3,3,0.0%,2m
4753,1,[Oops]Randsan,3764,1686,134,120,254,52.8%,2m
4753,1,[яєѕ]Lurkas,3764,1038,31,42,73,42.5%,9m
4753,2,Stayback,3764,600,22,26,48,45.8%,27m
4753,2,Denryuu,3764,100,4,9,13,30.8%,3m
4753,2,Lewwawurscht,3764,0,1,0,1,100.0%,12m
4753,2,HorstLocal,3764,0,0,1,1,0.0%,5m
4753,3,[aNx]Vrielo,3764,0,0,1,1,0.0%,19m
4753,2,Alprazolam,3764,0,0,1,1,0.0%,2m
4753,2,[ManB]surculus,3764,0,0,5,5,0.0%,3m
4762,2,hxxud,3763,1301,570,539,1109,51.4%,2m
4762,2,vasiilii,3763,1253,267,249,516,51.7%,19m
4762,2,Unsaint,3763,1557,84,75,159,52.8%,8m
4762,2,Itachi,3763,684,68,57,125,54.4%,2m
4762,2,nangaybiss,3763,854,33,34,67,49.3%,14m
4762,2,JakeOtto,3763,308,12,11,23,52.2%,2m
4762,3,[BRSKR]Lucasdart,3763,86,3,2,5,60.0%,3m
4762,2,[ICGl]TooFasT,3763,60,2,3,5,40.0%,17m
4762,2,[KaGa]lynx,3763,0,0,1,1,0.0%,11m
4771,2,Kenobi,3762,1355,127,119,246,51.6%,15m
4771,2,Abhorash,3762,1589,72,72,144,50.0%,6m
4771,2,IIIIIIIIIIII,3762,528,28,4,32,87.5%,14m
4771,2,vansvemirac,3762,468,19,11,30,63.3%,26m
4771,2,Kruspe,3762,528,19,15,34,55.9%,26m
4771,2,Plugawy,3762,136,4,5,9,44.4%,15m
4771,2,Ayou,3762,60,2,6,8,25.0%,10m
4771,2,Miroxus,3762,0,0,1,1,0.0%,9m
4779,2,Malabar,3761,808,53,49,102,52.0%,18m
4779,2,avraL,3761,1130,41,42,83,49.4%,5m
4779,2,Veruuu,3761,304,17,13,30,56.7%,5m
4779,2,Kyezer,3761,441,16,24,40,40.0%,16m
4779,2,[PANPR]Kohlrabi,3761,58,3,2,5,60.0%,12m
4779,2,Cartman,3761,30,2,0,2,100.0%,2m
4779,2,[Dobro]Arontong,3761,30,1,2,3,33.3%,27m
4786,2,Jossi,3760,1034,191,173,364,52.5%,12m
4786,2,intrepretato,3760,1616,118,112,230,51.3%,9m
4786,2,Slipotron,3760,1200,80,78,158,50.6%,9m
4786,2,[Sc2S]AmazingKurd,3760,856,55,60,115,47.8%,9m
4786,2,[ØC]Jon,3760,838,30,33,63,47.6%,14m
4786,2,Косолапый,3760,92,3,5,8,37.5%,14m
4786,2,Przemek,3760,0,1,0,1,100.0%,6m
4786,2,[GyCd]Alcootest,3760,0,1,2,3,33.3%,2m
4786,2,[SLOTH]ProtostitutE,3760,0,0,1,1,0.0%,10m
4786,2,[FTC]Metaphor,3760,0,0,1,1,0.0%,18m
4786,2,[EV0C]Stefchy,3760,0,0,1,1,0.0%,10m
4786,2,libik,3760,0,0,2,2,0.0%,9m
4798,2,Leikan,3759,1278,115,105,220,52.3%,5m
4798,2,[Smegma]KingLouie,3759,1583,108,110,218,49.5%,4m
4798,3,VinChaud,3759,167,9,2,11,81.8%,2m
4798,2,Lagacy,3759,178,6,9,15,40.0%,40m
4798,2,[DIVOC]Talgoa,3759,58,2,4,6,33.3%,2m
4798,2,Skaro,3759,0,0,2,2,0.0%,16m
4798,2,RedDevil,3759,0,0,2,2,0.0%,8m
4805,2,SKTrashCan,3758,1565,465,454,919,50.6%,6m
4805,2,gary,3758,1217,154,160,314,49.0%,3m
4805,2,[BRSKR]Fishy,3758,560,126,122,248,50.8%,4m
4805,2,Kickazz,3758,1328,52,50,102,51.0%,3m
4805,2,[plopow]Coldkeeper,3758,30,1,1,2,50.0%,16m
4810,2,JerryYu,3757,236,10,11,21,47.6%,11m
4810,2,NaNoPaBo,3757,0,1,0,1,100.0%,27m
4810,2,Shadow,3757,0,0,1,1,0.0%,6m
4810,2,Bucephalus,3757,0,0,1,1,0.0%,9m
4814,2,[PiMoK]HornYprobE,3756,1597,266,233,499,53.3%,8m
4814,2,Stereophobia,3756,379,19,7,26,73.1%,16m
4814,2,Arthur,3756,257,15,17,32,46.9%,5m
4814,2,Oldwow,3756,252,13,5,18,72.2%,5m
4814,2,Kryptonite,3756,322,12,11,23,52.2%,3m
4814,2,stubborn,3756,92,3,4,7,42.9%,6m
4814,2,ArtGatti,3756,0,1,0,1,100.0%,3m
4821,1,Lamkin,3755,980,121,136,257,47.1%,14m
4821,2,[SLW]NainPro,3755,1475,92,76,168,54.8%,3m
4821,2,DrPepper,3755,990,37,40,77,48.1%,9m
4821,2,eeevnsun,3755,691,26,31,57,45.6%,18m
4821,2,[D0N3]ImbaLino,3755,244,8,11,19,42.1%,6m
4821,3,[CRAIC]Penta,3755,121,2,1,3,66.7%,27m
4821,2,Enigma,3755,0,1,1,2,50.0%,3m
4821,3,[Z3RGTV]SERG,3755,0,0,1,1,0.0%,8m
4821,2,Bouftondomac,3755,0,0,3,3,0.0%,2m
4830,2,QuaD,3754,1046,39,38,77,50.6%,2m
4830,2,Bubbles,3754,90,8,10,18,44.4%,4m
4830,1,seed,3754,236,6,19,25,24.0%,8m
4830,1,[FG7]Torgar,3754,105,2,13,15,13.3%,18m
4830,2,[spbila]Adama,3754,30,1,2,3,33.3%,4m
4830,2,ELEGIGGLE,3754,0,0,1,1,0.0%,16m
4836,1,[GAMI]Reset,3753,1328,98,68,166,59.0%,2m
4836,2,Bitu,3753,1416,56,52,108,51.9%,6m
4836,2,HoTkEyS,3753,430,22,10,32,68.8%,15m
4836,2,Kiwistan,3753,373,15,13,28,53.6%,2m
4836,2,[F4RM]DonKarnage,3753,264,9,8,17,52.9%,10m
4836,3,IIIIIIIIIIII,3753,86,4,3,7,57.1%,9m
4836,2,Bison,3753,30,2,4,6,33.3%,5m
4836,2,[DFYIII]sam,3753,0,0,1,1,0.0%,16m
4844,1,Dofenshmirtz,3752,1811,197,197,394,50.0%,11m
4844,2,DerBaum,3752,608,47,52,99,47.5%,18m
4844,2,[PLA2N]Bekzhan,3752,766,29,28,57,50.9%,10m
4844,3,[BWArmy]TRC,3752,315,11,7,18,61.1%,4m
4844,2,Dionys,3752,0,3,2,5,60.0%,12m
4844,2,[TENRIX]nerz,3752,86,3,6,9,33.3%,5m
4844,2,PANIE,3752,0,2,3,5,40.0%,9m
4851,2,yondai,3751,1313,76,79,155,49.0%,5m
4851,2,[HpT]termosCZ,3751,1431,61,49,110,55.5%,19m
4851,2,Snulli,3751,1011,41,32,73,56.2%,7m
4851,2,NFloN,3751,376,30,26,56,53.6%,4m
4851,2,John,3751,482,20,9,29,69.0%,5m
4851,2,WhiteRabbit,3751,410,13,20,33,39.4%,18m
4851,2,SkyLine,3751,0,0,1,1,0.0%,7m
4858,1,IDBigBro,3750,1411,208,220,428,48.6%,6m
4858,2,[DМG]OldMaster,3750,1035,172,171,343,50.1%,8m
4858,1,soulwriter,3750,1336,149,139,288,51.7%,9m
4858,2,Morgul,3750,1238,109,118,227,48.0%,5m
4858,1,stormwingz,3750,671,32,31,63,50.8%,5m
4858,2,ArtiCuNo,3750,592,27,18,45,60.0%,12m
4858,2,[RGAN]ISmokeWeed,3750,536,23,16,39,59.0%,17m
4858,1,Leopard,3750,592,17,31,48,35.4%,5m
4858,2,IIIIIIIIIIII,3750,226,7,11,18,38.9%,5m
4858,2,cybobyrev,3750,122,5,12,17,29.4%,3m
4858,3,[RDrewf]MKH,3750,121,2,2,4,50.0%,13m
4858,2,IllIlIIlIIIl,3750,30,1,5,6,16.7%,9m
4858,3,[Frzen]Elsa,3750,0,0,1,1,0.0%,8m
4871,1,[Hrr]wawx,3749,1083,208,208,416,50.0%,7m
4871,2,tdc,3749,1114,77,64,141,54.6%,11m
4871,2,CannonRusher,3749,323,30,23,53,56.6%,10m
4871,2,lllllllll,3749,683,29,18,47,61.7%,19m
4871,2,[WÖLFE]haebreus,3749,224,8,5,13,61.5%,9m
4871,2,[D13S]azaTkin,3749,48,3,5,8,37.5%,5m
4871,2,Юленька,3749,30,2,1,3,66.7%,10m
4871,2,Fabutaste,3749,30,1,2,3,33.3%,5m
4879,2,ObilanCenobi,3748,662,32,16,48,66.7%,11m
4879,2,[DarkEZ]FunkyPants,3748,644,24,21,45,53.3%,9m
4879,2,[αX]Danotory,3748,346,14,9,23,60.9%,5m
4879,2,TaoMunK,3748,296,11,12,23,47.8%,40m
4879,2,Funnyway,3748,0,1,0,1,100.0%,6m
4879,2,QfifteeN,3748,0,0,1,1,0.0%,18m
4885,1,Carrots,3747,1267,101,111,212,47.6%,2m
4885,2,Alago,3747,309,17,10,27,63.0%,16m
4885,2,Juzpen,3747,184,7,11,18,38.9%,40m
4885,1,MikeLitoris,3747,118,3,0,3,100.0%,4m
4885,2,Teranoiz,3747,0,1,0,1,100.0%,19m
4885,2,GoodLuckHave,3747,88,1,2,3,33.3%,13m
4885,3,NotSureYet,3747,0,0,2,2,0.0%,26m
4885,2,SpaceX,3747,0,0,2,2,0.0%,9m
4893,2,[LMBD]qqvpp,3746,1639,393,385,778,50.5%,40m
4893,1,lIlIlIlIlIlI,3746,1840,376,390,766,49.1%,6m
4893,2,FeSSvG,3746,501,24,7,31,77.4%,12m
4893,2,Frost,3746,457,19,20,39,48.7%,8m
4893,2,idk,3746,325,17,8,25,68.0%,15m
4893,2,Hacip,3746,238,9,10,19,47.4%,8m
4893,3,[nB]TheSvampis,3746,189,6,1,7,85.7%,15m
4893,2,[αX]Azura,3746,154,6,8,14,42.9%,11m
4893,2,Storm,3746,64,2,5,7,28.6%,40m
4893,2,ANAZAPTA,3746,0,1,0,1,100.0%,19m
4893,2,[TheDOH]Shadow,3746,0,0,1,1,0.0%,18m
4904,1,Bee,3745,1860,366,370,736,49.7%,5m
4904,2,Sȅtsuƞai,3745,701,118,109,227,52.0%,2m
4904,2,mack,3745,766,96,95,191,50.3%,14m
4904,2,Paddo,3745,438,15,18,33,45.5%,10m
4904,2,omg,3745,266,11,5,16,68.8%,5m
4904,2,CarbonString,3745,0,1,0,1,100.0%,12m
4904,2,Slaislom,3745,0,0,1,1,0.0%,10m
4911,1,[Mosaic]Areaz,3744,1451,46,55,101,45.5%,5m
4911,1,Logic,3744,1422,45,60,105,42.9%,18m
4911,2,MikeHawk,3744,260,8,8,16,50.0%,19m
4911,2,Zes,3744,90,4,1,5,80.0%,10m
4911,1,[OCL]Sig,3744,42,1,16,17,5.9%,14m
4911,2,[H0C]Greed,3744,0,0,1,1,0.0%,27m
4911,2,[KABANG]TerenceSkill,3744,0,0,4,4,0.0%,11m
4918,2,[SCiE]TheNewTos,3743,1510,163,159,322,50.6%,10m
4918,2,DevilOP,3743,711,42,38,80,52.5%,8m
4918,2,Strache,3743,436,17,14,31,54.8%,5m
4918,2,[BARJO]Maximus,3743,312,13,5,18,72.2%,3m
4918,3,louvirilou,3743,209,7,9,16,43.8%,12m
4918,3,Gubbel,3743,30,1,3,4,25.0%,17m
4918,2,[aW]Novo,3743,30,1,5,6,16.7%,14m
4918,2,[eSps]Angel,3743,0,0,1,1,0.0%,2m
4926,2,challiwell,3742,1588,85,59,144,59.0%,12m
4926,2,[xMiCx]Haze,3742,1361,59,56,115,51.3%,16m
4926,2,Mastermind,3742,424,15,9,24,62.5%,14m
4926,2,[TiTan]restanis,3742,122,5,5,10,50.0%,10m
4926,2,Indeed,3742,174,4,7,11,36.4%,5m
4926,2,[Hrr]Безразличие,3742,0,0,1,1,0.0%,2m
4932,2,Pagaille,3741,1590,227,227,454,50.0%,19m
4932,2,ViEnTo,3741,966,42,23,65,64.6%,17m
4932,2,Illuminator,3741,206,8,8,16,50.0%,16m
4932,2,SerralRules,3741,118,4,1,5,80.0%,7m
4932,2,Coxta,3741,90,3,5,8,37.5%,5m
4932,2,Willem,3741,96,3,7,10,30.0%,5m
4932,2,Executor,3741,58,2,1,3,66.7%,11m
4932,2,[TheDOH]Dain,3741,30,1,3,4,25.0%,12m
4932,2,homik,3741,30,1,3,4,25.0%,6m
4941,2,[EESC]Razydiee,3740,1637,166,163,329,50.5%,12m
4941,2,Enki,3740,1080,56,49,105,53.3%,40m
4941,1,ProtoZZavr,3740,1030,29,41,70,41.4%,7m
4941,2,[WaSl]Tafelwasser,3740,204,11,13,24,45.8%,6m
4941,2,[WWU]wtfxKKTHXBYE,3740,52,4,5,9,44.4%,14m
4941,2,[BiOdrO]TemplarGBA,3740,0,1,2,3,33.3%,17m
4941,2,[DeVu]IMoGsPrime,3740,0,0,1,1,0.0%,4m
4941,2,lIlIlllIlIII,3740,0,0,1,1,0.0%,8m
4941,2,Holmes,3740,0,0,3,3,0.0%,10m
4950,1,Rain,3739,1781,237,224,461,51.4%,8m
4950,2,IlIIllIIllII,3739,1562,118,93,211,55.9%,6m
4950,2,RgPRox,3739,286,22,12,34,64.7%,18m
4950,3,Velkor,3739,234,11,2,13,84.6%,9m
4950,2,FlowerABC,3739,30,2,1,3,66.7%,2m
4950,2,CookieMonsta,3739,0,1,6,7,14.3%,10m
4956,2,[Y187]Wombat,3738,1104,55,40,95,57.9%,2m
4956,2,[R4ZR]Kelenas,3738,1336,48,54,102,47.1%,12m
4956,2,CatInBox,3738,480,17,16,33,51.5%,5m
4956,2,[MogaDa]Raisolution,3738,116,4,8,12,33.3%,17m
4956,2,MiniGabe,3738,86,3,2,5,60.0%,15m
4956,2,Uniq,3738,30,2,2,4,50.0%,9m
4956,3,YFC,3738,0,1,0,1,100.0%,3m
4956,2,[TTAS]REPER,3738,30,1,1,2,50.0%,5m
4956,2,Robertino,3738,0,0,1,1,0.0%,27m
4965,2,[OtES]cronos,3737,1649,184,186,370,49.7%,9m
4965,2,[SaLa]ElxMargerin,3737,1002,40,34,74,54.1%,3m
4965,2,[сSсǃ]icygeo,3737,410,16,12,28,57.1%,8m
4965,2,vikke,3737,408,15,15,30,50.0%,16m
4965,3,Dudziu,3737,276,10,8,18,55.6%,2m
4965,2,royber,3737,182,9,13,22,40.9%,4m
4965,2,BabyPartinG,3737,0,1,0,1,100.0%,18m
4965,2,Robokops,3737,0,0,1,1,0.0%,16m
4965,1,ChefEjtebez,3737,0,0,1,1,0.0%,2m
4965,3,[STАR]PlatOK,3737,0,0,3,3,0.0%,27m
4975,2,Bulbasaur,3736,1536,131,112,243,53.9%,9m
4975,2,Noisym,3736,453,42,41,83,50.6%,10m
4975,2,[NMSQ]RubiX,3736,168,7,4,11,63.6%,5m
4975,2,[Walez]Gaspard,3736,126,4,8,12,33.3%,12m
4975,3,Läppulf,3736,58,2,1,3,66.7%,18m
4975,2,[SpeshT]Monte,3736,32,1,1,2,50.0%,3m
4975,2,Lioporto,3736,0,0,2,2,0.0%,6m
4982,1,BuRneR,3735,1864,561,587,1148,48.9%,4m
4982,1,GaMbleR,3735,1863,156,174,330,47.3%,11m
4982,1,[PbPlan]Hellraisa,3735,1853,123,139,262,46.9%,6m
4982,2,RRa,3735,1042,50,53,103,48.5%,19m
4982,2,TerranTears,3735,0,1,0,1,100.0%,8m
4982,2,Meepo,3735,34,1,4,5,20.0%,26m
4982,3,[BHC]BlackHand,3735,0,0,1,1,0.0%,27m
4982,2,Nahoy,3735,0,0,1,1,0.0%,13m
4982,2,Gwynbleidd,3735,0,0,1,1,0.0%,8m
4991,2,[NILE]Dukov,3734,1209,55,42,97,56.7%,9m
4991,2,[UA92]lArry,3734,1020,54,34,88,61.4%,16m
4991,2,[PiGPan]WaterDrop,3734,1072,50,54,104,48.1%,3m
4991,2,[ba5ic]IIIbarCODEII,3734,350,14,12,26,53.8%,5m
4991,2,[Kingz]Revenoir,3734,180,6,10,16,37.5%,2m
4991,2,GatewayMan,3734,0,1,0,1,100.0%,12m
4991,2,Cheesy,3734,0,1,0,1,100.0%,8m
4991,2,[Craft]PlayerCraft,3734,0,1,3,4,25.0%,16m
4991,2,[EAU]Foxsuze,3734,0,0,1,1,0.0%,10m
4991,2,[DsnD]NeaTea,3734,0,0,1,1,0.0%,14m
4991,2,[BOGG]EtiennePX,3734,0,0,2,2,0.0%,11m
5002,2,MrBlobbable,3733,1526,63,61,124,50.8%,15m
5002,2,boppers,3733,426,16,16,32,50.0%,11m
5002,1,MLtBethowen,3733,118,7,0,7,100.0%,4m
5002,2,rezt,3733,0,1,0,1,100.0%,8m
5002,2,ShadowStorm,3733,30,1,3,4,25.0%,10m
5002,2,llllllllllll,3733,0,0,1,1,0.0%,40m
5002,2,Nando,3733,0,0,1,1,0.0%,7m
5002,2,Jack,3733,0,0,2,2,0.0%,9m
5002,2,DuoPump,3733,0,0,4,4,0.0%,15m
5011,2,XIII,3732,574,54,51,105,51.4%,10m
5011,2,zeratul,3732,180,7,9,16,43.8%,4m
5011,2,FireFly,3732,114,5,13,18,27.8%,5m
5011,2,Barrie,3732,94,4,4,8,50.0%,10m
5011,2,[MERBAL]MerliN,3732,60,2,3,5,40.0%,19m
5011,2,pedick,3732,0,1,0,1,100.0%,5m
5011,2,BrothersDinn,3732,0,0,1,1,0.0%,9m
5011,2,AKIMITSU,3732,0,0,1,1,0.0%,3m
5011,2,Zorg,3732,0,0,2,2,0.0%,5m
5020,1,Umlaut,3731,1827,298,296,594,50.2%,18m
5020,2,ItsWillie,3731,1569,274,244,518,52.9%,17m
5020,2,NLJosh,3731,1499,182,181,363,50.1%,16m
5020,2,Alpha,3731,704,30,29,59,50.8%,8m
5020,2,ActionAdi,3731,463,24,9,33,72.7%,8m
5020,1,Infinity,3731,48,3,6,9,33.3%,12m
5020,2,eNTropy,3731,38,2,10,12,16.7%,40m
5020,2,BuRned,3731,0,1,0,1,100.0%,17m
5028,2,[AcidB]AcidBurn,3730,1596,293,283,576,50.9%,2m
5028,2,ALX,3730,821,73,66,139,52.5%,7m
5028,2,OniKratos,3730,1122,41,41,82,50.0%,16m
5028,2,[Cannоn]Onliner,3730,633,29,34,63,46.0%,14m
5028,2,XEN,3730,624,22,27,49,44.9%,5m
5028,2,klex,3730,277,19,12,31,61.3%,12m
5028,2,[FxL]OverRainbow,3730,332,11,13,24,45.8%,15m
5028,2,Erik,3730,232,8,13,21,38.1%,19m
5028,2,MHDARR,3730,102,6,5,11,54.5%,40m
5028,2,TrumpvsCovid,3730,0,1,0,1,100.0%,7m
5028,2,LeDuckling,3730,0,1,1,2,50.0%,16m
5028,2,Thepanek,3730,30,1,1,2,50.0%,40m
5028,2,ONBlivionS,3730,88,1,3,4,25.0%,18m
5028,2,Artöm,3730,0,0,1,1,0.0%,2m
5028,2,Imagine,3730,0,0,1,1,0.0%,18m
5043,2,Starkiller,3729,937,97,92,189,51.3%,11m
5043,2,Barcode,3729,901,92,71,163,56.4%,9m
5043,2,[ykyp]adrfinance,3729,783,52,36,88,59.1%,6m
5043,2,[EAU]LouisDCLXVI,3729,1462,52,59,111,46.8%,5m
5043,2,TraGEN,3729,481,21,22,43,48.8%,40m
5043,2,inoprishilen,3729,271,21,27,48,43.8%,27m
5043,2,llllllllllll,3729,430,16,9,25,64.0%,27m
5043,2,[AG]BeerPong,3729,284,11,8,19,57.9%,15m
5043,2,Антонас,3729,0,0,1,1,0.0%,13m
5052,2,[GosuB]Yavoul,3728,1577,208,205,413,50.4%,12m
5052,2,[ÐSharK]eRaZz,3728,550,29,13,42,69.0%,16m
5052,2,LacSpore,3728,568,27,33,60,45.0%,5m
5052,2,Emulebest,3728,588,25,12,37,67.6%,5m
5052,2,Beeznees,3728,117,5,9,14,35.7%,27m
5052,2,Cherminator,3728,86,4,2,6,66.7%,7m
5052,2,MaddoX,3728,60,3,2,5,60.0%,10m
5052,2,FreePts,3728,0,2,3,5,40.0%,2m
5052,2,PhENOm,3728,0,0,1,1,0.0%,19m
5052,2,Nizahe,3728,0,0,1,1,0.0%,9m
5052,2,SaViTaR,3728,0,0,1,1,0.0%,6m
5052,2,Balrok,3728,0,0,1,1,0.0%,9m
5052,2,IMBateValcho,3728,0,0,3,3,0.0%,7m
5065,2,Zillah,3727,1481,370,365,735,50.3%,6m
5065,2,fInch,3727,899,124,108,232,53.4%,9m
5065,2,aYeti,3727,365,13,10,23,56.5%,2m
5065,2,Venturo,3727,172,7,5,12,58.3%,2m
5065,2,LunatikGG,3727,90,3,3,6,50.0%,15m
5065,3,[BPX]EAǂDrelle,3727,0,0,1,1,0.0%,17m
5065,2,[JOH]Itchy,3727,0,0,1,1,0.0%,5m
5072,1,[wedown]Nasky,3726,1480,364,342,706,51.6%,3m
5072,2,loxamol,3726,1400,53,48,101,52.5%,15m
5072,1,mieslaw,3726,407,45,50,95,47.4%,3m
5072,2,Number,3726,468,17,20,37,45.9%,12m
5072,2,[GosuRU]TheVirusRUS,3726,167,5,4,9,55.6%,2m
5072,2,[xDMWx]Grolg,3726,146,5,8,13,38.5%,27m
5072,2,[UlaS]WannaBeZEST,3726,0,1,0,1,100.0%,10m
5072,2,Rod,3726,0,1,2,3,33.3%,10m
5072,2,GradegggggaR,3726,0,0,1,1,0.0%,8m
5081,2,Guska,3725,1529,94,74,168,56.0%,11m
5081,2,PanterA,3725,663,26,17,43,60.5%,19m
5081,2,sOggYBisCuiT,3725,0,3,2,5,60.0%,10m
5081,2,uberluberl,3725,30,2,1,3,66.7%,4m
5081,2,PurpleStuff,3725,0,1,1,2,50.0%,2m
5081,2,KaraK,3725,30,1,3,4,25.0%,13m
5081,3,[IBeAŚI]IcyDust,3725,0,0,1,1,0.0%,14m
5088,1,noobprime,3724,1842,518,524,1042,49.7%,26m
5088,1,[WRONA]Kiełczan,3724,1854,197,205,402,49.0%,11m
5088,2,[VFN]BTD,3724,591,92,87,179,51.4%,8m
5088,2,Jason,3724,1519,76,67,143,53.1%,11m
5088,2,[RеG]ZOOOM,3724,1459,69,56,125,55.2%,9m
5088,2,Tea,3724,980,36,42,78,46.2%,10m
5088,3,Spooner,3724,193,10,3,13,76.9%,16m
5088,2,Skyreal,3724,270,9,12,21,42.9%,9m
5088,2,UnknownNoTwo,3724,159,5,6,11,45.5%,11m
5088,2,[PaniC]Kadgar,3724,60,2,2,4,50.0%,15m
5088,2,ǂKJ,3724,0,1,0,1,100.0%,9m
5088,2,Nickname,3724,0,1,0,1,100.0%,26m
5088,2,Durandal,3724,0,0,1,1,0.0%,10m
5088,2,Deadman,3724,0,0,1,1,0.0%,12m
5088,2,Shampii,3724,0,0,1,1,0.0%,17m
5088,2,InamotoWMB,3724,0,0,1,1,0.0%,15m
5104,2,pete,3723,897,136,122,258,52.7%,2m
5104,2,Severin,3723,1301,105,101,206,51.0%,5m
5104,1,siRNA,3723,1722,72,85,157,45.9%,2m
5104,2,brfh,3723,488,32,21,53,60.4%,10m
5104,2,[Jedi]MasterBetty,3723,58,3,2,5,60.0%,2m
5104,2,[GenD]HerrDerLinge,3723,35,2,3,5,40.0%,11m
5104,3,[nB]MekTypro,3723,30,2,5,7,28.6%,15m
5104,2,edmak,3723,0,1,0,1,100.0%,15m
5104,2,miked,3723,0,0,1,1,0.0%,7m
5104,2,[ExpdtD]Aragnath,3723,0,0,1,1,0.0%,12m
5114,2,ulkiorashu,3722,941,49,52,101,48.5%,40m
5114,2,WearPurple,3722,433,35,35,70,50.0%,16m
5114,2,CaptBadger,3722,204,8,8,16,50.0%,7m
5114,2,SangSom,3722,0,5,0,5,100.0%,12m
5114,3,[KAY5]blitzkrieg,3722,60,4,9,13,30.8%,14m
5114,2,Darklymoon,3722,0,1,0,1,100.0%,10m
5114,2,[Zsquad]Ostik,3722,0,1,0,1,100.0%,5m
5114,2,Denчik,3722,0,1,2,3,33.3%,10m
5122,2,Szudemer,3721,1523,57,62,119,47.9%,10m
5122,2,Feeserd,3721,130,7,5,12,58.3%,6m
5122,2,illustrator,3721,112,3,0,3,100.0%,5m
5122,2,VeryEasyAI,3721,30,2,0,2,100.0%,8m
5126,2,[JGJG]BeeTaster,3720,1566,213,215,428,49.8%,11m
5126,2,[lWHl]program,3720,1080,106,73,179,59.2%,7m
5126,2,Kakugyō,3720,1546,91,90,181,50.3%,7m
5126,2,Agradar,3720,1109,81,67,148,54.7%,16m
5126,2,[forceX]lion,3720,734,52,52,104,50.0%,5m
5126,2,Kamala,3720,662,32,23,55,58.2%,3m
5126,2,MMFOOD,3720,365,23,29,52,44.2%,5m
5126,2,IAmSoNoo,3720,480,22,12,34,64.7%,6m
5126,2,[hiddle]Snowfox,3720,427,19,10,29,65.5%,7m
5126,2,[Skunks]Stinktier,3720,230,9,10,19,47.4%,5m
5126,2,[GGWPEZ]Koim,3720,48,3,1,4,75.0%,16m
5126,2,[RSK]GantDeToilet,3720,86,3,3,6,50.0%,6m
5126,2,NezukoChan,3720,92,3,8,11,27.3%,27m
5126,2,[xAngry]IIIIIIIIIIII,3720,0,1,0,1,100.0%,12m
5126,2,[HZeS]Hope,3720,30,1,1,2,50.0%,15m
5126,2,uNDeaDZERG,3720,0,1,2,3,33.3%,19m
5126,2,Sepp,3720,0,0,2,2,0.0%,18m
5143,2,[B2b]SirSlaughter,3719,1546,142,135,277,51.3%,11m
5143,2,[UATeam]Neyv,3719,892,88,87,175,50.3%,27m
5143,2,[Animoo]Dannie,3719,904,79,73,152,52.0%,9m
5143,2,filip,3719,1262,57,54,111,51.4%,12m
5143,3,[Arrows]Qwerty,3719,280,11,1,12,91.7%,5m
5143,2,Seriovsky,3719,265,9,9,18,50.0%,6m
5143,2,[ĦĦ]Destiny,3719,180,6,11,17,35.3%,8m
5143,3,ПетушкаРизо,3719,86,4,3,7,57.1%,5m
5143,2,Spartan,3719,30,1,2,3,33.3%,12m
5143,2,MargariN,3719,0,0,2,2,0.0%,5m
5153,2,AirpodsMax,3718,422,23,6,29,79.3%,9m
5153,2,lllllllllll,3718,88,4,4,8,50.0%,16m
5153,1,Double,3718,97,3,4,7,42.9%,9m
5153,2,SeriousSheep,3718,58,2,1,3,66.7%,9m
5153,2,[LTUFED]enhoss,3718,30,2,1,3,66.7%,5m
5153,2,[EBU]Yulia,3718,58,2,6,8,25.0%,8m
5153,1,llllllllllll,3718,0,0,1,1,0.0%,4m
5153,3,BigRichard,3718,0,0,2,2,0.0%,12m
5161,2,Foxy,3717,1570,204,180,384,53.1%,5m
5161,2,Destructo,3717,1443,185,154,339,54.6%,27m
5161,2,[NOCW]Padi,3717,1584,130,118,248,52.4%,12m
5161,1,[NLLO]EvA,3717,1832,84,78,162,51.9%,2m
5161,2,[DWTeam]Wolfstalker,3717,582,23,22,45,51.1%,27m
5161,2,[PHØMUI]Winchester,3717,450,16,25,41,39.0%,27m
5161,3,[BEHEMT]Toasts,3717,0,1,0,1,100.0%,12m
5161,2,[TWGs]Demograf,3717,30,1,4,5,20.0%,7m
5169,2,[JAPSE]Kaboom,3716,473,20,12,32,62.5%,2m
5169,2,BioFreak,3716,30,6,0,6,100.0%,5m
5169,2,[HBGSJR]Тescatlipoka,3716,172,6,7,13,46.2%,2m
5169,2,YourAnimeGF,3716,114,4,3,7,57.1%,7m
5169,2,kalisha,3716,94,3,10,13,23.1%,6m
5169,2,[Bias]piml,3716,0,2,3,5,40.0%,40m
5169,2,HunterKiller,3716,30,1,2,3,33.3%,11m
5169,2,[NL]DeadKid,3716,0,0,1,1,0.0%,14m
5169,2,dgs,3716,0,0,5,5,0.0%,12m
5178,2,kNo,3715,780,36,26,62,58.1%,5m
5178,3,[4BG]AoiHikari,3715,189,10,2,12,83.3%,26m
5178,2,AerO,3715,30,1,1,2,50.0%,5m
5178,2,[XF71]Belqta,3715,0,0,1,1,0.0%,3m
5182,1,IlIlIIlllIlI,3714,1746,272,263,535,50.8%,16m
5182,2,McNaplet,3714,546,20,18,38,52.6%,10m
5182,2,Yōkai,3714,424,16,11,27,59.3%,6m
5182,2,[LeUcHt]InvaderZ,3714,242,15,22,37,40.5%,27m
5182,2,Mestru,3714,262,13,6,19,68.4%,2m
5182,3,[NOW]GravesGrace,3714,160,9,1,10,90.0%,10m
5182,1,Broezn,3714,118,7,0,7,100.0%,3m
5182,2,Random,3714,144,5,5,10,50.0%,7m
5182,2,[LiteS]LaretS,3714,0,0,1,1,0.0%,8m
5191,2,[Dek]AdVictoriam,3713,1575,168,153,321,52.3%,6m
5191,2,[NINJ88]iliyanpetrov,3713,1627,108,102,210,51.4%,6m
5191,2,Dschihād,3713,779,35,13,48,72.9%,15m
5191,2,[DBr]HyneK,3713,723,30,23,53,56.6%,11m
5191,2,AkVAgRIM,3713,391,20,3,23,87.0%,8m
5191,2,SeeDs,3713,314,12,15,27,44.4%,9m
5191,2,Hero,3713,206,7,13,20,35.0%,2m
5191,1,Slevin,3713,97,2,0,2,100.0%,15m
5191,2,Piggy,3713,30,2,1,3,66.7%,5m
5191,2,LRMx,3713,62,2,4,6,33.3%,16m
5191,2,BigBob,3713,30,1,3,4,25.0%,9m
5191,2,Aicile,3713,0,0,1,1,0.0%,18m
5191,2,[LiFe]Rumper,3713,0,0,1,1,0.0%,6m
5191,2,YaoFace,3713,0,0,4,4,0.0%,5m
5205,1,Taptap,3712,1794,128,135,263,48.7%,15m
5205,2,[Тетере]IIIIIIIIIIII,3712,1444,70,57,127,55.1%,16m
5205,2,[A1SS]Harsesis,3712,156,15,17,32,46.9%,5m
5205,2,itzyaboiELO,3712,191,11,2,13,84.6%,13m
5205,2,CrazyEight,3712,0,1,0,1,100.0%,3m
5205,2,[nB]Elie,3712,0,0,1,1,0.0%,13m
5211,2,[ExL]Darkcabal,3711,1604,135,129,264,51.1%,11m
5211,2,[NPCǂ]Hausgeist,3711,1580,106,113,219,48.4%,9m
5211,2,Booglie,3711,1484,56,61,117,47.9%,15m
5211,2,tambo,3711,881,39,31,70,55.7%,40m
5211,2,cthulhuplx,3711,814,37,36,73,50.7%,12m
5211,2,QuaD,3711,498,20,10,30,66.7%,16m
5211,2,[Uprise]LionInCage,3711,294,9,9,18,50.0%,16m
5211,3,DeepOnes,3711,237,8,6,14,57.1%,6m
5211,2,Shamans,3711,150,6,6,12,50.0%,27m
5211,2,ClownFiesta,3711,118,4,3,7,57.1%,11m
5211,2,[7x]SevenXIgon,3711,86,3,2,5,60.0%,5m
5211,2,confuseD,3711,0,1,0,1,100.0%,2m
5211,2,Blaise,3711,0,1,2,3,33.3%,16m
5211,2,[2LuX]ǂMystïCLinGǂ,3711,0,0,1,1,0.0%,7m
5211,2,llllllllllll,3711,0,0,1,1,0.0%,26m
5211,2,ersi,3711,0,0,7,7,0.0%,8m
5227,2,NOD,3710,1372,74,70,144,51.4%,27m
5227,2,[InFy]XRater,3710,970,67,74,141,47.5%,17m
5227,2,Tangihorse,3710,489,43,39,82,52.4%,11m
5227,2,QuaD,3710,968,40,29,69,58.0%,19m
5227,2,Forever,3710,417,16,18,34,47.1%,27m
5227,2,Ukko,3710,206,8,6,14,57.1%,16m
5227,2,Saddist,3710,0,1,0,1,100.0%,40m
5227,2,[PiGPan]sneakyleming,3710,0,0,1,1,0.0%,12m
5235,2,Flo,3709,356,13,10,23,56.5%,9m
5235,2,[3M1]Yannik,3709,116,4,4,8,50.0%,6m
5235,2,[FrNiCl]Heats,3709,60,3,4,7,42.9%,6m
5235,2,[lMMl]salama,3709,62,2,8,10,20.0%,8m
5235,2,shinarthas,3709,0,1,0,1,100.0%,15m
5235,2,[Gachis]Eshaker,3709,0,0,2,2,0.0%,16m
5241,2,DarCko,3708,585,38,34,72,52.8%,8m
5241,2,Piča,3708,898,37,29,66,56.1%,19m
5241,2,LImco,3708,236,18,22,40,45.0%,10m
5241,2,terminator,3708,381,15,17,32,46.9%,11m
5241,1,[Овощи]DampiL,3708,388,9,34,43,20.9%,15m
5241,2,[FxL]amx,3708,171,4,6,10,40.0%,14m
5241,2,Challenger,3708,0,1,0,1,100.0%,15m
5241,2,PainGamer,3708,30,1,2,3,33.3%,3m
5241,2,Tezu,3708,0,0,1,1,0.0%,18m
5241,2,Ebrithil,3708,0,0,3,3,0.0%,5m
5251,2,IllIIIIllll,3707,1622,190,178,368,51.6%,15m
5251,1,WOaLFa,3707,1690,48,70,118,40.7%,40m
5251,2,[Noyce]Swatyo,3707,315,23,31,54,42.6%,9m
5251,2,[WAST3]Erthoras,3707,534,22,19,41,53.7%,11m
5251,2,Rippou,3707,248,13,13,26,50.0%,9m
5251,2,[Hаsu]Quasar,3707,88,3,6,9,33.3%,5m
5251,2,[iX]Dystopia,3707,30,2,1,3,66.7%,18m
5251,2,[EXPANT]Dono,3707,0,1,0,1,100.0%,6m
5251,2,Countess,3707,0,1,0,1,100.0%,26m
5251,2,[PiGPan]FissKael,3707,0,1,0,1,100.0%,5m
5251,2,[Gents]NekWioS,3707,0,1,0,1,100.0%,9m
5251,2,Seventh,3707,0,1,0,1,100.0%,3m
5263,2,Oleg,3706,1531,501,489,990,50.6%,18m
5263,1,rISTE,3706,1835,444,448,892,49.8%,4m
5263,2,Life,3706,1573,298,294,592,50.3%,14m
5263,2,Zagreus,3706,1601,251,245,496,50.6%,8m
5263,2,orleger,3706,965,43,41,84,51.2%,26m
5263,2,Ewanda,3706,299,23,18,41,56.1%,12m
5263,2,Yohane,3706,351,16,6,22,72.7%,10m
5263,2,BondageChair,3706,140,6,2,8,75.0%,8m
5263,2,anathos,3706,144,5,8,13,38.5%,9m
5263,2,Dopa,3706,0,4,1,5,80.0%,5m
5263,2,darkReunion,3706,149,3,4,7,42.9%,8m
5263,2,[НТТ]Obsidian,3706,60,2,4,6,33.3%,12m
5263,2,[ØC]bagheera,3706,0,1,0,1,100.0%,19m
5263,3,EdvanSchleck,3706,0,1,0,1,100.0%,16m
5263,2,creer,3706,30,1,4,5,20.0%,19m
5263,2,[1A2857]Multitouch,3706,0,0,1,1,0.0%,16m
5263,2,[Nerak]Nagibatron,3706,0,0,1,1,0.0%,27m
5263,2,[RPD]GrayFox,3706,0,0,2,2,0.0%,6m
5281,2,Thoth,3705,1602,316,321,637,49.6%,10m
5281,2,skiracer,3705,1064,108,88,196,55.1%,9m
5281,2,eight,3705,413,97,98,195,49.7%,2m
5281,2,[NGion]sunstrider,3705,1589,68,71,139,48.9%,2m
5281,2,ihavetheorb,3705,423,19,6,25,76.0%,6m
5281,2,infamous,3705,412,16,16,32,50.0%,5m
5281,2,DrunkGamer,3705,330,12,18,30,40.0%,18m
5281,2,cHiLLoR,3705,182,7,9,16,43.8%,40m
5289,2,IIIIXXXIIII,3704,1596,243,253,496,49.0%,9m
5289,2,Saryrn,3704,1259,118,118,236,50.0%,27m
5289,2,marcos,3704,1152,102,90,192,53.1%,8m
5289,2,Memphis,3704,802,92,96,188,48.9%,10m
5289,2,[Penza]QuZerK,3704,671,32,24,56,57.1%,10m
5289,2,[ПИCYN]TigrSeX,3704,666,24,27,51,47.1%,3m
5289,2,MrX,3704,73,7,8,15,46.7%,2m
5289,2,[FUNS]Ager,3704,90,4,5,9,44.4%,6m
5289,3,Frost,3704,30,2,0,2,100.0%,7m
5289,2,[Muffs]Muffin,3704,30,2,1,3,66.7%,6m
5289,2,[PÂRłAH]hazLo,3704,30,2,1,3,66.7%,2m
5300,2,Mindkeeper,3703,1198,318,312,630,50.5%,27m
5300,2,EleCtriC,3703,1596,273,254,527,51.8%,6m
5300,2,TerranBroken,3703,670,35,32,67,52.2%,7m
5300,2,Tyras,3703,444,17,12,29,58.6%,28m
5300,2,[Läkäse]Nazrasim,3703,238,9,4,13,69.2%,6m
5300,2,GhosT,3703,142,4,0,4,100.0%,13m
5300,3,Gandoulfion,3703,0,1,0,1,100.0%,10m
5300,2,[соffeе]InTunDra,3703,0,1,3,4,25.0%,11m
5300,2,Areoryn,3703,0,0,1,1,0.0%,6m
5309,2,hadoukeeen,3702,844,152,133,285,53.3%,8m
5309,2,[KDV]krystk,3702,1264,80,71,151,53.0%,19m
5309,2,[ESS]Eekez,3702,1320,48,50,98,49.0%,17m
5309,1,BigB,3702,900,24,47,71,33.8%,5m
5309,2,ToTheTop,3702,338,12,16,28,42.9%,12m
5309,2,Romalien,3702,208,7,10,17,41.2%,10m
5309,2,Evolution,3702,140,6,1,7,85.7%,8m
5309,3,Papezinhoo,3702,98,4,1,5,80.0%,19m
5309,2,monte,3702,58,2,3,5,40.0%,19m
5309,2,Lazurion,3702,0,1,2,3,33.3%,12m
5309,2,[GoldM]Lora,3702,30,1,5,6,16.7%,3m
5309,2,Cain,3702,0,0,3,3,0.0%,40m
5321,2,Foosa,3701,1574,171,162,333,51.4%,7m
5321,2,Tau,3701,1034,42,47,89,47.2%,15m
5321,2,innnnovation,3701,418,19,9,28,67.9%,6m
5321,2,PymS,3701,340,19,16,35,54.3%,2m
5321,2,MipZero,3701,476,17,20,37,45.9%,15m
5321,3,[PUSSY1]Penetrator,3701,290,13,6,19,68.4%,3m
5321,3,[ǂNoMǂ]Abazu,3701,238,11,5,16,68.8%,40m
5321,2,TLGluon,3701,268,9,13,22,40.9%,19m
5321,1,Awegasm,3701,230,5,22,27,18.5%,19m
5321,3,[1nTeaM]Loki,3701,97,2,1,3,66.7%,3m
5321,2,[ERaven]ĐēåŦħƘƞȋǥḥŦ,3701,60,2,2,4,50.0%,9m
5321,3,FabzG,3701,0,1,0,1,100.0%,17m
5321,2,[Pзrsia]ShadowSwarm,3701,0,0,1,1,0.0%,8m
5334,2,[VVVici]Divus,3700,1243,56,53,109,51.4%,17m
5334,2,[PÂRłAH]Tomaso,3700,582,39,36,75,52.0%,12m
5334,2,Myste,3700,86,3,3,6,50.0%,6m
5334,2,Eidowen,3700,0,0,1,1,0.0%,3m
5338,2,[BGLC]Telika,3699,1582,176,182,358,49.2%,27m
5338,2,ЖАк,3699,1380,53,51,104,51.0%,3m
5338,2,Peptar,3699,607,30,12,42,71.4%,28m
5338,2,[LSPs]ruterman,3699,556,23,13,36,63.9%,19m
5338,2,[Batmen]Archiatrus,3699,272,10,11,21,47.6%,12m
5338,2,Nizni,3699,184,6,10,16,37.5%,15m
5338,2,Toua,3699,176,6,11,17,35.3%,10m
5338,2,Aryster,3699,90,5,4,9,55.6%,11m
5338,2,Qoo,3699,30,1,2,3,33.3%,8m
5338,2,[Wild99]sCirem,3699,0,0,1,1,0.0%,9m
5338,3,[Ting]Dalek,3699,0,0,1,1,0.0%,17m
5338,2,[Prax]ANDOII,3699,0,0,1,1,0.0%,6m
5338,2,Ladder,3699,0,0,3,3,0.0%,17m
5351,2,[BRSKR]CrimsonKing,3698,1388,219,219,438,50.0%,27m
5351,2,Gladiateur,3698,1586,84,70,154,54.5%,12m
5351,1,Suvara,3698,1809,69,81,150,46.0%,14m
5351,2,Flame,3698,292,10,15,25,40.0%,5m
5351,2,Lef,3698,140,6,1,7,85.7%,16m
5351,2,BuzaLisk,3698,117,4,5,9,44.4%,3m
5351,2,iLag,3698,58,2,5,7,28.6%,16m
5351,2,[10021]Redwhine,3698,0,1,0,1,100.0%,8m
5351,2,IceWind,3698,30,1,3,4,25.0%,8m
5351,2,Oli,3698,0,0,1,1,0.0%,7m
5351,2,neocodex,3698,0,0,1,1,0.0%,5m
5362,2,DreAmZyY,3697,1558,217,187,404,53.7%,2m
5362,2,Mati,3697,1216,48,50,98,49.0%,10m
5362,1,Kwickfish,3697,1406,40,57,97,41.2%,19m
5362,2,Aerith,3697,456,21,6,27,77.8%,19m
5362,2,Omelette,3697,559,20,20,40,50.0%,8m
5362,2,[N00BY]AIMBORG,3697,172,7,9,16,43.8%,7m
5362,2,DrTheBoss,3697,58,3,1,4,75.0%,15m
5362,2,[lLiTl]Smuffin,3697,30,2,0,2,100.0%,40m
5362,2,[mCon]WisH,3697,58,2,1,3,66.7%,26m
5362,2,Fake,3697,0,1,0,1,100.0%,7m
5362,2,[CHICKZ]Hohiro,3697,0,0,1,1,0.0%,16m
5362,2,Executioner,3697,0,0,4,4,0.0%,19m
5374,1,ysanafa,3696,1549,424,419,843,50.3%,5m
5374,2,[nopvp]sirBlue,3696,1555,72,50,122,59.0%,40m
5374,2,ZergiuS,3696,754,32,39,71,45.1%,26m
5374,2,Geronimo,3696,550,19,28,47,40.4%,5m
5374,1,ØþђҽĻȋą,3696,143,8,1,9,88.9%,27m
5374,2,BadTrip,3696,112,7,0,7,100.0%,40m
5374,2,llllllllllll,3696,168,6,7,13,46.2%,9m
5374,2,SUper,3696,150,4,1,5,80.0%,6m
5374,2,IamBrotoss,3696,97,4,6,10,40.0%,15m
5374,2,[WBO]Atais,3696,0,1,0,1,100.0%,2m
5374,2,BilboZeRabit,3696,0,1,0,1,100.0%,5m
5374,2,Zeal,3696,30,1,2,3,33.3%,2m
5374,2,[SLD]Eisdieler,3696,0,0,1,1,0.0%,16m
5374,2,[NMF]jeff,3696,0,0,1,1,0.0%,17m
5374,2,[Cannоn]Raa,3696,0,0,1,1,0.0%,15m
5389,2,meqlex,3695,1583,149,158,307,48.5%,6m
5389,2,penisua,3695,883,92,83,175,52.6%,27m
5389,1,Answer,3695,1490,81,93,174,46.6%,14m
5389,2,Lightbringer,3695,981,37,45,82,45.1%,3m
5389,2,llIIIlIlIlll,3695,546,17,31,48,35.4%,5m
5389,2,[DHCP]AntiDog,3695,140,6,1,7,85.7%,12m
5389,3,[FiStar]JackONeill,3695,115,6,4,10,60.0%,9m
5389,2,Loki,3695,142,5,5,10,50.0%,12m
5389,2,[aW]Jeatall,3695,30,1,1,2,50.0%,9m
5389,2,[НТТ]Heresiarch,3695,0,1,1,2,50.0%,19m
5389,2,Vamskie,3695,0,0,1,1,0.0%,17m
5389,2,Mirrodin,3695,0,0,1,1,0.0%,3m
5389,2,BURGERKING,3695,0,0,2,2,0.0%,26m
5389,2,Rebell,3695,0,0,5,5,0.0%,10m
5403,1,froghunter,3694,1625,279,273,552,50.5%,2m
5403,2,haze,3694,1392,57,44,101,56.4%,40m
5403,2,Charly,3694,430,40,32,72,55.6%,5m
5403,2,Akup,3694,780,29,25,54,53.7%,16m
5403,2,[ZHxPro]MightyPantsu,3694,172,6,4,10,60.0%,27m
5403,2,KillingSpree,3694,174,6,8,14,42.9%,6m
5403,2,[SwgBoi]DeadGame,3694,144,6,8,14,42.9%,8m
5403,2,[GLTD]Scrm,3694,146,5,4,9,55.6%,10m
5403,2,[PÂRłAH]SmokedSloth,3694,120,5,6,11,45.5%,27m
5403,3,[DaFF]PaiN,3694,58,3,1,4,75.0%,7m
5403,2,DrKukk,3694,30,1,4,5,20.0%,19m
5403,1,[FKTS]TheDoctor,3694,0,1,6,7,14.3%,16m
5415,1,[НТТ]SwitcheR,3693,1842,99,104,203,48.8%,18m
5415,2,WarroCraft,3693,351,19,9,28,67.9%,6m
5415,2,fAtbOyTOOM,3693,254,9,7,16,56.2%,2m
5415,2,SpursFan,3693,88,3,6,9,33.3%,6m
5415,2,Wilzyx,3693,60,2,3,5,40.0%,40m
5415,2,[unlR]Voxey,3693,0,0,1,1,0.0%,18m
5421,2,[ialm]ImZerg,3692,1173,71,29,100,71.0%,17m
5421,1,[HBGSJR]mSin,3692,1806,69,81,150,46.0%,14m
5421,2,Зорк,3692,890,37,24,61,60.7%,15m
5421,2,maleo,3692,845,34,36,70,48.6%,11m
5421,2,Martin,3692,478,17,16,33,51.5%,6m
5421,2,[FtBB]Schmick,3692,60,3,1,4,75.0%,15m
5421,2,Luyren,3692,58,2,2,4,50.0%,3m
5421,2,Törttö,3692,0,1,3,4,25.0%,18m
5421,2,[MIEM]Syncker,3692,30,1,3,4,25.0%,9m
5421,2,Tristan,3692,0,0,2,2,0.0%,15m
5431,2,qYn,3691,1567,147,149,296,49.7%,19m
5431,2,KimJungAdun,3691,164,6,0,6,100.0%,16m
5431,2,Dzolo,3691,102,3,3,6,50.0%,26m
5434,2,[LMBD]morningstar,3690,1608,224,222,446,50.2%,9m
5434,2,Viva,3690,395,85,64,149,57.0%,27m
5434,2,Zeju,3690,692,23,35,58,39.7%,7m
5434,2,Hellscream,3690,373,17,9,26,65.4%,11m
5434,2,[ЯD]Exo,3690,90,4,3,7,57.1%,16m
5434,2,[Kontra]Neutra,3690,30,2,1,3,66.7%,9m
5434,2,Gosu,3690,0,0,1,1,0.0%,10m
5434,2,Valderan,3690,0,0,2,2,0.0%,8m
5442,2,Mage,3689,1202,305,299,604,50.5%,2m
5442,2,shaki,3689,1622,212,212,424,50.0%,7m
5442,2,[Зерат]walthergreis,3689,1502,161,153,314,51.3%,7m
5442,2,megAdept,3689,1260,94,91,185,50.8%,40m
5442,2,MagicMike,3689,1336,62,35,97,63.9%,11m
5442,2,Coudest,3689,828,32,28,60,53.3%,27m
5442,2,[Vonny]Skraal,3689,572,22,22,44,50.0%,16m
5442,2,CCT,3689,319,18,15,33,54.5%,4m
5442,3,[Birni]meepo,3689,30,2,2,4,50.0%,9m
5442,2,ArkDamenen,3689,30,1,1,2,50.0%,11m
5442,2,Flopicase,3689,30,1,2,3,33.3%,8m
5453,2,Yoxs,3688,1526,212,201,413,51.3%,15m
5453,2,Alvear,3688,848,81,78,159,50.9%,15m
5453,2,[AgV]CheeseLove,3688,563,49,53,102,48.0%,12m
5453,2,Kodo,3688,412,48,27,75,64.0%,9m
5453,2,smokjail,3688,282,10,12,22,45.5%,9m
5453,2,Honorem,3688,238,9,14,23,39.1%,8m
5453,2,Kasatka,3688,200,7,18,25,28.0%,6m
5453,2,Adilem,3688,93,4,6,10,40.0%,8m
5453,2,[OSgZ]Röllstühl,3688,0,1,0,1,100.0%,15m
5453,2,BlackStar,3688,0,1,9,10,10.0%,10m
5453,2,[BoBa]Elite,3688,0,0,1,1,0.0%,3m
5464,1,sprayfart,3687,1819,101,117,218,46.3%,13m
5464,1,[Zizou]SolidDuke,3687,1570,84,98,182,46.2%,8m
5464,2,[BELSCF]Merre,3687,1047,48,51,99,48.5%,6m
5464,2,Clem,3687,692,24,30,54,44.4%,17m
5464,2,[ICGl]DarkTilRisen,3687,692,24,31,55,43.6%,6m
5464,2,[FisssT]Zorro,3687,258,9,13,22,40.9%,27m
5464,2,Square,3687,30,1,3,4,25.0%,8m
5471,1,Farnsworth,3686,1747,776,788,1564,49.6%,19m
5471,2,RedDemon,3686,183,8,8,16,50.0%,8m
5471,2,Dante,3686,86,3,3,6,50.0%,12m
5471,2,llllllllllll,3686,64,2,2,4,50.0%,2m
5471,2,Inarius,3686,62,2,5,7,28.6%,28m
5471,2,Ozeren,3686,0,0,1,1,0.0%,2m
5471,2,QwertyMaster,3686,0,0,1,1,0.0%,18m
5471,2,Georg,3686,0,0,1,1,0.0%,4m
5471,2,hacoro,3686,0,0,3,3,0.0%,19m
5480,2,[TAW]mutacrux,3685,1209,60,63,123,48.8%,11m
5480,2,Simp,3685,672,25,25,50,50.0%,40m
5480,2,Georgeous,3685,348,12,12,24,50.0%,8m
5480,2,llllllllllll,3685,106,5,3,8,62.5%,8m
5480,2,[GWB]Vexvl,3685,120,4,6,10,40.0%,7m
5480,2,Dwarfius,3685,60,3,2,5,60.0%,27m
5480,2,Darroth,3685,58,2,3,5,40.0%,19m
5480,2,ElunMosk,3685,0,1,0,1,100.0%,6m
5480,2,dragonstorm,3685,0,1,0,1,100.0%,11m
5489,2,Benaab,3684,1102,57,69,126,45.2%,17m
5489,2,Bishop,3684,453,37,25,62,59.7%,17m
5489,2,[EH]KavaiinoNeko,3684,551,30,12,42,71.4%,11m
5489,2,Name,3684,650,23,26,49,46.9%,15m
5489,2,Ladyboy,3684,297,17,8,25,68.0%,7m
5489,2,[EZPTS]ВованТерран,3684,322,12,10,22,54.5%,8m
5489,2,[Wolven]Tempest,3684,262,9,15,24,37.5%,17m
5489,2,SeYsEy,3684,30,2,2,4,50.0%,16m
5489,2,LORDGG,3684,30,1,1,2,50.0%,8m
5489,2,koranskii,3684,0,0,1,1,0.0%,10m
5489,2,[SUFU]Annunaki,3684,0,0,1,1,0.0%,12m
5500,2,HydrQ,3683,1523,243,226,469,51.8%,17m
5500,2,RilizeKraken,3683,1512,210,218,428,49.1%,3m
5500,2,Homer,3683,1295,116,110,226,51.3%,28m
5500,2,Rasterfant,3683,1072,41,38,79,51.9%,6m
5500,2,RuntimeError,3683,261,24,19,43,55.8%,12m
5500,2,GawrGura,3683,598,22,19,41,53.7%,15m
5500,2,alfahsed,3683,415,17,10,27,63.0%,6m
5500,2,Scon,3683,304,11,10,21,52.4%,19m
5500,2,IlIlIlIlIlIl,3683,0,3,2,5,60.0%,5m
5500,2,[CaHu]SluttySnail,3683,30,2,2,4,50.0%,5m
5500,2,IIIIIIIIIIII,3683,0,1,3,4,25.0%,7m
5500,2,sGa,3683,30,1,5,6,16.7%,6m
5500,2,Rennick,3683,0,0,1,1,0.0%,11m
5500,2,[CL0SE]Vulshok,3683,0,0,3,3,0.0%,16m
5514,2,[VFN]Marovingian,3682,1225,94,91,185,50.8%,3m
5514,2,[sprudl]squirrelsfun,3682,399,16,18,34,47.1%,5m
5514,2,[LandP]LordFekalos,3682,176,6,6,12,50.0%,6m
5514,2,[KUY]Narag,3682,58,3,0,3,100.0%,28m
5514,2,Spparo,3682,88,3,4,7,42.9%,8m
5514,2,[IndyK]HerOuLiT,3682,30,1,15,16,6.2%,12m
5520,2,Duality,3681,1566,250,250,500,50.0%,6m
5520,2,fashioner,3681,797,50,42,92,54.3%,26m
5520,2,Araris,3681,689,30,30,60,50.0%,6m
5520,2,[PaniC]Vertigo,3681,239,11,4,15,73.3%,8m
5520,2,foodstamps,3681,220,9,10,19,47.4%,19m
5520,2,NorDerot,3681,142,6,1,7,85.7%,3m
5520,3,Vargrat,3681,189,6,2,8,75.0%,2m
5520,2,NoLimits,3681,0,1,0,1,100.0%,15m
5520,2,BigSocks,3681,30,1,7,8,12.5%,19m
5520,2,[bullD]СиняяНеба,3681,0,0,1,1,0.0%,28m
5530,2,North,3680,1268,46,50,96,47.9%,26m
5530,2,инокишут,3680,928,32,40,72,44.4%,40m
5530,2,[PLA2N]Reycer,3680,729,31,24,55,56.4%,2m
5530,2,RAGEStitcheS,3680,192,10,3,13,76.9%,4m
5530,3,Eva,3680,167,5,2,7,71.4%,27m
5530,2,[ArZs]Sahozen,3680,146,5,3,8,62.5%,27m
5530,2,[BMD]Galaxy,3680,122,4,7,11,36.4%,12m
5530,2,[Ugg]JCreepers,3680,0,0,3,3,0.0%,10m
5530,2,[U2]Scoow,3680,0,0,3,3,0.0%,6m
5539,2,[TAW]equiNoxSC,3679,1539,187,189,376,49.7%,7m
5539,2,Voltux,3679,541,47,38,85,55.3%,6m
5539,2,[HBGSJR]Singler,3679,726,37,34,71,52.1%,15m
5539,1,FrozzenFrog,3679,717,24,40,64,37.5%,13m
5539,2,IllIllIlIIll,3679,0,0,1,1,0.0%,8m
5539,2,Bot,3679,0,0,3,3,0.0%,16m
5545,2,[IndyK]McClane,3678,631,48,52,100,48.0%,28m
5545,2,[BSPP]Zorrk,3678,1168,43,45,88,48.9%,26m
5545,2,Ewenement,3678,474,23,14,37,62.2%,27m
5545,2,Executioner,3678,406,19,17,36,52.8%,6m
5545,2,ohboiiiiiii,3678,308,15,9,24,62.5%,7m
5545,2,[GenGG]Mamba,3678,86,3,5,8,37.5%,19m
5545,2,TelosPacman,3678,0,0,6,6,0.0%,19m
5552,2,[WATM]mootafooka,3677,1606,551,532,1083,50.9%,5m
5552,1,[0301]sus,3677,1744,243,245,488,49.8%,13m
5552,2,[SPAINs]hzheng,3677,1607,95,87,182,52.2%,12m
5552,2,Sevvy,3677,530,27,22,49,55.1%,9m
5552,2,BunkyBunk,3677,363,14,9,23,60.9%,12m
5552,3,[JAREK]DeJoT,3677,282,13,4,17,76.5%,14m
5552,2,Haiden,3677,202,8,7,15,53.3%,10m
5552,2,Deepmind,3677,30,1,6,7,14.3%,6m
5552,2,[lLiTl]Failure,3677,0,0,3,3,0.0%,3m
5561,2,Khazeo,3676,640,42,15,57,73.7%,10m
5561,2,[RеG]Стас,3676,665,31,16,47,66.0%,7m
5561,2,llllllllllll,3676,126,4,13,17,23.5%,8m
5561,2,[Ascend]NeoNet,3676,0,2,3,5,40.0%,4m
5561,2,FArAmir,3676,0,0,2,2,0.0%,17m
5566,2,Zenpassant,3675,1555,153,142,295,51.9%,11m
5566,2,JiR,3675,1276,107,106,213,50.2%,27m
5566,2,Grim,3675,1152,64,52,116,55.2%,4m
5566,2,Starker,3675,1056,36,47,83,43.4%,10m
5566,2,[SEWP]Rezerfordium,3675,436,17,12,29,58.6%,5m
5566,1,JoeNova,3675,40,2,9,11,18.2%,8m
5566,2,Enthalpos,3675,0,1,0,1,100.0%,17m
5566,2,axljaxl,3675,0,1,0,1,100.0%,19m
5566,2,[TGB]Kuschelbunny,3675,0,0,1,1,0.0%,4m
5566,2,[mlem]TheBotanist,3675,0,0,3,3,0.0%,15m
5576,2,oggbonaian,3674,1022,143,128,271,52.8%,6m
5576,2,Troligt,3674,1497,94,82,176,53.4%,10m
5576,2,DarkGouki,3674,1338,78,75,153,51.0%,40m
5576,2,[DthCon]McBlanc,3674,468,52,7,59,88.1%,19m
5576,2,Sawol,3674,790,37,14,51,72.5%,4m
5576,2,[сSсǃ]Fansaf,3674,886,35,29,64,54.7%,6m
5576,2,[ULTX]TrickyHunter,3674,633,33,45,78,42.3%,40m
5576,2,[FlyFkr]Zhorliz,3674,760,30,23,53,56.6%,7m
5576,2,aLL,3674,620,24,20,44,54.5%,10m
5576,2,Postikana,3674,164,8,1,9,88.9%,16m
5576,2,[SGCxx]YouSeeMee,3674,236,8,9,17,47.1%,8m
5576,2,[R4Time]OcJluK,3674,180,7,16,23,30.4%,4m
5576,2,[NTL1]Puxx,3674,0,1,3,4,25.0%,6m
5576,2,[uclan]mrmirror,3674,0,1,4,5,20.0%,19m
5576,2,[Dicboy]zerxam,3674,0,1,4,5,20.0%,3m
5576,2,[NSBM]AntisaDød,3674,0,0,1,1,0.0%,15m
5576,2,Mickaël,3674,0,0,1,1,0.0%,19m
5576,2,[ITGC]Fresh,3674,0,0,1,1,0.0%,17m
5594,2,[P34L]natdead,3673,1618,198,162,360,55.0%,6m
5594,2,[IndyK]SadFtwo,3673,1108,145,144,289,50.2%,40m
5594,2,[4YLiFe]SPiriT,3673,1515,111,119,230,48.3%,10m
5594,2,DhuBleidd,3673,980,45,43,88,51.1%,12m
5594,2,[Qurwa]Vextor,3673,861,37,24,61,60.7%,19m
5594,2,[Tren]Naccer,3673,597,25,29,54,46.3%,6m
5594,2,[ArGGEU]VanHelsingLQ,3673,452,18,11,29,62.1%,10m
5594,2,ChimaY,3673,359,14,18,32,43.8%,15m
5594,2,CaptaiN,3673,176,7,15,22,31.8%,10m
5594,2,epoK,3673,140,6,1,7,85.7%,16m
5594,2,[CJFF]Scornage,3673,58,3,0,3,100.0%,8m
5594,2,AbdulAkbar,3673,88,3,3,6,50.0%,16m
5594,2,[ImbaIS]Kakuzu,3673,62,2,4,6,33.3%,9m
5594,3,[ShNice]IIIIIIIIIIII,3673,58,2,5,7,28.6%,12m
5594,2,æææ,3673,58,2,5,7,28.6%,11m
5594,2,[FxL]Atty,3673,0,1,0,1,100.0%,6m
5610,2,Ono,3672,1556,145,133,278,52.2%,19m
5610,2,Octobussy,3672,1296,138,137,275,50.2%,4m
5610,2,Dijkkie,3672,632,22,27,49,44.9%,7m
5610,2,[TAW]FizzyElf,3672,120,4,6,10,40.0%,6m
5610,1,[Rüfos]celphy,3672,0,3,4,7,42.9%,3m
5610,2,Mephis,3672,30,2,0,2,100.0%,8m
5610,2,Sava,3672,58,2,1,3,66.7%,10m
5610,2,Misiek,3672,0,0,1,1,0.0%,8m
5610,2,[0TaKe]bIS,3672,0,0,1,1,0.0%,15m
5610,2,dainius,3672,0,0,1,1,0.0%,15m
5610,2,Brobanovic,3672,0,0,1,1,0.0%,4m
5621,2,Proteus,3671,833,141,138,279,50.5%,2m
5621,2,JustMe,3671,1540,115,106,221,52.0%,17m
5621,2,Martin,3671,1591,113,117,230,49.1%,8m
5621,2,Huderon,3671,118,3,0,3,100.0%,14m
5621,2,ihormyroniuk,3671,90,3,6,9,33.3%,9m
5621,2,[druPa]Bugaga,3671,0,0,2,2,0.0%,16m
5627,2,CheeseCake,3670,1546,173,149,322,53.7%,16m
5627,2,[EESC]Aramos,3670,659,27,26,53,50.9%,5m
5627,2,[Fridge]Ever,3670,62,3,9,12,25.0%,11m
5627,2,Фортнайтер,3670,30,1,1,2,50.0%,5m
5627,2,xXDREADXx,3670,0,0,1,1,0.0%,2m
5627,2,[doyou]zyzz,3670,0,0,1,1,0.0%,6m
5627,2,GaZAR,3670,0,0,1,1,0.0%,6m
5627,2,QWERTYUIOP,3670,0,0,4,4,0.0%,8m
5635,2,Thunderbird,3669,1277,173,162,335,51.6%,27m
5635,2,Aclick,3669,710,26,30,56,46.4%,19m
5635,2,[RøS]DarthYok,3669,525,19,24,43,44.2%,6m
5635,2,Qevor,3669,119,7,0,7,100.0%,10m
5635,2,[KerriS]Sireals,3669,58,3,0,3,100.0%,6m
5635,2,[St1cK]Luckeri,3669,60,3,2,5,60.0%,15m
5635,2,MATIS,3669,58,2,1,3,66.7%,6m
5635,2,TriangleTom,3669,0,0,1,1,0.0%,10m
5635,2,[GURKI]Pazifist,3669,0,0,1,1,0.0%,17m
5644,2,Beau,3668,1326,60,45,105,57.1%,11m
5644,2,SneakyGerri,3668,786,38,19,57,66.7%,15m
5644,2,[AD]ResTinPeace,3668,796,29,33,62,46.8%,16m
5644,2,kippetje,3668,210,8,8,16,50.0%,12m
5644,2,GLgames,3668,58,2,4,6,33.3%,19m
5644,2,scoutyx,3668,0,0,1,1,0.0%,3m
5650,2,PMT,3667,862,33,32,65,50.8%,19m
5650,2,Emzeror,3667,586,25,19,44,56.8%,7m
5650,2,TomBombadil,3667,120,5,3,8,62.5%,10m
5650,2,Yak,3667,60,3,1,4,75.0%,9m
5650,2,TranceFuZion,3667,0,1,0,1,100.0%,4m
5650,3,Sarpoxicity,3667,0,1,0,1,100.0%,5m
5650,2,Penzli,3667,30,1,4,5,20.0%,12m
5650,3,[DutchG]Zazop,3667,0,0,1,1,0.0%,19m
5650,2,Xenos,3667,0,0,2,2,0.0%,2m
5650,2,Matrixx,3667,0,0,2,2,0.0%,16m
5660,2,Ivans,3666,1399,117,115,232,50.4%,40m
5660,2,FalconPawnch,3666,1141,58,51,109,53.2%,16m
5660,2,[Pullis]Pumi,3666,830,28,38,66,42.4%,7m
5660,2,NoMatter,3666,450,17,20,37,45.9%,27m
5660,2,LOLandMCFBG,3666,512,17,24,41,41.5%,6m
5660,2,Pacer,3666,222,8,13,21,38.1%,8m
5660,2,AxoL,3666,112,7,1,8,87.5%,40m
5660,2,[EWSS]EgisLorenzo,3666,30,1,3,4,25.0%,17m
5660,2,Barrysta,3666,0,1,3,4,25.0%,10m
5669,2,LKR,3665,1495,170,152,322,52.8%,19m
5669,2,Handstreich,3665,472,22,12,34,64.7%,27m
5669,2,Ryuzaki,3665,292,10,15,25,40.0%,12m
5669,3,Ozen,3665,216,8,3,11,72.7%,41m
5669,2,LeaveMeAlone,3665,222,8,13,21,38.1%,19m
5669,2,[rus54]FSpell,3665,144,5,5,10,50.0%,8m
5669,2,DuMIIJIc,3665,86,3,3,6,50.0%,6m
5669,2,Nemesis,3665,30,2,2,4,50.0%,19m
5669,2,[DMøøn]Mopovu,3665,0,1,0,1,100.0%,10m
5669,3,WolfIce,3665,0,0,1,1,0.0%,26m
5669,2,BlackVoid,3665,0,0,1,1,0.0%,18m
5669,2,johanka,3665,0,0,5,5,0.0%,9m
5681,2,junka,3664,1616,167,164,331,50.5%,10m
5681,2,TibEZot,3664,1629,163,152,315,51.7%,2m
5681,2,Öööö,3664,1376,140,111,251,55.8%,3m
5681,2,Rhoynar,3664,314,13,5,18,72.2%,6m
5681,2,Popa,3664,116,5,3,8,62.5%,2m
5681,2,aLLiaNcE,3664,0,1,1,2,50.0%,10m
5681,2,Дмитрий,3664,30,1,1,2,50.0%,5m
5688,2,GRey,3663,1368,79,80,159,49.7%,10m
5688,2,mik,3663,741,34,37,71,47.9%,2m
5688,2,[KörSa]Neiko,3663,587,25,15,40,62.5%,2m
5688,2,tmo,3663,622,23,27,50,46.0%,10m
5688,2,Xilogh,3663,278,10,5,15,66.7%,3m
5688,2,SprinG,3663,30,2,0,2,100.0%,7m
5688,2,[Ливай]grohom,3663,30,2,0,2,100.0%,18m
5688,2,[2s1ck]jhunter,3663,58,2,9,11,18.2%,11m
5688,2,ТОР,3663,30,1,3,4,25.0%,16m
5688,2,[lLiTl]HoboCop,3663,0,0,1,1,0.0%,16m
5688,2,yhy,3663,0,0,1,1,0.0%,8m
5699,2,NIHONIUM,3662,1586,288,256,544,52.9%,9m
5699,2,RaptorII,3662,250,26,23,49,53.1%,2m
5699,2,pioneer,3662,116,4,4,8,50.0%,27m
5699,2,ronalo,3662,0,1,0,1,100.0%,10m
5699,2,Debonair,3662,30,1,1,2,50.0%,9m
5699,2,Xamine,3662,0,0,1,1,0.0%,11m
5699,2,Detrick,3662,0,0,1,1,0.0%,4m
5706,2,Fleetz,3661,1551,237,247,484,49.0%,12m
5706,2,[CivW]CrAzYbObO,3661,793,105,107,212,49.5%,26m
5706,2,Murmel,3661,1493,84,87,171,49.1%,10m
5706,2,[BPX]Lutrax,3661,93,17,19,36,47.2%,28m
5706,2,[MSUSC2]Ulrezash,3661,234,7,5,12,58.3%,19m
5706,2,Legioner,3661,30,2,1,3,66.7%,11m
5706,2,Mauridius,3661,0,2,3,5,40.0%,5m
5706,2,Kenji,3661,58,2,5,7,28.6%,6m
5706,2,higlhf,3661,30,1,13,14,7.1%,12m
5706,2,ohaz,3661,0,0,1,1,0.0%,19m
5706,2,Minah,3661,0,0,1,1,0.0%,19m
5717,2,[Peeps]Mandarph,3660,1503,273,268,541,50.5%,27m
5717,2,[KCR44]CruciaX,3660,1594,249,230,479,52.0%,3m
5717,2,[SqAUT]Pluu,3660,1103,122,122,244,50.0%,27m
5717,2,WakeUp,3660,1564,71,57,128,55.5%,15m
5717,2,[GIMBO]Baldman,3660,1380,56,47,103,54.4%,12m
5717,2,Storm,3660,1130,47,40,87,54.0%,11m
5717,2,[bHumbL]Wildfire,3660,176,7,5,12,58.3%,17m
5717,2,DarK,3660,86,4,4,8,50.0%,16m
5717,2,Athernithies,3660,0,1,0,1,100.0%,3m
5717,2,[Heroes]Vales,3660,0,0,5,5,0.0%,8m
5727,2,niewiadom,3659,1350,99,97,196,50.5%,3m
5727,2,Shtirlitz,3659,1250,79,74,153,51.6%,12m
5727,2,YamaYama,3659,651,30,18,48,62.5%,11m
5727,2,Chimp,3659,144,6,5,11,54.5%,7m
5727,3,Fitchy,3659,124,5,6,11,45.5%,40m
5727,2,Ignis,3659,92,3,6,9,33.3%,6m
5727,3,[CocoCo]DansGame,3659,119,2,1,3,66.7%,26m
5727,2,[KDV]kiesiew,3659,30,2,6,8,25.0%,11m
5727,2,[SEXi]Ravelans,3659,30,1,1,2,50.0%,40m
5727,2,Osci,3659,30,1,7,8,12.5%,19m
5727,2,mindgap,3659,0,0,1,1,0.0%,7m
5727,2,TBob,3659,0,0,1,1,0.0%,13m
5727,2,[0BO]Eyepod,3659,0,0,1,1,0.0%,26m
5727,2,[Hrr]TypoKal,3659,0,0,2,2,0.0%,6m
5727,2,Ghoulie,3659,73,0,3,3,0.0%,3m
5727,2,[SCHTEW]YaggerMight,3659,0,0,7,7,0.0%,9m
5743,2,[K0mpis]Saimont,3658,1487,202,187,389,51.9%,26m
5743,2,Runich,3658,1378,159,152,311,51.1%,7m
5743,2,UsIChivas,3658,883,109,92,201,54.2%,19m
5743,2,Zari,3658,627,79,47,126,62.7%,5m
5743,2,GoSuAti,3658,813,60,47,107,56.1%,27m
5743,2,[DUX]Khaƴsaril,3658,501,21,11,32,65.6%,11m
5743,2,Mahtisonni,3658,491,18,20,38,47.4%,26m
5743,2,NassAjine,3658,225,12,6,18,66.7%,8m
5743,2,[TheDOH]LoKlok,3658,61,7,7,14,50.0%,28m
5743,2,Thefrozen,3658,0,0,3,3,0.0%,12m
5743,2,[3ØØ]DeaNova,3658,0,0,5,5,0.0%,12m
5754,2,JAXX,3657,1534,172,166,338,50.9%,28m
5754,2,[noоb]BOBO,3657,1599,147,137,284,51.8%,7m
5754,2,Viper,3657,1488,145,131,276,52.5%,7m
5754,2,Bro,3657,1576,101,94,195,51.8%,11m
5754,2,[HSTQ]Thor,3657,1559,73,63,136,53.7%,11m
5754,2,ContinentaL,3657,706,46,51,97,47.4%,27m
5754,2,DaveyJones,3657,1268,45,50,95,47.4%,8m
5754,1,Controlux,3657,1202,39,72,111,35.1%,16m
5754,2,[RBlood]hotTemplar,3657,454,20,9,29,69.0%,13m
5754,2,Lagger,3657,374,13,16,29,44.8%,40m
5754,2,Snouf,3657,274,9,6,15,60.0%,11m
5754,2,PlayingSC,3657,223,6,10,16,37.5%,4m
5754,2,[CranKy]Daunted,3657,30,1,1,2,50.0%,11m
5754,2,SneakyTurtle,3657,0,1,2,3,33.3%,6m
5754,2,maulinho,3657,0,1,3,4,25.0%,19m
5754,2,[SY2G]Antotoxic,3657,0,0,1,1,0.0%,6m
5754,2,rostoshka,3657,0,0,2,2,0.0%,8m
5771,1,Thib,3656,1543,221,229,450,49.1%,12m
5771,2,Maximus,3656,1580,86,84,170,50.6%,19m
5771,2,Assguard,3656,645,39,33,72,54.2%,6m
5771,2,[flyrev]flyrev,3656,846,31,30,61,50.8%,16m
5771,2,luke,3656,723,28,23,51,54.9%,11m
5771,2,Skroma,3656,456,18,16,34,52.9%,2m
5771,2,sEsScoun,3656,150,5,11,16,31.2%,40m
5771,2,Alexander,3656,0,0,1,1,0.0%,3m
5779,2,PangPang,3655,1408,374,358,732,51.1%,28m
5779,2,[BWArmy]Oxwaa,3655,1371,67,57,124,54.0%,7m
5779,2,Omni,3655,810,38,32,70,54.3%,9m
5779,2,MrManta,3655,958,36,36,72,50.0%,40m
5779,2,Goshater,3655,516,19,15,34,55.9%,27m
5779,2,[ChZeal]Zorcol,3655,462,17,16,33,51.5%,18m
5779,2,Zhadar,3655,454,17,17,34,50.0%,6m
5779,2,Zetsu,3655,448,15,15,30,50.0%,2m
5779,2,Granate,3655,0,4,1,5,80.0%,17m
5779,2,[DRE4MS]Landrew,3655,60,3,2,5,60.0%,16m
5779,2,whynot,3655,0,0,1,1,0.0%,6m
5790,2,[RBlood]IkuriO,3654,490,19,20,39,48.7%,10m
5790,3,EUgayHunter,3654,315,12,8,20,60.0%,19m
5790,2,ImmortanJoe,3654,275,11,6,17,64.7%,8m
5790,2,Riser,3654,166,6,2,8,75.0%,40m
5790,2,OverLord,3654,139,5,18,23,21.7%,4m
5790,1,Meczik,3654,0,1,0,1,100.0%,3m
5796,2,Ayren,3653,1096,191,182,373,51.2%,11m
5796,2,blinblin,3653,1529,61,64,125,48.8%,11m
5796,2,Thouruk,3653,1032,45,29,74,60.8%,3m
5796,2,Muminki,3653,955,41,36,77,53.2%,11m
5796,2,[ШОУМЕН]Mambo,3653,309,16,1,17,94.1%,40m
5796,2,[Anlav]Uolupukkie,3653,118,6,7,13,46.2%,15m
5796,2,[DМG]Hades,3653,58,3,1,4,75.0%,28m
5796,2,liquid,3653,48,3,4,7,42.9%,28m
5796,2,[PŖïMĄŁ]DarkGhost,3653,62,3,5,8,37.5%,6m
5796,2,[KFCFR]Dailycat,3653,0,1,2,3,33.3%,40m
5796,2,ishamael,3653,0,0,1,1,0.0%,10m
5796,3,Asfand,3653,0,0,1,1,0.0%,17m
5808,2,Comrad,3652,1577,193,178,371,52.0%,7m
5808,2,[FR1]LiquidCurage,3652,1523,76,70,146,52.1%,28m
5808,2,april,3652,858,40,45,85,47.1%,6m
5808,2,[GET]pANDE,3652,698,31,18,49,63.3%,6m
5808,2,Olive,3652,806,29,34,63,46.0%,8m
5808,2,OdiUS,3652,236,8,10,18,44.4%,6m
5808,2,supernoob,3652,148,6,4,10,60.0%,8m
5808,2,Strigoi,3652,182,6,9,15,40.0%,9m
5808,2,[ArGGEU]mOsTeN,3652,171,4,10,14,28.6%,18m
5808,2,AcerHMG,3652,60,2,5,7,28.6%,10m
5808,2,Mikc,3652,30,1,1,2,50.0%,6m
5808,2,Fenrisulfr,3652,0,0,1,1,0.0%,3m
5820,2,Yetiman,3651,1569,250,243,493,50.7%,8m
5820,2,Twice,3651,1489,58,60,118,49.2%,5m
5820,2,[Crabby]Musumeci,3651,984,39,46,85,45.9%,9m
5820,2,[SCor]Tyrano,3651,652,35,13,48,72.9%,11m
5820,2,flipke,3651,954,34,45,79,43.0%,9m
5820,2,Eiszeit,3651,438,31,25,56,55.4%,11m
5820,2,Likthor,3651,878,30,44,74,40.5%,7m
5820,2,DDmonkey,3651,494,17,19,36,47.2%,5m
5820,2,[6k]ДобрыйДобряк,3651,393,16,9,25,64.0%,8m
5820,2,VeND,3651,0,1,0,1,100.0%,10m
5820,2,[EZ4XY]ForSATB,3651,0,1,0,1,100.0%,8m
5820,2,Oknesif,3651,0,0,1,1,0.0%,17m
5820,2,[FET]sprawl,3651,0,0,1,1,0.0%,7m
5820,2,[SOUPAP]Martdx,3651,0,0,2,2,0.0%,7m
5834,2,Smallies,3650,1551,79,78,157,50.3%,6m
5834,2,NewLeafJones,3650,1415,69,60,129,53.5%,7m
5834,1,dutch,3650,1450,63,75,138,45.7%,14m
5834,2,[МУЛ]IceKing,3650,486,20,17,37,54.1%,7m
5834,3,[VVVV]Xanor,3650,191,10,5,15,66.7%,16m
5834,2,Lucius,3650,265,9,4,13,69.2%,6m
5834,2,Pazuzu,3650,236,8,11,19,42.1%,16m
5834,1,Zmey,3650,337,8,22,30,26.7%,15m
5834,2,WhatDoUWant,3650,30,1,2,3,33.3%,11m
5834,2,OpHappyZerg,3650,30,1,3,4,25.0%,3m
5834,2,[Pogo]Ecclebert,3650,48,1,3,4,25.0%,10m
5834,3,[GZerO]StarDrive,3650,0,0,1,1,0.0%,17m
5834,2,[LgMstr]llllll,3650,0,0,1,1,0.0%,6m
5847,1,[Quest]Softcloner,3649,1336,233,228,461,50.5%,27m
5847,2,bzazz,3649,897,142,124,266,53.4%,19m
5847,2,IndianR,3649,1004,112,103,215,52.1%,6m
5847,2,ZeroTeoD,3649,1526,76,51,127,59.8%,13m
5847,2,GHOST,3649,705,46,49,95,48.4%,27m
5847,2,[Dralag]StarCry,3649,496,19,16,35,54.3%,2m
5847,2,InfesTKaracK,3649,0,1,0,1,100.0%,19m
5847,2,SashT,3649,0,1,0,1,100.0%,4m
5847,2,Wizz,3649,0,1,2,3,33.3%,17m
5847,2,kasm,3649,30,1,4,5,20.0%,26m
5847,2,[ĦĦ]JamesWade,3649,0,0,1,1,0.0%,7m
5858,2,OutOfcOnTrol,3648,1618,897,864,1761,50.9%,18m
5858,2,eXeCutor,3648,1502,452,450,902,50.1%,27m
5858,2,[НТТ]Kaiser,3648,1495,259,254,513,50.5%,28m
5858,2,[PLA2N]TeRRa,3648,1624,210,205,415,50.6%,6m
5858,2,[DSWT]Spike,3648,1541,131,132,263,49.8%,15m
5858,2,Zolton,3648,1451,117,117,234,50.0%,6m
5858,2,Kraken,3648,1604,83,64,147,56.5%,16m
5858,2,[ValidG]Birdey,3648,213,19,15,34,55.9%,11m
5858,2,Eraglor,3648,438,15,19,34,44.1%,15m
5858,2,[FakJU]jazda,3648,336,13,9,22,59.1%,11m
5858,2,[Zelos]KoolMuShiZuL,3648,226,7,15,22,31.8%,16m
5858,2,[TLT]kwayne,3648,58,3,3,6,50.0%,8m
5858,3,[IceHus]lichking,3648,0,1,1,2,50.0%,8m
5858,2,Eikasang,3648,0,0,3,3,0.0%,15m
5872,2,ShadowStorm,3647,1017,43,34,77,55.8%,18m
5872,2,Drako,3647,577,29,17,46,63.0%,5m
5872,2,[Nject]MisterKoral,3647,58,3,1,4,75.0%,6m
5872,2,[UTGEU]BeefJerke,3647,0,1,0,1,100.0%,5m
5872,2,Scarfang,3647,0,1,0,1,100.0%,12m
5872,2,[Obz]Garcifab,3647,30,1,4,5,20.0%,28m
5872,2,derTeelp,3647,0,0,1,1,0.0%,8m
5872,2,[PandaC]GRX,3647,0,0,1,1,0.0%,10m
5872,2,Fatalzi,3647,0,0,1,1,0.0%,10m
5872,2,Chicken,3647,0,0,1,1,0.0%,18m
5872,2,GuamHurJun,3647,0,0,1,1,0.0%,15m
5883,2,fAtbOyNooB,3646,546,166,157,323,51.4%,40m
5883,2,[10110]Bab,3646,919,119,106,225,52.9%,4m
5883,2,sasso,3646,1442,72,66,138,52.2%,10m
5883,2,[UATeam]Maelnor,3646,843,66,52,118,55.9%,28m
5883,2,SSinner,3646,1005,39,34,73,53.4%,7m
5883,2,ari,3646,346,12,10,22,54.5%,10m
5883,2,Monnar,3646,318,12,13,25,48.0%,13m
5883,2,boanaan,3646,266,10,4,14,71.4%,11m
5883,2,[RÐG]RedDragon,3646,168,6,10,16,37.5%,13m
5883,2,[МLР]AppleJack,3646,30,1,2,3,33.3%,19m
5883,2,CrasH,3646,30,1,4,5,20.0%,7m
5883,2,SRUL,3646,0,0,1,1,0.0%,15m
5883,2,GreenKing,3646,0,0,1,1,0.0%,10m
5896,2,spineless,3645,1467,328,328,656,50.0%,15m
5896,1,Crop,3645,1767,236,252,488,48.4%,13m
5896,2,SlaM,3645,443,100,97,197,50.8%,28m
5896,2,NaroVana,3645,1233,86,79,165,52.1%,11m
5896,2,[FNK]SirFettFisch,3645,585,28,12,40,70.0%,15m
5896,2,[QreskT]SOVA,3645,672,28,24,52,53.8%,7m
5896,2,[BRSKR]WizardCat,3645,456,18,16,34,52.9%,3m
5896,2,DyingEcho,3645,197,9,5,14,64.3%,11m
5896,2,[VAZ]VeloceR,3645,0,1,0,1,100.0%,26m
5896,2,[SJSr]ChainBurn,3645,0,1,0,1,100.0%,5m
5896,2,[NMSQ]Serafit,3645,0,1,2,3,33.3%,15m
5896,2,waizen,3645,30,1,4,5,20.0%,8m
5908,2,[Xygws]Area,3644,1383,281,276,557,50.4%,27m
5908,2,[αX]Boulanger,3644,1415,77,67,144,53.5%,19m
5908,2,[B1lLie]Eilish,3644,812,54,4,58,93.1%,4m
5908,2,Howie,3644,419,32,20,52,61.5%,2m
5908,2,[SZ]Fairespiter,3644,752,27,33,60,45.0%,2m
5908,2,sirnaber,3644,506,20,17,37,54.1%,6m
5908,2,Raelox,3644,133,7,2,9,77.8%,11m
5908,2,Jettt,3644,30,2,2,4,50.0%,9m
5908,2,DTKing,3644,0,1,3,4,25.0%,6m
5908,3,asd,3644,0,0,1,1,0.0%,2m
5908,2,[Kingz]ZergPunch,3644,0,0,1,1,0.0%,19m
5919,2,BsCMBANerd,3643,835,38,24,62,61.3%,16m
5919,2,PlayerOne,3643,520,18,19,37,48.6%,19m
5919,2,Redos,3643,244,10,8,18,55.6%,10m
5919,2,KekseBaron,3643,172,7,9,16,43.8%,11m
5919,2,Mitchowyn,3643,90,4,5,9,44.4%,7m
5919,2,[DelRay]Dahila,3643,30,2,0,2,100.0%,3m
5919,3,WarrioR,3643,0,1,0,1,100.0%,5m
5919,2,TheSwarm,3643,0,1,0,1,100.0%,40m
5919,3,CoZzi,3643,0,0,1,1,0.0%,15m
5928,2,[K0mpis]Mojster,3642,1055,89,76,165,53.9%,9m
5928,2,[kkkkkk]Krak,3642,1353,85,89,174,48.9%,6m
5928,2,IoniC,3642,202,16,24,40,40.0%,12m
5928,2,leanes,3642,172,7,8,15,46.7%,5m
5928,2,[Tits]Hedarth,3642,0,1,0,1,100.0%,17m
5928,1,[EoW]Stephasus,3642,0,1,0,1,100.0%,18m
5928,2,[qDDSp]Phillie,3642,30,1,1,2,50.0%,8m
5928,2,DrRoBoTNiK,3642,0,0,1,1,0.0%,28m
5928,2,Scorpio,3642,0,0,1,1,0.0%,11m
5928,2,Emptiness,3642,0,0,1,1,0.0%,6m
5928,2,BEbnataGDeep,3642,0,0,3,3,0.0%,16m
5928,2,Spring,3642,0,0,3,3,0.0%,8m
5940,2,Alceste,3641,1459,281,269,550,51.1%,11m
5940,2,[TZCrew]Proodz,3641,1496,119,103,222,53.6%,18m
5940,2,pOwl,3641,1247,50,43,93,53.8%,5m
5940,2,[ICGl]elfleischo,3641,799,38,20,58,65.5%,5m
5940,2,[MkersA]slide,3641,380,15,13,28,53.6%,8m
5940,3,Arcotic,3641,128,10,4,14,71.4%,2m
5940,2,[JW]Jaesonian,3641,114,5,8,13,38.5%,27m
5940,3,Jules,3641,30,1,12,13,7.7%,8m
5940,1,Pommettes,3641,0,0,2,2,0.0%,41m
5940,2,[TAW]DigitZ,3641,0,0,2,2,0.0%,8m
5950,2,Rorschach,3640,1536,592,570,1162,50.9%,4m
5950,2,[SLD]mogoh,3640,1536,57,60,117,48.7%,4m
5950,2,festLeemON,3640,918,36,34,70,51.4%,7m
5950,2,[ICGl]Cerberus,3640,497,19,14,33,57.6%,19m
5950,2,ersAh,3640,249,8,8,16,50.0%,10m
5950,2,[Benz]Adam,3640,103,4,8,12,33.3%,9m
5950,2,bHm,3640,90,3,5,8,37.5%,6m
5950,1,Rush,3640,97,2,1,3,66.7%,5m
5950,2,[ScoT]GoldCat,3640,0,0,1,1,0.0%,11m
5950,2,Rage,3640,0,0,1,1,0.0%,10m
5950,2,[LuZe]Medusa,3640,0,0,1,1,0.0%,10m
5950,2,Magik,3640,0,0,4,4,0.0%,3m
5950,2,[DSCOM]zKay,3640,0,0,5,5,0.0%,15m
5950,2,[Tenchu]HandyDandy,3640,0,0,6,6,0.0%,13m
5964,2,krik,3639,1602,246,238,484,50.8%,40m
5964,2,Yaleo,3639,1588,131,112,243,53.9%,11m
5964,2,[HsDL]Scorpio,3639,1533,84,87,171,49.1%,9m
5964,2,Wakatoshi,3639,1354,51,54,105,48.6%,6m
5964,2,[DragKr]HBlish,3639,86,4,1,5,80.0%,19m
5964,2,zyle,3639,0,0,1,1,0.0%,9m
5964,2,[JeeEmm]Ripsy,3639,0,0,2,2,0.0%,16m
5964,2,Kerios,3639,0,0,2,2,0.0%,11m
5972,2,JaSuHonza,3638,1509,133,130,263,50.6%,9m
5972,2,Bezerger,3638,649,38,22,60,63.3%,19m
5972,2,Lynce,3638,326,16,14,30,53.3%,6m
5972,2,Frozor,3638,360,13,9,22,59.1%,2m
5972,2,[АNIME]MomiYT,3638,58,2,2,4,50.0%,9m
5972,2,GadDaki,3638,30,1,3,4,25.0%,7m
5972,2,RoachyRoach,3638,0,1,4,5,20.0%,2m
5972,2,lucky,3638,0,0,3,3,0.0%,7m
5980,2,Sai,3637,939,40,31,71,56.3%,12m
5980,2,TeRaLiSK,3637,429,36,44,80,45.0%,28m
5980,2,Lunar,3637,252,9,4,13,69.2%,15m
5980,2,[310]Ludochoco,3637,112,2,1,3,66.7%,9m
5980,2,Method,3637,0,2,3,5,40.0%,6m
5980,2,hanseN,3637,0,1,0,1,100.0%,19m
5980,1,kagerou,3637,97,1,2,3,33.3%,40m
5980,2,[SoLw]saak,3637,0,0,3,3,0.0%,9m
5988,2,Nosra,3636,1604,270,255,525,51.4%,6m
5988,2,[TryMe]Plow,3636,526,73,70,143,51.0%,15m
5988,2,DupaDuupa,3636,882,65,63,128,50.8%,5m
5988,2,niglof,3636,175,29,15,44,65.9%,8m
5988,2,[D4RK3R]Light,3636,341,26,21,47,55.3%,3m
5988,2,Daydans,3636,389,15,10,25,60.0%,15m
5988,2,Morsof,3636,440,15,20,35,42.9%,5m
5988,2,[uGetKO]Kais,3636,238,8,7,15,53.3%,14m
5988,2,MentalSnipe,3636,92,3,5,8,37.5%,19m
5988,2,jffun,3636,0,1,2,3,33.3%,9m
5988,2,KIss,3636,0,0,1,1,0.0%,11m
5988,2,[CLX]Koalaficated,3636,0,0,4,4,0.0%,26m
6000,2,CHRISTEVA,3635,1615,243,231,474,51.3%,6m
6000,2,[BORODA]Hardy,3635,1002,66,58,124,53.2%,6m
6000,2,JumpyLion,3635,825,51,42,93,54.8%,27m
6000,2,[aW]Maximus,3635,1322,48,52,100,48.0%,12m
6000,2,[Cannоn]Bam,3635,274,16,10,26,61.5%,11m
6000,2,GameofDrones,3635,112,7,1,8,87.5%,4m
6000,2,[BRSKR]Paloma,3635,214,7,8,15,46.7%,16m
6000,2,JaceKaoS,3635,88,3,3,6,50.0%,15m
6000,2,[KAOTx]ShupiK,3635,112,2,1,3,66.7%,3m
6000,2,HosManD,3635,18,2,4,6,33.3%,16m
6000,3,[Viva]Rubalom,3635,0,1,0,1,100.0%,3m
6000,2,Yandex,3635,30,1,8,9,11.1%,7m
6000,2,Hush,3635,0,0,3,3,0.0%,18m
6013,2,RednighT,3634,1587,713,711,1424,50.1%,6m
6013,2,Bali,3634,1635,404,394,798,50.6%,40m
6013,2,Ultra,3634,1531,137,135,272,50.4%,7m
6013,2,aLiThePsycho,3634,1166,47,41,88,53.4%,11m
6013,2,punk,3634,422,32,19,51,62.7%,28m
6013,2,[TeamUR]Jokerpoker,3634,413,22,10,32,68.8%,27m
6013,2,NiteEnd,3634,165,8,1,9,88.9%,5m
6013,1,BigChungus,3634,166,8,2,10,80.0%,28m
6013,2,[TheHof]SeymourBlood,3634,0,1,0,1,100.0%,10m
6013,2,Achillez,3634,0,1,3,4,25.0%,6m
6013,2,NaQa,3634,0,0,1,1,0.0%,11m
6013,2,Orange,3634,0,0,1,1,0.0%,19m
6013,2,pureatheart,3634,0,0,3,3,0.0%,9m
6026,2,PSF,3633,763,45,35,80,56.2%,2m
6026,2,[UATeam]SHOCK,3633,572,20,30,50,40.0%,13m
6026,2,Yharnam,3633,330,12,8,20,60.0%,10m
6026,2,Dodo,3633,319,12,11,23,52.2%,10m
6026,2,Narud,3633,86,3,3,6,50.0%,16m
6026,2,[ØC]Lyon,3633,0,1,0,1,100.0%,5m
6026,1,Хонор,3633,0,0,1,1,0.0%,4m
6026,2,[ioStuN]Stasidze,3633,0,0,1,1,0.0%,2m
6034,2,Gordon,3632,1568,100,97,197,50.8%,12m
6034,2,[CHustl]Unrider,3632,1161,69,61,130,53.1%,7m
6034,2,Noah,3632,1603,67,67,134,50.0%,17m
6034,2,DeadIsRed,3632,444,15,19,34,44.1%,19m
6034,2,BarCode,3632,346,13,12,25,52.0%,17m
6034,2,PinZar,3632,229,12,9,21,57.1%,10m
6034,2,Porty,3632,96,6,1,7,85.7%,7m
6034,2,IIIIIIIIIIII,3632,62,3,4,7,42.9%,17m
6034,2,[h0mos]death,3632,58,2,1,3,66.7%,5m
6034,2,BattleBot,3632,0,1,0,1,100.0%,19m
6034,2,psY,3632,30,1,2,3,33.3%,4m
6034,2,Kalevi,3632,0,1,4,5,20.0%,19m
6034,2,LilCookie,3632,0,0,3,3,0.0%,3m
6047,2,[semiT]Thigh,3631,1560,96,78,174,55.2%,40m
6047,2,Ithaca,3631,864,37,35,72,51.4%,8m
6047,2,CheezeCake,3631,914,35,38,73,47.9%,26m
6047,2,ManateeSpy,3631,620,31,26,57,54.4%,11m
6047,2,Salatkopf,3631,256,9,11,20,45.0%,19m
6047,2,Zockerbabba,3631,116,5,3,8,62.5%,15m
6047,2,Yosoku,3631,0,1,0,1,100.0%,19m
6047,2,Milamber,3631,30,1,2,3,33.3%,40m
6047,2,[G4VR]BresMatt,3631,0,0,1,1,0.0%,15m
6056,2,[šķūnī]napalmEye,3630,1566,308,321,629,49.0%,4m
6056,2,[HSofS]LegionaRy,3630,1566,173,145,318,54.4%,12m
6056,2,[RatEPi]MolOtOv,3630,1554,133,120,253,52.6%,40m
6056,2,[Hаsu]HazeOne,3630,810,70,63,133,52.6%,3m
6056,2,Bisonator,3630,1625,62,69,131,47.3%,15m
6056,2,[HamT]Tantale,3630,1040,41,45,86,47.7%,19m
6056,2,[zozos]predator,3630,615,27,21,48,56.2%,15m
6056,2,IziDritz,3630,266,14,6,20,70.0%,8m
6056,2,Neo,3630,256,11,3,14,78.6%,15m
6056,2,[Darlok]Darlok,3630,130,8,1,9,88.9%,19m
6056,2,DogMonthly,3630,160,8,1,9,88.9%,4m
6056,2,JayKie,3630,0,1,0,1,100.0%,7m
6056,2,[axis]Veracja,3630,0,1,3,4,25.0%,15m
6056,2,Garlanda,3630,0,0,1,1,0.0%,6m
6070,2,[DМG]ShadowChar,3629,1547,437,434,871,50.2%,2m
6070,2,[NooBeL]coco,3629,1577,207,205,412,50.2%,5m
6070,2,[neuroW]Jaxter,3629,1434,194,193,387,50.1%,9m
6070,2,Markam,3629,1522,139,150,289,48.1%,7m
6070,2,fishy,3629,593,70,42,112,62.5%,6m
6070,2,[DrkSn]Gwyndolin,3629,349,14,10,24,58.3%,40m
6070,2,OnionKing,3629,244,13,5,18,72.2%,14m
6070,2,[lwerf]AllEgg,3629,261,12,11,23,52.2%,8m
6070,2,Skyrundas,3629,60,2,6,8,25.0%,17m
6070,2,ShïNo,3629,60,2,7,9,22.2%,28m
6070,2,Xafire,3629,30,1,3,4,25.0%,6m
6070,2,PiNkUniCORN,3629,0,0,1,1,0.0%,12m
6070,2,potatosalad,3629,0,0,3,3,0.0%,10m
6083,2,Peleandrin,3628,927,161,139,300,53.7%,15m
6083,2,BlacKZ,3628,1107,126,99,225,56.0%,4m
6083,2,[Vortex]Tecke,3628,538,25,14,39,64.1%,8m
6083,2,sLacK,3628,521,24,18,42,57.1%,10m
6083,2,cmonson,3628,166,9,3,12,75.0%,15m
6083,2,[TheDOH]CapnHammered,3628,244,9,15,24,37.5%,9m
6083,2,Kaneki,3628,95,6,0,6,100.0%,4m
6083,2,[сSсǃ]Labsick,3628,126,4,0,4,100.0%,5m
6083,2,llllllllllll,3628,0,1,0,1,100.0%,11m
6083,3,[THRLLA]Gav,3628,97,1,1,2,50.0%,9m
6083,2,[MkersA]ClusterFCUK,3628,30,1,1,2,50.0%,7m
6083,2,Badack,3628,30,1,4,5,20.0%,7m
6095,1,Chaek,3627,924,193,204,397,48.6%,3m
6095,2,DeSquiCiouS,3627,858,126,114,240,52.5%,19m
6095,2,[Heroes]McMuffin,3627,971,40,31,71,56.3%,18m
6095,2,RaZerG,3627,306,10,23,33,30.3%,12m
6095,2,[AciNoN]TwilightZeRR,3627,282,9,7,16,56.2%,15m
6095,3,Bibizyan,3627,30,2,0,2,100.0%,14m
6095,2,Emufarmer,3627,60,2,5,7,28.6%,26m
6102,2,Pat,3626,1508,174,140,314,55.4%,19m
6102,2,Savoir,3626,1530,151,128,279,54.1%,19m
6102,2,RobertDindon,3626,761,34,21,55,61.8%,5m
6102,2,brrrrrrr,3626,291,32,31,63,50.8%,12m
6102,2,dudeTWOFIFTp,3626,574,23,20,43,53.5%,8m
6102,2,Normal,3626,304,13,13,26,50.0%,10m
6102,2,[TheER]Dwarfz,3626,220,11,4,15,73.3%,5m
6102,2,Archangal,3626,262,8,6,14,57.1%,7m
6102,2,Zlider,3626,114,8,6,14,57.1%,17m
6102,2,Mode,3626,180,6,8,14,42.9%,7m
6102,2,AlexGl,3626,137,5,3,8,62.5%,13m
6102,2,Jebediah,3626,71,4,5,9,44.4%,27m
6102,2,IIIIIIIIIIII,3626,0,1,1,2,50.0%,2m
6102,2,ABC,3626,30,1,3,4,25.0%,17m
6102,2,Enkidu,3626,30,1,5,6,16.7%,16m
6102,2,avraL,3626,0,0,1,1,0.0%,16m
6102,2,BigFungus,3626,0,0,2,2,0.0%,16m
6119,2,Omega,3625,1156,239,223,462,51.7%,15m
6119,2,Itachi,3625,1184,146,126,272,53.7%,17m
6119,2,IIyxMaster,3625,1210,67,50,117,57.3%,3m
6119,2,[aW]Kuoni,3625,1006,45,31,76,59.2%,15m
6119,2,Baga,3625,996,40,33,73,54.8%,18m
6119,2,noone,3625,487,20,12,32,62.5%,15m
6119,1,IIIIIIIIIIII,3625,168,8,2,10,80.0%,14m
6119,2,Remuko,3625,76,4,3,7,57.1%,9m
6119,2,[Bauta]Grodan,3625,30,2,2,4,50.0%,27m
6119,2,arch,3625,0,0,1,1,0.0%,13m
6119,2,[ENGNS]lHero,3625,0,0,3,3,0.0%,40m
6119,2,[yOuEzz]FatalisK,3625,0,0,3,3,0.0%,12m
6119,1,Nogard,3625,0,0,3,3,0.0%,17m
6132,2,Andrew,3624,1564,140,151,291,48.1%,28m
6132,2,Weytley,3624,478,19,12,31,61.3%,8m
6132,2,Chimera,3624,524,19,19,38,50.0%,19m
6132,2,Mpeta,3624,130,8,1,9,88.9%,6m
6132,2,JustYan,3624,118,5,9,14,35.7%,4m
6132,2,littleINno,3624,140,4,1,5,80.0%,6m
6132,2,Gortar,3624,114,4,3,7,57.1%,11m
6132,2,[Ukzerr]Captainsauté,3624,58,2,4,6,33.3%,19m
6132,2,[IIARII]HanSolo,3624,32,2,4,6,33.3%,2m
6132,2,PanSowa,3624,0,1,1,2,50.0%,6m
6132,2,[ƮesXG]BlueIce,3624,0,0,1,1,0.0%,19m
6132,3,[APGs]Ménix,3624,0,0,1,1,0.0%,41m
6132,2,[IOWAD]zonkibonki,3624,0,0,3,3,0.0%,19m
6132,2,GlinGophobe,3624,0,0,3,3,0.0%,16m
6146,2,lightphoenix,3623,542,104,84,188,55.3%,27m
6146,2,HappyMaumau,3623,1566,99,79,178,55.6%,5m
6146,2,DiZaGear,3623,951,61,52,113,54.0%,7m
6146,2,Stiegl,3623,1169,59,31,90,65.6%,5m
6146,2,[TITTIT]ILuvZilina,3623,322,12,18,30,40.0%,11m
6146,2,lllIllllIlll,3623,154,9,2,11,81.8%,40m
6146,2,Sinistro,3623,160,8,1,9,88.9%,40m
6146,2,[LAMPA]ShinoaLovers,3623,30,2,0,2,100.0%,8m
6146,2,[HämSec]LightTrack,3623,0,1,0,1,100.0%,18m
6146,2,WBF,3623,0,0,1,1,0.0%,5m
6146,3,[Bigold]Fefer,3623,0,0,1,1,0.0%,17m
6146,2,Xtse,3623,0,0,1,1,0.0%,19m
6158,2,Ubertuba,3622,1470,353,353,706,50.0%,28m
6158,2,AvarakSul,3622,1585,320,321,641,49.9%,7m
6158,2,[Arrows]Abaddon,3622,1201,61,66,127,48.0%,10m
6158,2,[PŖïMĄŁ]Divadius,3622,1402,53,51,104,51.0%,19m
6158,2,[TheRPW]Типочек,3622,60,11,13,24,45.8%,6m
6158,2,[TMROW]Viten,3622,270,9,14,23,39.1%,17m
6158,2,[PNH]Fingolfin,3622,131,7,11,18,38.9%,3m
6158,2,fjjotizz,3622,88,2,4,6,33.3%,19m
6158,2,[BjwA]NiTreXxX,3622,60,2,7,9,22.2%,3m
6158,2,Chroma,3622,30,1,4,5,20.0%,28m
6158,2,[Yame]YvesMatrak,3622,0,0,1,1,0.0%,15m
6158,2,betongapa,3622,0,0,1,1,0.0%,4m
6158,2,Panda,3622,0,0,1,1,0.0%,11m
6158,2,Baygon,3622,0,0,1,1,0.0%,26m
6172,2,[NvRScT]Nerg,3621,994,59,59,118,50.0%,4m
6172,2,[4Kappa]Yeskis,3621,0,2,3,5,40.0%,19m
6172,2,Sila,3621,0,1,0,1,100.0%,13m
6172,2,hApTiC,3621,88,1,3,4,25.0%,16m
6172,2,Drachenlord,3621,0,0,1,1,0.0%,5m
6172,2,flaxlail,3621,0,0,2,2,0.0%,12m
6178,2,Aeshma,3620,745,59,47,106,55.7%,11m
6178,2,NaNo,3620,873,45,52,97,46.4%,11m
6178,2,Sneakyfrog,3620,620,29,18,47,61.7%,8m
6178,2,Napster,3620,341,15,7,22,68.2%,9m
6178,2,[ITM]Scet,3620,274,10,12,22,45.5%,10m
6178,2,[LOGS]Chewchilla,3620,142,8,5,13,61.5%,15m
6178,3,ZeroCool,3620,248,7,9,16,43.8%,14m
6178,2,Inferno,3620,48,2,2,4,50.0%,11m
6178,2,[teamZP]Rauls,3620,0,1,0,1,100.0%,11m
6178,3,Dejaner,3620,97,1,1,2,50.0%,2m
6178,2,llllllllllll,3620,30,1,2,3,33.3%,16m
6189,2,[R4Time]Wizard,3619,1225,51,51,102,50.0%,11m
6189,2,rodnichok,3619,223,16,12,28,57.1%,7m
6189,2,Côôky,3619,218,13,10,23,56.5%,8m
6189,2,Maru,3619,95,6,0,6,100.0%,8m
6189,3,[ĀşƇ]Hikari,3619,0,5,0,5,100.0%,14m
6189,2,Ocelot,3619,58,2,2,4,50.0%,7m
6189,2,TeeDawl,3619,123,2,5,7,28.6%,7m
6189,2,Kono,3619,0,1,0,1,100.0%,10m
6189,2,[BANSHE]Hope,3619,30,1,3,4,25.0%,4m
6189,2,[HBGSJR]Darkwolf,3619,0,0,1,1,0.0%,7m
6199,2,Hilen,3618,1031,105,110,215,48.8%,27m
6199,2,[lOoOl]TEPPOPUCT,3618,302,17,3,20,85.0%,15m
6199,2,yesterhead,3618,149,3,4,7,42.9%,19m
6199,2,[SWISS]CrazyStar,3618,0,1,0,1,100.0%,15m
6199,2,[UAŦeam]Megalith,3618,0,0,1,1,0.0%,2m
6204,2,INFerno,3617,1606,264,258,522,50.6%,11m
6204,2,Rifter,3617,1365,79,73,152,52.0%,9m
6204,1,Nuzze,3617,190,10,2,12,83.3%,5m
6204,2,rovaa,3617,232,8,8,16,50.0%,7m
6204,2,ProtossFart,3617,88,3,5,8,37.5%,7m
6204,2,ArtyomHaayom,3617,30,1,1,2,50.0%,13m
6204,2,Testa,3617,0,1,4,5,20.0%,6m
6204,2,Hanchek,3617,0,0,3,3,0.0%,27m
6212,2,JoY,3616,1575,227,211,438,51.8%,18m
6212,2,neo,3616,1607,191,193,384,49.7%,27m
6212,2,[NiGL]Deontay,3616,362,37,36,73,50.7%,12m
6212,2,JacK,3616,393,20,8,28,71.4%,7m
6212,2,Joo,3616,516,20,19,39,51.3%,6m
6212,2,McLovIn,3616,434,19,11,30,63.3%,11m
6212,2,Predators,3616,173,12,12,24,50.0%,11m
6212,2,DeliCatz,3616,116,7,1,8,87.5%,13m
6212,2,rtegfdq,3616,139,7,1,8,87.5%,17m
6212,2,[IceHus]кереешка,3616,166,6,1,7,85.7%,9m
6212,2,Quest,3616,214,6,5,11,54.5%,2m
6212,1,[Looser]IYIBlade,3616,170,5,6,11,45.5%,9m
6212,2,[Ximic]ХитрыйКот,3616,92,4,4,8,50.0%,15m
6212,2,Lambert,3616,60,3,4,7,42.9%,8m
6212,2,Sashko,3616,0,1,0,1,100.0%,14m
6212,2,Ceddel,3616,46,1,6,7,14.3%,5m
6212,2,[RGQT]Façonnable,3616,0,0,1,1,0.0%,16m
6212,2,qazcdewsx,3616,0,0,1,1,0.0%,15m
6212,2,Ziserman,3616,0,0,1,1,0.0%,7m
6231,2,Azamantes,3615,1537,276,276,552,50.0%,11m
6231,2,MindBender,3615,1376,95,88,183,51.9%,7m
6231,2,mainman,3615,586,53,41,94,56.4%,10m
6231,2,[CMBO]eOliAs,3615,770,46,38,84,54.8%,7m
6231,2,ShuShu,3615,495,18,29,47,38.3%,10m
6231,1,Jaguar,3615,680,16,34,50,32.0%,8m
6231,2,[Reymor]HiveFive,3615,284,10,22,32,31.2%,28m
6231,2,[TAW]GHOST,3615,164,5,16,21,23.8%,3m
6231,3,IIIIIIIIIIII,3615,30,2,3,5,40.0%,11m
6231,2,[FИCK]DanjA,3615,0,2,4,6,33.3%,13m
6241,2,Berty,3614,854,60,43,103,58.3%,15m
6241,2,[BELIAL]Morgoth,3614,637,26,22,48,54.2%,16m
6241,2,[K0mpis]Avenger,3614,210,23,25,48,47.9%,12m
6241,2,[NТB]Mito,3614,514,20,16,36,55.6%,9m
6241,2,Samiimov,3614,126,4,11,15,26.7%,16m
6241,2,Smile,3614,86,3,11,14,21.4%,6m
6241,2,ArkGrendl,3614,0,1,0,1,100.0%,27m
6241,2,WARdd,3614,30,1,3,4,25.0%,15m
6241,2,Spygunner,3614,0,0,1,1,0.0%,10m
6250,2,HelioGracie,3613,1161,393,387,780,50.4%,17m
6250,2,CptProtoss,3613,466,38,15,53,71.7%,26m
6250,2,SilentGait,3613,458,16,15,31,51.6%,18m
6250,2,[nbsp]plazmdk,3613,170,6,5,11,54.5%,28m
6250,2,Capestian,3613,60,3,2,5,60.0%,15m
6250,2,PacRAT,3613,60,3,6,9,33.3%,7m
6250,1,GhostTemplar,3613,135,3,7,10,30.0%,9m
6250,2,APMeth,3613,30,1,8,9,11.1%,7m
6250,2,[PNSK]Ghengis,3613,0,0,1,1,0.0%,26m
6259,2,ChicCo,3612,1117,47,39,86,54.7%,19m
6259,2,ЛошокVIVIVI,3612,702,27,28,55,49.1%,3m
6259,2,tvm,3612,598,22,23,45,48.9%,41m
6259,1,[lDil]Artcore,3612,209,10,3,13,76.9%,3m
6259,2,[ZZW]OldNick,3612,165,8,1,9,88.9%,18m
6259,2,Barcode,3612,184,6,10,16,37.5%,10m
6259,2,[BGuard]CardBoxMan,3612,112,3,0,3,100.0%,11m
6259,2,[NBBS]pasen,3612,62,2,6,8,25.0%,12m
6259,2,[ez4klz]jume,3612,0,1,0,1,100.0%,17m
6259,2,ДжохниПрогей,3612,30,1,3,4,25.0%,16m
6259,2,Seat,3612,0,0,5,5,0.0%,6m
6270,2,[Ǽ1]PumkY,3611,1086,51,48,99,51.5%,6m
6270,2,[H4P]green,3611,185,47,57,104,45.2%,15m
6270,2,DinDjarin,3611,808,32,31,63,50.8%,19m
6270,2,[GasNub]RosMaria,3611,351,26,23,49,53.1%,9m
6270,2,[aW]clockmaster,3611,244,10,13,23,43.5%,5m
6270,2,BzKDriveR,3611,120,5,5,10,50.0%,15m
6270,2,[Dolp]DolphWin,3611,30,2,0,2,100.0%,15m
6270,2,Оладушек,3611,0,1,0,1,100.0%,4m
6270,2,Monkinek,3611,0,1,2,3,33.3%,9m
6270,2,TwinTurbo,3611,0,0,1,1,0.0%,11m
6270,2,[OPMFS]Agara,3611,0,0,3,3,0.0%,16m
6281,3,Keepoeu,3610,336,15,4,19,78.9%,8m
6281,2,Korn,3610,181,11,3,14,78.6%,7m
6281,2,caonima,3610,154,8,2,10,80.0%,3m
6281,2,Joker,3610,115,7,1,8,87.5%,4m
6281,2,Pogo,3610,150,6,11,17,35.3%,19m
6281,2,[NoRel]OliverThor,3610,90,5,7,12,41.7%,5m
6281,3,RedBlustery,3610,0,1,4,5,20.0%,12m
6281,2,AgentSmith,3610,0,0,1,1,0.0%,26m
6289,2,mole,3609,1575,134,132,266,50.4%,6m
6289,2,Meat,3609,1594,113,121,234,48.3%,40m
6289,2,[Li3]GoodDaddy,3609,1461,88,90,178,49.4%,18m
6289,2,Rafavr,3609,752,27,33,60,45.0%,2m
6289,2,[SRC]VitafreshUA,3609,310,12,14,26,46.2%,28m
6289,2,ICBreaker,3609,315,11,11,22,50.0%,12m
6289,2,[SpagLo]Asheir,3609,280,10,14,24,41.7%,9m
6289,2,Zoro,3609,0,1,0,1,100.0%,9m
6289,2,Sol,3609,0,1,0,1,100.0%,6m
6289,1,[DOM]Yolpo,3609,0,1,4,5,20.0%,7m
6289,2,gonn,3609,0,1,9,10,10.0%,8m
6289,2,SherazaR,3609,0,0,1,1,0.0%,16m
6301,2,[BCWolf]run,3608,1630,259,254,513,50.5%,7m
6301,1,[FRAG]Faraday,3608,878,229,234,463,49.5%,14m
6301,2,linkthesink,3608,913,88,66,154,57.1%,16m
6301,2,Anacobra,3608,274,29,39,68,42.6%,6m
6301,2,Adsven,3608,538,19,27,46,41.3%,8m
6301,2,Whyamimrpink,3608,119,7,1,8,87.5%,7m
6301,2,Pim,3608,95,5,0,5,100.0%,18m
6301,2,Baysen,3608,148,5,7,12,41.7%,17m
6301,2,Raif,3608,116,3,1,4,75.0%,12m
6301,2,OKNOTOK,3608,30,2,1,3,66.7%,10m
6301,2,kiritoooooo,3608,30,2,1,3,66.7%,5m
6301,3,[NumbAc]Puigs,3608,0,1,0,1,100.0%,19m
6301,1,Martin,3608,0,1,1,2,50.0%,17m
6301,2,Survival,3608,0,0,1,1,0.0%,5m
6301,2,SenSaTiOnELL,3608,0,0,1,1,0.0%,40m
6301,2,[DAXEI]Haizle,3608,0,0,1,1,0.0%,11m
6317,2,nSk,3607,1479,99,116,215,46.0%,12m
6317,2,[Ǽ1]Superhero,3607,1571,87,93,180,48.3%,11m
6317,2,Ethanol,3607,216,15,13,28,53.6%,9m
6317,2,Nicolas,3607,0,1,0,1,100.0%,6m
6317,2,Discerpo,3607,0,1,0,1,100.0%,40m
6317,2,Mazzzurr,3607,0,1,1,2,50.0%,28m
6317,2,[bareti]SpOoT,3607,0,0,1,1,0.0%,6m
6324,2,LangesElend,3606,1574,237,245,482,49.2%,6m
6324,2,EZnoko,3606,1489,123,108,231,53.2%,16m
6324,2,ArsisThesis,3606,1053,49,46,95,51.6%,6m
6324,2,[SPAINs]Romu,3606,339,39,27,66,59.1%,28m
6324,2,Pdt,3606,597,30,28,58,51.7%,15m
6324,2,Quiks,3606,369,23,33,56,41.1%,28m
6324,2,FAQ,3606,447,16,11,27,59.3%,19m
6324,2,[RBP3]JohnCreamer,3606,360,13,19,32,40.6%,13m
6324,2,ruth,3606,138,5,1,6,83.3%,7m
6324,3,[TheM]GreveGruva,3606,0,3,2,5,60.0%,17m
6324,2,Aerowen,3606,0,1,0,1,100.0%,4m
6335,2,[BWArmy]Corentin,3605,1436,208,178,386,53.9%,11m
6335,2,Hebbes,3605,1114,45,42,87,51.7%,20m
6335,2,Arkanis,3605,1190,45,50,95,47.4%,5m
6335,2,Emyox,3605,618,26,18,44,59.1%,18m
6335,2,[GRNSKN]Idunno,3605,676,24,29,53,45.3%,15m
6335,2,[Z3RGTV]Fantom,3605,543,20,19,39,51.3%,5m
6335,2,[HBGSJR]KrisFeeD,3605,228,9,8,17,52.9%,15m
6335,3,Baboon,3605,0,5,0,5,100.0%,4m
6335,2,[FlFi]Nereon,3605,126,4,1,5,80.0%,9m
6335,2,OBSIDIAN,3605,154,4,3,7,57.1%,15m
6335,3,Lachend,3605,0,3,2,5,60.0%,17m
6335,2,emmmm,3605,128,3,2,5,60.0%,12m
6335,2,Chickenman,3605,116,3,3,6,50.0%,6m
6335,2,GvinBlade,3605,60,3,3,6,50.0%,8m
6335,2,[Juliet]Wakaranai,3605,62,3,4,7,42.9%,7m
6335,2,TEMYP,3605,0,1,2,3,33.3%,3m
6335,2,[ЗЕRGТV]Sabitik,3605,30,1,3,4,25.0%,12m
6335,2,[APCRPH]WillBe,3605,0,0,2,2,0.0%,17m
6335,2,DPGGucci,3605,0,0,4,4,0.0%,7m
6354,2,[MYFS]Antiares,3604,860,104,104,208,50.0%,10m
6354,2,Cvoky,3604,843,36,38,74,48.6%,40m
6354,2,Sirgling,3604,477,24,13,37,64.9%,16m
6354,2,[BRSKR]LaTeX,3604,345,19,4,23,82.6%,40m
6354,2,LaoTzu,3604,478,17,20,37,45.9%,17m
6354,2,Heuner,3604,212,14,6,20,70.0%,26m
6354,2,[Zelos]DonquixoteDV,3604,205,9,2,11,81.8%,9m
6354,2,[EAU]VicTahy,3604,141,8,0,8,100.0%,7m
6354,2,[AGBF]llllllllllll,3604,88,2,0,2,100.0%,13m
6363,2,[Ty4a]BomBom,3603,767,59,61,120,49.2%,11m
6363,2,Bayash,3603,324,12,10,22,54.5%,15m
6363,2,LUZEA,3603,204,8,8,16,50.0%,5m
6363,2,MisterMarine,3603,0,3,2,5,60.0%,19m
6363,2,SlayersMMA,3603,30,2,2,4,50.0%,17m
6363,2,[KeWa]Tyran,3603,30,1,5,6,16.7%,10m
6363,2,[PLA2N]classikby,3603,0,0,1,1,0.0%,9m
6363,2,Arawr,3603,0,0,2,2,0.0%,16m
6371,2,WhiteWidow,3602,1652,544,523,1067,51.0%,6m
6371,2,riot,3602,959,60,65,125,48.0%,27m
6371,2,[HBGSJR]magic,3602,213,12,0,12,100.0%,40m
6371,2,Shaposhkite,3602,0,4,1,5,80.0%,13m
6371,2,Mindziasin,3602,0,1,0,1,100.0%,17m
6371,2,WassupMan,3602,88,1,1,2,50.0%,20m
6371,2,FANATICK,3602,0,1,1,2,50.0%,3m
6378,2,MasterMind,3601,1495,218,201,419,52.0%,11m
6378,2,[Yame]Battlemage,3601,1571,151,143,294,51.4%,40m
6378,2,sikvoya,3601,1381,83,61,144,57.6%,17m
6378,3,StefTheGreat,3601,0,5,0,5,100.0%,17m
6378,2,Kaliras,3601,116,5,10,15,33.3%,8m
6378,2,Tekkers,3601,88,2,0,2,100.0%,15m
6378,2,Broomremover,3601,0,1,0,1,100.0%,6m
6378,2,Karys,3601,0,1,5,6,16.7%,9m
6378,2,[S0SAT]Меир,3601,0,0,1,1,0.0%,16m
6378,2,[QRQ]lapa,3601,0,0,1,1,0.0%,16m
6388,2,Drakon,3600,1604,149,150,299,49.8%,7m
6388,2,Blackwolf,3600,363,74,64,138,53.6%,19m
6388,2,ClydeTheFrog,3600,1184,50,44,94,53.2%,20m
6388,2,FranZ,3600,817,48,53,101,47.5%,4m
6388,2,Talwar,3600,816,34,27,61,55.7%,15m
6388,2,MagicPancake,3600,404,20,13,33,60.6%,9m
6388,2,Cesar,3600,166,9,3,12,75.0%,11m
6388,2,GoodTime,3600,118,7,0,7,100.0%,11m
6388,2,lohgff,3600,124,5,6,11,45.5%,4m
6388,2,CaDuDé,3600,99,4,2,6,66.7%,26m
6388,2,[H0M0S]scurge,3600,118,4,6,10,40.0%,17m
6388,2,nabbcake,3600,90,3,5,8,37.5%,5m
6388,2,Furexus,3600,88,2,0,2,100.0%,8m
6388,2,Víðarr,3600,0,1,5,6,16.7%,7m
6388,2,Namelock,3600,0,0,1,1,0.0%,11m
6403,2,[IceHus]teryagov,3599,784,38,23,61,62.3%,7m
6403,2,[DZTK]Nyres,3599,228,13,10,23,56.5%,11m
6403,2,Soulstealer,3599,206,8,9,17,47.1%,5m
6403,2,Playy,3599,182,6,8,14,42.9%,11m
6403,2,flapiyo,3599,30,2,2,4,50.0%,11m
6403,2,[HERP]tHeReaveR,3599,0,1,0,1,100.0%,3m
6403,2,Нагибатор,3599,0,1,0,1,100.0%,11m
6403,2,ЛовкийЗерг,3599,88,1,1,2,50.0%,7m
6411,2,Insomnium,3598,1576,395,400,795,49.7%,40m
6411,2,LevenarK,3598,1428,216,218,434,49.8%,9m
6411,2,Zelgadiss,3598,590,36,8,44,81.8%,7m
6411,2,BonkbalBimbo,3598,749,33,24,57,57.9%,5m
6411,3,Midov,3598,202,15,6,21,71.4%,26m
6411,2,alastor,3598,187,9,5,14,64.3%,9m
6411,3,Parmigiano,3598,97,6,0,6,100.0%,6m
6411,2,[Fussel]Fiboniker,3598,95,4,1,5,80.0%,3m
6411,2,[ZERGML]Ramm,3598,128,4,2,6,66.7%,41m
6411,2,[GGxC]TheGREYBUSH,3598,96,3,2,5,60.0%,11m
6411,2,[nB]Setsin,3598,0,1,0,1,100.0%,11m
6411,2,WildLemur,3598,0,1,0,1,100.0%,7m
6411,2,[MST]Prometheus,3598,0,0,1,1,0.0%,11m
6424,2,[DZ16]PREDATOR,3597,1572,72,64,136,52.9%,13m
6424,2,IIIIIIIIIIII,3597,724,40,40,80,50.0%,11m
6424,2,Delirium,3597,856,37,27,64,57.8%,19m
6424,2,[T4E]TFEnos,3597,86,4,4,8,50.0%,7m
6424,2,[DМG]NaxxMare,3597,90,3,7,10,30.0%,11m
6424,2,[Vio]Jin,3597,0,1,0,1,100.0%,3m
6424,3,Heartless,3597,0,1,0,1,100.0%,18m
6424,2,Justacheeser,3597,30,1,2,3,33.3%,18m
6424,2,[Vio]CatZii,3597,0,0,2,2,0.0%,17m
6424,2,[RoAST]BiPolarBear,3597,0,0,2,2,0.0%,16m
6434,2,Vigil,3596,622,69,44,113,61.1%,17m
6434,2,VIP,3596,344,17,10,27,63.0%,14m
6434,2,MakiMix,3596,261,15,4,19,78.9%,40m
6434,2,[CTLNG]Puffs,3596,208,8,11,19,42.1%,17m
6434,2,Dithmarscher,3596,114,4,7,11,36.4%,40m
6434,2,[TSTG]Timor,3596,62,3,8,11,27.3%,7m
6434,2,Storm,3596,0,1,1,2,50.0%,19m
6434,2,kilovat,3596,0,1,1,2,50.0%,9m
6434,2,novoko,3596,0,0,1,1,0.0%,17m
6443,2,[CCF]Tarrackk,3595,177,23,15,38,60.5%,16m
6443,2,Relaxo,3595,363,22,23,45,48.9%,5m
6443,2,Snaky,3595,334,20,36,56,35.7%,40m
6443,3,Quadruppel,3595,368,16,6,22,72.7%,7m
6443,2,[MAS]ZWECK,3595,464,16,25,41,39.0%,11m
6443,2,Baki,3595,307,12,9,21,57.1%,10m
6443,2,SwarmQueen,3595,202,7,8,15,46.7%,8m
6443,2,[Ris3n]HomeTownCrib,3595,88,2,0,2,100.0%,11m
6443,2,SkIoASarkan,3595,88,1,1,2,50.0%,13m
6452,2,Ziykuna,3594,1594,214,189,403,53.1%,7m
6452,2,BartoK,3594,805,84,70,154,54.5%,3m
6452,2,ROACH,3594,1516,68,66,134,50.7%,13m
6452,2,Kys,3594,990,40,36,76,52.6%,19m
6452,2,Cheburek,3594,829,35,23,58,60.3%,11m
6452,2,Saint,3594,368,18,10,28,64.3%,16m
6452,2,Kirov,3594,374,14,12,26,53.8%,9m
6452,2,IIIIIIIIIIII,3594,310,13,6,19,68.4%,5m
6452,2,[Elbow]Face,3594,230,10,4,14,71.4%,10m
6452,2,SliZm,3594,220,8,11,19,42.1%,7m
6452,2,[ƮesXG2]Mulemech,3594,128,4,1,5,80.0%,16m
6452,2,dayvie,3594,102,3,1,4,75.0%,40m
6452,2,[Hаsu]JAEKS,3594,30,2,3,5,40.0%,13m
6452,2,DFTT,3594,0,1,0,1,100.0%,9m
6452,2,[NetGG]PrettyFly,3594,0,1,0,1,100.0%,11m
6467,2,JuicyDoubles,3593,1476,201,196,397,50.6%,5m
6467,2,[CHOPAA]Argonavt,3593,1223,111,97,208,53.4%,5m
6467,2,Adnox,3593,574,21,21,42,50.0%,20m
6467,2,[REIP00]mogue,3593,438,15,18,33,45.5%,7m
6467,2,Rgr,3593,270,12,8,20,60.0%,16m
6467,2,[isGG]Hawki,3593,144,7,1,8,87.5%,7m
6473,2,Chatpitou,3592,1452,93,90,183,50.8%,10m
6473,2,AvilS,3592,962,41,37,78,52.6%,4m
6473,2,Jinkies,3592,820,38,41,79,48.1%,19m
6473,2,[Viscrl]Leafstep,3592,713,32,20,52,61.5%,3m
6473,2,CISNoRegreT,3592,521,24,10,34,70.6%,11m
6473,2,Vito,3592,272,10,6,16,62.5%,16m
6473,2,[ĦĦ]BaXcoX,3592,299,10,9,19,52.6%,18m
6473,2,Maleb,3592,262,10,13,23,43.5%,13m
6473,2,[Stunt]Theios,3592,241,9,6,15,60.0%,19m
6473,2,Samaray,3592,160,8,8,16,50.0%,7m
6473,2,ramleren,3592,90,3,7,10,30.0%,15m
6473,2,HorstKevin,3592,73,3,8,11,27.3%,6m
6473,2,Toastbrot,3592,30,1,4,5,20.0%,17m
6473,2,HOSCHMOSCH,3592,0,0,1,1,0.0%,15m
6487,2,LeeVanQueef,3591,719,90,79,169,53.3%,27m
6487,2,[IceHus]Nikon,3591,1100,40,47,87,46.0%,6m
6487,2,llllllllllll,3591,723,39,31,70,55.7%,16m
6487,2,Manolo,3591,491,27,5,32,84.4%,9m
6487,3,IceStorm,3591,283,10,5,15,66.7%,6m
6487,3,Saigneur,3591,247,9,1,10,90.0%,5m
6487,2,classic,3591,176,7,6,13,53.8%,4m
6487,2,volanis,3591,191,6,5,11,54.5%,10m
6487,2,[TExGG]Metray,3591,0,1,0,1,100.0%,4m
6487,2,Paws,3591,30,1,5,6,16.7%,7m
6487,2,[ArnGms]Shogun,3591,0,0,1,1,0.0%,19m
6487,2,TheGoldenRat,3591,0,0,3,3,0.0%,3m
6499,2,clthegoat,3590,1533,96,87,183,52.5%,40m
6499,2,[DFgs]MasterMind,3590,1051,90,91,181,49.7%,7m
6499,2,[Dralag]Zinhar,3590,648,26,20,46,56.5%,41m
6499,2,Callboy,3590,541,25,17,42,59.5%,16m
6499,2,[Sc2V]brutuss,3590,216,8,11,19,42.1%,7m
6499,2,Dragon,3590,179,5,6,11,45.5%,7m
6499,2,Invictus,3590,169,4,5,9,44.4%,13m
6499,2,Epibaterios,3590,30,2,2,4,50.0%,15m
6499,2,NYdiesel,3590,62,2,12,14,14.3%,16m
6499,2,Ipe,3590,0,1,1,2,50.0%,20m
6499,1,Haarhus,3590,96,1,1,2,50.0%,9m
6499,2,spektr,3590,30,1,6,7,14.3%,26m
6499,2,Kite,3590,0,0,1,1,0.0%,10m
6499,2,glingut,3590,0,0,3,3,0.0%,7m
6513,2,[UAŦeam]RAM,3589,1034,51,27,78,65.4%,14m
6513,2,CXD,3589,483,45,43,88,51.1%,3m
6513,2,Johnney,3589,637,28,20,48,58.3%,3m
6513,2,RuDE,3589,423,18,10,28,64.3%,7m
6513,2,[AiRǂ]Warf,3589,160,11,6,17,64.7%,7m
6513,2,Skysork,3589,169,6,2,8,75.0%,28m
6513,2,GREZBANE,3589,156,5,13,18,27.8%,7m
6513,2,Marisa,3589,102,2,1,3,66.7%,5m
6513,2,rinaks,3589,30,1,5,6,16.7%,11m
6513,2,[MUUMI]ropo,3589,0,0,2,2,0.0%,10m
6513,2,Dylan,3589,0,0,3,3,0.0%,3m
6524,2,Naked,3588,1428,201,203,404,49.8%,3m
6524,2,[Lilith]Baerchen,3588,336,48,31,79,60.8%,7m
6524,2,kasar,3588,817,38,26,64,59.4%,9m
6524,2,walkthisway,3588,616,21,25,46,45.7%,16m
6524,2,CasqueOuille,3588,448,15,18,33,45.5%,7m
6524,2,twelvepool,3588,166,5,5,10,50.0%,7m
6524,2,[Shad0w]ProGhost,3588,58,3,3,6,50.0%,20m
6524,2,Doubt,3588,97,2,3,5,40.0%,8m
6524,2,[tXs]TheBloke,3588,60,2,5,7,28.6%,6m
6524,2,Ayi,3588,30,1,2,3,33.3%,19m
6524,2,Trinkhalm,3588,0,0,1,1,0.0%,3m
6535,2,Frey,3587,1314,164,161,325,50.5%,28m
6535,2,PolderPloer,3587,1561,110,97,207,53.1%,10m
6535,2,Isy,3587,1492,110,121,231,47.6%,11m
6535,2,Regis,3587,738,41,39,80,51.2%,2m
6535,2,LingMaster,3587,1094,41,46,87,47.1%,6m
6535,2,Fosvihar,3587,783,38,21,59,64.4%,6m
6535,2,Invisible,3587,482,19,18,37,51.4%,28m
6535,2,Finn,3587,168,11,1,12,91.7%,16m
6535,2,Venture,3587,156,6,1,7,85.7%,41m
6535,2,[GHOGHH]RedKokiedo,3587,102,3,0,3,100.0%,27m
6535,2,quietMADman,3587,88,2,1,3,66.7%,27m
6535,2,[zerg0]armagedon,3587,30,2,2,4,50.0%,5m
6535,1,[SC7]Lodz,3587,0,1,0,1,100.0%,17m
6548,2,ZXCVB,3586,1236,231,217,448,51.6%,17m
6548,2,ıŠıAD,3586,855,114,102,216,52.8%,6m
6548,2,fckProtoss,3586,671,53,62,115,46.1%,11m
6548,2,fatlawrence,3586,364,13,15,28,46.4%,16m
6548,3,Nugias,3586,242,10,3,13,76.9%,19m
6548,2,TurningPoint,3586,208,8,9,17,47.1%,3m
6548,2,[FeFw]Adilond,3586,180,6,16,22,27.3%,11m
6548,3,[LGC]Tranquilo,3586,0,1,0,1,100.0%,14m
6548,2,Kornilie,3586,0,1,1,2,50.0%,16m
6548,2,Polnikov,3586,30,1,4,5,20.0%,16m
6548,3,MaCFlyDay,3586,0,0,1,1,0.0%,18m
6548,3,CerO,3586,0,0,1,1,0.0%,40m
6560,2,Yann,3585,1322,412,404,816,50.5%,5m
6560,2,MEGODIEGO,3585,1336,157,149,306,51.3%,6m
6560,2,Diradas,3585,987,68,61,129,52.7%,12m
6560,2,From,3585,356,21,20,41,51.2%,13m
6560,2,XiondrapoS,3585,574,20,25,45,44.4%,11m
6560,3,mæma,3585,309,13,5,18,72.2%,13m
6560,2,NoobTerran,3585,215,7,14,21,33.3%,6m
6560,2,Ewells,3585,92,4,3,7,57.1%,3m
6560,3,NocteDeum,3585,0,0,1,1,0.0%,5m
6569,2,BitchBotBoii,3584,648,89,84,173,51.4%,10m
6569,2,DOMINATOr,3584,180,6,9,15,40.0%,7m
6569,2,[PhAFr]Papuche,3584,194,6,19,25,24.0%,17m
6569,2,rerasen,3584,94,5,7,12,41.7%,28m
6569,2,[UgaUga]Neanderl,3584,116,4,1,5,80.0%,4m
6569,3,Alexasby,3584,30,1,1,2,50.0%,18m
6569,2,BEETLEHORSE,3584,0,0,2,2,0.0%,10m
6576,2,Monochrome,3583,1231,63,50,113,55.8%,5m
6576,2,Sootha,3583,599,60,74,134,44.8%,8m
6576,2,Frogsmaster,3583,832,57,58,115,49.6%,40m
6576,2,pjekosz,3583,1290,49,51,100,49.0%,41m
6576,1,[lOoOl]MaM,3583,233,10,4,14,71.4%,2m
6576,3,KrawczykMPK,3583,166,8,1,9,88.9%,13m
6576,2,Bertie,3583,208,8,4,12,66.7%,7m
6576,2,Ridiko,3583,208,8,11,19,42.1%,5m
6576,2,[RеG]PARSiVal,3583,152,6,6,12,50.0%,4m
6576,1,EFFECT,3583,97,3,6,9,33.3%,3m
6576,2,[WysH]crazymanT,3583,100,3,15,18,16.7%,19m
6576,3,Cibernetic,3583,0,0,1,1,0.0%,3m
6588,2,mustigmust,3582,1399,74,61,135,54.8%,19m
6588,2,Nekoyuki,3582,624,22,28,50,44.0%,18m
6588,3,Strategy,3582,196,11,5,16,68.8%,12m
6588,3,Sabada,3582,215,10,2,12,83.3%,28m
6588,2,rhumkraken,3582,169,6,3,9,66.7%,5m
6588,2,JohnBird,3582,92,4,5,9,44.4%,6m
6588,2,NightKnight,3582,0,1,1,2,50.0%,14m
6588,3,Chip,3582,0,0,1,1,0.0%,16m
6596,2,evilMonkey,3581,1140,107,97,204,52.5%,28m
6596,2,jon,3581,1140,53,42,95,55.8%,13m
6596,2,[mOguy]TheBlue,3581,303,11,12,23,47.8%,3m
6596,2,KrazyKariia,3581,94,5,11,16,31.2%,18m
6596,3,[BellSL]SnorMossel,3581,118,4,3,7,57.1%,3m
6596,3,[WBGA]Rossix,3581,0,1,0,1,100.0%,10m
6596,3,[Glor]Caesar,3581,0,1,0,1,100.0%,28m
6596,3,Pagchomp,3581,30,1,2,3,33.3%,12m
6596,3,Akıncı,3581,0,0,1,1,0.0%,7m
6596,2,[ZERGML]Happy,3581,0,0,2,2,0.0%,6m
6596,3,Scarecrow,3581,0,0,4,4,0.0%,10m
6607,2,ddb,3580,1524,328,310,638,51.4%,8m
6607,2,Norman,3580,996,209,190,399,52.4%,7m
6607,2,Christoph,3580,1561,150,145,295,50.8%,8m
6607,2,Leonidos,3580,1191,79,43,122,64.8%,12m
6607,2,ZmallGuy,3580,402,65,67,132,49.2%,13m
6607,3,WoletarHeri,3580,706,27,27,54,50.0%,3m
6607,2,[UBDH]Ten,3580,340,17,14,31,54.8%,6m
6607,3,Poi,3580,250,9,8,17,52.9%,12m
6607,2,ShooOryuken,3580,218,7,6,13,53.8%,7m
6607,2,Lamelisk,3580,144,6,6,12,50.0%,9m
6607,2,LeCtion,3580,92,3,5,8,37.5%,40m
6607,2,[BadMen]SupremeBeing,3580,0,1,2,3,33.3%,15m
6619,2,Krastanis,3579,1431,249,249,498,50.0%,7m
6619,3,[romes]Niq,3579,1317,180,173,353,51.0%,7m
6619,3,KroN,3579,320,12,6,18,66.7%,3m
6619,2,kivan,3579,214,6,6,12,50.0%,17m
6619,2,[eXøde]powerspike,3579,122,4,8,12,33.3%,18m
6619,2,SigMir,3579,88,1,2,3,33.3%,10m
6619,2,[YMB]Arzann,3579,0,1,3,4,25.0%,17m
6626,2,Pride,3578,1492,166,154,320,51.9%,16m
6626,2,Flusskind,3578,1201,61,42,103,59.2%,19m
6626,2,Chidori,3578,88,5,6,11,45.5%,28m
6626,3,[DoPorn]Sayux,3578,95,2,4,6,33.3%,28m
6626,3,LuckLess,3578,0,1,1,2,50.0%,6m
6626,2,Fryryx,3578,30,1,4,5,20.0%,17m
6626,3,AlexKoz,3578,0,0,1,1,0.0%,16m
6626,3,braintvs,3578,0,0,1,1,0.0%,14m
6634,1,CopyThat,3577,1737,223,233,456,48.9%,11m
6634,2,[BRSKR]PRIME,3577,1405,98,78,176,55.7%,10m
6634,2,OrangeInn,3577,1117,47,41,88,53.4%,13m
6634,2,[pLine]Idwood,3577,150,5,10,15,33.3%,16m
6634,2,[ZoDiep]Raijingeki,3577,116,3,2,5,60.0%,11m
6634,2,[LMBD]llllllllllll,3577,137,2,6,8,25.0%,14m
6634,2,[kB5]jambon,3577,60,2,12,14,14.3%,4m
6634,3,[FFoHM]Footstomp,3577,0,1,0,1,100.0%,26m
6634,3,PzlNoRush,3577,0,1,0,1,100.0%,12m
6634,2,[FTN]Etirion,3577,0,1,1,2,50.0%,19m
6634,2,Kolargolo,3577,0,1,1,2,50.0%,13m
6634,3,[PÂRłAH]Hexed,3577,30,1,1,2,50.0%,16m
6634,2,[dzv3rg]Ifak,3577,30,1,7,8,12.5%,12m
6647,2,RamenKage,3576,1051,180,152,332,54.2%,13m
6647,2,[BornG]levver,3576,954,105,112,217,48.4%,12m
6647,2,WayTooLazy,3576,1471,75,77,152,49.3%,7m
6647,2,[PaniC]Losting,3576,1202,61,52,113,54.0%,6m
6647,2,Bush,3576,1282,59,48,107,55.1%,4m
6647,2,Vasec,3576,418,15,15,30,50.0%,3m
6647,3,NaCl,3576,204,10,11,21,47.6%,19m
6647,2,Khao,3576,150,7,9,16,43.8%,14m
6647,2,[THGbg]Dahaka,3576,62,2,4,6,33.3%,4m
6647,2,Entropy,3576,30,2,8,10,20.0%,3m
6647,2,[KWe]haschy,3576,88,1,2,3,33.3%,10m
6658,2,kju,3575,1544,239,221,460,52.0%,18m
6658,2,Elsen,3575,1556,219,207,426,51.4%,6m
6658,2,karkoss,3575,1290,96,95,191,50.3%,7m
6658,2,Banebust,3575,1542,69,78,147,46.9%,7m
6658,3,VulpesZerda,3575,470,18,11,29,62.1%,28m
6658,2,[Камрад]rimerzerg,3575,310,12,17,29,41.4%,9m
6658,1,ashura,3575,188,8,4,12,66.7%,7m
6658,3,Bubulucu,3575,0,5,0,5,100.0%,8m
6658,1,Mosaïk,3575,48,4,6,10,40.0%,10m
6658,3,[Папик]Хайдекай,3575,0,1,0,1,100.0%,3m
6658,2,[NJSR]BipNJ,3575,30,1,4,5,20.0%,13m
6658,3,[LAVEDE]Zacharias,3575,0,0,1,1,0.0%,19m
6658,3,Rozen,3575,0,0,1,1,0.0%,10m
6658,3,BlackWidow,3575,0,0,1,1,0.0%,18m
6658,2,AzinSalniu,3575,0,0,2,2,0.0%,4m
6673,2,MrW,3574,957,179,155,334,53.6%,7m
6673,2,Rednaxela,3574,1059,42,41,83,50.6%,16m
6673,3,Jeral,3574,530,22,10,32,68.8%,4m
6673,2,[SHcorp]portbagaj,3574,202,7,10,17,41.2%,15m
6673,3,darkforce,3574,145,4,1,5,80.0%,13m
6673,2,Freshmeat,3574,30,2,7,9,22.2%,10m
6673,2,Heisenberg,3574,62,2,8,10,20.0%,41m
6673,2,Sasi,3574,0,1,1,2,50.0%,9m
6673,3,EvilDuck,3574,30,1,1,2,50.0%,8m
6673,2,[TdDm]Minerking,3574,30,1,4,5,20.0%,18m
6673,2,[PunKai]Kaisar,3574,30,1,4,5,20.0%,4m
6673,3,[Pr0xу]MozG,3574,0,0,1,1,0.0%,18m
6685,2,Gopling,3573,409,155,148,303,51.2%,2m
6685,2,Minifutzi,3573,1543,81,78,159,50.9%,7m
6685,2,KingDorm,3573,242,14,5,19,73.7%,6m
6685,1,Basilic,3573,188,4,3,7,57.1%,15m
6685,2,[F3cK]Tynic,3573,86,4,7,11,36.4%,12m
6685,2,SyndrØme,3573,102,2,3,5,40.0%,27m
6685,1,Angesandet,3573,0,0,2,2,0.0%,4m
6692,1,Rohacommand,3572,1722,496,493,989,50.2%,6m
6692,2,Avion,3572,1610,188,176,364,51.6%,15m
6692,2,VblubV,3572,894,61,64,125,48.8%,40m
6692,2,Klitzipetel,3572,1349,55,56,111,49.5%,11m
6692,2,[bisk]Kavinsky,3572,152,4,4,8,50.0%,3m
6692,2,[Kicx]NawaL,3572,128,3,4,7,42.9%,4m
6692,3,ModalSoul,3572,58,2,1,3,66.7%,4m
6692,3,ThePunisher,3572,0,1,0,1,100.0%,8m
6692,2,Meijin,3572,0,0,4,4,0.0%,8m
6701,2,Dream,3571,1301,194,188,382,50.8%,9m
6701,2,[snOr]Fetch,3571,786,53,52,105,50.5%,16m
6701,3,[MERKL]AtilaHiltman,3571,0,3,2,5,60.0%,9m
6701,3,Santa,3571,88,3,3,6,50.0%,17m
6701,2,[OFocus]Gamme,3571,58,3,3,6,50.0%,6m
6701,2,[l7cT]ШТИРЛИЦ,3571,58,3,4,7,42.9%,19m
6701,2,Griker,3571,60,2,6,8,25.0%,6m
6701,3,[Jooooo]PitON,3571,0,1,0,1,100.0%,14m
6701,3,[TAW]FreeZ,3571,0,0,1,1,0.0%,5m
6701,3,Loveismurder,3571,0,0,1,1,0.0%,11m
6701,3,[AI1]VeeRust,3571,0,0,1,1,0.0%,27m
6701,3,Marco,3571,0,0,1,1,0.0%,28m
6701,2,[TGenot]KoningHenk,3571,0,0,4,4,0.0%,6m
6714,2,Guldlock,3570,1388,179,148,327,54.7%,9m
6714,2,Syu,3570,592,26,20,46,56.5%,16m
6714,3,[PKTS]Zekka,3570,58,3,0,3,100.0%,7m
6714,3,[kewl]gnarK,3570,0,1,0,1,100.0%,12m
6714,1,lIIIIlllllIl,3570,0,1,2,3,33.3%,16m
6714,2,LeggerLegger,3570,30,1,3,4,25.0%,40m
6714,3,[ValidG]ArcbostsSimp,3570,0,0,1,1,0.0%,7m
6721,2,Punkkiller,3569,1281,80,68,148,54.1%,27m
6721,2,DarkReaper,3569,1543,70,70,140,50.0%,10m
6721,2,[iMv]Tappsi,3569,1364,68,74,142,47.9%,27m
6721,2,[GoldM]PigeonWrench,3569,784,30,30,60,50.0%,7m
6721,3,tekurb,3569,411,18,9,27,66.7%,19m
6721,2,OldBoy,3569,297,18,26,44,40.9%,9m
6721,2,[xSRx]Bullseye,3569,360,13,20,33,39.4%,28m
6721,3,Washington,3569,0,5,0,5,100.0%,17m
6721,2,[PSlSTC]IntoTheSisu,3569,58,3,3,6,50.0%,41m
6721,3,GucciPoochie,3569,30,2,4,6,33.3%,7m
6721,3,[S06R]Calvados,3569,30,1,1,2,50.0%,14m
6721,3,[Ghоul]deadinside,3569,0,1,1,2,50.0%,7m
6721,2,[YEBAC]ISwarmYouBro,3569,0,1,2,3,33.3%,19m
6721,3,BLEE,3569,0,1,4,5,20.0%,7m
6721,2,[HEHEH]Jericho,3569,0,0,1,1,0.0%,4m
6721,3,Osghiliath,3569,0,0,1,1,0.0%,6m
6721,3,Tbone,3569,0,0,1,1,0.0%,10m
6738,2,GrrrrrreG,3568,1197,209,205,414,50.5%,40m
6738,2,[Snorky]HBA,3568,1599,205,206,411,49.9%,5m
6738,2,[TFSC]mirikashi,3568,1254,148,135,283,52.3%,20m
6738,2,Atlas,3568,1356,103,88,191,53.9%,11m
6738,2,requos,3568,642,36,29,65,55.4%,16m
6738,2,Semmler,3568,575,25,19,44,56.8%,27m
6738,2,DDG,3568,528,19,26,45,42.2%,27m
6738,3,Troglodyte,3568,58,6,1,7,85.7%,15m
6738,2,MrRedder,3568,154,6,8,14,42.9%,16m
6738,2,KralOstruzin,3568,168,6,13,19,31.6%,27m
6738,2,Hakase,3568,122,4,14,18,22.2%,3m
6738,2,KingArthur,3568,114,3,2,5,60.0%,5m
6738,3,Deadlegazy,3568,0,1,0,1,100.0%,4m
6738,3,Ihle,3568,30,1,2,3,33.3%,16m
6738,3,Sidious,3568,0,0,1,1,0.0%,3m
6738,3,[VByen]XelNaga,3568,0,0,1,1,0.0%,27m
6738,3,[SkCzM]Peter,3568,0,0,1,1,0.0%,8m
6755,2,[kuce]retRibution,3567,1539,191,192,383,49.9%,3m
6755,2,broukmoute,3567,1028,122,128,250,48.8%,28m
6755,2,KJBGsalina,3567,469,50,48,98,51.0%,19m
6755,2,Foulplay,3567,208,7,12,19,36.8%,19m
6755,2,Random,3567,115,3,0,3,100.0%,19m
6755,3,[Regret]Arachnid,3567,0,1,0,1,100.0%,18m
6755,3,UrAnus,3567,0,1,0,1,100.0%,18m
6755,3,Rationalist,3567,0,0,1,1,0.0%,10m
6755,3,zzvbm,3567,0,0,1,1,0.0%,15m
6755,3,[TheDOH]Executioner,3567,0,0,1,1,0.0%,27m
6765,2,[CJFF]tafkap,3566,1569,553,548,1101,50.2%,6m
6765,2,TheEngineer,3566,1068,157,142,299,52.5%,10m
6765,2,IMBAorSUCK,3566,1218,72,50,122,59.0%,18m
6765,3,llllllllllll,3566,400,17,10,27,63.0%,6m
6765,2,Liquid,3566,276,9,10,19,47.4%,27m
6765,2,[Oursbl]Kubera,3566,206,7,6,13,53.8%,9m
6765,3,[LawB]NitramVHive,3566,60,3,1,4,75.0%,41m
6765,3,KERBO,3566,0,1,0,1,100.0%,16m
6765,2,[NiN]NiNjadO,3566,0,1,1,2,50.0%,9m
6765,3,Fabolabo,3566,0,0,1,1,0.0%,9m
6765,3,Pikowet,3566,0,0,1,1,0.0%,28m
6765,2,cRYZ,3566,0,0,2,2,0.0%,3m
6765,2,Deadlocked,3566,0,0,4,4,0.0%,13m
6778,2,Azira,3565,1035,222,219,441,50.3%,3m
6778,2,Hurk,3565,1236,56,49,105,53.3%,7m
6778,2,eco,3565,1221,54,66,120,45.0%,40m
6778,3,karen,3565,58,4,3,7,57.1%,14m
6778,3,Burashi,3565,113,4,4,8,50.0%,9m
6778,3,[FrBz]Didi,3565,60,3,2,5,60.0%,10m
6778,2,[ANGRYY]iMPRo,3565,0,3,3,6,50.0%,4m
6778,2,[COOPM]LOCKDOWN,3565,60,3,5,8,37.5%,3m
6778,3,HappySwarm,3565,58,2,2,4,50.0%,10m
6778,3,Sondaljan,3565,0,1,0,1,100.0%,14m
6778,3,Reddhuth,3565,30,1,1,2,50.0%,13m
6778,3,[Traxen]Jiga,3565,0,0,1,1,0.0%,13m
6778,2,AlphaStar,3565,0,0,3,3,0.0%,7m
6791,1,Breizh,3564,1721,188,203,391,48.1%,17m
6791,2,[AnTi]armand,3564,1550,172,174,346,49.7%,28m
6791,2,Zufallsgott,3564,642,27,20,47,57.4%,3m
6791,2,[XiSPoo]NesboCZ,3564,616,25,18,43,58.1%,6m
6791,2,[OPS]LuUoH,3564,431,21,12,33,63.6%,11m
6791,2,Bober,3564,392,14,20,34,41.2%,20m
6791,3,IIIIIIIIIIII,3564,246,13,5,18,72.2%,4m
6791,2,[bitoQ2]Sazzaro,3564,311,9,12,21,42.9%,3m
6791,3,Rocky,3564,0,3,2,5,60.0%,10m
6791,2,chrząszcz,3564,96,3,5,8,37.5%,17m
6791,3,Celenos,3564,0,1,0,1,100.0%,26m
6791,3,RaijiN,3564,0,1,0,1,100.0%,16m
6791,1,[WGPL]marine,3564,97,1,5,6,16.7%,3m
6804,2,[DZTK]SuFu,3563,1568,309,280,589,52.5%,9m
6804,2,mrGame,3563,1599,273,276,549,49.7%,15m
6804,2,Fortis,3563,633,125,112,237,52.7%,3m
6804,2,JOCKER,3563,605,23,23,46,50.0%,4m
6804,2,Tude,3563,300,9,11,20,45.0%,6m
6804,2,Benzy,3563,266,9,14,23,39.1%,20m
6804,2,DABO,3563,162,8,2,10,80.0%,3m
6804,3,dodop,3563,142,5,5,10,50.0%,3m
6804,2,Probe,3563,128,4,3,7,57.1%,9m
6804,2,[РУИНА]ГȆЛȆТРȌН,3563,60,2,12,14,14.3%,7m
6804,3,Kaldir,3563,0,1,0,1,100.0%,7m
6804,2,Atoms,3563,0,1,11,12,8.3%,20m
6804,3,Blick,3563,0,0,1,1,0.0%,3m
6804,3,[Xa]IlCremo,3563,0,0,2,2,0.0%,15m
6818,2,kishill,3562,1536,357,344,701,50.9%,3m
6818,2,[PogC]Omni,3562,847,167,182,349,47.9%,11m
6818,2,CrazyDiamond,3562,760,165,147,312,52.9%,7m
6818,3,[TSEuro]FetterHobbit,3562,1663,79,72,151,52.3%,18m
6818,2,[42О]DMT,3562,1446,57,55,112,50.9%,6m
6818,2,TrueRandom,3562,815,37,30,67,55.2%,18m
6818,3,Crucial,3562,484,21,11,32,65.6%,3m
6818,2,[isIMBA]Riko,3562,241,8,9,17,47.1%,16m
6818,3,fischeye,3562,128,7,6,13,53.8%,3m
6818,3,[Brgman]TritZiu,3562,86,4,2,6,66.7%,14m
6818,3,Artos,3562,60,4,4,8,50.0%,14m
6818,2,Slayd,3562,86,3,6,9,33.3%,16m
6818,3,[MCPs]FeeZz,3562,58,2,3,5,40.0%,6m
6818,3,[G4MBLE]Cedd,3562,30,1,3,4,25.0%,41m
6818,3,[Skills]SpurvL,3562,0,0,1,1,0.0%,19m
6818,3,eVo,3562,0,0,1,1,0.0%,16m
6818,3,[theDH]Singo,3562,0,0,2,2,0.0%,7m
6835,2,kira,3561,1512,181,170,351,51.6%,4m
6835,2,Sova,3561,1564,65,59,124,52.4%,3m
6835,3,Auri,3561,1501,63,44,107,58.9%,7m
6835,2,VaeVictis,3561,1560,63,60,123,51.2%,6m
6835,3,GreatPeople,3561,1156,48,34,82,58.5%,18m
6835,2,JimmYty,3561,778,38,32,70,54.3%,27m
6835,2,[LNGBRR]jibbmn,3561,412,22,14,36,61.1%,11m
6835,2,Perserence,3561,382,18,20,38,47.4%,28m
6835,2,[4LG]Husefugel,3561,306,10,15,25,40.0%,19m
6835,2,ByronSully,3561,242,9,15,24,37.5%,7m
6835,1,LingKing,3561,110,5,3,8,62.5%,11m
6835,2,[BjwA]tisomi,3561,88,1,3,4,25.0%,13m
6835,2,Baris,3561,30,1,8,9,11.1%,13m
6835,3,[messys]TheKid,3561,0,0,2,2,0.0%,4m
6835,2,Awkward,3561,0,0,6,6,0.0%,5m
6850,2,gitn,3560,870,69,52,121,57.0%,8m
6850,3,Standby,3560,516,20,16,36,55.6%,10m
6850,2,JBONE,3560,380,14,17,31,45.2%,9m
6850,3,hiMelnikov,3560,181,8,0,8,100.0%,13m
6850,3,MaDFroG,3560,165,6,3,9,66.7%,13m
6850,2,AleX,3560,154,6,13,19,31.6%,28m
6850,2,MrTwiISTeR,3560,190,5,6,11,45.5%,10m
6850,2,[CОS]SeV,3560,126,5,7,12,41.7%,6m
6850,3,Fokusnik,3560,118,4,4,8,50.0%,11m
6850,3,llllllllllll,3560,42,3,2,5,60.0%,13m
6850,2,Lyuganok,3560,142,2,3,5,40.0%,19m
6850,2,Sharp,3560,58,2,5,7,28.6%,8m
6850,2,[SWWT]Papa,3560,0,1,10,11,9.1%,15m
6850,3,Erator,3560,0,0,1,1,0.0%,18m
6850,3,[AXG]AXǂArkeonis,3560,0,0,2,2,0.0%,18m
6850,3,KRom,3560,0,0,2,2,0.0%,3m
6866,2,llllllllllll,3559,1391,147,143,290,50.7%,3m
6866,1,Nano,3559,1720,142,153,295,48.1%,14m
6866,3,[BUGZ]zPǃCereb,3559,832,36,25,61,59.0%,28m
6866,2,LoleMonster,3559,720,31,23,54,57.4%,16m
6866,3,MuZzY,3559,659,26,23,49,53.1%,27m
6866,2,[aW]ZphiR,3559,476,20,16,36,55.6%,15m
6866,2,Anathema,3559,337,17,16,33,51.5%,16m
6866,2,mikrOguy,3559,382,14,20,34,41.2%,12m
6866,3,Algoma,3559,250,10,5,15,66.7%,5m
6866,2,[RioF]Barcode,3559,246,8,14,22,36.4%,7m
6866,3,Sibylle,3559,30,6,0,6,100.0%,7m
6866,3,Eledion,3559,86,4,0,4,100.0%,3m
6866,3,[YSB]Facebreaker,3559,30,1,1,2,50.0%,15m
6866,3,[Krasty]NAkiddo,3559,0,1,1,2,50.0%,9m
6866,2,DiBBuK,3559,30,1,5,6,16.7%,6m
6866,3,MrCivilised,3559,0,0,1,1,0.0%,3m
6866,2,[CxLxP]Ƶøŕҟ,3559,0,0,1,1,0.0%,8m
6866,2,[зерно]rrRamilka,3559,0,0,4,4,0.0%,7m
6866,2,Bistry,3559,0,0,4,4,0.0%,28m
6885,2,Gritoni,3558,1573,293,295,588,49.8%,5m
6885,1,[EESC]KempachiZara,3558,1534,223,249,472,47.2%,4m
6885,2,ART,3558,1561,78,74,152,51.3%,14m
6885,2,MehdiM,3558,936,33,41,74,44.6%,5m
6885,2,[Hаsu]Airi,3558,602,22,28,50,44.0%,15m
6885,2,soO,3558,370,13,18,31,41.9%,9m
6885,1,SixPooL,3558,249,8,2,10,80.0%,18m
6885,3,[DaB]Mint,3558,58,3,0,3,100.0%,28m
6885,2,JeanMax,3558,88,3,9,12,25.0%,6m
6885,2,Jogor,3558,30,2,3,5,40.0%,3m
6885,2,KingOfQueens,3558,0,1,2,3,33.3%,18m
6885,3,[ULTX]Apolcalpyse,3558,30,1,2,3,33.3%,4m
6885,3,[Blacer]BleakLord,3558,0,0,1,1,0.0%,14m
6898,3,Garlic,3557,525,57,51,108,52.8%,28m
6898,2,HenryLee,3557,1129,49,48,97,50.5%,7m
6898,2,zenTAR,3557,620,22,28,50,44.0%,6m
6898,2,[RIBERY]Gibzz,3557,181,7,8,15,46.7%,27m
6898,2,[TaKeUL]Satalko,3557,204,7,12,19,36.8%,4m
6898,3,Los,3557,116,5,3,8,62.5%,12m
6898,3,[ArShrk]SharKMouZ,3557,97,1,3,4,25.0%,3m
6898,3,[соv19]GrenaderKA,3557,0,0,1,1,0.0%,12m
6898,3,IIIIIIIIIIII,3557,0,0,2,2,0.0%,6m
6907,2,[LGNxEU]Attrition,3556,1523,220,205,425,51.8%,5m
6907,2,[LQR]priZon,3556,1223,58,40,98,59.2%,41m
6907,2,CheekClapper,3556,393,13,23,36,36.1%,19m
6907,2,[BSK88]Mostar,3556,175,9,13,22,40.9%,3m
6907,1,Ozzy,3556,233,7,3,10,70.0%,11m
6907,2,Flade,3556,102,3,3,6,50.0%,6m
6907,3,olanobnor,3556,0,1,0,1,100.0%,15m
6907,3,Forsaken,3556,0,0,1,1,0.0%,5m
6907,3,Evilswarm,3556,0,0,1,1,0.0%,20m
6916,2,[oneA]Chimptacular,3555,1514,234,243,477,49.1%,3m
6916,2,Foley,3555,807,192,178,370,51.9%,7m
6916,1,BeefITek,3555,1707,156,165,321,48.6%,12m
6916,2,EmptyFridge,3555,307,41,35,76,53.9%,9m
6916,2,[DEDAL]Glutek,3555,605,28,20,48,58.3%,9m
6916,2,Rainbow,3555,516,19,19,38,50.0%,17m
6916,3,[PŖïMĄŁ]Rio,3555,86,4,4,8,50.0%,20m
6916,2,[GZC]Epsilon,3555,79,1,3,4,25.0%,12m
6916,2,McSweetness,3555,88,1,3,4,25.0%,20m
6916,3,WhiteSocks,3555,0,0,1,1,0.0%,8m
6916,3,[oooboy]firetime,3555,0,0,1,1,0.0%,12m
6916,2,mimo,3555,0,0,3,3,0.0%,6m
6928,2,KOHHOP,3554,665,45,41,86,52.3%,19m
6928,2,RaZak,3554,363,13,13,26,50.0%,5m
6928,2,[HBeS]Zabura,3554,271,12,11,23,52.2%,16m
6928,3,[StarTw]NaxDu,3554,300,10,12,22,45.5%,20m
6928,3,Potaufeu,3554,220,8,6,14,57.1%,13m
6928,2,CaptainStive,3554,176,7,8,15,46.7%,26m
6928,2,[Galois]DocSnyder,3554,214,7,12,19,36.8%,6m
6928,3,Cygnus,3554,142,6,2,8,75.0%,12m
6928,2,[Obm]Xerafinapat,3554,190,6,6,12,50.0%,6m
6928,3,hitmenas,3554,176,6,8,14,42.9%,3m
6928,1,zarsy,3554,135,5,1,6,83.3%,41m
6928,3,Rasmus,3554,60,2,3,5,40.0%,13m
6928,3,TesTyVexX,3554,0,1,0,1,100.0%,3m
6928,1,Villetta,3554,0,1,1,2,50.0%,4m
6928,3,southwave,3554,0,1,1,2,50.0%,9m
6928,2,BeTa,3554,0,1,2,3,33.3%,7m
6928,3,BramTon,3554,0,0,1,1,0.0%,7m
6928,3,[Heroes]Chris,3554,0,0,2,2,0.0%,27m
6946,3,Bnaan,3553,1613,194,169,363,53.4%,3m
6946,2,SCommander,3553,700,82,82,164,50.0%,28m
6946,3,magnum,3553,686,30,20,50,60.0%,7m
6946,1,[EmŦ]Sirio,3553,674,20,37,57,35.1%,9m
6946,2,Medeni,3553,538,19,22,41,46.3%,3m
6946,3,Voltio,3553,312,14,6,20,70.0%,41m
6946,2,Farce,3553,30,1,4,5,20.0%,5m
6946,2,Laroi,3553,30,1,4,5,20.0%,5m
6954,1,krajek,3552,1697,500,481,981,51.0%,10m
6954,2,[FXB1]Bosancero,3552,1555,279,245,524,53.2%,19m
6954,2,[3KFC]Fliewatüüt,3552,1218,120,105,225,53.3%,28m
6954,1,SleepOnMic,3552,1312,85,104,189,45.0%,14m
6954,2,Latulipe,3552,1010,47,32,79,59.5%,9m
6954,3,GeileJenny,3552,463,29,14,43,67.4%,26m
6954,2,KirOndi,3552,448,25,34,59,42.4%,11m
6954,2,Mazzader,3552,446,15,15,30,50.0%,7m
6954,2,[BiDC]Cooper,3552,444,15,28,43,34.9%,3m
6954,2,RaenTorgon,3552,236,11,12,23,47.8%,3m
6954,2,LEBONCARLOS,3552,178,6,8,14,42.9%,8m
6954,2,[SmackB]Confrot,3552,88,4,6,10,40.0%,15m
6954,2,GrillY,3552,88,3,6,9,33.3%,7m
6954,3,ghOzt,3552,30,2,1,3,66.7%,10m
6954,3,[OK238]HeartcorE,3552,0,1,0,1,100.0%,3m
6954,3,[JustFF]Itarossa,3552,0,1,0,1,100.0%,10m
6954,2,BigP,3552,0,1,0,1,100.0%,4m
6954,3,[SL]Strøm,3552,30,1,1,2,50.0%,14m
6954,3,Feierabend,3552,30,1,1,2,50.0%,11m
6954,1,PainAuMiel,3552,0,0,1,1,0.0%,19m
6974,2,[eklig]BlaXXuN,3551,1629,174,188,362,48.1%,3m
6974,2,[FRERO]atchalak,3551,662,51,44,95,53.7%,10m
6974,3,RilKa,3551,785,43,23,66,65.2%,28m
6974,2,Dodjyz,3551,934,31,43,74,41.9%,10m
6974,2,JOJO,3551,466,15,24,39,38.5%,16m
6974,3,IIIIIIIIIIII,3551,277,13,5,18,72.2%,6m
6974,2,KrAuti,3551,190,6,18,24,25.0%,16m
6974,3,Aleke,3551,137,5,2,7,71.4%,10m
6974,3,[DFgs]spacesurgeon,3551,86,4,1,5,80.0%,28m
6974,3,Gubbelstar,3551,58,3,3,6,50.0%,4m
6974,3,[DT11]BoBo,3551,88,3,4,7,42.9%,14m
6974,3,[Bidjo]Den,3551,30,2,1,3,66.7%,11m
6974,3,[lLiTl]RyManTM,3551,0,1,0,1,100.0%,7m
6974,3,Orcinus,3551,0,0,1,1,0.0%,3m
6974,3,[Gandza]Apple,3551,0,0,2,2,0.0%,7m
6989,2,Ave,3550,1566,122,109,231,52.8%,16m
6989,3,Theffz,3550,1220,85,75,160,53.1%,19m
6989,2,[KG312]Sonkei,3550,312,13,8,21,61.9%,4m
6989,1,Leto,3550,241,6,6,12,50.0%,10m
6989,2,MrDont,3550,144,6,9,15,40.0%,6m
6989,3,saturn,3550,86,3,5,8,37.5%,41m
6989,3,[DumpD]MTS,3550,30,2,0,2,100.0%,5m
6989,3,Cheerio,3550,0,1,1,2,50.0%,7m
6989,3,CadvanLeven,3550,30,1,2,3,33.3%,5m
6989,3,ПоедательМаМ,3550,30,1,3,4,25.0%,3m
6989,3,[F2ACLK]Misstress,3550,0,0,1,1,0.0%,3m
6989,3,BipBip,3550,0,0,1,1,0.0%,3m
7001,2,OneMoreTime,3549,1551,421,405,826,51.0%,27m
7001,2,Leor,3549,1625,97,96,193,50.3%,11m
7001,3,Joke,3549,312,14,8,22,63.6%,15m
7001,3,Kotvič,3549,268,11,3,14,78.6%,19m
7001,2,DasSosh,3549,141,6,2,8,75.0%,14m
7001,2,LuckLess,3549,178,5,6,11,45.5%,9m
7001,3,BINI,3549,60,3,1,4,75.0%,28m
7001,2,MIRims,3549,114,3,3,6,50.0%,7m
7009,2,MirM,3548,1161,72,69,141,51.1%,7m
7009,2,[lkub]Brifie,3548,1070,42,42,84,50.0%,11m
7009,2,[ixixi]maxikraxi,3548,579,22,22,44,50.0%,6m
7009,2,Patrol,3548,584,22,25,47,46.8%,7m
7009,2,[s182]Varax,3548,368,12,16,28,42.9%,28m
7009,3,KraKen,3548,0,5,0,5,100.0%,7m
7009,3,[RbF]Neon,3548,114,4,1,5,80.0%,16m
7009,3,Devolhan,3548,0,1,0,1,100.0%,3m
7017,2,[NGJ]OverNice,3547,1431,92,71,163,56.4%,16m
7017,2,Casanova,3547,1322,50,56,106,47.2%,4m
7017,3,[1ndica]ZerO,3547,150,11,6,17,64.7%,5m
7017,2,Poelie,3547,262,8,9,17,47.1%,17m
7017,1,SjeveBurger,3547,240,6,32,38,15.8%,7m
7017,3,Donkrawallo,3547,0,5,0,5,100.0%,10m
7017,2,Empire,3547,120,5,7,12,41.7%,11m
7017,3,[WLLH]FragHeal,3547,0,1,0,1,100.0%,8m
7017,3,klappi,3547,30,1,2,3,33.3%,19m
7026,2,[Paka]Paka,3546,1553,638,631,1269,50.3%,13m
7026,2,suprBixlov,3546,1196,57,52,109,52.3%,27m
7026,2,Bioman,3546,162,5,17,22,22.7%,16m
7026,3,[BR0DER]Atravir,3546,58,2,2,4,50.0%,17m
7026,3,[XGRX]SurtR,3546,30,1,4,5,20.0%,28m
7026,3,Tank,3546,0,0,1,1,0.0%,10m
7026,3,[SSgF]Wildjäger,3546,0,0,1,1,0.0%,26m
7033,3,SIKN,3545,1172,51,36,87,58.6%,6m
7033,3,Monochrome,3545,717,30,23,53,56.6%,18m
7033,2,[DT974]Malo,3545,625,24,24,48,50.0%,4m
7033,2,[NG0ld]CarryPotter,3545,412,22,11,33,66.7%,6m
7033,2,Ramutra,3545,478,18,18,36,50.0%,26m
7033,3,[ValidG]JackMcKwack,3545,264,10,9,19,52.6%,3m
7033,3,[STDES]Gerwill,3545,90,3,4,7,42.9%,13m
7033,3,[UAŦeam]Adventurer,3545,30,2,0,2,100.0%,28m
7033,3,zez,3545,30,1,2,3,33.3%,13m
7033,3,IceCreaM,3545,0,0,1,1,0.0%,17m
7033,3,[lThEl]Babu,3545,0,0,1,1,0.0%,15m
7044,2,Lagunas,3544,1523,388,361,749,51.8%,16m
7044,3,[RSGANG]REDSKY,3544,1634,127,102,229,55.5%,17m
7044,2,VladmirPutin,3544,871,62,71,133,46.6%,28m
7044,2,[SO0S]Roxxas,3544,390,15,18,33,45.5%,9m
7044,3,BloodSerum,3544,266,11,3,14,78.6%,8m
7044,3,Gozal,3544,211,8,4,12,66.7%,3m
7044,3,[Sircho]Toron,3544,0,5,0,5,100.0%,27m
7044,3,Wombo,3544,0,5,0,5,100.0%,14m
7044,1,[KDV]WARIAT,3544,127,4,2,6,66.7%,28m
7044,2,Ksanch,3544,60,2,4,6,33.3%,10m
7044,3,[сSсǃ]NaJi,3544,62,2,5,7,28.6%,41m
7044,3,[Losira]PeRF,3544,0,1,2,3,33.3%,14m
7044,3,[WeATS]IvipIZerg,3544,0,0,1,1,0.0%,18m
7057,2,mishash,3543,1567,184,183,367,50.1%,19m
7057,2,Jax,3543,467,22,29,51,43.1%,7m
7057,2,kyle,3543,449,18,15,33,54.5%,19m
7057,3,llllllllllll,3543,226,11,8,19,57.9%,3m
7057,2,[Shirе]Frodo,3543,169,5,7,12,41.7%,16m
7057,3,[K0mpis]pelleplutt,3543,114,4,2,6,66.7%,41m
7057,1,[McFly]Luke,3543,162,4,2,6,66.7%,16m
7057,2,Saliwald,3543,0,3,3,6,50.0%,18m
7057,2,[Prima]Majoren,3543,92,3,8,11,27.3%,3m
7057,2,JinJaeJeong,3543,44,2,0,2,100.0%,6m
7057,2,Zekri,3543,88,2,3,5,40.0%,13m
7057,2,isak,3543,102,2,4,6,33.3%,16m
7069,2,[0BO]Barbarossa,3542,1341,70,65,135,51.9%,6m
7069,2,SuperSnail,3542,1293,52,47,99,52.5%,18m
7069,2,Shuya,3542,318,36,29,65,55.4%,19m
7069,2,Зпалки,3542,940,35,35,70,50.0%,13m
7069,3,Swee,3542,452,16,15,31,51.6%,16m
7069,3,thecrazyone,3542,322,14,7,21,66.7%,14m
7069,3,zhooche,3542,58,5,0,5,100.0%,3m
7069,3,Chokapiko,3542,142,5,4,9,55.6%,8m
7069,3,Евгений,3542,60,3,2,5,60.0%,9m
7069,3,webster,3542,0,1,1,2,50.0%,28m
7069,3,Staszee,3542,0,0,1,1,0.0%,3m
7069,3,[JDUNEZ]petrovich,3542,0,0,2,2,0.0%,11m
7081,3,SarXon,3541,406,45,28,73,61.6%,18m
7081,2,Mimistra,3541,702,35,44,79,44.3%,11m
7081,2,[IX9TH]Deidara,3541,174,6,9,15,40.0%,6m
7081,2,reDeem,3541,102,2,4,6,33.3%,19m
7081,3,NadMozg,3541,0,1,0,1,100.0%,18m
7086,1,Perserus,3540,1297,252,248,500,50.4%,6m
7086,2,[SSC2]mszerg,3540,1580,182,180,362,50.3%,13m
7086,3,Prayer,3540,1593,170,156,326,52.1%,11m
7086,2,[HBGSJR]Bayash,3540,827,36,39,75,48.0%,27m
7086,3,radschko,3540,622,23,21,44,52.3%,19m
7086,2,Fartosis,3540,175,16,14,30,53.3%,40m
7086,2,Nexvos,3540,304,10,22,32,31.2%,28m
7086,3,[FloF]methadream,3540,0,1,0,1,100.0%,16m
7086,2,Seub,3540,0,1,3,4,25.0%,15m
7095,2,llllllllllll,3539,1399,635,648,1283,49.5%,11m
7095,2,DedMazai,3539,1473,318,303,621,51.2%,9m
7095,2,[TLBK]Nightly,3539,1252,283,280,563,50.3%,15m
7095,2,Oberyn,3539,1536,68,65,133,51.1%,3m
7095,3,GABBER,3539,837,41,14,55,74.5%,13m
7095,2,RainbowJeZ,3539,776,24,43,67,35.8%,15m
7095,3,[MILOS]Dream,3539,284,10,9,19,52.6%,7m
7095,3,ColdSeadling,3539,0,5,0,5,100.0%,26m
7095,3,[tMnrd]Inteon,3539,60,3,2,5,60.0%,19m
7095,2,[orKs]SainTFirE,3539,0,1,1,2,50.0%,17m
7095,3,kkkk,3539,0,0,1,1,0.0%,16m
7106,3,[AciNoN]Ambrella,3538,1122,63,58,121,52.1%,9m
7106,2,[Pulpo]Doshik,3538,680,25,28,53,47.2%,16m
7106,2,Zerko,3538,270,10,9,19,52.6%,20m
7106,3,ThunderDCDT,3538,0,5,0,5,100.0%,3m
7106,2,Cantrix,3538,60,2,7,9,22.2%,27m
7106,3,[aW]LeteshnekTV,3538,30,1,2,3,33.3%,4m
7112,3,[JCLM]Eze,3537,1636,114,108,222,51.4%,18m
7112,3,Relax,3537,1668,102,86,188,54.3%,14m
7112,3,[CRIMP]iZnoGouD,3537,352,15,4,19,78.9%,4m
7112,2,robIIbo,3537,397,15,17,32,46.9%,17m
7112,3,Dannie,3537,327,11,7,18,61.1%,16m
7112,2,[WCKYLN]Mootek,3537,273,11,9,20,55.0%,7m
7112,3,VeSnA,3537,254,10,9,19,52.6%,26m
7112,3,[BNest]LoneWolf,3537,114,5,2,7,71.4%,7m
7112,3,[Blacer]Fentera,3537,0,1,0,1,100.0%,19m
7112,3,[scam0]UnoCarb,3537,0,1,0,1,100.0%,8m
7112,3,Handofanver,3537,0,1,0,1,100.0%,8m
7112,3,Houdini,3537,30,1,2,3,33.3%,8m
7112,3,TIMEX,3537,0,0,1,1,0.0%,16m
7125,2,[IVEI]lock,3536,1541,229,222,451,50.8%,16m
7125,2,mingo,3536,1542,121,105,226,53.5%,9m
7125,2,kiri,3536,1576,77,71,148,52.0%,3m
7125,3,Marshall,3536,298,13,9,22,59.1%,8m
7125,3,Silent,3536,262,11,8,19,57.9%,6m
7125,3,huakrung,3536,58,3,6,9,33.3%,12m
7125,3,White,3536,58,2,4,6,33.3%,7m
7125,2,maBrag,3536,88,1,4,5,20.0%,10m
7133,2,Nonshlen,3535,1546,176,169,345,51.0%,3m
7133,2,mod,3535,1029,146,136,282,51.8%,7m
7133,3,Keras,3535,1539,138,104,242,57.0%,9m
7133,3,Drahas,3535,1639,94,83,177,53.1%,18m
7133,3,[MBK]Mikami,3535,672,27,20,47,57.4%,7m
7133,2,[FreeN]Lamorra,3535,439,20,25,45,44.4%,6m
7133,2,Jeremayyye,3535,462,17,22,39,43.6%,19m
7133,2,Cormorant,3535,194,9,10,19,47.4%,10m
7133,2,[SNHonk]Fluffy,3535,284,9,12,21,42.9%,10m
7133,3,DuckBZH,3535,174,7,6,13,53.8%,15m
7133,3,IMYourFather,3535,0,5,0,5,100.0%,27m
7133,3,Mpq,3535,168,5,2,7,71.4%,3m
7133,3,[FKSD]ApachinoW,3535,30,2,3,5,40.0%,3m
7133,3,Darker,3535,0,2,3,5,40.0%,4m
7133,2,[PTLc]Keiga,3535,114,2,5,7,28.6%,8m
7133,3,[PLA2N]Quark,3535,30,1,2,3,33.3%,27m
7133,3,Scherby,3535,0,0,1,1,0.0%,26m
7133,3,zempar,3535,0,0,1,1,0.0%,28m
7133,2,ZeeLow,3535,0,0,3,3,0.0%,14m
7152,2,DaMs,3534,882,32,38,70,45.7%,28m
7152,2,partial,3534,277,15,8,23,65.2%,3m
7152,3,KillerQueen,3534,340,13,12,25,52.0%,7m
7152,1,Parazetamol,3534,188,11,5,16,68.8%,28m
7152,3,[mazter]benjamin,3534,240,10,9,19,52.6%,19m
7152,3,Randomdude,3534,120,4,4,8,50.0%,5m
7152,3,CBuckington,3534,30,1,2,3,33.3%,3m
7152,3,[CocoCo]BlackHawk,3534,0,0,1,1,0.0%,3m
7152,3,[Dupie]Chosen,3534,0,0,1,1,0.0%,3m
7152,3,[ThC2]Odin,3534,0,0,1,1,0.0%,8m
7152,3,nani,3534,0,0,1,1,0.0%,9m
7163,2,Jesus,3533,795,96,95,191,50.3%,15m
7163,2,Woocash,3533,1103,71,71,142,50.0%,13m
7163,3,Hellkaon,3533,1119,54,40,94,57.4%,13m
7163,3,[GhFr]iGIVcz,3533,58,3,0,3,100.0%,14m
7163,3,[Swaagy]MelchChue,3533,86,3,5,8,37.5%,3m
7163,3,[R3IGN]SkyBoiii,3533,0,1,0,1,100.0%,6m
7163,3,NerfZergPLZ,3533,0,1,0,1,100.0%,13m
7163,3,HumaJay,3533,0,1,1,2,50.0%,17m
7163,2,[xFUD]Darline,3533,0,1,3,4,25.0%,16m
7163,1,LazyProbe,3533,0,0,1,1,0.0%,5m
7163,3,[HẹṚø]ỈṣḣøẊ,3533,0,0,2,2,0.0%,14m
7174,3,Grez,3532,1628,174,159,333,52.3%,18m
7174,2,[aW]Herigo,3532,485,48,38,86,55.8%,10m
7174,3,Maks,3532,535,23,24,47,48.9%,11m
7174,3,cLoTHeRFieLd,3532,86,7,0,7,100.0%,41m
7174,2,MoS,3532,140,4,4,8,50.0%,27m
7174,3,[nGsǂ]Frigira,3532,0,0,1,1,0.0%,10m
7174,3,DumpyPaggy,3532,0,0,1,1,0.0%,12m
7174,3,[KoyBee]McButtFace,3532,0,0,1,1,0.0%,5m
7182,2,Agentum,3531,1617,193,174,367,52.6%,3m
7182,2,Gamblesock,3531,1500,99,108,207,47.8%,28m
7182,2,BarToLameY,3531,1352,48,56,104,46.2%,9m
7182,2,[DTCSMB]FaKeW,3531,252,13,5,18,72.2%,19m
7182,3,[JAPSE]SóuL,3531,223,11,5,16,68.8%,13m
7182,2,SBSxDeepDown,3531,278,10,10,20,50.0%,3m
7182,3,[Kjeks]Triaz,3531,0,5,0,5,100.0%,17m
7182,2,[InBri]Fedor,3531,60,3,6,9,33.3%,3m
7182,2,[SuSoR]Haudich,3531,92,3,7,10,30.0%,13m
7182,3,[BORODA]Krang,3531,30,1,1,2,50.0%,9m
7182,3,[PLA2N]MoyaPrelest,3531,0,1,4,5,20.0%,18m
7182,3,ХитрыйКраб,3531,0,0,1,1,0.0%,10m
7194,2,anuscleaner,3530,1470,80,78,158,50.6%,12m
7194,2,Yarnero,3530,867,45,57,102,44.1%,6m
7194,2,[S0fP]Koriander,3530,459,37,27,64,57.8%,13m
7194,3,higlhf,3530,228,8,11,19,42.1%,14m
7194,2,Cloudas,3530,224,8,15,23,34.8%,10m
7194,3,TempoJezus,3530,0,5,0,5,100.0%,8m
7194,2,[DwDw]Dworak,3530,92,3,11,14,21.4%,6m
7194,3,IlIlIlIlIlIl,3530,0,1,1,2,50.0%,17m
7194,2,RawrXD,3530,88,1,4,5,20.0%,10m
7194,3,Hydra,3530,0,1,5,6,16.7%,19m
7204,2,PozitiF,3529,1590,360,361,721,49.9%,13m
7204,2,Carbonrazor,3529,1276,286,274,560,51.1%,3m
7204,3,Arnolin,3529,719,97,92,189,51.3%,26m
7204,2,TossIsZeroIQ,3529,756,77,76,153,50.3%,13m
7204,2,IIIIIIIIIIII,3529,346,33,33,66,50.0%,41m
7204,3,SiNeaTeR,3529,252,10,7,17,58.8%,10m
7204,2,Wanderfalke,3529,96,1,8,9,11.1%,3m
7204,3,WiLo,3529,0,0,1,1,0.0%,18m
7204,3,TrumSpid,3529,0,0,1,1,0.0%,6m
7204,3,[Oudill]WesC,3529,0,0,3,3,0.0%,7m
7214,2,Kicknick,3528,1543,136,144,280,48.6%,28m
7214,2,Congo,3528,958,68,72,140,48.6%,15m
7214,2,tahmias,3528,362,18,11,29,62.1%,12m
7214,3,[iOwnU]ImbaLJ,3528,422,17,10,27,63.0%,13m
7214,3,FunkY,3528,361,16,7,23,69.6%,5m
7214,2,[CrøkeT]ElGropor,3528,378,15,12,27,55.6%,4m
7214,3,DrGlibber,3528,286,14,13,27,51.9%,4m
7214,3,llllllllllll,3528,172,7,5,12,58.3%,3m
7214,2,[BabG]Arkisto,3528,167,5,7,12,41.7%,6m
7214,3,[7BINKS]ZYON,3528,116,4,4,8,50.0%,18m
7214,3,Sorgen,3528,0,0,1,1,0.0%,11m
7214,2,NodfiX,3528,0,0,5,5,0.0%,10m
7226,2,BorN,3527,1118,48,39,87,55.2%,11m
7226,3,TGofhu,3527,273,42,40,82,51.2%,15m
7226,2,VinieV,3527,941,37,46,83,44.6%,12m
7226,2,KronosǂIconz,3527,481,24,17,41,58.5%,6m
7226,3,MannerUp,3527,286,14,8,22,63.6%,14m
7226,3,Chivs,3527,218,8,6,14,57.1%,5m
7226,3,Zugzwang,3527,88,4,1,5,80.0%,10m
7226,3,Asbjörn,3527,58,3,0,3,100.0%,14m
7226,2,daffy,3527,58,2,6,8,25.0%,41m
7226,3,[TENRIX]Darktherion,3527,0,1,0,1,100.0%,3m
7226,3,DeepSnow,3527,0,1,0,1,100.0%,4m
7226,3,[INAE]Sketcher,3527,30,1,3,4,25.0%,41m
7226,3,[TAW]RSN,3527,0,0,3,3,0.0%,3m
7239,3,Cerion,3526,1610,227,217,444,51.1%,14m
7239,2,zerGGame,3526,1093,200,180,380,52.6%,16m
7239,1,innoxiouss,3526,1005,105,122,227,46.3%,6m
7239,2,tRex,3526,1588,104,95,199,52.3%,3m
7239,2,UShadow,3526,614,22,25,47,46.8%,19m
7239,2,monarch,3526,138,12,29,41,29.3%,9m
7239,3,AaLR,3526,114,5,6,11,45.5%,11m
7239,3,[ggGGwp]VoidRay,3526,144,5,6,11,45.5%,15m
7239,3,[FxL]Sanda,3526,114,4,4,8,50.0%,28m
7239,2,[HTR57]Bölzer,3526,128,4,6,10,40.0%,10m
7239,1,[IDLK]Jereem,3526,48,2,0,2,100.0%,4m
7239,3,[Scr3d]Cerealkiller,3526,60,2,3,5,40.0%,7m
7239,3,Ferox,3526,0,1,2,3,33.3%,7m
7239,3,Ripper,3526,0,0,1,1,0.0%,3m
7239,3,Escoreal,3526,0,0,1,1,0.0%,5m
7239,3,[НасРат]Port,3526,0,0,1,1,0.0%,16m
7239,3,Tassaddar,3526,0,0,2,2,0.0%,41m
7256,2,PausePeco,3525,1407,98,100,198,49.5%,7m
7256,2,papidipupi,3525,833,69,67,136,50.7%,12m
7256,2,[hufter]Luxus,3525,818,29,36,65,44.6%,11m
7256,2,IIIIIIIIIIII,3525,434,26,27,53,49.1%,20m
7256,3,[DBdW]Penizhaubize,3525,336,15,12,27,55.6%,7m
7256,3,DorianOne,3525,0,0,1,1,0.0%,10m
7256,3,пифпафУточка,3525,0,0,1,1,0.0%,7m
7263,3,[Sw0rm]DRsloper,3524,1574,91,77,168,54.2%,18m
7263,3,Glenn,3524,1282,80,85,165,48.5%,8m
7263,2,[Sc2Owl]Metaspace,3524,914,44,40,84,52.4%,27m
7263,2,[TDCHK]Croustigrou,3524,766,27,33,60,45.0%,15m
7263,3,Dmitryb,3524,492,20,10,30,66.7%,18m
7263,2,ZergAbuse,3524,122,4,15,19,21.1%,3m
7263,3,extremebenny,3524,58,3,1,4,75.0%,6m
7263,3,[RiiiP]Fouki,3524,30,2,2,4,50.0%,14m
7263,3,Cuervo,3524,0,0,1,1,0.0%,3m
7263,3,Byrevestnik,3524,0,0,1,1,0.0%,6m
7263,2,Sbrada,3524,0,0,4,4,0.0%,28m
7274,2,[ZERG7V]Nuclear,3523,1531,119,107,226,52.7%,9m
7274,3,Meemsbror,3523,714,30,20,50,60.0%,16m
7274,3,july,3523,672,27,16,43,62.8%,14m
7274,3,Bufftin,3523,373,16,7,23,69.6%,13m
7274,3,Zell,3523,336,16,7,23,69.6%,18m
7274,3,[Graps]AbouDiaby,3523,401,13,13,26,50.0%,5m
7274,2,Good,3523,191,12,5,17,70.6%,11m
7274,2,Pain,3523,212,8,10,18,44.4%,6m
7274,2,[MST]Franz,3523,128,7,3,10,70.0%,16m
7274,2,Chernomor,3523,126,4,11,15,26.7%,8m
7274,3,Optic,3523,0,3,2,5,60.0%,18m
7274,3,ShinyRay,3523,0,1,0,1,100.0%,16m
7274,3,[Drunk9]Gio,3523,0,0,1,1,0.0%,5m
7287,2,Isildur,3522,1520,192,202,394,48.7%,28m
7287,2,Spartacus,3522,1550,61,61,122,50.0%,9m
7287,2,MoLineRo,3522,783,47,49,96,49.0%,6m
7287,3,omgvi,3522,802,32,25,57,56.1%,10m
7287,3,wipeOut,3522,292,12,3,15,80.0%,3m
7287,3,[NINJ88]ishiren,3522,226,8,8,16,50.0%,13m
7287,3,[VanSyo]IIIIIIIIIIII,3522,166,7,2,9,77.8%,5m
7287,3,Sham,3522,206,7,8,15,46.7%,13m
7287,3,[DL2006]RictalTwitch,3522,231,7,11,18,38.9%,18m
7287,3,Markvart,3522,90,4,4,8,50.0%,3m
7287,3,GAA,3522,86,3,1,4,75.0%,27m
7287,3,DerSchwarm,3522,86,3,5,8,37.5%,18m
7287,3,Sälklubbaren,3522,90,3,6,9,33.3%,41m
7287,3,ShowShallows,3522,30,1,4,5,20.0%,7m
7287,3,[skltn]Vincent,3522,0,0,1,1,0.0%,10m
7287,3,[BornG]seph,3522,0,0,1,1,0.0%,14m
7287,3,Saxo,3522,0,0,1,1,0.0%,13m
7304,3,LiquidSnute,3521,329,59,8,67,88.1%,16m
7304,2,HoneyBadger,3521,858,41,31,72,56.9%,7m
7304,3,sunsito,3521,532,39,33,72,54.2%,27m
7304,3,[NlGE]BILALISTICK,3521,1008,38,33,71,53.5%,16m
7304,3,crazycat,3521,759,30,22,52,57.7%,28m
7304,2,WorldSeizure,3521,354,12,18,30,40.0%,8m
7304,2,Daninja,3521,316,11,20,31,35.5%,6m
7304,2,Makro,3521,272,9,15,24,37.5%,16m
7304,3,NORTHKOR,3521,166,7,2,9,77.8%,19m
7304,2,maybelucky,3521,148,6,8,14,42.9%,17m
7304,2,MrTamrHit,3521,120,5,9,14,35.7%,19m
7304,2,[FxT]Ente,3521,120,4,8,12,33.3%,19m
7304,3,Navokum,3521,30,2,2,4,50.0%,7m
7304,2,[XClayX]roman,3521,116,2,6,8,25.0%,6m
7304,3,[n4Y]kluskis,3521,0,0,1,1,0.0%,14m
7319,2,[Kicx]DVN,3520,606,59,68,127,46.5%,11m
7319,2,Havok,3520,832,56,45,101,55.4%,9m
7319,2,[Sarmat]Mewa,3520,870,33,35,68,48.5%,6m
7319,3,[RUINPP]Sam,3520,540,21,12,33,63.6%,16m
7319,3,IIIIIIIIIIII,3520,287,13,8,21,61.9%,18m
7319,3,Sunshine,3520,202,7,7,14,50.0%,8m
7319,3,[EмŦS]Praeto,3520,0,5,0,5,100.0%,13m
7319,3,clo,3520,0,5,0,5,100.0%,18m
7319,3,[SMD]Chruscik,3520,0,1,2,3,33.3%,3m
7319,3,cedlabalbis,3520,0,0,1,1,0.0%,28m
7319,3,Gilliams,3520,0,0,2,2,0.0%,18m
7319,3,Animus,3520,0,0,2,2,0.0%,16m
7331,2,ColdTea,3519,1003,124,121,245,50.6%,7m
7331,2,Stringset,3519,1489,101,104,205,49.3%,27m
7331,2,[RTD]PoL,3519,871,42,44,86,48.8%,4m
7331,2,Chill,3519,772,36,23,59,61.0%,18m
7331,3,fefe,3519,369,16,7,23,69.6%,14m
7331,3,Interloper,3519,338,13,10,23,56.5%,7m
7331,3,mikk,3519,0,4,1,5,80.0%,3m
7331,2,Provieh,3519,181,4,8,12,33.3%,3m
7331,2,[NOCW]Saph,3519,0,2,3,5,40.0%,3m
7331,3,Alelka,3519,0,1,0,1,100.0%,18m
7331,3,Saneythyk,3519,0,1,0,1,100.0%,14m
7331,3,Alban,3519,0,0,1,1,0.0%,20m
7331,3,Infinity,3519,0,0,2,2,0.0%,17m
7344,2,Wizzard,3518,1445,340,340,680,50.0%,3m
7344,2,[Pot]Filemon,3518,1139,115,101,216,53.2%,17m
7344,3,Yaya,3518,1594,90,86,176,51.1%,7m
7344,3,Flake,3518,682,28,19,47,59.6%,13m
7344,3,GalaxY,3518,392,15,8,23,65.2%,14m
7344,3,[DaFF]IIIIIIIIIIII,3518,176,7,4,11,63.6%,11m
7344,2,[Dz]DzJeth,3518,194,7,11,18,38.9%,10m
7344,3,Chocov,3518,0,5,0,5,100.0%,7m
7344,3,[DaVo]Meddlfranke,3518,114,4,3,7,57.1%,41m
7344,3,[ƬC]bedrockman,3518,0,1,0,1,100.0%,20m
7344,3,Leilou,3518,0,0,1,1,0.0%,14m
7344,3,[Xa]Fantatratto,3518,0,0,1,1,0.0%,8m
7344,3,luckertv,3518,0,0,1,1,0.0%,20m
7344,3,Lax,3518,0,0,2,2,0.0%,20m
7358,2,Mat,3517,1575,182,172,354,51.4%,6m
7358,2,SticKsi,3517,1279,54,60,114,47.4%,6m
7358,2,[KAOTx]capslock,3517,300,11,14,25,44.0%,20m
7358,1,[Z3RGML]Сомбреро,3517,210,8,7,15,53.3%,28m
7358,3,ShOckeR,3517,142,6,2,8,75.0%,12m
7358,3,Enegue,3517,121,3,2,5,60.0%,18m
7358,3,[ÆVT]Naesle,3517,121,2,2,4,50.0%,10m
7358,3,[sGeeks]Skogshuggarn,3517,0,2,3,5,40.0%,3m
7358,3,che,3517,0,1,0,1,100.0%,15m
7358,3,[GnS]KillerKip,3517,30,1,9,10,10.0%,6m
7358,3,Castral,3517,0,0,1,1,0.0%,10m
7369,3,Eddar,3516,1535,170,115,285,59.6%,4m
7369,2,BrandonHeat,3516,451,148,133,281,52.7%,9m
7369,2,idol,3516,1384,93,83,176,52.8%,14m
7369,2,DearName,3516,1515,68,86,154,44.2%,15m
7369,2,RageKing,3516,1179,45,44,89,50.6%,18m
7369,2,ЛомаюЛица,3516,1026,39,39,78,50.0%,9m
7369,2,Oreeo,3516,242,38,51,89,42.7%,4m
7369,2,[NukeIt]Whispx,3516,482,17,25,42,40.5%,6m
7369,1,TopGun,3516,169,9,4,13,69.2%,20m
7369,2,[ZERGML]БейнлинЛингс,3516,274,9,14,23,39.1%,7m
7369,2,Nighthawk,3516,160,5,11,16,31.2%,8m
7369,3,zzzzzzzzzzzz,3516,0,4,0,4,100.0%,8m
7369,2,Portass,3516,164,4,8,12,33.3%,28m
7369,2,llllllllllll,3516,140,2,8,10,20.0%,8m
7369,3,IIIlllIIIlll,3516,30,1,1,2,50.0%,11m
7369,3,Lier,3516,0,0,1,1,0.0%,17m
7369,3,TieXe,3516,0,0,1,1,0.0%,10m
7369,3,[EZPTS]ЛюбительМаМ,3516,0,0,1,1,0.0%,27m
7369,3,TerranOPrace,3516,0,0,5,5,0.0%,17m
7388,2,Kregnach,3515,701,140,123,263,53.2%,7m
7388,2,Planktoni,3515,975,88,77,165,53.3%,9m
7388,3,[0BO]threepio,3515,527,61,50,111,55.0%,4m
7388,2,Hydra,3515,1239,47,51,98,48.0%,10m
7388,3,[I3oI3]psaikopaenda,3515,528,21,15,36,58.3%,8m
7388,2,IIIIIIIIIIII,3515,431,19,19,38,50.0%,13m
7388,3,Green,3515,294,13,12,25,52.0%,27m
7388,3,lllIlllIllll,3515,236,9,9,18,50.0%,7m
7388,3,eulzef,3515,114,5,1,6,83.3%,28m
7388,3,cRutChy,3515,90,4,3,7,57.1%,5m
7388,2,[FDK]Picolow,3515,88,3,8,11,27.3%,41m
7388,2,Actv,3515,44,2,2,4,50.0%,3m
7388,3,Maloy,3515,0,1,2,3,33.3%,27m
7388,3,[lOoOl]josito,3515,0,0,1,1,0.0%,13m
7388,3,Pomponette,3515,0,0,1,1,0.0%,8m
7403,3,DiuDiuOR,3514,1642,400,369,769,52.0%,10m
7403,2,Ecko,3514,870,80,84,164,48.8%,9m
7403,2,RevaN,3514,814,32,46,78,41.0%,16m
7403,3,[Dronez]Farsan,3514,345,15,8,23,65.2%,10m
7403,2,ChaosCaot,3514,252,10,16,26,38.5%,41m
7403,2,wojtek,3514,122,4,12,16,25.0%,7m
7403,3,[SOUPE]Bastébola,3514,86,3,3,6,50.0%,16m
7403,3,[DSTRI]TheRedWidow,3514,88,3,4,7,42.9%,12m
7403,3,OshuGun,3514,0,2,4,6,33.3%,3m
7403,3,[1FU2]IvMSaoSin,3514,0,0,1,1,0.0%,9m
7403,3,Abu,3514,0,0,2,2,0.0%,17m
7403,3,[PiCa]Ellie,3514,0,0,2,2,0.0%,3m
7403,3,Lemmings,3514,0,0,3,3,0.0%,28m
7403,3,Genadi,3514,0,0,3,3,0.0%,41m
7417,2,NumberTheory,3513,1567,75,79,154,48.7%,28m
7417,3,[SBG44]EvilGarfield,3513,771,60,39,99,60.6%,3m
7417,2,paÏen,3513,1331,52,49,101,51.5%,4m
7417,2,nike,3513,426,22,22,44,50.0%,26m
7417,2,theFog,3513,588,22,26,48,45.8%,12m
7417,2,Flipsus,3513,526,18,24,42,42.9%,7m
7417,3,Bleza,3513,414,17,8,25,68.0%,15m
7417,2,ZerYaTix,3513,253,11,18,29,37.9%,10m
7417,2,Fano,3513,218,6,10,16,37.5%,7m
7417,3,JokerKing,3513,0,5,0,5,100.0%,17m
7417,3,Trololo,3513,0,1,4,5,20.0%,17m
7417,3,[Wolven]EmirKaon,3513,0,0,3,3,0.0%,26m
7417,3,[NoHоmо]Danya,3513,0,0,3,3,0.0%,10m
7430,2,AzoG,3512,1115,188,173,361,52.1%,10m
7430,2,Nox,3512,1070,154,136,290,53.1%,28m
7430,3,GandalfAwA,3512,290,11,6,17,64.7%,5m
7430,3,stroier,3512,202,7,7,14,50.0%,16m
7430,3,[Razzle]Elkeezy,3512,116,5,3,8,62.5%,19m
7430,3,Chezz,3512,88,3,6,9,33.3%,8m
7430,3,[мапхак]Jokkushka,3512,58,2,3,5,40.0%,18m
7430,3,MrHapka,3512,0,1,0,1,100.0%,15m
7430,3,Night,3512,0,0,1,1,0.0%,17m
7430,3,[ZP777]Sergey,3512,0,0,1,1,0.0%,7m
7430,3,ZERG,3512,0,0,1,1,0.0%,41m
7430,3,NarDiX,3512,0,0,3,3,0.0%,10m
7442,2,[ICGl]BabaKB,3511,1464,94,95,189,49.7%,7m
7442,2,Diamond,3511,948,46,32,78,59.0%,6m
7442,2,[LPeeeG]lFgCreaper,3511,889,41,37,78,52.6%,6m
7442,3,madamepipi,3511,942,40,27,67,59.7%,18m
7442,3,Sekkey,3511,252,10,9,19,52.6%,10m
7442,3,[HBGSJR]ace,3511,214,8,5,13,61.5%,19m
7442,3,[Ygirl]Mimi,3511,220,6,11,17,35.3%,12m
7442,3,[Chrys]Sharen,3511,0,3,2,5,60.0%,13m
7442,3,ashToXi,3511,58,2,1,3,66.7%,3m
7442,3,Krabaten,3511,0,1,0,1,100.0%,3m
7442,2,[FMDRS]Kraki,3511,30,1,6,7,14.3%,9m
7453,2,ForgottenThe,3510,649,86,66,152,56.6%,7m
7453,2,[EUww1]Chel,3510,1462,70,72,142,49.3%,6m
7453,3,CaptainHump,3510,558,21,16,37,56.8%,18m
7453,2,OmasArche,3510,397,16,32,48,33.3%,9m
7453,3,IIIIIIIIIIII,3510,141,3,1,4,75.0%,14m
7453,3,MrFister,3510,60,3,4,7,42.9%,14m
7453,3,Shark,3510,30,1,4,5,20.0%,28m
7453,3,[SunGmr]BadDayRDK,3510,0,0,1,1,0.0%,9m
7461,2,poputu,3509,1424,109,103,212,51.4%,16m
7461,2,DampseY,3509,470,40,50,90,44.4%,28m
7461,2,OutCast,3509,841,33,34,67,49.3%,10m
7461,2,MrNew,3509,792,29,33,62,46.8%,41m
7461,3,JeorMormont,3509,203,19,21,40,47.5%,10m
7461,3,[KU5H]Crisis,3509,86,4,3,7,57.1%,17m
7461,2,[SBROT]Scenmox,3509,154,4,6,10,40.0%,7m
7461,3,[IceHus]lightzerg,3509,0,1,1,2,50.0%,8m
7461,3,focusrite,3509,0,0,1,1,0.0%,8m
7461,2,unicorn,3509,0,0,6,6,0.0%,8m
7471,2,[QTcIub]Scipio,3508,1547,188,188,376,50.0%,17m
7471,2,[SJDB]PonnyPonney,3508,1104,126,109,235,53.6%,17m
7471,2,[TDOW]Kikimora,3508,1095,99,107,206,48.1%,11m
7471,2,[GBH]MonsieurZor,3508,479,86,86,172,50.0%,3m
7471,3,[ssBCss]Nuke,3508,120,10,5,15,66.7%,3m
7471,3,Nezar,3508,176,6,6,12,50.0%,10m
7471,3,KaSSioPeiA,3508,109,4,4,8,50.0%,5m
7471,3,ToraTora,3508,58,2,1,3,66.7%,14m
7471,3,Chinro,3508,30,2,1,3,66.7%,27m
7471,3,Kyle,3508,0,1,0,1,100.0%,16m
7471,3,ClamZou,3508,30,1,2,3,33.3%,8m
7471,3,IIIIIIIIIIII,3508,0,0,1,1,0.0%,13m
7483,2,SirVival,3507,1233,136,122,258,52.7%,3m
7483,2,CúChulainn,3507,1549,104,82,186,55.9%,6m
7483,2,[SHOSH]Schorsch,3507,1538,96,100,196,49.0%,8m
7483,3,Kippaeu,3507,168,9,6,15,60.0%,16m
7483,3,Pekkakahva,3507,174,6,9,15,40.0%,12m
7483,2,ancient,3507,90,3,9,12,25.0%,3m
7483,3,[xNDGx]olanor,3507,0,1,0,1,100.0%,8m
7483,3,MalXantholos,3507,30,1,1,2,50.0%,7m
7483,3,[WnG]Moumout,3507,0,1,1,2,50.0%,7m
7483,3,Hellbreed,3507,0,0,1,1,0.0%,28m
7493,2,arise,3506,1467,309,309,618,50.0%,6m
7493,3,Gortak,3506,1455,149,145,294,50.7%,20m
7493,3,ПАЦАНЧИК,3506,1668,93,66,159,58.5%,14m
7493,2,[B1TCH]Ghostdog,3506,210,15,24,39,38.5%,13m
7493,3,[ЛĐT]Draf,3506,322,12,14,26,46.2%,20m
7493,2,[DZTK]hoppla,3506,276,10,18,28,35.7%,4m
7493,3,Craz,3506,0,5,0,5,100.0%,27m
7493,3,CoffeeAddict,3506,0,5,0,5,100.0%,4m
7493,3,[Novus]CiphroN,3506,97,3,3,6,50.0%,18m
7493,2,Cele,3506,134,3,4,7,42.9%,13m
7493,3,[kеbab]Removeit,3506,0,1,0,1,100.0%,5m
7493,2,[iANGEL]Legate,3506,30,1,7,8,12.5%,17m
7505,2,LonFoxHector,3505,1442,217,213,430,50.5%,27m
7505,2,Alleusia,3505,1302,67,49,116,57.8%,18m
7505,3,Vares,3505,338,30,18,48,62.5%,3m
7505,3,Marte,3505,528,23,15,38,60.5%,9m
7505,3,[SK1LL]Darvu,3505,412,15,14,29,51.7%,13m
7505,3,Hazama,3505,218,8,5,13,61.5%,4m
7505,3,[65351]TopDawg,3505,30,2,0,2,100.0%,27m
7505,3,Sardine,3505,30,1,1,2,50.0%,10m
7505,3,Ain,3505,0,1,3,4,25.0%,13m
7505,3,[59APM]Djaube,3505,0,0,2,2,0.0%,13m
7515,2,KROKO,3504,1487,134,114,248,54.0%,17m
7515,3,Chil,3504,935,82,61,143,57.3%,28m
7515,2,[PÂRłAH]robotikov,3504,1449,58,53,111,52.3%,6m
7515,3,MrT,3504,754,33,22,55,60.0%,14m
7515,3,[K0mpis]Fippel,3504,584,22,20,42,52.4%,6m
7515,3,[TruF]TheHive,3504,58,3,1,4,75.0%,10m
7515,3,[GLD]FrapKunKù,3504,30,2,0,2,100.0%,10m
7515,3,LesGrossman,3504,40,2,1,3,66.7%,27m
7515,3,MeeeM,3504,58,2,2,4,50.0%,10m
7515,3,Ravager,3504,0,1,0,1,100.0%,4m
7515,3,[SDCB]Pilgore,3504,0,1,0,1,100.0%,6m
7515,3,IIIIIIIIIIII,3504,0,1,0,1,100.0%,8m
7515,3,KingRempe,3504,30,1,1,2,50.0%,3m
7515,3,[4qq]BitchBotBoi,3504,30,1,2,3,33.3%,5m
7515,3,Sassnet,3504,0,0,1,1,0.0%,16m
7530,2,SubjectOP,3503,698,50,46,96,52.1%,17m
7530,2,DiEKLiNgE,3503,865,49,46,95,51.6%,13m
7530,3,[Kingz]Sakato,3503,859,34,23,57,59.6%,8m
7530,3,[10110]Eiikø,3503,397,25,21,46,54.3%,7m
7530,3,Kleso,3503,400,21,4,25,84.0%,13m
7530,3,Belazhur,3503,462,19,9,28,67.9%,17m
7530,3,[2II5]FootAbuser,3503,370,14,9,23,60.9%,17m
7530,3,Nikita,3503,312,11,10,21,52.4%,41m
7530,3,[Tenchu]Bullmamma,3503,282,10,10,20,50.0%,19m
7530,2,[АDMIN]AlChemyst,3503,248,9,15,24,37.5%,20m
7530,3,[RABD]HecThor,3503,118,6,5,11,54.5%,5m
7530,3,EasyAI,3503,148,6,6,12,50.0%,13m
7530,2,Ellisande,3503,118,5,8,13,38.5%,14m
7530,3,IzSHA,3503,58,3,0,3,100.0%,19m
7530,3,[neuroW]Drake,3503,58,2,4,6,33.3%,8m
7530,3,MaxPower,3503,0,1,2,3,33.3%,4m
7530,3,ClassiC,3503,0,0,1,1,0.0%,41m
7530,3,jester,3503,0,0,1,1,0.0%,13m
7530,3,KLM,3503,0,0,1,1,0.0%,14m
7549,2,PublicEnemy,3502,1558,443,443,886,50.0%,11m
7549,2,trouble,3502,1451,307,300,607,50.6%,6m
7549,3,Swullo,3502,840,152,111,263,57.8%,4m
7549,2,Legion,3502,712,35,40,75,46.7%,8m
7549,3,Clueless,3502,106,10,7,17,58.8%,3m
7549,2,[TEAREX]nubie,3502,93,6,1,7,85.7%,14m
7549,3,LUCY,3502,0,1,0,1,100.0%,8m
7549,3,[LqT]Blackened,3502,0,0,1,1,0.0%,41m
7549,3,Delaam,3502,0,0,1,1,0.0%,6m
7558,3,Fiskstim,3501,1397,166,145,311,53.4%,5m
7558,2,poiuyt,3501,1466,107,119,226,47.3%,41m
7558,2,Nibku,3501,1571,105,102,207,50.7%,10m
7558,3,[SLW]PIGNATA,3501,1003,89,86,175,50.9%,11m
7558,2,BioTech,3501,781,49,47,96,51.0%,7m
7558,3,[13g12p]reaverdrop,3501,432,39,24,63,61.9%,13m
7558,3,WaRW,3501,766,32,24,56,57.1%,5m
7558,2,Lantar,3501,823,30,35,65,46.2%,17m
7558,3,Dragon,3501,242,9,7,16,56.2%,17m
7558,2,[PŖïMĄŁ]MannYPacman,3501,30,2,9,11,18.2%,6m
7558,3,washurhands,3501,0,1,1,2,50.0%,13m
7558,3,PiQS,3501,30,1,1,2,50.0%,13m
7558,3,TwoMeTrue,3501,0,0,1,1,0.0%,6m
7558,1,fandecody,3501,0,0,40,40,0.0%,14m
7572,2,Escape,3500,1579,210,200,410,51.2%,19m
7572,2,Badlock,3500,1440,98,76,174,56.3%,20m
7572,3,[Heroes]Giaphage,3500,1509,80,75,155,51.6%,6m
7572,2,TripleZ,3500,801,47,48,95,49.5%,13m
7572,2,[tH]Takushin,3500,953,37,37,74,50.0%,8m
7572,2,[K0mpis]Arastein,3500,654,26,29,55,47.3%,11m
7572,2,[ryx13]RYXTER,3500,233,17,15,32,53.1%,6m
7572,2,Traviktox,3500,322,11,14,25,44.0%,27m
7572,3,PaCC,3500,176,6,10,16,37.5%,18m
7572,3,xArchAngelx,3500,86,4,0,4,100.0%,10m
7572,3,HeiSserHorSt,3500,86,3,2,5,60.0%,18m
7572,3,Brunfel,3500,86,3,5,8,37.5%,4m
7572,3,[iX]FanTasY,3500,30,2,0,2,100.0%,6m
7572,3,[DeCr]Wockes,3500,30,2,1,3,66.7%,5m
7572,2,[HBGSJR]llllllllllll,3500,60,2,9,11,18.2%,17m
7572,2,reaglex,3500,30,1,8,9,11.1%,17m
7572,2,[mTm]CarstinHO,3500,30,1,10,11,9.1%,16m
7572,3,Sammorack,3500,0,0,1,1,0.0%,27m
7572,3,[Rebrn]NemoniX,3500,0,0,2,2,0.0%,10m
7591,2,BaBaFinGO,3499,1576,404,395,799,50.6%,28m
7591,2,NoMoreSkyTos,3499,1051,136,144,280,48.6%,19m
7591,3,Bacon,3499,725,104,97,201,51.7%,6m
7591,2,OPhion,3499,658,43,41,84,51.2%,10m
7591,2,[EXC]Devotee,3499,612,26,36,62,41.9%,7m
7591,2,Rorschach,3499,578,21,27,48,43.8%,7m
7591,3,Maverick,3499,135,3,2,5,60.0%,14m
7591,3,[TExGG]Soap,3499,30,2,0,2,100.0%,41m
7591,3,RedviKING,3499,0,1,2,3,33.3%,13m
7600,2,jamislamb,3498,1565,244,200,444,55.0%,13m
7600,2,postman,3498,1460,97,105,202,48.0%,28m
7600,2,Argonauta,3498,943,62,69,131,47.3%,7m
7600,3,dindontetu,3498,925,51,35,86,59.3%,13m
7600,2,[FuCd]Mallyx,3498,711,42,44,86,48.8%,9m
7600,3,[HeClub]AkashiSei,3498,613,26,17,43,60.5%,13m
7600,3,Fenrack,3498,494,19,18,37,51.4%,13m
7600,3,Ponta,3498,425,18,11,29,62.1%,17m
7600,1,[Рачелы]hasagi,3498,175,11,3,14,78.6%,10m
7600,2,DalekSec,3498,164,8,2,10,80.0%,5m
7600,3,Affenbrotbau,3498,58,6,1,7,85.7%,9m
7600,2,DevilsFire,3498,116,5,14,19,26.3%,28m
7600,3,[PŖïMĄŁ]LUKITREK,3498,62,3,4,7,42.9%,13m
7600,3,PuReExile,3498,30,2,0,2,100.0%,20m
7600,3,Moonlight,3498,119,2,2,4,50.0%,28m
7600,3,HeyKappa,3498,0,1,2,3,33.3%,7m
7600,3,IIIIIIIIIIII,3498,0,0,1,1,0.0%,5m
7600,3,Ocrasi,3498,0,0,4,4,0.0%,14m
7618,2,Krissoku,3497,1321,243,229,472,51.5%,9m
7618,2,Freako,3497,610,22,23,45,48.9%,17m
7618,3,[НТТ]ART,3497,406,17,6,23,73.9%,3m
7618,2,[ULTX]auge,3497,260,12,16,28,42.9%,41m
7618,3,DegeL,3497,166,6,3,9,66.7%,13m
7618,2,Bobby,3497,196,6,9,15,40.0%,3m
7618,3,Astyanax,3497,0,5,0,5,100.0%,19m
7618,3,Gtoss,3497,118,5,6,11,45.5%,18m
7618,2,[iX]Chrismaverik,3497,165,4,7,11,36.4%,5m
7618,3,Yakain,3497,60,2,4,6,33.3%,4m
7618,3,[RBBT]MouseTrap,3497,0,1,0,1,100.0%,9m
7618,3,Mathlife,3497,30,1,3,4,25.0%,13m
7618,3,[EBU]Gesonec,3497,0,0,1,1,0.0%,12m
7618,3,Nutcracker,3497,0,0,3,3,0.0%,11m
7618,3,Lulu,3497,0,0,5,5,0.0%,4m
7633,2,[IndyK]EVOLET,3496,1588,543,534,1077,50.4%,11m
7633,2,NightBaker,3496,1567,165,157,322,51.2%,3m
7633,3,[NINJ88]Jahyaman,3496,340,21,17,38,55.3%,9m
7633,2,DrJhonnySins,3496,228,10,3,13,76.9%,6m
7633,3,Benquadinaro,3496,0,5,0,5,100.0%,26m
7633,3,IIIIIIIIIIII,3496,167,5,1,6,83.3%,28m
7633,3,[MSUSC2]Tabiary,3496,140,5,2,7,71.4%,10m
7633,3,[DTBMII]Kyu,3496,30,1,1,2,50.0%,14m
7633,3,skrrt,3496,0,0,1,1,0.0%,41m
7633,3,AnAIgin,3496,0,0,2,2,0.0%,20m
7633,3,Airborne,3496,0,0,3,3,0.0%,18m
7633,3,[0GAZ]Yip,3496,0,0,3,3,0.0%,6m
7645,3,[SchamR]pusHtoMiez,3495,1592,296,288,584,50.7%,7m
7645,3,friendly,3495,800,49,34,83,59.0%,3m
7645,2,WCP,3495,877,41,34,75,54.7%,6m
7645,2,IIIIIIIIIIII,3495,562,40,35,75,53.3%,3m
7645,2,Cheyen,3495,1050,39,40,79,49.4%,41m
7645,1,lililililili,3495,233,11,4,15,73.3%,5m
7645,2,Gobfreecs,3495,164,7,7,14,50.0%,8m
7645,3,nimatouqi,3495,0,5,0,5,100.0%,27m
7645,3,vodka,3495,0,5,0,5,100.0%,41m
7645,3,GeneralDFish,3495,114,4,3,7,57.1%,27m
7645,3,Slevin,3495,0,1,1,2,50.0%,9m
7645,2,llIllIlIlIll,3495,0,1,8,9,11.1%,7m
7645,3,Mindblaster,3495,0,0,2,2,0.0%,7m
7658,2,dragonheart,3494,1524,192,185,377,50.9%,17m
7658,3,[Hаsu]LittleSerral,3494,1165,127,108,235,54.0%,18m
7658,3,Bitween,3494,1218,108,93,201,53.7%,3m
7658,3,[IEK]WonkyDonkey,3494,1598,63,64,127,49.6%,27m
7658,3,FDAXHunter,3494,1212,60,59,119,50.4%,9m
7658,3,huskyftw,3494,394,14,13,27,51.9%,6m
7658,3,gewt,3494,300,11,12,23,47.8%,26m
7658,3,ELFETAO,3494,142,7,3,10,70.0%,17m
7658,3,DelinJa,3494,208,7,9,16,43.8%,7m
7658,1,Sedz,3494,134,4,3,7,57.1%,10m
7658,1,Protosseek,3494,0,2,0,2,100.0%,20m
7658,3,[2Proxy]Andariel,3494,0,1,1,2,50.0%,7m
7658,3,[neuroG]nutcake,3494,30,1,3,4,25.0%,13m
7671,2,Fixxx,3493,703,114,110,224,50.9%,13m
7671,3,Syence,3493,1234,48,41,89,53.9%,14m
7671,3,[TAW]Arno,3493,294,12,6,18,66.7%,3m
7671,3,Rain,3493,260,9,12,21,42.9%,7m
7671,3,[ZUBS]Ferret,3493,142,6,3,9,66.7%,16m
7671,3,oblivian,3493,0,1,0,1,100.0%,9m
7671,3,[WDAL1]Heresie,3493,30,1,1,2,50.0%,14m
7671,3,[GAGO]Popcorn,3493,0,0,1,1,0.0%,18m
7671,3,[EESC]TRiNiGhT,3493,0,0,1,1,0.0%,9m
7671,3,[KerriS]Fatline,3493,0,0,1,1,0.0%,16m
7671,3,CptSpyro,3493,0,0,2,2,0.0%,17m
7671,3,Marcy,3493,0,0,5,5,0.0%,5m
7683,2,Baldamir,3492,1547,366,370,736,49.7%,9m
7683,2,[Steamy]TinJuice,3492,1109,82,78,160,51.2%,11m
7683,3,kaskavel,3492,464,65,49,114,57.0%,7m
7683,2,Aykay,3492,650,51,57,108,47.2%,27m
7683,2,TTalgoa,3492,454,48,41,89,53.9%,13m
7683,2,Oxygene,3492,1226,42,61,103,40.8%,6m
7683,2,Nitron,3492,381,14,14,28,50.0%,13m
7683,3,MrKrABs,3492,285,13,10,23,56.5%,9m
7683,1,[Alkar]Elegrabin,3492,0,5,0,5,100.0%,13m
7683,3,lolx,3492,30,2,1,3,66.7%,8m
7683,2,[AXR]Cyb,3492,0,2,3,5,40.0%,3m
7683,2,poTOSSyntess,3492,88,2,4,6,33.3%,17m
7683,3,Arekk,3492,0,1,0,1,100.0%,13m
7683,3,TeaRex,3492,30,1,4,5,20.0%,14m
7683,3,Dolfik,3492,30,1,6,7,14.3%,5m
7683,2,[SQUÍK]MasuNinja,3492,30,1,7,8,12.5%,12m
7683,3,Kelthuzda,3492,0,0,1,1,0.0%,5m
7683,3,Pouki,3492,0,0,1,1,0.0%,16m
7701,2,Roma,3491,1489,164,149,313,52.4%,41m
7701,3,xlStok,3491,1281,119,112,231,51.5%,4m
7701,2,regnidorhcs,3491,1555,106,105,211,50.2%,4m
7701,2,DrEvil,3491,1520,101,104,205,49.3%,28m
7701,2,GERU,3491,748,35,29,64,54.7%,27m
7701,2,IlIlIlIlIlIl,3491,848,31,39,70,44.3%,3m
7701,3,Rimix,3491,439,19,13,32,59.4%,26m
7701,2,[D4RTH]Sefulica,3491,554,18,32,50,36.0%,17m
7701,3,[DisKCo]Cann,3491,140,6,2,8,75.0%,3m
7701,3,Vito,3491,170,6,5,11,54.5%,4m
7701,3,ISOLATE,3491,114,4,1,5,80.0%,17m
7701,3,Vino,3491,60,3,5,8,37.5%,3m
7701,1,Dream,3491,97,2,0,2,100.0%,17m
7701,1,[WolfGs]Roger,3491,0,2,3,5,40.0%,37m
7701,3,[PLWar]FlayeR,3491,0,0,2,2,0.0%,4m
7716,2,RaGouT,3490,990,36,41,77,46.8%,9m
7716,2,[RedFmm]Zilord,3490,784,29,32,61,47.5%,41m
7716,2,MillerAP,3490,429,18,14,32,56.2%,7m
7716,3,ToYs,3490,264,10,11,21,47.6%,19m
7716,3,Blackfire,3490,176,6,4,10,60.0%,10m
7716,3,Galaga,3490,0,5,0,5,100.0%,9m
7716,1,cheosaranG,3490,206,5,3,8,62.5%,7m
7716,3,Apotheosis,3490,86,4,2,6,66.7%,41m
7716,1,MeNoBrain,3490,142,3,1,4,75.0%,15m
7716,3,[SkAAL]SirFrosty,3490,58,2,5,7,28.6%,19m
7716,3,Uranium,3490,58,2,5,7,28.6%,18m
7716,3,shiro,3490,30,1,2,3,33.3%,5m
7716,3,Fridrix,3490,0,0,1,1,0.0%,9m
7729,3,Manwe,3489,1535,139,137,276,50.4%,3m
7729,2,Karst,3489,1407,96,94,190,50.5%,12m
7729,3,[Ecoli]Ensi,3489,839,80,78,158,50.6%,27m
7729,3,BlanCo,3489,202,19,16,35,54.3%,28m
7729,3,RaZoR,3489,58,2,1,3,66.7%,10m
7729,3,Drone,3489,30,1,2,3,33.3%,7m
7729,3,[GnS]Fraggi,3489,0,0,1,1,0.0%,27m
7729,3,[elCrab]Gazmyas,3489,0,0,1,1,0.0%,10m
7737,2,[Kazi]Yurgen,3488,1593,339,341,680,49.9%,29m
7737,3,[TEDF]Tagazox,3488,1596,86,82,168,51.2%,8m
7737,2,[HGame]Ghazgh,3488,871,35,34,69,50.7%,18m
7737,2,Solga,3488,467,32,27,59,54.2%,9m
7737,2,blrpapa,3488,304,14,14,28,50.0%,13m
7737,3,[QreskT]Arevalz,3488,228,12,7,19,63.2%,12m
7737,3,hgku,3488,58,3,2,5,60.0%,28m
7737,3,Bamboo,3488,124,3,4,7,42.9%,16m
7737,3,PureWater,3488,0,1,0,1,100.0%,6m
7737,3,Rewind,3488,30,1,6,7,14.3%,3m
7737,3,[Listic]Nyrius,3488,0,0,1,1,0.0%,7m
7737,3,[GxUxC]FlyUnicorn,3488,0,0,1,1,0.0%,17m
7737,3,[BigDad]RyoNarushima,3488,0,0,1,1,0.0%,19m
7737,3,[KmT]Djouls,3488,0,0,5,5,0.0%,9m
7751,3,Atonement,3487,825,83,76,159,52.2%,10m
7751,3,rty,3487,1495,65,46,111,58.6%,15m
7751,2,GeorgeGodhaj,3487,404,36,46,82,43.9%,41m
7751,3,mglo,3487,612,35,27,62,56.5%,9m
7751,2,Mir,3487,334,16,11,27,59.3%,17m
7751,2,SiKe,3487,311,12,18,30,40.0%,28m
7751,3,IIIIIIII,3487,108,5,8,13,38.5%,7m
7751,3,Nemesis,3487,88,4,2,6,66.7%,26m
7751,3,squeeeee,3487,90,4,7,11,36.4%,28m
7751,3,EEE,3487,0,3,1,4,75.0%,20m
7751,3,aTable,3487,0,1,0,1,100.0%,5m
7751,2,Pinkman,3487,30,1,13,14,7.1%,6m
7751,3,dottt,3487,0,0,1,1,0.0%,13m
7764,2,AdrianHealey,3486,1541,463,455,918,50.4%,18m
7764,2,[RGAN]DrJA,3486,1443,326,317,643,50.7%,7m
7764,2,[РUNK]NekrozNog,3486,1564,242,234,476,50.8%,3m
7764,2,SnitteLittle,3486,1175,127,122,249,51.0%,3m
7764,2,FreshGordon,3486,1487,92,74,166,55.4%,13m
7764,3,Epicure,3486,735,83,82,165,50.3%,41m
7764,3,[Blacer]Serral,3486,969,44,29,73,60.3%,28m
7764,3,imius,3486,1112,44,44,88,50.0%,6m
7764,3,MarineKing,3486,306,11,12,23,47.8%,13m
7764,3,[BrKi]Forsaken,3486,192,7,5,12,58.3%,41m
7764,3,vilandre,3486,97,5,1,6,83.3%,3m
7764,3,Baldr,3486,60,3,1,4,75.0%,17m
7764,3,TPxSpAnZo,3486,0,3,3,6,50.0%,5m
7764,3,[AON100]nar,3486,0,1,0,1,100.0%,5m
7764,3,[DDdogs]wizig,3486,0,0,1,1,0.0%,14m
7779,2,Dyabolic,3485,1564,722,726,1448,49.9%,5m
7779,2,julien,3485,1557,216,219,435,49.7%,6m
7779,3,Packs,3485,1509,111,104,215,51.6%,15m
7779,3,[CumA4]Serral,3485,1390,63,37,100,63.0%,16m
7779,2,meSSer,3485,1416,57,65,122,46.7%,18m
7779,3,[VFN]Echokill,3485,470,18,14,32,56.2%,18m
7779,2,Oglop,3485,233,10,4,14,71.4%,9m
7779,3,ErnstRiedler,3485,166,8,2,10,80.0%,4m
7779,3,otherA,3485,88,4,5,9,44.4%,4m
7779,2,[НТТ]Fargus,3485,141,3,3,6,50.0%,5m
7779,2,MouleBeat,3485,140,3,9,12,25.0%,6m
7779,3,Pheasant,3485,58,2,6,8,25.0%,28m
7779,3,ROCKSTAR,3485,0,1,1,2,50.0%,20m
7779,3,Malow,3485,0,1,2,3,33.3%,41m
7779,3,jonyfontein,3485,30,1,3,4,25.0%,27m
7779,3,sterne,3485,30,1,4,5,20.0%,11m
7779,3,Murinus,3485,0,0,1,1,0.0%,6m
7779,3,fear,3485,0,0,1,1,0.0%,13m
7797,2,and,3484,1508,173,187,360,48.1%,9m
7797,2,[OwOOwO]Krishn,3484,1445,68,68,136,50.0%,7m
7797,2,[Sents]EliteOma,3484,1086,56,60,116,48.3%,19m
7797,3,[ĦRZ]Crede,3484,1311,49,52,101,48.5%,10m
7797,2,Alpaca,3484,567,48,51,99,48.5%,16m
7797,2,[STacer]Tyrean,3484,386,35,24,59,59.3%,4m
7797,3,[H2Og]MRK,3484,719,30,14,44,68.2%,8m
7797,2,macBamber,3484,204,23,30,53,43.4%,28m
7797,3,Senakin,3484,252,13,3,16,81.2%,5m
7797,2,Flingorofil,3484,336,13,17,30,43.3%,17m
7797,2,Zepyhr,3484,406,13,24,37,35.1%,7m
7797,3,[BWArmy]Lefrancais,3484,30,2,0,2,100.0%,17m
7797,3,Кончаювсуп,3484,0,1,0,1,100.0%,11m
7797,3,Koi,3484,0,0,1,1,0.0%,11m
7797,3,Deviac,3484,0,0,1,1,0.0%,3m
7797,3,Neron,3484,0,0,1,1,0.0%,5m
7813,3,MrSmile,3483,1165,167,149,316,52.8%,14m
7813,3,[Wolven]newbiecraft,3483,1622,148,143,291,50.9%,6m
7813,3,TyrantsBlood,3483,690,38,25,63,60.3%,16m
7813,2,LØAD,3483,278,13,16,29,44.8%,3m
7813,3,KannaKamui,3483,60,3,1,4,75.0%,13m
7813,3,[AUTAJ]crapo,3483,30,2,0,2,100.0%,41m
7813,3,[HBGSJR]BILICH,3483,0,1,0,1,100.0%,14m
7813,3,Ravend,3483,0,1,1,2,50.0%,8m
7813,3,zuki,3483,0,1,2,3,33.3%,16m
7813,3,[ssev]Maiheu,3483,30,1,3,4,25.0%,19m
7813,2,Resuu,3483,0,1,6,7,14.3%,9m
7813,3,Allisrem,3483,0,0,1,1,0.0%,12m
7813,3,BGBOY,3483,0,0,1,1,0.0%,4m
7813,3,Xivert,3483,0,0,1,1,0.0%,17m
7813,3,RussianDad,3483,0,0,5,5,0.0%,16m
7828,2,[DreamB]Wesker,3482,1336,171,152,323,52.9%,7m
7828,3,Romsen,3482,779,35,25,60,58.3%,17m
7828,3,Chien,3482,176,7,5,12,58.3%,8m
7828,3,[ЯD]Prospect,3482,148,6,4,10,60.0%,4m
7828,3,HPC,3482,156,6,9,15,40.0%,15m
7828,3,[BScars]TheOldBee,3482,114,5,8,13,38.5%,5m
7828,2,[НОД17]chef,3482,126,4,10,14,28.6%,29m
7828,3,akakins,3482,30,2,0,2,100.0%,14m
7828,3,[4540]DEUSIIVixen,3482,0,1,0,1,100.0%,11m
7828,3,Valorfist,3482,0,0,1,1,0.0%,12m
7828,3,[TFS1]PizzAce,3482,0,0,5,5,0.0%,3m
7839,3,KäptnBlaubär,3481,481,45,40,85,52.9%,5m
7839,2,PrX,3481,867,33,44,77,42.9%,13m
7839,2,[666999]Jennorr,3481,773,30,41,71,42.3%,13m
7839,3,loveandmusic,3481,280,11,9,20,55.0%,41m
7839,3,Sazer,3481,278,11,12,23,47.8%,10m
7839,3,TrainingDay,3481,194,10,11,21,47.6%,7m
7839,3,[Hаsu]Karaks,3481,226,9,7,16,56.2%,6m
7839,3,[DIRSTK]JaySin,3481,270,9,12,21,42.9%,10m
7839,3,[xREKTx]Relentless,3481,234,8,11,19,42.1%,20m
7839,3,IIIIIIIIIII,3481,159,7,2,9,77.8%,20m
7839,3,rccbc,3481,176,7,6,13,53.8%,13m
7839,3,[НС]Zergling,3481,146,5,6,11,45.5%,12m
7839,3,[муррка]Кирито,3481,0,4,1,5,80.0%,5m
7839,3,imba,3481,30,2,0,2,100.0%,41m
7839,3,bobabomber,3481,97,2,2,4,50.0%,9m
7839,3,DrZ,3481,0,1,0,1,100.0%,15m
7839,3,SleepyBear,3481,0,0,1,1,0.0%,15m
7856,3,Bodybag,3480,1326,229,218,447,51.2%,20m
7856,3,Gemcluster,3480,346,53,44,97,54.6%,41m
7856,2,AdevodE,3480,827,44,44,88,50.0%,16m
7856,3,Otuclop,3480,119,6,1,7,85.7%,12m
7856,1,Falcon,3480,0,4,1,5,80.0%,9m
7856,3,IIIIIIII,3480,0,4,1,5,80.0%,17m
7856,3,[msvs]Cuddleton,3480,88,4,3,7,57.1%,10m
7856,3,[FDS4]virtuxa,3480,60,3,3,6,50.0%,8m
7856,3,Entragon,3480,60,3,4,7,42.9%,27m
7856,2,Mycelium,3480,94,2,1,3,66.7%,5m
7856,2,[lGGI]mXW,3480,30,1,10,11,9.1%,10m
7856,3,[INAE]Danatic,3480,0,0,3,3,0.0%,15m
7868,2,dbk,3479,985,68,72,140,48.6%,11m
7868,3,[WÖLFE]UnitedNation,3479,406,18,16,34,52.9%,5m
7868,2,TORNADER,3479,130,9,11,20,45.0%,10m
7868,3,Termy,3479,114,4,1,5,80.0%,8m
7868,3,[HBGSJR]Taruviel,3479,141,3,2,5,60.0%,41m
7868,3,[MDeS]SharKRippeR,3479,30,2,1,3,66.7%,13m
7868,3,[SEGPA]CptaineDurex,3479,30,2,1,3,66.7%,10m
7868,3,paknrozerg,3479,120,2,3,5,40.0%,13m
7868,3,[WOO]Tittania,3479,30,1,2,3,33.3%,8m
7868,3,PeRi,3479,0,0,1,1,0.0%,9m
7868,3,ScrappyCoco,3479,0,0,1,1,0.0%,4m
7868,3,[SFine]Granis,3479,0,0,1,1,0.0%,4m
7868,3,crsy,3479,0,0,1,1,0.0%,9m
7881,2,Yandros,3478,1566,230,247,477,48.2%,28m
7881,2,glhf,3478,222,40,31,71,56.3%,17m
7881,2,[SGARD]SWarrior,3478,1009,40,39,79,50.6%,41m
7881,3,Egik,3478,465,24,17,41,58.5%,41m
7881,3,[IceHus]Anihilation,3478,475,18,13,31,58.1%,8m
7881,2,Tuttkassen,3478,487,18,21,39,46.2%,11m
7881,3,BattleOoze,3478,321,12,11,23,52.2%,19m
7881,3,Shikari,3478,242,9,6,15,60.0%,4m
7881,2,Andersson,3478,270,9,12,21,42.9%,6m
7881,1,Amix,3478,197,8,7,15,53.3%,18m
7881,3,[Kompis]daboon,3478,121,6,1,7,85.7%,3m
7881,3,[Englis]ЛовкийЗерг,3478,136,6,4,10,60.0%,6m
7881,1,ScoobyDooGng,3478,0,5,0,5,100.0%,6m
7881,3,Sfoin,3478,58,3,1,4,75.0%,41m
7881,3,williamgrg,3478,30,2,3,5,40.0%,27m
7881,3,STRANGER,3478,30,2,3,5,40.0%,16m
7881,3,farfadet,3478,0,1,3,4,25.0%,28m
7881,3,Apparat,3478,0,0,4,4,0.0%,14m
7899,2,yehor,3477,1551,117,114,231,50.6%,28m
7899,2,[aW]Yuukito,3477,939,68,58,126,54.0%,16m
7899,3,BroNumberOne,3477,1085,66,54,120,55.0%,20m
7899,3,lampShade,3477,202,7,6,13,53.8%,15m
7899,3,Sobota,3477,120,5,1,6,83.3%,9m
7899,2,[CBBro]crafty,3477,60,2,11,13,15.4%,12m
7899,3,NoXiS,3477,0,0,4,4,0.0%,13m
7906,2,Koumei,3476,1565,106,121,227,46.7%,17m
7906,3,Szif,3476,443,20,17,37,54.1%,15m
7906,3,Alien,3476,487,17,18,35,48.6%,11m
7906,3,Ello,3476,105,7,1,8,87.5%,11m
7906,3,GhOst,3476,0,1,0,1,100.0%,11m
7911,3,[TLpsE]IloveYeony,3475,1548,81,76,157,51.6%,11m
7911,2,Mura,3475,795,43,44,87,49.4%,28m
7911,3,Zatoxs,3475,595,28,13,41,68.3%,5m
7911,3,TitLe,3475,564,21,24,45,46.7%,4m
7911,3,[iX]Würmchen,3475,532,18,23,41,43.9%,5m
7911,3,Forimbad,3475,400,15,14,29,51.7%,41m
7911,2,fLo,3475,422,14,26,40,35.0%,19m
7911,2,grimalk,3475,178,8,16,24,33.3%,28m
7911,3,[ZЕRGТV]SPARTA,3475,135,5,3,8,62.5%,9m
7911,3,[MAOLTE]BigBossALEX,3475,41,3,3,6,50.0%,18m
7911,3,Månegarm,3475,133,3,5,8,37.5%,10m
7911,3,[Deejay]TaSoeur,3475,58,2,3,5,40.0%,27m
7911,3,MasterYoda,3475,0,1,0,1,100.0%,16m
7911,3,[DeTime]Ketf,3475,0,1,0,1,100.0%,17m
7911,3,Razvule,3475,0,0,1,1,0.0%,7m
7911,3,[DM3at]Deathadder,3475,0,0,2,2,0.0%,15m
7927,2,Doom,3474,1549,266,241,507,52.5%,7m
7927,3,DynaLing,3474,894,40,32,72,55.6%,12m
7927,3,Ailer,3474,1062,39,41,80,48.8%,6m
7927,3,Derar,3474,788,34,27,61,55.7%,3m
7927,3,Capzda,3474,498,21,11,32,65.6%,13m
7927,3,Salattasche,3474,234,9,11,20,45.0%,27m
7927,3,InYaFace,3474,146,4,3,7,57.1%,19m
7927,3,isistaylor,3474,86,3,1,4,75.0%,6m
7927,3,exO,3474,60,3,5,8,37.5%,27m
7927,3,Dowel,3474,30,2,1,3,66.7%,27m
7927,3,[M3M0]Carkass,3474,0,0,3,3,0.0%,10m
7938,2,[ЗИБиАГ]OverLord,3473,1482,171,132,303,56.4%,12m
7938,3,FCA,3473,1463,64,52,116,55.2%,9m
7938,3,[ioStuN]Chronicles,3473,1400,58,47,105,55.2%,19m
7938,3,Olibaby,3473,491,22,11,33,66.7%,27m
7938,2,BEARSkyopp,3473,332,13,13,26,50.0%,7m
7938,3,[NWGD]MeguminSan,3473,358,13,14,27,48.1%,7m
7938,3,GKEY,3473,122,5,6,11,45.5%,20m
7938,3,[JRA]Vancker,3473,86,4,2,6,66.7%,15m
7938,3,Zurglub,3473,88,4,3,7,57.1%,18m
7938,3,[LaPaCa]Shyl,3473,58,3,1,4,75.0%,10m
7938,3,[Arabia]CaZ,3473,147,3,3,6,50.0%,4m
7938,3,DANE,3473,24,2,2,4,50.0%,9m
7938,3,Deex,3473,30,2,6,8,25.0%,15m
7938,3,[MАSTER]aleks,3473,30,1,3,4,25.0%,11m
7938,3,Jesterhead,3473,0,0,3,3,0.0%,28m
7953,3,JeanMichel,3472,32,84,65,149,56.4%,4m
7953,2,Agro,3472,587,28,22,50,56.0%,13m
7953,3,MacLeod,3472,559,23,7,30,76.7%,13m
7953,3,PeoN,3472,628,23,22,45,51.1%,10m
7953,3,MrBind,3472,498,19,12,31,61.3%,12m
7953,3,[HZeS]ZedFunSize,3472,428,16,18,34,47.1%,6m
7953,3,Dashet,3472,324,15,9,24,62.5%,41m
7953,2,Solken,3472,210,11,6,17,64.7%,10m
7953,2,Aetin,3472,278,10,17,27,37.0%,16m
7953,3,[tMnrd]Toffee,3472,214,9,1,10,90.0%,8m
7953,3,[SRPRZ]Mars,3472,0,5,0,5,100.0%,5m
7953,3,FisH,3472,0,5,1,6,83.3%,11m
7953,3,Liquidator,3472,86,4,0,4,100.0%,5m
7953,3,sone,3472,58,3,1,4,75.0%,5m
7953,3,MainVoid,3472,60,2,3,5,40.0%,16m
7953,3,[TFSC]Nayour,3472,60,2,4,6,33.3%,13m
7953,3,Fuglinn,3472,0,2,4,6,33.3%,10m
7953,3,Worhold,3472,58,2,7,9,22.2%,5m
7953,3,Alibril,3472,0,0,1,1,0.0%,14m
7972,2,VanVan,3471,345,191,202,393,48.6%,16m
7972,3,ployha,3471,783,67,52,119,56.3%,42m
7972,3,Anzen,3471,1181,51,38,89,57.3%,16m
7972,3,venom,3471,584,23,17,40,57.5%,11m
7972,2,letmefun,3471,642,21,38,59,35.6%,13m
7972,1,Skurt,3471,303,13,6,19,68.4%,9m
7972,3,MiguelPérez,3471,266,11,3,14,78.6%,28m
7972,3,capitanmartu,3471,0,1,0,1,100.0%,20m
7972,3,[muilut]Gramhol,3471,0,0,3,3,0.0%,7m
7981,2,IsoMurmeli,3470,1581,222,205,427,52.0%,8m
7981,3,[TWGs]Garrati,3470,1570,160,155,315,50.8%,3m
7981,2,CzarPrK,3470,625,98,88,186,52.7%,7m
7981,2,Moridin,3470,1477,81,73,154,52.6%,9m
7981,3,YelloWeeD,3470,522,76,68,144,52.8%,5m
7981,3,[Aichan]Aichan,3470,469,48,50,98,49.0%,5m
7981,3,ҚәтәҚ,3470,559,43,41,84,51.2%,19m
7981,2,Jacks,3470,754,40,47,87,46.0%,11m
7981,3,[IceHus]kytsyr,3470,546,21,17,38,55.3%,3m
7981,3,[MN8]Laggex,3470,271,18,20,38,47.4%,28m
7981,3,Reppageki,3470,315,14,7,21,66.7%,9m
7981,3,tdarovsky,3470,370,12,10,22,54.5%,18m
7981,2,[lMMl]ShadowRoCk,3470,214,7,16,23,30.4%,20m
7981,3,Mixalich,3470,30,2,1,3,66.7%,3m
7981,3,[DCAB]FarToHell,3470,58,2,3,5,40.0%,8m
7981,3,HeX,3470,0,0,1,1,0.0%,27m
7981,3,[D0N3]NERVOSO,3470,0,0,2,2,0.0%,4m
7998,2,llllllllllll,3469,1232,92,94,186,49.5%,17m
7998,3,LDMA,3469,937,48,39,87,55.2%,9m
7998,3,Nelphie,3469,285,11,9,20,55.0%,28m
7998,3,Harkey,3469,90,3,7,10,30.0%,16m
7998,3,NinjaTurtle,3469,0,1,0,1,100.0%,18m
7998,3,Kongurinn,3469,0,0,3,3,0.0%,5m
7998,3,SeriousSam,3469,0,0,3,3,0.0%,28m
8005,2,[TuRki]Grimmjow,3468,1021,110,94,204,53.9%,20m
8005,2,[PiGPan]BearHug,3468,1526,108,104,212,50.9%,18m
8005,2,[ESCrew]cal,3468,1580,102,110,212,48.1%,28m
8005,2,DemOk,3468,1326,66,65,131,50.4%,16m
8005,2,WannaBeSeral,3468,178,7,19,26,26.9%,7m
8005,3,[iaMsK]LeGioN,3468,140,6,8,14,42.9%,10m
8005,3,BrothaLion,3468,65,4,1,5,80.0%,10m
8005,3,Sane,3468,86,4,3,7,57.1%,17m
8005,3,SkyLie,3468,58,3,3,6,50.0%,10m
8005,3,Kira,3468,97,2,1,3,66.7%,10m
8005,3,[GoGs]MrSmooth,3468,30,2,6,8,25.0%,41m
8005,3,Alexeus,3468,30,1,2,3,33.3%,10m
8005,3,[Clacos]SkyStalkers,3468,9,1,3,4,25.0%,5m
8005,3,Skaiy,3468,30,1,3,4,25.0%,13m
8005,3,Rode,3468,0,0,1,1,0.0%,19m
8005,3,[TLux]LuxLunaSea,3468,0,0,1,1,0.0%,16m
8005,3,MLK,3468,0,0,2,2,0.0%,5m
8022,3,[Dobro]NickZERG,3467,611,40,34,74,54.1%,27m
8022,3,UrbanRedNeck,3467,340,13,6,19,68.4%,13m
8022,3,[dæD]InFeCTedLinG,3467,358,13,13,26,50.0%,6m
8022,3,[Яков]Япидар,3467,0,5,0,5,100.0%,17m
8022,3,Erazium,3467,90,3,7,10,30.0%,41m
8022,3,[valars]iluvatar,3467,30,2,3,5,40.0%,29m
8022,3,SpiderCat,3467,0,1,0,1,100.0%,13m
8022,3,Warsmith,3467,0,0,2,2,0.0%,4m
8030,2,TurokESP,3466,1538,185,179,364,50.8%,7m
8030,3,SoupCatcher,3466,1564,121,107,228,53.1%,13m
8030,3,[GdAT]Blutmilan,3466,1639,77,69,146,52.7%,42m
8030,3,Sean,3466,746,34,18,52,65.4%,13m
8030,3,[UATeam]Alex,3466,776,28,30,58,48.3%,11m
8030,3,impavidus,3466,404,18,12,30,60.0%,3m
8030,3,Trizztein,3466,311,15,8,23,65.2%,18m
8030,2,YouVladBro,3466,200,7,14,21,33.3%,4m
8030,3,Nielsi,3466,148,6,5,11,54.5%,16m
8030,3,Simon,3466,146,5,10,15,33.3%,9m
8030,3,Slashman,3466,86,4,0,4,100.0%,11m
8030,1,Sssky,3466,42,3,14,17,17.6%,20m
8030,3,[Rebеls]Rover,3466,30,2,2,4,50.0%,6m
8030,3,[NsuP]Cakerush,3466,30,2,3,5,40.0%,18m
8030,3,Neksus,3466,0,0,1,1,0.0%,29m
8030,2,[Li3]KosioOOSeven,3466,0,0,6,6,0.0%,6m
8046,2,oLoLo,3465,1487,120,109,229,52.4%,8m
8046,3,ShadowFury,3465,1177,58,57,115,50.4%,28m
8046,3,TheAnswer,3465,1380,50,53,103,48.5%,17m
8046,2,Ammoniak,3465,311,25,34,59,42.4%,9m
8046,3,Domtastic,3465,191,10,5,15,66.7%,16m
8046,3,JAMES,3465,192,8,7,15,53.3%,5m
8046,3,TittyTwister,3465,220,8,7,15,53.3%,4m
8046,3,xlPaRaNoiiDz,3465,182,6,12,18,33.3%,9m
8046,3,[4Zergs]BaniaK,3465,86,4,4,8,50.0%,5m
8046,3,RainClouD,3465,30,2,5,7,28.6%,6m
8046,2,Iluvatar,3465,30,2,5,7,28.6%,16m
8046,2,Telo,3465,0,1,0,1,100.0%,17m
8046,3,kerasin,3465,0,1,0,1,100.0%,13m
8046,3,[ACEP]Edgar,3465,30,1,1,2,50.0%,4m
8060,2,ElSonny,3464,1585,310,302,612,50.7%,28m
8060,3,Fleshwound,3464,1474,266,248,514,51.8%,12m
8060,3,[UCH]Otouchan,3464,1580,136,113,249,54.6%,8m
8060,3,[GGnet]OMGnoob,3464,978,136,129,265,51.3%,20m
8060,2,Неимя,3464,1525,126,116,242,52.1%,19m
8060,2,dorald,3464,623,114,108,222,51.4%,6m
8060,2,llllllllllll,3464,1622,93,97,190,48.9%,16m
8060,2,Wrogashz,3464,1330,47,54,101,46.5%,13m
8060,2,[Diktat]JoLasticot,3464,754,23,45,68,33.8%,11m
8060,3,Max,3464,412,16,16,32,50.0%,16m
8060,3,[RushR]Xanom,3464,300,11,10,21,52.4%,4m
8060,3,CoronaSiska,3464,200,8,8,16,50.0%,13m
8060,3,[TBPZDA]Borodality,3464,30,2,4,6,33.3%,9m
8060,3,[bOvOd]VIOLstar,3464,0,1,0,1,100.0%,8m
8060,3,CraZyJ,3464,0,0,1,1,0.0%,8m
8075,3,[сSсǃ]WannaBeMyslf,3463,1580,97,75,172,56.4%,16m
8075,2,Udonator,3463,1352,62,54,116,53.4%,16m
8075,3,DrekHad,3463,788,34,26,60,56.7%,11m
8075,3,[Mysa]Möller,3463,329,12,8,20,60.0%,6m
8075,2,TiMson,3463,298,10,21,31,32.3%,3m
8075,3,[PLA2N]BrainDeadNoo,3463,217,8,2,10,80.0%,8m
8075,2,Dartti,3463,150,8,13,21,38.1%,7m
8075,3,Raspberry,3463,144,5,7,12,41.7%,17m
8075,2,[Trals]whApaddy,3463,155,4,2,6,66.7%,8m
8075,3,Deciso,3463,116,4,5,9,44.4%,41m
8075,3,Emilia,3463,0,1,0,1,100.0%,15m
8075,3,mishocii,3463,0,1,2,3,33.3%,13m
8075,3,[utG]Nanothec,3463,0,0,1,1,0.0%,41m
8075,3,[SÐ]Poulpator,3463,0,0,1,1,0.0%,11m
8075,3,[CFFF]Flasher,3463,0,0,1,1,0.0%,12m
8075,3,[Bwolfs]WarMachine,3463,0,0,1,1,0.0%,41m
8075,1,[FrF]NoeeeeeeD,3463,0,0,2,2,0.0%,23m
8092,2,Ghostproject,3462,1441,245,220,465,52.7%,3m
8092,3,Tof,3462,1244,210,198,408,51.5%,15m
8092,3,[lBSGl]Maksim,3462,1414,120,121,241,49.8%,4m
8092,3,trumpisbest,3462,1614,69,58,127,54.3%,15m
8092,2,JulS,3462,831,36,30,66,54.5%,20m
8092,3,Quarddo,3462,527,22,15,37,59.5%,13m
8092,3,Serensha,3462,288,10,9,19,52.6%,10m
8092,3,[BARJO]Dorsale,3462,118,4,8,12,33.3%,6m
8092,3,DarthVaid,3462,62,3,4,7,42.9%,28m
8092,3,Walian,3462,30,2,4,6,33.3%,14m
8092,3,StarWolf,3462,0,1,0,1,100.0%,20m
8092,3,LiCh,3462,30,1,1,2,50.0%,13m
8092,3,Vasilisck,3462,0,0,1,1,0.0%,28m
8092,3,[QDoSai]Chrlie,3462,0,0,1,1,0.0%,9m
8092,2,ВялыйБейлинг,3462,0,0,2,2,0.0%,28m
8092,3,[BckPlt]martelnobi,3462,0,0,3,3,0.0%,27m
8092,3,[mTx]NeMe,3462,0,0,4,4,0.0%,3m
8109,1,[PaniC]scnightfire,3461,1014,465,491,956,48.6%,19m
8109,3,SupremeNisse,3461,1583,182,162,344,52.9%,28m
8109,1,[ØC]PRAQ,3461,1550,55,81,136,40.4%,8m
8109,2,[Furcel]buch,3461,673,35,27,62,56.5%,20m
8109,2,[Jyh]Photonburst,3461,876,30,37,67,44.8%,20m
8109,3,[HBGSJR]Retaliator,3461,307,25,24,49,51.0%,20m
8109,3,Jailer,3461,407,17,12,29,58.6%,15m
8109,3,Maffnat,3461,300,11,11,22,50.0%,17m
8109,3,Gume,3461,114,4,4,8,50.0%,14m
8109,3,readme,3461,0,1,0,1,100.0%,18m
8109,2,Hisoka,3461,0,1,0,1,100.0%,12m
8109,3,Liquid,3461,0,1,3,4,25.0%,13m
8109,3,PoBoMMA,3461,0,0,1,1,0.0%,3m
8109,3,VastoLorde,3461,0,0,1,1,0.0%,5m
8109,3,SunLight,3461,0,0,1,1,0.0%,5m
8109,3,Ksilon,3461,0,0,1,1,0.0%,5m
8125,2,Brainbug,3460,1511,588,562,1150,51.1%,16m
8125,2,[uCHAD]dvsealwasl,3460,1513,283,276,559,50.6%,17m
8125,3,[WE420]TiSpundu,3460,381,130,88,218,59.6%,19m
8125,3,SugarPuff,3460,1663,77,68,145,53.1%,19m
8125,3,[PLA2N]Nontar,3460,794,29,29,58,50.0%,5m
8125,3,[xp]defnitelyume,3460,381,16,12,28,57.1%,12m
8125,3,tito,3460,380,15,7,22,68.2%,9m
8125,2,Ankö,3460,229,9,5,14,64.3%,12m
8125,2,Maltese,3460,329,9,17,26,34.6%,7m
8125,3,Tholonas,3460,148,6,7,13,46.2%,16m
8125,3,[Ехprt]VerybBigBoom,3460,58,3,0,3,100.0%,13m
8125,3,[FMG]Tyralisk,3460,60,3,1,4,75.0%,17m
8125,3,[B1C]Artwenki,3460,55,3,3,6,50.0%,16m
8125,2,irnbro,3460,60,3,9,12,25.0%,20m
8125,3,[NADEON]TerranOP,3460,30,2,0,2,100.0%,28m
8125,3,[Sm0Q]Mmitch,3460,0,1,0,1,100.0%,4m
8125,3,[ffddfd]IIIIIIIIIIII,3460,0,0,1,1,0.0%,14m
8125,3,[IEASYI]Crafter,3460,0,0,3,3,0.0%,18m
8143,3,Budis,3459,370,17,10,27,63.0%,3m
8143,3,DkNeeD,3459,297,14,7,21,66.7%,4m
8143,3,Doomshroom,3459,86,4,1,5,80.0%,17m
8143,2,Laplada,3459,0,3,6,9,33.3%,6m
8143,3,apple,3459,0,1,0,1,100.0%,4m
8143,3,PinZaaar,3459,0,1,0,1,100.0%,7m
8143,3,HopY,3459,0,1,1,2,50.0%,15m
8143,3,Qbamax,3459,0,0,1,1,0.0%,18m
8143,3,Broronavirus,3459,0,0,1,1,0.0%,13m
8143,3,zeleboba,3459,0,0,1,1,0.0%,11m
8143,3,mutu,3459,0,0,5,5,0.0%,27m
8154,3,LIfeLover,3458,1335,118,101,219,53.9%,9m
8154,3,knedlík,3458,890,54,43,97,55.7%,9m
8154,3,Orix,3458,394,16,8,24,66.7%,10m
8154,3,[ST]Life,3458,86,4,2,6,66.7%,3m
8154,3,svampbob,3458,92,4,6,10,40.0%,42m
8154,3,LuckyTiger,3458,60,3,5,8,37.5%,11m
8154,3,BlekFater,3458,30,2,1,3,66.7%,10m
8154,3,[GALA]Burhan,3458,0,1,0,1,100.0%,5m
8154,3,[L1T]sYnthyyyTV,3458,0,0,1,1,0.0%,14m
8163,3,[WCKYLN]katzbalger,3457,1505,124,102,226,54.9%,3m
8163,3,derFeind,3457,695,31,18,49,63.3%,6m
8163,3,dAmnum,3457,307,30,31,61,49.2%,28m
8163,3,[LAMPA]ValertinG,3457,492,19,18,37,51.4%,5m
8163,3,[lMMl]Belgarath,3457,256,10,7,17,58.8%,17m
8163,3,ZimnyMarian,3457,166,6,2,8,75.0%,15m
8163,3,[W33B]Soares,3457,173,5,5,10,50.0%,42m
8163,3,[AsMu]Yodri,3457,30,2,2,4,50.0%,41m
8163,3,[ENGNS]RandomGüffel,3457,0,1,0,1,100.0%,20m
8163,3,wanted,3457,30,1,1,2,50.0%,14m
8163,3,drunkenJedi,3457,30,1,2,3,33.3%,27m
8163,3,Spapa,3457,0,0,1,1,0.0%,10m
8163,3,MadBoyScout,3457,0,0,2,2,0.0%,13m
8176,2,Jezzular,3456,1602,82,89,171,48.0%,17m
8176,3,Ecphelion,3456,820,64,60,124,51.6%,20m
8176,3,SapsaN,3456,834,33,31,64,51.6%,9m
8176,2,Lagoonie,3456,418,14,23,37,37.8%,6m
8176,1,[FGDU]Verus,3456,137,3,2,5,60.0%,12m
8176,3,LastSamurai,3456,0,1,0,1,100.0%,18m
8176,3,Dahl,3456,30,1,3,4,25.0%,3m
8183,2,[PLA2N]barcode,3455,1567,122,111,233,52.4%,17m
8183,3,[RUSMÜL]GeileKuh,3455,1130,55,55,110,50.0%,13m
8183,2,[Рачелы]Seesker,3455,730,25,30,55,45.5%,20m
8183,3,[OnaCHe]Delly,3455,425,18,7,25,72.0%,14m
8183,2,zeradun,3455,336,12,15,27,44.4%,7m
8183,3,Zeratul,3455,86,7,2,9,77.8%,13m
8183,2,JohnyPony,3455,84,7,12,19,36.8%,9m
8183,3,[ZFOX]Snap,3455,114,4,2,6,66.7%,42m
8183,3,[ZЕRGML]AxepeTb,3455,0,1,0,1,100.0%,41m
8183,3,[TTAOA]ELDEN,3455,0,0,1,1,0.0%,41m
8183,3,[T1ttS]Gaisha,3455,0,0,2,2,0.0%,8m
8183,3,OnlySP,3455,0,0,3,3,0.0%,16m
8195,2,Arikson,3454,1603,198,180,378,52.4%,20m
8195,3,Tetra,3454,458,33,30,63,52.4%,18m
8195,3,[EmŦ]Dart,3454,432,18,10,28,64.3%,29m
8195,3,Raczo,3454,298,14,7,21,66.7%,3m
8195,3,RudiBrudi,3454,206,11,10,21,52.4%,42m
8195,3,Ugnetatel,3454,241,11,16,27,40.7%,3m
8195,3,[JKRUA]TnT,3454,252,10,8,18,55.6%,9m
8195,3,[GFLG]Vavar,3454,120,5,5,10,50.0%,11m
8195,3,[Heroes]immOrTaL,3454,86,3,2,5,60.0%,6m
8195,3,Lovorko,3454,30,2,0,2,100.0%,14m
8195,3,cubiicubii,3454,30,1,3,4,25.0%,8m
8195,3,[TheDOH]badbug,3454,0,0,1,1,0.0%,4m
8195,3,[voff]Eclipse,3454,0,0,2,2,0.0%,5m
8195,3,[LОLI]tabletochka,3454,0,0,2,2,0.0%,19m
8195,3,Nightgarden,3454,0,0,5,5,0.0%,11m
8210,3,JJson,3453,1284,281,258,539,52.1%,8m
8210,2,[VetM]Flaa,3453,1569,269,283,552,48.7%,41m
8210,2,[TMGM]Shadow,3453,815,111,114,225,49.3%,4m
8210,2,MewNik,3453,884,87,86,173,50.3%,4m
8210,2,[HaT]Jaguar,3453,911,70,81,151,46.4%,41m
8210,3,FluffyTurtle,3453,908,34,36,70,48.6%,29m
8210,3,Quantum,3453,124,5,7,12,41.7%,13m
8210,3,bämLee,3453,116,4,2,6,66.7%,20m
8210,3,Wackd,3453,0,1,0,1,100.0%,11m
8210,3,CptnFleming,3453,0,1,1,2,50.0%,8m
8210,3,Stef,3453,30,1,2,3,33.3%,20m
8210,3,loodan,3453,30,1,6,7,14.3%,6m
8210,3,[StmT]KingofQueens,3453,0,0,1,1,0.0%,5m
8210,3,[Arrows]Metvix,3453,0,0,1,1,0.0%,5m
8224,3,ЕдкийГоблин,3452,1485,172,155,327,52.6%,13m
8224,3,neltharion,3452,1122,52,50,102,51.0%,16m
8224,3,uggeh,3452,677,27,16,43,62.8%,29m
8224,3,Shikari,3452,668,24,23,47,51.1%,15m
8224,3,Solve,3452,640,23,26,49,46.9%,11m
8224,3,LiquidFlem,3452,410,17,3,20,85.0%,18m
8224,1,[BIT]Tchubb,3452,273,13,7,20,65.0%,20m
8224,3,Titan,3452,145,8,1,9,88.9%,28m
8224,3,Stimmur,3452,166,7,2,9,77.8%,19m
8224,3,GoHard,3452,172,6,8,14,42.9%,19m
8224,3,PsychicAnt,3452,114,5,4,9,55.6%,41m
8224,3,[vHr]niiBeR,3452,58,3,3,6,50.0%,6m
8224,3,[Gr0s]DoubleMiP,3452,30,2,2,4,50.0%,28m
8224,1,JuliusCaesar,3452,0,2,3,5,40.0%,10m
8224,1,[1202]LucaRamon,3452,0,2,6,8,25.0%,26m
8224,3,[GOLDPL]LIMONAD,3452,0,1,0,1,100.0%,14m
8224,3,Liddo,3452,0,0,1,1,0.0%,16m
8224,3,[NLTN]thedude,3452,0,0,1,1,0.0%,14m
8242,2,Zav,3451,721,96,95,191,50.3%,28m
8242,3,Enlight,3451,730,76,62,138,55.1%,16m
8242,3,[FF4L]wurstragu,3451,1036,39,40,79,49.4%,41m
8242,2,[TKRs]houser,3451,870,30,37,67,44.8%,16m
8242,3,[VKY]EasterLeg,3451,244,9,7,16,56.2%,14m
8242,3,[SUUUUS]DarkMaster,3451,146,5,10,15,33.3%,10m
8242,2,[OOWW]RMziom,3451,66,4,13,17,23.5%,13m
8242,3,Nuu,3451,30,2,1,3,66.7%,3m
8242,3,Stallm,3451,60,2,2,4,50.0%,8m
8242,3,Merckxism,3451,0,2,3,5,40.0%,11m
8242,3,SchLenK,3451,30,1,7,8,12.5%,3m
8253,2,jachuu,3450,637,86,71,157,54.8%,11m
8253,2,Aspicherie,3450,1533,71,76,147,48.3%,18m
8253,3,FleIIIka,3450,405,34,30,64,53.1%,42m
8253,2,Growz,3450,225,9,3,12,75.0%,17m
8253,3,david,3450,159,8,5,13,61.5%,16m
8253,3,Sloth,3450,202,7,11,18,38.9%,27m
8253,3,[ÐTM]HeldVomFeld,3450,88,3,4,7,42.9%,11m
8253,3,[FSeS]Barry,3450,58,2,8,10,20.0%,19m
8253,3,[T4E]Cabbage,3450,0,1,0,1,100.0%,14m
8253,3,Picasssso,3450,30,1,3,4,25.0%,10m
8253,2,[LqT]Whykiller,3450,0,0,1,1,0.0%,12m
8253,3,[Xa]MugeN,3450,0,0,1,1,0.0%,3m
8253,3,Tungdil,3450,0,0,5,5,0.0%,13m
8266,3,[VVN]Plume,3449,1584,63,66,129,48.8%,3m
8266,3,tpj,3449,730,29,25,54,53.7%,18m
8266,3,WilliMC,3449,209,7,13,20,35.0%,13m
8266,3,[Ouch]Yalung,3449,0,1,0,1,100.0%,6m
8266,3,IIIIIIIIII,3449,0,1,4,5,20.0%,6m
8266,3,Anvi,3449,0,0,1,1,0.0%,5m
8266,3,Ønizuka,3449,0,0,1,1,0.0%,13m
8273,2,[HRoP]drclaus,3448,1566,229,240,469,48.8%,3m
8273,3,Dan,3448,790,208,184,392,53.1%,9m
8273,2,Nalan,3448,1574,159,143,302,52.6%,14m
8273,3,[NINJ88]Scorpion,3448,1110,44,37,81,54.3%,9m
8273,3,zaft,3448,822,43,39,82,52.4%,20m
8273,3,Kroyd,3448,834,32,35,67,47.8%,14m
8273,2,IMGsaibh,3448,653,24,28,52,46.2%,6m
8273,3,[MRQC]BlindBuzzz,3448,482,21,14,35,60.0%,27m
8273,3,[FTBS]zörgøn,3448,364,17,9,26,65.4%,12m
8273,3,Nicholosso,3448,428,17,13,30,56.7%,14m
8273,2,TheDestroyer,3448,321,16,13,29,55.2%,10m
8273,3,nvasion,3448,146,6,2,8,75.0%,28m
8273,3,КуртКобейн,3448,156,6,9,15,40.0%,15m
8273,3,Tawa,3448,88,5,4,9,55.6%,5m
8273,2,[TMLT]LateNuke,3448,128,4,16,20,20.0%,3m
8273,3,Amnesia,3448,0,3,4,7,42.9%,5m
8273,3,[Heroes]BreaDy,3448,58,2,1,3,66.7%,5m
8273,3,SCTrenev,3448,58,2,3,5,40.0%,42m
8273,3,gautgoth,3448,58,2,6,8,25.0%,5m
8273,3,Yoshi,3448,0,0,1,1,0.0%,8m
8273,3,blackspirit,3448,0,0,3,3,0.0%,20m
8273,3,[bod]JaggaJax,3448,0,0,3,3,0.0%,10m
8295,3,Gnoba,3447,1591,265,256,521,50.9%,9m
8295,2,rcxdude,3447,1440,171,149,320,53.4%,20m
8295,2,ÖStepOÖ,3447,543,44,46,90,48.9%,8m
8295,2,Clown,3447,521,22,19,41,53.7%,5m
8295,2,[ЭЩКЕРЕ]EvilGrandPA,3447,80,10,18,28,35.7%,11m
8295,3,HöligGung,3447,116,8,3,11,72.7%,3m
8295,3,Хан,3447,189,7,4,11,63.6%,41m
8295,3,HypnotiX,3447,144,5,4,9,55.6%,28m
8295,3,scr,3447,60,3,2,5,60.0%,3m
8295,3,DarHaz,3447,30,2,1,3,66.7%,42m
8295,3,[G0UDA]Tarascan,3447,0,2,6,8,25.0%,10m
8306,2,[aW]Sins,3446,1541,114,109,223,51.1%,10m
8306,3,abc,3446,720,28,23,51,54.9%,7m
8306,3,[PiGPan]SieMichAuch,3446,400,14,17,31,45.2%,10m
8306,3,[GROSEX]Snakiss,3446,210,7,5,12,58.3%,4m
8306,2,eThnA,3446,216,7,20,27,25.9%,13m
8306,3,Fifty,3446,120,6,6,12,50.0%,19m
8306,2,Stressling,3446,154,5,14,19,26.3%,4m
8306,1,[IceHus]Oxsirion,3446,0,4,2,6,66.7%,5m
8306,3,mcC,3446,60,3,1,4,75.0%,12m
8306,3,Raiminho,3446,60,3,2,5,60.0%,11m
8306,3,[rush77]MassLings,3446,30,1,1,2,50.0%,28m
8306,3,[IceHus]shiper,3446,0,1,4,5,20.0%,5m
8306,3,[4GAZ]Beignet,3446,0,0,1,1,0.0%,16m
8319,3,Kratos,3445,972,86,81,167,51.5%,12m
8319,3,ZeNn,3445,596,22,24,46,47.8%,16m
8319,3,ddasd,3445,516,21,16,37,56.8%,16m
8319,2,[MSUSC2]eferalgan,3445,512,17,28,45,37.8%,6m
8319,1,INNNNoVatioN,3445,222,6,3,9,66.7%,3m
8319,2,Badsky,3445,0,5,2,7,71.4%,5m
8319,3,SunnyDay,3445,169,5,5,10,50.0%,13m
8319,1,[CL3]Ares,3445,97,3,7,10,30.0%,20m
8319,3,[N00BB]Irep,3445,97,2,1,3,66.7%,10m
8319,3,CrabiTTo,3445,0,1,1,2,50.0%,29m
8319,3,[ESSEL]DeeDan,3445,0,0,1,1,0.0%,26m
8319,3,Maras,3445,0,0,2,2,0.0%,5m
8319,3,[W00F]PuppyDog,3445,0,0,2,2,0.0%,17m
8332,2,Dredmegakill,3444,1511,370,368,738,50.1%,6m
8332,2,[AiRǂ]ivelios,3444,1627,323,316,639,50.5%,9m
8332,2,KindOfBlue,3444,1578,258,256,514,50.2%,41m
8332,2,Komodo,3444,1482,107,97,204,52.5%,5m
8332,3,[BRSKR]Blade,3444,1323,86,66,152,56.6%,13m
8332,2,[PiGPan]Zrana,3444,856,48,57,105,45.7%,11m
8332,3,[улей55]Steelwar,3444,488,20,7,27,74.1%,17m
8332,3,[IceHus]Begemotik,3444,318,13,4,17,76.5%,11m
8332,3,BlackBread,3444,300,11,10,21,52.4%,13m
8332,3,[Z3RGML]Shadow,3444,144,7,2,9,77.8%,16m
8332,3,[Sarmat]RisingSun,3444,166,6,3,9,66.7%,5m
8332,3,[Fruz]Striker,3444,88,5,10,15,33.3%,20m
8332,3,[ApeT]Bändschie,3444,30,1,6,7,14.3%,6m
8332,3,[QTclub]Oecophylla,3444,0,0,2,2,0.0%,7m
8346,3,FraGor,3443,1628,240,237,477,50.3%,4m
8346,2,[CCAV]Enro,3443,1240,54,54,108,50.0%,6m
8346,3,Jerenko,3443,497,36,23,59,61.0%,15m
8346,3,ghosty,3443,283,12,6,18,66.7%,28m
8346,3,DarkVoice,3443,114,4,1,5,80.0%,27m
8346,3,SKYLINE,3443,0,1,0,1,100.0%,15m
8346,3,PenisInUrMoM,3443,0,1,0,1,100.0%,41m
8346,3,[GdAT]ScarlettUK,3443,30,1,3,4,25.0%,8m
8346,3,[Дядя]AzureDream,3443,0,0,1,1,0.0%,27m
8346,3,Emperor,3443,0,0,1,1,0.0%,19m
8346,3,Summer,3443,0,0,1,1,0.0%,20m
8346,3,NIEU,3443,0,0,2,2,0.0%,6m
8346,1,[D7P]Ekitai,3443,0,0,2,2,0.0%,17m
8359,2,LImE,3442,1520,228,192,420,54.3%,41m
8359,2,AskYani,3442,923,166,164,330,50.3%,5m
8359,2,[INAE]RamZesKTS,3442,1445,145,146,291,49.8%,4m
8359,2,Shren,3442,1315,113,128,241,46.9%,13m
8359,2,Rezhu,3442,1420,70,69,139,50.4%,12m
8359,3,[1239]Xenon,3442,1351,67,72,139,48.2%,20m
8359,3,IIIIIIIIIIII,3442,1087,42,37,79,53.2%,7m
8359,3,Beansies,3442,732,35,34,69,50.7%,5m
8359,3,Shegin,3442,708,26,24,50,52.0%,13m
8359,3,[NWGD]LЁva,3442,423,19,12,31,61.3%,16m
8359,3,Midgard,3442,392,15,3,18,83.3%,5m
8359,2,BBAlien,3442,194,10,3,13,76.9%,3m
8359,3,isaacKantz,3442,60,2,3,5,40.0%,19m
8359,3,TDNaYaNnoO,3442,0,0,2,2,0.0%,3m
8373,2,[wiGGa]DemiGodlv,3441,1390,96,98,194,49.5%,9m
8373,3,salah,3441,828,90,74,164,54.9%,8m
8373,3,PinGponGnE,3441,1074,82,50,132,62.1%,13m
8373,3,Fatamorgana,3441,580,23,22,45,51.1%,5m
8373,3,[КОМУНА]Sandman,3441,400,18,10,28,64.3%,10m
8373,3,[Cloaca]Gape,3441,182,10,5,15,66.7%,6m
8373,2,kWarta,3441,296,9,16,25,36.0%,4m
8373,2,shtopr,3441,0,1,0,1,100.0%,10m
8373,2,bIS,3441,42,1,3,4,25.0%,3m
8373,3,Evoke,3441,0,0,1,1,0.0%,42m
8373,3,Stelios,3441,0,0,5,5,0.0%,7m
8384,3,[MGALS]MirandasMom,3440,1329,99,102,201,49.3%,11m
8384,2,MacroLangelo,3440,1396,54,57,111,48.6%,28m
8384,3,ATuaMaeDQuat,3440,195,19,12,31,61.3%,7m
8384,3,aGiLe,3440,281,13,9,22,59.1%,10m
8384,3,Kerrigan,3440,290,11,13,24,45.8%,26m
8384,3,Rowannn,3440,244,10,6,16,62.5%,6m
8384,3,pingEling,3440,240,10,10,20,50.0%,28m
8384,3,Pferdle,3440,149,6,1,7,85.7%,11m
8384,3,Obdachloser,3440,44,6,2,8,75.0%,11m
8384,3,[Pönös]Archernar,3440,154,5,10,15,33.3%,10m
8384,2,Adjutant,3440,122,5,13,18,27.8%,11m
8384,3,Vision,3440,86,3,3,6,50.0%,41m
8384,3,yety,3440,86,3,4,7,42.9%,19m
8384,3,inkame,3440,30,2,0,2,100.0%,9m
8384,3,Effect,3440,30,2,2,4,50.0%,5m
8384,3,Moscow,3440,0,1,1,2,50.0%,18m
8384,3,BadTrïp,3440,30,1,4,5,20.0%,9m
8384,3,Windowsuser,3440,0,0,1,1,0.0%,6m
8384,3,Cybaer,3440,0,0,3,3,0.0%,13m
8403,3,Lilo,3439,1679,99,79,178,55.6%,4m
8403,3,vladddddd,3439,921,94,87,181,51.9%,14m
8403,3,[EYSAT]ARTq,3439,429,35,25,60,58.3%,9m
8403,3,[1FU2]Shinobi,3439,826,31,32,63,49.2%,4m
8403,3,[HsDL]Trebo,3439,762,29,30,59,49.2%,4m
8403,3,PapaMisty,3439,251,25,19,44,56.8%,9m
8403,2,CoronaVirus,3439,274,10,21,31,32.3%,7m
8403,3,DefenderJ,3439,60,2,3,5,40.0%,5m
8403,3,[HøTV]Zenex,3439,0,1,1,2,50.0%,9m
8403,3,Almore,3439,0,0,1,1,0.0%,9m
8403,3,[xIS3x]Shaddy,3439,0,0,1,1,0.0%,19m
8403,3,STAR,3439,0,0,1,1,0.0%,3m
8415,2,Constantin,3438,1532,364,354,718,50.7%,10m
8415,3,player,3438,1043,50,38,88,56.8%,11m
8415,2,MintCondish,3438,667,26,38,64,40.6%,20m
8415,3,ReppagekiPH,3438,432,19,12,31,61.3%,6m
8415,3,Ork,3438,522,19,15,34,55.9%,5m
8415,2,THKKEN,3438,167,8,3,11,72.7%,9m
8415,3,Romb,3438,161,7,3,10,70.0%,12m
8415,3,[XDD]Nyaaa,3438,192,7,8,15,46.7%,20m
8415,3,Andi,3438,172,6,4,10,60.0%,13m
8415,3,ПростоЧел,3438,116,4,8,12,33.3%,4m
8415,3,Arkyon,3438,30,2,1,3,66.7%,19m
8415,3,[LitCru]sergeEBURG,3438,30,1,1,2,50.0%,8m
8415,3,duBbY,3438,30,1,3,4,25.0%,18m
8415,3,Brothers,3438,0,0,2,2,0.0%,9m
8429,3,[FЂІ]Durag,3437,708,49,37,86,57.0%,11m
8429,2,arvak,3437,1248,49,58,107,45.8%,28m
8429,2,[l4Nl]RenardBleu,3437,835,39,34,73,53.4%,4m
8429,3,[SquafN]KaRkhas,3437,145,7,2,9,77.8%,28m
8429,3,Fondue,3437,114,5,4,9,55.6%,3m
8429,2,TNT,3437,116,5,21,26,19.2%,12m
8429,3,piry,3437,0,1,0,1,100.0%,6m
8429,3,Juloowewoo,3437,0,1,0,1,100.0%,11m
8429,3,[WGTG]zurgie,3437,0,0,1,1,0.0%,19m
8429,3,Alrik,3437,0,0,2,2,0.0%,9m
8429,3,Abathur,3437,0,0,2,2,0.0%,12m
8440,3,febryd,3436,1138,158,127,285,55.4%,12m
8440,3,Ripley,3436,1439,113,94,207,54.6%,18m
8440,3,nasenbr,3436,1510,103,92,195,52.8%,8m
8440,3,Trekala,3436,728,33,21,54,61.1%,15m
8440,3,[OLDbad]deesh,3436,778,31,27,58,53.4%,20m
8440,3,Angel,3436,782,30,24,54,55.6%,11m
8440,3,SgtSchwabbel,3436,507,21,10,31,67.7%,19m
8440,3,WorstGamerEU,3436,360,16,7,23,69.6%,12m
8440,3,[xProx]UnSkilled,3436,196,7,8,15,46.7%,14m
8440,3,ilovedesign,3436,60,5,3,8,62.5%,16m
8440,3,[lmGl]Anglahr,3436,114,4,6,10,40.0%,8m
8440,3,[PHØMUI]Eran,3436,116,4,9,13,30.8%,26m
8440,3,[PdGI]FeraSouder,3436,0,1,0,1,100.0%,14m
8440,3,[Wolven]WoLDeX,3436,0,0,1,1,0.0%,16m
8454,3,Nick,3435,1514,94,78,172,54.7%,3m
8454,2,[FOX]rahmu,3435,1443,66,64,130,50.8%,10m
8454,3,imNOOBsorry,3435,591,38,32,70,54.3%,8m
8454,3,sawya,3435,856,38,41,79,48.1%,11m
8454,3,Pikaa,3435,660,23,28,51,45.1%,12m
8454,3,MrChocolat,3435,378,18,8,26,69.2%,14m
8454,3,wozuiji,3435,220,8,6,14,57.1%,28m
8454,3,[ArchTV]Monarchy,3435,49,4,4,8,50.0%,15m
8454,3,GoYa,3435,62,3,6,9,33.3%,5m
8454,3,[Snax]crsy,3435,0,0,1,1,0.0%,26m
8454,3,[WcK]Goldmember,3435,0,0,1,1,0.0%,19m
8454,3,Zorro,3435,0,0,1,1,0.0%,28m
8454,3,[sp1r1t]GOstVladO,3435,0,0,1,1,0.0%,28m
8454,3,[GoTp]PolskiGracz,3435,0,0,1,1,0.0%,18m
8468,3,BodyBag,3434,1650,143,133,276,51.8%,20m
8468,2,[HZRD]Gamrok,3434,478,45,51,96,46.9%,8m
8468,3,Derand,3434,990,40,33,73,54.8%,8m
8468,3,HyperNEAT,3434,635,26,19,45,57.8%,28m
8468,2,[FGDSN]Vulcius,3434,91,26,26,52,50.0%,7m
8468,3,Bosain,3434,602,23,20,43,53.5%,12m
8468,2,Rizell,3434,292,14,10,24,58.3%,14m
8468,3,Fettoni,3434,245,11,8,19,57.9%,4m
8468,3,[TONGJI]Major,3434,161,6,6,12,50.0%,28m
8468,3,[ZelO]Twellve,3434,184,6,12,18,33.3%,27m
8468,3,SuJi,3434,30,4,3,7,57.1%,28m
8468,3,MindSwarm,3434,58,2,4,6,33.3%,28m
8468,3,BrickBazuka,3434,0,1,0,1,100.0%,8m
8468,3,[A0i]Miyamori,3434,0,0,1,1,0.0%,9m
8468,3,Goku,3434,0,0,1,1,0.0%,13m
8468,3,link,3434,0,0,1,1,0.0%,19m
8468,3,WhiteAlbino,3434,0,0,2,2,0.0%,8m
8485,2,Nephrithos,3433,1394,89,93,182,48.9%,12m
8485,3,LELUK,3433,1000,68,44,112,60.7%,28m
8485,2,TheDarkWing,3433,1231,46,52,98,46.9%,16m
8485,3,kubajz,3433,464,18,21,39,46.2%,13m
8485,3,HCAllAlone,3433,391,16,3,19,84.2%,4m
8485,3,[RTDS]Néréïde,3433,278,10,9,19,52.6%,41m
8485,3,[CurryW]Praetor,3433,274,10,12,22,45.5%,16m
8485,2,Hylet,3433,142,9,4,13,69.2%,18m
8485,3,[SaneGG]Wayne,3433,232,7,4,11,63.6%,13m
8485,3,[SwK]КАРАКУРТ,3433,142,6,5,11,54.5%,9m
8485,3,Molag,3433,172,6,10,16,37.5%,27m
8485,3,LittleAksMax,3433,144,5,5,10,50.0%,19m
8485,2,Stryker,3433,0,4,4,8,50.0%,7m
8485,2,JTY,3433,60,3,6,9,33.3%,15m
8485,3,[Peeps]Christiaan,3433,58,2,2,4,50.0%,29m
8485,3,ƷØƷ,3433,0,0,3,3,0.0%,13m
8485,3,[PDRFCE]Therion,3433,0,0,8,8,0.0%,5m
8502,3,BlackBear,3432,1602,392,372,764,51.3%,13m
8502,3,[Jeth]Raptor,3432,1474,77,74,151,51.0%,29m
8502,3,[PLA2N]MiHanoid,3432,898,34,31,65,52.3%,16m
8502,3,DrunkAccount,3432,518,21,17,38,55.3%,12m
8502,3,AnDiii,3432,382,15,13,28,53.6%,6m
8502,3,Nyrox,3432,242,10,2,12,83.3%,8m
8502,3,Azerua,3432,244,10,3,13,76.9%,9m
8502,3,NeoMJay,3432,0,5,1,6,83.3%,4m
8502,3,Atesz,3432,140,5,2,7,71.4%,27m
8502,3,dasRabid,3432,58,3,4,7,42.9%,9m
8502,3,[impro]Natasat,3432,30,2,5,7,28.6%,11m
8502,3,SKYTOSS,3432,62,2,6,8,25.0%,5m
8502,3,[JKV]AlexisSensei,3432,0,1,0,1,100.0%,4m
8502,3,Fadroma,3432,0,0,1,1,0.0%,5m
8502,3,[FZ1]Yarocker,3432,0,0,1,1,0.0%,12m
8502,3,HaWK,3432,0,0,6,6,0.0%,3m
8518,2,TheOne,3431,1580,250,246,496,50.4%,16m
8518,3,goonix,3431,1480,103,76,179,57.5%,9m
8518,3,SonOfMogh,3431,1621,70,73,143,49.0%,14m
8518,3,tazer,3431,1330,51,54,105,48.6%,20m
8518,3,[LFOFS]bugz,3431,816,37,25,62,59.7%,13m
8518,3,Nanatzuja,3431,490,20,20,40,50.0%,41m
8518,3,Gambos,3431,428,18,7,25,72.0%,8m
8518,3,Civilian,3431,288,10,10,20,50.0%,16m
8518,3,JungleFever,3431,272,10,15,25,40.0%,5m
8518,3,bluQ,3431,114,5,2,7,71.4%,19m
8518,3,[MvN]Maxfab,3431,118,4,9,13,30.8%,13m
8518,3,Suppaa,3431,30,2,2,4,50.0%,14m
8518,3,[OXs]Hyppox,3431,30,1,3,4,25.0%,13m
8531,2,ArcFlare,3430,1148,235,234,469,50.1%,28m
8531,3,GentleMinty,3430,268,41,46,87,47.1%,8m
8531,2,[ZERG7V]Adamsik,3430,696,39,34,73,53.4%,12m
8531,2,Alon,3430,600,32,34,66,48.5%,41m
8531,3,[xCvEx]eKrunD,3430,339,26,26,52,50.0%,8m
8531,3,DABO,3430,417,21,14,35,60.0%,6m
8531,3,TrueHorizons,3430,120,4,9,13,30.8%,11m
8531,3,Coussin,3430,143,3,3,6,50.0%,11m
8531,1,[ÄZDE]Demtyco,3430,113,2,1,3,66.7%,6m
8531,2,[TEF]Starbugs,3430,134,2,2,4,50.0%,5m
8531,3,[ябог]КожаныйМешок,3430,0,1,0,1,100.0%,17m
8531,3,BestAtMe,3430,0,1,0,1,100.0%,7m
8531,3,FlavourFavor,3430,30,1,2,3,33.3%,17m
8531,3,[EAU]nesquick,3430,0,0,1,1,0.0%,19m
8531,3,[KBС]Innokenty,3430,0,0,2,2,0.0%,5m
8531,3,glhf,3430,0,0,2,2,0.0%,7m
8547,2,[зерно]zealous,3429,1538,157,156,313,50.2%,16m
8547,3,Sheeperich,3429,1111,72,60,132,54.5%,18m
8547,2,Technics,3429,1452,69,75,144,47.9%,14m
8547,3,TuffCustomer,3429,836,59,43,102,57.8%,5m
8547,3,[lOoOl]foREVer,3429,684,30,17,47,63.8%,18m
8547,3,DönerWilli,3429,802,28,29,57,49.1%,4m
8547,2,[PabO]Älkøra,3429,546,19,29,48,39.6%,28m
8547,3,BrutalBeaver,3429,172,9,1,10,90.0%,14m
8547,3,bamsic,3429,0,4,1,5,80.0%,28m
8547,3,Wingit,3429,92,3,5,8,37.5%,42m
8547,3,teddybear,3429,0,1,0,1,100.0%,10m
8547,3,[DrNost]Dinain,3429,0,1,1,2,50.0%,4m
8547,3,Miii,3429,30,1,3,4,25.0%,41m
8547,2,GrandMister,3429,0,1,5,6,16.7%,20m
8547,3,Harvester,3429,0,0,5,5,0.0%,5m
8562,2,Gafurus,3428,1548,372,369,741,50.2%,3m
8562,3,[MDM4]Freshbread,3428,726,32,17,49,65.3%,6m
8562,3,Kiarna,3428,762,32,29,61,52.5%,3m
8562,3,[IceHus]LiquidWoo,3428,522,23,15,38,60.5%,9m
8562,3,Kolumn,3428,309,14,9,23,60.9%,8m
8562,3,Altaires,3428,159,8,3,11,72.7%,15m
8562,3,[WRG]Carnyfex,3428,208,7,10,17,41.2%,26m
8562,3,MorphiX,3428,60,3,1,4,75.0%,29m
8562,3,WoahPasssan,3428,0,1,0,1,100.0%,12m
8562,3,[6FfG]aLiEn,3428,0,0,1,1,0.0%,13m
8562,3,[Кусь]нуненадо,3428,0,0,1,1,0.0%,3m
8573,3,Guigou,3427,1529,117,115,232,50.4%,9m
8573,3,[MSUSC2]Khadgar,3427,835,41,15,56,73.2%,27m
8573,3,ventel,3427,815,35,25,60,58.3%,4m
8573,2,Andy,3427,372,12,18,30,40.0%,5m
8573,3,pinya,3427,140,5,1,6,83.3%,13m
8573,3,StreamZZang,3427,118,4,3,7,57.1%,4m
8573,1,[BMPZ]uPǂSpotlight,3427,0,2,3,5,40.0%,43m
8573,3,[Scapin]Kikoulol,3427,0,0,1,1,0.0%,5m
8573,3,Lasbi,3427,0,0,1,1,0.0%,17m
8573,3,[Büsi]Excaligo,3427,0,0,1,1,0.0%,42m
8573,3,[HIYYYA]Juked,3427,0,0,5,5,0.0%,15m
8584,3,[lMMl]Samo,3426,1574,207,168,375,55.2%,4m
8584,3,[Arrows]chiter,3426,1223,131,126,257,51.0%,3m
8584,3,DomKid,3426,1489,76,74,150,50.7%,42m
8584,3,[UKRA1N]Aibek,3426,1620,71,65,136,52.2%,11m
8584,2,DWARFRama,3426,1191,56,52,108,51.9%,12m
8584,3,[OC]Devak,3426,820,37,21,58,63.8%,3m
8584,3,IsTheNOnElse,3426,770,28,27,55,50.9%,19m
8584,3,[ǂǂǂǂǂ]Ustavson,3426,504,21,12,33,63.6%,3m
8584,3,IIIIIIIIIII,3426,283,12,20,32,37.5%,20m
8584,3,Robertoson,3426,279,10,6,16,62.5%,42m
8584,3,[JaPP]makatao,3426,125,8,8,16,50.0%,9m
8584,3,Sigontrue,3426,216,7,14,21,33.3%,19m
8584,3,DimX,3426,140,6,5,11,54.5%,9m
8584,3,[PИD]Clydefrog,3426,58,2,7,9,22.2%,26m
8584,3,JACMOC,3426,0,1,0,1,100.0%,16m
8584,3,StupidPig,3426,0,1,0,1,100.0%,10m
8584,3,llllllllllll,3426,0,1,2,3,33.3%,5m
8601,2,[hf4X4]RichMond,3425,1502,268,265,533,50.3%,8m
8601,1,Duck,3425,355,16,5,21,76.2%,15m
8601,3,KindBee,3425,278,10,6,16,62.5%,9m
8601,3,Alukard,3425,166,7,6,13,53.8%,16m
8601,3,[sfc]Ares,3425,150,5,13,18,27.8%,42m
8601,3,Singularity,3425,30,2,1,3,66.7%,11m
8601,3,Doomanek,3425,30,2,5,7,28.6%,13m
8601,3,DieMFDie,3425,30,1,2,3,33.3%,9m
8601,3,Sharper,3425,0,0,1,1,0.0%,16m
8601,3,Coral,3425,0,0,1,1,0.0%,4m
8601,3,Funmaster,3425,0,0,1,1,0.0%,11m
8612,3,ash,3424,1639,139,113,252,55.2%,4m
8612,3,BIgBean,3424,1064,112,93,205,54.6%,11m
8612,3,Rawlers,3424,741,45,37,82,54.9%,5m
8612,3,Нубас,3424,663,40,40,80,50.0%,11m
8612,3,Стараюсь,3424,552,31,18,49,63.3%,14m
8612,2,OnePurpleBee,3424,730,29,31,60,48.3%,28m
8612,3,VisseG,3424,302,15,8,23,65.2%,41m
8612,3,Atwarr,3424,170,7,7,14,50.0%,4m
8612,3,Blader,3424,100,5,4,9,55.6%,3m
8612,3,Astril,3424,30,1,2,3,33.3%,12m
8612,3,INnoVation,3424,0,0,1,1,0.0%,6m
8612,3,Moonbeam,3424,0,0,1,1,0.0%,18m
8624,3,Gizzard,3423,1145,77,63,140,55.0%,10m
8624,2,kSokSo,3423,763,30,39,69,43.5%,6m
8624,2,YourHighness,3423,806,28,36,64,43.8%,7m
8624,3,[BWArmy]Avicii,3423,356,13,9,22,59.1%,6m
8624,3,[GRiM]Sonny,3423,292,11,13,24,45.8%,12m
8624,3,[BeerTm]IIIIIIIIIIII,3423,265,9,8,17,52.9%,13m
8624,3,paiN,3423,0,5,1,6,83.3%,5m
8624,3,[HitPa]Shatter,3423,60,2,4,6,33.3%,20m
8624,3,TROMPADEFALO,3423,30,1,3,4,25.0%,16m
8624,3,[SkBG]Stacker,3423,30,1,9,10,10.0%,8m
8624,3,Eckipakang,3423,0,0,1,1,0.0%,8m
8624,3,ALT,3423,0,0,1,1,0.0%,4m
8624,3,[DelRay]NoiLliM,3423,0,0,1,1,0.0%,11m
8637,2,Yeezy,3422,1441,181,178,359,50.4%,9m
8637,3,Tzet,3422,1370,135,128,263,51.3%,8m
8637,3,Luckу,3422,1531,88,83,171,51.5%,9m
8637,3,[MPTUS]Kisser,3422,1080,60,55,115,52.2%,8m
8637,3,Neks,3422,380,14,21,35,40.0%,26m
8637,3,HaveFun,3422,313,11,12,23,47.8%,12m
8637,3,dionisius,3422,226,9,5,14,64.3%,41m
8637,3,MrDruck,3422,30,2,0,2,100.0%,12m
8637,3,Sephiroth,3422,60,2,3,5,40.0%,19m
8637,3,[Cuack]SneakyCuack,3422,0,1,0,1,100.0%,3m
8637,3,[ВеТеР]AMRA,3422,0,1,4,5,20.0%,15m
8637,3,notadecvat,3422,97,1,5,6,16.7%,20m
8637,3,Salazar,3422,0,0,1,1,0.0%,4m
8650,3,Leviathan,3421,1564,417,406,823,50.7%,5m
8650,2,[LLFF]Krux,3421,1467,171,164,335,51.0%,12m
8650,3,Skoalll,3421,1612,80,66,146,54.8%,7m
8650,3,TinTin,3421,1266,52,41,93,55.9%,18m
8650,3,[GGZERG]Future,3421,1134,42,48,90,46.7%,11m
8650,3,SirWhite,3421,879,36,27,63,57.1%,28m
8650,3,[371]javlahyena,3421,216,9,1,10,90.0%,13m
8650,3,rLin,3421,0,1,0,1,100.0%,6m
8650,3,gimilzor,3421,30,1,1,2,50.0%,17m
8650,3,DRONOS,3421,0,0,1,1,0.0%,7m
8650,3,[Fen]LLynser,3421,0,0,2,2,0.0%,5m
8661,3,[BRSKR]SCKEIKI,3420,1613,136,115,251,54.2%,15m
8661,3,NoNstop,3420,1167,52,43,95,54.7%,13m
8661,3,[opFaiL]Obserwator,3420,1232,50,43,93,53.8%,5m
8661,3,jakaba,3420,662,27,20,47,57.4%,16m
8661,3,[EAU]BlasterTorn,3420,716,25,28,53,47.2%,27m
8661,1,Clauzzz,3420,556,15,44,59,25.4%,3m
8661,3,sorcio,3420,143,7,2,9,77.8%,15m
8661,3,NightDragon,3420,74,4,0,4,100.0%,9m
8661,3,Hulk,3420,98,4,10,14,28.6%,3m
8661,3,SolidJuny,3420,30,2,2,4,50.0%,15m
8661,3,lampa,3420,30,1,5,6,16.7%,7m
8661,3,Обэма,3420,0,0,1,1,0.0%,28m
8673,3,SharkLife,3419,472,44,13,57,77.2%,13m
8673,3,Triton,3419,337,13,11,24,54.2%,20m
8673,3,cwfranklin,3419,138,12,13,25,48.0%,13m
8673,3,Magikarp,3419,168,9,7,16,56.2%,19m
8673,3,[BadAtt]SuperMishu,3419,58,3,1,4,75.0%,13m
8673,3,РонниКолмэн,3419,60,2,4,6,33.3%,29m
8673,3,HopeLing,3419,0,1,0,1,100.0%,10m
8673,3,GannibalKing,3419,0,1,0,1,100.0%,17m
8673,3,zbuffer,3419,30,1,8,9,11.1%,5m
8673,3,[ETA]JJThompson,3419,0,0,1,1,0.0%,12m
8673,3,DeStRoYeR,3419,0,0,1,1,0.0%,13m
8673,3,Zen,3419,0,0,1,1,0.0%,9m
8673,3,Вонг,3419,0,0,2,2,0.0%,4m
8686,3,Kyle,3418,597,82,73,155,52.9%,9m
8686,3,[Nððþs]Smart,3418,982,47,36,83,56.6%,11m
8686,3,NaSa,3418,376,15,9,24,62.5%,13m
8686,3,[LMBD]heliosARMY,3418,325,14,6,20,70.0%,29m
8686,3,SlubberBub,3418,212,8,4,12,66.7%,17m
8686,3,IIIIIIIIII,3418,60,7,3,10,70.0%,28m
8686,3,DogTor,3418,30,2,2,4,50.0%,16m
8686,3,MangoPinoy,3418,0,1,0,1,100.0%,14m
8686,3,[Sha]Shadok,3418,30,1,2,3,33.3%,10m
8686,3,[GdAT]Vavin,3418,30,1,2,3,33.3%,6m
8686,3,[VBros]DalaiLammah,3418,0,0,1,1,0.0%,14m
8686,3,Linkovish,3418,0,0,1,1,0.0%,41m
8686,3,[AiRǂ]OnePatchMan,3418,0,0,3,3,0.0%,7m
8699,2,hosun,3417,1460,106,94,200,53.0%,20m
8699,3,[ĦĦ]Trakhan,3417,1426,57,54,111,51.4%,6m
8699,2,OpTikZeiSure,3417,538,23,22,45,51.1%,19m
8699,2,BibiPeltier,3417,294,12,4,16,75.0%,6m
8699,3,[Klawo]Ver,3417,271,10,3,13,76.9%,27m
8699,3,Glorback,3417,120,5,5,10,50.0%,5m
8699,3,zupp,3417,58,3,3,6,50.0%,16m
8699,3,pazareg,3417,88,3,5,8,37.5%,28m
8699,3,IMakeLings,3417,90,3,6,9,33.3%,14m
8699,3,Awesomic,3417,30,1,4,5,20.0%,5m
8699,3,GriefSong,3417,0,0,1,1,0.0%,4m
8699,1,LuckyFree,3417,0,0,1,1,0.0%,15m
8711,2,[GUTE]Kipo,3416,1557,165,167,332,49.7%,7m
8711,2,[FDNL]DEBRUUT,3416,909,45,45,90,50.0%,9m
8711,3,[ITrick]Ghaylord,3416,288,30,28,58,51.7%,9m
8711,3,oneUP,3416,720,25,25,50,50.0%,27m
8711,2,[wedown]SeppiaPigra,3416,328,10,17,27,37.0%,10m
8711,3,hochupokakat,3416,170,7,4,11,63.6%,8m
8711,3,JKnightmare,3416,192,7,6,13,53.8%,9m
8711,3,IIIIIIIIIIII,3416,0,4,1,5,80.0%,19m
8711,3,Mars,3416,90,4,6,10,40.0%,6m
8711,3,vLx,3416,92,3,7,10,30.0%,14m
8711,3,XVIIIAAA,3416,0,0,1,1,0.0%,28m
8711,3,RedArmy,3416,0,0,1,1,0.0%,16m
8711,3,[GZerO]MarcoDelToro,3416,0,0,1,1,0.0%,29m
8711,3,Hyperthalisk,3416,0,0,1,1,0.0%,13m
8711,3,[BRSKR]DutchDrone,3416,0,0,3,3,0.0%,9m
8726,3,Nathuram,3415,952,82,65,147,55.8%,9m
8726,3,ozoncraft,3415,1547,63,58,121,52.1%,12m
8726,3,Edgykid,3415,444,40,35,75,53.3%,16m
8726,3,[ZERGML]HolySatan,3415,894,35,33,68,51.5%,13m
8726,2,[INOE]Zamarak,3415,637,26,27,53,49.1%,3m
8726,3,kahite,3415,294,9,11,20,45.0%,16m
8726,3,Willdorph,3415,114,5,2,7,71.4%,5m
8726,3,[FDP]François,3415,30,3,5,8,37.5%,5m
8726,3,Devuno,3415,0,1,0,1,100.0%,4m
8726,3,Scorpion,3415,0,1,1,2,50.0%,15m
8726,3,HorMYA,3415,30,1,1,2,50.0%,16m
8726,3,derpu,3415,0,0,1,1,0.0%,16m
8726,3,HellLighT,3415,0,0,2,2,0.0%,29m
8739,2,[PLSV]MegroN,3414,1030,167,174,341,49.0%,9m
8739,3,Snooze,3414,1694,89,84,173,51.4%,16m
8739,2,Sspray,3414,784,84,86,170,49.4%,7m
8739,2,Arthor,3414,971,43,44,87,49.4%,4m
8739,3,[Aggri]Aggressor,3414,847,35,31,66,53.0%,10m
8739,3,Dragodra,3414,936,35,34,69,50.7%,13m
8739,3,mysteryH,3414,411,22,5,27,81.5%,5m
8739,1,Rumi,3414,315,15,6,21,71.4%,29m
8739,3,Treco,3414,304,12,10,22,54.5%,4m
8739,3,[HBGS]Asumo,3414,196,7,5,12,58.3%,8m
8739,3,[Peeps]TGO,3414,205,5,11,16,31.2%,9m
8739,3,patachoux,3414,58,3,0,3,100.0%,8m
8739,3,ciceron,3414,86,3,1,4,75.0%,9m
8739,3,Specialiste,3414,30,1,4,5,20.0%,16m
8739,3,[ANGELL]paulhus,3414,30,1,4,5,20.0%,14m
8739,3,[NONIST]JagaJaga,3414,0,1,4,5,20.0%,17m
8739,3,Tesla,3414,0,0,3,3,0.0%,5m
8739,3,Gash,3414,0,0,4,4,0.0%,7m
8757,2,Bogdiman,3413,1540,169,165,334,50.6%,20m
8757,3,[Cybro]bogar,3413,1497,84,84,168,50.0%,28m
8757,3,[GgWall]fetknol,3413,1437,81,72,153,52.9%,7m
8757,3,pAmNikola,3413,502,49,45,94,52.1%,29m
8757,2,[TeamBL]Schrödinger,3413,957,36,54,90,40.0%,9m
8757,3,Skerelechuga,3413,578,26,20,46,56.5%,6m
8757,3,RushB,3413,512,17,24,41,41.5%,5m
8757,3,Azaghal,3413,192,7,7,14,50.0%,10m
8757,3,[TRsat]SejeSiN,3413,0,5,0,5,100.0%,6m
8757,3,wsufy,3413,120,5,8,13,38.5%,27m
8757,1,dslidd,3413,0,4,1,5,80.0%,60m
8757,3,[tlHope]uNikal,3413,90,4,8,12,33.3%,5m
8757,3,willus,3413,58,3,1,4,75.0%,18m
8757,3,[Mozart]DirTyMoOnKeY,3413,30,2,3,5,40.0%,13m
8757,3,[ExpdtD]DiabloFeTo,3413,0,1,0,1,100.0%,20m
8757,3,[QTclub]BreffXX,3413,0,0,1,1,0.0%,20m
8773,3,[MЕDOЕD]Kendero,3412,1149,153,154,307,49.8%,14m
8773,2,Reva,3412,1553,114,130,244,46.7%,13m
8773,3,[SD420]SnapD,3412,514,21,15,36,58.3%,4m
8773,3,Qwan,3412,360,14,12,26,53.8%,9m
8773,3,RedVelvetCke,3412,192,12,3,15,80.0%,8m
8773,2,Hans,3412,348,12,18,30,40.0%,11m
8773,2,[SSAC]JLoo,3412,332,10,17,27,37.0%,27m
8773,3,Kerthek,3412,246,9,4,13,69.2%,5m
8773,3,Pucha,3412,238,8,12,20,40.0%,28m
8773,3,Krizzly,3412,210,8,13,21,38.1%,16m
8773,3,Dominator,3412,140,5,4,9,55.6%,5m
8773,1,Atlas,3412,194,5,5,10,50.0%,29m
8773,2,Yinut,3412,93,2,0,2,100.0%,15m
8773,3,Sagma,3412,30,2,1,3,66.7%,12m
8773,3,slosiss,3412,60,2,3,5,40.0%,28m
8773,3,HydraOne,3412,30,1,1,2,50.0%,17m
8773,3,[JFTC]lefty,3412,0,0,3,3,0.0%,10m
8790,3,LurKer,3411,1653,365,354,719,50.8%,5m
8790,3,Holgerrr,3411,647,138,106,244,56.6%,20m
8790,2,MARS,3411,1230,55,57,112,49.1%,7m
8790,3,Slimba,3411,430,19,6,25,76.0%,8m
8790,2,Roovaaaa,3411,242,10,7,17,58.8%,8m
8790,3,Penis,3411,145,7,1,8,87.5%,26m
8790,3,Semmi,3411,180,6,8,14,42.9%,9m
8790,3,[ГГTea]IIIIIIIIIIII,3411,161,6,9,15,40.0%,41m
8790,2,Ozzy,3411,173,4,3,7,57.1%,17m
8790,3,HughJass,3411,124,4,9,13,30.8%,27m
8790,3,[RLNGZ]ludvigsn,3411,30,1,1,2,50.0%,4m
8790,1,Malakai,3411,0,1,4,5,20.0%,26m
8790,3,TomiJ,3411,0,1,6,7,14.3%,14m
8803,2,cannamusic,3410,1511,267,251,518,51.5%,12m
8803,3,corsaire,3410,1324,253,249,502,50.4%,6m
8803,3,[LifeAD]dekril,3410,660,34,22,56,60.7%,16m
8803,3,Baboulinax,3410,522,22,18,40,55.0%,9m
8803,3,[Grunt]Near,3410,288,11,7,18,61.1%,27m
8803,3,[4SVs]Alan,3410,300,11,14,25,44.0%,12m
8803,3,IlIlIlIlIlIl,3410,193,8,4,12,66.7%,17m
8803,2,AffroKrull,3410,238,8,19,27,29.6%,13m
8803,3,youkibear,3410,0,3,2,5,60.0%,15m
8803,3,Mika,3410,30,2,1,3,66.7%,11m
8803,3,Crapnoob,3410,58,2,2,4,50.0%,5m
8803,3,Lisek,3410,30,1,3,4,25.0%,28m
8803,3,nifel,3410,0,0,1,1,0.0%,7m
8803,3,[FOTBOT]KhunEdvahn,3410,0,0,1,1,0.0%,41m
8817,2,Bobaville,3409,1307,64,77,141,45.4%,12m
8817,2,OldSaul,3409,1582,62,70,132,47.0%,6m
8817,2,Chomba,3409,440,21,16,37,56.8%,14m
8817,3,[SPAINs]SOYTUCULO,3409,338,11,11,22,50.0%,17m
8817,1,GongMinji,3409,48,6,1,7,85.7%,10m
8817,3,Draf,3409,174,6,4,10,60.0%,13m
8817,1,any,3409,233,6,7,13,46.2%,12m
8817,3,RustyRigs,3409,121,3,1,4,75.0%,19m
8817,3,NeganGraves,3409,60,3,3,6,50.0%,12m
8817,3,atomas,3409,30,2,5,7,28.6%,16m
8817,3,badPlayer,3409,0,1,0,1,100.0%,11m
8817,3,[D0N3]ERGoN,3409,0,1,1,2,50.0%,42m
8817,2,Jan,3409,0,1,1,2,50.0%,18m
8817,3,NoLajf,3409,0,1,1,2,50.0%,5m
8817,3,[ialm]Kefaem,3409,0,1,1,2,50.0%,28m
8817,3,BaltoTheWolf,3409,30,1,1,2,50.0%,11m
8817,1,[KUY]Caxappp,3409,0,0,1,1,0.0%,41m
8817,3,Bobz,3409,0,0,1,1,0.0%,6m
8817,3,hatcher,3409,0,0,2,2,0.0%,16m
8836,3,[ohSL]HeyHou,3408,1594,147,140,287,51.2%,4m
8836,2,Eastone,3408,1563,93,96,189,49.2%,11m
8836,3,Fjun,3408,1609,79,76,155,51.0%,17m
8836,3,[DeBoys]Hackrolf,3408,754,68,60,128,53.1%,4m
8836,2,TXpleb,3408,791,65,52,117,55.6%,6m
8836,3,SluGsMud,3408,933,52,37,89,58.4%,29m
8836,3,PrometeO,3408,230,11,5,16,68.8%,17m
8836,3,StormRage,3408,244,11,6,17,64.7%,6m
8836,1,KILLERCHAMP,3408,293,11,6,17,64.7%,10m
8836,3,affemitwaffe,3408,174,6,6,12,50.0%,5m
8836,3,Metralleta,3408,0,5,1,6,83.3%,26m
8836,3,Baxmanz,3408,114,4,3,7,57.1%,4m
8836,3,[P3rsé]Leondor,3408,0,0,1,1,0.0%,18m
8836,3,[MATB]Kashim,3408,0,0,1,1,0.0%,10m
8836,3,repard,3408,0,0,1,1,0.0%,5m
8836,3,DrDrud,3408,0,0,5,5,0.0%,14m
8852,2,[HBGS]Borbet,3407,1138,123,122,245,50.2%,6m
8852,3,Serral,3407,1410,112,114,226,49.6%,16m
8852,3,BFG,3407,826,99,98,197,50.3%,5m
8852,3,yayagrou,3407,1180,59,58,117,50.4%,28m
8852,3,Serpent,3407,312,15,8,23,65.2%,6m
8852,3,llllllllllll,3407,292,13,7,20,65.0%,41m
8852,2,anusbisvodka,3407,143,7,4,11,63.6%,12m
8852,3,[пепега]rLogic,3407,220,7,14,21,33.3%,27m
8852,3,[GoldM]Hyouka,3407,144,5,11,16,31.2%,10m
8852,3,Dewd,3407,131,3,1,4,75.0%,13m
8852,3,Lofes,3407,0,1,1,2,50.0%,9m
8852,3,Seexking,3407,0,0,1,1,0.0%,14m
8864,3,Leckatall,3406,1587,225,203,428,52.6%,5m
8864,3,[NotSuR]Minatych,3406,1533,221,206,427,51.8%,11m
8864,3,[I3Z8]REAKTOR,3406,1609,82,72,154,53.2%,10m
8864,3,[GLHFGL]KäsekuchenA,3406,1424,65,51,116,56.0%,3m
8864,3,tobe,3406,1559,65,63,128,50.8%,17m
8864,3,[RckS]KSK,3406,900,35,31,66,53.0%,11m
8864,3,Krul,3406,333,12,12,24,50.0%,42m
8864,3,[Wolven]DevilMarine,3406,317,10,15,25,40.0%,12m
8864,3,Beybars,3406,82,6,7,13,46.2%,17m
8864,3,NurAbSal,3406,154,5,9,14,35.7%,14m
8864,3,[SURR]elHuron,3406,114,4,5,9,44.4%,5m
8864,3,[DHCP]Hiderow,3406,60,3,2,5,60.0%,8m
8864,3,quAzaR,3406,60,3,6,9,33.3%,41m
8864,3,Damandred,3406,0,1,0,1,100.0%,42m
8864,2,Odin,3406,96,1,4,5,20.0%,6m
8864,3,[WSAS]Aaron,3406,0,0,1,1,0.0%,27m
8864,3,[ĦRZ]Xplode,3406,0,0,1,1,0.0%,20m
8881,2,Némésis,3405,1208,98,90,188,52.1%,7m
8881,2,[WBGA]aymeric,3405,364,25,26,51,49.0%,7m
8881,3,[llIlkI]WarRieR,3405,446,24,32,56,42.9%,19m
8881,3,bingo,3405,538,23,12,35,65.7%,19m
8881,3,[MAKinG]DreamCatcher,3405,398,16,15,31,51.6%,13m
8881,2,[BSK88]Skiizz,3405,327,13,19,32,40.6%,18m
8881,1,Knuckle,3405,97,5,1,6,83.3%,39m
8881,3,[leOS]Ветер,3405,86,3,1,4,75.0%,12m
8881,3,Heerb,3405,60,3,1,4,75.0%,5m
8881,3,Thirtynine,3405,88,3,3,6,50.0%,10m
8881,3,[B0xers]KingMacron,3405,30,2,3,5,40.0%,19m
8881,2,Ralph,3405,90,2,7,9,22.2%,20m
8881,3,Cronos,3405,60,2,9,11,18.2%,27m
8881,3,[FxL]Hadoken,3405,0,1,0,1,100.0%,19m
8881,3,reran,3405,30,1,2,3,33.3%,14m
8881,3,[CTLF]Idoria,3405,0,0,2,2,0.0%,4m
8897,3,[RCHES]Vladecc,3404,1037,127,121,248,51.2%,20m
8897,3,KouYaMan,3404,808,57,58,115,49.6%,18m
8897,2,Elneik,3404,729,36,50,86,41.9%,16m
8897,3,[ZЕRGTV]дыдыдыр,3404,706,30,20,50,60.0%,11m
8897,1,Grimous,3404,244,7,5,12,58.3%,15m
8897,3,[dp]AlphaFrog,3404,146,5,6,11,45.5%,19m
8897,3,Marbod,3404,30,2,4,6,33.3%,9m
8897,3,[расея]рutinkiller,3404,0,1,0,1,100.0%,5m
8897,3,GuiLermeTell,3404,30,1,2,3,33.3%,14m
8897,3,Dundersztyc,3404,0,0,1,1,0.0%,28m
8897,3,Eco,3404,0,0,1,1,0.0%,14m
8897,3,Sick,3404,0,0,1,1,0.0%,15m
8897,3,[TAW]cruelrichard,3404,0,0,2,2,0.0%,4m
8910,3,Krowar,3403,1601,96,82,178,53.9%,28m
8910,3,tuziko,3403,1562,91,87,178,51.1%,12m
8910,2,ChillBill,3403,1289,85,101,186,45.7%,28m
8910,3,DrAcula,3403,963,44,32,76,57.9%,13m
8910,3,madeon,3403,913,36,40,76,47.4%,12m
8910,3,Puyi,3403,587,20,19,39,51.3%,13m
8910,3,Bear,3403,440,17,13,30,56.7%,41m
8910,3,shaco,3403,353,15,15,30,50.0%,10m
8910,1,[ASkill]ImbaNUL,3403,192,9,6,15,60.0%,4m
8910,3,Ullman,3403,277,9,7,16,56.2%,19m
8910,3,[Bitfix]Xeno,3403,142,5,4,9,55.6%,14m
8910,3,gangsta,3403,30,4,5,9,44.4%,19m
8910,3,Toro,3403,58,3,1,4,75.0%,9m
8910,3,Devion,3403,58,3,1,4,75.0%,18m
8910,3,LeatherFace,3403,0,1,1,2,50.0%,16m
8910,3,Flo,3403,0,0,1,1,0.0%,4m
8910,3,[exQ]Mave,3403,0,0,1,1,0.0%,16m
8910,3,toomze,3403,0,0,2,2,0.0%,19m
8910,3,niCEEmAN,3403,0,0,2,2,0.0%,5m
8929,3,Victory,3402,1556,91,87,178,51.1%,11m
8929,3,[HBGS]Wisper,3402,1568,61,65,126,48.4%,7m
8929,3,AnastasiaRu,3402,650,28,11,39,71.8%,9m
8929,3,Andreas,3402,614,23,27,50,46.0%,20m
8929,3,CheeseySheep,3402,492,21,11,32,65.6%,9m
8929,3,[ZhEba]Jarel,3402,406,16,11,27,59.3%,9m
8929,3,Tsudawa,3402,390,14,17,31,45.2%,28m
8929,2,GhostCleaner,3402,163,8,4,12,66.7%,7m
8929,1,[UKRA1N]yolo,3402,232,8,5,13,61.5%,6m
8929,3,ZenQW,3402,60,2,8,10,20.0%,4m
8929,3,deinernst,3402,30,1,3,4,25.0%,29m
8929,3,MetallicA,3402,0,1,8,9,11.1%,11m
8929,2,Bayo,3402,0,0,15,15,0.0%,20m
8942,3,PaicCitron,3401,874,44,36,80,55.0%,29m
8942,3,Basilios,3401,608,23,19,42,54.8%,17m
8942,3,llllllllllll,3401,411,19,13,32,59.4%,42m
8942,3,JaxO,3401,434,17,6,23,73.9%,42m
8942,3,Purpose,3401,328,13,12,25,52.0%,10m
8942,3,[BCBB]Nummy,3401,376,13,15,28,46.4%,28m
8942,3,JINHiRO,3401,58,7,2,9,77.8%,10m
8942,3,[NSKC]ZERGOED,3401,166,6,2,8,75.0%,5m
8942,3,bronko,3401,168,6,8,14,42.9%,7m
8942,3,PeeTee,3401,114,4,2,6,66.7%,9m
8942,3,Leech,3401,58,3,8,11,27.3%,29m
8942,3,Tano,3401,0,0,1,1,0.0%,7m
8942,3,[R1917]JohnBrown,3401,0,0,7,7,0.0%,12m
8955,2,ectoplsm,3400,1459,191,205,396,48.2%,13m
8955,2,KingOvermind,3400,1337,88,100,188,46.8%,5m
8955,3,dimchik,3400,1155,44,35,79,55.7%,42m
8955,3,[SaiYaN]OuB,3400,647,24,30,54,44.4%,14m
8955,3,DrStrudel,3400,554,21,16,37,56.8%,3m
8955,3,[ESHD]Master,3400,361,15,9,24,62.5%,5m
8955,2,[BRST]ZergDealer,3400,300,11,19,30,36.7%,11m
8955,2,Malodorous,3400,166,8,6,14,57.1%,4m
8955,2,Darror,3400,170,6,7,13,46.2%,12m
8955,3,JohnColtrane,3400,0,1,0,1,100.0%,10m
8955,3,[HngKng]Alin,3400,0,1,0,1,100.0%,4m
8955,3,Kiradi,3400,30,1,2,3,33.3%,19m
8955,3,jmut,3400,30,1,3,4,25.0%,12m
8955,3,Graf,3400,0,0,1,1,0.0%,8m
8955,3,Dolart,3400,0,0,1,1,0.0%,13m
8955,3,inferno,3400,0,0,1,1,0.0%,3m
8971,3,TAMPERE,3399,1552,211,214,425,49.6%,15m
8971,2,[TRADER]JagerViking,3399,1206,55,63,118,46.6%,29m
8971,3,[UATeam]Cronos,3399,1260,48,50,98,49.0%,9m
8971,3,Rtif,3399,697,47,52,99,47.5%,5m
8971,2,EliteForce,3399,1118,46,42,88,52.3%,12m
8971,2,PaN,3399,706,24,31,55,43.6%,20m
8971,3,Schmetten,3399,198,11,6,17,64.7%,13m
8971,3,Pariah,3399,195,7,3,10,70.0%,14m
8971,3,НУБвГМзаДЕНЬ,3399,118,6,1,7,85.7%,9m
8971,1,[F3l]Mollenger,3399,119,6,1,7,85.7%,20m
8971,3,[BxN]piertxo,3399,86,4,3,7,57.1%,29m
8971,3,[EWTZ]ZugZagZug,3399,97,3,5,8,37.5%,19m
8971,2,VertigO,3399,98,3,13,16,18.8%,19m
8971,3,NeoThird,3399,60,2,3,5,40.0%,19m
8971,3,llllllllllll,3399,58,2,3,5,40.0%,4m
8971,1,[Mattis]MøøG,3399,97,2,4,6,33.3%,1h
8971,3,[GBMǂ]KFColossGBM,3399,0,1,0,1,100.0%,12m
8971,3,[C1KK]Croc,3399,30,1,2,3,33.3%,10m
8989,3,cyberstorm,3398,1362,52,57,109,47.7%,29m
8989,3,SAN,3398,1016,39,34,73,53.4%,13m
8989,3,Cute,3398,456,33,25,58,56.9%,18m
8989,3,Xabibulin,3398,573,25,16,41,61.0%,19m
8989,3,TheLazyOne,3398,672,25,26,51,49.0%,11m
8989,3,Istrandar,3398,225,22,16,38,57.9%,4m
8989,3,Faust,3398,307,14,11,25,56.0%,28m
8989,3,[TUPU]Akumara,3398,114,5,0,5,100.0%,7m
8989,1,LostToTerran,3398,0,5,0,5,100.0%,28m
8989,1,Sauce,3398,0,5,0,5,100.0%,16m
8989,3,protoss,3398,142,5,5,10,50.0%,15m
8989,3,[vCH]MrPépitos,3398,58,3,3,6,50.0%,13m
8989,3,[T3]rustyisback,3398,58,2,3,5,40.0%,20m
8989,3,Master,3398,30,1,1,2,50.0%,8m
8989,3,[IDF48]pololop,3398,0,0,1,1,0.0%,7m
8989,3,Rayu,3398,0,0,1,1,0.0%,29m
8989,3,[FFoHM]Denali,3398,0,0,1,1,0.0%,19m
8989,3,Dasha,3398,0,0,1,1,0.0%,42m
9007,2,Revo,3397,1499,156,151,307,50.8%,8m
9007,3,[Grøs]Reg,3397,1068,133,107,240,55.4%,29m
9007,3,Mafyak,3397,1179,116,104,220,52.7%,13m
9007,2,[CHOBO]Doued,3397,1275,92,89,181,50.8%,9m
9007,3,PakOr,3397,880,76,87,163,46.6%,42m
9007,3,SeNSei,3397,782,31,28,59,52.5%,41m
9007,3,[QTcIub]adamo,3397,792,30,25,55,54.5%,13m
9007,3,[FUARK]Gravity,3397,208,15,10,25,60.0%,19m
9007,3,iCareeh,3397,412,15,17,32,46.9%,10m
9007,3,IceCreamMan,3397,398,13,19,32,40.6%,28m
9007,3,Mishanya,3397,154,11,9,20,55.0%,4m
9007,3,[PvZEU]Arany,3397,114,7,4,11,63.6%,10m
9007,2,zetoM,3397,0,2,20,22,9.1%,12m
9007,3,OneBeerDeep,3397,0,1,1,2,50.0%,17m
9007,1,PiggyInSpace,3397,48,1,2,3,33.3%,10m
9007,3,reaper,3397,30,1,2,3,33.3%,3m
9007,3,Etistone,3397,0,0,1,1,0.0%,15m
9024,3,Gordon,3396,1029,190,142,332,57.2%,7m
9024,3,Kamel,3396,997,134,136,270,49.6%,13m
9024,3,[MeMaMe]Wapakalypse,3396,640,88,74,162,54.3%,18m
9024,3,NaNou,3396,995,54,41,95,56.8%,42m
9024,3,Mizebo,3396,546,20,23,43,46.5%,28m
9024,3,MeHTaJLUCT,3396,428,16,13,29,55.2%,5m
9024,3,[LPFG]CCCР,3396,290,13,11,24,54.2%,7m
9024,2,[CHIPO]Spigola,3396,168,5,18,23,21.7%,10m
9024,3,PainKiller,3396,119,3,0,3,100.0%,9m
9024,3,[SeTeH]dksiazek,3396,48,2,1,3,66.7%,4m
9024,3,[Кусь]alisher,3396,0,1,0,1,100.0%,20m
9024,3,Oxotnik,3396,30,1,4,5,20.0%,13m
9024,3,FusRoDah,3396,0,0,1,1,0.0%,4m
9024,3,StippleR,3396,0,0,3,3,0.0%,14m
9038,2,[GIS]Zenadiz,3395,1532,165,162,327,50.5%,18m
9038,3,Kecha,3395,1537,139,133,272,51.1%,9m
9038,3,[8mylez]Kaschi,3395,1655,132,100,232,56.9%,16m
9038,3,ElCascador,3395,1216,46,43,89,51.7%,4m
9038,3,zarkzork,3395,787,43,38,81,53.1%,6m
9038,3,dodoodle,3395,366,23,23,46,50.0%,13m
9038,3,aaaaaa,3395,574,21,21,42,50.0%,19m
9038,3,SkyHigh,3395,258,12,7,19,63.2%,14m
9038,3,[Crаzy]DaniLa,3395,266,11,7,18,61.1%,41m
9038,3,Hoorly,3395,184,8,7,15,53.3%,13m
9038,2,mirzag,3395,138,3,2,5,60.0%,19m
9038,3,[TaOr]Hex,3395,92,3,8,11,27.3%,13m
9038,3,StarDrive,3395,30,2,0,2,100.0%,29m
9038,3,[DZTK]Geierchen,3395,30,2,1,3,66.7%,42m
9038,3,Rollinrasta,3395,0,1,0,1,100.0%,17m
9038,3,[PutinL]Fröze,3395,0,0,1,1,0.0%,11m
9054,3,PonJaulTwo,3394,1155,102,80,182,56.0%,7m
9054,3,ImperiumObes,3394,932,56,52,108,51.9%,42m
9054,3,TotalCreep,3394,546,55,29,84,65.5%,3m
9054,3,BoomerBTI,3394,492,28,13,41,68.3%,6m
9054,2,[K0mpis]Robzki,3394,536,18,25,43,41.9%,28m
9054,3,[TDOW]Trimer,3394,394,13,18,31,41.9%,28m
9054,3,[Skolan]VktmHenkel,3394,348,12,11,23,52.2%,21m
9054,1,Bear,3394,308,11,29,40,27.5%,12m
9054,3,Noob,3394,147,10,10,20,50.0%,10m
9054,3,zeta,3394,30,5,1,6,83.3%,10m
9054,3,IIIIIIIIIIII,3394,30,2,0,2,100.0%,6m
9054,3,KVG,3394,0,1,1,2,50.0%,16m
9054,3,llllllllllll,3394,30,1,6,7,14.3%,19m
9054,3,[MaMkin]soliron,3394,0,0,1,1,0.0%,7m
9054,1,ßaha,3394,0,0,1,1,0.0%,18m
9054,3,Hanareck,3394,0,0,2,2,0.0%,16m
9054,3,[MXG]Bobbo,3394,0,0,3,3,0.0%,16m
9071,3,Spolonic,3393,1562,168,146,314,53.5%,5m
9071,3,[ZERGTV]IvanGP,3393,1426,85,76,161,52.8%,29m
9071,3,[NagirU]Urigan,3393,738,62,51,113,54.9%,8m
9071,3,WøŁf,3393,813,36,25,61,59.0%,5m
9071,3,Cycu,3393,932,35,33,68,51.5%,42m
9071,3,Mogroth,3393,493,19,8,27,70.4%,42m
9071,3,CiTiZiN,3393,182,9,3,12,75.0%,4m
9071,3,[Hrr]Misterio,3393,146,9,4,13,69.2%,11m
9071,3,[iF]Darshu,3393,278,9,8,17,52.9%,13m
9071,3,Kara,3393,170,6,8,14,42.9%,4m
9071,3,DustLord,3393,114,5,2,7,71.4%,29m
9071,3,[EXBOIS]Langorn,3393,142,5,7,12,41.7%,42m
9071,1,NiþFoxxy,3393,92,5,9,14,35.7%,7m
9071,3,[KDV]Helnest,3393,86,3,3,6,50.0%,13m
9071,3,[DMagic]suler,3393,0,1,0,1,100.0%,27m
9071,3,Smaga,3393,0,1,0,1,100.0%,15m
9071,3,[Mijn]SirPanda,3393,0,1,0,1,100.0%,8m
9071,3,XxXdupciaXxX,3393,30,1,1,2,50.0%,14m
9071,3,CuteZerg,3393,0,0,1,1,0.0%,29m
9071,3,Znation,3393,0,0,5,5,0.0%,27m
9091,2,LLAG,3392,1493,270,277,547,49.4%,29m
9091,3,[ZIPP]EzMode,3392,1613,175,153,328,53.4%,12m
9091,2,iHendy,3392,769,49,53,102,48.0%,4m
9091,3,ЯМашина,3392,913,40,26,66,60.6%,4m
9091,3,SwaRmer,3392,300,11,10,21,52.4%,5m
9091,3,Sharringan,3392,170,10,4,14,71.4%,15m
9091,3,[Esq]Fiend,3392,262,9,11,20,45.0%,9m
9091,3,[ErR]StroKe,3392,238,9,14,23,39.1%,15m
9091,1,Randy,3392,102,7,1,8,87.5%,55m
9091,3,Octopus,3392,151,7,3,10,70.0%,12m
9091,1,Barric,3392,145,5,2,7,71.4%,7m
9091,3,Desmos,3392,114,5,4,9,55.6%,13m
9091,3,[boonZ]Sorrow,3392,60,3,1,4,75.0%,14m
9091,3,LennyDean,3392,58,3,1,4,75.0%,4m
9091,3,nekozel,3392,58,3,2,5,60.0%,13m
9091,3,Filemon,3392,0,0,1,1,0.0%,4m
9091,3,RiotSlug,3392,0,0,3,3,0.0%,20m
9091,3,SPLASH,3392,0,0,3,3,0.0%,11m
9109,2,[DƎI]Hyby,3391,1527,312,298,610,51.1%,6m
9109,3,validng,3391,1602,152,134,286,53.1%,18m
9109,3,Unicellular,3391,1602,126,86,212,59.4%,4m
9109,3,[Rol3kg]SemVaus,3391,1241,91,83,174,52.3%,21m
9109,2,[gaysCZ]IIIIIIIIIII,3391,627,33,31,64,51.6%,10m
9109,3,xoti,3391,654,24,25,49,49.0%,19m
9109,3,[5259]goji,3391,492,17,17,34,50.0%,9m
9109,3,NaSHx,3391,347,14,10,24,58.3%,11m
9109,3,[K0mpis]Rekever,3391,195,8,3,11,72.7%,42m
9109,2,Dumb,3391,149,4,0,4,100.0%,9m
9109,3,llllllllllll,3391,117,4,0,4,100.0%,19m
9109,3,[KARAL]Tordek,3391,30,2,1,3,66.7%,42m
9109,3,lllllllllllI,3391,0,2,3,5,40.0%,29m
9109,3,KurtBlock,3391,30,1,1,2,50.0%,13m
9109,3,ZeRgLiNG,3391,0,1,1,2,50.0%,9m
9109,3,AchiZui,3391,0,0,1,1,0.0%,11m
9109,3,lillaDH,3391,0,0,1,1,0.0%,20m
9126,3,Freesia,3390,1375,221,207,428,51.6%,12m
9126,3,SALUTCCOOL,3390,1341,184,163,347,53.0%,17m
9126,3,RoKo,3390,1529,131,119,250,52.4%,13m
9126,3,[LoneD]Glenne,3390,1559,113,104,217,52.1%,9m
9126,3,Theta,3390,1416,61,68,129,47.3%,5m
9126,3,[BMANG]TheFilth,3390,788,31,26,57,54.4%,18m
9126,3,[LKR]Drbignoze,3390,768,30,21,51,58.8%,42m
9126,3,RsTich,3390,305,24,15,39,61.5%,16m
9126,3,zBu,3390,324,15,8,23,65.2%,16m
9126,3,Stdioh,3390,146,9,4,13,69.2%,17m
9126,3,NotEpic,3390,171,8,3,11,72.7%,28m
9126,3,Shahmatist,3390,150,5,9,14,35.7%,13m
9126,2,TheCandyman,3390,141,3,3,6,50.0%,4m
9126,3,nosferatu,3390,60,3,4,7,42.9%,20m
9126,3,Muadib,3390,58,2,7,9,22.2%,8m
9126,3,Astraios,3390,0,1,1,2,50.0%,17m
9126,3,[WBG11]Tabriel,3390,30,1,1,2,50.0%,4m
9126,3,[LinEs]YuNIK,3390,30,1,3,4,25.0%,17m
9126,3,lëni,3390,0,0,1,1,0.0%,8m
9126,3,Lilith,3390,0,0,1,1,0.0%,11m
9146,2,Slow,3389,1084,153,169,322,47.5%,20m
9146,3,Tempent,3389,1296,116,106,222,52.3%,41m
9146,2,[WurS]samdaskod,3389,1505,90,90,180,50.0%,16m
9146,3,[Zoub]pred,3389,1110,78,79,157,49.7%,21m
9146,3,[NaOH]Térorus,3389,990,46,22,68,67.6%,12m
9146,3,[kisuli]CatsAss,3389,1104,41,50,91,45.1%,8m
9146,3,paranoia,3389,1024,40,38,78,51.3%,14m
9146,3,JarLeif,3389,750,35,40,75,46.7%,5m
9146,3,mtoom,3389,479,19,8,27,70.4%,16m
9146,3,Aphellion,3389,458,16,18,34,47.1%,13m
9146,3,[SaGo]Hagorian,3389,212,5,7,12,41.7%,12m
9146,3,JpegNeoZ,3389,169,5,7,12,41.7%,8m
9146,3,iBaWs,3389,0,4,1,5,80.0%,4m
9146,3,[Sø6]Lowewe,3389,58,2,2,4,50.0%,9m
9146,3,Ramuk,3389,30,1,2,3,33.3%,13m
9146,3,Ledjo,3389,0,0,1,1,0.0%,14m
9146,3,Andosan,3389,0,0,1,1,0.0%,28m
9146,3,WRIIIIIIIIII,3389,0,0,1,1,0.0%,15m
9164,3,Goldilocks,3388,1579,208,205,413,50.4%,18m
9164,2,Zagryen,3388,906,81,82,163,49.7%,11m
9164,3,[DТ]geerzak,3388,1293,54,42,96,56.2%,7m
9164,3,Brillo,3388,772,34,23,57,59.6%,14m
9164,3,UninstallPlz,3388,790,32,19,51,62.7%,11m
9164,3,Nay,3388,685,30,22,52,57.7%,16m
9164,2,BlackLegacy,3388,740,26,37,63,41.3%,20m
9164,3,Koshida,3388,622,25,13,38,65.8%,19m
9164,1,Urshnak,3388,317,14,8,22,63.6%,20m
9164,3,noobiept,3388,0,5,1,6,83.3%,5m
9164,3,dkornatko,3388,158,4,2,6,66.7%,8m
9164,3,AfterLife,3388,146,4,2,6,66.7%,11m
9164,3,[Medoеd]Orest,3388,58,3,0,3,100.0%,18m
9164,3,Kay,3388,58,3,2,5,60.0%,28m
9164,3,[theDH]DonTStoP,3388,30,2,2,4,50.0%,10m
9164,1,Bapuk,3388,0,2,3,5,40.0%,9m
9164,3,[Fusi0n]sNaCKey,3388,0,0,1,1,0.0%,5m
9164,3,[FrFrog]Corbeau,3388,0,0,1,1,0.0%,14m
9164,3,[DnDD]Szanyi,3388,0,0,1,1,0.0%,7m
9164,3,Albi,3388,0,0,2,2,0.0%,4m
9184,2,TheDarkVoice,3387,1472,106,108,214,49.5%,7m
9184,3,SecretName,3387,878,47,32,79,59.5%,20m
9184,3,Salty,3387,978,36,43,79,45.6%,29m
9184,2,[PROOO]Jesperpro,3387,716,29,32,61,47.5%,12m
9184,3,Overmind,3387,527,22,17,39,56.4%,4m
9184,3,[EмŦS]Historia,3387,212,8,3,11,72.7%,14m
9184,3,[Watjuu]Smokemonster,3387,92,3,13,16,18.8%,4m
9184,3,[Cheats]MasterMind,3387,30,2,4,6,33.3%,11m
9184,3,newtosctwo,3387,30,1,1,2,50.0%,8m
9184,3,beKind,3387,0,0,1,1,0.0%,16m
9184,3,[PiGPan]Qazl,3387,0,0,3,3,0.0%,13m
9195,3,DTM,3386,1584,261,233,494,52.8%,42m
9195,2,OneTwo,3386,1206,241,233,474,50.8%,28m
9195,3,TurtleTobi,3386,1476,217,171,388,55.9%,29m
9195,3,Samix,3386,1473,131,133,264,49.6%,21m
9195,3,HoTTeA,3386,1636,80,76,156,51.3%,16m
9195,2,Troll,3386,529,79,80,159,49.7%,8m
9195,3,fixe,3386,500,39,32,71,54.9%,13m
9195,3,[PVRUS]saha,3386,316,28,29,57,49.1%,28m
9195,3,Frostbite,3386,246,9,6,15,60.0%,4m
9195,3,Hølm,3386,142,7,2,9,77.8%,16m
9195,3,LittleChino,3386,122,4,13,17,23.5%,15m
9195,3,[BATG]DarKPoTaTO,3386,58,3,1,4,75.0%,13m
9195,1,[BetAlf]BlackSheep,3386,118,3,2,5,60.0%,13m
9195,3,Noclip,3386,60,2,3,5,40.0%,18m
9195,3,nukr,3386,0,1,0,1,100.0%,5m
9195,3,SeinseDCabra,3386,0,1,2,3,33.3%,12m
9195,3,[PIMBA]GASAI,3386,0,0,1,1,0.0%,7m
9195,3,[ENQ]HEROSHE,3386,0,0,1,1,0.0%,15m
9195,3,[SSCP]SauC,3386,0,0,2,2,0.0%,7m
9195,3,SêXyPIErr,3386,0,0,2,2,0.0%,4m
9195,3,Offline,3386,0,0,5,5,0.0%,15m
9216,3,Antaphy,3385,1602,203,203,406,50.0%,11m
9216,3,Psy,3385,1437,90,89,179,50.3%,9m
9216,3,[RBlood]Akinetsu,3385,1497,89,76,165,53.9%,12m
9216,3,RiotSwitch,3385,312,38,28,66,57.6%,9m
9216,2,DEADBUG,3385,238,32,32,64,50.0%,18m
9216,3,[VetM]FloW,3385,690,26,24,50,52.0%,41m
9216,3,liDH,3385,228,12,7,19,63.2%,7m
9216,3,sosh,3385,362,12,9,21,57.1%,29m
9216,3,Mallazo,3385,228,10,3,13,76.9%,42m
9216,3,tiga,3385,192,9,4,13,69.2%,42m
9216,3,[TheRC]Kribs,3385,233,9,8,17,52.9%,11m
9216,3,[Hppl]Sørlandet,3385,190,8,3,11,72.7%,28m
9216,3,UnfOrGiVeN,3385,118,5,5,10,50.0%,12m
9216,3,Sita,3385,86,3,2,5,60.0%,13m
9216,3,SharonKo,3385,88,3,3,6,50.0%,28m
9216,3,[MTBB]Norbert,3385,0,1,0,1,100.0%,17m
9216,3,HydraDeluxe,3385,0,0,1,1,0.0%,5m
9216,3,HEBE,3385,0,0,1,1,0.0%,29m
9234,3,Ping,3384,476,47,42,89,52.8%,41m
9234,3,[Narnia]JustinReaper,3384,307,24,21,45,53.3%,15m
9234,3,Jugei,3384,440,16,14,30,53.3%,19m
9234,3,[TaDb]Kalimerø,3384,278,11,6,17,64.7%,19m
9234,3,[RATM]mrGoodbye,3384,194,7,7,14,50.0%,21m
9234,2,[EZY]ToastAlone,3384,195,7,8,15,46.7%,7m
9234,3,EqualZero,3384,30,1,1,2,50.0%,6m
9234,3,Echnalest,3384,0,1,1,2,50.0%,19m
9234,3,ChibaCityblu,3384,0,0,1,1,0.0%,28m
9234,3,Happypants,3384,0,0,1,1,0.0%,20m
9234,3,Kvothe,3384,0,0,2,2,0.0%,42m
9234,3,Gegis,3384,0,0,2,2,0.0%,10m
9234,3,soulbebop,3384,0,0,3,3,0.0%,17m
9234,3,scorpion,3384,0,0,3,3,0.0%,17m
9234,2,BakaSan,3384,0,0,11,11,0.0%,8m
9249,3,Raven,3383,1607,190,187,377,50.4%,16m
9249,3,Magic,3383,388,16,11,27,59.3%,8m
9249,3,PartaSTI,3383,262,10,15,25,40.0%,42m
9249,3,[ZЕRGТV]ArturZerg,3383,256,9,13,22,40.9%,11m
9249,3,Sideburns,3383,192,8,2,10,80.0%,12m
9249,3,Tyler,3383,114,5,2,7,71.4%,16m
9249,3,Bagdas,3383,0,3,2,5,60.0%,6m
9249,3,ЧикЧирик,3383,58,3,8,11,27.3%,17m
9249,3,[OseF]Knarf,3383,30,2,0,2,100.0%,4m
9249,3,[PiGPan]Barkas,3383,30,2,1,3,66.7%,18m
9249,3,[h3fr]john,3383,0,1,0,1,100.0%,42m
9249,3,Demeer,3383,0,1,1,2,50.0%,42m
9249,3,[LNPT]Aoneccius,3383,0,0,1,1,0.0%,29m
9249,3,Kirill,3383,0,0,1,1,0.0%,14m
9249,3,Vasilergus,3383,0,0,1,1,0.0%,20m
9264,2,[DrimrZ]DungDealer,3382,1554,720,704,1424,50.6%,20m
9264,3,[CJFF]source,3382,1629,189,185,374,50.5%,20m
9264,3,[Risker]Herles,3382,614,52,58,110,47.3%,9m
9264,3,Pektz,3382,674,43,39,82,52.4%,10m
9264,3,NvrGoFurther,3382,630,23,18,41,56.1%,4m
9264,3,myWayBronze,3382,322,20,24,44,45.5%,5m
9264,3,TritoX,3382,372,15,10,25,60.0%,28m
9264,1,OTLoo,3382,97,5,1,6,83.3%,11m
9264,3,[3raza]Cazagames,3382,118,4,5,9,44.4%,14m
9264,3,HoLoHaGi,3382,114,4,9,13,30.8%,4m
9264,3,Pavlova,3382,60,3,3,6,50.0%,4m
9264,3,[ESOELT]ThaSquirrel,3382,0,1,0,1,100.0%,29m
9264,3,[eXze]fxTRIXERZ,3382,0,0,1,1,0.0%,17m
9264,3,[CWGG]Dorkox,3382,0,0,1,1,0.0%,7m
9264,3,[neuroW]SirSixPool,3382,0,0,1,1,0.0%,19m
9264,3,[DumpD]Apokalyptik,3382,0,0,2,2,0.0%,5m
9264,3,[SEWP]FrostLight,3382,0,0,3,3,0.0%,11m
9281,3,Sàph,3381,896,169,158,327,51.7%,7m
9281,2,[TDOW]Chocho,3381,649,47,49,96,49.0%,8m
9281,3,Rodan,3381,117,12,10,22,54.5%,8m
9281,3,IIIIIIIIIIII,3381,270,9,6,15,60.0%,7m
9281,3,[MiIIe]TiftersBruth,3381,274,9,14,23,39.1%,5m
9281,1,RasAlGhul,3381,119,6,1,7,85.7%,37m
9281,3,THEMANI,3381,0,2,3,5,40.0%,20m
9281,3,NØRD,3381,30,1,4,5,20.0%,21m
9281,3,[webcam]Volsere,3381,0,0,3,3,0.0%,20m
9290,2,DeADSAD,3380,1585,357,352,709,50.4%,16m
9290,1,потерпел,3380,1519,327,320,647,50.5%,11m
9290,3,Sigitang,3380,1589,188,179,367,51.2%,29m
9290,3,Spinnock,3380,1442,138,132,270,51.1%,13m
9290,3,Teebeutel,3380,1229,62,71,133,46.6%,4m
9290,3,SetoSylar,3380,1052,42,36,78,53.8%,42m
9290,3,[Ƶ5]Oceanworld,3380,361,21,15,36,58.3%,29m
9290,3,[SaviOr]GhostMaster,3380,490,18,16,34,52.9%,8m
9290,3,sutarcz,3380,456,17,9,26,65.4%,5m
9290,2,Iksosh,3380,107,12,20,32,37.5%,8m
9290,3,lilball,3380,300,11,9,20,55.0%,17m
9290,3,vergoin,3380,280,11,9,20,55.0%,17m
9290,3,PROteamart,3380,236,9,12,21,42.9%,42m
9290,3,Luca,3380,30,2,0,2,100.0%,42m
9290,1,DerNachbar,3380,95,2,3,5,40.0%,7m
9290,3,[Cannоn]Saitama,3380,0,1,0,1,100.0%,13m
9290,3,Kitty,3380,0,1,0,1,100.0%,20m
9290,3,[LTPX]EvilDuck,3380,30,1,4,5,20.0%,9m
9290,3,Exlegeek,3380,0,0,1,1,0.0%,7m
9290,3,GreWaRRed,3380,0,0,2,2,0.0%,7m
9310,2,[TheDOH]Themryon,3379,1516,146,149,295,49.5%,7m
9310,3,Funny,3379,1593,61,60,121,50.4%,14m
9310,3,[AiRǂ]Biscibasci,3379,558,23,16,39,59.0%,29m
9310,3,Zverg,3379,524,20,15,35,57.1%,17m
9310,3,Chemenem,3379,346,14,7,21,66.7%,20m
9310,3,Ormos,3379,164,11,15,26,42.3%,9m
9310,3,[RedFmm]Артем,3379,244,9,5,14,64.3%,20m
9310,3,[BAUZES]CptSideways,3379,114,5,0,5,100.0%,8m
9310,3,Study,3379,118,5,3,8,62.5%,19m
9310,3,Ayatsuru,3379,0,3,2,5,60.0%,8m
9310,1,[6PhD]ghost,3379,94,2,0,2,100.0%,20m
9310,1,[J4Fǂ]Kyex,3379,0,1,0,1,100.0%,32m
9310,3,conf,3379,0,1,0,1,100.0%,6m
9310,3,gunofbulshlt,3379,0,1,0,1,100.0%,42m
9310,3,Wochenplaner,3379,0,1,3,4,25.0%,7m
9310,3,Dennisel,3379,0,0,1,1,0.0%,29m
9310,3,DKH,3379,0,0,1,1,0.0%,42m
9310,3,balamut,3379,0,0,1,1,0.0%,11m
9310,3,[SMBH]Zwitter,3379,0,0,1,1,0.0%,10m
9310,2,krasto,3379,0,0,8,8,0.0%,4m
9330,3,CruzDirector,3378,1045,93,102,195,47.7%,28m
9330,3,Landsalmon,3378,531,45,35,80,56.2%,4m
9330,3,Hagbard,3378,1038,38,40,78,48.7%,4m
9330,3,Pikaboo,3378,791,37,29,66,56.1%,29m
9330,3,ssss,3378,482,18,13,31,58.1%,15m
9330,3,wurmvati,3378,458,17,20,37,45.9%,11m
9330,3,[OGCt]Ornkano,3378,334,13,11,24,54.2%,7m
9330,3,shock,3378,161,13,20,33,39.4%,18m
9330,3,YamaSita,3378,0,2,3,5,40.0%,15m
9330,3,LEO,3378,62,2,6,8,25.0%,20m
9330,1,lucifroom,3378,0,1,0,1,100.0%,19m
9330,3,[ĦRZ]Skimer,3378,0,0,1,1,0.0%,29m
9342,3,[LMBD]Mcsawyer,3377,1103,55,47,102,53.9%,19m
9342,2,Wildlife,3377,373,16,21,37,43.2%,16m
9342,3,netus,3377,394,14,17,31,45.2%,14m
9342,3,ProtoFossils,3377,368,14,18,32,43.8%,19m
9342,3,Asava,3377,190,8,0,8,100.0%,13m
9342,3,BlackAnubis,3377,206,7,13,20,35.0%,11m
9342,3,Tor,3377,152,5,7,12,41.7%,19m
9342,3,DOCG,3377,86,3,2,5,60.0%,12m
9342,3,supervillain,3377,94,3,7,10,30.0%,6m
9342,3,Damz,3377,0,1,0,1,100.0%,8m
9342,3,[WITRUM]Vitalos,3377,0,1,0,1,100.0%,11m
9342,1,[G4VR]IceNagaz,3377,94,1,1,2,50.0%,4m
9342,3,Youfi,3377,0,0,1,1,0.0%,15m
9342,3,ArielHanson,3377,0,0,1,1,0.0%,8m
9342,3,[PŖïMĄŁ]ApdmX,3377,0,0,4,4,0.0%,5m
9357,3,[НУБ]tazik,3376,1082,75,64,139,54.0%,8m
9357,3,FlausLord,3376,768,29,29,58,50.0%,9m
9357,3,[BeSC]AshOP,3376,594,23,22,45,51.1%,4m
9357,3,TisTus,3376,524,22,18,40,55.0%,8m
9357,3,Insuranceman,3376,228,12,8,20,60.0%,5m
9357,3,fatishmatish,3376,216,10,6,16,62.5%,42m
9357,3,[GEEZR]HighKill,3376,168,7,4,11,63.6%,4m
9357,3,EuroNight,3376,0,5,0,5,100.0%,4m
9357,3,snowfaster,3376,30,5,1,6,83.3%,42m
9357,3,boulevard,3376,144,5,6,11,45.5%,8m
9357,3,DEADMOROZ,3376,0,0,1,1,0.0%,20m
9368,2,ReVinCo,3375,1175,201,213,414,48.6%,14m
9368,3,Xillix,3375,1215,99,85,184,53.8%,27m
9368,3,Lucky,3375,1594,99,89,188,52.7%,42m
9368,3,LemonSqueezy,3375,464,20,13,33,60.6%,42m
9368,3,PortossMax,3375,444,20,15,35,57.1%,19m
9368,3,[Lobdok]GGutfright,3375,320,11,13,24,45.8%,20m
9368,3,Efreet,3375,0,5,1,6,83.3%,42m
9368,1,MUKHMAJONCH,3375,0,4,2,6,66.7%,6m
9368,3,[TaTe]Tommy,3375,0,0,1,1,0.0%,42m
9368,3,Guldan,3375,0,0,1,1,0.0%,6m
9368,3,[zorg12]zorg,3375,0,0,1,1,0.0%,5m
9368,3,[crabz]Kelmorn,3375,0,0,4,4,0.0%,8m
9380,3,ghydsg,3374,1515,245,225,470,52.1%,12m
9380,3,kusta,3374,590,127,117,244,52.0%,28m
9380,3,Sven,3374,1186,70,64,134,52.2%,16m
9380,3,[SZM]canublowme,3374,1530,66,69,135,48.9%,27m
9380,3,[NТB]ZergsPaPa,3374,666,26,26,52,50.0%,7m
9380,3,Happy,3374,144,3,4,7,42.9%,6m
9380,3,Atura,3374,30,2,0,2,100.0%,4m
9380,3,Kaisvap,3374,30,2,1,3,66.7%,8m
9380,3,zGerGou,3374,34,2,11,13,15.4%,8m
9380,3,Warbringer,3374,0,1,0,1,100.0%,19m
9380,3,Prototype,3374,30,1,1,2,50.0%,5m
9380,1,[WaCKi]Theus,3374,97,1,2,3,33.3%,16m
9380,3,Darcost,3374,30,1,2,3,33.3%,4m
9380,3,CountHarry,3374,0,1,4,5,20.0%,11m
9380,3,OnkelBob,3374,30,1,4,5,20.0%,20m
9380,3,Kladendes,3374,0,0,1,1,0.0%,4m
9380,3,MicroBeastTV,3374,0,0,1,1,0.0%,4m
9397,2,TeaMage,3373,487,305,296,601,50.7%,13m
9397,3,tot,3373,1558,239,236,475,50.3%,21m
9397,3,Wackedoe,3373,736,29,19,48,60.4%,5m
9397,3,Emmet,3373,638,26,15,41,63.4%,10m
9397,3,[Zelts]bbbloodmaker,3373,740,26,27,53,49.1%,27m
9397,3,PaLoaLTo,3373,527,20,13,33,60.6%,13m
9397,3,Pukiente,3373,530,17,28,45,37.8%,15m
9397,3,[ClCN]Colorin,3373,404,16,7,23,69.6%,21m
9397,3,[BULB]MrDarkTesla,3373,170,7,8,15,46.7%,18m
9397,3,Anti,3373,154,6,11,17,35.3%,8m
9397,3,Ден,3373,147,3,8,11,27.3%,10m
9397,3,[SXCG]HomE,3373,30,2,0,2,100.0%,5m
9397,3,[iBBQ]Skilltrick,3373,0,1,0,1,100.0%,10m
9397,3,Syyrup,3373,0,1,0,1,100.0%,4m
9397,2,PenguinClub,3373,30,1,8,9,11.1%,18m
9397,3,Smilodon,3373,0,0,1,1,0.0%,5m
9397,3,[ICDXXI]BadInFlüenCe,3373,0,0,3,3,0.0%,4m
9414,3,anders,3372,1153,135,136,271,49.8%,28m
9414,3,SledDave,3372,951,79,76,155,51.0%,8m
9414,3,IIIIIIIIIIII,3372,672,44,34,78,56.4%,8m
9414,3,Chaddaï,3372,964,37,35,72,51.4%,4m
9414,3,[WOO]StJohannes,3372,918,34,34,68,50.0%,5m
9414,3,BanShee,3372,675,32,11,43,74.4%,19m
9414,3,Sköhel,3372,490,30,19,49,61.2%,28m
9414,3,Kalbsbeuschl,3372,660,26,22,48,54.2%,10m
9414,3,Cocaines,3372,186,14,10,24,58.3%,4m
9414,3,Augn,3372,217,10,12,22,45.5%,17m
9414,3,[OTLSS]ItsAcidTime,3372,222,9,8,17,52.9%,20m
9414,3,Pubby,3372,185,6,4,10,60.0%,4m
9414,3,Rohkar,3372,116,4,4,8,50.0%,6m
9414,3,[Nec]incompatible,3372,205,4,9,13,30.8%,10m
9414,3,llllllllllll,3372,30,2,0,2,100.0%,17m
9414,3,[ZERGТV]Darkinsk,3372,0,1,1,2,50.0%,29m
9414,3,ReddevilFM,3372,0,1,1,2,50.0%,11m
9414,3,Zero,3372,0,0,1,1,0.0%,10m
9414,3,IIIIIIIIIIII,3372,0,0,2,2,0.0%,29m
9414,3,Ætheling,3372,0,0,3,3,0.0%,20m
9414,3,Rumble,3372,0,0,3,3,0.0%,12m
9435,3,[DМG]storm,3371,1599,536,526,1062,50.5%,10m
9435,3,lookaround,3371,1535,177,174,351,50.4%,11m
9435,3,Eluss,3371,489,49,45,94,52.1%,12m
9435,3,FiddeBo,3371,913,35,37,72,48.6%,5m
9435,3,[NoLair]Lords,3371,759,33,20,53,62.3%,29m
9435,3,[IndyK]ZaGGara,3371,282,31,24,55,56.4%,8m
9435,3,Naserox,3371,514,20,17,37,54.1%,4m
9435,3,TimeLord,3371,387,17,11,28,60.7%,4m
9435,2,CooLio,3371,232,8,23,31,25.8%,7m
9435,3,TommyShelby,3371,146,6,5,11,54.5%,19m
9435,2,Icki,3371,0,4,1,5,80.0%,11m
9435,3,[BRSKR]firendted,3371,58,3,1,4,75.0%,13m
9435,3,Judeau,3371,86,3,2,5,60.0%,27m
9435,2,LeTrac,3371,0,3,4,7,42.9%,17m
9435,3,MarmitePilot,3371,30,2,2,4,50.0%,4m
9435,3,[PlantZ]Albin,3371,0,2,5,7,28.6%,14m
9435,3,[IceHus]Ratmir,3371,0,1,0,1,100.0%,19m
9435,3,Dorian,3371,30,1,1,2,50.0%,11m
9435,3,NinjaHyper,3371,0,1,1,2,50.0%,19m
9435,3,Regis,3371,30,1,5,6,16.7%,9m
9435,3,morik,3371,0,0,1,1,0.0%,7m
9456,3,Heresy,3370,1555,135,118,253,53.4%,7m
9456,3,Mea,3370,1537,74,69,143,51.7%,17m
9456,3,ketoumymy,3370,796,44,36,80,55.0%,10m
9456,3,maaex,3370,978,39,28,67,58.2%,28m
9456,3,[SEXi]itzNaix,3370,730,38,30,68,55.9%,42m
9456,3,GhostMask,3370,702,27,23,50,54.0%,11m
9456,3,[6P00L]Freppan,3370,432,19,13,32,59.4%,29m
9456,3,[TaBite]Novapoik,3370,175,13,8,21,61.9%,9m
9456,3,[WaSl]TheButcher,3370,172,6,4,10,60.0%,6m
9456,3,[mfixed]drzungla,3370,136,4,0,4,100.0%,10m
9456,3,Thracian,3370,86,4,5,9,44.4%,28m
9456,1,SKliveevil,3370,122,3,3,6,50.0%,9m
9456,3,Juviken,3370,30,2,1,3,66.7%,13m
9456,3,IIllIIlIlIll,3370,119,2,3,5,40.0%,17m
9456,3,StuckDiamond,3370,0,0,1,1,0.0%,27m
9456,3,BadaBadMan,3370,0,0,5,5,0.0%,17m
9472,3,[HFR]pollux,3369,1572,218,199,417,52.3%,13m
9472,3,Shlex,3369,1539,139,143,282,49.3%,17m
9472,3,Monrot,3369,1636,95,79,174,54.6%,4m
9472,3,PrinceHarry,3369,1182,92,65,157,58.6%,14m
9472,3,[TuRki]Deidara,3369,1099,49,32,81,60.5%,19m
9472,3,[Teplay]Fuhio,3369,1104,45,40,85,52.9%,8m
9472,3,yodaogkush,3369,381,19,10,29,65.5%,29m
9472,3,Alucard,3369,189,9,3,12,75.0%,41m
9472,2,[CFX]Rovado,3369,230,6,16,22,27.3%,27m
9472,3,Shift,3369,68,5,4,9,55.6%,13m
9472,3,Dema,3369,88,4,2,6,66.7%,8m
9472,3,[OMGHAM]OMGJAMBON,3369,90,4,3,7,57.1%,17m
9472,3,[Deleam]WarLord,3369,0,1,0,1,100.0%,4m
9472,3,[roundh]Pkunk,3369,30,1,1,2,50.0%,6m
9472,1,Arcturus,3369,0,0,1,1,0.0%,19m
9472,3,Kigaldo,3369,0,0,2,2,0.0%,20m
9488,3,Mao,3368,1617,286,274,560,51.1%,10m
9488,3,théàlamenthe,3368,1501,88,84,172,51.2%,17m
9488,3,Pulsar,3368,1435,87,82,169,51.5%,4m
9488,2,Sava,3368,1541,76,84,160,47.5%,12m
9488,3,insolol,3368,1436,54,62,116,46.6%,9m
9488,3,SlovaRic,3368,984,39,27,66,59.1%,8m
9488,3,Cooper,3368,913,37,43,80,46.2%,20m
9488,3,Blab,3368,468,19,22,41,46.3%,10m
9488,3,Narisia,3368,394,17,20,37,45.9%,15m
9488,3,[TheDOH]ElStaso,3368,380,15,15,30,50.0%,10m
9488,3,[ECFeV]Czuppy,3368,348,13,6,19,68.4%,8m
9488,3,Squeezy,3368,88,7,3,10,70.0%,9m
9488,3,[BEV]WhyNot,3368,140,6,2,8,75.0%,10m
9488,3,astOOr,3368,174,6,9,15,40.0%,20m
9488,3,Chapa,3368,154,5,11,16,31.2%,7m
9488,3,DOOM,3368,135,3,8,11,27.3%,7m
9488,3,jkmaks,3368,30,2,2,4,50.0%,11m
9488,3,[VMAD]pizzaeater,3368,30,1,3,4,25.0%,7m
9488,3,[Nezuko]CodexVII,3368,0,0,3,3,0.0%,10m
9507,3,[FR1]Shanks,3367,1139,49,41,90,54.4%,18m
9507,3,Neowise,3367,621,22,25,47,46.8%,6m
9507,3,[Ohana]SweaeR,3367,429,19,11,30,63.3%,27m
9507,3,Baghtis,3367,400,18,8,26,69.2%,27m
9507,3,Gamman,3367,295,14,6,20,70.0%,11m
9507,3,MELIQ,3367,334,12,12,24,50.0%,8m
9507,3,GoGrillU,3367,142,5,2,7,71.4%,17m
9507,3,[aW]Whitelinker,3367,120,4,5,9,44.4%,4m
9507,3,[C0RE]Jerry,3367,93,2,1,3,66.7%,15m
9507,3,[EzPez]Akestro,3367,30,2,1,3,66.7%,10m
9507,3,Sleeky,3367,0,2,3,5,40.0%,12m
9507,3,DCHok,3367,0,1,0,1,100.0%,27m
9507,3,[MlGHTY]Atze,3367,0,0,1,1,0.0%,7m
9507,2,Apostol,3367,0,0,2,2,0.0%,7m
9521,3,Tar,3366,1609,239,217,456,52.4%,28m
9521,3,shotgun,3366,1609,126,104,230,54.8%,4m
9521,3,Japi,3366,1149,100,102,202,49.5%,42m
9521,2,[PiGPan]SMÔrangeUtan,3366,1066,81,90,171,47.4%,18m
9521,3,GoodGame,3366,144,15,11,26,57.7%,7m
9521,1,Brocklyn,3366,319,7,11,18,38.9%,12m
9521,1,Tetsuo,3366,97,5,1,6,83.3%,7m
9521,3,[SpaceB]LoneStar,3366,197,5,10,15,33.3%,20m
9521,3,HeaDacHe,3366,114,4,3,7,57.1%,6m
9521,3,[CCHP]MicroChelik,3366,87,4,4,8,50.0%,9m
9521,3,[IRager]RagingNyke,3366,30,1,1,2,50.0%,8m
9521,3,MadMax,3366,30,1,2,3,33.3%,10m
9521,3,VoxTemporis,3366,0,1,3,4,25.0%,29m
9521,3,[WoPe]Torumon,3366,0,0,1,1,0.0%,10m
9521,3,Exie,3366,0,0,1,1,0.0%,6m
9521,3,Revoloot,3366,0,0,2,2,0.0%,6m
9521,3,Strong,3366,0,0,2,2,0.0%,13m
9521,3,JasOnX,3366,0,0,2,2,0.0%,5m
9521,3,[ValidG]Kenshin,3366,0,0,2,2,0.0%,4m
9540,3,LeX,3365,1473,282,240,522,54.0%,13m
9540,3,TheJuice,3365,1071,85,88,173,49.1%,6m
9540,3,[CSLD]Jonsc,3365,290,64,53,117,54.7%,11m
9540,3,[EHET]LeChatVentru,3365,736,26,30,56,46.4%,13m
9540,3,ScottyP,3365,392,17,8,25,68.0%,42m
9540,3,Muffin,3365,446,17,17,34,50.0%,42m
9540,3,YdOOm,3365,377,15,3,18,83.3%,15m
9540,3,[DemuCl]rhoeb,3365,112,5,6,11,45.5%,29m
9540,2,DaSupervisor,3365,148,3,14,17,17.6%,12m
9540,3,Medievil,3365,97,2,1,3,66.7%,15m
9540,1,[Мaстер]Князь,3365,0,1,0,1,100.0%,7m
9551,2,[MWAF]fulger,3364,1558,496,477,973,51.0%,4m
9551,2,BioRNN,3364,780,90,83,173,52.0%,28m
9551,3,Zalupiy,3364,755,33,28,61,54.1%,14m
9551,2,SixGuns,3364,353,19,34,53,35.8%,6m
9551,3,[GNKLR]Arithras,3364,398,16,13,29,55.2%,5m
9551,2,Gantar,3364,160,8,4,12,66.7%,14m
9551,3,[СКМ]asd,3364,120,6,1,7,85.7%,9m
9551,3,Megumin,3364,140,6,1,7,85.7%,12m
9551,1,[Tyзик]WhiteShadow,3364,0,5,1,6,83.3%,32m
9551,3,Cropon,3364,88,4,3,7,57.1%,29m
9551,3,[crabz]Vladimir,3364,0,1,0,1,100.0%,15m
9551,3,[ZP777]MegaMakc,3364,0,1,0,1,100.0%,8m
9551,3,[LGE]DoublRainbow,3364,0,1,2,3,33.3%,10m
9551,3,gimmadibutzi,3364,0,0,2,2,0.0%,13m
9551,3,DarkDeemen,3364,0,0,3,3,0.0%,6m
9566,3,Gatssu,3363,962,146,132,278,52.5%,4m
9566,3,velbloud,3363,644,25,19,44,56.8%,10m
9566,3,[ÆR]Bakó,3363,466,19,12,31,61.3%,6m
9566,3,FierceBunneh,3363,328,11,7,18,61.1%,11m
9566,3,PassionPlaya,3363,243,10,12,22,45.5%,19m
9566,2,Drullen,3363,254,7,7,14,50.0%,21m
9566,3,sweetfood,3363,86,3,2,5,60.0%,12m
9566,3,ChaoSLogiC,3363,60,3,3,6,50.0%,16m
9566,3,Dalevi,3363,60,3,3,6,50.0%,19m
9566,3,[giBik]Iceman,3363,60,3,5,8,37.5%,17m
9566,3,jojozocker,3363,60,2,3,5,40.0%,8m
9566,3,Decifer,3363,0,1,0,1,100.0%,29m
9566,3,[RA08]Jarnomon,3363,30,1,2,3,33.3%,7m
9566,3,Baffius,3363,0,0,1,1,0.0%,10m
9566,3,SolarisDream,3363,0,0,1,1,0.0%,4m
9566,2,Flint,3363,0,0,1,1,0.0%,15m
9566,3,Erex,3363,0,0,1,1,0.0%,4m
9566,3,MrLinoyk,3363,0,0,1,1,0.0%,11m
9566,3,PRIDE,3363,0,0,2,2,0.0%,9m
9566,3,[Biu]Noir,3363,0,0,2,2,0.0%,9m
9566,3,[BTownR]TuschekBTR,3363,0,0,2,2,0.0%,17m
9587,3,[PCCxxx]Bennå,3362,1086,91,73,164,55.5%,7m
9587,3,MPmp,3362,1036,88,74,162,54.3%,28m
9587,3,[CH33SE]BatTotoro,3362,1159,86,87,173,49.7%,11m
9587,3,Lonkero,3362,1029,46,32,78,59.0%,6m
9587,3,[3IQ]Kpi,3362,256,37,37,74,50.0%,12m
9587,3,FADIMUH,3362,646,35,29,64,54.7%,4m
9587,3,Fexx,3362,420,24,14,38,63.2%,11m
9587,3,MaxPowerrr,3362,197,23,12,35,65.7%,18m
9587,3,Joefish,3362,485,22,10,32,68.8%,5m
9587,3,[PSlSTC]Reborn,3362,340,13,12,25,52.0%,9m
9587,3,[BIIC]Scuteeboii,3362,196,9,6,15,60.0%,28m
9587,3,CallMeMaybe,3362,146,8,10,18,44.4%,12m
9587,3,[DMI]SauceBoss,3362,138,7,7,14,50.0%,20m
9587,3,MaDFrou,3362,237,7,11,18,38.9%,29m
9587,3,[ENQ]Yarxxxnov,3362,206,7,12,19,36.8%,10m
9587,3,pirofany,3362,143,5,4,9,55.6%,2m
9587,3,Opalfruits,3362,30,2,2,4,50.0%,20m
9587,3,[Nepr]IPsmr,3362,0,1,0,1,100.0%,6m
9587,3,[CUB]Zeratyl,3362,0,1,3,4,25.0%,13m
9606,2,[DGSQ]EmperiumObes,3361,1515,98,106,204,48.0%,9m
9606,2,[RedFmm]REDDEVIL,3361,1199,87,92,179,48.6%,18m
9606,3,Refactor,3361,548,86,88,174,49.4%,13m
9606,3,CarpetDiatom,3361,978,51,47,98,52.0%,12m
9606,3,Ultimate,3361,303,25,23,48,52.1%,4m
9606,3,[lLiTl]DREDGE,3361,400,14,22,36,38.9%,7m
9606,3,[Pitw]Vini,3361,254,9,14,23,39.1%,16m
9606,2,Takeda,3361,228,8,12,20,40.0%,7m
9606,3,[MMower]matheux,3361,60,7,4,11,63.6%,4m
9606,3,Archinoob,3361,180,6,7,13,46.2%,19m
9606,1,Principal,3361,168,5,2,7,71.4%,12m
9606,1,lllllllll,3361,42,2,0,2,100.0%,7m
9606,3,[JBPs]saneb,3361,0,1,0,1,100.0%,3m
9606,3,Swofie,3361,0,1,2,3,33.3%,18m
9606,1,[S4cr3]Zengard,3361,0,0,1,1,0.0%,25m
9606,1,Foopad,3361,0,0,1,1,0.0%,2m
9606,3,LikeICare,3361,0,0,1,1,0.0%,2m
9606,3,GoodEvening,3361,0,0,1,1,0.0%,4m
9606,3,llllllllllll,3361,0,0,1,1,0.0%,15m
9606,3,КОРИЦА,3361,0,0,3,3,0.0%,4m
9626,3,HaveANiceDay,3360,1219,137,129,266,51.5%,11m
9626,3,[Veym]GeantVert,3360,1093,65,57,122,53.3%,19m
9626,3,[EvilGs]deaconfrost,3360,1155,63,57,120,52.5%,4m
9626,3,sexySamurai,3360,998,37,41,78,47.4%,11m
9626,3,SorrowShine,3360,295,20,16,36,55.6%,17m
9626,3,Hadeskorv,3360,462,18,18,36,50.0%,6m
9626,3,[DNvL]KillerQualle,3360,246,13,13,26,50.0%,18m
9626,3,[FLU5H]ArchonToilet,3360,204,7,8,15,46.7%,4m
9626,3,Ayako,3360,0,5,0,5,100.0%,11m
9626,3,[HypeSw]TERMINATOR,3360,88,4,10,14,28.6%,20m
9626,3,Facenapalm,3360,58,2,1,3,66.7%,4m
9626,2,[K4w4iy]Kratos,3360,44,2,2,4,50.0%,3m
9626,3,[tvESP]maralekos,3360,30,2,5,7,28.6%,6m
9626,3,oIITiMicT,3360,0,1,0,1,100.0%,8m
9626,3,RUBlind,3360,0,1,0,1,100.0%,10m
9626,3,Adidose,3360,30,1,2,3,33.3%,8m
9626,3,Zantim,3360,0,0,3,3,0.0%,17m
9643,3,Palef,3359,1501,167,163,330,50.6%,5m
9643,3,Darki,3359,904,128,114,242,52.9%,15m
9643,3,Serenity,3359,724,76,76,152,50.0%,10m
9643,2,AresNyx,3359,1383,62,64,126,49.2%,7m
9643,3,Nouee,3359,772,61,58,119,51.3%,6m
9643,3,YiMiY,3359,1162,51,56,107,47.7%,2m
9643,3,beuzathor,3359,1316,49,47,96,51.0%,3m
9643,3,[LESeV]EFG,3359,473,21,18,39,53.8%,17m
9643,3,GhostDog,3359,324,11,16,27,40.7%,8m
9643,3,[AtomM]Zetla,3359,200,7,12,19,36.8%,15m
9643,3,Sublime,3359,139,6,4,10,60.0%,21m
9643,3,BALiKA,3359,114,5,4,9,55.6%,4m
9643,3,xliqhtbeatz,3359,86,4,7,11,36.4%,6m
9643,3,Alfaruez,3359,60,3,1,4,75.0%,3m
9643,3,[0BO]Eribour,3359,42,1,9,10,10.0%,21m
9643,3,[DLKÅ]Blackswarma,3359,0,0,1,1,0.0%,2m
9659,3,notyou,3358,1546,650,635,1285,50.6%,6m
9659,3,Hethron,3358,1287,222,212,434,51.2%,10m
9659,3,Muminpappa,3358,1276,68,67,135,50.4%,2m
9659,3,DeepS,3358,842,67,52,119,56.3%,4m
9659,3,[PTZMuc]Darkness,3358,728,29,20,49,59.2%,6m
9659,3,DreamLord,3358,790,29,30,59,49.2%,2m
9659,3,VincentVega,3358,638,26,19,45,57.8%,14m
9659,3,Offe,3358,301,13,11,24,54.2%,4m
9659,3,AiRǂBlackØut,3358,402,13,20,33,39.4%,14m
9659,1,ash,3358,142,7,1,8,87.5%,14m
9659,3,LarrenOPGG,3358,189,7,4,11,63.6%,19m
9659,3,[Drsnak]YaNo,3358,184,7,10,17,41.2%,4m
9659,3,[Abs]Absolutiøn,3358,0,1,0,1,100.0%,21m
9659,3,Flens,3358,30,1,1,2,50.0%,15m
9659,3,[TheDOH]Sledgar,3358,30,1,3,4,25.0%,2m
9659,3,[QTclub]Sentinel,3358,0,0,1,1,0.0%,12m
9675,3,hyper,3357,1628,344,340,684,50.3%,13m
9675,3,[Pollas]Garoth,3357,1340,131,120,251,52.2%,15m
9675,3,Phoenix,3357,1587,94,83,177,53.1%,9m
9675,3,reppana,3357,531,62,54,116,53.4%,11m
9675,3,balbla,3357,536,19,20,39,48.7%,2m
9675,3,Savilise,3357,392,16,15,31,51.6%,4m
9675,3,Hydrix,3357,345,12,9,21,57.1%,2m
9675,3,[HZeS]gollor,3357,240,9,5,14,64.3%,12m
9675,3,[W4R]freshmeat,3357,265,9,6,15,60.0%,3m
9675,3,Magic,3357,114,5,7,12,41.7%,3m
9675,3,ItsNoHax,3357,124,4,7,11,36.4%,6m
9675,3,NeeChan,3357,58,3,2,5,60.0%,7m
9675,3,[Melk]Arie,3357,0,1,2,3,33.3%,8m
9675,3,[P2D2]JessyChrist,3357,0,0,1,1,0.0%,14m
9675,3,Enthalpy,3357,0,0,1,1,0.0%,19m
9675,3,Bargosh,3357,0,0,1,1,0.0%,20m
9675,3,Teschy,3357,0,0,1,1,0.0%,11m
9675,3,Daan,3357,0,0,1,1,0.0%,5m
9693,2,Wizzard,3356,1556,237,250,487,48.7%,8m
9693,3,HellcaT,3356,1620,90,78,168,53.6%,14m
9693,2,[OРДА]Gerikgood,3356,1451,68,72,140,48.6%,14m
9693,3,Empty,3356,1305,56,49,105,53.3%,16m
9693,3,whitemonk,3356,769,35,35,70,50.0%,13m
9693,3,whiteman,3356,740,28,26,54,51.9%,1m
9693,3,[MoT]AlexDT,3356,653,24,26,50,48.0%,13m
9693,3,Guybrush,3356,385,13,12,25,52.0%,19m
9693,3,[Ebanie]Kamenation,3356,226,8,10,18,44.4%,2m
9693,1,Оливия,3356,166,7,2,9,77.8%,24m
9693,3,Blaine,3356,30,5,1,6,83.3%,10m
9693,2,[Blacer]Deminz,3356,154,5,18,23,21.7%,7m
9693,3,Danil,3356,122,4,8,12,33.3%,21m
9693,3,Ziconius,3356,60,2,3,5,40.0%,1m
9693,3,Ardenit,3356,30,2,4,6,33.3%,5m
9693,3,Rosdahl,3356,0,1,0,1,100.0%,5m
9693,3,mouse,3356,0,1,0,1,100.0%,3m
9693,3,DBko,3356,30,1,2,3,33.3%,12m
9693,1,Ghabryel,3356,0,0,1,1,0.0%,53m
9693,3,Mybàran,3356,0,0,1,1,0.0%,2m
9693,3,[LGNDS]Delta,3356,0,0,1,1,0.0%,3m
9693,3,Despair,3356,0,0,1,1,0.0%,4m
9715,3,Sterax,3355,1430,118,112,230,51.3%,7m
9715,3,[TheSBU]firebabys,3355,1550,81,84,165,49.1%,8m
9715,3,[HACK3R]MatsuPro,3355,1427,76,69,145,52.4%,8m
9715,3,KeNOh,3355,1265,59,39,98,60.2%,6m
9715,3,nalOg,3355,479,43,31,74,58.1%,1m
9715,3,Bejebas,3355,285,18,7,25,72.0%,13m
9715,3,Taureg,3355,468,17,22,39,43.6%,20m
9715,3,Kimar,3355,200,8,8,16,50.0%,19m
9715,3,gevilde,3355,0,2,3,5,40.0%,15m
9715,3,Bruhlord,3355,58,2,3,5,40.0%,17m
9715,3,[Arrows]FishOnFire,3355,30,1,1,2,50.0%,19m
9715,3,kesha,3355,0,0,2,2,0.0%,1m
9727,3,Wisefull,3354,1153,83,78,161,51.6%,9m
9727,3,pawn,3354,801,40,10,50,80.0%,19m
9727,3,Kraa,3354,230,26,23,49,53.1%,19m
9727,3,[DTBU]Psio,3354,706,25,29,54,46.3%,4m
9727,3,SoftMist,3354,429,24,10,34,70.6%,15m
9727,2,ParkSodam,3354,630,22,25,47,46.8%,18m
9727,2,SkyCloud,3354,247,12,5,17,70.6%,3m
9727,2,[giBik]BScythe,3354,238,12,24,36,33.3%,9m
9727,2,pizu,3354,252,10,15,25,40.0%,19m
9727,3,Cake,3354,227,8,3,11,72.7%,6m
9727,1,WTF,3354,163,6,4,10,60.0%,19m
9727,3,кортавыйтигр,3354,118,4,3,7,57.1%,6m
9727,3,Tagged,3354,116,4,13,17,23.5%,14m
9727,3,[ENP]Votan,3354,0,0,1,1,0.0%,8m
9727,3,Отделочник,3354,0,0,1,1,0.0%,11m
9727,3,Unleashed,3354,0,0,3,3,0.0%,7m
9727,3,ViktorRajniy,3354,0,0,3,3,0.0%,17m
9727,3,Micolash,3354,0,0,3,3,0.0%,3m
9745,2,Overed,3353,1514,104,105,209,49.8%,10m
9745,3,HeadHunter,3353,1323,53,49,102,52.0%,15m
9745,2,[DАRK]FoxSilioN,3353,697,43,52,95,45.3%,8m
9745,3,[ECOMP]maula,3353,284,11,18,29,37.9%,12m
9745,3,Naruto,3353,193,9,3,12,75.0%,19m
9745,3,[RBP3]Zli,3353,204,8,9,17,47.1%,10m
9745,3,[FxL]Genti,3353,88,4,4,8,50.0%,10m
9745,3,FlameForFame,3353,0,1,1,2,50.0%,11m
9745,3,ElderLeaf,3353,0,1,2,3,33.3%,10m
9745,1,LordSlav,3353,0,0,1,1,0.0%,14m
9755,3,[beebop]pinkmantis,3352,1579,170,154,324,52.5%,17m
9755,3,Noc,3352,1650,167,145,312,53.5%,13m
9755,2,Pleydellia,3352,1509,139,156,295,47.1%,1m
9755,3,DEATH,3352,1297,80,70,150,53.3%,15m
9755,3,Mistgun,3352,1232,66,58,124,53.2%,20m
9755,3,Shentoza,3352,1417,62,54,116,53.4%,14m
9755,3,[OaSa]Styxx,3352,1342,62,60,122,50.8%,14m
9755,2,Broodmann,3352,455,21,23,44,47.7%,4m
9755,3,vincent,3352,258,9,3,12,75.0%,3m
9755,3,killik,3352,260,9,6,15,60.0%,13m
9755,3,BiL,3352,163,7,2,9,77.8%,11m
9755,3,Vampire,3352,142,7,6,13,53.8%,19m
9755,3,SaikiK,3352,178,5,3,8,62.5%,4m
9755,3,Rugrud,3352,0,1,0,1,100.0%,14m
9755,3,Paco,3352,0,1,7,8,12.5%,11m
9755,3,[KDV]Yoda,3352,0,0,1,1,0.0%,14m
9771,3,Cigar,3351,1110,149,110,259,57.5%,15m
9771,3,[POLon]Voyo,3351,1296,139,132,271,51.3%,14m
9771,3,[LURS]Maskinen,3351,1494,103,96,199,51.8%,17m
9771,3,DCSiyeon,3351,1546,64,63,127,50.4%,5m
9771,3,Xanjin,3351,614,32,36,68,47.1%,11m
9771,2,tryharder,3351,626,30,26,56,53.6%,8m
9771,3,Rebirth,3351,603,25,21,46,54.3%,7m
9771,3,[unƊeaƊ]jeanjean,3351,629,24,15,39,61.5%,4m
9771,2,Zephyrum,3351,546,18,30,48,37.5%,20m
9771,3,Guga,3351,205,15,15,30,50.0%,16m
9771,3,Bicon,3351,358,13,14,27,48.1%,14m
9771,3,[Abadie]Sophie,3351,242,10,3,13,76.9%,1m
9771,2,[Planos]Schultz,3351,250,10,5,15,66.7%,8m
9771,1,summonerho,3351,96,5,1,6,83.3%,11m
9771,3,[Чизеры]ReLLoMine,3351,0,1,0,1,100.0%,10m
9771,3,Bort,3351,0,1,3,4,25.0%,20m
9771,1,karoci,3351,0,0,1,1,0.0%,13m
9771,3,[ESErl]Devastating,3351,0,0,1,1,0.0%,7m
9771,3,BlazingMoon,3351,0,0,1,1,0.0%,15m
9771,3,VogortS,3351,0,0,1,1,0.0%,16m
9791,3,[Овощи]Easy,3350,935,56,43,99,56.6%,14m
9791,3,Knowing,3350,1154,48,37,85,56.5%,5m
9791,3,DrNoob,3350,1261,47,55,102,46.1%,3m
9791,3,[MLKSTK]ares,3350,828,46,49,95,48.4%,21m
9791,3,Karamba,3350,705,30,21,51,58.8%,1m
9791,3,[SC2ERZ]MoorPheuS,3350,394,13,21,34,38.2%,21m
9791,3,Philip,3350,118,6,5,11,54.5%,4m
9791,3,Flopik,3350,180,6,11,17,35.3%,1m
9791,3,[KaaTri]TriX,3350,60,3,3,6,50.0%,1m
9791,3,[MPTUS]FisTeR,3350,90,3,5,8,37.5%,1m
9791,3,PACETO,3350,90,3,10,13,23.1%,4m
9791,3,[Bricky]Crocky,3350,100,3,15,18,16.7%,4m
9791,3,[LQV]lûcky,3350,30,2,1,3,66.7%,7m
9791,3,Parasitics,3350,0,1,0,1,100.0%,6m
9791,2,Sephiroth,3350,0,1,1,2,50.0%,20m
9791,3,[IceHus]оливье,3350,0,1,1,2,50.0%,4m
9791,3,[NerCC]jan,3350,0,0,1,1,0.0%,17m
9791,3,thejazzapple,3350,0,0,1,1,0.0%,4m
9791,3,[Hаsu]Ford,3350,0,0,1,1,0.0%,10m
9791,3,Kikounousse,3350,0,0,2,2,0.0%,3m
9791,3,[Ǽ1]OHARA,3350,0,0,2,2,0.0%,4m
9812,3,DuokSemku,3349,1566,196,177,373,52.5%,18m
9812,3,Whirros,3349,536,97,51,148,65.5%,6m
9812,3,Yoo,3349,1590,91,70,161,56.5%,11m
9812,3,[5up]SWiggels,3349,1372,52,52,104,50.0%,20m
9812,3,Ageus,3349,516,39,38,77,50.6%,21m
9812,3,[ISV]JustLikE,3349,178,16,14,30,53.3%,2m
9812,3,Guillaume,3349,392,14,16,30,46.7%,12m
9812,3,Prometheus,3349,150,5,9,14,35.7%,11m
9812,1,Ren,3349,138,4,1,5,80.0%,14m
9812,2,Bleuelephant,3349,134,4,18,22,18.2%,9m
9812,3,Ace,3349,0,1,4,5,20.0%,3m
9812,3,[TaTe]SpryToss,3349,0,0,1,1,0.0%,4m
9812,3,[xUKPx]Szaller,3349,0,0,1,1,0.0%,2m
9812,3,JsL,3349,0,0,5,5,0.0%,9m
9826,2,[AciNoN]Invader,3348,726,65,48,113,57.5%,4m
9826,3,Mengsk,3348,989,50,54,104,48.1%,14m
9826,3,BlutwurschT,3348,1042,37,41,78,47.4%,9m
9826,3,CROMRAZ,3348,692,27,17,44,61.4%,19m
9826,3,Rmx,3348,307,19,16,35,54.3%,6m
9826,3,Банши,3348,384,15,10,25,60.0%,14m
9826,3,FlyHugh,3348,312,11,13,24,45.8%,8m
9826,2,Mewyn,3348,207,10,4,14,71.4%,4m
9826,3,[0u0]PiroPito,3348,180,9,8,17,52.9%,14m
9826,3,dontdo,3348,114,8,4,12,66.7%,12m
9826,3,УБЕЖдённый,3348,80,6,5,11,54.5%,15m
9826,1,Beuhbel,3348,140,2,5,7,28.6%,2m
9826,3,bariball,3348,0,1,0,1,100.0%,4m
9826,3,Boundless,3348,0,1,0,1,100.0%,8m
9826,3,IIIIIIIIIIII,3348,0,1,0,1,100.0%,21m
9826,3,kungenaa,3348,0,1,6,7,14.3%,20m
9826,3,SFJ,3348,0,0,1,1,0.0%,15m
9843,3,[Arrows]LoMaster,3347,616,23,23,46,50.0%,3m
9843,3,[ICSDS]DENPOY,3347,507,21,14,35,60.0%,20m
9843,3,[ZERGML]Even,3347,304,11,11,22,50.0%,9m
9843,3,[Gr3]maxs,3347,278,10,9,19,52.6%,20m
9843,1,AMG,3347,180,5,2,7,71.4%,2m
9843,3,vladh,3347,88,3,3,6,50.0%,2m
9843,3,naniHug,3347,30,2,5,7,28.6%,1m
9843,3,rafadegout,3347,0,1,0,1,100.0%,3m
9843,3,OtecAnisim,3347,0,1,0,1,100.0%,18m
9843,3,[TLitt]sensei,3347,0,1,1,2,50.0%,12m
9843,3,kersy,3347,0,0,1,1,0.0%,10m
9843,3,SekaJr,3347,0,0,1,1,0.0%,6m
9843,3,[TOUCAN]FunkyDrood,3347,0,0,1,1,0.0%,19m
9843,3,XxYOURMUMxX,3347,0,0,1,1,0.0%,11m
9843,3,Cixy,3347,0,0,1,1,0.0%,2m
9858,2,Blackczs,3346,1277,135,134,269,50.2%,7m
9858,3,vonder,3346,1607,93,80,173,53.8%,6m
9858,3,Reminasch,3346,457,45,33,78,57.7%,20m
9858,3,FaTe,3346,738,26,30,56,46.4%,21m
9858,3,oDiNe,3346,623,25,21,46,54.3%,4m
9858,3,Alpha,3346,511,21,21,42,50.0%,21m
9858,3,[NvBa]Jackawaka,3346,358,13,14,27,48.1%,16m
9858,3,[PiGPan]weegee,3346,346,12,18,30,40.0%,20m
9858,3,[XNTC]net,3346,287,10,15,25,40.0%,17m
9858,3,[HBGS]ElectrO,3346,266,10,17,27,37.0%,8m
9858,3,Cnsbmkpsr,3346,218,9,2,11,81.8%,2m
9858,1,[CIB]TIC,3346,249,9,7,16,56.2%,18m
9858,3,Mirage,3346,120,5,3,8,62.5%,8m
9858,3,Borzvu,3346,94,4,9,13,30.8%,17m
9858,3,Bwana,3346,0,0,1,1,0.0%,2m
9873,3,[voff]spacey,3345,1323,98,101,199,49.2%,3m
9873,3,flux,3345,1405,80,82,162,49.4%,3m
9873,2,MicroElf,3345,1069,52,69,121,43.0%,7m
9873,3,[mfxed]dawid,3345,1032,48,33,81,59.3%,14m
9873,3,Lenovo,3345,386,15,15,30,50.0%,7m
9873,3,TryHard,3345,275,14,5,19,73.7%,3m
9873,3,zblob,3345,386,13,11,24,54.2%,18m
9873,3,[Splend]Kirenai,3345,251,11,5,16,68.8%,19m
9873,3,[DEPH]LostBacon,3345,225,10,5,15,66.7%,13m
9873,3,PooHolePirat,3345,161,8,1,9,88.9%,7m
9873,3,feardragon,3345,195,8,5,13,61.5%,7m
9873,3,[bullD]WhySoSerious,3345,174,6,11,17,35.3%,2m
9873,2,SigmaFactor,3345,96,5,1,6,83.3%,21m
9873,3,BillyJoe,3345,0,3,2,5,60.0%,14m
9873,3,avon,3345,86,3,5,8,37.5%,20m
9873,3,[GАYSS]IIIIIIIIIIII,3345,0,1,0,1,100.0%,16m
9889,3,callzumen,3344,1541,432,404,836,51.7%,19m
9889,3,FuriousDuck,3344,1325,108,81,189,57.1%,15m
9889,3,NateRiver,3344,1577,107,112,219,48.9%,3m
9889,3,[ǂIAMǂ]SetoKaiba,3344,501,27,5,32,84.4%,5m
9889,3,[Muster]Frettchen,3344,750,26,31,57,45.6%,9m
9889,3,Gravix,3344,504,21,21,42,50.0%,1m
9889,3,[Alling]Shimaso,3344,58,7,1,8,87.5%,6m
9889,3,IIIIIIIIIIII,3344,58,3,1,4,75.0%,7m
9889,3,pepelyuga,3344,30,2,1,3,66.7%,4m
9889,3,HerraJeebos,3344,30,1,1,2,50.0%,5m
9889,3,SwiftDaddy,3344,30,1,1,2,50.0%,10m
9889,3,InnerVisioN,3344,30,1,2,3,33.3%,3m
9889,3,Smartkill,3344,30,1,4,5,20.0%,17m
9889,3,[Sausje]boemkool,3344,0,0,1,1,0.0%,6m
9889,3,krakanhakan,3344,0,0,2,2,0.0%,9m
9904,2,Kamui,3343,827,178,175,353,50.4%,20m
9904,3,[Xenoo]RapToR,3343,1501,139,118,257,54.1%,3m
9904,3,ElVisp,3343,1482,84,72,156,53.8%,1m
9904,3,LeX,3343,908,34,34,68,50.0%,21m
9904,3,[iPz]Hermes,3343,393,18,7,25,72.0%,12m
9904,3,Creepingu,3343,374,17,12,29,58.6%,21m
9904,3,NukeNoodles,3343,254,9,4,13,69.2%,4m
9904,3,[neuroW]SkeletonJack,3343,0,1,0,1,100.0%,16m
9904,1,yNeris,3343,97,1,1,2,50.0%,17m
9904,3,[1FU2]deathquasar,3343,30,1,4,5,20.0%,20m
9904,3,Zettern,3343,0,0,1,1,0.0%,4m
9904,2,KiteYou,3343,0,0,2,2,0.0%,18m
9904,3,MrsAhrim,3343,0,0,2,2,0.0%,8m
9917,3,SherPa,3342,1541,236,237,473,49.9%,9m
9917,3,[KeK]ArchEvil,3342,602,48,47,95,50.5%,5m
9917,3,GooDron,3342,332,17,20,37,45.9%,11m
9917,2,[MFclub]MiTrO,3342,530,17,30,47,36.2%,12m
9917,3,[ZЕRGML]BALAMUT,3342,226,9,4,13,69.2%,7m
9917,3,[Benz]Kove,3342,143,7,3,10,70.0%,17m
9917,3,llllllllllll,3342,116,5,2,7,71.4%,4m
9917,2,ghomekk,3342,88,5,8,13,38.5%,4m
9917,3,Qbba,3342,0,1,0,1,100.0%,5m
9917,3,Flow,3342,30,1,2,3,33.3%,9m
9917,3,[Sahut]néo,3342,0,1,2,3,33.3%,20m
9917,3,Quazimodem,3342,30,1,4,5,20.0%,7m
9917,3,xpleed,3342,0,0,1,1,0.0%,5m
9930,3,[DzL]urGrandpa,3341,1212,63,66,129,48.8%,9m
9930,3,Red,3341,1120,43,41,84,51.2%,15m
9930,3,FrankVonRip,3341,433,18,9,27,66.7%,11m
9930,3,[Hmmmmm]Hmmnaatz,3341,166,9,3,12,75.0%,16m
9930,3,[DCAB]KustOm,3341,242,9,17,26,34.6%,17m
9930,3,[K0mpis]HawkingS,3341,187,6,1,7,85.7%,7m
9930,1,Gyeongdan,3341,96,5,1,6,83.3%,2m
9930,3,Cadmium,3341,86,4,0,4,100.0%,11m
9930,3,ofp,3341,86,4,4,8,50.0%,18m
9930,3,[Djahoe]enrgizer,3341,60,3,2,5,60.0%,17m
9930,3,JlEBIIIA,3341,30,2,0,2,100.0%,20m
9930,3,[Scam]Mattfurion,3341,58,2,6,8,25.0%,8m
9930,3,[Fen]Mewtwo,3341,0,1,0,1,100.0%,13m
9930,3,MainThing,3341,30,1,1,2,50.0%,17m
9930,3,Antoine,3341,30,1,1,2,50.0%,19m
9930,3,Serenity,3341,0,1,2,3,33.3%,14m
9930,3,KalashDead,3341,0,0,1,1,0.0%,6m
9930,3,[OgreZ]Empress,3341,0,0,1,1,0.0%,16m
9948,3,energice,3340,1371,141,134,275,51.3%,18m
9948,3,[M12]Jackob,3340,1465,74,79,153,48.4%,4m
9948,3,[Wrex]seriosblack,3340,1456,62,58,120,51.7%,3m
9948,3,xBanana,3340,1139,58,50,108,53.7%,4m
9948,3,Cruel,3340,564,18,29,47,38.3%,12m
9948,3,MrPink,3340,408,16,16,32,50.0%,13m
9948,3,[ToFi]Aventador,3340,242,12,4,16,75.0%,15m
9948,3,[TheDOH]wolfsha,3340,354,12,15,27,44.4%,8m
9948,3,[TSNM]Thyraya,3340,254,9,11,20,45.0%,6m
9948,2,Taş,3340,95,5,1,6,83.3%,53m
9948,3,Ougao,3340,95,5,10,15,33.3%,18m
9948,3,FrimeeN,3340,58,2,2,4,50.0%,3m
9948,3,[Miiik]Roscopique,3340,0,1,0,1,100.0%,3m
9948,1,saber,3340,0,1,0,1,100.0%,36m
9948,3,[EXDU]Neami,3340,0,1,2,3,33.3%,15m
9948,3,Salih,3340,0,0,1,1,0.0%,20m
9948,3,[TOWEA]TobyfleX,3340,0,0,1,1,0.0%,12m
9948,2,phoenix,3340,0,0,1,1,0.0%,4m
9948,3,Tehelka,3340,0,0,1,1,0.0%,3m
9948,1,PlsNoRush,3340,0,0,1,1,0.0%,21m
9948,3,Ayaya,3340,0,0,2,2,0.0%,17m
9969,3,[BRSKR]Sedator,3339,1559,151,135,286,52.8%,6m
9969,3,xCooom,3339,1601,147,120,267,55.1%,18m
9969,3,Krestor,3339,514,105,94,199,52.8%,14m
9969,3,kOrYsTaurius,3339,739,28,21,49,57.1%,11m
9969,3,[LoLa]ClaTTer,3339,706,28,27,55,50.9%,6m
9969,3,[MaNc0s]Koldit,3339,565,25,29,54,46.3%,8m
9969,3,Caudate,3339,542,20,21,41,48.8%,7m
9969,3,FILIBUSTER,3339,420,18,13,31,58.1%,21m
9969,3,[EXPANT]Livradianth,3339,368,13,14,27,48.1%,10m
9969,3,[nesim]Dude,3339,344,12,4,16,75.0%,6m
9969,3,[TheDOH]DarKShadoW,3339,299,12,4,16,75.0%,15m
9969,3,Besoffen,3339,266,11,6,17,64.7%,3m
9969,3,TERrOR,3339,248,10,7,17,58.8%,18m
9969,3,[Slaƴer]Extreme,3339,145,7,3,10,70.0%,4m
9969,3,Enigma,3339,179,7,7,14,50.0%,4m
9969,3,Krabgus,3339,88,6,4,10,60.0%,18m
9969,3,Volk,3339,0,5,0,5,100.0%,4m
9969,3,Bayushi,3339,146,5,7,12,41.7%,10m
9969,3,[SeNF]Tideldirn,3339,86,4,3,7,57.1%,20m
9969,3,[Olk]Tomek,3339,124,4,10,14,28.6%,14m
9969,3,[WBO]Wiggggles,3339,60,3,3,6,50.0%,9m
9969,2,MolagBal,3339,0,1,0,1,100.0%,9m
9969,3,Outsider,3339,30,1,4,5,20.0%,8m
9969,3,[123abc]stowgood,3339,0,0,1,1,0.0%,4m
9969,3,xian,3339,0,0,1,1,0.0%,15m
9969,3,[VamBan]Pinister,3339,0,0,1,1,0.0%,20m
9969,3,GrimPanda,3339,0,0,3,3,0.0%,15m
9969,3,Nicole,3339,0,0,7,7,0.0%,15m
9997,3,Ekaterina,3338,1464,168,133,301,55.8%,4m
9997,3,Диверсант,3338,1578,105,89,194,54.1%,13m
9997,3,[7wonde]impact,3338,787,94,60,154,61.0%,3m
9997,3,[lLiTl]SHIN,3338,290,66,58,124,53.2%,6m
9997,3,[696]Jagatha,3338,964,63,71,134,47.0%,13m
9997,3,[IYOLOI]Malozabdo,3338,963,48,27,75,64.0%,19m
9997,3,Dmik,3338,592,24,16,40,60.0%,11m
9997,3,Hayko,3338,501,22,16,38,57.9%,15m
9997,3,[Arrows]derZilo,3338,458,16,18,34,47.1%,2m
9997,3,Daylight,3338,372,15,10,25,60.0%,21m
9997,3,[GCorps]HeilDechus,3338,282,10,2,12,83.3%,3m
9997,3,[ADVIA]DizzyDwarf,3338,200,8,12,20,40.0%,6m
9997,2,SoVeReiGN,3338,96,5,1,6,83.3%,10m
9997,3,Bertican,3338,163,5,2,7,71.4%,4m
9997,3,Beowulf,3338,114,5,4,9,55.6%,11m
9997,3,[IG20]Sentiar,3338,86,3,1,4,75.0%,4m
9997,3,Concord,3338,30,1,2,3,33.3%,4m
10014,3,SABCIO,3337,1585,78,76,154,50.6%,7m
10014,3,PWFD,3337,1583,77,81,158,48.7%,6m
10014,3,mabel,3337,1109,62,59,121,51.2%,8m
10014,3,[W33]Apollo,3337,756,30,26,56,53.6%,15m
10014,3,qzder,3337,297,26,21,47,55.3%,18m
10014,3,ZIZOO,3337,512,23,23,46,50.0%,19m
10014,2,OneBasePony,3337,251,15,5,20,75.0%,18m
10014,3,[OPsm]Lokomotive,3337,277,14,10,24,58.3%,3m
10014,3,Barsminator,3337,247,10,5,15,66.7%,19m
10014,3,Fenicx,3337,252,9,9,18,50.0%,12m
10014,3,pottytrained,3337,142,8,3,11,72.7%,17m
10014,1,[ERAZ]DunkieDoot,3337,96,5,1,6,83.3%,11m
10014,3,[BaPy]Stips,3337,30,2,7,9,22.2%,12m
10014,3,LozzaA,3337,60,2,8,10,20.0%,4m
10014,3,[RеG]Babulenok,3337,0,1,0,1,100.0%,7m
10014,3,[ICGl]IceColdBear,3337,30,1,1,2,50.0%,21m
10014,3,[TuttiG]Yuurina,3337,0,0,1,1,0.0%,5m
10031,3,sebyca,3336,1388,99,97,196,50.5%,6m
10031,3,Joyex,3336,364,28,26,54,51.9%,12m
10031,3,asic,3336,226,9,6,15,60.0%,21m
10031,3,Tyrant,3336,170,6,6,12,50.0%,19m
10031,3,Dixienormous,3336,146,5,9,14,35.7%,14m
10031,3,Мусоровоз,3336,90,4,8,12,33.3%,13m
10031,3,[LLG]Kreos,3336,145,3,5,8,37.5%,9m
10031,3,VladOK,3336,86,3,11,14,21.4%,9m
10031,3,jere,3336,0,1,2,3,33.3%,5m
10031,2,CutSyOzZy,3336,42,1,10,11,9.1%,3m
10031,3,[PTZS]Xeon,3336,0,0,3,3,0.0%,14m
10042,3,[Heroes]Roshey,3335,1589,240,234,474,50.6%,21m
10042,3,Borat,3335,914,83,62,145,57.2%,9m
10042,3,Hydropic,3335,1648,81,64,145,55.9%,7m
10042,3,Cioppi,3335,1573,58,61,119,48.7%,14m
10042,3,millivoje,3335,522,21,10,31,67.7%,18m
10042,3,Asparagus,3335,355,19,6,25,76.0%,2m
10042,3,Tevon,3335,492,19,10,29,65.5%,7m
10042,3,Tewakahe,3335,88,3,3,6,50.0%,19m
10042,3,dragonknight,3335,30,2,1,3,66.7%,1m
10042,3,blomstermax,3335,0,1,0,1,100.0%,7m
10042,3,TVirus,3335,30,1,3,4,25.0%,4m
10042,3,Mucke,3335,0,0,1,1,0.0%,1m
10054,2,bbqsauce,3334,0,111,111,222,50.0%,12m
10054,3,aral,3334,1444,81,72,153,52.9%,8m
10054,3,Longus,3334,1472,73,65,138,52.9%,4m
10054,3,[IBeAŚI]Herold,3334,875,56,34,90,62.2%,19m
10054,3,Etupelas,3334,777,46,9,55,83.6%,4m
10054,3,Costel,3334,981,40,30,70,57.1%,15m
10054,3,Pain,3334,893,37,24,61,60.7%,14m
10054,3,CarryPotter,3334,372,13,18,31,41.9%,2m
10054,2,ThatNice,3334,324,12,19,31,38.7%,4m
10054,3,[Husky]Shasta,3334,0,5,3,8,62.5%,11m
10054,3,[SBk]Martinus,3334,86,4,2,6,66.7%,11m
10054,3,NettoCity,3334,118,4,6,10,40.0%,3m
10054,3,[Hrr]uNdefined,3334,58,2,2,4,50.0%,14m
10054,3,[SKSS]ringo,3334,0,2,3,5,40.0%,19m
10054,3,[SFF]BreakYaNeck,3334,0,0,1,1,0.0%,17m
10054,3,Oleger,3334,0,0,1,1,0.0%,14m
10054,1,[RoAST]TeddyBagwell,3334,0,0,1,1,0.0%,7m
10054,3,[DMPP]Sawrgon,3334,0,0,1,1,0.0%,12m
10054,3,ceZyn,3334,0,0,1,1,0.0%,3m
10054,3,Razorитель,3334,0,0,1,1,0.0%,12m
10074,3,ChakaBoom,3333,1619,361,358,719,50.2%,11m
10074,3,VincentTMT,3333,1013,111,97,208,53.4%,2m
10074,3,Petrichor,3333,954,60,19,79,75.9%,18m
10074,3,VeryGooD,3333,905,35,28,63,55.6%,4m
10074,3,eQThib,3333,671,31,25,56,55.4%,11m
10074,3,[Hrr]less,3333,582,25,17,42,59.5%,15m
10074,3,[UJ]Jimba,3333,426,19,11,30,63.3%,16m
10074,3,[Heroes]BabyZergling,3333,165,15,17,32,46.9%,5m
10074,3,JimboJimbob,3333,394,14,18,32,43.8%,17m
10074,3,BimHitNooB,3333,120,9,9,18,50.0%,9m
10074,3,[3Д]SpeCial,3333,222,6,7,13,46.2%,19m
10074,3,[Swarm6]madness,3333,225,6,8,14,42.9%,2m
10074,2,Meiso,3333,96,5,1,6,83.3%,1h
10074,3,Amove,3333,120,4,7,11,36.4%,6m
10074,3,HorrorRabbit,3333,58,3,5,8,37.5%,3m
10074,1,Gvenivar,3333,97,2,1,3,66.7%,1h
10074,3,[MRCW]himsir,3333,30,2,2,4,50.0%,17m
10074,3,[NeStar]ОЯШ,3333,0,1,1,2,50.0%,19m
10074,3,Bluecloud,3333,0,1,2,3,33.3%,4m
10074,3,Apoxmelator,3333,0,1,8,9,11.1%,7m
10074,3,Ridan,3333,0,0,1,1,0.0%,11m
10074,1,[KDV]ZIMOL,3333,0,0,2,2,0.0%,11m
10074,3,[TOCC]Ustritsa,3333,0,0,2,2,0.0%,17m
10074,3,[EV]IronWarrior,3333,0,0,3,3,0.0%,5m
10098,3,[SB4L]Deleuze,3332,276,12,10,22,54.5%,9m
10098,3,Puff,3332,321,10,13,23,43.5%,3m
10098,3,MǂGringo,3332,202,8,8,16,50.0%,3m
10098,3,maxQ,3332,166,6,1,7,85.7%,2m
10098,3,Валантис,3332,86,4,3,7,57.1%,4m
10098,3,BadTomato,3332,0,1,0,1,100.0%,6m
10098,3,[SK81]Kmjsd,3332,30,1,1,2,50.0%,10m
10098,3,OstrichO,3332,30,1,2,3,33.3%,3m
10098,3,greenn,3332,0,0,1,1,0.0%,7m
10098,3,superChad,3332,0,0,3,3,0.0%,18m
10098,3,DocThor,3332,0,0,7,7,0.0%,3m
10109,3,[NMSQ]kakemonosc,3331,1591,256,258,514,49.8%,4m
10109,2,IIIIIIIIIIII,3331,1552,178,181,359,49.6%,4m
10109,3,Gert,3331,1208,176,184,360,48.9%,3m
10109,3,Felix,3331,1567,107,99,206,51.9%,6m
10109,3,Century,3331,1595,97,97,194,50.0%,19m
10109,3,OldGeeza,3331,1551,74,44,118,62.7%,3m
10109,3,Ghankd,3331,767,55,47,102,53.9%,2m
10109,3,[mYі]dHoogy,3331,453,47,48,95,49.5%,2m
10109,3,Koty,3331,620,36,24,60,60.0%,14m
10109,3,sadji,3331,596,30,21,51,58.8%,8m
10109,3,Shatzy,3331,531,24,17,41,58.5%,20m
10109,3,Skozzi,3331,346,15,10,25,60.0%,18m
10109,3,[Mavis]MoonLy,3331,346,12,16,28,42.9%,10m
10109,3,[SPHTRS]Monty,3331,264,9,10,19,47.4%,17m
10109,3,Vibe,3331,174,4,6,10,40.0%,1m
10109,3,[EESC]ııVersmooRıı,3331,30,2,1,3,66.7%,4m
10109,3,MadHatter,3331,30,2,1,3,66.7%,14m
10109,3,[Щитон]Давид,3331,0,1,5,6,16.7%,8m
10109,3,JosephStalin,3331,0,0,1,1,0.0%,17m
10109,3,TUBERSUSLIK,3331,0,0,1,1,0.0%,15m
10109,3,[MoBrÄu]yoolio,3331,0,0,2,2,0.0%,1m
10130,3,Laurens,3330,1473,190,189,379,50.1%,21m
10130,3,Montimus,3330,1542,152,154,306,49.7%,18m
10130,3,shmrckelzz,3330,1073,108,105,213,50.7%,18m
10130,3,Lipiluk,3330,996,39,33,72,54.2%,11m
10130,3,Boli,3330,566,24,21,45,53.3%,19m
10130,3,ROOR,3330,475,21,14,35,60.0%,19m
10130,3,twitchBilich,3330,356,13,13,26,50.0%,15m
10130,2,Jamalam,3330,184,12,5,17,70.6%,3m
10130,3,нуАвдрух,3330,169,9,3,12,75.0%,12m
10130,3,[R4Time]Cola,3330,116,4,2,6,66.7%,11m
10130,3,Aguerooo,3330,0,0,1,1,0.0%,17m
10130,3,[Zguege]Tec,3330,0,0,1,1,0.0%,3m
10130,3,PaNiC,3330,0,0,7,7,0.0%,3m
10143,2,twardy,3329,1482,133,130,263,50.6%,13m
10143,3,Ruslan,3329,366,31,19,50,62.0%,19m
10143,3,Reinecke,3329,697,28,25,53,52.8%,21m
10143,1,echo,3329,331,14,8,22,63.6%,3m
10143,1,[UKRA1N]Flamy,3329,302,13,7,20,65.0%,19m
10143,3,[OvRMnD]RyaN,3329,294,11,9,20,55.0%,21m
10143,3,AlexLock,3329,169,7,4,11,63.6%,14m
10143,3,Terprozer,3329,148,6,8,14,42.9%,7m
10143,3,Imbamannen,3329,158,5,14,19,26.3%,5m
10143,3,Uru,3329,118,4,3,7,57.1%,14m
10143,3,Corez,3329,120,4,9,13,30.8%,4m
10143,3,[Hakeem]Olajuwon,3329,60,2,5,7,28.6%,17m
10143,3,GrinkaV,3329,0,1,1,2,50.0%,8m
10143,3,[JGT]NoN,3329,0,1,5,6,16.7%,6m
10143,3,[AnimeS]Dabaeb,3329,0,0,1,1,0.0%,7m
10158,3,MARV,3328,1245,164,155,319,51.4%,20m
10158,3,MaMinou,3328,1575,131,126,257,51.0%,14m
10158,3,NeBomjik,3328,475,20,14,34,58.8%,17m
10158,2,ZergLingPark,3328,552,18,28,46,39.1%,3m
10158,3,kontur,3328,432,16,15,31,51.6%,6m
10158,2,Albania,3328,188,10,7,17,58.8%,4m
10158,3,Totenkopf,3328,276,9,13,22,40.9%,14m
10158,3,dDrunkenLord,3328,201,7,7,14,50.0%,14m
10158,3,[RaYak]JimmysMind,3328,86,6,3,9,66.7%,8m
10158,3,Andrewmufasa,3328,0,5,0,5,100.0%,5m
10158,3,McWigg,3328,140,5,5,10,50.0%,6m
10158,3,[aDGa]Aspiring,3328,154,5,8,13,38.5%,4m
10158,3,DarKat,3328,58,2,4,6,33.3%,3m
10158,3,NaLmeS,3328,0,1,0,1,100.0%,14m
10158,3,drone,3328,0,1,0,1,100.0%,3m
10158,1,Vencetudo,3328,93,1,1,2,50.0%,14m
10158,3,[ITGC]Slaze,3328,0,0,1,1,0.0%,3m
10158,3,NadineMorano,3328,0,0,2,2,0.0%,7m
10158,3,LuckyTiger,3328,0,0,2,2,0.0%,9m
10158,3,Bobby,3328,0,0,3,3,0.0%,12m
10178,3,Barbarian,3327,1320,167,107,274,60.9%,9m
10178,3,gurke,3327,1001,137,122,259,52.9%,11m
10178,3,Depiriator,3327,1331,65,54,119,54.6%,3m
10178,3,TobbeBeGood,3327,766,30,26,56,53.6%,7m
10178,3,Asparagus,3327,683,30,26,56,53.6%,4m
10178,3,Trece,3327,266,10,8,18,55.6%,15m
10178,3,[ƔƟƪƟ]illmatic,3327,202,8,5,13,61.5%,17m
10178,3,Cybernight,3327,276,8,16,24,33.3%,5m
10178,3,fryingpan,3327,140,5,1,6,83.3%,11m
10178,3,CestHonteux,3327,0,3,2,5,60.0%,6m
10178,3,LuckingGood,3327,0,1,0,1,100.0%,2m
10178,3,IIIIIIIIIII,3327,30,1,1,2,50.0%,3m
10178,3,Slippy,3327,30,1,2,3,33.3%,10m
10178,3,Firler,3327,30,1,6,7,14.3%,10m
10178,3,[BMDR]DrSultan,3327,0,0,1,1,0.0%,13m
10178,3,Jhd,3327,0,0,1,1,0.0%,8m
10178,3,kratzigel,3327,0,0,7,7,0.0%,7m
10195,3,[ExTr1m]DEHAKA,3326,1540,93,80,173,53.8%,13m
10195,3,RedApril,3326,260,25,36,61,41.0%,18m
10195,3,Linlil,3326,626,24,20,44,54.5%,15m
10195,1,[ƔĘƝ]Valerian,3326,258,7,10,17,41.2%,8m
10195,3,LastEngineer,3326,150,6,13,19,31.6%,5m
10195,1,limear,3326,118,5,2,7,71.4%,56m
10195,2,Legobyggarn,3326,159,5,2,7,71.4%,3m
10195,1,FireFly,3326,48,3,5,8,37.5%,27m
10195,3,treks,3326,30,2,2,4,50.0%,4m
10195,3,[D0N3]cicciobar,3326,60,2,3,5,40.0%,19m
10195,1,[NLS4]Tinel,3326,0,1,0,1,100.0%,18m
10195,3,[m3mez]Katz,3326,0,1,0,1,100.0%,5m
10195,3,ChriSo,3326,0,1,1,2,50.0%,3m
10195,3,Dubblestep,3326,30,1,3,4,25.0%,6m
10195,3,Muhx,3326,0,0,1,1,0.0%,11m
10195,3,[QaDo]GeloPerk,3326,0,0,1,1,0.0%,6m
10211,3,SickTrstanic,3325,714,132,126,258,51.2%,10m
10211,3,Crt,3325,706,49,49,98,50.0%,21m
10211,2,Alff,3325,791,30,43,73,41.1%,7m
10211,3,DexteR,3325,666,24,25,49,49.0%,16m
10211,3,Masonator,3325,296,18,13,31,58.1%,6m
10211,3,OneLOL,3325,216,8,5,13,61.5%,19m
10211,3,[ANUUS]Yahmacka,3325,170,7,3,10,70.0%,13m
10211,2,Brunya,3325,189,5,6,11,45.5%,1m
10211,3,dyzximulai,3325,0,4,1,5,80.0%,13m
10211,3,sternit,3325,0,1,0,1,100.0%,6m
10211,3,Ninetyfour,3325,0,1,0,1,100.0%,19m
10211,3,YellowWorm,3325,0,1,1,2,50.0%,20m
10211,3,Quidex,3325,0,0,1,1,0.0%,19m
10211,3,Michelle,3325,0,0,1,1,0.0%,15m
10225,2,TrusyEnota,3324,1576,232,237,469,49.5%,7m
10225,3,Mattias,3324,1545,73,70,143,51.0%,10m
10225,3,Pombe,3324,532,72,73,145,49.7%,2m
10225,3,[Kicx]ZWLO,3324,493,42,42,84,50.0%,12m
10225,3,Jolte,3324,818,33,37,70,47.1%,10m
10225,3,[SC2L]Павел,3324,530,20,18,38,52.6%,21m
10225,3,MrHöcker,3324,368,17,21,38,44.7%,10m
10225,3,rrröööaaarrr,3324,410,13,25,38,34.2%,7m
10225,3,TheMercenarY,3324,112,6,5,11,54.5%,4m
10225,3,[FrRacl]Anuviel,3324,90,4,7,11,36.4%,21m
10225,3,[DéKá]Chose,3324,0,3,2,5,60.0%,6m
10225,2,IIIIIIIIII,3324,0,3,2,5,60.0%,49m
10225,3,TheHomeR,3324,30,2,1,3,66.7%,14m
10225,3,MrASDF,3324,30,2,2,4,50.0%,14m
10225,3,GAZOVIK,3324,58,2,4,6,33.3%,14m
10225,3,tuxin,3324,30,1,1,2,50.0%,2m
10225,3,[CovPar]LexPress,3324,0,1,2,3,33.3%,3m
10225,3,VodkaRoxx,3324,30,1,3,4,25.0%,3m
10225,3,Freder,3324,0,0,3,3,0.0%,14m
10225,1,[EAU]KICKI,3324,0,0,4,4,0.0%,6m
10245,3,[l2poca]ltwopoca,3323,1546,158,130,288,54.9%,11m
10245,3,RoG,3323,1501,102,103,205,49.8%,17m
10245,2,Zergart,3323,1484,98,92,190,51.6%,11m
10245,3,AlenkaStar,3323,396,17,12,29,58.6%,6m
10245,3,Nukemaster,3323,164,8,2,10,80.0%,14m
10245,3,[Hrr]КапитанAlex,3323,176,7,10,17,41.2%,10m
10245,3,[LgnEU]Barcode,3323,30,5,1,6,83.3%,11m
10245,3,shurup,3323,0,1,0,1,100.0%,4m
10245,3,Bebetta,3323,0,1,0,1,100.0%,11m
10245,3,GianLuca,3323,0,1,1,2,50.0%,13m
10245,3,kidEth,3323,30,1,1,2,50.0%,8m
10245,3,[btroll]Trololo,3323,30,1,1,2,50.0%,6m
10245,3,[MANGAL]DrStein,3323,30,1,1,2,50.0%,13m
10245,3,melodynelson,3323,0,1,1,2,50.0%,18m
10245,3,tENsy,3323,0,0,1,1,0.0%,14m
10245,3,[DoDos]ZAUROU,3323,0,0,1,1,0.0%,15m
10245,3,[Няшкa]Apollo,3323,0,0,1,1,0.0%,6m
10262,3,Daimos,3322,282,12,7,19,63.2%,15m
10262,3,[EESC]Alejandro,3322,264,8,4,12,66.7%,5m
10262,3,[MosWar]ZenoS,3322,178,6,14,20,30.0%,4m
10262,3,Volkodav,3322,114,5,2,7,71.4%,6m
10262,3,Empire,3322,114,5,4,9,55.6%,4m
10262,3,Cartman,3322,30,2,0,2,100.0%,14m
10262,3,Amigo,3322,30,2,1,3,66.7%,2m
10262,1,Mario,3322,48,2,2,4,50.0%,24m
10262,3,[CH33SE]thanandar,3322,0,1,0,1,100.0%,2m
10262,3,chirik,3322,30,1,2,3,33.3%,15m
10262,3,[DZ16]kakoki,3322,30,1,4,5,20.0%,3m
10262,3,[xNooBs]Adamoszczy,3322,30,1,4,5,20.0%,20m
10262,3,[pBNRq]MasterSuprem,3322,0,1,9,10,10.0%,11m
10262,3,ShOOm,3322,0,0,1,1,0.0%,21m
10262,3,[MSUSC2]Guardian,3322,0,0,1,1,0.0%,21m
10262,3,IvanRos,3322,0,0,1,1,0.0%,3m
10262,3,[hBǂ]Orion,3322,0,0,2,2,0.0%,3m
10279,3,Jungle,3321,1514,245,253,498,49.2%,10m
10279,3,Neuron,3321,1567,201,205,406,49.5%,4m
10279,2,ionas,3321,777,125,132,257,48.6%,21m
10279,3,hAbaJ,3321,1364,57,53,110,51.8%,4m
10279,3,[BRSKR]CaptainKirk,3321,750,35,22,57,61.4%,19m
10279,3,Mistake,3321,675,27,21,48,56.2%,8m
10279,3,[Frоm]Silver,3321,358,14,16,30,46.7%,4m
10279,3,GorillaDog,3321,180,13,7,20,65.0%,4m
10279,3,[D4VOH]william,3321,358,13,12,25,52.0%,3m
10279,3,Admik,3321,218,9,2,11,81.8%,3m
10279,3,[FxL]Waé,3321,195,9,4,13,69.2%,4m
10279,3,hardware,3321,168,6,8,14,42.9%,3m
10279,3,Mushroom,3321,30,5,1,6,83.3%,14m
10279,3,lIlIIlIlIllI,3321,30,5,1,6,83.3%,5m
10279,3,Parse,3321,124,5,9,14,35.7%,14m
10279,3,Inertia,3321,30,2,5,7,28.6%,19m
10279,2,[Mkpz]LaMaSu,3321,140,2,7,9,22.2%,9m
10279,3,[75рус]Patriot,3321,0,0,1,1,0.0%,14m
10279,3,Jimify,3321,0,0,1,1,0.0%,20m
10279,3,[TIse]NaNaR,3321,0,0,2,2,0.0%,19m
10279,3,Faust,3321,0,0,2,2,0.0%,11m
10279,3,[QMnewb]FiveSZ,3321,0,0,3,3,0.0%,14m
10279,3,gglauge,3321,0,0,5,5,0.0%,14m
10302,3,willy,3320,1593,741,737,1478,50.1%,10m
10302,3,ilsid,3320,1523,94,85,179,52.5%,2m
10302,3,TalNar,3320,1503,63,71,134,47.0%,14m
10302,3,[xrym]Zehanbabay,3320,958,50,11,61,82.0%,9m
10302,2,Tobi,3320,921,50,68,118,42.4%,12m
10302,3,Tamme,3320,855,40,38,78,51.3%,10m
10302,3,Flammen,3320,744,26,28,54,48.1%,11m
10302,3,[Bskt]Eugeniusz,3320,476,17,23,40,42.5%,6m
10302,3,Ticklebeamer,3320,365,16,11,27,59.3%,14m
10302,3,ChangeCaps,3320,290,10,4,14,71.4%,16m
10302,3,TheorY,3320,159,5,6,11,45.5%,18m
10302,3,näm,3320,0,2,8,10,20.0%,16m
10302,3,[jEbAC]żabek,3320,0,1,1,2,50.0%,20m
10302,3,[Ar4ont]llllllllllll,3320,0,1,2,3,33.3%,11m
10302,3,OhPoo,3320,0,0,1,1,0.0%,10m
10302,3,Iron,3320,0,0,1,1,0.0%,3m
10302,3,XIPNOSIS,3320,0,0,2,2,0.0%,2m
10302,3,[R4Time]BRN,3320,0,0,2,2,0.0%,19m
10320,3,JDummy,3319,1239,95,100,195,48.7%,5m
10320,3,[C02133]phil,3319,946,41,39,80,51.2%,16m
10320,3,Tarrasque,3319,1046,39,47,86,45.3%,16m
10320,3,[ETSy]Turozumo,3319,379,25,25,50,50.0%,19m
10320,3,Krissz,3319,591,20,27,47,42.6%,12m
10320,3,MarineChien,3319,268,19,22,41,46.3%,6m
10320,3,[ЛЯГУХА]prishtina,3319,200,15,7,22,68.2%,3m
10320,2,[Hrr]Kado,3319,418,13,29,42,31.0%,3m
10320,3,Metalisk,3319,346,12,8,20,60.0%,2m
10320,3,Strat,3319,344,11,13,24,45.8%,9m
10320,3,satiety,3319,212,9,6,15,60.0%,18m
10320,1,Matsuh,3319,166,8,3,11,72.7%,5m
10320,2,RISING,3319,96,6,0,6,100.0%,60m
10320,3,MasterKWM,3319,172,6,8,14,42.9%,10m
10320,3,[BBOY]Kvarc,3319,146,5,9,14,35.7%,10m
10320,2,NaRa,3319,124,5,13,18,27.8%,3m
10320,3,Goo,3319,120,4,8,12,33.3%,17m
10320,3,mofoo,3319,30,2,1,3,66.7%,5m
10320,3,[TWIY]Tonydpala,3319,0,1,2,3,33.3%,19m
10320,2,Kryki,3319,0,1,8,9,11.1%,7m
10320,3,Razmetka,3319,0,0,2,2,0.0%,19m
10341,1,[Lambro]DinoZerg,3318,913,116,111,227,51.1%,10m
10341,3,magicarpe,3318,375,20,8,28,71.4%,4m
10341,3,SergNL,3318,384,15,4,19,78.9%,6m
10341,3,Menzyn,3318,134,15,11,26,57.7%,14m
10341,3,BlueR,3318,352,15,17,32,46.9%,18m
10341,3,[ƬC]Marys,3318,336,12,5,17,70.6%,5m
10341,2,Valentine,3318,160,8,6,14,57.1%,9m
10341,3,ScSpaghetti,3318,188,6,1,7,85.7%,12m
10341,2,[Fridge]Salvato,3318,128,3,10,13,23.1%,7m
10341,3,Louisss,3318,30,2,1,3,66.7%,11m
10341,3,EquinoX,3318,0,1,2,3,33.3%,18m
10341,3,Xcellence,3318,0,0,1,1,0.0%,2m
10341,3,crymoreplz,3318,0,0,1,1,0.0%,7m
10341,3,Deus,3318,0,0,1,1,0.0%,19m
10341,3,[ITA10]JGsnubben,3318,0,0,1,1,0.0%,15m
10341,3,[RBP3]DARKORBIT,3318,0,0,1,1,0.0%,7m
10341,3,[Dors]KillerDeath,3318,0,0,2,2,0.0%,20m
10341,3,Regevmiri,3318,0,0,3,3,0.0%,19m
10359,3,[GwT]DannyDemon,3317,1608,172,151,323,53.3%,11m
10359,3,MrDracula,3317,1563,138,135,273,50.5%,10m
10359,3,Barnski,3317,1523,106,87,193,54.9%,15m
10359,3,huage,3317,423,60,51,111,54.1%,16m
10359,3,Vamis,3317,1190,57,48,105,54.3%,12m
10359,3,Stiiiif,3317,693,29,20,49,59.2%,14m
10359,3,Серёжа,3317,279,23,16,39,59.0%,11m
10359,3,Issac,3317,322,15,8,23,65.2%,3m
10359,3,Django,3317,338,15,10,25,60.0%,4m
10359,3,Chyn,3317,236,14,13,27,51.9%,14m
10359,2,[FOSAK]jeroen,3317,252,10,6,16,62.5%,20m
10359,3,[BUF]splixz,3317,258,9,4,13,69.2%,14m
10359,2,zeratul,3317,271,9,6,15,60.0%,4m
10359,1,ErnYo,3317,0,5,1,6,83.3%,50m
10359,3,[xp3]Ceaz,3317,114,5,7,12,41.7%,17m
10359,3,Infested,3317,66,3,2,5,60.0%,10m
10359,3,ISWI,3317,30,1,1,2,50.0%,6m
10359,3,DabOnExpand,3317,0,1,3,4,25.0%,10m
10359,3,Nadirus,3317,30,1,6,7,14.3%,13m
10359,3,KardNelum,3317,0,0,1,1,0.0%,13m
10359,3,[ТКД]Ульди,3317,0,0,1,1,0.0%,16m
10359,3,iamzeus,3317,0,0,1,1,0.0%,11m
10381,2,[BrothW]SPaiDyR,3316,1291,114,111,225,50.7%,8m
10381,3,[dæD]Keo,3316,1395,102,99,201,50.7%,16m
10381,3,[псина]Reaver,3316,916,88,72,160,55.0%,10m
10381,3,DangerZone,3316,659,60,55,115,52.2%,16m
10381,3,[UЯANUS]mrSvine,3316,1226,48,39,87,55.2%,10m
10381,3,KolDunchiK,3316,1032,35,45,80,43.8%,14m
10381,2,QuirkyToss,3316,322,14,4,18,77.8%,4m
10381,3,Chaffinch,3316,266,10,12,22,45.5%,4m
10381,3,IIIllIIllIIl,3316,116,5,9,14,35.7%,11m
10381,3,[Natar]Натар,3316,118,4,4,8,50.0%,14m
10381,2,[Xa]CenturioN,3316,162,3,8,11,27.3%,3m
10381,3,[пепега]suchAKrab,3316,0,1,0,1,100.0%,15m
10381,3,Mayem,3316,30,1,3,4,25.0%,15m
10381,3,[NwK]Stiffler,3316,30,1,6,7,14.3%,5m
10381,3,SpicyTofu,3316,0,0,1,1,0.0%,20m
10381,3,fikumiku,3316,0,0,1,1,0.0%,20m
10381,3,serious,3316,0,0,1,1,0.0%,3m
10398,3,Luke,3315,1605,241,229,470,51.3%,6m
10398,3,[OGMFR]NaGabob,3315,1590,218,218,436,50.0%,18m
10398,3,Lee,3315,1626,112,84,196,57.1%,3m
10398,2,Dlyg,3315,1230,74,74,148,50.0%,6m
10398,3,Itachi,3315,945,61,57,118,51.7%,9m
10398,3,[iGD2D]Kurinkuji,3315,793,54,49,103,52.4%,11m
10398,3,[LFDSS]PitX,3315,752,28,33,61,45.9%,6m
10398,3,marc,3315,740,27,27,54,50.0%,6m
10398,3,[34ry]Handlebar,3315,620,27,29,56,48.2%,2m
10398,3,Willileliram,3315,196,8,3,11,72.7%,2m
10398,3,[Dytred]BoB,3315,154,6,5,11,54.5%,10m
10398,3,titops,3315,0,4,1,5,80.0%,18m
10398,3,[K9Unit]Hanayama,3315,114,4,11,15,26.7%,9m
10398,3,HarutAyan,3315,58,3,2,5,60.0%,21m
10398,3,[PEEPE]MarcoD,3315,144,3,7,10,30.0%,12m
10398,3,Dobby,3315,58,2,2,4,50.0%,4m
10398,3,Steler,3315,60,2,5,7,28.6%,17m
10398,3,IIIIIIIIIIII,3315,0,1,2,3,33.3%,3m
10398,3,[WBGA]aki,3315,0,1,3,4,25.0%,14m
10398,3,[SR5]Mataleao,3315,0,0,1,1,0.0%,19m
10398,3,HellraiZR,3315,0,0,2,2,0.0%,7m
10419,3,Pontifex,3314,1410,129,119,248,52.0%,10m
10419,3,IIIIIIIIIIII,3314,390,102,82,184,55.4%,14m
10419,2,triggertoo,3314,1257,55,52,107,51.4%,5m
10419,2,[Obz]smad,3314,1058,36,54,90,40.0%,21m
10419,3,Blacknes,3314,425,19,9,28,67.9%,14m
10419,3,[CHCH]MstrOfDsastr,3314,364,14,13,27,51.9%,19m
10419,2,[ZePD]JOJO,3314,272,9,4,13,69.2%,7m
10419,3,[HvA]Smaug,3314,194,8,3,11,72.7%,10m
10419,3,roquefort,3314,191,8,4,12,66.7%,15m
10419,3,dpplqpR,3314,202,8,11,19,42.1%,2m
10419,2,ZED,3314,96,5,1,6,83.3%,49m
10419,3,[oooboy]TalJacob,3314,30,2,0,2,100.0%,3m
10419,3,niner,3314,0,1,0,1,100.0%,11m
10419,2,RushMeHarder,3314,0,1,1,2,50.0%,21m
10419,3,borsh,3314,0,1,2,3,33.3%,12m
10419,3,[EXPANT]Capac,3314,0,0,1,1,0.0%,8m
10435,3,mugg,3313,1564,133,129,262,50.8%,3m
10435,3,MadMan,3313,1597,97,73,170,57.1%,12m
10435,3,stimpi,3313,631,79,75,154,51.3%,3m
10435,2,[GKTRK]Hopeless,3313,1382,79,94,173,45.7%,3m
10435,3,Cube,3313,1000,71,70,141,50.4%,14m
10435,2,Nefritox,3313,443,65,73,138,47.1%,9m
10435,3,hydra,3313,1300,54,39,93,58.1%,18m
10435,3,magass,3313,745,42,29,71,59.2%,4m
10435,3,Spacefox,3313,895,33,54,87,37.9%,21m
10435,3,[FlS]Drakula,3313,638,24,22,46,52.2%,8m
10435,3,Tiof,3313,536,20,18,38,52.6%,15m
10435,3,Ultron,3313,327,14,11,25,56.0%,16m
10435,3,artofwar,3313,236,8,12,20,40.0%,10m
10435,2,Biscuit,3313,0,4,1,5,80.0%,45m
10435,3,[ESG9]LOADING,3313,0,4,1,5,80.0%,20m
10435,1,Fear,3313,116,2,2,4,50.0%,1m
10435,3,Jeff,3313,58,2,3,5,40.0%,3m
10435,3,XiJinping,3313,0,1,0,1,100.0%,6m
10435,3,nybkorak,3313,30,1,3,4,25.0%,19m
10435,3,ReCoN,3313,0,1,5,6,16.7%,11m
10435,3,[Re1ch]VenediCro,3313,0,0,1,1,0.0%,15m
10456,3,Aqisiaq,3312,1200,67,65,132,50.8%,6m
10456,2,chrisugru,3312,952,31,46,77,40.3%,10m
10456,3,[PiRE]DemonStepan,3312,405,16,6,22,72.7%,11m
10456,3,Perturabo,3312,240,8,9,17,47.1%,21m
10456,3,VeryNoob,3312,144,6,2,8,75.0%,8m
10456,3,ichi,3312,165,6,5,11,54.5%,8m
10456,2,nikihaku,3312,96,5,1,6,83.3%,53m
10456,3,TöräHörä,3312,88,3,9,12,25.0%,5m
10456,3,[ialm]adelante,3312,0,1,0,1,100.0%,3m
10456,3,MastrOfOrion,3312,0,1,0,1,100.0%,19m
10456,3,[TExGG]Granate,3312,30,1,3,4,25.0%,6m
10456,3,Kiriman,3312,0,0,1,1,0.0%,3m
10456,3,[LPaC]tornadoflash,3312,0,0,1,1,0.0%,7m
10456,2,[Ruhn]Crystal,3312,0,0,1,1,0.0%,60m
10470,2,Solifluction,3311,1269,54,61,115,47.0%,14m
10470,3,[DМG]USSR,3311,640,21,31,52,40.4%,4m
10470,3,Happy,3311,410,18,16,34,52.9%,4m
10470,3,CASHFORHASH,3311,438,17,14,31,54.8%,11m
10470,3,[TTSD]KevA,3311,190,10,7,17,58.8%,6m
10470,1,creep,3311,118,6,2,8,75.0%,18m
10470,3,Asabuloo,3311,166,5,4,9,55.6%,4m
10470,2,[IsImBO]liquidLoleK,3311,96,4,2,6,66.7%,10m
10470,3,[P0P0]robsn,3311,143,3,2,5,60.0%,15m
10470,3,xXdarksasuke,3311,134,3,2,5,60.0%,20m
10470,3,Farentir,3311,86,3,4,7,42.9%,9m
10470,3,[Fiska]Redvixen,3311,39,3,7,10,30.0%,4m
10470,3,TAS,3311,58,2,3,5,40.0%,16m
10470,3,ThomasTor,3311,0,1,0,1,100.0%,11m
10470,3,[JLK]xxviking,3311,30,1,1,2,50.0%,7m
10470,3,[CОS]abracadabra,3311,0,1,1,2,50.0%,3m
10470,3,JoNiko,3311,0,0,1,1,0.0%,12m
10470,3,SwaaarM,3311,0,0,2,2,0.0%,4m
10470,3,LatexhotOO,3311,0,0,3,3,0.0%,17m
10470,3,Bivoj,3311,0,0,5,5,0.0%,15m
10490,2,TGS,3310,1537,249,257,506,49.2%,4m
10490,3,onC,3310,1569,133,127,260,51.2%,21m
10490,3,[ImWRs]zergio,3310,1545,123,114,237,51.9%,19m
10490,3,Petrolette,3310,878,42,27,69,60.9%,4m
10490,3,Hamslam,3310,587,42,39,81,51.9%,14m
10490,3,[DonaId]Duck,3310,773,30,26,56,53.6%,3m
10490,3,MakkO,3310,738,26,29,55,47.3%,6m
10490,3,[SCSR]silvipzs,3310,612,23,24,47,48.9%,7m
10490,3,Pacific,3310,403,17,9,26,65.4%,18m
10490,3,HDjoffa,3310,292,11,12,23,47.8%,5m
10490,3,BoneSButcheR,3310,203,10,4,14,71.4%,6m
10490,3,lexad,3310,206,7,10,17,41.2%,16m
10490,3,[sNu5]Falconare,3310,226,6,9,15,40.0%,17m
10490,3,Troublemaker,3310,88,3,4,7,42.9%,12m
10490,3,[VVing]Name,3310,30,2,1,3,66.7%,9m
10490,3,feliba,3310,0,1,0,1,100.0%,3m
10490,3,Kronos,3310,0,1,0,1,100.0%,8m
10490,3,[КПCC]OurVictoury,3310,30,1,1,2,50.0%,14m
10490,3,BlackOnca,3310,0,0,2,2,0.0%,12m
10509,3,LTCUSDT,3309,1607,113,91,204,55.4%,5m
10509,3,NeverZ,3309,1322,69,45,114,60.5%,16m
10509,3,[IncS]Mandredaster,3309,1484,68,72,140,48.6%,20m
10509,3,dor,3309,1133,51,40,91,56.0%,5m
10509,2,Illife,3309,1200,41,55,96,42.7%,10m
10509,3,NetShadowXX,3309,862,38,32,70,54.3%,4m
10509,3,[Salsig]Brugen,3309,305,25,21,46,54.3%,16m
10509,3,GTT,3309,610,20,28,48,41.7%,7m
10509,3,Shev,3309,344,13,14,27,48.1%,5m
10509,2,[NoGy]TheMaster,3309,272,12,5,17,70.6%,20m
10509,2,[Navvy]Egon,3309,253,11,7,18,61.1%,15m
10509,1,Kali,3309,97,5,2,7,71.4%,52m
10509,3,[PETE]Eranoid,3309,171,5,4,9,55.6%,14m
10509,3,SideShow,3309,140,5,5,10,50.0%,7m
10509,3,Ledo,3309,60,2,5,7,28.6%,17m
10509,2,Win,3309,0,1,4,5,20.0%,45m
10509,3,What,3309,0,0,2,2,0.0%,4m
10526,2,Andrii,3308,1237,343,352,695,49.4%,9m
10526,3,TylooTaeja,3308,1501,312,292,604,51.7%,19m
10526,3,[FIow]Smeerlap,3308,1497,168,165,333,50.5%,18m
10526,3,BBK,3308,710,25,28,53,47.2%,14m
10526,3,[Batia]moloko,3308,450,17,13,30,56.7%,19m
10526,3,StarKing,3308,330,12,12,24,50.0%,11m
10526,3,[MeDuS]Maito,3308,190,10,8,18,55.6%,21m
10526,3,[OÐ]Flixse,3308,218,9,8,17,52.9%,15m
10526,3,ThaLord,3308,234,8,14,22,36.4%,2m
10526,3,Toker,3308,58,3,1,4,75.0%,17m
10526,3,PAXI,3308,60,3,2,5,60.0%,6m
10526,2,ImRaker,3308,0,3,2,5,60.0%,13m
10526,3,DarkKnight,3308,60,3,6,9,33.3%,3m
10526,3,None,3308,62,2,7,9,22.2%,12m
10526,3,[3GBY]GentleMan,3308,0,1,1,2,50.0%,17m
10526,1,Sora,3308,0,0,2,2,0.0%,52m
10542,3,botbot,3307,1597,516,509,1025,50.3%,6m
10542,3,fluidz,3307,1583,82,70,152,53.9%,19m
10542,3,enda,3307,1487,76,70,146,52.1%,7m
10542,3,glhf,3307,1542,74,67,141,52.5%,9m
10542,3,[CS0]HarDRaiL,3307,834,50,44,94,53.2%,21m
10542,3,Lufferman,3307,1114,44,44,88,50.0%,11m
10542,3,Vertushka,3307,541,24,18,42,57.1%,7m
10542,3,[tftw]Kabooom,3307,430,22,21,43,51.2%,21m
10542,3,fcnpro,3307,481,20,9,29,69.0%,19m
10542,3,[ezpz]Erdbeerblau,3307,412,15,22,37,40.5%,4m
10542,3,Starlex,3307,270,10,10,20,50.0%,4m
10542,3,Kira,3307,214,9,4,13,69.2%,20m
10542,3,szakal,3307,90,3,7,10,30.0%,8m
10542,3,tykin,3307,30,2,1,3,66.7%,13m
10542,3,NaniSore,3307,58,2,2,4,50.0%,16m
10542,3,RuSh,3307,0,1,0,1,100.0%,17m
10542,3,Kryptic,3307,30,1,5,6,16.7%,10m
10542,2,InCtrl,3307,0,0,1,1,0.0%,18m
10542,3,Tayra,3307,0,0,1,1,0.0%,14m
10561,3,Azilot,3306,1536,359,352,711,50.5%,5m
10561,3,[ADIGA]Molaman,3306,565,113,117,230,49.1%,21m
10561,3,Kenny,3306,452,17,17,34,50.0%,3m
10561,3,PeteR,3306,202,13,11,24,54.2%,21m
10561,3,Deverio,3306,356,13,15,28,46.4%,4m
10561,3,BadfooD,3306,152,12,12,24,50.0%,15m
10561,3,lauri,3306,264,10,14,24,41.7%,12m
10561,3,azha,3306,145,9,10,19,47.4%,6m
10561,3,Wiskas,3306,146,6,2,8,75.0%,16m
10561,3,[IddE]Danuvius,3306,185,6,4,10,60.0%,3m
10561,3,Inqn,3306,86,4,0,4,100.0%,17m
10561,3,[HISKI]stinkynewt,3306,86,4,2,6,66.7%,6m
10561,2,Technique,3306,146,3,2,5,60.0%,20m
10561,3,[UnWp]nWpLawliet,3306,60,3,3,6,50.0%,7m
10561,3,[TZWP]Glück,3306,0,1,0,1,100.0%,20m
10561,3,[Sunray]CoalApple,3306,30,1,1,2,50.0%,19m
10561,1,Eridanus,3306,97,1,2,3,33.3%,16m
10561,3,[InBri]PolarBeeANG,3306,0,0,2,2,0.0%,6m
10561,3,bruh,3306,0,0,2,2,0.0%,17m
10580,3,spazbite,3305,1420,121,118,239,50.6%,16m
10580,3,Malus,3305,1593,95,90,185,51.4%,14m
10580,3,basad,3305,1221,79,69,148,53.4%,19m
10580,3,[BsG]Hunter,3305,1115,67,58,125,53.6%,11m
10580,3,qazer,3305,865,67,59,126,53.2%,21m
10580,3,[HZeS]ТеньМонолита,3305,703,34,10,44,77.3%,19m
10580,3,Neamo,3305,828,30,31,61,49.2%,9m
10580,3,[ITGC]Barcode,3305,654,25,23,48,52.1%,11m
10580,3,KartaL,3305,278,11,7,18,61.1%,3m
10580,3,[iX]Skywalker,3305,252,10,5,15,66.7%,8m
10580,3,[сSсǃ]SpektoR,3305,236,9,10,19,47.4%,17m
10580,3,[IceHus]Element,3305,209,6,7,13,46.2%,2m
10580,3,Theshade,3305,174,6,8,14,42.9%,17m
10580,3,[u4]XcelShark,3305,205,6,9,15,40.0%,12m
10580,3,[TITIEZ]Lunatic,3305,30,1,3,4,25.0%,20m
10580,3,[DZTK]aiur,3305,0,0,1,1,0.0%,11m
10580,3,SokoleOko,3305,0,0,2,2,0.0%,9m
10597,3,[antkr]Holshok,3304,1629,200,183,383,52.2%,7m
10597,3,SirSpook,3304,1529,155,146,301,51.5%,2m
10597,3,[MSTL]KereM,3304,1579,138,122,260,53.1%,2m
10597,3,Lautstark,3304,925,107,84,191,56.0%,16m
10597,3,[Eun]billy,3304,1584,100,84,184,54.3%,6m
10597,3,BigAssMonkey,3304,1577,95,83,178,53.4%,20m
10597,3,[ValidG]Shifty,3304,1388,60,46,106,56.6%,6m
10597,3,neverfailed,3304,1250,53,46,99,53.5%,19m
10597,3,SanoFi,3304,414,27,16,43,62.8%,11m
10597,3,Pravednik,3304,278,10,15,25,40.0%,6m
10597,1,Jack,3304,206,9,7,16,56.2%,6m
10597,3,Athoshiro,3304,236,9,10,19,47.4%,20m
10597,1,llllllllllll,3304,97,5,2,7,71.4%,27m
10597,3,ruslanbest,3304,58,2,1,3,66.7%,2m
10597,3,Nichos,3304,0,2,5,7,28.6%,4m
10597,3,[VISsc]Kinein,3304,0,1,0,1,100.0%,16m
10597,3,[AoTu]Pinkerton,3304,0,1,0,1,100.0%,18m
10597,3,llllllllllll,3304,30,1,2,3,33.3%,7m
10597,3,[0G]Xyusin,3304,30,1,3,4,25.0%,6m
10597,2,[KoBAdm]Unknown,3304,0,0,1,1,0.0%,29m
10617,3,DaveBoy,3303,1559,200,197,397,50.4%,10m
10617,3,nabhab,3303,1518,146,134,280,52.1%,10m
10617,3,Skeli,3303,1426,117,124,241,48.5%,18m
10617,3,Rabotron,3303,1238,102,96,198,51.5%,10m
10617,3,LuckyURVB,3303,1611,73,73,146,50.0%,12m
10617,3,[MGBNom]Hobo,3303,270,10,25,35,28.6%,7m
10617,3,tigerdyret,3303,176,7,4,11,63.6%,12m
10617,3,SlayerMatrix,3303,143,7,7,14,50.0%,12m
10617,1,Ryppinho,3303,120,6,2,8,75.0%,10m
10617,1,[TAW]HenpeT,3303,144,2,2,4,50.0%,41m
10617,3,FLOSAN,3303,0,1,0,1,100.0%,18m
10617,3,[BAPP]Squidite,3303,0,1,0,1,100.0%,21m
10617,3,SypnijZwirem,3303,0,0,1,1,0.0%,18m
10617,3,Shacko,3303,0,0,1,1,0.0%,6m
10617,3,Bobolina,3303,0,0,2,2,0.0%,7m
10632,3,batman,3302,1184,46,40,86,53.5%,4m
10632,3,Elorasa,3302,542,37,32,69,53.6%,7m
10632,3,ZerGAcTiOnch,3302,401,14,8,22,63.6%,3m
10632,3,BlackSheep,3302,322,12,8,20,60.0%,15m
10632,3,Hamsterling,3302,246,9,14,23,39.1%,16m
10632,3,[Nosda]Kiwi,3302,114,5,1,6,83.3%,4m
10632,3,WarLord,3302,102,4,6,10,40.0%,6m
10632,3,[JLT]Yegres,3302,116,4,6,10,40.0%,21m
10632,3,[DUCLAN]Monistrim,3302,0,1,0,1,100.0%,19m
10632,1,Cheedhead,3302,0,1,0,1,100.0%,52m
10632,3,holywan,3302,0,1,2,3,33.3%,7m
10632,3,RapidFire,3302,30,1,3,4,25.0%,18m
10632,3,Showtek,3302,0,0,2,2,0.0%,12m
10645,3,NYO,3301,1604,99,98,197,50.3%,4m
10645,3,Prophet,3301,1471,73,74,147,49.7%,8m
10645,3,[ZERG7V]Vifesia,3301,1059,58,60,118,49.2%,19m
10645,3,[Hrr]Verniy,3301,378,34,40,74,45.9%,2m
10645,3,Rogba,3301,702,27,30,57,47.4%,19m
10645,3,AimSamUan,3301,395,20,17,37,54.1%,10m
10645,3,[khoans]vjsr,3301,216,14,8,22,63.6%,4m
10645,3,yaki,3301,344,13,12,25,52.0%,9m
10645,3,Basusay,3301,320,12,10,22,54.5%,7m
10645,3,Sova,3301,178,6,1,7,85.7%,7m
10645,3,[Brud]Spags,3301,30,2,0,2,100.0%,18m
10645,3,Pagans,3301,30,2,0,2,100.0%,11m
10645,3,TeddyBear,3301,30,2,6,8,25.0%,2m
10645,3,Luutarhuri,3301,62,2,6,8,25.0%,5m
10645,3,[MNGGTV]Matsca,3301,0,1,0,1,100.0%,6m
10645,3,[LegVI]Snewp,3301,0,0,2,2,0.0%,11m
10661,3,Tpaktop,3300,526,152,147,299,50.8%,3m
10661,3,MarTiniii,3300,1625,107,104,211,50.7%,17m
10661,2,hoodlum,3300,869,45,58,103,43.7%,15m
10661,3,enmuriau,3300,575,23,14,37,62.2%,15m
10661,3,[BEKS]Zebulda,3300,346,13,10,23,56.5%,3m
10661,3,BanjO,3300,254,9,16,25,36.0%,16m
10661,3,[RnGpro]Cloud,3300,166,8,3,11,72.7%,7m
10661,3,Jester,3300,30,2,2,4,50.0%,16m
10661,3,epicvoid,3300,30,2,4,6,33.3%,14m
10661,3,Viperon,3300,0,1,0,1,100.0%,14m
10661,3,Computer,3300,0,1,0,1,100.0%,13m
10661,3,[0G]Pernix,3300,0,0,1,1,0.0%,20m
10661,3,Кабачок,3300,0,0,1,1,0.0%,21m
10661,3,[DaFF]BlackDragon,3300,0,0,1,1,0.0%,21m
10661,3,Elysian,3300,0,0,2,2,0.0%,17m
10676,2,SweetMask,3299,1452,380,377,757,50.2%,4m
10676,3,TAENORN,3299,1532,64,67,131,48.9%,9m
10676,3,[DvX]RuggiFuma,3299,1296,63,40,103,61.2%,6m
10676,3,[lllll1]сашабравлер,3299,842,39,36,75,52.0%,10m
10676,3,[FOG]Bloodplayer,3299,463,20,11,31,64.5%,3m
10676,3,Sdrummy,3299,286,15,5,20,75.0%,17m
10676,3,[ClubR]Pet,3299,360,14,13,27,51.9%,2m
10676,3,llllllllllll,3299,356,13,15,28,46.4%,11m
10676,3,DIFFF,3299,143,9,16,25,36.0%,15m
10676,2,TrainingTime,3299,168,7,6,13,53.8%,20m
10676,2,BadZerg,3299,96,5,1,6,83.3%,45m
10676,3,lazy,3299,0,3,3,6,50.0%,2m
10676,3,[ValidG]zimbabwue,3299,58,2,2,4,50.0%,11m
10676,3,Faluch,3299,0,1,1,2,50.0%,14m
10676,3,POVSTANEC,3299,0,1,1,2,50.0%,20m
10691,3,ErwinBanana,3298,1169,77,65,142,54.2%,5m
10691,3,[Cancro]Heaconz,3298,991,75,58,133,56.4%,15m
10691,3,CaseL,3298,1042,67,33,100,67.0%,11m
10691,3,[WHBO]Magulon,3298,858,33,31,64,51.6%,9m
10691,3,[Kompi]Exedo,3298,916,32,36,68,47.1%,19m
10691,3,[EZ4XY]Jerrymiao,3298,623,26,33,59,44.1%,8m
10691,3,Luchito,3298,449,18,12,30,60.0%,7m
10691,3,PanSarin,3298,482,17,14,31,54.8%,3m
10691,3,[Heroes]PaxAeterna,3298,441,15,11,26,57.7%,9m
10691,3,Polobob,3298,352,13,15,28,46.4%,2m
10691,2,[ƮƎƑ]ÃƧĦ,3298,404,12,31,43,27.9%,7m
10691,3,MathewGg,3298,140,10,9,19,52.6%,14m
10691,3,inikolaer,3298,86,4,1,5,80.0%,10m
10691,3,[GET]krastone,3298,114,4,3,7,57.1%,20m
10691,3,[Z3RGML]Baldman,3298,144,3,3,6,50.0%,2m
10691,3,Kanakatala,3298,30,2,1,3,66.7%,7m
10691,3,[Cybro]elamate,3298,30,1,2,3,33.3%,6m
10691,3,Ulrezaj,3298,0,1,4,5,20.0%,5m
10691,3,HydraX,3298,0,0,1,1,0.0%,2m
10710,3,bersobar,3297,1617,231,222,453,51.0%,6m
10710,3,[Pulpo]KRW,3297,1498,200,197,397,50.4%,2m
10710,3,[Ebula5]Blutegel,3297,549,24,15,39,61.5%,15m
10710,3,[GFXM]JackDaniel,3297,482,19,14,33,57.6%,10m
10710,3,[DgF2]Malzbier,3297,149,13,8,21,61.9%,10m
10710,3,SgtWuddel,3297,326,12,13,25,48.0%,20m
10710,3,Rafaello,3297,190,8,5,13,61.5%,2m
10710,3,Poiy,3297,142,6,6,12,50.0%,19m
10710,3,Activin,3297,120,5,3,8,62.5%,17m
10710,3,GroWinG,3297,156,5,15,20,25.0%,12m
10710,3,[hängA]kuPsen,3297,60,3,3,6,50.0%,11m
10710,1,[betaAL]synkALMERZ,3297,96,2,1,3,66.7%,26m
10710,3,[IVT]SiG,3297,0,1,1,2,50.0%,12m
10710,3,HokusFocus,3297,0,1,1,2,50.0%,7m
10710,3,Карантино,3297,30,1,1,2,50.0%,14m
10710,3,Spaark,3297,30,1,2,3,33.3%,19m
10710,3,Zerger,3297,26,1,10,11,9.1%,14m
10710,3,MarineKing,3297,0,0,1,1,0.0%,14m
10710,3,Néo,3297,0,0,2,2,0.0%,16m
10729,3,[HKSCII]IIIIIIIII,3296,388,131,104,235,55.7%,9m
10729,3,ЗергушЁнныш,3296,870,96,43,139,69.1%,19m
10729,3,mellonn,3296,915,91,85,176,51.7%,9m
10729,3,KiborG,3296,745,64,49,113,56.6%,3m
10729,3,Erejum,3296,916,35,30,65,53.8%,6m
10729,3,[neuroW]NEAC,3296,536,24,17,41,58.5%,21m
10729,3,[DOM]YOfr,3296,606,24,18,42,57.1%,11m
10729,3,Huntana,3296,349,18,14,32,56.2%,21m
10729,3,SummerWind,3296,333,15,11,26,57.7%,4m
10729,3,alkash,3296,340,13,13,26,50.0%,5m
10729,3,Ashot,3296,90,7,3,10,70.0%,6m
10729,3,DildoDragons,3296,90,7,9,16,43.8%,3m
10729,2,Gainz,3296,95,5,1,6,83.3%,44m
10729,2,teco,3296,0,4,1,5,80.0%,28m
10729,3,[lMMl]Justice,3296,86,4,3,7,57.1%,6m
10729,3,Solid,3296,58,3,0,3,100.0%,10m
10729,3,lKazura,3296,30,2,0,2,100.0%,21m
10729,3,Johnson,3296,58,2,3,5,40.0%,6m
10729,3,JiBé,3296,0,1,0,1,100.0%,20m
10729,3,Krmenadla,3296,0,0,1,1,0.0%,10m
10729,3,Минск,3296,0,0,2,2,0.0%,19m
10729,3,Jeff,3296,0,0,3,3,0.0%,16m
10751,3,[DTTSC]FuntX,3295,497,90,73,163,55.2%,2m
10751,3,Smile,3295,1181,75,73,148,50.7%,21m
10751,3,assclown,3295,868,46,35,81,56.8%,2m
10751,3,Bald,3295,848,41,29,70,58.6%,19m
10751,3,[AOIC]Hahniball,3295,720,38,43,81,46.9%,10m
10751,3,GGJustic,3295,775,35,30,65,53.8%,6m
10751,3,[PO1A1O]Chip,3295,501,23,16,39,59.0%,10m
10751,3,MrPink,3295,532,18,26,44,40.9%,21m
10751,1,IIIIIIIIIIII,3295,281,12,8,20,60.0%,4m
10751,3,ZhugeLight,3295,176,10,5,15,66.7%,2m
10751,2,tonttu,3295,150,8,16,24,33.3%,8m
10751,3,ChromeSteed,3295,239,7,4,11,63.6%,7m
10751,3,Amalirr,3295,112,5,9,14,35.7%,12m
10751,3,Dakk,3295,114,4,8,12,33.3%,10m
10751,3,Alchemist,3295,58,3,0,3,100.0%,9m
10751,3,[CIMI]Saribanum,3295,60,2,4,6,33.3%,6m
10751,3,bugster,3295,0,2,5,7,28.6%,20m
10751,3,[SemiCr]Loscolo,3295,0,1,0,1,100.0%,11m
10751,3,Lain,3295,0,1,1,2,50.0%,14m
10751,3,[DNUH]Yamato,3295,30,1,2,3,33.3%,4m
10751,2,CRyzzIS,3295,91,1,2,3,33.3%,7m
10751,3,FLOYD,3295,0,0,1,1,0.0%,7m
10773,2,PoweRLocK,3294,1599,227,222,449,50.6%,18m
10773,3,platzhalter,3294,1362,107,94,201,53.2%,14m
10773,3,AgonyAunt,3294,1362,95,91,186,51.1%,6m
10773,3,rakeyrakey,3294,491,23,28,51,45.1%,10m
10773,2,Snack,3294,656,22,35,57,38.6%,15m
10773,3,[US1D]ZellhuLu,3294,307,18,17,35,51.4%,4m
10773,3,Saboteur,3294,433,16,11,27,59.3%,11m
10773,3,Trunxz,3294,306,14,11,25,56.0%,18m
10773,3,[SUUUUS]Linebeck,3294,290,9,5,14,64.3%,12m
10773,3,llllllllllll,3294,170,7,3,10,70.0%,7m
10773,3,[рейд]Arch,3294,114,4,5,9,44.4%,17m
10773,3,[НОД17]Overmind,3294,126,4,12,16,25.0%,17m
10773,3,[PRAWN]BigKahuna,3294,88,3,3,6,50.0%,4m
10773,3,Alex,3294,0,1,0,1,100.0%,21m
10773,2,[gamato]ArxidatoS,3294,0,0,1,1,0.0%,6m
10773,3,BlackpinkBTS,3294,0,0,2,2,0.0%,3m
10789,3,Kalimor,3293,578,20,25,45,44.4%,9m
10789,3,BlackSmith,3293,446,17,15,32,53.1%,4m
10789,3,Demolka,3293,492,17,21,38,44.7%,3m
10789,3,[Фаталя]MassVoidRay,3293,391,16,2,18,88.9%,15m
10789,2,Demo,3293,292,12,7,19,63.2%,4m
10789,3,GhostCommand,3293,249,10,7,17,58.8%,6m
10789,1,GregWar,3293,141,7,3,10,70.0%,24m
10789,3,Rafcio,3293,192,7,7,14,50.0%,14m
10789,3,ChristopherR,3293,192,7,13,20,35.0%,18m
10789,3,[SFight]NeSmaavri,3293,114,5,1,6,83.3%,12m
10789,3,Inspyre,3293,60,2,5,7,28.6%,21m
10789,3,[neuroW]DroneScout,3293,0,1,0,1,100.0%,14m
10789,2,[HämSec]sciencedwarf,3293,0,1,0,1,100.0%,3m
10789,3,Anastasia,3293,0,1,0,1,100.0%,5m
10789,3,Toolism,3293,30,1,11,12,8.3%,21m
10789,3,Zastym,3293,0,0,1,1,0.0%,11m
10789,3,KombatWombat,3293,0,0,1,1,0.0%,21m
10789,3,[TuBois]TribalSpirit,3293,0,0,3,3,0.0%,14m
10789,1,[M1B]AgentJ,3293,0,0,7,7,0.0%,52m
10808,3,KimJongjong,3292,1573,119,97,216,55.1%,3m
10808,3,DerWurm,3292,881,52,48,100,52.0%,9m
10808,3,Marduk,3292,1202,48,39,87,55.2%,17m
10808,3,Alucard,3292,392,19,10,29,65.5%,19m
10808,3,TheDude,3292,258,17,6,23,73.9%,12m
10808,3,benjatoooo,3292,285,10,9,19,52.6%,6m
10808,3,[GRNSKN]Oferon,3292,140,6,3,9,66.7%,7m
10808,3,Zepto,3292,148,6,13,19,31.6%,14m
10808,3,[MiMs]Flip,3292,94,4,12,16,25.0%,6m
10808,3,Gregosss,3292,94,3,9,12,25.0%,10m
10808,3,[GBang]Pixel,3292,30,2,1,3,66.7%,12m
10808,3,[Умоджа]TEPPAH,3292,0,1,0,1,100.0%,3m
10808,3,Harkenstøne,3292,0,0,1,1,0.0%,20m
10808,3,Rydi,3292,0,0,1,1,0.0%,2m
10822,3,[FJAKE]KilKoff,3291,1677,257,254,511,50.3%,8m
10822,3,Poco,3291,1489,75,79,154,48.7%,14m
10822,3,GrungeGringo,3291,1310,49,48,97,50.5%,10m
10822,3,Vja,3291,482,32,17,49,65.3%,8m
10822,3,sweetydaddy,3291,488,22,10,32,68.8%,4m
10822,3,[Yame]Christophe,3291,584,21,27,48,43.8%,18m
10822,3,grix,3291,426,19,12,31,61.3%,4m
10822,3,[Hartz]DoubleMett,3291,197,8,7,15,53.3%,8m
10822,3,cro,3291,187,6,0,6,100.0%,4m
10822,3,LAPLACE,3291,142,6,3,9,66.7%,13m
10822,1,[PMS1]alchmist,3291,96,4,2,6,66.7%,16m
10822,3,IIIIIIIIIII,3291,92,4,4,8,50.0%,14m
10822,2,[Ǽ1]Cricri,3291,0,3,2,5,60.0%,14m
10822,3,zuqbu,3291,58,3,2,5,60.0%,10m
10822,3,Lomir,3291,86,3,3,6,50.0%,21m
10822,3,Quacke,3291,30,2,0,2,100.0%,10m
10822,3,[LuuZ]Grawer,3291,30,2,7,9,22.2%,18m
10822,3,DrumAndBass,3291,0,0,1,1,0.0%,11m
10822,3,uncool,3291,0,0,1,1,0.0%,6m
10822,3,Tres,3291,0,0,2,2,0.0%,21m
10822,3,Святой,3291,0,0,2,2,0.0%,20m
10822,3,[Swarm6]Queen,3291,0,0,2,2,0.0%,19m
10822,3,[NLTHB]Aionics,3291,0,0,2,2,0.0%,2m
10822,2,OMA,3291,0,0,5,5,0.0%,45m
10846,2,Serathus,3290,1132,177,172,349,50.7%,5m
10846,3,ExoticSphere,3290,1184,72,74,146,49.3%,8m
10846,3,[FOTF]Rafdune,3290,952,52,35,87,59.8%,11m
10846,3,Mitropanos,3290,1292,51,54,105,48.6%,3m
10846,3,[Hrr]Choojoy,3290,836,32,30,62,51.6%,2m
10846,3,Jago,3290,518,18,28,46,39.1%,14m
10846,3,Algous,3290,192,8,7,15,53.3%,10m
10846,3,Verukk,3290,0,5,0,5,100.0%,5m
10846,3,[SCBoys]CiRkuS,3290,114,4,2,6,66.7%,4m
10846,3,[ESMC]NotFound,3290,115,4,3,7,57.1%,11m
10846,3,Geecko,3290,0,1,1,2,50.0%,3m
10846,3,BMorge,3290,30,1,1,2,50.0%,18m
10846,3,Сказки,3290,0,1,1,2,50.0%,5m
10846,3,[HaDeEf]Nwudebudde,3290,0,0,1,1,0.0%,17m
10860,3,DrRudi,3289,1167,82,69,151,54.3%,17m
10860,3,Nyphang,3289,722,50,30,80,62.5%,7m
10860,3,[ÐcE]samkar,3289,661,34,8,42,81.0%,20m
10860,3,TEKKEN,3289,610,27,24,51,52.9%,10m
10860,3,AtbrrOficial,3289,601,26,23,49,53.1%,14m
10860,3,DreamerPhi,3289,428,17,16,33,51.5%,13m
10860,3,[136]sOOpr,3289,357,13,10,23,56.5%,17m
10860,3,[TeamR]JacquesVabre,3289,408,13,21,34,38.2%,8m
10860,3,Uvo,3289,168,8,7,15,53.3%,14m
10860,3,[BATG]CrisuBobonet,3289,172,6,8,14,42.9%,15m
10860,2,[Medoed]Jjfed,3289,0,5,0,5,100.0%,9m
10860,3,IIIIIIIIIIII,3289,116,5,7,12,41.7%,11m
10860,2,Nehalem,3289,0,3,2,5,60.0%,16m
10860,2,Obibi,3289,82,3,4,7,42.9%,15m
10860,3,[HLORDS]LardHelmchen,3289,60,2,6,8,25.0%,19m
10860,3,Marr,3289,62,2,11,13,15.4%,14m
10860,1,[SMDD]Zeilor,3289,0,1,0,1,100.0%,13m
10860,3,[KВN]MarikPw,3289,0,0,1,1,0.0%,12m
10860,3,Evg,3289,0,0,3,3,0.0%,7m
10879,2,freez,3288,1534,89,110,199,44.7%,18m
10879,2,Frijs,3288,529,74,81,155,47.7%,14m
10879,3,AnttiAnttila,3288,1108,42,41,83,50.6%,6m
10879,3,Reamonn,3288,908,36,24,60,60.0%,20m
10879,3,Jack,3288,718,27,31,58,46.6%,6m
10879,3,Wasureta,3288,365,16,10,26,61.5%,13m
10879,3,FocusIRE,3288,260,13,8,21,61.9%,14m
10879,3,Гераклион,3288,212,7,1,8,87.5%,6m
10879,2,[Ovrrtd]Alexander,3288,131,7,5,12,58.3%,5m
10879,3,[Famoso]Chavezzz,3288,94,5,1,6,83.3%,8m
10879,2,CobraLin,3288,142,5,3,8,62.5%,13m
10879,3,zohn,3288,0,4,1,5,80.0%,14m
10879,1,Eliptic,3288,142,3,2,5,60.0%,29m
10879,3,Vampire,3288,0,3,2,5,60.0%,4m
10879,3,[PLEBZZ]Shiny,3288,30,2,1,3,66.7%,4m
10879,3,[Listic]Mafydurf,3288,58,2,4,6,33.3%,15m
10879,3,[ProRax]yoma,3288,60,2,5,7,28.6%,18m
10879,3,kicuLito,3288,0,1,0,1,100.0%,20m
10879,3,LaKalaSH,3288,0,1,0,1,100.0%,14m
10879,2,[Halo]InfiParaiso,3288,0,1,4,5,20.0%,31m
10879,3,DarkAss,3288,0,0,1,1,0.0%,20m
10879,2,[ЕМPIRE]Червяк,3288,0,0,1,1,0.0%,20m
10879,3,Atropos,3288,0,0,2,2,0.0%,2m
10902,3,[PiGPan]Garethax,3287,1604,167,169,336,49.7%,9m
10902,3,Van,3287,1248,55,39,94,58.5%,10m
10902,3,uvccv,3287,460,35,26,61,57.4%,10m
10902,3,Houden,3287,684,26,23,49,53.1%,17m
10902,3,DönerKnight,3287,626,24,26,50,48.0%,3m
10902,3,sennt,3287,382,22,17,39,56.4%,4m
10902,3,Sam,3287,469,21,16,37,56.8%,10m
10902,3,HoleD,3287,259,12,15,27,44.4%,2m
10902,3,ExalT,3287,251,10,8,18,55.6%,15m
10902,3,Castiel,3287,86,4,1,5,80.0%,6m
10902,3,OrdanBest,3287,86,3,1,4,75.0%,15m
10902,3,Flox,3287,60,3,3,6,50.0%,8m
10902,3,DölerichHf,3287,125,3,5,8,37.5%,19m
10902,3,EXTREMEzerg,3287,30,2,1,3,66.7%,4m
10902,3,nabokow,3287,58,2,1,3,66.7%,11m
10902,3,Tepic,3287,30,2,2,4,50.0%,10m
10902,1,[FTWEED]Zael,3287,96,1,1,2,50.0%,48m
10902,3,Megagore,3287,0,1,1,2,50.0%,17m
10902,3,DICCBOY,3287,0,0,1,1,0.0%,15m
10921,2,[DRÔLE]KluGhorN,3286,1526,332,328,660,50.3%,16m
10921,3,Biomechanix,3286,1072,131,96,227,57.7%,3m
10921,3,Eleard,3286,489,81,71,152,53.3%,3m
10921,3,[Cannоn]Granate,3286,481,22,5,27,81.5%,17m
10921,3,Bossmode,3286,575,20,21,41,48.8%,20m
10921,3,[TULEN]Hardydav,3286,154,8,2,10,80.0%,6m
10921,2,itayper,3286,150,7,5,12,58.3%,7m
10921,3,aleandr,3286,0,4,1,5,80.0%,12m
10921,3,[EAU]Zergivor,3286,86,3,2,5,60.0%,20m
10921,3,Djcomf,3286,60,3,3,6,50.0%,9m
10921,3,Wennan,3286,58,2,4,6,33.3%,13m
10921,3,[MecGR]Tommy,3286,0,1,1,2,50.0%,15m
10921,3,Tetra,3286,0,0,1,1,0.0%,17m
10921,3,Casey,3286,0,0,1,1,0.0%,18m
10935,3,TorresK,3285,1300,67,63,130,51.5%,16m
10935,3,Rahvin,3285,981,49,47,96,51.0%,5m
10935,3,CrimsonKodo,3285,901,34,35,69,49.3%,17m
10935,3,BelBITE,3285,882,32,40,72,44.4%,5m
10935,3,maeri,3285,680,28,20,48,58.3%,6m
10935,3,Ruins,3285,496,19,16,35,54.3%,19m
10935,3,Ehomer,3285,508,18,22,40,45.0%,9m
10935,3,RAGEOWN,3285,398,15,13,28,53.6%,8m
10935,3,[WTSO]klafdis,3285,401,15,23,38,39.5%,18m
10935,3,[CZIPY]TaarnATD,3285,285,12,5,17,70.6%,20m
10935,3,PiKiTrOn,3285,264,10,8,18,55.6%,19m
10935,3,Hoboedd,3285,222,8,5,13,61.5%,14m
10935,3,Bart,3285,116,5,1,6,83.3%,4m
10935,3,[BTNB]Barbarry,3285,86,4,1,5,80.0%,2m
10935,3,[mfixed]Ablaze,3285,104,3,1,4,75.0%,6m
10935,3,Mattias,3285,30,2,1,3,66.7%,15m
10935,2,xakcar,3285,46,2,2,4,50.0%,47m
10935,3,[AusGam]Governorth,3285,0,1,0,1,100.0%,6m
10935,2,limpie,3285,0,1,1,2,50.0%,45m
10935,3,Shademoon,3285,0,1,1,2,50.0%,8m
10935,3,shaon,3285,0,1,2,3,33.3%,17m
10935,3,Extremis,3285,30,1,5,6,16.7%,17m
10935,3,DarkZoit,3285,0,0,1,1,0.0%,16m
10935,3,[Robilf]Akantor,3285,0,0,3,3,0.0%,9m
10959,2,[SEBULA]Terminus,3284,1479,319,316,635,50.2%,13m
10959,3,misc,3284,1561,68,71,139,48.9%,12m
10959,3,Vadesmus,3284,659,36,37,73,49.3%,6m
10959,3,Zeewz,3284,755,33,17,50,66.0%,20m
10959,3,[TRWG]Devlan,3284,265,17,9,26,65.4%,6m
10959,3,[HZeS]FARI,3284,301,12,3,15,80.0%,11m
10959,3,[RESURS]mrPetrovich,3284,295,10,6,16,62.5%,8m
10959,3,Zakraor,3284,194,8,4,12,66.7%,5m
10959,3,NiftySoft,3284,213,7,18,25,28.0%,15m
10959,3,[SEXi]itzNaix,3284,166,6,3,9,66.7%,17m
10959,3,Passchendael,3284,62,3,9,12,25.0%,12m
10959,3,KellogZ,3284,134,2,7,9,22.2%,5m
10959,3,[GosuRU]scIIexe,3284,0,1,1,2,50.0%,6m
10959,3,Drysc,3284,30,1,5,6,16.7%,15m
10959,3,BitGhost,3284,0,0,1,1,0.0%,11m
10959,3,aiur,3284,0,0,1,1,0.0%,9m
10959,3,CrazyConor,3284,0,0,2,2,0.0%,17m
10976,3,Antubis,3283,699,124,125,249,49.8%,2m
10976,3,[IceHus]Дурашка,3283,1312,87,79,166,52.4%,4m
10976,3,CLOxgoldpopx,3283,629,44,47,91,48.4%,10m
10976,3,KingOfBlades,3283,210,13,11,24,54.2%,4m
10976,3,CMo,3283,372,12,24,36,33.3%,4m
10976,1,Callidus,3283,219,11,8,19,57.9%,17m
10976,3,[xFRSx]Cylon,3283,206,7,0,7,100.0%,7m
10976,3,[Arrows]InsomniA,3283,170,6,10,16,37.5%,13m
10976,2,SCNoob,3283,0,4,1,5,80.0%,53m
10976,2,Chris,3283,93,2,4,6,33.3%,9m
10976,3,cabakaaaa,3283,64,2,11,13,15.4%,4m
10976,3,[TGWN]Python,3283,0,1,0,1,100.0%,12m
10976,3,Shutman,3283,30,1,4,5,20.0%,7m
10989,3,Dare,3282,704,75,73,148,50.7%,10m
10989,3,[EESC]sitaska,3282,1342,55,57,112,49.1%,14m
10989,3,BlingBling,3282,675,26,27,53,49.1%,12m
10989,3,paulin,3282,578,21,22,43,48.8%,10m
10989,3,[HsDL]kydd,3282,80,17,20,37,45.9%,6m
10989,3,BondageChair,3282,416,16,10,26,61.5%,5m
10989,3,TREY,3282,400,15,17,32,46.9%,13m
10989,3,TmG,3282,288,11,9,20,55.0%,5m
10989,3,[Gloves]AlexIG,3282,248,10,5,15,66.7%,17m
10989,3,Oekel,3282,230,8,9,17,47.1%,2m
10989,3,[Dobro]Bishokukai,3282,166,7,0,7,100.0%,3m
10989,2,Amaranthe,3282,0,3,2,5,60.0%,50m
10989,3,Kalenh,3282,58,2,2,4,50.0%,15m
10989,3,MarshGeology,3282,0,1,0,1,100.0%,9m
10989,3,Wicchi,3282,0,1,1,2,50.0%,4m
10989,3,WellDone,3282,30,1,7,8,12.5%,21m
10989,3,Greiv,3282,0,0,1,1,0.0%,15m
10989,3,[TAСО]Smile,3282,0,0,1,1,0.0%,6m
11007,3,chody,3281,1479,129,127,256,50.4%,3m
11007,3,[OwMind]Aaz,3281,1460,118,120,238,49.6%,18m
11007,3,StarLight,3281,1575,94,89,183,51.4%,17m
11007,3,Potato,3281,459,40,29,69,58.0%,14m
11007,3,diip,3281,622,28,20,48,58.3%,19m
11007,3,WarLord,3281,720,27,25,52,51.9%,10m
11007,3,[MDM4]MDMApøliakov,3281,399,18,10,28,64.3%,2m
11007,3,Xerlock,3281,408,15,17,32,46.9%,20m
11007,3,[Heroes]Moes,3281,342,12,18,30,40.0%,4m
11007,3,SpaceCowboy,3281,248,10,7,17,58.8%,3m
11007,3,Wub,3281,225,9,9,18,50.0%,10m
11007,3,PederAA,3281,174,8,5,13,61.5%,4m
11007,3,Killerfish,3281,86,4,1,5,80.0%,11m
11007,3,Number,3281,161,4,2,6,66.7%,18m
11007,3,Mercer,3281,122,2,4,6,33.3%,2m
11007,1,OldYoghurt,3281,0,1,0,1,100.0%,50m
11007,2,Painful,3281,0,0,1,1,0.0%,17m
11007,2,[iksD]SeptimusReyt,3281,0,0,2,2,0.0%,6m
11025,3,Mito,3280,1599,143,148,291,49.1%,10m
11025,3,[AsMG]dannyRose,3280,1482,73,57,130,56.2%,5m
11025,3,floi,3280,434,57,60,117,48.7%,6m
11025,3,Wanja,3280,1047,50,59,109,45.9%,14m
11025,3,Delly,3280,629,30,10,40,75.0%,11m
11025,3,[Arrows]TauRUS,3280,457,18,15,33,54.5%,12m
11025,3,Shlepming,3280,238,8,14,22,36.4%,14m
11025,3,BagelBringer,3280,60,3,3,6,50.0%,2m
11025,2,IceCold,3280,147,3,3,6,50.0%,21m
11025,3,Zeggix,3280,0,1,0,1,100.0%,16m
11025,2,[Ar4ont]Сенко,3280,0,1,0,1,100.0%,53m
11025,3,Hotage,3280,0,0,1,1,0.0%,13m
11025,3,GodLiKe,3280,0,0,1,1,0.0%,4m
11025,3,Isolate,3280,0,0,1,1,0.0%,2m
11025,3,[Bloomr]Humminbird,3280,0,0,1,1,0.0%,4m
11040,3,Skydiver,3279,1476,153,126,279,54.8%,3m
11040,3,[Донный]Eugeny,3279,1540,124,118,242,51.2%,21m
11040,3,gobs,3279,1015,51,41,92,55.4%,14m
11040,3,GKar,3279,617,35,25,60,58.3%,21m
11040,3,juampi,3279,567,24,20,44,54.5%,20m
11040,3,[LVF6]PiPo,3279,489,21,31,52,40.4%,10m
11040,3,Jokenbok,3279,373,14,15,29,48.3%,4m
11040,3,[PARSE]xdgamer,3279,261,13,14,27,48.1%,21m
11040,3,XBucksLater,3279,286,11,11,22,50.0%,20m
11040,3,[TaEl]WolfHead,3279,145,8,2,10,80.0%,2m
11040,3,Pug,3279,171,8,13,21,38.1%,3m
11040,3,Birdslayer,3279,236,7,4,11,63.6%,5m
11040,3,Burgeratora,3279,114,5,5,10,50.0%,6m
11040,2,drekorig,3279,0,4,1,5,80.0%,10m
11040,3,Torkill,3279,134,4,17,21,19.0%,20m
11040,3,[xTQc]WishDeath,3279,119,3,0,3,100.0%,6m
11040,3,Farven,3279,60,3,1,4,75.0%,14m
11040,2,[ÖMO]Jules,3279,46,3,2,5,60.0%,3m
11040,2,[SEKN]SecondTry,3279,0,1,0,1,100.0%,3m
11040,3,Parmifèr,3279,30,1,2,3,33.3%,17m
11040,3,Referendum,3279,0,0,1,1,0.0%,5m
11040,3,tarekp,3279,0,0,3,3,0.0%,19m
11040,3,Tormentor,3279,0,0,3,3,0.0%,5m
11040,3,[SINEVA]CharlieScene,3279,0,0,5,5,0.0%,2m
11064,3,Zaeten,3278,688,59,20,79,74.7%,12m
11064,3,TesTingVexX,3278,463,53,53,106,50.0%,10m
11064,3,belegorn,3278,846,36,25,61,59.0%,11m
11064,3,[BRTLsG]pipejr,3278,520,27,17,44,61.4%,9m
11064,3,[D5]nøstradamus,3278,364,15,14,29,51.7%,4m
11064,3,MysteryL,3278,246,10,8,18,55.6%,2m
11064,3,TheKondzio,3278,203,8,1,9,88.9%,20m
11064,3,[WCKYLN]weichMacher,3278,190,8,4,12,66.7%,4m
11064,3,llllllllllll,3278,114,8,5,13,61.5%,5m
11064,2,YEZUS,3278,160,8,5,13,61.5%,20m
11064,3,FunkyPan,3278,140,6,4,10,60.0%,6m
11064,3,Frosty,3278,184,6,12,18,33.3%,8m
11064,3,Alois,3278,86,4,1,5,80.0%,4m
11064,3,LikeSmoke,3278,86,4,3,7,57.1%,3m
11064,3,Mercy,3278,131,3,0,3,100.0%,16m
11064,3,Amon,3278,86,3,2,5,60.0%,6m
11064,3,Frex,3278,120,2,1,3,66.7%,3m
11064,3,Taloa,3278,60,2,4,6,33.3%,15m
11064,3,sPeTzI,3278,60,2,5,7,28.6%,11m
11064,3,Meister,3278,0,1,0,1,100.0%,15m
11064,3,LoTZ,3278,30,1,2,3,33.3%,5m
11064,3,[xAngry]angrythomap,3278,0,1,2,3,33.3%,9m
11064,3,[Zactar]Nubbling,3278,0,0,1,1,0.0%,20m
11064,3,Pankodak,3278,0,0,1,1,0.0%,3m
11064,3,[Dobro]Kulinar,3278,0,0,1,1,0.0%,19m
11064,3,Kazadrim,3278,0,0,1,1,0.0%,6m
11064,3,Hito,3278,0,0,3,3,0.0%,6m
11091,3,Mobacca,3277,1555,373,365,738,50.5%,21m
11091,3,Drchimaera,3277,1514,125,116,241,51.9%,9m
11091,3,sevro,3277,1361,85,69,154,55.2%,11m
11091,3,[WITCHs]KiWi,3277,1509,84,84,168,50.0%,20m
11091,3,sweetZerg,3277,1478,77,68,145,53.1%,15m
11091,3,Nibbler,3277,1601,65,53,118,55.1%,18m
11091,3,IIIIIIIIIIII,3277,711,29,23,52,55.8%,3m
11091,3,sva,3277,126,17,15,32,53.1%,6m
11091,3,[dG]salchwell,3277,368,14,11,25,56.0%,17m
11091,3,TERRAN,3277,392,13,20,33,39.4%,7m
11091,3,[KD103]HandsOff,3277,234,10,3,13,76.9%,11m
11091,1,Mendeleev,3277,164,7,3,10,70.0%,27m
11091,3,[EMST]syntax,3277,160,7,4,11,63.6%,9m
11091,3,[NIKA]Teodore,3277,86,3,2,5,60.0%,14m
11091,3,Nabon,3277,58,3,2,5,60.0%,5m
11091,1,NoName,3277,97,2,1,3,66.7%,57m
11091,3,Зяблик,3277,0,1,0,1,100.0%,5m
11091,3,[InitRu]HelLioS,3277,0,1,0,1,100.0%,20m
11091,3,[V1P3R]Cunningviper,3277,30,1,2,3,33.3%,7m
11091,3,[Ent]Luetzen,3277,30,1,2,3,33.3%,17m
11091,3,Grumpy,3277,30,1,8,9,11.1%,20m
11091,3,Pasto,3277,0,0,2,2,0.0%,3m
11113,3,[HQ31er]Mistro,3276,1533,433,432,865,50.1%,3m
11113,3,WBlake,3276,1559,266,259,525,50.7%,16m
11113,3,PavelMoscow,3276,1474,210,188,398,52.8%,6m
11113,3,[ØC2]Kellidan,3276,888,35,40,75,46.7%,5m
11113,3,AspenCat,3276,742,29,25,54,53.7%,18m
11113,3,Wojtas,3276,207,28,32,60,46.7%,6m
11113,3,KickTheNoob,3276,213,10,6,16,62.5%,14m
11113,3,PGG,3276,203,9,6,15,60.0%,12m
11113,3,LookingTrash,3276,218,8,5,13,61.5%,10m
11113,3,IIIlIIIlIIII,3276,120,6,3,9,66.7%,20m
11113,3,[T00D]Wittner,3276,148,6,8,14,42.9%,18m
11113,3,BARCODE,3276,88,5,5,10,50.0%,13m
11113,3,IIiIIiilllI,3276,30,4,2,6,66.7%,18m
11113,3,[BANY]Sphinx,3276,93,2,1,3,66.7%,14m
11113,3,Mishka,3276,64,2,12,14,14.3%,4m
11113,3,Edgeless,3276,30,1,1,2,50.0%,10m
11113,3,Grant,3276,0,0,1,1,0.0%,11m
11113,3,IIGrasiekII,3276,0,0,1,1,0.0%,10m
11113,3,DarckWaacku,3276,0,0,1,1,0.0%,16m
11113,3,Mac,3276,0,0,2,2,0.0%,5m
11133,3,DaJoS,3275,1581,176,176,352,50.0%,21m
11133,3,FrAgiLe,3275,1207,69,76,145,47.6%,14m
11133,3,elka,3275,1207,68,72,140,48.6%,14m
11133,3,Pahvinkeitin,3275,991,60,56,116,51.7%,6m
11133,3,Schlampampel,3275,650,60,61,121,49.6%,7m
11133,3,[OBY]shigeryu,3275,1010,53,51,104,51.0%,11m
11133,3,[LEVARP]MrDragon,3275,847,35,25,60,58.3%,9m
11133,3,[НОД17]SeNSeY,3275,427,34,14,48,70.8%,11m
11133,3,[SFight]NoobMaster,3275,658,25,27,52,48.1%,2m
11133,3,Leeroy,3275,474,17,17,34,50.0%,4m
11133,3,Serral,3275,262,12,6,18,66.7%,8m
11133,3,dontQ,3275,286,12,8,20,60.0%,17m
11133,3,JimmyHendrix,3275,176,11,5,16,68.8%,7m
11133,3,CreepyCrawly,3275,262,9,9,18,50.0%,6m
11133,3,Edmait,3275,122,7,1,8,87.5%,15m
11133,1,BoRRiCaNCo,3275,96,5,2,7,71.4%,37m
11133,3,[SQK]Celestine,3275,0,4,1,5,80.0%,6m
11133,2,[FiPS]Achse,3275,0,4,1,5,80.0%,31m
11133,3,Daredevil,3275,0,4,1,5,80.0%,5m
11133,2,Ikaros,3275,0,4,1,5,80.0%,1h
11133,3,Quicktum,3275,175,4,4,8,50.0%,9m
11133,3,Dahmm,3275,60,3,2,5,60.0%,16m
11133,3,[lloll]DadSkil,3275,92,3,8,11,27.3%,21m
11133,3,[iRwT]MonsterRax,3275,30,2,0,2,100.0%,3m
11133,3,Drei,3275,18,2,1,3,66.7%,20m
11133,3,[ePro]Clipstar,3275,30,2,4,6,33.3%,9m
11133,1,Alexrdl,3275,121,2,7,9,22.2%,51m
11133,3,Xpomocoma,3275,0,1,0,1,100.0%,18m
11133,3,EDDIE,3275,30,1,1,2,50.0%,15m
11133,3,[M3M0]diz,3275,0,1,4,5,20.0%,9m
11133,3,Kacperys,3275,0,0,1,1,0.0%,7m
11133,3,deferlant,3275,0,0,1,1,0.0%,6m
11165,2,MIKULA,3274,1454,265,279,544,48.7%,13m
11165,3,bibo,3274,1617,262,255,517,50.7%,14m
11165,3,SanGoo,3274,1138,140,121,261,53.6%,2m
11165,3,[InitRu]ozrKeLL,3274,1431,92,91,183,50.3%,4m
11165,3,CmmBTK,3274,994,69,65,134,51.5%,9m
11165,3,[PSidee]DaEtoJeSmile,3274,380,14,16,30,46.7%,3m
11165,3,HmHoozMilo,3274,310,11,21,32,34.4%,9m
11165,3,[N1NJ4Z]MrKey,3274,236,7,4,11,63.6%,6m
11165,3,[XGKS]PeCoRiNo,3274,172,6,4,10,60.0%,15m
11165,3,CoffeeCruise,3274,86,4,1,5,80.0%,19m
11165,3,PafO,3274,58,3,3,6,50.0%,10m
11165,3,[DragoM]GolD,3274,30,2,0,2,100.0%,17m
11165,2,SlaYeR,3274,0,2,3,5,40.0%,55m
11165,3,Khing,3274,0,1,0,1,100.0%,2m
11165,3,inter,3274,0,1,0,1,100.0%,6m
11165,3,milca,3274,0,1,0,1,100.0%,18m
11165,3,[ZxZ]Overlord,3274,0,0,1,1,0.0%,3m
11165,3,Yharon,3274,0,0,2,2,0.0%,19m
11165,3,BesnyPes,3274,0,0,4,4,0.0%,6m
11184,3,Usi,3273,1208,159,154,313,50.8%,18m
11184,3,NiniMae,3273,885,153,159,312,49.0%,12m
11184,3,PicSoU,3273,1255,119,110,229,52.0%,21m
11184,2,Zonkil,3273,1347,98,94,192,51.0%,3m
11184,3,DoctorGreen,3273,381,82,85,167,49.1%,10m
11184,3,[3vl]Levkan,3273,410,38,10,48,79.2%,5m
11184,3,Shandras,3273,697,33,16,49,67.3%,2m
11184,3,Demtros,3273,708,32,30,62,51.6%,11m
11184,3,Linoge,3273,760,28,27,55,50.9%,16m
11184,3,FMarineKing,3273,689,27,25,52,51.9%,6m
11184,3,Dooby,3273,548,19,25,44,43.2%,7m
11184,3,KARNAVAL,3273,344,16,9,25,64.0%,3m
11184,3,Zeus,3273,360,14,15,29,48.3%,3m
11184,1,[JND]Life,3273,213,9,3,12,75.0%,8m
11184,3,[EZ4XY]THINKBEN,3273,232,9,7,16,56.2%,3m
11184,3,[KsL]TheDarkLord,3273,86,7,4,11,63.6%,6m
11184,3,ddidd,3273,204,7,7,14,50.0%,13m
11184,3,JimmyS,3273,55,6,4,10,60.0%,17m
11184,3,itisme,3273,142,5,5,10,50.0%,2m
11184,3,[DoA]nnmisicrea,3273,120,5,14,19,26.3%,21m
11184,3,[ZCrew]turtle,3273,90,4,5,9,44.4%,16m
11184,2,martiros,3273,0,2,4,6,33.3%,54m
11184,3,Lefti,3273,30,1,2,3,33.3%,17m
11184,3,Dulc,3273,0,1,2,3,33.3%,6m
11184,3,Edelweiss,3273,0,1,2,3,33.3%,18m
11184,3,Luksis,3273,0,0,1,1,0.0%,11m
11184,3,[AiRǂ]LotoNero,3273,0,0,1,1,0.0%,4m
11211,3,AgentSmith,3272,1555,125,120,245,51.0%,19m
11211,3,BIGU,3272,1474,80,74,154,51.9%,11m
11211,3,[WhiteX]FatBob,3272,1446,63,74,137,46.0%,15m
11211,3,Abver,3272,273,61,46,107,57.0%,3m
11211,3,Nergath,3272,1422,52,58,110,47.3%,12m
11211,3,SizZLAR,3272,884,39,28,67,58.2%,18m
11211,3,[369]Eduardogl,3272,259,12,7,19,63.2%,6m
11211,3,SourisChauve,3272,276,11,4,15,73.3%,12m
11211,3,Slaygon,3272,188,6,2,8,75.0%,14m
11211,3,Mørtebianca,3272,0,4,1,5,80.0%,5m
11211,3,mrcord,3272,0,4,1,5,80.0%,12m
11211,1,ZeroMarine,3272,48,4,3,7,57.1%,18m
11211,3,Cheeky,3272,118,4,8,12,33.3%,2m
11211,3,[ProRAT]Novec,3272,170,4,13,17,23.5%,4m
11211,3,[NNMM]NMSinse,3272,30,2,2,4,50.0%,5m
11211,1,Shnok,3272,0,1,0,1,100.0%,2m
11211,3,eXiso,3272,30,1,2,3,33.3%,5m
11211,3,[zer5]nwzxc,3272,30,1,2,3,33.3%,11m
11211,3,SPBlackFall,3272,30,1,4,5,20.0%,18m
11211,3,Jordi,3272,0,0,1,1,0.0%,5m
11211,3,Cyron,3272,0,0,1,1,0.0%,15m
11211,3,[AZGru]Андрюха,3272,0,0,2,2,0.0%,2m
11211,3,Kelevra,3272,0,0,2,2,0.0%,15m
11211,3,[PlzDaD]daddy,3272,0,0,4,4,0.0%,5m
11235,3,PAMis,3271,1605,125,125,250,50.0%,5m
11235,3,anbecha,3271,698,94,88,182,51.6%,11m
11235,3,[ziMMes]Kamikadze,3271,667,91,84,175,52.0%,19m
11235,3,Matrixar,3271,607,64,54,118,54.2%,17m
11235,3,[U19]TerranNuke,3271,293,52,34,86,60.5%,6m
11235,3,[RBlood]Galactus,3271,558,21,23,44,47.7%,8m
11235,3,zhimzhim,3271,381,16,9,25,64.0%,5m
11235,3,source,3271,478,16,23,39,41.0%,5m
11235,3,shailor,3271,339,14,12,26,53.8%,13m
11235,3,Lohikäärme,3271,350,11,24,35,31.4%,21m
11235,3,illumiNation,3271,190,7,15,22,31.8%,18m
11235,3,FlyingHorse,3271,62,3,5,8,37.5%,5m
11235,3,SapoGg,3271,30,2,1,3,66.7%,2m
11235,3,Mullemeck,3271,30,1,1,2,50.0%,6m
11235,3,Miwka,3271,97,1,2,3,33.3%,16m
11235,3,[ChXx]JakRam,3271,30,1,4,5,20.0%,5m
11235,3,Varandragon,3271,0,0,1,1,0.0%,5m
11235,3,NotYou,3271,0,0,2,2,0.0%,17m
11235,3,Cunctator,3271,0,0,10,10,0.0%,21m
11254,3,BEversmann,3270,1565,224,229,453,49.4%,9m
11254,3,Burundanga,3270,1568,197,174,371,53.1%,16m
11254,3,Jomaro,3270,1582,112,90,202,55.4%,2m
11254,2,[ASRLAP]LRSAD,3270,1125,58,62,120,48.3%,3m
11254,3,chacha,3270,364,42,34,76,55.3%,15m
11254,3,Fafalasi,3270,846,30,37,67,44.8%,19m
11254,3,[STASFR]Comic,3270,390,21,24,45,46.7%,4m
11254,3,[LofE]Asakura,3270,372,16,15,31,51.6%,3m
11254,3,Havane,3270,408,15,19,34,44.1%,2m
11254,3,Jethro,3270,316,11,21,32,34.4%,10m
11254,3,Lale,3270,206,7,4,11,63.6%,5m
11254,3,Relq,3270,120,6,3,9,66.7%,6m
11254,3,[Absynt]AspikBardamu,3270,86,4,3,7,57.1%,10m
11254,3,watchmespew,3270,118,4,6,10,40.0%,10m
11254,1,Sickangel,3270,97,2,3,5,40.0%,24m
11254,2,Jaspman,3270,0,1,0,1,100.0%,23m
11254,3,[Lewds]Despair,3270,0,0,1,1,0.0%,2m
11271,3,Арториас,3269,1587,172,162,334,51.5%,12m
11271,3,itta,3269,1360,112,97,209,53.6%,7m
11271,3,[k1raen]dRb,3269,1075,88,80,168,52.4%,21m
11271,3,VladTImpaler,3269,677,82,75,157,52.2%,2m
11271,3,SuedO,3269,1037,81,77,158,51.3%,12m
11271,3,PatMan,3269,942,63,61,124,50.8%,3m
11271,3,Mystic,3269,424,36,22,58,62.1%,2m
11271,3,Caveman,3269,821,33,25,58,56.9%,13m
11271,3,Reborn,3269,500,18,15,33,54.5%,19m
11271,3,[LoGiN]Amadeus,3269,432,18,20,38,47.4%,6m
11271,3,eQuIt,3269,560,18,31,49,36.7%,21m
11271,1,Brave,3269,235,14,11,25,56.0%,4m
11271,3,FLY,3269,246,11,6,17,64.7%,8m
11271,3,Aragorn,3269,210,8,16,24,33.3%,21m
11271,3,Moradagh,3269,210,7,1,8,87.5%,19m
11271,3,[Kompi]RailyCoo,3269,218,6,3,9,66.7%,17m
11271,3,magejiprotos,3269,60,4,2,6,66.7%,21m
11271,3,[DWF]Nightfighter,3269,0,1,0,1,100.0%,15m
11271,3,[TZCrew]Spiro,3269,0,1,4,5,20.0%,20m
11271,3,AHS,3269,0,0,1,1,0.0%,2m
11271,3,[zaebum]KillerGry,3269,0,0,1,1,0.0%,20m
11271,3,ChrzCTZ,3269,0,0,1,1,0.0%,6m
11293,3,MazGhul,3268,1504,213,202,415,51.3%,5m
11293,3,Cromwell,3268,1589,177,173,350,50.6%,17m
11293,3,PopoHauer,3268,1454,117,116,233,50.2%,6m
11293,3,pHantom,3268,1532,99,97,196,50.5%,21m
11293,3,[xNSax]Noire,3268,1418,64,51,115,55.7%,9m
11293,3,Serv,3268,1534,61,65,126,48.4%,14m
11293,3,Nikoxlas,3268,779,34,22,56,60.7%,15m
11293,3,GreeneryZerg,3268,837,32,33,65,49.2%,6m
11293,3,SuperBrojin,3268,645,31,27,58,53.4%,15m
11293,3,ChlupChrup,3268,461,22,22,44,50.0%,17m
11293,3,[BCON]Archon,3268,449,19,16,35,54.3%,3m
11293,1,Sugar,3268,301,13,11,24,54.2%,12m
11293,3,[IAO]ZelOx,3268,330,12,18,30,40.0%,14m
11293,3,Aldebalaran,3268,203,7,5,12,58.3%,12m
11293,3,superhero,3268,0,1,0,1,100.0%,20m
11293,3,TIToss,3268,0,1,0,1,100.0%,8m
11293,3,Masu,3268,0,0,4,4,0.0%,15m
11293,3,[Mealen]Archimonde,3268,0,0,7,7,0.0%,9m
11311,3,Yof,3267,1194,479,462,941,50.9%,5m
11311,3,[DMøøn]Sniper,3267,1263,238,215,453,52.5%,19m
11311,3,SultanOfWing,3267,1625,228,209,437,52.2%,3m
11311,3,cosmicbaby,3267,1562,120,123,243,49.4%,10m
11311,3,bakspace,3267,1309,62,59,121,51.2%,21m
11311,3,Tranduil,3267,822,55,55,110,50.0%,10m
11311,3,Morphosis,3267,1376,54,52,106,50.9%,2m
11311,3,Catch,3267,781,36,23,59,61.0%,7m
11311,3,itrofimow,3267,556,23,13,36,63.9%,5m
11311,3,Crafter,3267,498,22,16,38,57.9%,8m
11311,3,demANgel,3267,219,17,17,34,50.0%,12m
11311,2,AlcoMarine,3267,48,5,2,7,71.4%,23m
11311,2,Alex,3267,0,4,1,5,80.0%,53m
11311,3,Echnaton,3267,168,4,2,6,66.7%,2m
11311,3,Napalman,3267,30,2,6,8,25.0%,7m
11311,3,GoFyS,3267,0,1,0,1,100.0%,12m
11311,2,[Batia]Марик,3267,0,1,0,1,100.0%,19m
11311,3,peculiar,3267,0,1,0,1,100.0%,7m
11311,3,aZmodai,3267,30,1,1,2,50.0%,15m
11311,3,Yamico,3267,30,1,2,3,33.3%,15m
11311,3,thewatcha,3267,30,1,7,8,12.5%,10m
11311,3,[niice]FolEnto,3267,0,0,1,1,0.0%,3m
11311,3,[QTclub]Spook,3267,0,0,3,3,0.0%,20m
11334,3,[Mitya]adsumus,3266,1618,134,122,256,52.3%,16m
11334,3,IVO,3266,1478,93,82,175,53.1%,8m
11334,3,BarackPyjama,3266,768,71,76,147,48.3%,4m
11334,3,WinterSalt,3266,1231,64,41,105,61.0%,5m
11334,3,cienias,3266,1242,55,51,106,51.9%,19m
11334,3,Halet,3266,1010,42,33,75,56.0%,10m
11334,3,[LaPLS]Xénépix,3266,613,26,18,44,59.1%,14m
11334,3,last,3266,290,21,10,31,67.7%,14m
11334,3,BuDa,3266,377,16,11,27,59.3%,19m
11334,3,[iX]dreign,3266,314,14,9,23,60.9%,5m
11334,3,Cairon,3266,196,14,13,27,51.9%,17m
11334,3,[ŁATWO]Ubumsulwa,3266,346,12,6,18,66.7%,5m
11334,3,[SanFam]marcélou,3266,328,11,14,25,44.0%,16m
11334,3,Kosmatiy,3266,237,7,4,11,63.6%,10m
11334,3,Foreverone,3266,0,4,1,5,80.0%,15m
11334,3,[TSTG]RBking,3266,124,4,7,11,36.4%,15m
11334,3,Artist,3266,30,2,0,2,100.0%,5m
11334,3,[Listic]Oxid,3266,58,2,3,5,40.0%,9m
11334,3,RAVI,3266,0,1,0,1,100.0%,19m
11334,3,[R0D]ReAcT,3266,30,1,1,2,50.0%,21m
11334,3,[sworld]söderkisen,3266,30,1,2,3,33.3%,4m
11334,3,VinniThePooh,3266,30,1,2,3,33.3%,7m
11334,3,[isIMBA]Sinnaah,3266,0,0,1,1,0.0%,7m
11334,3,darkkiss,3266,0,0,1,1,0.0%,9m
11334,3,Syck,3266,0,0,1,1,0.0%,20m
11334,3,catray,3266,0,0,1,1,0.0%,10m
11334,3,HappyFox,3266,0,0,1,1,0.0%,11m
11334,3,IIIIIIIIIIII,3266,0,0,3,3,0.0%,2m
11362,2,KillYou,3265,1567,410,422,832,49.3%,18m
11362,2,Syndicate,3265,1603,316,325,641,49.3%,8m
11362,3,Rickmouth,3265,1562,112,122,234,47.9%,10m
11362,3,matmat,3265,1576,81,78,159,50.9%,5m
11362,3,[TAW]artnquest,3265,548,31,18,49,63.3%,6m
11362,3,Апкурыш,3265,172,6,6,12,50.0%,5m
11362,3,[ZERGML]Abaddon,3265,194,6,15,21,28.6%,18m
11362,3,[prxspr]Moriz,3265,150,5,9,14,35.7%,15m
11362,3,ivhen,3265,124,4,7,11,36.4%,10m
11362,3,NoLa,3265,58,3,1,4,75.0%,3m
11362,2,balantrea,3265,0,3,2,5,60.0%,22m
11362,3,MsWho,3265,0,3,2,5,60.0%,11m
11362,3,BoBo,3265,86,3,3,6,50.0%,6m
11362,3,graNite,3265,157,3,11,14,21.4%,11m
11362,3,YaaakoV,3265,30,2,4,6,33.3%,9m
11362,3,САМОГОНЬ,3265,0,1,0,1,100.0%,21m
11362,1,NOONE,3265,0,1,0,1,100.0%,51m
11362,3,Kagayaga,3265,0,1,0,1,100.0%,16m
11362,3,IIIRAZORIII,3265,30,1,2,3,33.3%,3m
11362,3,pepyk,3265,40,1,6,7,14.3%,4m
11362,3,[tsRTS]AllE,3265,0,0,1,1,0.0%,14m
11362,3,Cyonent,3265,0,0,2,2,0.0%,18m
11384,3,Rostik,3264,1563,105,104,209,50.2%,7m
11384,3,AyRa,3264,595,84,63,147,57.1%,2m
11384,3,DarkKnight,3264,1524,70,67,137,51.1%,7m
11384,3,Nik,3264,708,28,30,58,48.3%,14m
11384,3,[fumv]MrFister,3264,616,23,20,43,53.5%,20m
11384,3,ftwo,3264,414,21,21,42,50.0%,4m
11384,3,MiSix,3264,485,18,13,31,58.1%,7m
11384,3,Elfkin,3264,369,16,12,28,57.1%,7m
11384,3,Dippo,3264,366,15,7,22,68.2%,18m
11384,3,SandwichLord,3264,273,12,7,19,63.2%,10m
11384,3,KimJongKool,3264,229,10,6,16,62.5%,2m
11384,3,Lynch,3264,278,9,19,28,32.1%,20m
11384,3,[TgAg]MaxThePigeon,3264,120,5,3,8,62.5%,20m
11384,2,[VLDLOX]Bezbalkonnay,3264,0,4,1,5,80.0%,33m
11384,3,[ḾŞ7]Artur,3264,30,1,2,3,33.3%,6m
11384,1,Spark,3264,0,1,2,3,33.3%,41m
11384,3,wanted,3264,30,1,5,6,16.7%,15m
11384,3,kratos,3264,0,0,1,1,0.0%,5m
11384,3,[mfxed]MioFx,3264,0,0,1,1,0.0%,11m
11384,3,[2580]Raimas,3264,0,0,3,3,0.0%,16m
11404,3,[RaClan]Kargosh,3263,1538,268,263,531,50.5%,21m
11404,3,Vioteo,3263,1066,67,60,127,52.8%,7m
11404,3,[RoTSB]GoSuGL,3263,490,20,16,36,55.6%,5m
11404,3,llllllllllll,3263,524,20,20,40,50.0%,18m
11404,3,Faid,3263,428,15,19,34,44.1%,20m
11404,3,Sidneto,3263,458,15,22,37,40.5%,3m
11404,3,KENNI,3263,280,11,4,15,73.3%,4m
11404,3,Altrecomp,3263,64,9,10,19,47.4%,17m
11404,3,CountTossula,3263,58,6,4,10,60.0%,16m
11404,3,[EliteX]Kubaxin,3263,176,6,7,13,46.2%,5m
11404,3,SuperManer,3263,142,6,8,14,42.9%,20m
11404,3,Cephalon,3263,92,5,1,6,83.3%,2m
11404,3,llllllllllll,3263,30,5,2,7,71.4%,2m
11404,3,[DMaTB]BjarkeTHEman,3263,105,5,4,9,55.6%,5m
11404,3,[Донный]Elf,3263,0,1,1,2,50.0%,19m
11404,3,Adi,3263,95,1,2,3,33.3%,18m
11404,3,PoDpyGuN,3263,0,0,1,1,0.0%,20m
11404,3,[WBGA]danielzar,3263,0,0,1,1,0.0%,5m
11404,3,ChiZerg,3263,0,0,1,1,0.0%,16m
11404,3,Raynor,3263,0,0,2,2,0.0%,21m
11424,3,Zpeon,3262,1218,80,73,153,52.3%,3m
11424,3,Fireffin,3262,1156,68,54,122,55.7%,4m
11424,3,ParkSangYul,3262,930,33,36,69,47.8%,9m
11424,3,[AjA]Chaga,3262,644,24,25,49,49.0%,18m
11424,3,SouldreamXe,3262,316,21,10,31,67.7%,12m
11424,3,FusilàPompe,3262,483,21,17,38,55.3%,21m
11424,3,uAtakhan,3262,468,20,13,33,60.6%,12m
11424,3,Zilow,3262,512,20,23,43,46.5%,20m
11424,3,groar,3262,356,15,20,35,42.9%,12m
11424,3,EvilDevil,3262,305,15,25,40,37.5%,5m
11424,3,racistprobe,3262,248,10,8,18,55.6%,8m
11424,3,[lLiTl]Kenpachi,3262,238,8,8,16,50.0%,13m
11424,2,IanCurtis,3262,0,4,2,6,66.7%,9m
11424,3,[InFy]Crane,3262,102,4,13,17,23.5%,14m
11424,3,NinjaCookie,3262,30,2,1,3,66.7%,15m
11424,3,FettNooben,3262,36,2,3,5,40.0%,14m
11424,3,aaiun,3262,0,1,0,1,100.0%,11m
11424,3,[Koufar]Votkah,3262,0,1,0,1,100.0%,16m
11424,3,DarkSide,3262,0,1,0,1,100.0%,4m
11424,3,Magic,3262,0,0,1,1,0.0%,6m
11424,3,CYBERNINJA,3262,0,0,2,2,0.0%,4m
11424,3,Justman,3262,0,0,2,2,0.0%,15m
11424,3,Sobolinko,3262,0,0,5,5,0.0%,5m
11447,3,Novis,3261,1507,191,189,380,50.3%,2m
11447,3,Zoran,3261,1522,63,67,130,48.5%,4m
11447,3,[BPPS]MoltenPucki,3261,738,48,43,91,52.7%,6m
11447,3,NoMore,3261,676,45,43,88,51.1%,4m
11447,3,SirGhost,3261,1014,34,46,80,42.5%,14m
11447,3,[ØC]mIg,3261,780,30,31,61,49.2%,8m
11447,3,[PIDORZ]Mirr,3261,292,10,17,27,37.0%,20m
11447,3,RobBot,3261,163,8,14,22,36.4%,3m
11447,3,Kappaeu,3261,139,7,2,9,77.8%,15m
11447,3,[77L]Couscous,3261,117,6,2,8,75.0%,21m
11447,3,zmeNcHic,3261,144,6,4,10,60.0%,2m
11447,3,[0TaKe]DjOtZt,3261,180,6,11,17,35.3%,11m
11447,1,[RavenZ]TheRedX,3261,166,5,5,10,50.0%,22m
11447,3,[afk247]Marineplay,3261,88,4,1,5,80.0%,8m
11447,3,InFiNitiSC,3261,0,4,1,5,80.0%,17m
11447,2,wArCartoO,3261,0,4,1,5,80.0%,57m
11447,2,nexus,3261,0,4,1,5,80.0%,3m
11447,3,[PlAr]Shadowmeld,3261,120,4,9,13,30.8%,11m
11447,3,djbomba,3261,0,3,0,3,100.0%,11m
11447,3,Xenocide,3261,62,3,6,9,33.3%,3m
11447,3,[cLn]ReTrY,3261,94,2,4,6,33.3%,20m
11447,2,[Shelll]Shellshock,3261,0,2,4,6,33.3%,33m
11447,3,RunGen,3261,30,1,2,3,33.3%,9m
11447,3,carlosvzas,3261,2,1,5,6,16.7%,11m
11447,1,srac,3261,0,0,1,1,0.0%,10m
11447,3,harddrill,3261,0,0,2,2,0.0%,13m
11447,3,[QTclub]Leifur,3261,0,0,2,2,0.0%,9m
11474,3,waneksx,3260,1637,191,192,383,49.9%,10m
11474,3,add,3260,1564,143,145,288,49.7%,14m
11474,3,BazyLee,3260,1257,106,88,194,54.6%,19m
11474,3,æDaemon,3260,970,36,35,71,50.7%,3m
11474,3,Regnar,3260,312,13,9,22,59.1%,7m
11474,3,OldSchool,3260,239,12,3,15,80.0%,16m
11474,3,Flee,3260,199,11,18,29,37.9%,5m
11474,3,EstebanN,3260,245,9,4,13,69.2%,16m
11474,1,Mysterio,3260,213,7,5,12,58.3%,10m
11474,2,System,3260,142,6,2,8,75.0%,45m
11474,3,[MalD]Calandosse,3260,186,5,4,9,55.6%,3m
11474,3,[IndyK]Magiszonek,3260,118,5,4,9,55.6%,14m
11474,2,Hivemind,3260,0,4,1,5,80.0%,29m
11474,1,[ABRUTI]Max,3260,142,3,7,10,30.0%,6m
11474,3,Elendar,3260,30,2,1,3,66.7%,10m
11474,3,[GRNSKN]markstrom,3260,30,2,1,3,66.7%,10m
11474,2,[LZZS]TiBombe,3260,0,1,0,1,100.0%,5m
11474,3,Kempto,3260,30,1,2,3,33.3%,13m
11474,3,[WdPC]uzername,3260,30,1,4,5,20.0%,6m
11474,3,Klivi,3260,30,1,7,8,12.5%,13m
11474,3,Benis,3260,0,0,1,1,0.0%,11m
11474,3,Neodreamer,3260,0,0,1,1,0.0%,21m
11496,3,Zorrander,3259,696,395,372,767,51.5%,9m
11496,1,[Crafts]Merlin,3259,1415,77,112,189,40.7%,16m
11496,3,TerminaThor,3259,1565,69,67,136,50.7%,16m
11496,3,Ryder,3259,1379,59,62,121,48.8%,5m
11496,3,BrendMAN,3259,508,48,44,92,52.2%,6m
11496,3,Sikoli,3259,847,37,28,65,56.9%,17m
11496,3,[M12]Evolves,3259,276,14,16,30,46.7%,9m
11496,3,Ran,3259,354,13,15,28,46.4%,5m
11496,3,Windfuker,3259,322,12,11,23,52.2%,16m
11496,3,Bloodvalve,3259,238,10,7,17,58.8%,14m
11496,2,MrPuzichka,3259,251,8,3,11,72.7%,19m
11496,3,Owned,3259,148,6,5,11,54.5%,6m
11496,3,CuteOverload,3259,0,4,1,5,80.0%,4m
11496,3,RedTideoDawn,3259,30,4,9,13,30.8%,16m
11496,3,IIIIIIIIIIII,3259,60,3,3,6,50.0%,2m
11496,3,Kelpie,3259,0,1,0,1,100.0%,3m
11496,1,ZombieDwarf,3259,93,1,2,3,33.3%,5m
11496,3,[WBO]TentacleChad,3259,30,1,2,3,33.3%,15m
11496,3,lightsha,3259,0,0,1,1,0.0%,10m
11496,3,EroS,3259,0,0,1,1,0.0%,13m
11496,3,Lyde,3259,0,0,2,2,0.0%,12m
11517,3,dav,3258,1610,168,157,325,51.7%,6m
11517,2,seiken,3258,1335,96,107,203,47.3%,8m
11517,3,[USDDay]Visrix,3258,891,46,44,90,51.1%,2m
11517,3,DrakÅ,3258,575,25,14,39,64.1%,2m
11517,3,MadMarine,3258,530,20,28,48,41.7%,10m
11517,3,[BRSKR]Kuro,3258,265,19,15,34,55.9%,5m
11517,3,Creeping,3258,450,17,13,30,56.7%,22m
11517,3,[PL4NCK]courgette,3258,174,16,10,26,61.5%,5m
11517,3,[KDV]KerivePL,3258,414,16,17,33,48.5%,10m
11517,3,[oaommm]Nymfora,3258,408,16,18,34,47.1%,8m
11517,3,Mega,3258,293,14,8,22,63.6%,20m
11517,3,[CuMo]Bastri,3258,346,12,9,21,57.1%,11m
11517,1,Tear,3258,191,9,4,13,69.2%,15m
11517,3,IIIIIIII,3258,232,9,8,17,52.9%,13m
11517,3,[VETS]Sprat,3258,232,8,10,18,44.4%,17m
11517,3,Breeze,3258,178,7,5,12,58.3%,4m
11517,3,[1017z]CuddleBunny,3258,79,4,1,5,80.0%,6m
11517,3,[ZelO]Tiffany,3258,95,2,4,6,33.3%,13m
11517,3,Xoronn,3258,0,1,0,1,100.0%,13m
11517,3,Moridin,3258,0,1,3,4,25.0%,16m
11517,3,[Colic]Kronik,3258,0,0,1,1,0.0%,7m
11517,3,HappyPants,3258,0,0,1,1,0.0%,21m
11517,3,zwift,3258,0,0,1,1,0.0%,6m
11517,3,[INFTS]Nayjot,3258,0,0,5,5,0.0%,2m
11541,3,[D0L4N]morDuck,3257,1433,230,221,451,51.0%,3m
11541,2,SpaceRanger,3257,1500,214,207,421,50.8%,9m
11541,3,Rodżo,3257,1535,182,162,344,52.9%,6m
11541,2,Xizor,3257,1114,171,170,341,50.1%,18m
11541,3,vazz,3257,1405,112,106,218,51.4%,14m
11541,3,Cutie,3257,713,41,11,52,78.8%,18m
11541,3,Artanis,3257,490,24,13,37,64.9%,19m
11541,1,katsumoto,3257,140,7,3,10,70.0%,11m
11541,3,[AnD]Alpina,3257,170,6,6,12,50.0%,9m
11541,3,Proberto,3257,178,6,10,16,37.5%,10m
11541,3,[XQC]CovidTwenty,3257,162,5,0,5,100.0%,15m
11541,3,Blaze,3257,158,5,12,17,29.4%,17m
11541,3,[Kans]Умник,3257,118,4,9,13,30.8%,13m
11541,3,[DМG]nwave,3257,60,3,5,8,37.5%,7m
11541,3,[Сold]Raul,3257,94,3,7,10,30.0%,7m
11541,3,Taldarim,3257,30,2,0,2,100.0%,5m
11541,3,ImpuLse,3257,0,1,2,3,33.3%,5m
11558,3,FLENEX,3256,917,446,422,868,51.4%,5m
11558,3,Murgel,3256,1382,410,391,801,51.2%,8m
11558,3,baconpancake,3256,1342,222,204,426,52.1%,21m
11558,3,IDESOFMARCH,3256,1395,140,126,266,52.6%,8m
11558,3,BlobbyColoss,3256,890,79,63,142,55.6%,10m
11558,3,paraNoID,3256,590,22,23,45,48.9%,6m
11558,3,[N1TDA]erbol,3256,631,22,31,53,41.5%,5m
11558,3,aAa,3256,549,21,23,44,47.7%,12m
11558,3,Bobrakon,3256,500,18,22,40,45.0%,8m
11558,3,glhf,3256,498,18,24,42,42.9%,17m
11558,3,simpson,3256,246,10,7,17,58.8%,9m
11558,3,GrimmHeart,3256,198,7,6,13,53.8%,5m
11558,2,DEZEZ,3256,0,4,1,5,80.0%,33m
11558,3,[EMST]Foocs,3256,114,4,5,9,44.4%,5m
11558,3,BabaIQ,3256,114,4,7,11,36.4%,17m
11558,2,Huawei,3256,0,3,1,4,75.0%,2m
11558,3,Hidden,3256,58,3,3,6,50.0%,9m
11558,3,[127ORT]поездболи,3256,90,3,4,7,42.9%,14m
11558,3,Korpo,3256,58,2,2,4,50.0%,13m
11558,3,CaptainRARAA,3256,30,2,3,5,40.0%,5m
11558,3,Phyrokar,3256,30,2,9,11,18.2%,18m
11558,2,IIIIIIIIIIII,3256,0,1,0,1,100.0%,22m
11558,3,DevitcaZerg,3256,0,1,0,1,100.0%,22m
11558,3,Loki,3256,0,1,1,2,50.0%,21m
11558,3,[skh]time,3256,0,0,1,1,0.0%,20m
11558,2,[IcMoon]llllllllllll,3256,0,0,1,1,0.0%,19m
11584,3,iTERRAN,3255,1034,89,85,174,51.1%,13m
11584,3,SirReggae,3255,1312,78,67,145,53.8%,13m
11584,2,NumeroUno,3255,748,55,72,127,43.3%,19m
11584,3,pOtAto,3255,308,50,59,109,45.9%,9m
11584,3,[MWAF]Zryw,3255,440,48,36,84,57.1%,9m
11584,3,Robalian,3255,378,14,9,23,60.9%,3m
11584,3,izibanana,3255,243,9,7,16,56.2%,6m
11584,3,TwixHappy,3255,232,8,8,16,50.0%,2m
11584,1,High,3255,119,6,2,8,75.0%,24m
11584,3,[PUPSIK]IsifLife,3255,169,6,8,14,42.9%,16m
11584,3,[roph]sEBARu,3255,58,3,1,4,75.0%,5m
11584,3,Stalin,3255,58,3,1,4,75.0%,3m
11584,3,[НОД17]SuMmeR,3255,118,2,2,4,50.0%,13m
11584,3,[Notag]Protoss,3255,0,1,1,2,50.0%,18m
11584,3,[ZOC]Nanami,3255,0,1,4,5,20.0%,16m
11584,3,Rcvtheninja,3255,0,0,1,1,0.0%,3m
11584,3,[Hаsu]MEDVED,3255,0,0,1,1,0.0%,18m
11584,3,Mojo,3255,0,0,1,1,0.0%,10m
11584,3,Aimie,3255,0,0,1,1,0.0%,8m
11584,3,HappyEgg,3255,0,0,3,3,0.0%,5m
11604,3,Axiom,3254,1349,240,222,462,51.9%,18m
11604,3,[Heroes]Minas,3254,1568,153,137,290,52.8%,12m
11604,3,inoxia,3254,1106,147,133,280,52.5%,11m
11604,3,[Poutre]Zboub,3254,640,43,43,86,50.0%,10m
11604,2,Mentat,3254,1066,40,59,99,40.4%,5m
11604,3,Skogix,3254,648,28,14,42,66.7%,9m
11604,3,pLAiNsAnE,3254,318,18,18,36,50.0%,21m
11604,2,exnihilo,3254,522,16,33,49,32.7%,8m
11604,3,EasyKaTKa,3254,417,14,15,29,48.3%,4m
11604,3,HeiSeNBerg,3254,216,8,9,17,47.1%,3m
11604,3,Riggy,3254,190,7,10,17,41.2%,5m
11604,3,[WTFvck]syso,3254,146,6,4,10,60.0%,6m
11604,3,Minussix,3254,144,6,4,10,60.0%,3m
11604,3,javiorpas,3254,150,6,9,15,40.0%,20m
11604,3,IIIIIIIIIIII,3254,0,4,1,5,80.0%,2m
11604,3,[ERHELM]Tuffe,3254,167,4,5,9,44.4%,6m
11604,3,Nuyeo,3254,88,4,7,11,36.4%,5m
11604,3,DJAY,3254,100,3,7,10,30.0%,16m
11604,3,Shinev,3254,30,2,2,4,50.0%,4m
11604,3,[ISIC]STALIN,3254,58,2,3,5,40.0%,10m
11604,3,[Sativa]MikhailS,3254,30,1,1,2,50.0%,13m
11604,2,FoxWulf,3254,42,1,2,3,33.3%,20m
11604,2,Halbvier,3254,88,1,2,3,33.3%,9m
11604,3,Thommath,3254,0,0,1,1,0.0%,4m
11628,3,Kriptman,3253,1428,72,66,138,52.2%,5m
11628,3,Idicious,3253,1062,45,38,83,54.2%,16m
11628,3,[iEmp]layla,3253,514,30,23,53,56.6%,13m
11628,3,Cash,3253,394,15,14,29,51.7%,11m
11628,3,Kinnicoun,3253,350,12,12,24,50.0%,20m
11628,3,GénéralPaton,3253,260,8,6,14,57.1%,4m
11628,3,[DYE]clownfish,3253,215,6,6,12,50.0%,22m
11628,3,Cloud,3253,197,6,7,13,46.2%,3m
11628,1,[XF71]alien,3253,96,5,2,7,71.4%,3m
11628,3,[LGC]Shinobi,3253,124,5,8,13,38.5%,12m
11628,3,aztead,3253,88,4,5,9,44.4%,4m
11628,3,GurraXx,3253,90,3,6,9,33.3%,7m
11628,3,[S04Fan]Amadeus,3253,30,2,0,2,100.0%,5m
11628,3,[SEWP]Geser,3253,58,2,2,4,50.0%,15m
11628,3,Alpharius,3253,30,1,2,3,33.3%,11m
11628,3,Zaszz,3253,0,0,2,2,0.0%,8m
11628,3,DisasteR,3253,0,0,3,3,0.0%,11m
11645,3,Johannes,3252,1080,388,370,758,51.2%,12m
11645,3,elnitz,3252,1248,168,168,336,50.0%,5m
11645,3,Bitelchus,3252,1543,114,110,224,50.9%,17m
11645,3,Siomi,3252,452,21,16,37,56.8%,9m
11645,1,NoScared,3252,459,19,5,24,79.2%,7m
11645,3,Fett,3252,512,19,14,33,57.6%,21m
11645,3,john,3252,342,14,9,23,60.9%,18m
11645,3,Jonathas,3252,276,10,16,26,38.5%,10m
11645,3,Thunder,3252,168,7,6,13,53.8%,3m
11645,1,[Kluten]NaXprO,3252,184,5,1,6,83.3%,1h
11645,3,Odin,3252,0,4,1,5,80.0%,26m
11645,3,Quester,3252,86,4,2,6,66.7%,5m
11645,3,Naja,3252,30,2,0,2,100.0%,17m
11645,3,Edelhirsch,3252,30,2,1,3,66.7%,4m
11645,3,martonw,3252,30,2,6,8,25.0%,21m
11645,3,[xSABx]TheHunterZA,3252,0,1,0,1,100.0%,9m
11645,3,[GR0V]BobbyJoe,3252,30,1,4,5,20.0%,15m
11645,3,enegIZZEr,3252,0,0,1,1,0.0%,2m
11645,3,[1FU2]Kizzmaul,3252,0,0,2,2,0.0%,5m
11645,3,AlexRAI,3252,0,0,3,3,0.0%,16m
11645,3,JohnSmith,3252,0,0,5,5,0.0%,3m
11666,3,Albert,3251,1447,155,156,311,49.8%,20m
11666,3,Efire,3251,1602,115,106,221,52.0%,3m
11666,3,Bluf,3251,668,104,92,196,53.1%,13m
11666,2,AllThumbs,3251,730,33,38,71,46.5%,12m
11666,3,PeterSVK,3251,812,29,34,63,46.0%,19m
11666,3,Kwis,3251,668,27,33,60,45.0%,7m
11666,3,[loxi]Oroch,3251,521,22,14,36,61.1%,13m
11666,3,iiiiiiiiiiii,3251,258,10,11,21,47.6%,18m
11666,3,Lucky,3251,142,7,3,10,70.0%,16m
11666,3,[TvT]BaToN,3251,138,6,2,8,75.0%,9m
11666,3,Fire,3251,169,4,2,6,66.7%,12m
11666,3,sunkk,3251,124,4,10,14,28.6%,5m
11666,2,badass,3251,95,3,2,5,60.0%,41m
11666,3,[КПCC]BrutaliskFan,3251,86,3,3,6,50.0%,3m
11666,3,Lad,3251,30,2,1,3,66.7%,9m
11666,3,Samusin,3251,58,2,3,5,40.0%,10m
11666,3,HeteroHero,3251,121,2,5,7,28.6%,20m
11666,3,Conguer,3251,0,1,0,1,100.0%,19m
11666,1,[RT9]Protesian,3251,0,0,1,1,0.0%,47m
11666,3,[Dobro]Фортунато,3251,0,0,1,1,0.0%,3m
11666,3,Punny,3251,0,0,3,3,0.0%,7m
11687,3,Kredo,3250,742,175,174,349,50.1%,20m
11687,3,ZeonIX,3250,1592,98,111,209,46.9%,7m
11687,3,Raack,3250,1427,72,76,148,48.6%,7m
11687,3,[Immota]Frontleiche,3250,878,54,46,100,54.0%,7m
11687,3,[BCNE]MadMike,3250,999,46,30,76,60.5%,18m
11687,3,[RFL]Fluo,3250,614,27,28,55,49.1%,5m
11687,3,amian,3250,253,17,10,27,63.0%,15m
11687,3,Strider,3250,363,15,7,22,68.2%,6m
11687,3,[BOLDO]Boldo,3250,345,15,12,27,55.6%,20m
11687,3,[Turb0o]kLaTscHe,3250,220,10,7,17,58.8%,4m
11687,3,smoukluker,3250,262,10,8,18,55.6%,6m
11687,3,ImrdE,3250,256,9,8,17,52.9%,5m
11687,3,[C18]Namenlos,3250,186,7,10,17,41.2%,5m
11687,3,NyanCat,3250,60,3,3,6,50.0%,9m
11687,3,shadow,3250,94,2,4,6,33.3%,5m
11687,3,Violet,3250,0,1,3,4,25.0%,4m
11687,3,oOC,3250,30,1,7,8,12.5%,10m
11687,3,[QTcIub]Karatekid,3250,0,0,1,1,0.0%,15m
11705,3,wichy,3249,1567,224,188,412,54.4%,6m
11705,2,[НТТ]Nishihi,3249,1489,186,185,371,50.1%,15m
11705,3,[JaPP]Perchik,3249,1467,177,145,322,55.0%,9m
11705,3,Osariys,3249,1208,46,50,96,47.9%,4m
11705,3,[WАSD]fyrgood,3249,823,33,37,70,47.1%,5m
11705,3,AsYouWish,3249,381,14,8,22,63.6%,2m
11705,3,edea,3249,402,14,17,31,45.2%,12m
11705,3,Tatara,3249,202,8,7,15,53.3%,3m
11705,3,Rixxon,3249,201,7,1,8,87.5%,2m
11705,3,Byga,3249,202,7,10,17,41.2%,16m
11705,3,EGStephanoRC,3249,166,6,5,11,54.5%,14m
11705,3,[sNu5]Norgus,3249,158,6,10,16,37.5%,5m
11705,3,iceface,3249,189,5,3,8,62.5%,5m
11705,3,[PDRFCE]Mephisto,3249,30,2,1,3,66.7%,17m
11705,3,harbinger,3249,0,2,3,5,40.0%,11m
11705,3,[WNTR]Hydrogenium,3249,126,2,6,8,25.0%,15m
11705,3,Curtisio,3249,0,1,0,1,100.0%,16m
11722,3,nika,3248,1613,182,143,325,56.0%,2m
11722,3,Captain,3248,1158,46,44,90,51.1%,20m
11722,3,[I6s]Rob,3248,593,28,20,48,58.3%,14m
11722,3,[aW]xion,3248,662,25,20,45,55.6%,3m
11722,3,smc,3248,602,24,16,40,60.0%,9m
11722,3,[Ximic]Mitrofan,3248,486,18,17,35,51.4%,5m
11722,3,zergV,3248,526,18,31,49,36.7%,20m
11722,3,[H2OKT]Hydroïde,3248,464,17,20,37,45.9%,19m
11722,3,[RToTD]Chirk,3248,378,15,17,32,46.9%,15m
11722,3,Orphelin,3248,95,14,13,27,51.9%,10m
11722,3,[laugh]Bakewka,3248,308,11,11,22,50.0%,14m
11722,3,spawn,3248,199,8,10,18,44.4%,7m
11722,3,Crusher,3248,125,5,3,8,62.5%,5m
11722,3,xzc,3248,144,4,1,5,80.0%,8m
11722,3,TheTrueMans,3248,0,4,1,5,80.0%,2m
11722,3,Crewly,3248,86,3,5,8,37.5%,8m
11722,3,[ABRX]twistednose,3248,30,2,0,2,100.0%,3m
11722,1,ZeratuL,3248,97,2,1,3,66.7%,8m
11722,3,[SUKL]ReaperFire,3248,60,2,2,4,50.0%,4m
11722,3,theIMP,3248,0,2,3,5,40.0%,2m
11722,3,jowl,3248,58,2,5,7,28.6%,8m
11722,3,FridayInFire,3248,30,2,5,7,28.6%,9m
11722,3,excalibur,3248,62,2,13,15,13.3%,4m
11722,3,[eXGE]cabris,3248,30,1,1,2,50.0%,5m
11722,3,Blondie,3248,30,1,5,6,16.7%,3m
11722,2,[PNZ]Plague,3248,0,0,1,1,0.0%,31m
11722,3,EpicSchinken,3248,0,0,1,1,0.0%,5m
11722,3,Hurz,3248,0,0,1,1,0.0%,20m
11722,3,PHX,3248,0,0,3,3,0.0%,2m
11722,3,Shjno,3248,0,0,3,3,0.0%,16m
11752,3,jokerSG,3247,1382,417,396,813,51.3%,5m
11752,3,[GCorps]Alltracks,3247,1199,86,67,153,56.2%,14m
11752,3,СНЕГОВИК,3247,1493,80,41,121,66.1%,8m
11752,3,Langfinger,3247,1418,61,60,121,50.4%,9m
11752,3,ololo,3247,1094,48,33,81,59.3%,20m
11752,3,SaTeLLiZe,3247,1110,40,46,86,46.5%,16m
11752,3,InSidE,3247,688,32,26,58,55.2%,9m
11752,3,[loli69]Shadr,3247,692,24,36,60,40.0%,16m
11752,3,Madlisc,3247,442,17,14,31,54.8%,3m
11752,3,MonkeyDDrago,3247,354,12,16,28,42.9%,21m
11752,3,[RaR]Garthealis,3247,162,9,3,12,75.0%,5m
11752,3,diadon,3247,237,8,3,11,72.7%,20m
11752,1,[SWN]Erébus,3247,139,4,0,4,100.0%,12m
11752,3,[Kh4os]Shurath,3247,86,3,2,5,60.0%,5m
11752,3,[SoothK]Kurt,3247,30,2,0,2,100.0%,19m
11752,3,[dEbE]LilStats,3247,30,2,1,3,66.7%,7m
11752,3,Narde,3247,60,2,4,6,33.3%,5m
11752,3,LoBBa,3247,0,0,1,1,0.0%,6m
11752,3,SANDU,3247,0,0,2,2,0.0%,10m
11771,3,fearless,3246,1455,196,199,395,49.6%,18m
11771,3,[TRMNT]Dave,3246,676,85,83,168,50.6%,3m
11771,3,doud,3246,752,71,68,139,51.1%,6m
11771,3,Xanton,3246,877,48,41,89,53.9%,14m
11771,3,Ulfsaar,3246,686,48,60,108,44.4%,22m
11771,3,QuantumBorne,3246,462,37,29,66,56.1%,19m
11771,2,eGoSlim,3246,335,14,7,21,66.7%,6m
11771,3,[NOW]Colt,3246,246,10,8,18,55.6%,7m
11771,3,[BRSKR]mmcalum,3246,266,9,15,24,37.5%,2m
11771,3,IAmTheSwarm,3246,196,8,7,15,53.3%,9m
11771,3,[FrSlip]Pangolin,3246,248,8,12,20,40.0%,10m
11771,3,Dante,3246,210,8,14,22,36.4%,18m
11771,3,BlackBadge,3246,170,7,6,13,53.8%,8m
11771,3,Tartusi,3246,196,7,14,21,33.3%,19m
11771,3,[CSQ]ChEEsusLikE,3246,127,6,4,10,60.0%,22m
11771,3,Optimus,3246,30,6,4,10,60.0%,16m
11771,3,Melancholy,3246,170,6,18,24,25.0%,12m
11771,3,RahGen,3246,148,5,5,10,50.0%,8m
11771,3,MCsmokey,3246,0,4,1,5,80.0%,18m
11771,3,Nygma,3246,0,4,1,5,80.0%,3m
11771,3,[KTK]Dino,3246,30,2,0,2,100.0%,5m
11771,3,Vacys,3246,30,2,5,7,28.6%,12m
11771,3,[MeyWar]ChriZ,3246,30,1,5,6,16.7%,2m
11771,2,Metanoia,3246,0,0,1,1,0.0%,1h
11795,3,[смер]micu,3245,1533,313,313,626,50.0%,11m
11795,2,wroth,3245,1554,302,311,613,49.3%,11m
11795,3,Baxter,3245,832,89,80,169,52.7%,8m
11795,3,Sauron,3245,1143,62,55,117,53.0%,7m
11795,3,killerbunny,3245,504,48,50,98,49.0%,22m
11795,3,ZergTheOne,3245,859,34,30,64,53.1%,6m
11795,3,Dezaxe,3245,650,25,21,46,54.3%,9m
11795,3,Arcsinger,3245,422,17,9,26,65.4%,5m
11795,3,Letroubado,3245,285,12,8,20,60.0%,20m
11795,3,unicorn,3245,348,12,15,27,44.4%,14m
11795,3,Pas,3245,183,9,5,14,64.3%,20m
11795,3,[PEE]Megusta,3245,260,9,11,20,45.0%,9m
11795,3,badpsy,3245,242,9,12,21,42.9%,9m
11795,3,[Hаsu]OZZY,3245,198,8,6,14,57.1%,9m
11795,3,[Borjos]drmaligno,3245,123,6,2,8,75.0%,4m
11795,3,[FoBro]Kaito,3245,187,6,3,9,66.7%,17m
11795,3,Weep,3245,60,2,3,5,40.0%,18m
11795,3,Hectorion,3245,0,1,0,1,100.0%,12m
11795,3,Eroune,3245,30,1,2,3,33.3%,3m
11795,3,АлкоСпорт,3245,0,1,5,6,16.7%,15m
11795,3,DroitWar,3245,0,0,1,1,0.0%,12m
11795,2,Frodefrodig,3245,0,0,1,1,0.0%,13m
11795,3,Hendrik,3245,0,0,1,1,0.0%,11m
11795,3,kuromukuro,3245,0,0,1,1,0.0%,6m
11795,3,[IEM21]Clemwillwin,3245,0,0,1,1,0.0%,2m
11795,3,Necra,3245,0,0,2,2,0.0%,18m
11795,3,fenix,3245,0,0,3,3,0.0%,13m
11822,3,[aW]SincE,3244,1590,831,804,1635,50.8%,13m
11822,3,Wel,3244,1593,195,191,386,50.5%,5m
11822,3,[xFRSx]coldjob,3244,927,120,123,243,49.4%,21m
11822,3,SleepyJoe,3244,855,98,89,187,52.4%,4m
11822,2,[VuV]DJDeepT,3244,1540,70,82,152,46.1%,12m
11822,3,[ImbaNB]EvoLution,3244,1035,49,36,85,57.6%,4m
11822,3,[WANG]Solstafir,3244,664,22,32,54,40.7%,10m
11822,3,[GGang]Spiggen,3244,377,19,12,31,61.3%,18m
11822,3,Dagon,3244,187,17,21,38,44.7%,12m
11822,3,Ojemine,3244,258,15,24,39,38.5%,6m
11822,3,Cashier,3244,328,12,15,27,44.4%,10m
11822,3,StonX,3244,230,9,3,12,75.0%,6m
11822,3,IlIlIlIlIlI,3244,146,9,5,14,64.3%,9m
11822,3,Exb,3244,262,9,13,22,40.9%,15m
11822,3,XTravius,3244,183,8,2,10,80.0%,4m
11822,3,MOONJAEIN,3244,92,5,1,6,83.3%,2m
11822,3,IIIIIIIIIIII,3244,143,4,1,5,80.0%,8m
11822,3,Symmetryfy,3244,0,3,2,5,60.0%,16m
11822,3,Spyro,3244,30,2,0,2,100.0%,10m
11822,3,[Drachw]Seburzal,3244,30,2,2,4,50.0%,15m
11822,3,[DF5]BudSpenzer,3244,30,2,3,5,40.0%,10m
11822,3,GuardianApe,3244,0,2,3,5,40.0%,20m
11822,3,[voff]FoxNews,3244,62,2,7,9,22.2%,12m
11822,1,Shaked,3244,0,1,0,1,100.0%,11m
11822,3,BuildsRoachs,3244,0,1,1,2,50.0%,20m
11822,3,[bugPP]SMURFIN,3244,0,1,1,2,50.0%,5m
11822,3,LetsDance,3244,30,1,2,3,33.3%,5m
11822,3,[LeCeVe]Scotched,3244,30,1,4,5,20.0%,19m
11822,3,[F6]Imperator,3244,30,1,6,7,14.3%,4m
11822,2,[PrStar]Illogic,3244,0,1,7,8,12.5%,20m
11822,3,Disery,3244,0,0,1,1,0.0%,2m
11822,3,[Cboo]Darkspine,3244,0,0,1,1,0.0%,3m
11822,3,burak,3244,0,0,1,1,0.0%,11m
11822,3,FrittenPaul,3244,0,0,2,2,0.0%,11m
11822,3,Luke,3244,0,0,3,3,0.0%,5m
11822,3,пожужжим,3244,0,0,4,4,0.0%,17m
11858,3,zzz,3243,1553,167,166,333,50.2%,22m
11858,3,hackbraten,3243,1274,151,143,294,51.4%,14m
11858,2,koma,3243,1331,47,64,111,42.3%,5m
11858,3,[Funky]ErisHope,3243,1020,46,28,74,62.2%,4m
11858,3,sAviOr,3243,885,43,25,68,63.2%,5m
11858,3,Shulu,3243,288,14,10,24,58.3%,13m
11858,3,Longbow,3243,265,10,4,14,71.4%,15m
11858,1,IKY,3243,166,7,3,10,70.0%,26m
11858,3,[3DE]evoLG,3243,169,5,2,7,71.4%,18m
11858,3,Kortex,3243,0,4,1,5,80.0%,1h
11858,3,Laziale,3243,0,3,2,5,60.0%,14m
11858,3,[OmDi]ALShep,3243,0,1,1,2,50.0%,16m
11858,3,[TRaven]RedChro,3243,0,0,1,1,0.0%,20m
11871,2,SirSniffAlot,3242,1543,143,148,291,49.1%,18m
11871,3,Psycho,3242,1549,138,140,278,49.6%,4m
11871,3,Killerkueken,3242,1531,79,78,157,50.3%,18m
11871,3,МøŋśŧR,3242,364,58,41,99,58.6%,13m
11871,3,Niko,3242,1193,46,43,89,51.7%,5m
11871,3,TazMan,3242,373,32,35,67,47.8%,10m
11871,3,[Arrows]GOLDY,3242,594,27,13,40,67.5%,3m
11871,3,Xiigo,3242,300,27,27,54,50.0%,14m
11871,3,[MecGR]Tartens,3242,524,19,18,37,51.4%,14m
11871,3,Azzurri,3242,404,16,13,29,55.2%,5m
11871,3,[TLGC]NoobRekter,3242,316,12,4,16,75.0%,9m
11871,3,Sheyenne,3242,296,11,11,22,50.0%,17m
11871,3,Sky,3242,200,9,8,17,52.9%,16m
11871,3,DrunkMeister,3242,240,8,3,11,72.7%,7m
11871,3,Hachiman,3242,150,5,10,15,33.3%,21m
11871,3,Westman,3242,0,4,1,5,80.0%,19m
11871,3,Khris,3242,120,4,6,10,40.0%,11m
11871,3,[MMTeam]Morgoth,3242,92,4,7,11,36.4%,4m
11871,2,tryHard,3242,0,1,0,1,100.0%,8m
11871,3,WhiZerg,3242,0,0,2,2,0.0%,9m
11871,3,AreYou,3242,0,0,6,6,0.0%,8m
11892,3,Rage,3241,1089,87,96,183,47.5%,18m
11892,3,Leeha,3241,582,73,64,137,53.3%,13m
11892,3,Milky,3241,830,36,24,60,60.0%,16m
11892,3,[TlGd]golock,3241,1006,36,43,79,45.6%,6m
11892,3,Sothoth,3241,916,35,36,71,49.3%,18m
11892,3,[ORLY]Herpederb,3241,495,30,22,52,57.7%,3m
11892,3,VOLKODAV,3241,637,27,24,51,52.9%,5m
11892,3,[RIPNA]riperino,3241,365,20,5,25,80.0%,2m
11892,3,kurica,3241,514,20,17,37,54.1%,15m
11892,3,GothicWave,3241,264,10,11,21,47.6%,14m
11892,3,Truper,3241,151,9,2,11,81.8%,3m
11892,3,ExarKuhn,3241,190,6,2,8,75.0%,19m
11892,3,yukoSefZ,3241,118,3,1,4,75.0%,2m
11892,3,Vitaal,3241,90,3,3,6,50.0%,8m
11892,1,Bomber,3241,95,2,0,2,100.0%,4m
11892,3,Jebediah,3241,0,1,0,1,100.0%,20m
11892,3,Мерсо,3241,30,1,3,4,25.0%,5m
11892,3,meryon,3241,30,1,4,5,20.0%,17m
11892,3,EYAEL,3241,0,0,1,1,0.0%,13m
11892,3,vBellae,3241,0,0,1,1,0.0%,21m
11892,3,[a14]SouPiC,3241,0,0,2,2,0.0%,16m
11892,3,nvq,3241,0,0,3,3,0.0%,5m
11914,3,[T4E]methical,3240,1288,223,216,439,50.8%,9m
11914,3,Dorn,3240,1575,164,159,323,50.8%,3m
11914,3,Program,3240,1416,114,106,220,51.8%,5m
11914,3,ParisHilton,3240,1534,94,107,201,46.8%,10m
11914,3,Alkor,3240,1614,93,80,173,53.8%,21m
11914,3,[Top8]Madengang,3240,534,20,25,45,44.4%,5m
11914,3,Coffeeman,3240,453,19,9,28,67.9%,12m
11914,3,mjood,3240,478,19,18,37,51.4%,19m
11914,3,AntonKarton,3240,382,15,16,31,48.4%,15m
11914,3,Sayer,3240,418,15,21,36,41.7%,7m
11914,3,[5QI]Ninotter,3240,143,14,17,31,45.2%,16m
11914,3,Lazy,3240,236,8,14,22,36.4%,15m
11914,3,AmILex,3240,88,3,14,17,17.6%,6m
11914,3,protoMolecul,3240,30,2,3,5,40.0%,21m
11914,3,Coiless,3240,64,2,12,14,14.3%,3m
11914,3,XDDDDDDDDDDD,3240,0,1,0,1,100.0%,6m
11914,3,[GPO]Nigel,3240,0,1,2,3,33.3%,11m
11914,1,InSoLenT,3240,48,1,5,6,16.7%,2m
11914,3,STROBOLIGHTS,3240,30,1,6,7,14.3%,21m
11914,3,Getin,3240,0,0,1,1,0.0%,18m
11914,3,Yxel,3240,0,0,1,1,0.0%,15m
11914,3,FieldNuge,3240,0,0,1,1,0.0%,9m
11936,3,[CUBITA]ZEUS,3239,965,129,113,242,53.3%,21m
11936,3,Trafalgar,3239,1072,111,105,216,51.4%,15m
11936,3,Сухой,3239,1494,63,47,110,57.3%,19m
11936,3,[ANO]Anonym,3239,1182,59,57,116,50.9%,22m
11936,3,ROA,3239,1376,56,53,109,51.4%,11m
11936,3,Pistvakt,3239,1014,39,45,84,46.4%,8m
11936,3,Edge,3239,557,38,24,62,61.3%,18m
11936,3,Gwen,3239,343,38,32,70,54.3%,10m
11936,3,Glitch,3239,651,33,23,56,58.9%,11m
11936,3,[Zeggg]flindpark,3239,884,32,36,68,47.1%,10m
11936,3,[GOCCM]IIIIIIIIIIII,3239,573,25,13,38,65.8%,6m
11936,3,[EBLOB]ddkedr,3239,626,23,30,53,43.4%,18m
11936,3,OneNatural,3239,502,21,15,36,58.3%,20m
11936,3,Freelance,3239,444,20,12,32,62.5%,14m
11936,3,[0xFF]Soss,3239,428,17,11,28,60.7%,9m
11936,3,Stasis,3239,416,17,12,29,58.6%,10m
11936,3,[пепегa]пепега,3239,269,10,6,16,62.5%,6m
11936,3,susu,3239,0,4,1,5,80.0%,14m
11936,3,Guigou,3239,0,4,1,5,80.0%,13m
11936,3,llllllllllll,3239,0,4,1,5,80.0%,2m
11936,1,Englin,3239,121,3,4,7,42.9%,20m
11936,3,Zinger,3239,96,2,0,2,100.0%,6m
11936,3,FinderSL,3239,58,2,1,3,66.7%,5m
11936,2,[KPot]wizmer,3239,46,2,1,3,66.7%,54m
11936,3,kumiho,3239,60,2,3,5,40.0%,6m
11936,3,Harald,3239,0,1,0,1,100.0%,21m
11936,3,Asand,3239,0,1,0,1,100.0%,7m
11936,3,AndY,3239,0,1,0,1,100.0%,12m
11936,3,IHateMyself,3239,30,1,1,2,50.0%,5m
11936,3,SvenskBlatte,3239,0,1,1,2,50.0%,9m
11936,3,skinnyman,3239,30,1,2,3,33.3%,14m
11936,3,Ranafein,3239,0,0,1,1,0.0%,12m
11936,3,[nGsǂ]nGsDanny,3239,0,0,1,1,0.0%,4m
11936,3,ItsBehindYou,3239,0,0,1,1,0.0%,17m
11936,3,Lightbearer,3239,0,0,2,2,0.0%,9m
11936,1,Makc,3239,0,0,4,4,0.0%,47m
11972,3,idd,3238,1570,177,174,351,50.4%,12m
11972,3,TuPoReZ,3238,1008,165,163,328,50.3%,16m
11972,3,Walhy,3238,1451,138,125,263,52.5%,11m
11972,3,[SPAINs]madara,3238,1561,137,108,245,55.9%,13m
11972,3,YouTubTigron,3238,1311,104,95,199,52.3%,2m
11972,3,Alchemist,3238,697,79,67,146,54.1%,8m
11972,3,[MicroK]turbocat,3238,1516,60,73,133,45.1%,8m
11972,3,FoxTrot,3238,1100,47,35,82,57.3%,10m
11972,2,Bluesman,3238,297,33,43,76,43.4%,13m
11972,3,RageQuitFTW,3238,526,23,19,42,54.8%,4m
11972,3,[Petrus]Georg,3238,463,17,13,30,56.7%,4m
11972,3,Dop,3238,387,15,11,26,57.7%,21m
11972,3,[Deezer]SpK,3238,281,9,7,16,56.2%,11m
11972,3,DanielSan,3238,233,9,12,21,42.9%,16m
11972,3,IIIIIIIIIIII,3238,151,4,2,6,66.7%,14m
11972,3,Liss,3238,122,4,9,13,30.8%,12m
11972,3,[TTIS]Xamos,3238,0,1,0,1,100.0%,10m
11972,3,ShakerGER,3238,0,1,1,2,50.0%,20m
11972,3,Tudor,3238,30,1,2,3,33.3%,12m
11972,3,slothdemon,3238,0,1,2,3,33.3%,7m
11972,3,[TBZVT]ruseh,3238,30,1,2,3,33.3%,18m
11972,3,HCGSA,3238,0,0,1,1,0.0%,18m
11972,3,vasabi,3238,0,0,1,1,0.0%,6m
11972,3,TapoCHECK,3238,0,0,4,4,0.0%,16m
11972,3,oskarm,3238,0,0,5,5,0.0%,8m
11997,3,SynTax,3237,424,78,52,130,60.0%,9m
11997,3,cnion,3237,1191,49,46,95,51.6%,6m
11997,3,SiberiaS,3237,1132,48,43,91,52.7%,3m
11997,3,IOWA,3237,661,43,32,75,57.3%,19m
11997,2,Shy,3237,1010,35,54,89,39.3%,19m
11997,3,[MMoF]Jeffe,3237,273,27,30,57,47.4%,4m
11997,3,zZzz,3237,475,23,11,34,67.6%,12m
11997,3,IIIIIIIIIIII,3237,305,13,10,23,56.5%,5m
11997,3,Vyi,3237,212,9,4,13,69.2%,7m
11997,3,rinGO,3237,195,8,4,12,66.7%,14m
11997,3,IIIOmegaIII,3237,218,8,9,17,47.1%,16m
11997,3,TTVLeTrac,3237,125,7,1,8,87.5%,5m
11997,3,[НС]GhoulSSSrank,3237,150,6,6,12,50.0%,10m
11997,3,Kirik,3237,0,5,0,5,100.0%,20m
11997,3,PloP,3237,0,4,1,5,80.0%,41m
11997,3,Wicked,3237,0,4,1,5,80.0%,4m
11997,3,KFanatic,3237,88,4,5,9,44.4%,16m
11997,3,Retroxxar,3237,86,4,6,10,40.0%,16m
11997,3,[nElf]Kacil,3237,88,4,7,11,36.4%,10m
11997,3,Nellie,3237,58,3,1,4,75.0%,6m
11997,3,DamnMad,3237,58,3,2,5,60.0%,8m
11997,3,[EGJD]LCW,3237,30,2,4,6,33.3%,12m
11997,3,[o1l]CastorTroy,3237,30,1,2,3,33.3%,3m
11997,1,UtterN,3237,0,1,7,8,12.5%,25m
11997,3,NinjaChicken,3237,0,0,1,1,0.0%,21m
11997,3,djrvywfbjr,3237,0,0,1,1,0.0%,5m
11997,3,Schneeble,3237,0,0,1,1,0.0%,8m
11997,3,Печенька,3237,0,0,2,2,0.0%,9m
11997,3,bNd,3237,0,0,3,3,0.0%,4m
12026,3,strichOr,3236,1577,227,193,420,54.0%,3m
12026,2,[IceHus]Asargin,3236,1477,58,71,129,45.0%,11m
12026,3,stoltz,3236,818,33,32,65,50.8%,12m
12026,3,WishIWasGood,3236,541,22,11,33,66.7%,7m
12026,3,Jimmy,3236,429,19,10,29,65.5%,7m
12026,3,[Ǽ1]OttoSpritz,3236,340,15,10,25,60.0%,18m
12026,3,[RvlD]Pramuk,3236,381,13,10,23,56.5%,5m
12026,3,[AiRǂ]GUA,3236,328,12,14,26,46.2%,5m
12026,3,NikraL,3236,308,11,14,25,44.0%,12m
12026,3,SOlar,3236,172,8,4,12,66.7%,21m
12026,3,[xTQc]Two,3236,179,6,2,8,75.0%,4m
12026,3,[BVRK]Zembawa,3236,152,5,7,12,41.7%,9m
12026,3,[DzQ]BadCode,3236,122,4,0,4,100.0%,5m
12026,3,KillerCourse,3236,167,4,3,7,57.1%,5m
12026,3,[IPARTY]RageKit,3236,138,4,7,11,36.4%,7m
12026,1,ymineycraft,3236,122,3,2,5,60.0%,2m
12026,3,[MnGSC2]Kerlag,3236,62,3,3,6,50.0%,3m
12026,3,[0VI]Spike,3236,62,3,5,8,37.5%,6m
12026,3,Zkelia,3236,30,2,6,8,25.0%,4m
12026,3,Russell,3236,0,1,0,1,100.0%,8m
12026,3,IIIIIIIIIIII,3236,0,1,1,2,50.0%,14m
12026,3,[CIMICE]AZOG,3236,0,1,2,3,33.3%,16m
12026,3,[KAOTx]WhoseThat,3236,30,1,7,8,12.5%,17m
12026,3,Rumpsteak,3236,0,0,1,1,0.0%,6m
12026,3,Grogu,3236,0,0,1,1,0.0%,17m
12026,3,namaste,3236,0,0,1,1,0.0%,17m
12052,3,[Sarmat]Suhinho,3235,1331,285,277,562,50.7%,21m
12052,3,poissonjl,3235,1543,253,252,505,50.1%,12m
12052,3,fwe,3235,1575,185,192,377,49.1%,10m
12052,3,досталНИДУС,3235,1093,53,44,97,54.6%,3m
12052,3,Fibonacci,3235,1121,47,35,82,57.3%,11m
12052,3,zanca,3235,795,41,35,76,53.9%,4m
12052,3,YoshiYo,3235,334,16,9,25,64.0%,6m
12052,3,[PiGPan]Zhargon,3235,430,14,19,33,42.4%,9m
12052,3,Nfjord,3235,212,13,10,23,56.5%,4m
12052,3,FourmiCrowd,3235,249,12,6,18,66.7%,3m
12052,3,Chaos,3235,200,7,2,9,77.8%,13m
12052,3,Lubert,3235,234,7,13,20,35.0%,7m
12052,3,rorozoro,3235,107,5,2,7,71.4%,5m
12052,3,Emily,3235,169,5,2,7,71.4%,15m
12052,3,Cloudy,3235,144,5,7,12,41.7%,2m
12052,3,BigMis,3235,86,4,3,7,57.1%,3m
12052,3,GKMukla,3235,0,3,2,5,60.0%,31m
12052,3,TooLazy,3235,60,3,5,8,37.5%,20m
12052,3,[Moisty]Latah,3235,30,2,0,2,100.0%,6m
12052,3,lENarrd,3235,30,2,1,3,66.7%,3m
12052,3,[HBGSJR]HackErIsTop,3235,58,2,2,4,50.0%,9m
12052,3,xan,3235,58,2,2,4,50.0%,3m
12052,3,ZERGUSHATINA,3235,62,2,4,6,33.3%,8m
12052,2,JOwar,3235,0,1,0,1,100.0%,4m
12052,3,[sonic1]Ezik,3235,0,1,0,1,100.0%,11m
12052,3,Апельсин,3235,18,1,7,8,12.5%,5m
12052,3,kreker,3235,0,0,1,1,0.0%,20m
12079,3,QuickBen,3234,1579,230,218,448,51.3%,20m
12079,3,[aDGa]Fabian,3234,1579,147,125,272,54.0%,6m
12079,2,[InBri]MoonWalker,3234,716,47,54,101,46.5%,8m
12079,3,neiron,3234,692,30,19,49,61.2%,16m
12079,3,Amon,3234,516,21,14,35,60.0%,20m
12079,3,[NerfHB]ChoboZerg,3234,585,20,19,39,51.3%,4m
12079,3,woshinidie,3234,218,11,4,15,73.3%,21m
12079,3,Kaban,3234,280,10,16,26,38.5%,14m
12079,3,Zoferos,3234,0,5,0,5,100.0%,2m
12079,3,космос,3234,187,5,3,8,62.5%,5m
12079,1,DiamondSutra,3234,186,5,4,9,55.6%,50m
12079,3,Tron,3234,0,4,1,5,80.0%,6m
12079,3,ShzbtRitual,3234,92,3,6,9,33.3%,18m
12079,3,[2806]mRCtrlEscp,3234,88,3,11,14,21.4%,18m
12079,3,MER,3234,58,2,2,4,50.0%,12m
12079,3,Mouche,3234,58,2,2,4,50.0%,3m
12079,3,[OPrace]Spiti,3234,0,1,0,1,100.0%,19m
12079,3,MarlboroO,3234,0,1,0,1,100.0%,16m
12079,3,everyme,3234,0,1,0,1,100.0%,10m
12079,3,Zergatul,3234,30,1,1,2,50.0%,9m
12079,3,Omega,3234,30,1,4,5,20.0%,14m
12079,3,daekian,3234,0,1,4,5,20.0%,6m
12079,3,[BRZT]Dysprosium,3234,30,1,5,6,16.7%,9m
12079,3,[from]Beuark,3234,0,0,1,1,0.0%,7m
12079,3,[DZTK]Kampfkushla,3234,0,0,1,1,0.0%,5m
12079,3,Łapczywy,3234,0,0,1,1,0.0%,13m
12079,3,Moose,3234,0,0,3,3,0.0%,4m
12106,3,Siridar,3233,1382,71,61,132,53.8%,6m
12106,2,axsc,3233,1344,46,66,112,41.1%,9m
12106,3,[DАRK]papka,3233,551,24,16,40,60.0%,16m
12106,3,oui,3233,479,21,22,43,48.8%,11m
12106,3,[HsDL]Alexanderis,3233,465,17,16,33,51.5%,4m
12106,3,Qwan,3233,408,14,24,38,36.8%,19m
12106,2,[PONEYF]PølluX,3233,271,10,10,20,50.0%,20m
12106,3,Mobius,3233,241,8,4,12,66.7%,12m
12106,3,puf,3233,0,4,1,5,80.0%,7m
12106,3,ZguhZer,3233,60,3,2,5,60.0%,20m
12106,3,wonddak,3233,86,3,3,6,50.0%,12m
12106,3,[PowerG]MatexSK,3233,90,3,6,9,33.3%,7m
12106,2,YukaNomura,3233,97,1,1,2,50.0%,33m
12106,3,muscleTIM,3233,30,1,2,3,33.3%,20m
12106,3,Starfury,3233,0,0,1,1,0.0%,6m
12106,3,lllllllll,3233,0,0,1,1,0.0%,14m
12106,3,freDDy,3233,0,0,1,1,0.0%,11m
12123,3,redpill,3232,1559,161,163,324,49.7%,9m
12123,3,ZimZo,3232,1512,139,135,274,50.7%,9m
12123,3,[Didim]Fckling,3232,1568,103,114,217,47.5%,19m
12123,3,ManVSWild,3232,1367,56,55,111,50.5%,5m
12123,3,Nightmare,3232,447,50,33,83,60.2%,10m
12123,3,Simon,3232,352,15,14,29,51.7%,20m
12123,3,[ARTAS]Eeroladan,3232,322,11,8,19,57.9%,17m
12123,2,GayBarMania,3232,273,10,9,19,52.6%,5m
12123,3,toxyk,3232,268,9,7,16,56.2%,11m
12123,3,Cherby,3232,124,5,8,13,38.5%,17m
12123,3,[WEOP]Iamnic,3232,114,4,6,10,40.0%,11m
12123,1,Tryptamine,3232,140,4,10,14,28.6%,58m
12123,3,IIIIIIIIIIII,3232,86,3,3,6,50.0%,17m
12123,3,[2DME]Sonzaisei,3232,30,2,1,3,66.7%,6m
12123,2,[Mohala]Såsbaronen,3232,96,2,5,7,28.6%,58m
12123,3,SlideOfFists,3232,42,2,9,11,18.2%,2m
12123,3,TuTata,3232,30,1,1,2,50.0%,11m
12123,3,[НТТ]ImmunitY,3232,0,0,1,1,0.0%,19m
12123,3,Moogiwar,3232,0,0,1,1,0.0%,16m
12142,1,zerg,3231,1346,370,400,770,48.1%,6m
12142,3,[Tuning]Snuuffi,3231,1581,65,62,127,51.2%,5m
12142,3,qeereell,3231,1198,62,54,116,53.4%,2m
12142,3,Elendil,3231,1091,47,46,93,50.5%,4m
12142,3,Henning,3231,463,33,15,48,68.8%,21m
12142,3,LikeOfLings,3231,563,25,16,41,61.0%,14m
12142,3,Marklar,3231,395,17,12,29,58.6%,4m
12142,3,Mush,3231,166,11,4,15,73.3%,3m
12142,3,zannall,3231,289,11,8,19,57.9%,3m
12142,3,[Arrows]Soundwave,3231,191,7,0,7,100.0%,6m
12142,3,Freddy,3231,178,7,14,21,33.3%,22m
12142,3,[23ds]bagklog,3231,154,6,12,18,33.3%,9m
12142,3,[dDb]TheThilo,3231,107,5,2,7,71.4%,14m
12142,2,[НУБ]zibl,3231,118,5,2,7,71.4%,33m
12142,3,[FDA]Mist,3231,140,5,7,12,41.7%,12m
12142,3,WaLiaN,3231,89,3,5,8,37.5%,12m
12142,3,thePotfur,3231,53,3,10,13,23.1%,4m
12142,3,[BATG]Cuzzi,3231,0,1,0,1,100.0%,15m
12142,2,aftspring,3231,40,1,1,2,50.0%,10m
12142,3,luk,3231,30,1,1,2,50.0%,16m
12142,3,[SHUT]Zade,3231,0,0,1,1,0.0%,5m
12142,3,rOoSter,3231,0,0,2,2,0.0%,5m
12142,3,Sand,3231,0,0,2,2,0.0%,14m
12142,3,lIlIIIIlllI,3231,0,0,4,4,0.0%,22m
12166,3,[xProx]PeterGriffin,3230,1601,622,603,1225,50.8%,5m
12166,3,ruabags,3230,1562,257,247,504,51.0%,16m
12166,3,Hbear,3230,1561,187,181,368,50.8%,9m
12166,3,Soil,3230,1000,55,53,108,50.9%,13m
12166,3,Hiilimato,3230,666,37,25,62,59.7%,16m
12166,3,[FlCKAR]Musashi,3230,679,36,32,68,52.9%,21m
12166,3,[Surdeg]Entropy,3230,385,25,17,42,59.5%,7m
12166,3,Thalowitsch,3230,668,24,32,56,42.9%,9m
12166,3,[SotR]DJPicture,3230,381,14,11,25,56.0%,16m
12166,3,zlrka,3230,327,11,7,18,61.1%,2m
12166,3,Kingpin,3230,330,11,11,22,50.0%,6m
12166,3,IIIIIIIIII,3230,208,8,1,9,88.9%,6m
12166,3,[G4YoU]LingKing,3230,203,8,1,9,88.9%,2m
12166,2,OBELIX,3230,272,8,5,13,61.5%,2m
12166,3,jDtFesS,3230,78,5,4,9,55.6%,11m
12166,3,xiele,3230,0,4,1,5,80.0%,17m
12166,3,[Inval]Hisk,3230,120,3,0,3,100.0%,5m
12166,3,Raynor,3230,60,3,2,5,60.0%,14m
12166,3,Zilch,3230,30,2,11,13,15.4%,5m
12166,3,[ZP777]DikiiDavid,3230,0,1,0,1,100.0%,18m
12186,3,MLT,3229,1281,249,255,504,49.4%,9m
12186,3,[FuсkUU]Player,3229,798,192,133,325,59.1%,4m
12186,3,duncan,3229,1125,158,136,294,53.7%,4m
12186,3,Joe,3229,1496,135,130,265,50.9%,4m
12186,3,[enivay]TWTVenivay,3229,667,42,45,87,48.3%,14m
12186,3,WombatMaster,3229,508,17,23,40,42.5%,5m
12186,3,[Peeps]Kobold,3229,397,15,11,26,57.7%,10m
12186,2,PeteNice,3229,327,14,6,20,70.0%,15m
12186,3,[TheDOH]Filip,3229,178,14,14,28,50.0%,4m
12186,3,Imissmycat,3229,242,12,4,16,75.0%,17m
12186,3,[uWo]Megalomaniac,3229,300,9,8,17,52.9%,6m
12186,3,reloco,3229,212,8,3,11,72.7%,8m
12186,2,PJD,3229,97,5,1,6,83.3%,1h
12186,3,MeEr,3229,150,5,8,13,38.5%,8m
12186,3,Numinex,3229,86,4,4,8,50.0%,4m
12186,3,Exray,3229,88,4,5,9,44.4%,11m
12186,3,StarTUM,3229,126,4,10,14,28.6%,5m
12186,3,EntroJack,3229,0,1,2,3,33.3%,19m
12186,3,AronOslo,3229,30,1,2,3,33.3%,13m
12186,3,Aidiney,3229,0,0,1,1,0.0%,10m
12206,3,Shopov,3228,853,192,174,366,52.5%,5m
12206,3,[Dae]Alnaée,3228,1480,165,159,324,50.9%,4m
12206,3,[PR1M3]Fafner,3228,1613,111,102,213,52.1%,8m
12206,3,ImbaAdepts,3228,1534,81,68,149,54.4%,16m
12206,3,[Batia]Mateorule,3228,1084,42,37,79,53.2%,4m
12206,3,romkapazifis,3228,726,40,5,45,88.9%,12m
12206,3,BlooD,3228,950,40,34,74,54.1%,4m
12206,3,Tyrese,3228,491,38,27,65,58.5%,6m
12206,3,Albert,3228,444,29,22,51,56.9%,15m
12206,3,[PELMЕN]CyTb,3228,562,21,18,39,53.8%,6m
12206,3,[Mikoz]Лера,3228,211,14,3,17,82.4%,14m
12206,3,[Slakin]SslackSton,3228,308,12,5,17,70.6%,5m
12206,3,PaniQue,3228,285,12,9,21,57.1%,4m
12206,3,BigJim,3228,224,10,7,17,58.8%,11m
12206,3,Hanayama,3228,116,5,2,7,71.4%,16m
12206,3,Güatdefak,3228,118,5,4,9,55.6%,6m
12206,3,[YMB]Ortenn,3228,170,4,3,7,57.1%,7m
12206,3,Whistler,3228,143,4,7,11,36.4%,16m
12206,3,[NVDRM]Romfly,3228,126,4,13,17,23.5%,19m
12206,3,[HADHE]whiteman,3228,30,2,1,3,66.7%,13m
12206,3,[GZerO]Senwyn,3228,60,2,9,11,18.2%,10m
12206,3,SmilingAlone,3228,0,1,0,1,100.0%,16m
12206,3,Janis,3228,0,1,3,4,25.0%,58m
12206,3,[Jiggel]VibeScholar,3228,0,0,1,1,0.0%,20m
12206,3,[3AS]Solidus,3228,0,0,1,1,0.0%,12m
12206,3,NinjaXD,3228,0,0,1,1,0.0%,5m
12206,3,Iron,3228,0,0,1,1,0.0%,12m
12233,3,Lance,3227,1529,374,375,749,49.9%,18m
12233,3,[D0N3]jobiz,3227,1274,100,91,191,52.4%,5m
12233,3,FatCat,3227,1563,100,92,192,52.1%,18m
12233,3,TacoTruck,3227,1510,67,52,119,56.3%,4m
12233,3,notime,3227,1017,49,47,96,51.0%,12m
12233,3,Mola,3227,930,42,40,82,51.2%,13m
12233,3,creative,3227,757,35,33,68,51.5%,9m
12233,3,Nadgnity,3227,435,24,17,41,58.5%,7m
12233,3,Savage,3227,686,24,28,52,46.2%,9m
12233,3,QQQ,3227,490,17,20,37,45.9%,4m
12233,3,Sml,3227,444,16,23,39,41.0%,8m
12233,3,tiSSot,3227,355,14,13,27,51.9%,6m
12233,3,WannaBeSCV,3227,206,11,9,20,55.0%,20m
12233,3,TreNrod,3227,270,10,15,25,40.0%,16m
12233,3,miniphili,3227,141,8,2,10,80.0%,19m
12233,2,[āÐāM]ALekSS,3227,143,6,2,8,75.0%,25m
12233,3,KodiaK,3227,145,6,4,10,60.0%,7m
12233,3,[Y3ET]KryloKz,3227,158,6,9,15,40.0%,12m
12233,3,Secret,3227,0,4,1,5,80.0%,15m
12233,3,Gades,3227,92,4,2,6,66.7%,15m
12233,3,TixTix,3227,118,3,0,3,100.0%,21m
12233,3,Snapshot,3227,119,2,1,3,66.7%,16m
12233,3,lzizl,3227,62,2,7,9,22.2%,6m
12233,3,louiseflbdv,3227,0,1,1,2,50.0%,4m
12233,3,[BOYIS]Skerrigan,3227,0,1,2,3,33.3%,14m
12233,3,[aDGa]inqisitorgfd,3227,0,0,1,1,0.0%,11m
12259,3,sLm,3226,1221,341,331,672,50.7%,18m
12259,3,[RUS]Annabelle,3226,988,51,20,71,71.8%,12m
12259,3,Docenta,3226,1034,47,42,89,52.8%,4m
12259,3,MrAkuu,3226,623,36,30,66,54.5%,8m
12259,3,RainTeller,3226,930,36,32,68,52.9%,6m
12259,3,[DUCINA]KULE,3226,746,32,23,55,58.2%,5m
12259,3,Radiance,3226,591,25,14,39,64.1%,12m
12259,3,SilenceRiver,3226,239,12,6,18,66.7%,18m
12259,3,[EGi]MichZor,3226,103,12,10,22,54.5%,11m
12259,3,HoggerTime,3226,148,8,5,13,61.5%,7m
12259,3,RisingSun,3226,0,4,1,5,80.0%,37m
12259,3,TicTac,3226,114,4,4,8,50.0%,19m
12259,3,Adek,3226,30,2,1,3,66.7%,15m
12259,3,[0KitS0]Sargas,3226,62,2,9,11,18.2%,15m
12259,3,[TC55]Nemesis,3226,0,1,0,1,100.0%,7m
12259,3,[8DJ8]mhY,3226,0,1,0,1,100.0%,10m
12259,3,Alex,3226,0,1,0,1,100.0%,4m
12259,3,DarkLizzard,3226,0,0,1,1,0.0%,7m
12259,3,Lelicman,3226,0,0,1,1,0.0%,19m
12259,3,Swekills,3226,0,0,2,2,0.0%,12m
12279,3,[ЕМPIRE]Mikhail,3225,1466,207,212,419,49.4%,2m
12279,3,Karos,3225,1248,131,110,241,54.4%,8m
12279,3,IIIIIIlIIIl,3225,1484,110,99,209,52.6%,10m
12279,3,Raphael,3225,768,57,48,105,54.3%,5m
12279,3,[Rylst]Enguerrant,3225,1303,55,44,99,55.6%,15m
12279,3,[UoBCP]Katyurkokov,3225,1296,52,42,94,55.3%,6m
12279,3,SalfetKa,3225,817,38,24,62,61.3%,8m
12279,3,[We3eD]BananaJoe,3225,964,37,36,73,50.7%,18m
12279,3,[LOGS]Dodo,3225,831,36,36,72,50.0%,10m
12279,3,[lMMl]Macmed,3225,698,27,23,50,54.0%,5m
12279,3,Arcail,3225,438,17,19,36,47.2%,5m
12279,3,NYPD,3225,321,16,10,26,61.5%,3m
12279,3,Verda,3225,296,13,9,22,59.1%,10m
12279,3,saigo,3225,358,13,14,27,48.1%,19m
12279,3,FreestyloKZ,3225,348,12,11,23,52.2%,7m
12279,3,Camalot,3225,276,10,14,24,41.7%,9m
12279,3,llllllllllll,3225,212,9,6,15,60.0%,6m
12279,3,TheX,3225,250,9,15,24,37.5%,12m
12279,3,BroLuk,3225,163,6,2,8,75.0%,3m
12279,3,[KZstan]Noger,3225,178,6,7,13,46.2%,6m
12279,3,SaCrOs,3225,0,4,1,5,80.0%,10m
12279,3,FURYCH,3225,158,4,1,5,80.0%,6m
12279,3,Neuro,3225,86,4,3,7,57.1%,12m
12279,3,[IVJI]Makrotello,3225,116,4,7,11,36.4%,3m
12279,3,Rochehouse,3225,60,3,1,4,75.0%,4m
12279,1,ManukinGG,3225,124,3,2,5,60.0%,53m
12279,3,Eightmouse,3225,90,3,3,6,50.0%,10m
12279,3,lololik,3225,0,1,0,1,100.0%,21m
12279,3,[IamCpt]Captian,3225,0,1,0,1,100.0%,4m
12279,3,Vesh,3225,0,1,0,1,100.0%,11m
12279,3,Larres,3225,0,1,0,1,100.0%,5m
12279,3,Turik,3225,0,1,1,2,50.0%,16m
12279,3,[GCorps]BlizzOmega,3225,30,1,2,3,33.3%,11m
12279,3,[Hrr]powerofchaos,3225,0,0,2,2,0.0%,10m
12313,3,Paene,3224,1631,460,449,909,50.6%,16m
12313,3,whohow,3224,1595,385,364,749,51.4%,19m
12313,3,Simas,3224,1595,130,129,259,50.2%,14m
12313,3,Raymon,3224,1562,124,116,240,51.7%,3m
12313,3,Rico,3224,1299,66,71,137,48.2%,9m
12313,3,[K0mpis]Kurre,3224,457,51,47,98,52.0%,9m
12313,3,[ZM]Titou,3224,476,24,7,31,77.4%,2m
12313,3,[2s1ck]XGodHarryS,3224,614,24,17,41,58.5%,20m
12313,3,[cArB0t]FlorinKratos,3224,572,20,17,37,54.1%,3m
12313,3,[SƬǂ]PogoTheClown,3224,519,19,19,38,50.0%,20m
12313,3,Vince,3224,396,15,10,25,60.0%,18m
12313,3,LitPord,3224,94,8,12,20,40.0%,5m
12313,3,[GGMS]BlackAdder,3224,204,7,9,16,43.8%,6m
12313,3,[DSTARI]Kalapács,3224,211,6,12,18,33.3%,3m
12313,2,LastEmperor,3224,0,5,1,6,83.3%,49m
12313,1,[BxFxV]MetalheadBBG,3224,214,5,3,8,62.5%,27m
12313,3,[LOGS]Chinis,3224,0,5,3,8,62.5%,14m
12313,3,[BRCHTV]BunnyBugzy,3224,120,4,4,8,50.0%,5m
12313,3,[13NRV]valithor,3224,135,3,7,10,30.0%,6m
12313,3,[LUP]Kopernick,3224,58,3,9,12,25.0%,22m
12313,3,[Cannоn]BelaM,3224,0,0,1,1,0.0%,4m
12313,3,[НС]Надзиратель,3224,0,0,1,1,0.0%,10m
12335,3,kofeinik,3223,1592,273,259,532,51.3%,20m
12335,3,KoooSz,3223,1323,235,208,443,53.0%,10m
12335,3,HUNTER,3223,1510,147,99,246,59.8%,3m
12335,3,IIIIIIIIIIII,3223,1004,128,109,237,54.0%,4m
12335,3,preuBB,3223,1240,111,112,223,49.8%,10m
12335,3,Nachtwächter,3223,1323,75,69,144,52.1%,3m
12335,3,Ostkaka,3223,1555,73,64,137,53.3%,4m
12335,3,quiz,3223,869,38,25,63,60.3%,9m
12335,3,enemy,3223,865,34,27,61,55.7%,4m
12335,3,Nerethos,3223,586,27,16,43,62.8%,6m
12335,3,[OYY]Koltess,3223,462,17,18,35,48.6%,9m
12335,2,Faker,3223,95,5,2,7,71.4%,18m
12335,3,TeOulb,3223,148,5,10,15,33.3%,4m
12335,3,MINASMODDY,3223,58,2,7,9,22.2%,22m
12335,3,woju,3223,0,1,0,1,100.0%,13m
12335,3,[osorok]seriousnick,3223,0,1,0,1,100.0%,7m
12335,3,Eyum,3223,0,1,1,2,50.0%,15m
12335,3,[BadAtt]xebek,3223,30,1,3,4,25.0%,2m
12335,1,AokiShoji,3223,0,0,1,1,0.0%,33m
12335,3,улыбастик,3223,0,0,1,1,0.0%,13m
12355,3,Zamer,3222,1210,292,291,583,50.1%,3m
12355,2,daylight,3222,1556,191,200,391,48.8%,4m
12355,3,bloodbath,3222,1578,178,165,343,51.9%,5m
12355,3,[RIPERY]Lasic,3222,1483,161,139,300,53.7%,14m
12355,3,Daemon,3222,483,85,89,174,48.9%,4m
12355,3,IIIIIIIIIIU,3222,784,54,40,94,57.4%,4m
12355,3,foxer,3222,729,44,40,84,52.4%,8m
12355,3,SolarBoiii,3222,659,32,17,49,65.3%,18m
12355,3,[JS]bubiyascha,3222,814,30,35,65,46.2%,11m
12355,3,kesha,3222,381,25,22,47,53.2%,11m
12355,3,veter,3222,521,22,18,40,55.0%,4m
12355,3,[FSL]Uvaron,3222,266,13,8,21,61.9%,17m
12355,3,Kazekage,3222,147,10,7,17,58.8%,5m
12355,3,[B00M4]frosty,3222,262,10,11,21,47.6%,21m
12355,3,SEREP,3222,182,7,9,16,43.8%,16m
12355,3,AEC,3222,124,5,7,12,41.7%,20m
12355,3,Stivion,3222,132,4,3,7,57.1%,6m
12355,3,Aktiv,3222,88,3,6,9,33.3%,16m
12355,3,EuraRa,3222,119,2,1,3,66.7%,16m
12355,3,[SZM]Nadeem,3222,0,1,1,2,50.0%,8m
12355,3,Jebbster,3222,0,1,1,2,50.0%,14m
12355,3,[МLР]PrCelestia,3222,30,1,2,3,33.3%,3m
12355,3,[GC]RygelXVI,3222,0,1,4,5,20.0%,5m
12355,3,[Optik]Insanity,3222,0,0,1,1,0.0%,4m
12355,3,QAB,3222,0,0,1,1,0.0%,3m
12355,3,BlackMilk,3222,0,0,3,3,0.0%,16m
12381,3,SlowZerg,3221,1225,346,313,659,52.5%,17m
12381,3,aCiD,3221,1486,164,152,316,51.9%,17m
12381,3,effics,3221,1127,156,139,295,52.9%,18m
12381,3,Tim,3221,405,66,58,124,53.2%,14m
12381,3,[DUPA]boombel,3221,785,45,33,78,57.7%,6m
12381,3,Reign,3221,1103,45,43,88,51.1%,3m
12381,3,[MSK5]Dastmodest,3221,1002,42,34,76,55.3%,6m
12381,3,[PRAIM]LingKing,3221,233,32,23,55,58.2%,7m
12381,3,CaroleBaskin,3221,638,27,22,49,55.1%,20m
12381,3,elNOVELISTA,3221,403,19,25,44,43.2%,6m
12381,3,likonit,3221,375,16,7,23,69.6%,8m
12381,3,Raresvoda,3221,93,15,6,21,71.4%,22m
12381,3,Oldrich,3221,301,10,8,18,55.6%,7m
12381,3,galdomir,3221,241,8,4,12,66.7%,12m
12381,2,Zendomaster,3221,116,6,3,9,66.7%,54m
12381,3,federal,3221,131,6,3,9,66.7%,12m
12381,3,ubilskap,3221,213,6,5,11,54.5%,5m
12381,2,Amphion,3221,96,5,2,7,71.4%,39m
12381,3,[743]Omgitsyou,3221,138,3,2,5,60.0%,21m
12381,3,[SNKN]PhoneticsPro,3221,0,1,1,2,50.0%,22m
12381,3,[Batia]alariii,3221,0,1,1,2,50.0%,5m
12381,1,[Rakii]xerg,3221,0,1,4,5,20.0%,14m
12381,1,RXM,3221,0,0,1,1,0.0%,15m
12381,3,iskar,3221,0,0,1,1,0.0%,18m
12381,3,[6pooI]zortex,3221,0,0,1,1,0.0%,5m
12406,3,[BWArmy]niskae,3220,881,371,369,740,50.1%,9m
12406,3,Bandershtadt,3220,1272,214,209,423,50.6%,17m
12406,3,Evgeniy,3220,823,111,92,203,54.7%,20m
12406,3,iDovj,3220,1395,109,92,201,54.2%,10m
12406,3,insect,3220,935,97,22,119,81.5%,5m
12406,3,lynx,3220,1058,39,40,79,49.4%,10m
12406,3,OhmInpw,3220,630,23,27,50,46.0%,5m
12406,3,starkiller,3220,447,17,12,29,58.6%,20m
12406,3,SweatyBetty,3220,347,16,10,26,61.5%,20m
12406,3,AmnesiaK,3220,277,14,7,21,66.7%,10m
12406,3,slv,3220,132,11,5,16,68.8%,12m
12406,3,tof,3220,232,8,4,12,66.7%,6m
12406,1,[BotFK]Kerm,3220,187,8,4,12,66.7%,25m
12406,3,KanosMágus,3220,0,5,0,5,100.0%,21m
12406,3,MindControl,3220,0,4,1,5,80.0%,14m
12406,3,TOMag,3220,115,3,0,3,100.0%,4m
12406,2,mavruss,3220,116,3,1,4,75.0%,54m
12406,3,Prophet,3220,0,2,3,5,40.0%,10m
12406,3,GladHeAteHer,3220,62,2,8,10,20.0%,22m
12406,3,[VetM]BaygonVert,3220,0,1,0,1,100.0%,4m
12406,3,[khalas]Radovan,3220,0,1,0,1,100.0%,5m
12406,3,Nexmar,3220,30,1,6,7,14.3%,19m
12406,3,ZidVicious,3220,0,0,1,1,0.0%,5m
12429,3,Unterkatze,3219,1276,323,321,644,50.2%,7m
12429,3,Gomph,3219,1462,88,82,170,51.8%,12m
12429,3,Proquiv,3219,1609,75,76,151,49.7%,10m
12429,3,Rick,3219,1479,70,50,120,58.3%,21m
12429,3,[Pot]Bucóka,3219,997,57,45,102,55.9%,12m
12429,3,MiLaShKa,3219,943,41,27,68,60.3%,18m
12429,3,MoonLightETA,3219,529,34,23,57,59.6%,3m
12429,3,AfganUA,3219,629,26,19,45,57.8%,10m
12429,3,Tyrios,3219,310,22,21,43,51.2%,9m
12429,3,[Petrus]Petrus,3219,521,21,12,33,63.6%,4m
12429,3,Efreet,3219,435,21,13,34,61.8%,6m
12429,3,BlueSide,3219,337,21,21,42,50.0%,9m
12429,3,Ráďa,3219,217,20,10,30,66.7%,12m
12429,3,[GGLose]SkeJIoF,3219,464,20,12,32,62.5%,20m
12429,3,utrator,3219,519,20,14,34,58.8%,6m
12429,3,Murgho,3219,319,20,15,35,57.1%,15m
12429,3,[GSRbe]Tenebris,3219,398,15,10,25,60.0%,20m
12429,3,[GOST61]Kloputze,3219,272,9,12,21,42.9%,11m
12429,3,[dling]Wirx,3219,146,6,6,12,50.0%,12m
12429,3,[TNZs]Nadapolis,3219,170,6,8,14,42.9%,17m
12429,3,Killerfridge,3219,114,3,1,4,75.0%,6m
12429,3,NoobSaibot,3219,90,3,10,13,23.1%,15m
12429,3,FizzyElf,3219,60,2,4,6,33.3%,9m
12429,3,Fruityloop,3219,0,1,0,1,100.0%,13m
12429,3,demolition,3219,0,1,0,1,100.0%,4m
12429,3,Chillkröte,3219,0,1,0,1,100.0%,7m
12429,3,[Didim]Meglomaniac,3219,0,1,1,2,50.0%,13m
12429,3,Nibbs,3219,94,1,1,2,50.0%,4m
12429,3,[Argon]LieS,3219,0,0,1,1,0.0%,12m
12429,3,[Trasch]Pico,3219,0,0,1,1,0.0%,5m
12429,3,Safar,3219,0,0,2,2,0.0%,18m
12460,3,[mfxed]owner,3218,1380,138,122,260,53.1%,7m
12460,3,Бывалый,3218,975,120,79,199,60.3%,15m
12460,3,groebens,3218,849,114,96,210,54.3%,3m
12460,3,FatalX,3218,1451,112,104,216,51.9%,7m
12460,3,Dero,3218,1077,63,45,108,58.3%,12m
12460,3,glhf,3218,1297,59,48,107,55.1%,5m
12460,3,Silver,3218,1159,53,38,91,58.2%,19m
12460,3,[RVT]FXBaBaHaHn,3218,744,33,23,56,58.9%,14m
12460,3,Herrstan,3218,613,27,18,45,60.0%,18m
12460,3,[salata]WARLOCK,3218,411,26,21,47,55.3%,22m
12460,3,Marve,3218,482,21,11,32,65.6%,4m
12460,3,[WNGS]Belowzero,3218,294,19,10,29,65.5%,11m
12460,3,[neuroW]Comlock,3218,532,19,18,37,51.4%,14m
12460,3,[REDFm]sinica,3218,379,17,9,26,65.4%,2m
12460,3,Reaper,3218,408,14,20,34,41.2%,10m
12460,3,xOIiIOx,3218,288,13,11,24,54.2%,21m
12460,3,ness,3218,282,11,5,16,68.8%,4m
12460,3,Zero,3218,208,8,7,15,53.3%,10m
12460,3,Sankari,3218,212,7,12,19,36.8%,10m
12460,3,Pumbaa,3218,185,5,3,8,62.5%,6m
12460,3,IggyAzalea,3218,0,4,1,5,80.0%,5m
12460,3,Scytale,3218,118,4,10,14,28.6%,4m
12460,3,Amfi,3218,58,3,1,4,75.0%,5m
12460,3,twoget,3218,95,2,0,2,100.0%,6m
12460,2,Nikkist,3218,46,2,1,3,66.7%,58m
12460,3,soulfreak,3218,58,2,3,5,40.0%,11m
12460,1,Tiberius,3218,125,2,5,7,28.6%,17m
12460,3,[G4YoU]morohbj,3218,30,1,2,3,33.3%,15m
12460,3,rainbow,3218,0,0,1,1,0.0%,15m
12460,3,BrahMa,3218,0,0,2,2,0.0%,10m
12460,3,[aBueLo]INIGORUS,3218,0,0,2,2,0.0%,8m
12460,3,GrandMasterB,3218,0,0,3,3,0.0%,3m
12492,3,RElIquIe,3217,1529,154,155,309,49.8%,11m
12492,3,[KrnBrs]msetler,3217,1369,124,103,227,54.6%,10m
12492,3,Eral,3217,656,104,86,190,54.7%,21m
12492,3,Light,3217,1345,83,90,173,48.0%,13m
12492,3,camel,3217,506,57,46,103,55.3%,10m
12492,3,rangleklods,3217,932,38,34,72,52.8%,5m
12492,3,[RGdC]iseo,3217,184,36,15,51,70.6%,18m
12492,3,Bob,3217,397,36,27,63,57.1%,22m
12492,3,[CuWoǂ]Theknife,3217,802,34,31,65,52.3%,11m
12492,3,ThePreacher,3217,654,28,22,50,56.0%,15m
12492,3,MajorNeuf,3217,199,24,15,39,61.5%,10m
12492,3,[Sarmat]MissCaVeiRa,3217,524,22,12,34,64.7%,6m
12492,3,vevers,3217,238,15,5,20,75.0%,16m
12492,3,llllllllllll,3217,307,12,4,16,75.0%,8m
12492,3,MatixPL,3217,329,11,12,23,47.8%,13m
12492,3,Stardu,3217,282,9,9,18,50.0%,19m
12492,3,Stemir,3217,234,9,10,19,47.4%,20m
12492,3,Kinkasun,3217,0,4,1,5,80.0%,5m
12492,3,Zergy,3217,0,4,1,5,80.0%,16m
12492,3,Nasdaq,3217,88,3,4,7,42.9%,12m
12492,3,[RAHRAH]Riegel,3217,88,3,5,8,37.5%,3m
12492,3,[K0RM2]Константин,3217,94,2,0,2,100.0%,7m
12492,3,[J4E]CHAPPiE,3217,60,2,4,6,33.3%,10m
12492,3,[ERQ]MawlinsTV,3217,0,1,0,1,100.0%,16m
12492,3,[HFR]Redwar,3217,0,1,1,2,50.0%,11m
12492,3,[CSIFE]wefhy,3217,92,1,1,2,50.0%,20m
12492,3,[TSTG]Joshiso,3217,0,1,5,6,16.7%,18m
12492,3,[MiWo]Gingernuts,3217,30,1,5,6,16.7%,18m
12492,3,[Lowko]Dinouu,3217,0,0,1,1,0.0%,18m
12492,3,[4TY2]Prospector,3217,0,0,1,1,0.0%,17m
12522,2,HiveMind,3216,1577,418,425,843,49.6%,9m
12522,3,[GAMI]santiego,3216,1568,98,78,176,55.7%,19m
12522,3,xXBigDickXx,3216,873,98,81,179,54.7%,5m
12522,3,Path,3216,518,95,83,178,53.4%,11m
12522,3,[Fridge]OZN,3216,441,62,47,109,56.9%,10m
12522,3,Rymygo,3216,1023,45,34,79,57.0%,15m
12522,3,Demure,3216,793,38,33,71,53.5%,21m
12522,3,[GH2]DealEye,3216,722,36,25,61,59.0%,21m
12522,3,Mokuke,3216,747,30,27,57,52.6%,22m
12522,3,SvArTaJuMp,3216,299,28,18,46,60.9%,12m
12522,3,[Čigāns]Salaats,3216,678,28,21,49,57.1%,3m
12522,3,Beliytigr,3216,776,26,36,62,41.9%,10m
12522,3,[efb]Ehlers,3216,384,17,13,30,56.7%,2m
12522,3,soso,3216,378,13,27,40,32.5%,20m
12522,3,Itama,3216,185,9,3,12,75.0%,4m
12522,3,[O2Ds]Fufel,3216,189,9,4,13,69.2%,21m
12522,3,Misanthrop,3216,289,9,8,17,52.9%,11m
12522,3,[Furya]PSK,3216,258,9,10,19,47.4%,5m
12522,3,[Ninjas]Prodigy,3216,199,7,2,9,77.8%,10m
12522,2,Sorcerer,3216,204,7,4,11,63.6%,15m
12522,3,MrBarcode,3216,142,6,4,10,60.0%,12m
12522,3,Skigth,3216,176,6,5,11,54.5%,16m
12522,3,ProtossOTP,3216,170,6,6,12,50.0%,5m
12522,3,Shaftpunk,3216,64,6,13,19,31.6%,21m
12522,3,[WCKYLN]BOSSHOORE,3216,146,5,7,12,41.7%,12m
12522,3,SVIOO,3216,120,5,8,13,38.5%,14m
12522,3,[Hrr]Ethanolos,3216,136,4,0,4,100.0%,3m
12522,3,DeVole,3216,141,4,1,5,80.0%,12m
12522,3,GoNDaR,3216,154,4,2,6,66.7%,20m
12522,3,judos,3216,32,4,4,8,50.0%,18m
12522,1,Shrunkai,3216,119,3,0,3,100.0%,8m
12522,3,[PO1A1O]Bardude,3216,112,3,0,3,100.0%,16m
12522,3,yule,3216,90,3,5,8,37.5%,21m
12522,3,[InitRu]SameOldName,3216,30,2,3,5,40.0%,9m
12522,3,[TTe]puk,3216,0,1,0,1,100.0%,18m
12522,3,ShirOkiyyy,3216,94,1,1,2,50.0%,12m
12522,3,CrEativE,3216,0,0,1,1,0.0%,8m
12522,3,[VFN]tvmoviespohr,3216,0,0,1,1,0.0%,5m
12522,3,IpuntPuppies,3216,0,0,1,1,0.0%,18m
12561,3,startega,3215,468,234,226,460,50.9%,13m
12561,3,[ProbKA]Vanooo,3215,566,92,63,155,59.4%,9m
12561,3,DrProut,3215,1382,67,65,132,50.8%,19m
12561,3,IINirvSpinIl,3215,710,57,47,104,54.8%,15m
12561,3,EtamiN,3215,725,56,42,98,57.1%,5m
12561,3,Erovraren,3215,1057,47,33,80,58.8%,16m
12561,3,HoopsFtW,3215,1151,46,41,87,52.9%,6m
12561,3,DarkLobz,3215,378,45,26,71,63.4%,14m
12561,3,newbe,3215,720,34,15,49,69.4%,6m
12561,3,Boss,3215,761,32,21,53,60.4%,18m
12561,3,DaB,3215,478,19,17,36,52.8%,4m
12561,3,Valsoray,3215,354,17,7,24,70.8%,15m
12561,3,mgh,3215,307,14,11,25,56.0%,3m
12561,3,GRAF,3215,315,13,5,18,72.2%,16m
12561,3,[ADVIA]InterNeto,3215,188,12,13,25,48.0%,13m
12561,3,[ЮЗ]Денон,3215,168,10,6,16,62.5%,12m
12561,3,CuervoTroll,3215,187,5,5,10,50.0%,5m
12561,3,llllllllllll,3215,145,4,8,12,33.3%,20m
12561,3,Exquid,3215,122,4,9,13,30.8%,22m
12561,3,[xDOOBx]Gringan,3215,86,3,9,12,25.0%,14m
12561,3,sisu,3215,30,2,2,4,50.0%,20m
12561,2,MasterYota,3215,0,1,0,1,100.0%,51m
12561,3,Syne,3215,0,1,3,4,25.0%,17m
12561,3,[ЕПРСТ]JuGGler,3215,30,1,3,4,25.0%,5m
12561,3,Бреге,3215,0,0,1,1,0.0%,19m
12561,3,Kartowka,3215,0,0,1,1,0.0%,19m
12561,3,[NetGG]Lelouche,3215,0,0,2,2,0.0%,20m
12588,3,Gelkram,3214,1572,334,314,648,51.5%,4m
12588,3,Oelewapperke,3214,1549,249,237,486,51.2%,3m
12588,3,Bleed,3214,1555,192,196,388,49.5%,11m
12588,3,Guigez,3214,769,90,76,166,54.2%,4m
12588,3,[PCAS]LRSAD,3214,1153,59,57,116,50.9%,11m
12588,3,Дмитрий,3214,1323,58,41,99,58.6%,6m
12588,3,Cerebrate,3214,898,33,41,74,44.6%,4m
12588,3,[LOoTeX]BSG,3214,759,32,24,56,57.1%,5m
12588,3,Armageddon,3214,361,32,38,70,45.7%,17m
12588,3,[Aetat]NharaX,3214,520,21,17,38,55.3%,5m
12588,3,MrSuccess,3214,214,19,10,29,65.5%,17m
12588,3,mak,3214,172,6,0,6,100.0%,4m
12588,3,[LINGY]Mandrake,3214,152,5,14,19,26.3%,5m
12588,3,ShaCk,3214,0,4,1,5,80.0%,7m
12588,3,[nWss]BiKi,3214,152,4,2,6,66.7%,16m
12588,3,Krovah,3214,95,2,0,2,100.0%,18m
12588,3,FLORIN,3214,0,1,0,1,100.0%,5m
12588,3,Squidy,3214,94,1,1,2,50.0%,6m
12588,3,freeZell,3214,0,0,4,4,0.0%,13m
12607,2,manygridi,3213,1509,352,371,723,48.7%,4m
12607,3,IcyGoblin,3213,641,93,91,184,50.5%,16m
12607,3,VidarViking,3213,1530,90,78,168,53.6%,4m
12607,3,[HASN]HAL,3213,1423,88,64,152,57.9%,5m
12607,3,Guiguite,3213,791,82,72,154,53.2%,11m
12607,3,Methusalam,3213,716,62,55,117,53.0%,13m
12607,3,EGIdrA,3213,873,53,39,92,57.6%,11m
12607,3,Supicat,3213,462,32,30,62,51.6%,8m
12607,3,GakTakLakPak,3213,594,30,9,39,76.9%,7m
12607,3,Cocaa,3213,664,25,35,60,41.7%,5m
12607,3,Medusa,3213,363,15,8,23,65.2%,14m
12607,3,Brice,3213,400,13,30,43,30.2%,20m
12607,3,[TheDOH]Miczu,3213,271,12,2,14,85.7%,21m
12607,3,[CPkTs]Jinpachu,3213,278,11,10,21,52.4%,10m
12607,3,Антошка,3213,233,8,5,13,61.5%,15m
12607,3,Shansur,3213,239,7,5,12,58.3%,16m
12607,3,[ZERGTV]DaniilSuper,3213,173,6,1,7,85.7%,19m
12607,2,Schlüpfer,3213,186,6,4,10,60.0%,51m
12607,3,Indevarit,3213,211,6,5,11,54.5%,18m
12607,3,[sc2rf]vasyok,3213,154,4,2,6,66.7%,4m
12607,3,BruTaL,3213,60,4,6,10,40.0%,14m
12607,3,[RxOxG]Crank,3213,138,3,2,5,60.0%,6m
12607,3,[CRAYZE]Кристина,3213,0,1,0,1,100.0%,13m
12607,3,asher,3213,94,1,1,2,50.0%,16m
12607,3,[BAX]Tekon,3213,94,1,1,2,50.0%,11m
12607,3,[SVINA]mokkabonna,3213,0,0,1,1,0.0%,10m
12607,3,Maxim,3213,0,0,1,1,0.0%,8m
12607,3,ululululuul,3213,0,0,2,2,0.0%,10m
12607,3,[Pisdec]Mainkane,3213,0,0,3,3,0.0%,8m
12607,3,Danx,3213,0,0,3,3,0.0%,13m
12637,3,Korvin,3212,1465,170,143,313,54.3%,18m
12637,3,[REBLSZ]Imasz,3212,1529,153,125,278,55.0%,6m
12637,3,[WBGA]Sumsar,3212,1550,117,97,214,54.7%,7m
12637,3,qtai,3212,1498,85,79,164,51.8%,14m
12637,3,GravenHill,3212,1339,65,52,117,55.6%,6m
12637,3,Ганнибал,3212,1385,63,67,130,48.5%,5m
12637,3,ByUn,3212,814,41,23,64,64.1%,17m
12637,3,EatMyPepe,3212,764,37,17,54,68.5%,18m
12637,3,[VädA]dAVaddA,3212,889,33,32,65,50.8%,8m
12637,3,FaiL,3212,527,20,14,34,58.8%,14m
12637,3,[Dicboy]Pudgey,3212,490,20,14,34,58.8%,6m
12637,3,[NWGD]Aqua,3212,452,19,12,31,61.3%,3m
12637,3,[Levit]Levitas,3212,478,18,14,32,56.2%,5m
12637,3,Noire,3212,342,15,11,26,57.7%,6m
12637,2,Shyheim,3212,256,12,9,21,57.1%,4m
12637,3,FeelgoodMD,3212,297,10,7,17,58.8%,4m
12637,3,UnholyMask,3212,322,10,10,20,50.0%,10m
12637,3,[ÄoB]SpiceIT,3212,264,10,14,24,41.7%,4m
12637,3,DarkTech,3212,189,9,1,10,90.0%,11m
12637,3,Alkadia,3212,234,8,8,16,50.0%,7m
12637,3,[VillaF]BaTDonald,3212,93,6,0,6,100.0%,7m
12637,3,[WNTR]Ikses,3212,129,4,4,8,50.0%,5m
12637,3,deyimd,3212,30,2,1,3,66.7%,19m
12637,2,AnomBomj,3212,48,2,2,4,50.0%,1h
12637,3,[KORN2]ChelSim,3212,0,1,0,1,100.0%,3m
12637,3,SparTa,3212,0,1,4,5,20.0%,7m
12637,3,FunnyZerg,3212,30,1,4,5,20.0%,19m
12637,3,bluedark,3212,0,0,1,1,0.0%,9m
12637,3,[Karoko]ShieldanMana,3212,0,0,1,1,0.0%,16m
12637,3,[K0mpis]Nexus,3212,0,0,1,1,0.0%,12m
12637,3,StrangeMD,3212,0,0,1,1,0.0%,16m
12637,3,[zhuk]uranic,3212,0,0,2,2,0.0%,9m
12669,3,PAPA,3211,1220,233,224,457,51.0%,13m
12669,3,Echo,3211,1349,158,134,292,54.1%,12m
12669,3,[JINX]SokoOne,3211,1076,92,6,98,93.9%,6m
12669,3,[TopGS]LingKing,3211,856,92,80,172,53.5%,11m
12669,3,ValacAxi,3211,682,91,69,160,56.9%,20m
12669,3,DrunkMaster,3211,1345,58,48,106,54.7%,6m
12669,3,Luffy,3211,1224,48,40,88,54.5%,7m
12669,3,awesome,3211,684,47,33,80,58.8%,8m
12669,3,ТИМУР,3211,1103,44,45,89,49.4%,10m
12669,3,[POTEAU]Celamarda,3211,545,35,24,59,59.3%,21m
12669,3,Coronavirus,3211,677,27,20,47,57.4%,15m
12669,2,[TxDxM]Josh,3211,746,23,51,74,31.1%,8m
12669,3,FKLM,3211,336,19,10,29,65.5%,6m
12669,3,Unfug,3211,417,18,13,31,58.1%,19m
12669,3,[AiRǂ]Rictal,3211,325,16,5,21,76.2%,11m
12669,3,roritnse,3211,325,15,11,26,57.7%,10m
12669,3,[яєѕ]owenose,3211,321,14,12,26,53.8%,18m
12669,3,[ZaiFu]AsuDesu,3211,294,12,4,16,75.0%,13m
12669,3,[NGJ]KimuKun,3211,246,12,10,22,54.5%,19m
12669,2,Xean,3211,160,7,4,11,63.6%,5m
12669,3,[oTCo]LTJ,3211,218,6,11,17,35.3%,11m
12669,3,Rhasta,3211,0,4,1,5,80.0%,32m
12669,3,[SZIG]Ilúvatar,3211,76,4,5,9,44.4%,9m
12669,3,[pTa]ShiQuRas,3211,93,2,0,2,100.0%,11m
12669,3,sYnc,3211,93,2,0,2,100.0%,18m
12669,3,GunsNRoaches,3211,94,1,1,2,50.0%,5m
12669,3,[TKJM]SYSTEMCRASH,3211,0,1,2,3,33.3%,18m
12669,3,[Brain]MrLprcaun,3211,0,1,2,3,33.3%,4m
12669,3,Cyclone,3211,30,1,6,7,14.3%,9m
12669,3,[Orewa]ChinChin,3211,0,0,2,2,0.0%,4m
12669,1,JonRy,3211,0,0,5,5,0.0%,21m
12700,3,risto,3210,1320,167,142,309,54.0%,21m
12700,3,KorVixx,3210,1088,102,87,189,54.0%,17m
12700,3,ZwEi,3210,187,97,16,113,85.8%,11m
12700,3,nicholincho,3210,1269,91,50,141,64.5%,4m
12700,3,[RWH]aNOobIs,3210,417,35,39,74,47.3%,17m
12700,3,[Veco]Awesomest,3210,695,33,24,57,57.9%,6m
12700,3,[FGDU]fgNemesis,3210,657,29,21,50,58.0%,8m
12700,3,ErzaScarlet,3210,529,25,15,40,62.5%,3m
12700,3,DarkPingDuck,3210,335,24,14,38,63.2%,6m
12700,3,[KSN]DyxectoR,3210,493,21,12,33,63.6%,4m
12700,3,invizMamulek,3210,532,21,21,42,50.0%,14m
12700,3,SerralsLing,3210,602,21,27,48,43.8%,3m
12700,3,Robbog,3210,488,17,20,37,45.9%,10m
12700,3,SkyCrue,3210,428,16,12,28,57.1%,16m
12700,3,[NLS4]cccp,3210,303,16,16,32,50.0%,13m
12700,3,kvkalmin,3210,442,16,17,33,48.5%,14m
12700,3,[ZeDe20]Bogdan,3210,307,15,8,23,65.2%,4m
12700,3,[NoObS]SyKo,3210,404,14,22,36,38.9%,8m
12700,3,[NSJLM]Smidarok,3210,291,11,5,16,68.8%,15m
12700,3,[Ba2c]Zitoine,3210,161,11,7,18,61.1%,11m
12700,3,Kwasny,3210,240,10,4,14,71.4%,4m
12700,3,Ralphman,3210,146,10,6,16,62.5%,13m
12700,3,SOLO,3210,204,10,10,20,50.0%,13m
12700,3,Gid,3210,304,10,21,31,32.3%,17m
12700,3,[Th3Bad]venomskull,3210,225,9,1,10,90.0%,7m
12700,3,Murash,3210,204,7,8,15,46.7%,6m
12700,3,cobaka,3210,119,6,2,8,75.0%,5m
12700,3,Anonymous,3210,112,6,2,8,75.0%,9m
12700,2,elekid,3210,93,5,2,7,71.4%,3m
12700,3,[ZhEba]Siraton,3210,159,5,3,8,62.5%,12m
12700,3,Cocycle,3210,86,4,3,7,57.1%,3m
12700,3,[kiborg]няшка,3210,90,3,4,7,42.9%,9m
12700,3,[PŖïMĄŁ]Agricultor,3210,91,2,1,3,66.7%,11m
12700,3,[DEASY]Bubasetti,3210,30,1,2,3,33.3%,20m
12700,3,[SxOxM]iLoveVicky,3210,0,1,4,5,20.0%,4m
12700,3,Nept,3210,0,0,1,1,0.0%,5m
12700,3,[RekLaW]DTempler,3210,0,0,1,1,0.0%,17m
12700,3,BlazerMan,3210,0,0,1,1,0.0%,4m
12700,3,NYT,3210,0,0,1,1,0.0%,10m
12739,3,CCR,3209,585,120,97,217,55.3%,6m
12739,3,Breaker,3209,591,85,69,154,55.2%,11m
12739,3,Lazard,3209,159,75,61,136,55.1%,5m
12739,3,nixo,3209,998,75,62,137,54.7%,10m
12739,3,rabosot,3209,571,72,79,151,47.7%,12m
12739,3,[fam1ly]KinpachLordX,3209,886,68,50,118,57.6%,12m
12739,3,REDA,3209,1578,67,66,133,50.4%,12m
12739,3,Admin,3209,1153,61,59,120,50.8%,20m
12739,3,Claw,3209,1201,58,57,115,50.4%,17m
12739,3,Vilburn,3209,1302,50,52,102,49.0%,15m
12739,3,Goodboi,3209,398,33,17,50,66.0%,15m
12739,3,orcin,3209,687,29,18,47,61.7%,7m
12739,3,socialinput,3209,679,29,21,50,58.0%,17m
12739,3,[ТМC]zakkat,3209,638,23,23,46,50.0%,5m
12739,3,[THRLLA]sixofsouls,3209,208,14,10,24,58.3%,5m
12739,1,WesCoriginal,3209,232,11,1,12,91.7%,20m
12739,3,[ONG]gdog,3209,286,9,10,19,47.4%,12m
12739,3,Darktar,3209,94,4,8,12,33.3%,5m
12739,2,Timotjeeh,3209,95,2,1,3,66.7%,50m
12739,2,JackieChan,3209,0,2,3,5,40.0%,18m
12739,3,[zukaCo]Kyamsa,3209,62,2,5,7,28.6%,5m
12739,3,Link,3209,95,1,1,2,50.0%,3m
12739,3,[ǂŢǂ]Alen,3209,94,1,1,2,50.0%,18m
12739,3,Crowley,3209,88,1,1,2,50.0%,7m
12739,3,DarthStellar,3209,0,0,1,1,0.0%,8m
12739,3,ТёмТёмыч,3209,0,0,1,1,0.0%,8m
12739,3,[TvTDD]Volkers,3209,0,0,4,4,0.0%,4m
12766,3,[NANE]Ortsyd,3208,1559,115,111,226,50.9%,16m
12766,3,Panda,3208,1599,104,103,207,50.2%,4m
12766,3,Björn,3208,969,102,95,197,51.8%,20m
12766,3,[Dobro]PontyPilat,3208,1025,75,62,137,54.7%,19m
12766,3,[RUINPP]Prax,3208,900,59,50,109,54.1%,12m
12766,3,WhoRlyCares,3208,425,58,56,114,50.9%,6m
12766,3,Lappen,3208,1166,45,46,91,49.5%,11m
12766,3,wetfartosis,3208,755,43,31,74,58.1%,13m
12766,3,Lionin,3208,742,42,32,74,56.8%,18m
12766,3,elven,3208,987,41,31,72,56.9%,16m
12766,3,NastyNoob,3208,892,37,31,68,54.4%,22m
12766,3,[PŖïMĄŁ]수상자 작품,3208,932,34,38,72,47.2%,5m
12766,3,[QTclub]YoAnSingSong,3208,648,26,24,50,52.0%,22m
12766,3,[HAYTER]Pete,3208,596,24,19,43,55.8%,3m
12766,3,ElDhoine,3208,458,18,11,29,62.1%,4m
12766,3,WarBuffett,3208,269,14,4,18,77.8%,15m
12766,3,icik,3208,398,14,21,35,40.0%,15m
12766,3,Caponetti,3208,392,14,23,37,37.8%,8m
12766,3,Amorin,3208,362,12,14,26,46.2%,8m
12766,2,AydenClay,3208,313,11,7,18,61.1%,4m
12766,3,Fafer,3208,242,11,9,20,55.0%,5m
12766,3,[Onanis]Garlic,3208,249,11,10,21,52.4%,2m
12766,3,IIIIIIIIIIII,3208,322,11,12,23,47.8%,4m
12766,3,Relak,3208,90,11,13,24,45.8%,6m
12766,3,WannaBeAce,3208,270,10,19,29,34.5%,10m
12766,3,[DINGS]YYZ,3208,292,9,9,18,50.0%,16m
12766,3,wwwSEOtaxi,3208,258,9,10,19,47.4%,6m
12766,3,qwpo,3208,234,8,6,14,57.1%,16m
12766,3,Eternastu,3208,215,7,4,11,63.6%,6m
12766,3,Ghali,3208,0,3,1,4,75.0%,15m
12766,3,genius,3208,120,3,1,4,75.0%,5m
12766,3,Rhedone,3208,115,3,2,5,60.0%,4m
12766,3,Bouce,3208,58,2,5,7,28.6%,3m
12766,3,Amarant,3208,0,1,0,1,100.0%,10m
12766,3,Nybod,3208,0,1,2,3,33.3%,12m
12766,3,Polar,3208,30,1,5,6,16.7%,6m
12766,3,ChuckNorris,3208,0,0,1,1,0.0%,16m
12803,3,milicko,3207,1579,242,227,469,51.6%,15m
12803,3,[bullD]Семен,3207,1576,234,245,479,48.9%,3m
12803,3,[369]Regulus,3207,1530,196,183,379,51.7%,6m
12803,3,[PiGPan]Conzy,3207,1576,155,160,315,49.2%,10m
12803,3,Flo,3207,413,118,96,214,55.1%,6m
12803,3,[7wonde]Lithium,3207,1553,94,96,190,49.5%,14m
12803,2,Denis,3207,722,92,93,185,49.7%,19m
12803,3,[Донный]GRIF,3207,1478,85,50,135,63.0%,21m
12803,3,Thisisboo,3207,985,42,39,81,51.9%,4m
12803,3,FullContact,3207,943,36,32,68,52.9%,7m
12803,3,IIIIIIIIIIII,3207,939,35,34,69,50.7%,12m
12803,3,OptimistiK,3207,658,33,19,52,63.5%,11m
12803,3,Bayek,3207,272,31,15,46,67.4%,6m
12803,3,MATHEMATIK,3207,217,30,26,56,53.6%,12m
12803,3,student,3207,724,26,33,59,44.1%,16m
12803,3,LeChove,3207,566,21,21,42,50.0%,2m
12803,3,INQTV,3207,246,18,8,26,69.2%,21m
12803,3,MMM,3207,428,15,15,30,50.0%,16m
12803,3,[Лень]BoPoH,3207,356,14,8,22,63.6%,8m
12803,3,JonathanLaub,3207,340,14,15,29,48.3%,4m
12803,3,Gerg,3207,263,11,7,18,61.1%,4m
12803,3,Icarus,3207,265,11,8,19,57.9%,4m
12803,3,[SD2006]kadi,3207,172,8,4,12,66.7%,4m
12803,1,Izsha,3207,171,8,5,13,61.5%,22m
12803,3,NaiJi,3207,234,8,9,17,47.1%,3m
12803,3,[SeVenV]Tamamo,3207,234,7,5,12,58.3%,14m
12803,3,[18v25]kvodan,3207,172,7,8,15,46.7%,20m
12803,3,FleetCommand,3207,101,6,1,7,85.7%,4m
12803,1,Xiss,3207,145,6,4,10,60.0%,57m
12803,3,[ІDDQD]BFG,3207,172,6,11,17,35.3%,19m
12803,3,MapleLeaf,3207,140,4,1,5,80.0%,16m
12803,3,Маэрс,3207,116,4,9,13,30.8%,4m
12803,3,Dikanda,3207,59,3,5,8,37.5%,7m
12803,3,[FD030]Megatron,3207,90,3,6,9,33.3%,5m
12803,3,MaxWhite,3207,30,2,1,3,66.7%,6m
12803,2,PaCJlaboHeC,3207,141,2,3,5,40.0%,34m
12803,3,Prisonerd,3207,30,2,7,9,22.2%,17m
12803,3,MEfrantik,3207,0,1,0,1,100.0%,15m
12803,2,NiCeViBeZZ,3207,0,1,0,1,100.0%,4m
12803,3,[PaniC]Winter,3207,95,1,1,2,50.0%,3m
12803,1,Territum,3207,46,1,1,2,50.0%,41m
12803,3,[DR4ST1]lejlot,3207,0,1,1,2,50.0%,19m
12803,3,Micton,3207,0,1,7,8,12.5%,20m
12803,3,[RPJC]TCHITCHI,3207,0,0,2,2,0.0%,10m
12803,3,Clément,3207,0,0,7,7,0.0%,3m
12848,3,OneOfFive,3206,1530,184,186,370,49.7%,6m
12848,3,[I77I]Doc,3206,1533,112,110,222,50.5%,8m
12848,3,Hazi,3206,953,102,94,196,52.0%,22m
12848,3,[Run974]Mordoress,3206,870,74,63,137,54.0%,15m
12848,3,wekzzz,3206,732,74,65,139,53.2%,10m
12848,3,PrZrStalky,3206,578,53,55,108,49.1%,7m
12848,3,Talder,3206,774,39,17,56,69.6%,17m
12848,3,[THST]Khelghar,3206,733,36,15,51,70.6%,8m
12848,3,LeToïToï,3206,596,33,20,53,62.3%,4m
12848,3,Makar,3206,532,25,17,42,59.5%,16m
12848,3,Fruityloop,3206,637,25,22,47,53.2%,5m
12848,3,ich,3206,518,20,16,36,55.6%,4m
12848,3,Gelo,3206,349,17,26,43,39.5%,19m
12848,3,[hf4X4]Parapoomba,3206,132,14,9,23,60.9%,13m
12848,3,wicked,3206,370,14,17,31,45.2%,5m
12848,3,Vesuvius,3206,185,8,5,13,61.5%,6m
12848,3,[TWCE]Whodis,3206,206,8,9,17,47.1%,21m
12848,3,Fenor,3206,230,8,14,22,36.4%,15m
12848,3,Ignotus,3206,148,6,6,12,50.0%,12m
12848,3,Vackjo,3206,178,6,12,18,33.3%,12m
12848,3,Relentless,3206,0,5,0,5,100.0%,8m
12848,3,DreamCake,3206,146,5,7,12,41.7%,15m
12848,3,Habicht,3206,160,5,15,20,25.0%,4m
12848,3,Kira,3206,168,4,4,8,50.0%,10m
12848,3,Lars,3206,0,1,0,1,100.0%,4m
12848,3,[Mavis]rodeo,3206,0,1,1,2,50.0%,15m
12848,3,RandomFish,3206,0,1,4,5,20.0%,35m
12848,3,AshlynRae,3206,91,1,5,6,16.7%,6m
12848,3,[SEWP]Arthur,3206,0,0,1,1,0.0%,7m
12848,3,[яєѕ]NinEleven,3206,0,0,1,1,0.0%,18m
12848,3,leO,3206,0,0,2,2,0.0%,15m
12848,3,[SALAMI]XanTos,3206,0,0,2,2,0.0%,6m
12848,3,Wyrm,3206,0,0,3,3,0.0%,7m
12881,3,JackRackham,3205,926,72,59,131,55.0%,16m
12881,3,[GymBoy]MucKaBoy,3205,952,70,56,126,55.6%,15m
12881,3,Tide,3205,1068,64,19,83,77.1%,13m
12881,3,[Mądry]Goldimaksvel,3205,1056,62,56,118,52.5%,7m
12881,3,[KaMakt]Zeke,3205,766,53,47,100,53.0%,6m
12881,3,Paradisum,3205,1173,49,38,87,56.3%,17m
12881,3,[NoMøre]ObTortoCollo,3205,800,37,29,66,56.1%,18m
12881,3,TwoBx,3205,725,31,22,53,58.5%,16m
12881,3,LittleAce,3205,778,31,40,71,43.7%,7m
12881,3,TimGold,3205,386,28,22,50,56.0%,22m
12881,3,[NoSepi]TheMarcklar,3205,816,27,33,60,45.0%,5m
12881,3,[RB7m]EvilHippie,3205,604,25,21,46,54.3%,7m
12881,3,[wpwpwp]Positron,3205,375,18,10,28,64.3%,7m
12881,3,MrCrowley,3205,332,14,16,30,46.7%,4m
12881,3,SoundAsleep,3205,286,12,3,15,80.0%,17m
12881,3,[PiGPan]BKS,3205,122,9,16,25,36.0%,19m
12881,3,EvilDwarf,3205,144,8,3,11,72.7%,3m
12881,3,[ĦĦ]Dubu,3205,189,8,6,14,57.1%,4m
12881,3,Grodden,3205,241,7,8,15,46.7%,19m
12881,3,SweetRamekin,3205,141,6,4,10,60.0%,7m
12881,3,DuskLight,3205,108,5,2,7,71.4%,13m
12881,3,Spacegoat,3205,169,5,3,8,62.5%,7m
12881,1,Oted,3205,119,4,2,6,66.7%,54m
12881,3,Razingbal,3205,161,4,3,7,57.1%,11m
12881,3,Fatal,3205,140,3,2,5,60.0%,8m
12881,3,vita,3205,116,2,2,4,50.0%,19m
12881,3,HoplaGeiss,3205,60,2,3,5,40.0%,10m
12881,3,DinoZavr,3205,0,1,0,1,100.0%,21m
12881,2,IndraRinne,3205,0,1,0,1,100.0%,3m
12881,3,Rafix,3205,0,0,1,1,0.0%,20m
12881,3,ipman,3205,0,0,1,1,0.0%,16m
12881,3,Zonghuo,3205,0,0,5,5,0.0%,15m
12913,2,Defmatt,3204,1547,226,237,463,48.8%,8m
12913,3,Fudge,3204,1296,48,50,98,49.0%,5m
12913,3,[Йольфы]GhostDragon,3204,931,45,28,73,61.6%,8m
12913,3,JustNoob,3204,684,34,21,55,61.8%,14m
12913,3,[usbr]Broformist,3204,685,30,29,59,50.8%,4m
12913,3,Spyder,3204,429,20,14,34,58.8%,3m
12913,3,kurva,3204,502,18,20,38,47.4%,11m
12913,3,DarkDiest,3204,488,18,21,39,46.2%,13m
12913,3,Nikrosk,3204,388,15,10,25,60.0%,21m
12913,3,SKilada,3204,330,12,7,19,63.2%,19m
12913,3,kakaru,3204,270,10,11,21,47.6%,20m
12913,3,Yago,3204,245,7,7,14,50.0%,5m
12913,3,Seka,3204,0,5,0,5,100.0%,10m
12913,3,Vallen,3204,127,5,6,11,45.5%,15m
12913,3,Feelgood,3204,90,4,4,8,50.0%,7m
12913,3,[DМG]Miaonel,3204,58,3,2,5,60.0%,12m
12913,3,Neon,3204,94,2,0,2,100.0%,18m
12913,3,VerseUni,3204,30,2,3,5,40.0%,11m
12913,3,Lobotom,3204,0,0,2,2,0.0%,11m
12932,3,Markulf,3203,1083,102,87,189,54.0%,15m
12932,3,Kintamani,3203,887,101,97,198,51.0%,8m
12932,3,[A2C]Alkyrrion,3203,1577,93,84,177,52.5%,15m
12932,3,HeaSteN,3203,1187,82,68,150,54.7%,6m
12932,3,[CoL]newt,3203,1053,75,59,134,56.0%,15m
12932,3,Sequence,3203,878,40,22,62,64.5%,13m
12932,3,OnlyFlans,3203,653,38,41,79,48.1%,4m
12932,3,[HJMNG]Totem,3203,925,37,30,67,55.2%,4m
12932,3,[STerra]Javasek,3203,828,30,32,62,48.4%,6m
12932,3,MadScientist,3203,692,28,23,51,54.9%,17m
12932,3,Nuggat,3203,524,25,22,47,53.2%,5m
12932,3,[glhf20]Sok,3203,660,24,20,44,54.5%,9m
12932,3,Treemanula,3203,504,18,23,41,43.9%,12m
12932,3,[bullD]FiftyZerg,3203,348,14,6,20,70.0%,7m
12932,3,[TThe]KalljuMarju,3203,149,14,10,24,58.3%,13m
12932,3,agressoR,3203,228,10,7,17,58.8%,12m
12932,3,SaturniN,3203,234,9,17,26,34.6%,17m
12932,3,IIIIIIIIIIII,3203,226,7,17,24,29.2%,19m
12932,3,[SliMEe]IIIIIIIIIIII,3203,191,6,1,7,85.7%,4m
12932,3,Clozer,3203,177,5,3,8,62.5%,10m
12932,3,Prostata,3203,137,4,1,5,80.0%,4m
12932,3,PapaNoil,3203,118,4,5,9,44.4%,4m
12932,3,Tapzi,3203,92,3,12,15,20.0%,12m
12932,3,lionzlow,3203,121,2,2,4,50.0%,12m
12932,3,[HBGS]GladiaThor,3203,0,1,0,1,100.0%,18m
12932,3,Someone,3203,0,1,0,1,100.0%,4m
12932,3,mrluiaard,3203,0,1,0,1,100.0%,18m
12932,3,[Catory]Kacpeross,3203,0,1,1,2,50.0%,17m
12932,3,Daisyk,3203,30,1,2,3,33.3%,4m
12932,3,[Hrr]Bargmr,3203,30,1,4,5,20.0%,19m
12932,3,[ERASER]Shadow,3203,0,0,2,2,0.0%,3m
12963,3,[Schnok]Joukov,3202,1160,75,81,156,48.1%,12m
12963,3,[QZC]Falamir,3202,899,55,50,105,52.4%,13m
12963,2,Stazerg,3202,1421,49,68,117,41.9%,2m
12963,3,[TheDOH]Grubson,3202,955,47,46,93,50.5%,17m
12963,3,[SWE]LaxSalmon,3202,400,44,42,86,51.2%,22m
12963,3,Wingent,3202,751,39,13,52,75.0%,4m
12963,3,[CsTr]chudatta,3202,736,26,33,59,44.1%,5m
12963,3,ZincSaucier,3202,371,25,20,45,55.6%,3m
12963,3,Mkpolonel,3202,482,24,12,36,66.7%,21m
12963,3,FoTh,3202,473,19,13,32,59.4%,7m
12963,3,MapleJoe,3202,558,19,19,38,50.0%,18m
12963,3,IIIIIIIIIIII,3202,357,13,9,22,59.1%,15m
12963,1,mlo,3202,254,11,10,21,52.4%,8m
12963,2,[THANOS]Swarm,3202,152,9,9,18,50.0%,10m
12963,3,[BWArmy]yaze,3202,224,8,5,13,61.5%,4m
12963,3,[33cl]NeSs,3202,144,7,3,10,70.0%,8m
12963,3,Tzaa,3202,170,5,7,12,41.7%,20m
12963,3,SCream,3202,156,5,15,20,25.0%,7m
12963,3,TheKobra,3202,0,4,1,5,80.0%,7m
12963,3,onlinehero,3202,138,4,2,6,66.7%,5m
12963,3,[IRBD]Subutai,3202,95,3,1,4,75.0%,8m
12963,2,IIIIIIIIIIII,3202,113,3,3,6,50.0%,5m
12963,3,[NTuna]PEREidurale,3202,94,2,0,2,100.0%,9m
12963,3,[DutchG]sparten,3202,38,2,3,5,40.0%,15m
12963,3,FeldJäger,3202,119,2,3,5,40.0%,4m
12963,3,NPGCMadGuy,3202,60,2,4,6,33.3%,4m
12963,3,Fenfen,3202,58,2,5,7,28.6%,11m
12963,1,[mfixed]Dzionny,3202,122,2,8,10,20.0%,21m
12963,3,Nova,3202,93,1,1,2,50.0%,7m
12963,3,llllllllllll,3202,94,1,1,2,50.0%,18m
12963,3,Nsal,3202,0,1,2,3,33.3%,4m
12994,3,Ixisrisko,3201,1428,225,220,445,50.6%,15m
12994,3,[зерно]DREKRASHER,3201,1569,116,74,190,61.1%,15m
12994,3,justme,3201,945,45,36,81,55.6%,10m
12994,3,[74Rus]ДиКиЙнУбАсИк,3201,906,42,28,70,60.0%,17m
12994,3,llllllllllll,3201,575,27,12,39,69.2%,8m
12994,3,Pilgrim,3201,694,27,28,55,49.1%,7m
12994,3,[KAOTx]Browbeat,3201,467,21,14,35,60.0%,14m
12994,3,[SmackB]ZealGoon,3201,205,18,20,38,47.4%,11m
12994,3,DerCremige,3201,306,13,6,19,68.4%,12m
12994,3,[AciNoN]AngryFrog,3201,255,11,3,14,78.6%,19m
12994,3,[YEP4VR]Fire,3201,136,10,8,18,55.6%,11m
12994,3,[RSPD]denchik,3201,198,10,12,22,45.5%,10m
12994,3,[GSTAR]Pain,3201,247,9,4,13,69.2%,4m
12994,3,[ARG]vincaa,3201,253,9,10,19,47.4%,7m
12994,3,[4GGsc]Soulz,3201,242,8,12,20,40.0%,5m
12994,3,PapyTony,3201,170,6,1,7,85.7%,21m
12994,3,Zeyqs,3201,44,5,1,6,83.3%,41m
12994,3,steve,3201,163,4,3,7,57.1%,19m
12994,3,Prefferance,3201,60,2,5,7,28.6%,13m
12994,3,IIIIIIIIIIII,3201,0,1,0,1,100.0%,9m
12994,3,[DøA]asu,3201,92,1,1,2,50.0%,8m
12994,3,avebHyperion,3201,0,1,1,2,50.0%,20m
12994,3,Dragonmaster,3201,30,1,2,3,33.3%,6m
12994,3,[GdAT]Ciclyde,3201,30,1,3,4,25.0%,1m
12994,3,[lLiTl]fis,3201,97,1,3,4,25.0%,37m
12994,3,[FOX]JinSuS,3201,30,1,4,5,20.0%,3m
12994,3,[MyN]Aanonymous,3201,0,0,1,1,0.0%,9m
12994,3,[SCAC]ObsidiaN,3201,0,0,1,1,0.0%,4m
12994,3,Chrthegreat,3201,0,0,1,1,0.0%,7m
12994,3,Koma,3201,0,0,1,1,0.0%,10m
12994,3,[3DE]Checkmate,3201,0,0,3,3,0.0%,7m
13025,3,Nyx,3200,728,188,177,365,51.5%,8m
13025,3,Breakger,3200,1489,135,117,252,53.6%,6m
13025,3,[3Macro]Бонапарт,3200,1457,80,35,115,69.6%,19m
13025,3,[Sativa]SNEG,3200,1302,63,54,117,53.8%,17m
13025,3,mrDudzich,3200,1367,63,66,129,48.8%,11m
13025,3,Johnny,3200,926,44,38,82,53.7%,5m
13025,3,AltaiR,3200,757,36,20,56,64.3%,5m
13025,3,Lumiel,3200,571,34,10,44,77.3%,8m
13025,3,VoidWanderer,3200,698,28,18,46,60.9%,5m
13025,3,renren,3200,744,27,31,58,46.6%,10m
13025,3,jITO,3200,492,21,13,34,61.8%,12m
13025,3,[MAKinG]xTrIckKsHotx,3200,383,17,8,25,68.0%,6m
13025,3,[GH2]PaLTiMeDuTou,3200,328,12,8,20,60.0%,3m
13025,3,renok,3200,256,8,7,15,53.3%,22m
13025,1,AdVictoriam,3200,40,5,1,6,83.3%,18m
13025,2,ChristineEVE,3200,121,5,2,7,71.4%,51m
13025,1,[OSgZ]Hednar,3200,170,4,10,14,28.6%,11m
13025,3,Hagmak,3200,0,3,1,4,75.0%,15m
13025,3,[Rofler]Camille,3200,60,3,4,7,42.9%,1m
13025,3,[Zboubz]Titisnake,3200,0,2,0,2,100.0%,24m
13025,1,Stalker,3200,42,2,0,2,100.0%,3m
13025,3,[PigFTW]dominikxD,3200,117,2,2,4,50.0%,7m
13025,1,icks,3200,0,1,0,1,100.0%,12m
13025,3,Vudurlak,3200,0,1,0,1,100.0%,22m
13025,3,ProGTsw,3200,30,1,4,5,20.0%,19m
13025,1,Chillking,3200,0,0,1,1,0.0%,6m
13025,3,ILoveBlades,3200,0,0,2,2,0.0%,19m
13025,3,Neezone,3200,0,0,2,2,0.0%,17m
13053,3,ArtBitter,3199,1433,314,284,598,52.5%,6m
13053,3,moulk,3199,1541,71,58,129,55.0%,4m
13053,3,ЧеДаКак,3199,698,29,28,57,50.9%,5m
13053,3,[STONKS]Pepuz,3199,680,24,26,50,48.0%,2m
13053,3,uuuuuuuuuuuu,3199,402,15,13,28,53.6%,12m
13053,3,[NLR]bobRiTo,3199,370,13,17,30,43.3%,13m
13053,3,Deicide,3199,312,11,8,19,57.9%,12m
13053,1,IIIIIIIIII,3199,205,9,5,14,64.3%,21m
13053,1,Mejor,3199,208,7,3,10,70.0%,45m
13053,3,Milczek,3199,180,6,11,17,35.3%,11m
13053,1,Kreios,3199,44,2,0,2,100.0%,6m
13053,3,beno,3199,30,2,2,4,50.0%,4m
13053,1,[FuTeam]Niglo,3199,0,1,0,1,100.0%,20m
13053,1,Ворюга,3199,0,1,0,1,100.0%,1m
13053,2,HarrisonFord,3199,0,1,0,1,100.0%,1h
13053,3,[SonAsg]Alpha,3199,0,1,1,2,50.0%,22m
13053,3,[EPIX]Kalime,3199,0,1,1,2,50.0%,5m
13053,1,OmarEightTwo,3199,0,0,1,1,0.0%,5m
13053,1,Gorfirst,3199,0,0,1,1,0.0%,22m
13053,1,StellRAY,3199,0,0,1,1,0.0%,4m
13053,3,Sky,3199,0,0,2,2,0.0%,9m
13074,3,[NMSQ]Fullar,3198,1530,415,411,826,50.2%,2m
13074,3,JKtheMaster,3198,1514,276,286,562,49.1%,18m
13074,1,nika,3198,1505,134,109,243,55.1%,18m
13074,3,IIIIIIIIIIII,3198,551,78,56,134,58.2%,8m
13074,3,LastEngineer,3198,861,61,54,115,53.0%,9m
13074,3,[ULTX]FeuerDrache,3198,1070,48,46,94,51.1%,3m
13074,3,[Newbie]Jacer,3198,587,48,48,96,50.0%,6m
13074,3,Zhenksta,3198,148,6,6,12,50.0%,7m
13074,3,Eadris,3198,121,5,2,7,71.4%,32m
13074,3,SupeRLolitA,3198,0,1,1,2,50.0%,16m
13074,3,Voldemar,3198,0,1,2,3,33.3%,4m
13074,3,Intro,3198,94,1,2,3,33.3%,11m
13074,3,[DL2006]Roithar,3198,30,1,6,7,14.3%,13m
13074,1,[WBO]Domen,3198,0,0,1,1,0.0%,11m
13074,1,Flint,3198,0,0,1,1,0.0%,8m
13074,1,Tvorobey,3198,0,0,2,2,0.0%,1h
13090,3,Vadim,3197,1541,392,359,751,52.2%,3m
13090,3,Creepiecal,3197,1517,106,96,202,52.5%,11m
13090,3,[RBP3]zeverynth,3197,1340,100,97,197,50.8%,2m
13090,3,Tear,3197,1550,85,84,169,50.3%,17m
13090,3,Drown,3197,838,59,48,107,55.1%,3m
13090,3,[HZeS]Deadanarchit,3197,431,30,21,51,58.8%,5m
13090,3,[CHOPAA]NAGIBATOR,3197,698,25,31,56,44.6%,12m
13090,3,Lyurax,3197,484,18,14,32,56.2%,1m
13090,3,Orwen,3197,320,15,12,27,55.6%,3m
13090,3,KenndaL,3197,214,11,6,17,64.7%,10m
13090,3,Nowarich,3197,86,6,7,13,46.2%,2m
13090,1,Shuler,3197,161,5,3,8,62.5%,17m
13090,1,Cicada,3197,40,4,2,6,66.7%,11m
13090,3,Repek,3197,44,4,3,7,57.1%,30m
13090,3,Mylo,3197,88,3,3,6,50.0%,11m
13090,3,[synTWD]Roach,3197,60,3,6,9,33.3%,8m
13090,3,HydraXY,3197,92,3,8,11,27.3%,21m
13090,1,[scp3]moussaka,3197,0,1,0,1,100.0%,3m
13090,1,Crackling,3197,44,1,1,2,50.0%,2m
13090,3,[VetM]KimboSlice,3197,0,1,8,9,11.1%,18m
13090,1,Rame,3197,0,0,1,1,0.0%,11m
13090,1,Bradis,3197,0,0,1,1,0.0%,3m
13112,3,Garryrage,3196,1573,198,199,397,49.9%,9m
13112,3,Poual,3196,1205,73,64,137,53.3%,21m
13112,1,[RBMS]Fenrir,3196,1480,66,51,117,56.4%,1m
13112,3,VollmoG,3196,1438,60,55,115,52.2%,6m
13112,3,Ungraceful,3196,435,37,50,87,42.5%,7m
13112,3,[Horst]Callahan,3196,735,31,23,54,57.4%,10m
13112,1,Snowflake,3196,389,13,6,19,68.4%,4m
13112,2,[IceHus]llllllllll,3196,277,10,6,16,62.5%,9m
13112,1,Dreadnogh,3196,234,9,4,13,69.2%,53m
13112,1,Bingo,3196,158,5,2,7,71.4%,6m
13112,3,MattTheCruel,3196,44,5,2,7,71.4%,4m
13112,3,Interitum,3196,0,3,1,4,75.0%,2m
13112,3,red,3196,60,3,3,6,50.0%,22m
13112,2,[WaCKi]Tsuo,3196,95,2,1,3,66.7%,58m
13112,3,ALASTHOR,3196,62,2,5,7,28.6%,12m
13112,3,iloveoof,3196,0,1,1,2,50.0%,10m
13112,1,Kleshtar,3196,0,0,1,1,0.0%,22m
13112,1,Hieroglyphs,3196,0,0,1,1,0.0%,5m
13112,1,[SøG]Ifer,3196,0,0,1,1,0.0%,7m
13112,3,[VETS]ImaG,3196,0,0,2,2,0.0%,5m
13112,3,[VYCM]MusIC,3196,0,0,2,2,0.0%,4m
13133,3,Gaudino,3195,1456,208,214,422,49.3%,22m
13133,3,ADS,3195,1307,123,119,242,50.8%,5m
13133,3,[SUI]Marcel,3195,1481,113,120,233,48.5%,22m
13133,3,Tactics,3195,448,96,82,178,53.9%,3m
13133,3,Salaberri,3195,1450,91,62,153,59.5%,3m
13133,3,[NWGD]OVERMIND,3195,733,82,53,135,60.7%,5m
13133,3,Dest,3195,1635,82,93,175,46.9%,2m
13133,3,Andartis,3195,331,30,29,59,50.8%,4m
13133,1,lIlIlIlIlI,3195,444,22,4,26,84.6%,12m
13133,3,DeadMage,3195,326,19,11,30,63.3%,9m
13133,3,Fistalk,3195,285,14,6,20,70.0%,21m
13133,3,Attila,3195,317,11,9,20,55.0%,4m
13133,3,Pain,3195,165,8,7,15,53.3%,4m
13133,3,ELIS,3195,97,5,1,6,83.3%,27m
13133,3,[GoTx]Kozel,3195,93,5,7,12,41.7%,4m
13133,3,[RSOF1]LSBOSSES,3195,58,2,5,7,28.6%,7m
13133,3,anomolokaris,3195,60,2,5,7,28.6%,13m
13133,3,sonkeyton,3195,0,2,6,8,25.0%,7m
13133,3,SwordFish,3195,0,1,4,5,20.0%,5m
13133,1,Vertar,3195,0,0,1,1,0.0%,8m
13133,1,cjk,3195,0,0,1,1,0.0%,5m
13133,3,Delete,3195,0,0,2,2,0.0%,10m
13155,3,opponentX,3194,1470,313,315,628,49.8%,16m
13155,3,KOJI,3194,1089,214,224,438,48.9%,4m
13155,3,PINGVIN,3194,1557,122,102,224,54.5%,21m
13155,3,Kunati,3194,1613,73,73,146,50.0%,17m
13155,3,MCT,3194,553,39,45,84,46.4%,11m
13155,3,Luiso,3194,755,33,21,54,61.1%,12m
13155,3,Hools,3194,505,20,16,36,55.6%,11m
13155,3,mathz,3194,466,19,15,34,55.9%,15m
13155,3,[ZERGSC]MrZerg,3194,456,18,21,39,46.2%,19m
13155,3,Qnugg,3194,284,10,15,25,40.0%,4m
13155,1,Tanabe,3194,214,6,7,13,46.2%,22m
13155,3,Next,3194,166,6,9,15,40.0%,2m
13155,1,JurGołinDałn,3194,0,5,0,5,100.0%,4m
13155,3,Smile,3194,121,5,2,7,71.4%,44m
13155,1,[Caz]Stig,3194,0,4,1,5,80.0%,21m
13155,3,Reese,3194,60,3,5,8,37.5%,5m
13155,1,VectorBundle,3194,112,2,2,4,50.0%,3m
13155,1,[BBW]StrawB,3194,0,1,0,1,100.0%,20m
13155,3,Banzai,3194,30,1,11,12,8.3%,18m
13155,1,KakTyC,3194,0,0,1,1,0.0%,10m
13155,3,varciasz,3194,0,0,2,2,0.0%,12m
13155,3,[K0mpis]Obba,3194,0,0,2,2,0.0%,7m
13155,3,[Sabat]Baikotesla,3194,0,0,2,2,0.0%,20m
13155,3,[H0C]iDrone,3194,0,0,2,2,0.0%,11m
13155,3,chewe,3194,0,0,4,4,0.0%,2m
13180,3,DarkSun,3193,1336,102,104,206,49.5%,11m
13180,3,AlexSURmaN,3193,1182,44,47,91,48.4%,20m
13180,3,Axces,3193,732,43,34,77,55.8%,12m
13180,3,MapleLeaf,3193,451,39,25,64,60.9%,16m
13180,3,Excalibur,3193,731,39,50,89,43.8%,16m
13180,3,Dyda,3193,186,33,25,58,56.9%,11m
13180,3,Ascendo,3193,856,29,46,75,38.7%,10m
13180,3,[BFG3K]Arek,3193,626,24,24,48,50.0%,4m
13180,3,[GZerO]glhfwptyfuuU,3193,622,24,30,54,44.4%,9m
13180,3,MikeTheSpike,3193,490,22,17,39,56.4%,16m
13180,3,Odysseus,3193,458,20,14,34,58.8%,22m
13180,3,Ten,3193,387,19,13,32,59.4%,7m
13180,1,Feanor,3193,642,18,15,33,54.5%,2m
13180,1,MarDuK,3193,323,14,9,23,60.9%,4m
13180,1,[H0C]softmax,3193,332,13,11,24,54.2%,20m
13180,3,BeastyFlw,3193,156,7,11,18,38.9%,3m
13180,3,[INCTS]QuillZel,3193,150,6,13,19,31.6%,13m
13180,3,[PaniC]BeMole,3193,133,3,4,7,42.9%,8m
13180,3,Илья,3193,62,3,5,8,37.5%,4m
13180,3,Nekrolin,3193,30,2,2,4,50.0%,8m
13180,3,Deneb,3193,30,2,6,8,25.0%,15m
13180,3,[HELENE]ChimpwOw,3193,0,1,0,1,100.0%,7m
13180,1,IWolverineI,3193,0,0,1,1,0.0%,18m
13180,1,hopjesvla,3193,0,0,1,1,0.0%,9m
13180,1,[PerúES]SilensDark,3193,0,0,1,1,0.0%,4m
13180,1,[ZINNBA]supermarine,3193,0,0,1,1,0.0%,9m
13180,1,MagicLobster,3193,0,0,1,1,0.0%,19m
13180,3,Disturbers,3193,0,0,2,2,0.0%,7m
13180,3,antip,3193,0,0,2,2,0.0%,5m
13209,3,CVDH,3192,1553,222,212,434,51.2%,22m
13209,3,Semaka,3192,1490,64,63,127,50.4%,1m
13209,3,lollif,3192,1229,53,44,97,54.6%,3m
13209,3,Tenelt,3192,176,38,15,53,71.7%,3m
13209,3,[AiRǂ]SwaiX,3192,814,34,47,81,42.0%,10m
13209,3,Prizrak,3192,588,23,19,42,54.8%,7m
13209,3,Zee,3192,386,19,16,35,54.3%,5m
13209,3,[сSсǃ]SiriuS,3192,280,9,17,26,34.6%,4m
13209,3,lewfen,3192,180,6,7,13,46.2%,21m
13209,3,WoutVanAert,3192,30,5,3,8,62.5%,3m
13209,1,Kharnis,3192,122,3,1,4,75.0%,12m
13209,3,Qwerty,3192,115,3,1,4,75.0%,16m
13209,3,[SZM]Sole,3192,117,3,3,6,50.0%,1m
13209,3,Skwisgaar,3192,32,2,2,4,50.0%,13m
13209,3,[3Dcla]Alexlocky,3192,60,2,4,6,33.3%,3m
13209,3,Coffie,3192,94,1,2,3,33.3%,5m
13209,3,[THound]blank,3192,0,1,4,5,20.0%,4m
13209,3,SchizoNOR,3192,0,0,3,3,0.0%,18m
13227,3,[PPooDo]gstrit,3191,1616,131,126,257,51.0%,4m
13227,3,Toasted,3191,1217,103,104,207,49.8%,6m
13227,3,Test,3191,1382,83,72,155,53.5%,5m
13227,3,altushka,3191,557,75,64,139,54.0%,22m
13227,3,[LLTeam]Briac,3191,1469,58,51,109,53.2%,8m
13227,3,Dante,3191,1207,46,43,89,51.7%,4m
13227,3,NeagerPins,3191,494,42,44,86,48.8%,5m
13227,3,Leithar,3191,879,38,31,69,55.1%,2m
13227,1,smartmen,3191,676,21,20,41,51.2%,7m
13227,3,romchikk,3191,499,20,12,32,62.5%,10m
13227,3,BeefSirPreme,3191,392,14,19,33,42.4%,22m
13227,3,NajiM,3191,156,6,8,14,42.9%,19m
13227,3,[MaruGd]ChinaNoOne,3191,140,4,0,4,100.0%,6m
13227,3,Mareczek,3191,0,4,1,5,80.0%,44m
13227,3,Wilson,3191,0,4,1,5,80.0%,4m
13227,1,DanceManiac,3191,42,1,1,2,50.0%,9m
13227,3,Avarail,3191,0,1,2,3,33.3%,18m
13227,3,Yxos,3191,30,1,3,4,25.0%,8m
13227,3,Tobmob,3191,30,1,5,6,16.7%,4m
13227,1,porKpie,3191,0,0,1,1,0.0%,12m
13227,1,[RVodka]umD,3191,0,0,1,1,0.0%,10m
13248,3,Envy,3190,1291,78,77,155,50.3%,18m
13248,3,[QTclub]Ромашка,3190,1041,68,46,114,59.6%,12m
13248,3,Darktempest,3190,541,25,22,47,53.2%,2m
13248,3,Zeratul,3190,704,25,27,52,48.1%,5m
13248,3,Lolkek,3190,650,24,26,50,48.0%,9m
13248,3,privetpivz,3190,528,19,23,42,45.2%,6m
13248,1,[MCat]DrOrk,3190,308,13,1,14,92.9%,1m
13248,1,Бульба,3190,256,8,3,11,72.7%,6m
13248,2,Vers,3190,233,8,5,13,61.5%,7m
13248,3,Zedus,3190,176,6,3,9,66.7%,1m
13248,1,MrTrackball,3190,160,5,1,6,83.3%,1m
13248,2,MrNiceGuy,3190,96,5,2,7,71.4%,25m
13248,3,Quon,3190,44,5,2,7,71.4%,24m
13248,3,[1TP]heroBrauni,3190,168,4,5,9,44.4%,11m
13248,3,Jont,3190,94,2,1,3,66.7%,12m
13248,3,[trible]JOhN,3190,94,2,1,3,66.7%,21m
13248,3,[LSPs]timocius,3190,30,2,4,6,33.3%,4m
13248,1,galaxion,3190,0,0,1,1,0.0%,2m
13248,3,[A4J]ender,3190,0,0,2,2,0.0%,21m
13267,3,[drrsch]Dosn,3189,1506,122,112,234,52.1%,5m
13267,3,[IndyK]KaaPII,3189,1425,67,73,140,47.9%,19m
13267,3,[N0oBS]Sjefen,3189,924,43,54,97,44.3%,18m
13267,3,EliteBowser,3189,132,26,18,44,59.1%,13m
13267,3,[Nerdom]Scarrin,3189,476,18,19,37,48.6%,4m
13267,2,Genn,3189,275,14,7,21,66.7%,10m
13267,1,Bertalanffy,3189,204,6,2,8,75.0%,22m
13267,2,MagneR,3189,96,5,2,7,71.4%,15m
13267,3,[BWArmy]LiGhtNinG,3189,160,5,2,7,71.4%,10m
13267,1,[BGDK]Viking,3189,206,5,5,10,50.0%,10m
13267,3,Слава,3189,0,4,1,5,80.0%,35m
13267,3,[aW]Chweps,3189,60,3,3,6,50.0%,5m
13267,3,[16yo]Slyce,3189,0,3,3,6,50.0%,16m
13267,1,Advizor,3189,42,2,1,3,66.7%,18m
13267,1,iddqd,3189,125,2,1,3,66.7%,4m
13267,1,Silk,3189,0,1,0,1,100.0%,10m
13267,1,[Fanyy]Filipo,3189,0,0,1,1,0.0%,21m
13267,3,Yagami,3189,0,0,2,2,0.0%,4m
13267,3,[SSOC]JediJoeXXX,3189,0,0,2,2,0.0%,3m
13267,3,[FoDuPo]DonBalloche,3189,0,0,3,3,0.0%,10m
13267,3,Peace,3189,0,0,3,3,0.0%,8m
13288,3,Fluoro,3188,1596,213,223,436,48.9%,22m
13288,3,Kesko,3188,1576,127,119,246,51.6%,7m
13288,3,Sfer,3188,1549,102,102,204,50.0%,16m
13288,3,[VacHr1]ToMo,3188,1338,58,57,115,50.4%,8m
13288,3,goaulD,3188,853,42,51,93,45.2%,5m
13288,3,Ster,3188,371,38,29,67,56.7%,12m
13288,3,грозный,3188,577,33,37,70,47.1%,11m
13288,3,Kinion,3188,470,19,13,32,59.4%,1m
13288,3,[MuL]Oliver,3188,434,18,12,30,60.0%,8m
13288,3,Melkor,3188,237,11,9,20,55.0%,18m
13288,3,Ratce,3188,254,10,10,20,50.0%,16m
13288,1,Sluthusky,3188,213,7,1,8,87.5%,21m
13288,3,[2MS]SosoLeTriton,3188,199,7,3,10,70.0%,18m
13288,1,AlProh,3188,163,7,3,10,70.0%,12m
13288,3,Virus,3188,146,5,8,13,38.5%,2m
13288,1,Fred,3188,84,3,1,4,75.0%,4m
13288,3,[1NFEC7]oneeye,3188,118,3,2,5,60.0%,7m
13288,3,Slemp,3188,86,3,4,7,42.9%,11m
13288,3,[DDiv]Gringo,3188,90,3,5,8,37.5%,7m
13288,1,pipi,3188,134,2,2,4,50.0%,10m
13288,3,Worrag,3188,121,2,3,5,40.0%,14m
13288,2,YoloSwagger,3188,0,1,1,2,50.0%,1m
13288,3,[демоно]Brannty,3188,95,1,2,3,33.3%,12m
13288,3,[DeadDe]Madson,3188,30,1,4,5,20.0%,7m
13288,2,ignite,3188,0,0,1,1,0.0%,19m
13288,1,Pandarroganz,3188,0,0,1,1,0.0%,3m
13288,1,pkv,3188,0,0,1,1,0.0%,21m
13288,1,Igniter,3188,0,0,1,1,0.0%,12m
13288,3,Kitchentable,3188,0,0,2,2,0.0%,13m
13288,3,[TlTTIE]FatalSausage,3188,0,0,3,3,0.0%,16m
13318,3,[TheDOH]RSPOL,3187,805,115,94,209,55.0%,20m
13318,3,BurningBush,3187,1266,68,71,139,48.9%,2m
13318,3,[JIH]Mařen,3187,1150,54,56,110,49.1%,22m
13318,3,out,3187,710,49,37,86,57.0%,10m
13318,3,SpaceCageFuk,3187,951,41,37,78,52.6%,11m
13318,3,Taurus,3187,796,35,26,61,57.4%,19m
13318,1,fittnesszerg,3187,528,33,21,54,61.1%,2m
13318,3,[BND]Gnollface,3187,659,28,25,53,52.8%,6m
13318,3,GoFMido,3187,487,21,11,32,65.6%,20m
13318,3,[DIIF]Dillimaster,3187,448,16,21,37,43.2%,8m
13318,3,RastaRocket,3187,315,15,12,27,55.6%,16m
13318,3,SimpanZz,3187,304,11,14,25,44.0%,20m
13318,1,[LV]TargeT,3187,232,6,3,9,66.7%,54m
13318,3,MrFluffy,3187,164,6,9,15,40.0%,8m
13318,3,TheDoctor,3187,94,5,2,7,71.4%,6m
13318,3,Maximus,3187,180,5,4,9,55.6%,12m
13318,3,Notch,3187,152,5,13,18,27.8%,18m
13318,1,Flatsix,3187,0,4,1,5,80.0%,4m
13318,3,tameremoche,3187,142,4,3,7,57.1%,11m
13318,1,[mfxed]Faldhir,3187,118,3,1,4,75.0%,22m
13318,3,FireFly,3187,44,2,6,8,25.0%,13m
13318,1,[AkaneS]EnEtoRiator,3187,0,1,0,1,100.0%,9m
13318,1,[YlKES]Kotbert,3187,0,0,1,1,0.0%,19m
13341,3,Fil,3186,1567,464,468,932,49.8%,10m
13341,3,MaTthIas,3186,1567,150,122,272,55.1%,21m
13341,3,[300IQ]AverDroz,3186,1030,70,68,138,50.7%,16m
13341,3,fool,3186,1227,47,53,100,47.0%,3m
13341,3,YEYKO,3186,962,40,44,84,47.6%,3m
13341,1,RaPh,3186,389,12,16,28,42.9%,4m
13341,3,EVAsian,3186,108,7,1,8,87.5%,17m
13341,1,Sally,3186,190,7,7,14,50.0%,42m
13341,3,OqopO,3186,204,7,10,17,41.2%,11m
13341,1,souquet,3186,118,5,2,7,71.4%,19m
13341,3,[1MoD]Joker,3186,0,4,1,5,80.0%,53m
13341,2,[ik4]ikaruga,3186,0,4,2,6,66.7%,51m
13341,3,cxbxb,3186,120,4,6,10,40.0%,3m
13341,3,[JnduGG]winkzzzzzzzz,3186,86,3,6,9,33.3%,1m
13341,3,DAG,3186,139,2,5,7,28.6%,48m
13341,3,Kite,3186,0,1,1,2,50.0%,19m
13341,3,antifreeze,3186,0,1,1,2,50.0%,4m
13341,3,YoungTobey,3186,0,0,4,4,0.0%,7m
13341,3,ÅpoliscreeÐ,3186,0,0,5,5,0.0%,10m
13341,3,Slash,3186,0,0,7,7,0.0%,18m
13361,3,Blurlover,3185,1243,297,274,571,52.0%,7m
13361,1,Ilyas,3185,963,172,166,338,50.9%,9m
13361,3,[NuF]Instantot,3185,843,93,87,180,51.7%,10m
13361,3,Nyx,3185,936,42,45,87,48.3%,5m
13361,3,Kotyara,3185,997,41,36,77,53.2%,19m
13361,3,[s1ayer]Taow,3185,251,33,31,64,51.6%,18m
13361,3,gepardy,3185,669,27,25,52,51.9%,12m
13361,3,Shiner,3185,167,13,9,22,59.1%,5m
13361,1,SHOCK,3185,166,8,5,13,61.5%,15m
13361,1,Prjanuk,3185,117,5,5,10,50.0%,11m
13361,3,[HCN]Genji,3185,0,4,1,5,80.0%,49m
13361,1,Paradise,3185,83,3,2,5,60.0%,18m
13361,1,[LezLox]WanBeParting,3185,166,3,3,6,50.0%,53m
13361,3,Skeleo,3185,94,2,1,3,66.7%,21m
13361,3,[InƑeS]Sergio,3185,124,2,2,4,50.0%,16m
13361,3,[ZERGML]ZenderLor,3185,30,2,3,5,40.0%,11m
13361,3,Hop,3185,60,2,4,6,33.3%,22m
13361,3,KefZz,3185,0,1,1,2,50.0%,18m
13361,2,GreenZerg,3185,0,1,1,2,50.0%,10m
13361,3,FROST,3185,0,1,1,2,50.0%,4m
13361,3,Railgun,3185,0,1,3,4,25.0%,6m
13361,1,Bliah,3185,0,0,1,1,0.0%,19m
13361,1,[EzEz]Alien,3185,0,0,1,1,0.0%,3m
13384,3,[Hrr]Svat,3184,1615,188,185,373,50.4%,3m
13384,3,Vojda,3184,1107,45,40,85,52.9%,20m
13384,1,[TheDOH]Dimaria,3184,540,42,7,49,85.7%,22m
13384,3,Topohanta,3184,944,35,36,71,49.3%,21m
13384,1,BeerMan,3184,1026,34,31,65,52.3%,10m
13384,3,ǂƤƹƶǂ,3184,238,11,8,19,57.9%,18m
13384,3,AwakinG,3184,204,10,5,15,66.7%,12m
13384,3,[ƬC]Dflex,3184,237,9,5,14,64.3%,2m
13384,3,InSaNitY,3184,144,5,10,15,33.3%,6m
13384,3,[4mz]Nightmare,3184,134,3,4,7,42.9%,12m
13384,3,[NWGD]Warrior,3184,88,3,11,14,21.4%,5m
13384,1,[Peeps]GFG,3184,42,2,0,2,100.0%,4m
13384,2,Trops,3184,0,0,1,1,0.0%,17m
13384,1,Baked,3184,0,0,1,1,0.0%,1m
13384,3,[VUA]dfd,3184,0,0,6,6,0.0%,7m
13384,3,Farts,3184,0,0,8,8,0.0%,4m
13400,3,sophist,3183,1556,400,367,767,52.2%,11m
13400,3,Aronakss,3183,1103,70,56,126,55.6%,1m
13400,3,Begemot,3183,646,41,38,79,51.9%,4m
13400,3,Magicl,3183,689,37,14,51,72.5%,17m
13400,3,Makeshik,3183,829,34,28,62,54.8%,17m
13400,1,Пивар,3183,746,23,20,43,53.5%,20m
13400,3,[LeUcHt]TheDarkNight,3183,409,18,12,30,60.0%,14m
13400,1,Glasø,3183,442,14,7,21,66.7%,21m
13400,3,Robin,3183,244,9,16,25,36.0%,9m
13400,1,Zerdrøx,3183,224,8,4,12,66.7%,3m
13400,3,MozGi,3183,247,7,9,16,43.8%,11m
13400,1,LingLing,3183,0,4,1,5,80.0%,19m
13400,3,Artvel,3183,0,4,1,5,80.0%,31m
13400,3,[GPs57]Kzkh,3183,155,4,4,8,50.0%,21m
13400,3,Dodde,3183,38,2,3,5,40.0%,22m
13400,1,deadlocks,3183,0,2,3,5,40.0%,3m
13400,3,[Z3RGTV]MrPanda,3183,94,1,2,3,33.3%,3m
13400,3,[яєѕ]JesuKristus,3183,0,0,2,2,0.0%,19m
13400,3,[ЗИБиАГ]Black,3183,0,0,2,2,0.0%,1m
13419,3,Silvio,3182,1183,164,149,313,52.4%,6m
13419,3,Muerte,3182,1505,134,151,285,47.0%,3m
13419,3,CERBERO,3182,505,71,62,133,53.4%,3m
13419,3,Ghasty,3182,771,34,28,62,54.8%,20m
13419,1,Vortex,3182,813,31,21,52,59.6%,11m
13419,1,[FKSD]claderike,3182,436,13,9,22,59.1%,1m
13419,3,[Dobro]ninofabula,3182,302,12,6,18,66.7%,7m
13419,2,Wolle,3182,378,12,46,58,20.7%,12m
13419,1,HailToKing,3182,308,8,9,17,47.1%,17m
13419,3,[IceHus]LeGend,3182,189,6,6,12,50.0%,4m
13419,3,[PLEBSS]Vendemmia,3182,170,5,4,9,55.6%,10m
13419,3,KruT,3182,148,5,14,19,26.3%,16m
13419,1,Therg,3182,142,4,4,8,50.0%,1m
13419,1,Игрок,3182,122,3,2,5,60.0%,22m
13419,1,[JS]draaykinG,3182,111,2,2,4,50.0%,21m
13419,3,LYBLYPELMENI,3182,115,2,2,4,50.0%,2m
13419,3,Ishiki,3182,30,2,4,6,33.3%,18m
13419,1,sid,3182,0,1,0,1,100.0%,12m
13419,1,[GAMI]Veyux,3182,103,1,3,4,25.0%,20m
13419,2,GaneSh,3182,0,0,1,1,0.0%,1h
13419,1,[KMNDX]Vegasas,3182,0,0,1,1,0.0%,17m
13419,1,Konalupa,3182,0,0,1,1,0.0%,11m
13419,3,reborn,3182,0,0,2,2,0.0%,11m
13442,3,Fariac,3181,1515,256,235,491,52.1%,10m
13442,3,HiddenPants,3181,1517,158,137,295,53.6%,6m
13442,3,FishZerg,3181,625,79,70,149,53.0%,11m
13442,2,Invictus,3181,983,73,94,167,43.7%,10m
13442,3,[TTe]markusi,3181,724,66,56,122,54.1%,9m
13442,3,Phantom,3181,387,44,36,80,55.0%,22m
13442,3,Trickster,3181,947,39,31,70,55.7%,1m
13442,1,ArnaudMéla,3181,633,34,30,64,53.1%,22m
13442,3,Musan,3181,761,32,35,67,47.8%,11m
13442,3,tinou,3181,719,29,25,54,53.7%,11m
13442,3,[FUSB]Samxtar,3181,825,29,29,58,50.0%,10m
13442,3,[SCDHun]Zesedar,3181,591,24,17,41,58.5%,6m
13442,3,Pelton,3181,177,18,22,40,45.0%,7m
13442,1,[dDb]Överlord,3181,444,13,8,21,61.9%,10m
13442,3,[FrC]Benzoate,3181,358,13,16,29,44.8%,10m
13442,3,PubliusMus,3181,258,11,6,17,64.7%,3m
13442,3,[FBng]Foeti,3181,150,11,15,26,42.3%,19m
13442,1,Shadow,3181,181,8,3,11,72.7%,1m
13442,1,[ǂescǂ]Nomascus,3181,186,8,4,12,66.7%,4m
13442,1,GrlFiauxe,3181,42,2,1,3,66.7%,12m
13442,3,[RTLS]oLrZo,3181,60,2,6,8,25.0%,7m
13442,1,[Cens]axelteo,3181,0,1,0,1,100.0%,22m
13442,1,[WLE]freya,3181,0,1,0,1,100.0%,6m
13442,2,[KH4ZIX]xileF,3181,0,1,1,2,50.0%,12m
13442,3,Easystress,3181,0,1,2,3,33.3%,4m
13442,3,[Froze]Elsa,3181,0,1,2,3,33.3%,16m
13442,1,Daloso,3181,0,0,1,1,0.0%,19m
13442,1,Keyzx,3181,0,0,1,1,0.0%,1m
13442,1,funny,3181,0,0,1,1,0.0%,5m
13442,1,Nestaral,3181,0,0,1,1,0.0%,2m
13442,1,Krean,3181,0,0,1,1,0.0%,4m
13442,1,[GiBL]Prontik,3181,0,0,1,1,0.0%,2m
13442,1,HAIFISH,3181,0,0,1,1,0.0%,11m
13442,2,Djuchi,3181,0,0,1,1,0.0%,48m
13442,3,LagunaRock,3181,0,0,2,2,0.0%,5m
13442,3,Antigone,3181,0,0,3,3,0.0%,22m
13442,3,Maniac,3181,0,0,4,4,0.0%,21m
13479,1,MaxL,3180,1787,318,308,626,50.8%,1m
13479,3,[TINion]Rayback,3180,1552,299,302,601,49.8%,10m
13479,3,Necros,3180,1012,168,160,328,51.2%,11m
13479,3,Jacquard,3180,1526,153,157,310,49.4%,5m
13479,3,[OCH]MissGUN,3180,1533,88,64,152,57.9%,4m
13479,3,[C37224]GranPedrito,3180,1278,55,61,116,47.4%,21m
13479,1,Timran,3180,869,33,27,60,55.0%,5m
13479,3,oma,3180,469,20,15,35,57.1%,22m
13479,2,llllllllllll,3180,349,13,5,18,72.2%,17m
13479,3,Craicling,3180,310,12,12,24,50.0%,12m
13479,3,Karma,3180,278,10,7,17,58.8%,18m
13479,3,Degenerał,3180,291,9,10,19,47.4%,20m
13479,3,DedMazay,3180,122,4,9,13,30.8%,11m
13479,3,Deathsong,3180,123,3,3,6,50.0%,10m
13479,1,HungryDrone,3180,42,2,0,2,100.0%,2m
13479,1,PickNicker,3180,142,2,1,3,66.7%,58m
13479,3,PSINA,3180,60,2,7,9,22.2%,18m
13479,3,[ZeBig]CrAzYcAt,3180,90,1,3,4,25.0%,3m
13479,1,Syfon,3180,0,0,1,1,0.0%,18m
13479,1,Boyington,3180,0,0,1,1,0.0%,7m
13479,1,Rutigan,3180,0,0,1,1,0.0%,21m
13479,3,GRANDMASTER,3180,0,0,2,2,0.0%,7m
13479,3,[Ketäjä]Metalsnake,3180,0,0,2,2,0.0%,11m
13479,1,[Bloro]Lestaron,3180,0,0,2,2,0.0%,2m
13503,3,Killerted,3179,1222,274,273,547,50.1%,11m
13503,3,Blorb,3179,1563,58,58,116,50.0%,7m
13503,3,[TAW]Gustav,3179,562,35,34,69,50.7%,8m
13503,3,IQlab,3179,632,31,33,64,48.4%,20m
13503,3,MrMamont,3179,686,26,26,52,50.0%,6m
13503,3,Shrader,3179,294,23,16,39,59.0%,1m
13503,3,[dinmor]ButtersDK,3179,562,19,32,51,37.3%,3m
13503,3,Fleborg,3179,384,16,12,28,57.1%,9m
13503,1,Radiance,3179,281,12,3,15,80.0%,15m
13503,3,AngelDust,3179,314,11,16,27,40.7%,1m
13503,3,RFerdinand,3179,257,9,8,17,52.9%,11m
13503,1,Manabu,3179,212,7,5,12,58.3%,2m
13503,1,[GrPt]Vis,3179,119,6,3,9,66.7%,10m
13503,3,[FDJ]Dos,3179,174,6,11,17,35.3%,1m
13503,2,Freeze,3179,46,5,3,8,62.5%,34m
13503,3,[ROTGz]Okasama,3179,0,4,1,5,80.0%,18m
13503,3,SameOldName,3179,0,4,1,5,80.0%,34m
13503,2,Dota,3179,0,4,2,6,66.7%,57m
13503,1,qqq,3179,120,3,1,4,75.0%,12m
13503,3,Fast,3179,135,3,3,6,50.0%,4m
13503,1,[GSquad]Battleman,3179,0,1,0,1,100.0%,20m
13503,3,XixS,3179,30,1,4,5,20.0%,17m
13503,1,[KhSo]romeo,3179,0,0,1,1,0.0%,18m
13503,1,Moon,3179,0,0,5,5,0.0%,12m
13527,3,DiMM,3178,1614,507,505,1012,50.1%,7m
13527,2,[BWArmy]DarkSwaGG,3178,1535,385,381,766,50.3%,5m
13527,3,KronG,3178,1254,151,157,308,49.0%,21m
13527,1,Crow,3178,1115,87,61,148,58.8%,19m
13527,3,Muineth,3178,604,51,46,97,52.6%,22m
13527,3,Ishtar,3178,1028,42,41,83,50.6%,22m
13527,3,LunarMAX,3178,753,36,18,54,66.7%,5m
13527,1,DujekOnearm,3178,887,36,18,54,66.7%,4m
13527,3,LiquidZerg,3178,942,36,33,69,52.2%,18m
13527,3,[TheLB]StoubyW,3178,876,36,36,72,50.0%,20m
13527,3,spotke,3178,954,32,43,75,42.7%,13m
13527,1,прилив,3178,631,28,15,43,65.1%,2m
13527,3,ComebackKid,3178,541,26,9,35,74.3%,16m
13527,3,Mystic,3178,175,26,25,51,51.0%,13m
13527,3,pain,3178,570,22,19,41,53.7%,5m
13527,3,Masterme,3178,310,16,17,33,48.5%,11m
13527,3,[mTx]WaL,3178,181,8,6,14,57.1%,16m
13527,1,[SUUUUS]Artemis,3178,184,7,5,12,58.3%,17m
13527,3,FUUUUman,3178,184,6,10,16,37.5%,3m
13527,3,joe,3178,42,5,2,7,71.4%,34m
13527,2,MasterMind,3178,132,4,2,6,66.7%,42m
13527,3,ElNiNos,3178,97,1,1,2,50.0%,16m
13527,3,Quark,3178,28,1,7,8,12.5%,20m
13527,1,Phantom,3178,0,0,1,1,0.0%,12m
13551,3,CrazyBanana,3177,761,64,46,110,58.2%,4m
13551,3,coolbyte,3177,1224,46,48,94,48.9%,16m
13551,3,Eriolas,3177,396,41,35,76,53.9%,16m
13551,3,FARAMIR,3177,412,20,18,38,52.6%,20m
13551,1,Neobhodima,3177,532,16,12,28,57.1%,19m
13551,3,sash,3177,412,14,18,32,43.8%,11m
13551,3,ZerginaldTe,3177,336,12,13,25,48.0%,19m
13551,3,MooreTim,3177,238,11,6,17,64.7%,21m
13551,3,[InitRu]DEGREI,3177,300,11,11,22,50.0%,1m
13551,3,Riddle,3177,248,8,7,15,53.3%,1m
13551,1,Busty,3177,175,8,7,15,53.3%,7m
13551,3,almaz,3177,118,5,9,14,35.7%,10m
13551,3,Zintor,3177,146,5,11,16,31.2%,5m
13551,2,Kyean,3177,165,4,2,6,66.7%,43m
13551,3,Crom,3177,164,4,4,8,50.0%,4m
13551,3,[FWez]Saga,3177,88,4,5,9,44.4%,7m
13551,1,MadDogKisiel,3177,78,2,1,3,66.7%,18m
13551,3,Bowser,3177,60,2,7,9,22.2%,10m
13551,1,Игорь,3177,0,1,0,1,100.0%,10m
13551,1,zamesin,3177,0,1,0,1,100.0%,1m
13551,1,[ARO]Guderian,3177,0,1,1,2,50.0%,3m
13551,1,Kekec,3177,0,1,1,2,50.0%,22m
13551,1,Devourer,3177,0,0,1,1,0.0%,3m
13551,1,Knorke,3177,0,0,1,1,0.0%,4m
13551,3,Sławo,3177,0,0,1,1,0.0%,46m
13551,1,[FiNT]NoGoMoran,3177,0,0,1,1,0.0%,12m
13551,1,[ZeDe20]Lacagaste,3177,0,0,1,1,0.0%,12m
13551,1,Nitara,3177,0,0,2,2,0.0%,4m
13579,3,Takuto,3176,1533,123,98,221,55.7%,4m
13579,3,[crabz]WhiteNights,3176,1481,68,61,129,52.7%,21m
13579,3,JouBliksem,3176,558,56,46,102,54.9%,6m
13579,3,[BRSKR]Ferral,3176,1116,50,46,96,52.1%,4m
13579,3,[GODSSS]Fuzileiro,3176,1108,40,44,84,47.6%,8m
13579,3,[13g12p]SnaKe,3176,641,24,22,46,52.2%,21m
13579,3,Max,3176,142,11,11,22,50.0%,11m
13579,1,[STED]StarCat,3176,346,9,6,15,60.0%,22m
13579,3,Copinou,3176,170,7,10,17,41.2%,20m
13579,3,TroubleMaker,3176,60,6,4,10,60.0%,1m
13579,2,Traex,3176,0,4,2,6,66.7%,40m
13579,1,[Sewer]Forgotten,3176,0,1,1,2,50.0%,8m
13579,1,KingOfNoob,3176,0,1,2,3,33.3%,21m
13579,1,Ssvlad,3176,0,1,4,5,20.0%,3m
13579,1,Gwaar,3176,0,0,1,1,0.0%,11m
13579,1,MrBigRuss,3176,0,0,1,1,0.0%,20m
13579,1,CarolusRex,3176,0,0,1,1,0.0%,11m
13579,1,llllllllllll,3176,0,0,1,1,0.0%,20m
13579,1,pansit,3176,0,0,2,2,0.0%,6m
13579,3,Zenit,3176,0,0,3,3,0.0%,2m
13599,3,[PMS]zepp,3175,1527,168,171,339,49.6%,11m
13599,3,[DFgs]ShadowDragon,3175,1050,83,73,156,53.2%,3m
13599,1,mazik,3175,497,34,14,48,70.8%,5m
13599,1,Darun,3175,611,18,16,34,52.9%,18m
13599,3,Sva,3175,428,17,17,34,50.0%,1m
13599,3,[ICGl]Aven,3175,309,16,22,38,42.1%,4m
13599,1,Cerberus,3175,184,15,10,25,60.0%,17m
13599,2,MrGambit,3175,315,14,9,23,60.9%,5m
13599,1,DeKaH,3175,387,12,6,18,66.7%,5m
13599,3,GbR,3175,213,7,6,13,53.8%,18m
13599,3,[4GYM]Shpug,3175,210,6,6,12,50.0%,3m
13599,3,[WarD]Hozg,3175,164,4,5,9,44.4%,8m
13599,1,Mithic,3175,122,3,4,7,42.9%,2m
13599,3,[TSPEZ]Krobek,3175,90,3,8,11,27.3%,18m
13599,3,Ollu,3175,30,2,2,4,50.0%,5m
13599,1,IRA,3175,0,1,0,1,100.0%,7m
13599,1,[ICFI]Xid,3175,44,1,2,3,33.3%,20m
13599,3,Axamitny,3175,0,1,3,4,25.0%,6m
13599,1,Jinstu,3175,0,0,1,1,0.0%,17m
13599,1,phace,3175,0,0,1,1,0.0%,20m
13599,3,MIRUKY,3175,0,0,3,3,0.0%,12m
13620,3,Minas,3174,978,176,154,330,53.3%,12m
13620,3,Bercerzen,3174,1077,138,124,262,52.7%,5m
13620,3,[Nudist]Golgotai,3174,1367,90,96,186,48.4%,1m
13620,3,OutLife,3174,291,12,15,27,44.4%,18m
13620,1,HotCoffee,3174,302,11,3,14,78.6%,11m
13620,3,eXceS,3174,330,11,10,21,52.4%,13m
13620,1,[Gr33dy]RoaringGoose,3174,300,9,6,15,60.0%,17m
13620,3,donFabio,3174,252,9,12,21,42.9%,22m
13620,1,[TheRET]Raigon,3174,230,6,5,11,54.5%,8m
13620,3,Indebear,3174,97,3,3,6,50.0%,26m
13620,3,[STr6]Gloomitel,3174,30,3,6,9,33.3%,7m
13620,3,[CS2F]Slafnia,3174,95,2,1,3,66.7%,6m
13620,1,SBBomB,3174,42,2,1,3,66.7%,17m
13620,3,[SPAINs]Rainierwolf,3174,30,2,4,6,33.3%,3m
13620,1,SuperVitamin,3174,0,1,0,1,100.0%,3m
13620,1,Sazanow,3174,0,0,1,1,0.0%,1m
13620,2,KruchuVerchu,3174,0,0,1,1,0.0%,38m
13620,1,Deleron,3174,73,0,4,4,0.0%,5m
13638,3,TheSlicer,3173,1640,463,471,934,49.6%,11m
13638,3,[Wolven]Ottoman,3173,1521,201,194,395,50.9%,5m
13638,3,decoydave,3173,1568,74,59,133,55.6%,6m
13638,3,SPACE,3173,1535,68,61,129,52.7%,4m
13638,3,Deftey,3173,1045,45,41,86,52.3%,3m
13638,3,GGeryx,3173,788,37,27,64,57.8%,21m
13638,3,Helio,3173,952,34,37,71,47.9%,2m
13638,3,GordonRamsay,3173,518,29,25,54,53.7%,2m
13638,1,Chad,3173,561,24,6,30,80.0%,6m
13638,3,umopaplsdn,3173,496,18,25,43,41.9%,21m
13638,3,SaltAndPeppa,3173,290,11,12,23,47.8%,7m
13638,3,Destrack,3173,158,7,10,17,41.2%,5m
13638,2,IASGATG,3173,141,6,2,8,75.0%,21m
13638,3,Tominator,3173,189,5,5,10,50.0%,12m
13638,3,[DМG]BerryBee,3173,136,3,3,6,50.0%,17m
13638,3,HavanaBanana,3173,90,3,10,13,23.1%,4m
13638,1,Citizen,3173,40,2,0,2,100.0%,11m
13638,1,[Dmntd]Bubble,3173,80,2,1,3,66.7%,1m
13638,1,Spetsnaz,3173,42,2,1,3,66.7%,22m
13638,1,GrootNRoll,3173,113,2,1,3,66.7%,3m
13638,3,Shanks,3173,114,2,2,4,50.0%,11m
13638,1,Corleozo,3173,82,2,2,4,50.0%,8m
13638,1,Lucki,3173,0,2,3,5,40.0%,20m
13638,1,[CØG]Norzemop,3173,0,0,1,1,0.0%,10m
13638,1,Mizeri,3173,0,0,1,1,0.0%,19m
13663,3,[696]Palamarys,3172,1587,637,621,1258,50.6%,6m
13663,3,GETARTEMIS,3172,1527,370,369,739,50.1%,21m
13663,3,ChoiceGold,3172,1603,253,232,485,52.2%,1m
13663,3,Zenster,3172,1557,159,154,313,50.8%,5m
13663,3,GNUSikk,3172,1139,108,111,219,49.3%,3m
13663,3,UnKind,3172,1381,91,89,180,50.6%,1m
13663,3,EvilFish,3172,629,82,75,157,52.2%,2m
13663,3,[MNI]Nitor,3172,1542,79,87,166,47.6%,6m
13663,3,StOrm,3172,583,56,47,103,54.4%,21m
13663,3,[InnoG]Mextli,3172,1076,40,44,84,47.6%,19m
13663,1,[113RUS]Solo,3172,1102,38,28,66,57.6%,5m
13663,3,[tofury]FùSiiOn,3172,282,11,6,17,64.7%,18m
13663,3,RAYN,3172,266,9,6,15,60.0%,6m
13663,3,[ḆŽǤ]DIAZ,3172,194,8,6,14,57.1%,6m
13663,1,[IMTh]Dimront,3172,189,6,3,9,66.7%,6m
13663,1,[HLFLMN]balka,3172,230,6,4,10,60.0%,4m
13663,1,monk,3172,191,5,6,11,45.5%,8m
13663,3,NewWaves,3172,0,4,1,5,80.0%,46m
13663,3,hamer,3172,92,4,5,9,44.4%,20m
13663,1,[Noyce]ecruos,3172,42,2,0,2,100.0%,17m
13663,1,TossPwayer,3172,0,1,0,1,100.0%,3m
13663,1,MaRa,3172,0,0,1,1,0.0%,18m
13685,3,[DLC1]WartoQNL,3171,913,135,132,267,50.6%,11m
13685,3,JackBell,3171,1592,134,95,229,58.5%,21m
13685,1,UrbanLegend,3171,1787,130,105,235,55.3%,8m
13685,3,Flex,3171,1511,93,79,172,54.1%,3m
13685,3,Emrys,3171,819,91,82,173,52.6%,2m
13685,3,[CRSRIO]VaLmaLisK,3171,1089,66,54,120,55.0%,17m
13685,3,YuDeNkRicKeT,3171,875,58,49,107,54.2%,11m
13685,3,Yegorka,3171,870,32,43,75,42.7%,11m
13685,1,teneuro,3171,542,31,13,44,70.5%,18m
13685,3,MisterSmal,3171,378,14,11,25,56.0%,7m
13685,3,[Xy9lce]Ksv,3171,332,11,21,32,34.4%,1m
13685,1,Shamousse,3171,232,6,4,10,60.0%,8m
13685,3,[0KIG0]Astartes,3171,204,6,5,11,54.5%,6m
13685,3,funjinfu,3171,0,4,1,5,80.0%,19m
13685,3,CruunkJuiice,3171,0,4,1,5,80.0%,1h
13685,3,Nobad,3171,138,4,3,7,57.1%,20m
13685,1,Rodmin,3171,82,2,3,5,40.0%,8m
13685,3,Joanix,3171,30,2,6,8,25.0%,18m
13685,1,[RTD]RTDFAQ,3171,0,1,0,1,100.0%,22m
13685,1,Schnuffi,3171,0,1,0,1,100.0%,21m
13685,3,Zero,3171,0,1,2,3,33.3%,6m
13685,2,[1DLE]Thial,3171,36,1,3,4,25.0%,16m
13685,1,Wybaux,3171,0,0,1,1,0.0%,4m
13685,3,llllllllllll,3171,0,0,1,1,0.0%,4m
13685,1,[NiN]Nimbus,3171,0,0,2,2,0.0%,48m
13685,1,frankimahri,3171,0,0,2,2,0.0%,18m
13685,3,dimarus,3171,0,0,4,4,0.0%,21m
13712,3,Hydromel,3170,953,246,248,494,49.8%,19m
13712,3,tiGGon,3170,1062,75,71,146,51.4%,7m
13712,3,johncena,3170,1014,67,68,135,49.6%,8m
13712,3,Mammoth,3170,685,66,65,131,50.4%,22m
13712,3,jaspilit,3170,284,39,41,80,48.8%,11m
13712,1,NightDark,3170,749,29,20,49,59.2%,17m
13712,3,[H2OKT]FarSeer,3170,610,25,19,44,56.8%,18m
13712,1,bob,3170,576,22,15,37,59.5%,20m
13712,1,kamiGami,3170,506,22,18,40,55.0%,6m
13712,1,blacky,3170,616,20,15,35,57.1%,20m
13712,3,GCNeoZerg,3170,389,18,12,30,60.0%,2m
13712,3,HanSolo,3170,492,18,21,39,46.2%,9m
13712,3,ALE,3170,323,14,11,25,56.0%,7m
13712,2,[MSUSC2]krirller,3170,334,12,9,21,57.1%,5m
13712,3,Bananii,3170,324,12,14,26,46.2%,21m
13712,2,ilusha,3170,141,7,3,10,70.0%,4m
13712,3,[GrPt]JinaLence,3170,0,5,0,5,100.0%,13m
13712,1,Nikitiiy,3170,154,5,1,6,83.3%,5m
13712,3,Flo,3170,30,2,3,5,40.0%,3m
13712,3,Xuaï,3170,32,1,1,2,50.0%,6m
13712,1,RedX,3170,0,0,1,1,0.0%,1m
13712,1,Lunatic,3170,0,0,2,2,0.0%,12m
13712,1,Aiwe,3170,0,0,2,2,0.0%,17m
13712,3,[zouave]Niethalf,3170,0,0,6,6,0.0%,16m
13736,3,DemonSeed,3169,1549,174,176,350,49.7%,16m
13736,3,[СКИЛЫ]Aleksmas,3169,898,115,111,226,50.9%,6m
13736,3,neo,3169,1427,73,65,138,52.9%,7m
13736,3,Pisanlit,3169,1010,68,75,143,47.6%,11m
13736,3,[CM4R]bakermir,3169,1151,52,40,92,56.5%,3m
13736,3,[ФБК]CoFFeIN,3169,940,43,33,76,56.6%,17m
13736,3,RedStorm,3169,847,36,29,65,55.4%,9m
13736,3,KryStal,3169,571,35,26,61,57.4%,1m
13736,1,FrostElf,3169,451,19,17,36,52.8%,4m
13736,1,AliasHunter,3169,158,5,4,9,55.6%,17m
13736,1,Spiral,3169,120,3,4,7,42.9%,12m
13736,1,zimi,3169,84,2,4,6,33.3%,2m
13736,1,ChrisGamers,3169,80,2,4,6,33.3%,2m
13736,3,RAVTEL,3169,115,2,4,6,33.3%,5m
13736,3,Angeles,3169,60,2,5,7,28.6%,22m
13736,3,apartment,3169,0,1,2,3,33.3%,2m
13736,1,Daedalus,3169,42,1,3,4,25.0%,21m
13736,3,MarineFox,3169,0,0,3,3,0.0%,7m
13754,3,OneLooK,3168,1543,215,192,407,52.8%,6m
13754,3,Ouraganco,3168,496,188,184,372,50.5%,8m
13754,1,IkillMALL,3168,1753,148,139,287,51.6%,21m
13754,3,vvsk,3168,1134,99,91,190,52.1%,5m
13754,3,stonehead,3168,881,86,82,168,51.2%,18m
13754,3,Caradryan,3168,1085,78,54,132,59.1%,4m
13754,3,Shiadra,3168,148,29,27,56,51.8%,21m
13754,3,Teimceper,3168,592,28,16,44,63.6%,8m
13754,3,[Krabы]titanik,3168,215,26,11,37,70.3%,4m
13754,3,MadaK,3168,366,17,12,29,58.6%,2m
13754,3,Denkan,3168,233,11,7,18,61.1%,22m
13754,3,Kreuz,3168,266,11,8,19,57.9%,10m
13754,1,[GoldM]XENOX,3168,268,8,4,12,66.7%,2m
13754,3,Syber,3168,253,8,17,25,32.0%,22m
13754,2,Parzival,3168,207,7,4,11,63.6%,40m
13754,1,[BElad]Matthew,3168,200,6,3,9,66.7%,12m
13754,1,Norenau,3168,227,6,7,13,46.2%,21m
13754,1,Philliphus,3168,0,4,1,5,80.0%,3m
13754,3,Harkor,3168,160,4,5,9,44.4%,13m
13754,1,SentiNeL,3168,142,3,4,7,42.9%,22m
13754,3,[MJSD]Tipaik,3168,62,3,9,12,25.0%,16m
13754,3,Hawk,3168,62,2,6,8,25.0%,10m
13754,3,LeeroyV,3168,30,2,11,13,15.4%,17m
13754,3,[NuF]Cyclopes,3168,0,1,0,1,100.0%,20m
13754,1,Animewarrior,3168,0,0,1,1,0.0%,3m
13779,3,[BgScum]Mifkata,3167,469,56,57,113,49.6%,1m
13779,3,YliKylä,3167,619,47,38,85,55.3%,4m
13779,3,max,3167,210,34,33,67,50.7%,10m
13779,3,[sprtan]Titan,3167,535,22,29,51,43.1%,3m
13779,1,[IBIF]Meteorshock,3167,436,19,12,31,61.3%,22m
13779,1,Kiogras,3167,438,12,12,24,50.0%,20m
13779,3,AlphaJuliet,3167,219,10,9,19,52.6%,10m
13779,3,VlSsVe,3167,184,7,8,15,46.7%,3m
13779,1,Panderica,3167,200,5,5,10,50.0%,3m
13779,3,[Xcode]baluchi,3167,126,5,10,15,33.3%,11m
13779,1,[TCOA]ebGMcSilent,3167,0,4,1,5,80.0%,2m
13779,3,[10TCLs]xdicsx,3167,116,3,2,5,60.0%,2m
13779,1,Blam,3167,42,2,0,2,100.0%,21m
13779,3,Moctar,3167,30,2,3,5,40.0%,11m
13779,1,Kiliboon,3167,0,1,0,1,100.0%,3m
13779,1,Balloo,3167,38,1,2,3,33.3%,11m
13779,2,MaitrePatate,3167,88,1,2,3,33.3%,21m
13796,3,porky,3166,1578,302,307,609,49.6%,22m
13796,3,Fish,3166,1556,77,66,143,53.8%,16m
13796,3,MurphysLaw,3166,571,65,42,107,60.7%,12m
13796,3,Rębajło,3166,1218,65,64,129,50.4%,10m
13796,3,ISanych,3166,950,64,57,121,52.9%,12m
13796,1,SnaiLy,3166,1119,44,35,79,55.7%,7m
13796,3,HYDRAK,3166,516,18,17,35,51.4%,21m
13796,1,Magic,3166,243,15,12,27,55.6%,3m
13796,1,HuitSix,3166,341,14,5,19,73.7%,11m
13796,3,[Dobro]vandrcontrol,3166,315,13,6,19,68.4%,7m
13796,1,Terry,3166,300,12,2,14,85.7%,18m
13796,3,iris,3166,176,6,3,9,66.7%,10m
13796,1,Callon,3166,158,5,2,7,71.4%,20m
13796,1,Mutal,3166,74,5,3,8,62.5%,7m
13796,3,[STERNI]Titus,3166,0,4,2,6,66.7%,6m
13796,1,SCPlusPlus,3166,204,4,5,9,44.4%,19m
13796,3,Huliveivari,3166,90,3,6,9,33.3%,13m
13796,3,Ayoran,3166,16,3,9,12,25.0%,5m
13796,1,[КНР]ForAiur,3166,40,2,0,2,100.0%,21m
13796,1,DerPapa,3166,82,2,3,5,40.0%,5m
13796,3,LennartNL,3166,0,1,1,2,50.0%,10m
13796,1,Kodveto,3166,95,1,1,2,50.0%,21m
13796,1,Life,3166,0,1,2,3,33.3%,1h
13796,3,Kasablanka,3166,0,1,2,3,33.3%,10m
13796,3,[FUCBOY]Fazt,3166,30,1,3,4,25.0%,3m
13796,3,Dirtus,3166,0,1,3,4,25.0%,20m
13822,3,AllThumbs,3165,1318,151,127,278,54.3%,5m
13822,3,Woutorius,3165,1541,105,93,198,53.0%,5m
13822,1,[Ttræn]Kowai,3165,499,14,15,29,48.3%,9m
13822,3,Rojvan,3165,114,5,7,12,41.7%,19m
13822,1,monmon,3165,172,4,7,11,36.4%,19m
13822,3,[u2lol]GGEZ,3165,30,2,3,5,40.0%,11m
13822,3,[ZDND]Dennis,3165,0,1,0,1,100.0%,17m
13822,1,FrostDragon,3165,0,1,1,2,50.0%,11m
13822,1,[TG0]bYtcloSeD,3165,0,0,1,1,0.0%,17m
13822,1,Eretanor,3165,0,0,1,1,0.0%,12m
13822,1,[GunGuy]DrSputko,3165,0,0,2,2,0.0%,12m
13822,1,max,3165,0,0,2,2,0.0%,1m
13834,3,lvkeat,3164,1498,203,197,400,50.8%,12m
13834,3,fronz,3164,1644,140,134,274,51.1%,19m
13834,3,KaraHerjá,3164,1506,96,94,190,50.5%,13m
13834,3,ZBoule,3164,787,41,29,70,58.6%,9m
13834,3,PinkBee,3164,919,39,39,78,50.0%,21m
13834,3,wowthiscray,3164,779,38,27,65,58.5%,17m
13834,3,TheMadnessOn,3164,930,34,36,70,48.6%,13m
13834,3,[Normal]Krullsan,3164,718,24,35,59,40.7%,5m
13834,3,[SGSA]Fierce,3164,478,19,25,44,43.2%,11m
13834,3,Johnyu,3164,366,13,16,29,44.8%,4m
13834,3,Near,3164,362,13,19,32,40.6%,20m
13834,3,Laynex,3164,236,9,15,24,37.5%,17m
13834,1,[NFGS]NucleoZ,3164,280,7,9,16,43.8%,1m
13834,3,Bloodwar,3164,215,6,8,14,42.9%,7m
13834,3,Bogg,3164,169,5,5,10,50.0%,9m
13834,3,Malma,3164,122,5,12,17,29.4%,11m
13834,3,Demen,3164,0,4,1,5,80.0%,20m
13834,3,Mythotheboss,3164,0,2,4,6,33.3%,19m
13834,2,robotikov,3164,0,1,0,1,100.0%,16m
13834,1,ProbeProbius,3164,0,0,1,1,0.0%,6m
13854,3,FadingBadger,3163,807,87,76,163,53.4%,5m
13854,1,HappyPepe,3163,1061,57,37,94,60.6%,5m
13854,3,SixelA,3163,1052,42,37,79,53.2%,10m
13854,3,zhaar,3163,840,41,43,84,48.8%,5m
13854,3,Wartortle,3163,626,26,19,45,57.8%,6m
13854,3,wIxXoR,3163,277,22,15,37,59.5%,8m
13854,3,[AAPP]NotyourMum,3163,561,22,23,45,48.9%,9m
13854,3,Avalance,3163,522,20,23,43,46.5%,21m
13854,3,NoScared,3163,447,18,8,26,69.2%,9m
13854,3,LeBrioch,3163,456,16,22,38,42.1%,8m
13854,1,Austerack,3163,339,14,6,20,70.0%,1m
13854,3,OOSeven,3163,378,13,12,25,52.0%,3m
13854,3,Rafalolej,3163,291,10,9,19,52.6%,6m
13854,1,[NO0Ber]porkiuss,3163,234,7,5,12,58.3%,14m
13854,1,NevrHadUrCar,3163,263,7,8,15,46.7%,17m
13854,3,Arminius,3163,169,6,3,9,66.7%,8m
13854,3,[Oath]Ceasar,3163,212,5,10,15,33.3%,11m
13854,3,Wojtek,3163,164,4,5,9,44.4%,18m
13854,1,EllenPage,3163,147,3,5,8,37.5%,4m
13854,3,[CPROP]GGWP,3163,62,3,6,9,33.3%,17m
13854,3,[Dev667]Dynamics,3163,30,2,4,6,33.3%,20m
13854,1,Apeiron,3163,86,2,7,9,22.2%,17m
13854,3,Redfild,3163,48,2,7,9,22.2%,6m
13854,1,[AjA]DarthLuke,3163,0,1,0,1,100.0%,12m
13854,1,Bohr,3163,0,0,1,1,0.0%,1m
13854,3,[Bustin]Bustin,3163,0,0,5,5,0.0%,39m
13880,3,Perkunas,3162,1596,293,269,562,52.1%,11m
13880,2,[BnRY]Clemooooooou,3162,1506,132,135,267,49.4%,2m
13880,3,areYouSrsly,3162,1385,96,100,196,49.0%,21m
13880,3,[TGosuB]halcyonic,3162,1050,47,33,80,58.8%,7m
13880,3,NeferPitou,3162,416,25,34,59,42.4%,3m
13880,1,[INPG]Bono,3162,652,24,15,39,61.5%,21m
13880,1,Timo,3162,540,16,13,29,55.2%,2m
13880,3,mAtHeWs,3162,328,14,5,19,73.7%,20m
13880,3,WanniX,3162,264,9,8,17,52.9%,20m
13880,3,[пепега]Evall,3162,250,9,15,24,37.5%,21m
13880,3,etxeberro,3162,109,7,6,13,53.8%,16m
13880,1,[Aquile]Antibob,3162,186,6,8,14,42.9%,2m
13880,1,noname,3162,105,5,2,7,71.4%,10m
13880,3,Pablo,3162,148,5,8,13,38.5%,11m
13880,3,august,3162,122,4,7,11,36.4%,2m
13880,3,Behelit,3162,92,3,13,16,18.8%,18m
13880,1,toolakea,3162,0,1,0,1,100.0%,20m
13880,1,[OMGITS]Stefan,3162,0,1,0,1,100.0%,5m
13880,2,Drachenfeuer,3162,0,1,0,1,100.0%,52m
13880,3,[LADG]JudgeWarhol,3162,30,1,1,2,50.0%,16m
13880,1,Weidro,3162,0,0,1,1,0.0%,6m
13880,1,Xenomorph,3162,0,0,1,1,0.0%,7m
13880,1,[KSap]TheOsangar,3162,0,0,1,1,0.0%,20m
13880,1,Lastbreath,3162,0,0,2,2,0.0%,2m
13904,3,[Hrr]Femto,3161,1561,76,81,157,48.4%,21m
13904,3,CrusherT,3161,969,36,37,73,49.3%,12m
13904,3,Lodar,3161,501,32,40,72,44.4%,5m
13904,1,camenbert,3161,508,14,11,25,56.0%,20m
13904,3,[HBeS]Normonon,3161,298,10,14,24,41.7%,1m
13904,1,Chebyrec,3161,342,9,9,18,50.0%,6m
13904,2,cbt,3161,167,6,1,7,85.7%,45m
13904,2,Kryel,3161,204,6,4,10,60.0%,58m
13904,3,[HZeS]Vasay,3161,203,6,6,12,50.0%,3m
13904,2,[El3yal]Rebella,3161,0,4,2,6,66.7%,50m
13904,3,Mara,3161,30,4,4,8,50.0%,3m
13904,1,toofusion,3161,40,2,1,3,66.7%,1m
13904,3,ПРОБИУС,3161,0,2,3,5,40.0%,44m
13904,1,Sideways,3161,0,1,0,1,100.0%,19m
13904,1,tutis,3161,0,1,0,1,100.0%,10m
13904,3,Akillerduck,3161,0,1,2,3,33.3%,4m
13904,1,Skorpo,3161,38,1,3,4,25.0%,2m
13904,3,TMuller,3161,97,1,3,4,25.0%,9m
13904,3,[Heroes]Knails,3161,0,1,6,7,14.3%,6m
13904,1,Hardest,3161,0,0,1,1,0.0%,1m
13904,1,Buster,3161,0,0,1,1,0.0%,5m
13904,1,[NerCC]Eloy,3161,0,0,1,1,0.0%,6m
13904,1,OssGoss,3161,0,0,2,2,0.0%,20m
13904,3,Shinigami,3161,0,0,3,3,0.0%,6m
13928,3,PoloHC,3160,1356,117,115,232,50.4%,5m
13928,3,FatBasterd,3160,1469,110,115,225,48.9%,4m
13928,3,Darkesty,3160,1573,89,89,178,50.0%,10m
13928,3,[GTT]Omzy,3160,773,62,63,125,49.6%,6m
13928,3,рэпернотми,3160,1081,42,46,88,47.7%,16m
13928,3,boozie,3160,372,40,33,73,54.8%,2m
13928,3,Klaww,3160,751,31,28,59,52.5%,20m
13928,3,Calibra,3160,744,28,25,53,52.8%,22m
13928,3,anvar,3160,351,27,24,51,52.9%,10m
13928,1,Blaximus,3160,722,23,19,42,54.8%,2m
13928,3,BingoWolf,3160,474,18,26,44,40.9%,11m
13928,1,Stickman,3160,246,7,6,13,53.8%,18m
13928,3,[fam1ly]Clacking,3160,249,7,9,16,43.8%,3m
13928,3,[wiXtha]MrP,3160,0,5,0,5,100.0%,42m
13928,1,[TSM420]LemonBee,3160,200,5,6,11,45.5%,21m
13928,3,WeedZ,3160,119,3,4,7,42.9%,1m
13928,1,Loaf,3160,80,2,1,3,66.7%,21m
13928,3,Radek,3160,0,2,4,6,33.3%,17m
13928,3,windom,3160,62,2,5,7,28.6%,3m
13928,3,[Tripin]SiCKO,3160,0,1,0,1,100.0%,21m
13928,1,bengbengezpz,3160,0,1,0,1,100.0%,17m
13928,3,Divix,3160,0,1,2,3,33.3%,10m
13928,3,Dio,3160,0,1,3,4,25.0%,13m
13928,1,ChilSurg,3160,0,0,1,1,0.0%,4m
13928,1,LXST,3160,0,0,1,1,0.0%,20m
13953,3,promsky,3159,1639,219,210,429,51.0%,16m
13953,3,lazyDragoon,3159,678,121,127,248,48.8%,6m
13953,3,Ibanezz,3159,1238,77,92,169,45.6%,7m
13953,3,[STONKS]BrAiN,3159,1061,64,67,131,48.9%,7m
13953,3,[PLA2N]diesertir,3159,1027,63,52,115,54.8%,17m
13953,3,Narvalo,3159,961,36,37,73,49.3%,13m
13953,3,[Dragen]STERBANS,3159,732,30,27,57,52.6%,6m
13953,3,Dektral,3159,628,21,31,52,40.4%,4m
13953,3,kaleb,3159,396,19,16,35,54.3%,13m
13953,3,[RBP3]Ahil,3159,385,13,16,29,44.8%,5m
13953,3,Axiome,3159,298,10,13,23,43.5%,3m
13953,3,[Uzan]ranchok,3159,296,10,13,23,43.5%,4m
13953,3,halftwilight,3159,216,8,20,28,28.6%,21m
13953,3,[TBRain]Sawano,3159,140,7,4,11,63.6%,8m
13953,1,Faust,3159,180,6,3,9,66.7%,10m
13953,3,lefous,3159,178,6,11,17,35.3%,1m
13953,1,WaWa,3159,180,5,3,8,62.5%,1h
13953,1,Moose,3159,162,4,4,8,50.0%,12m
13953,3,[EmŦ]Garithos,3159,0,3,2,5,60.0%,2m
13953,2,Ootka,3159,95,2,0,2,100.0%,54m
13953,3,[QaDo]igrok,3159,0,2,4,6,33.3%,31m
13953,3,papygroover,3159,60,2,6,8,25.0%,6m
13953,1,[LGM]Evlex,3159,0,1,0,1,100.0%,8m
13953,1,Praxx,3159,0,1,0,1,100.0%,42m
13953,3,Azimor,3159,0,1,3,4,25.0%,12m
13953,2,[SMSP]Sensage,3159,0,1,6,7,14.3%,14m
13953,1,Mava,3159,0,0,1,1,0.0%,21m
13953,1,[LAGY]Societ,3159,0,0,1,1,0.0%,7m
13953,1,Shvakozabra,3159,0,0,1,1,0.0%,1m
13953,3,RaZa,3159,0,0,5,5,0.0%,1m
13983,1,[ExTr1m]BOCHETUNMAY,3158,1793,116,104,220,52.7%,7m
13983,3,Dip,3158,719,47,60,107,43.9%,6m
13983,3,RockSpider,3158,1017,40,38,78,51.3%,17m
13983,3,Rafik,3158,641,39,36,75,52.0%,9m
13983,1,[JVK12]Michael,3158,285,36,19,55,65.5%,12m
13983,1,Rechargeable,3158,713,29,19,48,60.4%,17m
13983,3,politepeople,3158,737,27,29,56,48.2%,12m
13983,1,Lawrey,3158,665,24,15,39,61.5%,6m
13983,3,Adicad,3158,232,7,7,14,50.0%,11m
13983,1,[RGSC2]StraTov,3158,198,6,4,10,60.0%,21m
13983,2,NYC,3158,0,5,2,7,71.4%,57m
13983,1,[PLA2N]ILYA,3158,116,4,0,4,100.0%,21m
13983,3,doraleix,3158,97,4,2,6,66.7%,42m
13983,3,Hall,3158,0,3,2,5,60.0%,43m
13983,3,Xine,3158,60,3,6,9,33.3%,4m
13983,3,Jim,3158,97,2,0,2,100.0%,24m
13983,3,Aster,3158,90,2,2,4,50.0%,4m
13983,3,Rezalto,3158,113,2,3,5,40.0%,4m
13983,3,[eRZR]Harlekin,3158,60,2,6,8,25.0%,11m
13983,1,[HZeS]Dredzik,3158,0,1,0,1,100.0%,5m
13983,1,Demion,3158,38,1,2,3,33.3%,7m
13983,3,[HQ31er]FENIX,3158,0,1,2,3,33.3%,6m
13983,1,[ZЕRGТV]Tozz,3158,0,0,1,1,0.0%,21m
13983,2,[SKYBRS]Nialllll,3158,0,0,1,1,0.0%,59m
14007,3,Dagumpf,3157,1398,240,249,489,49.1%,9m
14007,3,YooSK,3157,1112,107,100,207,51.7%,16m
14007,1,[200P]Mattes,3157,743,90,89,179,50.3%,1m
14007,3,MehdiByn,3157,730,41,39,80,51.2%,10m
14007,1,HanVing,3157,931,36,28,64,56.2%,10m
14007,3,Extractz,3157,857,36,32,68,52.9%,5m
14007,3,Foppol,3157,654,27,20,47,57.4%,8m
14007,3,UGlennylee,3157,458,17,19,36,47.2%,2m
14007,1,KalergiPlan,3157,543,17,21,38,44.7%,21m
14007,3,serendir,3157,368,14,17,31,45.2%,21m
14007,3,[INOE]IIIIIIIIIIII,3157,182,8,11,19,42.1%,12m
14007,3,Blast,3157,180,8,12,20,40.0%,18m
14007,3,HolzPirat,3157,150,5,12,17,29.4%,13m
14007,3,[CØG]AsGArD,3157,122,4,7,11,36.4%,7m
14007,3,RubbinMaNips,3157,0,1,3,4,25.0%,3m
14007,3,ipopotem,3157,30,1,4,5,20.0%,13m
14007,3,LieberKaffee,3157,30,1,5,6,16.7%,11m
14007,1,[ŚS6]PiraMID,3157,0,0,1,1,0.0%,5m
14007,1,DecidЗe,3157,0,0,1,1,0.0%,10m
14007,1,Amunorama,3157,0,0,2,2,0.0%,33m
14007,3,[GGMS]Sarenor,3157,0,0,4,4,0.0%,20m
14007,3,AnonHyfrose,3157,0,0,8,8,0.0%,11m
14007,3,Mizer,3157,0,0,8,8,0.0%,11m
14030,3,Dionysos,3156,1552,423,414,837,50.5%,21m
14030,3,[TPX]NeoGeo,3156,1558,134,130,264,50.8%,13m
14030,3,BamBam,3156,1571,73,61,134,54.5%,4m
14030,1,[GamerX]AlphaZero,3156,1486,55,49,104,52.9%,12m
14030,3,morph,3156,570,32,19,51,62.7%,7m
14030,3,Sahneseppel,3156,492,18,23,41,43.9%,17m
14030,3,Salty,3156,500,16,26,42,38.1%,9m
14030,1,[RTO]Paul,3156,454,15,8,23,65.2%,14m
14030,3,[Keion]AlbrEinstein,3156,386,15,11,26,57.7%,6m
14030,1,Michalaa,3156,335,10,6,16,62.5%,19m
14030,3,Adieu,3156,152,9,8,17,52.9%,3m
14030,2,[Brioc]Ewi,3156,216,8,4,12,66.7%,46m
14030,1,duduzboo,3156,119,6,5,11,54.5%,53m
14030,3,PMW,3156,182,6,13,19,31.6%,21m
14030,1,Justfox,3156,148,5,2,7,71.4%,6m
14030,3,[SPAINs]Jomasteur,3156,126,4,3,7,57.1%,6m
14030,3,Eschaton,3156,97,3,3,6,50.0%,32m
14030,1,[JWG]Skigur,3156,84,3,3,6,50.0%,12m
14030,3,inkerman,3156,152,3,6,9,33.3%,20m
14030,3,ana,3156,86,3,11,14,21.4%,7m
14030,3,kev,3156,0,1,0,1,100.0%,53m
14030,1,Durza,3156,0,1,4,5,20.0%,3m
14030,3,pivanov,3156,30,1,5,6,16.7%,22m
14030,1,Skye,3156,0,0,1,1,0.0%,20m
14054,3,Garnett,3155,1027,43,41,84,51.2%,5m
14054,3,[BiGBRO]fortheglory,3155,392,23,27,50,46.0%,3m
14054,3,LAJW,3155,410,21,18,39,53.8%,10m
14054,3,[STF71]gurkini,3155,295,19,12,31,61.3%,4m
14054,1,Wrath,3155,373,15,7,22,68.2%,8m
14054,3,KoZ,3155,438,15,22,37,40.5%,8m
14054,3,[DDH]JaYJaY,3155,243,12,7,19,63.2%,8m
14054,3,OXO,3155,270,12,9,21,57.1%,16m
14054,1,[Leviou]Erebus,3155,316,9,9,18,50.0%,2m
14054,3,Shaly,3155,216,7,11,18,38.9%,5m
14054,2,[lEvTl]FooFighter,3155,191,6,10,16,37.5%,19m
14054,1,[RеG]Tsoi,3155,0,1,0,1,100.0%,7m
14054,3,VanDerJoik,3155,0,1,4,5,20.0%,6m
14054,1,San,3155,0,0,1,1,0.0%,2m
14054,1,kecar,3155,0,0,1,1,0.0%,5m
14054,1,Katsuhiro,3155,0,0,1,1,0.0%,21m
14054,1,Korbiniak,3155,0,0,1,1,0.0%,18m
14054,3,[Chauss]Madness,3155,0,0,1,1,0.0%,28m
14054,1,Goku,3155,0,0,2,2,0.0%,1m
14054,1,AlejandroXXI,3155,0,0,2,2,0.0%,6m
14054,3,[69x69]krasi,3155,0,0,4,4,0.0%,3m
14054,3,[Pietre]Euisroman,3155,0,0,5,5,0.0%,16m
14076,2,[8GRILL]tbekas,3154,1432,495,510,1005,49.3%,9m
14076,1,Inex,3154,1319,80,69,149,53.7%,9m
14076,3,Lover,3154,912,68,67,135,50.4%,5m
14076,3,[CeMo]Lycolus,3154,929,62,58,120,51.7%,19m
14076,3,Fesch,3154,668,45,35,80,56.2%,8m
14076,3,kres,3154,561,36,27,63,57.1%,8m
14076,3,olegthunder,3154,726,36,32,68,52.9%,4m
14076,3,Antho,3154,815,36,37,73,49.3%,5m
14076,3,Davish,3154,506,21,20,41,51.2%,13m
14076,1,Slait,3154,313,19,12,31,61.3%,17m
14076,1,Tracer,3154,268,8,6,14,57.1%,20m
14076,1,[BYNKER]iluba,3154,238,6,6,12,50.0%,6m
14076,1,Vatlaaw,3154,0,5,0,5,100.0%,10m
14076,1,[BAC0N]TerrorPrime,3154,78,2,4,6,33.3%,12m
14076,1,[Ape]korpuskel,3154,42,1,1,2,50.0%,6m
14076,1,pitou,3154,40,1,1,2,50.0%,8m
14076,3,[ONE]Imperius,3154,0,1,3,4,25.0%,14m
14076,1,DaNoM,3154,0,0,1,1,0.0%,5m
14094,3,itsDani,3153,1552,106,95,201,52.7%,10m
14094,1,Grosouaf,3153,1648,79,67,146,54.1%,9m
14094,3,ИванБровко,3153,1063,73,68,141,51.8%,17m
14094,3,[TheDOH]WubaLubadud,3153,1491,63,49,112,56.2%,7m
14094,3,Starfox,3153,1122,47,49,96,49.0%,5m
14094,3,Kryp,3153,159,27,21,48,56.2%,2m
14094,3,ZNEEL,3153,272,27,36,63,42.9%,7m
14094,1,[ǂVVVǂ]Barnabé,3153,590,22,18,40,55.0%,2m
14094,3,ZEn,3153,553,22,18,40,55.0%,1m
14094,1,AndrusAranha,3153,405,17,7,24,70.8%,10m
14094,1,sykefu,3153,234,7,5,12,58.3%,7m
14094,3,Darkez,3153,138,5,1,6,83.3%,9m
14094,1,SCJunkie,3153,0,4,1,5,80.0%,12m
14094,1,Gyoshi,3153,156,4,3,7,57.1%,2m
14094,3,[UJ]JIMMYJOKER,3153,170,4,5,9,44.4%,6m
14094,1,SnowEater,3153,44,2,1,3,66.7%,6m
14094,3,[Thor2]PetitHomme,3153,97,2,4,6,33.3%,42m
14094,1,[BoAnt]Kraynor,3153,0,1,0,1,100.0%,17m
14094,1,[SFPr0n]Iller,3153,0,1,0,1,100.0%,4m
14094,1,Winbar,3153,42,1,2,3,33.3%,6m
14114,3,iluvatar,3152,1155,128,119,247,51.8%,10m
14114,3,SnikerSnikS,3152,1337,109,98,207,52.7%,3m
14114,1,Bogatur,3152,1640,95,81,176,54.0%,19m
14114,3,[KStönz]FallenLegend,3152,1385,77,63,140,55.0%,3m
14114,3,[EP4E]XcellentPlay,3152,637,46,46,92,50.0%,2m
14114,3,ParadoxOn,3152,505,43,36,79,54.4%,7m
14114,3,[CaZerg]Kjubaran,3152,985,39,43,82,47.6%,6m
14114,3,greenklaus,3152,1086,39,47,86,45.3%,16m
14114,3,[ILRI]Groovy,3152,542,18,25,43,41.9%,18m
14114,3,[fam1ly]ArtiDo,3152,416,17,12,29,58.6%,19m
14114,3,iziKo,3152,321,15,17,32,46.9%,6m
14114,3,[IceHus]Ivashization,3152,323,10,15,25,40.0%,5m
14114,3,[35BZH]jojo,3152,163,7,5,12,58.3%,10m
14114,3,DaMaGeR,3152,135,6,8,14,42.9%,6m
14114,2,[DarKwi]mistralbw,3152,0,4,2,6,66.7%,34m
14114,1,russiantoxic,3152,152,4,4,8,50.0%,21m
14114,1,Disease,3152,82,3,2,5,60.0%,22m
14114,1,Borgrdr,3152,80,2,2,4,50.0%,7m
14114,3,[VGOsc2]Vertigo,3152,0,1,0,1,100.0%,26m
14114,3,Arbalest,3152,0,1,1,2,50.0%,5m
14114,3,[CNNB]Throne,3152,0,1,3,4,25.0%,7m
14114,1,[Trint]Mrphilip,3152,0,0,1,1,0.0%,21m
14114,1,TillerMaN,3152,0,0,1,1,0.0%,7m
14114,1,HodiDim,3152,0,0,3,3,0.0%,6m
14138,3,anyone,3151,1583,93,84,177,52.5%,3m
14138,3,Den,3151,661,46,47,93,49.5%,16m
14138,3,[All]Johnnybacon,3151,750,30,27,57,52.6%,3m
14138,1,MediumRare,3151,807,28,22,50,56.0%,11m
14138,1,AiRollA,3151,768,27,20,47,57.4%,10m
14138,1,Sobriety,3151,700,27,27,54,50.0%,12m
14138,3,gagk,3151,553,23,24,47,48.9%,13m
14138,3,arouane,3151,467,21,17,38,55.3%,5m
14138,3,Timkiller,3151,398,17,11,28,60.7%,17m
14138,3,Melon,3151,438,14,15,29,48.3%,10m
14138,3,aRsony,3151,350,13,16,29,44.8%,7m
14138,1,PleaseGoEasy,3151,233,10,5,15,66.7%,21m
14138,3,DefRagger,3151,125,7,2,9,77.8%,17m
14138,1,llllllllllll,3151,152,5,2,7,71.4%,8m
14138,1,Mariusz,3151,120,5,2,7,71.4%,10m
14138,3,Manuel,3151,0,4,2,6,66.7%,31m
14138,1,sqweqweqwe,3151,82,3,1,4,75.0%,4m
14138,1,WiTeSheeP,3151,0,3,2,5,60.0%,5m
14138,3,[ELCC]Zaltes,3151,60,3,6,9,33.3%,6m
14138,1,robinhood,3151,42,2,0,2,100.0%,6m
14138,1,Thur,3151,0,1,0,1,100.0%,6m
14138,1,Linkin,3151,0,0,1,1,0.0%,21m
14138,1,Misho,3151,0,0,2,2,0.0%,20m
14138,1,Boogie,3151,0,0,3,3,0.0%,2m
14138,1,[J4E]Golddragon,3151,0,0,3,3,0.0%,30m
14138,3,[Ly]SSJPascal,3151,0,0,6,6,0.0%,5m
14164,1,SrAǂHgtefr,3150,1754,635,614,1249,50.8%,21m
14164,3,LeMarquis,3150,1213,226,217,443,51.0%,18m
14164,3,Botis,3150,1317,206,210,416,49.5%,2m
14164,3,AveSwarmWLM,3150,1354,160,150,310,51.6%,4m
14164,1,swelf,3150,1746,137,132,269,50.9%,6m
14164,1,Superman,3150,1753,84,80,164,51.2%,9m
14164,3,Grindmork,3150,1181,78,69,147,53.1%,2m
14164,2,Crow,3150,1514,76,84,160,47.5%,13m
14164,3,[ZERG7V]MadBird,3150,898,63,24,87,72.4%,13m
14164,3,Lati,3150,629,50,41,91,54.9%,4m
14164,3,RentFree,3150,948,38,38,76,50.0%,7m
14164,3,JustThatLuka,3150,684,36,34,70,51.4%,14m
14164,1,Coosto,3150,534,18,11,29,62.1%,13m
14164,1,Cadnium,3150,274,14,0,14,100.0%,11m
14164,3,[OРДА]батя,3150,356,14,17,31,45.2%,17m
14164,3,Flowcharted,3150,391,13,16,29,44.8%,11m
14164,3,[HUN13r]Cadett,3150,354,13,17,30,43.3%,23m
14164,3,[N1M]Laidius,3150,121,6,3,9,66.7%,11m
14164,1,[bullD]адзунян,3150,80,3,1,4,75.0%,11m
14164,3,korail,3150,0,3,2,5,60.0%,50m
14164,3,JakoBo,3150,90,3,12,15,20.0%,10m
14164,1,LemonenJäger,3150,80,2,2,4,50.0%,10m
14164,1,[LVXE]AƻC,3150,0,1,1,2,50.0%,22m
14164,1,[RLA]AGǂEaren,3150,0,0,1,1,0.0%,21m
14164,1,hola,3150,0,0,1,1,0.0%,14m
14164,1,Nik,3150,0,0,1,1,0.0%,21m
14164,2,Fidel,3150,0,0,2,2,0.0%,3m
14191,3,[mfxed]obcengi,3149,1558,333,333,666,50.0%,9m
14191,3,korid,3149,826,99,90,189,52.4%,5m
14191,3,MyAmaranth,3149,1268,49,55,104,47.1%,16m
14191,3,Øbscuritas,3149,426,44,38,82,53.7%,2m
14191,3,Xupypr,3149,1173,43,42,85,50.6%,16m
14191,3,Qalacat,3149,411,34,33,67,50.7%,18m
14191,1,LDMA,3149,369,12,13,25,48.0%,17m
14191,3,Eviliys,3149,207,10,6,16,62.5%,16m
14191,3,Gertturbo,3149,214,9,6,15,60.0%,5m
14191,1,Majestic,3149,44,2,0,2,100.0%,17m
14191,1,robotikov,3149,78,2,1,3,66.7%,22m
14191,3,Loko,3149,0,1,0,1,100.0%,36m
14191,1,fetzo,3149,0,1,0,1,100.0%,3m
14191,1,[NoSepi]Antihero,3149,42,1,1,2,50.0%,7m
14191,1,Sintaist,3149,0,1,1,2,50.0%,22m
14191,3,[Kuchen]Roqskillz,3149,0,1,3,4,25.0%,21m
14191,1,[ville9]BotRoss,3149,0,0,1,1,0.0%,12m
14191,1,TartoFraize,3149,0,0,1,1,0.0%,18m
14209,3,Naisy,3148,1228,112,108,220,50.9%,3m
14209,3,Zacke,3148,799,95,88,183,51.9%,13m
14209,3,FRIK,3148,1293,87,88,175,49.7%,6m
14209,3,Flaku,3148,1511,85,66,151,56.3%,3m
14209,3,[696]nilsragnar,3148,494,18,20,38,47.4%,12m
14209,3,DiskHisp,3148,342,15,11,26,57.7%,14m
14209,3,[AMCque]MoNsTeR,3148,356,11,13,24,45.8%,17m
14209,3,Joker,3148,217,9,7,16,56.2%,7m
14209,1,herrar,3148,253,8,2,10,80.0%,7m
14209,1,ForEveR,3148,205,8,5,13,61.5%,38m
14209,3,Thorki,3148,212,8,10,18,44.4%,6m
14209,2,DarkMatter,3148,229,7,5,12,58.3%,11m
14209,2,SREnigma,3148,164,5,0,5,100.0%,34m
14209,3,[XEA]throw,3148,0,4,1,5,80.0%,19m
14209,3,MartyMcFly,3148,164,4,6,10,40.0%,8m
14209,1,CaptainBebop,3148,0,3,2,5,60.0%,18m
14209,3,[CZSC]SHADOW,3148,58,3,6,9,33.3%,14m
14209,1,wooooooshhhh,3148,0,2,3,5,40.0%,10m
14209,3,GeneralTeo,3148,44,2,4,6,33.3%,10m
14209,3,Pawnee,3148,58,2,8,10,20.0%,6m
14209,1,[RABD]CASH,3148,0,1,0,1,100.0%,11m
14209,1,zzz,3148,40,1,1,2,50.0%,9m
14209,1,Chim,3148,0,1,2,3,33.3%,3m
14209,3,Maelstrom,3148,94,1,2,3,33.3%,8m
14209,1,DrunkWarrior,3148,38,1,3,4,25.0%,18m
14209,3,[1FU2]ProxyNydus,3148,30,1,5,6,16.7%,22m
14235,3,SayMeWhy,3147,1048,94,93,187,50.3%,10m
14235,3,JigSaw,3147,886,71,62,133,53.4%,17m
14235,3,[UE]Orbit,3147,956,66,73,139,47.5%,11m
14235,1,caineurs,3147,1544,64,50,114,56.1%,1m
14235,1,Iados,3147,899,49,35,84,58.3%,23m
14235,3,Sikke,3147,1104,42,45,87,48.3%,16m
14235,3,GopStop,3147,519,35,33,68,51.5%,5m
14235,3,BenGuruSon,3147,776,28,33,61,45.9%,7m
14235,3,misterapple,3147,202,26,19,45,57.8%,9m
14235,3,Diamand,3147,173,14,11,25,56.0%,20m
14235,1,[M4GYK]Manty,3147,366,10,12,22,45.5%,8m
14235,3,eLFix,3147,214,8,11,19,42.1%,11m
14235,3,ScoobyLoo,3147,246,8,13,21,38.1%,6m
14235,3,Derisus,3147,86,7,7,14,50.0%,3m
14235,3,SolarLair,3147,180,6,12,18,33.3%,20m
14235,3,Wealdan,3147,0,4,2,6,66.7%,1h
14235,1,Gadac,3147,106,3,4,7,42.9%,7m
14235,2,SupZero,3147,88,2,0,2,100.0%,11m
14235,1,[Сlеver]Alximik,3147,0,1,0,1,100.0%,21m
14235,1,HANNIBAL,3147,0,1,0,1,100.0%,18m
14235,1,johs,3147,0,1,0,1,100.0%,19m
14235,1,Rajaka,3147,42,1,1,2,50.0%,22m
14235,2,Ahsoka,3147,95,1,1,2,50.0%,46m
14235,1,[OGTV]Lorgard,3147,40,1,2,3,33.3%,3m
14235,1,[Mavis]FireStarter,3147,0,0,1,1,0.0%,13m
14235,1,Zilaz,3147,0,0,1,1,0.0%,21m
14235,1,BystryMłot,3147,0,0,1,1,0.0%,18m
14235,2,Bigsexrobot,3147,0,0,3,3,0.0%,3m
14263,3,Mortician,3146,553,78,75,153,51.0%,7m
14263,1,skyknight,3146,1285,48,37,85,56.5%,10m
14263,1,Merdek,3146,618,32,30,62,51.6%,6m
14263,3,NSpire,3146,260,11,8,19,57.9%,21m
14263,1,TareCaani,3146,327,9,4,13,69.2%,18m
14263,1,tmcSeomon,3146,89,3,2,5,60.0%,20m
14263,3,TheBishop,3146,137,3,5,8,37.5%,6m
14263,1,Flux,3146,0,0,1,1,0.0%,21m
14263,3,CCAA,3146,0,0,1,1,0.0%,5m
14263,1,Stonekiller,3146,0,0,1,1,0.0%,20m
14273,3,ChewieDOG,3145,1539,134,137,271,49.4%,11m
14273,3,[httman]Hattman,3145,1482,92,81,173,53.2%,3m
14273,1,Klaue,3145,1421,89,43,132,67.4%,5m
14273,1,shaman,3145,1164,84,20,104,80.8%,8m
14273,3,Niafront,3145,1073,66,67,133,49.6%,11m
14273,1,Satella,3145,449,64,35,99,64.6%,8m
14273,1,[ČSSR]Needle,3145,946,31,29,60,51.7%,5m
14273,1,МаминХулиган,3145,525,20,12,32,62.5%,5m
14273,3,Maxx,3145,437,20,19,39,51.3%,22m
14273,3,hawi,3145,413,19,24,43,44.2%,11m
14273,3,[RBP3]Bidon,3145,422,18,13,31,58.1%,12m
14273,1,BroZBravo,3145,119,6,3,9,66.7%,20m
14273,1,[THRLLA]Cookeie,3145,152,4,3,7,57.1%,10m
14273,3,Rhaegar,3145,88,4,6,10,40.0%,2m
14273,3,[Heroes]Cloud,3145,117,3,6,9,33.3%,21m
14273,3,iceBearD,3145,92,2,2,4,50.0%,17m
14273,1,Paul,3145,144,2,3,5,40.0%,13m
14273,1,[SÐ]HumåkT,3145,42,2,3,5,40.0%,21m
14273,3,Airty,3145,60,2,6,8,25.0%,2m
14273,1,Monarch,3145,0,1,0,1,100.0%,23m
14273,2,[GCeva]Lomo,3145,0,1,1,2,50.0%,16m
14273,3,TilyX,3145,30,1,6,7,14.3%,10m
14273,1,Gortal,3145,0,0,1,1,0.0%,7m
14296,3,Maditation,3144,1493,385,374,759,50.7%,2m
14296,3,unearthyone,3144,852,30,31,61,49.2%,4m
14296,3,[SAX]Jonne,3144,504,29,36,65,44.6%,10m
14296,1,CaroleBaskin,3144,437,12,9,21,57.1%,3m
14296,1,Scrabble,3144,213,9,6,15,60.0%,13m
14296,1,Oleg,3144,310,9,6,15,60.0%,19m
14296,1,Evilkidz,3144,0,5,0,5,100.0%,17m
14296,3,vCrYLvSwOrk,3144,30,5,3,8,62.5%,4m
14296,3,Xurion,3144,120,5,9,14,35.7%,13m
14296,1,HandofDeath,3144,86,3,3,6,50.0%,6m
14296,1,[DMøøn]DOOM,3144,96,3,11,14,21.4%,15m
14296,1,[xFRSx]Sherlock,3144,82,2,3,5,40.0%,4m
14296,3,IIIIIIIIIIII,3144,30,1,5,6,16.7%,2m
14296,1,[FMQ]Helix,3144,0,0,1,1,0.0%,18m
14296,1,Lion,3144,0,0,1,1,0.0%,22m
14296,1,DragonKirb,3144,0,0,2,2,0.0%,6m
14296,1,[NKPC]GodFake,3144,0,0,3,3,0.0%,18m
14296,3,[MeVih]swikni,3144,0,0,4,4,0.0%,4m
14314,3,ImWithStupid,3143,1152,126,131,257,49.0%,12m
14314,1,Nosfer,3143,1365,82,73,155,52.9%,12m
14314,3,Ceder,3143,466,74,69,143,51.7%,2m
14314,3,Valuga,3143,264,70,60,130,53.8%,22m
14314,3,Rektangle,3143,338,38,29,67,56.7%,9m
14314,3,AuxiLeCookie,3143,942,38,31,69,55.1%,4m
14314,3,AhtunG,3143,656,23,31,54,42.6%,6m
14314,1,Motörhead,3143,239,10,3,13,76.9%,12m
14314,3,KrakDark,3143,213,9,5,14,64.3%,9m
14314,3,[SD7]IstX,3143,184,6,5,11,54.5%,10m
14314,1,reyni,3143,168,4,5,9,44.4%,3m
14314,1,[CocoCo]Sillenoz,3143,84,3,4,7,42.9%,8m
14314,1,AverageJoe,3143,42,2,1,3,66.7%,13m
14314,1,OnlyFrans,3143,78,2,1,3,66.7%,3m
14314,1,Fastlane,3143,80,2,5,7,28.6%,22m
14314,3,AJSC,3143,121,2,5,7,28.6%,26m
14314,1,[canZeg]oscaridley,3143,0,1,2,3,33.3%,3m
14314,1,Aries,3143,46,1,4,5,20.0%,6m
14314,3,Prae,3143,0,0,1,1,0.0%,9m
14314,1,[DWTeam]Andragon,3143,0,0,1,1,0.0%,5m
14314,3,Khankki,3143,0,0,5,5,0.0%,59m
14335,3,Vio,3142,1547,169,148,317,53.3%,2m
14335,3,Sephiröth,3142,1384,123,120,243,50.6%,11m
14335,3,Eol,3142,1084,87,89,176,49.4%,17m
14335,3,Afrikalibyan,3142,1046,64,68,132,48.5%,2m
14335,1,Kamil,3142,966,54,52,106,50.9%,17m
14335,3,VodKanibal,3142,1267,50,51,101,49.5%,5m
14335,3,BitBlit,3142,1286,48,52,100,48.0%,4m
14335,3,Mephystofel,3142,542,37,42,79,46.8%,22m
14335,1,Umata,3142,519,18,11,29,62.1%,20m
14335,1,Vamis,3142,416,12,8,20,60.0%,5m
14335,1,Tusk,3142,276,7,8,15,46.7%,6m
14335,1,SimplyGregor,3142,192,5,6,11,45.5%,18m
14335,1,SpicyHummus,3142,0,4,1,5,80.0%,7m
14335,1,[KiII]Killer,3142,80,3,1,4,75.0%,9m
14335,3,theapfel,3142,145,3,4,7,42.9%,4m
14335,3,dio,3142,122,2,5,7,28.6%,22m
14335,1,Anomick,3142,0,1,2,3,33.3%,35m
14335,1,Lonnit,3142,40,1,2,3,33.3%,4m
14335,1,BooMC,3142,40,1,4,5,20.0%,18m
14335,1,Duke,3142,0,0,1,1,0.0%,9m
14335,1,[Gоld]Univers,3142,0,0,1,1,0.0%,17m
14356,3,Grorel,3141,1618,231,220,451,51.2%,4m
14356,3,chips,3141,1551,200,190,390,51.3%,2m
14356,3,TUI,3141,1546,183,180,363,50.4%,3m
14356,3,Samed,3141,1667,154,150,304,50.7%,6m
14356,3,Django,3141,1529,99,91,190,52.1%,13m
14356,3,RomperStompr,3141,1300,73,72,145,50.3%,13m
14356,3,[BOBOI]Valsty,3141,635,26,29,55,47.3%,10m
14356,3,soulpirate,3141,693,24,32,56,42.9%,9m
14356,3,[NaZi]fashisto,3141,491,17,18,35,48.6%,21m
14356,1,Raek,3141,235,16,12,28,57.1%,21m
14356,3,Szumazu,3141,316,14,6,20,70.0%,12m
14356,3,maverick,3141,252,8,16,24,33.3%,7m
14356,3,[Fxnadu]Insanemika,3141,178,7,12,19,36.8%,11m
14356,2,TOR,3141,96,5,3,8,62.5%,17m
14356,3,Fatnoob,3141,121,4,3,7,57.1%,29m
14356,1,[iX]BKBStorMCroW,3141,124,4,5,9,44.4%,22m
14356,3,[Degab]DEFEHUN,3141,130,4,15,19,21.1%,3m
14356,1,[TonT0n]Tonstor,3141,114,3,8,11,27.3%,1m
14356,2,sakura,3141,119,2,2,4,50.0%,5m
14356,2,[DeSnou]Delas,3141,96,2,3,5,40.0%,1h
14356,1,Filips,3141,40,2,3,5,40.0%,21m
14356,1,HyungMin,3141,32,2,4,6,33.3%,22m
14356,1,[DLD]Janney,3141,0,0,1,1,0.0%,21m
14356,1,Игон,3141,0,0,1,1,0.0%,8m
14356,3,lighthottie,3141,0,0,1,1,0.0%,42m
14356,1,[PUSS]Сосруко,3141,0,0,1,1,0.0%,13m
14356,1,[WYG]Pierre,3141,0,0,1,1,0.0%,23m
14356,1,Jabjab,3141,0,0,2,2,0.0%,9m
14356,1,Danmirans,3141,0,0,2,2,0.0%,21m
14385,3,Berkules,3140,1560,289,292,581,49.7%,11m
14385,3,[ArchTV]Dolmatt,3140,1523,157,159,316,49.7%,22m
14385,3,[RBlood]lebrute,3140,1602,116,118,234,49.6%,12m
14385,3,Icaro,3140,617,104,97,201,51.7%,17m
14385,1,Smile,3140,1695,63,55,118,53.4%,5m
14385,3,Alfonzo,3140,736,60,48,108,55.6%,17m
14385,3,[Vøid]Viodaey,3140,495,42,51,93,45.2%,7m
14385,3,erk,3140,646,41,30,71,57.7%,12m
14385,3,llllllllllll,3140,624,26,22,48,54.2%,4m
14385,1,DaSwarm,3140,423,17,8,25,68.0%,10m
14385,3,Tacita,3140,368,17,18,35,48.6%,4m
14385,3,Gsus,3140,335,17,21,38,44.7%,6m
14385,3,JohnBlond,3140,485,17,24,41,41.5%,9m
14385,3,[BLCK]hembbaa,3140,368,13,20,33,39.4%,17m
14385,3,NipeL,3140,209,6,9,15,40.0%,10m
14385,1,oxymoron,3140,42,2,1,3,66.7%,18m
14385,1,[Frins]Kerrichal,3140,78,2,1,3,66.7%,9m
14385,1,Shaman,3140,0,0,1,1,0.0%,9m
14385,1,[Heroes]swagman,3140,0,0,1,1,0.0%,5m
14404,3,PHV,3139,1589,459,456,915,50.2%,4m
14404,3,Jintro,3139,1566,149,156,305,48.9%,2m
14404,3,Judex,3139,1449,128,118,246,52.0%,17m
14404,1,ANT,3139,696,64,47,111,57.7%,12m
14404,1,Papai,3139,1262,51,44,95,53.7%,2m
14404,3,Freekl,3139,719,32,41,73,43.8%,5m
14404,1,majsmannen,3139,780,31,23,54,57.4%,21m
14404,1,IIIIIIIIIIII,3139,602,20,11,31,64.5%,10m
14404,3,[gEg]Bugfinder,3139,314,13,14,27,48.1%,4m
14404,3,[SRoB]Andrey,3139,317,10,12,22,45.5%,22m
14404,3,Murdoch,3139,236,9,16,25,36.0%,13m
14404,3,[hBǂ]Tournesol,3139,208,8,16,24,33.3%,12m
14404,3,Teg,3139,136,6,4,10,60.0%,22m
14404,1,Chronos,3139,156,5,3,8,62.5%,21m
14404,1,[B4EV]Cephero,3139,118,3,3,6,50.0%,3m
14404,1,Djent,3139,36,2,4,6,33.3%,7m
14404,1,[lancon]ARITHON,3139,0,1,0,1,100.0%,20m
14404,1,[SRC]MooDuck,3139,0,1,0,1,100.0%,10m
14404,3,JohnKennedy,3139,30,1,4,5,20.0%,20m
14404,1,Dorne,3139,0,0,1,1,0.0%,2m
14404,1,Mirage,3139,0,0,1,1,0.0%,6m
14404,1,Gramps,3139,0,0,3,3,0.0%,17m
14426,3,FOX,3138,1512,137,134,271,50.6%,11m
14426,3,Mithrandir,3138,1520,127,128,255,49.8%,6m
14426,1,Lotus,3138,1396,122,101,223,54.7%,10m
14426,3,maingantée,3138,1455,77,78,155,49.7%,3m
14426,3,Trial,3138,883,60,55,115,52.2%,12m
14426,1,Angel,3138,1098,57,40,97,58.8%,13m
14426,3,[k1raen]ALISHER,3138,1181,49,48,97,50.5%,17m
14426,3,ysyh,3138,414,40,42,82,48.8%,2m
14426,3,makita,3138,410,36,43,79,45.6%,20m
14426,3,[Harley]Liberty,3138,807,31,29,60,51.7%,8m
14426,1,Path,3138,760,27,22,49,55.1%,20m
14426,3,[IceHus]Oleg,3138,528,20,19,39,51.3%,13m
14426,3,Jarre,3138,371,18,19,37,48.6%,11m
14426,3,Karamazad,3138,403,16,13,29,55.2%,4m
14426,2,[lEBBl]Jokeless,3138,118,5,3,8,62.5%,11m
14426,3,justFun,3138,0,4,1,5,80.0%,46m
14426,3,PrettyFly,3138,0,4,1,5,80.0%,46m
14426,1,[NOKOFF]OldYogurt,3138,162,4,4,8,50.0%,4m
14426,1,[FAZE69]Eltigrethor,3138,124,3,2,5,60.0%,22m
14426,1,[DМG]MasterYoda,3138,118,3,3,6,50.0%,6m
14426,1,SlckWolkie,3138,138,3,4,7,42.9%,2m
14426,1,[Darkia]Jinx,3138,36,2,2,4,50.0%,3m
14426,3,[Ŧєzz]DonJunior,3138,60,2,7,9,22.2%,5m
14426,1,luckygirl,3138,0,1,0,1,100.0%,12m
14426,1,DoDo,3138,0,1,1,2,50.0%,6m
14426,1,Rex,3138,0,1,1,2,50.0%,3m
14426,1,[D0N3]tiakun,3138,0,1,1,2,50.0%,10m
14426,1,FatherDrift,3138,0,1,1,2,50.0%,7m
14426,3,Dodo,3138,0,1,2,3,33.3%,17m
14426,1,Kryp,3138,36,1,4,5,20.0%,9m
14426,3,Afflictiónz,3138,0,0,1,1,0.0%,27m
14426,1,Grotfang,3138,0,0,1,1,0.0%,10m
14426,1,Gârât,3138,0,0,1,1,0.0%,2m
14459,3,[ATSEV]blux,3137,1492,134,138,272,49.3%,8m
14459,3,CheckReality,3137,1544,105,110,215,48.8%,17m
14459,3,[DG3]Warrior,3137,477,68,88,156,43.6%,5m
14459,3,Artemis,3137,1273,46,49,95,48.4%,21m
14459,3,[sc2swa]Dahaka,3137,636,29,34,63,46.0%,6m
14459,1,baniling,3137,501,28,14,42,66.7%,2m
14459,3,LLIAMAH,3137,587,26,24,50,52.0%,14m
14459,3,[OSgZ]Thrawn,3137,464,21,15,36,58.3%,21m
14459,3,[ZDxD]Azncharles,3137,338,14,9,23,60.9%,20m
14459,3,[PAF31]Fazprout,3137,334,12,18,30,40.0%,9m
14459,3,Tyranek,3137,286,10,19,29,34.5%,19m
14459,1,Elmoi,3137,246,9,7,16,56.2%,10m
14459,2,ovo,3137,95,6,2,8,75.0%,16m
14459,1,Sewage,3137,183,5,2,7,71.4%,17m
14459,1,[BulBul]Envirobeer,3137,200,5,8,13,38.5%,5m
14459,1,[S1N]TorrentKattn,3137,0,4,1,5,80.0%,5m
14459,1,omerekren,3137,118,4,3,7,57.1%,10m
14459,1,ValeraOpasni,3137,68,3,1,4,75.0%,2m
14459,1,hixpérion,3137,96,3,2,5,60.0%,22m
14459,3,BoozyB,3137,60,2,13,15,13.3%,4m
14459,1,Asporine,3137,42,1,3,4,25.0%,21m
14459,3,MMM,3137,30,1,5,6,16.7%,18m
14459,3,[SDTL]Veritas,3137,0,1,7,8,12.5%,21m
14459,1,Darkling,3137,0,0,1,1,0.0%,6m
14459,1,[MoWo]ordos,3137,0,0,1,1,0.0%,2m
14484,1,Cyz,3136,916,75,62,137,54.7%,6m
14484,3,[A2W]JaïDy,3136,619,51,51,102,50.0%,20m
14484,3,GeneraKenobi,3136,1138,45,39,84,53.6%,3m
14484,1,Femto,3136,792,36,21,57,63.2%,20m
14484,1,[NotSuR]Kipyatosh,3136,326,11,3,14,78.6%,5m
14484,1,Lou,3136,214,9,6,15,60.0%,13m
14484,1,LEX,3136,298,9,8,17,52.9%,5m
14484,3,[UPS]bubbalisk,3136,268,9,11,20,45.0%,7m
14484,3,IIIIIIIIIIII,3136,257,8,7,15,53.3%,3m
14484,3,[MooK]NerfProtoss,3136,246,8,18,26,30.8%,12m
14484,1,[EmŦ]Monta,3136,228,7,4,11,63.6%,9m
14484,3,Tonni,3136,0,5,0,5,100.0%,45m
14484,1,[Granze]Kanapski,3136,156,5,2,7,71.4%,11m
14484,1,UltraM,3136,162,5,4,9,55.6%,6m
14484,3,Wurfyt,3136,0,3,2,5,60.0%,54m
14484,1,Lucky,3136,82,2,2,4,50.0%,18m
14484,1,lIlIlIlIlIlI,3136,0,2,3,5,40.0%,18m
14484,3,Mambos,3136,122,2,4,6,33.3%,17m
14484,3,[12844]Lillmackan,3136,0,1,0,1,100.0%,45m
14484,1,KolyanExe,3136,42,1,4,5,20.0%,17m
14484,1,[DisES]Rekin,3136,0,0,1,1,0.0%,6m
14484,1,denthsun,3136,0,0,3,3,0.0%,18m
14506,3,Sania,3135,1325,95,103,198,48.0%,2m
14506,3,[PcT]canard,3135,1336,47,60,107,43.9%,11m
14506,1,[drth]pocko,3135,731,28,17,45,62.2%,5m
14506,3,scipio,3135,738,26,40,66,39.4%,19m
14506,3,Xavier,3135,272,10,7,17,58.8%,2m
14506,3,Werstef,3135,145,6,2,8,75.0%,5m
14506,3,[ƬC]XCOM,3135,0,4,2,6,66.7%,29m
14506,3,[TCWAN]Bæver,3135,143,4,5,9,44.4%,17m
14506,1,George,3135,116,3,1,4,75.0%,1m
14506,1,LeoSponza,3135,82,3,1,4,75.0%,2m
14506,3,Коготь,3135,138,3,5,8,37.5%,7m
14506,1,Bakó,3135,112,3,5,8,37.5%,18m
14506,1,Greenknight,3135,42,2,0,2,100.0%,7m
14506,1,[LEAN]TheBrain,3135,113,2,3,5,40.0%,18m
14506,1,[KStyle]sitry,3135,0,1,1,2,50.0%,23m
14506,2,iiiiiilliiii,3135,0,1,1,2,50.0%,17m
14506,1,[AntCol]xXiklititiXx,3135,40,1,3,4,25.0%,2m
14506,3,Lokiran,3135,30,1,5,6,16.7%,8m
14506,1,Rippon,3135,0,0,1,1,0.0%,18m
14506,1,MetalRaider,3135,0,0,1,1,0.0%,7m
14526,3,MoOnZe,3134,1599,185,174,359,51.5%,10m
14526,3,PiTTiLLo,3134,1504,76,76,152,50.0%,21m
14526,3,VlaykovBG,3134,1293,60,67,127,47.2%,10m
14526,3,Norwind,3134,1048,36,47,83,43.4%,21m
14526,3,Rakovoz,3134,794,31,30,61,50.8%,6m
14526,1,GameZsoocube,3134,361,11,9,20,55.0%,5m
14526,1,[H2DICK]SoRuKa,3134,189,8,5,13,61.5%,54m
14526,2,[FUEU]MikeU,3134,42,5,3,8,62.5%,32m
14526,1,[PLA2N]Leeroy,3134,162,4,6,10,40.0%,21m
14526,1,Daedalus,3134,82,3,1,4,75.0%,17m
14526,1,Gilgamesh,3134,118,3,5,8,37.5%,10m
14526,1,[ärhoo]syila,3134,40,2,0,2,100.0%,4m
14526,3,OhDaeSu,3134,58,2,6,8,25.0%,17m
14526,1,Garm,3134,0,1,0,1,100.0%,5m
14526,1,Rixer,3134,40,1,2,3,33.3%,3m
14526,1,ASH,3134,95,1,2,3,33.3%,10m
14526,1,wambotcha,3134,44,1,3,4,25.0%,20m
14526,3,StK,3134,0,1,5,6,16.7%,17m
14526,1,[xFLGx]SergeantE,3134,0,0,2,2,0.0%,12m
14545,1,ImSorryManGG,3133,1248,114,90,204,55.9%,9m
14545,1,DrDrake,3133,1314,56,55,111,50.5%,10m
14545,1,[Bwolfs]NickYU,3133,1090,39,36,75,52.0%,5m
14545,1,dolmio,3133,968,30,34,64,46.9%,2m
14545,1,[КЕКS]niksap,3133,515,21,13,34,61.8%,2m
14545,1,LiderHW,3133,482,20,8,28,71.4%,9m
14545,1,Bane,3133,477,20,11,31,64.5%,6m
14545,3,casualxx,3133,468,18,21,39,46.2%,5m
14545,3,Pots,3133,344,13,11,24,54.2%,14m
14545,1,bert,3133,182,10,3,13,76.9%,21m
14545,1,[TOFG]DOOM,3133,356,10,13,23,43.5%,3m
14545,1,ZedKiller,3133,296,9,9,18,50.0%,2m
14545,3,Swib,3133,178,6,7,13,46.2%,4m
14545,1,[ВSL]Exalted,3133,160,5,3,8,62.5%,2m
14545,3,MasonIsHiga,3133,0,4,2,6,66.7%,24m
14545,3,Муландир,3133,175,4,8,12,33.3%,8m
14545,3,goira,3133,123,3,5,8,37.5%,7m
14545,1,RiQuuu,3133,80,2,3,5,40.0%,9m
14545,1,vita,3133,84,2,4,6,33.3%,6m
14545,3,[CovPar]Cyrialkiller,3133,0,2,5,7,28.6%,8m
14545,1,[MoFe]Faustus,3133,0,1,0,1,100.0%,18m
14545,1,FyGodddddd,3133,0,1,0,1,100.0%,5m
14545,1,IIIIIIIIIIII,3133,0,1,0,1,100.0%,23m
14545,3,Aosaki,3133,0,1,0,1,100.0%,5m
14545,1,Vespa,3133,40,1,5,6,16.7%,6m
14545,1,[PrAy8T]ChetBaker,3133,0,0,2,2,0.0%,20m
14545,1,Testi,3133,0,0,2,2,0.0%,22m
14572,1,bastoune,3132,1759,152,134,286,53.1%,18m
14572,3,MYMOperator,3132,1568,74,85,159,46.5%,4m
14572,3,Vampöbelli,3132,1418,49,62,111,44.1%,6m
14572,1,Eighth,3132,218,30,19,49,61.2%,2m
14572,3,TheJangler,3132,605,27,10,37,73.0%,12m
14572,3,CoS,3132,657,26,22,48,54.2%,8m
14572,1,Rangleklods,3132,482,23,5,28,82.1%,22m
14572,1,Greengimp,3132,427,18,15,33,54.5%,18m
14572,3,[Dinky]Halloikama,3132,414,15,18,33,45.5%,10m
14572,1,[Arrows]IvanKoghedub,3132,396,12,10,22,54.5%,6m
14572,1,Mak,3132,342,10,7,17,58.8%,1m
14572,3,Rommeo,3132,312,10,15,25,40.0%,16m
14572,1,[NTLA]AlessioHu,3132,300,9,7,16,56.2%,10m
14572,1,[SYSTEМ]LocalHost,3132,175,6,5,11,54.5%,21m
14572,1,Licorico,3132,135,6,7,13,46.2%,5m
14572,1,[SCHD]Riverse,3132,118,4,1,5,80.0%,18m
14572,1,[T4E]Flitzpiepe,3132,120,3,2,5,60.0%,5m
14572,3,[Miszcz]kaktanternak,3132,30,3,6,9,33.3%,2m
14572,3,KoScHmArChE,3132,30,2,5,7,28.6%,8m
14572,1,SchurupIK,3132,34,1,2,3,33.3%,21m
14572,1,[WNTR]WhiteTrash,3132,0,0,1,1,0.0%,9m
14572,1,whonoobtheme,3132,0,0,1,1,0.0%,2m
14572,1,Borsti,3132,0,0,2,2,0.0%,21m
14572,1,davidliga,3132,0,0,3,3,0.0%,7m
14596,3,Argianis,3131,1485,158,148,306,51.6%,2m
14596,3,rotn,3131,1346,123,109,232,53.0%,13m
14596,3,Cirocco,3131,1493,107,93,200,53.5%,13m
14596,3,Senechaux,3131,1305,55,45,100,55.0%,22m
14596,3,ToadKing,3131,873,46,38,84,54.8%,21m
14596,3,vfursyk,3131,1104,44,43,87,50.6%,21m
14596,3,[beeeer]FRAGlator,3131,410,19,13,32,59.4%,7m
14596,1,kinze,3131,360,11,7,18,61.1%,23m
14596,1,[WBever]Jelljel,3131,270,8,6,14,57.1%,8m
14596,1,[LZA]DarkRhydoc,3131,196,6,8,14,42.9%,2m
14596,3,Gencho,3131,178,6,15,21,28.6%,12m
14596,3,skileet,3131,158,5,4,9,55.6%,22m
14596,1,[Kngsmn]Ryssdani,3131,0,4,1,5,80.0%,5m
14596,3,AshlynRae,3131,97,4,2,6,66.7%,2m
14596,3,[KNGS]Valerash,3131,58,3,5,8,37.5%,21m
14596,1,Galaxiors,3131,38,2,2,4,50.0%,10m
14596,1,Qwister,3131,82,2,2,4,50.0%,6m
14596,1,Xvolte,3131,80,2,3,5,40.0%,6m
14596,1,ache,3131,40,2,3,5,40.0%,21m
14596,1,Nir,3131,42,2,3,5,40.0%,12m
14596,1,BPog,3131,89,2,4,6,33.3%,9m
14596,1,martinf,3131,0,1,1,2,50.0%,21m
14596,1,[GTOWN]MadsT,3131,0,0,1,1,0.0%,10m
14619,3,EvGT,3130,1321,149,145,294,50.7%,11m
14619,3,[сSсǃ]MacroLee,3130,1441,98,78,176,55.7%,12m
14619,1,Scandal,3130,1054,56,57,113,49.6%,18m
14619,3,ForNurgl,3130,982,55,52,107,51.4%,14m
14619,3,gevolushn,3130,1257,55,60,115,47.8%,7m
14619,3,[REZO]TerranKILLER,3130,652,32,37,69,46.4%,10m
14619,3,LazyOrc,3130,724,27,32,59,45.8%,8m
14619,3,Sylvanior,3130,407,18,28,46,39.1%,12m
14619,3,Chester,3130,526,18,29,47,38.3%,19m
14619,3,raZoRfeX,3130,321,15,24,39,38.5%,18m
14619,1,[D0N3]Enyalos,3130,244,11,6,17,64.7%,2m
14619,3,Prophete,3130,220,10,9,19,52.6%,7m
14619,3,Alexi,3130,218,7,13,20,35.0%,13m
14619,1,Starz,3130,188,5,3,8,62.5%,21m
14619,3,Vaaco,3130,90,5,9,14,35.7%,3m
14619,3,Sky,3130,93,4,3,7,57.1%,19m
14619,1,[5weaty]brown,3130,159,3,1,4,75.0%,12m
14619,1,mag,3130,0,1,1,2,50.0%,10m
14619,1,ITACHI,3130,0,0,1,1,0.0%,23m
14619,1,Pajskor,3130,0,0,1,1,0.0%,6m
14619,1,[BULB]RED,3130,0,0,1,1,0.0%,22m
14619,1,[russes]KirusPapirus,3130,0,0,2,2,0.0%,2m
14619,1,MeThaDom,3130,0,0,3,3,0.0%,5m
14619,3,tonioecto,3130,0,0,5,5,0.0%,6m
14643,3,DerDonHugo,3129,1496,169,161,330,51.2%,21m
14643,1,Zerg,3129,910,116,99,215,54.0%,5m
14643,3,DIMI,3129,647,65,51,116,56.0%,10m
14643,3,zeitnot,3129,701,27,33,60,45.0%,5m
14643,1,[Arrows]Limbo,3129,352,17,12,29,58.6%,7m
14643,1,Hechi,3129,340,16,12,28,57.1%,21m
14643,1,XAVOUNET,3129,486,15,13,28,53.6%,13m
14643,3,TheEyeszlade,3129,72,10,16,26,38.5%,6m
14643,1,fepnatchy,3129,0,5,0,5,100.0%,11m
14643,1,[z0o]Cow,3129,158,5,5,10,50.0%,9m
14643,1,MrBaneling,3129,78,3,3,6,50.0%,21m
14643,1,[anse]LeonDerProfi,3129,0,2,1,3,66.7%,3m
14643,1,RamozUA,3129,40,2,1,3,66.7%,2m
14643,1,Azazal,3129,44,1,2,3,33.3%,18m
14643,3,PRAETORIAN,3129,0,1,4,5,20.0%,3m
14643,2,Kuldix,3129,0,0,2,2,0.0%,17m
14659,3,Luca,3128,904,64,59,123,52.0%,4m
14659,1,Claustrofoby,3128,567,43,27,70,61.4%,8m
14659,3,[ncotic]StarRain,3128,981,38,44,82,46.3%,20m
14659,1,[RIPULI]Kakiisch,3128,355,20,16,36,55.6%,23m
14659,3,[SNOE]Lingonsylt,3128,490,17,23,40,42.5%,7m
14659,1,Grej,3128,326,13,12,25,52.0%,14m
14659,1,Autonigerrr,3128,460,13,14,27,48.1%,14m
14659,1,[SCiE]Ghost,3128,212,7,4,11,63.6%,22m
14659,1,Seth,3128,86,5,5,10,50.0%,3m
14659,1,[J4E]Chris,3128,112,4,6,10,40.0%,2m
14659,1,MichyMoko,3128,158,4,6,10,40.0%,2m
14659,1,PhoeniX,3128,76,2,4,6,33.3%,13m
14659,1,JJH,3128,0,1,0,1,100.0%,20m
14659,1,Nameless,3128,0,1,0,1,100.0%,10m
14659,1,MajaGrünzeug,3128,0,1,0,1,100.0%,8m
14659,1,NotMercyLess,3128,0,1,1,2,50.0%,6m
14659,1,Echoes,3128,42,1,3,4,25.0%,4m
14659,1,[NTS]LtTrouble,3128,0,0,1,1,0.0%,1h
14659,1,[IPWT]SirLuckalot,3128,0,0,1,1,0.0%,2m
14678,3,[SicK]rixorrr,3127,1538,160,155,315,50.8%,6m
14678,3,[PLA2N]Cruiser,3127,1431,135,120,255,52.9%,2m
14678,3,Delinrus,3127,510,68,64,132,51.5%,3m
14678,1,Sunny,3127,1245,56,50,106,52.8%,7m
14678,1,VladimirXop,3127,1130,50,42,92,54.3%,8m
14678,3,[ArchTV]Dolmatt,3127,1276,50,48,98,51.0%,6m
14678,3,Fibor,3127,614,34,31,65,52.3%,19m
14678,1,ItzYumy,3127,300,12,13,25,48.0%,3m
14678,1,raskolnikov,3127,353,11,6,17,64.7%,17m
14678,3,Remenissions,3127,267,10,8,18,55.6%,5m
14678,3,Humbledrum,3127,207,9,7,16,56.2%,23m
14678,3,Сумрак,3127,266,9,13,22,40.9%,2m
14678,3,Toxity,3127,270,9,22,31,29.0%,10m
14678,1,TheRatMage,3127,89,4,2,6,66.7%,18m
14678,1,AVE,3127,67,4,5,9,44.4%,12m
14678,1,[Gloves]WSW,3127,120,3,2,5,60.0%,20m
14678,1,StaticX,3127,82,2,6,8,25.0%,4m
14678,1,Asirius,3127,42,1,1,2,50.0%,6m
14678,1,Several,3127,0,1,1,2,50.0%,12m
14678,1,DésolateEra,3127,0,1,2,3,33.3%,9m
14678,1,Talento,3127,0,0,1,1,0.0%,13m
14678,3,Gothic,3127,0,0,1,1,0.0%,20m
14700,3,[G0UDA]nhutton,3126,1589,210,204,414,50.7%,7m
14700,3,DrunkBender,3126,1524,206,208,414,49.8%,2m
14700,1,ferkelchen,3126,1388,88,73,161,54.7%,9m
14700,1,McFreaK,3126,986,51,40,91,56.0%,22m
14700,1,CodeZ,3126,898,43,38,81,53.1%,13m
14700,3,zpa,3126,322,12,15,27,44.4%,20m
14700,1,XRTY,3126,330,11,8,19,57.9%,8m
14700,1,Dschonathan,3126,302,10,8,18,55.6%,20m
14700,1,Coral,3126,198,6,5,11,54.5%,13m
14700,1,Selven,3126,127,5,3,8,62.5%,20m
14700,1,xRUGBYx,3126,92,4,3,7,57.1%,14m
14700,1,InGodsName,3126,128,2,9,11,18.2%,12m
14700,1,BUZNA,3126,0,1,0,1,100.0%,3m
14700,1,[ZelO]FuZzyCat,3126,0,1,0,1,100.0%,5m
14700,1,[ATPLT]Purpose,3126,0,1,0,1,100.0%,2m
14700,2,[ФАКЕР]Wasler,3126,0,1,1,2,50.0%,60m
14700,1,[HОW]Slaan,3126,42,1,3,4,25.0%,5m
14700,3,MrHaM,3126,30,1,6,7,14.3%,9m
14718,3,Griito,3125,1544,309,301,610,50.7%,13m
14718,3,Riaxy,3125,1531,183,174,357,51.3%,11m
14718,3,TinSoldier,3125,1450,117,108,225,52.0%,5m
14718,3,HenryIV,3125,1445,78,76,154,50.6%,7m
14718,3,Marko,3125,1200,57,59,116,49.1%,23m
14718,1,aske,3125,1340,47,47,94,50.0%,9m
14718,3,[ЕМPIRE]DoorsXP,3125,628,27,25,52,51.9%,5m
14718,1,[Torby]STINGER,3125,676,24,15,39,61.5%,13m
14718,3,SilverLeague,3125,457,20,14,34,58.8%,21m
14718,1,[N0LIF3]ruzovej,3125,575,19,15,34,55.9%,4m
14718,1,CaLiguLa,3125,421,16,9,25,64.0%,21m
14718,1,Tasadar,3125,406,15,11,26,57.7%,4m
14718,1,[OSgZ]MEGAZVER,3125,443,13,12,25,52.0%,23m
14718,3,TMay,3125,283,11,8,19,57.9%,20m
14718,1,Dashwood,3125,400,11,13,24,45.8%,20m
14718,1,PuffGoof,3125,228,7,4,11,63.6%,2m
14718,2,[Torby]Eclipse,3125,99,3,1,4,75.0%,24m
14718,3,[PLA2N]NelrOp,3125,62,3,6,9,33.3%,8m
14718,1,Tenaka,3125,42,2,2,4,50.0%,4m
14718,1,[YEMAN]Alix,3125,0,2,3,5,40.0%,12m
14718,2,[FreeN]Shaka,3125,64,2,17,19,10.5%,17m
14718,1,террАн,3125,0,1,0,1,100.0%,8m
14718,1,phil,3125,0,1,1,2,50.0%,12m
14718,1,agrrovant,3125,42,1,1,2,50.0%,18m
14718,1,Honou,3125,40,1,4,5,20.0%,4m
14718,1,WhiteRa,3125,0,0,1,1,0.0%,10m
14744,3,OliFour,3124,1559,191,197,388,49.2%,7m
14744,3,[MSR]DonSebo,3124,1162,182,171,353,51.6%,7m
14744,1,[WTFGG]Gambit,3124,1703,78,67,145,53.8%,2m
14744,1,DGGRAF,3124,1324,70,48,118,59.3%,18m
14744,1,KaraHerja,3124,1149,55,46,101,54.5%,5m
14744,1,Jekenius,3124,740,50,39,89,56.2%,5m
14744,1,[G4MBLE]braindamage,3124,1038,48,44,92,52.2%,5m
14744,1,NtS,3124,813,30,23,53,56.6%,21m
14744,1,[ncotic]SaD,3124,605,18,16,34,52.9%,17m
14744,3,[TeSol]Abysmatic,3124,292,11,14,25,44.0%,6m
14744,3,Zerglein,3124,65,11,16,27,40.7%,4m
14744,3,OverWolf,3124,232,9,14,23,39.1%,14m
14744,2,[EMVAUD]vaLis,3124,169,6,5,11,54.5%,2m
14744,1,Alcalyn,3124,169,5,3,8,62.5%,23m
14744,1,Zedryx,3124,164,5,5,10,50.0%,17m
14744,1,[TDCHK]Helium,3124,156,4,15,19,21.1%,13m
14744,3,ronpopopom,3124,32,2,2,4,50.0%,13m
14744,1,MikeOxLong,3124,0,2,3,5,40.0%,5m
14744,1,[RÆVVA]Fekt,3124,0,1,1,2,50.0%,7m
14744,1,[GsQ]Funkmaster,3124,42,1,3,4,25.0%,6m
14744,1,DqGǂPaDocK,3124,42,1,4,5,20.0%,21m
14744,1,NYT,3124,0,0,1,1,0.0%,22m
14744,1,Vidrux,3124,0,0,1,1,0.0%,12m
14767,1,Sei,3123,1700,500,466,966,51.8%,2m
14767,3,Index,3123,1542,206,195,401,51.4%,9m
14767,3,Symbule,3123,923,83,66,149,55.7%,17m
14767,1,léo,3123,1499,83,71,154,53.9%,8m
14767,3,Zibroumix,3123,1375,66,65,131,50.4%,11m
14767,3,[BUCHER]BuchER,3123,1419,56,60,116,48.3%,4m
14767,3,MLDN,3123,1074,55,61,116,47.4%,13m
14767,3,челяба,3123,800,31,36,67,46.3%,2m
14767,3,ZenkinRU,3123,534,19,23,42,45.2%,11m
14767,1,XaPyZaTnik,3123,380,12,13,25,48.0%,8m
14767,1,andikite,3123,318,11,7,18,61.1%,12m
14767,1,[44A]Tyler,3123,368,11,13,24,45.8%,10m
14767,3,BYUN,3123,262,11,14,25,44.0%,13m
14767,1,StarLorD,3123,192,6,5,11,54.5%,5m
14767,3,[NLTN]illilililili,3123,94,4,8,12,33.3%,10m
14767,1,xenocombo,3123,114,3,3,6,50.0%,3m
14767,1,IIIIIIIIIIII,3123,40,2,0,2,100.0%,12m
14767,1,Loveme,3123,82,2,5,7,28.6%,20m
14767,3,Artimus,3123,9,2,8,10,20.0%,13m
14767,1,StevieXL,3123,0,1,0,1,100.0%,5m
14767,1,[MNGGTV]MaNNaGGia,3123,42,1,3,4,25.0%,9m
14767,1,YanosS,3123,0,1,4,5,20.0%,31m
14767,1,Asthentix,3123,40,1,4,5,20.0%,18m
14767,1,Topimo,3123,0,0,1,1,0.0%,21m
14767,2,[BSK88]Jackow,3123,0,0,1,1,0.0%,30m
14767,1,[Defeat]Svenling,3123,0,0,1,1,0.0%,12m
14793,1,EllieFingers,3122,1393,78,69,147,53.1%,12m
14793,1,llllllllllll,3122,496,28,1,29,96.6%,18m
14793,3,DougSluggins,3122,626,23,29,52,44.2%,11m
14793,3,[VARP]PUSTOTA,3122,630,21,31,52,40.4%,13m
14793,1,DeadMeet,3122,276,8,3,11,72.7%,21m
14793,1,homus,3122,224,7,5,12,58.3%,22m
14793,1,УчусьИграть,3122,231,6,3,9,66.7%,2m
14793,1,DragonBallZ,3122,89,5,1,6,83.3%,2m
14793,1,[Azimut]Morgoth,3122,198,5,7,12,41.7%,8m
14793,1,[BjwA]Puco,3122,110,4,5,9,44.4%,7m
14793,1,Jakkiller,3122,122,3,3,6,50.0%,7m
14793,1,likeBoom,3122,78,2,2,4,50.0%,18m
14793,1,Epps,3122,0,0,1,1,0.0%,6m
14793,1,Astori,3122,0,0,1,1,0.0%,18m
14793,1,Schtievo,3122,0,0,1,1,0.0%,13m
14808,3,only,3121,1567,107,110,217,49.3%,6m
14808,3,Eazy,3121,786,34,39,73,46.6%,23m
14808,3,[G58]Moppel,3121,858,29,37,66,43.9%,20m
14808,3,Callesen,3121,763,26,29,55,47.3%,21m
14808,1,ffii,3121,426,21,6,27,77.8%,10m
14808,1,neiron,3121,453,20,12,32,62.5%,12m
14808,1,zergand,3121,457,16,12,28,57.1%,12m
14808,3,Auhm,3121,373,16,15,31,51.6%,8m
14808,1,AncientBrain,3121,418,12,16,28,42.9%,10m
14808,1,Roforsho,3121,148,4,3,7,57.1%,7m
14808,3,GenjisAss,3121,120,4,15,19,21.1%,10m
14808,1,[MAIDAN]Fransua,3121,42,2,0,2,100.0%,12m
14808,1,Protector,3121,38,2,1,3,66.7%,14m
14808,1,NeMArjay,3121,73,1,2,3,33.3%,7m
14808,1,Bullepower,3121,40,1,2,3,33.3%,8m
14808,1,[ZumbiC]Nawu,3121,0,0,1,1,0.0%,7m
14808,1,Asturianu,3121,0,0,1,1,0.0%,4m
14808,1,[Marx]Geist,3121,0,0,2,2,0.0%,13m
14808,1,Werwey,3121,0,0,3,3,0.0%,9m
14827,1,BatdaD,3120,1660,104,84,188,55.3%,21m
14827,3,Raynor,3120,826,91,78,169,53.8%,6m
14827,1,quarter,3120,1691,75,54,129,58.1%,19m
14827,3,ELPuErCo,3120,1142,41,51,92,44.6%,19m
14827,3,cdecl,3120,949,40,39,79,50.6%,8m
14827,1,PerfectForm,3120,714,36,33,69,52.2%,17m
14827,1,WhereIsMyQQQ,3120,828,28,22,50,56.0%,2m
14827,3,Mars,3120,567,21,22,43,48.8%,4m
14827,3,SPOOK,3120,370,18,12,30,60.0%,7m
14827,1,Tim,3120,422,17,15,32,53.1%,5m
14827,3,ReturnValue,3120,389,15,7,22,68.2%,9m
14827,1,EndJoyPain,3120,460,14,10,24,58.3%,20m
14827,1,dongotti,3120,211,13,7,20,65.0%,5m
14827,1,[ALCAs]Troniak,3120,466,13,12,25,52.0%,21m
14827,1,[RMWP]BLUE,3120,380,11,9,20,55.0%,13m
14827,3,moooo,3120,292,11,15,26,42.3%,21m
14827,1,cocosik,3120,215,9,5,14,64.3%,53m
14827,3,SMOKE,3120,245,8,8,16,50.0%,8m
14827,1,BanglaDezu,3120,302,8,9,17,47.1%,19m
14827,3,VingtCent,3120,115,7,2,9,77.8%,16m
14827,1,pNzRLZwMn,3120,121,5,2,7,71.4%,51m
14827,1,Austin,3120,140,5,5,10,50.0%,12m
14827,3,LingNeverDie,3120,200,5,8,13,38.5%,2m
14827,1,Diaboluss,3120,176,4,2,6,66.7%,2m
14827,1,Muhi,3120,78,2,2,4,50.0%,22m
14827,1,GreenZerg,3120,0,0,2,2,0.0%,23m
14827,1,[EXPANT]Moon,3120,0,0,3,3,0.0%,7m
14854,3,NumnumRekoko,3119,1458,96,90,186,51.6%,10m
14854,3,UncleSenya,3119,1394,79,75,154,51.3%,4m
14854,1,AsaLiaH,3119,1753,73,65,138,52.9%,9m
14854,1,[2M1B]WastedBorn,3119,1189,48,36,84,57.1%,7m
14854,3,madHATTER,3119,564,34,34,68,50.0%,13m
14854,1,Eraser,3119,382,16,6,22,72.7%,22m
14854,3,[bullD]misterhappy,3119,391,12,17,29,41.4%,12m
14854,1,FeelIN,3119,242,10,6,16,62.5%,8m
14854,3,Kyoshiro,3119,280,9,12,21,42.9%,21m
14854,1,DrOst,3119,151,7,4,11,63.6%,12m
14854,2,[tutuut]Buggis,3119,182,5,8,13,38.5%,11m
14854,1,Susanoo,3119,146,4,1,5,80.0%,9m
14854,1,SWARM,3119,144,3,2,5,60.0%,48m
14854,2,Vencundo,3119,153,3,5,8,37.5%,10m
14854,3,Naspix,3119,90,3,8,11,27.3%,5m
14854,1,Serralych,3119,77,2,2,4,50.0%,5m
14854,1,Executioner,3119,0,0,1,1,0.0%,6m
14854,1,thasquirrel,3119,0,0,1,1,0.0%,6m
14872,2,Jidosha,3118,1469,142,149,291,48.8%,12m
14872,1,[KDV]rydzyk,3118,1432,63,43,106,59.4%,18m
14872,1,[SóiCon]Wolf,3118,1186,45,37,82,54.9%,20m
14872,3,PhX,3118,924,33,39,72,45.8%,21m
14872,3,МеДвеДыЧ,3118,237,12,9,21,57.1%,2m
14872,1,mcgui,3118,318,11,7,18,61.1%,22m
14872,3,DragoneFire,3118,256,9,3,12,75.0%,16m
14872,3,IIIIIIIIIIII,3118,278,9,20,29,31.0%,12m
14872,1,Hierarch,3118,191,8,6,14,57.1%,26m
14872,1,[LoveU]SnaKeDeViL,3118,155,7,0,7,100.0%,9m
14872,1,ruHurma,3118,218,7,5,12,58.3%,3m
14872,1,[DIDLIN]ountzountz,3118,148,5,4,9,55.6%,4m
14872,1,RariJack,3118,144,4,2,6,66.7%,3m
14872,3,flyrev,3118,0,4,2,6,66.7%,19m
14872,3,ADSKI,3118,0,4,3,7,57.1%,1h
14872,1,Era,3118,76,2,2,4,50.0%,3m
14872,1,FehlerX,3118,82,2,3,5,40.0%,19m
14872,3,[mXv3]Sloubi,3118,0,1,0,1,100.0%,2m
14872,3,RageDemons,3118,0,1,1,2,50.0%,38m
14872,1,Monax,3118,0,0,1,1,0.0%,12m
14872,1,veteris,3118,0,0,3,3,0.0%,21m
14872,1,[SVK014]OLDStone,3118,0,0,3,3,0.0%,18m
14872,3,Danilano,3118,0,0,6,6,0.0%,4m
14895,3,zzebraa,3117,1122,342,299,641,53.4%,11m
14895,3,Corrosion,3117,1385,166,158,324,51.2%,6m
14895,3,WillFire,3117,1565,152,150,302,50.3%,18m
14895,3,JPriest,3117,1592,122,127,249,49.0%,22m
14895,3,Kuula,3117,1532,101,101,202,50.0%,7m
14895,3,eXoSwarm,3117,1059,90,83,173,52.0%,13m
14895,3,Najt,3117,916,82,77,159,51.6%,13m
14895,3,SAMER,3117,716,50,40,90,55.6%,10m
14895,3,Lasaqus,3117,800,48,51,99,48.5%,10m
14895,1,MartinMCF,3117,874,45,35,80,56.2%,4m
14895,3,SpeedyRogue,3117,782,32,34,66,48.5%,14m
14895,1,Aspartamx,3117,529,23,21,44,52.3%,3m
14895,3,[Reggy]bIgJaX,3117,454,18,13,31,58.1%,20m
14895,3,Malleus,3117,317,13,12,25,52.0%,4m
14895,3,tosha,3117,304,10,17,27,37.0%,8m
14895,3,LLLLLLLLLLLL,3117,0,4,2,6,66.7%,24m
14895,1,MrPaganini,3117,122,3,5,8,37.5%,20m
14895,1,Frigost,3117,122,3,7,10,30.0%,9m
14895,1,[kurisu]Amadeus,3117,0,1,1,2,50.0%,8m
14895,1,[HNet]aXePerT,3117,0,0,1,1,0.0%,2m
14895,1,Spiff,3117,0,0,3,3,0.0%,18m
14916,3,Lum,3116,849,199,189,388,51.3%,13m
14916,1,[CrêTum]CreepDweller,3116,1762,135,122,257,52.5%,10m
14916,3,[EmŦ]VIPERA,3116,1478,103,72,175,58.9%,12m
14916,1,НебесныйЛИС,3116,1209,45,46,91,49.5%,23m
14916,1,Human,3116,500,37,31,68,54.4%,6m
14916,1,Chefalarm,3116,854,27,29,56,48.2%,13m
14916,1,[mCb]USISAVACH,3116,494,25,20,45,55.6%,20m
14916,1,ShADY,3116,439,16,13,29,55.2%,21m
14916,3,Pughy,3116,364,16,19,35,45.7%,13m
14916,1,[TSLD]SolidAnimus,3116,414,14,13,27,51.9%,8m
14916,3,eliya,3116,366,12,21,33,36.4%,5m
14916,1,Werhunter,3116,316,11,10,21,52.4%,19m
14916,1,Mayday,3116,199,10,5,15,66.7%,18m
14916,3,[InitRu]wispEr,3116,190,7,11,18,38.9%,8m
14916,2,[CMMWLT]Ado,3116,96,5,3,8,62.5%,37m
14916,1,[418]MachineHead,3116,122,4,4,8,50.0%,7m
14916,1,GendalfSnipe,3116,118,3,3,6,50.0%,6m
14916,3,Bosya,3116,58,3,6,9,33.3%,9m
14916,1,NightKnight,3116,40,2,4,6,33.3%,23m
14916,1,Wakho,3116,40,1,4,5,20.0%,4m
14916,1,MrHappy,3116,0,0,1,1,0.0%,13m
14916,1,ChuckNarine,3116,0,0,1,1,0.0%,4m
14916,1,[IVöVI]FiveSD,3116,0,0,3,3,0.0%,13m
14916,1,[БУБУБ]mmrGendarme,3116,0,0,5,5,0.0%,12m
14940,3,Fulger,3115,1511,108,99,207,52.2%,22m
14940,1,uakari,3115,1160,51,35,86,59.3%,2m
14940,3,Tiglath,3115,1224,48,56,104,46.2%,11m
14940,1,[WarKak]Muppets,3115,852,38,22,60,63.3%,20m
14940,3,vollo,3115,537,26,24,50,52.0%,6m
14940,1,Tieger,3115,581,21,16,37,56.8%,18m
14940,1,Tetzel,3115,539,20,14,34,58.8%,7m
14940,3,AmShaegar,3115,403,17,18,35,48.6%,7m
14940,1,lusifer,3115,516,15,11,26,57.7%,23m
14940,3,[NeMoKi]DarKside,3115,270,9,12,21,42.9%,9m
14940,1,OrkyUgly,3115,279,8,4,12,66.7%,12m
14940,1,Globus,3115,159,7,3,10,70.0%,12m
14940,3,[TaCC]Lux,3115,30,6,3,9,66.7%,2m
14940,1,Nerot,3115,100,5,2,7,71.4%,19m
14940,1,Sampo,3115,0,4,1,5,80.0%,22m
14940,3,Thunder,3115,120,4,10,14,28.6%,18m
14940,1,[UF2AC]GOTY,3115,42,2,2,4,50.0%,4m
14940,1,StarPlatinum,3115,0,1,0,1,100.0%,6m
14940,1,SooM,3115,0,1,1,2,50.0%,21m
14940,1,sornico,3115,0,1,1,2,50.0%,12m
14940,3,[BOLos]IDKFA,3115,94,1,5,6,16.7%,5m
14940,3,BhyGoath,3115,94,1,5,6,16.7%,11m
14940,1,Omnibeast,3115,0,0,1,1,0.0%,21m
14940,1,Perfi,3115,0,0,1,1,0.0%,10m
14964,3,Tayoda,3114,1524,216,197,413,52.3%,16m
14964,1,[DaFF]Dudee,3114,1526,116,95,211,55.0%,7m
14964,1,Integro,3114,1109,67,57,124,54.0%,13m
14964,1,CatKat,3114,714,35,9,44,79.5%,10m
14964,3,Avade,3114,590,25,21,46,54.3%,9m
14964,3,Shinubo,3114,331,19,26,45,42.2%,10m
14964,1,[ory]Tolier,3114,492,17,10,27,63.0%,14m
14964,1,Chaski,3114,472,14,14,28,50.0%,7m
14964,1,Notexist,3114,256,12,4,16,75.0%,48m
14964,3,Rastamon,3114,282,10,17,27,37.0%,10m
14964,1,Ufake,3114,146,8,3,11,72.7%,5m
14964,2,[DoPLS]GuruArtti,3114,148,5,29,34,14.7%,20m
14964,1,[theNFs]tjerrieh,3114,138,4,1,5,80.0%,8m
14964,3,MaskedGauss,3114,0,3,3,6,50.0%,22m
14964,1,Themistokles,3114,84,2,5,7,28.6%,2m
14964,1,Aurelia,3114,0,1,0,1,100.0%,5m
14964,1,[173]sergkhr,3114,42,1,1,2,50.0%,13m
14964,1,Plznobugs,3114,0,1,5,6,16.7%,19m
14964,1,[WAEH]Fudasys,3114,0,0,1,1,0.0%,23m
14964,1,[VLHLM]Droberts,3114,0,0,1,1,0.0%,13m
14984,3,Rumus,3113,1558,226,198,424,53.3%,7m
14984,3,[31415]skvol,3113,1354,100,90,190,52.6%,2m
14984,1,[Chonky]Effigy,3113,1075,89,81,170,52.4%,12m
14984,3,[B3est]Tykk,3113,1046,38,44,82,46.3%,5m
14984,3,Eldinoooo,3113,875,33,36,69,47.8%,20m
14984,1,VictoR,3113,630,27,20,47,57.4%,7m
14984,1,[IceHus]vovque,3113,504,24,26,50,48.0%,6m
14984,3,AniMaLus,3113,487,20,20,40,50.0%,20m
14984,1,XtrmR,3113,387,17,15,32,53.1%,5m
14984,1,emptysoul,3113,397,13,9,22,59.1%,21m
14984,1,ASPIRE,3113,437,13,14,27,48.1%,9m
14984,3,NightFox,3113,283,9,10,19,47.4%,5m
14984,1,Czjubon,3113,291,8,5,13,61.5%,4m
14984,1,Leeeeroooy,3113,306,8,10,18,44.4%,21m
14984,3,[Z3RGML]hazzard,3113,200,7,13,20,35.0%,8m
14984,1,[EESC]Guerrillero,3113,152,5,3,8,62.5%,9m
14984,1,TibboSaurous,3113,148,4,4,8,50.0%,4m
14984,1,Ватрушка,3113,46,4,7,11,36.4%,42m
14984,1,[LYBITE]leonidas,3113,42,2,1,3,66.7%,8m
14984,1,Ray,3113,95,2,2,4,50.0%,38m
14984,1,Lokerus,3113,40,2,2,4,50.0%,8m
14984,3,Игнезис,3113,0,1,0,1,100.0%,36m
14984,1,Vertical,3113,40,1,4,5,20.0%,13m
14984,1,Semels,3113,0,0,1,1,0.0%,10m
15008,3,FejkoAjkula,3112,1592,257,245,502,51.2%,22m
15008,3,IonutIgnat,3112,1538,224,215,439,51.0%,5m
15008,1,Ledrion,3112,1736,195,185,380,51.3%,12m
15008,3,[DiDZ]Czarny,3112,1325,151,158,309,48.9%,10m
15008,3,aninpospio,3112,1250,145,142,287,50.5%,2m
15008,3,trackeur,3112,1522,118,109,227,52.0%,19m
15008,1,jarrow,3112,1563,89,82,171,52.0%,18m
15008,1,johnybill,3112,1293,85,29,114,74.6%,20m
15008,3,BeBeZiaNa,3112,1506,74,61,135,54.8%,6m
15008,3,[IH7]fastigial,3112,882,67,72,139,48.2%,13m
15008,3,HydralicH,3112,1488,66,56,122,54.1%,2m
15008,1,CharliChan,3112,839,60,55,115,52.2%,10m
15008,3,Flakey,3112,1199,58,60,118,49.2%,6m
15008,1,cobrastajl,3112,886,55,40,95,57.9%,6m
15008,3,Champis,3112,1008,51,59,110,46.4%,18m
15008,3,SunHuyChai,3112,888,42,33,75,56.0%,4m
15008,3,[KatHal]DEJV,3112,682,30,25,55,54.5%,11m
15008,1,AglowTexas,3112,315,20,11,31,64.5%,19m
15008,3,[RADK]IlllIlIlIlI,3112,314,13,7,20,65.0%,5m
15008,2,Radcenzo,3112,185,8,4,12,66.7%,11m
15008,3,Akhenot,3112,218,7,13,20,35.0%,4m
15008,1,[oAOPo]PÉLARDON,3112,118,3,3,6,50.0%,8m
15008,1,[Heroes]Rane,3112,80,3,3,6,50.0%,3m
15008,3,FRANCYS,3112,110,3,4,7,42.9%,13m
15008,1,chedel,3112,78,2,5,7,28.6%,23m
15008,1,[Dae]GulLeNecro,3112,78,2,6,8,25.0%,7m
15008,1,[PTTian]Nairik,3112,0,1,0,1,100.0%,2m
15008,1,Blackington,3112,0,1,0,1,100.0%,18m
15008,3,Fogs,3112,94,1,5,6,16.7%,20m
15008,1,[LEP]MrWooood,3112,0,0,1,1,0.0%,2m
15008,1,KumosWoW,3112,0,0,1,1,0.0%,5m
15008,3,Duts,3112,0,0,1,1,0.0%,43m
15008,1,FlyingKirito,3112,0,0,2,2,0.0%,7m
15041,1,stiligmatic,3111,1747,172,157,329,52.3%,7m
15041,3,Icon,3111,518,132,115,247,53.4%,8m
15041,1,GhostDragon,3111,747,35,41,76,46.1%,3m
15041,3,SSG,3111,382,26,25,51,51.0%,11m
15041,1,[ККП]GEORG,3111,423,15,9,24,62.5%,10m
15041,1,[MHACKS]kenji,3111,382,11,13,24,45.8%,3m
15041,3,spacemaster,3111,170,8,2,10,80.0%,24m
15041,2,[SSC2]tango,3111,146,7,10,17,41.2%,3m
15041,1,[BSTRD]Akuzatif,3111,264,7,11,18,38.9%,20m
15041,1,[SR5]Arantir,3111,194,6,9,15,40.0%,6m
15041,1,Тимарь,3111,241,5,4,9,55.6%,13m
15041,3,[THR]LittleZergy,3111,97,4,2,6,66.7%,36m
15041,1,[hf4X4]apeironus,3111,40,2,2,4,50.0%,2m
15041,1,ichwillkekse,3111,0,1,0,1,100.0%,17m
15041,1,Quintinus,3111,89,1,1,2,50.0%,2m
15041,1,HeRo,3111,0,0,1,1,0.0%,22m
15041,1,Sebs,3111,0,0,2,2,0.0%,19m
15041,1,Dun,3111,0,0,3,3,0.0%,9m
15041,1,[RPTRMX]Andris,3111,0,0,5,5,0.0%,50m
15060,3,Maneken,3110,1638,148,140,288,51.4%,2m
15060,3,Nain,3110,315,104,112,216,48.1%,23m
15060,1,SmurF,3110,1226,46,41,87,52.9%,19m
15060,3,[KFy]tau,3110,601,27,32,59,45.8%,5m
15060,3,zerg,3110,383,21,21,42,50.0%,6m
15060,1,Despr,3110,431,18,11,29,62.1%,10m
15060,1,Hampan,3110,293,13,8,21,61.9%,9m
15060,1,Blood,3110,310,11,5,16,68.8%,4m
15060,1,MichelMichel,3110,216,9,6,15,60.0%,45m
15060,1,Spam,3110,192,8,8,16,50.0%,3m
15060,1,Battlestar,3110,190,6,4,10,60.0%,19m
15060,1,[KNFX]TMFboss,3110,188,5,4,9,55.6%,18m
15060,1,xXHateRBoYXx,3110,0,4,1,5,80.0%,18m
15060,1,Dyia,3110,118,3,2,5,60.0%,6m
15060,1,SuperNova,3110,88,2,0,2,100.0%,5m
15060,1,[FLOTOZ]TopFivHotKys,3110,40,2,3,5,40.0%,21m
15060,1,MeMv,3110,38,1,1,2,50.0%,13m
15060,1,waku,3110,40,1,2,3,33.3%,17m
15060,1,KévinChazaud,3110,0,0,1,1,0.0%,18m
15060,1,[aW]swardnight,3110,0,0,2,2,0.0%,21m
15060,1,Hyaena,3110,0,0,4,4,0.0%,14m
15081,3,[RBlood]Epyks,3109,1489,165,128,293,56.3%,8m
15081,1,Silverspoon,3109,1279,52,35,87,59.8%,6m
15081,1,doNped,3109,633,48,46,94,51.1%,4m
15081,1,[BiDC]Gizmoo,3109,579,20,22,42,47.6%,18m
15081,3,Delayed,3109,367,17,12,29,58.6%,3m
15081,3,Aløne,3109,312,10,9,19,52.6%,2m
15081,3,MrWhippy,3109,217,6,10,16,37.5%,2m
15081,1,[eli]Adam,3109,142,5,3,8,62.5%,13m
15081,3,Pyx,3109,204,5,9,14,35.7%,17m
15081,3,[OGTV]MrVert,3109,0,4,2,6,66.7%,17m
15081,1,DoktorFaust,3109,116,4,2,6,66.7%,9m
15081,1,JeeWoo,3109,104,2,1,3,66.7%,19m
15081,2,Schneaky,3109,44,1,1,2,50.0%,2m
15081,1,Kuleofserbia,3109,40,1,1,2,50.0%,4m
15081,1,[apeiro]Fraukenstein,3109,0,0,1,1,0.0%,22m
15081,1,iDoom,3109,0,0,1,1,0.0%,8m
15081,1,AlexSpotti,3109,0,0,1,1,0.0%,9m
15098,1,Khe,3108,1526,92,78,170,54.1%,2m
15098,3,Sightlyfan,3108,1017,91,92,183,49.7%,6m
15098,1,MLZeri,3108,1517,63,45,108,58.3%,7m
15098,3,Boroda,3108,1189,56,57,113,49.6%,8m
15098,1,MyTrouble,3108,1324,53,42,95,55.8%,22m
15098,3,Karquo,3108,482,41,36,77,53.2%,19m
15098,1,[FMGF]FlorentinH,3108,867,38,32,70,54.3%,18m
15098,1,TakSeHasam,3108,878,29,27,56,51.8%,23m
15098,1,takezo,3108,680,26,19,45,57.8%,9m
15098,1,Subzero,3108,810,23,25,48,47.9%,10m
15098,1,[S0LID]SolidCaesar,3108,390,15,11,26,57.7%,6m
15098,1,Pariah,3108,316,15,13,28,53.6%,2m
15098,1,boozzee,3108,304,13,9,22,59.1%,13m
15098,1,[Lomag]magnus,3108,242,11,8,19,57.9%,21m
15098,3,PtiBiscuit,3108,322,11,19,30,36.7%,12m
15098,3,BoyNextDoor,3108,142,6,13,19,31.6%,23m
15098,3,Egor,3108,97,5,1,6,83.3%,33m
15098,1,standby,3108,136,5,5,10,50.0%,13m
15098,1,cssdom,3108,192,5,5,10,50.0%,9m
15098,1,[XwzeX]Lathor,3108,198,5,8,13,38.5%,18m
15098,1,DandiLeos,3108,126,3,0,3,100.0%,19m
15098,1,[SkCzM]mičkakingCZ,3108,36,2,0,2,100.0%,3m
15098,1,SerialKiller,3108,40,2,2,4,50.0%,4m
15098,1,Laine,3108,0,1,1,2,50.0%,9m
15098,1,[DLB]Eko,3108,40,1,3,4,25.0%,9m
15098,1,[iJRR]Feanor,3108,44,1,5,6,16.7%,13m
15098,1,[SuaZL]HeyitsPg,3108,0,0,1,1,0.0%,2m
15098,1,Sunwoo,3108,0,0,1,1,0.0%,7m
15098,2,blazersmaxbg,3108,0,0,1,1,0.0%,32m
15098,1,äLgREALitY,3108,0,0,1,1,0.0%,9m
15098,1,Galosh,3108,0,0,1,1,0.0%,7m
15129,3,Jaczora,3107,1595,107,99,206,51.9%,5m
15129,3,[DutchG]Deliciata,3107,1475,70,75,145,48.3%,12m
15129,3,Tomoprof,3107,382,21,25,46,45.7%,5m
15129,1,GravyTrain,3107,478,20,10,30,66.7%,5m
15129,1,Mingues,3107,411,12,14,26,46.2%,21m
15129,1,kaysik,3107,234,6,9,15,40.0%,10m
15129,1,[mTm]Aghost,3107,224,6,10,16,37.5%,21m
15129,3,Jarruraita,3107,180,6,15,21,28.6%,9m
15129,1,Gelicide,3107,96,4,4,8,50.0%,12m
15129,3,heeeVs,3107,0,3,3,6,50.0%,7m
15129,3,SpeedyRogue,3107,110,3,4,7,42.9%,17m
15129,3,[Йольфы]Madness,3107,88,2,1,3,66.7%,5m
15129,3,DvFiveRatje,3107,60,2,10,12,16.7%,13m
15129,1,futurclassic,3107,0,1,0,1,100.0%,7m
15129,1,Lucifer,3107,0,1,0,1,100.0%,6m
15129,1,[ACNJP]Skadi,3107,0,1,0,1,100.0%,6m
15129,3,adder,3107,30,1,8,9,11.1%,13m
15129,1,kasid,3107,0,0,1,1,0.0%,7m
15129,1,Void,3107,0,0,3,3,0.0%,23m
15129,1,Etienne,3107,0,0,4,4,0.0%,6m
15149,3,Qubed,3106,1148,72,78,150,48.0%,3m
15149,3,Serenity,3106,758,35,33,68,51.5%,2m
15149,1,[CS0]Tarwe,3106,799,27,22,49,55.1%,7m
15149,3,Dir,3106,688,22,37,59,37.3%,13m
15149,3,Nerdking,3106,374,14,7,21,66.7%,22m
15149,1,[EBU]Princ,3106,312,9,11,20,45.0%,22m
15149,1,Darkbabacool,3106,130,6,4,10,60.0%,13m
15149,1,ТяпунДуболом,3106,163,6,6,12,50.0%,19m
15149,3,[xWLCx]Abyss,3106,97,5,2,7,71.4%,59m
15149,1,Tuaniz,3106,168,4,3,7,57.1%,6m
15149,2,[BRSKR]Berzerker,3106,46,2,2,4,50.0%,59m
15149,1,ArkKnight,3106,0,1,0,1,100.0%,14m
15149,1,[ММ]MoRTiFeR,3106,38,1,3,4,25.0%,6m
15149,1,KniVen,3106,0,0,2,2,0.0%,8m
15163,1,[RBP3]KostoF,3105,1611,146,114,260,56.2%,18m
15163,1,RicharParker,3105,1607,99,99,198,50.0%,13m
15163,3,burlakov,3105,1220,97,100,197,49.2%,21m
15163,1,whistle,3105,1484,95,67,162,58.6%,12m
15163,3,Gardly,3105,636,71,61,132,53.8%,8m
15163,3,Corwew,3105,1618,71,67,138,51.4%,5m
15163,3,Fury,3105,911,56,49,105,53.3%,23m
15163,1,iGrumbi,3105,664,37,25,62,59.7%,12m
15163,1,phoenix,3105,976,32,30,62,51.6%,23m
15163,3,beginner,3105,622,28,20,48,58.3%,6m
15163,1,AngrySmurf,3105,475,21,11,32,65.6%,23m
15163,1,BlitzSteal,3105,582,21,12,33,63.6%,21m
15163,1,Tchayen,3105,448,15,14,29,51.7%,6m
15163,3,DarkSouL,3105,255,11,7,18,61.1%,6m
15163,1,Banan,3105,400,11,10,21,52.4%,23m
15163,1,DeAd,3105,364,11,12,23,47.8%,8m
15163,1,truboder,3105,161,8,4,12,66.7%,19m
15163,2,lolfail,3105,161,8,5,13,61.5%,30m
15163,3,AmberFox,3105,225,7,4,11,63.6%,21m
15163,1,mBass,3105,166,5,3,8,62.5%,42m
15163,3,Penchekryak,3105,90,4,9,13,30.8%,17m
15163,1,Grixx,3105,124,3,3,6,50.0%,20m
15163,2,[ISK]SnOoOoPyYy,3105,94,2,0,2,100.0%,55m
15163,3,iBear,3105,94,2,2,4,50.0%,4m
15163,1,SurgeonSwag,3105,0,1,0,1,100.0%,22m
15163,3,Andarno,3105,0,1,1,2,50.0%,13m
15163,1,LokiAThor,3105,0,1,1,2,50.0%,7m
15163,1,seb,3105,0,0,1,1,0.0%,12m
15191,3,LurryFan,3104,915,60,68,128,46.9%,16m
15191,1,Marianuss,3104,852,43,32,75,57.3%,4m
15191,3,Draywer,3104,869,36,34,70,51.4%,22m
15191,1,Elyth,3104,984,36,36,72,50.0%,3m
15191,3,Walknort,3104,736,27,35,62,43.5%,17m
15191,1,FocuS,3104,723,25,20,45,55.6%,19m
15191,1,MightyMoose,3104,504,15,15,30,50.0%,6m
15191,1,[HODOR1]franzoah,3104,227,9,2,11,81.8%,21m
15191,1,Kagukuk,3104,273,9,12,21,42.9%,4m
15191,3,[696]Billy,3104,241,9,12,21,42.9%,2m
15191,3,zigmana,3104,121,5,2,7,71.4%,24m
15191,3,[LSPs]Floid,3104,152,5,16,21,23.8%,16m
15191,1,voltab,3104,0,3,2,5,60.0%,42m
15191,1,[herass]BlackWidow,3104,36,2,0,2,100.0%,18m
15191,1,Tenkomiel,3104,0,1,1,2,50.0%,23m
15191,1,PichorR,3104,0,1,4,5,20.0%,2m
15191,1,Yousef,3104,0,0,1,1,0.0%,8m
15191,1,Joker,3104,0,0,1,1,0.0%,21m
15191,1,LumynO,3104,0,0,1,1,0.0%,13m
15210,3,[QTcIub]Saevitium,3103,1128,95,93,188,50.5%,5m
15210,1,Grizelda,3103,1720,90,74,164,54.9%,19m
15210,3,BANANA,3103,1302,78,82,160,48.8%,9m
15210,3,Wingsand,3103,1080,72,70,142,50.7%,19m
15210,3,Frost,3103,835,62,57,119,52.1%,23m
15210,1,Misocheesy,3103,1140,40,36,76,52.6%,6m
15210,3,qoobic,3103,908,32,37,69,46.4%,4m
15210,1,Medir,3103,499,29,24,53,54.7%,21m
15210,3,ForZe,3103,453,20,19,39,51.3%,8m
15210,3,[QTcIub]Gimlouis,3103,518,18,27,45,40.0%,12m
15210,1,BUCS,3103,276,14,6,20,70.0%,21m
15210,3,[RealEG]fabfab,3103,421,13,17,30,43.3%,11m
15210,1,[TeVoid]gforce,3103,314,10,11,21,47.6%,10m
15210,3,Mayday,3103,280,10,14,24,41.7%,6m
15210,1,[D0N3]Rivera,3103,131,6,3,9,66.7%,2m
15210,1,Durst,3103,221,6,4,10,60.0%,5m
15210,2,CanadianZerg,3103,141,5,5,10,50.0%,11m
15210,1,jari,3103,146,4,2,6,66.7%,21m
15210,1,kip,3103,152,4,6,10,40.0%,2m
15210,1,[MaGeOn]Maev,3103,82,3,3,6,50.0%,2m
15210,1,recskabajnok,3103,80,3,5,8,37.5%,10m
15210,2,EndlessDream,3103,0,2,5,7,28.6%,5m
15210,3,Cerde,3103,62,2,10,12,16.7%,20m
15210,1,ZeThuG,3103,0,1,0,1,100.0%,9m
15210,3,[PUDDIN]eXpLiCt,3103,0,1,0,1,100.0%,18m
15210,1,Snorkel,3103,40,1,3,4,25.0%,3m
15210,1,Wuk,3103,0,0,1,1,0.0%,23m
15210,1,[SJHD]ZRoZ,3103,0,0,1,1,0.0%,4m
15210,1,Zecathos,3103,0,0,2,2,0.0%,6m
15210,3,[RPZ]Yodubz,3103,0,0,16,16,0.0%,23m
15240,1,[Ptah]Benduu,3102,1034,220,215,435,50.6%,8m
15240,3,Ayals,3102,1623,120,124,244,49.2%,11m
15240,1,Eres,3102,1499,93,84,177,52.5%,13m
15240,3,[Dawrye]GeoRed,3102,1000,92,81,173,53.2%,22m
15240,3,Yandex,3102,1186,80,72,152,52.6%,11m
15240,3,baabaa,3102,564,23,21,44,52.3%,7m
15240,1,niu,3102,186,8,1,9,88.9%,7m
15240,2,RetrO,3102,214,8,5,13,61.5%,10m
15240,1,[WNTR]CryVI,3102,205,7,7,14,50.0%,20m
15240,3,SkaTaN,3102,200,7,16,23,30.4%,22m
15240,1,Imported,3102,100,5,2,7,71.4%,7m
15240,3,FireSheep,3102,121,5,3,8,62.5%,17m
15240,1,[lOoOl]KatyaAngel,3102,114,4,2,6,66.7%,4m
15240,1,Cam,3102,198,4,3,7,57.1%,23m
15240,1,[Blacer]BlueKnight,3102,152,4,9,13,30.8%,12m
15240,1,[IRTG]Futorius,3102,0,3,2,5,60.0%,4m
15240,1,Grifex,3102,0,3,2,5,60.0%,12m
15240,1,QttM,3102,38,2,5,7,28.6%,4m
15240,1,[SAPIN]TrD,3102,42,2,5,7,28.6%,21m
15240,1,Kalan,3102,0,1,0,1,100.0%,3m
15240,3,joncol,3102,30,1,7,8,12.5%,6m
15240,1,Ragnar,3102,0,0,1,1,0.0%,3m
15240,1,NeoBlade,3102,0,0,2,2,0.0%,4m
15240,1,Ralphman,3102,0,0,2,2,0.0%,9m
15264,3,Balthazor,3101,1556,132,135,267,49.4%,13m
15264,3,[FloPo]Estler,3101,1065,44,47,91,48.4%,13m
15264,1,[BURIZA]poesh,3101,1066,39,31,70,55.7%,2m
15264,3,sudo,3101,522,35,34,69,50.7%,5m
15264,3,zZyZzZz,3101,773,33,31,64,51.6%,11m
15264,1,Kestal,3101,729,32,19,51,62.7%,22m
15264,1,Tamecles,3101,723,27,20,47,57.4%,13m
15264,3,[tbsL]DemonBlacks,3101,561,26,21,47,55.3%,4m
15264,1,ytrsasdfgh,3101,440,15,11,26,57.7%,8m
15264,1,[ANET69]Boocha,3101,218,9,7,16,56.2%,42m
15264,1,[ATHENE]Zuldah,3101,38,5,2,7,71.4%,10m
15264,1,HarryMudd,3101,96,2,0,2,100.0%,19m
15264,1,nimzur,3101,0,1,4,5,20.0%,2m
15264,1,SmellyFootRU,3101,38,1,6,7,14.3%,14m
15278,3,UnkindledONE,3100,1529,206,190,396,52.0%,23m
15278,1,popug,3100,1673,123,120,243,50.6%,6m
15278,3,[Arrows]Lembas,3100,893,82,66,148,55.4%,8m
15278,1,[VuV]AiGiL,3100,929,79,60,139,56.8%,4m
15278,3,Guillaume,3100,1181,79,84,163,48.5%,9m
15278,1,[BIEDA]duudley,3100,1256,49,42,91,53.8%,21m
15278,1,[HANYU]VanishingDol,3100,1117,43,32,75,57.3%,9m
15278,3,niokr,3100,496,33,31,64,51.6%,23m
15278,3,Meech,3100,895,31,34,65,47.7%,11m
15278,1,Lulo,3100,940,30,31,61,49.2%,5m
15278,1,Blackdict,3100,528,22,15,37,59.5%,12m
15278,1,Lisky,3100,479,21,14,35,60.0%,2m
15278,1,PinkFlicker,3100,419,18,10,28,64.3%,21m
15278,3,Spaceem,3100,165,9,4,13,69.2%,13m
15278,1,Jileanu,3100,348,9,8,17,52.9%,10m
15278,1,Квирк,3100,294,9,9,18,50.0%,6m
15278,3,Grogou,3100,186,7,9,16,43.8%,12m
15278,1,LuckyTiger,3100,149,5,3,8,62.5%,5m
15278,1,Maxim,3100,78,3,1,4,75.0%,20m
15278,1,Overlord,3100,82,3,6,9,33.3%,7m
15278,1,ErrorFix,3100,88,2,4,6,33.3%,2m
15278,3,[PiGPan]kovic,3100,0,1,0,1,100.0%,6m
15278,1,Candleholder,3100,0,1,0,1,100.0%,17m
15278,1,[Pulco]Jeremy,3100,0,0,1,1,0.0%,23m
15278,1,[ZERGSC]krovyfalcon,3100,0,0,1,1,0.0%,19m
15303,3,pwi,3099,1613,109,115,224,48.7%,8m
15303,3,ToNyM,3099,1193,65,61,126,51.6%,21m
15303,3,zarak,3099,849,41,45,86,47.7%,17m
15303,3,Zergling,3099,891,40,33,73,54.8%,8m
15303,3,Sarana,3099,191,39,40,79,49.4%,18m
15303,3,[AqA]HariSeldon,3099,474,34,36,70,48.6%,6m
15303,1,[Neth]Krassak,3099,522,26,13,39,66.7%,5m
15303,3,PaddyP,3099,299,22,23,45,48.9%,5m
15303,1,Jirry,3099,483,21,10,31,67.7%,6m
15303,1,Motionless,3099,254,10,7,17,58.8%,13m
15303,3,broudoudou,3099,239,10,12,22,45.5%,19m
15303,3,Demi,3099,221,9,8,17,52.9%,18m
15303,1,MoeSzyslak,3099,209,9,8,17,52.9%,5m
15303,3,XxMOBABOxX,3099,270,8,13,21,38.1%,5m
15303,1,asfalt,3099,32,5,2,7,71.4%,7m
15303,3,Hellraiser,3099,121,5,3,8,62.5%,11m
15303,1,shadowbad,3099,144,4,1,5,80.0%,6m
15303,1,[Click]SmoKie,3099,40,4,3,7,57.1%,23m
15303,1,[Revolt]babidoula,3099,0,3,2,5,60.0%,18m
15303,1,headcracked,3099,76,3,3,6,50.0%,18m
15303,1,FlyingPaiul,3099,84,3,6,9,33.3%,5m
15303,1,Life,3099,40,2,1,3,66.7%,8m
15303,1,arthann,3099,130,2,2,4,50.0%,11m
15303,1,lamifan,3099,42,1,1,2,50.0%,21m
15303,1,Apodarilli,3099,0,1,2,3,33.3%,42m
15303,2,[GGPRC]Zacexplosion,3099,95,1,2,3,33.3%,1h
15303,1,Klubbland,3099,40,1,3,4,25.0%,18m
15303,1,Ladord,3099,0,0,1,1,0.0%,18m
15331,3,[dd33nt]DigitalDave,3098,1387,100,95,195,51.3%,2m
15331,1,treepower,3098,875,81,75,156,51.9%,13m
15331,1,Nikolay,3098,1557,67,54,121,55.4%,4m
15331,3,CHAOS,3098,432,53,64,117,45.3%,23m
15331,1,[NGEGNE]PsychoPlow,3098,1007,41,33,74,55.4%,12m
15331,3,RinGO,3098,554,19,23,42,45.2%,5m
15331,1,[CRL]ShaFaX,3098,466,14,15,29,48.3%,6m
15331,1,[Jail]Siixo,3098,274,13,9,22,59.1%,19m
15331,3,[JERST4]Strumf,3098,234,8,15,23,34.8%,18m
15331,1,[profit]HellothereXD,3098,191,7,1,8,87.5%,20m
15331,1,ardene,3098,0,4,2,6,66.7%,2m
15331,1,JoeGrand,3098,40,2,5,7,28.6%,17m
15331,3,Tttttimon,3098,121,2,6,8,25.0%,28m
15331,3,MaistroMads,3098,0,1,0,1,100.0%,54m
15331,2,[oTETAo]Jonisora,3098,44,1,2,3,33.3%,25m
15331,1,Bati,3098,38,1,3,4,25.0%,5m
15331,1,DonDraper,3098,40,1,4,5,20.0%,2m
15331,1,Liza,3098,0,0,2,2,0.0%,18m
15349,3,янка,3097,1526,467,463,930,50.2%,19m
15349,1,Ztyxx,3097,1571,141,108,249,56.6%,5m
15349,3,PipandPop,3097,1221,110,117,227,48.5%,5m
15349,1,Perpendiculo,3097,1613,99,87,186,53.2%,21m
15349,3,RAZDVA,3097,1551,78,83,161,48.4%,3m
15349,3,[SQDSQD]ArnikBB,3097,1184,75,66,141,53.2%,18m
15349,3,ZERGisAMOVE,3097,1532,66,70,136,48.5%,13m
15349,1,aiya,3097,1206,60,61,121,49.6%,6m
15349,1,Smithski,3097,1318,59,42,101,58.4%,2m
15349,3,atilla,3097,783,37,42,79,46.8%,2m
15349,3,[WADER]LittleDiablo,3097,836,35,38,73,47.9%,12m
15349,3,Balthazar,3097,395,33,32,65,50.8%,2m
15349,3,Raymond,3097,648,27,18,45,60.0%,21m
15349,1,Igniter,3097,798,25,29,54,46.3%,18m
15349,1,slash,3097,444,16,12,28,57.1%,4m
15349,3,AlphаStar,3097,386,15,16,31,48.4%,6m
15349,3,FCrazy,3097,412,14,25,39,35.9%,16m
15349,1,Whsprs,3097,353,13,7,20,65.0%,5m
15349,3,Glladiator,3097,310,11,16,27,40.7%,4m
15349,3,Lukosya,3097,324,11,19,30,36.7%,3m
15349,1,[swatx]HasloGasRa,3097,276,8,9,17,47.1%,14m
15349,1,[MLPELA]SoNk,3097,0,5,0,5,100.0%,12m
15349,1,[HST7]watsup,3097,88,5,1,6,83.3%,7m
15349,1,[EXPANT]Mormegil,3097,135,4,0,4,100.0%,8m
15349,1,Nixso,3097,0,4,1,5,80.0%,20m
15349,1,KAWAKWEK,3097,0,4,1,5,80.0%,24m
15349,1,[Lidеr]Usual,3097,0,4,1,5,80.0%,21m
15349,3,[1939]Marines,3097,0,4,2,6,66.7%,9m
15349,1,[RMWP]Azathoth,3097,156,4,5,9,44.4%,12m
15349,1,bosswoss,3097,156,3,2,5,60.0%,22m
15349,1,[Rebеls]кеша,3097,36,2,1,3,66.7%,20m
15349,2,Sharon,3097,141,2,4,6,33.3%,31m
15349,1,Marcassin,3097,0,1,0,1,100.0%,3m
15349,3,simhall,3097,0,1,1,2,50.0%,44m
15349,1,[Импери]asfer,3097,0,1,1,2,50.0%,5m
15349,1,romaric,3097,38,1,2,3,33.3%,21m
15349,1,[DarKS]xexes,3097,0,0,1,1,0.0%,34m
15349,1,[U19]ghost,3097,0,0,1,1,0.0%,7m
15349,1,Garcoss,3097,0,0,2,2,0.0%,4m
15349,1,[Ultrа]aquarius,3097,0,0,2,2,0.0%,7m
15349,1,[HFR]KaliroG,3097,0,0,2,2,0.0%,12m
15349,1,Bobby,3097,0,0,3,3,0.0%,3m
15349,3,Klaxhu,3097,0,0,10,10,0.0%,5m
15392,1,Coyote,3096,1202,161,143,304,53.0%,20m
15392,1,SomEhoW,3096,1289,92,72,164,56.1%,3m
15392,1,elvesCastle,3096,1732,69,62,131,52.7%,5m
15392,1,System,3096,1026,53,39,92,57.6%,10m
15392,1,Eichhörnchen,3096,756,41,10,51,80.4%,4m
15392,1,Shikiru,3096,472,20,20,40,50.0%,13m
15392,1,bee,3096,287,13,5,18,72.2%,8m
15392,1,InLove,3096,290,12,10,22,54.5%,5m
15392,1,[LIDAB]Xxpwnstar,3096,276,9,5,14,64.3%,23m
15392,1,[BornG]Hillnor,3096,247,8,13,21,38.1%,21m
15392,1,WinDetta,3096,155,5,0,5,100.0%,5m
15392,3,Nitram,3096,140,4,6,10,40.0%,3m
15392,1,[Spiidi]Xandathar,3096,116,3,1,4,75.0%,5m
15392,2,[Buggo]CreepRemover,3096,0,3,4,7,42.9%,10m
15392,1,[FMG]WhiteEagle,3096,116,3,5,8,37.5%,21m
15392,1,xaroshi,3096,116,3,5,8,37.5%,8m
15392,3,[RuVoid]ЧереЧпоЧек,3096,0,1,0,1,100.0%,30m
15392,3,Roobi,3096,0,1,3,4,25.0%,22m
15392,1,tibo,3096,0,1,4,5,20.0%,6m
15392,1,TitanCrusade,3096,0,0,1,1,0.0%,3m
15392,1,Dmitriions,3096,0,0,1,1,0.0%,8m
15392,1,[Orlinz]RogerFDP,3096,0,0,1,1,0.0%,2m
15392,1,Spengbob,3096,0,0,2,2,0.0%,11m
15392,1,[TSFG]Énrico,3096,0,0,5,5,0.0%,20m
15416,1,Lilalaunebär,3095,1675,142,143,285,49.8%,8m
15416,1,[QTcIub]TrollingPoo,3095,1164,106,101,207,51.2%,12m
15416,1,MisterEKO,3095,1521,65,51,116,56.0%,12m
15416,3,OwenReal,3095,390,52,53,105,49.5%,2m
15416,3,apassi,3095,1264,47,50,97,48.5%,5m
15416,3,Tezzomio,3095,1204,41,55,96,42.7%,8m
15416,1,HughDoongus,3095,815,33,26,59,55.9%,5m
15416,1,[TSmash]oyo,3095,687,31,19,50,62.0%,7m
15416,1,moid,3095,902,30,33,63,47.6%,6m
15416,3,Khroux,3095,301,27,30,57,47.4%,23m
15416,1,[N1TDA]Apceros,3095,473,24,14,38,63.2%,6m
15416,3,lameass,3095,522,18,22,40,45.0%,19m
15416,1,Schneider,3095,371,15,11,26,57.7%,8m
15416,1,[NERDHÖ]Schmoopy,3095,213,10,6,16,62.5%,22m
15416,3,Чин,3095,172,8,6,14,57.1%,12m
15416,2,Charles,3095,167,7,4,11,63.6%,3m
15416,3,DragonGamePr,3095,240,7,10,17,41.2%,7m
15416,3,Hadgehog,3095,97,6,1,7,85.7%,54m
15416,1,YORICK,3095,210,6,6,12,50.0%,19m
15416,3,iSeven,3095,109,5,4,9,55.6%,19m
15416,1,Dataz,3095,158,5,6,11,45.5%,20m
15416,3,[Tusky]mexorcist,3095,0,4,2,6,66.7%,27m
15416,1,shadow,3095,153,4,2,6,66.7%,21m
15416,1,[ncotic]Paradox,3095,128,3,2,5,60.0%,3m
15416,1,[Robins]JimmyJimKev,3095,126,3,4,7,42.9%,20m
15416,1,Aphlax,3095,40,2,0,2,100.0%,9m
15416,1,DioR,3095,80,2,5,7,28.6%,5m
15416,1,[75PSG]DMz,3095,40,1,1,2,50.0%,2m
15416,1,[JaPP]Dubrovskijj,3095,40,1,1,2,50.0%,23m
15416,1,Gabba,3095,0,0,1,1,0.0%,23m
15416,1,[BrdSkl]Leodasam,3095,0,0,1,1,0.0%,4m
15416,1,XecFayne,3095,0,0,1,1,0.0%,12m
15416,3,BadMazaFaka,3095,0,0,1,1,0.0%,16m
15416,1,Viperon,3095,0,0,1,1,0.0%,21m
15416,1,Gerrero,3095,0,0,2,2,0.0%,2m
15416,1,BigRazz,3095,0,0,3,3,0.0%,3m
15452,3,barcode,3094,1259,158,148,306,51.6%,13m
15452,3,VillaLobos,3094,1558,155,148,303,51.2%,8m
15452,1,[MsWar]hyperion,3094,775,135,124,259,52.1%,4m
15452,3,Killed,3094,1470,93,103,196,47.4%,18m
15452,1,Kartu,3094,787,90,81,171,52.6%,13m
15452,3,[DDaD]Karramba,3094,795,73,70,143,51.0%,9m
15452,1,dotdot,3094,1211,55,33,88,62.5%,2m
15452,1,Enge,3094,1084,49,51,100,49.0%,21m
15452,1,DarkNets,3094,954,48,42,90,53.3%,13m
15452,1,nyx,3094,654,34,13,47,72.3%,13m
15452,3,[GTyumy]Tofu,3094,905,34,35,69,49.3%,21m
15452,3,Easy,3094,856,28,40,68,41.2%,5m
15452,3,GrandPas,3094,352,26,24,50,52.0%,17m
15452,1,Maurice,3094,680,22,20,42,52.4%,12m
15452,1,[БУТЕР1]Ribolov,3094,314,10,7,17,58.8%,13m
15452,1,Rasplás,3094,256,7,7,14,50.0%,4m
15452,1,[OPA]DreiProMille,3094,229,6,3,9,66.7%,12m
15452,1,[MnrcK]CladFFVII,3094,74,3,1,4,75.0%,10m
15452,1,Andy,3094,78,3,3,6,50.0%,10m
15452,1,[RuRush]TheEnd,3094,40,1,1,2,50.0%,23m
15452,1,serg,3094,0,1,1,2,50.0%,13m
15452,1,PUTEN,3094,0,1,1,2,50.0%,12m
15452,2,glhf,3094,92,1,1,2,50.0%,30m
15452,1,Neskobar,3094,40,1,4,5,20.0%,3m
15452,3,Sutra,3094,30,1,9,10,10.0%,6m
15452,1,GeneralNoah,3094,0,0,1,1,0.0%,5m
15452,1,[1QYU]PzYÇZzH,3094,0,0,1,1,0.0%,8m
15452,1,Sеrrаl,3094,0,0,1,1,0.0%,13m
15452,1,petey,3094,0,0,1,1,0.0%,21m
15481,3,Faron,3093,1563,331,318,649,51.0%,21m
15481,1,Superbeere,3093,1624,124,106,230,53.9%,7m
15481,3,[ZePD]Noboody,3093,1568,118,117,235,50.2%,8m
15481,1,mamont,3093,1740,105,91,196,53.6%,20m
15481,1,Sleepycod,3093,1523,95,90,185,51.4%,13m
15481,1,Azze,3093,1465,88,80,168,52.4%,8m
15481,3,Fatalix,3093,400,62,68,130,47.7%,4m
15481,1,[KCR44]Booyaa,3093,1480,60,48,108,55.6%,19m
15481,3,macro,3093,371,30,25,55,54.5%,10m
15481,1,[isIMBА]Aoshima,3093,739,27,20,47,57.4%,4m
15481,3,Ainhorr,3093,704,25,29,54,46.3%,6m
15481,1,Lumar,3093,470,19,15,34,55.9%,5m
15481,1,[BELPA]CnalbErion,3093,643,19,21,40,47.5%,13m
15481,3,Pagy,3093,296,11,15,26,42.3%,23m
15481,1,Creepy,3093,338,10,8,18,55.6%,20m
15481,1,MakieSama,3093,221,8,5,13,61.5%,5m
15481,3,MasterMind,3093,255,7,13,20,35.0%,12m
15481,1,Gwiny,3093,215,5,6,11,45.5%,5m
15481,1,Saine,3093,150,4,6,10,40.0%,8m
15481,1,[100001]IceDee,3093,34,2,1,3,66.7%,4m
15481,1,Suga,3093,36,2,1,3,66.7%,21m
15481,1,[WCKYLN]krypto,3093,80,2,4,6,33.3%,6m
15481,1,[J4E]Knochenkopf,3093,38,1,1,2,50.0%,9m
15481,1,Stumpilu,3093,40,1,2,3,33.3%,6m
15481,1,Gruia,3093,42,1,5,6,16.7%,21m
15481,1,[PSlSTC]Ejoe,3093,0,0,2,2,0.0%,12m
15481,1,meloso,3093,0,0,2,2,0.0%,50m
15508,3,Cepera,3092,1542,135,126,261,51.7%,12m
15508,1,AuCalme,3092,1528,56,58,114,49.1%,3m
15508,1,stEVE,3092,1271,50,42,92,54.3%,2m
15508,1,TED,3092,506,27,11,38,71.1%,20m
15508,1,MrDurden,3092,621,24,16,40,60.0%,2m
15508,1,terminator,3092,390,16,17,33,48.5%,19m
15508,1,grumbler,3092,260,12,7,19,63.2%,4m
15508,3,bRiCk,3092,253,11,8,19,57.9%,2m
15508,1,Janniya,3092,214,8,3,11,72.7%,10m
15508,3,EFEX,3092,236,7,7,14,50.0%,18m
15508,1,[UltraM]Nakato,3092,120,5,3,8,62.5%,18m
15508,3,Maël,3092,121,5,3,8,62.5%,30m
15508,1,Vroxky,3092,0,4,1,5,80.0%,15m
15508,1,Aoi,3092,78,2,7,9,22.2%,2m
15508,1,Mifas,3092,0,1,1,2,50.0%,2m
15508,1,nazgul,3092,40,1,3,4,25.0%,15m
15508,3,ThisAintFun,3092,0,0,1,1,0.0%,22m
15508,1,Cronus,3092,0,0,1,1,0.0%,10m
15508,1,[DFYIII]Zliang,3092,0,0,1,1,0.0%,21m
15508,1,slipnote,3092,0,0,2,2,0.0%,20m
15508,1,[BREZAR]PurplPeplum,3092,0,0,2,2,0.0%,11m
15529,1,[HCHav]SirTioneb,3091,1738,116,114,230,50.4%,8m
15529,1,Vacivitous,3091,1376,105,79,184,57.1%,12m
15529,3,Sarah,3091,1208,80,65,145,55.2%,22m
15529,3,BELUNI,3091,1304,50,50,100,50.0%,2m
15529,1,[KGSC2]PrimeStar,3091,861,29,28,57,50.9%,13m
15529,1,Aviicii,3091,820,25,28,53,47.2%,7m
15529,3,[LiFe]Zeracyb,3091,424,17,23,40,42.5%,6m
15529,3,Bear,3091,296,13,13,26,50.0%,4m
15529,1,Niels,3091,255,9,3,12,75.0%,13m
15529,1,Felton,3091,220,9,5,14,64.3%,5m
15529,1,hunter,3091,279,9,9,18,50.0%,2m
15529,2,[DKLE]Stoei,3091,166,6,3,9,66.7%,47m
15529,1,[FoRiGr]winer,3091,204,6,3,9,66.7%,2m
15529,1,BBQmaker,3091,222,6,4,10,60.0%,10m
15529,3,Zpak,3091,97,4,3,7,57.1%,45m
15529,1,Dagorlad,3091,120,4,4,8,50.0%,9m
15529,1,[Rebеls]Raven,3091,0,1,1,2,50.0%,19m
15529,2,[CLICKk]SweetDave,3091,46,1,3,4,25.0%,44m
15529,1,Hornet,3091,42,1,6,7,14.3%,6m
15529,1,[Dobro]OneHandor,3091,73,0,3,3,0.0%,8m
15549,3,[SUFU]KeyJack,3090,1538,106,113,219,48.4%,17m
15549,1,dart,3090,1013,90,86,176,51.1%,19m
15549,3,Saladron,3090,1118,46,41,87,52.9%,22m
15549,1,[1stGG]JacDraco,3090,1037,38,32,70,54.3%,18m
15549,1,Swacha,3090,622,18,19,37,48.6%,3m
15549,3,Saraf,3090,322,12,17,29,41.4%,14m
15549,3,GTSkill,3090,163,7,2,9,77.8%,21m
15549,1,[PaniC]NotMe,3090,205,7,4,11,63.6%,8m
15549,1,Akama,3090,48,6,0,6,100.0%,26m
15549,1,Zurg,3090,159,6,5,11,54.5%,2m
15549,1,[AHill]Wanze,3090,188,5,7,12,41.7%,6m
15549,1,LuxVI,3090,90,4,3,7,57.1%,12m
15549,3,IAmTop,3090,143,3,2,5,60.0%,14m
15549,1,[youlol]Keturioz,3090,76,3,5,8,37.5%,20m
15549,1,Tepsel,3090,88,2,0,2,100.0%,2m
15549,1,[H0C]Mamojebac,3090,32,2,2,4,50.0%,9m
15549,3,DrDeath,3090,94,1,4,5,20.0%,21m
15549,1,Plutos,3090,0,1,4,5,20.0%,4m
15549,1,[KiKr]kieselbursch,3090,0,0,1,1,0.0%,4m
15568,3,brum,3089,1433,405,406,811,49.9%,19m
15568,3,[1aG]Slayer,3089,1526,255,259,514,49.6%,23m
15568,3,[GapSis]Lilioceris,3089,1287,200,186,386,51.8%,7m
15568,3,[TheDOH]McLenn,3089,1469,183,176,359,51.0%,2m
15568,3,[AdRiX]DOBRYS,3089,1291,118,107,225,52.4%,19m
15568,1,HazeTribes,3089,1149,65,63,128,50.8%,21m
15568,3,Brutaline,3089,989,35,38,73,47.9%,13m
15568,1,TenisPart,3089,385,17,12,29,58.6%,17m
15568,3,[K0ZAKI]Bluerec,3089,360,13,23,36,36.1%,8m
15568,3,Yemzmey,3089,279,12,8,20,60.0%,5m
15568,1,COMMANDER,3089,175,6,2,8,75.0%,18m
15568,1,mikeynoob,3089,191,5,9,14,35.7%,20m
15568,1,[Brun7]Wurre,3089,0,3,1,4,75.0%,29m
15568,1,TJbehemoth,3089,90,3,2,5,60.0%,46m
15568,1,tea,3089,0,3,2,5,60.0%,57m
15568,3,korzhy,3089,97,2,0,2,100.0%,37m
15568,1,Apocalypsis,3089,0,2,3,5,40.0%,27m
15568,1,Airat,3089,0,1,0,1,100.0%,13m
15568,1,[F2Acl]Kolbaska,3089,40,1,3,4,25.0%,6m
15568,3,санек,3089,0,0,1,1,0.0%,3m
15568,1,[Ebeny]GorzzorG,3089,0,0,1,1,0.0%,21m
15589,3,boeSe,3088,1161,252,254,506,49.8%,23m
15589,1,Eddy,3088,1682,157,132,289,54.3%,5m
15589,1,[DILIT]MaXiNe,3088,1453,77,27,104,74.0%,7m
15589,1,[HYPNO]Weaver,3088,495,70,72,142,49.3%,10m
15589,1,RyukoMatoi,3088,1161,65,51,116,56.0%,22m
15589,1,Troyand,3088,1386,55,54,109,50.5%,9m
15589,1,PlebsNeeded,3088,1399,54,48,102,52.9%,10m
15589,3,Remz,3088,670,30,34,64,46.9%,13m
15589,3,Lvcian,3088,662,28,24,52,53.8%,8m
15589,1,TVister,3088,535,26,9,35,74.3%,8m
15589,1,[CM4R]Lodric,3088,531,21,15,36,58.3%,19m
15589,2,Dez,3088,464,19,21,40,47.5%,19m
15589,1,Skopy,3088,456,17,13,30,56.7%,8m
15589,3,[PiGPan]StefanS,3088,380,13,23,36,36.1%,14m
15589,1,PMmisi,3088,362,10,15,25,40.0%,23m
15589,1,[PiGPan]Supremefist,3088,293,8,7,15,53.3%,3m
15589,1,[HFR]Goose,3088,281,6,11,17,35.3%,12m
15589,1,Dokatos,3088,122,5,3,8,62.5%,19m
15589,3,flyinghotdog,3088,30,5,4,9,55.6%,11m
15589,1,mcmacke,3088,150,4,5,9,44.4%,13m
15589,1,Vladis,3088,74,3,5,8,37.5%,2m
15589,1,Sardoche,3088,91,2,0,2,100.0%,7m
15589,1,KratosEvil,3088,90,2,0,2,100.0%,4m
15589,1,lilWishuOo,3088,82,2,6,8,25.0%,6m
15589,1,fgra,3088,0,1,0,1,100.0%,4m
15589,1,Spagheet,3088,0,1,1,2,50.0%,8m
15589,1,[AClic]Ununhexium,3088,0,1,2,3,33.3%,2m
15589,1,Nameless,3088,0,0,1,1,0.0%,3m
15589,1,Ibaniez,3088,0,0,1,1,0.0%,13m
15589,1,Kojiro,3088,0,0,1,1,0.0%,3m
15589,1,Kerrigan,3088,0,0,1,1,0.0%,22m
15620,3,[SPAINs]sajerago,3087,1529,216,212,428,50.5%,8m
15620,1,htissiez,3087,1225,99,99,198,50.0%,13m
15620,3,[AciNoN]WERTEX,3087,1286,85,70,155,54.8%,5m
15620,1,Vedac,3087,1723,71,57,128,55.5%,4m
15620,3,shusher,3087,752,34,32,66,51.5%,5m
15620,3,Szczurek,3087,576,26,21,47,55.3%,22m
15620,1,EthanAgger,3087,315,14,16,30,46.7%,3m
15620,1,[биотех]hfafoq,3087,340,11,7,18,61.1%,2m
15620,1,Syzygy,3087,338,10,10,20,50.0%,18m
15620,1,Carbonito,3087,292,9,9,18,50.0%,2m
15620,1,[XIII]Jack,3087,186,5,3,8,62.5%,5m
15620,3,GreenOwl,3087,150,5,11,16,31.2%,14m
15620,1,Specton,3087,139,4,1,5,80.0%,6m
15620,1,[zsír]FiatalVoltam,3087,0,3,2,5,60.0%,2m
15620,1,NDLESS,3087,74,3,3,6,50.0%,12m
15620,1,mindtrance,3087,124,2,2,4,50.0%,13m
15620,1,Vilkas,3087,78,2,3,5,40.0%,15m
15620,1,[ZgEgZ]Starius,3087,42,2,4,6,33.3%,23m
15620,3,Mat,3087,58,2,11,13,15.4%,8m
15620,3,[KZORG]habusjr,3087,0,1,0,1,100.0%,20m
15620,1,Solomonic,3087,0,1,5,6,16.7%,19m
15620,1,[FAMEX]Vexu,3087,0,0,1,1,0.0%,2m
15620,1,[PaniC]WhiteEagle,3087,0,0,1,1,0.0%,18m
15620,3,[CoV37]BlwGƪXanthus,3087,0,0,1,1,0.0%,5m
15644,3,Nicolas,3086,714,352,344,696,50.6%,12m
15644,1,KrimiX,3086,1491,104,93,197,52.8%,18m
15644,1,Uezo,3086,869,74,59,133,55.6%,23m
15644,1,iweasel,3086,1446,72,69,141,51.1%,9m
15644,3,NysexBG,3086,949,45,36,81,55.6%,12m
15644,1,Sorry,3086,1208,41,42,83,49.4%,2m
15644,1,Yamtu,3086,308,34,26,60,56.7%,8m
15644,1,gerwulf,3086,297,29,21,50,58.0%,3m
15644,1,[InvKit]SFoxner,3086,678,24,17,41,58.5%,2m
15644,1,BrodoSwagins,3086,470,16,19,35,45.7%,12m
15644,1,[аймой]BabaRada,3086,316,12,13,25,48.0%,2m
15644,1,[8xxO]PunyOne,3086,384,10,13,23,43.5%,11m
15644,1,Brownsugar,3086,366,10,17,27,37.0%,7m
15644,3,[BUFU8]Linki,3086,260,7,13,20,35.0%,7m
15644,1,Andrei,3086,203,6,5,11,54.5%,21m
15644,3,Hapide,3086,188,6,13,19,31.6%,23m
15644,1,Aze,3086,48,5,1,6,83.3%,29m
15644,2,Stafer,3086,141,5,5,10,50.0%,17m
15644,1,[IceHus]IIIIIIIIIIII,3086,152,5,6,11,45.5%,5m
15644,1,funktku,3086,121,4,0,4,100.0%,17m
15644,1,[44RU]Rustaveli,3086,152,4,2,6,66.7%,22m
15644,1,EAX,3086,88,4,2,6,66.7%,2m
15644,1,[druPa]Bro,3086,120,3,1,4,75.0%,21m
15644,1,[GSI]MasterYogurt,3086,0,3,2,5,60.0%,19m
15644,1,morelka,3086,0,3,2,5,60.0%,50m
15644,1,[LSPs]XxKHENSUxX,3086,153,3,7,10,30.0%,12m
15644,1,Feminist,3086,95,2,0,2,100.0%,52m
15644,1,[LegioV]Thor,3086,104,2,1,3,66.7%,19m
15644,3,[Bü]Arcanis,3086,97,1,1,2,50.0%,31m
15644,1,[3ØØ]EscoBar,3086,0,0,1,1,0.0%,13m
15644,1,[BPX]FettmannBrot,3086,0,0,1,1,0.0%,21m
15644,1,HEKPOMAHT,3086,0,0,1,1,0.0%,8m
15644,1,udii,3086,0,0,2,2,0.0%,22m
15677,3,BanterBoy,3085,1500,118,138,256,46.1%,12m
15677,1,speedUp,3085,1550,99,78,177,55.9%,5m
15677,1,Diogen,3085,1427,71,57,128,55.5%,18m
15677,1,TossMaster,3085,1088,50,33,83,60.2%,19m
15677,1,MilkEffect,3085,997,35,33,68,51.5%,4m
15677,1,ЦиклоНяша,3085,500,27,7,34,79.4%,4m
15677,1,Unknowz,3085,284,23,16,39,59.0%,10m
15677,1,[MkersA]morph,3085,726,22,26,48,45.8%,2m
15677,1,FunRei,3085,659,21,19,40,52.5%,19m
15677,3,LaTravleña,3085,574,19,26,45,42.2%,3m
15677,1,[ZGlot]Mirrorer,3085,350,18,6,24,75.0%,6m
15677,1,[Karuna]aleos,3085,314,17,13,30,56.7%,2m
15677,1,Forbidden,3085,346,14,8,22,63.6%,9m
15677,1,AhriCutie,3085,378,14,14,28,50.0%,23m
15677,3,[FLAT]radi,3085,309,11,7,18,61.1%,16m
15677,3,GreenForYou,3085,235,8,4,12,66.7%,11m
15677,1,Lazyexpert,3085,274,8,10,18,44.4%,19m
15677,1,Darota,3085,266,7,12,19,36.8%,6m
15677,1,Slyder,3085,126,3,1,4,75.0%,5m
15677,3,FourTwentyLE,3085,0,3,2,5,60.0%,22m
15677,1,DoctorNinja,3085,163,3,3,6,50.0%,18m
15677,1,[GLGLG]Максимус,3085,120,3,9,12,25.0%,8m
15677,3,PolishVodka,3085,0,1,1,2,50.0%,29m
15677,1,SplashFenix,3085,38,1,4,5,20.0%,7m
15677,1,[1K1L]DextroyerXp,3085,0,0,1,1,0.0%,2m
15677,1,AǂDeusires,3085,0,0,1,1,0.0%,31m
15703,3,Mike,3084,1537,329,329,658,50.0%,5m
15703,1,CHAAAARGE,3084,1134,295,287,582,50.7%,7m
15703,1,DEathkNIghtS,3084,1112,78,74,152,51.3%,13m
15703,1,RusO,3084,1380,70,40,110,63.6%,10m
15703,1,[ggEZI]Uneha,3084,858,28,31,59,47.5%,8m
15703,1,Noname,3084,698,26,27,53,49.1%,3m
15703,3,Anton,3084,467,18,18,36,50.0%,18m
15703,3,Bizzzon,3084,376,13,15,28,46.4%,8m
15703,1,lIIlIIlIIl,3084,360,11,8,19,57.9%,12m
15703,1,Snide,3084,372,11,10,21,52.4%,23m
15703,1,[1ndica]StOnEd,3084,206,8,2,10,80.0%,2m
15703,1,[Brgny]Totoo,3084,112,3,0,3,100.0%,18m
15703,1,ramnit,3084,116,3,4,7,42.9%,12m
15703,1,Schism,3084,112,3,5,8,37.5%,19m
15703,1,Idk,3084,0,2,3,5,40.0%,2m
15703,1,CheeseMcDugl,3084,0,1,2,3,33.3%,21m
15703,1,[SL]pebriniel,3084,96,1,3,4,25.0%,2m
15703,1,Thomer,3084,73,1,5,6,16.7%,6m
15703,1,Satis,3084,0,0,1,1,0.0%,4m
15703,1,Jaabulani,3084,0,0,1,1,0.0%,8m
15703,1,PinkyPoo,3084,0,0,1,1,0.0%,2m
15703,3,PowerZone,3084,0,0,1,1,0.0%,8m
15703,1,Silverhand,3084,0,0,1,1,0.0%,23m
15703,2,[MCat]Alex,3084,0,0,2,2,0.0%,41m
15727,3,dezVal,3083,1566,160,161,321,49.8%,23m
15727,3,theidus,3083,1550,81,78,159,50.9%,12m
15727,1,patator,3083,1532,72,72,144,50.0%,18m
15727,1,[RRRRDT]HappyBeeps,3083,1338,45,47,92,48.9%,7m
15727,1,Zilvah,3083,738,27,28,55,49.1%,5m
15727,1,VonRodinus,3083,445,20,16,36,55.6%,12m
15727,1,Adipositas,3083,278,11,8,19,57.9%,4m
15727,3,LoneWolf,3083,133,7,2,9,77.8%,16m
15727,3,Лис,3083,212,7,15,22,31.8%,2m
15727,3,[UNCNKG]GireOut,3083,145,6,4,10,60.0%,20m
15727,1,[BWArmy]ArrowCombo,3083,190,5,7,12,41.7%,22m
15727,3,Angels,3083,181,4,2,6,66.7%,55m
15727,1,Smmm,3083,158,4,2,6,66.7%,23m
15727,1,[LeWät]Ishaqt,3083,112,3,7,10,30.0%,7m
15727,1,Daggoth,3083,88,1,1,2,50.0%,21m
15727,1,NoMicro,3083,0,1,1,2,50.0%,10m
15727,1,[rikard]aomaru,3083,40,1,2,3,33.3%,20m
15727,1,[FKSD]Fearless,3083,0,0,1,1,0.0%,3m
15727,1,[LOGS]Beibarsov,3083,0,0,1,1,0.0%,21m
15727,1,Stas,3083,0,0,1,1,0.0%,9m
15727,1,KimJungUn,3083,0,0,2,2,0.0%,23m
15748,1,Hagal,3082,1674,87,75,162,53.7%,2m
15748,3,BezMleka,3082,1388,75,78,153,49.0%,4m
15748,1,weakling,3082,940,52,23,75,69.3%,19m
15748,1,Taiki,3082,965,51,35,86,59.3%,21m
15748,1,superdedupe,3082,827,48,33,81,59.3%,2m
15748,1,Bru,3082,810,28,27,55,50.9%,18m
15748,1,Taronimo,3082,788,27,25,52,51.9%,21m
15748,1,xoVox,3082,606,26,21,47,55.3%,21m
15748,3,ArsKur,3082,331,23,21,44,52.3%,4m
15748,1,[Noobzz]HeM,3082,523,20,17,37,54.1%,19m
15748,1,[fckswg]StillDodgin,3082,419,16,12,28,57.1%,5m
15748,1,fatherFaria,3082,370,16,15,31,51.6%,8m
15748,1,smellybreath,3082,216,11,6,17,64.7%,11m
15748,1,ZatteTarzan,3082,250,9,7,16,56.2%,12m
15748,1,Marschall,3082,316,9,14,23,39.1%,10m
15748,1,XXXRany,3082,287,8,6,14,57.1%,12m
15748,3,Humongous,3082,94,8,7,15,53.3%,8m
15748,1,TYRevelation,3082,265,7,15,22,31.8%,6m
15748,1,[PLOUPI]LapinMalin,3082,120,6,3,9,66.7%,2m
15748,1,[42О]DimitarK,3082,194,6,6,12,50.0%,13m
15748,1,[SnSh]Yob,3082,230,6,10,16,37.5%,23m
15748,3,Numeric,3082,180,5,10,15,33.3%,12m
15748,1,ANDROCK,3082,141,4,1,5,80.0%,2m
15748,1,Swiftblood,3082,48,4,2,6,66.7%,28m
15748,1,[HBeS]youngKami,3082,196,4,4,8,50.0%,13m
15748,2,НоваяПапка,3082,167,4,8,12,33.3%,23m
15748,3,partizan,3082,90,4,8,12,33.3%,22m
15748,1,[1NFEC7]BiZarKiD,3082,0,3,2,5,60.0%,5m
15748,1,[ODGI]Browntown,3082,0,3,2,5,60.0%,12m
15748,1,Eztof,3082,112,3,6,9,33.3%,21m
15748,1,MadProbe,3082,105,2,1,3,66.7%,2m
15748,1,[XSpace]FireDrake,3082,80,2,3,5,40.0%,7m
15748,1,mitzanu,3082,0,1,0,1,100.0%,2m
15748,1,[XNTR]Drakonica,3082,40,1,4,5,20.0%,23m
15748,1,RuNeK,3082,0,0,1,1,0.0%,4m
15748,1,Lightning,3082,0,0,1,1,0.0%,6m
15748,1,Xadi,3082,0,0,1,1,0.0%,3m
15748,3,Miasanrdy,3082,0,0,1,1,0.0%,13m
15748,1,[CHUJE]ORZEL,3082,0,0,2,2,0.0%,12m
15748,1,[ZERGML]Gabriel,3082,0,0,3,3,0.0%,5m
15788,3,zStylLo,3081,445,272,261,533,51.0%,4m
15788,3,Judge,3081,1474,178,182,360,49.4%,23m
15788,1,[454]Salmon,3081,1436,98,89,187,52.4%,23m
15788,1,Banan,3081,1664,76,45,121,62.8%,18m
15788,1,skylord,3081,1117,51,31,82,62.2%,10m
15788,1,Curlviv,3081,1054,39,37,76,51.3%,6m
15788,1,llllllllll,3081,739,30,24,54,55.6%,20m
15788,1,Gaston,3081,753,25,25,50,50.0%,9m
15788,1,[TiAra]pollo,3081,352,14,15,29,48.3%,5m
15788,3,PFRibelli,3081,186,9,7,16,56.2%,21m
15788,1,StepToSpace,3081,169,6,2,8,75.0%,4m
15788,1,[MinDes]modKenny,3081,76,3,2,5,60.0%,18m
15788,1,DigitaL,3081,0,3,2,5,60.0%,4m
15788,1,Palkiya,3081,82,2,3,5,40.0%,8m
15788,1,Engel,3081,40,1,2,3,33.3%,13m
15788,1,BigBadMama,3081,89,1,5,6,16.7%,23m
15788,1,Rakso,3081,42,1,7,8,12.5%,4m
15788,1,[GmSp]RachUCiachU,3081,0,0,1,1,0.0%,7m
15788,1,executor,3081,0,0,1,1,0.0%,12m
15788,1,Echizen,3081,0,0,1,1,0.0%,7m
15808,3,AltRighteous,3080,1530,75,76,151,49.7%,22m
15808,1,[L4M3RS]roxycrystals,3080,1691,68,69,137,49.6%,2m
15808,3,zlzsheep,3080,1283,51,54,105,48.6%,9m
15808,1,Meranae,3080,602,23,15,38,60.5%,22m
15808,1,[oniz]SneakiesJeww,3080,491,22,14,36,61.1%,13m
15808,3,Lucas,3080,580,21,27,48,43.8%,5m
15808,3,[MCFire]Stormwar,3080,535,20,22,42,47.6%,5m
15808,1,Indigo,3080,455,17,12,29,58.6%,10m
15808,1,[Cladoq]NegatioN,3080,417,16,17,33,48.5%,13m
15808,1,Espelurius,3080,365,15,5,20,75.0%,9m
15808,1,PLG,3080,510,15,16,31,48.4%,10m
15808,1,bRoNzElEaGuE,3080,387,12,9,21,57.1%,5m
15808,3,khan,3080,162,7,4,11,63.6%,4m
15808,3,[FR1]AstRaxx,3080,152,7,5,12,58.3%,6m
15808,1,[BRSKR]FrodoShagins,3080,222,7,6,13,53.8%,10m
15808,3,Baal,3080,145,6,3,9,66.7%,28m
15808,1,Sergant,3080,169,5,2,7,71.4%,11m
15808,1,[LSRP]Mlemz,3080,100,5,2,7,71.4%,21m
15808,3,[PŖïMĄŁ]MalbertoM,3080,152,5,14,19,26.3%,20m
15808,1,Funuko,3080,114,4,3,7,57.1%,5m
15808,1,veri,3080,126,4,4,8,50.0%,12m
15808,1,Epicmous,3080,125,3,1,4,75.0%,12m
15808,1,[luzstr]Tempetters,3080,118,3,7,10,30.0%,4m
15808,1,[Ðicey]chuckles,3080,38,2,2,4,50.0%,18m
15808,1,fairytail,3080,89,1,1,2,50.0%,7m
15808,1,[TTur]TTurSealk,3080,0,0,1,1,0.0%,8m
15808,1,[NerCC]Rogusser,3080,0,0,1,1,0.0%,20m
15808,3,Ranann,3080,0,0,2,2,0.0%,19m
15808,1,[Pönös]TranneLRK,3080,0,0,2,2,0.0%,10m
15808,1,StarEd,3080,0,0,4,4,0.0%,22m
15838,3,Anopey,3079,1476,145,124,269,53.9%,7m
15838,1,Somnorosu,3079,1626,132,115,247,53.4%,10m
15838,3,Mirafnir,3079,1205,126,117,243,51.9%,2m
15838,1,[JiK]JaghataiKhan,3079,1580,125,112,237,52.7%,2m
15838,3,Heinrich,3079,1572,98,108,206,47.6%,11m
15838,3,Greedy,3079,706,83,85,168,49.4%,2m
15838,1,Termit,3079,1516,69,65,134,51.5%,8m
15838,1,Teddybaer,3079,1343,53,44,97,54.6%,21m
15838,1,Nissa,3079,969,36,38,74,48.6%,2m
15838,1,Psyked,3079,1032,35,38,73,47.9%,9m
15838,1,ZergEmpire,3079,330,15,11,26,57.7%,12m
15838,1,herbstkind,3079,462,13,14,27,48.1%,22m
15838,1,MBMB,3079,262,6,6,12,50.0%,4m
15838,1,glhfgg,3079,218,6,8,14,42.9%,12m
15838,1,hoerlahu,3079,159,5,2,7,71.4%,23m
15838,1,[ESErl]Pyteax,3079,142,4,5,9,44.4%,13m
15838,1,Rethnael,3079,142,4,7,11,36.4%,40m
15838,1,GaZth,3079,80,3,2,5,60.0%,9m
15838,1,[WYFU]onlymatze,3079,0,1,0,1,100.0%,8m
15838,1,[ULTX]Moritz,3079,38,1,2,3,33.3%,6m
15838,1,[ELCC]Toutanofus,3079,0,0,1,1,0.0%,9m
15838,1,BlackSteel,3079,0,0,1,1,0.0%,19m
15860,3,LingLing,3078,1615,292,285,577,50.6%,23m
15860,3,[wfolks]Electrician,3078,826,166,138,304,54.6%,6m
15860,1,Janus,3078,1597,85,78,163,52.1%,22m
15860,1,Dracula,3078,1689,61,59,120,50.8%,3m
15860,1,Sagan,3078,777,36,22,58,62.1%,23m
15860,1,baricool,3078,971,33,36,69,47.8%,21m
15860,1,dotalova,3078,679,31,20,51,60.8%,21m
15860,1,mMmCcK,3078,328,26,20,46,56.5%,2m
15860,1,Ehrmantraut,3078,673,24,26,50,48.0%,7m
15860,1,HyfoxT,3078,579,19,25,44,43.2%,18m
15860,1,Kienshi,3078,442,15,9,24,62.5%,6m
15860,1,rosv,3078,184,12,6,18,66.7%,19m
15860,1,frenao,3078,430,12,17,29,41.4%,5m
15860,1,Frees,3078,245,11,5,16,68.8%,6m
15860,1,Tmoe,3078,156,8,4,12,66.7%,9m
15860,1,[BSG19]Kerrigan,3078,184,7,4,11,63.6%,2m
15860,1,[AS90]JeeratRome,3078,68,6,4,10,60.0%,8m
15860,1,[SvsFl]Nobelsix,3078,0,4,1,5,80.0%,8m
15860,1,Dabeh,3078,0,4,2,6,66.7%,5m
15860,1,[RESURS]NIKOTIN,3078,146,4,5,9,44.4%,13m
15860,1,Slayn,3078,162,4,11,15,26.7%,4m
15860,1,Eintrag,3078,0,3,2,5,60.0%,1h
15860,3,Daikenas,3078,66,2,17,19,10.5%,13m
15860,1,MSTLerougde,3078,0,1,1,2,50.0%,8m
15860,1,[GGSC2]Gimy,3078,92,1,1,2,50.0%,21m
15860,1,[αX]Serpagel,3078,0,1,1,2,50.0%,19m
15860,1,BrigaDIR,3078,0,0,1,1,0.0%,5m
15860,1,alexterror,3078,0,0,1,1,0.0%,3m
15888,1,Vasp,3077,717,65,63,128,50.8%,18m
15888,3,ripper,3077,853,37,30,67,55.2%,6m
15888,1,[EBOLO]vector,3077,686,30,21,51,58.8%,22m
15888,1,ImaGo,3077,715,29,32,61,47.5%,22m
15888,1,Ztee,3077,421,24,16,40,60.0%,5m
15888,1,[Саб]Артур,3077,335,17,3,20,85.0%,20m
15888,1,neptun,3077,395,13,13,26,50.0%,20m
15888,1,SamuiDobrui,3077,257,9,5,14,64.3%,5m
15888,1,Unfug,3077,282,8,16,24,33.3%,4m
15888,1,XxRamGxX,3077,133,6,3,9,66.7%,4m
15888,3,Glhf,3077,110,6,3,9,66.7%,12m
15888,1,DIMONmina,3077,209,6,3,9,66.7%,8m
15888,3,MaliSqirto,3077,0,5,1,6,83.3%,22m
15888,1,Zrakes,3077,0,4,2,6,66.7%,12m
15888,1,Patoche,3077,121,4,5,9,44.4%,19m
15888,1,Rokehn,3077,126,3,1,4,75.0%,19m
15888,1,falck,3077,76,2,4,6,33.3%,7m
15888,1,[DemGam]Tyco,3077,0,1,0,1,100.0%,2m
15888,1,[Sask2]Changeling,3077,0,0,2,2,0.0%,29m
15888,1,LaMKa,3077,0,0,4,4,0.0%,3m
15908,1,[Specim]grAnite,3076,892,79,67,146,54.1%,5m
15908,1,BeliverX,3076,1073,73,68,141,51.8%,4m
15908,1,ouki,3076,1161,55,34,89,61.8%,4m
15908,1,bigbang,3076,956,36,30,66,54.5%,4m
15908,1,calmvibes,3076,1006,36,39,75,48.0%,13m
15908,1,[ExTr1m]KoViGens,3076,798,33,22,55,60.0%,8m
15908,1,abracula,3076,678,27,23,50,54.0%,20m
15908,1,[CocSac]вкусняшка,3076,744,25,21,46,54.3%,19m
15908,3,Дразарг,3076,606,20,29,49,40.8%,13m
15908,3,[Heroes]Juvator,3076,30,19,21,40,47.5%,4m
15908,3,MightyAphro,3076,323,13,9,22,59.1%,6m
15908,1,General,3076,296,10,6,16,62.5%,22m
15908,1,[Volo]Majkarto,3076,316,9,8,17,52.9%,6m
15908,1,chichibuchka,3076,215,8,5,13,61.5%,15m
15908,1,gaaaaaaaaaaa,3076,248,8,8,16,50.0%,5m
15908,1,Neyfra,3076,205,6,7,13,46.2%,12m
15908,1,SealClubber,3076,131,4,1,5,80.0%,11m
15908,3,IIIIIIIIIIII,3076,133,4,3,7,57.1%,13m
15908,1,redline,3076,154,4,6,10,40.0%,11m
15908,1,CoronaGabo,3076,118,2,2,4,50.0%,8m
15908,1,Whyyouimba,3076,0,1,0,1,100.0%,53m
15908,1,[IUFOI]DeTrosty,3076,0,1,3,4,25.0%,13m
15908,1,[Dytred]MayorKirov,3076,42,1,3,4,25.0%,2m
15908,1,SaTanda,3076,0,0,1,1,0.0%,2m
15908,2,gatoconak,3076,0,0,3,3,0.0%,12m
15908,1,yolosweg,3076,0,0,4,4,0.0%,12m
15934,3,Aurelius,3075,1590,124,118,242,51.2%,21m
15934,3,Azraael,3075,1524,97,89,186,52.2%,5m
15934,3,CerealKiller,3075,1427,58,56,114,50.9%,22m
15934,1,[Kingz]MasterLxPt,3075,515,52,42,94,55.3%,13m
15934,1,North,3075,687,38,14,52,73.1%,4m
15934,1,PeteNice,3075,451,18,9,27,66.7%,22m
15934,1,[BotN]FunkyBear,3075,550,17,20,37,45.9%,20m
15934,1,diREKT,3075,395,16,6,22,72.7%,8m
15934,3,GagamelsRage,3075,323,16,8,24,66.7%,7m
15934,1,Phiras,3075,308,9,10,19,47.4%,19m
15934,1,IvO,3075,182,6,4,10,60.0%,2m
15934,3,Layo,3075,193,6,10,16,37.5%,4m
15934,3,[EESC]TripleS,3075,124,5,13,18,27.8%,4m
15934,1,TryNïtÿ,3075,104,3,0,3,100.0%,23m
15934,1,[Nosda]Elodin,3075,107,3,0,3,100.0%,18m
15934,1,Trout,3075,0,3,2,5,60.0%,29m
15934,1,TheTerranGuy,3075,0,3,2,5,60.0%,12m
15934,1,[KNiG]ICH,3075,116,3,4,7,42.9%,4m
15934,1,dynamite,3075,104,2,2,4,50.0%,4m
15934,1,Deniska,3075,0,1,0,1,100.0%,20m
15934,1,[Hаsu]Brightfuture,3075,94,1,1,2,50.0%,23m
15934,3,Calambra,3075,30,1,12,13,7.7%,13m
15934,1,ZergMachine,3075,0,0,1,1,0.0%,5m
15934,1,[Dytred]BigSexi,3075,0,0,1,1,0.0%,23m
15958,1,Bon,3074,1749,214,187,401,53.4%,5m
15958,3,west,3074,683,65,47,112,58.0%,21m
15958,1,[IceHus]KartofunSumy,3074,1026,59,52,111,53.2%,4m
15958,1,[PiGPan]VictORIGINAL,3074,1400,53,48,101,52.5%,19m
15958,3,AsMo,3074,987,52,54,106,49.1%,13m
15958,1,StalZ,3074,1089,40,34,74,54.1%,9m
15958,1,Tio,3074,943,29,33,62,46.8%,4m
15958,1,meatly,3074,774,23,26,49,46.9%,23m
15958,1,senpai,3074,398,18,12,30,60.0%,18m
15958,1,Livier,3074,331,12,9,21,57.1%,19m
15958,1,[SWEBK]Tasso,3074,204,6,4,10,60.0%,8m
15958,1,Jakubeslaw,3074,232,6,9,15,40.0%,11m
15958,1,Alexmig,3074,186,4,4,8,50.0%,3m
15958,1,slavko,3074,140,4,6,10,40.0%,18m
15958,1,wowa,3074,0,3,2,5,60.0%,19m
15958,1,kiwka,3074,80,3,4,7,42.9%,3m
15958,1,HighKick,3074,149,3,4,7,42.9%,8m
15958,2,Skendau,3074,115,3,5,8,37.5%,47m
15958,1,grindal,3074,103,2,1,3,66.7%,7m
15958,3,[LIQUID]SheeBa,3074,0,1,0,1,100.0%,43m
15958,1,[D0N3]SimonRise,3074,90,1,1,2,50.0%,21m
15958,3,FistingAss,3074,97,1,1,2,50.0%,52m
15958,1,Hans,3074,36,1,2,3,33.3%,22m
15958,1,Rossie,3074,38,1,3,4,25.0%,15m
15958,1,[Bri]Phillipht,3074,38,1,4,5,20.0%,22m
15958,3,[CBot]Katzenlord,3074,0,0,1,1,0.0%,6m
15958,1,LaNzE,3074,0,0,1,1,0.0%,9m
15958,1,Pinzgo,3074,0,0,2,2,0.0%,12m
15958,1,KeMpYXzZz,3074,0,0,2,2,0.0%,8m
15987,3,Docsquirrel,3073,1553,122,124,246,49.6%,6m
15987,1,zerGo,3073,1130,80,3,83,96.4%,4m
15987,1,FoxPS,3073,1126,66,52,118,55.9%,22m
15987,1,PinkiePie,3073,345,61,53,114,53.5%,8m
15987,3,ayo,3073,835,43,44,87,49.4%,7m
15987,1,Cece,3073,1040,40,40,80,50.0%,13m
15987,1,[WeiK]Balerion,3073,833,31,25,56,55.4%,19m
15987,1,Dalus,3073,595,28,17,45,62.2%,15m
15987,1,Driskol,3073,732,22,24,46,47.8%,23m
15987,1,LEON,3073,290,13,10,23,56.5%,4m
15987,1,Asukurra,3073,219,12,3,15,80.0%,12m
15987,1,GigantMbIsli,3073,311,11,7,18,61.1%,9m
15987,1,[SP4]ProxyNova,3073,235,10,4,14,71.4%,7m
15987,1,SmellyCherry,3073,206,10,6,16,62.5%,5m
15987,2,Ramuh,3073,259,9,6,15,60.0%,59m
15987,3,Like,3073,287,8,15,23,34.8%,12m
15987,3,billievision,3073,176,7,13,20,35.0%,14m
15987,1,[MCPrg]Mancini,3073,178,6,6,12,50.0%,21m
15987,1,[rages]mahi,3073,48,5,2,7,71.4%,4m
15987,3,Bober,3073,152,5,12,17,29.4%,8m
15987,1,IIIIIIIIIIII,3073,0,4,2,6,66.7%,13m
15987,1,Lighty,3073,64,4,5,9,44.4%,13m
15987,1,ALVAREZ,3073,74,3,3,6,50.0%,21m
15987,2,SoChara,3073,117,2,2,4,50.0%,13m
15987,1,[TVPV]stØzza,3073,0,1,0,1,100.0%,20m
15987,2,Sundowner,3073,93,1,2,3,33.3%,19m
15987,1,Heppatitt,3073,0,0,1,1,0.0%,6m
15987,1,[3Lings]Yoda,3073,0,0,1,1,0.0%,7m
15987,1,JesusChrist,3073,0,0,1,1,0.0%,2m
15987,1,Eraser,3073,0,0,1,1,0.0%,20m
16017,3,redwhite,3072,1580,289,271,560,51.6%,4m
16017,3,[sH33px]TheDeadSheep,3072,1280,107,103,210,51.0%,23m
16017,1,[tsty]Silberfisch,3072,1166,60,22,82,73.2%,20m
16017,1,gosha,3072,724,39,11,50,78.0%,6m
16017,3,[SNKlan]CarestiaSNK,3072,623,21,28,49,42.9%,7m
16017,1,[ZN]Manwe,3072,308,11,4,15,73.3%,7m
16017,1,[JaPP]LeTLe,3072,364,10,11,21,47.6%,6m
16017,1,Elightos,3072,325,9,9,18,50.0%,18m
16017,1,Snowdrop,3072,202,8,3,11,72.7%,4m
16017,1,PlatPenguin,3072,76,6,3,9,66.7%,22m
16017,3,Liquid,3072,211,6,8,14,42.9%,22m
16017,2,neElka,3072,96,5,3,8,62.5%,26m
16017,1,PaKe,3072,154,5,5,10,50.0%,20m
16017,1,[LCDA]ghörg,3072,0,4,1,5,80.0%,19m
16017,1,BIbop,3072,86,3,6,9,33.3%,9m
16017,1,kierenz,3072,160,3,6,9,33.3%,4m
16017,1,hamouche,3072,78,2,5,7,28.6%,18m
16017,1,FGAlvaro,3072,95,2,6,8,25.0%,18m
16017,1,[inFDk]Pochkonator,3072,88,1,1,2,50.0%,5m
16017,1,Duffman,3072,38,1,2,3,33.3%,8m
16017,1,InsanEGARRY,3072,38,1,2,3,33.3%,5m
16017,1,[BoAnt]Kaya,3072,40,1,4,5,20.0%,21m
16017,1,Elladan,3072,0,0,1,1,0.0%,5m
16017,1,TitusPullo,3072,0,0,3,3,0.0%,18m
16041,1,LaCucaracha,3071,1696,124,123,247,50.2%,4m
16041,3,[D7]DSevenMick,3071,1529,65,74,139,46.8%,12m
16041,1,Gambit,3071,1472,57,49,106,53.8%,20m
16041,3,River,3071,1293,56,60,116,48.3%,19m
16041,1,[Övis]Overlord,3071,1038,39,40,79,49.4%,2m
16041,3,AcahCruv,3071,958,34,43,77,44.2%,5m
16041,1,Palm,3071,687,30,26,56,53.6%,19m
16041,3,[N0oBS]Olisexsexsex,3071,629,28,24,52,53.8%,7m
16041,3,Tommy,3071,667,26,23,49,53.1%,3m
16041,1,Forsaken,3071,624,25,19,44,56.8%,21m
16041,3,Gyyyzmo,3071,651,25,25,50,50.0%,18m
16041,1,[ArGGEJ]Bismarck,3071,348,10,8,18,55.6%,4m
16041,1,Mage,3071,374,10,13,23,43.5%,8m
16041,1,walid,3071,262,9,5,14,64.3%,22m
16041,1,[PRTZ]theMONKEY,3071,144,9,12,21,42.9%,19m
16041,1,Shynamo,3071,262,7,13,20,35.0%,10m
16041,1,CurryCake,3071,180,5,7,12,41.7%,4m
16041,1,AEG,3071,196,5,9,14,35.7%,5m
16041,1,aeolis,3071,72,2,8,10,20.0%,7m
16041,1,Himal,3071,40,1,2,3,33.3%,3m
16041,1,[mtmt]Boris,3071,0,0,1,1,0.0%,2m
16041,1,Tilter,3071,0,0,1,1,0.0%,9m
16041,1,Gen,3071,0,0,1,1,0.0%,22m
16041,1,Tierraxhm,3071,0,0,2,2,0.0%,8m
16041,1,[RFK]PeculiarPear,3071,0,0,3,3,0.0%,4m
16041,1,suom,3071,0,0,4,4,0.0%,2m
16067,3,NudeDude,3070,1485,99,108,207,47.8%,12m
16067,1,BeliboOn,3070,850,37,28,65,56.9%,8m
16067,1,[NWGD]Panir,3070,936,29,30,59,49.2%,21m
16067,1,ALS,3070,920,28,34,62,45.2%,2m
16067,3,aleks,3070,708,23,33,56,41.1%,22m
16067,3,gZa,3070,497,20,21,41,48.8%,10m
16067,3,MickNinja,3070,334,14,8,22,63.6%,7m
16067,1,togostyrael,3070,396,12,12,24,50.0%,21m
16067,1,Naerea,3070,316,11,9,20,55.0%,10m
16067,1,[BRUSHT]Aquafresh,3070,363,10,10,20,50.0%,7m
16067,1,ilya,3070,186,6,4,10,60.0%,22m
16067,1,Dragster,3070,243,6,7,13,46.2%,4m
16067,1,[HaSt]StrrrrappsHS,3070,105,5,3,8,62.5%,12m
16067,1,Rasterpopoli,3070,194,5,5,10,50.0%,12m
16067,1,Пупырка,3070,154,5,7,12,41.7%,2m
16067,1,[ob5]StarMaster,3070,156,4,10,14,28.6%,18m
16067,1,Gromflomite,3070,116,3,4,7,42.9%,13m
16067,3,Otori,3070,175,3,8,11,27.3%,35m
16067,1,Nawaro,3070,36,2,1,3,66.7%,6m
16067,1,[0860]Broxi,3070,115,2,1,3,66.7%,8m
16067,1,Betrezen,3070,0,1,0,1,100.0%,20m
16067,1,ichyron,3070,0,1,0,1,100.0%,21m
16067,1,DeluSiON,3070,0,0,1,1,0.0%,2m
16067,1,Sequoia,3070,0,0,1,1,0.0%,7m
16067,1,[DAGW]greenloar,3070,0,0,1,1,0.0%,23m
16067,1,[J4E]bluedragon,3070,0,0,3,3,0.0%,7m
16093,3,HyperSonic,3069,1352,114,115,229,49.8%,13m
16093,1,[Dogmin]bohong,3069,1418,91,79,170,53.5%,6m
16093,3,[TeWu]Howland,3069,778,79,76,155,51.0%,13m
16093,1,zed,3069,560,62,58,120,51.7%,15m
16093,1,llllllllllll,3069,1338,52,45,97,53.6%,19m
16093,1,[Clocks]Euphoria,3069,1280,51,47,98,52.0%,11m
16093,3,tree,3069,749,34,43,77,44.2%,22m
16093,1,[CruZe]Marian,3069,466,20,12,32,62.5%,8m
16093,1,KlamFyr,3069,358,15,2,17,88.2%,8m
16093,1,Kaiser,3069,330,10,8,18,55.6%,9m
16093,1,DigitalEnemy,3069,368,10,14,24,41.7%,20m
16093,1,CrankyPants,3069,254,8,9,17,47.1%,2m
16093,1,[GudE]Shalanov,3069,120,6,2,8,75.0%,11m
16093,3,Jabol,3069,0,5,5,10,50.0%,7m
16093,3,Draganko,3069,122,4,14,18,22.2%,12m
16093,3,[IMeQ]NinnZyAeQ,3069,121,3,2,5,60.0%,45m
16093,1,Nasai,3069,68,3,4,7,42.9%,4m
16093,1,nesanot,3069,127,2,2,4,50.0%,11m
16093,1,keyser,3069,84,2,7,9,22.2%,6m
16093,1,IIIIIIIIII,3069,84,2,7,9,22.2%,18m
16093,1,wodkaisgood,3069,0,1,0,1,100.0%,7m
16093,1,nAno,3069,0,1,0,1,100.0%,21m
16093,1,GesùCristo,3069,0,1,0,1,100.0%,21m
16093,2,Ramzes,3069,0,1,0,1,100.0%,10m
16093,3,ZACH,3069,0,1,1,2,50.0%,50m
16093,1,Starzinger,3069,0,1,1,2,50.0%,20m
16093,1,Gradient,3069,0,1,3,4,25.0%,4m
16093,3,Essence,3069,30,1,10,11,9.1%,5m
16093,1,[BYOS]CurlyBaboon,3069,0,0,2,2,0.0%,6m
16122,3,Nikusz,3068,1484,275,266,541,50.8%,17m
16122,1,angr,3068,1669,115,109,224,51.3%,6m
16122,3,[TSURP]SuperLuznad,3068,812,30,34,64,46.9%,10m
16122,1,ProbeProcess,3068,700,22,23,45,48.9%,9m
16122,1,sysERROR,3068,346,19,15,34,55.9%,15m
16122,1,FabulousHero,3068,332,14,14,28,50.0%,11m
16122,1,Korlim,3068,358,12,10,22,54.5%,8m
16122,3,Iceman,3068,256,11,8,19,57.9%,4m
16122,1,CannonFodder,3068,368,10,9,19,52.6%,4m
16122,1,Yur,3068,320,9,10,19,47.4%,21m
16122,3,[SMID]Mikozza,3068,280,9,19,28,32.1%,5m
16122,1,[нагиб]Нагибыч,3068,141,8,5,13,61.5%,20m
16122,1,Слава,3068,169,7,4,11,63.6%,13m
16122,1,Kral,3068,220,7,10,17,41.2%,11m
16122,3,[InitRu]DeDyshka,3068,137,4,4,8,50.0%,33m
16122,1,sereetz,3068,154,4,6,10,40.0%,13m
16122,1,Omarnoir,3068,0,3,2,5,60.0%,18m
16122,1,Hawk,3068,0,3,2,5,60.0%,6m
16122,1,Malfeus,3068,116,3,8,11,27.3%,6m
16122,3,ShiVA,3068,96,2,1,3,66.7%,14m
16122,3,MileyCyrus,3068,122,2,2,4,50.0%,33m
16122,1,jamort,3068,0,1,0,1,100.0%,46m
16122,1,[Kompis]SagasPappa,3068,89,1,1,2,50.0%,10m
16122,1,Litago,3068,40,1,2,3,33.3%,13m
16122,1,Rugor,3068,38,1,2,3,33.3%,13m
16122,1,Timon,3068,0,0,1,1,0.0%,19m
16122,1,nesQuik,3068,0,0,1,1,0.0%,3m
16122,1,[Rakia]Spawn,3068,0,0,5,5,0.0%,8m
16150,3,BumbarasheK,3067,939,100,98,198,50.5%,12m
16150,3,[MSUSC2]Kirber,3067,714,60,65,125,48.0%,23m
16150,1,Dark,3067,935,56,48,104,53.8%,11m
16150,1,THaRi,3067,1014,47,46,93,50.5%,3m
16150,3,ValorTime,3067,942,43,51,94,45.7%,12m
16150,1,Druss,3067,1138,39,41,80,48.8%,12m
16150,3,fLipsTar,3067,623,32,42,74,43.2%,12m
16150,3,Tsalykval,3067,656,21,28,49,42.9%,21m
16150,3,Avmakt,3067,292,14,15,29,48.3%,20m
16150,3,bycraft,3067,380,13,23,36,36.1%,9m
16150,1,SneakyWater,3067,260,10,7,17,58.8%,15m
16150,1,ihazname,3067,110,8,5,13,61.5%,5m
16150,2,[M1o1T]nabbcake,3067,211,8,6,14,57.1%,10m
16150,1,[SLPro]Head,3067,72,7,3,10,70.0%,6m
16150,1,player,3067,221,7,4,11,63.6%,7m
16150,1,DGkr,3067,227,6,5,11,54.5%,4m
16150,3,[nB]Olways,3067,60,6,6,12,50.0%,18m
16150,1,ScHolarAGeNt,3067,184,5,9,14,35.7%,20m
16150,1,[JMML]Zacro,3067,154,4,8,12,33.3%,21m
16150,1,Mathist,3067,135,3,3,6,50.0%,18m
16150,1,NEETo,3067,76,3,3,6,50.0%,12m
16150,3,Rudu,3067,58,3,9,12,25.0%,4m
16150,1,[ZrgZer]redgorila,3067,103,2,1,3,66.7%,2m
16150,1,Bankyz,3067,105,2,2,4,50.0%,6m
16150,1,MistrPetr,3067,0,1,0,1,100.0%,6m
16150,1,[3ЕRGTV]Spender,3067,0,0,1,1,0.0%,12m
16176,1,lazyLefty,3066,1724,170,146,316,53.8%,21m
16176,1,MataBuitres,3066,633,44,39,83,53.0%,13m
16176,1,[ZERGYT]BTCHunter,3066,855,40,39,79,50.6%,4m
16176,1,fatbob,3066,1032,40,42,82,48.8%,5m
16176,1,AdmlAphexus,3066,1088,36,39,75,48.0%,22m
16176,1,Wushu,3066,940,32,32,64,50.0%,6m
16176,3,baabaa,3066,618,26,25,51,51.0%,11m
16176,3,SCSK,3066,377,18,21,39,46.2%,5m
16176,2,Tenbril,3066,294,13,10,23,56.5%,18m
16176,1,[DTRUMP]PaizuriChan,3066,324,9,11,20,45.0%,13m
16176,1,Aquatech,3066,218,7,9,16,43.8%,8m
16176,3,TomaszH,3066,206,7,15,22,31.8%,8m
16176,3,LeSadik,3066,60,6,5,11,54.5%,19m
16176,1,akaki,3066,140,5,5,10,50.0%,3m
16176,1,spitfyre,3066,0,3,3,6,50.0%,8m
16176,1,[ALED]Boomyxx,3066,116,3,5,8,37.5%,3m
16176,1,Azrael,3066,76,2,3,5,40.0%,15m
16176,2,[Kbanus]aurel,3066,0,1,0,1,100.0%,17m
16176,2,TomoLiestas,3066,30,1,1,2,50.0%,23m
16176,3,VxD,3066,0,1,2,3,33.3%,6m
16176,2,DrPhilGood,3066,0,1,3,4,25.0%,15m
16176,2,[BADBAO]Bibolo,3066,0,0,1,1,0.0%,9m
16176,2,[ЗХАПЙЦ]goto,3066,0,0,1,1,0.0%,4m
16176,2,TheThirdDay,3066,0,0,2,2,0.0%,1h
16200,1,DaHitch,3065,1459,69,52,121,57.0%,20m
16200,3,Loudwallace,3065,1104,60,66,126,47.6%,7m
16200,3,ScIIAvenger,3065,1027,40,47,87,46.0%,12m
16200,1,Kilëür,3065,914,34,26,60,56.7%,4m
16200,1,[theTPL]Kruzørf,3065,966,30,31,61,49.2%,8m
16200,1,Korban,3065,244,25,13,38,65.8%,23m
16200,1,HellFox,3065,355,16,9,25,64.0%,8m
16200,2,[stai]Серджо,3065,344,13,17,30,43.3%,7m
16200,1,[Desire]ZutuZ,3065,306,10,11,21,47.6%,4m
16200,1,[sonic1]MicroMEC,3065,105,7,3,10,70.0%,6m
16200,1,[GGasap]Drewin,3065,264,7,12,19,36.8%,6m
16200,3,VanDerFenix,3065,120,6,4,10,60.0%,10m
16200,1,FireBird,3065,96,5,4,9,55.6%,5m
16200,1,Колька,3065,80,3,4,7,42.9%,7m
16200,1,Podleshik,3065,116,3,6,9,33.3%,7m
16200,2,[FSCOTB]Arcanacal,3065,62,2,1,3,66.7%,11m
16200,2,[BCV]Bronx,3065,64,2,1,3,66.7%,18m
16200,1,Inthoxx,3065,38,2,3,5,40.0%,10m
16200,2,[pTa]Genbu,3065,0,1,0,1,100.0%,10m
16200,2,[J4E]рокош,3065,0,1,0,1,100.0%,23m
16200,1,FastoS,3065,0,1,1,2,50.0%,10m
16200,2,[dp]Imperfect,3065,0,0,1,1,0.0%,9m
16200,1,Kaiser,3065,0,0,3,3,0.0%,23m
16200,1,tIoIxIa,3065,0,0,3,3,0.0%,20m
16200,1,CrashThor,3065,0,0,4,4,0.0%,6m
16225,1,[GUGE]AjjKillJuu,3064,1675,141,142,283,49.8%,4m
16225,1,Deusmortis,3064,626,83,68,151,55.0%,9m
16225,3,[ChXx]ThorvaldAs,3064,751,82,86,168,48.8%,5m
16225,3,Daniel,3064,782,60,65,125,48.0%,7m
16225,1,minuteman,3064,1390,48,52,100,48.0%,22m
16225,3,Duke,3064,686,28,35,63,44.4%,5m
16225,1,Tvard,3064,581,20,15,35,57.1%,13m
16225,1,Ham,3064,500,15,16,31,48.4%,22m
16225,3,supertim,3064,269,12,11,23,52.2%,5m
16225,1,DroneForever,3064,326,10,10,20,50.0%,22m
16225,1,Maxblue,3064,306,8,13,21,38.1%,7m
16225,2,Gnark,3064,112,5,2,7,71.4%,20m
16225,1,Чэмп,3064,180,5,6,11,45.5%,4m
16225,1,Gtowmod,3064,148,5,8,13,38.5%,18m
16225,2,DerehamPride,3064,88,4,0,4,100.0%,22m
16225,1,fokabel,3064,97,4,2,6,66.7%,3m
16225,2,[AdABaN]AdVersum,3064,34,2,1,3,66.7%,5m
16225,1,[VSCODE]Begothen,3064,36,2,3,5,40.0%,4m
16225,2,[viz]Lost,3064,32,1,1,2,50.0%,7m
16225,1,raelag,3064,34,1,3,4,25.0%,3m
16225,1,schwayn,3064,38,1,7,8,12.5%,21m
16225,3,Monsoon,3064,30,1,14,15,6.7%,10m
16225,2,ManLove,3064,0,0,1,1,0.0%,23m
16225,2,[ArGGEJ]Tossadar,3064,0,0,1,1,0.0%,23m
16249,3,HommeFort,3063,989,102,94,196,52.0%,18m
16249,1,Inger,3063,1003,48,39,87,55.2%,11m
16249,3,[KMarks]pinkguy,3063,510,39,35,74,52.7%,3m
16249,3,KunDun,3063,427,14,21,35,40.0%,5m
16249,1,noverin,3063,443,13,12,25,52.0%,20m
16249,2,Quad,3063,316,11,10,21,52.4%,18m
16249,1,lóa,3063,224,9,7,16,56.2%,8m
16249,2,Word,3063,155,7,3,10,70.0%,7m
16249,1,Norecha,3063,145,7,6,13,53.8%,30m
16249,2,Ignaz,3063,133,3,1,4,75.0%,59m
16249,1,BabaNn,3063,68,3,2,5,60.0%,20m
16249,2,pxssydstryer,3063,64,2,1,3,66.7%,2m
16249,1,[ArDoC]onelastkiss,3063,46,2,3,5,40.0%,53m
16249,1,Itacheat,3063,76,2,4,6,33.3%,14m
16249,2,[Chariz]ricishort,3063,30,1,2,3,33.3%,19m
16249,1,[WALRUS]Cthulu,3063,0,1,3,4,25.0%,15m
16249,2,[MED0ЕD]Xeno,3063,0,0,1,1,0.0%,7m
16266,1,Apollon,3062,1714,603,608,1211,49.8%,6m
16266,2,FaFaN,3062,1511,283,266,549,51.5%,15m
16266,1,Modscore,3062,1649,155,132,287,54.0%,14m
16266,1,GERG,3062,1548,76,50,126,60.3%,22m
16266,3,Kessi,3062,951,56,58,114,49.1%,13m
16266,1,[Heroes]Pinion,3062,351,36,29,65,55.4%,13m
16266,2,Alex,3062,564,29,21,50,58.0%,18m
16266,1,JysN,3062,601,27,22,49,55.1%,21m
16266,2,zeratul,3062,225,25,19,44,56.8%,5m
16266,3,Ambresol,3062,464,22,21,43,51.2%,9m
16266,1,serst,3062,630,20,21,41,48.8%,19m
16266,1,Clapbox,3062,455,15,12,27,55.6%,4m
16266,3,[G4YoU]Christiankir,3062,326,10,17,27,37.0%,14m
16266,3,[UPA]RelliK,3062,310,10,27,37,27.0%,6m
16266,3,thejolly,3062,238,7,7,14,50.0%,17m
16266,1,Sensei,3062,143,4,3,7,57.1%,13m
16266,2,saliteeg,3062,0,3,2,5,60.0%,19m
16266,2,ZwS,3062,32,2,0,2,100.0%,6m
16266,2,Sephiroth,3062,115,2,1,3,66.7%,15m
16266,2,jhNsen,3062,44,1,2,3,33.3%,47m
16266,2,[JaH]DjouLo,3062,0,0,1,1,0.0%,10m
16266,2,Khajiit,3062,0,0,1,1,0.0%,12m
16266,2,[MoS]Kanaal,3062,0,0,1,1,0.0%,17m
16289,3,[MGK]Nicocotier,3061,1400,55,75,130,42.3%,7m
16289,1,Patate,3061,1227,51,43,94,54.3%,8m
16289,1,[HSofS]Algorithm,3061,964,39,26,65,60.0%,4m
16289,1,Paulie,3061,806,29,24,53,54.7%,3m
16289,1,ArthurC,3061,687,23,22,45,51.1%,2m
16289,1,Yaser,3061,540,16,21,37,43.2%,21m
16289,1,Kamil,3061,472,14,18,32,43.8%,3m
16289,1,NeverMind,3061,201,9,6,15,60.0%,13m
16289,3,Ratibor,3061,189,9,7,16,56.2%,5m
16289,2,Ako,3061,200,7,4,11,63.6%,21m
16289,3,Islington,3061,172,6,9,15,40.0%,22m
16289,1,jockey,3061,70,3,5,8,37.5%,4m
16289,1,henrybg,3061,89,2,1,3,66.7%,13m
16289,1,Akaneron,3061,123,2,3,5,40.0%,10m
16289,2,[BHN]sergoRU,3061,0,1,0,1,100.0%,21m
16289,1,[lESGl]Vadda,3061,40,1,3,4,25.0%,19m
16305,2,DarkMoli,3060,1530,105,101,206,51.0%,18m
16305,2,Mundilfari,3060,1116,89,67,156,57.1%,13m
16305,3,[PLH]Baba,3060,933,75,70,145,51.7%,4m
16305,2,[RTGG]Awake,3060,1364,65,31,96,67.7%,7m
16305,1,AldarsKose,3060,1243,61,55,116,52.6%,13m
16305,2,tsaga,3060,996,40,29,69,58.0%,22m
16305,1,Kydraviy,3060,990,35,34,69,50.7%,9m
16305,3,THEHIT,3060,770,31,32,63,49.2%,3m
16305,1,Spot,3060,638,22,25,47,46.8%,5m
16305,3,[ØC]BioFake,3060,415,15,16,31,48.4%,12m
16305,2,[ЗЕRGТV]ACWar,3060,131,4,1,5,80.0%,18m
16305,1,Advenne,3060,178,4,4,8,50.0%,21m
16305,1,Majorana,3060,40,4,6,10,40.0%,4m
16305,1,WinterKing,3060,0,3,2,5,60.0%,43m
16305,1,Bluntus,3060,136,3,3,6,50.0%,23m
16305,1,DonDaap,3060,90,2,1,3,66.7%,13m
16305,2,Asur,3060,64,2,2,4,50.0%,19m
16305,2,koop,3060,0,1,0,1,100.0%,4m
16305,2,Metalsous,3060,0,1,0,1,100.0%,5m
16305,3,Izzard,3060,0,1,1,2,50.0%,7m
16305,3,[Ormus]HeadHunter,3060,0,1,1,2,50.0%,28m
16305,2,JanStar,3060,34,1,2,3,33.3%,9m
16305,1,[HighP]KingdomPower,3060,38,1,3,4,25.0%,4m
16305,1,RaPaX,3060,0,0,2,2,0.0%,7m
16305,1,[TLT1]Sarnek,3060,0,0,2,2,0.0%,6m
16305,1,oettam,3060,0,0,3,3,0.0%,4m
16331,3,Gizui,3059,1545,289,285,574,50.3%,12m
16331,3,Lapinot,3059,1318,46,55,101,45.5%,5m
16331,1,Scipio,3059,603,26,16,42,61.9%,7m
16331,1,mikerotch,3059,661,23,20,43,53.5%,20m
16331,3,[Nudz]Imeryll,3059,634,23,32,55,41.8%,11m
16331,1,hlebushek,3059,402,13,14,27,48.1%,2m
16331,1,zACz,3059,396,13,14,27,48.1%,8m
16331,2,Ganton,3059,290,10,10,20,50.0%,9m
16331,1,CrazyTimon,3059,90,4,3,7,57.1%,12m
16331,2,JackDiPippe,3059,68,3,1,4,75.0%,7m
16331,3,[сSсǃ]SunFace,3059,58,3,11,14,21.4%,15m
16331,2,plage,3059,32,2,0,2,100.0%,9m
16331,1,Misha,3059,38,2,5,7,28.6%,13m
16331,3,[PTM]Senzaki,3059,62,2,8,10,20.0%,14m
16331,1,Vadim,3059,42,1,5,6,16.7%,6m
16331,2,Barmaley,3059,0,0,1,1,0.0%,9m
16331,3,Ray,3059,0,0,1,1,0.0%,25m
16331,1,[RBP3]GeScorpion,3059,0,0,3,3,0.0%,19m
16349,3,nano,3058,719,102,109,211,48.3%,23m
16349,1,Lokiknight,3058,1641,84,64,148,56.8%,13m
16349,1,KNIGHT,3058,1679,79,75,154,51.3%,23m
16349,3,[NLTN]Adler,3058,1454,76,70,146,52.1%,19m
16349,3,MEOW,3058,878,56,57,113,49.6%,5m
16349,1,Krys,3058,1516,54,61,115,47.0%,4m
16349,2,[76Crew]Kall,3058,1247,51,38,89,57.3%,15m
16349,1,[R4Time]Papatuu,3058,1019,48,37,85,56.5%,8m
16349,2,Valigare,3058,1095,47,35,82,57.3%,22m
16349,1,josenuno,3058,927,40,29,69,58.0%,22m
16349,3,RasiertaElch,3058,891,38,52,90,42.2%,12m
16349,1,[HeClub]matvey,3058,542,21,18,39,53.8%,2m
16349,3,Robek,3058,450,17,17,34,50.0%,21m
16349,1,Зератул,3058,288,10,9,19,52.6%,4m
16349,3,Kolyanych,3058,96,6,3,9,66.7%,18m
16349,2,ppsbbNO,3058,148,6,5,11,54.5%,12m
16349,1,Chemiczny,3058,220,6,7,13,46.2%,18m
16349,1,[WCKYLN]CookiePizza,3058,157,5,3,8,62.5%,7m
16349,3,WardeZ,3058,122,5,3,8,62.5%,33m
16349,2,[KACHIN]SCV,3058,0,4,1,5,80.0%,21m
16349,3,ilykot,3058,0,4,3,7,57.1%,22m
16349,1,[iX]Kuhmelker,3058,110,4,4,8,50.0%,13m
16349,3,Elios,3058,163,4,4,8,50.0%,2m
16349,2,[BMaids]fdf,3058,64,3,1,4,75.0%,13m
16349,1,Shadow,3058,0,3,2,5,60.0%,45m
16349,3,HEALTH,3058,86,3,13,16,18.8%,2m
16349,2,Spanish,3058,32,2,0,2,100.0%,6m
16349,2,[ILLTE]Secret,3058,0,1,0,1,100.0%,9m
16349,2,[Lowko]rextor,3058,0,1,4,5,20.0%,11m
16349,2,Flint,3058,0,0,1,1,0.0%,9m
16349,2,Bidet,3058,0,0,1,1,0.0%,13m
16349,1,Arise,3058,0,0,3,3,0.0%,3m
16381,3,smak,3057,1523,142,130,272,52.2%,20m
16381,2,Vizoze,3057,1635,123,104,227,54.2%,22m
16381,1,DeFlow,3057,659,107,94,201,53.2%,6m
16381,1,dozko,3057,1683,102,108,210,48.6%,8m
16381,1,[WBO]Bucky,3057,662,20,25,45,44.4%,22m
16381,1,[UnDo]EpidemIcLash,3057,440,12,13,25,48.0%,8m
16381,3,twofinger,3057,319,9,16,25,36.0%,13m
16381,1,CALLE,3057,172,8,8,16,50.0%,14m
16381,1,Andre,3057,124,7,3,10,70.0%,3m
16381,1,storm,3057,259,7,6,13,53.8%,23m
16381,2,QuirkyTurtle,3057,96,6,2,8,75.0%,10m
16381,1,JeReX,3057,171,6,3,9,66.7%,22m
16381,1,Hybrid,3057,230,6,11,17,35.3%,11m
16381,3,VoidKami,3057,42,5,3,8,62.5%,5m
16381,3,Verbludok,3057,141,4,2,6,66.7%,6m
16381,2,subserver,3057,0,3,2,5,60.0%,6m
16381,1,Cervantes,3057,0,3,2,5,60.0%,5m
16381,2,kopi,3057,32,2,0,2,100.0%,7m
16381,1,Retrosics,3057,40,2,3,5,40.0%,10m
16381,2,Kestrel,3057,136,2,3,5,40.0%,56m
16381,1,WotdeFack,3057,0,1,2,3,33.3%,6m
16381,1,Baggier,3057,95,1,3,4,25.0%,13m
16381,3,ZRey,3057,0,1,4,5,20.0%,22m
16381,1,Wave,3057,0,0,3,3,0.0%,18m
16405,3,ArKan,3056,1346,148,150,298,49.7%,18m
16405,3,Nazerot,3056,1259,83,86,169,49.1%,7m
16405,3,BigDaddyPump,3056,1102,61,44,105,58.1%,11m
16405,1,Улькаир,3056,1341,60,44,104,57.7%,3m
16405,1,Ipu,3056,558,35,41,76,46.1%,3m
16405,2,jabba,3056,663,32,24,56,57.1%,18m
16405,1,ColoursGreen,3056,821,29,27,56,51.8%,3m
16405,3,GlutenEbola,3056,486,28,27,55,50.9%,3m
16405,1,[ParGC]Iorg,3056,727,27,20,47,57.4%,4m
16405,1,BlessedG,3056,615,26,25,51,51.0%,6m
16405,1,Kreket,3056,483,19,16,35,54.3%,6m
16405,1,sambademaul,3056,426,16,14,30,53.3%,13m
16405,3,Vibe,3056,255,11,10,21,52.4%,7m
16405,1,Blue,3056,213,9,7,16,56.2%,22m
16405,1,[LeTa]Knigg,3056,181,7,5,12,58.3%,7m
16405,3,MCC,3056,152,7,8,15,46.7%,9m
16405,1,Menelaus,3056,117,6,6,12,50.0%,4m
16405,2,Berkovitz,3056,120,5,0,5,100.0%,19m
16405,3,jASOP,3056,184,5,5,10,50.0%,17m
16405,2,EDOCRAB,3056,119,3,1,4,75.0%,19m
16405,1,Wagnis,3056,30,2,1,3,66.7%,23m
16405,1,PaVLiK,3056,105,2,2,4,50.0%,4m
16405,2,[TWoF]CoolMcGrrr,3056,127,2,2,4,50.0%,7m
16405,2,[Zhig]grimhak,3056,0,1,0,1,100.0%,9m
16405,2,[RGSC2]DeadSky,3056,0,1,0,1,100.0%,19m
16405,1,[Quiz]Forcefield,3056,0,1,1,2,50.0%,9m
16405,1,[300APM]franQ,3056,38,1,6,7,14.3%,4m
16405,2,[PSILO]Kuula,3056,0,0,1,1,0.0%,18m
16405,2,ÜBERLISK,3056,0,0,1,1,0.0%,22m
16405,3,[KGBist]apanfi,3056,0,0,1,1,0.0%,17m
16435,3,IlllIIIlIIII,3055,1595,550,546,1096,50.2%,17m
16435,1,Little,3055,1429,249,240,489,50.9%,13m
16435,3,[2louz]MessaDesBois,3055,1551,145,149,294,49.3%,6m
16435,1,asbachcola,3055,1263,52,43,95,54.7%,6m
16435,1,KhvanVV,3055,411,32,34,66,48.5%,3m
16435,1,BloodRED,3055,645,29,15,44,65.9%,8m
16435,1,benji,3055,567,28,17,45,62.2%,7m
16435,3,[VFN]Helios,3055,429,25,29,54,46.3%,7m
16435,3,tom,3055,458,21,16,37,56.8%,22m
16435,1,[EZDUNK]ChthoniC,3055,306,11,13,24,45.8%,4m
16435,3,[Hivе]maxis,3055,312,10,20,30,33.3%,8m
16435,1,Sagon,3055,282,8,10,18,44.4%,3m
16435,2,[NVY]Zeratul,3055,206,7,6,13,53.8%,8m
16435,1,TehCube,3055,190,7,9,16,43.8%,12m
16435,2,Barry,3055,144,6,2,8,75.0%,19m
16435,1,Peaches,3055,30,5,2,7,71.4%,12m
16435,1,MadMat,3055,112,4,6,10,40.0%,23m
16435,1,millemille,3055,156,4,7,11,36.4%,21m
16435,1,[CHPT]Ackimm,3055,122,4,8,12,33.3%,3m
16435,2,Rekooo,3055,0,1,0,1,100.0%,11m
16435,1,[DraLo]WizarD,3055,0,1,1,2,50.0%,15m
16435,2,[BLAT]WarHog,3055,0,0,1,1,0.0%,21m
16435,1,malkontent,3055,0,0,3,3,0.0%,14m
16458,3,nanooko,3054,1564,279,270,549,50.8%,24m
16458,1,Modaj,3054,1587,124,105,229,54.1%,4m
16458,1,[WMPA]Elronmcbong,3054,883,84,30,114,73.7%,23m
16458,1,Aletheia,3054,1572,75,72,147,51.0%,4m
16458,1,Kirasempai,3054,614,54,43,97,55.7%,18m
16458,3,Elephantos,3054,1346,54,70,124,43.5%,22m
16458,1,Darkns,3054,1059,52,48,100,52.0%,11m
16458,2,NeoSecond,3054,788,29,26,55,52.7%,9m
16458,3,[N8Wrst]Plompo,3054,619,24,24,48,50.0%,6m
16458,1,AmiGO,3054,287,14,6,20,70.0%,19m
16458,1,Szaky,3054,332,14,8,22,63.6%,6m
16458,3,ErSmallTwo,3054,394,14,24,38,36.8%,5m
16458,1,Rolfvector,3054,329,11,11,22,50.0%,5m
16458,3,[BGN]Leifa,3054,356,11,27,38,28.9%,2m
16458,1,[chaton]Aldarande,3054,277,10,7,17,58.8%,3m
16458,3,Gulpen,3054,166,6,19,25,24.0%,12m
16458,1,Shockwave,3054,48,5,2,7,71.4%,41m
16458,1,GOTTA,3054,144,5,6,11,45.5%,4m
16458,2,SCVReady,3054,30,4,2,6,66.7%,22m
16458,2,[Aie]MORO,3054,120,4,3,7,57.1%,17m
16458,1,LuckyZerg,3054,116,4,7,11,36.4%,20m
16458,1,Etern,3054,117,3,3,6,50.0%,19m
16458,1,Moroten,3054,135,3,4,7,42.9%,9m
16458,1,CptObvious,3054,114,3,5,8,37.5%,18m
16458,1,[TETUS]Rel,3054,120,3,7,10,30.0%,23m
16458,3,Lytion,3054,121,3,9,12,25.0%,5m
16458,2,Lightpro,3054,125,2,11,13,15.4%,22m
16458,2,Nyx,3054,30,1,2,3,33.3%,7m
16458,2,[NINJ88]DaZe,3054,0,0,1,1,0.0%,4m
16458,2,[0CNCR]NetRux,3054,0,0,1,1,0.0%,22m
16458,2,GoldWing,3054,0,0,1,1,0.0%,15m
16489,1,SantA,3053,1561,164,150,314,52.2%,19m
16489,3,zozo,3053,1538,146,153,299,48.8%,19m
16489,1,nodelynk,3053,1586,132,102,234,56.4%,20m
16489,1,[WNTBD]drominet,3053,1333,120,112,232,51.7%,21m
16489,2,[AAhbf]Igorash,3053,632,56,69,125,44.8%,13m
16489,3,Grocake,3053,1202,42,47,89,47.2%,2m
16489,1,[Юнион]дмитрий,3053,815,39,35,74,52.7%,10m
16489,1,Tales,3053,448,36,15,51,70.6%,6m
16489,1,ohmy,3053,471,26,24,50,52.0%,3m
16489,1,[DiK]Reggie,3053,732,24,26,50,48.0%,23m
16489,1,Chocoroth,3053,503,21,13,34,61.8%,22m
16489,1,faucheur,3053,340,14,11,25,56.0%,20m
16489,1,[Hаsu]fjfalcon,3053,319,9,8,17,52.9%,22m
16489,1,Jacke,3053,220,7,3,10,70.0%,13m
16489,3,Ira,3053,181,7,4,11,63.6%,43m
16489,1,[mfxed]Zabel,3053,272,7,7,14,50.0%,5m
16489,2,shiranui,3053,130,5,3,8,62.5%,5m
16489,3,Third,3053,164,5,4,9,55.6%,37m
16489,2,TheRedBert,3053,140,4,2,6,66.7%,32m
16489,3,KaeL,3053,0,4,2,6,66.7%,19m
16489,2,kazbek,3053,60,2,1,3,66.7%,11m
16489,2,[TÆR]Orion,3053,0,1,0,1,100.0%,13m
16489,2,NemO,3053,0,1,0,1,100.0%,21m
16489,2,[Exis]Кастиил,3053,32,1,1,2,50.0%,11m
16489,1,SokZ,3053,0,1,2,3,33.3%,23m
16489,1,pscintio,3053,0,1,2,3,33.3%,10m
16489,1,Sitri,3053,0,1,2,3,33.3%,18m
16489,1,Crevettozor,3053,38,1,5,6,16.7%,14m
16489,2,mixer,3053,0,0,1,1,0.0%,9m
16489,1,Sparkless,3053,0,0,3,3,0.0%,21m
16519,3,PapaB,3052,1513,105,104,209,50.2%,12m
16519,1,КИРИЛЛ,3052,1469,103,86,189,54.5%,22m
16519,2,EnTaroZagara,3052,1022,63,8,71,88.7%,7m
16519,1,leMaître,3052,1147,47,29,76,61.8%,18m
16519,3,Palpatine,3052,306,40,47,87,46.0%,12m
16519,3,StarLord,3052,759,25,35,60,41.7%,5m
16519,1,[HighOP]GIGENO,3052,485,18,14,32,56.2%,9m
16519,1,Thomsing,3052,434,16,17,33,48.5%,19m
16519,2,[DLM12]Belardo,3052,244,9,8,17,52.9%,7m
16519,1,[ValidG]Mirko,3052,240,8,6,14,57.1%,9m
16519,3,Naum,3052,170,8,8,16,50.0%,9m
16519,2,Highway,3052,120,5,1,6,83.3%,18m
16519,2,Septimus,3052,0,4,1,5,80.0%,7m
16519,2,HeX,3052,0,3,2,5,60.0%,23m
16519,1,Morantista,3052,38,2,2,4,50.0%,10m
16519,2,pretender,3052,0,1,0,1,100.0%,6m
16519,2,Zed,3052,0,1,0,1,100.0%,7m
16519,2,Bedri,3052,32,1,1,2,50.0%,11m
16519,1,[mTn]lyintometa,3052,0,1,2,3,33.3%,4m
16519,1,SALOMERO,3052,0,1,2,3,33.3%,9m
16519,1,[JSC]MightyBeast,3052,0,1,3,4,25.0%,3m
16540,3,Archs,3051,1547,85,90,175,48.6%,11m
16540,3,Naapukka,3051,1038,72,54,126,57.1%,19m
16540,1,StarLight,3051,1301,58,52,110,52.7%,15m
16540,1,[ANCST2]Дракончик,3051,1311,53,45,98,54.1%,6m
16540,1,[KTFsC]mVmMycenaean,3051,726,31,25,56,55.4%,12m
16540,1,belion,3051,909,30,29,59,50.8%,13m
16540,2,LaSuze,3051,780,28,28,56,50.0%,21m
16540,2,BaGGaMaN,3051,703,27,22,49,55.1%,19m
16540,1,Shturman,3051,618,19,24,43,44.2%,6m
16540,1,[OBY]Captainflute,3051,358,11,13,24,45.8%,10m
16540,1,[Thána]Fracture,3051,228,10,7,17,58.8%,21m
16540,2,AXTI,3051,126,6,1,7,85.7%,21m
16540,1,Koldun,3051,216,6,10,16,37.5%,19m
16540,2,MaayongPasko,3051,129,5,3,8,62.5%,12m
16540,1,[LMOO]Doozy,3051,154,5,6,11,45.5%,10m
16540,1,[ALGII]QIZA,3051,0,4,1,5,80.0%,49m
16540,1,ubivalo,3051,137,4,2,6,66.7%,22m
16540,1,[SC2TIM]Tricks,3051,0,4,2,6,66.7%,18m
16540,3,aavado,3051,97,4,3,7,57.1%,50m
16540,1,Saravigote,3051,140,4,6,10,40.0%,5m
16540,2,[Axolot]Yosuke,3051,0,3,2,5,60.0%,3m
16540,1,[SТAR]LoganRU,3051,78,3,4,7,42.9%,23m
16540,1,SpinweB,3051,104,3,9,12,25.0%,4m
16540,1,birchi,3051,59,2,4,6,33.3%,7m
16540,1,yarmo,3051,109,1,4,5,20.0%,12m
16540,1,[Bü]greenmixer,3051,0,1,4,5,20.0%,15m
16540,2,Макс,3051,0,0,1,1,0.0%,22m
16567,1,[Wuf]faulwurf,3050,1688,234,222,456,51.3%,14m
16567,3,dktk,3050,1439,170,172,342,49.7%,7m
16567,3,LakaY,3050,1560,139,149,288,48.3%,7m
16567,1,darknoob,3050,1697,92,83,175,52.6%,8m
16567,1,EchoSierra,3050,809,75,54,129,58.1%,10m
16567,2,idaniel,3050,1452,61,50,111,55.0%,23m
16567,1,NasH,3050,402,57,62,119,47.9%,18m
16567,1,Kachrabi,3050,611,46,47,93,49.5%,19m
16567,3,[BJuF]Kerrigan,3050,1239,45,49,94,47.9%,14m
16567,1,Skretsch,3050,849,41,39,80,51.2%,18m
16567,1,Europa,3050,936,33,35,68,48.5%,18m
16567,1,[1NFEC7]Tilloss,3050,693,27,19,46,58.7%,2m
16567,1,ProNoob,3050,537,17,17,34,50.0%,5m
16567,1,ipxZerg,3050,313,13,7,20,65.0%,14m
16567,3,KRATOS,3050,157,8,5,13,61.5%,7m
16567,2,[fackme]turbo,3050,207,7,1,8,87.5%,15m
16567,3,[Turtlz]ILeSeveNI,3050,140,6,12,18,33.3%,22m
16567,1,[BULD0G]KalmeCavia,3050,200,5,3,8,62.5%,20m
16567,1,[Oggy]Whirligig,3050,0,4,1,5,80.0%,21m
16567,1,Geisterhund,3050,0,4,1,5,80.0%,1h
16567,2,Slawsh,3050,30,4,2,6,66.7%,10m
16567,1,DimON,3050,104,3,1,4,75.0%,12m
16567,1,xessi,3050,136,3,6,9,33.3%,18m
16567,3,xFlake,3050,144,3,11,14,21.4%,23m
16567,1,Gansgeil,3050,0,2,3,5,40.0%,1h
16567,2,STORM,3050,0,2,3,5,40.0%,22m
16567,3,Shakes,3050,88,1,1,2,50.0%,20m
16567,3,Klomoton,3050,0,1,2,3,33.3%,14m
16567,2,[CHOPAA]Lipton,3050,0,0,1,1,0.0%,5m
16567,2,DoctorWho,3050,0,0,1,1,0.0%,15m
16567,1,[LQV]Mike,3050,0,0,2,2,0.0%,6m
16567,1,[GGBENQ]Boniasty,3050,0,0,2,2,0.0%,22m
16567,1,[Sahut]Nephylie,3050,0,0,4,4,0.0%,13m
16600,3,[Kingz]Rush,3049,801,122,111,233,52.4%,9m
16600,3,[QTcIub]Zare,3049,902,71,77,148,48.0%,10m
16600,1,Schmandini,3049,1067,39,36,75,52.0%,9m
16600,1,Picsou,3049,406,32,31,63,50.8%,7m
16600,2,Sem,3049,619,25,15,40,62.5%,22m
16600,2,WalterWhite,3049,461,19,13,32,59.4%,8m
16600,1,Yoann,3049,336,13,7,20,65.0%,6m
16600,3,Arkanis,3049,247,9,3,12,75.0%,22m
16600,2,Pincho,3049,232,9,4,13,69.2%,21m
16600,2,HighNoK,3049,144,8,9,17,47.1%,7m
16600,1,SvenRedBeard,3049,145,5,2,7,71.4%,18m
16600,1,Runner,3049,183,5,5,10,50.0%,6m
16600,2,Callum,3049,30,4,2,6,66.7%,4m
16600,3,snowpea,3049,97,4,3,7,57.1%,60m
16600,2,[üPol]Tittebie,3049,96,4,4,8,50.0%,54m
16600,1,arbidol,3049,0,3,2,5,60.0%,4m
16600,2,mileff,3049,32,2,0,2,100.0%,21m
16600,1,[JJAQ]DARK,3049,124,2,4,6,33.3%,8m
16600,2,[УВЦ]Alcatraz,3049,0,1,0,1,100.0%,12m
16600,2,Badoodle,3049,30,1,2,3,33.3%,11m
16600,2,eMiLka,3049,0,0,1,1,0.0%,12m
16621,3,roguebee,3048,1365,182,188,370,49.2%,11m
16621,1,krapula,3048,1708,181,170,351,51.6%,19m
16621,1,Martinii,3048,1637,135,122,257,52.5%,6m
16621,1,Untake,3048,1703,91,86,177,51.4%,8m
16621,3,MinDark,3048,1337,65,70,135,48.1%,14m
16621,3,Heavyburger,3048,488,51,46,97,52.6%,20m
16621,1,LCOD,3048,982,41,37,78,52.6%,10m
16621,1,[TuuT]KRaNK,3048,197,21,15,36,58.3%,3m
16621,3,SoloTurk,3048,454,16,22,38,42.1%,22m
16621,1,ERPNWhYTeX,3048,474,15,17,32,46.9%,5m
16621,1,[BYOS]Phobos,3048,282,10,3,13,76.9%,49m
16621,1,[Keile]Garathakk,3048,329,9,12,21,42.9%,7m
16621,2,ImL,3048,220,8,4,12,66.7%,11m
16621,2,StatsIsBest,3048,150,6,0,6,100.0%,17m
16621,1,GotLost,3048,175,5,4,9,55.6%,21m
16621,3,[DrkLy]Solrac,3048,0,4,3,7,57.1%,22m
16621,2,MechGodAvilo,3048,97,4,4,8,50.0%,32m
16621,3,secilian,3048,128,4,14,18,22.2%,7m
16621,2,[Маньяк]KoshmarBRO,3048,18,2,0,2,100.0%,19m
16621,3,Умеренность,3048,96,2,1,3,66.7%,14m
16621,1,Makc,3048,34,2,2,4,50.0%,24m
16621,2,Gordon,3048,60,2,3,5,40.0%,23m
16621,2,Bean,3048,0,1,0,1,100.0%,15m
16621,2,ТопДэк,3048,0,1,0,1,100.0%,10m
16621,2,RagingPheno,3048,0,1,0,1,100.0%,21m
16621,1,[MiMs]DJSK,3048,0,1,2,3,33.3%,22m
16621,2,Belthingol,3048,0,0,1,1,0.0%,11m
16621,2,[MoopyS]david,3048,0,0,1,1,0.0%,20m
16649,1,unknown,3047,1372,149,135,284,52.5%,11m
16649,1,Dude,3047,1151,42,34,76,55.3%,22m
16649,1,EvolutioN,3047,698,24,23,47,51.1%,13m
16649,2,[rere01]GasTinhaha,3047,214,8,1,9,88.9%,22m
16649,2,Arkfly,3047,174,6,3,9,66.7%,10m
16649,1,Speedy,3047,192,6,8,14,42.9%,13m
16649,3,ForZion,3047,0,4,2,6,66.7%,54m
16649,2,ALHK,3047,0,3,2,5,60.0%,19m
16649,1,chaika,3047,0,3,2,5,60.0%,1h
16649,2,[OPFAR]Leviathan,3047,64,2,1,3,66.7%,18m
16649,1,Aloura,3047,90,2,5,7,28.6%,19m
16649,1,Tonio,3047,0,1,1,2,50.0%,20m
16649,1,Diza,3047,0,1,1,2,50.0%,10m
16649,2,[T3ars]JuppiJuppsen,3047,0,0,1,1,0.0%,4m
16649,2,Linuel,3047,0,0,1,1,0.0%,11m
16664,3,Maxmager,3046,1566,119,107,226,52.7%,3m
16664,1,новичок,3046,1632,93,81,174,53.4%,22m
16664,2,[F3cK]CrazyMarine,3046,1636,82,51,133,61.7%,17m
16664,1,KELT,3046,1483,66,66,132,50.0%,13m
16664,2,[CrBees]Fighter,3046,1374,52,52,104,50.0%,8m
16664,1,Ziptos,3046,664,38,30,68,55.9%,10m
16664,2,[3ЕRGTV]xxxFuSiOnxxx,3046,853,34,30,64,53.1%,7m
16664,3,hypzo,3046,338,26,42,68,38.2%,14m
16664,1,[EliteX]Romanoos,3046,552,25,22,47,53.2%,6m
16664,1,Tay,3046,441,17,12,29,58.6%,10m
16664,2,Cookieisalie,3046,257,11,7,18,61.1%,23m
16664,1,Linteros,3046,118,8,8,16,50.0%,1h
16664,2,[инж]RaDy,3046,88,3,2,5,60.0%,18m
16664,1,spongebob,3046,48,2,0,2,100.0%,16m
16664,1,marmalad,3046,0,2,0,2,100.0%,27m
16664,1,[ETU]imbaZK,3046,102,2,3,5,40.0%,22m
16664,2,[PiGPan]MrPindour,3046,0,1,0,1,100.0%,7m
16664,2,Cadavérix,3046,0,1,0,1,100.0%,11m
16664,2,Jabper,3046,0,0,1,1,0.0%,22m
16664,1,Raion,3046,0,0,3,3,0.0%,45m
16664,1,balbezsss,3046,0,0,8,8,0.0%,22m
16685,1,Ludvik,3045,1715,129,124,253,51.0%,19m
16685,2,[Wick]Pekl,3045,1267,76,52,128,59.4%,15m
16685,1,[αX]Shohei,3045,905,52,48,100,52.0%,22m
16685,1,Neveziah,3045,1169,48,40,88,54.5%,21m
16685,1,Argy,3045,1195,43,41,84,51.2%,4m
16685,1,Romchester,3045,536,42,41,83,50.6%,10m
16685,1,[GaMas]Slepoi,3045,977,36,36,72,50.0%,8m
16685,1,Jigslol,3045,438,23,6,29,79.3%,13m
16685,3,Wurstbonbon,3045,321,14,10,24,58.3%,20m
16685,1,[013NL]XilleVe,3045,490,14,17,31,45.2%,5m
16685,1,Gorre,3045,368,11,13,24,45.8%,19m
16685,3,Maximus,3045,183,6,3,9,66.7%,11m
16685,3,[PTWTM]Kiwave,3045,162,5,0,5,100.0%,43m
16685,1,xxxNARUTOxxx,3045,113,3,2,5,60.0%,5m
16685,2,Cryptum,3045,30,2,1,3,66.7%,21m
16685,1,Asteroid,3045,0,2,3,5,40.0%,52m
16685,1,wiQed,3045,38,2,7,9,22.2%,22m
16685,2,Kaukatsu,3045,0,1,0,1,100.0%,4m
16685,1,Lightman,3045,0,1,1,2,50.0%,33m
16685,2,[UoSSR]Yorick,3045,0,0,1,1,0.0%,7m
16705,1,Satisfy,3044,1420,72,54,126,57.1%,4m
16705,1,MiniMaus,3044,893,64,51,115,55.7%,18m
16705,2,mikey,3044,580,31,6,37,83.8%,11m
16705,2,[Bure]klicken,3044,231,22,15,37,59.5%,22m
16705,3,[KGens]IgnisGelidus,3044,663,22,30,52,42.3%,23m
16705,2,GreatToss,3044,534,19,19,38,50.0%,9m
16705,1,LimeDealer,3044,351,16,10,26,61.5%,5m
16705,3,[ToXIK]LeMarquis,3044,392,13,22,35,37.1%,6m
16705,2,PowerCrab,3044,331,12,10,22,54.5%,7m
16705,2,LemonBoy,3044,216,11,7,18,61.1%,6m
16705,1,CryZe,3044,267,10,8,18,55.6%,3m
16705,2,FrittenPaul,3044,191,9,5,14,64.3%,1h
16705,2,[NIARBI]Niarbitchkov,3044,280,9,8,17,52.9%,3m
16705,3,Booya,3044,114,7,5,12,58.3%,30m
16705,1,Scalzofedda,3044,161,7,6,13,53.8%,20m
16705,2,Green,3044,88,6,4,10,60.0%,7m
16705,3,encaputxat,3044,91,5,3,8,62.5%,7m
16705,3,llllllllllll,3044,121,5,3,8,62.5%,43m
16705,3,Ышка,3044,121,5,3,8,62.5%,39m
16705,1,[DeepT]sanconiglio,3044,106,4,7,11,36.4%,9m
16705,2,ODG,3044,0,3,2,5,60.0%,17m
16705,1,Tallec,3044,48,2,5,7,28.6%,43m
16705,1,[GGZERG]StarDefender,3044,78,2,9,11,18.2%,4m
16705,2,[swann]eltaiger,3044,0,0,1,1,0.0%,4m
16729,3,cJIoHuKu,3043,1500,170,161,331,51.4%,22m
16729,3,[D6AA]niks,3043,1272,142,128,270,52.6%,23m
16729,3,Bandit,3043,1475,114,109,223,51.1%,14m
16729,1,noxan,3043,1323,106,105,211,50.2%,10m
16729,1,[StaTo]Merphidros,3043,604,81,66,147,55.1%,23m
16729,1,[CS0]keretapir,3043,1348,80,79,159,50.3%,8m
16729,1,PlayerONE,3043,1542,78,65,143,54.5%,6m
16729,2,IIIIIIIIIIII,3043,1110,47,35,82,57.3%,8m
16729,1,Blossom,3043,963,38,31,69,55.1%,19m
16729,1,WildWolf,3043,749,35,36,71,49.3%,20m
16729,2,captainCrazy,3043,556,22,13,35,62.9%,10m
16729,1,Abbe,3043,542,20,20,40,50.0%,14m
16729,1,[PGCom]Cyberrevo,3043,242,16,11,27,59.3%,15m
16729,1,Tzeench,3043,373,15,12,27,55.6%,21m
16729,2,theconkerer,3043,320,13,12,25,52.0%,3m
16729,3,IIIIIIIIIIII,3043,357,13,17,30,43.3%,4m
16729,1,Mokuton,3043,410,12,17,29,41.4%,13m
16729,2,Deskariot,3043,186,7,0,7,100.0%,17m
16729,1,Claude,3043,145,7,2,9,77.8%,11m
16729,1,[PiMoK]STONEDzealot,3043,196,6,9,15,40.0%,22m
16729,3,IIIIIIIIIIII,3043,0,5,1,6,83.3%,33m
16729,3,Laure,3043,0,5,1,6,83.3%,12m
16729,1,Majky,3043,145,3,1,4,75.0%,46m
16729,2,Acolyte,3043,30,3,4,7,42.9%,21m
16729,1,StormInWorld,3043,82,3,5,8,37.5%,7m
16729,3,Siguru,3043,98,3,14,17,17.6%,20m
16729,1,Prozac,3043,88,2,1,3,66.7%,23m
16729,2,[FROG12]speedfox,3043,18,2,1,3,66.7%,7m
16729,3,Ashiroftw,3043,0,2,4,6,33.3%,25m
16729,1,StanyslassZ,3043,78,2,9,11,18.2%,14m
16729,2,[Nyde]Loke,3043,0,1,0,1,100.0%,21m
16729,2,caicaiko,3043,30,1,2,3,33.3%,9m
16729,2,Motór,3043,0,0,1,1,0.0%,7m
16729,1,Saber,3043,0,0,1,1,0.0%,12m
16729,2,[LGNDǂ]EarEngineer,3043,0,0,1,1,0.0%,13m
16764,3,саша,3042,1604,266,272,538,49.4%,9m
16764,3,sontor,3042,1424,84,94,178,47.2%,23m
16764,1,Veyer,3042,978,80,73,153,52.3%,3m
16764,1,qvunteks,3042,1065,56,44,100,56.0%,13m
16764,2,llisusferis,3042,1118,44,41,85,51.8%,22m
16764,1,[LegVI]Geocze,3042,1164,39,44,83,47.0%,11m
16764,2,Awe,3042,555,32,4,36,88.9%,17m
16764,2,POL,3042,658,26,18,44,59.1%,13m
16764,1,Elyjax,3042,456,21,16,37,56.8%,22m
16764,2,Alximikkk,3042,526,20,14,34,58.8%,12m
16764,1,ShutUp,3042,420,19,9,28,67.9%,9m
16764,1,Negod,3042,523,18,15,33,54.5%,9m
16764,3,ITZY,3042,506,17,28,45,37.8%,22m
16764,1,Tredecies,3042,379,15,16,31,48.4%,22m
16764,1,Alex,3042,281,12,7,19,63.2%,5m
16764,2,Bamtox,3042,324,11,10,21,52.4%,19m
16764,1,snezhok,3042,375,11,12,23,47.8%,3m
16764,2,Midmad,3042,146,5,4,9,55.6%,11m
16764,1,bouncybear,3042,135,4,3,7,57.1%,22m
16764,2,BigOne,3042,41,4,3,7,57.1%,10m
16764,1,RukPro,3042,141,3,4,7,42.9%,5m
16764,1,Saryon,3042,40,2,6,8,25.0%,3m
16764,1,[Yolo69]Chmielik,3042,0,1,4,5,20.0%,50m
16764,1,Martinus,3042,38,1,4,5,20.0%,3m
16764,1,[EEMA]Yahann,3042,0,0,1,1,0.0%,49m
16764,2,LazySnail,3042,0,0,1,1,0.0%,6m
16790,3,[TNSR]Recuperate,3041,1538,212,215,427,49.6%,18m
16790,1,Nerdatron,3041,1536,114,101,215,53.0%,4m
16790,1,IoIoIoI,3041,1236,42,44,86,48.8%,23m
16790,1,JuiceKeg,3041,907,38,37,75,50.7%,5m
16790,1,[FFFFFg]Kaldery,3041,669,29,26,55,52.7%,21m
16790,1,Sinoby,3041,679,24,23,47,51.1%,6m
16790,1,[Dronez]HZtaj,3041,350,14,11,25,56.0%,22m
16790,2,IIIIIIIIIIII,3041,318,12,5,17,70.6%,19m
16790,1,Fiif,3041,320,9,9,18,50.0%,28m
16790,2,WarlordWay,3041,62,3,1,4,75.0%,20m
16790,3,YuFool,3041,97,2,4,6,33.3%,38m
16790,1,trooper,3041,0,2,4,6,33.3%,6m
16790,2,[PGPOOL]VOVA,3041,0,0,2,2,0.0%,7m
16803,3,ThePuppeteer,3040,1592,220,216,436,50.5%,22m
16803,3,ALDOR,3040,1572,161,169,330,48.8%,14m
16803,3,AGDeAdLy,3040,1511,92,99,191,48.2%,12m
16803,3,LIGHT,3040,1135,65,66,131,49.6%,20m
16803,1,[F1N]Barracuda,3040,971,51,49,100,51.0%,8m
16803,2,Psychrolutes,3040,1235,50,43,93,53.8%,11m
16803,3,qoi,3040,301,31,27,58,53.4%,5m
16803,2,Bugrahan,3040,696,25,24,49,51.0%,15m
16803,1,[SRMC]Beskjorty,3040,560,24,18,42,57.1%,3m
16803,1,жёлтыйлист,3040,642,22,20,42,52.4%,19m
16803,1,AlY,3040,702,22,23,45,48.9%,3m
16803,2,Enguerrand,3040,554,20,17,37,54.1%,6m
16803,2,[AMFs]AlY,3040,546,20,18,38,52.6%,11m
16803,1,CoolBird,3040,566,17,21,38,44.7%,19m
16803,2,[T0RBA]spujb,3040,178,9,6,15,60.0%,6m
16803,3,PIER,3040,135,9,14,23,39.1%,21m
16803,1,luckman,3040,246,8,9,17,47.1%,6m
16803,2,MaKC,3040,230,7,2,9,77.8%,2m
16803,1,Akira,3040,186,6,7,13,46.2%,7m
16803,2,[Z1L]Ziltoid,3040,120,5,1,6,83.3%,24m
16803,1,[TePt]Lukas,3040,0,4,3,7,57.1%,4m
16803,2,Наука,3040,132,4,4,8,50.0%,18m
16803,1,Cozercatel,3040,108,3,5,8,37.5%,4m
16803,2,Kamalalala,3040,93,2,0,2,100.0%,7m
16803,1,destroer,3040,36,2,3,5,40.0%,18m
16803,2,SlayerSBoxeR,3040,46,1,5,6,16.7%,53m
16803,1,[NopEr]Zdendice,3040,0,0,1,1,0.0%,46m
16803,2,Reptael,3040,0,0,1,1,0.0%,22m
16831,3,TrashPanda,3039,1578,156,166,322,48.4%,7m
16831,1,ArganuM,3039,1201,52,41,93,55.9%,6m
16831,3,nyugizsuzsa,3039,753,37,38,75,49.3%,12m
16831,1,[Tranc3]DuDa,3039,471,33,21,54,61.1%,18m
16831,2,DarkShiado,3039,591,23,15,38,60.5%,9m
16831,2,[BEL]KingOrion,3039,589,22,18,40,55.0%,21m
16831,1,AntiCarnist,3039,453,16,16,32,50.0%,3m
16831,2,Marso,3039,402,15,13,28,53.6%,18m
16831,2,Prometey,3039,422,14,14,28,50.0%,21m
16831,2,[MDOH]Atelect,3039,114,4,2,6,66.7%,4m
16831,1,Jupiter,3039,97,4,2,6,66.7%,14m
16831,1,Spork,3039,114,3,8,11,27.3%,3m
16831,3,[Kompis]KALLINZOOOR,3039,122,2,3,5,40.0%,1h
16831,1,Alice,3039,42,2,6,8,25.0%,8m
16831,2,[NOOBpl]Blineq,3039,0,1,0,1,100.0%,9m
16831,1,Cosmologist,3039,91,1,3,4,25.0%,4m
16831,2,Vinci,3039,40,1,3,4,25.0%,10m
16831,1,JohnyKusH,3039,0,1,5,6,16.7%,19m
16831,1,Keuwa,3039,0,1,5,6,16.7%,16m
16831,2,Amaterasu,3039,0,0,2,2,0.0%,22m
16851,1,burakcosk,3038,1697,173,159,332,52.1%,18m
16851,1,Rawfodog,3038,1621,73,61,134,54.5%,19m
16851,1,BerserkerVX,3038,511,53,48,101,52.5%,22m
16851,1,[ZЕRGTV]Quant,3038,576,25,21,46,54.3%,19m
16851,1,iosa,3038,495,21,16,37,56.8%,23m
16851,1,dreaded,3038,656,21,27,48,43.8%,21m
16851,2,Уарабейъ,3038,370,14,13,27,51.9%,21m
16851,2,Music,3038,210,6,1,7,85.7%,20m
16851,3,Sairon,3038,164,6,3,9,66.7%,33m
16851,1,David,3038,166,6,7,13,46.2%,19m
16851,1,Luke,3038,188,6,10,16,37.5%,7m
16851,2,Mewtwo,3038,88,5,1,6,83.3%,7m
16851,1,Rafoboy,3038,114,4,9,13,30.8%,10m
16851,2,KuroudO,3038,0,3,2,5,60.0%,7m
16851,2,[Pédoss]Papyragorn,3038,88,2,6,8,25.0%,31m
16851,1,Alatriste,3038,0,0,4,4,0.0%,5m
16851,2,corea,3038,0,0,5,5,0.0%,21m
16868,1,[Heroes]CrashDragon,3037,1607,82,80,162,50.6%,8m
16868,3,Niko,3037,1414,50,62,112,44.6%,7m
16868,2,Greengo,3037,1206,45,42,87,51.7%,22m
16868,3,Hrothgar,3037,823,36,38,74,48.6%,8m
16868,3,EvulGoyim,3037,986,36,42,78,46.2%,18m
16868,1,IIIIIIIIIIII,3037,898,33,29,62,53.2%,4m
16868,2,[Heroes]WarpNate,3037,594,27,13,40,67.5%,18m
16868,2,GamePubertje,3037,640,25,17,42,59.5%,13m
16868,1,Tkitwa,3037,729,25,22,47,53.2%,14m
16868,1,CuiCui,3037,493,23,13,36,63.9%,6m
16868,1,Desh,3037,503,22,15,37,59.5%,14m
16868,3,SuperMango,3037,378,21,23,44,47.7%,3m
16868,3,Ebukentiy,3037,624,21,28,49,42.9%,3m
16868,1,Fugiel,3037,444,16,15,31,51.6%,21m
16868,3,Predicate,3037,353,16,17,33,48.5%,5m
16868,3,yoren,3037,306,13,10,23,56.5%,14m
16868,1,Onti,3037,193,4,6,10,40.0%,14m
16868,1,[IngTec]Meister,3037,158,4,7,11,36.4%,4m
16868,3,prOpPMS,3037,0,3,3,6,50.0%,49m
16868,1,DeadLove,3037,72,2,10,12,16.7%,4m
16868,2,StunLight,3037,0,1,0,1,100.0%,6m
16868,2,BigLupu,3037,0,1,0,1,100.0%,10m
16868,3,Spencer,3037,0,1,1,2,50.0%,17m
16868,1,eXtaZz,3037,0,1,1,2,50.0%,2m
16868,2,VOVAINUA,3037,0,0,1,1,0.0%,6m
16893,3,BlackTurban,3036,1459,231,231,462,50.0%,6m
16893,1,CultOfThree,3036,1717,204,203,407,50.1%,18m
16893,1,TOMAZI,3036,1701,161,152,313,51.4%,3m
16893,1,Puravida,3036,1512,92,73,165,55.8%,4m
16893,2,[fffs]Kerrah,3036,1366,79,67,146,54.1%,17m
16893,1,jakzer,3036,939,44,42,86,51.2%,14m
16893,3,Jarvink,3036,582,24,29,53,45.3%,5m
16893,1,[AKD2]boozibooz,3036,490,20,17,37,54.1%,11m
16893,3,Dfakla,3036,332,12,19,31,38.7%,15m
16893,1,SiMkE,3036,211,10,7,17,58.8%,19m
16893,1,Pyszczak,3036,278,9,12,21,42.9%,7m
16893,2,Moi,3036,122,5,2,7,71.4%,15m
16893,2,IdentyD,3036,122,5,3,8,62.5%,21m
16893,1,Stirrer,3036,159,5,7,12,41.7%,19m
16893,1,Kirasin,3036,0,4,1,5,80.0%,42m
16893,2,Thanth,3036,88,4,4,8,50.0%,9m
16893,2,Attcyka,3036,92,3,1,4,75.0%,9m
16893,2,[SlayAP]Iceri,3036,0,2,3,5,40.0%,7m
16893,1,Pepperoni,3036,102,2,3,5,40.0%,3m
16893,1,Nexoneall,3036,0,1,3,4,25.0%,24m
16893,2,AlieNSdL,3036,0,0,1,1,0.0%,15m
16914,1,zeot,3035,1459,236,219,455,51.9%,10m
16914,2,OneStepClosr,3035,1499,111,105,216,51.4%,17m
16914,1,krivel,3035,1131,70,64,134,52.2%,10m
16914,1,kingofmeow,3035,1617,64,57,121,52.9%,6m
16914,1,eLodiN,3035,1032,52,54,106,49.1%,18m
16914,2,Cookie,3035,1224,51,36,87,58.6%,9m
16914,1,iiiiiiiiiiii,3035,1247,46,44,90,51.1%,4m
16914,3,BICHO,3035,1024,37,54,91,40.7%,4m
16914,2,[ligma]DarthVader,3035,938,34,36,70,48.6%,10m
16914,1,Jack,3035,634,25,22,47,53.2%,4m
16914,1,DawidPL,3035,541,23,15,38,60.5%,8m
16914,1,[DieWG]Wiz,3035,567,20,16,36,55.6%,21m
16914,1,[Kicx]Guizzo,3035,546,17,20,37,45.9%,18m
16914,1,BuffaloDan,3035,370,16,12,28,57.1%,6m
16914,2,[espHB]Bang,3035,390,16,13,29,55.2%,24m
16914,3,Distrobird,3035,128,15,7,22,68.2%,12m
16914,2,[GTMNG]FroZeN,3035,302,12,7,19,63.2%,23m
16914,1,XueHaTa,3035,361,12,10,22,54.5%,10m
16914,2,popoye,3035,226,9,8,17,52.9%,10m
16914,3,[SOoOo]XtincT,3035,117,3,1,4,75.0%,24m
16914,2,Pakowa,3035,0,3,2,5,60.0%,22m
16914,2,XTR,3035,58,2,3,5,40.0%,9m
16914,2,[H0C]Zëäl,3035,0,1,0,1,100.0%,22m
16914,2,MalcomWho,3035,0,1,0,1,100.0%,23m
16914,2,Elmosasaurio,3035,32,1,1,2,50.0%,23m
16914,2,[CL0wnZ]VOLODIAGARAJ,3035,89,1,6,7,14.3%,12m
16914,2,[SAWR]Lizard,3035,0,0,1,1,0.0%,18m
16914,1,[MST]Treegem,3035,0,0,4,4,0.0%,13m
16942,2,Rodin,3034,1632,181,172,353,51.3%,17m
16942,3,GotDamnIt,3034,1531,171,163,334,51.2%,10m
16942,3,Lasileuka,3034,653,111,112,223,49.8%,3m
16942,2,[tagNCT]FaceHugger,3034,672,62,48,110,56.4%,22m
16942,1,[WWF]Wicked,3034,908,56,52,108,51.9%,9m
16942,2,[PoR]MysticLuna,3034,851,33,28,61,54.1%,21m
16942,1,verden,3034,667,31,35,66,47.0%,22m
16942,3,[ĦĦ]PositivDeath,3034,768,29,38,67,43.3%,21m
16942,2,goliath,3034,720,27,24,51,52.9%,10m
16942,1,RagingPixels,3034,672,25,17,42,59.5%,13m
16942,1,DeathNote,3034,696,25,22,47,53.2%,6m
16942,2,HALK,3034,416,20,9,29,69.0%,24m
16942,3,Ramazar,3034,584,20,31,51,39.2%,21m
16942,2,Alex,3034,464,19,15,34,55.9%,18m
16942,2,Burgie,3034,422,16,13,29,55.2%,6m
16942,1,qinyme,3034,356,15,10,25,60.0%,13m
16942,1,Chief,3034,347,14,13,27,51.9%,7m
16942,2,Jobatt,3034,281,13,4,17,76.5%,12m
16942,2,[ToXin]SternJumper,3034,190,8,5,13,61.5%,4m
16942,2,[Penza]regar,3034,178,7,2,9,77.8%,9m
16942,3,Talby,3034,94,4,11,15,26.7%,6m
16942,2,[SCiE]LEOKA,3034,0,3,2,5,60.0%,7m
16942,2,Mulecki,3034,94,3,5,8,37.5%,6m
16942,3,Minos,3034,121,2,3,5,40.0%,19m
16942,2,[УТочка]mangyko,3034,0,1,0,1,100.0%,9m
16942,1,[LEDS]Spartan,3034,0,1,1,2,50.0%,28m
16942,2,nimokil,3034,0,1,1,2,50.0%,9m
16942,2,QuakeII,3034,0,1,4,5,20.0%,15m
16942,1,DrunkCat,3034,93,1,6,7,14.3%,6m
16942,1,Insomnia,3034,40,1,8,9,11.1%,23m
16942,2,[AISC]Takefear,3034,0,0,1,1,0.0%,21m
16942,2,[DKSCII]Akerus,3034,0,0,1,1,0.0%,7m
16974,3,[PxHw]opisska,3033,1549,82,92,174,47.1%,22m
16974,1,CrazyBeaver,3033,763,80,71,151,53.0%,10m
16974,1,Branco,3033,1555,75,76,151,49.7%,10m
16974,1,dffct,3033,1479,63,44,107,58.9%,18m
16974,1,crazycorn,3033,1319,56,35,91,61.5%,6m
16974,3,Darkfuri,3033,330,42,52,94,44.7%,10m
16974,3,Pumba,3033,604,36,46,82,43.9%,7m
16974,2,TeamHoneyBee,3033,662,27,14,41,65.9%,8m
16974,1,PavlovsDog,3033,424,24,5,29,82.8%,4m
16974,1,Gasan,3033,573,21,19,40,52.5%,22m
16974,2,[oooboy]black,3033,400,14,13,27,51.9%,6m
16974,3,[13NRV]Fear,3033,326,11,22,33,33.3%,9m
16974,2,Ootheca,3033,265,10,3,13,76.9%,18m
16974,1,Tukaram,3033,290,8,10,18,44.4%,4m
16974,2,Hizashik,3033,194,7,3,10,70.0%,21m
16974,2,Oleg,3033,206,7,5,12,58.3%,21m
16974,2,[Kripta]САФАРИ,3033,170,6,5,11,54.5%,7m
16974,1,Elvilas,3033,102,5,3,8,62.5%,6m
16974,3,ckroxx,3033,160,5,23,28,17.9%,22m
16974,1,naikEn,3033,167,4,6,10,40.0%,4m
16974,2,[CZxX]Mishicale,3033,0,3,2,5,60.0%,3m
16974,1,ShiningLazer,3033,0,3,3,6,50.0%,4m
16974,1,[BUFUnl]DancingApe,3033,110,3,7,10,30.0%,14m
16974,2,[DTSUA]Petro,3033,30,2,1,3,66.7%,7m
16974,2,Favorit,3033,0,1,0,1,100.0%,18m
16974,1,[ADONIS]servus,3033,89,1,2,3,33.3%,23m
16974,2,SAS,3033,0,0,1,1,0.0%,23m
16974,2,[GoldM]Stehlify,3033,0,0,1,1,0.0%,21m
16974,2,Jonsey,3033,0,0,1,1,0.0%,21m
16974,1,[gscept]Clairvoyant,3033,0,0,2,2,0.0%,3m
16974,2,МастерЛу,3033,0,0,2,2,0.0%,7m
16974,3,Eichizen,3033,0,0,2,2,0.0%,4m
17006,3,SYSERROR,3032,912,211,211,422,50.0%,13m
17006,1,UndeadR,3032,1562,172,164,336,51.2%,7m
17006,1,Elam,3032,1715,147,125,272,54.0%,14m
17006,2,Rockcer,3032,1382,130,101,231,56.3%,10m
17006,1,MonsmegHead,3032,1519,110,94,204,53.9%,4m
17006,1,benadam,3032,730,23,29,52,44.2%,5m
17006,2,CarrotJam,3032,433,16,13,29,55.2%,7m
17006,1,[xHUNx]Csaszi,3032,459,15,19,34,44.1%,5m
17006,1,[mfxed]Mitico,3032,273,9,7,16,56.2%,11m
17006,2,chartzono,3032,222,8,9,17,47.1%,22m
17006,2,Gladius,3032,137,6,4,10,60.0%,24m
17006,3,bistriii,3032,119,5,5,10,50.0%,10m
17006,1,Dodo,3032,104,4,5,9,44.4%,7m
17006,2,Skillasaur,3032,87,3,1,4,75.0%,14m
17006,1,[TheRET]welly,3032,117,3,1,4,75.0%,45m
17006,3,[neuroW]Iyerbeth,3032,106,2,6,8,25.0%,12m
17006,2,[Mergel]Wigglos,3032,0,1,1,2,50.0%,10m
17006,2,FlashPlay,3032,32,1,1,2,50.0%,6m
17006,2,cowpox,3032,0,0,1,1,0.0%,7m
17006,1,zen,3032,0,0,3,3,0.0%,9m
17026,1,nooblife,3031,1680,406,404,810,50.1%,4m
17026,3,banana,3031,1499,239,251,490,48.8%,17m
17026,1,[FUAZ]Sinalat,3031,1689,214,202,416,51.4%,23m
17026,1,[BRSKR]VonRufiou,3031,1381,157,136,293,53.6%,4m
17026,3,Remmos,3031,1526,153,140,293,52.2%,3m
17026,1,AlexeyRed,3031,1348,103,102,205,50.2%,23m
17026,2,Peci,3031,581,70,63,133,52.6%,23m
17026,2,LightVader,3031,974,48,32,80,60.0%,22m
17026,2,Repa,3031,698,45,40,85,52.9%,23m
17026,3,Leggy,3031,563,36,40,76,47.4%,19m
17026,1,Wojeksl,3031,767,33,26,59,55.9%,23m
17026,1,[ЕST]TaHku,3031,658,31,32,63,49.2%,22m
17026,2,Sourpamach,3031,751,30,22,52,57.7%,10m
17026,2,heat,3031,619,27,18,45,60.0%,21m
17026,2,PROTOSRETARD,3031,419,23,7,30,76.7%,15m
17026,3,TyBrO,3031,204,21,26,47,44.7%,12m
17026,3,ChopSuey,3031,365,15,12,27,55.6%,11m
17026,1,[R4p3Rs]HESKEY,3031,407,14,13,27,51.9%,6m
17026,1,miEye,3031,426,13,12,25,52.0%,6m
17026,1,Falcon,3031,223,10,10,20,50.0%,20m
17026,1,Saftpresse,3031,346,9,11,20,45.0%,5m
17026,1,Awedron,3031,202,6,5,11,54.5%,15m
17026,2,zjinder,3031,34,5,1,6,83.3%,21m
17026,2,[Hollow]Thomass,3031,30,5,2,7,71.4%,15m
17026,1,Gromgt,3031,157,5,3,8,62.5%,10m
17026,1,[xDniwe]Ether,3031,0,4,1,5,80.0%,56m
17026,2,jallukilju,3031,88,4,2,6,66.7%,6m
17026,1,Draco,3031,0,3,2,5,60.0%,45m
17026,2,[FTCB]Acnologia,3031,30,2,2,4,50.0%,6m
17026,1,ArmlessHook,3031,97,2,3,5,40.0%,40m
17026,1,[PÂRłAH]Fangate,3031,76,2,10,12,16.7%,10m
17026,2,KnockShot,3031,0,1,0,1,100.0%,12m
17026,2,[ĦĦ]xmiio,3031,32,1,1,2,50.0%,12m
17026,2,[F10C]Apache,3031,0,0,1,1,0.0%,7m
17060,3,mseven,3030,1561,143,148,291,49.1%,9m
17060,3,FABZ,3030,1166,60,63,123,48.8%,23m
17060,1,Haruspex,3030,1038,51,29,80,63.8%,21m
17060,3,Gabinex,3030,776,41,39,80,51.2%,20m
17060,3,Reizor,3030,595,33,47,80,41.2%,14m
17060,2,MoNGoL,3030,649,31,27,58,53.4%,10m
17060,1,BronZza,3030,743,25,25,50,50.0%,20m
17060,1,[PChaos]Werman,3030,750,24,27,51,47.1%,22m
17060,1,TickTockGod,3030,649,23,19,42,54.8%,6m
17060,3,NightAngel,3030,425,19,26,45,42.2%,19m
17060,2,REPZ,3030,376,17,10,27,63.0%,21m
17060,1,saint,3030,314,9,12,21,42.9%,8m
17060,2,SeiskaPete,3030,0,4,1,5,80.0%,8m
17060,2,[JouMa]DJteaCosy,3030,94,4,2,6,66.7%,10m
17060,2,Scheergel,3030,145,4,2,6,66.7%,56m
17060,2,MundoPc,3030,178,4,8,12,33.3%,22m
17060,2,SabreRider,3030,0,3,2,5,60.0%,22m
17060,2,Izvas,3030,0,1,0,1,100.0%,11m
17060,1,Yarblek,3030,0,1,2,3,33.3%,22m
17060,2,deadpool,3030,0,0,1,1,0.0%,23m
17060,2,Moriarty,3030,0,0,1,1,0.0%,12m
17081,2,AlienVampire,3029,1524,94,50,144,65.3%,17m
17081,2,Rasslabuha,3029,444,41,17,58,70.7%,6m
17081,3,[AJJB]AlfaJampa,3029,653,38,48,86,44.2%,5m
17081,2,[CS0]ProTau,3029,644,31,18,49,63.3%,22m
17081,2,[Chariz]AlpakaStar,3029,609,24,16,40,60.0%,10m
17081,1,CheeseTown,3029,631,21,21,42,50.0%,19m
17081,2,INFECTEDZERG,3029,160,19,15,34,55.9%,6m
17081,1,eXistenZ,3029,477,15,13,28,53.6%,11m
17081,1,[StatsF]PashaF,3029,233,14,15,29,48.3%,19m
17081,1,[TFSC]Gorbang,3029,326,13,11,24,54.2%,24m
17081,1,[IPC1]Jun,3029,372,11,16,27,40.7%,20m
17081,1,[LA63]ChefKoch,3029,382,11,18,29,37.9%,8m
17081,3,TaRKuS,3029,119,8,4,12,66.7%,15m
17081,2,Maqnusbyr,3029,172,8,7,15,53.3%,7m
17081,2,[ONKIE]binloadin,3029,194,6,5,11,54.5%,47m
17081,3,GodOfFutsal,3029,152,6,14,20,30.0%,23m
17081,3,Millthunder,3029,0,4,3,7,57.1%,32m
17081,3,Odric,3029,98,3,2,5,60.0%,23m
17081,2,Streamer,3029,0,1,0,1,100.0%,21m
17081,2,eXstaa,3029,0,1,1,2,50.0%,6m
17081,3,Alex,3029,40,1,1,2,50.0%,37m
17081,2,AlexOnOff,3029,0,1,1,2,50.0%,23m
17081,2,[Gurken]Primagen,3029,0,0,1,1,0.0%,7m
17081,2,Pixar,3029,0,0,1,1,0.0%,21m
17105,1,Homyakman,3028,1669,186,148,334,55.7%,21m
17105,1,Sheff,3028,1649,181,170,351,51.6%,3m
17105,2,thunder,3028,1356,115,83,198,58.1%,11m
17105,1,LarryLaffer,3028,1177,109,107,216,50.5%,14m
17105,3,Julo,3028,957,84,76,160,52.5%,10m
17105,3,Aishin,3028,1598,74,97,171,43.3%,11m
17105,3,[SwSII]Meepo,3028,802,53,61,114,46.5%,4m
17105,1,pekpes,3028,790,25,27,52,48.1%,9m
17105,1,Utopia,3028,656,20,28,48,41.7%,5m
17105,1,WeeWeeRNA,3028,341,16,8,24,66.7%,8m
17105,2,BadHairDay,3028,189,6,2,8,75.0%,5m
17105,1,Fornson,3028,145,5,3,8,62.5%,5m
17105,1,Slith,3028,0,4,1,5,80.0%,44m
17105,3,dracothx,3028,97,4,3,7,57.1%,32m
17105,2,[xZero]reee,3028,0,3,2,5,60.0%,9m
17105,2,IIIIIIIIIIII,3028,30,2,0,2,100.0%,12m
17105,1,HellDoor,3028,96,2,2,4,50.0%,41m
17105,1,[ÆGlS]Knight,3028,0,1,0,1,100.0%,1h
17105,2,[hf4X4]Старый,3028,0,1,0,1,100.0%,15m
17105,2,Nandreu,3028,0,1,0,1,100.0%,12m
17105,2,Rafk,3028,0,1,1,2,50.0%,21m
17105,2,[HZDH]Xpatate,3028,30,1,1,2,50.0%,4m
17105,2,[CJFF]Laslorgen,3028,32,1,1,2,50.0%,8m
17105,1,[dolbo9]GameOver,3028,0,1,1,2,50.0%,45m
17105,1,gorre,3028,90,1,3,4,25.0%,5m
17105,3,Shadowfiend,3028,97,1,3,4,25.0%,43m
17105,3,[ĦĦ]Elonmusk,3028,30,1,5,6,16.7%,14m
17105,1,gooji,3028,0,0,1,1,0.0%,49m
17105,3,llllllllllll,3028,0,0,1,1,0.0%,60m
17134,3,Erdbeere,3027,1585,491,484,975,50.4%,13m
17134,3,[RеG]MaximiliaN,3027,1531,364,356,720,50.6%,23m
17134,1,ECV,3027,1641,268,250,518,51.7%,6m
17134,3,Griffon,3027,1586,202,216,418,48.3%,24m
17134,2,tecasse,3027,865,85,87,172,49.4%,6m
17134,1,Zentie,3027,1448,81,75,156,51.9%,14m
17134,1,EÐÐY,3027,1699,70,65,135,51.9%,10m
17134,1,gostA,3027,1172,45,44,89,50.6%,10m
17134,1,Kein,3027,798,33,27,60,55.0%,24m
17134,1,floppy,3027,750,29,21,50,58.0%,5m
17134,1,Grimmjow,3027,614,23,27,50,46.0%,3m
17134,1,Gariktron,3027,615,21,18,39,53.8%,22m
17134,3,GooM,3027,326,13,10,23,56.5%,21m
17134,2,Zorro,3027,324,12,12,24,50.0%,9m
17134,1,Simmons,3027,313,11,9,20,55.0%,43m
17134,2,DVN,3027,233,9,6,15,60.0%,7m
17134,1,VanNostrand,3027,244,7,10,17,41.2%,10m
17134,2,dopedepended,3027,174,6,5,11,54.5%,21m
17134,3,Lio,3027,138,4,4,8,50.0%,21m
17134,2,Evenbigger,3027,0,3,2,5,60.0%,22m
17134,2,Skank,3027,0,3,2,5,60.0%,8m
17134,2,PsychD,3027,133,3,3,6,50.0%,6m
17134,1,[SpOFr]Basha,3027,126,3,4,7,42.9%,11m
17134,1,[WpG]Calabian,3027,0,2,2,4,50.0%,21m
17134,1,[AiRǂ]PiccoloConte,3027,97,2,2,4,50.0%,50m
17134,2,blanKKa,3027,36,1,1,2,50.0%,6m
17134,2,[ATC28]Bender,3027,0,1,4,5,20.0%,10m
17134,3,Blubzy,3027,0,0,1,1,0.0%,7m
17134,1,[Rol3kg]Jopa,3027,0,0,1,1,0.0%,49m
17134,2,Холди,3027,0,0,1,1,0.0%,6m
17134,2,[ØN]KIIIIN,3027,0,0,1,1,0.0%,4m
17134,2,Skald,3027,0,0,1,1,0.0%,23m
17134,2,ForTrain,3027,0,0,1,1,0.0%,7m
17134,2,Kermit,3027,0,0,2,2,0.0%,21m
17134,2,Sera,3027,0,0,2,2,0.0%,21m
17134,3,Rafar,3027,0,0,10,10,0.0%,13m
17170,3,Zapple,3026,1558,510,494,1004,50.8%,8m
17170,1,OxiteGhosT,3026,976,170,164,334,50.9%,18m
17170,1,[L7R]Pafdeudan,3026,1377,86,57,143,60.1%,22m
17170,1,Maksimov,3026,1280,50,48,98,51.0%,13m
17170,1,[xFRSx]Arcthur,3026,978,36,41,77,46.8%,6m
17170,1,Skriming,3026,456,34,32,66,51.5%,13m
17170,1,[Rata]FinnTheHuman,3026,717,31,29,60,51.7%,7m
17170,1,IrishMate,3026,456,18,15,33,54.5%,19m
17170,1,[Peeps]RickyTheDoom,3026,465,15,13,28,53.6%,3m
17170,1,[MIZT]TIZ,3026,257,12,8,20,60.0%,6m
17170,1,[BxFǂ]Jolli,3026,410,12,19,31,38.7%,23m
17170,2,Virus,3026,308,11,9,20,55.0%,4m
17170,2,[IMIK]Inflames,3026,273,10,7,17,58.8%,3m
17170,2,CynderQuinn,3026,264,10,7,17,58.8%,6m
17170,2,[Bouzeu]AmShagaar,3026,226,9,5,14,64.3%,17m
17170,2,[0BO]Stiefe,3026,271,9,8,17,52.9%,21m
17170,2,Tonyblahe,3026,245,9,8,17,52.9%,7m
17170,2,KraytDragon,3026,178,8,5,13,61.5%,22m
17170,2,Muszu,3026,198,8,5,13,61.5%,17m
17170,1,cursed,3026,278,8,10,18,44.4%,5m
17170,3,FeorgeGloyd,3026,233,8,13,21,38.1%,4m
17170,1,Sevych,3026,228,7,5,12,58.3%,3m
17170,1,Maniolo,3026,214,7,8,15,46.7%,22m
17170,2,[oooboy]werser,3026,168,4,2,6,66.7%,8m
17170,2,JRJ,3026,92,4,4,8,50.0%,7m
17170,1,JackOfHearts,3026,120,4,8,12,33.3%,13m
17170,1,anakiouss,3026,103,3,2,5,60.0%,7m
17170,2,[CTD]Zewrgban,3026,138,3,3,6,50.0%,18m
17170,1,FilipRak,3026,139,3,4,7,42.9%,3m
17170,1,MericanChees,3026,0,2,1,3,66.7%,27m
17170,1,BlasterOOs,3026,0,1,2,3,33.3%,8m
17170,3,Xand,3026,30,1,10,11,9.1%,6m
17170,2,[sp1]Kronos,3026,0,0,2,2,0.0%,6m
17170,3,Garna,3026,0,0,2,2,0.0%,29m
17204,1,Ian,3025,1133,117,104,221,52.9%,22m
17204,1,oberststen,3025,1018,68,54,122,55.7%,10m
17204,2,DivPetel,3025,1244,58,59,117,49.6%,19m
17204,1,schasi,3025,392,36,23,59,61.0%,23m
17204,1,DUM,3025,707,33,16,49,67.3%,5m
17204,1,[BdPǂ]Giumbolizer,3025,708,31,22,53,58.5%,3m
17204,1,fissureX,3025,756,27,26,53,50.9%,6m
17204,2,Darmiel,3025,518,21,15,36,58.3%,21m
17204,1,AMBRZ,3025,638,19,27,46,41.3%,6m
17204,2,[OdoRo]Kathachiel,3025,334,14,10,24,58.3%,23m
17204,3,Rin,3025,400,14,25,39,35.9%,10m
17204,2,stepaXgg,3025,288,11,6,17,64.7%,9m
17204,1,ImNotASmurf,3025,251,11,7,18,61.1%,49m
17204,1,[dOfHAR]Ridogo,3025,282,10,8,18,55.6%,23m
17204,1,Leo,3025,265,9,16,25,36.0%,22m
17204,1,Forrest,3025,220,7,5,12,58.3%,19m
17204,3,Nymoon,3025,235,7,6,13,53.8%,6m
17204,2,Катакури,3025,144,6,2,8,75.0%,18m
17204,3,WillyWonka,3025,40,6,2,8,75.0%,18m
17204,1,Jaden,3025,235,6,7,13,46.2%,31m
17204,1,Evilguy,3025,97,4,2,6,66.7%,16m
17204,1,Mielec,3025,48,3,2,5,60.0%,58m
17204,1,FreeZeeS,3025,0,3,3,6,50.0%,32m
17204,2,EightBit,3025,30,2,2,4,50.0%,24m
17204,1,nightedition,3025,36,2,3,5,40.0%,4m
17204,2,Genji,3025,0,1,0,1,100.0%,23m
17204,1,Alyssina,3025,0,1,1,2,50.0%,28m
17231,1,Romaga,3024,1605,277,238,515,53.8%,24m
17231,3,[TAFSC2]ReaPerZ,3024,859,78,72,150,52.0%,6m
17231,2,Jelly,3024,1494,74,62,136,54.4%,19m
17231,1,Heaven,3024,1407,55,57,112,49.1%,11m
17231,1,Alexy,3024,1182,48,46,94,51.1%,3m
17231,1,[3DE]HeckobA,3024,663,42,38,80,52.5%,4m
17231,1,Gure,3024,809,32,27,59,54.2%,4m
17231,1,Jusifer,3024,625,30,23,53,56.6%,6m
17231,2,ElwynAce,3024,700,29,20,49,59.2%,14m
17231,1,Sok,3024,796,25,30,55,45.5%,20m
17231,2,Veto,3024,552,21,12,33,63.6%,22m
17231,1,finster,3024,580,19,20,39,48.7%,10m
17231,1,[mfixed]Baltar,3024,457,18,18,36,50.0%,6m
17231,1,Vulak,3024,424,17,15,32,53.1%,10m
17231,1,Ymiril,3024,432,16,17,33,48.5%,10m
17231,2,SeaSharp,3024,422,15,13,28,53.6%,6m
17231,1,Byun,3024,227,9,6,15,60.0%,39m
17231,1,[Sieral]SunshineBean,3024,264,8,13,21,38.1%,13m
17231,3,komar,3024,146,6,4,10,60.0%,39m
17231,2,RoyBamboo,3024,172,6,7,13,46.2%,15m
17231,1,tequilaeruza,3024,145,5,3,8,62.5%,53m
17231,2,Triakis,3024,120,5,4,9,55.6%,12m
17231,2,MastrMind,3024,0,4,1,5,80.0%,9m
17231,1,hollabrrack,3024,115,4,4,8,50.0%,3m
17231,2,MILNEAGE,3024,30,2,0,2,100.0%,22m
17231,2,YoRo,3024,34,2,2,4,50.0%,8m
17231,2,TpucTan,3024,60,2,4,6,33.3%,7m
17231,1,Mikiya,3024,0,1,3,4,25.0%,14m
17231,1,Johan,3024,38,1,8,9,11.1%,19m
17231,2,Pablantor,3024,0,0,1,1,0.0%,7m
17261,3,Jeje,3023,1587,316,318,634,49.8%,20m
17261,2,Chaosmaster,3023,1601,259,231,490,52.9%,7m
17261,1,Brsl,3023,1697,152,150,302,50.3%,10m
17261,1,[vFam]Argfede,3023,1597,139,133,272,51.1%,3m
17261,1,Lambda,3023,1691,132,129,261,50.6%,19m
17261,1,FreaQ,3023,1373,110,96,206,53.4%,3m
17261,2,qsek,3023,1481,84,69,153,54.9%,6m
17261,1,Osetrina,3023,1133,77,68,145,53.1%,8m
17261,3,cOsTa,3023,1477,70,82,152,46.1%,14m
17261,1,FutakuchiOG,3023,1569,66,68,134,49.3%,22m
17261,1,[RGG]uthar,3023,1145,43,38,81,53.1%,10m
17261,2,Biohazard,3023,820,33,28,61,54.1%,4m
17261,1,FlinkeMaus,3023,815,31,27,58,53.4%,14m
17261,2,[TedB]LATAR,3023,646,29,16,45,64.4%,12m
17261,2,BARcode,3023,621,25,16,41,61.0%,10m
17261,2,albertt,3023,442,17,11,28,60.7%,21m
17261,1,[3MD]Disk,3023,511,15,17,32,46.9%,9m
17261,1,[HLFLMN]Domi,3023,362,14,11,25,56.0%,13m
17261,2,OLDSTAR,3023,343,13,11,24,54.2%,8m
17261,2,[RMM]Tayar,3023,107,10,7,17,58.8%,12m
17261,3,AnArChY,3023,226,10,10,20,50.0%,9m
17261,1,LarsMorten,3023,174,8,6,14,57.1%,5m
17261,3,Maxim,3023,183,7,5,12,58.3%,47m
17261,2,Trickster,3023,184,6,1,7,85.7%,7m
17261,2,sirus,3023,162,5,0,5,100.0%,11m
17261,3,[Byczki]Lukasz,3023,145,4,3,7,57.1%,43m
17261,2,Sectoid,3023,122,4,4,8,50.0%,18m
17261,2,Interior,3023,0,3,2,5,60.0%,5m
17261,1,[Alkar]Elegrabin,3023,160,3,6,9,33.3%,19m
17261,2,RamStein,3023,93,2,0,2,100.0%,47m
17261,3,[Sages]Haribold,3023,97,2,1,3,66.7%,37m
17261,2,Prinss,3023,32,2,2,4,50.0%,23m
17261,3,[0VI]SicJack,3023,139,2,5,7,28.6%,26m
17261,2,Spharex,3023,0,0,1,1,0.0%,19m
17261,2,[LPIB]Ceorik,3023,0,0,1,1,0.0%,15m
17261,2,[Aмун]MrWest,3023,0,0,1,1,0.0%,12m
17261,2,hITECH,3023,0,0,1,1,0.0%,11m
17261,1,DdDuUuDdDuUu,3023,0,0,3,3,0.0%,18m
17261,1,douuuuuuuuu,3023,0,0,4,4,0.0%,20m
17300,1,JohnnyDrama,3022,1687,194,177,371,52.3%,9m
17300,2,onemoreBoar,3022,1125,150,126,276,54.3%,18m
17300,1,LiOneL,3022,1482,62,68,130,47.7%,5m
17300,1,Caras,3022,1391,61,56,117,52.1%,19m
17300,2,[LMBD]Chameleon,3022,1363,59,46,105,56.2%,7m
17300,1,Krak,3022,700,35,32,67,52.2%,23m
17300,3,Bethell,3022,802,30,36,66,45.5%,7m
17300,2,Raven,3022,660,23,25,48,47.9%,14m
17300,1,MonkFish,3022,628,21,17,38,55.3%,3m
17300,2,Nalaa,3022,366,13,12,25,52.0%,6m
17300,2,[nk44]oemer,3022,268,12,7,19,63.2%,12m
17300,1,NoliP,3022,160,9,6,15,60.0%,44m
17300,2,[hi5]geiLeN,3022,260,9,11,20,45.0%,5m
17300,1,[PiGPan]Emberck,3022,244,8,12,20,40.0%,20m
17300,3,Keltuvos,3022,145,6,4,10,60.0%,47m
17300,3,corvet,3022,135,5,4,9,55.6%,47m
17300,1,[RooD]DerPlagiator,3022,0,4,1,5,80.0%,37m
17300,1,[FaiI]Kahmoon,3022,97,4,2,6,66.7%,6m
17300,2,beardulf,3022,147,4,5,9,44.4%,24m
17300,1,[DWTeam]Agent,3022,110,4,6,10,40.0%,24m
17300,2,FatalT,3022,0,3,2,5,60.0%,10m
17300,1,Thanatos,3022,125,3,10,13,23.1%,23m
17300,2,[HARP]Baldo,3022,32,2,0,2,100.0%,11m
17300,2,kalt,3022,0,1,0,1,100.0%,7m
17300,2,Zero,3022,36,1,2,3,33.3%,12m
17300,2,[Brra]Chachou,3022,96,1,4,5,20.0%,6m
17326,2,MAX,3021,1615,261,232,493,52.9%,7m
17326,3,Behemoth,3021,1058,182,179,361,50.4%,18m
17326,1,notna,3021,1305,151,146,297,50.8%,3m
17326,1,GaTitO,3021,1596,117,110,227,51.5%,20m
17326,1,roda,3021,1200,56,37,93,60.2%,21m
17326,2,RukiKruki,3021,1314,49,46,95,51.6%,19m
17326,1,killahundso,3021,188,28,23,51,54.9%,14m
17326,2,[Trran]aea,3021,615,27,20,47,57.4%,23m
17326,2,Mani,3021,490,27,25,52,51.9%,9m
17326,1,SIREX,3021,690,23,26,49,46.9%,22m
17326,2,[VéGaNo]Habis,3021,549,19,18,37,51.4%,6m
17326,1,BlndMrn,3021,376,17,12,29,58.6%,5m
17326,3,Jhanaa,3021,326,15,8,23,65.2%,20m
17326,1,[OTLSS]santAa,3021,410,14,17,31,45.2%,5m
17326,1,MrCandyGuy,3021,243,10,3,13,76.9%,21m
17326,1,Avines,3021,366,10,13,23,43.5%,5m
17326,2,[Hrѓ]Акулка,3021,200,8,6,14,57.1%,10m
17326,1,Shya,3021,284,8,12,20,40.0%,11m
17326,2,MadeCR,3021,107,6,3,9,66.7%,59m
17326,2,Zergcules,3021,158,6,5,11,54.5%,56m
17326,1,[LöK]MajorFailure,3021,166,4,0,4,100.0%,32m
17326,2,[eXe]Sobek,3021,94,4,4,8,50.0%,18m
17326,2,BlueSky,3021,0,4,4,8,50.0%,48m
17326,1,twisted,3021,96,4,5,9,44.4%,46m
17326,2,[IBTMBL]DJNana,3021,177,4,6,10,40.0%,21m
17326,1,metric,3021,145,3,5,8,37.5%,43m
17326,2,[PowOw]SABCJayme,3021,30,2,0,2,100.0%,7m
17326,2,[TODOW]ipez,3021,66,2,2,4,50.0%,5m
17326,2,[GGL1]ossir,3021,60,2,4,6,33.3%,21m
17326,2,TWC,3021,0,1,0,1,100.0%,24m
17326,1,Dmcc,3021,46,1,3,4,25.0%,49m
17326,1,Sergeevich,3021,0,1,3,4,25.0%,6m
17326,1,DavidP,3021,38,1,4,5,20.0%,21m
17326,2,DokTor,3021,88,1,5,6,16.7%,23m
17326,2,LiandriCorp,3021,0,0,1,1,0.0%,9m
17326,1,Tushy,3021,0,0,1,1,0.0%,1h
17326,1,Frisck,3021,0,0,3,3,0.0%,10m
17363,1,dizzzasta,3020,1032,78,74,152,51.3%,5m
17363,1,Shaka,3020,1027,74,58,132,56.1%,6m
17363,1,Slide,3020,489,63,58,121,52.1%,4m
17363,2,Gniewosz,3020,983,49,31,80,61.2%,19m
17363,2,[MioInc]MioDrank,3020,708,35,13,48,72.9%,7m
17363,1,OriginalFake,3020,688,24,22,46,52.2%,22m
17363,3,[StrLz]Murray,3020,658,22,32,54,40.7%,12m
17363,3,Valamer,3020,315,17,18,35,48.6%,8m
17363,1,PapaDave,3020,460,17,24,41,41.5%,24m
17363,2,Virusy,3020,302,13,9,22,59.1%,17m
17363,2,FatalMix,3020,330,10,9,19,52.6%,21m
17363,3,adVII,3020,276,10,18,28,35.7%,24m
17363,1,[IFAI]AnFalslh,3020,275,9,13,22,40.9%,8m
17363,1,[RBlood]Nas,3020,163,8,4,12,66.7%,3m
17363,2,Skyppy,3020,146,8,5,13,61.5%,15m
17363,1,Timonchy,3020,258,8,7,15,53.3%,59m
17363,2,FoX,3020,140,6,5,11,54.5%,22m
17363,2,[ASPRU]Sitewalker,3020,178,6,7,13,46.2%,15m
17363,1,MeowGeek,3020,121,5,4,9,55.6%,5m
17363,2,[LSPs]Makake,3020,92,4,4,8,50.0%,21m
17363,1,Hernan,3020,138,4,9,13,30.8%,7m
17363,2,paltus,3020,88,3,3,6,50.0%,9m
17363,2,RectalAmbush,3020,0,2,3,5,40.0%,4m
17363,1,[Meet]dAMiAn,3020,122,2,4,6,33.3%,21m
17363,1,null,3020,0,1,0,1,100.0%,50m
17363,2,Noctis,3020,30,1,1,2,50.0%,12m
17363,2,[KUJD]Maciuś,3020,0,1,1,2,50.0%,5m
17363,2,BusI,3020,0,1,2,3,33.3%,22m
17363,1,Kindness,3020,0,1,7,8,12.5%,23m
17363,3,EliteInvest,3020,0,0,1,1,0.0%,60m
17363,2,Nurival,3020,0,0,1,1,0.0%,10m
17363,1,FreedomDiver,3020,0,0,1,1,0.0%,45m
17363,2,Evilday,3020,0,0,3,3,0.0%,9m
17363,1,[T3RR4N]Svelwyn,3020,0,0,9,9,0.0%,4m
17397,2,Metoecen,3019,1620,168,146,314,53.5%,7m
17397,1,mmonstr,3019,893,98,103,201,48.8%,21m
17397,1,[Töfte]RudeBoy,3019,1692,81,82,163,49.7%,6m
17397,3,Giant,3019,1427,69,75,144,47.9%,21m
17397,1,[YOLOx]JiZZoMAN,3019,1100,37,41,78,47.4%,5m
17397,1,Toaster,3019,829,32,26,58,55.2%,10m
17397,1,[220172]Nevir,3019,812,29,29,58,50.0%,23m
17397,1,llllllllllll,3019,806,26,30,56,46.4%,10m
17397,1,Renny,3019,458,16,15,31,51.6%,7m
17397,2,Djin,3019,363,15,12,27,55.6%,9m
17397,1,brzytki,3019,341,13,10,23,56.5%,19m
17397,2,[TeamJ]Behemoth,3019,328,12,11,23,52.2%,12m
17397,2,Maza,3019,294,11,4,15,73.3%,18m
17397,1,WhatAWaste,3019,213,10,7,17,58.8%,14m
17397,2,Zergnase,3019,163,7,8,15,46.7%,1h
17397,2,Vovanchik,3019,97,6,2,8,75.0%,48m
17397,2,CaptainSkull,3019,142,6,3,9,66.7%,14m
17397,1,Highlander,3019,158,4,4,8,50.0%,6m
17397,2,Alligator,3019,60,3,2,5,60.0%,9m
17397,1,Prsevrnce,3019,0,3,2,5,60.0%,47m
17397,2,nora,3019,0,3,2,5,60.0%,9m
17397,2,Nukleari,3019,64,2,2,4,50.0%,10m
17397,2,Piopiotte,3019,0,1,0,1,100.0%,12m
17397,2,[4SALE]Netruner,3019,0,1,0,1,100.0%,23m
17397,3,aeS,3019,97,1,1,2,50.0%,6m
17397,1,Deadend,3019,0,1,4,5,20.0%,4m
17397,2,tufflax,3019,0,1,4,5,20.0%,11m
17397,1,Sonic,3019,36,1,6,7,14.3%,7m
17397,3,Pyzokopter,3019,18,1,15,16,6.2%,5m
17397,2,Relapse,3019,0,0,1,1,0.0%,19m
17397,2,Droter,3019,0,0,1,1,0.0%,7m
17428,3,Corbindallas,3018,1567,222,225,447,49.7%,3m
17428,3,slimgod,3018,830,181,174,355,51.0%,22m
17428,1,batist,3018,1113,73,54,127,57.5%,14m
17428,2,[Rebеls]ling,3018,1634,69,58,127,54.3%,12m
17428,2,SwarmPool,3018,626,52,38,90,57.8%,7m
17428,2,HopeLess,3018,1023,41,35,76,53.9%,11m
17428,2,cCrazy,3018,1001,38,33,71,53.5%,12m
17428,1,Hapster,3018,570,35,35,70,50.0%,20m
17428,2,[Animoo]deadspine,3018,729,34,27,61,55.7%,3m
17428,2,Ray,3018,808,32,27,59,54.2%,19m
17428,2,rupture,3018,501,22,19,41,53.7%,10m
17428,3,[SQTeam]QuitoYang,3018,379,16,14,30,53.3%,18m
17428,2,Choeloli,3018,256,9,5,14,64.3%,21m
17428,2,MaZen,3018,236,8,11,19,42.1%,9m
17428,2,AdmiralRdnek,3018,142,6,4,10,60.0%,18m
17428,3,Aaron,3018,193,5,2,7,71.4%,44m
17428,2,Shadowlancer,3018,142,5,3,8,62.5%,10m
17428,2,XSander,3018,0,4,1,5,80.0%,10m
17428,2,[uCHAD]KGXSparks,3018,162,4,1,5,80.0%,12m
17428,2,[Bangz]Hodini,3018,124,4,4,8,50.0%,22m
17428,2,KeminSSHKG,3018,60,3,0,3,100.0%,21m
17428,2,tachibana,3018,68,3,2,5,60.0%,7m
17428,2,ASTRE,3018,60,3,2,5,60.0%,18m
17428,2,Flakhx,3018,0,2,0,2,100.0%,6m
17428,2,Ragmon,3018,66,2,1,3,66.7%,7m
17428,1,Doctor,3018,88,2,3,5,40.0%,6m
17428,2,[LQV]STARWAREX,3018,0,1,0,1,100.0%,19m
17428,2,Secret,3018,0,1,0,1,100.0%,19m
17428,2,Grimmjow,3018,0,1,1,2,50.0%,21m
17428,2,Sirlosealot,3018,0,1,4,5,20.0%,12m
17428,1,betrayal,3018,36,1,5,6,16.7%,5m
17428,2,Felix,3018,0,0,1,1,0.0%,19m
17428,2,IIIIIIIIII,3018,0,0,1,1,0.0%,18m
17461,3,psina,3017,1570,234,237,471,49.7%,12m
17461,3,[ITVB]NicoValkuz,3017,851,159,168,327,48.6%,3m
17461,1,[Jupme]ankkax,3017,1702,114,95,209,54.5%,19m
17461,3,Lorras,3017,272,50,43,93,53.8%,10m
17461,1,qwerty,3017,780,41,43,84,48.8%,6m
17461,1,Winston,3017,699,24,22,46,52.2%,22m
17461,1,Kiok,3017,425,17,14,31,54.8%,8m
17461,2,Pau,3017,372,16,13,29,55.2%,13m
17461,2,Nog,3017,366,14,10,24,58.3%,6m
17461,1,Tetsu,3017,439,14,13,27,51.9%,14m
17461,2,[CRAYZE]Адунтеридас,3017,194,7,7,14,50.0%,9m
17461,1,Solar,3017,216,7,12,19,36.8%,5m
17461,2,[Sizzle]RisingFenix,3017,86,4,1,5,80.0%,12m
17461,1,[slаyеr]konas,3017,48,4,2,6,66.7%,12m
17461,2,[GGmc2]ChristFist,3017,122,4,7,11,36.4%,12m
17461,1,Dizzy,3017,136,4,8,12,33.3%,6m
17461,1,GeiSha,3017,0,3,2,5,60.0%,14m
17461,1,JinSquare,3017,0,3,2,5,60.0%,33m
17461,3,OpenFold,3017,157,3,4,7,42.9%,19m
17461,1,[IIGDTD]Plibby,3017,90,2,1,3,66.7%,22m
17461,2,ZuchTieStar,3017,66,2,3,5,40.0%,15m
17461,2,changhav,3017,0,1,0,1,100.0%,5m
17461,2,[WCKYLN]Lonestar,3017,30,1,2,3,33.3%,5m
17461,2,[СОСK]АПАСНЫЙ,3017,32,1,2,3,33.3%,19m
17461,2,[Heyy]PowerPoint,3017,0,0,1,1,0.0%,23m
17461,2,[RAFFAN]ytwog,3017,0,0,1,1,0.0%,21m
17461,2,VSUS,3017,0,0,1,1,0.0%,19m
17461,2,[dTemp]MaGeBaN,3017,0,0,5,5,0.0%,9m
17489,3,metzo,3016,1358,139,132,271,51.3%,7m
17489,1,Rei,3016,1317,67,58,125,53.6%,21m
17489,3,lIIiiiiiilll,3016,795,54,54,108,50.0%,5m
17489,1,Salakelmi,3016,677,35,40,75,46.7%,24m
17489,2,[L0L]KORTES,3016,864,34,26,60,56.7%,23m
17489,2,Wullewupwup,3016,387,14,12,26,53.8%,9m
17489,2,[Cecky]Psyke,3016,383,14,12,26,53.8%,12m
17489,1,[ZgnRs]Percevalo,3016,255,14,12,26,53.8%,7m
17489,1,hellfire,3016,256,11,6,17,64.7%,20m
17489,2,Protothrope,3016,285,9,8,17,52.9%,10m
17489,2,SucukSoldier,3016,131,7,5,12,58.3%,7m
17489,3,acnp,3016,212,7,6,13,53.8%,14m
17489,1,BattleRap,3016,114,4,10,14,28.6%,3m
17489,1,flying,3016,0,3,2,5,60.0%,1h
17489,2,SerbianForev,3016,147,3,3,6,50.0%,38m
17489,1,[PORO3]Pinkrock,3016,44,3,9,12,25.0%,4m
17489,2,Aragel,3016,60,2,4,6,33.3%,10m
17489,2,[RIAW]RIPMorne,3016,0,1,1,2,50.0%,18m
17489,2,[L2ERS]Hor,3016,0,0,1,1,0.0%,21m
17489,1,davidkiller,3016,0,0,4,4,0.0%,13m
17509,1,jplgg,3015,1697,179,174,353,50.7%,13m
17509,2,Adiiiiiiiiii,3015,626,93,72,165,56.4%,4m
17509,2,GoLdenStar,3015,1184,69,59,128,53.9%,19m
17509,2,[FBDY]Kasparoo,3015,800,52,46,98,53.1%,12m
17509,3,Mythalys,3015,1139,46,55,101,45.5%,7m
17509,2,Strown,3015,491,43,41,84,51.2%,18m
17509,1,DeBiLNaVeRnO,3015,408,27,17,44,61.4%,21m
17509,1,PurpleInc,3015,724,23,26,49,46.9%,5m
17509,3,TRIBES,3015,522,18,26,44,40.9%,6m
17509,2,ANGRY,3015,454,17,17,34,50.0%,17m
17509,2,[LRDP]Scrats,3015,362,16,13,29,55.2%,7m
17509,2,TheDarkSide,3015,286,12,8,20,60.0%,18m
17509,2,Synthetic,3015,274,11,6,17,64.7%,21m
17509,1,NoNeGoDie,3015,407,11,13,24,45.8%,4m
17509,2,APAP,3015,256,10,7,17,58.8%,4m
17509,2,Xam,3015,227,10,10,20,50.0%,5m
17509,3,[BSkyT]LuKrO,3015,157,6,4,10,60.0%,23m
17509,3,ChromaTron,3015,159,6,4,10,60.0%,1h
17509,3,SadLobster,3015,150,6,5,11,54.5%,8m
17509,1,dioops,3015,202,6,7,13,46.2%,14m
17509,2,BufniTa,3015,122,5,5,10,50.0%,7m
17509,2,MicroJackson,3015,178,5,7,12,41.7%,15m
17509,1,LoDblrb,3015,220,5,8,13,38.5%,18m
17509,2,joeylee,3015,90,4,1,5,80.0%,15m
17509,1,Terran,3015,136,4,3,7,57.1%,31m
17509,2,RusWillis,3015,155,4,4,8,50.0%,7m
17509,1,СынЦыганки,3015,0,3,2,5,60.0%,13m
17509,1,Skyrobotte,3015,0,3,3,6,50.0%,19m
17509,1,[DFgsA]Nightroad,3015,112,3,9,12,25.0%,10m
17509,2,BlackRavens,3015,94,2,2,4,50.0%,21m
17509,1,Bathman,3015,0,2,4,6,33.3%,13m
17509,2,[CHAPZ]kenno,3015,64,2,5,7,28.6%,23m
17509,2,Grimalkin,3015,30,1,3,4,25.0%,18m
17509,2,żuraw,3015,0,0,1,1,0.0%,21m
17509,2,DerRadierer,3015,0,0,1,1,0.0%,15m
17509,2,XSC,3015,0,0,2,2,0.0%,20m
17509,1,[DOLDU]Batuhan,3015,0,0,5,5,0.0%,8m
17546,1,COCOON,3014,1680,342,336,678,50.4%,5m
17546,3,Boitout,3014,964,235,220,455,51.6%,23m
17546,1,toastedfear,3014,1096,83,68,151,55.0%,10m
17546,2,DontKnowPlay,3014,832,61,52,113,54.0%,23m
17546,3,[XTCLol]logaan,3014,925,50,46,96,52.1%,4m
17546,2,[Börks]Tim,3014,794,36,18,54,66.7%,22m
17546,1,[CHââTe]Imlerith,3014,911,32,31,63,50.8%,11m
17546,2,Pocus,3014,335,31,29,60,51.7%,8m
17546,1,Monster,3014,636,27,24,51,52.9%,6m
17546,1,[FUEL]Circularcube,3014,645,23,29,52,44.2%,9m
17546,3,Wiggy,3014,506,19,29,48,39.6%,12m
17546,2,Cornygun,3014,458,18,17,35,51.4%,6m
17546,2,[RxxxD]Camouflage,3014,313,12,10,22,54.5%,13m
17546,1,Stein,3014,309,11,10,21,52.4%,4m
17546,2,ManlyBruno,3014,247,10,3,13,76.9%,23m
17546,2,EarlyBird,3014,256,9,10,19,47.4%,7m
17546,2,Polipastman,3014,216,7,8,15,46.7%,6m
17546,1,Azagapp,3014,219,6,6,12,50.0%,22m
17546,1,[BEARCL]chainsaw,3014,158,5,4,9,55.6%,13m
17546,2,YellowWorm,3014,170,5,4,9,55.6%,10m
17546,2,Atoli,3014,120,5,4,9,55.6%,9m
17546,2,Madrid,3014,46,5,5,10,50.0%,24m
17546,1,IIIIIIIIII,3014,30,4,4,8,50.0%,10m
17546,2,WilliamTell,3014,58,3,1,4,75.0%,6m
17546,1,Nexx,3014,0,3,2,5,60.0%,56m
17546,1,Anarion,3014,97,3,5,8,37.5%,19m
17546,2,[DiM]VasoCruser,3014,34,2,0,2,100.0%,21m
17546,2,[HRDS]Ozelot,3014,0,1,0,1,100.0%,23m
17546,1,KRYack,3014,0,1,0,1,100.0%,31m
17546,3,Speedy,3014,0,1,1,2,50.0%,29m
17546,2,[SCCCC]KasperNeuzig,3014,0,1,1,2,50.0%,20m
17546,2,Salt,3014,91,1,3,4,25.0%,9m
17546,2,Honesty,3014,30,1,4,5,20.0%,17m
17546,2,[RUSl56]GeneralPups,3014,0,0,1,1,0.0%,9m
17580,2,Imsaho,3013,1596,219,213,432,50.7%,12m
17580,1,Meja,3013,1629,193,187,380,50.8%,19m
17580,1,[oYm]Killuminati,3013,889,114,104,218,52.3%,19m
17580,1,Noski,3013,939,49,56,105,46.7%,5m
17580,2,bloodwolff,3013,1086,44,34,78,56.4%,6m
17580,1,Niüt,3013,1037,38,35,73,52.1%,6m
17580,3,BigBig,3013,988,38,45,83,45.8%,11m
17580,3,Horph,3013,800,35,35,70,50.0%,5m
17580,2,Nelio,3013,367,26,15,41,63.4%,6m
17580,2,[B1lly]TrueBilly,3013,547,23,13,36,63.9%,9m
17580,2,DiesIrae,3013,476,22,11,33,66.7%,23m
17580,2,[YSwag]Dennerwotter,3013,459,17,13,30,56.7%,12m
17580,2,Nemesis,3013,332,16,9,25,64.0%,21m
17580,1,Зamай,3013,407,16,16,32,50.0%,14m
17580,1,KALI,3013,317,11,10,21,52.4%,6m
17580,3,VerQuer,3013,221,8,18,26,30.8%,6m
17580,1,Azo,3013,253,7,8,15,46.7%,7m
17580,1,[Lowko]Pavonis,3013,170,6,9,15,40.0%,8m
17580,2,[JAPSE]TSoul,3013,121,5,4,9,55.6%,50m
17580,2,[PolSku]Torfingor,3013,180,5,4,9,55.6%,7m
17580,1,[Popped]SaRaH,3013,48,4,3,7,57.1%,33m
17580,3,[RomanV]Roman,3013,97,4,3,7,57.1%,19m
17580,2,[DoVV]AcidBurn,3013,172,4,5,9,44.4%,9m
17580,1,Add,3013,154,4,14,18,22.2%,6m
17580,2,[FTS2]genesim,3013,0,3,2,5,60.0%,11m
17580,2,SDS,3013,0,3,2,5,60.0%,21m
17580,2,ssakom,3013,60,3,3,6,50.0%,10m
17580,1,[EZPTS]Rizo,3013,97,3,3,6,50.0%,43m
17580,2,krmb,3013,32,1,2,3,33.3%,18m
17580,1,Coprocraft,3013,0,1,2,3,33.3%,6m
17580,2,Morghan,3013,0,0,1,1,0.0%,12m
17611,3,BoXer,3012,891,130,131,261,49.8%,14m
17611,3,[iPain]Decrepifier,3012,1288,93,99,192,48.4%,6m
17611,3,Tenenberg,3012,540,89,95,184,48.4%,17m
17611,1,kababik,3012,1645,71,61,132,53.8%,7m
17611,3,function,3012,1227,61,67,128,47.7%,3m
17611,2,GoblinWojny,3012,846,53,34,87,60.9%,17m
17611,1,Miralika,3012,833,48,43,91,52.7%,8m
17611,1,Belliver,3012,906,30,33,63,47.6%,21m
17611,3,SegFault,3012,322,14,10,24,58.3%,17m
17611,2,Tserg,3012,307,11,7,18,61.1%,21m
17611,1,heisenzerg,3012,391,10,13,23,43.5%,7m
17611,1,Yago,3012,213,9,8,17,52.9%,18m
17611,1,[NARUD]warney,3012,36,5,3,8,62.5%,21m
17611,3,monkie,3012,40,5,4,9,55.6%,6m
17611,2,XHunterX,3012,167,5,6,11,45.5%,11m
17611,2,[IoSS]EmbO,3012,94,4,0,4,100.0%,10m
17611,2,Zhenya,3012,94,4,4,8,50.0%,12m
17611,1,stickman,3012,110,4,7,11,36.4%,7m
17611,3,Tony,3012,131,3,4,7,42.9%,32m
17611,3,slu,3012,123,3,4,7,42.9%,7m
17611,1,Studsboll,3012,46,2,0,2,100.0%,43m
17611,1,waldymarxtnf,3012,38,2,6,8,25.0%,6m
17611,1,Sneakz,3012,74,2,9,11,18.2%,6m
17611,2,ltnk,3012,30,1,1,2,50.0%,12m
17611,2,[UndCo]jackhaze,3012,0,1,1,2,50.0%,21m
17611,1,Flower,3012,97,1,2,3,33.3%,16m
17611,2,Biały,3012,0,0,1,1,0.0%,4m
17611,1,NicolasCage,3012,0,0,5,5,0.0%,17m
17639,1,[ZiPx]Scitz,3011,1340,111,96,207,53.6%,7m
17639,2,DrivRRR,3011,1610,106,89,195,54.4%,22m
17639,1,Valgard,3011,1593,103,107,210,49.0%,8m
17639,2,rottenorange,3011,1324,90,81,171,52.6%,5m
17639,1,[jpeg]Octozane,3011,1607,84,87,171,49.1%,6m
17639,1,[GdAT]Fazy,3011,1411,67,67,134,50.0%,10m
17639,1,Engeron,3011,712,50,46,96,52.1%,10m
17639,3,factOR,3011,1164,49,57,106,46.2%,10m
17639,1,Crásh,3011,844,42,24,66,63.6%,24m
17639,2,XoMute,3011,825,37,23,60,61.7%,19m
17639,2,Philou,3011,854,35,29,64,54.7%,7m
17639,1,[MOHO]Moss,3011,834,33,28,61,54.1%,10m
17639,2,andrei,3011,724,28,21,49,57.1%,5m
17639,2,dennisje,3011,447,21,5,26,80.8%,10m
17639,3,[RAŞÇI]Gintoki,3011,260,12,11,23,52.2%,15m
17639,2,anklan,3011,160,11,2,13,84.6%,24m
17639,2,Strike,3011,263,11,2,13,84.6%,24m
17639,2,[Балаче]Tzvetnia,3011,310,10,7,17,58.8%,12m
17639,1,[Tuki]Lance,3011,295,10,18,28,35.7%,7m
17639,3,drumer,3011,146,9,8,17,52.9%,22m
17639,2,ZaNoZa,3011,196,8,7,15,53.3%,20m
17639,2,Neobird,3011,198,7,8,15,46.7%,17m
17639,3,[SFight]Smaavri,3011,166,6,0,6,100.0%,10m
17639,1,Asmodheus,3011,144,5,3,8,62.5%,17m
17639,2,MilkPerson,3011,124,5,5,10,50.0%,18m
17639,2,[888888]НаглыйТос,3011,154,5,7,12,41.7%,7m
17639,2,serdjao,3011,0,3,2,5,60.0%,9m
17639,1,Soma,3011,74,3,5,8,37.5%,6m
17639,1,jash,3011,119,3,5,8,37.5%,6m
17639,1,War,3011,110,3,10,13,23.1%,24m
17639,1,NeoCisab,3011,46,2,1,3,66.7%,4m
17639,1,foAd,3011,78,2,10,12,16.7%,9m
17639,2,CocoFruit,3011,0,1,0,1,100.0%,13m
17639,3,Dara,3011,40,1,4,5,20.0%,60m
17639,2,saver,3011,0,0,1,1,0.0%,7m
17639,2,Kaveri,3011,0,0,1,1,0.0%,17m
17639,2,trole,3011,0,0,1,1,0.0%,10m
17676,1,Kara,3010,1303,182,175,357,51.0%,5m
17676,2,[BRSKR]Viroos,3010,1018,72,28,100,72.0%,21m
17676,2,llllllllllll,3010,843,49,9,58,84.5%,21m
17676,2,Steinlíng,3010,600,42,37,79,53.2%,23m
17676,3,[197Au]Skinka,3010,995,38,38,76,50.0%,18m
17676,2,Fluxation,3010,480,28,23,51,54.9%,5m
17676,1,[ISS2]Nostralis,3010,576,20,21,41,48.8%,5m
17676,2,дима,3010,272,18,13,31,58.1%,23m
17676,3,EMBLEMMMM,3010,408,17,23,40,42.5%,13m
17676,3,Matsu,3010,228,7,18,25,28.0%,12m
17676,1,Schweinling,3010,134,6,4,10,60.0%,4m
17676,1,[KDV]vipek,3010,220,6,11,17,35.3%,3m
17676,3,serega,3010,0,5,2,7,71.4%,21m
17676,2,BenJammin,3010,114,5,3,8,62.5%,7m
17676,3,AbedNego,3010,0,4,3,7,57.1%,15m
17676,1,Taka,3010,162,4,7,11,36.4%,3m
17676,2,karikamento,3010,88,3,3,6,50.0%,18m
17676,2,[CBot]RoadToElune,3010,125,3,4,7,42.9%,18m
17676,2,Rwaew,3010,30,2,0,2,100.0%,5m
17676,2,Strassa,3010,30,2,3,5,40.0%,17m
17676,1,Mossad,3010,78,2,10,12,16.7%,11m
17676,2,[GGBF]Johndave,3010,0,1,0,1,100.0%,7m
17676,2,Sniez,3010,0,1,0,1,100.0%,3m
17676,2,[XGRX]ZeeP,3010,0,1,0,1,100.0%,18m
17676,2,[ELTM]Dussa,3010,0,1,1,2,50.0%,18m
17676,1,Solent,3010,0,1,1,2,50.0%,38m
17676,2,[UKG]Ellii,3010,88,1,2,3,33.3%,7m
17676,2,myZei,3010,0,0,1,1,0.0%,24m
17676,1,Anpanman,3010,0,0,5,5,0.0%,19m
17705,1,[QaDo]predator,3009,1504,133,130,263,50.6%,8m
17705,3,Blassreiter,3009,1564,128,133,261,49.0%,20m
17705,1,SantaClaus,3009,1311,83,74,157,52.9%,3m
17705,1,Arnianor,3009,1318,58,40,98,59.2%,3m
17705,1,lyon,3009,1213,54,44,98,55.1%,3m
17705,1,Satir,3009,291,15,10,25,60.0%,3m
17705,2,Artum,3009,242,15,18,33,45.5%,7m
17705,2,[XGKS]PeCoRiNa,3009,330,12,9,21,57.1%,15m
17705,1,tfffuuu,3009,99,10,16,26,38.5%,19m
17705,2,gidbin,3009,241,9,7,16,56.2%,21m
17705,2,GlowingStar,3009,163,5,2,7,71.4%,59m
17705,1,Klackknight,3009,100,5,3,8,62.5%,3m
17705,2,Mercurian,3009,120,5,4,9,55.6%,9m
17705,3,[illjil]MateFeedKill,3009,177,5,4,9,55.6%,56m
17705,1,BLEST,3009,100,5,8,13,38.5%,3m
17705,1,Leffotrak,3009,194,5,9,14,35.7%,7m
17705,1,SiGnUM,3009,0,4,1,5,80.0%,57m
17705,3,BShield,3009,97,4,4,8,50.0%,1h
17705,2,RiseofLambs,3009,88,3,3,6,50.0%,10m
17705,2,PurpleSkunK,3009,0,1,0,1,100.0%,12m
17705,2,Bob,3009,0,1,0,1,100.0%,6m
17705,1,IIIIIIIIIIII,3009,0,1,3,4,25.0%,17m
17705,1,MoistLord,3009,0,0,1,1,0.0%,12m
17728,3,Roedie,3008,1526,248,246,494,50.2%,21m
17728,3,neasi,3008,1507,95,96,191,49.7%,10m
17728,3,MonsieurBou,3008,1236,62,67,129,48.1%,18m
17728,2,Behemoth,3008,677,41,28,69,59.4%,7m
17728,1,MTn,3008,477,21,16,37,56.8%,11m
17728,2,Timur,3008,467,21,19,40,52.5%,20m
17728,2,Wolfius,3008,516,18,17,35,51.4%,23m
17728,2,CoOons,3008,330,12,10,22,54.5%,10m
17728,1,VechnoOdinok,3008,366,11,15,26,42.3%,22m
17728,2,[NRV]LaOz,3008,176,9,7,16,56.2%,22m
17728,2,Rick,3008,234,8,6,14,57.1%,36m
17728,2,[LuBa]Zeifen,3008,144,8,7,15,53.3%,8m
17728,1,[Prvrs]phophy,3008,234,7,11,18,38.9%,21m
17728,2,BeeMaster,3008,116,5,3,8,62.5%,18m
17728,3,MuShu,3008,202,5,10,15,33.3%,9m
17728,2,STALKER,3008,30,2,0,2,100.0%,24m
17728,2,[FRGSP]Chavi,3008,58,2,1,3,66.7%,21m
17728,2,Kyrann,3008,58,2,4,6,33.3%,10m
17728,2,ChStarfish,3008,121,2,4,6,33.3%,53m
17728,3,Ukushu,3008,62,2,15,17,11.8%,6m
17728,2,jNk,3008,0,0,1,1,0.0%,10m
17728,2,FooDog,3008,0,0,1,1,0.0%,7m
17728,2,[BANSHE]Saeria,3008,0,0,2,2,0.0%,15m
17751,3,Twistal,3007,1548,187,169,356,52.5%,12m
17751,1,DrHasenbein,3007,1558,86,75,161,53.4%,23m
17751,2,SiK,3007,1000,83,66,149,55.7%,9m
17751,1,DynamicASS,3007,1674,78,82,160,48.8%,11m
17751,2,Vast,3007,1345,58,48,106,54.7%,18m
17751,1,Space,3007,940,38,32,70,54.3%,4m
17751,2,AspireGlobal,3007,493,35,30,65,53.8%,5m
17751,2,INVOKER,3007,677,33,18,51,64.7%,19m
17751,3,[JANEZI]Xeon,3007,645,33,20,53,62.3%,18m
17751,2,Kartoonn,3007,617,26,17,43,60.5%,24m
17751,1,ZujekPLWWa,3007,224,24,16,40,60.0%,11m
17751,3,abbou,3007,442,20,16,36,55.6%,18m
17751,2,UFOalien,3007,436,17,16,33,51.5%,6m
17751,2,lktrbl,3007,388,16,7,23,69.6%,9m
17751,1,Zarock,3007,442,16,16,32,50.0%,24m
17751,2,Pixel,3007,374,13,10,23,56.5%,18m
17751,1,Koт,3007,345,13,13,26,50.0%,3m
17751,1,TheBoss,3007,116,7,3,10,70.0%,5m
17751,1,Remanner,3007,251,6,9,15,40.0%,13m
17751,2,Dykson,3007,191,5,3,8,62.5%,5m
17751,3,DeathEagle,3007,42,5,4,9,55.6%,21m
17751,2,shaan,3007,0,3,2,5,60.0%,15m
17751,2,[KKRUSH]Zorly,3007,60,3,2,5,60.0%,7m
17751,2,Kyto,3007,60,3,2,5,60.0%,21m
17751,1,FeedME,3007,0,2,1,3,66.7%,59m
17751,1,sypchik,3007,36,2,4,6,33.3%,24m
17751,3,[OXXXY]laplap,3007,0,1,0,1,100.0%,47m
17751,2,Morroz,3007,0,1,0,1,100.0%,4m
17751,2,[UAŦeam]LingMisha,3007,0,1,1,2,50.0%,7m
17751,1,Iden,3007,48,1,4,5,20.0%,55m
17751,1,MrFeiLong,3007,0,1,5,6,16.7%,9m
17751,2,NoLogic,3007,0,0,1,1,0.0%,19m
17751,2,Crispin,3007,0,0,2,2,0.0%,9m
17784,3,Paco,3006,892,69,68,137,50.4%,8m
17784,1,Darku,3006,885,66,69,135,48.9%,6m
17784,2,Bierbrot,3006,502,18,18,36,50.0%,12m
17784,1,[RomanV]Roman,3006,548,17,18,35,48.6%,22m
17784,1,EmilioZapata,3006,382,16,13,29,55.2%,6m
17784,1,Игрик,3006,510,16,21,37,43.2%,6m
17784,2,[ZERGTV]STALKER,3006,310,12,10,22,54.5%,24m
17784,1,Karrick,3006,280,9,10,19,47.4%,22m
17784,2,fleischbank,3006,234,8,4,12,66.7%,21m
17784,1,AlphaFart,3006,249,8,9,17,47.1%,6m
17784,3,Taisty,3006,146,6,4,10,60.0%,26m
17784,1,Aweresis,3006,201,6,7,13,46.2%,10m
17784,1,Stranger,3006,158,5,3,8,62.5%,10m
17784,3,absidian,3006,121,5,3,8,62.5%,6m
17784,3,Noob,3006,42,5,4,9,55.6%,36m
17784,1,[ExTr1m]HeadCrabe,3006,168,5,5,10,50.0%,21m
17784,2,ebick,3006,142,5,8,13,38.5%,10m
17784,2,StarScream,3006,0,3,2,5,60.0%,6m
17784,1,Royal,3006,96,3,4,7,42.9%,33m
17784,1,PaSSti,3006,36,2,4,6,33.3%,5m
17784,2,Cosbibi,3006,58,2,7,9,22.2%,11m
17784,2,[Neewbe]Boxer,3006,0,1,0,1,100.0%,22m
17784,2,[IndyK]MLD,3006,0,1,3,4,25.0%,15m
17784,1,[10TCLs]Sloky,3006,0,1,4,5,20.0%,6m
17784,2,[ATArmy]anyway,3006,34,1,4,5,20.0%,7m
17784,2,StJHNApoca,3006,0,0,1,1,0.0%,9m
17784,2,CBD,3006,0,0,2,2,0.0%,23m
17811,3,Silverjudge,3005,1175,187,188,375,49.9%,8m
17811,3,Soeren,3005,1561,181,183,364,49.7%,5m
17811,1,MasterIntima,3005,1440,146,120,266,54.9%,3m
17811,3,Rufi,3005,1561,117,121,238,49.2%,8m
17811,1,Yogawa,3005,978,70,69,139,50.4%,5m
17811,2,Зверь,3005,668,66,38,104,63.5%,6m
17811,2,[SUUCE]JeanBernard,3005,1257,53,40,93,57.0%,14m
17811,1,boojo,3005,633,35,35,70,50.0%,19m
17811,1,JinS,3005,931,33,38,71,46.5%,14m
17811,2,Vision,3005,679,30,14,44,68.2%,9m
17811,1,Geroz,3005,560,21,19,40,52.5%,23m
17811,1,LetsDoItQuik,3005,543,19,19,38,50.0%,22m
17811,1,bliT,3005,420,17,14,31,54.8%,4m
17811,3,[SPAINs]NoScriptDude,3005,459,14,23,37,37.8%,6m
17811,2,[Catory]MrFilmoosh,3005,308,13,8,21,61.9%,12m
17811,2,GovnotoP,3005,316,11,7,18,61.1%,18m
17811,2,Probius,3005,289,11,11,22,50.0%,15m
17811,2,Kuroko,3005,247,9,2,11,81.8%,10m
17811,1,[owouwu]FlokiGL,3005,226,9,4,13,69.2%,21m
17811,2,[Папик]РэперНотМи,3005,157,9,7,16,56.2%,50m
17811,2,Горох,3005,160,5,0,5,100.0%,23m
17811,1,make,3005,40,5,4,9,55.6%,24m
17811,2,Bomber,3005,148,5,7,12,41.7%,6m
17811,2,IIIIIIIIIIII,3005,150,5,7,12,41.7%,4m
17811,1,NtAkoS,3005,0,4,2,6,66.7%,21m
17811,3,GaZZaRoL,3005,163,4,5,9,44.4%,45m
17811,1,dNGRPavuel,3005,124,2,5,7,28.6%,13m
17811,2,Frolick,3005,0,1,0,1,100.0%,1h
17811,2,[AOTW]Blooddy,3005,30,1,2,3,33.3%,7m
17840,1,Dempa,3004,1523,103,108,211,48.8%,6m
17840,2,Airos,3004,981,91,83,174,52.3%,9m
17840,3,[RBP3]ScorpionFire,3004,1431,83,94,177,46.9%,15m
17840,1,[BoAiud]Narboom,3004,1520,67,54,121,55.4%,3m
17840,1,spielluk,3004,1309,60,51,111,54.1%,12m
17840,2,Funzzy,3004,548,44,29,73,60.3%,15m
17840,1,KarlSberg,3004,1194,40,47,87,46.0%,5m
17840,1,nescalzz,3004,517,25,18,43,58.1%,6m
17840,2,Ron,3004,359,22,19,41,53.7%,6m
17840,1,Skippy,3004,371,17,27,44,38.6%,7m
17840,1,[Stary]FOSSOYEUR,3004,481,16,14,30,53.3%,19m
17840,3,Starkbier,3004,272,13,11,24,54.2%,3m
17840,1,EDRusH,3004,351,12,9,21,57.1%,37m
17840,1,SaucissonOP,3004,440,12,19,31,38.7%,15m
17840,2,WhiteRabbit,3004,216,8,6,14,57.1%,19m
17840,1,FranticOgre,3004,0,4,2,6,66.7%,23m
17840,1,fraNk,3004,88,4,3,7,57.1%,19m
17840,1,Perian,3004,181,4,4,8,50.0%,43m
17840,2,Vivaldi,3004,98,4,6,10,40.0%,8m
17840,1,Silahka,3004,146,4,10,14,28.6%,6m
17840,2,[ŋǤ]XaToS,3004,0,1,0,1,100.0%,10m
17840,2,Arctus,3004,0,1,0,1,100.0%,15m
17840,2,Iboten,3004,0,1,0,1,100.0%,21m
17840,2,samÆl,3004,0,0,1,1,0.0%,23m
17840,3,Nyarlathotep,3004,0,0,1,1,0.0%,37m
17840,1,Lionath,3004,0,0,2,2,0.0%,43m
17840,2,Casine,3004,0,0,4,4,0.0%,18m
17867,3,Ulf,3003,1306,103,102,205,50.2%,7m
17867,1,BSticks,3003,1455,77,71,148,52.0%,23m
17867,1,zabinson,3003,999,64,62,126,50.8%,10m
17867,1,beckett,3003,884,58,55,113,51.3%,22m
17867,1,sisk,3003,1031,49,44,93,52.7%,21m
17867,2,momodevils,3003,650,36,6,42,85.7%,13m
17867,1,Mouchou,3003,826,27,28,55,49.1%,14m
17867,2,Fyntik,3003,614,23,22,45,51.1%,8m
17867,1,Energy,3003,502,19,18,37,51.4%,19m
17867,1,[TTTT]Albert,3003,487,15,16,31,48.4%,23m
17867,2,Shad,3003,204,10,8,18,55.6%,19m
17867,1,HawkyHawk,3003,346,10,17,27,37.0%,9m
17867,2,[GBGB]KingBurt,3003,328,9,13,22,40.9%,6m
17867,2,Ketter,3003,204,8,5,13,61.5%,6m
17867,2,Loik,3003,144,7,3,10,70.0%,21m
17867,2,Drebezg,3003,179,7,6,13,53.8%,31m
17867,3,DReeNo,3003,201,7,8,15,46.7%,8m
17867,2,BroLeev,3003,176,6,4,10,60.0%,18m
17867,1,Kris,3003,161,4,3,7,57.1%,49m
17867,1,[FalPal]Marbuel,3003,166,4,13,17,23.5%,5m
17867,2,Rurik,3003,0,3,2,5,60.0%,19m
17867,1,Daes,3003,0,3,3,6,50.0%,6m
17867,1,TheDukE,3003,48,2,2,4,50.0%,6m
17867,2,[PUDDI]YanYan,3003,62,2,4,6,33.3%,7m
17867,3,[BAAR]bare,3003,44,2,7,9,22.2%,25m
17867,2,[lEcal]Eca,3003,0,1,0,1,100.0%,17m
17867,2,BlackNogger,3003,30,1,3,4,25.0%,4m
17867,2,Defekt,3003,88,1,3,4,25.0%,10m
17867,1,Gianthuust,3003,0,1,4,5,20.0%,22m
17867,1,[DZTK]Otti,3003,0,0,1,1,0.0%,55m
17867,2,[ZЕRGТV]OraCuLe,3003,0,0,1,1,0.0%,18m
17867,2,[RTZzz]xHandOfGodx,3003,0,0,1,1,0.0%,9m
17867,2,Masque,3003,0,0,1,1,0.0%,9m
17900,1,[rn42]hisdudeness,3002,1180,158,152,310,51.0%,7m
17900,2,Kur,3002,1503,84,74,158,53.2%,9m
17900,1,stimk,3002,870,67,63,130,51.5%,24m
17900,2,ПoTpoWuTeJl,3002,1093,50,30,80,62.5%,10m
17900,2,kirdape,3002,882,50,41,91,54.9%,6m
17900,2,SFarttcar,3002,202,31,21,52,59.6%,21m
17900,2,[ČBEC]DAVEMAN,3002,674,29,29,58,50.0%,14m
17900,1,mrRazDva,3002,754,27,27,54,50.0%,21m
17900,1,Dremered,3002,745,26,26,52,50.0%,5m
17900,2,starburst,3002,506,23,8,31,74.2%,21m
17900,1,StormCruel,3002,497,20,16,36,55.6%,10m
17900,2,[Moobs]Rimsplitter,3002,497,18,17,35,51.4%,9m
17900,2,Shadowhawk,3002,279,15,13,28,53.6%,23m
17900,3,Jacko,3002,312,13,10,23,56.5%,23m
17900,2,Komsin,3002,267,11,8,19,57.9%,9m
17900,2,skR,3002,136,6,4,10,60.0%,11m
17900,2,[SPSes]ivanrsz,3002,174,6,6,12,50.0%,10m
17900,1,notEvil,3002,200,6,8,14,42.9%,6m
17900,2,Artiiste,3002,120,5,6,11,45.5%,10m
17900,2,FaKeR,3002,86,4,1,5,80.0%,9m
17900,1,squideyboy,3002,97,4,2,6,66.7%,44m
17900,2,TwinkleShītz,3002,88,4,2,6,66.7%,9m
17900,1,[XZ]rhox,3002,48,4,3,7,57.1%,45m
17900,3,Occulta,3002,0,4,3,7,57.1%,9m
17900,2,[GRR46]Cucudrulu,3002,62,3,1,4,75.0%,6m
17900,2,Kioal,3002,86,3,1,4,75.0%,10m
17900,2,Bumblebee,3002,116,3,1,4,75.0%,41m
17900,2,[Bifi]ElTupi,3002,126,3,2,5,60.0%,19m
17900,2,BeBen,3002,0,3,2,5,60.0%,18m
17900,2,CandyThief,3002,88,3,2,5,60.0%,5m
17900,3,[Kapt]Fery,3002,138,3,4,7,42.9%,17m
17900,2,HansOlo,3002,88,3,6,9,33.3%,9m
17900,2,Amarantik,3002,30,2,1,3,66.7%,24m
17900,2,Petrovech,3002,62,2,1,3,66.7%,20m
17900,1,Never,3002,0,2,4,6,33.3%,56m
17900,1,[РWNED]Tomahawk,3002,126,2,6,8,25.0%,9m
17900,2,[RBlood]Gabou,3002,0,0,1,1,0.0%,15m
17900,3,isida,3002,0,0,1,1,0.0%,55m
17900,2,[Penze]Mindenhato,3002,0,0,1,1,0.0%,6m
17939,1,Towns,3001,1679,237,217,454,52.2%,14m
17939,1,[GGZERG]Loki,3001,931,197,175,372,53.0%,5m
17939,1,[KDV]Heisenberg,3001,1660,194,191,385,50.4%,24m
17939,1,Dynamix,3001,862,93,83,176,52.8%,9m
17939,3,GEO,3001,1470,77,75,152,50.7%,9m
17939,2,[sonic1]НазарБонд,3001,1332,67,29,96,69.8%,12m
17939,2,BloodCage,3001,1467,60,51,111,54.1%,7m
17939,1,Cereal,3001,1024,38,35,73,52.1%,7m
17939,2,zergislife,3001,258,12,8,20,60.0%,3m
17939,2,Phoenix,3001,255,11,7,18,61.1%,8m
17939,2,RTS,3001,294,11,11,22,50.0%,23m
17939,2,Jules,3001,211,11,13,24,45.8%,24m
17939,1,[SkCzM]Yogregator,3001,329,10,11,21,47.6%,8m
17939,3,MindıControL,3001,182,7,5,12,58.3%,45m
17939,3,Shódan,3001,185,7,5,12,58.3%,23m
17939,2,angelgg,3001,245,7,5,12,58.3%,10m
17939,3,[EESC]haskichawa,3001,152,7,8,15,46.7%,21m
17939,1,[BeGa]Moppebart,3001,208,7,11,18,38.9%,24m
17939,2,[КодБи]goldkreateav,3001,121,6,7,13,46.2%,6m
17939,2,Freeeeeze,3001,194,6,9,15,40.0%,24m
17939,2,KidFunkyFry,3001,106,5,2,7,71.4%,6m
17939,2,Roanok,3001,88,4,2,6,66.7%,20m
17939,2,[IceFel]StarVader,3001,60,3,1,4,75.0%,10m
17939,2,[Ewaldi]Dico,3001,0,3,2,5,60.0%,24m
17939,2,[VuV]Illu,3001,30,2,0,2,100.0%,20m
17939,2,PublicUnique,3001,32,2,2,4,50.0%,23m
17939,2,IIIIIIIIIIII,3001,34,2,3,5,40.0%,6m
17939,2,Tatsche,3001,0,1,0,1,100.0%,7m
17939,1,[TwSwag]Reah,3001,48,1,2,3,33.3%,55m
17939,2,Akamii,3001,0,1,3,4,25.0%,24m
17939,2,IIIIIIIIIIII,3001,0,0,1,1,0.0%,10m
17939,2,boubz,3001,0,0,1,1,0.0%,6m
17939,2,chipie,3001,0,0,2,2,0.0%,21m
17939,2,ChrisPBacon,3001,0,0,2,2,0.0%,9m
17973,1,Zerg,3000,1662,233,225,458,50.9%,11m
17973,1,Tagernako,3000,1170,223,213,436,51.1%,14m
17973,2,Bloodthirst,3000,728,87,77,164,53.0%,13m
17973,3,[Esply]EsplyEd,3000,705,50,45,95,52.6%,14m
17973,1,[S1MPLE]Mrnousak,3000,794,42,28,70,60.0%,10m
17973,2,solovey,3000,755,38,31,69,55.1%,18m
17973,3,KoivunHerra,3000,495,34,36,70,48.6%,10m
17973,2,MufasaPrime,3000,607,32,29,61,52.5%,3m
17973,2,DrGreenthumb,3000,644,30,12,42,71.4%,24m
17973,2,ScottyBoom,3000,248,22,12,34,64.7%,6m
17973,1,Rusifikator,3000,540,22,18,40,55.0%,5m
17973,2,[Sapcrf]yatagan,3000,509,20,14,34,58.8%,7m
17973,1,xaverseltsam,3000,435,15,14,29,51.7%,21m
17973,2,riskohusak,3000,367,13,15,28,46.4%,9m
17973,1,Blazerg,3000,355,13,17,30,43.3%,13m
17973,1,SleKKiT,3000,331,11,11,22,50.0%,5m
17973,3,MrBean,3000,362,11,30,41,26.8%,6m
17973,2,Reckvus,3000,270,10,5,15,66.7%,6m
17973,2,ISHII,3000,286,10,6,16,62.5%,20m
17973,2,[KZORG]Frankinjo,3000,148,6,6,12,50.0%,18m
17973,2,Alpachino,3000,0,5,0,5,100.0%,21m
17973,1,Kidosick,3000,48,4,3,7,57.1%,3m
17973,3,oksi,3000,97,4,4,8,50.0%,34m
17973,1,[NTD]Tulakhord,3000,0,3,2,5,60.0%,1h
17973,2,Wyrda,3000,60,3,2,5,60.0%,5m
17973,2,Sam,3000,112,2,2,4,50.0%,15m
17973,1,[DACF]Lars,3000,36,2,5,7,28.6%,11m
17973,1,[UAONE]shadowstorm,3000,0,1,0,1,100.0%,57m
17973,1,Cronos,3000,97,1,1,2,50.0%,1h
17973,2,tamse,3000,30,1,1,2,50.0%,11m
17973,2,[NWGD]Freezy,3000,30,1,1,2,50.0%,10m
17973,2,Oxima,3000,30,1,2,3,33.3%,7m
17973,1,Hannibal,3000,0,1,5,6,16.7%,14m
17973,2,Mateszopsz,3000,0,0,1,1,0.0%,5m
17973,2,Penetrator,3000,0,0,2,2,0.0%,10m
17973,2,[HZeS]Koenigsegg,3000,0,0,2,2,0.0%,9m
17973,2,[0108]Mathmagician,3000,0,0,3,3,0.0%,7m
18010,3,Griff,2999,1145,513,516,1029,49.9%,12m
18010,2,RevolteC,2999,1603,171,133,304,56.2%,15m
18010,3,Серёжа,2999,797,154,123,277,55.6%,7m
18010,1,[ExTr1m]Bruccie,2999,1503,102,104,206,49.5%,13m
18010,1,[KMA90]TYaGal,2999,1170,96,90,186,51.6%,22m
18010,3,[Iteuil]Flam,2999,1504,93,103,196,47.4%,13m
18010,2,Lynx,2999,1322,56,59,115,48.7%,24m
18010,3,Ori,2999,280,37,43,80,46.2%,19m
18010,1,IVAKIN,2999,697,25,23,48,52.1%,11m
18010,1,[VIIDCS]StonedMole,2999,832,25,32,57,43.9%,10m
18010,1,Jasperera,2999,514,20,15,35,57.1%,12m
18010,1,[NaSV]JaddNS,2999,498,18,16,34,52.9%,7m
18010,1,Drax,2999,306,16,13,29,55.2%,4m
18010,1,gsl,2999,482,15,19,34,44.1%,4m
18010,1,Yarin,2999,315,14,12,26,53.8%,10m
18010,1,UberSasha,2999,478,14,17,31,45.2%,4m
18010,1,Jesu,2999,336,10,12,22,45.5%,9m
18010,1,[FreeGT]StrangeMan,2999,263,8,15,23,34.8%,10m
18010,1,SwagHound,2999,145,6,5,11,54.5%,24m
18010,1,Manfred,2999,48,5,2,7,71.4%,27m
18010,2,[TOPZIK]Kinson,2999,162,5,2,7,71.4%,7m
18010,1,sanchez,2999,144,5,8,13,38.5%,21m
18010,2,[QWEZXC]XuMuK,2999,88,4,2,6,66.7%,22m
18010,2,JInzhiyu,2999,129,4,2,6,66.7%,18m
18010,1,[GŁ]HUNTY,2999,38,4,5,9,44.4%,14m
18010,1,NoahGetBoat,2999,0,3,2,5,60.0%,1h
18010,2,[Dniw3]StoneSculpt,2999,60,3,3,6,50.0%,21m
18010,2,Diego,2999,66,3,3,6,50.0%,10m
18010,2,Nanuk,2999,30,2,0,2,100.0%,6m
18010,1,[dd33nt]daJonas,2999,0,2,3,5,40.0%,43m
18010,2,Varrag,2999,0,0,1,1,0.0%,18m
18010,2,РАСTAMAH,2999,0,0,1,1,0.0%,18m
18010,1,[Kingal]DrakonCHLEN,2999,0,0,1,1,0.0%,42m
18010,2,SpookySound,2999,0,0,1,1,0.0%,10m
18010,2,[NBRK]GroVe,2999,0,0,4,4,0.0%,24m
18010,2,Jawiah,2999,0,0,4,4,0.0%,10m
18046,2,Nethog,2998,1176,194,182,376,51.6%,9m
18046,2,Eqth,2998,1394,178,159,337,52.8%,10m
18046,1,RedRush,2998,1055,177,162,339,52.2%,14m
18046,2,DarkOopa,2998,1675,80,80,160,50.0%,18m
18046,3,СИЛ,2998,365,80,86,166,48.2%,21m
18046,3,aScDeadcam,2998,556,80,87,167,47.9%,6m
18046,1,XraY,2998,1325,79,80,159,49.7%,11m
18046,2,градинаря,2998,1079,61,59,120,50.8%,14m
18046,1,Southoak,2998,506,45,41,86,52.3%,6m
18046,1,Bltizo,2998,821,44,42,86,51.2%,13m
18046,2,BossToBoss,2998,760,31,24,55,56.4%,6m
18046,1,RickSanchez,2998,698,28,29,57,49.1%,6m
18046,1,[PRAIM]ApeKing,2998,433,22,18,40,55.0%,14m
18046,1,NannyState,2998,360,11,16,27,40.7%,24m
18046,2,Pasques,2998,289,10,15,25,40.0%,9m
18046,2,Hervé,2998,223,9,2,11,81.8%,6m
18046,2,Pixel,2998,185,7,6,13,53.8%,47m
18046,2,Laker,2998,180,7,6,13,53.8%,13m
18046,2,[FGStar]SealOil,2998,143,6,3,9,66.7%,16m
18046,3,Starwarrior,2998,145,6,3,9,66.7%,29m
18046,1,borny,2998,128,5,6,11,45.5%,21m
18046,2,[POGGER]kinAtrA,2998,118,4,3,7,57.1%,23m
18046,3,HorO,2998,116,4,4,8,50.0%,29m
18046,2,AntyKapeć,2998,58,3,0,3,100.0%,5m
18046,2,[RRT]Roly,2998,92,3,4,7,42.9%,7m
18046,2,Nightwalker,2998,30,2,0,2,100.0%,18m
18046,2,chelovek,2998,30,2,1,3,66.7%,17m
18046,2,mathi,2998,0,1,1,2,50.0%,13m
18046,1,[biteee]nanamisenu,2998,48,1,1,2,50.0%,4m
18046,2,Nizbeez,2998,0,0,1,1,0.0%,20m
18046,2,[HIYYYA]PlzBeGentle,2998,0,0,2,2,0.0%,12m
18077,3,Nikolopupus,2997,1393,114,111,225,50.7%,6m
18077,1,Realterm,2997,1602,99,99,198,50.0%,7m
18077,1,BlackDir,2997,1630,88,74,162,54.3%,22m
18077,1,Леденец,2997,1225,63,33,96,65.6%,22m
18077,2,Arturoh,2997,1089,46,38,84,54.8%,10m
18077,1,[CYG]Günterin,2997,685,25,23,48,52.1%,13m
18077,1,grogg,2997,396,17,18,35,48.6%,23m
18077,2,Akira,2997,208,14,12,26,53.8%,12m
18077,2,[43rus]Bot,2997,389,13,10,23,56.5%,17m
18077,2,[Room13]HaLD,2997,372,13,15,28,46.4%,13m
18077,2,[BTAG]Real,2997,174,7,5,12,58.3%,23m
18077,1,ThreshGR,2997,169,6,3,9,66.7%,56m
18077,2,Tomasberkut,2997,148,6,5,11,54.5%,4m
18077,1,GhostRider,2997,194,6,11,17,35.3%,12m
18077,2,Hurribeast,2997,88,4,2,6,66.7%,4m
18077,2,BMA,2997,0,3,2,5,60.0%,9m
18077,1,Letaguator,2997,0,3,2,5,60.0%,4m
18077,2,Zaton,2997,149,3,4,7,42.9%,18m
18077,2,heme,2997,30,2,3,5,40.0%,10m
18077,2,PocketMartin,2997,0,1,3,4,25.0%,9m
18077,2,gambit,2997,0,0,1,1,0.0%,14m
18077,2,Error,2997,0,0,1,1,0.0%,17m
18077,2,HappyRaccoon,2997,0,0,1,1,0.0%,19m
18077,2,Attar,2997,0,0,1,1,0.0%,18m
18077,2,[uCHAD]Gadzila,2997,0,0,1,1,0.0%,16m
18077,2,Smegg,2997,0,0,3,3,0.0%,18m
18077,1,[mfixed]Mello,2997,0,0,6,6,0.0%,6m
18104,2,Falham,2996,1614,299,269,568,52.6%,13m
18104,2,sultana,2996,999,93,77,170,54.7%,20m
18104,2,Neverland,2996,1414,61,47,108,56.5%,7m
18104,1,Stody,2996,657,26,22,48,54.2%,14m
18104,2,Max,2996,626,24,21,45,53.3%,18m
18104,1,[mfixed]Zeratulisk,2996,576,18,19,37,48.6%,6m
18104,2,Orionstar,2996,319,14,11,25,56.0%,6m
18104,1,[qtBois]Lykrir,2996,191,6,6,12,50.0%,29m
18104,1,FaMS,2996,0,4,1,5,80.0%,27m
18104,2,NOGAVKANAVE,2996,160,4,1,5,80.0%,20m
18104,2,Kcoo,2996,111,3,1,4,75.0%,24m
18104,1,exdil,2996,0,3,2,5,60.0%,49m
18104,2,bOOmer,2996,126,3,2,5,60.0%,6m
18104,1,IIIIIIIIIIII,2996,146,3,3,6,50.0%,27m
18104,2,Ingrimch,2996,114,3,5,8,37.5%,21m
18104,1,GogaMagoga,2996,112,3,8,11,27.3%,5m
18104,2,XLerate,2996,0,2,3,5,40.0%,20m
18104,2,HailMeruem,2996,58,2,5,7,28.6%,9m
18104,2,[UGHAGH]Ugh,2996,0,1,0,1,100.0%,14m
18104,2,Сайнок,2996,0,1,1,2,50.0%,6m
18104,2,INWY,2996,0,1,1,2,50.0%,23m
18104,1,soupy,2996,0,1,1,2,50.0%,23m
18104,2,NizioR,2996,0,1,2,3,33.3%,9m
18104,2,Stok,2996,0,1,3,4,25.0%,10m
18104,2,[Arrows]ParaBellum,2996,30,1,3,4,25.0%,10m
18104,2,PanMyśliwy,2996,30,1,5,6,16.7%,22m
18104,3,YmikaiCho,2996,36,1,6,7,14.3%,3m
18104,1,Andrii,2996,0,0,1,1,0.0%,12m
18132,3,[ЕМPIRE]Renesmee,2995,1416,81,98,179,45.3%,9m
18132,2,OceanLancer,2995,1079,61,58,119,51.3%,24m
18132,1,Hayner,2995,1234,58,48,106,54.7%,13m
18132,2,ReX,2995,274,56,27,83,67.5%,24m
18132,2,Rai,2995,580,22,17,39,56.4%,23m
18132,1,shaMash,2995,257,10,10,20,50.0%,19m
18132,1,[DaSon]Freak,2995,188,8,8,16,50.0%,31m
18132,3,Riegleren,2995,226,8,18,26,30.8%,6m
18132,2,[ITMA]MaNtiCorE,2995,146,6,5,11,54.5%,19m
18132,1,antimony,2995,138,6,6,12,50.0%,30m
18132,3,[TRNA]Lovesare,2995,144,5,4,9,55.6%,18m
18132,1,Veeh,2995,172,5,7,12,41.7%,8m
18132,2,tom,2995,88,4,2,6,66.7%,22m
18132,2,Darkside,2995,116,4,4,8,50.0%,8m
18132,2,Thraxen,2995,0,1,0,1,100.0%,10m
18132,2,apollóHUN,2995,30,1,3,4,25.0%,4m
18132,2,Alex,2995,0,1,4,5,20.0%,6m
18132,2,Beertje,2995,0,0,1,1,0.0%,10m
18132,2,[OU74]Зukk,2995,0,0,1,1,0.0%,23m
18132,2,GenoaSalami,2995,0,0,1,1,0.0%,10m
18132,2,Flubjig,2995,0,0,2,2,0.0%,7m
18153,3,Shwin,2994,1156,317,303,620,51.1%,3m
18153,1,kernel,2994,1678,251,249,500,50.2%,16m
18153,1,SwarmGost,2994,1391,208,184,392,53.1%,3m
18153,2,Анку,2994,1562,161,146,307,52.4%,9m
18153,1,TaldeeR,2994,1604,93,70,163,57.1%,11m
18153,2,Barmoglot,2994,1485,62,56,118,52.5%,24m
18153,2,butch,2994,1456,58,50,108,53.7%,20m
18153,2,Stone,2994,969,54,47,101,53.5%,20m
18153,1,Azerex,2994,855,46,37,83,55.4%,14m
18153,1,Tonesz,2994,781,33,27,60,55.0%,12m
18153,2,TariTara,2994,340,28,16,44,63.6%,12m
18153,1,Vedogor,2994,814,28,30,58,48.3%,9m
18153,1,[CTEHA]Odin,2994,771,26,28,54,48.1%,24m
18153,3,MechAnt,2994,538,18,29,47,38.3%,11m
18153,1,SingleMan,2994,164,15,20,35,42.9%,19m
18153,1,[RToTD]XeNon,2994,263,11,11,22,50.0%,5m
18153,1,FedorBrz,2994,318,9,19,28,32.1%,5m
18153,2,Green,2994,212,8,8,16,50.0%,21m
18153,1,LaXul,2994,199,7,6,13,53.8%,10m
18153,2,ImyourQueen,2994,182,6,2,8,75.0%,9m
18153,3,outrun,2994,0,5,2,7,71.4%,60m
18153,1,Riskari,2994,194,5,12,17,29.4%,11m
18153,1,[d3p]Goerk,2994,140,4,2,6,66.7%,58m
18153,2,Slim,2994,116,4,3,7,57.1%,21m
18153,1,TimeSplit,2994,48,4,3,7,57.1%,1h
18153,2,Nowliei,2994,128,4,6,10,40.0%,20m
18153,1,WindSteel,2994,102,4,7,11,36.4%,10m
18153,1,[Slunga]SpongeBob,2994,145,3,1,4,75.0%,14m
18153,2,EnOtIk,2994,60,3,1,4,75.0%,20m
18153,2,[ZЕRGTV]Keryb,2994,90,3,4,7,42.9%,18m
18153,1,TFC,2994,88,3,4,7,42.9%,13m
18153,1,[ReSw]Muronordan,2994,143,3,6,9,33.3%,3m
18153,2,[Smegin]CrazyFalcon,2994,167,3,6,9,33.3%,57m
18153,2,[NSVL]mutozek,2994,30,2,0,2,100.0%,7m
18153,2,Themarine,2994,0,2,2,4,50.0%,21m
18153,2,Guarani,2994,0,1,1,2,50.0%,6m
18153,2,Player,2994,0,1,1,2,50.0%,21m
18153,2,RobotWizard,2994,30,1,1,2,50.0%,6m
18153,2,Jon,2994,36,1,3,4,25.0%,7m
18153,2,[alu]uvran,2994,0,0,1,1,0.0%,13m
18153,2,Vorasha,2994,0,0,1,1,0.0%,21m
18153,2,Crunky,2994,0,0,1,1,0.0%,12m
18153,2,illyasviel,2994,0,0,1,1,0.0%,6m
18196,3,Alvaro,2993,1517,233,227,460,50.7%,9m
18196,1,Seamus,2993,1670,213,202,415,51.3%,8m
18196,1,[wiGGa]DmyTraG,2993,1662,101,86,187,54.0%,19m
18196,2,Keyster,2993,988,77,64,141,54.6%,7m
18196,1,icekrim,2993,1677,74,76,150,49.3%,8m
18196,3,Jade,2993,1366,73,73,146,50.0%,8m
18196,1,Wsen,2993,971,48,51,99,48.5%,16m
18196,2,Macheengun,2993,432,47,33,80,58.8%,9m
18196,1,NanoTr,2993,1059,38,38,76,50.0%,13m
18196,2,Dezz,2993,1024,37,40,77,48.1%,8m
18196,2,Mordenkainen,2993,301,22,13,35,62.9%,4m
18196,3,RussianBear,2993,582,20,29,49,40.8%,22m
18196,1,Mæger,2993,422,17,15,32,53.1%,8m
18196,2,[Ёbloki]DanchikLol,2993,333,14,10,24,58.3%,10m
18196,1,[MSUSC2]JoDSolo,2993,414,13,17,30,43.3%,23m
18196,1,chriss,2993,209,10,13,23,43.5%,7m
18196,3,Foggsi,2993,146,5,6,11,45.5%,44m
18196,2,poplers,2993,114,4,3,7,57.1%,21m
18196,2,[DZTK]zergbräter,2993,181,4,4,8,50.0%,8m
18196,1,Lucille,2993,148,4,6,10,40.0%,5m
18196,1,Natisar,2993,0,3,2,5,60.0%,5m
18196,2,Kiyomena,2993,88,2,1,3,66.7%,24m
18196,2,KINGKONG,2993,60,2,3,5,40.0%,4m
18196,1,YannickTamR,2993,78,2,8,10,20.0%,8m
18196,2,atanushev,2993,30,1,1,2,50.0%,23m
18196,2,KoT,2993,32,1,4,5,20.0%,4m
18196,2,Gandohar,2993,30,1,4,5,20.0%,6m
18196,2,[3DE]Namiator,2993,0,0,1,1,0.0%,16m
18196,2,Galaxor,2993,0,0,1,1,0.0%,1h
18196,2,Jacki,2993,0,0,1,1,0.0%,9m
18196,2,[BÄMM]SkiRoboter,2993,0,0,2,2,0.0%,17m
18196,2,PoZiTiVCHiK,2993,0,0,3,3,0.0%,7m
18228,1,Vishar,2992,512,112,95,207,54.1%,11m
18228,2,kukarsik,2992,1608,87,80,167,52.1%,24m
18228,2,Jackybauer,2992,1609,86,75,161,53.4%,16m
18228,3,derien,2992,1340,56,69,125,44.8%,18m
18228,1,Mephisto,2992,1348,51,50,101,50.5%,13m
18228,3,locb,2992,1385,48,61,109,44.0%,13m
18228,2,Gondou,2992,1160,46,42,88,52.3%,7m
18228,3,ClimateZone,2992,1129,43,51,94,45.7%,5m
18228,2,[WOSCHD]Koun,2992,844,32,30,62,51.6%,9m
18228,1,MisiAQ,2992,739,28,26,54,51.9%,9m
18228,2,[Radium]DFG,2992,570,21,21,42,50.0%,7m
18228,1,mosesI,2992,508,17,21,38,44.7%,11m
18228,3,[Jfv]hades,2992,349,14,10,24,58.3%,22m
18228,1,KOtyaviy,2992,339,13,14,27,48.1%,5m
18228,1,[1v1ez]Frolt,2992,402,11,19,30,36.7%,22m
18228,2,trueneu,2992,227,9,7,16,56.2%,24m
18228,2,Antondis,2992,187,8,6,14,57.1%,56m
18228,2,xirrag,2992,190,7,6,13,53.8%,53m
18228,3,leChrist,2992,207,7,12,19,36.8%,13m
18228,1,Psøøm,2992,256,7,14,21,33.3%,24m
18228,1,Deblaze,2992,212,6,4,10,60.0%,1h
18228,1,Biblo,2992,195,5,7,12,41.7%,8m
18228,2,[RIZY]Resønance,2992,118,4,5,9,44.4%,7m
18228,1,FroggyClyde,2992,104,3,10,13,23.1%,5m
18228,1,[NLS4]Guru,2992,0,1,0,1,100.0%,42m
18228,2,[Sløth]SoSicK,2992,0,1,1,2,50.0%,23m
18228,2,[IRBD]kingwarde,2992,0,1,1,2,50.0%,9m
18228,2,Dragula,2992,30,1,2,3,33.3%,7m
18228,2,ImperiaL,2992,30,1,2,3,33.3%,13m
18228,3,Eka,2992,0,1,3,4,25.0%,20m
18228,2,AlienFrisbee,2992,0,0,1,1,0.0%,9m
18228,2,SPLENDID,2992,0,0,1,1,0.0%,16m
18228,2,NumberOne,2992,0,0,2,2,0.0%,52m
18261,2,[PÂRłAH]Vlad,2991,1425,210,185,395,53.2%,16m
18261,2,murshroomik,2991,1151,50,34,84,59.5%,21m
18261,1,RONIN,2991,1062,41,36,77,53.2%,10m
18261,3,jackyd,2991,886,35,39,74,47.3%,6m
18261,2,Alchimist,2991,757,31,25,56,55.4%,4m
18261,2,LaCroix,2991,687,28,21,49,57.1%,10m
18261,2,Maxmald,2991,446,17,12,29,58.6%,23m
18261,3,GbGunjubas,2991,412,16,26,42,38.1%,13m
18261,3,[Z3RGTV]Yuracom,2991,464,16,30,46,34.8%,9m
18261,2,Liwhelm,2991,271,15,9,24,62.5%,7m
18261,3,Safais,2991,430,15,28,43,34.9%,8m
18261,2,Overbeat,2991,330,14,14,28,50.0%,9m
18261,3,ZORGALOG,2991,308,12,10,22,54.5%,14m
18261,2,Spawek,2991,114,4,4,8,50.0%,4m
18261,1,Chucky,2991,0,3,2,5,60.0%,6m
18261,1,[Dobrо]Element,2991,105,3,4,7,42.9%,9m
18261,1,JanzJenau,2991,90,3,4,7,42.9%,24m
18261,2,XFooLoR,2991,0,1,0,1,100.0%,24m
18261,2,[SCSEU]BenBytes,2991,0,1,0,1,100.0%,14m
18261,2,Limbo,2991,30,1,1,2,50.0%,8m
18261,2,[Jöthem]Bergamot,2991,30,1,1,2,50.0%,9m
18261,2,[Temeri]mistszu,2991,0,1,1,2,50.0%,15m
18261,3,Torkus,2991,40,1,1,2,50.0%,26m
18261,2,IIIIIIIIIIII,2991,0,0,1,1,0.0%,13m
18261,2,Sodomie,2991,0,0,1,1,0.0%,20m
18261,2,MarkuSidious,2991,0,0,4,4,0.0%,13m
18287,2,buczer,2990,1288,340,324,664,51.2%,3m
18287,1,[RUSMÜL]Trump,2990,1396,105,106,211,49.8%,23m
18287,2,HuGOo,2990,1596,101,98,199,50.8%,12m
18287,1,PrinzBobaFat,2990,1411,97,101,198,49.0%,7m
18287,3,[MmS]Alice,2990,337,77,76,153,50.3%,18m
18287,1,[SSGUK]Flooky,2990,1383,66,52,118,55.9%,13m
18287,1,[QkA]Claintic,2990,1573,60,64,124,48.4%,13m
18287,3,deadpool,2990,952,35,43,78,44.9%,19m
18287,1,[lolw0t]Harlequinok,2990,751,25,29,54,46.3%,7m
18287,2,Sovereign,2990,454,22,19,41,53.7%,12m
18287,2,Ravenor,2990,435,21,13,34,61.8%,12m
18287,2,[PANNON]Borden,2990,127,15,10,25,60.0%,18m
18287,1,[DKWR]sWARmKING,2990,369,15,17,32,46.9%,21m
18287,2,[FloPo]Narret,2990,328,12,12,24,50.0%,5m
18287,3,Leo,2990,376,12,22,34,35.3%,14m
18287,1,Isabelle,2990,284,11,10,21,52.4%,1h
18287,1,[UuB]OinksMoped,2990,328,11,10,21,52.4%,3m
18287,1,[1830]Pray,2990,400,11,20,31,35.5%,24m
18287,2,Touk,2990,226,8,8,16,50.0%,17m
18287,3,Gaisariks,2990,194,7,7,14,50.0%,46m
18287,1,alpha,2990,120,6,1,7,85.7%,40m
18287,1,marantent,2990,198,6,6,12,50.0%,23m
18287,2,[NADEON]Akilors,2990,88,4,2,6,66.7%,23m
18287,1,[bod]Joetheflow,2990,48,4,3,7,57.1%,1h
18287,3,XETO,2990,0,4,3,7,57.1%,6m
18287,2,[xSCVx]vinycz,2990,90,4,4,8,50.0%,15m
18287,2,Sollex,2990,0,3,2,5,60.0%,11m
18287,2,Ragschas,2990,58,3,3,6,50.0%,5m
18287,2,GreenAvoy,2990,86,3,4,7,42.9%,12m
18287,3,HUGO,2990,0,0,1,1,0.0%,38m
18287,2,Walker,2990,0,0,1,1,0.0%,7m
18287,2,[PTKM]Bundak,2990,0,0,1,1,0.0%,7m
18287,2,Wraith,2990,0,0,1,1,0.0%,23m
18287,3,Qwan,2990,0,0,1,1,0.0%,49m
18287,1,[lMMl]nunununununu,2990,0,0,2,2,0.0%,44m
18287,2,[DrChMa]Novastorm,2990,0,0,2,2,0.0%,8m
18287,2,GhOst,2990,0,0,2,2,0.0%,42m
18324,2,Korp,2989,1600,132,114,246,53.7%,23m
18324,2,[NGone]VindoViper,2989,1605,92,81,173,53.2%,7m
18324,2,Matos,2989,1168,63,52,115,54.8%,19m
18324,1,elserralfake,2989,829,32,31,63,50.8%,10m
18324,1,[NWGD]Destroyer,2989,570,21,17,38,55.3%,13m
18324,1,[НОД17]Djulus,2989,458,14,19,33,42.4%,7m
18324,1,Darves,2989,392,12,17,29,41.4%,5m
18324,1,CoalVi,2989,337,11,14,25,44.0%,7m
18324,3,[Pekа]Madness,2989,296,10,21,31,32.3%,22m
18324,2,Panem,2989,60,6,3,9,66.7%,23m
18324,1,DieForHeniek,2989,150,6,5,11,54.5%,13m
18324,3,BuflákÚr,2989,0,5,2,7,71.4%,33m
18324,2,afanan,2989,168,5,4,9,55.6%,52m
18324,2,Ruff,2989,173,5,5,10,50.0%,6m
18324,3,[P3rsé]astrocam,2989,0,4,4,8,50.0%,7m
18324,2,Hype,2989,0,3,2,5,60.0%,5m
18324,2,[PutinL]Rex,2989,0,3,2,5,60.0%,22m
18324,3,IIIIIIIIIIII,2989,139,3,3,6,50.0%,41m
18324,2,Vévé,2989,30,2,2,4,50.0%,12m
18324,2,[WTFvck]WTFljewr,2989,0,1,0,1,100.0%,12m
18324,2,Nokiva,2989,32,1,1,2,50.0%,24m
18324,1,EKOZERG,2989,0,1,2,3,33.3%,4m
18324,2,DontAtello,2989,0,0,6,6,0.0%,9m
18347,3,SEGREY,2988,1503,354,347,701,50.5%,6m
18347,1,azouldir,2988,820,75,65,140,53.6%,9m
18347,1,[LsCs]Juniorchik,2988,1215,46,42,88,52.3%,22m
18347,2,Crunge,2988,605,26,21,47,55.3%,6m
18347,1,HawkJoe,2988,580,24,21,45,53.3%,13m
18347,1,CaramelMilk,2988,460,19,15,34,55.9%,21m
18347,3,Ramius,2988,526,16,35,51,31.4%,13m
18347,2,PiranHa,2988,296,10,11,21,47.6%,6m
18347,3,walleout,2988,279,8,17,25,32.0%,20m
18347,2,Зелень,2988,216,7,11,18,38.9%,7m
18347,2,TPmfgZG,2988,136,5,4,9,55.6%,23m
18347,3,[NotEM]Edpayasugo,2988,97,4,4,8,50.0%,3m
18347,1,[PSTN]GrundaloO,2988,154,4,6,10,40.0%,4m
18347,2,[frruju]frido,2988,58,3,0,3,100.0%,10m
18347,2,Shakira,2988,0,3,2,5,60.0%,24m
18347,2,[PÂRłAH]Millamber,2988,90,3,4,7,42.9%,8m
18347,2,Halim,2988,30,2,2,4,50.0%,8m
18347,2,GratisKatze,2988,0,1,0,1,100.0%,9m
18347,2,[SortDD]Fako,2988,44,1,1,2,50.0%,5m
18347,3,[CF0rce]ZiTsCh,2988,34,1,1,2,50.0%,45m
18347,2,[sonic1]Minitur,2988,0,0,2,2,0.0%,7m
18368,1,[Freeze]Protec,2987,1011,108,114,222,48.6%,6m
18368,3,[TheDOH]Moonkid,2987,1227,88,108,196,44.9%,13m
18368,3,Alexey,2987,851,72,85,157,45.9%,5m
18368,2,zero,2987,824,36,22,58,62.1%,6m
18368,2,lohkar,2987,667,34,14,48,70.8%,8m
18368,2,[НG]CaptainSwarm,2987,326,25,21,46,54.3%,17m
18368,1,Spooj,2987,520,24,14,38,63.2%,9m
18368,2,EntoN,2987,597,23,15,38,60.5%,13m
18368,2,Luckyzergin,2987,329,22,18,40,55.0%,5m
18368,2,[xFRSx]Rafus,2987,255,11,6,17,64.7%,8m
18368,1,[ncotic]basti,2987,302,11,20,31,35.5%,5m
18368,1,Daroude,2987,221,9,4,13,69.2%,14m
18368,2,[ODGW]TheZealot,2987,161,9,11,20,45.0%,6m
18368,2,dmksbk,2987,236,8,8,16,50.0%,5m
18368,2,[xDOOBx]Fallope,2987,225,7,9,16,43.8%,1h
18368,2,Toine,2987,140,6,4,10,60.0%,21m
18368,1,[Whoaaa]DarkKrix,2987,212,6,11,17,35.3%,5m
18368,2,Baracouda,2987,0,3,2,5,60.0%,11m
18368,2,StarCloNe,2987,0,3,2,5,60.0%,21m
18368,2,WhoAmI,2987,0,3,2,5,60.0%,7m
18368,2,[NLTHB]ReFruity,2987,30,2,0,2,100.0%,21m
18368,2,[D0N3]Badabing,2987,30,2,1,3,66.7%,10m
18368,1,[BFG3K]Macioss,2987,118,2,2,4,50.0%,44m
18368,1,[4TwenT]Fistaya,2987,125,2,6,8,25.0%,3m
18368,2,Jaws,2987,0,1,0,1,100.0%,5m
18368,2,KzD,2987,30,1,2,3,33.3%,6m
18368,2,[DPYT]tsepesh,2987,30,1,3,4,25.0%,8m
18368,2,Majamila,2987,34,1,4,5,20.0%,6m
18368,2,INQUISITOR,2987,38,1,4,5,20.0%,7m
18368,2,josemaxito,2987,0,0,1,1,0.0%,13m
18368,2,Mivcheg,2987,0,0,1,1,0.0%,9m
18399,2,sophist,2986,1398,324,319,643,50.4%,7m
18399,1,YugeWang,2986,1037,55,52,107,51.4%,6m
18399,1,Limpalex,2986,233,33,25,58,56.9%,5m
18399,2,Rayreborned,2986,496,20,16,36,55.6%,8m
18399,1,PTTUSER,2986,345,15,13,28,53.6%,6m
18399,2,Ven,2986,296,15,15,30,50.0%,15m
18399,2,SleezyTobey,2986,342,14,9,23,60.9%,24m
18399,2,eatownleg,2986,350,14,11,25,56.0%,19m
18399,1,GhalMaraz,2986,478,14,25,39,35.9%,12m
18399,2,[DL2006]Dioniso,2986,261,13,7,20,65.0%,19m
18399,2,[MeoWS]Fanf,2986,368,13,11,24,54.2%,12m
18399,1,Shatraf,2986,207,12,16,28,42.9%,6m
18399,2,WolFeaR,2986,220,7,11,18,38.9%,5m
18399,2,AlexisLionel,2986,201,6,8,14,42.9%,12m
18399,2,[0001]Bredator,2986,0,5,0,5,100.0%,22m
18399,1,Odin,2986,88,5,2,7,71.4%,13m
18399,2,[J4E]Raven,2986,114,5,4,9,55.6%,6m
18399,1,eRRor,2986,174,5,11,16,31.2%,10m
18399,2,[NoGy]Liebingabbo,2986,136,4,0,4,100.0%,23m
18399,2,Eliarh,2986,0,4,1,5,80.0%,12m
18399,2,Irri,2986,0,3,2,5,60.0%,7m
18399,1,Mist,2986,0,3,3,6,50.0%,16m
18399,2,ULTRAKILL,2986,30,2,0,2,100.0%,20m
18399,2,[Numpty]LittleHazy,2986,30,2,1,3,66.7%,19m
18399,2,Clay,2986,0,1,0,1,100.0%,20m
18399,2,[GSLs]BioS,2986,0,1,0,1,100.0%,6m
18399,2,Captrain,2986,30,1,1,2,50.0%,23m
18399,2,miko,2986,30,1,1,2,50.0%,10m
18399,1,Draren,2986,0,0,1,1,0.0%,59m
18399,3,Kyle,2986,0,0,2,2,0.0%,19m
18429,3,Ormando,2985,1327,238,221,459,51.9%,23m
18429,1,[ƬC]Zix,2985,1644,105,106,211,49.8%,14m
18429,1,FisherKing,2985,1363,86,93,179,48.0%,7m
18429,2,[WANG]Ling,2985,1303,74,55,129,57.4%,8m
18429,1,jelo,2985,1439,74,74,148,50.0%,6m
18429,3,Falkhorn,2985,1110,68,75,143,47.6%,5m
18429,1,deeew,2985,905,60,48,108,55.6%,14m
18429,2,AlcatraZ,2985,1034,38,39,77,49.4%,9m
18429,2,Drake,2985,571,32,14,46,69.6%,10m
18429,2,Mangouste,2985,940,32,36,68,47.1%,10m
18429,1,MrBrown,2985,704,23,32,55,41.8%,21m
18429,2,Colichou,2985,500,19,16,35,54.3%,7m
18429,2,Nalyasikyyyy,2985,341,14,11,25,56.0%,20m
18429,3,rgSoL,2985,315,12,11,23,52.2%,21m
18429,1,Primaeval,2985,141,7,6,13,53.8%,53m
18429,2,Gubbins,2985,204,7,11,18,38.9%,15m
18429,2,[Kovaci]Dzukadin,2985,89,6,8,14,42.9%,15m
18429,2,Hunter,2985,88,4,1,5,80.0%,12m
18429,1,Shnobel,2985,97,4,2,6,66.7%,12m
18429,2,[DSP]Streit,2985,120,4,5,9,44.4%,9m
18429,2,Fab,2985,126,4,9,13,30.8%,8m
18429,2,king,2985,58,3,0,3,100.0%,8m
18429,1,Atze,2985,97,3,3,6,50.0%,28m
18429,2,[lolw0t]Vegan,2985,0,3,3,6,50.0%,20m
18429,3,[Rakii]Tristar,2985,97,2,2,4,50.0%,51m
18429,2,[scarc2]Monolit,2985,0,1,0,1,100.0%,13m
18429,1,Nodorf,2985,0,1,4,5,20.0%,8m
18429,2,JadranKrt,2985,0,0,1,1,0.0%,6m
18457,2,DeFract,2984,1593,208,197,405,51.4%,22m
18457,2,[OcК]ReeFox,2984,1368,75,53,128,58.6%,7m
18457,2,[TaKeUL]Hirnspalter,2984,812,31,33,64,48.4%,10m
18457,1,[hf4X4]ProfKahre,2984,725,30,25,55,54.5%,11m
18457,1,tokoinho,2984,737,28,29,57,49.1%,14m
18457,1,Wandera,2984,910,28,40,68,41.2%,14m
18457,2,Zerran,2984,509,27,25,52,51.9%,10m
18457,3,Malzii,2984,659,27,27,54,50.0%,23m
18457,1,[SLOTH]Jebús,2984,212,23,23,46,50.0%,7m
18457,2,frnchtoastf,2984,386,21,21,42,50.0%,22m
18457,2,Zigzagzog,2984,468,19,11,30,63.3%,21m
18457,3,Hirich,2984,420,16,18,34,47.1%,8m
18457,2,yayamotto,2984,387,15,9,24,62.5%,23m
18457,2,Ignat,2984,366,14,11,25,56.0%,9m
18457,2,Bluesman,2984,284,10,9,19,52.6%,12m
18457,2,Capybara,2984,260,10,11,21,47.6%,21m
18457,2,[pugio]byxapukl,2984,254,9,7,16,56.2%,18m
18457,2,HrSpEgEpØlSe,2984,266,8,6,14,57.1%,18m
18457,1,theconker,2984,200,8,11,19,42.1%,11m
18457,2,Karacuk,2984,146,6,4,10,60.0%,12m
18457,2,Distance,2984,122,4,7,11,36.4%,18m
18457,2,[LBGTQ]Assblaster,2984,153,3,6,9,33.3%,18m
18457,2,[K0RM2]DoKToR,2984,62,2,2,4,50.0%,22m
18457,2,[AQR]AQRpogpog,2984,0,1,3,4,25.0%,13m
18457,2,Dracool,2984,0,0,2,2,0.0%,7m
18482,3,FROG,2983,1529,204,216,420,48.6%,24m
18482,2,Eremak,2983,1568,165,151,316,52.2%,12m
18482,2,emue,2983,1536,143,122,265,54.0%,7m
18482,1,Кирк,2983,852,111,108,219,50.7%,5m
18482,1,[NWGD]GranAdmiral,2983,1509,103,99,202,51.0%,9m
18482,2,Karltomwaffe,2983,1507,81,69,150,54.0%,11m
18482,2,debussy,2983,1559,66,60,126,52.4%,20m
18482,2,Firefly,2983,1063,61,56,117,52.1%,21m
18482,3,Whitenova,2983,789,41,39,80,51.2%,13m
18482,1,Splicer,2983,601,37,42,79,46.8%,23m
18482,2,Havelykke,2983,756,29,30,59,49.2%,15m
18482,3,llllllllllll,2983,668,24,26,50,48.0%,10m
18482,1,МруКакМуха,2983,509,19,18,37,51.4%,3m
18482,2,zext,2983,391,15,19,34,44.1%,19m
18482,2,qOrLrp,2983,380,14,14,28,50.0%,16m
18482,2,AnalogoN,2983,275,12,7,19,63.2%,11m
18482,1,BriVicShadow,2983,348,12,12,24,50.0%,23m
18482,1,[RNP]Corrsive,2983,218,8,14,22,36.4%,14m
18482,2,Szipka,2983,208,7,7,14,50.0%,9m
18482,1,[ĦĦ]galen,2983,97,3,1,4,75.0%,32m
18482,1,XXXXXXXXXXXX,2983,159,2,9,11,18.2%,11m
18482,2,[IBproo]FJayFarek,2983,0,1,0,1,100.0%,22m
18482,2,[YAMAHA]Demia,2983,34,1,1,2,50.0%,21m
18482,2,[UAŦeam]Faeton,2983,30,1,1,2,50.0%,24m
18482,2,[SVGS]RAPHYIR,2983,0,1,1,2,50.0%,16m
18482,2,llllllllllll,2983,30,1,2,3,33.3%,11m
18482,2,Gordijus,2983,30,1,4,5,20.0%,21m
18482,2,RacoD,2983,0,0,1,1,0.0%,8m
18482,2,Isle,2983,0,0,1,1,0.0%,18m
18511,3,Willy,2982,1563,198,211,409,48.4%,22m
18511,2,Bloddyelbow,2982,1497,147,127,274,53.6%,23m
18511,1,ValeX,2982,975,99,82,181,54.7%,5m
18511,1,[NAICHA]Sheepy,2982,612,85,82,167,50.9%,19m
18511,2,[QMnewb]Gringotseru,2982,805,45,42,87,51.7%,15m
18511,1,bigkrp,2982,725,38,41,79,48.1%,14m
18511,3,[FTEII]FTElite,2982,760,32,29,61,52.5%,18m
18511,2,Hellsound,2982,499,26,21,47,55.3%,23m
18511,1,ZZsuperZero,2982,402,20,22,42,47.6%,24m
18511,1,[GaMToX]TaKMashido,2982,524,16,22,38,42.1%,5m
18511,2,[13NRV]Argnaras,2982,255,11,7,18,61.1%,59m
18511,2,[VVA]BigNoob,2982,322,11,13,24,45.8%,16m
18511,2,[coors]coorsllte,2982,208,8,6,14,57.1%,12m
18511,1,MrJohnRing,2982,120,7,4,11,63.6%,25m
18511,2,TiiviTaavi,2982,166,6,0,6,100.0%,8m
18511,3,ChefBuff,2982,146,6,4,10,60.0%,41m
18511,3,Bagelstein,2982,120,5,3,8,62.5%,23m
18511,2,[DFYIII]Tta,2982,90,5,6,11,45.5%,24m
18511,2,PaiNFuL,2982,0,4,1,5,80.0%,21m
18511,2,[RüMBo]JoBro,2982,38,2,2,4,50.0%,12m
18511,2,[prbswm]alekseyces,2982,102,2,2,4,50.0%,16m
18511,2,kusakiri,2982,62,2,3,5,40.0%,18m
18511,2,ScareCrow,2982,0,1,0,1,100.0%,10m
18511,1,Trucik,2982,32,1,8,9,11.1%,24m
18511,2,ZelenyDYM,2982,0,0,1,1,0.0%,22m
18511,2,[T0RI]ony,2982,0,0,1,1,0.0%,11m
18511,2,bodryachock,2982,0,0,3,3,0.0%,13m
18511,1,[Hkni]hkMalaqias,2982,0,0,6,6,0.0%,6m
18539,1,Nosfery,2981,1669,334,328,662,50.5%,22m
18539,2,bobby,2981,1359,75,63,138,54.3%,18m
18539,2,KorObaKinari,2981,899,73,57,130,56.2%,8m
18539,3,prettymofukk,2981,1475,65,71,136,47.8%,6m
18539,3,HaveAniceDay,2981,756,57,68,125,45.6%,20m
18539,2,[VGW]Bernard,2981,1408,54,54,108,50.0%,8m
18539,1,WEB,2981,1405,53,52,105,50.5%,6m
18539,2,Kinch,2981,1198,47,43,90,52.2%,12m
18539,1,wowvaqa,2981,888,29,37,66,43.9%,22m
18539,1,Najash,2981,613,26,34,60,43.3%,6m
18539,2,Kirimtor,2981,516,21,13,34,61.8%,21m
18539,2,[Juju]Plagueis,2981,415,16,9,25,64.0%,23m
18539,2,DanteJusTesT,2981,198,8,6,14,57.1%,9m
18539,2,Кикита,2981,131,7,2,9,77.8%,16m
18539,2,TKACH,2981,180,4,3,7,57.1%,37m
18539,2,PplzSht,2981,60,3,1,4,75.0%,7m
18539,2,Садовник,2981,0,3,2,5,60.0%,10m
18539,2,ANTOX,2981,86,3,5,8,37.5%,9m
18539,3,Ghost,2981,97,2,0,2,100.0%,31m
18539,2,[LUDOLF]gluso,2981,46,2,1,3,66.7%,16m
18539,1,[DTBM]UhrU,2981,66,2,9,11,18.2%,3m
18539,2,Schluffi,2981,0,1,0,1,100.0%,22m
18539,2,[REGGE]SEAR,2981,0,1,0,1,100.0%,44m
18539,2,kickbear,2981,30,1,1,2,50.0%,12m
18539,2,argeitqu,2981,30,1,2,3,33.3%,5m
18539,1,timofey,2981,0,1,4,5,20.0%,33m
18539,2,NiveiCe,2981,0,0,1,1,0.0%,8m
18539,1,[Scam]CarimJamal,2981,0,0,5,5,0.0%,5m
18567,3,Ziggy,2980,1346,181,185,366,49.5%,5m
18567,1,Piko,2980,1584,150,143,293,51.2%,9m
18567,2,FilaBita,2980,993,53,36,89,59.6%,19m
18567,2,simpo,2980,882,39,42,81,48.1%,15m
18567,2,JoeBanana,2980,783,35,28,63,55.6%,21m
18567,2,Weeger,2980,389,22,12,34,64.7%,12m
18567,1,[mfixed]Craft,2980,630,20,25,45,44.4%,14m
18567,1,Brainshack,2980,504,16,23,39,41.0%,19m
18567,2,carrera,2980,228,9,2,11,81.8%,21m
18567,2,Dmitrov,2980,234,9,8,17,52.9%,5m
18567,1,bogiman,2980,215,5,9,14,35.7%,11m
18567,2,Reistry,2980,180,5,10,15,33.3%,38m
18567,2,[blur]ABORT,2980,88,4,2,6,66.7%,7m
18567,2,[TSC2C]chudini,2980,58,3,3,6,50.0%,5m
18567,2,farfadet,2980,90,3,4,7,42.9%,8m
18567,3,pusswy,2980,97,2,1,3,66.7%,52m
18567,1,Rioss,2980,88,1,4,5,20.0%,7m
18567,1,Elarion,2980,89,1,4,5,20.0%,24m
18567,1,Daptrius,2980,0,1,5,6,16.7%,6m
18567,1,Finwych,2980,0,0,1,1,0.0%,5m
18567,2,Zodiac,2980,0,0,1,1,0.0%,7m
18567,2,RIPIIII,2980,0,0,1,1,0.0%,11m
18567,2,Darkarchon,2980,0,0,1,1,0.0%,1h
18567,2,GolDaniels,2980,0,0,1,1,0.0%,10m
18591,1,stressor,2979,1383,101,96,197,51.3%,10m
18591,2,[НОД17]Ghostmarine,2979,1515,84,71,155,54.2%,24m
18591,3,[BTEU]AnikiCooking,2979,1240,84,86,170,49.4%,7m
18591,1,bspace,2979,477,28,28,56,50.0%,6m
18591,1,[Moisty]Ilyen,2979,241,13,8,21,61.9%,19m
18591,2,Gordo,2979,214,10,4,14,71.4%,23m
18591,2,Youruch,2979,220,9,6,15,60.0%,16m
18591,2,Jekko,2979,176,9,6,15,60.0%,5m
18591,1,IIIIIIIIIIII,2979,202,8,9,17,47.1%,6m
18591,2,FaNtik,2979,241,7,8,15,46.7%,6m
18591,2,Riichard,2979,144,6,5,11,54.5%,12m
18591,2,Orvoloson,2979,90,4,3,7,57.1%,23m
18591,2,[GTkz]Afthor,2979,58,3,1,4,75.0%,7m
18591,1,Kaldy,2979,0,3,2,5,60.0%,22m
18591,2,[THESCV]WorstPlayer,2979,90,3,5,8,37.5%,7m
18591,2,GodsRage,2979,0,2,3,5,40.0%,12m
18591,2,[DOKA2]СтарыйВолк,2979,0,1,0,1,100.0%,18m
18591,2,Seifer,2979,0,1,1,2,50.0%,13m
18591,2,[SSOO]JimRaynor,2979,32,1,4,5,20.0%,13m
18591,2,EricDraven,2979,0,0,1,1,0.0%,7m
18591,2,Nobaka,2979,0,0,1,1,0.0%,21m
18591,2,Vestnik,2979,0,0,1,1,0.0%,21m
18591,2,[HoWaY]Mando,2979,0,0,2,2,0.0%,20m
18591,2,HappyHour,2979,0,0,4,4,0.0%,23m
18615,1,[C0M]Nickelicious,2978,940,192,162,354,54.2%,5m
18615,1,Miraxle,2978,1572,76,68,144,52.8%,4m
18615,1,EvilSoda,2978,1198,46,42,88,52.3%,13m
18615,2,Naruto,2978,799,37,19,56,66.1%,6m
18615,1,[HNS]Knut,2978,926,31,36,67,46.3%,6m
18615,2,Zergatul,2978,672,30,22,52,57.7%,11m
18615,3,Wiseman,2978,406,15,25,40,37.5%,19m
18615,2,Fenrisson,2978,355,13,9,22,59.1%,13m
18615,2,[Achtun]vadim,2978,286,11,10,21,52.4%,10m
18615,2,shjOoR,2978,278,11,12,23,47.8%,10m
18615,2,Zergulya,2978,220,10,5,15,66.7%,12m
18615,2,IIIIIIIIIIII,2978,200,8,8,16,50.0%,12m
18615,2,[Svin4]KISSARMY,2978,174,7,5,12,58.3%,9m
18615,3,Glab,2978,30,5,5,10,50.0%,3m
18615,1,legendman,2978,0,4,1,5,80.0%,41m
18615,2,spah,2978,0,4,1,5,80.0%,6m
18615,1,CoolAid,2978,48,3,2,5,60.0%,21m
18615,2,Graphic,2978,20,2,0,2,100.0%,8m
18615,2,[ehe2]Mephistophel,2978,60,2,3,5,40.0%,7m
18615,2,azanta,2978,0,1,0,1,100.0%,7m
18615,2,Beast,2978,27,1,2,3,33.3%,6m
18615,2,InspektorKot,2978,0,0,1,1,0.0%,21m
18615,2,[DayJ]Fozzy,2978,0,0,2,2,0.0%,10m
18615,2,[BRNL]RoGueSheeP,2978,0,0,4,4,0.0%,18m
18639,1,Vintage,2977,1118,141,140,281,50.2%,23m
18639,2,Dakala,2977,1617,97,78,175,55.4%,7m
18639,1,[nCoV]Redwazer,2977,1186,86,91,177,48.6%,14m
18639,2,Pokebowl,2977,838,35,28,63,55.6%,13m
18639,2,Flakon,2977,852,32,34,66,48.5%,7m
18639,1,[HFR]Redeyed,2977,686,29,24,53,54.7%,19m
18639,3,Rainbows,2977,852,29,37,66,43.9%,13m
18639,1,Kuzze,2977,707,25,26,51,49.0%,3m
18639,2,[ШиШаНы]Nyashka,2977,420,19,14,33,57.6%,10m
18639,2,[eXeInt]MasterMinder,2977,379,16,14,30,53.3%,11m
18639,2,Dimale,2977,344,12,12,24,50.0%,20m
18639,2,zigaPRM,2977,245,10,3,13,76.9%,23m
18639,2,higgins,2977,242,10,8,18,55.6%,20m
18639,2,[abffl]hotMom,2977,167,8,5,13,61.5%,23m
18639,1,froniu,2977,264,8,9,17,47.1%,4m
18639,2,Mithrandir,2977,232,8,10,18,44.4%,18m
18639,1,Waitch,2977,260,7,9,16,43.8%,54m
18639,3,Neurogenesis,2977,150,6,16,22,27.3%,15m
18639,3,[CriteS]Stealther,2977,121,5,4,9,55.6%,25m
18639,2,[Trran]Commander,2977,155,4,3,7,57.1%,12m
18639,2,Vrednyj,2977,88,3,2,5,60.0%,7m
18639,2,AnOObis,2977,86,3,3,6,50.0%,19m
18639,2,[NiW]Marquise,2977,30,2,3,5,40.0%,5m
18639,1,[P3T]CptAwesome,2977,72,2,8,10,20.0%,20m
18639,2,Jubai,2977,0,1,0,1,100.0%,7m
18639,2,IIIIIIIIIIII,2977,0,1,1,2,50.0%,23m
18639,2,NoMads,2977,0,1,1,2,50.0%,12m
18639,2,Eindbaas,2977,30,1,2,3,33.3%,6m
18639,2,CrAtoS,2977,0,1,3,4,25.0%,23m
18639,2,Sergio,2977,0,0,1,1,0.0%,4m
18639,2,Barcode,2977,0,0,1,1,0.0%,10m
18639,2,[PizdaD]Amen,2977,0,0,2,2,0.0%,10m
18639,2,Ded,2977,0,0,2,2,0.0%,7m
18672,1,Yoru,2976,1662,154,127,281,54.8%,14m
18672,2,Patates,2976,1089,50,41,91,54.9%,12m
18672,2,[CS0]LingLad,2976,924,40,27,67,59.7%,7m
18672,2,valkata,2976,673,34,29,63,54.0%,24m
18672,2,bool,2976,162,31,28,59,52.5%,7m
18672,2,Prodigum,2976,709,27,23,50,54.0%,7m
18672,1,graal,2976,688,24,28,52,46.2%,5m
18672,2,Seb,2976,524,21,18,39,53.8%,6m
18672,2,[BCFW]datrandomguy,2976,397,18,5,23,78.3%,24m
18672,1,matttti,2976,308,16,15,31,51.6%,20m
18672,2,Apathy,2976,265,10,8,18,55.6%,16m
18672,2,zsolo,2976,227,9,7,16,56.2%,20m
18672,2,LоrdDeSeike,2976,244,8,11,19,42.1%,9m
18672,2,pabl,2976,155,7,2,9,77.8%,14m
18672,2,HasNot,2976,172,7,5,12,58.3%,6m
18672,2,[ZHxPro]DeltaFirst,2976,114,5,3,8,62.5%,23m
18672,2,[See]wolle,2976,122,4,8,12,33.3%,24m
18672,2,[DFTW]Pteranodon,2976,0,1,0,1,100.0%,11m
18672,2,VivaVilla,2976,30,1,2,3,33.3%,20m
18672,2,[SevnUP]Bonpepito,2976,30,1,6,7,14.3%,9m
18672,1,Skip,2976,30,1,7,8,12.5%,14m
18672,2,martinez,2976,0,0,1,1,0.0%,18m
18672,2,Beatso,2976,0,0,1,1,0.0%,12m
18672,2,[TATW]ShadoW,2976,0,0,1,1,0.0%,13m
18672,2,adem,2976,0,0,2,2,0.0%,13m
18672,2,Cassadian,2976,0,0,3,3,0.0%,22m
18698,2,[FD69]GXTachtZWO,2975,1628,199,181,380,52.4%,15m
18698,1,zerginator,2975,1266,129,108,237,54.4%,11m
18698,3,Hurtone,2975,1564,128,139,267,47.9%,22m
18698,1,SerafinStw,2975,1665,110,108,218,50.5%,8m
18698,2,Kirik,2975,719,67,64,131,51.1%,18m
18698,2,BoissonTemps,2975,1368,56,49,105,53.3%,11m
18698,1,rideez,2975,810,45,37,82,54.9%,12m
18698,1,Vylyn,2975,471,35,27,62,56.5%,24m
18698,1,[ValidG]snusmumriken,2975,576,19,22,41,46.3%,23m
18698,2,Spellwringer,2975,417,18,14,32,56.2%,13m
18698,2,toxicen,2975,346,15,12,27,55.6%,20m
18698,1,Grakalaken,2975,371,12,12,24,50.0%,5m
18698,2,Scylla,2975,336,11,10,21,52.4%,18m
18698,2,[Dobro]Trigger,2975,310,10,15,25,40.0%,23m
18698,3,rambo,2975,227,8,5,13,61.5%,34m
18698,1,RealJuice,2975,270,8,10,18,44.4%,6m
18698,1,[Banda]Phurba,2975,308,8,13,21,38.1%,9m
18698,2,CptClaw,2975,170,6,6,12,50.0%,12m
18698,2,[Çipet]Lostad,2975,125,4,2,6,66.7%,7m
18698,2,[overC]lclc,2975,118,4,4,8,50.0%,19m
18698,2,[KRUNK]Grandma,2975,60,3,2,5,60.0%,9m
18698,2,Misonghetis,2975,0,3,2,5,60.0%,12m
18698,1,[Eagls]Ocula,2975,94,2,2,4,50.0%,8m
18698,1,Atom,2975,92,2,2,4,50.0%,7m
18698,2,MMmarc,2975,0,1,0,1,100.0%,18m
18698,2,[J4E]TalentCube,2975,30,1,1,2,50.0%,13m
18698,2,KondzikPL,2975,0,1,3,4,25.0%,22m
18698,2,Myn,2975,30,1,3,4,25.0%,22m
18698,2,AbyssWalk,2975,0,1,4,5,20.0%,20m
18698,2,Blackgamer,2975,0,0,1,1,0.0%,20m
18698,2,Darkglasses,2975,0,0,1,1,0.0%,23m
18698,2,boheki,2975,0,0,1,1,0.0%,8m
18730,3,samlowry,2974,1564,255,262,517,49.3%,23m
18730,1,Ester,2974,1217,191,165,356,53.7%,23m
18730,1,[beebop]Bloubi,2974,1516,162,125,287,56.4%,7m
18730,2,KybuK,2974,1488,97,92,189,51.3%,7m
18730,3,RUS,2974,815,81,77,158,51.3%,12m
18730,3,Kamui,2974,1216,50,66,116,43.1%,15m
18730,2,[ßRUH]CreativeSos,2974,926,41,27,68,60.3%,12m
18730,3,[Эхехе]Svintoo,2974,632,20,38,58,34.5%,21m
18730,1,Zibbang,2974,471,15,18,33,45.5%,7m
18730,1,enice,2974,538,15,20,35,42.9%,5m
18730,2,[NinJs]Fascination,2974,386,13,16,29,44.8%,14m
18730,1,Voland,2974,322,12,8,20,60.0%,32m
18730,2,DimonLimon,2974,194,9,7,16,56.2%,54m
18730,2,SnowWhite,2974,242,8,10,18,44.4%,24m
18730,2,Tagger,2974,192,6,2,8,75.0%,10m
18730,2,Belgiansucks,2974,142,6,5,11,54.5%,33m
18730,2,Ico,2974,144,5,4,9,55.6%,10m
18730,2,Froze,2974,130,4,1,5,80.0%,18m
18730,1,MiniNinja,2974,0,4,1,5,80.0%,56m
18730,2,Yoll,2974,101,4,6,10,40.0%,8m
18730,2,DeadApolon,2974,60,3,2,5,60.0%,9m
18730,2,[СК20]cumshot,2974,126,3,2,5,60.0%,8m
18730,2,Arks,2974,60,3,4,7,42.9%,8m
18730,1,[ZelO]tides,2974,36,2,6,8,25.0%,24m
18730,2,huitza,2974,0,1,0,1,100.0%,16m
18730,2,llllllllllll,2974,0,1,0,1,100.0%,5m
18730,2,tomawake,2974,0,0,1,1,0.0%,16m
18730,2,[Batia]POMA,2974,0,0,1,1,0.0%,5m
18730,2,CrazyNik,2974,0,0,1,1,0.0%,8m
18730,2,Franklin,2974,0,0,1,1,0.0%,9m
18730,2,[OwMind]SonarPTZ,2974,0,0,2,2,0.0%,8m
18730,2,Jacer,2974,0,0,2,2,0.0%,23m
18730,2,Maximus,2974,0,0,3,3,0.0%,18m
18730,2,[SuperF]princeyolo,2974,0,0,4,4,0.0%,22m
18730,1,Weteran,2974,0,0,7,7,0.0%,20m
18765,1,Heya,2973,1661,143,144,287,49.8%,14m
18765,2,redfase,2973,1446,135,127,262,51.5%,23m
18765,2,[BVE]TöbbN,2973,1051,60,49,109,55.0%,18m
18765,1,tzp,2973,964,60,66,126,47.6%,3m
18765,1,[ANTS]MaMeise,2973,1038,45,40,85,52.9%,19m
18765,2,City,2973,838,38,28,66,57.6%,19m
18765,1,[R0]DragosIonut,2973,773,37,31,68,54.4%,8m
18765,2,Martin,2973,739,35,16,51,68.6%,12m
18765,2,Darkeeesh,2973,802,34,26,60,56.7%,16m
18765,2,[sonic1]Reaper,2973,724,31,24,55,56.4%,8m
18765,1,Markand,2973,832,30,31,61,49.2%,6m
18765,2,[axis]aak,2973,758,28,25,53,52.8%,24m
18765,3,DragonionS,2973,702,25,32,57,43.9%,6m
18765,2,[KAOTx]Zergkiller,2973,535,24,24,48,50.0%,22m
18765,2,Crafting,2973,273,13,10,23,56.5%,22m
18765,3,[NATI0N]Mikkolo,2973,329,12,17,29,41.4%,7m
18765,2,Furiosa,2973,251,10,9,19,52.6%,13m
18765,2,pOntiOs,2973,175,8,5,13,61.5%,7m
18765,2,[WeAre]Pactain,2973,204,8,7,15,53.3%,19m
18765,2,java,2973,180,7,9,16,43.8%,11m
18765,2,juwoy,2973,173,6,6,12,50.0%,8m
18765,1,KuN,2973,97,5,1,6,83.3%,40m
18765,2,[NSFG0D]Necrat,2973,102,5,3,8,62.5%,7m
18765,2,[FrF]Louzof,2973,0,3,2,5,60.0%,20m
18765,1,[NCPLZ]gritol,2973,0,3,2,5,60.0%,1h
18765,3,Crawler,2973,97,2,0,2,100.0%,26m
18765,2,[M1L]Tenenbaum,2973,107,2,3,5,40.0%,7m
18765,2,[HMB]Tydirius,2973,0,1,0,1,100.0%,18m
18765,2,IIIIIIIIIIII,2973,0,1,0,1,100.0%,5m
18765,2,[LeVaV]Borislav,2973,0,0,1,1,0.0%,23m
18765,2,MassDonfel,2973,0,0,1,1,0.0%,18m
18765,2,[Нидус]Slavka,2973,0,0,1,1,0.0%,13m
18797,1,Eltaxi,2972,1650,182,161,343,53.1%,11m
18797,1,[Czakon]andykalypse,2972,1483,103,91,194,53.1%,11m
18797,2,stefan,2972,1596,95,74,169,56.2%,24m
18797,2,орк,2972,1215,59,42,101,58.4%,8m
18797,1,[TWKH]Jorge,2972,727,40,38,78,51.3%,11m
18797,1,DonPorolon,2972,1038,38,40,78,48.7%,23m
18797,2,Yanuki,2972,626,22,21,43,51.2%,21m
18797,2,HyperXCubeOS,2972,386,18,6,24,75.0%,23m
18797,2,Patamon,2972,424,16,14,30,53.3%,20m
18797,3,KrzysiekJ,2972,486,16,29,45,35.6%,18m
18797,2,Graboid,2972,320,13,6,19,68.4%,22m
18797,2,Purplewolf,2972,234,11,6,17,64.7%,23m
18797,2,MUPPET,2972,226,8,5,13,61.5%,10m
18797,3,Devl,2972,213,7,3,10,70.0%,36m
18797,1,Kosmos,2972,224,6,12,18,33.3%,22m
18797,2,[sonic1]Serzh,2972,88,4,1,5,80.0%,9m
18797,2,[Emot]NyDuS,2972,86,4,2,6,66.7%,20m
18797,2,Scofield,2972,60,4,3,7,57.1%,9m
18797,2,Raoul,2972,118,4,5,9,44.4%,14m
18797,2,Nighteyes,2972,146,3,3,6,50.0%,6m
18797,2,Vicb,2972,0,1,1,2,50.0%,24m
18797,2,Green,2972,0,1,1,2,50.0%,23m
18797,2,Wizzard,2972,0,1,1,2,50.0%,19m
18797,2,TroMz,2972,0,1,1,2,50.0%,10m
18797,2,JamRourk,2972,30,1,2,3,33.3%,10m
18797,3,NekronNekron,2972,97,1,2,3,33.3%,26m
18797,1,[AnimeX]MacViser,2972,0,1,3,4,25.0%,12m
18797,1,charzety,2972,40,1,7,8,12.5%,10m
18797,3,[DarkK]Blacksnake,2972,0,0,1,1,0.0%,36m
18797,2,ScreamOfSoul,2972,0,0,1,1,0.0%,7m
18797,1,Tsaari,2972,0,0,4,4,0.0%,24m
18797,2,chlenpure,2972,0,0,4,4,0.0%,24m
18829,3,Lena,2971,1460,108,107,215,50.2%,20m
18829,1,Naviester,2971,1652,66,64,130,50.8%,11m
18829,2,IREFUSE,2971,1320,65,36,101,64.4%,11m
18829,2,LarsVegas,2971,395,16,11,27,59.3%,19m
18829,2,SmirnOFF,2971,407,16,12,28,57.1%,16m
18829,1,Magnac,2971,408,12,22,34,35.3%,12m
18829,2,[MmS]iep,2971,296,11,8,19,57.9%,6m
18829,2,[EloHel]NickDiaz,2971,228,10,1,11,90.9%,12m
18829,1,Antihrest,2971,312,9,19,28,32.1%,12m
18829,3,bobwah,2971,189,7,4,11,63.6%,21m
18829,2,[BlTE]Roheryn,2971,170,7,5,12,58.3%,18m
18829,1,Maksoncheg,2971,165,7,6,13,53.8%,3m
18829,2,Samurai,2971,190,5,4,9,55.6%,6m
18829,2,Peace,2971,152,4,2,6,66.7%,16m
18829,1,Antsu,2971,62,4,7,11,36.4%,7m
18829,2,Leer,2971,144,4,8,12,33.3%,54m
18829,1,[PROST]CeeEll,2971,121,3,0,3,100.0%,1h
18829,2,Platanh,2971,0,3,2,5,60.0%,23m
18829,1,Raft,2971,0,3,2,5,60.0%,34m
18829,2,Daddy,2971,30,2,0,2,100.0%,6m
18829,2,Ginger,2971,44,2,1,3,66.7%,34m
18829,2,Den,2971,60,2,2,4,50.0%,22m
18829,2,bzium,2971,0,1,0,1,100.0%,5m
18829,2,Azatoth,2971,0,1,0,1,100.0%,8m
18829,2,[GNJ]TechNoiDo,2971,30,1,2,3,33.3%,13m
18829,2,Danykos,2971,30,1,2,3,33.3%,7m
18829,2,KnuckleOhs,2971,0,1,3,4,25.0%,6m
18829,2,DrunkenChimp,2971,0,0,1,1,0.0%,10m
18829,1,[rwsSC2]Colonel,2971,0,0,2,2,0.0%,57m
18858,1,Joske,2970,1373,64,67,131,48.9%,23m
18858,1,DivineDust,2970,922,39,41,80,48.8%,20m
18858,2,przoci,2970,779,33,23,56,58.9%,16m
18858,2,JerryKahns,2970,582,26,13,39,66.7%,11m
18858,2,macuba,2970,698,26,27,53,49.1%,7m
18858,2,nEWPlayer,2970,223,21,15,36,58.3%,23m
18858,2,Winner,2970,464,20,17,37,54.1%,8m
18858,2,[KCD]Smrkous,2970,371,17,16,33,51.5%,24m
18858,1,[Brun7]fbksmguld,2970,451,15,17,32,46.9%,13m
18858,2,[OPStar]Merciful,2970,262,9,6,15,60.0%,7m
18858,1,grushan,2970,97,5,1,6,83.3%,23m
18858,1,Jurson,2970,183,5,4,9,55.6%,53m
18858,3,Ezhonok,2970,0,4,3,7,57.1%,30m
18858,2,CoCos,2970,0,2,2,4,50.0%,10m
18858,2,Wulfy,2970,0,1,0,1,100.0%,9m
18858,2,Seph,2970,30,1,4,5,20.0%,7m
18858,2,Schiggy,2970,0,0,1,1,0.0%,20m
18858,1,SkipLegDay,2970,0,0,1,1,0.0%,17m
18858,2,[TEPCO]imgi,2970,0,0,1,1,0.0%,7m
18858,2,Grimlinks,2970,0,0,1,1,0.0%,18m
18858,2,Lelouch,2970,0,0,1,1,0.0%,7m
18858,3,KenKaneki,2970,0,0,1,1,0.0%,14m
18880,2,Flintytrex,2969,1598,307,287,594,51.7%,11m
18880,1,CeramicBowl,2969,1241,224,215,439,51.0%,9m
18880,2,[IMoosI]Vinz,2969,766,107,102,209,51.2%,5m
18880,2,[Ǽ1]Impostor,2969,1364,104,74,178,58.4%,5m
18880,1,Artt,2969,837,97,84,181,53.6%,9m
18880,1,IIIIIIIIIIII,2969,1630,91,69,160,56.9%,14m
18880,1,Docol,2969,698,87,81,168,51.8%,5m
18880,2,WildOwl,2969,1233,50,42,92,54.3%,13m
18880,1,[0BO]Griselbrand,2969,1258,45,50,95,47.4%,13m
18880,2,lll,2969,1076,41,41,82,50.0%,14m
18880,2,FAKAS,2969,382,15,16,31,48.4%,6m
18880,2,[BHR]Khlint,2969,237,9,9,18,50.0%,21m
18880,2,GKmjd,2969,88,4,4,8,50.0%,12m
18880,2,PereNoël,2969,118,4,7,11,36.4%,8m
18880,2,[UFOP]Link,2969,126,3,1,4,75.0%,6m
18880,2,dorsash,2969,0,3,2,5,60.0%,10m
18880,1,[Silex]wyrmm,2969,0,3,2,5,60.0%,32m
18880,2,Sargon,2969,0,3,2,5,60.0%,13m
18880,1,Slugz,2969,0,3,2,5,60.0%,43m
18880,2,[SZ]NeMo,2969,30,2,1,3,66.7%,5m
18880,3,Fantomas,2969,96,2,2,4,50.0%,9m
18880,2,legalasca,2969,30,2,4,6,33.3%,21m
18880,2,[TopSC]LowDoor,2969,0,1,0,1,100.0%,12m
18880,2,[WSCol]SerMorphium,2969,30,1,1,2,50.0%,10m
18880,2,[DuzdR]Rhapsody,2969,0,1,1,2,50.0%,23m
18880,1,Rhino,2969,0,1,1,2,50.0%,5m
18880,2,[FkDyMw]Ðryft,2969,0,0,1,1,0.0%,42m
18880,2,Alone,2969,0,0,1,1,0.0%,3m
18880,1,[ProBC]ddrake,2969,0,0,1,1,0.0%,30m
18880,1,[Rakii]ERMAN,2969,0,0,1,1,0.0%,50m
18880,2,IGWXZ,2969,0,0,1,1,0.0%,19m
18880,3,Alph,2969,0,0,3,3,0.0%,12m
18880,2,Fatish,2969,0,0,3,3,0.0%,13m
18880,2,Kerigir,2969,0,0,5,5,0.0%,22m
18880,1,[FlexA]Neuron,2969,0,0,10,10,0.0%,14m
18915,3,Hanumon,2968,883,160,157,317,50.5%,21m
18915,2,Sasa,2968,1602,111,102,213,52.1%,13m
18915,2,Gucky,2968,1390,99,94,193,51.3%,20m
18915,1,FullHouse,2968,1580,81,72,153,52.9%,8m
18915,1,RehabHero,2968,955,32,37,69,46.4%,6m
18915,1,Rico,2968,689,26,26,52,50.0%,3m
18915,2,PeruvnSwarm,2968,551,22,21,43,51.2%,14m
18915,2,MoreCowbell,2968,445,18,15,33,54.5%,13m
18915,1,llllllllllll,2968,454,17,17,34,50.0%,8m
18915,3,Zerayl,2968,466,17,30,47,36.2%,7m
18915,2,Hexag,2968,330,13,8,21,61.9%,22m
18915,2,[invc]IdrA,2968,278,11,5,16,68.8%,10m
18915,2,Konstantin,2968,203,8,8,16,50.0%,5m
18915,1,Greekdriver,2968,239,7,6,13,53.8%,5m
18915,1,[knofcy]Pantera,2968,220,7,15,22,31.8%,3m
18915,3,Beleive,2968,120,6,5,11,54.5%,18m
18915,1,FireStorm,2968,194,6,12,18,33.3%,12m
18915,3,Delos,2968,119,3,3,6,50.0%,18m
18915,2,treeone,2968,88,2,0,2,100.0%,24m
18915,2,Primal,2968,38,2,0,2,100.0%,56m
18915,2,Torokgyik,2968,112,2,1,3,66.7%,16m
18915,2,Function,2968,88,2,4,6,33.3%,10m
18915,1,GGGLHF,2968,0,1,0,1,100.0%,44m
18915,2,padRe,2968,0,0,1,1,0.0%,6m
18915,2,Burgerkill,2968,0,0,1,1,0.0%,6m
18915,2,hanbing,2968,0,0,3,3,0.0%,9m
18941,1,Baal,2967,1547,223,195,418,53.3%,4m
18941,1,zoldbeka,2967,713,58,45,103,56.3%,5m
18941,1,Mindblend,2967,892,47,39,86,54.7%,12m
18941,1,Levanthium,2967,1354,47,54,101,46.5%,13m
18941,2,Greendonkey,2967,837,37,26,63,58.7%,18m
18941,1,Whtr,2967,944,36,38,74,48.6%,8m
18941,2,LouisCHEN,2967,680,28,27,55,50.9%,11m
18941,3,[ĦĦ]Nanuk,2967,610,22,32,54,40.7%,21m
18941,2,[H0C]SandStorm,2967,378,16,8,24,66.7%,21m
18941,2,Weeret,2967,405,15,10,25,60.0%,12m
18941,3,Jahh,2967,478,15,29,44,34.1%,5m
18941,2,xcos,2967,315,14,0,14,100.0%,1h
18941,3,Alex,2967,343,13,11,24,54.2%,8m
18941,2,taiN,2967,267,12,9,21,57.1%,6m
18941,2,Phizzler,2967,325,11,6,17,64.7%,14m
18941,2,Shatoboar,2967,204,9,8,17,52.9%,5m
18941,1,MASAGLUTORJT,2967,247,7,10,17,41.2%,23m
18941,2,[BN]Zantarg,2967,231,6,13,19,31.6%,18m
18941,1,lolcake,2967,221,5,10,15,33.3%,20m
18941,2,Ivon,2967,142,3,2,5,60.0%,7m
18941,2,ciupaila,2967,120,3,4,7,42.9%,21m
18941,2,[MurtuM]Jenslol,2967,0,1,0,1,100.0%,7m
18941,2,[Arrows]igor,2967,0,0,1,1,0.0%,12m
18941,2,WhiteCrab,2967,0,0,1,1,0.0%,23m
18941,2,[GRAM4]Fastest,2967,0,0,2,2,0.0%,7m
18941,2,Friss,2967,0,0,4,4,0.0%,14m
18967,2,JumpyLeCobra,2966,1587,196,167,363,54.0%,24m
18967,1,MICHAL,2966,1638,129,132,261,49.4%,20m
18967,1,TEDROGO,2966,1658,124,101,225,55.1%,23m
18967,3,DeathHaze,2966,1105,100,104,204,49.0%,14m
18967,3,TenaX,2966,840,97,96,193,50.3%,14m
18967,2,otec,2966,351,14,9,23,60.9%,23m
18967,2,[CJFF]Jasper,2966,219,10,4,14,71.4%,8m
18967,2,Ganimede,2966,237,10,4,14,71.4%,6m
18967,2,llllllllllll,2966,242,9,8,17,52.9%,12m
18967,2,[xSwarm]wenji,2966,201,8,5,13,61.5%,8m
18967,2,Nots,2966,180,6,10,16,37.5%,12m
18967,2,[S1B]BloppieZA,2966,146,5,6,11,45.5%,5m
18967,1,[spastu]CoolePudding,2966,97,4,2,6,66.7%,30m
18967,1,Peffo,2966,146,4,11,15,26.7%,8m
18967,2,[LCT]Adastrae,2966,126,3,1,4,75.0%,20m
18967,1,Weasel,2966,0,3,2,5,60.0%,40m
18967,2,Barabba,2966,60,3,3,6,50.0%,12m
18967,2,MMR,2966,58,3,3,6,50.0%,22m
18967,2,Daddy,2966,0,2,0,2,100.0%,13m
18967,2,DAJP,2966,30,2,3,5,40.0%,24m
18967,2,ViRuL,2966,88,2,4,6,33.3%,8m
18967,2,[LSPs]Stimpack,2966,30,2,5,7,28.6%,19m
18967,1,[LKGS]bibounet,2966,102,2,6,8,25.0%,7m
18967,2,Khuna,2966,0,1,0,1,100.0%,7m
18967,2,[CОS]Jypsy,2966,0,1,1,2,50.0%,14m
18967,2,krzaq,2966,0,1,1,2,50.0%,14m
18967,2,Protosik,2966,30,1,3,4,25.0%,7m
18967,2,Ayatulli,2966,0,0,1,1,0.0%,16m
18967,2,[GTkz]AZAMAT,2966,0,0,1,1,0.0%,19m
18967,2,Ozymandias,2966,0,0,1,1,0.0%,18m
18997,1,Scar,2965,1608,132,132,264,50.0%,5m
18997,1,meklem,2965,1413,96,73,169,56.8%,9m
18997,1,eem,2965,1092,85,80,165,51.5%,5m
18997,1,[TVK]zeljur,2965,1235,81,81,162,50.0%,22m
18997,2,Terran,2965,487,51,50,101,50.5%,24m
18997,1,Martinator,2965,1357,47,56,103,45.6%,4m
18997,2,Herakles,2965,916,46,49,95,48.4%,8m
18997,2,WhiteMimos,2965,1037,43,33,76,56.6%,24m
18997,2,BrudLi,2965,1073,41,41,82,50.0%,8m
18997,2,Nero,2965,771,34,24,58,58.6%,23m
18997,2,Immortal,2965,748,33,24,57,57.9%,12m
18997,2,Sergio,2965,477,18,14,32,56.2%,10m
18997,2,Muchisu,2965,524,18,17,35,51.4%,14m
18997,1,MarcoPolo,2965,311,18,18,36,50.0%,14m
18997,1,Yuicy,2965,301,10,13,23,43.5%,51m
18997,2,Red,2965,202,8,3,11,72.7%,24m
18997,2,Toasterling,2965,172,6,6,12,50.0%,16m
18997,2,frikadelka,2965,136,4,1,5,80.0%,11m
18997,2,Luchkox,2965,92,3,5,8,37.5%,10m
18997,2,jeanpascal,2965,62,3,6,9,33.3%,12m
18997,1,Femire,2965,106,3,9,12,25.0%,21m
18997,2,Sagreth,2965,60,2,3,5,40.0%,23m
18997,1,[IIIllI]SunStar,2965,34,2,6,8,25.0%,20m
18997,1,KilledDebtor,2965,34,2,8,10,20.0%,3m
18997,2,IAMKOREAN,2965,0,1,0,1,100.0%,12m
18997,2,[12SKT1]HERO,2965,0,1,1,2,50.0%,8m
18997,2,LAV,2965,30,1,3,4,25.0%,7m
18997,2,master,2965,30,1,3,4,25.0%,10m
18997,2,DonWurmillo,2965,0,1,4,5,20.0%,23m
18997,2,[Juzs]deedbush,2965,0,0,1,1,0.0%,7m
18997,2,[IIuBo]KickOFF,2965,0,0,1,1,0.0%,8m
18997,2,[PROWO]Skunixx,2965,0,0,1,1,0.0%,14m
18997,2,NACHBIP,2965,0,0,1,1,0.0%,23m
19030,2,ComradeBork,2964,1638,354,342,696,50.9%,12m
19030,1,Arlekin,2964,1071,121,113,234,51.7%,23m
19030,3,undercrow,2964,1423,109,105,214,50.9%,20m
19030,2,julio,2964,963,89,82,171,52.0%,19m
19030,2,Maxlin,2964,1578,86,61,147,58.5%,24m
19030,2,Elements,2964,905,42,36,78,53.8%,16m
19030,2,mastergareen,2964,496,19,19,38,50.0%,10m
19030,2,RAVƷN,2964,319,12,7,19,63.2%,13m
19030,2,SuchY,2964,276,10,7,17,58.8%,10m
19030,2,Hydrius,2964,254,10,7,17,58.8%,8m
19030,1,Seven,2964,124,5,5,10,50.0%,13m
19030,1,oberkaiser,2964,97,4,1,5,80.0%,6m
19030,2,kaiser,2964,126,4,1,5,80.0%,19m
19030,2,Glaeder,2964,114,4,4,8,50.0%,8m
19030,2,[Petrиs]kavadarcanec,2964,114,4,5,9,44.4%,8m
19030,1,iDaRaX,2964,190,4,8,12,33.3%,10m
19030,1,FlekaZz,2964,0,3,2,5,60.0%,36m
19030,1,Elenduyl,2964,0,3,3,6,50.0%,19m
19030,1,[ENV]Paczek,2964,70,3,9,12,25.0%,12m
19030,2,Spronx,2964,58,2,2,4,50.0%,8m
19030,1,[ThUdLu]JustlDead,2964,121,2,6,8,25.0%,1h
19030,1,[BRCH]Hypophis,2964,40,2,8,10,20.0%,23m
19030,3,[N2]Swoog,2964,0,1,2,3,33.3%,16m
19030,1,Raftoons,2964,0,1,5,6,16.7%,16m
19030,1,BerlinSports,2964,0,0,5,5,0.0%,40m
19055,3,Occupunk,2963,1375,118,123,241,49.0%,11m
19055,2,Ternence,2963,1497,72,65,137,52.6%,7m
19055,2,Martin,2963,673,48,40,88,54.5%,12m
19055,2,RONaNa,2963,804,39,30,69,56.5%,8m
19055,2,DeadStar,2963,411,37,31,68,54.4%,13m
19055,2,Endos,2963,683,32,17,49,65.3%,12m
19055,3,Nightmare,2963,643,31,44,75,41.3%,8m
19055,2,DiTya,2963,546,28,24,52,53.8%,8m
19055,1,[10110]Bestasttung,2963,737,27,29,56,48.2%,9m
19055,2,[MarING]BaronOwSky,2963,454,21,15,36,58.3%,19m
19055,1,Wolf,2963,566,20,29,49,40.8%,19m
19055,2,voices,2963,396,16,10,26,61.5%,22m
19055,2,AdmTolwin,2963,350,15,7,22,68.2%,9m
19055,1,alpert,2963,278,13,10,23,56.5%,5m
19055,2,MrYan,2963,240,9,2,11,81.8%,23m
19055,1,PippoJedi,2963,265,8,10,18,44.4%,10m
19055,2,Lord,2963,140,6,4,10,60.0%,4m
19055,2,NerfBane,2963,144,5,2,7,71.4%,6m
19055,2,Hader,2963,118,5,3,8,62.5%,13m
19055,2,CodeNoir,2963,116,5,5,10,50.0%,7m
19055,1,Sorry,2963,0,4,2,6,66.7%,13m
19055,2,CatJWarrior,2963,86,4,5,9,44.4%,10m
19055,2,Honte,2963,118,4,5,9,44.4%,22m
19055,1,tolaaayn,2963,122,4,12,16,25.0%,22m
19055,2,[TCS69]Bluejay,2963,70,3,3,6,50.0%,11m
19055,3,RedSnapper,2963,127,3,10,13,23.1%,15m
19055,1,Gigu,2963,108,3,11,14,21.4%,4m
19055,2,MrRandom,2963,30,2,1,3,66.7%,7m
19055,2,[VFN]NinJa,2963,0,1,0,1,100.0%,6m
19055,2,ZeRo,2963,0,1,0,1,100.0%,7m
19055,2,ApfelSchnize,2963,0,1,1,2,50.0%,22m
19055,1,Nalim,2963,90,1,6,7,14.3%,3m
19055,2,RUBASINA,2963,0,0,1,1,0.0%,16m
19055,3,Petryshka,2963,0,0,2,2,0.0%,46m
19055,2,[Arcane]AǂFrespic,2963,0,0,3,3,0.0%,8m
19055,1,[REDALL]DarkLight,2963,0,0,9,9,0.0%,7m
19091,2,nehmo,2962,407,115,99,214,53.7%,12m
19091,1,Corvojean,2962,1312,81,74,155,52.3%,15m
19091,2,Yuino,2962,670,30,23,53,56.6%,7m
19091,1,[ZERG7V]LoomY,2962,853,29,36,65,44.6%,14m
19091,1,Arcji,2962,274,24,19,43,55.8%,8m
19091,1,[SL]Maple,2962,258,13,7,20,65.0%,24m
19091,2,[ZERG7V]ЛягушкаЛяга,2962,352,13,14,27,48.1%,7m
19091,2,eligorkoson,2962,282,11,12,23,47.8%,23m
19091,2,[TxM]Reason,2962,254,10,10,20,50.0%,14m
19091,3,Sephiroth,2962,294,9,25,34,26.5%,22m
19091,2,Lock,2962,82,6,6,12,50.0%,36m
19091,2,Rudkaj,2962,148,6,8,14,42.9%,14m
19091,2,Lambert,2962,115,5,5,10,50.0%,5m
19091,1,alanmortier,2962,0,3,2,5,60.0%,50m
19091,1,Hollown,2962,0,3,2,5,60.0%,55m
19091,2,Drölf,2962,60,3,5,8,37.5%,12m
19091,2,[XiSPoo]Lockdown,2962,112,2,1,3,66.7%,4m
19091,2,Centipede,2962,30,2,5,7,28.6%,23m
19091,2,JohnSkyspar,2962,0,1,1,2,50.0%,24m
19091,2,[KYOJIN]necrohert,2962,30,1,2,3,33.3%,23m
19091,1,[dolban]Пупа,2962,0,0,1,1,0.0%,50m
19091,2,Vekenas,2962,0,0,1,1,0.0%,8m
19091,1,ooF,2962,0,0,2,2,0.0%,46m
19091,2,[TSC2C]Тирион,2962,0,0,4,4,0.0%,10m
19115,2,Frlanton,2961,1488,122,88,210,58.1%,10m
19115,1,PeeDrinker,2961,1378,92,77,169,54.4%,5m
19115,1,Dieter,2961,975,78,85,163,47.9%,20m
19115,2,DrAkula,2961,1336,71,65,136,52.2%,10m
19115,2,[SlllH]Shorty,2961,1487,63,50,113,55.8%,9m
19115,2,[200P]Mike,2961,1194,56,31,87,64.4%,22m
19115,2,[TTSD]Reven,2961,1138,50,44,94,53.2%,11m
19115,2,SBI,2961,1065,43,36,79,54.4%,19m
19115,1,Maniacow,2961,1092,39,41,80,48.8%,19m
19115,1,flucher,2961,777,31,28,59,52.5%,22m
19115,2,Prusias,2961,514,21,15,36,58.3%,21m
19115,2,[ZEGARA]CraxS,2961,418,15,18,33,45.5%,11m
19115,2,[THANOS]Kadiriri,2961,293,11,6,17,64.7%,22m
19115,2,TurboRoach,2961,303,10,8,18,55.6%,7m
19115,2,RamzesXIII,2961,167,6,5,11,54.5%,7m
19115,1,[ACW]Oeli,2961,221,6,11,17,35.3%,15m
19115,1,Luma,2961,97,5,1,6,83.3%,5m
19115,1,Nebuar,2961,97,5,1,6,83.3%,34m
19115,2,Paxanb,2961,116,5,3,8,62.5%,19m
19115,2,DeLuini,2961,148,5,5,10,50.0%,10m
19115,2,FeFDragonPL,2961,86,3,6,9,33.3%,22m
19115,2,BigDickMike,2961,112,2,2,4,50.0%,23m
19115,2,Falcon,2961,0,1,0,1,100.0%,8m
19115,2,SCVMBXG,2961,0,1,1,2,50.0%,7m
19115,2,GuNii,2961,0,0,1,1,0.0%,19m
19115,2,Otem,2961,0,0,1,1,0.0%,13m
19115,2,Prac,2961,0,0,1,1,0.0%,8m
19115,2,[IceCub]Призрак,2961,0,0,2,2,0.0%,16m
19143,1,IsoPropyl,2960,1513,161,143,304,53.0%,12m
19143,2,BaadnewZ,2960,520,108,87,195,55.4%,14m
19143,1,[DHSC]Decoy,2960,907,61,52,113,54.0%,19m
19143,2,[CR0WS]Kelling,2960,1230,46,47,93,49.5%,19m
19143,2,[JKdII]RishKhaa,2960,668,28,22,50,56.0%,12m
19143,1,adamqu,2960,545,28,31,59,47.5%,22m
19143,2,NateTestAcc,2960,471,19,12,31,61.3%,21m
19143,1,BlindmanDF,2960,170,18,23,41,43.9%,14m
19143,2,[Фаталя]Daniillee,2960,415,17,10,27,63.0%,12m
19143,2,[wedown]BloodySmoker,2960,314,12,5,17,70.6%,6m
19143,2,uhmateush,2960,360,12,11,23,52.2%,8m
19143,2,AranSIRE,2960,280,10,6,16,62.5%,7m
19143,1,Walva,2960,246,8,12,20,40.0%,4m
19143,1,Stranik,2960,118,6,1,7,85.7%,16m
19143,2,[ZePi]Illidan,2960,167,4,10,14,28.6%,22m
19143,2,RedSpades,2960,0,3,2,5,60.0%,18m
19143,2,ТвояМАМКА,2960,0,3,2,5,60.0%,23m
19143,2,TheFox,2960,62,3,5,8,37.5%,8m
19143,2,[k1raen]amidamary,2960,88,2,0,2,100.0%,11m
19143,2,Heeger,2960,0,2,0,2,100.0%,37m
19143,2,Sardukar,2960,30,2,3,5,40.0%,22m
19143,2,[FancyD]Tutu,2960,30,1,1,2,50.0%,20m
19143,2,[zukaCo]MaMu,2960,30,1,3,4,25.0%,5m
19143,2,goliath,2960,0,1,4,5,20.0%,5m
19143,2,[Gоld]Doktor,2960,0,0,1,1,0.0%,19m
19143,2,[lazio]Jim,2960,0,0,2,2,0.0%,23m
19143,2,Cyphergun,2960,0,0,2,2,0.0%,22m
19143,1,Conq,2960,0,0,2,2,0.0%,14m
19171,3,IamRuss,2959,1518,229,210,439,52.2%,15m
19171,3,mystic,2959,1551,196,189,385,50.9%,7m
19171,1,[58113]molnar,2959,801,168,175,343,49.0%,4m
19171,2,KillFirst,2959,1543,93,84,177,52.5%,8m
19171,2,strem,2959,1180,80,67,147,54.4%,16m
19171,2,[KNUS]SnowMan,2959,442,47,19,66,71.2%,8m
19171,2,BART,2959,725,42,28,70,60.0%,7m
19171,1,Inikoyi,2959,495,42,44,86,48.8%,6m
19171,2,SvarmGost,2959,703,26,25,51,51.0%,5m
19171,1,lucker,2959,641,25,25,50,50.0%,14m
19171,2,[Zhig]Nova,2959,414,21,8,29,72.4%,14m
19171,1,[MNKTS]Adrianmika,2959,579,20,21,41,48.8%,7m
19171,1,Deyshan,2959,359,19,15,34,55.9%,11m
19171,2,Vale,2959,454,17,18,35,48.6%,12m
19171,2,Ymikai,2959,245,14,13,27,51.9%,5m
19171,2,FUTURA,2959,313,13,7,20,65.0%,24m
19171,2,БезТрусов,2959,303,13,9,22,59.1%,8m
19171,2,ZergKEBAB,2959,281,10,6,16,62.5%,22m
19171,3,[TC18]Raii,2959,189,8,5,13,61.5%,15m
19171,2,Frosty,2959,135,4,3,7,57.1%,9m
19171,1,[0BO]HappyDrones,2959,160,4,14,18,22.2%,15m
19171,2,AXYB,2959,58,3,2,5,60.0%,7m
19171,2,SimonAWP,2959,0,3,2,5,60.0%,34m
19171,1,Pawlolas,2959,0,3,3,6,50.0%,14m
19171,2,[BISHOP]karambol,2959,30,2,3,5,40.0%,10m
19171,2,Weedjo,2959,0,2,3,5,40.0%,23m
19171,2,Shareni,2959,0,1,0,1,100.0%,8m
19171,1,[XOMЯKИ]Cristalpkey,2959,0,1,0,1,100.0%,32m
19171,2,Adi,2959,34,1,3,4,25.0%,4m
19171,2,robo,2959,0,1,4,5,20.0%,10m
19171,2,[FRANZ]Endrox,2959,0,0,1,1,0.0%,14m
19171,1,[BuGG3R]Geri,2959,0,0,1,1,0.0%,25m
19171,2,gunbi,2959,0,0,1,1,0.0%,16m
19204,1,MusliM,2958,1654,220,213,433,50.8%,11m
19204,3,Lluls,2958,1220,107,95,202,53.0%,8m
19204,2,[NerCC]ArtCrafter,2958,1473,79,60,139,56.8%,20m
19204,1,Gehacktes,2958,854,59,60,119,49.6%,20m
19204,1,Duuujk,2958,969,58,62,120,48.3%,8m
19204,1,WhiteFangmsi,2958,699,37,39,76,48.7%,19m
19204,2,Nova,2958,314,20,18,38,52.6%,11m
19204,2,Stiflersmom,2958,340,17,14,31,54.8%,7m
19204,2,Funtik,2958,395,14,11,25,56.0%,4m
19204,2,[BioMec]ThoFly,2958,282,11,9,20,55.0%,6m
19204,2,KroNax,2958,191,7,3,10,70.0%,16m
19204,3,GardenShovel,2958,202,7,6,13,53.8%,45m
19204,2,ZergPower,2958,133,6,3,9,66.7%,22m
19204,2,MickDundee,2958,102,3,0,3,100.0%,19m
19204,2,OKej,2958,102,3,1,4,75.0%,12m
19204,2,norb,2958,126,3,2,5,60.0%,21m
19204,2,BThabrothers,2958,0,3,2,5,60.0%,7m
19204,2,Zlayaa,2958,90,3,5,8,37.5%,8m
19204,2,ShadowEagle,2958,143,3,5,8,37.5%,16m
19204,2,MRI,2958,0,2,3,5,40.0%,13m
19204,2,DarkKeeper,2958,30,2,3,5,40.0%,6m
19204,2,[WRAON]BlobBob,2958,58,2,4,6,33.3%,24m
19204,2,MackFly,2958,0,1,0,1,100.0%,23m
19204,2,ReD,2958,0,1,0,1,100.0%,24m
19204,2,Somin,2958,0,1,0,1,100.0%,5m
19204,2,KonfuZius,2958,0,1,0,1,100.0%,10m
19204,2,Azazerg,2958,0,1,2,3,33.3%,19m
19204,2,drkorte,2958,30,1,3,4,25.0%,24m
19204,2,Bheasty,2958,0,0,1,1,0.0%,22m
19204,2,NORandom,2958,0,0,1,1,0.0%,3m
19204,2,PokiZ,2958,0,0,1,1,0.0%,5m
19204,2,[ḆŽǤ]matej,2958,0,0,2,2,0.0%,6m
19204,2,MarineBlu,2958,0,0,2,2,0.0%,23m
19204,2,[HighP]Федор,2958,0,0,2,2,0.0%,24m
19204,2,zergay,2958,0,0,4,4,0.0%,12m
19239,2,Mumenrider,2957,1295,223,171,394,56.6%,20m
19239,1,Boemund,2957,1651,191,203,394,48.5%,25m
19239,3,[BZerO]txtsxm,2957,813,133,108,241,55.2%,6m
19239,1,[SPAINs]Thanan,2957,858,107,103,210,51.0%,21m
19239,2,Kunglosman,2957,1256,90,69,159,56.6%,8m
19239,1,Trasher,2957,1128,62,62,124,50.0%,5m
19239,2,[JotC]Calamitavia,2957,1219,46,49,95,48.4%,11m
19239,1,[Capo]ANeVIL,2957,1205,44,46,90,48.9%,15m
19239,1,Myst,2957,485,32,30,62,51.6%,14m
19239,2,[lOoOl]microjackson,2957,424,31,18,49,63.3%,5m
19239,2,Kelvin,2957,756,29,28,57,50.9%,18m
19239,2,Troddler,2957,581,23,23,46,50.0%,24m
19239,2,[pfdsva]fabian,2957,512,22,15,37,59.5%,9m
19239,2,[TSotV]AsDeTreboles,2957,481,21,14,35,60.0%,8m
19239,1,Riosca,2957,441,18,14,32,56.2%,13m
19239,2,UtanSocker,2957,427,17,17,34,50.0%,8m
19239,2,[MANGO]Maxonage,2957,231,16,11,27,59.3%,21m
19239,2,OozzE,2957,277,11,10,21,52.4%,10m
19239,2,WinstonNC,2957,300,10,12,22,45.5%,21m
19239,2,StarKing,2957,228,8,3,11,72.7%,34m
19239,2,Reptile,2957,176,6,11,17,35.3%,12m
19239,2,MaxBeast,2957,191,5,3,8,62.5%,12m
19239,1,Ardin,2957,126,5,7,12,41.7%,14m
19239,2,vegeta,2957,0,3,2,5,60.0%,23m
19239,2,StormWolf,2957,88,2,0,2,100.0%,19m
19239,2,[RBlood]Ninjuke,2957,0,1,0,1,100.0%,10m
19239,2,[TWO]manniTWO,2957,30,1,3,4,25.0%,7m
19239,2,BakIn,2957,30,1,5,6,16.7%,5m
19239,2,HOTLINE,2957,30,1,5,6,16.7%,12m
19239,2,Blizz,2957,0,0,1,1,0.0%,14m
19239,2,[Нrr]Ruleezzz,2957,0,0,1,1,0.0%,14m
19239,2,[TedB]MisterFicus,2957,0,0,1,1,0.0%,20m
19239,2,[Nvalny]Neksis,2957,0,0,3,3,0.0%,47m
19239,2,MrJaksha,2957,0,0,4,4,0.0%,23m
19273,3,Polishfox,2956,1234,161,137,298,54.0%,19m
19273,2,Toufeus,2956,1415,119,106,225,52.9%,24m
19273,2,ElfoBey,2956,1409,108,86,194,55.7%,9m
19273,2,ObiWan,2956,655,79,67,146,54.1%,19m
19273,2,[ZaG]LTrain,2956,619,63,57,120,52.5%,7m
19273,1,raptor,2956,815,37,34,71,52.1%,5m
19273,2,Sinoglart,2956,749,36,35,71,50.7%,19m
19273,2,Dynasty,2956,553,30,22,52,57.7%,10m
19273,3,Jagdwolf,2956,567,18,29,47,38.3%,4m
19273,2,Piccolus,2956,167,10,6,16,62.5%,23m
19273,2,Bellman,2956,271,9,9,18,50.0%,8m
19273,2,[SP3RME]Histos,2956,258,8,9,17,47.1%,23m
19273,2,num,2956,236,8,12,20,40.0%,13m
19273,2,[Ǽ1]Warpspeed,2956,176,7,5,12,58.3%,8m
19273,2,[LsSsD]eTRIP,2956,86,4,5,9,44.4%,10m
19273,2,lamok,2956,0,3,2,5,60.0%,10m
19273,2,Vesser,2956,102,3,4,7,42.9%,16m
19273,2,Yeldoow,2956,92,3,4,7,42.9%,8m
19273,1,Sym,2956,44,2,1,3,66.7%,23m
19273,2,[Pasxa]Axilex,2956,30,2,1,3,66.7%,22m
19273,1,Draho,2956,0,2,2,4,50.0%,4m
19273,2,champion,2956,101,1,5,6,16.7%,24m
19273,1,Tolot,2956,0,1,9,10,10.0%,14m
19273,1,BadRobot,2956,0,0,1,1,0.0%,23m
19273,2,[ZERGTB]Deimos,2956,0,0,1,1,0.0%,14m
19273,2,[EMST]Sanktum,2956,0,0,3,3,0.0%,7m
19273,3,Plakat,2956,0,0,3,3,0.0%,23m
19300,3,wujek,2955,1551,191,203,394,48.5%,4m
19300,2,[БАНДА]GreyVolk,2955,1578,162,156,318,50.9%,8m
19300,2,Zörg,2955,1490,131,118,249,52.6%,12m
19300,2,Glanzschurke,2955,1121,53,33,86,61.6%,8m
19300,2,shroom,2955,669,26,23,49,53.1%,8m
19300,1,Tolstiy,2955,542,22,23,45,48.9%,14m
19300,2,Rodman,2955,477,20,18,38,52.6%,12m
19300,2,[Hanse]DeWil,2955,420,16,15,31,51.6%,19m
19300,2,Firegiggi,2955,474,16,22,38,42.1%,14m
19300,2,Lumicka,2955,380,15,16,31,48.4%,20m
19300,1,Oxdarq,2955,261,13,8,21,61.9%,51m
19300,2,Sanchezz,2955,199,10,4,14,71.4%,9m
19300,2,Sispéo,2955,268,9,14,23,39.1%,8m
19300,1,FAS,2955,72,7,4,11,63.6%,14m
19300,2,Doragon,2955,186,6,3,9,66.7%,12m
19300,2,Echo,2955,182,6,11,17,35.3%,22m
19300,2,HEKPOMAHT,2955,160,5,3,8,62.5%,7m
19300,2,[eXøde]faiza,2955,146,5,5,10,50.0%,24m
19300,1,wiki,2955,108,4,11,15,26.7%,7m
19300,2,Hasterok,2955,0,3,2,5,60.0%,45m
19300,2,lsyrk,2955,0,3,2,5,60.0%,58m
19300,2,blaze,2955,30,2,1,3,66.7%,12m
19300,2,Basipooh,2955,92,2,2,4,50.0%,5m
19300,1,[BobSem]Lijmer,2955,117,2,3,5,40.0%,44m
19300,2,PALA,2955,30,2,3,5,40.0%,7m
19300,2,Gorgamol,2955,32,2,3,5,40.0%,7m
19300,2,holderoger,2955,0,1,1,2,50.0%,23m
19300,3,[бобры]Akhlaim,2955,97,1,2,3,33.3%,53m
19300,2,[Пеc0к]Varrkan,2955,30,1,2,3,33.3%,19m
19300,3,IlIlIlIlI,2955,0,1,2,3,33.3%,38m
19300,3,jEsioN,2955,38,1,4,5,20.0%,39m
19300,2,[Promil]Paladyn,2955,0,0,1,1,0.0%,6m
19300,2,BlaueBirne,2955,0,0,2,2,0.0%,17m
19300,2,[IceHus]DashYarik,2955,0,0,3,3,0.0%,21m
19334,3,JSIS,2954,1477,263,263,526,50.0%,4m
19334,3,ЛизниКабана,2954,570,94,68,162,58.0%,6m
19334,1,Mephisto,2954,1392,80,66,146,54.8%,7m
19334,2,Phenix,2954,941,38,33,71,53.5%,4m
19334,2,Synth,2954,626,33,28,61,54.1%,9m
19334,1,TEKKEN,2954,639,29,24,53,54.7%,21m
19334,2,Alben,2954,684,28,21,49,57.1%,25m
19334,2,nymphen,2954,725,28,33,61,45.9%,12m
19334,2,berkistayn,2954,520,19,24,43,44.2%,22m
19334,2,Raven,2954,430,15,16,31,48.4%,8m
19334,2,dio,2954,326,13,10,23,56.5%,23m
19334,2,SyncMaster,2954,230,11,7,18,61.1%,24m
19334,3,LivEr,2954,214,8,5,13,61.5%,26m
19334,3,Stasz,2954,0,5,2,7,71.4%,17m
19334,2,Hunter,2954,0,3,2,5,60.0%,18m
19334,2,REJIVIER,2954,107,2,1,3,66.7%,23m
19334,2,Madsinner,2954,58,2,3,5,40.0%,19m
19334,2,DEF,2954,58,2,3,5,40.0%,23m
19334,2,[HU1]Traktorista,2954,0,1,0,1,100.0%,7m
19334,2,Gamil,2954,88,1,1,2,50.0%,6m
19334,2,[NOAL]Emperor,2954,0,1,2,3,33.3%,19m
19334,2,[ATOMS]gzzz,2954,30,1,3,4,25.0%,23m
19334,2,[OoE]Virus,2954,0,1,4,5,20.0%,12m
19334,1,NIKITA,2954,0,0,1,1,0.0%,22m
19334,2,Storn,2954,0,0,1,1,0.0%,10m
19334,2,LoneWolf,2954,0,0,3,3,0.0%,18m
19334,2,[Petrиs]MockBa,2954,0,0,3,3,0.0%,19m
19334,2,[Lumen]Vipsern,2954,0,0,5,5,0.0%,32m
19362,1,[CC4N]Finwecillo,2953,1617,84,81,165,50.9%,14m
19362,1,MarkF,2953,1516,81,79,160,50.6%,14m
19362,2,BronzeMaster,2953,1303,56,46,102,54.9%,6m
19362,1,Cornhulio,2953,822,54,55,109,49.5%,19m
19362,2,MOOMLEM,2953,434,40,31,71,56.3%,7m
19362,1,[Hаsu]Style,2953,952,31,35,66,47.0%,3m
19362,2,Gristin,2953,763,30,34,64,46.9%,11m
19362,2,[ЗИБиАГ]Talat,2953,632,27,17,44,61.4%,6m
19362,1,Erratus,2953,425,23,22,45,51.1%,11m
19362,1,NeverMore,2953,692,20,29,49,40.8%,15m
19362,2,[GGGLHF]fxprochess,2953,370,15,11,26,57.7%,16m
19362,1,magus,2953,442,13,23,36,36.1%,6m
19362,1,Burjuman,2953,388,12,20,32,37.5%,14m
19362,2,beegoody,2953,265,10,6,16,62.5%,18m
19362,2,Kraeutereule,2953,150,7,9,16,43.8%,20m
19362,2,Franky,2953,112,6,2,8,75.0%,13m
19362,2,Peppone,2953,168,6,2,8,75.0%,18m
19362,1,General,2953,62,6,5,11,54.5%,3m
19362,2,Barada,2953,142,6,7,13,46.2%,5m
19362,1,Routom,2953,144,2,6,8,25.0%,51m
19362,3,[THRLLA]MrTell,2953,30,2,9,11,18.2%,9m
19362,2,[2ndLaw]SuperTable,2953,88,1,1,2,50.0%,8m
19362,1,GrubaHelga,2953,0,1,2,3,33.3%,36m
19362,2,[GapSis]Zisaku,2953,0,1,3,4,25.0%,10m
19362,2,Csiróvitéz,2953,0,1,4,5,20.0%,6m
19362,2,[DaRi]Dragon,2953,0,0,1,1,0.0%,20m
19362,2,Lochnes,2953,0,0,1,1,0.0%,13m
19362,3,TomBomHDYT,2953,0,0,1,1,0.0%,12m
19390,1,Slither,2952,1009,112,108,220,50.9%,24m
19390,2,Bars,2952,1464,58,50,108,53.7%,13m
19390,2,Chaoslike,2952,727,47,42,89,52.8%,12m
19390,1,NeKoSeNPAi,2952,563,28,31,59,47.5%,19m
19390,1,Huclan,2952,710,26,30,56,46.4%,22m
19390,2,Yan,2952,546,25,14,39,64.1%,10m
19390,2,hidedragon,2952,409,15,16,31,48.4%,18m
19390,2,Nikolai,2952,370,14,13,27,51.9%,13m
19390,2,CartoO,2952,247,10,8,18,55.6%,44m
19390,2,[U5]Csizi,2952,259,10,9,19,52.6%,43m
19390,2,defouy,2952,304,10,14,24,41.7%,19m
19390,2,Hitman,2952,172,7,5,12,58.3%,24m
19390,2,DawnStar,2952,151,7,10,17,41.2%,8m
19390,1,GartenZERG,2952,184,6,4,10,60.0%,28m
19390,2,[ASMR]JayyWr,2952,148,5,7,12,41.7%,23m
19390,2,zergtryhard,2952,152,5,7,12,41.7%,7m
19390,2,[Frbelg]Thibalt,2952,114,4,2,6,66.7%,20m
19390,2,[AlzHG]Bats,2952,86,4,5,9,44.4%,11m
19390,2,LTSMASH,2952,0,3,2,5,60.0%,8m
19390,2,Vaendryl,2952,0,3,2,5,60.0%,1h
19390,2,Anomander,2952,0,3,2,5,60.0%,19m
19390,2,Cyfer,2952,30,2,2,4,50.0%,16m
19390,1,happyfeet,2952,0,1,1,2,50.0%,39m
19390,2,[dMza]ScHMIDTY,2952,0,1,1,2,50.0%,14m
19390,2,SCTitan,2952,30,1,5,6,16.7%,13m
19390,2,Leembo,2952,30,1,5,6,16.7%,24m
19390,1,Naamar,2952,0,0,1,1,0.0%,39m
19390,2,SorenLingus,2952,0,0,1,1,0.0%,7m
19390,2,[ZERGTV]Rmazaxak,2952,0,0,1,1,0.0%,5m
19390,2,[SRJ]Space,2952,0,0,2,2,0.0%,12m
19390,2,DARKDESIGN,2952,0,0,5,5,0.0%,7m
19421,2,Павел,2951,1128,178,164,342,52.0%,23m
19421,2,[ngng]Regret,2951,1087,86,84,170,50.6%,8m
19421,2,Johnny,2951,1575,63,64,127,49.6%,8m
19421,2,Chris,2951,1185,51,41,92,55.4%,22m
19421,2,[vandal]Paul,2951,897,37,32,69,53.6%,11m
19421,2,[IndyK]rNs,2951,496,29,28,57,50.9%,10m
19421,2,Sarah,2951,505,25,20,45,55.6%,23m
19421,2,Jake,2951,700,25,28,53,47.2%,19m
19421,2,[ACNs]IronBottle,2951,188,19,14,33,57.6%,10m
19421,2,[HateZ]Giallone,2951,427,18,10,28,64.3%,11m
19421,2,Stongolbest,2951,416,16,13,29,55.2%,10m
19421,2,XorisOnoma,2951,370,16,15,31,51.6%,19m
19421,2,DaJarouš,2951,152,16,17,33,48.5%,8m
19421,2,Firefou,2951,400,14,12,26,53.8%,5m
19421,2,Libertas,2951,245,14,12,26,53.8%,8m
19421,2,Invader,2951,244,11,3,14,78.6%,6m
19421,2,[Ronins]GuczynS,2951,342,11,16,27,40.7%,23m
19421,3,Neos,2951,217,8,5,13,61.5%,44m
19421,2,Smudo,2951,218,7,5,12,58.3%,19m
19421,2,Jordi,2951,139,6,4,10,60.0%,8m
19421,2,Nokiteck,2951,180,6,7,13,46.2%,10m
19421,2,Nawar,2951,0,3,2,5,60.0%,55m
19421,2,darklama,2951,30,2,3,5,40.0%,10m
19421,2,[LОLI]DOSOCHKA,2951,0,2,3,5,40.0%,16m
19421,2,RoManiaC,2951,60,2,8,10,20.0%,11m
19421,2,DrMuller,2951,0,1,0,1,100.0%,8m
19421,2,Newdigger,2951,88,1,1,2,50.0%,11m
19421,3,[SENW]chamagurkaf,2951,0,1,1,2,50.0%,23m
19421,2,Anxiety,2951,0,0,1,1,0.0%,26m
19421,2,BlackMagic,2951,0,0,1,1,0.0%,7m
19421,2,ESQEATOS,2951,0,0,1,1,0.0%,18m
19421,2,takerman,2951,0,0,2,2,0.0%,1h
19421,2,Levi,2951,0,0,5,5,0.0%,23m
19454,3,Здраер,2950,1027,122,126,248,49.2%,14m
19454,2,[SeuSS]Dabig,2950,1584,101,95,196,51.5%,11m
19454,1,[Hehe]jcjs,2950,932,92,90,182,50.5%,9m
19454,2,[TOOOLD]CuteZergling,2950,1252,82,76,158,51.9%,7m
19454,2,[RеG]Укропчик,2950,1247,57,43,100,57.0%,5m
19454,2,[BR4VE]ShadowFox,2950,501,46,46,92,50.0%,7m
19454,2,SeTe,2950,660,34,17,51,66.7%,23m
19454,2,Ierron,2950,812,34,28,62,54.8%,10m
19454,2,[BRock]EmpireZ,2950,785,32,25,57,56.1%,7m
19454,2,Ledenec,2950,768,30,26,56,53.6%,13m
19454,2,Ivine,2950,477,27,7,34,79.4%,19m
19454,2,Alligator,2950,490,18,19,37,48.6%,21m
19454,2,KuDoS,2950,367,17,5,22,77.3%,22m
19454,3,voinsveta,2950,311,12,17,29,41.4%,12m
19454,2,GrmGrl,2950,262,11,9,20,55.0%,20m
19454,2,[TFBS]TheBigTony,2950,314,11,14,25,44.0%,23m
19454,2,SoulAlone,2950,212,10,10,20,50.0%,9m
19454,1,[EaGS]AizeNN,2950,144,8,8,16,50.0%,14m
19454,2,[994]Bananashell,2950,262,8,17,25,32.0%,7m
19454,2,hhgfh,2950,131,7,2,9,77.8%,24m
19454,2,[Jiggel]Rocco,2950,195,7,4,11,63.6%,22m
19454,2,Flotschgee,2950,200,7,8,15,46.7%,14m
19454,2,Bnkyo,2950,148,6,5,11,54.5%,8m
19454,1,[AmFo]Garrus,2950,218,6,13,19,31.6%,10m
19454,1,Zugzwang,2950,187,5,4,9,55.6%,13m
19454,2,bOII,2950,116,4,0,4,100.0%,18m
19454,2,Crazinezz,2950,0,4,1,5,80.0%,8m
19454,2,[DASOUL]Nemesis,2950,0,4,1,5,80.0%,11m
19454,1,AceOne,2950,97,4,4,8,50.0%,25m
19454,2,[Batia]IIIIIIII,2950,100,3,1,4,75.0%,20m
19454,2,Invictus,2950,118,3,1,4,75.0%,25m
19454,1,raffael,2950,97,3,3,6,50.0%,6m
19454,3,MalaxovDuke,2950,97,3,6,9,33.3%,34m
19454,2,WarHeaD,2950,60,2,3,5,40.0%,20m
19454,2,[Medoed]sem,2950,60,2,5,7,28.6%,25m
19454,2,RayOfDarknes,2950,60,2,6,8,25.0%,22m
19454,2,[BRSKR]Nomcrus,2950,0,1,0,1,100.0%,7m
19454,2,BloodyDancer,2950,30,1,2,3,33.3%,22m
19454,2,Underscore,2950,0,0,2,2,0.0%,13m
19493,2,Sauchan,2949,1599,144,126,270,53.3%,11m
19493,2,margolnak,2949,1292,108,92,200,54.0%,8m
19493,2,darkey,2949,1219,100,94,194,51.5%,20m
19493,2,Rubban,2949,1389,97,87,184,52.7%,19m
19493,2,Cvile,2949,1591,95,73,168,56.5%,16m
19493,2,dirtypants,2949,917,55,35,90,61.1%,8m
19493,2,Prototype,2949,1238,54,40,94,57.4%,10m
19493,1,Arobein,2949,1119,51,35,86,59.3%,5m
19493,2,Oghma,2949,921,36,35,71,50.7%,8m
19493,1,NRG,2949,615,24,26,50,48.0%,5m
19493,2,AlkoBomBer,2949,398,16,14,30,53.3%,20m
19493,2,[N6K]AstroPhysiKs,2949,292,14,10,24,58.3%,11m
19493,2,Grueffelo,2949,244,9,5,14,64.3%,6m
19493,2,Brazzerg,2949,176,6,9,15,40.0%,9m
19493,2,Gyppokrat,2949,116,5,4,9,55.6%,8m
19493,2,[120mm]oOinfestedOo,2949,128,5,8,13,38.5%,11m
19493,1,Gabriel,2949,97,4,1,5,80.0%,41m
19493,3,vampir,2949,0,4,3,7,57.1%,34m
19493,2,ghostrider,2949,30,2,1,3,66.7%,24m
19493,2,[Medoed]ArizenElm,2949,62,2,7,9,22.2%,18m
19493,1,[XSEUX]IIIIIIIIIIII,2949,0,1,0,1,100.0%,50m
19493,2,AoPJoly,2949,0,1,1,2,50.0%,13m
19493,2,Insanity,2949,0,1,1,2,50.0%,7m
19493,2,Dhamon,2949,0,1,1,2,50.0%,11m
19493,3,SAM,2949,97,1,2,3,33.3%,17m
19493,2,[ƐRR0R]DanielC,2949,0,0,1,1,0.0%,10m
19519,2,ZeZeT,2948,1578,90,89,179,50.3%,15m
19519,1,Zudork,2948,1246,48,48,96,50.0%,6m
19519,1,Wing,2948,1025,43,33,76,56.6%,22m
19519,2,[glhf20]Ṥậṱằṁӑӣ,2948,418,21,6,27,77.8%,11m
19519,2,Blake,2948,482,20,14,34,58.8%,7m
19519,2,Xraman,2948,160,15,12,27,55.6%,9m
19519,2,moeb,2948,162,15,14,29,51.7%,22m
19519,2,PenspinningG,2948,228,10,3,13,76.9%,22m
19519,2,[SHigh]Profitroll,2948,230,9,6,15,60.0%,11m
19519,2,Starzinger,2948,238,8,6,14,57.1%,6m
19519,2,soulyx,2948,209,7,4,11,63.6%,8m
19519,2,Ahumados,2948,176,6,7,13,46.2%,22m
19519,2,Ootka,2948,168,5,2,7,71.4%,19m
19519,1,[EzClaP]ShadowStorm,2948,0,5,2,7,71.4%,23m
19519,3,Deiceide,2948,121,5,5,10,50.0%,57m
19519,2,Tomahawkk,2948,30,4,3,7,57.1%,24m
19519,2,Келтузедд,2948,0,3,2,5,60.0%,11m
19519,2,MiniVen,2948,96,3,5,8,37.5%,7m
19519,2,Derpling,2948,0,2,3,5,40.0%,8m
19519,2,[Чизеры]Sanya,2948,0,1,0,1,100.0%,9m
19519,2,[SPAINs]Alejat,2948,0,1,0,1,100.0%,12m
19519,2,[BRAS]Migeroti,2948,0,0,1,1,0.0%,20m
19519,2,Elia,2948,0,0,1,1,0.0%,13m
19542,1,Madscientist,2947,1625,120,122,242,49.6%,23m
19542,2,Oxygenium,2947,1580,86,75,161,53.4%,7m
19542,2,breizhlolo,2947,1603,74,70,144,51.4%,11m
19542,1,zhenya,2947,1627,73,76,149,49.0%,9m
19542,2,Incarnadine,2947,1351,53,49,102,52.0%,7m
19542,1,tyler,2947,1334,53,52,105,50.5%,24m
19542,2,[UAŦeam]RAZE,2947,406,46,44,90,51.1%,11m
19542,2,Hipo,2947,1029,40,40,80,50.0%,12m
19542,1,Skar,2947,828,37,33,70,52.9%,4m
19542,2,AsRac,2947,599,34,34,68,50.0%,8m
19542,2,Mamamitch,2947,619,29,19,48,60.4%,21m
19542,2,[5gb]iMoCKinGBirD,2947,565,26,14,40,65.0%,12m
19542,2,Shinrei,2947,655,26,24,50,52.0%,18m
19542,2,RaGe,2947,540,23,20,43,53.5%,22m
19542,1,viso,2947,692,23,27,50,46.0%,9m
19542,2,школьник,2947,555,21,22,43,48.8%,11m
19542,2,RoadKiLL,2947,318,20,18,38,52.6%,10m
19542,2,Moriatti,2947,387,16,13,29,55.2%,12m
19542,1,Kiroh,2947,442,13,20,33,39.4%,14m
19542,2,Zayaz,2947,280,12,7,19,63.2%,18m
19542,2,Olfarin,2947,231,9,5,14,64.3%,21m
19542,2,[Корхал]Master,2947,188,8,7,15,53.3%,46m
19542,2,NumA,2947,181,7,2,9,77.8%,13m
19542,2,fudde,2947,144,6,6,12,50.0%,11m
19542,2,Yarmaul,2947,231,6,6,12,50.0%,46m
19542,2,KrekeN,2947,141,4,2,6,66.7%,11m
19542,2,[АРМОР]neAnatoliy,2947,86,4,5,9,44.4%,20m
19542,1,VicMackey,2947,146,4,11,15,26.7%,24m
19542,2,Fibo,2947,0,1,0,1,100.0%,22m
19542,2,Strelock,2947,0,1,0,1,100.0%,10m
19542,2,llllllllllll,2947,88,1,1,2,50.0%,24m
19542,2,jad,2947,0,0,1,1,0.0%,11m
19542,3,FotonGGimba,2947,0,0,2,2,0.0%,24m
19575,1,DontCare,2946,1197,59,60,119,49.6%,24m
19575,2,Reaper,2946,1107,55,26,81,67.9%,13m
19575,1,torades,2946,1160,47,40,87,54.0%,6m
19575,1,Alpinist,2946,1053,39,41,80,48.8%,14m
19575,1,Twep,2946,622,35,41,76,46.1%,6m
19575,2,GameGode,2946,682,29,22,51,56.9%,23m
19575,2,SCVready,2946,572,25,11,36,69.4%,9m
19575,3,zerg,2946,686,23,39,62,37.1%,10m
19575,2,Baderling,2946,558,20,20,40,50.0%,10m
19575,2,kkrotz,2946,414,16,13,29,55.2%,16m
19575,2,Тащер,2946,410,14,17,31,45.2%,7m
19575,2,Dasbooty,2946,245,11,6,17,64.7%,24m
19575,2,OMSK,2946,301,11,8,19,57.9%,51m
19575,2,Shatterer,2946,255,8,7,15,53.3%,22m
19575,2,Surround,2946,0,3,2,5,60.0%,32m
19575,2,lodidodi,2946,128,3,3,6,50.0%,20m
19575,2,Urbant,2946,58,3,4,7,42.9%,11m
19575,2,[NVRFGT]kingSYROhacf,2946,30,2,1,3,66.7%,16m
19575,2,CapS,2946,60,2,3,5,40.0%,14m
19575,3,Evrasty,2946,74,2,5,7,28.6%,36m
19575,2,kekx,2946,62,2,5,7,28.6%,22m
19575,2,Cyl,2946,88,1,1,2,50.0%,18m
19575,2,ElcorE,2946,0,1,1,2,50.0%,19m
19575,1,[LoLa]Toad,2946,0,1,2,3,33.3%,6m
19575,2,VirtualRepka,2946,30,1,2,3,33.3%,9m
19575,2,Ruslan,2946,0,1,2,3,33.3%,8m
19575,1,Eragon,2946,32,1,8,9,11.1%,6m
19575,2,[Днищче]CyberGhost,2946,0,0,1,1,0.0%,8m
19575,2,AndrewMarks,2946,0,0,1,1,0.0%,18m
19575,2,[bBbg7]DerFufuPrinz,2946,0,0,1,1,0.0%,7m
19575,2,[kozaks]Naryvan,2946,0,0,1,1,0.0%,7m
19575,1,[UF2AC]Вермешелька,2946,0,0,1,1,0.0%,48m
19575,2,DumBFounDeaD,2946,0,0,1,1,0.0%,18m
19575,2,[SCRD]PinkPiggy,2946,0,0,1,1,0.0%,5m
19575,2,Ulkiorra,2946,0,0,2,2,0.0%,19m
19610,1,Tessum,2945,1610,429,422,851,50.4%,5m
19610,1,Epileptic,2945,1639,183,182,365,50.1%,15m
19610,2,GreenPanda,2945,1436,103,101,204,50.5%,22m
19610,2,murs,2945,1153,51,37,88,58.0%,8m
19610,2,skillotboga,2945,207,49,35,84,58.3%,24m
19610,2,Sorim,2945,350,45,44,89,50.6%,7m
19610,1,bompa,2945,980,43,46,89,48.3%,21m
19610,1,ZeroHour,2945,826,32,35,67,47.8%,10m
19610,2,HoldOnTight,2945,522,24,16,40,60.0%,22m
19610,2,[Xa]Elgand,2945,331,18,12,30,60.0%,8m
19610,2,profi,2945,475,17,17,34,50.0%,14m
19610,1,Voltage,2945,424,16,17,33,48.5%,20m
19610,2,LootGoblin,2945,332,12,9,21,57.1%,22m
19610,2,[Еврей]DrSik,2945,256,8,7,15,53.3%,5m
19610,2,Aksyra,2945,218,8,9,17,47.1%,24m
19610,1,Gru,2945,224,7,14,21,33.3%,23m
19610,3,Insomnia,2945,164,5,0,5,100.0%,1h
19610,3,BullDog,2945,0,5,2,7,71.4%,44m
19610,2,Shahun,2945,183,5,6,11,45.5%,20m
19610,2,Alzapúa,2945,122,5,8,13,38.5%,23m
19610,1,GOLden,2945,97,4,2,6,66.7%,45m
19610,2,Blazer,2945,30,4,4,8,50.0%,23m
19610,2,Ich,2945,92,4,5,9,44.4%,12m
19610,2,[RoBro]Exekutor,2945,88,2,0,2,100.0%,24m
19610,2,Uragan,2945,88,2,4,6,33.3%,7m
19610,2,Spitfire,2945,88,2,4,6,33.3%,16m
19610,2,[СТРАТ]ODeN,2945,0,1,0,1,100.0%,13m
19610,2,АБАТУР,2945,0,1,0,1,100.0%,16m
19610,3,SquishDidloo,2945,97,1,2,3,33.3%,19m
19610,2,Goldenblood,2945,0,1,2,3,33.3%,14m
19610,2,PandaS,2945,30,1,3,4,25.0%,11m
19610,2,[st7777]OnMinD,2945,0,0,1,1,0.0%,8m
19610,2,[elCrab]drag,2945,0,0,1,1,0.0%,12m
19610,2,vxony,2945,0,0,1,1,0.0%,22m
19644,2,Säblzahn,2944,1607,191,181,372,51.3%,11m
19644,1,Otstavnik,2944,686,70,47,117,59.8%,8m
19644,1,Dirtypeanuts,2944,1042,64,66,130,49.2%,11m
19644,2,Madbonya,2944,933,59,45,104,56.7%,10m
19644,2,Taurus,2944,1050,44,34,78,56.4%,7m
19644,1,schafix,2944,1082,36,44,80,45.0%,15m
19644,2,IIIIIIIIIQ,2944,855,35,30,65,53.8%,22m
19644,2,[EUisOK]WEEBRATOR,2944,573,26,14,40,65.0%,16m
19644,2,BobApricot,2944,516,21,17,38,55.3%,10m
19644,2,MasterLordi,2944,403,16,12,28,57.1%,20m
19644,2,[Bouzeu]Agamous,2944,374,15,13,28,53.6%,9m
19644,2,Dzierzba,2944,280,12,5,17,70.6%,24m
19644,2,Prometheus,2944,344,12,16,28,42.9%,11m
19644,1,Mike,2944,340,12,18,30,40.0%,23m
19644,2,Gornet,2944,310,11,8,19,57.9%,56m
19644,1,[IMORTp]KairosVI,2944,346,11,18,29,37.9%,24m
19644,1,AlvaroLayon,2944,229,10,17,27,37.0%,8m
19644,1,NeverlOk,2944,209,7,3,10,70.0%,6m
19644,2,øpzium,2944,148,6,7,13,46.2%,7m
19644,1,Eyekontakt,2944,48,5,3,8,62.5%,53m
19644,2,Citru,2944,131,4,1,5,80.0%,5m
19644,2,Gong,2944,130,4,2,6,66.7%,7m
19644,2,Frog,2944,148,4,5,9,44.4%,8m
19644,2,MetalHead,2944,90,4,6,10,40.0%,10m
19644,2,Otshelnik,2944,114,3,1,4,75.0%,25m
19644,2,Payasson,2944,86,3,4,7,42.9%,16m
19644,2,RoseCheese,2944,138,3,6,9,33.3%,19m
19644,2,zorkapa,2944,30,2,1,3,66.7%,22m
19644,2,tawi,2944,0,2,1,3,66.7%,22m
19644,2,Kurakeisari,2944,30,2,2,4,50.0%,11m
19644,2,Misanthrope,2944,0,1,0,1,100.0%,7m
19644,2,Cryo,2944,0,1,2,3,33.3%,58m
19644,2,[Bursty]Ganondwarf,2944,0,0,1,1,0.0%,13m
19644,2,[ХоХ]KROKA,2944,0,0,3,3,0.0%,13m
19678,3,Gloom,2943,1532,98,107,205,47.8%,20m
19678,2,Fab,2943,920,68,54,122,55.7%,7m
19678,3,Strandjanet,2943,1458,55,67,122,45.1%,8m
19678,2,NiceGuy,2943,820,39,28,67,58.2%,19m
19678,2,Ogiiiiii,2943,482,18,17,35,51.4%,19m
19678,2,Striker,2943,371,17,6,23,73.9%,9m
19678,1,[looool]Danao,2943,361,17,14,31,54.8%,7m
19678,1,kbbk,2943,512,16,26,42,38.1%,5m
19678,2,mumin,2943,324,12,15,27,44.4%,19m
19678,3,EridoN,2943,209,9,4,13,69.2%,34m
19678,3,RyuK,2943,146,9,6,15,60.0%,15m
19678,2,[Lobdok]Snery,2943,248,8,5,13,61.5%,7m
19678,3,DKlHybrid,2943,221,8,6,14,57.1%,22m
19678,2,Razziel,2943,209,7,4,11,63.6%,25m
19678,2,Eteist,2943,178,7,6,13,53.8%,10m
19678,2,Dangorin,2943,202,7,8,15,46.7%,11m
19678,2,Papus,2943,150,6,6,12,50.0%,15m
19678,2,kickmen,2943,140,5,7,12,41.7%,13m
19678,2,Makiki,2943,0,4,0,4,100.0%,13m
19678,2,Worseize,2943,86,4,4,8,50.0%,18m
19678,1,BengaminVDV,2943,186,4,10,14,28.6%,9m
19678,2,HeroRoach,2943,0,3,2,5,60.0%,17m
19678,2,Karl,2943,116,3,2,5,60.0%,8m
19678,1,Statix,2943,114,3,14,17,17.6%,23m
19678,2,llllllllllll,2943,88,2,0,2,100.0%,13m
19678,2,Vandet,2943,30,2,3,5,40.0%,19m
19678,2,herOS,2943,58,2,3,5,40.0%,6m
19678,2,TrapZ,2943,0,1,0,1,100.0%,10m
19678,1,[BLkSa]NarkotiKa,2943,0,1,1,2,50.0%,51m
19678,2,iPanda,2943,0,1,1,2,50.0%,50m
19678,2,[0wawa0]WGAMEHD,2943,30,1,2,3,33.3%,6m
19678,1,LetsRoll,2943,48,1,2,3,33.3%,58m
19678,2,Ryuk,2943,0,1,2,3,33.3%,5m
19678,2,mamba,2943,132,1,4,5,20.0%,22m
19678,2,Hardboiled,2943,0,0,1,1,0.0%,19m
19678,2,Sherminator,2943,0,0,2,2,0.0%,12m
19678,2,Sibe,2943,0,0,4,4,0.0%,36m
19715,2,vrmllrt,2942,747,137,129,266,51.5%,16m
19715,1,vicjens,2942,1152,132,115,247,53.4%,6m
19715,2,[Ɖeus]RulezHD,2942,528,61,51,112,54.5%,7m
19715,2,GURZIL,2942,1059,50,39,89,56.2%,23m
19715,1,Lokiju,2942,889,34,31,65,52.3%,9m
19715,3,Влад,2942,531,32,33,65,49.2%,7m
19715,2,Kotik,2942,646,27,22,49,55.1%,24m
19715,2,Naimark,2942,731,27,26,53,50.9%,18m
19715,1,[GOGOLS]Yioss,2942,576,18,27,45,40.0%,10m
19715,1,[CanFod]MeShock,2942,485,16,26,42,38.1%,20m
19715,2,testdetruc,2942,261,12,3,15,80.0%,11m
19715,2,[TeamUR]FusTup,2942,198,8,10,18,44.4%,12m
19715,2,ZapBrannigan,2942,212,7,10,17,41.2%,16m
19715,2,Huguenciorg,2942,130,5,0,5,100.0%,23m
19715,2,Misaka,2942,116,5,4,9,55.6%,18m
19715,1,[Böcke]HerbertKrull,2942,188,4,5,9,44.4%,15m
19715,2,TonyMontana,2942,0,3,1,4,75.0%,8m
19715,2,MonkeyDGobli,2942,0,3,2,5,60.0%,25m
19715,1,lIlIlllIII,2942,110,3,11,14,21.4%,6m
19715,2,aleyckin,2942,88,2,0,2,100.0%,23m
19715,2,Aeoit,2942,30,2,2,4,50.0%,8m
19715,2,Mac,2942,62,2,3,5,40.0%,9m
19715,2,[Barbie]CptAwesome,2942,0,1,1,2,50.0%,20m
19715,2,[SkCzM]EvilMarine,2942,0,0,1,1,0.0%,10m
19715,3,Etas,2942,0,0,1,1,0.0%,12m
19715,2,Romol,2942,0,0,2,2,0.0%,23m
19715,2,juozapas,2942,0,0,2,2,0.0%,10m
19742,1,[WCKYLN]donhuette,2941,1632,182,180,362,50.3%,22m
19742,1,Ludegr,2941,924,124,107,231,53.7%,25m
19742,1,zairax,2941,1483,122,127,249,49.0%,7m
19742,2,Wanderer,2941,1518,116,101,217,53.5%,8m
19742,1,[FuFAt]Shd,2941,708,32,24,56,57.1%,6m
19742,3,[JOPAKK]HgAg,2941,924,31,47,78,39.7%,13m
19742,2,[SPAINs]markiman,2941,705,29,24,53,54.7%,10m
19742,1,[ExTr1m]valax,2941,802,29,31,60,48.3%,8m
19742,2,lllllllll,2941,726,28,26,54,51.9%,24m
19742,2,[ApKorv]SwanT,2941,632,26,21,47,55.3%,10m
19742,2,[mfxed]Dracula,2941,445,23,20,43,53.5%,14m
19742,2,kTQ,2941,280,22,15,37,59.5%,11m
19742,2,Necate,2941,363,14,13,27,51.9%,11m
19742,2,Haaans,2941,290,10,10,20,50.0%,7m
19742,2,Dyo,2941,219,8,5,13,61.5%,19m
19742,1,Taimi,2941,240,8,15,23,34.8%,8m
19742,2,[DMI]BlinkFloyd,2941,120,4,8,12,33.3%,4m
19742,2,Tankk,2941,86,3,5,8,37.5%,39m
19742,2,shizzlr,2941,88,2,0,2,100.0%,4m
19742,2,relict,2941,88,2,0,2,100.0%,22m
19742,2,Homelander,2941,138,2,6,8,25.0%,8m
19742,3,IsifLiferu,2941,0,2,6,8,25.0%,46m
19742,2,Clayman,2941,62,2,7,9,22.2%,12m
19742,2,[Lowko]Averie,2941,0,1,0,1,100.0%,9m
19742,2,Mahai,2941,0,1,0,1,100.0%,5m
19742,2,Wuschel,2941,0,0,1,1,0.0%,6m
19742,2,[KS007]Nuke,2941,0,0,3,3,0.0%,5m
19769,2,ZergEatYou,2940,1101,178,141,319,55.8%,8m
19769,2,akta,2940,1567,86,60,146,58.9%,20m
19769,1,csdemons,2940,1313,84,52,136,61.8%,19m
19769,2,slake,2940,1141,54,34,88,61.4%,7m
19769,2,[1DLE]Random,2940,691,43,42,85,50.6%,7m
19769,1,[DIRSTK]Endorama,2940,467,40,42,82,48.8%,25m
19769,2,yolosix,2940,1006,38,38,76,50.0%,12m
19769,2,LingKing,2940,846,36,37,73,49.3%,10m
19769,2,Daedlypuppy,2940,665,31,16,47,66.0%,16m
19769,1,Niko,2940,788,26,34,60,43.3%,23m
19769,1,Audriukasa,2940,465,23,20,43,53.5%,14m
19769,2,[LøS]StraToN,2940,500,19,20,39,48.7%,19m
19769,1,noZebo,2940,624,19,28,47,40.4%,6m
19769,2,LaTeX,2940,438,14,19,33,42.4%,13m
19769,2,MättöKurko,2940,288,11,10,21,52.4%,5m
19769,2,CompuServe,2940,262,10,8,18,55.6%,23m
19769,2,Wolverine,2940,206,7,4,11,63.6%,24m
19769,2,[Viggo]raab,2940,184,6,4,10,60.0%,8m
19769,2,WhiskyPower,2940,113,5,1,6,83.3%,8m
19769,3,Pox,2940,165,5,6,11,45.5%,53m
19769,2,[Qual]dementer,2940,0,4,1,5,80.0%,18m
19769,1,Diamor,2940,0,4,2,6,66.7%,1h
19769,3,[TLEN]oBunLokoc,2940,0,4,3,7,57.1%,34m
19769,2,[Mavis]DoNiLDa,2940,90,4,4,8,50.0%,13m
19769,2,Snake,2940,60,3,2,5,60.0%,7m
19769,2,thomers,2940,0,3,2,5,60.0%,8m
19769,2,FireBall,2940,30,3,4,7,42.9%,16m
19769,2,[QTcIub]phatvt,2940,30,2,1,3,66.7%,7m
19769,2,[ĦĦ]KenKeez,2940,60,2,3,5,40.0%,7m
19769,2,[ZЕRGТV]Pokrepche,2940,0,1,0,1,100.0%,14m
19769,1,danto,2940,97,1,1,2,50.0%,26m
19769,3,PrincePlaya,2940,0,1,2,3,33.3%,46m
19769,2,SevenSins,2940,107,1,4,5,20.0%,21m
19769,2,klooio,2940,0,0,1,1,0.0%,5m
19769,2,Mădălin,2940,0,0,1,1,0.0%,23m
19769,2,Valletos,2940,0,0,1,1,0.0%,7m
19769,2,[O1G]łJoeAceł,2940,0,0,3,3,0.0%,7m
19806,2,Tanggang,2939,1151,256,247,503,50.9%,23m
19806,2,[LMBD]Talha,2939,1592,204,174,378,54.0%,7m
19806,2,Traktarion,2939,1179,72,58,130,55.4%,7m
19806,2,SlavikusVOG,2939,1344,53,46,99,53.5%,7m
19806,2,XXEpheneAXX,2939,744,44,5,49,89.8%,22m
19806,2,Crazy,2939,344,18,16,34,52.9%,8m
19806,2,zet,2939,343,14,12,26,53.8%,19m
19806,2,Aspartat,2939,313,13,17,30,43.3%,6m
19806,2,TexTreMe,2939,328,11,15,26,42.3%,23m
19806,3,[Alboz]FeNix,2939,310,11,25,36,30.6%,24m
19806,2,[RahLuk]dorido,2939,256,10,9,19,52.6%,13m
19806,1,[WndKnd]ywecur,2939,328,9,18,27,33.3%,8m
19806,1,[LKp1]Kelian,2939,66,7,3,10,70.0%,20m
19806,2,actarus,2939,219,7,5,12,58.3%,13m
19806,2,[Heroes]Hatsu,2939,154,6,1,7,85.7%,10m
19806,2,PooopTroper,2939,58,5,4,9,55.6%,11m
19806,2,[Heroes]Beacon,2939,96,5,7,12,41.7%,7m
19806,2,[CUL1]MasterOfDuty,2939,0,4,1,5,80.0%,35m
19806,2,медоед,2939,62,4,6,10,40.0%,4m
19806,2,[Malkak]TheChemist,2939,0,3,2,5,60.0%,24m
19806,2,[SproL]Sheik,2939,112,2,2,4,50.0%,23m
19806,2,Noblesuslik,2939,88,1,1,2,50.0%,10m
19806,2,[AofK]Mro,2939,0,0,1,1,0.0%,11m
19806,2,Thomas,2939,0,0,1,1,0.0%,23m
19830,2,PurpleAvatar,2938,1580,177,167,344,51.5%,7m
19830,1,Ritz,2938,1129,100,96,196,51.0%,25m
19830,2,Zarz,2938,434,86,70,156,55.1%,8m
19830,1,Trustnoone,2938,1650,86,77,163,52.8%,14m
19830,2,Venom,2938,1043,60,31,91,65.9%,23m
19830,1,Tervi,2938,1015,38,44,82,46.3%,19m
19830,1,Sanjuuroku,2938,782,30,29,59,50.8%,21m
19830,3,WhiteBeard,2938,662,29,44,73,39.7%,24m
19830,2,Dervish,2938,627,23,22,45,51.1%,12m
19830,2,Srad,2938,384,16,9,25,64.0%,10m
19830,2,Auch,2938,378,15,13,28,53.6%,16m
19830,2,MaitreGeek,2938,338,14,14,28,50.0%,22m
19830,2,cоndomring,2938,334,12,9,21,57.1%,13m
19830,2,[fam1ly]Steha,2938,242,9,4,13,69.2%,13m
19830,2,Blackbeard,2938,264,9,13,22,40.9%,8m
19830,2,Skag,2938,198,7,10,17,41.2%,11m
19830,2,ChikkenBacon,2938,156,6,1,7,85.7%,10m
19830,3,[K2]JoTaeLe,2938,145,6,5,11,54.5%,46m
19830,1,[Heroes]voidpointer,2938,241,6,8,14,42.9%,31m
19830,2,valra,2938,162,6,10,16,37.5%,11m
19830,1,[Larry]Anaxagore,2938,131,5,4,9,55.6%,4m
19830,2,[KnF]NrG,2938,88,4,3,7,57.1%,19m
19830,3,mxaxa,2938,88,4,7,11,36.4%,18m
19830,2,Fada,2938,102,3,1,4,75.0%,19m
19830,2,selo,2938,120,3,1,4,75.0%,18m
19830,2,noname,2938,102,2,2,4,50.0%,19m
19830,1,JustGoKill,2938,138,2,3,5,40.0%,18m
19830,2,Ado,2938,58,2,4,6,33.3%,13m
19830,2,AresWarcryer,2938,0,1,0,1,100.0%,13m
19830,2,[H0C]McBaine,2938,0,1,0,1,100.0%,12m
19830,2,господин,2938,0,1,0,1,100.0%,22m
19830,2,[QLs]reacT,2938,92,1,1,2,50.0%,23m
19830,1,[HZeS]Dream,2938,0,1,1,2,50.0%,36m
19830,2,[HRDS]ZeroCooL,2938,0,0,1,1,0.0%,11m
19830,2,Rowdy,2938,0,0,1,1,0.0%,7m
19830,2,DeStRo,2938,0,0,1,1,0.0%,14m
19830,2,theone,2938,0,0,2,2,0.0%,7m
19830,2,Nefastis,2938,0,0,3,3,0.0%,23m
19868,2,KpeBeTko,2937,1588,389,377,766,50.8%,23m
19868,3,SkyGF,2937,1493,356,367,723,49.2%,25m
19868,2,Stein,2937,1588,100,77,177,56.5%,25m
19868,2,Razor,2937,874,91,78,169,53.8%,22m
19868,3,Maro,2937,1462,89,87,176,50.6%,15m
19868,1,Polkovnik,2937,1124,72,68,140,51.4%,24m
19868,2,Shazam,2937,610,37,32,69,53.6%,22m
19868,2,WwW,2937,723,33,20,53,62.3%,8m
19868,1,Arta,2937,650,25,25,50,50.0%,14m
19868,1,sjaakbouw,2937,716,22,30,52,42.3%,4m
19868,1,azyr,2937,510,17,24,41,41.5%,6m
19868,1,Cheesus,2937,280,16,16,32,50.0%,23m
19868,2,DiesIrae,2937,385,15,9,24,62.5%,7m
19868,2,Hoggerita,2937,432,15,15,30,50.0%,11m
19868,3,[OvZeTo]laJoud,2937,386,12,27,39,30.8%,6m
19868,2,BlumBlum,2937,322,11,16,27,40.7%,4m
19868,2,CHACKA,2937,278,10,11,21,47.6%,7m
19868,3,Steve,2937,227,8,6,14,57.1%,4m
19868,2,SwarmPrince,2937,230,8,10,18,44.4%,20m
19868,1,Teyas,2937,186,6,4,10,60.0%,36m
19868,2,AlexKirs,2937,106,5,2,7,71.4%,16m
19868,2,Lipstick,2937,150,5,6,11,45.5%,5m
19868,2,[InBe]Quoth,2937,0,3,2,5,60.0%,29m
19868,3,SaviorKai,2937,102,3,4,7,42.9%,35m
19868,2,[hf4X4]Fix,2937,30,3,5,8,37.5%,14m
19868,2,POINPOIN,2937,90,3,7,10,30.0%,19m
19868,2,[UNNerv]GendoIkari,2937,90,3,9,12,25.0%,20m
19868,2,Mrkuzy,2937,60,2,4,6,33.3%,19m
19868,2,CaptBigBoss,2937,88,1,1,2,50.0%,4m
19868,1,[bQuirk]Dofamin,2937,97,1,1,2,50.0%,48m
19868,2,SlamDunk,2937,0,1,2,3,33.3%,16m
19868,1,TheBOSS,2937,48,1,2,3,33.3%,43m
19868,2,[4gk]DarkGuard,2937,0,0,1,1,0.0%,25m
19901,2,Semyonishe,2936,1584,122,117,239,51.0%,8m
19901,2,Dmunozsan,2936,1189,121,109,230,52.6%,11m
19901,2,[InitRu]YASTRIBB,2936,341,80,64,144,55.6%,7m
19901,2,dadilium,2936,1556,69,66,135,51.1%,16m
19901,2,Zacus,2936,862,58,63,121,47.9%,22m
19901,2,[ǂMWRǂ]GoOn,2936,969,39,37,76,51.3%,22m
19901,2,Whounel,2936,741,38,30,68,55.9%,8m
19901,1,gabo,2936,990,35,42,77,45.5%,7m
19901,2,akaeisisdes,2936,678,26,23,49,53.1%,8m
19901,1,[Wu5]patchMe,2936,462,19,18,37,51.4%,20m
19901,2,Leming,2936,452,17,13,30,56.7%,14m
19901,2,aglio,2936,388,15,16,31,48.4%,19m
19901,1,Zaner,2936,379,14,13,27,51.9%,12m
19901,1,NotEnough,2936,408,13,18,31,41.9%,6m
19901,2,[DomPre]barkod,2936,246,12,16,28,42.9%,19m
19901,2,StarForce,2936,288,10,13,23,43.5%,13m
19901,2,[RIZY]attaka,2936,280,10,15,25,40.0%,10m
19901,2,AMFad,2936,218,8,10,18,44.4%,7m
19901,2,Nederplebs,2936,212,8,13,21,38.1%,13m
19901,2,Klonklion,2936,174,7,8,15,46.7%,7m
19901,2,БешеныЙ,2936,194,6,4,10,60.0%,22m
19901,2,Jurnalci,2936,144,6,5,11,54.5%,11m
19901,2,Voland,2936,161,6,6,12,50.0%,22m
19901,2,LeonSakh,2936,174,6,11,17,35.3%,22m
19901,2,Licht,2936,152,5,9,14,35.7%,13m
19901,2,Crover,2936,96,4,4,8,50.0%,13m
19901,2,NeVo,2936,0,3,2,5,60.0%,47m
19901,2,[UAG]Mik,2936,0,3,2,5,60.0%,12m
19901,2,Dagmar,2936,60,3,3,6,50.0%,7m
19901,1,Budynho,2936,0,3,3,6,50.0%,38m
19901,2,XtrizThreeD,2936,30,2,2,4,50.0%,8m
19901,3,doc,2936,123,2,5,7,28.6%,45m
19901,2,BloodLind,2936,88,1,1,2,50.0%,19m
19901,2,Gelbrekt,2936,0,1,2,3,33.3%,24m
19901,2,[LuTe]Tashenk,2936,0,0,1,1,0.0%,16m
19901,2,Maxazac,2936,0,0,1,1,0.0%,6m
19901,2,JenKO,2936,0,0,1,1,0.0%,23m
19901,2,NumbMind,2936,0,0,2,2,0.0%,23m
19939,2,Sia,2935,1470,280,258,538,52.0%,24m
19939,2,BoxAndOne,2935,1556,93,57,150,62.0%,8m
19939,1,[Peeps]ToSsGirL,2935,1636,66,66,132,50.0%,8m
19939,2,Schmette,2935,624,49,42,91,53.8%,7m
19939,2,[Fonta]Juri,2935,537,46,25,71,64.8%,13m
19939,1,[ClDlN]TotalBWord,2935,1132,41,41,82,50.0%,7m
19939,3,[FYBF]Archstefesis,2935,693,32,43,75,42.7%,19m
19939,2,[DSK15]Feniks,2935,589,25,16,41,61.0%,8m
19939,2,[BornG]Bleesk,2935,630,25,19,44,56.8%,22m
19939,2,icantwin,2935,218,23,6,29,79.3%,13m
19939,3,Gbeto,2935,463,20,21,41,48.8%,9m
19939,2,Magoa,2935,228,11,1,12,91.7%,8m
19939,2,[GTOWN]Wikingmarine,2935,276,10,8,18,55.6%,34m
19939,2,ando,2935,270,9,7,16,56.2%,13m
19939,2,micubisi,2935,214,8,4,12,66.7%,7m
19939,2,[loxi]Kurad,2935,184,7,4,11,63.6%,10m
19939,2,[SPAINs]kevinukooo,2935,151,6,5,11,54.5%,22m
19939,2,[KGens]impetus,2935,162,5,3,8,62.5%,13m
19939,3,SzuflA,2935,168,5,3,8,62.5%,55m
19939,1,TortueAgile,2935,161,5,14,19,26.3%,19m
19939,1,Danceacy,2935,104,4,14,18,22.2%,25m
19939,2,Tawerdef,2935,0,3,2,5,60.0%,39m
19939,2,Blackeagle,2935,144,3,3,6,50.0%,12m
19939,2,SanctiRose,2935,140,3,3,6,50.0%,19m
19939,2,Noumz,2935,88,3,5,8,37.5%,25m
19939,2,[SP4CE]SPACE,2935,114,2,2,4,50.0%,14m
19939,2,[HBGSJR]megadimon,2935,0,1,0,1,100.0%,24m
19939,2,DISCARDED,2935,0,1,1,2,50.0%,24m
19939,2,[MenIB]Gantoris,2935,0,1,3,4,25.0%,8m
19939,2,RegentCID,2935,0,1,4,5,20.0%,14m
19939,2,Sety,2935,0,0,1,1,0.0%,5m
19939,2,OgrLord,2935,0,0,1,1,0.0%,16m
19939,2,Afterthought,2935,0,0,1,1,0.0%,7m
19939,2,NextGen,2935,0,0,2,2,0.0%,20m
19939,2,LifeFoNerzul,2935,0,0,2,2,0.0%,13m
19939,1,mokimano,2935,0,0,3,3,0.0%,1h
19975,1,Curious,2934,1476,187,167,354,52.8%,20m
19975,2,getfeinier,2934,958,93,81,174,53.4%,20m
19975,2,utrop,2934,1470,92,81,173,53.2%,7m
19975,2,crisedepseud,2934,1507,92,86,178,51.7%,13m
19975,3,Sjakieownz,2934,437,81,80,161,50.3%,24m
19975,1,Venom,2934,347,63,30,93,67.7%,16m
19975,2,SunCanRock,2934,1183,46,44,90,51.1%,7m
19975,2,Tívar,2934,701,43,34,77,55.8%,8m
19975,2,Starscream,2934,917,40,36,76,52.6%,8m
19975,2,[TBGeV]Bitspyde,2934,751,36,22,58,62.1%,11m
19975,3,NoX,2934,557,30,40,70,42.9%,14m
19975,1,Mystic,2934,803,29,31,60,48.3%,11m
19975,2,[Nеzukо]OniUbiliKeni,2934,549,22,17,39,56.4%,7m
19975,2,SHYTBIRD,2934,538,20,16,36,55.6%,24m
19975,1,[OWLCO]Mordekaye,2934,255,11,9,20,55.0%,42m
19975,2,штаныудачи,2934,309,10,10,20,50.0%,19m
19975,2,[PUT1]SaMere,2934,306,10,15,25,40.0%,7m
19975,1,zoeee,2934,296,8,18,26,30.8%,15m
19975,2,[DINANT]SlaatjeBla,2934,216,7,5,12,58.3%,8m
19975,2,Noobiwan,2934,173,7,5,12,58.3%,24m
19975,2,[WYK]YKiff,2934,140,6,3,9,66.7%,8m
19975,2,pasha,2934,150,6,5,11,54.5%,7m
19975,1,[HACK3R]óóóJuiceWRLD,2934,190,5,2,7,71.4%,60m
19975,1,RAXAS,2934,0,4,2,6,66.7%,47m
19975,1,Imunity,2934,97,4,3,7,57.1%,1h
19975,2,Silentstrike,2934,102,3,0,3,100.0%,7m
19975,2,Ekynos,2934,102,3,1,4,75.0%,9m
19975,2,destructor,2934,86,3,4,7,42.9%,13m
19975,2,GeneralLuke,2934,102,2,1,3,66.7%,7m
19975,2,Fomich,2934,102,2,2,4,50.0%,11m
19975,1,Nikon,2934,34,2,7,9,22.2%,6m
19975,2,[Sparky]Sparky,2934,0,1,0,1,100.0%,16m
19975,2,[M1SE]maghea,2934,0,1,0,1,100.0%,14m
19975,3,Tassadar,2934,0,1,1,2,50.0%,47m
19975,2,Draco,2934,30,1,2,3,33.3%,25m
19975,1,[VoiDTS]ape,2934,48,1,2,3,33.3%,29m
19975,2,[Bádzsó]nerelf,2934,30,1,3,4,25.0%,10m
19975,2,Scorch,2934,42,1,4,5,20.0%,9m
19975,1,KwarkNL,2934,0,1,5,6,16.7%,22m
19975,2,Max,2934,0,0,1,1,0.0%,54m
19975,2,TerranumBLR,2934,0,0,1,1,0.0%,10m
19975,2,Lanka,2934,0,0,2,2,0.0%,10m
19975,2,Flash,2934,0,0,7,7,0.0%,8m
20018,2,FIsben,2933,1545,177,166,343,51.6%,7m
20018,1,StaryTygrys,2933,1541,117,111,228,51.3%,6m
20018,1,Inodeed,2933,1455,104,97,201,51.7%,15m
20018,2,kimdoun,2933,1583,92,85,177,52.0%,16m
20018,2,Flamindm,2933,1154,83,70,153,54.2%,23m
20018,2,[Cassel]Peroxi,2933,1374,82,71,153,53.6%,16m
20018,2,[leOS]Civolt,2933,565,40,30,70,57.1%,5m
20018,2,Schuki,2933,871,37,34,71,52.1%,11m
20018,2,Daimeg,2933,721,28,24,52,53.8%,6m
20018,1,[VFN]DerNibelung,2933,603,24,27,51,47.1%,2m
20018,1,[GURKI]Homunculus,2933,373,19,2,21,90.5%,25m
20018,2,Razihel,2933,425,18,14,32,56.2%,7m
20018,2,Avgan,2933,293,13,4,17,76.5%,12m
20018,2,Radnaatseren,2933,253,9,8,17,52.9%,54m
20018,2,Ken,2933,118,7,6,13,53.8%,1m
20018,3,КотИгрун,2933,151,7,7,14,50.0%,38m
20018,2,[MG2K]GMLee,2933,204,7,11,18,38.9%,22m
20018,1,[SC2ERZ]McMuff,2933,276,7,14,21,33.3%,15m
20018,3,[RxDn]Rotvinn,2933,158,6,6,12,50.0%,57m
20018,3,DeMHioS,2933,187,5,18,23,21.7%,10m
20018,2,IpeX,2933,0,3,2,5,60.0%,1h
20018,2,shMi,2933,0,3,2,5,60.0%,56m
20018,1,Lisk,2933,79,3,12,15,20.0%,2m
20018,3,[AwH]Lobisan,2933,0,1,0,1,100.0%,14m
20018,2,Murphy,2933,0,1,2,3,33.3%,11m
20018,3,Apicis,2933,0,0,1,1,0.0%,16m
20018,3,WePo,2933,0,0,1,1,0.0%,10m
20018,2,[J4tS]Bakka,2933,0,0,3,3,0.0%,8m
20046,3,ChrisTwo,2932,1523,349,353,702,49.7%,3m
20046,3,Jackyd,2932,811,69,79,148,46.6%,11m
20046,2,Girji,2932,645,29,22,51,56.9%,21m
20046,2,Instalooter,2932,563,21,21,42,50.0%,6m
20046,2,[DLTED]AnarQ,2932,446,18,18,36,50.0%,1m
20046,1,Foxxy,2932,276,11,11,22,50.0%,4m
20046,1,RIP,2932,279,11,11,22,50.0%,5m
20046,2,[LIQUID]Squirtonit,2932,206,8,11,19,42.1%,24m
20046,1,[BTF]TurricanNP,2932,212,7,7,14,50.0%,11m
20046,3,[MVV77]MVVRock,2932,140,6,2,8,75.0%,4m
20046,1,JYL,2932,115,5,8,13,38.5%,25m
20046,3,CELPHgorgo,2932,145,4,1,5,80.0%,2m
20046,3,Aero,2932,30,4,2,6,66.7%,15m
20046,1,Hulahuga,2932,97,4,3,7,57.1%,1h
20046,3,[GDK]klindo,2932,0,3,2,5,60.0%,7m
20046,3,Notaruseton,2932,0,3,2,5,60.0%,2m
20046,2,Vagi,2932,30,2,3,5,40.0%,8m
20046,1,Marcus,2932,97,2,3,5,40.0%,22m
20046,2,Corax,2932,60,2,4,6,33.3%,10m
20046,3,[Zolid]Gnurebukken,2932,30,1,1,2,50.0%,7m
20046,3,gornak,2932,30,1,1,2,50.0%,3m
20046,2,[B7]Eldraim,2932,46,1,6,7,14.3%,48m
20046,2,Antony,2932,0,0,2,2,0.0%,7m
20046,2,KATALLIS,2932,0,0,3,3,0.0%,3m
20046,2,Snore,2932,0,0,3,3,0.0%,24m
20071,1,Grudge,2931,1624,139,149,288,48.3%,23m
20071,2,CragHack,2931,1463,124,122,246,50.4%,7m
20071,2,Thyrno,2931,894,110,97,207,53.1%,8m
20071,2,[K0RM2]Agrobot,2931,1551,104,109,213,48.8%,11m
20071,1,[FCHW]KuchiyatSin,2931,959,87,81,168,51.8%,6m
20071,2,HowHardCanZb,2931,1451,79,67,146,54.1%,16m
20071,1,Loynis,2931,1496,73,81,154,47.4%,11m
20071,1,MtGǂStarK,2931,1350,51,50,101,50.5%,10m
20071,2,MiszczGajusz,2931,267,32,27,59,54.2%,9m
20071,2,Serg,2931,614,26,17,43,60.5%,3m
20071,2,[5dHndy]RatSlayer,2931,495,24,14,38,63.2%,22m
20071,1,[WienA]Carnifex,2931,616,24,25,49,49.0%,2m
20071,2,Zoust,2931,498,20,20,40,50.0%,14m
20071,2,MorenoVentas,2931,466,17,19,36,47.2%,8m
20071,2,OnlyOne,2931,415,16,17,33,48.5%,2m
20071,3,aapakner,2931,232,6,9,15,40.0%,38m
20071,3,caine,2931,142,5,4,9,55.6%,14m
20071,3,Mirda,2931,0,4,1,5,80.0%,7m
20071,3,[MFall]Rytern,2931,0,3,1,4,75.0%,13m
20071,2,MangoHi,2931,0,3,2,5,60.0%,48m
20071,3,NextDoor,2931,0,3,2,5,60.0%,5m
20071,2,[CØG]cosmos,2931,30,2,4,6,33.3%,25m
20071,3,SeanSki,2931,0,0,1,1,0.0%,10m
20071,3,Creuvard,2931,0,0,1,1,0.0%,23m
20071,3,BOOMcap,2931,0,0,1,1,0.0%,15m
20071,2,Dareus,2931,0,0,2,2,0.0%,4m
20071,2,gringuo,2931,0,0,2,2,0.0%,5m
20071,2,llllllllllll,2931,0,0,5,5,0.0%,56m
20071,2,zeRa,2931,0,0,7,7,0.0%,10m
20100,3,aaa,2930,1480,79,94,173,45.7%,15m
20100,1,bubur,2930,1559,63,64,127,49.6%,25m
20100,2,Heziva,2930,1223,55,43,98,56.1%,11m
20100,2,Petrishka,2930,1052,54,57,111,48.6%,6m
20100,2,fgvyjmvgbyki,2930,1123,44,43,87,50.6%,23m
20100,2,[boiis]puleeya,2930,929,37,31,68,54.4%,23m
20100,2,FANTIK,2930,685,33,35,68,48.5%,24m
20100,1,Kejmil,2930,913,30,35,65,46.2%,8m
20100,1,MuaDip,2930,562,28,35,63,44.4%,10m
20100,2,[CdiM]mazimo,2930,531,22,19,41,53.7%,14m
20100,2,[ЧИcЯe4]Carlos,2930,458,21,16,37,56.8%,22m
20100,2,fish,2930,588,20,19,39,51.3%,7m
20100,3,[HZeS]Sodon,2930,406,16,5,21,76.2%,7m
20100,2,BrilleHankat,2930,291,12,8,20,60.0%,49m
20100,2,Yunika,2930,268,12,10,22,54.5%,25m
20100,2,Insaneone,2930,267,11,6,17,64.7%,12m
20100,3,TcL,2930,300,11,7,18,61.1%,23m
20100,2,[SPGR]coucouniette,2930,210,8,7,15,53.3%,1h
20100,3,[NMF]Cobalt,2930,221,7,8,15,46.7%,49m
20100,2,arravity,2930,138,5,5,10,50.0%,25m
20100,3,Omega,2930,0,4,1,5,80.0%,13m
20100,3,[213121]Darik,2930,58,3,2,5,60.0%,22m
20100,1,TerranNoob,2930,64,2,5,7,28.6%,14m
20100,3,[KKTI]Monkezzz,2930,0,1,0,1,100.0%,2m
20100,3,DEMO,2930,0,1,0,1,100.0%,12m
20100,3,Loota,2930,0,1,0,1,100.0%,24m
20100,3,LeMonLinK,2930,30,1,2,3,33.3%,9m
20100,3,ironwolf,2930,0,0,1,1,0.0%,11m
20100,3,Equinox,2930,0,0,1,1,0.0%,22m
20100,2,[xTSPx]Elphin,2930,0,0,2,2,0.0%,10m
20100,2,Tosh,2930,0,0,2,2,0.0%,24m
20100,2,[KH3]Riku,2930,0,0,7,7,0.0%,10m
20132,1,oskar,2929,1633,206,210,416,49.5%,11m
20132,2,llllllllllll,2929,1572,199,191,390,51.0%,11m
20132,2,superfil,2929,1334,154,141,295,52.2%,24m
20132,2,DartVader,2929,1540,151,125,276,54.7%,16m
20132,2,Sefa,2929,1556,128,102,230,55.7%,1m
20132,1,CrazyLiv,2929,1447,92,70,162,56.8%,13m
20132,2,Arouza,2929,1472,89,73,162,54.9%,8m
20132,2,Grame,2929,1147,67,63,130,51.5%,3m
20132,2,[SicST]birdy,2929,1507,61,58,119,51.3%,22m
20132,2,Cute,2929,1462,57,54,111,51.4%,8m
20132,1,Brieftraeger,2929,1305,50,49,99,50.5%,25m
20132,2,TheGrayson,2929,669,50,54,104,48.1%,11m
20132,1,MiNuS,2929,1382,49,53,102,48.0%,23m
20132,2,[VFN]RazvanBly,2929,862,39,26,65,60.0%,7m
20132,2,[fFlags]barthem,2929,628,39,43,82,47.6%,8m
20132,2,CrazyDick,2929,267,35,23,58,60.3%,7m
20132,2,[ImWRs]vacatore,2929,634,29,16,45,64.4%,24m
20132,2,[Due]Arteros,2929,346,20,17,37,54.1%,11m
20132,2,Tarasz,2929,358,17,6,23,73.9%,23m
20132,2,[Petrиs]IIIIIIIIIIII,2929,372,14,15,29,48.3%,3m
20132,2,[SCVL]Kerrigan,2929,340,13,10,23,56.5%,10m
20132,1,[voff]Hugo,2929,369,11,16,27,40.7%,22m
20132,2,[Brgman]Coleman,2929,266,9,9,18,50.0%,22m
20132,2,Lucky,2929,117,6,2,8,75.0%,25m
20132,3,BaBaYaSa,2929,140,5,2,7,71.4%,1m
20132,2,IIIIIIIII,2929,134,4,2,6,66.7%,24m
20132,2,Nosta,2929,88,4,4,8,50.0%,7m
20132,2,Marvin,2929,166,4,5,9,44.4%,3m
20132,3,Graeme,2929,0,3,2,5,60.0%,22m
20132,2,moloh,2929,140,3,4,7,42.9%,13m
20132,1,pain,2929,152,3,6,9,33.3%,4m
20132,3,SimakinK,2929,30,2,1,3,66.7%,3m
20132,3,Milano,2929,30,2,1,3,66.7%,13m
20132,2,Zozio,2929,60,2,5,7,28.6%,13m
20132,1,Azalan,2929,48,2,7,9,22.2%,53m
20132,3,Smoke,2929,0,1,0,1,100.0%,2m
20132,2,ТронЛавр,2929,0,1,1,2,50.0%,12m
20132,2,Rem,2929,30,1,8,9,11.1%,8m
20132,3,[Cacoon]Deluchi,2929,0,0,1,1,0.0%,7m
20132,2,Borealis,2929,0,0,3,3,0.0%,14m
20132,2,Ocabeth,2929,0,0,3,3,0.0%,8m
20132,2,szparo,2929,0,0,6,6,0.0%,3m
20174,1,Pive,2928,1637,144,142,286,50.3%,12m
20174,2,Demonizer,2928,1467,123,104,227,54.2%,22m
20174,3,[T2020]MikePence,2928,557,115,101,216,53.2%,6m
20174,2,Calbe,2928,1197,83,72,155,53.5%,22m
20174,2,[J4E]Snehulko,2928,956,60,41,101,59.4%,7m
20174,1,AndrejSmJest,2928,585,26,23,49,53.1%,14m
20174,1,Huchira,2928,678,23,28,51,45.1%,11m
20174,3,GGman,2928,596,21,35,56,37.5%,7m
20174,2,SALCHICHÓN,2928,505,19,15,34,55.9%,22m
20174,2,PoilAuMenton,2928,331,12,8,20,60.0%,51m
20174,3,ChukNorris,2928,301,11,12,23,47.8%,6m
20174,2,Maru,2928,202,7,4,11,63.6%,8m
20174,2,[Tigrus]Arcadeous,2928,176,6,3,9,66.7%,1m
20174,2,Sarminator,2928,152,5,1,6,83.3%,1h
20174,1,WinVal,2928,145,5,3,8,62.5%,58m
20174,1,[Tr0led]Tibi,2928,121,5,5,10,50.0%,46m
20174,2,[6Starz]GreGY,2928,146,4,1,5,80.0%,15m
20174,3,GiJoeBoomi,2928,97,4,4,8,50.0%,7m
20174,2,Archonia,2928,90,4,4,8,50.0%,6m
20174,2,Polaris,2928,92,4,5,9,44.4%,3m
20174,3,Metafomus,2928,88,3,2,5,60.0%,1m
20174,3,Mashine,2928,0,3,2,5,60.0%,7m
20174,2,Boro,2928,0,3,2,5,60.0%,2m
20174,2,Lazeh,2928,90,3,5,8,37.5%,22m
20174,1,Doli,2928,97,2,1,3,66.7%,53m
20174,2,FruitVendor,2928,101,2,4,6,33.3%,1m
20174,2,Shinluu,2928,30,2,5,7,28.6%,24m
20174,2,Amerkan,2928,58,2,5,7,28.6%,10m
20174,3,bastinou,2928,58,2,6,8,25.0%,3m
20174,3,Xukimar,2928,0,1,0,1,100.0%,25m
20174,3,PantokratoR,2928,0,1,0,1,100.0%,15m
20205,2,thilnk,2927,1593,169,160,329,51.4%,24m
20205,2,slip,2927,1591,106,112,218,48.6%,24m
20205,2,Meridian,2927,1522,92,86,178,51.7%,22m
20205,2,Taro,2927,1467,85,66,151,56.3%,8m
20205,2,HTRON,2927,1442,69,64,133,51.9%,24m
20205,2,[ytTO]TheOdies,2927,1325,61,45,106,57.5%,25m
20205,3,Grib,2927,722,23,40,63,36.5%,16m
20205,2,[CMBO]eozym,2927,522,22,18,40,55.0%,10m
20205,2,Blowёbrain,2927,376,18,5,23,78.3%,24m
20205,2,LeftCZ,2927,379,18,12,30,60.0%,22m
20205,2,[SHADAH]xMADSKILZZx,2927,319,14,7,21,66.7%,11m
20205,2,XayAxiA,2927,314,12,8,20,60.0%,23m
20205,3,[SplX]amigo,2927,343,12,9,21,57.1%,25m
20205,1,odin,2927,224,11,9,20,55.0%,14m
20205,3,HacheDeuxOs,2927,277,9,9,18,50.0%,4m
20205,2,Excalibur,2927,207,9,13,22,40.9%,7m
20205,2,[SMTeam]AlexeiJie,2927,180,7,4,11,63.6%,8m
20205,3,[PLA2N]Psihosenser,2927,118,5,4,9,55.6%,22m
20205,2,BlackFeather,2927,163,4,5,9,44.4%,7m
20205,2,[Kodos]farba,2927,0,3,2,5,60.0%,46m
20205,3,VolkerRacho,2927,58,3,2,5,60.0%,24m
20205,3,[Corbi]MEGAKING,2927,0,3,2,5,60.0%,3m
20205,2,MrFraction,2927,0,3,2,5,60.0%,4m
20205,3,Пассажир,2927,0,3,2,5,60.0%,1m
20205,1,Wolf,2927,0,3,3,6,50.0%,26m
20205,3,KarisVenner,2927,58,2,1,3,66.7%,1m
20205,2,[thEnd]DeadEnd,2927,58,2,4,6,33.3%,8m
20205,2,RomanWarrior,2927,60,2,5,7,28.6%,1m
20205,2,IIIIIIIIIIII,2927,30,2,6,8,25.0%,3m
20205,3,Foolpilpa,2927,0,1,0,1,100.0%,3m
20205,2,Заратоол,2927,0,1,1,2,50.0%,1m
20205,2,ukidono,2927,93,1,3,4,25.0%,21m
20205,2,CooLer,2927,0,1,5,6,16.7%,8m
20205,3,[PubgL]Пройдоха,2927,0,0,1,1,0.0%,11m
20205,3,DreadKhar,2927,0,0,1,1,0.0%,14m
20205,2,Naza,2927,0,0,2,2,0.0%,21m
20205,2,SkitFace,2927,0,0,2,2,0.0%,22m
20205,2,cheeseBird,2927,0,0,3,3,0.0%,13m
20243,1,KSVxPipp,2926,1600,200,193,393,50.9%,11m
20243,1,Panashe,2926,1584,94,96,190,49.5%,9m
20243,1,[ZDI]NoughtEmotio,2926,1623,94,99,193,48.7%,24m
20243,2,Naktul,2926,496,87,73,160,54.4%,8m
20243,2,Likov,2926,1353,53,48,101,52.5%,6m
20243,2,[ZERGTV]Grin,2926,716,33,33,66,50.0%,7m
20243,1,EisenbahN,2926,244,32,34,66,48.5%,15m
20243,1,Revorm,2926,738,30,36,66,45.5%,5m
20243,1,EverJy,2926,698,26,27,53,49.1%,7m
20243,2,CptVimes,2926,513,20,15,35,57.1%,13m
20243,2,Reiswind,2926,400,16,12,28,57.1%,3m
20243,2,Shirohige,2926,392,16,16,32,50.0%,14m
20243,2,wizardry,2926,440,15,22,37,40.5%,6m
20243,3,Smoksul,2926,218,11,7,18,61.1%,12m
20243,2,Redirts,2926,256,8,5,13,61.5%,37m
20243,2,Yera,2926,208,7,6,13,53.8%,21m
20243,1,MajinSinhell,2926,192,7,9,16,43.8%,31m
20243,3,[45silm]KingCZE,2926,216,6,6,12,50.0%,21m
20243,2,[CzReKt]DžeyDžey,2926,184,6,10,16,37.5%,6m
20243,2,Casajemo,2926,88,4,3,7,57.1%,8m
20243,1,aaaa,2926,120,4,4,8,50.0%,52m
20243,2,[TSC69]Comrade,2926,94,3,5,8,37.5%,6m
20243,2,jungleboogie,2926,86,3,7,10,30.0%,16m
20243,1,VarpO,2926,88,2,2,4,50.0%,1m
20243,3,IIIIIIIIIIII,2926,0,1,0,1,100.0%,8m
20243,2,Nistelbog,2926,0,1,5,6,16.7%,11m
20243,3,Nua,2926,0,0,1,1,0.0%,3m
20243,3,Crusader,2926,0,0,1,1,0.0%,3m
20243,3,WujekSoko,2926,0,0,1,1,0.0%,12m
20243,3,[TSSI]BouhDiu,2926,0,0,1,1,0.0%,11m
20243,3,МегоДедс,2926,0,0,1,1,0.0%,10m
20243,2,saracin,2926,0,0,3,3,0.0%,1m
20243,2,ElevatorII,2926,0,0,3,3,0.0%,10m
20276,2,KazimirZero,2925,1537,182,180,362,50.3%,1m
20276,3,[PcT]NoOnAL,2925,1508,149,154,303,49.2%,7m
20276,3,Kilo,2925,1527,123,136,259,47.5%,9m
20276,2,[AAWW]Txustice,2925,1533,70,56,126,55.6%,9m
20276,3,[RoxtaR]megavit,2925,702,35,23,58,60.3%,12m
20276,1,GingerBen,2925,612,21,26,47,44.7%,12m
20276,2,Shy,2925,536,20,17,37,54.1%,11m
20276,2,NataS,2925,345,15,17,32,46.9%,13m
20276,3,tehpwnrer,2925,335,13,13,26,50.0%,25m
20276,2,Pelinore,2925,379,13,18,31,41.9%,11m
20276,2,[Z3R9]Näx,2925,303,10,10,20,50.0%,14m
20276,2,[j3w]SLIMMMEYYYY,2925,214,9,7,16,56.2%,22m
20276,3,llllllllllll,2925,168,8,2,10,80.0%,16m
20276,2,[lOoOl]NoobyDoo,2925,206,7,4,11,63.6%,3m
20276,3,[AlienR]ReaMbled,2925,99,5,2,7,71.4%,4m
20276,2,Dab,2925,154,5,6,11,45.5%,3m
20276,2,strangelet,2925,30,4,3,7,57.1%,14m
20276,2,[xFire]JonyFox,2925,144,4,5,9,44.4%,58m
20276,2,Kookoko,2925,0,3,2,5,60.0%,59m
20276,2,[xFSRx]Erich,2925,0,3,3,6,50.0%,13m
20276,2,IIIIIIIIIIII,2925,90,3,5,8,37.5%,7m
20276,2,Jochem,2925,90,3,6,9,33.3%,24m
20276,3,[EDI]SkillsInge,2925,30,1,1,2,50.0%,14m
20276,3,Brofessor,2925,0,0,1,1,0.0%,3m
20276,3,PsychO,2925,0,0,1,1,0.0%,16m
20276,2,Mellifaro,2925,0,0,4,4,0.0%,57m
20302,2,OLDMANHERO,2924,1579,121,113,234,51.7%,7m
20302,2,GhandisRage,2924,1027,72,69,141,51.1%,11m
20302,2,Volker,2924,1349,68,59,127,53.5%,3m
20302,1,woody,2924,912,65,68,133,48.9%,11m
20302,2,Twister,2924,989,43,32,75,57.3%,3m
20302,3,Perfn,2924,953,37,30,67,55.2%,21m
20302,1,[WF31A]Apollo,2924,832,36,38,74,48.6%,12m
20302,1,[abbb]howdeh,2924,777,32,31,63,50.8%,5m
20302,2,LuckyShot,2924,590,26,15,41,63.4%,25m
20302,2,EnkiVritra,2924,289,22,27,49,44.9%,7m
20302,2,misa,2924,465,21,7,28,75.0%,24m
20302,2,Mortis,2924,422,16,14,30,53.3%,13m
20302,2,[V1]waf,2924,179,12,9,21,57.1%,8m
20302,2,Xakari,2924,314,12,9,21,57.1%,24m
20302,2,[GGasap]andChill,2924,304,11,10,21,52.4%,7m
20302,1,[TheLH]BurtMacklin,2924,336,10,20,30,33.3%,1m
20302,3,Grif,2924,216,8,6,14,57.1%,22m
20302,2,[Yoga]Kundalini,2924,203,7,7,14,50.0%,1m
20302,1,FaTaLiTy,2924,174,7,7,14,50.0%,4m
20302,2,[RBadB]Smaug,2924,146,6,8,14,42.9%,11m
20302,3,djark,2924,86,4,1,5,80.0%,7m
20302,2,[AruFur]Arukanin,2924,118,4,5,9,44.4%,10m
20302,2,Chivas,2924,128,4,9,13,30.8%,7m
20302,3,[decoy]dib,2924,58,3,2,5,60.0%,11m
20302,2,BobSnot,2924,60,3,3,6,50.0%,8m
20302,3,[SCF]DemonHunter,2924,0,1,0,1,100.0%,22m
20302,3,TitusPullo,2924,0,1,0,1,100.0%,14m
20302,2,LAMAO,2924,30,1,5,6,16.7%,3m
20302,3,Keijiro,2924,0,0,1,1,0.0%,6m
20302,2,FaDjong,2924,0,0,2,2,0.0%,7m
20332,2,BudHimself,2923,777,85,72,157,54.1%,11m
20332,1,MERION,2923,765,32,25,57,56.1%,23m
20332,1,Casic,2923,812,28,35,63,44.4%,4m
20332,2,buuu,2923,546,20,17,37,54.1%,24m
20332,3,[SPAINs]RENO,2923,421,16,13,29,55.2%,23m
20332,2,Noklyne,2923,441,15,15,30,50.0%,13m
20332,2,Silwio,2923,354,14,14,28,50.0%,7m
20332,3,Gylisan,2923,368,13,2,15,86.7%,7m
20332,2,[SoLu]JonDuomma,2923,205,10,7,17,58.8%,22m
20332,1,KaminaGG,2923,249,8,14,22,36.4%,8m
20332,2,Sonnemuzen,2923,168,7,4,11,63.6%,14m
20332,3,TheOneSwarm,2923,200,7,6,13,53.8%,16m
20332,3,Lipton,2923,180,7,8,15,46.7%,22m
20332,2,УбийцаЛохов,2923,148,6,7,13,46.2%,3m
20332,1,[xKillx]Killer,2923,176,5,14,19,26.3%,22m
20332,3,SweetLou,2923,0,4,1,5,80.0%,2m
20332,2,BigGuy,2923,126,4,10,14,28.6%,16m
20332,2,PrayOneMe,2923,0,3,2,5,60.0%,56m
20332,2,mka,2923,0,3,2,5,60.0%,47m
20332,2,[ROSC]cobrabm,2923,88,3,8,11,27.3%,3m
20332,1,Nemesis,2923,97,2,0,2,100.0%,1h
20332,2,Cassiopeia,2923,0,1,1,2,50.0%,25m
20332,2,target,2923,0,1,2,3,33.3%,8m
20332,2,[2iq]MacroLI,2923,88,1,2,3,33.3%,24m
20332,3,ЗлойКошара,2923,0,0,1,1,0.0%,22m
20332,3,IceMan,2923,0,0,1,1,0.0%,16m
20332,3,leo,2923,0,0,1,1,0.0%,9m
20332,3,MiiiNoGa,2923,0,0,1,1,0.0%,7m
20332,2,Arduriki,2923,0,0,2,2,0.0%,3m
20361,1,brtk,2922,1417,112,112,224,50.0%,6m
20361,1,[ZERGTV]mamaHacker,2922,1639,98,100,198,49.5%,4m
20361,1,[1FU2]atpnrj,2922,957,76,74,150,50.7%,15m
20361,1,[Hrr]FrIsTaYl,2922,1239,49,58,107,45.8%,23m
20361,2,Yunt,2922,631,39,38,77,50.6%,7m
20361,2,Jast,2922,718,30,25,55,54.5%,3m
20361,2,MlleVerte,2922,738,27,29,56,48.2%,11m
20361,2,Jazzor,2922,589,23,21,44,52.3%,8m
20361,2,[RMWP]MrScruff,2922,426,22,19,41,53.7%,5m
20361,2,noobz,2922,561,22,20,42,52.4%,9m
20361,2,Akeno,2922,560,20,21,41,48.8%,12m
20361,2,JerOrc,2922,295,11,10,21,52.4%,12m
20361,1,Covid,2922,374,11,22,33,33.3%,8m
20361,2,Yama,2922,148,5,8,13,38.5%,3m
20361,1,tokAgero,2922,224,5,10,15,33.3%,4m
20361,2,makhach,2922,0,4,1,5,80.0%,3m
20361,2,[AAO]Arminius,2922,114,4,5,9,44.4%,1m
20361,3,Tchetchen,2922,93,4,5,9,44.4%,8m
20361,3,MikleOP,2922,0,1,0,1,100.0%,3m
20361,2,Stringset,2922,0,1,0,1,100.0%,1h
20361,3,Devaax,2922,30,1,2,3,33.3%,1m
20361,3,llllllllllll,2922,0,0,1,1,0.0%,1h
20361,3,Tbroco,2922,0,0,1,1,0.0%,8m
20384,1,Ezt,2921,1245,112,102,214,52.3%,8m
20384,2,[Petrиs]JusttheKeL,2921,1009,107,88,195,54.9%,10m
20384,2,Hosenpaul,2921,1067,88,80,168,52.4%,3m
20384,2,dementium,2921,673,26,27,53,49.1%,22m
20384,2,Cold,2921,339,17,10,27,63.0%,24m
20384,2,[QTclub]Rey,2921,341,14,6,20,70.0%,3m
20384,2,[Tuki]MrOrange,2921,215,12,9,21,57.1%,8m
20384,1,Hoyskyi,2921,388,12,22,34,35.3%,2m
20384,2,[kGk]Zilos,2921,200,8,6,14,57.1%,25m
20384,2,Ironside,2921,257,7,6,13,53.8%,17m
20384,2,Daemos,2921,146,6,8,14,42.9%,15m
20384,3,Roberto,2921,38,5,4,9,55.6%,23m
20384,1,Sarisael,2921,112,5,18,23,21.7%,2m
20384,2,LuSolo,2921,114,4,9,13,30.8%,13m
20384,2,Havoc,2921,62,3,3,6,50.0%,8m
20384,3,[LEVATI]Maestral,2921,30,3,3,6,50.0%,7m
20384,2,[LIQUID]NOOBeERrXD,2921,0,2,1,3,66.7%,47m
20384,2,Tugrakod,2921,0,2,2,4,50.0%,18m
20384,2,[THound]Skyy,2921,10,2,4,6,33.3%,13m
20384,1,MrClottom,2921,60,2,12,14,14.3%,13m
20384,3,LunaticFool,2921,95,1,2,3,33.3%,16m
20384,1,FoAMDFun,2921,44,1,3,4,25.0%,7m
20384,2,MrTock,2921,30,1,3,4,25.0%,3m
20384,2,Zestiny,2921,30,1,4,5,20.0%,7m
20384,3,Shatolllllll,2921,0,0,1,1,0.0%,3m
20384,3,ITишник,2921,0,0,1,1,0.0%,13m
20384,2,[Dralag]FerimOn,2921,0,0,2,2,0.0%,5m
20384,2,suppedans,2921,0,0,4,4,0.0%,2m
20412,2,IIIIIIIII,2920,1587,235,211,446,52.7%,12m
20412,2,loikun,2920,1365,178,172,350,50.9%,12m
20412,2,abc,2920,1408,100,95,195,51.3%,25m
20412,2,Ivan,2920,1584,96,78,174,55.2%,11m
20412,2,CyalloN,2920,997,50,47,97,51.5%,7m
20412,2,NangaParbat,2920,1240,49,50,99,49.5%,2m
20412,2,LeonLi,2920,1013,44,38,82,53.7%,7m
20412,2,Sharovf,2920,1041,43,36,79,54.4%,4m
20412,2,hybride,2920,610,29,16,45,64.4%,17m
20412,2,DuMaCoH,2920,692,27,26,53,50.9%,6m
20412,3,LaLeTe,2920,731,27,34,61,44.3%,10m
20412,1,ksayter,2920,784,26,34,60,43.3%,11m
20412,1,[MHACKS]Fenris,2920,512,19,20,39,48.7%,12m
20412,2,DeeX,2920,181,10,11,21,47.6%,3m
20412,2,bigmanIsak,2920,248,9,7,16,56.2%,23m
20412,2,Maksim,2920,116,7,6,13,53.8%,7m
20412,1,DrAngelicus,2920,0,4,3,7,57.1%,8m
20412,2,TisseFrans,2920,0,3,2,5,60.0%,48m
20412,2,Punisher,2920,60,3,3,6,50.0%,7m
20412,2,[Herz]Isengrim,2920,144,3,4,7,42.9%,2m
20412,3,GWashington,2920,0,2,2,4,50.0%,15m
20412,2,[turtle]Ralphwiggum,2920,58,2,4,6,33.3%,12m
20412,2,Taichoru,2920,94,2,4,6,33.3%,21m
20412,2,Tattletale,2920,30,1,3,4,25.0%,3m
20412,3,[Pöhn]HibsmyHubs,2920,0,1,4,5,20.0%,11m
20412,2,jabushka,2920,30,1,6,7,14.3%,11m
20412,3,[Maitri]AryaTara,2920,0,0,1,1,0.0%,11m
20412,3,Zed,2920,0,0,1,1,0.0%,24m
20412,3,[Dtail]Riddim,2920,0,0,1,1,0.0%,6m
20412,3,UltraSerg,2920,0,0,1,1,0.0%,10m
20412,2,[GGames]AntSavva,2920,0,0,3,3,0.0%,25m
20443,2,[JYD]jpoha,2919,1411,158,141,299,52.8%,9m
20443,1,DarkSector,2919,1626,140,139,279,50.2%,4m
20443,1,Hakuda,2919,1648,73,82,155,47.1%,6m
20443,2,Nikrator,2919,587,36,19,55,65.5%,3m
20443,2,Tsar,2919,658,27,21,48,56.2%,7m
20443,2,Abaddon,2919,447,23,7,30,76.7%,13m
20443,2,EgorMaker,2919,490,21,8,29,72.4%,24m
20443,2,Tatyana,2919,454,15,16,31,48.4%,10m
20443,2,Damkani,2919,398,15,17,32,46.9%,8m
20443,1,Hugos,2919,416,14,19,33,42.4%,15m
20443,2,vadimjim,2919,146,8,7,15,53.3%,7m
20443,1,[BRSKR]Ratfizz,2919,186,6,6,12,50.0%,37m
20443,2,[D0N3]Tehdemonic,2919,154,5,2,7,71.4%,2m
20443,3,[DeepT]alex,2919,0,3,2,5,60.0%,22m
20443,3,Apoks,2919,0,3,2,5,60.0%,6m
20443,2,[239]LeAST,2919,68,2,8,10,20.0%,25m
20443,3,Rinzler,2919,30,1,1,2,50.0%,4m
20443,3,iLLNino,2919,0,0,1,1,0.0%,10m
20443,3,Slama,2919,0,0,1,1,0.0%,10m
20462,1,BaboJan,2918,892,71,71,142,50.0%,10m
20462,2,Kucharro,2918,1435,65,59,124,52.4%,14m
20462,2,EliteHunter,2918,1457,62,49,111,55.9%,24m
20462,1,[SkBG]pentium,2918,1121,45,43,88,51.1%,2m
20462,3,[Moskva]Rodnoy,2918,695,40,28,68,58.8%,24m
20462,2,[BlackT]LightYagami,2918,231,27,17,44,61.4%,12m
20462,3,Sicko,2918,542,22,17,39,56.4%,4m
20462,2,Lich,2918,98,20,12,32,62.5%,10m
20462,3,Wexaris,2918,477,19,8,27,70.4%,10m
20462,2,[DAzz]Kevin,2918,470,19,16,35,54.3%,8m
20462,1,malda,2918,454,19,19,38,50.0%,23m
20462,2,VULPE,2918,466,19,19,38,50.0%,1m
20462,1,Ichi,2918,598,19,26,45,42.2%,14m
20462,2,Noksion,2918,412,18,16,34,52.9%,10m
20462,2,[R4Time]MARS,2918,438,16,14,30,53.3%,5m
20462,2,Серега,2918,258,12,12,24,50.0%,8m
20462,2,bayesian,2918,205,11,13,24,45.8%,11m
20462,3,LikerGames,2918,210,9,5,14,64.3%,2m
20462,3,Mad,2918,174,7,4,11,63.6%,13m
20462,2,Mako,2918,228,7,4,11,63.6%,20m
20462,3,Krigueur,2918,193,7,7,14,50.0%,33m
20462,2,NepNep,2918,128,6,4,10,60.0%,10m
20462,2,Slickmund,2918,30,5,2,7,71.4%,23m
20462,2,JordanYA,2918,77,4,4,8,50.0%,21m
20462,1,Copmuter,2918,148,4,4,8,50.0%,20m
20462,2,LEKSERG,2918,86,4,7,11,36.4%,22m
20462,3,[TBWF]Buskelusker,2918,0,3,2,5,60.0%,14m
20462,3,Endofo,2918,0,3,2,5,60.0%,3m
20462,1,[MIGROS]achmanngopf,2918,48,3,4,7,42.9%,48m
20462,3,Troptox,2918,58,2,1,3,66.7%,22m
20462,2,Adwi,2918,30,2,2,4,50.0%,14m
20462,2,Crazzy,2918,36,2,2,4,50.0%,14m
20462,1,korslash,2918,0,1,0,1,100.0%,29m
20462,3,[Hppl]Axezz,2918,0,1,0,1,100.0%,3m
20462,3,Brizzy,2918,0,1,0,1,100.0%,2m
20462,2,Shadowmaker,2918,88,1,2,3,33.3%,25m
20462,3,Vanitas,2918,0,0,1,1,0.0%,3m
20462,3,esLXeqtR,2918,0,0,1,1,0.0%,2m
20462,2,[Tjops]badger,2918,0,0,2,2,0.0%,2m
20501,3,[ValidG]Life,2917,1552,300,287,587,51.1%,8m
20501,2,sayurealboi,2917,1096,155,125,280,55.4%,8m
20501,2,AGenericUser,2917,754,29,29,58,50.0%,3m
20501,3,IoiLOS,2917,445,22,9,31,71.0%,21m
20501,2,Lotionan,2917,296,11,9,20,55.0%,8m
20501,1,bre,2917,295,9,7,16,56.2%,31m
20501,2,[EXPANT]Bratta,2917,166,9,9,18,50.0%,20m
20501,1,madmaniac,2917,193,7,5,12,58.3%,49m
20501,3,SorryImDrunk,2917,120,5,4,9,55.6%,11m
20501,3,[Qiogun]Froiz,2917,86,4,2,6,66.7%,5m
20501,3,Jaywalker,2917,0,3,1,4,75.0%,1m
20501,2,[BMTR]Joei,2917,0,3,2,5,60.0%,1m
20501,2,[XTeeAM]cid,2917,60,2,4,6,33.3%,22m
20501,2,Ziko,2917,58,2,4,6,33.3%,16m
20501,3,Shatun,2917,0,1,0,1,100.0%,25m
20501,3,[Hellsc]overmind,2917,30,1,1,2,50.0%,3m
20501,3,PistolPete,2917,0,0,1,1,0.0%,24m
20501,3,Deviance,2917,0,0,1,1,0.0%,12m
20501,3,DijonMustach,2917,0,0,1,1,0.0%,16m
20501,2,MrExcuseMe,2917,0,0,2,2,0.0%,24m
20501,2,skoorB,2917,0,0,2,2,0.0%,9m
20501,2,Martoko,2917,0,0,3,3,0.0%,6m
20501,3,TWiace,2917,0,0,3,3,0.0%,5m
20524,3,pulsar,2916,916,312,316,628,49.7%,3m
20524,2,SeeJah,2916,1475,80,83,163,49.1%,6m
20524,2,muzman,2916,859,73,70,143,51.0%,7m
20524,2,Sigur,2916,1315,52,56,108,48.1%,13m
20524,2,Combain,2916,813,31,31,62,50.0%,2m
20524,2,MiniPeludin,2916,374,14,16,30,46.7%,3m
20524,2,fLy,2916,137,9,6,15,60.0%,18m
20524,2,[BCM]Iceman,2916,260,9,8,17,52.9%,6m
20524,1,[EZKBM]HeavensWolf,2916,296,9,9,18,50.0%,31m
20524,2,KamIdZu,2916,212,8,10,18,44.4%,8m
20524,2,ECII,2916,200,7,6,13,53.8%,16m
20524,1,[BH4E]AmarR,2916,206,6,1,7,85.7%,45m
20524,2,[RaLaKn]ToMoKrOwA,2916,176,6,9,15,40.0%,14m
20524,3,[Catena]Daereon,2916,144,5,4,9,55.6%,21m
20524,1,drv,2916,144,5,14,19,26.3%,22m
20524,1,NotoriousBIG,2916,165,4,1,5,80.0%,24m
20524,1,Tentacule,2916,96,4,7,11,36.4%,59m
20524,2,Kartyl,2916,0,3,2,5,60.0%,15m
20524,2,WarPrism,2916,0,3,2,5,60.0%,18m
20524,3,Chmock,2916,0,3,2,5,60.0%,14m
20524,1,[BGS]SumerskiBog,2916,0,3,3,6,50.0%,47m
20524,2,Dislife,2916,48,3,3,6,50.0%,18m
20524,2,KpacyH,2916,30,2,2,4,50.0%,14m
20524,2,ДРАБИЛКА,2916,64,2,5,7,28.6%,8m
20524,2,[BBLS]eZxSievi,2916,0,1,0,1,100.0%,40m
20524,3,Toadboii,2916,0,1,0,1,100.0%,24m
20524,3,AtmOroZoK,2916,0,1,0,1,100.0%,23m
20524,2,Seneram,2916,0,1,1,2,50.0%,21m
20524,3,Dreyghost,2916,0,0,1,1,0.0%,16m
20553,1,SWAYCER,2915,1597,208,199,407,51.1%,4m
20553,2,CrimsonKing,2915,1467,92,82,174,52.9%,3m
20553,2,miraal,2915,1267,65,50,115,56.5%,16m
20553,3,Slasher,2915,1177,48,40,88,54.5%,24m
20553,2,Anticancer,2915,1190,48,42,90,53.3%,8m
20553,1,YLibelluleG,2915,1046,39,43,82,47.6%,12m
20553,1,valy,2915,389,30,34,64,46.9%,3m
20553,2,[lŦl]Aramanth,2915,510,18,24,42,42.9%,24m
20553,2,FearMyFist,2915,402,15,12,27,55.6%,24m
20553,2,[Adeln]Spaden,2915,354,14,12,26,53.8%,1m
20553,2,[PIAIC]Wridem,2915,348,12,11,23,52.2%,7m
20553,1,[TBiC]DeXaT,2915,308,12,11,23,52.2%,37m
20553,2,Vayki,2915,143,6,1,7,85.7%,8m
20553,3,Hilps,2915,170,6,4,10,60.0%,12m
20553,2,FlexPlexico,2915,90,6,5,11,54.5%,3m
20553,2,Vargen,2915,48,5,1,6,83.3%,15m
20553,3,timi,2915,114,5,2,7,71.4%,3m
20553,3,Raoth,2915,146,5,3,8,62.5%,5m
20553,3,Endless,2915,115,4,3,7,57.1%,13m
20553,2,Lemmiwinkz,2915,114,4,6,10,40.0%,13m
20553,2,Flo,2915,114,4,7,11,36.4%,1m
20553,3,yolodaddy,2915,0,3,2,5,60.0%,1m
20553,3,[Ginf]Meradan,2915,30,2,0,2,100.0%,10m
20553,3,CrazyIvan,2915,58,2,1,3,66.7%,7m
20553,3,northstream,2915,48,2,3,5,40.0%,24m
20553,1,EvilFF,2915,96,2,5,7,28.6%,30m
20553,2,Scipion,2915,30,1,9,10,10.0%,25m
20553,3,[NCtk]Bartimaeus,2915,0,0,1,1,0.0%,10m
20553,2,[Aw3]legarca,2915,0,0,3,3,0.0%,10m
20553,3,Malikou,2915,0,0,9,9,0.0%,2m
20583,1,space,2914,1614,202,215,417,48.4%,5m
20583,1,JohnLaw,2914,1618,152,141,293,51.9%,23m
20583,3,Matches,2914,1443,118,106,224,52.7%,9m
20583,2,[DnBA]Byjol,2914,438,43,42,85,50.6%,24m
20583,1,[KKTI]ViRuZ,2914,869,34,32,66,51.5%,11m
20583,1,mruniversum,2914,855,32,34,66,48.5%,14m
20583,2,[QTcIub]Faro,2914,657,29,18,47,61.7%,7m
20583,1,OneTwo,2914,702,27,30,57,47.4%,4m
20583,2,HangMAN,2914,344,13,16,29,44.8%,13m
20583,1,[LLEDV]Foxtwo,2914,201,7,2,9,77.8%,24m
20583,3,Punisher,2914,177,7,5,12,58.3%,14m
20583,2,sin,2914,144,6,12,18,33.3%,24m
20583,3,Xiep,2914,139,5,2,7,71.4%,10m
20583,3,[LTFBF]Daggster,2914,183,4,5,9,44.4%,19m
20583,2,IIIIIIIIIIII,2914,0,3,2,5,60.0%,1h
20583,3,APTYP,2914,60,2,2,4,50.0%,10m
20583,3,NoNameMyName,2914,60,2,4,6,33.3%,8m
20583,1,barbouse,2914,0,2,5,7,28.6%,30m
20583,1,[Yakuza]JuZdOiT,2914,0,1,0,1,100.0%,33m
20583,3,Aservat,2914,30,1,1,2,50.0%,7m
20583,3,Syrenox,2914,0,0,1,1,0.0%,8m
20583,3,Para,2914,0,0,1,1,0.0%,14m
20583,3,[NLTN]Ultralisk,2914,0,0,1,1,0.0%,6m
20583,3,Бандера,2914,0,0,1,1,0.0%,10m
20607,1,Koschder,2913,1632,125,118,243,51.4%,12m
20607,2,[1ndica]elZablo,2913,1544,93,74,167,55.7%,8m
20607,2,Kushtro,2913,1555,90,79,169,53.3%,22m
20607,2,BbIDP,2913,1570,85,75,160,53.1%,22m
20607,2,[FARLIG]Terminator,2913,1171,46,47,93,49.5%,3m
20607,3,Born,2913,846,32,27,59,54.2%,17m
20607,2,Deleska,2913,217,14,12,26,53.8%,10m
20607,2,[TTEA]Genera,2913,420,14,14,28,50.0%,14m
20607,3,[iSARS]Duran,2913,307,13,12,25,52.0%,23m
20607,3,[PMMM]Ender,2913,280,10,10,20,50.0%,25m
20607,1,Sardar,2913,275,10,14,24,41.7%,9m
20607,2,onefuncman,2913,231,9,8,17,52.9%,43m
20607,2,Booyah,2913,202,8,4,12,66.7%,6m
20607,1,Hoakin,2913,190,7,11,18,38.9%,8m
20607,2,Moesg,2913,164,6,7,13,46.2%,54m
20607,2,zougoulou,2913,158,5,13,18,27.8%,3m
20607,1,[SAHO]Firestorm,2913,0,4,3,7,57.1%,6m
20607,3,Martì,2913,152,4,4,8,50.0%,8m
20607,3,konrad,2913,86,3,2,5,60.0%,9m
20607,2,Zazu,2913,102,3,2,5,60.0%,8m
20607,2,Ted,2913,0,3,2,5,60.0%,35m
20607,2,marwincz,2913,88,2,1,3,66.7%,22m
20607,3,Rqptor,2913,0,1,0,1,100.0%,24m
20607,3,Tibbltabbl,2913,0,1,0,1,100.0%,8m
20607,3,Brodyaga,2913,0,1,0,1,100.0%,9m
20607,3,Fox,2913,0,1,0,1,100.0%,25m
20607,3,Glace,2913,0,1,0,1,100.0%,7m
20607,1,Azagapp,2913,0,1,2,3,33.3%,14m
20607,2,[MG2K]awelase,2913,30,1,3,4,25.0%,10m
20607,3,[ReziPe]CremeBrulee,2913,0,0,1,1,0.0%,15m
20607,2,NightOwlvQ,2913,0,0,2,2,0.0%,24m
20607,2,Thebossadry,2913,0,0,7,7,0.0%,7m
20639,3,Mercury,2912,1548,365,361,726,50.3%,9m
20639,3,Nevermind,2912,1626,235,219,454,51.8%,21m
20639,1,drRobz,2912,1387,180,174,354,50.8%,23m
20639,2,Hence,2912,949,179,168,347,51.6%,13m
20639,3,Zaur,2912,1298,124,127,251,49.4%,23m
20639,1,МакроЛичинус,2912,1041,43,38,81,53.1%,23m
20639,3,NUDELAUFLAUF,2912,470,30,37,67,44.8%,11m
20639,2,BlueBanana,2912,658,29,19,48,60.4%,3m
20639,2,[MGIMO]kiradaily,2912,461,26,15,41,63.4%,14m
20639,1,TormenDad,2912,467,19,21,40,47.5%,22m
20639,2,ClayWaifu,2912,420,16,14,30,53.3%,13m
20639,2,Wertyn,2912,376,13,19,32,40.6%,24m
20639,2,DyingDead,2912,282,12,11,23,52.2%,24m
20639,2,Smârsh,2912,261,11,8,19,57.9%,22m
20639,2,Retro,2912,284,11,10,21,52.4%,19m
20639,2,[Ogz]Faramir,2912,271,10,14,24,41.7%,25m
20639,1,[TBMG]unwetter,2912,276,9,10,19,47.4%,7m
20639,2,pTxcLiFF,2912,227,8,9,17,47.1%,42m
20639,3,Flavianz,2912,170,7,3,10,70.0%,4m
20639,1,PrettyFlacko,2912,114,6,5,11,54.5%,23m
20639,2,[WFB]Recognize,2912,112,5,3,8,62.5%,20m
20639,1,Moon,2912,160,5,14,19,26.3%,22m
20639,2,Myutix,2912,152,4,4,8,50.0%,22m
20639,3,PlanckTime,2912,60,3,1,4,75.0%,10m
20639,2,[COUINE]Heliphas,2912,0,3,2,5,60.0%,7m
20639,2,RuRader,2912,112,3,2,5,60.0%,8m
20639,1,[TAW]TinGodzilla,2912,145,2,3,5,40.0%,31m
20639,1,hmmlol,2912,97,2,3,5,40.0%,29m
20639,1,Lasio,2912,0,1,0,1,100.0%,38m
20639,3,Mester,2912,30,1,1,2,50.0%,22m
20639,3,Chopiporchok,2912,0,0,1,1,0.0%,10m
20639,1,bambiraptor,2912,0,0,1,1,0.0%,56m
20639,3,Danik,2912,0,0,1,1,0.0%,7m
20639,3,ukrosamurai,2912,0,0,1,1,0.0%,12m
20639,2,EvDoHa,2912,0,0,3,3,0.0%,24m
20674,2,Larraby,2911,1519,143,131,274,52.2%,9m
20674,1,nanuh,2911,1478,139,131,270,51.5%,13m
20674,1,zalupich,2911,1207,73,66,139,52.5%,4m
20674,2,Bardaakkk,2911,931,71,73,144,49.3%,6m
20674,2,TipaRembo,2911,1487,65,62,127,51.2%,7m
20674,1,putinhuylo,2911,775,49,47,96,51.0%,10m
20674,1,Prophet,2911,1027,45,45,90,50.0%,15m
20674,2,Nick,2911,635,34,35,69,49.3%,13m
20674,1,NapRuGa,2911,696,30,24,54,55.6%,24m
20674,2,Galiant,2911,679,25,22,47,53.2%,10m
20674,1,[FLZN]elhobb,2911,403,18,18,36,50.0%,15m
20674,2,[MCFire]Gammler,2911,401,17,15,32,53.1%,2m
20674,1,IIIIIIIIIIII,2911,472,16,22,38,42.1%,14m
20674,2,[RBTV3]DAWǂAlcatraz,2911,425,14,16,30,46.7%,3m
20674,1,[TheShy]Galoschinio,2911,274,13,8,21,61.9%,23m
20674,1,Raitoshu,2911,242,12,11,23,52.2%,2m
20674,2,Nidole,2911,319,12,11,23,52.2%,8m
20674,3,llllllllllll,2911,90,6,4,10,60.0%,7m
20674,3,ImDumb,2911,94,5,1,6,83.3%,17m
20674,3,sergmax,2911,0,4,1,5,80.0%,14m
20674,2,Mammalia,2911,0,3,2,5,60.0%,4m
20674,3,LyshinyrWos,2911,0,3,2,5,60.0%,17m
20674,2,Besefi,2911,0,3,3,6,50.0%,13m
20674,2,DubDub,2911,128,3,4,7,42.9%,8m
20674,1,[igni]Nanning,2911,48,2,2,4,50.0%,56m
20674,3,GhostDream,2911,0,1,0,1,100.0%,2m
20674,2,CraLike,2911,88,1,3,4,25.0%,9m
20674,2,Konel,2911,0,1,4,5,20.0%,51m
20674,2,[RECKU]BambusMensch,2911,30,1,5,6,16.7%,10m
20674,1,lingling,2911,0,0,1,1,0.0%,24m
20674,2,[tetguy]higgs,2911,0,0,2,2,0.0%,34m
20705,1,Thahoasje,2910,1623,151,158,309,48.9%,1m
20705,3,ParadoxMojo,2910,1248,122,116,238,51.3%,16m
20705,2,Zeus,2910,1156,80,79,159,50.3%,13m
20705,2,Blackstar,2910,1117,49,37,86,57.0%,10m
20705,3,Lucifer,2910,1029,42,33,75,56.0%,7m
20705,2,BroilerBear,2910,650,25,27,52,48.1%,24m
20705,3,sEBa,2910,196,13,5,18,72.2%,16m
20705,2,proxxs,2910,250,9,14,23,39.1%,7m
20705,2,GrmxYourMom,2910,173,5,10,15,33.3%,1h
20705,3,DnbFX,2910,0,4,1,5,80.0%,8m
20705,3,BabaChimbo,2910,0,4,1,5,80.0%,3m
20705,3,просто,2910,97,3,6,9,33.3%,6m
20705,2,Stixoo,2910,0,2,2,4,50.0%,48m
20705,3,Imperialist,2910,58,2,2,4,50.0%,16m
20705,2,FatGeneraL,2910,108,2,4,6,33.3%,1h
20705,3,GoZ,2910,0,1,0,1,100.0%,17m
20705,3,DjekForser,2910,0,1,0,1,100.0%,3m
20705,3,RocknRoLL,2910,30,1,2,3,33.3%,15m
20705,3,[Animе]maroder,2910,30,1,2,3,33.3%,3m
20705,2,Hechkomp,2910,30,1,5,6,16.7%,7m
20705,3,DonBilal,2910,0,0,1,1,0.0%,11m
20705,3,Juster,2910,0,0,1,1,0.0%,11m
20705,2,[Pxyool]MSK,2910,0,0,5,5,0.0%,24m
20728,1,Heznzu,2909,1511,95,98,193,49.2%,10m
20728,1,[BFME2]James,2909,1026,92,99,191,48.2%,5m
20728,3,Fenders,2909,742,34,22,56,60.7%,7m
20728,3,OutoOlio,2909,664,25,22,47,53.2%,25m
20728,2,Grevorski,2909,400,16,15,31,51.6%,25m
20728,2,yarpool,2909,265,13,10,23,56.5%,3m
20728,1,[AiRǂ]DPS,2909,282,13,25,38,34.2%,10m
20728,2,nativeJm,2909,283,11,8,19,57.9%,16m
20728,1,NekoTyan,2909,370,11,20,31,35.5%,9m
20728,3,Pugtato,2909,224,9,4,13,69.2%,6m
20728,2,Miro,2909,248,9,8,17,52.9%,23m
20728,3,[Users]DuckPower,2909,237,8,2,10,80.0%,5m
20728,1,СъелиМать,2909,0,4,3,7,57.1%,14m
20728,3,Lemon,2909,96,4,17,21,19.0%,7m
20728,3,Croc,2909,118,3,1,4,75.0%,22m
20728,3,[Lab14]Rhadamanthys,2909,0,3,2,5,60.0%,11m
20728,2,Zety,2909,60,3,4,7,42.9%,22m
20728,2,Khrone,2909,88,2,2,4,50.0%,14m
20728,2,Mumbo,2909,0,2,2,4,50.0%,33m
20728,2,fUnZilla,2909,94,2,3,5,40.0%,16m
20728,3,[Ug4y]barly,2909,0,1,0,1,100.0%,2m
20728,3,[2SG2]KOT,2909,0,1,0,1,100.0%,3m
20728,3,Opponent,2909,30,1,1,2,50.0%,9m
20728,1,Kentrum,2909,0,1,1,2,50.0%,39m
20728,3,nikitarus,2909,0,0,1,1,0.0%,2m
20728,2,Sitrox,2909,0,0,3,3,0.0%,7m
20754,1,BeFeshechka,2908,1148,76,77,153,49.7%,7m
20754,1,MAKTRAXER,2908,1289,64,62,126,50.8%,15m
20754,3,Viper,2908,952,33,48,81,40.7%,7m
20754,2,[Frntln]Mylor,2908,375,28,22,50,56.0%,7m
20754,3,DarKLine,2908,350,16,13,29,55.2%,3m
20754,2,IIIIIIIIIIII,2908,270,10,10,20,50.0%,45m
20754,2,Kserany,2908,191,8,3,11,72.7%,11m
20754,3,Antigonos,2908,172,6,3,9,66.7%,16m
20754,2,Toulk,2908,150,6,11,17,35.3%,3m
20754,2,protossbad,2908,118,5,3,8,62.5%,8m
20754,3,[УТочка]SeregaELCAMX,2908,86,4,0,4,100.0%,23m
20754,3,Cih,2908,86,4,2,6,66.7%,10m
20754,2,[EzD]Adek,2908,0,3,2,5,60.0%,30m
20754,3,[Bcoop]WhiteWolf,2908,0,3,2,5,60.0%,3m
20754,2,BRO,2908,60,3,3,6,50.0%,22m
20754,2,MasterVAN,2908,0,3,3,6,50.0%,3m
20754,3,Urzaaf,2908,118,2,2,4,50.0%,16m
20754,3,Tanaku,2908,0,1,0,1,100.0%,3m
20754,3,Ayman,2908,0,1,1,2,50.0%,23m
20754,3,MrEasy,2908,0,1,2,3,33.3%,1h
20754,1,[FLERS]Tilko,2908,48,1,3,4,25.0%,30m
20754,3,ТАМПЛИЕР,2908,0,0,1,1,0.0%,8m
20754,3,[vlast]mARIO,2908,0,0,2,2,0.0%,9m
20754,3,Zeraphul,2908,0,0,2,2,0.0%,8m
20778,3,Potemkine,2907,1494,232,235,467,49.7%,8m
20778,1,Andreus,2907,1398,208,210,418,49.8%,9m
20778,1,[1FU2]старик,2907,821,99,108,207,47.8%,5m
20778,1,SLAM,2907,895,97,99,196,49.5%,9m
20778,2,Mzullt,2907,729,66,53,119,55.5%,4m
20778,2,denysen,2907,1022,44,39,83,53.0%,23m
20778,3,sil,2907,764,36,25,61,59.0%,11m
20778,3,[DFgs]stukov,2907,528,30,29,59,50.8%,10m
20778,2,Loko,2907,402,17,18,35,48.6%,6m
20778,2,Human,2907,284,13,19,32,40.6%,7m
20778,2,[UNS]OmuVerde,2907,332,12,11,23,52.2%,9m
20778,3,SPIRT,2907,212,9,5,14,64.3%,28m
20778,2,DrMunchies,2907,217,9,8,17,52.9%,11m
20778,2,ubi,2907,204,7,6,13,53.8%,6m
20778,3,Toss,2907,86,3,2,5,60.0%,16m
20778,2,AUMSENRIKE,2907,0,3,2,5,60.0%,55m
20778,1,Zetski,2907,0,3,4,7,42.9%,52m
20778,2,[3ЕRGTV]unster,2907,60,3,8,11,27.3%,6m
20778,1,Skynet,2907,94,3,13,16,18.8%,5m
20778,3,Киборг,2907,117,2,2,4,50.0%,9m
20778,2,RitUga,2907,0,1,0,1,100.0%,37m
20778,3,NeedMore,2907,0,1,0,1,100.0%,9m
20778,3,Michael,2907,0,0,1,1,0.0%,14m
20778,3,[PiGPan]DAniilcola,2907,0,0,1,1,0.0%,3m
20778,3,koshara,2907,0,0,1,1,0.0%,5m
20803,2,MapleCat,2906,1543,186,176,362,51.4%,10m
20803,2,Thousand,2906,1383,70,65,135,51.9%,1m
20803,2,pedrito,2906,1158,41,44,85,48.2%,6m
20803,3,[rsf88]Phate,2906,564,27,23,50,54.0%,16m
20803,3,MHJ,2906,729,25,45,70,35.7%,4m
20803,2,[Jerv]Macarius,2906,567,22,20,42,52.4%,10m
20803,3,[BLO0DY]Darkness,2906,497,21,7,28,75.0%,2m
20803,1,[EZdiE]Adabuu,2906,407,15,18,33,45.5%,10m
20803,3,diidoxd,2906,304,12,7,19,63.2%,3m
20803,2,MumenRider,2906,334,12,20,32,37.5%,6m
20803,2,Guyxx,2906,249,11,9,20,55.0%,20m
20803,3,Coronat,2906,304,10,10,20,50.0%,7m
20803,1,YellowFinch,2906,320,10,22,32,31.2%,24m
20803,1,Vadim,2906,231,8,4,12,66.7%,56m
20803,1,[ORLCY]NickAce,2906,161,8,7,15,53.3%,4m
20803,2,Liu,2906,220,7,8,15,46.7%,11m
20803,1,[nWss]Lotus,2906,145,6,2,8,75.0%,5m
20803,3,Miroslavek,2906,120,5,4,9,55.6%,7m
20803,3,Жирожабль,2906,0,4,1,5,80.0%,16m
20803,3,ALHK,2906,171,4,6,10,40.0%,2m
20803,3,MaciekBEST,2906,58,3,0,3,100.0%,23m
20803,3,Mowgli,2906,0,3,2,5,60.0%,22m
20803,1,Valdemar,2906,141,3,6,9,33.3%,4m
20803,1,RumBar,2906,155,3,8,11,27.3%,17m
20803,3,Seek,2906,30,2,1,3,66.7%,8m
20803,3,ARAti,2906,0,0,1,1,0.0%,25m
20803,3,Maschinchen,2906,0,0,1,1,0.0%,9m
20803,3,Eragonball,2906,0,0,2,2,0.0%,9m
20831,2,drajz,2905,767,54,53,107,50.5%,10m
20831,2,polli,2905,1026,38,40,78,48.7%,6m
20831,1,LoBsTaR,2905,902,33,38,71,46.5%,13m
20831,1,Rufus,2905,658,25,26,51,49.0%,14m
20831,2,Brenda,2905,301,23,26,49,46.9%,8m
20831,2,Paulus,2905,479,19,18,37,51.4%,22m
20831,3,Rvach,2905,478,18,12,30,60.0%,3m
20831,2,Bot,2905,270,16,15,31,51.6%,7m
20831,1,[Close]CracKCoCain,2905,520,16,23,39,41.0%,7m
20831,2,Jerles,2905,380,13,18,31,41.9%,10m
20831,1,Targetlocker,2905,452,13,28,41,31.7%,3m
20831,1,[GnW]EniDead,2905,193,7,3,10,70.0%,16m
20831,3,[Harboe]StoneCold,2905,236,7,4,11,63.6%,7m
20831,1,[5p4c3]Dimos,2905,147,6,5,11,54.5%,57m
20831,1,Genbob,2905,144,6,5,11,54.5%,57m
20831,1,Hrvat,2905,96,6,5,11,54.5%,1m
20831,2,DarkLord,2905,119,6,6,12,50.0%,39m
20831,1,ShivaGamer,2905,97,5,3,8,62.5%,28m
20831,2,[TeHaCe]luQ,2905,164,5,11,16,31.2%,10m
20831,1,[isreal]DYmusicguy,2905,96,4,3,7,57.1%,25m
20831,3,[DТ]BeelzeBul,2905,30,4,3,7,57.1%,8m
20831,3,Cosmyn,2905,0,3,2,5,60.0%,12m
20831,3,[WRYH]Wyfen,2905,0,3,2,5,60.0%,17m
20831,3,qblizt,2905,0,3,2,5,60.0%,8m
20831,3,ХИЗБУЛАТ,2905,0,2,3,5,40.0%,23m
20831,1,SpaceCowboy,2905,66,2,11,13,15.4%,14m
20831,3,Reinhard,2905,0,1,0,1,100.0%,16m
20831,3,ElVish,2905,0,1,0,1,100.0%,11m
20831,3,Deschain,2905,0,1,0,1,100.0%,24m
20831,3,Vier,2905,0,1,1,2,50.0%,5m
20831,3,Fortnite,2905,30,1,1,2,50.0%,4m
20831,3,grrr,2905,90,1,1,2,50.0%,16m
20831,3,Clockwork,2905,0,1,1,2,50.0%,19m
20831,2,MrBig,2905,0,1,4,5,20.0%,49m
20831,2,TchoY,2905,30,1,6,7,14.3%,22m
20831,3,DoomSong,2905,0,0,1,1,0.0%,10m
20867,1,BannedSCV,2904,799,62,64,126,49.2%,3m
20867,3,Biiru,2904,1179,47,35,82,57.3%,11m
20867,2,LUC,2904,658,35,38,73,47.9%,9m
20867,1,RobinR,2904,962,35,40,75,46.7%,7m
20867,3,[KMLT]Fwerge,2904,368,15,13,28,53.6%,15m
20867,3,Funkykong,2904,319,14,10,24,58.3%,3m
20867,3,[lol0l]Zulkylol,2904,311,14,13,27,51.9%,10m
20867,2,Steelhammer,2904,138,11,8,19,57.9%,25m
20867,2,Smoke,2904,318,11,17,28,39.3%,8m
20867,3,[BornG]arT,2904,166,7,1,8,87.5%,10m
20867,1,Smile,2904,0,5,2,7,71.4%,46m
20867,2,leesquealer,2904,92,4,9,13,30.8%,3m
20867,3,Rubster,2904,0,3,2,5,60.0%,12m
20867,2,veg,2904,0,3,2,5,60.0%,56m
20867,3,Arrogant,2904,0,3,2,5,60.0%,11m
20867,1,IIIIIIIIIIII,2904,0,3,3,6,50.0%,17m
20867,2,[Adlscø]fitaaa,2904,114,3,6,9,33.3%,24m
20867,3,TATANGALAR,2904,97,2,0,2,100.0%,52m
20867,3,TTToooMMM,2904,60,2,3,5,40.0%,8m
20867,2,Prestige,2904,30,2,7,9,22.2%,2m
20867,3,Necrobaz,2904,0,1,2,3,33.3%,24m
20867,2,Nekromant,2904,0,1,2,3,33.3%,24m
20867,3,[Farla]chiwendios,2904,30,1,2,3,33.3%,3m
20867,3,Luke,2904,0,0,1,1,0.0%,23m
20867,3,жизньзайур,2904,0,0,1,1,0.0%,17m
20867,3,Melon,2904,0,0,1,1,0.0%,10m
20893,1,[DiRE]ANTITROL,2903,1463,113,99,212,53.3%,6m
20893,3,[U19]Next,2903,1213,98,75,173,56.6%,13m
20893,2,AlekSan,2903,422,66,66,132,50.0%,11m
20893,3,Cannonfodder,2903,499,31,8,39,79.5%,3m
20893,3,[U19]ElsaStrong,2903,333,23,22,45,51.1%,12m
20893,2,Тарип,2903,281,10,10,20,50.0%,24m
20893,3,Zasiu,2903,232,10,15,25,40.0%,5m
20893,3,[GBang]Soenson,2903,196,8,6,14,57.1%,3m
20893,1,Micha,2903,167,6,5,11,54.5%,55m
20893,2,TraiT,2903,142,5,3,8,62.5%,22m
20893,3,THeFeAR,2903,114,5,3,8,62.5%,8m
20893,3,MindBlues,2903,148,5,5,10,50.0%,10m
20893,2,clslrns,2903,172,5,5,10,50.0%,9m
20893,2,[псина]KeenG,2903,142,5,9,14,35.7%,11m
20893,2,MiuGu,2903,93,4,4,8,50.0%,16m
20893,3,rob,2903,30,2,0,2,100.0%,10m
20893,3,[LovvB]Xpanded,2903,0,1,0,1,100.0%,1h
20893,3,kusokSOBAKI,2903,0,1,0,1,100.0%,3m
20893,1,karapuz,2903,0,1,2,3,33.3%,33m
20893,3,[DStar]tMK,2903,0,1,3,4,25.0%,48m
20893,2,[PÂRłAH]CZDiesel,2903,0,0,1,1,0.0%,25m
20893,3,Thunerous,2903,0,0,1,1,0.0%,8m
20893,3,ShadowTube,2903,0,0,2,2,0.0%,8m
20893,3,SpaceAnt,2903,0,0,2,2,0.0%,10m
20893,2,Pepto,2903,0,0,3,3,0.0%,12m
20918,1,[SkBG]RMER,2902,1584,347,320,667,52.0%,7m
20918,1,luckeR,2902,1580,231,216,447,51.7%,7m
20918,2,EDDDDDDDDDDD,2902,1545,179,179,358,50.0%,14m
20918,1,Maevius,2902,961,161,153,314,51.3%,11m
20918,2,[EV0C]Necross,2902,813,114,113,227,50.2%,7m
20918,2,Ocin,2902,658,87,86,173,50.3%,8m
20918,2,Summer,2902,1476,80,63,143,55.9%,2m
20918,2,BlackGad,2902,1074,49,54,103,47.6%,13m
20918,3,SailorPorky,2902,735,31,31,62,50.0%,3m
20918,3,[GOLDPL]Lancelot,2902,594,30,11,41,73.2%,15m
20918,2,MassEffect,2902,451,17,15,32,53.1%,24m
20918,3,[BPX]BloodAngel,2902,371,15,9,24,62.5%,22m
20918,2,Sparkman,2902,293,13,10,23,56.5%,11m
20918,3,Delikios,2902,228,12,11,23,52.2%,24m
20918,2,Valent,2902,193,9,9,18,50.0%,54m
20918,1,elApache,2902,260,9,15,24,37.5%,24m
20918,2,Ryso,2902,174,4,6,10,40.0%,1h
20918,2,[LAMPA]ТоксичныйТеР,2902,118,4,8,12,33.3%,24m
20918,3,Tauroks,2902,121,3,1,4,75.0%,1h
20918,3,Yiggdrasill,2902,97,2,0,2,100.0%,48m
20918,3,mellivora,2902,0,2,1,3,66.7%,11m
20918,1,[Draigo]wouinny,2902,48,2,2,4,50.0%,1h
20918,3,Holymola,2902,0,0,1,1,0.0%,42m
20918,1,Paul,2902,0,0,1,1,0.0%,28m
20918,3,[NNBS]Serral,2902,0,0,1,1,0.0%,10m
20918,3,GACHIMaster,2902,0,0,1,1,0.0%,10m
20918,2,Гудвин,2902,0,0,3,3,0.0%,12m
20918,2,rAyWinDz,2902,0,0,4,4,0.0%,59m
20946,2,BarCode,2901,1421,71,65,136,52.2%,9m
20946,2,zadira,2901,1027,48,45,93,51.6%,8m
20946,3,Altaran,2901,1064,41,35,76,53.9%,22m
20946,2,[Z3RG7V]Garret,2901,108,36,36,72,50.0%,10m
20946,2,GROKA,2901,793,31,37,68,45.6%,6m
20946,3,[LV]lolsteamroll,2901,339,13,12,25,52.0%,3m
20946,2,pinedepain,2901,322,12,12,24,50.0%,4m
20946,3,xDontxCryx,2901,294,10,3,13,76.9%,13m
20946,2,[Noixch]InGénious,2901,226,9,7,16,56.2%,57m
20946,2,SOOOOHAPPY,2901,272,9,13,22,40.9%,23m
20946,2,[ЗЛО]fenRier,2901,240,8,12,20,40.0%,4m
20946,3,dakotapearl,2901,174,7,5,12,58.3%,2m
20946,2,elQ,2901,90,6,6,12,50.0%,4m
20946,2,Jalexo,2901,154,6,7,13,46.2%,14m
20946,2,ale,2901,177,5,4,9,55.6%,3m
20946,3,hiimzaki,2901,86,4,2,6,66.7%,21m
20946,3,Roks,2901,0,3,1,4,75.0%,1m
20946,3,zibIII,2901,0,3,2,5,60.0%,22m
20946,2,oeoeio,2901,0,3,3,6,50.0%,14m
20946,1,[HDOG]Azn,2901,48,3,4,7,42.9%,57m
20946,2,Daiodem,2901,0,2,1,3,66.7%,28m
20946,3,vank,2901,0,1,0,1,100.0%,8m
20946,3,Narcosifus,2901,30,1,1,2,50.0%,3m
20946,3,[Leolan]MickiFan,2901,0,1,1,2,50.0%,57m
20946,1,[TedB]Kelrimor,2901,0,1,3,4,25.0%,48m
20946,3,[Pw]YuMi,2901,36,1,12,13,7.7%,14m
20946,1,kiruKatO,2901,0,0,1,1,0.0%,1h
20946,2,[1WCG]Blackman,2901,0,0,2,2,0.0%,10m
20946,3,willbill,2901,0,0,2,2,0.0%,10m
20975,1,Touchdown,2900,1613,201,187,388,51.8%,23m
20975,2,LingDingDing,2900,1549,102,102,204,50.0%,2m
20975,2,DaAims,2900,1561,73,82,155,47.1%,8m
20975,2,LOLтакНельзя,2900,925,68,70,138,49.3%,8m
20975,3,[ETYM]skrop,2900,1090,63,54,117,53.8%,2m
20975,1,[ValidG]eboue,2900,1272,52,62,114,45.6%,8m
20975,2,BabbiBear,2900,766,50,48,98,51.0%,16m
20975,2,Guardian,2900,667,28,20,48,58.3%,9m
20975,2,BeerStealer,2900,676,24,29,53,45.3%,6m
20975,2,RenKoren,2900,380,20,13,33,60.6%,10m
20975,3,[TSmash]Fitoiyo,2900,382,17,14,31,54.8%,10m
20975,2,maelic,2900,351,14,14,28,50.0%,24m
20975,2,roberry,2900,378,14,18,32,43.8%,9m
20975,2,Sobisson,2900,217,11,6,17,64.7%,8m
20975,2,sorryiamlate,2900,292,11,14,25,44.0%,10m
20975,2,Camux,2900,218,10,8,18,55.6%,37m
20975,2,Butch,2900,220,8,6,14,57.1%,17m
20975,2,BogvABW,2900,198,8,9,17,47.1%,4m
20975,2,chucknorris,2900,199,7,16,23,30.4%,8m
20975,3,Algomicro,2900,176,6,4,10,60.0%,3m
20975,2,CooperUA,2900,95,5,6,11,45.5%,11m
20975,2,tema,2900,0,3,2,5,60.0%,1h
20975,2,neverpuick,2900,0,2,3,5,40.0%,2m
20975,2,Napoleon,2900,114,2,4,6,33.3%,8m
20975,2,Finnosaurus,2900,30,2,4,6,33.3%,9m
20975,3,CityBoris,2900,58,2,4,6,33.3%,15m
20975,3,[Elimin]patalisk,2900,30,1,2,3,33.3%,3m
20975,3,GuiiGeek,2900,30,1,2,3,33.3%,8m
20975,3,Nisha,2900,0,1,8,9,11.1%,30m
20975,2,[gkdn]dassox,2900,0,0,3,3,0.0%,9m
21005,2,Neo,2899,607,145,142,287,50.5%,25m
21005,2,lunchbox,2899,1562,129,115,244,52.9%,11m
21005,2,[aDGa]Dominiator,2899,1473,91,86,177,51.4%,22m
21005,3,brunocznv,2899,562,80,57,137,58.4%,11m
21005,1,Rivz,2899,1115,65,60,125,52.0%,13m
21005,1,Halfies,2899,656,43,49,92,46.7%,12m
21005,1,Slifer,2899,611,29,33,62,46.8%,25m
21005,3,Sophia,2899,564,22,17,39,56.4%,3m
21005,3,librinaut,2899,452,18,13,31,58.1%,23m
21005,2,OneAtwO,2899,493,18,18,36,50.0%,9m
21005,2,Zhmurik,2899,496,17,21,38,44.7%,22m
21005,1,LEO,2899,375,16,9,25,64.0%,39m
21005,2,Dragon,2899,244,10,11,21,47.6%,8m
21005,3,Doommer,2899,206,8,7,15,53.3%,23m
21005,3,Tysd,2899,181,8,8,16,50.0%,8m
21005,3,[ZATAAN]Dante,2899,205,7,2,9,77.8%,7m
21005,1,Thalun,2899,96,6,4,10,60.0%,46m
21005,2,Genghis,2899,192,6,6,12,50.0%,6m
21005,2,[HDTV]USax,2899,206,6,8,14,42.9%,22m
21005,1,szlvester,2899,97,5,2,7,71.4%,36m
21005,3,Inkarzero,2899,161,4,9,13,30.8%,17m
21005,2,Kaczi,2899,0,3,2,5,60.0%,1h
21005,2,[Harley]Demm,2899,48,3,4,7,42.9%,33m
21005,2,[CZEK]TermiXccc,2899,114,2,3,5,40.0%,25m
21005,3,[DAK]MLCxBöserlux,2899,0,1,0,1,100.0%,7m
21005,3,Zwalas,2899,30,1,1,2,50.0%,10m
21005,3,Prometheus,2899,0,1,1,2,50.0%,3m
21005,3,Cyberphönix,2899,0,1,1,2,50.0%,25m
21005,2,Roggenmehl,2899,0,1,5,6,16.7%,8m
21005,2,[HBGSJR]llllllllllll,2899,30,1,5,6,16.7%,11m
21005,1,ablaze,2899,0,1,7,8,12.5%,3m
21005,3,SpaceFREEZER,2899,0,0,1,1,0.0%,5m
21005,3,Paczilla,2899,0,0,1,1,0.0%,16m
21005,3,kid,2899,0,0,1,1,0.0%,16m
21005,1,Nanodesy,2899,0,0,2,2,0.0%,28m
21040,2,Кирилл,2898,959,52,41,93,55.9%,8m
21040,2,[MG2K]Авгур,2898,1410,52,57,109,47.7%,8m
21040,2,Rolex,2898,742,37,30,67,55.2%,24m
21040,2,[xoxxoo]llllllllllll,2898,409,16,13,29,55.2%,6m
21040,3,arogrida,2898,262,11,5,16,68.8%,9m
21040,2,WarSocks,2898,244,10,10,20,50.0%,7m
21040,2,strike,2898,230,9,6,15,60.0%,4m
21040,2,[ЯD]Magico,2898,146,6,8,14,42.9%,9m
21040,1,Mamba,2898,123,5,5,10,50.0%,3m
21040,3,StaryKomuch,2898,0,4,1,5,80.0%,24m
21040,3,Devil,2898,0,3,2,5,60.0%,22m
21040,3,Macco,2898,86,3,3,6,50.0%,10m
21040,2,xndr,2898,128,3,4,7,42.9%,10m
21040,3,SzuperCsiga,2898,30,2,1,3,66.7%,2m
21040,3,Xuboj,2898,0,2,3,5,40.0%,2m
21040,2,Alo,2898,114,2,4,6,33.3%,6m
21040,3,Galaxie,2898,0,1,0,1,100.0%,14m
21040,2,BigBlind,2898,30,1,3,4,25.0%,11m
21040,2,Demolisher,2898,48,1,6,7,14.3%,6m
21040,3,kobra,2898,0,0,1,1,0.0%,22m
21060,1,[SPAINs]KARALHO,2897,1595,224,217,441,50.8%,5m
21060,1,sivt,2897,910,102,107,209,48.8%,9m
21060,1,Viktorio,2897,1503,94,93,187,50.3%,7m
21060,2,Cenarius,2897,1107,45,40,85,52.9%,11m
21060,2,blerou,2897,788,31,39,70,44.3%,11m
21060,2,HotCoffeeDog,2897,730,30,25,55,54.5%,25m
21060,3,[WldCaT]YummyDead,2897,358,12,7,19,63.2%,24m
21060,3,GrannyPanty,2897,326,12,12,24,50.0%,10m
21060,1,[DAGW]Caucasus,2897,334,11,20,31,35.5%,2m
21060,3,AMBERLAMPS,2897,252,10,6,16,62.5%,23m
21060,2,Zahyx,2897,231,9,7,16,56.2%,6m
21060,2,Dtmon,2897,231,9,8,17,52.9%,53m
21060,2,[Hrr]TinGol,2897,132,9,10,19,47.4%,11m
21060,3,[DGteam]RSGeneral,2897,124,6,3,9,66.7%,3m
21060,2,сасайкудасай,2897,184,6,6,12,50.0%,22m
21060,2,OpTu,2897,155,5,5,10,50.0%,13m
21060,3,Taxx,2897,0,4,1,5,80.0%,15m
21060,2,Kaktus,2897,102,3,1,4,75.0%,9m
21060,3,CPTSmAcKaHo,2897,0,3,2,5,60.0%,14m
21060,1,Tuantrung,2897,159,3,3,6,50.0%,25m
21060,3,mammasan,2897,60,3,5,8,37.5%,10m
21060,3,[ODISO]igor,2897,0,1,0,1,100.0%,4m
21060,3,SkillReX,2897,0,1,0,1,100.0%,24m
21060,3,Smetikir,2897,0,1,0,1,100.0%,23m
21060,3,Kenzo,2897,0,1,1,2,50.0%,16m
21060,2,[ÄoB]drofus,2897,30,1,6,7,14.3%,10m
21060,3,[Ritsb]Nayls,2897,0,0,1,1,0.0%,8m
21060,3,neroxLz,2897,0,0,1,1,0.0%,6m
21060,2,Artem,2897,0,0,1,1,0.0%,5m
21060,3,miep,2897,0,0,2,2,0.0%,10m
21090,2,Maxwell,2896,1523,193,187,380,50.8%,8m
21090,3,Mart,2896,1476,109,108,217,50.2%,12m
21090,1,Lightofday,2896,1356,94,79,173,54.3%,23m
21090,2,Gfunk,2896,1610,66,65,131,50.4%,17m
21090,1,JuJuUuBeEe,2896,841,33,37,70,47.1%,14m
21090,3,symple,2896,461,30,23,53,56.6%,16m
21090,2,Mariusxxz,2896,549,23,19,42,54.8%,8m
21090,2,[Тропа]Повелитель,2896,440,18,17,35,51.4%,5m
21090,2,HenQueen,2896,412,14,20,34,41.2%,24m
21090,3,ewerty,2896,125,6,3,9,66.7%,22m
21090,2,[SaBro]Oris,2896,186,6,5,11,54.5%,7m
21090,2,DonVino,2896,170,6,7,13,46.2%,11m
21090,2,tormentor,2896,118,4,8,12,33.3%,13m
21090,3,[Z1L]Inquisition,2896,86,3,2,5,60.0%,13m
21090,2,Skyler,2896,42,2,4,6,33.3%,58m
21090,2,wolfy,2896,62,2,5,7,28.6%,16m
21090,1,Turtamel,2896,0,1,1,2,50.0%,5m
21090,2,DragonEagle,2896,0,1,2,3,33.3%,3m
21090,2,Tshufengvaj,2896,0,0,2,2,0.0%,2m
21109,1,Alf,2895,1417,161,168,329,48.9%,10m
21109,2,JeanPlisse,2895,1155,141,118,259,54.4%,2m
21109,1,Starzinger,2895,1579,60,63,123,48.8%,2m
21109,2,SchizoInside,2895,850,35,28,63,55.6%,25m
21109,2,grider,2895,790,32,26,58,55.2%,12m
21109,3,Silenther,2895,609,30,13,43,69.8%,11m
21109,2,Arganick,2895,693,29,26,55,52.7%,7m
21109,3,Jonathan,2895,691,28,22,50,56.0%,22m
21109,2,Avaril,2895,406,23,22,45,51.1%,10m
21109,2,Rayenok,2895,602,23,26,49,46.9%,8m
21109,2,GdFongus,2895,386,13,20,33,39.4%,9m
21109,2,smiley,2895,271,12,16,28,42.9%,9m
21109,2,ПРОЦЕССОРРРР,2895,259,11,17,28,39.3%,22m
21109,3,[smite]Midnight,2895,277,10,5,15,66.7%,25m
21109,2,Temprado,2895,255,10,8,18,55.6%,49m
21109,2,[PLA2N]FlintD,2895,276,10,10,20,50.0%,25m
21109,3,Meeh,2895,239,9,6,15,60.0%,56m
21109,2,mouz,2895,230,8,8,16,50.0%,25m
21109,2,Max,2895,211,8,10,18,44.4%,8m
21109,3,Cichy,2895,166,7,2,9,77.8%,16m
21109,1,CyberZombie,2895,222,7,17,24,29.2%,5m
21109,1,[DcksQ]MadEgg,2895,108,6,7,13,46.2%,4m
21109,2,YoHan,2895,148,5,8,13,38.5%,3m
21109,3,Staya,2895,113,4,3,7,57.1%,16m
21109,2,DeepNine,2895,0,3,2,5,60.0%,41m
21109,2,[WCFAN]Schlitzer,2895,92,3,11,14,21.4%,3m
21109,2,sinisterevil,2895,30,2,3,5,40.0%,2m
21109,3,Illu,2895,60,2,6,8,25.0%,23m
21109,3,ChaosTheory,2895,0,1,0,1,100.0%,3m
21109,2,[UUU2]korviin,2895,30,1,5,6,16.7%,13m
21109,2,Psi,2895,88,1,6,7,14.3%,12m
21109,3,[IceHus]СТИМПАК,2895,0,0,1,1,0.0%,24m
21109,3,torvaldd,2895,0,0,1,1,0.0%,8m
21109,2,dabo,2895,0,0,5,5,0.0%,7m
21143,2,funTime,2894,1336,87,71,158,55.1%,24m
21143,3,Vortex,2894,1319,53,62,115,46.1%,21m
21143,3,Lesok,2894,985,44,26,70,62.9%,2m
21143,1,Berraco,2894,980,33,43,76,43.4%,23m
21143,3,[SpArrt]GwadaBogosse,2894,800,30,30,60,50.0%,22m
21143,2,guiton,2894,571,26,24,50,52.0%,24m
21143,3,Brutzer,2894,506,22,9,31,71.0%,6m
21143,2,DEathkNIghtS,2894,507,20,21,41,48.8%,9m
21143,3,[Burla]Starvind,2894,478,18,17,35,51.4%,11m
21143,3,maxim,2894,358,13,12,25,52.0%,16m
21143,2,feDOs,2894,216,7,10,17,41.2%,8m
21143,3,[LPbass]anywayLA,2894,118,5,4,9,55.6%,5m
21143,1,[weplay]zombie,2894,0,4,2,6,66.7%,53m
21143,1,[šƒ]Gaspiboy,2894,89,4,4,8,50.0%,7m
21143,2,ShadowHunter,2894,86,4,8,12,33.3%,14m
21143,3,Gavial,2894,0,3,2,5,60.0%,22m
21143,1,Jorerock,2894,110,3,13,16,18.8%,13m
21143,3,Adon,2894,0,1,0,1,100.0%,13m
21143,3,HyperFlex,2894,0,1,0,1,100.0%,9m
21143,3,[Kaem]KamicuX,2894,30,1,3,4,25.0%,23m
21143,2,Papaecho,2894,0,1,3,4,25.0%,4m
21143,3,Wallfacer,2894,0,0,2,2,0.0%,24m
21143,3,Alex,2894,0,0,2,2,0.0%,4m
21143,2,[1411]RedRoach,2894,0,0,3,3,0.0%,13m
21143,2,TakeOnMe,2894,0,0,6,6,0.0%,16m
21168,1,Mikounetor,2893,1509,101,109,210,48.1%,9m
21168,1,Cilius,2893,810,79,71,150,52.7%,6m
21168,3,Moht,2893,454,69,48,117,59.0%,22m
21168,2,ttsMiLeTU,2893,1010,44,40,84,52.4%,14m
21168,3,Valsire,2893,536,20,17,37,54.1%,3m
21168,2,[HBGSJR]stepanator,2893,477,18,17,35,51.4%,24m
21168,3,Dimentor,2893,405,16,6,22,72.7%,3m
21168,3,[LaB]Gawanabana,2893,249,13,3,16,81.2%,3m
21168,3,Renkin,2893,276,11,7,18,61.1%,9m
21168,2,misakulicka,2893,194,8,10,18,44.4%,9m
21168,1,Naupilus,2893,131,6,6,12,50.0%,10m
21168,1,MeanFreePath,2893,213,6,13,19,31.6%,6m
21168,3,Gwaihir,2893,142,5,3,8,62.5%,10m
21168,3,IcEdrAgOn,2893,141,4,3,7,57.1%,8m
21168,3,[FENIKS]Imbech,2893,88,4,4,8,50.0%,3m
21168,3,BryanFury,2893,90,4,4,8,50.0%,25m
21168,2,Chronix,2893,169,4,6,10,40.0%,3m
21168,1,speezil,2893,155,4,10,14,28.6%,5m
21168,3,Onsightfree,2893,0,3,2,5,60.0%,2m
21168,3,FrankenNoob,2893,0,3,2,5,60.0%,14m
21168,3,[iSCH]DunningKrugr,2893,86,3,3,6,50.0%,6m
21168,1,kahko,2893,0,3,4,7,42.9%,23m
21168,2,Paradox,2893,60,3,6,9,33.3%,24m
21168,2,[6Gears]Antoma,2893,60,3,7,10,30.0%,3m
21168,3,Viak,2893,0,2,3,5,40.0%,32m
21168,3,Stranger,2893,60,2,4,6,33.3%,3m
21168,2,Cwaniaczek,2893,58,2,5,7,28.6%,24m
21168,2,[BøZø]ggnel,2893,0,1,1,2,50.0%,4m
21168,2,[DaAm]manino,2893,0,1,2,3,33.3%,11m
21168,1,Ishimura,2893,0,1,2,3,33.3%,45m
21168,2,Véktørs,2893,88,1,3,4,25.0%,24m
21168,3,[TOMBOS]Higo,2893,0,0,1,1,0.0%,17m
21168,2,CanardSansTT,2893,0,0,3,3,0.0%,6m
21201,1,Alex,2892,1606,379,376,755,50.2%,25m
21201,3,agrafka,2892,1571,253,259,512,49.4%,15m
21201,2,iProctor,2892,1529,85,75,160,53.1%,23m
21201,2,grachus,2892,1475,78,79,157,49.7%,9m
21201,3,DARK,2892,1270,76,91,167,45.5%,14m
21201,1,happyfaceAR,2892,1458,54,66,120,45.0%,5m
21201,2,Tarantul,2892,970,49,21,70,70.0%,14m
21201,3,fozzy,2892,961,42,29,71,59.2%,10m
21201,3,Lujin,2892,644,37,47,84,44.0%,10m
21201,3,Leckatall,2892,596,33,22,55,60.0%,14m
21201,3,[NGaBZH]Cronul,2892,464,19,16,35,54.3%,7m
21201,3,Dimson,2892,444,17,13,30,56.7%,22m
21201,2,Liet,2892,492,17,17,34,50.0%,7m
21201,3,[KLANI]Thing,2892,333,15,8,23,65.2%,4m
21201,3,SirPoopins,2892,352,13,6,19,68.4%,14m
21201,3,[литрпг]Ансирал,2892,251,9,2,11,81.8%,5m
21201,3,[BWArmy]Slazy,2892,238,9,9,18,50.0%,2m
21201,3,[D0N3]Pacselly,2892,258,8,4,12,66.7%,8m
21201,1,[MagiCǃ]oIITiMicT,2892,236,7,6,13,53.8%,52m
21201,1,hyperborea,2892,97,6,3,9,66.7%,1h
21201,2,Atom,2892,120,5,12,17,29.4%,8m
21201,2,MaksFoer,2892,116,4,3,7,57.1%,25m
21201,3,Theta,2892,0,3,1,4,75.0%,16m
21201,2,Zvony,2892,0,3,2,5,60.0%,56m
21201,3,[Ded1n]Efizel,2892,0,3,2,5,60.0%,23m
21201,3,Джеймс,2892,0,3,2,5,60.0%,11m
21201,3,Kashmar,2892,30,2,1,3,66.7%,16m
21201,3,Pshin,2892,30,2,1,3,66.7%,16m
21201,2,[OРДА]FriendlyRUS,2892,62,2,5,7,28.6%,10m
21201,2,CeytNot,2892,60,2,7,9,22.2%,6m
21201,3,NzUmer,2892,0,1,1,2,50.0%,13m
21201,3,[kB5]Cacoa,2892,0,0,1,1,0.0%,6m
21201,2,WiThErOsE,2892,0,0,3,3,0.0%,3m
21201,2,Evilsend,2892,0,0,3,3,0.0%,3m
21235,1,MrPikac,2891,1584,107,101,208,51.4%,24m
21235,2,tallyHO,2891,776,83,76,159,52.2%,24m
21235,3,TheRealPED,2891,948,63,48,111,56.8%,25m
21235,1,NeverMore,2891,754,24,35,59,40.7%,2m
21235,2,santa,2891,442,16,21,37,43.2%,3m
21235,3,GrandPa,2891,319,15,10,25,60.0%,16m
21235,1,Maxipocak,2891,329,13,14,27,48.1%,8m
21235,3,Тихо,2891,225,11,4,15,73.3%,9m
21235,1,keroQ,2891,96,7,6,13,53.8%,22m
21235,3,CobraUnit,2891,228,7,9,16,43.8%,23m
21235,1,Kvakva,2891,163,6,4,10,60.0%,34m
21235,3,Jester,2891,86,6,4,10,60.0%,3m
21235,2,[RGO]DarkOh,2891,144,6,6,12,50.0%,5m
21235,3,Blaiize,2891,0,4,1,5,80.0%,11m
21235,3,Arti,2891,113,4,3,7,57.1%,17m
21235,2,[ZaG]Brez,2891,48,4,3,7,57.1%,41m
21235,3,BlueMerlin,2891,86,3,2,5,60.0%,23m
21235,3,Atreyd,2891,0,1,0,1,100.0%,16m
21235,3,Nothing,2891,30,1,1,2,50.0%,4m
21235,3,grig,2891,0,0,1,1,0.0%,13m
21235,3,[696]Aiur,2891,0,0,1,1,0.0%,16m
21235,3,VINCHESTER,2891,0,0,1,1,0.0%,8m
21235,3,BirdBøy,2891,0,0,1,1,0.0%,5m
21235,2,[TIGER5]Chris,2891,0,0,3,3,0.0%,9m
21259,2,Antimoine,2890,1495,198,183,381,52.0%,8m
21259,2,[THANOS]KARATIAGA,2890,1545,176,163,339,51.9%,24m
21259,1,Antonf,2890,1618,161,161,322,50.0%,23m
21259,1,Pontif,2890,1481,132,135,267,49.4%,25m
21259,2,Keg,2890,793,88,88,176,50.0%,7m
21259,2,Artem,2890,1311,87,91,178,48.9%,13m
21259,2,deckie,2890,938,37,41,78,47.4%,21m
21259,1,KAMELLOT,2890,843,36,40,76,47.4%,5m
21259,3,BlackAssasin,2890,628,28,29,57,49.1%,4m
21259,2,[WPru]Click,2890,533,21,18,39,53.8%,9m
21259,2,Mrakk,2890,445,17,14,31,54.8%,9m
21259,3,[Sehyo]scƻskWhoTe,2890,291,13,7,20,65.0%,16m
21259,1,ShadoW,2890,198,8,4,12,66.7%,18m
21259,1,Leonardo,2890,120,6,4,10,60.0%,15m
21259,3,Umbra,2890,74,4,0,4,100.0%,8m
21259,2,thomasyao,2890,88,4,3,7,57.1%,13m
21259,2,Dittu,2890,142,4,4,8,50.0%,8m
21259,1,gorthaur,2890,112,3,0,3,100.0%,39m
21259,3,[MRZz]Snac,2890,129,3,1,4,75.0%,54m
21259,2,[VFN]Kreigon,2890,0,3,2,5,60.0%,43m
21259,2,BrotherAug,2890,90,3,6,9,33.3%,7m
21259,2,ArcVico,2890,90,3,6,9,33.3%,14m
21259,2,MrRager,2890,30,2,3,5,40.0%,14m
21259,3,LuKasstare,2890,30,1,1,2,50.0%,6m
21259,3,[UTech]Ecen,2890,0,1,4,5,20.0%,8m
21259,3,PiphPaph,2890,0,0,1,1,0.0%,16m
21259,3,Tazar,2890,0,0,1,1,0.0%,8m
21286,2,AeonOfStrife,2889,1556,200,192,392,51.0%,11m
21286,1,Ccat,2889,1209,122,128,250,48.8%,7m
21286,1,[ProbKA]LeksBakr,2889,521,35,39,74,47.3%,8m
21286,3,Loss,2889,684,28,23,51,54.9%,4m
21286,2,Legato,2889,632,25,21,46,54.3%,25m
21286,2,boumi,2889,641,24,25,49,49.0%,4m
21286,3,Bonesplitter,2889,534,19,19,38,50.0%,24m
21286,2,GandyDancer,2889,470,17,19,36,47.2%,5m
21286,2,[CRA3]Brandenburak,2889,500,17,21,38,44.7%,11m
21286,3,[Kiber]FoxGera,2889,320,12,3,15,80.0%,13m
21286,3,ButchT,2889,278,12,13,25,48.0%,9m
21286,1,Itachi,2889,280,11,11,22,50.0%,3m
21286,3,Siedlerprofi,2889,265,10,8,18,55.6%,11m
21286,2,Kvapinson,2889,237,8,8,16,50.0%,11m
21286,2,[NofN]sHADow,2889,164,7,10,17,41.2%,9m
21286,3,Critical,2889,0,4,1,5,80.0%,21m
21286,2,Lowermind,2889,88,4,3,7,57.1%,22m
21286,3,Unforeseen,2889,0,3,2,5,60.0%,11m
21286,3,aigux,2889,0,3,2,5,60.0%,8m
21286,3,BlackSynergy,2889,0,3,2,5,60.0%,2m
21286,3,Lapierre,2889,58,2,1,3,66.7%,2m
21286,3,SpecialForce,2889,30,2,4,6,33.3%,5m
21286,2,[HAHAH]Khyane,2889,117,2,5,7,28.6%,58m
21286,1,Dopeaf,2889,0,1,1,2,50.0%,17m
21286,1,Deuteriumm,2889,0,1,1,2,50.0%,6m
21286,3,Boomermin,2889,34,1,3,4,25.0%,19m
21286,1,Tengan,2889,0,1,8,9,11.1%,14m
21286,3,devid,2889,0,0,2,2,0.0%,16m
21286,3,Deyd,2889,0,0,2,2,0.0%,10m
21315,1,[MKDK]Gontello,2888,1610,255,251,506,50.4%,13m
21315,1,[raahhh]OursPD,2888,1616,129,138,267,48.3%,25m
21315,2,sollaris,2888,1477,125,111,236,53.0%,8m
21315,1,Pricey,2888,1035,95,107,202,47.0%,9m
21315,2,long,2888,1408,76,80,156,48.7%,9m
21315,2,YKV,2888,527,19,20,39,48.7%,10m
21315,2,Флу,2888,396,14,18,32,43.8%,10m
21315,2,Duskworker,2888,434,13,16,29,44.8%,10m
21315,2,bobbes,2888,101,10,14,24,41.7%,9m
21315,3,[ULTX]schorsch,2888,236,9,10,19,47.4%,11m
21315,2,Nobody,2888,190,9,11,20,45.0%,9m
21315,3,AiOne,2888,208,6,5,11,54.5%,9m
21315,2,Jonysek,2888,154,5,9,14,35.7%,13m
21315,3,Calgarus,2888,30,2,2,4,50.0%,2m
21315,2,SerJaws,2888,102,2,2,4,50.0%,17m
21315,3,Falstaff,2888,0,2,3,5,40.0%,11m
21315,3,[RusTM]vintik,2888,30,1,1,2,50.0%,8m
21315,2,Pizza,2888,0,1,1,2,50.0%,5m
21315,2,Bomberix,2888,0,1,2,3,33.3%,4m
21315,3,[WField]ZającKażanka,2888,30,1,3,4,25.0%,23m
21315,3,[ThZe]Tharcil,2888,0,1,3,4,25.0%,17m
21315,2,ScaryMonster,2888,95,1,9,10,10.0%,12m
21315,2,Xzu,2888,0,0,1,1,0.0%,2m
21315,3,ThaThoss,2888,0,0,1,1,0.0%,8m
21315,3,[SLeo]BloodyStorm,2888,0,0,2,2,0.0%,22m
21315,2,[SZAP]Shnake,2888,0,0,6,6,0.0%,24m
21341,2,AllArmyAMove,2887,1378,186,179,365,51.0%,24m
21341,3,[LMBD]GRRRRRRRRRR,2887,1265,143,111,254,56.3%,2m
21341,1,DoctorRoach,2887,829,127,117,244,52.0%,7m
21341,2,Órói,2887,1429,86,86,172,50.0%,11m
21341,2,AltZ,2887,754,62,55,117,53.0%,11m
21341,2,JJD,2887,1276,55,52,107,51.4%,6m
21341,3,Marlito,2887,830,49,42,91,53.8%,10m
21341,1,[shadly]Ironside,2887,871,39,37,76,51.3%,25m
21341,3,Tamikara,2887,806,30,29,59,50.8%,22m
21341,2,Dregsy,2887,664,29,26,55,52.7%,6m
21341,2,Fantasma,2887,622,26,23,49,53.1%,14m
21341,3,Nitro,2887,355,15,7,22,68.2%,17m
21341,3,[wtw]WEITNOW,2887,396,15,13,28,53.6%,8m
21341,3,Badestrand,2887,246,10,7,17,58.8%,8m
21341,3,Fakie,2887,253,8,9,17,47.1%,24m
21341,2,Karakondjol,2887,264,8,11,19,42.1%,8m
21341,1,Azrail,2887,193,7,5,12,58.3%,4m
21341,3,umbraVirens,2887,60,6,7,13,46.2%,3m
21341,3,Bucket,2887,122,4,5,9,44.4%,5m
21341,2,Nameless,2887,0,3,2,5,60.0%,60m
21341,3,[Fansaf]Alexey,2887,0,3,2,5,60.0%,10m
21341,2,YourGranny,2887,117,3,4,7,42.9%,9m
21341,3,[KFCL]Dareneo,2887,30,2,1,3,66.7%,16m
21341,3,[SCEVER]lolostar,2887,58,2,2,4,50.0%,2m
21341,3,Hkon,2887,0,1,2,3,33.3%,9m
21341,3,[DМG]Gaiety,2887,0,0,1,1,0.0%,51m
21341,3,rrRrr,2887,0,0,1,1,0.0%,3m
21368,3,daemi,2886,1655,200,186,386,51.8%,9m
21368,1,Hich,2886,1396,106,110,216,49.1%,16m
21368,3,КОТ,2886,877,42,19,61,68.9%,24m
21368,2,[Sencor]MasterPig,2886,647,29,21,50,58.0%,15m
21368,2,Kris,2886,379,15,9,24,62.5%,9m
21368,2,[yлeй55]ПечальныйТОС,2886,339,13,11,24,54.2%,8m
21368,1,Pawel,2886,273,12,13,25,48.0%,15m
21368,3,kamernyid,2886,290,11,10,21,52.4%,16m
21368,2,Špekov,2886,287,10,11,21,47.6%,10m
21368,2,[dNsY]Vorisek,2886,173,8,6,14,57.1%,22m
21368,3,CrazyPenguin,2886,204,8,7,15,53.3%,9m
21368,3,Ektomorf,2886,196,8,7,15,53.3%,7m
21368,3,alKALIce,2886,140,6,3,9,66.7%,15m
21368,3,Valerko,2886,176,6,6,12,50.0%,16m
21368,3,todan,2886,148,5,5,10,50.0%,13m
21368,2,Ostwind,2886,180,5,5,10,50.0%,11m
21368,1,[BtW]EcstaTea,2886,136,4,0,4,100.0%,6m
21368,3,[13NRV]Alex,2886,0,4,1,5,80.0%,22m
21368,2,Morgoth,2886,76,4,3,7,57.1%,13m
21368,1,ViceVersa,2886,48,4,4,8,50.0%,5m
21368,3,carlbror,2886,58,3,1,4,75.0%,2m
21368,3,[230ММ]IronKerya,2886,0,3,1,4,75.0%,13m
21368,1,[L0KI]ßoßkiller,2886,0,3,3,6,50.0%,3m
21368,2,MrGabe,2886,114,3,4,7,42.9%,12m
21368,1,danil,2886,48,2,0,2,100.0%,7m
21368,3,Husiragon,2886,58,2,2,4,50.0%,15m
21368,3,Leviatan,2886,0,1,0,1,100.0%,3m
21368,3,ToxiY,2886,0,1,0,1,100.0%,24m
21368,2,Basic,2886,0,1,0,1,100.0%,44m
21368,3,DEMQN,2886,0,0,3,3,0.0%,8m
21368,3,Uber,2886,0,0,3,3,0.0%,3m
21368,2,LedZeppelin,2886,0,0,4,4,0.0%,24m
21400,3,Newmaxl,2885,1540,107,96,203,52.7%,25m
21400,3,[AiRǂ]Giovanni,2885,1600,82,61,143,57.3%,17m
21400,2,Cilius,2885,1473,64,53,117,54.7%,23m
21400,2,Sabaken,2885,426,33,31,64,51.6%,3m
21400,1,Janko,2885,780,32,29,61,52.5%,9m
21400,3,Lumnezia,2885,399,20,18,38,52.6%,4m
21400,2,TMcSpitfire,2885,503,19,17,36,52.8%,10m
21400,2,[HOMIS]Dododream,2885,281,13,11,24,54.2%,3m
21400,2,vnmZor,2885,272,11,10,21,52.4%,9m
21400,3,Fener,2885,284,10,4,14,71.4%,24m
21400,3,Vypeer,2885,235,8,6,14,57.1%,7m
21400,2,ActionWords,2885,224,8,7,15,53.3%,13m
21400,2,SONIKz,2885,250,8,12,20,40.0%,24m
21400,1,[brzzer]Alvaro,2885,242,7,12,19,36.8%,23m
21400,1,DAAS,2885,141,5,1,6,83.3%,52m
21400,1,Harkot,2885,125,5,6,11,45.5%,2m
21400,2,ImSiberian,2885,0,4,3,7,57.1%,23m
21400,2,Noul,2885,122,4,7,11,36.4%,9m
21400,3,Doods,2885,0,3,2,5,60.0%,3m
21400,2,HitSmoker,2885,0,3,2,5,60.0%,59m
21400,3,Whitey,2885,88,3,4,7,42.9%,8m
21400,3,FlakeyBanana,2885,30,2,1,3,66.7%,7m
21400,2,[Yeager]hollowUnit,2885,30,2,4,6,33.3%,3m
21400,3,[R0]Ketodar,2885,0,1,0,1,100.0%,15m
21400,3,farienthé,2885,0,1,0,1,100.0%,7m
21400,3,vadlap,2885,0,1,0,1,100.0%,7m
21400,2,JustBerkai,2885,0,1,0,1,100.0%,58m
21400,1,qwazed,2885,97,1,1,2,50.0%,48m
21400,1,РядовойРудге,2885,0,1,1,2,50.0%,18m
21400,3,xtargetx,2885,30,1,1,2,50.0%,17m
21400,2,[Quite]Rimseg,2885,30,1,5,6,16.7%,13m
21431,3,[Hаsu]BiHiTRiLL,2884,1530,481,481,962,50.0%,13m
21431,1,mishmish,2884,1101,144,153,297,48.5%,25m
21431,2,Jickars,2884,1462,99,102,201,49.3%,6m
21431,2,Rashow,2884,583,83,86,169,49.1%,9m
21431,3,Istone,2884,1499,60,58,118,50.8%,8m
21431,1,[WCF]Nago,2884,1286,60,60,120,50.0%,15m
21431,1,Hummingbird,2884,890,47,47,94,50.0%,25m
21431,3,Error,2884,191,33,24,57,57.9%,3m
21431,3,Shinzou,2884,583,24,14,38,63.2%,3m
21431,3,[Xtreme]Requiem,2884,604,24,16,40,60.0%,22m
21431,2,Hordalos,2884,484,24,24,48,50.0%,12m
21431,2,Nasenzwicker,2884,556,20,20,40,50.0%,23m
21431,2,kaenazje,2884,532,20,22,42,47.6%,9m
21431,3,phasotron,2884,476,18,15,33,54.5%,9m
21431,2,GRZES,2884,472,16,19,35,45.7%,8m
21431,1,walabiz,2884,358,13,21,34,38.2%,14m
21431,3,dark,2884,333,11,8,19,57.9%,2m
21431,2,Melange,2884,210,6,8,14,42.9%,8m
21431,2,Mongol,2884,158,5,5,10,50.0%,3m
21431,2,СЕМЬЯ,2884,46,4,3,7,57.1%,3m
21431,2,MAITRE,2884,88,4,3,7,57.1%,4m
21431,3,xan,2884,58,3,1,4,75.0%,16m
21431,1,[TacoB]Squid,2884,145,3,7,10,30.0%,4m
21431,1,WidowCruiser,2884,97,2,0,2,100.0%,1h
21431,2,[IÐŠI]Staggy,2884,30,2,5,7,28.6%,11m
21431,3,[wN5]Vanan,2884,0,1,0,1,100.0%,16m
21431,3,Borp,2884,0,1,0,1,100.0%,17m
21431,3,SARMAT,2884,30,1,1,2,50.0%,2m
21431,2,TriXFox,2884,0,1,1,2,50.0%,25m
21431,3,Well,2884,0,0,1,1,0.0%,9m
21431,3,GeorgTD,2884,0,0,2,2,0.0%,5m
21431,3,Zerg,2884,0,0,3,3,0.0%,17m
21463,3,GGz,2883,1439,89,88,177,50.3%,2m
21463,2,Knight,2883,737,70,58,128,54.7%,6m
21463,2,Heltarion,2883,1457,63,56,119,52.9%,24m
21463,2,Nimrat,2883,1187,44,47,91,48.4%,9m
21463,1,Visdmin,2883,881,30,38,68,44.1%,6m
21463,3,Hindi,2883,574,25,16,41,61.0%,23m
21463,2,Billiboyed,2883,557,22,20,42,52.4%,9m
21463,3,Hopeless,2883,474,17,16,33,51.5%,24m
21463,3,Aiko,2883,400,14,16,30,46.7%,15m
21463,2,zChaos,2883,267,12,10,22,54.5%,3m
21463,3,Edinorog,2883,212,12,13,25,48.0%,10m
21463,3,aXzion,2883,201,11,3,14,78.6%,25m
21463,3,[T4E]KomplexX,2883,281,11,9,20,55.0%,22m
21463,3,darki,2883,196,7,8,15,46.7%,34m
21463,3,Kuririn,2883,184,7,8,15,46.7%,23m
21463,3,deKeter,2883,0,5,3,8,62.5%,14m
21463,2,ilox,2883,60,5,5,10,50.0%,23m
21463,3,METHUSALEM,2883,86,4,1,5,80.0%,22m
21463,2,Steast,2883,140,4,3,7,57.1%,1h
21463,2,folk,2883,98,4,10,14,28.6%,2m
21463,3,Mystogan,2883,0,3,2,5,60.0%,14m
21463,2,Peeps,2883,0,3,3,6,50.0%,8m
21463,1,[TirolA]Dzodzo,2883,145,2,3,5,40.0%,30m
21463,2,qiVenny,2883,0,2,3,5,40.0%,2m
21463,3,ХрякЕда,2883,0,1,0,1,100.0%,11m
21463,3,Shadow,2883,0,1,2,3,33.3%,54m
21463,2,[Nubis]Sýron,2883,30,1,4,5,20.0%,17m
21463,3,Kawaz,2883,0,0,1,1,0.0%,2m
21463,3,[4a6f62]Anonymous,2883,0,0,1,1,0.0%,13m
21463,2,Sleizer,2883,0,0,1,1,0.0%,51m
21463,2,phantom,2883,0,0,1,1,0.0%,22m
21463,3,[basdp]Mora,2883,0,0,2,2,0.0%,23m
21495,2,Игорь,2882,1493,100,94,194,51.5%,24m
21495,2,[ICE5]Seligman,2882,1306,86,63,149,57.7%,24m
21495,3,Frice,2882,1440,68,46,114,59.6%,13m
21495,2,Comète,2882,990,48,49,97,49.5%,9m
21495,3,Rejoice,2882,828,31,30,61,50.8%,23m
21495,3,Shikimikiman,2882,710,28,26,54,51.9%,23m
21495,2,Harrtuck,2882,426,19,17,36,52.8%,25m
21495,3,Theodoris,2882,375,18,7,25,72.0%,15m
21495,3,Shocked,2882,332,14,13,27,51.9%,16m
21495,3,[IBeAŚI]MRRage,2882,228,11,3,14,78.6%,8m
21495,2,MLíko,2882,288,10,4,14,71.4%,49m
21495,1,Skapie,2882,192,7,5,12,58.3%,56m
21495,3,Fares,2882,176,7,5,12,58.3%,16m
21495,2,FateZero,2882,210,7,8,15,46.7%,15m
21495,3,[Svtsky]Gyton,2882,193,6,3,9,66.7%,8m
21495,1,Frosch,2882,0,5,4,9,55.6%,15m
21495,3,RaimisFx,2882,144,5,4,9,55.6%,11m
21495,3,[ТКД]Scorp,2882,188,5,5,10,50.0%,12m
21495,1,JokkePokke,2882,120,4,5,9,44.4%,59m
21495,2,[Traxen]Space,2882,0,3,4,7,42.9%,15m
21495,2,[56APM]ladilla,2882,68,3,5,8,37.5%,11m
21495,2,[FuryØ]luc,2882,90,3,7,10,30.0%,12m
21495,3,Diggahs,2882,0,2,3,5,40.0%,10m
21495,1,Cobaneros,2882,0,1,0,1,100.0%,56m
21495,3,Zib,2882,0,1,1,2,50.0%,22m
21495,3,[SBR42]eXtaZzy,2882,0,1,1,2,50.0%,10m
21495,3,Nightmare,2882,30,1,1,2,50.0%,5m
21495,2,MicroJordann,2882,0,1,1,2,50.0%,25m
21495,3,Godnez,2882,30,1,3,4,25.0%,24m
21495,3,[LPA]Phranix,2882,0,0,1,1,0.0%,30m
21495,3,ZyReX,2882,0,0,1,1,0.0%,16m
21495,3,[xLuck]Eugene,2882,0,0,1,1,0.0%,17m
21495,3,SImplyOo,2882,0,0,1,1,0.0%,14m
21495,3,[LinGG]ZerGG,2882,0,0,1,1,0.0%,8m
21495,3,[PowerG]MasterMind,2882,0,0,2,2,0.0%,6m
21495,3,[JORJOS]GekkeGerrit,2882,0,0,2,2,0.0%,3m
21495,2,ikL,2882,0,0,3,3,0.0%,24m
21532,2,Fruitkiller,2881,1544,87,87,174,50.0%,2m
21532,2,Charmaquest,2881,735,61,52,113,54.0%,4m
21532,2,Tounkle,2881,622,39,33,72,54.2%,10m
21532,3,Ricky,2881,837,33,27,60,55.0%,2m
21532,2,Empresslilyy,2881,793,33,33,66,50.0%,23m
21532,1,[TAW]Sulkosaurus,2881,890,30,39,69,43.5%,9m
21532,3,balabala,2881,469,23,12,35,65.7%,5m
21532,2,Vince,2881,488,20,18,38,52.6%,3m
21532,2,Wayofdao,2881,555,20,23,43,46.5%,14m
21532,2,[KrnBrs]Волшебник,2881,269,18,16,34,52.9%,9m
21532,2,[SeeLaw]Jordan,2881,474,17,22,39,43.6%,24m
21532,1,EntityZero,2881,374,14,23,37,37.8%,3m
21532,2,Frostmourne,2881,341,12,10,22,54.5%,8m
21532,3,[ЗИБиАГ]GaNGsTaR,2881,297,10,8,18,55.6%,10m
21532,3,schokobon,2881,193,8,7,15,53.3%,7m
21532,2,Reayman,2881,196,7,11,18,38.9%,23m
21532,3,KnackTwoBaby,2881,114,5,3,8,62.5%,5m
21532,3,[glmx]Kernesto,2881,120,5,5,10,50.0%,15m
21532,3,Elitesko,2881,170,5,5,10,50.0%,3m
21532,1,toi,2881,194,5,12,17,29.4%,6m
21532,3,[BRSKR]Mudflap,2881,149,3,2,5,60.0%,49m
21532,3,Pulloutking,2881,0,3,2,5,60.0%,17m
21532,3,[NLTN]Rożek,2881,58,2,1,3,66.7%,16m
21532,3,[UOWS]LadyCelestia,2881,119,2,5,7,28.6%,9m
21532,2,[xFRSx]iMaster,2881,62,2,7,9,22.2%,9m
21532,1,[ATOMOS]Calogero,2881,0,1,2,3,33.3%,52m
21532,3,[KEKZ]Unam,2881,30,1,2,3,33.3%,22m
21532,3,Fayfull,2881,0,1,2,3,33.3%,10m
21532,3,Unhealthy,2881,30,1,3,4,25.0%,4m
21532,2,[MoopyS]Nubsan,2881,99,1,7,8,12.5%,9m
21532,3,PandA,2881,0,0,1,1,0.0%,24m
21532,3,swop,2881,0,0,1,1,0.0%,23m
21532,3,FearLessGirl,2881,0,0,1,1,0.0%,16m
21565,2,Repetuz,2880,1563,130,115,245,53.1%,17m
21565,2,Tanaki,2880,1549,90,86,176,51.1%,13m
21565,3,Kendrick,2880,1474,72,80,152,47.4%,25m
21565,2,EightBit,2880,543,35,39,74,47.3%,12m
21565,3,Siegfried,2880,743,30,28,58,51.7%,10m
21565,2,[Dzen]konstantinos,2880,299,17,11,28,60.7%,13m
21565,3,ZuKi,2880,414,16,15,31,51.6%,7m
21565,3,IamDoduuu,2880,382,15,13,28,53.6%,7m
21565,3,MadScientist,2880,200,15,15,30,50.0%,5m
21565,2,[DUF]Bllizdy,2880,254,13,12,25,52.0%,24m
21565,3,HammerPAE,2880,304,11,9,20,55.0%,8m
21565,3,[1Pack]Calculon,2880,262,10,8,18,55.6%,8m
21565,2,[TuRki]BigTesty,2880,181,9,8,17,52.9%,8m
21565,3,Mungo,2880,174,7,5,12,58.3%,2m
21565,3,EMPEROR,2880,116,5,1,6,83.3%,23m
21565,2,Rendodo,2880,152,5,5,10,50.0%,23m
21565,3,PurpleStar,2880,144,4,1,5,80.0%,25m
21565,3,Jasont,2880,114,4,3,7,57.1%,17m
21565,3,Kruger,2880,182,4,6,10,40.0%,2m
21565,2,Feyruz,2880,90,4,8,12,33.3%,11m
21565,2,[PARCE]Niloc,2880,116,3,3,6,50.0%,24m
21565,3,Tesla,2880,58,3,3,6,50.0%,22m
21565,2,Tormentor,2880,90,3,7,10,30.0%,24m
21565,2,OMEGA,2880,94,3,10,13,23.1%,17m
21565,2,Quick,2880,105,2,1,3,66.7%,53m
21565,3,Plikis,2880,58,2,1,3,66.7%,24m
21565,2,[БАРА]IIIIIIIIIIII,2880,88,2,3,5,40.0%,11m
21565,2,Fingon,2880,30,2,3,5,40.0%,13m
21565,2,Winner,2880,30,2,4,6,33.3%,10m
21565,3,Thetheth,2880,0,1,0,1,100.0%,16m
21565,1,ket,2880,96,1,1,2,50.0%,56m
21565,3,AdunToridas,2880,30,1,2,3,33.3%,23m
21565,3,[CCSR]RONIN,2880,32,1,3,4,25.0%,46m
21565,3,NightCrawler,2880,30,1,4,5,20.0%,4m
21565,3,[SLW]Titans,2880,0,1,4,5,20.0%,2m
21565,3,[TBMF]Lukas,2880,0,0,1,1,0.0%,25m
21565,3,DEIMOS,2880,0,0,1,1,0.0%,9m
21565,3,NuclearK,2880,0,0,4,4,0.0%,46m
21603,1,Matmouth,2879,1627,723,723,1446,50.0%,11m
21603,1,Obsoleto,2879,931,316,316,632,50.0%,13m
21603,1,[PLFS]Tarkes,2879,1094,84,86,170,49.4%,25m
21603,2,McSuicide,2879,792,47,50,97,48.5%,9m
21603,3,CORONAVR,2879,1090,43,39,82,52.4%,5m
21603,2,[OJKSB]Kevin,2879,951,38,37,75,50.7%,9m
21603,1,Bubka,2879,836,33,34,67,49.3%,6m
21603,1,Muckel,2879,465,29,42,71,40.8%,5m
21603,3,nomadoda,2879,620,27,20,47,57.4%,17m
21603,3,artolio,2879,524,21,21,42,50.0%,3m
21603,2,Pov,2879,481,19,14,33,57.6%,24m
21603,3,cassolette,2879,440,17,14,31,54.8%,17m
21603,3,NBdestorm,2879,360,14,9,23,60.9%,16m
21603,2,AzimuthXeno,2879,271,10,11,21,47.6%,25m
21603,3,Urzaaf,2879,262,9,8,17,52.9%,17m
21603,3,DuncanDalas,2879,256,8,13,21,38.1%,13m
21603,1,Repelsteel,2879,119,5,4,9,55.6%,48m
21603,2,Whuen,2879,58,4,5,9,44.4%,8m
21603,1,lars,2879,147,4,5,9,44.4%,41m
21603,1,Haugen,2879,0,3,3,6,50.0%,6m
21603,2,[SAoN]SAK,2879,48,3,3,6,50.0%,59m
21603,2,Aximo,2879,0,3,3,6,50.0%,56m
21603,3,[4GT]Wienczyslaw,2879,146,3,4,7,42.9%,9m
21603,1,DJB,2879,0,3,4,7,42.9%,44m
21603,3,Hell,2879,88,3,5,8,37.5%,9m
21603,2,[ADDR]BaconBob,2879,60,3,6,9,33.3%,25m
21603,3,Siplard,2879,0,1,0,1,100.0%,4m
21603,3,JleLmeshek,2879,0,1,0,1,100.0%,16m
21603,3,[WCKYLN]Gammelon,2879,0,1,1,2,50.0%,14m
21603,3,GolDoSemka,2879,30,1,1,2,50.0%,11m
21603,3,Luciy,2879,0,1,1,2,50.0%,4m
21603,3,Madara,2879,30,1,3,4,25.0%,13m
21603,3,[F0S]StarWarrior,2879,0,1,11,12,8.3%,2m
21603,3,mostal,2879,0,0,1,1,0.0%,2m
21603,3,Floppy,2879,0,0,1,1,0.0%,16m
21603,3,Nik,2879,0,0,1,1,0.0%,14m
21603,3,Quimby,2879,0,0,1,1,0.0%,2m
21640,3,Brubbster,2878,1526,420,413,833,50.4%,10m
21640,2,VovanGarag,2878,1578,121,122,243,49.8%,11m
21640,3,Splinterjack,2878,1343,55,50,105,52.4%,2m
21640,3,[NGaBZH]Térazil,2878,972,32,49,81,39.5%,9m
21640,3,[PULET]SweetLeaf,2878,484,20,16,36,55.6%,10m
21640,3,Quicot,2878,558,19,20,39,48.7%,4m
21640,3,BilboBaggins,2878,323,13,4,17,76.5%,17m
21640,2,FMD,2878,279,11,12,23,47.8%,8m
21640,1,[w8tpvr]gremlin,2878,316,11,22,33,33.3%,13m
21640,2,Gabol,2878,125,9,9,18,50.0%,1h
21640,2,ligmalarva,2878,258,9,13,22,40.9%,8m
21640,3,SBKǂHystWarr,2878,228,8,10,18,44.4%,4m
21640,3,UwU,2878,213,6,3,9,66.7%,8m
21640,1,[Flexen]NaturTalent,2878,121,6,5,11,54.5%,6m
21640,2,PerEGrønvik,2878,124,5,9,14,35.7%,3m
21640,3,slidsolid,2878,94,4,2,6,66.7%,13m
21640,3,Herbert,2878,168,4,2,6,66.7%,17m
21640,3,[PIJP]PinkDevil,2878,95,4,2,6,66.7%,2m
21640,3,Furkan,2878,0,3,2,5,60.0%,2m
21640,1,Serummoner,2878,0,3,3,6,50.0%,7m
21640,2,[Оми]Аккерман,2878,114,3,4,7,42.9%,7m
21640,1,Gaara,2878,142,3,5,8,37.5%,51m
21640,2,Vaha,2878,140,2,2,4,50.0%,3m
21640,3,FearLess,2878,0,1,0,1,100.0%,3m
21640,3,Realone,2878,0,1,0,1,100.0%,10m
21640,3,Tyrant,2878,30,1,2,3,33.3%,22m
21640,2,Strife,2878,0,1,3,4,25.0%,4m
21640,2,GaTTo,2878,0,1,4,5,20.0%,25m
21640,3,john,2878,0,0,1,1,0.0%,7m
21640,3,TheZerg,2878,0,0,2,2,0.0%,8m
21640,3,CoolStoryBob,2878,0,0,2,2,0.0%,15m
21671,2,Dragos,2877,1550,359,349,708,50.7%,4m
21671,3,Ireniicus,2877,1558,98,107,205,47.8%,14m
21671,2,Nêcrô,2877,337,74,65,139,53.2%,8m
21671,3,kokopop,2877,1457,59,53,112,52.7%,8m
21671,2,Bliss,2877,649,58,51,109,53.2%,6m
21671,3,Tonko,2877,788,31,29,60,51.7%,5m
21671,2,liquid,2877,716,29,23,52,55.8%,3m
21671,3,Meatpants,2877,411,18,11,29,62.1%,13m
21671,2,DesertFox,2877,384,16,11,27,59.3%,15m
21671,2,MrMiyagi,2877,397,15,17,32,46.9%,23m
21671,3,Facepalm,2877,275,13,10,23,56.5%,17m
21671,1,Nux,2877,303,13,10,23,56.5%,24m
21671,2,[Listic]Traktobu,2877,378,13,16,29,44.8%,23m
21671,3,Zershaan,2877,304,11,5,16,68.8%,2m
21671,3,TheStickyBun,2877,176,9,8,17,52.9%,11m
21671,1,[VXO5]Vrees,2877,210,9,9,18,50.0%,45m
21671,2,Yuradi,2877,167,9,11,20,45.0%,11m
21671,1,Warlord,2877,253,8,5,13,61.5%,48m
21671,3,Mase,2877,228,8,8,16,50.0%,22m
21671,3,WoWaZaNiK,2877,224,8,8,16,50.0%,9m
21671,2,[DNGR]ĐăƦķŋƐƺƾ,2877,154,6,8,14,42.9%,10m
21671,2,SnapFlapper,2877,46,5,6,11,45.5%,41m
21671,2,[DМG]DobryyKot,2877,92,4,6,10,40.0%,15m
21671,3,Idiot,2877,0,3,2,5,60.0%,17m
21671,3,SCGUY,2877,86,3,3,6,50.0%,11m
21671,3,[Актив]serega,2877,147,3,4,7,42.9%,34m
21671,3,Memorantix,2877,58,2,1,3,66.7%,2m
21671,3,MichuX,2877,0,2,3,5,40.0%,10m
21671,2,Gajam,2877,142,2,6,8,25.0%,2m
21671,3,andrey,2877,0,1,0,1,100.0%,12m
21671,3,[BzHeRo]Derox,2877,0,1,0,1,100.0%,23m
21671,3,Fongerzog,2877,0,1,0,1,100.0%,4m
21671,3,alexprotasov,2877,0,0,1,1,0.0%,16m
21671,1,[KGIAAS]DoomY,2877,0,0,1,1,0.0%,29m
21671,2,MnogoIdey,2877,0,0,1,1,0.0%,56m
21671,3,[BFG9K]Top,2877,0,0,2,2,0.0%,11m
21707,1,LevelUP,2876,1622,365,343,708,51.6%,7m
21707,2,[SPАRТА]Akixiro,2876,1161,46,42,88,52.3%,12m
21707,2,gramos,2876,826,32,32,64,50.0%,23m
21707,3,Kimarius,2876,766,28,26,54,51.9%,11m
21707,3,Steve,2876,335,14,12,26,53.8%,24m
21707,3,[Fae]Scalpex,2876,207,14,13,27,51.9%,16m
21707,3,NTI,2876,321,13,12,25,52.0%,13m
21707,2,[Krmz]Hermione,2876,240,10,8,18,55.6%,24m
21707,2,[fam1ly]NOOBDekA,2876,204,7,11,18,38.9%,8m
21707,3,KitKat,2876,98,6,2,8,75.0%,5m
21707,1,JanSolo,2876,0,5,2,7,71.4%,24m
21707,2,Krovn,2876,138,4,4,8,50.0%,1h
21707,3,oTactXo,2876,143,4,5,9,44.4%,23m
21707,3,Gilgamesh,2876,60,3,2,5,60.0%,16m
21707,3,Cheesus,2876,0,3,2,5,60.0%,8m
21707,1,[TFL]ThePharaoh,2876,97,3,3,6,50.0%,3m
21707,3,[Эмо228]USBKOT,2876,0,1,0,1,100.0%,14m
21707,1,ZumSieg,2876,0,1,1,2,50.0%,45m
21707,1,Scar,2876,48,1,1,2,50.0%,42m
21707,3,[ZЕRG7V]JohnnyBravo,2876,30,1,2,3,33.3%,12m
21707,3,Jowkster,2876,30,1,3,4,25.0%,24m
21707,1,[HaoS]Alduin,2876,0,0,1,1,0.0%,31m
21729,2,[PÂRłAH]DanielCzech,2875,1535,195,185,380,51.3%,24m
21729,2,Lunar,2875,1136,90,93,183,49.2%,9m
21729,1,dmn,2875,1306,85,88,173,49.1%,8m
21729,2,Bellua,2875,861,75,73,148,50.7%,14m
21729,2,[WCKYLN]Xyed,2875,1379,74,71,145,51.0%,8m
21729,1,wztvm,2875,925,64,69,133,48.1%,9m
21729,3,[ProbKA]ДухКомунизма,2875,1337,60,39,99,60.6%,25m
21729,3,tarvota,2875,611,53,40,93,57.0%,3m
21729,3,rabbagast,2875,1089,53,45,98,54.1%,16m
21729,2,Agiro,2875,631,36,27,63,57.1%,26m
21729,3,[piknes]Floydy,2875,726,27,25,52,51.9%,17m
21729,3,[HZeS]GooseLuck,2875,530,23,3,26,88.5%,14m
21729,2,Hovermind,2875,292,11,13,24,45.8%,13m
21729,3,[scp3]bertnard,2875,336,11,14,25,44.0%,3m
21729,2,Nexus,2875,263,9,6,15,60.0%,3m
21729,3,[SunWu]Olghyr,2875,226,9,8,17,52.9%,39m
21729,3,MrAD,2875,232,8,3,11,72.7%,13m
21729,3,Olympien,2875,184,8,6,14,57.1%,4m
21729,2,SIVERTOV,2875,88,7,9,16,43.8%,23m
21729,3,[CS0]LupiLupa,2875,146,6,5,11,54.5%,25m
21729,3,gIggs,2875,174,6,7,13,46.2%,22m
21729,3,[LPDCSC]NightFall,2875,124,5,3,8,62.5%,4m
21729,3,Babo,2875,86,4,2,6,66.7%,24m
21729,2,Rama,2875,109,4,4,8,50.0%,6m
21729,2,magnolia,2875,142,4,5,9,44.4%,8m
21729,3,SpongeBob,2875,0,3,2,5,60.0%,7m
21729,2,[SDRV]ALCOLMAN,2875,141,2,1,3,66.7%,43m
21729,3,gizMax,2875,30,2,2,4,50.0%,23m
21729,3,[TheRET]Breez,2875,60,2,3,5,40.0%,9m
21729,3,[lnvoke]MicMaN,2875,0,1,0,1,100.0%,7m
21729,2,[Milas]EnTaroZeratu,2875,0,1,2,3,33.3%,2m
21729,1,Graff,2875,0,1,2,3,33.3%,18m
21729,3,Scrouji,2875,30,1,3,4,25.0%,22m
21729,2,[ÆR]ReVeHUN,2875,0,1,4,5,20.0%,12m
21729,2,MANURIS,2875,0,0,1,1,0.0%,58m
21729,2,Zzz,2875,0,0,1,1,0.0%,19m
21729,3,YoWtF,2875,0,0,3,3,0.0%,22m
21766,3,sdk,2874,1595,174,151,325,53.5%,2m
21766,2,Zoran,2874,1553,156,160,316,49.4%,2m
21766,2,Ywing,2874,1592,150,142,292,51.4%,10m
21766,2,[DMSW]trolzilol,2874,674,125,120,245,51.0%,17m
21766,2,[SibOPG]SiberianOPG,2874,762,109,80,189,57.7%,24m
21766,3,Sufferu,2874,1116,58,43,101,57.4%,8m
21766,3,antoine,2874,906,44,24,68,64.7%,9m
21766,2,lahciMx,2874,883,37,32,69,53.6%,17m
21766,2,Helluva,2874,835,34,38,72,47.2%,17m
21766,3,Dovakinovich,2874,648,26,22,48,54.2%,8m
21766,2,[FB3]emiltheman,2874,85,17,26,43,39.5%,17m
21766,3,Indianadrone,2874,266,16,10,26,61.5%,2m
21766,2,Giannino,2874,356,14,14,28,50.0%,23m
21766,2,ALeakyFaucet,2874,347,14,14,28,50.0%,12m
21766,2,Popop,2874,332,12,15,27,44.4%,3m
21766,3,Terranium,2874,330,11,8,19,57.9%,24m
21766,1,[BHN]Leonidass,2874,358,10,24,34,29.4%,10m
21766,1,Azazel,2874,280,9,18,27,33.3%,2m
21766,3,Kamikaze,2874,140,6,2,8,75.0%,22m
21766,2,Teclis,2874,154,6,6,12,50.0%,8m
21766,2,[8Pool]mcmara,2874,229,6,9,15,40.0%,33m
21766,1,FRIGOPLEIN,2874,182,6,14,20,30.0%,6m
21766,2,[NordB]Trustich,2874,0,4,1,5,80.0%,23m
21766,3,[UWDIE]Asimov,2874,30,4,3,7,57.1%,23m
21766,2,Kolot,2874,46,4,3,7,57.1%,39m
21766,3,Tomiris,2874,30,4,3,7,57.1%,6m
21766,1,[0142]WENGER,2874,121,3,1,4,75.0%,50m
21766,2,[KeKMax]TheWolf,2874,0,3,2,5,60.0%,1h
21766,2,nnn,2874,126,3,2,5,60.0%,39m
21766,2,[MadKuy]Kita,2874,0,3,4,7,42.9%,24m
21766,3,[ЕБАННЫ]SuperGamer,2874,30,2,1,3,66.7%,13m
21766,3,[hf4X4]OneTwo,2874,58,2,1,3,66.7%,25m
21766,1,Narlow,2874,95,2,3,5,40.0%,17m
21766,1,Iowa,2874,0,2,5,7,28.6%,20m
21766,3,[Vuur]Bloedvuur,2874,0,1,0,1,100.0%,22m
21766,3,george,2874,0,1,0,1,100.0%,26m
21766,3,[vlnr]mOkel,2874,30,1,2,3,33.3%,7m
21766,1,[QWARK]Alienskater,2874,97,1,2,3,33.3%,1h
21766,2,[MTFBWY]Oxido,2874,30,1,5,6,16.7%,14m
21766,2,[ICZEI]Gantraz,2874,0,1,6,7,14.3%,13m
21766,3,Hypogojix,2874,0,0,1,1,0.0%,9m
21766,3,Rufixme,2874,0,0,1,1,0.0%,22m
21766,2,eType,2874,0,0,2,2,0.0%,8m
21766,3,Duchik,2874,0,0,2,2,0.0%,23m
21766,3,Yoyott,2874,0,0,2,2,0.0%,2m
21766,3,[ZЕRGTV]DOT,2874,0,0,3,3,0.0%,16m
21812,2,Angriff,2873,1498,189,172,361,52.4%,17m
21812,3,IceCube,2873,838,169,149,318,53.1%,10m
21812,2,AngryRoach,2873,1591,114,111,225,50.7%,8m
21812,3,gaiden,2873,1129,96,110,206,46.6%,14m
21812,1,[SWABIA]Nygiz,2873,1468,96,110,206,46.6%,5m
21812,2,Lhuq,2873,1563,79,86,165,47.9%,23m
21812,1,caret,2873,1406,74,87,161,46.0%,12m
21812,2,QueenOfRoses,2873,756,55,42,97,56.7%,9m
21812,2,Крапива,2873,1076,46,43,89,51.7%,8m
21812,2,Contratoss,2873,493,41,39,80,51.2%,9m
21812,3,[DLTED]Impailer,2873,546,35,16,51,68.6%,9m
21812,3,ZorPit,2873,914,34,29,63,54.0%,3m
21812,3,reptiler,2873,790,33,24,57,57.9%,7m
21812,3,[SCGTR]Myxa,2873,415,16,9,25,64.0%,7m
21812,2,Gratz,2873,400,15,14,29,51.7%,6m
21812,3,Pomki,2873,290,11,10,21,52.4%,22m
21812,2,swibberman,2873,191,10,9,19,52.6%,43m
21812,3,Ironside,2873,235,7,4,11,63.6%,5m
21812,2,Nik,2873,220,7,8,15,46.7%,12m
21812,3,Gum,2873,174,6,6,12,50.0%,22m
21812,3,ElTortuga,2873,114,5,1,6,83.3%,5m
21812,2,ALIVE,2873,98,4,9,13,30.8%,24m
21812,2,ØrmWorZul,2873,0,3,2,5,60.0%,2m
21812,3,Imago,2873,58,3,2,5,60.0%,9m
21812,3,[BDWH]Hege,2873,145,3,6,9,33.3%,21m
21812,3,Komudat,2873,119,2,3,5,40.0%,14m
21812,3,[DHTs]Blis,2873,0,1,0,1,100.0%,9m
21812,3,[JEBLA]kikondo,2873,0,1,0,1,100.0%,5m
21812,3,bUNNiRunnI,2873,30,1,4,5,20.0%,9m
21812,3,[Stront]Nitro,2873,0,0,1,1,0.0%,17m
21812,3,[1Xp1]MongoHelgson,2873,0,0,1,1,0.0%,9m
21812,3,FadingShadow,2873,0,0,2,2,0.0%,3m
21812,3,HiveCaKe,2873,0,0,3,3,0.0%,24m
21812,3,Arkat,2873,0,0,3,3,0.0%,14m
21846,1,KingCrimson,2872,1614,434,430,864,50.2%,7m
21846,2,[DaAm]Stetkaer,2872,1453,328,360,688,47.7%,25m
21846,1,toberses,2872,1505,194,197,391,49.6%,9m
21846,2,giove,2872,1323,148,128,276,53.6%,24m
21846,2,WildStyle,2872,1442,105,98,203,51.7%,9m
21846,2,Mcgubbins,2872,1219,102,108,210,48.6%,23m
21846,2,Vikz,2872,710,78,67,145,53.8%,24m
21846,1,[NWGD]benito,2872,1068,77,73,150,51.3%,5m
21846,2,[mfixed]Tomek,2872,1361,64,64,128,50.0%,9m
21846,2,SPY,2872,1371,60,55,115,52.2%,26m
21846,2,Nanaki,2872,911,43,31,74,58.1%,9m
21846,1,DasGrauen,2872,1021,42,46,88,47.7%,17m
21846,3,Abathur,2872,1024,40,33,73,54.8%,17m
21846,1,PikPok,2872,728,30,37,67,44.8%,24m
21846,3,KaCTeT,2872,690,26,21,47,55.3%,5m
21846,3,Wnuk,2872,270,19,12,31,61.3%,14m
21846,3,momo,2872,288,12,10,22,54.5%,12m
21846,3,CrazyChicken,2872,190,7,6,13,53.8%,6m
21846,2,Ryu,2872,229,7,10,17,41.2%,8m
21846,2,Liara,2872,140,6,5,11,54.5%,2m
21846,3,alexinAtoR,2872,126,6,6,12,50.0%,1h
21846,3,Platynowy,2872,86,3,1,4,75.0%,10m
21846,1,Polopash,2872,0,3,3,6,50.0%,1h
21846,3,niph,2872,30,2,1,3,66.7%,8m
21846,3,LizardKing,2872,0,2,3,5,40.0%,17m
21846,2,MoonHunter,2872,30,2,5,7,28.6%,8m
21846,3,Kotofan,2872,0,1,0,1,100.0%,23m
21846,3,Vember,2872,0,1,0,1,100.0%,4m
21846,3,[Кратос]sava,2872,30,1,3,4,25.0%,16m
21846,2,Petala,2872,76,1,3,4,25.0%,12m
21846,3,mak,2872,30,1,3,4,25.0%,6m
21846,3,MrKunnas,2872,0,0,1,1,0.0%,7m
21846,3,Buryak,2872,0,0,1,1,0.0%,4m
21846,3,Arkveeri,2872,0,0,2,2,0.0%,11m
21880,1,Storm,2871,1598,278,274,552,50.4%,13m
21880,2,[Cancro]Horzik,2871,1578,160,137,297,53.9%,24m
21880,2,BrownOstrich,2871,751,92,90,182,50.5%,8m
21880,1,JeanneHaZuKi,2871,1568,79,81,160,49.4%,23m
21880,3,soggiestcake,2871,1105,59,42,101,58.4%,24m
21880,3,Eraser,2871,920,53,46,99,53.5%,2m
21880,2,Cracknut,2871,542,20,23,43,46.5%,8m
21880,1,blackhole,2871,534,20,25,45,44.4%,6m
21880,2,Yashmariman,2871,266,15,10,25,60.0%,23m
21880,2,Papoy,2871,167,15,13,28,53.6%,25m
21880,3,Lukar,2871,292,13,10,23,56.5%,13m
21880,3,LongJohnson,2871,319,12,4,16,75.0%,39m
21880,2,Pavlentiy,2871,368,12,17,29,41.4%,15m
21880,1,Recluso,2871,233,9,2,11,81.8%,41m
21880,2,Phenice,2871,181,9,8,17,52.9%,24m
21880,3,[TuPiZi]Patrik,2871,224,9,8,17,52.9%,35m
21880,3,IceFear,2871,236,8,4,12,66.7%,16m
21880,1,[JoK]Messer,2871,189,7,6,13,53.8%,57m
21880,3,Hulio,2871,120,5,5,10,50.0%,25m
21880,3,GLUK,2871,60,3,2,5,60.0%,2m
21880,3,AytugBerat,2871,30,2,0,2,100.0%,14m
21880,3,sickk,2871,58,2,1,3,66.7%,2m
21880,2,Schtibbi,2871,88,2,2,4,50.0%,25m
21880,3,Torino,2871,0,2,3,5,40.0%,7m
21880,1,[Какуля]FacTron,2871,46,2,5,7,28.6%,26m
21880,3,Thiamats,2871,0,1,0,1,100.0%,8m
21880,3,Armagedon,2871,0,1,0,1,100.0%,9m
21880,3,НачоNacho,2871,30,1,1,2,50.0%,3m
21880,3,[Antik]MahesVarra,2871,0,0,1,1,0.0%,10m
21880,3,[Nipps]SITTner,2871,0,0,1,1,0.0%,23m
21880,3,LowAF,2871,0,0,1,1,0.0%,16m
21880,3,George,2871,0,0,1,1,0.0%,24m
21912,1,Peter,2870,1601,302,306,608,49.7%,9m
21912,2,Mutax,2870,1492,65,58,123,52.8%,9m
21912,2,FiWe,2870,774,59,47,106,55.7%,11m
21912,2,Potato,2870,881,37,29,66,56.1%,24m
21912,2,buongfive,2870,988,34,43,77,44.2%,26m
21912,3,trucommander,2870,771,30,22,52,57.7%,14m
21912,2,LaMB,2870,568,21,24,45,46.7%,24m
21912,2,SpaceSwarm,2870,312,13,10,23,56.5%,14m
21912,2,Pinqui,2870,271,11,10,21,52.4%,8m
21912,2,[Aeria]FJHG,2870,299,10,9,19,52.6%,1h
21912,2,CNM,2870,163,8,5,13,61.5%,11m
21912,2,LimitLesS,2870,254,8,11,19,42.1%,14m
21912,3,GooDcAt,2870,214,7,2,9,77.8%,13m
21912,2,Voigas,2870,58,5,5,10,50.0%,23m
21912,1,Lupus,2870,48,4,4,8,50.0%,57m
21912,2,MetalStorm,2870,116,4,5,9,44.4%,26m
21912,2,SKIF,2870,167,4,8,12,33.3%,1h
21912,3,[BR0K1K]Gforce,2870,141,3,3,6,50.0%,2m
21912,3,[ASNII]Cohanes,2870,88,3,4,7,42.9%,22m
21912,3,Sesh,2870,58,3,4,7,42.9%,10m
21912,1,Zarakalus,2870,145,3,6,9,33.3%,52m
21912,2,Lollet,2870,88,3,7,10,30.0%,23m
21912,1,NPC,2870,93,2,0,2,100.0%,32m
21912,2,ALeXFeeD,2870,42,2,1,3,66.7%,1h
21912,3,iAmDrunk,2870,30,2,1,3,66.7%,8m
21912,2,FlexX,2870,128,2,6,8,25.0%,26m
21912,3,Darkzealot,2870,30,1,1,2,50.0%,2m
21912,1,Rodolfo,2870,48,1,3,4,25.0%,43m
21912,3,Myer,2870,0,0,1,1,0.0%,10m
21912,3,tamerampire,2870,0,0,1,1,0.0%,7m
21912,3,[FurRev]Bit,2870,0,0,1,1,0.0%,2m
21912,3,Festival,2870,0,0,1,1,0.0%,3m
21912,2,FaitNian,2870,0,0,2,2,0.0%,17m
21945,2,Tarjan,2869,1321,79,73,152,52.0%,14m
21945,3,MissQuiet,2869,1413,61,53,114,53.5%,2m
21945,2,MahaCarrier,2869,832,60,50,110,54.5%,8m
21945,3,nPoKyPaToP,2869,573,30,17,47,63.8%,10m
21945,3,Kara,2869,586,25,13,38,65.8%,22m
21945,3,Beliziano,2869,605,24,19,43,55.8%,4m
21945,2,[aTw]Ash,2869,465,23,11,34,67.6%,10m
21945,3,Hasenmeier,2869,512,20,23,43,46.5%,7m
21945,2,[BMNL]Kaas,2869,456,16,22,38,42.1%,25m
21945,3,BsKy,2869,407,14,15,29,48.3%,22m
21945,3,[CØG]bouclier,2869,298,10,5,15,66.7%,13m
21945,3,[TSmash]NERO,2869,231,10,9,19,52.6%,16m
21945,2,Sendo,2869,306,10,13,23,43.5%,4m
21945,2,[BEteam]Vandalenok,2869,178,9,9,18,50.0%,20m
21945,3,KTTK,2869,168,7,4,11,63.6%,22m
21945,1,Jacob,2869,152,6,10,16,37.5%,3m
21945,1,EvilTom,2869,129,5,1,6,83.3%,26m
21945,1,[nWss]abrodtgaard,2869,48,4,4,8,50.0%,30m
21945,3,Lime,2869,0,4,4,8,50.0%,45m
21945,3,Rahl,2869,86,3,3,6,50.0%,3m
21945,3,Strahu,2869,86,3,5,8,37.5%,9m
21945,2,charl,2869,58,3,7,10,30.0%,23m
21945,2,ZION,2869,0,2,0,2,100.0%,36m
21945,3,Necro,2869,30,1,1,2,50.0%,15m
21945,1,[mini7x]ZlayaGrusha,2869,0,1,1,2,50.0%,5m
21945,3,Babou,2869,0,1,2,3,33.3%,10m
21945,3,Life,2869,0,0,1,1,0.0%,22m
21945,2,SKip,2869,0,0,1,1,0.0%,47m
21945,3,Takeo,2869,0,0,2,2,0.0%,9m
21974,2,slin,2868,1418,75,73,148,50.7%,10m
21974,2,[SoSaGe]jorrrrris,2868,1112,74,66,140,52.9%,23m
21974,2,GoldenEye,2868,1137,58,48,106,54.7%,24m
21974,2,tymwal,2868,742,30,27,57,52.6%,12m
21974,3,ARTANIS,2868,683,27,24,51,52.9%,8m
21974,3,MrOuille,2868,634,25,22,47,53.2%,3m
21974,3,UmadBro,2868,652,24,22,46,52.2%,14m
21974,2,achil,2868,411,21,23,44,47.7%,14m
21974,2,RedJohn,2868,492,18,21,39,46.2%,3m
21974,3,[298K]Barsik,2868,314,17,6,23,73.9%,26m
21974,2,Steve,2868,232,17,15,32,53.1%,17m
21974,2,Astmin,2868,404,17,16,33,51.5%,8m
21974,2,[SoloGG]SCDUDE,2868,317,11,12,23,47.8%,5m
21974,3,[1NFEC7]GANMU,2868,144,6,7,13,46.2%,9m
21974,3,[CNC3]CTpayC,2868,172,6,7,13,46.2%,12m
21974,2,JacPetrelli,2868,212,6,10,16,37.5%,9m
21974,2,äLgRemslem,2868,146,6,11,17,35.3%,4m
21974,3,FrostyDog,2868,92,5,1,6,83.3%,2m
21974,2,Sescenarius,2868,148,5,9,14,35.7%,8m
21974,3,[guilla]Psychonaut,2868,86,3,3,6,50.0%,15m
21974,2,Hobson,2868,0,2,3,5,40.0%,18m
21974,2,maskal,2868,107,2,4,6,33.3%,23m
21974,1,[WITCHs]DarkCCII,2868,0,2,6,8,25.0%,23m
21974,3,MrNoseman,2868,30,1,1,2,50.0%,17m
21974,3,Krispe,2868,0,0,1,1,0.0%,2m
21999,2,EmptySPACE,2867,1545,110,92,202,54.5%,14m
21999,2,cleaner,2867,763,100,89,189,52.9%,24m
21999,2,Gloom,2867,1277,90,76,166,54.2%,6m
21999,1,Alex,2867,1128,66,65,131,50.4%,9m
21999,3,Fenrir,2867,1174,43,43,86,50.0%,3m
21999,3,[SC2T4K]Porcinerate,2867,553,32,14,46,69.6%,4m
21999,3,Yanaz,2867,439,28,20,48,58.3%,16m
21999,2,cocico,2867,296,26,20,46,56.5%,17m
21999,3,HelloThere,2867,673,26,24,50,52.0%,11m
21999,2,Kielnia,2867,666,25,32,57,43.9%,11m
21999,3,Tim,2867,453,22,17,39,56.4%,2m
21999,2,kastell,2867,494,20,21,41,48.8%,3m
21999,2,Gereay,2867,407,18,12,30,60.0%,15m
21999,2,Babel,2867,516,18,22,40,45.0%,25m
21999,2,Bozzy,2867,452,17,14,31,54.8%,9m
21999,3,ElSe,2867,326,13,5,18,72.2%,11m
21999,2,DiVeR,2867,239,11,10,21,52.4%,8m
21999,2,Rene,2867,330,11,17,28,39.3%,25m
21999,3,Ellumination,2867,218,7,3,10,70.0%,23m
21999,3,Yamato,2867,167,7,5,12,58.3%,2m
21999,3,HaXiiT,2867,178,7,7,14,50.0%,2m
21999,1,VeNoNyK,2867,144,6,6,12,50.0%,39m
21999,3,Eshko,2867,142,5,5,10,50.0%,3m
21999,3,[15ANS]TikiBoom,2867,140,4,9,13,30.8%,5m
21999,2,Staysindark,2867,145,3,2,5,60.0%,48m
21999,3,Sky,2867,60,3,2,5,60.0%,8m
21999,3,[TDraC]PascalHero,2867,86,3,3,6,50.0%,16m
21999,2,djaba,2867,0,2,3,5,40.0%,56m
21999,2,[ZЕRGТV]heave,2867,60,2,8,10,20.0%,8m
21999,1,Verith,2867,0,1,0,1,100.0%,45m
21999,2,Gotik,2867,90,1,1,2,50.0%,20m
21999,3,[tofury]TollerName,2867,30,1,1,2,50.0%,15m
21999,3,Kimi,2867,42,1,3,4,25.0%,22m
21999,2,Kiocyden,2867,0,0,1,1,0.0%,38m
21999,3,DEvilGamer,2867,0,0,1,1,0.0%,2m
21999,3,[UAŦeam]DerI,2867,0,0,1,1,0.0%,48m
22035,1,Lostconos,2866,1592,362,362,724,50.0%,11m
22035,2,Kelt,2866,1463,169,151,320,52.8%,9m
22035,2,Torres,2866,1241,146,147,293,49.8%,7m
22035,2,Kreparinder,2866,1012,95,73,168,56.5%,2m
22035,2,BananKage,2866,831,72,64,136,52.9%,9m
22035,3,XantiXae,2866,881,65,50,115,56.5%,8m
22035,1,Dragonio,2866,742,65,68,133,48.9%,7m
22035,2,Amadeus,2866,844,61,59,120,50.8%,9m
22035,2,GameChanger,2866,999,58,45,103,56.3%,2m
22035,2,Torus,2866,394,40,37,77,51.9%,11m
22035,2,[Petrus]ZWAttitude,2866,779,36,26,62,58.1%,24m
22035,2,[S29]Sava,2866,962,36,40,76,47.4%,9m
22035,2,HankSolo,2866,722,29,24,53,54.7%,8m
22035,3,Executor,2866,388,16,6,22,72.7%,6m
22035,3,Сергей,2866,364,16,19,35,45.7%,6m
22035,2,[HSofS]Xeo,2866,316,14,11,25,56.0%,26m
22035,2,Zephyr,2866,364,13,17,30,43.3%,3m
22035,1,GrumpyPants,2866,171,8,7,15,53.3%,24m
22035,3,[RanMon]Sensei,2866,198,8,8,16,50.0%,35m
22035,3,[fam1ly]PapaCountry,2866,228,8,10,18,44.4%,23m
22035,3,lxndryng,2866,168,7,3,10,70.0%,5m
22035,2,[xBaTx]Frenzen,2866,209,7,8,15,46.7%,1h
22035,3,[1FU2]Jaga,2866,189,5,2,7,71.4%,7m
22035,1,[PNKS]RedTankist,2866,48,5,3,8,62.5%,59m
22035,1,Ixido,2866,193,5,7,12,41.7%,5m
22035,2,RoManHD,2866,120,3,4,7,42.9%,4m
22035,3,Defailer,2866,66,3,4,7,42.9%,9m
22035,3,tronictoast,2866,60,2,2,4,50.0%,12m
22035,3,[LSE]Mika,2866,0,1,0,1,100.0%,8m
22035,3,[RPZm]Tarsonis,2866,0,1,0,1,100.0%,46m
22035,3,[rosen]rosensuppe,2866,30,1,2,3,33.3%,24m
22035,1,ShuTz,2866,97,1,2,3,33.3%,48m
22035,2,dark,2866,0,1,2,3,33.3%,17m
22035,2,[H0DEN]StahlKraft,2866,48,1,5,6,16.7%,18m
22035,3,Дмитрич,2866,0,0,1,1,0.0%,2m
22035,2,[BITEME]Adoro,2866,0,0,1,1,0.0%,16m
22035,3,Shino,2866,0,0,1,1,0.0%,24m
22035,3,labuse,2866,0,0,3,3,0.0%,17m
22035,3,[MynFre]Panzerbille,2866,0,0,4,4,0.0%,15m
22074,1,[voodtr]Vincent,2865,1613,409,394,803,50.9%,5m
22074,2,scaR,2865,1512,108,106,214,50.5%,11m
22074,3,Yolandi,2865,730,100,74,174,57.5%,22m
22074,2,[Bro007]Lightning,2865,1506,77,79,156,49.4%,9m
22074,2,Emeraude,2865,1185,75,54,129,58.1%,15m
22074,2,FREEMAN,2865,1144,68,65,133,51.1%,14m
22074,3,Bamse,2865,889,45,40,85,52.9%,2m
22074,2,[MeMi]Wolfman,2865,944,39,37,76,51.3%,9m
22074,3,Kryger,2865,453,18,18,36,50.0%,16m
22074,2,[2DMIP]VacGodd,2865,375,14,13,27,51.9%,3m
22074,3,CoreX,2865,304,11,7,18,61.1%,4m
22074,2,Hypno,2865,241,10,8,18,55.6%,4m
22074,3,Hubble,2865,253,9,7,16,56.2%,27m
22074,3,[MIRAJ]SemoSepheron,2865,174,7,5,12,58.3%,22m
22074,1,AKaPULKO,2865,202,6,10,16,37.5%,8m
22074,3,senpaiii,2865,97,2,0,2,100.0%,7m
22074,3,Marat,2865,118,2,1,3,66.7%,16m
22074,3,[UF2AC]Rick,2865,30,2,2,4,50.0%,2m
22074,2,Luciferka,2865,0,2,3,5,40.0%,1h
22074,3,TrashPasser,2865,0,1,1,2,50.0%,5m
22074,3,Ironside,2865,0,1,2,3,33.3%,26m
22074,3,Nattvasen,2865,0,1,2,3,33.3%,23m
22074,1,[3ЕRGTV]asfW,2865,0,0,1,1,0.0%,1h
22097,2,fixye,2864,143,45,49,94,47.9%,4m
22097,1,HisashiBuri,2864,1090,38,50,88,43.2%,22m
22097,1,[vedV]Piffe,2864,323,13,10,23,56.5%,1h
22097,2,Massive,2864,220,9,12,21,42.9%,20m
22097,1,cactusmutant,2864,191,6,5,11,54.5%,24m
22097,3,knifish,2864,128,6,5,11,54.5%,19m
22097,3,Nosey,2864,150,5,8,13,38.5%,9m
22097,1,kilouck,2864,97,4,3,7,57.1%,27m
22097,3,infernaltee,2864,0,3,2,5,60.0%,22m
22097,3,[GGxC]Methos,2864,58,3,3,6,50.0%,9m
22097,2,[OvdM]Vekijem,2864,140,3,3,6,50.0%,8m
22097,2,ThËÐÛÐÈ,2864,134,3,4,7,42.9%,41m
22097,3,[H8D8R]Arthas,2864,30,2,0,2,100.0%,16m
22097,3,Snowball,2864,30,2,3,5,40.0%,11m
22097,2,MrRomich,2864,0,2,3,5,40.0%,1h
22097,3,[c0vri]Shanis,2864,58,2,5,7,28.6%,9m
22097,3,Displeased,2864,0,1,0,1,100.0%,3m
22097,3,Froke,2864,0,1,0,1,100.0%,8m
22097,3,MetodiK,2864,0,1,0,1,100.0%,7m
22097,3,llllll,2864,0,1,0,1,100.0%,17m
22097,3,WorstZergEU,2864,0,1,2,3,33.3%,3m
22097,3,[WzD]CFAJAuPOLSKA,2864,30,1,3,4,25.0%,6m
22097,2,[MMGB]Yannihilate,2864,0,1,3,4,25.0%,13m
22097,3,shentei,2864,0,0,1,1,0.0%,23m
22097,3,Maru,2864,0,0,1,1,0.0%,7m
22097,3,Hulumulut,2864,0,0,2,2,0.0%,3m
22123,2,Nesis,2863,1064,73,70,143,51.0%,11m
22123,2,[Няшкa]HardCode,2863,1249,67,63,130,51.5%,14m
22123,1,hrumin,2863,1185,45,51,96,46.9%,7m
22123,3,Bombenregen,2863,647,27,21,48,56.2%,3m
22123,2,Deschain,2863,393,16,15,31,51.6%,9m
22123,2,TotallyAGirl,2863,416,15,13,28,53.6%,8m
22123,3,Pfifferling,2863,314,12,11,23,52.2%,14m
22123,2,[FZoG]kompani,2863,271,11,10,21,52.4%,2m
22123,3,[oooo89]TheCiuLi,2863,338,11,11,22,50.0%,4m
22123,2,Gecko,2863,249,10,9,19,52.6%,34m
22123,1,Salem,2863,259,8,6,14,57.1%,47m
22123,3,LoneSurvivor,2863,206,7,8,15,46.7%,11m
22123,2,NautiLus,2863,192,7,11,18,38.9%,7m
22123,1,Deathlike,2863,145,6,5,11,54.5%,45m
22123,3,buggang,2863,86,5,5,10,50.0%,9m
22123,3,Ilushka,2863,107,4,3,7,57.1%,14m
22123,2,Illusion,2863,116,4,10,14,28.6%,4m
22123,3,[FreeN]LiiE,2863,58,3,2,5,60.0%,23m
22123,3,[PowOw]Spot,2863,30,2,3,5,40.0%,17m
22123,2,MasterChief,2863,48,2,5,7,28.6%,59m
22123,3,BicheRobot,2863,0,1,1,2,50.0%,3m
22123,2,NapSter,2863,0,0,1,1,0.0%,1h
22123,3,VanaTallinn,2863,0,0,1,1,0.0%,7m
22123,3,[SРID]ПеЧеНьКа,2863,0,0,1,1,0.0%,24m
22123,3,NumerusDuo,2863,0,0,1,1,0.0%,10m
22123,3,arodger,2863,0,0,1,1,0.0%,9m
22123,1,losick,2863,0,0,3,3,0.0%,24m
22150,1,Makina,2862,1579,226,212,438,51.6%,8m
22150,2,CoolName,2862,1010,96,89,185,51.9%,11m
22150,3,neo,2862,965,91,83,174,52.3%,10m
22150,1,[WАSD]SimulacraTos,2862,1562,80,55,135,59.3%,12m
22150,1,Sateri,2862,720,36,38,74,48.6%,16m
22150,3,[DDaD]Ziemek,2862,660,31,16,47,66.0%,8m
22150,3,[D0N3]AndyJT,2862,558,20,20,40,50.0%,5m
22150,3,Alexius,2862,238,19,17,36,52.8%,11m
22150,3,nanibaul,2862,383,16,10,26,61.5%,6m
22150,2,radu,2862,226,15,21,36,41.7%,12m
22150,2,Alekskusn,2862,456,15,25,40,37.5%,6m
22150,2,Bigor,2862,266,10,17,27,37.0%,9m
22150,3,[ƤrG]Nostex,2862,216,9,6,15,60.0%,42m
22150,1,дима,2862,307,8,6,14,57.1%,6m
22150,3,AmazingZerG,2862,170,7,6,13,53.8%,49m
22150,2,blpblrBa,2862,141,5,2,7,71.4%,39m
22150,2,DamSyKo,2862,168,5,7,12,41.7%,24m
22150,2,Sebastian,2862,177,5,8,13,38.5%,9m
22150,1,JDVDS,2862,48,4,4,8,50.0%,47m
22150,1,Pablo,2862,0,3,3,6,50.0%,1h
22150,2,Hanurik,2862,0,2,3,5,40.0%,1h
22150,2,Hunter,2862,30,2,4,6,33.3%,8m
22150,3,unknown,2862,0,1,0,1,100.0%,8m
22150,3,Dovahkiin,2862,30,1,1,2,50.0%,17m
22150,2,ELGames,2862,38,1,2,3,33.3%,1h
22150,3,[RSPCT]Ariken,2862,30,1,3,4,25.0%,9m
22150,2,FuNdaMentaL,2862,30,1,6,7,14.3%,25m
22150,3,Slavik,2862,0,0,1,1,0.0%,4m
22150,3,Senuohoj,2862,0,0,2,2,0.0%,16m
22150,3,Tznon,2862,0,0,2,2,0.0%,13m
22180,3,COVIDX,2861,1618,336,318,654,51.4%,13m
22180,2,LaBoilezer,2861,1561,146,135,281,52.0%,11m
22180,3,Gorbach,2861,1026,77,73,150,51.3%,24m
22180,3,[ZUBS]RAIDAGE,2861,1072,73,67,140,52.1%,17m
22180,3,vladimir,2861,1147,50,36,86,58.1%,5m
22180,2,GoodMan,2861,662,26,27,53,49.1%,5m
22180,3,[MLSK]Hydra,2861,172,24,8,32,75.0%,8m
22180,2,Zaslot,2861,429,22,16,38,57.9%,14m
22180,3,kensai,2861,543,22,17,39,56.4%,5m
22180,2,AXELing,2861,562,21,23,44,47.7%,3m
22180,3,Bullseye,2861,417,18,17,35,51.4%,16m
22180,3,puffin,2861,248,16,10,26,61.5%,26m
22180,2,GonoRReaHP,2861,358,16,10,26,61.5%,9m
22180,3,Ballzdeep,2861,358,14,10,24,58.3%,23m
22180,2,ZadkieL,2861,414,14,18,32,43.8%,25m
22180,3,Veas,2861,291,11,9,20,55.0%,23m
22180,3,Psy,2861,290,11,9,20,55.0%,2m
22180,2,Supernova,2861,198,10,9,19,52.6%,11m
22180,1,[Jdge]Hellkid,2861,96,7,4,11,63.6%,48m
22180,3,Marth,2861,188,6,3,9,66.7%,9m
22180,3,Màmàdou,2861,147,6,4,10,60.0%,8m
22180,2,Vojtesla,2861,114,5,4,9,55.6%,24m
22180,3,Shiki,2861,0,4,1,5,80.0%,22m
22180,3,[NHX]Aureliol,2861,0,3,2,5,60.0%,16m
22180,1,LadyThatcher,2861,0,3,3,6,50.0%,29m
22180,3,enesercin,2861,62,2,6,8,25.0%,24m
22180,1,Bendix,2861,0,1,1,2,50.0%,5m
22180,3,Fntxy,2861,0,1,3,4,25.0%,11m
22180,2,ArQoNyqn,2861,88,1,4,5,20.0%,12m
22180,3,Gall,2861,0,0,1,1,0.0%,4m
22180,3,elbodenbob,2861,0,0,1,1,0.0%,3m
22180,3,albertsigp,2861,0,0,1,1,0.0%,23m
22180,1,kla,2861,0,0,2,2,0.0%,53m
22213,2,Mouah,2860,796,215,205,420,51.2%,26m
22213,3,[Still]MrMagOo,2860,438,25,24,49,51.0%,24m
22213,2,MATEUSZ,2860,459,17,17,34,50.0%,6m
22213,3,FrozenSw,2860,336,13,14,27,48.1%,13m
22213,3,[сSсǃ]KailoR,2860,284,10,6,16,62.5%,12m
22213,3,MacroJordan,2860,202,8,7,15,53.3%,2m
22213,3,HuntGuy,2860,174,7,5,12,58.3%,17m
22213,3,buffedCookie,2860,192,7,7,14,50.0%,1h
22213,3,Texxirloaded,2860,145,6,2,8,75.0%,9m
22213,3,Tobulus,2860,166,4,1,5,80.0%,5m
22213,3,Nikos,2860,0,4,4,8,50.0%,32m
22213,1,Zet,2860,48,4,4,8,50.0%,19m
22213,3,Frættestær,2860,68,4,5,9,44.4%,2m
22213,3,McFlurry,2860,120,4,7,11,36.4%,23m
22213,1,[PTTian]PouetPouet,2860,139,3,5,8,37.5%,29m
22213,1,[Töff]Darkkolombo,2860,48,2,1,3,66.7%,18m
22213,1,IronsideRIAW,2860,97,2,1,3,66.7%,48m
22213,3,Gubi,2860,0,1,0,1,100.0%,25m
22213,3,Sjuka,2860,0,1,0,1,100.0%,8m
22213,3,[Aмун]MrHeadless,2860,0,1,1,2,50.0%,16m
22213,3,[Noirea]Didouda,2860,30,1,3,4,25.0%,23m
22213,3,ZIOMKRIS,2860,30,1,3,4,25.0%,16m
22213,3,[1stGG]MiKa,2860,0,0,3,3,0.0%,5m
22236,3,Bzzzik,2859,869,34,28,62,54.8%,6m
22236,3,[WhPd]FunkeyMonkey,2859,697,29,26,55,52.7%,12m
22236,3,WINDERR,2859,477,22,9,31,71.0%,5m
22236,3,InWin,2859,536,19,16,35,54.3%,17m
22236,3,Skrippel,2859,336,13,12,25,52.0%,9m
22236,3,Anders,2859,331,12,7,19,63.2%,9m
22236,2,NLBTW,2859,278,11,14,25,44.0%,7m
22236,2,[AsAu]William,2859,202,8,13,21,38.1%,25m
22236,2,rozimbabwe,2859,218,7,9,16,43.8%,8m
22236,3,Bug,2859,107,5,8,13,38.5%,16m
22236,3,CornBread,2859,90,4,5,9,44.4%,4m
22236,3,[4or5t]pWaHn,2859,0,3,2,5,60.0%,12m
22236,3,[1KMP1]Molochko,2859,60,2,2,4,50.0%,23m
22236,3,Grayn,2859,30,2,2,4,50.0%,6m
22236,2,[SMCrew]mAus,2859,0,1,1,2,50.0%,11m
22236,3,[OSB]Pilpaul,2859,0,1,1,2,50.0%,16m
22236,3,Jleks,2859,0,1,1,2,50.0%,2m
22236,1,idontknow,2859,0,1,2,3,33.3%,48m
22236,3,haallooo,2859,0,1,3,4,25.0%,5m
22236,3,NorthIDS,2859,0,0,1,1,0.0%,22m
22236,3,[Abs]Zelfurax,2859,0,0,3,3,0.0%,11m
22236,3,ghost,2859,0,0,4,4,0.0%,22m
22236,3,III,2859,0,0,4,4,0.0%,16m
22259,2,Feligion,2858,1516,233,208,441,52.8%,8m
22259,2,Koblenz,2858,1598,126,127,253,49.8%,4m
22259,2,Tangidor,2858,1375,87,82,169,51.5%,17m
22259,3,Martir,2858,1470,61,61,122,50.0%,26m
22259,3,bibu,2858,412,20,12,32,62.5%,23m
22259,2,anarchy,2858,542,19,27,46,41.3%,23m
22259,3,[gG7]MrPMC,2858,443,17,12,29,58.6%,12m
22259,2,stranger,2858,271,13,8,21,61.9%,37m
22259,3,fooliodoolio,2858,293,12,11,23,52.2%,15m
22259,1,KAMIL,2858,226,10,10,20,50.0%,7m
22259,3,Rekin,2858,259,9,5,14,64.3%,47m
22259,3,PrinceAli,2858,170,7,5,12,58.3%,11m
22259,3,flex,2858,208,7,10,17,41.2%,16m
22259,3,ellnick,2858,193,6,3,9,66.7%,9m
22259,3,JoCER,2858,198,6,3,9,66.7%,9m
22259,3,Krisinox,2858,165,4,3,7,57.1%,4m
22259,2,TimelessOne,2858,122,4,10,14,28.6%,9m
22259,1,Vetaput,2858,133,3,3,6,50.0%,39m
22259,2,Terraniser,2858,0,3,4,7,42.9%,24m
22259,3,[Sja]SjaSja,2858,0,2,3,5,40.0%,11m
22259,2,Wiewiór,2858,0,2,4,6,33.3%,5m
22259,2,Cerberus,2858,115,2,4,6,33.3%,52m
22259,3,[DLOK]Deadly,2858,0,1,0,1,100.0%,10m
22259,3,kesstarwars,2858,0,1,0,1,100.0%,4m
22259,3,MrCrackFox,2858,0,1,1,2,50.0%,17m
22259,3,[HBGSJR]aDago,2858,30,1,1,2,50.0%,9m
22259,3,GoGotz,2858,0,0,1,1,0.0%,16m
22259,3,[ZERGTB]Lost,2858,0,0,1,1,0.0%,6m
22259,3,AnungUnRama,2858,0,0,2,2,0.0%,2m
22288,2,Arlienne,2857,897,129,115,244,52.9%,12m
22288,2,SBSxTamerlap,2857,1228,48,45,93,51.6%,14m
22288,2,Hoody,2857,782,28,34,62,45.2%,9m
22288,1,Van,2857,523,20,24,44,45.5%,10m
22288,2,[сSсǃ]ToxicTerran,2857,471,17,17,34,50.0%,12m
22288,2,[Giraff]Tonza,2857,162,14,13,27,51.9%,4m
22288,2,Lilli,2857,349,13,8,21,61.9%,19m
22288,2,Ganjaman,2857,351,12,15,27,44.4%,8m
22288,3,DayMan,2857,198,8,6,14,57.1%,34m
22288,2,[HGeezy]Claudio,2857,154,7,8,15,46.7%,23m
22288,1,MrPako,2857,145,6,3,9,66.7%,5m
22288,3,czajna,2857,162,5,8,13,38.5%,13m
22288,3,Blinchik,2857,142,4,0,4,100.0%,3m
22288,2,Skallek,2857,30,4,4,8,50.0%,2m
22288,3,Марат,2857,30,2,0,2,100.0%,16m
22288,3,CromONE,2857,30,2,2,4,50.0%,3m
22288,3,Sukaldi,2857,0,1,0,1,100.0%,6m
22288,3,[FoKt]Snytem,2857,0,0,1,1,0.0%,4m
22288,3,[РосИмп]Wek,2857,0,0,1,1,0.0%,3m
22288,3,pablitoahah,2857,0,0,1,1,0.0%,17m
22288,3,Baffreux,2857,0,0,2,2,0.0%,2m
22288,3,fuzzyd,2857,0,0,4,4,0.0%,5m
22310,2,Laczwit,2856,1577,380,361,741,51.3%,2m
22310,2,Victor,2856,1541,360,399,759,47.4%,11m
22310,2,Brooder,2856,722,87,68,155,56.1%,10m
22310,3,kjam,2856,1410,70,47,117,59.8%,11m
22310,3,BatPanda,2856,1293,56,38,94,59.6%,12m
22310,3,Spider,2856,602,26,23,49,53.1%,3m
22310,2,[Magnus]Batman,2856,274,11,9,20,55.0%,33m
22310,3,Auslander,2856,243,9,4,13,69.2%,14m
22310,3,FtA,2856,184,8,6,14,57.1%,8m
22310,3,NATO,2856,199,8,6,14,57.1%,17m
22310,2,CARTMAN,2856,172,7,10,17,41.2%,23m
22310,2,OWGrant,2856,178,6,14,20,30.0%,2m
22310,1,[Patata]RollWhisTler,2856,191,5,4,9,55.6%,34m
22310,3,bababbababab,2856,188,5,4,9,55.6%,5m
22310,3,Munk,2856,86,4,3,7,57.1%,17m
22310,2,NONONONOPLS,2856,165,4,4,8,50.0%,20m
22310,3,jolliam,2856,114,4,5,9,44.4%,9m
22310,3,[TAPG]Saphierus,2856,0,2,2,4,50.0%,3m
22310,2,Shadowkiller,2856,0,2,2,4,50.0%,24m
22310,3,[GlNYU]frenzy,2856,30,2,4,6,33.3%,2m
22310,3,tuetenfrog,2856,0,1,0,1,100.0%,4m
22310,2,Falric,2856,42,1,3,4,25.0%,49m
22310,3,shØut,2856,0,0,1,1,0.0%,17m
22333,3,[lVI]Masak,2855,1531,151,159,310,48.7%,22m
22333,2,LeZoru,2855,1208,145,133,278,52.2%,24m
22333,2,Shirini,2855,1537,134,117,251,53.4%,11m
22333,2,Rico,2855,1575,110,104,214,51.4%,8m
22333,1,Protox,2855,1409,56,62,118,47.5%,8m
22333,3,Bond,2855,1160,51,29,80,63.8%,15m
22333,3,Yougloups,2855,1198,49,35,84,58.3%,3m
22333,2,AhAr,2855,606,26,26,52,50.0%,7m
22333,3,pinats,2855,581,22,17,39,56.4%,16m
22333,3,Milord,2855,330,14,13,27,51.9%,16m
22333,2,KDE,2855,372,14,19,33,42.4%,11m
22333,2,Fingolfin,2855,368,13,12,25,52.0%,14m
22333,1,nemixas,2855,230,13,12,25,52.0%,46m
22333,3,[ExTr1m]ИгорьОК,2855,255,10,3,13,76.9%,14m
22333,2,Shiba,2855,188,10,8,18,55.6%,14m
22333,3,GeileJenny,2855,252,10,8,18,55.6%,15m
22333,2,[AA36]GoLLum,2855,139,9,7,16,56.2%,1h
22333,3,DENDY,2855,205,8,9,17,47.1%,38m
22333,2,MARCO,2855,171,7,6,13,53.8%,5m
22333,2,sssBARONsss,2855,152,7,10,17,41.2%,11m
22333,3,rabbied,2855,58,5,3,8,62.5%,4m
22333,2,AlexFrost,2855,60,5,5,10,50.0%,2m
22333,1,Blaxelace,2855,145,5,5,10,50.0%,21m
22333,2,[eseeHC]Royalwinner,2855,118,5,7,12,41.7%,12m
22333,3,FishNett,2855,90,4,3,7,57.1%,4m
22333,3,Barahlush,2855,168,4,4,8,50.0%,48m
22333,2,mrzdrva,2855,48,3,3,6,50.0%,1h
22333,1,Bene,2855,30,3,5,8,37.5%,8m
22333,3,artanis,2855,150,3,6,9,33.3%,8m
22333,3,death,2855,58,2,1,3,66.7%,16m
22333,2,[bumsen]aimeric,2855,102,2,5,7,28.6%,17m
22333,3,[FHANU]Avokk,2855,0,1,1,2,50.0%,24m
22333,3,Palmarin,2855,0,1,1,2,50.0%,39m
22333,3,[BBCTV]BigBear,2855,30,1,2,3,33.3%,9m
22333,2,LDLCǂNails,2855,0,0,1,1,0.0%,16m
22333,3,Glitch,2855,0,0,1,1,0.0%,5m
22369,2,brigadis,2854,1581,206,182,388,53.1%,14m
22369,2,IISCorpionII,2854,1284,133,126,259,51.4%,25m
22369,3,boogeyman,2854,1602,111,76,187,59.4%,17m
22369,2,Carlson,2854,1200,51,48,99,51.5%,14m
22369,2,FilthyCasual,2854,744,34,33,67,50.7%,9m
22369,3,Majooo,2854,785,29,25,54,53.7%,10m
22369,2,FrankyBip,2854,678,28,29,57,49.1%,5m
22369,2,Maxprime,2854,568,20,26,46,43.5%,14m
22369,2,VaasKasich,2854,351,16,16,32,50.0%,23m
22369,2,pulzarrr,2854,430,16,24,40,40.0%,4m
22369,2,SuffinS,2854,323,15,14,29,51.7%,11m
22369,3,peerless,2854,355,14,11,25,56.0%,22m
22369,1,Superman,2854,333,13,11,24,54.2%,18m
22369,3,SeDiva,2854,291,11,4,15,73.3%,24m
22369,2,EllGx,2854,244,10,10,20,50.0%,11m
22369,2,JoSeTe,2854,256,9,11,20,45.0%,11m
22369,3,[Ecoli]Dreon,2854,198,7,2,9,77.8%,3m
22369,3,Schutz,2854,90,4,3,7,57.1%,2m
22369,3,Vengeanse,2854,0,3,2,5,60.0%,2m
22369,2,Caribou,2854,0,3,3,6,50.0%,9m
22369,1,iLLbeFreakY,2854,0,1,0,1,100.0%,6m
22369,3,Fraaan,2854,0,1,0,1,100.0%,17m
22369,2,Vegaa,2854,0,1,1,2,50.0%,46m
22369,3,Givotnoe,2854,30,1,1,2,50.0%,23m
22369,1,DarkProbe,2854,0,1,1,2,50.0%,1h
22369,3,[clan25]ITSFabi,2854,30,1,2,3,33.3%,25m
22369,2,[7HeLLs]FLuFyZerGLin,2854,0,1,4,5,20.0%,8m
22369,3,GiedTetis,2854,0,0,1,1,0.0%,8m
22369,3,Terran,2854,0,0,1,1,0.0%,7m
22398,3,Zenlike,2853,1602,663,633,1296,51.2%,22m
22398,3,Придурок,2853,1552,319,338,657,48.6%,10m
22398,2,AngelaZergel,2853,1235,72,75,147,49.0%,11m
22398,3,Bababoiu,2853,874,63,51,114,55.3%,13m
22398,2,Vrikkie,2853,903,45,43,88,51.1%,9m
22398,3,HEETS,2853,852,35,33,68,51.5%,2m
22398,2,AntonGosu,2853,750,34,29,63,54.0%,23m
22398,3,Zyndro,2853,324,17,12,29,58.6%,11m
22398,1,[Dz1ady]Thomlyn,2853,339,15,20,35,42.9%,26m
22398,2,Serghei,2853,399,13,7,20,65.0%,59m
22398,2,Kvothe,2853,374,13,9,22,59.1%,38m
22398,3,RONiMO,2853,214,13,16,29,44.8%,17m
22398,2,denucqweqwe,2853,313,13,19,32,40.6%,9m
22398,3,CptGnorp,2853,344,11,9,20,55.0%,14m
22398,2,Kenetiz,2853,245,8,7,15,53.3%,2m
22398,3,NTesla,2853,86,3,2,5,60.0%,15m
22398,2,TMTC,2853,0,3,3,6,50.0%,11m
22398,1,Terradani,2853,48,2,1,3,66.7%,52m
22398,3,Keeer,2853,30,2,2,4,50.0%,16m
22398,3,MorningLight,2853,0,1,0,1,100.0%,23m
22398,1,Memelephant,2853,0,1,0,1,100.0%,29m
22398,2,KrepkaRepka,2853,0,1,0,1,100.0%,54m
22398,3,Hannibal,2853,30,1,1,2,50.0%,5m
22398,3,ColT,2853,0,1,1,2,50.0%,25m
22398,3,CryJka,2853,94,1,1,2,50.0%,23m
22398,1,[rNboow]rNbOlicornjr,2853,46,1,3,4,25.0%,1h
22398,3,[Tuning]Larsson,2853,0,0,1,1,0.0%,12m
22398,3,bboOOobs,2853,0,0,1,1,0.0%,3m
22426,2,Imo,2852,1431,319,295,614,52.0%,12m
22426,2,Dancore,2852,1068,122,109,231,52.8%,26m
22426,3,PshPshKfskya,2852,1655,114,88,202,56.4%,13m
22426,3,Bykbek,2852,1305,81,69,150,54.0%,12m
22426,3,LordW,2852,1412,80,83,163,49.1%,8m
22426,2,naid,2852,1014,62,56,118,52.5%,24m
22426,1,roschpatoits,2852,568,22,25,47,46.8%,11m
22426,1,everystone,2852,326,12,13,25,48.0%,30m
22426,2,iionochka,2852,234,11,12,23,47.8%,1h
22426,1,RimmJob,2852,205,8,0,8,100.0%,51m
22426,2,Чайковский,2852,142,5,3,8,62.5%,47m
22426,3,Lex,2852,157,4,1,5,80.0%,9m
22426,3,Finishco,2852,109,4,3,7,57.1%,17m
22426,3,[Zguege]Quentinous,2852,58,3,2,5,60.0%,9m
22426,3,Stringer,2852,0,3,3,6,50.0%,8m
22426,2,Buga,2852,0,3,3,6,50.0%,2m
22426,3,MisteR,2852,94,2,0,2,100.0%,11m
22426,2,[Admral]DimonZero,2852,88,2,2,4,50.0%,8m
22426,3,semyon,2852,60,2,6,8,25.0%,11m
22426,2,[BV]nikishok,2852,58,2,8,10,20.0%,23m
22426,3,ФОЛСАД,2852,0,1,0,1,100.0%,24m
22426,2,nnn,2852,0,1,0,1,100.0%,1h
22426,3,PrideDaniel,2852,0,1,1,2,50.0%,16m
22426,2,Jack,2852,30,1,6,7,14.3%,6m
22426,3,[OPAF]Poliam,2852,0,0,1,1,0.0%,16m
22426,1,Funkyshift,2852,0,0,1,1,0.0%,52m
22426,3,[WWP]ATozz,2852,0,0,2,2,0.0%,2m
22453,3,Minhou,2851,1609,107,98,205,52.2%,8m
22453,2,Deje,2851,852,103,82,185,55.7%,25m
22453,3,Hornet,2851,1148,65,38,103,63.1%,2m
22453,3,Incatime,2851,330,52,35,87,59.8%,14m
22453,3,Followup,2851,504,40,34,74,54.1%,3m
22453,3,AweNaaiers,2851,390,30,28,58,51.7%,16m
22453,2,[A0P]Tanatheld,2851,701,27,26,53,50.9%,14m
22453,2,Klops,2851,750,26,30,56,46.4%,3m
22453,2,Kokusz,2851,676,25,28,53,47.2%,9m
22453,2,Reutlinger,2851,627,25,30,55,45.5%,8m
22453,3,Fesser,2851,491,21,10,31,67.7%,8m
22453,3,Deathmot,2851,436,17,15,32,53.1%,8m
22453,3,Refraim,2851,414,16,8,24,66.7%,8m
22453,3,RaijinOX,2851,426,16,12,28,57.1%,8m
22453,3,Nutcracker,2851,323,14,14,28,50.0%,11m
22453,3,[A1E]BinGe,2851,398,12,14,26,46.2%,7m
22453,3,DarkBerkut,2851,262,10,2,12,83.3%,25m
22453,2,XDwarningXD,2851,213,9,9,18,50.0%,20m
22453,2,Drun,2851,117,8,8,16,50.0%,9m
22453,3,[aBrain]LETRiX,2851,202,7,8,15,46.7%,14m
22453,3,[byghuf]louos,2851,140,6,3,9,66.7%,8m
22453,2,Opapay,2851,140,5,6,11,45.5%,26m
22453,2,[Føcus]Sørøle,2851,30,4,4,8,50.0%,12m
22453,2,Yazon,2851,116,4,10,14,28.6%,8m
22453,3,[Hitech]satrap,2851,58,3,5,8,37.5%,9m
22453,3,RuskiEugene,2851,30,2,0,2,100.0%,12m
22453,3,SaltyBot,2851,30,2,1,3,66.7%,8m
22453,3,Sanya,2851,118,2,1,3,66.7%,4m
22453,3,Zerg,2851,115,2,2,4,50.0%,8m
22453,2,[UNM]PaiN,2851,0,2,3,5,40.0%,58m
22453,2,Zefaka,2851,32,2,10,12,16.7%,8m
22453,3,Barro,2851,30,1,1,2,50.0%,2m
22453,1,ephRay,2851,36,1,16,17,5.9%,23m
22453,3,Crocodile,2851,0,0,1,1,0.0%,11m
22453,3,Mikrorul,2851,0,0,1,1,0.0%,24m
22453,3,ferdi,2851,0,0,1,1,0.0%,13m
22453,3,NoobSayBot,2851,0,0,1,1,0.0%,4m
22453,2,DarkAdino,2851,0,0,9,9,0.0%,4m
22491,2,MuOn,2850,1524,274,269,543,50.5%,2m
22491,2,Arazu,2850,659,74,65,139,53.2%,11m
22491,3,Elligos,2850,636,72,60,132,54.5%,4m
22491,3,DreamZzZ,2850,424,54,53,107,50.5%,15m
22491,3,sirOverseer,2850,969,49,31,80,61.2%,4m
22491,3,[GRNSKN]Broce,2850,696,39,30,69,56.5%,5m
22491,2,Oritano,2850,607,38,30,68,55.9%,14m
22491,3,Xristi,2850,937,36,33,69,52.2%,22m
22491,1,Tassarian,2850,867,31,49,80,38.8%,6m
22491,3,Talyalyanin,2850,509,24,17,41,58.5%,5m
22491,2,CapWuzza,2850,460,23,20,43,53.5%,7m
22491,3,GreenLord,2850,601,22,19,41,53.7%,2m
22491,2,[Ww]Quezalcoalt,2850,492,18,18,36,50.0%,14m
22491,3,Vendetta,2850,269,12,6,18,66.7%,17m
22491,1,[Wolven]Güllerormanı,2850,250,12,13,25,48.0%,25m
22491,2,zealk,2850,118,7,7,14,50.0%,2m
22491,2,Rahn,2850,140,6,6,12,50.0%,23m
22491,3,NoWaY,2850,0,4,1,5,80.0%,11m
22491,1,torvale,2850,96,2,0,2,100.0%,1h
22491,2,[Нrr]Radulik,2850,124,2,8,10,20.0%,13m
22491,3,KilRahn,2850,30,1,3,4,25.0%,11m
22491,3,DarthNoodle,2850,0,0,1,1,0.0%,15m
22491,3,CodeR,2850,0,0,2,2,0.0%,24m
22491,2,Romance,2850,0,0,6,6,0.0%,4m
22515,2,MadMan,2849,965,133,129,262,50.8%,2m
22515,2,serjohnny,2849,1493,97,85,182,53.3%,5m
22515,2,EncOre,2849,1412,94,77,171,55.0%,24m
22515,2,[EvT]karl,2849,1126,53,56,109,48.6%,9m
22515,3,Prestor,2849,497,20,12,32,62.5%,8m
22515,1,EponymousEan,2849,515,20,24,44,45.5%,10m
22515,2,Nim,2849,401,17,20,37,45.9%,23m
22515,3,spree,2849,365,12,9,21,57.1%,24m
22515,3,[FkDyMw]Neil,2849,234,11,6,17,64.7%,1h
22515,1,[ZaG]TheSituation,2849,291,9,5,14,64.3%,5m
22515,3,Kronus,2849,229,8,4,12,66.7%,51m
22515,2,[Gr3Z]RayTeck,2849,83,8,8,16,50.0%,14m
22515,3,EtiquetteMan,2849,183,7,5,12,58.3%,8m
22515,3,ShiVAs,2849,0,4,1,5,80.0%,12m
22515,3,[GerAM]Brdlmpft,2849,175,4,4,8,50.0%,5m
22515,2,[KUJD]Damianuś,2849,0,3,2,5,60.0%,51m
22515,2,[iChz]Puhakz,2849,0,3,3,6,50.0%,8m
22515,3,SPARTANEC,2849,58,3,3,6,50.0%,17m
22515,3,WaRmEaTeR,2849,30,2,1,3,66.7%,8m
22515,1,Scar,2849,121,2,2,4,50.0%,23m
22515,3,[НИГГИ]Oxxxymiron,2849,60,2,2,4,50.0%,13m
22515,3,samboets,2849,58,2,2,4,50.0%,10m
22515,1,Sullivision,2849,145,2,3,5,40.0%,44m
22515,3,MOLURUS,2849,60,2,3,5,40.0%,17m
22515,3,Tonton,2849,58,2,3,5,40.0%,13m
22515,3,LuckyIrish,2849,0,1,0,1,100.0%,3m
22515,2,[Ebalay]llllllllllll,2849,0,1,0,1,100.0%,16m
22515,2,CHiBLaST,2849,0,1,1,2,50.0%,50m
22515,3,[1ami1]elEnd,2849,30,1,2,3,33.3%,10m
22515,3,Doniek,2849,30,1,4,5,20.0%,12m
22515,3,Laboisg,2849,0,0,1,1,0.0%,17m
22515,3,JohnnyBambou,2849,0,0,1,1,0.0%,4m
22515,2,Destinova,2849,0,0,5,5,0.0%,9m
22548,2,DIKAR,2848,1574,152,146,298,51.0%,3m
22548,3,Archange,2848,797,139,131,270,51.5%,11m
22548,3,Fizooha,2848,1053,108,92,200,54.0%,8m
22548,3,lukaplusx,2848,1389,69,58,127,54.3%,3m
22548,2,lamia,2848,969,50,44,94,53.2%,2m
22548,3,toxicdonkey,2848,670,43,25,68,63.2%,5m
22548,1,jrgenolsen,2848,888,32,43,75,42.7%,10m
22548,1,[KgGlg]BOBBYFR,2848,970,32,43,75,42.7%,24m
22548,3,KazantiP,2848,511,22,23,45,48.9%,12m
22548,3,Pascal,2848,369,18,9,27,66.7%,3m
22548,2,NiksoN,2848,384,16,18,34,47.1%,4m
22548,3,Kiry,2848,400,15,9,24,62.5%,10m
22548,2,ShinShanShun,2848,208,15,21,36,41.7%,8m
22548,2,ZaN,2848,284,11,12,23,47.8%,24m
22548,3,Latro,2848,207,9,7,16,56.2%,48m
22548,3,[соклан]Данила,2848,218,8,4,12,66.7%,3m
22548,2,AimoLohkare,2848,281,8,10,18,44.4%,49m
22548,2,[COMO]Hook,2848,142,5,10,15,33.3%,55m
22548,3,NeoCobra,2848,30,2,1,3,66.7%,5m
22548,1,[Ug4y]Mike,2848,93,2,1,3,66.7%,22m
22548,2,findows,2848,88,2,2,4,50.0%,11m
22548,1,MeatSpear,2848,96,2,3,5,40.0%,49m
22548,3,BraiNur,2848,0,1,1,2,50.0%,23m
22548,3,Kvasur,2848,30,1,4,5,20.0%,4m
22548,2,yelpHD,2848,0,0,1,1,0.0%,19m
22548,3,[торТВ]Serzhantik,2848,0,0,4,4,0.0%,16m
22574,1,glhf,2847,1210,156,133,289,54.0%,6m
22574,2,Alta,2847,1557,115,96,211,54.5%,14m
22574,3,Killjoy,2847,918,95,98,193,49.2%,23m
22574,3,[PXLD]Tronzi,2847,1528,82,68,150,54.7%,2m
22574,2,Marvel,2847,442,58,48,106,54.7%,12m
22574,3,MasterBadack,2847,340,15,9,24,62.5%,15m
22574,3,TehOcelot,2847,229,9,8,17,52.9%,28m
22574,3,Archon,2847,187,6,0,6,100.0%,7m
22574,1,[NMKR]HerbaList,2847,193,5,7,12,41.7%,59m
22574,2,thec,2847,90,4,7,11,36.4%,25m
22574,3,[50kT]MuzafAs,2847,119,3,0,3,100.0%,16m
22574,3,[ISRI]zaEBENIGRAD,2847,0,3,2,5,60.0%,12m
22574,3,Amile,2847,0,3,2,5,60.0%,2m
22574,3,unkleChe,2847,88,3,5,8,37.5%,2m
22574,3,HEASAGER,2847,143,3,6,9,33.3%,16m
22574,3,Whatever,2847,30,2,1,3,66.7%,4m
22574,3,Mexanick,2847,0,1,1,2,50.0%,3m
22574,1,BlackFlame,2847,0,1,2,3,33.3%,34m
22574,3,Mwesto,2847,0,0,1,1,0.0%,23m
22574,3,JerraXuS,2847,0,0,1,1,0.0%,15m
22574,3,abba,2847,0,0,1,1,0.0%,56m
22574,2,[dlgc]WhiteRa,2847,0,0,1,1,0.0%,40m
22574,3,[WCKYLN]Geschlossen,2847,0,0,3,3,0.0%,23m
22597,1,Matatieu,2846,1592,199,199,398,50.0%,6m
22597,3,Dyb,2846,1601,186,157,343,54.2%,3m
22597,2,Grandmiam,2846,893,146,143,289,50.5%,25m
22597,3,[OmDi]JOHNY,2846,1623,131,121,252,52.0%,8m
22597,2,farseeR,2846,846,91,86,177,51.4%,11m
22597,3,Masher,2846,1379,80,61,141,56.7%,13m
22597,2,giantschrimp,2846,1449,68,63,131,51.9%,9m
22597,3,[TmFlei]Noha,2846,1158,43,42,85,50.6%,17m
22597,3,[Bwolfs]Inquisitor,2846,520,23,11,34,67.6%,25m
22597,3,BeJIuKoeZJIo,2846,573,23,17,40,57.5%,15m
22597,3,[БАНДА]КАМАПУЛЯЕЖЖИ,2846,428,18,17,35,51.4%,22m
22597,3,Biseptold,2846,232,13,9,22,59.1%,16m
22597,3,[Ирбис]TROLLZZZZZZ,2846,292,11,10,21,52.4%,3m
22597,2,KlimenToS,2846,350,11,15,26,42.3%,15m
22597,3,korigien,2846,289,10,8,18,55.6%,22m
22597,3,overlord,2846,179,6,2,8,75.0%,23m
22597,3,AKINCIBEYi,2846,172,6,7,13,46.2%,3m
22597,2,[N0SV0R]polo,2846,88,5,3,8,62.5%,12m
22597,3,JayDzei,2846,177,5,8,13,38.5%,13m
22597,3,AziriSS,2846,120,4,5,9,44.4%,5m
22597,3,warlords,2846,120,4,6,10,40.0%,4m
22597,3,Firefang,2846,121,3,2,5,60.0%,45m
22597,1,sumthingelse,2846,0,3,3,6,50.0%,60m
22597,3,NotDeepmind,2846,0,1,0,1,100.0%,7m
22597,3,Meddre,2846,0,1,1,2,50.0%,10m
22597,3,SraLL,2846,30,1,1,2,50.0%,23m
22597,3,[ISSOVA]SirUrlich,2846,30,1,4,5,20.0%,3m
22597,3,Madbanshee,2846,94,1,5,6,16.7%,23m
22597,2,[Stealt]lolmarcuslol,2846,0,1,10,11,9.1%,5m
22597,3,Glym,2846,0,0,1,1,0.0%,3m
22597,3,Guigs,2846,0,0,2,2,0.0%,13m
22597,3,improvisator,2846,0,0,2,2,0.0%,13m
22629,3,ContenedorZ,2845,261,65,47,112,58.0%,13m
22629,3,dgksp,2845,1197,58,47,105,55.2%,8m
22629,2,MrHanky,2845,803,55,50,105,52.4%,23m
22629,3,Fate,2845,860,37,29,66,56.1%,13m
22629,2,VinylRaider,2845,728,30,25,55,54.5%,17m
22629,3,StarInfestor,2845,688,29,21,50,58.0%,24m
22629,1,Snoopy,2845,648,21,31,52,40.4%,3m
22629,3,Senn,2845,550,19,18,37,51.4%,2m
22629,2,Odinosus,2845,234,9,9,18,50.0%,2m
22629,3,[3DE]SilverGhost,2845,170,7,3,10,70.0%,23m
22629,2,Regul,2845,148,6,11,17,35.3%,4m
22629,3,Slap,2845,122,5,7,12,41.7%,13m
22629,2,sWINdler,2845,94,4,9,13,30.8%,17m
22629,3,[DL2006]Wirv,2845,0,3,1,4,75.0%,3m
22629,1,[J4E]iReve,2845,138,3,1,4,75.0%,6m
22629,2,[JDWSJL]bugstar,2845,0,3,3,6,50.0%,24m
22629,3,jurgen,2845,0,3,3,6,50.0%,2m
22629,3,Snow,2845,30,2,0,2,100.0%,8m
22629,2,Simonsaysz,2845,95,2,3,5,40.0%,55m
22629,2,THEBEST,2845,42,1,3,4,25.0%,42m
22629,3,Suvorov,2845,30,1,4,5,20.0%,16m
22629,3,turgon,2845,30,1,5,6,16.7%,17m
22629,3,[GhostW]Grantz,2845,0,0,1,1,0.0%,9m
22629,3,BlueberryYum,2845,0,0,1,1,0.0%,23m
22629,3,BEAST,2845,0,0,1,1,0.0%,22m
22629,3,JhonnyG,2845,0,0,1,1,0.0%,12m
22629,3,RavenGuard,2845,0,0,1,1,0.0%,16m
22629,3,XvaT,2845,0,0,1,1,0.0%,13m
22629,3,Torkah,2845,0,0,2,2,0.0%,11m
22658,2,Gicu,2844,1601,199,196,395,50.4%,9m
22658,3,EnsaNe,2844,1372,162,151,313,51.8%,9m
22658,2,TitoRobert,2844,825,98,98,196,50.0%,4m
22658,3,Kerrigan,2844,1300,73,71,144,50.7%,5m
22658,2,[PLA2N]Titanych,2844,882,32,35,67,47.8%,4m
22658,2,pibi,2844,539,24,25,49,49.0%,11m
22658,2,Serval,2844,458,20,27,47,42.6%,8m
22658,3,[Kjerne]Steps,2844,364,17,10,27,63.0%,25m
22658,3,[Öplex]frogOPS,2844,358,14,6,20,70.0%,8m
22658,3,Svartsot,2844,321,12,5,17,70.6%,8m
22658,3,[17]Braveheart,2844,303,10,6,16,62.5%,16m
22658,3,BensZ,2844,251,8,4,12,66.7%,3m
22658,1,Tariel,2844,259,7,7,14,50.0%,1h
22658,3,Faikert,2844,0,4,1,5,80.0%,9m
22658,2,Mouse,2844,140,4,4,8,50.0%,57m
22658,2,Fogy,2844,122,4,11,15,26.7%,24m
22658,2,Highlander,2844,0,3,3,6,50.0%,16m
22658,1,Kvard,2844,148,3,8,11,27.3%,45m
22658,3,[DHYD]SalyT,2844,62,2,5,7,28.6%,10m
22658,3,[Kpedo]Витязь,2844,0,1,0,1,100.0%,7m
22658,3,Vrc,2844,0,1,0,1,100.0%,8m
22658,2,[CS1rus]Quasar,2844,89,1,2,3,33.3%,59m
22658,3,Ithaqua,2844,30,1,2,3,33.3%,24m
22681,2,Vortex,2843,1521,72,60,132,54.5%,4m
22681,1,[BLCKWD]Atai,2843,788,27,39,66,40.9%,12m
22681,3,Artificial,2843,574,24,19,43,55.8%,8m
22681,3,[DBUGS]lundril,2843,393,22,15,37,59.5%,23m
22681,3,[Batzn]BlobOfSlime,2843,434,16,11,27,59.3%,8m
22681,3,[CОS]DearBear,2843,345,13,9,22,59.1%,22m
22681,3,Demonic,2843,172,6,9,15,40.0%,10m
22681,2,NexusRU,2843,130,5,3,8,62.5%,24m
22681,3,DiJayX,2843,118,5,3,8,62.5%,12m
22681,3,Manticore,2843,0,4,1,5,80.0%,23m
22681,2,Kapybara,2843,132,4,11,15,26.7%,3m
22681,2,killerbee,2843,0,3,3,6,50.0%,56m
22681,1,Hoskel,2843,96,3,3,6,50.0%,52m
22681,3,GerAerox,2843,0,2,1,3,66.7%,2m
22681,3,JaooD,2843,0,2,3,5,40.0%,24m
22681,2,berserkgatz,2843,0,2,3,5,40.0%,1h
22681,3,superharam,2843,0,2,3,5,40.0%,8m
22681,3,Ben,2843,0,1,0,1,100.0%,23m
22681,3,Paghmanden,2843,0,1,1,2,50.0%,9m
22681,3,[ЛДПР]FloreGame,2843,0,0,1,1,0.0%,8m
22681,3,TWOkTM,2843,0,0,1,1,0.0%,23m
22681,3,[Hrѓ]KamyshevSV,2843,0,0,1,1,0.0%,9m
22681,3,[DarKN8]CASTBOUND,2843,0,0,2,2,0.0%,5m
22681,3,Zhnec,2843,0,0,2,2,0.0%,8m
22681,2,[Uaks]Stenforcer,2843,0,0,5,5,0.0%,57m
22706,3,[GGLose]scWildGhost,2842,1313,110,97,207,53.1%,7m
22706,2,oGGiePG,2842,1454,99,105,204,48.5%,8m
22706,2,Ezk,2842,1142,85,77,162,52.5%,25m
22706,3,bOot,2842,1237,50,44,94,53.2%,12m
22706,1,Gerda,2842,638,48,54,102,47.1%,26m
22706,3,Phate,2842,1072,45,42,87,51.7%,23m
22706,3,Kampfkarpfn,2842,812,31,27,58,53.4%,16m
22706,1,JohnnyGroove,2842,556,21,19,40,52.5%,23m
22706,2,zero,2842,472,18,18,36,50.0%,7m
22706,2,Quimby,2842,358,12,23,35,34.3%,4m
22706,1,ZAToM,2842,337,11,19,30,36.7%,9m
22706,3,[WАSD]Noram,2842,281,10,5,15,66.7%,11m
22706,3,Kurita,2842,247,10,8,18,55.6%,16m
22706,3,Ssinxdy,2842,236,8,5,13,61.5%,16m
22706,3,[m0d3ls]Balder,2842,166,6,6,12,50.0%,9m
22706,2,Legion,2842,60,5,5,10,50.0%,14m
22706,1,RedToni,2842,119,4,4,8,50.0%,4m
22706,2,[Koffie]DrGertMan,2842,121,4,13,17,23.5%,22m
22706,2,Dmiltrius,2842,120,4,13,17,23.5%,11m
22706,3,[Sfi]AquaPhil,2842,0,3,2,5,60.0%,12m
22706,2,serzeo,2842,0,3,2,5,60.0%,51m
22706,3,Chefkoch,2842,0,3,2,5,60.0%,24m
22706,3,[TAW]cantouchthis,2842,62,3,4,7,42.9%,17m
22706,2,darling,2842,140,3,4,7,42.9%,32m
22706,2,HoBBeS,2842,0,2,3,5,40.0%,2m
22706,2,ixaakeex,2842,62,2,9,11,18.2%,25m
22706,3,Mons,2842,0,1,0,1,100.0%,3m
22706,3,PROдуманный,2842,0,1,0,1,100.0%,17m
22706,2,ВодныйЖерех,2842,90,1,3,4,25.0%,49m
22706,1,Celtrim,2842,48,1,4,5,20.0%,57m
22706,3,Rötten,2842,32,1,4,5,20.0%,28m
22706,3,[6ix]ExTikxX,2842,0,0,1,1,0.0%,11m
22706,3,[QTclub]BlackWiCKED,2842,0,0,1,1,0.0%,16m
22706,3,Tonik,2842,0,0,1,1,0.0%,15m
22706,3,Saezman,2842,0,0,1,1,0.0%,23m
22706,1,Tore,2842,0,0,3,3,0.0%,6m
22706,3,SeNko,2842,0,0,3,3,0.0%,9m
22743,1,Raketmördarn,2841,1582,450,444,894,50.3%,23m
22743,2,Ivanushka,2841,1372,109,99,208,52.4%,4m
22743,3,[ScNo1]OMG,2841,908,97,80,177,54.8%,11m
22743,1,[TIHIC]DaW,2841,970,64,69,133,48.1%,25m
22743,3,Stringer,2841,1194,52,53,105,49.5%,11m
22743,3,Drop,2841,562,44,57,101,43.6%,14m
22743,3,SadPanda,2841,1005,41,37,78,52.6%,14m
22743,3,[Ǽ1]AGoatedPlat,2841,696,31,17,48,64.6%,24m
22743,1,AttilaHM,2841,697,31,30,61,50.8%,14m
22743,3,ProtossAnt,2841,733,30,27,57,52.6%,7m
22743,3,Toss,2841,675,28,22,50,56.0%,14m
22743,3,ntl,2841,644,24,21,45,53.3%,11m
22743,2,Melancholia,2841,518,20,22,42,47.6%,9m
22743,3,Spring,2841,449,18,10,28,64.3%,4m
22743,1,[Козак]Aster,2841,300,13,14,27,48.1%,5m
22743,3,davvs,2841,369,12,13,25,48.0%,14m
22743,2,Sashageolog,2841,279,11,10,21,52.4%,4m
22743,3,Ithuriel,2841,145,9,6,15,60.0%,23m
22743,2,Fantomat,2841,212,6,4,10,60.0%,28m
22743,2,[Case1]kiosk,2841,128,6,5,11,54.5%,11m
22743,3,[TEMED]Snilleur,2841,147,6,7,13,46.2%,47m
22743,1,[THANOS]Rogue,2841,162,5,4,9,55.6%,16m
22743,3,CannonCoward,2841,162,4,2,6,66.7%,24m
22743,2,Leopard,2841,0,4,2,6,66.7%,55m
22743,2,hauszerg,2841,0,3,3,6,50.0%,8m
22743,1,theBEAN,2841,48,3,6,9,33.3%,57m
22743,3,BrutalTomato,2841,92,3,8,11,27.3%,13m
22743,3,Exodus,2841,0,2,3,5,40.0%,14m
22743,3,MuchoMacho,2841,0,1,0,1,100.0%,22m
22743,3,marain,2841,94,1,6,7,14.3%,12m
22743,3,[TPXtv]BorroW,2841,0,0,1,1,0.0%,15m
22743,3,JuriBoika,2841,0,0,1,1,0.0%,10m
22775,3,PreDAToR,2840,375,52,42,94,55.3%,4m
22775,3,Lumis,2840,1248,51,47,98,52.0%,12m
22775,3,Алекс,2840,1184,48,45,93,51.6%,2m
22775,3,[FLAX]DnBWicked,2840,538,21,17,38,55.3%,9m
22775,3,inane,2840,522,19,22,41,46.3%,2m
22775,2,HzxByOnline,2840,487,17,19,36,47.2%,9m
22775,2,Kwriss,2840,422,16,19,35,45.7%,14m
22775,3,[AciNoN]sin,2840,230,9,7,16,56.2%,3m
22775,3,[stmdf]krabik,2840,252,9,8,17,52.9%,23m
22775,3,Gustiik,2840,291,9,12,21,42.9%,9m
22775,2,Simon,2840,246,9,15,24,37.5%,5m
22775,3,[SDDDD]ОдинокийСтар,2840,228,8,2,10,80.0%,25m
22775,2,Man,2840,220,8,9,17,47.1%,8m
22775,3,BongoPete,2840,58,6,3,9,66.7%,3m
22775,3,[Dondon]Florchan,2840,157,5,0,5,100.0%,14m
22775,2,Vio,2840,159,5,4,9,55.6%,1h
22775,2,mrnice,2840,117,4,3,7,57.1%,1h
22775,1,retroCZ,2840,0,4,4,8,50.0%,9m
22775,1,[KinEU]RatJack,2840,145,4,5,9,44.4%,16m
22775,2,Volper,2840,0,3,3,6,50.0%,46m
22775,3,valhalla,2840,30,2,1,3,66.7%,16m
22775,3,[TODOW]Linkimbis,2840,58,2,3,5,40.0%,4m
22775,3,vinovi,2840,30,2,3,5,40.0%,4m
22775,3,AndrewZ,2840,58,2,3,5,40.0%,17m
22775,2,Dearous,2840,0,2,3,5,40.0%,56m
22775,3,Pentarh,2840,30,2,5,7,28.6%,14m
22775,3,[Petrиs]Gor,2840,0,0,3,3,0.0%,3m
22775,3,[Poo]HappyPoo,2840,0,0,4,4,0.0%,2m
22803,3,AZA,2839,1629,102,96,198,51.5%,12m
22803,2,[Cynaps]KaneHelax,2839,1249,53,56,109,48.6%,9m
22803,2,[NBV]docode,2839,600,48,50,98,49.0%,8m
22803,3,Pyksell,2839,982,44,37,81,54.3%,17m
22803,2,Miracles,2839,652,39,36,75,52.0%,12m
22803,3,johan,2839,638,25,22,47,53.2%,8m
22803,3,Zeddiculus,2839,420,15,16,31,48.4%,4m
22803,1,Jin,2839,334,14,16,30,46.7%,23m
22803,3,Prokop,2839,310,10,8,18,55.6%,14m
22803,3,dendud,2839,157,8,1,9,88.9%,23m
22803,3,mihmax,2839,187,5,2,7,71.4%,16m
22803,1,Nythos,2839,97,4,3,7,57.1%,49m
22803,3,Edorock,2839,58,3,1,4,75.0%,4m
22803,2,Skadoosh,2839,0,3,2,5,60.0%,1h
22803,1,[KiIn]Rattenfänger,2839,68,3,6,9,33.3%,16m
22803,3,[Brutos]pirinbg,2839,30,2,1,3,66.7%,13m
22803,1,[EESC]Hectorg,2839,60,2,18,20,10.0%,3m
22803,3,[ƮesXG]Huski,2839,0,1,0,1,100.0%,4m
22803,3,[NLTN]Tri,2839,0,1,0,1,100.0%,24m
22803,3,BBQLord,2839,30,1,2,3,33.3%,9m
22803,3,Sagdahl,2839,0,1,2,3,33.3%,23m
22803,3,YLsIntoTanks,2839,0,1,4,5,20.0%,23m
22803,2,Arsenide,2839,94,1,5,6,16.7%,48m
22803,3,Васисуалий,2839,0,0,1,1,0.0%,7m
22803,3,Nohow,2839,0,0,1,1,0.0%,23m
22803,3,bonky,2839,0,0,1,1,0.0%,22m
22803,3,ASDASDASDASD,2839,0,0,1,1,0.0%,4m
22803,3,Miomoto,2839,0,0,1,1,0.0%,4m
22831,2,cingula,2838,1524,453,433,886,51.1%,24m
22831,2,Saimon,2838,1553,256,248,504,50.8%,9m
22831,2,[WARHED]WseeDRAGon,2838,1302,129,118,247,52.2%,15m
22831,3,LloRiDer,2838,1580,109,94,203,53.7%,2m
22831,2,[Rakii]tosun,2838,532,68,77,145,46.9%,8m
22831,3,Chilch,2838,1009,61,40,101,60.4%,12m
22831,2,FLoiD,2838,1440,61,58,119,51.3%,14m
22831,2,[VTGO]Grismar,2838,1414,55,54,109,50.5%,9m
22831,3,Gladiator,2838,727,30,33,63,47.6%,10m
22831,3,LUKE,2838,697,28,23,51,54.9%,17m
22831,2,Light,2838,258,24,25,49,49.0%,4m
22831,3,Goldie,2838,396,15,10,25,60.0%,7m
22831,3,MINATO,2838,315,15,16,31,48.4%,24m
22831,3,RamasChamas,2838,228,12,8,20,60.0%,17m
22831,2,Aeneas,2838,258,10,11,21,47.6%,1h
22831,1,Makhaos,2838,190,8,10,18,44.4%,54m
22831,1,GoVbon,2838,190,7,7,14,50.0%,34m
22831,1,HaTiko,2838,94,5,5,10,50.0%,16m
22831,1,ТрахерЧечни,2838,129,5,6,11,45.5%,8m
22831,3,noncheeseacc,2838,0,3,2,5,60.0%,3m
22831,3,GouGoule,2838,30,2,0,2,100.0%,23m
22831,1,[Домик]карлсон,2838,97,2,2,4,50.0%,31m
22831,1,Blossom,2838,97,2,4,6,33.3%,58m
22831,3,Forgot,2838,60,2,4,6,33.3%,4m
22831,3,PewCrew,2838,30,2,4,6,33.3%,11m
22831,3,[VuV]Gendalf,2838,60,2,5,7,28.6%,9m
22831,1,Nilmsa,2838,0,1,0,1,100.0%,29m
22831,3,Nocilax,2838,0,1,0,1,100.0%,9m
22831,3,Driox,2838,0,1,1,2,50.0%,11m
22831,2,Teodor,2838,0,1,1,2,50.0%,1h
22831,3,[DTSA]Curldow,2838,0,1,1,2,50.0%,11m
22831,3,[KokBre]JoCobre,2838,0,1,2,3,33.3%,10m
22831,3,sebzore,2838,0,0,1,1,0.0%,23m
22831,3,Zenitium,2838,0,0,1,1,0.0%,22m
22831,3,Pmzch,2838,0,0,1,1,0.0%,4m
22831,3,tolikuuu,2838,0,0,2,2,0.0%,2m
22831,3,[PLA2N]Uroboros,2838,0,0,2,2,0.0%,8m
22831,1,AllysonNL,2838,0,0,2,2,0.0%,1h
22869,3,Котяка,2837,1619,203,192,395,51.4%,4m
22869,3,[GVAD]teach,2837,1568,73,66,139,52.5%,15m
22869,2,Cargobiker,2837,1585,68,73,141,48.2%,4m
22869,2,Gimago,2837,1360,58,62,120,48.3%,9m
22869,3,Crowye,2837,881,55,61,116,47.4%,7m
22869,3,[Adlscø]nerukan,2837,1031,38,34,72,52.8%,8m
22869,2,inMachine,2837,610,24,24,48,50.0%,14m
22869,2,[SPAINs]DIPLODOCUS,2837,462,20,17,37,54.1%,9m
22869,2,KnowOne,2837,545,20,23,43,46.5%,15m
22869,3,МетельДуши,2837,459,17,11,28,60.7%,14m
22869,3,EFM,2837,411,15,13,28,53.6%,9m
22869,3,Nozdrolomo,2837,390,15,15,30,50.0%,10m
22869,3,Gryphus,2837,389,15,17,32,46.9%,9m
22869,3,Sapozhnik,2837,359,14,6,20,70.0%,23m
22869,3,marmorix,2837,314,12,14,26,46.2%,10m
22869,3,bonday,2837,0,4,1,5,80.0%,11m
22869,2,[SFine]Cabrera,2837,0,3,2,5,60.0%,57m
22869,2,Ilya,2837,0,2,3,5,40.0%,55m
22869,3,PablitoMan,2837,58,2,4,6,33.3%,4m
22869,3,RIPHarambe,2837,0,1,1,2,50.0%,10m
22869,3,Blaik,2837,30,1,2,3,33.3%,4m
22869,3,TokioJPN,2837,30,1,3,4,25.0%,3m
22869,3,Quarkh,2837,0,0,1,1,0.0%,5m
22869,3,[XzF]Radix,2837,0,0,1,1,0.0%,4m
22869,3,ChAngaChOice,2837,0,0,2,2,0.0%,23m
22894,1,Jarvis,2836,1070,100,99,199,50.3%,5m
22894,3,GSXR,2836,887,42,28,70,60.0%,23m
22894,3,LawlyBoy,2836,1034,40,41,81,49.4%,9m
22894,2,xenon,2836,427,40,42,82,48.8%,4m
22894,3,[Донный]Terch,2836,539,33,5,38,86.8%,9m
22894,2,Gomer,2836,758,32,27,59,54.2%,4m
22894,2,CmdBanana,2836,584,31,34,65,47.7%,23m
22894,3,karanas,2836,448,15,17,32,46.9%,17m
22894,3,[KCoLoK]RoMaNoR,2836,458,15,34,49,30.6%,7m
22894,1,moorten,2836,283,10,9,19,52.6%,51m
22894,2,Doren,2836,277,10,13,23,43.5%,17m
22894,3,TheAssasin,2836,242,8,5,13,61.5%,3m
22894,3,[Gremli]Zorrotul,2836,136,7,4,11,63.6%,24m
22894,3,Karasiu,2836,148,7,8,15,46.7%,42m
22894,1,Berci,2836,147,6,4,10,60.0%,21m
22894,3,[ZЕRG7V]SkiFi,2836,62,6,7,13,46.2%,20m
22894,1,[Чмок]Cake,2836,194,6,7,13,46.2%,44m
22894,3,bloshin,2836,118,4,7,11,36.4%,4m
22894,3,[NRH]Panda,2836,30,2,1,3,66.7%,4m
22894,3,Hunter,2836,0,1,0,1,100.0%,4m
22894,3,Luxgile,2836,0,1,1,2,50.0%,16m
22894,3,Savage,2836,30,1,3,4,25.0%,9m
22894,3,Dark,2836,0,0,1,1,0.0%,25m
22894,3,Coosmic,2836,0,0,1,1,0.0%,23m
22894,3,Starkiller,2836,0,0,2,2,0.0%,3m
22894,3,peonmonster,2836,0,0,2,2,0.0%,38m
22894,3,Liranay,2836,0,0,3,3,0.0%,23m
22921,1,Thorgas,2835,1312,257,253,510,50.4%,24m
22921,2,[WGTG]stefmann,2835,1049,183,182,365,50.1%,4m
22921,1,LazyRobot,2835,1418,84,84,168,50.0%,3m
22921,2,Waszel,2835,1266,48,49,97,49.5%,9m
22921,1,Fire,2835,1286,47,58,105,44.8%,6m
22921,3,carrion,2835,806,29,26,55,52.7%,3m
22921,3,[PvZNW]HolyFlame,2835,707,27,28,55,49.1%,15m
22921,2,Step,2835,560,24,22,46,52.2%,25m
22921,3,Gervaise,2835,615,23,23,46,50.0%,5m
22921,3,Akerman,2835,367,20,15,35,57.1%,26m
22921,3,WawaCool,2835,521,20,16,36,55.6%,23m
22921,1,Денис,2835,620,20,35,55,36.4%,24m
22921,1,[SoL]WhitedeviL,2835,414,18,19,37,48.6%,7m
22921,3,one,2835,352,14,11,25,56.0%,13m
22921,3,[STZK]Snack,2835,248,12,12,24,50.0%,26m
22921,2,duke,2835,249,11,7,18,61.1%,52m
22921,2,CosmicFlower,2835,237,9,12,21,42.9%,55m
22921,3,[BWArmy]Iricommi,2835,172,6,2,8,75.0%,8m
22921,1,rockycz,2835,96,6,5,11,54.5%,50m
22921,3,OnlyOneGod,2835,86,6,6,12,50.0%,8m
22921,3,[PdGI]BobbyFleck,2835,163,5,1,6,83.3%,9m
22921,1,OmgMissile,2835,145,5,5,10,50.0%,21m
22921,3,ZergNoob,2835,142,4,1,5,80.0%,12m
22921,3,[ЯD]Mono,2835,116,4,8,12,33.3%,17m
22921,1,Alex,2835,141,3,2,5,60.0%,58m
22921,2,Aquilius,2835,0,3,3,6,50.0%,23m
22921,3,[VFish]crml,2835,30,2,2,4,50.0%,17m
22921,3,[WAAAR]LED,2835,60,2,3,5,40.0%,2m
22921,3,Ehcl,2835,60,2,6,8,25.0%,16m
22921,3,Groot,2835,30,1,2,3,33.3%,5m
22921,3,MichalO,2835,0,0,1,1,0.0%,15m
22921,3,tass,2835,0,0,1,1,0.0%,23m
22921,3,Edikum,2835,0,0,1,1,0.0%,10m
22921,3,[GERGG]koonst,2835,0,0,2,2,0.0%,4m
22921,3,[Slurps]Stargass,2835,0,0,3,3,0.0%,4m
22956,2,DJHAHN,2834,1437,165,152,317,52.1%,5m
22956,3,sharp,2834,1072,47,39,86,54.7%,7m
22956,3,caxap,2834,918,39,39,78,50.0%,3m
22956,3,shadowwolf,2834,731,35,24,59,59.3%,23m
22956,2,EgoRICH,2834,725,26,33,59,44.1%,4m
22956,3,DummerSandro,2834,449,19,7,26,73.1%,14m
22956,2,Nitsuja,2834,406,17,18,35,48.6%,8m
22956,3,DevilHydra,2834,259,15,13,28,53.6%,5m
22956,1,Vadinoy,2834,165,13,5,18,72.2%,1h
22956,3,IIIIIIIIIIII,2834,268,9,2,11,81.8%,48m
22956,3,[FRNG]Cerber,2834,262,9,7,16,56.2%,27m
22956,3,Sonyman,2834,231,8,3,11,72.7%,17m
22956,3,[Rushrs]MiruMir,2834,178,7,8,15,46.7%,6m
22956,3,GhsT,2834,190,6,4,10,60.0%,4m
22956,2,Izopicha,2834,128,6,6,12,50.0%,8m
22956,2,Xerrea,2834,216,6,8,14,42.9%,14m
22956,2,GGEasy,2834,118,6,9,15,40.0%,25m
22956,3,Gelo,2834,150,5,10,15,33.3%,14m
22956,3,Pablo,2834,58,3,6,9,33.3%,8m
22956,3,CONF,2834,0,1,0,1,100.0%,22m
22956,3,Гоал,2834,30,1,1,2,50.0%,11m
22956,3,ALEXEY,2834,30,1,2,3,33.3%,4m
22956,3,SKOVDRENGEN,2834,30,1,3,4,25.0%,12m
22956,3,[Arrows]AID,2834,30,1,6,7,14.3%,11m
22956,3,Wimpy,2834,0,0,1,1,0.0%,11m
22956,1,Ferox,2834,0,0,2,2,0.0%,38m
22982,2,Barik,2833,861,216,207,423,51.1%,11m
22982,3,PantsOfLuck,2833,1423,67,51,118,56.8%,6m
22982,3,AnimeN,2833,658,62,56,118,52.5%,5m
22982,1,MooM,2833,894,31,38,69,44.9%,6m
22982,2,WhiteWind,2833,525,30,34,64,46.9%,14m
22982,3,PolishGamer,2833,602,23,22,45,51.1%,17m
22982,3,[PYHU]Пучахендза,2833,304,17,12,29,58.6%,23m
22982,3,Shadowblate,2833,385,13,10,23,56.5%,17m
22982,2,RedCart,2833,330,13,12,25,52.0%,25m
22982,2,[TANOS]Smoke,2833,348,11,15,26,42.3%,6m
22982,2,Chaoz,2833,310,10,17,27,37.0%,23m
22982,3,[baker]уеокп,2833,215,7,4,11,63.6%,7m
22982,2,hedGehog,2833,142,7,6,13,53.8%,10m
22982,2,Agma,2833,164,7,7,14,50.0%,23m
22982,2,JeanMiAulas,2833,117,5,2,7,71.4%,44m
22982,1,[HebT]JiTiBO,2833,185,5,15,20,25.0%,53m
22982,3,LegoLaz,2833,137,4,0,4,100.0%,8m
22982,3,Lenker,2833,144,4,1,5,80.0%,9m
22982,3,pyspark,2833,0,4,4,8,50.0%,52m
22982,3,Palach,2833,114,3,0,3,100.0%,25m
22982,3,konstanzer,2833,58,3,2,5,60.0%,23m
22982,3,Beast,2833,92,3,3,6,50.0%,11m
22982,3,[AnIM37]BlackFire,2833,30,2,1,3,66.7%,5m
22982,3,GetRekt,2833,0,2,3,5,40.0%,12m
22982,3,[AOoG]Cayser,2833,0,1,0,1,100.0%,23m
22982,2,Kinzie,2833,0,1,0,1,100.0%,1h
22982,3,[LTJP]Ksad,2833,0,0,1,1,0.0%,4m
22982,3,[SadW]AdventureAl,2833,0,0,1,1,0.0%,14m
22982,3,[TTpom]Curare,2833,0,0,1,1,0.0%,14m
23011,1,HellTos,2832,1302,308,312,620,49.7%,13m
23011,1,Pysio,2832,1419,178,175,353,50.4%,12m
23011,2,Efem,2832,1564,174,155,329,52.9%,9m
23011,3,Colabria,2832,1099,42,39,81,51.9%,2m
23011,1,llllllllllll,2832,761,33,47,80,41.2%,26m
23011,3,Brocololo,2832,636,23,22,45,51.1%,26m
23011,3,BERLINcrime,2832,546,21,18,39,53.8%,9m
23011,3,[RLMC]MaxGingers,2832,514,18,23,41,43.9%,5m
23011,3,UnderTaker,2832,285,10,6,16,62.5%,14m
23011,2,MmAaXx,2832,212,10,9,19,52.6%,8m
23011,3,[359]jokera,2832,258,8,5,13,61.5%,41m
23011,2,xStampede,2832,196,7,16,23,30.4%,2m
23011,2,Isahn,2832,48,5,2,7,71.4%,27m
23011,3,GendiGendi,2832,183,5,3,8,62.5%,16m
23011,1,Hushpuppie,2832,145,5,5,10,50.0%,49m
23011,2,[OHOHO]aronlimm,2832,154,5,17,22,22.7%,17m
23011,2,Nawq,2832,0,3,3,6,50.0%,20m
23011,3,Barfcraft,2832,86,3,4,7,42.9%,8m
23011,3,[TempPL]Jagniątko,2832,30,2,2,4,50.0%,12m
23011,3,[FCxAKW]sfoster,2832,60,2,2,4,50.0%,23m
23011,3,llordmbce,2832,58,2,4,6,33.3%,17m
23011,3,deckrimenant,2832,30,2,4,6,33.3%,10m
23011,3,MatNat,2832,0,1,0,1,100.0%,19m
23011,3,Annatar,2832,0,1,0,1,100.0%,9m
23011,3,[SLW]speedyPifPaf,2832,30,1,1,2,50.0%,4m
23011,3,LiaChan,2832,0,1,2,3,33.3%,11m
23011,3,артём,2832,0,0,1,1,0.0%,9m
23011,3,[SPAINs]ZEIT,2832,0,0,2,2,0.0%,24m
23039,3,KorwinCraft,2831,1337,109,113,222,49.1%,12m
23039,3,happyfish,2831,162,97,88,185,52.4%,6m
23039,3,Night,2831,920,87,67,154,56.5%,25m
23039,3,[ÄÖÜ]TimboKarl,2831,1438,64,45,109,58.7%,11m
23039,2,[LMBD]MateXia,2831,751,63,40,103,61.2%,6m
23039,3,TwóPóíntóh,2831,467,37,26,63,58.7%,15m
23039,3,Nanovydra,2831,678,29,18,47,61.7%,17m
23039,3,PallaDium,2831,604,26,15,41,63.4%,23m
23039,2,Timba,2831,640,24,29,53,45.3%,8m
23039,3,stones,2831,318,20,12,32,62.5%,17m
23039,3,BananaJoe,2831,509,20,18,38,52.6%,3m
23039,3,[ZHxPro]GeneralArtin,2831,430,16,13,29,55.2%,5m
23039,2,blannti,2831,204,11,9,20,55.0%,9m
23039,2,StuckPlat,2831,266,11,9,20,55.0%,7m
23039,3,[SmoCrE]MisterA,2831,236,9,2,11,81.8%,8m
23039,3,Puperlords,2831,220,9,10,19,47.4%,5m
23039,3,[TdFd]Ubreak,2831,233,7,4,11,63.6%,23m
23039,3,NonMetaL,2831,146,6,6,12,50.0%,1h
23039,3,SJoe,2831,172,6,10,16,37.5%,3m
23039,2,[Xa]TheOcelot,2831,65,6,11,17,35.3%,4m
23039,3,RyhHem,2831,152,5,9,14,35.7%,4m
23039,3,Scuby,2831,144,3,2,5,60.0%,24m
23039,3,Khan,2831,60,3,2,5,60.0%,23m
23039,3,[2raxyo]discomaniac,2831,30,2,1,3,66.7%,4m
23039,3,headches,2831,120,2,2,4,50.0%,5m
23039,3,[Lowko]stiege,2831,60,2,3,5,40.0%,12m
23039,3,Szymon,2831,62,2,5,7,28.6%,4m
23039,3,ornastra,2831,0,1,0,1,100.0%,4m
23039,3,[CaSCuT]elka,2831,0,1,0,1,100.0%,24m
23039,3,Battledroid,2831,0,1,0,1,100.0%,17m
23039,3,[Alеx07]KacTuEJlb,2831,0,0,1,1,0.0%,5m
23039,3,[KMarks]maks,2831,0,0,1,1,0.0%,13m
23039,3,Zapcore,2831,0,0,2,2,0.0%,22m
23072,3,spiderpig,2830,1321,116,102,218,53.2%,17m
23072,2,Tardigrade,2830,995,62,62,124,50.0%,9m
23072,3,VpJalq,2830,1055,42,34,76,55.3%,14m
23072,2,[KhSo]Pierre,2830,849,34,37,71,47.9%,25m
23072,3,evzzz,2830,691,28,23,51,54.9%,5m
23072,3,chiratoss,2830,560,23,17,40,57.5%,2m
23072,3,Holidayfreak,2830,547,20,16,36,55.6%,25m
23072,3,[n3rd]Versale,2830,322,11,7,18,61.1%,34m
23072,3,DarkRonin,2830,301,11,10,21,52.4%,23m
23072,2,look,2830,296,9,19,28,32.1%,9m
23072,3,[CS0]ORIGIN,2830,116,7,1,8,87.5%,16m
23072,2,Ulug,2830,176,7,14,21,33.3%,17m
23072,3,david,2830,144,6,5,11,54.5%,12m
23072,3,vShvartz,2830,144,5,5,10,50.0%,10m
23072,2,BigGDani,2830,0,4,1,5,80.0%,21m
23072,2,Bear,2830,0,4,1,5,80.0%,58m
23072,3,PapaYago,2830,157,4,4,8,50.0%,58m
23072,1,Solomon,2830,97,4,4,8,50.0%,59m
23072,3,Killitron,2830,0,4,4,8,50.0%,19m
23072,3,SmegHeadCZE,2830,58,3,2,5,60.0%,17m
23072,3,Kuuhaku,2830,112,3,2,5,60.0%,4m
23072,3,Bishop,2830,30,2,2,4,50.0%,9m
23072,3,UFOM,2830,0,1,1,2,50.0%,28m
23072,3,Dumbledore,2830,30,1,2,3,33.3%,9m
23072,3,Andrei,2830,0,1,3,4,25.0%,1h
23072,3,LivaY,2830,0,1,3,4,25.0%,14m
23072,3,Gozea,2830,30,1,3,4,25.0%,7m
23072,3,BloodCloud,2830,0,0,1,1,0.0%,5m
23072,1,[ZERGTB]Fimnesorz,2830,0,0,2,2,0.0%,18m
23072,3,twoshy,2830,0,0,3,3,0.0%,11m
23072,2,[IYOLOI]Cythraul,2830,0,0,6,6,0.0%,12m
23103,2,lurkker,2829,1565,199,186,385,51.7%,4m
23103,2,radium,2829,1613,195,189,384,50.8%,25m
23103,3,VpyH,2829,1589,117,110,227,51.5%,24m
23103,1,EugenE,2829,1579,74,72,146,50.7%,6m
23103,2,[Sapphi]sanaimar,2829,489,74,79,153,48.4%,13m
23103,3,InertAlert,2829,1139,63,53,116,54.3%,4m
23103,3,reedemer,2829,789,56,51,107,52.3%,17m
23103,1,BadMove,2829,979,52,68,120,43.3%,6m
23103,2,Ookx,2829,1005,48,36,84,57.1%,12m
23103,2,gdmsob,2829,1124,40,49,89,44.9%,25m
23103,3,poLi,2829,918,38,30,68,55.9%,8m
23103,2,Pisøø,2829,962,38,35,73,52.1%,9m
23103,2,Fridge,2829,628,22,30,52,42.3%,12m
23103,3,NeedMoreRage,2829,409,14,12,26,53.8%,13m
23103,3,[WWP]IvanDrago,2829,301,10,11,21,47.6%,23m
23103,3,THAlLAND,2829,257,9,10,19,47.4%,7m
23103,2,Keter,2829,146,6,10,16,37.5%,9m
23103,2,vano,2829,114,5,5,10,50.0%,23m
23103,1,timehider,2829,175,5,8,13,38.5%,45m
23103,2,RefLex,2829,95,2,4,6,33.3%,7m
23103,3,[ZeCouZ]wongsifou,2829,0,1,0,1,100.0%,23m
23103,3,[ØN]Tertiary,2829,0,1,1,2,50.0%,17m
23103,3,[BRATVA]val,2829,0,1,1,2,50.0%,3m
23103,3,lilyAnne,2829,0,1,2,3,33.3%,15m
23103,3,[Rebеls]QueenOfHell,2829,0,0,1,1,0.0%,23m
23103,3,HexepHaxep,2829,0,0,3,3,0.0%,11m
23129,2,Dmail,2828,337,57,46,103,55.3%,9m
23129,2,hypnoz,2828,1202,57,52,109,52.3%,23m
23129,2,NoobKiller,2828,1150,42,49,91,46.2%,14m
23129,3,Phantom,2828,778,37,19,56,66.1%,8m
23129,3,MrDiarrhea,2828,854,34,32,66,51.5%,3m
23129,3,Pauzka,2828,656,27,19,46,58.7%,17m
23129,3,Vyrus,2828,710,26,23,49,53.1%,3m
23129,3,AlgreN,2828,564,23,19,42,54.8%,23m
23129,3,Scøøper,2828,471,18,14,32,56.2%,26m
23129,2,[PÂRłAH]DARK,2828,319,12,14,26,46.2%,14m
23129,3,Tikovka,2828,258,11,7,18,61.1%,15m
23129,2,BountyHunter,2828,230,10,10,20,50.0%,11m
23129,3,GrimsDottir,2828,245,9,3,12,75.0%,12m
23129,2,[P3N14]ratatoek,2828,293,8,16,24,33.3%,25m
23129,2,LuţăAgresoru,2828,44,4,4,8,50.0%,3m
23129,3,Tsirkon,2828,98,4,17,21,19.0%,8m
23129,3,[QaDo]Рен,2828,58,3,1,4,75.0%,9m
23129,1,kiselewspb,2828,120,3,9,12,25.0%,6m
23129,3,EvilSquirrel,2828,30,2,1,3,66.7%,5m
23129,3,Anvarsky,2828,0,1,0,1,100.0%,12m
23129,3,[V1B3]STIMZ,2828,0,1,0,1,100.0%,17m
23129,3,blaagi,2828,0,1,0,1,100.0%,4m
23129,3,Bateman,2828,0,1,2,3,33.3%,9m
23129,3,Kira,2828,0,1,4,5,20.0%,6m
23129,3,rAviq,2828,0,0,1,1,0.0%,26m
23129,3,Vyvich,2828,0,0,1,1,0.0%,24m
23129,2,teemu,2828,0,0,2,2,0.0%,7m
23129,2,[Candy1]Sanchez,2828,0,0,2,2,0.0%,57m
23129,3,Nero,2828,0,0,3,3,0.0%,16m
23158,2,EbBase,2827,689,198,181,379,52.2%,11m
23158,2,klink,2827,1573,138,129,267,51.7%,5m
23158,2,AllSaintsDay,2827,802,37,41,78,47.4%,4m
23158,2,Harlekinho,2827,805,29,36,65,44.6%,9m
23158,3,Superinse,2827,574,22,19,41,53.7%,2m
23158,3,[SSC2]korsakov,2827,366,14,13,27,51.9%,3m
23158,3,Ratezzy,2827,280,11,11,22,50.0%,10m
23158,3,[G2I]LonelyProbe,2827,262,10,9,19,52.6%,9m
23158,1,Talarea,2827,193,6,5,11,54.5%,4m
23158,1,MiloSmith,2827,0,5,2,7,71.4%,9m
23158,3,Barryl,2827,174,5,8,13,38.5%,15m
23158,3,hdi,2827,86,4,6,10,40.0%,5m
23158,3,[InFy]Erduyta,2827,114,4,7,11,36.4%,8m
23158,2,cos,2827,124,4,13,17,23.5%,9m
23158,2,blecho,2827,0,3,2,5,60.0%,57m
23158,3,[eWRS]SovietTankie,2827,88,3,3,6,50.0%,9m
23158,3,Mavira,2827,30,2,3,5,40.0%,4m
23158,3,CryptoMan,2827,60,2,5,7,28.6%,4m
23158,3,HunteRavager,2827,0,1,0,1,100.0%,25m
23158,3,rickmass,2827,30,1,4,5,20.0%,4m
23158,2,[TGN]Blackened,2827,0,0,1,1,0.0%,4m
23158,3,Wisi,2827,0,0,1,1,0.0%,8m
23158,3,Snuggles,2827,0,0,5,5,0.0%,15m
23181,3,CHerOBukXpeH,2826,1561,120,109,229,52.4%,2m
23181,2,Bobo,2826,752,114,113,227,50.2%,17m
23181,2,Duffenzag,2826,1402,56,68,124,45.2%,26m
23181,2,virus,2826,1050,38,44,82,46.3%,22m
23181,3,Lokierin,2826,683,36,23,59,61.0%,16m
23181,3,TrailerHaze,2826,490,36,32,68,52.9%,10m
23181,3,hawkk,2826,388,31,25,56,55.4%,9m
23181,3,Mich,2826,312,12,11,23,52.2%,17m
23181,3,Chupakabra,2826,308,12,13,25,48.0%,17m
23181,2,tiltedhuman,2826,292,11,15,26,42.3%,12m
23181,2,DeathAngel,2826,257,10,10,20,50.0%,43m
23181,3,[TirolA]AluHuT,2826,234,9,7,16,56.2%,3m
23181,1,[WALLER]LaBotte,2826,224,9,10,19,47.4%,10m
23181,1,MPlordmaster,2826,182,8,7,15,53.3%,7m
23181,3,[BOTZ]CHIEFbrody,2826,158,6,9,15,40.0%,17m
23181,3,TessaBliss,2826,160,5,1,6,83.3%,8m
23181,3,[KNILCH]Schweinemett,2826,127,5,4,9,55.6%,24m
23181,3,ANIKI,2826,163,4,3,7,57.1%,11m
23181,3,Esseker,2826,94,4,3,7,57.1%,2m
23181,1,Krahos,2826,170,4,8,12,33.3%,60m
23181,3,Steep,2826,115,2,1,3,66.7%,18m
23181,1,[Da2P]Thors,2826,0,1,0,1,100.0%,48m
23181,1,Michnek,2826,0,1,0,1,100.0%,34m
23181,3,Ilda,2826,0,1,1,2,50.0%,17m
23181,2,Syl,2826,30,1,8,9,11.1%,15m
23181,2,[PGing]Vndetta,2826,0,0,1,1,0.0%,30m
23181,3,Kiwistaude,2826,0,0,1,1,0.0%,25m
23181,3,lamobot,2826,0,0,1,1,0.0%,15m
23181,1,[ZAIU]Nazzur,2826,0,0,2,2,0.0%,7m
23181,3,GrUmLee,2826,0,0,4,4,0.0%,8m
23211,1,tucholsky,2825,1612,633,635,1268,49.9%,15m
23211,2,Dinykh,2825,1207,104,91,195,53.3%,15m
23211,3,sliceoflife,2825,988,94,80,174,54.0%,8m
23211,3,JFive,2825,637,40,37,77,51.9%,26m
23211,3,GilleFra,2825,621,32,36,68,47.1%,24m
23211,3,eviltedy,2825,742,25,31,56,44.6%,16m
23211,3,Viola,2825,601,23,19,42,54.8%,13m
23211,3,KAPATEJIb,2825,193,16,12,28,57.1%,15m
23211,2,[GoBot]ILLIDAN,2825,466,16,19,35,45.7%,11m
23211,3,Alex,2825,243,14,7,21,66.7%,17m
23211,3,astana,2825,346,13,14,27,48.1%,17m
23211,3,SadMarine,2825,242,10,9,19,52.6%,4m
23211,3,[HBGSJR]qwaqsha,2825,224,9,3,12,75.0%,9m
23211,3,Niglafar,2825,298,9,8,17,52.9%,15m
23211,3,Ironfists,2825,226,8,9,17,47.1%,11m
23211,2,Mephon,2825,232,8,15,23,34.8%,10m
23211,3,Eidos,2825,176,7,5,12,58.3%,23m
23211,3,lIIlIIlIlllI,2825,250,7,11,18,38.9%,7m
23211,1,[2Pizzа]Nordry,2825,214,7,16,23,30.4%,16m
23211,3,Cheesecake,2825,173,6,1,7,85.7%,12m
23211,3,Berzerk,2825,206,6,4,10,60.0%,22m
23211,3,Omega,2825,149,6,4,10,60.0%,11m
23211,1,Atmos,2825,167,6,5,11,54.5%,16m
23211,3,eazY,2825,142,4,1,5,80.0%,15m
23211,3,Jackfull,2825,0,4,1,5,80.0%,5m
23211,3,REDvolution,2825,110,4,3,7,57.1%,6m
23211,1,soyCowboy,2825,48,4,5,9,44.4%,6m
23211,3,sƷxǀƑąƴȃ,2825,179,4,6,10,40.0%,51m
23211,3,[EBoI]RogalDorn,2825,148,3,4,7,42.9%,17m
23211,3,ThanosSnap,2825,120,3,5,8,37.5%,22m
23211,3,[InitRu]Fellax,2825,60,2,3,5,40.0%,26m
23211,3,Kiki,2825,62,2,5,7,28.6%,11m
23211,3,covid,2825,58,2,7,9,22.2%,5m
23211,1,LuciferSam,2825,0,1,0,1,100.0%,45m
23211,3,[Змлн]Molibdolin,2825,0,1,0,1,100.0%,23m
23211,2,[LMBD]LaZMariNE,2825,0,1,0,1,100.0%,1h
23211,3,TOSHETO,2825,0,1,0,1,100.0%,18m
23211,3,thehuter,2825,0,1,1,2,50.0%,9m
23211,3,Nooby,2825,0,0,1,1,0.0%,14m
23250,2,[фсо]JONiSEO,2824,1162,185,176,361,51.2%,24m
23250,3,Halestorm,2824,1346,172,157,329,52.3%,9m
23250,3,[NevSur]nurFischer,2824,1125,92,97,189,48.7%,6m
23250,3,ruix,2824,1566,90,77,167,53.9%,4m
23250,2,[LSPs]Daro,2824,1525,70,63,133,52.6%,11m
23250,3,Nervai,2824,1262,58,41,99,58.6%,4m
23250,3,DrKisel,2824,1362,56,51,107,52.3%,6m
23250,2,Madara,2824,921,56,51,107,52.3%,7m
23250,3,ilBATTERISTA,2824,1186,46,45,91,50.5%,10m
23250,3,omu,2824,830,40,23,63,63.5%,23m
23250,1,[NWGD]MirayGee,2824,949,37,37,74,50.0%,26m
23250,1,woodapple,2824,754,29,36,65,44.6%,6m
23250,3,AngryShawarm,2824,654,27,12,39,69.2%,15m
23250,1,[4BG]ZergoNino,2824,514,23,28,51,45.1%,16m
23250,2,MonkeY,2824,527,22,20,42,52.4%,24m
23250,3,Павел,2824,433,20,13,33,60.6%,8m
23250,3,MerPanama,2824,513,19,16,35,54.3%,3m
23250,2,Alexius,2824,335,14,18,32,43.8%,13m
23250,3,Napoléon,2824,297,11,6,17,64.7%,22m
23250,3,MaloyKiller,2824,264,10,8,18,55.6%,36m
23250,2,adamek,2824,282,10,13,23,43.5%,8m
23250,2,Dementria,2824,176,7,15,22,31.8%,14m
23250,3,vojta,2824,142,6,6,12,50.0%,5m
23250,3,GhoSt,2824,170,5,3,8,62.5%,3m
23250,2,Allatarious,2824,116,5,5,10,50.0%,12m
23250,3,[ILMOVO]Andu,2824,136,4,1,5,80.0%,7m
23250,3,Max,2824,118,4,5,9,44.4%,6m
23250,1,Yanodin,2824,48,4,5,9,44.4%,21m
23250,2,Kringe,2824,142,3,9,12,25.0%,4m
23250,3,Echo,2824,60,2,3,5,40.0%,23m
23250,3,Hebbe,2824,0,1,0,1,100.0%,3m
23250,2,[SryPod]Стул,2824,0,1,1,2,50.0%,19m
23250,3,ZergRushed,2824,30,1,2,3,33.3%,23m
23250,3,dots,2824,0,1,4,5,20.0%,24m
23250,2,Constantine,2824,0,0,1,1,0.0%,44m
23250,3,[3DE]JOSHAN,2824,0,0,1,1,0.0%,24m
23250,3,Mothyl,2824,0,0,2,2,0.0%,5m
23287,3,NightWish,2823,1494,192,169,361,53.2%,4m
23287,2,Problemative,2823,898,126,106,232,54.3%,2m
23287,2,lakerson,2823,1590,74,80,154,48.1%,9m
23287,3,KappaGandalf,2823,589,70,56,126,55.6%,4m
23287,3,Emperor,2823,1345,59,48,107,55.1%,7m
23287,2,BLANK,2823,596,26,21,47,55.3%,4m
23287,3,Oldern,2823,610,24,23,47,51.1%,4m
23287,3,Monos,2823,491,20,20,40,50.0%,22m
23287,3,ElWizzz,2823,426,19,13,32,59.4%,3m
23287,3,[KrnBrs]mik,2823,492,19,16,35,54.3%,17m
23287,2,OldBloke,2823,250,10,9,19,52.6%,18m
23287,3,[LAIDI]Zananto,2823,232,8,5,13,61.5%,26m
23287,3,Kurik,2823,195,7,5,12,58.3%,14m
23287,1,Moukito,2823,140,5,4,9,55.6%,19m
23287,1,osvald,2823,122,4,6,10,40.0%,7m
23287,3,Eldores,2823,60,3,3,6,50.0%,17m
23287,2,BoldMove,2823,0,3,3,6,50.0%,55m
23287,3,LittleYogik,2823,60,2,5,7,28.6%,5m
23287,3,[CCMC]Blbtailazcz,2823,0,1,0,1,100.0%,5m
23287,3,[GLIVET]Uber,2823,30,1,3,4,25.0%,23m
23287,3,victor,2823,0,0,1,1,0.0%,25m
23287,1,[MUUMI]Kumilelu,2823,0,0,1,1,0.0%,1h
23287,3,GameOfDrones,2823,0,0,1,1,0.0%,9m
23287,3,Sekâri,2823,0,0,1,1,0.0%,3m
23287,3,MOHTep,2823,0,0,1,1,0.0%,4m
23287,3,[oooboy]prizma,2823,0,0,1,1,0.0%,3m
23287,2,Aightial,2823,0,0,1,1,0.0%,19m
23287,3,StarKiller,2823,0,0,2,2,0.0%,11m
23315,3,master,2822,1484,95,87,182,52.2%,10m
23315,2,tinyZerg,2822,1369,84,82,166,50.6%,25m
23315,3,KarolZerg,2822,353,72,48,120,60.0%,5m
23315,2,EVGENFTF,2822,1236,50,52,102,49.0%,5m
23315,2,Neve,2822,673,41,38,79,51.9%,5m
23315,2,[TChaos]ooSuBSynKoo,2822,594,23,24,47,48.9%,5m
23315,2,yukecen,2822,585,21,21,42,50.0%,9m
23315,3,Single,2822,533,19,18,37,51.4%,9m
23315,3,Wingen,2822,453,18,16,34,52.9%,9m
23315,2,Nexussix,2822,285,12,10,22,54.5%,26m
23315,3,DeadFuturist,2822,279,11,8,19,57.9%,3m
23315,2,Rinoi,2822,282,11,11,22,50.0%,25m
23315,3,dikij,2822,86,4,2,6,66.7%,25m
23315,3,Onichi,2822,147,4,3,7,57.1%,4m
23315,3,[BDSME]KiToToo,2822,30,4,4,8,50.0%,11m
23315,2,DarkSerg,2822,48,4,4,8,50.0%,28m
23315,3,[CHCANO]ExtStriker,2822,120,4,10,14,28.6%,8m
23315,3,стас,2822,113,3,1,4,75.0%,9m
23315,3,llllllllllll,2822,58,3,2,5,60.0%,17m
23315,3,Sanity,2822,34,2,3,5,40.0%,47m
23315,3,[gSub]HunteR,2822,30,2,6,8,25.0%,14m
23315,1,FuNeRoCk,2822,0,1,0,1,100.0%,1h
23315,3,[D0N3]Frank,2822,97,1,3,4,25.0%,17m
23315,3,Nudo,2822,30,1,3,4,25.0%,16m
23315,3,[ph3no]FraukePetry,2822,0,0,1,1,0.0%,22m
23315,3,BioLizzard,2822,0,0,1,1,0.0%,17m
23315,3,[HelH]SergeyZZZerg,2822,0,0,1,1,0.0%,23m
23315,3,Goldeagle,2822,0,0,1,1,0.0%,15m
23315,3,GeneralDuke,2822,0,0,1,1,0.0%,23m
23315,3,Ellium,2822,0,0,2,2,0.0%,3m
23315,3,Drus,2822,0,0,2,2,0.0%,23m
23346,3,Vorito,2821,1439,67,51,118,56.8%,23m
23346,3,[KON]HammerFall,2821,888,58,46,104,55.8%,5m
23346,3,PeZee,2821,1198,55,35,90,61.1%,3m
23346,1,Vivi,2821,1058,41,44,85,48.2%,3m
23346,3,Kidvento,2821,577,40,27,67,59.7%,4m
23346,3,Sazed,2821,855,37,32,69,53.6%,12m
23346,3,LightWarrior,2821,561,30,17,47,63.8%,10m
23346,2,Bief,2821,661,26,23,49,53.1%,4m
23346,1,DronesCanFly,2821,594,19,33,52,36.5%,16m
23346,3,tScAmez,2821,173,18,16,34,52.9%,4m
23346,3,xanhast,2821,243,18,23,41,43.9%,23m
23346,3,MegaDeath,2821,97,10,4,14,71.4%,4m
23346,1,CrabMan,2821,275,8,6,14,57.1%,7m
23346,3,Amfy,2821,204,8,8,16,50.0%,51m
23346,2,Kerrigan,2821,178,7,9,16,43.8%,14m
23346,3,Gaius,2821,142,5,6,11,45.5%,24m
23346,2,Alter,2821,118,4,3,7,57.1%,30m
23346,2,Steamjunk,2821,46,4,4,8,50.0%,55m
23346,2,Smudge,2821,0,3,3,6,50.0%,7m
23346,3,nightdancer,2821,0,3,3,6,50.0%,24m
23346,2,Esebian,2821,0,3,3,6,50.0%,49m
23346,2,[QTcIub]Rafart,2821,48,3,4,7,42.9%,34m
23346,3,Wolv,2821,0,1,1,2,50.0%,11m
23346,3,Sverok,2821,30,1,17,18,5.6%,4m
23346,3,WitzeClown,2821,0,0,1,1,0.0%,15m
23346,2,HeroZergling,2821,0,0,1,1,0.0%,5m
23346,1,Buzan,2821,0,0,1,1,0.0%,6m
23346,3,CrazyZerg,2821,0,0,1,1,0.0%,14m
23346,3,RoseRosfold,2821,0,0,2,2,0.0%,3m
23375,3,John,2820,1439,144,128,272,52.9%,9m
23375,3,Kai,2820,1513,116,84,200,58.0%,12m
23375,1,Alshedow,2820,1256,71,83,154,46.1%,3m
23375,3,Ferry,2820,1604,70,58,128,54.7%,4m
23375,2,Evergreen,2820,914,39,47,86,45.3%,17m
23375,3,Ivan,2820,885,37,28,65,56.9%,5m
23375,2,[RAINER]schRAINER,2820,898,34,40,74,45.9%,5m
23375,3,Mike,2820,609,30,19,49,61.2%,11m
23375,3,[ZZT]Logistix,2820,632,26,31,57,45.6%,12m
23375,3,Alex,2820,628,23,25,48,47.9%,17m
23375,3,Scroggy,2820,531,22,23,45,48.9%,10m
23375,3,[NSJLM]XeQiu,2820,389,20,10,30,66.7%,23m
23375,3,Chapis,2820,498,18,21,39,46.2%,10m
23375,2,Stagnator,2820,530,18,23,41,43.9%,4m
23375,2,[PRUTLL]Kezno,2820,479,17,22,39,43.6%,7m
23375,3,Scipion,2820,354,14,12,26,53.8%,18m
23375,3,simson,2820,414,14,13,27,51.9%,4m
23375,2,DeWitt,2820,289,12,11,23,52.2%,16m
23375,3,CoronaJack,2820,286,11,11,22,50.0%,8m
23375,2,[Mavis]ussela,2820,316,11,17,28,39.3%,14m
23375,3,Beiz,2820,194,7,7,14,50.0%,3m
23375,2,Hhiruma,2820,120,7,12,19,36.8%,31m
23375,1,minime,2820,186,6,5,11,54.5%,7m
23375,3,Abstaubear,2820,113,5,0,5,100.0%,11m
23375,3,павилитель,2820,161,5,3,8,62.5%,8m
23375,2,Shelby,2820,150,5,16,21,23.8%,9m
23375,3,ChriSLinkz,2820,114,4,5,9,44.4%,5m
23375,3,ЗлойГном,2820,136,3,3,6,50.0%,15m
23375,3,[V3S]Lutfisk,2820,92,3,5,8,37.5%,8m
23375,2,[NepNep]Planeptune,2820,155,3,10,13,23.1%,10m
23375,3,BabiboB,2820,60,2,4,6,33.3%,1m
23375,3,synka,2820,0,1,0,1,100.0%,4m
23375,3,[WАIFU]mosquitokil,2820,0,1,0,1,100.0%,8m
23375,3,tigu,2820,0,1,1,2,50.0%,47m
23375,3,[THINK]Eska,2820,94,1,5,6,16.7%,3m
23375,3,Dahaka,2820,0,0,1,1,0.0%,4m
23375,3,[Nvtrnt]Kllians,2820,0,0,1,1,0.0%,1m
23412,3,Crafty,2819,1388,128,108,236,54.2%,16m
23412,3,[FGYT]Wiviiides,2819,1560,81,78,159,50.9%,16m
23412,3,LinKendel,2819,1424,65,43,108,60.2%,14m
23412,3,Misty,2819,1395,65,50,115,56.5%,7m
23412,3,Gogogo,2819,1204,51,44,95,53.7%,2m
23412,3,GerRomell,2819,955,44,30,74,59.5%,25m
23412,2,[Gordi]Necromonger,2819,507,36,33,69,52.2%,12m
23412,3,Frostbite,2819,647,31,24,55,56.4%,4m
23412,3,[ACC]Gromold,2819,687,29,20,49,59.2%,7m
23412,3,TommyRelax,2819,454,20,17,37,54.1%,24m
23412,2,[HZeS]CheckLeds,2819,427,20,20,40,50.0%,8m
23412,3,Robinator,2819,397,17,8,25,68.0%,16m
23412,3,[OGR232]SkillEnota,2819,192,15,7,22,68.2%,10m
23412,2,TheFather,2819,276,10,13,23,43.5%,25m
23412,3,Aakrop,2819,277,9,7,16,56.2%,3m
23412,3,DoKadjit,2819,228,8,4,12,66.7%,9m
23412,2,DrugAddict,2819,198,8,8,16,50.0%,25m
23412,1,[xDiamx]javelo,2819,214,8,11,19,42.1%,5m
23412,3,Roarshark,2819,60,7,2,9,77.8%,1m
23412,3,Iron,2819,209,7,9,16,43.8%,1m
23412,3,Rokatansky,2819,174,6,2,8,75.0%,13m
23412,3,Namaste,2819,174,6,6,12,50.0%,9m
23412,2,[RatG]Sorrowblade,2819,180,6,12,18,33.3%,9m
23412,3,[BoLLeK]oLLeK,2819,156,4,3,7,57.1%,2m
23412,3,[яєѕ]Zergius,2819,30,1,3,4,25.0%,6m
23412,3,mirceaadrian,2819,0,1,4,5,20.0%,24m
23412,3,[Frogy]GringoLoco,2819,0,0,1,1,0.0%,11m
23412,3,Oshikuru,2819,0,0,1,1,0.0%,26m
23412,3,Monser,2819,0,0,1,1,0.0%,10m
23412,3,[TAСО]ZLODNIKOV,2819,0,0,2,2,0.0%,16m
23412,3,BlackBetty,2819,0,0,3,3,0.0%,25m
23443,3,nathanbbrown,2818,1056,48,47,95,50.5%,11m
23443,3,[ZЕRGТV]NEFIRU,2818,664,34,14,48,70.8%,4m
23443,3,OxiBoxI,2818,535,23,15,38,60.5%,14m
23443,2,Dan,2818,626,22,31,53,41.5%,12m
23443,3,[EOCTH]DuDie,2818,466,18,19,37,48.6%,10m
23443,3,CoaxyuM,2818,389,16,9,25,64.0%,17m
23443,3,[696]GWWolf,2818,430,16,13,29,55.2%,14m
23443,3,[ONLAN]Kalexx,2818,340,13,14,27,48.1%,26m
23443,3,SaintieL,2818,308,11,9,20,55.0%,3m
23443,3,[NCtk]Rage,2818,258,9,14,23,39.1%,4m
23443,3,Kringon,2818,256,8,9,17,47.1%,11m
23443,3,[FiIthy]Yoshi,2818,229,7,8,15,46.7%,1m
23443,2,CoCoKyJIuTKu,2818,173,7,8,15,46.7%,25m
23443,3,SockCucker,2818,196,7,11,18,38.9%,46m
23443,3,[Домик]pAnDa,2818,169,5,4,9,55.6%,25m
23443,3,[Kaiju]ChiefJustice,2818,146,5,6,11,45.5%,15m
23443,1,isomis,2818,201,5,10,15,33.3%,43m
23443,3,ZIGA,2818,135,4,0,4,100.0%,12m
23443,2,[EAASY]TheDude,2818,0,2,1,3,66.7%,1m
23443,3,Matthew,2818,30,2,1,3,66.7%,6m
23443,3,Nicknackboo,2818,113,2,1,3,66.7%,9m
23443,3,Artemis,2818,58,2,4,6,33.3%,26m
23443,3,[THC420]Junky,2818,0,1,0,1,100.0%,4m
23443,3,darkclay,2818,0,1,0,1,100.0%,14m
23443,1,[TPOEG]Nooneknows,2818,97,1,2,3,33.3%,7m
23443,3,CodeX,2818,0,0,1,1,0.0%,4m
23443,3,[CStar]Viryus,2818,0,0,1,1,0.0%,6m
23443,3,jjeppson,2818,0,0,1,1,0.0%,4m
23443,3,Dogland,2818,0,0,1,1,0.0%,10m
23443,3,Nam,2818,0,0,1,1,0.0%,17m
23443,3,Magicadam,2818,0,0,2,2,0.0%,6m
23443,3,Decebal,2818,0,0,2,2,0.0%,6m
23443,3,Аларак,2818,0,0,6,6,0.0%,3m
23476,2,astroboombo,2817,1496,275,259,534,51.5%,25m
23476,1,BobKelso,2817,1567,255,257,512,49.8%,1m
23476,1,Judoman,2817,1444,157,152,309,50.8%,7m
23476,2,rushboxx,2817,1549,152,155,307,49.5%,8m
23476,2,Hellscream,2817,1426,64,60,124,51.6%,7m
23476,3,Biohazzard,2817,1215,50,40,90,55.6%,9m
23476,3,Intoxikot,2817,656,42,27,69,60.9%,24m
23476,2,[OFocus]Furnus,2817,754,25,34,59,42.4%,14m
23476,3,[NotSuR]xtkbr,2817,630,23,21,44,52.3%,8m
23476,3,[BABYSS]utgard,2817,300,17,13,30,56.7%,8m
23476,3,barcode,2817,344,14,8,22,63.6%,9m
23476,3,[34glhf]CCsCq,2817,316,14,8,22,63.6%,4m
23476,3,Ago,2817,325,14,13,27,51.9%,5m
23476,3,ivanko,2817,327,11,12,23,47.8%,4m
23476,3,Coriolanus,2817,155,10,0,10,100.0%,26m
23476,3,FanTastiC,2817,179,9,4,13,69.2%,4m
23476,2,StasOda,2817,232,9,11,20,45.0%,1h
23476,3,jaimenak,2817,199,7,7,14,50.0%,4m
23476,2,timur,2817,90,6,6,12,50.0%,8m
23476,3,Коражёр,2817,107,5,1,6,83.3%,17m
23476,1,org,2817,141,5,3,8,62.5%,58m
23476,3,[Tales]Russltime,2817,192,5,5,10,50.0%,8m
23476,1,[PTZ]Lxp,2817,124,5,5,10,50.0%,36m
23476,3,[LAVA]Painkiller,2817,153,5,6,11,45.5%,10m
23476,3,[Side]inteam,2817,86,4,3,7,57.1%,4m
23476,2,Arlesko,2817,46,4,3,7,57.1%,56m
23476,2,Tessio,2817,138,4,4,8,50.0%,29m
23476,3,Harderer,2817,119,4,4,8,50.0%,13m
23476,3,[Sarmat]Majkelrooshi,2817,118,4,6,10,40.0%,8m
23476,3,palson,2817,135,3,3,6,50.0%,13m
23476,3,[swagtv]perry,2817,0,3,3,6,50.0%,4m
23476,3,ToxicRussian,2817,30,3,4,7,42.9%,9m
23476,1,Mancee,2817,0,3,5,8,37.5%,24m
23476,3,[JaPP]Komisar,2817,0,1,0,1,100.0%,8m
23476,2,Kocim,2817,0,1,2,3,33.3%,34m
23476,3,Siol,2817,30,1,7,8,12.5%,14m
23512,2,Midnight,2816,1516,138,145,283,48.8%,12m
23512,1,Lonetuft,2816,1561,110,108,218,50.5%,12m
23512,3,larrifari,2816,409,58,36,94,61.7%,1m
23512,3,karroni,2816,861,52,44,96,54.2%,7m
23512,3,PyroMathic,2816,1028,46,34,80,57.5%,9m
23512,1,Mouskuri,2816,938,32,45,77,41.6%,3m
23512,3,[РакПак]kardan,2816,217,23,14,37,62.2%,10m
23512,3,Exsorcist,2816,556,22,15,37,59.5%,9m
23512,2,Zebulon,2816,401,20,14,34,58.8%,4m
23512,3,collapsz,2816,385,14,11,25,56.0%,17m
23512,2,[PeDC]Moch,2816,388,13,21,34,38.2%,25m
23512,3,[mrcoh]Deeew,2816,308,12,12,24,50.0%,24m
23512,3,MagicDiamond,2816,333,11,9,20,55.0%,11m
23512,3,Markl,2816,225,11,10,21,52.4%,17m
23512,2,Merterer,2816,205,10,9,19,52.6%,12m
23512,2,[Schabe]Napoleon,2816,255,9,6,15,60.0%,54m
23512,3,ТЭД,2816,158,7,3,10,70.0%,6m
23512,3,Ryper,2816,142,6,6,12,50.0%,25m
23512,3,Sanji,2816,168,6,6,12,50.0%,7m
23512,3,kingwieser,2816,150,6,6,12,50.0%,11m
23512,1,LakY,2816,166,5,3,8,62.5%,18m
23512,3,Limeila,2816,120,5,5,10,50.0%,24m
23512,2,XENOMORPHPL,2816,94,5,5,10,50.0%,45m
23512,3,Leo,2816,152,5,8,13,38.5%,4m
23512,3,Congress,2816,109,4,3,7,57.1%,10m
23512,3,VOO,2816,90,4,4,8,50.0%,9m
23512,1,MeatBaIIz,2816,84,4,8,12,33.3%,48m
23512,3,shellschock,2816,115,3,0,3,100.0%,5m
23512,3,RBN,2816,118,3,1,4,75.0%,2m
23512,3,bOUNCY,2816,115,2,1,3,66.7%,15m
23512,3,Radus,2816,30,2,1,3,66.7%,26m
23512,3,MrMiddleTv,2816,0,1,0,1,100.0%,3m
23512,1,[TheD]Ancorage,2816,97,1,2,3,33.3%,48m
23512,3,[2KY]Keer,2816,30,1,2,3,33.3%,11m
23512,2,BananaKing,2816,0,1,5,6,16.7%,59m
23512,3,[bqobd]nik,2816,30,1,6,7,14.3%,24m
23512,3,LuckyFlower,2816,0,0,1,1,0.0%,15m
23512,3,Kapitaine,2816,0,0,1,1,0.0%,2m
23512,3,Menkar,2816,0,0,2,2,0.0%,8m
23512,3,sergey,2816,0,0,2,2,0.0%,5m
23512,3,Fischbrot,2816,0,0,3,3,0.0%,12m
23512,3,MrRakalDino,2816,0,0,3,3,0.0%,11m
23554,2,Crespo,2815,1588,253,257,510,49.6%,8m
23554,3,[PowOw]FluffyRSA,2815,804,81,72,153,52.9%,15m
23554,3,[Klaz]IsakJr,2815,1598,78,60,138,56.5%,10m
23554,1,Vérmes,2815,1060,70,81,151,46.4%,7m
23554,3,Kbry,2815,1027,54,39,93,58.1%,25m
23554,3,JustFox,2815,982,49,32,81,60.5%,13m
23554,3,Karnaval,2815,925,42,27,69,60.9%,7m
23554,3,PuPsik,2815,810,39,19,58,67.2%,15m
23554,2,CokBoks,2815,884,39,38,77,50.6%,9m
23554,3,SimonDm,2815,935,34,33,67,50.7%,18m
23554,2,[HWL]Kekke,2815,716,29,28,57,50.9%,25m
23554,3,Mars,2815,680,28,25,53,52.8%,8m
23554,3,Lohk,2815,506,25,8,33,75.8%,16m
23554,3,Ricutor,2815,221,25,22,47,53.2%,24m
23554,2,Hans,2815,610,21,25,46,45.7%,3m
23554,3,[Br0k3n]Wingz,2815,393,15,14,29,51.7%,26m
23554,3,hanny,2815,400,14,16,30,46.7%,25m
23554,3,Akai,2815,295,11,13,24,45.8%,3m
23554,3,[ASS]Konrad,2815,266,10,4,14,71.4%,16m
23554,2,nooby,2815,265,10,14,24,41.7%,14m
23554,1,[L4DYS]MissTake,2815,246,8,5,13,61.5%,35m
23554,3,[XLAG]nephilim,2815,208,8,10,18,44.4%,26m
23554,3,Cylonn,2815,186,6,3,9,66.7%,4m
23554,2,Canoa,2815,218,6,12,18,33.3%,11m
23554,3,[WАSD]TeddyCrew,2815,105,5,5,10,50.0%,24m
23554,2,Larans,2815,92,5,5,10,50.0%,40m
23554,3,[ANSS]SparkWOD,2815,118,4,6,10,40.0%,3m
23554,3,Dune,2815,122,3,2,5,60.0%,25m
23554,3,[TLD]cHaOs,2815,0,3,2,5,60.0%,3m
23554,3,nosferatu,2815,90,3,5,8,37.5%,8m
23554,3,FUSHIA,2815,86,3,6,9,33.3%,16m
23554,3,Proffel,2815,115,2,2,4,50.0%,17m
23554,3,[Psevdo]TapeFace,2815,30,2,2,4,50.0%,17m
23554,2,Hoek,2815,114,2,5,7,28.6%,29m
23554,3,[TePoGa]PoleCat,2815,97,1,1,2,50.0%,47m
23554,1,maZya,2815,96,1,1,2,50.0%,21m
23554,3,Yosei,2815,30,1,4,5,20.0%,10m
23554,3,[Heel]derBimbo,2815,0,0,1,1,0.0%,11m
23554,3,[gllv]grantmal,2815,0,0,1,1,0.0%,25m
23554,3,Probocis,2815,0,0,1,1,0.0%,4m
23594,3,Beo,2814,1578,151,134,285,53.0%,5m
23594,1,[mohu]nosnicu,2814,1317,138,134,272,50.7%,24m
23594,1,Narrator,2814,1101,85,98,183,46.4%,13m
23594,3,GoGo,2814,1492,81,77,158,51.3%,25m
23594,2,BANEinASS,2814,990,63,62,125,50.4%,11m
23594,3,Rolly,2814,717,36,13,49,73.5%,11m
23594,3,BabaUB,2814,892,35,31,66,53.0%,14m
23594,3,Bledge,2814,558,23,16,39,59.0%,2m
23594,3,Spartacus,2814,468,20,12,32,62.5%,25m
23594,3,[ShSq]Randomizer,2814,469,20,23,43,46.5%,7m
23594,3,Koba,2814,357,18,12,30,60.0%,10m
23594,3,soHigh,2814,332,16,6,22,72.7%,18m
23594,3,Albertfour,2814,372,14,14,28,50.0%,12m
23594,2,MeXaNiK,2814,206,10,9,19,52.6%,12m
23594,3,Saor,2814,142,10,14,24,41.7%,16m
23594,3,Castiel,2814,253,9,7,16,56.2%,9m
23594,2,TrueOG,2814,135,6,7,13,46.2%,8m
23594,2,Kubaman,2814,129,5,12,17,29.4%,4m
23594,3,LKNR,2814,116,4,5,9,44.4%,12m
23594,2,[Yame]perceval,2814,174,4,10,14,28.6%,10m
23594,3,Capidosia,2814,111,2,2,4,50.0%,5m
23594,2,jorgedk,2814,0,2,3,5,40.0%,20m
23594,3,Enivo,2814,0,1,1,2,50.0%,8m
23594,3,GeneralFrost,2814,30,1,3,4,25.0%,10m
23594,3,Doppelganger,2814,30,1,4,5,20.0%,11m
23594,3,kokops,2814,0,0,1,1,0.0%,17m
23594,1,NiKiTa,2814,0,0,1,1,0.0%,35m
23594,3,Medax,2814,0,0,1,1,0.0%,3m
23594,1,[IOGTVI]Lezgegos,2814,0,0,2,2,0.0%,46m
23594,3,qsdqsd,2814,0,0,2,2,0.0%,4m
23594,3,Seelnii,2814,0,0,2,2,0.0%,11m
23594,2,[МуDТ]BLIZ,2814,0,0,4,4,0.0%,1m
23594,3,oOoOoOo,2814,0,0,4,4,0.0%,12m
23627,2,pab,2813,1602,221,220,441,50.1%,1m
23627,1,Quasar,2813,1578,153,167,320,47.8%,9m
23627,3,Keltrain,2813,476,59,42,101,58.4%,5m
23627,3,[RekLaW]Weggal,2813,666,58,46,104,55.8%,9m
23627,3,Frenkiart,2813,1310,53,50,103,51.5%,3m
23627,1,Houswill,2813,1042,47,51,98,48.0%,25m
23627,2,Brainslug,2813,814,29,39,68,42.6%,15m
23627,3,[PiGPan]pinion,2813,620,27,23,50,54.0%,14m
23627,3,kid,2813,505,22,12,34,64.7%,16m
23627,3,Riel,2813,576,21,21,42,50.0%,26m
23627,2,ydear,2813,452,16,26,42,38.1%,11m
23627,2,Woland,2813,462,15,24,39,38.5%,7m
23627,2,KingChris,2813,389,14,17,31,45.2%,12m
23627,3,goodmanOK,2813,267,12,10,22,54.5%,7m
23627,3,Nightmare,2813,243,9,6,15,60.0%,8m
23627,3,Stim,2813,204,8,7,15,53.3%,11m
23627,3,MoNsTeR,2813,180,7,11,18,38.9%,16m
23627,2,Moriartik,2813,167,6,1,7,85.7%,42m
23627,3,[strael]Karvu,2813,189,6,3,9,66.7%,11m
23627,3,Crux,2813,185,6,4,10,60.0%,12m
23627,2,YeZealver,2813,120,6,10,16,37.5%,9m
23627,3,[CUBITA]pap,2813,0,4,5,9,44.4%,5m
23627,3,KaShvtaal,2813,120,4,7,11,36.4%,5m
23627,3,Fox,2813,30,2,2,4,50.0%,4m
23627,3,HellsCream,2813,30,2,3,5,40.0%,3m
23627,3,[Mronn]Warburton,2813,0,1,0,1,100.0%,13m
23627,3,Taiga,2813,0,0,1,1,0.0%,39m
23627,3,AmZDexxxxxxx,2813,0,0,2,2,0.0%,2m
23627,3,[FRKISS]Nep,2813,0,0,2,2,0.0%,14m
23656,2,destinyisall,2812,1574,135,120,255,52.9%,14m
23656,2,Spionu,2812,1520,105,107,212,49.5%,4m
23656,3,[JJBZ]LawnMower,2812,1003,67,53,120,55.8%,7m
23656,3,ahmad,2812,952,45,36,81,55.6%,10m
23656,2,gladiator,2812,542,27,26,53,50.9%,25m
23656,2,Opa,2812,694,27,28,55,49.1%,9m
23656,3,AndyTRAMBLEx,2812,609,25,31,56,44.6%,3m
23656,2,ParaZite,2812,392,20,22,42,47.6%,7m
23656,2,[ZLOBOZ]SSavernake,2812,316,19,21,40,47.5%,17m
23656,3,[MacG]Mattlinn,2812,287,15,0,15,100.0%,25m
23656,3,DiSBond,2812,241,14,8,22,63.6%,26m
23656,3,[NucPus]LeoLanser,2812,302,11,11,22,50.0%,5m
23656,3,[sampad]titop,2812,297,10,8,18,55.6%,16m
23656,3,MucaMeow,2812,274,9,12,21,42.9%,1m
23656,2,[RJNP]Farcy,2812,94,5,5,10,50.0%,56m
23656,3,[ZЕRGТV]ReMbO,2812,141,4,1,5,80.0%,11m
23656,2,FARSH,2812,130,4,5,9,44.4%,4m
23656,3,XzyrXos,2812,90,4,6,10,40.0%,7m
23656,3,[film]ghosten,2812,134,3,1,4,75.0%,10m
23656,1,Банкай,2812,0,3,4,7,42.9%,59m
23656,3,[EmOfEv]Emperor,2812,94,2,0,2,100.0%,16m
23656,1,alex,2812,97,2,1,3,66.7%,32m
23656,3,[CWPM]TechTronic,2812,58,2,3,5,40.0%,17m
23656,3,NaMeLeSs,2812,30,2,3,5,40.0%,11m
23656,2,[KSRF]MaXTnT,2812,102,2,7,9,22.2%,1m
23656,2,koment,2812,0,1,0,1,100.0%,49m
23656,3,[JIH]Anomander,2812,30,1,4,5,20.0%,26m
23656,2,Icecube,2812,0,1,6,7,14.3%,7m
23656,3,IIIIIIIIIIII,2812,0,0,1,1,0.0%,16m
23656,3,JakJu,2812,0,0,2,2,0.0%,1m
23686,3,Rookskerm,2811,1459,147,132,279,52.7%,1m
23686,3,Xxnoobslayer,2811,975,43,23,66,65.2%,4m
23686,3,Whyes,2811,475,21,9,30,70.0%,25m
23686,3,camper,2811,473,21,10,31,67.7%,11m
23686,3,sensii,2811,231,21,22,43,48.8%,10m
23686,3,Snusmumrik,2811,402,17,8,25,68.0%,17m
23686,2,LiquidAdri,2811,416,15,18,33,45.5%,15m
23686,2,Yayayayaya,2811,194,15,18,33,45.5%,7m
23686,3,SantaKlaus,2811,331,14,6,20,70.0%,12m
23686,3,IOPCOH,2811,238,12,13,25,48.0%,10m
23686,3,[roph]Manny,2811,268,10,12,22,45.5%,10m
23686,3,IFELSE,2811,273,8,14,22,36.4%,3m
23686,3,Kaffitørst,2811,136,7,2,9,77.8%,24m
23686,3,Mangeling,2811,146,7,6,13,53.8%,39m
23686,1,OturanBoga,2811,138,7,6,13,53.8%,19m
23686,3,[Hanz0]linonemas,2811,167,5,3,8,62.5%,9m
23686,1,Milos,2811,120,5,4,9,55.6%,1h
23686,3,Health,2811,58,5,5,10,50.0%,16m
23686,1,ChinoGemiDj,2811,121,4,5,9,44.4%,40m
23686,3,Shaggy,2811,140,4,7,11,36.4%,17m
23686,3,baboushka,2811,86,4,8,12,33.3%,13m
23686,2,Gerpu,2811,0,3,3,6,50.0%,1h
23686,2,Echo,2811,48,2,5,7,28.6%,18m
23686,1,Foxits,2811,0,1,1,2,50.0%,7m
23686,3,[пепега]Farmacevt,2811,0,0,1,1,0.0%,7m
23686,3,KrotZalupa,2811,0,0,1,1,0.0%,10m
23686,3,Next,2811,0,0,2,2,0.0%,8m
23713,1,Zoidberg,2810,1591,403,385,788,51.1%,5m
23713,3,Barbosix,2810,1615,262,247,509,51.5%,9m
23713,2,Dettus,2810,1586,253,233,486,52.1%,15m
23713,2,oiашотакоеoi,2810,1035,237,240,477,49.7%,15m
23713,3,Sanity,2810,1535,223,217,440,50.7%,5m
23713,2,Ripper,2810,1578,171,165,336,50.9%,13m
23713,3,Chasokin,2810,1342,153,123,276,55.4%,2m
23713,3,Mercury,2810,1581,71,74,145,49.0%,6m
23713,3,[skh]flip,2810,939,65,54,119,54.6%,9m
23713,2,Норберт,2810,917,64,54,118,54.2%,15m
23713,3,cRg,2810,1394,59,59,118,50.0%,17m
23713,2,[GTMNG]shadows,2810,1308,58,52,110,52.7%,13m
23713,2,ToastKing,2810,604,34,30,64,53.1%,25m
23713,2,Neths,2810,840,30,37,67,44.8%,13m
23713,3,Storm,2810,581,24,18,42,57.1%,18m
23713,3,[VITESS]ZEEMAN,2810,456,17,16,33,51.5%,9m
23713,3,priceman,2810,281,16,15,31,51.6%,6m
23713,1,DSG,2810,394,12,25,37,32.4%,3m
23713,2,florze,2810,294,11,11,22,50.0%,34m
23713,3,borzwarrior,2810,270,9,12,21,42.9%,6m
23713,3,LovkiZerg,2810,191,8,6,14,57.1%,11m
23713,3,BrightLord,2810,246,8,13,21,38.1%,13m
23713,3,Kixi,2810,205,7,8,15,46.7%,14m
23713,2,[xFRSx]aNarCHy,2810,186,6,12,18,33.3%,1m
23713,2,DIW,2810,176,6,13,19,31.6%,9m
23713,3,WEEDMASTER,2810,119,5,3,8,62.5%,15m
23713,3,faker,2810,196,5,5,10,50.0%,11m
23713,3,tracking,2810,140,5,7,12,41.7%,18m
23713,3,yunayayuna,2810,167,5,8,13,38.5%,3m
23713,3,llllllll,2810,159,4,5,9,44.4%,5m
23713,3,AgraiL,2810,134,3,2,5,60.0%,11m
23713,3,[ZATAAN]pldeluxe,2810,64,2,3,5,40.0%,35m
23713,3,DaZiim,2810,129,2,4,6,33.3%,50m
23713,3,[F3N]Dragoon,2810,0,1,0,1,100.0%,3m
23713,1,Баклажан,2810,0,1,0,1,100.0%,58m
23713,3,Dentistul,2810,94,1,1,2,50.0%,4m
23713,3,Zerugiro,2810,0,1,2,3,33.3%,16m
23713,3,DeathL,2810,0,0,1,1,0.0%,9m
23713,3,ElGognolo,2810,0,0,2,2,0.0%,6m
23752,3,Marvin,2809,1150,51,39,90,56.7%,2m
23752,2,Zhumamurat,2809,1360,51,56,107,47.7%,25m
23752,2,MeisterFips,2809,962,46,44,90,51.1%,10m
23752,3,Skagg,2809,884,39,30,69,56.5%,1m
23752,3,player,2809,659,36,8,44,81.8%,9m
23752,3,SaladOthon,2809,789,31,29,60,51.7%,15m
23752,3,[Xpl0dE]vitez,2809,755,29,22,51,56.9%,24m
23752,3,TheLIghtning,2809,561,23,16,39,59.0%,4m
23752,3,Mde,2809,501,20,18,38,52.6%,9m
23752,3,nonono,2809,500,19,25,44,43.2%,26m
23752,3,[BMF]SID,2809,397,17,10,27,63.0%,3m
23752,3,vadimhalo,2809,393,14,10,24,58.3%,3m
23752,1,Deadly,2809,363,14,17,31,45.2%,25m
23752,3,PKBOSS,2809,153,13,5,18,72.2%,1m
23752,3,[GH2]Xanto,2809,295,12,7,19,63.2%,1m
23752,2,Coeurbrave,2809,280,9,8,17,52.9%,28m
23752,3,BandonBanshe,2809,236,9,8,17,52.9%,18m
23752,2,[BloTi]Dreamode,2809,191,8,8,16,50.0%,2m
23752,3,TBapb,2809,144,8,9,17,47.1%,4m
23752,3,Karotter,2809,206,7,4,11,63.6%,25m
23752,3,Zaurgiauth,2809,155,7,5,12,58.3%,3m
23752,3,yamamotsu,2809,189,7,7,14,50.0%,3m
23752,3,Lôrdevil,2809,174,7,9,16,43.8%,18m
23752,3,Ito,2809,198,6,7,13,46.2%,3m
23752,3,[iLight]Atlas,2809,180,6,8,14,42.9%,9m
23752,3,Макуха,2809,189,5,3,8,62.5%,6m
23752,2,Baozi,2809,46,5,7,12,41.7%,20m
23752,3,Neuro,2809,0,4,4,8,50.0%,25m
23752,3,XccX,2809,113,4,4,8,50.0%,4m
23752,1,[StOuHa]Flusooo,2809,145,4,6,10,40.0%,45m
23752,2,Hell,2809,46,3,4,7,42.9%,24m
23752,3,Hassle,2809,30,2,1,3,66.7%,17m
23752,3,Malus,2809,0,2,3,5,40.0%,3m
23752,3,Patrick,2809,60,2,4,6,33.3%,15m
23752,3,Ingi,2809,141,2,7,9,22.2%,7m
23752,3,BKG,2809,58,2,8,10,20.0%,8m
23752,2,Zaurito,2809,0,1,1,2,50.0%,57m
23752,3,Pyp,2809,93,1,1,2,50.0%,15m
23752,2,[TиCo]RedDotOnMap,2809,0,1,3,4,25.0%,2m
23752,3,SombreroPlz,2809,30,1,3,4,25.0%,2m
23752,3,Fantom,2809,25,1,4,5,20.0%,4m
23752,3,Fizi,2809,30,1,5,6,16.7%,25m
23752,3,[AnimeF]TheNightZerg,2809,0,0,1,1,0.0%,9m
23752,3,TrikyZerg,2809,0,0,2,2,0.0%,5m
23752,3,CCF,2809,0,0,3,3,0.0%,7m
23797,1,Hollenegger,2808,1575,416,416,832,50.0%,3m
23797,2,chris,2808,1580,223,203,426,52.3%,10m
23797,2,shlanga,2808,1457,155,133,288,53.8%,7m
23797,3,TrooperTi,2808,1078,127,111,238,53.4%,3m
23797,3,[SLGH]sova,2808,1605,112,100,212,52.8%,1m
23797,3,Franky,2808,1283,102,85,187,54.5%,5m
23797,2,Knurek,2808,1205,92,94,186,49.5%,7m
23797,3,[ESPTNP]DayvanCowboy,2808,1496,68,59,127,53.5%,17m
23797,3,YVKA,2808,1296,62,42,104,59.6%,18m
23797,3,Voidead,2808,1331,55,48,103,53.4%,5m
23797,3,Artem,2808,1184,51,40,91,56.0%,17m
23797,3,ELpedios,2808,742,37,28,65,56.9%,17m
23797,1,KellerPoland,2808,841,36,53,89,40.4%,16m
23797,3,Silomad,2808,644,23,28,51,45.1%,25m
23797,3,[FBDY]Panda,2808,383,16,12,28,57.1%,7m
23797,3,Komics,2808,177,16,15,31,51.6%,17m
23797,2,[Heroes]tiwaheronud,2808,290,14,11,25,56.0%,14m
23797,3,bunny,2808,339,12,10,22,54.5%,5m
23797,3,ubiuka,2808,316,12,13,25,48.0%,12m
23797,3,Hulimulin,2808,200,8,8,16,50.0%,26m
23797,2,tochka,2808,267,7,13,20,35.0%,18m
23797,3,[Cannоn]Lukas,2808,182,6,2,8,75.0%,14m
23797,3,Kassidy,2808,0,6,4,10,60.0%,24m
23797,3,llllllllllll,2808,146,4,3,7,57.1%,9m
23797,3,[SEBULA]Papiq,2808,118,4,4,8,50.0%,18m
23797,3,Vadim,2808,0,1,0,1,100.0%,3m
23797,3,Freakshot,2808,94,1,1,2,50.0%,27m
23797,3,[VPP]VISION,2808,93,1,1,2,50.0%,11m
23797,3,[x67x]ROHoZ,2808,0,0,1,1,0.0%,26m
23797,2,[111110]DutchPepe,2808,0,0,1,1,0.0%,40m
23797,2,DangerMouse,2808,0,0,1,1,0.0%,39m
23797,3,IIxtechnoxII,2808,0,0,1,1,0.0%,26m
23797,3,jokke,2808,0,0,1,1,0.0%,11m
23797,3,[DGNM]PsychoLisk,2808,0,0,2,2,0.0%,18m
23831,3,Argentum,2807,1354,125,116,241,51.9%,7m
23831,3,Прадед,2807,1561,114,88,202,56.4%,18m
23831,3,MarioWagant,2807,365,68,59,127,53.5%,6m
23831,3,RaizoRaw,2807,1488,66,59,125,52.8%,9m
23831,3,[CEXY]Bastrd,2807,895,40,26,66,60.6%,3m
23831,3,Peacemaker,2807,554,30,29,59,50.8%,18m
23831,3,Qant,2807,499,29,26,55,52.7%,12m
23831,3,NoSmoking,2807,146,24,11,35,68.6%,9m
23831,3,serg,2807,489,22,14,36,61.1%,11m
23831,3,[KOTER]SeCreT,2807,494,20,17,37,54.1%,18m
23831,3,AbuturWorm,2807,365,19,3,22,86.4%,10m
23831,3,freakMeduza,2807,441,19,10,29,65.5%,25m
23831,3,[Ирбис]Цербер,2807,340,15,7,22,68.2%,17m
23831,1,KtrE,2807,397,12,24,36,33.3%,9m
23831,3,ZaiN,2807,236,9,1,10,90.0%,24m
23831,2,Vixu,2807,183,6,4,10,60.0%,58m
23831,2,outstaff,2807,128,6,6,12,50.0%,10m
23831,3,Barbariska,2807,178,6,10,16,37.5%,25m
23831,2,[VRTAN]Reinor,2807,167,5,4,9,55.6%,1h
23831,3,xaver,2807,0,4,1,5,80.0%,5m
23831,2,DrFeelGood,2807,0,4,1,5,80.0%,57m
23831,3,[NINDUD]NoSkill,2807,165,4,3,7,57.1%,11m
23831,2,Wonni,2807,0,3,4,7,42.9%,9m
23831,3,[1stGG]Shidabiazler,2807,132,3,5,8,37.5%,18m
23831,1,[Petite]Princesse,2807,97,3,5,8,37.5%,7m
23831,3,terminator,2807,114,2,1,3,66.7%,7m
23831,3,Alexandrovic,2807,123,2,3,5,40.0%,1h
23831,2,AnCiEnT,2807,0,2,4,6,33.3%,45m
23831,2,Welfor,2807,96,2,4,6,33.3%,34m
23831,3,[UPA]Lipeling,2807,0,1,0,1,100.0%,18m
23831,2,[SimpIy]lliliililiii,2807,0,1,0,1,100.0%,52m
23831,3,Grot,2807,0,1,0,1,100.0%,25m
23831,3,MLGrusGamer,2807,0,1,0,1,100.0%,14m
23831,1,Ksen,2807,0,1,7,8,12.5%,7m
23831,3,Yan,2807,0,0,1,1,0.0%,18m
23831,3,Prorok,2807,0,0,1,1,0.0%,1m
23831,3,[HOKI]JackBack,2807,0,0,1,1,0.0%,7m
23831,3,[bullD]Mishka,2807,0,0,2,2,0.0%,10m
23869,3,ObiWKenobi,2806,1589,77,84,161,47.8%,25m
23869,3,DaviKappa,2806,1287,70,42,112,62.5%,9m
23869,1,TFXTyler,2806,884,62,68,130,47.7%,11m
23869,2,BLANK,2806,1051,49,38,87,56.3%,14m
23869,3,[SiGaMi]Starlord,2806,588,31,9,40,77.5%,17m
23869,3,Flake,2806,565,26,18,44,59.1%,5m
23869,3,kamat,2806,347,16,14,30,53.3%,5m
23869,3,lackluck,2806,306,10,10,20,50.0%,15m
23869,3,Pain,2806,247,9,7,16,56.2%,1h
23869,1,karatza,2806,185,7,6,13,53.8%,60m
23869,3,Rhodium,2806,176,7,8,15,46.7%,4m
23869,3,Scharlachrot,2806,168,6,2,8,75.0%,9m
23869,2,Iceman,2806,184,5,5,10,50.0%,39m
23869,3,Demetris,2806,0,3,2,5,60.0%,2m
23869,3,Nervenzelle,2806,86,3,4,7,42.9%,10m
23869,2,SpawN,2806,106,2,3,5,40.0%,9m
23869,3,Vortsok,2806,0,2,3,5,40.0%,3m
23869,3,MRJ,2806,107,2,5,7,28.6%,3m
23869,3,[xP4Px]Suiba,2806,0,1,0,1,100.0%,3m
23869,3,Chaos,2806,0,1,0,1,100.0%,3m
23869,1,Squirtle,2806,0,1,0,1,100.0%,29m
23869,3,Zuchu,2806,30,1,2,3,33.3%,12m
23869,3,[mfixed]SunnyGoo,2806,30,1,3,4,25.0%,9m
23869,1,wasyawex,2806,0,1,5,6,16.7%,19m
23869,3,DuKKe,2806,0,0,1,1,0.0%,1m
23869,3,ProtoSlayer,2806,0,0,1,1,0.0%,1m
23869,3,ChillWars,2806,0,0,1,1,0.0%,2m
23896,3,vada,2805,1391,60,45,105,57.1%,3m
23896,2,planetmuscle,2805,1180,45,47,92,48.9%,13m
23896,1,[H3N1]Mage,2805,247,41,48,89,46.1%,9m
23896,3,Träskpaddan,2805,847,38,29,67,56.7%,14m
23896,2,Zverius,2805,706,30,34,64,46.9%,12m
23896,3,neadekva,2805,680,28,24,52,53.8%,13m
23896,3,GoodRipper,2805,440,27,23,50,54.0%,5m
23896,3,Clemlepred,2805,213,21,19,40,52.5%,10m
23896,1,Croff,2805,261,17,29,46,37.0%,6m
23896,2,calamiTy,2805,332,13,9,22,59.1%,1h
23896,3,Jake,2805,342,13,12,25,52.0%,7m
23896,2,Solon,2805,304,12,12,24,50.0%,18m
23896,3,Tico,2805,316,11,15,26,42.3%,2m
23896,3,[ELaser]Heisenzerg,2805,261,10,4,14,71.4%,3m
23896,3,AveTsezar,2805,204,9,6,15,60.0%,5m
23896,3,flopp,2805,300,9,9,18,50.0%,1m
23896,3,Ramzes,2805,218,9,10,19,47.4%,32m
23896,1,Erik,2805,142,7,5,12,58.3%,49m
23896,2,Radus,2805,186,6,7,13,46.2%,56m
23896,1,MarineMan,2805,94,6,8,14,42.9%,6m
23896,1,GigiX,2805,214,5,6,11,45.5%,36m
23896,3,Bonafide,2805,162,4,3,7,57.1%,14m
23896,2,[DMI]VoiDReApEr,2805,0,3,3,6,50.0%,58m
23896,3,[x01]doctor,2805,58,3,3,6,50.0%,2m
23896,2,SEPTIM,2805,0,3,3,6,50.0%,20m
23896,3,Soviet,2805,93,2,1,3,66.7%,11m
23896,3,vixenes,2805,0,1,0,1,100.0%,9m
23896,3,OOOTTOOO,2805,94,1,1,2,50.0%,9m
23896,3,[HODOR1]Biglipps,2805,0,1,1,2,50.0%,17m
23896,1,Cuthbert,2805,95,1,3,4,25.0%,18m
23896,3,MrFiasco,2805,0,0,2,2,0.0%,12m
23896,2,BeastyQT,2805,0,0,6,6,0.0%,20m
23928,2,Ripst,2804,1568,385,388,773,49.8%,4m
23928,3,[AiRǂ]Carogna,2804,1447,129,112,241,53.5%,9m
23928,3,Lite,2804,1139,127,95,222,57.2%,9m
23928,3,Silverdeer,2804,1564,80,71,151,53.0%,11m
23928,3,boec,2804,1026,42,45,87,48.3%,15m
23928,3,guimelo,2804,758,34,22,56,60.7%,9m
23928,3,SKYFALL,2804,723,33,36,69,47.8%,16m
23928,3,Timon,2804,838,31,29,60,51.7%,15m
23928,3,bEarchZz,2804,639,28,18,46,60.9%,7m
23928,3,Тит,2804,424,27,24,51,52.9%,4m
23928,3,WithGod,2804,628,25,21,46,54.3%,1m
23928,2,Kamil,2804,446,19,18,37,51.4%,6m
23928,2,Djédys,2804,342,17,30,47,36.2%,5m
23928,2,HeMan,2804,201,15,20,35,42.9%,24m
23928,2,Petya,2804,422,14,22,36,38.9%,7m
23928,3,drislio,2804,280,10,17,27,37.0%,5m
23928,3,EUZerg,2804,216,9,7,16,56.2%,18m
23928,3,[Фаталя]Фаталя,2804,205,7,3,10,70.0%,9m
23928,3,AKTIOR,2804,176,7,10,17,41.2%,25m
23928,2,Arapakos,2804,219,6,3,9,66.7%,2m
23928,3,Alien,2804,202,6,4,10,60.0%,2m
23928,3,Murmure,2804,145,6,5,11,54.5%,9m
23928,3,[DFgsA]ZeroFace,2804,142,5,8,13,38.5%,1m
23928,1,TeaYellow,2804,220,5,10,15,33.3%,46m
23928,3,[SPAINs]aasdfggg,2804,140,4,1,5,80.0%,7m
23928,1,Lamask,2804,46,4,3,7,57.1%,22m
23928,3,ank,2804,88,4,3,7,57.1%,16m
23928,3,[ExTr1m]Killmonger,2804,112,4,4,8,50.0%,5m
23928,3,bombarbia,2804,86,3,5,8,37.5%,24m
23928,3,ЗверяЗмейПРо,2804,30,2,2,4,50.0%,26m
23928,3,MAKSIMUS,2804,60,2,3,5,40.0%,12m
23928,2,Greed,2804,0,2,3,5,40.0%,1h
23928,3,LoreTakeAway,2804,131,2,6,8,25.0%,46m
23928,3,SANTEY,2804,30,1,2,3,33.3%,9m
23928,3,Tominix,2804,0,1,3,4,25.0%,10m
23928,3,Ripper,2804,0,0,1,1,0.0%,1m
23928,3,Zmbieschnitz,2804,0,0,1,1,0.0%,9m
23928,3,SimpleJack,2804,0,0,5,5,0.0%,14m
23966,3,Pirus,2803,513,76,38,114,66.7%,4m
23966,3,Zera,2803,1011,47,41,88,53.4%,26m
23966,3,iMahila,2803,885,46,38,84,54.8%,3m
23966,3,Chumbawumba,2803,874,38,32,70,54.3%,8m
23966,3,FedeGosi,2803,734,33,26,59,55.9%,15m
23966,3,[ProRax]TheAftor,2803,436,21,6,27,77.8%,1m
23966,2,penguinone,2803,484,20,17,37,54.1%,12m
23966,3,candy,2803,375,19,7,26,73.1%,26m
23966,3,[SBG44]patateman,2803,254,10,11,21,47.6%,9m
23966,3,Crikka,2803,199,9,5,14,64.3%,5m
23966,1,viovio,2803,144,6,6,12,50.0%,7m
23966,2,KenTzetsu,2803,90,6,6,12,50.0%,9m
23966,3,Aldeano,2803,165,5,2,7,71.4%,5m
23966,3,Shadow,2803,116,5,5,10,50.0%,25m
23966,3,Kalix,2803,143,4,2,6,66.7%,8m
23966,1,Salazar,2803,0,4,3,7,57.1%,43m
23966,2,Schihar,2803,48,4,4,8,50.0%,58m
23966,3,[Vioc]STAROS,2803,90,4,4,8,50.0%,18m
23966,2,AnAthOs,2803,30,4,5,9,44.4%,10m
23966,3,sla,2803,121,3,1,4,75.0%,3m
23966,3,gatorok,2803,130,3,2,5,60.0%,5m
23966,3,[ЗИБиАГ]DimirSpybug,2803,0,3,2,5,60.0%,1m
23966,2,xXx,2803,0,3,3,6,50.0%,2m
23966,3,Nize,2803,90,3,4,7,42.9%,4m
23966,3,[Petrus]make,2803,30,2,1,3,66.7%,2m
23966,3,[KVOID]AngrySCV,2803,62,2,4,6,33.3%,5m
23966,3,Raijin,2803,94,1,1,2,50.0%,6m
23966,2,IDBǂHerenof,2803,0,1,2,3,33.3%,28m
23966,3,appel,2803,30,1,4,5,20.0%,6m
23966,3,cakeless,2803,30,1,4,5,20.0%,3m
23966,3,mateuszkita,2803,0,0,1,1,0.0%,5m
23997,3,Swayzomad,2802,1569,179,163,342,52.3%,7m
23997,1,nico,2802,671,68,74,142,47.9%,26m
23997,1,Sarëth,2802,1004,57,58,115,49.6%,16m
23997,3,DrDlPSHlT,2802,795,41,19,60,68.3%,25m
23997,3,[НЕТУДА]DimasKa,2802,799,33,22,55,60.0%,9m
23997,2,fortheswarm,2802,524,19,25,44,43.2%,3m
23997,3,npyt,2802,302,14,13,27,51.9%,5m
23997,3,Virus,2802,257,10,3,13,76.9%,3m
23997,3,[ШОУМЕН]Tsepeshonok,2802,133,9,0,9,100.0%,9m
23997,3,Yoloska,2802,262,9,10,19,47.4%,18m
23997,3,[FRESH]Kinabalu,2802,241,8,5,13,61.5%,7m
23997,3,[IceHus]Krep,2802,244,8,5,13,61.5%,9m
23997,2,damianffj,2802,169,8,6,14,57.1%,18m
23997,3,[3Macro]MOT,2802,104,7,8,15,46.7%,27m
23997,2,CeriSe,2802,253,6,19,25,24.0%,1h
23997,1,Purifier,2802,176,5,3,8,62.5%,60m
23997,3,КольоКътмата,2802,88,5,6,11,45.5%,9m
23997,3,Puolikas,2802,86,4,4,8,50.0%,4m
23997,1,Genzen,2802,88,4,5,9,44.4%,3m
23997,1,Viperov,2802,48,4,5,9,44.4%,60m
23997,3,Moos,2802,0,3,2,5,60.0%,2m
23997,3,Napoleon,2802,30,2,6,8,25.0%,10m
23997,3,Nico,2802,0,1,0,1,100.0%,9m
23997,3,[NWGD]AXILES,2802,93,1,1,2,50.0%,6m
23997,2,[hf4X4]Totoche,2802,0,1,2,3,33.3%,1m
23997,3,McLovin,2802,30,1,3,4,25.0%,17m
23997,3,kosheen,2802,0,1,3,4,25.0%,5m
23997,3,[QaDo]WARPOZ,2802,30,1,6,7,14.3%,13m
23997,3,[1830]GeperTrast,2802,0,0,1,1,0.0%,26m
23997,3,SoHLo,2802,0,0,1,1,0.0%,2m
23997,3,nEVMENyaemyi,2802,0,0,2,2,0.0%,8m
23997,3,adventure,2802,0,0,2,2,0.0%,16m
23997,1,neznaika,2802,0,0,3,3,0.0%,59m
23997,3,Makmerdo,2802,0,0,3,3,0.0%,9m
23997,3,Winky,2802,0,0,4,4,0.0%,11m
24032,2,Heisenzerg,2801,1369,97,90,187,51.9%,13m
24032,3,MadGodEater,2801,1295,74,61,135,54.8%,5m
24032,2,OptimusRhyme,2801,1288,59,64,123,48.0%,16m
24032,3,MpK,2801,816,36,18,54,66.7%,3m
24032,3,[Arrows]zarcasukus,2801,574,25,15,40,62.5%,17m
24032,3,Shift,2801,559,25,17,42,59.5%,11m
24032,3,Sanguinius,2801,515,22,18,40,55.0%,5m
24032,2,Engrenado,2801,452,18,16,34,52.9%,12m
24032,2,Kuzu,2801,330,11,20,31,35.5%,4m
24032,2,GMPLKP,2801,210,9,9,18,50.0%,20m
24032,1,Pawner,2801,279,8,8,16,50.0%,24m
24032,3,Dolothion,2801,239,8,10,18,44.4%,10m
24032,3,seventyOne,2801,171,7,8,15,46.7%,6m
24032,3,[MadKuy]ELkukuy,2801,178,5,4,9,55.6%,25m
24032,3,MorganSaturn,2801,0,4,1,5,80.0%,25m
24032,3,mamek,2801,0,4,1,5,80.0%,3m
24032,2,[BRKZAK]Boris,2801,48,4,3,7,57.1%,57m
24032,3,loveUmate,2801,148,4,4,8,50.0%,54m
24032,3,Sloid,2801,0,3,3,6,50.0%,3m
24032,3,[HUMI]iYosuua,2801,30,2,3,5,40.0%,10m
24032,3,[Zing]Cata,2801,121,2,4,6,33.3%,49m
24032,3,MacroBanana,2801,0,1,0,1,100.0%,25m
24032,2,NoBigE,2801,0,1,0,1,100.0%,57m
24032,2,Ежик,2801,0,1,0,1,100.0%,57m
24032,1,Eragom,2801,0,1,0,1,100.0%,8m
24032,3,[SOPCA]AnGavr,2801,0,1,1,2,50.0%,15m
24032,3,Wickedcruel,2801,30,1,4,5,20.0%,10m
24032,3,hooger,2801,0,0,1,1,0.0%,3m
24032,3,mörda,2801,0,0,1,1,0.0%,7m
24032,3,[MVDD]viniel,2801,0,0,5,5,0.0%,9m
24032,2,Umoja,2801,0,0,8,8,0.0%,9m
24063,2,[TrueMe]deNom,2800,1591,344,330,674,51.0%,10m
24063,3,Surgeon,2800,1514,84,76,160,52.5%,11m
24063,3,JarJarWinks,2800,488,47,37,84,56.0%,3m
24063,3,steifler,2800,1234,46,49,95,48.4%,2m
24063,3,[2021]Tuchka,2800,684,30,21,51,58.8%,7m
24063,3,pipito,2800,528,21,19,40,52.5%,16m
24063,1,BrussianBoi,2800,327,12,14,26,46.2%,30m
24063,3,WurzelSepp,2800,232,9,3,12,75.0%,18m
24063,3,[SkBG]barry,2800,178,6,3,9,66.7%,5m
24063,2,Pipolla,2800,90,6,7,13,46.2%,10m
24063,3,Saigon,2800,30,4,4,8,50.0%,1m
24063,3,teksla,2800,88,4,5,9,44.4%,14m
24063,2,[BABYSS]Svalza,2800,142,4,7,11,36.4%,13m
24063,3,[GdAT]Legendk,2800,126,4,9,13,30.8%,10m
24063,2,leo,2800,130,4,9,13,30.8%,1h
24063,1,[AiRǂ]Giovak,2800,114,3,2,5,60.0%,58m
24063,3,sheva,2800,0,3,3,6,50.0%,3m
24063,1,Asnofyx,2800,82,2,2,4,50.0%,32m
24063,1,IIIIIIIII,2800,97,2,2,4,50.0%,39m
24063,3,martis,2800,30,2,3,5,40.0%,11m
24063,1,mKw,2800,0,1,0,1,100.0%,21m
24063,3,MAR,2800,0,1,0,1,100.0%,9m
24063,3,MoJoe,2800,30,1,3,4,25.0%,9m
24063,3,Haikou,2800,30,1,4,5,20.0%,3m
24063,3,JohnnyVile,2800,30,1,5,6,16.7%,2m
24063,3,RandomJoker,2800,0,0,1,1,0.0%,5m
24063,1,[Moskva]Аббадон,2800,0,0,1,1,0.0%,30m
24063,3,Kolatalisk,2800,0,0,2,2,0.0%,3m
24091,1,Кайф,2799,1599,468,436,904,51.8%,13m
24091,3,[PROESL]MiT,2799,1540,206,223,429,48.0%,25m
24091,2,[SWANO]Strailat,2799,1405,87,76,163,53.4%,14m
24091,3,Freiheit,2799,1443,62,54,116,53.4%,3m
24091,2,BlueMoon,2799,392,56,53,109,51.4%,13m
24091,3,AreyS,2799,257,49,46,95,51.6%,10m
24091,3,[BigLib]gaillou,2799,578,46,47,93,49.5%,1m
24091,3,IBAK,2799,924,40,30,70,57.1%,16m
24091,2,sin,2799,1009,40,42,82,48.8%,25m
24091,1,IIIIIIIIII,2799,843,39,36,75,52.0%,11m
24091,3,RoffeRuff,2799,741,31,25,56,55.4%,4m
24091,3,ivacho,2799,700,29,26,55,52.7%,1m
24091,3,PusT,2799,532,28,33,61,45.9%,26m
24091,2,Snoopy,2799,648,26,22,48,54.2%,26m
24091,3,Cold,2799,377,17,14,31,54.8%,13m
24091,3,badarty,2799,412,14,13,27,51.9%,2m
24091,3,ситх,2799,339,11,15,26,42.3%,5m
24091,2,chucha,2799,243,10,9,19,52.6%,3m
24091,1,nathekiller,2799,251,9,6,15,60.0%,27m
24091,3,LyrikM,2799,295,9,8,17,52.9%,3m
24091,1,Accuser,2799,183,6,5,11,54.5%,31m
24091,1,Irkles,2799,230,6,6,12,50.0%,46m
24091,2,Whistle,2799,116,5,5,10,50.0%,12m
24091,2,[APWAL]horche,2799,48,4,4,8,50.0%,42m
24091,1,Bodycount,2799,48,4,5,9,44.4%,5m
24091,3,FuriousTom,2799,92,4,8,12,33.3%,9m
24091,3,Postman,2799,86,3,8,11,27.3%,2m
24091,1,Ethan,2799,92,2,0,2,100.0%,20m
24091,3,Kurg,2799,30,1,4,5,20.0%,7m
24091,1,Raven,2799,0,0,1,1,0.0%,38m
24091,1,[TFSC]Néo,2799,0,0,1,1,0.0%,52m
24122,3,[ZЕRGТV]Sovushka,2798,1412,134,115,249,53.8%,12m
24122,2,Usbwarrior,2798,426,73,80,153,47.7%,15m
24122,3,Katha,2798,1257,66,53,119,55.5%,9m
24122,2,Nallen,2798,753,47,47,94,50.0%,25m
24122,2,MeXaHuЗm,2798,1110,47,56,103,45.6%,24m
24122,1,Vetko,2798,973,43,31,74,58.1%,19m
24122,1,Eran,2798,696,39,1,40,97.5%,49m
24122,3,[NYPER]Vladek,2798,940,39,33,72,54.2%,25m
24122,3,SunSinK,2798,854,33,26,59,55.9%,8m
24122,3,Degermark,2798,746,29,25,54,53.7%,10m
24122,2,CassBeck,2798,692,26,31,57,45.6%,10m
24122,3,[RGSC2]MONSTER,2798,496,20,16,36,55.6%,26m
24122,3,Ksiciarz,2798,451,18,15,33,54.5%,25m
24122,3,pebblS,2798,420,17,17,34,50.0%,3m
24122,2,Xirodian,2798,349,15,9,24,62.5%,53m
24122,2,[TEZz]slenderstar,2798,245,9,15,24,37.5%,4m
24122,1,Warayge,2798,206,7,5,12,58.3%,60m
24122,3,astra,2798,215,6,6,12,50.0%,9m
24122,1,Crow,2798,168,6,7,13,46.2%,4m
24122,3,Ryborgg,2798,226,6,10,16,37.5%,11m
24122,2,Coestath,2798,0,4,3,7,57.1%,26m
24122,1,Destroyer,2798,164,4,4,8,50.0%,18m
24122,2,Jigsaw,2798,0,3,3,6,50.0%,45m
24122,1,ooonick,2798,91,3,3,6,50.0%,8m
24122,3,Ubivec,2798,86,3,6,9,33.3%,2m
24122,1,CarregaFTW,2798,40,2,0,2,100.0%,19m
24122,3,Raziel,2798,30,2,2,4,50.0%,6m
24122,1,[KRATZA]TomRipley,2798,0,1,0,1,100.0%,41m
24122,3,[MTPL]szczelny,2798,0,1,1,2,50.0%,3m
24122,1,WithFlair,2798,0,0,1,1,0.0%,29m
24122,1,[NLTN]chrisborg,2798,0,0,2,2,0.0%,1h
24153,3,Maurokun,2797,1524,150,138,288,52.1%,8m
24153,2,kim,2797,508,25,28,53,47.2%,15m
24153,3,Nakero,2797,385,24,19,43,55.8%,10m
24153,1,Kayak,2797,554,23,20,43,53.5%,26m
24153,1,Kazaimer,2797,650,20,21,41,48.8%,33m
24153,3,[LGNxEU]Snyper,2797,230,8,5,13,61.5%,24m
24153,3,JimmySaville,2797,152,6,5,11,54.5%,4m
24153,1,Cordyceps,2797,0,5,3,8,62.5%,58m
24153,2,liluk,2797,140,5,5,10,50.0%,3m
24153,2,ignoh,2797,58,5,5,10,50.0%,9m
24153,3,Discere,2797,60,5,5,10,50.0%,4m
24153,1,Lapitenko,2797,116,4,0,4,100.0%,34m
24153,1,[TRPo]oTRPoLIN,2797,120,4,4,8,50.0%,58m
24153,1,picorba,2797,36,3,3,6,50.0%,20m
24153,2,PSX,2797,92,3,12,15,20.0%,25m
24153,1,[SUZUKI]Costin,2797,48,2,1,3,66.7%,49m
24153,3,KrO,2797,30,2,3,5,40.0%,2m
24153,1,FTwoToWin,2797,0,2,3,5,40.0%,1h
24153,3,[HMB]YenloWang,2797,30,1,4,5,20.0%,11m
24153,2,[morts]Raptor,2797,0,0,1,1,0.0%,32m
24153,3,desnartdani,2797,0,0,3,3,0.0%,10m
24174,1,organum,2796,1555,334,336,670,49.9%,13m
24174,2,[mCb]KAMIONČINA,2796,629,57,54,111,51.4%,3m
24174,3,Ben,2796,710,54,49,103,52.4%,25m
24174,3,[Ximic]МрачныйВорон,2796,817,49,36,85,57.6%,15m
24174,2,soulfly,2796,699,44,43,87,50.6%,10m
24174,3,Negtah,2796,678,38,34,72,52.8%,25m
24174,3,NAVboarist,2796,416,30,28,58,51.7%,14m
24174,3,askom,2796,782,28,30,58,48.3%,9m
24174,3,MaDMaNssS,2796,514,23,18,41,56.1%,17m
24174,3,Stu,2796,499,21,17,38,55.3%,5m
24174,3,Arkadiusz,2796,206,17,9,26,65.4%,9m
24174,3,Styx,2796,290,11,14,25,44.0%,18m
24174,2,Just,2796,186,7,13,20,35.0%,7m
24174,3,[N8Wrst]Lennox,2796,172,6,11,17,35.3%,26m
24174,3,pixel,2796,120,5,14,19,26.3%,7m
24174,1,Izzaqui,2796,82,2,1,3,66.7%,32m
24174,1,[ZrgZer]Darkxcqre,2796,70,2,2,4,50.0%,1h
24174,3,Krentian,2796,0,0,3,3,0.0%,2m
24174,1,[BornG]MCauthon,2796,0,0,3,3,0.0%,31m
24193,3,KdM,2795,1431,239,252,491,48.7%,4m
24193,3,[RoleP]Sheigar,2795,318,12,15,27,44.4%,14m
24193,3,Torium,2795,162,9,5,14,64.3%,9m
24193,1,Yvesvzla,2795,226,8,1,9,88.9%,27m
24193,2,[FMG]Sturm,2795,156,7,6,13,53.8%,11m
24193,1,KariBig,2795,190,7,8,15,46.7%,21m
24193,3,Korkenzieher,2795,142,6,5,11,54.5%,5m
24193,3,UncleBogdan,2795,148,6,6,12,50.0%,5m
24193,1,idthsfrAiur,2795,120,4,3,7,57.1%,18m
24193,3,ERIKtheRED,2795,164,4,4,8,50.0%,14m
24193,1,JustAPlayer,2795,159,4,5,9,44.4%,49m
24193,3,Chaøs,2795,60,4,6,10,40.0%,9m
24193,1,InqFridRU,2795,0,3,2,5,60.0%,4m
24193,1,Kuvash,2795,0,1,0,1,100.0%,46m
24193,3,[Førçē]PayThePrice,2795,30,1,3,4,25.0%,16m
24193,3,Shasol,2795,30,1,4,5,20.0%,10m
24193,2,ElFrancisco,2795,0,0,1,1,0.0%,54m
24210,3,mike,2794,1521,320,317,637,50.2%,26m
24210,3,executeR,2794,1590,111,107,218,50.9%,4m
24210,1,Charles,2794,1416,101,113,214,47.2%,16m
24210,3,Raden,2794,1377,70,59,129,54.3%,14m
24210,3,Crowling,2794,804,49,47,96,51.0%,16m
24210,3,ToeMass,2794,588,22,20,42,52.4%,17m
24210,3,DrDapson,2794,544,21,16,37,56.8%,9m
24210,1,Popcorn,2794,599,19,19,38,50.0%,25m
24210,3,GRbIZyH,2794,231,16,15,31,51.6%,10m
24210,1,REALbestname,2794,486,14,21,35,40.0%,1h
24210,3,Tintamar,2794,288,11,11,22,50.0%,14m
24210,3,[K0mpis]banjo,2794,258,9,6,15,60.0%,14m
24210,3,Etermal,2794,234,7,4,11,63.6%,35m
24210,2,Jester,2794,184,6,3,9,66.7%,2m
24210,3,[mltdcz]NickMcCloud,2794,175,5,3,8,62.5%,15m
24210,3,[S1Q]Lolly,2794,120,5,4,9,55.6%,15m
24210,2,Zst,2794,44,4,4,8,50.0%,1h
24210,1,Nicouz,2794,0,1,0,1,100.0%,22m
24210,1,EML,2794,0,1,0,1,100.0%,1h
24210,3,hlord,2794,0,0,2,2,0.0%,9m
24210,3,Lexotan,2794,0,0,3,3,0.0%,6m
24210,1,Junkok,2794,0,0,3,3,0.0%,52m
24232,3,Lelouch,2793,867,64,40,104,61.5%,1m
24232,3,killhh,2793,922,41,34,75,54.7%,10m
24232,3,[pro101]jefie,2793,665,28,26,54,51.9%,5m
24232,3,diegoer,2793,235,27,27,54,50.0%,6m
24232,3,Kietai,2793,606,25,27,52,48.1%,1m
24232,3,[PAБ]MCIBibabi,2793,503,20,11,31,64.5%,3m
24232,1,btester,2793,401,12,7,19,63.2%,59m
24232,3,Rash,2793,303,11,8,19,57.9%,4m
24232,2,NoReplay,2793,278,11,10,21,52.4%,25m
24232,3,[tofury]Darkscythe,2793,190,8,8,16,50.0%,54m
24232,3,MrNad,2793,228,8,11,19,42.1%,5m
24232,1,Innos,2793,191,6,7,13,46.2%,48m
24232,3,Stereotype,2793,118,5,5,10,50.0%,10m
24232,2,yousef,2793,0,3,2,5,60.0%,9m
24232,1,snips,2793,0,3,2,5,60.0%,21m
24232,1,Shoker,2793,164,3,3,6,50.0%,57m
24232,3,[OpSun]mAdmAze,2793,58,3,4,7,42.9%,11m
24232,1,[БОДУН]Cemerset,2793,0,2,1,3,66.7%,59m
24232,2,Tamplier,2793,0,1,0,1,100.0%,32m
24232,1,Brabus,2793,0,1,0,1,100.0%,59m
24232,3,KaKolaK,2793,30,1,4,5,20.0%,14m
24232,1,[FFLEXX]Reybey,2793,0,0,1,1,0.0%,58m
24232,3,gadget,2793,0,0,2,2,0.0%,14m
24255,3,FlyingHippo,2792,1410,117,95,212,55.2%,10m
24255,2,Robotor,2792,1020,99,84,183,54.1%,5m
24255,3,friedchicken,2792,1334,74,57,131,56.5%,10m
24255,2,general,2792,659,57,67,124,46.0%,8m
24255,2,wish,2792,1156,42,50,92,45.7%,9m
24255,2,[RTT]LeSerbe,2792,831,33,34,67,49.3%,10m
24255,3,AndreySt,2792,695,32,17,49,65.3%,11m
24255,2,RageQuitRudi,2792,633,29,31,60,48.3%,4m
24255,2,Khalilson,2792,699,29,34,63,46.0%,24m
24255,2,norris,2792,659,23,26,49,46.9%,25m
24255,1,SmallManIsak,2792,661,20,14,34,58.8%,34m
24255,1,Rabitibike,2792,464,18,9,27,66.7%,1h
24255,3,Rick,2792,226,16,13,29,55.2%,6m
24255,3,Keiser,2792,393,15,32,47,31.9%,26m
24255,3,[GAY5]Nick,2792,245,11,8,19,57.9%,24m
24255,2,[CRAYZE]Zagara,2792,287,11,18,29,37.9%,9m
24255,1,Andrey,2792,220,7,2,9,77.8%,2m
24255,3,FluXZerG,2792,177,6,4,10,60.0%,25m
24255,1,cuting,2792,193,5,7,12,41.7%,30m
24255,2,Ukharn,2792,150,5,14,19,26.3%,9m
24255,2,PSIH,2792,0,4,1,5,80.0%,2m
24255,1,Brucemoose,2792,80,3,2,5,60.0%,22m
24255,3,DynastesHerc,2792,97,2,0,2,100.0%,19m
24255,2,Jurgiz,2792,0,2,3,5,40.0%,2m
24255,1,[LGNxEU]Axxellerate,2792,0,1,0,1,100.0%,38m
24255,3,SAMIDARA,2792,0,1,1,2,50.0%,10m
24255,3,Totallimit,2792,30,1,3,4,25.0%,17m
24255,2,[CovPar]GrapplingJJB,2792,0,0,1,1,0.0%,6m
24255,1,MikaAbra,2792,0,0,1,1,0.0%,6m
24255,1,NidusVbuhtu,2792,0,0,1,1,0.0%,56m
24255,1,svyat,2792,0,0,1,1,0.0%,4m
24255,1,Fulgrim,2792,0,0,1,1,0.0%,30m
24255,1,Duty,2792,0,0,1,1,0.0%,2m
24288,3,Xandor,2791,1590,190,181,371,51.2%,4m
24288,1,[SPAINs]Destajador,2791,1473,135,134,269,50.2%,12m
24288,1,Suva,2791,1695,122,109,231,52.8%,31m
24288,3,FriedEgg,2791,1506,99,87,186,53.2%,13m
24288,3,Elite,2791,356,42,28,70,60.0%,18m
24288,3,[POON]PoodleBasher,2791,261,37,34,71,52.1%,15m
24288,2,Kingpin,2791,857,35,37,72,48.6%,18m
24288,3,MIR,2791,754,30,23,53,56.6%,2m
24288,2,Pecat,2791,830,28,35,63,44.4%,26m
24288,3,TerranLoL,2791,623,23,23,46,50.0%,10m
24288,3,[RAYDOR]Eilysium,2791,555,21,18,39,53.8%,13m
24288,3,Shtanjel,2791,384,13,17,30,43.3%,14m
24288,1,serval,2791,402,12,9,21,57.1%,2m
24288,1,miGGE,2791,440,12,9,21,57.1%,57m
24288,3,Чупакупа,2791,221,11,6,17,64.7%,25m
24288,1,GoDKaRaKaN,2791,315,9,13,22,40.9%,2m
24288,1,[Taalid]SleinUnknow,2791,160,8,4,12,66.7%,6m
24288,3,[LIQUID]unTonee,2791,205,7,3,10,70.0%,9m
24288,1,abc,2791,236,7,6,13,53.8%,25m
24288,1,[PLA2N]AmoralDed,2791,118,4,0,4,100.0%,21m
24288,3,Darkfeever,2791,121,4,3,7,57.1%,16m
24288,1,[Köfte]LeonLion,2791,0,3,2,5,60.0%,1h
24288,3,LuHoTTe,2791,149,3,4,7,42.9%,18m
24288,3,Jaffro,2791,60,3,6,9,33.3%,9m
24288,3,DAVINY,2791,30,2,2,4,50.0%,14m
24288,1,VeNoM,2791,0,1,4,5,20.0%,21m
24288,3,[696]Crevard,2791,0,1,6,7,14.3%,5m
24288,1,BaNET,2791,0,0,1,1,0.0%,1h
24288,1,[FIXi]Папус,2791,0,0,5,5,0.0%,8m
24317,1,JearMan,2790,1375,491,490,981,50.1%,26m
24317,3,Abradoks,2790,1484,94,95,189,49.7%,11m
24317,3,Pojebaniec,2790,1168,81,70,151,53.6%,7m
24317,1,Psyduck,2790,1145,66,78,144,45.8%,10m
24317,1,[SAoN]JCO,2790,899,48,63,111,43.2%,17m
24317,2,FatFox,2790,949,36,39,75,48.0%,24m
24317,3,Fiddlyhoo,2790,664,28,25,53,52.8%,25m
24317,3,[Seton]LACIOOO,2790,649,28,28,56,50.0%,6m
24317,3,Silverside,2790,630,27,21,48,56.2%,18m
24317,3,jasta,2790,565,25,17,42,59.5%,4m
24317,2,BadPete,2790,628,22,28,50,44.0%,9m
24317,1,[HZeS]SanJ,2790,468,20,8,28,71.4%,44m
24317,1,TheSilent,2790,650,20,17,37,54.1%,27m
24317,1,Karol,2790,296,13,5,18,72.2%,9m
24317,3,Суслик,2790,290,10,7,17,58.8%,6m
24317,3,Awesomus,2790,273,9,7,16,56.2%,17m
24317,2,NeOu,2790,96,5,2,7,71.4%,19m
24317,1,AlCapwn,2790,172,5,4,9,55.6%,35m
24317,2,[FROMAG]Spamy,2790,142,4,8,12,33.3%,12m
24317,1,Rambo,2790,0,3,2,5,60.0%,18m
24317,2,Furnie,2790,94,3,3,6,50.0%,52m
24317,3,Jantos,2790,30,2,3,5,40.0%,5m
24317,3,[RUxZet]данил,2790,62,2,9,11,18.2%,3m
24317,1,LifeisDance,2790,0,1,0,1,100.0%,1h
24317,2,Chimerde,2790,46,1,2,3,33.3%,50m
24317,2,[LOGS]Doofy,2790,89,1,3,4,25.0%,21m
24317,1,Viking,2790,48,1,4,5,20.0%,55m
24317,3,Cannibal,2790,30,1,4,5,20.0%,2m
24317,3,Peibol,2790,0,1,4,5,20.0%,25m
24317,2,[7a8DAN]SeptemOcto,2790,0,0,1,1,0.0%,60m
24317,2,Zapata,2790,0,0,2,2,0.0%,57m
24317,3,[BigDad]WarTC,2790,0,0,2,2,0.0%,3m
24349,3,DreamVl,2789,1491,170,136,306,55.6%,13m
24349,3,IIIIIIIIIIII,2789,1104,107,87,194,55.2%,24m
24349,3,[HWN]Karêdhíumn,2789,1201,57,55,112,50.9%,10m
24349,3,Blacksmith,2789,888,36,32,68,52.9%,3m
24349,2,MajorPatouf,2789,305,24,21,45,53.3%,5m
24349,2,Ascention,2789,452,15,19,34,44.1%,14m
24349,1,STYKE,2789,373,13,11,24,54.2%,1h
24349,3,[C12760]Harmony,2789,100,9,2,11,81.8%,28m
24349,3,TerranMan,2789,232,9,6,15,60.0%,17m
24349,2,Murdend,2789,167,7,7,14,50.0%,25m
24349,3,Vitus,2789,186,5,4,9,55.6%,8m
24349,3,[GаVnO]Alpheratz,2789,114,4,10,14,28.6%,14m
24349,1,SirPoopins,2789,140,3,1,4,75.0%,49m
24349,1,paulixx,2789,38,3,3,6,50.0%,30m
24349,2,Chis,2789,0,3,4,7,42.9%,10m
24349,3,Palko,2789,90,3,5,8,37.5%,13m
24349,2,MayBe,2789,94,2,0,2,100.0%,4m
24349,3,toineduke,2789,30,2,2,4,50.0%,16m
24349,3,Kiman,2789,30,2,3,5,40.0%,13m
24349,1,[BaSpIn]DeusEx,2789,0,0,1,1,0.0%,4m
24349,1,VLAD,2789,0,0,1,1,0.0%,5m
24349,1,[DZTK]HEROS,2789,0,0,1,1,0.0%,26m
24349,3,Otzako,2789,0,0,2,2,0.0%,12m
24372,3,Jonny,2788,1272,67,45,112,59.8%,9m
24372,3,Apokalyp,2788,1077,61,56,117,52.1%,8m
24372,3,[AnReal]deni,2788,876,44,31,75,58.7%,24m
24372,3,vegas,2788,848,43,36,79,54.4%,17m
24372,1,killerboys,2788,784,35,24,59,59.3%,21m
24372,1,DJTRUMP,2788,298,12,14,26,46.2%,24m
24372,3,[Stunt]Sonic,2788,218,9,9,18,50.0%,15m
24372,2,Gankhulug,2788,184,5,5,10,50.0%,57m
24372,1,BladeRunnerL,2788,120,5,5,10,50.0%,30m
24372,1,bnage,2788,197,4,1,5,80.0%,1h
24372,2,elfo,2788,98,4,14,18,22.2%,13m
24372,1,Equanimous,2788,0,3,4,7,42.9%,8m
24372,1,GDim,2788,0,3,6,9,33.3%,32m
24372,3,SersMasters,2788,30,2,2,4,50.0%,9m
24372,2,HimeRa,2788,0,2,3,5,40.0%,21m
24372,2,[IBIZA]Frankiefunk,2788,0,2,3,5,40.0%,5m
24372,1,Thauglor,2788,0,1,0,1,100.0%,1h
24372,3,Amou,2788,0,1,1,2,50.0%,3m
24372,3,Goliath,2788,97,1,2,3,33.3%,57m
24372,3,llllllllllll,2788,0,1,5,6,16.7%,2m
24372,1,tommy,2788,0,0,7,7,0.0%,25m
24393,1,[turtle]jakkaval,2787,1547,133,139,272,48.9%,14m
24393,2,Riddler,2787,1541,98,74,172,57.0%,25m
24393,2,[eFWe]COBRA,2787,1234,93,96,189,49.2%,11m
24393,3,LightBetStrs,2787,901,35,37,72,48.6%,16m
24393,1,sarrel,2787,514,18,14,32,56.2%,53m
24393,3,DoNotCare,2787,218,18,18,36,50.0%,17m
24393,3,Example,2787,217,16,12,28,57.1%,15m
24393,3,иван,2787,375,15,11,26,57.7%,10m
24393,3,Fokus,2787,226,13,17,30,43.3%,10m
24393,2,ReadySKP,2787,370,13,20,33,39.4%,11m
24393,2,Zozo,2787,337,12,12,24,50.0%,46m
24393,3,[IEAOIE]Hindenburg,2787,287,11,6,17,64.7%,2m
24393,1,MASSUKKAMURA,2787,286,10,8,18,55.6%,19m
24393,3,Yakudza,2787,306,10,17,27,37.0%,8m
24393,2,Proctologue,2787,236,9,12,21,42.9%,21m
24393,1,Armando,2787,192,8,4,12,66.7%,2m
24393,3,PodguZZZnik,2787,271,8,9,17,47.1%,6m
24393,3,Teltstang,2787,243,8,9,17,47.1%,7m
24393,3,[S5RTA]Wissian,2787,168,7,10,17,41.2%,11m
24393,2,Dimnosaure,2787,163,5,4,9,55.6%,47m
24393,1,CHiPoPo,2787,145,5,6,11,45.5%,53m
24393,2,Red,2787,95,5,8,13,38.5%,1h
24393,1,Yeti,2787,96,4,4,8,50.0%,50m
24393,3,JoJo,2787,86,4,4,8,50.0%,17m
24393,1,Hehehehehehe,2787,145,4,6,10,40.0%,57m
24393,2,[iplG]CpLShagim,2787,0,3,3,6,50.0%,50m
24393,1,[mYn1]Fackma,2787,118,3,3,6,50.0%,2m
24393,1,Ronin,2787,72,2,2,4,50.0%,37m
24393,2,[KnbZ]BrThome,2787,0,2,3,5,40.0%,1h
24393,3,Debba,2787,0,2,3,5,40.0%,1h
24393,3,Thukke,2787,0,2,4,6,33.3%,12m
24393,3,[bvbo9]painuser,2787,62,2,5,7,28.6%,15m
24393,1,CyTeHePMambI,2787,0,1,0,1,100.0%,4m
24393,3,JustusJonas,2787,0,1,1,2,50.0%,4m
24393,1,Timonus,2787,0,1,1,2,50.0%,1h
24393,3,ArtDestr,2787,0,1,1,2,50.0%,3m
24393,1,MILLAGA,2787,0,1,4,5,20.0%,18m
24393,3,[C12760]Cramlight,2787,30,1,5,6,16.7%,17m
24393,1,Ashtray,2787,0,0,1,1,0.0%,1h
24393,1,Meuzel,2787,0,0,1,1,0.0%,8m
24393,1,lucas,2787,0,0,1,1,0.0%,1h
24393,1,Latyraru,2787,0,0,1,1,0.0%,57m
24435,3,Vash,2786,1130,49,40,89,55.1%,2m
24435,3,[K0REA]Andi,2786,899,34,34,68,50.0%,17m
24435,3,[SszZ7]дима,2786,535,21,18,39,53.8%,14m
24435,3,rect,2786,502,20,15,35,57.1%,14m
24435,2,prohoops,2786,482,20,21,41,48.8%,9m
24435,2,Metalyst,2786,473,20,23,43,46.5%,9m
24435,1,[VDKN]HukanloS,2786,409,16,11,27,59.3%,41m
24435,2,[FLBAR]BaRmaleY,2786,368,16,14,30,53.3%,12m
24435,3,Pezz,2786,224,16,15,31,51.6%,17m
24435,1,[PTLc]Pallas,2786,184,5,2,7,71.4%,59m
24435,1,[Bähhh]Paddy,2786,78,4,4,8,50.0%,31m
24435,1,Anatho,2786,97,4,4,8,50.0%,7m
24435,3,nacura,2786,120,4,7,11,36.4%,15m
24435,3,Zoo,2786,86,4,9,13,30.8%,12m
24435,2,Enricobixio,2786,118,4,9,13,30.8%,23m
24435,1,fortunaty,2786,78,3,0,3,100.0%,30m
24435,2,Chromnitrit,2786,159,3,1,4,75.0%,19m
24435,1,Fantom,2786,0,3,4,7,42.9%,30m
24435,3,Arhangel,2786,60,2,7,9,22.2%,16m
24435,1,Maxeldr,2786,0,1,0,1,100.0%,27m
24435,3,[1C1C]Lesoooo,2786,0,1,1,2,50.0%,17m
24435,3,Smeag,2786,0,1,1,2,50.0%,8m
24435,3,gnom,2786,30,1,6,7,14.3%,13m
24435,3,[SPRNS]Winil,2786,0,0,2,2,0.0%,9m
24435,2,tnuilk,2786,0,0,2,2,0.0%,44m
24435,3,medros,2786,0,0,5,5,0.0%,3m
24461,3,Blaze,2785,1545,227,225,452,50.2%,9m
24461,3,Benners,2785,704,81,59,140,57.9%,2m
24461,3,[PIZIKS]DarkVenumMMA,2785,803,34,24,58,58.6%,17m
24461,3,SixPullRush,2785,295,31,18,49,63.3%,6m
24461,3,[SFight]Loki,2785,344,21,19,40,52.5%,6m
24461,2,[MoTeam]Ratshoot,2785,488,21,21,42,50.0%,25m
24461,1,ChosenOne,2785,543,17,11,28,60.7%,48m
24461,1,AllDayTicket,2785,310,11,15,26,42.3%,10m
24461,3,Houston,2785,291,10,8,18,55.6%,3m
24461,3,shadow,2785,216,8,6,14,57.1%,4m
24461,3,[MCKH]Dab,2785,206,8,9,17,47.1%,9m
24461,3,[iOwnU]charlie,2785,236,8,12,20,40.0%,11m
24461,3,MaxyZz,2785,201,7,4,11,63.6%,6m
24461,3,[13NRV]zemlyanin,2785,165,6,2,8,75.0%,3m
24461,3,[FrSlip]Kangourou,2785,184,6,4,10,60.0%,14m
24461,3,AHCImode,2785,177,6,4,10,60.0%,2m
24461,1,Pydracor,2785,118,5,3,8,62.5%,1h
24461,1,gys,2785,38,3,3,6,50.0%,40m
24461,3,Siflit,2785,0,3,3,6,50.0%,15m
24461,1,glhf,2785,168,3,4,7,42.9%,60m
24461,3,Sallad,2785,0,2,3,5,40.0%,1h
24461,1,MrProper,2785,109,2,3,5,40.0%,34m
24461,1,ГенералАУЕ,2785,0,1,0,1,100.0%,1h
24461,3,SEAMY,2785,30,1,3,4,25.0%,4m
24461,1,Syrind,2785,0,0,1,1,0.0%,37m
24461,1,datkrutoi,2785,0,0,1,1,0.0%,31m
24461,1,OverPowered,2785,0,0,5,5,0.0%,21m
24488,2,RandyMarsh,2784,1560,153,153,306,50.0%,5m
24488,3,Moke,2784,1222,52,49,101,51.5%,9m
24488,1,Canary,2784,1202,48,40,88,54.5%,27m
24488,3,[PezEz]Sheppstar,2784,1013,46,39,85,54.1%,4m
24488,1,WarpigCTS,2784,469,42,30,72,58.3%,46m
24488,3,IntroSpirit,2784,648,24,21,45,53.3%,4m
24488,3,Ampio,2784,429,22,13,35,62.9%,13m
24488,2,[TRKS]Lerida,2784,532,17,23,40,42.5%,11m
24488,3,[TKDSC]Kadock,2784,366,15,14,29,51.7%,16m
24488,2,[Zhig]KiRICH,2784,186,6,5,11,54.5%,4m
24488,2,Chupakabra,2784,141,4,4,8,50.0%,24m
24488,1,XAXOL,2784,97,2,0,2,100.0%,30m
24488,1,CuciFlash,2784,80,2,2,4,50.0%,18m
24488,3,AMIAK,2784,0,2,2,4,50.0%,2m
24488,3,[RavB]Lidius,2784,58,2,4,6,33.3%,12m
24488,1,astro,2784,112,2,4,6,33.3%,6m
24488,1,BubbleBuddy,2784,40,2,5,7,28.6%,46m
24488,1,Justkidding,2784,0,1,0,1,100.0%,48m
24488,2,[CRAB3]SpruceVolk,2784,0,1,0,1,100.0%,1h
24488,1,NeverNude,2784,0,1,0,1,100.0%,1h
24488,3,Lolo,2784,0,1,1,2,50.0%,12m
24488,3,Steingrimm,2784,30,1,3,4,25.0%,25m
24488,3,KpopIsGay,2784,0,1,5,6,16.7%,13m
24488,1,Домохозяйка,2784,0,0,1,1,0.0%,19m
24488,3,Fedonator,2784,0,0,2,2,0.0%,12m
24488,1,TeddyNator,2784,0,0,4,4,0.0%,22m
24514,2,Chupacabra,2783,1261,182,184,366,49.7%,10m
24514,3,Remdah,2783,1401,62,51,113,54.9%,4m
24514,3,darkOI,2783,520,45,35,80,56.2%,15m
24514,3,davelitoss,2783,951,38,29,67,56.7%,13m
24514,3,[HYX]alex,2783,716,25,29,54,46.3%,5m
24514,1,[ISK]zerglordtud,2783,251,14,11,25,56.0%,52m
24514,3,andid,2783,236,8,7,15,53.3%,4m
24514,1,[RBlood]ArKHYUS,2783,261,7,8,15,46.7%,5m
24514,2,Leonardo,2783,184,6,4,10,60.0%,37m
24514,3,GamerSC,2783,217,6,7,13,46.2%,11m
24514,3,[Crios]Alex,2783,154,6,10,16,37.5%,4m
24514,3,eoL,2783,90,4,0,4,100.0%,1h
24514,2,logan,2783,48,4,4,8,50.0%,6m
24514,1,NightShift,2783,112,3,1,4,75.0%,1h
24514,1,Tissanthor,2783,0,1,0,1,100.0%,45m
24514,3,danraven,2783,94,1,2,3,33.3%,18m
24514,3,[4CB]GAMERSTAR,2783,0,1,2,3,33.3%,10m
24514,3,blacknerpa,2783,30,1,3,4,25.0%,13m
24514,3,[LVswat]DemonRomSin,2783,0,0,1,1,0.0%,48m
24514,3,kyba,2783,0,0,2,2,0.0%,10m
24514,3,[lLiTl]Arnas,2783,0,0,2,2,0.0%,12m
24514,1,Protosexual,2783,0,0,5,5,0.0%,42m
24536,3,Kelvin,2782,1274,220,204,424,51.9%,8m
24536,2,[RnL]Neobahamut,2782,1372,95,91,186,51.1%,25m
24536,1,ArToFZeRg,2782,1207,88,85,173,50.9%,16m
24536,2,leoguitch,2782,811,62,62,124,50.0%,16m
24536,1,SlowNLow,2782,1022,49,56,105,46.7%,9m
24536,3,[FSMD88]Mailman,2782,1169,42,43,85,49.4%,17m
24536,1,stick,2782,461,30,19,49,61.2%,4m
24536,3,Валуев,2782,359,16,7,23,69.6%,4m
24536,1,GordonCole,2782,308,9,4,13,69.2%,1h
24536,1,Rancor,2782,224,6,3,9,66.7%,59m
24536,2,illusionvry,2782,152,5,15,20,25.0%,9m
24536,1,leres,2782,73,4,5,9,44.4%,1h
24536,1,[S4G]GaboHaze,2782,80,3,1,4,75.0%,30m
24536,1,GrapLex,2782,0,2,3,5,40.0%,30m
24536,2,sammon,2782,0,1,2,3,33.3%,31m
24536,3,justgoodman,2782,30,1,3,4,25.0%,10m
24536,1,DrSeedon,2782,0,1,4,5,20.0%,2m
24536,3,thompy,2782,0,0,3,3,0.0%,6m
24554,1,MUSEXE,2781,569,163,180,343,47.5%,6m
24554,3,Nagini,2781,1314,107,92,199,53.8%,9m
24554,3,CYLON,2781,1575,101,102,203,49.8%,11m
24554,2,добрыйЭэх,2781,972,42,37,79,53.2%,15m
24554,3,YOUNG,2781,631,29,19,48,60.4%,7m
24554,2,[Jg44]Hackor,2781,261,23,25,48,47.9%,1m
24554,3,alextop,2781,455,16,13,29,55.2%,5m
24554,3,Sperma,2781,236,9,9,18,50.0%,25m
24554,3,LunarNova,2781,175,5,5,10,50.0%,25m
24554,3,[cheeee]Kamo,2781,30,2,2,4,50.0%,18m
24554,3,nvcherrygg,2781,84,2,3,5,40.0%,10m
24554,3,[theDH]Bamse,2781,60,2,8,10,20.0%,12m
24554,2,MoeSTRo,2781,0,1,0,1,100.0%,39m
24554,1,[Gоld]twentYSeven,2781,0,1,0,1,100.0%,45m
24554,3,andr,2781,97,1,1,2,50.0%,31m
24554,1,Rufus,2781,42,1,2,3,33.3%,23m
24554,1,[AMG42]Bronzie,2781,0,0,1,1,0.0%,20m
24554,1,Artcher,2781,0,0,1,1,0.0%,5m
24554,3,[RBMK]Fernando,2781,0,0,2,2,0.0%,17m
24554,3,Gromozekoff,2781,0,0,2,2,0.0%,11m
24554,3,CoconutBrah,2781,0,0,4,4,0.0%,17m
24575,1,Unity,2780,1426,64,56,120,53.3%,24m
24575,1,doubrechka,2780,1033,54,50,104,51.9%,17m
24575,3,fredophil,2780,866,39,39,78,50.0%,9m
24575,3,Yoshimidzu,2780,904,37,34,71,52.1%,10m
24575,3,[GTDK]Drocky,2780,787,34,25,59,57.6%,10m
24575,3,trasjol,2780,548,24,15,39,61.5%,25m
24575,1,Bamboocha,2780,536,22,15,37,59.5%,52m
24575,3,SpYcY,2780,552,20,19,39,51.3%,24m
24575,3,Aviad,2780,454,19,22,41,46.3%,13m
24575,3,MoominPlaya,2780,324,14,7,21,66.7%,25m
24575,3,MGJTERRAN,2780,243,11,7,18,61.1%,1h
24575,1,[burrit]dafvid,2780,242,7,3,10,70.0%,45m
24575,1,[JGRU]Papamix,2780,148,6,3,9,66.7%,53m
24575,1,Belguin,2780,209,6,4,10,60.0%,57m
24575,3,GEKKO,2780,211,6,5,11,54.5%,24m
24575,3,DuszQ,2780,158,6,9,15,40.0%,15m
24575,1,Коммунизм,2780,209,5,16,21,23.8%,18m
24575,2,Lucifer,2780,60,4,8,12,33.3%,10m
24575,2,Clohyd,2780,0,3,3,6,50.0%,2m
24575,3,Zanderzon,2780,92,3,6,9,33.3%,10m
24575,3,[OLÉ]Storm,2780,90,3,7,10,30.0%,10m
24575,1,Люцифер,2780,82,2,1,3,66.7%,34m
24575,3,[heavyM]Neezo,2780,30,2,2,4,50.0%,6m
24575,3,[гусини]бот,2780,30,2,3,5,40.0%,14m
24575,3,Awakened,2780,58,2,5,7,28.6%,13m
24575,1,MamaMia,2780,0,1,0,1,100.0%,32m
24575,1,[SiTFLY]ryeryerye,2780,40,1,2,3,33.3%,1h
24575,1,Reki,2780,0,0,1,1,0.0%,9m
24575,1,Radam,2780,0,0,1,1,0.0%,24m
24575,3,sirMax,2780,0,0,2,2,0.0%,16m
24575,3,[RuVoid]FriskCerber,2780,0,0,4,4,0.0%,10m
24606,3,Lavazza,2779,1624,278,262,540,51.5%,15m
24606,2,RedRascal,2779,1567,113,113,226,50.0%,24m
24606,2,ZakHooi,2779,1389,100,98,198,50.5%,27m
24606,3,[GBLNS]DaRkLoRd,2779,682,30,26,56,53.6%,4m
24606,2,[ERIC]Shoes,2779,342,14,17,31,45.2%,9m
24606,1,BasiZmiyata,2779,186,6,2,8,75.0%,31m
24606,2,Liberta,2779,88,6,8,14,42.9%,18m
24606,3,[HeiTim]Schokobubi,2779,114,5,5,10,50.0%,6m
24606,3,[UnderP]Romano,2779,120,5,9,14,35.7%,12m
24606,3,IIIIIIIIIIII,2779,142,5,11,16,31.2%,8m
24606,3,Mustang,2779,142,5,12,17,29.4%,5m
24606,2,ThePunisher,2779,46,4,5,9,44.4%,42m
24606,3,Kreig,2779,110,3,11,14,21.4%,6m
24606,3,[CIU2]JackTheLord,2779,120,2,4,6,33.3%,13m
24606,1,Gonzo,2779,0,1,0,1,100.0%,1h
24606,1,Alex,2779,0,1,1,2,50.0%,45m
24606,1,[Hawd]KRrum,2779,42,1,1,2,50.0%,41m
24606,1,WeiGO,2779,48,1,4,5,20.0%,6m
24624,2,Eljy,2778,858,36,37,73,49.3%,14m
24624,3,Schloschgesc,2778,695,27,25,52,51.9%,9m
24624,3,RayRayz,2778,359,21,21,42,50.0%,18m
24624,3,Morose,2778,328,14,10,24,58.3%,12m
24624,3,wiggi,2778,298,13,11,24,54.2%,15m
24624,3,Luigi,2778,341,12,12,24,50.0%,8m
24624,1,[Ralls]Dom,2778,324,9,8,17,52.9%,7m
24624,3,donkeyshot,2778,208,8,8,16,50.0%,6m
24624,1,Ramzess,2778,174,8,10,18,44.4%,4m
24624,3,Noob,2778,192,7,2,9,77.8%,1h
24624,3,Bogdan,2778,183,7,3,10,70.0%,16m
24624,3,KyRRon,2778,202,7,6,13,53.8%,11m
24624,3,Hanluk,2778,150,5,9,14,35.7%,14m
24624,3,HafforS,2778,114,3,1,4,75.0%,9m
24624,2,Nosferu,2778,0,3,4,7,42.9%,10m
24624,2,Deer,2778,0,3,4,7,42.9%,24m
24624,1,Vinara,2778,144,3,8,11,27.3%,50m
24624,3,MoMo,2778,0,2,3,5,40.0%,1h
24624,1,BeterThatTea,2778,0,2,3,5,40.0%,3m
24624,1,Omri,2778,0,1,0,1,100.0%,59m
24624,3,Gizmo,2778,0,1,1,2,50.0%,12m
24624,1,[KoKz]Castro,2778,0,0,1,1,0.0%,1h
24624,3,[AngorA]MrHang,2778,0,0,2,2,0.0%,3m
24647,1,Esb,2777,1357,97,82,179,54.2%,25m
24647,2,JosUA,2777,1131,67,72,139,48.2%,26m
24647,2,Ubik,2777,882,36,36,72,50.0%,9m
24647,1,[ToC]TOXYQ,2777,988,35,30,65,53.8%,25m
24647,1,sooreen,2777,697,23,33,56,41.1%,13m
24647,3,[Gondon]Imagination,2777,387,17,15,32,53.1%,5m
24647,3,[ROFG]AnatoliyNoha,2777,345,17,18,35,48.6%,7m
24647,2,IDMUT,2777,248,10,10,20,50.0%,50m
24647,3,Anxious,2777,168,7,7,14,50.0%,18m
24647,3,Beuleu,2777,200,6,7,13,46.2%,18m
24647,3,Greedy,2777,30,5,4,9,55.6%,2m
24647,3,Henan,2777,181,5,4,9,55.6%,37m
24647,1,Sourze,2777,94,4,5,9,44.4%,55m
24647,3,[BRock]PierreTom,2777,124,4,10,14,28.6%,12m
24647,3,ColonThree,2777,0,3,2,5,60.0%,22m
24647,3,tgards,2777,113,3,2,5,60.0%,9m
24647,2,hkkzero,2777,95,3,3,6,50.0%,19m
24647,1,PwROvRwLmNg,2777,0,2,3,5,40.0%,2m
24647,1,[IRONIV]rusma,2777,0,1,0,1,100.0%,31m
24647,1,Example,2777,42,1,1,2,50.0%,48m
24647,2,IIIIIIIIIIII,2777,88,1,4,5,20.0%,15m
24647,1,Fireon,2777,0,0,1,1,0.0%,34m
24669,2,Storm,2776,1251,74,75,149,49.7%,8m
24669,3,Lando,2776,559,23,15,38,60.5%,18m
24669,3,infallible,2776,494,21,21,42,50.0%,9m
24669,1,Winger,2776,623,20,20,40,50.0%,56m
24669,1,[LnGz]Raizar,2776,467,15,15,30,50.0%,26m
24669,3,Jtam,2776,132,13,5,18,72.2%,25m
24669,2,[TaDb]Teesal,2776,233,7,15,22,31.8%,10m
24669,1,MakakTaka,2776,168,6,6,12,50.0%,6m
24669,3,[IntCC]BOB,2776,177,5,5,10,50.0%,41m
24669,3,GeneticJuice,2776,172,5,5,10,50.0%,25m
24669,1,Raiseurhatch,2776,142,4,2,6,66.7%,4m
24669,1,NoChanceForU,2776,110,4,3,7,57.1%,44m
24669,1,[МŴŚ]Toto,2776,48,4,8,12,33.3%,30m
24669,2,[TeamVO]Slane,2776,115,3,1,4,75.0%,31m
24669,2,[MHK]MARUY,2776,0,3,3,6,50.0%,2m
24669,1,LeNecroroi,2776,0,1,0,1,100.0%,52m
24669,1,tmathe,2776,0,1,1,2,50.0%,38m
24669,2,Ethereum,2776,0,1,20,21,4.8%,13m
24669,1,martin,2776,0,0,1,1,0.0%,26m
24669,1,DaWINci,2776,0,0,1,1,0.0%,5m
24669,1,[ZЕRGТV]NoOTIFly,2776,0,0,2,2,0.0%,7m
24669,3,IlFedaykin,2776,0,0,2,2,0.0%,9m
24691,1,Viper,2775,1738,136,116,252,54.0%,4m
24691,1,karasik,2775,1167,61,38,99,61.6%,9m
24691,3,Wizzard,2775,425,55,54,109,50.5%,11m
24691,3,[Kariba]Anatrox,2775,580,22,21,43,51.2%,18m
24691,3,marcus,2775,283,17,20,37,45.9%,10m
24691,3,[Koent]JonkO,2775,322,12,16,28,42.9%,9m
24691,3,Skel,2775,296,10,10,20,50.0%,5m
24691,3,Sebastien,2775,252,10,11,21,47.6%,1h
24691,2,[LaP1]pyrogoth,2775,252,10,22,32,31.2%,18m
24691,1,Ale,2775,148,6,3,9,66.7%,20m
24691,1,[pipicl]tmt,2775,120,4,1,5,80.0%,1h
24691,3,Gwynbleid,2775,166,4,2,6,66.7%,39m
24691,3,Rendor,2775,86,4,7,11,36.4%,6m
24691,1,Brainbug,2775,166,3,2,5,60.0%,41m
24691,3,Gustof,2775,140,3,3,6,50.0%,12m
24691,3,[Dralag]NeroDeath,2775,88,3,6,9,33.3%,9m
24691,3,[Timbré]spiritelixir,2775,30,2,3,5,40.0%,10m
24691,3,Steve,2775,83,1,3,4,25.0%,28m
24691,3,Pablo,2775,30,1,4,5,20.0%,17m
24691,2,барбариска,2775,0,0,1,1,0.0%,38m
24691,1,[Pandr]DieRasur,2775,0,0,1,1,0.0%,58m
24691,1,Assasinbeast,2775,0,0,1,1,0.0%,27m
24691,3,[ILLIR]DARKPRIEUR,2775,0,0,2,2,0.0%,25m
24714,3,DevilNT,2774,1514,96,87,183,52.5%,9m
24714,2,[SAKZ]Ossan,2774,1474,84,92,176,47.7%,1m
24714,1,dadcore,2774,761,56,74,130,43.1%,17m
24714,2,[xTDA]Phylexian,2774,502,38,46,84,45.2%,10m
24714,1,LYNX,2774,960,32,32,64,50.0%,3m
24714,3,BlueOcean,2774,628,27,18,45,60.0%,10m
24714,1,Hagaren,2774,257,10,13,23,43.5%,9m
24714,2,Smeeton,2774,211,9,9,18,50.0%,10m
24714,3,[OSNC]IIIIIIIIIIII,2774,284,9,9,18,50.0%,13m
24714,1,Leonidas,2774,0,5,3,8,62.5%,42m
24714,2,crackmigg,2774,164,5,4,9,55.6%,47m
24714,3,UHJ,2774,148,5,14,19,26.3%,40m
24714,1,Starthefred,2774,88,4,2,6,66.7%,44m
24714,1,misekemitoko,2774,156,4,6,10,40.0%,1h
24714,3,Shurik,2774,124,4,12,16,25.0%,17m
24714,1,DiMiD,2774,80,3,0,3,100.0%,34m
24714,1,ХмурыйМонах,2774,42,2,1,3,66.7%,59m
24714,3,DrGonzo,2774,0,2,3,5,40.0%,3m
24714,3,help,2774,58,2,9,11,18.2%,5m
24714,1,Soha,2774,0,0,1,1,0.0%,22m
24734,3,stefk,2773,1233,79,73,152,52.0%,11m
24734,3,Zecater,2773,1565,71,62,133,53.4%,4m
24734,3,LeViaThan,2773,763,33,30,63,52.4%,9m
24734,3,peterwhie,2773,733,32,23,55,58.2%,17m
24734,1,ThunderBird,2773,749,31,18,49,63.3%,1h
24734,3,PickleRick,2773,514,24,19,43,55.8%,6m
24734,3,GottesErbe,2773,471,21,15,36,58.3%,10m
24734,3,Pepe,2773,446,18,13,31,58.1%,5m
24734,3,itybityzergy,2773,419,16,16,32,50.0%,6m
24734,3,Drastic,2773,431,14,14,28,50.0%,17m
24734,3,Chareck,2773,424,14,17,31,45.2%,3m
24734,1,pierrot,2773,388,12,5,17,70.6%,44m
24734,1,lolek,2773,323,12,13,25,48.0%,30m
24734,3,[FiU]Tschilo,2773,322,11,9,20,55.0%,16m
24734,1,SuperSonics,2773,275,9,10,19,47.4%,5m
24734,1,Bidjo,2773,245,9,10,19,47.4%,18m
24734,3,[weekly]LadiesChoicE,2773,178,6,13,19,31.6%,16m
24734,2,Iulius,2773,186,5,5,10,50.0%,19m
24734,3,[HollоW]Hiten,2773,0,4,1,5,80.0%,48m
24734,1,[HGGZ]Kanoya,2773,105,3,8,11,27.3%,16m
24734,1,rendo,2773,70,2,2,4,50.0%,34m
24734,1,HufferPuffer,2773,40,1,1,2,50.0%,52m
24734,3,SniperKing,2773,0,1,4,5,20.0%,32m
24734,3,[IceHus]typicalplayr,2773,30,1,7,8,12.5%,10m
24734,1,Deev,2773,0,0,1,1,0.0%,2m
24734,1,ZephyroOX,2773,0,0,1,1,0.0%,5m
24734,3,nEwRace,2773,0,0,2,2,0.0%,18m
24734,3,KemoK,2773,0,0,3,3,0.0%,10m
24762,1,JOHAN,2772,1619,82,82,164,50.0%,16m
24762,1,Azamalin,2772,1358,56,45,101,55.4%,4m
24762,1,evg,2772,999,38,31,69,55.1%,49m
24762,3,Vito,2772,580,36,19,55,65.5%,27m
24762,1,[298K]Okarin,2772,889,30,24,54,55.6%,24m
24762,3,eczdervis,2772,679,29,26,55,52.7%,9m
24762,2,MrStark,2772,486,17,28,45,37.8%,10m
24762,1,Westah,2772,441,15,14,29,51.7%,37m
24762,3,shai,2772,351,14,9,23,60.9%,5m
24762,1,Ckitalec,2772,320,10,4,14,71.4%,44m
24762,1,[SNRGY]Anvar,2772,304,8,6,14,57.1%,52m
24762,2,RdyTwoRun,2772,209,6,4,10,60.0%,1h
24762,3,хилюнеори,2772,157,5,3,8,62.5%,2m
24762,1,DeathKnight,2772,162,5,5,10,50.0%,1h
24762,3,KuroFox,2772,169,4,5,9,44.4%,2m
24762,3,AttakaiKaze,2772,118,4,6,10,40.0%,11m
24762,3,Aqua,2772,111,3,3,6,50.0%,9m
24762,1,Andrey,2772,119,3,3,6,50.0%,1h
24762,2,[TSB]Arjen,2772,118,3,4,7,42.9%,1h
24762,1,GGNOWKISKILL,2772,120,3,4,7,42.9%,8m
24762,1,[Ирбис]alex,2772,0,2,3,5,40.0%,37m
24762,2,[tetguy]Gamygym,2772,58,2,12,14,14.3%,10m
24762,3,delsolaris,2772,0,1,1,2,50.0%,5m
24762,3,iRON,2772,30,1,5,6,16.7%,1h
24762,1,Rabiba,2772,0,0,1,1,0.0%,4m
24762,1,xPhEniXx,2772,0,0,1,1,0.0%,2m
24762,1,TheMachine,2772,0,0,1,1,0.0%,6m
24762,2,Magthepon,2772,0,0,1,1,0.0%,35m
24790,1,IzI,2771,1508,116,95,211,55.0%,19m
24790,1,Titic,2771,987,77,68,145,53.1%,17m
24790,3,Ragiex,2771,329,75,55,130,57.7%,6m
24790,3,Broze,2771,1158,71,71,142,50.0%,11m
24790,2,[Gauge]Pigspanker,2771,1272,60,65,125,48.0%,13m
24790,1,Hose,2771,975,33,25,58,56.9%,1h
24790,3,MicroondasR,2771,734,30,28,58,51.7%,12m
24790,1,Sallent,2771,368,10,9,19,52.6%,8m
24790,3,ArkMan,2771,295,9,8,17,52.9%,15m
24790,3,NHP,2771,200,7,10,17,41.2%,25m
24790,3,amgpferd,2771,208,7,11,18,38.9%,11m
24790,1,[LGNxEU]Tomer,2771,0,5,0,5,100.0%,5m
24790,3,TRIBUNAL,2771,140,5,8,13,38.5%,17m
24790,2,SOR,2771,95,4,3,7,57.1%,1h
24790,3,[ZALP]barabashka,2771,146,3,4,7,42.9%,10m
24790,1,Widowmaker,2771,80,2,1,3,66.7%,2m
24790,3,ВЛАСТЕЛИН,2771,30,2,2,4,50.0%,16m
24790,3,[АDorit]LowAPM,2771,30,2,2,4,50.0%,5m
24790,3,KZA,2771,30,1,4,5,20.0%,24m
24790,1,LonyStar,2771,0,0,1,1,0.0%,54m
24810,3,Celebrimbor,2770,1023,46,41,87,52.9%,3m
24810,3,[Bambi2]Waul,2770,473,18,17,35,51.4%,9m
24810,2,[hf4X4]GlitchMaster,2770,456,16,21,37,43.2%,9m
24810,3,Panorama,2770,360,13,12,25,52.0%,17m
24810,1,[SUF]Malco,2770,262,10,10,20,50.0%,50m
24810,1,[qip]БогМикро,2770,312,9,3,12,75.0%,43m
24810,1,[BloTi]MonteCristo,2770,240,7,8,15,46.7%,59m
24810,1,[CIGC]MrSmi,2770,188,4,3,7,57.1%,2m
24810,1,[ENUAER]ENUAEAR,2770,106,4,4,8,50.0%,57m
24810,3,Mexxn,2770,161,4,6,10,40.0%,9m
24810,1,DarkElder,2770,80,3,1,4,75.0%,27m
24810,3,louiz,2770,120,3,2,5,60.0%,4m
24810,3,Fahrengate,2770,0,3,3,6,50.0%,9m
24810,1,[SUDA]bananana,2770,0,2,3,5,40.0%,4m
24810,2,[NeBa]Eoniron,2770,0,1,0,1,100.0%,1h
24810,2,KillerPalle,2770,0,1,0,1,100.0%,4m
24826,3,[Heroes]BigBrotoss,2769,1593,298,259,557,53.5%,18m
24826,1,SaSSoN,2769,1485,105,117,222,47.3%,3m
24826,3,vertexarray,2769,938,102,93,195,52.3%,2m
24826,1,[Heroes]CapnCrunch,2769,1285,97,97,194,50.0%,27m
24826,1,[Hacı]WaSuDoKu,2769,1010,39,27,66,59.1%,5m
24826,1,Schnulli,2769,491,30,14,44,68.2%,20m
24826,2,karaz,2769,389,16,7,23,69.6%,60m
24826,3,DomPrats,2769,313,10,10,20,50.0%,25m
24826,1,[DIAHN]Pushipuss,2769,297,8,3,11,72.7%,2m
24826,1,Hughes,2769,224,7,6,13,53.8%,27m
24826,2,Nüschel,2769,176,7,14,21,33.3%,10m
24826,3,[Animoo]Leczez,2769,142,6,6,12,50.0%,12m
24826,1,Bumbe,2769,212,5,5,10,50.0%,36m
24826,1,[HLX]PlasmaStorm,2769,96,5,6,11,45.5%,1h
24826,1,[SPCs]RightProfit,2769,42,2,1,3,66.7%,4m
24826,1,agardi,2769,0,2,3,5,40.0%,1h
24826,1,Zsugabubus,2769,36,1,1,2,50.0%,30m
24826,1,[FAZE69]WøŁf,2769,0,1,1,2,50.0%,4m
24826,3,Demoneus,2769,0,1,1,2,50.0%,2m
24826,1,Vnitu,2769,0,1,1,2,50.0%,38m
24826,1,Random,2769,40,1,2,3,33.3%,43m
24826,1,Slay,2769,42,1,2,3,33.3%,1h
24826,1,Vital,2769,0,1,4,5,20.0%,43m
24826,2,[MHunt]DrBusman,2769,0,0,1,1,0.0%,4m
24826,1,[Wo4R]Woluex,2769,0,0,1,1,0.0%,25m
24826,1,[oII0]StarCat,2769,0,0,2,2,0.0%,1h
24826,1,[БОБ]Душесос,2769,0,0,2,2,0.0%,58m
24826,2,CRABMAN,2769,0,0,3,3,0.0%,23m
24854,2,Lucky,2768,921,101,89,190,53.2%,5m
24854,3,EGǂFeeLing,2768,1584,74,64,138,53.6%,4m
24854,3,[WCITF]Key,2768,1428,65,56,121,53.7%,12m
24854,1,SnakeOdUA,2768,1221,53,56,109,48.6%,25m
24854,3,NoX,2768,864,47,42,89,52.8%,13m
24854,1,Luckers,2768,491,27,21,48,56.2%,34m
24854,1,DaveyBach,2768,575,23,24,47,48.9%,1h
24854,1,[Luten]Gizzy,2768,582,20,18,38,52.6%,59m
24854,3,Zermingore,2768,467,18,15,33,54.5%,26m
24854,1,Malper,2768,480,15,11,26,57.7%,43m
24854,3,Marafettiq,2768,359,15,18,33,45.5%,10m
24854,3,[БГТ]Лупа,2768,274,9,9,18,50.0%,2m
24854,3,SirCus,2768,218,8,11,19,42.1%,9m
24854,1,oleg,2768,36,5,1,6,83.3%,52m
24854,2,NSwarrrior,2768,30,4,6,10,40.0%,12m
24854,2,Ares,2768,93,3,3,6,50.0%,19m
24854,2,Taku,2768,94,3,4,7,42.9%,1h
24854,1,zeckron,2768,126,3,5,8,37.5%,52m
24854,1,[NICHE]PrettyFly,2768,40,2,1,3,66.7%,31m
24854,1,[MiOwA]WastPowie,2768,0,1,0,1,100.0%,19m
24854,3,Max,2768,32,1,1,2,50.0%,1h
24854,2,Stive,2768,0,1,1,2,50.0%,48m
24854,3,XANWI,2768,0,1,2,3,33.3%,25m
24854,3,[TARune]Omlain,2768,30,1,7,8,12.5%,6m
24854,1,Tsunami,2768,0,0,1,1,0.0%,34m
24854,2,Gawi,2768,0,0,2,2,0.0%,24m
24880,2,[SOECES]BridoKiLLeR,2767,1417,96,106,202,47.5%,10m
24880,3,Urville,2767,751,61,51,112,54.5%,18m
24880,1,RusVarver,2767,1194,53,63,116,45.7%,13m
24880,3,Excitle,2767,763,29,27,56,51.8%,3m
24880,1,Sxten,2767,671,24,36,60,40.0%,8m
24880,1,llllllllllll,2767,614,21,22,43,48.8%,26m
24880,3,DaEver,2767,428,18,18,36,50.0%,6m
24880,2,Hanzy,2767,428,18,20,38,47.4%,18m
24880,1,Fürgeróka,2767,522,17,27,44,38.6%,17m
24880,3,fatman,2767,334,15,16,31,48.4%,12m
24880,3,OnlyZerg,2767,189,12,9,21,57.1%,9m
24880,1,[357mag]benek,2767,302,9,8,17,52.9%,40m
24880,1,Glühdraht,2767,332,9,10,19,47.4%,46m
24880,1,Shemhazai,2767,250,8,9,17,47.1%,33m
24880,2,HarryB,2767,218,8,17,25,32.0%,9m
24880,2,Ezekiel,2767,212,7,5,12,58.3%,29m
24880,3,[1C5]CocainCowboy,2767,215,7,7,14,50.0%,18m
24880,3,AlexUnder,2767,218,7,12,19,36.8%,12m
24880,2,callmePA,2767,116,5,5,10,50.0%,25m
24880,2,EleMenTal,2767,119,4,3,7,57.1%,1h
24880,1,OverLasting,2767,0,4,4,8,50.0%,59m
24880,1,FriedSushi,2767,97,4,5,9,44.4%,53m
24880,3,Azuros,2767,132,3,3,6,50.0%,14m
24880,1,Szok,2767,0,1,0,1,100.0%,2m
24880,3,[evo4]Supersnoop,2767,0,1,0,1,100.0%,25m
24880,3,[NSFG0D]LiionSKenedy,2767,0,1,3,4,25.0%,2m
24880,3,KovidXii,2767,0,0,1,1,0.0%,18m
24880,2,Saybork,2767,0,0,1,1,0.0%,33m
24880,3,ZoolCarbon,2767,0,0,2,2,0.0%,2m
24880,1,cedoeyxo,2767,0,0,2,2,0.0%,27m
24910,2,[GLTV]Belogriw,2766,1428,257,237,494,52.0%,18m
24910,3,Nero,2766,1582,126,123,249,50.6%,4m
24910,2,CptKock,2766,827,40,45,85,47.1%,15m
24910,2,Chillkröte,2766,443,37,48,85,43.5%,10m
24910,1,mag,2766,364,12,8,20,60.0%,34m
24910,3,[SAW50]ApelsinchiK,2766,245,8,7,15,53.3%,25m
24910,1,konflikt,2766,181,7,5,12,58.3%,46m
24910,1,iQNoX,2766,220,5,5,10,50.0%,21m
24910,2,llIlIlI,2766,128,4,4,8,50.0%,27m
24910,1,[Маэстр]Smitsmit,2766,0,3,2,5,60.0%,9m
24910,3,Deivs,2766,101,3,2,5,60.0%,17m
24910,2,IIIIIIIIIIII,2766,0,3,4,7,42.9%,10m
24910,2,[HZSC2]malod,2766,42,3,5,8,37.5%,38m
24910,2,WasFalsch,2766,0,1,0,1,100.0%,26m
24910,1,[ECU]ecuYaz,2766,0,1,1,2,50.0%,24m
24910,2,Hobekotkas,2766,94,1,1,2,50.0%,1h
24910,1,lille,2766,0,0,1,1,0.0%,1h
24910,1,[M2X]blq,2766,0,0,2,2,0.0%,52m
24928,3,MementoMori,2765,808,77,66,143,53.8%,18m
24928,3,Alakir,2765,1444,76,84,160,47.5%,5m
24928,2,birdlives,2765,771,46,42,88,52.3%,24m
24928,2,KdxE,2765,1116,41,47,88,46.6%,12m
24928,3,PRIMEX,2765,800,31,28,59,52.5%,17m
24928,3,Kage,2765,764,30,29,59,50.8%,11m
24928,3,FleX,2765,568,20,24,44,45.5%,9m
24928,2,[FTMW]rondomedia,2765,470,16,21,37,43.2%,26m
24928,1,Gallson,2765,247,9,7,16,56.2%,30m
24928,1,[lBBTl]laBRUTE,2765,306,8,6,14,57.1%,59m
24928,3,Klang,2765,168,6,6,12,50.0%,1m
24928,3,Orcade,2765,121,5,7,12,41.7%,35m
24928,3,[SCTR]CraZZy,2765,30,4,4,8,50.0%,24m
24928,1,[WuTaCl]Afghane,2765,82,3,2,5,60.0%,43m
24928,1,Holzken,2765,78,3,2,5,60.0%,2m
24928,1,Chaosberk,2765,117,3,2,5,60.0%,5m
24928,3,PixelTrooper,2765,144,3,5,8,37.5%,9m
24928,3,[WtCG]FrOstiIzZ,2765,0,2,3,5,40.0%,20m
24928,3,ZuBy,2765,30,2,4,6,33.3%,24m
24928,2,Daristotel,2765,0,1,1,2,50.0%,44m
24928,1,[ZPCS]DimonDych,2765,38,1,1,2,50.0%,41m
24928,1,[MyGaAc]WindBreaker,2765,32,1,2,3,33.3%,48m
24928,1,vladsaper,2765,36,1,3,4,25.0%,33m
24928,2,AoGGloRy,2765,0,0,1,1,0.0%,1h
24928,3,GerOfTheStar,2765,0,0,1,1,0.0%,55m
24928,1,Scornn,2765,0,0,2,2,0.0%,2m
24928,3,DesertArcher,2765,0,0,2,2,0.0%,17m
24928,3,Luktim,2765,0,0,5,5,0.0%,10m
24956,2,Julian,2764,1563,197,189,386,51.0%,3m
24956,3,[LOGS]wazzzuuuupp,2764,1556,161,122,283,56.9%,3m
24956,2,ruslanyan,2764,594,146,134,280,52.1%,7m
24956,3,Loki,2764,1186,76,74,150,50.7%,9m
24956,3,FarbrorMusse,2764,484,21,19,40,52.5%,14m
24956,3,[Cigar]TomRipley,2764,545,19,20,39,48.7%,25m
24956,3,bloodraven,2764,444,17,15,32,53.1%,25m
24956,3,FiftyBliss,2764,415,17,16,33,51.5%,10m
24956,1,Zox,2764,273,16,10,26,61.5%,24m
24956,1,VoidAbyss,2764,162,5,2,7,71.4%,54m
24956,1,[Phrog]Aphotic,2764,120,5,5,10,50.0%,22m
24956,3,Choach,2764,30,4,4,8,50.0%,9m
24956,1,Seph,2764,97,4,5,9,44.4%,50m
24956,1,OutLaW,2764,42,2,0,2,100.0%,25m
24956,1,DeMad,2764,48,2,2,4,50.0%,38m
24956,3,Limej,2764,34,2,3,5,40.0%,50m
24956,2,ReperSM,2764,0,1,0,1,100.0%,37m
24956,1,Jareks,2764,40,1,2,3,33.3%,44m
24956,3,Smirolio,2764,0,1,3,4,25.0%,5m
24956,3,[HUEMAE]HappyNewFear,2764,30,1,5,6,16.7%,11m
24956,3,ShampooLord,2764,30,1,5,6,16.7%,3m
24956,1,sprinteur,2764,0,0,1,1,0.0%,1h
24956,1,æng,2764,0,0,2,2,0.0%,22m
24956,3,Kiroin,2764,0,0,3,3,0.0%,2m
24980,1,[U19]Soldatich,2763,764,60,60,120,50.0%,8m
24980,2,Kikilicious,2763,700,57,60,117,48.7%,12m
24980,1,Nide,2763,1630,55,58,113,48.7%,22m
24980,1,[PPoRR]iMpAcT,2763,1407,53,43,96,55.2%,1h
24980,1,Chupacabra,2763,827,53,51,104,51.0%,7m
24980,1,RobotNinja,2763,833,51,41,92,55.4%,2m
24980,1,AnnIonch,2763,993,39,24,63,61.9%,1h
24980,3,[WLDD]HMDC,2763,705,34,24,58,58.6%,2m
24980,3,Zergdoktor,2763,709,27,26,53,50.9%,6m
24980,1,Pleticosa,2763,628,20,17,37,54.1%,46m
24980,3,Poseidon,2763,420,17,16,33,51.5%,26m
24980,2,KING,2763,388,14,20,34,41.2%,10m
24980,3,Nacl,2763,291,13,11,24,54.2%,9m
24980,1,[SkBG]Sanders,2763,310,13,16,29,44.8%,11m
24980,1,Nop,2763,379,11,5,16,68.8%,46m
24980,2,[59APM]TiredBear,2763,330,11,19,30,36.7%,13m
24980,2,CeeliX,2763,172,7,8,15,46.7%,2m
24980,1,DrProfNo,2763,259,6,4,10,60.0%,43m
24980,2,[YSB]HeavyPain,2763,46,4,4,8,50.0%,37m
24980,3,[DmdSh]Solt,2763,108,4,7,11,36.4%,18m
24980,2,Hitohi,2763,174,4,8,12,33.3%,44m
24980,1,Ximik,2763,72,3,0,3,100.0%,27m
24980,1,[Iancu]Moloz,2763,88,3,3,6,50.0%,5m
24980,1,SouLShakeR,2763,163,3,5,8,37.5%,31m
24980,2,AubeZero,2763,58,2,10,12,16.7%,12m
24980,1,[MADNSS]MugenKyoki,2763,0,1,0,1,100.0%,52m
24980,1,ZERATUL,2763,0,0,1,1,0.0%,48m
25007,2,Kladris,2762,1567,182,182,364,50.0%,5m
25007,2,AsiRis,2762,1391,111,99,210,52.9%,25m
25007,3,DrMonster,2762,1507,97,97,194,50.0%,10m
25007,3,Tredii,2762,1020,41,35,76,53.9%,4m
25007,1,Mattagon,2762,995,40,25,65,61.5%,1h
25007,3,JudasPriest,2762,456,24,14,38,63.2%,16m
25007,3,zjxpro,2762,648,23,25,48,47.9%,18m
25007,3,WipeR,2762,409,17,14,31,54.8%,4m
25007,3,[Heroes]pavele,2762,260,10,6,16,62.5%,8m
25007,3,BloodBearer,2762,238,9,13,22,40.9%,13m
25007,1,Shargo,2762,241,8,8,16,50.0%,1h
25007,1,Phoenix,2762,240,7,6,13,53.8%,31m
25007,3,Tonimon,2762,218,7,13,20,35.0%,7m
25007,1,IlIIlIlI,2762,206,6,5,11,54.5%,26m
25007,1,Chucky,2762,162,6,5,11,54.5%,31m
25007,3,Iceh,2762,154,6,6,12,50.0%,3m
25007,2,Garp,2762,118,6,10,16,37.5%,6m
25007,3,[ZERGTV]Observer,2762,124,5,8,13,38.5%,13m
25007,1,[RuLi]Okreh,2762,95,3,1,4,75.0%,5m
25007,1,Wonziu,2762,120,3,2,5,60.0%,55m
25007,1,Rabaaz,2762,80,3,2,5,60.0%,25m
25007,1,[АDMIN]LFIS,2762,40,2,0,2,100.0%,38m
25007,1,Samnya,2762,40,2,0,2,100.0%,43m
25007,3,[HOERS]BlessYou,2762,133,2,7,9,22.2%,2m
25007,2,OTSS,2762,46,1,1,2,50.0%,1h
25007,1,[Cossac]Gross,2762,42,1,3,4,25.0%,49m
25007,3,ZioKraxia,2762,97,1,4,5,20.0%,37m
25007,1,[TMM21]Smoothie,2762,0,0,1,1,0.0%,6m
25007,1,Alex,2762,0,0,1,1,0.0%,48m
25007,1,Elennor,2762,0,0,1,1,0.0%,47m
25007,3,[ЗЕRGТV]xMISAx,2762,0,0,3,3,0.0%,6m
25038,3,[D0N3]KwADwO,2761,1554,126,131,257,49.0%,10m
25038,3,pnd,2761,1606,82,84,166,49.4%,10m
25038,3,ELIMINATOR,2761,1458,61,60,121,50.4%,3m
25038,3,radas,2761,777,34,27,61,55.7%,4m
25038,3,KATIE,2761,764,32,26,58,55.2%,4m
25038,3,MAloy,2761,561,25,15,40,62.5%,13m
25038,3,Darkened,2761,542,22,17,39,56.4%,17m
25038,3,Sebo,2761,378,14,17,31,45.2%,8m
25038,3,GrandRoyal,2761,246,9,6,15,60.0%,6m
25038,1,MinaMax,2761,305,8,5,13,61.5%,19m
25038,2,REtinaZER,2761,214,7,19,26,26.9%,7m
25038,1,bill,2761,142,5,1,6,83.3%,59m
25038,1,Jamside,2761,255,5,4,9,55.6%,30m
25038,3,KoLco,2761,164,5,7,12,41.7%,10m
25038,3,CocoComeL,2761,30,4,4,8,50.0%,18m
25038,2,ADAM,2761,46,4,4,8,50.0%,1h
25038,2,KamiNari,2761,144,4,7,11,36.4%,4m
25038,1,Shathe,2761,80,2,2,4,50.0%,34m
25038,3,[spbila]Kirk,2761,93,2,3,5,40.0%,3m
25038,3,Microwave,2761,114,2,3,5,40.0%,5m
25038,2,ccdrik,2761,94,2,4,6,33.3%,56m
25038,1,NoobSaibot,2761,0,1,1,2,50.0%,59m
25038,3,[SCcoop]assassin,2761,0,1,2,3,33.3%,11m
25038,1,KAWA,2761,40,1,2,3,33.3%,33m
25038,3,GeneralBæsh,2761,0,0,1,1,0.0%,51m
25038,2,Saurcroc,2761,0,0,2,2,0.0%,21m
25038,3,alexsei,2761,0,0,3,3,0.0%,10m
25065,3,[xxAGxx]Skretchyy,2760,1124,125,116,241,51.9%,15m
25065,3,DonBilbo,2760,613,113,94,207,54.6%,17m
25065,3,[FR1]TRUMP,2760,1625,68,72,140,48.6%,18m
25065,2,[InitRu]Lambo,2760,221,43,39,82,52.4%,9m
25065,2,[UCW]PsKinggood,2760,1157,40,53,93,43.0%,26m
25065,3,ICA,2760,945,37,35,72,51.4%,5m
25065,3,SiriusBLACK,2760,579,23,21,44,52.3%,16m
25065,3,[Xa]Asso,2760,525,22,20,42,52.4%,13m
25065,3,iananas,2760,421,21,17,38,55.3%,11m
25065,3,[Horst]holzi,2760,387,17,17,34,50.0%,26m
25065,3,Grummelbär,2760,92,14,21,35,40.0%,9m
25065,3,[Hrr]Kelv,2760,367,13,13,26,50.0%,15m
25065,1,Edison,2760,373,12,5,17,70.6%,48m
25065,2,megatoster,2760,326,12,17,29,41.4%,26m
25065,1,Apo,2760,300,10,9,19,52.6%,24m
25065,3,QuickBen,2760,169,9,4,13,69.2%,17m
25065,2,NaHell,2760,220,8,11,19,42.1%,24m
25065,1,Deom,2760,110,7,4,11,63.6%,9m
25065,1,Gunilla,2760,210,4,6,10,40.0%,24m
25065,3,RoscanAlex,2760,114,4,10,14,28.6%,18m
25065,1,Hedgehog,2760,0,3,4,7,42.9%,19m
25065,2,[MANGE]Chazam,2760,46,2,0,2,100.0%,31m
25065,3,DuLac,2760,0,2,3,5,40.0%,34m
25065,3,Shamanking,2760,0,2,3,5,40.0%,34m
25065,1,Jallupaukku,2760,80,2,3,5,40.0%,1h
25065,1,Haze,2760,0,2,3,5,40.0%,5m
25065,2,TheOrboy,2760,0,1,0,1,100.0%,59m
25065,1,atapidriver,2760,0,1,1,2,50.0%,9m
25065,1,cheville,2760,38,1,1,2,50.0%,38m
25065,1,[8DJ8]Sebby,2760,96,1,2,3,33.3%,1h
25065,1,Jaeyx,2760,40,1,3,4,25.0%,46m
25065,3,[FrcLn]SzobiPetya,2760,30,1,6,7,14.3%,12m
25065,3,Nuka,2760,0,0,1,1,0.0%,21m
25065,2,serjs,2760,0,0,1,1,0.0%,2m
25065,3,PikkewynMan,2760,0,0,3,3,0.0%,13m
25100,2,Neiro,2759,1190,100,80,180,55.6%,10m
25100,3,Aaron,2759,1121,49,42,91,53.8%,2m
25100,2,Speed,2759,359,46,37,83,55.4%,15m
25100,3,Fire,2759,476,26,22,48,54.2%,5m
25100,1,DarkǂBlast,2759,256,8,8,16,50.0%,49m
25100,1,Rehsur,2759,123,4,4,8,50.0%,41m
25100,1,Saido,2759,118,3,3,6,50.0%,31m
25100,1,Laxus,2759,40,2,0,2,100.0%,22m
25100,3,ZERG,2759,0,2,5,7,28.6%,2m
25100,3,DrooG,2759,64,2,9,11,18.2%,11m
25100,1,lymmeln,2759,0,1,0,1,100.0%,27m
25100,2,SirThuzad,2759,95,1,1,2,50.0%,50m
25100,1,Антон,2759,0,0,1,1,0.0%,44m
25100,1,KatariTari,2759,0,0,1,1,0.0%,1h
25100,1,kukruss,2759,0,0,2,2,0.0%,22m
25100,3,KillerMarti,2759,0,0,3,3,0.0%,18m
25116,3,Sencux,2758,1540,61,60,121,50.4%,4m
25116,1,Komi,2758,1489,57,40,97,58.8%,58m
25116,3,mbum,2758,778,53,51,104,51.0%,11m
25116,1,ZergIsOp,2758,1028,36,33,69,52.2%,42m
25116,1,чорт,2758,489,33,27,60,55.0%,20m
25116,3,Shturmovik,2758,486,30,32,62,48.4%,11m
25116,1,ikki,2758,377,13,10,23,56.5%,59m
25116,1,[YRU]Twosmoker,2758,284,10,5,15,66.7%,8m
25116,1,Prometheus,2758,182,5,4,9,55.6%,8m
25116,1,Dzar,2758,74,3,0,3,100.0%,44m
25116,1,[SDDDD]Muchahos,2758,84,3,3,6,50.0%,43m
25116,3,Baneling,2758,0,3,3,6,50.0%,8m
25116,3,FREE,2758,60,3,8,11,27.3%,16m
25116,1,SlagterSvend,2758,42,2,2,4,50.0%,19m
25116,1,Dexter,2758,0,2,3,5,40.0%,53m
25116,3,Alexander,2758,0,2,4,6,33.3%,12m
25116,1,[яєѕ]BigBrother,2758,0,1,0,1,100.0%,9m
25116,1,pellepelle,2758,48,1,2,3,33.3%,1h
25116,1,Glenfiddich,2758,48,1,4,5,20.0%,22m
25116,3,viper,2758,0,0,1,1,0.0%,19m
25136,1,eini,2757,1499,70,65,135,51.9%,30m
25136,2,[VAP]Jinzo,2757,974,37,45,82,45.1%,10m
25136,3,Beckha,2757,770,32,23,55,58.2%,4m
25136,3,peppe,2757,528,23,19,42,54.8%,5m
25136,1,Nemo,2757,328,21,11,32,65.6%,46m
25136,1,[ZERG7V]Sharkman,2757,414,12,9,21,57.1%,52m
25136,1,[NigTer]AlexdjEP,2757,328,11,11,22,50.0%,59m
25136,3,Cyberdriver,2757,210,8,10,18,44.4%,24m
25136,1,Dualsokes,2757,166,7,5,12,58.3%,50m
25136,3,[WАSD]Starman,2757,228,7,8,15,46.7%,51m
25136,3,[UWDIE]Khimi,2757,200,6,9,15,40.0%,14m
25136,2,[Swappy]Murmelizer,2757,112,4,4,8,50.0%,31m
25136,1,[KAVDR]Waaagh,2757,97,4,5,9,44.4%,53m
25136,2,Smn,2757,151,4,12,16,25.0%,26m
25136,3,Vadim,2757,0,2,1,3,66.7%,43m
25136,3,[Roq4t]BeerAndVodka,2757,0,2,2,4,50.0%,46m
25136,3,alexander,2757,0,2,3,5,40.0%,5m
25136,1,[ZERGТV]FanVof,2757,0,2,3,5,40.0%,41m
25136,1,[THA]Endi,2757,0,1,1,2,50.0%,24m
25136,3,Kurisuti,2757,30,1,4,5,20.0%,25m
25136,3,linus,2757,0,0,1,1,0.0%,48m
25136,1,aceofspades,2757,0,0,5,5,0.0%,43m
25136,3,scøørn,2757,0,0,5,5,0.0%,17m
25159,3,Sibanac,2756,1575,242,216,458,52.8%,9m
25159,3,Valanar,2756,1381,105,92,197,53.3%,4m
25159,3,Clees,2756,1044,65,66,131,49.6%,2m
25159,1,WarLord,2756,948,36,27,63,57.1%,8m
25159,3,Rhoku,2756,950,36,40,76,47.4%,4m
25159,2,Димандекс,2756,235,9,12,21,42.9%,51m
25159,1,Paka,2756,218,8,10,18,44.4%,4m
25159,3,POPCORN,2756,245,7,8,15,46.7%,21m
25159,3,Kaofael,2756,204,7,12,19,36.8%,18m
25159,2,EvilivE,2756,178,6,4,10,60.0%,20m
25159,2,stasMaru,2756,143,5,5,10,50.0%,26m
25159,1,[WAAR]BIQAS,2756,150,4,1,5,80.0%,2m
25159,1,Marex,2756,89,3,3,6,50.0%,38m
25159,1,SzyszonEX,2756,88,3,3,6,50.0%,44m
25159,3,[MSII]Fahio,2756,145,3,6,9,33.3%,6m
25159,1,RaptorHavx,2756,42,2,0,2,100.0%,1h
25159,1,Zhuk,2756,0,2,1,3,66.7%,1h
25159,3,ChessCitten,2756,0,2,3,5,40.0%,1h
25159,1,max,2756,40,1,3,4,25.0%,1h
25159,1,Mabbru,2756,40,1,3,4,25.0%,52m
25159,1,Shendelzare,2756,42,1,3,4,25.0%,56m
25159,3,Lujien,2756,0,0,2,2,0.0%,18m
25159,3,Pashhar,2756,0,0,3,3,0.0%,11m
25159,3,SocjoŚwir,2756,0,0,5,5,0.0%,13m
25183,2,SpeTz,2755,1593,245,251,496,49.4%,14m
25183,3,Midzenis,2755,1462,154,132,286,53.8%,2m
25183,2,[UF2AC]tvorec,2755,552,46,43,89,51.7%,9m
25183,1,Cookiemaniac,2755,720,25,23,48,52.1%,5m
25183,3,Hosghen,2755,532,20,18,38,52.6%,4m
25183,3,[KievUA]ReezaK,2755,229,20,20,40,50.0%,5m
25183,3,Repton,2755,421,16,15,31,51.6%,2m
25183,3,Killzone,2755,306,14,10,24,58.3%,3m
25183,1,Subik,2755,340,13,14,27,48.1%,33m
25183,2,Zingo,2755,358,11,21,32,34.4%,27m
25183,1,MagusAdptus,2755,332,10,7,17,58.8%,1h
25183,1,Mojita,2755,332,10,8,18,55.6%,39m
25183,3,Kriton,2755,258,10,9,19,52.6%,7m
25183,1,Prophet,2755,235,9,4,13,69.2%,59m
25183,3,Sab,2755,144,8,7,15,53.3%,2m
25183,3,VIPTankz,2755,186,6,3,9,66.7%,26m
25183,1,ThatScrub,2755,0,5,3,8,62.5%,2m
25183,1,micolaminsky,2755,141,4,1,5,80.0%,18m
25183,3,Greg,2755,116,2,4,6,33.3%,9m
25183,1,Bibleman,2755,0,1,0,1,100.0%,2m
25183,1,[ZELNAG]Tigervic,2755,0,1,1,2,50.0%,2m
25183,1,[Yedaz]grumpyelf,2755,0,1,4,5,20.0%,1h
25183,1,Silentium,2755,0,0,1,1,0.0%,1h
25183,1,Sinsuko,2755,0,0,1,1,0.0%,18m
25183,1,mroovy,2755,0,0,1,1,0.0%,30m
25183,1,[Prox]Óptimus,2755,0,0,1,1,0.0%,48m
25183,1,NOnowww,2755,0,0,3,3,0.0%,20m
25210,1,DMark,2754,1688,128,103,231,55.4%,41m
25210,1,[PAPIS]HolyThunder,2754,1418,89,104,193,46.1%,12m
25210,3,BlackOni,2754,1246,53,44,97,54.6%,9m
25210,3,Kaurus,2754,1092,52,51,103,50.5%,3m
25210,1,Billy,2754,971,48,40,88,54.5%,59m
25210,3,[TROPBG]arlam,2754,875,38,34,72,52.8%,17m
25210,1,[ELPHNT]Viceroy,2754,392,14,12,26,53.8%,20m
25210,1,[OPANA]RoarOfProxy,2754,361,12,5,17,70.6%,4m
25210,1,XXLnoob,2754,202,11,12,23,47.8%,24m
25210,1,[POPIK]popik,2754,370,10,6,16,62.5%,1h
25210,1,Dauan,2754,231,8,7,15,53.3%,1h
25210,2,Valenth,2754,188,6,17,23,26.1%,7m
25210,3,JenniferRush,2754,135,5,2,7,71.4%,13m
25210,1,[IRLA]TheFinalBoss,2754,118,4,1,5,80.0%,30m
25210,3,DUHA,2754,124,4,10,14,28.6%,4m
25210,2,[VaoR]VanDerVouts,2754,0,3,3,6,50.0%,40m
25210,3,NainMaboule,2754,135,3,3,6,50.0%,4m
25210,3,DiletantBuch,2754,120,3,4,7,42.9%,5m
25210,1,GuStello,2754,38,2,1,3,66.7%,42m
25210,3,TrueSilver,2754,120,2,4,6,33.3%,15m
25210,1,[GBoys]Mars,2754,0,1,0,1,100.0%,9m
25210,1,Asmodei,2754,0,1,0,1,100.0%,1h
25210,1,[ZATON]Alucardo,2754,40,1,2,3,33.3%,2m
25210,1,Strong,2754,0,0,1,1,0.0%,5m
25210,1,szomonos,2754,0,0,1,1,0.0%,6m
25210,1,mybidisbig,2754,0,0,3,3,0.0%,59m
25236,2,Copiman,2753,1491,201,203,404,49.8%,27m
25236,3,tumbak,2753,1374,92,76,168,54.8%,14m
25236,1,Heidö,2753,1599,79,74,153,51.6%,5m
25236,3,[AciNoN]ImmUnd,2753,1202,59,51,110,53.6%,2m
25236,3,[SoLu]JONS,2753,1312,53,53,106,50.0%,3m
25236,3,korgoth,2753,537,33,26,59,55.9%,5m
25236,2,Latinalover,2753,698,29,30,59,49.2%,12m
25236,1,SaXaRok,2753,863,27,23,50,54.0%,27m
25236,3,Evergen,2753,620,24,26,50,48.0%,18m
25236,3,manbra,2753,466,19,15,34,55.9%,15m
25236,3,Jules,2753,442,18,15,33,54.5%,13m
25236,2,nova,2753,278,14,10,24,58.3%,50m
25236,1,[GGL1]Kruzenger,2753,282,11,1,12,91.7%,49m
25236,2,RLZ,2753,0,4,2,6,66.7%,1h
25236,1,mcclane,2753,120,3,4,7,42.9%,38m
25236,3,[CNC3]ifurr,2753,86,3,7,10,30.0%,5m
25236,1,Chodziu,2753,0,1,0,1,100.0%,44m
25236,3,DRZaT,2753,30,1,5,6,16.7%,7m
25236,2,Vinicius,2753,0,1,5,6,16.7%,5m
25236,2,UnlayerSoul,2753,0,0,1,1,0.0%,20m
25256,3,[страх]JackOfShadow,2752,1594,129,121,250,51.6%,14m
25256,2,Lysy,2752,676,27,25,52,51.9%,2m
25256,3,Scuba,2752,559,26,32,58,44.8%,6m
25256,1,Genius,2752,600,25,13,38,65.8%,34m
25256,1,SavinkOff,2752,548,23,10,33,69.7%,44m
25256,1,Kryforce,2752,413,17,9,26,65.4%,1h
25256,1,Dadue,2752,392,14,13,27,51.9%,43m
25256,3,IIIIIIIIIIII,2752,331,14,13,27,51.9%,4m
25256,1,Quixotical,2752,312,10,6,16,62.5%,1h
25256,3,xDubitox,2752,226,9,9,18,50.0%,4m
25256,3,[2EZ4]DooMbringer,2752,0,3,2,5,60.0%,28m
25256,2,[J3Ws]konradius,2752,95,3,4,7,42.9%,44m
25256,3,Cra,2752,62,3,5,8,37.5%,2m
25256,1,Polyester,2752,0,1,0,1,100.0%,1h
25256,1,AsTreL,2752,0,1,1,2,50.0%,48m
25256,1,Akosyh,2752,42,1,2,3,33.3%,7m
25256,1,Elfer,2752,32,1,2,3,33.3%,44m
25256,1,Brebux,2752,0,0,1,1,0.0%,38m
25256,1,[Gibs]Chrysomele,2752,0,0,3,3,0.0%,30m
25275,2,BigBadBug,2751,1436,221,210,431,51.3%,26m
25275,3,[ExTr1m]pinkers,2751,1132,52,45,97,53.6%,9m
25275,2,kavalar,2751,1181,48,45,93,51.6%,13m
25275,1,rohezal,2751,738,44,40,84,52.4%,9m
25275,2,flowthepow,2751,799,38,45,83,45.8%,9m
25275,3,Sincero,2751,669,32,33,65,49.2%,2m
25275,3,Ares,2751,511,20,16,36,55.6%,4m
25275,3,Sekz,2751,540,19,27,46,41.3%,27m
25275,1,Pong,2751,396,14,15,29,48.3%,4m
25275,3,[ORM]TiSunstrider,2751,374,13,12,25,52.0%,5m
25275,1,Demerzel,2751,208,11,13,24,45.8%,16m
25275,1,Toddy,2751,291,10,10,20,50.0%,50m
25275,2,[avil0]Adoru,2751,194,8,8,16,50.0%,27m
25275,3,Saloma,2751,170,5,7,12,41.7%,6m
25275,3,maraon,2751,118,4,9,13,30.8%,16m
25275,1,[LTIFP]hans,2751,142,4,23,27,14.8%,24m
25275,1,Marodeur,2751,88,3,3,6,50.0%,41m
25275,3,mibi,2751,0,3,3,6,50.0%,2m
25275,1,Twijet,2751,74,2,1,3,66.7%,52m
25275,3,[ABSE]Шумик,2751,0,2,3,5,40.0%,20m
25275,1,[Ypikaï]nicolqs,2751,0,1,1,2,50.0%,27m
25275,1,Ritosan,2751,0,1,1,2,50.0%,40m
25275,1,StarMaSta,2751,0,1,1,2,50.0%,52m
25275,1,CHn,2751,0,1,1,2,50.0%,50m
25275,2,aiur,2751,0,0,1,1,0.0%,5m
25275,3,TURTLE,2751,0,0,3,3,0.0%,10m
25275,3,[WАSD]Hasll,2751,0,0,4,4,0.0%,10m
25302,3,Vei,2750,1547,73,69,142,51.4%,9m
25302,3,[SngR]gargamel,2750,1328,65,53,118,55.1%,26m
25302,3,[BWArmy]Tchipe,2750,769,31,31,62,50.0%,10m
25302,1,jodead,2750,814,30,25,55,54.5%,5m
25302,1,Armando,2750,716,29,33,62,46.8%,6m
25302,1,Grasparv,2750,743,28,43,71,39.4%,9m
25302,3,[АУЕШКИ]Egor,2750,344,13,8,21,61.9%,9m
25302,3,Restrepo,2750,390,13,18,31,41.9%,25m
25302,3,FreAky,2750,252,9,13,22,40.9%,10m
25302,1,Stakerrt,2750,176,6,4,10,60.0%,1h
25302,2,Psclly,2750,140,5,2,7,71.4%,42m
25302,1,zealot,2750,0,4,1,5,80.0%,52m
25302,1,[ZERGTV]jkLivin,2750,150,4,2,6,66.7%,38m
25302,1,ZeRen,2750,108,3,2,5,60.0%,20m
25302,1,daddy,2750,40,2,1,3,66.7%,5m
25302,1,[TDraC]Abathur,2750,82,2,3,5,40.0%,31m
25302,1,Rikitan,2750,0,1,0,1,100.0%,38m
25302,3,dingo,2750,30,1,5,6,16.7%,17m
25302,3,[mtl]meteorcrash,2750,19,1,7,8,12.5%,18m
25302,1,Durzo,2750,0,0,1,1,0.0%,1h
25322,3,[QCZ]Hawrix,2749,1159,154,148,302,51.0%,15m
25322,3,tiptop,2749,1565,116,109,225,51.6%,4m
25322,3,Centurion,2749,811,73,71,144,50.7%,26m
25322,1,JeanGens,2749,1263,60,45,105,57.1%,22m
25322,1,pirmin,2749,1329,50,47,97,51.5%,31m
25322,2,ILoveJuice,2749,643,27,28,55,49.1%,24m
25322,3,Otzelot,2749,494,16,20,36,44.4%,2m
25322,1,KaptajnGrue,2749,281,10,9,19,52.6%,20m
25322,1,JinZo,2749,142,9,9,18,50.0%,9m
25322,3,Zeratul,2749,251,8,7,15,53.3%,10m
25322,3,sanna,2749,58,6,4,10,60.0%,4m
25322,3,Totty,2749,156,5,12,17,29.4%,25m
25322,1,NekoMan,2749,120,3,4,7,42.9%,59m
25322,3,NAZGUL,2749,32,1,1,2,50.0%,9m
25322,1,DarkLuBu,2749,0,1,2,3,33.3%,3m
25322,1,Qwaratox,2749,0,1,2,3,33.3%,5m
25322,1,ZLou,2749,38,1,2,3,33.3%,41m
25322,1,karsklag,2749,0,0,1,1,0.0%,34m
25322,1,BeardyMcGee,2749,0,0,1,1,0.0%,22m
25341,3,[OLM]Arganir,2748,992,132,126,258,51.2%,6m
25341,1,ESGARD,2748,1696,73,59,132,55.3%,1h
25341,1,wampir,2748,672,26,16,42,61.9%,8m
25341,1,Angel,2748,432,15,15,30,50.0%,41m
25341,1,WooMan,2748,464,14,13,27,51.9%,59m
25341,1,vanillah,2748,346,13,11,24,54.2%,43m
25341,3,[SISKE]PULESOSKE,2748,300,12,12,24,50.0%,5m
25341,1,Lammas,2748,294,9,12,21,42.9%,5m
25341,1,trueneu,2748,228,6,7,13,46.2%,33m
25341,3,[FMGrus]Ruslan,2748,152,6,11,17,35.3%,9m
25341,1,shade,2748,73,5,4,9,55.6%,50m
25341,1,Douldoul,2748,126,4,2,6,66.7%,31m
25341,3,[4TwenT]Inraged,2748,93,4,3,7,57.1%,17m
25341,3,Reinci,2748,124,4,11,15,26.7%,17m
25341,3,RealBigFish,2748,60,3,8,11,27.3%,10m
25341,2,kollis,2748,135,2,1,3,66.7%,1h
25341,1,[Tales]MegaClaw,2748,0,2,3,5,40.0%,44m
25341,2,VidHartt,2748,0,2,6,8,25.0%,9m
25341,3,Wrongester,2748,58,2,8,10,20.0%,18m
25341,3,[Mordu]Hirawin,2748,0,1,0,1,100.0%,41m
25341,2,Alunis,2748,0,1,0,1,100.0%,31m
25341,3,Din,2748,0,1,0,1,100.0%,40m
25341,1,tecstar,2748,105,1,2,3,33.3%,1h
25341,1,[isIMBА]Цемчик,2748,40,1,2,3,33.3%,49m
25341,1,[Cancro]Schipper,2748,0,1,4,5,20.0%,33m
25341,1,[YMCAP]ViRUSAlexx,2748,0,0,1,1,0.0%,37m
25367,3,Cry,2747,1530,259,238,497,52.1%,4m
25367,2,Halakost,2747,1530,153,151,304,50.3%,26m
25367,1,Zork,2747,1755,99,95,194,51.0%,46m
25367,1,IIFRIIzeuxs,2747,1588,54,69,123,43.9%,17m
25367,3,SkeefZ,2747,758,50,33,83,60.2%,7m
25367,3,Jacob,2747,965,41,36,77,53.2%,25m
25367,1,SwasoW,2747,936,32,29,61,52.5%,41m
25367,2,[FMJ]Styliann,2747,759,29,37,66,43.9%,15m
25367,1,Jasper,2747,651,26,15,41,63.4%,30m
25367,3,IIIIIIIIIIII,2747,449,21,13,34,61.8%,15m
25367,1,SimilarBoy,2747,442,17,18,35,48.6%,11m
25367,1,veretskii,2747,428,15,10,25,60.0%,9m
25367,1,[InFgo]superzerg,2747,406,13,14,27,48.1%,1h
25367,2,Argallion,2747,204,8,11,19,42.1%,1h
25367,2,[xBBCx]LonelyDroner,2747,159,6,4,10,60.0%,2m
25367,2,Gits,2747,94,5,6,11,45.5%,5m
25367,3,Romchec,2747,187,5,8,13,38.5%,2m
25367,2,ArtZer,2747,141,4,5,9,44.4%,1h
25367,1,Mendelfist,2747,38,3,4,7,42.9%,2m
25367,3,Aizen,2747,60,3,5,8,37.5%,4m
25367,1,RussianWolf,2747,48,2,1,3,66.7%,9m
25367,3,Vallar,2747,0,0,4,4,0.0%,18m
25389,1,[NLTN]StoneColdIKE,2746,1662,148,140,288,51.4%,49m
25389,3,Peeeer,2746,1589,124,120,244,50.8%,2m
25389,1,Romulus,2746,890,30,24,54,55.6%,32m
25389,3,Imjim,2746,621,24,21,45,53.3%,17m
25389,1,ActiveDK,2746,425,17,11,28,60.7%,9m
25389,3,NeverRush,2746,303,16,17,33,48.5%,4m
25389,3,FIL,2746,181,14,13,27,51.9%,11m
25389,3,NoDiplomacy,2746,338,11,19,30,36.7%,12m
25389,2,Fredrik,2746,312,10,16,26,38.5%,16m
25389,1,xJuggalettex,2746,206,9,5,14,64.3%,41m
25389,1,Govno,2746,203,5,2,7,71.4%,1h
25389,2,mindCrtl,2746,184,5,6,11,45.5%,2m
25389,2,James,2746,121,5,7,12,41.7%,21m
25389,1,Hemfast,2746,0,4,1,5,80.0%,43m
25389,2,MrDeityZenit,2746,159,4,2,6,66.7%,2m
25389,2,[MINAI]boris,2746,96,4,3,7,57.1%,49m
25389,1,[R3ject]Doom,2746,116,4,3,7,57.1%,1h
25389,1,[HCI]nasH,2746,88,3,3,6,50.0%,27m
25389,1,Excel,2746,112,3,3,6,50.0%,1h
25389,3,Vershok,2746,146,3,6,9,33.3%,17m
25389,1,starblaze,2746,38,2,1,3,66.7%,8m
25389,1,zzDONzz,2746,0,1,0,1,100.0%,5m
25389,2,Sorry,2746,0,1,3,4,25.0%,42m
25389,1,Nevok,2746,0,0,1,1,0.0%,57m
25389,1,ДедТукТук,2746,0,0,1,1,0.0%,1h
25389,2,MSGHIsberg,2746,0,0,4,4,0.0%,1h
25389,1,CutieBST,2746,0,0,5,5,0.0%,5m
25416,3,stasHeaven,2745,629,149,163,312,47.8%,10m
25416,3,[Daos]DaosStyX,2745,1635,124,110,234,53.0%,8m
25416,1,LonelyDonut,2745,1093,41,32,73,56.2%,32m
25416,2,Shin,2745,506,19,18,37,51.4%,24m
25416,1,[xFRSx]kartofel,2745,576,18,16,34,52.9%,54m
25416,3,BarathBathum,2745,343,14,15,29,48.3%,5m
25416,1,Sleck,2745,434,13,12,25,52.0%,34m
25416,3,[TlGd]SirConçis,2745,388,13,15,28,46.4%,10m
25416,1,Hellbringer,2745,232,12,13,25,48.0%,25m
25416,2,[Etna]Vulturne,2745,336,11,24,35,31.4%,17m
25416,1,Mior,2745,347,10,9,19,52.6%,33m
25416,2,Mirceatop,2745,300,9,16,25,36.0%,12m
25416,1,anfänger,2745,214,7,5,12,58.3%,54m
25416,3,FireStarter,2745,176,7,13,20,35.0%,11m
25416,3,[TdFd]margorior,2745,174,6,10,16,37.5%,6m
25416,1,[6I9]silver,2745,145,5,6,11,45.5%,36m
25416,3,[Тир]Снэкри,2745,146,5,12,17,29.4%,10m
25416,1,DedFura,2745,80,3,1,4,75.0%,49m
25416,1,ZORSTEP,2745,145,3,3,6,50.0%,8m
25416,3,Phoenix,2745,0,3,3,6,50.0%,2m
25416,2,[PiBi]Fangri,2745,0,3,4,7,42.9%,42m
25416,1,skyclasher,2745,0,3,4,7,42.9%,55m
25416,1,hLeBuShEk,2745,124,3,5,8,37.5%,1h
25416,1,[NLTN]emib,2745,40,2,1,3,66.7%,2m
25416,3,Geten,2745,0,2,3,5,40.0%,55m
25416,1,Mathrogwar,2745,0,2,3,5,40.0%,22m
25416,3,[CNDs]CoNd,2745,30,2,5,7,28.6%,4m
25416,3,Disea,2745,58,2,7,9,22.2%,2m
25416,1,Fynn,2745,40,1,1,2,50.0%,1h
25416,3,Tumour,2745,61,1,4,5,20.0%,11m
25416,3,nile,2745,0,1,5,6,16.7%,4m
25416,1,HandyR,2745,0,0,1,1,0.0%,41m
25448,1,WiseFace,2744,1443,191,194,385,49.6%,26m
25448,1,[HELCOR]Oburec,2744,1380,136,145,281,48.4%,17m
25448,1,BrainBug,2744,1500,87,71,158,55.1%,39m
25448,3,zeliboba,2744,1561,74,69,143,51.7%,2m
25448,2,madsjl,2744,910,55,56,111,49.5%,3m
25448,1,cosh,2744,785,49,43,92,53.3%,9m
25448,3,Graeme,2744,975,42,46,88,47.7%,6m
25448,1,Kahe,2744,766,31,37,68,45.6%,12m
25448,1,reckoner,2744,474,16,15,31,51.6%,8m
25448,3,Belshazzar,2744,402,16,21,37,43.2%,27m
25448,1,Bob,2744,329,14,8,22,63.6%,1h
25448,1,Smiles,2744,285,10,2,12,83.3%,42m
25448,1,[12IQ]Floryster,2744,178,4,1,5,80.0%,33m
25448,1,Glynnball,2744,62,3,1,4,75.0%,2m
25448,2,MlekonCz,2744,0,3,3,6,50.0%,58m
25448,1,СвятоСаша,2744,127,2,3,5,40.0%,18m
25448,1,RpgFiftyNine,2744,0,1,0,1,100.0%,22m
25448,1,PuMBa,2744,0,1,0,1,100.0%,33m
25448,2,HuKKo,2744,0,1,1,2,50.0%,29m
25448,1,Usul,2744,40,1,2,3,33.3%,42m
25448,1,DAn,2744,0,0,1,1,0.0%,44m
25469,3,Ephedrin,2743,644,140,114,254,55.1%,5m
25469,3,[ØstGnG]Jacopod,2743,1339,109,112,221,49.3%,25m
25469,2,kenhepen,2743,898,35,30,65,53.8%,14m
25469,1,rambo,2743,838,27,26,53,50.9%,54m
25469,1,EgoriuZ,2743,526,15,16,31,48.4%,34m
25469,3,[LCT]PeyO,2743,424,14,22,36,38.9%,18m
25469,1,Mercyflush,2743,272,10,7,17,58.8%,44m
25469,3,Whatever,2743,276,9,9,18,50.0%,18m
25469,3,Fyndhrael,2743,288,9,18,27,33.3%,9m
25469,1,[BLO0DY]MARS,2743,239,8,7,15,53.3%,24m
25469,1,Manner,2743,169,7,5,12,58.3%,50m
25469,1,liluk,2743,215,6,3,9,66.7%,2m
25469,2,[ECFeV]Blechfaust,2743,158,5,10,15,33.3%,18m
25469,2,VVVPrime,2743,119,4,4,8,50.0%,49m
25469,1,[LMNTAL]Vibe,2743,209,4,7,11,36.4%,24m
25469,1,[TwoS]Klein,2743,88,3,3,6,50.0%,52m
25469,1,BlinkOff,2743,40,3,4,7,42.9%,32m
25469,1,[OUBL]Xenophon,2743,0,1,0,1,100.0%,27m
25469,1,Ebbon,2743,0,1,1,2,50.0%,44m
25469,1,FWhite,2743,42,1,1,2,50.0%,26m
25469,1,Stormbreaker,2743,0,0,1,1,0.0%,5m
25469,1,buffedCookie,2743,0,0,3,3,0.0%,52m
25469,1,MainTrululus,2743,0,0,3,3,0.0%,31m
25492,3,fatpat,2742,1576,181,174,355,51.0%,5m
25492,3,Hurbat,2742,1405,67,62,129,51.9%,12m
25492,1,Frozen,2742,656,26,26,52,50.0%,8m
25492,3,[696]MishRqt,2742,714,26,29,55,47.3%,18m
25492,3,[BloTi]martin,2742,490,22,17,39,56.4%,15m
25492,3,RumosGrief,2742,582,21,30,51,41.2%,13m
25492,2,[ĦĦ]Kippe,2742,462,17,23,40,42.5%,10m
25492,2,Hello,2742,299,13,11,24,54.2%,2m
25492,1,Energizer,2742,238,8,7,15,53.3%,1h
25492,3,Gasan,2742,212,8,10,18,44.4%,11m
25492,1,doompoo,2742,162,4,0,4,100.0%,47m
25492,1,NUkrainia,2742,112,4,2,6,66.7%,38m
25492,3,Folk,2742,95,4,3,7,57.1%,10m
25492,1,[fFlags]zrn,2742,105,4,4,8,50.0%,2m
25492,2,llllllllllll,2742,46,4,5,9,44.4%,3m
25492,1,REDDAK,2742,119,3,0,3,100.0%,1h
25492,1,HankiePanky,2742,40,2,0,2,100.0%,46m
25492,1,Gogen,2742,44,2,0,2,100.0%,1h
25492,3,crzack,2742,0,2,3,5,40.0%,45m
25492,3,FaZeLukario,2742,0,2,3,5,40.0%,56m
25492,2,Bomber,2742,0,1,0,1,100.0%,59m
25492,1,[Маньяк]severugaYTUB,2742,0,1,0,1,100.0%,1h
25492,1,Jannick,2742,0,1,2,3,33.3%,1h
25492,3,[BloTi]PräsChulz,2742,30,1,5,6,16.7%,4m
25492,2,Barth,2742,0,0,1,1,0.0%,59m
25492,1,[DFgsA]FKrisz,2742,0,0,3,3,0.0%,1h
25518,3,Dresirus,2741,1616,68,63,131,51.9%,12m
25518,1,DukeOfFancy,2741,1730,63,62,125,50.4%,52m
25518,2,coffee,2741,1125,44,45,89,49.4%,11m
25518,3,Ray,2741,490,19,16,35,54.3%,10m
25518,3,HarrisonFord,2741,282,13,10,23,56.5%,58m
25518,1,seventyThree,2741,377,12,6,18,66.7%,19m
25518,2,Ikarus,2741,299,12,10,22,54.5%,34m
25518,3,[WAEH]reign,2741,204,7,3,10,70.0%,28m
25518,1,SloHabe,2741,76,3,0,3,100.0%,52m
25518,1,ArchI,2741,140,3,2,5,60.0%,1h
25518,2,SlaYzZ,2741,0,3,4,7,42.9%,56m
25518,1,raggsocken,2741,118,3,5,8,37.5%,59m
25518,1,BulletXSpark,2741,80,2,5,7,28.6%,26m
25518,1,TTSkull,2741,34,1,1,2,50.0%,1h
25518,1,RawPizza,2741,36,1,1,2,50.0%,58m
25518,1,[ĦĦ]Prometheus,2741,0,0,1,1,0.0%,41m
25518,2,Paranoia,2741,0,0,2,2,0.0%,56m
25518,1,Railed,2741,0,0,2,2,0.0%,6m
25518,3,Wardop,2741,0,0,4,4,0.0%,43m
25537,3,LbSouthwell,2740,1524,175,157,332,52.7%,4m
25537,3,Drakers,2740,723,78,59,137,56.9%,11m
25537,1,Ozkurt,2740,1244,70,42,112,62.5%,1h
25537,1,Ghosty,2740,1331,62,36,98,63.3%,32m
25537,1,Unbinilium,2740,386,13,9,22,59.1%,54m
25537,1,Imbanessy,2740,311,13,10,23,56.5%,58m
25537,3,[liFO]Deftar,2740,328,12,11,23,52.2%,16m
25537,1,denrus,2740,322,11,3,14,78.6%,41m
25537,1,Icy,2740,291,10,14,24,41.7%,27m
25537,1,OrionRUS,2740,304,8,10,18,44.4%,44m
25537,1,Paweł,2740,191,7,7,14,50.0%,31m
25537,1,iksdede,2740,267,7,9,16,43.8%,4m
25537,1,Dimst,2740,165,6,6,12,50.0%,1h
25537,2,[DTEK]Evranus,2740,180,6,11,17,35.3%,9m
25537,3,adas,2740,0,4,2,6,66.7%,14m
25537,1,GranatMasken,2740,78,3,0,3,100.0%,34m
25537,1,DukeSilver,2740,89,3,3,6,50.0%,44m
25537,2,thWaynE,2740,0,2,1,3,66.7%,47m
25537,2,soc,2740,114,2,1,3,66.7%,5m
25537,1,Fabio,2740,0,1,0,1,100.0%,58m
25537,1,DoNiL,2740,0,1,0,1,100.0%,20m
25537,1,StarLord,2740,0,1,1,2,50.0%,34m
25537,1,Robizmus,2740,0,0,1,1,0.0%,44m
25537,2,[ICHI]KramBamBuli,2740,0,0,2,2,0.0%,29m
25561,2,Batlakruta,2739,969,84,92,176,47.7%,14m
25561,2,SVS,2739,782,66,63,129,51.2%,26m
25561,3,Skreet,2739,1287,64,47,111,57.7%,15m
25561,1,Leyhu,2739,418,19,17,36,52.8%,1h
25561,1,eRUha,2739,427,17,22,39,43.6%,13m
25561,3,[snowBY]ChmokPypsik,2739,335,13,2,15,86.7%,21m
25561,3,ultrastan,2739,134,10,14,24,41.7%,24m
25561,2,Epsilonis,2739,220,8,16,24,33.3%,5m
25561,2,RaZooM,2739,177,7,10,17,41.2%,58m
25561,1,Reoflex,2739,97,6,3,9,66.7%,59m
25561,1,Naughty,2739,156,6,6,12,50.0%,2m
25561,2,Lasalad,2739,184,6,14,20,30.0%,26m
25561,2,ThomE,2739,58,5,6,11,45.5%,18m
25561,1,SovA,2739,158,4,0,4,100.0%,34m
25561,1,[Amyn]Smokkkkker,2739,0,4,1,5,80.0%,2m
25561,1,VLADiK,2739,148,4,4,8,50.0%,33m
25561,1,Xzale,2739,134,4,6,10,40.0%,52m
25561,1,DingleBerri,2739,0,3,4,7,42.9%,46m
25561,3,NuWanDa,2739,0,2,3,5,40.0%,1h
25561,1,RizeN,2739,143,2,4,6,33.3%,50m
25561,2,Bukvátor,2739,0,2,5,7,28.6%,3m
25561,2,sagon,2739,0,0,1,1,0.0%,26m
25561,1,Nikitka,2739,0,0,1,1,0.0%,1h
25584,3,ILLaizer,2738,918,45,42,87,51.7%,25m
25584,3,[LDS]BBRodrigus,2738,1039,44,40,84,52.4%,4m
25584,3,[LSsc2]nkrs,2738,411,18,16,34,52.9%,3m
25584,1,DECADE,2738,245,7,3,10,70.0%,58m
25584,3,xBosna,2738,181,7,7,14,50.0%,10m
25584,1,Weresk,2738,146,4,6,10,40.0%,38m
25584,2,Ilich,2738,46,3,5,8,37.5%,1h
25584,1,Demien,2738,78,2,1,3,66.7%,52m
25584,1,Feanor,2738,0,2,3,5,40.0%,52m
25584,1,WhiteNegro,2738,80,2,3,5,40.0%,38m
25584,1,Juggernaut,2738,40,1,2,3,33.3%,49m
25584,3,Romantiks,2738,95,1,5,6,16.7%,12m
25584,2,dothon,2738,0,0,9,9,0.0%,25m
25597,2,STarVation,2737,1061,126,128,254,49.6%,14m
25597,3,Systez,2737,624,62,49,111,55.9%,10m
25597,3,Starpav,2737,632,33,29,62,53.2%,16m
25597,3,[DR187]Corrupt,2737,663,28,21,49,57.1%,8m
25597,3,Cronosphere,2737,750,26,34,60,43.3%,18m
25597,3,Drakdödaren,2737,496,20,21,41,48.8%,9m
25597,3,huylkabum,2737,447,17,15,32,53.1%,8m
25597,1,darMar,2737,337,16,14,30,53.3%,23m
25597,2,Arryan,2737,296,14,13,27,51.9%,9m
25597,1,Wasiu,2737,359,13,6,19,68.4%,57m
25597,3,ForeverNoob,2737,233,11,18,29,37.9%,3m
25597,1,[ZERG7V]Diontep,2737,284,10,4,14,71.4%,35m
25597,1,[KONY]Tablefloor,2737,321,9,10,19,47.4%,41m
25597,2,AcRope,2737,173,7,8,15,46.7%,13m
25597,2,[HPG]Sealo,2737,228,6,5,11,54.5%,8m
25597,1,Maxwell,2737,145,6,5,11,54.5%,19m
25597,1,Blackness,2737,237,5,4,9,55.6%,59m
25597,1,OGkush,2737,144,4,21,25,16.0%,8m
25597,1,Oxen,2737,0,2,3,5,40.0%,32m
25597,3,Mitchellson,2737,30,2,8,10,20.0%,8m
25597,3,TheHerbalist,2737,23,2,8,10,20.0%,27m
25597,1,Alshain,2737,28,1,2,3,33.3%,30m
25597,1,Taïb,2737,0,0,1,1,0.0%,32m
25620,2,[RBP3]Tyrbok,2736,1484,322,321,643,50.1%,12m
25620,3,mastermorgan,2736,1565,130,116,246,52.8%,3m
25620,3,fazes,2736,650,89,80,169,52.7%,16m
25620,3,Mgsvtts,2736,707,60,40,100,60.0%,3m
25620,1,tnt,2736,800,39,17,56,69.6%,19m
25620,3,[Freya]have,2736,814,37,26,63,58.7%,5m
25620,1,серега,2736,363,29,21,50,58.0%,23m
25620,1,[Trasch]SorryBud,2736,701,25,19,44,56.8%,54m
25620,2,untzuntz,2736,642,25,26,51,49.0%,18m
25620,1,PeL,2736,362,23,13,36,63.9%,40m
25620,1,Velnyke,2736,411,18,11,29,62.1%,1h
25620,2,piramida,2736,488,17,25,42,40.5%,5m
25620,1,Bayzket,2736,344,15,14,29,51.7%,44m
25620,3,CrackMe,2736,311,13,14,27,48.1%,14m
25620,1,[KeyJo]XamDm,2736,358,11,6,17,64.7%,54m
25620,1,Kokant,2736,188,8,11,19,42.1%,13m
25620,1,Venom,2736,168,7,4,11,63.6%,27m
25620,1,Winner,2736,162,6,3,9,66.7%,34m
25620,1,MarineBand,2736,225,6,7,13,46.2%,53m
25620,2,dreampunchB,2736,96,4,3,7,57.1%,58m
25620,3,[eXsO]AssKicker,2736,90,4,8,12,33.3%,17m
25620,1,[tVal]OctoValkyrie,2736,78,3,1,4,75.0%,26m
25620,2,Stig,2736,96,3,4,7,42.9%,58m
25620,2,micheljj,2736,95,3,4,7,42.9%,8m
25620,3,[Cysorz]Kusok,2736,97,2,3,5,40.0%,41m
25620,3,Tojin,2736,0,2,3,5,40.0%,5m
25620,1,Shurgot,2736,78,2,5,7,28.6%,33m
25620,1,Yurgen,2736,0,1,0,1,100.0%,59m
25620,1,GeeODee,2736,0,1,0,1,100.0%,50m
25620,1,[ZЕRGTV]pitip,2736,0,0,1,1,0.0%,50m
25620,1,Kiryl,2736,0,0,3,3,0.0%,26m
25651,3,DHikki,2735,1538,82,80,162,50.6%,17m
25651,3,Cuchu,2735,567,80,63,143,55.9%,16m
25651,1,trollkarl,2735,788,33,17,50,66.0%,41m
25651,1,CIRO,2735,552,25,15,40,62.5%,52m
25651,1,Ultra,2735,431,16,9,25,64.0%,27m
25651,1,Deniz,2735,384,12,10,22,54.5%,34m
25651,2,Leszu,2735,364,12,22,34,35.3%,12m
25651,3,[Batia]papirusk,2735,324,11,6,17,64.7%,19m
25651,2,HellBoy,2735,306,10,21,31,32.3%,10m
25651,1,[IODIS]Madi,2735,245,9,1,10,90.0%,52m
25651,1,[InfNgh]Dark,2735,188,5,5,10,50.0%,49m
25651,2,Pochtalon,2735,182,5,6,11,45.5%,24m
25651,3,[SaltyB]ptaszor,2735,121,5,7,12,41.7%,20m
25651,3,Pasanosic,2735,86,4,6,10,40.0%,12m
25651,1,BFGX,2735,0,1,0,1,100.0%,1h
25651,1,[F3cK]Fatboi,2735,0,0,1,1,0.0%,52m
25651,1,Godbrazer,2735,0,0,1,1,0.0%,1h
25651,3,[eWRS]OwlJoker,2735,0,0,7,7,0.0%,11m
25669,3,ptrkZOnaZ,2734,1546,204,208,412,49.5%,26m
25669,3,HitoSaigo,2734,1056,149,121,270,55.2%,10m
25669,2,[ЕКБ]Sam,2734,1443,112,116,228,49.1%,24m
25669,3,Denvej,2734,864,95,78,173,54.9%,9m
25669,1,[EUww1]LABADIENA,2734,1242,42,43,85,49.4%,60m
25669,1,UnseenShadow,2734,618,20,18,38,52.6%,34m
25669,3,Elba,2734,391,19,9,28,67.9%,16m
25669,1,[Аtomic]Данька,2734,245,17,10,27,63.0%,31m
25669,3,Sadjared,2734,300,11,9,20,55.0%,26m
25669,1,[UCL]prime,2734,308,11,10,21,52.4%,6m
25669,3,Dieter,2734,326,11,15,26,42.3%,14m
25669,1,Autophagy,2734,259,10,2,12,83.3%,1h
25669,1,PizzaCore,2734,286,8,10,18,44.4%,35m
25669,1,puck,2734,162,7,7,14,50.0%,1h
25669,1,Matrix,2734,110,6,5,11,54.5%,32m
25669,1,Lamko,2734,265,6,11,17,35.3%,52m
25669,1,antizack,2734,198,5,6,11,45.5%,49m
25669,3,Snaidy,2734,146,5,10,15,33.3%,25m
25669,3,[StRa]Edkinson,2734,0,3,4,7,42.9%,2m
25669,1,OsiemTrzy,2734,0,2,3,5,40.0%,59m
25669,1,KILLER,2734,0,1,0,1,100.0%,58m
25669,1,CorpseVI,2734,0,1,0,1,100.0%,46m
25669,1,Currywurst,2734,0,0,1,1,0.0%,52m
25669,1,[TDOJO]SHIIINOBIII,2734,0,0,1,1,0.0%,9m
25693,3,StefanN,2733,1049,61,69,130,46.9%,12m
25693,1,DanTDM,2733,934,31,31,62,50.0%,5m
25693,1,CapitanVaims,2733,715,26,19,45,57.8%,1h
25693,3,[DGHau5]XskyPigz,2733,599,24,21,45,53.3%,14m
25693,1,InOutLake,2733,530,21,20,41,51.2%,26m
25693,3,[FloRnC]armi,2733,586,21,22,43,48.8%,4m
25693,1,AreUserious,2733,218,10,19,29,34.5%,4m
25693,3,[0BO]Leo,2733,241,9,11,20,45.0%,10m
25693,1,Jere,2733,48,6,5,11,54.5%,24m
25693,3,vic,2733,160,6,6,12,50.0%,9m
25693,1,Bunzirombolo,2733,212,6,7,13,46.2%,33m
25693,1,JumboTron,2733,199,6,8,14,42.9%,34m
25693,1,Hede,2733,192,6,11,17,35.3%,49m
25693,1,Plestin,2733,140,5,2,7,71.4%,49m
25693,1,[yayo]zhorikluv,2733,158,5,5,10,50.0%,58m
25693,3,[MAKinG]Swift,2733,160,5,7,12,41.7%,25m
25693,1,[LOWAPM]Pilatus,2733,78,3,1,4,75.0%,47m
25693,2,fafa,2733,48,3,5,8,37.5%,32m
25693,2,[ExTr1m]ERRORЗOЗ,2733,93,2,0,2,100.0%,58m
25693,3,EooN,2733,0,2,3,5,40.0%,3m
25693,2,чебурек,2733,0,2,4,6,33.3%,55m
25693,1,Minzi,2733,0,1,0,1,100.0%,1h
25693,1,kiryas,2733,0,1,1,2,50.0%,9m
25716,1,JDDDDDD,2732,1519,67,55,122,54.9%,44m
25716,1,smile,2732,1711,66,64,130,50.8%,52m
25716,1,[Sarmat]MatiKlok,2732,862,40,16,56,71.4%,49m
25716,3,[HKH]Perséphone,2732,744,28,31,59,47.5%,10m
25716,2,[НОД17]Eagle,2732,652,26,28,54,48.1%,15m
25716,1,AurskogMafia,2732,502,23,10,33,69.7%,52m
25716,1,ZigZag,2732,271,7,4,11,63.6%,49m
25716,3,ElRey,2732,150,6,9,15,40.0%,8m
25716,3,[pushik]Svecha,2732,0,3,2,5,60.0%,56m
25716,1,ATOMFox,2732,97,3,3,6,50.0%,1h
25716,2,Levty,2732,0,0,1,1,0.0%,1h
25716,2,[Moobs]Jackinatorz,2732,0,0,1,1,0.0%,56m
25716,1,[Oarsch]Flasher,2732,0,0,1,1,0.0%,44m
25716,1,[696]sandy,2732,0,0,3,3,0.0%,2m
25730,2,EighthMage,2731,1573,96,102,198,48.5%,5m
25730,1,Pony,2731,776,79,59,138,57.2%,1h
25730,2,Ooniki,2731,842,60,71,131,45.8%,13m
25730,3,depe,2731,648,47,43,90,52.2%,9m
25730,3,MrZERG,2731,986,35,43,78,44.9%,8m
25730,1,Veiovis,2731,930,30,29,59,50.8%,1h
25730,1,ArquiRaVeN,2731,597,23,17,40,57.5%,32m
25730,1,Mephiste,2731,649,22,21,43,51.2%,4m
25730,3,swin,2731,260,9,6,15,60.0%,43m
25730,1,Orwell,2731,331,9,17,26,34.6%,33m
25730,3,divo,2731,242,8,7,15,53.3%,4m
25730,1,Swan,2731,224,7,6,13,53.8%,2m
25730,3,Meow,2731,214,7,14,21,33.3%,11m
25730,1,shuriki,2731,224,6,8,14,42.9%,56m
25730,1,Alibande,2731,169,5,7,12,41.7%,31m
25730,2,Arkatein,2731,95,4,3,7,57.1%,58m
25730,3,Alienfive,2731,118,4,11,15,26.7%,12m
25730,1,Salader,2731,0,3,2,5,60.0%,41m
25730,1,Yurok,2731,116,3,3,6,50.0%,27m
25730,2,qwark,2731,0,3,4,7,42.9%,33m
25730,1,mAoO,2731,48,3,7,10,30.0%,52m
25730,2,Viy,2731,118,3,8,11,27.3%,8m
25730,1,Croesus,2731,42,2,0,2,100.0%,44m
25730,3,[M42]LAMULAGA,2731,97,2,2,4,50.0%,26m
25730,3,FrostEHot,2731,0,2,3,5,40.0%,55m
25730,2,Qoobu,2731,0,1,0,1,100.0%,40m
25730,2,Ivex,2731,94,1,1,2,50.0%,1h
25730,3,[Lo3]Pornflakes,2731,34,1,3,4,25.0%,21m
25730,1,Ermhead,2731,0,0,2,2,0.0%,41m
25730,1,safasasha,2731,0,0,2,2,0.0%,44m
25730,1,[Exprt]DarkTyranivo,2731,0,0,3,3,0.0%,6m
25730,2,Triger,2731,0,0,4,4,0.0%,20m
25730,2,Chillipepper,2731,0,0,10,10,0.0%,18m
25763,2,sould,2730,1490,179,173,352,50.9%,12m
25763,1,Jin,2730,1517,151,150,301,50.2%,25m
25763,3,mato,2730,881,57,55,112,50.9%,18m
25763,3,[BloTi]RUS,2730,1094,48,38,86,55.8%,3m
25763,1,TerramoN,2730,1112,41,33,74,55.4%,2m
25763,3,Paint,2730,658,23,31,54,42.6%,16m
25763,1,Silk,2730,496,18,13,31,58.1%,44m
25763,1,filly,2730,332,14,13,27,51.9%,50m
25763,3,chologringo,2730,302,11,13,24,45.8%,11m
25763,1,[BeerTm]Bakani,2730,262,8,8,16,50.0%,44m
25763,1,Triss,2730,184,6,2,8,75.0%,35m
25763,3,Balu,2730,124,5,11,16,31.2%,7m
25763,1,MrZergling,2730,114,3,3,6,50.0%,52m
25763,1,Insanima,2730,0,2,3,5,40.0%,1h
25763,3,PBR,2730,30,1,1,2,50.0%,1h
25763,1,sasha,2730,0,1,1,2,50.0%,46m
25763,2,iamAFK,2730,0,1,2,3,33.3%,2m
25763,1,[Dobro]Miraz,2730,40,1,2,3,33.3%,24m
25763,1,[KQ]HerrDerLinge,2730,95,1,3,4,25.0%,20m
25763,1,Fireeyes,2730,73,1,4,5,20.0%,20m
25763,3,starduster,2730,0,0,1,1,0.0%,1h
25763,1,dimbos,2730,0,0,1,1,0.0%,52m
25763,1,MEGAPASH,2730,0,0,2,2,0.0%,53m
25786,3,Serega,2729,1632,337,329,666,50.6%,2m
25786,3,russiaaa,2729,1062,139,132,271,51.3%,14m
25786,3,JGapes,2729,1155,46,48,94,48.9%,9m
25786,3,[Gremli]УшлыйОРК,2729,761,34,24,58,58.6%,18m
25786,1,zinovy,2729,583,26,13,39,66.7%,1h
25786,3,Parliament,2729,281,12,10,22,54.5%,9m
25786,3,Haman,2729,122,7,10,17,41.2%,49m
25786,2,[ZnCeR]AstroLux,2729,95,5,9,14,35.7%,26m
25786,3,оцелот,2729,0,4,1,5,80.0%,1h
25786,2,barkley,2729,113,4,5,9,44.4%,9m
25786,1,Chris,2729,123,3,1,4,75.0%,1h
25786,3,IIIIIIII,2729,137,3,2,5,60.0%,21m
25786,1,Lac,2729,88,3,3,6,50.0%,49m
25786,3,FazeManta,2729,30,3,5,8,37.5%,4m
25786,1,Azathoth,2729,82,3,5,8,37.5%,44m
25786,1,[AiRǂ]AirBass,2729,48,2,0,2,100.0%,49m
25786,1,IlIlIlIllIIl,2729,40,2,1,3,66.7%,30m
25786,3,неоченьигрок,2729,42,2,1,3,66.7%,54m
25786,1,[OGCC]Sanjusaurus,2729,116,2,3,5,40.0%,35m
25786,1,RoseMarine,2729,0,1,1,2,50.0%,2m
25786,2,soadi,2729,0,1,1,2,50.0%,29m
25786,3,CoCoon,2729,30,1,2,3,33.3%,51m
25786,1,Катя,2729,48,1,3,4,25.0%,32m
25786,3,Mahor,2729,0,1,3,4,25.0%,35m
25786,3,[PUTING]Ebhalisk,2729,30,1,6,7,14.3%,14m
25786,3,birambam,2729,0,0,1,1,0.0%,1h
25786,1,ZeRgJoShUa,2729,0,0,1,1,0.0%,22m
25786,1,Ramp,2729,0,0,1,1,0.0%,56m
25814,1,IMinWorking,2728,1545,108,119,227,47.6%,11m
25814,1,[Bloopz]StormBlooper,2728,1049,55,47,102,53.9%,60m
25814,1,[RRRRDT]Computer,2728,605,25,20,45,55.6%,58m
25814,1,[пепега]RSM,2728,642,19,19,38,50.0%,1h
25814,1,machetenjoe,2728,513,18,13,31,58.1%,31m
25814,1,Dizzydi,2728,499,16,18,34,47.1%,4m
25814,2,TwojStary,2728,476,16,29,45,35.6%,2m
25814,1,Alberthx,2728,484,15,13,28,53.6%,30m
25814,1,[COMMIE]TheSamMiner,2728,209,8,2,10,80.0%,1h
25814,1,Rovanion,2728,254,8,8,16,50.0%,59m
25814,1,habhunger,2728,100,5,12,17,29.4%,6m
25814,1,[LoCarb]Macroroni,2728,213,4,2,6,66.7%,38m
25814,1,[LSPs]EiGzEiZeLL,2728,118,4,4,8,50.0%,40m
25814,3,[NUGG]Xellos,2728,0,4,6,10,40.0%,20m
25814,1,[Olk]HORUS,2728,112,3,2,5,60.0%,27m
25814,3,Imiter,2728,97,3,3,6,50.0%,48m
25814,1,[LCSC]Enelos,2728,40,1,1,2,50.0%,1h
25814,1,Darkavenger,2728,0,1,3,4,25.0%,4m
25814,3,Алексей,2728,0,1,3,4,25.0%,15m
25814,3,Ironside,2728,0,0,4,4,0.0%,5m
25834,1,XuDFiT,2727,1603,129,138,267,48.3%,10m
25834,1,[Shx]Browstain,2727,1053,40,32,72,55.6%,1h
25834,3,Nihilist,2727,935,38,35,73,52.1%,10m
25834,1,[яєѕ]EsclavModern,2727,878,33,29,62,53.2%,5m
25834,3,Asmaikan,2727,764,27,34,61,44.3%,6m
25834,1,Neil,2727,446,20,16,36,55.6%,39m
25834,1,Coach,2727,375,15,12,27,55.6%,27m
25834,1,[D2L4]CptBoring,2727,331,13,10,23,56.5%,19m
25834,1,Arbok,2727,205,8,5,13,61.5%,24m
25834,1,Яхзлол,2727,239,8,8,16,50.0%,46m
25834,3,Shejkin,2727,199,8,10,18,44.4%,4m
25834,1,Muerte,2727,176,7,7,14,50.0%,22m
25834,2,switchback,2727,140,5,4,9,55.6%,44m
25834,1,Zappy,2727,96,5,7,12,41.7%,26m
25834,2,[GG4l]athos,2727,139,4,5,9,44.4%,6m
25834,1,GEDGES,2727,142,3,5,8,37.5%,34m
25834,1,Firea,2727,38,2,0,2,100.0%,31m
25851,2,ThIrDMoON,2726,1391,188,192,380,49.5%,13m
25851,3,Andryshok,2726,651,161,167,328,49.1%,25m
25851,1,gITLERkAPUT,2726,646,28,14,42,66.7%,9m
25851,3,Siegfried,2726,673,28,24,52,53.8%,12m
25851,3,Criminal,2726,380,16,11,27,59.3%,9m
25851,3,DuckSie,2726,308,15,11,26,57.7%,10m
25851,1,dorik,2726,282,13,4,17,76.5%,5m
25851,2,Zhigel,2726,338,12,11,23,52.2%,36m
25851,2,Azrael,2726,115,9,3,12,75.0%,53m
25851,1,Мародер,2726,231,7,8,15,46.7%,19m
25851,3,[TheER]UxorialRook,2726,200,7,13,20,35.0%,15m
25851,1,xanix,2726,222,6,6,12,50.0%,33m
25851,1,[WPoT]TrashMan,2726,164,5,3,8,62.5%,20m
25851,1,[J4E]Bergdoktor,2726,184,5,5,10,50.0%,20m
25851,3,Medyczek,2726,42,4,3,7,57.1%,47m
25851,1,MounA,2726,88,3,3,6,50.0%,52m
25851,3,Леонел,2726,30,2,5,7,28.6%,16m
25851,1,EvilSanta,2726,0,1,0,1,100.0%,43m
25851,1,[Ktuluu]HellPrincess,2726,36,1,1,2,50.0%,27m
25870,2,lfeDV,2725,1600,134,135,269,49.8%,4m
25870,3,pghvesser,2725,1458,113,104,217,52.1%,17m
25870,1,llllllllllll,2725,1472,108,83,191,56.5%,9m
25870,2,SirJim,2725,861,58,66,124,46.8%,16m
25870,1,[S3ise]Catalin,2725,885,42,26,68,61.8%,8m
25870,1,Xargor,2725,680,27,22,49,55.1%,2m
25870,1,becalm,2725,492,15,14,29,51.7%,52m
25870,3,[Harboe]MickeySaint,2725,391,14,15,29,48.3%,11m
25870,3,Hovado,2725,218,9,9,18,50.0%,1h
25870,3,Tireon,2725,168,7,8,15,46.7%,17m
25870,2,NYKǂVaRiaL,2725,187,6,5,11,54.5%,35m
25870,3,Shinnybeast,2725,151,5,6,11,45.5%,5m
25870,3,[IIE]sanzi,2725,137,4,5,9,44.4%,2m
25870,2,Legatus,2725,92,3,3,6,50.0%,51m
25870,3,[GrU]CapSeb,2725,92,3,8,11,27.3%,16m
25870,1,[1Pack]ElMexicano,2725,96,2,0,2,100.0%,45m
25870,1,[NTLA]Krzychu,2725,38,2,0,2,100.0%,41m
25870,1,Loa,2725,0,1,0,1,100.0%,41m
25870,2,[MINW]BuGi,2725,0,1,1,2,50.0%,50m
25870,1,Ost,2725,0,1,3,4,25.0%,49m
25870,3,Leodiffy,2725,0,0,1,1,0.0%,39m
25891,1,xConan,2724,750,156,128,284,54.9%,27m
25891,1,SamTX,2724,1673,128,120,248,51.6%,1h
25891,1,NiKoGoYo,2724,1362,68,61,129,52.7%,59m
25891,3,Checkit,2724,764,30,29,59,50.8%,15m
25891,3,Kneusje,2724,815,30,34,64,46.9%,15m
25891,3,Buerty,2724,710,28,28,56,50.0%,10m
25891,1,Yamaha,2724,556,27,14,41,65.9%,37m
25891,3,Zblonk,2724,264,12,10,22,54.5%,18m
25891,3,EnsElEyici,2724,312,12,10,22,54.5%,9m
25891,1,[МыХуи]BrokenLeg,2724,296,10,5,15,66.7%,35m
25891,1,PhiberOptik,2724,340,9,11,20,45.0%,59m
25891,3,Swarmy,2724,233,7,9,16,43.8%,7m
25891,1,[SBV]Athtors,2724,142,5,8,13,38.5%,37m
25891,1,[FNDL]Amon,2724,0,4,1,5,80.0%,59m
25891,1,RÆV,2724,36,4,2,6,66.7%,46m
25891,3,Tides,2724,97,3,3,6,50.0%,2m
25891,3,Skapidea,2724,94,3,8,11,27.3%,13m
25891,1,JlDesign,2724,42,2,0,2,100.0%,27m
25891,1,[OSgZ]EatMyShorts,2724,82,2,3,5,40.0%,59m
25891,1,[Dz1ady]Kropka,2724,0,2,3,5,40.0%,6m
25891,1,Dranton,2724,82,2,4,6,33.3%,59m
25891,3,[Serral]lefterisyolo,2724,97,1,2,3,33.3%,49m
25891,1,AlekseiTG,2724,0,0,1,1,0.0%,41m
25914,2,eisenbieger,2723,1538,371,366,737,50.3%,10m
25914,3,Agon,2723,514,136,127,263,51.7%,5m
25914,3,precisionist,2723,1321,113,106,219,51.6%,14m
25914,3,Heimer,2723,1417,81,75,156,51.9%,9m
25914,3,Guido,2723,1329,76,61,137,55.5%,18m
25914,3,[IceHus]КоролеваРоя,2723,467,55,46,101,54.5%,18m
25914,1,[GKY]ZuZ,2723,1233,52,35,87,59.8%,5m
25914,3,Jason,2723,1122,43,46,89,48.3%,5m
25914,2,Paha,2723,968,37,44,81,45.7%,13m
25914,3,[TTIS]PoppZg,2723,837,35,36,71,49.3%,26m
25914,3,Slayer,2723,932,34,41,75,45.3%,7m
25914,1,Evride,2723,726,26,22,48,54.2%,58m
25914,1,HundredKeyz,2723,726,23,25,48,47.9%,3m
25914,1,Kalmi,2723,620,22,16,38,57.9%,19m
25914,2,[NODA]MarineManne,2723,414,18,24,42,42.9%,8m
25914,1,llllllllllll,2723,305,11,4,15,73.3%,5m
25914,1,[HTAED]Eichhörnchen,2723,254,8,6,14,57.1%,23m
25914,3,solmnyr,2723,206,8,8,16,50.0%,16m
25914,1,Link,2723,220,7,5,12,58.3%,38m
25914,2,BuBu,2723,209,5,3,8,62.5%,1h
25914,2,[ACHI]Szabi,2723,88,4,5,9,44.4%,27m
25914,1,FlibberTyG,2723,78,3,1,4,75.0%,46m
25914,1,Midirov,2723,80,3,3,6,50.0%,49m
25914,2,[сVn]Zortnag,2723,0,3,4,7,42.9%,12m
25914,3,Thenorias,2723,90,2,7,9,22.2%,10m
25914,1,RomanSau,2723,0,1,1,2,50.0%,37m
25914,1,[KGIAAS]LIMITBREAK,2723,0,1,2,3,33.3%,45m
25914,3,SenshiPL,2723,0,1,2,3,33.3%,1h
25914,1,MrBotka,2723,0,1,2,3,33.3%,9m
25914,1,[DARK86]SIGMA,2723,0,0,1,1,0.0%,1h
25944,1,Royaly,2722,1388,101,91,192,52.6%,26m
25944,1,Marekano,2722,1617,76,61,137,55.5%,41m
25944,3,Sød,2722,593,43,42,85,50.6%,2m
25944,1,OmniKai,2722,741,41,28,69,59.4%,58m
25944,1,diablejaune,2722,722,28,16,44,63.6%,52m
25944,1,Blackfear,2722,776,24,26,50,48.0%,59m
25944,3,[696]PHOENIX,2722,288,14,11,25,56.0%,14m
25944,3,Baituri,2722,336,13,10,23,56.5%,7m
25944,3,ollibaer,2722,376,13,21,34,38.2%,11m
25944,3,deadlyKiss,2722,363,12,16,28,42.9%,7m
25944,1,beginnere,2722,207,9,11,20,45.0%,60m
25944,1,GeoGodley,2722,291,8,5,13,61.5%,1h
25944,1,Samynix,2722,190,7,9,16,43.8%,22m
25944,2,RouRou,2722,117,4,4,8,50.0%,50m
25944,3,[JoTe]Prime,2722,144,3,6,9,33.3%,52m
25944,1,Sarma,2722,32,2,1,3,66.7%,32m
25944,1,Mogg,2722,124,2,1,3,66.7%,52m
25944,2,Баклажан,2722,95,2,1,3,66.7%,59m
25944,1,[DaFF]MOISTLING,2722,0,1,0,1,100.0%,5m
25944,2,Laz,2722,0,1,3,4,25.0%,24m
25944,1,Gilad,2722,40,1,3,4,25.0%,38m
25944,1,[59APM]Cepera,2722,0,0,2,2,0.0%,47m
25966,3,[S3ise]wallcraft,2721,1156,45,60,105,42.9%,9m
25966,3,gosLuv,2721,1060,43,43,86,50.0%,15m
25966,3,Faust,2721,854,36,30,66,54.5%,2m
25966,1,zaphod,2721,678,27,19,46,58.7%,54m
25966,2,hankdatank,2721,684,25,29,54,46.3%,7m
25966,1,SlothTiger,2721,770,24,25,49,49.0%,1h
25966,3,[OVRBRZ]deUrsa,2721,226,19,19,38,50.0%,5m
25966,3,MagMa,2721,395,17,15,32,53.1%,9m
25966,1,xxGRAYxx,2721,297,12,4,16,75.0%,26m
25966,1,[PLA2N]ProtoseGG,2721,351,11,14,25,44.0%,27m
25966,3,Kawa,2721,341,11,21,32,34.4%,9m
25966,3,[DrkShp]HuangZhong,2721,266,10,12,22,45.5%,15m
25966,1,hefastagon,2721,192,8,6,14,57.1%,57m
25966,1,che,2721,268,7,6,13,53.8%,56m
25966,3,Inemina,2721,171,7,7,14,50.0%,2m
25966,3,leDJo,2721,62,5,5,10,50.0%,4m
25966,1,MrFox,2721,0,4,1,5,80.0%,1h
25966,1,Hothgadt,2721,141,4,3,7,57.1%,32m
25966,2,Dowudca,2721,139,4,5,9,44.4%,1h
25966,1,Swip,2721,88,3,3,6,50.0%,1h
25966,3,saintRhino,2721,30,3,8,11,27.3%,4m
25966,2,Romera,2721,97,2,0,2,100.0%,40m
25966,1,pixelkrafter,2721,34,2,1,3,66.7%,6m
25966,3,IIIIIIIIIIII,2721,94,2,2,4,50.0%,10m
25966,3,GodModON,2721,0,2,3,5,40.0%,28m
25966,3,Haazh,2721,0,2,3,5,40.0%,28m
25966,1,tratos,2721,38,2,5,7,28.6%,5m
25966,1,[fische]CaptainFisch,2721,0,1,0,1,100.0%,49m
25966,3,dmonkoff,2721,0,1,0,1,100.0%,28m
25966,1,[PlAr]akhileus,2721,0,0,1,1,0.0%,19m
25966,1,Mortek,2721,0,0,1,1,0.0%,59m
25997,2,Maximatey,2720,1324,312,301,613,50.9%,15m
25997,3,Nomisarache,2720,1605,109,97,206,52.9%,25m
25997,3,[URANGG]Kunde,2720,738,45,40,85,52.9%,17m
25997,1,Akumashiro,2720,832,27,28,55,49.1%,44m
25997,1,BlindWoozie,2720,293,11,4,15,73.3%,22m
25997,3,[sStars]Pickaface,2720,380,11,35,46,23.9%,9m
25997,3,Makula,2720,303,10,12,22,45.5%,25m
25997,2,LortGravidy,2720,280,9,16,25,36.0%,16m
25997,1,trafalgar,2720,114,7,4,11,63.6%,22m
25997,1,[IVöVI]MAXHE,2720,172,6,5,11,54.5%,1h
25997,1,Darkhides,2720,179,6,6,12,50.0%,32m
25997,1,Rozgonyator,2720,147,3,2,5,60.0%,33m
25997,1,badarty,2720,110,3,4,7,42.9%,56m
25997,1,neo,2720,38,2,0,2,100.0%,31m
25997,1,Abies,2720,97,1,4,5,20.0%,1h
25997,2,Buur,2720,0,0,1,1,0.0%,1h
25997,3,[OПГ]ArtDark,2720,0,0,1,1,0.0%,53m
25997,1,Doxa,2720,0,0,2,2,0.0%,2m
25997,1,masterhacker,2720,0,0,2,2,0.0%,1h
26016,1,PARASITE,2719,955,79,33,112,70.5%,41m
26016,1,Laxsy,2719,1434,52,51,103,50.5%,31m
26016,3,длинный,2719,870,40,25,65,61.5%,17m
26016,1,[PowOw]ZedraC,2719,622,22,17,39,56.4%,1h
26016,3,Creutzfeldt,2719,349,17,17,34,50.0%,16m
26016,1,Cos,2719,391,16,14,30,53.3%,24m
26016,1,Drovosek,2719,487,15,13,28,53.6%,54m
26016,1,NikolausDeo,2719,260,9,6,15,60.0%,44m
26016,1,[33cl]Yokinathor,2719,163,7,5,12,58.3%,46m
26016,2,Koyot,2719,205,6,2,8,75.0%,43m
26016,1,[Logic]LogicSputnik,2719,143,5,6,11,45.5%,43m
26016,3,Pepelluce,2719,120,5,12,17,29.4%,11m
26016,2,[4Nordy]Sadhomer,2719,94,4,3,7,57.1%,51m
26016,1,[Cleans]StMarc,2719,118,3,4,7,42.9%,40m
26016,1,emperor,2719,0,2,1,3,66.7%,41m
26016,1,Akío,2719,0,2,3,5,40.0%,43m
26016,3,RALF,2719,0,2,3,5,40.0%,28m
26016,1,SunnyDee,2719,0,1,0,1,100.0%,59m
26016,2,FlexOOSEMЪ,2719,48,1,3,4,25.0%,45m
26016,3,UAP,2719,0,1,5,6,16.7%,17m
26016,2,Beast,2719,0,0,2,2,0.0%,1h
26016,1,DICCTUCKERRR,2719,0,0,2,2,0.0%,37m
26038,1,Zoblar,2718,1069,137,121,258,53.1%,3m
26038,1,[SPAINs]NordKapp,2718,1685,112,101,213,52.6%,27m
26038,1,[SPEZUL]Phydra,2718,1742,89,84,173,51.4%,57m
26038,3,[JaPP]Infestorrr,2718,1213,75,68,143,52.4%,12m
26038,3,Freedom,2718,1195,70,71,141,49.6%,11m
26038,3,Nicoleon,2718,996,54,53,107,50.5%,10m
26038,3,MVA,2718,978,44,43,87,50.6%,5m
26038,1,Mike,2718,823,39,36,75,52.0%,5m
26038,1,DaftJoker,2718,691,29,15,44,65.9%,44m
26038,1,ButPlug,2718,297,13,4,17,76.5%,7m
26038,1,[FTWWP]GoShoKoNq,2718,312,9,8,17,52.9%,56m
26038,1,limfostar,2718,134,6,3,9,66.7%,30m
26038,1,[улей55]Obito,2718,190,6,4,10,60.0%,9m
26038,1,Axoolotl,2718,96,6,8,14,42.9%,1h
26038,1,Banomet,2718,152,5,3,8,62.5%,20m
26038,1,sznycel,2718,154,5,7,12,41.7%,59m
26038,1,XeliX,2718,120,4,3,7,57.1%,27m
26038,2,marsinator,2718,48,4,5,9,44.4%,59m
26038,1,aaaaaaaaaa,2718,128,3,1,4,75.0%,20m
26038,1,OneFour,2718,78,3,2,5,60.0%,1h
26038,1,[Fxnadu]Harfang,2718,82,2,3,5,40.0%,47m
26038,3,arxz,2718,0,2,4,6,33.3%,3m
26038,1,Ace,2718,0,1,2,3,33.3%,31m
26038,1,[mMcH]MeleeKeeper,2718,0,0,1,1,0.0%,27m
26062,1,Gwoop,2717,1369,84,77,161,52.2%,19m
26062,1,CrniTomislav,2717,1617,81,69,150,54.0%,2m
26062,3,MiniHusarz,2717,1157,47,49,96,49.0%,8m
26062,1,[OFocus]Alcubierre,2717,861,38,47,85,44.7%,27m
26062,3,[FMmkay]telkamp,2717,297,13,13,26,50.0%,6m
26062,3,deMirt,2717,308,10,18,28,35.7%,5m
26062,1,PongLenis,2717,274,8,9,17,47.1%,52m
26062,1,Fang,2717,258,7,10,17,41.2%,58m
26062,2,[CFD]HardiHard,2717,155,6,8,14,42.9%,9m
26062,1,Moin,2717,144,6,8,14,42.9%,20m
26062,3,EXODIUS,2717,148,6,9,15,40.0%,12m
26062,1,Malmatiko,2717,180,5,8,13,38.5%,41m
26062,1,Daddy,2717,88,3,3,6,50.0%,27m
26062,1,[Bruv]PickleRick,2717,74,2,2,4,50.0%,22m
26062,3,RobertRath,2717,0,2,3,5,40.0%,28m
26062,2,Bodex,2717,0,2,3,5,40.0%,50m
26062,3,Malde,2717,0,1,0,1,100.0%,6m
26062,1,astrobeglec,2717,40,1,1,2,50.0%,57m
26062,1,neferfabi,2717,0,0,1,1,0.0%,9m
26062,1,SELECT,2717,0,0,2,2,0.0%,47m
26082,2,ZhukeZZlay,2716,1370,141,128,269,52.4%,14m
26082,3,Berk,2716,472,31,35,66,47.0%,17m
26082,3,ABCD,2716,212,8,14,22,36.4%,11m
26082,1,Flexon,2716,175,6,0,6,100.0%,7m
26082,1,Botsia,2716,170,5,1,6,83.3%,22m
26082,1,Erri,2716,161,5,3,8,62.5%,32m
26082,3,[HNTK]Kallewirsch,2716,160,5,4,9,55.6%,4m
26082,1,GGboi,2716,0,4,1,5,80.0%,1h
26082,1,LiTuS,2716,118,4,4,8,50.0%,1h
26082,2,Karasich,2716,139,4,5,9,44.4%,9m
26082,1,[tMnrd]enderdan,2716,76,3,2,5,60.0%,3m
26082,2,Woralo,2716,0,3,3,6,50.0%,6m
26082,1,Sygul,2716,125,3,3,6,50.0%,59m
26082,3,Maxim,2716,93,2,2,4,50.0%,5m
26082,3,PaintUser,2716,0,2,3,5,40.0%,1h
26082,2,[ZERGTV]SkyWeeD,2716,88,2,4,6,33.3%,9m
26082,3,Naum,2716,125,2,4,6,33.3%,26m
26082,1,Malzadas,2716,0,1,0,1,100.0%,41m
26082,1,Sekasnaya,2716,0,1,0,1,100.0%,35m
26082,1,[ChZeal]Gorgon,2716,40,1,2,3,33.3%,39m
26082,1,defaultSushi,2716,40,1,4,5,20.0%,58m
26082,1,iamsama,2716,0,0,1,1,0.0%,6m
26082,2,deltafeatpka,2716,0,0,2,2,0.0%,1h
26082,3,gnome,2716,0,0,3,3,0.0%,35m
26106,3,SuperSquid,2715,1368,128,124,252,50.8%,27m
26106,3,Alex,2715,1281,72,70,142,50.7%,12m
26106,2,popol,2715,952,35,46,81,43.2%,16m
26106,1,TRUMPLOSTQQ,2715,401,20,2,22,90.9%,4m
26106,3,Aeternios,2715,152,20,18,38,52.6%,8m
26106,2,Вестгейр,2715,471,16,25,41,39.0%,10m
26106,1,[gliOrc]Dungeon,2715,261,10,8,18,55.6%,41m
26106,1,Potato,2715,254,8,3,11,72.7%,60m
26106,3,TogenX,2715,187,7,9,16,43.8%,26m
26106,1,БаРкОд,2715,208,6,2,8,75.0%,60m
26106,1,LeGrandJojo,2715,230,6,9,15,40.0%,31m
26106,1,Britney,2715,104,3,3,6,50.0%,26m
26106,1,mycephei,2715,30,2,4,6,33.3%,58m
26106,1,[Dahu]Aleksander,2715,89,2,4,6,33.3%,9m
26106,1,Julio,2715,133,2,7,9,22.2%,8m
26106,1,[KOTV]Onno,2715,0,1,0,1,100.0%,9m
26106,1,[FLB]SuperDownie,2715,0,1,0,1,100.0%,20m
26106,3,[FOKU]vulture,2715,0,1,0,1,100.0%,55m
26106,2,MOON,2715,0,0,1,1,0.0%,20m
26106,1,[run]serways,2715,0,0,1,1,0.0%,27m
26106,3,[PLEBZZ]ChillRAW,2715,0,0,1,1,0.0%,28m
26106,1,[CHOPAA]Blood,2715,0,0,1,1,0.0%,32m
26106,1,DeadlyPants,2715,0,0,1,1,0.0%,8m
26106,3,aZENsFer,2715,0,0,8,8,0.0%,11m
26130,1,Popeye,2714,1267,53,51,104,51.0%,20m
26130,1,Feshy,2714,703,42,30,72,58.3%,1h
26130,1,Scarecrow,2714,947,41,26,67,61.2%,1h
26130,1,ZluBurK,2714,571,25,24,49,51.0%,49m
26130,1,UnholyMask,2714,207,23,9,32,71.9%,46m
26130,1,Wise,2714,322,18,6,24,75.0%,38m
26130,3,AiD,2714,514,18,23,41,43.9%,11m
26130,3,[RlSKQQ]Shadow,2714,293,11,12,23,47.8%,25m
26130,1,[mfxed]Zildan,2714,335,9,20,29,31.0%,7m
26130,1,BlackArrow,2714,252,7,7,14,50.0%,19m
26130,3,nils,2714,168,5,7,12,41.7%,10m
26130,1,Reagent,2714,240,5,8,13,38.5%,33m
26130,1,Birdmen,2714,152,4,6,10,40.0%,33m
26130,1,[TLZS]DELATA,2714,80,3,2,5,60.0%,47m
26130,1,MoonAmigo,2714,97,2,2,4,50.0%,50m
26130,1,Laconnex,2714,0,1,0,1,100.0%,58m
26130,1,John,2714,0,0,1,1,0.0%,56m
26130,1,Magnar,2714,0,0,3,3,0.0%,4m
26148,1,MrSaltyWhite,2713,995,39,29,68,57.4%,54m
26148,1,Jeka,2713,435,36,24,60,60.0%,35m
26148,1,TwixArmy,2713,950,35,28,63,55.6%,43m
26148,1,Minotros,2713,841,30,22,52,57.7%,19m
26148,3,Burzum,2713,751,26,27,53,49.1%,2m
26148,1,[101101]Kindlund,2713,324,18,8,26,69.2%,56m
26148,1,Mefisto,2713,592,17,21,38,44.7%,1h
26148,1,Lancelot,2713,176,6,5,11,54.5%,47m
26148,3,[OKW1]URIEL,2713,0,4,3,7,57.1%,18m
26148,2,ChestorDS,2713,114,4,5,9,44.4%,1h
26148,3,Delasmo,2713,62,3,7,10,30.0%,12m
26148,1,Spider,2713,78,2,5,7,28.6%,43m
26148,1,Cruel,2713,0,0,1,1,0.0%,41m
26148,1,[NWGD]Крамбл,2713,0,0,1,1,0.0%,8m
26148,1,gwesto,2713,0,0,4,4,0.0%,35m
26163,1,TuRocker,2712,1542,155,173,328,47.3%,8m
26163,3,bloodlestat,2712,1533,100,102,202,49.5%,8m
26163,1,nobraintrain,2712,1258,50,44,94,53.2%,31m
26163,3,Sockerpullan,2712,1011,48,41,89,53.9%,5m
26163,3,Manse,2712,955,36,40,76,47.4%,25m
26163,1,FippelDippel,2712,908,33,31,64,51.6%,27m
26163,3,Nikolas,2712,634,32,24,56,57.1%,16m
26163,1,[KMW]ZeRedDragon,2712,870,29,26,55,52.7%,35m
26163,1,RichFroning,2712,323,13,9,22,59.1%,38m
26163,1,ДжонСмит,2712,323,12,12,24,50.0%,19m
26163,3,[Fnatik]Арсанис,2712,290,11,11,22,50.0%,9m
26163,1,[BiTr]CreepFeeder,2712,352,10,9,19,52.6%,52m
26163,1,GGreg,2712,193,7,6,13,53.8%,55m
26163,1,BlackUnit,2712,260,7,7,14,50.0%,49m
26163,1,chris,2712,184,6,8,14,42.9%,9m
26163,3,[ЗЕRGТV]Kronas,2712,195,5,8,13,38.5%,10m
26163,1,[CZxxSK]WolfasTheCat,2712,189,4,2,6,66.7%,26m
26163,3,teukwonjae,2712,97,4,2,6,66.7%,4m
26163,2,XAMCTEP,2712,139,3,2,5,60.0%,40m
26163,1,ddw,2712,88,3,3,6,50.0%,59m
26163,1,Harllu,2712,112,3,4,7,42.9%,20m
26163,1,follon,2712,0,2,3,5,40.0%,22m
26163,3,Артём,2712,0,1,3,4,25.0%,26m
26163,1,DarkDreamer,2712,38,1,4,5,20.0%,43m
26163,1,ImGroot,2712,0,0,1,1,0.0%,8m
26163,2,[4JEN]NotoriosPUD,2712,0,0,4,4,0.0%,5m
26189,2,MissLaura,2711,837,118,121,239,49.4%,2m
26189,2,[FF]Fudra,2711,1504,104,107,211,49.3%,25m
26189,2,Tsumi,2711,953,52,43,95,54.7%,2m
26189,3,Itachi,2711,768,29,28,57,50.9%,18m
26189,3,[BloTi]barcode,2711,738,25,33,58,43.1%,18m
26189,3,Lauron,2711,493,24,23,47,51.1%,6m
26189,3,FrozenJunky,2711,583,24,25,49,49.0%,11m
26189,3,Jolipoli,2711,568,22,25,47,46.8%,10m
26189,2,Thordran,2711,528,21,27,48,43.8%,11m
26189,1,kTWOmoz,2711,504,15,17,32,46.9%,40m
26189,2,Bowser,2711,96,6,1,7,85.7%,58m
26189,2,DoZYy,2711,175,4,1,5,80.0%,1h
26189,1,Kajuq,2711,0,2,3,5,40.0%,44m
26189,3,Alexandr,2711,0,2,3,5,40.0%,49m
26189,1,[AciNoN]Viole,2711,0,2,3,5,40.0%,1h
26189,3,illusha,2711,42,1,1,2,50.0%,60m
26189,1,PERAL,2711,0,1,2,3,33.3%,32m
26189,1,[Hitech]Prime,2711,38,1,2,3,33.3%,24m
26189,1,[RITB]Senpai,2711,0,1,2,3,33.3%,55m
26189,1,Yeet,2711,38,1,3,4,25.0%,47m
26189,1,NekoKnight,2711,0,1,3,4,25.0%,59m
26189,1,[ClDlN]ChopperChuck,2711,0,0,1,1,0.0%,47m
26211,1,[Chariz]Забвение,2710,1576,214,185,399,53.6%,59m
26211,3,Bobby,2710,1287,119,117,236,50.4%,26m
26211,1,peghius,2710,1403,59,41,100,59.0%,52m
26211,1,Drax,2710,1015,47,36,83,56.6%,32m
26211,1,Wiel,2710,570,21,15,36,58.3%,33m
26211,1,[TaMort]DontCryBaby,2710,608,19,17,36,52.8%,58m
26211,3,[WWJIM]Yivo,2710,269,11,11,22,50.0%,1h
26211,3,Seryyyyy,2710,302,11,11,22,50.0%,51m
26211,1,Hakan,2710,404,11,14,25,44.0%,31m
26211,1,HeX,2710,380,10,10,20,50.0%,44m
26211,2,Krarnev,2710,362,10,21,31,32.3%,25m
26211,3,Morhik,2710,92,5,11,16,31.2%,11m
26211,1,Hages,2710,110,4,2,6,66.7%,9m
26211,3,tenikov,2710,0,3,2,5,60.0%,35m
26211,1,Equalizer,2710,80,3,6,9,33.3%,31m
26211,1,RVN,2710,124,3,7,10,30.0%,58m
26211,3,[DEDbl]Fan,2710,92,3,9,12,25.0%,6m
26211,1,Olipeon,2710,0,2,4,6,33.3%,41m
26211,1,SooFeD,2710,0,2,7,9,22.2%,55m
26211,1,fettal,2710,0,1,0,1,100.0%,19m
26211,1,jwe,2710,38,1,1,2,50.0%,8m
26211,3,NAD,2710,30,1,4,5,20.0%,18m
26211,1,DrProctor,2710,38,1,4,5,20.0%,35m
26211,1,[3Mz]Strog,2710,0,0,1,1,0.0%,25m
26211,1,[Qarnty]Zero,2710,0,0,1,1,0.0%,47m
26211,3,Rhevan,2710,0,0,2,2,0.0%,18m
26211,1,NihilSineEgo,2710,0,0,3,3,0.0%,31m
26238,3,Artemopolus,2709,1503,107,102,209,51.2%,10m
26238,3,HePBuK,2709,1187,51,37,88,58.0%,3m
26238,3,Masterf,2709,264,43,47,90,47.8%,26m
26238,1,Lucy,2709,1110,36,39,75,48.0%,37m
26238,1,KennY,2709,569,26,13,39,66.7%,33m
26238,1,[NÛL]Kratoslezerg,2709,553,18,16,34,52.9%,33m
26238,1,Xprime,2709,428,17,14,31,54.8%,3m
26238,3,pitfox,2709,406,15,19,34,44.1%,12m
26238,1,Клеопатра,2709,320,14,3,17,82.4%,1h
26238,3,Loge,2709,198,7,13,20,35.0%,4m
26238,1,[ReGRoC]Alarak,2709,178,5,2,7,71.4%,49m
26238,1,Jeanne,2709,109,5,5,10,50.0%,28m
26238,3,Eztly,2709,0,4,1,5,80.0%,31m
26238,1,Dioraks,2709,156,4,2,6,66.7%,41m
26238,3,Xav,2709,90,4,6,10,40.0%,17m
26238,2,Orak,2709,95,3,5,8,37.5%,1h
26238,1,[ТЧК]gunter,2709,0,1,0,1,100.0%,49m
26238,1,Olex,2709,0,1,0,1,100.0%,20m
26238,1,Akuma,2709,120,1,3,4,25.0%,50m
26238,2,Pipas,2709,46,1,3,4,25.0%,24m
26238,3,Atlant,2709,0,0,1,1,0.0%,53m
26238,3,gopoo,2709,0,0,1,1,0.0%,36m
26238,2,Сопляк,2709,0,0,2,2,0.0%,53m
26238,1,JerryKan,2709,0,0,3,3,0.0%,5m
26238,1,Repentence,2709,0,0,5,5,0.0%,58m
26263,2,Oicnebur,2708,1575,309,308,617,50.1%,25m
26263,1,Halo,2708,1507,228,228,456,50.0%,25m
26263,1,accpushkin,2708,1647,152,130,282,53.9%,28m
26263,1,xliszt,2708,827,77,77,154,50.0%,26m
26263,1,БУЛОЧКА,2708,1302,65,42,107,60.7%,57m
26263,1,Syechkah,2708,1334,65,58,123,52.8%,3m
26263,1,Markinhos,2708,1270,53,39,92,57.6%,44m
26263,3,Flegma,2708,287,48,51,99,48.5%,7m
26263,1,Phenix,2708,671,29,12,41,70.7%,54m
26263,3,Lacura,2708,514,19,26,45,42.2%,11m
26263,1,ShasDk,2708,344,12,7,19,63.2%,31m
26263,1,ooooo,2708,294,11,3,14,78.6%,22m
26263,3,mirko,2708,238,11,10,21,52.4%,7m
26263,1,DonFecalio,2708,130,10,5,15,66.7%,1h
26263,1,Neofitik,2708,213,9,6,15,60.0%,1h
26263,2,Takodo,2708,205,7,17,24,29.2%,11m
26263,1,Mamedkonfet,2708,187,6,2,8,75.0%,20m
26263,1,ITryMyBest,2708,157,6,4,10,60.0%,50m
26263,2,Boniek,2708,116,5,3,8,62.5%,51m
26263,1,Wulfioso,2708,145,5,6,11,45.5%,50m
26263,2,[BZSS]Lazard,2708,62,4,8,12,33.3%,19m
26263,1,GroMoBoy,2708,118,3,7,10,30.0%,35m
26263,3,fringant,2708,56,3,9,12,25.0%,5m
26263,1,[Tere]KatSuMoToPo,2708,0,2,3,5,40.0%,5m
26263,1,Hardstem,2708,0,2,3,5,40.0%,43m
26263,1,thorius,2708,78,2,7,9,22.2%,3m
26263,1,silverice,2708,0,1,0,1,100.0%,20m
26263,1,Khadgar,2708,0,1,0,1,100.0%,27m
26263,1,ovi,2708,89,1,1,2,50.0%,33m
26263,1,Bianchirock,2708,93,1,1,2,50.0%,48m
26263,1,Delriver,2708,30,1,3,4,25.0%,1h
26263,3,[SaH]Machine,2708,92,1,4,5,20.0%,14m
26263,1,Chaps,2708,0,1,4,5,20.0%,44m
26263,1,Nordic,2708,0,0,1,1,0.0%,1h
26263,1,agakundle,2708,0,0,2,2,0.0%,27m
26263,1,[ZPXS]CroppPriest,2708,0,0,2,2,0.0%,49m
26299,1,Альфабабуин,2707,1544,361,369,730,49.5%,8m
26299,1,Xavv,2707,1712,127,123,250,50.8%,39m
26299,1,Plautze,2707,1583,84,77,161,52.2%,1h
26299,2,[LesSaB]QuadDamaged,2707,1527,68,66,134,50.7%,25m
26299,3,Mineos,2707,1418,61,68,129,47.3%,6m
26299,2,FisherWeil,2707,1390,53,54,107,49.5%,12m
26299,1,rösner,2707,1073,44,36,80,55.0%,43m
26299,1,PatY,2707,944,43,35,78,55.1%,41m
26299,2,Batskater,2707,395,23,29,52,44.2%,11m
26299,1,elDuderino,2707,258,23,30,53,43.4%,8m
26299,1,SWEETiCHERRY,2707,658,22,17,39,56.4%,5m
26299,1,JackpoT,2707,517,16,12,28,57.1%,7m
26299,1,Buberts,2707,307,12,12,24,50.0%,44m
26299,1,Abe,2707,209,11,3,14,78.6%,44m
26299,1,WiRm,2707,295,9,4,13,69.2%,3m
26299,1,Kyyyki,2707,230,7,8,15,46.7%,1h
26299,1,BulletMagnet,2707,178,6,3,9,66.7%,1h
26299,1,[OTLSS]WINDFIRE,2707,228,6,6,12,50.0%,46m
26299,3,BuzzMon,2707,158,6,12,18,33.3%,3m
26299,1,Skrippel,2707,102,4,4,8,50.0%,1h
26299,1,Victoire,2707,0,3,2,5,60.0%,27m
26299,1,lazerr,2707,0,2,4,6,33.3%,31m
26299,1,Alex,2707,0,0,1,1,0.0%,22m
26299,1,[COОP]Lexx,2707,0,0,1,1,0.0%,60m
26323,3,[TMOS]ZergDrachen,2706,1520,70,54,124,56.5%,2m
26323,1,LingBoy,2706,657,57,50,107,53.3%,3m
26323,1,[ULTX]Bavor,2706,848,56,45,101,55.4%,47m
26323,3,[ThFctr]BlackFactor,2706,823,42,50,92,45.7%,10m
26323,3,CaptianFox,2706,428,18,21,39,46.2%,15m
26323,3,Džigljaš,2706,361,17,22,39,43.6%,2m
26323,1,tiagon,2706,350,13,14,27,48.1%,8m
26323,1,DrHoernchen,2706,164,5,8,13,38.5%,4m
26323,3,[RI3B]DExcavatoR,2706,0,4,1,5,80.0%,40m
26323,1,[ULP]Changelingir,2706,0,4,1,5,80.0%,20m
26323,3,[5200OS]Brinchmann,2706,167,4,9,13,30.8%,13m
26323,2,West,2706,94,3,4,7,42.9%,59m
26323,3,Papaya,2706,92,3,4,7,42.9%,5m
26323,1,Пан,2706,0,2,3,5,40.0%,32m
26323,1,Воронов,2706,0,1,0,1,100.0%,6m
26323,1,[ZeDe20]aLeXz,2706,0,1,0,1,100.0%,31m
26323,1,[GoTerr]TioBalda,2706,0,0,1,1,0.0%,32m
26323,1,[sissis]Auresion,2706,0,0,1,1,0.0%,60m
26341,3,[Ptit]Балиас,2705,1597,264,259,523,50.5%,6m
26341,1,Ёршик,2705,1663,73,73,146,50.0%,43m
26341,1,Starcounter,2705,849,62,33,95,65.3%,1h
26341,1,[SAKZ]Polidrap,2705,1101,43,39,82,52.4%,5m
26341,1,NeVeS,2705,706,27,20,47,57.4%,3m
26341,1,Vena,2705,539,22,18,40,55.0%,1h
26341,1,CaptObvious,2705,493,19,19,38,50.0%,3m
26341,3,Mahlzeit,2705,494,17,26,43,39.5%,10m
26341,1,Fandilo,2705,480,15,10,25,60.0%,26m
26341,1,DonPiff,2705,397,14,9,23,60.9%,31m
26341,1,Voin,2705,264,7,10,17,41.2%,47m
26341,1,IlIlIlIlIlIl,2705,167,6,7,13,46.2%,43m
26341,1,[FROG12]MrSolatik,2705,186,5,3,8,62.5%,1h
26341,1,Kyrorian,2705,150,4,4,8,50.0%,8m
26341,1,DirtyToss,2705,118,4,4,8,50.0%,58m
26341,3,Necros,2705,161,4,8,12,33.3%,51m
26341,3,[Poofff]HxCKid,2705,128,4,14,18,22.2%,18m
26341,1,McG,2705,160,3,2,5,60.0%,5m
26341,1,Indra,2705,72,2,2,4,50.0%,44m
26341,1,Ironside,2705,121,2,2,4,50.0%,47m
26341,3,Maple,2705,0,2,3,5,40.0%,1h
26341,1,Edzu,2705,0,2,3,5,40.0%,47m
26341,3,Mifus,2705,58,2,10,12,16.7%,11m
26341,1,Tadixxx,2705,0,1,0,1,100.0%,57m
26341,1,Bore,2705,0,1,0,1,100.0%,23m
26341,1,alterego,2705,40,1,1,2,50.0%,41m
26341,1,TeKKitty,2705,0,1,2,3,33.3%,9m
26341,1,Seingeschäft,2705,0,0,1,1,0.0%,35m
26341,1,[ZЕRGТV]Хлебушек,2705,0,0,3,3,0.0%,28m
26370,1,Radnor,2704,1101,188,176,364,51.6%,58m
26370,3,Mylord,2704,1256,166,156,322,51.6%,3m
26370,1,Headshot,2704,1498,69,48,117,59.0%,19m
26370,3,[BYTCA]thorN,2704,1059,42,44,86,48.8%,10m
26370,1,AnXieTy,2704,539,22,25,47,46.8%,12m
26370,1,[300mk2]KOrni,2704,309,13,9,22,59.1%,20m
26370,2,GumGum,2704,152,10,19,29,34.5%,27m
26370,1,Avoska,2704,174,6,1,7,85.7%,19m
26370,3,[rpt]Elbor,2704,168,5,7,12,41.7%,19m
26370,3,Sowa,2704,195,5,7,12,41.7%,13m
26370,3,Lollapalooza,2704,97,3,3,6,50.0%,6m
26370,2,[NWAro]FelineFrog,2704,133,3,4,7,42.9%,6m
26370,1,Luyan,2704,82,3,6,9,33.3%,1h
26370,1,[CNC3]iliyesku,2704,121,2,2,4,50.0%,45m
26370,1,CneKTP,2704,78,2,6,8,25.0%,52m
26370,1,Tholo,2704,36,1,2,3,33.3%,37m
26370,1,stormi,2704,0,0,1,1,0.0%,59m
26370,1,Tassartanis,2704,0,0,2,2,0.0%,27m
26370,1,HerrPulaRau,2704,0,0,2,2,0.0%,41m
26370,1,corradolab,2704,0,0,3,3,0.0%,24m
26390,1,[AciNoN]Skill,2703,979,42,22,64,65.6%,19m
26390,1,HeyRock,2703,845,38,24,62,61.3%,44m
26390,3,GreeFine,2703,487,22,24,46,47.8%,27m
26390,1,phenyl,2703,284,17,8,25,68.0%,43m
26390,1,Woulver,2703,306,12,12,24,50.0%,53m
26390,1,[TAW]PforPizza,2703,326,10,9,19,52.6%,46m
26390,1,PINGALOKA,2703,189,9,4,13,69.2%,44m
26390,1,smartassraty,2703,329,9,8,17,52.9%,41m
26390,1,XArgon,2703,187,6,7,13,46.2%,8m
26390,1,Jayminator,2703,173,5,4,9,55.6%,6m
26390,2,Beerlover,2703,143,5,5,10,50.0%,21m
26390,3,FangVik,2703,44,2,1,3,66.7%,52m
26390,3,Martinus,2703,0,2,3,5,40.0%,42m
26390,1,[TOMK]MarineKing,2703,0,1,2,3,33.3%,53m
26390,1,[Трутни]RazarRiper,2703,40,1,2,3,33.3%,45m
26390,1,PriKoLyoSha,2703,0,0,1,1,0.0%,35m
26406,2,benizakura,2702,1371,132,148,280,47.1%,17m
26406,3,Laayyzz,2702,609,71,63,134,53.0%,16m
26406,3,urumikanzaki,2702,1389,60,60,120,50.0%,9m
26406,3,[S4G]Nico,2702,1272,47,54,101,46.5%,13m
26406,1,IIIIIIIIIIII,2702,530,39,42,81,48.1%,26m
26406,1,[GOAMPU]BlackViper,2702,699,32,25,57,56.1%,8m
26406,1,Cerulean,2702,677,31,19,50,62.0%,9m
26406,3,Sibastion,2702,396,30,22,52,57.7%,16m
26406,1,Lexx,2702,864,28,29,57,49.1%,21m
26406,1,Darchangel,2702,424,24,17,41,58.5%,22m
26406,1,[PIKMN]UnPrisoned,2702,476,16,12,28,57.1%,58m
26406,3,BloodMoon,2702,336,14,9,23,60.9%,10m
26406,1,EchizoLoviuf,2702,387,14,11,25,56.0%,31m
26406,1,ABT,2702,321,11,7,18,61.1%,4m
26406,1,[PÂRłAH]CedalmCZ,2702,360,11,14,25,44.0%,6m
26406,1,Remnon,2702,160,5,5,10,50.0%,5m
26406,1,[Flammy]Ling,2702,143,4,2,6,66.7%,44m
26406,3,[xDNOx]XeLaS,2702,116,4,8,12,33.3%,18m
26406,3,[69780]lucky,2702,0,3,4,7,42.9%,16m
26406,1,Andrew,2702,106,3,8,11,27.3%,43m
26406,1,JesuusCry,2702,0,2,2,4,50.0%,19m
26406,3,НюхайБэбру,2702,0,2,3,5,40.0%,9m
26406,1,Nebenhode,2702,0,1,0,1,100.0%,5m
26406,2,[GLNMS]QbQb,2702,0,1,0,1,100.0%,5m
26406,1,ЕНОТ,2702,0,1,0,1,100.0%,4m
26406,1,Graezer,2702,42,1,4,5,20.0%,21m
26406,1,Ghost,2702,0,0,1,1,0.0%,27m
26406,1,ALEX,2702,0,0,1,1,0.0%,35m
26406,3,GriwMF,2702,0,0,1,1,0.0%,6m
26406,2,Shadow,2702,0,0,1,1,0.0%,1h
26406,1,Lokahn,2702,0,0,2,2,0.0%,1h
26406,1,kSHARK,2702,0,0,3,3,0.0%,33m
26438,3,Aril,2701,983,68,72,140,48.6%,10m
26438,2,FanFan,2701,869,56,63,119,47.1%,9m
26438,1,Gungani,2701,1240,50,44,94,53.2%,9m
26438,3,OraOra,2701,866,36,35,71,50.7%,26m
26438,1,Thoroni,2701,732,34,15,49,69.4%,60m
26438,1,Drell,2701,644,25,18,43,58.1%,1h
26438,1,todbeibrot,2701,375,13,7,20,65.0%,41m
26438,1,MrDaVinc,2701,400,12,14,26,46.2%,9m
26438,1,Buratino,2701,376,11,10,21,52.4%,3m
26438,1,[Kripta]Зомби,2701,294,9,10,19,47.4%,60m
26438,2,notafish,2701,228,9,10,19,47.4%,9m
26438,1,theman,2701,167,6,7,13,46.2%,9m
26438,3,[REDFOX]Faneco,2701,118,6,8,14,42.9%,15m
26438,1,[GAMAD]dujejur,2701,153,5,5,10,50.0%,7m
26438,1,[АDMIN]HOstvind,2701,122,5,6,11,45.5%,19m
26438,1,[IndyK]Lieutenant,2701,180,5,8,13,38.5%,1h
26438,2,PPO,2701,96,4,4,8,50.0%,21m
26438,1,Zot,2701,116,4,5,9,44.4%,50m
26438,1,alexfoxdave,2701,106,3,1,4,75.0%,26m
26438,1,[RMF]Mortum,2701,80,3,5,8,37.5%,26m
26438,3,elective,2701,0,2,3,5,40.0%,52m
26438,1,GidraLisk,2701,76,2,3,5,40.0%,52m
26438,1,IIyKaH,2701,40,1,2,3,33.3%,19m
26438,3,tobeyforce,2701,0,1,2,3,33.3%,1h
26438,2,[BVtp]SkullBones,2701,0,0,1,1,0.0%,44m
26463,2,RomanO,2700,1710,156,164,320,48.8%,19m
26463,3,USSR,2700,1552,100,85,185,54.1%,16m
26463,1,Akashhh,2700,1039,89,72,161,55.3%,47m
26463,3,[Seti]CorranHorn,2700,1546,77,67,144,53.5%,6m
26463,1,Pocho,2700,1731,68,64,132,51.5%,22m
26463,1,martyros,2700,1462,66,52,118,55.9%,31m
26463,3,[IPPNNH]Basamel,2700,1215,46,48,94,48.9%,5m
26463,1,Hamster,2700,885,43,25,68,63.2%,6m
26463,1,Trulseren,2700,1033,43,32,75,57.3%,9m
26463,3,Sadie,2700,329,11,10,21,52.4%,4m
26463,2,[FSO]BaronBrax,2700,212,7,4,11,63.6%,40m
26463,3,GOTOHELL,2700,188,7,8,15,46.7%,19m
26463,3,Xaserstxr,2700,158,6,9,15,40.0%,47m
26463,1,bebel,2700,196,5,3,8,62.5%,1h
26463,1,Hiob,2700,38,3,4,7,42.9%,59m
26463,1,GreenDay,2700,122,3,5,8,37.5%,8m
26463,1,KingTeonidas,2700,80,3,5,8,37.5%,19m
26463,2,Nyachi,2700,46,3,5,8,37.5%,32m
26463,3,Curya,2700,0,2,3,5,40.0%,49m
26463,3,Trinity,2700,118,2,7,9,22.2%,5m
26463,1,Paulus,2700,96,1,2,3,33.3%,47m
26463,1,Todbinger,2700,0,1,4,5,20.0%,59m
26463,1,Archiette,2700,0,0,1,1,0.0%,57m
26463,1,RyukoFatoi,2700,0,0,5,5,0.0%,38m
26487,1,Ottis,2699,1688,79,76,155,51.0%,32m
26487,1,Merlin,2699,1277,72,73,145,49.7%,7m
26487,1,Jarley,2699,738,58,53,111,52.3%,3m
26487,3,Baneling,2699,1047,40,40,80,50.0%,7m
26487,1,Даниил,2699,757,34,22,56,60.7%,44m
26487,2,Papatudo,2699,657,22,31,53,41.5%,10m
26487,1,shadowclone,2699,535,17,15,32,53.1%,35m
26487,1,[TSC2C]Инквизиция,2699,311,13,7,20,65.0%,32m
26487,1,Daymon,2699,372,11,11,22,50.0%,1h
26487,1,[Falkon]Scofield,2699,326,10,8,18,55.6%,1h
26487,1,Legion,2699,216,8,8,16,50.0%,59m
26487,1,Erynnis,2699,257,7,7,14,50.0%,1h
26487,1,Hercule,2699,131,5,0,5,100.0%,32m
26487,1,elpietro,2699,135,4,1,5,80.0%,8m
26487,1,Виктор,2699,166,4,4,8,50.0%,55m
26487,1,[Mercy1]Grumbleball,2699,110,4,5,9,44.4%,45m
26487,3,adiq,2699,97,3,3,6,50.0%,49m
26487,1,[LGC]mattju,2699,42,2,1,3,66.7%,53m
26487,1,Skjegg,2699,36,2,2,4,50.0%,60m
26487,3,slake,2699,0,2,3,5,40.0%,60m
26487,3,[NOT1ME]soragons,2699,0,1,1,2,50.0%,50m
26487,1,Ulveraker,2699,94,1,1,2,50.0%,50m
26487,1,Rasboinic,2699,0,0,1,1,0.0%,41m
26487,1,HAVEFAN,2699,0,0,1,1,0.0%,31m
26487,2,Geryx,2699,0,0,1,1,0.0%,9m
26487,1,[KRUTO]Swagmond,2699,0,0,2,2,0.0%,7m
26487,1,Рубик,2699,73,0,3,3,0.0%,60m
26514,3,BlackWorm,2698,1497,242,229,471,51.4%,11m
26514,3,veleye,2698,1571,209,201,410,51.0%,10m
26514,3,Hell,2698,1508,185,173,358,51.7%,26m
26514,2,Xolo,2698,1110,93,102,195,47.7%,13m
26514,1,Xordan,2698,1642,60,60,120,50.0%,47m
26514,1,tbang,2698,1292,49,45,94,52.1%,59m
26514,2,boo,2698,606,24,31,55,43.6%,26m
26514,1,Rinzler,2698,351,15,8,23,65.2%,47m
26514,3,Алиночка,2698,357,13,15,28,46.4%,15m
26514,3,Дмитрий,2698,174,8,15,23,34.8%,4m
26514,1,KingCrevette,2698,240,7,12,19,36.8%,1h
26514,1,Ahriman,2698,136,5,23,28,17.9%,5m
26514,1,Ditmir,2698,119,4,0,4,100.0%,53m
26514,2,[NLǂ]oversium,2698,0,3,4,7,42.9%,24m
26514,1,Nogue,2698,106,3,4,7,42.9%,4m
26514,3,DarkMag,2698,0,2,3,5,40.0%,9m
26514,1,[ExTr1m]NekRoMen,2698,0,2,3,5,40.0%,59m
26514,1,matrash,2698,0,2,3,5,40.0%,9m
26514,1,SlotMachine,2698,36,2,4,6,33.3%,35m
26514,3,Janesu,2698,91,2,7,9,22.2%,8m
26514,1,FatPinjata,2698,0,1,1,2,50.0%,54m
26514,1,[765]RoBot,2698,38,1,2,3,33.3%,7m
26514,1,[DBTU]Ghostpants,2698,0,0,1,1,0.0%,8m
26514,3,RUINICALE,2698,0,0,1,1,0.0%,56m
26538,1,hellfish,2697,517,20,15,35,57.1%,31m
26538,3,Adve,2697,517,20,22,42,47.6%,4m
26538,1,[FrC0]Cleto,2697,490,14,15,29,48.3%,53m
26538,1,ZopAgent,2697,309,11,17,28,39.3%,50m
26538,3,einstein,2697,182,7,11,18,38.9%,16m
26538,1,MrSweterek,2697,226,6,6,12,50.0%,1h
26538,1,MiniCote,2697,194,6,10,16,37.5%,2m
26538,1,[OmDi]IrishKiad,2697,136,3,2,5,60.0%,3m
26538,3,DopingDrone,2697,0,3,3,6,50.0%,1h
26538,3,Alcatraz,2697,40,3,6,9,33.3%,11m
26538,1,OKSERIAN,2697,173,3,6,9,33.3%,3m
26538,2,[aslick]FURIATPL,2697,95,2,1,3,66.7%,32m
26538,1,randomhacker,2697,97,2,2,4,50.0%,36m
26538,3,Makaveli,2697,64,2,9,11,18.2%,18m
26538,1,vJullian,2697,36,1,2,3,33.3%,19m
26538,1,topNoob,2697,40,1,3,4,25.0%,1h
26538,1,ArmaniMani,2697,0,0,2,2,0.0%,5m
26538,3,drzewol,2697,0,0,3,3,0.0%,25m
26556,2,Olayanne,2696,1501,193,200,393,49.1%,11m
26556,1,Lukas,2696,1634,95,82,177,53.7%,20m
26556,1,Dark,2696,1124,63,48,111,56.8%,28m
26556,1,Killagedon,2696,745,40,27,67,59.7%,1h
26556,1,Briciola,2696,860,28,27,55,50.9%,9m
26556,1,[MaSSS]ironcrack,2696,738,24,25,49,49.0%,41m
26556,3,[GAME33]СТАЛКЕР,2696,466,22,27,49,44.9%,16m
26556,3,FlowerKiller,2696,524,19,26,45,42.2%,11m
26556,3,beerkinauta,2696,421,17,21,38,44.7%,3m
26556,3,Бабуйн,2696,280,11,20,31,35.5%,10m
26556,3,[Obz]Yéthylique,2696,278,9,17,26,34.6%,18m
26556,1,Ressehc,2696,132,5,4,9,55.6%,52m
26556,1,GACHIped,2696,140,4,4,8,50.0%,53m
26556,2,baphomet,2696,120,4,16,20,20.0%,11m
26556,1,[Skyy]max,2696,112,3,4,7,42.9%,26m
26556,2,[Маньяк]llllllllllll,2696,97,2,0,2,100.0%,26m
26556,3,Loggi,2696,0,2,3,5,40.0%,35m
26556,3,Koczer,2696,0,1,6,7,14.3%,17m
26556,2,[iR3B]Stankezz,2696,0,0,1,1,0.0%,1h
26556,1,Henrik,2696,0,0,2,2,0.0%,39m
26556,1,LUXOdotZiP,2696,0,0,2,2,0.0%,1h
26556,1,lalalaalalal,2696,0,0,3,3,0.0%,23m
26578,1,JanSolo,2695,1319,149,141,290,51.4%,1h
26578,1,Булат,2695,1712,108,104,212,50.9%,1h
26578,3,Пакувыцо,2695,1414,56,57,113,49.6%,10m
26578,1,DarthRobin,2695,940,39,30,69,56.5%,9m
26578,1,diabezdemona,2695,821,32,26,58,55.2%,52m
26578,2,[IIOGII]Sigfried,2695,624,21,34,55,38.2%,11m
26578,3,Sibbotine,2695,425,16,20,36,44.4%,17m
26578,1,[WWP]Argentina,2695,430,15,10,25,60.0%,1h
26578,1,Han,2695,347,13,15,28,46.4%,35m
26578,1,striker,2695,233,11,7,18,61.1%,57m
26578,2,Voodoo,2695,251,10,15,25,40.0%,2m
26578,3,[BWArmy]LeGuims,2695,171,8,14,22,36.4%,4m
26578,1,[AWP38]KaTuZa,2695,216,6,9,15,40.0%,1h
26578,1,Trax,2695,74,3,3,6,50.0%,60m
26578,2,[BaCorp]Brasnar,2695,0,3,4,7,42.9%,19m
26578,3,Shigeko,2695,92,3,11,14,21.4%,4m
26578,1,HerojaK,2695,38,1,3,4,25.0%,1h
26578,1,MistaEvil,2695,0,0,1,1,0.0%,20m
26578,1,Mitchel,2695,0,0,2,2,0.0%,47m
26597,3,Sarge,2694,1197,117,116,233,50.2%,6m
26597,1,ToxikIne,2694,1592,86,71,157,54.8%,50m
26597,3,warmhugs,2694,1213,69,72,141,48.9%,4m
26597,2,Cape,2694,833,41,54,95,43.2%,13m
26597,1,ERRORcat,2694,859,40,22,62,64.5%,1h
26597,3,Noise,2694,1030,39,41,80,48.8%,17m
26597,1,[BigRat]SteelRat,2694,485,26,7,33,78.8%,41m
26597,1,Crevette,2694,598,23,19,42,54.8%,22m
26597,1,JackSparroW,2694,548,22,15,37,59.5%,31m
26597,1,DRAGONVA,2694,522,20,12,32,62.5%,7m
26597,2,taiyin,2694,403,16,21,37,43.2%,15m
26597,1,Nyarla,2694,264,14,2,16,87.5%,43m
26597,1,[TrouBå]Kuroro,2694,356,14,12,26,53.8%,43m
26597,1,starlord,2694,388,11,11,22,50.0%,46m
26597,1,Zyron,2694,210,8,6,14,57.1%,54m
26597,1,crusty,2694,258,8,10,18,44.4%,58m
26597,2,RoboCop,2694,170,7,8,15,46.7%,11m
26597,3,[WIch]PiOeuvre,2694,176,6,16,22,27.3%,11m
26597,1,Brainafkler,2694,136,5,1,6,83.3%,1h
26597,3,[SSGH]Raven,2694,0,5,1,6,83.3%,1h
26597,1,VEz,2694,183,5,2,7,71.4%,33m
26597,3,Djurosaur,2694,154,4,7,11,36.4%,14m
26597,1,Kronolis,2694,74,3,2,5,60.0%,1h
26597,1,[KBLNZ]Commander,2694,120,3,5,8,37.5%,5m
26597,1,notbnk,2694,97,3,6,9,33.3%,54m
26597,1,[НТТ]Hashirama,2694,34,2,2,4,50.0%,21m
26597,1,KeuperMarlue,2694,0,2,3,5,40.0%,54m
26597,1,[NBV]LazyOwl,2694,0,2,3,5,40.0%,9m
26597,1,Dreier,2694,0,1,0,1,100.0%,28m
26597,1,StarSchwarf,2694,0,1,0,1,100.0%,8m
26597,1,Caweridramus,2694,0,1,0,1,100.0%,50m
26597,2,djglatnakke,2694,0,1,3,4,25.0%,32m
26597,1,MrGrumpy,2694,40,1,4,5,20.0%,21m
26597,3,[IK3A]Domeport,2694,30,1,6,7,14.3%,9m
26597,1,StarKillers,2694,0,0,1,1,0.0%,21m
26597,3,[Famlly]Blackbird,2694,0,0,1,1,0.0%,2m
26633,1,Sjoerd,2693,1589,96,80,176,54.5%,1h
26633,1,Omnislash,2693,1321,73,67,140,52.1%,53m
26633,1,[mfxed]Adamoz,2693,1183,65,54,119,54.6%,52m
26633,2,Boomeroid,2693,1441,53,59,112,47.3%,26m
26633,2,Mike,2693,547,21,28,49,42.9%,4m
26633,3,paranoiax,2693,251,18,24,42,42.9%,14m
26633,1,Aelix,2693,280,14,7,21,66.7%,4m
26633,2,Roconator,2693,362,14,15,29,48.3%,13m
26633,1,PrinceFlaco,2693,264,12,10,22,54.5%,24m
26633,1,[Radium]ElinaRosle,2693,286,10,6,16,62.5%,19m
26633,3,TheBoomer,2693,260,8,11,19,42.1%,2m
26633,1,DJMolina,2693,180,6,3,9,66.7%,47m
26633,1,Kallisto,2693,257,6,6,12,50.0%,1h
26633,3,Psychopath,2693,182,6,14,20,30.0%,4m
26633,3,[Buldog]Pleften,2693,166,5,4,9,55.6%,22m
26633,1,GorEviN,2693,120,4,4,8,50.0%,5m
26633,3,[BTB]Arkan,2693,0,2,3,5,40.0%,21m
26633,3,Eltarax,2693,62,2,10,12,16.7%,3m
26633,1,Tascam,2693,88,1,1,2,50.0%,22m
26652,2,MetalhaMMer,2692,1429,249,248,497,50.1%,5m
26652,2,[Perm]protosek,2692,1304,166,156,322,51.6%,8m
26652,1,Saytori,2692,886,82,60,142,57.7%,41m
26652,2,[mfxed]Onceinalife,2692,308,56,60,116,48.3%,13m
26652,1,[NEPROM]Randomguy,2692,924,42,28,70,60.0%,3m
26652,3,[EEBÄR]Monsta,2692,292,10,9,19,52.6%,34m
26652,1,MakisG,2692,250,8,9,17,47.1%,43m
26652,1,qшp,2692,234,8,9,17,47.1%,58m
26652,2,mrtireones,2692,219,7,6,13,53.8%,43m
26652,1,[BARJOT]Cmoi,2692,280,7,7,14,50.0%,1h
26652,3,Grina,2692,172,7,10,17,41.2%,5m
26652,1,Beonix,2692,119,6,3,9,66.7%,1h
26652,2,Lßaz,2692,138,6,7,13,46.2%,19m
26652,3,Macharius,2692,127,5,6,11,45.5%,8m
26652,1,Samurakhe,2692,190,5,7,12,41.7%,39m
26652,1,AnafoR,2692,112,3,5,8,37.5%,60m
26652,1,[696]ProBEherOboy,2692,89,2,0,2,100.0%,1h
26652,1,[TIeu]killonenow,2692,88,2,0,2,100.0%,8m
26652,3,Sattlix,2692,0,2,2,4,50.0%,6m
26652,3,[Rondel]Syachu,2692,0,2,3,5,40.0%,60m
26652,1,Esprit,2692,72,2,3,5,40.0%,9m
26652,1,Diamond,2692,0,2,3,5,40.0%,1h
26652,1,Leninlive,2692,89,1,1,2,50.0%,50m
26652,1,Skrrt,2692,0,0,1,1,0.0%,1h
26652,1,Makkemias,2692,0,0,3,3,0.0%,35m
26677,3,tho,2691,1409,124,122,246,50.4%,18m
26677,3,[SltSpt]GeneralLasse,2691,1559,120,115,235,51.1%,18m
26677,1,YtekSpouki,2691,1711,87,82,169,51.5%,31m
26677,3,Voodoo,2691,1553,71,76,147,48.3%,26m
26677,1,[PiGPan]CJV,2691,522,47,44,91,51.6%,42m
26677,1,Manogaroff,2691,678,29,20,49,59.2%,1h
26677,3,fucboinugget,2691,655,23,28,51,45.1%,4m
26677,1,SayNoToStim,2691,554,19,16,35,54.3%,53m
26677,1,Lapse,2691,208,7,10,17,41.2%,1h
26677,3,GLASSMAX,2691,173,5,5,10,50.0%,23m
26677,3,Kole,2691,125,5,5,10,50.0%,6m
26677,3,[DaDrDu]Joe,2691,158,5,15,20,25.0%,13m
26677,3,Valokordin,2691,0,2,3,5,40.0%,51m
26677,1,[Белшир]BlackNinja,2691,0,2,4,6,33.3%,3m
26677,1,[ncotic]BlackBoar,2691,0,1,0,1,100.0%,2m
26677,3,momommomom,2691,0,1,0,1,100.0%,34m
26677,1,Ventriloc,2691,0,1,3,4,25.0%,58m
26677,1,[ScARx]sporten,2691,0,0,1,1,0.0%,22m
26677,1,Darkbait,2691,0,0,1,1,0.0%,8m
26677,1,Illustro,2691,0,0,3,3,0.0%,28m
26697,1,[xFRSx]capHadock,2690,1239,438,427,865,50.6%,17m
26697,1,masterone,2690,311,163,147,310,52.6%,56m
26697,3,replayRTW,2690,801,30,39,69,43.5%,18m
26697,1,DinuX,2690,842,28,25,53,52.8%,30m
26697,3,proil,2690,676,28,26,54,51.9%,25m
26697,3,Frezzer,2690,356,22,24,46,47.8%,7m
26697,1,Hiddius,2690,470,13,20,33,39.4%,53m
26697,1,ГИГАПИГА,2690,355,12,10,22,54.5%,53m
26697,2,Zaharel,2690,116,5,3,8,62.5%,1h
26697,1,[Wø]Darcklaw,2690,110,4,3,7,57.1%,33m
26697,3,Calero,2690,0,2,3,5,40.0%,55m
26697,1,[DIL80]Dragonstrike,2690,0,2,3,5,40.0%,9m
26697,1,Bangau,2690,76,2,3,5,40.0%,60m
26697,1,[DG5500]Maxiste,2690,0,2,3,5,40.0%,49m
26697,1,Zulraggar,2690,68,2,8,10,20.0%,45m
26697,1,Akhu,2690,0,1,0,1,100.0%,35m
26697,1,Corona,2690,0,1,0,1,100.0%,57m
26697,3,Lillebror,2690,0,0,1,1,0.0%,51m
26697,1,xavier,2690,0,0,1,1,0.0%,60m
26697,1,маус,2690,0,0,2,2,0.0%,1h
26717,3,Hellgin,2689,970,115,116,231,49.8%,26m
26717,1,DogsGang,2689,1541,110,85,195,56.4%,57m
26717,3,[αX]woodooo,2689,639,90,76,166,54.2%,11m
26717,3,Ermik,2689,823,31,33,64,48.4%,13m
26717,1,[DrPlat]Paer,2689,562,21,22,43,48.8%,9m
26717,1,Djecraft,2689,548,17,16,33,51.5%,4m
26717,1,Doil,2689,207,7,9,16,43.8%,3m
26717,1,HardGosu,2689,183,6,2,8,75.0%,44m
26717,1,[TgAg]YeshuaIsKing,2689,169,5,2,7,71.4%,58m
26717,2,Bogatirev,2689,117,4,3,7,57.1%,5m
26717,1,phikus,2689,120,4,4,8,50.0%,50m
26717,1,EGO,2689,116,4,4,8,50.0%,31m
26717,1,SoNaJeRo,2689,0,3,3,6,50.0%,22m
26717,1,[PiGPan]jebuz,2689,74,3,7,10,30.0%,26m
26717,1,[4ekavo]HranitelOka,2689,110,3,9,12,25.0%,57m
26717,1,Graflordalot,2689,0,2,3,5,40.0%,7m
26717,1,pretender,2689,76,2,6,8,25.0%,26m
26717,1,ScanX,2689,96,2,7,9,22.2%,1h
26717,1,[SaloXD]MoNo,2689,0,1,0,1,100.0%,58m
26717,1,Kontures,2689,38,1,2,3,33.3%,7m
26717,3,[TTBBLL]iximini,2689,0,0,2,2,0.0%,1h
26717,2,Alexander,2689,0,0,2,2,0.0%,1h
26739,3,RoyDuck,2688,829,200,189,389,51.4%,12m
26739,1,Omaewamou,2688,860,78,62,140,55.7%,35m
26739,3,Knackwurst,2688,1473,65,56,121,53.7%,13m
26739,1,Taerïn,2688,1197,60,53,113,53.1%,24m
26739,1,[dlps]mTwNoNaMe,2688,500,18,17,35,51.4%,31m
26739,1,[HsDL]StarLord,2688,566,17,17,34,50.0%,53m
26739,1,[NINJ88]ImHbrow,2688,376,16,9,25,64.0%,41m
26739,3,Koïgh,2688,409,14,17,31,45.2%,15m
26739,1,[SSGUK]DalyLaCow,2688,310,12,9,21,57.1%,57m
26739,2,feuille,2688,200,12,9,21,57.1%,15m
26739,1,[ExTr1m]Lite,2688,192,8,3,11,72.7%,22m
26739,1,Wessex,2688,204,8,4,12,66.7%,5m
26739,1,Zatsep,2688,213,7,4,11,63.6%,19m
26739,1,RabbidLesbo,2688,202,7,4,11,63.6%,41m
26739,1,nOskiL,2688,236,7,8,15,46.7%,21m
26739,3,oberfreak,2688,202,7,13,20,35.0%,5m
26739,2,FATE,2688,136,6,7,13,46.2%,19m
26739,1,Mediterranea,2688,156,5,3,8,62.5%,25m
26739,1,BAHR,2688,138,4,4,8,50.0%,60m
26739,1,IIIIIIIIIIII,2688,74,3,3,6,50.0%,24m
26739,1,[ESOT]SuperIorni,2688,76,3,5,8,37.5%,9m
26739,1,[J4E]IHateBugs,2688,120,3,8,11,27.3%,20m
26739,3,Mawpeh,2688,0,2,3,5,40.0%,46m
26739,3,RainTerror,2688,0,2,3,5,40.0%,4m
26739,1,Papayahachi,2688,0,2,3,5,40.0%,60m
26739,1,Orbitalforce,2688,0,1,0,1,100.0%,1h
26739,1,ZergRush,2688,0,1,2,3,33.3%,38m
26739,3,[FtsM]Fantasy,2688,0,0,1,1,0.0%,2m
26739,1,[VGW]Jokerman,2688,0,0,1,1,0.0%,60m
26739,2,kjipt,2688,0,0,1,1,0.0%,58m
26739,1,teli,2688,0,0,4,4,0.0%,20m
26770,1,FLA,2687,1136,301,315,616,48.9%,27m
26770,1,designer,2687,1721,280,256,536,52.2%,1h
26770,3,Vior,2687,1063,79,84,163,48.5%,7m
26770,1,Shadeslayer,2687,850,30,25,55,54.5%,19m
26770,1,clioloko,2687,763,25,24,49,51.0%,7m
26770,3,Eric,2687,300,12,19,31,38.7%,18m
26770,3,HeavenRaven,2687,289,11,11,22,50.0%,25m
26770,2,Lapuh,2687,262,11,14,25,44.0%,25m
26770,3,Booooooooooo,2687,216,9,9,18,50.0%,4m
26770,2,CuunooPlay,2687,132,5,4,9,55.6%,6m
26770,1,warwa,2687,0,4,1,5,80.0%,9m
26770,1,ddoogg,2687,156,4,5,9,44.4%,60m
26770,3,Justdoit,2687,92,4,7,11,36.4%,16m
26770,3,[Heroes]Waddles,2687,0,3,4,7,42.9%,5m
26770,1,Zainali,2687,88,2,4,6,33.3%,41m
26770,1,[THound]CHNO,2687,0,1,0,1,100.0%,35m
26770,1,[HUNNNN]bLACk,2687,89,1,1,2,50.0%,31m
26770,1,vovagator,2687,36,1,3,4,25.0%,35m
26770,1,kras,2687,0,0,1,1,0.0%,57m
26770,1,rocketman,2687,0,0,1,1,0.0%,19m
26770,3,[Hydrа]Kaspiec,2687,0,0,1,1,0.0%,41m
26770,2,Bloodshadow,2687,0,0,2,2,0.0%,1h
26770,1,greenreaper,2687,0,0,2,2,0.0%,53m
26770,1,Linkz,2687,0,0,4,4,0.0%,54m
26794,1,Chayhanshik,2686,1261,81,73,154,52.6%,6m
26794,1,Solorien,2686,954,75,73,148,50.7%,35m
26794,1,Vasser,2686,535,33,24,57,57.9%,22m
26794,1,Phoenix,2686,695,29,26,55,52.7%,31m
26794,1,Kitty,2686,778,26,27,53,49.1%,54m
26794,1,kanrenjiudui,2686,602,23,18,41,56.1%,21m
26794,3,[OVNI]Userwilm,2686,368,16,12,28,57.1%,15m
26794,1,Arminius,2686,530,16,18,34,47.1%,5m
26794,1,Hodggins,2686,427,15,10,25,60.0%,53m
26794,3,[YaGGas]Lvky,2686,260,13,22,35,37.1%,26m
26794,1,[453]EwigerNoob,2686,286,11,11,22,50.0%,27m
26794,1,Plagg,2686,212,7,6,13,53.8%,28m
26794,2,[NGSL]Kubbing,2686,203,6,7,13,46.2%,4m
26794,3,IIIIIIIIIIII,2686,145,4,4,8,50.0%,56m
26794,1,Poof,2686,148,4,5,9,44.4%,59m
26794,1,LoitneR,2686,133,3,2,5,60.0%,22m
26794,1,maksimus,2686,114,3,5,8,37.5%,1h
26794,2,[KAT]Manflik,2686,93,2,0,2,100.0%,60m
26794,1,Ogreg,2686,0,2,3,5,40.0%,32m
26794,1,[Gоld]JEKA,2686,103,2,7,9,22.2%,9m
26794,1,MariahCarrey,2686,0,1,0,1,100.0%,45m
26794,1,SERENITY,2686,0,1,1,2,50.0%,49m
26794,1,ShadowSev,2686,0,1,2,3,33.3%,1h
26794,1,Iridium,2686,38,1,2,3,33.3%,23m
26794,1,Weautus,2686,0,0,1,1,0.0%,7m
26794,1,Praefect,2686,0,0,1,1,0.0%,1h
26794,1,crazycake,2686,0,0,1,1,0.0%,60m
26794,3,xxxLuCkYxxx,2686,0,0,1,1,0.0%,29m
26794,1,SlimX,2686,0,0,5,5,0.0%,43m
26823,3,Predel,2685,1551,88,99,187,47.1%,7m
26823,3,cvtt,2685,1626,86,93,179,48.0%,7m
26823,3,[0tLb0]desruptor,2685,474,27,31,58,46.6%,19m
26823,3,Sambriscø,2685,576,25,23,48,52.1%,19m
26823,1,Nibbler,2685,435,18,10,28,64.3%,47m
26823,2,Benja,2685,350,15,23,38,39.5%,13m
26823,1,Ратимир,2685,294,14,8,22,63.6%,1h
26823,2,ВеселыйБамбу,2685,178,5,3,8,62.5%,60m
26823,1,German,2685,151,5,6,11,45.5%,28m
26823,2,ИмяФамилия,2685,60,5,7,12,41.7%,10m
26823,2,[GTDK]Siwson,2685,209,5,8,13,38.5%,6m
26823,3,[CDPM]Ghenda,2685,79,5,11,16,31.2%,12m
26823,3,Felix,2685,78,4,4,8,50.0%,35m
26823,3,Fede,2685,93,3,5,8,37.5%,14m
26823,1,Ephe,2685,110,3,7,10,30.0%,21m
26823,3,OgreRouge,2685,0,2,3,5,40.0%,50m
26823,1,GIGAVEST,2685,0,2,3,5,40.0%,38m
26823,2,Dennis,2685,92,2,6,8,25.0%,1h
26823,2,ExTZeiKo,2685,0,1,1,2,50.0%,50m
26823,3,FANATdeVigor,2685,0,1,2,3,33.3%,40m
26823,1,Misery,2685,0,0,1,1,0.0%,7m
26823,1,ALREXER,2685,0,0,1,1,0.0%,26m
26823,3,SuperSalade,2685,0,0,2,2,0.0%,3m
26846,1,dreaddad,2684,1703,102,95,197,51.8%,8m
26846,1,SaberRider,2684,1264,55,40,95,57.9%,38m
26846,1,[ЗАКЛАД]Чорт,2684,353,18,18,36,50.0%,1h
26846,1,[VL0rds]VoidMax,2684,408,15,12,27,55.6%,26m
26846,1,Yamborghini,2684,377,13,13,26,50.0%,60m
26846,2,lllllllllll,2684,310,10,26,36,27.8%,10m
26846,1,[AciNoN]Женя,2684,237,9,3,12,75.0%,7m
26846,1,[Boota]Penge,2684,252,8,7,15,53.3%,53m
26846,1,Radio,2684,123,6,4,10,60.0%,47m
26846,1,platzeins,2684,150,5,4,9,55.6%,49m
26846,1,BooZerg,2684,110,4,4,8,50.0%,32m
26846,1,Winger,2684,146,4,5,9,44.4%,40m
26846,3,Crax,2684,97,3,3,6,50.0%,35m
26846,1,HandsomeVlad,2684,70,3,3,6,50.0%,52m
26846,1,XXAdiSS,2684,119,2,1,3,66.7%,33m
26846,1,DemaGorgone,2684,102,2,1,3,66.7%,57m
26846,3,dotse,2684,0,2,3,5,40.0%,57m
26846,1,Merser,2684,0,1,1,2,50.0%,47m
26846,1,FeederCoyote,2684,0,1,2,3,33.3%,1h
26846,1,Arstotzka,2684,0,0,1,1,0.0%,35m
26846,1,Nosfferatu,2684,0,0,1,1,0.0%,34m
26846,1,Фадден,2684,0,0,2,2,0.0%,40m
26868,1,Reneeke,2683,1718,203,188,391,51.9%,3m
26868,1,Joopig,2683,1538,145,135,280,51.8%,4m
26868,1,[KANNAK]Dustkicker,2683,1548,74,71,145,51.0%,44m
26868,1,MasterFireSi,2683,654,26,17,43,60.5%,3m
26868,2,Aks,2683,468,15,28,43,34.9%,15m
26868,1,Duske,2683,356,12,8,20,60.0%,47m
26868,2,Danchu,2683,291,12,13,25,48.0%,26m
26868,1,GrowlSparrow,2683,306,11,13,24,45.8%,20m
26868,1,Echo,2683,188,7,9,16,43.8%,31m
26868,1,DeDoK,2683,124,6,2,8,75.0%,44m
26868,3,Division,2683,58,5,6,11,45.5%,5m
26868,1,[NukeZ]ThAPm,2683,114,4,4,8,50.0%,24m
26868,1,Darkangel,2683,118,4,6,10,40.0%,58m
26868,1,benzer,2683,158,4,9,13,30.8%,21m
26868,1,VocxoD,2683,105,3,0,3,100.0%,1h
26868,1,Snaipaz,2683,56,3,7,10,30.0%,58m
26868,1,Motylia,2683,116,3,8,11,27.3%,43m
26868,3,Mitrudat,2683,120,2,1,3,66.7%,37m
26868,3,WangGun,2683,0,2,3,5,40.0%,37m
26868,1,antonio,2683,0,1,3,4,25.0%,1h
26888,3,DrInfierno,2682,1596,179,167,346,51.7%,12m
26888,3,Diego,2682,1215,88,93,181,48.6%,5m
26888,2,Zvirbulis,2682,1260,69,74,143,48.3%,26m
26888,1,Yanek,2682,1019,38,31,69,55.1%,47m
26888,1,Braune,2682,532,26,11,37,70.3%,43m
26888,1,CrushLP,2682,533,20,14,34,58.8%,34m
26888,1,Antichrist,2682,159,7,3,10,70.0%,50m
26888,1,lathor,2682,199,6,3,9,66.7%,53m
26888,2,Wralith,2682,162,5,6,11,45.5%,38m
26888,1,xNOLifEZerGX,2682,194,5,10,15,33.3%,32m
26888,1,[All]BarbatoR,2682,0,3,3,6,50.0%,19m
26888,1,Padox,2682,36,3,4,7,42.9%,1h
26888,2,TJB,2682,0,3,4,7,42.9%,56m
26888,1,chewy,2682,0,3,6,9,33.3%,51m
26888,3,Webi,2682,97,2,0,2,100.0%,57m
26888,1,[SKR]Aarbaal,2682,38,2,1,3,66.7%,50m
26888,1,[W4SP]Jacechandra,2682,30,2,2,4,50.0%,4m
26888,3,Miinnx,2682,0,2,3,5,40.0%,36m
26888,1,Мильд,2682,42,2,3,5,40.0%,1h
26888,1,iskembeburak,2682,0,2,3,5,40.0%,32m
26888,2,Exile,2682,0,1,5,6,16.7%,46m
26888,1,nakedbear,2682,0,0,1,1,0.0%,31m
26888,3,faza,2682,0,0,1,1,0.0%,29m
26888,1,[Clnm]Faaron,2682,0,0,1,1,0.0%,3m
26888,1,[TFIJ]Fredstar,2682,0,0,1,1,0.0%,34m
26913,1,AirBorne,2681,1631,94,77,171,55.0%,41m
26913,3,ХАН,2681,246,58,50,108,53.7%,16m
26913,3,Rams,2681,547,56,54,110,50.9%,11m
26913,1,Dogma,2681,786,44,41,85,51.8%,40m
26913,1,canelus,2681,764,40,29,69,58.0%,20m
26913,1,AntFromRus,2681,641,27,19,46,58.7%,50m
26913,1,KrabovoeChle,2681,666,22,26,48,45.8%,56m
26913,1,[Cannоn]ZenO,2681,478,19,11,30,63.3%,52m
26913,3,victor,2681,534,19,28,47,40.4%,28m
26913,1,JoeSoul,2681,530,17,18,35,48.6%,44m
26913,1,satta,2681,470,15,15,30,50.0%,46m
26913,1,[ZteZ]awenael,2681,438,13,12,25,52.0%,59m
26913,1,mmi,2681,332,13,14,27,48.1%,19m
26913,3,ilya,2681,297,11,12,23,47.8%,26m
26913,1,Theli,2681,241,7,9,16,43.8%,33m
26913,1,Mudalisk,2681,89,5,2,7,71.4%,31m
26913,1,derKasch,2681,164,5,3,8,62.5%,26m
26913,1,[mtl]DIRTYmasterB,2681,193,5,4,9,55.6%,31m
26913,1,Motza,2681,116,5,5,10,50.0%,42m
26913,1,[Ark]Dariox,2681,100,4,3,7,57.1%,9m
26913,2,DunkanZmey,2681,48,4,6,10,40.0%,1h
26913,1,[MED0ЕD]metil,2681,120,3,5,8,37.5%,49m
26913,1,lmMike,2681,0,2,3,5,40.0%,6m
26913,3,Libik,2681,0,1,0,1,100.0%,1h
26913,3,[Tesese]NinJaDiMs,2681,0,1,2,3,33.3%,35m
26913,1,ElPolloLoco,2681,0,1,3,4,25.0%,3m
26913,1,ArturiStella,2681,0,0,1,1,0.0%,32m
26913,1,STARrussher,2681,0,0,1,1,0.0%,6m
26913,1,Alexanderas,2681,0,0,1,1,0.0%,47m
26913,1,KILLSTAR,2681,0,0,2,2,0.0%,39m
26913,3,[Albion]imzilot,2681,0,0,2,2,0.0%,2m
26913,1,[Ay2]sAmkeY,2681,0,0,3,3,0.0%,19m
26945,3,DiMoN,2680,1478,206,213,419,49.2%,4m
26945,1,[µlµ]vagabond,2680,1595,160,136,296,54.1%,41m
26945,2,Lasermorph,2680,1633,102,80,182,56.0%,60m
26945,3,[StarLg]Monocycle,2680,1472,91,63,154,59.1%,5m
26945,1,[Wick]Elmchen,2680,1290,90,87,177,50.8%,53m
26945,2,MaGmA,2680,820,82,78,160,51.2%,6m
26945,1,Woeha,2680,1532,73,58,131,55.7%,1h
26945,1,Excel,2680,1042,40,33,73,54.8%,1h
26945,1,[Chaven]Qwi,2680,604,34,29,63,54.0%,20m
26945,3,Shiansu,2680,911,34,40,74,45.9%,11m
26945,1,Daddy,2680,668,26,23,49,53.1%,9m
26945,1,stronix,2680,677,22,26,48,45.8%,1h
26945,2,djmaster,2680,482,17,13,30,56.7%,22m
26945,1,LUREKER,2680,402,16,11,27,59.3%,1h
26945,3,VasaZaicev,2680,374,14,12,26,53.8%,9m
26945,2,BitterMango,2680,186,7,18,25,28.0%,26m
26945,1,WatWatInDaBu,2680,172,6,3,9,66.7%,1h
26945,2,Core,2680,179,6,6,12,50.0%,44m
26945,1,Lordik,2680,140,6,8,14,42.9%,6m
26945,1,Mihawk,2680,146,6,9,15,40.0%,51m
26945,1,Kozhakanova,2680,233,6,9,15,40.0%,9m
26945,1,slazy,2680,138,4,2,6,66.7%,33m
26945,1,SHARY,2680,116,4,8,12,33.3%,33m
26945,2,Elenfall,2680,46,2,2,4,50.0%,21m
26945,2,Drakul,2680,0,2,3,5,40.0%,56m
26945,2,LaManoDeDios,2680,0,2,3,5,40.0%,23m
26945,1,edrain,2680,0,1,1,2,50.0%,28m
26945,2,[Kboom]karkarak,2680,30,1,2,3,33.3%,51m
26945,3,[CrX]Munky,2680,0,1,2,3,33.3%,9m
26945,1,[ClDlN]Langeweile,2680,0,1,2,3,33.3%,1h
26945,1,Stylize,2680,0,1,2,3,33.3%,60m
26945,1,LebLebi,2680,40,1,5,6,16.7%,22m
26945,1,KaKaShi,2680,0,0,1,1,0.0%,44m
26945,1,corvusarpa,2680,0,0,1,1,0.0%,1h
26945,1,[NINJ88]Ant,2680,0,0,2,2,0.0%,6m
26980,3,igor,2679,848,59,51,110,53.6%,17m
26980,1,Voodoochilli,2679,1528,55,54,109,50.5%,24m
26980,1,Distrik,2679,1326,48,45,93,51.6%,28m
26980,3,shadow,2679,836,44,55,99,44.4%,5m
26980,1,DEADREAM,2679,868,36,31,67,53.7%,6m
26980,1,GuiZi,2679,326,34,29,63,54.0%,5m
26980,1,MrsPerchiks,2679,638,29,20,49,59.2%,35m
26980,1,Mayo,2679,505,18,17,35,51.4%,31m
26980,3,SleviN,2679,456,16,23,39,41.0%,5m
26980,1,[ǺŁǻşłđ]DEVOSTATOR,2679,380,15,8,23,65.2%,19m
26980,2,МахачКалла,2679,327,13,9,22,59.1%,8m
26980,1,DTMPower,2679,174,7,8,15,46.7%,51m
26980,1,BimBamBude,2679,108,4,4,8,50.0%,53m
26980,1,HAMLET,2679,68,4,5,9,44.4%,44m
26980,1,NeroNex,2679,74,3,3,6,50.0%,32m
26980,2,erictrueno,2679,0,3,4,7,42.9%,57m
26980,1,Jade,2679,48,2,3,5,40.0%,6m
26980,2,Eragon,2679,0,1,0,1,100.0%,57m
26980,2,[NLTN]niko,2679,0,0,1,1,0.0%,57m
26999,1,Demon,2678,1680,147,148,295,49.8%,53m
26999,3,Poseh,2678,1414,63,55,118,53.4%,11m
26999,1,Schlumpf,2678,956,40,42,82,48.8%,4m
26999,2,TheLight,2678,517,25,6,31,80.6%,19m
26999,1,Goralden,2678,470,19,24,43,44.2%,26m
26999,1,Tyll,2678,293,11,12,23,47.8%,19m
26999,3,TerranUnit,2678,312,11,13,24,45.8%,14m
26999,2,KruEv,2678,194,10,12,22,45.5%,4m
26999,1,[Tuning]Tenwors,2678,207,6,7,13,46.2%,59m
26999,3,joel,2678,113,6,9,15,40.0%,11m
26999,1,controlfreak,2678,114,4,7,11,36.4%,20m
26999,3,UrexTheGreat,2678,90,4,14,18,22.2%,26m
26999,3,Wscieklyjez,2678,0,3,4,7,42.9%,26m
26999,1,piotrekpl,2678,0,3,5,8,37.5%,39m
26999,1,[Heroes]gxalpha,2678,120,3,5,8,37.5%,40m
26999,3,Melifor,2678,94,3,8,11,27.3%,13m
26999,3,KingArtas,2678,62,3,9,12,25.0%,7m
26999,2,Devilcos,2678,60,2,1,3,66.7%,27m
26999,1,[IceHus]иван,2678,34,2,1,3,66.7%,24m
26999,3,Conhil,2678,0,2,3,5,40.0%,1h
26999,3,Markcq,2678,0,2,3,5,40.0%,55m
26999,2,ben,2678,0,2,3,5,40.0%,50m
26999,3,ScriptorisVI,2678,0,2,4,6,33.3%,1h
26999,1,Revi,2678,78,2,4,6,33.3%,50m
26999,3,BABUSHKA,2678,0,2,4,6,33.3%,1h
26999,2,NeCroBox,2678,0,1,0,1,100.0%,1h
26999,2,iTzNephtys,2678,0,1,0,1,100.0%,21m
26999,2,Aquin,2678,32,1,1,2,50.0%,39m
26999,2,PotzBlitzzz,2678,0,0,1,1,0.0%,56m
26999,2,[ДД]Слива,2678,0,0,1,1,0.0%,43m
26999,2,ExSeaD,2678,0,0,1,1,0.0%,19m
26999,1,Tropiņš,2678,0,0,2,2,0.0%,26m
26999,1,[SV49]VfB,2678,0,0,2,2,0.0%,50m
27032,1,IIIIIIIIIIII,2677,1681,249,236,485,51.3%,47m
27032,1,Jankoic,2677,1259,95,80,175,54.3%,53m
27032,1,aratap,2677,1645,64,59,123,52.0%,32m
27032,3,Jerome,2677,1563,60,67,127,47.2%,18m
27032,1,Bachus,2677,1231,52,39,91,57.1%,58m
27032,1,MaNNeQuN,2677,1033,42,44,86,48.8%,59m
27032,3,taren,2677,874,40,33,73,54.8%,12m
27032,1,PAPA,2677,275,38,27,65,58.5%,53m
27032,1,Vitalferox,2677,601,25,17,42,59.5%,1h
27032,1,Clank,2677,565,18,21,39,46.2%,32m
27032,1,slomaa,2677,290,13,6,19,68.4%,1h
27032,3,Starkiller,2677,267,10,13,23,43.5%,8m
27032,1,prankroker,2677,146,7,5,12,58.3%,1h
27032,1,Agony,2677,170,6,5,11,54.5%,42m
27032,3,Jaipastor,2677,177,6,8,14,42.9%,3m
27032,1,Zoza,2677,151,5,2,7,71.4%,27m
27032,3,olm,2677,97,3,3,6,50.0%,3m
27032,2,LeChove,2677,112,3,4,7,42.9%,60m
27032,2,Torenkiller,2677,0,2,3,5,40.0%,60m
27032,2,Kuplinyaha,2677,0,2,3,5,40.0%,46m
27032,2,ihshadow,2677,0,2,3,5,40.0%,7m
27032,1,PIkaweird,2677,40,2,4,6,33.3%,5m
27032,2,timoxa,2677,73,1,1,2,50.0%,3m
27032,2,JuzoFA,2677,0,1,1,2,50.0%,23m
27032,2,[TFS1]Googleplex,2677,34,1,2,3,33.3%,1h
27032,3,Cookie,2677,0,1,4,5,20.0%,34m
27032,2,[SCTM]Jojje,2677,0,0,1,1,0.0%,46m
27032,3,Wolfie,2677,0,0,1,1,0.0%,21m
27032,1,megauntouch,2677,0,0,2,2,0.0%,27m
27061,1,VincentDaddy,2676,1506,95,91,186,51.1%,7m
27061,3,SEǂPich,2676,594,40,46,86,46.5%,16m
27061,3,Benen,2676,903,33,47,80,41.2%,3m
27061,1,mnem,2676,500,23,13,36,63.9%,9m
27061,3,tomwodcke,2676,318,20,22,42,47.6%,16m
27061,1,GukiKOkd,2676,360,17,8,25,68.0%,19m
27061,3,Zaval,2676,352,12,21,33,36.4%,9m
27061,1,Matt,2676,237,11,9,20,55.0%,45m
27061,1,Max,2676,303,10,9,19,52.6%,49m
27061,1,Performer,2676,230,10,9,19,52.6%,1h
27061,1,Colourblind,2676,386,10,15,25,40.0%,42m
27061,3,Formanden,2676,270,9,7,16,56.2%,49m
27061,1,naorat,2676,247,9,7,16,56.2%,1h
27061,3,alexRF,2676,269,9,16,25,36.0%,10m
27061,1,DonProm,2676,218,7,9,16,43.8%,56m
27061,1,UABart,2676,246,6,3,9,66.7%,51m
27061,3,SgtMono,2676,131,6,5,11,54.5%,25m
27061,1,mihaisan,2676,165,6,8,14,42.9%,5m
27061,2,[2Ta]FredoMercure,2676,140,4,0,4,100.0%,46m
27061,1,barbar,2676,122,3,2,5,60.0%,53m
27061,2,Angel,2676,95,3,4,7,42.9%,53m
27061,2,[BiFeld]Tesa,2676,114,3,5,8,37.5%,22m
27061,2,DecubituS,2676,96,2,2,4,50.0%,46m
27061,3,zucoF,2676,0,2,3,5,40.0%,47m
27061,2,EvoError,2676,0,2,3,5,40.0%,38m
27061,2,GhostSC,2676,0,1,0,1,100.0%,56m
27061,2,ЧёрныйКот,2676,0,0,1,1,0.0%,36m
27061,1,[UFOZ]MartyMcFly,2676,0,0,2,2,0.0%,6m
27089,2,hulava,2675,1502,194,198,392,49.5%,13m
27089,2,PISO,2675,1177,90,82,172,52.3%,1h
27089,1,Chakakazull,2675,784,62,45,107,57.9%,35m
27089,1,Zatarra,2675,886,30,32,62,48.4%,1h
27089,2,[krdo]Soulseeker,2675,532,22,11,33,66.7%,55m
27089,1,GriffeXe,2675,599,22,21,43,51.2%,7m
27089,3,Hjarl,2675,468,18,23,41,43.9%,6m
27089,1,manarok,2675,321,15,5,20,75.0%,27m
27089,1,packy,2675,188,6,4,10,60.0%,35m
27089,1,[Grunt]Medmex,2675,136,6,7,13,46.2%,44m
27089,1,FutyTurtle,2675,186,5,4,9,55.6%,53m
27089,2,[palats]Catweazle,2675,0,4,1,5,80.0%,46m
27089,3,Herodotus,2675,0,4,2,6,66.7%,37m
27089,2,[isMVP]TerranImba,2675,143,4,5,9,44.4%,60m
27089,3,Snake,2675,0,3,2,5,60.0%,3m
27089,2,[BRRR]Skandibal,2675,30,3,3,6,50.0%,60m
27089,2,Vladdd,2675,94,3,4,7,42.9%,1h
27089,2,Kuab,2675,0,3,4,7,42.9%,57m
27089,2,Zluglu,2675,0,2,3,5,40.0%,9m
27089,2,[OBT]daska,2675,0,1,0,1,100.0%,4m
27089,2,Fyodor,2675,0,1,0,1,100.0%,39m
27089,2,BaggyPicsou,2675,0,1,0,1,100.0%,39m
27089,3,[MoscH]Squirrely,2675,30,1,4,5,20.0%,21m
27089,2,ZEUS,2675,0,1,4,5,20.0%,1h
27089,1,[yiddo]Eiron,2675,0,0,2,2,0.0%,1h
27114,3,Konti,2674,1461,75,74,149,50.3%,11m
27114,1,ZZZergling,2674,245,21,11,32,65.6%,21m
27114,3,Dody,2674,324,20,17,37,54.1%,4m
27114,2,SiMulat,2674,399,16,4,20,80.0%,35m
27114,2,SiteTech,2674,348,11,25,36,30.6%,26m
27114,2,Rami,2674,250,10,15,25,40.0%,19m
27114,2,Fujibananas,2674,281,10,18,28,35.7%,1h
27114,1,[CROCHI]Доминатор,2674,229,7,5,12,58.3%,1h
27114,1,CyTaylor,2674,247,7,7,14,50.0%,31m
27114,1,[FaPe]faceless,2674,184,6,6,12,50.0%,39m
27114,2,[RUS78]cccP,2674,166,5,7,12,41.7%,46m
27114,1,[CVK]Ravened,2674,104,4,5,9,44.4%,42m
27114,1,Stonehart,2674,97,4,6,10,40.0%,1h
27114,1,abishell,2674,118,4,7,11,36.4%,6m
27114,1,Kneggge,2674,40,3,5,8,37.5%,52m
27114,2,demon,2674,30,2,0,2,100.0%,1h
27114,2,Stugazz,2674,0,2,3,5,40.0%,19m
27114,3,[TDRUS]PhonkOneLove,2674,0,2,3,5,40.0%,56m
27114,2,[LAGY]Ashiku,2674,30,1,1,2,50.0%,39m
27114,2,Mamon,2674,0,0,1,1,0.0%,5m
27134,3,yspdnl,2673,1580,182,173,355,51.3%,3m
27134,1,[WZ1]Ray,2673,1684,145,146,291,49.8%,59m
27134,1,Terp,2673,1625,80,68,148,54.1%,21m
27134,3,[ННД]Zodiac,2673,659,62,62,124,50.0%,25m
27134,1,MVPǂVertti,2673,982,53,46,99,53.5%,60m
27134,2,Varifikator,2673,757,29,22,51,56.9%,8m
27134,1,[Bruk]Oheron,2673,371,15,18,33,45.5%,49m
27134,2,Arbiter,2673,379,14,8,22,63.6%,1h
27134,3,Anubis,2673,242,12,11,23,52.2%,18m
27134,1,Darth,2673,315,11,18,29,37.9%,4m
27134,1,TheChosenOne,2673,178,7,6,13,53.8%,52m
27134,2,Paxan,2673,158,5,1,6,83.3%,35m
27134,2,[RMM]SuperStein,2673,184,5,6,11,45.5%,1h
27134,2,[QTcIub]Robotopia,2673,120,4,2,6,66.7%,46m
27134,3,CWarlike,2673,94,4,5,9,44.4%,9m
27134,3,[IGSq]Wolverine,2673,0,3,2,5,60.0%,1h
27134,3,[5Cary]Anonymous,2673,0,3,3,6,50.0%,40m
27134,2,Толяныч,2673,30,2,0,2,100.0%,1h
27134,3,[CrøkeT]ElClebard,2673,0,2,3,5,40.0%,1h
27134,3,[VoiDTS]Elytra,2673,0,2,4,6,33.3%,1h
27134,2,Zerglou,2673,30,1,1,2,50.0%,59m
27134,1,DANTE,2673,89,1,2,3,33.3%,42m
27134,3,Willem,2673,0,0,1,1,0.0%,41m
27134,2,dub,2673,0,0,1,1,0.0%,1h
27134,1,Logan,2673,0,0,1,1,0.0%,21m
27134,2,[SSC2]SidXRam,2673,0,0,1,1,0.0%,19m
27134,1,LiquidWay,2673,0,0,2,2,0.0%,28m
27134,1,[H1]Leris,2673,0,0,3,3,0.0%,5m
27162,1,АтакаЗомбят,2672,1573,95,87,182,52.2%,41m
27162,1,Bubuloo,2672,981,78,66,144,54.2%,39m
27162,1,StuckLogo,2672,906,55,41,96,57.3%,39m
27162,1,Anarki,2672,515,23,20,43,53.5%,45m
27162,1,GrayBrush,2672,463,18,18,36,50.0%,1h
27162,1,Георгий,2672,347,15,14,29,51.7%,49m
27162,1,[Baduk]Sam,2672,347,12,8,20,60.0%,56m
27162,1,Greedylax,2672,323,12,12,24,50.0%,31m
27162,3,[HZeS]nicci,2672,229,11,8,19,57.9%,11m
27162,1,[КПCC]Андрей,2672,285,10,9,19,52.6%,35m
27162,1,[PR0uT]MartyMcFight,2672,328,9,12,21,42.9%,20m
27162,3,SmoothDigger,2672,215,8,10,18,44.4%,5m
27162,1,[2D2Д]Chan,2672,228,7,7,14,50.0%,32m
27162,2,[UmU]grudu,2672,122,7,10,17,41.2%,14m
27162,1,Szymli,2672,145,6,3,9,66.7%,31m
27162,2,Jimbo,2672,156,5,0,5,100.0%,33m
27162,2,Halatlan,2672,114,4,5,9,44.4%,49m
27162,2,steflabise,2672,88,4,5,9,44.4%,26m
27162,3,[CJFF]EgorDark,2672,93,3,5,8,37.5%,16m
27162,1,[oAOPo]Reblochon,2672,115,2,3,5,40.0%,60m
27162,3,GEGTturbo,2672,0,2,4,6,33.3%,38m
27162,2,[BAPEN]INnoVation,2672,30,1,1,2,50.0%,8m
27162,1,[MMRis]ArchonDrops,2672,38,1,3,4,25.0%,1h
27162,3,Sasanarx,2672,0,1,4,5,20.0%,2m
27162,2,CHACAL,2672,0,0,1,1,0.0%,24m
27162,2,sevotar,2672,0,0,1,1,0.0%,43m
27162,2,KRULES,2672,0,0,1,1,0.0%,41m
27162,1,andyk,2672,0,0,2,2,0.0%,5m
27190,2,[Балаче]Tzvetnia,2671,1150,53,45,98,54.1%,3m
27190,2,LarvePlanete,2671,835,48,41,89,53.9%,51m
27190,1,noza,2671,806,35,25,60,58.3%,41m
27190,2,Carls,2671,90,21,27,48,43.8%,18m
27190,2,KerriganSara,2671,308,10,24,34,29.4%,4m
27190,1,[J4E]Sorcerer,2671,298,9,10,19,47.4%,47m
27190,3,Clutter,2671,159,7,7,14,50.0%,19m
27190,2,Tasher,2671,225,6,3,9,66.7%,10m
27190,2,AarOraA,2671,182,6,11,17,35.3%,13m
27190,3,nikolai,2671,182,6,15,21,28.6%,10m
27190,1,Edembop,2671,148,4,7,11,36.4%,26m
27190,2,Argus,2671,92,3,1,4,75.0%,55m
27190,2,kviat,2671,90,3,2,5,60.0%,54m
27190,1,[SBTO]Tombstone,2671,89,2,1,3,66.7%,59m
27190,1,[InitRu]scorpion,2671,123,2,3,5,40.0%,58m
27190,1,[PLA2N]Medvedev,2671,74,2,4,6,33.3%,26m
27190,1,llllllllllll,2671,76,2,7,9,22.2%,19m
27190,3,Smirky,2671,0,1,0,1,100.0%,1h
27190,1,Shifting,2671,36,1,7,8,12.5%,19m
27190,2,ForeverNoob,2671,0,0,1,1,0.0%,7m
27190,3,knockyou,2671,0,0,1,1,0.0%,47m
27190,1,[ЗЕRGТV]LordGodzill,2671,0,0,2,2,0.0%,31m
27212,1,Nertond,2670,1178,74,74,148,50.0%,47m
27212,3,VertRum,2670,1315,58,52,110,52.7%,2m
27212,1,iLoveProtoss,2670,661,29,15,44,65.9%,60m
27212,1,[z666z]MakeMyWeapon,2670,608,21,16,37,56.8%,34m
27212,1,Gendernator,2670,694,21,20,41,51.2%,9m
27212,1,[Skaro]Lokisglut,2670,403,16,11,27,59.3%,41m
27212,1,FunkyPants,2670,408,16,16,32,50.0%,58m
27212,3,Primarch,2670,370,12,22,34,35.3%,5m
27212,1,Squid,2670,368,10,10,20,50.0%,35m
27212,1,kronk,2670,144,5,5,10,50.0%,59m
27212,1,[НОД17]DonWin,2670,48,4,6,10,40.0%,50m
27212,3,SpookyeManRO,2670,30,2,9,11,18.2%,13m
27212,2,Geaeen,2670,0,1,0,1,100.0%,46m
27212,2,[LIQUID]IgorZ,2670,0,1,0,1,100.0%,32m
27212,2,DimaBorsch,2670,0,1,0,1,100.0%,23m
27212,1,[SCWEED]ragingfire,2670,0,1,1,2,50.0%,57m
27212,3,Tyrael,2670,40,1,2,3,33.3%,32m
27212,2,voidray,2670,0,1,2,3,33.3%,8m
27212,3,Anistrix,2670,0,1,3,4,25.0%,21m
27212,3,dzpak,2670,30,1,5,6,16.7%,19m
27232,1,Marik,2669,1608,182,183,365,49.9%,49m
27232,3,[GOOOG]Bluerage,2669,1228,67,72,139,48.2%,11m
27232,1,Klarre,2669,659,55,56,111,49.5%,59m
27232,3,Treadstoun,2669,1043,40,41,81,49.4%,2m
27232,2,kelthor,2669,544,24,15,39,61.5%,1h
27232,1,[EXOS]Kgeri,2669,668,21,22,43,48.8%,57m
27232,1,Dreadcrumb,2669,276,9,9,18,50.0%,7m
27232,1,KAeL,2669,210,8,8,16,50.0%,32m
27232,1,RydeR,2669,280,8,10,18,44.4%,1h
27232,2,[DOBE]Recondite,2669,216,6,4,10,60.0%,24m
27232,1,joesl,2669,195,4,5,9,44.4%,1h
27232,1,Lunár,2669,191,4,11,15,26.7%,1h
27232,2,SEǂLussy,2669,62,3,0,3,100.0%,1h
27232,2,GerSer,2669,140,3,3,6,50.0%,1h
27232,2,Эрвик,2669,0,2,2,4,50.0%,50m
27232,2,дуд,2669,0,2,3,5,40.0%,2m
27232,3,AndreiSirop,2669,0,2,3,5,40.0%,24m
27232,3,ihearcolors,2669,0,2,3,5,40.0%,43m
27232,3,[JG]BLadeZ,2669,0,1,0,1,100.0%,35m
27232,3,SpArk,2669,0,0,1,1,0.0%,55m
27232,1,Armagedon,2669,0,0,3,3,0.0%,1h
27253,3,volk,2668,1574,238,235,473,50.3%,5m
27253,3,Dannerg,2668,1576,113,103,216,52.3%,4m
27253,3,ineedajob,2668,1308,74,81,155,47.7%,12m
27253,3,BOmmeLpetEr,2668,970,36,43,79,45.6%,6m
27253,1,[nopvp]nopvp,2668,571,27,11,38,71.1%,23m
27253,2,[IOT]Grytulf,2668,419,16,16,32,50.0%,19m
27253,1,kubalonek,2668,319,15,11,26,57.7%,47m
27253,3,Skubi,2668,365,15,17,32,46.9%,14m
27253,1,xhi,2668,279,14,10,24,58.3%,1h
27253,1,Mashiro,2668,153,6,8,14,42.9%,45m
27253,1,[Shr3Kd]MeNeSbatto,2668,142,5,2,7,71.4%,42m
27253,2,Bibka,2668,150,5,3,8,62.5%,8m
27253,2,Emperor,2668,115,4,4,8,50.0%,1h
27253,2,БабаБулочник,2668,58,3,0,3,100.0%,47m
27253,1,Harokku,2668,36,2,2,4,50.0%,10m
27253,3,[DpbUtd]FunkyZzy,2668,0,2,3,5,40.0%,57m
27253,3,[O4FUN]Cyngiel,2668,0,2,3,5,40.0%,20m
27253,2,Serdnix,2668,0,2,3,5,40.0%,29m
27253,2,Tarnilas,2668,0,1,0,1,100.0%,54m
27253,2,[JaPP]XachApuri,2668,0,1,0,1,100.0%,24m
27253,1,MRX,2668,0,1,2,3,33.3%,31m
27253,1,[Bbatal]PODIMONISSE,2668,96,1,2,3,33.3%,32m
27253,1,nir,2668,0,1,3,4,25.0%,48m
27253,3,Ivar,2668,0,1,7,8,12.5%,12m
27253,1,Eizi,2668,0,0,2,2,0.0%,53m
27253,1,[ТобиПИ]Phantom,2668,0,0,4,4,0.0%,9m
27279,1,Julfli,2667,1586,85,76,161,52.8%,50m
27279,1,Lazyturtle,2667,1579,60,60,120,50.0%,38m
27279,1,Falcon,2667,1296,52,44,96,54.2%,3m
27279,3,[BYTCA]pit,2667,1185,47,47,94,50.0%,10m
27279,1,WeltallAlpha,2667,324,33,21,54,61.1%,44m
27279,2,Theleil,2667,727,27,23,50,54.0%,6m
27279,1,TheDude,2667,454,18,16,34,52.9%,1h
27279,2,grappa,2667,271,12,9,21,57.1%,60m
27279,3,Mergeniy,2667,212,10,11,21,47.6%,11m
27279,1,Akmanah,2667,318,9,7,16,56.2%,56m
27279,1,ptolingio,2667,276,9,8,17,52.9%,1h
27279,1,AbramYkt,2667,158,7,5,12,58.3%,35m
27279,2,Rain,2667,144,5,4,9,55.6%,60m
27279,1,vash,2667,231,5,6,11,45.5%,42m
27279,2,Hardy,2667,58,2,1,3,66.7%,56m
27279,3,DIMKO,2667,62,2,10,12,16.7%,11m
27279,3,[zCCCPz]artyom,2667,0,1,0,1,100.0%,57m
27279,2,Avgustin,2667,46,1,5,6,16.7%,55m
27279,2,KleptoZ,2667,0,0,1,1,0.0%,30m
27279,2,StormzBG,2667,0,0,1,1,0.0%,29m
27279,2,Vossi,2667,0,0,1,1,0.0%,39m
27279,2,[Sages]SPLAT,2667,0,0,3,3,0.0%,1h
27301,3,Rimas,2666,1174,113,111,224,50.4%,9m
27301,1,marcino,2666,1643,103,91,194,53.1%,31m
27301,1,Fenixfallen,2666,504,44,41,85,51.8%,59m
27301,1,ALXfire,2666,965,34,29,63,54.0%,5m
27301,3,DEMOBAZA,2666,771,28,34,62,45.2%,12m
27301,1,Enigma,2666,203,24,14,38,63.2%,25m
27301,1,[MISTO]Beacon,2666,335,24,20,44,54.5%,47m
27301,2,[ReDeLe]Rubi,2666,474,19,18,37,51.4%,8m
27301,3,LaFrYp,2666,483,18,17,35,51.4%,26m
27301,1,Retromen,2666,395,17,15,32,53.1%,60m
27301,1,DrPineapple,2666,420,14,16,30,46.7%,42m
27301,3,cfif,2666,392,12,17,29,41.4%,18m
27301,1,Докеби,2666,237,8,6,14,57.1%,54m
27301,1,Замес,2666,168,6,1,7,85.7%,51m
27301,2,Torvic,2666,58,4,4,8,50.0%,56m
27301,3,Тарас,2666,126,4,4,8,50.0%,6m
27301,1,[LGO123]sqwale,2666,142,4,6,10,40.0%,1h
27301,1,KingBabylon,2666,139,3,3,6,50.0%,35m
27301,3,ПАН,2666,0,2,3,5,40.0%,6m
27301,3,XeNo,2666,97,2,4,6,33.3%,29m
27301,1,RoJoBa,2666,0,2,4,6,33.3%,3m
27301,1,Kukas,2666,40,2,4,6,33.3%,1h
27301,1,[Maciu]Smesca,2666,80,2,7,9,22.2%,45m
27301,2,[013NL]Riffdoctor,2666,0,1,0,1,100.0%,1h
27301,2,DyRZylG,2666,0,1,0,1,100.0%,1h
27301,2,dpd,2666,0,1,2,3,33.3%,58m
27301,1,[Poher]MrDen,2666,73,1,5,6,16.7%,26m
27301,1,MiTiaY,2666,0,0,4,4,0.0%,1h
27329,1,WelcomtoHell,2665,898,39,27,66,59.1%,10m
27329,3,Bronsted,2665,470,16,21,37,43.2%,18m
27329,1,[Liu]Krotian,2665,289,13,7,20,65.0%,23m
27329,3,[HTRK]Bootmonkey,2665,330,13,17,30,43.3%,7m
27329,1,Magus,2665,323,10,8,18,55.6%,35m
27329,1,STETHAM,2665,300,9,13,22,40.9%,6m
27329,1,kostyakyn,2665,241,8,8,16,50.0%,27m
27329,1,Highlydodgy,2665,266,8,10,18,44.4%,59m
27329,2,Injouable,2665,138,5,5,10,50.0%,39m
27329,1,nijwons,2665,150,5,8,13,38.5%,57m
27329,1,YamahaFazer,2665,198,5,9,14,35.7%,1h
27329,1,PlzStop,2665,66,4,5,9,44.4%,60m
27329,1,[DOKA2]ButterflyMuM,2665,193,3,7,10,30.0%,1h
27329,2,[RuHuCo]KeD,2665,30,2,0,2,100.0%,8m
27329,3,TheBS,2665,0,2,3,5,40.0%,34m
27329,3,Dunq,2665,0,2,3,5,40.0%,10m
27329,2,saxplayer,2665,0,2,3,5,40.0%,39m
27329,2,[PsyML]OutOfControl,2665,0,2,5,7,28.6%,23m
27329,1,Maximums,2665,40,1,4,5,20.0%,1h
27348,1,luchito,2664,1605,179,178,357,50.1%,42m
27348,1,Vixi,2664,1090,57,58,115,49.6%,45m
27348,1,XRareshRO,2664,475,29,14,43,67.4%,42m
27348,2,Hatrun,2664,501,22,16,38,57.9%,51m
27348,1,DarkTRade,2664,617,18,19,37,48.6%,48m
27348,2,Zergamoto,2664,420,14,12,26,53.8%,51m
27348,1,Hristo,2664,468,14,16,30,46.7%,3m
27348,3,OBrother,2664,340,12,10,22,54.5%,47m
27348,1,willyk,2664,316,10,11,21,47.6%,5m
27348,1,ScRiM,2664,248,10,12,22,45.5%,20m
27348,1,Shingeen,2664,206,7,7,14,50.0%,34m
27348,2,HEAT,2664,96,4,4,8,50.0%,1h
27348,3,Rainlainz,2664,0,2,3,5,40.0%,3m
27348,1,GrafSpee,2664,74,2,5,7,28.6%,42m
27348,1,kivvi,2664,0,1,1,2,50.0%,41m
27348,1,Nigg,2664,0,1,1,2,50.0%,32m
27348,2,[xPVx]prahlad,2664,0,1,3,4,25.0%,2m
27365,1,[UGZrg]Tundr,2663,1453,92,90,182,50.5%,47m
27365,1,Tschesus,2663,1409,78,71,149,52.3%,60m
27365,3,vaska,2663,886,33,42,75,44.0%,25m
27365,2,[iSAR]Humble,2663,476,17,11,28,60.7%,7m
27365,1,KalAzaar,2663,329,12,15,27,44.4%,1h
27365,3,[VZON]Frisk,2663,344,12,17,29,41.4%,10m
27365,3,Addraer,2663,292,8,15,23,34.8%,14m
27365,1,paolo,2663,272,7,10,17,41.2%,3m
27365,3,Highrope,2663,157,7,15,22,31.8%,6m
27365,1,ChowChow,2663,88,6,1,7,85.7%,32m
27365,1,[1UpBHV]Mikrolisk,2663,241,6,7,13,46.2%,1h
27365,2,Mors,2663,88,6,8,14,42.9%,11m
27365,1,[RZMS]FoxxxSide,2663,150,5,6,11,45.5%,54m
27365,2,Cyckołapacz,2663,118,4,5,9,44.4%,51m
27365,3,ziemek,2663,42,3,4,7,42.9%,50m
27365,3,UnknownHero,2663,97,2,2,4,50.0%,1h
27365,3,[GRNS]Helkazzan,2663,0,2,3,5,40.0%,1h
27365,3,DarkRider,2663,0,2,4,6,33.3%,21m
27365,3,vidar,2663,0,2,5,7,28.6%,1h
27365,1,ichich,2663,82,2,8,10,20.0%,54m
27365,2,Andcol,2663,0,1,0,1,100.0%,60m
27365,2,Kreur,2663,0,1,0,1,100.0%,22m
27365,1,Technology,2663,0,1,1,2,50.0%,1h
27365,2,дихака,2663,0,1,2,3,33.3%,24m
27365,1,[Pub77]Pub,2663,0,1,4,5,20.0%,59m
27365,2,zandR,2663,0,1,4,5,20.0%,36m
27365,2,EndNool,2663,0,1,4,5,20.0%,35m
27365,1,RanRafi,2663,0,1,5,6,16.7%,5m
27365,3,Volta,2663,30,1,9,10,10.0%,18m
27365,2,DrAybolit,2663,0,0,1,1,0.0%,4m
27365,2,RoodI,2663,0,0,1,1,0.0%,51m
27365,2,heeranz,2663,0,0,1,1,0.0%,1h
27365,1,[HtBt]Gooks,2663,0,0,2,2,0.0%,9m
27365,3,Beisi,2663,0,0,3,3,0.0%,18m
27365,1,Shorty,2663,0,0,4,4,0.0%,9m
27400,1,[NuF]Umbra,2662,1557,89,80,169,52.7%,50m
27400,3,[atsh]snikaz,2662,1569,85,94,179,47.5%,12m
27400,1,meliodos,2662,1327,77,63,140,55.0%,28m
27400,1,Pileofshiit,2662,1376,47,53,100,47.0%,60m
27400,1,kirkannos,2662,1112,43,35,78,55.1%,28m
27400,3,Andrew,2662,715,24,31,55,43.6%,10m
27400,3,Screamua,2662,461,16,18,34,47.1%,25m
27400,2,Buba,2662,327,13,8,21,61.9%,35m
27400,2,Stefanka,2662,285,11,11,22,50.0%,2m
27400,3,[RsTb]kid,2662,268,11,13,24,45.8%,5m
27400,3,TheSpurge,2662,233,10,11,21,47.6%,13m
27400,1,Ansvider,2662,213,7,7,14,50.0%,25m
27400,3,MaadA,2662,228,7,13,20,35.0%,12m
27400,2,Mddj,2662,160,5,2,7,71.4%,25m
27400,1,Sirin,2662,153,5,3,8,62.5%,53m
27400,3,[KenX]Nekooonya,2662,60,5,7,12,41.7%,5m
27400,1,Vukota,2662,149,4,4,8,50.0%,1h
27400,2,SarahRosely,2662,96,4,11,15,26.7%,50m
27400,2,[Gionny]Kesh,2662,95,2,1,3,66.7%,8m
27400,3,GWolfenG,2662,0,2,3,5,40.0%,53m
27400,1,ЯзлоеДерево,2662,40,1,5,6,16.7%,27m
27400,1,klinik,2662,0,0,3,3,0.0%,48m
27422,3,Mycon,2661,1518,161,159,320,50.3%,3m
27422,1,alnvra,2661,1674,100,89,189,52.9%,10m
27422,1,Roggan,2661,1304,80,71,151,53.0%,31m
27422,1,Masyanya,2661,1051,43,32,75,57.3%,42m
27422,3,Nacho,2661,502,18,23,41,43.9%,10m
27422,3,saso,2661,433,15,27,42,35.7%,11m
27422,3,MRAVKATA,2661,355,14,10,24,58.3%,22m
27422,1,WaitWhat,2661,300,10,7,17,58.8%,39m
27422,3,Eriak,2661,111,9,10,19,47.4%,41m
27422,2,Nasty,2661,60,5,9,14,35.7%,3m
27422,1,[SaviOr]Storm,2661,112,4,7,11,36.4%,42m
27422,1,Beavman,2661,90,3,4,7,42.9%,3m
27422,1,HoYaGa,2661,120,3,9,12,25.0%,25m
27422,2,Nimrod,2661,0,2,3,5,40.0%,24m
27422,2,Nikitka,2661,0,1,0,1,100.0%,37m
27422,1,[WL706]WOLF,2661,0,1,1,2,50.0%,32m
27422,2,zEd,2661,93,1,1,2,50.0%,39m
27422,2,ben,2661,44,1,5,6,16.7%,32m
27422,2,MasterRalll,2661,0,0,1,1,0.0%,60m
27441,3,[Eyes]CEO,2660,1621,178,179,357,49.9%,14m
27441,1,Gandalf,2660,712,156,150,306,51.0%,32m
27441,1,Laggg,2660,1683,94,91,185,50.8%,22m
27441,3,ВАСЯ,2660,1147,59,61,120,49.2%,17m
27441,2,Mrjugg,2660,866,52,38,90,57.8%,60m
27441,3,rubbishskata,2660,546,25,23,48,52.1%,5m
27441,2,bronzy,2660,648,23,31,54,42.6%,6m
27441,1,Sanguinius,2660,172,8,5,13,61.5%,31m
27441,1,[TeeT]Fire,2660,165,8,8,16,50.0%,25m
27441,2,Bobart,2660,238,7,8,15,46.7%,57m
27441,3,Kamu,2660,232,7,9,16,43.8%,36m
27441,3,Toto,2660,86,6,9,15,40.0%,21m
27441,1,Atreides,2660,0,5,5,10,50.0%,7m
27441,3,Torr,2660,30,4,5,9,44.4%,4m
27441,1,Zarattul,2660,74,3,3,6,50.0%,10m
27441,2,Lycus,2660,0,3,4,7,42.9%,4m
27441,2,RexOmnium,2660,88,2,0,2,100.0%,54m
27441,1,[xxBSxx]KaptenKaki,2660,90,2,2,4,50.0%,3m
27441,2,Xarchok,2660,30,1,1,2,50.0%,19m
27441,1,Akai,2660,0,1,2,3,33.3%,35m
27441,1,Rokas,2660,0,1,2,3,33.3%,7m
27441,1,Svone,2660,0,1,3,4,25.0%,9m
27441,1,TOXA,2660,0,0,2,2,0.0%,32m
27464,2,YART,2659,1528,122,123,245,49.8%,10m
27464,3,Varatharg,2659,1269,108,106,214,50.5%,17m
27464,3,Lazyturtle,2659,1568,102,105,207,49.3%,4m
27464,1,[HHOTS]ThePolletor,2659,652,72,67,139,51.8%,6m
27464,1,Oozi,2659,761,40,37,77,51.9%,3m
27464,3,Hrust,2659,573,26,32,58,44.8%,19m
27464,1,Gemmer,2659,424,20,12,32,62.5%,42m
27464,2,[SPAINs]jOseLiTorZ,2659,250,8,4,12,66.7%,21m
27464,2,Polikarpov,2659,94,4,0,4,100.0%,52m
27464,3,[RuRø]Cornex,2659,0,3,2,5,60.0%,6m
27464,3,argewolen,2659,0,3,4,7,42.9%,19m
27464,1,Big,2659,108,3,8,11,27.3%,26m
27464,1,[OPMFS]mmbb,2659,0,1,0,1,100.0%,8m
27464,1,Casquero,2659,0,1,1,2,50.0%,50m
27464,1,ssjwolf,2659,89,1,2,3,33.3%,26m
27464,1,[P0W3RD]Adolphus,2659,34,1,5,6,16.7%,31m
27464,3,[WOODYS]Shuuichi,2659,19,1,8,9,11.1%,28m
27464,3,[дошик]ВертуалСопля,2659,0,0,1,1,0.0%,1h
27464,2,Patriks,2659,0,0,1,1,0.0%,22m
27464,2,[Юнион]Gucci,2659,0,0,2,2,0.0%,35m
27464,1,HydraDen,2659,0,0,2,2,0.0%,42m
27464,2,KerRayNis,2659,0,0,2,2,0.0%,55m
27486,3,contenance,2658,1365,340,342,682,49.9%,25m
27486,3,Emperor,2658,1568,281,283,564,49.8%,2m
27486,3,Astar,2658,443,72,80,152,47.4%,19m
27486,1,Jey,2658,387,34,21,55,61.8%,27m
27486,1,Crystalize,2658,581,25,20,45,55.6%,33m
27486,1,fipsgg,2658,620,24,26,50,48.0%,20m
27486,1,[ABOMB]FatMan,2658,524,15,21,36,41.7%,25m
27486,3,[MwP]AlphaMax,2658,341,13,17,30,43.3%,10m
27486,1,JimmyRacheta,2658,302,9,12,21,42.9%,47m
27486,3,Belisar,2658,278,9,13,22,40.9%,11m
27486,1,[PMTM1]krosand,2658,250,7,11,18,38.9%,60m
27486,3,Echo,2658,129,4,4,8,50.0%,47m
27486,1,NEMA,2658,143,4,6,10,40.0%,57m
27486,2,ApoDeron,2658,60,3,0,3,100.0%,27m
27486,1,[ATAB]manystyles,2658,88,3,4,7,42.9%,33m
27486,1,KingLammbi,2658,94,3,5,8,37.5%,54m
27486,3,Mid,2658,40,2,5,7,28.6%,29m
27486,1,Sickness,2658,0,1,0,1,100.0%,51m
27486,2,[SQUA]TheNano,2658,0,0,1,1,0.0%,5m
27486,2,Jack,2658,0,0,5,5,0.0%,39m
27506,1,Perpedon,2657,1585,150,143,293,51.2%,60m
27506,2,Belial,2657,1583,98,90,188,52.1%,22m
27506,3,[IndyK]Chludek,2657,1350,61,66,127,48.0%,26m
27506,2,LoveLife,2657,543,41,31,72,56.9%,48m
27506,3,ExodusPrime,2657,474,25,31,56,44.6%,16m
27506,3,RyutoPak,2657,261,24,23,47,51.1%,12m
27506,1,Astronafs,2657,306,11,6,17,64.7%,53m
27506,1,Morgoth,2657,296,9,27,36,25.0%,3m
27506,1,Xaivier,2657,321,8,10,18,44.4%,23m
27506,2,VampireDeSad,2657,168,7,9,16,43.8%,16m
27506,2,FeuerFox,2657,180,6,9,15,40.0%,21m
27506,2,tede,2657,0,4,1,5,80.0%,60m
27506,2,brnkačkaEZ,2657,144,4,1,5,80.0%,48m
27506,2,lastopa,2657,60,3,1,4,75.0%,8m
27506,2,QuickToast,2657,0,2,3,5,40.0%,1h
27506,2,[No0opE]Mutsue,2657,0,1,0,1,100.0%,1h
27506,1,Zmeechka,2657,0,1,1,2,50.0%,59m
27506,2,[1stGG]wurzelsepp,2657,0,0,1,1,0.0%,51m
27506,2,someone,2657,0,0,1,1,0.0%,60m
27506,2,pewy,2657,0,0,1,1,0.0%,35m
27506,2,Киллер,2657,0,0,1,1,0.0%,46m
27506,2,SayNoToStim,2657,0,0,1,1,0.0%,24m
27506,2,Alex,2657,0,0,2,2,0.0%,1h
27529,3,Libris,2656,1127,153,146,299,51.2%,11m
27529,1,FalkE,2656,963,90,84,174,51.7%,44m
27529,1,JamesBond,2656,1141,48,42,90,53.3%,31m
27529,1,CherryBlood,2656,1011,37,54,91,40.7%,9m
27529,3,ZergAteYou,2656,907,32,41,73,43.8%,11m
27529,1,[mfixed]TYTY,2656,418,30,21,51,58.8%,53m
27529,3,Roac,2656,577,26,32,58,44.8%,3m
27529,2,[HMarch]Gnedkoff,2656,463,18,12,30,60.0%,45m
27529,1,ShadowskY,2656,303,9,7,16,56.2%,32m
27529,1,Bigsam,2656,209,6,5,11,54.5%,47m
27529,1,Maximuss,2656,151,4,5,9,44.4%,42m
27529,2,[NoVin]Kortinel,2656,116,4,5,9,44.4%,20m
27529,3,SKTiloveoov,2656,121,3,4,7,42.9%,10m
27529,1,Aimon,2656,0,3,5,8,37.5%,47m
27529,2,emerge,2656,62,2,2,4,50.0%,59m
27529,1,[SftS]amaranthine,2656,68,2,4,6,33.3%,54m
27529,3,SandR,2656,42,2,5,7,28.6%,29m
27529,2,Sammeh,2656,0,1,0,1,100.0%,20m
27529,2,Yonndu,2656,0,1,0,1,100.0%,27m
27529,2,serral,2656,0,1,0,1,100.0%,30m
27529,2,Люцифер,2656,40,1,1,2,50.0%,21m
27529,1,TikaMajere,2656,42,1,6,7,14.3%,7m
27529,2,Lussebullen,2656,0,0,1,1,0.0%,10m
27529,1,Scuffed,2656,0,0,4,4,0.0%,56m
27529,1,Spinix,2656,0,0,5,5,0.0%,49m
27554,1,Smashup,2655,1213,85,73,158,53.8%,20m
27554,1,Nimb,2655,881,74,44,118,62.7%,10m
27554,1,[lg90]Thanos,2655,1203,52,39,91,57.1%,53m
27554,1,ColdasGonzlz,2655,973,43,65,108,39.8%,11m
27554,2,Hyperlighter,2655,750,34,13,47,72.3%,54m
27554,2,[45silm]tamadCZ,2655,885,34,30,64,53.1%,36m
27554,2,Vittek,2655,574,23,29,52,44.2%,12m
27554,3,Ghost,2655,632,22,33,55,40.0%,19m
27554,2,[PH4L]edde,2655,433,20,11,31,64.5%,1h
27554,1,temon,2655,648,20,22,42,47.6%,42m
27554,3,[ЗИБиАГ]QWERTY,2655,258,12,5,17,70.6%,5m
27554,1,SHAITANblCH,2655,298,10,9,19,52.6%,57m
27554,1,Ronin,2655,169,6,8,14,42.9%,51m
27554,2,savionok,2655,144,5,3,8,62.5%,37m
27554,3,Veiija,2655,0,3,3,6,50.0%,10m
27554,1,Tahras,2655,118,3,6,9,33.3%,35m
27554,1,Jim,2655,97,2,2,4,50.0%,9m
27554,2,[BCNE]Valroe,2655,0,2,3,5,40.0%,54m
27554,2,[PROst8]Braumeister,2655,0,2,3,5,40.0%,51m
27554,3,[ZTP4]Polecatson,2655,0,2,3,5,40.0%,6m
27554,2,Frkoviti,2655,122,2,4,6,33.3%,9m
27554,2,Maki,2655,30,1,1,2,50.0%,42m
27554,2,IIIIIIIIIIII,2655,46,1,3,4,25.0%,59m
27554,2,Reuq,2655,0,1,4,5,20.0%,33m
27554,1,Данте,2655,0,1,4,5,20.0%,53m
27554,2,NOK,2655,0,0,1,1,0.0%,19m
27554,2,zlooo,2655,0,0,2,2,0.0%,25m
27581,3,Korgik,2654,1558,221,206,427,51.8%,6m
27581,1,[RsTb]Red,2654,1681,145,147,292,49.7%,27m
27581,1,Katarina,2654,1682,117,102,219,53.4%,28m
27581,1,[DaFF]PinkyStar,2654,666,41,25,66,62.1%,6m
27581,1,Rosh,2654,690,26,20,46,56.5%,26m
27581,1,[Ultm]TXK,2654,490,16,16,32,50.0%,9m
27581,2,[ULTX]Shadowflame,2654,358,15,19,34,44.1%,16m
27581,2,Shinjiru,2654,334,14,11,25,56.0%,19m
27581,2,Dunder,2654,278,9,4,13,69.2%,8m
27581,3,[EAG]FjZ,2654,209,8,11,19,42.1%,41m
27581,1,nothing,2654,195,7,10,17,41.2%,41m
27581,1,LakiLook,2654,121,5,7,12,41.7%,3m
27581,1,Xerox,2654,190,5,8,13,38.5%,41m
27581,2,[zerw]subotai,2654,86,4,0,4,100.0%,27m
27581,3,mememan,2654,0,4,1,5,80.0%,7m
27581,3,CTPAHHuK,2654,133,4,3,7,57.1%,1h
27581,1,[ZЕRGТV]Tardis,2654,148,4,8,12,33.3%,27m
27581,1,Nik,2654,146,4,9,13,30.8%,1h
27581,3,Cazz,2654,120,4,15,19,21.1%,6m
27581,1,nod,2654,140,3,4,7,42.9%,46m
27581,3,Flyling,2654,0,2,1,3,66.7%,46m
27581,2,JIN,2654,0,2,3,5,40.0%,1h
27581,3,SCV,2654,0,2,3,5,40.0%,35m
27581,2,Hoder,2654,0,2,3,5,40.0%,29m
27581,3,Arashtoi,2654,97,2,4,6,33.3%,56m
27581,2,dooznet,2654,0,1,0,1,100.0%,23m
27581,2,[Sеgа]Baribal,2654,0,0,1,1,0.0%,60m
27608,3,Madara,2653,855,116,97,213,54.5%,8m
27608,3,antonskakun,2653,822,33,36,69,47.8%,19m
27608,1,CryEngine,2653,1014,32,53,85,37.6%,7m
27608,3,iLuxo,2653,750,30,31,61,49.2%,18m
27608,1,najlepa,2653,413,21,20,41,51.2%,53m
27608,1,darckdestroy,2653,505,19,14,33,57.6%,1h
27608,1,Manrom,2653,466,19,15,34,55.9%,1h
27608,3,Omega,2653,426,16,21,37,43.2%,19m
27608,2,[CUBITA]Rasthak,2653,203,7,7,14,50.0%,27m
27608,2,[SeNF]bebbo,2653,190,7,9,16,43.8%,38m
27608,2,kirillko,2653,118,5,4,9,55.6%,4m
27608,2,CruelDuck,2653,134,4,1,5,80.0%,1h
27608,1,jason,2653,138,4,3,7,57.1%,1h
27608,2,VikingQuest,2653,86,3,1,4,75.0%,1h
27608,2,[DEASY]NelsoN,2653,136,3,1,4,75.0%,28m
27608,2,ratches,2653,88,3,3,6,50.0%,38m
27608,3,Аларак,2653,0,2,3,5,40.0%,21m
27608,3,WEEBARIUM,2653,93,1,3,4,25.0%,16m
27608,1,RaGnArOk,2653,36,1,4,5,20.0%,45m
27608,1,Frefghter,2653,30,1,4,5,20.0%,35m
27608,2,Рокемон,2653,0,0,1,1,0.0%,52m
27629,1,yorick,2652,755,49,47,96,51.0%,27m
27629,2,Terinak,2652,577,22,29,51,43.1%,3m
27629,2,[2021]ZHAMANBAY,2652,402,15,8,23,65.2%,37m
27629,1,эпичнаямышь,2652,443,14,13,27,51.9%,42m
27629,1,Robix,2652,353,12,15,27,44.4%,44m
27629,1,Yooreck,2652,186,6,9,15,40.0%,27m
27629,3,NOOBSTMPRNIN,2652,0,4,2,6,66.7%,1h
27629,2,Tergas,2652,30,3,4,7,42.9%,50m
27629,1,Enkidu,2652,40,1,6,7,14.3%,3m
27629,2,Mikro,2652,0,0,1,1,0.0%,35m
27629,2,TheFury,2652,0,0,1,1,0.0%,51m
27629,2,Alpachino,2652,0,0,1,1,0.0%,28m
27629,2,Anton,2652,0,0,1,1,0.0%,56m
27629,2,noobIOII,2652,0,0,1,1,0.0%,57m
27629,2,Stefano,2652,0,0,2,2,0.0%,56m
27629,1,[EoAF]Squinookle,2652,0,0,4,4,0.0%,38m
27645,3,Roy,2651,1597,321,331,652,49.2%,7m
27645,1,WilliWürfel,2651,1700,185,191,376,49.2%,6m
27645,1,Mafyou,2651,1525,109,109,218,50.0%,7m
27645,3,[WАSD]lXXXWASDXXXl,2651,1258,53,56,109,48.6%,19m
27645,1,[SKRSPZ]толя,2651,817,48,41,89,53.9%,6m
27645,1,Smolar,2651,493,36,18,54,66.7%,60m
27645,3,ZergCraft,2651,986,35,44,79,44.3%,16m
27645,2,SanyaJor,2651,468,23,11,34,67.6%,37m
27645,1,Ivo,2651,392,15,11,26,57.7%,1h
27645,2,FeLLoN,2651,244,9,6,15,60.0%,21m
27645,1,[GiRLgg]CuteKitty,2651,271,8,10,18,44.4%,34m
27645,2,Миша,2651,154,6,2,8,75.0%,45m
27645,1,youngZerg,2651,176,6,2,8,75.0%,23m
27645,1,[Abibas]AcidShadow,2651,192,6,9,15,40.0%,47m
27645,2,[PLKurw]pointman,2651,132,5,3,8,62.5%,51m
27645,2,mishoon,2651,88,4,3,7,57.1%,60m
27645,2,CloseYou,2651,86,3,2,5,60.0%,1h
27645,2,Nogan,2651,30,3,3,6,50.0%,29m
27645,3,DatSickKid,2651,42,3,4,7,42.9%,1h
27645,2,Jorak,2651,138,3,6,9,33.3%,4m
27645,2,Плюмчик,2651,64,2,2,4,50.0%,1h
27645,2,AlexeiStukov,2651,0,2,3,5,40.0%,33m
27645,2,HalflingHR,2651,0,2,3,5,40.0%,22m
27645,3,DandY,2651,97,2,4,6,33.3%,50m
27645,1,[MWAF]Drozen,2651,48,2,5,7,28.6%,48m
27645,2,DestraM,2651,0,1,1,2,50.0%,1h
27645,2,zero,2651,30,1,1,2,50.0%,10m
27645,2,KOOLSAN,2651,36,1,2,3,33.3%,55m
27645,1,Bananalisk,2651,0,0,4,4,0.0%,47m
27674,1,Agent,2650,1204,73,78,151,48.3%,1h
27674,1,joleclodo,2650,709,71,60,131,54.2%,8m
27674,1,[KERNEL]Холодный,2650,1306,55,50,105,52.4%,32m
27674,3,Kerrigan,2650,283,22,26,48,45.8%,19m
27674,1,BezpredelYT,2650,418,17,15,32,53.1%,19m
27674,3,Matare,2650,412,16,17,33,48.5%,18m
27674,1,Proydoha,2650,386,11,17,28,39.3%,28m
27674,2,saber,2650,190,5,11,16,31.2%,6m
27674,1,YaoMing,2650,175,4,10,14,28.6%,34m
27674,1,jiji,2650,160,3,5,8,37.5%,32m
27674,1,Lankos,2650,102,3,5,8,37.5%,4m
27674,2,Warden,2650,0,1,0,1,100.0%,6m
27674,3,Mahks,2650,0,1,0,1,100.0%,1h
27674,2,kiritos,2650,0,1,0,1,100.0%,49m
27674,1,CroHunter,2650,0,1,1,2,50.0%,42m
27674,2,jaisi,2650,0,1,1,2,50.0%,37m
27674,2,[PPU]ромаsik,2650,0,0,1,1,0.0%,7m
27674,2,sobolesnuy,2650,0,0,1,1,0.0%,9m
27674,2,СосокEdition,2650,0,0,1,1,0.0%,3m
27674,2,Ilya,2650,0,0,2,2,0.0%,40m
27674,2,Jimon,2650,0,0,2,2,0.0%,41m
27674,2,DustTail,2650,0,0,2,2,0.0%,51m
27674,3,tazadar,2650,0,0,5,5,0.0%,35m
27697,1,Roskolnikov,2649,1595,120,127,247,48.6%,11m
27697,1,ßlackVandal,2649,1612,107,95,202,53.0%,10m
27697,1,Joel,2649,1604,91,88,179,50.8%,32m
27697,3,Tklz,2649,1470,78,77,155,50.3%,27m
27697,1,ViYs,2649,581,42,25,67,62.7%,50m
27697,2,Kmpek,2649,787,39,32,71,54.9%,1h
27697,1,Yellowst,2649,918,35,29,64,54.7%,32m
27697,3,[n00b0d]Aerobaz,2649,838,32,41,73,43.8%,19m
27697,3,артём,2649,544,24,28,52,46.2%,18m
27697,2,Camembert,2649,398,16,12,28,57.1%,3m
27697,2,ODySSey,2649,405,16,15,31,51.6%,1h
27697,3,Kitsunebi,2649,287,13,11,24,54.2%,1h
27697,1,Kerrigan,2649,297,12,8,20,60.0%,60m
27697,1,Levi,2649,184,8,8,16,50.0%,4m
27697,1,Kurlik,2649,206,8,8,16,50.0%,23m
27697,1,AllSilentSky,2649,250,8,10,18,44.4%,9m
27697,2,PsyChocore,2649,158,5,6,11,45.5%,43m
27697,1,Anexus,2649,36,4,4,8,50.0%,3m
27697,1,Pikabctch,2649,106,2,2,4,50.0%,55m
27697,2,GeraX,2649,60,2,3,5,40.0%,1h
27697,2,ellie,2649,0,2,3,5,40.0%,30m
27697,2,Klaus,2649,0,1,0,1,100.0%,1h
27697,2,Phoenix,2649,0,1,0,1,100.0%,21m
27697,3,zergling,2649,0,1,1,2,50.0%,53m
27697,2,gigi,2649,0,1,2,3,33.3%,28m
27697,2,Xyrex,2649,30,1,2,3,33.3%,35m
27697,2,deimos,2649,0,0,1,1,0.0%,56m
27697,2,[2Pizzа]Polaris,2649,0,0,1,1,0.0%,9m
27697,1,дикий,2649,0,0,3,3,0.0%,53m
27697,1,Hercles,2649,0,0,4,4,0.0%,1h
27727,1,РакОтшельник,2648,1694,66,67,133,49.6%,10m
27727,1,ELCAB,2648,1125,43,42,85,50.6%,35m
27727,2,boGár,2648,1019,40,32,72,55.6%,54m
27727,1,Stammfäller,2648,881,33,31,64,51.6%,1h
27727,1,Nibelunge,2648,891,30,29,59,50.8%,1h
27727,1,Misha,2648,584,26,20,46,56.5%,33m
27727,1,Cyberxsgt,2648,190,8,8,16,50.0%,32m
27727,1,[RFTW2k]Tardface,2648,193,7,4,11,63.6%,42m
27727,2,Hansosolo,2648,189,7,6,13,53.8%,1h
27727,2,mixas,2648,122,5,5,10,50.0%,1h
27727,3,wasd,2648,0,4,1,5,80.0%,47m
27727,2,Tarakan,2648,131,4,4,8,50.0%,50m
27727,2,[4SALE]SISKIN,2648,66,3,2,5,60.0%,21m
27727,2,Orange,2648,201,3,3,6,50.0%,54m
27727,3,Einar,2648,64,3,10,13,23.1%,12m
27727,1,PAOG,2648,38,2,6,8,25.0%,31m
27727,2,IIIIIIIIIIII,2648,0,1,0,1,100.0%,51m
27727,2,TristiaAsuka,2648,0,1,0,1,100.0%,59m
27727,2,Метанольчик,2648,0,1,0,1,100.0%,60m
27727,2,[KKZE]Cbrox,2648,0,0,1,1,0.0%,49m
27747,3,МалышKid,2647,1585,162,145,307,52.8%,25m
27747,3,[moreno]andres,2647,1592,157,154,311,50.5%,26m
27747,1,[Søre]Yarg,2647,1035,58,54,112,51.8%,23m
27747,1,Alkado,2647,966,45,43,88,51.1%,6m
27747,3,подчас,2647,815,45,47,92,48.9%,3m
27747,1,SheikofLings,2647,962,37,38,75,49.3%,1h
27747,3,Chop,2647,508,25,32,57,43.9%,5m
27747,1,[YSRY]Ling,2647,135,24,22,46,52.2%,32m
27747,1,Keltium,2647,666,24,24,48,50.0%,36m
27747,2,лёлик,2647,452,17,15,32,53.1%,52m
27747,1,[ClSq]Ислам,2647,411,17,22,39,43.6%,8m
27747,1,[AITEAM]MakroMarc,2647,163,9,11,20,45.0%,27m
27747,3,Flash,2647,194,8,11,19,42.1%,16m
27747,3,ZataRion,2647,206,8,17,25,32.0%,16m
27747,1,Scorp,2647,291,7,9,16,43.8%,47m
27747,2,Poddradion,2647,199,6,1,7,85.7%,51m
27747,2,NaNo,2647,171,5,4,9,55.6%,1h
27747,2,[Seek]Getayr,2647,92,4,2,6,66.7%,1h
27747,2,BUH,2647,144,4,3,7,57.1%,47m
27747,1,Playlife,2647,156,4,10,14,28.6%,34m
27747,2,Koevoet,2647,142,3,3,6,50.0%,19m
27747,1,Vladlen,2647,96,3,6,9,33.3%,1h
27747,3,Freshjuice,2647,94,3,14,17,17.6%,4m
27747,2,HADERfc,2647,60,2,4,6,33.3%,51m
27747,2,[CumA4]fourgeymer,2647,0,1,0,1,100.0%,32m
27747,2,Fancy,2647,0,1,1,2,50.0%,38m
27747,2,Prétention,2647,0,1,1,2,50.0%,39m
27747,1,[Buldog]Genv,2647,0,1,2,3,33.3%,33m
27747,2,[Gassy]GGmartin,2647,44,1,3,4,25.0%,41m
27747,1,CartooN,2647,38,1,4,5,20.0%,3m
27747,2,[Zombiz]Jbon,2647,0,0,1,1,0.0%,52m
27747,2,ShaiTanchik,2647,0,0,1,1,0.0%,23m
27747,2,[AC]Plinio,2647,0,0,2,2,0.0%,23m
27780,1,MaSeGe,2646,1571,257,244,501,51.3%,28m
27780,1,Sad,2646,542,34,30,64,53.1%,3m
27780,2,Alwayshappy,2646,597,30,18,48,62.5%,9m
27780,1,FallenAngel,2646,661,23,23,46,50.0%,60m
27780,1,Eps,2646,582,23,23,46,50.0%,1h
27780,3,PilouPilou,2646,632,21,32,53,39.6%,7m
27780,2,ЫВА,2646,316,14,17,31,45.2%,56m
27780,1,Muybien,2646,306,12,8,20,60.0%,47m
27780,1,Zertzustr,2646,280,10,7,17,58.8%,45m
27780,2,Bezzakonnic,2646,116,6,6,12,50.0%,56m
27780,1,Scar,2646,48,6,6,12,50.0%,33m
27780,3,Jiff,2646,0,4,3,7,57.1%,18m
27780,2,[ЗЕRGТV]KOMARanezi,2646,58,3,0,3,100.0%,4m
27780,2,iluhas,2646,62,3,1,4,75.0%,56m
27780,2,kevin,2646,95,3,5,8,37.5%,1h
27780,2,Aseitas,2646,30,2,0,2,100.0%,1h
27780,2,vudy,2646,66,2,3,5,40.0%,9m
27780,1,Anty,2646,38,2,5,7,28.6%,27m
27780,2,gogo,2646,0,1,0,1,100.0%,42m
27780,2,Boyer,2646,30,1,1,2,50.0%,45m
27780,1,Christmas,2646,44,1,4,5,20.0%,35m
27780,2,whoeveris,2646,0,1,4,5,20.0%,50m
27780,2,Pinowww,2646,0,1,4,5,20.0%,50m
27780,2,WiK,2646,0,0,1,1,0.0%,20m
27780,3,Dorian,2646,0,0,1,1,0.0%,32m
27780,1,Joker,2646,0,0,2,2,0.0%,9m
27806,1,[TMYR]RagingBull,2645,1691,288,291,579,49.7%,1h
27806,1,njoy,2645,1667,98,101,199,49.2%,54m
27806,1,Ziga,2645,1220,56,35,91,61.5%,60m
27806,2,JustAnOldGuy,2645,1207,49,34,83,59.0%,1h
27806,1,Darkwing,2645,783,40,36,76,52.6%,28m
27806,2,[from]YoMister,2645,340,10,9,19,52.6%,30m
27806,1,Diamorotic,2645,334,10,13,23,43.5%,41m
27806,2,Kalle,2645,200,8,10,18,44.4%,40m
27806,3,[ABOMB]LittleBoy,2645,132,5,6,11,45.5%,14m
27806,2,EZFHO,2645,135,3,1,4,75.0%,22m
27806,2,Laec,2645,144,3,3,6,50.0%,24m
27806,1,Wallior,2645,128,3,5,8,37.5%,1h
27806,2,[ANIÓŁY]Plunkton,2645,32,2,1,3,66.7%,44m
27806,1,Lost,2645,90,1,3,4,25.0%,60m
27806,2,GoodWin,2645,0,0,1,1,0.0%,60m
27806,2,Nankarai,2645,0,0,1,1,0.0%,1h
27806,2,[L2S5D]Kosmichevich,2645,0,0,2,2,0.0%,24m
27806,1,[laxAPM]NoWarPls,2645,0,0,2,2,0.0%,1h
27824,3,oneEqualsTwo,2644,1500,223,223,446,50.0%,13m
27824,1,kitkat,2644,976,36,35,71,50.7%,60m
27824,1,psi,2644,577,27,17,44,61.4%,31m
27824,1,Hyltran,2644,674,24,35,59,40.7%,9m
27824,1,NarThalos,2644,549,18,17,35,51.4%,3m
27824,2,Tientienne,2644,180,6,3,9,66.7%,1h
27824,1,Casey,2644,179,5,6,11,45.5%,59m
27824,2,[xDADEx]Prumos,2644,96,4,2,6,66.7%,1h
27824,2,Shadowhawk,2644,58,2,3,5,40.0%,1h
27824,2,IDDQD,2644,0,1,1,2,50.0%,40m
27824,2,zerglot,2644,0,0,2,2,0.0%,48m
27824,2,[Baduk]Polymnie,2644,0,0,5,5,0.0%,1h
27836,3,Mariano,2643,1079,228,200,428,53.3%,5m
27836,3,Shadrin,2643,381,79,85,164,48.2%,8m
27836,2,[EKORN]Inkognitower,2643,1202,49,38,87,56.3%,60m
27836,1,Alex,2643,872,32,28,60,53.3%,59m
27836,3,ElLoOoco,2643,788,30,30,60,50.0%,3m
27836,2,[PS23]TheMagicCoin,2643,548,23,22,45,51.1%,36m
27836,2,Zufl,2643,437,18,9,27,66.7%,41m
27836,1,[6mm]AdPadoue,2643,88,3,4,7,42.9%,1h
27836,3,hohlokit,2643,120,2,4,6,33.3%,5m
27836,2,ImSoHiGh,2643,0,1,0,1,100.0%,25m
27836,2,Хомяк,2643,0,1,0,1,100.0%,56m
27836,2,TRIFON,2643,0,1,2,3,33.3%,1h
27836,1,lion,2643,0,1,5,6,16.7%,3m
27836,2,TSIRLIPIPIS,2643,0,0,1,1,0.0%,37m
27836,1,PhysoTronic,2643,0,0,3,3,0.0%,52m
27836,1,Vadim,2643,0,0,5,5,0.0%,42m
27852,2,Octoporuchac,2642,1598,156,115,271,57.6%,55m
27852,3,[DaFF]Delusion,2642,159,37,40,77,48.1%,28m
27852,2,SQTFU,2642,614,25,21,46,54.3%,60m
27852,1,kasius,2642,506,16,21,37,43.2%,20m
27852,1,Bulletbeast,2642,391,15,15,30,50.0%,32m
27852,1,[AgnG]LightRider,2642,261,8,8,16,50.0%,21m
27852,3,MDK,2642,212,7,6,13,53.8%,10m
27852,1,peaceprayer,2642,170,5,4,9,55.6%,42m
27852,3,ScopCony,2642,60,5,6,11,45.5%,6m
27852,1,stewie,2642,186,4,6,10,40.0%,1h
27852,1,[ChBag]piter,2642,114,4,8,12,33.3%,7m
27852,2,Skrillex,2642,30,2,0,2,100.0%,42m
27852,2,BooMtj,2642,38,2,0,2,100.0%,1h
27852,1,Tim,2642,95,2,1,3,66.7%,60m
27852,3,UncleBricks,2642,0,2,2,4,50.0%,24m
27852,2,[TTRaid]MoonSlicer,2642,0,2,3,5,40.0%,49m
27852,3,[ShFox]Murr,2642,0,2,3,5,40.0%,44m
27852,2,zuzupuzy,2642,0,1,0,1,100.0%,37m
27852,2,Cin,2642,32,1,1,2,50.0%,30m
27852,1,Goala,2642,0,1,4,5,20.0%,1h
27852,3,[PARADX]OkumaZ,2642,0,1,4,5,20.0%,24m
27852,1,[M0rtiS]WarfareSnake,2642,0,1,5,6,16.7%,60m
27852,2,OmegaOdie,2642,0,0,1,1,0.0%,23m
27852,2,Боров,2642,0,0,1,1,0.0%,48m
27852,2,VikiR,2642,0,0,1,1,0.0%,38m
27852,1,toBe,2642,0,0,2,2,0.0%,1h
27852,2,JinnFarewell,2642,0,0,2,2,0.0%,37m
27879,1,onelastjob,2641,1564,235,239,474,49.6%,55m
27879,1,Zats,2641,1047,113,98,211,53.6%,60m
27879,1,Icarion,2641,921,100,94,194,51.5%,55m
27879,1,[БУБУБ]AZERTY,2641,1262,61,41,102,59.8%,31m
27879,1,disabler,2641,1065,42,43,85,49.4%,34m
27879,1,RaVaGe,2641,769,27,29,56,48.2%,32m
27879,1,ParaDiGm,2641,638,25,24,49,51.0%,1h
27879,2,TURBOCUMTANK,2641,502,24,13,37,64.9%,1h
27879,1,WildKraut,2641,332,14,8,22,63.6%,31m
27879,3,[foots]blackarrow,2641,0,5,2,7,71.4%,15m
27879,1,FLASTIK,2641,162,5,8,13,38.5%,33m
27879,1,[EEB]Marazhuk,2641,145,4,3,7,57.1%,45m
27879,1,[oODSo]jamesbryan,2641,138,4,7,11,36.4%,60m
27879,2,Quimas,2641,92,3,4,7,42.9%,41m
27879,1,Jacubus,2641,114,3,4,7,42.9%,3m
27879,1,[SPdI]Rouge,2641,96,3,6,9,33.3%,27m
27879,3,llllllllll,2641,0,2,2,4,50.0%,1h
27879,3,[ULIH]cSm,2641,0,2,3,5,40.0%,49m
27879,2,Ghost,2641,0,2,3,5,40.0%,50m
27879,2,Maybe,2641,0,0,1,1,0.0%,1h
27899,2,Sleepy,2640,503,21,17,38,55.3%,44m
27899,2,SanchopeS,2640,431,20,21,41,48.8%,42m
27899,1,Max,2640,446,14,17,31,45.2%,36m
27899,1,Arb,2640,203,9,5,14,64.3%,33m
27899,1,[RUBIS]Андрей,2640,281,9,11,20,45.0%,42m
27899,2,OLIWIER,2640,92,5,3,8,62.5%,45m
27899,2,[SHMLK]Treetall,2640,0,4,4,8,50.0%,1h
27899,3,RANDOM,2640,42,3,4,7,42.9%,1h
27899,2,BSRV,2640,88,3,5,8,37.5%,1h
27899,2,moritz,2640,32,2,1,3,66.7%,7m
27899,2,[LSKGS]MasterEC,2640,32,2,1,3,66.7%,1h
27899,1,[BeB]Marsyan,2640,89,2,1,3,66.7%,28m
27899,1,[WАSD]RansuTapani,2640,108,2,2,4,50.0%,32m
27899,1,Adama,2640,40,2,3,5,40.0%,40m
27899,1,FelipeSevenG,2640,0,1,0,1,100.0%,1h
27899,2,Razarvater,2640,0,1,0,1,100.0%,38m
27899,2,[XvFe]ShamuraTLO,2640,0,1,0,1,100.0%,41m
27899,2,WolkadaW,2640,0,1,4,5,20.0%,56m
27899,2,[Incm]KrYoxZ,2640,0,0,2,2,0.0%,37m
27918,1,Efflum,2639,1193,82,63,145,56.6%,20m
27918,1,fanerotim,2639,1598,64,63,127,50.4%,44m
27918,1,ЗлойГусь,2639,962,62,57,119,52.1%,7m
27918,1,Neico,2639,917,45,33,78,57.7%,27m
27918,2,LIKMIJNBALLE,2639,829,41,17,58,70.7%,9m
27918,1,ForgoTTeN,2639,641,35,25,60,58.3%,53m
27918,2,ДенАкс,2639,648,30,20,50,60.0%,37m
27918,2,Andrey,2639,366,15,6,21,71.4%,29m
27918,1,[PARSE]TonyStark,2639,282,12,10,22,54.5%,51m
27918,3,DelArco,2639,148,6,7,13,46.2%,18m
27918,1,DarkMarine,2639,88,5,2,7,71.4%,45m
27918,3,VladIsLove,2639,154,5,4,9,55.6%,10m
27918,1,[killU]Marineder,2639,133,5,5,10,50.0%,53m
27918,2,Livermorium,2639,140,4,6,10,40.0%,42m
27918,1,VELNS,2639,136,4,8,12,33.3%,42m
27918,1,IIIIIIIIIII,2639,158,4,12,16,25.0%,35m
27918,2,Aleria,2639,113,3,1,4,75.0%,60m
27918,2,Adkard,2639,120,3,2,5,60.0%,1h
27918,2,Fape,2639,0,3,2,5,60.0%,45m
27918,3,SwankyPants,2639,121,3,4,7,42.9%,21m
27918,2,morbo,2639,0,3,4,7,42.9%,10m
27918,3,KesyBTW,2639,42,3,4,7,42.9%,46m
27918,2,[UlgCy]tomKET,2639,96,3,5,8,37.5%,5m
27918,1,Exe,2639,96,3,7,10,30.0%,3m
27918,1,zayaz,2639,110,3,7,10,30.0%,34m
27918,2,[RPro]HAV,2639,30,2,0,2,100.0%,24m
27918,2,DUBAI,2639,0,1,0,1,100.0%,57m
27918,2,[S3ise]Sorin,2639,0,1,0,1,100.0%,52m
27918,3,Jogherd,2639,0,1,1,2,50.0%,32m
27918,2,LosLosLos,2639,0,0,1,1,0.0%,35m
27948,1,Cabia,2638,1001,47,41,88,53.4%,9m
27948,2,Shodow,2638,618,27,26,53,50.9%,24m
27948,3,FATworm,2638,146,8,10,18,44.4%,8m
27948,2,CreeperTNT,2638,190,7,0,7,100.0%,10m
27948,2,nkazul,2638,116,6,3,9,66.7%,43m
27948,1,Kazan,2638,222,6,12,18,33.3%,6m
27948,2,WooD,2638,164,6,13,19,31.6%,28m
27948,2,iGGnoRE,2638,60,4,4,8,50.0%,24m
27948,2,[Y8U]Jogarcg,2638,88,3,4,7,42.9%,30m
27948,1,[OD2014]Garmor,2638,116,2,3,5,40.0%,50m
27948,3,FanagoS,2638,0,2,3,5,40.0%,26m
27948,1,The,2638,78,2,9,11,18.2%,6m
27948,2,Rakh,2638,0,1,1,2,50.0%,9m
27948,2,[Dnmt]MoonBang,2638,0,1,1,2,50.0%,50m
27948,1,JAY,2638,0,1,3,4,25.0%,41m
27948,2,[NHT]CaptainFOX,2638,0,0,1,1,0.0%,1h
27948,3,[NoPa]niceone,2638,0,0,1,1,0.0%,40m
27948,2,ComDIV,2638,0,0,2,2,0.0%,9m
27948,2,Fkellog,2638,0,0,2,2,0.0%,1h
27948,2,Kruger,2638,0,0,3,3,0.0%,5m
27968,3,BROKER,2637,1385,100,86,186,53.8%,28m
27968,2,namsoft,2637,967,89,80,169,52.7%,1h
27968,3,rpjss,2637,928,83,85,168,49.4%,6m
27968,1,johannes,2637,1661,75,71,146,51.4%,31m
27968,1,Konstantin,2637,1352,63,55,118,53.4%,1h
27968,1,emyot,2637,795,54,47,101,53.5%,3m
27968,1,UPYR,2637,935,36,33,69,52.2%,59m
27968,3,OKPOJI,2637,844,31,40,71,43.7%,7m
27968,1,[hf4X4]DrNoob,2637,604,19,18,37,51.4%,31m
27968,3,Noobik,2637,418,16,21,37,43.2%,16m
27968,1,Banzola,2637,574,16,41,57,28.1%,3m
27968,2,[RO2020]DonEnzone,2637,237,8,3,11,72.7%,38m
27968,2,Hondel,2637,240,8,9,17,47.1%,42m
27968,1,TheStig,2637,290,8,18,26,30.8%,51m
27968,1,[PPM]Greenghost,2637,178,6,8,14,42.9%,42m
27968,1,Priliand,2637,138,5,5,10,50.0%,1h
27968,1,Pedro,2637,160,4,5,9,44.4%,36m
27968,1,Theokiedoke,2637,114,4,5,9,44.4%,60m
27968,1,Rstar,2637,78,3,4,7,42.9%,3m
27968,1,WildChipmunk,2637,34,2,3,5,40.0%,24m
27968,2,[GBLNS]бот,2637,0,2,3,5,40.0%,55m
27968,2,[sc2tm]Artunela,2637,30,2,11,13,15.4%,10m
27968,2,NikSlaughter,2637,0,1,0,1,100.0%,7m
27968,2,святославови,2637,0,1,1,2,50.0%,1h
27968,1,Wizzardo,2637,0,1,1,2,50.0%,33m
27968,2,Hurt,2637,0,0,1,1,0.0%,23m
27968,2,BrutalPony,2637,0,0,2,2,0.0%,41m
27968,2,[B3ard]Dontyr,2637,0,0,5,5,0.0%,9m
27996,3,Perecsz,2636,878,138,146,284,48.6%,13m
27996,3,evo,2636,1527,104,112,216,48.1%,11m
27996,1,Luri,2636,1411,73,68,141,51.8%,59m
27996,1,Manni,2636,611,72,65,137,52.6%,41m
27996,2,Kaesebrot,2636,1445,58,52,110,52.7%,1h
27996,1,RockBest,2636,307,10,13,23,43.5%,42m
27996,1,EVØLVE,2636,313,9,10,19,47.4%,3m
27996,2,Nik,2636,246,7,8,15,46.7%,5m
27996,3,[M3X]Sverlaz,2636,183,7,9,16,43.8%,3m
27996,2,julian,2636,92,7,9,16,43.8%,26m
27996,3,[Z3RG7V]CacaoPimp,2636,206,7,18,25,28.0%,6m
27996,2,Imm,2636,122,5,4,9,55.6%,25m
27996,2,dERwOLK,2636,0,2,3,5,40.0%,47m
27996,3,[Skylr]Miami,2636,0,2,3,5,40.0%,55m
27996,3,Mitsukete,2636,0,2,3,5,40.0%,1h
27996,2,Escuder,2636,62,2,5,7,28.6%,21m
27996,2,voin,2636,0,1,0,1,100.0%,8m
27996,3,DanSport,2636,0,0,1,1,0.0%,5m
27996,2,spliff,2636,0,0,1,1,0.0%,22m
28015,1,[Dobro]кром,2635,1604,116,96,212,54.7%,6m
28015,3,[PÂRłAH]sadko,2635,1410,86,87,173,49.7%,12m
28015,2,Mateo,2635,1492,68,47,115,59.1%,20m
28015,1,IkeSkywalker,2635,879,47,38,85,55.3%,9m
28015,1,Den,2635,777,26,30,56,46.4%,36m
28015,1,Rwzzz,2635,682,25,27,52,48.1%,6m
28015,2,[CREPES]Guideuz,2635,477,18,12,30,60.0%,10m
28015,1,DILDON,2635,188,9,8,17,52.9%,21m
28015,2,VorTeXx,2635,144,6,3,9,66.7%,60m
28015,2,schublade,2635,186,5,7,12,41.7%,45m
28015,2,sandorlol,2635,92,4,4,8,50.0%,51m
28015,2,Fusgaar,2635,113,4,6,10,40.0%,5m
28015,3,vistop,2635,0,2,3,5,40.0%,1h
28015,1,[uloser]Egich,2635,174,2,10,12,16.7%,59m
28015,2,[blizou]darkAz,2635,0,1,0,1,100.0%,1h
28015,3,[sort]Kødkussen,2635,36,1,1,2,50.0%,46m
28015,2,Zergalicious,2635,0,1,1,2,50.0%,23m
28015,2,[Psevdo]BJIAДbIKA,2635,34,1,1,2,50.0%,56m
28015,2,[PROESL]PROsiaczek,2635,0,0,1,1,0.0%,60m
28015,3,Garci,2635,0,0,4,4,0.0%,1h
28035,1,MaxComrad,2634,1645,148,138,286,51.7%,34m
28035,1,bojidar,2634,1257,74,60,134,55.2%,59m
28035,3,[oO]Mano,2634,1398,73,72,145,50.3%,10m
28035,1,Werock,2634,1632,68,60,128,53.1%,1h
28035,2,Webmaster,2634,497,34,31,65,52.3%,44m
28035,1,[CoBiSi]danijoo,2634,708,29,27,56,51.8%,21m
28035,1,Humanity,2634,526,20,18,38,52.6%,53m
28035,2,Leaveyou,2634,482,18,16,34,52.9%,1h
28035,1,[BWz]HUNTerPL,2634,221,17,15,32,53.1%,1h
28035,2,PROMETHEUS,2634,460,16,15,31,51.6%,32m
28035,1,Oryr,2634,550,16,23,39,41.0%,7m
28035,1,Blender,2634,365,15,8,23,65.2%,10m
28035,3,Melenya,2634,308,11,16,27,40.7%,13m
28035,1,oleandreynik,2634,362,10,12,22,45.5%,32m
28035,2,GeoGeo,2634,268,9,9,18,50.0%,56m
28035,1,Beta,2634,230,8,7,15,53.3%,28m
28035,2,Jawas,2634,139,6,5,11,54.5%,1h
28035,2,Secret,2634,90,5,7,12,41.7%,3m
28035,2,Roko,2634,0,4,1,5,80.0%,4m
28035,2,adryan,2634,114,4,6,10,40.0%,26m
28035,1,темай,2634,97,3,4,7,42.9%,1h
28035,1,[RBTV5]ThylekShran,2634,97,3,5,8,37.5%,31m
28035,3,[Cancro]SneakyGhost,2634,145,3,5,8,37.5%,48m
28035,1,[xASFx]Shaaban,2634,154,3,6,9,33.3%,20m
28035,1,BaAalZ,2634,104,3,6,9,33.3%,50m
28035,2,[8D]rinzler,2634,0,1,0,1,100.0%,52m
28035,1,taki,2634,96,1,1,2,50.0%,47m
28035,2,[OverX]xcashxx,2634,93,1,1,2,50.0%,50m
28035,3,[DRKOL]lkojda,2634,97,1,1,2,50.0%,1h
28035,2,dandrian,2634,0,0,1,1,0.0%,4m
28035,2,Ultrawork,2634,0,0,1,1,0.0%,6m
28035,3,AlexanderVar,2634,0,0,2,2,0.0%,24m
28067,1,SeBB,2633,657,79,80,159,49.7%,21m
28067,1,SZEFU,2633,878,48,44,92,52.2%,36m
28067,1,Guile,2633,897,47,47,94,50.0%,9m
28067,2,lui,2633,221,17,12,29,58.6%,27m
28067,2,RAGE,2633,444,16,10,26,61.5%,51m
28067,2,HolyNecro,2633,427,15,16,31,48.4%,4m
28067,1,Myzone,2633,340,11,10,21,52.4%,28m
28067,1,Shavka,2633,284,9,7,16,56.2%,57m
28067,2,[IBC]Ariel,2633,260,9,9,18,50.0%,56m
28067,2,[DNOser]GeteRo,2633,212,6,3,9,66.7%,40m
28067,1,Cosmak,2633,211,6,6,12,50.0%,5m
28067,2,MechAniCs,2633,128,4,7,11,36.4%,9m
28067,2,LBA,2633,0,3,2,5,60.0%,1h
28067,2,Artp,2633,32,2,0,2,100.0%,8m
28067,2,ChilliHole,2633,107,2,4,6,33.3%,20m
28067,1,Drobovik,2633,38,1,5,6,16.7%,53m
28067,1,gamerhappy,2633,0,0,2,2,0.0%,45m
28067,1,Tulduru,2633,0,0,2,2,0.0%,20m
28085,3,Paul,2632,1507,191,194,385,49.6%,13m
28085,3,[SigV]Dlacreme,2632,1144,56,63,119,47.1%,6m
28085,2,[OMGITS]zenden,2632,714,28,24,52,53.8%,51m
28085,2,sersergiu,2632,532,22,13,35,62.9%,54m
28085,2,[59APM]gameover,2632,494,18,13,31,58.1%,9m
28085,1,Huricane,2632,417,18,17,35,51.4%,42m
28085,2,Loktai,2632,417,14,15,29,48.3%,40m
28085,1,TpaXyXoJIb,2632,329,11,13,24,45.8%,20m
28085,1,VIKINGR,2632,277,8,10,18,44.4%,31m
28085,1,Valkyrie,2632,238,8,11,19,42.1%,20m
28085,1,Keima,2632,163,4,1,5,80.0%,9m
28085,1,[fdu]fduch,2632,152,4,5,9,44.4%,1h
28085,2,Левославный,2632,60,3,0,3,100.0%,1h
28085,2,MRKripo,2632,30,2,1,3,66.7%,57m
28085,2,Zackelis,2632,64,2,2,4,50.0%,59m
28085,1,крабик,2632,122,2,4,6,33.3%,6m
28085,3,Fubert,2632,40,2,5,7,28.6%,7m
28085,1,Zest,2632,126,2,8,10,20.0%,20m
28085,2,Greyvor,2632,30,1,2,3,33.3%,4m
28085,2,Michto,2632,0,0,1,1,0.0%,22m
28085,3,[ArĮnĒn]ØḼĐђŲÑŦĒŘ,2632,0,0,1,1,0.0%,52m
28106,2,TheEnigmaTNG,2631,1594,71,62,133,53.4%,35m
28106,2,Brotherluk,2631,1194,50,39,89,56.2%,40m
28106,1,Dendis,2631,880,29,35,64,45.3%,20m
28106,3,LiNN,2631,639,22,29,51,43.1%,6m
28106,3,Infiusy,2631,321,13,11,24,54.2%,38m
28106,1,clemmrogg,2631,437,13,14,27,48.1%,45m
28106,2,Мячик,2631,243,8,9,17,47.1%,59m
28106,2,Fluffy,2631,163,5,6,11,45.5%,26m
28106,1,[TmdN]Quetar,2631,96,5,8,13,38.5%,1h
28106,1,[TFSC]aaa,2631,174,5,9,14,35.7%,28m
28106,3,PineTreeSeed,2631,135,4,0,4,100.0%,21m
28106,2,Marlene,2631,0,4,4,8,50.0%,27m
28106,1,inexxt,2631,154,4,9,13,30.8%,28m
28106,2,marvman,2631,171,4,10,14,28.6%,54m
28106,2,Mirk,2631,93,3,6,9,33.3%,52m
28106,2,GunmanSR,2631,36,2,1,3,66.7%,24m
28106,2,Ancient,2631,0,1,0,1,100.0%,46m
28106,2,JhonyGhost,2631,0,1,2,3,33.3%,51m
28124,1,[CaLe]Snowkills,2630,1095,115,105,220,52.3%,27m
28124,3,[ENV]Mylny,2630,443,33,32,65,50.8%,12m
28124,1,Clouddigger,2630,766,24,30,54,44.4%,36m
28124,1,Gambuz,2630,437,18,20,38,47.4%,48m
28124,2,GuiltYCroWn,2630,476,17,15,32,53.1%,1h
28124,2,aleph,2630,242,16,34,50,32.0%,11m
28124,3,doez,2630,274,13,14,27,48.1%,13m
28124,1,WolnyBrovar,2630,223,12,14,26,46.2%,7m
28124,2,[Витязи]Hopeless,2630,282,9,6,15,60.0%,20m
28124,1,Mousetrap,2630,184,8,9,17,47.1%,1h
28124,2,Plate,2630,206,6,6,12,50.0%,21m
28124,2,ByndCtrl,2630,117,5,4,9,55.6%,39m
28124,3,Paramoor,2630,0,4,2,6,66.7%,22m
28124,3,Mystic,2630,30,4,5,9,44.4%,18m
28124,2,[KZ05]Aidin,2630,0,3,2,5,60.0%,1h
28124,2,svaliceli,2630,0,3,5,8,37.5%,20m
28124,2,Fury,2630,32,2,0,2,100.0%,44m
28124,2,Potato,2630,30,2,2,4,50.0%,1h
28124,2,MAHO,2630,88,2,4,6,33.3%,20m
28124,2,Aiur,2630,30,1,1,2,50.0%,41m
28124,2,Farja,2630,0,1,1,2,50.0%,47m
28124,3,[teamCZ]Filip,2630,0,0,1,1,0.0%,26m
28124,1,TjiZi,2630,0,0,3,3,0.0%,4m
28124,2,Josh,2630,0,0,5,5,0.0%,6m
28148,1,raymondbty,2629,1571,117,114,231,50.6%,9m
28148,2,Remken,2629,1618,71,66,137,51.8%,35m
28148,3,[bgzona]PlayerSC,2629,932,37,46,83,44.6%,5m
28148,1,WiReD,2629,982,36,35,71,50.7%,7m
28148,2,samo,2629,784,35,22,57,61.4%,23m
28148,1,shhhchizo,2629,786,31,33,64,48.4%,20m
28148,2,Butschie,2629,798,30,27,57,52.6%,60m
28148,1,[NSJLM]Steez,2629,547,24,20,44,54.5%,39m
28148,1,jaweeeeel,2629,580,19,23,42,45.2%,1h
28148,1,IIIIIIIIIIII,2629,406,16,15,31,51.6%,42m
28148,2,[GGBOYZ]puckY,2629,295,12,10,22,54.5%,35m
28148,2,zmora,2629,278,10,12,22,45.5%,47m
28148,2,Homer,2629,152,8,2,10,80.0%,21m
28148,1,Pato,2629,214,8,8,16,50.0%,36m
28148,3,Giuseppe,2629,256,8,17,25,32.0%,6m
28148,2,Майки,2629,107,5,2,7,71.4%,1h
28148,2,[Dobro]TEW,2629,154,5,5,10,50.0%,7m
28148,1,HappyRobot,2629,88,4,3,7,57.1%,6m
28148,2,[xFRSx]Tournesol,2629,58,3,0,3,100.0%,1h
28148,3,Spillouz,2629,0,2,3,5,40.0%,40m
28148,1,Social,2629,0,2,4,6,33.3%,32m
28148,2,Sanchez,2629,34,1,2,3,33.3%,41m
28148,1,tole,2629,40,1,6,7,14.3%,47m
28148,2,[sc2tm]sanekprost,2629,0,0,1,1,0.0%,1h
28148,2,LuckyOwl,2629,0,0,1,1,0.0%,3m
28148,1,Shirogane,2629,0,0,3,3,0.0%,24m
28174,1,Noob,2628,1544,230,212,442,52.0%,21m
28174,1,TimTam,2628,1649,216,210,426,50.7%,33m
28174,3,Lqtjcrylgrtz,2628,1607,115,128,243,47.3%,10m
28174,2,CkopJLyllka,2628,971,80,72,152,52.6%,1h
28174,2,[DeathG]Ghostz,2628,868,71,58,129,55.0%,5m
28174,1,Wulfram,2628,586,61,51,112,54.5%,39m
28174,2,cookielord,2628,1100,58,33,91,63.7%,1h
28174,3,[UVs]mONCHiDeluxe,2628,922,41,44,85,48.2%,9m
28174,1,LiDLdude,2628,486,31,28,59,52.5%,4m
28174,1,[BEL]Zorrotwee,2628,780,29,31,60,48.3%,28m
28174,3,DonHubé,2628,381,17,19,36,47.2%,20m
28174,1,[DoVV]slytherPRIME,2628,330,13,11,24,54.2%,10m
28174,3,Miraje,2628,289,13,12,25,52.0%,14m
28174,1,Adrik,2628,221,8,9,17,47.1%,21m
28174,2,YYds,2628,206,8,11,19,42.1%,24m
28174,2,LaughingMan,2628,243,7,5,12,58.3%,10m
28174,1,Mayota,2628,116,5,6,11,45.5%,42m
28174,2,Kmout,2628,90,3,4,7,42.9%,9m
28174,2,Roman,2628,0,3,4,7,42.9%,26m
28174,2,[BGDEMO]UncontroLLL,2628,0,3,5,8,37.5%,26m
28174,1,Scutchi,2628,36,2,6,8,25.0%,28m
28174,2,AMIRALNICOR,2628,0,1,0,1,100.0%,1h
28174,3,Chamber,2628,0,1,2,3,33.3%,3m
28174,1,pomalaNca,2628,0,1,4,5,20.0%,54m
28174,2,[Users]Nosfiarmus,2628,0,0,1,1,0.0%,40m
28174,2,Jedi,2628,0,0,1,1,0.0%,38m
28174,2,baRRakudda,2628,0,0,2,2,0.0%,6m
28174,2,AlexSparoww,2628,0,0,3,3,0.0%,46m
28174,3,Curtice,2628,0,0,5,5,0.0%,1h
28203,1,Patrick,2627,1626,150,139,289,51.9%,10m
28203,1,YURA,2627,1295,52,55,107,48.6%,4m
28203,2,[LIE]dftghjgdfhdf,2627,868,38,24,62,61.3%,29m
28203,2,RtHonHaligon,2627,785,37,22,59,62.7%,54m
28203,2,NoMore,2627,750,33,24,57,57.9%,20m
28203,1,EIVEV,2627,652,24,23,47,51.1%,42m
28203,3,macaca,2627,392,20,30,50,40.0%,13m
28203,1,benet,2627,450,19,15,34,55.9%,1h
28203,1,GeO,2627,365,15,15,30,50.0%,21m
28203,2,DNSoul,2627,313,14,12,26,53.8%,40m
28203,3,[SMFC]Isegrimm,2627,324,14,20,34,41.2%,13m
28203,2,Sorry,2627,229,10,5,15,66.7%,21m
28203,2,MGD,2627,240,9,8,17,52.9%,35m
28203,1,San,2627,280,9,12,21,42.9%,41m
28203,2,[Тянки]MRMAR,2627,88,3,2,5,60.0%,34m
28203,1,Typhi,2627,142,3,3,6,50.0%,1h
28203,3,Jesse,2627,97,3,4,7,42.9%,7m
28203,2,Fartumasti,2627,58,2,1,3,66.7%,22m
28203,2,Atoss,2627,32,2,2,4,50.0%,27m
28203,2,kakaowazebra,2627,0,2,3,5,40.0%,60m
28203,3,MelodramatiK,2627,0,2,3,5,40.0%,54m
28203,2,Ourouk,2627,0,1,0,1,100.0%,7m
28203,2,[ЗЕRGТV]Максим,2627,0,1,0,1,100.0%,23m
28203,2,KripT,2627,93,1,1,2,50.0%,49m
28203,1,Afir,2627,0,1,1,2,50.0%,10m
28203,2,Brainiacs,2627,30,1,4,5,20.0%,59m
28203,2,javier,2627,0,0,1,1,0.0%,29m
28203,2,Magamarc,2627,0,0,1,1,0.0%,30m
28203,2,[THFX]Sutakku,2627,0,0,1,1,0.0%,1h
28203,2,Ender,2627,0,0,1,1,0.0%,60m
28203,3,Azerdark,2627,0,0,1,1,0.0%,34m
28234,2,[oooboy]makfek,2626,1618,141,132,273,51.6%,27m
28234,1,[PhoX]Robstaa,2626,1650,103,93,196,52.6%,10m
28234,1,RepoorT,2626,827,53,55,108,49.1%,28m
28234,1,oliverkush,2626,700,27,28,55,49.1%,51m
28234,3,glumanda,2626,610,21,28,49,42.9%,12m
28234,2,FoolWise,2626,514,19,21,40,47.5%,56m
28234,3,Sebixon,2626,369,16,19,35,45.7%,18m
28234,2,therock,2626,293,10,9,19,52.6%,1h
28234,1,[BIAE]frääääänk,2626,292,10,12,22,45.5%,1h
28234,1,mushy,2626,231,9,12,21,42.9%,9m
28234,1,[nan]Insane,2626,257,6,7,13,46.2%,5m
28234,2,light,2626,114,4,2,6,66.7%,41m
28234,2,DEKU,2626,149,4,3,7,57.1%,51m
28234,1,Nikitisik,2626,130,3,3,6,50.0%,20m
28234,3,[6th]DEMI,2626,0,2,2,4,50.0%,1h
28234,3,Sabbat,2626,89,2,3,5,40.0%,7m
28234,2,ChachouFR,2626,0,2,3,5,40.0%,59m
28234,3,HonkyMonky,2626,0,1,5,6,16.7%,1h
28234,2,akaTheBandit,2626,0,0,1,1,0.0%,8m
28234,3,xeno,2626,0,0,1,1,0.0%,1h
28234,3,[4EK]ewanleboss,2626,0,0,1,1,0.0%,44m
28234,2,LanCuster,2626,0,0,2,2,0.0%,1h
28234,2,lexluthor,2626,0,0,3,3,0.0%,1h
28257,2,EyeCan,2625,954,62,63,125,49.6%,6m
28257,3,PaBleG,2625,432,29,38,67,43.3%,6m
28257,1,Skillerz,2625,418,22,18,40,55.0%,1h
28257,2,Stefan,2625,465,20,10,30,66.7%,1h
28257,2,Rook,2625,512,18,15,33,54.5%,1h
28257,1,[696]ProfessoR,2625,514,16,23,39,41.0%,34m
28257,2,Gratwicke,2625,326,11,12,23,47.8%,7m
28257,1,Raidfish,2625,311,9,4,13,69.2%,6m
28257,1,[RSTM]Rexarll,2625,127,9,6,15,60.0%,41m
28257,2,Hydralich,2625,204,8,6,14,57.1%,40m
28257,3,llllllllllll,2625,62,6,5,11,54.5%,11m
28257,1,SevenFloor,2625,145,5,4,9,55.6%,27m
28257,3,HarterHarald,2625,97,4,2,6,66.7%,7m
28257,2,mou,2625,94,4,2,6,66.7%,45m
28257,2,[RadRat]DrFenris,2625,130,4,5,9,44.4%,4m
28257,1,[ЕМPIRE]MEFESTO,2625,155,4,5,9,44.4%,1h
28257,2,OGkarhu,2625,44,4,6,10,40.0%,28m
28257,3,[PrimeC]AKpRo,2625,60,4,9,13,30.8%,6m
28257,3,[4eTкIe]MonsaterR,2625,0,3,4,7,42.9%,8m
28257,1,[Какуля]Dogeater,2625,169,3,9,12,25.0%,41m
28257,2,MeWiL,2625,0,2,3,5,40.0%,38m
28257,1,TOBCYXOB,2625,0,2,4,6,33.3%,50m
28257,2,[Kingz]MILF,2625,90,2,5,7,28.6%,1h
28257,3,Skummis,2625,0,1,0,1,100.0%,1h
28257,2,ender,2625,0,1,2,3,33.3%,38m
28257,2,aheezaly,2625,0,1,2,3,33.3%,47m
28257,2,[Isas]loraco,2625,0,0,1,1,0.0%,30m
28257,2,Wyatt,2625,0,0,1,1,0.0%,29m
28257,2,Constantine,2625,0,0,3,3,0.0%,1h
28257,2,Platon,2625,0,0,3,3,0.0%,1h
28287,2,crazystone,2624,1237,613,621,1234,49.7%,13m
28287,1,WelcomeAw,2624,1576,231,220,451,51.2%,23m
28287,3,Derpling,2624,1476,96,99,195,49.2%,6m
28287,2,OBWV,2624,1596,85,66,151,56.3%,51m
28287,1,[PRAWN]theCrackFox,2624,625,27,26,53,50.9%,1h
28287,2,DrNewcastle,2624,549,21,17,38,55.3%,23m
28287,2,[KCKNB]llllllllllll,2624,450,19,6,25,76.0%,1h
28287,3,néo,2624,385,15,21,36,41.7%,10m
28287,2,MaXimum,2624,318,12,11,23,52.2%,25m
28287,1,DerStu,2624,353,12,19,31,38.7%,27m
28287,2,Toby,2624,314,11,15,26,42.3%,1h
28287,1,[NorthG]Jodyhateyou,2624,312,9,15,24,37.5%,48m
28287,2,Bleys,2624,216,8,9,17,47.1%,55m
28287,1,[Faith1]DAKE,2624,200,7,8,15,46.7%,36m
28287,2,pastilla,2624,176,6,4,10,60.0%,22m
28287,1,WhoDOESthat,2624,150,4,6,10,40.0%,5m
28287,1,[klanix]mamhinsyhn,2624,142,4,8,12,33.3%,20m
28287,1,Sanders,2624,136,4,9,13,30.8%,21m
28287,2,Deckim,2624,86,3,1,4,75.0%,37m
28287,2,Matte,2624,0,3,4,7,42.9%,42m
28287,2,Aleksey,2624,60,3,4,7,42.9%,41m
28287,1,alexzero,2624,114,3,9,12,25.0%,1h
28287,2,Rancho,2624,95,2,2,4,50.0%,1h
28287,2,RoachPizza,2624,0,2,3,5,40.0%,51m
28287,1,[АЧП]Skull,2624,123,2,7,9,22.2%,4m
28287,2,Ciciarampa,2624,0,1,0,1,100.0%,60m
28287,1,eProtest,2624,0,1,3,4,25.0%,32m
28287,3,[7a8DAN]DanSolo,2624,0,1,4,5,20.0%,32m
28287,2,monster,2624,0,0,1,1,0.0%,24m
28287,2,Ngasta,2624,0,0,1,1,0.0%,29m
28287,2,Soviet,2624,0,0,2,2,0.0%,42m
28287,1,rybakisa,2624,0,0,4,4,0.0%,21m
28319,3,IIIIIIIIIIII,2623,1016,96,96,192,50.0%,12m
28319,2,TheCoon,2623,1366,70,61,131,53.4%,24m
28319,1,[NUBBIE]STROY,2623,1599,69,67,136,50.7%,4m
28319,3,llllllllllll,2623,1026,41,40,81,50.6%,4m
28319,1,dichok,2623,560,19,23,42,45.2%,6m
28319,2,SoKoJI,2623,379,15,8,23,65.2%,9m
28319,1,LooneyTunes,2623,329,9,14,23,39.1%,32m
28319,3,Dmitry,2623,136,7,5,12,58.3%,9m
28319,3,Lawryn,2623,0,4,2,6,66.7%,1h
28319,2,DEXTER,2623,90,4,4,8,50.0%,57m
28319,2,Kazael,2623,95,3,3,6,50.0%,1h
28319,1,morda,2623,88,3,4,7,42.9%,10m
28319,1,Ultra,2623,30,3,5,8,37.5%,9m
28319,2,[lZornG]Alien,2623,30,2,2,4,50.0%,54m
28319,2,[PuNcyN]Maćko,2623,0,1,0,1,100.0%,5m
28319,2,nikotin,2623,0,1,0,1,100.0%,47m
28319,2,[PIZIKS]RIPer,2623,95,1,2,3,33.3%,40m
28319,2,Omega,2623,0,1,2,3,33.3%,7m
28319,3,Dakyna,2623,40,1,3,4,25.0%,50m
28319,2,Bazinga,2623,0,0,1,1,0.0%,1h
28319,1,TreebornFrog,2623,0,0,6,6,0.0%,40m
28340,1,shnorkell,2622,1666,221,211,432,51.2%,1h
28340,1,Preiby,2622,1483,103,94,197,52.3%,28m
28340,1,Solevita,2622,1283,84,90,174,48.3%,28m
28340,2,vikisek,2622,605,69,55,124,55.6%,22m
28340,1,Fon,2622,1388,59,56,115,51.3%,53m
28340,1,[TGTGTG]darkantoine,2622,941,35,30,65,53.8%,6m
28340,1,Gillerboy,2622,802,33,26,59,55.9%,1h
28340,3,Martishow,2622,434,24,29,53,45.3%,8m
28340,1,Святогор,2622,475,18,15,33,54.5%,1h
28340,1,Warlo,2622,299,13,10,23,56.5%,60m
28340,3,crw,2622,288,12,15,27,44.4%,3m
28340,2,[CJFF]JustLap,2622,286,11,6,17,64.7%,41m
28340,1,Atlas,2622,338,11,13,24,45.8%,48m
28340,1,Rippness,2622,326,10,13,23,43.5%,59m
28340,3,[DoEUW]Cinder,2622,248,9,17,26,34.6%,27m
28340,1,hisDudeness,2622,223,6,7,13,46.2%,36m
28340,2,PowerNap,2622,162,5,1,6,83.3%,1h
28340,1,Luman,2622,96,5,10,15,33.3%,33m
28340,2,Sylthar,2622,129,4,5,9,44.4%,8m
28340,3,Kryos,2622,38,3,5,8,37.5%,49m
28340,2,Furax,2622,0,3,5,8,37.5%,7m
28340,2,sant,2622,92,2,3,5,40.0%,8m
28340,3,MilkyWay,2622,0,2,3,5,40.0%,1h
28340,2,[YoiPop]DEN,2622,0,1,0,1,100.0%,52m
28340,2,Shorty,2622,0,1,0,1,100.0%,10m
28340,2,Satanademon,2622,0,1,0,1,100.0%,29m
28340,2,[titanm]sombre,2622,88,1,1,2,50.0%,51m
28340,2,Medon,2622,32,1,5,6,16.7%,37m
28340,1,bygui,2622,0,0,4,4,0.0%,36m
28369,2,Solakivi,2621,1636,262,241,503,52.1%,20m
28369,3,MZperX,2621,930,59,57,116,50.9%,27m
28369,3,[Natar]BroodLord,2621,718,30,35,65,46.2%,27m
28369,2,JohnAlone,2621,452,19,9,28,67.9%,52m
28369,2,LuSharp,2621,436,17,10,27,63.0%,20m
28369,2,Kamikatze,2621,207,13,12,25,52.0%,41m
28369,2,OldMan,2621,264,10,11,21,47.6%,8m
28369,2,[TSBS]progamer,2621,224,8,7,15,53.3%,23m
28369,1,DimonGold,2621,161,7,9,16,43.8%,41m
28369,3,[BloTi]Kozanostra,2621,161,5,5,10,50.0%,1h
28369,2,cKruk,2621,126,4,1,5,80.0%,44m
28369,3,Yota,2621,0,2,3,5,40.0%,30m
28369,2,itsRL,2621,0,2,5,7,28.6%,51m
28369,1,[5ExY]ThePerson,2621,78,2,9,11,18.2%,57m
28369,2,dots,2621,0,1,3,4,25.0%,56m
28369,2,Varjaga,2621,0,0,1,1,0.0%,6m
28369,2,bouuman,2621,0,0,1,1,0.0%,1h
28369,2,DeepSpace,2621,0,0,3,3,0.0%,1h
28387,2,heuretk,2620,1395,149,132,281,53.0%,52m
28387,1,bessporno,2620,1655,145,137,282,51.4%,6m
28387,2,Emergy,2620,1567,119,119,238,50.0%,6m
28387,1,curare,2620,1287,56,58,114,49.1%,31m
28387,1,Buran,2620,934,50,47,97,51.5%,48m
28387,1,Mallo,2620,599,22,23,45,48.9%,9m
28387,1,Hubert,2620,594,20,24,44,45.5%,21m
28387,3,[Gоld]Bonuz,2620,578,19,34,53,35.8%,9m
28387,2,FalconHeart,2620,422,16,17,33,48.5%,39m
28387,2,TwoLines,2620,412,16,22,38,42.1%,38m
28387,2,Odblask,2620,262,9,4,13,69.2%,22m
28387,2,Ermahgerd,2620,250,9,7,16,56.2%,1h
28387,2,ASahlin,2620,0,5,0,5,100.0%,4m
28387,3,Kirteezy,2620,94,5,3,8,62.5%,6m
28387,2,ваня,2620,139,4,2,6,66.7%,9m
28387,2,ShaDowNfav,2620,114,4,4,8,50.0%,4m
28387,1,[scMAUI]Jayden,2620,178,4,7,11,36.4%,50m
28387,2,Zuzya,2620,107,3,4,7,42.9%,29m
28387,2,[pndjos]NukeMan,2620,138,3,7,10,30.0%,10m
28387,2,KaLipsoo,2620,30,2,1,3,66.7%,30m
28387,2,мортопл,2620,0,2,1,3,66.7%,35m
28387,2,[Nagplz]JellyBear,2620,60,2,2,4,50.0%,1h
28387,2,TheOneUtrock,2620,30,1,1,2,50.0%,1h
28387,3,Hitman,2620,0,0,1,1,0.0%,32m
28387,2,lollegend,2620,0,0,1,1,0.0%,3m
28387,2,Felix,2620,0,0,2,2,0.0%,37m
28387,3,AkretUA,2620,0,0,3,3,0.0%,43m
28414,2,javibox,2619,1189,204,188,392,52.0%,11m
28414,1,batman,2619,696,71,71,142,50.0%,21m
28414,2,sarus,2619,367,64,56,120,53.3%,47m
28414,3,Saturn,2619,1397,61,59,120,50.8%,3m
28414,1,terminator,2619,671,23,26,49,46.9%,32m
28414,1,Ajkula,2619,329,18,12,30,60.0%,60m
28414,1,KRaTHaS,2619,384,14,9,23,60.9%,37m
28414,1,dResk,2619,348,11,14,25,44.0%,50m
28414,1,Ciprian,2619,341,10,12,22,45.5%,33m
28414,1,Protain,2619,206,9,7,16,56.2%,44m
28414,1,DimonoiD,2619,307,8,10,18,44.4%,50m
28414,2,[USWE]XofBlack,2619,178,6,7,13,46.2%,56m
28414,2,Willehpeh,2619,114,4,7,11,36.4%,41m
28414,1,NikoN,2619,124,4,10,14,28.6%,10m
28414,2,Роман,2619,60,3,0,3,100.0%,10m
28414,2,sixkiller,2619,90,3,3,6,50.0%,29m
28414,3,ZattaR,2619,42,3,4,7,42.9%,58m
28414,1,Quma,2619,30,3,5,8,37.5%,32m
28414,2,EvilZerg,2619,30,2,0,2,100.0%,20m
28414,2,GreatNutsack,2619,0,2,3,5,40.0%,47m
28414,3,Ranajay,2619,0,2,3,5,40.0%,30m
28414,2,Lexusnoguera,2619,0,2,3,5,40.0%,51m
28414,3,Krakodeel,2619,122,2,8,10,20.0%,8m
28414,3,Saggi,2619,62,2,13,15,13.3%,26m
28414,2,Soap,2619,0,1,2,3,33.3%,40m
28414,3,xianate,2619,42,1,2,3,33.3%,52m
28414,2,Piras,2619,0,1,2,3,33.3%,1h
28414,1,[Arrows]MorpehMaksim,2619,89,1,4,5,20.0%,28m
28414,3,Thingamabob,2619,0,0,2,2,0.0%,58m
28443,1,[PunPat]Dave,2618,1665,361,342,703,51.4%,1h
28443,2,empiricus,2618,1593,141,134,275,51.3%,1h
28443,2,Pavllo,2618,1205,73,72,145,50.3%,11m
28443,2,Kuolleille,2618,1204,50,45,95,52.6%,35m
28443,2,CARNAGE,2618,671,30,14,44,68.2%,52m
28443,2,Scorpio,2618,604,23,22,45,51.1%,35m
28443,2,even,2618,505,20,19,39,51.3%,40m
28443,3,Jooe,2618,450,20,21,41,48.8%,15m
28443,1,DoctorX,2618,347,14,13,27,51.9%,48m
28443,3,Voroth,2618,298,13,16,29,44.8%,9m
28443,1,xabi,2618,403,13,16,29,44.8%,1h
28443,1,Basset,2618,441,13,18,31,41.9%,9m
28443,2,[CVK]Livingdeath,2618,229,8,3,11,72.7%,46m
28443,2,[Щитон]Solpik,2618,122,5,4,9,55.6%,35m
28443,2,Artodoc,2618,0,4,4,8,50.0%,48m
28443,1,Elrinda,2618,108,3,8,11,27.3%,39m
28443,3,Murloc,2618,97,2,4,6,33.3%,24m
28443,1,cungfuzerg,2618,68,2,7,9,22.2%,58m
28443,2,[ConG]Skilldevache,2618,0,1,0,1,100.0%,35m
28443,2,Joost,2618,30,1,1,2,50.0%,9m
28443,3,[ChUdAk]Кошак,2618,0,1,2,3,33.3%,56m
28443,2,PjúPjú,2618,30,1,2,3,33.3%,37m
28465,1,Llpol,2617,1645,113,109,222,50.9%,47m
28465,3,Jari,2617,1122,98,92,190,51.6%,7m
28465,1,Etzu,2617,1118,85,84,169,50.3%,32m
28465,1,KuraJ,2617,1570,64,61,125,51.2%,28m
28465,1,Злыедетижгут,2617,1048,42,44,86,48.8%,10m
28465,2,strangelove,2617,681,28,24,52,53.8%,1h
28465,3,лопата,2617,670,24,27,51,47.1%,18m
28465,2,[C86]SpaCeFrogger,2617,514,18,18,36,50.0%,6m
28465,1,CoRtEZz,2617,443,16,19,35,45.7%,45m
28465,3,Hermes,2617,430,14,24,38,36.8%,27m
28465,2,Solek,2617,66,3,1,4,75.0%,60m
28465,2,Qelo,2617,60,3,2,5,60.0%,1h
28465,3,[SAoN]nightknight,2617,0,3,2,5,60.0%,7m
28465,3,skriinx,2617,121,3,5,8,37.5%,38m
28465,2,JustGo,2617,30,2,2,4,50.0%,1h
28465,3,GroovyG,2617,0,2,3,5,40.0%,58m
28465,2,umad,2617,0,2,3,5,40.0%,1h
28465,2,Sparky,2617,0,1,0,1,100.0%,38m
28465,2,MedicoPeste,2617,0,1,0,1,100.0%,22m
28465,1,ЗDShyrik,2617,0,1,4,5,20.0%,51m
28465,2,Fort,2617,0,0,1,1,0.0%,54m
28465,2,[Tahery]VADIM,2617,0,0,1,1,0.0%,9m
28465,2,ZaleksiZ,2617,0,0,2,2,0.0%,1h
28488,2,komazZZ,2616,1501,120,111,231,51.9%,52m
28488,1,Tacheki,2616,1065,53,40,93,57.0%,59m
28488,2,dDemon,2616,872,38,29,67,56.7%,20m
28488,1,[FLZG]CptFlow,2616,806,30,29,59,50.8%,21m
28488,1,[SaviOr]GhostKeeper,2616,586,24,18,42,57.1%,31m
28488,2,Muembe,2616,623,24,20,44,54.5%,4m
28488,2,herak,2616,491,22,27,49,44.9%,6m
28488,2,SteVartr,2616,439,17,15,32,53.1%,31m
28488,2,Fantomstrike,2616,344,13,6,19,68.4%,1h
28488,1,Hugalisk,2616,330,12,11,23,52.2%,38m
28488,2,[Ebalay]Ranger,2616,232,10,1,11,90.9%,49m
28488,1,[KS2]Omega,2616,276,9,11,20,45.0%,55m
28488,1,Fantasia,2616,326,9,16,25,36.0%,42m
28488,2,NUDEXxX,2616,238,8,7,15,53.3%,20m
28488,2,Smartyy,2616,214,8,7,15,53.3%,39m
28488,3,Endoplast,2616,182,7,19,26,26.9%,9m
28488,3,Leech,2616,135,4,5,9,44.4%,48m
28488,2,Gülli,2616,0,3,5,8,37.5%,8m
28488,2,Diems,2616,109,2,1,3,66.7%,1h
28488,3,Leitsac,2616,0,2,1,3,66.7%,22m
28488,1,Zarevok,2616,40,2,5,7,28.6%,45m
28488,1,[mineXD]Bumbi,2616,72,2,6,8,25.0%,20m
28488,2,Haldadrin,2616,0,1,0,1,100.0%,55m
28488,2,Animot,2616,0,1,0,1,100.0%,5m
28488,2,anakreon,2616,30,1,1,2,50.0%,1h
28488,3,Linky,2616,0,0,1,1,0.0%,22m
28488,2,Franjesco,2616,0,0,2,2,0.0%,46m
28488,2,KelT,2616,0,0,3,3,0.0%,49m
28516,1,Chestnut,2615,1561,207,188,395,52.4%,33m
28516,2,Gola,2615,1563,94,70,164,57.3%,34m
28516,3,SemiGhoul,2615,930,32,42,74,43.2%,16m
28516,2,Колдырь,2615,429,25,16,41,61.0%,1h
28516,2,[InitRu]consoleLog,2615,513,23,14,37,62.2%,25m
28516,3,Vectorfox,2615,390,14,22,36,38.9%,19m
28516,3,Wiley,2615,322,12,15,27,44.4%,15m
28516,3,Kropeczka,2615,249,11,12,23,47.8%,13m
28516,2,mrDetroid,2615,260,10,6,16,62.5%,3m
28516,1,[ISRI]Titano,2615,348,10,12,22,45.5%,37m
28516,2,[Thanas]Crysis,2615,196,8,6,14,57.1%,1h
28516,2,[Sewer]Dynamite,2615,188,6,2,8,75.0%,1h
28516,2,[ZERGSC]GovnaKusok,2615,140,5,1,6,83.3%,25m
28516,3,[KELLER]hotrod,2615,171,5,6,11,45.5%,1h
28516,1,[улей55]qwerty,2615,139,3,0,3,100.0%,9m
28516,1,[FSGT]Atorion,2615,88,3,4,7,42.9%,6m
28516,2,[TemG]MaKsImKaRU,2615,30,2,1,3,66.7%,5m
28516,2,LeChtoff,2615,30,2,3,5,40.0%,1h
28516,2,maxmaer,2615,0,1,0,1,100.0%,36m
28516,2,FoBoS,2615,0,1,0,1,100.0%,9m
28516,2,[Shr3Kd]ZinkaZa,2615,93,1,3,4,25.0%,51m
28516,3,DarthVader,2615,0,0,1,1,0.0%,41m
28516,2,BooMBorG,2615,0,0,1,1,0.0%,1h
28516,2,BUX,2615,0,0,1,1,0.0%,9m
28516,2,KazumaRose,2615,0,0,3,3,0.0%,44m
28541,1,Alex,2614,871,67,57,124,54.0%,31m
28541,2,Skydex,2614,368,17,9,26,65.4%,9m
28541,2,[CCake]Kiruma,2614,260,9,5,14,64.3%,40m
28541,2,LexX,2614,255,8,6,14,57.1%,9m
28541,2,Mauno,2614,174,6,6,12,50.0%,60m
28541,1,[AGBF]Byrtoszz,2614,74,3,5,8,37.5%,51m
28541,2,nnhE,2614,30,2,2,4,50.0%,55m
28541,2,Palma,2614,0,2,3,5,40.0%,47m
28541,2,[ATMO]MrAlex,2614,0,1,1,2,50.0%,52m
28541,1,[x1337x]MAS,2614,0,1,5,6,16.7%,5m
28541,2,[SPAINs]FeniX,2614,0,0,1,1,0.0%,37m
28541,2,KvoDosh,2614,0,0,1,1,0.0%,8m
28541,2,RahmatBAE,2614,0,0,2,2,0.0%,59m
28541,1,Medardus,2614,0,0,6,6,0.0%,40m
28555,3,[ExTr1m]zzKoZzz,2613,1119,146,129,275,53.1%,19m
28555,2,Marauder,2613,692,131,126,257,51.0%,17m
28555,2,Tricera,2613,945,48,29,77,62.3%,1h
28555,2,Clickbutt,2613,835,44,39,83,53.0%,52m
28555,3,Noobis,2613,498,31,43,74,41.9%,19m
28555,1,RedChekenBur,2613,676,23,23,46,50.0%,51m
28555,2,WizenCashew,2613,413,14,15,29,48.3%,49m
28555,2,Alex,2613,257,11,8,19,57.9%,9m
28555,1,[GNN]DrCreeps,2613,303,10,12,22,45.5%,1h
28555,1,SilmeToO,2613,255,9,9,18,50.0%,59m
28555,2,[Koban]Shisui,2613,163,5,0,5,100.0%,1h
28555,3,DarkHybrid,2613,201,5,5,10,50.0%,3m
28555,2,Azurok,2613,0,3,2,5,60.0%,1h
28555,2,[PParty]Plamenniy,2613,0,3,2,5,60.0%,35m
28555,1,Zutschini,2613,0,3,3,6,50.0%,36m
28555,2,Fourmi,2613,0,3,5,8,37.5%,51m
28555,1,deathstar,2613,193,3,7,10,30.0%,1h
28555,2,[mfxed]Imper,2613,0,2,3,5,40.0%,38m
28555,3,Смертник,2613,0,2,4,6,33.3%,7m
28555,1,Hule,2613,0,2,5,7,28.6%,5m
28555,2,Gnaff,2613,84,2,5,7,28.6%,26m
28555,1,Gozdon,2613,70,2,8,10,20.0%,1h
28555,2,Цепеш,2613,30,1,1,2,50.0%,44m
28555,2,[SmackB]PekЗl,2613,0,1,1,2,50.0%,1h
28555,3,klapek,2613,0,0,2,2,0.0%,37m
28555,2,MacroJackson,2613,0,0,2,2,0.0%,20m
28555,1,DonDauziona,2613,0,0,2,2,0.0%,1h
28582,3,JamesKirk,2612,1590,380,378,758,50.1%,6m
28582,1,Megamah,2612,980,48,41,89,53.9%,7m
28582,2,stoune,2612,855,35,31,66,53.0%,39m
28582,2,[axis]Benthe,2612,837,33,30,63,52.4%,59m
28582,1,Menigmadsen,2612,693,24,27,51,47.1%,29m
28582,1,JackONeill,2612,388,14,12,26,53.8%,50m
28582,2,[NIC]niclucky,2612,272,13,6,19,68.4%,1h
28582,1,[QX9650]angel,2612,299,12,9,21,57.1%,20m
28582,2,aliocha,2612,300,11,10,21,52.4%,30m
28582,2,Reiner,2612,262,9,10,19,47.4%,51m
28582,3,pirakula,2612,121,6,7,13,46.2%,1h
28582,1,[ElSuHu]GeneralGee,2612,302,6,16,22,27.3%,1h
28582,2,MrPlow,2612,118,5,4,9,55.6%,55m
28582,1,JamesKngiht,2612,143,5,7,12,41.7%,45m
28582,3,javividi,2612,0,4,2,6,66.7%,37m
28582,3,Linutz,2612,97,3,3,6,50.0%,43m
28582,2,SiiW,2612,0,3,5,8,37.5%,1h
28582,2,Lafik,2612,58,2,1,3,66.7%,1h
28582,2,Ansvipp,2612,0,2,3,5,40.0%,39m
28582,1,ShowKaTime,2612,0,2,3,5,40.0%,47m
28582,1,Aterwyn,2612,0,2,4,6,33.3%,33m
28582,2,Ryusaki,2612,0,1,0,1,100.0%,4m
28582,2,Sacrest,2612,0,1,0,1,100.0%,4m
28582,2,[SloT]Kocó,2612,30,1,2,3,33.3%,23m
28582,2,Zed,2612,30,1,2,3,33.3%,1h
28582,2,ADHD,2612,0,0,2,2,0.0%,56m
28582,2,[k1raen]CorbenDallas,2612,0,0,3,3,0.0%,7m
28609,1,Watain,2611,1665,205,200,405,50.6%,9m
28609,3,Angel,2611,1307,142,142,284,50.0%,28m
28609,3,Sib,2611,1166,82,68,150,54.7%,3m
28609,2,[WUBL]BoZz,2611,865,57,48,105,54.3%,57m
28609,1,Juhzn,2611,969,46,45,91,50.5%,4m
28609,3,KovarnyEnot,2611,679,28,26,54,51.9%,13m
28609,1,[LEIA]IIIIIIIIIIII,2611,879,28,35,63,44.4%,1h
28609,1,imgaytoday,2611,574,23,19,42,54.8%,20m
28609,2,chanzo,2611,376,15,14,29,51.7%,8m
28609,2,[QClan]opahs,2611,283,12,4,16,75.0%,1h
28609,1,Persil,2611,352,11,18,29,37.9%,21m
28609,3,Mathor,2611,261,8,13,21,38.1%,26m
28609,2,TheCreator,2611,182,7,0,7,100.0%,10m
28609,2,Exosome,2611,182,7,2,9,77.8%,41m
28609,2,Kingkong,2611,234,7,5,12,58.3%,23m
28609,2,[AviaN]Berserker,2611,176,7,11,18,38.9%,1h
28609,2,Piffpoff,2611,58,4,4,8,50.0%,37m
28609,2,Crowbar,2611,0,4,4,8,50.0%,17m
28609,3,[SLSL]Hyperdonkey,2611,38,3,5,8,37.5%,57m
28609,2,[SRAM]Famozeen,2611,60,3,8,11,27.3%,6m
28609,2,[CIique]Scribblenawt,2611,32,2,2,4,50.0%,23m
28609,2,Gasai,2611,30,2,2,4,50.0%,59m
28609,3,DaQookie,2611,44,1,3,4,25.0%,50m
28609,2,Arbiter,2611,0,0,1,1,0.0%,51m
28609,3,Verius,2611,0,0,1,1,0.0%,36m
28634,1,raiden,2610,1511,92,88,180,51.1%,45m
28634,3,[Shaju]Juniver,2610,1228,68,81,149,45.6%,5m
28634,2,Reimu,2610,1382,63,48,111,56.8%,59m
28634,1,OSOM,2610,460,62,58,120,51.7%,54m
28634,1,[MPTS]axelrod,2610,1531,57,62,119,47.9%,1h
28634,3,FoxWi,2610,585,24,28,52,46.2%,5m
28634,2,Bubaj,2610,612,22,21,43,51.2%,8m
28634,1,hamilyon,2610,612,21,22,43,48.8%,35m
28634,2,lmi,2610,457,20,17,37,54.1%,36m
28634,2,OrangeJuice,2610,326,11,8,19,57.9%,1h
28634,2,Kareful,2610,271,9,6,15,60.0%,40m
28634,2,maelb,2610,297,9,8,17,52.9%,44m
28634,2,SuckMyHuge,2610,214,7,3,10,70.0%,45m
28634,2,DarkSpectre,2610,225,6,9,15,40.0%,7m
28634,2,LrZl,2610,60,3,1,4,75.0%,1h
28634,1,[WOSCHD]khalZen,2610,105,3,9,12,25.0%,36m
28634,2,Mygicc,2610,30,2,0,2,100.0%,52m
28634,2,TouchpadHero,2610,58,2,1,3,66.7%,1h
28634,2,MADCAT,2610,30,2,2,4,50.0%,59m
28634,3,MrMB,2610,0,2,2,4,50.0%,37m
28634,2,SonOfSpider,2610,66,2,3,5,40.0%,1h
28634,2,AbsolvoTe,2610,0,0,1,1,0.0%,35m
28634,2,Eni,2610,0,0,2,2,0.0%,1h
28657,3,daulaus,2609,1207,99,99,198,50.0%,9m
28657,1,LoWeSt,2609,1320,48,49,97,49.5%,54m
28657,1,Derman,2609,1036,38,45,83,45.8%,26m
28657,2,ailuroq,2609,569,34,32,66,51.5%,51m
28657,2,Kibbicer,2609,697,30,32,62,48.4%,59m
28657,1,RadTaba,2609,539,24,19,43,55.8%,10m
28657,1,StarsCrapToo,2609,223,9,6,15,60.0%,25m
28657,2,Charmander,2609,226,8,3,11,72.7%,23m
28657,2,Empire,2609,208,8,5,13,61.5%,42m
28657,1,JUliusCäsar,2609,178,6,7,13,46.2%,23m
28657,2,Pollen,2609,118,5,5,10,50.0%,55m
28657,2,sabastocrato,2609,150,5,7,12,41.7%,55m
28657,1,ACETP,2609,48,2,5,7,28.6%,48m
28657,2,Ratazey,2609,0,1,0,1,100.0%,1h
28657,2,VampireLord,2609,0,0,1,1,0.0%,37m
28657,2,GHK,2609,0,0,1,1,0.0%,29m
28657,3,бма,2609,0,0,1,1,0.0%,1h
28657,2,[IllA]red,2609,0,0,4,4,0.0%,9m
28675,1,Андрейка,2608,1649,115,94,209,55.0%,6m
28675,3,Strixling,2608,1577,107,117,224,47.8%,12m
28675,1,Зигрейн,2608,756,42,33,75,56.0%,31m
28675,2,Varg,2608,664,28,23,51,54.9%,60m
28675,1,challenger,2608,812,26,28,54,48.1%,1h
28675,1,danjah,2608,653,22,26,48,45.8%,54m
28675,1,BamBook,2608,488,16,21,37,43.2%,10m
28675,2,Toxic,2608,368,12,10,22,54.5%,37m
28675,2,Samplicio,2608,180,9,6,15,60.0%,33m
28675,2,[SunTry]беды,2608,205,8,4,12,66.7%,41m
28675,1,ElSupeee,2608,164,8,6,14,57.1%,44m
28675,2,AlmightySwif,2608,180,6,6,12,50.0%,22m
28675,2,[WWOGU]Zero,2608,177,5,2,7,71.4%,45m
28675,2,Winchester,2608,128,5,5,10,50.0%,56m
28675,2,[KyPe]ApiReb,2608,120,5,5,10,50.0%,59m
28675,1,KRAB,2608,121,4,5,9,44.4%,20m
28675,2,pryaniksex,2608,157,3,3,6,50.0%,10m
28675,3,Andy,2608,94,3,14,17,17.6%,15m
28675,1,Kapecq,2608,0,2,3,5,40.0%,52m
28675,1,[SHRDD]pluga,2608,0,2,3,5,40.0%,41m
28675,3,MrFinch,2608,0,2,4,6,33.3%,47m
28675,2,[DТ]gidroom,2608,88,2,4,6,33.3%,39m
28697,3,[SddS]Drone,2607,970,130,137,267,48.7%,28m
28697,1,dosha,2607,1407,112,112,224,50.0%,42m
28697,2,VersaltoDIO,2607,960,51,28,79,64.6%,1h
28697,1,DarkNess,2607,1258,43,49,92,46.7%,36m
28697,2,Exindar,2607,821,40,19,59,67.8%,37m
28697,2,ZLOW,2607,934,37,30,67,55.2%,20m
28697,2,Komalarn,2607,341,14,9,23,60.9%,35m
28697,2,Melvin,2607,135,6,4,10,60.0%,1h
28697,3,XARTEMX,2607,140,6,4,10,60.0%,6m
28697,2,Reloecc,2607,206,6,7,13,46.2%,1h
28697,2,NebelYves,2607,186,6,8,14,42.9%,56m
28697,1,jin,2607,182,6,9,15,40.0%,23m
28697,2,asuia,2607,148,5,6,11,45.5%,4m
28697,3,[FLAX]bassic,2607,110,5,6,11,45.5%,48m
28697,2,[D0N3]WarPig,2607,0,0,1,1,0.0%,58m
28697,1,Doncarlos,2607,0,0,1,1,0.0%,34m
28697,2,SirOk,2607,0,0,3,3,0.0%,1h
28714,3,[IDGaGa]JAS,2606,1579,420,415,835,50.3%,13m
28714,1,HaloweenJake,2606,1659,227,221,448,50.7%,1h
28714,2,ferrum,2606,664,69,58,127,54.3%,51m
28714,1,Kiselini,2606,1334,62,61,123,50.4%,42m
28714,3,Juanito,2606,923,61,67,128,47.7%,12m
28714,2,[SPAINs]Sten,2606,1226,50,43,93,53.8%,1h
28714,1,Etircopyh,2606,904,47,44,91,51.6%,60m
28714,1,PaPaCharly,2606,1268,46,50,96,47.9%,1h
28714,1,[vivi]darkknight,2606,834,43,33,76,56.6%,42m
28714,3,Богомол,2606,881,42,48,90,46.7%,12m
28714,3,dominonzerg,2606,1069,40,42,82,48.8%,14m
28714,1,Reeji,2606,662,32,39,71,45.1%,21m
28714,2,Majkl,2606,179,21,9,30,70.0%,22m
28714,1,LukeStoneHm,2606,486,20,24,44,45.5%,1h
28714,2,[ZERGSC]makosin,2606,466,18,24,42,42.9%,5m
28714,2,QQmam,2606,307,17,9,26,65.4%,52m
28714,1,borkil,2606,328,11,12,23,47.8%,38m
28714,2,[LMBD]cderici,2606,224,8,2,10,80.0%,22m
28714,1,Canuma,2606,277,8,9,17,47.1%,5m
28714,2,[ioStuN]FluffyKitten,2606,202,6,4,10,60.0%,59m
28714,2,Samhain,2606,174,6,7,13,46.2%,23m
28714,3,Arkage,2606,171,6,8,14,42.9%,45m
28714,2,[DaFF]Adanos,2606,126,5,4,9,55.6%,37m
28714,2,[VoK]IlluMInaTTI,2606,62,3,0,3,100.0%,9m
28714,2,Clay,2606,88,3,3,6,50.0%,46m
28714,2,[UPwn]Caetano,2606,0,3,5,8,37.5%,10m
28714,2,Légion,2606,30,2,0,2,100.0%,57m
28714,2,KimYoungHo,2606,44,2,3,5,40.0%,40m
28714,1,PZh,2606,0,2,4,6,33.3%,20m
28714,3,[NukeZ]AirToss,2606,0,1,1,2,50.0%,1h
28714,2,Gzm,2606,30,1,2,3,33.3%,10m
28714,1,[findus]DjoKO,2606,38,1,9,10,10.0%,25m
28714,2,RaphyNova,2606,0,0,1,1,0.0%,44m
28714,3,Shellar,2606,0,0,1,1,0.0%,1h
28714,2,SexParty,2606,0,0,1,1,0.0%,23m
28749,1,[zpn3]JokerCap,2605,1389,62,41,103,60.2%,42m
28749,1,[MCat]HasuZwerg,2605,741,30,25,55,54.5%,51m
28749,2,[RE]Wotan,2605,593,23,20,43,53.5%,55m
28749,2,GaNiBal,2605,509,19,14,33,57.6%,1h
28749,2,unity,2605,440,16,16,32,50.0%,1h
28749,3,[jfcs]jules,2605,436,13,22,35,37.1%,12m
28749,2,Meteor,2605,333,12,8,20,60.0%,20m
28749,2,Koroc,2605,224,9,5,14,64.3%,9m
28749,1,Lazerbeam,2605,299,9,10,19,47.4%,60m
28749,2,DiGrizz,2605,226,7,6,13,53.8%,1h
28749,2,ZebbzeN,2605,146,6,4,10,60.0%,46m
28749,2,Stakks,2605,198,6,8,14,42.9%,23m
28749,2,[БУБУБ]Virtuzo,2605,148,6,10,16,37.5%,30m
28749,2,[132C0]Jenkins,2605,90,5,6,11,45.5%,20m
28749,3,[ZYB]Sworn,2605,58,4,4,8,50.0%,14m
28749,3,BarKot,2605,108,3,8,11,27.3%,50m
28749,1,TaBi,2605,140,2,2,4,50.0%,60m
28749,2,[xUfax]Dunhill,2605,0,2,3,5,40.0%,24m
28749,3,[LLTQ]argomina,2605,0,2,4,6,33.3%,1h
28749,2,StanensoN,2605,0,1,1,2,50.0%,29m
28749,1,[BNest]RedKing,2605,0,1,1,2,50.0%,27m
28749,2,[CMEN]TipRightef,2605,30,1,2,3,33.3%,22m
28749,2,[TTGL]KingofWeebs,2605,0,0,1,1,0.0%,25m
28749,2,ReaL,2605,0,0,2,2,0.0%,5m
28749,3,[lZornG]DArthurD,2605,0,0,3,3,0.0%,4m
28749,1,Killerloli,2605,0,0,6,6,0.0%,48m
28775,3,IIIIIIIIIIII,2604,449,100,108,208,48.1%,6m
28775,2,Swarm,2604,1487,62,60,122,50.8%,1h
28775,1,Saunt,2604,980,36,38,74,48.6%,32m
28775,1,Александр,2604,477,18,18,36,50.0%,1h
28775,1,[SR5]Wolfwood,2604,581,18,20,38,47.4%,32m
28775,3,Lumor,2604,108,5,6,11,45.5%,1h
28775,2,kio,2604,88,4,1,5,80.0%,30m
28775,1,Auskren,2604,0,2,3,5,40.0%,1h
28775,3,AdyCom,2604,38,2,5,7,28.6%,1h
28775,2,[OnDack]MrSmile,2604,0,1,0,1,100.0%,1h
28775,3,zzaaazzzzpp,2604,0,1,0,1,100.0%,49m
28775,2,NumotPT,2604,95,1,1,2,50.0%,42m
28775,2,iNaiix,2604,0,0,1,1,0.0%,26m
28788,3,Carbuz,2603,1522,220,221,441,49.9%,7m
28788,1,easy,2603,706,136,121,257,52.9%,4m
28788,2,Bob,2603,500,91,83,174,52.3%,57m
28788,2,buyukbaskan,2603,657,69,56,125,55.2%,10m
28788,3,Scorpion,2603,833,31,37,68,45.6%,16m
28788,3,Zoub,2603,776,27,38,65,41.5%,20m
28788,1,[SC22SC]Kseno,2603,605,24,20,44,54.5%,32m
28788,2,[BBXT]Azuvaal,2603,620,23,24,47,48.9%,33m
28788,2,[Kay2]Cato,2603,528,19,18,37,51.4%,20m
28788,2,[Lowko]AgentKami,2603,363,15,12,27,55.6%,60m
28788,1,Zmajo,2603,388,13,13,26,50.0%,44m
28788,2,SimoSpera,2603,259,10,10,20,50.0%,1h
28788,2,BARCODE,2603,324,9,19,28,32.1%,14m
28788,1,артемка,2603,235,8,10,18,44.4%,7m
28788,1,Selki,2603,0,4,2,6,66.7%,45m
28788,1,Garox,2603,158,4,3,7,57.1%,9m
28788,2,WTF,2603,94,3,5,8,37.5%,1h
28788,2,Oups,2603,30,2,2,4,50.0%,36m
28788,2,BeriyZ,2603,60,2,5,7,28.6%,56m
28788,2,[UPGR]allin,2603,0,1,0,1,100.0%,42m
28788,3,[НОД17]MenronVoque,2603,0,1,0,1,100.0%,58m
28788,2,Khan,2603,32,1,2,3,33.3%,1h
28788,3,xluciferx,2603,0,1,8,9,11.1%,14m
28788,2,ShomaKun,2603,0,0,1,1,0.0%,55m
28788,2,Stepych,2603,0,0,1,1,0.0%,8m
28813,3,Charlie,2602,1191,98,100,198,49.5%,5m
28813,2,Servietsky,2602,1596,93,85,178,52.2%,1h
28813,2,[NFGS]PAFF,2602,1519,64,56,120,53.3%,30m
28813,2,skirbSTJÄRNA,2602,1149,58,52,110,52.7%,46m
28813,1,ZaVDV,2602,420,16,14,30,53.3%,8m
28813,3,Mateja,2602,193,16,25,41,39.0%,6m
28813,2,fatfa,2602,148,7,5,12,58.3%,36m
28813,1,Rhaegar,2602,136,4,12,16,25.0%,48m
28813,2,AndresLoor,2602,115,3,1,4,75.0%,20m
28813,1,Roland,2602,104,3,7,10,30.0%,42m
28813,2,camelCaser,2602,32,2,0,2,100.0%,1h
28813,1,[øLTA]ArtisSedih,2602,0,2,3,5,40.0%,23m
28813,2,MikeSauce,2602,0,2,3,5,40.0%,39m
28813,3,TankBG,2602,0,1,6,7,14.3%,11m
28813,2,[1FU2]Had,2602,0,0,1,1,0.0%,1h
28828,3,IIIIllllIlIl,2601,1099,93,100,193,48.2%,26m
28828,2,zadrotyarik,2601,1436,78,63,141,55.3%,30m
28828,1,Agiriys,2601,1591,71,68,139,51.1%,59m
28828,2,Trym,2601,1251,58,56,114,50.9%,60m
28828,2,[Gayf]sambucca,2601,1213,55,55,110,50.0%,35m
28828,1,CatKnife,2601,1269,51,47,98,52.0%,47m
28828,3,Bloodwake,2601,1067,48,46,94,51.1%,18m
28828,2,QuickNDirtY,2601,750,47,37,84,56.0%,27m
28828,2,Imperius,2601,764,35,17,52,67.3%,1h
28828,2,babok,2601,874,35,31,66,53.0%,20m
28828,2,[НОД17]TugW,2601,794,31,23,54,57.4%,7m
28828,3,Devillion,2601,389,16,17,33,48.5%,5m
28828,1,tpfx,2601,412,15,16,31,48.4%,21m
28828,2,axe,2601,253,9,4,13,69.2%,24m
28828,2,SkyCleaner,2601,236,8,10,18,44.4%,60m
28828,2,Vollcod,2601,192,7,4,11,63.6%,9m
28828,2,Tuch,2601,216,7,4,11,63.6%,1h
28828,3,Hasenpups,2601,169,4,5,9,44.4%,54m
28828,2,Nix,2601,140,4,6,10,40.0%,10m
28828,2,Masa,2601,94,4,13,17,23.5%,18m
28828,2,HappyBirth,2601,88,3,6,9,33.3%,42m
28828,1,[D3LTA]SlyFoX,2601,0,2,3,5,40.0%,55m
28828,3,Strigg,2601,97,2,4,6,33.3%,46m
28828,2,LightElfTank,2601,0,1,0,1,100.0%,1h
28828,2,didjei,2601,88,1,1,2,50.0%,24m
28853,2,QMAcomplete,2600,1510,207,183,390,53.1%,1h
28853,3,Decubitus,2600,1495,122,116,238,51.3%,20m
28853,2,Jency,2600,372,47,47,94,50.0%,37m
28853,2,Goriliol,2600,465,30,46,76,39.5%,6m
28853,2,Bayesd,2600,603,26,15,41,63.4%,1h
28853,2,Panasratic,2600,615,24,18,42,57.1%,1h
28853,1,PDL,2600,512,19,22,41,46.3%,22m
28853,1,Wixon,2600,487,16,17,33,48.5%,29m
28853,2,IlIlIlIIllII,2600,372,15,9,24,62.5%,35m
28853,2,mllpoz,2600,352,13,10,23,56.5%,9m
28853,1,Karnifex,2600,326,12,11,23,52.2%,57m
28853,2,[HFun]morchar,2600,238,7,10,17,41.2%,58m
28853,2,whatwhatwhy,2600,90,4,4,8,50.0%,60m
28853,2,Yokozuna,2600,30,2,0,2,100.0%,1h
28853,2,Blaisik,2600,0,2,1,3,66.7%,9m
28853,2,Mallons,2600,102,2,1,3,66.7%,47m
28853,2,kronos,2600,0,2,3,5,40.0%,47m
28853,1,AndyBoy,2600,0,2,3,5,40.0%,45m
28853,3,[HEROgg]PanEca,2600,0,1,0,1,100.0%,22m
28853,2,Mikkel,2600,0,0,2,2,0.0%,51m
28873,3,GLHF,2599,1485,177,157,334,53.0%,7m
28873,1,[evola]worldshift,2599,1470,61,55,116,52.6%,45m
28873,2,snakeater,2599,679,26,32,58,44.8%,20m
28873,1,twocap,2599,746,25,31,56,44.6%,32m
28873,2,Cloudbob,2599,606,24,19,43,55.8%,20m
28873,1,Mkali,2599,211,20,21,41,48.8%,43m
28873,2,Maltos,2599,381,17,15,32,53.1%,4m
28873,2,Swayze,2599,194,13,12,25,52.0%,6m
28873,2,PlumpBear,2599,320,12,13,25,48.0%,55m
28873,2,JackLigting,2599,264,10,12,22,45.5%,40m
28873,3,[SCAV]IssuN,2599,129,5,3,8,62.5%,21m
28873,3,HazarD,2599,40,4,5,9,44.4%,3m
28873,2,EDRH,2599,0,2,3,5,40.0%,35m
28873,2,ROLF,2599,0,1,2,3,33.3%,42m
28873,2,PINATA,2599,0,1,4,5,20.0%,4m
28873,1,ClinLoy,2599,0,1,5,6,16.7%,1h
28873,3,[KerriS]Noobs,2599,0,0,1,1,0.0%,57m
28873,2,Schmock,2599,0,0,1,1,0.0%,25m
28873,2,Nastrom,2599,0,0,2,2,0.0%,32m
28873,2,MSTRmissCliK,2599,0,0,2,2,0.0%,1h
28873,2,[IMxGI]HobbyZocker,2599,0,0,2,2,0.0%,22m
28873,2,[LaggIT]Vidde,2599,0,0,3,3,0.0%,60m
28895,1,XYLON,2598,1257,77,79,156,49.4%,22m
28895,1,TenLetters,2598,1278,75,70,145,51.7%,1h
28895,1,Proven,2598,688,52,43,95,54.7%,10m
28895,2,vlad,2598,846,31,34,65,47.7%,1h
28895,2,Redbread,2598,530,22,21,43,51.2%,4m
28895,2,[fbk]Razgriz,2598,276,18,13,31,58.1%,23m
28895,2,Ibliss,2598,278,10,11,21,47.6%,52m
28895,2,[13NRV]robingood,2598,296,10,12,22,45.5%,57m
28895,2,Gromazeka,2598,286,10,12,22,45.5%,46m
28895,3,Laur,2598,199,9,13,22,40.9%,10m
28895,2,XpycTuK,2598,240,8,9,17,47.1%,30m
28895,1,JorgeStar,2598,249,8,10,18,44.4%,9m
28895,2,iNickX,2598,201,7,6,13,53.8%,59m
28895,2,[HØ]ladedrengen,2598,148,6,4,10,60.0%,24m
28895,2,Trusetyv,2598,92,4,2,6,66.7%,60m
28895,2,[D4T]Flow,2598,30,4,8,12,33.3%,10m
28895,2,KeY,2598,129,3,2,5,60.0%,48m
28895,2,Hopeless,2598,114,3,5,8,37.5%,60m
28895,1,GodsWill,2598,90,2,3,5,40.0%,45m
28895,2,[GnnnN]Xnat,2598,0,1,0,1,100.0%,40m
28895,3,gogetit,2598,97,1,2,3,33.3%,1h
28895,2,[Soldi]Ziv,2598,30,1,3,4,25.0%,9m
28895,2,[GoTerr]QuirkyTurtle,2598,30,1,3,4,25.0%,33m
28895,2,[Krueg]гамадрил,2598,0,0,1,1,0.0%,1h
28895,3,JohnWayne,2598,0,0,1,1,0.0%,1h
28920,1,Patratel,2597,1473,277,277,554,50.0%,51m
28920,1,withoutxp,2597,1616,97,95,192,50.5%,1h
28920,2,Fabien,2597,1428,84,70,154,54.5%,9m
28920,2,[Kicx]IceFox,2597,1539,78,58,136,57.4%,51m
28920,2,avos,2597,685,42,30,72,58.3%,9m
28920,3,Spambot,2597,362,14,15,29,48.3%,15m
28920,2,[gokuB]Ace,2597,308,10,7,17,58.8%,8m
28920,2,ART,2597,198,9,9,18,50.0%,24m
28920,1,[Miiik]crobe,2597,170,8,9,17,47.1%,1h
28920,2,[UndeD]Under,2597,210,7,10,17,41.2%,36m
28920,1,Tonic,2597,244,7,13,20,35.0%,48m
28920,2,Chard,2597,144,6,3,9,66.7%,33m
28920,2,SoldierTriad,2597,150,6,4,10,60.0%,1h
28920,2,CombatPilot,2597,150,6,7,13,46.2%,37m
28920,1,wojtek,2597,168,5,7,12,41.7%,57m
28920,2,Speedy,2597,139,4,2,6,66.7%,55m
28920,3,kepich,2597,34,4,3,7,57.1%,36m
28920,2,[Лакерс]Рик,2597,0,3,0,3,100.0%,40m
28920,3,SkannaIV,2597,0,3,5,8,37.5%,14m
28920,2,ASB,2597,30,2,0,2,100.0%,1h
28920,3,Larsenleft,2597,38,2,4,6,33.3%,58m
28920,1,пирожок,2597,0,2,4,6,33.3%,1h
28920,2,bischof,2597,0,2,5,7,28.6%,1h
28920,3,TamIIJIueP,2597,0,2,5,7,28.6%,1h
28920,3,Kerotic,2597,0,1,0,1,100.0%,1h
28920,2,[GkGrs]ReDragon,2597,0,1,1,2,50.0%,40m
28920,2,[BESY]Beny,2597,0,1,1,2,50.0%,51m
28920,2,[OMiD]LarvaCreEp,2597,0,0,1,1,0.0%,46m
28920,2,Ozverok,2597,0,0,1,1,0.0%,30m
28949,1,ElTuzo,2596,1068,61,54,115,53.0%,54m
28949,2,Esuges,2596,1000,48,35,83,57.8%,20m
28949,1,Gor,2596,670,43,38,81,53.1%,59m
28949,2,[EoNabs]Glutenfree,2596,790,35,19,54,64.8%,50m
28949,2,BlackLion,2596,418,33,18,51,64.7%,52m
28949,1,Supahsalami,2596,756,29,25,54,53.7%,51m
28949,3,Racon,2596,289,10,17,27,37.0%,14m
28949,1,Voollien,2596,214,7,11,18,38.9%,53m
28949,2,[BHC]Hilliti,2596,166,6,1,7,85.7%,57m
28949,1,MrHanky,2596,183,6,7,13,46.2%,6m
28949,2,sixsevan,2596,231,6,7,13,46.2%,44m
28949,2,[lMMl]Kettupaini,2596,128,5,7,12,41.7%,6m
28949,2,DenzelCurry,2596,159,5,7,12,41.7%,44m
28949,2,[PLA2N]ISyBeRI,2596,92,4,2,6,66.7%,1h
28949,2,BasWorld,2596,106,3,0,3,100.0%,36m
28949,2,WildPanda,2596,132,3,2,5,60.0%,47m
28949,1,Fusil,2596,95,3,5,8,37.5%,1h
28949,2,[SkBG]GetRektNoob,2596,30,2,0,2,100.0%,42m
28949,1,anthony,2596,0,2,1,3,66.7%,23m
28949,2,darksoul,2596,0,1,0,1,100.0%,36m
28949,2,Dionis,2596,0,1,3,4,25.0%,1h
28949,2,Vitafit,2596,0,0,1,1,0.0%,10m
28949,3,Linjo,2596,0,0,1,1,0.0%,49m
28949,3,[PPIG]JIFO,2596,0,0,1,1,0.0%,57m
28949,2,[CCRev]CheeseLord,2596,0,0,2,2,0.0%,60m
28974,1,[FrSlip]Leopard,2595,1499,96,91,187,51.3%,6m
28974,2,[Sencor]Leguan,2595,463,23,7,30,76.7%,10m
28974,2,Atomiusz,2595,566,23,18,41,56.1%,5m
28974,2,[BoEin]Teslon,2595,567,22,16,38,57.9%,23m
28974,2,UglyKidJoe,2595,485,18,15,33,54.5%,1h
28974,2,ajax,2595,387,14,15,29,48.3%,23m
28974,1,hentai,2595,267,11,11,22,50.0%,1h
28974,1,[КПCC]анскилл,2595,272,10,8,18,55.6%,32m
28974,2,Chetto,2595,211,8,4,12,66.7%,32m
28974,2,ManongJed,2595,141,5,5,10,50.0%,5m
28974,1,Hive,2595,213,5,9,14,35.7%,48m
28974,2,[xPAPPA]Generalen,2595,114,4,4,8,50.0%,30m
28974,3,[ßnDª]Kaptar,2595,97,3,3,6,50.0%,1h
28974,1,MaxV,2595,0,2,3,5,40.0%,29m
28974,1,Satchmo,2595,0,2,3,5,40.0%,23m
28974,3,PEAT,2595,0,2,4,6,33.3%,58m
28974,1,XWraith,2595,0,1,1,2,50.0%,10m
28974,2,[MG2K]MedusaHex,2595,0,1,1,2,50.0%,1h
28974,2,[KerriS]VirusTotal,2595,0,1,1,2,50.0%,30m
28974,2,imnub,2595,30,1,1,2,50.0%,1h
28974,3,purpleHerald,2595,0,1,4,5,20.0%,46m
28974,1,[SGEY]TYTY,2595,0,0,1,1,0.0%,34m
28974,2,ceko,2595,0,0,1,1,0.0%,39m
28974,2,Lolizerg,2595,0,0,2,2,0.0%,41m
28974,2,Serzh,2595,0,0,2,2,0.0%,1h
28999,3,Vestres,2594,1461,101,112,213,47.4%,5m
28999,2,GarethGore,2594,1517,63,59,122,51.6%,1h
28999,3,DIM,2594,1484,58,59,117,49.6%,6m
28999,2,[ShadAl]gomer,2594,973,41,34,75,54.7%,51m
28999,2,Ixonius,2594,649,39,31,70,55.7%,8m
28999,1,Ermn,2594,862,35,29,64,54.7%,1h
28999,1,Vli,2594,409,19,23,42,45.2%,6m
28999,2,Bomboni,2594,551,19,24,43,44.2%,60m
28999,1,[CОS]Simvol,2594,350,11,16,27,40.7%,48m
28999,1,[BISH]healweed,2594,288,10,11,21,47.6%,4m
28999,2,Alex,2594,230,8,10,18,44.4%,1h
28999,2,monoid,2594,84,5,3,8,62.5%,26m
28999,2,[WeDoM]Onja,2594,186,5,6,11,45.5%,34m
28999,1,GREG,2594,174,5,12,17,29.4%,47m
28999,1,[BrUUh]JoyMasu,2594,163,4,2,6,66.7%,34m
28999,3,SitixGallion,2594,168,4,5,9,44.4%,22m
28999,1,Turiya,2594,111,4,6,10,40.0%,33m
28999,2,Инкогнито,2594,60,3,1,4,75.0%,6m
28999,3,VileIIINine,2594,97,3,5,8,37.5%,7m
28999,2,Strange,2594,30,2,0,2,100.0%,7m
28999,2,Fixtry,2594,102,2,2,4,50.0%,36m
28999,1,[8472]Namir,2594,0,2,3,5,40.0%,8m
28999,3,ColdFire,2594,121,2,3,5,40.0%,1h
28999,2,Neimenovan,2594,0,1,1,2,50.0%,60m
28999,2,YouNeedLube,2594,30,1,2,3,33.3%,1h
28999,3,Karamell,2594,0,0,1,1,0.0%,1h
28999,2,sandman,2594,0,0,1,1,0.0%,32m
28999,2,Zeron,2594,0,0,2,2,0.0%,23m
28999,2,BOTasd,2594,0,0,3,3,0.0%,9m
29028,1,Zerga,2593,1252,50,43,93,53.8%,1h
29028,2,помидорка,2593,688,27,21,48,56.2%,1h
29028,1,[MeXI]LIMB,2593,482,16,20,36,44.4%,1h
29028,1,Kiwi,2593,475,15,20,35,42.9%,60m
29028,2,Blue,2593,248,14,12,26,53.8%,55m
29028,2,Alucarde,2593,296,12,10,22,54.5%,3m
29028,1,[SOWEST]Torinight,2593,343,11,2,13,84.6%,1h
29028,2,Someone,2593,150,10,9,19,52.6%,1h
29028,2,IlJacklI,2593,271,10,16,26,38.5%,4m
29028,2,Jonas,2593,172,8,7,15,53.3%,28m
29028,2,Kolos,2593,208,7,3,10,70.0%,59m
29028,2,punisher,2593,176,7,8,15,46.7%,1h
29028,1,Anton,2593,216,7,8,15,46.7%,1h
29028,2,[Sylph]ijsisglat,2593,186,6,4,10,60.0%,60m
29028,2,tjt,2593,166,5,2,7,71.4%,9m
29028,2,ZAKU,2593,112,4,3,7,57.1%,46m
29028,2,Ebbe,2593,137,4,6,10,40.0%,5m
29028,2,[LeWin]TotalTalent,2593,161,3,3,6,50.0%,20m
29028,2,[Floren]ACR,2593,102,2,1,3,66.7%,1h
29028,3,[VARUK]Redmesa,2593,121,2,2,4,50.0%,41m
29028,1,Lavliett,2593,0,2,3,5,40.0%,41m
29028,1,[ŁATWO]MagicznaRyba,2593,0,2,4,6,33.3%,51m
29028,1,SamiRami,2593,46,1,1,2,50.0%,1h
29028,2,Osk,2593,34,1,1,2,50.0%,24m
29028,3,Солнышко,2593,38,1,1,2,50.0%,24m
29028,2,[DEDAL]SwankyOwl,2593,30,1,2,3,33.3%,52m
29028,2,[GGWin]RobSnydeR,2593,0,0,2,2,0.0%,33m
29055,2,TomBombadil,2592,607,44,36,80,55.0%,52m
29055,2,Ikki,2592,925,34,43,77,44.2%,11m
29055,2,[DH120]IIIIIIIIIIII,2592,528,27,8,35,77.1%,36m
29055,2,Morty,2592,389,17,5,22,77.3%,8m
29055,2,Kotya,2592,261,10,12,22,45.5%,9m
29055,2,[VoxX]sghjJR,2592,184,7,4,11,63.6%,58m
29055,2,[Gøsu]ĐiamondĐrop,2592,222,7,6,13,53.8%,51m
29055,1,MrProper,2592,204,7,11,18,38.9%,36m
29055,2,plamen,2592,116,5,4,9,55.6%,23m
29055,2,DimON,2592,86,4,3,7,57.1%,34m
29055,2,HowdyCowboy,2592,30,4,3,7,57.1%,9m
29055,2,[sctrap]JungerPadawa,2592,94,4,5,9,44.4%,1h
29055,1,Phil,2592,106,4,9,13,30.8%,1h
29055,2,[GangDa]SieGe,2592,126,3,2,5,60.0%,60m
29055,2,SPEEDRON,2592,134,3,2,5,60.0%,1h
29055,2,Slayer,2592,96,2,0,2,100.0%,1h
29055,2,BlikBlouk,2592,30,2,2,4,50.0%,42m
29055,2,[EnFi]orlando,2592,0,2,2,4,50.0%,28m
29055,2,[ICCCPI]sSs,2592,0,1,3,4,25.0%,40m
29055,2,KridgiGames,2592,30,1,5,6,16.7%,6m
29055,1,[ƬC]WraithCraft,2592,0,0,1,1,0.0%,1h
29055,2,potap,2592,0,0,1,1,0.0%,7m
29055,2,FeeTourner,2592,0,0,2,2,0.0%,29m
29078,1,Pezdoled,2591,1609,519,512,1031,50.3%,5m
29078,1,Zealot,2591,912,63,52,115,54.8%,32m
29078,1,Medvediko,2591,509,23,17,40,57.5%,36m
29078,2,QuelDorei,2591,349,15,18,33,45.5%,11m
29078,1,Volrath,2591,329,12,12,24,50.0%,36m
29078,3,louis,2591,244,9,12,21,42.9%,15m
29078,2,[Wed3ad]deadred,2591,291,8,9,17,47.1%,36m
29078,3,Wasted,2591,80,5,7,12,41.7%,33m
29078,2,Song,2591,137,4,5,9,44.4%,3m
29078,3,håkon,2591,157,4,5,9,44.4%,1h
29078,2,pride,2591,58,4,5,9,44.4%,56m
29078,2,WhoCares,2591,100,4,6,10,40.0%,51m
29078,1,TETEDECHIPS,2591,149,4,7,11,36.4%,23m
29078,1,[NoLF]Brutaller,2591,146,4,10,14,28.6%,54m
29078,2,GOGI,2591,58,3,2,5,60.0%,23m
29078,1,leinaD,2591,46,2,0,2,100.0%,21m
29078,2,PIT,2591,30,2,1,3,66.7%,1h
29078,2,mRk,2591,60,2,3,5,40.0%,23m
29078,1,CrouchingPig,2591,0,1,4,5,20.0%,1h
29078,2,beldin,2591,0,0,1,1,0.0%,1h
29078,3,FunkyMonk,2591,0,0,2,2,0.0%,37m
29078,2,Gulynin,2591,0,0,2,2,0.0%,52m
29100,2,ArkKup,2590,1553,226,225,451,50.1%,1h
29100,3,lIlIlIlIlIlI,2590,614,225,212,437,51.5%,3m
29100,2,IIIIIIIIII,2590,1312,78,72,150,52.0%,23m
29100,2,Nazarka,2590,1149,48,36,84,57.1%,60m
29100,2,[DirStr]Stahor,2590,391,14,13,27,51.9%,37m
29100,1,DevilMayCry,2590,478,14,24,38,36.8%,22m
29100,2,КозакШвайка,2590,241,11,5,16,68.8%,40m
29100,1,zivil,2590,189,7,9,16,43.8%,51m
29100,3,Keytlan,2590,76,6,4,10,60.0%,7m
29100,2,PDIIIIIIIIII,2590,30,5,6,11,45.5%,16m
29100,3,OldTerran,2590,62,5,7,12,41.7%,27m
29100,2,Leventa,2590,30,4,3,7,57.1%,59m
29100,2,Akashi,2590,0,3,5,8,37.5%,1h
29100,2,thebestvaler,2590,40,2,0,2,100.0%,57m
29100,2,Natic,2590,30,2,2,4,50.0%,23m
29100,2,Colli,2590,30,2,2,4,50.0%,48m
29100,2,[TSotV]Numenesse,2590,0,2,3,5,40.0%,6m
29100,2,BøøLet,2590,92,2,7,9,22.2%,20m
29100,2,[TOCC]Vendetta,2590,0,1,0,1,100.0%,32m
29100,2,[Crews]MrSkiller,2590,0,1,0,1,100.0%,57m
29100,2,WARRIOR,2590,0,1,2,3,33.3%,25m
29100,2,WalkinBot,2590,0,1,4,5,20.0%,60m
29100,1,Vathos,2590,34,1,8,9,11.1%,34m
29123,1,[PdTus]Vogul,2589,1545,257,251,508,50.6%,45m
29123,2,maximusprime,2589,1627,155,162,317,48.9%,15m
29123,2,patriarch,2589,1145,60,52,112,53.6%,1h
29123,3,albeno,2589,707,40,50,90,44.4%,29m
29123,2,DaKid,2589,869,36,27,63,57.1%,1h
29123,2,PeeKaBQQ,2589,792,35,25,60,58.3%,1h
29123,3,Pavarotti,2589,467,19,22,41,46.3%,12m
29123,2,AngelofDead,2589,428,18,17,35,51.4%,42m
29123,1,ikonaut,2589,540,16,25,41,39.0%,5m
29123,2,CaptainLippy,2589,376,13,11,24,54.2%,23m
29123,2,Itachinew,2589,316,13,13,26,50.0%,51m
29123,3,[GURKI]blowfishfugu,2589,373,13,18,31,41.9%,5m
29123,2,GeGegeR,2589,212,8,11,19,42.1%,1h
29123,3,dradnote,2589,230,7,8,15,46.7%,3m
29123,1,Istarion,2589,0,5,4,9,55.6%,60m
29123,2,llllllllllll,2589,149,5,5,10,50.0%,39m
29123,2,[Dobro]PunisherJ,2589,126,4,0,4,100.0%,38m
29123,3,Seagull,2589,0,3,3,6,50.0%,26m
29123,3,SFL,2589,97,3,4,7,42.9%,22m
29123,3,Naikay,2589,97,3,4,7,42.9%,36m
29123,2,[NWGD]illia,2589,90,3,4,7,42.9%,46m
29123,1,whiner,2589,0,3,4,7,42.9%,10m
29123,2,[54D]adskiyDroch,2589,30,2,1,3,66.7%,47m
29123,2,NoGameNC,2589,62,2,4,6,33.3%,9m
29123,1,Spvolk,2589,70,2,8,10,20.0%,40m
29123,2,[CBFPL]LordInfestor,2589,0,1,0,1,100.0%,46m
29123,3,Истребитель,2589,0,0,2,2,0.0%,43m
29123,2,Ljone,2589,0,0,2,2,0.0%,47m
29151,1,Werhoz,2588,1627,150,154,304,49.3%,48m
29151,1,Avocadomaki,2588,847,81,81,162,50.0%,29m
29151,2,Tim,2588,1594,80,63,143,55.9%,1h
29151,1,Cxndr,2588,564,43,45,88,48.9%,6m
29151,1,Zingo,2588,886,33,30,63,52.4%,23m
29151,2,Mantis,2588,560,24,16,40,60.0%,9m
29151,2,Moon,2588,381,16,9,25,64.0%,36m
29151,2,SHALFEY,2588,330,15,4,19,78.9%,22m
29151,2,[AiRǂ]Bonsai,2588,408,15,14,29,51.7%,1h
29151,3,DelWin,2588,296,13,14,27,48.1%,3m
29151,1,QTMAN,2588,248,12,14,26,46.2%,36m
29151,3,Driss,2588,290,10,13,23,43.5%,29m
29151,2,Archy,2588,176,8,8,16,50.0%,25m
29151,1,nikolas,2588,86,8,9,17,47.1%,9m
29151,2,Appone,2588,178,6,3,9,66.7%,55m
29151,2,Magnific,2588,144,6,5,11,54.5%,52m
29151,2,[R2GrMa]Gaudi,2588,154,6,7,13,46.2%,5m
29151,3,Lastdude,2588,150,6,8,14,42.9%,6m
29151,2,IlyaTsyba,2588,120,4,6,10,40.0%,1h
29151,2,[pdrz]Massa,2588,96,3,5,8,37.5%,23m
29151,2,[TeamLB]Николай,2588,60,2,4,6,33.3%,55m
29151,2,Beeer,2588,0,1,0,1,100.0%,47m
29151,2,CalvinHarass,2588,32,1,5,6,16.7%,60m
29151,2,[DHAP]brigitte,2588,0,0,1,1,0.0%,57m
29151,2,Grusher,2588,0,0,1,1,0.0%,58m
29151,2,Grafkeks,2588,0,0,1,1,0.0%,50m
29151,2,Firinor,2588,0,0,2,2,0.0%,1h
29178,1,Hardbass,2587,1140,47,46,93,50.5%,6m
29178,3,[nps]Shade,2587,898,40,49,89,44.9%,28m
29178,2,Ryuzaki,2587,858,38,29,67,56.7%,1h
29178,2,[696]Daimiel,2587,375,16,15,31,51.6%,51m
29178,2,Gomreo,2587,369,14,9,23,60.9%,47m
29178,2,TheHummus,2587,280,11,12,23,47.8%,1h
29178,2,[LMBD]marulovetea,2587,200,8,5,13,61.5%,5m
29178,1,xxArenaMxx,2587,250,8,12,20,40.0%,47m
29178,2,SonOfSaatana,2587,170,7,8,15,46.7%,42m
29178,3,dhantist,2587,133,5,7,12,41.7%,26m
29178,2,Nick,2587,158,5,8,13,38.5%,1h
29178,2,Chronologia,2587,128,4,2,6,66.7%,46m
29178,2,Whiplash,2587,114,4,4,8,50.0%,25m
29178,2,[TaMort]IIIIIIIIIIII,2587,90,4,5,9,44.4%,42m
29178,3,battlerdreid,2587,78,4,6,10,40.0%,29m
29178,2,DixenFive,2587,60,3,4,7,42.9%,29m
29178,1,Mietfekatfe,2587,90,3,5,8,37.5%,39m
29178,2,[OrBeSo]HaterHUN,2587,0,2,3,5,40.0%,24m
29178,2,Basti,2587,0,2,4,6,33.3%,36m
29178,3,happyrouge,2587,97,1,1,2,50.0%,50m
29178,2,[ArKD3]danielo,2587,30,1,2,3,33.3%,9m
29178,2,PrisonDaddy,2587,0,1,3,4,25.0%,22m
29178,2,rob,2587,30,1,3,4,25.0%,42m
29178,2,[BULLA]ZarlecK,2587,0,0,1,1,0.0%,47m
29178,2,Vargala,2587,0,0,1,1,0.0%,1h
29178,2,Robotwizard,2587,0,0,2,2,0.0%,33m
29178,1,[SwaV]Leon,2587,0,0,3,3,0.0%,23m
29178,2,Clodius,2587,0,0,3,3,0.0%,23m
29178,1,filthyhero,2587,0,0,6,6,0.0%,6m
29207,3,crazhyouse,2586,1593,209,203,412,50.7%,4m
29207,2,[Свин]Assasin,2586,1575,74,71,145,51.0%,1h
29207,2,mikden,2586,1029,60,35,95,63.2%,28m
29207,2,Gref,2586,1211,50,38,88,56.8%,39m
29207,2,pypsik,2586,952,40,27,67,59.7%,28m
29207,1,[13NRV]Nerf,2586,509,29,26,55,52.7%,32m
29207,2,Stefanenkov,2586,364,24,20,44,54.5%,52m
29207,3,akendo,2586,534,18,27,45,40.0%,7m
29207,2,Shaman,2586,386,16,7,23,69.6%,1h
29207,1,Zarathustra,2586,354,15,13,28,53.6%,4m
29207,2,Falcon,2586,355,13,13,26,50.0%,37m
29207,3,feador,2586,316,11,18,29,37.9%,19m
29207,3,Mantis,2586,226,8,21,29,27.6%,11m
29207,2,[Skaro]LuLu,2586,126,4,0,4,100.0%,10m
29207,3,incipientOne,2586,30,3,4,7,42.9%,1h
29207,2,krypto,2586,108,3,6,9,33.3%,25m
29207,2,Thotorin,2586,0,3,6,9,33.3%,1h
29207,2,krakuseus,2586,30,2,1,3,66.7%,32m
29207,2,[cosset]МнеЧГода,2586,30,2,1,3,66.7%,28m
29207,2,AdmiralPyro,2586,0,1,0,1,100.0%,20m
29207,2,Probius,2586,30,1,1,2,50.0%,30m
29207,2,IIIIIIIIIIII,2586,0,0,1,1,0.0%,1h
29229,1,Skywalker,2585,1657,289,288,577,50.1%,10m
29229,2,ErnyCz,2585,1447,98,105,203,48.3%,11m
29229,2,[TAW]morqeus,2585,625,73,66,139,52.5%,32m
29229,2,Marshakk,2585,528,41,38,79,51.9%,30m
29229,1,Mattcattt,2585,741,28,33,61,45.9%,48m
29229,2,Jimp,2585,610,23,20,43,53.5%,24m
29229,2,[SiSn]WizardPow,2585,550,22,19,41,53.7%,55m
29229,1,KENTAURUS,2585,446,14,20,34,41.2%,1h
29229,1,Arthur,2585,155,5,4,9,55.6%,44m
29229,2,Cerodes,2585,182,5,4,9,55.6%,42m
29229,2,Ðundra,2585,126,5,7,12,41.7%,48m
29229,2,[DIJON1]Tanath,2585,60,2,5,7,28.6%,1h
29229,2,[BornG]Nominos,2585,0,1,0,1,100.0%,20m
29229,1,Perfectu,2585,0,1,1,2,50.0%,11m
29229,3,[SOWAR]LeaveX,2585,0,1,3,4,25.0%,5m
29229,1,Jacques,2585,0,0,1,1,0.0%,55m
29245,2,DDGms,2584,1341,113,100,213,53.1%,60m
29245,2,THEIRON,2584,1478,109,102,211,51.7%,51m
29245,2,Zorg,2584,1047,66,55,121,54.5%,20m
29245,2,Barius,2584,626,55,41,96,57.3%,1h
29245,1,Bulwark,2584,920,33,36,69,47.8%,58m
29245,2,exzaminator,2584,316,27,25,52,51.9%,1h
29245,2,PowerRanger,2584,439,18,9,27,66.7%,51m
29245,2,Mossel,2584,435,17,27,44,38.6%,17m
29245,2,докторЛешый,2584,406,14,8,22,63.6%,47m
29245,2,Nickname,2584,210,8,9,17,47.1%,30m
29245,2,far,2584,178,6,3,9,66.7%,20m
29245,2,PhillyJilly,2584,172,6,7,13,46.2%,36m
29245,1,SilentOne,2584,130,5,4,9,55.6%,1h
29245,2,akela,2584,0,3,2,5,60.0%,23m
29245,1,Dejjv,2584,125,3,5,8,37.5%,8m
29245,2,[FrSPR]Primus,2584,60,2,3,5,40.0%,7m
29245,1,FunkHyuk,2584,0,2,3,5,40.0%,47m
29245,2,Snapo,2584,0,1,1,2,50.0%,1h
29245,2,nilog,2584,0,0,1,1,0.0%,1h
29264,3,[LifeTV]MatteoZo,2583,1513,409,395,804,50.9%,12m
29264,1,Tony,2583,1420,67,70,137,48.9%,1h
29264,2,mammuluk,2583,576,41,38,79,51.9%,1h
29264,1,[CS0]BloodRayne,2583,863,35,30,65,53.8%,11m
29264,1,RizleR,2583,800,28,34,62,45.2%,7m
29264,2,NuBiK,2583,250,15,13,28,53.6%,30m
29264,2,SokolDV,2583,274,11,9,20,55.0%,25m
29264,2,TANOS,2583,203,7,4,11,63.6%,57m
29264,2,Barcode,2583,154,5,2,7,71.4%,51m
29264,3,[Zhig]TолянRu,2583,184,5,4,9,55.6%,42m
29264,2,ElUAF,2583,30,3,4,7,42.9%,5m
29264,1,[HTPeu]Donka,2583,0,2,3,5,40.0%,38m
29264,2,Domon,2583,0,2,3,5,40.0%,57m
29264,2,Black,2583,0,2,3,5,40.0%,1h
29264,3,Crean,2583,97,2,5,7,28.6%,30m
29264,2,BabaYaga,2583,89,1,1,2,50.0%,52m
29264,3,[HZeS]ЛексUРэквием,2583,0,1,2,3,33.3%,47m
29264,2,Spipe,2583,73,1,3,4,25.0%,32m
29264,3,[57A]Kez,2583,0,0,1,1,0.0%,43m
29264,3,[Tостер]KzFantomKz,2583,0,0,1,1,0.0%,38m
29264,2,MGL,2583,73,0,2,2,0.0%,30m
29264,2,Boec,2583,0,0,3,3,0.0%,60m
29264,1,TSM,2583,0,0,5,5,0.0%,27m
29287,2,Deniseg,2582,1164,161,144,305,52.8%,40m
29287,1,OldSkuLL,2582,1629,158,137,295,53.6%,44m
29287,2,yorgidi,2582,1582,125,109,234,53.4%,5m
29287,3,Twenny,2582,1604,106,120,226,46.9%,6m
29287,2,[DNGs]Frontela,2582,1314,91,89,180,50.6%,38m
29287,2,[HTPSC2]PolarArz,2582,1092,45,36,81,55.6%,51m
29287,2,ZergAxe,2582,739,38,38,76,50.0%,52m
29287,2,den,2582,931,38,38,76,50.0%,1h
29287,2,NIghtRaven,2582,534,23,22,45,51.1%,23m
29287,1,IIIIIIIIIII,2582,478,22,27,49,44.9%,54m
29287,1,PeddalToft,2582,490,20,19,39,51.3%,8m
29287,2,ivg,2582,508,19,16,35,54.3%,1h
29287,2,Serp,2582,330,13,15,28,46.4%,52m
29287,2,PaysSonny,2582,230,9,7,16,56.2%,44m
29287,1,Hannibal,2582,145,8,11,19,42.1%,5m
29287,2,Intriga,2582,168,7,6,13,53.8%,1h
29287,2,llllllllllll,2582,205,6,6,12,50.0%,7m
29287,2,[uCHAD]MrKolosPL,2582,112,5,3,8,62.5%,59m
29287,2,KingBoo,2582,122,5,5,10,50.0%,60m
29287,3,[LotPP]Loki,2582,145,4,5,9,44.4%,47m
29287,2,Axamiya,2582,88,3,5,8,37.5%,52m
29287,1,[Vips]fenix,2582,0,2,5,7,28.6%,7m
29287,2,[GSSCRY]ХитрыйКраб,2582,30,1,1,2,50.0%,33m
29287,2,NarenKat,2582,0,1,1,2,50.0%,1h
29287,2,Alex,2582,0,1,2,3,33.3%,1h
29287,1,Doodlesacker,2582,95,1,3,4,25.0%,1h
29287,1,[FASA]Bonersoup,2582,95,1,5,6,16.7%,60m
29287,1,[Amigos]Dimmu,2582,96,1,5,6,16.7%,9m
29287,3,circle,2582,34,1,8,9,11.1%,21m
29287,2,Gasoline,2582,0,0,1,1,0.0%,56m
29287,3,[KOFA]BojoNoja,2582,0,0,2,2,0.0%,50m
29287,2,[Nz4L]Kwosie,2582,0,0,3,3,0.0%,40m
29319,1,IIIllIlIlIlI,2581,1591,64,61,125,51.2%,4m
29319,1,[ПOHHИ]Serega,2581,1224,64,72,136,47.1%,22m
29319,2,Lomic,2581,706,37,28,65,56.9%,60m
29319,2,[WarKak]Codeglee,2581,692,34,31,65,52.3%,42m
29319,2,Hedos,2581,571,26,28,54,48.1%,23m
29319,2,Ghola,2581,447,19,14,33,57.6%,56m
29319,1,[BRPD]HitPlicT,2581,514,18,19,37,48.6%,60m
29319,1,unvershamt,2581,499,18,22,40,45.0%,58m
29319,1,IIAskaeLII,2581,340,10,14,24,41.7%,51m
29319,2,Utiranus,2581,238,8,6,14,57.1%,46m
29319,2,Carthias,2581,42,5,4,9,55.6%,41m
29319,2,taraon,2581,140,5,6,11,45.5%,23m
29319,3,RiseDenise,2581,72,4,6,10,40.0%,33m
29319,2,lerad,2581,0,3,2,5,60.0%,47m
29319,2,meGGaKill,2581,96,3,3,6,50.0%,38m
29319,2,TheTEMA,2581,88,2,0,2,100.0%,23m
29319,2,Sektor,2581,30,2,4,6,33.3%,42m
29319,2,Golonog,2581,68,2,4,6,33.3%,3m
29319,2,bronzodia,2581,0,1,1,2,50.0%,1h
29319,3,ExTress,2581,0,1,3,4,25.0%,1h
29319,2,nikita,2581,0,0,2,2,0.0%,52m
29319,2,overkill,2581,0,0,2,2,0.0%,1h
29341,1,POLIAK,2580,1625,93,95,188,49.5%,60m
29341,2,patwan,2580,860,53,24,77,68.8%,1h
29341,1,[IKD]drlazer,2580,1284,51,52,103,49.5%,53m
29341,2,[POLIMI]Aston,2580,1004,44,30,74,59.5%,1h
29341,1,DimonUA,2580,616,25,18,43,58.1%,29m
29341,3,bobs,2580,706,23,38,61,37.7%,18m
29341,1,cosmic,2580,620,22,25,47,46.8%,28m
29341,2,Anomandaris,2580,410,18,17,35,51.4%,34m
29341,3,DoCaCeBaL,2580,299,11,16,27,40.7%,7m
29341,1,volc,2580,0,3,2,5,60.0%,44m
29341,2,Nova,2580,58,3,3,6,50.0%,1h
29341,2,EMC,2580,30,3,4,7,42.9%,1h
29341,1,NIKSMIR,2580,72,3,4,7,42.9%,24m
29341,2,[LKVRS]убийца,2580,142,3,5,8,37.5%,57m
29341,3,[P00T]КэпНогЭбатор,2580,30,3,5,8,37.5%,53m
29341,1,leha,2580,0,2,3,5,40.0%,1h
29341,1,izzonu,2580,0,2,3,5,40.0%,58m
29341,2,Nùmenor,2580,0,2,3,5,40.0%,23m
29341,1,casualhuman,2580,0,2,4,6,33.3%,1h
29341,2,Soldjah,2580,72,2,7,9,22.2%,30m
29341,2,Vladramm,2580,0,1,1,2,50.0%,9m
29341,2,[ZERG7V]Prime,2580,0,0,1,1,0.0%,47m
29341,2,PaxMan,2580,0,0,2,2,0.0%,39m
29364,3,Nungwiman,2579,1166,98,100,198,49.5%,7m
29364,2,[IFAI]NAkamA,2579,1122,62,62,124,50.0%,20m
29364,2,[2M1B]Pippin,2579,1408,61,50,111,55.0%,20m
29364,2,Sadykw,2579,753,36,34,70,51.4%,56m
29364,1,benito,2579,846,35,31,66,53.0%,33m
29364,2,[Pita]MiniDeMocher,2579,541,18,21,39,46.2%,22m
29364,1,oneshotTHRLL,2579,536,17,21,38,44.7%,48m
29364,2,drukQ,2579,442,16,15,31,51.6%,1h
29364,1,[N0IP]Elander,2579,341,15,10,25,60.0%,1h
29364,1,Nykzo,2579,310,12,10,22,54.5%,55m
29364,2,DeFRout,2579,345,12,12,24,50.0%,9m
29364,2,NoOFix,2579,334,10,15,25,40.0%,42m
29364,1,Baku,2579,245,9,10,19,47.4%,5m
29364,1,Bambooja,2579,196,8,11,19,42.1%,48m
29364,2,hutkiz,2579,153,6,9,15,40.0%,51m
29364,2,[TeamBL]Monari,2579,131,4,6,10,40.0%,5m
29364,2,[Btow]Slaj,2579,116,4,9,13,30.8%,23m
29364,1,iadaci,2579,138,4,10,14,28.6%,7m
29364,1,Rygel,2579,97,3,3,6,50.0%,7m
29364,2,Waségégé,2579,0,0,1,1,0.0%,34m
29364,2,[ACDUM]TrollTove,2579,0,0,1,1,0.0%,24m
29385,2,HexagonSun,2578,1071,117,104,221,52.9%,1h
29385,2,Smoker,2578,1513,92,75,167,55.1%,40m
29385,2,Pomme,2578,1620,92,88,180,51.1%,4m
29385,1,[NWGD]GAx,2578,1378,63,57,120,52.5%,34m
29385,2,[PioD]Lisoedov,2578,558,26,16,42,61.9%,20m
29385,2,[HoboMT]HappyIzrod,2578,589,23,17,40,57.5%,60m
29385,1,cerseixd,2578,380,21,20,41,51.2%,50m
29385,1,[BloTi]GoZer,2578,324,21,26,47,44.7%,1h
29385,2,[just9E]kai,2578,532,20,21,41,48.8%,23m
29385,1,[TGJ]GicaTanku,2578,145,6,8,14,42.9%,44m
29385,2,Shurik,2578,116,4,2,6,66.7%,1h
29385,1,ZlyGolem,2578,105,4,6,10,40.0%,45m
29385,2,borthor,2578,92,3,5,8,37.5%,8m
29385,1,Pickeboo,2578,121,3,5,8,37.5%,41m
29385,1,SergeantMuff,2578,32,3,5,8,37.5%,10m
29385,2,TwoOneThree,2578,126,3,6,9,33.3%,47m
29385,2,ZergLingKing,2578,30,2,1,3,66.7%,48m
29385,1,MARTi,2578,0,2,3,5,40.0%,39m
29385,3,[DL2006]nagata,2578,0,1,0,1,100.0%,42m
29385,2,[Panas]Konkordus,2578,30,1,1,2,50.0%,52m
29385,1,MightyWings,2578,90,1,4,5,20.0%,42m
29385,2,KalaKukko,2578,0,0,1,1,0.0%,25m
29385,2,Инфэстос,2578,0,0,1,1,0.0%,40m
29385,3,Cristal,2578,0,0,1,1,0.0%,58m
29385,2,ЧАЙКА,2578,0,0,4,4,0.0%,9m
29410,1,ploii,2577,1577,109,103,212,51.4%,1h
29410,1,core,2577,1378,52,61,113,46.0%,58m
29410,1,Ryuk,2577,439,17,21,38,44.7%,36m
29410,1,DrunkenFist,2577,467,15,17,32,46.9%,29m
29410,1,Bricox,2577,411,14,15,29,48.3%,48m
29410,2,euskalmutila,2577,227,8,8,16,50.0%,36m
29410,3,[4BRO]Whiteshadows,2577,174,6,9,15,40.0%,10m
29410,2,Corrosivedge,2577,70,5,4,9,55.6%,3m
29410,1,stason,2577,168,5,12,17,29.4%,36m
29410,1,Sztandirr,2577,97,3,3,6,50.0%,40m
29410,2,UMdivad,2577,0,3,5,8,37.5%,46m
29410,1,Janzeer,2577,38,3,6,9,33.3%,1h
29410,1,[CHIGG]Jurius,2577,48,2,2,4,50.0%,57m
29410,2,Andrax,2577,132,2,3,5,40.0%,42m
29410,3,LOLOize,2577,0,2,4,6,33.3%,41m
29410,2,[InitRu]Batmen,2577,0,1,0,1,100.0%,57m
29410,2,мфтапрол,2577,88,1,1,2,50.0%,52m
29410,2,MiaManarote,2577,88,1,1,2,50.0%,52m
29410,2,rsh,2577,0,0,1,1,0.0%,23m
29429,1,ElEleyon,2576,1572,138,125,263,52.5%,58m
29429,2,Mightyretard,2576,1399,58,58,116,50.0%,28m
29429,2,InfTurtle,2576,594,36,31,67,53.7%,36m
29429,2,[GC]onkelBeejay,2576,429,17,15,32,53.1%,9m
29429,1,TeRa,2576,389,12,11,23,52.2%,10m
29429,2,FritolSVK,2576,188,11,16,27,40.7%,23m
29429,2,Catworm,2576,308,10,13,23,43.5%,6m
29429,2,[PVDG]Psycho,2576,225,9,7,16,56.2%,47m
29429,2,Blitzkrieg,2576,195,7,7,14,50.0%,52m
29429,2,[DFwN]Ikarus,2576,128,4,1,5,80.0%,20m
29429,2,LeBZzZDeL,2576,140,4,2,6,66.7%,32m
29429,2,Kingofwars,2576,86,3,4,7,42.9%,22m
29429,1,Rebbi,2576,123,3,6,9,33.3%,1h
29429,2,Daemonicus,2576,34,2,1,3,66.7%,36m
29429,2,[Hаsu]vitekes,2576,0,1,0,1,100.0%,48m
29429,2,AlexMeren,2576,0,1,0,1,100.0%,44m
29429,3,greg,2576,38,1,1,2,50.0%,47m
29429,2,kyle,2576,0,0,1,1,0.0%,33m
29429,2,[Сold]IIIIIIIIIIII,2576,0,0,1,1,0.0%,52m
29448,2,ZleH,2575,1602,88,81,169,52.1%,1h
29448,1,Sokolof,2575,1628,86,82,168,51.2%,20m
29448,2,[R4Time]KinGCOCkROaC,2575,1082,63,51,114,55.3%,36m
29448,2,DmitryCravt,2575,1007,43,29,72,59.7%,1h
29448,1,topwar,2575,853,37,30,67,55.2%,20m
29448,2,[TН]LamGen,2575,664,28,22,50,56.0%,9m
29448,2,Moritzdg,2575,423,23,14,37,62.2%,4m
29448,3,NIKXZ,2575,492,18,27,45,40.0%,14m
29448,2,Skeleton,2575,443,15,15,30,50.0%,31m
29448,2,Schuhsohle,2575,337,13,11,24,54.2%,56m
29448,2,[BaBaSC]KeKe,2575,360,13,13,26,50.0%,51m
29448,3,Pinball,2575,184,7,17,24,29.2%,13m
29448,3,[RusLv]ЭпичныйОН,2575,168,6,8,14,42.9%,15m
29448,2,Highlander,2575,155,5,4,9,55.6%,1h
29448,2,[éire]Korg,2575,155,4,3,7,57.1%,22m
29448,3,Myaaar,2575,97,3,4,7,42.9%,21m
29448,2,darkmaster,2575,90,3,6,9,33.3%,1h
29448,3,Hardek,2575,0,2,4,6,33.3%,1h
29448,1,greinern,2575,48,2,4,6,33.3%,47m
29448,2,Natasang,2575,0,0,1,1,0.0%,39m
29448,2,maDD,2575,0,0,1,1,0.0%,1h
29448,3,ZEUS,2575,0,0,1,1,0.0%,30m
29448,2,samtec,2575,0,0,2,2,0.0%,5m
29471,3,roj,2574,1551,80,87,167,47.9%,16m
29471,1,Onarr,2574,1027,51,52,103,49.5%,1h
29471,1,Meyo,2574,1229,48,49,97,49.5%,4m
29471,1,Trabbati,2574,1102,40,46,86,46.5%,40m
29471,2,[Petrиs]GREIS,2574,970,35,40,75,46.7%,1h
29471,2,end,2574,726,32,20,52,61.5%,33m
29471,2,Gym,2574,784,32,30,62,51.6%,20m
29471,2,Chewbe,2574,472,18,17,35,51.4%,1h
29471,1,[XupaK]MiltonDTF,2574,481,17,20,37,45.9%,22m
29471,2,Stygi,2574,345,14,14,28,50.0%,60m
29471,2,ICY,2574,270,9,8,17,52.9%,25m
29471,2,[ƈG]Tossah,2574,229,8,3,11,72.7%,44m
29471,2,[VDN]Zorn,2574,122,5,7,12,41.7%,1h
29471,2,[CLV]Legion,2574,102,3,0,3,100.0%,38m
29471,1,Макаров,2574,66,3,8,11,27.3%,4m
29471,2,[D0N3]SpaccaZerg,2574,88,2,0,2,100.0%,36m
29471,3,ШАТАЛБАЗУ,2574,0,2,3,5,40.0%,51m
29471,2,kamnevedov,2574,0,1,0,1,100.0%,25m
29471,2,eKata,2574,30,1,2,3,33.3%,29m
29471,2,UranusProbe,2574,0,1,2,3,33.3%,30m
29471,2,Vancraft,2574,0,0,1,1,0.0%,42m
29471,2,Woodcutter,2574,0,0,1,1,0.0%,55m
29471,3,Seleron,2574,0,0,1,1,0.0%,58m
29494,2,Cybersquir,2573,1309,84,84,168,50.0%,9m
29494,2,jellybean,2573,148,39,24,63,61.9%,36m
29494,2,konos,2573,893,37,33,70,52.9%,8m
29494,2,[PiLiCW]xuskeiro,2573,392,15,11,26,57.7%,1h
29494,1,Retaliator,2573,269,15,20,35,42.9%,54m
29494,2,[Чайник]AksKolyan,2573,335,14,14,28,50.0%,23m
29494,1,hiroes,2573,190,7,7,14,50.0%,21m
29494,2,Mojo,2573,142,7,8,15,46.7%,1h
29494,2,GrafAlbrecht,2573,196,6,7,13,46.2%,55m
29494,1,carlos,2573,162,6,8,14,42.9%,23m
29494,3,WestViper,2573,94,5,4,9,55.6%,10m
29494,2,glaDo,2573,146,4,1,5,80.0%,8m
29494,1,Tarkon,2573,114,2,1,3,66.7%,54m
29494,2,NooDs,2573,0,2,3,5,40.0%,50m
29494,3,Kanama,2573,0,2,4,6,33.3%,1h
29494,3,Free,2573,0,2,4,6,33.3%,36m
29494,3,Sanya,2573,0,1,0,1,100.0%,33m
29494,3,cobra,2573,0,1,0,1,100.0%,33m
29494,2,IFreez,2573,88,1,1,2,50.0%,4m
29494,2,Jdem,2573,73,1,3,4,25.0%,51m
29494,2,Legnacra,2573,0,1,4,5,20.0%,40m
29494,2,HeLa,2573,0,0,1,1,0.0%,56m
29494,2,StarKing,2573,0,0,1,1,0.0%,33m
29517,1,teDDyBear,2572,1653,74,77,151,49.0%,60m
29517,2,Ninja,2572,955,41,42,83,49.4%,49m
29517,1,[1FU2]Grapes,2572,310,11,16,27,40.7%,1h
29517,2,Kuzco,2572,224,9,3,12,75.0%,60m
29517,1,[ÆVT]ZerGisImbA,2572,234,9,9,18,50.0%,54m
29517,2,DarifiN,2572,167,8,4,12,66.7%,47m
29517,2,Tejonte,2572,171,7,7,14,50.0%,20m
29517,2,Ozen,2572,116,5,5,10,50.0%,58m
29517,2,JarRoD,2572,149,5,7,12,41.7%,59m
29517,1,OOOOOOOOO,2572,136,5,9,14,35.7%,7m
29517,2,Rogba,2572,0,3,3,6,50.0%,4m
29517,2,Reaper,2572,60,3,5,8,37.5%,38m
29517,3,Haleem,2572,0,3,5,8,37.5%,6m
29517,2,Krapan,2572,60,2,3,5,40.0%,20m
29517,2,Elzor,2572,136,2,3,5,40.0%,33m
29517,2,Monkey,2572,107,2,5,7,28.6%,40m
29517,2,Koolk,2572,60,2,5,7,28.6%,1h
29517,2,SaltySalad,2572,30,2,6,8,25.0%,34m
29517,2,Lakon,2572,0,1,0,1,100.0%,38m
29517,2,[Wick]IronHand,2572,0,0,1,1,0.0%,1h
29517,2,Sidius,2572,0,0,1,1,0.0%,38m
29517,1,[holyJ]psst,2572,0,0,1,1,0.0%,1h
29517,1,Captiddies,2572,0,0,3,3,0.0%,47m
29540,1,[Wensze]LlUuKk,2571,1002,71,63,134,53.0%,29m
29540,1,Zocram,2571,710,47,44,91,51.6%,4m
29540,2,BretAktaK,2571,511,34,31,65,52.3%,55m
29540,1,demiroot,2571,607,25,32,57,43.9%,25m
29540,1,Corenbaine,2571,449,16,18,34,47.1%,43m
29540,1,Spartacus,2571,468,16,23,39,41.0%,34m
29540,2,Nairda,2571,231,9,5,14,64.3%,4m
29540,2,Ganunu,2571,171,5,4,9,55.6%,36m
29540,2,Bell,2571,154,4,3,7,57.1%,1h
29540,1,PsychO,2571,123,4,9,13,30.8%,32m
29540,2,glebchik,2571,117,3,2,5,60.0%,23m
29540,2,Murcury,2571,130,3,4,7,42.9%,23m
29540,1,Thanos,2571,102,3,14,17,17.6%,33m
29540,2,Bazzie,2571,0,1,0,1,100.0%,20m
29540,2,[LOXA]BadFairyTale,2571,0,1,0,1,100.0%,60m
29540,2,Krtasek,2571,0,0,1,1,0.0%,40m
29540,2,Timmyb,2571,0,0,1,1,0.0%,4m
29540,2,EasyAI,2571,0,0,5,5,0.0%,1h
29558,2,[QaDo]Neversmile,2570,529,21,16,37,56.8%,4m
29558,2,Sturmotz,2570,496,17,18,35,48.6%,1h
29558,2,McBroody,2570,237,8,6,14,57.1%,51m
29558,1,Amagro,2570,69,7,11,18,38.9%,54m
29558,2,[TFSC]Tungsten,2570,152,5,8,13,38.5%,42m
29558,2,SowaFSLive,2570,160,5,10,15,33.3%,1h
29558,2,Guardian,2570,58,3,3,6,50.0%,36m
29558,2,HiotV,2570,97,2,2,4,50.0%,9m
29558,3,Olivcrer,2570,0,2,4,6,33.3%,54m
29558,1,MrSirene,2570,0,2,4,6,33.3%,1h
29558,2,[TedB]NEV,2570,30,1,2,3,33.3%,1h
29558,2,[DOGF]Carnovasch,2570,0,0,1,1,0.0%,1h
29558,2,smoker,2570,0,0,1,1,0.0%,47m
29558,3,Ritheu,2570,0,0,1,1,0.0%,54m
29558,2,mconqrtk,2570,0,0,2,2,0.0%,1h
29558,3,SHERIFF,2570,0,0,2,2,0.0%,1h
29574,2,Xyron,2569,1159,74,39,113,65.5%,23m
29574,1,Mateo,2569,1383,54,51,105,51.4%,7m
29574,3,unfgtn,2569,967,37,42,79,46.8%,11m
29574,1,Miakhil,2569,712,26,28,54,48.1%,10m
29574,2,EyeOfJustice,2569,537,23,21,44,52.3%,6m
29574,2,Oscalot,2569,457,20,15,35,57.1%,60m
29574,2,[USKL]Rulez,2569,418,17,14,31,54.8%,41m
29574,2,Cicco,2569,336,12,11,23,52.2%,36m
29574,2,[BWArmy]GABY,2569,198,8,8,16,50.0%,1h
29574,2,Ceezyy,2569,215,7,9,16,43.8%,1h
29574,2,Gza,2569,152,5,6,11,45.5%,51m
29574,2,Pompom,2569,141,4,5,9,44.4%,22m
29574,3,Curbitec,2569,125,3,1,4,75.0%,1h
29574,2,Mirodasc,2569,0,3,2,5,60.0%,33m
29574,2,ßlùdgódx,2569,94,2,5,7,28.6%,47m
29574,2,[Gottg]MrLong,2569,88,1,1,2,50.0%,1h
29574,2,[EXPANT]Drukaron,2569,44,1,5,6,16.7%,33m
29574,2,[MoopyS]Guidoge,2569,0,0,1,1,0.0%,4m
29592,2,HMP,2568,1011,63,53,116,54.3%,25m
29592,1,[SOSP]Amiral,2568,1116,60,61,121,49.6%,22m
29592,1,bourdonne,2568,1310,46,54,100,46.0%,48m
29592,1,monkeyzerg,2568,1018,40,40,80,50.0%,1h
29592,1,Kaiser,2568,444,34,36,70,48.6%,46m
29592,2,Has,2568,630,30,32,62,48.4%,58m
29592,1,IoSnLoSciame,2568,428,15,13,28,53.6%,4m
29592,2,korakchik,2568,275,11,7,18,61.1%,1h
29592,2,BTX,2568,219,8,3,11,72.7%,39m
29592,1,[BSnow]naglertattoo,2568,64,4,7,11,36.4%,26m
29592,2,seven,2568,60,3,4,7,42.9%,1h
29592,3,KmitazZzZ,2568,36,3,5,8,37.5%,42m
29592,3,TwilightFire,2568,38,3,5,8,37.5%,48m
29592,2,UnkownNoNine,2568,100,3,8,11,27.3%,6m
29592,2,Lucassimo,2568,30,2,1,3,66.7%,1h
29592,2,Copperhead,2568,0,2,3,5,40.0%,30m
29592,3,Babboz,2568,0,2,4,6,33.3%,58m
29592,2,Xadarr,2568,88,2,5,7,28.6%,1h
29592,2,WiKkee,2568,30,2,5,7,28.6%,37m
29592,2,[KLPAW]Beniek,2568,0,1,0,1,100.0%,37m
29592,2,nAiL,2568,88,1,1,2,50.0%,55m
29592,2,[glhfCZ]Toxin,2568,30,1,3,4,25.0%,60m
29592,1,noTuesday,2568,0,1,4,5,20.0%,8m
29592,2,СметанКа,2568,0,1,5,6,16.7%,1h
29592,1,Mebios,2568,0,0,4,4,0.0%,1h
29617,2,Sjokola,2567,1149,51,38,89,57.3%,39m
29617,2,Kikibon,2567,1085,48,33,81,59.3%,1h
29617,2,Brinziberfer,2567,402,25,8,33,75.8%,33m
29617,1,Linked,2567,440,24,30,54,44.4%,40m
29617,2,[Heroes]StragaSevera,2567,338,14,8,22,63.6%,38m
29617,2,[300gas]ZLEEzz,2567,298,14,9,23,60.9%,43m
29617,1,LiamNox,2567,274,10,14,24,41.7%,1h
29617,1,oli,2567,300,10,19,29,34.5%,60m
29617,1,Steeleague,2567,220,9,10,19,47.4%,1h
29617,2,LOPOT,2567,201,7,7,14,50.0%,40m
29617,2,Piotrkos,2567,194,7,9,16,43.8%,52m
29617,2,MLEET,2567,162,5,3,8,62.5%,45m
29617,2,RaiDmaN,2567,90,4,4,8,50.0%,1h
29617,2,[SPAINs]Avefenix,2567,122,4,7,11,36.4%,1h
29617,2,[HTWB]TraginGombor,2567,102,3,1,4,75.0%,1h
29617,3,DeadEye,2567,121,3,4,7,42.9%,20m
29617,1,[NNcity]nosochek,2567,0,2,1,3,66.7%,40m
29617,2,Berga,2567,30,2,2,4,50.0%,25m
29617,2,beesting,2567,0,1,0,1,100.0%,36m
29617,3,Vitcox,2567,0,1,1,2,50.0%,48m
29617,3,MrFer,2567,0,1,6,7,14.3%,1h
29617,3,Thor,2567,0,0,1,1,0.0%,1h
29617,2,DARTHKK,2567,0,0,1,1,0.0%,58m
29617,1,Litwos,2567,0,0,2,2,0.0%,1h
29641,1,Becherovka,2566,1570,147,135,282,52.1%,22m
29641,2,AliTraore,2566,1463,105,101,206,51.0%,23m
29641,1,Профсоюз,2566,1615,101,93,194,52.1%,42m
29641,3,DeChardin,2566,1596,99,108,207,47.8%,8m
29641,2,RocK,2566,1500,90,90,180,50.0%,39m
29641,2,haagendazs,2566,1472,90,93,183,49.2%,1h
29641,2,STORN,2566,1548,66,54,120,55.0%,24m
29641,2,Ivy,2566,870,65,55,120,54.2%,52m
29641,2,faiji,2566,1181,49,45,94,52.1%,10m
29641,2,[DL2006]Exdar,2566,894,38,25,63,60.3%,50m
29641,2,Ninja,2566,370,13,15,28,46.4%,1h
29641,2,CaptainBlue,2566,287,10,11,21,47.6%,60m
29641,2,ETL,2566,141,9,2,11,81.8%,25m
29641,2,BlackParrot,2566,229,7,6,13,53.8%,23m
29641,2,[iwnl]DOKHO,2566,195,7,8,15,46.7%,24m
29641,2,BigPlane,2566,152,4,3,7,57.1%,10m
29641,2,Fatnub,2566,30,4,4,8,50.0%,26m
29641,2,Killer,2566,116,3,1,4,75.0%,1h
29641,1,Sohillo,2566,121,3,2,5,60.0%,51m
29641,1,LovEmAll,2566,105,3,3,6,50.0%,36m
29641,1,Dhakra,2566,0,2,3,5,40.0%,41m
29641,2,Merkenau,2566,30,1,3,4,25.0%,40m
29641,2,Oameni,2566,121,1,5,6,16.7%,52m
29641,2,Rocinante,2566,0,0,1,1,0.0%,10m
29641,2,GACHIMUCHI,2566,0,0,1,1,0.0%,52m
29641,2,FlexBeier,2566,0,0,1,1,0.0%,47m
29641,1,Bahamut,2566,0,0,2,2,0.0%,45m
29668,2,Egr,2565,364,51,25,76,67.1%,38m
29668,2,Mäxxx,2565,918,49,41,90,54.4%,49m
29668,1,Mdehl,2565,1070,39,39,78,50.0%,52m
29668,2,ZEK,2565,331,16,8,24,66.7%,52m
29668,2,Liksio,2565,346,15,4,19,78.9%,1h
29668,2,Fega,2565,192,8,2,10,80.0%,52m
29668,2,Krurgor,2565,100,5,7,12,41.7%,5m
29668,3,ZaЯц,2565,146,4,5,9,44.4%,47m
29668,2,ButBeware,2565,116,4,6,10,40.0%,1h
29668,2,Kipasa,2565,0,3,5,8,37.5%,1h
29668,2,[ExTr1m]LUX,2565,60,2,3,5,40.0%,43m
29668,2,Valouch,2565,0,1,0,1,100.0%,59m
29668,2,valshmel,2565,0,1,0,1,100.0%,52m
29668,2,[JooJoo]Protopop,2565,0,1,1,2,50.0%,57m
29668,2,Overmind,2565,32,1,4,5,20.0%,1h
29668,2,[LFTW]XLoRD,2565,0,0,1,1,0.0%,36m
29668,2,NightMare,2565,0,0,1,1,0.0%,26m
29668,2,Adri,2565,0,0,1,1,0.0%,33m
29668,2,FrostyFeet,2565,0,0,1,1,0.0%,53m
29687,1,OrangeSlime,2564,1648,353,346,699,50.5%,46m
29687,2,BadLuckBird,2564,628,37,42,79,46.8%,1h
29687,2,Dirtysaam,2564,592,25,20,45,55.6%,23m
29687,2,Berilii,2564,493,20,17,37,54.1%,20m
29687,1,Ornitorrinko,2564,451,14,18,32,43.8%,22m
29687,2,proBeHeaVy,2564,325,13,12,25,52.0%,39m
29687,1,Maxlo,2564,362,11,20,31,35.5%,33m
29687,1,Assassin,2564,262,10,9,19,52.6%,4m
29687,2,XTITCH,2564,280,10,13,23,43.5%,1h
29687,2,PrinzRolle,2564,204,8,9,17,47.1%,29m
29687,2,Vagabond,2564,232,8,10,18,44.4%,30m
29687,2,GhostMurlocs,2564,108,3,0,3,100.0%,36m
29687,2,manith,2564,134,2,1,3,66.7%,21m
29687,2,[CBTW]Icybolt,2564,0,2,1,3,66.7%,47m
29687,2,leonardo,2564,30,2,3,5,40.0%,24m
29687,2,Anx,2564,0,1,1,2,50.0%,1h
29687,2,drMancino,2564,30,1,3,4,25.0%,55m
29687,3,Alarion,2564,0,0,1,1,0.0%,8m
29687,2,drunk,2564,0,0,2,2,0.0%,1h
29687,2,MoeSzyslak,2564,0,0,4,4,0.0%,50m
29707,1,Jiminimonka,2563,1638,245,247,492,49.8%,4m
29707,3,Finjaeger,2563,1546,180,190,370,48.6%,19m
29707,3,ILYAufa,2563,1535,148,147,295,50.2%,8m
29707,2,Benzitler,2563,1121,67,58,125,53.6%,40m
29707,2,Glutołaz,2563,717,56,43,99,56.6%,4m
29707,2,ezicik,2563,1330,50,54,104,48.1%,1h
29707,2,[HDPL]fory,2563,1065,48,32,80,60.0%,60m
29707,1,[LESeV]Wani,2563,916,43,45,88,48.9%,32m
29707,1,Vladchlen,2563,1061,38,43,81,46.9%,55m
29707,2,[iSucks]Honik,2563,681,37,11,48,77.1%,5m
29707,1,[MSTPLS]Delmortis,2563,862,32,36,68,47.1%,1h
29707,1,Kapis,2563,709,29,24,53,54.7%,21m
29707,2,[TIREL]Escalibur,2563,683,28,22,50,56.0%,36m
29707,2,[Horst]flex,2563,295,28,28,56,50.0%,23m
29707,2,Tusko,2563,622,26,23,49,53.1%,26m
29707,2,Ghost,2563,472,23,12,35,65.7%,37m
29707,1,DDA,2563,242,23,27,50,46.0%,36m
29707,2,Arcane,2563,249,12,6,18,66.7%,1h
29707,2,Dehaka,2563,294,11,8,19,57.9%,42m
29707,2,JDizzle,2563,156,6,11,17,35.3%,11m
29707,1,[Catory]MAKSIO,2563,183,5,9,14,35.7%,1h
29707,2,Faint,2563,102,3,0,3,100.0%,31m
29707,2,Erasmus,2563,88,3,3,6,50.0%,57m
29707,3,DezGar,2563,42,3,4,7,42.9%,54m
29707,3,[SPАRТА]LEXX,2563,123,3,6,9,33.3%,4m
29707,3,Pokec,2563,135,3,6,9,33.3%,4m
29707,2,PoloTB,2563,30,2,2,4,50.0%,40m
29707,1,ImbaStranniK,2563,0,2,3,5,40.0%,55m
29707,2,bagnet,2563,58,2,4,6,33.3%,39m
29707,3,LSM,2563,0,2,6,8,25.0%,7m
29707,2,Duplo,2563,66,2,7,9,22.2%,58m
29707,2,Eric,2563,0,1,0,1,100.0%,25m
29707,1,danchik,2563,0,0,1,1,0.0%,1h
29707,2,GonzaloUli,2563,0,0,3,3,0.0%,52m
29741,2,Janbour,2562,1069,47,36,83,56.6%,56m
29741,2,[EESC]Solidmiki,2562,446,25,23,48,52.1%,1h
29741,2,[GET]sebOt,2562,466,15,20,35,42.9%,5m
29741,2,inskin,2562,351,15,21,36,41.7%,1h
29741,1,Kam,2562,353,11,14,25,44.0%,48m
29741,2,[RDDN]Tsyuko,2562,204,7,7,14,50.0%,1h
29741,2,[OUUH]KonekoChat,2562,138,5,3,8,62.5%,56m
29741,2,habbomatrix,2562,0,2,3,5,40.0%,4m
29741,3,Artemitol,2562,0,2,4,6,33.3%,38m
29741,1,Fenris,2562,97,2,4,6,33.3%,54m
29741,3,benepaille,2562,0,1,0,1,100.0%,54m
29741,2,puresilvrboy,2562,88,1,1,2,50.0%,1h
29741,1,[Psyk]tisdag,2562,34,1,4,5,20.0%,57m
29741,2,Morznak,2562,0,1,4,5,20.0%,23m
29741,1,Surtur,2562,0,1,6,7,14.3%,5m
29741,2,Todi,2562,0,0,1,1,0.0%,29m
29741,2,mmm,2562,0,0,1,1,0.0%,53m
29758,2,stwls,2561,1557,430,412,842,51.1%,9m
29758,1,Sielunveli,2561,1642,147,152,299,49.2%,54m
29758,1,Kvant,2561,1377,49,57,106,46.2%,58m
29758,2,KLM,2561,596,25,22,47,53.2%,50m
29758,3,shpet,2561,667,24,38,62,38.7%,16m
29758,2,[LOIX]Zibiak,2561,597,23,21,44,52.3%,57m
29758,2,Timurkin,2561,401,14,13,27,51.9%,1h
29758,2,bolshak,2561,218,10,11,21,47.6%,47m
29758,1,theDZA,2561,252,10,13,23,43.5%,54m
29758,3,Asasila,2561,220,7,0,7,100.0%,53m
29758,2,Антошка,2561,146,6,5,11,54.5%,36m
29758,2,DimonLV,2561,204,6,6,12,50.0%,60m
29758,2,Marlow,2561,134,6,9,15,40.0%,1h
29758,1,Vladimer,2561,166,5,3,8,62.5%,48m
29758,2,Батон,2561,126,4,1,5,80.0%,25m
29758,3,POStishka,2561,0,3,4,7,42.9%,1h
29758,3,Choovak,2561,121,2,2,4,50.0%,35m
29758,1,[MЕDOЕD]NecroDragon,2561,0,2,3,5,40.0%,55m
29758,2,PayBooM,2561,0,2,3,5,40.0%,56m
29758,2,badford,2561,60,2,3,5,40.0%,26m
29758,2,puzan,2561,0,1,0,1,100.0%,53m
29758,2,Zmajmun,2561,0,1,1,2,50.0%,51m
29758,2,Microwave,2561,0,1,3,4,25.0%,1h
29758,2,[THANOS]RAYMANKAPEEN,2561,0,0,1,1,0.0%,1h
29758,3,ZёrgImba,2561,0,0,1,1,0.0%,50m
29758,2,ImmerEssen,2561,0,0,1,1,0.0%,57m
29758,2,BlumeCorp,2561,0,0,1,1,0.0%,4m
29758,2,[DFgsA]NightHunter,2561,0,0,3,3,0.0%,22m
29786,2,llllllllllll,2560,1485,196,200,396,49.5%,12m
29786,2,Bordun,2560,1578,74,69,143,51.7%,10m
29786,1,[SupprM]SupremCC,2560,861,35,35,70,50.0%,1h
29786,2,Ellinas,2560,789,29,29,58,50.0%,49m
29786,2,Sprouts,2560,348,14,12,26,53.8%,23m
29786,1,Sheparde,2560,456,14,17,31,45.2%,42m
29786,1,RaChoU,2560,274,14,24,38,36.8%,36m
29786,2,evgen,2560,238,11,12,23,47.8%,5m
29786,1,ARX,2560,209,7,10,17,41.2%,1h
29786,2,Adora,2560,206,7,14,21,33.3%,1h
29786,2,[TAW]Senbean,2560,142,5,7,12,41.7%,22m
29786,3,MasterCatII,2560,0,4,1,5,80.0%,50m
29786,3,[Эсперт]Shiroe,2560,86,4,2,6,66.7%,22m
29786,1,Sparky,2560,74,4,7,11,36.4%,7m
29786,2,Gakke,2560,100,4,7,11,36.4%,4m
29786,3,Hampoz,2560,121,3,0,3,100.0%,10m
29786,3,jerkopederko,2560,0,3,2,5,60.0%,1h
29786,3,SuperPower,2560,121,3,3,6,50.0%,44m
29786,2,KIA,2560,88,3,7,10,30.0%,23m
29786,2,SuicidalVirg,2560,90,3,20,23,13.0%,11m
29786,2,Stark,2560,88,2,1,3,66.7%,60m
29786,2,Alex,2560,99,2,2,4,50.0%,31m
29786,1,EskanderUA,2560,141,2,5,7,28.6%,28m
29786,2,Récro,2560,30,1,4,5,20.0%,24m
29786,2,Danille,2560,0,0,1,1,0.0%,33m
29786,3,JimRascom,2560,0,0,1,1,0.0%,21m
29786,3,Sokol,2560,0,0,1,1,0.0%,6m
29786,3,IllIIlIlllIl,2560,0,0,1,1,0.0%,1h
29786,2,JustNeni,2560,0,0,1,1,0.0%,37m
29815,2,Adya,2559,1473,260,250,510,51.0%,46m
29815,1,Frituurvet,2559,1553,123,120,243,50.6%,7m
29815,2,ManDell,2559,1083,87,80,167,52.1%,10m
29815,2,jashuaObrian,2559,778,81,84,165,49.1%,7m
29815,3,LiveUpAtDaWn,2559,441,50,39,89,56.2%,60m
29815,2,Teoden,2559,1030,43,38,81,53.1%,1h
29815,2,[eWRS]RusPRO,2559,742,31,24,55,56.4%,60m
29815,2,Yndepan,2559,602,24,17,41,58.5%,5m
29815,2,Juraj,2559,500,22,15,37,59.5%,23m
29815,2,PiriaLRUSss,2559,464,20,14,34,58.8%,4m
29815,3,[PrZr]PHoBoS,2559,530,18,33,51,35.3%,15m
29815,1,TwoScvOneCup,2559,386,14,15,29,48.3%,45m
29815,3,Grizzy,2559,288,11,14,25,44.0%,7m
29815,3,MacAndCheese,2559,295,11,16,27,40.7%,33m
29815,2,Murdoc,2559,92,4,5,9,44.4%,36m
29815,3,Koller,2559,72,4,6,10,40.0%,56m
29815,3,[GRMA]AMS,2559,58,3,0,3,100.0%,54m
29815,3,[Mouuz]FelixUwU,2559,0,3,2,5,60.0%,54m
29815,2,Sovka,2559,115,3,3,6,50.0%,1h
29815,3,Raxelslem,2559,122,3,5,8,37.5%,1h
29815,1,[F0RTES]Skynet,2559,106,3,13,16,18.8%,25m
29815,1,ric,2559,0,2,3,5,40.0%,40m
29815,2,pattso,2559,60,2,6,8,25.0%,43m
29815,3,[KYB]BujajTorbe,2559,30,1,1,2,50.0%,37m
29815,2,[tDKe]NeON,2559,30,1,4,5,20.0%,4m
29815,1,[BOAE]Bandit,2559,88,1,4,5,20.0%,46m
29841,2,Жекичан,2558,1287,47,50,97,48.5%,1h
29841,2,AFKshnik,2558,905,37,33,70,52.9%,1h
29841,1,wumbomaster,2558,480,26,31,57,45.6%,60m
29841,2,HugMePls,2558,656,24,22,46,52.2%,1h
29841,1,LaDeconne,2558,649,24,25,49,49.0%,10m
29841,2,rubick,2558,488,18,19,37,48.6%,1h
29841,1,Darakne,2558,141,14,17,31,45.2%,33m
29841,3,JonGalindo,2558,344,12,8,20,60.0%,44m
29841,3,[iCue]Giogiu,2558,270,12,13,25,48.0%,10m
29841,3,БешеныйГлист,2558,218,6,11,17,35.3%,6m
29841,2,Micka,2558,173,3,6,9,33.3%,9m
29841,3,[TrM]TMgoayakla,2558,30,2,0,2,100.0%,10m
29841,3,GuitarGuitar,2558,0,1,0,1,100.0%,51m
29841,2,prdx,2558,0,1,0,1,100.0%,30m
29841,3,Ahzzak,2558,0,1,0,1,100.0%,23m
29841,1,Magemanne,2558,0,1,3,4,25.0%,26m
29841,2,Aurinik,2558,0,0,1,1,0.0%,21m
29858,1,[IRBD]Joebzz,2557,751,29,32,61,47.5%,32m
29858,1,[ASPRU]pedawin,2557,777,29,32,61,47.5%,54m
29858,3,Оляпыч,2557,606,22,22,44,50.0%,38m
29858,2,cooking,2557,227,20,18,38,52.6%,1h
29858,3,DarkLordAmon,2557,386,19,52,71,26.8%,12m
29858,1,KOTENOK,2557,182,9,14,23,39.1%,5m
29858,3,TrickNick,2557,257,8,8,16,50.0%,43m
29858,1,Nindan,2557,226,8,10,18,44.4%,35m
29858,3,[CLIC]carlositu,2557,135,6,4,10,60.0%,6m
29858,3,[4orce]Draugar,2557,122,5,3,8,62.5%,1h
29858,2,[epiXX]Ezai,2557,88,4,5,9,44.4%,1h
29858,3,Gemanov,2557,86,3,4,7,42.9%,4m
29858,1,[Oarsch]UbootUwe,2557,48,3,4,7,42.9%,45m
29858,3,Xzadem,2557,0,2,5,7,28.6%,22m
29858,2,David,2557,60,2,5,7,28.6%,40m
29858,3,dreya,2557,0,2,5,7,28.6%,30m
29858,2,david,2557,88,1,2,3,33.3%,1h
29858,3,snakebite,2557,97,1,4,5,20.0%,41m
29858,1,Lugburz,2557,0,0,5,5,0.0%,40m
29877,1,Manicx,2556,1635,291,291,582,50.0%,42m
29877,2,JonnyWalker,2556,791,113,103,216,52.3%,29m
29877,1,[SILeSp]bosscara,2556,1420,85,93,178,47.8%,1h
29877,2,McLaugh,2556,577,27,20,47,57.4%,1h
29877,1,Leelos,2556,624,26,30,56,46.4%,29m
29877,1,mQp,2556,719,24,35,59,40.7%,36m
29877,1,Kardus,2556,626,23,23,46,50.0%,4m
29877,2,BlackNeco,2556,223,18,12,30,60.0%,24m
29877,2,[K0RM2]Keyt,2556,384,12,13,25,48.0%,1h
29877,1,[WysH]HuDTV,2556,372,11,21,32,34.4%,7m
29877,2,uNiT,2556,276,9,12,21,42.9%,7m
29877,1,Cheriss,2556,233,7,6,13,53.8%,32m
29877,3,BEYYYTA,2556,88,4,1,5,80.0%,39m
29877,1,Tyfoon,2556,30,4,5,9,44.4%,1h
29877,2,[Inval]ПростоPony,2556,94,4,6,10,40.0%,43m
29877,1,[ISIC]UwU,2556,88,3,5,8,37.5%,29m
29877,2,MRSA,2556,98,2,2,4,50.0%,31m
29877,3,chingachgook,2556,0,2,3,5,40.0%,51m
29877,1,illwin,2556,0,2,3,5,40.0%,39m
29877,3,tsugio,2556,0,2,4,6,33.3%,25m
29877,2,Fumy,2556,0,1,2,3,33.3%,24m
29877,2,Masochista,2556,30,1,3,4,25.0%,37m
29877,3,TooM,2556,0,1,4,5,20.0%,33m
29877,3,Ceravid,2556,0,0,1,1,0.0%,1h
29877,3,TrAcKdAyHeRo,2556,0,0,1,1,0.0%,38m
29877,2,Ezens,2556,0,0,3,3,0.0%,32m
29903,2,MisákÁdám,2555,1194,55,36,91,60.4%,3m
29903,2,[TeRoCa]Rowmer,2555,278,40,40,80,50.0%,49m
29903,2,Frank,2555,512,26,24,50,52.0%,46m
29903,1,maxpower,2555,504,16,24,40,40.0%,2m
29903,3,[AciNoN]BloomingDead,2555,320,11,9,20,55.0%,36m
29903,2,CrasyStraus,2555,256,10,12,22,45.5%,1h
29903,3,Emixam,2555,179,8,3,11,72.7%,50m
29903,2,ZergMan,2555,232,7,7,14,50.0%,36m
29903,3,Timmy,2555,142,6,2,8,75.0%,24m
29903,3,Tomi,2555,185,5,7,12,41.7%,1h
29903,2,Schorlinksi,2555,166,5,7,12,41.7%,23m
29903,2,POKPOKPOK,2555,156,5,10,15,33.3%,1h
29903,2,Zaxon,2555,122,4,8,12,33.3%,10m
29903,3,frakki,2555,0,3,5,8,37.5%,11m
29903,3,XxThemenxX,2555,97,2,1,3,66.7%,1h
29903,3,Denizly,2555,30,1,1,2,50.0%,50m
29903,2,magician,2555,0,1,2,3,33.3%,38m
29903,3,Druides,2555,0,1,4,5,20.0%,30m
29921,1,robotdeha,2554,786,117,104,221,52.9%,36m
29921,3,IIIIIIIIIIII,2554,1069,92,98,190,48.4%,9m
29921,2,[Izual]VeryEasy,2554,438,31,30,61,50.8%,1h
29921,2,IbarutK,2554,374,27,27,54,50.0%,38m
29921,2,Skill,2554,338,25,16,41,61.0%,38m
29921,3,Vovvvvan,2554,495,22,33,55,40.0%,6m
29921,1,[DET54]DimonLimON,2554,360,14,13,27,51.9%,46m
29921,2,Azares,2554,378,14,17,31,45.2%,36m
29921,3,Torrent,2554,334,13,10,23,56.5%,6m
29921,2,[kozaks]Pawlonyn,2554,287,12,6,18,66.7%,9m
29921,3,Prince,2554,258,10,9,19,52.6%,45m
29921,2,Fennieway,2554,230,8,7,15,53.3%,1h
29921,2,nickoke,2554,222,7,8,15,46.7%,1h
29921,2,[Jail]TuJefe,2554,203,5,11,16,31.2%,9m
29921,2,Mebius,2554,201,4,8,12,33.3%,9m
29921,1,arbok,2554,88,3,5,8,37.5%,34m
29921,2,myszolejen,2554,44,2,0,2,100.0%,1h
29921,1,JOHNT,2554,48,2,4,6,33.3%,37m
29921,1,toine,2554,0,1,0,1,100.0%,1h
29921,1,Noob,2554,0,1,1,2,50.0%,1h
29921,3,VacuumDecay,2554,30,1,2,3,33.3%,1h
29921,2,[EDKH]htlrdnwrng,2554,30,1,5,6,16.7%,1h
29921,3,[MEDAH]handstyler,2554,0,0,1,1,0.0%,32m
29921,2,megolodon,2554,0,0,2,2,0.0%,37m
29945,2,aherly,2553,1602,134,124,258,51.9%,25m
29945,1,[MkerIT]ChuChu,2553,1619,82,94,176,46.6%,5m
29945,1,TarakanoLov,2553,1056,48,47,95,50.5%,4m
29945,1,teoden,2553,1466,48,77,125,38.4%,5m
29945,2,OTmorojeny,2553,430,22,11,33,66.7%,1h
29945,3,Petiee,2553,409,14,16,30,46.7%,32m
29945,2,Schokoboo,2553,296,12,12,24,50.0%,28m
29945,2,PHMRager,2553,145,10,13,23,43.5%,1h
29945,3,[BIGGHK]Isusek,2553,271,9,5,14,64.3%,52m
29945,1,лицемер,2553,186,8,7,15,53.3%,1h
29945,1,poik,2553,96,7,8,15,46.7%,60m
29945,3,YellowWorm,2553,116,5,3,8,62.5%,36m
29945,2,darkmatter,2553,122,5,5,10,50.0%,5m
29945,3,MaJIou,2553,88,4,1,5,80.0%,42m
29945,3,CrAsHbOy,2553,30,1,1,2,50.0%,57m
29945,3,[Clyd]RotoMif,2553,30,1,1,2,50.0%,7m
29945,2,Alexbag,2553,0,1,1,2,50.0%,24m
29945,1,miha,2553,0,1,3,4,25.0%,1h
29945,2,GoDZz,2553,0,0,1,1,0.0%,1h
29945,3,Equalizer,2553,0,0,1,1,0.0%,47m
29945,2,Destroyer,2553,0,0,2,2,0.0%,31m
29966,1,ЛуиDжи,2552,1633,226,230,456,49.6%,29m
29966,1,yolka,2552,1629,146,149,295,49.5%,1h
29966,1,Pyrrhus,2552,1581,59,66,125,47.2%,44m
29966,1,Stim,2552,313,26,30,56,46.4%,1h
29966,1,Amosh,2552,541,22,22,44,50.0%,33m
29966,3,smeke,2552,578,21,27,48,43.8%,10m
29966,2,Wahn,2552,473,20,16,36,55.6%,1h
29966,2,alex,2552,167,15,10,25,60.0%,9m
29966,3,SpaceAlex,2552,329,13,8,21,61.9%,10m
29966,2,Smog,2552,320,12,9,21,57.1%,38m
29966,2,[NS2019]Alariy,2552,218,7,6,13,53.8%,37m
29966,1,[glhf20]yann,2552,179,7,14,21,33.3%,26m
29966,2,GimBo,2552,93,3,4,7,42.9%,41m
29966,2,DiscoLord,2552,30,3,5,8,37.5%,1h
29966,2,Sipulimummo,2552,96,3,6,9,33.3%,49m
29966,3,ZommerD,2552,30,2,0,2,100.0%,1h
29966,1,[LTPX]Traks,2552,48,2,4,6,33.3%,46m
29966,3,Askar,2552,0,2,5,7,28.6%,37m
29966,1,Outlaw,2552,90,2,5,7,28.6%,6m
29966,2,Kalimos,2552,0,1,2,3,33.3%,1h
29966,2,Vinn,2552,92,1,2,3,33.3%,9m
29966,2,TODD,2552,0,1,2,3,33.3%,38m
29966,3,Vali,2552,0,0,1,1,0.0%,50m
29966,2,Skills,2552,0,0,1,1,0.0%,1h
29966,3,[nr40]gracken,2552,0,0,1,1,0.0%,36m
29966,2,[SDogs]Haku,2552,0,0,4,4,0.0%,25m
29966,1,Slip,2552,0,0,5,5,0.0%,36m
29993,3,Bucktwo,2551,722,39,31,70,55.7%,10m
29993,2,[VOVA]BlizzGamer,2551,977,39,37,76,51.3%,53m
29993,1,BlkZZ,2551,777,28,34,62,45.2%,54m
29993,2,Tyrega,2551,636,23,24,47,48.9%,36m
29993,2,kaboom,2551,300,22,18,40,55.0%,53m
29993,3,Maya,2551,419,21,28,49,42.9%,20m
29993,2,[тьма]multosss,2551,222,8,10,18,44.4%,38m
29993,1,Zilmer,2551,232,8,12,20,40.0%,44m
29993,3,Azrael,2551,88,3,2,5,60.0%,11m
29993,3,DieOnMySight,2551,88,3,3,6,50.0%,4m
29993,3,Reaper,2551,0,1,0,1,100.0%,1h
29993,2,[VoidDr]HangmanЯр,2551,0,1,2,3,33.3%,53m
29993,2,BenjyGregory,2551,30,1,4,5,20.0%,55m
29993,3,Jawker,2551,0,0,1,1,0.0%,30m
29993,3,Pit,2551,0,0,1,1,0.0%,49m
29993,3,CemionCFG,2551,0,0,1,1,0.0%,58m
29993,2,Vollells,2551,0,0,2,2,0.0%,47m
29993,1,JTR,2551,0,0,5,5,0.0%,4m
30011,1,blackcraft,2550,1585,148,148,296,50.0%,1h
30011,2,qdqdq,2550,1556,72,77,149,48.3%,1h
30011,1,Петька,2550,424,55,53,108,50.9%,2m
30011,2,ChakSobchak,2550,1174,42,41,83,50.6%,1h
30011,3,Zargnaza,2550,939,39,31,70,55.7%,30m
30011,2,BloodOfDeath,2550,703,34,39,73,46.6%,52m
30011,2,ecHarley,2550,507,33,25,58,56.9%,1h
30011,1,ilportal,2550,892,29,39,68,42.6%,46m
30011,3,[BoBF]Mostunique,2550,227,10,10,20,50.0%,19m
30011,2,Студент,2550,193,9,3,12,75.0%,49m
30011,2,Womble,2550,207,7,9,16,43.8%,58m
30011,2,uEz,2550,148,5,8,13,38.5%,38m
30011,3,WinRar,2550,160,4,1,5,80.0%,41m
30011,2,Wyrm,2550,60,4,6,10,40.0%,7m
30011,2,Utar,2550,101,3,3,6,50.0%,1h
30011,2,KIXO,2550,90,3,5,8,37.5%,1h
30011,3,DerMeister,2550,0,2,5,7,28.6%,9m
30011,3,PERA,2550,97,1,1,2,50.0%,1h
30011,2,Bill,2550,0,1,1,2,50.0%,38m
30011,3,Noose,2550,30,1,6,7,14.3%,57m
30011,2,Sergej,2550,0,0,2,2,0.0%,25m
30011,2,Crox,2550,0,0,5,5,0.0%,24m
30033,1,[IXtrme]GrandMaster,2549,1637,126,125,251,50.2%,43m
30033,3,NoName,2549,882,112,106,218,51.4%,34m
30033,2,comod,2549,1161,105,91,196,53.6%,11m
30033,2,hydralongre,2549,774,37,33,70,52.9%,10m
30033,2,Пряник,2549,737,31,23,54,57.4%,10m
30033,2,FatalError,2549,633,24,23,47,51.1%,56m
30033,2,Feust,2549,439,14,21,35,40.0%,25m
30033,3,Banzai,2549,398,13,31,44,29.5%,13m
30033,1,Mudara,2549,261,7,9,16,43.8%,28m
30033,3,DaNimal,2549,172,6,0,6,100.0%,5m
30033,3,Lama,2549,131,5,3,8,62.5%,4m
30033,2,YIVAN,2549,157,4,3,7,57.1%,1h
30033,2,SuicideFrog,2549,30,4,4,8,50.0%,57m
30033,3,HaPpY,2549,68,4,6,10,40.0%,50m
30033,3,nefas,2549,58,2,3,5,40.0%,42m
30033,2,Businesstour,2549,102,2,3,5,40.0%,47m
30033,1,Googulag,2549,34,2,7,9,22.2%,43m
30033,3,SpaceWUBU,2549,36,1,2,3,33.3%,47m
30033,2,[SIMONS]TingleLink,2549,88,1,2,3,33.3%,58m
30033,3,HaosHay,2549,0,0,1,1,0.0%,1m
30033,2,яблоко,2549,0,0,3,3,0.0%,45m
30054,1,Prygames,2548,1547,98,78,176,55.7%,45m
30054,2,[HAYTER]MMM,2548,1128,93,77,170,54.7%,51m
30054,3,[OVESEE]Amir,2548,250,10,4,14,71.4%,33m
30054,2,Axcsm,2548,272,10,8,18,55.6%,11m
30054,2,[RBcom]Steelpanther,2548,153,6,1,7,85.7%,48m
30054,3,fattum,2548,88,3,2,5,60.0%,48m
30054,2,plet,2548,114,3,5,8,37.5%,5m
30054,3,DyzerPak,2548,0,2,3,5,40.0%,58m
30054,1,FuseKiller,2548,0,1,0,1,100.0%,41m
30054,3,Erkan,2548,0,0,1,1,0.0%,27m
30054,3,Sykybekk,2548,0,0,1,1,0.0%,48m
30065,1,Asheinag,2547,982,119,112,231,51.5%,6m
30065,3,[ЗИБиАГ]BeTaL,2547,681,36,7,43,83.7%,27m
30065,3,Staticc,2547,781,29,29,58,50.0%,24m
30065,2,Suti,2547,574,24,16,40,60.0%,1m
30065,2,ElectricNoma,2547,304,12,8,20,60.0%,3m
30065,2,SiiG,2547,229,7,8,15,46.7%,1h
30065,2,RobiRatlos,2547,135,6,5,11,54.5%,42m
30065,3,[PHØMUI]Jihau,2547,152,6,17,23,26.1%,12m
30065,3,Kraszczak,2547,0,3,2,5,60.0%,59m
30065,2,[r6ad]Agrail,2547,125,3,4,7,42.9%,45m
30065,2,Sigaxel,2547,95,3,6,9,33.3%,1h
30065,3,KombatStail,2547,121,2,1,3,66.7%,41m
30065,1,Dedeus,2547,48,2,4,6,33.3%,55m
30065,3,Yashu,2547,0,1,0,1,100.0%,7m
30065,2,[aBooo]Hannibal,2547,42,1,1,2,50.0%,30m
30065,1,[OMiD]OUBLANK,2547,48,1,2,3,33.3%,49m
30065,3,Teferi,2547,0,0,1,1,0.0%,39m
30065,3,Oni,2547,0,0,1,1,0.0%,42m
30065,1,[LPKT]LPKTFerski,2547,0,0,1,1,0.0%,49m
30084,1,Busat,2546,869,32,36,68,47.1%,1h
30084,3,Nemesis,2546,613,20,30,50,40.0%,7m
30084,2,Sanechka,2546,251,15,5,20,75.0%,1h
30084,2,Ashenari,2546,396,15,11,26,57.7%,10m
30084,1,BMDer,2546,324,11,13,24,45.8%,1h
30084,3,BossPun,2546,226,8,13,21,38.1%,7m
30084,3,Jenok,2546,142,6,3,9,66.7%,58m
30084,3,Pathetic,2546,102,5,6,11,45.5%,37m
30084,1,Mips,2546,130,5,11,16,31.2%,48m
30084,2,Bobrishe,2546,88,3,22,25,12.0%,17m
30084,3,[RofIer]CTRLALTDEL,2546,119,2,4,6,33.3%,27m
30084,3,SaSsergeich,2546,0,2,4,6,33.3%,7m
30084,2,Garet,2546,0,1,0,1,100.0%,42m
30084,2,[ANN]Agirre,2546,0,1,1,2,50.0%,7m
30084,1,[DET54]Batlegase,2546,44,1,1,2,50.0%,1h
30084,2,Pityuh,2546,0,0,2,2,0.0%,52m
30084,2,Dartsithus,2546,0,0,3,3,0.0%,47m
30101,1,Tik,2545,1539,89,92,181,49.2%,54m
30101,3,LUNATICO,2545,1359,76,76,152,50.0%,60m
30101,3,Qualia,2545,950,65,51,116,56.0%,41m
30101,1,[KatHal]kowadlo,2545,1213,61,61,122,50.0%,10m
30101,3,Rock,2545,1067,48,50,98,49.0%,14m
30101,3,infestor,2545,395,18,13,31,58.1%,42m
30101,2,grishman,2545,366,15,10,25,60.0%,10m
30101,2,Mahmax,2545,290,12,16,28,42.9%,35m
30101,3,[NTIG]Seezz,2545,160,7,1,8,87.5%,39m
30101,3,BlackVinny,2545,191,6,1,7,85.7%,41m
30101,3,Kaz,2545,93,4,3,7,57.1%,54m
30101,3,WhiteLion,2545,72,4,6,10,40.0%,1h
30101,3,[ZBLAH]Dumis,2545,0,3,4,7,42.9%,54m
30101,2,Zordrak,2545,30,3,5,8,37.5%,9m
30101,3,Yauwz,2545,38,3,5,8,37.5%,30m
30101,3,Yarik,2545,30,2,0,2,100.0%,53m
30101,1,HecyCBeT,2545,0,2,3,5,40.0%,37m
30101,3,[xKillx]wikti,2545,0,2,3,5,40.0%,51m
30101,3,Zumba,2545,0,2,4,6,33.3%,56m
30101,3,EineGabel,2545,28,2,4,6,33.3%,42m
30101,2,zamir,2545,60,2,5,7,28.6%,1h
30101,3,Arach,2545,0,1,0,1,100.0%,43m
30101,1,Pavian,2545,0,1,5,6,16.7%,46m
30101,3,[PRNC]Raven,2545,0,0,1,1,0.0%,41m
30101,3,[SWUGG]sbepuz,2545,0,0,1,1,0.0%,4m
30101,2,XaTaBiG,2545,0,0,2,2,0.0%,51m
30101,2,Aringhot,2545,0,0,3,3,0.0%,57m
30128,2,[ParGC]Planemo,2544,1094,115,115,230,50.0%,1h
30128,3,Regentomok,2544,1575,84,66,150,56.0%,1h
30128,1,GhostDog,2544,1444,83,76,159,52.2%,52m
30128,2,MİLLER,2544,621,22,24,46,47.8%,48m
30128,2,kvas,2544,344,14,9,23,60.9%,36m
30128,2,Juffin,2544,314,11,11,22,50.0%,49m
30128,2,Illumiknight,2544,249,10,5,15,66.7%,4m
30128,2,Subjugate,2544,306,7,8,15,46.7%,43m
30128,2,DeMoNouS,2544,146,6,7,13,46.2%,1h
30128,2,IIIIIIIIIIII,2544,177,5,4,9,55.6%,33m
30128,3,Кирилл,2544,60,3,1,4,75.0%,4m
30128,2,Kenny,2544,111,3,4,7,42.9%,1h
30128,2,sergeif,2544,30,3,5,8,37.5%,39m
30128,3,KACKA,2544,30,2,0,2,100.0%,23m
30128,2,MrJelly,2544,30,2,2,4,50.0%,38m
30128,2,Abencerage,2544,0,2,4,6,33.3%,39m
30128,2,MIHA,2544,0,1,1,2,50.0%,31m
30128,2,Cody,2544,0,0,1,1,0.0%,1h
30128,2,Aposthle,2544,0,0,3,3,0.0%,25m
30147,3,Kijanach,2543,516,68,66,134,50.7%,1h
30147,2,vaypas,2543,592,41,43,84,48.8%,1h
30147,2,lel,2543,838,40,27,67,59.7%,25m
30147,2,[VoxX]VoxMorituri,2543,807,33,26,59,55.9%,1h
30147,2,[iX]TornadoVape,2543,563,31,36,67,46.3%,1m
30147,2,PooyaY,2543,285,30,22,52,57.7%,1h
30147,2,[fdp60]gregdur,2543,550,20,25,45,44.4%,5m
30147,2,zitov,2543,414,15,19,34,44.1%,42m
30147,2,[eFikSZ]kszk,2543,355,14,16,30,46.7%,1h
30147,1,Oblomov,2543,386,13,20,33,39.4%,36m
30147,3,[DPS]Jawrk,2543,267,12,14,26,46.2%,1h
30147,1,WideEye,2543,182,9,10,19,47.4%,35m
30147,2,Pausyrt,2543,136,7,7,14,50.0%,10m
30147,2,LaSaK,2543,228,7,9,16,43.8%,38m
30147,3,Tachyon,2543,168,6,3,9,66.7%,1h
30147,2,Vitboss,2543,156,6,4,10,60.0%,47m
30147,1,рнк,2543,209,6,13,19,31.6%,8m
30147,3,[Маньяк]llllllllllll,2543,144,5,4,9,55.6%,1h
30147,2,Legion,2543,116,5,7,12,41.7%,5m
30147,1,[DnD101]Gusano,2543,66,4,7,11,36.4%,1h
30147,3,Правоверный,2543,88,3,2,5,60.0%,23m
30147,3,kradox,2543,145,3,2,5,60.0%,42m
30147,2,ChopChop,2543,88,3,8,11,27.3%,1h
30147,1,Zhanghet,2543,0,2,5,7,28.6%,1h
30147,2,kirk,2543,60,2,8,10,20.0%,25m
30147,3,gouzzy,2543,0,1,0,1,100.0%,32m
30147,3,Coon,2543,0,1,1,2,50.0%,54m
30147,3,ghoUst,2543,0,0,1,1,0.0%,42m
30147,3,claki,2543,0,0,1,1,0.0%,1h
30147,1,Merlin,2543,0,0,5,5,0.0%,43m
30177,1,Tenaciel,2542,1368,76,77,153,49.7%,4m
30177,3,Will,2542,1088,48,42,90,53.3%,2m
30177,2,ршл,2542,1212,45,47,92,48.9%,1h
30177,1,Дракон,2542,581,35,42,77,45.5%,48m
30177,3,Sandu,2542,631,27,21,48,56.2%,60m
30177,2,Ifndef,2542,652,25,20,45,55.6%,60m
30177,3,Motaba,2542,517,21,10,31,67.7%,39m
30177,3,[DeePuz]Emperor,2542,414,15,11,26,57.7%,55m
30177,2,Massaraksh,2542,245,12,4,16,75.0%,52m
30177,2,[TTe]Tenckules,2542,198,7,9,16,43.8%,57m
30177,2,[dFz]Hefeweizen,2542,218,7,10,17,41.2%,52m
30177,2,Максrus,2542,184,7,11,18,38.9%,56m
30177,3,[STOBAG]shine,2542,193,6,7,13,46.2%,57m
30177,3,Pacyfist,2542,0,3,2,5,60.0%,11m
30177,2,Vise,2542,121,3,5,8,37.5%,1h
30177,2,[BrassZ]WPenguin,2542,122,3,5,8,37.5%,50m
30177,3,LickerDaPuss,2542,0,3,5,8,37.5%,11m
30177,3,DonaldTrump,2542,121,2,2,4,50.0%,58m
30177,2,Anatomic,2542,46,2,3,5,40.0%,33m
30177,3,Dayumer,2542,0,2,4,6,33.3%,33m
30177,3,Rjomba,2542,0,2,5,7,28.6%,25m
30177,3,[NINJ88]Fostaliga,2542,0,0,1,1,0.0%,28m
30177,3,Zero,2542,0,0,1,1,0.0%,1h
30177,3,Big,2542,0,0,1,1,0.0%,27m
30177,2,DarkLord,2542,0,0,3,3,0.0%,1h
30202,2,Apollo,2541,1628,183,172,355,51.5%,1h
30202,2,[CocoCo]Toby,2541,1412,89,109,198,44.9%,10m
30202,2,[ANGRYM]Castor,2541,1273,74,63,137,54.0%,50m
30202,2,Mephisto,2541,792,33,30,63,52.4%,7m
30202,1,[C2E]Edweed,2541,637,22,27,49,44.9%,1h
30202,3,TerminaL,2541,337,16,6,22,72.7%,37m
30202,3,Heeman,2541,375,14,5,19,73.7%,37m
30202,3,TheCEO,2541,339,11,13,24,45.8%,6m
30202,2,[maxdan]ObiWanKenobi,2541,248,8,3,11,72.7%,42m
30202,2,Kanapka,2541,139,4,7,11,36.4%,37m
30202,1,[VGMF]gnôme,2541,96,4,9,13,30.8%,33m
30202,1,Räminator,2541,125,3,11,14,21.4%,45m
30202,2,[AoIN]Silverstore,2541,0,2,4,6,33.3%,39m
30202,3,BaronBössa,2541,0,1,5,6,16.7%,1h
30202,3,Yuri,2541,0,0,1,1,0.0%,50m
30202,3,SulfuricAcid,2541,0,0,1,1,0.0%,23m
30202,2,[900iq]veloci,2541,0,0,3,3,0.0%,47m
30219,2,Luna,2540,764,77,67,144,53.5%,1m
30219,2,hariton,2540,1623,70,62,132,53.0%,1h
30219,2,scorpion,2540,676,23,27,50,46.0%,30m
30219,2,Majorana,2540,401,19,18,37,51.4%,48m
30219,3,snickersen,2540,321,19,28,47,40.4%,12m
30219,3,foibos,2540,350,13,10,23,56.5%,43m
30219,1,[FoBro]frutiger,2540,196,11,13,24,45.8%,1h
30219,1,ice,2540,310,10,18,28,35.7%,33m
30219,3,[BeP]RekaBull,2540,202,8,4,12,66.7%,57m
30219,3,fremen,2540,64,4,6,10,40.0%,1h
30219,3,Androns,2540,0,2,5,7,28.6%,7m
30219,3,[0Head]artur,2540,0,1,0,1,100.0%,44m
30219,1,bob,2540,0,1,0,1,100.0%,40m
30219,3,ioiboi,2540,30,1,1,2,50.0%,50m
30219,3,[шаурм]нотище,2540,0,1,4,5,20.0%,57m
30234,3,Simon,2539,1132,42,48,90,46.7%,6m
30234,2,AverieAutumn,2539,560,34,16,50,68.0%,57m
30234,3,Pucka,2539,614,24,16,40,60.0%,39m
30234,2,TheLordNase,2539,390,16,9,25,64.0%,32m
30234,2,Чизер,2539,341,13,9,22,59.1%,3m
30234,3,ALin,2539,374,13,13,26,50.0%,11m
30234,1,FastJack,2539,249,8,3,11,72.7%,53m
30234,3,oZF,2539,263,8,5,13,61.5%,37m
30234,3,XYZ,2539,184,7,4,11,63.6%,28m
30234,2,Univerce,2539,200,7,5,12,58.3%,50m
30234,1,[Weedoc]CriticalHaze,2539,171,7,5,12,58.3%,60m
30234,2,Vadulik,2539,178,5,5,10,50.0%,11m
30234,1,[liisks]galacticspy,2539,111,4,1,5,80.0%,1h
30234,3,McDeJay,2539,125,4,5,9,44.4%,1h
30234,3,[SC22SC]Ptik,2539,58,2,1,3,66.7%,50m
30234,2,Jack,2539,88,2,1,3,66.7%,35m
30234,3,RatonPoeta,2539,0,2,4,6,33.3%,54m
30234,3,fistaszek,2539,95,2,4,6,33.3%,8m
30234,3,AlarAk,2539,0,2,5,7,28.6%,2m
30234,3,[SszZ7]Быдло,2539,0,1,0,1,100.0%,31m
30234,3,Schrodinger,2539,0,0,1,1,0.0%,59m
30234,3,Kaiden,2539,0,0,1,1,0.0%,1h
30234,2,Lolikuh,2539,0,0,2,2,0.0%,4m
30257,2,Litheas,2538,1537,177,168,345,51.3%,10m
30257,2,lightman,2538,1560,88,80,168,52.4%,25m
30257,3,GiantBalls,2538,1476,87,85,172,50.6%,1h
30257,2,Ryu,2538,527,35,31,66,53.0%,53m
30257,3,Эквалайзер,2538,835,32,24,56,57.1%,23m
30257,3,Pechenka,2538,363,15,9,24,62.5%,50m
30257,3,Shaarluun,2538,239,9,6,15,60.0%,38m
30257,3,MiaLandsem,2538,192,8,12,20,40.0%,51m
30257,2,TourisT,2538,228,7,7,14,50.0%,1h
30257,1,Aneyro,2538,144,6,10,16,37.5%,33m
30257,3,chippR,2538,188,5,1,6,83.3%,39m
30257,2,[LowEx]bads,2538,154,5,5,10,50.0%,58m
30257,3,Emilut,2538,0,2,4,6,33.3%,54m
30257,1,Lorgar,2538,48,2,7,9,22.2%,53m
30257,3,[BadPun]Bop,2538,0,1,0,1,100.0%,50m
30257,1,ScarneX,2538,95,1,3,4,25.0%,10m
30257,2,korkers,2538,30,1,4,5,20.0%,57m
30257,3,AdasW,2538,0,0,1,1,0.0%,42m
30257,3,[FreeGT]TheVadim,2538,0,0,2,2,0.0%,1h
30276,3,[MSK77]Greyfox,2537,1641,101,93,194,52.1%,37m
30276,1,[TAW]Xyrox,2537,1227,86,81,167,51.5%,2m
30276,2,SanyaReaper,2537,1320,65,64,129,50.4%,56m
30276,1,lxdvspb,2537,1251,52,51,103,50.5%,43m
30276,2,Motorhaube,2537,690,26,31,57,45.6%,48m
30276,1,rabiddios,2537,525,19,26,45,42.2%,36m
30276,2,russio,2537,399,17,16,33,51.5%,10m
30276,2,StellarFox,2537,390,16,18,34,47.1%,56m
30276,2,biverVs,2537,362,14,11,25,56.0%,1h
30276,1,Goldy,2537,270,11,14,25,44.0%,28m
30276,2,stemer,2537,242,10,8,18,55.6%,10m
30276,2,[NoTos]LeRiffle,2537,223,8,1,9,88.9%,39m
30276,3,Failon,2537,168,6,3,9,66.7%,1h
30276,2,[злань]PycckuuZerg,2537,168,6,3,9,66.7%,53m
30276,2,jcmd,2537,88,5,7,12,41.7%,8m
30276,3,[FMG]shadowknight,2537,157,4,3,7,57.1%,1h
30276,2,Lanff,2537,92,4,5,9,44.4%,1h
30276,2,Mirus,2537,150,4,5,9,44.4%,29m
30276,2,[2z]spliff,2537,60,3,4,7,42.9%,1h
30276,2,[HsDL]Canjack,2537,0,2,4,6,33.3%,30m
30276,3,OddWarrior,2537,0,1,3,4,25.0%,5m
30276,3,[PackrS]Philipozz,2537,0,0,2,2,0.0%,2m
30298,1,ОпАСнАяЛаЛКа,2536,1625,81,88,169,47.9%,2m
30298,2,komyna,2536,906,46,30,76,60.5%,4m
30298,2,Deadcandance,2536,635,27,23,50,54.0%,1h
30298,1,Chivas,2536,734,25,31,56,44.6%,29m
30298,3,freibad,2536,580,22,18,40,55.0%,57m
30298,1,Nobody,2536,616,20,28,48,41.7%,2m
30298,2,DeNNiS,2536,380,13,16,29,44.8%,5m
30298,2,[Tassar]Aeternant,2536,236,9,11,20,45.0%,38m
30298,3,Konan,2536,108,6,10,16,37.5%,50m
30298,3,Rappty,2536,159,5,5,10,50.0%,53m
30298,2,Credenza,2536,118,4,8,12,33.3%,11m
30298,1,nechik,2536,0,3,1,4,75.0%,49m
30298,2,Bequinve,2536,30,2,6,8,25.0%,6m
30298,3,Egirl,2536,122,2,6,8,25.0%,38m
30298,3,Cycle,2536,0,1,0,1,100.0%,41m
30298,3,[NoMczZ]tontsa,2536,0,1,1,2,50.0%,33m
30298,2,Kudesnik,2536,0,1,2,3,33.3%,55m
30298,2,BooM,2536,0,0,2,2,0.0%,1m
30316,1,pelle,2535,1551,290,290,580,50.0%,39m
30316,3,imYourFather,2535,1575,177,188,365,48.5%,3m
30316,1,[Dose]AbdulLachmal,2535,1421,94,93,187,50.3%,60m
30316,2,[JAHODA]MaxKratosCZ,2535,855,61,47,108,56.5%,1h
30316,2,nightstef,2535,1292,47,49,96,49.0%,53m
30316,2,[KLTara]TygX,2535,583,24,16,40,60.0%,41m
30316,2,Tuca,2535,455,18,17,35,51.4%,57m
30316,2,[H3G]Triumph,2535,419,15,15,30,50.0%,35m
30316,2,Nazuth,2535,262,12,17,29,41.4%,16m
30316,2,durbagar,2535,264,10,10,20,50.0%,29m
30316,3,RazerJet,2535,222,7,7,14,50.0%,11m
30316,2,TheBeyonder,2535,166,5,11,16,31.2%,42m
30316,3,Holo,2535,149,4,6,10,40.0%,42m
30316,3,AvDominusNox,2535,94,2,2,4,50.0%,58m
30316,3,HighWisnia,2535,0,2,3,5,40.0%,27m
30316,3,RuFFF,2535,0,2,3,5,40.0%,60m
30316,1,HannaH,2535,119,2,4,6,33.3%,55m
30316,3,OneArmedMong,2535,72,2,4,6,33.3%,50m
30316,2,LiS,2535,42,2,5,7,28.6%,51m
30316,2,CaptainD,2535,0,1,1,2,50.0%,6m
30316,3,vpavlenko,2535,0,1,1,2,50.0%,1h
30316,1,ZeaCore,2535,46,1,3,4,25.0%,56m
30316,2,[OdinJ]gagamel,2535,34,1,7,8,12.5%,4m
30316,3,Vít,2535,0,0,1,1,0.0%,26m
30340,1,[Petrиs]scargot,2534,1593,77,77,154,50.0%,1h
30340,1,Rüdiger,2534,1464,65,75,140,46.4%,6m
30340,1,Narava,2534,291,52,55,107,48.6%,54m
30340,2,[HPBL]simonctnr,2534,952,37,36,73,50.7%,26m
30340,1,Салоед,2534,436,22,25,47,46.8%,8m
30340,3,[pederi]Lorgar,2534,417,20,9,29,69.0%,35m
30340,2,[R88lol]MilkyWay,2534,373,20,20,40,50.0%,9m
30340,3,NZOTH,2534,384,14,8,22,63.6%,45m
30340,2,[ZERGTB]Domi,2534,241,9,8,17,52.9%,24m
30340,2,Probianer,2534,128,6,4,10,60.0%,25m
30340,2,Klimento,2534,88,5,7,12,41.7%,1h
30340,1,OvidiuA,2534,162,5,13,18,27.8%,46m
30340,1,Macys,2534,120,4,6,10,40.0%,24m
30340,2,HerrDentist,2534,94,4,6,10,40.0%,59m
30340,3,[MousM]Louie,2534,90,3,2,5,60.0%,28m
30340,3,Жнец,2534,86,3,2,5,60.0%,1h
30340,2,AOZ,2534,30,2,2,4,50.0%,10m
30340,1,JesusNorsken,2534,48,2,4,6,33.3%,42m
30340,3,saschiigamer,2534,0,2,5,7,28.6%,39m
30340,2,DronT,2534,88,2,5,7,28.6%,23m
30340,3,[Высший]mfert,2534,0,1,4,5,20.0%,1h
30340,2,[oDTCo]ibN,2534,30,1,6,7,14.3%,38m
30340,3,Niruin,2534,0,0,1,1,0.0%,59m
30340,3,artem,2534,0,0,2,2,0.0%,7m
30340,2,Maxpowerpro,2534,0,0,3,3,0.0%,52m
30365,2,Jimbo,2533,433,77,61,138,55.8%,7m
30365,2,Tassadir,2533,281,10,9,19,52.6%,1h
30365,2,Bence,2533,259,8,9,17,47.1%,1m
30365,3,[LPGR]DyoRioN,2533,207,7,5,12,58.3%,11m
30365,3,Riopasha,2533,58,6,2,8,75.0%,36m
30365,3,GliRoaMutHyd,2533,142,6,5,11,54.5%,30m
30365,2,AnaleRandale,2533,146,6,8,14,42.9%,33m
30365,3,Dextir,2533,114,5,1,6,83.3%,31m
30365,2,[NANNA]NaTuRaL,2533,52,4,6,10,40.0%,9m
30365,2,LeimanZerga,2533,30,4,10,14,28.6%,7m
30365,2,[3Cycle]hoze,2533,88,3,4,7,42.9%,39m
30365,1,Nusky,2533,0,2,2,4,50.0%,53m
30365,1,GeneralDrake,2533,48,2,3,5,40.0%,55m
30365,3,xNinjaFish,2533,0,1,0,1,100.0%,4m
30365,3,[TTL]Gabriel,2533,0,1,1,2,50.0%,8m
30365,1,Cwy,2533,0,1,3,4,25.0%,51m
30365,1,Nikita,2533,0,0,1,1,0.0%,50m
30365,3,[Z3RGTV]FrAmE,2533,0,0,1,1,0.0%,35m
30365,3,RaVeR,2533,0,0,2,2,0.0%,2m
30384,2,[beaste]Storm,2532,1492,65,58,123,52.8%,23m
30384,2,Cicada,2532,660,32,32,64,50.0%,60m
30384,2,DrShotgun,2532,366,24,37,61,39.3%,11m
30384,2,Baton,2532,443,20,11,31,64.5%,4m
30384,3,Акелла,2532,457,18,10,28,64.3%,57m
30384,1,Loiron,2532,352,12,12,24,50.0%,6m
30384,3,IllusiveMan,2532,274,11,14,25,44.0%,9m
30384,3,paphitis,2532,268,10,10,20,50.0%,49m
30384,3,MaxiKing,2532,262,9,9,18,50.0%,55m
30384,1,[DOGI]Menax,2532,170,8,8,16,50.0%,1h
30384,1,[SkeSS]JensDemens,2532,296,8,14,22,36.4%,46m
30384,2,nairolF,2532,176,5,6,11,45.5%,1h
30384,2,BarZlacH,2532,116,4,2,6,66.7%,46m
30384,2,Miks,2532,44,4,7,11,36.4%,41m
30384,1,Wonsui,2532,126,4,7,11,36.4%,46m
30384,2,Debrille,2532,108,3,5,8,37.5%,25m
30384,3,[1FU2]Bisk,2532,58,2,2,4,50.0%,31m
30384,1,Amadeus,2532,0,2,3,5,40.0%,49m
30384,2,Rufusnu,2532,0,2,4,6,33.3%,41m
30384,2,Macław,2532,0,2,4,6,33.3%,57m
30384,3,[Resy]light,2532,0,2,4,6,33.3%,45m
30384,3,PathOfNewbie,2532,0,1,0,1,100.0%,60m
30384,3,llllllllllll,2532,0,1,0,1,100.0%,6m
30384,3,[CKi]chowkedar,2532,30,1,2,3,33.3%,31m
30384,3,Alexgaev,2532,0,0,1,1,0.0%,57m
30384,3,Eskurian,2532,0,0,1,1,0.0%,26m
30384,3,[çDTNç]kraken,2532,0,0,1,1,0.0%,60m
30411,1,Eniac,2531,1438,186,183,369,50.4%,29m
30411,1,KjudВy,2531,1387,101,103,204,49.5%,43m
30411,2,motott,2531,1628,98,93,191,51.3%,1h
30411,2,Rovshen,2531,1070,72,81,153,47.1%,10m
30411,3,Amfeon,2531,1472,61,73,134,45.5%,20m
30411,1,[theLS]Sepet,2531,1057,59,62,121,48.8%,8m
30411,2,[VRND]rotemj,2531,304,18,14,32,56.2%,47m
30411,2,[НОД17]GERODOT,2531,218,8,9,17,47.1%,26m
30411,3,[Spehx]Anerad,2531,214,7,7,14,50.0%,1h
30411,2,Faker,2531,202,6,5,11,54.5%,57m
30411,2,Cheshire,2531,160,5,5,10,50.0%,1h
30411,3,Masle,2531,127,3,1,4,75.0%,37m
30411,3,TibAL,2531,163,3,2,5,60.0%,8m
30411,1,lolich,2531,0,3,3,6,50.0%,1h
30411,3,KingAchilles,2531,60,2,2,4,50.0%,34m
30411,3,Pofvissie,2531,0,2,3,5,40.0%,26m
30411,3,[TZ3]Zeghosty,2531,0,1,0,1,100.0%,60m
30411,3,KibeRChlen,2531,0,1,0,1,100.0%,6m
30411,3,KxalTerrorbl,2531,0,1,2,3,33.3%,57m
30411,2,[2RVLV]fbicoyote,2531,88,1,3,4,25.0%,5m
30411,3,StalinChan,2531,0,1,4,5,20.0%,1h
30411,3,[FauG]Hamstarotto,2531,0,0,1,1,0.0%,60m
30411,3,Starman,2531,0,0,2,2,0.0%,41m
30411,3,PAXeke,2531,0,0,2,2,0.0%,42m
30411,1,Kenobi,2531,0,0,3,3,0.0%,49m
30436,2,Niziur,2530,1117,46,44,90,51.1%,1m
30436,1,[ScHb3R]Pfonderino,2530,1242,46,46,92,50.0%,33m
30436,3,[REGGE]JSO,2530,746,26,70,96,27.1%,13m
30436,2,[tchü]sephiroth,2530,632,25,26,51,49.0%,38m
30436,2,SpaceAce,2530,579,24,18,42,57.1%,23m
30436,2,Kvinn,2530,302,16,9,25,64.0%,1h
30436,2,LukasDMania,2530,440,16,18,34,47.1%,53m
30436,1,[Zaint]SirDoomlord,2530,414,16,20,36,44.4%,60m
30436,3,wormstrong,2530,396,14,11,25,56.0%,36m
30436,1,RicardnniZ,2530,289,11,20,31,35.5%,4m
30436,2,Toast,2530,269,8,11,19,42.1%,28m
30436,3,[IceHus]Pandosss,2530,208,7,9,16,43.8%,34m
30436,2,Pablo,2530,140,5,6,11,45.5%,5m
30436,3,[FteamF]ОлегМонгол,2530,0,4,1,5,80.0%,45m
30436,3,Santana,2530,143,4,5,9,44.4%,26m
30436,3,Rosen,2530,120,4,5,9,44.4%,28m
30436,3,[MOFFO]kPanda,2530,0,2,4,6,33.3%,58m
30436,3,JunLPM,2530,0,2,4,6,33.3%,31m
30436,2,conclusus,2530,30,2,6,8,25.0%,52m
30436,3,AleshaRAseya,2530,0,1,0,1,100.0%,27m
30436,3,Zasady,2530,0,1,1,2,50.0%,58m
30436,3,[xCrüe]Strykker,2530,0,0,1,1,0.0%,1h
30436,3,[nrkz]Sherbet,2530,0,0,2,2,0.0%,11m
30436,3,BowHunter,2530,0,0,2,2,0.0%,42m
30436,2,Zarkwerk,2530,0,0,3,3,0.0%,7m
30461,3,krot,2529,1458,127,122,249,51.0%,36m
30461,2,Zujek,2529,688,104,104,208,50.0%,31m
30461,2,Malthael,2529,1402,84,77,161,52.2%,36m
30461,2,Sinnley,2529,1151,52,44,96,54.2%,29m
30461,1,Selmo,2529,1111,44,41,85,51.8%,43m
30461,2,Arzh,2529,643,26,22,48,54.2%,1h
30461,2,[Hyper1]jalone,2529,659,25,24,49,51.0%,58m
30461,3,ElHeredero,2529,518,20,17,37,54.1%,35m
30461,1,Shango,2529,475,17,21,38,44.7%,52m
30461,3,Elf,2529,392,16,12,28,57.1%,60m
30461,3,Ghost,2529,340,13,9,22,59.1%,6m
30461,2,[Goöm]amdÖl,2529,341,13,12,25,52.0%,52m
30461,2,DezLum,2529,253,8,11,19,42.1%,53m
30461,2,penaizorta,2529,200,7,5,12,58.3%,10m
30461,2,toyjus,2529,92,4,5,9,44.4%,55m
30461,3,Creep,2529,168,4,5,9,44.4%,25m
30461,3,LeBreton,2529,86,3,2,5,60.0%,31m
30461,2,[FMGF]Niko,2529,114,3,3,6,50.0%,1h
30461,2,Encrypted,2529,118,3,5,8,37.5%,1h
30461,3,Matex,2529,30,2,0,2,100.0%,2m
30461,2,Willer,2529,30,2,3,5,40.0%,47m
30461,3,Wiii,2529,58,2,4,6,33.3%,33m
30461,2,invalid,2529,0,2,4,6,33.3%,1h
30461,1,KION,2529,97,2,6,8,25.0%,40m
30461,3,Swarmling,2529,92,1,4,5,20.0%,12m
30461,3,Sergey,2529,0,0,1,1,0.0%,11m
30461,3,sten,2529,0,0,1,1,0.0%,24m
30461,3,[CHOPAA]SEMENKORNEEV,2529,0,0,1,1,0.0%,31m
30461,3,ButterJuice,2529,0,0,1,1,0.0%,27m
30461,2,Barbarossa,2529,0,0,5,5,0.0%,1h
30491,2,georgiev,2528,1417,64,54,118,54.2%,1h
30491,3,[BAGGN]Ziaberer,2528,1471,62,53,115,53.9%,1h
30491,2,[DDiv]SpeedyFrog,2528,1501,58,57,115,50.4%,3m
30491,2,Jimmy,2528,1410,54,55,109,49.5%,57m
30491,2,kseroys,2528,864,45,23,68,66.2%,1h
30491,2,[LightC]ReD,2528,921,42,22,64,65.6%,36m
30491,2,[Bulke]Cerb,2528,648,29,32,61,47.5%,23m
30491,2,[UKRA1N]Sainkat,2528,720,29,32,61,47.5%,43m
30491,2,megaultrfall,2528,514,20,17,37,54.1%,1h
30491,1,[НЕТУДА]ComSfdss,2528,606,19,28,47,40.4%,29m
30491,3,sensei,2528,250,10,16,26,38.5%,4m
30491,2,Imote,2528,132,5,7,12,41.7%,1h
30491,3,Vedics,2528,182,5,7,12,41.7%,38m
30491,1,[Tостер]XstepnX,2528,120,5,14,19,26.3%,2m
30491,2,DariuS,2528,150,4,8,12,33.3%,1h
30491,2,[RеG]Hunblee,2528,116,3,2,5,60.0%,41m
30491,3,[5dHndy]ACDCLIVE,2528,117,3,4,7,42.9%,37m
30491,3,[ErGT]Seir,2528,58,2,2,4,50.0%,50m
30491,2,[Pxyool]MMRSanta,2528,30,2,3,5,40.0%,11m
30491,3,HummeL,2528,0,1,0,1,100.0%,1h
30491,3,Урсок,2528,36,1,2,3,33.3%,5m
30491,1,Jupyter,2528,0,1,6,7,14.3%,1h
30491,3,KingJulian,2528,0,0,1,1,0.0%,33m
30491,3,KebabowaDiet,2528,0,0,1,1,0.0%,1h
30491,3,OldBaldBallz,2528,0,0,1,1,0.0%,39m
30491,3,SinKz,2528,0,0,2,2,0.0%,1h
30517,2,manex,2527,1575,204,204,408,50.0%,23m
30517,3,CroTaluS,2527,884,45,37,82,54.9%,37m
30517,3,Maciek,2527,668,25,32,57,43.9%,4m
30517,1,Colson,2527,582,21,24,45,46.7%,11m
30517,2,Tuman,2527,451,17,17,34,50.0%,1h
30517,2,Brainsucker,2527,415,17,18,35,48.6%,1h
30517,2,Galaxy,2527,428,15,16,31,48.4%,53m
30517,3,Nora,2527,358,13,6,19,68.4%,39m
30517,2,[zuc]zeta,2527,304,11,12,23,47.8%,2m
30517,2,steypho,2527,276,10,11,21,47.6%,53m
30517,1,Sisasash,2527,220,7,10,17,41.2%,54m
30517,1,Langostinos,2527,137,5,8,13,38.5%,7m
30517,3,[brosBE]ErlusPerlu,2527,0,1,0,1,100.0%,60m
30517,3,Parzival,2527,0,1,0,1,100.0%,57m
30517,2,[scst]JuJuBa,2527,88,1,3,4,25.0%,1h
30517,2,Lykkeliten,2527,30,1,8,9,11.1%,55m
30517,3,BubbleGum,2527,0,0,1,1,0.0%,49m
30517,3,YukiHyou,2527,0,0,1,1,0.0%,1h
30517,3,[ROTR]kolyambus,2527,0,0,1,1,0.0%,23m
30536,2,vlk,2526,938,55,52,107,51.4%,24m
30536,1,Isolcam,2526,1322,50,52,102,49.0%,29m
30536,1,GeorgeRDX,2526,406,26,27,53,49.1%,3m
30536,2,Darkentitan,2526,352,22,23,45,48.9%,53m
30536,2,WitchCraft,2526,272,11,7,18,61.1%,7m
30536,1,DDKong,2526,150,5,8,13,38.5%,46m
30536,3,vvhisper,2526,154,5,19,24,20.8%,14m
30536,2,Modanko,2526,165,4,4,8,50.0%,1h
30536,3,Fox,2526,150,4,5,9,44.4%,1h
30536,3,Lance,2526,144,3,2,5,60.0%,39m
30536,2,SpaceY,2526,177,3,5,8,37.5%,52m
30536,3,Slayers,2526,30,2,0,2,100.0%,1h
30536,3,kingshorz,2526,0,1,0,1,100.0%,42m
30536,3,[DHYD]Priest,2526,90,1,4,5,20.0%,35m
30536,2,adam,2526,0,1,6,7,14.3%,42m
30536,3,GoSuGhOsT,2526,0,0,1,1,0.0%,11m
30536,3,[SkBG]BojowyRopuch,2526,0,0,2,2,0.0%,43m
30536,3,[7D5]Yooshy,2526,0,0,2,2,0.0%,33m
30554,2,Crisstooferr,2525,1035,147,131,278,52.9%,58m
30554,2,drCeucc,2525,1114,54,41,95,56.8%,1h
30554,3,Melchior,2525,888,37,36,73,50.7%,3m
30554,2,SoundCheck,2525,475,21,16,37,56.8%,52m
30554,3,Milho,2525,566,21,18,39,53.8%,56m
30554,2,Breakcore,2525,524,20,18,38,52.6%,25m
30554,2,MisterXpert,2525,323,12,12,24,50.0%,24m
30554,2,Serv,2525,226,8,9,17,47.1%,1h
30554,2,MiZi,2525,238,8,15,23,34.8%,55m
30554,3,[KiII]Shata,2525,210,7,0,7,100.0%,57m
30554,1,Andr,2525,192,7,5,12,58.3%,51m
30554,1,QWERTY,2525,205,7,9,16,43.8%,1h
30554,2,youkaidi,2525,214,7,10,17,41.2%,7m
30554,2,[PARSE]Belzeebul,2525,184,6,7,13,46.2%,5m
30554,2,[KOtics]Nickwontell,2525,170,6,11,17,35.3%,53m
30554,3,[ZERGTB]ZergHeil,2525,90,4,3,7,57.1%,34m
30554,3,Toroto,2525,58,3,1,4,75.0%,25m
30554,3,Abzocker,2525,129,3,2,5,60.0%,31m
30554,2,[Riazi]Shams,2525,102,3,2,5,60.0%,1h
30554,3,GromoKoshka,2525,58,2,3,5,40.0%,11m
30554,3,[TН]ThreeRaptors,2525,95,2,3,5,40.0%,37m
30554,2,Jilano,2525,0,2,4,6,33.3%,52m
30554,2,Zorg,2525,30,1,4,5,20.0%,5m
30554,2,Scarlett,2525,0,1,5,6,16.7%,23m
30554,2,RospoCattivo,2525,30,1,6,7,14.3%,11m
30554,3,[CZG]Guisborne,2525,0,0,1,1,0.0%,49m
30554,3,[Monlit]LoLNetKlip,2525,0,0,1,1,0.0%,36m
30554,3,Namele,2525,0,0,1,1,0.0%,2m
30554,1,Diamond,2525,0,0,1,1,0.0%,57m
30554,3,Johnyproo,2525,0,0,2,2,0.0%,1h
30584,2,Vanbonkers,2524,1601,113,111,224,50.4%,3m
30584,3,lukibalboą,2524,927,39,26,65,60.0%,11m
30584,3,[GæG]DirtyD,2524,966,38,31,69,55.1%,55m
30584,1,starleader,2524,868,31,35,66,47.0%,1h
30584,2,[Migos]Kabal,2524,681,29,34,63,46.0%,39m
30584,3,[crabz]MauZeR,2524,672,25,27,52,48.1%,36m
30584,2,Omikron,2524,639,25,31,56,44.6%,6m
30584,2,[Змлн]Веталь,2524,337,13,16,29,44.8%,41m
30584,2,fAbikUs,2524,445,13,20,33,39.4%,6m
30584,3,[AiRǂ]Sottocolle,2524,322,12,8,20,60.0%,7m
30584,2,silver,2524,314,11,18,29,37.9%,1h
30584,2,ForestFergy,2524,278,9,9,18,50.0%,57m
30584,3,Elfi,2524,169,8,2,10,80.0%,26m
30584,2,KorbenDallas,2524,273,8,12,20,40.0%,46m
30584,1,Légions,2524,184,7,7,14,50.0%,26m
30584,3,ExoShadow,2524,207,5,3,8,62.5%,1h
30584,3,TABOR,2524,86,4,0,4,100.0%,58m
30584,3,[WWTG]Desfigurel,2524,144,4,3,7,57.1%,30m
30584,2,jojojojojo,2524,86,4,9,13,30.8%,53m
30584,2,[MFGCUK]Nurdock,2524,150,3,5,8,37.5%,39m
30584,3,pangge,2524,32,3,5,8,37.5%,25m
30584,2,InFlame,2524,30,2,2,4,50.0%,50m
30584,2,LokkiZzz,2524,46,2,4,6,33.3%,3m
30584,3,[ANCST2]ByMHuK,2524,97,2,4,6,33.3%,36m
30584,3,[5BC]Terrorist,2524,97,2,5,7,28.6%,43m
30584,2,gleff,2524,60,2,10,12,16.7%,1h
30584,3,ClodPupon,2524,30,1,1,2,50.0%,1h
30584,3,[TFSC]FenRir,2524,30,1,2,3,33.3%,7m
30584,1,ковеер,2524,48,1,2,3,33.3%,29m
30584,2,Naaya,2524,32,1,5,6,16.7%,1m
30584,3,Scout,2524,0,0,1,1,0.0%,31m
30584,2,[ZERG7V]Dreiko,2524,0,0,2,2,0.0%,43m
30584,3,[DarKsS]Andrew,2524,0,0,2,2,0.0%,38m
30617,2,Wahrwolf,2523,502,20,20,40,50.0%,1h
30617,2,eomerr,2523,287,12,6,18,66.7%,25m
30617,3,[2Ta]NiceParadise,2523,314,12,9,21,57.1%,27m
30617,3,ExtraChasm,2523,249,10,7,17,58.8%,4m
30617,2,Scrabex,2523,279,10,12,22,45.5%,26m
30617,1,WienerVegan,2523,190,7,7,14,50.0%,1h
30617,2,Caronte,2523,184,7,11,18,38.9%,25m
30617,3,dRust,2523,188,6,7,13,46.2%,57m
30617,3,HlibSlob,2523,0,4,4,8,50.0%,6m
30617,3,Stargasm,2523,135,3,3,6,50.0%,37m
30617,2,Kozlostroj,2523,116,3,4,7,42.9%,3m
30617,3,Ubyza,2523,94,2,4,6,33.3%,60m
30617,3,Thor,2523,0,1,2,3,33.3%,1h
30617,3,Tyrael,2523,30,1,2,3,33.3%,44m
30617,3,ZeroCool,2523,30,1,3,4,25.0%,38m
30617,2,[K0RM2]RobotGG,2523,30,1,4,5,20.0%,28m
30617,1,SneakySnek,2523,0,0,1,1,0.0%,56m
30634,3,[BTSM]canee,2522,1599,108,93,201,53.7%,37m
30634,2,Schmulian,2522,712,27,27,54,50.0%,41m
30634,2,ALARM,2522,520,24,23,47,51.1%,1h
30634,3,sserg,2522,432,17,5,22,77.3%,30m
30634,3,NikiTo,2522,370,15,12,27,55.6%,33m
30634,3,GaNDoN,2522,338,14,3,17,82.4%,6m
30634,3,KingJulien,2522,353,13,13,26,50.0%,59m
30634,1,[GG2020]Dragora,2522,206,9,10,19,47.4%,3m
30634,3,AmnnaOcri,2522,194,7,6,13,53.8%,30m
30634,2,Reuseup,2522,222,7,10,17,41.2%,27m
30634,3,OmNomRarg,2522,220,7,10,17,41.2%,33m
30634,2,LEEB,2522,208,7,11,18,38.9%,53m
30634,2,tomfoolery,2522,105,6,6,12,50.0%,43m
30634,3,GiraLord,2522,165,5,4,9,55.6%,27m
30634,1,Wizard,2522,164,5,15,20,25.0%,26m
30634,2,Whatev,2522,129,4,5,9,44.4%,25m
30634,3,Carma,2522,146,3,2,5,60.0%,35m
30634,3,Sanya,2522,159,3,3,6,50.0%,38m
30634,3,Sutorei,2522,66,3,3,6,50.0%,1h
30634,2,BaRuTeKu,2522,60,3,5,8,37.5%,53m
30634,2,Xpert,2522,30,3,5,8,37.5%,11m
30634,3,LAFAUCHEUSE,2522,36,3,6,9,33.3%,37m
30634,2,[EmŦ]blackpearl,2522,90,3,11,14,21.4%,9m
30634,1,[80s]Inestier,2522,0,2,0,2,100.0%,51m
30634,1,Light,2522,0,2,1,3,66.7%,10m
30634,2,Krasi,2522,88,2,2,4,50.0%,1h
30634,3,DoktorWo,2522,38,2,3,5,40.0%,53m
30634,3,Werewerf,2522,0,2,3,5,40.0%,3m
30634,2,King,2522,0,2,4,6,33.3%,1h
30634,1,Wispa,2522,0,1,3,4,25.0%,53m
30634,2,[twerps]Darkmaster,2522,30,1,4,5,20.0%,1h
30634,3,Antuin,2522,0,0,1,1,0.0%,42m
30634,1,[Смешно]Хех,2522,0,0,2,2,0.0%,1h
30634,2,Odasity,2522,0,0,3,3,0.0%,53m
30668,1,edsainsbury,2521,1279,87,84,171,50.9%,33m
30668,3,TheFetaGamer,2521,686,30,15,45,66.7%,60m
30668,2,Wipebolb,2521,661,24,28,52,46.2%,47m
30668,3,zendelphi,2521,477,17,16,33,51.5%,30m
30668,2,Zel,2521,334,12,14,26,46.2%,6m
30668,2,NejniyPatrul,2521,275,9,12,21,42.9%,56m
30668,3,DarkSoul,2521,148,5,8,13,38.5%,8m
30668,3,[SLPRY]HGbeatnik,2521,121,4,5,9,44.4%,2m
30668,3,StAnger,2521,169,4,6,10,40.0%,58m
30668,3,Dzigoro,2521,0,3,2,5,60.0%,36m
30668,1,terri,2521,92,3,13,16,18.8%,9m
30668,3,chris,2521,97,2,5,7,28.6%,49m
30668,3,[HudraD]Omegon,2521,30,1,3,4,25.0%,53m
30668,3,llllllllllll,2521,0,0,1,1,0.0%,43m
30668,3,MaxProTTT,2521,0,0,1,1,0.0%,34m
30668,3,Ekr,2521,0,0,1,1,0.0%,6m
30668,2,DavidH,2521,0,0,2,2,0.0%,7m
30685,2,[SQUI]Lithium,2520,1514,70,65,135,51.9%,47m
30685,3,globo,2520,626,51,41,92,55.4%,2m
30685,2,[HDNKBL]sebinger,2520,853,49,43,92,53.3%,60m
30685,2,xdkssc,2520,745,32,20,52,61.5%,1h
30685,2,yeO,2520,633,23,25,48,47.9%,8m
30685,3,Catherine,2520,484,19,15,34,55.9%,31m
30685,2,[lBBTl]LeBon,2520,421,17,8,25,68.0%,31m
30685,1,hakaki,2520,384,12,15,27,44.4%,1h
30685,1,tweek,2520,205,11,12,23,47.8%,57m
30685,1,Melkor,2520,264,8,13,21,38.1%,37m
30685,3,Artanis,2520,148,8,13,21,38.1%,15m
30685,2,[IQ27]SLopatom,2520,182,6,14,20,30.0%,43m
30685,2,Megadeath,2520,148,5,7,12,41.7%,31m
30685,3,Grondotter,2520,183,4,4,8,50.0%,43m
30685,2,Slash,2520,0,3,3,6,50.0%,52m
30685,2,[PMMM]Alderonzzzo,2520,64,3,7,10,30.0%,4m
30685,3,DLOzTOR,2520,30,2,1,3,66.7%,51m
30685,3,Sengski,2520,0,2,4,6,33.3%,45m
30685,2,[Grund]Dnk,2520,60,2,5,7,28.6%,6m
30685,3,Turuk,2520,0,1,0,1,100.0%,51m
30685,3,VeSeL,2520,97,1,4,5,20.0%,1h
30685,3,[MUNCHA]Bruski,2520,0,0,2,2,0.0%,1h
30685,2,DaRapperJam,2520,0,0,3,3,0.0%,53m
30708,2,lamaking,2519,992,98,68,166,59.0%,56m
30708,2,Skorpion,2519,802,35,29,64,54.7%,57m
30708,1,Мельтиус,2519,743,24,31,55,43.6%,43m
30708,2,Thermal,2519,350,16,15,31,51.6%,37m
30708,1,[GOONI]Fixxx,2519,316,14,10,24,58.3%,39m
30708,3,EJOA,2519,236,8,1,9,88.9%,1h
30708,3,MasterBardo,2519,172,7,5,12,58.3%,3m
30708,1,Swordpl,2519,132,6,5,11,54.5%,60m
30708,3,Doughboy,2519,114,5,3,8,62.5%,43m
30708,3,Verl,2519,148,5,7,12,41.7%,1h
30708,3,[SCGTR]Zerakul,2519,60,3,2,5,60.0%,34m
30708,3,patpanda,2519,89,3,5,8,37.5%,39m
30708,1,[ROvt]PIF,2519,0,2,1,3,66.7%,55m
30708,3,[TPDK]Arcain,2519,30,2,1,3,66.7%,42m
30708,2,luk,2519,60,2,4,6,33.3%,60m
30708,3,[FuNcp]FuNEcLiPsE,2519,30,2,5,7,28.6%,1h
30708,3,Wuschi,2519,0,1,0,1,100.0%,54m
30708,3,TuiMau,2519,0,1,0,1,100.0%,49m
30708,3,[00100]Kyklovod,2519,0,1,1,2,50.0%,60m
30708,3,[LMBD]AGJAJI,2519,0,0,1,1,0.0%,34m
30708,3,mikolka,2519,0,0,1,1,0.0%,27m
30708,3,Dámonische,2519,0,0,1,1,0.0%,1h
30708,3,forser,2519,0,0,1,1,0.0%,60m
30708,3,Vladislav,2519,0,0,1,1,0.0%,35m
30708,2,BeetleJuice,2519,0,0,3,3,0.0%,1h
30708,2,Mario,2519,0,0,5,5,0.0%,1h
30734,3,Gawlas,2518,1577,62,64,126,49.2%,14m
30734,2,[RuCrew]Mozart,2518,1214,50,53,103,48.5%,1h
30734,3,[NUKsyn]Техамега,2518,535,22,17,39,56.4%,41m
30734,3,[CLTM]Kratex,2518,568,21,16,37,56.8%,37m
30734,3,Smarog,2518,302,15,16,31,48.4%,4m
30734,3,Klubzenzyg,2518,350,15,19,34,44.1%,25m
30734,1,Plague,2518,332,15,22,37,40.5%,1h
30734,3,UNDEADBAN,2518,406,14,17,31,45.2%,28m
30734,3,vadimSFru,2518,288,11,7,18,61.1%,1h
30734,2,Acctank,2518,273,10,9,19,52.6%,5m
30734,3,[G3lb]Nexirall,2518,224,8,6,14,57.1%,7m
30734,3,Toxic,2518,195,6,6,12,50.0%,1h
30734,1,BeautifulRUS,2518,170,6,16,22,27.3%,49m
30734,1,[AiRǂ]SaveAz,2518,62,4,9,13,30.8%,35m
30734,3,Phenix,2518,88,3,2,5,60.0%,1h
30734,2,hubert,2518,88,3,6,9,33.3%,5m
30734,3,SnowBeard,2518,95,2,4,6,33.3%,51m
30734,2,[TLOAWS]XARSES,2518,30,1,5,6,16.7%,60m
30734,3,ScherbertLem,2518,0,0,1,1,0.0%,27m
30734,2,KIBERAM,2518,0,0,1,1,0.0%,44m
30734,3,Kriomorf,2518,0,0,1,1,0.0%,51m
30734,3,oxymore,2518,0,0,1,1,0.0%,1h
30756,2,PepVedella,2517,1447,137,125,262,52.3%,25m
30756,2,rhsn,2517,1520,101,92,193,52.3%,30m
30756,3,NonoW,2517,775,79,83,162,48.8%,11m
30756,2,pANIK,2517,771,60,59,119,50.4%,56m
30756,1,Pinchepana,2517,974,60,69,129,46.5%,33m
30756,3,[BuO]destroy,2517,926,53,0,53,100.0%,51m
30756,3,bronzeHero,2517,840,45,13,58,77.6%,41m
30756,2,Groovz,2517,467,23,26,49,46.9%,1h
30756,2,kastamer,2517,563,21,22,43,48.8%,57m
30756,2,[NIHED]CrazyPeti,2517,438,14,20,34,41.2%,47m
30756,1,[LGDH]Boudah,2517,229,13,19,32,40.6%,60m
30756,3,[ZSAA]gectra,2517,316,12,2,14,85.7%,27m
30756,3,[17RED]KaSPeR,2517,365,12,7,19,63.2%,30m
30756,1,noRulez,2517,349,10,18,28,35.7%,51m
30756,2,ProFide,2517,202,8,4,12,66.7%,25m
30756,1,[PBZ]BlackMamba,2517,150,4,15,19,21.1%,5m
30756,1,mozenrad,2517,0,3,2,5,60.0%,1h
30756,1,[Shad0w]xXSnoWManXx,2517,88,3,5,8,37.5%,3m
30756,3,[BTHEB]Penna,2517,121,3,5,8,37.5%,2m
30756,3,iIiIiIiIi,2517,0,2,3,5,40.0%,38m
30756,3,Anton,2517,0,2,5,7,28.6%,42m
30756,3,EZMoney,2517,0,1,0,1,100.0%,31m
30756,3,[Hleb]SMOUrPH,2517,0,1,0,1,100.0%,42m
30756,3,RafikosteFun,2517,0,1,1,2,50.0%,57m
30756,3,StellaZ,2517,0,0,1,1,0.0%,26m
30756,3,kreotib,2517,0,0,1,1,0.0%,30m
30756,3,helion,2517,0,0,1,1,0.0%,49m
30756,2,ElimGarak,2517,0,0,2,2,0.0%,6m
30784,1,GangstaNupe,2516,1521,118,125,243,48.6%,1h
30784,2,Blademaster,2516,1329,52,51,103,50.5%,53m
30784,3,DontStop,2516,1231,51,43,94,54.3%,44m
30784,1,LuckyNoob,2516,577,41,35,76,53.9%,58m
30784,2,DistractedDi,2516,486,21,14,35,60.0%,50m
30784,3,Neks,2516,429,17,10,27,63.0%,23m
30784,2,RiGGzR,2516,276,15,13,28,53.6%,11m
30784,3,ReadyToDead,2516,332,12,17,29,41.4%,8m
30784,2,ArtemkasSs,2516,230,10,12,22,45.5%,53m
30784,1,bobo,2516,198,6,12,18,33.3%,1h
30784,2,ProtonM,2516,194,5,4,9,55.6%,1h
30784,2,Knusken,2516,142,5,12,17,29.4%,39m
30784,1,Sevolito,2516,138,4,18,22,18.2%,43m
30784,3,[DrPlat]Supersten,2516,74,3,2,5,60.0%,1h
30784,3,Nephalem,2516,97,3,5,8,37.5%,45m
30784,2,Thanhye,2516,60,3,8,11,27.3%,3m
30784,3,Benzincioo,2516,97,2,1,3,66.7%,59m
30784,2,Azazel,2516,30,2,8,10,20.0%,42m
30784,3,BackPocket,2516,30,1,1,2,50.0%,37m
30784,3,CozeirTag,2516,97,1,2,3,33.3%,1h
30784,3,heeeeeeeeeee,2516,30,1,2,3,33.3%,52m
30784,3,Mer,2516,30,1,3,4,25.0%,49m
30784,2,GrandMom,2516,90,1,3,4,25.0%,1h
30784,2,Sqall,2516,0,0,3,3,0.0%,1h
30808,2,Calypso,2515,624,44,40,84,52.4%,7m
30808,2,Rozé,2515,639,26,21,47,55.3%,1h
30808,3,[dpw]TooMuchSky,2515,580,22,21,43,51.2%,39m
30808,2,NoBoDy,2515,353,14,19,33,42.4%,52m
30808,3,Ultimatule,2515,305,10,6,16,62.5%,37m
30808,2,CAndrey,2515,241,9,9,18,50.0%,31m
30808,1,[ZERGTV]Baron,2515,287,8,15,23,34.8%,1h
30808,3,[rtn]Johnny,2515,212,7,7,14,50.0%,51m
30808,3,[GEB]ZeTA,2515,177,7,12,19,36.8%,60m
30808,2,Край,2515,114,6,8,14,42.9%,5m
30808,3,Evgeny,2515,120,5,4,9,55.6%,3m
30808,3,[Jotaro]firestargame,2515,90,4,4,8,50.0%,11m
30808,2,maXXar,2515,127,4,5,9,44.4%,55m
30808,1,CloneY,2515,90,3,3,6,50.0%,56m
30808,3,max,2515,0,3,6,9,33.3%,20m
30808,3,[ExTr1m]CanadianRus,2515,58,2,2,4,50.0%,44m
30808,1,[BZIG]coupe,2515,0,2,3,5,40.0%,1h
30808,1,Fengo,2515,0,2,3,5,40.0%,8m
30808,3,Ryones,2515,30,1,1,2,50.0%,31m
30808,3,[Arrows]dikkkkkkkkkk,2515,0,1,1,2,50.0%,31m
30808,1,Wizart,2515,0,1,2,3,33.3%,9m
30808,3,[STAPH]Sharkieboy,2515,0,1,4,5,20.0%,39m
30808,3,oguzalb,2515,0,0,1,1,0.0%,39m
30808,3,luffy,2515,0,0,2,2,0.0%,2m
30808,3,Silencerx,2515,0,0,3,3,0.0%,49m
30808,2,StevePS,2515,0,0,3,3,0.0%,10m
30808,2,Bignic,2515,0,0,6,6,0.0%,40m
30835,1,CubaXLibre,2514,1613,104,100,204,51.0%,60m
30835,2,Killsoftly,2514,1215,100,90,190,52.6%,6m
30835,3,Ullltra,2514,1440,81,74,155,52.3%,44m
30835,2,spellcaster,2514,1042,45,36,81,55.6%,3m
30835,3,Sketch,2514,373,22,17,39,56.4%,50m
30835,2,dalaraz,2514,297,20,24,44,45.5%,47m
30835,3,Schmerlz,2514,538,18,34,52,34.6%,12m
30835,3,[RvdS]Thorin,2514,333,15,1,16,93.8%,28m
30835,3,[EKORN]Buril,2514,379,15,17,32,46.9%,8m
30835,2,Petrofuga,2514,258,11,6,17,64.7%,45m
30835,2,angara,2514,356,11,15,26,42.3%,23m
30835,3,kostja,2514,235,8,9,17,47.1%,30m
30835,3,БАЕТЦ,2514,60,6,2,8,75.0%,37m
30835,3,[MNGGTV]Pisa,2514,116,5,5,10,50.0%,1h
30835,3,NancYe,2514,145,4,5,9,44.4%,37m
30835,3,[Aмун]Максим,2514,30,2,0,2,100.0%,39m
30835,3,RedLeader,2514,0,2,1,3,66.7%,11m
30835,3,Hydralich,2514,76,2,4,6,33.3%,30m
30835,3,ReVan,2514,88,1,1,2,50.0%,2m
30835,3,foxegamer,2514,0,1,1,2,50.0%,8m
30835,3,SomeboDY,2514,0,0,1,1,0.0%,7m
30835,3,Tselest,2514,0,0,1,1,0.0%,35m
30835,2,[Пиупиу]Andrey,2514,0,0,2,2,0.0%,36m
30835,2,HuMaaaN,2514,0,0,3,3,0.0%,3m
30859,2,Ubiquitous,2513,1568,95,95,190,50.0%,30m
30859,2,Плохиш,2513,452,16,19,35,45.7%,1h
30859,2,Taipan,2513,524,16,29,45,35.6%,1h
30859,1,Värdegrundrn,2513,297,13,10,23,56.5%,8m
30859,3,ferz,2513,232,9,7,16,56.2%,28m
30859,1,koprulu,2513,114,4,6,10,40.0%,32m
30859,3,llucke,2513,119,3,3,6,50.0%,11m
30859,2,[Z3RG7V]Злой,2513,60,3,4,7,42.9%,10m
30859,2,Chewyy,2513,30,3,5,8,37.5%,25m
30859,3,MorpheusCZ,2513,118,3,5,8,37.5%,11m
30859,2,weto,2513,38,2,2,4,50.0%,10m
30859,2,angrypanda,2513,30,2,7,9,22.2%,1h
30859,3,[ESP1]Legislador,2513,0,1,0,1,100.0%,28m
30859,1,[izék]Skydrive,2513,0,1,1,2,50.0%,46m
30859,3,OldDad,2513,30,1,1,2,50.0%,49m
30859,3,Necko,2513,30,1,2,3,33.3%,25m
30859,3,[onimee]RaySan,2513,97,1,2,3,33.3%,47m
30859,3,[BoShak]Thatassadar,2513,0,0,1,1,0.0%,39m
30877,2,Pil,2512,1433,131,125,256,51.2%,26m
30877,2,Will,2512,980,47,54,101,46.5%,1h
30877,2,IIIIIIIIIIII,2512,1036,44,36,80,55.0%,3m
30877,3,[U19]BulBul,2512,640,35,1,36,97.2%,46m
30877,3,Idimmy,2512,846,32,33,65,49.2%,44m
30877,1,Spiridon,2512,545,23,21,44,52.3%,59m
30877,2,MiQuan,2512,532,19,19,38,50.0%,30m
30877,2,[LMBD]demci,2512,479,18,17,35,51.4%,50m
30877,3,drahlana,2512,473,16,13,29,55.2%,50m
30877,2,Ivan,2512,220,16,15,31,51.6%,1h
30877,1,Zidan,2512,417,13,20,33,39.4%,34m
30877,3,RobPiton,2512,196,5,6,11,45.5%,51m
30877,3,[BnW]Caleya,2512,164,4,5,9,44.4%,1h
30877,3,[БИЗНЕС]VOLKAR,2512,0,2,0,2,100.0%,46m
30877,3,Sedativ,2512,30,2,1,3,66.7%,42m
30877,1,LightReaper,2512,48,1,4,5,20.0%,39m
30877,3,Aggrogant,2512,0,0,2,2,0.0%,26m
30894,1,[ExTr1m]HuliPasesh,2511,1586,360,356,716,50.3%,1h
30894,3,[Dipo]DPGALEX,2511,976,42,46,88,47.7%,49m
30894,2,westo,2511,712,27,27,54,50.0%,56m
30894,2,darkskykling,2511,388,21,14,35,60.0%,9m
30894,2,ElKoala,2511,468,18,16,34,52.9%,32m
30894,2,anub,2511,370,13,13,26,50.0%,53m
30894,2,Vegeta,2511,301,12,12,24,50.0%,48m
30894,2,[z666z]AFTAXA,2511,196,6,5,11,54.5%,37m
30894,3,[STDES]JAKUB,2511,105,3,0,3,100.0%,42m
30894,3,Wxllnxr,2511,96,3,3,6,50.0%,50m
30894,3,hiatus,2511,96,3,3,6,50.0%,6m
30894,2,DrSceern,2511,94,3,7,10,30.0%,53m
30894,3,Rouge,2511,97,2,3,5,40.0%,6m
30894,1,[CripOG]Boris,2511,48,2,4,6,33.3%,35m
30894,3,Kaczinsky,2511,60,2,4,6,33.3%,1h
30894,3,Quarzfels,2511,0,1,0,1,100.0%,35m
30894,3,meegyx,2511,0,1,0,1,100.0%,41m
30894,3,Testarosa,2511,0,1,0,1,100.0%,34m
30894,1,XxDarkHeroxX,2511,48,1,1,2,50.0%,29m
30894,3,Igord,2511,0,1,2,3,33.3%,1h
30894,2,drC,2511,0,0,1,1,0.0%,26m
30894,3,Uninie,2511,0,0,1,1,0.0%,52m
30894,3,[DS24]HABOW,2511,0,0,1,1,0.0%,4m
30894,3,rInaS,2511,0,0,2,2,0.0%,2m
30894,1,[STRIP2]EDK,2511,0,0,4,4,0.0%,7m
30894,3,[LosTG]Kingz,2511,0,0,5,5,0.0%,31m
30920,2,[PS23]IVirtual,2510,1443,66,49,115,57.4%,53m
30920,2,franklucas,2510,1177,43,46,89,48.3%,41m
30920,3,Bladerunner,2510,589,26,25,51,51.0%,11m
30920,2,[FR1]Vlayd,2510,336,13,21,34,38.2%,9m
30920,2,[Saber]Winter,2510,422,13,21,34,38.2%,1h
30920,2,[Витязи]Akbar,2510,160,7,5,12,58.3%,1h
30920,3,Devil,2510,166,7,8,15,46.7%,60m
30920,3,Aalac,2510,111,5,2,7,71.4%,58m
30920,2,[TSGs]Sevkko,2510,122,4,8,12,33.3%,42m
30920,3,Wepix,2510,116,3,4,7,42.9%,51m
30920,3,Jester,2510,60,2,4,6,33.3%,26m
30920,3,Rohlík,2510,0,1,0,1,100.0%,33m
30920,2,FeuerGOtt,2510,0,1,1,2,50.0%,43m
30920,2,TSGXBOT,2510,89,1,2,3,33.3%,28m
30920,2,Margorg,2510,46,1,4,5,20.0%,3m
30920,3,[RavB]ZeratUl,2510,0,0,1,1,0.0%,38m
30920,3,antegrOS,2510,0,0,1,1,0.0%,38m
30920,3,Маркус,2510,0,0,1,1,0.0%,1h
30920,3,Method,2510,0,0,1,1,0.0%,39m
30920,3,GodStopMe,2510,0,0,1,1,0.0%,38m
30920,3,Powerflower,2510,0,0,2,2,0.0%,60m
30920,1,DTC,2510,0,0,2,2,0.0%,33m
30920,3,kosmos,2510,0,0,3,3,0.0%,60m
30920,2,[CuriO]CuriosityO,2510,0,0,8,8,0.0%,1h
30944,1,Noobasik,2509,1419,72,73,145,49.7%,46m
30944,1,[ǂFrank]DaveBowman,2509,947,53,61,114,46.5%,45m
30944,3,[PiGPan]Inspired,2509,653,41,37,78,52.6%,60m
30944,2,generalKur,2509,636,23,25,48,47.9%,55m
30944,1,parasit,2509,434,14,22,36,38.9%,33m
30944,2,EnJE,2509,149,9,8,17,52.9%,1h
30944,3,Light,2509,100,8,4,12,66.7%,2m
30944,3,RazalT,2509,259,8,8,16,50.0%,55m
30944,2,Zerga,2509,143,6,3,9,66.7%,50m
30944,2,[hexOr]насоксудьбы,2509,146,6,10,16,37.5%,42m
30944,3,DeadAlbus,2509,0,5,0,5,100.0%,2m
30944,2,Destructeur,2509,108,5,3,8,62.5%,37m
30944,3,Indelion,2509,86,4,4,8,50.0%,46m
30944,2,Lion,2509,90,3,4,7,42.9%,9m
30944,1,Lionheart,2509,48,1,1,2,50.0%,44m
30944,3,xeon,2509,0,1,2,3,33.3%,3m
30944,2,BigBrother,2509,0,1,2,3,33.3%,28m
30944,1,ROCK,2509,0,1,3,4,25.0%,1h
30944,1,[WIMW]ChubsChase,2509,0,0,1,1,0.0%,3m
30944,3,Serenis,2509,0,0,1,1,0.0%,60m
30964,3,Tortor,2508,1575,168,160,328,51.2%,26m
30964,1,ElCuCo,2508,935,44,38,82,53.7%,35m
30964,3,Gabers,2508,305,38,29,67,56.7%,41m
30964,2,Bothi,2508,813,31,34,65,47.7%,42m
30964,2,nobiik,2508,401,15,18,33,45.5%,2m
30964,3,dvadsatedva,2508,243,10,16,26,38.5%,26m
30964,2,[MAUD]thefull,2508,244,7,9,16,43.8%,39m
30964,3,PsychoTSO,2508,60,3,4,7,42.9%,1h
30964,3,ZiQ,2508,60,2,3,5,40.0%,41m
30964,2,[xXQXx]Meatbag,2508,0,2,4,6,33.3%,1h
30964,3,SilentSword,2508,30,1,2,3,33.3%,2m
30964,2,IIIIIIIIIIII,2508,30,1,5,6,16.7%,48m
30964,3,Cront,2508,0,0,1,1,0.0%,55m
30977,3,OSIRIS,2507,988,168,149,317,53.0%,36m
30977,2,Shroom,2507,859,58,56,114,50.9%,41m
30977,2,KetaHans,2507,966,48,47,95,50.5%,35m
30977,3,Soul,2507,669,41,37,78,52.6%,37m
30977,2,Mnmlsm,2507,279,23,17,40,57.5%,23m
30977,1,Sirtomw,2507,296,12,5,17,70.6%,1h
30977,3,Rexen,2507,121,6,3,9,66.7%,1h
30977,3,rafa,2507,175,5,7,12,41.7%,38m
30977,1,[Xenor]DarkStorm,2507,145,4,1,5,80.0%,40m
30977,2,[AK47]HOH,2507,154,4,6,10,40.0%,6m
30977,3,[ExYu]screamzerO,2507,0,2,3,5,40.0%,1h
30977,3,[FOXGMS]StarPaladin,2507,60,2,4,6,33.3%,49m
30977,3,Tarmi,2507,97,2,4,6,33.3%,1h
30977,3,[BULB]Faraday,2507,0,1,0,1,100.0%,58m
30977,1,[696]interceptor,2507,0,1,0,1,100.0%,37m
30977,1,ArkturMengsk,2507,0,1,2,3,33.3%,56m
30977,3,Jamba,2507,0,1,2,3,33.3%,1h
30994,1,[ĐoŁ]Masarykt,2506,1607,622,626,1248,49.8%,9m
30994,2,SDanny,2506,877,50,40,90,55.6%,9m
30994,3,HugoHorror,2506,1170,43,40,83,51.8%,4m
30994,2,TestoTom,2506,1094,42,39,81,51.9%,36m
30994,3,Anarchy,2506,892,34,32,66,51.5%,1h
30994,3,Trainee,2506,765,30,25,55,54.5%,8m
30994,2,XROYALxRAGEX,2506,331,15,14,29,51.7%,57m
30994,2,yvos,2506,358,14,12,26,53.8%,45m
30994,3,LutiK,2506,380,14,13,27,51.9%,2m
30994,3,ЗлойФотончик,2506,385,13,10,23,56.5%,26m
30994,2,AGRESS,2506,255,12,16,28,42.9%,36m
30994,3,[grimgr]icedregon,2506,286,9,4,13,69.2%,59m
30994,2,efro,2506,240,9,11,20,45.0%,1h
30994,3,[reinor]ultralchick,2506,226,8,0,8,100.0%,60m
30994,3,TheSx,2506,120,7,2,9,77.8%,1h
30994,2,bashor,2506,147,6,4,10,60.0%,3m
30994,1,hearthdragon,2506,186,6,10,16,37.5%,58m
30994,3,GogetaSSJ,2506,169,5,6,11,45.5%,1h
30994,3,[22asw1]BENIS,2506,114,4,4,8,50.0%,35m
30994,2,servion,2506,152,4,6,10,40.0%,3m
30994,3,Amiko,2506,97,3,4,7,42.9%,30m
30994,3,Bob,2506,97,3,5,8,37.5%,38m
30994,1,ptflea,2506,0,2,3,5,40.0%,32m
30994,3,ваня,2506,0,1,0,1,100.0%,4m
30994,1,SpONgE,2506,0,1,0,1,100.0%,1h
30994,3,ВинныйМастер,2506,30,1,4,5,20.0%,11m
30994,2,pazair,2506,30,1,8,9,11.1%,34m
30994,3,[HZeS]Dyllarian,2506,0,0,1,1,0.0%,11m
30994,2,macron,2506,0,0,4,4,0.0%,1h
31023,2,Rocco,2505,1552,160,157,317,50.5%,58m
31023,2,latinos,2505,1174,154,131,285,54.0%,57m
31023,1,[basdp]OLDBOY,2505,1434,136,137,273,49.8%,39m
31023,1,Midnight,2505,463,69,78,147,46.9%,34m
31023,3,straszyk,2505,1026,62,76,138,44.9%,18m
31023,3,[GgWp9]leo,2505,1151,49,33,82,59.8%,2m
31023,2,NottNott,2505,928,40,33,73,54.8%,40m
31023,2,aleksa,2505,566,35,19,54,64.8%,32m
31023,2,babouc,2505,794,30,33,63,47.6%,1h
31023,3,Suske,2505,400,14,18,32,43.8%,26m
31023,2,Sickness,2505,318,13,15,28,46.4%,10m
31023,2,Frosti,2505,272,9,14,23,39.1%,1h
31023,2,jihadxdeath,2505,226,7,6,13,53.8%,10m
31023,3,alex,2505,165,5,3,8,62.5%,30m
31023,2,StevenToast,2505,128,4,3,7,57.1%,34m
31023,3,[TeUn]Kai,2505,143,4,6,10,40.0%,24m
31023,3,Joapie,2505,86,3,3,6,50.0%,49m
31023,3,[RullP]Findus,2505,90,3,5,8,37.5%,4m
31023,3,Legion,2505,0,3,6,9,33.3%,58m
31023,3,FannyFart,2505,0,2,3,5,40.0%,38m
31023,2,FairCry,2505,0,1,0,1,100.0%,2m
31023,3,kebeko,2505,30,1,1,2,50.0%,49m
31023,3,Healthy,2505,30,1,1,2,50.0%,1h
31023,3,Gewürzgurke,2505,0,0,1,1,0.0%,27m
31023,3,[VGSC]Jakhals,2505,0,0,1,1,0.0%,30m
31023,3,jibeljay,2505,0,0,2,2,0.0%,50m
31049,3,Kmicic,2504,1445,301,300,601,50.1%,14m
31049,2,[EZPR]Crea,2504,882,77,73,150,51.3%,31m
31049,2,OverlordUA,2504,801,28,30,58,48.3%,53m
31049,2,Xalok,2504,330,26,27,53,49.1%,42m
31049,1,dukedethron,2504,652,25,27,52,48.1%,1h
31049,2,[TFG]Spof,2504,742,23,48,71,32.4%,3m
31049,2,[Stront]ManyMistakes,2504,618,18,38,56,32.1%,7m
31049,3,Pyndersboele,2504,259,13,6,19,68.4%,7m
31049,3,[ICFTA]xuz,2504,427,13,16,29,44.8%,35m
31049,3,BigBens,2504,337,12,9,21,57.1%,28m
31049,2,kiloYOle,2504,136,6,10,16,37.5%,37m
31049,1,Rikost,2504,160,6,14,20,30.0%,1h
31049,3,Lurkerman,2504,170,5,4,9,55.6%,53m
31049,1,LOWMANAMAGE,2504,145,3,1,4,75.0%,56m
31049,3,Zellion,2504,58,3,1,4,75.0%,1h
31049,3,MaxPower,2504,58,3,2,5,60.0%,23m
31049,2,[Faith1]DrBanshee,2504,30,2,3,5,40.0%,3m
31049,3,Alexceed,2504,30,1,1,2,50.0%,50m
31049,3,ErrorMSE,2504,0,0,3,3,0.0%,30m
31068,3,leoken,2503,1536,351,370,721,48.7%,12m
31068,3,[SCGGA]DBG,2503,1620,125,117,242,51.7%,39m
31068,1,merola,2503,907,74,72,146,50.7%,30m
31068,3,zekken,2503,504,39,33,72,54.2%,39m
31068,3,[N1NJ4Z]Patilan,2503,849,35,23,58,60.3%,11m
31068,2,LiveInAmbeR,2503,704,27,24,51,52.9%,3m
31068,1,AlphaPulsar,2503,488,22,22,44,50.0%,1h
31068,3,NOxplode,2503,634,22,25,47,46.8%,8m
31068,2,Grotteneule,2503,495,18,17,35,51.4%,39m
31068,2,LilPonk,2503,378,15,20,35,42.9%,24m
31068,3,IIIIIIIIIIII,2503,284,10,9,19,52.6%,24m
31068,2,nbz,2503,292,10,15,25,40.0%,3m
31068,2,Becool,2503,231,9,8,17,52.9%,45m
31068,2,ArKax,2503,208,9,12,21,42.9%,37m
31068,3,Saints,2503,153,7,5,12,58.3%,41m
31068,2,глазктулху,2503,229,7,6,13,53.8%,24m
31068,2,[CCP2]ADE,2503,160,5,9,14,35.7%,47m
31068,3,DukeNukem,2503,147,4,1,5,80.0%,6m
31068,2,Strus,2503,88,4,6,10,40.0%,57m
31068,3,Lebedun,2503,88,3,4,7,42.9%,49m
31068,2,Eselreiter,2503,114,3,4,7,42.9%,1h
31068,1,Джей,2503,0,2,3,5,40.0%,39m
31068,2,Sanya,2503,0,2,4,6,33.3%,43m
31068,1,SoulReapers,2503,48,2,4,6,33.3%,3m
31068,3,[СБ]vZASADE,2503,0,1,0,1,100.0%,1h
31068,2,jakub,2503,96,1,3,4,25.0%,42m
31068,3,[Барсик]абатур,2503,0,0,1,1,0.0%,51m
31068,3,[russpr]Warvar,2503,0,0,1,1,0.0%,55m
31068,3,[ZM]Wolfmdr,2503,0,0,1,1,0.0%,1h
31068,3,Gladiator,2503,0,0,1,1,0.0%,55m
31098,2,Insaybr,2502,1562,149,138,287,51.9%,10m
31098,3,Moa,2502,1607,73,63,136,53.7%,50m
31098,2,Tito,2502,1291,60,51,111,54.1%,1h
31098,2,[DEDAL]darxx,2502,1211,49,46,95,51.6%,9m
31098,3,TheGammie,2502,898,41,30,71,57.7%,11m
31098,1,maru,2502,633,24,28,52,46.2%,9m
31098,1,Drus,2502,338,23,27,50,46.0%,48m
31098,3,УльтраЗерг,2502,432,21,9,30,70.0%,60m
31098,3,Misha,2502,366,15,7,22,68.2%,50m
31098,2,kopatch,2502,403,14,14,28,50.0%,1h
31098,2,dontgo,2502,412,14,15,29,48.3%,56m
31098,2,kordez,2502,392,14,18,32,43.8%,1h
31098,1,NonUddaDan,2502,384,13,19,32,40.6%,45m
31098,2,Redrum,2502,354,12,16,28,42.9%,2m
31098,2,TakéoThéodus,2502,96,8,10,18,44.4%,1h
31098,2,BoBObOLIciU,2502,142,6,6,12,50.0%,60m
31098,1,PegasoGbg,2502,200,6,15,21,28.6%,3m
31098,2,Sleepwalker,2502,124,4,11,15,26.7%,57m
31098,1,iqus,2502,145,3,1,4,75.0%,35m
31098,3,Elfsarkany,2502,127,3,1,4,75.0%,51m
31098,3,gronichon,2502,86,3,4,7,42.9%,23m
31098,1,GoldOmasz,2502,88,3,5,8,37.5%,10m
31098,2,Nova,2502,96,3,6,9,33.3%,2m
31098,1,Blackroro,2502,96,3,8,11,27.3%,60m
31098,3,димоооон,2502,30,2,1,3,66.7%,40m
31098,2,elbufa,2502,7,2,10,12,16.7%,2m
31098,3,[DeaDNB]BLACKSTAR,2502,0,1,0,1,100.0%,38m
31098,2,[APIPIS]RushB,2502,95,1,3,4,25.0%,1h
31098,2,[Nukeu]Xseros,2502,0,1,4,5,20.0%,31m
31098,1,IntoTheAbyss,2502,0,0,1,1,0.0%,39m
31098,3,NighTMaRe,2502,0,0,1,1,0.0%,45m
31098,3,[P0W3RD]SuperTeej,2502,0,0,1,1,0.0%,38m
31130,2,Andrey,2501,1352,160,176,336,47.6%,19m
31130,2,Elior,2501,979,84,84,168,50.0%,26m
31130,2,[SPAINs]Salchipapa,2501,606,25,23,48,52.1%,48m
31130,3,DeMarco,2501,285,16,14,30,53.3%,39m
31130,3,матвей,2501,234,8,9,17,47.1%,51m
31130,2,NavySeal,2501,202,6,9,15,40.0%,53m
31130,2,fRANELI,2501,144,5,5,10,50.0%,25m
31130,1,Сергей,2501,186,4,4,8,50.0%,52m
31130,2,Stachun,2501,90,4,5,9,44.4%,1h
31130,3,canonmaster,2501,58,3,0,3,100.0%,31m
31130,3,Tobi,2501,118,3,1,4,75.0%,1h
31130,1,Devitor,2501,0,3,7,10,30.0%,8m
31130,1,Vollkornmehl,2501,76,3,11,14,21.4%,37m
31130,1,Kaelthas,2501,97,2,4,6,33.3%,43m
31130,1,Sathol,2501,0,2,4,6,33.3%,41m
31130,3,[FIN9]Chadowlol,2501,95,2,4,6,33.3%,1h
31130,1,Серега,2501,30,2,10,12,16.7%,24m
31130,3,minatokai,2501,0,1,0,1,100.0%,26m
31130,3,MrK,2501,0,0,1,1,0.0%,38m
31130,2,kiberAlex,2501,0,0,1,1,0.0%,27m
31150,2,phalanx,2500,1501,168,172,340,49.4%,1h
31150,2,EDAM,2500,1305,50,50,100,50.0%,31m
31150,3,[HsDL]bonnieTv,2500,1117,45,42,87,51.7%,51m
31150,3,Vuda,2500,955,36,35,71,50.7%,41m
31150,3,Crusader,2500,611,25,18,43,58.1%,45m
31150,2,[CMArmy]PoyZone,2500,354,13,19,32,40.6%,1h
31150,2,Crulo,2500,341,12,14,26,46.2%,5m
31150,3,Crossraiser,2500,278,12,16,28,42.9%,5m
31150,2,Aliasborat,2500,282,11,11,22,50.0%,56m
31150,1,zidan,2500,334,11,18,29,37.9%,28m
31150,2,Бабайка,2500,308,9,11,20,45.0%,52m
31150,3,AllPlay,2500,208,7,3,10,70.0%,6m
31150,2,cancentan,2500,163,4,4,8,50.0%,5m
31150,2,[ApKorv]Boorran,2500,128,4,7,11,36.4%,25m
31150,1,[EnBois]Cnetom,2500,134,4,8,12,33.3%,57m
31150,3,borgius,2500,90,3,2,5,60.0%,25m
31150,3,ThisIsASteak,2500,0,3,4,7,42.9%,46m
31150,2,Raven,2500,96,3,8,11,27.3%,1h
31150,3,Cromwill,2500,30,2,2,4,50.0%,38m
31150,1,MayDayBear,2500,48,2,5,7,28.6%,39m
31150,2,FINN,2500,72,2,7,9,22.2%,41m
31150,3,[XPLcX]Carlo,2500,0,1,0,1,100.0%,50m
31150,3,STARWARS,2500,0,1,0,1,100.0%,38m
31150,3,Melofmatix,2500,0,1,0,1,100.0%,37m
31150,3,Гранит,2500,0,1,0,1,100.0%,1h
31150,3,Ren,2500,30,1,1,2,50.0%,58m
31150,2,Fenix,2500,30,1,7,8,12.5%,53m
31150,3,Dirge,2500,0,0,1,1,0.0%,35m
31150,2,misterp,2500,0,0,3,3,0.0%,30m
31150,3,Modżo,2500,0,0,3,3,0.0%,58m
31180,2,[zik]ale,2499,745,33,25,58,56.9%,38m
31180,2,Pahomath,2499,268,8,11,19,42.1%,10m
31180,3,CommanderLeo,2499,216,7,2,9,77.8%,55m
31180,2,FrozenLord,2499,199,7,5,12,58.3%,1h
31180,3,krj,2499,90,4,4,8,50.0%,1h
31180,3,[NWGD]GraphpiTTV,2499,143,4,4,8,50.0%,28m
31180,3,[HnRiCh]MrsMarpel,2499,97,3,5,8,37.5%,8m
31180,3,SaN,2499,0,3,6,9,33.3%,6m
31180,3,ParamValue,2499,122,2,2,4,50.0%,11m
31180,3,Helmut,2499,96,2,4,6,33.3%,28m
31180,1,aech,2499,0,2,4,6,33.3%,30m
31180,2,HaGEN,2499,30,1,4,5,20.0%,35m
31180,2,Wragosh,2499,30,1,8,9,11.1%,46m
31180,1,[PtiLou]Milpub,2499,0,0,1,1,0.0%,46m
31180,3,Андрейка,2499,0,0,1,1,0.0%,4m
31195,2,Booger,2498,1054,81,79,160,50.6%,38m
31195,2,SnowBars,2498,1238,55,43,98,56.1%,38m
31195,2,Legenus,2498,1126,53,52,105,50.5%,41m
31195,2,[SPS31]twinky,2498,696,25,27,52,48.1%,3m
31195,3,[SoWas]Neight,2498,157,13,7,20,65.0%,23m
31195,2,[LHPS]Nogard,2498,380,13,18,31,41.9%,1h
31195,3,Xant,2498,310,12,13,25,48.0%,42m
31195,1,Rick,2498,300,11,12,23,47.8%,3m
31195,3,JaKuboPrvy,2498,289,10,11,21,47.6%,55m
31195,2,DarkstormD,2498,274,9,11,20,45.0%,57m
31195,2,Vasea,2498,254,9,13,22,40.9%,53m
31195,2,Touine,2498,166,7,6,13,53.8%,2m
31195,1,Moskuz,2498,96,5,3,8,62.5%,53m
31195,2,[IceN]Wibble,2498,90,4,13,17,23.5%,21m
31195,2,DPDOOM,2498,163,3,1,4,75.0%,1h
31195,1,Glith,2498,121,3,1,4,75.0%,6m
31195,3,Timms,2498,118,3,4,7,42.9%,57m
31195,1,Deadwood,2498,0,2,4,6,33.3%,47m
31195,2,Torgerd,2498,96,2,5,7,28.6%,7m
31195,3,[TLAS]Kushnaa,2498,0,1,0,1,100.0%,37m
31195,3,Bunya,2498,0,1,0,1,100.0%,1h
31195,3,[TeamKy]KryroK,2498,0,1,0,1,100.0%,1h
31195,2,Tagano,2498,88,1,4,5,20.0%,1h
31195,3,GunPower,2498,0,1,4,5,20.0%,42m
31195,3,grisiel,2498,0,0,1,1,0.0%,46m
31195,3,HunterGOOD,2498,0,0,1,1,0.0%,7m
31221,2,kiwi,2497,1513,135,139,274,49.3%,57m
31221,1,xekaj,2497,674,48,44,92,52.2%,1h
31221,3,zerGeeWoo,2497,1134,44,37,81,54.3%,39m
31221,3,[Specim]Vuorineuvos,2497,729,42,22,64,65.6%,25m
31221,3,Raycor,2497,286,25,16,41,61.0%,49m
31221,2,Vlados,2497,371,18,23,41,43.9%,1h
31221,3,Nemelis,2497,363,14,6,20,70.0%,49m
31221,1,[UNTS]onehenderson,2497,430,14,24,38,36.8%,37m
31221,3,IIIIIIIIIII,2497,290,12,6,18,66.7%,49m
31221,2,BirzhanIM,2497,262,10,13,23,43.5%,31m
31221,2,Link,2497,232,8,14,22,36.4%,31m
31221,3,HiDik,2497,208,7,4,11,63.6%,58m
31221,3,[BTSM]Dementor,2497,168,7,5,12,58.3%,53m
31221,3,ovigomy,2497,218,6,4,10,60.0%,25m
31221,2,medea,2497,205,6,9,15,40.0%,8m
31221,1,[FilsDe]zewolf,2497,184,5,18,23,21.7%,42m
31221,3,mycelium,2497,0,4,1,5,80.0%,1h
31221,3,xvtee,2497,0,2,3,5,40.0%,39m
31221,3,[ExTr1m]Dehaka,2497,0,1,0,1,100.0%,6m
31221,2,[Drunk9]RouSou,2497,42,1,2,3,33.3%,8m
31241,3,Trixy,2496,1377,53,56,109,48.6%,3m
31241,1,Sexinant,2496,835,38,31,69,55.1%,55m
31241,3,[NWAro]Tavi,2496,793,35,21,56,62.5%,50m
31241,3,Martin,2496,631,24,21,45,53.3%,28m
31241,3,Qortex,2496,518,18,20,38,47.4%,1h
31241,3,Adlay,2496,377,15,13,28,53.6%,42m
31241,2,Macelix,2496,224,8,13,21,38.1%,9m
31241,3,Tark,2496,114,6,6,12,50.0%,27m
31241,3,[ССРа]Дрын,2496,180,6,7,13,46.2%,26m
31241,2,younduck,2496,120,6,9,15,40.0%,36m
31241,3,pinkie,2496,172,5,6,11,45.5%,60m
31241,2,Phoenix,2496,0,4,2,6,66.7%,1h
31241,3,Sławomir,2496,118,4,6,10,40.0%,50m
31241,3,Timingsleet,2496,88,3,5,8,37.5%,31m
31241,3,Zhorikcccp,2496,30,2,2,4,50.0%,3m
31241,3,[GdAT]Righteousnes,2496,0,2,3,5,40.0%,53m
31241,3,ShuRik,2496,0,2,3,5,40.0%,34m
31241,3,[REGGE]LsdTino,2496,60,2,5,7,28.6%,39m
31241,3,nikodim,2496,30,1,1,2,50.0%,1h
31241,2,Silencioo,2496,0,1,2,3,33.3%,35m
31241,3,RIMIKS,2496,30,1,3,4,25.0%,39m
31241,3,Rafas,2496,30,1,3,4,25.0%,43m
31241,2,[Rajkit]NazMax,2496,0,1,5,6,16.7%,25m
31241,1,[WCKYLN]JaysonSAN,2496,0,1,7,8,12.5%,58m
31241,1,MercyHentai,2496,0,0,1,1,0.0%,44m
31241,3,tga,2496,0,0,1,1,0.0%,11m
31241,3,[FGС]SurFnute,2496,0,0,1,1,0.0%,49m
31241,3,[UNoobz]TurtleMagic,2496,0,0,2,2,0.0%,35m
31241,3,Tamles,2496,0,0,3,3,0.0%,51m
31270,2,[Duzk]Perseus,2495,1007,135,131,266,50.8%,56m
31270,2,Tsipa,2495,1556,129,122,251,51.4%,39m
31270,3,Toxichof,2495,1048,93,79,172,54.1%,9m
31270,3,Totowipeout,2495,1206,56,47,103,54.4%,1h
31270,3,RoachRush,2495,490,51,35,86,59.3%,42m
31270,3,[AtrK]MaverickS,2495,819,33,23,56,58.9%,28m
31270,2,[LBE]Supermomo,2495,395,16,16,32,50.0%,41m
31270,3,[LMBD]ÜlkücüMarine,2495,374,15,13,28,53.6%,58m
31270,3,Katchinga,2495,418,15,14,29,51.7%,33m
31270,3,Daniela,2495,401,14,15,29,48.3%,9m
31270,2,Grainak,2495,356,13,14,27,48.1%,1h
31270,2,Bombey,2495,252,12,15,27,44.4%,38m
31270,2,thunderbear,2495,165,6,7,13,46.2%,40m
31270,2,seventhson,2495,183,6,9,15,40.0%,59m
31270,3,Sealer,2495,169,5,2,7,71.4%,25m
31270,2,[ExTr1m]qBRybc,2495,152,5,13,18,27.8%,36m
31270,1,MonkeyDLuffy,2495,182,5,19,24,20.8%,43m
31270,3,DrOetkeR,2495,76,4,7,11,36.4%,1h
31270,2,[sissis]reeetac,2495,102,3,3,6,50.0%,1h
31270,2,Hook,2495,58,3,5,8,37.5%,3m
31270,2,LordorIgamer,2495,46,3,7,10,30.0%,24m
31270,1,felfoce,2495,0,2,3,5,40.0%,42m
31270,1,instate,2495,48,2,4,6,33.3%,1h
31270,1,[pvepvp]shturm,2495,0,2,4,6,33.3%,1h
31270,3,AlleXz,2495,95,2,5,7,28.6%,34m
31270,1,FlyingTyger,2495,48,2,5,7,28.6%,45m
31270,3,Voidwalker,2495,0,2,5,7,28.6%,1h
31270,3,[Judg]Opos,2495,30,1,1,2,50.0%,56m
31270,3,cebollita,2495,30,1,1,2,50.0%,59m
31270,3,мир,2495,30,1,2,3,33.3%,44m
31270,2,vili,2495,0,1,3,4,25.0%,57m
31270,1,DooMMen,2495,0,1,4,5,20.0%,28m
31270,3,[NcTsT]Nabz,2495,0,0,1,1,0.0%,11m
31270,2,DreadJesteR,2495,0,0,5,5,0.0%,37m
31270,3,IrMa,2495,0,0,5,5,0.0%,28m
31305,2,Mageguy,2494,1126,127,130,257,49.4%,50m
31305,1,Octavius,2494,1421,61,68,129,47.3%,1h
31305,2,SolidState,2494,546,34,33,67,50.7%,60m
31305,2,[5oD]Jogra,2494,568,34,40,74,45.9%,56m
31305,2,WarLee,2494,686,31,28,59,52.5%,58m
31305,1,PierreHinsin,2494,828,27,36,63,42.9%,60m
31305,2,UNIVERSO,2494,391,14,15,29,48.3%,4m
31305,2,zoumines,2494,168,6,4,10,60.0%,1h
31305,3,никита,2494,183,6,7,13,46.2%,1h
31305,3,Samhein,2494,148,5,0,5,100.0%,45m
31305,3,michael,2494,116,5,3,8,62.5%,35m
31305,3,Meto,2494,146,5,4,9,55.6%,10m
31305,3,loggers,2494,148,5,9,14,35.7%,38m
31305,3,ANUBIS,2494,0,3,6,9,33.3%,6m
31305,3,FreeMad,2494,30,2,1,3,66.7%,52m
31305,3,Спасокукоцки,2494,30,2,4,6,33.3%,34m
31305,3,Titoulight,2494,0,1,0,1,100.0%,31m
31305,3,Lihten,2494,0,1,1,2,50.0%,31m
31305,3,[LoL4ik]SeekerGame,2494,0,1,1,2,50.0%,50m
31305,3,ReliableFrog,2494,0,1,3,4,25.0%,1h
31305,3,DaNiL,2494,0,1,4,5,20.0%,27m
31305,3,Dovhakiin,2494,0,0,1,1,0.0%,45m
31305,1,Blocky,2494,0,0,1,1,0.0%,10m
31305,3,Hombre,2494,0,0,2,2,0.0%,60m
31305,2,Андрей,2494,0,0,2,2,0.0%,39m
31305,3,IIIIII,2494,0,0,2,2,0.0%,2m
31331,3,christoforos,2493,707,27,24,51,52.9%,8m
31331,1,Oblivion,2493,387,20,29,49,40.8%,1h
31331,2,CarnifeX,2493,410,15,17,32,46.9%,30m
31331,2,[JBJ]Klungel,2493,249,13,16,29,44.8%,58m
31331,3,HolyGopher,2493,324,11,5,16,68.8%,46m
31331,3,HunTRDMNK,2493,244,7,8,15,46.7%,50m
31331,3,kedibasi,2493,186,7,8,15,46.7%,31m
31331,3,LarryMcfly,2493,120,5,4,9,55.6%,39m
31331,1,yuugen,2493,148,5,9,14,35.7%,37m
31331,2,[Heroes]sempie,2493,132,5,10,15,33.3%,4m
31331,3,Nicku,2493,144,4,1,5,80.0%,33m
31331,2,nishinyan,2493,117,4,7,11,36.4%,11m
31331,2,Kubanoid,2493,105,3,0,3,100.0%,51m
31331,3,BladHeBamnip,2493,58,3,1,4,75.0%,43m
31331,3,Saggi,2493,88,3,4,7,42.9%,45m
31331,2,[FoxC]Никча,2493,0,1,2,3,33.3%,1h
31331,3,biggiesmalls,2493,30,1,2,3,33.3%,24m
31331,3,Dragonfire,2493,0,0,1,1,0.0%,2m
31331,3,Rafajelo,2493,0,0,1,1,0.0%,42m
31331,3,FreezeTime,2493,0,0,2,2,0.0%,28m
31331,2,DamnSon,2493,0,0,4,4,0.0%,31m
31352,1,[Cheas]Tuff,2492,1321,327,314,641,51.0%,58m
31352,3,EBX,2492,1503,87,77,164,53.0%,39m
31352,3,EHOTpoloskun,2492,444,18,7,25,72.0%,44m
31352,3,[PARSE]abc,2492,305,11,9,20,55.0%,50m
31352,3,Slow,2492,251,9,1,10,90.0%,11m
31352,3,SpringKerrik,2492,197,8,5,13,61.5%,2m
31352,1,Boxybrown,2492,234,8,13,21,38.1%,4m
31352,2,Wice,2492,214,7,7,14,50.0%,57m
31352,2,MatSeruna,2492,186,5,4,9,55.6%,39m
31352,3,MikeyMike,2492,195,5,5,10,50.0%,1h
31352,2,Martin,2492,128,5,10,15,33.3%,5m
31352,2,Karl,2492,152,5,11,16,31.2%,38m
31352,3,BigPi,2492,120,4,5,9,44.4%,45m
31352,2,KAPPO,2492,46,4,8,12,33.3%,60m
31352,2,Renolo,2492,30,2,6,8,25.0%,1h
31352,3,[QaDo]kOlEkA,2492,0,1,0,1,100.0%,57m
31352,3,Tionofal,2492,0,1,3,4,25.0%,1h
31352,3,[CHIPO]Sonik,2492,0,1,3,4,25.0%,29m
31352,2,spmarine,2492,30,1,8,9,11.1%,57m
31352,3,Evgi,2492,0,0,1,1,0.0%,28m
31372,3,Eoghan,2491,1559,315,322,637,49.5%,9m
31372,3,polimorph,2491,930,60,58,118,50.8%,43m
31372,3,llllllllll,2491,1167,50,36,86,58.1%,50m
31372,1,[GvCm]DemonONI,2491,587,50,52,102,49.0%,49m
31372,3,HuluMulu,2491,937,40,38,78,51.3%,60m
31372,2,[TBRow]Hussar,2491,497,29,35,64,45.3%,1h
31372,2,Hunken,2491,529,21,19,40,52.5%,11m
31372,2,[FunFR]Iken,2491,310,15,8,23,65.2%,36m
31372,3,Rychard,2491,316,12,14,26,46.2%,28m
31372,3,SPoTSepSiS,2491,214,9,7,16,56.2%,1h
31372,2,[NoHоmо]Kisho,2491,209,6,10,16,37.5%,1h
31372,3,Glh,2491,144,5,5,10,50.0%,60m
31372,2,Nikolai,2491,161,4,2,6,66.7%,7m
31372,1,Sipuli,2491,48,4,2,6,66.7%,45m
31372,1,APride,2491,48,4,3,7,57.1%,37m
31372,2,Doujo,2491,88,4,6,10,40.0%,24m
31372,1,Crash,2491,0,3,3,6,50.0%,43m
31372,3,Vasya,2491,88,3,4,7,42.9%,34m
31372,3,Chameleon,2491,147,3,4,7,42.9%,1h
31372,2,Alka,2491,137,3,4,7,42.9%,52m
31372,3,Lerhish,2491,94,3,7,10,30.0%,60m
31372,2,[BTown]TeMpLeR,2491,30,2,2,4,50.0%,37m
31372,2,danilec,2491,0,2,3,5,40.0%,43m
31372,3,Rotmir,2491,58,2,4,6,33.3%,46m
31372,3,Brucsvit,2491,0,2,5,7,28.6%,38m
31372,3,[LJKM]max,2491,0,1,0,1,100.0%,2m
31372,3,Dominions,2491,0,0,2,2,0.0%,25m
31372,1,Amazing,2491,0,0,2,2,0.0%,1h
31372,3,MrsTorgue,2491,0,0,4,4,0.0%,53m
31401,1,Comunix,2490,1378,121,111,232,52.2%,1h
31401,3,Zimo,2490,890,33,33,66,50.0%,55m
31401,3,Crank,2490,644,22,21,43,51.2%,31m
31401,3,EvilKraM,2490,564,21,20,41,51.2%,24m
31401,3,Timurian,2490,299,15,0,15,100.0%,37m
31401,2,Praetor,2490,386,13,18,31,41.9%,8m
31401,2,roborobi,2490,288,10,16,26,38.5%,1h
31401,2,[BCNE]Bendikov,2490,213,7,9,16,43.8%,4m
31401,3,SaiGo,2490,201,6,8,14,42.9%,58m
31401,3,DaBeardedOne,2490,114,5,4,9,55.6%,40m
31401,3,Evgeshka,2490,131,4,5,9,44.4%,1h
31401,3,Szef,2490,58,3,2,5,60.0%,38m
31401,3,Narew,2490,40,3,7,10,30.0%,8m
31401,3,Satellite,2490,94,3,7,10,30.0%,20m
31401,2,BossMerinos,2490,40,2,1,3,66.7%,1h
31401,1,RaVEX,2490,0,2,3,5,40.0%,46m
31401,3,scorpions,2490,30,1,2,3,33.3%,49m
31401,1,Rombo,2490,0,1,4,5,20.0%,48m
31401,3,ЛовкиеПальцы,2490,0,1,6,7,14.3%,45m
31401,3,[RNKS]SÄÄTÄJÄ,2490,0,0,1,1,0.0%,1h
31401,3,Exoskeleton,2490,0,0,1,1,0.0%,6m
31401,3,скорпион,2490,0,0,1,1,0.0%,33m
31423,2,[RO2018]RaulCiceovan,2489,537,68,63,131,51.9%,24m
31423,2,Yooda,2489,935,51,57,108,47.2%,1h
31423,3,SurvivedInTs,2489,968,45,53,98,45.9%,13m
31423,2,svano,2489,845,37,35,72,51.4%,53m
31423,1,Eballiman,2489,850,32,40,72,44.4%,1h
31423,3,GTTN,2489,758,31,28,59,52.5%,53m
31423,2,ICEBALL,2489,412,22,27,49,44.9%,53m
31423,2,MVRGELJ,2489,304,11,16,27,40.7%,1h
31423,3,Starfriend,2489,294,10,6,16,62.5%,7m
31423,3,BloodRayne,2489,199,9,8,17,52.9%,2m
31423,2,[музклу]makckrai,2489,220,9,9,18,50.0%,53m
31423,2,Octava,2489,307,9,12,21,42.9%,37m
31423,2,Dariander,2489,142,5,3,8,62.5%,1h
31423,3,SlippinJimmy,2489,58,5,4,9,55.6%,25m
31423,3,Biochemist,2489,148,5,5,10,50.0%,10m
31423,2,Druger,2489,172,5,6,11,45.5%,1h
31423,1,Natsukiii,2489,184,4,11,15,26.7%,59m
31423,3,Vadication,2489,116,3,4,7,42.9%,31m
31423,1,WIDOWMAKER,2489,97,2,0,2,100.0%,42m
31423,2,Darkfoma,2489,42,2,0,2,100.0%,7m
31423,3,[lDirel]ViperWR,2489,30,2,1,3,66.7%,57m
31423,1,Xploziv,2489,0,2,2,4,50.0%,36m
31423,3,BYuN,2489,0,2,3,5,40.0%,1h
31423,1,strain,2489,0,2,3,5,40.0%,30m
31423,3,Sxros,2489,0,0,1,1,0.0%,45m
31423,3,Nakin,2489,0,0,4,4,0.0%,59m
31449,3,flusa,2488,1291,56,49,105,53.3%,26m
31449,2,[SPAINs]Jaaviitoo,2488,1542,56,60,116,48.3%,48m
31449,3,DarthMaul,2488,779,34,20,54,63.0%,1h
31449,1,MaxiBraDa,2488,369,29,37,66,43.9%,33m
31449,3,Tuber,2488,462,18,15,33,54.5%,12m
31449,3,[SS2208]SergZerg,2488,444,17,15,32,53.1%,26m
31449,3,OPBrow,2488,440,17,15,32,53.1%,27m
31449,3,RoyBatty,2488,365,16,7,23,69.6%,45m
31449,3,areslara,2488,406,15,20,35,42.9%,11m
31449,1,Aepheon,2488,417,14,21,35,40.0%,29m
31449,3,Roger,2488,306,13,13,26,50.0%,31m
31449,3,Lemyrka,2488,308,11,14,25,44.0%,51m
31449,2,Gaffie,2488,278,9,9,18,50.0%,28m
31449,3,[AofK]saeng,2488,182,9,9,18,50.0%,53m
31449,2,Vak,2488,294,9,12,21,42.9%,8m
31449,3,oneshot,2488,172,5,7,12,41.7%,45m
31449,3,mangojooce,2488,86,4,3,7,57.1%,43m
31449,3,boldxhead,2488,114,4,3,7,57.1%,49m
31449,3,Dante,2488,169,4,3,7,57.1%,37m
31449,1,Vac,2488,103,4,4,8,50.0%,35m
31449,2,DreadOMantis,2488,30,3,6,9,33.3%,10m
31449,1,Teściowa,2488,48,2,0,2,100.0%,41m
31449,2,Evgeni,2488,0,1,0,1,100.0%,2m
31449,3,Yokodera,2488,30,1,1,2,50.0%,2m
31449,3,[ZERB]HolieShedt,2488,0,1,1,2,50.0%,38m
31449,2,Erenet,2488,91,1,2,3,33.3%,9m
31475,2,[Geezer]theclue,2487,1291,105,99,204,51.5%,6m
31475,2,DigitalShark,2487,959,50,41,91,54.9%,24m
31475,1,Spiff,2487,1188,50,51,101,49.5%,1h
31475,2,[BURIZA]AlexKoks,2487,430,29,32,61,47.5%,49m
31475,2,Ergoproxy,2487,732,25,28,53,47.2%,34m
31475,3,KaptnCat,2487,657,24,22,46,52.2%,1h
31475,3,AxN,2487,340,22,12,34,64.7%,28m
31475,2,Deadpool,2487,537,22,21,43,51.2%,30m
31475,1,NeixSly,2487,185,7,11,18,38.9%,3m
31475,3,[Ǽ1]SilverMaster,2487,184,6,0,6,100.0%,27m
31475,2,ninuu,2487,192,6,11,17,35.3%,31m
31475,3,MorAnd,2487,88,4,3,7,57.1%,50m
31475,1,chtplt,2487,0,3,2,5,60.0%,44m
31475,3,patrolboy,2487,60,3,2,5,60.0%,28m
31475,3,Arsackkk,2487,36,2,1,3,66.7%,30m
31475,2,odin,2487,0,2,4,6,33.3%,3m
31475,1,ТеронRU,2487,0,2,5,7,28.6%,7m
31475,1,ShadowHK,2487,0,2,5,7,28.6%,24m
31475,2,SeraphinDo,2487,62,2,9,11,18.2%,53m
31475,3,vulfke,2487,0,1,0,1,100.0%,50m
31475,3,Anur,2487,0,1,4,5,20.0%,1h
31475,3,LibertyChimp,2487,0,0,1,1,0.0%,28m
31475,3,Denico,2487,0,0,1,1,0.0%,39m
31475,2,SirKnatch,2487,0,0,1,1,0.0%,1h
31475,3,elmasmalo,2487,0,0,1,1,0.0%,28m
31475,3,DUMI,2487,0,0,1,1,0.0%,1h
31475,3,FlikK,2487,0,0,1,1,0.0%,35m
31475,1,Raven,2487,0,0,2,2,0.0%,24m
31475,3,YOSHIMITSU,2487,0,0,3,3,0.0%,39m
31475,3,Mlekot,2487,0,0,3,3,0.0%,51m
31505,2,eror,2486,1541,59,55,114,51.8%,38m
31505,2,FiRePhaNtOm,2486,532,28,27,55,50.9%,49m
31505,2,DotnKnowPlay,2486,583,23,29,52,44.2%,26m
31505,2,КирюшаБледны,2486,500,20,19,39,51.3%,1h
31505,2,bestlover,2486,251,12,12,24,50.0%,53m
31505,1,zavina,2486,332,10,24,34,29.4%,1h
31505,2,[WRPftw]cobra,2486,263,9,15,24,37.5%,11m
31505,3,wml,2486,233,8,4,12,66.7%,8m
31505,3,DerHein,2486,232,8,10,18,44.4%,12m
31505,2,BrusLee,2486,153,6,8,14,42.9%,1h
31505,3,[vPaM]MooN,2486,176,5,7,12,41.7%,6m
31505,3,[brzzer]JokalSex,2486,143,4,1,5,80.0%,53m
31505,3,slimer,2486,58,2,5,7,28.6%,24m
31505,3,Surinamer,2486,0,1,0,1,100.0%,50m
31505,3,Lolkass,2486,30,1,2,3,33.3%,57m
31505,2,Azelvan,2486,0,1,4,5,20.0%,1h
31505,3,TiARETiK,2486,0,0,1,1,0.0%,53m
31505,3,[m333m]ProTivNik,2486,0,0,4,4,0.0%,37m
31523,2,МУЖИК,2485,1546,82,86,168,48.8%,37m
31523,2,ZAG,2485,915,41,41,82,50.0%,26m
31523,3,Sebitasproo,2485,956,37,31,68,54.4%,24m
31523,3,Tema,2485,582,27,32,59,45.8%,39m
31523,3,SlavaRazor,2485,655,25,23,48,52.1%,27m
31523,3,Dominion,2485,528,23,16,39,59.0%,46m
31523,2,[harald]Finn,2485,632,23,26,49,46.9%,38m
31523,2,Ruso,2485,482,19,20,39,48.7%,8m
31523,1,Mongoose,2485,524,17,26,43,39.5%,1h
31523,3,Orion,2485,249,15,15,30,50.0%,53m
31523,3,Uwe,2485,151,7,2,9,77.8%,8m
31523,3,[Ebloid]Scilef,2485,167,5,6,11,45.5%,1h
31523,3,Peur,2485,142,5,6,11,45.5%,53m
31523,3,СТАС,2485,88,4,2,6,66.7%,28m
31523,1,ImmortalWood,2485,0,4,2,6,66.7%,31m
31523,2,smetanka,2485,140,4,3,7,57.1%,1h
31523,3,ameuter,2485,58,3,0,3,100.0%,49m
31523,3,llllllllllll,2485,60,3,2,5,60.0%,31m
31523,3,Sheferstoun,2485,97,3,6,9,33.3%,1h
31523,2,Eurotrash,2485,62,3,8,11,27.3%,1h
31523,2,Zamas,2485,60,3,8,11,27.3%,48m
31523,3,schoot,2485,0,2,3,5,40.0%,28m
31523,3,NikoDe,2485,30,2,3,5,40.0%,57m
31523,2,Artmun,2485,0,2,4,6,33.3%,1h
31523,1,jgt,2485,0,2,4,6,33.3%,56m
31523,1,Remedy,2485,122,2,6,8,25.0%,59m
31523,3,[Zguege]cockieland,2485,0,0,1,1,0.0%,31m
31523,3,ДикаяСосиска,2485,0,0,2,2,0.0%,28m
31523,3,Timothy,2485,0,0,2,2,0.0%,11m
31523,3,Nico,2485,0,0,3,3,0.0%,31m
31553,1,Pancake,2484,1513,255,250,505,50.5%,8m
31553,2,TschapunSKy,2484,1280,67,64,131,51.1%,1h
31553,2,Coimao,2484,1145,50,44,94,53.2%,5m
31553,2,BladeRSA,2484,588,27,17,44,61.4%,35m
31553,3,Faflu,2484,640,26,20,46,56.5%,38m
31553,3,FinalDegree,2484,572,25,17,42,59.5%,43m
31553,2,FEGY,2484,586,25,27,52,48.1%,33m
31553,2,Ponchik,2484,520,21,22,43,48.8%,51m
31553,3,Babaika,2484,481,16,18,34,47.1%,52m
31553,2,friendlydead,2484,439,16,22,38,42.1%,1h
31553,3,CanelaMolida,2484,279,10,17,27,37.0%,2m
31553,1,Leinad,2484,256,8,12,20,40.0%,11m
31553,2,Ulnarix,2484,180,6,13,19,31.6%,52m
31553,2,spaermiosis,2484,208,5,6,11,45.5%,55m
31553,3,[MazDIE]RussianDzen,2484,157,5,7,12,41.7%,1h
31553,3,Sparky,2484,90,4,7,11,36.4%,3m
31553,3,Hodius,2484,0,3,6,9,33.3%,17m
31553,3,[Pédoss]seraphime,2484,38,3,6,9,33.3%,4m
31553,1,[KMarks]Tempest,2484,95,2,3,5,40.0%,33m
31553,3,aza,2484,122,2,3,5,40.0%,60m
31553,3,[NOOBpl]elea,2484,96,2,3,5,40.0%,38m
31553,3,logorithm,2484,0,2,5,7,28.6%,1h
31553,3,[FLDI]Sitixallion,2484,30,1,1,2,50.0%,53m
31553,2,LateTuho,2484,88,1,2,3,33.3%,31m
31553,3,EmJay,2484,30,1,3,4,25.0%,50m
31553,3,Fruchtfliege,2484,0,0,1,1,0.0%,53m
31553,3,protos,2484,0,0,1,1,0.0%,1h
31553,3,Krabic,2484,0,0,2,2,0.0%,51m
31553,3,[JaPP]Konstagreen,2484,0,0,2,2,0.0%,5m
31582,3,BaDghost,2483,806,76,66,142,53.5%,53m
31582,3,Saladash,2483,813,50,47,97,51.5%,50m
31582,2,Soichiro,2483,1030,47,30,77,61.0%,10m
31582,3,cornus,2483,371,33,16,49,67.3%,42m
31582,3,[KBai]BigZappa,2483,616,29,16,45,64.4%,11m
31582,3,[SKORM]AvoSkorm,2483,664,28,23,51,54.9%,53m
31582,3,xMerkulx,2483,691,26,23,49,53.1%,31m
31582,3,[RusMoo]Vencendor,2483,335,15,6,21,71.4%,51m
31582,3,[EsOst]Infinity,2483,355,14,8,22,63.6%,9m
31582,1,toto,2483,377,13,19,32,40.6%,1h
31582,2,[Izual]Alrey,2483,292,10,12,22,45.5%,10m
31582,2,Axay,2483,187,7,10,17,41.2%,40m
31582,2,kuska,2483,116,5,6,11,45.5%,1h
31582,3,MIRACLE,2483,0,4,1,5,80.0%,55m
31582,2,DimLemon,2483,60,4,8,12,33.3%,3m
31582,3,[Wither]Nicooooo,2483,57,3,2,5,60.0%,10m
31582,2,PegaS,2483,0,3,4,7,42.9%,10m
31582,3,EnigmaCT,2483,121,3,5,8,37.5%,34m
31582,1,[llenny]XDWatto,2483,48,2,4,6,33.3%,45m
31582,3,klingen,2483,0,2,5,7,28.6%,8m
31582,1,Gottfridd,2483,0,2,5,7,28.6%,36m
31582,3,[Amons]Ares,2483,0,1,0,1,100.0%,45m
31582,3,sKafandra,2483,0,1,4,5,20.0%,51m
31582,2,ApOlLOL,2483,32,1,8,9,11.1%,1h
31582,3,dandi,2483,0,0,1,1,0.0%,28m
31582,3,LongHot,2483,0,0,1,1,0.0%,7m
31582,3,Suzuki,2483,0,0,3,3,0.0%,49m
31609,1,martius,2482,1588,357,353,710,50.3%,1h
31609,3,narkoteq,2482,872,37,35,72,51.4%,53m
31609,3,RandomPlayer,2482,842,35,34,69,50.7%,49m
31609,3,brownknight,2482,706,28,26,54,51.9%,31m
31609,3,RoBituSSin,2482,560,21,17,38,55.3%,55m
31609,2,[CHIGG]Vec,2482,380,15,15,30,50.0%,48m
31609,3,LarvaLing,2482,304,12,10,22,54.5%,10m
31609,3,Raven,2482,314,12,11,23,52.2%,57m
31609,3,MagicTurtle,2482,293,12,16,28,42.9%,39m
31609,1,boulickjr,2482,163,7,10,17,41.2%,24m
31609,1,[ZVG]Hellcat,2482,192,5,12,17,29.4%,59m
31609,3,[АDV]NesCafe,2482,90,4,2,6,66.7%,29m
31609,3,Arés,2482,160,4,5,9,44.4%,10m
31609,2,[KDV]Adamin,2482,90,4,10,14,28.6%,41m
31609,3,mouggy,2482,98,3,5,8,37.5%,2m
31609,3,[CrpZts]Icold,2482,121,3,5,8,37.5%,1h
31609,3,сергей,2482,0,1,0,1,100.0%,52m
31609,1,Vladilion,2482,0,1,1,2,50.0%,46m
31609,3,[Laki]PhantomKI,2482,0,1,1,2,50.0%,3m
31609,3,jarekPL,2482,0,1,2,3,33.3%,24m
31609,1,Fisken,2482,0,1,5,6,16.7%,53m
31609,3,elga,2482,0,0,3,3,0.0%,1h
31631,3,Mozart,2481,1056,87,78,165,52.7%,1h
31631,3,Modather,2481,1027,79,68,147,53.7%,42m
31631,3,TasteOfLife,2481,1387,56,56,112,50.0%,10m
31631,3,MrKaizi,2481,992,42,38,80,52.5%,31m
31631,2,Patucho,2481,820,30,36,66,45.5%,1h
31631,3,alexandre,2481,562,22,21,43,51.2%,31m
31631,2,Meder,2481,455,17,18,35,48.6%,1h
31631,3,SirOnenaGro,2481,258,9,9,18,50.0%,43m
31631,2,дИтонатор,2481,254,9,11,20,45.0%,39m
31631,3,[cun7]GreatWhiteSi,2481,217,8,0,8,100.0%,49m
31631,1,[GNVR]Facejizz,2481,118,6,9,15,40.0%,1h
31631,3,GWAM,2481,121,4,3,7,57.1%,3m
31631,2,vladd,2481,166,4,8,12,33.3%,48m
31631,2,freerun,2481,76,4,9,13,30.8%,10m
31631,3,ObsidianX,2481,0,3,2,5,60.0%,39m
31631,3,[MVC]Krismal,2481,40,3,6,9,33.3%,3m
31631,2,pavildle,2481,60,3,11,14,21.4%,38m
31631,1,STan,2481,97,2,0,2,100.0%,41m
31631,3,FireMan,2481,0,1,0,1,100.0%,60m
31631,3,Greshnik,2481,0,1,0,1,100.0%,50m
31631,3,Proxy,2481,0,1,1,2,50.0%,34m
31631,3,[CTLF]Silith,2481,0,1,1,2,50.0%,27m
31631,3,MamaMia,2481,30,1,1,2,50.0%,36m
31631,2,Nunatakker,2481,40,1,6,7,14.3%,59m
31631,1,bekeibalazs,2481,0,0,1,1,0.0%,42m
31631,2,GiovanniCapo,2481,0,0,2,2,0.0%,37m
31657,3,[MinGa]Codemaster,2480,1612,423,425,848,49.9%,33m
31657,3,[RABE]Timex,2480,977,40,33,73,54.8%,27m
31657,3,rataton,2480,873,35,29,64,54.7%,8m
31657,3,[SNRGY]Horatio,2480,462,18,13,31,58.1%,52m
31657,2,BattleSilvan,2480,83,16,20,36,44.4%,24m
31657,2,[RP1]Ksamilion,2480,436,14,23,37,37.8%,1h
31657,3,вано,2480,268,10,15,25,40.0%,17m
31657,2,pan,2480,203,5,8,13,38.5%,38m
31657,3,[101101]Axel,2480,30,4,5,9,44.4%,42m
31657,3,RanderNess,2480,119,3,0,3,100.0%,43m
31657,3,BoyNextDoor,2480,0,3,2,5,60.0%,34m
31657,3,Blind,2480,147,3,3,6,50.0%,2m
31657,3,PoliteElk,2480,116,3,5,8,37.5%,37m
31657,3,Chubaka,2480,154,3,8,11,27.3%,27m
31657,3,Zaltoi,2480,60,2,3,5,40.0%,1h
31657,3,FostatA,2480,96,2,4,6,33.3%,58m
31657,2,KyKyPyZZz,2480,0,2,4,6,33.3%,52m
31657,3,Jokzz,2480,95,2,4,6,33.3%,6m
31657,1,Stormbro,2480,48,2,5,7,28.6%,31m
31657,3,Goblin,2480,0,1,1,2,50.0%,26m
31657,3,Icefear,2480,0,1,2,3,33.3%,7m
31657,1,rest,2480,0,0,5,5,0.0%,34m
31679,3,Dell,2479,1423,191,188,379,50.4%,13m
31679,3,Tarazar,2479,1100,96,92,188,51.1%,35m
31679,1,DenStoreSmed,2479,1608,75,88,163,46.0%,2m
31679,3,HiveSphere,2479,1310,55,41,96,57.3%,31m
31679,2,[Wed3ad]pontan,2479,727,44,39,83,53.0%,49m
31679,3,Calabuezo,2479,981,40,34,74,54.1%,11m
31679,1,[OTW6]Float,2479,1051,38,50,88,43.2%,47m
31679,3,Denders,2479,972,36,34,70,51.4%,39m
31679,3,Roland,2479,451,33,15,48,68.8%,28m
31679,3,Thedirtycat,2479,358,24,44,68,35.3%,5m
31679,2,LittleDemon,2479,524,22,26,48,45.8%,4m
31679,3,HaBam,2479,373,15,14,29,51.7%,43m
31679,3,Rush,2479,124,15,18,33,45.5%,44m
31679,3,Shikaren,2479,416,14,14,28,50.0%,27m
31679,1,Niteig,2479,410,14,18,32,43.8%,8m
31679,1,Вафелька,2479,302,13,12,25,52.0%,24m
31679,1,Rexortom,2479,278,10,17,27,37.0%,1h
31679,2,Miha,2479,264,9,10,19,47.4%,5m
31679,3,Maden,2479,245,8,9,17,47.1%,43m
31679,3,Rupacitus,2479,172,7,7,14,50.0%,4m
31679,2,Jeetah,2479,171,6,7,13,46.2%,1h
31679,3,[ATHEN]MoustachioMD,2479,86,5,6,11,45.5%,1h
31679,3,Demux,2479,136,4,2,6,66.7%,52m
31679,2,Terry,2479,94,4,7,11,36.4%,24m
31679,3,spacehoppr,2479,0,1,1,2,50.0%,1h
31679,3,KuduVoodoo,2479,30,1,1,2,50.0%,55m
31679,2,Mike,2479,94,1,3,4,25.0%,10m
31679,3,Kratos,2479,0,0,1,1,0.0%,1h
31679,3,Hares,2479,0,0,1,1,0.0%,28m
31679,3,SlimeMind,2479,0,0,1,1,0.0%,53m
31709,3,shurup,2478,709,118,118,236,50.0%,26m
31709,3,Svebster,2478,1077,53,32,85,62.4%,43m
31709,3,MateO,2478,667,48,39,87,55.2%,1h
31709,2,[PrTons]kelesha,2478,852,31,36,67,46.3%,29m
31709,3,Чех,2478,274,19,7,26,73.1%,51m
31709,2,ToxKayzer,2478,297,12,12,24,50.0%,40m
31709,2,[TyDud]Lentin,2478,334,11,14,25,44.0%,39m
31709,3,ipoopandpee,2478,309,10,11,21,47.6%,37m
31709,2,IЭnwer,2478,208,7,9,16,43.8%,1h
31709,2,Natsu,2478,196,6,9,15,40.0%,1h
31709,3,Truffolo,2478,140,3,2,5,60.0%,6m
31709,1,marcos,2478,97,3,4,7,42.9%,1h
31709,1,Vagich,2478,121,3,5,8,37.5%,52m
31709,2,[WYG]DEX,2478,0,3,7,10,30.0%,45m
31709,3,iPood,2478,97,2,0,2,100.0%,59m
31709,3,drrudeboy,2478,0,2,5,7,28.6%,59m
31709,2,[Jail]VIctorDestro,2478,30,2,6,8,25.0%,1h
31709,3,TzarLeonid,2478,0,1,0,1,100.0%,49m
31709,1,DbW,2478,0,1,1,2,50.0%,46m
31709,3,monke,2478,96,1,1,2,50.0%,7m
31709,3,ZergisCovid,2478,0,0,1,1,0.0%,31m
31709,3,[Snаkеs]SaltSnake,2478,0,0,1,1,0.0%,50m
31709,3,Tartararam,2478,0,0,1,1,0.0%,41m
31709,3,Voros,2478,0,0,1,1,0.0%,46m
31733,1,[RBRO]HGdemone,2477,1061,71,69,140,50.7%,25m
31733,3,Crow,2477,818,57,36,93,61.3%,49m
31733,2,Tony,2477,940,35,37,72,48.6%,37m
31733,2,Dariosmith,2477,884,33,38,71,46.5%,1h
31733,3,[SICH]ITshnick,2477,813,32,29,61,52.5%,28m
31733,3,Orange,2477,572,27,23,50,54.0%,57m
31733,3,Vaggos,2477,486,23,6,29,79.3%,55m
31733,3,[WАSD]АрхоСтраж,2477,356,14,11,25,56.0%,43m
31733,3,zergunion,2477,351,12,12,24,50.0%,52m
31733,1,DoomRanger,2477,272,11,14,25,44.0%,52m
31733,2,[hukomo]bertuas,2477,270,9,10,19,47.4%,59m
31733,3,HiSpace,2477,164,5,0,5,100.0%,39m
31733,3,Ситран,2477,161,4,1,5,80.0%,38m
31733,3,boubou,2477,144,4,3,7,57.1%,40m
31733,2,SgtBeans,2477,133,4,6,10,40.0%,31m
31733,1,ArtSeven,2477,48,3,3,6,50.0%,9m
31733,3,SlasH,2477,62,3,5,8,37.5%,1h
31733,1,linkeniffo,2477,0,2,4,6,33.3%,10m
31733,3,простонуб,2477,0,2,5,7,28.6%,8m
31733,1,DrunkedDuck,2477,48,2,5,7,28.6%,53m
31733,1,ГейПорно,2477,0,1,0,1,100.0%,54m
31733,2,[SPAINs]ePhoenix,2477,0,1,7,8,12.5%,1h
31733,3,BaXToRjr,2477,0,0,1,1,0.0%,50m
31756,3,roooman,2476,1573,290,285,575,50.4%,38m
31756,1,gigo,2476,1482,57,63,120,47.5%,30m
31756,2,Gregoose,2476,625,25,26,51,49.0%,7m
31756,2,Dustbuster,2476,350,14,22,36,38.9%,15m
31756,3,RMG,2476,355,13,6,19,68.4%,31m
31756,3,ROMEO,2476,330,12,16,28,42.9%,60m
31756,2,Jutko,2476,268,10,14,24,41.7%,1h
31756,3,llllllllll,2476,248,8,11,19,42.1%,51m
31756,2,CoffeeMaker,2476,228,8,11,19,42.1%,53m
31756,2,SlowHandsOiq,2476,44,4,6,10,40.0%,43m
31756,2,Граф,2476,141,3,2,5,60.0%,28m
31756,3,ehgaming,2476,117,2,1,3,66.7%,36m
31756,3,kinlus,2476,0,2,3,5,40.0%,28m
31756,3,[STH]Mabuse,2476,0,1,0,1,100.0%,4m
31756,1,Calas,2476,0,1,2,3,33.3%,2m
31756,3,AxxeL,2476,0,0,1,1,0.0%,36m
31756,3,GrannyBasher,2476,0,0,2,2,0.0%,43m
31756,3,BorMay,2476,0,0,2,2,0.0%,31m
31774,2,Ponyalone,2475,1345,193,184,377,51.2%,1h
31774,2,[Hammer]Madtrax,2475,1292,69,81,150,46.0%,12m
31774,3,Aeugh,2475,1130,52,45,97,53.6%,28m
31774,3,kakTotak,2475,897,37,34,71,52.1%,2m
31774,2,Mallatta,2475,916,35,38,73,47.9%,1h
31774,1,DERFUCHS,2475,678,26,28,54,48.1%,28m
31774,3,Caleb,2475,332,21,23,44,47.7%,53m
31774,2,TheKing,2475,488,18,18,36,50.0%,1h
31774,3,ZeeGermans,2475,484,17,15,32,53.1%,50m
31774,2,Scarabeus,2475,348,15,24,39,38.5%,1h
31774,2,BiGFooT,2475,347,12,14,26,46.2%,41m
31774,3,[CoSmE]boulverine,2475,268,10,2,12,83.3%,60m
31774,3,AgentIZain,2475,132,4,4,8,50.0%,1h
31774,3,Ibsen,2475,0,3,2,5,60.0%,35m
31774,3,DaNiLkA,2475,30,2,1,3,66.7%,40m
31774,2,[KoxySC]Nightmere,2475,0,2,5,7,28.6%,10m
31774,3,saiqasan,2475,0,0,1,1,0.0%,38m
31774,3,centfroid,2475,0,0,1,1,0.0%,27m
31774,2,WojlaW,2475,0,0,2,2,0.0%,1h
31774,3,[LNDD]Bol,2475,0,0,3,3,0.0%,2m
31794,1,RapidGuard,2474,1520,166,155,321,51.7%,10m
31794,3,MumusMdr,2474,796,95,71,166,57.2%,12m
31794,3,Nuuri,2474,1159,50,47,97,51.5%,27m
31794,2,xandy,2474,974,46,49,95,48.4%,38m
31794,3,aDaM,2474,836,35,30,65,53.8%,6m
31794,2,FayN,2474,453,29,27,56,51.8%,37m
31794,3,Zaeloth,2474,200,7,5,12,58.3%,24m
31794,3,Mark,2474,197,6,4,10,60.0%,31m
31794,3,KRASH,2474,174,5,7,12,41.7%,31m
31794,3,Arto,2474,95,2,0,2,100.0%,31m
31794,3,chef,2474,30,1,3,4,25.0%,50m
31794,1,Phosa,2474,0,1,4,5,20.0%,1h
31794,3,VANO,2474,30,1,5,6,16.7%,28m
31794,3,Neyo,2474,0,0,1,1,0.0%,36m
31794,3,HypnoED,2474,0,0,1,1,0.0%,1h
31794,3,[ZERG7V]Astral,2474,0,0,1,1,0.0%,1h
31794,1,[IceHus]Auf,2474,0,0,1,1,0.0%,1h
31811,1,[InitRu]uri,2473,1583,353,349,702,50.3%,1h
31811,2,didou,2473,1036,85,84,169,50.3%,26m
31811,3,Deadmouse,2473,926,78,58,136,57.4%,43m
31811,1,Namron,2473,823,53,58,111,47.7%,49m
31811,3,Foxtrot,2473,890,42,33,75,56.0%,50m
31811,2,yogosuma,2473,951,38,37,75,50.7%,49m
31811,2,[OoE]Vintrex,2473,673,26,31,57,45.6%,43m
31811,3,Geos,2473,465,20,20,40,50.0%,39m
31811,2,Sashenka,2473,502,18,20,38,47.4%,53m
31811,3,Spartan,2473,381,15,12,27,55.6%,38m
31811,2,TheLaw,2473,395,14,17,31,45.2%,4m
31811,2,ShootingTard,2473,370,12,18,30,40.0%,15m
31811,2,DamiNouMineT,2473,266,10,13,23,43.5%,11m
31811,3,[basdp]Dobro,2473,236,9,8,17,52.9%,12m
31811,2,preamp,2473,217,5,8,13,38.5%,1h
31811,3,MikeHawk,2473,0,4,3,7,57.1%,48m
31811,1,Gandaci,2473,96,3,4,7,42.9%,30m
31811,2,SpaceLord,2473,30,3,5,8,37.5%,41m
31811,2,[JKCNFT]niktank,2473,60,3,6,9,33.3%,31m
31811,3,AXH,2473,94,3,7,10,30.0%,3m
31811,3,Kamikazykid,2473,95,2,3,5,40.0%,40m
31811,1,oldshad,2473,0,1,0,1,100.0%,40m
31811,3,POKERGRIG,2473,30,1,2,3,33.3%,51m
31811,3,SpaceFood,2473,0,0,3,3,0.0%,9m
31835,3,Miranda,2472,1540,85,70,155,54.8%,24m
31835,3,Kaizen,2472,1454,63,65,128,49.2%,2m
31835,2,[LifeTV]SmerchKZ,2472,569,54,42,96,56.2%,45m
31835,2,Evg,2472,1067,45,36,81,55.6%,26m
31835,3,Sugoooi,2472,305,20,14,34,58.8%,43m
31835,3,[LanVG]Lich,2472,328,12,14,26,46.2%,57m
31835,3,LEOKA,2472,245,9,3,12,75.0%,57m
31835,2,Zvolac,2472,200,8,12,20,40.0%,1h
31835,3,lko,2472,201,7,7,14,50.0%,8m
31835,2,KNECHTER,2472,197,7,8,15,46.7%,43m
31835,3,[PH4L]Blaze,2472,233,7,8,15,46.7%,50m
31835,2,Arslan,2472,154,6,5,11,54.5%,41m
31835,3,Nevermind,2472,165,5,7,12,41.7%,1h
31835,3,[nepal]Kellahselai,2472,88,4,3,7,57.1%,60m
31835,3,Atuin,2472,0,3,2,5,60.0%,27m
31835,3,[AClD]narsou,2472,62,2,4,6,33.3%,52m
31835,1,erA,2472,48,2,5,7,28.6%,39m
31835,3,BbIpka,2472,0,1,0,1,100.0%,28m
31835,1,[Дядя]Magnit,2472,0,1,4,5,20.0%,56m
31835,3,[VNSD]MSNA,2472,0,1,4,5,20.0%,28m
31835,1,HUNCIBABA,2472,0,0,2,2,0.0%,37m
31835,3,Makaroni,2472,0,0,3,3,0.0%,49m
31835,3,xKedr,2472,0,0,3,3,0.0%,31m
31835,1,noaj,2472,0,0,6,6,0.0%,52m
31859,2,NukeKrychu,2471,1620,128,126,254,50.4%,11m
31859,3,Laitius,2471,1578,75,75,150,50.0%,9m
31859,3,ZaaKuu,2471,903,51,41,92,55.4%,44m
31859,3,ELKAPO,2471,859,33,34,67,49.3%,58m
31859,3,[LBZ]ElAhui,2471,630,30,14,44,68.2%,7m
31859,3,Pavlus,2471,633,29,25,54,53.7%,7m
31859,3,Bärtram,2471,633,25,23,48,52.1%,45m
31859,3,BladeEmperor,2471,527,24,14,38,63.2%,29m
31859,3,Bekele,2471,500,17,16,33,51.5%,58m
31859,2,dzBAN,2471,328,11,12,23,47.8%,48m
31859,2,young,2471,232,6,14,20,30.0%,34m
31859,3,[Hyper1]citizen,2471,0,4,1,5,80.0%,60m
31859,3,[FROP]Bolchevique,2471,167,4,7,11,36.4%,8m
31859,1,XMANN,2471,93,2,0,2,100.0%,56m
31859,3,FoeCrux,2471,0,1,0,1,100.0%,6m
31859,3,Patton,2471,30,1,1,2,50.0%,49m
31859,2,[SpPSq]Nerd,2471,0,0,1,1,0.0%,8m
31859,3,Szakallo,2471,0,0,1,1,0.0%,49m
31859,3,[UAFire]Tayz,2471,0,0,3,3,0.0%,31m
31878,3,[Bplus]FastRoger,2470,985,91,99,190,47.9%,10m
31878,3,Gochuani,2470,1005,70,61,131,53.4%,1h
31878,3,drschmidt,2470,1339,63,45,108,58.3%,2m
31878,3,KaTok,2470,1040,39,44,83,47.0%,42m
31878,2,JiDoO,2470,806,36,41,77,46.8%,24m
31878,3,Metamorph,2470,735,27,26,53,50.9%,12m
31878,2,RISKY,2470,375,13,16,29,44.8%,1h
31878,3,Guest,2470,364,12,9,21,57.1%,49m
31878,3,MrSalamandr,2470,293,11,4,15,73.3%,49m
31878,3,XenoX,2470,293,10,12,22,45.5%,12m
31878,3,interzone,2470,88,4,2,6,66.7%,31m
31878,2,Argg,2470,0,3,5,8,37.5%,1h
31878,3,Rozenberg,2470,0,2,3,5,40.0%,7m
31878,1,Bumblebee,2470,48,2,7,9,22.2%,34m
31878,3,SvIstoplas,2470,0,1,0,1,100.0%,1h
31878,3,ZERG,2470,30,1,3,4,25.0%,1h
31878,1,Blind,2470,0,1,4,5,20.0%,4m
31878,3,NoKeybinds,2470,0,1,4,5,20.0%,1h
31878,3,макс,2470,0,0,1,1,0.0%,1h
31878,3,SuperMichel,2470,0,0,1,1,0.0%,1h
31898,2,Niviroth,2469,1095,45,40,85,52.9%,1h
31898,3,Knorri,2469,518,22,8,30,73.3%,38m
31898,3,viktoroven,2469,483,19,17,36,52.8%,49m
31898,3,IceCreamMan,2469,423,18,10,28,64.3%,29m
31898,2,[GROF]hellas,2469,456,17,18,35,48.6%,48m
31898,2,Solhatten,2469,251,12,12,24,50.0%,45m
31898,3,[Mynow]Destroyer,2469,282,10,11,21,47.6%,29m
31898,3,Kawior,2469,124,7,11,18,38.9%,12m
31898,3,Ludwig,2469,174,6,7,13,46.2%,50m
31898,2,lucas,2469,176,5,9,14,35.7%,1h
31898,2,XANXENXUN,2469,34,4,7,11,36.4%,1h
31898,3,Reidan,2469,30,2,1,3,66.7%,50m
31898,3,Gooopy,2469,30,2,1,3,66.7%,9m
31898,3,DrunkPhysics,2469,0,2,6,8,25.0%,36m
31898,3,ТраТаТа,2469,0,1,0,1,100.0%,55m
31898,3,Ray,2469,0,1,0,1,100.0%,53m
31898,3,Kazak,2469,30,1,6,7,14.3%,49m
31898,3,Indrik,2469,0,0,1,1,0.0%,45m
31916,3,[RoXY]hYtAkYtE,2468,1486,396,388,784,50.5%,40m
31916,2,ihateterran,2468,1154,79,84,163,48.5%,43m
31916,3,sorrybroo,2468,884,34,32,66,51.5%,3m
31916,3,[SEWP]STALKER,2468,412,16,15,31,51.6%,10m
31916,3,ŻryjGruz,2468,373,13,11,24,54.2%,7m
31916,3,Mimiska,2468,174,8,8,16,50.0%,12m
31916,3,MdB,2468,146,8,13,21,38.1%,5m
31916,2,fobus,2468,197,6,9,15,40.0%,2m
31916,1,Tarmacshrimp,2468,238,6,13,19,31.6%,8m
31916,2,fky,2468,120,5,6,11,45.5%,48m
31916,2,flesh,2468,128,4,11,15,26.7%,53m
31916,1,kinchiman,2468,48,2,0,2,100.0%,42m
31916,3,[DpDF]SirPidoid,2468,119,2,1,3,66.7%,33m
31916,3,Aurimas,2468,60,2,2,4,50.0%,58m
31916,3,hebyrashka,2468,30,1,1,2,50.0%,1h
31916,1,Vladisl,2468,0,0,1,1,0.0%,31m
31916,3,[MSII]Helljumper,2468,0,0,1,1,0.0%,3m
31916,3,[ZERGTV]ЗлойДух,2468,0,0,1,1,0.0%,60m
31916,3,[dd33nt]DarkOsiris,2468,0,0,2,2,0.0%,7m
31916,3,Adveturerr,2468,0,0,2,2,0.0%,27m
31916,3,charlama,2468,0,0,3,3,0.0%,37m
31937,3,[YpT]sebbix,2467,900,48,41,89,53.9%,34m
31937,3,gepresst,2467,490,19,21,40,47.5%,9m
31937,3,minhducit,2467,390,14,8,22,63.6%,41m
31937,2,IIIIIIIIIIII,2467,132,6,9,15,40.0%,2m
31937,1,MrHarrison,2467,144,5,2,7,71.4%,39m
31937,3,Pops,2467,30,5,2,7,71.4%,34m
31937,2,JInvisible,2467,180,5,3,8,62.5%,1h
31937,3,Niyaz,2467,122,5,6,11,45.5%,1h
31937,3,[pTa]Morturia,2467,164,5,8,13,38.5%,38m
31937,3,CAD,2467,88,4,3,7,57.1%,28m
31937,2,DonMimimi,2467,60,3,5,8,37.5%,56m
31937,1,OpixOnFIre,2467,48,2,0,2,100.0%,42m
31937,1,[Teror]CHINESE,2467,0,2,4,6,33.3%,48m
31937,1,xaerock,2467,97,2,4,6,33.3%,45m
31937,3,Pamnek,2467,0,1,0,1,100.0%,45m
31937,3,Ktulhe,2467,0,1,0,1,100.0%,31m
31937,1,Magrus,2467,0,1,1,2,50.0%,40m
31937,3,Maikun,2467,97,1,3,4,25.0%,51m
31937,3,ZinkZi,2467,0,1,4,5,20.0%,27m
31937,3,Bergzwerg,2467,0,1,4,5,20.0%,27m
31937,3,teramus,2467,0,0,1,1,0.0%,60m
31937,1,yago,2467,0,0,2,2,0.0%,1h
31937,3,[SC22SC]ЗлыеНоски,2467,0,0,2,2,0.0%,34m
31937,3,ШабНигурат,2467,0,0,3,3,0.0%,3m
31961,3,Hollow,2466,1119,95,83,178,53.4%,38m
31961,2,ElipkaZz,2466,1081,81,70,151,53.6%,1h
31961,3,Strogmass,2466,1051,76,70,146,52.1%,45m
31961,3,killer,2466,1268,64,57,121,52.9%,12m
31961,2,razzer,2466,900,39,40,79,49.4%,26m
31961,1,scoon,2466,632,31,36,67,46.3%,7m
31961,1,[NLTN]CreepyCreep,2466,874,28,42,70,40.0%,55m
31961,2,Marbel,2466,279,20,26,46,43.5%,24m
31961,2,Cirkusulla,2466,411,17,24,41,41.5%,9m
31961,3,Arti,2466,311,13,14,27,48.1%,10m
31961,2,Embren,2466,182,9,11,20,45.0%,1h
31961,2,[MCDTG]Toldo,2466,122,4,11,15,26.7%,1h
31961,1,maelstrom,2466,48,2,1,3,66.7%,4m
31961,3,SasNiYMVK,2466,118,2,2,4,50.0%,8m
31961,3,ReturnZero,2466,0,2,3,5,40.0%,6m
31961,1,Jaybo,2466,48,2,5,7,28.6%,1h
31961,1,DidjeY,2466,0,1,1,2,50.0%,46m
31961,3,Peaky,2466,30,1,3,4,25.0%,2m
31961,3,JustPro,2466,0,0,1,1,0.0%,29m
31961,3,Nedug,2466,0,0,3,3,0.0%,60m
31981,2,[HuNBhD]Midrykaly,2465,1507,100,84,184,54.3%,53m
31981,2,[GBCSC2]Maggy,2465,889,33,35,68,48.5%,1h
31981,3,[MSCR]Annlover,2465,621,29,31,60,48.3%,9m
31981,3,takiinbor,2465,523,20,12,32,62.5%,59m
31981,3,ato,2465,514,20,20,40,50.0%,1h
31981,3,BatlleAnt,2465,464,19,9,28,67.9%,60m
31981,1,bongio,2465,422,18,18,36,50.0%,53m
31981,2,Максимус,2465,496,17,22,39,43.6%,37m
31981,3,DinRecords,2465,428,14,29,43,32.6%,20m
31981,3,TheRealAnton,2465,349,13,14,27,48.1%,28m
31981,3,YourDestiny,2465,283,9,7,16,56.2%,38m
31981,3,Reegol,2465,193,6,5,11,54.5%,35m
31981,3,Rokoko,2465,152,6,9,15,40.0%,7m
31981,3,Clouds,2465,205,5,4,9,55.6%,1h
31981,2,[KFF]Nemesis,2465,120,5,12,17,29.4%,30m
31981,3,agmm,2465,140,4,0,4,100.0%,44m
31981,3,Vodachka,2465,0,3,2,5,60.0%,60m
31981,3,mordu,2465,150,3,4,7,42.9%,41m
31981,2,[khps]Cherembsha,2465,0,3,6,9,33.3%,7m
31981,2,storm,2465,62,3,9,12,25.0%,41m
31981,3,DunkelZwei,2465,121,2,2,4,50.0%,59m
31981,3,Bergen,2465,0,1,4,5,20.0%,40m
31981,3,qsen,2465,0,1,4,5,20.0%,31m
31981,2,LebonFrancis,2465,0,1,6,7,14.3%,1h
31981,3,PewPewLazer,2465,0,0,1,1,0.0%,31m
32006,3,Grey,2464,1589,250,246,496,50.4%,38m
32006,2,Domini,2464,775,34,33,67,50.7%,51m
32006,3,JoyTarget,2464,729,29,31,60,48.3%,54m
32006,3,Shakazul,2464,399,17,11,28,60.7%,31m
32006,3,Аларак,2464,407,15,23,38,39.5%,57m
32006,3,Rickman,2464,251,10,2,12,83.3%,8m
32006,3,VRdog,2464,298,10,11,21,47.6%,29m
32006,3,MaruSucks,2464,192,7,2,9,77.8%,60m
32006,3,Forgest,2464,230,6,15,21,28.6%,58m
32006,3,Pavel,2464,184,5,4,9,55.6%,39m
32006,3,[aDIV]bigdaddy,2464,30,2,2,4,50.0%,37m
32006,3,[SBHAWK]Iggy,2464,58,2,5,7,28.6%,1h
32006,1,SwatBat,2464,48,2,5,7,28.6%,9m
32006,3,[ЕМPIRE]рускот,2464,97,1,1,2,50.0%,8m
32006,1,ХОРОНЯКА,2464,46,1,5,6,16.7%,49m
32006,1,[ATCH]Nord,2464,0,0,1,1,0.0%,31m
32006,3,Byron,2464,0,0,6,6,0.0%,4m
32023,2,[mfixed]PieRun,2463,1561,189,180,369,51.2%,1h
32023,1,who,2463,1392,122,115,237,51.5%,1h
32023,2,Deraskos,2463,1427,119,112,231,51.5%,1h
32023,2,jöremias,2463,1560,99,88,187,52.9%,1h
32023,3,[MdbS]NeverGind,2463,590,45,28,73,61.6%,51m
32023,3,uzy,2463,1096,45,41,86,52.3%,6m
32023,3,Saishan,2463,1070,40,40,80,50.0%,52m
32023,3,AleX,2463,780,35,28,63,55.6%,40m
32023,2,oldupzer,2463,766,31,29,60,51.7%,56m
32023,3,Sneezle,2463,798,30,31,61,49.2%,41m
32023,3,RockYou,2463,471,23,15,38,60.5%,43m
32023,3,powerslide,2463,426,15,15,30,50.0%,43m
32023,3,[DEDAL]uciekinier,2463,360,14,5,19,73.7%,1h
32023,3,KiDoC,2463,390,14,8,22,63.6%,6m
32023,3,Alex,2463,237,13,15,28,46.4%,41m
32023,3,IIIIIIIIIIII,2463,260,10,5,15,66.7%,45m
32023,2,tUrbo,2463,192,8,8,16,50.0%,58m
32023,1,Ellorie,2463,115,5,6,11,45.5%,46m
32023,3,САНГВИНИЙ,2463,120,5,6,11,45.5%,40m
32023,1,[беш]hellfire,2463,0,3,3,6,50.0%,37m
32023,2,Lathus,2463,126,2,2,4,50.0%,37m
32023,3,Skald,2463,95,2,4,6,33.3%,38m
32023,3,[Connor]Atlantis,2463,0,2,5,7,28.6%,59m
32023,2,Клюква,2463,97,2,5,7,28.6%,1h
32023,3,Gisch,2463,0,1,1,2,50.0%,4m
32023,3,Bistou,2463,0,0,2,2,0.0%,52m
32049,3,WILDROBOT,2462,701,34,17,51,66.7%,38m
32049,3,trety,2462,867,34,32,66,51.5%,59m
32049,2,Tekan,2462,536,31,36,67,46.3%,34m
32049,3,Lifebtrippin,2462,775,30,32,62,48.4%,8m
32049,2,Phresher,2462,445,23,28,51,45.1%,37m
32049,2,Kurczak,2462,512,18,21,39,46.2%,42m
32049,3,Marine,2462,336,14,7,21,66.7%,6m
32049,1,EGO,2462,284,9,24,33,27.3%,1h
32049,3,Pelia,2462,209,8,7,15,53.3%,10m
32049,2,[MechNC]justQb,2462,211,8,11,19,42.1%,60m
32049,3,Kemand,2462,178,6,0,6,100.0%,7m
32049,2,Robly,2462,145,5,8,13,38.5%,41m
32049,3,[SkBG]CATU,2462,60,3,5,8,37.5%,37m
32049,3,Leilin,2462,30,2,0,2,100.0%,31m
32049,3,ZergTox,2462,119,2,2,4,50.0%,52m
32049,3,[braBra]SkyZnation,2462,30,2,3,5,40.0%,44m
32049,3,zorikar,2462,95,2,4,6,33.3%,60m
32049,3,Cederlund,2462,30,2,5,7,28.6%,59m
32049,3,RaptoR,2462,30,1,4,5,20.0%,56m
32049,3,Kane,2462,0,0,1,1,0.0%,6m
32049,3,[from]Jawal,2462,0,0,1,1,0.0%,27m
32049,3,Sanya,2462,0,0,1,1,0.0%,45m
32049,3,[Fansaf]eldar,2462,0,0,2,2,0.0%,49m
32072,3,[SS13]Johnny,2461,946,37,24,61,60.7%,3m
32072,2,BestMuv,2461,928,33,43,76,43.4%,1h
32072,3,VILCHES,2461,494,32,29,61,52.5%,9m
32072,3,Nikiciukas,2461,477,23,23,46,50.0%,51m
32072,3,Stian,2461,407,16,13,29,55.2%,55m
32072,1,Crésus,2461,385,14,18,32,43.8%,11m
32072,2,Rovenant,2461,296,13,21,34,38.2%,39m
32072,3,[GZTV]Tedeous,2461,114,7,6,13,53.8%,1h
32072,1,baronVonPepe,2461,164,6,7,13,46.2%,1h
32072,2,Peepeesker,2461,149,6,11,17,35.3%,1h
32072,3,Artaniz,2461,167,4,4,8,50.0%,39m
32072,3,ZeroDay,2461,161,4,8,12,33.3%,36m
32072,2,verrektejj,2461,111,4,9,13,30.8%,5m
32072,1,[WeiK]yxaswe,2461,126,4,11,15,26.7%,34m
32072,3,[HyCl]IIIIIIIIIIII,2461,137,3,7,10,30.0%,3m
32072,3,kingsize,2461,117,2,2,4,50.0%,1h
32072,1,Aemyl,2461,0,1,0,1,100.0%,46m
32072,1,Hudson,2461,0,1,0,1,100.0%,51m
32072,3,Kridz,2461,0,1,2,3,33.3%,51m
32072,2,[TedB]Veseluxa,2461,92,1,3,4,25.0%,2m
32072,1,GoserKiev,2461,0,1,4,5,20.0%,41m
32072,3,BigDickHonky,2461,0,1,4,5,20.0%,31m
32072,3,[FBON]Nakami,2461,0,0,2,2,0.0%,42m
32095,3,Janek,2460,924,54,58,112,48.2%,44m
32095,2,ten,2460,615,44,48,92,47.8%,1h
32095,2,lubiiik,2460,834,32,40,72,44.4%,17m
32095,3,TheStranger,2460,337,13,13,26,50.0%,11m
32095,3,[VarPe]Sanggi,2460,409,13,16,29,44.8%,54m
32095,2,[Bopos]SatellitexHD,2460,58,6,5,11,54.5%,24m
32095,2,DeFRaGZoR,2460,218,6,11,17,35.3%,1h
32095,1,DarkMatter,2460,193,5,4,9,55.6%,53m
32095,3,NickNaylor,2460,190,5,6,11,45.5%,44m
32095,2,SofaNinja,2460,86,5,8,13,38.5%,1h
32095,2,Wite,2460,154,5,11,16,31.2%,1h
32095,3,[sonic1]Archon,2460,114,4,5,9,44.4%,9m
32095,2,Stellar,2460,42,4,8,12,33.3%,3m
32095,2,NickName,2460,82,4,11,15,26.7%,9m
32095,3,LeshiY,2460,0,3,2,5,60.0%,54m
32095,3,IIIIIIIIIIII,2460,62,2,6,8,25.0%,33m
32095,3,Light,2460,0,1,0,1,100.0%,1h
32095,3,Kamizash,2460,0,1,1,2,50.0%,50m
32095,3,[WАSD]Kin,2460,0,1,4,5,20.0%,7m
32095,3,Aladar,2460,0,0,1,1,0.0%,3m
32095,1,OFsaID,2460,0,0,1,1,0.0%,30m
32095,3,Craig,2460,0,0,2,2,0.0%,34m
32117,2,doctorvenom,2459,1476,157,154,311,50.5%,51m
32117,2,Miru,2459,1532,128,124,252,50.8%,4m
32117,3,[FCKDHA]droaeyy,2459,1579,121,102,223,54.3%,1h
32117,2,DrunkKutuzov,2459,1550,84,81,165,50.9%,4m
32117,3,Murk,2459,319,30,16,46,65.2%,51m
32117,2,Asdar,2459,624,23,27,50,46.0%,1h
32117,3,INSANE,2459,515,21,12,33,63.6%,52m
32117,2,[XIIIX]Check,2459,461,19,19,38,50.0%,56m
32117,3,Stepll,2459,327,14,2,16,87.5%,36m
32117,2,CobraKai,2459,376,13,17,30,43.3%,4m
32117,3,[WWIS]WildShaman,2459,243,9,1,10,90.0%,27m
32117,2,tuxcart,2459,204,7,10,17,41.2%,1h
32117,2,Oyrad,2459,246,7,13,20,35.0%,9m
32117,3,monsuta,2459,147,5,6,11,45.5%,1h
32117,3,LtDamn,2459,119,5,10,15,33.3%,24m
32117,2,Andreton,2459,60,4,7,11,36.4%,48m
32117,3,daop,2459,0,3,2,5,60.0%,54m
32117,1,Kanelbrød,2459,117,2,1,3,66.7%,58m
32117,3,Alaric,2459,118,2,2,4,50.0%,56m
32117,3,BlazeVVV,2459,30,2,2,4,50.0%,1h
32117,2,Montreary,2459,92,2,3,5,40.0%,41m
32117,2,Xyphor,2459,0,2,4,6,33.3%,25m
32117,1,MrMechanist,2459,97,2,4,6,33.3%,4m
32117,3,StarChief,2459,30,1,2,3,33.3%,34m
32117,3,cosmic,2459,9,1,4,5,20.0%,7m
32117,3,[TBL]Shargoth,2459,30,1,5,6,16.7%,58m
32117,3,Azket,2459,0,0,2,2,0.0%,46m
32144,2,PlanC,2458,1027,154,150,304,50.7%,8m
32144,3,Wyze,2458,691,103,98,201,51.2%,57m
32144,1,[NeCriN]Shigi,2458,1551,85,95,180,47.2%,49m
32144,3,cobracccp,2458,822,59,58,117,50.4%,35m
32144,1,IceFire,2458,821,50,42,92,54.3%,1h
32144,3,oldmustache,2458,1044,48,31,79,60.8%,57m
32144,1,[WIRNIX]Kapaus,2458,1197,44,48,92,47.8%,1h
32144,1,Smorly,2458,727,27,33,60,45.0%,59m
32144,2,ShaddamV,2458,217,9,15,24,37.5%,53m
32144,2,[GOLDPL]Shark,2458,170,7,10,17,41.2%,1h
32144,3,Golgren,2458,167,5,2,7,71.4%,4m
32144,3,piv,2458,60,3,3,6,50.0%,28m
32144,3,Misakusi,2458,97,3,6,9,33.3%,49m
32144,3,Azinot,2458,30,2,1,3,66.7%,10m
32144,3,Razz,2458,19,2,4,6,33.3%,1h
32144,3,toka,2458,0,1,0,1,100.0%,28m
32144,3,doctordrones,2458,0,1,0,1,100.0%,49m
32144,1,ловкий,2458,0,1,4,5,20.0%,40m
32144,3,Итальянец,2458,30,1,6,7,14.3%,25m
32144,1,Tassadar,2458,0,0,1,1,0.0%,30m
32144,3,Gnotro,2458,0,0,1,1,0.0%,1h
32144,3,artboxer,2458,0,0,1,1,0.0%,31m
32166,3,Richard,2457,1204,130,118,248,52.4%,42m
32166,3,[beaste]TheSwarmLead,2457,1460,114,95,209,54.5%,28m
32166,3,Silencer,2457,966,48,37,85,56.5%,50m
32166,3,CALC,2457,973,46,33,79,58.2%,35m
32166,3,FoxyRUS,2457,547,41,37,78,52.6%,9m
32166,3,Windfurious,2457,513,38,32,70,54.3%,36m
32166,3,WishMaster,2457,877,37,27,64,57.8%,60m
32166,3,Hakii,2457,559,37,32,69,53.6%,42m
32166,2,Okay,2457,723,32,30,62,51.6%,6m
32166,3,BRUCER,2457,655,28,23,51,54.9%,49m
32166,3,olpq,2457,581,25,20,45,55.6%,9m
32166,3,Opadelirium,2457,170,24,10,34,70.6%,34m
32166,3,Airblasted,2457,468,17,16,33,51.5%,52m
32166,3,Leonid,2457,250,13,15,28,46.4%,28m
32166,2,cfyz,2457,298,12,15,27,44.4%,1h
32166,3,GoG,2457,174,9,8,17,52.9%,10m
32166,1,SkipperS,2457,250,9,12,21,42.9%,46m
32166,3,[k1raen]Neo,2457,146,5,8,13,38.5%,56m
32166,1,Ourdvuk,2457,0,4,2,6,66.7%,39m
32166,1,VneMoraly,2457,0,4,2,6,66.7%,9m
32166,3,[DWTeam]shadowdragon,2457,116,4,4,8,50.0%,60m
32166,3,Ghenya,2457,90,4,6,10,40.0%,34m
32166,2,HawK,2457,90,4,9,13,30.8%,4m
32166,3,Moonlight,2457,60,3,6,9,33.3%,4m
32166,3,BobbyMcmarly,2457,30,1,2,3,33.3%,28m
32166,1,Tejs,2457,0,1,4,5,20.0%,1h
32166,1,Jaegar,2457,0,1,4,5,20.0%,11m
32166,3,Murphy,2457,0,0,1,1,0.0%,57m
32166,3,Lentyao,2457,0,0,1,1,0.0%,2m
32166,3,yiforce,2457,0,0,2,2,0.0%,50m
32166,3,[ZERGTV]Hund,2457,0,0,2,2,0.0%,1h
32197,2,kikadas,2456,1035,259,243,502,51.6%,59m
32197,2,Glebaddon,2456,1063,50,34,84,59.5%,41m
32197,3,Leinad,2456,716,49,36,85,57.6%,1h
32197,3,roastbeef,2456,861,46,41,87,52.9%,60m
32197,3,CoqSauvage,2456,908,39,36,75,52.0%,3m
32197,3,DrBoom,2456,389,17,5,22,77.3%,54m
32197,3,Andy,2456,332,15,10,25,60.0%,53m
32197,3,Dzhenzherya,2456,176,9,3,12,75.0%,3m
32197,3,Joker,2456,192,9,9,18,50.0%,58m
32197,1,MaybNextTime,2456,255,8,6,14,57.1%,49m
32197,2,Calex,2456,294,7,14,21,33.3%,59m
32197,2,George,2456,212,7,15,22,31.8%,1h
32197,3,[Foxize]Vad,2456,146,5,6,11,45.5%,1h
32197,3,Beda,2456,150,5,7,12,41.7%,1h
32197,3,[mfxed]NigrumF,2456,118,5,8,13,38.5%,44m
32197,3,Rjames,2456,60,3,5,8,37.5%,41m
32197,3,Grim,2456,96,2,0,2,100.0%,28m
32197,3,Лисичка,2456,0,0,1,1,0.0%,40m
32197,3,daqiao,2456,0,0,3,3,0.0%,37m
32216,3,MIXA,2455,1581,209,199,408,51.2%,3m
32216,3,Potatolord,2455,1576,107,79,186,57.5%,6m
32216,3,Revane,2455,1188,70,58,128,54.7%,60m
32216,2,dave,2455,354,34,32,66,51.5%,41m
32216,3,Cosmopoly,2455,710,30,22,52,57.7%,6m
32216,2,DrunkOldFart,2455,671,28,34,62,45.2%,2m
32216,3,KyleNeedHook,2455,88,4,3,7,57.1%,1h
32216,3,Rahlen,2455,117,3,3,6,50.0%,1h
32216,2,KingDeeDee,2455,116,3,4,7,42.9%,31m
32216,3,krypton,2455,58,2,5,7,28.6%,60m
32216,3,zhora,2455,0,1,0,1,100.0%,36m
32216,3,Vladimir,2455,97,1,5,6,16.7%,55m
32216,3,robban,2455,0,0,1,1,0.0%,52m
32229,3,ludoleader,2454,893,40,31,71,56.3%,39m
32229,3,YannickFR,2454,998,36,40,76,47.4%,38m
32229,3,[xFRSx]Dharma,2454,927,34,30,64,53.1%,45m
32229,3,[baker]Gerbert,2454,719,29,25,54,53.7%,31m
32229,3,Diasat,2454,676,26,27,53,49.1%,35m
32229,3,puddle,2454,695,25,31,56,44.6%,4m
32229,3,Titan,2454,601,24,21,45,53.3%,27m
32229,3,[OLT]GENGIU,2454,403,18,14,32,56.2%,27m
32229,3,[BCNG]Vanchesko,2454,451,17,13,30,56.7%,35m
32229,2,Possibility,2454,444,17,18,35,48.6%,53m
32229,2,SpaceMarine,2454,515,16,21,37,43.2%,25m
32229,1,[Berode]Guile,2454,354,11,19,30,36.7%,50m
32229,3,StarLight,2454,290,10,6,16,62.5%,35m
32229,3,[NVRGUP]lauripoika,2454,306,10,12,22,45.5%,31m
32229,2,OblakoOfRtut,2454,126,5,8,13,38.5%,25m
32229,3,[CLMOB]Archijevny,2454,173,4,7,11,36.4%,6m
32229,2,Shrek,2454,84,3,1,4,75.0%,34m
32229,1,Delik,2454,97,3,3,6,50.0%,40m
32229,3,madamka,2454,86,3,6,9,33.3%,1h
32229,3,Maksiu,2454,0,1,0,1,100.0%,28m
32229,1,GustavGhost,2454,0,1,3,4,25.0%,52m
32229,3,Brotbaumbrot,2454,30,1,4,5,20.0%,35m
32229,3,vgta,2454,0,0,1,1,0.0%,28m
32229,1,[Percel]Richy,2454,0,0,1,1,0.0%,1h
32253,3,Techmate,2453,928,41,35,76,53.9%,40m
32253,2,vax,2453,526,31,23,54,57.4%,59m
32253,2,PlayForFun,2453,705,28,31,59,47.5%,1h
32253,3,ostolbeney,2453,335,24,20,44,54.5%,31m
32253,3,KingLeQwer,2453,517,22,13,35,62.9%,33m
32253,3,[CHNI]DaFastKyuSha,2453,311,21,16,37,56.8%,58m
32253,3,Тахтамыш,2453,456,18,19,37,48.6%,1h
32253,3,miki,2453,470,17,15,32,53.1%,51m
32253,2,Jebalnik,2453,316,12,18,30,40.0%,57m
32253,3,Botzo,2453,148,8,7,15,53.3%,46m
32253,3,Maxi,2453,208,8,8,16,50.0%,55m
32253,3,Rognek,2453,208,8,9,17,47.1%,2m
32253,2,Rieutheu,2453,180,8,11,19,42.1%,41m
32253,3,ArtzCoffe,2453,148,6,5,11,54.5%,36m
32253,2,danktemplar,2453,178,6,9,15,40.0%,1h
32253,3,ferocious,2453,168,5,5,10,50.0%,4m
32253,2,jigitto,2453,138,4,4,8,50.0%,37m
32253,3,FamaS,2453,118,2,1,3,66.7%,49m
32253,3,Skippy,2453,121,2,2,4,50.0%,11m
32253,3,Aster,2453,0,1,0,1,100.0%,55m
32253,3,Janekxxxx,2453,0,0,1,1,0.0%,34m
32253,1,juhothenero,2453,0,0,1,1,0.0%,40m
32253,3,Arctic,2453,0,0,2,2,0.0%,43m
32253,2,Mas,2453,0,0,3,3,0.0%,33m
32253,1,ZecheTop,2453,0,0,3,3,0.0%,39m
32278,1,iiiiiiiiiiii,2452,1098,349,356,705,49.5%,9m
32278,2,Flatulencio,2452,836,120,110,230,52.2%,1h
32278,2,ChrisNomf,2452,1032,112,107,219,51.1%,33m
32278,3,Hadwin,2452,411,111,101,212,52.4%,9m
32278,1,Rez,2452,1338,101,95,196,51.5%,27m
32278,2,[РСФРС]ZorTuL,2452,1548,90,74,164,54.9%,10m
32278,3,НееЖить,2452,911,67,56,123,54.5%,58m
32278,1,CoronaVirus,2452,899,46,51,97,47.4%,33m
32278,3,burlybest,2452,367,15,13,28,53.6%,60m
32278,3,XType,2452,390,14,16,30,46.7%,3m
32278,3,karljang,2452,325,13,11,24,54.2%,60m
32278,3,Phily,2452,232,9,12,21,42.9%,15m
32278,3,Twixmaniak,2452,170,6,5,11,54.5%,51m
32278,2,Muffin,2452,161,5,2,7,71.4%,53m
32278,2,Truechill,2452,90,5,7,12,41.7%,37m
32278,3,Magmusus,2452,145,4,1,5,80.0%,48m
32278,3,KeyDg,2452,137,4,1,5,80.0%,28m
32278,1,MSDB,2452,145,3,5,8,37.5%,37m
32278,3,[Arrows]Klemst,2452,30,2,2,4,50.0%,11m
32278,2,SepulvedaBlv,2452,30,2,5,7,28.6%,1h
32278,3,Striker,2452,0,1,0,1,100.0%,43m
32278,1,Ravdrien,2452,0,1,2,3,33.3%,59m
32278,3,пипи,2452,30,1,4,5,20.0%,57m
32278,1,Ябадабаду,2452,0,1,4,5,20.0%,56m
32278,3,[AlphC]Morhold,2452,30,1,6,7,14.3%,34m
32278,1,Ido,2452,0,0,1,1,0.0%,42m
32278,3,Bert,2452,0,0,1,1,0.0%,2m
32278,3,rocht,2452,0,0,1,1,0.0%,28m
32278,3,Rakot,2452,0,0,2,2,0.0%,44m
32278,3,Clad,2452,0,0,3,3,0.0%,7m
32308,2,NaNome,2451,919,40,38,78,51.3%,10m
32308,3,Elijah,2451,628,31,11,42,73.8%,28m
32308,3,Strategie,2451,680,25,27,52,48.1%,51m
32308,2,Ssibal,2451,370,13,9,22,59.1%,11m
32308,2,palact,2451,374,12,21,33,36.4%,53m
32308,3,Amwas,2451,306,11,13,24,45.8%,27m
32308,3,[Leviou]Harryoox,2451,216,10,13,23,43.5%,36m
32308,1,NyashMyash,2451,226,10,16,26,38.5%,55m
32308,2,McSushi,2451,147,6,8,14,42.9%,48m
32308,3,[HÖDAN]Phil,2451,162,4,1,5,80.0%,33m
32308,3,DragonCat,2451,76,4,8,12,33.3%,2m
32308,3,Asterianne,2451,117,3,1,4,75.0%,40m
32308,3,Pixel,2451,95,3,1,4,75.0%,35m
32308,3,[M0R3]Pallos,2451,139,3,2,5,60.0%,7m
32308,2,Anov,2451,94,3,11,14,21.4%,32m
32308,3,Aleratorz,2451,97,2,0,2,100.0%,51m
32308,3,csalol,2451,30,2,1,3,66.7%,51m
32308,3,Marksman,2451,94,2,4,6,33.3%,38m
32308,2,Иван,2451,30,2,8,10,20.0%,17m
32308,3,MalustarVIII,2451,0,1,0,1,100.0%,31m
32308,3,XELLOSSYNC,2451,30,1,7,8,12.5%,52m
32329,3,generos,2450,1480,65,51,116,56.0%,45m
32329,1,Badger,2450,742,27,24,51,52.9%,7m
32329,3,Svitanok,2450,533,20,20,40,50.0%,57m
32329,3,zergling,2450,485,20,21,41,48.8%,43m
32329,3,DarkMorphPT,2450,311,18,14,32,56.2%,53m
32329,1,Figaro,2450,370,14,14,28,50.0%,30m
32329,2,Hellfis,2450,402,14,16,30,46.7%,10m
32329,3,Dex,2450,221,6,6,12,50.0%,8m
32329,3,RedWolf,2450,120,5,7,12,41.7%,9m
32329,3,Griffin,2450,58,2,4,6,33.3%,43m
32329,3,Debellum,2450,95,1,1,2,50.0%,40m
32329,2,Сид,2450,0,1,1,2,50.0%,48m
32329,1,перс,2450,0,1,2,3,33.3%,34m
32329,3,thanatoID,2450,0,1,3,4,25.0%,43m
32329,3,DEstroyer,2450,0,1,3,4,25.0%,44m
32329,3,ANAKONDAS,2450,0,0,3,3,0.0%,60m
32345,3,coosa,2449,1401,255,246,501,50.9%,3m
32345,2,Stanley,2449,1350,109,107,216,50.5%,26m
32345,3,Alexx,2449,946,65,64,129,50.4%,44m
32345,2,Fox,2449,814,62,62,124,50.0%,41m
32345,3,zløbá,2449,365,44,28,72,61.1%,54m
32345,3,Artur,2449,371,17,13,30,56.7%,45m
32345,3,IngvarRai,2449,411,15,10,25,60.0%,1h
32345,3,NovA,2449,303,13,10,23,56.5%,7m
32345,3,nexus,2449,360,13,16,29,44.8%,38m
32345,1,[boși]Surgical,2449,245,10,14,24,41.7%,31m
32345,3,JoL,2449,260,9,6,15,60.0%,51m
32345,2,EDU,2449,252,8,10,18,44.4%,1h
32345,3,[LCTeam]cpadélol,2449,215,8,11,19,42.1%,1h
32345,3,Kron,2449,200,6,8,14,42.9%,11m
32345,3,gandalf,2449,185,5,9,14,35.7%,34m
32345,3,rataton,2449,0,4,1,5,80.0%,3m
32345,3,[RеG]VALERA,2449,117,3,0,3,100.0%,28m
32345,3,Hjalte,2449,30,2,4,6,33.3%,24m
32345,3,MaphLionXIV,2449,68,2,24,26,7.7%,16m
32345,3,[NaShou]Mayday,2449,95,1,1,2,50.0%,7m
32345,3,okke,2449,30,1,2,3,33.3%,35m
32345,3,Crossbreed,2449,0,1,2,3,33.3%,1h
32345,1,Pergaña,2449,0,1,4,5,20.0%,56m
32345,3,Meldir,2449,0,1,4,5,20.0%,27m
32345,2,polakziomek,2449,30,1,8,9,11.1%,9m
32345,3,eZcore,2449,0,0,1,1,0.0%,48m
32345,3,[FYBF]Koprican,2449,0,0,1,1,0.0%,38m
32345,3,BOgdan,2449,0,0,1,1,0.0%,52m
32345,3,Menver,2449,0,0,2,2,0.0%,36m
32345,3,KSB,2449,0,0,3,3,0.0%,56m
32375,3,Ryoh,2448,1566,135,119,254,53.1%,7m
32375,1,Austerlitz,2448,1457,99,103,202,49.0%,3m
32375,3,yahooo,2448,1453,61,53,114,53.5%,38m
32375,3,kingbejk,2448,908,49,55,104,47.1%,35m
32375,3,[GGTOP]Zlodei,2448,739,39,34,73,53.4%,35m
32375,3,Hator,2448,582,24,15,39,61.5%,51m
32375,3,[Dоbrо]AgentOF,2448,428,19,3,22,86.4%,35m
32375,3,[PMTM1]karal,2448,269,11,3,14,78.6%,45m
32375,3,Piotr,2448,341,11,10,21,52.4%,37m
32375,2,Mysskas,2448,314,10,17,27,37.0%,39m
32375,3,SpatOul,2448,227,8,8,16,50.0%,1h
32375,3,Vinegredinka,2448,226,8,10,18,44.4%,1h
32375,3,CorolJab,2448,228,7,7,14,50.0%,3m
32375,3,[M42]AKII,2448,166,6,7,13,46.2%,49m
32375,3,Davide,2448,129,3,3,6,50.0%,31m
32375,3,Flex,2448,42,3,7,10,30.0%,34m
32375,3,[ZЕRG7V]АнтихрисТ,2448,95,2,0,2,100.0%,49m
32375,3,[WSKY]UnderDark,2448,30,2,1,3,66.7%,40m
32375,3,[DOGGO]ManyDoge,2448,0,1,3,4,25.0%,1h
32375,3,denis,2448,30,1,4,5,20.0%,42m
32375,3,SuperSich,2448,30,1,5,6,16.7%,8m
32375,3,[Elva]Luna,2448,0,0,1,1,0.0%,46m
32375,3,[MCat]Rain,2448,0,0,1,1,0.0%,1h
32375,3,sellingmoms,2448,0,0,2,2,0.0%,27m
32375,3,Danilka,2448,0,0,3,3,0.0%,42m
32400,2,Aleks,2447,966,211,206,417,50.6%,1h
32400,3,MUIIIKAH,2447,1420,86,81,167,51.5%,46m
32400,3,kavalerOO,2447,1344,64,43,107,59.8%,46m
32400,3,PressFforMe,2447,1191,50,42,92,54.3%,45m
32400,3,SHADOWDRAGON,2447,427,31,30,61,50.8%,40m
32400,3,[Dralag]Reverentia,2447,523,23,12,35,65.7%,39m
32400,3,Atlas,2447,466,19,13,32,59.4%,37m
32400,3,louster,2447,318,13,13,26,50.0%,40m
32400,2,Jass,2447,344,12,12,24,50.0%,37m
32400,1,michel,2447,338,11,15,26,42.3%,35m
32400,3,Einadel,2447,281,9,8,17,52.9%,11m
32400,3,NightLight,2447,230,9,14,23,39.1%,21m
32400,3,[PL345]QuBuS,2447,203,8,6,14,57.1%,39m
32400,3,Ftern,2447,231,8,8,16,50.0%,59m
32400,3,Smiley,2447,164,7,6,13,53.8%,1h
32400,3,Дмитрий,2447,168,6,7,13,46.2%,40m
32400,3,Caesar,2447,178,6,8,14,42.9%,37m
32400,2,Megatron,2447,202,5,5,10,50.0%,55m
32400,3,FLInT,2447,30,1,2,3,33.3%,46m
32400,2,Ragnarson,2447,40,1,2,3,33.3%,53m
32400,3,wqed,2447,0,1,3,4,25.0%,11m
32400,3,PayoLoko,2447,0,0,1,1,0.0%,8m
32400,3,rover,2447,0,0,4,4,0.0%,34m
32400,3,[Petrиs]Kiranos,2447,0,0,5,5,0.0%,12m
32424,3,BeatMeGoGold,2446,475,51,48,99,51.5%,12m
32424,2,FigurR,2446,1044,47,47,94,50.0%,1h
32424,3,PanAdam,2446,342,35,39,74,47.3%,29m
32424,3,GoRoX,2446,518,29,24,53,54.7%,49m
32424,3,HeavyDrinker,2446,622,25,28,53,47.2%,1h
32424,3,HowlingMad,2446,480,21,15,36,58.3%,58m
32424,2,[RÖÖV]Yorgro,2446,490,20,19,39,51.3%,48m
32424,3,asdasdasdasd,2446,415,14,18,32,43.8%,1h
32424,3,MOOORTEN,2446,273,9,5,14,64.3%,33m
32424,3,vavl,2446,253,8,10,18,44.4%,60m
32424,2,[NIK2]Cavman,2446,272,8,13,21,38.1%,32m
32424,3,[RofIer]SkilleT,2446,231,7,4,11,63.6%,37m
32424,3,nookiez,2446,178,7,7,14,50.0%,32m
32424,3,Tavronch,2446,145,5,5,10,50.0%,1h
32424,3,STING,2446,150,5,8,13,38.5%,40m
32424,1,Etrisc,2446,120,4,0,4,100.0%,57m
32424,3,Sirix,2446,62,3,3,6,50.0%,58m
32424,2,NewChampion,2446,30,3,6,9,33.3%,38m
32424,1,Moce,2446,48,2,5,7,28.6%,38m
32424,3,моргенштерн,2446,0,2,5,7,28.6%,1h
32424,1,Angon,2446,0,1,0,1,100.0%,48m
32424,3,Johnny,2446,0,1,1,2,50.0%,11m
32424,3,[LIQUID]Atlant,2446,0,1,1,2,50.0%,1h
32424,3,Maestro,2446,30,1,2,3,33.3%,51m
32424,3,ALEKCANDR,2446,0,1,4,5,20.0%,27m
32424,1,Kichou,2446,0,1,4,5,20.0%,4m
32424,3,Edgarwulf,2446,0,1,4,5,20.0%,9m
32424,1,kail,2446,0,0,1,1,0.0%,40m
32424,3,[BM0]Romeo,2446,0,0,2,2,0.0%,31m
32424,3,Tirodyn,2446,0,0,3,3,0.0%,33m
32454,1,borio,2445,1025,136,125,261,52.1%,47m
32454,3,shabobfox,2445,939,74,70,144,51.4%,12m
32454,3,iGGotchu,2445,917,63,50,113,55.8%,29m
32454,1,[C0RE]Scrappy,2445,1318,56,75,131,42.7%,8m
32454,3,thl,2445,914,42,43,85,49.4%,1h
32454,2,Maverick,2445,648,29,27,56,51.8%,46m
32454,3,Xeraloth,2445,333,27,15,42,64.3%,1h
32454,3,Katya,2445,601,24,18,42,57.1%,8m
32454,3,akurilo,2445,551,20,18,38,52.6%,1h
32454,3,botyara,2445,509,19,13,32,59.4%,42m
32454,3,Right,2445,386,15,15,30,50.0%,45m
32454,3,Azrael,2445,324,11,16,27,40.7%,51m
32454,3,Notorious,2445,224,9,9,18,50.0%,9m
32454,3,Zedized,2445,242,8,8,16,50.0%,58m
32454,3,geckoNlui,2445,96,5,8,13,38.5%,54m
32454,3,llllllolnope,2445,202,5,11,16,31.2%,1h
32454,1,[ScSwrm]Scientist,2445,162,5,17,22,22.7%,37m
32454,3,[KFSRus]IIIIIIIIIIII,2445,177,4,5,9,44.4%,1h
32454,1,Gaster,2445,66,4,9,13,30.8%,4m
32454,3,НикНеВажен,2445,0,2,3,5,40.0%,42m
32454,3,Surge,2445,97,1,2,3,33.3%,1h
32454,3,Serral,2445,0,1,4,5,20.0%,2m
32454,2,[ESRR]Luceira,2445,0,1,5,6,16.7%,47m
32454,3,Pawel,2445,0,0,1,1,0.0%,1h
32454,3,Darwin,2445,0,0,1,1,0.0%,58m
32454,1,MasterChief,2445,0,0,1,1,0.0%,57m
32454,3,sukramk,2445,0,0,3,3,0.0%,39m
32481,3,Zhabi,2444,1242,80,74,154,51.9%,31m
32481,2,ПИСЕЦ,2444,1434,53,64,117,45.3%,38m
32481,3,FReq,2444,521,22,15,37,59.5%,38m
32481,3,Svoi,2444,371,15,11,26,57.7%,34m
32481,3,PlayerTwo,2444,350,13,12,25,52.0%,24m
32481,3,[RRQ]akani,2444,235,12,13,25,48.0%,1h
32481,3,frayas,2444,232,9,11,20,45.0%,10m
32481,3,Xenuxus,2444,221,7,5,12,58.3%,1h
32481,3,Hoschi,2444,147,3,4,7,42.9%,58m
32481,3,[NvAA]Archivist,2444,125,2,2,4,50.0%,54m
32481,3,Hate,2444,0,2,3,5,40.0%,52m
32481,2,[KNFX]Kecires,2444,110,2,4,6,33.3%,1h
32481,1,[2B2F]Felino,2444,0,2,4,6,33.3%,1h
32481,3,[GAE]zerling,2444,97,2,5,7,28.6%,40m
32481,2,comandercitt,2444,89,1,2,3,33.3%,43m
32481,3,Midoriya,2444,0,1,3,4,25.0%,34m
32481,3,[Seek]martin,2444,30,1,4,5,20.0%,40m
32498,2,[Körvar]kraschpuck,2443,1461,146,152,298,49.0%,1h
32498,1,Max,2443,545,65,65,130,50.0%,28m
32498,3,IcyDuck,2443,893,42,27,69,60.9%,12m
32498,2,Safari,2443,1042,41,45,86,47.7%,36m
32498,2,Techies,2443,952,38,45,83,45.8%,41m
32498,3,[RioF]oettn,2443,700,31,28,59,52.5%,1h
32498,3,Terrano,2443,542,19,19,38,50.0%,60m
32498,3,BookerDewitt,2443,450,18,15,33,54.5%,1h
32498,3,ich,2443,345,17,20,37,45.9%,1h
32498,3,Kims,2443,411,14,15,29,48.3%,8m
32498,3,Jeka,2443,217,9,7,16,56.2%,38m
32498,3,Soareboi,2443,301,9,8,17,52.9%,4m
32498,2,BorsukUlamTh,2443,186,7,5,12,58.3%,25m
32498,3,пупсик,2443,232,7,6,13,53.8%,31m
32498,1,[Sencor]crockargamer,2443,97,2,2,4,50.0%,24m
32498,3,llllllllllll,2443,94,2,4,6,33.3%,33m
32498,3,Lorim,2443,30,1,4,5,20.0%,58m
32498,1,JulHun,2443,0,1,4,5,20.0%,29m
32498,3,Azirov,2443,0,0,1,1,0.0%,27m
32498,3,[ExMen]Gambit,2443,0,0,1,1,0.0%,12m
32498,3,XyJIiraH,2443,0,0,1,1,0.0%,42m
32519,3,Electricfish,2442,338,78,58,136,57.4%,29m
32519,3,[MUTPLA]ThePlayer,2442,855,36,32,68,52.9%,42m
32519,3,Skurwol,2442,948,34,38,72,47.2%,2m
32519,3,Fatch,2442,395,17,11,28,60.7%,12m
32519,2,RDRD,2442,392,17,22,39,43.6%,39m
32519,3,[Gassy]Lubbalou,2442,394,13,13,26,50.0%,51m
32519,3,Crusher,2442,219,7,5,12,58.3%,42m
32519,3,lIlIlIl,2442,171,6,4,10,60.0%,53m
32519,3,[TkcS]ZaGXG,2442,58,5,6,11,45.5%,46m
32519,3,gotHacks,2442,142,4,2,6,66.7%,60m
32519,1,Титан,2442,144,4,6,10,40.0%,42m
32519,3,manju,2442,68,4,7,11,36.4%,1h
32519,2,[luxorx]xLUXORx,2442,130,4,9,13,30.8%,34m
32519,3,rumspaceham,2442,58,3,2,5,60.0%,1h
32519,3,Ckrols,2442,60,3,5,8,37.5%,3m
32519,3,[scp3]Rylavein,2442,62,3,6,9,33.3%,34m
32519,2,MonSteRiNo,2442,30,3,6,9,33.3%,17m
32519,3,TheNorweigan,2442,129,3,6,9,33.3%,24m
32519,2,[БУБУБ]somebdysm,2442,0,3,7,10,30.0%,1h
32519,3,Sovic,2442,60,2,3,5,40.0%,58m
32519,3,trepach,2442,30,1,2,3,33.3%,38m
32519,3,Johnnywalks,2442,0,0,1,1,0.0%,46m
32519,1,[AMBHXI]Traian,2442,0,0,3,3,0.0%,25m
32542,1,Madao,2441,1587,213,198,411,51.8%,10m
32542,2,Moonman,2441,594,24,25,49,49.0%,1h
32542,3,FapaThor,2441,343,14,18,32,43.8%,1h
32542,3,[мрази]Алинадурында,2441,292,10,10,20,50.0%,33m
32542,2,[dolbo9]Palkin,2441,306,9,14,23,39.1%,9m
32542,3,Гай,2441,208,8,9,17,47.1%,32m
32542,2,gamma,2441,247,8,12,20,40.0%,37m
32542,3,[XKot]XmuriyKot,2441,145,6,5,11,54.5%,45m
32542,3,[Tic2]lynx,2441,191,5,5,10,50.0%,31m
32542,3,DireWolf,2441,86,4,3,7,57.1%,44m
32542,1,moot,2441,169,4,5,9,44.4%,57m
32542,2,Solo,2441,116,4,8,12,33.3%,52m
32542,3,Aversin,2441,167,4,9,13,30.8%,8m
32542,3,Resty,2441,94,3,3,6,50.0%,1h
32542,1,neocortex,2441,96,3,6,9,33.3%,6m
32542,3,ricakylo,2441,121,3,6,9,33.3%,31m
32542,3,[Rabbid]PinkCukorka,2441,0,2,3,5,40.0%,1h
32542,1,ElPea,2441,76,2,13,15,13.3%,2m
32542,3,Robert,2441,0,1,1,2,50.0%,52m
32542,3,Kobra,2441,0,1,4,5,20.0%,54m
32542,2,TEPLEBIUSTAH,2441,0,0,1,1,0.0%,25m
32542,3,[PLA2N]LuckyFox,2441,0,0,1,1,0.0%,1h
32542,3,GEnEtiK,2441,0,0,1,1,0.0%,9m
32542,3,Capris,2441,0,0,1,1,0.0%,10m
32542,3,eboHATOP,2441,0,0,1,1,0.0%,5m
32567,3,Simple,2440,1496,368,380,748,49.2%,20m
32567,2,Xunstoppable,2440,1530,110,106,216,50.9%,1h
32567,3,Peaky,2440,772,103,92,195,52.8%,9m
32567,3,Fullrush,2440,1179,78,73,151,51.7%,54m
32567,3,Ionus,2440,251,59,44,103,57.3%,36m
32567,3,Baccardi,2440,1127,47,44,91,51.6%,55m
32567,3,Wheresmyjack,2440,310,11,13,24,45.8%,43m
32567,3,Nemaksss,2440,284,10,15,25,40.0%,27m
32567,1,Nom,2440,194,9,7,16,56.2%,53m
32567,3,superariel,2440,194,7,9,16,43.8%,1h
32567,3,bosik,2440,226,7,9,16,43.8%,8m
32567,2,damnfool,2440,212,7,11,18,38.9%,52m
32567,3,[SworD3]ZergANgeL,2440,192,5,5,10,50.0%,1h
32567,3,Chiro,2440,149,4,8,12,33.3%,44m
32567,3,SnipeR,2440,120,4,9,13,30.8%,2m
32567,3,Tosh,2440,96,3,1,4,75.0%,44m
32567,3,EKI,2440,60,3,3,6,50.0%,4m
32567,1,Saurny,2440,114,3,5,8,37.5%,47m
32567,3,Star,2440,0,2,5,7,28.6%,59m
32567,3,[Ǽ1]GrafX,2440,96,1,2,3,33.3%,1h
32567,1,Van,2440,0,1,4,5,20.0%,4m
32567,1,PlP,2440,0,1,4,5,20.0%,1h
32567,3,LTa,2440,0,0,1,1,0.0%,49m
32567,1,[DBDF]GabbO,2440,73,0,2,2,0.0%,51m
32567,3,Bomel,2440,0,0,3,3,0.0%,1h
32592,1,vladb,2439,822,29,39,68,42.6%,11m
32592,3,jumbolino,2439,576,24,14,38,63.2%,46m
32592,3,[Calvo]Darwin,2439,403,16,20,36,44.4%,37m
32592,1,[696]NearEdge,2439,330,12,11,23,52.2%,45m
32592,2,Gandalf,2439,238,7,8,15,46.7%,44m
32592,1,agace,2439,188,7,11,18,38.9%,1h
32592,3,Karnickel,2439,194,6,4,10,60.0%,51m
32592,3,Reinoff,2439,174,6,7,13,46.2%,2m
32592,2,Minimalmusic,2439,180,6,13,19,31.6%,53m
32592,3,JoraKornev,2439,139,5,5,10,50.0%,35m
32592,1,[CEXY]NickP,2439,166,4,2,6,66.7%,51m
32592,1,HyCy,2439,145,4,3,7,57.1%,1h
32592,3,Lumerielle,2439,114,3,2,5,60.0%,43m
32592,3,[eerrgg]eranww,2439,143,3,3,6,50.0%,52m
32592,3,Призрак,2439,121,2,2,4,50.0%,58m
32592,1,DuKec,2439,0,1,0,1,100.0%,52m
32592,1,[WCB18]SirLincolln,2439,0,1,4,5,20.0%,30m
32592,1,Zacha,2439,0,1,4,5,20.0%,5m
32592,1,BassToad,2439,0,0,2,2,0.0%,1h
32592,3,Борщ,2439,0,0,2,2,0.0%,2m
32592,1,[St8TrU]TEXASBOY,2439,0,0,3,3,0.0%,60m
32592,2,[5Packs]Dihydrogene,2439,0,0,4,4,0.0%,49m
32614,3,skrech,2438,630,80,86,166,48.2%,2m
32614,2,Take,2438,962,36,46,82,43.9%,8m
32614,2,meE,2438,803,32,33,65,49.2%,1h
32614,2,ParrisHilton,2438,413,29,27,56,51.8%,9m
32614,3,ElBakko,2438,374,14,9,23,60.9%,51m
32614,3,[justS]Thorth,2438,159,5,2,7,71.4%,1h
32614,3,adam,2438,126,5,9,14,35.7%,36m
32614,3,poloch,2438,120,3,3,6,50.0%,42m
32614,3,Thruzt,2438,36,2,1,3,66.7%,46m
32614,3,TheMagistr,2438,30,2,3,5,40.0%,27m
32614,2,KimLaN,2438,30,1,4,5,20.0%,5m
32614,1,WujcioPapcio,2438,0,1,4,5,20.0%,42m
32614,3,winklerrr,2438,30,1,8,9,11.1%,1h
32614,3,texnolog,2438,0,0,2,2,0.0%,29m
32614,3,[Alling]Løki,2438,0,0,3,3,0.0%,31m
32629,3,Electryke,2437,1410,162,143,305,53.1%,12m
32629,1,Shirkan,2437,1380,71,82,153,46.4%,55m
32629,3,[MRRUSH]Dant,2437,426,20,19,39,51.3%,52m
32629,2,wasteland,2437,450,15,18,33,45.5%,10m
32629,3,Alebrant,2437,259,11,9,20,55.0%,52m
32629,1,Kaotiques,2437,284,8,5,13,61.5%,4m
32629,1,raa,2437,334,8,9,17,47.1%,36m
32629,3,DoReMe,2437,253,8,10,18,44.4%,9m
32629,3,DELOG,2437,30,3,7,10,30.0%,12m
32629,2,Azov,2437,104,3,11,14,21.4%,27m
32629,1,ShadoW,2437,0,1,0,1,100.0%,53m
32629,2,upakowka,2437,90,1,1,2,50.0%,42m
32629,3,SuPSHaMaN,2437,30,1,4,5,20.0%,1h
32629,1,Roth,2437,0,1,5,6,16.7%,48m
32629,1,[EpicSr]Lisiqmetodis,2437,0,0,1,1,0.0%,42m
32629,3,cristiduh,2437,0,0,1,1,0.0%,1h
32645,2,Bomg,2436,729,39,38,77,50.6%,58m
32645,3,[BOTSI]MiTysy,2436,825,37,25,62,59.7%,35m
32645,1,Thanatos,2436,1088,37,25,62,59.7%,1h
32645,3,LeGedeon,2436,501,20,13,33,60.6%,12m
32645,2,Baron,2436,350,18,23,41,43.9%,41m
32645,3,Besserer,2436,476,17,20,37,45.9%,45m
32645,3,NighTy,2436,268,10,12,22,45.5%,27m
32645,2,Master,2436,270,10,15,25,40.0%,31m
32645,2,[SNMRTZ]Covid,2436,220,8,7,15,53.3%,5m
32645,2,fish,2436,126,6,13,19,31.6%,25m
32645,2,Chipset,2436,127,4,7,11,36.4%,53m
32645,2,Malzahar,2436,58,4,7,11,36.4%,40m
32645,1,Tazz,2436,145,3,6,9,33.3%,30m
32645,3,icewarrior,2436,58,2,4,6,33.3%,35m
32645,1,[GTG]jokfil,2436,0,1,0,1,100.0%,43m
32645,1,MrdamTiPandu,2436,0,1,4,5,20.0%,40m
32645,1,SinAngelo,2436,0,1,4,5,20.0%,29m
32645,1,[ZeRgg]Arseniy,2436,0,1,5,6,16.7%,38m
32645,3,Raspova,2436,30,1,7,8,12.5%,29m
32645,1,bubblegumYAY,2436,0,0,1,1,0.0%,52m
32645,3,Atrivix,2436,0,0,2,2,0.0%,50m
32645,1,Scandal,2436,0,0,3,3,0.0%,49m
32667,2,Shell,2435,1261,56,57,113,49.6%,33m
32667,3,[CubRub]Gymnopedie,2435,848,38,28,66,57.6%,57m
32667,3,[proto3]shrek,2435,256,9,6,15,60.0%,37m
32667,3,MauZZeR,2435,160,7,9,16,43.8%,40m
32667,2,Madrin,2435,196,5,10,15,33.3%,58m
32667,2,[123212]кирилл,2435,60,4,9,13,30.8%,31m
32667,1,knarkor,2435,132,4,12,16,25.0%,59m
32667,1,[Arenot]ГейБой,2435,132,3,1,4,75.0%,11m
32667,2,Obliteration,2435,122,3,2,5,60.0%,46m
32667,1,GROMLIGHT,2435,0,1,0,1,100.0%,1h
32667,1,[31Baka]Silver,2435,0,1,3,4,25.0%,11m
32667,1,Jamboo,2435,0,1,4,5,20.0%,11m
32667,3,SkeletonCrew,2435,0,0,4,4,0.0%,34m
32680,2,effeM,2434,390,20,28,48,41.7%,1h
32680,1,Imperator,2434,604,18,30,48,37.5%,34m
32680,2,blademaster,2434,504,17,26,43,39.5%,5m
32680,3,Loyolo,2434,114,4,5,9,44.4%,52m
32680,2,Nezuko,2434,91,2,2,4,50.0%,10m
32680,3,boun,2434,0,2,4,6,33.3%,28m
32680,1,Heater,2434,0,1,4,5,20.0%,5m
32680,1,SebastianeK,2434,0,1,4,5,20.0%,1h
32680,3,LevaK,2434,0,1,6,7,14.3%,31m
32680,1,Dzioboł,2434,0,0,1,1,0.0%,49m
32680,2,[SWINE]Sairy,2434,0,0,5,5,0.0%,52m
32691,1,[VEGGYY]VUICelery,2433,1556,230,229,459,50.1%,60m
32691,3,Che,2433,1437,60,56,116,51.7%,3m
32691,3,UGO,2433,883,33,30,63,52.4%,1h
32691,2,Syn,2433,806,33,31,64,51.6%,40m
32691,2,[Pako]KillDaFrog,2433,682,27,52,79,34.2%,13m
32691,1,Mors,2433,630,22,20,42,52.4%,11m
32691,3,Aotling,2433,558,20,24,44,45.5%,24m
32691,3,ghoshuuu,2433,458,17,17,34,50.0%,38m
32691,2,Danahad,2433,114,14,14,28,50.0%,24m
32691,3,KenVate,2433,328,13,6,19,68.4%,40m
32691,3,ProWilku,2433,150,5,9,14,35.7%,34m
32691,1,Leon,2433,116,3,1,4,75.0%,38m
32691,2,Laaba,2433,0,3,7,10,30.0%,40m
32691,1,[qip]ISwGIiImixI,2433,0,1,0,1,100.0%,50m
32691,1,BobenX,2433,0,1,0,1,100.0%,33m
32691,3,Den,2433,30,1,3,4,25.0%,12m
32691,1,[mfxed]DzikaPralka,2433,0,1,4,5,20.0%,1h
32691,1,Искрозад,2433,0,1,4,5,20.0%,5m
32691,1,Prigorella,2433,48,1,5,6,16.7%,44m
32710,2,zurlaz,2432,1319,133,134,267,49.8%,1h
32710,3,RastaMan,2432,1541,110,92,202,54.5%,1h
32710,2,Dav,2432,135,38,31,69,55.1%,56m
32710,2,[BNCREW]Civa,2432,929,38,41,79,48.1%,53m
32710,3,ChriKre,2432,555,22,26,48,45.8%,35m
32710,2,Bobriguez,2432,668,22,27,49,44.9%,26m
32710,3,McDowell,2432,548,20,22,42,47.6%,38m
32710,3,Maks,2432,520,16,33,49,32.7%,15m
32710,2,Tukaram,2432,345,12,17,29,41.4%,11m
32710,3,Firesrest,2432,311,10,9,19,52.6%,50m
32710,2,Артемида,2432,275,9,6,15,60.0%,9m
32710,2,Angel,2432,302,9,15,24,37.5%,26m
32710,1,[bree]Romana,2432,189,6,5,11,54.5%,57m
32710,1,AyeBrotha,2432,229,6,6,12,50.0%,39m
32710,3,darkphoenix,2432,114,6,8,14,42.9%,7m
32710,2,Vindedious,2432,140,6,11,17,35.3%,58m
32710,1,Даниил,2432,48,4,4,8,50.0%,50m
32710,3,Hydroix,2432,97,3,4,7,42.9%,38m
32710,1,Gurrinho,2432,145,3,5,8,37.5%,56m
32710,1,Terminus,2432,97,2,4,6,33.3%,50m
32710,1,JeffMills,2432,0,1,0,1,100.0%,6m
32710,3,[BN44]nieux,2432,30,1,7,8,12.5%,3m
32710,2,TanksHuman,2432,0,0,4,4,0.0%,5m
32733,3,EnchanterIO,2431,601,41,43,84,48.8%,1h
32733,2,[CОS]zaurs,2431,154,27,26,53,50.9%,1h
32733,3,PinkyPanda,2431,545,23,22,45,51.1%,37m
32733,1,[NFA]Romby,2431,303,12,14,26,46.2%,38m
32733,1,BoJack,2431,256,9,7,16,56.2%,52m
32733,1,[УТочка]тенешторм,2431,274,9,7,16,56.2%,44m
32733,2,Caedere,2431,193,6,4,10,60.0%,3m
32733,3,victor,2431,198,6,4,10,60.0%,38m
32733,2,RAILGUN,2431,239,6,5,11,54.5%,38m
32733,3,mik,2431,166,6,9,15,40.0%,52m
32733,1,[BarKin]Misha,2431,0,2,3,5,40.0%,10m
32733,3,Legion,2431,0,2,4,6,33.3%,28m
32733,1,Void,2431,48,2,6,8,25.0%,1h
32733,1,Überninja,2431,0,1,0,1,100.0%,41m
32733,3,StabbursNiss,2431,0,1,1,2,50.0%,53m
32733,1,DmitriusVII,2431,0,0,1,1,0.0%,1h
32733,1,SannyKrocket,2431,0,0,2,2,0.0%,48m
32733,3,Darkshadow,2431,0,0,2,2,0.0%,52m
32733,3,[TSC2C]comer,2431,0,0,4,4,0.0%,42m
32752,2,Dariuz,2430,1526,113,114,227,49.8%,32m
32752,3,Krapiva,2430,1192,105,88,193,54.4%,40m
32752,3,greenglow,2430,1090,42,44,86,48.8%,5m
32752,1,[NlGE]BobRoss,2430,742,33,20,53,62.3%,1h
32752,3,Uvex,2430,464,18,13,31,58.1%,51m
32752,1,Ash,2430,289,12,5,17,70.6%,1h
32752,2,Gneus,2430,331,11,2,13,84.6%,33m
32752,3,Harangar,2430,241,11,14,25,44.0%,24m
32752,3,JagHasie,2430,207,8,13,21,38.1%,8m
32752,3,longslim,2430,231,7,6,13,53.8%,27m
32752,2,Shtirlitz,2430,141,5,8,13,38.5%,2m
32752,1,[n3wb13]SpookyFoxPL,2430,172,4,2,6,66.7%,1h
32752,1,Stuffy,2430,153,4,7,11,36.4%,56m
32752,3,Sasthis,2430,0,2,5,7,28.6%,5m
32752,2,[heXnab]Thuson,2430,0,2,5,7,28.6%,8m
32752,3,dachris,2430,0,1,2,3,33.3%,24m
32752,1,Visteron,2430,0,1,3,4,25.0%,1h
32752,1,Lyudmiliks,2430,0,1,4,5,20.0%,42m
32752,1,Andromeda,2430,0,1,4,5,20.0%,35m
32752,3,Atrox,2430,0,1,5,6,16.7%,37m
32752,1,Agrozel,2430,0,0,1,1,0.0%,10m
32773,3,Deckard,2429,1006,41,45,86,47.7%,3m
32773,3,BrinG,2429,746,30,27,57,52.6%,34m
32773,1,rki,2429,603,22,34,56,39.3%,1h
32773,3,BigDaddy,2429,316,19,17,36,52.8%,50m
32773,3,ssssergeyyyy,2429,499,18,16,34,52.9%,1h
32773,1,ElRolfo,2429,502,14,7,21,66.7%,41m
32773,3,MejLaPoutre,2429,301,11,8,19,57.9%,1h
32773,1,KayanaSule,2429,73,4,4,8,50.0%,10m
32773,3,foxtrot,2429,117,3,1,4,75.0%,3m
32773,1,cwZerro,2429,97,2,1,3,66.7%,1h
32773,3,[InitRu]gacar,2429,66,2,4,6,33.3%,1h
32773,1,dimonpokemon,2429,0,1,0,1,100.0%,50m
32773,1,hart,2429,0,1,4,5,20.0%,33m
32773,3,[LifeAD]DRACOZ,2429,30,1,5,6,16.7%,50m
32773,1,MvpMatty,2429,0,0,1,1,0.0%,60m
32788,2,Mongo,2428,1169,45,45,90,50.0%,37m
32788,2,[8mylez]Suuni,2428,888,36,33,69,52.2%,53m
32788,3,roger,2428,757,28,29,57,49.1%,32m
32788,1,LokiGang,2428,726,21,13,34,61.8%,51m
32788,2,[EESC]ViDi,2428,510,18,27,45,40.0%,32m
32788,2,[BrassZ]Coli,2428,250,9,11,20,45.0%,26m
32788,3,Crowy,2428,199,9,13,22,40.9%,1h
32788,2,crazylass,2428,120,7,11,18,38.9%,58m
32788,2,conquisitor,2428,209,6,7,13,46.2%,11m
32788,3,ГрАл,2428,166,6,9,15,40.0%,10m
32788,2,AlexandrSt,2428,135,3,5,8,37.5%,50m
32788,1,Airwipe,2428,94,2,1,3,66.7%,36m
32788,1,drakeMUFFIN,2428,73,2,6,8,25.0%,11m
32788,1,Бетрезен,2428,0,1,0,1,100.0%,9m
32788,1,[4Cap]CptBoroda,2428,0,1,0,1,100.0%,46m
32788,1,[Drunk9]PoppyTheBoss,2428,0,1,0,1,100.0%,43m
32788,1,GeekisImba,2428,0,1,4,5,20.0%,40m
32788,1,Vedex,2428,0,0,1,1,0.0%,50m
32788,1,SuHuitSixDR,2428,0,0,1,1,0.0%,1h
32788,3,Viktorr,2428,0,0,1,1,0.0%,1h
32788,1,Dmitry,2428,0,0,1,1,0.0%,30m
32788,1,Misha,2428,0,0,1,1,0.0%,39m
32788,3,[GfG]Bilbo,2428,0,0,2,2,0.0%,42m
32811,2,Ozymandias,2427,1537,136,128,264,51.5%,1h
32811,2,SDS,2427,1215,129,127,256,50.4%,56m
32811,1,brahamnp,2427,1136,114,114,228,50.0%,11m
32811,3,Deathknight,2427,1089,68,57,125,54.4%,39m
32811,3,DonKKosa,2427,1282,57,46,103,55.3%,1h
32811,3,banana,2427,1356,57,49,106,53.8%,1h
32811,3,[ANREN]КаменщикЖора,2427,776,33,24,57,57.9%,42m
32811,3,[JaPP]Notorious,2427,878,32,31,63,50.8%,52m
32811,3,Inquisitor,2427,361,27,24,51,52.9%,24m
32811,1,BlokkerMC,2427,658,23,35,58,39.7%,8m
32811,2,nikew,2427,255,9,13,22,40.9%,40m
32811,2,NotgoodNotme,2427,238,8,11,19,42.1%,37m
32811,2,Bungalowbul,2427,143,4,4,8,50.0%,36m
32811,2,Murlocninja,2427,30,3,6,9,33.3%,49m
32811,1,wysupreme,2427,0,1,0,1,100.0%,60m
32811,3,[MUTAL]kosik,2427,93,1,2,3,33.3%,56m
32811,3,iNasty,2427,0,1,3,4,25.0%,34m
32811,1,QeenNayeon,2427,46,1,5,6,16.7%,36m
32811,1,Zoroten,2427,97,1,5,6,16.7%,48m
32830,2,EvenLonger,2426,621,92,70,162,56.8%,26m
32830,3,bigstarnik,2426,1034,42,41,83,50.6%,4m
32830,3,Toor,2426,340,33,37,70,47.1%,29m
32830,2,vTScar,2426,698,29,34,63,46.0%,46m
32830,3,FrankCZ,2426,580,22,26,48,45.8%,27m
32830,1,Master,2426,434,16,18,34,47.1%,1h
32830,3,XxRaimoxX,2426,434,16,22,38,42.1%,32m
32830,3,mainHASAGA,2426,388,14,15,29,48.3%,12m
32830,3,brdlesspsych,2426,225,13,15,28,46.4%,1h
32830,3,ZERO,2426,221,7,9,16,43.8%,58m
32830,3,VladTepes,2426,173,6,6,12,50.0%,40m
32830,2,Snake,2426,227,6,7,13,46.2%,1h
32830,3,Halo,2426,140,6,10,16,37.5%,50m
32830,2,Didou,2426,190,6,17,23,26.1%,48m
32830,3,Glaz,2426,184,5,3,8,62.5%,57m
32830,1,Occupant,2426,0,3,4,7,42.9%,25m
32830,1,GosuAppa,2426,97,3,5,8,37.5%,60m
32830,1,Glaros,2426,96,2,6,8,25.0%,25m
32830,2,esqesqq,2426,0,1,1,2,50.0%,1h
32830,1,Tobba,2426,44,1,5,6,16.7%,54m
32830,1,[2RVLV]Rambo,2426,0,0,1,1,0.0%,44m
32830,1,[MSQ]Dudule,2426,0,0,1,1,0.0%,1h
32830,1,gouzzy,2426,0,0,1,1,0.0%,1h
32830,3,kamikaze,2426,0,0,2,2,0.0%,24m
32854,1,[RoXY]Zarko,2425,1876,113,117,230,49.1%,1h
32854,2,Jesus,2425,1334,111,101,212,52.4%,1h
32854,3,Bettlejuice,2425,1498,99,81,180,55.0%,31m
32854,3,Jeffrey,2425,622,28,19,47,59.6%,27m
32854,3,SvelteSloth,2425,209,15,5,20,75.0%,1h
32854,3,VartV,2425,381,12,13,25,48.0%,38m
32854,3,прк,2425,292,11,5,16,68.8%,10m
32854,1,SAMURAIVAAJA,2425,402,11,5,16,68.8%,53m
32854,3,NONAME,2425,136,4,1,5,80.0%,60m
32854,1,PatchPig,2425,187,4,6,10,40.0%,48m
32854,3,максим,2425,30,3,3,6,50.0%,11m
32854,3,Angrywolf,2425,60,2,4,6,33.3%,11m
32854,2,Fryan,2425,88,2,6,8,25.0%,56m
32854,3,[ŁBD]Outlander,2425,95,1,2,3,33.3%,50m
32854,1,[Colony]MacGyver,2425,0,0,1,1,0.0%,1h
32854,1,[illGG]tirdent,2425,0,0,1,1,0.0%,1h
32870,3,[LifeTV]NOOB,2424,639,261,266,527,49.5%,2m
32870,3,Hannez,2424,991,50,41,91,54.9%,38m
32870,1,[PiGPan]tImMo,2424,1064,46,58,104,44.2%,3m
32870,3,ALEXANDRO,2424,1188,45,48,93,48.4%,40m
32870,3,[AKAMAT]ReiZulu,2424,1132,39,59,98,39.8%,4m
32870,3,Xenomorph,2424,993,38,34,72,52.8%,52m
32870,1,IBU,2424,1020,32,27,59,54.2%,7m
32870,2,CliffSmoker,2424,837,32,33,65,49.2%,38m
32870,3,overdrive,2424,200,17,16,33,51.5%,1h
32870,3,Panzerbaer,2424,346,12,16,28,42.9%,9m
32870,3,Nenerial,2424,295,11,8,19,57.9%,31m
32870,3,pringle,2424,270,8,10,18,44.4%,45m
32870,1,[WAAR]MVALordSethi,2424,169,4,0,4,100.0%,44m
32870,1,Crowdstrike,2424,97,3,1,4,75.0%,48m
32870,1,Wiseguy,2424,44,3,4,7,42.9%,8m
32870,2,DaviD,2424,40,2,1,3,66.7%,1h
32870,1,Greza,2424,97,2,5,7,28.6%,35m
32870,3,TMP,2424,32,1,1,2,50.0%,59m
32870,3,Georgerush,2424,30,1,4,5,20.0%,45m
32889,2,Hyakutake,2423,928,33,38,71,46.5%,59m
32889,1,[play45]IIIIIIIIIIII,2423,664,24,31,55,43.6%,9m
32889,3,Zinloos,2423,417,20,5,25,80.0%,12m
32889,3,Griftarr,2423,453,18,14,32,56.2%,1h
32889,3,[Lab14]Rares,2423,215,8,5,13,61.5%,37m
32889,2,FewFew,2423,195,6,8,14,42.9%,53m
32889,1,Víctor,2423,136,4,3,7,57.1%,1h
32889,3,Amon,2423,163,4,5,9,44.4%,1h
32889,3,Nagash,2423,60,3,3,6,50.0%,28m
32889,1,[турнир]рейнор,2423,44,2,0,2,100.0%,42m
32889,3,slayer,2423,32,2,1,3,66.7%,57m
32889,3,SalntDeVll,2423,58,2,4,6,33.3%,44m
32889,1,Topaz,2423,42,2,5,7,28.6%,1h
32889,3,Jowkasta,2423,0,1,0,1,100.0%,1h
32889,3,GingerLightn,2423,0,1,5,6,16.7%,31m
32904,3,dimaavp,2422,1547,71,62,133,53.4%,45m
32904,3,Zeratsio,2422,831,31,29,60,51.7%,36m
32904,3,ELKAPO,2422,487,21,19,40,52.5%,1h
32904,3,[Blini]Lamp,2422,485,19,19,38,50.0%,31m
32904,3,Tomé,2422,341,14,10,24,58.3%,40m
32904,3,[Star57]Сольпуга,2422,186,12,6,18,66.7%,3m
32904,1,Lucky,2422,284,10,1,11,90.9%,36m
32904,2,Tokipok,2422,160,5,13,18,27.8%,42m
32904,1,QUASIBIER,2422,132,4,2,6,66.7%,1h
32904,1,[IZRSI]Samael,2422,44,2,0,2,100.0%,1h
32904,1,Wega,2422,0,2,3,5,40.0%,45m
32904,1,Нубасик,2422,97,2,3,5,40.0%,1h
32904,1,fyuzZ,2422,48,2,5,7,28.6%,54m
32904,1,Michael,2422,0,1,4,5,20.0%,43m
32904,1,[Lansky]Yarchelo,2422,0,0,1,1,0.0%,1h
32904,3,TANKist,2422,0,0,1,1,0.0%,38m
32920,3,NORA,2421,1523,75,67,142,52.8%,52m
32920,2,Zel,2421,1381,72,74,146,49.3%,1h
32920,3,Gigglingbug,2421,1503,65,57,122,53.3%,46m
32920,3,Salo,2421,977,40,36,76,52.6%,50m
32920,3,[VCa]Klin,2421,955,36,34,70,51.4%,12m
32920,2,[Rakia]MindStorm,2421,276,25,23,48,52.1%,37m
32920,2,Foxy,2421,610,22,26,48,45.8%,42m
32920,3,DomSniperX,2421,365,16,10,26,61.5%,7m
32920,2,mialinx,2421,460,15,24,39,38.5%,1h
32920,3,Pashtet,2421,317,12,6,18,66.7%,1h
32920,3,Aereasup,2421,316,12,15,27,44.4%,4m
32920,3,Slepoy,2421,296,11,15,26,42.3%,3m
32920,3,Pecius,2421,122,9,8,17,52.9%,40m
32920,1,NoAimNP,2421,192,8,12,20,40.0%,8m
32920,2,Shoggy,2421,190,6,6,12,50.0%,36m
32920,1,ady,2421,172,5,9,14,35.7%,1h
32920,2,LivingThing,2421,130,4,7,11,36.4%,5m
32920,3,Nexeos,2421,30,3,6,9,33.3%,34m
32920,3,[972]MALACHI,2421,97,3,6,9,33.3%,58m
32920,2,Sidomir,2421,140,3,6,9,33.3%,1h
32920,2,Killhimslow,2421,30,3,6,9,33.3%,37m
32920,2,Clemempereur,2421,129,2,4,6,33.3%,1h
32920,1,Bab,2421,0,2,5,7,28.6%,50m
32920,1,Jugien,2421,94,2,6,8,25.0%,2m
32920,1,[SprStu]CrAZý,2421,0,2,7,9,22.2%,40m
32920,1,[ISCS]KeineAhnung,2421,0,1,1,2,50.0%,12m
32920,1,[VVA]Amalah,2421,44,1,2,3,33.3%,5m
32920,1,Mythicnoob,2421,0,1,4,5,20.0%,36m
32920,2,Gravitation,2421,0,1,6,7,14.3%,58m
32920,1,VooDoo,2421,0,0,1,1,0.0%,50m
32920,1,skyh,2421,0,0,1,1,0.0%,34m
32920,1,lbvf,2421,0,0,1,1,0.0%,52m
32920,3,[GELG]DerNxGPlayer,2421,0,0,3,3,0.0%,8m
32920,1,ИЛЛИДАН,2421,73,0,3,3,0.0%,36m
32954,2,FAfullV,2420,612,26,26,52,50.0%,24m
32954,3,Bottle,2420,466,18,14,32,56.2%,2m
32954,2,killakat,2420,382,14,17,31,45.2%,10m
32954,2,[ICCT]витя,2420,302,12,13,25,48.0%,1h
32954,1,marateyka,2420,365,10,6,16,62.5%,36m
32954,2,[FR1]arthuro,2420,232,7,10,17,41.2%,11m
32954,1,PieseuTigris,2420,214,5,4,9,55.6%,1h
32954,1,Arna,2420,193,3,3,6,50.0%,40m
32954,1,ggg,2420,46,2,2,4,50.0%,43m
32954,3,contradanil,2420,30,2,2,4,50.0%,44m
32954,3,Bulbasaurus,2420,30,2,3,5,40.0%,43m
32954,1,android,2420,0,1,0,1,100.0%,57m
32954,1,musBalance,2420,44,1,2,3,33.3%,1h
32954,1,[PLST]Rabibrack,2420,0,1,4,5,20.0%,10m
32954,1,lazyturtle,2420,0,1,4,5,20.0%,59m
32954,3,Tyran,2420,0,0,2,2,0.0%,40m
32954,3,veko,2420,0,0,3,3,0.0%,1h
32971,2,Becky,2419,858,55,67,122,45.1%,1h
32971,2,BlackTiger,2419,1104,48,40,88,54.5%,58m
32971,1,SymphoManiac,2419,823,26,38,64,40.6%,1h
32971,2,serdjo,2419,496,20,22,42,47.6%,4m
32971,3,Netnika,2419,434,18,14,32,56.2%,52m
32971,2,RaZzYer,2419,295,9,15,24,37.5%,4m
32971,3,Vertrag,2419,146,5,8,13,38.5%,24m
32971,1,Fogsan,2419,128,5,8,13,38.5%,25m
32971,3,Enigma,2419,141,4,2,6,66.7%,43m
32971,1,Baphomet,2419,122,4,5,9,44.4%,43m
32971,1,ErdnandHolz,2419,157,3,3,6,50.0%,43m
32971,1,[RMIUC]Fali,2419,0,1,0,1,100.0%,52m
32971,1,davistoron,2419,0,1,4,5,20.0%,50m
32971,1,BadWolf,2419,0,1,4,5,20.0%,4m
32971,1,[PFLM1N]VIT,2419,0,0,5,5,0.0%,1h
32986,3,MoviePruce,2418,476,46,42,88,52.3%,43m
32986,3,kiko,2418,633,23,23,46,50.0%,46m
32986,1,Hamekas,2418,392,20,15,35,57.1%,8m
32986,3,DrakeDog,2418,224,18,18,36,50.0%,40m
32986,2,sHeeKa,2418,360,12,14,26,46.2%,1h
32986,2,nedomerok,2418,224,10,11,21,47.6%,7m
32986,1,Tarvanis,2418,205,5,6,11,45.5%,55m
32986,2,Pete,2418,158,5,12,17,29.4%,12m
32986,3,MysteryRo,2418,78,4,10,14,28.6%,34m
32986,1,BenDover,2418,78,3,2,5,60.0%,41m
32986,3,swole,2418,0,3,3,6,50.0%,46m
32986,3,venicereturn,2418,60,3,4,7,42.9%,36m
32986,3,Bigplay,2418,0,2,5,7,28.6%,42m
32986,3,Razor,2418,58,2,7,9,22.2%,32m
32986,3,[RusGay]MaminStrateh,2418,0,1,0,1,100.0%,9m
32986,1,DZIOBAK,2418,0,1,0,1,100.0%,60m
32986,1,WhiteTiger,2418,44,1,2,3,33.3%,4m
32986,3,VelociRaptor,2418,0,1,3,4,25.0%,32m
32986,1,Maxwelll,2418,0,1,4,5,20.0%,60m
32986,1,[µEoG]Defs,2418,0,0,1,1,0.0%,44m
32986,3,Tomi,2418,0,0,3,3,0.0%,12m
33007,2,[DArmy]Warmonkey,2417,807,91,77,168,54.2%,39m
33007,3,mnsov,2417,1449,73,73,146,50.0%,40m
33007,3,Borber,2417,1253,69,54,123,56.1%,57m
33007,2,EasyBoy,2417,1467,68,67,135,50.4%,40m
33007,3,Khazmodan,2417,745,40,26,66,60.6%,11m
33007,1,CoKoJI,2417,1252,39,32,71,54.9%,29m
33007,2,artisdent,2417,1030,38,46,84,45.2%,32m
33007,3,Лирой,2417,506,19,21,40,47.5%,27m
33007,1,Beaver,2417,235,9,9,18,50.0%,41m
33007,3,Dvillar,2417,171,6,8,14,42.9%,1h
33007,1,ShredDude,2417,179,5,8,13,38.5%,54m
33007,3,mingnjjue,2417,60,3,4,7,42.9%,29m
33007,3,[666999]УХО,2417,92,3,6,9,33.3%,12m
33007,1,Snow,2417,38,2,4,6,33.3%,44m
33007,1,GLICIRIN,2417,0,1,4,5,20.0%,41m
33007,1,CRuser,2417,0,0,1,1,0.0%,46m
33007,1,inly,2417,0,0,1,1,0.0%,50m
33007,1,Lait,2417,0,0,1,1,0.0%,44m
33007,1,[MinP]Thomas,2417,0,0,1,1,0.0%,47m
33007,1,ТоПчИп,2417,0,0,1,1,0.0%,52m
33027,3,CrazyCat,2416,1384,94,78,172,54.7%,1h
33027,3,Barsfoxteam,2416,1373,82,80,162,50.6%,31m
33027,3,[s0rry]Ilya,2416,1563,74,66,140,52.9%,1h
33027,2,Gandalfchris,2416,704,26,35,61,42.6%,35m
33027,3,Raistlin,2416,429,24,30,54,44.4%,52m
33027,3,[BM3]BARRACUDAS,2416,392,14,17,31,45.2%,43m
33027,3,Yoda,2416,256,9,12,21,42.9%,43m
33027,2,hallonspelar,2416,120,6,10,16,37.5%,37m
33027,1,Jouelvago,2416,214,5,5,10,50.0%,50m
33027,3,HolyVomit,2416,58,3,4,7,42.9%,1h
33027,3,Rykk,2416,117,3,5,8,37.5%,29m
33027,1,Nightmare,2416,42,2,4,6,33.3%,11m
33027,1,Lynar,2416,0,2,5,7,28.6%,40m
33027,1,InSanguinum,2416,0,1,0,1,100.0%,41m
33027,1,TRoN,2416,0,1,0,1,100.0%,54m
33027,1,[Gawain]Odin,2416,97,1,1,2,50.0%,11m
33027,3,vesel,2416,30,1,4,5,20.0%,42m
33027,1,mellonSan,2416,0,0,1,1,0.0%,33m
33027,1,TobikGG,2416,0,0,1,1,0.0%,47m
33027,1,Mick,2416,0,0,2,2,0.0%,1h
33027,3,Bifford,2416,0,0,3,3,0.0%,1h
33048,3,TootTootDude,2415,1374,61,54,115,53.0%,57m
33048,3,Polizhen,2415,1268,54,43,97,55.7%,27m
33048,3,HONZA,2415,1028,42,37,79,53.2%,45m
33048,3,Sclirs,2415,881,33,37,70,47.1%,26m
33048,1,CArTON,2415,567,18,6,24,75.0%,6m
33048,3,[DAHUS]Jerem,2415,303,11,10,21,52.4%,49m
33048,1,Abaroch,2415,316,8,20,28,28.6%,49m
33048,1,asper,2415,191,6,12,18,33.3%,40m
33048,1,CkviLL,2415,220,5,6,11,45.5%,40m
33048,3,meepmeep,2415,88,4,5,9,44.4%,44m
33048,1,KingKarma,2415,0,3,2,5,60.0%,39m
33048,3,LOBODEMAR,2415,58,3,6,9,33.3%,49m
33048,1,[0MGz]pandocha,2415,44,2,2,4,50.0%,53m
33048,2,AnthoninoW,2415,0,2,5,7,28.6%,1h
33048,1,[PGZ]Gosufighter,2415,0,1,0,1,100.0%,1h
33048,1,Goose,2415,0,1,4,5,20.0%,60m
33048,1,sdOrange,2415,0,0,1,1,0.0%,44m
33048,3,Feedme,2415,0,0,2,2,0.0%,37m
33048,1,armag,2415,0,0,2,2,0.0%,1h
33067,3,TallChalk,2414,1554,72,65,137,52.6%,1h
33067,3,Dioboli,2414,1027,53,48,101,52.5%,1h
33067,3,Ultraworg,2414,682,36,27,63,57.1%,36m
33067,1,Alvar,2414,526,35,48,83,42.2%,30m
33067,3,heyzuez,2414,739,29,30,59,49.2%,42m
33067,3,[IBSC]oTTbakoyma,2414,557,25,21,46,54.3%,38m
33067,3,BACOON,2414,472,21,24,45,46.7%,4m
33067,1,ehehrawr,2414,590,20,8,28,71.4%,39m
33067,3,[SchamR]daGriech,2414,478,20,13,33,60.6%,45m
33067,3,[PsF]Gery,2414,305,17,20,37,45.9%,10m
33067,1,Mozzarella,2414,382,11,12,23,47.8%,29m
33067,3,[GdAT]Disaster,2414,314,11,14,25,44.0%,43m
33067,3,nasum,2414,198,7,14,21,33.3%,52m
33067,3,astana,2414,196,6,6,12,50.0%,33m
33067,3,[O4FUN]ZŁO,2414,180,6,8,14,42.9%,38m
33067,1,[BULETX]BlackFlag,2414,173,5,8,13,38.5%,56m
33067,3,[PSSC]Crow,2414,118,4,6,10,40.0%,45m
33067,1,OIOIIOOI,2414,0,3,2,5,60.0%,46m
33067,1,щщшш,2414,48,3,2,5,60.0%,1h
33067,1,xdestinyx,2414,48,2,6,8,25.0%,40m
33067,1,DEBGAME,2414,0,1,4,5,20.0%,1h
33067,1,MineTycon,2414,0,1,4,5,20.0%,11m
33067,3,Limon,2414,0,1,5,6,16.7%,12m
33067,1,MatdYs,2414,0,0,1,1,0.0%,4m
33067,1,Czternacsie,2414,0,0,2,2,0.0%,1h
33067,1,NameNew,2414,0,0,3,3,0.0%,54m
33093,3,Breaker,2413,1279,104,98,202,51.5%,56m
33093,2,BorisBritva,2413,1230,100,103,203,49.3%,54m
33093,2,[xFRSx]Mike,2413,1310,99,104,203,48.8%,56m
33093,3,Marduk,2413,1580,96,87,183,52.5%,1h
33093,1,JimmyMcGood,2413,1703,75,69,144,52.1%,1h
33093,3,Perets,2413,579,26,21,47,55.3%,37m
33093,3,SEGA,2413,533,21,23,44,47.7%,28m
33093,3,Maanesyume,2413,483,20,16,36,55.6%,58m
33093,3,[сюда]ARMAPIZDA,2413,289,13,13,26,50.0%,35m
33093,3,Sultanius,2413,246,10,8,18,55.6%,47m
33093,2,victhaur,2413,321,10,16,26,38.5%,41m
33093,1,gidelon,2413,322,8,9,17,47.1%,48m
33093,1,IlluvataR,2413,169,5,2,7,71.4%,56m
33093,3,rickjames,2413,142,4,2,6,66.7%,54m
33093,1,[1s1]ToolTimr,2413,166,4,2,6,66.7%,1h
33093,1,[JfH]Forstgeneral,2413,176,4,3,7,57.1%,9m
33093,1,Maurits,2413,0,2,4,6,33.3%,54m
33093,2,sayand,2413,42,2,5,7,28.6%,1h
33093,3,Unstoppable,2413,62,2,6,8,25.0%,1h
33093,1,MrMem,2413,0,2,6,8,25.0%,35m
33093,1,ScrappyCoco,2413,44,1,2,3,33.3%,27m
33093,1,Beetz,2413,0,1,4,5,20.0%,1h
33093,1,Mamua,2413,0,1,4,5,20.0%,5m
33093,1,GVanT,2413,0,1,4,5,20.0%,36m
33093,3,Ostmann,2413,0,0,1,1,0.0%,60m
33093,3,Umka,2413,0,0,3,3,0.0%,3m
33119,1,Reynor,2412,1599,362,365,727,49.8%,52m
33119,1,SushiAddict,2412,592,47,45,92,51.1%,51m
33119,3,Nomak,2412,158,9,12,21,42.9%,11m
33119,1,[TRVMP]dobispr,2412,374,9,14,23,39.1%,48m
33119,3,Melky,2412,240,9,14,23,39.1%,52m
33119,2,Sev,2412,191,7,11,18,38.9%,1h
33119,2,[GGLose]Separatists,2412,288,7,14,21,33.3%,43m
33119,3,Salarida,2412,172,6,8,14,42.9%,1h
33119,1,PanRudzik,2412,0,3,2,5,60.0%,46m
33119,3,sanandi,2412,58,3,3,6,50.0%,1h
33119,1,QueenOfCreep,2412,130,3,4,7,42.9%,30m
33119,1,Jluna,2412,0,2,5,7,28.6%,32m
33119,3,Tomato,2412,97,2,6,8,25.0%,58m
33119,3,Blitzkrieg,2412,0,1,1,2,50.0%,1h
33119,1,IFreshP,2412,44,1,1,2,50.0%,48m
33119,1,delovoy,2412,48,1,2,3,33.3%,1h
33119,1,MalGenis,2412,0,1,4,5,20.0%,57m
33119,1,Nongrata,2412,0,0,1,1,0.0%,43m
33119,1,[DarKsS]fernandillo,2412,0,0,2,2,0.0%,27m
33119,1,Konstantin,2412,0,0,4,4,0.0%,1h
33139,2,СлаваВеталю,2411,890,85,78,163,52.1%,1h
33139,1,YuriyWeissL,2411,810,34,28,62,54.8%,3m
33139,3,Gans,2411,144,33,23,56,58.9%,43m
33139,3,VoodooDolls,2411,508,30,27,57,52.6%,1h
33139,3,RedRay,2411,762,29,25,54,53.7%,27m
33139,3,[UAŦeam]pacific,2411,461,19,22,41,46.3%,40m
33139,3,Iamaman,2411,474,18,20,38,47.4%,1h
33139,1,Roujizi,2411,500,15,8,23,65.2%,10m
33139,2,niknikitin,2411,384,15,17,32,46.9%,1h
33139,1,Ropliux,2411,351,12,14,26,46.2%,44m
33139,3,[ToQ]Geraldo,2411,216,9,7,16,56.2%,52m
33139,1,[CAI]Careear,2411,336,8,9,17,47.1%,30m
33139,3,КирпиДон,2411,247,7,9,16,43.8%,12m
33139,1,[mfixed]Odlot,2411,172,5,0,5,100.0%,28m
33139,1,Beavis,2411,170,4,2,6,66.7%,57m
33139,1,Sparrow,2411,84,4,4,8,50.0%,47m
33139,1,[PChaos]PonQan,2411,160,4,4,8,50.0%,60m
33139,3,Bezzo,2411,63,3,5,8,37.5%,8m
33139,1,Hatoshin,2411,30,3,9,12,25.0%,1h
33139,3,[HaoS]pggprgprggs,2411,121,2,3,5,40.0%,7m
33139,1,DenBercut,2411,0,2,3,5,40.0%,55m
33139,1,[HARDOS]Tigrou,2411,153,2,5,7,28.6%,39m
33139,1,teo,2411,0,1,0,1,100.0%,51m
33139,1,Katerina,2411,0,1,0,1,100.0%,32m
33139,3,Cydee,2411,0,1,1,2,50.0%,58m
33139,3,Kryd,2411,46,1,1,2,50.0%,52m
33139,1,ManiStar,2411,0,1,4,5,20.0%,53m
33139,1,Nao,2411,0,1,4,5,20.0%,30m
33139,1,tatarsamurai,2411,0,1,4,5,20.0%,1h
33139,1,Limonkova,2411,0,1,4,5,20.0%,1h
33139,1,Laespi,2411,0,1,4,5,20.0%,57m
33139,3,sansam,2411,30,1,5,6,16.7%,44m
33139,1,Chobo,2411,0,0,1,1,0.0%,46m
33139,3,Kloo,2411,0,0,2,2,0.0%,5m
33139,3,Бдышытс,2411,0,0,3,3,0.0%,8m
33174,2,[ANREN]SteLsiK,2410,1483,277,287,564,49.1%,3m
33174,2,[Сold]Маэстро,2410,1600,211,220,431,49.0%,12m
33174,1,stelloxx,2410,697,30,10,40,75.0%,54m
33174,1,Mike,2410,575,21,6,27,77.8%,10m
33174,1,[LuOLa]Psykotik,2410,566,21,16,37,56.8%,1h
33174,2,garlik,2410,538,19,24,43,44.2%,26m
33174,3,Pirks,2410,421,16,15,31,51.6%,39m
33174,1,larrifari,2410,400,11,5,16,68.8%,55m
33174,1,Janke,2410,313,9,17,26,34.6%,9m
33174,3,[RoPRO]shockux,2410,192,8,11,19,42.1%,32m
33174,3,DarkKnight,2410,86,3,6,9,33.3%,51m
33174,1,duh,2410,145,3,6,9,33.3%,38m
33174,1,Perez,2410,48,2,5,7,28.6%,50m
33174,1,Platon,2410,0,1,0,1,100.0%,58m
33174,1,Jodi,2410,0,1,4,5,20.0%,1h
33174,1,SirMarc,2410,0,1,4,5,20.0%,57m
33174,3,Ieael,2410,30,1,5,6,16.7%,9m
33174,1,Kilebor,2410,0,0,1,1,0.0%,1h
33174,3,Patrick,2410,0,0,1,1,0.0%,5m
33174,2,[ÜKBM]ZergPhanTom,2410,0,0,3,3,0.0%,54m
33194,3,HumRapi,2409,1566,116,110,226,51.3%,39m
33194,2,Shadow,2409,428,90,72,162,55.6%,1h
33194,3,spirise,2409,1299,52,49,101,51.5%,1h
33194,3,usALar,2409,1223,44,47,91,48.4%,40m
33194,3,Malman,2409,232,24,23,47,51.1%,11m
33194,3,Lynchjustiz,2409,397,16,16,32,50.0%,32m
33194,1,[НОД17]Прахиндей,2409,414,15,15,30,50.0%,4m
33194,2,LoLKicK,2409,285,12,12,24,50.0%,52m
33194,1,Bespal,2409,296,10,2,12,83.3%,8m
33194,1,Adjutant,2409,213,6,7,13,46.2%,50m
33194,2,[MVDM]GPP,2409,171,5,2,7,71.4%,1h
33194,1,Gorik,2409,134,3,1,4,75.0%,1h
33194,1,conkid,2409,96,3,6,9,33.3%,54m
33194,3,[K1F]FraqFink,2409,119,2,4,6,33.3%,43m
33194,1,[TGCH]Mollycoddle,2409,0,2,6,8,25.0%,40m
33194,1,[Kaiza]Samebi,2409,0,0,1,1,0.0%,11m
33194,1,Ergotizm,2409,0,0,2,2,0.0%,29m
33211,3,stylewalker,2408,769,31,27,58,53.4%,1h
33211,1,Ego,2408,660,22,22,44,50.0%,39m
33211,3,Lightrend,2408,544,21,23,44,47.7%,1h
33211,1,Rainy,2408,306,14,10,24,58.3%,58m
33211,2,trent,2408,240,8,16,24,33.3%,1h
33211,1,ПапаКарло,2408,157,4,1,5,80.0%,28m
33211,3,anders,2408,160,4,3,7,57.1%,49m
33211,1,шумахер,2408,156,3,4,7,42.9%,50m
33211,3,Afroed,2408,62,3,7,10,30.0%,1h
33211,3,Uder,2408,94,3,8,11,27.3%,1h
33211,1,mert,2408,107,2,1,3,66.7%,35m
33211,1,DarkAssassin,2408,82,2,2,4,50.0%,8m
33211,3,ColonelPhil,2408,58,2,6,8,25.0%,40m
33211,1,Roman,2408,0,1,0,1,100.0%,30m
33211,1,[CBTR]Heidi,2408,0,1,1,2,50.0%,1h
33211,1,Dags,2408,0,1,4,5,20.0%,34m
33211,1,[RxCh]AnalnyCherv,2408,0,0,1,1,0.0%,48m
33211,1,kakaxa,2408,0,0,1,1,0.0%,59m
33211,3,rubendp,2408,0,0,2,2,0.0%,3m
33211,3,[HRisk]Maximmuss,2408,0,0,2,2,0.0%,36m
33211,1,IIIIIIIIIIII,2408,0,0,5,5,0.0%,54m
33232,3,CookiXXX,2407,858,37,34,71,52.1%,39m
33232,3,aspotashev,2407,481,17,18,35,48.6%,1h
33232,1,[TENRIX]Innocence,2407,402,10,6,16,62.5%,53m
33232,3,KillerBee,2407,157,4,3,7,57.1%,11m
33232,3,CarryMyTrash,2407,122,3,7,10,30.0%,56m
33232,3,[Cykabl]CarM,2407,121,3,9,12,25.0%,9m
33232,1,Sarkany,2407,0,2,3,5,40.0%,43m
33232,3,Naza,2407,32,2,4,6,33.3%,37m
33232,3,Lonza,2407,60,2,6,8,25.0%,43m
33232,3,DevilBat,2407,97,2,6,8,25.0%,5m
33232,1,Zorry,2407,48,1,1,2,50.0%,26m
33232,1,[RLPX]Wayfarer,2407,97,1,3,4,25.0%,43m
33232,1,EnTaroAdun,2407,48,1,3,4,25.0%,27m
33232,3,Misael,2407,0,0,1,1,0.0%,48m
33232,1,YkAmaL,2407,0,0,1,1,0.0%,1h
33232,1,дракон,2407,0,0,5,5,0.0%,33m
33248,2,Stuart,2406,824,32,32,64,50.0%,41m
33248,3,[JCp]Backi,2406,563,20,18,38,52.6%,47m
33248,3,Raikon,2406,399,14,15,29,48.3%,12m
33248,1,kirito,2406,306,11,3,14,78.6%,1h
33248,1,[RIZY]ЗлойПингвин,2406,438,11,8,19,57.9%,11m
33248,1,[XvFe]Sacke,2406,286,9,9,18,50.0%,54m
33248,3,Terran,2406,260,8,7,15,53.3%,1h
33248,1,llllllllllll,2406,294,7,1,8,87.5%,42m
33248,2,Haleem,2406,148,7,10,17,41.2%,1h
33248,3,Qualax,2406,221,7,11,18,38.9%,59m
33248,3,Mattiaman,2406,185,5,9,14,35.7%,59m
33248,2,SandroGames,2406,30,3,6,9,33.3%,54m
33248,1,STARTERRAN,2406,0,1,4,5,20.0%,30m
33248,1,Richie,2406,0,1,5,6,16.7%,48m
33248,1,Kieightra,2406,0,0,1,1,0.0%,33m
33248,3,Todesbote,2406,0,0,1,1,0.0%,31m
33248,1,WafflesMcGee,2406,0,0,1,1,0.0%,57m
33248,2,ToPoirrot,2406,0,0,1,1,0.0%,60m
33248,1,[BWD]JohnCoffey,2406,0,0,2,2,0.0%,7m
33267,1,ТРЕНДЕ,2405,734,41,56,97,42.3%,8m
33267,3,Unaluna,2405,679,32,31,63,50.8%,31m
33267,3,Dreey,2405,456,19,17,36,52.8%,28m
33267,1,max,2405,280,8,7,15,53.3%,42m
33267,3,SerDalar,2405,200,6,8,14,42.9%,37m
33267,3,Robert,2405,121,3,2,5,60.0%,38m
33267,2,warofblood,2405,90,2,2,4,50.0%,25m
33267,1,smiledude,2405,0,1,0,1,100.0%,50m
33267,1,CheesePlayer,2405,0,1,3,4,25.0%,42m
33267,1,KiciKici,2405,0,0,2,2,0.0%,1h
33267,3,Stephan,2405,0,0,3,3,0.0%,5m
33278,1,waldor,2404,1122,120,131,251,47.8%,38m
33278,3,MonsieurB,2404,1619,90,80,170,52.9%,9m
33278,3,BORMASHINKA,2404,1487,77,72,149,51.7%,50m
33278,3,RusCorp,2404,1157,61,64,125,48.8%,25m
33278,3,Estom,2404,1166,50,49,99,50.5%,1h
33278,1,[ARISS3]whyalwaysme,2404,964,37,23,60,61.7%,54m
33278,3,BlackBear,2404,656,22,43,65,33.8%,12m
33278,1,MGX,2404,438,18,23,41,43.9%,25m
33278,1,Feral,2404,339,12,2,14,85.7%,1h
33278,1,[oooboy]FTKDave,2404,356,11,7,18,61.1%,42m
33278,2,LifeTryer,2404,291,10,16,26,38.5%,27m
33278,3,Jakes,2404,253,9,8,17,52.9%,7m
33278,3,FrOka,2404,201,8,5,13,61.5%,37m
33278,3,Rizarid,2404,146,5,9,14,35.7%,33m
33278,1,RMF,2404,172,4,6,10,40.0%,36m
33278,1,nHawk,2404,40,3,4,7,42.9%,44m
33278,1,guemper,2404,48,3,5,8,37.5%,54m
33278,3,[НОД17]bagi,2404,19,3,5,8,37.5%,44m
33278,3,ljspeltdutch,2404,147,3,5,8,37.5%,45m
33278,1,Grisza,2404,0,2,3,5,40.0%,52m
33278,3,Nabulak,2404,117,2,3,5,40.0%,1h
33278,3,[ЧСВ]Протосс,2404,0,1,0,1,100.0%,5m
33278,3,Aivengo,2404,34,1,2,3,33.3%,4m
33278,1,Dobrusha,2404,0,1,4,5,20.0%,29m
33278,1,Caracas,2404,34,1,6,7,14.3%,10m
33278,1,[КПCC]pmpkn,2404,0,0,1,1,0.0%,57m
33278,1,Наум,2404,0,0,1,1,0.0%,3m
33278,1,EmuOcelot,2404,0,0,2,2,0.0%,1h
33278,1,SwagyFatFace,2404,0,0,2,2,0.0%,57m
33278,3,RageFull,2404,0,0,3,3,0.0%,1h
33308,2,Drozd,2403,1418,80,83,163,49.1%,1h
33308,2,ThoodTheNoOb,2403,1213,71,76,147,48.3%,1m
33308,3,Anastezia,2403,1509,60,62,122,49.2%,1h
33308,1,[VRB]michssen,2403,829,25,24,49,51.0%,1h
33308,1,hglff,2403,636,20,38,58,34.5%,11m
33308,3,Väinämöinen,2403,487,18,20,38,47.4%,1h
33308,3,leevskij,2403,312,11,14,25,44.0%,32m
33308,2,Smokills,2403,320,11,16,27,40.7%,4m
33308,1,ZTrick,2403,392,10,5,15,66.7%,2m
33308,1,Russed,2403,204,6,4,10,60.0%,60m
33308,3,rusikagmel,2403,222,6,9,15,40.0%,1h
33308,1,VerscepipBoy,2403,172,5,2,7,71.4%,55m
33308,2,Murph,2403,101,4,12,16,25.0%,43m
33308,1,[berezi]burymm,2403,120,3,4,7,42.9%,52m
33308,3,Serax,2403,0,3,8,11,27.3%,7m
33308,2,[TsNP]NoCash,2403,60,3,11,14,21.4%,4m
33308,2,[XSK]Marv,2403,0,2,5,7,28.6%,1h
33308,2,supercraft,2403,0,2,5,7,28.6%,32m
33308,3,омлет,2403,94,2,5,7,28.6%,11m
33308,3,Crabman,2403,0,2,6,8,25.0%,38m
33308,1,Badabok,2403,97,1,2,3,33.3%,1h
33308,1,Comix,2403,0,0,1,1,0.0%,57m
33308,1,Bell,2403,0,0,1,1,0.0%,44m
33331,1,Andrij,2402,758,23,14,37,62.2%,40m
33331,1,[AwTm]inDiGo,2402,492,15,12,27,55.6%,26m
33331,3,Ghost,2402,338,14,13,27,51.9%,1h
33331,1,cypubog,2402,360,10,5,15,66.7%,57m
33331,1,WOLFI,2402,279,9,8,17,52.9%,9m
33331,1,Alex,2402,348,9,8,17,52.9%,49m
33331,1,[ExTr1m]sashaTopGg,2402,280,8,6,14,57.1%,4m
33331,1,Kaneelbagel,2402,210,8,17,25,32.0%,11m
33331,1,Rammud,2402,0,3,2,5,60.0%,32m
33331,1,[678]DEADLYSTALKE,2402,145,3,5,8,37.5%,29m
33331,3,SpartaKook,2402,94,3,7,10,30.0%,11m
33331,1,[lMMl]BirDie,2402,0,1,0,1,100.0%,1h
33331,2,[Fast43]BUUUUNT,2402,0,1,1,2,50.0%,9m
33331,1,MsP,2402,97,1,1,2,50.0%,34m
33331,1,ArtBerich,2402,0,1,4,5,20.0%,43m
33331,1,GETINTHEVAN,2402,0,1,4,5,20.0%,38m
33331,2,Hamely,2402,0,0,1,1,0.0%,28m
33348,2,Percyworld,2401,1433,65,73,138,47.1%,58m
33348,1,Burkels,2401,1308,48,33,81,59.3%,57m
33348,1,Karuzo,2401,544,20,23,43,46.5%,42m
33348,3,[Изувер]МитчИИ,2401,526,19,20,39,48.7%,39m
33348,3,Shiomy,2401,446,18,15,33,54.5%,52m
33348,1,[HBRG]ForAiur,2401,276,8,4,12,66.7%,50m
33348,3,[sctrap]KarlMarxxx,2401,213,7,6,13,53.8%,12m
33348,1,Garrapata,2401,66,6,6,12,50.0%,52m
33348,3,HHRaw,2401,182,6,11,17,35.3%,1h
33348,3,[Sabat]Lazarz,2401,201,5,9,14,35.7%,51m
33348,3,[Mutter]Aristo,2401,120,4,8,12,33.3%,3m
33348,1,[evsu]BLovich,2401,97,2,1,3,66.7%,43m
33348,3,[Bomje]Penguin,2401,30,2,4,6,33.3%,31m
33348,2,Neandrix,2401,0,2,5,7,28.6%,1h
33348,1,[ImbaG]Vladimir,2401,0,1,1,2,50.0%,11m
33348,1,Basters,2401,44,1,2,3,33.3%,1h
33348,3,[pisos]andmyfarttoo,2401,96,1,3,4,25.0%,34m
33348,1,Dreamlock,2401,0,0,1,1,0.0%,55m
33348,1,[Щитон]Star,2401,0,0,1,1,0.0%,11m
33348,1,Propanoïaque,2401,0,0,1,1,0.0%,54m
33348,3,CyberSoldier,2401,0,0,6,6,0.0%,32m
33348,1,[Mavis]HellerCS,2401,0,0,6,6,0.0%,1h
33370,1,styx,2400,1885,88,76,164,53.7%,1h
33370,1,LaBuche,2400,1615,58,50,108,53.7%,27m
33370,3,TheDarDevil,2400,1070,57,58,115,49.6%,43m
33370,3,SupremeKyn,2400,711,30,27,57,52.6%,28m
33370,2,ToTeaTrouT,2400,377,13,21,34,38.2%,1h
33370,2,Mog,2400,308,10,9,19,52.6%,53m
33370,2,[RMF]RKLSK,2400,166,7,8,15,46.7%,54m
33370,3,BulOx,2400,60,3,9,12,25.0%,7m
33370,1,DevilXXIV,2400,0,2,1,3,66.7%,54m
33370,3,AwasteR,2400,117,2,4,6,33.3%,35m
33370,1,Valentin,2400,0,2,4,6,33.3%,42m
33370,3,KartEr,2400,46,2,6,8,25.0%,40m
33370,1,zylan,2400,0,2,6,8,25.0%,55m
33370,1,ORZ,2400,44,1,1,2,50.0%,3m
33370,1,Berlioz,2400,0,1,1,2,50.0%,1h
33370,1,newANS,2400,0,1,4,5,20.0%,57m
33370,1,electron,2400,0,0,1,1,0.0%,42m
33387,3,MatLap,2399,737,98,80,178,55.1%,50m
33387,1,Cyrex,2399,407,42,27,69,60.9%,1h
33387,1,Mikro,2399,638,27,17,44,61.4%,4m
33387,1,anabioz,2399,526,22,21,43,51.2%,1h
33387,1,Bogun,2399,504,14,12,26,53.8%,41m
33387,1,Dragonguy,2399,452,12,9,21,57.1%,1h
33387,1,[TLD]EricCartman,2399,324,9,6,15,60.0%,9m
33387,1,Martinbrooks,2399,252,7,4,11,63.6%,56m
33387,1,ilitch,2399,269,7,8,15,46.7%,52m
33387,3,Danielosio,2399,219,7,12,19,36.8%,29m
33387,3,Busterenko,2399,182,6,8,14,42.9%,45m
33387,2,Lubricus,2399,114,6,9,15,40.0%,48m
33387,3,denis,2399,206,5,11,16,31.2%,3m
33387,3,Домовой,2399,175,4,9,13,30.8%,1h
33387,3,[1WN1]elconejo,2399,122,4,11,15,26.7%,29m
33387,1,LeocanEvil,2399,0,3,2,5,60.0%,50m
33387,2,Newplaya,2399,0,3,5,8,37.5%,10m
33387,3,PDT,2399,97,3,6,9,33.3%,40m
33387,2,Keply,2399,30,3,6,9,33.3%,11m
33387,3,TheTobby,2399,0,2,4,6,33.3%,1h
33387,1,xxdokkaebix,2399,0,2,5,7,28.6%,45m
33387,1,Goyim,2399,132,2,5,7,28.6%,50m
33387,2,ISppsd,2399,0,1,2,3,33.3%,1h
33387,1,OverLord,2399,0,1,4,5,20.0%,54m
33387,1,karax,2399,0,0,1,1,0.0%,34m
33387,1,[NNcity]zmeika,2399,0,0,1,1,0.0%,47m
33387,1,Bluesky,2399,0,0,1,1,0.0%,46m
33414,3,IBT,2398,1286,79,70,149,53.0%,40m
33414,3,AKHKHARU,2398,1098,43,46,89,48.3%,12m
33414,1,Alcaudon,2398,760,21,21,42,50.0%,55m
33414,3,MVN,2398,580,20,24,44,45.5%,41m
33414,3,Petrov,2398,445,16,18,34,47.1%,1h
33414,1,grog,2398,168,5,1,6,83.3%,50m
33414,3,generalY,2398,133,4,6,10,40.0%,1h
33414,3,electronengi,2398,117,4,7,11,36.4%,4m
33414,3,Samy,2398,58,3,4,7,42.9%,39m
33414,1,jakbal,2398,97,2,0,2,100.0%,57m
33414,2,MrFish,2398,0,2,5,7,28.6%,37m
33414,3,[FR1]ShahKaal,2398,0,1,2,3,33.3%,35m
33414,1,[HaSKo]Den,2398,44,1,2,3,33.3%,1h
33414,1,Milflover,2398,0,0,2,2,0.0%,54m
33414,3,[OPStar]Viver,2398,0,0,3,3,0.0%,40m
33429,3,[vDog]milamber,2397,732,30,26,56,53.6%,42m
33429,3,nhabine,2397,532,20,20,40,50.0%,60m
33429,1,kazuma,2397,446,11,10,21,52.4%,43m
33429,1,Raiden,2397,246,7,3,10,70.0%,58m
33429,3,LEMON,2397,142,4,2,6,66.7%,28m
33429,1,Mikl,2397,125,4,9,13,30.8%,5m
33429,1,Лёха,2397,92,3,2,5,60.0%,52m
33429,1,Blood,2397,0,3,3,6,50.0%,60m
33429,2,[ZBys]Enni,2397,38,2,1,3,66.7%,53m
33429,1,Hitane,2397,42,2,5,7,28.6%,46m
33429,1,[Minden]Spirit,2397,145,2,6,8,25.0%,34m
33429,1,ЩШЩШЩШЩШЩШ,2397,0,1,0,1,100.0%,35m
33429,1,Tesarion,2397,0,1,0,1,100.0%,52m
33429,3,SERG,2397,97,1,1,2,50.0%,1h
33429,1,Morpheous,2397,0,1,3,4,25.0%,9m
33429,3,Kirushic,2397,97,1,3,4,25.0%,46m
33429,1,Lex,2397,0,1,4,5,20.0%,50m
33429,3,Haron,2397,30,1,5,6,16.7%,43m
33447,2,Shmelll,2396,1341,83,81,164,50.6%,6m
33447,1,PierroChon,2396,1226,41,61,102,40.2%,10m
33447,2,JYoJin,2396,730,27,31,58,46.6%,6m
33447,1,TakT,2396,540,14,12,26,53.8%,28m
33447,3,MEFF,2396,275,9,17,26,34.6%,51m
33447,3,BimBuha,2396,223,8,4,12,66.7%,12m
33447,3,satellite,2396,243,8,9,17,47.1%,27m
33447,3,[CОS]Hohol,2396,207,7,6,13,53.8%,39m
33447,3,ScreeAchy,2396,171,4,7,11,36.4%,1h
33447,1,SteinShirt,2396,118,2,5,7,28.6%,52m
33447,1,Bobbel,2396,48,2,5,7,28.6%,52m
33447,1,Giglamech,2396,73,2,7,9,22.2%,1h
33447,1,BloOdǂSoun,2396,0,1,0,1,100.0%,26m
33447,3,[КПCC]FireZerg,2396,0,1,2,3,33.3%,57m
33447,1,Skyloveyou,2396,44,1,3,4,25.0%,44m
33447,1,Koriggar,2396,0,1,4,5,20.0%,52m
33447,1,AleNZ,2396,48,1,6,7,14.3%,1h
33447,1,ARYANYS,2396,0,0,1,1,0.0%,55m
33465,2,Cyberslav,2395,1524,175,174,349,50.1%,7m
33465,3,Valkyr,2395,898,63,62,125,50.4%,50m
33465,3,CMMT,2395,721,54,53,107,50.5%,57m
33465,3,Keiratul,2395,187,34,25,59,57.6%,57m
33465,3,Corfriden,2395,413,18,14,32,56.2%,39m
33465,2,warzyrm,2395,480,18,19,37,48.6%,1h
33465,2,Jetflie,2395,279,12,9,21,57.1%,4m
33465,1,PaniC,2395,44,3,5,8,37.5%,40m
33465,2,OutlawGuru,2395,58,3,10,13,23.1%,53m
33465,1,NuxKrux,2395,44,2,0,2,100.0%,1h
33465,1,[VENDET]LuisMiguel,2395,42,1,1,2,50.0%,59m
33465,1,Zeph,2395,97,1,2,3,33.3%,57m
33465,1,Razziatore,2395,0,1,4,5,20.0%,46m
33465,1,Hunter,2395,0,1,4,5,20.0%,1h
33465,1,elreymago,2395,0,1,4,5,20.0%,57m
33465,3,[RuCrew]iloveyourmom,2395,30,1,4,5,20.0%,8m
33465,3,Gyro,2395,0,1,6,7,14.3%,44m
33465,1,Legolas,2395,0,0,1,1,0.0%,1h
33465,1,Shezu,2395,0,0,2,2,0.0%,49m
33465,1,Skip,2395,0,0,3,3,0.0%,1h
33465,3,Executor,2395,0,0,5,5,0.0%,50m
33465,2,Marshmello,2395,0,0,6,6,0.0%,1h
33487,2,ScottishHunt,2394,1584,173,159,332,52.1%,11m
33487,3,Biggie,2394,1001,63,62,125,50.4%,3m
33487,1,Molok,2394,1307,43,36,79,54.4%,54m
33487,1,Sanya,2394,914,28,23,51,54.9%,39m
33487,1,Drayk,2394,725,27,18,45,60.0%,1h
33487,3,[RIn]Thoriax,2394,612,25,25,50,50.0%,1h
33487,1,[Kingal]senya,2394,614,24,16,40,60.0%,54m
33487,3,Joza,2394,467,17,15,32,53.1%,54m
33487,1,Iorveil,2394,266,7,12,19,36.8%,53m
33487,1,Luke,2394,144,6,5,11,54.5%,1m
33487,3,CAPTAMERICA,2394,94,5,8,13,38.5%,42m
33487,1,LastLegion,2394,132,4,6,10,40.0%,37m
33487,3,Amnam,2394,131,4,7,11,36.4%,38m
33487,1,Hansen,2394,0,3,2,5,60.0%,1h
33487,1,Knubbsälen,2394,0,3,2,5,60.0%,50m
33487,3,[ZCK]kingofblades,2394,145,3,3,6,50.0%,29m
33487,1,Stoofy,2394,145,3,6,9,33.3%,34m
33487,2,Elanor,2394,0,2,6,8,25.0%,6m
33487,1,[Fansaf]Kvihant,2394,0,1,0,1,100.0%,32m
33487,1,Damianek,2394,0,1,4,5,20.0%,10m
33487,1,tobtim,2394,0,0,1,1,0.0%,50m
33487,1,dgdxv,2394,0,0,1,1,0.0%,1h
33487,1,[AciNoN]TASSADAR,2394,0,0,1,1,0.0%,60m
33487,1,chainloose,2394,0,0,1,1,0.0%,8m
33487,1,[STDES]MAXYMUS,2394,0,0,2,2,0.0%,57m
33487,2,[SAPT]Smile,2394,0,0,2,2,0.0%,53m
33487,3,Lichking,2394,0,0,9,9,0.0%,1h
33514,2,Sørrel,2393,850,166,155,321,51.7%,39m
33514,3,TheProdigy,2393,1112,49,50,99,49.5%,57m
33514,3,Enx,2393,645,38,41,79,48.1%,51m
33514,1,Original,2393,602,21,16,37,56.8%,11m
33514,3,ryanfire,2393,521,21,21,42,50.0%,40m
33514,1,Bricks,2393,664,19,17,36,52.8%,1h
33514,3,Aluveth,2393,481,19,19,38,50.0%,45m
33514,1,Dragonlord,2393,610,16,19,35,45.7%,1h
33514,3,bojan,2393,295,10,9,19,52.6%,46m
33514,1,DarkMewtu,2393,236,10,15,25,40.0%,1m
33514,3,varatron,2393,226,8,13,21,38.1%,34m
33514,2,[aBueLo]CheiLys,2393,214,7,4,11,63.6%,1h
33514,3,Shadow,2393,204,7,5,12,58.3%,53m
33514,1,Akella,2393,218,6,5,11,54.5%,11m
33514,1,ruin,2393,123,4,7,11,36.4%,7m
33514,1,RUM,2393,44,2,1,3,66.7%,36m
33514,1,undertaker,2393,0,2,3,5,40.0%,53m
33514,1,DRLulu,2393,0,2,3,5,40.0%,54m
33514,3,[CocoCo]Ashloids,2393,94,2,5,7,28.6%,40m
33514,3,xouma,2393,42,2,6,8,25.0%,1h
33514,1,Mathias,2393,0,1,1,2,50.0%,1h
33514,1,indigo,2393,0,1,1,2,50.0%,52m
33514,3,ceib,2393,0,1,5,6,16.7%,50m
33514,2,[MooooN]MrsMoon,2393,0,0,3,3,0.0%,6m
33538,2,Mortyus,2392,1546,130,127,257,50.6%,58m
33538,3,Gatskopper,2392,446,25,30,55,45.5%,45m
33538,1,[3ЕRGTV]Vlad,2392,597,17,12,29,58.6%,10m
33538,3,Murzazeal,2392,293,17,19,36,47.2%,1h
33538,3,[Glenn]GanjáBob,2392,387,14,19,33,42.4%,56m
33538,3,NuStream,2392,388,13,14,27,48.1%,47m
33538,1,Zolphi,2392,373,11,15,26,42.3%,1h
33538,3,Nikolai,2392,86,3,7,10,30.0%,53m
33538,1,DRONxBOT,2392,48,2,5,7,28.6%,30m
33538,1,[13pool]JRaynor,2392,0,1,4,5,20.0%,9m
33538,1,[BLABOI]chnkymnky,2392,0,1,4,5,20.0%,53m
33538,1,shador,2392,0,0,2,2,0.0%,44m
33538,3,Lolo,2392,0,0,4,4,0.0%,1h
33551,2,Igua,2391,1615,177,182,359,49.3%,1m
33551,3,[Gondon]BABABOI,2391,1048,134,125,259,51.7%,46m
33551,3,AnK,2391,1597,130,131,261,49.8%,56m
33551,3,Rocu,2391,1273,103,98,201,51.2%,37m
33551,2,[WАSD]Feroom,2391,1212,86,69,155,55.5%,42m
33551,3,ZoïdBerG,2391,1091,42,46,88,47.7%,12m
33551,1,[UATeam]SuperSkunk,2391,1105,37,53,90,41.1%,56m
33551,3,Comphez,2391,314,11,17,28,39.3%,57m
33551,3,Iruga,2391,239,9,5,14,64.3%,60m
33551,3,Atlan,2391,231,8,2,10,80.0%,46m
33551,2,Jakubix,2391,131,6,5,11,54.5%,54m
33551,3,DandeboixXXx,2391,208,6,9,15,40.0%,36m
33551,3,Стрелок,2391,193,5,8,13,38.5%,34m
33551,3,WLK,2391,144,5,10,15,33.3%,43m
33551,2,IIIIIIIIII,2391,121,4,1,5,80.0%,56m
33551,1,MiChAtLLO,2391,164,4,5,9,44.4%,52m
33551,1,lager,2391,122,3,3,6,50.0%,1h
33551,1,chupameelqlo,2391,70,3,3,6,50.0%,8m
33551,1,Konzzzales,2391,96,3,7,10,30.0%,10m
33551,3,артём,2391,30,2,0,2,100.0%,1h
33551,1,Zellaz,2391,96,2,8,10,20.0%,50m
33551,3,Jomallo,2391,97,1,2,3,33.3%,28m
33551,1,Yurek,2391,36,1,3,4,25.0%,26m
33551,1,cashmereffec,2391,0,1,4,5,20.0%,53m
33551,1,Siwy,2391,0,0,3,3,0.0%,50m
33576,3,Cicollos,2390,1510,78,75,153,51.0%,12m
33576,3,vlad,2390,1416,57,52,109,52.3%,58m
33576,3,TheOverlord,2390,253,53,51,104,51.0%,40m
33576,3,Herb,2390,782,31,27,58,53.4%,8m
33576,1,vladrus,2390,246,6,1,7,85.7%,59m
33576,1,SovestKun,2390,200,6,3,9,66.7%,28m
33576,1,ShadowGoat,2390,258,6,7,13,46.2%,44m
33576,3,Smirnov,2390,174,6,7,13,46.2%,1h
33576,3,Flynn,2390,122,4,8,12,33.3%,29m
33576,1,KrataKnow,2390,0,1,0,1,100.0%,1h
33576,3,Baltasar,2390,0,1,1,2,50.0%,28m
33576,1,Alexnk,2390,0,1,4,5,20.0%,1h
33588,2,КапчАн,2389,1529,117,132,249,47.0%,19m
33588,3,Sodzisan,2389,1500,67,59,126,53.2%,58m
33588,2,Ongbak,2389,503,20,25,45,44.4%,41m
33588,1,rino,2389,646,18,15,33,54.5%,10m
33588,2,Акселератор,2389,426,17,21,38,44.7%,51m
33588,3,Floresco,2389,363,16,20,36,44.4%,7m
33588,1,Precious,2389,320,9,8,17,52.9%,8m
33588,3,Papashka,2389,213,6,7,13,46.2%,10m
33588,1,GuyMotte,2389,86,3,1,4,75.0%,1h
33588,3,viking,2389,60,3,4,7,42.9%,1h
33588,1,Impressio,2389,0,1,1,2,50.0%,43m
33588,1,Firevd,2389,42,1,3,4,25.0%,4m
33588,1,sankasei,2389,0,1,4,5,20.0%,60m
33588,1,serawer,2389,117,1,4,5,20.0%,50m
33588,1,CptHarlock,2389,0,1,5,6,16.7%,58m
33588,1,Rodik,2389,0,0,1,1,0.0%,49m
33588,1,Stimpunk,2389,0,0,2,2,0.0%,50m
33605,3,Henke,2388,882,33,38,71,46.5%,53m
33605,3,myway,2388,667,29,25,54,53.7%,39m
33605,1,NoSense,2388,916,27,25,52,51.9%,52m
33605,1,NordWarrior,2388,646,19,14,33,57.6%,1h
33605,3,StumerBro,2388,348,12,10,22,54.5%,44m
33605,2,Jess,2388,270,9,13,22,40.9%,52m
33605,1,SpicyTobasco,2388,307,8,7,15,53.3%,3m
33605,1,Callum,2388,169,5,4,9,55.6%,1h
33605,1,zloyBOBER,2388,0,3,2,5,60.0%,11m
33605,1,OSIRIS,2388,0,3,3,6,50.0%,34m
33605,3,[lOoOl]ristlin,2388,97,3,7,10,30.0%,47m
33605,1,КРАБ,2388,0,1,1,2,50.0%,58m
33605,3,Teddy,2388,0,1,3,4,25.0%,39m
33605,1,KlikoBoom,2388,42,1,3,4,25.0%,47m
33605,1,[AdvM]Piquet,2388,0,1,4,5,20.0%,1m
33605,1,ByDedokOk,2388,0,0,1,1,0.0%,1h
33605,2,[Ejine]Warazou,2388,0,0,2,2,0.0%,28m
33605,1,Kronos,2388,0,0,3,3,0.0%,40m
33623,3,Виктор,2387,1365,53,57,110,48.2%,8m
33623,3,EnzoGiorgi,2387,947,44,34,78,56.4%,53m
33623,2,lst,2387,942,43,51,94,45.7%,31m
33623,1,[RеG]diablaid,2387,595,36,37,73,49.3%,50m
33623,1,Насяльника,2387,366,24,19,43,55.8%,8m
33623,1,[1squad]alexzero,2387,600,18,34,52,34.6%,6m
33623,1,BoB,2387,474,12,12,24,50.0%,42m
33623,3,Nightmind,2387,231,7,8,15,46.7%,31m
33623,1,CrusaderPLnd,2387,0,1,0,1,100.0%,50m
33623,1,танк,2387,0,1,0,1,100.0%,10m
33623,1,Dekharius,2387,0,1,4,5,20.0%,50m
33623,1,dMordeKaiser,2387,0,1,4,5,20.0%,54m
33623,1,vlad,2387,0,0,2,2,0.0%,58m
33636,2,Golin,2386,1273,174,187,361,48.2%,1h
33636,1,Avi,2386,1589,109,96,205,53.2%,28m
33636,3,EccioHD,2386,668,39,30,69,56.5%,1h
33636,3,Denman,2386,957,34,39,73,46.6%,27m
33636,3,LEON,2386,572,31,24,55,56.4%,59m
33636,1,Vego,2386,939,28,23,51,54.9%,55m
33636,1,[Tambor]хитрый,2386,253,19,0,19,100.0%,1m
33636,3,Skaadja,2386,410,15,20,35,42.9%,11m
33636,1,NoName,2386,204,6,3,9,66.7%,1h
33636,3,bBelcampo,2386,196,6,8,14,42.9%,1h
33636,3,Dende,2386,88,3,8,11,27.3%,27m
33636,1,Swooshy,2386,0,1,0,1,100.0%,57m
33636,3,PokerFace,2386,0,1,0,1,100.0%,1h
33636,3,[TeamAS]fapapucs,2386,0,1,1,2,50.0%,54m
33636,1,HuFFnerr,2386,0,1,1,2,50.0%,54m
33636,1,[U4P]RoiHeenok,2386,115,1,5,6,16.7%,55m
33636,2,DimasFantoms,2386,0,0,4,4,0.0%,10m
33653,3,ZLAVA,2385,935,66,62,128,51.6%,35m
33653,2,KenT,2385,1446,51,62,113,45.1%,27m
33653,3,Carl,2385,956,37,35,72,51.4%,51m
33653,2,Broinstkopf,2385,772,29,39,68,42.6%,2m
33653,3,batbekh,2385,473,20,19,39,51.3%,29m
33653,3,Abdi,2385,468,17,17,34,50.0%,57m
33653,1,Awen,2385,443,16,16,32,50.0%,28m
33653,3,[uCHAD]KolesławCh,2385,385,15,13,28,53.6%,8m
33653,3,Prinishivace,2385,401,15,17,32,46.9%,1h
33653,2,LongStroke,2385,280,9,12,21,42.9%,54m
33653,1,Wolf,2385,155,7,2,9,77.8%,8m
33653,3,[MEKU]фанатик,2385,158,4,4,8,50.0%,1h
33653,1,kansbar,2385,0,3,4,7,42.9%,53m
33653,1,phoenix,2385,42,2,0,2,100.0%,10m
33653,1,weng,2385,44,2,5,7,28.6%,60m
33653,1,[Rebеls]Demotix,2385,0,1,1,2,50.0%,48m
33653,1,AAP,2385,44,1,3,4,25.0%,32m
33653,3,[LeSang]SoshyV,2385,30,1,3,4,25.0%,43m
33653,3,Subliminal,2385,30,1,7,8,12.5%,3m
33653,1,[ЗЕRGТV]TsvetkovD,2385,0,0,1,1,0.0%,1h
33673,2,lebreton,2384,1575,340,337,677,50.2%,26m
33673,3,KathiLove,2384,1613,142,145,287,49.5%,39m
33673,3,Newby,2384,712,40,35,75,53.3%,11m
33673,3,[DIS]MarineKingPR,2384,677,26,24,50,52.0%,51m
33673,3,[Batia]Aldiyar,2384,687,25,26,51,49.0%,32m
33673,1,[wizurd]Teusku,2384,543,17,18,35,48.6%,53m
33673,3,najch,2384,356,13,17,30,43.3%,46m
33673,2,TaURuS,2384,288,12,14,26,46.2%,50m
33673,3,Vazec,2384,281,10,13,23,43.5%,42m
33673,1,[LoGiN]fraer,2384,334,9,1,10,90.0%,39m
33673,2,[OmDi]Karpos,2384,226,8,14,22,36.4%,1h
33673,1,Ilysha,2384,122,3,2,5,60.0%,57m
33673,1,aurelambroz,2384,0,2,6,8,25.0%,44m
33673,3,Silicium,2384,30,2,7,9,22.2%,29m
33673,1,ktvz,2384,0,1,0,1,100.0%,58m
33673,3,Seneka,2384,30,1,8,9,11.1%,3m
33673,1,hubert,2384,0,0,2,2,0.0%,47m
33673,1,[сюда]XXX,2384,0,0,2,2,0.0%,3m
33691,3,[mfxed]PanKasztanPL,2383,1558,265,244,509,52.1%,59m
33691,3,SilentFear,2383,1545,89,73,162,54.9%,41m
33691,1,[ZERGSC]NikitA,2383,953,40,48,88,45.5%,33m
33691,3,LSHD,2383,525,26,24,50,52.0%,58m
33691,1,Zergling,2383,794,25,17,42,59.5%,45m
33691,3,Nova,2383,644,23,27,50,46.0%,51m
33691,3,[VGSC]CivilSteel,2383,525,22,21,43,51.2%,43m
33691,2,[NoGy]CrazyFrog,2383,591,20,27,47,42.6%,34m
33691,2,Commander,2383,444,19,13,32,59.4%,1h
33691,1,MELT,2383,361,12,8,20,60.0%,43m
33691,3,[PrTons]SpooneyKnify,2383,201,5,12,17,29.4%,53m
33691,1,Poppy,2383,48,4,4,8,50.0%,4m
33691,3,Yirka,2383,90,4,6,10,40.0%,40m
33691,1,[CHââTe]Meriwin,2383,0,3,3,6,50.0%,43m
33691,3,Kosh,2383,42,2,2,4,50.0%,5m
33691,1,[ЕМPIRE]Ranger,2383,38,1,1,2,50.0%,52m
33691,3,AtzeBrauner,2383,0,1,7,8,12.5%,39m
33691,1,[Nothio]NeuTronn,2383,0,0,1,1,0.0%,5m
33691,1,Warwic,2383,0,0,1,1,0.0%,46m
33710,3,[SCSM]ToolTime,2382,1483,239,240,479,49.9%,16m
33710,3,Hannez,2382,790,120,118,238,50.4%,57m
33710,3,[CloudX]nidoking,2382,475,32,34,66,48.5%,41m
33710,3,Andreu,2382,765,28,31,59,47.5%,29m
33710,3,TroughSTER,2382,545,27,31,58,46.6%,12m
33710,1,Conqueror,2382,569,16,19,35,45.7%,60m
33710,3,AmOrFeU,2382,375,14,16,30,46.7%,12m
33710,3,Mike,2382,238,10,10,20,50.0%,1h
33710,1,LosTinWooDs,2382,264,8,7,15,53.3%,46m
33710,1,EcSaGha,2382,158,5,8,13,38.5%,48m
33710,2,Reckeris,2382,226,5,11,16,31.2%,56m
33710,3,MutantMass,2382,94,5,11,16,31.2%,14m
33710,3,Trusker,2382,60,4,5,9,44.4%,29m
33710,1,spekkyo,2382,48,3,6,9,33.3%,40m
33710,3,magma,2382,90,3,8,11,27.3%,44m
33710,1,AnOnSaiko,2382,0,1,0,1,100.0%,7m
33710,1,verker,2382,0,0,1,1,0.0%,56m
33710,1,AlexMarine,2382,0,0,1,1,0.0%,50m
33728,2,ZAMOK,2381,943,161,172,333,48.3%,12m
33728,2,TimmyTango,2381,1450,51,65,116,44.0%,9m
33728,1,Lowkey,2381,975,42,21,63,66.7%,1h
33728,3,bountyknight,2381,1170,41,46,87,47.1%,5m
33728,2,Felix,2381,384,22,32,54,40.7%,54m
33728,3,Yupik,2381,616,21,26,47,44.7%,1h
33728,2,LexxLutiy,2381,211,7,5,12,58.3%,39m
33728,3,MoodSwings,2381,124,5,8,13,38.5%,41m
33728,2,Musto,2381,140,5,8,13,38.5%,6m
33728,3,Gasoline,2381,120,4,9,13,30.8%,44m
33728,1,[Skitzo]AllysonNL,2381,130,3,3,6,50.0%,36m
33728,3,[CaoZ]Rabauke,2381,30,3,7,10,30.0%,53m
33728,1,NoFo,2381,40,2,4,6,33.3%,55m
33728,1,[KRUR]denikarabenc,2381,44,1,1,2,50.0%,1h
33728,2,imumi,2381,0,1,4,5,20.0%,53m
33728,1,[XeNoNs]Rustam,2381,0,0,1,1,0.0%,26m
33744,3,[EXPANT]Splayn,2380,1533,71,74,145,49.0%,1h
33744,3,BamBa,2380,1283,56,61,117,47.9%,42m
33744,2,yeti,2380,977,53,83,136,39.0%,16m
33744,3,zergouze,2380,1253,50,53,103,48.5%,9m
33744,1,Marado,2380,1360,48,36,84,57.1%,1h
33744,1,WOZBUHATEL,2380,938,42,26,68,61.8%,56m
33744,1,Stockish,2380,1111,39,28,67,58.2%,50m
33744,3,StarComanRU,2380,714,27,24,51,52.9%,60m
33744,1,Szymon,2380,654,24,15,39,61.5%,53m
33744,2,apocc,2380,354,15,18,33,45.5%,1h
33744,3,timmehh,2380,396,14,18,32,43.8%,29m
33744,3,Ybipbip,2380,394,14,21,35,40.0%,4m
33744,3,irinicus,2380,261,8,9,17,47.1%,32m
33744,3,Cip,2380,88,5,9,14,35.7%,1h
33744,2,Kamchak,2380,114,5,10,15,33.3%,16m
33744,1,[SoothK]Isso,2380,148,3,5,8,37.5%,47m
33744,1,Radek,2380,128,3,6,9,33.3%,39m
33744,1,Reaper,2380,0,1,1,2,50.0%,1h
33744,2,Agonytech,2380,0,1,2,3,33.3%,4m
33744,1,Virruss,2380,0,0,1,1,0.0%,9m
33744,1,[ROG]DrFuzz,2380,0,0,1,1,0.0%,1h
33744,1,MadJohn,2380,0,0,1,1,0.0%,30m
33744,3,[NSJLM]jakcouille,2380,0,0,4,4,0.0%,58m
33767,2,mojemantry,2379,348,218,229,447,48.8%,1m
33767,1,Fornax,2379,1814,161,155,316,50.9%,54m
33767,1,Piper,2379,1836,66,68,134,49.3%,2m
33767,3,Ciniyzayac,2379,1185,64,59,123,52.0%,7m
33767,1,Mystix,2379,815,27,29,56,48.2%,50m
33767,1,McIvor,2379,557,23,37,60,38.3%,3m
33767,1,pgF,2379,414,15,4,19,78.9%,8m
33767,3,Ludowarrior,2379,342,15,11,26,57.7%,36m
33767,2,AlexPUA,2379,188,6,13,19,31.6%,1h
33767,3,cometa,2379,120,5,10,15,33.3%,4m
33767,3,Erixxon,2379,64,4,8,12,33.3%,57m
33767,2,MWJ,2379,130,3,11,14,21.4%,27m
33767,1,[drrsch]Oliverinspac,2379,46,2,0,2,100.0%,40m
33767,1,AAM,2379,44,2,3,5,40.0%,52m
33767,3,[NLTN]Wokram,2379,72,2,7,9,22.2%,6m
33767,1,YHG,2379,0,1,0,1,100.0%,49m
33767,1,Criss,2379,42,1,2,3,33.3%,53m
33767,1,Lisiasty,2379,0,1,2,3,33.3%,28m
33767,2,[FteamF]Aynn,2379,0,1,2,3,33.3%,46m
33767,2,[TedB]DarkSunGwyn,2379,0,1,4,5,20.0%,57m
33767,3,Ultralisk,2379,30,1,7,8,12.5%,39m
33767,1,[YLLUMA]Abominus,2379,0,0,2,2,0.0%,48m
33789,3,кровоточащий,2378,1284,62,65,127,48.8%,13m
33789,3,Phtevan,2378,776,50,53,103,48.5%,45m
33789,3,IIII,2378,929,44,44,88,50.0%,44m
33789,3,Lormak,2378,904,43,38,81,53.1%,27m
33789,3,[LifeTV]IOOOOOO,2378,516,36,33,69,52.2%,3m
33789,3,RaketenBär,2378,838,34,34,68,50.0%,27m
33789,2,HolaQueTal,2378,619,23,28,51,45.1%,1h
33789,3,boultan,2378,582,20,25,45,44.4%,53m
33789,1,Enem,2378,240,7,2,9,77.8%,1h
33789,1,Norrock,2378,132,3,2,5,60.0%,54m
33789,3,СуМраК,2378,97,2,0,2,100.0%,1h
33789,3,SleepyHorse,2378,30,2,5,7,28.6%,32m
33789,1,SAMUPAL,2378,0,1,1,2,50.0%,31m
33789,1,ридик,2378,40,1,4,5,20.0%,50m
33789,1,[RekTzW]Wojtaszy,2378,0,1,5,6,16.7%,34m
33789,1,alexsandr,2378,0,0,1,1,0.0%,1h
33805,3,Thulmade,2377,1370,66,70,136,48.5%,32m
33805,3,Syrinx,2377,1281,58,60,118,49.2%,44m
33805,3,ALkoNAfT,2377,343,12,13,25,48.0%,54m
33805,3,PeterPanini,2377,237,10,9,19,52.6%,1h
33805,3,Guiritham,2377,152,9,8,17,52.9%,58m
33805,3,[TeamDJ]FFHLH,2377,148,4,8,12,33.3%,1h
33805,1,Artcor,2377,152,3,1,4,75.0%,60m
33805,1,maciekuk,2377,0,3,2,5,60.0%,1h
33805,1,CalexQQwZ,2377,48,3,5,8,37.5%,2m
33805,1,Tatthwa,2377,97,2,4,6,33.3%,47m
33805,1,[PiPsA]HEPHAESTUS,2377,0,1,1,2,50.0%,43m
33805,1,MrBananix,2377,44,1,2,3,33.3%,51m
33805,2,[HsDL]Blu,2377,0,1,4,5,20.0%,51m
33805,1,Swuder,2377,48,1,5,6,16.7%,57m
33805,3,LEKSO,2377,30,1,8,9,11.1%,34m
33805,1,Aston,2377,0,0,1,1,0.0%,28m
33805,2,[БОДУН]Nekrosoon,2377,0,0,1,1,0.0%,35m
33805,1,Huku,2377,0,0,2,2,0.0%,39m
33805,2,Zanaxal,2377,0,0,3,3,0.0%,7m
33805,1,SrRipper,2377,0,0,3,3,0.0%,58m
33825,3,Glenelg,2376,1039,40,40,80,50.0%,34m
33825,3,[Stilll]Andronic,2376,611,25,25,50,50.0%,28m
33825,2,NTech,2376,347,13,22,35,37.1%,4m
33825,1,CII,2376,406,11,18,29,37.9%,46m
33825,1,Duque,2376,213,8,13,21,38.1%,1h
33825,1,LaKillaQueen,2376,42,4,2,6,66.7%,52m
33825,1,[em66]Stef,2376,80,4,4,8,50.0%,26m
33825,1,Tankir,2376,181,4,7,11,36.4%,8m
33825,2,Кекс,2376,142,4,8,12,33.3%,11m
33825,1,Gaba,2376,42,1,1,2,50.0%,48m
33825,3,Gerolsteiner,2376,97,1,2,3,33.3%,9m
33825,1,DarkShift,2376,0,1,4,5,20.0%,55m
33825,1,Steefen,2376,0,1,5,6,16.7%,49m
33825,1,Outworld,2376,0,1,5,6,16.7%,10m
33825,1,Marley,2376,0,0,2,2,0.0%,42m
33825,3,Venom,2376,0,0,3,3,0.0%,32m
33841,2,PandaMan,2375,1315,58,46,104,55.8%,1h
33841,1,Typo,2375,1243,46,39,85,54.1%,1h
33841,3,zergouner,2375,1050,45,34,79,57.0%,38m
33841,1,Supersonic,2375,444,18,12,30,60.0%,36m
33841,1,QuBuS,2375,435,16,9,25,64.0%,35m
33841,1,AsPMaSsAkEr,2375,48,4,3,7,57.1%,50m
33841,1,VKaz,2375,88,3,1,4,75.0%,26m
33841,1,Pegasus,2375,96,3,8,11,27.3%,10m
33841,1,NAhujuBombel,2375,42,2,1,3,66.7%,50m
33841,1,[DMTN]Xanatha,2375,44,2,1,3,66.7%,3m
33841,2,Mentos,2375,0,2,3,5,40.0%,1h
33841,1,giusetto,2375,0,1,0,1,100.0%,8m
33841,3,Flimflamfox,2375,0,1,1,2,50.0%,1h
33841,1,[BPX]Buddy,2375,0,1,4,5,20.0%,7m
33841,1,Croce,2375,0,0,1,1,0.0%,47m
33841,1,snyggkexe,2375,0,0,1,1,0.0%,47m
33841,1,Arsdor,2375,0,0,1,1,0.0%,1h
33841,3,[BR4H]DrakeBRAH,2375,0,0,2,2,0.0%,1h
33859,2,[tnt]bytethunder,2374,1621,369,365,734,50.3%,57m
33859,3,Мощнятский,2374,1191,75,76,151,49.7%,58m
33859,1,Avalon,2374,1457,64,51,115,55.7%,51m
33859,3,Venom,2374,810,28,31,59,47.5%,52m
33859,2,GlTRON,2374,493,17,21,38,44.7%,10m
33859,3,starcrAYEft,2374,377,14,10,24,58.3%,37m
33859,1,[Лохи]Mefytrap,2374,326,11,6,17,64.7%,7m
33859,3,ordWeist,2374,308,10,10,20,50.0%,50m
33859,3,KaEmIks,2374,30,4,5,9,44.4%,46m
33859,1,Tar,2374,166,4,5,9,44.4%,2m
33859,3,Conman,2374,140,4,5,9,44.4%,3m
33859,1,Ragnarokk,2374,147,4,6,10,40.0%,45m
33859,1,Milkyway,2374,48,2,5,7,28.6%,49m
33859,2,IIIIIIIIIIII,2374,38,1,2,3,33.3%,1h
33859,3,LiMoN,2374,0,0,1,1,0.0%,38m
33859,1,IlyasBP,2374,0,0,2,2,0.0%,54m
33859,1,NAUTICER,2374,0,0,3,3,0.0%,57m
33876,2,Zin,2373,870,228,222,450,50.7%,1h
33876,3,[GAMI]Valounours,2373,1289,82,71,153,53.6%,52m
33876,1,DJEMO,2373,1226,45,49,94,47.9%,44m
33876,1,Autechre,2373,645,32,32,64,50.0%,30m
33876,1,bukin,2373,741,26,18,44,59.1%,60m
33876,1,RedQueen,2373,694,19,23,42,45.2%,1h
33876,1,Patan,2373,589,16,12,28,57.1%,1h
33876,2,Tessellator,2373,250,9,15,24,37.5%,1h
33876,1,Alfros,2373,129,4,8,12,33.3%,12m
33876,2,[Petrus]louma,2373,72,3,10,13,23.1%,1h
33876,1,руся,2373,82,2,1,3,66.7%,9m
33876,2,ШУРИК,2373,0,2,3,5,40.0%,32m
33876,1,Mario,2373,0,2,4,6,33.3%,1h
33876,1,Priest,2373,0,1,0,1,100.0%,44m
33876,3,Pirial,2373,0,1,0,1,100.0%,4m
33876,2,CreepZergSix,2373,0,1,4,5,20.0%,5m
33876,2,Kupsef,2373,94,1,5,6,16.7%,1h
33876,1,картошка,2373,0,1,5,6,16.7%,34m
33876,3,[Cancro]NightMareCPU,2373,0,1,5,6,16.7%,46m
33876,1,Gab,2373,0,0,2,2,0.0%,39m
33876,1,caman,2373,0,0,2,2,0.0%,1h
33897,2,igor,2372,1332,156,160,316,49.4%,34m
33897,1,Kitten,2372,672,112,118,230,48.7%,1h
33897,1,ChikiPuki,2372,1836,75,74,149,50.3%,42m
33897,3,Jolasticot,2372,984,37,43,80,46.2%,52m
33897,3,Zoldon,2372,604,28,28,56,50.0%,41m
33897,1,PatataMagica,2372,642,22,17,39,56.4%,42m
33897,1,Sparta,2372,718,20,16,36,55.6%,6m
33897,3,Civvic,2372,383,17,23,40,42.5%,32m
33897,2,Reg,2372,244,9,19,28,32.1%,40m
33897,2,[FYT]kek,2372,232,6,14,20,30.0%,38m
33897,2,Icarus,2372,184,6,15,21,28.6%,57m
33897,3,koWyE,2372,184,6,15,21,28.6%,29m
33897,3,Ythi,2372,90,5,8,13,38.5%,56m
33897,1,majk,2372,208,5,8,13,38.5%,30m
33897,1,[BWArmy]FreeMmrGiver,2372,168,4,2,6,66.7%,46m
33897,1,Baps,2372,48,3,6,9,33.3%,5m
33897,1,NasikFury,2372,48,2,1,3,66.7%,43m
33897,1,TOnOTyH,2372,38,2,2,4,50.0%,53m
33897,1,Kaizoku,2372,0,2,3,5,40.0%,42m
33897,3,TaSeAn,2372,122,2,8,10,20.0%,59m
33897,1,SieStein,2372,0,1,0,1,100.0%,5m
33897,1,keffir,2372,0,1,1,2,50.0%,46m
33897,2,[Heroes]DrBram,2372,88,1,4,5,20.0%,36m
33897,1,Krzysztofeł,2372,42,1,6,7,14.3%,6m
33921,3,Alfred,2371,1366,44,71,115,38.3%,7m
33921,3,kkrotztheii,2371,284,25,32,57,43.9%,3m
33921,1,[VGZR]Swaffeln,2371,440,15,12,27,55.6%,34m
33921,3,[WHIM74]Chamanboubou,2371,364,15,17,32,46.9%,3m
33921,1,dragonkiller,2371,328,9,3,12,75.0%,1h
33921,2,Leonardo,2371,259,9,12,21,42.9%,42m
33921,1,RoY,2371,378,9,12,21,42.9%,50m
33921,1,BEAST,2371,240,6,8,14,42.9%,11m
33921,1,Kratos,2371,126,3,2,5,60.0%,11m
33921,2,KeLboCu,2371,0,3,2,5,60.0%,52m
33921,2,[RSGANG]dedboi,2371,0,2,5,7,28.6%,12m
33921,3,lawgamer,2371,0,2,6,8,25.0%,1h
33921,1,qiwi,2371,115,1,3,4,25.0%,1h
33921,1,Danikray,2371,46,1,4,5,20.0%,57m
33921,1,LordDarol,2371,0,0,1,1,0.0%,10m
33921,1,[Sbcr]prostoplay,2371,0,0,1,1,0.0%,42m
33921,1,Zaraziteli,2371,0,0,2,2,0.0%,46m
33921,3,nikita,2371,0,0,3,3,0.0%,9m
33939,3,Rambo,2370,939,82,89,171,48.0%,57m
33939,3,[STRO]Cristi,2370,1168,42,48,90,46.7%,43m
33939,1,graaaaa,2370,744,23,21,44,52.3%,10m
33939,1,[iJaG]mutabor,2370,391,14,15,29,48.3%,57m
33939,1,[TBDM]Ulamog,2370,336,8,5,13,61.5%,50m
33939,1,StinkyBell,2370,217,6,6,12,50.0%,1h
33939,1,funny,2370,202,5,3,8,62.5%,9m
33939,1,[cx]Mexx,2370,84,4,6,10,40.0%,40m
33939,3,Jokk,2370,127,4,9,13,30.8%,2m
33939,1,Anigilator,2370,88,3,2,5,60.0%,53m
33939,1,redterror,2370,48,2,2,4,50.0%,45m
33939,1,Valentin,2370,0,2,4,6,33.3%,46m
33939,1,gee,2370,0,2,5,7,28.6%,11m
33939,1,[izako]BoarsKratos,2370,0,1,0,1,100.0%,58m
33939,2,MMG,2370,0,1,4,5,20.0%,1h
33939,3,[TLML]TLTROOPER,2370,0,0,7,7,0.0%,28m
33955,2,BBQMaster,2369,769,81,81,162,50.0%,54m
33955,1,Diman,2369,1013,45,36,81,55.6%,28m
33955,3,Kahan,2369,940,40,35,75,53.3%,53m
33955,1,Piche,2369,606,27,29,56,48.2%,47m
33955,3,ILNUR,2369,315,11,17,28,39.3%,51m
33955,3,ichor,2369,214,8,52,60,13.3%,16m
33955,3,Arkad,2369,166,6,6,12,50.0%,48m
33955,1,[SC2GB]Dexter,2369,97,4,2,6,66.7%,1h
33955,1,mantas,2369,97,2,4,6,33.3%,32m
33955,1,Astrello,2369,95,2,5,7,28.6%,28m
33955,1,Souldancer,2369,0,2,5,7,28.6%,38m
33955,1,[NIHED]PIROSKALOZ,2369,46,1,4,5,20.0%,28m
33955,1,Хардбасыч,2369,0,1,4,5,20.0%,32m
33955,1,[HiumT]Miilyh,2369,0,0,1,1,0.0%,28m
33955,1,minesis,2369,0,0,1,1,0.0%,3m
33970,2,Vegas,2368,1540,70,79,149,47.0%,38m
33970,1,MaxxeN,2368,611,45,26,71,63.4%,12m
33970,1,[UNBR]shveiser,2368,797,28,19,47,59.6%,1h
33970,2,TauntiO,2368,730,28,39,67,41.8%,17m
33970,3,[Hybrid]Boboklatttt,2368,559,21,24,45,46.7%,12m
33970,1,Syllasie,2368,279,12,13,25,48.0%,49m
33970,1,Krechet,2368,235,6,5,11,54.5%,42m
33970,1,Tedik,2368,130,4,2,6,66.7%,58m
33970,1,Sirithcam,2368,145,3,6,9,33.3%,2m
33970,3,TheGhost,2368,106,2,5,7,28.6%,56m
33970,2,[STMS]Nayoko,2368,0,1,3,4,25.0%,49m
33970,2,irbis,2368,0,1,4,5,20.0%,32m
33970,3,[SymWar]mmt,2368,30,1,4,5,20.0%,30m
33970,1,Tethar,2368,0,0,1,1,0.0%,53m
33970,1,[H0C]Kuslja,2368,0,0,1,1,0.0%,28m
33970,1,csqe,2368,0,0,2,2,0.0%,60m
33986,3,[KuRaKi]Padzak,2367,1390,200,193,393,50.9%,41m
33986,3,[ExTr1m]IZI,2367,1525,94,87,181,51.9%,32m
33986,1,лананечеч,2367,695,30,17,47,63.8%,12m
33986,1,[НОД17]Delonge,2367,508,17,31,48,35.4%,60m
33986,1,[SW69]Uchiha,2367,493,14,12,26,53.8%,39m
33986,2,MrProTest,2367,264,9,12,21,42.9%,11m
33986,1,OSHO,2367,206,4,3,7,57.1%,55m
33986,1,[Piwka]Bluelos,2367,112,4,3,7,57.1%,49m
33986,1,[GWN]idanmenashes,2367,46,3,4,7,42.9%,50m
33986,1,[FAJ]EiMin,2367,42,2,0,2,100.0%,1h
33986,1,WINTER,2367,42,2,1,3,66.7%,11m
33986,1,Damo,2367,0,1,5,6,16.7%,31m
33986,1,[ONI62]LoSgrullo,2367,0,0,1,1,0.0%,50m
33986,1,Scrofula,2367,0,0,5,5,0.0%,11m
34000,1,Zeratul,2366,1262,114,140,254,44.9%,11m
34000,2,Focktor,2366,1083,91,92,183,49.7%,42m
34000,2,RIVERDALE,2366,1246,50,46,96,52.1%,7m
34000,3,HeartsStars,2366,304,46,46,92,50.0%,30m
34000,1,Imperator,2366,1184,42,36,78,53.8%,1h
34000,1,Waldo,2366,896,26,24,50,52.0%,58m
34000,1,Kraken,2366,608,19,22,41,46.3%,3m
34000,1,abce,2366,573,18,25,43,41.9%,44m
34000,3,sudoVoid,2366,403,15,23,38,39.5%,32m
34000,1,scrimers,2366,492,13,16,29,44.8%,50m
34000,3,SatoriKomeji,2366,172,7,7,14,50.0%,60m
34000,1,Maru,2366,90,6,10,16,37.5%,1h
34000,2,babadoockk,2366,204,6,12,18,33.3%,1h
34000,1,[HATE]keule,2366,156,5,7,12,41.7%,1h
34000,2,VanishGolg,2366,0,4,1,5,80.0%,7m
34000,3,FellowCitize,2366,122,3,6,9,33.3%,28m
34000,1,Szajba,2366,84,2,4,6,33.3%,34m
34000,1,Eskei,2366,88,2,6,8,25.0%,1h
34000,1,[KECHU]SouL,2366,0,1,1,2,50.0%,52m
34000,1,Batman,2366,46,1,2,3,33.3%,60m
34000,1,[CZwd]Ravenas,2366,44,1,4,5,20.0%,49m
34000,2,General,2366,0,1,4,5,20.0%,1m
34000,1,banraju,2366,0,0,1,1,0.0%,57m
34000,1,[StarWs]Meegon,2366,0,0,1,1,0.0%,7m
34000,1,Moose,2366,0,0,1,1,0.0%,10m
34000,1,[PÂRłAH]KUMI,2366,0,0,1,1,0.0%,50m
34000,1,logonihiht,2366,0,0,2,2,0.0%,28m
34000,3,PingWon,2366,0,0,3,3,0.0%,28m
34028,3,Luxck,2365,715,32,23,55,58.2%,56m
34028,3,aliciadiazz,2365,712,31,23,54,57.4%,50m
34028,1,Blubbi,2365,487,16,8,24,66.7%,1h
34028,1,larissa,2365,292,12,12,24,50.0%,1h
34028,2,Bloodcraft,2365,140,6,6,12,50.0%,1h
34028,3,[DoAII]Soulrazy,2365,168,5,6,11,45.5%,11m
34028,1,LoNzrEt,2365,82,3,3,6,50.0%,59m
34028,1,[ACBMBL]Davidino,2365,42,2,2,4,50.0%,30m
34028,1,RedRosa,2365,145,2,2,4,50.0%,1h
34028,3,UncleBob,2365,0,2,6,8,25.0%,32m
34028,1,[EWEN]youtube,2365,0,1,1,2,50.0%,45m
34028,1,robar,2365,42,1,3,4,25.0%,52m
34028,2,nazar,2365,0,1,4,5,20.0%,31m
34028,1,Flame,2365,0,1,4,5,20.0%,46m
34028,1,AngUs,2365,0,0,1,1,0.0%,1h
34028,1,[LOGS]Jylle,2365,0,0,1,1,0.0%,12m
34028,1,[ReBrG]Durruti,2365,0,0,1,1,0.0%,53m
34028,1,Leechoss,2365,0,0,2,2,0.0%,42m
34046,3,BDog,2364,878,117,113,230,50.9%,35m
34046,3,Marsvinet,2364,720,75,54,129,58.1%,51m
34046,1,Nyél,2364,695,21,16,37,56.8%,1h
34046,1,Seleucos,2364,524,16,11,27,59.3%,35m
34046,1,Plagegeist,2364,200,6,5,11,54.5%,1h
34046,2,Fotis,2364,164,6,9,15,40.0%,10m
34046,3,Brontos,2364,180,6,13,19,31.6%,47m
34046,3,lal,2364,30,5,3,8,62.5%,30m
34046,1,Adur,2364,160,5,8,13,38.5%,1h
34046,1,LGD,2364,128,4,6,10,40.0%,48m
34046,1,Zeus,2364,145,3,3,6,50.0%,46m
34046,1,QuEZz,2364,44,2,0,2,100.0%,48m
34046,1,Gumzig,2364,0,2,5,7,28.6%,40m
34046,1,ShterenbergS,2364,0,1,0,1,100.0%,59m
34046,3,NoBrain,2364,95,1,4,5,20.0%,11m
34046,1,louded,2364,0,0,6,6,0.0%,40m
34062,3,LUX,2363,1190,48,48,96,50.0%,32m
34062,1,Bajula,2363,480,16,9,25,64.0%,43m
34062,1,Knight,2363,217,8,12,20,40.0%,1h
34062,1,DarkWolf,2363,225,6,1,7,85.7%,46m
34062,2,wandtapete,2363,161,5,9,14,35.7%,4m
34062,1,lfybkf,2363,0,3,7,10,30.0%,2m
34062,2,Antidope,2363,0,2,3,5,40.0%,6m
34062,1,титан,2363,120,2,5,7,28.6%,29m
34062,1,LEGENDA,2363,0,1,0,1,100.0%,4m
34062,1,Widowmaker,2363,0,1,4,5,20.0%,37m
34062,1,DeadlyKayzer,2363,44,1,5,6,16.7%,53m
34062,3,Sonic,2363,30,1,7,8,12.5%,58m
34062,1,ZoukBuster,2363,0,0,3,3,0.0%,54m
34062,2,[RATTIG]Uncoro,2363,0,0,5,5,0.0%,1h
34076,3,Skvor,2362,1009,46,49,95,48.4%,52m
34076,1,berismode,2362,868,27,29,56,48.2%,43m
34076,1,dinozavarapz,2362,674,24,19,43,55.8%,45m
34076,1,COSMO,2362,704,24,23,47,51.1%,55m
34076,1,Elgar,2362,404,12,9,21,57.1%,30m
34076,3,Mihanic,2362,217,7,7,14,50.0%,39m
34076,3,Bettastar,2362,235,7,11,18,38.9%,1h
34076,1,Firestorm,2362,200,5,4,9,55.6%,29m
34076,1,[piknes]Tagst,2362,145,4,4,8,50.0%,37m
34076,1,Term,2362,160,4,10,14,28.6%,48m
34076,1,[zukaCo]benjamin,2362,42,3,4,7,42.9%,1h
34076,1,Kozmogorov,2362,0,2,4,6,33.3%,40m
34076,1,Prezident,2362,0,1,1,2,50.0%,26m
34076,1,Kirua,2362,0,1,4,5,20.0%,49m
34076,1,Jktulord,2362,44,1,5,6,16.7%,8m
34076,3,Phorhud,2362,0,1,5,6,16.7%,51m
34076,1,Nick,2362,0,1,5,6,16.7%,44m
34076,1,[IGRTWI]GlobalRak,2362,0,0,1,1,0.0%,49m
34076,1,frei,2362,0,0,3,3,0.0%,47m
34095,1,СвятйНиколай,2361,1023,38,27,65,58.5%,45m
34095,3,[gogone]Unkh,2361,921,36,36,72,50.0%,12m
34095,1,citrus,2361,1064,33,37,70,47.1%,47m
34095,3,oneshot,2361,170,30,35,65,46.2%,4m
34095,1,Fusler,2361,499,19,16,35,54.3%,39m
34095,2,[MCKH]xädis,2361,492,19,27,46,41.3%,42m
34095,3,DIO,2361,454,17,17,34,50.0%,53m
34095,3,[Cheel]oler,2361,309,11,13,24,45.8%,44m
34095,2,Szwagier,2361,279,10,13,23,43.5%,9m
34095,1,Krafter,2361,236,7,5,12,58.3%,35m
34095,1,[TFSC]Helitacker,2361,196,5,2,7,71.4%,60m
34095,1,SHMELru,2361,206,5,5,10,50.0%,1m
34095,1,[fFlags]Reeve,2361,135,4,5,9,44.4%,45m
34095,1,panda,2361,145,3,2,5,60.0%,51m
34095,1,Cybernetics,2361,42,2,0,2,100.0%,60m
34095,1,ScHwOnZfAcE,2361,44,2,2,4,50.0%,42m
34095,3,Qwertypas,2361,96,2,6,8,25.0%,32m
34095,1,legertes,2361,0,1,0,1,100.0%,49m
34095,1,Владыка,2361,0,1,0,1,100.0%,10m
34095,2,meshok,2361,0,1,4,5,20.0%,31m
34095,1,Oberox,2361,0,1,4,5,20.0%,59m
34095,1,Kookadu,2361,0,0,1,1,0.0%,6m
34095,3,Bronske,2361,0,0,2,2,0.0%,36m
34095,2,Arahmid,2361,0,0,5,5,0.0%,49m
34095,2,Кукс,2361,0,0,5,5,0.0%,54m
34120,3,SERG,2360,1544,315,300,615,51.2%,13m
34120,3,storm,2360,1091,115,114,229,50.2%,50m
34120,1,Flori,2360,1418,45,44,89,50.6%,1h
34120,3,[BamBum]Ulitka,2360,1161,45,57,102,44.1%,50m
34120,1,Jvz,2360,643,23,13,36,63.9%,10m
34120,3,[OXs]Alpha,2360,521,18,21,39,46.2%,37m
34120,3,Edvinab,2360,380,16,7,23,69.6%,1h
34120,1,elektrik,2360,562,16,10,26,61.5%,60m
34120,1,Purivan,2360,406,11,12,23,47.8%,1h
34120,3,[B1B]Allinadin,2360,290,10,9,19,52.6%,32m
34120,1,shagernaut,2360,173,7,15,22,31.8%,1h
34120,1,RobotWizard,2360,202,6,1,7,85.7%,3m
34120,1,axo,2360,151,6,7,13,46.2%,58m
34120,1,StuntS,2360,203,5,3,8,62.5%,9m
34120,1,Ben,2360,210,5,10,15,33.3%,12m
34120,1,HoneyImHome,2360,145,3,6,9,33.3%,49m
34120,1,KoosKansloos,2360,153,2,4,6,33.3%,30m
34120,1,Prdak,2360,0,1,1,2,50.0%,37m
34120,3,ellkill,2360,0,1,4,5,20.0%,29m
34120,3,borninUSSR,2360,0,1,5,6,16.7%,2m
34120,1,Elengal,2360,0,0,3,3,0.0%,40m
34141,2,Aether,2359,1525,80,80,160,50.0%,38m
34141,1,wink,2359,1454,66,64,130,50.8%,52m
34141,1,Лердн,2359,1044,42,31,73,57.5%,37m
34141,3,ZoleeG,2359,387,24,28,52,46.2%,45m
34141,1,neponyal,2359,774,23,17,40,57.5%,7m
34141,3,asdf,2359,574,21,24,45,46.7%,34m
34141,1,Destiny,2359,608,19,15,34,55.9%,47m
34141,3,niwder,2359,119,4,6,10,40.0%,32m
34141,1,[KG312]Roy,2359,86,3,0,3,100.0%,48m
34141,1,eskaen,2359,118,3,4,7,42.9%,55m
34141,1,jok,2359,111,3,5,8,37.5%,1h
34141,1,Ullumafullu,2359,128,3,7,10,30.0%,11m
34141,3,Marek,2359,60,3,8,11,27.3%,26m
34141,3,[WG8]Offen,2359,30,2,2,4,50.0%,1h
34141,1,KABAH,2359,0,1,0,1,100.0%,1h
34141,1,[КПСС2]funter,2359,0,1,3,4,25.0%,50m
34141,1,CHILLMILL,2359,0,1,5,6,16.7%,1h
34141,1,Windbreeezer,2359,0,0,1,1,0.0%,12m
34141,1,PeaceNLove,2359,0,0,2,2,0.0%,50m
34141,1,emenƎy,2359,0,0,2,2,0.0%,52m
34161,1,Nagibator,2358,949,47,50,97,48.5%,6m
34161,3,Eldermann,2358,630,27,25,52,51.9%,4m
34161,1,Stijfhoer,2358,636,18,20,38,47.4%,43m
34161,3,Jurand,2358,525,18,22,40,45.0%,1h
34161,3,Viszlat,2358,371,14,15,29,48.3%,1h
34161,1,[13Rätt]Virkler,2358,420,13,6,19,68.4%,54m
34161,3,luchyk,2358,230,8,9,17,47.1%,50m
34161,1,FireSkull,2358,97,3,4,7,42.9%,43m
34161,1,Ximik,2358,44,3,4,7,42.9%,1h
34161,3,Mortimer,2358,121,2,4,6,33.3%,1h
34161,1,keomix,2358,36,2,5,7,28.6%,1h
34161,3,BARAKUDA,2358,0,2,6,8,25.0%,1h
34161,2,Zvereff,2358,60,2,9,11,18.2%,48m
34161,1,HANSOLO,2358,0,1,0,1,100.0%,44m
34161,1,[PGYT]Retamik,2358,0,1,0,1,100.0%,55m
34161,1,WolvezZ,2358,36,1,3,4,25.0%,60m
34161,1,Volir,2358,0,1,3,4,25.0%,49m
34161,2,[JML2]heavyhikai,2358,0,1,4,5,20.0%,51m
34161,1,zorh,2358,0,1,4,5,20.0%,1h
34161,1,ArtTeam,2358,0,0,1,1,0.0%,1h
34181,2,ActiveDK,2357,1451,79,69,148,53.4%,60m
34181,1,Ulysse,2357,771,28,25,53,52.8%,10m
34181,3,Sudia,2357,591,27,31,58,46.6%,53m
34181,3,[CGEO]Tirorero,2357,428,21,25,46,45.7%,2m
34181,3,Golz,2357,546,19,22,41,46.3%,40m
34181,1,lilKUS,2357,350,12,6,18,66.7%,7m
34181,1,Ikajin,2357,364,10,8,18,55.6%,55m
34181,1,Zureel,2357,272,8,7,15,53.3%,1h
34181,1,ChapperSRI,2357,288,8,7,15,53.3%,53m
34181,3,[Тянки]Nikollya,2357,218,7,4,11,63.6%,43m
34181,1,noname,2357,130,3,3,6,50.0%,10m
34181,1,ZOODARK,2357,97,2,2,4,50.0%,51m
34181,1,Xces,2357,0,2,5,7,28.6%,53m
34181,1,[RstE]Bibow,2357,96,2,6,8,25.0%,51m
34181,1,Croker,2357,0,0,1,1,0.0%,7m
34196,3,Клim,2356,1431,62,52,114,54.4%,51m
34196,3,[IBIZA]Lagrangeson,2356,787,40,41,81,49.4%,47m
34196,2,rusiam,2356,732,28,30,58,48.3%,52m
34196,3,Dropbear,2356,737,27,33,60,45.0%,29m
34196,1,kiritoasina,2356,730,23,18,41,56.1%,57m
34196,1,pumpel,2356,580,18,13,31,58.1%,52m
34196,3,IIIIIIIIIIII,2356,210,17,24,41,41.5%,30m
34196,2,Kovalexius,2356,468,15,20,35,42.9%,26m
34196,1,[Olеg]SazZaks,2356,404,13,14,27,48.1%,57m
34196,2,Xeno,2356,242,8,7,15,53.3%,56m
34196,1,[Nsight]andrei,2356,284,7,8,15,46.7%,28m
34196,1,[TExGG]Brink,2356,212,6,7,13,46.2%,49m
34196,1,patriots,2356,179,5,6,11,45.5%,29m
34196,3,Obanze,2356,126,5,9,14,35.7%,53m
34196,3,Koah,2356,140,4,4,8,50.0%,36m
34196,3,[ORPY]Maki,2356,81,4,12,16,25.0%,11m
34196,1,RedPatrick,2356,0,2,1,3,66.7%,10m
34196,1,YNe,2356,0,2,3,5,40.0%,40m
34196,1,HooCee,2356,0,0,1,1,0.0%,1h
34196,1,Wąski,2356,0,0,4,4,0.0%,40m
34216,1,[XeTeX]naeu,2355,1773,131,131,262,50.0%,1h
34216,3,Criss,2355,1299,89,85,174,51.1%,9m
34216,3,[HEАT]CHE,2355,237,26,30,56,46.4%,44m
34216,1,[Чайник]Nordlord,2355,627,17,16,33,51.5%,47m
34216,1,[Astra]Polykarp,2355,436,12,12,24,50.0%,11m
34216,3,[Nýx]Bjorn,2355,241,11,11,22,50.0%,46m
34216,3,Skinski,2355,58,6,4,10,60.0%,29m
34216,1,Fosh,2355,248,6,7,13,46.2%,1h
34216,3,gamadril,2355,193,5,10,15,33.3%,1h
34216,1,[GBrM]SpaceOddity,2355,170,4,3,7,57.1%,1h
34216,3,sasha,2355,58,4,7,11,36.4%,56m
34216,1,Draz,2355,72,3,2,5,60.0%,28m
34216,1,[Kamael]SaJIamandR,2355,97,2,3,5,40.0%,57m
34216,1,Simok,2355,44,2,4,6,33.3%,30m
34216,1,oblivion,2355,97,2,5,7,28.6%,37m
34216,1,[mTx]Acquaragia,2355,88,2,6,8,25.0%,1h
34216,2,JustDanil,2355,0,1,0,1,100.0%,49m
34216,1,MAESTRO,2355,0,1,4,5,20.0%,1h
34216,2,Triduza,2355,0,1,4,5,20.0%,54m
34216,1,Kryper,2355,0,1,4,5,20.0%,44m
34216,3,tomek,2355,0,1,5,6,16.7%,60m
34237,1,WildWold,2354,1400,53,45,98,54.1%,10m
34237,1,Bakuś,2354,1095,36,30,66,54.5%,1h
34237,3,WILD,2354,1002,36,42,78,46.2%,4m
34237,1,eugine,2354,672,19,15,34,55.9%,30m
34237,3,britneyspear,2354,466,17,26,43,39.5%,12m
34237,2,[ZeCouZ]yohko,2354,254,10,10,20,50.0%,11m
34237,3,Annonymouse,2354,232,7,9,16,43.8%,37m
34237,3,[daktnt]mrtnt,2354,227,7,9,16,43.8%,54m
34237,1,Владос,2354,202,6,6,12,50.0%,1h
34237,1,Suntra,2354,248,6,8,14,42.9%,3m
34237,1,[LEZZO]parafinìco,2354,155,5,1,6,83.3%,35m
34237,3,Demonix,2354,147,4,8,12,33.3%,1h
34237,1,KAPEC,2354,151,3,15,18,16.7%,26m
34237,1,[TRÉBO]Oussam,2354,112,2,4,6,33.3%,53m
34237,1,Gosydarenkov,2354,97,2,5,7,28.6%,49m
34237,1,Kesha,2354,0,1,4,5,20.0%,43m
34237,1,blek,2354,0,1,4,5,20.0%,42m
34237,1,Keisim,2354,0,0,1,1,0.0%,12m
34237,1,Olvigera,2354,0,0,1,1,0.0%,3m
34256,3,respiner,2353,1366,86,84,170,50.6%,39m
34256,3,WastlSepp,2353,1175,76,77,153,49.7%,53m
34256,1,ILOoOLI,2353,1047,51,47,98,52.0%,6m
34256,1,andnev,2353,1200,35,41,76,46.1%,57m
34256,1,Rock,2353,576,19,17,36,52.8%,39m
34256,2,Analog,2353,518,19,19,38,50.0%,30m
34256,3,Timo,2353,362,16,14,30,53.3%,1h
34256,1,Rappe,2353,430,16,14,30,53.3%,46m
34256,1,OoNnEeSs,2353,592,16,17,33,48.5%,34m
34256,2,Cykron,2353,488,16,22,38,42.1%,57m
34256,3,fluchender,2353,378,13,17,30,43.3%,51m
34256,1,pashatexnik,2353,308,8,6,14,57.1%,26m
34256,1,Marvin,2353,190,8,15,23,34.8%,1h
34256,3,Bkozz,2353,216,6,10,16,37.5%,10m
34256,3,hobbyquaker,2353,173,5,7,12,41.7%,29m
34256,3,[VTKS]Voimant,2353,116,5,8,13,38.5%,1h
34256,3,[ICoCP]Sacantus,2353,147,4,11,15,26.7%,9m
34256,1,[ШиШаНы]BomBersem,2353,86,3,2,5,60.0%,40m
34256,3,XIdsiv,2353,116,3,3,6,50.0%,40m
34256,3,Absølute,2353,142,3,7,10,30.0%,60m
34256,1,[WowSpy]ZeroNet,2353,84,2,1,3,66.7%,1h
34256,1,Briz,2353,48,1,2,3,33.3%,28m
34256,2,Matrixxx,2353,0,0,1,1,0.0%,1h
34279,1,Scarecrow,2352,768,30,26,56,53.6%,35m
34279,2,Lobster,2352,418,17,23,40,42.5%,6m
34279,1,[NoMIC]Loki,2352,197,7,0,7,100.0%,49m
34279,1,Violet,2352,256,6,5,11,54.5%,1h
34279,3,MissingLink,2352,134,5,6,11,45.5%,29m
34279,2,Andruxa,2352,46,3,3,6,50.0%,59m
34279,3,miroCROpena,2352,60,3,8,11,27.3%,10m
34279,1,voidage,2352,0,1,0,1,100.0%,11m
34279,1,Alex,2352,0,1,0,1,100.0%,47m
34279,2,Follint,2352,0,1,2,3,33.3%,1h
34279,1,llJDll,2352,0,1,4,5,20.0%,55m
34279,1,TrollPumba,2352,0,0,1,1,0.0%,28m
34279,1,MrDeagle,2352,0,0,6,6,0.0%,51m
34292,3,RaScAsS,2351,1592,176,163,339,51.9%,13m
34292,3,outerloper,2351,1382,118,113,231,51.1%,41m
34292,3,icefofi,2351,932,92,75,167,55.1%,8m
34292,3,WaveRider,2351,1463,87,72,159,54.7%,28m
34292,1,BePTyH,2351,614,29,19,48,60.4%,57m
34292,1,EwokuChan,2351,712,26,37,63,41.3%,31m
34292,1,ArcyAdam,2351,698,21,40,61,34.4%,37m
34292,2,Painkiller,2351,530,19,27,46,41.3%,1h
34292,1,ColbeyB,2351,480,15,16,31,48.4%,56m
34292,3,[Evilii]Wedgeski,2351,374,12,22,34,35.3%,44m
34292,3,[orbita]smoke,2351,268,11,9,20,55.0%,52m
34292,1,VarGraben,2351,209,6,6,12,50.0%,42m
34292,1,[obi1k]ASWD,2351,197,5,5,10,50.0%,30m
34292,1,Dasfleih,2351,214,5,6,11,45.5%,1h
34292,3,Keelias,2351,172,5,8,13,38.5%,44m
34292,1,WinterSpirit,2351,48,2,1,3,66.7%,31m
34292,2,RavisS,2351,0,2,3,5,40.0%,58m
34292,2,гро,2351,0,1,0,1,100.0%,8m
34292,1,[54D]SkyNet,2351,42,1,1,2,50.0%,57m
34292,1,Marioc,2351,0,1,1,2,50.0%,1m
34292,1,Leakys,2351,30,1,2,3,33.3%,1h
34292,1,Google,2351,0,0,1,1,0.0%,53m
34292,2,Torygg,2351,0,0,1,1,0.0%,11m
34292,2,HypoCrite,2351,0,0,1,1,0.0%,53m
34316,2,IIIIIIIIIIII,2350,1553,153,158,311,49.2%,11m
34316,3,[Chariz]chrZZ,2350,1388,104,99,203,51.2%,11m
34316,3,Makaveli,2350,1465,96,96,192,50.0%,58m
34316,3,Voicely,2350,574,68,58,126,54.0%,30m
34316,2,[SPAINs]asheep,2350,533,20,29,49,40.8%,2m
34316,2,[DBL]Battlekilo,2350,184,6,12,18,33.3%,48m
34316,3,luux,2350,60,4,8,12,33.3%,27m
34316,1,ClikMan,2350,119,4,9,13,30.8%,30m
34316,1,Mojin,2350,76,3,2,5,60.0%,1h
34316,3,PsYcHo,2350,92,3,9,12,25.0%,35m
34316,1,Gogu,2350,42,2,2,4,50.0%,32m
34316,2,kirdamas,2350,0,1,1,2,50.0%,55m
34316,1,[Un00bz]SpecOps,2350,0,0,1,1,0.0%,37m
34316,1,DIMAS,2350,0,0,1,1,0.0%,35m
34330,3,Armageddon,2349,682,39,33,72,54.2%,12m
34330,1,MrGoldFish,2349,953,33,27,60,55.0%,34m
34330,3,Ezir,2349,509,20,24,44,45.5%,9m
34330,1,LONGSTRIKE,2349,514,16,15,31,51.6%,36m
34330,3,HecticKris,2349,334,13,18,31,41.9%,47m
34330,3,серж,2349,183,6,10,16,37.5%,60m
34330,3,Victormik,2349,170,5,8,13,38.5%,49m
34330,1,[Zaiger]HathoR,2349,210,5,10,15,33.3%,32m
34330,1,MrSemik,2349,162,4,6,10,40.0%,1h
34330,1,Hainex,2349,169,3,5,8,37.5%,42m
34330,1,Grishap,2349,0,1,0,1,100.0%,47m
34330,1,WithLove,2349,0,1,1,2,50.0%,32m
34330,2,shirohige,2349,0,1,3,4,25.0%,52m
34330,1,noobtactics,2349,0,1,4,5,20.0%,59m
34330,1,[AntiZ]bobinebond,2349,0,0,1,1,0.0%,30m
34330,1,vegetable,2349,0,0,1,1,0.0%,60m
34330,2,LastBastion,2349,0,0,2,2,0.0%,1h
34330,2,Nano,2349,0,0,2,2,0.0%,1h
34330,1,konefkoski,2349,0,0,2,2,0.0%,28m
34349,3,cades,2348,1524,105,97,202,52.0%,1h
34349,1,[Dralag]sMall,2348,976,29,31,60,48.3%,60m
34349,1,ауе,2348,707,27,20,47,57.4%,2m
34349,3,kyrtishman,2348,680,26,33,59,44.1%,32m
34349,1,[KÖRKAN]lithas,2348,769,24,20,44,54.5%,46m
34349,1,DeniSoS,2348,582,19,11,30,63.3%,6m
34349,3,titipolo,2348,406,13,22,35,37.1%,32m
34349,1,MagicBob,2348,314,9,5,14,64.3%,57m
34349,2,Zarin,2348,225,7,12,19,36.8%,9m
34349,1,Tharadon,2348,120,6,13,19,31.6%,56m
34349,3,Sylla,2348,169,5,0,5,100.0%,7m
34349,1,lilith,2348,0,4,3,7,57.1%,1h
34349,1,Alchemyst,2348,40,2,1,3,66.7%,5m
34349,1,Battlkille,2348,0,2,3,5,40.0%,28m
34349,1,GegGigt,2348,0,2,4,6,33.3%,42m
34349,1,[MDLeg]Fobos,2348,0,1,7,8,12.5%,5m
34349,1,Faer,2348,0,0,1,1,0.0%,51m
34349,1,ZeralTool,2348,0,0,1,1,0.0%,58m
34349,1,Ljoker,2348,0,0,2,2,0.0%,57m
34368,3,Lilou,2347,1403,64,62,126,50.8%,40m
34368,1,[holki]Madle,2347,765,26,20,46,56.5%,1h
34368,3,[DRÔLE]Kyubi,2347,650,23,27,50,46.0%,30m
34368,1,TerMinaToRz,2347,530,15,13,28,53.6%,12m
34368,1,TheJangler,2347,385,12,14,26,46.2%,45m
34368,3,DoTroXHD,2347,227,8,10,18,44.4%,29m
34368,1,Archalia,2347,212,5,7,12,41.7%,40m
34368,1,Draack,2347,170,4,7,11,36.4%,1h
34368,1,egorka,2347,97,3,4,7,42.9%,5m
34368,1,Nemaster,2347,97,2,3,5,40.0%,10m
34368,1,gabou,2347,0,1,5,6,16.7%,54m
34379,1,[FAJAS]berecikpl,2346,604,34,18,52,65.4%,54m
34379,3,danypata,2346,875,33,37,70,47.1%,57m
34379,1,VeTerran,2346,664,24,25,49,49.0%,11m
34379,1,Viggen,2346,487,16,22,38,42.1%,57m
34379,1,tivoli,2346,232,9,15,24,37.5%,1h
34379,3,SCV,2346,191,6,9,15,40.0%,3m
34379,2,Tesla,2346,147,6,10,16,37.5%,54m
34379,3,Nilf,2346,173,5,9,14,35.7%,46m
34379,3,Tasareo,2346,117,4,10,14,28.6%,53m
34379,3,[Zigu]AndreiMes,2346,94,3,11,14,21.4%,3m
34379,1,MohamedHewil,2346,42,2,1,3,66.7%,3m
34379,1,bluecraker,2346,44,2,5,7,28.6%,36m
34379,1,Rehabi,2346,97,2,5,7,28.6%,57m
34379,1,[FYBF]ASAP,2346,0,1,1,2,50.0%,56m
34379,1,[ЕМPIRE]Ебалай,2346,44,1,3,4,25.0%,57m
34379,2,Thraos,2346,30,1,9,10,10.0%,5m
34379,1,Dazi,2346,0,0,1,1,0.0%,30m
34379,1,Seraphim,2346,0,0,1,1,0.0%,1h
34397,3,Dandelion,2345,172,32,23,55,58.2%,4m
34397,1,Wadas,2345,1056,32,31,63,50.8%,35m
34397,1,Gansik,2345,877,31,20,51,60.8%,50m
34397,1,Dragon,2345,590,16,15,31,51.6%,10m
34397,1,Artanis,2345,413,11,12,23,47.8%,11m
34397,3,КузькинаМать,2345,258,9,9,18,50.0%,35m
34397,1,Fetish,2345,169,4,7,11,36.4%,41m
34397,1,SirSkeleton,2345,36,4,7,11,36.4%,1h
34397,1,mac,2345,126,3,5,8,37.5%,47m
34397,1,[Ɖŕąĩǵǿ]DuneRunner,2345,97,2,3,5,40.0%,44m
34397,1,Anatoly,2345,0,2,4,6,33.3%,57m
34397,2,fRaN,2345,0,2,6,8,25.0%,12m
34397,1,Evolucidity,2345,0,1,0,1,100.0%,11m
34397,1,[Nyyuko]Denicoma,2345,0,1,1,2,50.0%,34m
34397,1,Zerofriends,2345,40,1,1,2,50.0%,39m
34397,1,SirAaerious,2345,42,1,1,2,50.0%,37m
34397,3,Pietro,2345,0,1,1,2,50.0%,32m
34397,1,[Zhig]JOKER,2345,0,1,1,2,50.0%,35m
34397,2,Irbis,2345,0,1,4,5,20.0%,40m
34397,2,itheraelmini,2345,0,1,4,5,20.0%,47m
34397,1,Zhigilevsk,2345,0,0,1,1,0.0%,54m
34397,1,[okere]Adricool,2345,0,0,1,1,0.0%,31m
34397,1,[Youth]Oppai,2345,0,0,2,2,0.0%,1h
34420,3,Iarwain,2344,1478,99,93,192,51.6%,32m
34420,3,CATKILs,2344,945,42,35,77,54.5%,32m
34420,1,Sander,2344,712,24,27,51,47.1%,60m
34420,2,Gray,2344,562,21,31,52,40.4%,59m
34420,3,soergi,2344,142,7,10,17,41.2%,38m
34420,1,РусскийБоец,2344,121,4,3,7,57.1%,41m
34420,1,Sardak,2344,143,4,5,9,44.4%,60m
34420,1,евгений,2344,40,1,2,3,33.3%,55m
34420,1,NotAnOmen,2344,0,1,3,4,25.0%,40m
34420,1,Redgamer,2344,42,1,4,5,20.0%,47m
34420,2,[KCTV]KimJongNuke,2344,0,0,1,1,0.0%,1h
34420,1,DELiT,2344,0,0,1,1,0.0%,56m
34420,1,Mitch,2344,0,0,2,2,0.0%,11m
34420,1,Apatia,2344,0,0,2,2,0.0%,1h
34434,3,LeonID,2343,1469,116,109,225,51.6%,47m
34434,1,Baga,2343,759,46,44,90,51.1%,30m
34434,2,LazyTitan,2343,1072,40,46,86,46.5%,10m
34434,1,KriegGuard,2343,720,21,16,37,56.8%,1h
34434,3,zpkeks,2343,196,9,9,18,50.0%,10m
34434,1,Klim,2343,294,8,2,10,80.0%,1h
34434,1,timati,2343,207,7,8,15,46.7%,39m
34434,1,Vladimir,2343,202,7,12,19,36.8%,55m
34434,2,[DomPre]Garagok,2343,200,6,11,17,35.3%,55m
34434,1,[ConFed]Populus,2343,192,5,8,13,38.5%,1h
34434,1,BadRambo,2343,0,4,2,6,66.7%,1h
34434,3,[Тетере]Падре,2343,174,4,5,9,44.4%,60m
34434,3,mamba,2343,119,3,4,7,42.9%,4m
34434,1,IncomElisey,2343,44,2,2,4,50.0%,1h
34434,1,[SaloXD]WHAT,2343,84,2,3,5,40.0%,30m
34434,1,Lexa,2343,118,2,3,5,40.0%,46m
34434,2,soza,2343,36,2,10,12,16.7%,38m
34434,1,[TATW]INFECTED,2343,0,1,1,2,50.0%,1h
34434,3,salchikman,2343,94,1,4,5,20.0%,30m
34434,1,[BANW]Pablin,2343,0,0,1,1,0.0%,58m
34434,1,Duzzo,2343,0,0,1,1,0.0%,45m
34434,1,LeRigaud,2343,0,0,4,4,0.0%,6m
34456,2,TIME,2342,1552,180,192,372,48.4%,57m
34456,1,schnarphooo,2342,724,32,32,64,50.0%,2m
34456,3,Cael,2342,644,23,27,50,46.0%,53m
34456,1,TYRNIK,2342,629,21,21,42,50.0%,44m
34456,1,Vlad,2342,593,19,12,31,61.3%,2m
34456,1,[THANOS]Johnry,2342,658,18,17,35,51.4%,1h
34456,1,HolySheep,2342,382,15,8,23,65.2%,37m
34456,3,Tobi,2342,316,13,23,36,36.1%,19m
34456,2,Archeleos,2342,203,11,9,20,55.0%,58m
34456,3,Kerrigan,2342,296,10,20,30,33.3%,29m
34456,2,Haze,2342,212,8,13,21,38.1%,1h
34456,3,Rine,2342,222,7,7,14,50.0%,51m
34456,3,Adamisek,2342,171,4,3,7,57.1%,5m
34456,2,Viperx,2342,0,3,2,5,60.0%,5m
34456,3,Dinster,2342,30,2,2,4,50.0%,7m
34456,3,medalex,2342,60,2,8,10,20.0%,44m
34456,1,darkboss,2342,0,1,0,1,100.0%,9m
34456,1,Zumbalalla,2342,0,1,4,5,20.0%,46m
34456,1,Wander,2342,0,0,2,2,0.0%,58m
34475,1,Dozer,2341,1765,239,243,482,49.6%,1h
34475,3,Till,2341,1584,195,194,389,50.1%,39m
34475,3,DeathTheKid,2341,999,45,38,83,54.2%,45m
34475,1,dragos,2341,829,23,21,44,52.3%,52m
34475,1,Rangleklods,2341,369,14,13,27,51.9%,2m
34475,3,Leon,2341,360,14,14,28,50.0%,1h
34475,2,Lilit,2341,386,14,21,35,40.0%,1h
34475,1,[OUUH]Charogne,2341,296,9,3,12,75.0%,12m
34475,1,Panoramix,2341,329,9,7,16,56.2%,40m
34475,1,LazzaBBestia,2341,274,8,4,12,66.7%,1h
34475,1,TrashCan,2341,206,8,11,19,42.1%,40m
34475,2,Dex,2341,245,8,11,19,42.1%,46m
34475,3,resprom,2341,122,5,13,18,27.8%,1h
34475,3,Oznerol,2341,125,4,8,12,33.3%,26m
34475,1,[VPleb]BARONDEATH,2341,169,3,2,5,60.0%,1h
34475,1,[GlBB]kreykloltt,2341,44,2,2,4,50.0%,2m
34475,1,Fearless,2341,0,2,4,6,33.3%,51m
34475,3,DeathKnight,2341,0,2,5,7,28.6%,1h
34475,1,HANZO,2341,0,1,3,4,25.0%,51m
34475,1,upuaut,2341,0,1,4,5,20.0%,28m
34475,1,MARATILIUS,2341,0,0,1,1,0.0%,9m
34475,1,Bogus,2341,0,0,1,1,0.0%,44m
34497,3,Nikita,2340,1400,92,96,188,48.9%,56m
34497,1,Nelturion,2340,1406,51,57,108,47.2%,59m
34497,1,Anubirnabis,2340,1498,50,45,95,52.6%,53m
34497,2,Dakasnik,2340,560,22,24,46,47.8%,1h
34497,1,Kilit,2340,219,15,11,26,57.7%,7m
34497,1,TheElectron,2340,349,14,27,41,34.1%,4m
34497,1,miles,2340,412,11,11,22,50.0%,3m
34497,3,honiboi,2340,236,8,7,15,53.3%,6m
34497,3,Glayoss,2340,189,6,15,21,28.6%,41m
34497,1,Galaran,2340,196,5,5,10,50.0%,3m
34497,1,[STDES]dondiablo,2340,160,4,5,9,44.4%,35m
34497,1,sahar,2340,84,3,1,4,75.0%,54m
34497,1,ПроАртёмПро,2340,160,3,3,6,50.0%,1h
34497,3,OneWolf,2340,146,3,4,7,42.9%,53m
34497,1,Pynox,2340,144,3,5,8,37.5%,39m
34497,1,BananaGun,2340,82,2,9,11,18.2%,45m
34497,1,renkagop,2340,0,1,5,6,16.7%,1h
34497,1,WooDLee,2340,0,0,1,1,0.0%,58m
34515,3,killmemybaby,2339,569,68,71,139,48.9%,12m
34515,1,McFly,2339,946,35,35,70,50.0%,53m
34515,1,Lunæ,2339,888,34,17,51,66.7%,1h
34515,1,[KSMH]NOOBFRACS,2339,599,20,12,32,62.5%,1h
34515,3,Kira,2339,405,20,26,46,43.5%,8m
34515,1,Logon,2339,511,15,14,29,51.7%,58m
34515,3,HackfruchtB,2339,120,7,12,19,36.8%,3m
34515,2,Fabinho,2339,136,7,13,20,35.0%,10m
34515,1,SneakyMidget,2339,156,5,6,11,45.5%,57m
34515,1,Mogromir,2339,42,2,2,4,50.0%,34m
34515,1,Wyzogytu,2339,0,2,3,5,40.0%,50m
34515,3,froggbit,2339,30,2,5,7,28.6%,37m
34515,1,manokanaka,2339,48,2,6,8,25.0%,49m
34515,1,BabaHema,2339,48,2,6,8,25.0%,1h
34515,1,Oldboy,2339,0,1,0,1,100.0%,50m
34515,1,[WannaB]Rower,2339,48,1,1,2,50.0%,51m
34515,1,Achilles,2339,42,1,1,2,50.0%,1h
34515,1,zoro,2339,42,1,2,3,33.3%,28m
34515,1,ZaAiur,2339,0,1,4,5,20.0%,50m
34515,3,[Нrr]MarkKrass,2339,0,0,1,1,0.0%,58m
34535,2,vogelbot,2338,1154,76,78,154,49.4%,34m
34535,1,jinta,2338,803,72,65,137,52.6%,34m
34535,1,StageIV,2338,307,9,8,17,52.9%,34m
34535,1,rom,2338,289,7,12,19,36.8%,42m
34535,1,Muhh,2338,118,3,2,5,60.0%,1h
34535,1,good,2338,121,3,2,5,60.0%,48m
34535,1,Realoner,2338,120,3,5,8,37.5%,1h
34535,1,Ogrik,2338,117,3,6,9,33.3%,57m
34535,1,lukerman,2338,44,2,2,4,50.0%,12m
34535,1,Foidek,2338,44,2,3,5,40.0%,49m
34535,1,Barabasz,2338,0,1,0,1,100.0%,1h
34535,1,kramptame,2338,44,1,1,2,50.0%,12m
34535,1,Snoop,2338,42,1,2,3,33.3%,50m
34535,2,SpacedeadOff,2338,0,1,4,5,20.0%,51m
34535,1,bravo,2338,0,1,4,5,20.0%,11m
34535,1,Baxter,2338,0,0,1,1,0.0%,55m
34535,1,Panasonic,2338,0,0,1,1,0.0%,26m
34535,3,Андрей,2338,0,0,1,1,0.0%,1h
34535,1,[JaPP]JoKeR,2338,0,0,1,1,0.0%,1h
34535,1,Gulasch,2338,0,0,2,2,0.0%,57m
34535,1,Patryk,2338,0,0,3,3,0.0%,44m
34535,1,Человек,2338,0,0,5,5,0.0%,57m
34557,3,Starlight,2337,714,50,39,89,56.2%,28m
34557,1,gabrey,2337,335,9,5,14,64.3%,50m
34557,1,cAnAdA,2337,276,7,2,9,77.8%,1h
34557,1,ANDRII,2337,182,5,8,13,38.5%,28m
34557,1,FleX,2337,168,4,6,10,40.0%,42m
34557,1,[ERIC]Beaulaques,2337,196,4,10,14,28.6%,1h
34557,1,Katisha,2337,130,3,4,7,42.9%,44m
34557,1,OMGitsDennyZ,2337,0,1,0,1,100.0%,41m
34557,1,Eldoratto,2337,0,1,0,1,100.0%,1h
34557,1,[MC2SC2]emilelechat,2337,97,1,1,2,50.0%,45m
34557,1,GhostPants,2337,40,1,1,2,50.0%,46m
34557,2,stevendiesel,2337,0,1,4,5,20.0%,6m
34557,1,kempes,2337,0,0,4,4,0.0%,60m
34570,3,Merkaba,2336,743,149,142,291,51.2%,8m
34570,1,Falconer,2336,986,46,42,88,52.3%,36m
34570,3,nava,2336,397,45,45,90,50.0%,43m
34570,1,TRM,2336,1276,42,40,82,51.2%,1h
34570,3,HorroRist,2336,771,35,43,78,44.9%,36m
34570,3,[CTRLs]Pata,2336,630,24,27,51,47.1%,56m
34570,1,AZAROTH,2336,553,18,10,28,64.3%,40m
34570,1,FasBenDeR,2336,268,7,7,14,50.0%,54m
34570,1,Аммолит,2336,214,6,4,10,60.0%,4m
34570,2,MLyoube,2336,219,6,13,19,31.6%,1h
34570,3,ZogZog,2336,114,5,6,11,45.5%,58m
34570,3,Apfeltasche,2336,181,5,10,15,33.3%,9m
34570,1,NickRossNR,2336,169,5,13,18,27.8%,54m
34570,1,[Españ]aghalberto,2336,160,4,2,6,66.7%,40m
34570,1,qwertyokey,2336,44,3,4,7,42.9%,39m
34570,1,Gabija,2336,105,3,5,8,37.5%,11m
34570,1,[bonx]Remix,2336,84,2,1,3,66.7%,4m
34570,1,Юки,2336,97,2,5,7,28.6%,1h
34570,1,gekton,2336,0,1,1,2,50.0%,1h
34570,2,MYTHGOTIC,2336,0,1,2,3,33.3%,35m
34570,1,Dima,2336,48,1,2,3,33.3%,1h
34570,2,ЩЩЩЩЩЩЩЩЩЩЩЩ,2336,46,1,5,6,16.7%,7m
34570,1,Reedik,2336,0,0,1,1,0.0%,52m
34570,1,liberador,2336,0,0,2,2,0.0%,55m
34570,1,LYAGUSH,2336,0,0,3,3,0.0%,35m
34595,3,[oooboy]Baron,2335,1315,68,76,144,47.2%,10m
34595,3,Klænex,2335,291,40,34,74,54.1%,59m
34595,1,Zaliukas,2335,604,33,29,62,53.2%,35m
34595,1,Saty,2335,877,26,25,51,51.0%,52m
34595,1,matras,2335,610,18,16,34,52.9%,58m
34595,2,Lukas,2335,514,16,33,49,32.7%,49m
34595,1,[TExGG]TausendFisch,2335,244,7,4,11,63.6%,1h
34595,1,Componotus,2335,40,2,0,2,100.0%,52m
34595,1,Saratheas,2335,97,2,3,5,40.0%,53m
34595,1,akaNaka,2335,42,1,2,3,33.3%,1h
34595,1,Futurama,2335,42,1,2,3,33.3%,30m
34595,1,GnuPasta,2335,0,1,5,6,16.7%,40m
34595,1,Starfaktory,2335,0,0,1,1,0.0%,45m
34608,3,Kinkeid,2334,1362,201,200,401,50.1%,56m
34608,3,dnb,2334,1259,95,93,188,50.5%,26m
34608,1,Stantheman,2334,1476,64,60,124,51.6%,1h
34608,1,przem,2334,1171,47,35,82,57.3%,10m
34608,1,Pego,2334,1294,44,40,84,52.4%,10m
34608,3,Pippeli,2334,1028,35,46,81,43.2%,55m
34608,1,GreenNK,2334,361,12,14,26,46.2%,57m
34608,1,Stéphano,2334,280,11,18,29,37.9%,1h
34608,1,torlien,2334,305,8,3,11,72.7%,35m
34608,1,Servan,2334,143,7,3,10,70.0%,10m
34608,3,Alarion,2334,100,4,10,14,28.6%,13m
34608,1,Niktoon,2334,82,3,1,4,75.0%,50m
34608,3,XdeadshotX,2334,121,3,1,4,75.0%,27m
34608,1,pulse,2334,128,3,5,8,37.5%,1h
34608,1,AwpY,2334,86,3,7,10,30.0%,53m
34608,3,mishkagamy,2334,18,3,7,10,30.0%,1h
34608,1,toju,2334,142,2,4,6,33.3%,52m
34608,1,[LPR]raffa,2334,42,2,6,8,25.0%,32m
34608,1,Lycaner,2334,97,2,6,8,25.0%,8m
34608,3,[S06R]kiwiarmand,2334,0,1,4,5,20.0%,10m
34608,2,Eisenbrei,2334,0,1,4,5,20.0%,51m
34608,1,Schweppes,2334,0,1,5,6,16.7%,43m
34608,3,[NSCSC]Kirill,2334,0,0,1,1,0.0%,1h
34608,1,Dima,2334,0,0,1,1,0.0%,29m
34632,1,LLIMEJIb,2333,1365,47,47,94,50.0%,52m
34632,1,XxBELLZxX,2333,749,24,28,52,46.2%,1h
34632,1,DaiTo,2333,558,23,12,35,65.7%,51m
34632,1,blahblahblah,2333,392,13,29,42,31.0%,9m
34632,3,Regonzu,2333,204,7,11,18,38.9%,49m
34632,1,[mfxed]MokryLolek,2333,262,6,5,11,54.5%,50m
34632,1,[Zhig]остап,2333,146,4,7,11,36.4%,50m
34632,1,Joehardstock,2333,0,2,4,6,33.3%,52m
34632,1,[DEDAL]Hydra,2333,48,2,5,7,28.6%,34m
34632,1,HunterKiller,2333,0,1,0,1,100.0%,11m
34632,1,[Kagune]Firecore,2333,91,1,1,2,50.0%,52m
34632,1,jessto,2333,0,1,5,6,16.7%,31m
34632,1,Fishermen,2333,0,0,1,1,0.0%,52m
34632,1,Babazorro,2333,0,0,2,2,0.0%,49m
34632,1,ArMan,2333,0,0,2,2,0.0%,1h
34632,1,[K0RM2]Leonykt,2333,0,0,3,3,0.0%,2m
34648,1,Daffi,2332,1723,102,93,195,52.3%,8m
34648,1,Hyps,2332,955,28,34,62,45.2%,28m
34648,3,[CREPES]leo,2332,269,10,19,29,34.5%,58m
34648,3,NerV,2332,187,9,9,18,50.0%,36m
34648,3,llllllllllll,2332,296,9,17,26,34.6%,4m
34648,3,DBD,2332,156,7,12,19,36.8%,1h
34648,1,DouxPanda,2332,48,6,6,12,50.0%,10m
34648,3,Iceskin,2332,168,5,9,14,35.7%,38m
34648,1,FreeD,2332,165,4,5,9,44.4%,12m
34648,1,Angelisworld,2332,144,3,6,9,33.3%,30m
34648,1,AgentJC,2332,126,3,8,11,27.3%,49m
34648,1,Terminator,2332,48,2,0,2,100.0%,49m
34648,1,tobis,2332,84,2,4,6,33.3%,35m
34648,1,DonalDuck,2332,121,2,7,9,22.2%,1h
34648,3,DARKrozman,2332,0,2,7,9,22.2%,56m
34648,1,Raynik,2332,0,1,0,1,100.0%,40m
34648,1,angelcaido,2332,0,1,0,1,100.0%,7m
34648,1,DarkAngel,2332,0,1,1,2,50.0%,1h
34648,2,[рейнор]буба,2332,0,1,2,3,33.3%,28m
34648,2,ZElaw,2332,0,1,4,5,20.0%,1h
34648,2,kaleith,2332,0,1,4,5,20.0%,1m
34648,1,JonKarnage,2332,0,1,5,6,16.7%,59m
34648,1,Elbon,2332,0,0,2,2,0.0%,52m
34648,3,Koz,2332,0,0,3,3,0.0%,1h
34648,1,Bunraku,2332,73,0,6,6,0.0%,42m
34673,1,LomArt,2331,1721,86,69,155,55.5%,37m
34673,1,Pepote,2331,1672,71,66,137,51.8%,1h
34673,1,Dart,2331,637,20,24,44,45.5%,1h
34673,3,[Waste]Blume,2331,504,20,25,45,44.4%,2m
34673,1,MostRomero,2331,237,10,7,17,58.8%,57m
34673,3,Aliquid,2331,301,9,14,23,39.1%,33m
34673,2,MarrowGnawer,2331,191,7,11,18,38.9%,7m
34673,2,[Zhig]arturrium,2331,260,6,12,18,33.3%,11m
34673,2,ужж,2331,92,5,11,16,31.2%,1h
34673,1,Blushven,2331,121,4,2,6,66.7%,30m
34673,1,[RuVoid]JOKEP,2331,177,4,7,11,36.4%,8m
34673,1,Ferkart,2331,0,3,4,7,42.9%,10m
34673,2,Slowpost,2331,86,3,7,10,30.0%,42m
34673,3,Adam,2331,102,3,10,13,23.1%,1h
34673,3,oxonium,2331,30,2,4,6,33.3%,32m
34673,1,Subject,2331,42,2,5,7,28.6%,11m
34673,2,Deathnar,2331,0,1,0,1,100.0%,8m
34673,1,[Dahu]KserChew,2331,0,1,0,1,100.0%,52m
34673,1,[3Y]Арчер,2331,0,1,1,2,50.0%,50m
34673,1,vait,2331,40,1,2,3,33.3%,35m
34673,1,ThS,2331,0,1,4,5,20.0%,11m
34694,3,Lots,2330,1546,200,203,403,49.6%,1h
34694,1,[SeVenV]xexen,2330,1085,191,199,390,49.0%,53m
34694,2,Sedmin,2330,284,62,63,125,49.6%,30m
34694,1,DarkKain,2330,1380,56,35,91,61.5%,60m
34694,1,Drakot,2330,964,46,36,82,56.1%,39m
34694,1,kanut,2330,1280,42,40,82,51.2%,28m
34694,1,Bob,2330,485,29,28,57,50.9%,1h
34694,3,Manstein,2330,693,27,30,57,47.4%,12m
34694,1,Slipstream,2330,734,25,22,47,53.2%,37m
34694,3,MrT,2330,540,20,20,40,50.0%,59m
34694,1,Brutus,2330,358,12,9,21,57.1%,37m
34694,1,MarkerII,2330,204,10,5,15,66.7%,50m
34694,2,flycat,2330,203,8,13,21,38.1%,39m
34694,1,CONSUBI,2330,174,7,8,15,46.7%,60m
34694,1,[RBP3]KOVALSKI,2330,222,6,2,8,75.0%,6m
34694,2,Rexsone,2330,133,6,7,13,46.2%,6m
34694,1,Steve,2330,170,5,22,27,18.5%,41m
34694,2,andre,2330,0,3,2,5,60.0%,32m
34694,1,Géno,2330,78,3,2,5,60.0%,37m
34694,1,[IMoGsP]trollman,2330,117,2,5,7,28.6%,49m
34694,1,[НОД17]alex,2330,42,2,6,8,25.0%,9m
34694,1,Reyz,2330,0,1,1,2,50.0%,12m
34694,1,PuppyArmz,2330,0,1,3,4,25.0%,38m
34694,3,Chelovek,2330,0,1,6,7,14.3%,46m
34694,1,drwoswaa,2330,0,0,1,1,0.0%,1h
34694,1,[MG974]ArionWind,2330,0,0,1,1,0.0%,58m
34694,1,ablucian,2330,0,0,4,4,0.0%,55m
34721,1,SkewTheWise,2329,936,31,25,56,55.4%,40m
34721,3,KAMIKAZE,2329,670,24,30,54,44.4%,55m
34721,3,[ZERG7V]Inquisitor,2329,346,13,18,31,41.9%,44m
34721,3,kevdhore,2329,212,13,18,31,41.9%,1h
34721,1,Corsarius,2329,403,12,6,18,66.7%,1h
34721,1,illewess,2329,280,10,15,25,40.0%,40m
34721,1,ARX,2329,315,9,9,18,50.0%,1h
34721,1,Grubas,2329,252,8,11,19,42.1%,44m
34721,1,[NukeZ]DarkenersNEO,2329,162,6,6,12,50.0%,52m
34721,2,HAVOC,2329,208,6,8,14,42.9%,1h
34721,3,FFD,2329,123,3,2,5,60.0%,1h
34721,1,[PANDR1]EXCTNGerard,2329,109,3,3,6,50.0%,1h
34721,3,Spidhaz,2329,123,3,4,7,42.9%,52m
34721,1,PROTOS,2329,42,2,1,3,66.7%,37m
34721,1,JustEugene,2329,42,2,1,3,66.7%,11m
34721,3,Mrxant,2329,0,2,5,7,28.6%,27m
34721,1,stefakata,2329,0,1,0,1,100.0%,47m
34721,1,DiamondHACK,2329,38,1,2,3,33.3%,10m
34721,2,Wariacik,2329,0,1,4,5,20.0%,55m
34721,2,[Rafi]Lord,2329,0,1,4,5,20.0%,54m
34721,1,Kremenko,2329,0,0,1,1,0.0%,55m
34721,1,[JFKKen]ProtosLife,2329,0,0,2,2,0.0%,59m
34721,2,MecM,2329,0,0,2,2,0.0%,6m
34744,3,Vazor,2328,1465,152,148,300,50.7%,26m
34744,1,LaMaGrA,2328,1763,65,70,135,48.1%,8m
34744,3,NiceSpirit,2328,1203,46,58,104,44.2%,4m
34744,1,munapea,2328,382,11,7,18,61.1%,53m
34744,2,boredom,2328,218,10,9,19,52.6%,2m
34744,1,CharlesGecko,2328,266,9,3,12,75.0%,50m
34744,3,MayatniK,2328,152,7,11,18,38.9%,46m
34744,1,hobibit,2328,165,5,1,6,83.3%,35m
34744,1,Tankomen,2328,184,5,3,8,62.5%,43m
34744,1,BTV,2328,213,5,7,12,41.7%,1h
34744,3,Сервамп,2328,0,4,2,6,66.7%,4m
34744,1,Byoz,2328,144,4,5,9,44.4%,60m
34744,1,[MagicM]Titan,2328,149,3,1,4,75.0%,8m
34744,1,MrJack,2328,46,2,6,8,25.0%,35m
34744,2,ElestraGOD,2328,88,1,1,2,50.0%,1h
34744,1,Jillaxx,2328,42,1,2,3,33.3%,44m
34744,1,Plato,2328,42,1,3,4,25.0%,59m
34744,1,Ryan,2328,0,0,4,4,0.0%,26m
34762,1,newcommand,2327,1824,846,865,1711,49.4%,58m
34762,3,nisseirymden,2327,1545,154,149,303,50.8%,39m
34762,2,Beruch,2327,1468,73,67,140,52.1%,38m
34762,2,[HMarch]ptx,2327,820,31,35,66,47.0%,11m
34762,2,blizok,2327,556,22,26,48,45.8%,40m
34762,1,PanchoVilla,2327,585,17,13,30,56.7%,11m
34762,1,JlasSik,2327,454,13,17,30,43.3%,3m
34762,2,FROL,2327,258,11,18,29,37.9%,1h
34762,1,Krizalit,2327,42,3,4,7,42.9%,1h
34762,1,[SevRud]Sevan,2327,42,2,1,3,66.7%,54m
34762,1,[GSSCRY]StarKiller,2327,82,2,2,4,50.0%,42m
34762,1,RedJackPL,2327,88,2,6,8,25.0%,50m
34762,1,[AnQ]Oldie,2327,0,1,1,2,50.0%,42m
34762,2,MeshoK,2327,0,1,2,3,33.3%,4m
34762,2,Rachel,2327,0,1,4,5,20.0%,55m
34762,2,Strawberry,2327,0,1,4,5,20.0%,46m
34762,1,Plexxer,2327,0,1,4,5,20.0%,50m
34762,1,Snitchez,2327,0,1,5,6,16.7%,55m
34762,1,Femex,2327,0,1,7,8,12.5%,1h
34762,1,[SoMaLi]Therier,2327,0,0,1,1,0.0%,58m
34762,2,Fred,2327,0,0,5,5,0.0%,32m
34783,1,[gllv]Phoenix,2326,1660,63,65,128,49.2%,50m
34783,3,nestrato,2326,861,56,55,111,50.5%,43m
34783,2,Pokefels,2326,808,49,54,103,47.6%,34m
34783,1,Hallais,2326,755,26,32,58,44.8%,1h
34783,1,djredhat,2326,522,18,12,30,60.0%,1h
34783,1,Malaka,2326,395,15,17,32,46.9%,53m
34783,1,Cranium,2326,330,12,8,20,60.0%,52m
34783,1,Darkling,2326,239,9,6,15,60.0%,37m
34783,1,[PаK]Terran,2326,352,9,7,16,56.2%,6m
34783,1,DvjBazuka,2326,346,8,6,14,57.1%,28m
34783,1,Aldstone,2326,126,4,2,6,66.7%,40m
34783,3,felixtalaver,2326,90,4,10,14,28.6%,36m
34783,1,Lustig,2326,130,3,3,6,50.0%,40m
34783,1,MetalGod,2326,97,1,2,3,33.3%,26m
34783,1,Wargle,2326,42,1,3,4,25.0%,3m
34783,1,Korks,2326,0,0,1,1,0.0%,1h
34799,3,Intrepidibex,2325,1535,136,134,270,50.4%,6m
34799,3,noob,2325,504,38,39,77,49.4%,6m
34799,3,ILGAMST,2325,577,22,22,44,50.0%,1h
34799,2,Drak,2325,255,8,13,21,38.1%,1h
34799,1,[0CNCR]Nahaax,2325,194,6,4,10,60.0%,53m
34799,3,Drikce,2325,181,5,10,15,33.3%,1h
34799,1,[Deadln]Aksamit,2325,128,4,5,9,44.4%,13m
34799,1,[5D]Лесничий,2325,172,3,1,4,75.0%,6m
34799,1,Акакий,2325,93,3,3,6,50.0%,45m
34799,1,Ghost,2325,84,3,4,7,42.9%,1h
34799,1,DagothUr,2325,86,2,5,7,28.6%,1h
34799,2,кей,2325,0,1,0,1,100.0%,49m
34799,3,Robbibob,2325,0,1,5,6,16.7%,56m
34799,1,Sca,2325,0,1,6,7,14.3%,1h
34799,1,TeRiFy,2325,0,0,1,1,0.0%,53m
34799,2,Яша,2325,0,0,1,1,0.0%,54m
34799,1,Corolla,2325,0,0,1,1,0.0%,55m
34799,1,dyablobody,2325,0,0,1,1,0.0%,43m
34799,2,VeganBurrito,2325,0,0,5,5,0.0%,1h
34799,1,TillTerran,2325,0,0,5,5,0.0%,8m
34819,1,MegaMan,2324,513,16,11,27,59.3%,3m
34819,1,InkDaemon,2324,264,8,4,12,66.7%,12m
34819,1,CrAnKJoKeR,2324,97,4,4,8,50.0%,55m
34819,1,[SKGame]dsp,2324,120,3,1,4,75.0%,13m
34819,3,[HYÐRA]Lixn,2324,0,3,4,7,42.9%,5m
34819,1,Ferdinard,2324,84,2,2,4,50.0%,1h
34819,1,Lufox,2324,0,1,4,5,20.0%,1h
34819,3,JeanLuc,2324,30,1,5,6,16.7%,29m
34827,3,Seeloo,2323,1552,186,190,376,49.5%,41m
34827,1,TvInForest,2323,1218,136,129,265,51.3%,57m
34827,3,[Sclaq]Espadon,2323,1276,52,51,103,50.5%,53m
34827,1,[YAMZS]Yanek,2323,907,30,32,62,48.4%,12m
34827,1,[Zakel]Dinastix,2323,518,17,16,33,51.5%,1h
34827,3,Cosmo,2323,392,16,19,35,45.7%,13m
34827,1,[ГеРоИИ]БелТамплиер,2323,174,5,4,9,55.6%,44m
34827,2,Motverator,2323,141,4,7,11,36.4%,28m
34827,1,LoOM,2323,166,4,9,13,30.8%,51m
34827,1,Robustious,2323,110,3,4,7,42.9%,9m
34827,2,Alex,2323,0,3,6,9,33.3%,1h
34827,3,Drterran,2323,62,3,9,12,25.0%,28m
34827,2,Banis,2323,0,2,3,5,40.0%,31m
34827,1,bambucha,2323,0,2,6,8,25.0%,55m
34827,1,WMB,2323,0,1,0,1,100.0%,28m
34827,1,poLRed,2323,0,1,1,2,50.0%,57m
34827,1,METECUL,2323,0,1,5,6,16.7%,1h
34827,1,Hidaru,2323,0,0,2,2,0.0%,30m
34827,2,glistarista,2323,0,0,2,2,0.0%,31m
34846,1,Jakuza,2322,1829,190,184,374,50.8%,52m
34846,1,Sheldor,2322,304,10,12,22,45.5%,43m
34846,3,Inveker,2322,292,9,11,20,45.0%,47m
34846,3,DonOlympus,2322,216,8,13,21,38.1%,2m
34846,1,Grayser,2322,232,7,11,18,38.9%,43m
34846,1,tize,2322,238,6,11,17,35.3%,2m
34846,1,Bowback,2322,172,6,11,17,35.3%,36m
34846,1,Nerevarin,2322,194,5,3,8,62.5%,54m
34846,3,[LAP]Ares,2322,184,5,8,13,38.5%,9m
34846,2,[6P00L]SquidFighter,2322,176,5,43,48,10.4%,20m
34846,1,sloffenjager,2322,74,3,0,3,100.0%,55m
34846,1,Nubick,2322,44,2,1,3,66.7%,1h
34846,3,Pixter,2322,30,2,8,10,20.0%,41m
34846,1,[Tic2]Satrox,2322,0,1,0,1,100.0%,56m
34846,1,[Rooar]Vint,2322,42,1,1,2,50.0%,29m
34846,1,Sirith,2322,0,1,1,2,50.0%,56m
34846,2,Adisavix,2322,0,1,4,5,20.0%,55m
34846,1,Eliot,2322,0,0,1,1,0.0%,52m
34864,3,waze,2321,1369,169,159,328,51.5%,38m
34864,3,Anti,2321,208,28,26,54,51.9%,3m
34864,1,Maulwurfen,2321,852,27,33,60,45.0%,57m
34864,1,[2vs2v3]Blagovest,2321,162,4,3,7,57.1%,53m
34864,1,poduluboq,2321,118,4,3,7,57.1%,46m
34864,3,[Myrm]AKTIS,2321,155,4,8,12,33.3%,39m
34864,2,[TLGC]JiuZaa,2321,0,3,2,5,60.0%,11m
34864,1,Refsuion,2321,131,3,5,8,37.5%,28m
34864,3,BrucePain,2321,97,2,1,3,66.7%,1h
34864,1,[HaTaMB]CommanderEm,2321,42,2,2,4,50.0%,35m
34864,1,XapoH,2321,80,2,2,4,50.0%,1h
34864,3,[FlyDt]XeON,2321,97,1,3,4,25.0%,59m
34864,3,Anden,2321,0,1,5,6,16.7%,55m
34864,1,Kly,2321,0,0,1,1,0.0%,1h
34864,1,Dambo,2321,0,0,2,2,0.0%,1h
34879,1,[ŞỮҜǺ]ĘĿvįŖḀ,2320,1546,117,125,242,48.3%,11m
34879,1,Egbert,2320,1492,57,49,106,53.8%,34m
34879,1,Besylur,2320,1309,46,35,81,56.8%,60m
34879,3,gremelin,2320,1014,37,47,84,44.0%,2m
34879,1,DonConsti,2320,256,7,7,14,50.0%,1h
34879,1,Орион,2320,227,7,8,15,46.7%,1h
34879,3,FINGER,2320,169,4,5,9,44.4%,55m
34879,1,Darth,2320,136,3,3,6,50.0%,1h
34879,3,[VWaile]FuсkAgro,2320,0,3,8,11,27.3%,6m
34879,1,Antyangin,2320,0,1,0,1,100.0%,52m
34879,1,DenisBelarus,2320,36,1,2,3,33.3%,28m
34879,1,Spacefly,2320,42,1,3,4,25.0%,32m
34879,1,paskiss,2320,48,1,3,4,25.0%,51m
34879,2,Winsth,2320,0,1,4,5,20.0%,1h
34879,2,Phantasma,2320,0,1,4,5,20.0%,1h
34879,1,FlameArt,2320,96,1,5,6,16.7%,42m
34879,1,Wattar,2320,0,1,5,6,16.7%,34m
34879,1,[PA2]BigDuck,2320,0,0,1,1,0.0%,46m
34879,1,IAN,2320,0,0,1,1,0.0%,1h
34879,1,Petroslav,2320,0,0,2,2,0.0%,1h
34879,3,Fluliath,2320,0,0,2,2,0.0%,27m
34879,1,Voiddd,2320,0,0,4,4,0.0%,1h
34901,3,Chaika,2319,1499,203,206,409,49.6%,13m
34901,2,tripleMerged,2319,1402,66,74,140,47.1%,1h
34901,1,BarackObama,2319,454,45,42,87,51.7%,4m
34901,1,bGd,2319,1029,35,31,66,53.0%,60m
34901,1,aquarius,2319,966,28,30,58,48.3%,50m
34901,3,Jerryh,2319,548,21,24,45,46.7%,55m
34901,2,jiqinowo,2319,278,10,11,21,47.6%,10m
34901,1,Zaur,2319,192,7,4,11,63.6%,49m
34901,1,[AOTW]Gaben,2319,203,5,10,15,33.3%,55m
34901,1,Savapas,2319,191,4,2,6,66.7%,59m
34901,2,Spurius,2319,48,4,3,7,57.1%,8m
34901,1,BlackDaddy,2319,174,4,7,11,36.4%,51m
34901,1,Carnem,2319,107,3,7,10,30.0%,6m
34901,2,[QWEZXC]Arcado,2319,30,3,7,10,30.0%,38m
34901,1,[voff]XpliT,2319,84,2,3,5,40.0%,13m
34901,1,Rytis,2319,0,2,4,6,33.3%,6m
34901,1,Hanno,2319,44,2,5,7,28.6%,12m
34901,1,Omyx,2319,0,1,0,1,100.0%,43m
34901,1,Trötter,2319,0,1,5,6,16.7%,1h
34901,1,[12APM]XOXOXOXOXO,2319,0,0,1,1,0.0%,60m
34901,1,pass,2319,0,0,1,1,0.0%,1h
34922,3,MufMaster,2318,1551,94,96,190,49.5%,39m
34922,1,Elbridas,2318,1481,64,61,125,51.2%,35m
34922,1,Denver,2318,1017,38,32,70,54.3%,37m
34922,1,Opanos,2318,567,23,17,40,57.5%,1h
34922,1,AmiGami,2318,379,20,11,31,64.5%,42m
34922,1,teo,2318,491,16,21,37,43.2%,26m
34922,1,bdfg,2318,328,11,11,22,50.0%,7m
34922,1,Hizza,2318,208,7,13,20,35.0%,1h
34922,3,HardMashina,2318,216,6,3,9,66.7%,32m
34922,1,DoDo,2318,216,6,8,14,42.9%,36m
34922,3,[Zavood]Talupoeg,2318,30,5,4,9,55.6%,4m
34922,1,Lava,2318,86,3,3,6,50.0%,54m
34922,1,Bamby,2318,82,3,3,6,50.0%,11m
34922,1,HeiSeNBeRG,2318,167,3,6,9,33.3%,44m
34922,2,Futon,2318,88,2,3,5,40.0%,11m
34922,1,gomesh,2318,44,2,4,6,33.3%,43m
34922,1,PrinzDan,2318,0,1,0,1,100.0%,1h
34922,1,Harmode,2318,0,1,1,2,50.0%,60m
34922,3,jeanpipi,2318,0,1,2,3,33.3%,46m
34922,2,SNICKERS,2318,0,1,4,5,20.0%,55m
34922,1,slv,2318,0,0,2,2,0.0%,45m
34943,3,GamexOverPL,2317,1327,99,103,202,49.0%,41m
34943,3,Romarain,2317,1106,84,85,169,49.7%,12m
34943,1,Istvan,2317,1228,63,63,126,50.0%,51m
34943,1,Kez,2317,1488,59,53,112,52.7%,11m
34943,3,MassTarGeT,2317,1258,46,52,98,46.9%,39m
34943,3,Koteyka,2317,533,21,18,39,53.8%,28m
34943,1,Lesshii,2317,722,21,22,43,48.8%,28m
34943,2,Lichi,2317,285,12,14,26,46.2%,50m
34943,1,[Töff]Enkephalin,2317,154,4,4,8,50.0%,46m
34943,3,Pyro,2317,0,4,12,16,25.0%,4m
34943,1,CaptainBrash,2317,0,3,4,7,42.9%,37m
34943,1,MicxyDough,2317,82,3,6,9,33.3%,1h
34943,1,JohnDoe,2317,167,3,8,11,27.3%,45m
34943,3,[LBCS]Oukr,2317,97,2,1,3,66.7%,10m
34943,1,neondragon,2317,145,2,4,6,33.3%,53m
34943,1,Kamikaze,2317,0,1,0,1,100.0%,47m
34943,1,thegodFather,2317,0,1,1,2,50.0%,53m
34943,2,AljChe,2317,88,1,1,2,50.0%,7m
34943,1,[Tuur]klimuxel,2317,0,1,1,2,50.0%,40m
34943,1,DemonPS,2317,0,1,4,5,20.0%,1h
34943,1,[GGGLHF]noah,2317,0,0,1,1,0.0%,8m
34943,1,Індюк,2317,0,0,1,1,0.0%,48m
34943,1,[BRPD]Azulmario,2317,0,0,1,1,0.0%,58m
34943,2,[megga]FaklsWor,2317,0,0,2,2,0.0%,40m
34943,1,[WNTR]TranqilChaos,2317,0,0,4,4,0.0%,50m
34968,3,[HARPIA]Doncy,2316,1252,46,56,102,45.1%,36m
34968,1,Sheepling,2316,736,22,23,45,48.9%,28m
34968,1,[45silm]Kojjaks,2316,374,18,8,26,69.2%,32m
34968,1,[RofIer]chipuchilo,2316,426,12,7,19,63.2%,9m
34968,2,узбек,2316,137,10,5,15,66.7%,1h
34968,3,Samoht,2316,238,8,18,26,30.8%,51m
34968,3,Forgeser,2316,225,7,7,14,50.0%,4m
34968,1,RostZzz,2316,282,7,9,16,43.8%,50m
34968,3,LanSung,2316,237,7,9,16,43.8%,59m
34968,3,Jose,2316,116,5,11,16,31.2%,9m
34968,1,[CDIgg]Xnre,2316,120,4,3,7,57.1%,55m
34968,1,[CZMKL]MakLawry,2316,88,2,9,11,18.2%,59m
34968,1,DoctorProbes,2316,42,1,3,4,25.0%,52m
34968,1,Kaczorblb,2316,0,0,1,1,0.0%,56m
34968,1,[BKEG]Personanon,2316,0,0,1,1,0.0%,51m
34983,3,grek,2315,1090,42,42,84,50.0%,44m
34983,1,popoboss,2315,321,17,11,28,60.7%,28m
34983,1,skullHUNter,2315,540,15,18,33,45.5%,34m
34983,1,SylNex,2315,342,14,15,29,48.3%,12m
34983,1,fireline,2315,266,9,8,17,52.9%,1h
34983,3,Ernie,2315,232,8,13,21,38.1%,32m
34983,1,[SeeLaw]Lagerta,2315,193,6,6,12,50.0%,2m
34983,3,[EvK19]deonisijRU,2315,190,6,14,20,30.0%,11m
34983,1,Fromage,2315,162,4,5,9,44.4%,45m
34983,1,WhiteVolk,2315,78,3,1,4,75.0%,28m
34983,2,IMkarlo,2315,0,3,2,5,60.0%,40m
34983,1,[zhuds]Кот,2315,88,2,6,8,25.0%,1h
34983,1,piko,2315,0,1,0,1,100.0%,1h
34983,1,Goku,2315,0,1,0,1,100.0%,50m
34983,1,quwi,2315,0,1,1,2,50.0%,53m
34983,2,Ecologist,2315,0,1,4,5,20.0%,55m
34983,2,[Symph]Staubify,2315,0,1,4,5,20.0%,59m
34983,1,Fejuu,2315,0,0,1,1,0.0%,36m
34983,1,[ISHTAR]Paullecrocq,2315,0,0,2,2,0.0%,53m
34983,1,MyraKaru,2315,0,0,2,2,0.0%,60m
34983,1,[FDPD]Kazelodie,2315,0,0,3,3,0.0%,57m
35004,1,SLTnVNGR,2314,1401,96,97,193,49.7%,9m
35004,3,Rebel,2314,549,27,30,57,47.4%,4m
35004,1,SonGoku,2314,582,22,26,48,45.8%,5m
35004,1,MikeWazowski,2314,181,6,12,18,33.3%,35m
35004,2,Matrix,2314,174,6,16,22,27.3%,45m
35004,1,lVifVa,2314,38,5,1,6,83.3%,55m
35004,1,disastertwo,2314,216,5,3,8,62.5%,56m
35004,1,WalterHelss,2314,155,5,5,10,50.0%,11m
35004,1,MAXIMYS,2314,97,2,5,7,28.6%,28m
35004,3,Neronfapper,2314,66,2,8,10,20.0%,41m
35004,1,IceMan,2314,0,0,1,1,0.0%,12m
35004,1,John,2314,0,0,1,1,0.0%,7m
35004,1,[Gruzim]trollhacker,2314,0,0,1,1,0.0%,1h
35004,1,Apollo,2314,0,0,1,1,0.0%,2m
35004,1,nazeru,2314,0,0,1,1,0.0%,55m
35004,1,Azunai,2314,0,0,1,1,0.0%,39m
35004,1,inz,2314,0,0,2,2,0.0%,30m
35021,2,AlexL,2313,1451,104,110,214,48.6%,1h
35021,1,Spawn,2313,1776,60,64,124,48.4%,10m
35021,1,[Pushka]main,2313,1296,41,44,85,48.2%,55m
35021,1,LilButtDaddy,2313,1000,40,42,82,48.8%,12m
35021,3,DERF,2313,520,32,37,69,46.4%,6m
35021,1,zhouyi,2313,673,27,23,50,54.0%,1h
35021,1,[PL27]TyRex,2313,735,23,25,48,47.9%,53m
35021,1,[BNest]Jedi,2313,401,15,6,21,71.4%,60m
35021,1,[KBOT]Swarmathon,2313,534,15,19,34,44.1%,52m
35021,1,[OmDi]Raventor,2313,404,14,15,29,48.3%,47m
35021,1,Overmind,2313,350,12,12,24,50.0%,37m
35021,1,Radikal,2313,124,4,6,10,40.0%,10m
35021,1,Napon,2313,126,3,6,9,33.3%,53m
35021,1,DaThristan,2313,44,2,0,2,100.0%,6m
35021,3,DhiseTea,2313,97,2,1,3,66.7%,27m
35021,1,Töminator,2313,0,2,4,6,33.3%,13m
35021,1,Soun,2313,88,2,7,9,22.2%,35m
35021,1,RinatST,2313,0,1,0,1,100.0%,54m
35021,1,LEWAK,2313,0,1,0,1,100.0%,28m
35021,1,Asgard,2313,0,1,0,1,100.0%,3m
35021,1,DarkPlayer,2313,0,1,1,2,50.0%,12m
35021,1,Cryonis,2313,0,1,4,5,20.0%,39m
35021,1,[ROMN]mugur,2313,0,1,5,6,16.7%,44m
35021,1,Road,2313,0,0,1,1,0.0%,12m
35045,2,DNA,2312,502,21,30,51,41.2%,6m
35045,3,PROXMEN,2312,556,20,26,46,43.5%,41m
35045,1,PunchyDexter,2312,618,18,17,35,51.4%,1h
35045,3,atreyu,2312,294,10,14,24,41.7%,28m
35045,1,[HCCB]Heimdall,2312,404,10,15,25,40.0%,57m
35045,1,Nadrak,2312,303,9,11,20,45.0%,44m
35045,1,SMHRMN,2312,226,7,3,10,70.0%,36m
35045,1,[SL4Y3R]Eclipse,2312,145,4,4,8,50.0%,2m
35045,1,[Учиха]Itachi,2312,36,2,1,3,66.7%,9m
35045,1,Anthony,2312,48,2,3,5,40.0%,43m
35045,1,Gasar,2312,0,1,0,1,100.0%,11m
35045,1,ZeKa,2312,43,1,1,2,50.0%,11m
35045,1,MindelVK,2312,42,1,2,3,33.3%,1h
35045,1,demigodas,2312,109,1,2,3,33.3%,1h
35045,2,LeGenDarySea,2312,0,1,2,3,33.3%,1h
35045,1,ertooo,2312,0,1,5,6,16.7%,60m
35045,1,lmnchk,2312,0,0,1,1,0.0%,33m
35045,1,Bandarrilla,2312,0,0,1,1,0.0%,28m
35063,3,[RuRø]Kamura,2311,398,53,51,104,51.0%,1h
35063,3,demon,2311,663,23,28,51,45.1%,1h
35063,1,DarcXederGG,2311,311,19,13,32,59.4%,7m
35063,1,DNice,2311,528,16,15,31,51.6%,59m
35063,1,[RÖÖV]GoatBeast,2311,284,11,9,20,55.0%,50m
35063,3,Esexe,2311,267,11,12,23,47.8%,10m
35063,1,BlackHole,2311,347,11,18,29,37.9%,10m
35063,3,Shenlong,2311,223,8,11,19,42.1%,26m
35063,1,Sraka,2311,0,3,3,6,50.0%,9m
35063,1,[SUKL]GrakoForewer,2311,0,1,0,1,100.0%,51m
35063,3,Vandersexxx,2311,0,1,0,1,100.0%,6m
35063,1,[Мульт]макс,2311,73,1,1,2,50.0%,44m
35063,3,Pitiku,2311,0,1,4,5,20.0%,1h
35063,1,Ares,2311,0,1,4,5,20.0%,50m
35063,3,dert,2311,30,1,10,11,9.1%,1h
35063,1,egor,2311,0,0,1,1,0.0%,33m
35063,1,szymonrto,2311,0,0,3,3,0.0%,49m
35063,1,[MadKuy]GachiVanya,2311,73,0,6,6,0.0%,43m
35081,3,nexus,2310,1541,264,267,531,49.7%,55m
35081,2,[K1LL]DarkSoull,2310,1518,67,73,140,47.9%,6m
35081,1,SneakyPete,2310,330,12,19,31,38.7%,45m
35081,1,Billis,2310,344,9,10,19,47.4%,52m
35081,1,luftig,2310,216,6,5,11,54.5%,9m
35081,1,MegaHuhn,2310,122,4,5,9,44.4%,28m
35081,1,Paulik,2310,121,3,1,4,75.0%,5m
35081,1,Vikec,2310,112,3,2,5,60.0%,28m
35081,1,Brillenpuzer,2310,0,3,3,6,50.0%,52m
35081,1,leviathan,2310,0,2,3,5,40.0%,1h
35081,1,KAMIL,2310,48,2,6,8,25.0%,41m
35081,1,Remeee,2310,0,0,2,2,0.0%,37m
35093,3,[pBÆ]Hunbar,2309,1194,155,160,315,49.2%,54m
35093,1,Holo,2309,1800,69,62,131,52.7%,1h
35093,1,Killer,2309,1657,60,56,116,51.7%,51m
35093,1,ReAnimator,2309,1062,39,29,68,57.4%,12m
35093,1,stalkprey,2309,812,28,26,54,51.9%,9m
35093,1,Muskeltutte,2309,575,19,22,41,46.3%,11m
35093,1,player,2309,208,6,8,14,42.9%,50m
35093,3,Aqualung,2309,209,6,11,17,35.3%,6m
35093,3,dansaev,2309,169,5,9,14,35.7%,1h
35093,3,Nif,2309,88,4,8,12,33.3%,56m
35093,1,seiros,2309,42,2,1,3,66.7%,47m
35093,1,Денис,2309,84,2,3,5,40.0%,37m
35093,2,frost,2309,0,2,3,5,40.0%,1h
35093,1,Zedd,2309,0,2,4,6,33.3%,1h
35093,1,[U22U2]DarkMelonArm,2309,42,1,1,2,50.0%,51m
35093,1,СанёкШ,2309,97,1,6,7,14.3%,1h
35109,1,zera,2308,1793,161,159,320,50.3%,31m
35109,1,NERVE,2308,1283,77,73,150,51.3%,28m
35109,3,kooler,2308,1194,76,69,145,52.4%,12m
35109,3,PhilyP,2308,847,73,74,147,49.7%,30m
35109,3,Miha,2308,781,64,62,126,50.8%,34m
35109,1,Saturon,2308,961,49,43,92,53.3%,41m
35109,1,TRANCEMASTER,2308,1137,39,39,78,50.0%,55m
35109,1,[LPbass]Vas,2308,1232,38,39,77,49.4%,37m
35109,1,[АРМАДА]доминат,2308,835,35,28,63,55.6%,34m
35109,1,Mediocrema,2308,1032,35,36,71,49.3%,53m
35109,1,izanagi,2308,795,34,25,59,57.6%,1h
35109,1,MaFFin,2308,874,27,31,58,46.6%,46m
35109,1,Mingeslap,2308,414,14,17,31,45.2%,1h
35109,1,hieverybody,2308,366,13,12,25,52.0%,47m
35109,1,Михаил,2308,311,7,7,14,50.0%,32m
35109,1,LeBon,2308,258,7,12,19,36.8%,49m
35109,1,[LLOOTT]Ares,2308,208,6,5,11,54.5%,1h
35109,1,Noddy,2308,240,6,8,14,42.9%,55m
35109,3,Borokov,2308,174,5,8,13,38.5%,44m
35109,1,Sagan,2308,40,3,3,6,50.0%,47m
35109,1,besubik,2308,84,3,3,6,50.0%,54m
35109,2,[J4E]Geronimus,2308,145,3,11,14,21.4%,52m
35109,1,[2500]Корсар,2308,128,2,4,6,33.3%,51m
35109,1,FWGE,2308,0,2,5,7,28.6%,10m
35109,2,Flux,2308,0,1,0,1,100.0%,50m
35109,1,Хочуха,2308,0,1,0,1,100.0%,40m
35109,1,Dimon,2308,0,1,0,1,100.0%,13m
35109,1,Ella,2308,0,1,0,1,100.0%,4m
35109,1,Noobinator,2308,0,1,4,5,20.0%,57m
35109,1,[GGEL]Brandavaar,2308,0,0,1,1,0.0%,12m
35109,1,TekCorp,2308,0,0,5,5,0.0%,11m
35140,1,mka,2307,1792,170,169,339,50.1%,34m
35140,1,танто,2307,1310,42,42,84,50.0%,12m
35140,1,hayalet,2307,848,29,29,58,50.0%,53m
35140,3,Kenji,2307,816,29,35,64,45.3%,29m
35140,1,Devastator,2307,362,15,21,36,41.7%,55m
35140,2,daBozz,2307,296,11,20,31,35.5%,9m
35140,3,mamenkoUaRu,2307,268,9,8,17,52.9%,5m
35140,1,Gwydo,2307,249,6,9,15,40.0%,41m
35140,1,ZeHiR,2307,233,6,11,17,35.3%,58m
35140,3,Krok,2307,147,4,4,8,50.0%,32m
35140,3,tronisto,2307,97,4,5,9,44.4%,10m
35140,1,ustes,2307,97,3,4,7,42.9%,7m
35140,1,Berzul,2307,112,3,5,8,37.5%,11m
35140,1,NoName,2307,118,3,5,8,37.5%,44m
35140,1,[FSTM]FireStar,2307,80,3,7,10,30.0%,1h
35140,3,user,2307,94,3,11,14,21.4%,13m
35140,3,КусокТорта,2307,0,2,6,8,25.0%,35m
35140,2,Water,2307,0,0,5,5,0.0%,55m
35158,3,jaguartordu,2306,1560,257,259,516,49.8%,28m
35158,3,ZEL,2306,1502,99,101,200,49.5%,51m
35158,3,[H4Pw]generał,2306,848,31,39,70,44.3%,41m
35158,1,aDastrA,2306,808,26,20,46,56.5%,36m
35158,1,KASZA,2306,597,18,19,37,48.6%,53m
35158,3,Roachy,2306,359,13,20,33,39.4%,43m
35158,1,DaZerq,2306,226,9,9,18,50.0%,47m
35158,2,SoulAsS,2306,236,8,14,22,36.4%,47m
35158,1,craynorr,2306,128,6,6,12,50.0%,44m
35158,1,Helldust,2306,245,6,7,13,46.2%,49m
35158,1,Alch,2306,129,3,0,3,100.0%,6m
35158,1,kakiw,2306,143,3,3,6,50.0%,60m
35158,3,Sköllaze,2306,32,2,9,11,18.2%,1h
35158,3,QuBuS,2306,30,1,2,3,33.3%,10m
35158,1,[ZenDex]JloMaHyTblu,2306,0,1,2,3,33.3%,34m
35158,1,Degree,2306,0,1,3,4,25.0%,58m
35158,2,MPKmix,2306,0,1,5,6,16.7%,55m
35158,1,proGamer,2306,0,0,1,1,0.0%,39m
35158,1,[Stoog]RuMnCokE,2306,0,0,1,1,0.0%,12m
35158,1,ZEVI,2306,0,0,1,1,0.0%,11m
35158,1,Double,2306,0,0,2,2,0.0%,35m
35179,1,[DRG]DayHaten,2305,672,20,17,37,54.1%,12m
35179,3,anakin,2305,256,12,13,25,48.0%,55m
35179,1,[TiH]DrunkenRhino,2305,207,6,15,21,28.6%,55m
35179,1,snaher,2305,207,5,8,13,38.5%,58m
35179,1,weshwesh,2305,193,4,3,7,57.1%,10m
35179,1,[N1TDA]GravityStilz,2305,97,3,4,7,42.9%,51m
35179,1,Apocalypse,2305,0,1,0,1,100.0%,1h
35179,1,[DaBoiz]Sticky,2305,44,1,1,2,50.0%,55m
35179,1,Waminno,2305,0,1,2,3,33.3%,1h
35179,1,[hlcst]unnamed,2305,0,0,1,1,0.0%,37m
35179,2,[HerS]dalliner,2305,0,0,1,1,0.0%,7m
35179,1,[Poufe]StrutPlayer,2305,0,0,2,2,0.0%,57m
35191,3,Фродо,2304,1501,98,90,188,52.1%,47m
35191,1,Mugge,2304,876,26,27,53,49.1%,47m
35191,3,chaotix,2304,563,21,24,45,46.7%,53m
35191,1,ribki,2304,304,20,21,41,48.8%,11m
35191,1,ShaggyDogg,2304,531,14,17,31,45.2%,55m
35191,1,[OPStar]Vadim,2304,349,9,9,18,50.0%,53m
35191,1,LucasDavid,2304,126,3,0,3,100.0%,59m
35191,1,[AETeam]STURM,2304,46,2,1,3,66.7%,39m
35191,1,Тролл,2304,84,2,5,7,28.6%,36m
35191,2,biøsphare,2304,0,1,4,5,20.0%,59m
35191,1,Niegz,2304,0,1,5,6,16.7%,3m
35191,1,Kilou,2304,0,0,2,2,0.0%,53m
35191,1,FireInTheSky,2304,0,0,6,6,0.0%,44m
35204,1,Azmodan,2303,1778,161,152,313,51.4%,36m
35204,3,Espiritu,2303,652,106,92,198,53.5%,51m
35204,1,sotesh,2303,1499,96,99,195,49.2%,5m
35204,1,wolFox,2303,1154,39,42,81,48.1%,28m
35204,1,Razvanov,2303,764,24,18,42,57.1%,32m
35204,3,Kerking,2303,616,22,27,49,44.9%,2m
35204,1,QmiaN,2303,406,18,17,35,51.4%,39m
35204,1,HeDoBoDKa,2303,258,8,6,14,57.1%,56m
35204,1,[2iq]XUI,2303,318,8,10,18,44.4%,1h
35204,1,[LifeTV]Zoomser,2303,242,7,5,12,58.3%,2m
35204,3,Aerari,2303,145,3,4,7,42.9%,39m
35204,1,PIskatella,2303,0,2,3,5,40.0%,46m
35204,3,StoniBoni,2303,0,2,7,9,22.2%,13m
35204,2,Hannibal,2303,0,1,4,5,20.0%,49m
35204,1,MKMaxi,2303,0,1,5,6,16.7%,1h
35204,1,Kuka,2303,42,1,8,9,11.1%,44m
35204,1,StonedHobo,2303,0,0,2,2,0.0%,1h
35221,1,Sebalubu,2302,371,13,7,20,65.0%,1h
35221,2,Hedgenious,2302,120,8,14,22,36.4%,4m
35221,3,topnoob,2302,236,8,16,24,33.3%,1h
35221,1,[LxnB]benny,2302,139,7,9,16,43.8%,1h
35221,3,Parashift,2302,147,4,8,12,33.3%,57m
35221,1,[TCSRep]Neryl,2302,142,3,6,9,33.3%,1h
35221,2,norstar,2302,30,3,8,11,27.3%,52m
35221,1,[VVPE]Lyxa,2302,48,2,1,3,66.7%,1h
35221,1,veener,2302,90,2,1,3,66.7%,44m
35221,1,FeeL,2302,0,1,0,1,100.0%,11m
35221,1,alexdi,2302,0,1,4,5,20.0%,56m
35221,1,BiNgO,2302,0,0,1,1,0.0%,44m
35233,1,Ratsi,2301,208,8,1,9,88.9%,42m
35233,3,Folken,2301,289,8,13,21,38.1%,6m
35233,1,[FilsDe]kitach,2301,124,4,4,8,50.0%,41m
35233,1,cruellimits,2301,130,4,8,12,33.3%,36m
35233,3,Quentin,2301,116,3,6,9,33.3%,3m
35233,1,Glugginn,2301,96,2,5,7,28.6%,58m
35233,1,arad,2301,48,2,6,8,25.0%,55m
35233,1,PostrelyoNOK,2301,0,1,0,1,100.0%,1h
35233,1,ADS,2301,38,1,1,2,50.0%,5m
35233,1,BlazzerD,2301,0,1,5,6,16.7%,56m
35243,2,PlokiZui,2300,1056,73,85,158,46.2%,13m
35243,1,Mazdamundi,2300,1119,51,41,92,55.4%,55m
35243,1,Erlaq,2300,450,12,12,24,50.0%,32m
35243,2,[PS23]Scafetv,2300,230,10,15,25,40.0%,1h
35243,3,Mandarinka,2300,285,9,11,20,45.0%,51m
35243,1,Suddenly,2300,48,3,5,8,37.5%,45m
35243,1,Konosouler,2300,48,2,6,8,25.0%,43m
35243,2,Зашибиь,2300,0,2,6,8,25.0%,6m
35243,1,OgRaNoM,2300,0,1,0,1,100.0%,48m
35243,1,Clemsoth,2300,36,1,3,4,25.0%,55m
35243,1,OptimusPrime,2300,0,1,4,5,20.0%,1h
35243,1,Noryac,2300,0,1,5,6,16.7%,30m
35243,1,Wümme,2300,0,1,5,6,16.7%,12m
35243,3,[ZAW]Jacko,2300,0,0,1,1,0.0%,32m
35257,3,DBFJ,2299,1241,88,82,170,51.8%,8m
35257,1,uazhdan,2299,1589,69,53,122,56.6%,55m
35257,1,Duke,2299,560,55,59,114,48.2%,53m
35257,1,Zergood,2299,1110,38,36,74,51.4%,49m
35257,1,Florian,2299,1014,32,32,64,50.0%,49m
35257,1,DKlAcidViper,2299,794,24,23,47,51.1%,5m
35257,3,jefemax,2299,346,13,14,27,48.1%,38m
35257,1,Scientist,2299,284,8,8,16,50.0%,11m
35257,3,Numberwang,2299,241,8,11,19,42.1%,39m
35257,1,[Solvol]Aerd,2299,212,7,3,10,70.0%,1h
35257,1,[258]Cuirassier,2299,244,7,7,14,50.0%,44m
35257,3,saltan,2299,220,7,8,15,46.7%,27m
35257,1,VlaDy,2299,249,7,11,18,38.9%,58m
35257,1,Selected,2299,101,5,5,10,50.0%,55m
35257,1,HOPS,2299,116,4,5,9,44.4%,46m
35257,3,ARKHAM,2299,60,4,8,12,33.3%,60m
35257,1,Aschenbecher,2299,145,3,7,10,30.0%,12m
35257,1,Slurgi,2299,0,2,2,4,50.0%,10m
35257,3,TARAS,2299,32,2,3,5,40.0%,1h
35257,1,BigAsHaze,2299,93,2,4,6,33.3%,3m
35257,1,Rostovskii,2299,0,2,4,6,33.3%,1h
35257,1,emanouile,2299,73,2,7,9,22.2%,43m
35257,2,Treaties,2299,0,1,0,1,100.0%,8m
35257,1,[Miho]Tyckin,2299,42,1,1,2,50.0%,1h
35257,1,[Cubers]крекер,2299,0,1,1,2,50.0%,44m
35257,2,Nyador,2299,0,1,4,5,20.0%,1h
35257,2,saladbrother,2299,0,1,4,5,20.0%,50m
35257,1,[Адские]Александр,2299,0,1,4,5,20.0%,1h
35257,1,Darktemplar,2299,0,1,5,6,16.7%,53m
35257,2,Ermak,2299,0,1,5,6,16.7%,1h
35257,1,ЦонкоКъсмета,2299,0,1,5,6,16.7%,39m
35257,1,[LCN]BossEscuDero,2299,0,0,1,1,0.0%,35m
35289,1,[Muist]MateiT,2298,1116,43,34,77,55.8%,8m
35289,1,Zeus,2298,906,31,34,65,47.7%,48m
35289,1,Devourer,2298,797,29,30,59,49.2%,1h
35289,1,ZORG,2298,512,16,12,28,57.1%,12m
35289,1,Novaraptor,2298,392,14,11,25,56.0%,1h
35289,2,RiderUA,2298,346,14,20,34,41.2%,54m
35289,1,[BigRat]qZilot,2298,397,13,7,20,65.0%,54m
35289,1,Karnauhov,2298,230,7,6,13,53.8%,53m
35289,3,LUCEFER,2298,245,7,6,13,53.8%,32m
35289,3,Uthroy,2298,114,5,9,14,35.7%,60m
35289,1,stanlox,2298,160,4,6,10,40.0%,31m
35289,1,[doub1e]WDAF,2298,96,3,2,5,60.0%,41m
35289,1,IIIIIIIIIIII,2298,192,3,5,8,37.5%,31m
35289,1,Бибиджабал,2298,42,3,5,8,37.5%,10m
35289,3,Leadership,2298,135,3,9,12,25.0%,43m
35289,1,MarxNotDead,2298,0,2,4,6,33.3%,51m
35289,1,bdfg,2298,0,1,0,1,100.0%,59m
35289,1,LorDolor,2298,0,0,1,1,0.0%,41m
35289,3,Lenny,2298,0,0,1,1,0.0%,27m
35289,1,GayLord,2298,0,0,2,2,0.0%,1h
35309,1,Franzon,2297,1779,80,77,157,51.0%,55m
35309,1,kapaPL,2297,1533,63,62,125,50.4%,1h
35309,3,MorbidDesire,2297,718,29,27,56,51.8%,1h
35309,1,CHEESE,2297,542,19,19,38,50.0%,55m
35309,3,[PRBJC]CashWasabi,2297,266,17,20,37,45.9%,37m
35309,1,GhostDog,2297,558,15,19,34,44.1%,28m
35309,1,xnaf,2297,254,8,10,18,44.4%,42m
35309,3,JoKeRz,2297,146,6,12,18,33.3%,32m
35309,2,Wargoose,2297,140,4,3,7,57.1%,2m
35309,1,Kailek,2297,121,4,4,8,50.0%,44m
35309,1,[N1TDA]fINCLIVER,2297,121,4,4,8,50.0%,46m
35309,1,Tamerlan,2297,145,4,5,9,44.4%,31m
35309,1,[ISC2I]Skinnygaming,2297,0,1,0,1,100.0%,30m
35309,2,MrDude,2297,88,1,3,4,25.0%,1h
35309,1,Chroma,2297,0,1,5,6,16.7%,41m
35309,1,Персик,2297,0,0,1,1,0.0%,32m
35309,1,TheHose,2297,0,0,2,2,0.0%,12m
35326,1,Alki,2296,532,20,23,43,46.5%,42m
35326,1,Harabin,2296,564,15,17,32,46.9%,57m
35326,1,DYSTREX,2296,426,14,18,32,43.8%,39m
35326,3,Yugioh,2296,243,12,5,17,70.6%,1h
35326,1,AKONAMOKA,2296,267,10,4,14,71.4%,44m
35326,1,[GoForA]JPSgfx,2296,344,9,10,19,47.4%,8m
35326,1,slegka,2296,159,7,3,10,70.0%,12m
35326,1,florian,2296,206,7,9,16,43.8%,1h
35326,1,juli,2296,238,6,10,16,37.5%,58m
35326,2,[BliTau]Octane,2296,86,5,9,14,35.7%,43m
35326,1,DuffBeeR,2296,115,4,7,11,36.4%,42m
35326,1,[1NYA]Koneko,2296,0,1,0,1,100.0%,1h
35326,2,Jolenemo,2296,0,0,2,2,0.0%,55m
35339,3,ShejTWOud,2295,928,101,101,202,50.0%,53m
35339,1,[buyu]NoCivilWar,2295,1535,59,48,107,55.1%,28m
35339,1,[BRSKR]Gliscor,2295,370,16,19,35,45.7%,1h
35339,1,corvonoturno,2295,279,15,19,34,44.1%,37m
35339,3,[Dnmt]goalkeeper,2295,383,14,13,27,51.9%,43m
35339,1,Егор,2295,440,13,15,28,46.4%,37m
35339,2,[ANCST2]Sashenka,2295,401,13,25,38,34.2%,45m
35339,1,KidAmn,2295,400,10,15,25,40.0%,42m
35339,1,[r32]Борщевик,2295,300,9,12,21,42.9%,45m
35339,1,Candle,2295,181,7,5,12,58.3%,1h
35339,1,FIREBLADESTR,2295,202,6,4,10,60.0%,48m
35339,2,NPC,2295,205,6,9,15,40.0%,3m
35339,3,MadSkillz,2295,227,6,10,16,37.5%,39m
35339,1,Sabord,2295,122,3,1,4,75.0%,1h
35339,2,GroGnaG,2295,30,3,7,10,30.0%,9m
35339,1,SamuraiHunt,2295,40,2,1,3,66.7%,1h
35339,1,Dzuuix,2295,0,1,0,1,100.0%,42m
35339,1,[Lagops]Gasteve,2295,0,1,1,2,50.0%,2m
35339,1,[S4G]beito,2295,42,1,3,4,25.0%,50m
35339,1,davegamer,2295,97,1,3,4,25.0%,55m
35339,1,[BUND]IhorStalker,2295,0,1,4,5,20.0%,36m
35339,1,[SLGH]IIIIIIIIIIII,2295,0,0,1,1,0.0%,28m
35339,3,Bragajiini,2295,0,0,3,3,0.0%,36m
35362,1,Takiteasy,2294,1478,129,135,264,48.9%,45m
35362,1,Konstantin,2294,1648,81,76,157,51.6%,12m
35362,1,macus,2294,1569,61,54,115,53.0%,26m
35362,1,ArtySca,2294,1174,60,51,111,54.1%,57m
35362,2,David,2294,733,41,45,86,47.7%,48m
35362,1,Hoemai,2294,759,26,26,52,50.0%,1h
35362,3,JHONKRAKOSES,2294,422,15,19,34,44.1%,51m
35362,1,technetium,2294,436,12,10,22,54.5%,10m
35362,1,AaronTorkil,2294,310,9,9,18,50.0%,49m
35362,2,breadfan,2294,226,8,15,23,34.8%,52m
35362,1,ColèreNacrée,2294,240,7,13,20,35.0%,49m
35362,1,MalwormRO,2294,190,6,7,13,46.2%,12m
35362,1,Obone,2294,126,6,13,19,31.6%,35m
35362,1,ReBah,2294,183,6,13,19,31.6%,50m
35362,1,Nemesis,2294,160,6,14,20,30.0%,36m
35362,1,PMZ,2294,158,5,4,9,55.6%,1h
35362,3,Stepanaft,2294,171,5,9,14,35.7%,39m
35362,1,juanblas,2294,48,2,6,8,25.0%,48m
35362,2,HARDWAR,2294,0,2,7,9,22.2%,1h
35362,1,[SW69]Леонид,2294,48,1,4,5,20.0%,31m
35362,1,XRUBEN,2294,0,1,5,6,16.7%,50m
35362,1,Deltach,2294,43,1,5,6,16.7%,51m
35362,1,KaitoKid,2294,0,1,5,6,16.7%,36m
35362,1,GAL,2294,0,0,2,2,0.0%,1h
35362,1,sid,2294,0,0,2,2,0.0%,40m
35387,2,Skymatera,2293,1384,65,58,123,52.8%,59m
35387,1,SAREVOK,2293,1102,37,37,74,50.0%,10m
35387,3,Overlord,2293,487,18,24,42,42.9%,52m
35387,1,ant,2293,415,16,14,30,53.3%,39m
35387,1,Levente,2293,408,12,10,22,54.5%,43m
35387,3,Dastfox,2293,318,12,18,30,40.0%,8m
35387,2,Beubeu,2293,282,11,17,28,39.3%,7m
35387,1,[NuF]Grubenhubert,2293,88,2,0,2,100.0%,1h
35387,1,БабаЯга,2293,42,2,3,5,40.0%,1h
35387,3,xvSamppavx,2293,30,1,4,5,20.0%,41m
35387,1,Dominant,2293,0,1,5,6,16.7%,41m
35387,1,Sim,2293,0,0,3,3,0.0%,34m
35387,1,caveman,2293,0,0,6,6,0.0%,36m
35400,1,Heaven,2292,1441,132,130,262,50.4%,52m
35400,1,[1FU2]mikado,2292,1685,65,63,128,50.8%,34m
35400,1,GoldenGambas,2292,1701,61,57,118,51.7%,6m
35400,1,[Ne0]StaZ,2292,923,59,58,117,50.4%,6m
35400,1,Awsky,2292,349,9,12,21,42.9%,51m
35400,3,peterminus,2292,236,9,14,23,39.1%,1h
35400,3,JustNuts,2292,255,8,12,20,40.0%,39m
35400,1,romaAmour,2292,200,6,5,11,54.5%,45m
35400,1,bemby,2292,240,6,7,13,46.2%,55m
35400,1,PINKiller,2292,72,5,4,9,55.6%,1h
35400,3,CIUBO,2292,115,4,6,10,40.0%,41m
35400,1,DoomDozer,2292,96,3,4,7,42.9%,48m
35400,1,[TERIZM]Familiya,2292,0,3,4,7,42.9%,2m
35400,1,[STAFI]kokolen,2292,0,1,0,1,100.0%,53m
35400,3,NIMCblue,2292,0,1,1,2,50.0%,39m
35400,1,Volk,2292,40,1,3,4,25.0%,58m
35400,2,Marvell,2292,0,1,4,5,20.0%,52m
35400,1,Matrixomen,2292,0,1,4,5,20.0%,47m
35400,1,evrIka,2292,0,0,1,1,0.0%,59m
35400,1,MALEBOLGIA,2292,0,0,1,1,0.0%,1h
35400,1,Mef,2292,0,0,3,3,0.0%,43m
35421,3,Aurenen,2291,1542,206,203,409,50.4%,6m
35421,3,Rubin,2291,563,26,24,50,52.0%,51m
35421,3,Kinou,2291,653,24,28,52,46.2%,55m
35421,1,Makai,2291,335,13,20,33,39.4%,4m
35421,1,BARON,2291,321,10,5,15,66.7%,59m
35421,3,[HRD]Lukotas,2291,148,5,8,13,38.5%,58m
35421,1,Jaykub,2291,95,3,1,4,75.0%,44m
35421,1,FlyingTurk,2291,97,2,3,5,40.0%,53m
35421,1,vasay,2291,84,2,4,6,33.3%,49m
35421,1,[ШОУМЕН]ЛюбительЧая,2291,0,1,1,2,50.0%,39m
35421,3,[RoGCT]noods,2291,0,1,9,10,10.0%,11m
35421,1,Tuubi,2291,0,0,1,1,0.0%,44m
35421,1,НИППЕЛЬ,2291,0,0,1,1,0.0%,28m
35421,1,ivansdc,2291,0,0,1,1,0.0%,60m
35435,1,GonzusIII,2290,1802,240,238,478,50.2%,12m
35435,3,Tzatziki,2290,996,58,56,114,50.9%,8m
35435,2,[ZЕRGТV]Şũŋrĭsé,2290,552,23,33,56,41.1%,60m
35435,1,[WАSD]BalgorPack,2290,630,19,19,38,50.0%,58m
35435,1,overlord,2290,313,11,6,17,64.7%,45m
35435,1,SpeedRacer,2290,397,11,15,26,42.3%,53m
35435,1,Waxu,2290,243,8,6,14,57.1%,36m
35435,1,Thunder,2290,225,5,5,10,50.0%,50m
35435,1,SrLobo,2290,126,4,8,12,33.3%,4m
35435,1,Сверчок,2290,165,3,2,5,60.0%,9m
35435,1,GBosh,2290,94,2,3,5,40.0%,43m
35435,1,Fuzaa,2290,38,2,5,7,28.6%,8m
35435,3,toncho,2290,97,1,4,5,20.0%,35m
35435,1,manson,2290,0,1,5,6,16.7%,34m
35435,1,Zloikloun,2290,0,0,1,1,0.0%,44m
35435,1,[БИЗНЕС]Hag,2290,0,0,1,1,0.0%,51m
35435,1,JLG,2290,0,0,2,2,0.0%,40m
35452,1,Swiff,2289,1723,114,108,222,51.4%,1h
35452,1,Simsisamstar,2289,1738,105,94,199,52.8%,44m
35452,1,Ashel,2289,1070,45,43,88,51.1%,28m
35452,1,[KPZA]ILoveDi,2289,790,32,20,52,61.5%,1h
35452,1,Acidjunky,2289,696,25,22,47,53.2%,44m
35452,1,SECTORzzzUA,2289,789,24,21,45,53.3%,1h
35452,1,Perfectoz,2289,644,21,22,43,48.8%,48m
35452,1,MRKSArthY,2289,450,18,22,40,45.0%,31m
35452,1,lexaabz,2289,228,7,10,17,41.2%,59m
35452,3,Nedhassum,2289,217,7,11,18,38.9%,41m
35452,1,[IceCub]SAVA,2289,230,6,8,14,42.9%,28m
35452,1,Johnny,2289,235,5,8,13,38.5%,43m
35452,1,LavaPiranha,2289,168,4,10,14,28.6%,52m
35452,1,Smoolijkeee,2289,97,3,5,8,37.5%,59m
35452,1,Syte,2289,110,2,2,4,50.0%,12m
35452,1,legcyofthevo,2289,0,1,1,2,50.0%,12m
35452,1,lapinou,2289,0,1,5,6,16.7%,47m
35452,1,Flymerick,2289,0,0,1,1,0.0%,48m
35452,1,Verixon,2289,0,0,1,1,0.0%,58m
35452,1,samkrmr,2289,0,0,3,3,0.0%,56m
35452,3,Ozark,2289,0,0,3,3,0.0%,53m
35473,1,Scat,2288,1442,49,55,104,47.1%,5m
35473,1,FaraonAng,2288,766,44,31,75,58.7%,1h
35473,1,Fumety,2288,852,34,29,63,54.0%,59m
35473,1,[EzD]ikar,2288,453,25,24,49,51.0%,59m
35473,3,Delicious,2288,437,18,25,43,41.9%,41m
35473,3,Kubaxxx,2288,335,14,14,28,50.0%,55m
35473,1,[Бульба]Mixsar,2288,423,14,17,31,45.2%,1h
35473,1,EugeneSky,2288,293,9,9,18,50.0%,48m
35473,1,Droste,2288,352,9,14,23,39.1%,37m
35473,3,Farmless,2288,219,7,10,17,41.2%,1h
35473,1,[псина]АндрейПёс,2288,172,4,3,7,57.1%,53m
35473,3,Starklim,2288,121,3,3,6,50.0%,9m
35473,1,Ashenari,2288,76,2,5,7,28.6%,12m
35473,1,[WITA]CuBe,2288,40,1,2,3,33.3%,11m
35473,3,darruc,2288,0,1,6,7,14.3%,5m
35473,3,Leonidas,2288,0,0,2,2,0.0%,1h
35473,1,суперпуперч,2288,0,0,3,3,0.0%,1h
35490,1,bnbarkas,2287,1207,136,133,269,50.6%,52m
35490,3,Gandalf,2287,1496,91,83,174,52.3%,32m
35490,1,Foreach,2287,1309,57,54,111,51.4%,1h
35490,1,KazaK,2287,620,30,28,58,51.7%,56m
35490,1,Vozle,2287,578,17,16,33,51.5%,50m
35490,3,Saddas,2287,373,14,19,33,42.4%,1h
35490,1,Vlad,2287,246,7,9,16,43.8%,1h
35490,1,SashaMaster,2287,240,6,3,9,66.7%,34m
35490,1,AndryPowers,2287,150,4,2,6,66.7%,1h
35490,1,Dave,2287,164,4,7,11,36.4%,59m
35490,1,Swarm,2287,73,4,7,11,36.4%,1h
35490,1,dexaps,2287,144,4,9,13,30.8%,1h
35490,2,Fummy,2287,30,3,7,10,30.0%,43m
35490,2,Sixtysketch,2287,46,2,0,2,100.0%,31m
35490,1,Comby,2287,82,2,3,5,40.0%,29m
35490,2,Anastasiya,2287,0,2,6,8,25.0%,12m
35490,1,Mrstartor,2287,94,1,1,2,50.0%,11m
35490,1,Hawk,2287,42,1,2,3,33.3%,1h
35490,1,KILIGHT,2287,0,1,2,3,33.3%,44m
35490,2,DKdh,2287,0,1,4,5,20.0%,52m
35490,1,Mightyowl,2287,0,0,1,1,0.0%,1h
35490,1,hanabi,2287,0,0,1,1,0.0%,10m
35490,2,AnimalPrint,2287,0,0,1,1,0.0%,11m
35490,1,Ric,2287,0,0,1,1,0.0%,44m
35514,1,Новичог,2286,870,31,22,53,58.5%,35m
35514,1,perry,2286,603,23,20,43,53.5%,1h
35514,3,Yahi,2286,536,20,20,40,50.0%,1h
35514,2,sarkofa,2286,247,8,15,23,34.8%,4m
35514,3,MsLab,2286,196,6,11,17,35.3%,1h
35514,1,NESSUNO,2286,160,5,5,10,50.0%,33m
35514,1,Eredain,2286,40,4,3,7,57.1%,59m
35514,1,NeXa,2286,154,4,6,10,40.0%,53m
35514,1,[TC58]xLuisitox,2286,172,4,7,11,36.4%,51m
35514,1,skrillgames,2286,139,3,2,5,60.0%,1h
35514,1,Apache,2286,48,2,2,4,50.0%,7m
35514,1,[VWaile]HATEAGGRO,2286,0,2,3,5,40.0%,56m
35514,1,DOMININAS,2286,0,1,0,1,100.0%,53m
35514,1,[SC2GG]nutro,2286,0,1,5,6,16.7%,1h
35514,1,Ssnowman,2286,0,0,2,2,0.0%,54m
35529,1,jack,2285,1793,181,184,365,49.6%,9m
35529,3,Andoni,2285,1557,116,122,238,48.7%,33m
35529,1,Zheldor,2285,1742,69,58,127,54.3%,44m
35529,1,Effect,2285,1136,41,32,73,56.2%,11m
35529,3,[riddik]PREDATOR,2285,826,29,34,63,46.0%,45m
35529,1,[GlNYU]Onlineritter,2285,572,21,16,37,56.8%,55m
35529,1,AndySky,2285,351,17,17,34,50.0%,53m
35529,3,SEREDAS,2285,435,17,22,39,43.6%,41m
35529,1,MegaKycь,2285,344,12,5,17,70.6%,55m
35529,3,Dondog,2285,220,6,11,17,35.3%,1h
35529,1,BBK,2285,46,5,6,11,45.5%,48m
35529,1,Legion,2285,118,3,1,4,75.0%,43m
35529,2,[PEFEDU]OSCURINATY,2285,0,3,2,5,60.0%,59m
35529,1,IronLove,2285,0,2,3,5,40.0%,9m
35529,1,Pragner,2285,96,2,3,5,40.0%,13m
35529,2,Alexeychup,2285,48,1,4,5,20.0%,55m
35529,1,noje,2285,0,0,1,1,0.0%,1h
35529,1,Ulrezaj,2285,0,0,2,2,0.0%,28m
35547,1,BlazejJagge,2284,1769,67,69,136,49.3%,49m
35547,1,Asiofil,2284,625,33,10,43,76.7%,12m
35547,1,HansHans,2284,477,19,12,31,61.3%,1h
35547,1,builderland,2284,634,19,22,41,46.3%,1h
35547,2,ПЁС,2284,356,16,24,40,40.0%,27m
35547,3,Slider,2284,291,15,18,33,45.5%,1h
35547,1,Dimmex,2284,321,8,8,16,50.0%,5m
35547,1,SxualChcolat,2284,183,6,4,10,60.0%,44m
35547,1,Сirrhosis,2284,172,5,5,10,50.0%,45m
35547,1,винтик,2284,154,4,10,14,28.6%,3m
35547,1,PlayerOne,2284,107,3,0,3,100.0%,50m
35547,1,yuos,2284,145,3,6,9,33.3%,1h
35547,1,JeMi,2284,0,2,3,5,40.0%,37m
35547,1,Zahid,2284,70,2,3,5,40.0%,1h
35547,2,SatoPoW,2284,0,1,2,3,33.3%,4m
35547,1,Funkaps,2284,48,1,4,5,20.0%,1h
35547,1,MyasnikDI,2284,0,1,4,5,20.0%,1h
35547,3,Macfdfed,2284,0,1,6,7,14.3%,46m
35547,1,[кулик]BrainA,2284,0,0,1,1,0.0%,1h
35547,1,Danilych,2284,0,0,1,1,0.0%,2m
35547,1,SgtPepper,2284,0,0,2,2,0.0%,41m
35547,1,Antoine,2284,0,0,2,2,0.0%,52m
35547,3,Alex,2284,0,0,3,3,0.0%,57m
35547,1,MRmar,2284,0,0,3,3,0.0%,1h
35547,1,ПлачьИкара,2284,0,0,5,5,0.0%,58m
35572,1,Meduza,2283,1663,160,152,312,51.3%,59m
35572,1,Sachem,2283,1047,95,95,190,50.0%,1h
35572,1,NightWarFare,2283,383,70,60,130,53.8%,28m
35572,1,Blitz,2283,1783,67,71,138,48.6%,53m
35572,1,ЗергЗубр,2283,736,36,25,61,59.0%,39m
35572,1,IceBlock,2283,645,20,21,41,48.8%,1h
35572,1,APPHOFISS,2283,258,12,14,26,46.2%,43m
35572,1,Taiipz,2283,191,10,0,10,100.0%,50m
35572,1,Quean,2283,178,8,6,14,57.1%,1h
35572,3,BETLEROK,2283,256,7,5,12,58.3%,37m
35572,1,DIMON,2283,190,6,2,8,75.0%,53m
35572,1,Mindaugas,2283,236,6,8,14,42.9%,34m
35572,1,Predator,2283,147,5,2,7,71.4%,44m
35572,1,[FAR2]Brennus,2283,212,5,3,8,62.5%,4m
35572,3,NeoGeek,2283,113,4,9,13,30.8%,44m
35572,1,Krasnal,2283,42,2,2,4,50.0%,59m
35572,3,Meru,2283,121,2,4,6,33.3%,60m
35572,1,Shinkiro,2283,0,1,0,1,100.0%,53m
35572,2,Windlex,2283,91,1,6,7,14.3%,1h
35572,1,Evgded,2283,0,0,2,2,0.0%,1h
35572,1,Ambrosio,2283,0,0,2,2,0.0%,8m
35572,1,[SPFE]FreeDyc,2283,0,0,2,2,0.0%,1h
35594,1,Prash,2282,1520,189,187,376,50.3%,41m
35594,1,Deltrax,2282,750,30,22,52,57.7%,1h
35594,1,[HMarch]Larrs,2282,520,19,16,35,54.3%,51m
35594,1,GachiMaster,2282,266,9,7,16,56.2%,44m
35594,1,[LalkuX]серёга,2282,221,6,19,25,24.0%,4m
35594,2,Iman,2282,190,6,22,28,21.4%,2m
35594,1,Pancaldi,2282,0,3,3,6,50.0%,55m
35594,2,[boiko]soldierbg,2282,0,2,3,5,40.0%,52m
35594,1,Gerondil,2282,78,2,3,5,40.0%,53m
35594,2,IvaN,2282,0,2,4,6,33.3%,44m
35594,1,ishkitiev,2282,0,1,0,1,100.0%,10m
35594,1,matys,2282,0,1,0,1,100.0%,1h
35594,2,TeslaWarrior,2282,0,1,1,2,50.0%,1h
35594,1,[Meruz]DemoNiki,2282,42,1,2,3,33.3%,12m
35594,1,[D3L]JJxDUB,2282,0,1,5,6,16.7%,5m
35594,1,illuvios,2282,0,0,1,1,0.0%,54m
35610,1,pomidor,2281,1753,108,99,207,52.2%,13m
35610,2,ElectronChik,2281,1192,45,59,104,43.3%,1h
35610,1,Hummel,2281,503,18,13,31,58.1%,59m
35610,1,parasitekill,2281,431,18,20,38,47.4%,45m
35610,1,Piepo,2281,297,10,15,25,40.0%,36m
35610,1,Saladores,2281,378,9,15,24,37.5%,54m
35610,1,Chris,2281,316,8,13,21,38.1%,7m
35610,1,Vivalui,2281,254,6,9,15,40.0%,46m
35610,1,[CripOG]stivi,2281,192,5,6,11,45.5%,12m
35610,1,bodopi,2281,167,4,7,11,36.4%,47m
35610,1,DogBog,2281,121,3,3,6,50.0%,1h
35610,1,keira,2281,42,2,2,4,50.0%,28m
35610,1,Sarlet,2281,73,2,8,10,20.0%,33m
35610,1,dragon,2281,0,1,1,2,50.0%,8m
35610,1,Asuramaru,2281,0,1,4,5,20.0%,58m
35610,1,ШaЙтАн,2281,0,0,1,1,0.0%,54m
35610,1,Philby,2281,0,0,4,4,0.0%,31m
35627,1,IVLEGION,2280,1780,79,79,158,50.0%,53m
35627,1,HaNkYn,2280,1027,63,74,137,46.0%,1h
35627,2,Anténix,2280,463,41,60,101,40.6%,27m
35627,1,KefiR,2280,567,20,24,44,45.5%,4m
35627,1,[MPT]Cenerella,2280,324,10,11,21,47.6%,52m
35627,1,Zufall,2280,284,10,14,24,41.7%,31m
35627,1,toxic,2280,230,6,7,13,46.2%,54m
35627,1,dronsis,2280,157,5,1,6,83.3%,12m
35627,1,Berjas,2280,150,4,5,9,44.4%,2m
35627,1,APOCRYPHT,2280,97,3,7,10,30.0%,11m
35627,2,RayV,2280,0,2,7,9,22.2%,59m
35627,1,Noxxl,2280,48,2,7,9,22.2%,39m
35627,1,Grincheux,2280,0,1,0,1,100.0%,34m
35627,1,абакановский,2280,0,1,1,2,50.0%,47m
35627,1,[CZxX]DayRay,2280,0,1,1,2,50.0%,56m
35627,2,AlexsusD,2280,0,1,5,6,16.7%,1h
35627,2,Atterus,2280,0,1,5,6,16.7%,1h
35627,1,Lucklicot,2280,0,0,1,1,0.0%,50m
35645,1,jennerj,2279,1004,37,37,74,50.0%,55m
35645,1,[D0N3]Alien,2279,651,33,19,52,63.5%,51m
35645,1,Medea,2279,461,15,16,31,48.4%,1h
35645,3,ThePowerPuff,2279,364,13,16,29,44.8%,1h
35645,1,Chill,2279,317,12,11,23,52.2%,37m
35645,3,DaniiXeto,2279,221,6,7,13,46.2%,39m
35645,1,KZZZ,2279,232,6,14,20,30.0%,58m
35645,1,Badhaircat,2279,241,5,10,15,33.3%,44m
35645,1,COBECTb,2279,142,4,4,8,50.0%,55m
35645,2,MattiasD,2279,48,3,3,6,50.0%,49m
35645,1,Kowalski,2279,102,3,4,7,42.9%,60m
35645,1,Disonda,2279,74,3,7,10,30.0%,33m
35645,1,[LAA]HellBlaze,2279,40,2,2,4,50.0%,12m
35645,3,icequake,2279,95,2,6,8,25.0%,59m
35645,1,Chris,2279,0,1,5,6,16.7%,58m
35645,1,Saervak,2279,0,0,1,1,0.0%,58m
35645,1,[IceCub]ZERGOZAVR,2279,73,0,2,2,0.0%,51m
35645,1,[nWss]riptidezim,2279,0,0,5,5,0.0%,58m
35645,3,Zalupsei,2279,0,0,6,6,0.0%,9m
35664,3,RedHeadLove,2278,1547,69,69,138,50.0%,30m
35664,3,Arturo,2278,1447,56,51,107,52.3%,58m
35664,1,PlayerOne,2278,397,33,18,51,64.7%,2m
35664,3,LordAncent,2278,173,20,26,46,43.5%,33m
35664,1,Mitschi,2278,388,16,14,30,53.3%,50m
35664,1,tupaartem,2278,297,11,6,17,64.7%,12m
35664,1,LETSPLAY,2278,295,11,7,18,61.1%,47m
35664,1,Lüftli,2278,226,10,4,14,71.4%,1h
35664,1,[Wamaj]DrakoaoKakao,2278,242,7,7,14,50.0%,45m
35664,3,bango,2278,149,4,8,12,33.3%,1h
35664,2,Aconitum,2278,0,3,2,5,60.0%,47m
35664,3,Miron,2278,0,3,4,7,42.9%,29m
35664,2,Beelzebub,2278,48,3,5,8,37.5%,8m
35664,1,Gnaeus,2278,44,1,2,3,33.3%,40m
35664,3,StefCraft,2278,0,1,4,5,20.0%,43m
35679,1,Colod,2277,1226,63,57,120,52.5%,59m
35679,1,CVS,2277,998,34,37,71,47.9%,5m
35679,1,DiakonRai,2277,336,13,7,20,65.0%,56m
35679,2,GHOST,2277,348,13,21,34,38.2%,1h
35679,2,Limitus,2277,284,11,17,28,39.3%,10m
35679,1,luchok,2277,216,8,8,16,50.0%,47m
35679,1,ViLiVoNkA,2277,252,7,10,17,41.2%,4m
35679,1,[Käft]Gawdfather,2277,264,6,9,15,40.0%,57m
35679,3,afinapallada,2277,147,6,9,15,40.0%,43m
35679,1,Syndicate,2277,123,4,0,4,100.0%,52m
35679,1,dashak,2277,169,4,1,5,80.0%,49m
35679,2,LeGeNda,2277,141,3,2,5,60.0%,55m
35679,1,Max,2277,143,3,3,6,50.0%,51m
35679,1,Лисколиск,2277,73,2,8,10,20.0%,43m
35679,3,Freaker,2277,0,1,0,1,100.0%,6m
35679,1,[A1one]Sliches,2277,0,1,0,1,100.0%,48m
35679,3,GreassyGamer,2277,0,1,0,1,100.0%,7m
35679,1,Pizza,2277,0,1,1,2,50.0%,1h
35679,1,[SDN1]NoCake,2277,0,1,1,2,50.0%,45m
35679,1,Merlen,2277,0,1,4,5,20.0%,47m
35679,1,Kanto,2277,0,1,4,5,20.0%,47m
35679,1,PsijicScream,2277,0,1,5,6,16.7%,12m
35679,1,Zorg,2277,0,1,5,6,16.7%,31m
35679,2,injinero,2277,88,1,9,10,10.0%,1h
35679,1,Bluberlutsch,2277,0,0,1,1,0.0%,7m
35679,2,AbloTyran,2277,0,0,1,1,0.0%,48m
35679,1,Voll,2277,0,0,4,4,0.0%,1h
35706,3,Xelor,2276,959,51,48,99,51.5%,55m
35706,1,[PeEff]Dry,2276,925,30,31,61,49.2%,28m
35706,1,SquishyXP,2276,589,21,20,41,51.2%,44m
35706,3,Xune,2276,498,18,23,41,43.9%,55m
35706,2,LEVItan,2276,229,7,8,15,46.7%,35m
35706,1,[Josema]Pitu,2276,244,6,12,18,33.3%,28m
35706,1,tecno,2276,166,3,3,6,50.0%,13m
35706,2,WooDoo,2276,30,3,9,12,25.0%,50m
35706,1,мальчишка,2276,40,2,1,3,66.7%,56m
35706,1,[MARSS]Tchapakan,2276,125,2,2,4,50.0%,10m
35706,1,[LIQUID]BigFudge,2276,90,2,5,7,28.6%,42m
35706,1,[SS13]ASD,2276,110,2,6,8,25.0%,28m
35706,1,TimeWillTell,2276,0,1,5,6,16.7%,30m
35719,1,PatLOrD,2275,585,21,19,40,52.5%,1h
35719,1,Xaira,2275,223,12,9,21,57.1%,50m
35719,3,[PLOUPI]Ploupi,2275,254,8,13,21,38.1%,32m
35719,1,Gelos,2275,200,5,6,11,45.5%,1h
35719,3,Secchio,2275,106,5,11,16,31.2%,39m
35719,1,Gamper,2275,78,4,6,10,40.0%,53m
35719,1,DaNiOoPL,2275,97,1,1,2,50.0%,39m
35719,1,spindrift,2275,89,1,1,2,50.0%,59m
35719,1,FluffyTail,2275,0,1,2,3,33.3%,43m
35719,3,RomUluS,2275,97,1,2,3,33.3%,48m
35719,2,Creid,2275,0,1,5,6,16.7%,58m
35719,1,Импостер,2275,0,0,1,1,0.0%,30m
35719,1,Hapkomek,2275,0,0,1,1,0.0%,54m
35719,1,Aaaaaaaaaaa,2275,0,0,4,4,0.0%,9m
35719,1,Ignis,2275,0,0,5,5,0.0%,27m
35719,1,картошка,2275,0,0,5,5,0.0%,1h
35735,1,TanZZzzz,2274,1650,182,181,363,50.1%,54m
35735,1,Кобра,2274,1643,81,80,161,50.3%,4m
35735,3,KräuterTroll,2274,874,63,58,121,52.1%,44m
35735,1,Pupsik,2274,681,51,47,98,52.0%,1h
35735,1,[ANREN]GGZerg,2274,809,30,27,57,52.6%,1h
35735,1,horrigan,2274,585,29,21,50,58.0%,33m
35735,1,LazerTV,2274,558,21,20,41,51.2%,35m
35735,1,AAngelus,2274,586,16,21,37,43.2%,37m
35735,1,ALORIAN,2274,359,15,11,26,57.7%,44m
35735,3,Stavaros,2274,255,10,12,22,45.5%,39m
35735,2,Kiux,2274,232,10,15,25,40.0%,1h
35735,1,SideraITAG,2274,203,9,2,11,81.8%,34m
35735,1,Schkinskiy,2274,210,7,12,19,36.8%,11m
35735,1,[I3W]DonVitto,2274,156,6,1,7,85.7%,1h
35735,1,sebmaster,2274,214,6,4,10,60.0%,54m
35735,1,dandan,2274,234,5,5,10,50.0%,44m
35735,1,NiCoha,2274,144,4,9,13,30.8%,2m
35735,1,Glupfrog,2274,40,3,5,8,37.5%,5m
35735,1,TerRazit,2274,90,2,2,4,50.0%,9m
35735,2,eyesnight,2274,0,2,3,5,40.0%,8m
35735,3,loganjoe,2274,63,2,5,7,28.6%,57m
35735,1,DChocolate,2274,91,1,1,2,50.0%,44m
35735,1,[WADF]Hearthwolf,2274,0,1,5,6,16.7%,41m
35735,1,fabchao,2274,0,1,5,6,16.7%,50m
35735,1,dBrick,2274,0,0,1,1,0.0%,1h
35735,2,Sonne,2274,0,0,1,1,0.0%,1h
35735,3,vanomazz,2274,0,0,6,6,0.0%,4m
35762,1,Mafloom,2273,482,18,17,35,51.4%,37m
35762,1,Alysme,2273,595,18,24,42,42.9%,1h
35762,1,Sam,2273,475,16,13,29,55.2%,8m
35762,1,Moonlay,2273,234,9,1,10,90.0%,40m
35762,1,NAV,2273,188,9,12,21,42.9%,1h
35762,3,Marvestaff,2273,215,7,10,17,41.2%,1h
35762,1,[Minet]Tasavalta,2273,149,6,1,7,85.7%,1h
35762,1,Myriad,2273,216,6,7,13,46.2%,31m
35762,1,Zan,2273,228,6,10,16,37.5%,59m
35762,3,[Schlng]HeXaN,2273,90,5,10,15,33.3%,1h
35762,1,TheViking,2273,82,3,3,6,50.0%,1h
35762,1,Warus,2273,0,3,4,7,42.9%,34m
35762,1,Heizer,2273,126,3,7,10,30.0%,54m
35762,1,ŀòòndq,2273,145,3,7,10,30.0%,10m
35762,2,ThSwarm,2273,30,3,7,10,30.0%,51m
35762,1,[Exprt]SamLeSerpent,2273,0,2,6,8,25.0%,37m
35762,1,Cloud,2273,0,2,6,8,25.0%,48m
35762,2,ZENF,2273,0,2,7,9,22.2%,50m
35762,1,siopsys,2273,0,1,0,1,100.0%,36m
35762,1,[Мульт]smouk,2273,0,1,0,1,100.0%,37m
35762,2,vlad,2273,0,1,0,1,100.0%,40m
35762,1,Kesse,2273,0,0,1,1,0.0%,9m
35762,1,reptilewolf,2273,0,0,1,1,0.0%,41m
35785,3,lonewolf,2272,1403,64,75,139,46.0%,13m
35785,1,IgzzzJet,2272,1339,55,55,110,50.0%,27m
35785,1,SleepyCat,2272,1007,33,39,72,45.8%,1h
35785,1,Millenium,2272,211,25,31,56,44.6%,1h
35785,1,TnT,2272,612,16,21,37,43.2%,1h
35785,1,Lateralus,2272,224,14,9,23,60.9%,1h
35785,3,Főnök,2272,392,13,18,31,41.9%,58m
35785,1,[ZERGSC]Drakaris,2272,236,12,2,14,85.7%,11m
35785,3,SpanVagyTeso,2272,293,11,22,33,33.3%,1h
35785,1,RisenDeath,2272,231,10,5,15,66.7%,45m
35785,1,kosmos,2272,339,10,17,27,37.0%,28m
35785,3,NIkolaiSSHH,2272,240,7,10,17,41.2%,60m
35785,1,Kaleeb,2272,143,5,4,9,55.6%,32m
35785,3,[Pkr]CoFFeiN,2272,121,4,9,13,30.8%,60m
35785,3,TCO,2272,60,4,10,14,28.6%,55m
35785,2,Honda,2272,187,3,2,5,60.0%,1h
35785,1,Хрустик,2272,88,3,3,6,50.0%,36m
35785,1,Greuceanu,2272,48,2,0,2,100.0%,33m
35785,3,MyrLok,2272,0,2,2,4,50.0%,32m
35785,1,[3DTOSS]Тольятти,2272,40,2,4,6,33.3%,1h
35785,1,Hokage,2272,0,1,2,3,33.3%,8m
35785,1,KanNonRushky,2272,0,0,1,1,0.0%,55m
35807,1,DESANT,2271,499,27,19,46,58.7%,5m
35807,1,Orcosexi,2271,564,21,27,48,43.8%,32m
35807,1,Polo,2271,477,19,13,32,59.4%,48m
35807,2,MarsBallon,2271,265,11,16,27,40.7%,37m
35807,1,prometheus,2271,372,10,15,25,40.0%,29m
35807,1,[MaAM]QQW,2271,349,10,15,25,40.0%,55m
35807,3,JetSetWilly,2271,174,7,13,20,35.0%,1h
35807,1,[haufen]gedöhns,2271,117,4,10,14,28.6%,10m
35807,2,Rebrovsqij,2271,86,3,21,24,12.5%,7m
35807,1,Rozmarin,2271,0,2,6,8,25.0%,58m
35807,1,sugus,2271,0,1,1,2,50.0%,47m
35807,1,Asakiraze,2271,0,1,1,2,50.0%,46m
35807,3,Thore,2271,0,1,1,2,50.0%,1h
35807,1,[CumBoy]Foreyton,2271,91,1,1,2,50.0%,5m
35807,1,[Beatz]xXChaosXx,2271,44,1,6,7,14.3%,1h
35807,2,CRIZ,2271,0,0,5,5,0.0%,31m
35823,1,[pCorps]FearKlick,2270,1400,53,53,106,50.0%,59m
35823,3,MerK,2270,439,34,42,76,44.7%,33m
35823,3,naget,2270,348,33,37,70,47.1%,9m
35823,1,Voislav,2270,683,31,20,51,60.8%,1h
35823,3,Tom,2270,689,26,36,62,41.9%,44m
35823,1,Enot,2270,241,9,5,14,64.3%,43m
35823,1,[K0RM2]AlbaRisus,2270,251,8,8,16,50.0%,1h
35823,1,CrazyyArms,2270,218,7,9,16,43.8%,4m
35823,1,Stilgarr,2270,164,5,8,13,38.5%,4m
35823,1,NZT,2270,206,5,8,13,38.5%,44m
35823,2,Mastercheff,2270,0,4,1,5,80.0%,1h
35823,1,КОТЭ,2270,144,4,3,7,57.1%,1h
35823,1,Conundrumz,2270,138,4,9,13,30.8%,55m
35823,1,Ilyas,2270,160,3,3,6,50.0%,44m
35823,1,[Gremli]УшлыйКролик,2270,123,3,7,10,30.0%,4m
35823,1,MaxHimself,2270,40,2,1,3,66.7%,12m
35823,1,mopastar,2270,0,1,3,4,25.0%,33m
35823,1,Barsilion,2270,0,1,5,6,16.7%,1h
35823,2,GrumpyKitten,2270,0,1,5,6,16.7%,1h
35823,1,RagingBadger,2270,0,0,2,2,0.0%,1h
35843,3,Destructor,2269,776,115,119,234,49.1%,1h
35843,1,[MASTRO]Kaiju,2269,299,15,4,19,78.9%,44m
35843,1,Nambona,2269,372,14,16,30,46.7%,45m
35843,1,zerg,2269,459,13,14,27,48.1%,9m
35843,1,Molodoy,2269,446,11,12,23,47.8%,43m
35843,1,Lotusss,2269,202,9,15,24,37.5%,9m
35843,1,avror,2269,267,8,5,13,61.5%,10m
35843,1,Qaz,2269,310,8,10,18,44.4%,53m
35843,1,[Bould]Crambu,2269,322,8,15,23,34.8%,48m
35843,3,Sintorred,2269,220,6,7,13,46.2%,7m
35843,1,Braindead,2269,144,5,8,13,38.5%,53m
35843,2,avieor,2269,48,2,1,3,66.7%,50m
35843,1,Jenz,2269,103,2,2,4,50.0%,1h
35843,1,Dvi,2269,84,2,4,6,33.3%,7m
35843,1,philipp,2269,0,1,1,2,50.0%,4m
35843,1,Rabs,2269,0,1,1,2,50.0%,1h
35859,1,AzzieElbub,2268,1505,70,67,137,51.1%,54m
35859,3,enzo,2268,1122,68,53,121,56.2%,27m
35859,1,Necronomicon,2268,1269,57,41,98,58.2%,1h
35859,1,Mizeri,2268,608,24,21,45,53.3%,10m
35859,1,Marjohr,2268,712,23,26,49,46.9%,29m
35859,1,СЕРАФИМ,2268,279,12,7,19,63.2%,57m
35859,1,daj,2268,380,12,16,28,42.9%,42m
35859,1,TROUBELMAKER,2268,252,9,7,16,56.2%,56m
35859,3,HansWurst,2268,264,8,11,19,42.1%,27m
35859,1,draugen,2268,241,4,6,10,40.0%,30m
35859,1,Max,2268,103,2,2,4,50.0%,41m
35859,1,Зевр,2268,88,2,4,6,33.3%,42m
35859,1,[S5RTA]PaulaMamdouh,2268,0,1,0,1,100.0%,12m
35859,1,fernando,2268,0,1,2,3,33.3%,1h
35859,2,adriamarto,2268,48,1,2,3,33.3%,50m
35859,2,Light,2268,0,1,4,5,20.0%,58m
35859,1,[DnD101]DnDamelin,2268,0,1,6,7,14.3%,56m
35859,1,[AresG]king,2268,0,0,1,1,0.0%,10m
35877,1,bURTONgp,2267,1752,124,114,238,52.1%,60m
35877,1,Nicholas,2267,1515,98,87,185,53.0%,42m
35877,1,KillerNight,2267,1758,91,83,174,52.3%,10m
35877,1,Heffa,2267,1048,68,66,134,50.7%,10m
35877,1,BillyKimbah,2267,424,14,9,23,60.9%,1h
35877,1,Torhin,2267,305,10,16,26,38.5%,12m
35877,3,[WH2D]Eschus,2267,316,10,22,32,31.2%,43m
35877,1,SleepyBoar,2267,139,4,6,10,40.0%,10m
35877,1,арти,2267,89,2,0,2,100.0%,1h
35877,1,Swinter,2267,0,1,1,2,50.0%,3m
35877,1,Sharm,2267,0,1,5,6,16.7%,48m
35877,1,[onimee]OnimeSan,2267,0,1,6,7,14.3%,32m
35889,3,hayusunny,2266,619,28,26,54,51.9%,8m
35889,2,Jaspita,2266,391,16,13,29,55.2%,8m
35889,3,BenMi,2266,330,12,24,36,33.3%,10m
35889,1,Syncerus,2266,406,11,12,23,47.8%,1h
35889,1,Espinete,2266,364,11,22,33,33.3%,11m
35889,1,perekaz,2266,300,9,11,20,45.0%,59m
35889,3,Devil,2266,202,6,10,16,37.5%,48m
35889,2,imkiss,2266,116,5,2,7,71.4%,4m
35889,2,[VCa]Phantom,2266,144,3,2,5,60.0%,1h
35889,2,Belerafon,2266,144,3,5,8,37.5%,1h
35889,1,LAKATOS,2266,96,3,6,9,33.3%,51m
35889,3,SULTANALPARS,2266,32,3,8,11,27.3%,47m
35889,1,rSkKiM,2266,0,2,4,6,33.3%,1h
35889,1,[AiRǂ]Roxy,2266,39,2,4,6,33.3%,53m
35889,2,Diyar,2266,48,2,6,8,25.0%,58m
35889,1,[NucLea]ExperT,2266,0,1,1,2,50.0%,1h
35889,1,LilaEismann,2266,0,1,2,3,33.3%,31m
35889,2,Mriswith,2266,0,1,5,6,16.7%,32m
35889,1,Boo,2266,0,0,1,1,0.0%,45m
35889,1,[filip]Yom,2266,0,0,2,2,0.0%,10m
35889,1,[HUNBT]balintmester,2266,0,0,2,2,0.0%,47m
35889,1,Jojo,2266,0,0,5,5,0.0%,30m
35911,1,iskaimin,2265,1190,97,87,184,52.7%,11m
35911,3,NecesaryEVIL,2265,1205,58,61,119,48.7%,1h
35911,1,Mity,2265,717,33,20,53,62.3%,10m
35911,1,Clay,2265,738,24,31,55,43.6%,44m
35911,1,Red,2265,467,21,19,40,52.5%,1h
35911,1,Reaperdom,2265,526,15,18,33,45.5%,42m
35911,2,Reaper,2265,292,10,11,21,47.6%,34m
35911,1,Matek,2265,236,6,14,20,30.0%,56m
35911,3,lostone,2265,186,6,16,22,27.3%,33m
35911,2,Dardasa,2265,98,4,0,4,100.0%,13m
35911,3,Gadzinka,2265,84,4,10,14,28.6%,53m
35911,1,Hexec,2265,0,3,3,6,50.0%,10m
35911,1,KENT,2265,112,3,4,7,42.9%,56m
35911,3,mrERASER,2265,60,3,11,14,21.4%,54m
35911,1,Sssilez,2265,42,2,4,6,33.3%,29m
35911,2,Praid,2265,73,2,7,9,22.2%,35m
35911,1,Palo,2265,0,1,3,4,25.0%,43m
35911,3,Prostaandr,2265,0,0,2,2,0.0%,35m
35911,1,Banan,2265,0,0,3,3,0.0%,51m
35930,2,tuğçe,2264,1337,153,151,304,50.3%,12m
35930,1,terran,2264,1568,61,53,114,53.5%,56m
35930,1,AsA,2264,916,34,46,80,42.5%,32m
35930,1,ZORO,2264,406,15,11,26,57.7%,56m
35930,2,[CRIMP]Nerobaronj,2264,241,12,2,14,85.7%,39m
35930,1,[NZB]Janex,2264,413,12,14,26,46.2%,58m
35930,1,Alex,2264,270,11,15,26,42.3%,3m
35930,3,Polaris,2264,218,7,10,17,41.2%,58m
35930,2,Spray,2264,198,6,5,11,54.5%,34m
35930,1,Wilkens,2264,228,6,10,16,37.5%,1h
35930,2,[НасРат]MorionRus,2264,156,5,2,7,71.4%,1h
35930,1,FlowerPot,2264,138,4,5,9,44.4%,8m
35930,1,BurryProtos,2264,130,4,7,11,36.4%,1h
35930,3,Mikielle,2264,146,3,6,9,33.3%,30m
35930,2,simapl,2264,48,2,2,4,50.0%,37m
35930,2,[lkgg]MOMO,2264,0,1,4,5,20.0%,59m
35930,2,[DÖRKH]SirKätzchen,2264,0,0,1,1,0.0%,57m
35930,2,[PuSo]AngryHika,2264,0,0,1,1,0.0%,47m
35930,1,[зерно]KibeRPanc,2264,0,0,4,4,0.0%,52m
35949,3,Anko,2263,901,64,64,128,50.0%,27m
35949,1,[Arrows]Vitako,2263,1176,39,46,85,45.9%,5m
35949,1,Almighty,2263,550,24,26,50,48.0%,12m
35949,1,SegøØ,2263,712,22,30,52,42.3%,45m
35949,1,Петрович,2263,619,21,27,48,43.8%,4m
35949,1,arzack,2263,444,17,13,30,56.7%,48m
35949,1,Grozz,2263,428,16,14,30,53.3%,8m
35949,1,Жужа,2263,345,12,19,31,38.7%,29m
35949,1,ZânaMăselută,2263,221,10,3,13,76.9%,12m
35949,2,[004]Dave,2263,202,8,3,11,72.7%,1h
35949,2,Marcel,2263,212,7,5,12,58.3%,45m
35949,1,malibdeen,2263,202,7,6,13,53.8%,54m
35949,1,DLHD,2263,46,4,5,9,44.4%,29m
35949,1,[OGCC]leraxs,2263,44,2,3,5,40.0%,40m
35949,1,GeneralMagma,2263,97,1,1,2,50.0%,2m
35949,2,tivire,2263,32,1,2,3,33.3%,10m
35949,2,Basstowel,2263,0,1,4,5,20.0%,31m
35949,2,FrIzen,2263,0,1,4,5,20.0%,6m
35949,1,Means,2263,0,1,5,6,16.7%,10m
35949,2,repulsion,2263,0,0,1,1,0.0%,47m
35949,2,Separ,2263,0,0,1,1,0.0%,51m
35970,2,Ars,2262,316,14,8,22,63.6%,29m
35970,1,Nobody,2262,289,6,10,16,37.5%,1h
35970,2,DANEFANTOM,2262,102,4,3,7,57.1%,13m
35970,2,Audi,2262,38,4,10,14,28.6%,48m
35970,2,Feanor,2262,48,2,4,6,33.3%,55m
35970,1,xKyoRo,2262,0,2,6,8,25.0%,39m
35970,3,антон,2262,0,1,5,6,16.7%,1h
35970,2,Eternal,2262,0,0,1,1,0.0%,1h
35970,3,Player,2262,0,0,2,2,0.0%,56m
35970,1,Blairwitch,2262,0,0,3,3,0.0%,4m
35970,1,Catanelu,2262,0,0,3,3,0.0%,36m
35981,1,TheCrusher,2261,451,14,12,26,53.8%,3m
35981,1,DznJackimilk,2261,366,10,12,22,45.5%,8m
35981,3,[T800]vakar,2261,62,5,6,11,45.5%,29m
35981,2,SENTINEL,2261,150,3,8,11,27.3%,4m
35981,1,[ALPis]schane,2261,42,2,2,4,50.0%,43m
35981,1,Vic,2261,118,2,2,4,50.0%,2m
35981,1,codeTwelve,2261,48,2,5,7,28.6%,50m
35981,1,kell,2261,48,2,8,10,20.0%,34m
35981,3,Освободитель,2261,30,1,2,3,33.3%,48m
35981,2,[VALET]ERETIK,2261,0,0,1,1,0.0%,1h
35981,2,MrHeisenber,2261,0,0,1,1,0.0%,59m
35981,1,Lucathiel,2261,0,0,2,2,0.0%,58m
35993,1,VoZSo,2260,1485,57,61,118,48.3%,4m
35993,3,BreakPunk,2260,1081,46,45,91,50.5%,13m
35993,3,kcoclemac,2260,828,39,47,86,45.3%,13m
35993,1,Bear,2260,1004,34,34,68,50.0%,53m
35993,1,Lakal,2260,938,29,33,62,46.8%,1h
35993,1,Darderion,2260,466,14,20,34,41.2%,1h
35993,1,asav,2260,193,4,7,11,36.4%,47m
35993,2,[CMGB]ßÅrT,2260,0,2,3,5,40.0%,45m
35993,2,iceberg,2260,0,1,0,1,100.0%,8m
35993,2,BetalGeze,2260,0,0,1,1,0.0%,1h
35993,2,Andreyako,2260,0,0,1,1,0.0%,28m
35993,1,Tassadare,2260,0,0,4,4,0.0%,30m
36005,3,[LeNi3]KoRnELpl,2259,1523,80,92,172,46.5%,33m
36005,1,DreamMethods,2259,254,29,25,54,53.7%,34m
36005,1,kvothe,2259,760,23,35,58,39.7%,1h
36005,3,Sportsmen,2259,320,12,21,33,36.4%,55m
36005,1,Corpuscular,2259,255,10,15,25,40.0%,37m
36005,1,Saveliy,2259,243,8,6,14,57.1%,35m
36005,1,Ottokristus,2259,300,8,10,18,44.4%,4m
36005,1,cybertooth,2259,40,6,3,9,66.7%,45m
36005,1,Lev,2259,194,6,6,12,50.0%,13m
36005,2,Viktor,2259,98,5,10,15,33.3%,43m
36005,2,Čuchoprd,2259,0,3,2,5,60.0%,48m
36005,1,Indaclub,2259,0,3,3,6,50.0%,45m
36005,2,firetank,2259,0,3,3,6,50.0%,1h
36005,1,POTE,2259,174,3,4,7,42.9%,55m
36005,1,Alexander,2259,127,3,6,9,33.3%,1h
36005,2,Raynor,2259,0,2,4,6,33.3%,1h
36005,2,Benniiee,2259,0,2,4,6,33.3%,52m
36005,2,ToRTiLLo,2259,137,2,5,7,28.6%,55m
36005,1,Pchel,2259,30,2,6,8,25.0%,55m
36005,1,Ashad,2259,0,1,3,4,25.0%,1h
36005,2,Siub,2259,0,0,1,1,0.0%,30m
36005,2,[Herosi]Czareski,2259,0,0,1,1,0.0%,55m
36005,1,[grB420]Nico,2259,0,0,2,2,0.0%,13m
36028,1,[lupi]xmalfx,2258,1786,387,382,769,50.3%,51m
36028,2,Supersoft,2258,901,63,72,135,46.7%,2m
36028,2,shaineu,2258,791,35,29,64,54.7%,1h
36028,2,Rigel,2258,468,17,31,48,35.4%,1h
36028,1,Chukar,2258,217,7,7,14,50.0%,1h
36028,1,Liramoy,2258,144,4,7,11,36.4%,1h
36028,2,Zunie,2258,0,3,2,5,60.0%,29m
36028,3,YUL,2258,94,2,7,9,22.2%,28m
36028,1,DenChik,2258,0,0,2,2,0.0%,5m
36028,2,Tengu,2258,0,0,5,5,0.0%,54m
36038,2,Elkanijo,2257,678,53,53,106,50.0%,12m
36038,3,Flet,2257,562,34,40,74,45.9%,58m
36038,1,DeadShot,2257,751,28,30,58,48.3%,29m
36038,2,Athmoless,2257,681,24,35,59,40.7%,4m
36038,1,major,2257,546,20,18,38,52.6%,57m
36038,1,Mentuso,2257,195,5,5,10,50.0%,36m
36038,1,MoRk,2257,208,5,13,18,27.8%,53m
36038,1,Raider,2257,97,3,7,10,30.0%,58m
36038,3,GOTALT,2257,60,3,8,11,27.3%,1h
36038,1,Aende,2257,170,3,9,12,25.0%,53m
36038,1,Nickname,2257,40,2,4,6,33.3%,55m
36038,2,Spartaneca,2257,48,2,5,7,28.6%,2m
36038,3,SangreS,2257,0,2,5,7,28.6%,40m
36038,2,Pinky,2257,62,2,6,8,25.0%,35m
36038,1,[BiBAP]Gorean,2257,48,2,7,9,22.2%,11m
36038,2,[CОS]Heretic,2257,0,1,0,1,100.0%,31m
36038,2,Andrey,2257,34,1,1,2,50.0%,45m
36038,2,Nazgul,2257,0,1,1,2,50.0%,7m
36038,1,Bennoda,2257,97,1,7,8,12.5%,39m
36038,2,TERRAkiller,2257,0,0,1,1,0.0%,1h
36038,1,Soraja,2257,0,0,3,3,0.0%,8m
36038,1,shader,2257,0,0,5,5,0.0%,53m
36060,1,majK,2256,1309,138,147,285,48.4%,53m
36060,1,Nexo,2256,991,86,86,172,50.0%,1h
36060,3,dukE,2256,1405,63,63,126,50.0%,13m
36060,1,[OmDi]Shoes,2256,1458,62,49,111,55.9%,33m
36060,1,Engelking,2256,1154,42,37,79,53.2%,44m
36060,1,arsen,2256,756,22,32,54,40.7%,11m
36060,1,Aruruderecht,2256,427,21,11,32,65.6%,1h
36060,1,Sahem,2256,522,19,21,40,47.5%,1h
36060,1,PMB,2256,546,17,21,38,44.7%,1h
36060,3,mat,2256,328,14,21,35,40.0%,41m
36060,1,Ulothrix,2256,122,4,5,9,44.4%,1h
36060,2,[Rus2]Zombie,2256,119,3,0,3,100.0%,35m
36060,1,Kyaze,2256,74,3,8,11,27.3%,1h
36060,2,Alien,2256,0,2,2,4,50.0%,55m
36060,1,Ciprian,2256,97,2,5,7,28.6%,1h
36060,2,Infidèle,2256,0,1,0,1,100.0%,1h
36060,1,MajorAndy,2256,91,1,2,3,33.3%,55m
36060,2,TheDuck,2256,0,1,5,6,16.7%,55m
36060,2,CorneliQ,2256,0,1,5,6,16.7%,47m
36060,2,Fatwa,2256,0,0,1,1,0.0%,1h
36080,1,Александр,2255,1304,44,47,91,48.4%,44m
36080,1,WindCent,2255,997,37,30,67,55.2%,29m
36080,1,Leshka,2255,302,12,6,18,66.7%,51m
36080,1,Life,2255,393,12,19,31,38.7%,1h
36080,1,TasVoid,2255,356,11,10,21,52.4%,12m
36080,1,[KoyBee]Serralfanboy,2255,328,11,13,24,45.8%,50m
36080,2,VseNaDno,2255,237,8,13,21,38.1%,1h
36080,1,NikerGuns,2255,211,6,4,10,60.0%,58m
36080,2,GladioBAB,2255,0,3,2,5,60.0%,1h
36080,2,еммДрасте,2255,34,2,0,2,100.0%,8m
36080,1,Bre,2255,98,2,3,5,40.0%,2m
36080,1,AngeIDust,2255,36,2,4,6,33.3%,8m
36080,2,Fraketrain,2255,0,2,7,9,22.2%,1h
36080,2,TheVoron,2255,0,1,0,1,100.0%,7m
36080,2,Merluzote,2255,0,1,0,1,100.0%,45m
36080,2,[mfxed]Diabeloo,2255,88,1,2,3,33.3%,40m
36080,2,Raph,2255,0,1,4,5,20.0%,1h
36080,2,sembems,2255,0,0,1,1,0.0%,10m
36098,1,KeYka,2254,640,30,18,48,62.5%,1h
36098,1,[ArNaQu]mathieu,2254,778,23,23,46,50.0%,27m
36098,1,[VdpV]PloKoon,2254,674,19,23,42,45.2%,58m
36098,3,crux,2254,320,14,19,33,42.4%,55m
36098,1,Beelzebub,2254,296,11,8,19,57.9%,4m
36098,1,Teratoma,2254,231,8,7,15,53.3%,10m
36098,3,Itherael,2254,192,5,6,11,45.5%,5m
36098,2,Ivanhoe,2254,64,3,1,4,75.0%,1h
36098,2,[I2x2I]SaSHko,2254,0,3,2,5,60.0%,2m
36098,2,Track,2254,109,3,8,11,27.3%,7m
36098,2,alexeich,2254,121,2,1,3,66.7%,34m
36098,2,[FCTX]Viuran,2254,66,2,2,4,50.0%,40m
36098,1,[STMS]Krosis,2254,76,2,4,6,33.3%,58m
36098,2,Vasilevs,2254,0,1,2,3,33.3%,47m
36098,1,timpark,2254,76,1,6,7,14.3%,37m
36098,3,Champions,2254,0,0,1,1,0.0%,27m
36098,2,[HMarch]KNOBODYIKNOW,2254,0,0,1,1,0.0%,9m
36115,1,Revo,2253,701,27,24,51,52.9%,1h
36115,1,llllllllllll,2253,377,22,23,45,48.9%,8m
36115,1,Ggoo,2253,498,17,21,38,44.7%,53m
36115,2,Latrell,2253,390,13,18,31,41.9%,57m
36115,2,era,2253,88,2,0,2,100.0%,29m
36115,2,aPerson,2253,32,2,0,2,100.0%,36m
36115,1,boergi,2253,0,2,6,8,25.0%,55m
36115,2,Aurumъ,2253,0,1,1,2,50.0%,55m
36115,2,NiNeu,2253,0,1,4,5,20.0%,51m
36115,1,Furbo,2253,0,1,6,7,14.3%,40m
36115,1,Schorschi,2253,38,1,6,7,14.3%,12m
36115,2,Sammers,2253,0,0,1,1,0.0%,44m
36115,2,FGGSP,2253,0,0,1,1,0.0%,36m
36115,1,[xFRSx]UKctus,2253,0,0,2,2,0.0%,1h
36115,1,Hrvoje,2253,0,0,4,4,0.0%,53m
36130,2,Brutalisk,2252,658,25,20,45,55.6%,44m
36130,1,Phonecall,2252,310,11,8,19,57.9%,2m
36130,1,Onegin,2252,282,9,15,24,37.5%,4m
36130,2,Abaddon,2252,190,8,16,24,33.3%,39m
36130,2,Red,2252,0,4,7,11,36.4%,14m
36130,2,SirVlad,2252,0,3,4,7,42.9%,44m
36130,2,Raggnars,2252,0,2,3,5,40.0%,28m
36130,2,RETRO,2252,32,1,2,3,33.3%,1h
36130,1,Hades,2252,0,1,2,3,33.3%,1h
36130,1,[AnVi]GuroFan,2252,0,1,5,6,16.7%,1h
36130,1,Obiron,2252,0,1,5,6,16.7%,5m
36130,1,poinashero,2252,0,1,6,7,14.3%,45m
36130,2,[monstr]hercules,2252,0,0,1,1,0.0%,1h
36130,2,Чебурек,2252,0,0,1,1,0.0%,44m
36144,1,Mistic,2251,809,37,22,59,62.7%,12m
36144,1,[PROSTA]MARTIN,2251,722,34,32,66,51.5%,36m
36144,1,Doberka,2251,691,21,32,53,39.6%,53m
36144,1,Slaaatt,2251,358,13,9,22,59.1%,44m
36144,2,[НОД17]SCII,2251,346,10,8,18,55.6%,1h
36144,1,PUZZLEINC,2251,239,5,2,7,71.4%,33m
36144,1,tabouta,2251,208,5,11,16,31.2%,4m
36144,1,Chmurkins,2251,108,4,8,12,33.3%,12m
36144,2,[DEAD2R]SLAY,2251,0,1,2,3,33.3%,54m
36144,2,[LMZW]madnesowsky,2251,0,0,1,1,0.0%,1h
36144,2,frosty,2251,0,0,1,1,0.0%,38m
36144,2,amandy,2251,0,0,1,1,0.0%,14m
36144,1,Rasty,2251,0,0,1,1,0.0%,1h
36144,1,Cruella,2251,0,0,3,3,0.0%,33m
36158,2,Franz,2250,1499,77,73,150,51.3%,1h
36158,1,Ana,2250,820,40,21,61,65.6%,47m
36158,1,[lBSGl]KotBegemot,2250,844,26,30,56,46.4%,2m
36158,2,Tetto,2250,462,17,27,44,38.6%,8m
36158,1,Lin,2250,388,14,9,23,60.9%,44m
36158,1,Ashtech,2250,344,12,17,29,41.4%,54m
36158,1,Virtua,2250,321,10,8,18,55.6%,53m
36158,1,luminiq,2250,301,9,8,17,52.9%,1h
36158,1,Wussa,2250,192,6,10,16,37.5%,1h
36158,1,SkullCandy,2250,237,5,9,14,35.7%,55m
36158,2,Deadrabbit,2250,30,3,7,10,30.0%,11m
36158,3,BUBS,2250,30,3,8,11,27.3%,30m
36158,2,Horus,2250,0,2,4,6,33.3%,1h
36158,2,[E2F]Arsenic,2250,97,2,5,7,28.6%,45m
36158,3,iiiiiiiiiiii,2250,88,2,6,8,25.0%,52m
36158,3,[хмкт]ХмурыйКот,2250,93,2,6,8,25.0%,47m
36158,2,[RuVoid]Predator,2250,0,1,0,1,100.0%,45m
36158,1,[Profix]Unikum,2250,0,1,4,5,20.0%,4m
36176,2,доктор,2249,1152,142,147,289,49.1%,39m
36176,1,Friday,2249,980,58,52,110,52.7%,13m
36176,1,Vag,2249,1205,53,56,109,48.6%,54m
36176,1,biased,2249,1080,39,41,80,48.8%,43m
36176,3,stargate,2249,861,32,37,69,46.4%,60m
36176,1,Fiskesuppe,2249,294,9,7,16,56.2%,58m
36176,3,EGOIST,2249,242,9,15,24,37.5%,52m
36176,1,kvric,2249,262,7,9,16,43.8%,1h
36176,1,iNTER,2249,227,6,9,15,40.0%,51m
36176,2,jhgjtyttryhg,2249,0,0,1,1,0.0%,1h
36176,1,thabigcuck,2249,0,0,2,2,0.0%,46m
36176,1,[рейнор]ДобрыйЗЕРГ,2249,0,0,2,2,0.0%,1h
36188,1,[CS0]Krytos,2248,1164,41,39,80,51.2%,3m
36188,1,Taki,2248,609,18,22,40,45.0%,29m
36188,1,[SSSC2]KyleSFive,2248,439,14,21,35,40.0%,29m
36188,1,energilyold,2248,399,11,10,21,52.4%,53m
36188,1,[OverX]Стронг,2248,378,10,16,26,38.5%,8m
36188,1,Happy,2248,264,8,7,15,53.3%,55m
36188,1,Mihalych,2248,284,8,12,20,40.0%,47m
36188,1,Manatee,2248,232,7,11,18,38.9%,1h
36188,1,[NZO]KiLiug,2248,170,5,6,11,45.5%,1h
36188,1,Phoenix,2248,154,5,6,11,45.5%,48m
36188,2,LEV,2248,62,3,1,4,75.0%,1h
36188,2,[TWCE]ElJefe,2248,32,2,5,7,28.6%,35m
36188,2,IronFist,2248,0,1,4,5,20.0%,1h
36188,2,GameOfDrones,2248,0,0,1,1,0.0%,5m
36188,1,врсмло,2248,0,0,1,1,0.0%,44m
36203,2,Medvvin,2247,1140,80,94,174,46.0%,47m
36203,2,ULTRAMOETOR,2247,974,54,51,105,51.4%,9m
36203,1,Likon,2247,1355,52,44,96,54.2%,13m
36203,1,necroix,2247,856,36,41,77,46.8%,3m
36203,1,ketch,2247,848,35,36,71,49.3%,12m
36203,1,frAp,2247,904,31,30,61,50.8%,40m
36203,1,[БУБУБ]fidger,2247,462,14,14,28,50.0%,49m
36203,1,BleepBloOp,2247,436,13,14,27,48.1%,3m
36203,2,[ZЕRGTV]Бесстрашный,2247,147,6,9,15,40.0%,1h
36203,2,lolmot,2247,154,6,9,15,40.0%,11m
36203,2,Bajinx,2247,0,4,6,10,40.0%,4m
36203,2,PersikZerg,2247,0,2,3,5,40.0%,28m
36203,2,[lNN]MrHoney,2247,0,1,0,1,100.0%,1h
36203,1,[Cybro]alfad,2247,0,1,1,2,50.0%,58m
36203,1,OlD,2247,48,1,2,3,33.3%,51m
36203,2,Kalooo,2247,0,0,1,1,0.0%,31m
36203,1,Kelvincomrat,2247,0,0,3,3,0.0%,12m
36203,1,Mariusroby,2247,0,0,5,5,0.0%,59m
36221,3,luczefer,2246,1594,212,211,423,50.1%,1h
36221,1,Beetle,2246,1271,54,49,103,52.4%,27m
36221,3,tararim,2246,263,11,9,20,55.0%,10m
36221,2,SlaaV,2246,377,11,15,26,42.3%,11m
36221,1,Rustymattok,2246,168,5,7,12,41.7%,43m
36221,2,Starborn,2246,92,4,1,5,80.0%,33m
36221,1,[LOOOOS]RobotVegan,2246,152,4,7,11,36.4%,54m
36221,1,[emyru]Zarigüeya,2246,160,4,11,15,26.7%,44m
36221,1,llllllllllll,2246,147,3,7,10,30.0%,35m
36221,2,Manio,2246,60,2,2,4,50.0%,1h
36221,2,SAINT,2246,0,2,3,5,40.0%,48m
36221,2,Trushek,2246,60,2,3,5,40.0%,45m
36221,1,mafiosi,2246,48,2,3,5,40.0%,11m
36221,1,[z666z]frace,2246,111,2,6,8,25.0%,35m
36221,1,skszaTU,2246,97,2,6,8,25.0%,55m
36221,3,tytan,2246,0,2,6,8,25.0%,30m
36221,2,Havok,2246,0,0,1,1,0.0%,1h
36221,2,[NetGG]ChernoAlpha,2246,0,0,1,1,0.0%,38m
36221,2,NeverMInd,2246,0,0,1,1,0.0%,1h
36221,1,Ivor,2246,0,0,2,2,0.0%,1h
36221,1,gleb,2246,0,0,2,2,0.0%,56m
36242,1,Gabounch,2245,1318,60,64,124,48.4%,1h
36242,1,[Тянки]Reaper,2245,1042,53,43,96,55.2%,12m
36242,1,[2bgr2]Sumrak,2245,1275,51,52,103,49.5%,1h
36242,2,[BlackX]Kendatchi,2245,733,47,65,112,42.0%,7m
36242,1,Leprosorium,2245,447,24,26,50,48.0%,31m
36242,1,SnowManGo,2245,530,20,18,38,52.6%,56m
36242,2,Masochist,2245,213,9,18,27,33.3%,58m
36242,1,Bosniii,2245,182,8,15,23,34.8%,7m
36242,1,Qwfon,2245,176,7,3,10,70.0%,40m
36242,1,DedNoob,2245,183,5,9,14,35.7%,41m
36242,3,Dreger,2245,125,3,4,7,42.9%,4m
36242,1,Dante,2245,122,3,7,10,30.0%,45m
36242,3,McWiebel,2245,121,3,8,11,27.3%,60m
36242,1,Wolftron,2245,0,1,1,2,50.0%,4m
36242,2,AgrPigeon,2245,0,1,3,4,25.0%,1h
36242,1,NinjaRobot,2245,0,1,4,5,20.0%,13m
36242,1,Yesterday,2245,48,1,6,7,14.3%,8m
36242,2,Tanglydrop,2245,0,0,1,1,0.0%,1h
36242,2,ToYoS,2245,0,0,1,1,0.0%,54m
36242,2,[Naissu]DrOctO,2245,0,0,1,1,0.0%,55m
36262,3,[Splend]Derral,2244,1459,83,81,164,50.6%,1h
36262,1,[So0]weset,2244,827,53,45,98,54.1%,40m
36262,1,ace,2244,1007,46,50,96,47.9%,36m
36262,2,Shaman,2244,936,35,41,76,46.1%,1h
36262,1,EnDOrFIncHIC,2244,517,23,13,36,63.9%,43m
36262,2,[ZERGTB]Drogon,2244,381,16,3,19,84.2%,1h
36262,3,Wolf,2244,244,7,10,17,41.2%,57m
36262,2,[QLSS]DevoltN,2244,162,5,0,5,100.0%,1h
36262,1,[SwgBoi]Nanuuki,2244,147,4,7,11,36.4%,29m
36262,1,Starlord,2244,120,3,6,9,33.3%,40m
36262,2,[soldat]Adelante,2244,32,2,0,2,100.0%,53m
36262,2,Tarrasque,2244,0,1,3,4,25.0%,1h
36262,1,Boozinger,2244,0,0,3,3,0.0%,1h
36275,1,ZerGutt,2243,1754,349,359,708,49.3%,48m
36275,1,Dimka,2243,1707,136,128,264,51.5%,54m
36275,3,[DТ]Accelerator,2243,1085,47,51,98,48.0%,29m
36275,1,malice,2243,811,28,30,58,48.3%,1h
36275,1,Thoko,2243,682,26,30,56,46.4%,29m
36275,3,[NICHE]allegro,2243,700,24,32,56,42.9%,3m
36275,1,SuMBiD,2243,462,17,15,32,53.1%,58m
36275,2,tema,2243,428,16,16,32,50.0%,4m
36275,3,promo,2243,357,12,20,32,37.5%,30m
36275,2,deligan,2243,297,11,10,21,52.4%,60m
36275,1,cherry,2243,198,7,10,17,41.2%,29m
36275,2,Zippy,2243,98,3,4,7,42.9%,33m
36275,1,[AGEAE]Noshimoto,2243,96,3,8,11,27.3%,3m
36275,2,ProAcid,2243,34,2,0,2,100.0%,33m
36275,2,[azerty]ETERNITY,2243,96,1,1,2,50.0%,1h
36275,2,Ziffa,2243,0,1,4,5,20.0%,34m
36275,2,Adrolan,2243,0,0,1,1,0.0%,9m
36275,2,[R4Time]KingCrimson,2243,0,0,1,1,0.0%,1h
36275,3,Dragnez,2243,0,0,1,1,0.0%,13m
36275,2,zero,2243,0,0,2,2,0.0%,1h
36275,1,PleVz,2243,0,0,2,2,0.0%,46m
36275,1,Dizar,2243,0,0,3,3,0.0%,57m
36297,3,DaiOmmA,2242,1470,112,121,233,48.1%,33m
36297,2,STIGMAWOW,2242,1132,73,67,140,52.1%,1h
36297,1,Baayo,2242,1196,39,39,78,50.0%,40m
36297,1,XoOTTOoX,2242,646,22,20,42,52.4%,29m
36297,1,Score,2242,577,20,21,41,48.8%,10m
36297,2,Snaiky,2242,306,14,4,18,77.8%,59m
36297,3,StukovFan,2242,343,12,12,24,50.0%,1h
36297,1,ALCfr,2242,320,8,9,17,47.1%,46m
36297,3,xman,2242,224,7,9,16,43.8%,13m
36297,2,cichy,2242,144,6,3,9,66.7%,1h
36297,1,StarfightrBG,2242,236,6,11,17,35.3%,54m
36297,1,Kir,2242,114,3,4,7,42.9%,56m
36297,2,MagicPylon,2242,125,2,1,3,66.7%,59m
36297,2,Tobinator,2242,121,2,2,4,50.0%,49m
36297,1,Mike,2242,89,1,3,4,25.0%,11m
36297,2,Tomcat,2242,0,1,5,6,16.7%,50m
36297,2,GvanGReaper,2242,0,0,1,1,0.0%,1h
36297,2,Inquisitor,2242,0,0,2,2,0.0%,42m
36315,1,zecaraz,2241,563,21,16,37,56.8%,11m
36315,1,[Vioc]Gazelle,2241,629,20,23,43,46.5%,11m
36315,1,SquirellFox,2241,411,16,18,34,47.1%,53m
36315,2,BassMonton,2241,311,12,8,20,60.0%,59m
36315,2,Dryupa,2241,266,9,9,18,50.0%,1h
36315,1,BendeR,2241,233,7,7,14,50.0%,29m
36315,1,Nibler,2241,244,6,9,15,40.0%,54m
36315,1,[ZCORP]Mhan,2241,162,5,5,10,50.0%,37m
36315,2,llllllllllll,2241,30,2,0,2,100.0%,1h
36315,1,Nemesis,2241,0,2,4,6,33.3%,13m
36315,2,[NSH]Demiurge,2241,0,1,1,2,50.0%,58m
36315,2,Veroci,2241,0,0,1,1,0.0%,37m
36327,1,Supermacer,2240,1645,68,76,144,47.2%,31m
36327,2,whYAsk,2240,1005,43,45,88,48.9%,57m
36327,3,Nimp,2240,768,42,53,95,44.2%,4m
36327,1,RoaringWrath,2240,795,27,37,64,42.2%,41m
36327,2,alex,2240,594,23,14,37,62.2%,2m
36327,1,[Opticz]WUrax,2240,512,19,22,41,46.3%,1h
36327,3,nnm,2240,478,16,24,40,40.0%,45m
36327,1,İnFeruu,2240,459,15,17,32,46.9%,1h
36327,3,mzyou,2240,289,12,9,21,57.1%,8m
36327,1,Gromozeba,2240,237,10,16,26,38.5%,33m
36327,1,Shadowking,2240,160,9,7,16,56.2%,10m
36327,1,kaylogs,2240,48,3,8,11,27.3%,41m
36327,2,[calbos]SilentStorm,2240,46,2,1,3,66.7%,54m
36327,1,vileider,2240,0,2,6,8,25.0%,39m
36327,2,[FearEU]darkmin,2240,48,2,7,9,22.2%,29m
36327,2,martous,2240,0,1,4,5,20.0%,44m
36343,1,Mezmerise,2239,1381,59,57,116,50.9%,1h
36343,1,DobryKot,2239,960,29,29,58,50.0%,1h
36343,1,TheMechanic,2239,808,28,28,56,50.0%,29m
36343,2,[Listic]Jeppsson,2239,489,18,10,28,64.3%,4m
36343,2,nightshift,2239,385,15,8,23,65.2%,54m
36343,2,USUL,2239,223,6,9,15,40.0%,1h
36343,1,[TН]Only,2239,116,6,13,19,31.6%,6m
36343,2,Hitzar,2239,132,5,1,6,83.3%,13m
36343,1,[FFPC]Jagerbomber,2239,210,5,8,13,38.5%,11m
36343,2,[KBomb]Mantizzla,2239,174,4,7,11,36.4%,29m
36343,2,kwaaaaa,2239,0,1,0,1,100.0%,54m
36343,2,SINGULARITY,2239,32,1,2,3,33.3%,57m
36343,1,DeathRiter,2239,14,1,4,5,20.0%,9m
36343,2,DaN,2239,0,0,1,1,0.0%,8m
36343,2,Mengsk,2239,0,0,1,1,0.0%,1h
36343,2,Pusish,2239,0,0,1,1,0.0%,1h
36343,2,Relgertan,2239,0,0,1,1,0.0%,1h
36343,1,Marcopolo,2239,0,0,2,2,0.0%,9m
36343,2,[LOVlaw]CAT,2239,0,0,2,2,0.0%,1h
36362,2,SoulReaper,2238,910,32,32,64,50.0%,49m
36362,1,[CxCx]димидролл,2238,592,17,20,37,45.9%,60m
36362,1,Bully,2238,267,12,5,17,70.6%,49m
36362,2,Floyd,2238,278,10,7,17,58.8%,44m
36362,1,TrioBoss,2238,221,8,14,22,36.4%,11m
36362,3,Jokezstar,2238,157,6,8,14,42.9%,41m
36362,1,[SoNaYo]SkillZero,2238,0,1,0,1,100.0%,51m
36362,2,Mehmew,2238,30,1,3,4,25.0%,50m
36362,2,Uzym,2238,0,1,4,5,20.0%,11m
36362,2,Kuli,2238,0,0,1,1,0.0%,44m
36372,2,Egorizmo,2237,615,21,27,48,43.8%,10m
36372,1,KoshNaranek,2237,676,20,27,47,42.6%,8m
36372,1,Artaron,2237,658,19,23,42,45.2%,36m
36372,1,Ranuu,2237,365,10,14,24,41.7%,3m
36372,1,AdvreX,2237,262,9,8,17,52.9%,29m
36372,3,AntikPrisadk,2237,294,9,13,22,40.9%,1h
36372,1,Diabolical,2237,257,6,9,15,40.0%,6m
36372,2,FireDen,2237,222,6,11,17,35.3%,1h
36372,2,IIIIIIIIIIII,2237,112,5,2,7,71.4%,43m
36372,1,FFF,2237,170,5,9,14,35.7%,37m
36372,1,akaydo,2237,187,4,8,12,33.3%,35m
36372,2,ZerokS,2237,119,3,4,7,42.9%,55m
36372,1,DannyTheMany,2237,145,2,1,3,66.7%,59m
36372,2,[ERIC]NexNinja,2237,58,2,5,7,28.6%,1h
36372,1,Player,2237,48,2,6,8,25.0%,39m
36372,2,Xenon,2237,0,1,0,1,100.0%,14m
36372,2,Elcorniv,2237,0,0,1,1,0.0%,54m
36372,2,Silron,2237,0,0,1,1,0.0%,37m
36372,2,Valefor,2237,0,0,1,1,0.0%,8m
36372,2,Reloaded,2237,0,0,1,1,0.0%,34m
36392,3,[ExTr1m]iMUSE,2236,1541,111,111,222,50.0%,5m
36392,3,soare,2236,1274,98,99,197,49.7%,12m
36392,1,Rompek,2236,835,33,24,57,57.9%,5m
36392,1,PantyDropper,2236,741,30,19,49,61.2%,29m
36392,2,Szatos,2236,654,24,24,48,50.0%,29m
36392,1,KLIP,2236,513,15,25,40,37.5%,4m
36392,2,KaosTalon,2236,338,12,5,17,70.6%,11m
36392,1,Bachman,2236,388,11,16,27,40.7%,29m
36392,1,Feziu,2236,324,11,16,27,40.7%,1h
36392,1,dentex,2236,354,10,16,26,38.5%,41m
36392,1,[II3II]DRLR,2236,344,9,12,21,42.9%,11m
36392,3,Fluttershy,2236,160,7,16,23,30.4%,1h
36392,1,SoiBoi,2236,48,5,6,11,45.5%,33m
36392,1,[DiPeNi]mib,2236,160,4,7,11,36.4%,59m
36392,1,Кобан,2236,42,2,6,8,25.0%,4m
36392,1,WarLordXx,2236,48,2,8,10,20.0%,41m
36392,3,Konstantin,2236,30,2,8,10,20.0%,48m
36392,1,BorshNah,2236,0,1,1,2,50.0%,11m
36392,2,[Corvum]Shinobi,2236,32,1,2,3,33.3%,1h
36392,1,[DeThXD]CaNdYpAnDa,2236,0,0,1,1,0.0%,47m
36392,2,Tryfonus,2236,0,0,1,1,0.0%,1h
36392,2,MaX,2236,73,0,5,5,0.0%,47m
36414,1,ICE,2235,818,61,57,118,51.7%,1h
36414,1,Borg,2235,890,40,43,83,48.2%,1h
36414,2,ПаДж,2235,642,25,23,48,52.1%,14m
36414,1,Irbis,2235,679,19,22,41,46.3%,1h
36414,1,[1231PH]Doomshoop,2235,312,11,20,31,35.5%,58m
36414,1,[chickn]BlueHaze,2235,250,8,11,19,42.1%,54m
36414,3,[LKDSC2]Tacata,2235,198,6,6,12,50.0%,57m
36414,1,brunao,2235,133,5,1,6,83.3%,60m
36414,3,Demented,2235,146,3,2,5,60.0%,1h
36414,2,OmsrPro,2235,0,0,1,1,0.0%,11m
36414,2,Arkanoid,2235,0,0,1,1,0.0%,48m
36425,1,RushFortress,2234,272,22,14,36,61.1%,3m
36425,1,[DTST]nilz,2234,298,10,8,18,55.6%,31m
36425,1,rattenplan,2234,142,3,5,8,37.5%,13m
36425,1,Lip,2234,0,1,2,3,33.3%,54m
36425,2,Raynans,2234,36,1,3,4,25.0%,7m
36425,1,[АСС]ILvIR,2234,73,1,3,4,25.0%,41m
36425,2,pizhon,2234,0,0,1,1,0.0%,1h
36425,2,Waggy,2234,0,0,1,1,0.0%,1h
36425,2,Loshok,2234,0,0,1,1,0.0%,55m
36425,2,аааццц,2234,0,0,1,1,0.0%,1h
36435,1,HoBa,2233,1663,73,70,143,51.0%,1h
36435,1,mavmp,2233,1543,57,57,114,50.0%,59m
36435,2,mattis,2233,892,37,27,64,57.8%,30m
36435,3,khaos,2233,1072,36,50,86,41.9%,37m
36435,1,Анвар,2233,496,25,12,37,67.6%,1h
36435,2,BigC,2233,489,18,18,36,50.0%,1h
36435,2,Quezocoatl,2233,293,11,9,20,55.0%,1h
36435,2,Chrissi,2233,312,10,12,22,45.5%,30m
36435,2,[лунааа]starkiller,2233,253,7,9,16,43.8%,3m
36435,1,BASON,2233,44,3,9,12,25.0%,1h
36435,2,[290720]ComanderFabi,2233,32,2,0,2,100.0%,29m
36435,1,[Ximic]Тиховет,2233,48,2,4,6,33.3%,39m
36435,3,Дмитрий,2233,0,1,0,1,100.0%,36m
36435,2,[mfixed]scarlett,2233,0,0,1,1,0.0%,14m
36435,2,Shirouz,2233,0,0,1,1,0.0%,1h
36435,2,złotakaczka,2233,0,0,1,1,0.0%,1h
36451,1,Nils,2232,1726,185,183,368,50.3%,44m
36451,1,Rakit,2232,481,42,52,94,44.7%,3m
36451,2,Ryo,2232,597,19,18,37,51.4%,30m
36451,1,mustBEnice,2232,219,16,11,27,59.3%,36m
36451,1,MacWaldspast,2232,460,13,17,30,43.3%,29m
36451,2,Shockwâvê,2232,314,11,14,25,44.0%,1h
36451,2,thedude,2232,137,9,15,24,37.5%,1h
36451,1,[HAKS]BLACKALIROSE,2232,232,6,12,18,33.3%,7m
36451,2,Raziel,2232,62,3,7,10,30.0%,1h
36451,1,Zealot,2232,92,2,1,3,66.7%,46m
36451,1,hahaha,2232,0,2,5,7,28.6%,40m
36451,2,Ryuk,2232,48,1,2,3,33.3%,7m
36451,2,PenguinRIOT,2232,0,1,6,7,14.3%,1h
36451,2,LuckyPig,2232,0,0,1,1,0.0%,37m
36451,2,Mhue,2232,0,0,2,2,0.0%,10m
36451,1,Mates,2232,0,0,2,2,0.0%,43m
36451,3,[EndEmp]ManParuda,2232,0,0,5,5,0.0%,57m
36451,2,Rednoodle,2232,0,0,5,5,0.0%,33m
36469,1,Jan,2231,832,36,55,91,39.6%,30m
36469,1,Death,2231,718,25,26,51,49.0%,7m
36469,2,Chalice,2231,307,13,1,14,92.9%,50m
36469,2,Turdinson,2231,329,10,9,19,52.6%,1h
36469,1,Ronin,2231,294,10,12,22,45.5%,54m
36469,1,[DL2006]Hybrid,2231,306,8,8,16,50.0%,1h
36469,1,Galeodes,2231,152,5,0,5,100.0%,47m
36469,1,[CBraz]Centalia,2231,99,4,12,16,25.0%,11m
36469,2,ETALIANEC,2231,0,2,2,4,50.0%,3m
36478,3,Lauodamus,2230,1507,215,226,441,48.8%,40m
36478,1,ArutyunSWAG,2230,1578,60,60,120,50.0%,27m
36478,1,Hubbabubba,2230,1230,43,49,92,46.7%,58m
36478,1,[SMBD]Jackdest,2230,841,36,28,64,56.2%,11m
36478,1,Manfo,2230,775,36,34,70,51.4%,37m
36478,1,[GNORI]Oguretrix,2230,470,22,14,36,61.1%,40m
36478,1,ILYA,2230,564,22,17,39,56.4%,13m
36478,1,PurpelUrkel,2230,648,18,20,38,47.4%,46m
36478,2,GriFoN,2230,250,16,20,36,44.4%,1h
36478,1,yan,2230,234,9,9,18,50.0%,40m
36478,3,GhostMan,2230,178,8,12,20,40.0%,55m
36478,1,Bazil,2230,326,7,13,20,35.0%,11m
36478,2,игрок,2230,70,3,1,4,75.0%,36m
36478,2,DemonSlayer,2230,34,2,1,3,66.7%,11m
36478,2,Malajka,2230,0,1,0,1,100.0%,35m
36478,3,whitebetter,2230,0,1,1,2,50.0%,60m
36478,2,dragon,2230,0,0,1,1,0.0%,44m
36478,2,lauri,2230,0,0,1,1,0.0%,1h
36478,2,DarkBlood,2230,0,0,2,2,0.0%,54m
36478,2,Vlad,2230,0,0,5,5,0.0%,9m
36498,3,Kvazar,2229,1494,144,150,294,49.0%,58m
36498,3,[PND18]Cabal,2229,1531,58,72,130,44.6%,41m
36498,1,SamuraiPaNDa,2229,868,32,35,67,47.8%,11m
36498,2,[GSBLol]WhitePink,2229,800,31,30,61,50.8%,12m
36498,3,Hiddenhung,2229,283,11,8,19,57.9%,1h
36498,1,RadioSonic,2229,207,11,17,28,39.3%,1h
36498,1,Tascobo,2229,250,8,7,15,53.3%,40m
36498,2,Eiger,2229,88,7,3,10,70.0%,12m
36498,3,Кисаморто,2229,149,4,2,6,66.7%,44m
36498,1,GioeleZ,2229,108,4,9,13,30.8%,29m
36498,1,ApolloRO,2229,97,3,6,9,33.3%,56m
36498,2,coco,2229,0,2,1,3,66.7%,60m
36498,1,[PLA2N]DenverXP,2229,0,2,4,6,33.3%,35m
36498,2,TomHariless,2229,0,1,1,2,50.0%,36m
36498,1,Fenrir,2229,48,1,4,5,20.0%,1h
36498,2,venril,2229,0,1,4,5,20.0%,45m
36498,1,[2DNeko]Hairitan,2229,0,0,1,1,0.0%,6m
36498,2,slevin,2229,0,0,1,1,0.0%,7m
36516,1,SaucizPurée,2228,1718,156,166,322,48.4%,9m
36516,2,guillevr,2228,1410,52,52,104,50.0%,1h
36516,2,castero,2228,364,21,19,40,52.5%,36m
36516,2,efoincflcefc,2228,421,19,33,52,36.5%,4m
36516,1,Toede,2228,269,9,8,17,52.9%,48m
36516,1,benjo,2228,198,8,4,12,66.7%,57m
36516,2,Praad,2228,152,5,6,11,45.5%,10m
36516,3,Robot,2228,199,5,10,15,33.3%,57m
36516,1,Hanter,2228,193,4,5,9,44.4%,48m
36516,1,lentie,2228,89,3,4,7,42.9%,56m
36516,2,ТЕМА,2228,0,1,4,5,20.0%,4m
36516,2,fich,2228,0,0,1,1,0.0%,30m
36516,2,Dodo,2228,0,0,1,1,0.0%,11m
36529,1,GrafVadim,2227,553,23,15,38,60.5%,50m
36529,3,JonasDT,2227,543,22,28,50,44.0%,45m
36529,1,Yuriv,2227,446,15,19,34,44.1%,29m
36529,1,[aNNa]JeanneOscour,2227,257,15,22,37,40.5%,43m
36529,1,BagpipeSnipe,2227,160,5,3,8,62.5%,5m
36529,2,[tjack]sad,2227,64,2,2,4,50.0%,53m
36529,2,[Fabbel]DimonDeleron,2227,30,1,1,2,50.0%,4m
36529,1,Cantine,2227,0,1,5,6,16.7%,53m
36529,1,Nemeros,2227,0,1,6,7,14.3%,43m
36529,2,KODIAK,2227,0,0,1,1,0.0%,35m
36529,2,SilverMoon,2227,0,0,1,1,0.0%,11m
36529,2,[lolxdx]kezdo,2227,0,0,5,5,0.0%,1h
36529,1,George,2227,0,0,6,6,0.0%,12m
36542,2,durca,2226,1077,178,173,351,50.7%,1h
36542,1,Blümchen,2226,1359,113,124,237,47.7%,35m
36542,1,Sabu,2226,773,100,93,193,51.8%,31m
36542,1,Rulez,2226,944,32,36,68,47.1%,9m
36542,1,МегаПицца,2226,637,19,28,47,40.4%,7m
36542,1,Kotlett,2226,534,16,22,38,42.1%,36m
36542,1,Sewip,2226,318,11,15,26,42.3%,1h
36542,3,AlastorM,2226,250,10,12,22,45.5%,1h
36542,1,aegolius,2226,374,10,13,23,43.5%,1h
36542,2,Puchupazi,2226,206,7,6,13,53.8%,10m
36542,3,Mszczuj,2226,235,7,13,20,35.0%,1h
36542,2,STYPLA,2226,154,5,4,9,55.6%,50m
36542,2,ULTRAARNE,2226,86,4,1,5,80.0%,10m
36542,1,DannyBoi,2226,0,3,2,5,60.0%,37m
36542,2,Xenomorph,2226,60,3,5,8,37.5%,39m
36542,1,Cristianx,2226,110,2,3,5,40.0%,54m
36542,2,eyal,2226,0,1,0,1,100.0%,42m
36542,2,Rathalos,2226,0,1,3,4,25.0%,55m
36542,2,nibeon,2226,0,0,1,1,0.0%,1h
36542,2,Изящно,2226,0,0,1,1,0.0%,1h
36562,2,ElonaGay,2225,879,50,69,119,42.0%,1h
36562,1,Bargel,2225,1032,37,39,76,48.7%,58m
36562,1,Manson,2225,392,32,27,59,54.2%,53m
36562,2,MeddlE,2225,772,28,30,58,48.3%,45m
36562,2,Mitko,2225,382,12,11,23,52.2%,1h
36562,2,Bimireul,2225,301,11,7,18,61.1%,45m
36562,2,shura,2225,296,10,10,20,50.0%,54m
36562,1,Sansonan,2225,333,9,9,18,50.0%,1h
36562,1,[МЕD0ED]Ekranial,2225,182,8,3,11,72.7%,38m
36562,3,minimupp,2225,181,6,11,17,35.3%,1h
36562,2,Capablanca,2225,154,5,15,20,25.0%,53m
36562,2,ARYEN,2225,62,2,1,3,66.7%,1h
36562,2,GeraltOutlaw,2225,0,1,0,1,100.0%,1h
36562,2,Madden,2225,36,1,4,5,20.0%,36m
36562,1,Invizzy,2225,0,1,4,5,20.0%,54m
36562,2,Jep,2225,0,1,4,5,20.0%,46m
36562,2,Arren,2225,0,1,4,5,20.0%,5m
36562,2,Zerpoad,2225,97,1,5,6,16.7%,1h
36562,3,Terminator,2225,30,1,7,8,12.5%,1h
36562,2,BlackCape,2225,0,0,1,1,0.0%,50m
36562,2,Lotos,2225,0,0,5,5,0.0%,58m
36583,1,Evgenii,2224,429,41,33,74,55.4%,1h
36583,2,[AnC1ub]GhostK,2224,757,32,25,57,56.1%,33m
36583,2,FeniksRUS,2224,645,25,13,38,65.8%,40m
36583,1,FishA,2224,752,21,30,51,41.2%,50m
36583,1,[GIBLA]Spoky,2224,440,13,15,28,46.4%,35m
36583,2,RoberPower,2224,258,10,7,17,58.8%,31m
36583,1,Dogservice,2224,241,8,9,17,47.1%,51m
36583,1,[2RVLV]Gribouille,2224,84,5,6,11,45.5%,49m
36583,1,Kulek,2224,42,4,6,10,40.0%,1h
36583,1,Inferno,2224,196,4,7,11,36.4%,57m
36583,1,sparta,2224,82,3,6,9,33.3%,12m
36583,2,Scarecrow,2224,30,3,9,12,25.0%,1h
36583,1,leolex,2224,145,2,6,8,25.0%,11m
36583,2,kapibara,2224,0,1,0,1,100.0%,54m
36583,2,Pedrito,2224,0,1,6,7,14.3%,45m
36583,1,MnschnFressr,2224,0,0,1,1,0.0%,1h
36583,2,LazyTitan,2224,0,0,1,1,0.0%,53m
36583,2,ElMnchacho,2224,0,0,2,2,0.0%,54m
36601,1,[nosexx]BrokenAss,2223,1432,91,91,182,50.0%,11m
36601,1,Lehabes,2223,1094,62,58,120,51.7%,41m
36601,1,Borney,2223,710,22,21,43,51.2%,40m
36601,1,SenSaiSam,2223,734,22,23,45,48.9%,58m
36601,2,[Lolers]Mrpoloko,2223,578,22,31,53,41.5%,1h
36601,2,Arflock,2223,406,13,15,28,46.4%,42m
36601,2,SolArgenti,2223,281,10,3,13,76.9%,1h
36601,2,joeski,2223,58,5,4,9,55.6%,11m
36601,2,broncetoGMez,2223,144,5,4,9,55.6%,31m
36601,3,flamestorm,2223,150,5,12,17,29.4%,13m
36601,1,Krasiolet,2223,134,3,2,5,60.0%,1h
36601,1,[SSPoc]EMty,2223,103,2,3,5,40.0%,60m
36601,1,RIckon,2223,91,2,3,5,40.0%,9m
36601,1,RedDevil,2223,97,2,7,9,22.2%,39m
36601,1,IrisiaIsley,2223,46,2,7,9,22.2%,1h
36601,2,ZibelBobel,2223,88,1,2,3,33.3%,44m
36601,1,Xelaxo,2223,42,1,5,6,16.7%,36m
36601,2,Грейтус,2223,0,1,5,6,16.7%,55m
36601,3,Sneaky,2223,30,1,6,7,14.3%,39m
36601,2,sasha,2223,0,0,2,2,0.0%,1h
36601,3,[ExTr1m]MaverickClaw,2223,0,0,2,2,0.0%,57m
36601,1,IIIIIIIIII,2223,0,0,3,3,0.0%,54m
36623,1,[B76]MikeDuC,2222,620,23,32,55,41.8%,3m
36623,2,LeaderUSSR,2222,377,14,11,25,56.0%,54m
36623,1,[WCKYLN]Handke,2222,516,14,17,31,45.2%,1h
36623,3,Puckich,2222,293,10,13,23,43.5%,8m
36623,1,ketjow,2222,82,5,5,10,50.0%,1h
36623,1,Nurshat,2222,120,4,5,9,44.4%,11m
36623,2,Erika,2222,84,3,2,5,60.0%,45m
36623,2,Baraba,2222,62,2,1,3,66.7%,3m
36623,1,kellog,2222,84,2,7,9,22.2%,1h
36623,2,Throgaash,2222,30,1,3,4,25.0%,30m
36623,2,Frost,2222,0,1,4,5,20.0%,1h
36623,1,RedWolf,2222,40,1,7,8,12.5%,56m
36623,2,ivod,2222,0,0,1,1,0.0%,6m
36623,2,Gremlin,2222,0,0,1,1,0.0%,1h
36623,2,Fcknkarl,2222,0,0,2,2,0.0%,1h
36638,1,Dusken,2221,1762,81,77,158,51.3%,40m
36638,1,Haosit,2221,723,51,46,97,52.6%,3m
36638,1,Snobist,2221,413,13,11,24,54.2%,58m
36638,1,Evo,2221,166,5,11,16,31.2%,1h
36638,3,Corben,2221,144,4,9,13,30.8%,53m
36638,2,ShamanKirduk,2221,46,2,5,7,28.6%,54m
36638,1,InsaneFace,2221,0,2,5,7,28.6%,58m
36638,1,QuitscheEnte,2221,119,2,7,9,22.2%,44m
36638,2,dragonlord,2221,0,1,6,7,14.3%,1h
36638,2,Virginia,2221,0,0,1,1,0.0%,31m
36638,2,NoEffort,2221,0,0,5,5,0.0%,55m
36649,1,kstkn,2220,1161,166,149,315,52.7%,50m
36649,1,СерпИмолот,2220,1000,77,67,144,53.5%,48m
36649,1,KaLaSh,2220,402,14,16,30,46.7%,57m
36649,2,aymanmehawed,2220,146,5,3,8,62.5%,1h
36649,1,Cebas,2220,194,5,7,12,41.7%,9m
36649,2,[2iq]Shizoid,2220,141,4,4,8,50.0%,60m
36649,2,pahipahi,2220,97,3,4,7,42.9%,1h
36649,2,TheRayGaming,2220,0,1,0,1,100.0%,45m
36649,2,[Heets]timbik,2220,0,1,1,2,50.0%,1h
36649,2,PATAFON,2220,0,1,5,6,16.7%,2m
36649,1,Nakhttoter,2220,44,1,7,8,12.5%,46m
36649,2,[ULTX]Snek,2220,0,0,3,3,0.0%,9m
36661,1,bmc,2219,334,19,19,38,50.0%,1h
36661,1,Alfred,2219,316,16,7,23,69.6%,41m
36661,2,Morsvite,2219,332,13,12,25,52.0%,10m
36661,1,[ttd13]Matt,2219,118,5,7,12,41.7%,11m
36661,2,SiloJopov,2219,94,3,4,7,42.9%,54m
36661,1,Spiritoftime,2219,40,3,6,9,33.3%,1h
36661,2,Satanas,2219,0,0,1,1,0.0%,5m
36668,1,Arno,2218,702,47,54,101,46.5%,57m
36668,1,drspartnil,2218,1282,45,43,88,51.1%,1h
36668,2,Hellstaff,2218,613,20,23,43,46.5%,39m
36668,1,Landkindt,2218,297,9,13,22,40.9%,9m
36668,2,Yammamotosan,2218,158,6,15,21,28.6%,7m
36668,3,SiSiFliegen,2218,121,3,3,6,50.0%,1h
36668,1,matiko,2218,160,3,5,8,37.5%,31m
36668,2,portoslemac,2218,60,2,2,4,50.0%,59m
36668,1,Seboulba,2218,86,2,9,11,18.2%,54m
36668,1,ALTRISTE,2218,0,1,1,2,50.0%,13m
36668,2,Chiefo,2218,95,1,5,6,16.7%,1h
36668,1,Runcis,2218,0,0,1,1,0.0%,33m
36668,2,[CОS]innoVation,2218,0,0,1,1,0.0%,59m
36668,2,[Mastr]killers,2218,0,0,1,1,0.0%,47m
36668,2,GenghisKhan,2218,0,0,2,2,0.0%,44m
36683,1,OMEGABOOM,2217,468,18,17,35,51.4%,1h
36683,1,Protoss,2217,445,17,18,35,48.6%,53m
36683,2,pOlTrA,2217,382,15,22,37,40.5%,42m
36683,1,elxan,2217,412,14,23,37,37.8%,2m
36683,1,Sergg,2217,426,12,16,28,42.9%,1h
36683,1,[QaQa]Quasar,2217,238,6,6,12,50.0%,39m
36683,1,Jhappi,2217,30,5,3,8,62.5%,53m
36683,1,Olschbox,2217,121,5,6,11,45.5%,33m
36683,2,[NCT]Lakhamu,2217,62,3,4,7,42.9%,1h
36683,1,MAZI,2217,84,3,8,11,27.3%,1h
36683,1,[urzerg]Anna,2217,74,2,5,7,28.6%,54m
36683,2,Pandémie,2217,0,1,0,1,100.0%,1h
36683,2,SadMan,2217,30,1,3,4,25.0%,50m
36683,2,HydraD,2217,0,0,1,1,0.0%,1h
36683,2,Gunsmas,2217,0,0,1,1,0.0%,14m
36683,2,HanSolo,2217,0,0,1,1,0.0%,1h
36683,2,erzhan,2217,0,0,5,5,0.0%,60m
36700,1,nin,2216,1686,155,153,308,50.3%,1h
36700,1,[firstb]maorlak,2216,979,35,36,71,49.3%,11m
36700,1,obo,2216,364,12,19,31,38.7%,55m
36700,1,nSorim,2216,334,11,21,32,34.4%,54m
36700,2,[BIGGIE]piyuyo,2216,194,7,5,12,58.3%,1h
36700,2,Randall,2216,94,3,6,9,33.3%,7m
36700,2,Lanzor,2216,76,2,2,4,50.0%,1h
36700,1,momchil,2216,0,2,6,8,25.0%,35m
36700,1,[PSIGH]Brutika,2216,80,2,7,9,22.2%,58m
36700,2,Corol,2216,0,1,4,5,20.0%,1h
36700,2,Originalname,2216,46,1,6,7,14.3%,2m
36700,1,Auswahlliste,2216,44,1,8,9,11.1%,10m
36700,2,cookie,2216,0,0,2,2,0.0%,14m
36713,1,[T3N]Qwerty,2215,678,23,30,53,43.4%,46m
36713,2,ArgentiSol,2215,288,10,9,19,52.6%,55m
36713,1,SunriseSky,2215,284,8,8,16,50.0%,47m
36713,1,Mercenario,2215,192,5,10,15,33.3%,50m
36713,2,Paschy,2215,150,4,9,13,30.8%,3m
36713,2,JSanchez,2215,0,1,0,1,100.0%,54m
36713,2,demidonjkee,2215,96,1,5,6,16.7%,38m
36713,2,[ILSA]Alpha,2215,0,0,1,1,0.0%,1h
36713,1,Nasekomoe,2215,0,0,1,1,0.0%,11m
36713,1,[Панки]Myata,2215,0,0,6,6,0.0%,12m
36723,1,[WARHED]napster,2214,1055,129,136,265,48.7%,36m
36723,2,String,2214,573,25,27,52,48.1%,14m
36723,2,IIIIIIIIII,2214,461,20,22,42,47.6%,3m
36723,1,DarkShadow,2214,572,18,23,41,43.9%,29m
36723,1,WildCatling,2214,490,15,18,33,45.5%,1h
36723,1,Ragnarson,2214,355,10,15,25,40.0%,35m
36723,1,Alexandru,2214,150,6,2,8,75.0%,57m
36723,2,LeninJiv,2214,220,6,9,15,40.0%,8m
36723,2,ALPJUAN,2214,114,5,0,5,100.0%,3m
36723,1,rasX,2214,48,5,4,9,55.6%,58m
36723,1,Pierre,2214,161,5,9,14,35.7%,31m
36723,3,Brindille,2214,153,4,8,12,33.3%,30m
36723,2,Krevetochka,2214,62,3,2,5,60.0%,1h
36723,1,Smokey,2214,96,3,8,11,27.3%,43m
36723,2,ДимаGSpot,2214,30,2,0,2,100.0%,55m
36723,2,Ghost,2214,32,2,2,4,50.0%,9m
36723,2,DFLight,2214,0,2,3,5,40.0%,3m
36723,2,VACSS,2214,94,2,7,9,22.2%,7m
36723,2,llllllllllll,2214,0,1,4,5,20.0%,9m
36723,2,XxBOOSTERxX,2214,46,1,6,7,14.3%,60m
36723,3,Darktall,2214,0,0,1,1,0.0%,1h
36723,2,HAPPYGOOSE,2214,0,0,1,1,0.0%,29m
36723,2,DONALDTRUMP,2214,0,0,1,1,0.0%,8m
36723,1,[5NSK4]WobisRUSSIA,2214,0,0,2,2,0.0%,44m
36723,2,Serg,2214,0,0,2,2,0.0%,1h
36748,1,ottoman,2213,1544,56,66,122,45.9%,45m
36748,1,Rockstarr,2213,474,27,33,60,45.0%,57m
36748,2,Tosondr,2213,650,21,43,64,32.8%,59m
36748,2,Davinchio,2213,383,13,17,30,43.3%,1h
36748,2,SAdemon,2213,139,8,5,13,61.5%,9m
36748,1,Mike,2213,191,7,6,13,53.8%,1h
36748,3,LacertaX,2213,150,5,17,22,22.7%,36m
36748,2,Kairory,2213,132,4,6,10,40.0%,52m
36748,1,TIGER,2213,48,3,8,11,27.3%,48m
36748,2,RaiRai,2213,0,1,3,4,25.0%,58m
36748,2,[DeGame]LostHope,2213,0,0,1,1,0.0%,45m
36748,2,pasa,2213,0,0,1,1,0.0%,1h
36748,2,ваня,2213,0,0,1,1,0.0%,1h
36748,2,[UIS]SeqZZ,2213,0,0,1,1,0.0%,49m
36748,2,Acestriker,2213,0,0,2,2,0.0%,29m
36763,3,AndreiAra,2212,1225,45,51,96,46.9%,30m
36763,1,Eaglewatch,2212,436,17,18,35,48.6%,46m
36763,1,sergykTT,2212,402,14,12,26,53.8%,27m
36763,2,Romario,2212,410,14,15,29,48.3%,50m
36763,2,futrzak,2212,434,14,15,29,48.3%,54m
36763,2,Dimmu,2212,391,12,12,24,50.0%,28m
36763,2,[MQQ]Arudin,2212,266,10,9,19,52.6%,1h
36763,2,ivga,2212,184,5,4,9,55.6%,59m
36763,1,Семеринко,2212,155,3,5,8,37.5%,44m
36763,1,dino,2212,48,2,8,10,20.0%,1h
36763,2,Кефир,2212,93,1,1,2,50.0%,8m
36763,2,Aleksandr,2212,0,1,1,2,50.0%,34m
36763,2,jerus,2212,0,1,1,2,50.0%,1h
36763,1,Lexx,2212,0,1,2,3,33.3%,51m
36763,1,PROdoom,2212,91,1,4,5,20.0%,40m
36763,1,AlexUA,2212,0,1,6,7,14.3%,50m
36763,2,Дима,2212,0,1,6,7,14.3%,48m
36763,2,[BestIG]joel,2212,0,0,1,1,0.0%,34m
36763,2,[GRUNDI]Aries,2212,0,0,1,1,0.0%,55m
36782,2,catmaster,2211,393,16,7,23,69.6%,4m
36782,2,SYKAYAKTO,2211,310,14,7,21,66.7%,45m
36782,2,[LokiXX]DanniPlayBoy,2211,90,4,2,6,66.7%,1h
36782,1,Lissi,2211,74,3,8,11,27.3%,47m
36782,1,RaNDaLL,2211,0,2,8,10,20.0%,13m
36782,2,DekanSwift,2211,0,1,1,2,50.0%,1h
36782,1,Rixifox,2211,38,1,3,4,25.0%,54m
36782,2,InkEE,2211,0,0,1,1,0.0%,42m
36782,2,DROOJ,2211,0,0,2,2,0.0%,53m
36791,2,Storm,2210,1629,271,280,551,49.2%,1h
36791,1,eugenyyy,2210,1731,65,64,129,50.4%,56m
36791,1,ZiSheTou,2210,1169,39,43,82,47.6%,11m
36791,3,neirinho,2210,496,19,21,40,47.5%,40m
36791,2,Victor,2210,388,14,11,25,56.0%,55m
36791,1,QuickSort,2210,495,14,16,30,46.7%,9m
36791,1,NikiBobonjik,2210,471,14,20,34,41.2%,4m
36791,1,theboxghost,2210,295,9,17,26,34.6%,1h
36791,1,[ZrgSw]exploit,2210,310,8,17,25,32.0%,59m
36791,1,BìoníC,2210,159,6,10,16,37.5%,33m
36791,1,[Teror]Fok,2210,208,6,11,17,35.3%,41m
36791,3,Russianrap,2210,60,3,3,6,50.0%,57m
36791,1,[Olеg]Cheezh,2210,0,2,4,6,33.3%,48m
36791,3,LilWorld,2210,60,2,11,13,15.4%,46m
36791,2,[ZЕRGТV]Greenkrolik,2210,0,1,0,1,100.0%,29m
36791,1,reptinchu,2210,0,0,1,1,0.0%,53m
36791,2,SamuraiJack,2210,0,0,5,5,0.0%,13m
36808,2,Moon,2209,442,19,15,34,55.9%,29m
36808,2,comertone,2209,544,19,18,37,51.4%,53m
36808,1,cafeconleche,2209,519,18,20,38,47.4%,46m
36808,1,Triatonix,2209,584,18,21,39,46.2%,4m
36808,2,GENi,2209,480,17,14,31,54.8%,36m
36808,2,[zhuds]Саня,2209,464,16,19,35,45.7%,3m
36808,2,ArtesFog,2209,354,14,27,41,34.1%,41m
36808,2,Avalon,2209,0,3,10,13,23.1%,33m
36808,1,Drender,2209,42,1,10,11,9.1%,1h
36808,2,benjamin,2209,0,0,1,1,0.0%,35m
36808,2,sven,2209,0,0,2,2,0.0%,49m
36819,1,[ATC28]pusztulat,2208,1098,47,39,86,54.7%,54m
36819,1,Lovpalek,2208,652,23,24,47,48.9%,1h
36819,1,GrumpyCat,2208,578,20,19,39,51.3%,11m
36819,2,[ДeRpy]ANIME,2208,184,7,6,13,53.8%,33m
36819,2,Céphalotank,2208,168,4,5,9,44.4%,10m
36819,1,Furyan,2208,0,2,4,6,33.3%,1h
36819,2,Miandro,2208,62,2,4,6,33.3%,13m
36819,2,sablezub,2208,0,1,0,1,100.0%,1h
36819,2,[zona]DLIJ,2208,0,1,0,1,100.0%,1h
36819,1,azuel,2208,0,1,4,5,20.0%,11m
36819,3,Basym,2208,30,1,6,7,14.3%,59m
36819,2,[панда]zErLONG,2208,0,0,1,1,0.0%,52m
36831,1,VinnyJazz,2207,1050,49,43,92,53.3%,1h
36831,1,dgeril,2207,1044,35,35,70,50.0%,1h
36831,1,[UNPE]Kcrook,2207,676,30,35,65,46.2%,31m
36831,1,Exo,2207,734,25,28,53,47.2%,29m
36831,1,PogoWorm,2207,516,19,22,41,46.3%,3m
36831,2,ToughKnight,2207,380,15,6,21,71.4%,39m
36831,1,[ЭЩКЕРЕ]Mihals,2207,440,14,26,40,35.0%,54m
36831,2,Cemen,2207,344,12,13,25,48.0%,36m
36831,1,[PARSE]simi,2207,137,5,6,11,45.5%,58m
36831,1,Николай,2207,110,4,9,13,30.8%,45m
36831,1,Aizen,2207,119,3,2,5,60.0%,47m
36831,2,Guster,2207,0,3,2,5,60.0%,1h
36831,1,[FISI]Krypet,2207,0,3,3,6,50.0%,1h
36831,1,shadowlace,2207,78,3,4,7,42.9%,12m
36831,1,Poison,2207,48,2,6,8,25.0%,11m
36831,1,sverre,2207,0,1,1,2,50.0%,58m
36831,2,Kreker,2207,0,1,1,2,50.0%,52m
36831,2,LuckyPanda,2207,0,0,1,1,0.0%,50m
36831,2,DIYXFedastre,2207,0,0,1,1,0.0%,1h
36831,3,Magaruis,2207,0,0,6,6,0.0%,41m
36851,3,Achilles,2206,1528,158,176,334,47.3%,5m
36851,1,Yhtill,2206,1073,39,42,81,48.1%,1h
36851,2,anfaini,2206,758,28,31,59,47.5%,29m
36851,1,Moe,2206,724,20,24,44,45.5%,4m
36851,1,LovemyLady,2206,350,12,14,26,46.2%,49m
36851,1,Антоша,2206,202,8,7,15,53.3%,56m
36851,1,[luxdd]Gupu,2206,38,5,8,13,38.5%,54m
36851,2,[AIUR15]FAKE,2206,30,3,9,12,25.0%,40m
36851,2,[RBadB]GoldenCat,2206,48,2,0,2,100.0%,56m
36851,2,[olive]IIII,2206,0,1,0,1,100.0%,37m
36851,1,MaksSan,2206,46,1,2,3,33.3%,11m
36851,2,yazik,2206,34,1,3,4,25.0%,36m
36851,2,slevin,2206,0,0,1,1,0.0%,1h
36864,3,[DECIMA]kierantodds,2205,1023,94,92,186,50.5%,38m
36864,1,Miszol,2205,1476,57,57,114,50.0%,1h
36864,3,Skywalker,2205,551,57,63,120,47.5%,6m
36864,1,[xFDPx]JhnJhn,2205,1047,47,55,102,46.1%,31m
36864,1,Lemon,2205,913,35,33,68,51.5%,40m
36864,1,jarjar,2205,789,28,30,58,48.3%,1h
36864,3,ComJack,2205,674,24,29,53,45.3%,10m
36864,1,TpasUnKdo,2205,530,23,17,40,57.5%,1h
36864,1,[xRoSS]KuroYonu,2205,375,14,14,28,50.0%,12m
36864,1,splash,2205,228,7,9,16,43.8%,31m
36864,1,Eclipsej,2205,120,4,9,13,30.8%,29m
36864,1,[ATRX]ATARAXIUM,2205,68,4,12,16,25.0%,11m
36864,1,Trykester,2205,130,3,5,8,37.5%,1h
36864,2,TOMISLAV,2205,58,3,13,16,18.8%,58m
36864,2,sucemoi,2205,64,2,1,3,66.7%,35m
36864,1,SunSolar,2205,40,1,6,7,14.3%,1h
36864,1,OstraCytryna,2205,0,0,2,2,0.0%,1h
36864,1,darkpredator,2205,0,0,3,3,0.0%,44m
36864,1,Полунин,2205,0,0,3,3,0.0%,51m
36883,2,Antonisimus,2204,1617,67,63,130,51.5%,39m
36883,1,Morgul,2204,549,18,17,35,51.4%,40m
36883,1,Tomaszskała,2204,536,17,23,40,42.5%,37m
36883,3,EGORazo,2204,198,6,12,18,33.3%,1h
36883,2,[CZUMPI]Grodek,2204,92,2,3,5,40.0%,56m
36883,1,DeuS,2204,78,2,7,9,22.2%,46m
36883,1,kavezic,2204,34,2,7,9,22.2%,51m
36883,1,rodrigo,2204,0,2,9,11,18.2%,57m
36883,2,[YSRY]TerranTaran,2204,0,1,2,3,33.3%,36m
36883,1,Spetsnaz,2204,48,1,3,4,25.0%,48m
36883,2,Ciceron,2204,0,1,4,5,20.0%,5m
36883,1,icaro,2204,0,1,5,6,16.7%,9m
36883,2,[Jail]longeu,2204,0,0,1,1,0.0%,45m
36883,2,[NeCriN]ZizouLarson,2204,0,0,3,3,0.0%,45m
36897,1,DanceJunkie,2203,1092,79,70,149,53.0%,48m
36897,3,vpower,2203,1455,53,62,115,46.1%,45m
36897,2,[QuBuS]QuBuS,2203,269,10,7,17,58.8%,29m
36897,2,RAHITA,2203,147,6,6,12,50.0%,33m
36897,2,[ValidG]DeathIsAwe,2203,124,4,3,7,57.1%,46m
36897,1,Clairvoyant,2203,132,4,8,12,33.3%,51m
36897,2,[Blakey]TheFallen,2203,30,3,4,7,42.9%,1h
36897,2,deimik,2203,0,2,3,5,40.0%,13m
36897,1,Adikowski,2203,96,1,2,3,33.3%,47m
36897,1,Fuff,2203,48,1,4,5,20.0%,1h
36897,3,[PIZIKS]uvikay,2203,97,1,6,7,14.3%,1h
36897,2,Powiux,2203,0,0,1,1,0.0%,10m
36897,2,Mazay,2203,0,0,1,1,0.0%,1h
36910,1,TaPOCHek,2202,1007,35,35,70,50.0%,53m
36910,1,Nemesis,2202,748,24,29,53,45.3%,54m
36910,1,amrit,2202,606,18,28,46,39.1%,54m
36910,1,DarkLilix,2202,568,17,22,39,43.6%,58m
36910,2,serBlack,2202,406,14,10,24,58.3%,12m
36910,2,Toni,2202,164,14,13,27,51.9%,36m
36910,2,NotACat,2202,60,6,1,7,85.7%,12m
36910,1,kingkhalid,2202,90,5,12,17,29.4%,57m
36910,3,VerboMLG,2202,130,5,18,23,21.7%,4m
36910,2,Lukaz,2202,0,1,1,2,50.0%,47m
36910,2,LINCOLN,2202,0,1,1,2,50.0%,1h
36910,2,[KCHOJE]EloPrzemo,2202,0,1,5,6,16.7%,32m
36910,1,[CDIR]Bumhorn,2202,0,1,5,6,16.7%,47m
36910,1,макар,2202,0,1,6,7,14.3%,51m
36910,2,дикийлось,2202,0,0,1,1,0.0%,58m
36925,1,Wrathan,2201,1390,98,86,184,53.3%,1h
36925,1,sairon,2201,1044,38,37,75,50.7%,12m
36925,3,Infinity,2201,444,18,26,44,40.9%,11m
36925,1,[CDTMF]Vitarico,2201,220,6,9,15,40.0%,54m
36925,3,gfhjkl,2201,194,5,3,8,62.5%,1h
36925,1,Duk,2201,194,5,16,21,23.8%,35m
36925,1,oldway,2201,0,3,4,7,42.9%,53m
36925,2,[Zhig]Killtech,2201,0,2,3,5,40.0%,32m
36925,2,Aesarion,2201,0,1,0,1,100.0%,1h
36925,2,utemine,2201,0,1,1,2,50.0%,13m
36925,2,Eydis,2201,48,1,6,7,14.3%,12m
36925,2,danik,2201,0,0,1,1,0.0%,1h
36925,2,[DFYJTU]ALEXSSS,2201,0,0,1,1,0.0%,13m
36925,2,kIRa,2201,0,0,1,1,0.0%,3m
36925,2,VarWoids,2201,0,0,5,5,0.0%,52m
36925,2,[TODOW]Skajinx,2201,0,0,6,6,0.0%,50m
36941,3,flow,2200,1531,107,114,221,48.4%,38m
36941,2,Hope,2200,1060,83,85,168,49.4%,1h
36941,2,BroXan,2200,590,23,26,49,46.9%,47m
36941,1,qwerty,2200,496,19,22,41,46.3%,3m
36941,1,doompoo,2200,394,13,17,30,43.3%,56m
36941,2,Arcanex,2200,298,11,9,20,55.0%,3m
36941,1,[GrPt]Satan,2200,166,5,14,19,26.3%,43m
36941,2,Lekano,2200,175,4,9,13,30.8%,38m
36941,2,GaDanic,2200,64,2,2,4,50.0%,30m
36941,2,[1ftg]darkmole,2200,0,2,8,10,20.0%,1h
36941,2,Marlock,2200,0,1,0,1,100.0%,1h
36941,2,RuFF,2200,0,1,0,1,100.0%,36m
36941,2,DrOffensive,2200,0,1,1,2,50.0%,32m
36941,2,Bainkiller,2200,0,1,5,6,16.7%,2m
36941,2,JeanJo,2200,0,0,1,1,0.0%,1h
36941,2,TIM,2200,0,0,5,5,0.0%,32m
36957,2,NoboLulu,2199,1309,89,83,172,51.7%,54m
36957,1,Celta,2199,863,46,53,99,46.5%,1h
36957,2,CroProGaming,2199,364,16,11,27,59.3%,55m
36957,2,СТРЭЙК,2199,288,10,4,14,71.4%,39m
36957,1,saskeeeeee,2199,247,8,11,19,42.1%,38m
36957,3,chejahmonf,2199,197,5,7,12,41.7%,1h
36957,1,Flekz,2199,177,4,8,12,33.3%,3m
36957,1,Meanmachnie,2199,96,2,1,3,66.7%,51m
36957,2,Maxpatac,2199,0,2,3,5,40.0%,13m
36957,1,URAN,2199,145,2,4,6,33.3%,6m
36957,2,FlyingSheep,2199,88,1,5,6,16.7%,54m
36957,2,[baker]PauK,2199,0,0,1,1,0.0%,12m
36957,2,Totmato,2199,0,0,2,2,0.0%,1h
36970,1,Usiobrzusio,2198,1421,56,48,104,53.8%,36m
36970,2,WEODRES,2198,925,40,30,70,57.1%,13m
36970,2,FeLemonTM,2198,493,17,23,40,42.5%,8m
36970,1,[SNAV]Vainvain,2198,436,13,18,31,41.9%,9m
36970,1,каратель,2198,365,11,9,20,55.0%,55m
36970,1,angryANT,2198,298,8,10,18,44.4%,1h
36970,1,samir,2198,165,5,11,16,31.2%,1h
36970,1,Prometheus,2198,118,4,10,14,28.6%,53m
36970,2,GRIMM,2198,138,3,2,5,60.0%,33m
36970,1,romanovich,2198,76,3,5,8,37.5%,1h
36970,2,[DAHUS]Tom,2198,120,3,5,8,37.5%,28m
36970,2,Gordy,2198,0,1,0,1,100.0%,55m
36970,2,EmperorGG,2198,32,1,3,4,25.0%,55m
36970,2,дядяваня,2198,0,0,2,2,0.0%,5m
36970,2,Fares,2198,0,0,5,5,0.0%,9m
36985,1,enken,2197,1496,65,63,128,50.8%,29m
36985,1,[fackme]борода,2197,1381,49,55,104,47.1%,58m
36985,1,Legion,2197,780,28,27,55,50.9%,46m
36985,1,xYtriu,2197,510,20,19,39,51.3%,58m
36985,1,JustNoobie,2197,481,15,16,31,48.4%,40m
36985,2,ZxZ,2197,320,11,6,17,64.7%,1h
36985,1,NoxPrixcz,2197,274,10,12,22,45.5%,9m
36985,1,azerty,2197,229,7,8,15,46.7%,53m
36985,2,theSquid,2197,96,4,5,9,44.4%,37m
36985,2,Kroaxx,2197,96,1,1,2,50.0%,55m
36985,1,LadySwarm,2197,0,1,5,6,16.7%,51m
36985,2,prowll,2197,32,1,5,6,16.7%,1h
36985,3,Chernogled,2197,0,1,6,7,14.3%,29m
36985,2,shepa,2197,0,0,1,1,0.0%,59m
36985,2,Scorpion,2197,0,0,1,1,0.0%,1h
36985,1,[Lactor]Misterklick,2197,0,0,1,1,0.0%,40m
37001,1,lukasesok,2196,1168,42,44,86,48.8%,4m
37001,2,Pascal,2196,852,33,30,63,52.4%,56m
37001,2,lelemento,2196,715,28,29,57,49.1%,1h
37001,2,[LMBD]QuiGonJinn,2196,690,26,29,55,47.3%,45m
37001,2,AzA,2196,247,7,6,13,53.8%,1h
37001,2,Isond,2196,200,7,9,16,43.8%,54m
37001,2,GDBAD,2196,141,5,4,9,55.6%,1h
37001,2,LoveAndPeace,2196,106,3,3,6,50.0%,1h
37001,1,Lerner,2196,48,2,1,3,66.7%,3m
37001,2,Riddarvarg,2196,0,2,4,6,33.3%,1h
37001,2,Nuke,2196,96,2,5,7,28.6%,35m
37001,1,Jonny,2196,48,2,7,9,22.2%,43m
37001,1,Samalson,2196,0,1,6,7,14.3%,12m
37001,2,PanAdam,2196,0,0,1,1,0.0%,1h
37001,2,CallMeTibco,2196,0,0,1,1,0.0%,1h
37001,2,[JaPP]EMAE,2196,0,0,1,1,0.0%,14m
37001,3,Titruie,2196,0,0,2,2,0.0%,51m
37018,2,Ronagon,2195,1643,67,58,125,53.6%,1h
37018,2,GANIBBAL,2195,930,41,33,74,55.4%,1h
37018,2,SilentStorm,2195,973,40,37,77,51.9%,10m
37018,2,DonDiego,2195,424,14,16,30,46.7%,31m
37018,3,[SPAINs]Sergiohulkie,2195,331,12,25,37,32.4%,14m
37018,2,MINOS,2195,236,6,7,13,46.2%,35m
37018,2,wwwslezo,2195,96,4,1,5,80.0%,57m
37018,2,sow,2195,94,4,4,8,50.0%,54m
37018,2,Auirz,2195,0,2,4,6,33.3%,1h
37018,2,Skeltar,2195,60,2,5,7,28.6%,38m
37018,1,LouisCX,2195,0,1,0,1,100.0%,60m
37018,2,Tnardo,2195,0,1,0,1,100.0%,1h
37018,2,[OmDi]Hashlael,2195,34,1,2,3,33.3%,31m
37018,1,UggOR,2195,97,1,4,5,20.0%,9m
37018,1,deniolo,2195,40,1,5,6,16.7%,1h
37018,1,[DeHi]Pokemaster,2195,0,1,5,6,16.7%,12m
37018,2,finaldoom,2195,0,0,1,1,0.0%,54m
37018,2,Daniel,2195,0,0,1,1,0.0%,5m
37018,2,unimetal,2195,0,0,1,1,0.0%,55m
37037,2,[L2IMP]Japo,2194,630,22,28,50,44.0%,39m
37037,1,Affliction,2194,402,16,21,37,43.2%,41m
37037,2,inox,2194,355,12,16,28,42.9%,7m
37037,1,Nikolai,2194,212,6,9,15,40.0%,43m
37037,1,Tosh,2194,192,5,9,14,35.7%,49m
37037,2,Адель,2194,96,2,7,9,22.2%,1h
37037,2,CTPEJlOK,2194,0,1,0,1,100.0%,8m
37037,1,jimduyolo,2194,0,1,4,5,20.0%,9m
37037,2,Reginald,2194,0,1,4,5,20.0%,1h
37037,2,Blue,2194,0,0,5,5,0.0%,57m
37047,2,Voron,2193,330,17,5,22,77.3%,1h
37047,2,МосЛеро,2193,260,8,5,13,61.5%,29m
37047,2,CannonRusher,2193,170,5,10,15,33.3%,3m
37047,2,dozf,2193,46,4,3,7,57.1%,45m
37047,3,Musashi,2193,142,4,7,11,36.4%,8m
37047,2,LorrdPicollo,2193,0,1,4,5,20.0%,45m
37047,2,Master,2193,0,0,5,5,0.0%,30m
37054,3,fabibi,2192,1090,62,67,129,48.1%,13m
37054,1,CanBKN,2192,1082,49,47,96,51.0%,4m
37054,2,Jourdonnais,2192,511,20,14,34,58.8%,31m
37054,1,TomasGops,2192,500,20,16,36,55.6%,1h
37054,2,TyphonZede,2192,390,16,12,28,57.1%,9m
37054,1,Gabrio,2192,294,12,8,20,60.0%,54m
37054,1,[A0P]PontlEvêque,2192,192,6,7,13,46.2%,12m
37054,2,davkon,2192,96,4,2,6,66.7%,45m
37054,2,ApostaL,2192,106,4,4,8,50.0%,29m
37054,1,Arec,2192,123,3,8,11,27.3%,1h
37054,1,Fighugo,2192,104,3,11,14,21.4%,43m
37054,2,[game01]stasOI,2192,30,2,2,4,50.0%,14m
37054,1,Mexaformio,2192,0,1,0,1,100.0%,33m
37054,2,CHIMPATOM,2192,0,1,5,6,16.7%,29m
37054,1,letamesecco,2192,38,1,6,7,14.3%,1h
37069,1,soonewbie,2191,1329,155,169,324,47.8%,54m
37069,2,GrumpyPants,2191,987,40,38,78,51.3%,29m
37069,1,[HAVTT]NSC,2191,197,22,17,39,56.4%,11m
37069,1,nejdeath,2191,675,22,25,47,46.8%,45m
37069,2,[7I0]Cheesus,2191,597,21,16,37,56.8%,50m
37069,1,SAYgg,2191,374,17,27,44,38.6%,3m
37069,1,MindReader,2191,396,14,14,28,50.0%,9m
37069,1,[A100]prototer,2191,560,14,23,37,37.8%,46m
37069,2,JhonBoss,2191,206,8,6,14,57.1%,1h
37069,2,Milan,2191,136,5,8,13,38.5%,1h
37069,2,Арес,2191,0,1,0,1,100.0%,4m
37069,2,baryl,2191,0,1,1,2,50.0%,1h
37069,2,gouns,2191,32,1,2,3,33.3%,35m
37069,2,[PQNC]RodrigoGuido,2191,0,0,1,1,0.0%,13m
37069,1,julsoneQ,2191,0,0,1,1,0.0%,53m
37069,2,piotrov,2191,0,0,1,1,0.0%,4m
37069,1,[STDES]ciemny,2191,0,0,1,1,0.0%,38m
37086,1,BubX,2190,811,82,83,165,49.7%,55m
37086,2,Partyprophet,2190,1008,37,37,74,50.0%,1h
37086,2,Holland,2190,413,20,23,43,46.5%,45m
37086,1,Zook,2190,534,15,18,33,45.5%,12m
37086,2,Dobye,2190,188,6,6,12,50.0%,29m
37086,3,steinip,2190,222,6,12,18,33.3%,57m
37086,2,Zaggarrakss,2190,142,5,5,10,50.0%,11m
37086,1,[TRIO3]silentkeeper,2190,137,3,5,8,37.5%,1h
37086,2,meepmeep,2190,48,2,1,3,66.7%,1h
37086,2,ToXeN,2190,0,1,0,1,100.0%,3m
37086,1,Tom,2190,0,1,5,6,16.7%,1h
37086,2,maksi,2190,0,0,1,1,0.0%,52m
37086,3,misk,2190,0,0,3,3,0.0%,8m
37086,2,PsewDoKnight,2190,0,0,4,4,0.0%,1h
37086,2,SuperKillir,2190,0,0,4,4,0.0%,54m
37101,1,ForCorona,2189,1695,83,84,167,49.7%,35m
37101,1,[NOOBpl]nokia,2189,988,64,63,127,50.4%,9m
37101,1,davveis,2189,529,19,23,42,45.2%,38m
37101,1,ANGELRCXD,2189,379,12,14,26,46.2%,51m
37101,1,[8mylez]mylez,2189,357,10,15,25,40.0%,44m
37101,2,Alfa,2189,168,6,8,14,42.9%,13m
37101,1,PootyTang,2189,70,3,6,9,33.3%,1h
37101,1,Tor,2189,89,2,5,7,28.6%,6m
37101,2,Shootblood,2189,34,1,1,2,50.0%,54m
37101,1,Kirazzz,2189,0,1,1,2,50.0%,58m
37101,1,Dark,2189,0,1,2,3,33.3%,1h
37101,2,khrone,2189,0,1,5,6,16.7%,53m
37101,3,DarkKing,2189,0,1,6,7,14.3%,11m
37101,2,Ilmarinen,2189,0,0,1,1,0.0%,1h
37101,2,[NaNii]Sparda,2189,0,0,1,1,0.0%,1h
37101,2,UglyBustard,2189,0,0,1,1,0.0%,57m
37101,2,[TGZP]Nik,2189,0,0,1,1,0.0%,56m
37101,1,[GhRa]LümmelLörres,2189,0,0,4,4,0.0%,7m
37119,3,[BHN]ddev,2188,1427,125,135,260,48.1%,54m
37119,1,AlelCraft,2188,1688,121,116,237,51.1%,1h
37119,3,MYTOGEH,2188,1118,119,131,250,47.6%,38m
37119,1,BorsuK,2188,1649,101,100,201,50.2%,38m
37119,1,Frost,2188,773,37,40,77,48.1%,1h
37119,2,[DioBr]IndShock,2188,499,20,13,33,60.6%,31m
37119,3,Pedobear,2188,248,8,13,21,38.1%,57m
37119,2,torch,2188,147,3,4,7,42.9%,50m
37119,2,[FCCO]Shrike,2188,118,2,2,4,50.0%,11m
37119,2,Mayday,2188,0,2,4,6,33.3%,56m
37119,2,ARSbars,2188,0,0,1,1,0.0%,1h
37130,2,hmm,2187,634,24,16,40,60.0%,1h
37130,1,[PDB59]ChantalXXX,2187,514,15,22,37,40.5%,51m
37130,1,[SUDA]xapourep,2187,290,8,5,13,61.5%,1h
37130,1,taurinkill,2187,192,5,11,16,31.2%,47m
37130,1,Andrey,2187,87,3,3,6,50.0%,33m
37130,2,[PLA2N]Menorik,2187,0,1,1,2,50.0%,59m
37130,2,ixioxp,2187,32,1,3,4,25.0%,57m
37130,2,[JaPP]Luxfrium,2187,0,0,1,1,0.0%,32m
37130,2,sasha,2187,0,0,3,3,0.0%,36m
37130,2,Zerantoss,2187,0,0,3,3,0.0%,36m
37140,2,Эльфри,2186,828,52,48,100,52.0%,7m
37140,3,Reylgun,2186,1076,36,50,86,41.9%,34m
37140,2,Bzikeroff,2186,602,26,20,46,56.5%,13m
37140,2,Nomad,2186,520,19,19,38,50.0%,43m
37140,1,DiMiTRiO,2186,442,12,19,31,38.7%,12m
37140,1,Mougdefre,2186,319,10,12,22,45.5%,56m
37140,2,[OGCC]zorro,2186,264,9,10,19,47.4%,1h
37140,1,Mishas,2186,285,6,3,9,66.7%,1h
37140,3,Saman,2186,215,6,8,14,42.9%,39m
37140,2,Shathae,2186,30,3,9,12,25.0%,33m
37140,2,Tarchik,2186,0,1,3,4,25.0%,1h
37151,1,[XZ3R0X]BeHappyyy,2185,1683,129,122,251,51.4%,37m
37151,2,DIMAPIDORASS,2185,864,33,31,64,51.6%,54m
37151,3,Feuerfrosch,2185,446,18,21,39,46.2%,33m
37151,1,MCDaniil,2185,290,8,10,18,44.4%,50m
37151,1,cawa,2185,293,7,13,20,35.0%,1h
37151,2,lyra,2185,220,5,5,10,50.0%,31m
37151,1,maeon,2185,168,5,11,16,31.2%,51m
37151,3,Akotea,2185,0,4,5,9,44.4%,11m
37151,2,Ragnar,2185,162,4,6,10,40.0%,38m
37151,2,Never,2185,58,3,1,4,75.0%,45m
37151,2,uGod,2185,30,2,0,2,100.0%,1h
37151,2,[BlaSH]JeBlackHole,2185,97,2,1,3,66.7%,8m
37151,1,Dokles,2185,142,2,2,4,50.0%,40m
37151,2,[MinDes]SPIRIT,2185,60,2,4,6,33.3%,35m
37151,3,[Sande]Frog,2185,30,2,8,10,20.0%,41m
37151,2,Mazi,2185,0,0,1,1,0.0%,45m
37151,2,Mortiferr,2185,0,0,1,1,0.0%,45m
37151,3,[MBite]dicks,2185,0,0,2,2,0.0%,1h
37169,3,[Iperyt]Лизонька,2184,1339,263,289,552,47.6%,9m
37169,2,VERUIGIO,2184,610,24,16,40,60.0%,1h
37169,2,Kuromaru,2184,238,11,12,23,47.8%,40m
37169,2,Ebaka,2184,242,10,14,24,41.7%,35m
37169,1,Vic,2184,274,9,15,24,37.5%,44m
37169,1,Darkkiller,2184,298,9,16,25,36.0%,3m
37169,1,zins,2184,254,8,13,21,38.1%,58m
37169,2,Neal,2184,260,7,8,15,46.7%,57m
37169,1,Lexis,2184,48,4,5,9,44.4%,32m
37169,1,[BoTu]SLINSON,2184,112,4,9,13,30.8%,40m
37169,2,PREDATOR,2184,173,4,10,14,28.6%,1h
37169,2,Kaz,2184,46,3,4,7,42.9%,56m
37169,3,Tvorog,2184,94,2,7,9,22.2%,1h
37169,1,Dzyubinio,2184,48,1,2,3,33.3%,11m
37169,1,colemano,2184,0,1,5,6,16.7%,1h
37169,2,GOTHI,2184,0,1,5,6,16.7%,1h
37169,1,Knacks,2184,0,1,6,7,14.3%,12m
37169,1,Belesed,2184,0,1,6,7,14.3%,52m
37169,2,Flyper,2184,0,0,5,5,0.0%,9m
37169,2,kriskobg,2184,0,0,5,5,0.0%,1h
37189,1,shadowdanil,2183,1456,58,53,111,52.3%,1h
37189,1,ColonelWolf,2183,1105,37,44,81,45.7%,50m
37189,2,[TheDOH]thrashermax,2183,662,29,25,54,53.7%,1h
37189,1,DOOM,2183,311,9,10,19,47.4%,47m
37189,1,[Flammy]Wilkenson,2183,262,8,11,19,42.1%,54m
37189,1,Oboo,2183,180,6,5,11,54.5%,43m
37189,2,Rick,2183,160,4,0,4,100.0%,32m
37189,1,YourDad,2183,127,4,7,11,36.4%,12m
37189,2,ricardor,2183,32,2,4,6,33.3%,29m
37189,1,Yokoo,2183,44,2,5,7,28.6%,1h
37189,2,wowlich,2183,30,1,1,2,50.0%,36m
37189,2,riverekil,2183,0,1,1,2,50.0%,1h
37189,2,faraday,2183,0,1,5,6,16.7%,1h
37189,2,SuperPete,2183,0,1,5,6,16.7%,1h
37189,1,Hellqueen,2183,0,1,6,7,14.3%,32m
37189,2,eQuant,2183,0,0,1,1,0.0%,31m
37189,2,Suspencore,2183,0,0,2,2,0.0%,1h
37189,2,ZARTAK,2183,0,0,3,3,0.0%,53m
37189,2,IceWind,2183,0,0,5,5,0.0%,60m
37208,1,Yalico,2182,1334,142,144,286,49.7%,14m
37208,2,Karpfen,2182,864,95,98,193,49.2%,29m
37208,1,Legba,2182,1258,65,71,136,47.8%,59m
37208,1,Neofloppy,2182,1586,54,64,118,45.8%,1h
37208,1,VimanA,2182,900,44,51,95,46.3%,51m
37208,3,[USST]Dicarto,2182,637,21,36,57,36.8%,31m
37208,1,Azoth,2182,591,19,23,42,45.2%,13m
37208,1,[Mercy1]mein,2182,454,15,17,32,46.9%,41m
37208,1,XMonoDreamX,2182,344,10,12,22,45.5%,29m
37208,1,[BNCREW]Belomax,2182,169,5,7,12,41.7%,50m
37208,1,IIImortalll,2182,150,5,11,16,31.2%,27m
37208,1,Jak,2182,0,4,6,10,40.0%,48m
37208,2,Raggarn,2182,32,2,1,3,66.7%,1h
37208,2,Sirply,2182,0,2,3,5,40.0%,35m
37208,1,Skorpio,2182,0,1,3,4,25.0%,56m
37208,2,SherlockTaPz,2182,0,0,1,1,0.0%,55m
37208,2,Celestant,2182,0,0,2,2,0.0%,56m
37225,1,Igoryan,2181,1569,115,107,222,51.8%,49m
37225,1,Beltenebros,2181,1244,62,65,127,48.8%,1h
37225,2,Dew,2181,832,31,33,64,48.4%,55m
37225,3,Rakanishyu,2181,513,21,33,54,38.9%,33m
37225,2,SanchesAL,2181,538,20,20,40,50.0%,57m
37225,1,OSCAR,2181,488,14,23,37,37.8%,44m
37225,3,Sundmay,2181,179,6,13,19,31.6%,41m
37225,1,Инквизитор,2181,143,5,6,11,45.5%,11m
37225,1,timurka,2181,189,5,10,15,33.3%,1h
37225,2,Stevennus,2181,102,4,3,7,57.1%,1h
37225,2,Maximusalex,2181,115,2,1,3,66.7%,52m
37225,2,dragonssx,2181,139,2,1,3,66.7%,8m
37225,2,Knorke,2181,64,2,3,5,40.0%,51m
37225,1,Feyd,2181,121,2,4,6,33.3%,44m
37225,2,Stormclaw,2181,0,1,0,1,100.0%,1h
37225,2,llllllllllll,2181,0,1,0,1,100.0%,54m
37225,2,xopek,2181,0,1,2,3,33.3%,9m
37225,2,Kkmak,2181,0,1,4,5,20.0%,45m
37225,3,xXPakoTenaXx,2181,97,1,5,6,16.7%,54m
37225,2,Apopheos,2181,0,0,2,2,0.0%,11m
37225,1,[RPTeam]ToxicStray,2181,0,0,3,3,0.0%,58m
37246,1,Kernelpanic,2180,1652,210,209,419,50.1%,55m
37246,2,Quadro,2180,1548,96,97,193,49.7%,7m
37246,1,FlashGab,2180,1296,65,69,134,48.5%,13m
37246,1,GCoN,2180,536,34,29,63,54.0%,1h
37246,2,[Tuur]Fair,2180,912,32,35,67,47.8%,54m
37246,1,Toasty,2180,193,6,5,11,54.5%,1h
37246,1,Abxaz,2180,261,6,10,16,37.5%,1h
37246,1,Ohgodhelp,2180,132,5,9,14,35.7%,53m
37246,2,[U2ró]Macilacika,2180,60,3,1,4,75.0%,36m
37246,2,Avocadonis,2180,0,2,3,5,40.0%,45m
37246,1,Valher,2180,121,2,7,9,22.2%,47m
37246,2,VolkodlaK,2180,32,1,2,3,33.3%,5m
37246,1,nik,2180,0,1,7,8,12.5%,1h
37246,1,kamiel,2180,0,1,8,9,11.1%,42m
37246,2,Zeevonk,2180,0,0,1,1,0.0%,52m
37261,1,MajDark,2179,1461,108,118,226,47.8%,36m
37261,3,[PHGP]xxCrAzY,2179,541,18,31,49,36.7%,46m
37261,1,AlphaA,2179,558,17,24,41,41.5%,41m
37261,2,buhvim,2179,300,10,14,24,41.7%,54m
37261,2,GeneralTAOS,2179,248,8,10,18,44.4%,1h
37261,3,Wyndigo,2179,206,6,2,8,75.0%,7m
37261,2,Hucky,2179,186,6,5,11,54.5%,1h
37261,2,svanojr,2179,148,6,9,15,40.0%,1h
37261,2,AbrikosiK,2179,30,2,0,2,100.0%,59m
37261,1,YannKerrigan,2179,0,2,5,7,28.6%,52m
37261,2,shadow,2179,0,1,5,6,16.7%,6m
37261,3,mertvec,2179,0,0,1,1,0.0%,36m
37261,2,[Buldog]Tiphon,2179,0,0,1,1,0.0%,14m
37261,2,Dwanadziesię,2179,0,0,1,1,0.0%,1h
37275,1,MonsieurDoZ,2178,1595,76,75,151,50.3%,58m
37275,2,nonnono,2178,888,36,28,64,56.2%,1h
37275,1,nicchenicche,2178,611,18,22,40,45.0%,10m
37275,1,DrakonRe,2178,316,10,15,25,40.0%,58m
37275,3,[Hybrid]Babov,2178,242,10,15,25,40.0%,1h
37275,1,MasterChief,2178,286,9,14,23,39.1%,1h
37275,2,[WoLA]Tiberius,2178,212,8,1,9,88.9%,1h
37275,1,YagamiLaght,2178,264,8,10,18,44.4%,54m
37275,1,zicars,2178,154,4,13,17,23.5%,12m
37275,2,Hior,2178,0,3,7,10,30.0%,6m
37275,2,AHA,2178,142,2,2,4,50.0%,9m
37275,2,[ƬC]Xllon,2178,0,1,0,1,100.0%,53m
37275,2,Santiago,2178,0,1,4,5,20.0%,8m
37288,2,Gamerlolly,2177,1243,78,75,153,51.0%,1h
37288,2,[ESPION]Askorbik,2177,493,32,18,50,64.0%,36m
37288,2,Unknown,2177,678,25,31,56,44.6%,8m
37288,1,Monoware,2177,522,20,30,50,40.0%,3m
37288,2,ciprian,2177,126,4,6,10,40.0%,12m
37288,1,MoonPrincess,2177,0,3,4,7,42.9%,12m
37288,1,Theedencool,2177,48,3,9,12,25.0%,52m
37288,2,KOZA,2177,30,2,1,3,66.7%,54m
37288,2,Boewulf,2177,30,2,1,3,66.7%,13m
37288,2,Motumbo,2177,66,2,5,7,28.6%,1h
37288,2,Cookie,2177,88,1,5,6,16.7%,29m
37288,3,picatrix,2177,0,1,7,8,12.5%,1h
37288,1,SCrEaM,2177,0,1,9,10,10.0%,40m
37301,1,Hank,2176,1727,96,95,191,50.3%,4m
37301,3,[PowOw]TheDoctor,2176,1188,67,67,134,50.0%,34m
37301,3,ВОЛОСАТЫЙ,2176,850,34,45,79,43.0%,45m
37301,1,Chichi,2176,637,27,34,61,44.3%,52m
37301,2,Heavypush,2176,409,15,11,26,57.7%,5m
37301,1,Nebster,2176,317,10,12,22,45.5%,58m
37301,1,clvwfj,2176,184,5,13,18,27.8%,29m
37301,2,hellacrazy,2176,62,3,2,5,60.0%,56m
37301,2,Lightning,2176,122,2,2,4,50.0%,1h
37301,2,[NoAir]Simulakrum,2176,88,1,1,2,50.0%,1h
37301,2,Barmaley,2176,0,1,1,2,50.0%,45m
37301,1,незламний,2176,0,1,3,4,25.0%,40m
37301,2,Apologizer,2176,0,1,4,5,20.0%,40m
37301,1,Odi,2176,0,1,5,6,16.7%,3m
37301,1,Kypryakon,2176,0,1,6,7,14.3%,58m
37301,1,Invictus,2176,0,1,6,7,14.3%,50m
37301,2,[ZERGSC]Aragorn,2176,0,0,1,1,0.0%,4m
37301,2,[NICHE]KingFloyd,2176,0,0,1,1,0.0%,56m
37319,1,soDa,2175,1654,68,77,145,46.9%,29m
37319,2,shatoo,2175,798,29,28,57,50.9%,29m
37319,2,BarelySleep,2175,454,18,22,40,45.0%,1h
37319,2,[r161om]KosinusUA,2175,452,17,11,28,60.7%,48m
37319,2,Marsruben,2175,220,9,5,14,64.3%,45m
37319,2,Padre,2175,179,6,14,20,30.0%,55m
37319,1,Harmakhis,2175,126,4,11,15,26.7%,31m
37319,1,Руслан,2175,48,3,9,12,25.0%,1h
37319,1,Haeniken,2175,30,2,8,10,20.0%,38m
37319,1,Aeswa,2175,88,1,3,4,25.0%,1h
37319,2,Alchemist,2175,0,0,1,1,0.0%,36m
37319,2,Bob,2175,0,0,5,5,0.0%,12m
37331,1,Ashu,2174,864,29,34,63,46.0%,1h
37331,2,mxl,2174,366,12,12,24,50.0%,11m
37331,1,tim,2174,370,10,16,26,38.5%,40m
37331,1,Vladimir,2174,250,8,10,18,44.4%,3m
37331,3,Riuk,2174,136,4,8,12,33.3%,31m
37331,3,NeStEr,2174,60,2,16,18,11.1%,10m
37331,1,[DHHD]Kanashii,2174,48,1,2,3,33.3%,56m
37331,2,Fuellnoir,2174,0,1,5,6,16.7%,3m
37331,2,seal,2174,0,1,6,7,14.3%,32m
37331,1,Dawid,2174,0,0,1,1,0.0%,35m
37341,1,crz,2173,819,38,35,73,52.1%,54m
37341,3,Demon,2173,226,29,35,64,45.3%,44m
37341,1,darkdragon,2173,356,16,19,35,45.7%,1h
37341,2,Siempre,2173,334,12,7,19,63.2%,34m
37341,2,LEOKUBENswe,2173,256,9,4,13,69.2%,37m
37341,2,TonyStark,2173,192,8,7,15,53.3%,29m
37341,1,iamSOplastic,2173,150,6,8,14,42.9%,1h
37341,1,Chewye,2173,48,2,3,5,40.0%,1h
37341,2,Jek,2173,0,2,3,5,40.0%,1h
37341,2,PsychoSRL,2173,0,1,0,1,100.0%,12m
37341,2,[NsG20]Shrogh,2173,0,1,1,2,50.0%,51m
37341,2,GARY,2173,30,1,1,2,50.0%,1h
37341,2,Rogalik,2173,0,0,1,1,0.0%,11m
37341,2,ASMOOT,2173,0,0,2,2,0.0%,1h
37355,1,Alesh,2172,1398,49,55,104,47.1%,46m
37355,2,MRmax,2172,776,28,27,55,50.9%,37m
37355,1,Kratos,2172,355,23,23,46,50.0%,52m
37355,2,ninja,2172,453,17,11,28,60.7%,54m
37355,2,Perses,2172,187,7,5,12,58.3%,1h
37355,1,Razloj,2172,78,4,7,11,36.4%,29m
37355,1,[DaFF]Arbok,2172,193,4,11,15,26.7%,46m
37355,2,StaRFoX,2172,0,3,2,5,60.0%,59m
37355,2,warior,2172,0,1,2,3,33.3%,10m
37355,2,NastyFarts,2172,0,0,1,1,0.0%,11m
37355,2,maxxanox,2172,0,0,1,1,0.0%,1h
37355,2,Youlidante,2172,0,0,5,5,0.0%,10m
37355,1,fishbeard,2172,0,0,7,7,0.0%,55m
37368,2,ЛордЗазуля,2171,608,27,18,45,60.0%,1h
37368,1,kalyosik,2171,456,18,17,35,51.4%,1h
37368,2,osman,2171,438,14,17,31,45.2%,12m
37368,1,Janmaret,2171,284,8,12,20,40.0%,1h
37368,1,FalorRu,2171,295,8,15,23,34.8%,41m
37368,2,LoTis,2171,30,2,0,2,100.0%,13m
37368,2,kinqzon,2171,0,2,3,5,40.0%,57m
37368,2,DuoYun,2171,66,2,4,6,33.3%,1h
37368,2,[HipS]Guinness,2171,94,1,5,6,16.7%,32m
37368,3,trelled,2171,97,1,5,6,16.7%,1h
37368,2,[HaoS]Exsempld,2171,97,1,8,9,11.1%,46m
37368,2,Papagal,2171,0,0,1,1,0.0%,49m
37368,2,burjui,2171,0,0,2,2,0.0%,60m
37368,2,[PRTKP]mervin,2171,0,0,5,5,0.0%,4m
37382,3,Cosya,2170,953,60,69,129,46.5%,48m
37382,1,mero,2170,593,38,39,77,49.4%,3m
37382,1,EvilLeek,2170,632,24,34,58,41.4%,55m
37382,2,Korch,2170,353,13,13,26,50.0%,8m
37382,1,egzekutor,2170,287,9,11,20,45.0%,54m
37382,2,[H0ly]miniRo,2170,263,8,9,17,47.1%,44m
37382,1,Goman,2170,0,4,4,8,50.0%,38m
37382,2,Poulpatine,2170,142,4,10,14,28.6%,7m
37382,1,[Euter]Cubey,2170,96,3,5,8,37.5%,60m
37382,1,illich,2170,78,3,9,12,25.0%,36m
37382,3,Herpyderps,2170,30,3,10,13,23.1%,5m
37382,2,llllllllllll,2170,112,2,1,3,66.7%,4m
37382,2,Fibo,2170,58,2,3,5,40.0%,1h
37382,1,semamen,2170,48,2,7,9,22.2%,1h
37382,2,[MPT]TaigaBstLoli,2170,30,1,2,3,33.3%,31m
37382,1,Electra,2170,48,1,5,6,16.7%,40m
37382,1,Deado,2170,0,1,6,7,14.3%,42m
37382,3,Catspow,2170,0,1,7,8,12.5%,30m
37382,2,agentBARSIK,2170,0,0,5,5,0.0%,56m
37401,2,[Эщкер]deeen,2169,1109,68,68,136,50.0%,4m
37401,2,[KPZA]kirill,2169,669,22,24,46,47.8%,7m
37401,3,onDDASSS,2169,481,15,21,36,41.7%,52m
37401,2,Cyva,2169,176,7,7,14,50.0%,29m
37401,2,Siecinianin,2169,190,6,4,10,60.0%,56m
37401,2,[PLA2N]deathNote,2169,193,5,4,9,55.6%,56m
37401,1,SONTERA,2169,111,3,9,12,25.0%,52m
37401,2,Alex,2169,58,2,1,3,66.7%,1h
37401,1,hunter,2169,48,2,8,10,20.0%,11m
37401,2,[Щитон]Керриган,2169,0,1,0,1,100.0%,47m
37401,2,noks,2169,73,1,1,2,50.0%,5m
37401,2,Rotomor,2169,0,1,1,2,50.0%,8m
37401,2,master,2169,0,1,4,5,20.0%,9m
37401,2,Napoleon,2169,94,1,5,6,16.7%,46m
37415,2,Immazi,2168,1339,344,357,701,49.1%,15m
37415,2,Lancaster,2168,1394,79,82,161,49.1%,4m
37415,1,KamusheK,2168,914,55,43,98,56.1%,13m
37415,1,[PowOw]TargetBoy,2168,1092,52,59,111,46.8%,9m
37415,2,Relicanth,2168,1104,48,38,86,55.8%,1h
37415,2,Senghe,2168,717,27,29,56,48.2%,47m
37415,2,Devx,2168,443,17,12,29,58.6%,44m
37415,2,Habanerohero,2168,356,11,18,29,37.9%,10m
37415,3,Lucos,2168,261,9,14,23,39.1%,31m
37415,1,IUDA,2168,198,8,8,16,50.0%,11m
37415,2,KuniGaru,2168,99,2,2,4,50.0%,11m
37415,2,Neo,2168,0,1,4,5,20.0%,35m
37415,2,Death,2168,0,0,1,1,0.0%,29m
37415,2,SCORPION,2168,0,0,1,1,0.0%,56m
37429,2,[kill0]MrMarmalade,2167,640,24,23,47,51.1%,33m
37429,2,BaumGott,2167,369,17,12,29,58.6%,13m
37429,1,murf,2167,320,10,13,23,43.5%,10m
37429,2,[258]Alexzed,2167,212,8,7,15,53.3%,1h
37429,2,[ExTr1m]Scorpion,2167,204,8,12,20,40.0%,11m
37429,3,txuminGG,2167,244,8,13,21,38.1%,50m
37429,2,[wazzo]Arkanitt,2167,0,1,0,1,100.0%,1h
37429,1,NinemanVGX,2167,48,1,5,6,16.7%,45m
37429,2,BairdSLC,2167,0,0,1,1,0.0%,1h
37429,2,SBash,2167,0,0,1,1,0.0%,10m
37429,2,[УЗУ]yar,2167,0,0,4,4,0.0%,6m
37440,1,WwErgh,2166,1675,137,146,283,48.4%,34m
37440,3,dyango,2166,283,33,35,68,48.5%,42m
37440,1,[ZZIz]Ulenn,2166,438,23,22,45,51.1%,53m
37440,1,dav,2166,266,18,22,40,45.0%,1h
37440,1,[ICCCPI]Dgon,2166,479,14,19,33,42.4%,37m
37440,2,Juan,2166,341,12,23,35,34.3%,53m
37440,1,ZerBärUs,2166,156,5,6,11,45.5%,12m
37440,2,Dux,2166,164,5,6,11,45.5%,10m
37440,2,[TedB]IIIDEHAKAIII,2166,0,3,0,3,100.0%,1h
37440,2,Lesorub,2166,86,3,2,5,60.0%,1h
37440,2,NekoMeow,2166,92,3,3,6,50.0%,54m
37440,1,[GLHC]Lavr,2166,48,1,3,4,25.0%,7m
37440,2,Kutagen,2166,94,1,5,6,16.7%,38m
37440,2,Smirnayga,2166,0,0,5,5,0.0%,12m
37440,2,Zerg,2166,0,0,5,5,0.0%,1h
37440,2,MiniNija,2166,0,0,5,5,0.0%,50m
37456,2,Furai,2165,1127,47,45,92,51.1%,47m
37456,1,[QNTC7]BioMassya,2165,1300,45,51,96,46.9%,35m
37456,1,Trillan,2165,1011,43,38,81,53.1%,51m
37456,1,[LIQUID]Giamo,2165,519,37,33,70,52.9%,1h
37456,1,Hero,2165,582,17,26,43,39.5%,1h
37456,2,Draxies,2165,340,12,13,25,48.0%,39m
37456,1,MaLiFiKaR,2165,260,5,6,11,45.5%,1h
37456,1,min,2165,92,5,7,12,41.7%,32m
37456,1,mrdavsong,2165,36,2,6,8,25.0%,58m
37456,2,Louvrissa,2165,58,2,7,9,22.2%,38m
37456,1,Fullliare,2165,96,2,7,9,22.2%,42m
37456,3,Wind,2165,0,1,0,1,100.0%,38m
37456,2,meech,2165,0,0,2,2,0.0%,12m
37456,2,rtm,2165,0,0,4,4,0.0%,31m
37456,2,Rodi,2165,0,0,4,4,0.0%,10m
37471,1,[Cancro]Optimus,2164,1134,95,104,199,47.7%,35m
37471,2,oggo,2164,778,31,29,60,51.7%,5m
37471,2,[GGRiP]Shrill,2164,830,31,36,67,46.3%,1h
37471,2,Godboroos,2164,507,20,20,40,50.0%,4m
37471,2,SIdling,2164,500,19,17,36,52.8%,47m
37471,2,Sentenx,2164,386,14,16,30,46.7%,1h
37471,2,JGHTheLegend,2164,356,12,18,30,40.0%,1h
37471,2,ParadoX,2164,258,10,3,13,76.9%,29m
37471,2,yumeko,2164,162,6,4,10,60.0%,29m
37471,1,[530]Matee,2164,264,5,3,8,62.5%,55m
37471,1,KOCHICH,2164,36,4,4,8,50.0%,31m
37471,2,ghost,2164,34,2,1,3,66.7%,29m
37471,2,Roman,2164,0,2,3,5,40.0%,1h
37471,1,SimXgaminG,2164,48,2,8,10,20.0%,31m
37471,2,TommyEisbaer,2164,0,1,0,1,100.0%,1h
37471,2,ДикийЗерг,2164,0,1,0,1,100.0%,39m
37471,1,machoseks,2164,0,1,3,4,25.0%,58m
37471,2,[DarkTI]FreeMush,2164,0,0,1,1,0.0%,40m
37471,2,EnnumaEllish,2164,0,0,1,1,0.0%,12m
37471,2,ihorzver,2164,0,0,2,2,0.0%,9m
37471,2,chemist,2164,0,0,4,4,0.0%,1h
37471,2,Marshmellow,2164,73,0,5,5,0.0%,46m
37493,1,Oayder,2163,579,19,21,40,47.5%,45m
37493,2,Mantaspats,2163,150,8,7,15,53.3%,46m
37493,1,Skaplord,2163,198,6,12,18,33.3%,29m
37493,2,Draculius,2163,30,4,3,7,57.1%,1h
37493,1,HedgeHog,2163,108,3,5,8,37.5%,14m
37493,1,Vanek,2163,124,3,7,10,30.0%,29m
37493,2,[ValidG]Pinoester,2163,125,2,4,6,33.3%,13m
37493,1,Dschadir,2163,0,1,0,1,100.0%,1h
37493,1,terror,2163,0,1,6,7,14.3%,50m
37493,1,OneTrickT,2163,90,1,6,7,14.3%,34m
37493,2,JamesFord,2163,0,0,1,1,0.0%,53m
37493,2,Immortal,2163,0,0,1,1,0.0%,1h
37493,2,Tiefern,2163,0,0,5,5,0.0%,1h
37506,1,Kollioid,2162,1640,63,61,124,50.8%,1h
37506,2,ZidCampeador,2162,1418,51,59,110,46.4%,44m
37506,1,Dunlop,2162,718,24,27,51,47.1%,37m
37506,1,SubaroVOD,2162,472,20,22,42,47.6%,43m
37506,2,pleple,2162,453,19,9,28,67.9%,11m
37506,2,Boven,2162,205,10,9,19,52.6%,34m
37506,2,SSq,2162,265,9,7,16,56.2%,13m
37506,1,niklaslas,2162,206,9,18,27,33.3%,38m
37506,1,adrimax,2162,202,5,10,15,33.3%,29m
37506,2,zefire,2162,62,2,4,6,33.3%,1h
37506,2,LemonFreezer,2162,46,2,6,8,25.0%,49m
37506,1,ROY,2162,78,2,11,13,15.4%,38m
37506,2,lCarlitos,2162,0,1,0,1,100.0%,29m
37506,2,Yasin,2162,48,1,7,8,12.5%,46m
37506,2,KdizO,2162,0,0,5,5,0.0%,39m
37521,2,BARRAS,2161,887,42,48,90,46.7%,50m
37521,1,Broncco,2161,746,34,35,69,49.3%,50m
37521,1,Adielk,2161,622,20,28,48,41.7%,12m
37521,2,[Uсhiha]tveiv,2161,535,17,21,38,44.7%,11m
37521,2,zzz,2161,354,12,13,25,48.0%,1h
37521,2,Demyan,2161,120,5,8,13,38.5%,1h
37521,2,YasosUbibu,2161,0,3,2,5,60.0%,36m
37521,2,IDAssasin,2161,127,3,4,7,42.9%,29m
37521,1,Óvergu,2161,68,3,9,12,25.0%,9m
37521,2,PandaSamurai,2161,62,2,1,3,66.7%,10m
37521,2,Mattiqa,2161,0,2,4,6,33.3%,35m
37521,2,GHOST,2161,60,2,5,7,28.6%,29m
37521,1,[IFRI]Seysays,2161,0,1,5,6,16.7%,4m
37521,1,Sosk,2161,38,1,7,8,12.5%,60m
37521,2,[YoOli]FlemLion,2161,0,0,1,1,0.0%,51m
37521,2,ЧиЧиС,2161,0,0,1,1,0.0%,54m
37521,2,[TLOTT]FrankySee,2161,0,0,2,2,0.0%,8m
37538,1,Greg,2160,1366,327,354,681,48.0%,11m
37538,1,scriptacc,2160,1416,54,54,108,50.0%,9m
37538,2,MyNamesBarry,2160,418,18,19,37,48.6%,55m
37538,1,[SETAS]Javidralisco,2160,387,14,16,30,46.7%,51m
37538,3,NazmoX,2160,259,9,1,10,90.0%,4m
37538,2,[PTVru]BigD,2160,200,7,2,9,77.8%,54m
37538,3,var,2160,161,6,11,17,35.3%,53m
37538,2,Izzi,2160,168,5,9,14,35.7%,11m
37538,2,kemosabe,2160,0,2,3,5,40.0%,33m
37538,1,[NOSV]Nosferatul,2160,42,1,8,9,11.1%,40m
37538,2,Eyelars,2160,0,0,1,1,0.0%,1h
37538,2,madman,2160,0,0,3,3,0.0%,55m
37538,2,[LMBD]joss,2160,0,0,5,5,0.0%,35m
37551,2,scar,2159,884,42,40,82,51.2%,54m
37551,1,Tavtar,2159,755,41,46,87,47.1%,32m
37551,2,meng,2159,661,36,7,43,83.7%,55m
37551,1,Alexeichua,2159,362,14,14,28,50.0%,45m
37551,2,Aradon,2159,332,12,14,26,46.2%,1h
37551,1,khourshid,2159,223,5,6,11,45.5%,34m
37551,2,Alucard,2159,152,5,9,14,35.7%,46m
37551,2,Arachnus,2159,86,4,3,7,57.1%,1h
37551,2,Roger,2159,146,4,8,12,33.3%,1h
37551,2,[Чуваши]Юра,2159,112,3,0,3,100.0%,35m
37551,2,Gayство,2159,48,2,1,3,66.7%,53m
37551,2,[Chariz]FLOOBAROO,2159,0,2,4,6,33.3%,1h
37551,1,tag,2159,0,1,2,3,33.3%,35m
37551,2,capiclecrane,2159,46,1,3,4,25.0%,30m
37551,2,cidil,2159,0,0,1,1,0.0%,1h
37551,2,SleMz,2159,0,0,1,1,0.0%,1h
37567,2,Starlord,2158,1219,117,116,233,50.2%,11m
37567,1,bjorndjuret,2158,1336,47,50,97,48.5%,12m
37567,2,Krytos,2158,701,27,28,55,49.1%,10m
37567,2,Astral,2158,573,23,14,37,62.2%,50m
37567,1,Vegas,2158,222,17,21,38,44.7%,43m
37567,2,Remi,2158,178,9,6,15,60.0%,10m
37567,2,[UscHi]DerPoet,2158,195,6,4,10,60.0%,29m
37567,1,chaqueti,2158,282,6,12,18,33.3%,40m
37567,2,TYLERZ,2158,138,4,6,10,40.0%,8m
37567,2,[FKSD]Anakin,2158,126,4,7,11,36.4%,8m
37567,3,Mannie,2158,97,2,4,6,33.3%,50m
37567,2,Shogun,2158,0,1,0,1,100.0%,1h
37567,2,SinteZzz,2158,0,0,1,1,0.0%,29m
37567,2,bobik,2158,0,0,6,6,0.0%,1h
37581,2,GIZMO,2157,919,33,38,71,46.5%,55m
37581,2,Nicosaurus,2157,491,18,17,35,51.4%,12m
37581,2,Mettemor,2157,286,12,14,26,46.2%,29m
37581,1,Ggiuglio,2157,168,5,4,9,55.6%,6m
37581,2,Ктулху,2157,60,3,2,5,60.0%,36m
37581,2,RedOrDead,2157,60,3,6,9,33.3%,7m
37581,3,Shido,2157,30,3,8,11,27.3%,42m
37581,3,xHAx,2157,121,3,9,12,25.0%,33m
37581,2,IIIIIIIIIIII,2157,0,2,2,4,50.0%,55m
37581,1,ДжеймсБолт,2157,120,2,6,8,25.0%,31m
37581,1,ВоваЗадний,2157,97,1,3,4,25.0%,53m
37581,1,InSiteCom,2157,30,1,8,9,11.1%,3m
37593,2,rafaelthetru,2156,1504,96,87,183,52.5%,47m
37593,1,Greshnik,2156,476,21,20,41,51.2%,9m
37593,2,LOST,2156,206,9,6,15,60.0%,31m
37593,2,Gobbo,2156,197,9,6,15,60.0%,31m
37593,3,Mito,2156,291,9,11,20,45.0%,4m
37593,2,linvincible,2156,174,8,15,23,34.8%,51m
37593,2,[HRD]Hasherino,2156,153,4,10,14,28.6%,10m
37593,2,[7D]абуббандит,2156,0,3,2,5,60.0%,1h
37593,1,CaniorChert,2156,96,2,0,2,100.0%,1h
37593,1,Oxygen,2156,143,2,4,6,33.3%,42m
37593,1,arturinnnnnn,2156,38,2,8,10,20.0%,45m
37593,1,malkom,2156,0,1,0,1,100.0%,60m
37593,1,Michele,2156,0,1,0,1,100.0%,48m
37593,2,Gore,2156,0,1,4,5,20.0%,50m
37593,2,NOMADIC,2156,0,0,1,1,0.0%,14m
37608,1,dubpynchon,2155,1640,96,100,196,49.0%,54m
37608,1,DinoDesp,2155,1668,67,66,133,50.4%,60m
37608,1,Dreamdoctor,2155,658,34,46,80,42.5%,58m
37608,2,Kupixer,2155,738,28,28,56,50.0%,29m
37608,2,PsychoCraft,2155,750,27,29,56,48.2%,4m
37608,2,Erundil,2155,156,5,13,18,27.8%,4m
37608,1,RoonJ,2155,96,4,8,12,33.3%,52m
37608,2,Melanie,2155,94,2,8,10,20.0%,51m
37608,2,kseroys,2155,0,1,0,1,100.0%,46m
37608,2,DrStalker,2155,0,0,1,1,0.0%,3m
37618,1,xvilleOps,2154,1683,88,89,177,49.7%,1h
37618,1,JabbaElJack,2154,874,73,66,139,52.5%,53m
37618,1,Kylar,2154,1456,52,58,110,47.3%,48m
37618,2,Ыштынгыздр,2154,1232,48,52,100,48.0%,54m
37618,1,[HAPING]cycrow,2154,675,25,27,52,48.1%,1h
37618,1,ranezu,2154,687,20,26,46,43.5%,3m
37618,1,Taac,2154,574,19,23,42,45.2%,52m
37618,2,HelperDen,2154,444,18,11,29,62.1%,54m
37618,2,IIIIIIIIIII,2154,504,17,17,34,50.0%,60m
37618,1,Темимурл,2154,612,17,28,45,37.8%,58m
37618,3,ZhakFresko,2154,286,14,8,22,63.6%,54m
37618,2,haløweed,2154,400,14,22,36,38.9%,51m
37618,2,Necrofero,2154,174,6,7,13,46.2%,54m
37618,2,[MH69]DonSimonus,2154,148,5,9,14,35.7%,10m
37618,1,Sprucesoup,2154,144,5,11,16,31.2%,1h
37618,1,Käseee,2154,152,3,3,6,50.0%,54m
37618,2,JeanClaude,2154,0,2,3,5,40.0%,1h
37618,1,Жнец,2154,40,2,6,8,25.0%,48m
37618,2,FailSC,2154,0,0,5,5,0.0%,32m
37637,2,DemonWolf,2153,1604,101,84,185,54.6%,29m
37637,1,MrBozzo,2153,1690,97,103,200,48.5%,55m
37637,1,Havk,2153,1212,58,57,115,50.4%,47m
37637,1,Чезаре,2153,467,16,24,40,40.0%,7m
37637,1,TmTh,2153,356,10,17,27,37.0%,44m
37637,1,Snorlax,2153,290,9,16,25,36.0%,56m
37637,2,МассБатлы,2153,76,3,5,8,37.5%,29m
37637,2,ReadySteady,2153,86,3,7,10,30.0%,36m
37637,2,Galamore,2153,96,2,5,7,28.6%,29m
37637,2,[fpros]Gabbo,2153,0,1,1,2,50.0%,56m
37637,2,DanZZya,2153,30,1,3,4,25.0%,1h
37637,2,[Uesh]cobrax,2153,0,0,1,1,0.0%,8m
37637,1,[TC212]TerrorWolf,2153,0,0,3,3,0.0%,1h
37650,1,[INCELS]НагибПРОГРАМ,2152,768,42,42,84,50.0%,1h
37650,2,lol,2152,584,20,19,39,51.3%,52m
37650,1,Cactaceae,2152,519,17,22,39,43.6%,1h
37650,3,Kyube,2152,232,7,15,22,31.8%,41m
37650,2,[KROK]DRGazeton,2152,118,4,4,8,50.0%,46m
37650,2,drfab,2152,0,2,4,6,33.3%,57m
37650,2,irasstar,2152,30,2,5,7,28.6%,14m
37650,1,OrbitalPerio,2152,0,1,0,1,100.0%,33m
37650,2,Modlizard,2152,0,0,2,2,0.0%,9m
37650,2,Freelans,2152,0,0,2,2,0.0%,29m
37660,1,FabioX,2151,1265,144,145,289,49.8%,1h
37660,1,boss,2151,987,35,42,77,45.5%,58m
37660,3,MisterChriz,2151,720,24,39,63,38.1%,52m
37660,3,spi,2151,601,21,26,47,44.7%,40m
37660,2,Honza,2151,378,14,14,28,50.0%,10m
37660,2,[КРН]Ibrik,2151,379,10,12,22,45.5%,35m
37660,1,[AQFOBQ]Prime,2151,354,10,16,26,38.5%,1h
37660,1,Silver,2151,206,6,13,19,31.6%,12m
37660,2,[Buldog]Artemi,2151,147,4,4,8,50.0%,12m
37660,2,JAIME,2151,0,1,0,1,100.0%,1h
37660,2,Krelian,2151,0,0,1,1,0.0%,1h
37660,2,[diseas]Коронавирус,2151,0,0,1,1,0.0%,9m
37672,1,артём,2150,1032,96,103,199,48.2%,60m
37672,2,MacroLi,2150,1089,56,84,140,40.0%,3m
37672,1,DrKepler,2150,1022,43,46,89,48.3%,37m
37672,2,Vibo,2150,486,21,11,32,65.6%,10m
37672,2,Missandei,2150,388,18,4,22,81.8%,13m
37672,2,diamondlors,2150,357,10,18,28,35.7%,38m
37672,2,delegonplay,2150,236,9,11,20,45.0%,6m
37672,1,moloss,2150,232,7,12,19,36.8%,41m
37672,3,VippeRxX,2150,177,6,9,15,40.0%,36m
37672,2,Ladislaus,2150,176,6,12,18,33.3%,1h
37672,2,CHEMA,2150,120,5,5,10,50.0%,1h
37672,2,planadel,2150,30,2,0,2,100.0%,11m
37672,2,RebelDragon,2150,62,2,9,11,18.2%,29m
37672,2,EmadY,2150,30,1,4,5,20.0%,51m
37672,2,GrEEnGHOst,2150,0,0,1,1,0.0%,47m
37672,2,HUNNU,2150,0,0,2,2,0.0%,32m
37672,1,Астенкен,2150,0,0,3,3,0.0%,45m
37672,2,DarKnife,2150,0,0,3,3,0.0%,1h
37690,2,[Funky]Titoune,2149,401,16,10,26,61.5%,40m
37690,1,Davidsky,2149,483,15,25,40,37.5%,1h
37690,2,XStrange,2149,282,11,14,25,44.0%,55m
37690,2,MicroWienver,2149,274,8,9,17,47.1%,1h
37690,2,[xFRSx]Blastha,2149,86,4,1,5,80.0%,29m
37690,1,[FMU]VanRos,2149,122,4,9,13,30.8%,44m
37690,1,PapaCraft,2149,42,2,7,9,22.2%,51m
37690,1,garras,2149,0,1,0,1,100.0%,50m
37690,2,bicycleGLAZ,2149,0,1,0,1,100.0%,8m
37690,2,Bumbac,2149,0,1,0,1,100.0%,7m
37690,3,CazimirMugla,2149,0,0,5,5,0.0%,7m
37690,2,Pekaper,2149,0,0,6,6,0.0%,1h
37702,2,LokiLann,2148,965,41,32,73,56.2%,1h
37702,2,ghostdragon,2148,140,6,3,9,66.7%,51m
37702,2,NightFury,2148,123,3,3,6,50.0%,10m
37702,2,Tstart,2148,72,2,1,3,66.7%,30m
37702,2,[SofPr0]CornflakezZ,2148,0,1,4,5,20.0%,1h
37702,1,figarella,2148,0,1,6,7,14.3%,1h
37702,2,Doug,2148,0,0,1,1,0.0%,36m
37709,2,Halesy,2147,1494,77,72,149,51.7%,31m
37709,1,Monk,2147,373,16,27,43,37.2%,1h
37709,1,[1NFEC7]Soosa,2147,400,12,21,33,36.4%,55m
37709,1,Eliken,2147,342,11,23,34,32.4%,53m
37709,2,kolia,2147,198,6,12,18,33.3%,49m
37709,2,Demppis,2147,144,5,5,10,50.0%,13m
37709,1,MatGamer,2147,179,5,9,14,35.7%,42m
37709,2,[Щитон]ееееееееееее,2147,58,3,2,5,60.0%,31m
37709,2,EGYGamer,2147,114,3,3,6,50.0%,60m
37709,2,PSIH,2147,0,2,3,5,40.0%,50m
37709,2,[IndVar]alexToss,2147,88,1,1,2,50.0%,8m
37709,3,[Саваны]KrinDar,2147,0,1,4,5,20.0%,7m
37709,1,Krampoloyd,2147,0,1,7,8,12.5%,31m
37709,2,Scape,2147,0,0,2,2,0.0%,1h
37709,3,vorpelmeney,2147,0,0,2,2,0.0%,60m
37709,1,Shambler,2147,0,0,4,4,0.0%,34m
37709,3,Temur,2147,0,0,5,5,0.0%,8m
37726,2,MXfire,2146,534,19,17,36,52.8%,13m
37726,2,Pwner,2146,502,18,19,37,48.6%,29m
37726,2,zloypisyun,2146,420,15,15,30,50.0%,36m
37726,2,[VWaile]AgroAgroAgro,2146,116,7,7,14,50.0%,1h
37726,2,Nephish,2146,95,2,1,3,66.7%,33m
37726,1,vikaz,2146,96,2,2,4,50.0%,32m
37726,2,[Kicx]FirstDogot,2146,0,1,0,1,100.0%,45m
37726,2,[DUSH]POTNEX,2146,0,1,0,1,100.0%,1h
37726,2,[ANREN]Yaross,2146,46,1,8,9,11.1%,59m
37735,1,ReVolt,2145,1675,120,126,246,48.8%,53m
37735,1,Pyrokar,2145,1036,43,48,91,47.3%,45m
37735,2,THUMBA,2145,612,23,20,43,53.5%,53m
37735,2,Аста,2145,630,22,24,46,47.8%,1h
37735,1,Odium,2145,468,14,18,32,43.8%,1h
37735,2,Dempsei,2145,209,13,19,32,40.6%,5m
37735,2,Soulslayer,2145,289,9,17,26,34.6%,13m
37735,3,lanvo,2145,116,7,1,8,87.5%,5m
37735,2,[AMN]LorenzCraft,2145,194,5,4,9,55.6%,4m
37735,2,Titouan,2145,60,3,3,6,50.0%,33m
37735,3,SpaceSeal,2145,30,2,8,10,20.0%,1h
37735,2,[ECP19]AntonyLazer,2145,0,1,0,1,100.0%,12m
37735,2,DERESPECT,2145,0,1,0,1,100.0%,54m
37735,2,wildfreeze,2145,0,0,1,1,0.0%,55m
37735,3,[WYV]Goliath,2145,0,0,5,5,0.0%,11m
37750,2,Alepanor,2144,1508,121,126,247,49.0%,36m
37750,2,Phentanylum,2144,1272,48,49,97,49.5%,31m
37750,3,Zingiber,2144,738,44,54,98,44.9%,42m
37750,2,[kek34]Fireice,2144,716,24,29,53,45.3%,31m
37750,1,Саргерас,2144,406,13,20,33,39.4%,5m
37750,2,redi,2144,152,6,9,15,40.0%,51m
37750,2,meem,2144,30,4,4,8,50.0%,1h
37750,2,[GDZg]Falcon,2144,0,3,3,6,50.0%,6m
37750,2,Chipchilinka,2144,60,3,3,6,50.0%,1h
37750,2,PoNchiK,2144,86,2,8,10,20.0%,14m
37750,2,sootruebyul,2144,0,1,0,1,100.0%,1h
37750,2,stralend,2144,0,1,2,3,33.3%,7m
37750,3,dukenstein,2144,0,0,3,3,0.0%,52m
37763,2,Pain,2143,1271,47,54,101,46.5%,1h
37763,1,Kaoru,2143,451,20,17,37,54.1%,31m
37763,2,Groofi,2143,496,16,16,32,50.0%,1h
37763,2,[НОД17]DenSol,2143,212,7,7,14,50.0%,10m
37763,1,Глаукома,2143,166,6,9,15,40.0%,46m
37763,1,Vinstor,2143,140,5,12,17,29.4%,59m
37763,1,Topceon,2143,192,5,13,18,27.8%,56m
37763,2,SKILL,2143,138,4,2,6,66.7%,1h
37763,1,Fatbuddy,2143,70,4,7,11,36.4%,45m
37763,1,amt,2143,96,4,9,13,30.8%,1h
37763,2,[Perita]DonRuy,2143,76,3,1,4,75.0%,55m
37763,2,[SGтv]logmist,2143,32,2,2,4,50.0%,1h
37763,2,Chocobo,2143,60,2,8,10,20.0%,54m
37763,1,Maxsimit,2143,0,1,4,5,20.0%,37m
37763,2,zaton,2143,0,0,1,1,0.0%,45m
37763,2,DaniilReznov,2143,0,0,1,1,0.0%,1h
37763,2,Katok,2143,0,0,1,1,0.0%,9m
37763,1,HarDcore,2143,0,0,1,1,0.0%,47m
37763,2,OverWolf,2143,0,0,2,2,0.0%,1h
37763,2,malangsab,2143,0,0,2,2,0.0%,13m
37763,3,JONNY,2143,0,0,5,5,0.0%,36m
37784,2,[DEOCAN]LucaFalco,2142,628,25,21,46,54.3%,36m
37784,2,Kadehel,2142,648,23,25,48,47.9%,56m
37784,1,IakovBoy,2142,240,5,6,11,45.5%,1h
37784,2,Alex,2142,88,4,1,5,80.0%,40m
37784,2,[Moskva]Андрей,2142,121,2,3,5,40.0%,58m
37784,1,[балдеж]RSinPrime,2142,0,1,2,3,33.3%,1h
37784,3,[Nugket]otra,2142,0,1,4,5,20.0%,12m
37784,2,Stefano,2142,0,1,6,7,14.3%,1h
37784,2,VANSTAR,2142,0,0,1,1,0.0%,54m
37784,2,[olive]Artemiy,2142,0,0,1,1,0.0%,60m
37784,3,OldmanAdwai,2142,0,0,1,1,0.0%,1h
37784,2,MonoxyExtra,2142,0,0,1,1,0.0%,1h
37784,2,zeus,2142,0,0,5,5,0.0%,51m
37797,2,Misiu,2141,1497,143,147,290,49.3%,12m
37797,1,PurmanSA,2141,1304,117,127,244,48.0%,13m
37797,2,[Panger]Bambatant,2141,1211,82,88,170,48.2%,14m
37797,2,[PTVru]Fatality,2141,1334,54,56,110,49.1%,45m
37797,1,sharonpreshe,2141,1107,41,39,80,51.2%,52m
37797,2,KyRen,2141,802,37,35,72,51.4%,1h
37797,3,dugonghina,2141,985,37,47,84,44.0%,59m
37797,2,[OmDi]YellowFog,2141,249,10,7,17,58.8%,45m
37797,2,[PARADX]WarZii,2141,195,7,3,10,70.0%,40m
37797,2,Pozitiv,2141,217,5,14,19,26.3%,1h
37797,2,Neko,2141,124,4,8,12,33.3%,1h
37797,2,Ultima,2141,128,3,2,5,60.0%,40m
37797,1,[Hyper1]Rocket,2141,0,2,5,7,28.6%,52m
37797,1,[Сlеvеr]Olrin,2141,0,1,0,1,100.0%,1h
37797,2,Dozia,2141,38,1,5,6,16.7%,10m
37797,2,SupItsFive,2141,97,1,5,6,16.7%,4m
37797,1,IXDIDainonih,2141,0,0,2,2,0.0%,38m
37797,3,PepinoMarino,2141,0,0,5,5,0.0%,1h
37815,2,[FUT69]WillymF,2140,1586,57,71,128,44.5%,14m
37815,2,aaa,2140,955,37,33,70,52.9%,40m
37815,2,Feel,2140,270,9,13,22,40.9%,1h
37815,3,Erien,2140,250,9,15,24,37.5%,6m
37815,2,JebanyFiltr,2140,232,8,9,17,47.1%,29m
37815,2,nar,2140,226,7,5,12,58.3%,32m
37815,3,Nhektor,2140,58,5,9,14,35.7%,40m
37815,1,kpectohoceu,2140,263,5,11,16,31.2%,14m
37815,2,BRIGHT,2140,48,4,6,10,40.0%,1h
37815,2,Vladimir,2140,182,4,8,12,33.3%,1h
37815,1,Against,2140,122,3,12,15,20.0%,36m
37815,2,OldGuard,2140,30,2,1,3,66.7%,42m
37815,2,[SPAINs]Mmet,2140,88,2,4,6,33.3%,12m
37815,1,ZHIGALISK,2140,48,2,8,10,20.0%,3m
37815,1,[krest]Azthurano,2140,0,1,0,1,100.0%,53m
37815,1,danya,2140,0,1,0,1,100.0%,52m
37815,2,jonny,2140,48,1,1,2,50.0%,12m
37815,2,[Leid]Ymir,2140,0,1,2,3,33.3%,54m
37815,2,Hennig,2140,48,1,3,4,25.0%,8m
37815,1,[DOKA2]Charlie,2140,0,1,7,8,12.5%,1h
37815,2,Starlight,2140,0,0,1,1,0.0%,56m
37815,2,DeZGuN,2140,0,0,4,4,0.0%,14m
37815,2,MichaelII,2140,0,0,5,5,0.0%,1h
37838,2,Hiei,2139,830,80,78,158,50.6%,48m
37838,1,sonix,2139,668,23,29,52,44.2%,32m
37838,3,Stalin,2139,440,13,29,42,31.0%,54m
37838,1,NIKITOS,2139,217,6,9,15,40.0%,40m
37838,2,Vakula,2139,136,3,5,8,37.5%,32m
37838,2,[MayDie]Nekromant,2139,30,1,1,2,50.0%,34m
37838,2,[Y8U]Máximo,2139,0,0,1,1,0.0%,49m
37838,2,BANKBOND,2139,0,0,2,2,0.0%,56m
37846,2,Absolem,2138,151,10,7,17,58.8%,36m
37846,1,Blabla,2138,230,6,6,12,50.0%,48m
37846,1,Beerus,2138,259,6,10,16,37.5%,42m
37846,1,CHSVRLING,2138,126,5,10,15,33.3%,56m
37846,3,Easy,2138,60,4,11,15,26.7%,56m
37846,2,Dratini,2138,0,1,1,2,50.0%,13m
37846,2,ragnarok,2138,30,1,1,2,50.0%,30m
37846,2,Raggs,2138,30,1,6,7,14.3%,13m
37846,2,[SCFA]Izanami,2138,0,0,1,1,0.0%,54m
37846,2,Nano,2138,0,0,5,5,0.0%,1h
37856,1,Beginner,2137,1699,162,164,326,49.7%,6m
37856,2,ente,2137,543,19,17,36,52.8%,54m
37856,2,[Zhig]демон,2137,213,8,3,11,72.7%,6m
37856,1,SainTool,2137,252,7,10,17,41.2%,53m
37856,1,porka,2137,289,7,13,20,35.0%,1h
37856,2,Foil,2137,157,5,10,15,33.3%,1h
37856,2,Ninth,2137,90,3,4,7,42.9%,1h
37856,1,MacroPasha,2137,143,2,4,6,33.3%,54m
37856,2,Graztor,2137,95,2,5,7,28.6%,56m
37856,2,Lowrider,2137,46,2,7,9,22.2%,45m
37856,2,Potowy,2137,0,1,1,2,50.0%,30m
37856,2,Saitama,2137,44,1,6,7,14.3%,32m
37856,1,Acronix,2137,0,0,1,1,0.0%,40m
37856,2,Death,2137,0,0,1,1,0.0%,1h
37856,2,[SryPod]Стол,2137,0,0,2,2,0.0%,8m
37856,2,Alpha,2137,0,0,5,5,0.0%,1h
37872,1,LanJoMo,2136,1676,586,601,1187,49.4%,59m
37872,1,unkown,2136,896,29,40,69,42.0%,46m
37872,1,[Temeri]zorg,2136,556,17,28,45,37.8%,46m
37872,2,HatakiKakshi,2136,456,16,30,46,34.8%,13m
37872,1,Xname,2136,360,14,15,29,48.3%,46m
37872,2,Lizardstorm,2136,378,14,16,30,46.7%,1h
37872,1,Pogo,2136,300,10,17,27,37.0%,8m
37872,2,SteelRyan,2136,68,6,5,11,54.5%,1h
37872,1,ГрязныйДжони,2136,241,5,11,16,31.2%,52m
37872,2,Azytronas,2136,137,4,5,9,44.4%,33m
37872,1,Vyper,2136,126,3,3,6,50.0%,54m
37872,1,Azax,2136,48,2,0,2,100.0%,47m
37872,2,Артём,2136,0,2,3,5,40.0%,6m
37872,1,Mar,2136,96,2,7,9,22.2%,49m
37872,2,[ZUBS]Hawk,2136,0,1,1,2,50.0%,6m
37872,2,[HZeS]ТайноТролль,2136,0,1,4,5,20.0%,53m
37872,3,Bagdaddy,2136,0,1,8,9,11.1%,41m
37872,2,vlad,2136,0,0,1,1,0.0%,29m
37872,3,Victor,2136,0,0,2,2,0.0%,9m
37891,1,Ocean,2135,1561,90,97,187,48.1%,3m
37891,1,Yacouneone,2135,986,37,38,75,49.3%,53m
37891,1,blackjack,2135,364,21,22,43,48.8%,33m
37891,2,Bullet,2135,368,14,14,28,50.0%,1h
37891,2,Rustic,2135,440,14,18,32,43.8%,1h
37891,2,Sergun,2135,268,10,7,17,58.8%,12m
37891,3,HANNIBAL,2135,193,10,23,33,30.3%,42m
37891,2,KaranD,2135,265,9,14,23,39.1%,13m
37891,2,Highvoid,2135,184,7,5,12,58.3%,52m
37891,2,[Z666Zx]zorg,2135,0,2,3,5,40.0%,8m
37891,2,[BMDR]Kinder,2135,76,2,4,6,33.3%,1h
37891,1,christian,2135,0,0,1,1,0.0%,50m
37891,2,Cliffjumper,2135,0,0,1,1,0.0%,35m
37891,2,Vallherek,2135,0,0,1,1,0.0%,3m
37905,1,[1v12a]TimeOfWar,2134,1693,307,327,634,48.4%,60m
37905,2,Vanber,2134,1062,45,35,80,56.2%,60m
37905,2,anndend,2134,651,45,53,98,45.9%,1h
37905,2,Masterando,2134,438,17,14,31,54.8%,1h
37905,1,Aisuviz,2134,487,14,27,41,34.1%,12m
37905,2,[eRZGEb]CommanderFun,2134,302,11,9,20,55.0%,11m
37905,2,Winter,2134,325,11,18,29,37.9%,4m
37905,2,LEONIDAS,2134,220,7,11,18,38.9%,1h
37905,2,Terminator,2134,92,3,6,9,33.3%,1h
37905,2,kostya,2134,136,3,9,12,25.0%,55m
37905,2,Dixu,2134,0,1,0,1,100.0%,38m
37905,1,Riskvikk,2134,0,1,7,8,12.5%,47m
37905,2,Nowator,2134,0,0,1,1,0.0%,53m
37905,2,CountDrugula,2134,0,0,1,1,0.0%,51m
37905,3,tyrann,2134,0,0,2,2,0.0%,1h
37905,2,Timerox,2134,0,0,2,2,0.0%,46m
37905,3,BalD,2134,0,0,5,5,0.0%,60m
37905,2,Refa,2134,0,0,6,6,0.0%,49m
37923,1,Fox,2133,644,21,25,46,45.7%,1h
37923,2,Bane,2133,374,15,13,28,53.6%,1h
37923,1,holtby,2133,466,15,20,35,42.9%,3m
37923,1,Santi,2133,184,6,11,17,35.3%,44m
37923,1,fyare,2133,212,6,14,20,30.0%,54m
37923,2,[MSII]goewolf,2133,58,3,1,4,75.0%,60m
37923,1,[PRTING]TheOverlord,2133,96,3,11,14,21.4%,1h
37923,2,KillerBunny,2133,60,2,4,6,33.3%,1h
37923,1,DeStroY,2133,48,1,5,6,16.7%,42m
37923,2,Dividorial,2133,0,1,6,7,14.3%,33m
37923,2,JoNinja,2133,0,0,3,3,0.0%,32m
37934,1,NikDan,2132,446,13,19,32,40.6%,48m
37934,2,Lakisrit,2132,306,11,11,22,50.0%,40m
37934,2,whitebelt,2132,142,8,1,9,88.9%,38m
37934,2,Kjiflm,2132,90,2,4,6,33.3%,32m
37934,2,[XDN]Astor,2132,58,2,6,8,25.0%,6m
37934,2,Necrid,2132,0,1,3,4,25.0%,30m
37934,2,[Cybro]Liwintre,2132,0,0,2,2,0.0%,34m
37934,2,ZergRanger,2132,0,0,5,5,0.0%,46m
37942,1,BrentheGreat,2131,1516,84,75,159,52.8%,13m
37942,2,Adventure,2131,884,36,40,76,47.4%,1h
37942,2,gothic,2131,565,21,19,40,52.5%,11m
37942,2,TaRaKan,2131,230,9,8,17,52.9%,32m
37942,2,витя,2131,274,8,8,16,50.0%,11m
37942,1,RainZx,2131,211,7,7,14,50.0%,59m
37942,2,Titus,2131,150,5,10,15,33.3%,1h
37942,2,Idaho,2131,60,3,1,4,75.0%,29m
37942,2,Ardan,2131,94,2,1,3,66.7%,45m
37942,1,starmen,2131,46,2,7,9,22.2%,1h
37942,1,ElToro,2131,0,1,0,1,100.0%,47m
37942,1,Slash,2131,0,1,0,1,100.0%,40m
37942,1,Wojtex,2131,0,1,1,2,50.0%,40m
37942,2,[KDV]bambuspunk,2131,30,1,1,2,50.0%,1h
37942,2,teros,2131,0,1,1,2,50.0%,60m
37942,2,Predator,2131,30,1,4,5,20.0%,1h
37942,2,Skilles,2131,0,1,5,6,16.7%,12m
37942,1,Kewlguy,2131,0,0,2,2,0.0%,46m
37960,2,[RSPCT]scout,2130,584,26,20,46,56.5%,1h
37960,2,mortarion,2130,698,26,29,55,47.3%,55m
37960,2,Serega,2130,792,26,40,66,39.4%,60m
37960,2,Lucy,2130,350,15,17,32,46.9%,1h
37960,2,belphegor,2130,359,13,15,28,46.4%,55m
37960,2,Fly,2130,270,12,7,19,63.2%,56m
37960,2,Leandrito,2130,198,9,11,20,45.0%,45m
37960,2,NoObUshiwaka,2130,200,8,9,17,47.1%,32m
37960,2,VecToR,2130,164,6,2,8,75.0%,1h
37960,2,IskroMan,2130,239,6,7,13,46.2%,56m
37960,1,Lapie,2130,248,6,11,17,35.3%,31m
37960,2,HEX,2130,155,5,3,8,62.5%,52m
37960,1,Алекс,2130,169,4,6,10,40.0%,1h
37960,2,Ayonarendis,2130,130,4,7,11,36.4%,54m
37960,1,pizza,2130,189,4,10,14,28.6%,32m
37960,2,[PRIDEx]glebrus,2130,30,2,2,4,50.0%,36m
37960,1,Edmaker,2130,97,2,2,4,50.0%,1h
37960,2,Volatile,2130,0,1,0,1,100.0%,37m
37960,3,Beaubeste,2130,0,1,2,3,33.3%,1h
37960,2,MrCrowley,2130,0,1,5,6,16.7%,60m
37960,2,DuunkeN,2130,0,0,1,1,0.0%,1h
37960,2,Sevil,2130,0,0,2,2,0.0%,49m
37960,2,patriOt,2130,0,0,2,2,0.0%,56m
37983,2,ГектАр,2129,975,48,48,96,50.0%,14m
37983,1,Blinchik,2129,582,20,26,46,43.5%,57m
37983,2,LeoNOOB,2129,324,10,15,25,40.0%,9m
37983,3,DecSloth,2129,30,5,10,15,33.3%,7m
37983,2,[GOHELL]Anihilyator,2129,102,2,6,8,25.0%,46m
37983,1,NickWrecks,2129,0,1,7,8,12.5%,40m
37983,2,kfir,2129,0,0,1,1,0.0%,1h
37983,2,[k1raen]Squiq,2129,0,0,3,3,0.0%,33m
37991,2,MzM,2128,1277,60,55,115,52.2%,55m
37991,1,Kelte,2128,1338,47,52,99,47.5%,4m
37991,2,[snowBY]NULL,2128,329,16,5,21,76.2%,40m
37991,2,Choopix,2128,377,15,16,31,48.4%,13m
37991,2,leonidas,2128,397,12,16,28,42.9%,1h
37991,2,[Em0ti]Gurkensaftig,2128,188,10,16,26,38.5%,8m
37991,3,sosin,2128,227,7,15,22,31.8%,44m
37991,2,NaNaMi,2128,176,6,2,8,75.0%,1h
37991,2,yohhaaa,2128,115,5,2,7,71.4%,53m
37991,2,[мотор]Motor,2128,88,3,5,8,37.5%,38m
37991,3,LethalBanana,2128,96,2,8,10,20.0%,31m
37991,3,Alebi,2128,97,1,2,3,33.3%,1h
37991,2,hUanZnG,2128,93,1,6,7,14.3%,46m
37991,2,Zerg,2128,0,1,6,7,14.3%,1h
37991,2,[Dzikii]Apink,2128,0,0,1,1,0.0%,35m
37991,2,Denis,2128,0,0,2,2,0.0%,1h
38007,2,[HMB666]Nightmare,2127,615,40,34,74,54.1%,33m
38007,2,Sledopyt,2127,761,35,27,62,56.5%,45m
38007,2,NRT,2127,306,10,12,22,45.5%,1h
38007,1,Chloe,2127,209,9,8,17,52.9%,3m
38007,1,[078]SLuRFmUts,2127,337,8,19,27,29.6%,57m
38007,2,Marshall,2127,242,7,6,13,53.8%,1h
38007,2,loaquellogam,2127,114,6,8,14,42.9%,1h
38007,2,Grziwi,2127,0,3,2,5,60.0%,1h
38007,2,DereKyu,2127,60,3,4,7,42.9%,3m
38007,2,Skorpionchik,2127,30,3,6,9,33.3%,1h
38007,1,leonidas,2127,118,3,9,12,25.0%,45m
38007,2,Ali,2127,132,2,2,4,50.0%,1h
38007,2,Skyraptor,2127,0,1,1,2,50.0%,38m
38007,1,zxy,2127,0,1,7,8,12.5%,12m
38007,2,KaptOrtega,2127,0,0,1,1,0.0%,12m
38022,1,[ark722]Arkling,2126,1562,147,167,314,46.8%,29m
38022,2,JohnGiorno,2126,1046,45,36,81,55.6%,38m
38022,2,VLS,2126,1051,41,40,81,50.6%,60m
38022,2,FlyingKoala,2126,248,10,8,18,55.6%,38m
38022,2,Phyzer,2126,154,6,7,13,46.2%,6m
38022,2,[IIOII]Filionelius,2126,118,4,5,9,44.4%,10m
38022,1,Kezax,2126,168,4,8,12,33.3%,1h
38022,1,PatBalkany,2126,60,3,6,9,33.3%,10m
38022,2,[RnBw]GeForce,2126,30,2,2,4,50.0%,34m
38022,2,нуЯхз,2126,0,1,1,2,50.0%,13m
38022,2,Ayman,2126,80,1,6,7,14.3%,6m
38022,2,espeon,2126,0,0,1,1,0.0%,56m
38022,1,[TSC2C]JamesCradock,2126,0,0,2,2,0.0%,42m
38022,2,AGrumpyPig,2126,0,0,2,2,0.0%,46m
38022,2,FuZZiX,2126,0,0,2,2,0.0%,1h
38022,2,CrazyCat,2126,0,0,2,2,0.0%,52m
38022,2,неывесность,2126,0,0,5,5,0.0%,53m
38039,3,BarrelRider,2125,1428,91,100,191,47.6%,42m
38039,1,NaN,2125,911,41,43,84,48.8%,3m
38039,2,Gogrus,2125,660,23,25,48,47.9%,4m
38039,2,DamnArrow,2125,538,19,24,43,44.2%,1h
38039,2,Gilloux,2125,310,11,12,23,47.8%,9m
38039,2,PeaceAndLove,2125,136,4,2,6,66.7%,1h
38039,2,GaviS,2125,117,2,7,9,22.2%,9m
38039,2,Gonfaloner,2125,0,0,1,1,0.0%,3m
38039,2,generalJK,2125,0,0,1,1,0.0%,38m
38048,3,eSeS,2124,1510,64,85,149,43.0%,46m
38048,1,raduku,2124,1070,45,60,105,42.9%,34m
38048,3,VentoSilente,2124,1114,40,54,94,42.6%,37m
38048,2,barkin,2124,395,15,15,30,50.0%,1h
38048,2,raid,2124,338,12,18,30,40.0%,57m
38048,2,dibji,2124,217,9,8,17,52.9%,35m
38048,2,WallaS,2124,260,9,12,21,42.9%,38m
38048,2,Icosaedro,2124,264,8,17,25,32.0%,1h
38048,2,Raider,2124,222,7,8,15,46.7%,11m
38048,2,BBZ,2124,176,6,12,18,33.3%,1h
38048,2,Tala,2124,78,3,7,10,30.0%,1h
38048,2,Mickykill,2124,62,2,5,7,28.6%,60m
38048,2,Raptor,2124,30,2,5,7,28.6%,10m
38048,2,Rangelov,2124,0,1,1,2,50.0%,7m
38048,2,MrGreen,2124,0,0,1,1,0.0%,60m
38048,2,Klevil,2124,0,0,1,1,0.0%,45m
38048,2,Overlord,2124,0,0,4,4,0.0%,13m
38065,2,Inkvizor,2123,270,16,16,32,50.0%,45m
38065,2,FREETOPLAY,2123,438,14,26,40,35.0%,12m
38065,2,[PÂRłAH]Noxmenos,2123,265,7,8,15,46.7%,1h
38065,2,WeakZerg,2123,157,7,8,15,46.7%,51m
38065,1,Xerox,2123,145,3,8,11,27.3%,59m
38065,3,thanos,2123,0,1,4,5,20.0%,6m
38065,2,kot,2123,0,1,6,7,14.3%,50m
38065,1,Kirill,2123,0,1,7,8,12.5%,1h
38065,2,PtiZiZi,2123,0,0,1,1,0.0%,9m
38065,3,[Terraz]marcus,2123,0,0,1,1,0.0%,33m
38065,2,Pelmesh,2123,0,0,1,1,0.0%,30m
38065,3,scaveger,2123,0,0,2,2,0.0%,54m
38077,2,Xorgas,2122,1265,89,85,174,51.1%,1h
38077,1,Leodiruk,2122,457,17,19,36,47.2%,31m
38077,1,RuntyGoblin,2122,429,13,18,31,41.9%,59m
38077,3,RoiHeenok,2122,307,12,11,23,52.2%,4m
38077,1,MiG,2122,401,11,17,28,39.3%,52m
38077,2,PLLacek,2122,128,7,2,9,77.8%,40m
38077,2,Maxim,2122,173,5,11,16,31.2%,55m
38077,2,Damarantho,2122,62,4,4,8,50.0%,10m
38077,1,Clockwork,2122,96,3,6,9,33.3%,1h
38077,3,roisleonidas,2122,62,3,9,12,25.0%,1h
38077,2,UbaNawak,2122,60,3,9,12,25.0%,1h
38077,2,Сoolscar,2122,136,3,9,12,25.0%,33m
38077,1,Cosmic,2122,73,3,10,13,23.1%,30m
38077,2,[G4R3N]zero,2122,0,2,3,5,40.0%,40m
38077,1,SazukeTakeo,2122,0,1,0,1,100.0%,12m
38077,3,Monika,2122,0,0,4,4,0.0%,6m
38077,2,Manigolz,2122,0,0,5,5,0.0%,55m
38077,3,[USA42]BerwiSwander,2122,0,0,5,5,0.0%,1h
38095,2,Birdyves,2121,1004,37,37,74,50.0%,1h
38095,1,Shodan,2121,478,14,26,40,35.0%,1h
38095,2,Kraken,2121,94,3,7,10,30.0%,6m
38095,3,Yourick,2121,0,2,3,5,40.0%,43m
38095,2,[BHIT]Teemo,2121,97,2,5,7,28.6%,1h
38095,2,[CYOSK]flöwrilège,2121,74,2,7,9,22.2%,1h
38095,2,caxan,2121,0,0,1,1,0.0%,1h
38095,1,cxminnxxt,2121,0,0,2,2,0.0%,56m
38095,3,Lasconi,2121,0,0,5,5,0.0%,1h
38095,2,Kenshi,2121,0,0,6,6,0.0%,1h
38105,2,kris,2120,1096,40,43,83,48.2%,29m
38105,2,ADVOKAT,2120,543,25,20,45,55.6%,44m
38105,2,DedIvan,2120,516,18,22,40,45.0%,1h
38105,1,[TSC2C]Osoko,2120,379,11,19,30,36.7%,1h
38105,3,губошлеп,2120,217,7,15,22,31.8%,47m
38105,1,Syllin,2120,192,5,12,17,29.4%,1h
38105,1,Kaida,2120,34,4,5,9,44.4%,1h
38105,2,[Gondon]денискрюков,2120,0,2,4,6,33.3%,1h
38105,3,Wozrox,2120,0,0,5,5,0.0%,1h
38105,2,Gama,2120,0,0,5,5,0.0%,10m
38105,3,hairypothead,2120,0,0,5,5,0.0%,33m
38116,2,Parasite,2119,1148,109,107,216,50.5%,1h
38116,2,IHNM,2119,480,23,32,55,41.8%,42m
38116,2,Ant,2119,170,5,11,16,31.2%,1h
38116,1,Marcus,2119,196,4,12,16,25.0%,1h
38116,2,Lajter,2119,114,2,2,4,50.0%,1h
38116,2,Mind,2119,104,2,2,4,50.0%,35m
38116,2,Sora,2119,0,1,0,1,100.0%,1h
38116,1,[Shadit]BlackyKiller,2119,0,1,5,6,16.7%,38m
38116,2,SpaceDandy,2119,92,1,6,7,14.3%,3m
38116,2,Kain,2119,0,0,1,1,0.0%,48m
38116,1,RishardS,2119,0,0,3,3,0.0%,52m
38116,1,[Kиски]Qumannyy,2119,0,0,3,3,0.0%,45m
38128,2,Даве,2118,751,32,25,57,56.1%,30m
38128,2,MarTime,2118,764,28,28,56,50.0%,45m
38128,2,Tishoo,2118,222,11,15,26,42.3%,1h
38128,2,[NOOBpl]Wrex,2118,217,9,2,11,81.8%,49m
38128,2,JohnDalton,2118,253,9,11,20,45.0%,1h
38128,1,[ROPain]Sajrus,2118,255,8,17,25,32.0%,54m
38128,3,Tonice,2118,138,5,12,17,29.4%,36m
38128,2,monki,2118,255,5,12,17,29.4%,1h
38128,2,pingouino,2118,95,4,4,8,50.0%,4m
38128,2,дракон,2118,112,3,0,3,100.0%,34m
38128,2,mrPro,2118,124,3,8,11,27.3%,60m
38128,2,sztinka,2118,0,1,0,1,100.0%,11m
38128,2,marcin,2118,0,1,1,2,50.0%,56m
38128,2,Byarok,2118,0,1,5,6,16.7%,1h
38128,2,SHIK,2118,0,0,1,1,0.0%,1h
38143,2,Yanro,2117,433,22,15,37,59.5%,1h
38143,1,Doramir,2117,638,20,32,52,38.5%,51m
38143,2,Pukkancs,2117,209,7,6,13,53.8%,34m
38143,1,JackRo,2117,112,3,9,12,25.0%,38m
38143,2,ПЕНДАЛЬФ,2117,0,2,3,5,40.0%,57m
38143,1,zoix,2117,0,1,1,2,50.0%,50m
38143,2,[JaPP]Владимир,2117,0,1,2,3,33.3%,1h
38143,1,vonchu,2117,0,1,4,5,20.0%,3m
38143,2,NerisD,2117,0,0,1,1,0.0%,5m
38143,2,FairyFighter,2117,0,0,1,1,0.0%,45m
38143,1,MiniTitan,2117,0,0,1,1,0.0%,54m
38143,2,Kerrigan,2117,0,0,1,1,0.0%,12m
38155,3,Jay,2116,1586,611,641,1252,48.8%,42m
38155,3,Fungus,2116,1570,90,105,195,46.2%,29m
38155,2,[TB02]Moskit,2116,693,26,24,50,52.0%,4m
38155,2,ThePeoshow,2116,270,13,16,29,44.8%,56m
38155,2,WillBeSick,2116,218,9,4,13,69.2%,30m
38155,2,claylord,2116,192,9,6,15,60.0%,48m
38155,2,[SPAINs]MegaKartoxa,2116,287,7,9,16,43.8%,36m
38155,2,[USCB]kadj,2116,172,7,11,18,38.9%,8m
38155,2,GIDRALISK,2116,154,5,11,16,31.2%,57m
38155,2,[АDorit]Jango,2116,30,2,2,4,50.0%,1h
38155,2,ELMartinjo,2116,0,1,0,1,100.0%,11m
38155,2,Hwanni,2116,0,1,0,1,100.0%,13m
38155,2,[ADMEN]Xaero,2116,94,1,2,3,33.3%,38m
38155,2,[ТмТм]aleks,2116,30,1,2,3,33.3%,38m
38155,2,MrMuschel,2116,0,0,1,1,0.0%,12m
38155,3,СолоМон,2116,0,0,1,1,0.0%,1h
38171,1,Dragonrain,2115,373,13,21,34,38.2%,6m
38171,2,ROSTOHEKNUKI,2115,303,9,13,22,40.9%,52m
38171,1,Supreza,2115,202,8,13,21,38.1%,44m
38171,2,SuperAK,2115,164,6,8,14,42.9%,52m
38171,1,супернидзя,2115,170,5,4,9,55.6%,13m
38171,2,ImNotGood,2115,164,5,4,9,55.6%,37m
38171,2,[FREESY]Generalskill,2115,120,5,6,11,45.5%,30m
38171,1,Marko,2115,192,5,8,13,38.5%,32m
38171,2,Morty,2115,0,1,6,7,14.3%,38m
38171,2,WizKid,2115,0,0,2,2,0.0%,35m
38171,3,depakl,2115,0,0,5,5,0.0%,11m
38171,2,НямаНяма,2115,0,0,5,5,0.0%,29m
38171,2,LucidUnicorn,2115,0,0,6,6,0.0%,1h
38184,2,Kaguvi,2114,965,41,27,68,60.3%,9m
38184,2,Skalien,2114,195,8,7,15,53.3%,10m
38184,2,Yoshi,2114,172,7,7,14,50.0%,34m
38184,1,Ezios,2114,198,7,12,19,36.8%,46m
38184,1,Joker,2114,238,6,19,25,24.0%,35m
38184,1,LeShY,2114,179,4,9,13,30.8%,35m
38184,1,Totlii,2114,0,1,2,3,33.3%,42m
38184,2,[geym]Zeratul,2114,0,1,2,3,33.3%,56m
38184,2,areX,2114,88,1,5,6,16.7%,30m
38184,3,BronzeHero,2114,0,0,1,1,0.0%,60m
38184,3,Arro,2114,0,0,5,5,0.0%,11m
38195,1,duckduckgo,2113,434,14,19,33,42.4%,57m
38195,2,DMRG,2113,349,12,23,35,34.3%,11m
38195,2,Kylo,2113,229,8,5,13,61.5%,1h
38195,2,akvarista,2113,190,7,10,17,41.2%,36m
38195,2,YuraEj,2113,216,7,10,17,41.2%,44m
38195,3,Rhambo,2113,104,5,11,16,31.2%,33m
38195,2,cloy,2113,140,4,2,6,66.7%,6m
38195,2,NightWolf,2113,90,4,3,7,57.1%,54m
38195,1,Sirus,2113,48,4,6,10,40.0%,54m
38195,1,Rofo,2113,48,2,3,5,40.0%,51m
38195,2,PARAZIT,2113,0,1,0,1,100.0%,10m
38195,2,Seizewell,2113,0,1,2,3,33.3%,49m
38195,1,Vovarus,2113,0,1,6,7,14.3%,55m
38195,1,Xuetrap,2113,0,1,6,7,14.3%,57m
38195,2,BlackForce,2113,0,0,1,1,0.0%,34m
38195,2,[FIXIT]VADIMER,2113,0,0,5,5,0.0%,42m
38211,1,pirogi,2112,1508,130,139,269,48.3%,51m
38211,2,MirrorMan,2112,437,15,17,32,46.9%,1h
38211,2,[CyTron]LikeyourcutG,2112,250,9,6,15,60.0%,1h
38211,2,zahar,2112,0,4,1,5,80.0%,38m
38211,2,[4N00b]Watermelon,2112,0,1,0,1,100.0%,10m
38211,1,DITIS,2112,0,1,1,2,50.0%,56m
38211,2,ozdemirasaf,2112,97,1,5,6,16.7%,30m
38211,2,Klauronn,2112,96,1,6,7,14.3%,49m
38211,2,Ceko,2112,0,0,1,1,0.0%,11m
38211,1,rajko,2112,0,0,1,1,0.0%,8m
38211,2,Grom,2112,0,0,2,2,0.0%,45m
38211,3,TinyKitten,2112,0,0,5,5,0.0%,9m
38211,3,kudlik,2112,0,0,5,5,0.0%,9m
38211,2,JOXIS,2112,0,0,5,5,0.0%,13m
38225,2,Rubiogoe,2111,635,54,56,110,49.1%,14m
38225,2,[II3II]SñrFuixench,2111,642,23,28,51,45.1%,1h
38225,2,sssss,2111,478,20,13,33,60.6%,12m
38225,2,nerazim,2111,473,19,14,33,57.6%,1h
38225,2,CommanderLOK,2111,230,8,9,17,47.1%,55m
38225,2,[NOOBpl]Shige,2111,246,7,7,14,50.0%,31m
38225,2,Murlok,2111,103,7,8,15,46.7%,32m
38225,2,MrComrade,2111,193,5,6,11,45.5%,13m
38225,2,DarkTurtle,2111,145,2,5,7,28.6%,48m
38225,2,vuko,2111,0,1,2,3,33.3%,32m
38225,2,GUILHEM,2111,0,0,4,4,0.0%,29m
38225,2,[УТочка]ProFixSon,2111,0,0,6,6,0.0%,29m
38237,2,Kuskus,2110,787,32,28,60,53.3%,6m
38237,2,beOne,2110,229,6,10,16,37.5%,1h
38237,2,Tezzeret,2110,120,3,1,4,75.0%,36m
38237,2,Deus,2110,44,2,3,5,40.0%,51m
38237,2,Zoloman,2110,0,1,1,2,50.0%,30m
38237,2,OsvaldHerst,2110,0,1,5,6,16.7%,1h
38237,2,Yamabushi,2110,0,1,5,6,16.7%,55m
38237,2,arsénne,2110,0,0,1,1,0.0%,54m
38237,2,Plutoniy,2110,0,0,1,1,0.0%,36m
38237,3,Salmo,2110,0,0,2,2,0.0%,7m
38247,2,[SDKG]DimSoneX,2109,1108,68,59,127,53.5%,10m
38247,1,AppleJin,2109,989,34,48,82,41.5%,29m
38247,2,DarkStalker,2109,559,33,27,60,55.0%,1h
38247,2,shadow,2109,925,33,36,69,47.8%,40m
38247,2,GaEsEx,2109,716,25,38,63,39.7%,1h
38247,1,Vraiepoor,2109,627,21,34,55,38.2%,4m
38247,2,Chuila,2109,361,13,12,25,52.0%,13m
38247,2,[love2D]Light,2109,158,5,1,6,83.3%,36m
38247,2,GITSL,2109,136,5,2,7,71.4%,38m
38247,2,Soyputa,2109,60,3,2,5,60.0%,30m
38247,2,WingNut,2109,0,3,3,6,50.0%,9m
38247,2,Shresser,2109,88,3,3,6,50.0%,56m
38247,1,Derpfestor,2109,0,2,8,10,20.0%,1h
38247,2,BroodFather,2109,0,1,0,1,100.0%,7m
38247,2,Altfdix,2109,0,1,1,2,50.0%,36m
38247,1,[Catory]Bricker,2109,48,1,3,4,25.0%,34m
38247,2,king,2109,0,0,1,1,0.0%,5m
38247,2,Franzi,2109,0,0,4,4,0.0%,32m
38247,3,MrExziST,2109,0,0,5,5,0.0%,6m
38266,2,raggnar,2108,1576,70,63,133,52.6%,1h
38266,2,Gael,2108,674,25,31,56,44.6%,10m
38266,3,Вершитель,2108,736,25,39,64,39.1%,39m
38266,2,DrSmall,2108,263,13,11,24,54.2%,14m
38266,2,Suicide,2108,250,8,14,22,36.4%,48m
38266,2,Roadtripper,2108,202,6,14,20,30.0%,11m
38266,2,Luca,2108,120,4,5,9,44.4%,34m
38266,2,dosya,2108,88,2,0,2,100.0%,48m
38266,2,Francesco,2108,60,2,5,7,28.6%,60m
38266,2,LLIOKEP,2108,0,1,2,3,33.3%,6m
38266,2,[batPT]Daxter,2108,0,0,1,1,0.0%,14m
38266,2,Funny,2108,0,0,5,5,0.0%,1h
38278,1,lagwal,2107,1563,256,273,529,48.4%,13m
38278,1,mvp,2107,1555,79,76,155,51.0%,1h
38278,2,[nwby]XenoKing,2107,563,28,23,51,54.9%,38m
38278,2,Laochra,2107,526,19,25,44,43.2%,8m
38278,2,RidarTV,2107,457,18,22,40,45.0%,1h
38278,2,Valentinchik,2107,438,14,19,33,42.4%,36m
38278,2,[666999]IsoldMySoul,2107,270,9,13,22,40.9%,1h
38278,2,SlyxVs,2107,48,5,7,12,41.7%,10m
38278,1,Terminator,2107,143,4,7,11,36.4%,50m
38278,3,TheSolution,2107,0,0,3,3,0.0%,1h
38278,2,ТвояПсихушка,2107,0,0,4,4,0.0%,1h
38289,2,[SaCult]FlameoN,2106,1206,47,54,101,46.5%,52m
38289,2,[niCOno]kakachiSAN,2106,950,34,43,77,44.2%,6m
38289,2,Erratas,2106,319,31,39,70,44.3%,1h
38289,2,[RAT01]RatRobain,2106,470,16,16,32,50.0%,38m
38289,2,Solmyr,2106,260,8,11,19,42.1%,40m
38289,2,murzik,2106,86,3,5,8,37.5%,54m
38289,2,tequilas,2106,97,2,0,2,100.0%,9m
38289,2,potato,2106,0,1,4,5,20.0%,1h
38289,2,pajonker,2106,0,0,1,1,0.0%,54m
38289,1,AlexSpite,2106,0,0,1,1,0.0%,54m
38289,2,CapLapca,2106,0,0,2,2,0.0%,40m
38289,2,Simone,2106,0,0,4,4,0.0%,8m
38289,2,Zardoz,2106,0,0,4,4,0.0%,55m
38302,2,[x193x]SeilRundung,2105,318,10,10,20,50.0%,1h
38302,2,[widma]Kerrigan,2105,150,6,10,16,37.5%,58m
38302,2,Bajekon,2105,124,3,1,4,75.0%,1h
38302,2,MER,2105,0,3,3,6,50.0%,13m
38302,2,Krovav,2105,34,2,2,4,50.0%,1h
38302,1,[N3N]Sedna,2105,88,2,10,12,16.7%,1h
38302,3,[RRQ]HaitiFox,2105,0,1,0,1,100.0%,1h
38302,2,Chezs,2105,95,1,1,2,50.0%,5m
38302,1,[SEBULA]mixedmix,2105,97,1,4,5,20.0%,52m
38302,2,[APAB]Buturinnn,2105,0,1,5,6,16.7%,30m
38302,1,KaterZentaur,2105,97,1,5,6,16.7%,34m
38302,2,adminko,2105,0,0,1,1,0.0%,60m
38302,2,Marcusilo,2105,0,0,1,1,0.0%,36m
38315,1,Alquimia,2104,1637,228,268,496,46.0%,13m
38315,2,zet,2104,404,24,20,44,54.5%,1h
38315,2,Apelsinchik,2104,450,15,16,31,48.4%,31m
38315,2,CullenTrey,2104,374,13,18,31,41.9%,1h
38315,2,Jeremytippet,2104,142,5,1,6,83.3%,3m
38315,2,Weltenfisch,2104,196,5,9,14,35.7%,1h
38315,2,Zephyrstoner,2104,134,4,8,12,33.3%,56m
38315,2,IONIC,2104,116,3,2,5,60.0%,1h
38315,2,[KoWo]Henning,2104,126,3,5,8,37.5%,56m
38315,1,ImoShane,2104,145,3,9,12,25.0%,51m
38315,2,unamedjfw,2104,0,1,0,1,100.0%,1h
38315,2,РанокКактуса,2104,0,1,1,2,50.0%,6m
38315,2,Bappé,2104,0,0,1,1,0.0%,4m
38315,3,SixPaiN,2104,0,0,5,5,0.0%,33m
38329,1,Ravi,2103,1010,37,45,82,45.1%,38m
38329,2,[MGXN]Morgoth,2103,792,30,35,65,46.2%,5m
38329,2,[clavak]Alexua,2103,276,9,5,14,64.3%,1h
38329,2,Disaster,2103,180,6,4,10,60.0%,48m
38329,1,SweaTizZ,2103,96,3,1,4,75.0%,45m
38329,2,elias,2103,30,2,1,3,66.7%,34m
38329,2,Irozage,2103,140,2,8,10,20.0%,56m
38329,2,KOKOKUN,2103,30,1,3,4,25.0%,35m
38329,2,miarmi,2103,30,1,7,8,12.5%,29m
38338,2,Lodrop,2102,547,21,12,33,63.6%,1h
38338,2,Flo,2102,204,8,9,17,47.1%,1h
38338,1,tom,2102,169,6,5,11,54.5%,51m
38338,2,matr,2102,166,6,7,13,46.2%,55m
38338,1,Elzndyl,2102,287,6,13,19,31.6%,11m
38338,2,Jim,2102,116,5,5,10,50.0%,1h
38338,2,Zergitop,2102,30,4,3,7,57.1%,40m
38338,1,[SFCM]Banban,2102,97,2,8,10,20.0%,41m
38338,2,WOLVARINE,2102,60,2,8,10,20.0%,36m
38338,2,Hamster,2102,0,1,2,3,33.3%,56m
38338,3,Bone,2102,30,1,12,13,7.7%,30m
38338,2,[ЕМPIRE]Барбатос,2102,0,0,1,1,0.0%,29m
38338,2,Smartphone,2102,0,0,3,3,0.0%,1h
38338,2,Stefon,2102,0,0,5,5,0.0%,13m
38352,2,FoXiK,2101,475,18,25,43,41.9%,1h
38352,2,Kulning,2101,318,13,7,20,65.0%,14m
38352,1,SALXIG,2101,337,9,14,23,39.1%,40m
38352,1,Megam,2101,190,6,10,16,37.5%,7m
38352,2,Lamora,2101,177,6,14,20,30.0%,38m
38352,2,[GAMAD]Nerul,2101,58,4,5,9,44.4%,11m
38352,1,ZOM,2101,116,4,11,15,26.7%,31m
38352,1,oRkA,2101,76,3,10,13,23.1%,41m
38352,2,Deschi,2101,120,2,8,10,20.0%,37m
38352,2,Karusmari,2101,0,1,2,3,33.3%,51m
38352,2,[RMF]Ферыч,2101,0,1,4,5,20.0%,4m
38352,2,Blackhawk,2101,0,0,5,5,0.0%,12m
38352,1,AlaRack,2101,0,0,5,5,0.0%,40m
38365,2,SiSKOTRON,2100,1602,110,105,215,51.2%,1h
38365,2,[CS0]harken,2100,727,46,45,91,50.5%,56m
38365,2,Mirco,2100,274,9,10,19,47.4%,60m
38365,2,Blonder,2100,320,9,16,25,36.0%,48m
38365,1,Njeuhmens,2100,316,8,14,22,36.4%,1h
38365,2,Pepper,2100,164,4,4,8,50.0%,38m
38365,2,Leeroy,2100,88,2,0,2,100.0%,60m
38365,2,insight,2100,30,2,9,11,18.2%,28m
38365,2,SmoSX,2100,95,1,6,7,14.3%,1h
38365,2,[RuVoid]Arrow,2100,0,0,2,2,0.0%,52m
38365,3,JudahPaul,2100,0,0,2,2,0.0%,52m
38365,2,Rundvogel,2100,0,0,3,3,0.0%,50m
38365,1,Radu,2100,0,0,4,4,0.0%,35m
38378,2,BERURIER,2099,1070,43,46,89,48.3%,34m
38378,1,Arkhan,2099,956,33,41,74,44.6%,54m
38378,2,Khan,2099,549,22,20,42,52.4%,1h
38378,2,[TPZGG]Metalhead,2099,355,11,13,24,45.8%,56m
38378,2,[PTWTM]Raven,2099,159,4,4,8,50.0%,5m
38378,3,Adix,2099,121,3,0,3,100.0%,28m
38378,1,Shake,2099,0,2,8,10,20.0%,42m
38378,2,Tib,2099,30,1,2,3,33.3%,11m
38378,2,YRK,2099,42,1,3,4,25.0%,31m
38378,1,Starmaschin,2099,0,1,7,8,12.5%,12m
38378,2,LRD,2099,0,0,2,2,0.0%,1h
38389,2,mrtumble,2098,382,14,11,25,56.0%,40m
38389,2,FTFTXH,2098,241,10,16,26,38.5%,6m
38389,1,Rivette,2098,188,5,11,16,31.2%,42m
38389,2,danul,2098,114,2,2,4,50.0%,1h
38389,2,[GamerX]Whanos,2098,0,0,3,3,0.0%,1h
38389,2,Moritz,2098,0,0,6,6,0.0%,41m
38389,2,RacerX,2098,0,0,7,7,0.0%,59m
38396,2,epla,2097,1505,68,68,136,50.0%,36m
38396,2,Pontius,2097,1184,47,46,93,50.5%,54m
38396,2,Starship,2097,152,9,7,16,56.2%,1h
38396,1,CrolenStone,2097,199,8,8,16,50.0%,47m
38396,1,JoJo,2097,285,8,11,19,42.1%,1h
38396,2,ShnecK,2097,188,6,3,9,66.7%,12m
38396,2,Shuma,2097,144,5,7,12,41.7%,40m
38396,3,KaPraL,2097,30,3,11,14,21.4%,1h
38396,2,[Duvel]MiaoMiao,2097,112,2,2,4,50.0%,1h
38396,2,Tverskoy,2097,0,1,1,2,50.0%,30m
38396,1,SULCA,2097,46,1,5,6,16.7%,41m
38396,2,Martin,2097,0,1,5,6,16.7%,1h
38408,1,Flim,2096,845,33,36,69,47.8%,41m
38408,2,Falki,2096,368,16,10,26,61.5%,60m
38408,2,Lorn,2096,344,11,13,24,45.8%,1h
38408,2,PrOf,2096,232,7,7,14,50.0%,9m
38408,2,AlexNSK,2096,137,6,3,9,66.7%,7m
38408,2,kamox,2096,144,5,6,11,45.5%,34m
38408,2,SekaiSenpai,2096,121,4,5,9,44.4%,54m
38408,3,IIIIIIIIIIII,2096,0,2,3,5,40.0%,43m
38408,2,KryoMichli,2096,118,2,7,9,22.2%,39m
38408,1,Metanabol,2096,121,2,8,10,20.0%,13m
38408,2,[JOPAKK]JJiViLL,2096,0,0,1,1,0.0%,52m
38408,2,milky,2096,0,0,1,1,0.0%,51m
38408,2,AlfaYT,2096,0,0,1,1,0.0%,56m
38408,2,Wonderspud,2096,0,0,1,1,0.0%,52m
38408,2,[UF2AC]Anonimus,2096,0,0,2,2,0.0%,51m
38408,2,paulo,2096,0,0,3,3,0.0%,12m
38408,3,guiosteo,2096,0,0,5,5,0.0%,1h
38425,1,Kwad,2095,1585,145,152,297,48.8%,14m
38425,3,[OmDi]SAL,2095,1505,86,105,191,45.0%,1h
38425,2,mewowaw,2095,925,40,35,75,53.3%,12m
38425,3,Bartleb,2095,428,17,27,44,38.6%,60m
38425,2,[PITYX]Lisi,2095,402,14,16,30,46.7%,1h
38425,2,Andrei,2095,230,7,6,13,53.8%,1h
38425,2,Butcher,2095,199,6,11,17,35.3%,35m
38425,2,[НЕТУДА]Doshik,2095,127,4,4,8,50.0%,46m
38425,2,TarryFungus,2095,60,3,4,7,42.9%,6m
38425,2,Wolf,2095,0,1,3,4,25.0%,10m
38425,2,Fra,2095,0,0,1,1,0.0%,8m
38425,1,Paphoved,2095,0,0,3,3,0.0%,57m
38425,2,IIIIIIIIIIII,2095,0,0,5,5,0.0%,39m
38438,2,[mfxed]grimsey,2094,1515,165,183,348,47.4%,12m
38438,2,[Limee]kringe,2094,1576,69,69,138,50.0%,29m
38438,2,[d0gg]vinniemfb,2094,568,24,23,47,51.1%,54m
38438,2,Blaze,2094,133,19,16,35,54.3%,37m
38438,2,lOOlik,2094,496,17,20,37,45.9%,58m
38438,2,herald,2094,306,11,16,27,40.7%,48m
38438,1,Tombarian,2094,96,3,9,12,25.0%,59m
38438,1,Vuxes,2094,78,3,11,14,21.4%,52m
38438,2,comediant,2094,88,2,1,3,66.7%,1h
38438,2,Nikitos,2094,114,2,2,4,50.0%,1h
38438,1,lobo,2094,48,2,9,11,18.2%,41m
38438,2,[ILR]SHP,2094,30,1,4,5,20.0%,13m
38438,2,naibuleuse,2094,0,1,5,6,16.7%,1h
38438,1,Silver,2094,0,1,8,9,11.1%,7m
38452,2,[WPki]Sokol,2093,875,32,39,71,45.1%,1h
38452,2,[Lolers]Kaizerai,2093,271,11,9,20,55.0%,1h
38452,1,Ishak,2093,294,11,11,22,50.0%,1h
38452,2,Numbulan,2093,102,3,1,4,75.0%,60m
38452,2,vigorsol,2093,62,3,5,8,37.5%,37m
38452,1,SpaceMarine,2093,92,2,6,8,25.0%,1h
38452,3,Dan,2093,30,1,1,2,50.0%,5m
38452,2,RuFF,2093,93,1,1,2,50.0%,45m
38452,2,[SS2208]Svetik,2093,0,1,4,5,20.0%,1h
38452,2,Hetman,2093,0,1,6,7,14.3%,56m
38452,2,[252bat]JesTac,2093,0,0,1,1,0.0%,33m
38463,3,Panbuk,2092,1400,126,123,249,50.6%,41m
38463,2,[HEGEL]Albus,2092,946,36,39,75,48.0%,1h
38463,2,MoonPrincess,2092,364,12,12,24,50.0%,51m
38463,2,KWASI,2092,241,8,6,14,57.1%,34m
38463,1,[HUNCom]Almi,2092,193,6,12,18,33.3%,40m
38463,2,[TheDOH]miko,2092,58,3,8,11,27.3%,1h
38463,2,CmrdMarvin,2092,148,3,10,13,23.1%,1h
38463,3,guguen,2092,30,2,1,3,66.7%,54m
38463,2,ssss,2092,109,2,2,4,50.0%,52m
38463,3,[ADLN]AlexDelete,2092,0,1,0,1,100.0%,38m
38463,3,[FF5EU]Kai,2092,0,0,5,5,0.0%,1h
38463,3,Eclipse,2092,0,0,5,5,0.0%,1h
38475,2,Evidar,2091,288,9,8,17,52.9%,30m
38475,2,[vDog]overrun,2091,118,5,7,12,41.7%,1h
38475,2,Juggernaut,2091,92,5,7,12,41.7%,1h
38475,2,Helldra,2091,156,5,12,17,29.4%,4m
38475,2,lofstraker,2091,116,3,2,5,60.0%,1h
38475,2,Dreyz,2091,123,3,9,12,25.0%,4m
38475,2,Djoory,2091,0,2,4,6,33.3%,56m
38475,2,СмертоМышь,2091,116,2,4,6,33.3%,1h
38475,2,Ullital,2091,60,2,5,7,28.6%,7m
38475,3,[SHTORM]Shaman,2091,0,1,0,1,100.0%,46m
38475,2,CSherk,2091,0,1,1,2,50.0%,59m
38475,2,[TEEEMO]Volltreffer,2091,0,1,6,7,14.3%,30m
38475,2,aurapanthere,2091,0,0,1,1,0.0%,38m
38475,2,Gaspar,2091,0,0,2,2,0.0%,8m
38489,2,regtemarmot,2090,1234,112,114,226,49.6%,8m
38489,2,kwas,2090,769,59,60,119,49.6%,30m
38489,2,DaronFox,2090,306,10,16,26,38.5%,1h
38489,3,TheSupreming,2090,192,7,8,15,46.7%,1h
38489,1,naglfar,2090,174,6,18,24,25.0%,36m
38489,1,zzzERGYsss,2090,48,2,4,6,33.3%,1h
38489,2,ermian,2090,96,2,7,9,22.2%,56m
38489,2,[6IKEA9]YaponeC,2090,88,2,9,11,18.2%,12m
38489,2,Rallient,2090,46,1,3,4,25.0%,3m
38489,3,Carlson,2090,0,1,4,5,20.0%,46m
38489,2,Irie,2090,94,1,6,7,14.3%,59m
38489,3,charlie,2090,0,0,4,4,0.0%,45m
38501,2,Fuсker,2089,1265,66,65,131,50.4%,1h
38501,1,[USKL]Medichi,2089,1112,64,77,141,45.4%,10m
38501,2,Gaja,2089,1588,54,78,132,40.9%,10m
38501,2,[InƑeS]Majooo,2089,489,18,37,55,32.7%,1h
38501,1,Misha,2089,216,9,12,21,42.9%,46m
38501,3,IDKAnymore,2089,147,3,8,11,27.3%,46m
38501,2,Zero,2089,24,2,3,5,40.0%,60m
38501,2,tzaren,2089,0,2,5,7,28.6%,1h
38501,2,Bubblik,2089,0,2,9,11,18.2%,36m
38501,3,sramoslyab,2089,0,1,0,1,100.0%,1h
38501,3,WarlorD,2089,0,0,1,1,0.0%,38m
38501,2,Cronous,2089,0,0,6,6,0.0%,1h
38513,2,Bonny,2088,1601,150,156,306,49.0%,35m
38513,2,[OmDi]Romul,2088,1018,48,50,98,49.0%,40m
38513,3,Emperator,2088,514,22,7,29,75.9%,1h
38513,2,sas,2088,492,20,15,35,57.1%,31m
38513,2,aeiu,2088,590,19,25,44,43.2%,5m
38513,1,AMETIST,2088,436,18,19,37,48.6%,51m
38513,2,Gerc,2088,296,11,6,17,64.7%,8m
38513,2,IGOR,2088,244,8,13,21,38.1%,35m
38513,2,MonkeyDLuffy,2088,186,6,4,10,60.0%,1h
38513,3,ThemisWizard,2088,172,4,9,13,30.8%,40m
38513,3,егор,2088,121,3,3,6,50.0%,1h
38513,2,Gsuperhero,2088,62,3,3,6,50.0%,56m
38513,2,DracovAD,2088,92,2,8,10,20.0%,3m
38513,2,[KaLaRu]СанТехник,2088,0,1,1,2,50.0%,29m
38513,2,Kobrettie,2088,92,1,1,2,50.0%,1h
38513,2,ZULUMASTER,2088,0,1,2,3,33.3%,29m
38513,2,Jack,2088,0,1,5,6,16.7%,1h
38513,3,[6JD]Dementorian,2088,0,0,5,5,0.0%,1h
38513,2,Retel,2088,0,0,6,6,0.0%,56m
38532,1,[SXY]murderer,2087,1667,171,179,350,48.9%,41m
38532,2,SNorthWood,2087,991,66,70,136,48.5%,1h
38532,1,[SeVenV]Tormozko,2087,665,22,30,52,42.3%,1h
38532,1,PengBoom,2087,189,4,10,14,28.6%,31m
38532,1,MadMax,2087,0,3,6,9,33.3%,36m
38532,2,mutya,2087,30,2,6,8,25.0%,29m
38532,2,NikoGeG,2087,0,1,1,2,50.0%,51m
38532,3,Skywood,2087,0,0,4,4,0.0%,37m
38532,3,Doumalagqua,2087,0,0,5,5,0.0%,52m
38532,3,Сильверблу,2087,0,0,5,5,0.0%,58m
38542,2,Dimok,2086,596,26,22,48,54.2%,34m
38542,3,kishin,2086,593,21,16,37,56.8%,28m
38542,2,chitaury,2086,323,17,9,26,65.4%,1h
38542,2,ThotSlayer,2086,172,6,5,11,54.5%,59m
38542,2,Vladimir,2086,166,5,5,10,50.0%,5m
38542,3,WERGAS,2086,30,5,7,12,41.7%,1h
38542,1,ПростоМакс,2086,191,3,10,13,23.1%,1h
38542,2,Benfor,2086,90,2,4,6,33.3%,51m
38542,2,iwtsm,2086,0,1,1,2,50.0%,51m
38542,2,Anakim,2086,88,1,6,7,14.3%,36m
38542,2,Venom,2086,0,1,7,8,12.5%,45m
38542,3,Darinan,2086,0,0,3,3,0.0%,50m
38542,3,Jurrow,2086,0,0,5,5,0.0%,3m
38555,2,MrJellyMoobs,2085,1136,49,45,94,52.1%,51m
38555,2,wizzbot,2085,566,26,20,46,56.5%,29m
38555,3,APOLLO,2085,428,16,5,21,76.2%,11m
38555,3,[BiBAP]Keks,2085,149,4,12,16,25.0%,43m
38555,3,BlackRaven,2085,58,2,3,5,40.0%,5m
38555,1,кот,2085,97,2,8,10,20.0%,47m
38555,2,Norndm,2085,30,1,5,6,16.7%,1h
38555,3,[ZЕRGML]РаГнАрОс,2085,0,0,1,1,0.0%,5m
38555,1,Fallen,2085,0,0,2,2,0.0%,14m
38555,3,Hiqsa,2085,0,0,5,5,0.0%,52m
38555,3,OneKawaiiMan,2085,0,0,5,5,0.0%,1h
38555,3,Antofil,2085,0,0,5,5,0.0%,1h
38567,1,Next,2084,979,48,57,105,45.7%,13m
38567,2,stéfano,2084,609,20,30,50,40.0%,48m
38567,2,Artico,2084,0,4,2,6,66.7%,60m
38567,1,Gray,2084,119,4,7,11,36.4%,1h
38567,1,HeavyDeath,2084,159,4,9,13,30.8%,31m
38567,2,Macsim,2084,0,0,1,1,0.0%,48m
38567,1,Родион,2084,0,0,2,2,0.0%,42m
38567,1,Dispatchio,2084,0,0,4,4,0.0%,33m
38567,3,AmBu,2084,0,0,5,5,0.0%,1h
38576,1,Masterplex,2083,484,18,22,40,45.0%,1h
38576,3,orbitus,2083,118,4,5,9,44.4%,1h
38576,3,Dirici,2083,88,3,2,5,60.0%,1h
38576,2,XIMIK,2083,58,3,3,6,50.0%,34m
38576,2,Locazo,2083,58,3,3,6,50.0%,38m
38576,2,Ung,2083,98,3,10,13,23.1%,40m
38576,2,Hrycku,2083,102,2,2,4,50.0%,40m
38576,2,SimplePlayer,2083,46,2,2,4,50.0%,1h
38576,2,[WBK]muli,2083,30,2,3,5,40.0%,13m
38576,2,LeRotatif,2083,102,2,6,8,25.0%,1h
38576,3,Skys,2083,0,0,1,1,0.0%,45m
38576,1,GodArease,2083,0,0,1,1,0.0%,1h
38588,2,Mdsimi,2082,1150,49,46,95,51.6%,48m
38588,2,Lockey,2082,1123,47,35,82,57.3%,29m
38588,1,AspiD,2082,1000,47,53,100,47.0%,1h
38588,2,FOSTER,2082,1084,45,37,82,54.9%,12m
38588,2,ADANRO,2082,628,27,14,41,65.9%,55m
38588,3,MeXaniZm,2082,279,8,17,25,32.0%,11m
38588,2,Pumba,2082,118,5,5,10,50.0%,51m
38588,2,Brattmosh,2082,46,2,8,10,20.0%,29m
38588,3,[TExGG]Akkarin,2082,0,1,0,1,100.0%,1h
38588,3,[KrSr]Lonkka,2082,0,0,4,4,0.0%,1h
38588,3,Raistlin,2082,0,0,5,5,0.0%,1h
38599,2,Tanor,2081,1568,72,73,145,49.7%,38m
38599,2,whitch,2081,1419,65,70,135,48.1%,1h
38599,2,Mads,2081,346,18,16,34,52.9%,8m
38599,2,Zetaman,2081,206,14,10,24,58.3%,45m
38599,2,Mxtxx,2081,292,10,16,26,38.5%,41m
38599,2,BudSpencer,2081,0,3,3,6,50.0%,1h
38599,2,Asterix,2081,88,3,5,8,37.5%,9m
38599,1,toss,2081,0,1,3,4,25.0%,6m
38599,2,Kilirino,2081,0,1,3,4,25.0%,1h
38599,2,zxv,2081,0,0,2,2,0.0%,1h
38599,2,Максимилиан,2081,0,0,3,3,0.0%,1h
38599,3,armonox,2081,0,0,5,5,0.0%,6m
38611,2,Mafiaboss,2080,740,32,21,53,60.4%,9m
38611,2,Piochu,2080,525,20,33,53,37.7%,50m
38611,2,Deadpresiden,2080,480,16,21,37,43.2%,55m
38611,2,catfalcon,2080,242,8,11,19,42.1%,31m
38611,2,cluv,2080,58,3,5,8,37.5%,34m
38611,3,FlutterShy,2080,58,2,1,3,66.7%,54m
38611,3,Kalamity,2080,0,1,0,1,100.0%,55m
38611,3,JAN,2080,0,1,1,2,50.0%,1h
38611,2,[MiAzGa]Siarkens,2080,0,1,2,3,33.3%,1h
38611,2,[NGEGNE]Xeno,2080,0,1,2,3,33.3%,15m
38611,2,Geks,2080,30,1,3,4,25.0%,6m
38611,3,Zeleon,2080,38,1,6,7,14.3%,41m
38611,1,JDB,2080,0,1,7,8,12.5%,12m
38611,2,FENY,2080,0,0,1,1,0.0%,56m
38611,2,[StarLg]Chuxulub,2080,0,0,2,2,0.0%,40m
38611,2,APOSTOL,2080,0,0,2,2,0.0%,48m
38627,2,Fakver,2079,540,22,24,46,47.8%,36m
38627,2,druzaza,2079,475,19,18,37,51.4%,42m
38627,2,Neeb,2079,462,18,25,43,41.9%,9m
38627,1,MAX,2079,529,17,25,42,40.5%,1h
38627,2,Suzukima,2079,364,11,20,31,35.5%,1h
38627,1,Michael,2079,248,9,15,24,37.5%,56m
38627,1,HenryThree,2079,226,8,15,23,34.8%,1h
38627,2,Lisuva,2079,181,5,7,12,41.7%,7m
38627,2,[KKSV]GreenDay,2079,0,4,2,6,66.7%,7m
38627,2,MrMarch,2079,60,3,8,11,27.3%,1h
38627,2,hitmanttv,2079,0,1,6,7,14.3%,46m
38627,1,[TFSC]LittleCaZo,2079,97,1,8,9,11.1%,59m
38627,3,Аларий,2079,0,0,1,1,0.0%,34m
38627,3,Xenos,2079,0,0,5,5,0.0%,55m
38641,2,MariuszCK,2078,1605,86,91,177,48.6%,55m
38641,2,Rimer,2078,494,21,20,41,51.2%,1h
38641,2,potatoonpota,2078,478,18,15,33,54.5%,52m
38641,2,Fitnesspuff,2078,410,17,16,33,51.5%,30m
38641,1,HansHalal,2078,470,13,25,38,34.2%,54m
38641,2,Velheim,2078,118,7,9,16,43.8%,1h
38641,3,Бармаглот,2078,176,6,6,12,50.0%,48m
38641,3,IIIIIIIIIIII,2078,86,3,1,4,75.0%,9m
38641,1,RomaUZ,2078,48,1,9,10,10.0%,46m
38641,3,neoflo,2078,0,0,1,1,0.0%,38m
38641,3,Animka,2078,0,0,5,5,0.0%,55m
38652,1,ilyich,2077,1251,46,49,95,48.4%,11m
38652,2,[L5D]kumbi,2077,515,26,34,60,43.3%,32m
38652,1,[UF2AC]Грач,2077,424,15,20,35,42.9%,4m
38652,3,Broly,2077,199,8,17,25,32.0%,1h
38652,2,Evolmia,2077,120,5,5,10,50.0%,9m
38652,2,Gecko,2077,178,5,5,10,50.0%,34m
38652,2,Last,2077,90,4,7,11,36.4%,36m
38652,2,Siggi,2077,0,3,3,6,50.0%,1h
38652,3,Lothrick,2077,30,2,1,3,66.7%,37m
38652,2,Rock,2077,30,2,4,6,33.3%,38m
38652,3,VVVkEstik,2077,0,0,1,1,0.0%,1h
38652,2,Reaper,2077,0,0,6,6,0.0%,1h
38664,1,[CataC]sambady,2076,1581,116,117,233,49.8%,51m
38664,2,Paha,2076,1382,57,56,113,50.4%,30m
38664,2,[RBCOMM]GeNiUSssS,2076,270,14,8,22,63.6%,1h
38664,2,Krabi,2076,102,3,5,8,37.5%,51m
38664,2,Sonozaki,2076,94,3,10,13,23.1%,1h
38664,2,[Rbth]Nabe,2076,0,2,4,6,33.3%,30m
38664,3,OzcV,2076,0,1,0,1,100.0%,37m
38664,3,SirMcClutch,2076,0,0,1,1,0.0%,5m
38664,2,therfouf,2076,0,0,2,2,0.0%,48m
38664,2,Sympak,2076,0,0,2,2,0.0%,1h
38664,3,Centurion,2076,0,0,2,2,0.0%,30m
38664,1,Mendozakss,2076,0,0,5,5,0.0%,1h
38664,3,KROM,2076,0,0,5,5,0.0%,1h
38677,3,SolacoMan,2075,771,31,27,58,53.4%,3m
38677,2,Ктовсехврот,2075,150,5,12,17,29.4%,1h
38677,2,DreadLord,2075,165,4,4,8,50.0%,4m
38677,3,[xHaoSx]LOLBIT,2075,0,4,8,12,33.3%,37m
38677,3,POCHOTE,2075,100,3,9,12,25.0%,35m
38677,2,cee,2075,38,2,3,5,40.0%,1h
38677,2,bilstein,2075,0,1,1,2,50.0%,30m
38677,2,[CdNRO]Dane,2075,0,1,4,5,20.0%,58m
38677,2,dukratchoc,2075,0,0,3,3,0.0%,1h
38677,2,dieDose,2075,0,0,3,3,0.0%,1h
38687,2,imagine,2074,539,24,22,46,52.2%,1h
38687,2,[SyperS]Repzpank,2074,388,16,12,28,57.1%,55m
38687,2,CEKO,2074,182,9,9,18,50.0%,1h
38687,3,LumiSSenS,2074,273,9,17,26,34.6%,58m
38687,2,AngryZerg,2074,214,7,10,17,41.2%,51m
38687,1,ShereRa,2074,234,7,15,22,31.8%,1h
38687,1,Crypta,2074,92,6,19,25,24.0%,35m
38687,2,GIVEMEACAGE,2074,116,3,4,7,42.9%,1h
38687,2,Wurst,2074,88,3,8,11,27.3%,1h
38687,2,[ANREN]dimontas,2074,93,1,2,3,33.3%,1h
38687,2,[C12760]Elrroth,2074,30,1,6,7,14.3%,6m
38687,3,Phanto,2074,40,1,6,7,14.3%,1h
38687,2,assasyn,2074,0,1,6,7,14.3%,1h
38687,3,KRUT,2074,0,0,1,1,0.0%,51m
38701,2,Slihed,2073,1369,53,62,115,46.1%,60m
38701,3,yuraqwalla,2073,377,12,24,36,33.3%,55m
38701,2,bapa,2073,94,4,6,10,40.0%,10m
38701,1,[ST2SAS]kirkland,2073,90,2,3,5,40.0%,45m
38701,1,RaWge,2073,0,1,1,2,50.0%,51m
38701,2,Hellos,2073,0,1,2,3,33.3%,45m
38701,1,loks,2073,95,1,2,3,33.3%,45m
38708,2,Brogue,2072,1531,118,110,228,51.8%,1h
38708,2,Tiem,2072,644,57,57,114,50.0%,1h
38708,2,niquitsch,2072,934,35,43,78,44.9%,55m
38708,2,rikx,2072,819,28,31,59,47.5%,38m
38708,2,JornSnow,2072,602,23,23,46,50.0%,8m
38708,2,ololoider,2072,573,22,21,43,51.2%,12m
38708,1,TrafalMat,2072,202,9,12,21,42.9%,1h
38708,2,MicroFraud,2072,112,6,2,8,75.0%,30m
38708,3,[zurt]zurtmaster,2072,201,6,6,12,50.0%,57m
38708,1,MrFahrenheit,2072,236,6,12,18,33.3%,1h
38708,3,[LQV]ShadowDragon,2072,0,1,1,2,50.0%,34m
38708,2,[842703]Jacek,2072,0,1,2,3,33.3%,58m
38708,3,токсикипорук,2072,0,1,4,5,20.0%,1h
38708,2,ShoggyD,2072,0,1,6,7,14.3%,59m
38708,1,zguyTV,2072,0,0,2,2,0.0%,1h
38723,2,NightLive,2071,344,20,19,39,51.3%,44m
38723,2,Wolfer,2071,356,13,16,29,44.8%,1h
38723,3,RatKingSoury,2071,290,12,14,26,46.2%,5m
38723,3,campus,2071,266,11,9,20,55.0%,34m
38723,2,[Аоуэйя]kok,2071,334,10,18,28,35.7%,1h
38723,3,[Varose]ivanovick,2071,140,9,3,12,75.0%,34m
38723,3,Oskar,2071,213,6,4,10,60.0%,55m
38723,2,dragonknight,2071,168,6,5,11,54.5%,55m
38723,2,Shaduwu,2071,134,6,7,13,46.2%,41m
38723,1,Maximax,2071,145,3,10,13,23.1%,1h
38723,3,OggyOli,2071,0,1,0,1,100.0%,1h
38723,3,Devlo,2071,0,0,1,1,0.0%,46m
38723,2,Bryan,2071,0,0,2,2,0.0%,33m
38723,1,[LOGS]James,2071,0,0,2,2,0.0%,34m
38723,3,Still,2071,0,0,5,5,0.0%,45m
38738,1,Max,2070,223,18,22,40,45.0%,1h
38738,3,Adihasz,2070,425,15,20,35,42.9%,6m
38738,2,Shikoloff,2070,112,4,4,8,50.0%,46m
38738,3,materdeter,2070,0,2,3,5,40.0%,1h
38738,3,DarkLord,2070,0,1,0,1,100.0%,1h
38738,2,Strikestar,2070,0,0,2,2,0.0%,1h
38744,1,Eipieti,2069,744,23,32,55,41.8%,59m
38744,1,mecajet,2069,244,9,12,21,42.9%,37m
38744,2,ComoN,2069,190,6,13,19,31.6%,60m
38744,2,Chris,2069,62,3,9,12,25.0%,1h
38744,2,jaanonim,2069,0,1,1,2,50.0%,33m
38744,2,[F3dP0L]ShinyPants,2069,0,1,3,4,25.0%,48m
38744,2,KanUndead,2069,88,1,4,5,20.0%,1h
38744,3,Repti,2069,0,0,1,1,0.0%,1h
38752,2,Uno,2068,530,18,25,43,41.9%,42m
38752,2,[ATRS]Supaserrin,2068,490,17,20,37,45.9%,1h
38752,2,Nikita,2068,270,10,8,18,55.6%,10m
38752,2,[N1CANI]Engello,2068,162,6,7,13,46.2%,13m
38752,1,HeliosToRa,2068,188,5,6,11,45.5%,13m
38752,1,[BIRB]bluesyfluesy,2068,188,3,5,8,37.5%,45m
38752,2,Namarrgon,2068,94,3,7,10,30.0%,1h
38752,1,Kontent,2068,167,3,11,14,21.4%,4m
38752,3,tif,2068,0,1,4,5,20.0%,1h
38752,2,storm,2068,0,1,5,6,16.7%,29m
38752,2,Weelzevul,2068,0,0,3,3,0.0%,1h
38763,2,WOLFSBLUT,2067,355,15,9,24,62.5%,1h
38763,3,Koteman,2067,360,14,10,24,58.3%,1h
38763,2,mistrz,2067,185,4,6,10,40.0%,9m
38763,1,Ingo,2067,142,4,9,13,30.8%,44m
38763,1,Khaimera,2067,132,4,11,15,26.7%,12m
38763,1,Tinkerbell,2067,0,2,10,12,16.7%,14m
38763,3,Shinrekt,2067,0,1,4,5,20.0%,34m
38763,1,[JaPP]Астарот,2067,0,1,4,5,20.0%,41m
38763,3,Tempi,2067,0,0,5,5,0.0%,1h
38772,1,генерал,2066,716,25,33,58,43.1%,54m
38772,2,Grizzly,2066,315,14,7,21,66.7%,1h
38772,2,SnowballFour,2066,246,13,20,33,39.4%,1h
38772,2,hanter,2066,185,10,5,15,66.7%,37m
38772,2,Acar,2066,250,8,8,16,50.0%,1h
38772,2,Blady,2066,238,7,11,18,38.9%,1h
38772,3,maesking,2066,173,4,5,9,44.4%,5m
38772,3,Povstanets,2066,88,3,3,6,50.0%,60m
38772,2,Roman,2066,58,2,4,6,33.3%,37m
38772,3,llllllllllll,2066,0,0,1,1,0.0%,54m
38772,3,joab,2066,0,0,6,6,0.0%,43m
38783,1,Dominoiooi,2065,1400,64,76,140,45.7%,13m
38783,2,buduumnee,2065,561,25,25,50,50.0%,1h
38783,2,Amoxicilina,2065,355,12,19,31,38.7%,1h
38783,3,Jejes,2065,100,4,6,10,40.0%,47m
38783,3,Katysak,2065,30,2,1,3,66.7%,42m
38783,3,IIIIIIIIIIII,2065,30,1,3,4,25.0%,7m
38789,3,ShinköGane,2064,526,18,35,53,34.0%,42m
38789,2,AlexSerbanro,2064,88,4,7,11,36.4%,1h
38789,3,[ImbaG]Putin,2064,30,2,1,3,66.7%,30m
38789,2,valerik,2064,42,2,2,4,50.0%,45m
38789,3,[CaLe]Subotay,2064,30,1,1,2,50.0%,1h
38789,2,CptBartek,2064,88,1,3,4,25.0%,35m
38789,2,[LBCS]Wítr,2064,25,1,6,7,14.3%,60m
38789,2,Nico,2064,30,1,6,7,14.3%,10m
38789,2,yeetdHamster,2064,0,1,6,7,14.3%,13m
38789,3,Marauder,2064,97,1,8,9,11.1%,54m
38799,2,KrAuTOnE,2063,352,13,15,28,46.4%,54m
38799,3,FTSwarm,2063,273,11,18,29,37.9%,1h
38799,2,KusznikJacek,2063,353,10,21,31,32.3%,30m
38799,3,Stylker,2063,220,7,5,12,58.3%,57m
38799,1,Samotichou,2063,217,6,12,18,33.3%,12m
38799,2,LeoLejon,2063,151,3,6,9,33.3%,1h
38799,3,KostikH,2063,58,2,2,4,50.0%,3m
38799,2,LOLO,2063,92,2,5,7,28.6%,3m
38799,3,[Kboin]Alexis,2063,30,1,3,4,25.0%,9m
38799,1,Helbaal,2063,0,1,8,9,11.1%,42m
38809,2,[N1TDA]HarryCover,2062,1535,270,285,555,48.6%,37m
38809,1,VeryGood,2062,779,55,61,116,47.4%,59m
38809,2,soszkers,2062,779,49,52,101,48.5%,15m
38809,2,Coconut,2062,462,17,27,44,38.6%,1h
38809,1,[ExTr1m]Gor,2062,454,16,24,40,40.0%,49m
38809,1,[DeVu]BorisChan,2062,234,8,9,17,47.1%,60m
38809,2,Threlgor,2062,141,2,7,9,22.2%,10m
38809,3,SamsonDaniel,2062,38,1,1,2,50.0%,55m
38809,2,[Molot]Pustoy,2062,0,1,2,3,33.3%,8m
38809,2,TOLOTOS,2062,0,1,9,10,10.0%,45m
38809,1,Smart,2062,0,0,3,3,0.0%,56m
38809,3,[Resy]DaniDan,2062,0,0,5,5,0.0%,1h
38809,2,Ruby,2062,0,0,7,7,0.0%,56m
38822,2,Цезарь,2061,1095,41,45,86,47.7%,38m
38822,2,ПодПивасом,2061,433,15,16,31,48.4%,31m
38822,2,TossMenda,2061,432,14,20,34,41.2%,1h
38822,1,jojo,2061,233,9,7,16,56.2%,45m
38822,2,[21789]JoshuaM,2061,156,4,3,7,57.1%,6m
38822,2,Just,2061,0,3,5,8,37.5%,13m
38822,2,Tomas,2061,184,3,7,10,30.0%,1h
38822,3,[BCV]Czeczot,2061,120,2,3,5,40.0%,40m
38822,2,[Hrѓ]СтаяИгнуса,2061,102,2,5,7,28.6%,39m
38822,3,crazymen,2061,30,2,5,7,28.6%,43m
38822,2,Xantos,2061,94,1,1,2,50.0%,1h
38822,1,Smanu,2061,0,1,8,9,11.1%,8m
38822,3,Cupcake,2061,0,0,1,1,0.0%,1h
38822,2,[FMG]SgtShake,2061,0,0,2,2,0.0%,34m
38836,1,EnVill,2060,1446,55,61,116,47.4%,30m
38836,3,Dozzzerboss,2060,744,28,23,51,54.9%,41m
38836,2,BotZero,2060,462,18,20,38,47.4%,14m
38836,3,maksimkla,2060,306,11,15,26,42.3%,38m
38836,2,Shadnax,2060,121,4,7,11,36.4%,4m
38836,2,Luthor,2060,107,3,9,12,25.0%,1h
38836,3,hior,2060,0,1,0,1,100.0%,1h
38836,2,[ZiCh]Алукард,2060,0,1,0,1,100.0%,33m
38836,1,MiKola,2060,0,1,0,1,100.0%,45m
38836,3,ReaperOfZerg,2060,0,1,0,1,100.0%,47m
38836,3,[54D]doni,2060,30,1,2,3,33.3%,34m
38836,2,manu,2060,95,1,7,8,12.5%,55m
38836,1,blorg,2060,0,0,2,2,0.0%,47m
38836,2,JACKSON,2060,0,0,3,3,0.0%,1h
38836,3,GoldLord,2060,0,0,5,5,0.0%,1h
38836,3,Tribe,2060,0,0,5,5,0.0%,1h
38852,2,Artigy,2059,1450,65,68,133,48.9%,55m
38852,2,KoPa,2059,775,28,33,61,45.9%,1h
38852,1,Rynke,2059,672,22,37,59,37.3%,54m
38852,3,DangerFloof,2059,60,3,2,5,60.0%,11m
38852,2,Prodromos,2059,0,0,3,3,0.0%,1h
38852,3,lagunero,2059,0,0,5,5,0.0%,3m
38858,2,intersys,2058,1514,145,153,298,48.7%,51m
38858,2,Nannack,2058,214,10,10,20,50.0%,9m
38858,1,[сюда]DarkCookie,2058,140,4,1,5,80.0%,1h
38858,2,jonny,2058,138,3,4,7,42.9%,1h
38858,3,[Foxeh]DangerFoxeh,2058,30,2,5,7,28.6%,38m
38858,3,[3Mz]Varkh,2058,0,0,5,5,0.0%,1h
38858,3,Swaggosaurus,2058,0,0,5,5,0.0%,1h
38865,2,[Rellik]Cinnamon,2057,628,23,27,50,46.0%,12m
38865,3,DED,2057,278,11,2,13,84.6%,54m
38865,1,[ETBAV]ZIeyKIzzy,2057,243,7,14,21,33.3%,37m
38865,1,IKaRuS,2057,177,6,8,14,42.9%,9m
38865,2,Rushardcore,2057,88,4,6,10,40.0%,37m
38865,2,[Сold]даникпро,2057,0,1,5,6,16.7%,8m
38865,2,ulkor,2057,0,1,6,7,14.3%,1h
38865,1,[Vizzor]Andrbayt,2057,0,0,1,1,0.0%,34m
38873,1,wernexper,2056,1212,69,84,153,45.1%,1h
38873,1,Lkobraa,2056,711,25,39,64,39.1%,30m
38873,2,McNinja,2056,551,18,26,44,40.9%,9m
38873,2,MajesticRoar,2056,154,7,6,13,53.8%,14m
38873,2,vladxxx,2056,144,6,6,12,50.0%,1h
38873,3,Spleenfloyd,2056,193,6,6,12,50.0%,1h
38873,1,vtotR,2056,96,3,1,4,75.0%,1h
38873,3,MihaLexx,2056,60,3,2,5,60.0%,1h
38873,2,MAGLURprikin,2056,86,3,4,7,42.9%,34m
38873,3,[Дру9я]Эдвард,2056,0,1,0,1,100.0%,38m
38873,2,Verus,2056,30,1,8,9,11.1%,32m
38873,3,[CHOPAA]ART,2056,0,0,2,2,0.0%,1h
38873,3,xaxa,2056,0,0,3,3,0.0%,52m
38873,2,kierzkos,2056,0,0,6,6,0.0%,39m
38887,1,MontevonzoT,2055,1580,79,87,166,47.6%,44m
38887,3,LoveMyTisane,2055,142,7,6,13,53.8%,11m
38887,2,Hero,2055,172,7,8,15,46.7%,31m
38887,2,Ghosthost,2055,203,7,17,24,29.2%,3m
38887,2,DAMNED,2055,174,6,9,15,40.0%,15m
38887,3,artem,2055,118,4,4,8,50.0%,3m
38887,1,Joelito,2055,0,3,6,9,33.3%,55m
38887,3,EinfachLars,2055,30,3,11,14,21.4%,1h
38887,3,xxxfrixxx,2055,94,2,5,7,28.6%,13m
38887,3,SipasBZG,2055,30,1,3,4,25.0%,1h
38887,2,Glocki,2055,0,1,7,8,12.5%,46m
38887,3,lifeline,2055,0,0,1,1,0.0%,14m
38887,3,[SworD3]Leegoo,2055,0,0,5,5,0.0%,1h
38900,1,Skyfall,2054,862,144,160,304,47.4%,1h
38900,2,paulhus,2054,918,61,62,123,49.6%,37m
38900,3,Alecots,2054,169,7,6,13,53.8%,1h
38900,2,Queenie,2054,134,3,4,7,42.9%,1h
38900,3,[Allakh]Sauge,2054,30,2,1,3,66.7%,56m
38900,2,beyxAvoid,2054,90,2,8,10,20.0%,1h
38900,3,Sprudel,2054,0,0,1,1,0.0%,1h
38900,3,Zitz,2054,0,0,1,1,0.0%,8m
38900,2,[BGBKBR]Neeb,2054,0,0,1,1,0.0%,57m
38909,2,Saphira,2053,961,51,48,99,51.5%,55m
38909,3,WULFGAR,2053,1196,46,44,90,51.1%,58m
38909,2,ThorsHammer,2053,220,7,7,14,50.0%,1h
38909,2,Maestro,2053,120,7,9,16,43.8%,51m
38909,3,piotrek,2053,190,6,5,11,54.5%,11m
38909,3,[HEROX]Jleyher,2053,148,5,5,10,50.0%,11m
38909,1,Alac,2053,236,5,6,11,45.5%,1h
38909,1,Igu,2053,216,5,12,17,29.4%,1h
38909,2,Nik,2053,0,1,1,2,50.0%,30m
38909,2,Joe,2053,0,0,1,1,0.0%,51m
38909,2,Aleksey,2053,0,0,2,2,0.0%,55m
38920,2,ALPHAZEALOT,2052,901,51,52,103,49.5%,56m
38920,3,Batoti,2052,272,9,10,19,47.4%,1h
38920,2,rimpk,2052,119,6,5,11,54.5%,12m
38920,3,Alv,2052,150,3,13,16,18.8%,1h
38920,3,[GKTRK]Zaloğlu,2052,32,1,1,2,50.0%,1h
38920,1,xcralpy,2052,48,1,2,3,33.3%,52m
38920,3,RustR,2052,0,0,5,5,0.0%,1h
38927,1,MrPickles,2051,1097,62,81,143,43.4%,59m
38927,2,Marchello,2051,924,39,43,82,47.6%,1h
38927,1,МистерСмерть,2051,952,32,42,74,43.2%,55m
38927,2,goatcommand,2051,750,31,29,60,51.7%,55m
38927,2,euskal,2051,757,29,31,60,48.3%,1h
38927,3,garrot,2051,493,19,21,40,47.5%,41m
38927,2,MakarChudra,2051,320,12,10,22,54.5%,55m
38927,1,[INMF]Kealeth,2051,335,7,16,23,30.4%,48m
38927,1,Malevih,2051,311,6,17,23,26.1%,7m
38927,2,Rosdee,2051,259,5,11,16,31.2%,45m
38927,3,Бравлер,2051,0,2,3,5,40.0%,54m
38927,3,[K0RM2]Nidus,2051,0,1,0,1,100.0%,47m
38927,3,LAVRON,2051,0,1,0,1,100.0%,6m
38927,2,servinaty,2051,0,1,2,3,33.3%,1h
38927,3,paltiniki,2051,0,0,1,1,0.0%,3m
38927,3,[Zhig]Пашель,2051,0,0,1,1,0.0%,6m
38927,3,Yage,2051,0,0,2,2,0.0%,37m
38927,3,Blowering,2051,0,0,5,5,0.0%,43m
38927,3,[FreshR]DellaCosta,2051,0,0,6,6,0.0%,1h
38946,2,Kisada,2050,677,26,26,52,50.0%,1h
38946,2,JohnCena,2050,314,10,15,25,40.0%,38m
38946,3,CLON,2050,114,4,7,11,36.4%,40m
38946,2,DvP,2050,140,4,14,18,22.2%,11m
38946,2,Boemz,2050,46,2,4,6,33.3%,13m
38946,2,CeleryBear,2050,111,2,6,8,25.0%,51m
38946,3,Erazerhead,2050,0,0,4,4,0.0%,52m
38946,2,photON,2050,0,0,4,4,0.0%,29m
38946,3,Hojalata,2050,0,0,5,5,0.0%,1h
38955,2,Brainstorm,2049,694,25,25,50,50.0%,1h
38955,2,ABCD,2049,362,15,19,34,44.1%,1h
38955,2,Limbo,2049,238,6,10,16,37.5%,1h
38955,2,Gannik,2049,146,5,2,7,71.4%,6m
38955,2,[mfxed]jasina,2049,143,5,2,7,71.4%,38m
38955,2,legeek,2049,179,5,9,14,35.7%,1h
38955,1,Quot,2049,186,5,12,17,29.4%,44m
38955,2,Thanquol,2049,58,4,12,16,25.0%,4m
38955,3,Mipio,2049,0,0,1,1,0.0%,5m
38955,3,Somyc,2049,0,0,4,4,0.0%,55m
38955,2,DocG,2049,0,0,7,7,0.0%,1h
38966,1,Zerebrat,2048,1538,80,90,170,47.1%,14m
38966,2,Mastadoc,2048,1013,56,55,111,50.5%,48m
38966,3,Txuster,2048,413,20,20,40,50.0%,58m
38966,2,Dandoh,2048,582,19,26,45,42.2%,45m
38966,2,neville,2048,426,14,19,33,42.4%,48m
38966,2,brutus,2048,448,13,23,36,36.1%,12m
38966,2,Okytos,2048,269,11,10,21,52.4%,1h
38966,3,[CxCx]Amine,2048,140,5,5,10,50.0%,1h
38966,2,Alexdesas,2048,150,5,9,14,35.7%,1h
38966,2,Freedom,2048,167,3,11,14,21.4%,1h
38966,1,Kepi,2048,117,2,4,6,33.3%,1h
38966,3,JoJo,2048,0,1,1,2,50.0%,1h
38966,2,Onyx,2048,0,1,1,2,50.0%,60m
38966,3,LimNylon,2048,30,1,1,2,50.0%,11m
38966,2,pinniwini,2048,0,0,3,3,0.0%,5m
38966,3,Nutswar,2048,0,0,5,5,0.0%,12m
38982,2,RichieStar,2047,1065,76,94,170,44.7%,1h
38982,2,Koosklaas,2047,1336,50,52,102,49.0%,50m
38982,2,Kost,2047,423,29,25,54,53.7%,1h
38982,2,CRiMiSoN,2047,342,13,13,26,50.0%,1h
38982,3,[ottos]Naiadune,2047,368,13,14,27,48.1%,55m
38982,3,Aralax,2047,300,12,13,25,48.0%,9m
38982,2,gegoran,2047,365,11,13,24,45.8%,50m
38982,3,[DKSCII]counterspace,2047,81,7,7,14,50.0%,58m
38982,1,korsar,2047,215,7,9,16,43.8%,12m
38982,1,Watermelon,2047,144,4,11,15,26.7%,33m
38982,3,XxXD,2047,49,2,4,6,33.3%,53m
38982,3,Milziade,2047,0,1,5,6,16.7%,12m
38982,3,Opezdal,2047,0,0,5,5,0.0%,3m
38995,2,Dazman,2046,815,42,51,93,45.2%,6m
38995,2,Maksimus,2046,326,21,25,46,45.7%,10m
38995,3,[Catory]Kychcio,2046,496,17,14,31,54.8%,37m
38995,3,Abgoni,2046,420,14,28,42,33.3%,16m
38995,2,Часовой,2046,302,10,15,25,40.0%,9m
38995,2,Dmitrit,2046,351,9,17,26,34.6%,30m
38995,3,PurpleBroly,2046,212,7,9,16,43.8%,1h
38995,3,ZerggyDoggy,2046,142,6,1,7,85.7%,5m
38995,3,[Аоуэйя]zajebioza,2046,142,5,4,9,55.6%,9m
38995,3,inSame,2046,114,4,5,9,44.4%,47m
38995,2,Sumaru,2046,90,2,9,11,18.2%,48m
38995,2,Kostet,2046,0,1,0,1,100.0%,53m
38995,2,loker,2046,30,1,6,7,14.3%,11m
38995,3,ZubanPL,2046,32,1,9,10,10.0%,42m
38995,3,Guniu,2046,0,0,1,1,0.0%,43m
39010,2,Spec,2045,270,32,36,68,47.1%,1h
39010,1,MisterCoco,2045,706,25,31,56,44.6%,59m
39010,3,CrazyHorse,2045,636,22,25,47,46.8%,54m
39010,2,Aspid,2045,254,9,19,28,32.1%,1h
39010,3,joy,2045,210,7,8,15,46.7%,9m
39010,3,Klimov,2045,195,6,5,11,54.5%,1h
39010,2,Parsam,2045,182,5,10,15,33.3%,56m
39010,1,MesviJ,2045,112,4,11,15,26.7%,57m
39010,3,[chww]ZergRush,2045,86,3,2,5,60.0%,58m
39010,3,FallenGhost,2045,40,3,4,7,42.9%,1h
39010,3,Atlantis,2045,30,3,8,11,27.3%,45m
39010,2,BossGH,2045,88,2,3,5,40.0%,13m
39010,3,Troels,2045,0,0,1,1,0.0%,30m
39010,3,InfEstaaahhh,2045,0,0,1,1,0.0%,11m
39024,3,[SPAINs]batchar,2044,624,28,31,59,47.5%,8m
39024,2,[ABDI]Sacha,2044,584,23,20,43,53.5%,1h
39024,3,Yoka,2044,512,20,16,36,55.6%,1h
39024,2,tornado,2044,298,13,20,33,39.4%,55m
39024,2,Lokkee,2044,278,10,10,20,50.0%,34m
39024,3,PasutusI,2044,0,1,0,1,100.0%,1h
39024,1,StarChild,2044,95,1,1,2,50.0%,9m
39024,3,[420GG]Chiken,2044,0,1,4,5,20.0%,1h
39024,2,PzyKo,2044,30,1,7,8,12.5%,12m
39024,2,Overlod,2044,0,0,3,3,0.0%,46m
39034,2,[ZENITS]voyager,2043,818,101,108,209,48.3%,8m
39034,1,Zeruel,2043,1609,85,101,186,45.7%,6m
39034,1,Xagula,2043,795,31,36,67,46.3%,14m
39034,2,Timmi,2043,428,15,22,37,40.5%,56m
39034,2,Stranken,2043,327,10,17,27,37.0%,1h
39034,2,[HRisk]СуперМаг,2043,241,7,10,17,41.2%,29m
39034,1,[IaGMI]Lechoupastek,2043,212,5,8,13,38.5%,41m
39034,3,BLAZE,2043,30,2,2,4,50.0%,45m
39034,2,SKOROsTRELOK,2043,0,0,2,2,0.0%,41m
39034,2,SysiLIII,2043,0,0,3,3,0.0%,1h
39034,3,Anduril,2043,0,0,4,4,0.0%,1h
39045,2,umer,2042,410,14,19,33,42.4%,8m
39045,2,Toni,2042,238,7,9,16,43.8%,1h
39045,2,also,2042,96,1,2,3,33.3%,57m
39045,2,SISERA,2042,30,1,4,5,20.0%,6m
39045,2,Kuglof,2042,88,1,6,7,14.3%,58m
39045,2,BeardedHare,2042,95,1,7,8,12.5%,30m
39045,3,кирилл,2042,0,0,1,1,0.0%,6m
39045,1,VIGITAL,2042,0,0,5,5,0.0%,42m
39053,1,TBoy,2041,1198,56,53,109,51.4%,54m
39053,2,SirZimaPk,2041,659,34,27,61,55.7%,51m
39053,2,Turan,2041,594,25,20,45,55.6%,50m
39053,2,NupaDupa,2041,600,24,28,52,46.2%,46m
39053,3,sajbend,2041,538,21,19,40,52.5%,58m
39053,2,BlackVolf,2041,427,12,21,33,36.4%,10m
39053,3,itsmonsta,2041,206,5,12,17,29.4%,39m
39053,3,speciialkh,2041,114,4,4,8,50.0%,30m
39053,2,juliojugando,2041,127,4,6,10,40.0%,60m
39053,1,[Tостер]Бирсиаль,2041,95,2,2,4,50.0%,1h
39053,3,DJCommander,2041,0,1,0,1,100.0%,1h
39053,3,PrettyMonstr,2041,0,0,1,1,0.0%,39m
39053,3,Pawuk,2041,0,0,1,1,0.0%,38m
39066,2,химик,2040,857,38,35,73,52.1%,30m
39066,2,Raid,2040,800,31,32,63,49.2%,55m
39066,3,[BLINtv]DungeonMastr,2040,256,10,20,30,33.3%,58m
39066,3,lol,2040,140,5,5,10,50.0%,1h
39066,1,LOL,2040,124,2,9,11,18.2%,1h
39066,3,[LDvx]SNAIPER,2040,0,1,0,1,100.0%,37m
39066,3,Abbysss,2040,0,0,1,1,0.0%,11m
39073,2,[JAHODA]Rostavil,2039,282,9,17,26,34.6%,34m
39073,3,[Steep]IvanYST,2039,133,4,8,12,33.3%,38m
39073,3,Whitepill,2039,97,2,3,5,40.0%,1h
39073,2,wegeve,2039,0,1,4,5,20.0%,59m
39073,3,Voroshilov,2039,0,0,2,2,0.0%,7m
39078,2,Warmecanic,2038,906,58,53,111,52.3%,1h
39078,3,nagrizolich,2038,602,22,27,49,44.9%,57m
39078,2,Sennin,2038,410,17,18,35,48.6%,37m
39078,3,Niggo,2038,246,9,13,22,40.9%,35m
39078,2,patorike,2038,210,7,12,19,36.8%,1h
39078,2,diegladeitor,2038,154,5,8,13,38.5%,30m
39078,1,andrey,2038,218,5,12,17,29.4%,12m
39078,2,[Torgal]Paradoxez,2038,98,5,13,18,27.8%,6m
39078,2,TheLeaf,2038,0,3,5,8,37.5%,3m
39078,2,nik,2038,120,2,4,6,33.3%,36m
39078,2,[Z3R6TV]XeNoS,2038,80,2,10,12,16.7%,60m
39078,3,kenzo,2038,30,1,2,3,33.3%,1h
39078,3,Crimone,2038,30,1,3,4,25.0%,1h
39078,3,LuckySnail,2038,0,0,1,1,0.0%,9m
39078,3,GallantSteed,2038,0,0,1,1,0.0%,53m
39093,2,Cedric,2037,826,31,36,67,46.3%,55m
39093,2,SEba,2037,286,20,20,40,50.0%,37m
39093,1,Дмитрий,2037,302,18,27,45,40.0%,59m
39093,2,dezzodog,2037,408,16,17,33,48.5%,37m
39093,2,Cactus,2037,362,11,15,26,42.3%,1h
39093,3,Max,2037,190,8,2,10,80.0%,1h
39093,3,Neexs,2037,249,7,9,16,43.8%,34m
39093,2,Max,2037,166,7,18,25,28.0%,1h
39093,2,swisswarrior,2037,60,3,6,9,33.3%,1h
39093,3,[DL2006]Tonytag,2037,38,2,1,3,66.7%,43m
39093,3,xanawaro,2037,0,2,3,5,40.0%,58m
39093,2,BlackFire,2037,46,2,3,5,40.0%,39m
39093,3,[CeGeTe]UnKnown,2037,119,2,5,7,28.6%,1h
39093,2,[Бaтьки]Waletta,2037,30,2,12,14,14.3%,1h
39093,3,[Jail]Poseidonswat,2037,30,1,3,4,25.0%,15m
39093,3,МЕТАЛИК,2037,0,0,1,1,0.0%,3m
39093,2,Jimmelreiter,2037,0,0,2,2,0.0%,56m
39110,2,[ForUA]Dingo,2036,1565,118,129,247,47.8%,10m
39110,2,aston,2036,1112,44,50,94,46.8%,58m
39110,3,[TB02]Stachu,2036,443,20,15,35,57.1%,11m
39110,2,Lazarus,2036,266,9,11,20,45.0%,10m
39110,2,Honzik,2036,200,8,9,17,47.1%,56m
39110,3,LoveBugged,2036,193,6,13,19,31.6%,1h
39110,1,GarryOZ,2036,180,6,17,23,26.1%,1h
39110,2,LeO,2036,30,2,8,10,20.0%,29m
39110,2,HairCutter,2036,60,2,9,11,18.2%,3m
39110,3,[guppi]SKW,2036,30,1,3,4,25.0%,1h
39110,2,[LCN]Francisco,2036,0,1,3,4,25.0%,1h
39110,2,max,2036,42,1,9,10,10.0%,3m
39110,3,[LAIROF]AndroiD,2036,0,0,1,1,0.0%,3m
39110,3,[FAJAS]myks,2036,0,0,1,1,0.0%,12m
39110,3,[ZeCouZ]hellgast,2036,0,0,2,2,0.0%,9m
39125,2,lamba,2035,475,20,15,35,57.1%,30m
39125,2,FlorisSaurus,2035,394,18,27,45,40.0%,46m
39125,1,EZHOWWW,2035,205,14,27,41,34.1%,1h
39125,2,Wild,2035,314,9,16,25,36.0%,43m
39125,3,GoodGams,2035,0,1,4,5,20.0%,38m
39125,1,DIMON,2035,46,1,8,9,11.1%,55m
39131,3,Gwuw,2034,316,12,11,23,52.2%,1h
39131,2,dijoke,2034,230,9,9,18,50.0%,1h
39131,3,Vers,2034,157,6,7,13,46.2%,1h
39131,2,FreddyHell,2034,208,6,9,15,40.0%,1h
39131,3,Xeton,2034,78,5,2,7,71.4%,11m
39131,1,CatS,2034,172,4,15,19,21.1%,41m
39131,3,Stown,2034,76,3,4,7,42.9%,1h
39131,3,MooN,2034,58,2,4,6,33.3%,7m
39131,3,PiNoKZeVVsA,2034,0,1,0,1,100.0%,1h
39131,1,SGT,2034,48,1,2,3,33.3%,36m
39131,2,[xBBCx]Plato,2034,0,1,7,8,12.5%,3m
39131,1,[GIMIK]Buczek,2034,0,1,7,8,12.5%,6m
39131,3,Xentos,2034,0,0,1,1,0.0%,47m
39131,3,gogo,2034,0,0,1,1,0.0%,46m
39131,3,MATI,2034,0,0,6,6,0.0%,1h
39131,2,SoloLeveling,2034,0,0,7,7,0.0%,56m
39147,2,Wazaaaaaaaaa,2033,250,44,55,99,44.4%,30m
39147,2,makc,2033,858,32,37,69,46.4%,6m
39147,2,VKing,2033,626,23,27,50,46.0%,6m
39147,2,Ralph,2033,310,13,24,37,35.1%,55m
39147,3,AJmaxPower,2033,266,9,9,18,50.0%,3m
39147,2,[ABDI]Dadane,2033,261,9,15,24,37.5%,51m
39147,1,[Ba2c]MisterJoBa,2033,188,6,1,7,85.7%,1h
39147,3,TenYearsOld,2033,90,4,2,6,66.7%,34m
39147,2,Freeonio,2033,128,4,6,10,40.0%,56m
39147,3,SnrCitizen,2033,30,2,1,3,66.7%,8m
39147,2,[3X3]dariahmm,2033,0,1,0,1,100.0%,33m
39147,3,psichi,2033,0,0,1,1,0.0%,52m
39147,3,Megyminimba,2033,0,0,1,1,0.0%,8m
39160,2,carloslt,2032,102,7,2,9,77.8%,1h
39160,2,maksim,2032,200,7,12,19,36.8%,5m
39160,3,ItzakStern,2032,220,6,10,16,37.5%,29m
39160,1,Static,2032,241,4,14,18,22.2%,56m
39160,1,BlackenED,2032,60,3,9,12,25.0%,1h
39160,3,tyoma,2032,0,1,0,1,100.0%,38m
39160,3,Elendil,2032,42,1,2,3,33.3%,37m
39160,3,[Seu]shadowlord,2032,0,0,1,1,0.0%,15m
39168,2,Tincanman,2031,686,24,35,59,40.7%,40m
39168,2,[Klekst]Ginxq,2031,298,11,18,29,37.9%,1h
39168,2,LARGEHADRON,2031,278,9,19,28,32.1%,34m
39168,2,Geniy,2031,206,6,7,13,46.2%,7m
39168,3,[OGiK]AlexAnal,2031,209,5,7,12,41.7%,1h
39168,3,Egoist,2031,58,3,2,5,60.0%,9m
39168,3,Aytal,2031,60,3,12,15,20.0%,42m
39168,3,ZerO,2031,30,2,0,2,100.0%,37m
39168,3,[BWArmy]IIIIIIII,2031,0,2,3,5,40.0%,3m
39168,3,Lixus,2031,88,1,5,6,16.7%,47m
39178,1,tournevis,2030,983,63,66,129,48.8%,14m
39178,2,TheHellGeek,2030,1005,38,47,85,44.7%,44m
39178,3,alexvey,2030,705,29,12,41,70.7%,5m
39178,2,Krubel,2030,295,24,26,50,48.0%,11m
39178,2,Taleo,2030,238,9,11,20,45.0%,55m
39178,2,Bonum,2030,172,5,7,12,41.7%,7m
39178,1,[ExTr1m]BlackSnayper,2030,40,4,6,10,40.0%,57m
39178,3,Ananas,2030,58,2,2,4,50.0%,8m
39178,2,Jamie,2030,0,1,5,6,16.7%,39m
39178,1,DanTan,2030,30,1,5,6,16.7%,12m
39178,2,CEKI,2030,0,1,7,8,12.5%,42m
39178,3,[SIRUS]Derling,2030,0,1,9,10,10.0%,47m
39190,2,kazak,2029,1382,52,51,103,50.5%,5m
39190,2,FlaWar,2029,710,28,28,56,50.0%,50m
39190,1,ghostPL,2029,0,1,1,2,50.0%,47m
39190,1,GildAragorn,2029,48,1,9,10,10.0%,43m
39190,3,nekotrap,2029,0,0,2,2,0.0%,41m
39190,3,[LMquee]LMqueen,2029,0,0,2,2,0.0%,35m
39190,2,Thrawn,2029,0,0,3,3,0.0%,51m
39197,1,edincer,2028,1367,47,66,113,41.6%,48m
39197,2,KatopaktA,2028,189,3,10,13,23.1%,3m
39197,2,slupsky,2028,30,2,5,7,28.6%,1h
39197,2,PorpoiseXQ,2028,108,2,7,9,22.2%,1h
39197,3,Käsus,2028,0,1,0,1,100.0%,38m
39197,3,SoothSlayer,2028,97,1,2,3,33.3%,1h
39197,3,Fenrir,2028,0,0,1,1,0.0%,12m
39197,2,CycloCross,2028,0,0,6,6,0.0%,12m
39197,2,[RBlood]ChenZen,2028,0,0,6,6,0.0%,55m
39206,2,Ramzie,2027,636,25,28,53,47.2%,8m
39206,2,Berett,2027,623,24,25,49,49.0%,1h
39206,2,[Zyxl]Optimator,2027,318,17,23,40,42.5%,10m
39206,2,ker,2027,374,12,15,27,44.4%,55m
39206,1,Rain,2027,337,12,24,36,33.3%,52m
39206,1,skilgannon,2027,331,9,16,25,36.0%,12m
39206,2,Chris,2027,175,5,14,19,26.3%,56m
39206,3,Seirou,2027,42,2,2,4,50.0%,8m
39206,2,WildOstin,2027,0,2,4,6,33.3%,53m
39206,3,Dogwar,2027,30,1,4,5,20.0%,12m
39206,3,DarkAngel,2027,0,0,1,1,0.0%,11m
39206,3,Doner,2027,0,0,1,1,0.0%,6m
39206,2,[opol]Ordeith,2027,0,0,2,2,0.0%,33m
39206,3,[SSquаd]ghch,2027,0,0,5,5,0.0%,9m
39220,2,Dziker,2026,1562,98,104,202,48.5%,56m
39220,3,Aurèle,2026,1026,39,44,83,47.0%,38m
39220,2,ToriK,2026,462,15,26,41,36.6%,8m
39220,3,slashLEE,2026,185,5,2,7,71.4%,34m
39220,3,[Zhig]VICTOR,2026,120,4,0,4,100.0%,55m
39220,3,LolDom,2026,149,3,4,7,42.9%,1h
39220,2,GhGiov,2026,60,2,7,9,22.2%,1h
39220,2,DarkVoid,2026,44,1,5,6,16.7%,56m
39220,1,MisioX,2026,0,0,1,1,0.0%,1h
39220,3,Евгений,2026,0,0,6,6,0.0%,1h
39230,2,Александр,2025,1495,57,67,124,46.0%,1h
39230,2,[MASTOR]ThelwKrepes,2025,314,14,17,31,45.2%,12m
39230,2,BomBar,2025,211,11,8,19,57.9%,1h
39230,1,[Y3БАН]kirlan,2025,166,5,8,13,38.5%,1h
39230,1,ProgramFiles,2025,172,5,12,17,29.4%,59m
39230,3,AlexRo,2025,90,4,4,8,50.0%,1h
39230,2,BarbaroR,2025,62,3,9,12,25.0%,1h
39230,2,IIIIIIIIIIII,2025,0,1,1,2,50.0%,34m
39230,2,[Tblue]Mateboer,2025,0,0,1,1,0.0%,1h
39239,2,Alto,2024,771,50,45,95,52.6%,1h
39239,2,Frederick,2024,453,23,26,49,46.9%,46m
39239,2,qpax,2024,420,15,22,37,40.5%,10m
39239,2,[scvvcs]nautilus,2024,0,1,7,8,12.5%,36m
39243,3,ГАЛСТАРКРАФ,2023,1398,80,88,168,47.6%,47m
39243,3,Nekros,2023,868,33,38,71,46.5%,1h
39243,3,peguska,2023,658,25,21,46,54.3%,9m
39243,2,Atar,2023,449,18,26,44,40.9%,10m
39243,3,Crawler,2023,90,3,5,8,37.5%,1h
39243,1,ruton,2023,90,3,12,15,20.0%,14m
39243,2,[AntLYF]Royal,2023,90,2,2,4,50.0%,51m
39243,3,[J4E]Machtiern,2023,0,1,0,1,100.0%,39m
39243,1,[MrLord]вак,2023,48,1,4,5,20.0%,51m
39252,2,kuznec,2022,673,24,35,59,40.7%,10m
39252,2,Malmas,2022,144,6,6,12,50.0%,42m
39252,3,[MSNTRP]Hexos,2022,114,5,2,7,71.4%,45m
39252,2,[NoVin]Vakidos,2022,46,2,3,5,40.0%,8m
39252,3,maximepmr,2022,0,2,4,6,33.3%,11m
39252,2,[HidraG]SargentoJr,2022,92,2,7,9,22.2%,30m
39252,1,DonCosciotte,2022,0,1,2,3,33.3%,3m
39252,3,Winsitoo,2022,0,1,4,5,20.0%,44m
39252,3,[Betr]Akuserarēta,2022,0,0,1,1,0.0%,1h
39252,1,Slairak,2022,0,0,4,4,0.0%,31m
39252,3,Mkive,2022,0,0,6,6,0.0%,1h
39263,2,younes,2021,636,25,28,53,47.2%,10m
39263,2,РОСТОВ,2021,367,11,16,27,40.7%,1h
39263,3,Отчаяный,2021,238,8,9,17,47.1%,1h
39263,1,[RTBN]inviction,2021,328,7,16,23,30.4%,1h
39263,2,BlackDevill,2021,86,3,9,12,25.0%,29m
39263,3,GoLdsWiM,2021,0,1,0,1,100.0%,40m
39263,3,MPaK,2021,0,1,0,1,100.0%,53m
39263,3,[NTD]Daniel,2021,0,1,4,5,20.0%,1h
39263,2,Chyvak,2021,0,1,6,7,14.3%,36m
39263,3,АРТ,2021,0,0,5,5,0.0%,7m
39263,3,Swarley,2021,0,0,5,5,0.0%,45m
39274,1,RamsesII,2020,214,5,13,18,27.8%,56m
39274,3,broc,2020,44,2,1,3,66.7%,1h
39274,2,King,2020,46,2,9,11,18.2%,1h
39274,2,GhostOfNapA,2020,93,1,7,8,12.5%,56m
39274,1,bombergamer,2020,0,1,8,9,11.1%,51m
39274,2,Arbot,2020,0,0,1,1,0.0%,1h
39274,3,Crackerrrs,2020,0,0,1,1,0.0%,28m
39274,1,nono,2020,0,0,3,3,0.0%,47m
39282,2,OMGClayAiken,2019,867,107,114,221,48.4%,37m
39282,2,LOPUH,2019,388,13,15,28,46.4%,13m
39282,3,cazeg,2019,252,10,16,26,38.5%,11m
39282,3,ToPiK,2019,270,9,16,25,36.0%,1h
39282,2,svintus,2019,130,6,8,14,42.9%,59m
39282,3,AnDroksus,2019,60,3,3,6,50.0%,15m
39282,2,BunkerWolf,2019,114,3,5,8,37.5%,60m
39282,3,Swarogearth,2019,74,2,3,5,40.0%,1h
39282,1,ADEPT,2019,0,1,0,1,100.0%,1h
39282,1,Nataly,2019,0,1,7,8,12.5%,59m
39282,3,Raptus,2019,0,0,1,1,0.0%,47m
39282,3,missC,2019,0,0,1,1,0.0%,28m
39282,2,Enest,2019,0,0,3,3,0.0%,30m
39282,3,[Corbi]Eracle,2019,0,0,5,5,0.0%,35m
39296,2,[Katzen]Mätti,2018,1537,91,87,178,51.1%,46m
39296,3,WİLDWolf,2018,472,15,24,39,38.5%,1h
39296,3,DuendeVerde,2018,96,5,16,21,23.8%,51m
39296,2,Despair,2018,134,3,5,8,37.5%,56m
39296,2,Rodger,2018,58,3,8,11,27.3%,1h
39296,3,BORTOLO,2018,30,3,13,16,18.8%,1h
39296,3,darklink,2018,0,0,1,1,0.0%,12m
39296,2,[plCake]GumaZ,2018,0,0,7,7,0.0%,48m
39304,3,Luxun,2017,1227,46,54,100,46.0%,1h
39304,2,Libertarian,2017,1195,44,47,91,48.4%,1h
39304,2,jake,2017,234,9,11,20,45.0%,48m
39304,1,WujekTomek,2017,349,8,12,20,40.0%,53m
39304,2,[Sc2V]joaquin,2017,156,6,13,19,31.6%,1h
39304,2,[SeVenV]Mengsk,2017,126,5,12,17,29.4%,1h
39304,3,Cronos,2017,88,3,4,7,42.9%,38m
39304,3,cozhywarf,2017,0,1,0,1,100.0%,34m
39304,3,[SMSM]DanyTv,2017,42,1,3,4,25.0%,1h
39304,2,[ANREN]про,2017,0,0,2,2,0.0%,60m
39304,3,Lam,2017,0,0,5,5,0.0%,1h
39304,2,[MGME]KappaClappa,2017,0,0,5,5,0.0%,33m
39304,3,PLaytOster,2017,0,0,5,5,0.0%,1h
39304,3,lyckegard,2017,0,0,5,5,0.0%,34m
39304,2,Qubutus,2017,0,0,6,6,0.0%,29m
39319,3,Zorag,2016,569,19,17,36,52.8%,34m
39319,3,chery,2016,284,11,21,32,34.4%,40m
39319,2,ivan,2016,246,8,11,19,42.1%,6m
39319,2,Feniks,2016,184,6,10,16,37.5%,1h
39319,2,[GDZg]KOJIbIBAH,2016,149,6,11,17,35.3%,1h
39319,3,GrumpyPants,2016,30,2,0,2,100.0%,60m
39319,3,SuperMan,2016,62,2,5,7,28.6%,55m
39319,3,Кексик,2016,122,2,5,7,28.6%,1h
39319,2,[SomSob]Séodoa,2016,0,0,1,1,0.0%,1h
39319,3,DRONOXXX,2016,0,0,1,1,0.0%,11m
39319,3,Laci,2016,0,0,2,2,0.0%,1h
39330,3,moonhide,2015,883,34,41,75,45.3%,5m
39330,3,Toothless,2015,653,24,33,57,42.1%,45m
39330,2,Pinkelephant,2015,250,8,16,24,33.3%,1h
39330,1,Greenfald,2015,226,7,13,20,35.0%,43m
39330,2,paulus,2015,121,3,3,6,50.0%,9m
39330,2,KyleKtan,2015,64,3,7,10,30.0%,1h
39330,2,enj,2015,119,3,7,10,30.0%,1h
39330,1,Masina,2015,48,3,11,14,21.4%,12m
39330,1,[6077]SkinnyZerg,2015,30,2,8,10,20.0%,1h
39330,3,stom,2015,0,1,0,1,100.0%,38m
39330,3,UrkeBoss,2015,0,0,1,1,0.0%,8m
39341,3,SalmonSushi,2014,454,15,18,33,45.5%,15m
39341,3,Iain,2014,195,6,6,12,50.0%,39m
39341,3,NazGul,2014,98,4,2,6,66.7%,1h
39341,2,даска,2014,84,3,1,4,75.0%,1h
39341,2,Wolf,2014,140,2,5,7,28.6%,1h
39341,3,monstoide,2014,0,1,0,1,100.0%,28m
39341,2,goga,2014,0,1,2,3,33.3%,55m
39341,1,hohlenuss,2014,0,1,7,8,12.5%,57m
39341,3,Nykterstein,2014,0,0,2,2,0.0%,34m
39341,2,Next,2014,0,0,2,2,0.0%,10m
39341,2,ROD,2014,0,0,3,3,0.0%,1h
39341,3,MaffinMan,2014,0,0,3,3,0.0%,13m
39341,2,thekiller,2014,0,0,6,6,0.0%,30m
39354,2,rauchgal,2013,1108,43,57,100,43.0%,31m
39354,2,Sharos,2013,673,24,34,58,41.4%,1h
39354,3,Strider,2013,561,20,23,43,46.5%,34m
39354,3,GangAji,2013,330,13,15,28,46.4%,37m
39354,2,drakshadow,2013,258,9,12,21,42.9%,1h
39354,1,CoolFlame,2013,0,4,4,8,50.0%,42m
39354,2,shosh,2013,133,3,9,12,25.0%,9m
39354,3,SvantE,2013,0,1,4,5,20.0%,1h
39354,3,Donatello,2013,0,0,5,5,0.0%,8m
39354,3,TooEZ,2013,0,0,5,5,0.0%,1h
39364,3,thePlankfish,2012,430,16,18,34,47.1%,5m
39364,1,Michaelbx,2012,215,6,7,13,46.2%,40m
39364,2,Trey,2012,128,4,12,16,25.0%,51m
39364,3,Fox,2012,70,3,3,6,50.0%,9m
39364,3,THOR,2012,30,2,0,2,100.0%,1h
39364,3,MadDOG,2012,0,2,3,5,40.0%,1h
39364,3,JulleTheMan,2012,0,2,5,7,28.6%,52m
39364,2,darioyannis,2012,92,1,2,3,33.3%,10m
39364,3,thanos,2012,30,1,4,5,20.0%,42m
39364,3,Define,2012,36,1,7,8,12.5%,1h
39374,2,RAW,2011,607,25,24,49,51.0%,9m
39374,2,SCGod,2011,644,23,32,55,41.8%,8m
39374,3,Belcka,2011,298,10,17,27,37.0%,39m
39374,3,ROCKETxSPUDZ,2011,242,8,7,15,53.3%,1h
39374,2,Kupson,2011,119,2,8,10,20.0%,31m
39374,3,Whoik,2011,0,1,1,2,50.0%,60m
39374,3,Zelektt,2011,97,1,2,3,33.3%,34m
39374,3,juju,2011,0,0,3,3,0.0%,47m
39374,2,[PompaE]stwr,2011,0,0,3,3,0.0%,51m
39383,3,HajimeZ,2010,505,17,25,42,40.5%,1h
39383,2,Fish,2010,197,5,11,16,31.2%,9m
39383,3,Slajmo,2010,127,4,12,16,25.0%,1h
39383,3,ValliriusACV,2010,30,2,2,4,50.0%,46m
39383,1,[R4Time]Alisher,2010,92,2,3,5,40.0%,60m
39383,3,Linebeck,2010,0,1,0,1,100.0%,38m
39383,3,ToMoS,2010,0,0,1,1,0.0%,8m
39390,2,FENIX,2009,1474,61,61,122,50.0%,4m
39390,3,Dante,2009,284,16,11,27,59.3%,6m
39390,2,Guilty,2009,466,16,27,43,37.2%,55m
39390,3,Frodog,2009,284,11,15,26,42.3%,55m
39390,2,BaloskiBarbi,2009,220,7,17,24,29.2%,37m
39390,1,Solar,2009,262,7,19,26,26.9%,39m
39390,2,Awink,2009,88,2,5,7,28.6%,57m
39390,2,[13g12p]brny,2009,0,1,0,1,100.0%,53m
39390,3,Oxer,2009,0,0,1,1,0.0%,37m
39390,3,Konkord,2009,0,0,2,2,0.0%,1h
39390,3,Elfeda,2009,0,0,6,6,0.0%,37m
39390,2,[FmGr]DimSun,2009,0,0,8,8,0.0%,60m
39402,3,Vila,2008,401,39,41,80,48.8%,12m
39402,3,RenoJoggson,2008,310,10,10,20,50.0%,1h
39402,3,Feri,2008,172,7,10,17,41.2%,37m
39402,1,[IRK138]Danilka,2008,252,6,8,14,42.9%,47m
39402,3,Jason,2008,120,5,4,9,55.6%,52m
39402,3,Noobling,2008,86,5,13,18,27.8%,54m
39402,1,Jeff,2008,96,3,8,11,27.3%,43m
39402,3,[kill2u]Jimiasty,2008,0,2,4,6,33.3%,1h
39402,2,Legion,2008,0,1,1,2,50.0%,51m
39411,2,[PCAS]Brutalage,2007,1180,51,57,108,47.2%,1h
39411,3,maks,2007,468,17,26,43,39.5%,41m
39411,1,Woplex,2007,44,2,9,11,18.2%,1h
39411,3,[кроссы]Riddie,2007,0,0,1,1,0.0%,54m
39411,3,джокер,2007,0,0,6,6,0.0%,46m
39416,2,langenpg,2006,476,18,22,40,45.0%,1h
39416,3,RedPikachu,2006,503,16,27,43,37.2%,54m
39416,1,Nagash,2006,310,11,0,11,100.0%,31m
39416,2,Greh,2006,317,10,21,31,32.3%,1h
39416,1,Hatiman,2006,273,6,11,17,35.3%,40m
39416,2,[БИЗНЕС]Фатонщик,2006,118,5,10,15,33.3%,1h
39416,1,SirOboldui,2006,89,3,6,9,33.3%,42m
39416,2,GrEEdy,2006,44,2,2,4,50.0%,7m
39416,2,arneconcarne,2006,0,1,8,9,11.1%,54m
39416,3,pchamrower,2006,0,0,1,1,0.0%,1h
39416,3,André,2006,0,0,1,1,0.0%,1h
39427,2,MiniNinja,2005,380,13,20,33,39.4%,39m
39427,3,Raphy,2005,298,11,16,27,40.7%,3m
39427,3,Sid,2005,232,8,12,20,40.0%,12m
39427,2,[JCLM]Daweed,2005,256,7,10,17,41.2%,60m
39427,3,licaon,2005,30,1,1,2,50.0%,40m
39432,3,Hicks,2004,899,31,39,70,44.3%,58m
39432,2,Thamkrabok,2004,583,23,26,49,46.9%,58m
39432,3,AIDYN,2004,475,18,21,39,46.2%,57m
39432,3,[StTm]quasar,2004,460,17,13,30,56.7%,5m
39432,3,volk,2004,425,15,13,28,53.6%,39m
39432,3,kuzima,2004,333,12,13,25,48.0%,60m
39432,1,kto,2004,86,3,15,18,16.7%,59m
39432,3,OLEG,2004,30,2,2,4,50.0%,45m
39432,3,Заяц,2004,0,1,0,1,100.0%,3m
39432,3,FunkeyLP,2004,91,1,5,6,16.7%,11m
39432,3,dawidos,2004,0,0,1,1,0.0%,34m
39432,3,Vicci,2004,0,0,2,2,0.0%,29m
39432,3,Petteroni,2004,0,0,3,3,0.0%,6m
39432,3,Лывпиу,2004,0,0,6,6,0.0%,1h
39446,3,lilas,2003,209,8,2,10,80.0%,43m
39446,2,[vlast]MickeyMouse,2003,193,7,7,14,50.0%,37m
39446,3,Stego,2003,207,6,12,18,33.3%,60m
39446,3,mikitoni,2003,0,1,1,2,50.0%,30m
39446,3,dangernk,2003,0,0,1,1,0.0%,1h
39446,3,happy,2003,0,0,2,2,0.0%,46m
39452,2,ini,2002,710,27,30,57,47.4%,41m
39452,2,[50k4]surastasi,2002,408,13,19,32,40.6%,56m
39452,3,DENERGAR,2002,175,5,13,18,27.8%,35m
39452,3,AkuryoSama,2002,60,2,3,5,40.0%,45m
39452,2,Paladinu,2002,90,2,5,7,28.6%,9m
39452,2,Павлуха,2002,64,2,9,11,18.2%,12m
39452,3,Фартовый,2002,0,1,4,5,20.0%,3m
39452,1,Tosh,2002,30,1,9,10,10.0%,1h
39452,3,Reaper,2002,0,0,1,1,0.0%,12m
39452,3,Katerina,2002,0,0,1,1,0.0%,38m
39452,2,Andreyfort,2002,0,0,1,1,0.0%,30m
39452,3,LIrpOON,2002,0,0,2,2,0.0%,1h
39452,1,Fantom,2002,0,0,2,2,0.0%,43m
39452,3,Xygar,2002,0,0,4,4,0.0%,1h
39466,2,[45IQ]DRED,2001,1308,46,61,107,43.0%,37m
39466,3,Mithradtes,2001,402,32,27,59,54.2%,1h
39466,3,Rargcretch,2001,662,22,33,55,40.0%,1h
39466,3,rip,2001,190,6,7,13,46.2%,1h
39466,2,Paltose,2001,118,4,9,13,30.8%,55m
39466,3,Mega,2001,147,3,2,5,60.0%,1h
39466,3,MarshalCole,2001,88,3,3,6,50.0%,34m
39466,2,Appelsiini,2001,0,3,3,6,50.0%,1h
39466,2,xXxTurboxXx,2001,95,1,8,9,11.1%,1h
39466,3,Nikopol,2001,0,0,1,1,0.0%,55m
39466,3,Wizard,2001,0,0,1,1,0.0%,1h
39477,3,Gemaechtmann,2000,310,10,7,17,58.8%,34m
39477,1,Thor,2000,272,9,20,29,31.0%,42m
39477,1,tonetillo,2000,152,7,11,18,38.9%,44m
39477,2,Potoropis,2000,0,1,0,1,100.0%,47m
39477,3,NoUpgrades,2000,0,0,1,1,0.0%,53m
39477,3,Dracogus,2000,0,0,5,5,0.0%,3m
39483,2,Mario,1999,638,50,50,100,50.0%,13m
39483,2,Faktor,1999,356,13,19,32,40.6%,1h
39483,3,blacksheep,1999,176,6,8,14,42.9%,1h
39483,3,Phaezion,1999,88,4,4,8,50.0%,11m
39483,3,[PNC]Drufus,1999,58,2,2,4,50.0%,8m
39483,2,ВасилийНикон,1999,92,1,2,3,33.3%,1h
39483,3,[STDES]Krucjata,1999,0,0,1,1,0.0%,15m
39483,3,max,1999,0,0,1,1,0.0%,12m
39483,2,ANTON,1999,0,0,4,4,0.0%,10m
39492,3,Filip,1998,1259,44,53,97,45.4%,54m
39492,3,BladyMery,1998,362,13,12,25,52.0%,53m
39492,3,Viper,1998,162,4,4,8,50.0%,1h
39492,3,ELPATOPATOSO,1998,30,1,2,3,33.3%,1h
39492,2,ЧайИЗZилота,1998,12,1,3,4,25.0%,33m
39492,3,WildChessRu,1998,0,1,3,4,25.0%,38m
39492,3,racok,1998,0,1,5,6,16.7%,1h
39492,3,CaptainFars,1998,30,1,5,6,16.7%,12m
39492,3,FarmerDog,1998,0,0,6,6,0.0%,1h
39501,2,HUURRRE,1997,1573,267,288,555,48.1%,36m
39501,3,Mads,1997,347,12,18,30,40.0%,51m
39501,2,Furrig,1997,130,4,11,15,26.7%,55m
39501,3,SINTAXSYS,1997,0,2,3,5,40.0%,55m
39501,1,Melorka,1997,0,0,1,1,0.0%,56m
39501,3,IIIIIIIIIIII,1997,0,0,1,1,0.0%,12m
39501,3,[OvmpO]Vedovonero,1997,0,0,2,2,0.0%,55m
39501,3,[1NFEC7]caillou,1997,0,0,2,2,0.0%,55m
39501,3,Paweł,1997,0,0,5,5,0.0%,1h
39510,2,renato,1996,1270,70,82,152,46.1%,29m
39510,2,Zpapa,1996,1134,52,58,110,47.3%,51m
39510,3,Mepulsor,1996,38,3,6,9,33.3%,9m
39510,3,Drfinch,1996,0,2,3,5,40.0%,1h
39510,3,SilverFox,1996,58,2,3,5,40.0%,8m
39510,2,КлодунДруид,1996,79,2,4,6,33.3%,13m
39510,3,[КРН]Prometheus,1996,42,1,2,3,33.3%,58m
39510,3,Advokate,1996,0,1,3,4,25.0%,1h
39510,3,OnLink,1996,0,0,2,2,0.0%,30m
39519,1,Crude,1995,1343,50,58,108,46.3%,41m
39519,1,Friendly,1995,1118,45,55,100,45.0%,54m
39519,3,LuxAeterna,1995,972,36,39,75,48.0%,39m
39519,3,bananaboi,1995,737,29,28,57,50.9%,9m
39519,2,zelg,1995,630,22,34,56,39.3%,4m
39519,3,Chazz,1995,305,13,15,28,46.4%,58m
39519,2,Suprovský,1995,285,13,16,29,44.8%,11m
39519,2,Fardok,1995,38,4,5,9,44.4%,47m
39519,2,SmOkeSOme,1995,124,4,12,16,25.0%,55m
39519,3,COUSIIL,1995,0,2,3,5,40.0%,29m
39519,2,Leonard,1995,90,2,5,7,28.6%,48m
39519,3,Hunter,1995,36,2,5,7,28.6%,55m
39519,2,BossFi,1995,60,2,9,11,18.2%,14m
39519,1,Agrotos,1995,48,2,10,12,16.7%,58m
39519,1,Alcarent,1995,0,1,1,2,50.0%,1h
39519,2,[ПИCYN]MihanySEX,1995,0,0,1,1,0.0%,1h
39519,3,Vladimir,1995,0,0,3,3,0.0%,1h
39519,3,Simulation,1995,0,0,5,5,0.0%,55m
39537,2,Phoenix,1994,472,19,22,41,46.3%,13m
39537,2,Olycka,1994,526,17,30,47,36.2%,1h
39537,3,[OSgZ]Kiliman,1994,147,3,4,7,42.9%,1h
39537,1,[MIIM]SpookyM,1994,0,0,6,6,0.0%,48m
39541,3,mrilyn,1993,1415,80,98,178,44.9%,8m
39541,2,Aeterƞǣ,1993,1195,43,49,92,46.7%,29m
39541,3,Panimoni,1993,1105,40,53,93,43.0%,60m
39541,2,Craisedx,1993,530,21,22,43,48.8%,53m
39541,2,Jenda,1993,150,5,14,19,26.3%,58m
39541,3,Евгений,1993,90,4,7,11,36.4%,1h
39541,1,Washborn,1993,186,3,7,10,30.0%,45m
39541,2,Probious,1993,91,2,6,8,25.0%,36m
39541,3,Follox,1993,30,1,2,3,33.3%,1h
39550,3,Ardreg,1992,640,26,20,46,56.5%,1h
39550,3,likemzc,1992,572,21,18,39,53.8%,40m
39550,1,Тролль,1992,217,6,14,20,30.0%,43m
39550,2,Fear,1992,120,4,10,14,28.6%,3m
39550,3,frugele,1992,36,2,6,8,25.0%,40m
39555,2,Cthulhu,1991,343,11,19,30,36.7%,1h
39555,2,Gaboniasty,1991,183,6,14,20,30.0%,55m
39555,3,Cmertdemonam,1991,118,5,2,7,71.4%,37m
39555,2,Alex,1991,139,4,10,14,28.6%,1h
39555,2,llllllllllll,1991,30,2,8,10,20.0%,60m
39555,3,vetpeter,1991,90,1,3,4,25.0%,1h
39555,3,[BUND]WorkerRash,1991,0,0,1,1,0.0%,34m
39555,3,happyMomo,1991,0,0,1,1,0.0%,1h
39563,1,Jaroslav,1990,980,33,52,85,38.8%,41m
39563,2,Cyprine,1990,457,17,18,35,48.6%,4m
39563,1,Стуков,1990,337,13,21,34,38.2%,54m
39563,2,metalika,1990,328,10,16,26,38.5%,55m
39563,3,PlayBeagle,1990,166,9,3,12,75.0%,1h
39563,1,Pylot,1990,221,8,15,23,34.8%,47m
39563,2,Мастик,1990,139,2,3,5,40.0%,60m
39563,2,Solaire,1990,130,2,4,6,33.3%,30m
39563,3,joker,1990,30,1,4,5,20.0%,1h
39563,3,Mamka,1990,0,1,5,6,16.7%,53m
39563,3,[DnD101]DnDmelan,1990,30,1,7,8,12.5%,1h
39563,1,gringio,1990,0,0,1,1,0.0%,47m
39563,1,Xardur,1990,0,0,6,6,0.0%,33m
39576,1,[LE4VE]anorganic,1989,1117,44,63,107,41.1%,60m
39576,3,SPQR,1989,567,31,20,51,60.8%,1h
39576,2,[IntCC]Nic,1989,604,22,23,45,48.9%,1h
39576,2,Hollowex,1989,276,10,14,24,41.7%,5m
39576,2,bratwurst,1989,165,4,9,13,30.8%,56m
39576,3,Balla,1989,120,2,1,3,66.7%,51m
39576,3,[Wurm]HeurKl,1989,25,1,2,3,33.3%,53m
39583,3,CLOUD,1988,380,14,17,31,45.2%,40m
39583,3,georgelord,1988,199,6,3,9,66.7%,11m
39583,2,cigaHckiy,1988,167,5,7,12,41.7%,1h
39583,2,Ammarak,1988,212,4,8,12,33.3%,33m
39583,2,Kłapouchy,1988,58,3,8,11,27.3%,57m
39583,3,[N1TDA]Riyaiky,1988,30,1,2,3,33.3%,1h
39583,2,[JaPP]jeleyka,1988,38,1,6,7,14.3%,13m
39583,3,silkr,1988,0,0,1,1,0.0%,44m
39583,3,warhammerlad,1988,0,0,1,1,0.0%,46m
39583,3,Wark,1988,0,0,6,6,0.0%,46m
39593,2,itsaruck,1987,1128,50,39,89,56.2%,30m
39593,3,SirTuDaBlee,1987,606,23,20,43,53.5%,1h
39593,3,Sedokiro,1987,328,11,4,15,73.3%,11m
39593,3,merlin,1987,358,11,11,22,50.0%,42m
39593,3,Light,1987,249,8,4,12,66.7%,29m
39593,3,FallenRaven,1987,0,2,2,4,50.0%,35m
39593,3,physicist,1987,0,1,0,1,100.0%,34m
39593,3,MisterED,1987,0,1,1,2,50.0%,1h
39593,3,KUBA,1987,0,0,1,1,0.0%,51m
39593,3,HaxingorTTV,1987,0,0,1,1,0.0%,1h
39593,3,KorowaNaHaip,1987,0,0,3,3,0.0%,9m
39593,2,АртёмБаг,1987,0,0,6,6,0.0%,6m
39605,3,EAWR,1986,708,25,30,55,45.5%,1h
39605,3,[proto3]denVENken,1986,606,24,18,42,57.1%,11m
39605,3,Fantom,1986,458,16,26,42,38.1%,40m
39605,2,Cieniu,1986,250,6,10,16,37.5%,8m
39605,2,КотКокос,1986,126,4,3,7,57.1%,60m
39605,2,[BandNa]YugenAssAss,1986,92,4,9,13,30.8%,30m
39605,2,tuladansleq,1986,128,3,10,13,23.1%,14m
39605,3,[10swrm]Callmehenry,1986,0,1,4,5,20.0%,1h
39605,3,zerg,1986,30,1,6,7,14.3%,5m
39605,3,enternet,1986,0,1,10,11,9.1%,1h
39605,3,FlynnTaggart,1986,0,0,1,1,0.0%,58m
39605,2,MTC,1986,0,0,1,1,0.0%,57m
39617,3,darkknight,1985,991,40,41,81,49.4%,35m
39617,2,eljay,1985,321,17,24,41,41.5%,47m
39617,1,MACK,1985,236,8,13,21,38.1%,40m
39617,1,joseisamurai,1985,239,4,9,13,30.8%,14m
39617,2,llllllllllll,1985,122,2,3,5,40.0%,8m
39617,3,[SC2SA]BlayiD,1985,96,2,4,6,33.3%,1h
39617,3,jefe,1985,30,2,5,7,28.6%,40m
39617,1,[HBGG]TheSwarm,1985,48,2,10,12,16.7%,44m
39617,3,[BierG]MainRANDOM,1985,0,1,1,2,50.0%,40m
39617,3,Dyps,1985,0,0,4,4,0.0%,55m
39617,3,adato,1985,0,0,4,4,0.0%,8m
39617,3,Spiro,1985,0,0,4,4,0.0%,1h
39617,3,Maicce,1985,0,0,5,5,0.0%,14m
39630,3,Agoraht,1984,1376,56,59,115,48.7%,1h
39630,3,slayp,1984,338,12,14,26,46.2%,1h
39630,3,[ADM]marc,1984,214,10,19,29,34.5%,1h
39630,3,CPTNiJo,1984,251,8,10,18,44.4%,1h
39630,3,Ant,1984,123,7,2,9,77.8%,55m
39630,3,[ganten]Felix,1984,166,7,4,11,63.6%,55m
39630,3,joker,1984,144,4,2,6,66.7%,1h
39630,2,EpicComeBack,1984,157,4,3,7,57.1%,49m
39630,3,UAdeDI,1984,144,4,5,9,44.4%,1h
39630,1,RilloX,1984,142,3,13,16,18.8%,7m
39630,2,[telka]telka,1984,133,2,4,6,33.3%,48m
39630,3,DedBulachnik,1984,30,1,1,2,50.0%,8m
39630,3,[Mo47]SIBBI,1984,95,1,6,7,14.3%,1h
39630,3,Arsek,1984,0,0,3,3,0.0%,40m
39644,3,barbiQ,1983,656,38,45,83,45.8%,37m
39644,3,ReXire,1983,374,14,13,27,51.9%,48m
39644,3,TumanZ,1983,259,10,10,20,50.0%,29m
39644,3,[TeUn]Gabriel,1983,86,6,4,10,60.0%,41m
39644,1,Laur,1983,142,3,10,13,23.1%,48m
39644,3,[Sepuku]ЯКРУТ,1983,0,0,1,1,0.0%,1h
39644,2,Darlon,1983,0,0,6,6,0.0%,50m
39651,1,Tempest,1982,1589,124,146,270,45.9%,1h
39651,3,Guinik,1982,432,16,21,37,43.2%,38m
39651,3,HardProk,1982,224,9,7,16,56.2%,55m
39651,3,zerzilot,1982,78,3,4,7,42.9%,1h
39651,1,LTōgarashi,1982,142,3,6,9,33.3%,14m
39651,3,Stas,1982,0,2,3,5,40.0%,45m
39651,3,zeratul,1982,0,2,3,5,40.0%,1h
39651,2,[1GROM2]GzuzMaxwell,1982,0,1,8,9,11.1%,9m
39651,3,Артас,1982,0,0,1,1,0.0%,40m
39651,3,[DTCz]altéra,1982,0,0,2,2,0.0%,40m
39651,3,Rus,1982,0,0,2,2,0.0%,1h
39651,3,Kinte,1982,0,0,2,2,0.0%,35m
39663,3,Danrik,1981,721,31,26,57,54.4%,7m
39663,3,gen,1981,201,7,14,21,33.3%,53m
39663,3,[I12DR]FilypW,1981,168,4,1,5,80.0%,5m
39663,3,Lenkon,1981,162,4,3,7,57.1%,58m
39663,3,HristoIX,1981,62,2,7,9,22.2%,1h
39663,3,cfpa,1981,30,1,2,3,33.3%,57m
39663,3,[лампа]DFR,1981,0,0,2,2,0.0%,53m
39663,3,Viper,1981,0,0,5,5,0.0%,1h
39663,3,Orquneaise,1981,0,0,6,6,0.0%,40m
39672,3,eljajuar,1980,216,8,9,17,47.1%,29m
39672,1,Sugarcult,1980,148,6,14,20,30.0%,1h
39672,2,FRIZua,1980,150,5,12,17,29.4%,51m
39672,3,Creepuxx,1980,168,4,2,6,66.7%,4m
39672,3,zionizos,1980,58,3,4,7,42.9%,29m
39672,3,Avagan,1980,0,1,5,6,16.7%,58m
39672,1,tagu,1980,0,0,1,1,0.0%,14m
39672,3,StarLord,1980,0,0,4,4,0.0%,12m
39672,3,Sunzy,1980,0,0,5,5,0.0%,15m
39672,3,Bbqer,1980,0,0,6,6,0.0%,8m
39672,2,UltimateToad,1980,0,0,7,7,0.0%,9m
39683,3,Kablys,1979,854,33,35,68,48.5%,7m
39683,2,Oribong,1979,632,22,31,53,41.5%,34m
39683,2,[GGZERG]BeshinyKot,1979,222,7,17,24,29.2%,1h
39683,3,IIIIIIIIIIII,1979,0,1,0,1,100.0%,1h
39683,3,AkemiDragon,1979,36,1,2,3,33.3%,53m
39683,3,inaneLikeMe,1979,0,0,1,1,0.0%,6m
39683,3,[SUDA]Alim,1979,0,0,1,1,0.0%,12m
39683,3,Hydro,1979,0,0,1,1,0.0%,35m
39683,1,Alex,1979,0,0,7,7,0.0%,52m
39692,2,Imbirek,1978,758,28,38,66,42.4%,4m
39692,3,RedFox,1978,528,20,17,37,54.1%,40m
39692,1,Wamp,1978,390,10,16,26,38.5%,40m
39692,3,AnGeJI,1978,0,1,2,3,33.3%,1h
39692,3,Farkas,1978,0,0,4,4,0.0%,53m
39697,1,preditar,1977,558,21,27,48,43.8%,1h
39697,3,FunnyGreenB,1977,192,8,6,14,57.1%,40m
39697,1,olasoyunzerg,1977,0,1,8,9,11.1%,40m
39697,3,Skykilla,1977,0,0,1,1,0.0%,40m
39701,1,[glhf20]Phil,1976,1379,53,65,118,44.9%,5m
39701,3,cheery,1976,90,4,4,8,50.0%,1h
39701,2,ogpaul,1976,0,3,4,7,42.9%,39m
39701,1,[1948]UCraiova,1976,0,0,1,1,0.0%,12m
39701,2,[DaFF]jody,1976,0,0,3,3,0.0%,46m
39706,3,Ayneks,1975,416,17,21,38,44.7%,1h
39706,1,DinorD,1975,358,11,18,29,37.9%,42m
39706,1,Pegasus,1975,96,4,14,18,22.2%,43m
39706,3,HOWLIN,1975,86,3,46,49,6.1%,22m
39706,3,Aurelian,1975,0,2,3,5,40.0%,1h
39706,3,[ZERGSC]eurchik,1975,0,1,0,1,100.0%,1h
39706,3,Xelloth,1975,0,1,0,1,100.0%,1h
39706,3,ArtemAlmaz,1975,0,0,6,6,0.0%,1h
39714,2,Servex,1974,225,6,10,16,37.5%,1h
39714,1,TripleM,1974,221,6,14,20,30.0%,43m
39714,2,pop,1974,48,1,4,5,20.0%,46m
39714,3,ZergSwarm,1974,0,1,10,11,9.1%,1h
39718,3,Misha,1973,717,38,49,87,43.7%,1h
39718,3,XENIX,1973,878,33,37,70,47.1%,1h
39718,3,KingOH,1973,276,11,14,25,44.0%,1h
39718,3,FuuCkinGNodY,1973,256,10,9,19,52.6%,45m
39718,1,PiratRoger,1973,351,7,16,23,30.4%,51m
39718,2,RooT,1973,0,1,8,9,11.1%,1h
39724,3,JadranKaMoso,1972,302,10,17,27,37.0%,34m
39724,3,[GBang]Ucciditore,1972,254,9,11,20,45.0%,12m
39724,3,Leo,1972,114,4,6,10,40.0%,1h
39724,3,[MaYa]TimeLord,1972,58,3,8,11,27.3%,53m
39724,2,Настя,1972,90,3,12,15,20.0%,1h
39724,2,sopilka,1972,0,0,7,7,0.0%,4m
39730,2,PsYkLpWn,1971,1011,48,52,100,48.0%,1h
39730,3,SADUTI,1971,508,18,19,37,48.6%,9m
39730,3,karapuz,1971,170,7,5,12,58.3%,15m
39730,3,[ANREN]Graf,1971,198,5,13,18,27.8%,55m
39730,2,BondEA,1971,216,5,14,19,26.3%,10m
39730,3,[isIMBА]StupidNoob,1971,202,5,16,21,23.8%,1h
39730,2,smokrasyzerg,1971,110,2,8,10,20.0%,51m
39730,3,DarkEthanX,1971,0,1,4,5,20.0%,4m
39730,3,Lanfear,1971,0,0,1,1,0.0%,52m
39730,3,ZATARIUS,1971,0,0,1,1,0.0%,42m
39730,3,frankie,1971,0,0,1,1,0.0%,7m
39730,3,MMAzerg,1971,0,0,1,1,0.0%,1h
39742,2,Genocvali,1970,1518,153,165,318,48.1%,37m
39742,2,nSortim,1970,904,37,49,86,43.0%,1h
39742,3,TSL,1970,475,35,41,76,46.1%,37m
39742,1,Serrql,1970,250,7,26,33,21.2%,50m
39742,1,Predator,1970,143,3,10,13,23.1%,34m
39742,3,Doudou,1970,0,1,1,2,50.0%,9m
39742,3,Azrial,1970,93,1,1,2,50.0%,39m
39742,3,[Un00bz]Azyryx,1970,30,1,2,3,33.3%,10m
39750,2,Wooshoo,1969,439,14,24,38,36.8%,50m
39750,3,MrPerfect,1969,76,7,6,13,53.8%,58m
39750,3,Ilativ,1969,0,1,3,4,25.0%,42m
39750,3,jujules,1969,0,0,1,1,0.0%,40m
39750,3,Moeruhasu,1969,0,0,2,2,0.0%,34m
39750,2,[RAT01]RatTanya,1969,0,0,3,3,0.0%,47m
39750,2,GGOUT,1969,0,0,6,6,0.0%,57m
39757,3,ghaze,1968,1598,123,134,257,47.9%,1h
39757,3,Uranhön,1968,266,9,12,21,42.9%,8m
39757,3,StreetKid,1968,261,8,5,13,61.5%,15m
39757,2,FROL,1968,102,5,10,15,33.3%,12m
39757,1,Волк,1968,237,4,9,13,30.8%,45m
39757,3,IIIIIIIIIIII,1968,151,4,9,13,30.8%,40m
39757,3,mordred,1968,88,3,3,6,50.0%,1h
39757,2,Egork,1968,128,3,6,9,33.3%,56m
39757,3,baruuk,1968,0,0,1,1,0.0%,8m
39757,3,sdgiks,1968,0,0,5,5,0.0%,1h
39767,3,ryblik,1967,332,12,11,23,52.2%,8m
39767,3,Brollux,1967,102,3,7,10,30.0%,37m
39767,3,MagicSfx,1967,90,3,8,11,27.3%,1h
39770,3,IvenTV,1966,474,31,30,61,50.8%,5m
39770,1,Funaky,1966,597,29,73,102,28.4%,6m
39770,3,nosferatu,1966,150,5,5,10,50.0%,49m
39770,3,Snuskprutt,1966,0,1,1,2,50.0%,1h
39770,3,plusmore,1966,0,0,1,1,0.0%,35m
39775,3,Orion,1965,533,20,20,40,50.0%,45m
39775,2,keinan,1965,514,20,25,45,44.4%,34m
39775,1,Lamer,1965,119,2,5,7,28.6%,1h
39775,2,[Mistik]Bartek,1965,80,2,11,13,15.4%,4m
39775,3,Muciek,1965,0,0,1,1,0.0%,1h
39780,3,LOLтакНельзя,1964,849,35,29,64,54.7%,5m
39780,3,КОТ,1964,402,14,10,24,58.3%,1h
39780,1,Leonidas,1964,288,11,18,29,37.9%,1h
39780,3,Cesareus,1964,189,6,1,7,85.7%,5m
39780,3,zoarengBZH,1964,0,1,0,1,100.0%,1h
39780,3,Айра,1964,0,0,1,1,0.0%,5m
39786,2,Hellscream,1963,1095,41,50,91,45.1%,1h
39786,2,MALAK,1963,735,33,39,72,45.8%,1h
39786,3,SnowZ,1963,335,11,10,21,52.4%,8m
39786,2,Ulukay,1963,255,10,12,22,45.5%,8m
39786,3,Olgon,1963,96,2,6,8,25.0%,1h
39786,1,Metamorf,1963,0,1,9,10,10.0%,14m
39786,2,DarkRanger,1963,0,0,1,1,0.0%,1h
39786,3,Devass,1963,0,0,1,1,0.0%,58m
39786,3,Bloodymare,1963,0,0,6,6,0.0%,34m
39795,3,Vendetta,1962,282,9,14,23,39.1%,1h
39795,3,[Ирбис]mdd,1962,226,6,11,17,35.3%,48m
39795,2,lolpeep,1962,169,5,6,11,45.5%,7m
39795,3,MULSHCHIKI,1962,62,3,2,5,60.0%,37m
39795,1,[IceCub]EГОР,1962,118,2,10,12,16.7%,32m
39795,3,[РусЭл]roboji,1962,0,1,1,2,50.0%,60m
39795,3,Deathspada,1962,0,0,1,1,0.0%,6m
39795,3,mrTimmy,1962,0,0,6,6,0.0%,1h
39803,3,Snapshot,1961,953,41,39,80,51.2%,1h
39803,3,Valou,1961,437,15,19,34,44.1%,48m
39803,2,bob,1961,92,1,4,5,20.0%,34m
39806,3,[gairt]Gainullin,1960,485,19,12,31,61.3%,49m
39806,3,SeriousJoker,1960,289,18,20,38,47.4%,40m
39806,2,[FR1]benyboy,1960,378,15,14,29,51.7%,8m
39806,3,alma,1960,248,8,12,20,40.0%,1h
39806,2,Deon,1960,149,4,12,16,25.0%,5m
39806,3,Twitch,1960,64,3,4,7,42.9%,55m
39806,2,Mannfort,1960,90,1,3,4,25.0%,10m
39813,1,Masachristus,1959,939,42,56,98,42.9%,54m
39813,3,[starBf]Bofa,1959,30,1,2,3,33.3%,1h
39813,3,Hargard,1959,0,0,5,5,0.0%,60m
39813,3,NantX,1959,0,0,7,7,0.0%,55m
39817,2,unDeaD,1958,1324,88,110,198,44.4%,13m
39817,3,Keto,1958,1553,85,86,171,49.7%,1h
39817,3,Pest,1958,334,13,16,29,44.8%,1h
39817,3,Flouk,1958,32,2,5,7,28.6%,1h
39817,2,[6House]Dagoth,1958,0,1,3,4,25.0%,13m
39822,3,Misanthrop,1957,332,14,23,37,37.8%,49m
39822,3,[GSSC]BriggsY,1957,86,8,2,10,80.0%,4m
39822,2,Tyran,1957,96,5,15,20,25.0%,8m
39822,3,darriny,1957,88,4,5,9,44.4%,51m
39822,3,МАКС,1957,42,1,2,3,33.3%,53m
39822,3,MrHyena,1957,0,1,3,4,25.0%,1h
39822,3,Silverdragon,1957,0,1,4,5,20.0%,36m
39822,3,RIKITOS,1957,0,0,1,1,0.0%,39m
39822,3,LonelyWolf,1957,0,0,3,3,0.0%,12m
39822,3,DauBine,1957,0,0,4,4,0.0%,35m
39832,3,[Buśki]Kagawa,1956,1579,153,173,326,46.9%,1h
39832,3,Alina,1956,1564,122,144,266,45.9%,41m
39834,3,UkSrAaIsNty,1955,268,8,12,20,40.0%,15m
39834,2,MrStrato,1955,176,5,12,17,29.4%,52m
39834,2,Ged,1955,145,4,7,11,36.4%,10m
39834,3,Goblingodess,1955,0,0,6,6,0.0%,55m
39834,3,DarkViper,1955,0,0,6,6,0.0%,7m
39839,2,[Nastуa]NARIMAN,1954,520,33,31,64,51.6%,6m
39839,3,Kinrany,1954,231,10,18,28,35.7%,51m
39839,3,Struck,1954,0,1,2,3,33.3%,40m
39839,2,moonlight,1954,0,0,5,5,0.0%,42m
39839,3,ALIEN,1954,0,0,6,6,0.0%,43m
39844,3,Allerdings,1953,1544,64,81,145,44.1%,6m
39844,1,[RSPCT3]Yamin,1953,173,8,13,21,38.1%,1h
39844,3,[PARADX]Azertrox,1953,40,6,1,7,85.7%,34m
39844,2,ScorpioMan,1953,178,5,10,15,33.3%,1h
39844,3,[Kunca]illu,1953,30,2,3,5,40.0%,40m
39844,3,FenderBender,1953,0,1,0,1,100.0%,55m
39844,3,Monkey,1953,0,1,5,6,16.7%,8m
39844,2,Szabi,1953,0,0,8,8,0.0%,1h
39852,3,Ivan,1952,318,13,9,22,59.1%,5m
39852,2,Domanoid,1952,82,4,9,13,30.8%,1h
39852,1,lennart,1952,94,3,6,9,33.3%,55m
39852,3,Zerg,1952,95,1,5,6,16.7%,11m
39852,3,Baboon,1952,0,0,1,1,0.0%,1h
39852,3,FreeMan,1952,0,0,1,1,0.0%,54m
39858,3,[Nxv]Deceive,1951,857,37,43,80,46.2%,1h
39858,3,colmutu,1951,792,30,32,62,48.4%,12m
39858,3,jummbo,1951,672,24,31,55,43.6%,42m
39858,3,IIIIIIIIIIII,1951,0,2,3,5,40.0%,1h
39858,3,Nimnis,1951,97,2,12,14,14.3%,1h
39858,3,Kretcht,1951,0,1,2,3,33.3%,1h
39858,3,Bob,1951,30,1,4,5,20.0%,1h
39858,2,[luchik]михмиханик,1951,0,0,4,4,0.0%,47m
39858,3,Escalade,1951,0,0,5,5,0.0%,1h
39867,3,DAavidekhaha,1950,172,9,17,26,34.6%,58m
39867,3,Zerozidno,1950,172,8,3,11,72.7%,11m
39867,3,EchoCZ,1950,140,5,7,12,41.7%,11m
39867,3,[7STAR]reinonatural,1950,167,4,1,5,80.0%,40m
39867,3,Jheid,1950,0,1,0,1,100.0%,48m
39867,3,CaptainSlice,1950,0,1,1,2,50.0%,40m
39867,3,Fedgdn,1950,0,1,3,4,25.0%,29m
39867,3,CLOVICH,1950,0,0,1,1,0.0%,9m
39875,1,Ludovick,1949,256,9,18,27,33.3%,1h
39875,3,ThunderStef,1949,0,0,5,5,0.0%,15m
39875,3,Hallelujah,1949,0,0,6,6,0.0%,55m
39875,3,KozmaPrutkov,1949,0,0,6,6,0.0%,4m
39879,3,Din,1948,680,25,27,52,48.1%,10m
39879,3,DJDIKKAT,1948,294,12,13,25,48.0%,37m
39879,3,CatAttack,1948,249,9,9,18,50.0%,49m
39879,3,Diniskoff,1948,195,6,4,10,60.0%,1h
39879,3,[SCSB]BlackChoco,1948,30,2,2,4,50.0%,41m
39879,1,Morgling,1948,0,1,1,2,50.0%,57m
39879,3,WordQA,1948,0,0,5,5,0.0%,44m
39886,3,camardon,1947,30,2,3,5,40.0%,53m
39886,3,Djomla,1947,36,2,5,7,28.6%,7m
39886,2,[XOMЯKИ]докторкто,1947,0,0,1,1,0.0%,56m
39889,3,Pawel,1946,602,22,28,50,44.0%,1h
39889,1,Xrsist,1946,630,19,34,53,35.8%,1h
39889,2,SilentFart,1946,546,18,28,46,39.1%,43m
39889,3,kolya,1946,90,7,4,11,63.6%,36m
39889,3,popcorn,1946,58,3,3,6,50.0%,1h
39889,1,BloodMan,1946,96,3,8,11,27.3%,1h
39889,3,Marshall,1946,0,1,0,1,100.0%,36m
39889,3,Sargeras,1946,0,0,1,1,0.0%,1h
39889,3,ScuryMachine,1946,0,0,2,2,0.0%,1h
39889,3,dantesikzhl,1946,0,0,3,3,0.0%,1h
39899,3,[SUD34]Shinoda,1945,900,31,44,75,41.3%,1h
39899,3,RaMbO,1945,579,22,29,51,43.1%,1h
39899,3,Shaftwannabe,1945,202,10,10,20,50.0%,1h
39899,3,Niko,1945,0,2,3,5,40.0%,1h
39899,3,TOCSic,1945,0,0,1,1,0.0%,39m
39904,1,MAXUS,1944,493,21,27,48,43.8%,52m
39904,3,Trigger,1944,356,19,21,40,47.5%,55m
39904,3,БонииКлайд,1944,394,15,21,36,41.7%,45m
39904,3,MadMan,1944,190,6,2,8,75.0%,40m
39904,1,GoodDog,1944,231,6,15,21,28.6%,50m
39904,3,AlanWolker,1944,0,1,0,1,100.0%,7m
39904,3,Unitx,1944,0,1,0,1,100.0%,9m
39904,3,CcTop,1944,0,0,2,2,0.0%,9m
39904,2,JeanCooks,1944,0,0,2,2,0.0%,7m
39913,3,Sallas,1943,276,10,11,21,47.6%,1h
39913,3,xcom,1943,56,3,4,7,42.9%,1h
39913,3,Cipra,1943,0,0,1,1,0.0%,8m
39913,3,tal,1943,0,0,4,4,0.0%,1h
39917,2,GRfl,1942,1310,67,78,145,46.2%,6m
39917,3,Zorg,1942,758,36,37,73,49.3%,1h
39917,3,cmtKARMA,1942,291,10,12,22,45.5%,4m
39917,3,Potato,1942,258,9,11,20,45.0%,1h
39917,2,sapiyo,1942,280,8,16,24,33.3%,11m
39917,3,Xecautioner,1942,220,7,11,18,38.9%,31m
39917,3,ghost,1942,58,3,6,9,33.3%,48m
39917,2,MrSun,1942,90,2,0,2,100.0%,47m
39925,3,billybouns,1941,1576,111,121,232,47.8%,49m
39925,2,Sheeweluch,1941,963,37,42,79,46.8%,1h
39925,1,FEITAN,1941,304,8,16,24,33.3%,33m
39925,3,Pieter,1941,210,7,9,16,43.8%,48m
39925,2,[HARDY]Vendetta,1941,180,6,12,18,33.3%,4m
39925,3,szedav,1941,60,3,7,10,30.0%,15m
39925,1,пук,1941,44,2,2,4,50.0%,59m
39925,3,Lethal,1941,0,2,3,5,40.0%,1h
39925,3,YourCoach,1941,66,2,9,11,18.2%,1h
39925,3,Elsing,1941,30,1,4,5,20.0%,1h
39925,3,CREAM,1941,0,0,1,1,0.0%,1h
39925,2,Conras,1941,0,0,7,7,0.0%,57m
39937,3,TKiller,1940,494,25,29,54,46.3%,1h
39937,2,Treviz,1940,258,8,18,26,30.8%,1h
39937,3,RushMeSlowly,1940,183,7,2,9,77.8%,15m
39937,3,iop,1940,0,2,2,4,50.0%,1h
39937,3,MrCorp,1940,0,2,3,5,40.0%,12m
39937,3,CanisLupus,1940,60,2,6,8,25.0%,1h
39937,3,Dason,1940,0,1,0,1,100.0%,37m
39937,3,Amusedcart,1940,30,1,2,3,33.3%,37m
39945,2,серый,1939,808,29,41,70,41.4%,30m
39945,3,Oertel,1939,626,22,24,46,47.8%,1h
39945,3,Alfirionfirs,1939,425,15,24,39,38.5%,55m
39945,3,[KrankS]Schranky,1939,316,10,19,29,34.5%,39m
39945,3,toto,1939,0,0,2,2,0.0%,8m
39945,3,Percival,1939,0,0,6,6,0.0%,44m
39951,3,Guma,1938,366,13,21,34,38.2%,48m
39951,3,Gyoxi,1938,314,12,14,26,46.2%,55m
39951,3,Rosomak,1938,273,9,7,16,56.2%,5m
39951,3,Schattenwolf,1938,121,3,2,5,60.0%,1h
39951,3,akakiy,1938,62,2,7,9,22.2%,10m
39951,3,francesco,1938,30,1,7,8,12.5%,4m
39951,3,Wads,1938,0,0,2,2,0.0%,55m
39951,3,GOKU,1938,0,0,5,5,0.0%,42m
39959,3,[FR1]BABA,1937,313,10,23,33,30.3%,39m
39959,3,almazik,1937,216,7,6,13,53.8%,29m
39959,3,démoniack,1937,96,1,1,2,50.0%,1h
39959,3,eos,1937,96,1,1,2,50.0%,43m
39963,3,Amans,1936,1089,43,40,83,51.8%,9m
39963,3,serral,1936,1201,42,50,92,45.7%,9m
39963,3,smok,1936,423,15,14,29,51.7%,1h
39963,3,Panda,1936,289,9,7,16,56.2%,37m
39963,3,Boomer,1936,30,4,5,9,44.4%,1h
39963,3,Zerg,1936,58,3,7,10,30.0%,10m
39963,3,FioletUltra,1936,118,3,10,13,23.1%,1h
39963,2,ДариН,1936,46,2,8,10,20.0%,1h
39963,3,Aspid,1936,36,1,8,9,11.1%,1h
39963,1,kornolio,1936,0,0,1,1,0.0%,4m
39963,2,Neptune,1936,0,0,1,1,0.0%,1h
39963,3,Guard,1936,0,0,1,1,0.0%,1h
39963,2,Azog,1936,0,0,7,7,0.0%,30m
39976,3,Improwizer,1935,362,15,17,32,46.9%,1h
39976,3,sXV,1935,210,7,13,20,35.0%,1h
39976,2,AlexanderIII,1935,88,4,6,10,40.0%,30m
39976,3,Resder,1935,94,3,10,13,23.1%,15m
39976,3,[SeVenV]kreker,1935,122,2,4,6,33.3%,48m
39976,3,wintik,1935,60,2,8,10,20.0%,1h
39976,3,nebeynas,1935,36,1,2,3,33.3%,44m
39976,3,Aleaiactaest,1935,0,0,1,1,0.0%,53m
39976,3,parakrama,1935,0,0,5,5,0.0%,1h
39985,3,Gildat,1934,336,13,20,33,39.4%,37m
39985,3,Eminems,1934,356,13,21,34,38.2%,6m
39985,3,[AntCol]NICHOLAS,1934,58,3,3,6,50.0%,9m
39988,3,grim,1933,784,35,21,56,62.5%,1h
39988,1,PrIz,1933,137,4,16,20,20.0%,14m
39988,3,[1BR1]MORFrus,1933,96,2,0,2,100.0%,1h
39988,3,EbsStaRR,1933,0,2,3,5,40.0%,39m
39988,3,Hellpepper,1933,0,0,1,1,0.0%,1h
39988,3,Thud,1933,0,0,4,4,0.0%,47m
39994,3,Maze,1932,220,7,4,11,63.6%,54m
39994,3,cocaino,1932,94,4,8,12,33.3%,48m
39994,3,[zurt]gbo,1932,0,0,5,5,0.0%,12m
39997,3,Nitrogen,1931,802,32,26,58,55.2%,1h
39997,3,SergeyUA,1931,648,24,26,50,48.0%,1h
39997,3,kjemon,1931,180,8,4,12,66.7%,1h
39997,2,tropylaund,1931,90,3,10,13,23.1%,1h
39997,1,Perfecto,1931,96,3,12,15,20.0%,47m
39997,3,NoRiLL,1931,30,1,2,3,33.3%,37m
39997,3,HUNGRYCAKE,1931,0,0,1,1,0.0%,1h
39997,3,Ecthelion,1931,0,0,3,3,0.0%,8m
39997,2,Каруселя,1931,0,0,3,3,0.0%,10m
39997,3,WoobsGaming,1931,0,0,6,6,0.0%,9m
40007,3,Yoghy,1930,808,32,33,65,49.2%,1h
40007,3,JARVIZ,1930,244,9,8,17,52.9%,1h
40007,3,xXTSkyaTXx,1930,30,2,1,3,66.7%,6m
40007,3,Optizerg,1930,62,2,6,8,25.0%,7m
40007,3,RIP,1930,0,0,1,1,0.0%,1h
40012,3,Ksuen,1929,758,42,17,59,71.2%,1h
40012,3,boldpeaches,1929,30,2,2,4,50.0%,40m
40012,3,Żurosław,1929,0,0,5,5,0.0%,40m
40012,3,Londoneyes,1929,0,0,7,7,0.0%,7m
40016,2,Awerkwar,1928,126,8,11,19,42.1%,30m
40016,3,kstone,1928,173,5,8,13,38.5%,55m
40016,1,leo,1928,146,5,15,20,25.0%,46m
40016,2,Zucchemberg,1928,211,4,11,15,26.7%,60m
40020,1,ALEX,1927,906,32,44,76,42.1%,1h
40020,2,XMEN,1927,877,31,34,65,47.7%,32m
40020,1,WhiteCowboy,1927,160,4,13,17,23.5%,46m
40020,3,Torsten,1927,64,3,6,9,33.3%,1h
40020,3,Amou,1927,0,1,4,5,20.0%,44m
40025,2,cylon,1926,641,22,32,54,40.7%,51m
40025,2,stas,1926,358,11,17,28,39.3%,1h
40025,3,Highlandcrow,1926,231,8,20,28,28.6%,1h
40025,3,WhiteRaven,1926,81,4,1,5,80.0%,53m
40025,1,АльфаИАмега,1926,36,4,7,11,36.4%,14m
40025,2,CherT,1926,166,3,10,13,23.1%,10m
40025,3,Ksardrey,1926,0,1,1,2,50.0%,1h
40032,2,Elthachou,1925,1231,153,180,333,45.9%,37m
40032,3,Winchester,1925,517,18,28,46,39.1%,1h
40032,3,DinJoe,1925,408,14,19,33,42.4%,60m
40032,3,bigstalker,1925,312,11,14,25,44.0%,1h
40032,3,White,1925,308,9,16,25,36.0%,12m
40032,3,JBL,1925,230,8,12,20,40.0%,1h
40032,3,MiniNinja,1925,182,7,8,15,46.7%,46m
40032,2,Redfox,1925,231,5,12,17,29.4%,1h
40032,2,GRIFA,1925,88,3,6,9,33.3%,47m
40032,3,PassivPVP,1925,0,1,0,1,100.0%,1h
40042,3,Novrex,1924,282,36,47,83,43.4%,6m
40042,3,[Uсhiha]Джотароо,1924,241,10,11,21,47.6%,37m
40042,3,krlom,1924,141,3,11,14,21.4%,1h
40042,3,Hahi,1924,0,1,0,1,100.0%,13m
40042,3,Xrares,1924,0,0,1,1,0.0%,8m
40047,3,Iamthelaw,1923,475,16,20,36,44.4%,42m
40047,1,[SPAINs]PENRIL,1923,252,11,20,31,35.5%,46m
40047,2,PlastikEsat,1923,321,11,20,31,35.5%,1h
40047,3,MroźnyGnat,1923,268,10,10,20,50.0%,1h
40047,3,NikDevil,1923,196,6,2,8,75.0%,7m
40047,2,greentea,1923,160,4,11,15,26.7%,50m
40047,2,streljk,1923,177,3,11,14,21.4%,52m
40047,3,[3ЕRGTV]Kot,1923,30,1,3,4,25.0%,1h
40047,3,Gangsta,1923,0,0,1,1,0.0%,40m
40047,3,NoName,1923,0,0,1,1,0.0%,47m
40057,3,Chort,1922,456,16,20,36,44.4%,42m
40057,3,amntdm,1922,0,1,2,3,33.3%,1h
40059,2,Dani,1921,422,13,27,40,32.5%,1h
40059,3,Monak,1921,282,10,15,25,40.0%,12m
40059,3,AlfSanz,1921,30,3,5,8,37.5%,41m
40059,3,cinu,1921,30,2,2,4,50.0%,1h
40059,3,Marcin,1921,0,0,1,1,0.0%,29m
40064,3,Swizzly,1920,1575,671,803,1474,45.5%,1h
40064,1,Fisken,1920,369,20,31,51,39.2%,33m
40064,3,Dig,1920,68,3,3,6,50.0%,39m
40064,3,[Дошик1]Rocknik,1920,120,2,3,5,40.0%,1h
40064,1,Newby,1920,0,1,0,1,100.0%,1h
40064,1,Хoблик,1920,0,0,1,1,0.0%,4m
40070,3,Sushi,1919,844,31,37,68,45.6%,41m
40070,2,Rasoon,1919,264,9,10,19,47.4%,60m
40070,3,Valun,1919,150,5,14,19,26.3%,15m
40070,1,вячеслав,1919,86,4,12,16,25.0%,12m
40070,1,xazka,1919,162,3,12,15,20.0%,1h
40070,1,FRO,1919,0,0,1,1,0.0%,46m
40070,3,Algi,1919,0,0,6,6,0.0%,15m
40077,1,shadwell,1918,340,9,2,11,81.8%,41m
40077,1,Neikma,1918,118,5,7,12,41.7%,1h
40077,1,HBall,1918,114,3,10,13,23.1%,47m
40077,1,EnderStim,1918,103,2,9,11,18.2%,41m
40077,1,OberstBreit,1918,0,1,11,12,8.3%,41m
40077,1,Blackmer,1918,0,0,1,1,0.0%,51m
40077,1,kekdambaz,1918,0,0,1,1,0.0%,35m
40077,1,Neverhood,1918,0,0,5,5,0.0%,43m
40085,2,TheWillis,1917,596,25,27,52,48.1%,14m
40085,3,Karatel,1917,145,4,2,6,66.7%,46m
40085,2,DerKrasse,1917,170,3,5,8,37.5%,10m
40085,3,[zCCCPz]diedmoon,1917,0,0,1,1,0.0%,9m
40085,3,inaya,1917,0,0,1,1,0.0%,12m
40090,2,MegaDude,1916,194,4,12,16,25.0%,9m
40090,2,staspro,1916,0,0,1,1,0.0%,60m
40090,1,[1Fan]ЫЫЫЫЫЫЫЫЫЫЫЫ,1916,0,0,1,1,0.0%,59m
40093,3,mav,1915,344,13,21,34,38.2%,1h
40093,1,DrKimble,1915,436,10,9,19,52.6%,53m
40093,3,Pawell,1915,132,4,2,6,66.7%,41m
40093,3,[speak]MarissonLefr,1915,60,3,4,7,42.9%,1h
40093,1,DustyFrog,1915,0,2,3,5,40.0%,47m
40093,2,[100PSC]MiguelAngelo,1915,44,1,1,2,50.0%,51m
40093,1,ПУПСback,1915,46,1,7,8,12.5%,12m
40100,1,Kurty,1914,214,9,12,21,42.9%,48m
40100,3,Farinha,1914,181,8,10,18,44.4%,51m
40100,1,PREDETOR,1914,211,4,12,16,25.0%,12m
40100,1,Wiltche,1914,99,2,6,8,25.0%,13m
40100,1,saske,1914,30,2,11,13,15.4%,47m
40100,1,WaRDoG,1914,0,1,0,1,100.0%,8m
40100,3,MrShon,1914,96,1,6,7,14.3%,1h
40100,3,edvinas,1914,0,0,1,1,0.0%,53m
40108,3,Prekursor,1913,283,12,21,33,36.4%,1h
40108,3,CRUZ,1913,119,3,5,8,37.5%,51m
40108,1,celmer,1913,0,0,1,1,0.0%,1h
40108,3,[R4Time]Zeratul,1913,0,0,1,1,0.0%,1h
40108,1,BOBO,1913,73,0,4,4,0.0%,1h
40113,2,[NVRGUP]Miziq,1912,210,7,12,19,36.8%,37m
40113,2,firenest,1912,30,2,9,11,18.2%,54m
40113,2,EpsToDay,1912,0,2,11,13,15.4%,1h
40113,1,UlliManHD,1912,32,2,12,14,14.3%,35m
40113,3,DrMorgi,1912,0,0,6,6,0.0%,55m
40118,3,ZeuS,1911,578,22,22,44,50.0%,1h
40118,1,Seonic,1911,768,22,26,48,45.8%,60m
40118,1,[repoS]forbidden,1911,186,5,16,21,23.8%,47m
40118,3,Veroniiae,1911,121,2,2,4,50.0%,1h
40122,2,Pisolo,1910,1394,47,61,108,43.5%,1h
40122,3,PanMIM,1910,780,28,31,59,47.5%,51m
40122,2,gonzo,1910,150,9,13,22,40.9%,1h
40122,3,KOTCHANKIN,1910,201,6,6,12,50.0%,29m
40122,3,[аз3]dagor,1910,30,2,3,5,40.0%,1h
40122,1,KillerMaster,1910,0,1,5,6,16.7%,1h
40128,3,mootoo,1909,1016,34,44,78,43.6%,40m
40128,3,хуеверт,1909,225,7,6,13,53.8%,1h
40128,2,[БУБУБ]ValeraZeRg,1909,210,7,12,19,36.8%,57m
40128,3,Hamel,1909,60,3,3,6,50.0%,46m
40128,1,Murk,1909,32,2,9,11,18.2%,1h
40128,3,Notority,1909,30,1,2,3,33.3%,54m
40128,2,GeorgiL,1909,30,1,8,9,11.1%,1h
40135,3,tovarm,1908,0,1,0,1,100.0%,8m
40135,2,[утка]миша,1908,40,1,4,5,20.0%,42m
40135,3,Hancock,1908,0,0,3,3,0.0%,9m
40135,3,Nevervideo,1908,0,0,4,4,0.0%,53m
40139,1,TrojaN,1907,1277,40,47,87,46.0%,45m
40139,1,Ggamnol,1907,444,11,15,26,42.3%,1h
40139,1,крутов,1907,344,9,3,12,75.0%,45m
40139,1,[ChBoyz]Tireje,1907,46,2,0,2,100.0%,1h
40139,3,Miro,1907,0,0,1,1,0.0%,1h
40139,3,muffin,1907,0,0,2,2,0.0%,40m
40145,2,VALENTOR,1906,191,8,6,14,57.1%,10m
40145,2,AimKeks,1906,173,6,9,15,40.0%,1h
40145,1,Lith,1906,191,4,15,19,21.1%,1h
40145,1,Verme,1906,162,3,2,5,60.0%,13m
40145,1,[N7TKKD]Dimidrol,1906,48,1,2,3,33.3%,36m
40145,3,JottL,1906,0,0,4,4,0.0%,1h
40151,3,Wave,1905,251,8,17,25,32.0%,29m
40151,3,[YMSP]William,1905,210,7,6,13,53.8%,11m
40151,1,Selim,1905,194,7,19,26,26.9%,14m
40151,1,Judaszek,1905,0,0,2,2,0.0%,1h
40155,1,IvanSelick,1904,587,25,22,47,53.2%,4m
40155,3,TriManXx,1904,685,25,26,51,49.0%,39m
40155,3,BoBDeBeKeR,1904,0,0,6,6,0.0%,1h
40155,2,Ocyld,1904,0,0,7,7,0.0%,1h
40159,3,fafaf,1903,794,28,36,64,43.8%,1h
40159,3,blackstorm,1903,165,6,7,13,46.2%,38m
40159,1,roman,1903,0,0,1,1,0.0%,42m
40159,2,Atu,1903,0,0,8,8,0.0%,1h
40163,3,Davout,1902,1576,73,85,158,46.2%,1h
40163,3,Panart,1902,533,24,30,54,44.4%,37m
40163,3,[NINJ88]Ragman,1902,720,24,34,58,41.4%,54m
40163,3,Artanis,1902,97,2,2,4,50.0%,45m
40163,1,rams,1902,0,1,0,1,100.0%,36m
40168,3,DraconianAsh,1901,1032,36,41,77,46.8%,1h
40168,3,[widma]DominikO,1901,228,11,15,26,42.3%,43m
40168,1,GrandBBang,1901,129,4,1,5,80.0%,47m
40168,1,lolnope,1901,0,1,9,10,10.0%,57m
40168,1,[GG1sec]lSDl,1901,0,0,1,1,0.0%,36m
40168,1,Fama,1901,0,0,5,5,0.0%,1h
40168,3,kufargery,1901,0,0,9,9,0.0%,1h
40175,3,[DEDAL]Furno,1900,217,7,10,17,41.2%,46m
40175,1,CEOofZergs,1900,143,5,1,6,83.3%,33m
40175,1,[Soßes]hyprix,1900,173,4,4,8,50.0%,50m
40175,1,Dragonscar,1900,0,0,1,1,0.0%,4m
40175,2,Gordon,1900,0,0,3,3,0.0%,36m
40180,1,ToiletDive,1899,38,2,0,2,100.0%,1h
40180,1,[CHQ]Gandalf,1899,0,0,1,1,0.0%,33m
40180,3,[EnFi]HotBlueSky,1899,0,0,1,1,0.0%,1h
40183,3,Baw,1898,278,10,16,26,38.5%,12m
40183,3,Владичара,1898,278,9,14,23,39.1%,1h
40183,1,[KSMH]KeSeMeKa,1898,90,2,2,4,50.0%,35m
40183,3,Tingofotz,1898,0,1,1,2,50.0%,9m
40183,3,Surrender,1898,36,1,5,6,16.7%,47m
40183,2,[АЧП]Xlebishek,1898,0,0,9,9,0.0%,30m
40189,1,pes,1897,423,10,0,10,100.0%,49m
40189,3,TopperArgio,1897,266,9,16,25,36.0%,1h
40189,1,GreenBalls,1897,194,7,17,24,29.2%,1h
40189,1,den,1897,176,5,2,7,71.4%,1h
40189,1,IlikeLoli,1897,134,4,14,18,22.2%,55m
40189,3,lihatskiy,1897,0,1,0,1,100.0%,7m
40189,3,Max,1897,30,1,2,3,33.3%,1h
40189,2,[AnGoSt]DanyaPyccom,1897,0,1,9,10,10.0%,57m
40197,3,Dragonlord,1896,0,0,4,4,0.0%,34m
40198,3,Komick,1895,859,33,46,79,41.8%,48m
40198,3,Yaantheale,1895,601,20,23,43,46.5%,48m
40198,1,Русич,1895,293,7,4,11,63.6%,57m
40198,1,[ЭтоНе]Озабоченный,1895,212,4,1,5,80.0%,60m
40198,1,iTzVodka,1895,46,1,1,2,50.0%,9m
40198,3,ĐENERALE,1895,34,1,3,4,25.0%,1h
40198,2,[Pisyn]KROMSATEL,1895,0,0,1,1,0.0%,1h
40205,3,Cherepundel,1894,480,18,30,48,37.5%,12m
40205,2,UsadaPekora,1894,548,18,36,54,33.3%,56m
40205,3,MSK,1894,120,5,9,14,35.7%,1h
40205,3,AbrisjediHUN,1894,0,0,3,3,0.0%,1h
40209,3,Kayyot,1893,806,28,34,62,45.2%,1h
40209,3,[R4t3L]ZONZON,1893,275,20,23,43,46.5%,1h
40209,3,katarsis,1893,407,15,18,33,45.5%,29m
40209,3,Kristina,1893,0,2,4,6,33.3%,8m
40209,3,franksch,1893,60,2,9,11,18.2%,1h
40209,3,ArnoldRoth,1893,0,0,6,6,0.0%,1h
40215,3,Lebrali,1892,673,28,30,58,48.3%,60m
40215,3,Ahornius,1892,476,19,16,35,54.3%,41m
40215,1,[Raa]Palladium,1892,95,1,6,7,14.3%,1h
40215,1,шафи,1892,0,0,1,1,0.0%,47m
40215,1,Kujivunia,1892,0,0,4,4,0.0%,1h
40220,3,WilliWinzig,1891,1560,142,175,317,44.8%,1h
40220,1,[FR1]KaltenCPN,1891,318,8,6,14,57.1%,41m
40220,3,ganjamoscow,1891,178,7,8,15,46.7%,41m
40220,3,Wweis,1891,0,2,2,4,50.0%,9m
40220,1,Seenay,1891,0,2,3,5,40.0%,55m
40220,1,Alex,1891,0,0,2,2,0.0%,47m
40220,3,Nibiru,1891,0,0,5,5,0.0%,47m
40220,2,TiGrA,1891,0,0,8,8,0.0%,1h
40228,2,Kazah,1890,218,7,12,19,36.8%,53m
40228,2,ShotInjectio,1890,88,1,2,3,33.3%,42m
40228,2,[amiz]StarCristal,1890,0,0,1,1,0.0%,47m
40228,3,[KRONOM]GHOST,1890,0,0,1,1,0.0%,1h
40228,3,wiesiek,1890,0,0,4,4,0.0%,40m
40228,3,Emperor,1890,0,0,7,7,0.0%,12m
40234,3,Aurélien,1889,716,42,39,81,51.9%,6m
40234,1,Silentce,1889,581,19,8,27,70.4%,60m
40234,1,simpleminds,1889,314,7,6,13,53.8%,1h
40234,1,illyuzionist,1889,187,5,5,10,50.0%,1h
40234,1,Chupakabra,1889,48,3,3,6,50.0%,60m
40234,3,Bulka,1889,30,3,5,8,37.5%,1h
40240,1,caiiikabro,1888,1039,30,35,65,46.2%,41m
40240,3,Itoren,1888,97,2,5,7,28.6%,41m
40240,1,Arthoth,1888,73,1,9,10,10.0%,1h
40240,1,Flip,1888,0,0,1,1,0.0%,8m
40240,2,Drake,1888,0,0,1,1,0.0%,1h
40245,3,Bot,1887,396,15,13,28,53.6%,1h
40245,3,Austintrezen,1887,352,11,24,35,31.4%,31m
40245,1,Hikkikomori,1887,128,5,14,19,26.3%,51m
40245,3,RYDER,1887,176,4,6,10,40.0%,49m
40245,1,JaegerKorp,1887,184,4,7,11,36.4%,12m
40245,2,FOUDRE,1887,0,2,4,6,33.3%,1h
40245,3,fagh,1887,30,1,3,4,25.0%,4m
40245,2,Sparta,1887,0,0,3,3,0.0%,37m
40245,3,Plutarch,1887,0,0,7,7,0.0%,1h
40254,3,Meg,1886,800,27,39,66,40.9%,31m
40254,1,Barwize,1886,554,13,15,28,46.4%,50m
40254,3,Alinmas,1886,215,10,6,16,62.5%,39m
40257,3,Nitros,1885,30,1,3,4,25.0%,9m
40258,3,heisenberg,1884,364,18,24,42,42.9%,53m
40258,3,Autocarl,1884,142,6,12,18,33.3%,1h
40258,2,Darkblack,1884,95,1,1,2,50.0%,57m
40258,3,Atex,1884,30,1,7,8,12.5%,1h
40258,1,Gaffax,1884,0,1,10,11,9.1%,46m
40258,1,[IRvGI]vladosibl,1884,0,0,1,1,0.0%,1h
40258,3,Willhelm,1884,0,0,5,5,0.0%,41m
40265,3,lukolik,1883,304,16,15,31,51.6%,9m
40265,3,mangodehuey,1883,363,14,8,22,63.6%,42m
40265,1,MarineX,1883,142,4,0,4,100.0%,41m
40265,3,antxon,1883,0,4,4,8,50.0%,1h
40265,3,Mithrandir,1883,60,4,7,11,36.4%,1h
40265,3,Tolerian,1883,0,0,4,4,0.0%,34m
40265,3,jean,1883,0,0,7,7,0.0%,1h
40272,2,[RMWP]Catnip,1882,1231,92,93,185,49.7%,13m
40272,3,Rushme,1882,0,3,0,3,100.0%,12m
40272,3,[Fansaf]Дед,1882,30,3,6,9,33.3%,6m
40275,2,Napoleon,1881,1443,128,145,273,46.9%,50m
40275,3,ShadowDragon,1881,670,28,20,48,58.3%,1h
40275,3,NCHSııLøukid,1881,420,15,23,38,39.5%,15m
40275,3,asdfsadf,1881,332,11,19,30,36.7%,5m
40275,3,manro,1881,322,10,9,19,52.6%,1h
40275,1,CrayXP,1881,333,10,20,30,33.3%,39m
40275,3,dimavydrin,1881,284,8,12,20,40.0%,6m
40275,3,andertimi,1881,197,7,5,12,58.3%,1h
40275,1,jack,1881,230,6,8,14,42.9%,1h
40275,3,callvin,1881,114,5,19,24,20.8%,34m
40275,3,[PECAN]SanfroixX,1881,0,1,4,5,20.0%,53m
40286,3,Zorander,1880,308,10,18,28,35.7%,5m
40286,2,nightswing,1880,62,3,12,15,20.0%,1h
40286,1,CancelALEX,1880,0,1,4,5,20.0%,9m
40286,1,RassBroKZ,1880,0,0,2,2,0.0%,32m
40290,3,GenMiskov,1879,262,8,14,22,36.4%,57m
40290,3,MaXpOwEr,1879,48,2,1,3,66.7%,1h
40292,2,starhant,1878,1429,89,102,191,46.6%,59m
40292,1,MOH,1878,303,8,5,13,61.5%,35m
40292,3,Zauber,1878,250,8,20,28,28.6%,15m
40292,3,Sharon,1878,72,2,10,12,16.7%,53m
40292,1,[СПАС]Diezz,1878,0,0,2,2,0.0%,53m
40292,3,Pvm,1878,0,0,7,7,0.0%,12m
40298,3,RUSMarkuel,1877,115,3,3,6,50.0%,1h
40298,1,[LSDXIX]SummerSnow,1877,0,1,0,1,100.0%,47m
40298,3,proyon,1877,0,1,1,2,50.0%,1h
40298,2,Kirutan,1877,0,1,9,10,10.0%,7m
40302,2,qunn,1876,1553,148,175,323,45.8%,38m
40302,3,Wolf,1876,619,61,73,134,45.5%,40m
40302,3,AnnaghMore,1876,1124,48,52,100,48.0%,53m
40302,3,imba,1876,195,6,12,18,33.3%,12m
40302,3,Élythia,1876,162,4,7,11,36.4%,13m
40302,3,Anakeim,1876,30,3,5,8,37.5%,47m
40302,1,JAN,1876,40,2,11,13,15.4%,52m
40302,1,Puffpin,1876,0,0,1,1,0.0%,59m
40302,3,BERRIES,1876,0,0,7,7,0.0%,6m
40302,3,простоЛис,1876,0,0,7,7,0.0%,1h
40312,3,Dori,1875,1528,59,63,122,48.4%,1h
40312,1,Kerrigan,1875,708,18,19,37,48.6%,9m
40312,1,BIBA,1875,518,12,11,23,52.2%,36m
40312,1,GhostDog,1875,422,10,8,18,55.6%,48m
40312,1,DerLauch,1875,0,0,1,1,0.0%,43m
40317,3,MASTERBBA,1874,494,76,88,164,46.3%,41m
40317,1,scar,1874,790,20,25,45,44.4%,46m
40317,2,Razel,1874,318,8,15,23,34.8%,1h
40320,3,[Ogz]Ryan,1873,337,11,13,24,45.8%,39m
40320,3,oliwier,1873,0,0,1,1,0.0%,55m
40322,3,Potato,1872,660,25,26,51,49.0%,1h
40322,1,Zerus,1872,708,17,15,32,53.1%,33m
40322,3,vladvolk,1872,290,13,22,35,37.1%,41m
40322,3,giz,1872,88,4,7,11,36.4%,1h
40322,3,Xandr,1872,0,0,1,1,0.0%,40m
40322,2,[mstake]SeeYouEnTee,1872,0,0,2,2,0.0%,60m
40322,1,fasststrike,1872,0,0,2,2,0.0%,8m
40329,1,Jolma,1871,1472,198,223,421,47.0%,13m
40329,3,gerfild,1871,599,20,26,46,43.5%,41m
40329,2,Krawcowy,1871,458,15,26,41,36.6%,1h
40329,3,OleksandrPRY,1871,306,10,11,21,47.6%,60m
40329,3,Joker,1871,152,4,15,19,21.1%,1h
40329,2,Sinh,1871,0,2,7,9,22.2%,10m
40329,3,[LMBD]Osi,1871,72,2,7,9,22.2%,1h
40329,1,[DragW]Matveismi,1871,0,0,1,1,0.0%,32m
40329,3,ViOLent,1871,0,0,1,1,0.0%,53m
40338,3,[SDW2]Viktorier,1870,1296,52,57,109,47.7%,43m
40338,3,Lorencas,1870,918,32,47,79,40.5%,7m
40338,3,[KoSII]XIPHIOIDES,1870,388,14,18,32,43.8%,1h
40338,3,Mundus,1870,207,5,14,19,26.3%,1h
40338,3,Riot,1870,142,4,9,13,30.8%,7m
40338,3,Pjevs,1870,0,0,3,3,0.0%,15m
40344,3,SpacialRonin,1869,705,26,35,61,42.6%,41m
40344,1,HelmOfWill,1869,148,5,18,23,21.7%,8m
40344,1,[400apm]Arthanis,1869,110,4,9,13,30.8%,7m
40344,3,батлщет,1869,30,2,3,5,40.0%,37m
40344,3,Bran,1869,0,0,6,6,0.0%,8m
40344,2,ArkanDeath,1869,0,0,8,8,0.0%,37m
40350,3,GimBrother,1868,717,30,38,68,44.1%,12m
40350,3,adriannic,1868,466,16,19,35,45.7%,1h
40350,3,Blackbird,1868,0,2,4,6,33.3%,1h
40350,3,[MVV77]Hero,1868,0,1,2,3,33.3%,1h
40350,3,vitmak,1868,0,0,4,4,0.0%,7m
40355,3,Nobu,1867,430,15,14,29,51.7%,58m
40355,3,Atheh,1867,335,12,15,27,44.4%,6m
40355,2,JacobOrgana,1867,255,7,14,21,33.3%,48m
40355,3,BERLOK,1867,0,4,1,5,80.0%,34m
40355,1,bnk,1867,44,2,1,3,66.7%,1h
40355,2,Zorbin,1867,0,2,10,12,16.7%,29m
40355,2,Zumbla,1867,88,1,8,9,11.1%,1h
40355,2,Kyme,1867,93,1,9,10,10.0%,13m
40363,3,Nonos,1866,1228,42,62,104,40.4%,53m
40363,2,Navarro,1866,40,1,2,3,33.3%,33m
40363,1,WhiteGG,1866,44,1,3,4,25.0%,43m
40363,3,hAWk,1866,0,1,3,4,25.0%,55m
40363,1,Teisu,1866,0,1,4,5,20.0%,4m
40368,2,FlyAway,1865,1481,124,165,289,42.9%,57m
40368,3,Devillos,1865,408,13,24,37,35.1%,6m
40368,1,[K1LL]tempesta,1865,184,6,16,22,27.3%,1h
40368,1,КЛОУН,1865,46,2,0,2,100.0%,60m
40368,3,Valikoz,1865,0,2,4,6,33.3%,41m
40368,1,Xadrikore,1865,142,2,10,12,16.7%,9m
40368,1,ZhuTou,1865,0,1,1,2,50.0%,43m
40368,1,BlackWolf,1865,0,0,2,2,0.0%,1h
40368,1,kruiz,1865,0,0,3,3,0.0%,43m
40377,1,FANTASTIC,1864,224,5,5,10,50.0%,1h
40377,3,Fantik,1864,138,5,5,10,50.0%,39m
40377,2,redy,1864,182,4,5,9,44.4%,46m
40377,3,KeppeK,1864,90,3,10,13,23.1%,1h
40377,3,Gambit,1864,30,2,7,9,22.2%,4m
40377,3,[Reano]stealthplays,1864,0,0,9,9,0.0%,41m
40383,2,ShaiHulud,1863,1276,44,61,105,41.9%,1h
40383,1,Hati,1863,164,8,13,21,38.1%,35m
40383,1,JoRussi,1863,92,4,5,9,44.4%,1h
40383,2,GianluT,1863,114,3,6,9,33.3%,55m
40383,1,NEVER,1863,73,1,7,8,12.5%,33m
40388,3,Galagycyber,1862,1181,72,86,158,45.6%,1h
40388,3,PREDATOR,1862,829,43,44,87,49.4%,29m
40388,1,BigPutotoy,1862,115,2,11,13,15.4%,4m
40388,1,[MiAzGa]MarcinMullER,1862,0,0,1,1,0.0%,15m
40388,3,FauxTech,1862,0,0,1,1,0.0%,13m
40388,3,[Zavess]ISFCKNGHOT,1862,0,0,2,2,0.0%,7m
40388,2,Sereti,1862,0,0,3,3,0.0%,13m
40395,2,troll,1861,1504,54,71,125,43.2%,10m
40395,3,Petro,1861,62,3,6,9,33.3%,1h
40395,1,[prosy9]eryk,1861,90,2,3,5,40.0%,39m
40395,1,inkvizitor,1861,0,1,0,1,100.0%,4m
40395,2,MaximUA,1861,0,1,0,1,100.0%,33m
40395,1,Kess,1861,0,1,1,2,50.0%,34m
40395,1,Victor,1861,0,0,1,1,0.0%,32m
40402,3,Mariño,1860,409,13,15,28,46.4%,1h
40402,1,[чух]Абрикосик,1860,266,6,4,10,60.0%,1h
40402,3,DASFlagman,1860,0,0,4,4,0.0%,6m
40402,3,призрак,1860,0,0,6,6,0.0%,40m
40406,3,UniTx,1859,1107,68,85,153,44.4%,6m
40406,2,[LRteam]Catherines,1859,294,9,22,31,29.0%,10m
40406,1,CelMaiBun,1859,127,3,2,5,60.0%,48m
40406,1,Doofy,1859,0,3,2,5,60.0%,48m
40406,3,Charasa,1859,119,3,5,8,37.5%,1h
40406,1,Nighteagle,1859,46,1,1,2,50.0%,34m
40412,3,Chewy,1858,577,20,23,43,46.5%,3m
40412,1,Dédé,1858,406,9,18,27,33.3%,57m
40412,1,Gorjeck,1858,357,9,20,29,31.0%,1h
40412,3,IvanIvanov,1858,34,1,3,4,25.0%,37m
40412,3,Math,1858,0,0,2,2,0.0%,53m
40412,3,Kishar,1858,0,0,3,3,0.0%,1h
40418,3,Teonirvana,1857,140,12,24,36,33.3%,46m
40418,3,Rammstein,1857,322,12,26,38,31.6%,48m
40418,3,Achiwo,1857,146,5,9,14,35.7%,41m
40418,1,DustyHobbies,1857,68,3,13,16,18.8%,2m
40418,3,[ALO]Altayr,1857,0,0,1,1,0.0%,42m
40418,3,[PRLYZE]McLovin,1857,0,0,3,3,0.0%,8m
40424,3,[OmDi]DSX,1856,1116,42,53,95,44.2%,1h
40424,2,TheStormRage,1856,30,2,3,5,40.0%,39m
40424,1,TrYsO,1856,134,2,5,7,28.6%,47m
40424,3,Iwantpizza,1856,30,2,7,9,22.2%,59m
40424,1,Rutek,1856,46,1,4,5,20.0%,47m
40429,1,Lama,1855,694,17,13,30,56.7%,42m
40429,3,[ĦĦ]blackbrain,1855,32,1,2,3,33.3%,40m
40431,3,Grut,1854,165,4,14,18,22.2%,41m
40431,1,Admos,1854,36,2,0,2,100.0%,52m
40431,2,AlfaCentauri,1854,78,2,7,9,22.2%,1h
40431,3,PYJIb,1854,62,2,8,10,20.0%,9m
40435,2,[L0L]KrakenPL,1853,796,28,37,65,43.1%,58m
40435,3,HoshNaaiers,1853,464,21,34,55,38.2%,37m
40435,3,CatarroSporc,1853,522,19,24,43,44.2%,59m
40435,3,YNO,1853,378,14,23,37,37.8%,53m
40435,3,Zak,1853,259,8,9,17,47.1%,15m
40435,1,gellos,1853,265,5,9,14,35.7%,59m
40435,3,starscrapper,1853,0,1,0,1,100.0%,37m
40435,3,Crone,1853,0,1,2,3,33.3%,13m
40435,3,Creative,1853,0,0,3,3,0.0%,47m
40444,3,Crux,1852,324,12,18,30,40.0%,39m
40444,1,RunRobot,1852,163,5,6,11,45.5%,46m
40444,2,Megatron,1852,152,5,19,24,20.8%,1h
40444,1,[Gurkie]Midnor,1852,184,3,8,11,27.3%,1h
40444,3,Dynamiterr,1852,60,3,10,13,23.1%,12m
40444,1,zorcka,1852,94,2,4,6,33.3%,43m
40444,2,Курицын,1852,88,2,9,11,18.2%,37m
40444,2,ГАГАРИН,1852,60,2,10,12,16.7%,1h
40444,1,FeonwOw,1852,131,2,11,13,15.4%,1h
40444,1,MrNicolay,1852,0,0,1,1,0.0%,1h
40444,1,Ledus,1852,0,0,3,3,0.0%,49m
40455,1,katy,1851,1497,118,143,261,45.2%,13m
40455,3,FENIXTAN,1851,316,10,14,24,41.7%,10m
40455,1,lyterogas,1851,94,2,11,13,15.4%,60m
40458,3,owmorde,1850,1546,83,100,183,45.4%,10m
40458,3,StarM,1850,1222,53,69,122,43.4%,51m
40458,3,Gspilap,1850,264,8,12,20,40.0%,47m
40458,2,[AiRǂ]ATHOR,1850,125,2,4,6,33.3%,55m
40458,3,Боня,1850,0,1,5,6,16.7%,59m
40463,1,boeberking,1849,251,7,14,21,33.3%,55m
40463,2,gos,1849,236,6,13,19,31.6%,1h
40463,1,Buentorax,1849,208,5,2,7,71.4%,57m
40463,3,Amiterak,1849,88,2,3,5,40.0%,54m
40463,1,Борис,1849,30,2,10,12,16.7%,49m
40463,2,nthngy,1849,48,2,12,14,14.3%,10m
40463,2,TechnoGirl,1849,48,1,12,13,7.7%,1h
40470,3,Khakhar,1848,1458,62,72,134,46.3%,12m
40470,1,MonkeyMagic,1848,959,29,38,67,43.3%,13m
40470,1,benderguay,1848,270,6,8,14,42.9%,47m
40470,1,DUMMSDEI,1848,149,3,12,15,20.0%,52m
40470,1,Shaman,1848,46,2,4,6,33.3%,33m
40470,2,ketrab,1848,0,0,1,1,0.0%,54m
40470,2,SyNcZ,1848,0,0,3,3,0.0%,47m
40477,1,LePresident,1847,1497,75,98,173,43.4%,35m
40477,3,Machy,1847,986,34,50,84,40.5%,60m
40477,3,YANfzltt,1847,761,27,41,68,39.7%,45m
40477,3,lochux,1847,0,1,0,1,100.0%,53m
40477,3,DoWePlayLike,1847,0,0,3,3,0.0%,1h
40482,1,Dlander,1846,0,1,1,2,50.0%,50m
40482,1,котик,1846,42,1,5,6,16.7%,1h
40482,2,Mikasa,1846,0,0,1,1,0.0%,13m
40482,3,[JOG]Shiiggyy,1846,0,0,2,2,0.0%,1h
40482,3,TheBusDriver,1846,0,0,8,8,0.0%,1h
40487,1,tesla,1845,242,10,12,22,45.5%,15m
40487,3,Deawoolf,1845,216,7,16,23,30.4%,41m
40487,3,Petredo,1845,106,4,8,12,33.3%,13m
40487,2,Axefighter,1845,215,4,11,15,26.7%,1h
40487,3,Timur,1845,108,3,8,11,27.3%,59m
40487,3,Bertles,1845,0,0,1,1,0.0%,10m
40493,1,multpit,1844,96,6,9,15,40.0%,45m
40493,1,MaDzone,1844,0,1,0,1,100.0%,8m
40493,1,Shatoon,1844,0,1,5,6,16.7%,42m
40493,3,SpicySwarm,1844,0,0,2,2,0.0%,1h
40497,3,TSL,1843,1544,135,149,284,47.5%,43m
40497,3,Xenonstar,1843,848,30,39,69,43.5%,1h
40497,3,DuranDuran,1843,298,9,20,29,31.0%,53m
40497,3,TSNLEGEND,1843,265,8,14,22,36.4%,43m
40497,3,[228822]Sparky,1843,144,4,4,8,50.0%,1h
40497,2,Necro,1843,80,3,0,3,100.0%,34m
40497,1,SosnaMRK,1843,92,2,3,5,40.0%,50m
40497,3,aras,1843,0,1,1,2,50.0%,13m
40497,2,Quiro,1843,0,1,10,11,9.1%,10m
40497,1,[NJoke]MOnsoon,1843,0,0,1,1,0.0%,53m
40497,1,Hiwett,1843,0,0,1,1,0.0%,59m
40497,1,Schokogurke,1843,73,0,7,7,0.0%,60m
40509,2,Alvaro,1842,678,25,38,63,39.7%,13m
40509,1,[Ale96]Alèxandros,1842,90,3,1,4,75.0%,55m
40509,1,Asistole,1842,42,2,0,2,100.0%,14m
40509,1,Mortigald,1842,136,2,1,3,66.7%,51m
40509,1,WarLordKai,1842,88,1,6,7,14.3%,57m
40509,3,CookieMonstr,1842,0,0,5,5,0.0%,8m
40515,1,Злоубийца,1841,554,14,12,26,53.8%,36m
40515,3,StyrianTower,1841,326,11,23,34,32.4%,54m
40515,1,ProfessorOak,1841,48,1,1,2,50.0%,15m
40515,2,MerlinT,1841,0,0,1,1,0.0%,1h
40515,1,BurebistaEu,1841,0,0,2,2,0.0%,46m
40515,3,ErtHalf,1841,0,0,6,6,0.0%,1h
40521,1,Roland,1840,344,9,11,20,45.0%,1h
40521,2,zerg,1840,46,4,11,15,26.7%,42m
40521,2,LizaSolnceva,1840,148,4,17,21,19.0%,14m
40521,1,Andrew,1840,0,0,1,1,0.0%,7m
40521,3,[krishu]Shadow,1840,0,0,3,3,0.0%,56m
40526,1,Dafuq,1839,48,2,12,14,14.3%,9m
40526,3,SanchoS,1839,0,1,0,1,100.0%,10m
40526,1,Andrey,1839,32,1,2,3,33.3%,13m
40529,3,[ANREN]Перун,1838,314,10,22,32,31.2%,57m
40529,1,WingsTV,1838,96,4,7,11,36.4%,1h
40529,1,deMichel,1838,138,3,2,5,60.0%,60m
40529,2,[Podpol]Лёша,1838,44,1,4,5,20.0%,13m
40533,3,MaHuak,1837,82,5,17,22,22.7%,58m
40533,3,Luchouski,1837,0,2,5,7,28.6%,12m
40533,1,[TSATSA]HQueen,1837,46,1,2,3,33.3%,39m
40533,1,[EliteX]IlllIllllI,1837,0,0,5,5,0.0%,57m
40537,1,Vinda,1836,1270,47,72,119,39.5%,14m
40537,1,[2L33T]KimJongSkill,1836,340,7,11,18,38.9%,1h
40537,3,ShadowWalker,1836,60,2,3,5,40.0%,12m
40537,3,GFORCE,1836,30,1,6,7,14.3%,1h
40541,1,Meriodasu,1835,236,4,8,12,33.3%,8m
40542,3,sebu,1834,364,14,15,29,48.3%,1h
40542,2,Queen,1834,281,8,13,21,38.1%,54m
40542,1,Dmitry,1834,96,2,2,4,50.0%,1h
40545,3,[zsír]hukkle,1833,1152,70,81,151,46.4%,1h
40545,3,[I1I]lilijj,1833,133,19,30,49,38.8%,58m
40545,1,RonZ,1833,484,12,6,18,66.7%,12m
40545,3,MARIXYANA,1833,170,5,9,14,35.7%,59m
40545,3,ARHANGEL,1833,0,0,2,2,0.0%,53m
40550,2,[zKSKz]Penibel,1832,90,2,8,10,20.0%,55m
40550,3,Nemo,1832,0,1,0,1,100.0%,1h
40550,2,NeuralMutant,1832,0,1,3,4,25.0%,49m
40550,1,[II3II]XavierD,1832,0,0,1,1,0.0%,46m
40550,1,sever,1832,0,0,3,3,0.0%,47m
40550,1,[nWss]llllllllllRa,1832,0,0,3,3,0.0%,33m
40550,1,Liao,1832,0,0,3,3,0.0%,35m
40557,1,gunpower,1831,1588,48,56,104,46.2%,53m
40557,3,makc,1831,840,48,59,107,44.9%,8m
40557,3,papyrus,1831,62,4,15,19,21.1%,1h
40557,1,DemonCock,1831,107,3,5,8,37.5%,60m
40557,3,Moloko,1831,0,1,4,5,20.0%,1h
40562,1,DrunkPanda,1830,725,24,20,44,54.5%,52m
40562,3,VJAY,1830,122,4,8,12,33.3%,1h
40562,1,Cube,1830,0,1,2,3,33.3%,47m
40562,1,Bantor,1830,0,1,5,6,16.7%,1h
40562,2,ImDavid,1830,0,0,1,1,0.0%,1h
40562,3,OperCWALL,1830,0,0,5,5,0.0%,40m
40568,2,Armenius,1829,566,21,31,52,40.4%,10m
40568,1,CHAKALAN,1829,660,18,29,47,38.3%,1h
40568,2,Austra,1829,105,2,2,4,50.0%,1h
40568,1,Yuriy,1829,125,2,6,8,25.0%,41m
40568,1,Sharpblade,1829,0,1,5,6,16.7%,41m
40568,1,gawliniak,1829,73,0,2,2,0.0%,46m
40574,2,jackhammer,1828,451,37,39,76,48.7%,7m
40574,2,Nostromo,1828,176,4,13,17,23.5%,1h
40574,1,Thunder,1828,0,0,2,2,0.0%,13m
40574,3,Xarcrom,1828,0,0,6,6,0.0%,1h
40578,1,[Derpt]трататашка,1827,96,1,7,8,12.5%,1h
40578,3,VOLiMBUREK,1827,0,0,2,2,0.0%,53m
40578,3,ZeB,1827,0,0,5,5,0.0%,1h
40581,1,DJTosh,1826,869,23,29,52,44.2%,43m
40581,3,[Mastr]cooollmomins,1826,399,15,17,32,46.9%,3m
40581,1,AMNIBAL,1826,208,7,12,19,36.8%,9m
40581,3,Mcannin,1826,230,7,16,23,30.4%,46m
40581,1,Fenix,1826,222,5,14,19,26.3%,60m
40581,1,ScrappyCoCo,1826,224,4,13,17,23.5%,1h
40581,2,LaserOptic,1826,210,4,13,17,23.5%,9m
40581,1,[PGYT]LiquidClem,1826,92,1,1,2,50.0%,60m
40581,1,artik,1826,0,0,1,1,0.0%,43m
40590,3,DeusEx,1825,440,16,28,44,36.4%,54m
40590,2,YaldiBA,1825,262,8,9,17,47.1%,9m
40592,1,zei,1824,662,20,16,36,55.6%,53m
40592,1,Stalin,1824,86,2,4,6,33.3%,55m
40592,3,shurkyj,1824,0,1,2,3,33.3%,37m
40592,1,Coekie,1824,44,1,2,3,33.3%,53m
40596,3,barsik,1823,812,34,43,77,44.2%,1h
40596,3,davidrisko,1823,342,13,24,37,35.1%,52m
40598,1,alka,1822,448,11,11,22,50.0%,32m
40598,1,Tib,1822,470,11,18,29,37.9%,41m
40598,1,Vlad,1822,262,9,18,27,33.3%,57m
40598,3,Akson,1822,120,4,5,9,44.4%,1h
40598,3,Dystariel,1822,34,2,1,3,66.7%,1h
40598,1,Zeratul,1822,44,2,2,4,50.0%,60m
40598,1,inferno,1822,0,1,0,1,100.0%,12m
40605,1,[ErLi]Baracke,1821,325,12,1,13,92.3%,50m
40605,1,ПересветIvan,1821,84,3,4,7,42.9%,55m
40605,1,ProductUboja,1821,94,2,5,7,28.6%,53m
40605,3,Bancocoman,1821,0,1,13,14,7.1%,4m
40605,3,[xzw12]szymiqq,1821,0,0,1,1,0.0%,35m
40610,1,varenik,1820,603,15,18,33,45.5%,57m
40610,1,Juanjo,1820,0,1,11,12,8.3%,43m
40612,1,сайнед,1819,1124,53,93,146,36.3%,33m
40612,1,[mfxed]Domel,1819,451,11,15,26,42.3%,35m
40612,1,Dimonpokimon,1819,167,4,15,19,21.1%,47m
40612,3,Loki,1819,0,1,2,3,33.3%,53m
40612,3,Deges,1819,0,0,1,1,0.0%,53m
40617,2,Toffer,1818,323,10,24,34,29.4%,40m
40617,1,[утка]ZERGPEK,1818,168,4,14,18,22.2%,7m
40617,1,Nyx,1818,133,3,7,10,30.0%,52m
40617,3,Wraiten,1818,0,0,1,1,0.0%,53m
40617,1,MakutaXarxas,1818,0,0,1,1,0.0%,37m
40617,1,Aapdo,1818,0,0,1,1,0.0%,47m
40623,3,Tristan,1817,223,7,16,23,30.4%,15m
40623,3,Rictol,1817,62,2,10,12,16.7%,55m
40623,2,DrB,1817,102,2,10,12,16.7%,1h
40623,1,Vai,1817,0,1,1,2,50.0%,51m
40623,3,Зинго,1817,34,1,5,6,16.7%,56m
40623,1,[3Pack]VoxoV,1817,0,0,1,1,0.0%,12m
40629,3,hesienberg,1816,238,8,18,26,30.8%,37m
40629,1,[SPSes]EspaRraGO,1816,46,2,2,4,50.0%,42m
40631,3,[AgresU]Владимир,1815,0,1,3,4,25.0%,40m
40631,1,Commander,1815,44,1,5,6,16.7%,43m
40631,2,kemo,1815,0,0,2,2,0.0%,1h
40634,3,skiff,1814,295,9,10,19,47.4%,1m
40634,3,tip,1814,0,1,6,7,14.3%,1h
40634,1,DarkLemming,1814,0,1,11,12,8.3%,36m
40634,3,roadkill,1814,0,0,1,1,0.0%,1h
40638,1,Tropper,1813,1358,53,64,117,45.3%,43m
40638,3,BradToys,1813,1078,36,53,89,40.4%,35m
40638,3,Stoke,1813,634,22,30,52,42.3%,39m
40638,1,NaUghtydad,1813,138,4,7,11,36.4%,47m
40638,1,[Makkie]GekkeMarki,1813,0,0,1,1,0.0%,43m
40638,1,Bootyca,1813,0,0,3,3,0.0%,60m
40644,1,[TPZGG]Max,1812,138,4,7,11,36.4%,48m
40644,1,myAss,1812,207,3,9,12,25.0%,1h
40644,1,PoorlyDrawn,1812,94,3,16,19,15.8%,15m
40644,1,redarmy,1812,0,1,4,5,20.0%,45m
40648,1,iiieeee,1811,504,15,26,41,36.6%,42m
40648,2,sinkelis,1811,225,8,5,13,61.5%,55m
40648,3,[Covid]Eli,1811,0,0,1,1,0.0%,8m
40651,1,Skrem,1810,666,19,20,39,48.7%,45m
40651,1,Модный,1810,254,6,7,13,46.2%,51m
40651,3,lorgus,1810,0,0,1,1,0.0%,53m
40654,1,Lucenzo,1809,618,16,20,36,44.4%,13m
40654,1,[So0]AnonymBastet,1809,288,9,10,19,47.4%,55m
40654,3,Mitzonghel,1809,136,5,10,15,33.3%,56m
40654,2,LeckDay,1809,0,1,0,1,100.0%,1h
40654,1,[AniME6]ToBi,1809,0,0,1,1,0.0%,48m
40659,1,Елизяй,1808,342,10,4,14,71.4%,43m
40659,3,kart,1808,303,10,22,32,31.2%,1h
40659,2,[ВладА4]delte,1808,62,5,9,14,35.7%,57m
40659,2,kirok,1808,42,2,2,4,50.0%,1h
40659,3,Korzhik,1808,0,0,1,1,0.0%,13m
40659,1,SkyWorrier,1808,0,0,2,2,0.0%,42m
40665,1,LOLLOEFEDE,1807,536,14,23,37,37.8%,34m
40666,1,glhfTWOall,1806,901,31,74,105,29.5%,53m
40666,1,Евгений,1806,510,16,17,33,48.5%,41m
40666,3,maduduka,1806,257,12,15,27,44.4%,53m
40666,1,SuperBierMan,1806,238,6,6,12,50.0%,32m
40666,3,[CRLTNS]Alberto,1806,150,5,15,20,25.0%,41m
40666,3,[micute]Mentula,1806,32,2,0,2,100.0%,10m
40666,1,Kostyan,1806,40,1,5,6,16.7%,41m
40666,3,Emmanuel,1806,0,0,9,9,0.0%,7m
40674,1,drdisrespect,1805,674,17,27,44,38.6%,52m
40674,1,[shoo]muldrothaEDH,1805,117,2,3,5,40.0%,60m
40674,1,kotlet,1805,0,1,4,5,20.0%,37m
40674,3,pavel,1805,91,1,11,12,8.3%,1h
40674,3,Ratsistis,1805,0,0,1,1,0.0%,34m
40674,1,RamsesHH,1805,0,0,1,1,0.0%,32m
40680,1,Sesalin,1804,920,25,33,58,43.1%,34m
40680,1,Heyho,1804,184,6,14,20,30.0%,52m
40680,3,kartalm,1804,90,3,9,12,25.0%,15m
40680,1,Argus,1804,0,0,2,2,0.0%,41m
40684,1,LEPAPERE,1803,780,22,21,43,51.2%,13m
40684,1,MEN,1803,502,15,24,39,38.5%,13m
40684,3,argor,1803,172,5,9,14,35.7%,1h
40684,2,Semik,1803,0,2,7,9,22.2%,50m
40684,2,[Vizzor]Nikita,1803,0,0,1,1,0.0%,1m
40684,2,МаминСтратег,1803,0,0,1,1,0.0%,8m
40690,3,marinica,1802,30,1,9,10,10.0%,49m
40691,3,VladFreeze,1801,410,13,25,38,34.2%,55m
40692,3,Tukizi,1800,194,7,15,22,31.8%,6m
40692,3,hawkeye,1800,167,4,8,12,33.3%,35m
40692,1,[Rokk]Frain,1800,140,3,2,5,60.0%,5m
40692,1,Masi,1800,46,2,3,5,40.0%,1h
40692,2,Ian,1800,94,2,9,11,18.2%,1h
40692,1,PureLight,1800,0,0,1,1,0.0%,8m
40698,1,lachin,1799,122,4,15,19,21.1%,43m
40698,1,zeratul,1799,0,1,2,3,33.3%,41m
40698,1,[mfxed]igor,1799,0,1,13,14,7.1%,52m
40701,1,masterstrike,1798,438,31,32,63,49.2%,57m
40701,1,LeoMagico,1798,138,4,1,5,80.0%,1h
40701,1,gagge,1798,46,1,1,2,50.0%,45m
40701,2,BionicDragon,1798,42,1,3,4,25.0%,60m
40705,2,Blackdolphin,1797,784,28,40,68,41.2%,57m
40705,1,chaps,1797,465,12,10,22,54.5%,53m
40707,3,[Саваны]ilor,1796,0,1,2,3,33.3%,38m
40707,3,Spoutnik,1796,0,1,4,5,20.0%,13m
40707,1,LorTarbos,1796,73,0,8,8,0.0%,48m
40710,1,office,1795,1473,55,81,136,40.4%,10m
40710,2,CHRIS,1795,90,3,13,16,18.8%,10m
40712,3,REDIR,1794,119,3,6,9,33.3%,1h
40712,2,Kondratjuk,1794,30,1,7,8,12.5%,13m
40712,2,Bamse,1794,38,1,10,11,9.1%,1m
40715,3,koolc,1793,726,25,42,67,37.3%,8m
40715,1,[SeVenV]ElderBear,1793,807,20,27,47,42.6%,1h
40715,1,Toreas,1793,431,15,17,32,46.9%,7m
40715,2,BaZinGa,1793,80,4,22,26,15.4%,1h
40715,1,grimin,1793,38,2,11,13,15.4%,39m
40715,3,[Chaven]Jirnnobruh,1793,0,1,4,5,20.0%,47m
40715,3,Batulllek,1793,0,0,8,8,0.0%,10m
40722,1,джедай,1792,768,20,30,50,40.0%,32m
40722,1,feiwel,1792,224,5,10,15,33.3%,1h
40724,3,JonnyB,1791,179,67,100,167,40.1%,1h
40724,3,Oasis,1791,306,10,23,33,30.3%,10m
40724,1,krystian,1791,384,8,6,14,57.1%,8m
40724,1,DerCasanova,1791,0,0,1,1,0.0%,1h
40724,1,ЕСКАДРОНБГ,1791,73,0,2,2,0.0%,1h
40724,1,xenon,1791,73,0,5,5,0.0%,55m
40730,1,Zonke,1790,534,13,27,40,32.5%,49m
40730,1,selarom,1790,166,6,5,11,54.5%,50m
40730,2,Pavel,1790,156,5,10,15,33.3%,10m
40730,3,DougieB,1790,30,2,7,9,22.2%,1h
40730,2,Luis,1790,30,2,11,13,15.4%,14m
40730,1,Ragnar,1790,0,1,14,15,6.7%,32m
40730,3,Viper,1790,0,0,1,1,0.0%,1h
40737,3,xispado,1789,58,2,2,4,50.0%,35m
40737,3,[SaZ]MaXiMus,1789,0,0,1,1,0.0%,35m
40737,1,Prorok,1789,0,0,1,1,0.0%,39m
40740,3,marguzzio,1788,399,15,20,35,42.9%,1h
40741,1,Cassvi,1787,425,10,22,32,31.2%,57m
40741,1,Darius,1787,92,3,5,8,37.5%,1h
40741,2,Pandaboy,1787,0,0,1,1,0.0%,1h
40744,1,[svinik]ArmoredRaven,1786,285,5,15,20,25.0%,1h
40744,3,TubriK,1786,80,2,7,9,22.2%,53m
40744,1,sasou,1786,101,1,4,5,20.0%,13m
40744,1,MaLoU,1786,0,0,1,1,0.0%,1h
40748,1,TakSiakStef,1785,296,7,8,15,46.7%,35m
40748,2,Goose,1785,138,5,13,18,27.8%,57m
40748,1,[CxCx]karakancolos,1785,176,4,7,11,36.4%,48m
40748,1,[Harley]bezon,1785,40,2,1,3,66.7%,57m
40752,1,Zombiakkk,1784,138,3,4,7,42.9%,53m
40752,1,Reappers,1784,46,1,1,2,50.0%,9m
40752,3,Evkakiy,1784,30,1,10,11,9.1%,9m
40752,1,cakal,1784,0,0,1,1,0.0%,60m
40756,1,ЧудоГоблин,1783,740,20,20,40,50.0%,52m
40756,1,Maxexmax,1783,382,13,19,32,40.6%,13m
40756,1,LEOPARDI,1783,532,13,26,39,33.3%,60m
40756,2,GOLD,1783,82,2,11,13,15.4%,52m
40760,1,danilop,1782,166,4,4,8,50.0%,50m
40760,1,Gleboncer,1782,136,2,13,15,13.3%,1h
40760,3,aaronct,1782,0,0,1,1,0.0%,13m
40763,1,Vodoley,1781,280,7,5,12,58.3%,45m
40763,3,Liviathanx,1781,176,7,10,17,41.2%,56m
40763,3,[HZeS]JINGLEJANGLE,1781,120,5,5,10,50.0%,1h
40763,3,killersimo,1781,80,3,8,11,27.3%,37m
40763,1,BlackNalym,1781,0,1,4,5,20.0%,39m
40763,3,prol,1781,0,0,2,2,0.0%,1h
40769,1,aaaaaaaaaaa,1780,245,11,14,25,44.0%,37m
40770,1,Stefano,1779,236,6,6,12,50.0%,9m
40770,1,Mason,1779,157,2,4,6,33.3%,4m
40770,1,Zergio,1779,0,1,0,1,100.0%,39m
40770,2,tErist,1779,0,1,9,10,10.0%,59m
40770,3,Panettiere,1779,0,0,1,1,0.0%,13m
40775,3,Бориска,1778,747,26,43,69,37.7%,15m
40775,1,Azrael,1778,248,7,5,12,58.3%,53m
40775,1,ProkPRG,1778,270,7,6,13,53.8%,32m
40775,3,[Cafard]Monsterfire,1778,86,2,12,14,14.3%,44m
40775,3,[GSP1]ALZAR,1778,0,1,0,1,100.0%,56m
40775,3,Karol,1778,0,0,1,1,0.0%,13m
40781,1,AkaAtso,1776,630,15,22,37,40.5%,1h
40781,1,Бибурат,1776,48,1,2,3,33.3%,43m
40783,3,Magnus,1775,0,0,1,1,0.0%,8m
40784,3,kkurek,1774,943,39,52,91,42.9%,35m
40784,3,Greeniigames,1774,368,13,24,37,35.1%,6m
40784,1,Károly,1774,260,6,10,16,37.5%,48m
40787,2,[TeamRC]Fishy,1773,38,2,11,13,15.4%,1h
40787,1,JohnDoe,1773,44,1,4,5,20.0%,50m
40787,3,Barbarian,1773,30,1,5,6,16.7%,1h
40787,1,[Vepar]Cyclop,1773,0,0,4,4,0.0%,55m
40787,3,SimpaTillas,1773,0,0,7,7,0.0%,56m
40792,1,speedovoi,1772,325,13,15,28,46.4%,48m
40792,1,Ruben,1772,90,3,7,10,30.0%,57m
40792,3,Mozza,1772,0,2,3,5,40.0%,53m
40795,3,Zalder,1771,610,20,31,51,39.2%,1h
40795,1,jonny,1771,256,9,22,31,29.0%,39m
40795,3,[fafan]Godemperor,1771,119,3,7,10,30.0%,39m
40795,1,alex,1771,0,1,1,2,50.0%,53m
40799,3,Hideyoshi,1769,1362,72,82,154,46.8%,1h
40799,2,Sander,1769,553,18,33,51,35.3%,1h
40799,1,mittomendve,1769,252,7,7,14,50.0%,49m
40802,1,muck,1768,264,7,9,16,43.8%,45m
40802,2,DarkBeaver,1768,0,0,9,9,0.0%,39m
40804,3,Roadstar,1767,203,20,26,46,43.5%,6m
40804,3,MMK,1767,58,6,7,13,46.2%,15m
40804,1,name,1767,224,6,9,15,40.0%,55m
40804,2,CottonBanjo,1767,0,0,10,10,0.0%,38m
40808,1,SimplyBest,1766,440,11,12,23,47.8%,54m
40808,3,Maximatron,1766,58,3,3,6,50.0%,53m
40808,1,salim,1766,0,0,1,1,0.0%,32m
40811,1,GaneshJJB,1765,1919,77,104,181,42.5%,15m
40811,1,Synti,1765,257,7,19,26,26.9%,55m
40811,1,[krotSC]jom,1765,97,2,0,2,100.0%,46m
40814,1,BesugoPT,1764,916,25,33,58,43.1%,10m
40814,1,Ryu,1764,133,4,4,8,50.0%,1h
40814,1,Eterigos,1764,0,0,1,1,0.0%,42m
40814,1,[Famlly]FirezzBoyz,1764,0,0,1,1,0.0%,13m
40818,2,AITH,1763,42,2,12,14,14.3%,57m
40818,1,НИКИТА,1763,0,0,2,2,0.0%,13m
40820,3,Mitzy,1761,836,26,46,72,36.1%,1h
40820,1,Каа,1761,298,8,13,21,38.1%,50m
40822,1,Happy,1760,512,12,14,26,46.2%,1h
40822,3,Ally,1760,39,10,20,30,33.3%,6m
40822,2,[UFOG]Smugler,1760,88,5,11,16,31.2%,1h
40825,1,Sumpfeule,1759,0,2,4,6,33.3%,50m
40825,3,OSMANLI,1759,0,0,1,1,0.0%,1h
40827,1,ктото,1758,362,10,12,22,45.5%,53m
40827,3,ChilSkilBil,1758,36,1,4,5,20.0%,13m
40827,1,krista,1758,0,0,1,1,0.0%,47m
40830,1,pipo,1756,440,11,19,30,36.7%,40m
40830,1,КалибрИ,1756,186,7,10,17,41.2%,52m
40830,3,kronos,1756,30,3,4,7,42.9%,53m
40830,3,Ben,1756,0,0,6,6,0.0%,34m
40834,3,Nefrit,1755,123,3,9,12,25.0%,10m
40834,3,pankracy,1755,0,0,2,2,0.0%,7m
40836,1,Vozhich,1754,1898,70,89,159,44.0%,53m
40836,1,ekisdieou,1754,180,5,4,9,55.6%,1h
40836,1,MonsterKevin,1754,0,1,6,7,14.3%,55m
40836,3,kimirsen,1754,38,1,10,11,9.1%,40m
40840,3,Tomawak,1753,149,5,10,15,33.3%,1h
40840,1,SHADOW,1753,42,2,1,3,66.7%,1h
40842,3,Monstrbara,1752,288,10,26,36,27.8%,1h
40842,1,Marcus,1752,255,5,13,18,27.8%,35m
40842,3,sazyke,1752,0,1,2,3,33.3%,47m
40845,3,NOX,1750,124,3,15,18,16.7%,1h
40845,1,Krasavik,1750,0,2,4,6,33.3%,37m
40845,2,abri,1750,0,0,2,2,0.0%,57m
40845,3,AliRenegade,1750,0,0,3,3,0.0%,56m
40849,1,FALCON,1749,73,1,6,7,14.3%,40m
40850,3,jonson,1748,826,34,38,72,47.2%,1h
40850,2,Layr,1748,0,1,11,12,8.3%,4m
40852,1,[Puro]luiggi,1747,931,27,41,68,39.7%,1h
40852,2,Redshadow,1747,46,2,2,4,50.0%,14m
40852,3,SirTobi,1747,0,1,4,5,20.0%,56m
40855,1,Beglarov,1746,1341,68,97,165,41.2%,42m
40855,1,Kirjaban,1746,0,1,0,1,100.0%,43m
40857,1,serzlo,1745,160,5,11,16,31.2%,13m
40857,3,Gepard,1745,0,0,4,4,0.0%,40m
40859,1,WuTanG,1744,203,4,10,14,28.6%,47m
40859,1,Chiefgogo,1744,95,2,1,3,66.7%,40m
40859,1,Egorushka,1744,40,1,2,3,33.3%,52m
40859,1,Gotchaa,1744,0,1,4,5,20.0%,4m
40863,1,Streeke,1743,261,11,12,23,47.8%,1h
40863,1,Venzor,1743,0,5,2,7,71.4%,37m
40863,3,Raven,1743,0,0,1,1,0.0%,1h
40863,1,dimakoptev,1743,0,0,1,1,0.0%,42m
40867,2,MrFreaked,1742,1496,71,99,170,41.8%,5m
40867,1,Dawqara,1742,86,2,3,5,40.0%,1h
40867,1,Gnom,1742,97,2,15,17,11.8%,1h
40867,3,[4EK]Robotix,1742,0,0,1,1,0.0%,56m
40867,1,Doggi,1742,0,0,7,7,0.0%,60m
40872,1,RayRay,1741,922,24,41,65,36.9%,49m
40872,3,Sharky,1741,296,9,21,30,30.0%,37m
40874,1,ceni,1740,1274,38,46,84,45.2%,1h
40874,1,Leonidas,1740,818,27,30,57,47.4%,32m
40874,3,Lulian,1740,130,4,7,11,36.4%,38m
40877,1,[АУЕШКИ]Cobainkillme,1739,211,4,10,14,28.6%,48m
40878,3,КЕРИГАН,1738,1031,49,64,113,43.4%,60m
40878,1,феникс,1738,48,1,4,5,20.0%,53m
40880,1,RZA,1737,530,16,18,34,47.1%,47m
40880,1,Dezzert,1737,156,7,8,15,46.7%,1h
40880,1,[MKBO]BeBOP,1737,30,2,1,3,66.7%,50m
40880,3,Olga,1737,0,1,3,4,25.0%,1h
40880,3,Mhorax,1737,0,0,9,9,0.0%,1h
40885,3,swifty,1735,0,0,5,5,0.0%,1h
40886,1,Daniil,1733,131,2,14,16,12.5%,47m
40887,2,Marat,1732,468,15,30,45,33.3%,10m
40887,3,DimirVla,1732,0,2,3,5,40.0%,10m
40889,1,Zealot,1731,0,0,5,5,0.0%,60m
40890,1,bratkom,1729,303,11,8,19,57.9%,1h
40890,1,JimmyNoodlez,1729,0,1,2,3,33.3%,52m
40890,2,Privatemax,1729,0,0,2,2,0.0%,1h
40890,3,Marculius,1729,0,0,5,5,0.0%,1h
40894,1,Megatron,1728,1034,49,80,129,38.0%,1h
40894,3,ИГОРЕХА,1728,0,3,7,10,30.0%,1h
40894,1,Ottoman,1728,0,0,1,1,0.0%,32m
40894,1,Ermolay,1728,0,0,1,1,0.0%,32m
40898,3,Sparkle,1727,0,2,3,5,40.0%,1h
40898,1,Ars,1727,0,0,1,1,0.0%,60m
40900,1,buba,1726,767,23,24,47,48.9%,41m
40900,3,[CMM]CaptainWhite,1726,78,2,2,4,50.0%,1h
40900,3,dishi,1726,0,0,1,1,0.0%,56m
40903,1,fragnatik,1723,855,54,78,132,40.9%,43m
40903,1,ARTO,1723,1485,44,61,105,41.9%,52m
40903,1,andreas,1723,166,5,7,12,41.7%,54m
40906,1,SaKay,1722,150,4,9,13,30.8%,1h
40906,3,CricketArsen,1722,44,1,10,11,9.1%,1h
40906,1,EsAnderst,1722,0,0,6,6,0.0%,49m
40909,1,Nves,1721,717,29,32,61,47.5%,10m
40909,1,HERVE,1721,974,28,32,60,46.7%,42m
40911,1,achile,1720,878,23,36,59,39.0%,50m
40911,1,TRAFKA,1720,391,11,17,28,39.3%,1h
40911,3,[DZTK]NoNLoSo,1720,0,0,1,1,0.0%,47m
40911,3,Daeliavan,1720,0,0,10,10,0.0%,1h
40915,1,Tofalka,1719,394,14,29,43,32.6%,52m
40915,1,[Zhig]TinebrisElv,1719,270,8,7,15,53.3%,57m
40915,2,legohitler,1719,44,1,11,12,8.3%,1h
40918,1,Olaf,1718,308,7,16,23,30.4%,52m
40919,1,Fightscanner,1717,520,16,20,36,44.4%,15m
40919,1,BOROC,1717,478,15,11,26,57.7%,7m
40919,2,starBax,1717,174,6,18,24,25.0%,1h
40919,1,JJustice,1717,128,3,3,6,50.0%,1h
40919,3,[lkgg]ДЕШЁФФКА,1717,0,1,0,1,100.0%,10m
40919,1,tikhonovegor,1717,0,0,1,1,0.0%,1h
40919,1,[прас]Dyus,1717,0,0,1,1,0.0%,1h
40926,1,[izék]paleotom,1716,113,1,4,5,20.0%,7m
40926,3,technocarla,1716,30,1,9,10,10.0%,7m
40928,1,Marrow,1714,778,22,33,55,40.0%,5m
40928,3,[mfxed]WitchHammer,1714,30,2,2,4,50.0%,10m
40928,1,Yury,1714,0,2,4,6,33.3%,1h
40931,3,Naksio,1713,18,2,1,3,66.7%,38m
40931,3,[kill2u]Jaromiliasty,1713,74,2,3,5,40.0%,56m
40933,3,Ferranscio,1712,145,4,9,13,30.8%,4m
40933,3,Rudimentary,1712,0,1,4,5,20.0%,44m
40935,3,SuperVito,1711,44,1,1,2,50.0%,56m
40935,1,Tommaso,1711,0,0,1,1,0.0%,1h
40937,1,Speld,1710,46,1,5,6,16.7%,10m
40938,3,Zachay,1708,60,2,12,14,14.3%,8m
40938,1,[MWES]Bombo,1708,46,1,3,4,25.0%,46m
40938,3,БорисБритва,1708,0,1,4,5,20.0%,1h
40938,3,CleverAlexAU,1708,0,1,7,8,12.5%,1h
40938,1,[GNinja]violentCry,1708,0,0,1,1,0.0%,53m
40943,3,Sotomayor,1707,665,25,46,71,35.2%,39m
40943,3,[valdaa]Valda,1707,0,1,1,2,50.0%,1h
40943,3,Darknss,1707,0,0,1,1,0.0%,8m
40946,2,IIIIIIIIIIII,1706,266,7,65,72,9.7%,14m
40946,3,bouge,1706,66,3,11,14,21.4%,10m
40946,1,den,1706,0,1,2,3,33.3%,42m
40949,1,[EnFi]Jakubsek,1705,0,1,2,3,33.3%,32m
40950,1,Romulus,1704,1094,58,83,141,41.1%,49m
40950,1,Feketevölgy,1704,176,4,12,16,25.0%,60m
40950,1,WielkiBUM,1704,82,2,3,5,40.0%,41m
40953,1,Artem,1703,443,14,19,33,42.4%,4m
40953,1,[ShDg]Steigen,1703,170,4,12,16,25.0%,42m
40953,3,Сырок,1703,0,0,1,1,0.0%,1h
40953,1,MASTER,1703,0,0,1,1,0.0%,41m
40957,1,Khary,1702,295,9,11,20,45.0%,1h
40957,1,StarlinkOK,1702,0,0,6,6,0.0%,1h
40959,1,Spero,1701,469,11,25,36,30.6%,10m
40959,2,Dave,1701,60,2,16,18,11.1%,1h
40959,1,Frizbee,1701,0,0,2,2,0.0%,35m
40959,1,Underlords,1701,0,0,2,2,0.0%,41m
40963,1,aiur,1700,193,8,5,13,61.5%,50m
40963,1,Raif,1700,262,7,38,45,15.6%,10m
40963,1,Rizon,1700,205,3,14,17,17.6%,49m
40963,1,Alius,1700,0,1,6,7,14.3%,13m
40963,2,fabiobest,1700,0,0,2,2,0.0%,57m
40963,1,Hadès,1700,0,0,8,8,0.0%,50m
40969,2,ZaPa,1699,199,5,6,11,45.5%,50m
40970,1,[OverX]Ruby,1698,0,0,3,3,0.0%,10m
40971,1,QawaS,1697,73,0,3,3,0.0%,1h
40972,1,[TXRio7]Erik,1696,290,10,24,34,29.4%,45m
40972,1,mitarao,1696,295,6,12,18,33.3%,46m
40972,3,SAM,1696,0,1,0,1,100.0%,1h
40972,1,Batistuta,1696,0,0,5,5,0.0%,60m
40976,1,SMOKYBANDIT,1695,865,24,28,52,46.2%,1h
40976,1,Tikitembo,1695,581,15,21,36,41.7%,43m
40976,1,Reuke,1695,306,11,12,23,47.8%,5m
40976,1,HANEKAWA,1695,255,8,18,26,30.8%,13m
40980,3,Alex,1694,0,0,2,2,0.0%,1h
40981,3,Cax,1693,381,16,25,41,39.0%,1h
40982,2,Bynder,1692,104,3,12,15,20.0%,47m
40982,1,BaradDur,1692,44,2,3,5,40.0%,43m
40982,2,[Buldog]proKirft,1692,36,1,1,2,50.0%,14m
40982,1,гидралиск,1692,0,0,1,1,0.0%,60m
40982,3,NITRY,1692,0,0,5,5,0.0%,42m
40987,3,Selcuk,1691,90,3,13,16,18.8%,10m
40987,3,leboss,1691,30,2,7,9,22.2%,7m
40987,2,[KAPAd]Ohaja,1691,88,1,3,4,25.0%,1h
40990,1,TherioN,1690,988,39,54,93,41.9%,47m
40990,2,TRekt,1690,146,4,10,14,28.6%,33m
40992,1,siriuss,1689,828,21,37,58,36.2%,7m
40993,3,Lazerturken,1688,60,2,12,14,14.3%,53m
40993,3,stimpack,1688,0,1,4,5,20.0%,34m
40993,3,Kamenia,1688,0,0,5,5,0.0%,10m
40996,1,[NLLO]Alexoss,1687,0,1,3,4,25.0%,49m
40997,1,altervi,1686,1091,32,51,83,38.6%,43m
40997,1,SilentSword,1686,505,15,20,35,42.9%,10m
40999,1,zele,1685,532,13,24,37,35.1%,1h
40999,2,brambo,1685,36,1,1,2,50.0%,14m
41001,2,Diabloo,1684,109,4,9,13,30.8%,49m
41001,1,HzUBEYDULLA,1684,80,2,6,8,25.0%,1h
41001,3,JohnyMET,1684,0,2,8,10,20.0%,1h
41001,3,Xordessa,1684,40,1,5,6,16.7%,1h
41001,2,Zenom,1684,0,0,11,11,0.0%,1h
41006,2,Bananakin,1683,303,10,10,20,50.0%,1m
41007,1,ZergNSpirit,1681,1100,31,48,79,39.2%,41m
41007,2,ZergBerry,1681,107,2,13,15,13.3%,8m
41007,1,Алешенька,1681,44,1,4,5,20.0%,34m
41007,1,Вайтмейн,1681,42,1,6,7,14.3%,48m
41011,2,SAIX,1680,542,17,38,55,30.9%,32m
41011,1,MannyRay,1680,0,2,4,6,33.3%,40m
41013,1,PandaRoux,1679,0,0,2,2,0.0%,42m
41014,1,asdf,1678,0,0,3,3,0.0%,34m
41015,3,cygan,1677,1559,96,145,241,39.8%,15m
41015,3,SallahDin,1677,30,1,3,4,25.0%,56m
41017,2,istari,1676,0,0,1,1,0.0%,2m
41018,1,ShockShone,1675,681,18,31,49,36.7%,41m
41019,2,[IWOLFI]Gillette,1674,1405,59,60,119,49.6%,56m
41019,1,RYP,1674,1673,53,83,136,39.0%,10m
41019,2,[Smarty]SeregaL,1674,0,0,1,1,0.0%,34m
41019,2,kristooof,1674,0,0,1,1,0.0%,57m
41023,1,Nirvanko,1672,1169,35,57,92,38.0%,1h
41023,1,Orisy,1672,44,3,7,10,30.0%,43m
41025,1,petiolex,1671,625,17,30,47,36.2%,7m
41025,3,Rababio,1671,130,6,25,31,19.4%,55m
41025,2,[K0RM2]толян,1671,0,0,1,1,0.0%,57m
41028,2,[CAI]Clem,1670,78,3,3,6,50.0%,1m
41029,1,creker,1669,106,5,8,13,38.5%,37m
41029,3,IDsDaddy,1669,0,0,1,1,0.0%,40m
41029,3,olics,1669,0,0,1,1,0.0%,38m
41032,3,Drakon,1668,0,0,1,1,0.0%,53m
41032,3,KoTeu,1668,0,0,4,4,0.0%,54m
41034,2,Herou,1666,0,0,5,5,0.0%,1h
41035,3,EBayOR,1665,30,3,6,9,33.3%,39m
41036,2,donddave,1664,0,0,1,1,0.0%,56m
41037,2,Efreet,1663,40,1,1,2,50.0%,60m
41037,3,Talon,1663,0,0,1,1,0.0%,7m
41039,3,EnderKnight,1662,0,1,0,1,100.0%,7m
41039,2,LackofRex,1662,73,0,4,4,0.0%,1h
41041,2,TWilnEt,1661,246,6,20,26,23.1%,1h
41041,2,Мишелин,1661,70,2,2,4,50.0%,47m
41041,1,STFUCarl,1661,0,1,3,4,25.0%,54m
41044,3,denly,1659,128,4,11,15,26.7%,44m
41044,3,BobbyLapoint,1659,0,0,9,9,0.0%,7m
41046,1,ChocoCake,1658,158,6,20,26,23.1%,58m
41047,1,MorgothPL,1657,0,1,5,6,16.7%,41m
41047,1,SantyDavid,1657,0,1,5,6,16.7%,53m
41049,1,DoctorMax,1653,756,20,37,57,35.1%,57m
41049,1,TroubleMaker,1653,0,1,14,15,6.7%,1h
41051,3,sorrel,1652,0,0,9,9,0.0%,1h
41052,1,Treydor,1651,876,33,46,79,41.8%,46m
41052,3,[pdrz]Asterot,1651,0,1,0,1,100.0%,42m
41054,1,DECIMOTERCER,1650,146,5,7,12,41.7%,1h
41054,2,robotninga,1650,0,0,1,1,0.0%,1h
41056,3,Semlog,1649,30,1,3,4,25.0%,40m
41057,1,stabiloboss,1648,0,1,12,13,7.7%,41m
41057,3,InfoDecision,1648,0,0,1,1,0.0%,38m
41059,2,Crabby,1646,0,0,2,2,0.0%,2m
41060,2,Rudzielec,1645,0,0,3,3,0.0%,56m
41061,2,JacobX,1644,834,27,39,66,40.9%,33m
41061,1,Apollonius,1644,379,9,32,41,22.0%,47m
41063,2,Wanted,1643,0,1,4,5,20.0%,1h
41064,1,[Kicx]ƔiƦus,1642,1056,178,241,419,42.5%,49m
41064,2,Kwentein,1642,217,5,17,22,22.7%,35m
41066,2,[GAMI]OlivFR,1641,314,7,13,20,35.0%,10m
41067,3,Ega,1640,0,1,0,1,100.0%,10m
41067,2,Darkness,1640,0,0,3,3,0.0%,8m
41067,3,WingsOfFire,1640,0,0,6,6,0.0%,1h
41070,3,Iris,1639,226,7,8,15,46.7%,53m
41070,2,[CREPES]octave,1639,115,2,12,14,14.3%,1h
41072,2,Manuelweiss,1636,0,0,2,2,0.0%,57m
41073,3,doctor,1635,97,3,8,11,27.3%,34m
41073,2,[svinik]MineralWalk,1635,0,2,3,5,40.0%,1h
41073,2,Deathstroke,1635,0,2,3,5,40.0%,1h
41076,1,Brags,1634,372,12,19,31,38.7%,47m
41076,1,Jamesd,1634,48,2,9,11,18.2%,13m
41078,1,DarkNess,1633,408,16,29,45,35.6%,55m
41078,2,exolothrefti,1633,120,4,17,21,19.0%,2m
41078,2,IIIIIIIIIIII,1633,102,3,2,5,60.0%,1h
41078,1,GOBLIN,1633,0,3,4,7,42.9%,50m
41082,1,Zoy,1631,350,18,30,48,37.5%,48m
41082,1,Raibina,1631,300,9,19,28,32.1%,4m
41084,2,Miguelsd,1630,36,1,2,3,33.3%,52m
41085,1,TicTac,1629,552,14,27,41,34.1%,52m
41085,2,CheesyChees,1629,303,8,4,12,66.7%,57m
41087,3,tommdelong,1628,0,2,3,5,40.0%,8m
41087,2,Nero,1628,73,1,6,7,14.3%,57m
41089,3,Antares,1627,70,2,6,8,25.0%,1h
41089,3,mortanius,1627,110,2,12,14,14.3%,43m
41091,2,Krasher,1626,0,0,5,5,0.0%,57m
41091,1,Uragan,1626,0,0,7,7,0.0%,13m
41093,2,DarkDynastie,1624,222,6,6,12,50.0%,54m
41093,3,[Gauge]Anchor,1624,30,1,5,6,16.7%,1h
41093,1,Aura,1624,0,0,4,4,0.0%,13m
41096,1,бриангур,1623,0,1,2,3,33.3%,46m
41097,2,Recknarok,1621,30,1,12,13,7.7%,5m
41098,1,teco,1619,554,14,31,45,31.1%,46m
41098,1,EssenceStrng,1619,160,5,14,19,26.3%,43m
41100,3,Underground,1618,0,0,6,6,0.0%,1h
41101,2,jimjohanson,1617,0,1,2,3,33.3%,54m
41102,1,Pataphysics,1616,250,6,10,16,37.5%,57m
41102,3,FriDen,1616,0,0,2,2,0.0%,35m
41104,3,Munh,1614,0,0,8,8,0.0%,56m
41105,1,krek,1613,333,79,113,192,41.1%,1h
41105,1,Materoxloo,1613,297,9,12,21,42.9%,41m
41107,1,northern,1612,304,10,12,22,45.5%,8m
41107,1,Anderson,1612,118,5,8,13,38.5%,1h
41107,2,LolKin,1612,30,1,4,5,20.0%,56m
41110,1,SLAKER,1611,1366,283,332,615,46.0%,5m
41111,1,[GGTGV]EkoW,1610,1479,174,437,611,28.5%,17m
41112,2,VoidWalker,1609,254,9,20,29,31.0%,57m
41112,2,Кулибякин,1609,99,1,4,5,20.0%,1h
41112,1,OlesiaYur,1609,88,1,5,6,16.7%,1h
41112,3,loczek,1609,0,0,1,1,0.0%,56m
41112,2,[2ПУПСА]Catindead,1609,0,0,3,3,0.0%,1h
41117,2,[MC2SC2]starfire,1608,0,1,0,1,100.0%,54m
41117,2,Nicer,1608,46,1,5,6,16.7%,48m
41117,2,[kek34]рассия,1608,0,0,1,1,0.0%,8m
41120,1,tartarin,1607,144,5,11,16,31.2%,46m
41120,3,luntik,1607,0,0,4,4,0.0%,1h
41122,2,harion,1605,336,11,16,27,40.7%,48m
41123,2,Mintimer,1603,250,11,26,37,29.7%,14m
41123,2,DarkAngel,1603,0,0,8,8,0.0%,52m
41125,3,Igorechelo,1601,0,0,1,1,0.0%,40m
41126,3,Skyrtax,1600,168,5,21,26,19.2%,39m
41126,3,Laz,1600,0,0,1,1,0.0%,35m
41128,2,Tinécureuil,1599,310,10,14,24,41.7%,52m
41128,2,optimusprime,1599,0,0,1,1,0.0%,54m
41130,1,Endymion,1598,578,16,26,42,38.1%,60m
41130,1,giud,1598,419,12,21,33,36.4%,50m
41130,2,DiaboluS,1598,73,1,6,7,14.3%,10m
41133,2,Endy,1597,175,12,32,44,27.3%,56m
41134,2,oSTm,1594,30,2,1,3,66.7%,39m
41134,1,Manko,1594,46,2,10,12,16.7%,37m
41136,1,Damjan,1592,0,1,17,18,5.6%,1h
41137,2,gter,1590,0,0,1,1,0.0%,10m
41138,2,[Сold]спартазерга,1588,88,1,2,3,33.3%,10m
41138,1,IIkar,1588,0,1,10,11,9.1%,8m
41140,2,InYourFace,1587,68,3,1,4,75.0%,54m
41141,2,NordFuzz,1586,822,24,55,79,30.4%,49m
41142,2,sole,1585,0,0,1,1,0.0%,50m
41143,2,Linkis,1584,121,2,4,6,33.3%,8m
41143,2,vld,1584,48,2,18,20,10.0%,47m
41143,2,Steph,1584,0,0,3,3,0.0%,1h
41146,1,hannistar,1582,42,1,8,9,11.1%,1h
41147,1,dovchar,1580,180,4,10,14,28.6%,45m
41148,3,FatAlbert,1579,0,0,4,4,0.0%,56m
41149,1,www,1578,518,14,24,38,36.8%,8m
41149,3,artur,1578,30,2,3,5,40.0%,1h
41149,2,[Coop00]Nazar,1578,0,1,1,2,50.0%,10m
41149,3,Aealo,1578,0,0,1,1,0.0%,8m
41149,2,Knotsgek,1578,0,0,2,2,0.0%,34m
41154,2,rocketboot,1577,294,8,27,35,22.9%,39m
41155,3,[АГР]SHALUN,1576,0,0,1,1,0.0%,35m
41156,2,Stalker,1575,0,0,5,5,0.0%,49m
41157,1,hbhbh,1574,209,6,14,20,30.0%,34m
41157,1,mrwoops,1574,208,5,11,16,31.2%,43m
41157,2,Roman,1574,30,1,2,3,33.3%,54m
41160,3,НЕРВНЫЙ,1571,0,0,3,3,0.0%,38m
41161,1,[13NRV]виктор,1570,382,10,29,39,25.6%,57m
41161,3,DiskSender,1570,106,5,10,15,33.3%,13m
41161,2,Hogan,1570,0,0,1,1,0.0%,1h
41164,3,Pluton,1567,0,1,3,4,25.0%,1h
41165,2,dela,1565,0,1,0,1,100.0%,58m
41165,2,LaneXoss,1565,0,0,4,4,0.0%,60m
41167,2,NightRaven,1564,502,145,184,329,44.1%,1h
41167,3,decoch,1564,0,0,1,1,0.0%,40m
41169,3,neiji,1563,0,1,5,6,16.7%,8m
41170,3,Deeathwing,1562,40,1,9,10,10.0%,38m
41170,1,matthias,1562,0,0,9,9,0.0%,42m
41170,1,Crocman,1562,0,0,11,11,0.0%,50m
41173,3,german,1560,0,1,5,6,16.7%,8m
41174,2,vigan,1559,194,6,8,14,42.9%,54m
41174,2,deathcore,1559,46,1,2,3,33.3%,42m
41174,3,AragonHaKlos,1559,46,1,14,15,6.7%,35m
41174,3,Gang,1559,0,0,1,1,0.0%,1h
41178,2,Shadowlord,1558,0,3,8,11,27.3%,1h
41179,2,Lotsata,1557,0,1,0,1,100.0%,58m
41180,2,SirSasi,1556,370,10,21,31,32.3%,60m
41180,1,[BSG19]tiziano,1556,80,3,11,14,21.4%,13m
41182,3,zerg,1555,127,3,18,21,14.3%,1h
41183,2,[APER0]Dori,1552,456,15,34,49,30.6%,52m
41184,2,Cezus,1551,0,0,4,4,0.0%,52m
41185,3,Kajus,1550,0,0,2,2,0.0%,35m
41185,3,Ben,1550,0,0,13,13,0.0%,35m
41187,2,JEDREK,1549,70,3,5,8,37.5%,52m
41187,3,Makar,1549,0,0,1,1,0.0%,1h
41189,3,[КЮ]Cklewerr,1548,0,0,3,3,0.0%,56m
41190,2,StevenGomman,1547,0,1,0,1,100.0%,1h
41191,2,[GSBLol]ogonek,1546,73,1,7,8,12.5%,58m
41192,2,Ragneton,1545,270,6,11,17,35.3%,42m
41193,2,Kto,1543,314,10,32,42,23.8%,13m
41193,2,LieAbleitung,1543,250,7,9,16,43.8%,46m
41195,3,fury,1540,0,1,7,8,12.5%,7m
41196,2,[умри]хреножук,1539,120,5,19,24,20.8%,52m
41197,2,[lsexyl]DeusVult,1537,239,10,0,10,100.0%,1h
41198,2,FAZORDASH,1536,48,1,3,4,25.0%,1h
41199,2,GALAXYMAN,1535,322,11,15,26,42.3%,2m
41200,3,SonD,1534,30,2,4,6,33.3%,1h
41200,1,viki,1534,46,1,7,8,12.5%,13m
41202,2,JEANPIERRE,1533,0,0,3,3,0.0%,60m
41203,3,[BuO]OmentumMajus,1531,832,99,240,339,29.2%,23m
41204,3,VIXUSNET,1529,0,0,1,1,0.0%,35m
41204,2,taharounalli,1529,0,0,5,5,0.0%,58m
41206,2,[Анiме]гoвнотpax,1528,0,0,6,6,0.0%,34m
41207,1,SandMasteur,1527,178,5,15,20,25.0%,60m
41208,2,RusGoliAf,1524,0,0,1,1,0.0%,1h
41209,3,Bishop,1522,0,0,1,1,0.0%,1h
41210,1,xoxlusha,1518,0,1,16,17,5.9%,42m
41210,3,paganwolf,1518,0,0,1,1,0.0%,54m
41212,3,IIIIIIIIIIII,1514,30,4,3,7,57.1%,38m
41212,2,Veon,1514,0,0,1,1,0.0%,1h
41212,3,Zephrenic,1514,0,0,5,5,0.0%,47m
41215,2,bob,1513,128,3,9,12,25.0%,39m
41215,3,Супермаг,1513,0,0,1,1,0.0%,1h
41217,3,luxepower,1511,0,0,6,6,0.0%,53m
41218,2,[ANREN]Stalex,1510,124,3,2,5,60.0%,10m
41219,2,KuBBaCZ,1509,197,5,5,10,50.0%,1h
41219,2,Ghortogg,1509,30,1,20,21,4.8%,1h
41221,2,Asd,1508,32,2,0,2,100.0%,42m
41222,2,Overmind,1503,472,13,29,42,31.0%,1h
41223,2,Malaki,1502,262,9,17,26,34.6%,1h
41223,2,alxgrb,1502,0,0,2,2,0.0%,1h
41225,2,[Dralag]Вилла,1499,439,17,15,32,53.1%,1h
41226,3,medi,1497,32,1,6,7,14.3%,42m
41227,2,[7STAR]Prejudice,1495,272,9,17,26,34.6%,1h
41228,1,Jazcab,1494,170,6,14,20,30.0%,1h
41228,2,Leeroy,1494,122,3,12,15,20.0%,1h
41228,2,ski,1494,0,0,15,15,0.0%,14m
41231,2,jhjjt,1493,119,1,15,16,6.2%,58m
41232,1,[ValidG]koluch,1488,160,5,29,34,14.7%,15m
41233,1,ademp,1483,0,3,8,11,27.3%,60m
41233,2,aniilashongo,1483,76,2,7,9,22.2%,34m
41233,2,Costel,1483,116,2,8,10,20.0%,58m
41233,3,HITMAN,1483,0,1,10,11,9.1%,47m
41237,3,linium,1482,470,13,38,51,25.5%,7m
41237,3,PizzaHunter,1482,0,1,0,1,100.0%,47m
41239,2,[TESIL]IBUPROFENO,1480,239,28,48,76,36.8%,54m
41240,3,kalt,1478,0,1,0,1,100.0%,7m
41241,2,Братишка,1473,625,21,57,78,26.9%,54m
41242,2,demoneSKILL,1465,431,15,30,45,33.3%,57m
41243,3,Lumpus,1460,0,0,1,1,0.0%,54m
41244,2,akasha,1456,0,0,2,2,0.0%,54m
41244,3,[KJ420]Capone,1456,0,0,7,7,0.0%,1h
41246,2,Гидролиск,1454,157,4,7,11,36.4%,1h
41247,2,BAHHO,1447,244,4,20,24,16.7%,52m
41247,3,matvei,1447,60,2,17,19,10.5%,57m
41249,2,vital,1446,0,1,10,11,9.1%,34m
41250,2,gouzzy,1443,0,0,17,17,0.0%,9m
41251,3,Ghost,1442,0,0,1,1,0.0%,1h
41252,3,Vampy,1441,0,1,4,5,20.0%,1h
41253,1,PIONER,1437,128,5,27,32,15.6%,35m
41254,3,Berserk,1435,0,0,1,1,0.0%,1h
41255,2,Colin,1430,814,26,58,84,31.0%,2m
41255,3,[RofIer]Bogdan,1430,30,1,2,3,33.3%,1h
41255,3,Печенка,1430,0,0,1,1,0.0%,13m
41258,3,MurlloKK,1427,0,0,1,1,0.0%,1h
41259,2,Tiberius,1426,112,3,7,10,30.0%,1h
41259,2,Hanmandu,1426,108,3,11,14,21.4%,1h
41259,3,AHSPWR,1426,30,1,2,3,33.3%,1h
41262,2,OldDirtyBug,1424,791,25,68,93,26.9%,34m
41263,3,StrayCat,1421,0,0,5,5,0.0%,1h
41264,3,Rollo,1420,60,2,2,4,50.0%,8m
41265,3,lucian,1415,30,1,2,3,33.3%,56m
41266,3,CarryMaster,1414,132,9,2,11,81.8%,42m
41267,2,IgorNick,1412,73,3,12,15,20.0%,48m
41268,3,FlissPitsche,1411,118,4,1,5,80.0%,1h
41269,2,[v8ZX7h]PATRON,1407,162,4,19,23,17.4%,59m
41270,2,FatalSyntaX,1406,463,13,38,51,25.5%,48m
41271,3,[Spett]Joongsu,1404,286,9,9,18,50.0%,42m
41272,3,егорик,1403,0,0,1,1,0.0%,56m
41273,2,arofus,1399,301,10,26,36,27.8%,57m
41274,3,azrael,1391,0,0,2,2,0.0%,7m
41275,2,ANNYULI,1386,248,7,14,21,33.3%,1h
41276,3,Lymphomathik,1385,30,1,10,11,9.1%,35m
41277,3,qwerty,1384,0,1,0,1,100.0%,7m
41278,1,SeventyOne,1382,205,6,16,22,27.3%,1h
41279,3,CAYILO,1381,0,1,1,2,50.0%,13m
41279,3,[Blek13]нагибатор,1381,0,0,4,4,0.0%,35m
41281,3,Frenga,1380,0,0,6,6,0.0%,42m
41282,3,ovi,1376,0,0,7,7,0.0%,42m
41283,3,LingLing,1373,0,0,1,1,0.0%,1h
41284,3,Utaak,1369,0,1,1,2,50.0%,53m
41285,3,Obrubok,1368,30,2,7,9,22.2%,40m
41286,1,Schnuffi,1366,60,3,24,27,11.1%,12m
41287,3,adelheit,1355,790,26,40,66,39.4%,10m
41288,3,Socrat,1351,30,1,12,13,7.7%,54m
41289,3,FakeIIIIIIII,1346,62,2,21,23,8.7%,16m
41290,3,Lauren,1343,947,137,278,415,33.0%,49m
41291,3,KaNa,1336,126,4,16,20,20.0%,1h
41292,1,Митяй,1304,60,2,22,24,8.3%,58m
41293,3,BoiIiiIIiIII,1300,282,10,31,41,24.4%,56m
41293,3,RomanPo,1300,30,1,6,7,14.3%,54m
41295,3,[Burla]Sebastijan,1298,109,6,10,16,37.5%,35m
41296,3,Alex,1286,30,2,0,2,100.0%,1h
41297,3,benuts,1285,0,0,2,2,0.0%,8m
41298,3,Disturbed,1276,32,1,3,4,25.0%,35m
41299,2,DaDi,1267,0,0,19,19,0.0%,3m
41300,3,xjtianSucks,1258,64,2,57,59,3.4%,5m
41301,3,Killer,1240,58,3,4,7,42.9%,10m
41302,3,Scoolboy,1239,0,0,5,5,0.0%,56m
41303,3,Skatie,1229,0,0,20,20,0.0%,1h
41304,3,[Gregg]EscherBacon,1216,30,2,23,25,8.0%,16m
41305,3,IIIIIIIIIIII,1207,0,0,16,16,0.0%,1h
41306,3,VoVmx,1198,0,0,2,2,0.0%,1h
41307,1,Discount,1189,0,0,19,19,0.0%,1h
41308,3,вайфочка,1188,30,1,5,6,16.7%,56m
41309,3,spawn,1171,60,2,8,10,20.0%,13m
41310,3,Falciu,1158,0,0,3,3,0.0%,42m
41311,3,Wmonster,1157,38,2,5,7,28.6%,47m
41312,2,Dune,1147,118,4,34,38,10.5%,47m
41313,2,Matte,1143,130,5,26,31,16.1%,6m
41314,3,Leizergean,1123,0,0,5,5,0.0%,56m
41315,3,APOLLO,1117,0,0,11,11,0.0%,47m
41316,3,[drain]assplay,1091,30,1,14,15,6.7%,38m
41317,3,[RIBULI]keimu,1079,30,1,1,2,50.0%,42m
41318,3,Majo,1077,0,0,5,5,0.0%,13m
41319,3,RaketenKarli,1035,0,0,12,12,0.0%,1h
41320,3,sanivek,967,26,1,50,51,2.0%,1h
41321,1,FouGere,957,73,2,62,64,3.1%,45m
41322,3,[БУБУБ]jokolak,948,30,1,13,14,7.1%,1h
41323,3,[GrimCl]WannaBGrimus,942,146,5,63,68,7.4%,9m
41324,2,Plecto,889,5,664,910,1574,42.2%,13m
41325,3,[BilieJ]MacroJackson,538,30,1,110,111,0.9%,42m
41326,2,lllIIlIIIllI,144,0,222,1408,1630,13.6%,9m
