rank,tier,name,mmr,points,wins,losses,played,winrate,age
1,1,llllllllllll,6904,1294,28,10,38,73.7%,7m
2,1,llllllllllll,6788,0,1,0,1,100.0%,20m
3,1,llllllllllll,6785,0,0,1,1,0.0%,6m
4,1,llllllllllll,6780,97,2,0,2,100.0%,7m
5,1,llllllllllll,6742,193,7,2,9,77.8%,4m
6,1,Trap,6740,0,1,0,1,100.0%,20m
7,1,llllIlllIlll,6735,169,5,0,5,100.0%,16m
8,1,llllllllllll,6710,1758,71,40,111,64.0%,20m
9,1,lIlllllIllll,6690,194,5,2,7,71.4%,4m
10,1,[인투더]IntoTheZoun,6633,190,5,1,6,83.3%,20m
11,1,[AFSC2]Stats,6628,3174,159,69,228,69.7%,4m
12,1,llllllllllll,6615,2797,91,44,135,67.4%,4m
13,1,IlIlIlIlIlIl,6613,631,22,13,35,62.9%,4m
14,1,llllllllllll,6595,48,1,2,3,33.3%,7m
15,1,llllllllllll,6540,48,2,2,4,50.0%,16m
16,1,llllllllllll,6537,0,1,1,2,50.0%,16m
17,1,Has,6472,48,2,0,2,100.0%,7m
18,1,IIIIIIIIII,6469,144,3,2,5,60.0%,6m
19,1,[TeamNV]Creator,6467,1738,41,16,57,71.9%,6m
20,1,[RYE]Zest,6458,48,2,0,2,100.0%,6m
20,1,llllllllllll,6458,0,0,2,2,0.0%,6m
22,1,PartinG,6455,3890,401,96,497,80.7%,4m
23,1,llllllllllll,6413,682,17,18,35,48.6%,4m
24,1,IIIIIIIIIII,6395,0,1,0,1,100.0%,6m
25,1,llllllllllll,6390,0,0,10,10,0.0%,16m
26,1,Classic,6387,116,2,3,5,40.0%,4m
27,1,llllllllllll,6366,3809,249,171,420,59.3%,4m
28,1,llllllllllll,6361,0,0,3,3,0.0%,16m
29,1,Classic,6344,0,0,1,1,0.0%,6m
30,1,lllllllllll,6337,73,0,1,1,0.0%,7m
31,1,llllllllllll,6327,572,12,15,27,44.4%,6m
32,1,IIIIIIIIIIII,6319,926,47,32,79,59.5%,20m
33,1,[TeamGP]Prince,6316,96,3,1,4,75.0%,16m
34,1,[인투더]Dandy,6315,0,0,1,1,0.0%,7m
35,1,llllllllllll,6308,3045,84,61,145,57.9%,4m
36,1,llllllllllll,6304,0,0,2,2,0.0%,20m
37,1,[Rush]黑羽快斗,6302,581,22,23,45,48.9%,16m
38,1,llllllllllll,6251,0,0,1,1,0.0%,16m
39,1,llllllllll,6241,96,2,4,6,33.3%,7m
40,1,[인투더]Hurricane,6228,0,0,1,1,0.0%,6m
41,1,llllIIIIllll,6221,2325,61,49,110,55.5%,4m
42,1,llllllllllll,6174,0,1,0,1,100.0%,20m
43,1,llllllllllll,6168,48,2,0,2,100.0%,7m
44,1,IlIllllIIIII,6157,468,10,7,17,58.8%,7m
45,1,IIIIIIIIIIII,6145,791,32,20,52,61.5%,20m
46,1,lllllllllll,6144,774,17,14,31,54.8%,20m
47,1,lllllllllll,6124,1441,46,35,81,56.8%,16m
48,1,llllllllllll,6120,97,2,0,2,100.0%,7m
49,1,[GGGSC2]cyan,6103,1137,24,26,50,48.0%,4m
50,1,[TeamNV]NightMare,6096,2094,132,77,209,63.2%,16m
51,1,llllllllllll,6090,0,0,1,1,0.0%,6m
52,1,[jieshi]IIIIIIIIIIII,6054,298,45,36,81,55.6%,20m
53,1,llllllllllll,6049,48,2,7,9,22.2%,6m
54,1,llllllllll,6047,372,13,14,27,48.1%,4m
54,1,llllllllllll,6047,0,1,5,6,16.7%,16m
56,1,Yoger,6044,0,1,0,1,100.0%,16m
57,1,[Yisc]llllllllllll,6011,640,15,8,23,65.2%,7m
58,1,[混元星际]iGMacSed,6007,3634,645,609,1254,51.4%,4m
59,1,llllllllllll,5984,648,28,12,40,70.0%,6m
60,1,[Hyper]EGO,5979,0,1,0,1,100.0%,20m
61,1,[Yisc]수열이,5960,3015,119,75,194,61.3%,4m
62,1,llllllllllll,5959,48,1,2,3,33.3%,16m
63,1,[무한오영종]lIIlllIIIIIl,5955,3572,699,569,1268,55.1%,4m
64,1,[인투더]IntoTheStuN,5945,48,2,0,2,100.0%,7m
65,1,llllllllllll,5939,218,6,6,12,50.0%,20m
66,1,llllllllllll,5934,96,3,0,3,100.0%,20m
67,1,llllllllllll,5922,0,0,1,1,0.0%,7m
68,1,llllIIIlIIll,5902,465,16,3,19,84.2%,16m
69,1,Emotion,5897,48,1,3,4,25.0%,20m
70,1,lllllllllll,5847,167,3,1,4,75.0%,4m
71,1,[GdAT]GyulzzinG,5825,0,0,1,1,0.0%,20m
72,1,llllllllllll,5809,0,1,1,2,50.0%,7m
73,1,[트수Crew]DPGDark,5807,48,1,4,5,20.0%,7m
74,1,TAiLS,5800,1094,187,109,296,63.2%,16m
75,1,[인투더]TYTY,5778,1176,32,19,51,62.7%,6m
76,1,llllllllllll,5774,1799,95,70,165,57.6%,6m
77,1,[Kaizi]TIME,5753,994,27,17,44,61.4%,20m
78,1,[NDW]Rimuru,5751,0,0,1,1,0.0%,20m
79,1,llllllllllll,5740,0,0,1,1,0.0%,20m
80,1,[인트로]MarineMan,5713,0,0,4,4,0.0%,7m
81,1,[AFSC2]Armani,5705,298,9,2,11,81.8%,7m
82,1,llllllllllll,5680,0,1,0,1,100.0%,16m
83,1,[αX]Gin,5676,814,30,22,52,57.7%,6m
84,1,[인투더]MyuNgSiK,5673,853,57,53,110,51.8%,7m
85,1,llllllllllll,5669,2866,246,202,448,54.9%,4m
86,1,llllllllllll,5666,712,34,9,43,79.1%,16m
87,1,IIIIIIIIIIII,5662,1995,110,74,184,59.8%,16m
88,1,llllllllllll,5656,1607,55,45,100,55.0%,4m
89,1,IIIIIIIII,5634,418,13,3,16,81.2%,20m
90,1,llllllllllll,5627,1858,78,74,152,51.3%,4m
91,1,IIIIIIII,5620,1723,79,70,149,53.0%,4m
92,1,[KRisEZ]NORTHAMERICA,5617,3192,255,181,436,58.5%,4m
93,1,DPGEnChant,5616,402,11,10,21,52.4%,16m
94,1,[原味奶茶]统一阿萨姆奶茶,5614,572,30,10,40,75.0%,6m
95,1,llllllllllll,5608,0,0,1,1,0.0%,6m
96,1,LiquidTaeJa,5607,804,24,14,38,63.2%,7m
97,1,IIIIIIIIIIII,5601,455,23,10,33,69.7%,20m
98,1,llllllllllll,5594,285,6,8,14,42.9%,20m
99,1,llllllllllll,5583,1952,223,142,365,61.1%,6m
100,1,llllllllllll,5574,2989,167,135,302,55.3%,4m
100,1,DPGCure,5574,217,7,6,13,53.8%,6m
100,1,llllllllllll,5574,0,0,2,2,0.0%,7m
103,1,[무한오영종]Americano,5573,1637,66,40,106,62.3%,4m
103,1,llllllllllll,5573,1405,36,41,77,46.8%,4m
105,1,IIIIIIIIIIII,5562,296,17,21,38,44.7%,7m
106,1,IIIIIIIIIIII,5555,538,176,107,283,62.2%,7m
107,1,[Dopen]존잘시유,5553,81,2,3,5,40.0%,7m
108,1,duckdeok,5549,1877,356,232,588,60.5%,16m
109,1,EWBRWE,5547,3244,392,332,724,54.1%,4m
110,1,KingCobra,5546,493,79,43,122,64.8%,7m
111,1,[αX]RAGNAROK,5536,1433,52,39,91,57.1%,7m
112,1,[CSO]EastToss,5531,1557,43,41,84,51.2%,4m
112,1,[韭菜收割機]llllllllllll,5531,714,42,8,50,84.0%,4m
114,1,llllllllllll,5527,0,1,0,1,100.0%,7m
115,1,IIIIIIIIIIII,5526,2258,142,111,253,56.1%,4m
116,1,[M8HEXA]Ranger,5524,376,16,12,28,57.1%,6m
117,1,근본없는빌드만씀,5508,584,16,11,27,59.3%,20m
118,1,[Lotuz]Doritos,5507,740,26,13,39,66.7%,4m
118,1,llllllllllll,5507,0,0,1,1,0.0%,7m
120,1,[개못하는]초보토스,5501,1449,95,48,143,66.4%,16m
120,1,llllllllllll,5501,632,19,5,24,79.2%,7m
122,1,llIIlIIllIlI,5489,2035,221,190,411,53.8%,6m
123,1,IIIIIIIIIIII,5483,2156,72,68,140,51.4%,4m
123,1,[SOS団]長門有希,5483,0,1,1,2,50.0%,6m
125,1,[TeamGP]LunaSea,5482,1899,66,59,125,52.8%,4m
126,1,IIIIIIIIIIII,5478,168,6,0,6,100.0%,6m
127,1,[TeamGP]Sandcastle,5475,3144,347,278,625,55.5%,4m
128,1,llllllllllll,5466,408,14,16,30,46.7%,4m
128,1,[XYFANS]llllllllllll,5466,0,1,0,1,100.0%,16m
130,1,[EMTRMT]ReZeroRem,5451,0,1,0,1,100.0%,16m
131,1,[ELS]GGoRong,5449,1429,43,31,74,58.1%,4m
131,1,[西毒]欧阳锋,5449,415,17,13,30,56.7%,16m
133,1,Moroha,5442,1308,94,33,127,74.0%,16m
134,1,[CIM]HuK,5441,539,77,80,157,49.0%,7m
135,1,IIIIIII,5440,1230,48,27,75,64.0%,4m
136,1,운영연습을해봐요,5436,501,21,16,37,56.8%,6m
137,1,[김준식]lllllllll,5429,1216,37,26,63,58.7%,4m
138,1,[αX]Asuna,5425,32,3,2,5,60.0%,20m
139,1,llllllllllll,5423,440,27,12,39,69.2%,6m
140,1,llllllllllll,5422,300,8,9,17,47.1%,7m
141,1,沧海客,5421,349,17,4,21,81.0%,16m
142,1,IIIIIIIIIIII,5419,1591,69,23,92,75.0%,4m
142,1,[NieR]YoRHa,5419,190,5,6,11,45.5%,6m
144,1,IDkid,5414,3039,181,149,330,54.8%,4m
145,1,[인투더]IntoTheBest,5413,95,2,0,2,100.0%,16m
146,1,[MFSC2]Pezz,5404,312,9,10,19,47.4%,6m
146,1,llllllllllll,5404,48,1,1,2,50.0%,7m
148,1,llllllllllll,5402,357,10,7,17,58.8%,7m
148,1,ThuocLao,5402,234,6,5,11,54.5%,6m
148,1,[네오클랜]아이어의구원자,5402,0,1,0,1,100.0%,6m
151,1,llllllllllll,5397,760,36,20,56,64.3%,16m
151,1,[李至安]이지안,5397,171,5,5,10,50.0%,4m
153,1,[αX]Summer,5394,0,0,1,1,0.0%,7m
154,1,llllllllllll,5392,731,26,45,71,36.6%,4m
155,1,Protossnam,5388,1648,122,98,220,55.5%,20m
156,1,[EMTRMT]평양냉면에백두산,5386,3081,217,169,386,56.2%,4m
157,1,IIIIIIIIIIII,5385,1283,136,112,248,54.8%,16m
158,1,llllllllllll,5381,0,1,0,1,100.0%,20m
159,1,IIIIIIIIIIII,5376,486,16,11,27,59.3%,16m
160,1,IIIIIIIIIIII,5367,0,1,0,1,100.0%,16m
161,1,[XYFANS]llllllllllll,5363,964,40,28,68,58.8%,20m
162,1,llllllllllll,5362,2414,167,139,306,54.6%,4m
163,1,[TeamGP]Bubble,5360,1825,70,65,135,51.9%,4m
164,1,llllllllllll,5353,199,6,7,13,46.2%,20m
165,1,打人沙袋壹号,5350,241,10,4,14,71.4%,7m
166,1,[인투더]SpeCial,5348,92,5,2,7,71.4%,7m
167,1,[시셀라]시셀라,5343,134,4,4,8,50.0%,6m
168,1,[Rush]Nzs,5342,2211,93,80,173,53.8%,4m
168,1,Klourid,5342,1158,68,24,92,73.9%,7m
168,1,llllllllllll,5342,381,17,18,35,48.6%,6m
171,1,蛇蛇,5338,0,0,1,1,0.0%,16m
172,1,llllllIIIIII,5336,1424,58,34,92,63.0%,4m
173,1,노가다갤러리,5328,222,7,3,10,70.0%,6m
174,1,IIIIIIIIIIII,5325,428,16,12,28,57.1%,20m
175,1,[地域拉麵]蒼雷,5321,2178,94,69,163,57.7%,4m
176,1,llllllllllll,5317,92,1,5,6,16.7%,7m
177,1,CodeForYou,5316,0,0,1,1,0.0%,20m
178,1,llllllllllll,5314,711,85,69,154,55.2%,6m
179,1,[歪比巴卜]SpLicFly,5313,429,18,10,28,64.3%,7m
180,1,[TeamGP]Gemini,5312,2500,121,102,223,54.3%,4m
181,1,[ArGKR]JusticeSimon,5306,713,19,18,37,51.4%,4m
181,1,[ENT]틱홍,5306,0,0,1,1,0.0%,6m
183,1,Ruiyichi,5303,718,40,24,64,62.5%,16m
183,1,[alka]IIIIIIIIIIII,5303,660,40,27,67,59.7%,20m
185,1,[TeamGP]CasterCurry,5302,667,37,18,55,67.3%,16m
186,1,[VVDY]Rocto,5301,1829,301,225,526,57.2%,20m
187,1,IIIIIIIIIIII,5297,947,41,31,72,56.9%,6m
187,1,[인투더]IntoTheFarmY,5297,777,30,34,64,46.9%,6m
189,1,[PTG]Daydara,5294,0,0,1,1,0.0%,7m
190,1,lIIlllIlllII,5293,2972,378,333,711,53.2%,4m
190,1,tarik,5293,276,7,13,20,35.0%,6m
192,1,Alka,5292,2968,206,175,381,54.1%,4m
192,1,[인투더]겜알못,5292,0,1,0,1,100.0%,6m
194,1,llllllllllll,5285,0,1,7,8,12.5%,7m
195,1,IIIIIIIIIIII,5284,1084,52,42,94,55.3%,7m
196,1,[인두더]IntoTheFarmY,5279,98,3,10,13,23.1%,7m
197,1,llllllllllll,5278,0,0,3,3,0.0%,6m
198,1,[ENT]추키청정수,5276,239,10,7,17,58.8%,16m
199,1,[지니오개못핵]지니오저격용,5273,1536,133,76,209,63.6%,20m
200,1,[원피스]이준상조오옷,5263,1874,98,75,173,56.6%,6m
201,1,llllllllllll,5262,916,42,38,80,52.5%,4m
201,2,llllllllllll,5262,36,1,1,2,50.0%,6m
203,1,[토스개씹사기]KIMKIMKIM,5260,609,18,9,27,66.7%,4m
204,2,ivy,5259,242,13,12,25,52.0%,3m
205,1,llllllllllll,5257,1981,88,44,132,66.7%,4m
206,2,[CIM]데스윙,5255,0,1,0,1,100.0%,3m
206,2,여캠원탑미모,5255,0,1,0,1,100.0%,3m
206,1,IIIIIIIIIIII,5255,0,1,1,2,50.0%,16m
209,2,맵핵러,5254,99,2,4,6,33.3%,3m
209,1,llllllllllll,5254,0,0,2,2,0.0%,6m
211,1,llllllllllll,5253,159,5,4,9,55.6%,6m
212,1,[GIS]DraCula,5250,2935,171,155,326,52.5%,4m
212,2,lllllllllll,5250,1535,125,116,241,51.9%,6m
214,1,[ANGG]킹킹킹킹킹,5249,2875,276,232,508,54.3%,4m
214,2,llllllllllll,5249,739,34,25,59,57.6%,6m
216,2,[밀짚모해적단]불꽃해적강백호,5246,0,0,1,1,0.0%,3m
217,2,lIIIIllIIIII,5242,1894,101,85,186,54.3%,3m
218,1,lllllllllll,5241,20,2,2,4,50.0%,16m
219,1,StarAtt,5231,1190,80,69,149,53.7%,16m
219,1,[사천팔백실화]쌉벌뤩,5231,196,7,7,14,50.0%,20m
221,1,IIIIIIIIIIII,5229,1773,75,67,142,52.8%,4m
221,2,JackOssan,5229,12,2,0,2,100.0%,3m
223,2,llllllllllll,5225,0,1,0,1,100.0%,6m
224,1,llllllllllll,5222,2223,355,315,670,53.0%,4m
224,1,[Mophat]IIIIIIIIIIII,5222,2532,241,194,435,55.4%,4m
226,2,llllllllllll,5217,541,27,34,61,44.3%,6m
227,2,Yang,5214,300,16,7,23,69.6%,3m
228,1,[KRisEZ]KimJongAdun,5210,1730,89,72,161,55.3%,4m
229,2,IlIlIllIllIl,5209,1076,55,42,97,56.7%,3m
230,2,llllllllllll,5207,328,14,11,25,56.0%,6m
231,1,IIIIIIIIIIII,5206,741,36,19,55,65.5%,4m
232,2,IlIlllIIl,5204,1028,64,37,101,63.4%,6m
233,2,[GIS]MoRiArTy,5203,1989,205,177,382,53.7%,6m
233,2,[攘外必先安内]三民主義統一中國,5203,204,10,9,19,52.6%,3m
235,2,중학생원탑입니다,5202,0,1,2,3,33.3%,6m
236,1,llllllllllll,5195,0,0,23,23,0.0%,16m
237,2,llllllllllll,5190,0,1,0,1,100.0%,3m
237,2,[Yisc]Lilpearl,5190,26,1,1,2,50.0%,6m
239,2,[벌써일년]llllllllllll,5188,326,17,11,28,60.7%,3m
240,2,IIIIIIIIIIII,5185,108,5,3,8,62.5%,6m
241,2,동래굴링,5183,26,1,1,2,50.0%,6m
242,1,[Lotuz]OneSteP,5171,992,31,29,60,51.7%,4m
243,2,hedislimane,5163,234,11,3,14,78.6%,3m
244,2,Revolution,5159,0,1,0,1,100.0%,3m
245,2,llllllllllll,5158,58,4,9,13,30.8%,3m
246,2,허벌창뷰지박사,5151,22,1,3,4,25.0%,3m
247,2,想想拔本会怎么做,5148,178,13,7,20,65.0%,3m
248,2,[무한민태홍]문재인,5146,0,0,1,1,0.0%,3m
249,2,[Dopen]Kaini,5141,76,5,8,13,38.5%,3m
249,2,[ELS]StephenCurry,5141,61,3,2,5,60.0%,3m
251,2,Ryan,5137,334,18,6,24,75.0%,6m
252,1,[안성짱]안세짱,5135,2659,689,616,1305,52.8%,4m
252,1,Rex,5135,2876,228,180,408,55.9%,4m
252,1,해병대백상사,5135,0,0,4,4,0.0%,17m
255,2,[MGameS]레이트물냉,5134,0,2,2,4,50.0%,3m
256,2,llllllllllll,5123,0,1,0,1,100.0%,3m
257,1,tyapulin,5122,1848,110,90,200,55.0%,4m
257,1,[푸른장미]Skewed,5122,1777,83,78,161,51.6%,4m
259,1,[인투더]IntoTheNalZa,5121,2689,345,323,668,51.6%,4m
260,2,llllllllllll,5116,110,8,6,14,57.1%,3m
261,1,[oNs7]SHINee,5113,615,22,16,38,57.9%,4m
262,2,llllllllllll,5110,122,8,2,10,80.0%,3m
263,2,[AoG]Sana,5105,161,13,3,16,81.2%,3m
264,2,Panda,5104,488,23,21,44,52.3%,3m
264,2,IIIIIIIIIIII,5104,192,16,12,28,57.1%,3m
264,2,IIIIIIIIIIII,5104,184,14,12,26,53.8%,3m
267,2,[NCCU]ParalyzeD,5101,0,1,0,1,100.0%,3m
268,2,llllllllllll,5100,0,0,1,1,0.0%,3m
269,1,IIIIIIIIIIII,5093,1712,94,80,174,54.0%,4m
270,2,사쿠란보,5091,0,1,1,2,50.0%,3m
271,1,Mantaza,5090,1236,60,31,91,65.9%,4m
271,2,IIIIIIIIIIII,5090,122,7,7,14,50.0%,3m
271,2,[湖南孙一峰]艾尔航母,5090,78,4,8,12,33.3%,3m
274,2,小小小橘猫,5089,0,0,1,1,0.0%,3m
275,2,IIIIIIIIIIII,5086,38,1,2,3,33.3%,3m
276,2,IllIllIllIll,5079,360,20,15,35,57.1%,3m
277,2,llllllllllll,5076,287,11,14,25,44.0%,3m
278,1,Shin,5073,334,11,20,31,35.5%,20m
279,2,[무한오영종]Bird,5071,1432,86,51,137,62.8%,3m
279,2,[CyaN]Apfel,5071,164,8,8,16,50.0%,3m
281,2,WooJiWon,5070,0,0,1,1,0.0%,6m
282,2,[무한오영종]HelloAdrian,5069,378,18,18,36,50.0%,6m
283,2,[Rocto]RoctoBestFan,5066,0,0,1,1,0.0%,6m
284,2,神族又简单又强,5065,24,4,2,6,66.7%,3m
285,2,datter,5063,0,0,1,1,0.0%,6m
286,2,[Lotuz]에류엘,5060,0,1,0,1,100.0%,3m
287,2,llllllllllll,5059,1693,74,70,144,51.4%,3m
287,2,[Dopen]IIIIIIIIIIII,5059,471,17,21,38,44.7%,3m
289,2,llllllllllll,5058,424,31,0,31,100.0%,3m
290,2,HistGemini,5057,591,30,16,46,65.2%,6m
291,2,[雨何时会停]IIIIIIIIIIII,5056,490,29,11,40,72.5%,6m
292,2,[ELSII]llllllllllll,5052,0,1,0,1,100.0%,3m
293,2,[五漢廢言]亞撒西,5051,319,23,8,31,74.2%,6m
294,2,美郦神话,5050,390,27,21,48,56.2%,3m
295,2,llllllllllll,5048,0,1,2,3,33.3%,3m
296,2,야옹이의발톱,5047,0,0,1,1,0.0%,3m
297,1,[무한오영종]강짱,5045,2493,297,249,546,54.4%,4m
297,2,[TeamNV]박서준,5045,0,0,1,1,0.0%,3m
299,1,llllllllllll,5044,826,53,30,83,63.9%,4m
300,2,Yamada,5032,166,12,6,18,66.7%,3m
301,1,[Lotuz]짝부랄,5027,1210,60,53,113,53.1%,4m
302,2,로망토스,5026,85,4,1,5,80.0%,3m
302,2,[歪比巴卜]阿巴阿巴阿巴,5026,36,3,3,6,50.0%,3m
302,2,[ELS]Hwasin,5026,0,1,0,1,100.0%,4m
305,2,[越南探親希望]超爆爛怪人蟹肉,5024,299,12,15,27,44.4%,3m
305,2,Guuuuuuuu,5024,183,8,1,9,88.9%,3m
307,2,llllllllllll,5023,1554,68,68,136,50.0%,3m
308,2,IIIIIIIIIIII,5022,0,0,5,5,0.0%,3m
309,2,Koolaid,5021,0,1,0,1,100.0%,3m
310,2,[모두하나인숲]집정관,5020,0,1,0,1,100.0%,3m
311,2,[miKi1]anioki,5019,399,27,24,51,52.9%,3m
311,2,쫄깃한전복구이,5019,118,4,1,5,80.0%,3m
313,2,[SC2HK]Random,5016,24,3,2,5,60.0%,3m
314,3,llllllllllll,5009,1174,145,120,265,54.7%,4m
315,1,오빠차화염차,5008,289,9,8,17,52.9%,6m
316,1,llllllllllll,5007,0,0,1,1,0.0%,17m
317,3,[XYFANS]carpediem,5006,447,26,15,41,63.4%,7m
318,2,小坚强,5004,0,1,2,3,33.3%,3m
319,2,llllllllllll,5002,1456,93,66,159,58.5%,3m
319,2,IIIIIIIIIIII,5002,76,1,2,3,33.3%,3m
321,3,[αX]Sonny,4995,0,1,0,1,100.0%,7m
322,3,ALoNeLeaf,4993,0,0,1,1,0.0%,20m
322,3,ZhuYan,4993,0,0,1,1,0.0%,22m
324,3,[ELS]누가봐도소리니,4990,1146,61,52,113,54.0%,20m
324,3,[무한오영종]만장일치엠브이피,4990,0,0,1,1,0.0%,7m
326,3,[벌써일년]차붐,4986,156,16,12,28,57.1%,22m
327,3,[bling]안산의간지남,4985,0,0,1,1,0.0%,4m
328,2,IIIIIIIIIII,4983,854,37,40,77,48.1%,6m
328,3,[快樂玩家]好想與你相劍,4983,0,0,1,1,0.0%,5m
330,3,IIIIIIIIIIII,4970,146,18,12,30,60.0%,20m
330,3,IIIIIIIII,4970,44,6,5,11,54.5%,5m
332,3,[迷宮]Beef,4967,0,1,0,1,100.0%,22m
332,3,[무한오영종]BlackFresh,4967,0,1,4,5,20.0%,5m
334,3,lllllllll,4964,20,3,2,5,60.0%,5m
335,3,Ramdom,4962,60,7,1,8,87.5%,5m
336,3,Hupsaiya,4961,512,36,34,70,51.4%,5m
336,3,KoF,4961,0,0,1,1,0.0%,5m
338,3,[야근싫어요]llllllllllll,4959,0,0,1,1,0.0%,20m
339,3,llllllll,4956,1583,138,100,238,58.0%,7m
340,3,영계,4955,0,0,1,1,0.0%,22m
340,3,[Gan死歐卡]KKIIII,4955,0,0,1,1,0.0%,7m
342,3,llllllllllll,4951,2,1,2,3,33.3%,3m
343,3,ililililllli,4949,157,7,4,11,63.6%,22m
344,3,OpTiMiStC,4948,8,3,2,5,60.0%,20m
345,3,[주섬욱]Jest,4947,202,24,15,39,61.5%,3m
345,1,[ELS]llllllllllll,4947,0,1,0,1,100.0%,19m
347,3,[엘클라시코]Revolution,4946,1210,71,62,133,53.4%,4m
347,3,[SofT]골짱인중다이스키,4946,346,30,28,58,51.7%,4m
349,3,IIIIIIIIIIII,4945,148,24,14,38,63.2%,7m
350,3,llllllllllll,4941,241,15,17,32,46.9%,22m
351,3,IIIIIIIIIIII,4940,54,9,4,13,69.2%,3m
352,3,SuperNova,4937,0,0,1,1,0.0%,5m
353,2,[무한오영종]불꽃,4935,2388,315,264,579,54.4%,6m
353,2,IIIIIIIIIIII,4935,35,14,14,28,50.0%,3m
355,2,문재인,4930,2409,474,435,909,52.1%,6m
355,3,IIIIIIIIIII,4930,646,46,45,91,50.5%,20m
357,2,[무한오영종]설대경영,4928,2484,130,114,244,53.3%,3m
357,3,[Primer]Plan,4928,0,1,0,1,100.0%,20m
359,3,[NGameS]교복소녀티아라,4927,4,1,1,2,50.0%,20m
360,3,[NGameS]Disco,4926,0,1,2,3,33.3%,5m
361,3,barcode,4925,114,13,12,25,52.0%,22m
362,3,[WAZAI]자능이,4923,556,47,30,77,61.0%,20m
363,3,글자를꽉채워보자,4920,431,28,31,59,47.5%,20m
364,3,IIIIIIIIIIII,4919,577,61,34,95,64.2%,22m
365,3,[Nazzi]LuftWaffe,4918,4,2,5,7,28.6%,5m
366,3,[wudi]IIIIIIIIIIII,4914,8,2,0,2,100.0%,3m
367,3,IIIIIIIIII,4911,268,10,1,11,90.9%,22m
367,3,Tachikoma,4911,0,1,0,1,100.0%,22m
369,2,llllllllllll,4905,222,17,13,30,56.7%,6m
370,3,[모두하나인숲]라이노레,4904,0,0,1,1,0.0%,4m
371,3,연락처,4900,0,0,1,1,0.0%,5m
372,2,isenguard,4899,265,23,17,40,57.5%,3m
373,2,Special,4898,664,64,47,111,57.7%,3m
373,3,EsC,4898,426,29,33,62,46.8%,22m
375,3,llllllllllll,4896,14,3,4,7,42.9%,3m
376,2,mpycuku,4895,672,49,36,85,57.6%,3m
376,3,[패자는피를]Logic,4895,56,14,8,22,63.6%,5m
378,3,[얼라이브]Adonis,4894,492,43,25,68,63.2%,4m
378,3,lIlIlIlIlIlI,4894,82,13,8,21,61.9%,22m
378,3,[ELS]llllllllllll,4894,4,2,6,8,25.0%,20m
381,3,llllllllllll,4893,620,31,8,39,79.5%,3m
382,3,[ELS]OnceStork,4892,1795,184,166,350,52.6%,3m
383,3,IllllIlllIl,4891,0,0,1,1,0.0%,4m
384,3,[NDW]MysteryMan,4890,554,33,16,49,67.3%,5m
384,2,lIlIllllllII,4890,270,14,19,33,42.4%,6m
386,3,llllllllllll,4888,0,0,1,1,0.0%,22m
387,3,llllllllllll,4887,66,4,4,8,50.0%,22m
388,3,IlIIIIllllII,4883,0,1,0,1,100.0%,3m
389,3,Simple,4879,16,4,2,6,66.7%,3m
390,3,[협동전브론즈]으앙쥬금,4876,0,1,0,1,100.0%,5m
390,3,[디아이모탈]항문에맹독충,4876,0,0,1,1,0.0%,22m
392,3,[ELS]고기파전에막걸리,4874,1121,76,14,90,84.4%,5m
393,3,IIllIIllIIll,4871,301,38,28,66,57.6%,20m
394,3,Aggie,4868,0,1,0,1,100.0%,20m
395,3,[리니지폐인]데스나이트,4866,34,7,3,10,70.0%,5m
395,3,FrostGiant,4866,2,1,2,3,33.3%,5m
397,2,[이터널]송병구,4859,2397,379,353,732,51.8%,6m
398,3,universe,4858,0,1,0,1,100.0%,5m
399,2,IIIIIIIIIIII,4854,569,53,57,110,48.2%,3m
400,3,[frymrf]IIIIIIIIIII,4852,68,14,9,23,60.9%,7m
400,3,[이터널]햄스터왕국,4852,0,0,1,1,0.0%,5m
402,3,[StorM2]WizardStorM,4849,2172,131,105,236,55.5%,5m
402,3,IIIIIIIIIIII,4849,14,3,2,5,60.0%,5m
404,3,[Lotuz]Rain,4848,0,0,1,1,0.0%,20m
405,3,llllllllllll,4846,374,8,28,36,22.2%,5m
405,3,[XYFANS]superMC,4846,8,3,1,4,75.0%,7m
407,3,llllllllllll,4841,534,47,43,90,52.2%,22m
408,3,[Raze]EviL,4840,0,0,1,1,0.0%,22m
409,3,llllllllllll,4839,20,4,6,10,40.0%,3m
409,2,[네오]Daisy,4839,88,2,8,10,20.0%,5m
411,3,StarDuck,4838,304,51,34,85,60.0%,3m
412,3,llllllllllll,4837,183,12,9,21,57.1%,5m
413,3,InfiniteWing,4836,0,1,0,1,100.0%,22m
414,2,speaknow,4833,274,20,25,45,44.4%,6m
415,3,[TeamNV]프로토스,4832,1162,116,86,202,57.4%,5m
416,3,Leo,4831,22,4,7,11,36.4%,20m
417,2,Primepwner,4830,132,7,2,9,77.8%,6m
417,3,[감휴]Suya,4830,0,1,0,1,100.0%,5m
419,3,lIllllIIIIll,4829,0,3,2,5,60.0%,5m
420,2,HuIIIIIIIIII,4827,1394,74,75,149,49.7%,6m
421,3,[오직모니카만]IIIIIIIIII,4823,645,41,42,83,49.4%,5m
422,2,TwistedXD,4822,513,31,36,67,46.3%,6m
422,3,[Ato]제주바밤바사냥개,4822,343,23,16,39,59.0%,22m
424,3,[GIS]IIIIIIIIIIII,4821,0,1,0,1,100.0%,22m
425,3,[2552]llllllllllll,4820,6,3,3,6,50.0%,5m
425,3,유령,4820,0,0,1,1,0.0%,4m
427,3,Lundi,4819,8,1,2,3,33.3%,4m
428,3,네라짐,4816,414,39,39,78,50.0%,7m
428,3,[TeamGP]NaTuRal,4816,0,1,1,2,50.0%,22m
430,3,[ANGG]Tada,4812,841,38,26,64,59.4%,5m
431,3,[모두하나인숲]젤라가,4811,186,24,21,45,53.3%,22m
432,3,IIIIIIIIIIII,4807,2092,388,363,751,51.7%,20m
432,3,llllIIIIIIII,4807,60,12,11,23,52.2%,5m
434,3,[混元星际]星际指导员,4804,18,5,5,10,50.0%,3m
434,3,[초심]초심,4804,0,0,1,1,0.0%,4m
434,3,llllllllllll,4804,0,0,1,1,0.0%,22m
437,3,AloneWolf,4801,529,240,233,473,50.7%,20m
437,2,llllllllllll,4801,0,1,1,2,50.0%,7m
439,3,[封弊者]三世,4800,20,2,2,4,50.0%,5m
440,3,IIIIIIIIIIII,4798,466,24,1,25,96.0%,4m
441,3,[인투더]IntoTheMtOSS,4797,0,1,0,1,100.0%,5m
441,3,[래더납치범]Nash,4797,0,1,0,1,100.0%,5m
443,3,이번달목표토익,4795,210,10,4,14,71.4%,3m
444,2,llllllllllll,4794,0,1,3,4,25.0%,5m
445,3,BokDaeng,4793,0,0,1,1,0.0%,20m
445,3,[우한폐렴]신안과염전,4793,0,0,1,1,0.0%,5m
447,3,[가을보리병신]부엉이에듀,4792,0,1,0,1,100.0%,4m
447,3,IlIlIIlllI,4792,0,1,4,5,20.0%,5m
449,3,DiscoProtoss,4791,250,29,29,58,50.0%,3m
450,3,[Yisc]IIlllIIlIlIl,4790,1250,327,300,627,52.2%,5m
451,3,IIIIIIIIIIII,4789,28,5,5,10,50.0%,3m
451,3,[무한엄준식]lllllllllll,4789,0,2,2,4,50.0%,4m
453,3,[oNs7]버로닷,4788,1427,92,57,149,61.7%,4m
453,3,MiniAstrea,4788,383,13,2,15,86.7%,20m
453,3,[WDY]오우야의유디,4788,0,0,1,1,0.0%,3m
456,3,llllllllllll,4787,24,7,6,13,53.8%,20m
457,3,lIIIIIIIIIIl,4786,1132,201,189,390,51.5%,5m
458,3,llllllllllll,4785,182,12,16,28,42.9%,5m
459,3,llllllllllll,4784,153,18,11,29,62.1%,3m
460,3,[Ato]해물비빔소스도둑,4783,1204,75,81,156,48.1%,5m
460,1,llllllllllll,4783,212,4,1,5,80.0%,4m
462,3,IIIIIIIIIIII,4782,1994,271,264,535,50.7%,22m
462,3,llllIlll,4782,1142,169,137,306,55.2%,5m
464,3,[Trap]ChoSungHo,4781,654,32,8,40,80.0%,22m
465,3,鱼皮花生,4779,647,24,18,42,57.1%,4m
466,3,[든챙]광전사가족,4778,1477,490,486,976,50.2%,4m
466,3,[TeamNV]HwaRanG,4778,6,3,4,7,42.9%,5m
466,3,llllllllllll,4778,0,1,1,2,50.0%,5m
469,3,Povidone,4777,616,49,48,97,50.5%,7m
469,2,IIIIIIIIIIII,4777,0,5,0,5,100.0%,3m
469,3,[RYEkr]Zest,4777,145,4,0,4,100.0%,5m
472,3,[버러지]土修海羅逗繁駭喇,4776,0,1,0,1,100.0%,5m
473,3,[인투더]IntoTheMiSo,4775,873,119,108,227,52.4%,22m
474,3,PsiOniC,4774,1329,277,273,550,50.4%,5m
474,3,[五漢廢言]塔隆親王,4774,0,0,1,1,0.0%,20m
476,3,[청하]여신청하,4772,121,2,1,3,66.7%,4m
476,3,히히,4772,0,0,1,1,0.0%,22m
478,3,[인투더]IntoTheP,4770,1026,147,139,286,51.4%,5m
478,3,[ReV]Con,4770,972,61,65,126,48.4%,22m
478,3,llllllllllll,4770,866,36,23,59,61.0%,3m
478,3,[ELS]날빌쓰면원형탈모,4770,0,0,1,1,0.0%,22m
482,3,[맢레스토랑스]IlIIIIIlllII,4768,0,0,1,1,0.0%,5m
483,3,flowering,4767,1287,84,66,150,56.0%,22m
483,3,그네타는순실,4767,0,0,1,1,0.0%,4m
485,3,iwannamaster,4766,1143,165,160,325,50.8%,5m
485,3,[무한송준의]Whyrano,4766,996,44,34,78,56.4%,4m
487,3,[인성쓰렉민석]멸치는한영이꼭지,4765,1087,46,33,79,58.2%,5m
488,3,[WAZAI]JavaStory,4764,1028,62,56,118,52.5%,5m
488,3,IIIIIIIIIIII,4764,1068,58,46,104,55.8%,5m
488,3,llllllllllll,4764,97,2,0,2,100.0%,4m
488,3,RedFeet,4764,0,0,1,1,0.0%,20m
492,3,[GGPlay]PREMIUM,4762,1268,77,50,127,60.6%,3m
493,3,아옳옳옳,4761,1211,75,47,122,61.5%,22m
493,3,[빨리섭종기원]숙련된노가다의조,4761,97,2,0,2,100.0%,7m
493,3,PartingsSon,4761,0,1,1,2,50.0%,5m
496,3,Illlllllllll,4760,442,42,39,81,51.9%,3m
497,3,Zanter,4758,0,1,1,2,50.0%,7m
498,1,llllllllllll,4754,94,2,1,3,66.7%,7m
499,3,[NGameS]MoonStar,4743,660,35,38,73,47.9%,20m
499,3,llllllllllll,4743,22,7,8,15,46.7%,5m
501,3,IIIIIIIIIIII,4742,1088,65,50,115,56.5%,5m
502,1,막순이,4740,0,0,1,1,0.0%,19m
503,3,[무한오영종]한남들의나라,4739,34,5,13,18,27.8%,4m
504,1,IIIIIIIIIIII,4736,0,0,1,1,0.0%,17m
505,3,[Lotuz]Villain,4734,552,23,20,43,53.5%,5m
506,3,[這人族爛歸爛]但操作還可以,4728,104,6,8,14,42.9%,20m
506,1,IlIlIlIlIlIl,4728,0,1,0,1,100.0%,19m
508,3,Victor,4726,18,4,5,9,44.4%,7m
509,1,JyongEda,4725,786,33,27,60,55.0%,8m
509,3,Healbathur,4725,101,3,5,8,37.5%,7m
511,3,Timo,4723,416,21,13,34,61.8%,3m
512,3,IIIIIIIIIII,4722,4,2,4,6,33.3%,3m
513,3,丹东大老肥,4719,476,26,20,46,56.5%,7m
514,3,COSMOS,4718,525,30,20,50,60.0%,20m
515,2,打團,4717,271,7,2,9,77.8%,6m
516,1,llllllllllll,4715,48,1,1,2,50.0%,19m
517,3,sam,4712,1361,106,123,229,46.3%,3m
517,1,[越南探親希望]夯特叉叉,4712,514,11,12,23,47.8%,16m
517,1,[클린백수]내나이서른넷,4712,48,1,3,4,25.0%,19m
517,1,[SofT]묘이미나,4712,0,0,1,1,0.0%,19m
521,1,大帥哥,4710,234,9,6,15,60.0%,8m
522,1,[튼튼한노예]IIIIIIIIIIII,4709,48,1,1,2,50.0%,7m
523,1,Deneb,4706,144,4,2,6,66.7%,5m
524,3,[Lotuz]HeRitage,4704,1400,119,120,239,49.8%,5m
524,1,[0I터널]Gonzo,4704,514,13,5,18,72.2%,7m
526,1,tada,4702,1834,60,31,91,65.9%,17m
526,1,운영이머에여,4702,0,0,1,1,0.0%,19m
528,2,IIIIIIIIII,4700,2241,216,219,435,49.7%,6m
529,1,llllllllllll,4699,48,2,2,4,50.0%,16m
530,1,吃瓜群众,4697,2284,88,83,171,51.5%,16m
531,3,[WAZAI]GameDay,4695,874,63,65,128,49.2%,3m
532,3,llllllllllll,4692,2011,358,351,709,50.5%,20m
533,3,llllllllllll,4689,0,3,2,5,60.0%,18m
534,3,llllllllll,4685,0,0,6,6,0.0%,4m
535,1,llllllllllll,4683,355,13,0,13,100.0%,6m
535,1,down,4683,334,7,4,11,63.6%,5m
537,3,llllllllllll,4680,1492,78,84,162,48.1%,4m
537,1,llllllllllll,4680,132,5,6,11,45.5%,18m
539,1,여명삼공팔,4675,1005,30,28,58,51.7%,18m
539,1,IllIlllIll,4675,0,0,1,1,0.0%,6m
541,1,Apocalypse,4665,0,0,1,1,0.0%,17m
542,3,[彩虹]WelshCorgi,4661,156,13,22,35,37.1%,5m
542,1,[버러지]버러지,4661,140,4,3,7,57.1%,17m
544,1,[INFNO]胖胖王子,4660,2067,122,110,232,52.6%,16m
545,3,IIIIIIIIIIIl,4659,640,31,20,51,60.8%,20m
546,3,Elaine,4658,240,25,31,56,44.6%,7m
547,1,Silky,4657,0,0,1,1,0.0%,6m
548,1,IIIIIIIIIIII,4653,380,9,14,23,39.1%,18m
549,1,[Dopen]CarGO,4652,476,12,10,22,54.5%,7m
550,2,[Equal]Insight,4651,1344,66,86,152,43.4%,3m
550,3,지훈이애미걸레련,4651,44,19,26,45,42.2%,20m
552,3,장현우제자,4649,419,21,19,40,52.5%,22m
552,1,lIllIlllIlll,4649,0,1,0,1,100.0%,16m
554,1,[AFRSC2]Stats,4647,334,8,1,9,88.9%,19m
555,1,CherryBombs,4646,190,5,5,10,50.0%,7m
555,1,IIIlIIllIIII,4646,0,1,0,1,100.0%,17m
557,1,광전사,4645,1610,44,29,73,60.3%,16m
557,1,oGsForGG,4645,688,15,16,31,48.4%,17m
559,3,llllllllllll,4643,133,7,14,21,33.3%,7m
559,1,Sight,4643,240,5,6,11,45.5%,8m
561,1,IlIllIIlIIll,4642,640,14,4,18,77.8%,5m
561,1,llllllllllll,4642,144,4,0,4,100.0%,7m
563,1,[건강]韋翔咖啡,4638,48,1,1,2,50.0%,19m
564,3,아수라발발타,4637,1887,365,363,728,50.1%,3m
564,1,llllllllllll,4637,172,5,2,7,71.4%,16m
566,3,IIIIIII,4636,1968,381,378,759,50.2%,7m
567,1,VioletKasumi,4632,2075,196,203,399,49.1%,16m
567,1,리버,4632,142,3,3,6,50.0%,16m
569,3,DOLBAEB,4630,630,30,15,45,66.7%,7m
569,1,llllllllllll,4630,384,9,5,14,64.3%,19m
571,3,llllllllllll,4628,1238,76,74,150,50.7%,4m
571,3,llllllllllll,4628,559,40,43,83,48.2%,5m
573,1,llllllllllll,4626,2170,96,93,189,50.8%,8m
574,3,llllllllllll,4624,1233,75,80,155,48.4%,5m
575,3,IIIIIIIIIIII,4623,1710,165,132,297,55.6%,3m
576,3,kjwtenic,4622,29,11,15,26,42.3%,5m
577,3,lllllIIIIIII,4621,1573,94,102,196,48.0%,7m
577,1,llllllllllll,4621,192,4,4,8,50.0%,16m
579,1,Baedibiair,4618,779,19,12,31,61.3%,16m
580,1,[노닥노닥]낙지맛게임,4617,1196,28,27,55,50.9%,17m
581,3,[bu1ld]Whun,4610,600,146,158,304,48.0%,3m
582,3,[NGameS]나갑니다나가요,4606,1312,82,93,175,46.9%,20m
582,1,[타짜]깹이,4606,0,0,1,1,0.0%,6m
584,3,Astharos,4604,550,115,89,204,56.4%,22m
585,3,llllllllllll,4601,1966,687,665,1352,50.8%,3m
585,1,[쇄국정책]Kamylra,4601,944,22,28,50,44.0%,19m
587,1,[中國共產黨]VirusThePooH,4599,0,0,1,1,0.0%,16m
588,1,[Yisc]llllllllllll,4598,2200,160,141,301,53.2%,6m
588,1,windyprotoss,4598,282,6,5,11,54.5%,7m
590,1,[네오]YuKi,4597,96,3,0,3,100.0%,7m
591,1,seCNiNE,4596,138,4,1,5,80.0%,19m
592,1,llllllllllll,4593,190,5,4,9,55.6%,4m
593,1,Blink,4592,2196,80,81,161,49.7%,4m
594,3,[인투더]IntoTheKMJ,4590,148,12,18,30,40.0%,5m
594,1,[양학나가디져]김정은,4590,368,8,6,14,57.1%,19m
596,1,[EC]高阶圣堂武士,4587,1110,26,22,48,54.2%,19m
597,1,광주광역시김형구,4586,811,30,36,66,45.5%,18m
598,1,가자미,4582,1390,37,35,72,51.4%,16m
598,1,Aeolus,4582,404,9,13,22,40.9%,7m
600,1,FlowerRain,4581,234,6,5,11,54.5%,7m
601,3,[Hyper]오직테스형바라기,4580,1926,364,369,733,49.7%,22m
601,3,[2434]TokiSada,4580,30,6,22,28,21.4%,22m
603,1,세모글로빈,4579,2114,63,64,127,49.6%,17m
604,3,[무한오영종]남훈이,4574,617,174,177,351,49.6%,3m
604,1,[αX]FEqualsMA,4574,1732,63,35,98,64.3%,16m
606,3,llllllllllll,4571,1250,460,397,857,53.7%,20m
607,1,[Ato]정대희수제자,4570,142,3,5,8,37.5%,18m
608,1,[Gan死歐卡]Kagura,4569,1532,51,49,100,51.0%,17m
609,3,CrLaren,4568,1031,297,319,616,48.2%,20m
609,1,풋고추,4568,48,1,3,4,25.0%,18m
611,1,Undefined,4567,1473,53,49,102,52.0%,17m
612,1,Palette,4564,1168,50,44,94,53.2%,4m
612,1,[코트디부아르]흑인,4564,819,25,19,44,56.8%,6m
614,1,[OM]Templer,4562,492,16,14,30,53.3%,16m
615,1,아싸겜,4561,206,5,4,9,55.6%,17m
616,1,IIIIlIIIlIII,4560,1246,31,24,55,56.4%,6m
617,1,FoeverFree,4557,96,2,1,3,66.7%,6m
618,1,[ANGG]나그네,4554,2155,162,148,310,52.3%,19m
618,3,아르테타,4554,45,14,27,41,34.1%,20m
618,1,[Rush]TopRush,4554,332,8,8,16,50.0%,17m
621,1,[NGameS]열아홉살모솔아다,4553,0,0,1,1,0.0%,6m
621,1,ieLLiMo,4553,0,0,1,1,0.0%,7m
623,1,[蘿莉正教]天之御影命,4550,1886,106,97,203,52.2%,19m
624,1,[썩션판타지]nemeSIS,4549,1373,41,37,78,52.6%,6m
625,1,테란,4548,142,4,5,9,44.4%,17m
626,1,[ELS]애무부장관,4546,1510,291,271,562,51.8%,17m
626,1,[엔타로연합]Creating,4546,560,14,9,23,60.9%,16m
626,1,random,4546,638,14,14,28,50.0%,19m
629,1,DemonDaSh,4545,66,3,2,5,60.0%,17m
630,1,Cata,4543,232,6,4,10,60.0%,16m
630,1,[두피용면도기]IlIlIlllIl,4543,0,1,0,1,100.0%,7m
632,1,[GIS]ByuNDRimaru,4542,1730,56,58,114,49.1%,18m
632,1,Desmoines,4542,0,0,1,1,0.0%,7m
634,1,PandaTank,4541,542,13,9,22,59.1%,6m
635,1,[도리]DangRyubi,4540,322,7,6,13,53.8%,17m
635,1,[NDW]Hunter,4540,0,0,2,2,0.0%,5m
637,1,민삘,4539,677,30,8,38,78.9%,16m
638,1,PINACO,4537,789,20,6,26,76.9%,16m
639,1,[VVDY]llllllllllll,4532,142,3,2,5,60.0%,17m
640,1,[래더납치범]칼립스,4531,403,12,11,23,52.2%,18m
641,1,[GIS]alleandedith,4530,0,0,1,1,0.0%,19m
642,1,DrJekyll,4528,1935,312,312,624,50.0%,7m
642,1,[偶像型男隊]LoveSongForU,4528,1308,32,30,62,51.6%,17m
644,1,llllllllllll,4522,1172,30,32,62,48.4%,5m
644,1,waveyyds,4522,282,6,4,10,60.0%,19m
646,1,큰사랑전보람,4514,748,24,9,33,72.7%,16m
646,1,mini,4514,838,19,14,33,57.6%,17m
648,1,[GITS]纯爱战神犇头人,4513,1072,26,27,53,49.1%,17m
648,1,[不讲武德]MrFun,4513,94,5,3,8,62.5%,19m
650,1,주군,4511,418,10,9,19,52.6%,17m
650,1,[GdAT]CheesyKimbap,4511,96,2,10,12,16.7%,16m
650,1,귀신,4511,48,1,1,2,50.0%,18m
653,1,IIIIIIIIIIII,4507,1398,38,28,66,57.6%,17m
654,1,[快樂玩家]童汁戀精豎濕,4505,2060,78,70,148,52.7%,17m
655,1,llllllllllll,4504,1082,175,174,349,50.1%,18m
656,1,WarchiefRich,4502,1344,41,31,72,56.9%,17m
656,1,[Yisc]Genji,4502,406,9,15,24,37.5%,17m
656,1,[무한오영종]NeedKing,4502,322,7,5,12,58.3%,17m
656,3,llllllllllll,4502,0,0,1,1,0.0%,4m
660,1,[TalenT]奧爾卡,4501,1447,134,99,233,57.5%,16m
660,1,[행복토끼]Lunasia,4501,88,2,6,8,25.0%,8m
662,3,llllllllllll,4500,321,11,28,39,28.2%,22m
663,1,llllllllllll,4498,96,2,2,4,50.0%,17m
663,1,[DVS]阿貝師傅,4498,0,0,1,1,0.0%,8m
665,1,[EPEP]떡동,4497,2117,250,245,495,50.5%,16m
666,1,llllllllllll,4496,0,0,1,1,0.0%,17m
667,1,qwerty,4495,800,22,14,36,61.1%,17m
668,3,llllllllllll,4494,58,4,1,5,80.0%,22m
668,1,打工戰士,4494,0,1,0,1,100.0%,19m
670,1,하얀유성,4492,0,0,1,1,0.0%,17m
671,1,十四歲的老婆,4491,48,1,3,4,25.0%,7m
672,3,[애니멀킹덤]치즈칩스,4486,140,21,34,55,38.2%,20m
672,1,그마찍었던사람,4486,46,1,12,13,7.7%,8m
674,1,[小妖怪]含羞草,4483,2109,817,885,1702,48.0%,8m
674,1,[Dopen]지나가던놈들,4483,0,0,1,1,0.0%,8m
676,1,hide,4481,2057,101,70,171,59.1%,17m
677,1,KeNkEn,4480,1384,63,62,125,50.4%,7m
678,1,dozer,4479,96,3,3,6,50.0%,7m
679,1,IIIIIIIIIII,4477,144,4,9,13,30.8%,6m
680,1,IllIIlllIllI,4475,1021,110,110,220,50.0%,8m
680,1,[NaNoom]머이카노,4475,188,5,3,8,62.5%,5m
680,1,차효인,4475,184,4,3,7,57.1%,17m
680,1,DarkCarrot,4475,92,2,3,5,40.0%,16m
684,3,IIIIIIIIII,4474,1689,795,850,1645,48.3%,7m
685,1,[산군山君]산군추이,4472,1289,48,42,90,53.3%,6m
686,1,[空白]imData,4470,1084,26,30,56,46.4%,6m
686,1,[ELS]김월터,4470,48,2,2,4,50.0%,17m
688,3,[ClanGP]Crush,4467,1586,96,115,211,45.5%,5m
688,1,[NGameS]NanDal,4467,939,24,22,46,52.2%,6m
688,1,네이글,4467,0,0,1,1,0.0%,19m
688,1,llllllllllll,4467,0,0,1,1,0.0%,17m
692,1,킹킹킹킹킹,4466,1847,140,159,299,46.8%,8m
693,1,[FoIIow]TOPopular,4465,96,3,5,8,37.5%,8m
694,1,[아잉협회]아잉협회장,4462,769,18,11,29,62.1%,6m
695,1,IIIIIIIIIIII,4461,179,4,12,16,25.0%,16m
695,1,Fade,4461,0,1,2,3,33.3%,6m
697,1,llllllllllll,4460,142,4,2,6,66.7%,17m
698,1,Dwei,4456,2071,162,159,321,50.5%,19m
699,1,개돼지새끼,4455,1159,41,46,87,47.1%,18m
699,1,[WDY]Plasma,4455,510,11,19,30,36.7%,8m
701,1,314872968855,4453,0,1,0,1,100.0%,6m
702,1,[老人]ItOver,4452,0,0,1,1,0.0%,17m
702,1,Apollon,4452,0,0,1,1,0.0%,19m
704,1,llllllllllll,4451,2054,95,91,186,51.1%,4m
704,1,[TalenT]llllllllllll,4451,871,49,51,100,49.0%,18m
706,1,Lefty,4449,0,1,0,1,100.0%,16m
707,1,[지니오육천감]llllllllllll,4448,324,8,10,18,44.4%,5m
708,1,llllllllllll,4447,2078,366,392,758,48.3%,6m
708,1,IlIlIlllIIIl,4447,857,52,41,93,55.9%,17m
708,1,llllllllllll,4447,236,6,4,10,60.0%,6m
711,1,허황옹,4446,2034,178,169,347,51.3%,17m
712,1,[AbsPro]LeFromage,4444,538,25,8,33,75.8%,6m
712,1,[징짱]IIIIIIIIIIII,4444,0,0,1,1,0.0%,7m
714,1,Assistance,4443,324,12,5,17,70.6%,17m
715,1,[ANGG]크롱,4442,1182,43,23,66,65.2%,19m
715,1,[근본없는빌드]Tears,4442,663,18,9,27,66.7%,5m
715,1,[이터널]Harley,4442,46,2,0,2,100.0%,6m
718,3,[Dopen]lIlIllllIIIl,4441,968,56,80,136,41.2%,7m
719,1,[毒奶色]SteakXD,4440,1194,32,31,63,50.8%,4m
719,1,[너의ol름은]IllIIIllllII,4440,0,1,0,1,100.0%,18m
721,1,Gabriel,4439,920,22,21,43,51.2%,5m
721,1,llllllllllll,4439,542,12,10,22,54.5%,16m
723,1,[즐겜유저연합]개새낔,4438,0,0,1,1,0.0%,4m
723,1,[맵핵존내많네]llllIIIIllll,4438,0,0,5,5,0.0%,17m
725,1,[SofT]반짝이,4437,552,15,10,25,60.0%,18m
725,1,Mocha,4437,0,1,0,1,100.0%,5m
727,1,[시발병신토스]SaranG,4436,708,17,26,43,39.5%,18m
728,1,[패자는피를]퇴근,4435,886,22,28,50,44.0%,6m
729,1,[인투더]IntoTheDay,4434,0,1,1,2,50.0%,16m
730,1,[NsP]Plasma,4432,48,1,2,3,33.3%,17m
731,1,Ori,4431,592,13,13,26,50.0%,6m
732,1,[밀짚모해적단]Nechobi,4429,283,8,0,8,100.0%,4m
733,1,테란,4427,900,22,29,51,43.1%,4m
733,1,kyum,4427,48,1,2,3,33.3%,6m
735,1,IIIIIIIIIIII,4426,665,25,27,52,48.1%,16m
735,1,[αX]Sehyo,4426,178,6,7,13,46.2%,16m
735,1,llllllllllll,4426,278,6,9,15,40.0%,17m
735,1,김재규선생님,4426,142,3,6,9,33.3%,5m
739,1,inmyplace,4425,575,33,20,53,62.3%,19m
739,1,[TCUCM]Show,4425,826,20,29,49,40.8%,17m
741,1,[래더납치범]Nash,4423,1617,124,125,249,49.8%,16m
741,1,[CIM]JeonG,4423,142,3,3,6,50.0%,5m
743,1,llllllllllll,4422,0,0,1,1,0.0%,16m
744,1,BWBishOp,4420,1626,79,57,136,58.1%,16m
744,1,[국방부사서병]호랑이왕국,4420,1563,73,19,92,79.3%,5m
746,1,[Dopen]Maria,4419,1442,75,67,142,52.8%,17m
746,1,[CIM]Armour,4419,1729,56,57,113,49.6%,6m
746,1,[이터널]BOSS,4419,745,18,14,32,56.2%,8m
746,1,[Dopen]입대한영한사전,4419,94,2,8,10,20.0%,6m
750,1,[ELS]hOsys,4418,30,2,0,2,100.0%,17m
751,1,Rain,4417,1955,72,43,115,62.6%,16m
751,1,달빛조각사,4417,400,12,12,24,50.0%,18m
753,3,[先突破一万局]IIIIIIIIIIII,4416,1800,481,491,972,49.5%,3m
754,1,반도체,4415,238,6,5,11,54.5%,16m
754,1,ItoMarika,4415,284,6,8,14,42.9%,7m
756,1,[Yasha]ChickenYasha,4414,48,2,0,2,100.0%,19m
757,1,我愛小隻馬大咪咪,4412,2001,87,59,146,59.6%,16m
758,1,토끼와거북이,4411,2046,93,100,193,48.2%,8m
759,1,[CrewGP]반짝이,4408,1767,63,62,125,50.4%,8m
759,1,[StorM]WidowMine,4408,557,16,14,30,53.3%,16m
761,1,[NDW]很大,4406,996,42,29,71,59.2%,5m
761,1,desperate,4406,191,3,2,5,60.0%,18m
763,1,[삼시종결자]왜란종결자,4405,48,1,3,4,25.0%,5m
764,1,떡밥,4403,350,21,12,33,63.6%,7m
764,1,Naist,4403,0,0,2,2,0.0%,18m
766,1,AcchanSiriuS,4402,264,6,11,17,35.3%,18m
766,1,[StorM]Lochts,4402,96,2,2,4,50.0%,18m
768,1,[EMTRMT]IlIlIlIlIlIl,4400,1725,86,88,174,49.4%,19m
768,1,[무한오영종]주종없음,4400,264,7,4,11,63.6%,5m
768,1,simmenfl,4400,48,1,4,5,20.0%,17m
771,1,[빠체]Revival,4398,1755,147,148,295,49.8%,17m
772,1,llllllllllll,4397,500,11,21,32,34.4%,19m
773,2,llllllllllll,4396,0,0,1,1,0.0%,8m
774,1,llllllllllll,4395,315,19,2,21,90.5%,16m
775,1,IIIIIIIIIIII,4394,1355,63,49,112,56.2%,4m
775,1,IlIllIllIlIl,4394,752,49,27,76,64.5%,18m
775,1,士緯,4394,1117,30,26,56,53.6%,18m
775,1,[遊戲暫停]蝦機八亂玩,4394,206,4,3,7,57.1%,5m
775,1,[ANGG]YbK,4394,48,2,4,6,33.3%,6m
780,1,llllllllllll,4392,0,0,6,6,0.0%,17m
781,1,llllllllllll,4391,225,5,5,10,50.0%,7m
782,1,[비트]GaoLiangXD,4388,1848,118,122,240,49.2%,4m
782,1,llllllllllll,4388,653,28,9,37,75.7%,8m
782,1,[시럽]AISEN,4388,445,15,13,28,53.6%,6m
785,3,IIIIIIIIIIII,4385,1807,983,1067,2050,48.0%,4m
785,1,IIIIIIIIIII,4385,188,4,6,10,40.0%,19m
787,1,IIIIIIIIIIII,4383,0,0,9,9,0.0%,5m
788,1,[Aslan]꽁지,4382,2082,378,331,709,53.3%,5m
788,1,[OPT]Khzz,4382,1992,121,117,238,50.8%,6m
788,1,nsz,4382,1151,31,28,59,52.5%,17m
788,1,[NGameS]녹차프라푸치노,4382,518,23,9,32,71.9%,7m
788,1,[SofT]씨엘로,4382,94,2,8,10,20.0%,17m
788,1,CHNboy,4382,0,1,0,1,100.0%,4m
794,1,취익취익,4381,272,6,6,12,50.0%,19m
795,1,배터리사랑,4379,2027,128,129,257,49.8%,6m
795,1,[돼지쉐이끼]llllllllllll,4379,0,0,1,1,0.0%,4m
797,1,둠피스트,4377,392,22,2,24,91.7%,16m
798,1,PLU,4375,1376,104,49,153,68.0%,16m
798,1,Haneokameimi,4375,1262,102,108,210,48.6%,4m
798,1,[3달만에복귀]Seoulista,4375,46,1,2,3,33.3%,17m
798,1,llllllllllll,4375,0,0,1,1,0.0%,7m
802,1,IIIIIIIIIIII,4372,1137,75,85,160,46.9%,6m
803,1,BeSt,4371,0,0,1,1,0.0%,4m
804,1,[ELS]Jun,4369,963,251,249,500,50.2%,17m
804,1,[ANGG]HaDeung,4369,1380,64,54,118,54.2%,17m
806,1,저그,4366,94,2,4,6,33.3%,5m
806,1,[TeamGP]Joli,4366,0,1,4,5,20.0%,6m
808,1,[ELS]llllllllllll,4365,232,5,5,10,50.0%,16m
809,1,XYFans,4364,367,11,8,19,57.9%,17m
809,1,[나가자]llllllllllll,4364,0,0,1,1,0.0%,19m
811,1,ShinySalt,4363,534,16,9,25,64.0%,17m
811,1,Phive,4363,230,5,6,11,45.5%,6m
811,1,왕콘,4363,0,1,3,4,25.0%,17m
814,1,[어윤수님개쩜]llllllllllll,4362,1644,97,82,179,54.2%,19m
814,1,[Mist]ProToSseD,4362,107,3,0,3,100.0%,16m
816,1,llllllllllll,4361,93,1,1,2,50.0%,18m
816,1,也可可可,4361,0,0,2,2,0.0%,17m
818,1,IIIIIIIIIIII,4360,920,37,33,70,52.9%,16m
819,1,DJDJ,4359,1971,262,264,526,49.8%,19m
819,1,[ENT]Best,4359,1502,85,72,157,54.1%,5m
821,1,IIIIIIIIIIII,4358,219,8,7,15,53.3%,4m
821,1,Underdog,4358,0,0,1,1,0.0%,18m
823,1,[줫같은민석이]인성줫같은한영이,4357,1901,111,126,237,46.8%,18m
824,1,[IWYDI]Flandre,4356,1058,91,89,180,50.6%,6m
824,1,woo,4356,92,2,4,6,33.3%,17m
826,1,solitude,4355,1298,44,34,78,56.4%,4m
827,1,[Dopen]라르고,4354,1447,45,36,81,55.6%,19m
827,1,Aswin,4354,44,1,2,3,33.3%,17m
829,1,Prime,4352,1416,91,82,173,52.6%,17m
829,1,[ZooAc]Guider,4352,675,24,22,46,52.2%,17m
831,1,[MGameS]KILLSHOT,4351,834,49,15,64,76.6%,16m
831,1,IIIIIIllllll,4351,0,1,0,1,100.0%,18m
833,1,灰之魔女伊蕾娜,4350,0,0,1,1,0.0%,4m
834,1,IlIlIIlIIlIl,4348,272,10,4,14,71.4%,16m
834,1,[教我玩蟲族l]萬夫莫敵,4348,310,8,15,23,34.8%,18m
836,1,GArasi,4347,1774,188,180,368,51.1%,16m
837,2,llllllllllll,4346,316,16,1,17,94.1%,16m
837,2,[NDW]鹇愚魜森,4346,116,4,3,7,57.1%,6m
839,1,김용완,4344,1401,77,51,128,60.2%,19m
840,2,보이루,4340,1141,48,21,69,69.6%,17m
840,1,IIIIIIIIIIII,4340,332,8,20,28,28.6%,16m
840,2,Kyle,4340,42,1,2,3,33.3%,5m
843,1,너의얼굴,4338,1008,45,51,96,46.9%,18m
843,1,bayagster,4338,1344,35,45,80,43.8%,16m
845,1,태영데시앙,4337,112,3,6,9,33.3%,19m
846,2,[쇄국정책]Sylvanas,4336,1682,93,79,172,54.1%,15m
846,2,[B0A]NongNong,4336,0,0,1,1,0.0%,5m
848,1,똥을먹는다,4335,1730,106,104,210,50.5%,16m
848,1,거품이글스,4335,1490,63,55,118,53.4%,4m
848,1,Kyuri,4335,808,62,56,118,52.5%,19m
848,2,llllllllllll,4335,68,2,4,6,33.3%,8m
852,1,[TeamGP]llIlllIlllIl,4334,374,18,3,21,85.7%,16m
853,1,안영이,4332,1762,84,77,161,52.2%,17m
853,1,Ive,4332,1231,40,37,77,51.9%,16m
853,1,[XYFANS]RedBall,4332,1104,38,37,75,50.7%,8m
853,2,HUIHUI,4332,490,16,12,28,57.1%,6m
853,1,ThunderBolt,4332,184,4,4,8,50.0%,7m
858,3,DISTURB,4331,209,11,0,11,100.0%,4m
858,2,[ELS]안정인,4331,121,4,9,13,30.8%,5m
860,2,llllllllllll,4329,157,5,8,13,38.5%,5m
861,1,[WDY]Maddox,4328,2031,402,423,825,48.7%,18m
862,1,[협동전브론즈]맬찌님,4327,605,106,105,211,50.2%,17m
863,1,MARS,4326,280,7,10,17,41.2%,16m
864,1,[이터널]강백호,4325,593,24,21,45,53.3%,16m
865,1,[TGCrew]Kcal,4324,521,21,21,42,50.0%,19m
865,3,동태찌개,4324,97,4,2,6,66.7%,17m
867,1,IIIIIIII,4323,250,11,8,19,57.9%,4m
867,2,llllllllllll,4323,192,6,3,9,66.7%,7m
867,2,[Lotuz]엠빼롱,4323,0,0,2,2,0.0%,21m
870,2,[growup]Asuna,4322,594,42,45,87,48.3%,17m
871,1,스타강사,4319,1879,98,84,182,53.8%,19m
871,2,hiuds,4319,284,10,5,15,66.7%,21m
873,1,Requiem,4316,1845,171,135,306,55.9%,18m
873,2,유리,4316,1598,87,76,163,53.4%,7m
873,1,master,4316,1968,67,72,139,48.2%,6m
873,3,Last,4316,121,7,0,7,100.0%,14m
877,1,[MirG]espanafutbol,4315,354,9,13,22,40.9%,19m
877,2,[어윤수준우승]누가연속준우승함,4315,0,0,1,1,0.0%,6m
879,1,분가분가차차차,4313,377,11,13,24,45.8%,6m
880,1,[무한오영종]LEON,4311,2001,389,414,803,48.4%,4m
880,1,[NGameS]Spotlight,4311,462,13,16,29,44.8%,19m
882,1,[MartyR]IlIIIIIII,4310,870,20,40,60,33.3%,17m
883,2,벤틸러스,4309,132,6,0,6,100.0%,5m
884,1,[我吃萊豬]改革家國動,4308,2009,312,343,655,47.6%,6m
884,2,ripcord,4308,352,17,2,19,89.5%,4m
884,2,[電磁學]時曲同學,4308,408,14,7,21,66.7%,4m
884,1,[곶통]llllllllllll,4308,46,1,4,5,20.0%,19m
888,2,[아다치]터치,4306,465,23,11,34,67.6%,8m
889,2,[무한오영종]lIlIlIlIlIlI,4304,536,20,10,30,66.7%,7m
889,2,llllllllllll,4304,0,0,2,2,0.0%,7m
889,3,JOSH,4304,0,0,5,5,0.0%,19m
892,2,베지트,4303,616,45,50,95,47.4%,17m
892,3,볼빨다싼춘기,4303,0,1,0,1,100.0%,4m
894,1,[GIS]Lon,4302,1234,34,40,74,45.9%,7m
895,1,indarkness,4300,204,6,9,15,40.0%,6m
896,2,IlIlIlIlIlIl,4297,376,13,7,20,65.0%,4m
897,1,sSKS,4295,1013,101,116,217,46.5%,18m
898,2,llllllllllll,4293,92,4,2,6,66.7%,7m
898,1,[教我玩蟲族l]松島楓本人,4293,184,4,11,15,26.7%,18m
898,1,나는야파마스,4293,46,1,5,6,16.7%,19m
901,2,검은마법사,4292,912,45,17,62,72.6%,4m
901,2,[hYdRO]Black,4292,218,6,10,16,37.5%,4m
903,2,llllllllllll,4291,355,13,15,28,46.4%,5m
903,2,[이터널]PeinMoDeGY,4291,166,6,1,7,85.7%,5m
903,2,Sweeper,4291,0,0,1,1,0.0%,4m
906,1,ymdyuki,4290,598,13,26,39,33.3%,8m
906,2,IIIIIIIIIIII,4290,98,3,3,6,50.0%,8m
906,2,[Mini]JAY,4290,46,2,3,5,40.0%,18m
909,1,[Lotuz]Ruid,4289,1853,140,156,296,47.3%,18m
909,2,[공살]llllllllllll,4289,1378,113,89,202,55.9%,6m
911,2,날강두,4286,415,17,13,30,56.7%,8m
912,2,[이터널]오천,4285,1652,176,166,342,51.5%,15m
912,1,분열기버프가시급,4285,1967,113,118,231,48.9%,16m
914,1,[DVS]NeDk,4284,437,10,12,22,45.5%,19m
914,3,[Ygan]양민,4284,0,2,2,4,50.0%,4m
916,2,kwnsgh,4283,1629,67,61,128,52.3%,5m
916,2,flower,4283,686,26,16,42,61.9%,7m
916,1,IIIIIIIIIIII,4283,190,5,17,22,22.7%,18m
916,1,상너무님,4283,72,3,12,15,20.0%,18m
920,2,[CIM]와기,4282,936,37,26,63,58.7%,15m
920,2,[병신새끼]SpiritedAway,4282,182,6,0,6,100.0%,21m
920,2,KIMMINYOUNG,4282,0,0,1,1,0.0%,17m
923,1,IIIIIIIIII,4281,569,27,26,53,50.9%,16m
924,1,llllllllllll,4280,1953,497,502,999,49.7%,19m
925,2,[허대영]호일,4279,468,16,9,25,64.0%,7m
926,1,[戰血天道]休琴忘譜逍遙遊,4277,393,21,26,47,44.7%,6m
927,1,[겨울방어]파워업각성콩벌레,4276,400,9,18,27,33.3%,19m
928,1,IlIllllllIII,4273,1355,108,99,207,52.2%,6m
928,2,마나아캐차,4273,30,2,1,3,66.7%,6m
930,2,llllllllllll,4271,1187,70,65,135,51.9%,5m
930,1,ssapo,4271,166,7,7,14,50.0%,8m
932,2,llllllllll,4270,1408,53,53,106,50.0%,5m
932,2,llllllllllll,4270,231,6,8,14,42.9%,4m
934,1,DemonKnight,4265,1966,370,382,752,49.2%,4m
934,1,[테란만패줄게]테란아미안해,4265,1934,330,340,670,49.3%,17m
936,1,IIIIIIIIIIII,4264,1753,246,265,511,48.1%,17m
936,2,llllllllllll,4264,152,19,3,22,86.4%,21m
936,1,IlIlIlIlIlll,4264,264,8,8,16,50.0%,18m
936,2,TwiLight,4264,30,1,1,2,50.0%,21m
940,3,Kagurra,4263,145,3,4,7,42.9%,8m
941,2,[해병대]백이보충대,4262,30,2,4,6,33.3%,4m
941,3,[NGameS]LShunterS,4262,0,1,0,1,100.0%,3m
943,1,[아시발밸런]심심하다,4260,713,39,48,87,44.8%,6m
944,1,lllllllll,4259,1935,645,686,1331,48.5%,18m
944,2,pikaLGO,4259,111,4,8,12,33.3%,17m
946,2,[윤습]Zion,4258,694,40,37,77,51.9%,7m
947,2,Pain,4256,520,32,30,62,51.6%,17m
947,2,모기,4256,36,1,4,5,20.0%,6m
949,2,라미님,4255,322,9,7,16,56.2%,5m
950,1,woshibaoxuet,4253,1355,127,139,266,47.7%,6m
951,1,사신토스,4252,1943,246,266,512,48.0%,7m
952,2,군번줄,4251,88,3,8,11,27.3%,16m
953,1,beyerdynamic,4250,1783,73,78,151,48.3%,4m
953,2,IlIlIIllIlIl,4250,1015,48,28,76,63.2%,18m
953,1,PhantomPaIN,4250,264,6,8,14,42.9%,8m
953,1,IllIlllllll,4250,240,5,9,14,35.7%,4m
953,2,헤타이로이,4250,42,2,1,3,66.7%,5m
953,1,llllllllllll,4250,94,2,10,12,16.7%,7m
959,2,lIIIllIlIIl,4248,594,24,10,34,70.6%,21m
959,3,[하루살이]학생카드,4248,232,8,4,12,66.7%,7m
959,2,[攘外必先安内]黑暗中的片反本,4248,70,3,1,4,75.0%,8m
962,1,尬不,4246,1820,98,117,215,45.6%,8m
962,1,kimmstr,4246,625,15,25,40,37.5%,6m
964,2,llllllllllll,4245,0,1,0,1,100.0%,16m
965,3,[Equal]AnyTime,4244,1532,342,351,693,49.4%,8m
966,2,Masamune,4242,1101,104,108,212,49.1%,7m
966,2,[MRB]FlaSh,4242,324,13,5,18,72.2%,5m
968,2,UnicInte,4241,440,14,10,24,58.3%,5m
969,2,무사지심,4240,1626,415,407,822,50.5%,6m
969,2,[Ecchi]lovenico,4240,1552,307,291,598,51.3%,5m
969,2,Soul,4240,280,8,12,20,40.0%,21m
972,1,Rucas,4239,790,147,126,273,53.8%,17m
973,1,FreedomJay,4236,1590,156,140,296,52.7%,6m
973,2,저학년학생,4236,1386,81,57,138,58.7%,5m
973,2,[WDY]Fascio,4236,134,4,4,8,50.0%,15m
976,1,[ANGG]매실,4235,270,9,9,18,50.0%,16m
977,2,llllllllllll,4234,320,10,13,23,43.5%,5m
978,2,WhyManMC,4233,276,16,1,17,94.1%,4m
978,3,llllllllllll,4233,205,11,3,14,78.6%,4m
980,2,[CL]clblack,4232,290,10,11,21,47.6%,16m
981,3,llllllllllll,4231,213,11,0,11,100.0%,22m
982,2,다레기는재밌어,4228,226,9,8,17,52.9%,21m
982,2,llllllllllll,4228,0,1,0,1,100.0%,21m
982,2,IIIIlllllIII,4228,0,1,0,1,100.0%,4m
985,1,[릴리]Antares,4224,1324,52,48,100,52.0%,6m
985,2,NeOn,4224,79,3,2,5,60.0%,8m
985,2,Suzuki,4224,30,1,6,7,14.3%,6m
988,1,정뿡뿡,4223,1817,225,219,444,50.7%,6m
988,1,IIIIIIIIIIII,4223,1115,32,35,67,47.8%,6m
988,2,베이어다이나믹,4223,242,9,4,13,69.2%,5m
991,2,[ELS]골드,4222,516,55,36,91,60.4%,8m
991,2,DMNS,4222,964,37,30,67,55.2%,8m
991,2,[ENT]Daubechies,4222,32,1,4,5,20.0%,17m
994,2,IlllIlIIlIll,4221,0,0,1,1,0.0%,3m
995,2,artboxer,4220,1618,172,180,352,48.9%,21m
995,1,lIIIllIll,4220,1932,114,131,245,46.5%,4m
997,2,Notorious,4219,250,13,2,15,86.7%,4m
997,2,Nexus,4219,0,0,1,1,0.0%,6m
999,1,팝준코,4218,1918,636,685,1321,48.1%,18m
999,2,지은이팬클럽회장,4218,0,1,1,2,50.0%,21m
1001,2,narsha,4217,94,4,5,9,44.4%,4m
1002,1,[ELS]이민열,4216,1125,37,36,73,50.7%,19m
1003,1,[스카이파이터]FireBat,4214,48,1,5,6,16.7%,6m
1004,2,JungMin,4213,30,2,0,2,100.0%,4m
1005,2,고교스투러,4212,1611,176,168,344,51.2%,8m
1005,2,송군,4212,1088,49,25,74,66.2%,18m
1007,2,[무한오영종]견과믹스,4211,1282,52,46,98,53.1%,21m
1008,1,[ANGG]karaDebiti,4210,1104,30,37,67,44.8%,8m
1009,2,Twilight,4209,654,23,25,48,47.9%,5m
1010,1,OBsTiNatE,4207,1879,110,113,223,49.3%,6m
1010,2,[이터널]하우스,4207,502,22,3,25,88.0%,18m
1010,2,burst,4207,0,0,1,1,0.0%,16m
1013,1,[무한오영종]llllllllllll,4205,1860,573,594,1167,49.1%,4m
1013,2,llllllllllll,4205,1140,73,66,139,52.5%,16m
1015,2,DimenRush,4204,1616,371,337,708,52.4%,21m
1015,1,[이터널]RealMadrid,4204,1909,208,235,443,47.0%,16m
1015,2,[4계절]차가운겨울,4204,58,2,1,3,66.7%,7m
1018,2,DinoSaur,4203,1623,174,147,321,54.2%,8m
1018,1,[TalenT]iiiiiiii,4203,1636,124,123,247,50.2%,17m
1018,2,Yuuki,4203,920,36,27,63,57.1%,5m
1021,1,[ladys]dfafsf,4201,1876,104,107,211,49.3%,18m
1021,2,天美愛心,4201,871,33,30,63,52.4%,4m
1021,1,[DarkAG]Dro,4201,207,14,4,18,77.8%,19m
1024,2,llllllllllll,4200,726,45,5,50,90.0%,8m
1024,2,IIlllllllIl,4200,290,11,9,20,55.0%,5m
1024,2,USuckS,4200,156,5,2,7,71.4%,7m
1027,2,OUEI,4198,458,15,17,32,46.9%,21m
1028,2,[ANGG]주니준,4197,1585,100,93,193,51.8%,5m
1028,2,불곰,4197,98,3,6,9,33.3%,5m
1030,1,llllllllllll,4196,1555,470,484,954,49.3%,17m
1030,2,민소리,4196,603,28,26,54,51.9%,8m
1032,2,LTE,4194,210,6,10,16,37.5%,7m
1033,3,LeonGoretzka,4192,280,14,1,15,93.3%,3m
1033,2,[GIS]CuteProbe,4192,0,1,0,1,100.0%,7m
1035,2,IIIIIIIIIII,4191,1594,140,133,273,51.3%,15m
1035,2,[SofT]ENE,4191,770,30,19,49,61.2%,3m
1035,2,IIIIIIIIIIII,4191,435,22,8,30,73.3%,16m
1038,2,Dole,4190,698,26,20,46,56.5%,4m
1038,2,[ELS]lllllllllll,4190,0,0,1,1,0.0%,4m
1040,2,llllllllllll,4189,58,2,1,3,66.7%,6m
1041,2,IIIIIIIIIIII,4188,499,34,28,62,54.8%,3m
1041,2,[해경]llllllllllll,4188,636,31,7,38,81.6%,21m
1043,2,[ELS]초보입니닷,4187,765,44,48,92,47.8%,7m
1044,2,[국방부사서병]피터팬,4186,789,40,15,55,72.7%,18m
1044,2,[아다치]하루까,4186,259,19,11,30,63.3%,15m
1044,2,llllllllllll,4186,349,18,7,25,72.0%,6m
1047,2,[KRip]Newbi,4185,542,25,9,34,73.5%,8m
1047,2,Daniel,4185,342,13,7,20,65.0%,8m
1047,2,BrowN,4185,0,0,1,1,0.0%,5m
1047,2,[星际2不朽]我不喜欢吃麻辣烫,4185,0,0,1,1,0.0%,21m
1047,2,llllllllllll,4185,0,0,1,1,0.0%,4m
1052,2,[달빛양념기사]개보디,4184,754,26,27,53,49.1%,7m
1052,1,[Dopen]설화,4184,177,8,12,20,40.0%,18m
1054,2,IIIIIIIIIIII,4183,501,22,28,50,44.0%,16m
1054,2,llllllllllll,4183,246,8,7,15,53.3%,6m
1056,2,llllllllllll,4182,734,27,24,51,52.9%,17m
1057,2,스투망해라,4180,658,44,24,68,64.7%,7m
1058,2,[Mski]Pobbes,4176,990,43,30,73,58.9%,17m
1059,2,꼬꼬마텔레또비,4175,0,0,1,1,0.0%,7m
1060,1,YvesRocher,4174,753,49,40,89,55.1%,18m
1061,1,[제발봐주세요]COm,4173,1191,64,83,147,43.5%,8m
1061,2,귀염돌이후뉘,4173,88,3,6,9,33.3%,7m
1061,2,[CEO]AgnusDeiLucy,4173,0,1,1,2,50.0%,8m
1061,2,[뭔가상큼한]ZolunariaKR,4173,0,1,3,4,25.0%,15m
1065,1,[NDW]Drima,4171,1556,43,63,106,40.6%,7m
1066,2,케이모군,4169,1084,42,41,83,50.6%,4m
1066,2,방귀대장뿡뿡이,4169,224,8,12,20,40.0%,7m
1068,1,[快樂玩家]藍教授,4168,1639,74,60,134,55.2%,19m
1069,2,[Ygan]Reverie,4167,0,1,0,1,100.0%,7m
1070,2,민트달팽이,4164,1535,77,88,165,46.7%,21m
1070,2,[게임플레이]IIIIllllllII,4164,0,0,1,1,0.0%,6m
1072,2,prophet,4163,382,29,25,54,53.7%,21m
1073,2,tomorrow,4162,1526,201,202,403,49.9%,4m
1073,2,INFINITY,4162,669,33,10,43,76.7%,5m
1075,2,Foxy,4160,1454,194,195,389,49.9%,6m
1076,2,[NuAiur]Renatus,4159,342,20,14,34,58.8%,21m
1076,2,봄비,4159,30,2,0,2,100.0%,18m
1076,2,llllllllllll,4159,0,1,1,2,50.0%,7m
1079,2,[FRIES]CrazyFriday,4158,382,12,18,30,40.0%,4m
1080,2,[GIS]ReCall,4157,1608,143,146,289,49.5%,16m
1081,2,[동방예의지국]IIIIIIIIlIII,4156,358,15,5,20,75.0%,5m
1082,2,lIIIlIlIllII,4155,1376,58,43,101,57.4%,16m
1083,2,Joker,4154,811,36,19,55,65.5%,6m
1084,2,shinobu,4151,0,1,1,2,50.0%,16m
1085,1,KIRA,4150,1744,69,76,145,47.6%,16m
1085,2,[勇敢正义部队]克哈的天黑了,4150,106,4,9,13,30.8%,6m
1087,2,IIIIIIIIII,4149,1221,59,44,103,57.3%,4m
1088,2,RedRpm,4148,60,2,4,6,33.3%,6m
1089,2,llllllllll,4147,696,48,33,81,59.3%,7m
1090,1,꽁기,4146,1868,291,317,608,47.9%,19m
1091,1,Uriver,4145,1868,180,196,376,47.9%,18m
1091,2,[Lotuz]Owl,4145,662,28,16,44,63.6%,18m
1093,2,[Yisc]Heavenly,4144,656,22,25,47,46.8%,17m
1093,2,Dreamy,4144,510,20,24,44,45.5%,21m
1095,2,冬瓜檸檬茶,4143,1526,151,145,296,51.0%,15m
1095,2,XiNo,4143,58,3,7,10,30.0%,5m
1095,2,[GIS]Recall,4143,62,2,3,5,40.0%,3m
1095,2,[異界的檢察官]仙女,4143,0,0,4,4,0.0%,18m
1099,2,Vptwos,4142,511,99,102,201,49.3%,8m
1099,2,SiHyun,4142,871,68,58,126,54.0%,6m
1099,2,[청하]베지타,4142,0,0,1,1,0.0%,5m
1102,2,스타크래프트,4141,650,31,22,53,58.5%,6m
1102,2,lllIlllIIIll,4141,140,10,13,23,43.5%,16m
1102,2,동남전사,4141,94,4,2,6,66.7%,3m
1102,2,llllllllllll,4141,96,3,3,6,50.0%,7m
1106,1,[엔타로연합]니빠,4140,1386,49,50,99,49.5%,8m
1106,2,llllllllllll,4140,535,29,13,42,69.0%,4m
1106,2,[이터널]슬픈나르시스,4140,504,18,21,39,46.2%,22m
1106,2,llllllllllll,4140,30,1,3,4,25.0%,8m
1110,3,LLLLLLLLL,4139,0,0,6,6,0.0%,5m
1111,2,llllllllllll,4138,456,17,16,33,51.5%,7m
1112,1,암흑성소,4136,1701,123,130,253,48.6%,17m
1113,2,[Yisc]메리설아,4135,100,4,3,7,57.1%,6m
1113,2,Steorra,4135,0,1,0,1,100.0%,22m
1115,2,[겨울방어]육식남,4134,90,3,3,6,50.0%,18m
1116,1,[아앙]앰흑기사단,4133,1724,270,298,568,47.5%,17m
1116,2,테란,4133,836,40,27,67,59.7%,5m
1116,2,[트수Crew]님탑레몇임,4133,0,0,1,1,0.0%,18m
1119,2,[Dopen]Bolloong,4131,86,3,4,7,42.9%,7m
1119,2,프로토스,4131,0,2,3,5,40.0%,16m
1119,2,llllllllllll,4131,30,1,1,2,50.0%,18m
1122,1,Cosine,4130,1431,54,63,117,46.2%,17m
1122,2,히드라리스크,4130,30,2,4,6,33.3%,7m
1124,2,llllllllllll,4129,889,61,2,63,96.8%,16m
1124,2,Alphonse,4129,401,34,27,61,55.7%,22m
1124,2,llllllllllll,4129,132,6,5,11,54.5%,3m
1127,2,[SSIA]TwoNTeez,4128,0,1,0,1,100.0%,6m
1127,2,IllllIlIlIlI,4128,0,0,1,1,0.0%,22m
1129,2,MarsOz,4127,1236,76,58,134,56.7%,21m
1129,3,[타짜]UniqDefect,4127,97,4,4,8,50.0%,4m
1131,2,[제니스]OperA,4126,1561,302,301,603,50.1%,7m
1131,1,[어윤수님개쩜]IIIIIIIIIIII,4126,1676,124,116,240,51.7%,8m
1131,2,hest,4126,663,26,29,55,47.3%,8m
1134,2,llllllllllll,4125,265,15,2,17,88.2%,18m
1135,2,DotDot,4124,832,46,23,69,66.7%,15m
1135,3,哥的下面是巨龍,4124,0,0,1,1,0.0%,19m
1137,2,翡翠檸檬茶,4123,770,50,47,97,51.5%,22m
1137,2,[카논]카논사랑해,4123,0,1,3,4,25.0%,17m
1139,1,아이어,4122,868,101,107,208,48.6%,18m
1139,2,인형뽑기,4122,574,31,28,59,52.5%,5m
1139,2,[송해손잡고]스타투홍보대사,4122,0,2,3,5,40.0%,16m
1142,1,Martin,4121,1694,98,122,220,44.5%,7m
1142,2,DawnFaramit,4121,0,0,2,2,0.0%,18m
1144,1,[트수Crew]CominKi,4120,1379,57,64,121,47.1%,6m
1144,2,김진평,4120,0,0,2,2,0.0%,4m
1146,3,[인투더]IntoTheLiMi,4119,1582,626,686,1312,47.7%,5m
1146,2,[CryANT]성벽,4119,40,2,0,2,100.0%,4m
1148,2,llllllllllll,4117,1593,678,686,1364,49.7%,7m
1148,1,iNbuM,4117,1822,370,395,765,48.4%,17m
1148,2,[Equal]도담도담튼튼이,4117,556,20,21,41,48.8%,18m
1148,2,Prodeus,4117,214,15,13,28,53.6%,3m
1152,2,gunhee,4116,0,2,3,5,40.0%,6m
1153,2,김유진수제자,4114,919,38,29,67,56.7%,5m
1153,2,Hypoxia,4114,470,19,10,29,65.5%,6m
1155,2,what,4113,0,3,2,5,60.0%,4m
1156,2,roka,4111,1523,96,97,193,49.7%,5m
1156,2,[테란저그토스]포도,4111,535,26,7,33,78.8%,5m
1158,2,chemistry,4110,1608,155,131,286,54.2%,5m
1158,2,삐돌이조부장,4110,1069,52,57,109,47.7%,15m
1160,2,IIIIIIIIIIII,4108,503,26,9,35,74.3%,21m
1160,2,我栖息的夏天,4108,0,0,2,2,0.0%,8m
1162,2,[RuL]Blaster,4107,30,1,6,7,14.3%,7m
1162,2,[얼굴]이키하하,4107,0,0,1,1,0.0%,8m
1164,2,[TalenT]TWstrangner,4106,1632,67,60,127,52.8%,17m
1164,2,Adorable,4106,432,16,11,27,59.3%,6m
1166,2,kotori,4105,248,18,19,37,48.6%,17m
1167,2,SHOW,4104,849,39,30,69,56.5%,6m
1168,2,토스최고,4103,1366,54,52,106,50.9%,5m
1168,3,Gosu,4103,191,5,2,7,71.4%,17m
1168,2,기린,4103,0,0,1,1,0.0%,18m
1171,2,llllllllllll,4102,30,1,3,4,25.0%,5m
1172,2,IlllIllIllI,4101,1301,98,102,200,49.0%,16m
1172,2,[Csenya]Cheshiremiao,4101,0,0,1,1,0.0%,16m
1172,2,IIIIIIIIIIII,4101,0,0,3,3,0.0%,21m
1175,2,leta,4100,337,23,28,51,45.1%,8m
1176,2,llllllllllll,4099,0,1,0,1,100.0%,18m
1177,1,胖王,4098,0,3,5,8,37.5%,5m
1177,2,[더지니어스]그림같은홈런,4098,0,0,1,1,0.0%,15m
1179,1,llllllllll,4097,1830,753,811,1564,48.1%,18m
1179,2,llllllllllll,4097,196,7,12,19,36.8%,4m
1179,3,[팝콘TV]Butnny,4097,0,0,1,1,0.0%,20m
1182,2,Dyun,4096,438,36,24,60,60.0%,16m
1182,2,kindlysu,4096,126,7,6,13,53.8%,16m
1182,2,두루미횡격막,4096,0,1,0,1,100.0%,21m
1185,2,TYTY,4095,92,4,1,5,80.0%,7m
1185,2,Bao,4095,0,1,0,1,100.0%,22m
1187,2,武漢肺炎,4093,254,9,5,14,64.3%,5m
1188,2,[Master]Guillemot,4091,42,1,1,2,50.0%,21m
1189,2,[인투더]IntoTheSHSH,4090,349,16,11,27,59.3%,16m
1190,1,딩이,4089,1809,123,135,258,47.7%,19m
1190,2,llllllllllll,4089,1585,94,75,169,55.6%,21m
1190,2,battle,4089,411,53,61,114,46.5%,22m
1190,2,HKcow,4089,1144,43,40,83,51.8%,6m
1190,2,[s2Mc]SUITBOX,4089,316,12,11,23,52.2%,5m
1195,2,[안성짱]스시먹는김구,4087,0,0,1,1,0.0%,7m
1196,2,JaheeFan,4085,532,29,9,38,76.3%,18m
1197,3,눈사람,4084,238,10,3,13,76.9%,4m
1197,2,[홍대EXP]NalRa,4084,0,0,1,1,0.0%,18m
1199,2,[sc2mc]ragenick,4083,147,9,3,12,75.0%,3m
1200,2,sugo,4082,1555,357,346,703,50.8%,6m
1200,3,[네임]KKaMSI,4082,97,2,1,3,66.7%,7m
1202,2,Cognite,4081,198,8,5,13,61.5%,17m
1203,2,Medic,4079,0,1,0,1,100.0%,6m
1203,2,영재,4079,0,0,1,1,0.0%,22m
1205,2,[DNKCFT]FLORENCIO,4078,142,6,2,8,75.0%,4m
1206,3,zenon,4077,0,0,1,1,0.0%,20m
1207,2,[Rush]AirdRush,4076,617,25,15,40,62.5%,21m
1208,2,HyL,4075,1591,74,93,167,44.3%,18m
1208,3,Futurecore,4075,121,3,2,5,60.0%,19m
1208,2,RainDrops,4075,30,3,3,6,50.0%,6m
1211,1,[이터널]연겜만한다,4073,1820,144,142,286,50.3%,7m
1212,3,llllllllllll,4072,171,5,2,7,71.4%,8m
1213,2,llllllllllll,4071,1250,52,43,95,54.7%,8m
1214,1,CapTain,4070,1171,41,74,115,35.7%,6m
1214,2,아이마스,4070,220,7,11,18,38.9%,18m
1216,2,Signature,4068,1533,85,71,156,54.5%,5m
1216,2,休闲者,4068,114,4,7,11,36.4%,18m
1218,2,[사라시나루카]리아,4067,34,1,4,5,20.0%,8m
1219,3,그종족프읍읍읍,4064,193,9,8,17,52.9%,19m
1219,2,mckcw,4064,0,0,2,2,0.0%,4m
1221,2,IIIIIIIIIIII,4062,867,217,233,450,48.2%,6m
1221,2,[Cloud9]자네는왜안자나,4062,333,66,80,146,45.2%,3m
1221,2,[인투더]IntoTheB,4062,1054,64,70,134,47.8%,7m
1221,2,殘楓血霧,4062,50,3,2,5,60.0%,15m
1225,2,IIIIIIIIII,4061,1146,42,41,83,50.6%,6m
1225,2,[인투더]IntoTheJaeH,4061,606,23,21,44,52.3%,5m
1225,2,Lorik,4061,92,3,1,4,75.0%,16m
1225,2,[흐앙]llllllllIlll,4061,96,3,14,17,17.6%,18m
1225,2,[GITS]生猛海鮮,4061,0,0,2,2,0.0%,5m
1230,2,llllllllllll,4060,836,30,37,67,44.8%,7m
1230,2,llllllllllll,4060,30,1,3,4,25.0%,18m
1232,2,[인투더]IntoTheSWAN,4059,1394,90,83,173,52.0%,5m
1232,2,추적자병신유닛,4059,136,8,0,8,100.0%,21m
1234,2,Perfect,4058,1576,277,261,538,51.5%,17m
1235,2,FaranG,4057,448,20,15,35,57.1%,5m
1236,2,아엄마잘못했어,4056,1183,129,122,251,51.4%,15m
1236,2,SteveIrwin,4056,274,11,5,16,68.8%,16m
1236,2,[GAU]탈리스,4056,258,10,9,19,52.6%,5m
1236,2,NewsHerO,4056,156,6,7,13,46.2%,6m
1240,2,[대령]대령,4055,0,1,1,2,50.0%,17m
1241,2,Lune,4054,1162,42,52,94,44.7%,6m
1241,2,파후,4054,234,24,19,43,55.8%,22m
1241,2,[Lotuz]Nemshing,4054,0,1,1,2,50.0%,7m
1244,2,[Lotuz]SCwingzero,4053,666,76,64,140,54.3%,6m
1244,2,[WTSC]육식남,4053,0,0,1,1,0.0%,7m
1246,2,[SHIPS]듀크,4052,198,8,8,16,50.0%,8m
1247,2,[래더납치범]악마,4051,285,18,14,32,56.2%,8m
1247,2,Superior,4051,30,1,2,3,33.3%,7m
1249,2,[Master]나봉구리,4049,478,17,22,39,43.6%,18m
1250,2,[ALeveL]ShiningStars,4048,0,1,0,1,100.0%,5m
1251,1,IIIllIlIlIll,4047,1691,147,167,314,46.8%,18m
1252,2,Zero,4045,1552,260,246,506,51.4%,7m
1253,2,愚蠢的棒子,4044,1456,162,141,303,53.5%,18m
1253,2,옥수수초코볼,4044,759,38,17,55,69.1%,4m
1253,2,조라삐,4044,296,11,11,22,50.0%,22m
1253,3,IIIIIIIIIIII,4044,193,10,4,14,71.4%,19m
1257,2,머슬몬스터,4043,1387,172,170,342,50.3%,16m
1258,2,블랑몽,4042,1524,103,94,197,52.3%,6m
1258,2,NoOne,4042,174,6,11,17,35.3%,6m
1258,3,[크리에이터]YouTuber,4042,143,4,0,4,100.0%,4m
1258,2,[NDW]AresRush,4042,30,1,4,5,20.0%,15m
1262,2,llllllllllll,4041,908,35,35,70,50.0%,18m
1262,2,[XYFANS]Ken,4041,138,5,10,15,33.3%,7m
1264,2,[HuIIII]IMTB,4040,0,0,1,1,0.0%,3m
1265,2,사과,4038,116,5,5,10,50.0%,4m
1266,2,[CIM]바크주크,4037,114,5,6,11,45.5%,16m
1266,2,[Weast]망구리,4037,0,1,0,1,100.0%,16m
1268,2,llllllllllll,4036,575,25,25,50,50.0%,8m
1268,2,[먼치킨]이자요이,4036,88,3,4,7,42.9%,8m
1268,2,전장은나쁜게임,4036,30,2,0,2,100.0%,5m
1268,2,난최고라우,4036,30,2,1,3,66.7%,5m
1272,2,IIIlllIIllII,4035,1418,101,77,178,56.7%,18m
1273,2,[NDW]Xier,4034,60,3,0,3,100.0%,7m
1273,2,whiteSUS,4034,34,1,2,3,33.3%,7m
1275,2,可愛神,4033,1523,135,127,262,51.5%,7m
1275,2,이예슬,4033,30,1,2,3,33.3%,21m
1277,2,round,4032,116,4,2,6,66.7%,21m
1278,2,함지,4030,1530,236,249,485,48.7%,6m
1278,2,llllllllllll,4030,600,45,29,74,60.8%,5m
1280,2,토스만할꼬얌,4028,914,60,32,92,65.2%,5m
1281,2,HOBAS,4026,1370,157,139,296,53.0%,6m
1281,2,lIIllIIllllI,4026,0,0,1,1,0.0%,8m
1283,2,[Lotuz]WhiteBalance,4025,962,41,53,94,43.6%,8m
1283,2,[Ghana]지티,4025,114,5,1,6,83.3%,7m
1285,2,[SC2HK]ZeroWhite,4024,1530,118,107,225,52.4%,4m
1285,2,데이비드킴,4024,286,11,4,15,73.3%,21m
1287,2,[GITS]MaBaO,4023,453,16,21,37,43.2%,15m
1288,1,자색고구마,4022,1779,548,570,1118,49.0%,19m
1288,2,[군사정권]노태우,4022,797,36,23,59,61.0%,18m
1288,2,SYD,4022,148,6,6,12,50.0%,7m
1288,2,DPGPartinG,4022,48,2,0,2,100.0%,15m
1292,2,llllllllllll,4021,58,2,2,4,50.0%,6m
1293,2,MeatSpin,4018,302,12,4,16,75.0%,15m
1293,2,llllllllllll,4018,150,6,1,7,85.7%,18m
1295,2,llllllllllll,4017,504,23,11,34,67.6%,21m
1295,2,Dissa,4017,217,12,5,17,70.6%,3m
1295,2,[네오]보고배워라,4017,348,12,15,27,44.4%,5m
1295,1,llllllllllll,4017,97,3,4,7,42.9%,7m
1299,2,[올드보이]우럭아왜우럭,4016,1600,91,78,169,53.8%,5m
1299,2,Pocketmon,4016,206,7,2,9,77.8%,18m
1299,2,Tasty,4016,0,0,1,1,0.0%,16m
1302,2,奶油貓,4015,1111,216,224,440,49.1%,22m
1302,2,Fox,4015,1070,102,78,180,56.7%,5m
1302,2,[엔에스]자유의날개,4015,30,1,2,3,33.3%,5m
1305,2,짐승토스다망,4014,1003,43,45,88,48.9%,3m
1305,2,[겨울방어]happyday,4014,455,20,10,30,66.7%,16m
1305,2,InnoVatioN,4014,0,0,1,1,0.0%,3m
1308,2,송스타,4013,362,16,6,22,72.7%,5m
1309,1,[Tychus]Neo,4010,1735,175,169,344,50.9%,8m
1309,2,大杯冰奶茶不好喝,4010,97,1,1,2,50.0%,18m
1311,2,텔레토비,4009,0,1,1,2,50.0%,21m
1312,2,spark,4008,1513,130,130,260,50.0%,7m
1313,2,[회계사]CPA,4007,438,69,53,122,56.6%,21m
1314,2,[pepsl]찡찡,4006,1434,277,266,543,51.0%,8m
1314,2,FallenAngel,4006,0,0,3,3,0.0%,6m
1316,2,TUNATUNA,4005,684,32,23,55,58.2%,5m
1316,2,[前無後無]BIOTECH,4005,0,1,0,1,100.0%,22m
1318,2,[ROCno1]louisliao,4004,1560,119,123,242,49.2%,17m
1318,2,[TAS]Colt,4004,550,47,44,91,51.6%,3m
1318,2,[Dopen]공대오지마,4004,0,1,0,1,100.0%,7m
1321,2,WhiteHyun,4003,0,0,13,13,0.0%,7m
1322,2,[최희]쿠센이,4002,1198,60,47,107,56.1%,15m
1322,2,IIIIIIIIIIII,4002,355,16,6,22,72.7%,4m
1322,2,[팡캐월령전]white,4002,0,1,0,1,100.0%,7m
1325,2,[라바2]Slipknot,4001,450,15,20,35,42.9%,16m
1326,1,흑인,3999,1724,149,171,320,46.6%,16m
1326,1,짐레이너,3999,938,28,40,68,41.2%,19m
1328,2,[시럽]NewB,3998,380,13,10,23,56.5%,5m
1328,2,ZasgAk,3998,0,0,1,1,0.0%,8m
1330,2,llllllllllll,3997,0,1,0,1,100.0%,4m
1331,2,GoomP,3996,969,49,15,64,76.6%,6m
1331,2,SMITE,3996,189,9,0,9,100.0%,6m
1333,2,[겨울방어]유병언,3995,226,13,3,16,81.2%,16m
1333,2,JJaL,3995,30,2,1,3,66.7%,18m
1333,2,Kommt,3995,60,2,3,5,40.0%,17m
1333,2,lIlIlIlIlIlI,3995,30,1,2,3,33.3%,5m
1333,2,llllllllllll,3995,0,0,1,1,0.0%,5m
1338,2,grimZ,3994,851,57,37,94,60.6%,6m
1338,2,[PCCUeS]dynamite,3994,88,4,2,6,66.7%,17m
1340,2,know,3992,1138,58,54,112,51.8%,5m
1340,2,chan,3992,976,42,39,81,51.9%,18m
1340,2,[Equal]Minerva,3992,761,37,38,75,49.3%,3m
1343,2,twilight,3991,317,19,14,33,57.6%,17m
1343,2,Kimjaehyung,3991,259,15,3,18,83.3%,21m
1343,2,lllllll,3991,329,15,4,19,78.9%,4m
1346,2,gasibe,3990,1131,187,161,348,53.7%,5m
1346,2,KaKa,3990,117,9,4,13,69.2%,22m
1348,2,oneyear,3989,166,6,3,9,66.7%,21m
1349,2,rlawogks,3988,1372,98,81,179,54.7%,6m
1349,2,IlIIlllIIlIl,3988,504,80,87,167,47.9%,5m
1349,2,[플토쌉극혐]lIlIlIl,3988,120,4,8,12,33.3%,6m
1352,2,GraZer,3987,385,28,19,47,59.6%,8m
1352,2,[Lotuz]박진영왜케잘생김,3987,390,17,7,24,70.8%,18m
1352,2,Nurse,3987,382,17,10,27,63.0%,5m
1352,2,LifeForAiur,3987,0,3,3,6,50.0%,16m
1352,2,[探測機公會]CuteProbe,3987,0,0,1,1,0.0%,4m
1357,2,BallaDream,3986,420,18,8,26,69.2%,16m
1357,3,llllllllllll,3986,358,17,6,23,73.9%,8m
1357,2,GKJA,3986,62,3,5,8,37.5%,16m
1357,2,전쟁광,3986,0,0,1,1,0.0%,3m
1361,2,[다이버전트]Master,3985,30,2,1,3,66.7%,8m
1362,2,[杞人之優]meister,3984,92,3,5,8,37.5%,21m
1362,2,llllllllll,3984,62,3,6,9,33.3%,5m
1362,2,[瑄瑄我愛你]嫁給我好嗎,3984,0,1,0,1,100.0%,3m
1362,2,uno,3984,0,1,0,1,100.0%,5m
1366,2,ioppp,3983,1056,82,89,171,48.0%,21m
1366,2,[GIS]MaDHeaD,3983,1021,40,34,74,54.1%,4m
1366,2,protole,3983,687,32,18,50,64.0%,18m
1366,2,[SPTS]批欸死五豪豪玩呵,3983,0,0,1,1,0.0%,7m
1370,2,호랑이,3982,530,20,13,33,60.6%,5m
1370,2,Barcode,3982,367,17,6,23,73.9%,21m
1372,2,螢雪之功,3981,1554,129,136,265,48.7%,4m
1372,2,[NsP]김연아,3981,0,0,1,1,0.0%,22m
1374,2,ASDFGH,3980,406,17,10,27,63.0%,18m
1375,2,[송투더밍비]송미,3977,1553,240,214,454,52.9%,16m
1375,2,[Dopen]RoyaL,3977,288,10,14,24,41.7%,17m
1375,2,[高海耶]训练中的传奇,3977,30,1,8,9,11.1%,7m
1378,2,[Hyper]예은,3976,0,0,1,1,0.0%,21m
1379,2,[제라틀]Zeratul,3975,559,23,14,37,62.2%,5m
1380,2,[ThsG]째룽,3974,0,0,1,1,0.0%,7m
1381,2,[위신작끝났다]blackholic,3972,1327,63,45,108,58.3%,21m
1381,2,llllllllllll,3972,787,57,5,62,91.9%,18m
1381,2,Crystal,3972,554,26,16,42,61.9%,16m
1384,2,[0I터널]배유빈,3971,507,27,28,55,49.1%,6m
1384,2,살려는드릴게,3971,26,2,1,3,66.7%,22m
1384,2,sjkzm,3971,0,1,1,2,50.0%,5m
1384,2,[엘가나]pretty,3971,0,0,1,1,0.0%,8m
1384,2,[isnous]我是神,3971,0,0,1,1,0.0%,5m
1389,2,Rain,3970,1573,110,102,212,51.9%,15m
1389,2,llllllllllll,3970,406,13,29,42,31.0%,6m
1389,2,KyaruMyWaifu,3970,116,3,2,5,60.0%,5m
1392,2,llllllllllll,3969,1502,147,145,292,50.3%,22m
1392,2,[FOT]Daenerys,3969,829,91,93,184,49.5%,16m
1392,2,DAL,3969,415,15,12,27,55.6%,5m
1392,2,빠에야,3969,0,4,1,5,80.0%,15m
1396,2,타디스,3968,218,12,6,18,66.7%,7m
1397,2,Origin,3967,395,16,13,29,55.2%,7m
1397,2,IIIIIIIIIIII,3967,114,4,4,8,50.0%,6m
1399,3,붕어빵달인김효섭,3965,364,16,8,24,66.7%,15m
1400,2,[NGameS]SoulKey,3964,0,0,1,1,0.0%,3m
1400,2,REASON,3964,0,0,2,2,0.0%,4m
1402,2,히피뱅,3963,1522,196,167,363,54.0%,16m
1402,2,[CIM]갓보영,3963,276,10,5,15,66.7%,7m
1402,2,[문재인지지자]여자한테안져,3963,30,4,4,8,50.0%,4m
1405,2,lllllllllll,3962,88,3,6,9,33.3%,16m
1405,2,[StarC]LEO,3962,0,0,6,6,0.0%,16m
1407,2,또야,3961,1481,76,74,150,50.7%,5m
1408,2,IIIIIIIIIIII,3960,243,32,9,41,78.0%,5m
1408,2,Jack,3960,116,5,3,8,62.5%,5m
1408,2,[異界的檢察官]BlinkDarkShi,3960,30,2,0,2,100.0%,7m
1408,2,Matthew,3960,64,2,6,8,25.0%,7m
1412,2,[三民主義]三六,3959,1503,207,218,425,48.7%,6m
1412,2,zerz,3959,92,4,4,8,50.0%,7m
1414,2,장방울방울,3958,1575,124,102,226,54.9%,16m
1414,2,[S0fT]노라드,3958,0,0,2,2,0.0%,7m
1416,2,명박존박산다라박,3957,1495,105,117,222,47.3%,7m
1416,2,운영충,3957,298,12,10,22,54.5%,17m
1418,2,[SPTS]銀月嵐,3956,0,0,1,1,0.0%,7m
1419,2,Roger,3955,166,11,1,12,91.7%,16m
1420,2,[異界的檢察官]我討厭韓國和狗,3954,468,16,18,34,47.1%,7m
1420,2,[Arisu]CarDiA,3954,0,0,1,1,0.0%,7m
1422,2,멀티허락받고먹어,3953,388,15,15,30,50.0%,16m
1422,2,[Aster]손요공,3953,0,1,0,1,100.0%,5m
1424,2,[아프리카청춘]뾱뾱이,3952,30,1,3,4,25.0%,5m
1425,2,KipyaLarva,3951,902,43,27,70,61.4%,4m
1425,3,[디플]GANGTAE,3951,149,5,6,11,45.5%,5m
1425,2,OverMind,3951,122,4,9,13,30.8%,16m
1425,2,타라토노,3951,0,1,0,1,100.0%,21m
1425,2,[지비클]LovelyMina,3951,0,0,1,1,0.0%,6m
1430,2,Zojiji,3950,1512,236,210,446,52.9%,3m
1430,2,[Equal]Calamitas,3950,290,39,22,61,63.9%,5m
1432,2,초보,3949,86,5,10,15,33.3%,21m
1432,3,IIIIIo,3949,0,2,1,3,66.7%,22m
1432,3,IIlIllIIlIIl,3949,0,0,1,1,0.0%,20m
1435,2,[어윤수님개쩜]MintChoCo,3948,445,26,12,38,68.4%,4m
1435,2,[선장이필요해]LastStar,3948,330,15,6,21,71.4%,16m
1435,2,자귀자귀무자귀,3948,102,4,4,8,50.0%,6m
1435,2,[고추uUu]천사짱나,3948,0,1,1,2,50.0%,22m
1439,1,[게Yee밴d]흑인래퍼간디,3947,1727,145,172,317,45.7%,19m
1439,2,청하,3947,596,21,23,44,47.7%,17m
1439,2,[Lotuz]클라스차이,3947,135,4,2,6,66.7%,16m
1442,2,llllllllllll,3946,0,1,1,2,50.0%,18m
1443,2,Lambkin,3945,1035,528,507,1035,51.0%,5m
1443,1,[돌변쩔좀]공허폭격기성애자,3945,1630,130,149,279,46.6%,7m
1443,2,[겨울방어]지또,3945,1529,119,81,200,59.5%,7m
1443,2,[SeA]肉包,3945,0,1,1,2,50.0%,21m
1443,2,ALLToU,3945,0,0,1,1,0.0%,7m
1448,2,shhhhh,3944,394,81,66,147,55.1%,16m
1448,2,VinDiesel,3944,643,26,26,52,50.0%,7m
1448,2,Harenix,3944,295,11,15,26,42.3%,7m
1448,3,[TeamNV]Artist,3944,0,0,2,2,0.0%,15m
1452,2,[여단]페트로시안,3943,1475,84,76,160,52.5%,6m
1452,2,GWING,3943,1189,83,66,149,55.7%,4m
1454,2,[싸고난후]MULTISSUE,3942,1082,362,354,716,50.6%,6m
1454,2,꽃이피네,3942,1441,145,162,307,47.2%,3m
1454,2,RockAllen,3942,156,9,3,12,75.0%,16m
1457,2,MyStyLe,3941,660,36,13,49,73.5%,6m
1457,2,NiCe,3941,738,26,30,56,46.4%,5m
1457,2,SCTerran,3941,143,3,6,9,33.3%,5m
1457,2,CleveR,3941,0,1,1,2,50.0%,6m
1461,2,llllllllllll,3940,1260,54,66,120,45.0%,6m
1461,2,[WDY]물범이,3940,0,0,4,4,0.0%,18m
1463,2,[프사기박멸중]맹독충버프필수,3939,618,26,20,46,56.5%,5m
1463,1,Apple,3939,229,11,2,13,84.6%,17m
1463,2,Railgun,3939,0,0,1,1,0.0%,6m
1466,2,래더납치범,3938,729,53,0,53,100.0%,21m
1466,2,genghiskunt,3938,282,10,8,18,55.6%,3m
1466,2,[國本]BattleCruser,3938,0,3,2,5,60.0%,18m
1469,2,[인투더]IntoTheNero,3937,1459,80,90,170,47.1%,8m
1469,1,[S급용병]아들,3937,211,4,3,7,57.1%,17m
1469,2,[숲샘TV]PhanTaSuS,3937,30,2,1,3,66.7%,22m
1469,2,PonTa,3937,88,1,1,2,50.0%,21m
1473,2,trusT,3936,157,6,0,6,100.0%,5m
1473,2,lIIIIIIIIIII,3936,0,0,1,1,0.0%,7m
1475,2,[ELS]Hinatsuru,3935,1056,50,29,79,63.3%,18m
1475,2,애즈,3935,154,5,2,7,71.4%,4m
1477,2,daybreak,3934,1555,157,157,314,50.0%,21m
1477,2,[Dopen]Yoonkun,3934,141,5,1,6,83.3%,5m
1477,2,[카봇귀욤귀욤]나는전설이다,3934,30,1,3,4,25.0%,16m
1480,2,DDD,3933,764,30,38,68,44.1%,8m
1480,2,TxGaybar,3933,30,2,2,4,50.0%,21m
1480,2,FlaSh,3933,0,0,6,6,0.0%,8m
1483,2,IIIlllIIllIl,3932,350,12,13,25,48.0%,4m
1484,1,asdfqwert,3930,116,10,5,15,66.7%,17m
1484,2,JWP,3930,228,8,12,20,40.0%,16m
1486,2,Monday,3929,1482,458,457,915,50.1%,3m
1486,2,[아직이름없음]DictAtor,3929,58,3,4,7,42.9%,3m
1488,2,[break]Dsherlock,3927,342,11,23,34,32.4%,22m
1489,2,Qyuk,3926,1165,51,37,88,58.0%,16m
1489,3,NaYoNam,3926,30,1,2,3,33.3%,5m
1489,2,Felix,3926,30,1,3,4,25.0%,5m
1492,2,Jaesung,3925,1135,63,65,128,49.2%,22m
1492,2,IIIIIIIIIIII,3925,0,0,3,3,0.0%,5m
1494,2,Dear,3923,1135,127,120,247,51.4%,5m
1494,2,[엿보기구멍]난포토러시만해,3923,524,18,22,40,45.0%,6m
1496,2,IIIIIIIIII,3922,1577,114,114,228,50.0%,5m
1497,2,llllllllllll,3921,194,7,6,13,53.8%,3m
1497,2,IIIIIIIIIIII,3921,180,6,6,12,50.0%,6m
1499,2,김주성,3920,408,16,15,31,51.6%,5m
1499,2,[영앤리치]GoShaQ,3920,402,13,27,40,32.5%,5m
1499,2,lllIIIIIllll,3920,114,2,3,5,40.0%,22m
1502,2,gggl,3919,444,18,15,33,54.5%,8m
1502,2,lIIlllIIl,3919,166,5,4,9,55.6%,4m
1504,2,GoGoMarine,3918,0,1,1,2,50.0%,16m
1504,2,김영준,3918,30,1,3,4,25.0%,7m
1504,2,MEMENTO,3918,0,0,1,1,0.0%,18m
1507,2,붕여킹,3916,1170,61,36,97,62.9%,18m
1508,2,Disaster,3914,366,15,7,22,68.2%,7m
1509,3,OkGo,3912,114,5,1,6,83.3%,15m
1509,3,쿠로사키이치고,3912,120,5,3,8,62.5%,5m
1509,2,llllllllllll,3912,0,1,2,3,33.3%,6m
1512,2,경오짱짱짱,3911,0,0,4,4,0.0%,21m
1513,2,[TalenT]StatsIsChamp,3910,378,13,19,32,40.6%,7m
1513,2,Darklady,3910,0,0,3,3,0.0%,18m
1515,3,asdasdds,3909,0,1,1,2,50.0%,21m
1516,2,VThanh,3908,1533,390,406,796,49.0%,4m
1516,2,스타크래프트,3908,204,7,10,17,41.2%,5m
1516,3,[MUGATU]DVDASA,3908,171,5,1,6,83.3%,3m
1516,3,JamArcher,3908,0,1,0,1,100.0%,5m
1520,3,[시럽]aLive,3907,30,2,2,4,50.0%,8m
1520,3,sett,3907,0,0,1,1,0.0%,7m
1522,2,[인투더]IntoTheMoMo,3906,1586,334,330,664,50.3%,16m
1522,2,kantoot,3906,954,46,27,73,63.0%,18m
1522,3,[백수라이프]Inverse,3906,1012,42,28,70,60.0%,5m
1522,2,New,3906,60,2,11,13,15.4%,4m
1526,3,절막만지셧잖아요,3905,140,5,3,8,62.5%,19m
1526,3,Car,3905,0,0,1,1,0.0%,5m
1528,2,Sweeper,3904,1012,39,43,82,47.6%,4m
1529,3,Anais,3903,58,3,2,5,60.0%,4m
1530,3,Knight,3902,118,4,3,7,57.1%,7m
1530,2,AcE,3902,0,0,3,3,0.0%,17m
1532,2,蜂蜜檸檬茶,3900,1505,155,143,298,52.0%,5m
1532,3,양민학살,3900,1656,131,72,203,64.5%,21m
1534,3,ProJact,3899,30,2,0,2,100.0%,17m
1535,2,[NLTN]급식충,3898,340,12,20,32,37.5%,6m
1535,2,GTKung,3898,95,4,4,8,50.0%,5m
1537,3,[快樂玩家]FlaSh,3897,30,3,3,6,50.0%,8m
1538,2,이민호,3896,1120,43,53,96,44.8%,7m
1538,3,IntoTheBBoMi,3896,0,1,0,1,100.0%,5m
1540,3,주성욱화이팅,3895,295,16,10,26,61.5%,15m
1541,3,DerekRush,3893,0,0,1,1,0.0%,8m
1542,2,[ELS]llllllllllll,3892,499,17,19,36,47.2%,7m
1542,3,샥바꿔,3892,148,5,5,10,50.0%,3m
1542,3,[피망]Heemang,3892,30,2,1,3,66.7%,5m
1545,1,llllllllllll,3891,1651,142,151,293,48.5%,17m
1545,3,백령해병,3891,250,10,6,16,62.5%,4m
1547,2,이키앙,3890,1471,187,185,372,50.3%,6m
1547,2,llllllllllll,3890,96,7,0,7,100.0%,15m
1549,2,[XYFANS]IIIIIIIIIIII,3887,920,33,36,69,47.8%,21m
1549,2,국제농연,3887,141,7,3,10,70.0%,18m
1551,2,드랍해도아낙네,3886,1105,51,49,100,51.0%,22m
1551,2,매력남,3886,902,33,41,74,44.6%,7m
1551,3,기백,3886,149,4,5,9,44.4%,22m
1551,3,llll,3886,30,2,0,2,100.0%,8m
1551,3,jaws,3886,58,2,2,4,50.0%,5m
1556,1,IIIIIIIIIIII,3885,1551,118,138,256,46.1%,6m
1556,1,Cheoklate,3885,118,2,8,10,20.0%,4m
1558,2,lIlIlIlIlIlI,3884,1150,44,49,93,47.3%,6m
1558,2,tyson,3884,555,36,30,66,54.5%,17m
1560,3,Promise,3883,1006,45,23,68,66.2%,8m
1560,2,정나름,3883,0,1,1,2,50.0%,5m
1562,2,IIIIIIIIIIII,3882,1454,249,268,517,48.2%,15m
1562,2,MINHTHUHAI,3882,965,38,40,78,48.7%,22m
1562,3,[이터널]Pinkkiwi,3882,520,19,16,35,54.3%,4m
1562,3,Narzisse,3882,130,8,11,19,42.1%,20m
1562,3,IIIIIIIIIIII,3882,0,0,1,1,0.0%,20m
1567,2,jayhxmo,3881,700,37,20,57,64.9%,7m
1568,2,IIIIIIIIIIII,3880,96,6,10,16,37.5%,8m
1568,2,[Goe]Amber,3880,0,1,1,2,50.0%,16m
1570,3,Xslim,3879,0,0,1,1,0.0%,19m
1571,2,Myosotis,3878,48,2,6,8,25.0%,7m
1572,3,쥐티,3877,0,1,1,2,50.0%,3m
1572,3,[Care]여울,3877,0,0,3,3,0.0%,19m
1574,2,llllIIlllIIl,3876,785,61,77,138,44.2%,16m
1575,2,llllllllllll,3875,1511,314,338,652,48.2%,8m
1575,3,freeny,3875,360,12,14,26,46.2%,17m
1577,3,[어윤수님개쩜]캡틴티모나루,3874,526,19,23,42,45.2%,3m
1577,1,fromis,3874,183,5,2,7,71.4%,15m
1579,2,Fabutaste,3873,567,22,25,47,46.8%,7m
1580,2,桜田美夢,3869,134,11,1,12,91.7%,15m
1581,3,김치호,3868,1577,135,123,258,52.3%,19m
1582,3,論論,3867,0,0,1,1,0.0%,17m
1583,3,cuttr,3866,620,23,21,44,52.3%,21m
1583,3,홍춘,3866,60,3,2,5,60.0%,22m
1583,3,물만두,3866,0,1,0,1,100.0%,4m
1583,3,ANSsavior,3866,30,1,4,5,20.0%,19m
1583,3,[Gosuyo]ESpanic,3866,0,0,1,1,0.0%,5m
1588,3,김참새,3865,0,1,0,1,100.0%,22m
1589,2,此名稱無法更改,3864,1098,48,41,89,53.9%,5m
1589,2,Lightning,3864,861,46,40,86,53.5%,17m
1589,3,llllllllllll,3864,0,0,1,1,0.0%,4m
1592,3,[빨간달]앨리스,3862,0,0,1,1,0.0%,20m
1592,3,zizon,3862,0,0,1,1,0.0%,8m
1594,2,saber,3861,1113,48,54,102,47.1%,7m
1594,2,WHiteDay,3861,167,7,5,12,58.3%,6m
1596,3,[RESCUE]모노쿠마,3860,510,21,9,30,70.0%,19m
1597,2,개미하루,3858,0,1,9,10,10.0%,5m
1597,3,[SKTTII]김택용히,3858,0,0,1,1,0.0%,5m
1599,2,IIIIIIIIIII,3857,780,144,166,310,46.5%,16m
1600,1,CatPlaying,3856,1437,201,216,417,48.2%,17m
1600,1,큰검은빨대,3856,125,15,3,18,83.3%,6m
1600,2,NateHiggers,3856,112,5,5,10,50.0%,4m
1603,3,[이야신난다]끓인라면,3855,1375,167,154,321,52.0%,20m
1603,3,Overer,3855,430,16,12,28,57.1%,19m
1605,2,IIIIIIIII,3854,513,20,26,46,43.5%,4m
1605,3,사건의배후,3854,0,3,2,5,60.0%,21m
1607,2,입닥쳐,3853,204,7,15,22,31.8%,6m
1608,3,폭군,3852,1569,112,108,220,50.9%,22m
1608,2,[용가리가리]캐릭터이름뭐할까,3852,766,28,33,61,45.9%,8m
1608,3,SCII,3852,30,1,2,3,33.3%,4m
1611,2,llllllllllll,3850,1518,662,658,1320,50.2%,6m
1611,3,[영웅크래프트]호두의반란,3850,58,2,1,3,66.7%,19m
1611,3,[xTMDx]killXnight,3850,0,1,2,3,33.3%,20m
1614,2,[이터널]나르는참새,3849,116,4,5,9,44.4%,18m
1614,3,[MJF]SheaMus,3849,0,0,1,1,0.0%,18m
1616,2,호락서니,3848,510,62,54,116,53.4%,6m
1616,3,RealWby,3848,0,0,1,1,0.0%,17m
1618,3,용서없다,3847,482,22,15,37,59.5%,22m
1618,2,라이프,3847,171,11,3,14,78.6%,16m
1618,2,권창근,3847,46,2,1,3,66.7%,15m
1618,3,[PSIONI]토스장인김제라툴,3847,0,0,1,1,0.0%,4m
1622,3,HeXASoul,3846,58,2,1,3,66.7%,8m
1623,3,[IHan]Dash,3844,58,3,1,4,75.0%,20m
1624,3,착한사람입니다,3843,142,5,7,12,41.7%,15m
1624,3,ForTheHorde,3843,0,0,1,1,0.0%,22m
1626,3,KaKaw,3841,186,10,1,11,90.9%,5m
1626,3,Painful,3841,140,10,1,11,90.9%,4m
1626,3,[랜덤한테왜짐]integralidi,3841,58,3,0,3,100.0%,5m
1629,3,[快樂玩家]GroundBEEF,3840,0,0,1,1,0.0%,20m
1630,3,zio,3839,0,1,1,2,50.0%,18m
1630,3,시발난짱이다,3839,0,0,3,3,0.0%,19m
1632,3,[ELSII]위성락,3838,0,1,0,1,100.0%,7m
1633,2,[국가정보원]테스토스테란,3836,1087,68,61,129,52.7%,7m
1633,3,[PANG]푸른들,3836,0,1,0,1,100.0%,8m
1633,3,[Rush]HGP,3836,0,1,1,2,50.0%,4m
1636,3,YerinSunrise,3835,664,30,16,46,65.2%,7m
1637,3,옆집형,3834,140,3,1,4,75.0%,20m
1637,3,타우린,3834,30,2,1,3,66.7%,20m
1637,3,[Ruby]슈드,3834,0,1,0,1,100.0%,21m
1640,2,王者歸來,3833,58,2,8,10,20.0%,7m
1640,3,기체판금지존,3833,0,0,1,1,0.0%,15m
1642,3,[Ato]프로토스,3832,86,8,0,8,100.0%,20m
1642,3,작은덧니,3832,90,3,3,6,50.0%,5m
1642,3,IIIIIIIIII,3832,0,0,1,1,0.0%,5m
1642,3,[CBEL]브이라인수염차,3832,0,0,1,1,0.0%,7m
1646,3,llllllllllll,3829,340,13,10,23,56.5%,8m
1647,3,[地獄拉麵]蒼雷,3828,445,34,16,50,68.0%,18m
1648,2,llllllllllll,3827,1451,205,206,411,49.9%,6m
1648,2,아이어,3827,435,17,20,37,45.9%,18m
1648,3,Beyondexx,3827,60,3,1,4,75.0%,5m
1651,3,[래더납치범]Maru,3826,1469,58,56,114,50.9%,5m
1651,2,[聽音]HeavyMetal,3826,304,11,18,29,37.9%,8m
1653,2,논현동개끈녀,3825,243,8,12,20,40.0%,17m
1653,1,一馬,3825,208,4,4,8,50.0%,4m
1655,3,SPICA,3824,86,3,2,5,60.0%,22m
1655,3,산본피플,3824,0,1,1,2,50.0%,20m
1657,3,잭다니엘,3823,0,1,0,1,100.0%,19m
1658,1,Gonzo,3821,587,46,86,132,34.8%,7m
1658,3,[TalenT]攝護腺排骨,3821,263,13,5,18,72.2%,20m
1658,3,금강불괴,3821,0,1,0,1,100.0%,19m
1658,3,SPK,3821,30,1,1,2,50.0%,8m
1658,3,빡러쉬장인,3821,0,0,1,1,0.0%,15m
1658,3,eklee,3821,0,0,3,3,0.0%,19m
1664,2,JWA,3820,1373,203,205,408,49.8%,4m
1664,2,Gex,3820,1477,175,161,336,52.1%,16m
1664,2,IIIIIIIIIII,3820,1468,170,174,344,49.4%,5m
1664,3,iiiiiiiiiiii,3820,121,4,0,4,100.0%,5m
1668,3,[NDW]無料饅頭,3818,86,3,2,5,60.0%,19m
1669,3,PaiN,3817,30,2,1,3,66.7%,8m
1670,3,llllllllllll,3816,144,10,2,12,83.3%,20m
1671,2,[Abyss]NickeL,3815,1256,44,51,95,46.3%,5m
1671,3,amatoss,3815,694,26,24,50,52.0%,4m
1673,2,허접,3814,888,75,79,154,48.7%,21m
1673,3,Muldon,3814,277,31,22,53,58.5%,22m
1673,3,토스야캐요,3814,60,3,4,7,42.9%,20m
1673,3,TerATo,3814,0,0,1,1,0.0%,5m
1677,3,라이트닝퓨리,3812,250,7,12,19,36.8%,21m
1677,3,[호구집합]홍진영,3812,30,2,4,6,33.3%,7m
1677,3,[아라]llllllllllll,3812,0,1,0,1,100.0%,8m
1680,3,wwqw,3811,0,0,1,1,0.0%,17m
1680,3,[Hyper]Chobo,3811,0,0,3,3,0.0%,5m
1682,3,MGJProtoss,3810,502,18,19,37,48.6%,22m
1682,3,Cerulean,3810,0,1,0,1,100.0%,22m
1684,2,llllllllllll,3809,420,15,15,30,50.0%,21m
1684,3,곰돌이허니,3809,30,2,0,2,100.0%,19m
1684,3,범기사,3809,0,0,3,3,0.0%,4m
1687,3,랜덤닉생성,3808,0,1,0,1,100.0%,18m
1688,3,원이삭인쓰,3807,58,2,2,4,50.0%,5m
1689,3,龍騎士,3806,536,19,23,42,45.2%,15m
1689,3,테란만,3806,30,1,1,2,50.0%,15m
1691,3,awu,3805,437,17,17,34,50.0%,17m
1691,3,은메달염소자리,3805,294,12,10,22,54.5%,8m
1693,3,[NDW]腦膜炎,3804,58,2,3,5,40.0%,8m
1694,3,yikes,3803,373,17,7,24,70.8%,5m
1694,3,[REGENO]statsgoangfa,3803,366,13,12,25,52.0%,17m
1694,3,[Sergio]모선핵신자,3803,0,0,1,1,0.0%,21m
1694,3,[YONSEI]DABO,3803,0,0,1,1,0.0%,5m
1698,2,Leo,3802,568,18,41,59,30.5%,5m
1698,3,Lyon,3802,338,12,7,19,63.2%,20m
1700,3,[애니멀킹덤]블랙핑크왕국,3801,1572,66,49,115,57.4%,18m
1701,3,[우즈키엘]Hani,3800,0,0,2,2,0.0%,19m
1702,2,heyangel,3799,1561,233,237,470,49.6%,5m
1702,3,[xTMDx]LOTTO,3799,305,11,4,15,73.3%,19m
1702,3,AlphaGo,3799,0,0,2,2,0.0%,5m
1705,3,Shadow,3798,727,33,22,55,60.0%,21m
1705,3,[XYFANS]CuteShakura,3798,296,12,8,20,60.0%,19m
1705,3,llllllllllll,3798,146,5,6,11,45.5%,8m
1705,2,[말뫼FF]말뫼,3798,30,4,5,9,44.4%,7m
1705,3,[이터널]마이너스이온,3798,86,3,4,7,42.9%,19m
1705,3,국물이얼큰하네,3798,0,1,0,1,100.0%,4m
1711,3,Venis,3797,1197,62,21,83,74.7%,7m
1711,3,[Lotuz]피닉스킹,3797,0,0,2,2,0.0%,21m
1713,2,[Equal]큐티은우,3795,1616,78,86,164,47.6%,7m
1713,3,oHoK,3795,272,10,11,21,47.6%,19m
1713,1,[ANGG]UNOBomber,3795,0,0,1,1,0.0%,4m
1716,3,금이빨,3794,170,7,3,10,70.0%,15m
1717,3,[미남이군]SpecialSTOM,3793,118,4,9,13,30.8%,15m
1718,3,한승연,3792,114,4,5,9,44.4%,7m
1718,3,용스터,3792,58,2,5,7,28.6%,4m
1720,3,[현역]석호몬,3791,581,28,10,38,73.7%,21m
1720,2,[D3StaR]SanTaFe,3791,181,4,10,14,28.6%,5m
1722,3,覺醒力量,3790,60,3,3,6,50.0%,18m
1723,3,[IMBO]강철호드,3788,280,10,3,13,76.9%,21m
1724,2,브리부리,3787,717,28,34,62,45.2%,8m
1725,3,[TalenT]家可可,3786,346,14,14,28,50.0%,21m
1726,3,안녕,3785,0,1,0,1,100.0%,7m
1727,3,[허경영대통령]llllllllllll,3784,30,1,1,2,50.0%,4m
1728,3,[친클]EIOrZr,3783,704,36,20,56,64.3%,7m
1728,3,IIIIIIIIIIII,3783,756,35,17,52,67.3%,5m
1728,3,比那名居天子,3783,0,0,1,1,0.0%,20m
1731,3,xiyentaiku,3782,813,42,32,74,56.8%,15m
1731,3,GraVity,3782,166,11,3,14,78.6%,5m
1731,3,[MikoSp]博麗霊夢,3782,60,2,4,6,33.3%,19m
1731,3,[엔타로연합]호야고나,3782,0,0,1,1,0.0%,7m
1735,3,[농구의신]이제동,3781,242,9,8,17,52.9%,7m
1735,1,[AftWar]스틱스,3781,0,1,0,1,100.0%,8m
1735,3,iLoveHentay,3781,0,1,0,1,100.0%,22m
1735,3,토시남자,3781,0,0,1,1,0.0%,20m
1739,3,dobby,3779,138,4,3,7,57.1%,19m
1740,2,빙구박스,3778,1517,192,177,369,52.0%,4m
1741,3,[ACGN]Atlas,3777,248,10,10,20,50.0%,22m
1741,3,Red,3777,0,1,0,1,100.0%,4m
1741,3,[坂井泉水]IIIIIIIIIIII,3777,30,1,8,9,11.1%,19m
1744,2,[왕가순]Jason,3776,1157,121,104,225,53.8%,4m
1744,3,llllllllllll,3776,547,30,17,47,63.8%,22m
1744,2,[十三號星期五]傑森哥,3776,300,13,3,16,81.2%,6m
1744,3,영맨,3776,224,8,13,21,38.1%,5m
1748,3,VanDH,3775,706,27,29,56,48.2%,20m
1749,3,llllllllllll,3774,328,12,4,16,75.0%,18m
1750,3,llllllllllll,3773,1015,45,24,69,65.2%,5m
1750,3,Polyethylen,3773,180,6,0,6,100.0%,4m
1750,3,無影,3773,0,0,1,1,0.0%,8m
1753,3,[근첩애미찢기]스투무료충노앰,3772,30,2,1,3,66.7%,22m
1754,2,Rambla,3771,1522,210,217,427,49.2%,18m
1754,3,StrawBerry,3771,86,6,7,13,46.2%,4m
1754,3,vLDiOps,3771,0,0,7,7,0.0%,8m
1757,3,BaekJunyoung,3770,224,8,2,10,80.0%,19m
1758,3,일베충,3769,0,1,1,2,50.0%,15m
1759,3,[뿌야]Cruise,3768,0,0,1,1,0.0%,4m
1760,3,[PKERSe]안양꽁치,3767,394,15,14,29,51.7%,7m
1761,3,Magneto,3766,0,2,3,5,40.0%,5m
1761,3,[밥안주면단식]금수저,3766,0,1,1,2,50.0%,4m
1761,3,[입대4일남은]오르카즘,3766,0,0,1,1,0.0%,18m
1764,3,PresidentMoo,3764,228,10,1,11,90.9%,4m
1764,3,[해피투게더]TRoll,3764,30,1,1,2,50.0%,4m
1766,3,Reddox,3762,144,6,3,9,66.7%,17m
1767,3,Silla,3761,620,26,16,42,61.9%,21m
1767,3,llllllllll,3761,135,8,3,11,72.7%,17m
1769,3,[CPlay]Destiny,3760,168,6,8,14,42.9%,17m
1770,3,lllllllllII,3759,160,7,10,17,41.2%,15m
1770,2,[이터널]llllllllllll,3759,97,5,7,12,41.7%,16m
1770,3,MVP,3759,58,3,1,4,75.0%,19m
1770,3,[고졸테란]HonMonO,3759,30,1,3,4,25.0%,5m
1770,3,[NsP]파랑,3759,0,0,2,2,0.0%,8m
1775,3,FanTasy,3758,0,2,4,6,33.3%,8m
1776,1,목포,3756,0,2,3,5,40.0%,40m
1776,3,[NODE]gist,3756,0,0,1,1,0.0%,15m
1778,3,MagicLeaf,3755,993,71,56,127,55.9%,22m
1778,3,Rava,3755,0,5,0,5,100.0%,5m
1780,3,강동원,3754,1585,96,68,164,58.5%,7m
1780,3,Foolish,3754,327,15,7,22,68.2%,18m
1780,3,Rhapsody,3754,236,9,3,12,75.0%,7m
1780,3,[오소리]나루진,3754,60,3,2,5,60.0%,8m
1780,3,Tanqueray,3754,30,2,4,6,33.3%,8m
1785,3,[무한오영종]브이푸드,3753,305,21,11,32,65.6%,20m
1786,3,Brokenwings,3752,0,1,0,1,100.0%,22m
1787,3,흑곰,3751,606,23,25,48,47.9%,19m
1787,3,llllllllllll,3751,0,4,1,5,80.0%,18m
1789,3,dldldltla,3750,266,9,12,21,42.9%,15m
1790,3,None,3749,555,24,17,41,58.5%,19m
1790,3,[IWYDI]KSTaR,3749,0,1,0,1,100.0%,19m
1790,3,sAviOrMaRine,3749,0,0,1,1,0.0%,20m
1790,3,콜라먹고,3749,0,0,1,1,0.0%,8m
1790,2,llllllllllll,3749,0,0,1,1,0.0%,5m
1795,3,沉梅,3748,278,13,5,18,72.2%,17m
1795,3,나는준프로다,3748,140,5,2,7,71.4%,15m
1797,2,psycho,3747,1451,538,523,1061,50.7%,16m
1797,3,[zAWSLz]你媽叫你去睡覺,3747,230,12,3,15,80.0%,19m
1799,3,[잉여로운]하루하루하루룽,3746,1231,70,52,122,57.4%,7m
1799,3,LAN,3746,862,34,29,63,54.0%,8m
1799,3,전설,3746,737,32,18,50,64.0%,18m
1799,3,ULOS,3746,286,11,11,22,50.0%,4m
1799,3,EXILED,3746,97,3,4,7,42.9%,22m
1804,3,[지비클]Politician,3745,1551,279,278,557,50.1%,22m
1804,3,KimJongUn,3745,0,0,2,2,0.0%,15m
1806,2,Kazz,3744,1489,460,472,932,49.4%,6m
1806,3,BigDickEddy,3744,118,5,7,12,41.7%,20m
1806,3,[플레좀탈출]멸공의횃불,3744,0,1,0,1,100.0%,21m
1809,2,[xTMDx]rexisbast,3743,1168,179,205,384,46.6%,4m
1809,3,IlIIIlllIll,3743,456,21,16,37,56.8%,15m
1809,3,[원자폭탄]게으름뱅이,3743,58,3,0,3,100.0%,8m
1809,3,[Lotuz]바른연애생활탐구,3743,0,0,1,1,0.0%,4m
1813,3,[SSeiya]Shura,3742,197,6,3,9,66.7%,19m
1814,3,Claymore,3741,0,0,2,2,0.0%,21m
1815,2,SPQR,3740,1298,132,128,260,50.8%,21m
1815,3,IIIIIIIIIIII,3740,312,13,3,16,81.2%,19m
1815,1,zmd,3740,255,13,5,18,72.2%,4m
1815,3,llllllllllll,3740,0,1,1,2,50.0%,22m
1815,3,GreenEve,3740,0,0,1,1,0.0%,7m
1820,3,KJW,3739,492,18,12,30,60.0%,8m
1821,3,Novice,3738,748,28,26,54,51.9%,20m
1821,3,IIIIIIIIIII,3738,86,4,0,4,100.0%,5m
1821,3,AKITO,3738,0,1,1,2,50.0%,5m
1821,3,[중금속중독자]JudistLean,3738,0,1,1,2,50.0%,8m
1825,3,idkausername,3737,955,53,39,92,57.6%,4m
1825,2,IIIIIIIIIIII,3737,194,6,16,22,27.3%,6m
1827,3,카나발리즘,3736,0,1,5,6,16.7%,5m
1828,2,IIIIIIIIIIII,3735,522,17,34,51,33.3%,5m
1828,3,붕가붕가,3735,115,4,2,6,66.7%,4m
1830,3,SoS,3734,1453,81,70,151,53.6%,5m
1830,3,마초킹,3734,344,15,11,26,57.7%,5m
1830,3,[Sett]Alarak,3734,354,13,9,22,59.1%,19m
1830,3,[독도비둘기]krov,3734,0,1,0,1,100.0%,15m
1830,3,[마산]messi,3734,0,1,0,1,100.0%,15m
1835,2,초보,3733,1425,273,279,552,49.5%,18m
1835,3,까칠한호야,3733,1068,65,48,113,57.5%,5m
1835,2,BlueJDupley,3733,672,22,43,65,33.8%,5m
1835,3,[SML]너굴휘,3733,190,8,14,22,36.4%,5m
1839,3,테란살육도살머신,3732,92,4,4,8,50.0%,21m
1839,3,AsanaKuna,3732,118,4,7,11,36.4%,19m
1841,3,LostAgain,3730,1621,100,66,166,60.2%,4m
1841,3,Liberty,3730,114,5,2,7,71.4%,18m
1841,3,[노잼]보라노아바,3730,0,0,1,1,0.0%,5m
1844,3,GaiaMvP,3729,58,2,1,3,66.7%,5m
1845,3,IIIIIIIIIII,3728,230,10,5,15,66.7%,17m
1846,2,PPPPPPPPP,3727,1512,369,393,762,48.4%,22m
1846,3,[보돌]Woo,3727,652,27,16,43,62.8%,22m
1846,3,Garchuu,3727,114,5,0,5,100.0%,5m
1846,3,Triyakki,3727,58,3,3,6,50.0%,21m
1850,2,[Insane]goodnight,3726,1437,193,199,392,49.2%,6m
1850,1,spireet,3726,185,4,4,8,50.0%,4m
1852,3,IIIIIIIIIIII,3725,1609,209,198,407,51.4%,4m
1852,2,CHAOS,3725,1214,90,99,189,47.6%,15m
1854,3,Jonskma,3724,1302,108,104,212,50.9%,22m
1854,3,얼벌이,3724,0,0,1,1,0.0%,19m
1856,2,와디더,3723,1296,103,94,197,52.3%,8m
1856,3,[鋼鐵意志]風清揚,3723,30,1,1,2,50.0%,15m
1856,3,[Tyler]최강가츠,3723,0,0,2,2,0.0%,17m
1859,3,綠曲侯,3722,1528,159,133,292,54.5%,8m
1860,3,구공쌍탄,3721,1630,106,109,215,49.3%,8m
1860,3,한국사람,3721,251,9,17,26,34.6%,18m
1862,2,Luminox,3719,1441,485,517,1002,48.4%,8m
1862,3,孤星,3719,1299,128,117,245,52.2%,19m
1862,3,[자1위단]Wednesday,3719,146,5,8,13,38.5%,4m
1862,3,TerATo,3719,0,0,1,1,0.0%,15m
1866,3,독한술,3718,801,33,18,51,64.7%,5m
1866,3,Kipyatoss,3718,488,22,10,32,68.8%,5m
1866,3,llllllllllll,3718,142,5,5,10,50.0%,15m
1869,3,AdamMidler,3717,1570,186,179,365,51.0%,15m
1869,2,별바다,3717,1278,50,64,114,43.9%,22m
1871,3,애지가니,3716,544,22,13,35,62.9%,5m
1871,3,fialka,3716,172,7,7,14,50.0%,15m
1873,3,ClOuD,3715,86,8,1,9,88.9%,5m
1873,3,llllllllllll,3715,174,6,6,12,50.0%,4m
1873,3,[비트]파브레가스,3715,0,0,1,1,0.0%,19m
1876,3,[med]CasaiiiNova,3714,656,23,34,57,40.4%,7m
1876,3,조땡,3714,399,21,14,35,60.0%,22m
1876,3,[ELSII]OMGitsKorean,3714,495,19,8,27,70.4%,8m
1876,3,[무한오영종]Origin,3714,351,14,4,18,77.8%,19m
1876,3,IonAl,3714,114,5,2,7,71.4%,20m
1881,3,FoRtiSimO,3713,276,13,3,16,81.2%,19m
1881,3,[세미온특공대]쿠니키다하나마루,3713,0,0,1,1,0.0%,4m
1883,3,뿌잉뿌잉,3712,1537,116,101,217,53.5%,22m
1883,3,Zoveride,3712,526,18,20,38,47.4%,20m
1883,3,lllllllll,3712,30,2,1,3,66.7%,8m
1886,3,Fizz,3711,821,33,27,60,55.0%,17m
1886,3,Dice,3711,58,2,3,5,40.0%,15m
1886,3,Physical,3711,0,1,0,1,100.0%,5m
1889,2,fasdafdasd,3709,1589,118,118,236,50.0%,6m
1889,3,HyperX,3709,602,22,25,47,46.8%,7m
1889,3,[어윤수님개쩜]채워줘,3709,180,6,7,13,46.2%,7m
1889,3,IRISnine,3709,88,4,3,7,57.1%,19m
1889,3,저그가싫어요,3709,0,1,0,1,100.0%,19m
1894,2,IIIIIIIII,3708,1433,64,64,128,50.0%,5m
1894,3,[이터널]바퀴왕김백희,3708,740,29,24,53,54.7%,8m
1894,3,[d타짜b]너구리,3708,418,16,15,31,51.6%,5m
1894,3,[IWYDI]KarthySky,3708,430,14,22,36,38.9%,20m
1894,1,SmashConix,3708,0,5,0,5,100.0%,41m
1894,3,메리,3708,124,5,5,10,50.0%,19m
1900,3,lllllllllllI,3707,602,22,19,41,53.7%,5m
1900,3,IIIIIIIII,3707,90,4,8,12,33.3%,4m
1900,3,[丨SLT丨]秋名山的老司机,3707,0,1,0,1,100.0%,20m
1900,3,여기내맘속에,3707,30,1,2,3,33.3%,8m
1900,3,llllllllllll,3707,0,0,1,1,0.0%,17m
1900,3,[navel]Asahi,3707,0,0,5,5,0.0%,19m
1906,2,[인정]llllllllllll,3706,1516,184,182,366,50.3%,4m
1906,3,llllIIIIllll,3706,709,36,39,75,48.0%,15m
1906,3,CHOPINMARS,3706,322,22,19,41,53.7%,20m
1906,3,ctarsraft,3706,304,11,9,20,55.0%,19m
1910,3,worryburry,3704,488,19,11,30,63.3%,17m
1911,3,[SC2HK]青銅鮮奶茶,3703,172,6,9,15,40.0%,15m
1912,3,LinhgHas,3702,389,44,40,84,52.4%,22m
1912,3,hypothesis,3702,0,0,1,1,0.0%,15m
1914,2,YakJeng,3701,1462,106,113,219,48.4%,7m
1914,3,special,3701,123,3,1,4,75.0%,6m
1914,3,스따뚜,3701,30,1,2,3,33.3%,20m
1917,3,[정치공학]대간,3700,114,5,1,6,83.3%,19m
1917,3,新心手,3700,114,5,5,10,50.0%,19m
1919,2,bluebear,3699,1184,60,66,126,47.6%,8m
1919,3,소나기,3699,0,0,1,1,0.0%,4m
1921,3,goldfish,3698,1499,66,54,120,55.0%,8m
1922,3,[LOVEC]TravelEWorld,3697,168,6,5,11,54.5%,4m
1923,3,사회복무요원,3696,750,110,90,200,55.0%,19m
1924,2,향백병사,3695,1511,96,110,206,46.6%,15m
1925,3,TheNemesis,3694,1301,56,58,114,49.1%,8m
1925,3,NERD,3694,30,2,0,2,100.0%,22m
1927,3,[주몽]굉장히엄청난사람,3693,301,10,3,13,76.9%,8m
1927,3,세영낙타,3693,88,3,7,10,30.0%,4m
1927,3,llllllllllll,3693,0,1,1,2,50.0%,4m
1927,3,[한발이면]우윙,3693,30,1,2,3,33.3%,4m
1931,3,hansko,3692,983,53,53,106,50.0%,5m
1931,3,IIIIIIIIIIII,3692,689,28,18,46,60.9%,7m
1931,3,LGAB,3692,90,4,6,10,40.0%,8m
1931,3,행주,3692,86,3,6,9,33.3%,19m
1931,3,AkiyamaMio,3692,30,1,1,2,50.0%,15m
1931,3,[PsTe]Baneling,3692,0,0,1,1,0.0%,5m
1937,3,Fantasi,3691,1486,100,76,176,56.8%,19m
1937,3,IIIIIIIIIII,3691,801,40,47,87,46.0%,19m
1937,3,lIllIIlllIII,3691,375,18,8,26,69.2%,20m
1937,3,[브리티안]헤센카셀,3691,30,2,0,2,100.0%,18m
1937,3,llllllllllll,3691,94,1,1,2,50.0%,8m
1942,3,IIIIIIIIIIII,3690,62,2,6,8,25.0%,15m
1942,1,[SHIPS]븅신듀크새끼,3690,0,0,1,1,0.0%,4m
1944,3,Immaculate,3689,380,17,7,24,70.8%,19m
1944,3,lIlIIlllIlll,3689,0,0,1,1,0.0%,5m
1944,3,강화충,3689,0,0,2,2,0.0%,4m
1947,3,전기기술사따자,3688,60,2,3,5,40.0%,7m
1947,3,무적권,3688,0,0,2,2,0.0%,19m
1947,3,[그림리퍼]레이너,3688,0,0,3,3,0.0%,20m
1950,3,BugsBunny,3687,1509,238,233,471,50.5%,17m
1951,3,herO,3686,150,5,8,13,38.5%,4m
1952,3,LiF,3685,0,1,1,2,50.0%,18m
1952,3,강원도지킴이,3685,0,0,1,1,0.0%,5m
1954,3,[Cla1st]프로토스,3684,1512,199,181,380,52.4%,5m
1954,3,[GIS]ReCall,3684,1421,76,77,153,49.7%,8m
1956,3,llllllllllll,3683,454,16,15,31,51.6%,8m
1956,2,RyanKim,3683,226,8,1,9,88.9%,18m
1956,3,[WTSC]UED,3683,0,0,1,1,0.0%,20m
1959,3,clemfans,3682,1139,54,30,84,64.3%,4m
1959,3,alberthor,3682,474,19,17,36,52.8%,15m
1959,3,허공에이엠피,3682,288,12,15,27,44.4%,8m
1959,3,Very,3682,0,1,1,2,50.0%,4m
1963,3,IIIIIIIIIIII,3681,106,4,4,8,50.0%,17m
1963,3,[시럽]Respect,3681,0,0,1,1,0.0%,4m
1965,3,[CStorM]전지전능,3680,1397,99,90,189,52.4%,21m
1965,3,CYsurfinwind,3680,1002,77,59,136,56.6%,15m
1967,3,TOS,3679,1577,130,115,245,53.1%,19m
1967,3,삭풍스탈,3679,58,2,1,3,66.7%,21m
1969,3,그냥사는인간,3678,1099,49,34,83,59.0%,4m
1969,3,밍밍,3678,165,3,2,5,60.0%,8m
1971,2,llllllllllll,3677,607,179,204,383,46.7%,4m
1971,3,DJOKAWARI,3677,1500,74,70,144,51.4%,4m
1971,2,[Organs]ForMMR,3677,1047,51,72,123,41.5%,6m
1971,3,IIIIIIIIIIII,3677,501,33,30,63,52.4%,21m
1971,3,[LiBts]글로벌무료똥망겜,3677,329,16,8,24,66.7%,18m
1976,3,imbaraman,3676,1544,583,525,1108,52.6%,22m
1976,3,탐사정좀살려줘,3676,1368,52,53,105,49.5%,7m
1976,3,[순수]도로시,3676,30,2,0,2,100.0%,7m
1976,3,[WeRRa]llllllllllll,3676,0,0,2,2,0.0%,4m
1980,3,[NsP]Navaluss,3675,0,0,1,1,0.0%,5m
1980,3,lIllllllIIl,3675,0,0,1,1,0.0%,19m
1982,3,나를연애하게하라,3674,465,26,23,49,53.1%,5m
1982,1,llllllllllll,3674,0,0,1,1,0.0%,39m
1984,3,[ANGG]애플은사과,3672,730,28,29,57,49.1%,20m
1984,3,[아이라잌치킨]HedgeHog,3672,140,7,6,13,53.8%,8m
1984,3,DevilSeed,3672,154,6,9,15,40.0%,8m
1984,2,삭쾡이,3672,46,1,4,5,20.0%,19m
1988,3,Banker,3671,853,36,25,61,59.0%,8m
1988,3,[온갤]일상,3671,239,11,21,32,34.4%,15m
1988,1,SykO,3671,167,5,1,6,83.3%,40m
1988,3,PrfmArveL,3671,161,4,3,7,57.1%,7m
1988,3,Prophecy,3671,30,1,1,2,50.0%,8m
1988,3,CenTurioN,3671,0,0,1,1,0.0%,4m
1994,2,어락귀,3670,1433,224,229,453,49.4%,7m
1995,3,[WDY]Merry,3669,0,1,0,1,100.0%,4m
1995,3,죄송해요,3669,0,1,0,1,100.0%,8m
1997,2,SPARK,3668,1503,222,224,446,49.8%,7m
1997,3,wotjd,3668,1438,114,108,222,51.4%,4m
1997,3,[STbox]로시츠키,3668,780,32,27,59,54.2%,4m
1997,3,푸굽다튀기기,3668,60,2,4,6,33.3%,20m
2001,3,데몬헌터,3667,1471,130,111,241,53.9%,8m
2001,3,[ANGG]Geologist,3667,355,13,16,29,44.8%,4m
2003,3,HHHH,3666,161,4,2,6,66.7%,4m
2003,3,[MPC]SKTKIMYUHA,3666,0,1,0,1,100.0%,18m
2003,3,부뷰뷰,3666,0,0,1,1,0.0%,15m
2003,3,SeanLin,3666,0,0,1,1,0.0%,5m
2007,3,[원빈]원빈처럼고수처럼,3665,60,3,7,10,30.0%,19m
2007,3,메카짱짱맨,3665,30,1,5,6,16.7%,6m
2009,3,llIllIllIIll,3664,30,3,3,6,50.0%,5m
2009,3,임포스터,3664,0,0,1,1,0.0%,19m
2011,3,llllllllllll,3663,442,17,15,32,53.1%,15m
2011,3,쪼알,3663,482,17,19,36,47.2%,5m
2011,3,여찌,3663,360,14,10,24,58.3%,5m
2011,3,傲血峰,3663,0,3,2,5,60.0%,4m
2011,3,[듀단은아이유]긔태연,3663,30,2,0,2,100.0%,8m
2011,3,MoMoRing,3663,0,0,1,1,0.0%,19m
2011,3,아이린,3663,0,0,1,1,0.0%,19m
2018,3,[GIS]小翔,3662,1476,103,110,213,48.4%,5m
2018,3,IIIIIIIIIIII,3662,731,30,23,53,56.6%,5m
2018,3,ZRL,3662,150,8,1,9,88.9%,7m
2018,3,Spectre,3662,167,8,2,10,80.0%,7m
2022,3,[xTMDx]WinS,3661,86,4,7,11,36.4%,7m
2022,3,짐은레이너라네,3661,0,1,0,1,100.0%,20m
2024,2,[快樂玩家]Clementine,3660,1497,126,131,257,49.0%,7m
2024,3,Raboy,3660,196,7,4,11,63.6%,8m
2024,3,트월킹출게요,3660,0,1,0,1,100.0%,4m
2027,3,도노,3659,590,21,28,49,42.9%,5m
2027,3,Raye,3659,145,8,1,9,88.9%,8m
2027,3,[핑핑이]다크템플러,3659,0,0,1,1,0.0%,8m
2030,2,HowToPlay,3658,1480,479,468,947,50.6%,5m
2030,3,Secret,3658,144,5,3,8,62.5%,22m
2032,3,pilot,3657,60,3,3,6,50.0%,7m
2033,3,IllIIllIIllI,3656,587,33,42,75,44.0%,4m
2033,3,letria,3656,344,16,7,23,69.6%,21m
2033,3,llllllllIIIl,3656,259,15,0,15,100.0%,20m
2033,3,[wenoob]MagicGirlY,3656,97,2,0,2,100.0%,8m
2033,3,Kkyu,3656,0,1,4,5,20.0%,4m
2038,3,lllllllll,3655,214,7,13,20,35.0%,21m
2039,3,[액션스타]황간지,3654,1529,359,347,706,50.8%,21m
2039,3,Pollux,3654,979,40,36,76,52.6%,5m
2039,3,비둘기야밥먹자,3654,142,6,9,15,40.0%,4m
2039,3,스타만합니다,3654,0,0,1,1,0.0%,21m
2043,3,LoveZNW,3653,150,6,8,14,42.9%,21m
2043,3,볼빨간아저씨,3653,30,1,8,9,11.1%,22m
2045,3,haro,3652,1114,454,434,888,51.1%,8m
2045,3,zerglisk,3652,0,1,1,2,50.0%,4m
2047,3,즐기면서,3651,1542,77,66,143,53.8%,21m
2047,3,JasonRUSH,3651,143,8,2,10,80.0%,4m
2047,2,슈퍼초보,3651,141,5,8,13,38.5%,18m
2050,3,[잠시만]hseta,3650,1365,59,42,101,58.4%,22m
2050,3,Greyhair,3650,766,31,33,64,48.4%,15m
2050,3,LoveMade,3650,90,4,4,8,50.0%,8m
2053,3,Kriton,3649,861,41,26,67,61.2%,19m
2053,3,[back]ProssTemplar,3649,0,0,2,2,0.0%,4m
2055,3,llllllllllll,3648,817,37,21,58,63.8%,21m
2055,3,lIlIlIlIlIlI,3648,92,3,4,7,42.9%,20m
2055,3,NEXCho,3648,30,2,1,3,66.7%,21m
2058,3,[Equal]myeyes,3647,1316,180,167,347,51.9%,4m
2058,3,몬드,3647,1185,125,112,237,52.7%,21m
2058,3,[oNs7]슈우웅,3647,1328,61,33,94,64.9%,18m
2061,3,ANDY,3646,1467,92,68,160,57.5%,20m
2061,3,llllllllllll,3646,0,1,0,1,100.0%,4m
2061,3,Jazzer,3646,30,1,3,4,25.0%,5m
2064,3,大包哥哥,3644,258,10,11,21,47.6%,22m
2064,3,말머리유씨가문,3644,0,1,4,5,20.0%,6m
2066,3,sAviOr,3643,60,3,3,6,50.0%,22m
2066,3,Sylvanaslyz,3643,0,0,1,1,0.0%,15m
2068,3,오스키,3642,1233,92,54,146,63.0%,19m
2069,2,OLOI,3641,352,112,102,214,52.3%,6m
2069,3,경조,3641,30,2,0,2,100.0%,18m
2069,3,GwANgRaN,3641,0,0,1,1,0.0%,19m
2072,3,[NerfZg]Aguero,3639,1563,100,81,181,55.2%,4m
2072,3,llllllllllll,3639,1207,56,48,104,53.8%,15m
2072,3,[LF]푸른초,3639,705,54,61,115,47.0%,7m
2072,3,[2029]HisuMi,3639,376,15,6,21,71.4%,15m
2072,3,tqlsdlwsl,3639,60,2,3,5,40.0%,7m
2077,3,[공허거주]LEVIATHAN,3638,1326,108,85,193,56.0%,8m
2077,3,[살피마리]질럿,3638,0,0,6,6,0.0%,17m
2079,3,[Mini]Hwasin,3637,377,56,40,96,58.3%,22m
2079,3,[TUNA]Hero,3637,88,8,2,10,80.0%,4m
2079,3,맥도날드,3637,0,3,2,5,60.0%,4m
2079,3,국민영웅,3637,30,1,3,4,25.0%,5m
2079,3,어쿠스틱,3637,0,0,4,4,0.0%,15m
2084,2,Neroc,3636,92,2,0,2,100.0%,16m
2084,3,Raphael,3636,0,0,1,1,0.0%,5m
2086,3,에반데,3635,498,19,16,35,54.3%,5m
2086,3,OverLoading,3635,280,9,14,23,39.1%,15m
2086,3,[ELS]마이어,3635,167,4,6,10,40.0%,20m
2086,3,[TITSQ]AprilRyanTT,3635,0,1,0,1,100.0%,19m
2090,3,TossArtist,3634,30,6,1,7,85.7%,18m
2090,3,IIIIIIIIIIII,3634,92,4,5,9,44.4%,18m
2090,3,itsnotfunny,3634,0,0,3,3,0.0%,18m
2093,2,IIIIIIIIIIII,3633,187,9,4,13,69.2%,8m
2093,3,노란바퀴,3633,0,0,1,1,0.0%,4m
2093,3,Cheerio,3633,0,0,1,1,0.0%,5m
2096,3,[Tsuper]땜시,3632,736,31,16,47,66.0%,19m
2096,3,[걸스데이]llllllllllll,3632,30,1,2,3,33.3%,19m
2098,3,slimechips,3631,1558,290,278,568,51.1%,8m
2098,2,吟绿颂青,3631,96,6,0,6,100.0%,41m
2098,3,jIN,3631,0,1,0,1,100.0%,4m
2098,3,[Fu]Neptune,3631,97,1,4,5,20.0%,5m
2102,3,[국가정보원]llllllllllll,3630,337,21,22,43,48.8%,20m
2102,3,Statistics,3630,288,11,8,19,57.9%,4m
2102,2,IlIIlllIllII,3630,177,6,9,15,40.0%,18m
2105,3,파이리,3629,281,13,6,19,68.4%,5m
2105,3,prisprime,3629,0,0,1,1,0.0%,8m
2107,3,SpecialLunch,3628,1198,135,145,280,48.2%,18m
2107,3,Ashole,3628,296,11,8,19,57.9%,7m
2107,3,llllllllllll,3628,190,10,2,12,83.3%,19m
2107,3,天王州雅典娜,3628,0,1,0,1,100.0%,4m
2111,3,thskan,3627,1524,421,416,837,50.3%,19m
2111,2,TarpinG,3627,1454,281,281,562,50.0%,4m
2113,2,[硬漢]ToughguyMars,3626,1250,63,72,135,46.7%,22m
2113,3,[매독]TheG,3626,166,7,3,10,70.0%,19m
2113,3,캉매,3626,58,3,0,3,100.0%,19m
2113,3,KALNALQUEEN,3626,0,0,1,1,0.0%,4m
2117,3,압도적인힘으로,3625,731,102,95,197,51.8%,22m
2117,3,boxer,3625,1466,73,64,137,53.3%,7m
2117,3,pmLappy,3625,212,11,0,11,100.0%,18m
2117,3,iiillllliii,3625,88,4,2,6,66.7%,5m
2117,3,JUNE,3625,0,1,4,5,20.0%,5m
2117,3,장동건,3625,0,1,6,7,14.3%,19m
2117,3,[ELS]빵꾸똥꾸,3625,0,0,1,1,0.0%,17m
2124,3,Rick,3624,300,28,17,45,62.2%,19m
2124,3,[티모올스킨]nkpark,3624,30,1,3,4,25.0%,8m
2126,3,[Spades]TragicComedy,3623,1549,81,57,138,58.7%,18m
2126,2,deeplounge,3623,257,12,4,16,75.0%,18m
2128,3,AzrealBrian,3622,1079,83,78,161,51.6%,17m
2128,3,[NIA]SonicBullet,3622,1488,55,68,123,44.7%,19m
2128,1,[이방CITY]JuN,3622,165,8,1,9,88.9%,40m
2128,3,김에녹,3622,0,1,0,1,100.0%,18m
2132,3,Auliterrrrr,3621,1048,46,40,86,53.5%,17m
2132,3,[섹시아재]아빠멩스크,3621,86,3,1,4,75.0%,20m
2132,3,흐하악,3621,94,2,0,2,100.0%,6m
2132,3,Kanpo,3621,0,1,4,5,20.0%,6m
2136,3,NoVice,3620,30,2,0,2,100.0%,4m
2136,3,[투막빌런협회]군단의심장,3620,0,0,1,1,0.0%,5m
2138,3,마자아아룡,3619,1033,175,146,321,54.5%,22m
2138,3,케이준치킨샐러드,3619,30,2,2,4,50.0%,21m
2138,3,llIIllIIllII,3619,0,0,1,1,0.0%,8m
2138,3,[Equal]벨귀,3619,0,0,1,1,0.0%,21m
2142,3,존잘빈,3618,310,12,13,25,48.0%,20m
2143,3,[Miku39]微風,3617,1456,118,117,235,50.2%,8m
2144,3,[0I터널]Gonzo,3616,363,20,12,32,62.5%,20m
2144,3,[국방부사서병]코로나는사기다,3616,474,20,15,35,57.1%,8m
2144,1,Flamyblade,3616,122,7,1,8,87.5%,39m
2147,3,Raivia,3615,532,72,59,131,55.0%,22m
2147,3,[네임]ZawszeInLove,3615,278,10,18,28,35.7%,7m
2149,3,델랏,3614,1337,69,39,108,63.9%,18m
2149,3,黄金脆皮油炸鸡,3614,168,6,4,10,60.0%,22m
2151,3,[JD]YHJ,3613,421,19,6,25,76.0%,22m
2151,3,IIIlllIIIllI,3613,406,16,6,22,72.7%,5m
2151,3,dkricm,3613,416,15,13,28,53.6%,18m
2151,1,MyAss,3613,116,3,2,5,60.0%,40m
2151,1,드라군볼,3613,0,1,1,2,50.0%,6m
2151,3,ckshrimp,3613,40,1,4,5,20.0%,6m
2157,2,[SC2HK]好七的戰士,3611,1507,210,195,405,51.9%,21m
2157,3,[探測機公會]愛過了才知道痛,3611,0,1,0,1,100.0%,21m
2157,2,llllllllllll,3611,0,0,1,1,0.0%,42m
2160,3,[Rush]ccRush,3610,0,0,3,3,0.0%,22m
2161,3,[WDNMD]Sonic,3609,631,27,19,46,58.7%,8m
2161,3,asdfghjkl,3609,154,7,12,19,36.8%,5m
2161,3,lllllllllll,3609,0,1,0,1,100.0%,5m
2161,3,[피지옥]블러디블레이즈,3609,0,0,1,1,0.0%,19m
2165,2,지금은휴식중,3608,142,4,0,4,100.0%,16m
2165,1,[Rovic]Parasite,3608,48,2,1,3,66.7%,39m
2167,3,Guldan,3606,132,4,19,23,17.4%,21m
2167,3,완이,3606,0,1,0,1,100.0%,21m
2167,3,[CIM]彭于晏,3606,0,1,0,1,100.0%,8m
2170,3,llllllllllll,3605,464,21,6,27,77.8%,4m
2170,3,미남쫑,3605,0,1,0,1,100.0%,15m
2170,2,[GITS]HaoKing,3605,46,1,1,2,50.0%,42m
2170,3,간지용,3605,0,0,2,2,0.0%,8m
2174,3,sGravenhage,3604,1033,44,41,85,51.8%,8m
2174,3,Rain,3604,406,15,19,34,44.1%,15m
2174,3,[KRSC2]초무홈,3604,0,0,1,1,0.0%,22m
2177,3,IIIIIIIIIIII,3603,1058,47,30,77,61.0%,19m
2177,3,llllllllllll,3603,810,28,39,67,41.8%,4m
2177,3,[영어는야나두]asdsad,3603,128,7,1,8,87.5%,7m
2177,3,[Ato]Andrew,3603,0,1,0,1,100.0%,8m
2181,3,마스터상륙작전,3602,716,32,35,67,47.8%,8m
2181,3,[偶像型男隊]TerranRoy,3602,99,5,3,8,62.5%,5m
2181,3,[DaBL]콜레라,3602,0,0,1,1,0.0%,22m
2184,3,PowerAnet,3601,1534,82,60,142,57.7%,6m
2184,3,[도재욱]Best,3601,0,0,1,1,0.0%,19m
2184,3,[슈퍼꿀벌]Bobon,3601,0,0,1,1,0.0%,5m
2184,3,[SPTS]烏爾奇奧拉西法,3601,0,0,2,2,0.0%,5m
2188,3,vhbf,3600,745,32,20,52,61.5%,7m
2188,3,ZergHunter,3600,554,21,22,43,48.8%,4m
2190,3,동웅광전사,3599,760,34,32,66,51.5%,5m
2190,3,[deathK]Darkblade,3599,210,8,10,18,44.4%,15m
2190,3,llllllllllll,3599,116,4,3,7,57.1%,20m
2193,3,[NGameS]체리맛음료,3598,720,31,20,51,60.8%,15m
2193,3,EOEJEOEJ,3598,148,6,4,10,60.0%,15m
2193,3,히시로스,3598,58,2,2,4,50.0%,20m
2196,3,허댕,3597,1335,92,93,185,49.7%,5m
2196,3,Maverick,3597,775,65,46,111,58.6%,4m
2198,3,Halla,3596,30,2,5,7,28.6%,15m
2199,3,WinFestors,3595,1174,93,75,168,55.4%,20m
2199,3,Earl,3595,206,9,4,13,69.2%,6m
2199,3,Christmas,3595,0,1,2,3,33.3%,22m
2202,3,jOkeR,3594,419,45,48,93,48.4%,20m
2202,3,[연필]지우개,3594,30,2,1,3,66.7%,8m
2202,3,llllllllllll,3594,0,1,0,1,100.0%,21m
2202,2,[ForG]조영빈뿌잉뿌잉,3594,0,1,0,1,100.0%,6m
2202,3,[Gavin]Gavin,3594,0,1,0,1,100.0%,22m
2207,3,[스타놀이터]IIIIIIIIIIII,3593,796,30,30,60,50.0%,5m
2207,3,유령,3593,340,25,7,32,78.1%,7m
2207,3,IIIIIIIIIIII,3593,193,9,3,12,75.0%,8m
2207,3,kudryavka,3593,0,0,2,2,0.0%,15m
2211,3,DexKillsDeb,3592,734,32,25,57,56.1%,20m
2211,3,IIIIIIIII,3592,292,11,12,23,47.8%,5m
2211,3,MarineKing,3592,262,9,16,25,36.0%,8m
2211,3,VoidRay,3592,0,1,0,1,100.0%,20m
2211,3,[DMN]楪祈,3592,0,0,1,1,0.0%,5m
2211,3,YaMan,3592,0,0,2,2,0.0%,4m
2217,3,NNN,3591,518,23,14,37,62.2%,7m
2217,3,[Nembot]Nemesis,3591,154,6,18,24,25.0%,4m
2217,3,一只手打进职业,3591,0,0,1,1,0.0%,21m
2220,3,Zero,3590,1151,64,61,125,51.2%,4m
2220,3,llllllllllll,3590,1277,58,51,109,53.2%,8m
2220,3,zoltar,3590,0,0,1,1,0.0%,5m
2223,3,[XDream]WoPao,3589,384,14,18,32,43.8%,21m
2224,3,토리,3588,30,3,5,8,37.5%,8m
2224,3,UED,3588,30,2,2,4,50.0%,22m
2224,3,solwet,3588,60,2,4,6,33.3%,22m
2224,3,Luna,3588,30,1,4,5,20.0%,7m
2228,3,Closer,3587,825,39,37,76,51.3%,19m
2228,1,仙履奇緣,3587,0,0,1,1,0.0%,41m
2230,3,MingKynism,3585,1212,59,53,112,52.7%,7m
2230,3,쌩초보,3585,93,6,0,6,100.0%,7m
2230,3,melonsoda,3585,150,6,9,15,40.0%,6m
2230,3,LaCucaracha,3585,114,4,3,7,57.1%,19m
2230,3,quantum,3585,0,1,0,1,100.0%,18m
2230,3,Yun,3585,30,1,2,3,33.3%,5m
2236,3,아니하,3584,0,1,1,2,50.0%,5m
2236,3,김게임,3584,30,1,3,4,25.0%,8m
2238,3,SangDoo,3583,565,20,17,37,54.1%,18m
2238,3,비숑사랑,3583,178,6,10,16,37.5%,15m
2238,3,[빨간달]Seowal,3583,179,6,19,25,24.0%,5m
2238,3,Arondight,3583,0,1,4,5,20.0%,18m
2242,3,[국민MC]유재석,3582,960,39,36,75,52.0%,8m
2242,3,Gloriam,3582,94,6,0,6,100.0%,7m
2242,1,Bisu,3582,145,2,7,9,22.2%,40m
2242,3,TOP,3582,0,0,1,1,0.0%,8m
2246,3,DarkShadow,3581,1261,252,247,499,50.5%,6m
2246,2,ebi,3581,110,3,3,6,50.0%,6m
2246,3,정글쥬스,3581,0,0,3,3,0.0%,8m
2249,3,[ciua]Moombaex,3580,649,28,26,54,51.9%,20m
2249,2,[좀비항문]좀역,3580,303,11,11,22,50.0%,18m
2249,2,[달콤]바람꽃,3580,46,3,4,7,42.9%,41m
2249,3,싹수짱,3580,0,0,2,2,0.0%,19m
2253,3,데스노트,3579,1282,58,37,95,61.1%,21m
2253,3,llllllllllll,3579,294,13,17,30,43.3%,20m
2255,3,[무한오영종]llllllllllil,3578,1484,75,71,146,51.4%,8m
2256,3,sanfrancisco,3577,1577,108,102,210,51.4%,15m
2256,3,노숙자,3577,892,36,31,67,53.7%,6m
2256,3,포대장,3577,352,13,20,33,39.4%,8m
2256,3,IlIlIlIlIl,3577,148,5,10,15,33.3%,5m
2256,3,Rusien,3577,0,0,1,1,0.0%,8m
2261,3,foREVer,3576,90,8,3,11,72.7%,19m
2262,3,[무한오영종]루삥뽕,3575,30,2,5,7,28.6%,5m
2262,3,Takuan,3575,60,2,6,8,25.0%,20m
2264,2,IIIIIIIIIIII,3574,1517,330,331,661,49.9%,16m
2264,2,노호홍,3574,350,16,6,22,72.7%,18m
2264,3,[KRisEZ]KRisHARD,3574,30,2,3,5,40.0%,8m
2264,3,Asunbro,3574,30,1,2,3,33.3%,18m
2268,3,래지,3573,350,12,21,33,36.4%,8m
2268,3,무작위나가주거,3573,222,9,2,11,81.8%,4m
2268,3,llllllllllll,3573,215,7,2,9,77.8%,20m
2268,3,[갈라파고스]하루,3573,0,0,1,1,0.0%,4m
2268,3,[Mist]stickgolem,3573,0,0,1,1,0.0%,15m
2273,3,TITAN,3572,1498,145,139,284,51.1%,4m
2273,3,[开打星战前夜]SantaMonica,3572,166,5,2,7,71.4%,18m
2273,3,kms,3572,86,3,4,7,42.9%,21m
2273,3,unknown,3572,0,0,1,1,0.0%,17m
2277,3,[이쁘지수]llll,3571,343,27,10,37,73.0%,19m
2277,3,Rainair,3571,488,22,14,36,61.1%,7m
2277,3,Archtanis,3571,154,6,4,10,60.0%,20m
2280,3,Mochup,3570,319,46,49,95,48.4%,17m
2281,2,LTopAz,3569,1524,197,215,412,47.8%,7m
2281,3,[경기도민]GGangMY,3569,847,68,55,123,55.3%,17m
2281,3,[김정은만세]IIIIIIIIIIII,3569,724,31,21,52,59.6%,4m
2281,3,[3연벙]콩콩콩콩까지마,3569,630,23,35,58,39.7%,5m
2281,1,Cheese,3569,144,8,1,9,88.9%,40m
2281,3,DreamlanD,3569,194,7,9,16,43.8%,8m
2281,1,AvglE,3569,97,2,1,3,66.7%,17m
2281,3,[DagmBa]비니,3569,0,0,4,4,0.0%,4m
2289,3,IIIIIIIIII,3568,1193,49,45,94,52.1%,20m
2289,1,SarsSan,3568,155,8,2,10,80.0%,40m
2289,3,저그개씹사기,3568,30,2,0,2,100.0%,7m
2289,3,Fly,3568,30,1,1,2,50.0%,4m
2293,3,price,3567,0,0,1,1,0.0%,19m
2293,3,ProtossEz,3567,0,0,2,2,0.0%,21m
2295,3,장현준,3566,500,19,18,37,51.4%,22m
2295,2,섹시가이,3566,289,11,8,19,57.9%,5m
2295,3,IIIIIIIIIIII,3566,30,1,1,2,50.0%,8m
2298,3,아르타니스,3565,1511,198,196,394,50.3%,8m
2298,3,[Sugar]도리도리짱,3565,278,11,10,21,52.4%,8m
2298,3,[TalenT]Dream,3565,121,3,3,6,50.0%,18m
2298,3,Splash,3565,58,2,4,6,33.3%,22m
2302,3,Optimization,3564,1421,153,129,282,54.3%,5m
2302,3,ISOSIIKA,3564,215,10,3,13,76.9%,6m
2302,3,IIIIIIIIIIII,3564,0,5,0,5,100.0%,20m
2302,3,KRplayeBMsux,3564,166,4,3,7,57.1%,20m
2306,3,뻐끔뻐끔뻐끔,3563,30,2,3,5,40.0%,8m
2306,3,lIlIlIlIlIlI,3563,30,1,3,4,25.0%,20m
2308,3,GAMEMIX,3562,628,24,17,41,58.5%,22m
2308,3,IlIlIlIlIlIl,3562,186,9,4,13,69.2%,6m
2308,3,lIllllIllll,3562,0,0,1,1,0.0%,21m
2311,3,[ELS]희짱펀치,3560,1489,214,200,414,51.7%,21m
2311,3,aDecay,3560,1510,91,82,173,52.6%,8m
2313,3,[CIM]GATTON,3559,218,8,24,32,25.0%,20m
2313,3,[Lotuz]루테르,3559,0,1,3,4,25.0%,4m
2313,3,탁은호,3559,0,0,2,2,0.0%,19m
2316,3,SeCre,3558,58,3,2,5,60.0%,20m
2316,3,광전사가좋아요,3558,0,0,1,1,0.0%,15m
2318,3,Queenzbeat,3556,738,98,82,180,54.4%,15m
2318,3,[국가정보원]BrzFourYrAgo,3556,1150,76,46,122,62.3%,6m
2318,3,[StorM]Lightning,3556,400,17,5,22,77.3%,22m
2318,3,KingNight,3556,358,13,13,26,50.0%,5m
2318,3,MONKEYDLUFFY,3556,30,1,2,3,33.3%,8m
2318,3,Rain,3556,0,0,2,2,0.0%,8m
2324,3,SparkleHands,3555,472,17,19,36,47.2%,19m
2324,3,미소짓는유리,3555,298,10,10,20,50.0%,19m
2324,3,[아름다운세상]내가제일젤나가,3555,0,1,2,3,33.3%,19m
2324,3,지는게이기는것,3555,97,1,3,4,25.0%,8m
2328,3,[Equal]awoy,3554,235,7,10,17,41.2%,4m
2328,2,Desperate,3554,118,3,2,5,60.0%,16m
2328,3,RoYal,3554,30,2,3,5,40.0%,18m
2328,3,Envy,3554,0,0,1,1,0.0%,6m
2332,3,IIIIIII,3553,1397,169,162,331,51.1%,15m
2332,3,[대테란자치령]llllllllllll,3553,340,13,4,17,76.5%,21m
2332,3,[사냥꾼]동족전안하는땅크,3553,285,9,7,16,56.2%,5m
2332,3,[ENT]Aroma,3553,182,7,13,20,35.0%,20m
2332,3,[Cexer]달을사랑한별,3553,90,4,5,9,44.4%,7m
2332,3,[Silent]llllllllllll,3553,0,1,3,4,25.0%,7m
2332,3,[트수Crew]CriAngelica,3553,0,0,1,1,0.0%,4m
2332,1,GreySkies,3553,0,0,1,1,0.0%,39m
2332,3,라이징스타,3553,0,0,2,2,0.0%,21m
2341,3,ideal,3552,208,7,8,15,46.7%,20m
2342,3,AVOIR,3550,1264,211,175,386,54.7%,8m
2342,3,[별똥별]꼴뚜기,3550,490,17,21,38,44.7%,22m
2342,3,SinAtra,3550,301,15,7,22,68.2%,19m
2342,1,winddieddown,3550,142,7,2,9,77.8%,41m
2342,3,IIIIIIIIIIII,3550,206,7,3,10,70.0%,4m
2347,3,Sophie,3549,1028,64,40,104,61.5%,21m
2347,3,Jillllllllll,3549,610,33,11,44,75.0%,21m
2347,3,[그시절의]마린허니,3549,371,13,8,21,61.9%,5m
2347,3,[Lotuz]Fox,3549,162,4,4,8,50.0%,19m
2351,3,IIIIIIIIIIII,3548,1219,51,44,95,53.7%,4m
2351,3,Coffeelife,3548,0,5,0,5,100.0%,5m
2351,3,[SHIPS]Dreamer,3548,0,4,1,5,80.0%,19m
2351,3,놀랄만한선박,3548,0,2,3,5,40.0%,11m
2355,3,llllllllllll,3547,566,23,26,49,46.9%,6m
2355,3,[16LAB]PlatinumStar,3547,293,11,4,15,73.3%,8m
2355,3,[NGameS]보라돌이,3547,205,11,8,19,57.9%,22m
2355,3,flowerstory,3547,316,10,5,15,66.7%,7m
2355,3,lIIIIIIIIIIl,3547,0,2,3,5,40.0%,7m
2355,3,폭주기관차,3547,0,1,1,2,50.0%,5m
2355,3,리소나,3547,30,1,2,3,33.3%,8m
2362,3,LoL,3546,315,15,9,24,62.5%,17m
2362,3,Rain,3546,200,7,8,15,46.7%,18m
2362,3,[시럽]Valencia,3546,163,4,1,5,80.0%,17m
2362,3,mothership,3546,118,4,11,15,26.7%,8m
2366,3,IllIllIlII,3545,404,35,29,64,54.7%,20m
2366,3,RIP,3545,60,2,3,5,40.0%,7m
2368,3,비키티,3544,895,216,177,393,55.0%,15m
2368,3,IlIlIlIlIlIl,3544,400,19,10,29,65.5%,6m
2368,3,GugsuGong,3544,0,5,0,5,100.0%,11m
2368,3,lIllIlIllI,3544,30,2,2,4,50.0%,20m
2372,3,Pishi,3543,233,19,20,39,48.7%,8m
2372,3,虛無飄渺,3543,196,8,3,11,72.7%,15m
2374,3,곤줄박이,3542,401,25,16,41,61.0%,19m
2374,3,아르타니스,3542,580,23,17,40,57.5%,5m
2374,3,態度翩翩,3542,95,1,1,2,50.0%,18m
2374,1,[KOSEAL]퇴교생,3542,0,0,2,2,0.0%,40m
2378,3,All,3541,144,10,7,17,58.8%,20m
2379,3,[스카이파이터]제논의칼날,3540,368,40,40,80,50.0%,18m
2379,3,소리없는유오성,3540,609,30,32,62,48.4%,19m
2379,3,하오우,3540,146,3,2,5,60.0%,5m
2379,3,수원혼모노이현성,3540,60,2,2,4,50.0%,5m
2379,2,[갓거킹]베이컨치즈와퍼,3540,0,0,1,1,0.0%,7m
2384,3,[TalenT]長島,3539,405,25,16,41,61.0%,19m
2384,1,ZENNNNN,3539,95,6,1,7,85.7%,8m
2384,3,kakaru,3539,141,4,1,5,80.0%,19m
2384,3,Scale,3539,88,4,5,9,44.4%,5m
2384,3,lIlIIlIIIIII,3539,0,0,5,5,0.0%,4m
2389,3,Ment,3538,949,59,34,93,63.4%,22m
2389,3,IIIIIIIIIIII,3538,364,13,16,29,44.8%,21m
2389,3,일상한가지즐거움,3538,103,3,2,5,60.0%,4m
2389,3,weder,3538,95,2,0,2,100.0%,21m
2389,3,라라소프트,3538,0,0,1,1,0.0%,15m
2394,3,곽비누,3537,282,10,18,28,35.7%,22m
2394,3,llllllllllll,3537,210,8,9,17,47.1%,7m
2394,3,Ayac,3537,30,6,1,7,85.7%,19m
2394,3,[SofT]트와이스다현,3537,115,3,0,3,100.0%,20m
2394,2,[도담이]과염소산암모늄,3537,110,2,4,6,33.3%,7m
2394,3,[시럽]Hanu,3537,0,0,1,1,0.0%,5m
2400,3,ReaperMaster,3536,1533,151,140,291,51.9%,17m
2400,3,ElFruit,3536,336,56,69,125,44.8%,17m
2400,3,[Komica]MisterHYC,3536,436,16,9,25,64.0%,4m
2400,3,말린망고,3536,0,1,0,1,100.0%,22m
2400,3,manA,3536,0,0,2,2,0.0%,5m
2400,1,Pikachu,3536,0,0,7,7,0.0%,39m
2406,3,AyWan,3535,755,80,66,146,54.8%,15m
2406,3,[sc2mc]wodnjs,3535,1318,51,51,102,50.0%,4m
2406,3,[세미레전드]하니,3535,569,34,1,35,97.1%,5m
2409,2,[애니멀킹덤]강아지왕국,3534,0,0,1,1,0.0%,43m
2410,3,airis,3533,662,229,213,442,51.8%,20m
2410,3,[GITS]ASxRyan,3533,1383,122,109,231,52.8%,21m
2410,3,프리븐,3533,469,23,11,34,67.6%,8m
2410,3,[애니멀킹덤]노스랜드로동로봇,3533,213,6,4,10,60.0%,19m
2410,3,터프스머프,3533,197,5,5,10,50.0%,7m
2410,3,배시시,3533,117,3,0,3,100.0%,7m
2416,3,공허의저그,3532,1468,213,202,415,51.3%,19m
2416,3,[옹선생님]DesignHype,3532,1068,55,46,101,54.5%,5m
2418,3,Alor,3531,627,47,31,78,60.3%,19m
2418,3,[IWYDI]NinetyFive,3531,266,25,13,38,65.8%,19m
2418,3,[IU]Appling,3531,256,11,3,14,78.6%,20m
2418,3,BobaBalls,3531,244,11,5,16,68.8%,6m
2418,3,USABABY,3531,0,0,1,1,0.0%,20m
2423,3,折磨韩国人,3530,372,18,11,29,62.1%,5m
2423,3,키보드워리어,3530,207,7,4,11,63.6%,7m
2423,2,Kronox,3530,141,5,0,5,100.0%,41m
2423,3,[도도]깨비,3530,135,3,2,5,60.0%,8m
2427,3,DoMsn,3529,963,54,41,95,56.8%,6m
2427,3,TraFalGarLaw,3529,827,36,25,61,59.0%,20m
2427,3,끄야아앍,3529,715,30,19,49,61.2%,21m
2427,3,신지혜,3529,30,4,1,5,80.0%,5m
2427,3,COZY,3529,120,2,1,3,66.7%,4m
2427,3,[l암살단l]TobyRyu,3529,0,1,0,1,100.0%,6m
2433,3,[어윤수님개쩜]잉여포격기,3528,722,36,21,57,63.2%,7m
2433,3,[NaLBIL]삼분토스,3528,866,36,26,62,58.1%,20m
2433,3,eurra,3528,120,5,6,11,45.5%,19m
2436,3,[DagmBa]통감자,3527,968,82,70,152,53.9%,15m
2436,3,Lichun,3527,1206,53,64,117,45.3%,8m
2436,3,bloodbath,3527,1010,51,35,86,59.3%,5m
2439,2,[뽕치면뒤진다]추니,3526,1439,246,250,496,49.6%,4m
2439,3,Nvclear,3526,1423,76,59,135,56.3%,5m
2439,3,破邪卽顯正,3526,650,29,21,50,58.0%,20m
2439,3,SeruleanBlue,3526,608,21,21,42,50.0%,22m
2439,3,IIIIIIIIIIII,3526,300,16,6,22,72.7%,7m
2439,3,NosAres,3526,168,8,3,11,72.7%,5m
2439,3,llllllllllll,3526,136,4,0,4,100.0%,5m
2439,3,한국인,3526,116,3,0,3,100.0%,5m
2439,1,혼돈의역사,3526,122,3,3,6,50.0%,7m
2448,3,twentyCM,3525,1048,112,96,208,53.8%,8m
2448,3,eprisbest,3525,1478,54,59,113,47.8%,20m
2448,3,Manly,3525,303,22,13,35,62.9%,22m
2448,3,무작위,3525,378,16,17,33,48.5%,4m
2448,3,[西木野真姫]완자와밥상,3525,0,1,1,2,50.0%,7m
2453,3,MoonRiver,3524,1557,66,59,125,52.8%,21m
2453,3,Ryobis,3524,624,24,23,47,51.1%,15m
2453,3,YSYS,3524,155,8,4,12,66.7%,5m
2453,2,[푸른장미]GPANG,3524,224,8,4,12,66.7%,16m
2453,3,llllllllllll,3524,0,5,0,5,100.0%,4m
2453,3,AbdArRahman,3524,0,5,0,5,100.0%,5m
2453,3,Fulutterenq,3524,122,4,10,14,28.6%,8m
2460,3,Kuro,3523,298,11,6,17,64.7%,7m
2460,2,IIIIIIIIIIII,3523,236,8,2,10,80.0%,16m
2460,3,[ASCII]fishyMurky,3523,174,7,9,16,43.8%,5m
2460,2,llllllll,3523,118,6,1,7,85.7%,43m
2460,3,[lPZ223]안진마,3523,0,0,1,1,0.0%,5m
2460,1,나빌레라,3523,0,0,2,2,0.0%,39m
2466,3,SAe,3522,888,80,69,149,53.7%,5m
2466,3,[YCIM]야부키나코,3522,424,18,11,29,62.1%,5m
2466,3,gagoman,3522,182,5,5,10,50.0%,5m
2466,3,[대단하시네]PureIceDream,3522,120,2,1,3,66.7%,8m
2466,3,Piano,3522,121,2,2,4,50.0%,21m
2466,3,[피비언니]양혜지,3522,95,1,1,2,50.0%,21m
2466,3,lWorstGodl,3522,0,0,1,1,0.0%,22m
2473,3,추니추니,3521,699,62,52,114,54.4%,19m
2473,3,Shine,3521,593,22,19,41,53.7%,7m
2473,3,denisking,3521,456,17,13,30,56.7%,19m
2473,3,ballyFoX,3521,389,13,16,29,44.8%,19m
2473,3,[옹선생님]방구왕,3521,248,9,13,22,40.9%,4m
2473,3,VoidKing,3521,168,5,3,8,62.5%,6m
2473,3,[Eire]Nova,3521,0,1,2,3,33.3%,7m
2480,3,꼬등어구이,3520,1432,89,63,152,58.6%,8m
2480,3,IIIIIIIIIIII,3520,1057,53,40,93,57.0%,7m
2480,1,므가증헌디,3520,1459,50,42,92,54.3%,17m
2480,3,[구리구리킹]한심해,3520,427,20,8,28,71.4%,15m
2480,3,Nio,3520,221,6,5,11,54.5%,7m
2480,3,[DoDori]도도리탕,3520,95,1,1,2,50.0%,19m
2486,3,멍둥곰,3519,1153,76,83,159,47.8%,20m
2486,3,atlantica,3519,196,9,7,16,56.2%,8m
2486,3,Antilles,3519,0,5,0,5,100.0%,43m
2486,3,[yummy]Sandwich,3519,180,5,4,9,55.6%,19m
2490,3,XDXD,3518,30,6,2,8,75.0%,19m
2490,2,IIIIllllIIll,3518,116,2,6,8,25.0%,41m
2490,1,Husky,3518,0,0,1,1,0.0%,17m
2490,3,카나데,3518,0,0,4,4,0.0%,4m
2494,3,기생충마냐,3517,718,32,19,51,62.7%,22m
2495,3,llllllllllll,3516,352,12,14,26,46.2%,5m
2495,3,신민아,3516,160,6,10,16,37.5%,7m
2495,1,[겨울방어]하우광,3516,86,5,3,8,62.5%,8m
2495,1,Clap,3516,0,0,1,1,0.0%,8m
2495,3,IIIIIIIIIIII,3516,0,0,4,4,0.0%,20m
2500,1,MrCraft,3515,452,14,8,22,63.6%,6m
2500,1,LIght,3515,0,5,0,5,100.0%,6m
2500,3,일산장동건,3515,110,2,2,4,50.0%,19m
2503,2,llllIIlIlIII,3514,1495,489,488,977,50.1%,7m
2503,3,IIIIIIIIIIII,3514,431,79,76,155,51.0%,19m
2503,3,[시럽]여름군고구마장수,3514,135,3,2,5,60.0%,8m
2506,1,闪耀偶像芭芭拉,3513,212,5,3,8,62.5%,4m
2506,3,LEFT,3513,120,4,6,10,40.0%,15m
2508,2,NeoModern,3512,1642,148,174,322,46.0%,8m
2508,3,憂鬱幻境,3512,58,4,6,10,40.0%,17m
2510,3,[TalenT]Enzo,3511,272,12,8,20,60.0%,20m
2510,3,짐레이너,3511,168,4,4,8,50.0%,4m
2512,3,[ELS]Dabs,3510,1517,125,132,257,48.6%,4m
2512,3,[농구의신]LMH,3510,974,34,45,79,43.0%,8m
2512,3,[我想玩蟲族]太陽神拉,3510,137,4,1,5,80.0%,4m
2512,1,츄칠라,3510,143,4,6,10,40.0%,40m
2512,1,IIIIIIIIIlII,3510,0,0,1,1,0.0%,6m
2517,3,[CranKy]Aires,3509,196,6,13,19,31.6%,19m
2518,3,[Lotuz]vividrabbit,3508,511,19,19,38,50.0%,20m
2518,2,LIFESHOCK,3508,30,4,9,13,30.8%,7m
2520,3,[CNRush]shogi,3507,602,34,38,72,47.2%,5m
2520,1,꿀광토스,3507,612,19,12,31,61.3%,8m
2520,1,[샌또속]폰팔이,3507,373,13,7,20,65.0%,7m
2520,2,IIIIII,3507,143,4,0,4,100.0%,41m
2520,1,재백이,3507,0,1,1,2,50.0%,4m
2525,3,[무한오영종]MASTER,3506,1561,499,486,985,50.7%,18m
2525,3,탱크,3506,1543,129,127,256,50.4%,8m
2525,3,IIIIIIIIIIII,3506,106,2,3,5,40.0%,8m
2525,3,GLHFGG,3506,0,1,1,2,50.0%,20m
2529,3,III,3505,397,14,12,26,53.8%,5m
2529,1,Mistpostman,3505,42,2,0,2,100.0%,20m
2529,2,Mvp,3505,0,1,1,2,50.0%,43m
2532,3,CaNut,3504,717,32,22,54,59.3%,20m
2533,3,ZergMolestor,3503,314,11,15,26,42.3%,21m
2533,3,Easy,3503,97,6,0,6,100.0%,43m
2533,1,Jaga,3503,44,2,0,2,100.0%,7m
2536,3,Neeb,3502,565,22,17,39,56.4%,5m
2536,3,[SofT]씹덕담당일진,3502,291,11,6,17,64.7%,6m
2538,3,[Notice]즐기자,3501,1529,129,126,255,50.6%,5m
2538,3,[WDY]이지탁,3501,509,25,22,47,53.2%,17m
2538,1,[TalenT]掃地僧,3501,86,2,3,5,40.0%,4m
2538,3,[ELS]엘리자베스,3501,0,0,1,1,0.0%,8m
2542,1,llllllllllll,3500,790,24,18,42,57.1%,16m
2542,3,이순신전략,3500,152,5,7,12,41.7%,18m
2542,1,time,3500,0,0,1,1,0.0%,4m
2542,3,[익산]안뇽하새용,3500,0,0,2,2,0.0%,19m
2546,3,llllllllllll,3499,845,52,46,98,53.1%,7m
2546,3,ButterCup,3499,587,27,18,45,60.0%,8m
2546,1,WillyTheKid,3499,82,4,0,4,100.0%,15m
2546,1,DrunkZealot,3499,0,4,1,5,80.0%,4m
2546,3,[광막훈련소]Gaz,3499,90,3,5,8,37.5%,21m
2546,1,김창인,3499,0,0,1,1,0.0%,8m
2546,1,얼마이티,3499,0,0,1,1,0.0%,17m
2553,3,llllllllllll,3498,1459,69,73,142,48.6%,4m
2553,3,[수사]MarusParty,3498,417,17,13,30,56.7%,17m
2553,1,llIIlllIIlll,3498,494,14,10,24,58.3%,8m
2556,2,Vanvan,3497,0,2,3,5,40.0%,43m
2556,1,혜리,3497,0,0,2,2,0.0%,7m
2558,3,逆命,3496,1579,1884,1870,3754,50.2%,22m
2558,3,llllllllllll,3496,117,5,4,9,55.6%,20m
2558,2,[Blacer]내앞니에응아,3496,0,1,0,1,100.0%,19m
2558,3,[x64]powerwh,3496,0,0,3,3,0.0%,20m
2562,3,XenicsStorm,3495,496,33,16,49,67.3%,6m
2562,1,탈흐콧흐,3495,128,6,1,7,85.7%,15m
2562,3,lWorstGodl,3495,30,2,2,4,50.0%,17m
2562,3,[Rush]Kirito,3495,0,0,1,1,0.0%,43m
2566,3,똘추,3494,1390,69,65,134,51.5%,7m
2567,3,Instincts,3493,1459,208,206,414,50.2%,8m
2567,3,烏歸歸歸頭,3493,30,2,4,6,33.3%,5m
2567,1,[근위대]김태연,3493,0,1,0,1,100.0%,4m
2567,3,ace,3493,0,1,5,6,16.7%,17m
2571,3,아이유남친,3492,1013,114,97,211,54.0%,5m
2572,3,[쇼타임]Jun,3491,290,9,22,31,29.0%,5m
2572,2,llllllllllll,3491,205,6,14,20,30.0%,18m
2572,3,JYDREAM,3491,0,5,0,5,100.0%,43m
2572,3,IntoTheRain,3491,63,4,11,15,26.7%,19m
2572,1,암흑게이기사,3491,0,0,1,1,0.0%,6m
2577,3,[AMA]aTtTa,3489,877,59,49,108,54.6%,8m
2577,3,MathllSonTll,3489,207,37,31,68,54.4%,19m
2577,1,[ELS]스타끄고공부해라,3489,344,10,6,16,62.5%,17m
2580,1,IIIllllllIIl,3488,701,27,23,50,54.0%,17m
2580,3,earth,3488,564,26,25,51,51.0%,17m
2580,1,GLHF,3488,140,7,1,8,87.5%,4m
2583,3,iLeo,3487,1460,260,270,530,49.1%,20m
2583,3,lllllIlll,3487,115,3,2,5,60.0%,5m
2583,1,Mars,3487,124,3,4,7,42.9%,4m
2583,1,Carmino,3487,0,1,0,1,100.0%,5m
2583,1,Water,3487,42,1,2,3,33.3%,7m
2588,1,[xTMDx]wwwzzza,3486,400,11,9,20,55.0%,5m
2588,3,빨리하고끝내자,3486,303,9,13,22,40.9%,5m
2590,3,구울즈,3485,453,21,21,42,50.0%,19m
2590,1,폭풍저그,3485,0,0,1,1,0.0%,6m
2592,3,你媽死了,3484,226,8,3,11,72.7%,6m
2592,1,솔지늬,3484,0,1,0,1,100.0%,7m
2592,1,[αX]Xenodore,3484,0,1,0,1,100.0%,6m
2592,3,Akaza,3484,97,1,1,2,50.0%,6m
2596,1,sctrash,3483,627,28,3,31,90.3%,4m
2596,1,[SKRFAN]阴间神族必胜,3483,289,7,4,11,63.6%,7m
2598,2,쥬디,3482,1566,359,384,743,48.3%,15m
2598,3,IIIIIIIIIII,3482,1475,89,80,169,52.7%,5m
2598,3,NukeWinter,3482,1349,53,48,101,52.5%,8m
2598,3,llllllllllll,3482,435,28,31,59,47.5%,22m
2598,1,SherifofAiur,3482,624,20,19,39,51.3%,20m
2598,3,[5torM]갈아만든배,3482,142,8,8,16,50.0%,20m
2604,1,후라이드,3481,660,19,18,37,51.4%,17m
2604,3,abcdefghijk,3481,139,4,5,9,44.4%,4m
2604,3,ericmarine,3481,0,0,3,3,0.0%,19m
2607,2,[迷宮]EsCaPewAy,3480,95,5,3,8,62.5%,42m
2608,1,재니,3479,1761,212,193,405,52.3%,8m
2608,1,고위기사,3479,314,11,6,17,64.7%,17m
2608,2,[무한오엉종]IIIIIII,3479,0,5,1,6,83.3%,41m
2608,1,llllllllllll,3479,0,2,3,5,40.0%,17m
2608,1,[스카이파이터]콩성전차,3479,0,1,0,1,100.0%,7m
2613,3,[돌변쩔좀]오빠거긴앙앙,3478,1505,646,593,1239,52.1%,19m
2613,3,Jeth,3478,1392,94,76,170,55.3%,20m
2613,3,된장쥬스,3478,1309,67,69,136,49.3%,19m
2613,1,apple,3478,307,8,2,10,80.0%,5m
2613,1,초아,3478,178,5,2,7,71.4%,8m
2613,3,우왕좌왕,3478,40,1,11,12,8.3%,20m
2613,1,[샬롯]김훈승,3478,0,0,1,1,0.0%,16m
2620,1,[最帥小烈]keving,3477,279,9,5,14,64.3%,8m
2620,1,[건마]멕건마,3477,254,6,6,12,50.0%,7m
2620,1,대갈마왕,3477,164,4,4,8,50.0%,8m
2620,1,조선의좌익수준우,3477,0,1,0,1,100.0%,4m
2624,3,[Mecca]포로로카성인,3476,1568,110,114,224,49.1%,5m
2624,3,준선장,3476,616,31,17,48,64.6%,5m
2624,2,furcat,3476,390,13,27,40,32.5%,5m
2624,2,ScheduleK,3476,97,6,1,7,85.7%,42m
2628,1,Realty,3475,412,32,15,47,68.1%,8m
2628,3,[Enter]Dalgujie,3475,30,1,5,6,16.7%,21m
2628,1,[한타왕]Adol,3475,0,0,1,1,0.0%,7m
2631,3,wechan,3474,719,236,222,458,51.5%,17m
2631,1,Ricky,3474,1750,66,58,124,53.2%,6m
2631,1,[IWYDI]ForeverLove,3474,40,1,3,4,25.0%,4m
2634,3,티벳,3472,348,39,36,75,52.0%,21m
2634,3,재짱,3472,338,13,17,30,43.3%,17m
2634,1,alpaca,3472,0,4,0,4,100.0%,17m
2634,1,[NTUeS]MonkeyKing,3472,38,2,0,2,100.0%,7m
2634,1,[DivinE]AstiEL,3472,0,1,0,1,100.0%,8m
2634,1,我才不是小辣鸡,3472,44,1,3,4,25.0%,15m
2640,3,ConvexLens,3471,1250,133,130,263,50.6%,8m
2640,3,IIIIIIIIIIII,3471,670,31,30,61,50.8%,5m
2640,3,[Ato]너무떨려,3471,516,19,25,44,43.2%,21m
2643,1,[HuIIII]EleMaNtAl,3470,0,1,1,2,50.0%,17m
2644,3,SayfT,3469,162,25,16,41,61.0%,20m
2644,1,Kissmyass,3469,86,2,3,5,40.0%,8m
2646,3,이런미친,3468,1493,97,88,185,52.4%,19m
2646,3,[SC2HK]ComBilLi,3468,1496,94,106,200,47.0%,19m
2646,3,OniTe,3468,686,58,42,100,58.0%,5m
2646,3,AniaMania,3468,207,6,5,11,54.5%,19m
2650,3,[NEX]PunchLine,3467,327,19,23,42,45.2%,4m
2650,3,[무한오영종]Marine,3467,30,1,13,14,7.1%,7m
2652,3,ekdma,3466,1567,512,504,1016,50.4%,17m
2652,2,ChameesulO,3466,1516,361,364,725,49.8%,4m
2652,1,SuperKIDz,3466,241,7,6,13,53.8%,17m
2652,1,[DVS]拿不到首勝的雷恩,3466,196,6,2,8,75.0%,8m
2656,1,용팔,3465,250,6,7,13,46.2%,5m
2656,3,LordFeckalos,3465,0,5,0,5,100.0%,43m
2656,2,starone,3465,0,1,0,1,100.0%,43m
2656,1,[MVP1]BabyProbe,3465,0,1,0,1,100.0%,17m
2660,1,calmness,3464,756,35,31,66,53.0%,17m
2660,3,파워,3464,577,21,20,41,51.2%,4m
2660,1,셀렌디스,3464,86,3,1,4,75.0%,4m
2660,3,Rose,3464,134,3,4,7,42.9%,8m
2664,3,TonFroid,3463,352,14,18,32,43.8%,8m
2665,3,[서초중]우주최강에쓰쒸비,3462,1522,66,68,134,49.3%,8m
2665,1,泰瑞,3462,621,36,25,61,59.0%,6m
2665,1,WhiteFeather,3462,0,5,0,5,100.0%,4m
2665,3,Sri,3462,118,5,16,21,23.8%,19m
2665,1,GPGSM,3462,88,3,3,6,50.0%,5m
2670,3,Fappytoad,3461,91,6,1,7,85.7%,7m
2671,3,rkAa,3460,1407,174,165,339,51.3%,5m
2671,1,llllllllllll,3460,780,28,13,41,68.3%,4m
2671,3,으응잉,3460,192,6,5,11,54.5%,21m
2671,1,Markeep,3460,125,5,1,6,83.3%,17m
2671,2,KevinRush,3460,145,5,5,10,50.0%,18m
2671,1,엔젤리,3460,0,1,0,1,100.0%,8m
2677,1,IIIIIIIIIIII,3459,424,16,4,20,80.0%,4m
2677,3,Joker,3459,6,3,6,9,33.3%,6m
2677,1,무경이이긴데이,3459,0,1,0,1,100.0%,5m
2677,1,핵이당,3459,0,1,0,1,100.0%,17m
2681,1,뭬이플수토뤼,3457,1200,47,32,79,59.5%,5m
2681,1,[Equal]경상도군인,3457,800,24,20,44,54.5%,7m
2681,1,[Equal]CoMMuNaL,3457,172,5,4,9,55.6%,7m
2681,3,IlIlIlIlIlI,3457,168,4,3,7,57.1%,7m
2681,1,硬顶憨批摇,3457,76,3,2,5,60.0%,6m
2681,3,Dove,3457,86,3,8,11,27.3%,4m
2681,1,謊言世界,3457,42,2,2,4,50.0%,4m
2688,1,한자임요,3456,1628,248,221,469,52.9%,4m
2688,1,[abc901]Raintsai,3456,218,9,4,13,69.2%,4m
2688,1,GeniusDanGuN,3456,44,1,3,4,25.0%,16m
2691,3,Placebo,3455,513,64,53,117,54.7%,21m
2691,1,llllllllllll,3455,422,12,7,19,63.2%,4m
2691,1,[광속천문]고성능싸이코패스,3455,44,2,0,2,100.0%,15m
2694,3,magician,3454,58,3,4,7,42.9%,21m
2694,1,[NDW]鐵工,3454,42,2,0,2,100.0%,4m
2694,3,에이스,3454,0,1,1,2,50.0%,11m
2697,3,laijingyoyo,3453,1140,131,127,258,50.8%,8m
2697,1,Gamer,3453,1108,94,80,174,54.0%,8m
2697,3,[LQV]전술핵미사일,3453,30,1,7,8,12.5%,20m
2700,3,Tritium,3452,1484,332,323,655,50.7%,15m
2700,1,뽑국이,3452,0,3,2,5,60.0%,15m
2702,3,Mormegil,3451,284,8,11,19,42.1%,15m
2702,1,함박웃음,3451,213,6,3,9,66.7%,40m
2702,3,PULR,3451,130,5,13,18,27.8%,19m
2702,1,TaeJa,3451,124,3,5,8,37.5%,8m
2702,1,[문재앙씨발놈]신안노예출신,3451,0,0,2,2,0.0%,8m
2707,1,Pride,3450,199,9,4,13,69.2%,15m
2707,3,STYLISH,3450,97,2,0,2,100.0%,11m
2709,3,마지막희망,3449,60,3,8,11,27.3%,21m
2710,1,[地獄拉麵]多線獸,3448,484,14,9,23,60.9%,16m
2710,1,[PGAC]Rain,3448,198,6,4,10,60.0%,8m
2710,3,[INGay]모스크바사랑꾼,3448,95,2,2,4,50.0%,5m
2710,1,samokgogo,3448,42,1,2,3,33.3%,8m
2710,3,OuO,3448,30,1,6,7,14.3%,8m
2715,1,mirage,3447,1504,155,136,291,53.3%,16m
2715,1,[NGameS]soO,3447,429,13,5,18,72.2%,6m
2715,1,SoS,3447,0,0,1,1,0.0%,6m
2718,3,수족관,3446,1470,581,579,1160,50.1%,16m
2718,1,풍류,3446,392,13,4,17,76.5%,4m
2718,1,[Aster]Cheerful,3446,40,2,1,3,66.7%,7m
2718,2,Rime,3446,0,0,4,4,0.0%,6m
2722,1,llllllllllll,3445,0,1,0,1,100.0%,7m
2723,3,兔仔耳朵蒙面俠,3444,1504,264,261,525,50.3%,6m
2723,1,사도의유산,3444,86,2,4,6,33.3%,16m
2723,1,밤까마귀,3444,0,0,1,1,0.0%,6m
2726,1,[Kyou9]AnotherBirth,3443,1367,49,46,95,51.6%,17m
2726,3,문재인통치하의삶,3443,121,2,3,5,40.0%,5m
2728,3,Computer,3442,706,34,35,69,49.3%,16m
2728,1,[BTU]Qarn,3442,923,31,26,57,54.4%,20m
2728,1,llllllllllll,3442,0,1,0,1,100.0%,17m
2731,3,코이,3441,214,10,6,16,62.5%,21m
2732,3,BlackJoker,3440,408,21,13,34,61.8%,18m
2732,1,지폭장승,3440,688,21,24,45,46.7%,7m
2732,1,[썩션판타지]너는승급할수없다,3440,172,4,6,10,40.0%,6m
2735,1,ANNU,3439,86,2,1,3,66.7%,6m
2736,1,superhcw,3438,128,3,4,7,42.9%,4m
2736,1,대략신입,3438,0,0,1,1,0.0%,8m
2738,3,桃園最後希望,3436,1139,213,188,401,53.1%,5m
2738,1,폭풍저그,3436,812,87,77,164,53.0%,7m
2738,1,lIIIlllIllIl,3436,438,13,14,27,48.1%,7m
2738,1,꿀떡,3436,240,7,6,13,53.8%,20m
2738,3,asdads,3436,178,7,13,20,35.0%,8m
2743,1,Chrono,3435,274,11,11,22,50.0%,17m
2743,3,너를꿈꾸며,3435,121,6,1,7,85.7%,11m
2743,1,PRADA,3435,0,0,1,1,0.0%,17m
2746,1,아이유,3434,0,0,3,3,0.0%,8m
2746,3,MoonQ,3434,0,0,6,6,0.0%,23m
2748,1,Yoshi,3433,1123,57,45,102,55.9%,7m
2748,1,泽拉图,3433,138,4,1,5,80.0%,7m
2750,3,황윤하,3432,238,8,7,15,53.3%,22m
2750,1,[MJ麻吉]LEO,3432,250,6,3,9,66.7%,16m
2752,1,[NGNLZ]小周,3431,0,0,4,4,0.0%,4m
2753,1,[Arrest]MEless,3430,507,16,10,26,61.5%,6m
2753,1,Ahriman,3430,156,4,2,6,66.7%,16m
2755,1,[DICET]IIIlIIIlIII,3429,858,31,20,51,60.8%,17m
2755,1,스투똥망겜,3429,122,4,3,7,57.1%,8m
2755,1,Composer,3429,168,3,3,6,50.0%,15m
2755,3,고수,3429,64,2,13,15,13.3%,19m
2755,1,[유돈해브마미]beeshop,3429,0,1,1,2,50.0%,4m
2755,3,Elza,3429,0,0,5,5,0.0%,6m
2761,3,엠엠크루,3428,1441,90,95,185,48.6%,16m
2761,1,리츠,3428,1271,47,34,81,58.0%,8m
2761,3,[거그정]내이름은이훔바,3428,983,46,36,82,56.1%,19m
2761,1,직진남,3428,0,3,2,5,60.0%,15m
2761,1,하지만드라군이출,3428,0,0,2,2,0.0%,8m
2761,1,뭐하니뭐해,3428,0,0,2,2,0.0%,6m
2767,1,llllllllllll,3427,294,10,3,13,76.9%,16m
2767,1,OwNaGe,3427,0,4,0,4,100.0%,10m
2767,1,NZXT,3427,82,3,3,6,50.0%,20m
2767,1,좋아해요,3427,42,1,1,2,50.0%,8m
2767,1,[ProTT]khalsolame,3427,0,0,1,1,0.0%,17m
2772,1,glassbead,3426,847,32,19,51,62.7%,17m
2772,3,반집승,3426,556,30,24,54,55.6%,5m
2772,1,[싸갈쓰들]똥마려운변비,3426,380,12,8,20,60.0%,7m
2772,1,XuNka,3426,160,4,3,7,57.1%,8m
2772,3,[CLZ]yozora,3426,119,2,5,7,28.6%,7m
2772,1,WarGreymon,3426,0,0,2,2,0.0%,15m
2778,3,SOlar,3425,1022,38,41,79,48.1%,5m
2778,1,FrozenMarine,3425,223,9,10,19,47.4%,7m
2778,1,FanTa,3425,0,0,1,1,0.0%,6m
2781,1,프로토스만,3424,809,67,60,127,52.8%,8m
2781,1,울프,3424,126,4,2,6,66.7%,4m
2781,1,론커스텀,3424,0,0,1,1,0.0%,15m
2784,1,Rupee,3423,40,2,1,3,66.7%,6m
2784,1,즐뽕까셈,3423,90,2,6,8,25.0%,16m
2786,3,[Play1]進擊的美特,3422,397,101,100,201,50.2%,17m
2786,3,Libero,3422,1414,54,59,113,47.8%,5m
2786,3,KingDavid,3422,648,31,30,61,50.8%,6m
2786,3,llllllllllll,3422,568,21,23,44,47.7%,19m
2790,3,살살,3421,288,12,6,18,66.7%,7m
2790,1,PostGrad,3421,198,6,5,11,54.5%,7m
2790,1,Elfleischo,3421,0,5,0,5,100.0%,9m
2790,1,[ImMoe]Choice,3421,126,4,4,8,50.0%,4m
2794,1,냐음,3420,596,31,12,43,72.1%,5m
2794,1,막장으로나아가라,3420,84,3,6,9,33.3%,6m
2796,3,[너의ol름은]Expert,3419,1524,318,276,594,53.5%,19m
2796,3,박태화,3419,468,58,45,103,56.3%,7m
2796,1,success,3419,979,44,38,82,53.7%,8m
2796,1,저그야캐양,3419,325,11,3,14,78.6%,6m
2796,3,Devilelf,3419,290,11,16,27,40.7%,6m
2801,1,degaone,3418,401,16,10,26,61.5%,15m
2801,1,Garry,3418,475,15,11,26,57.7%,5m
2801,1,소팔다개된년,3418,0,1,3,4,25.0%,8m
2801,1,lIIIIlllllII,3418,0,0,1,1,0.0%,9m
2805,1,llllllllllll,3417,1478,66,57,123,53.7%,7m
2805,1,[역시나]그랑죠,3417,889,29,29,58,50.0%,8m
2805,3,끄라스,3417,535,28,39,67,41.8%,21m
2805,1,llllllllllll,3417,0,0,2,2,0.0%,8m
2809,1,白门楼,3416,46,3,4,7,42.9%,7m
2810,3,Marco,3415,1442,404,388,792,51.0%,19m
2810,2,얀아낭,3415,235,8,10,18,44.4%,7m
2810,1,[尊者]Eikasang,3415,40,2,0,2,100.0%,8m
2810,1,RaRaYA,3415,42,1,1,2,50.0%,4m
2810,1,잘해요,3415,0,0,1,1,0.0%,17m
2815,1,Mike,3413,588,24,13,37,64.9%,17m
2815,1,고래성,3413,446,22,8,30,73.3%,16m
2815,1,중요한순간,3413,349,16,5,21,76.2%,8m
2815,1,[SPTS]CHEERHERO,3413,0,1,2,3,33.3%,8m
2819,1,白雪紛紛何所似,3412,1535,162,148,310,52.3%,17m
2819,3,Tta,3412,1167,58,47,105,55.2%,15m
2819,1,내가뭘하든알바,3412,170,7,9,16,43.8%,5m
2822,1,IIIIIIIIIIII,3411,246,7,12,19,36.8%,17m
2822,1,프루나,3411,0,0,1,1,0.0%,16m
2824,3,IntoThetoro,3410,966,35,42,77,45.5%,6m
2824,3,AnDy,3410,171,9,13,22,40.9%,18m
2824,2,김치만두,3410,182,7,3,10,70.0%,43m
2824,1,월하군,3410,0,1,1,2,50.0%,5m
2824,1,Money,3410,0,1,3,4,25.0%,8m
2829,3,[DagmBa]Core,3409,1520,424,417,841,50.4%,21m
2829,3,lIlIlIllIlll,3409,1464,268,258,526,51.0%,23m
2829,1,IIIIIIIIIIII,3409,40,2,0,2,100.0%,6m
2832,3,akirastar,3408,1490,232,226,458,50.7%,21m
2832,1,MAX,3408,1457,61,50,111,55.0%,7m
2832,1,[조누]조선누룽지,3408,190,5,7,12,41.7%,7m
2832,3,Obersoldaten,3408,30,1,11,12,8.3%,16m
2836,3,IIIIIIIIIIII,3407,172,11,8,19,57.9%,7m
2836,1,아르미,3407,164,5,6,11,45.5%,7m
2836,1,fnfx,3407,42,2,3,5,40.0%,16m
2839,1,[Yisc]다현이,3406,1509,105,79,184,57.1%,4m
2839,3,[CIA암살단]Blizzabd,3406,1022,45,43,88,51.1%,19m
2839,3,SkyCube,3406,476,23,22,45,51.1%,18m
2842,3,암흑기사단,3405,90,4,9,13,30.8%,21m
2842,3,ExtrA,3405,0,3,4,7,42.9%,19m
2842,1,[CHORD]ZZX,3405,0,1,0,1,100.0%,16m
2842,1,몽키,3405,0,0,2,2,0.0%,5m
2846,3,다모임환장,3404,1445,72,65,137,52.6%,20m
2846,2,싸광남,3404,140,5,5,10,50.0%,42m
2848,1,아기공룡둘째,3403,289,10,5,15,66.7%,8m
2848,1,[咕咕咕的]RRCOrz,3403,131,2,4,6,33.3%,17m
2848,3,심신,3403,0,1,0,1,100.0%,11m
2851,3,nCsCokepig,3402,1513,149,133,282,52.8%,19m
2851,3,UsadaPekora,3402,1021,49,54,103,47.6%,5m
2851,1,신선왕,3402,0,1,1,2,50.0%,7m
2854,3,[Lotuz]LarS,3401,1483,112,97,209,53.6%,19m
2854,1,jieun,3401,595,17,20,37,45.9%,4m
2854,1,IIIIII,3401,444,16,12,28,57.1%,8m
2854,1,llllllllllll,3401,242,6,8,14,42.9%,8m
2858,1,IIIIIIIIIIII,3400,102,6,1,7,85.7%,20m
2858,1,[讓我玩神族]米酒,3400,0,0,1,1,0.0%,7m
2860,3,[ANGG]승진,3399,1278,76,80,156,48.7%,7m
2860,1,Hani,3399,86,2,5,7,28.6%,8m
2860,1,Darksweem,3399,38,1,1,2,50.0%,6m
2863,1,JuunJ,3398,513,104,91,195,53.3%,4m
2863,1,Markingstong,3398,334,24,22,46,52.2%,16m
2863,1,Ares,3398,300,12,6,18,66.7%,20m
2863,1,엔에스피품바,3398,0,4,0,4,100.0%,10m
2863,1,OGNSTar,3398,0,1,0,1,100.0%,6m
2868,3,llllllllllll,3397,720,26,34,60,43.3%,19m
2868,1,IIIIIIIIIIII,3397,259,8,6,14,57.1%,6m
2868,1,[Kaltra]hotkii,3397,163,5,1,6,83.3%,4m
2871,1,spTG,3396,1190,72,54,126,57.1%,7m
2871,1,임미례,3396,1478,49,50,99,49.5%,7m
2871,1,[히어로]태자,3396,120,4,2,6,66.7%,7m
2871,1,아옹,3396,129,3,0,3,100.0%,8m
2871,1,mvphj,3396,76,2,3,5,40.0%,16m
2871,1,추격자,3396,0,0,4,4,0.0%,5m
2877,1,peachfuzz,3395,1394,153,111,264,58.0%,16m
2877,1,Kangshin,3395,1551,107,93,200,53.5%,15m
2877,3,IIIIIIIIIIII,3395,424,37,35,72,51.4%,5m
2877,1,大唐,3395,407,29,17,46,63.0%,6m
2877,1,돼부장,3395,0,1,0,1,100.0%,5m
2877,1,[NLTN]짐네이년,3395,0,1,0,1,100.0%,16m
2883,1,불곰이싫어요,3394,119,1,7,8,12.5%,17m
2883,1,하루카,3394,0,0,5,5,0.0%,15m
2885,1,옆자리사령관,3393,1564,169,151,320,52.8%,15m
2885,3,[Equal]Odin,3393,840,31,35,66,47.0%,18m
2885,1,[Ex]Near,3393,561,22,11,33,66.7%,7m
2885,1,안보이는미래,3393,0,4,1,5,80.0%,20m
2885,1,Jehoel,3393,0,1,5,6,16.7%,5m
2890,1,UTAKATA,3392,797,34,25,59,57.6%,7m
2890,1,IIIIIIIIIII,3392,535,20,12,32,62.5%,17m
2890,1,Protoss,3392,424,14,8,22,63.6%,7m
2890,3,우유사세요,3392,118,5,7,12,41.7%,8m
2890,2,만돌잉,3392,88,1,2,3,33.3%,16m
2895,1,llllllllllll,3391,1466,59,48,107,55.1%,15m
2895,2,[M三I人]밀어댕기라,3391,96,3,6,9,33.3%,41m
2897,1,[YONSEI]하등한문과,3390,118,3,4,7,42.9%,7m
2897,1,[5torM]멀티플레이어,3390,103,3,5,8,37.5%,15m
2899,3,tungtung,3389,1440,388,393,781,49.7%,16m
2899,3,invisiblesim,3389,1470,192,197,389,49.4%,21m
2899,3,백승호,3389,486,17,25,42,40.5%,22m
2899,1,호접몽,3389,185,14,14,28,50.0%,6m
2899,1,ShoeLugs,3389,144,3,4,7,42.9%,41m
2899,1,psychopomp,3389,42,2,0,2,100.0%,17m
2905,3,사우스파크,3388,782,31,33,64,48.4%,9m
2905,1,갓윽오,3388,46,2,5,7,28.6%,5m
2907,3,김또이,3387,938,33,39,72,45.8%,8m
2907,1,WOONGJINvGP,3387,207,7,3,10,70.0%,41m
2907,3,drakebird,3387,121,6,2,8,75.0%,11m
2907,3,[구체적날빌]둥둥,3387,115,5,0,5,100.0%,11m
2907,1,게이,3387,0,3,2,5,60.0%,10m
2907,1,sosa,3387,0,1,2,3,33.3%,5m
2907,1,MMM,3387,0,0,2,2,0.0%,7m
2914,2,Poon,3386,139,4,4,8,50.0%,42m
2914,1,Zantrid,3386,80,2,3,5,40.0%,8m
2914,1,[컴공스투충]하잉국,3386,0,1,2,3,33.3%,5m
2917,3,Naruto,3385,1485,94,105,199,47.2%,19m
2917,1,[셱스하자]또띠,3385,1610,59,53,112,52.7%,5m
2917,3,HacKBomB,3385,1046,42,39,81,51.9%,5m
2917,1,dkdhdfas,3385,384,11,9,20,55.0%,4m
2917,2,저그왕,3385,167,6,6,12,50.0%,42m
2917,3,REATER,3385,117,3,1,4,75.0%,43m
2923,3,덜덜,3384,1472,126,103,229,55.0%,22m
2923,1,[SCmTS]Shiny,3384,637,21,21,42,50.0%,7m
2923,1,다마츼,3384,374,10,13,23,43.5%,5m
2923,1,[사람입니다]진격의양말,3384,0,0,1,1,0.0%,4m
2927,3,[어윤수님개쩜]여의나루초밥,3383,1214,299,306,605,49.4%,23m
2927,1,Timeout,3383,503,19,22,41,46.3%,7m
2927,1,soft,3383,249,10,4,14,71.4%,15m
2927,1,二小,3383,0,1,1,2,50.0%,15m
2931,1,실키얌,3382,165,6,4,10,60.0%,4m
2931,1,[KKR]옹통,3382,42,2,7,9,22.2%,5m
2933,1,레드스톰라이징,3381,626,28,17,45,62.2%,15m
2933,1,llllllllllll,3381,172,4,6,10,40.0%,8m
2933,1,따라따라따라땋,3381,0,1,3,4,25.0%,8m
2936,1,Terran,3380,1720,242,209,451,53.7%,17m
2936,1,[TwoS]TwoSMITW,3380,733,65,62,127,51.2%,8m
2936,1,[GIS]ReCall,3380,0,0,3,3,0.0%,5m
2939,1,Synthese,3379,490,49,36,85,57.6%,4m
2939,3,[TMR]yehyi,3379,544,19,25,44,43.2%,22m
2939,1,곰돌이하니허니,3379,516,14,12,26,53.8%,7m
2939,1,SCPLAYER,3379,139,3,2,5,60.0%,5m
2943,3,IIIIIIIIIIII,3378,499,29,28,57,50.9%,19m
2943,1,[겜동]hddgogogo,3378,534,25,13,38,65.8%,4m
2943,3,legion,3378,142,3,4,7,42.9%,7m
2943,1,혀누,3378,106,2,1,3,66.7%,17m
2947,1,[옵져버]JeannedArc,3377,646,20,18,38,52.6%,7m
2947,1,slskslskslsk,3377,331,14,4,18,77.8%,8m
2947,1,[트롤처리반장]중재중재,3377,38,6,2,8,75.0%,15m
2947,1,CrazySamurai,3377,0,0,1,1,0.0%,8m
2951,1,COVIDforever,3376,0,1,0,1,100.0%,8m
2951,1,오빠차화염차,3376,44,1,5,6,16.7%,7m
2953,3,mjony,3375,967,65,52,117,55.6%,19m
2953,1,김쟝김치,3375,1388,59,58,117,50.4%,8m
2953,1,SoSimple,3375,1012,49,32,81,60.5%,8m
2953,1,[439]lllllllllysk,3375,341,24,12,36,66.7%,6m
2953,3,3375,255,13,8,21,61.9%,20m
2953,1,데이비드장닭,3375,261,9,10,19,47.4%,17m
2959,3,사랑하는엄마,3374,207,9,5,14,64.3%,7m
2959,1,[MARVEL]VINAI,3374,0,1,0,1,100.0%,17m
2959,1,미나리사랑해,3374,0,1,0,1,100.0%,8m
2959,3,Zhoska,3374,97,1,1,2,50.0%,43m
2959,2,궤적,3374,0,0,2,2,0.0%,42m
2964,1,Giga,3373,555,27,14,41,65.9%,4m
2964,1,[건국]도드폭팔,3373,280,7,11,18,38.9%,7m
2964,1,[시럽]아리아나동그란데,3373,236,6,10,16,37.5%,40m
2967,1,그마가고싶어요,3372,1690,138,113,251,55.0%,17m
2967,3,[IWYDI]CWCWYD,3372,1377,52,59,111,46.8%,17m
2967,1,[붉은노을]BlUeTeE,3372,246,12,4,16,75.0%,5m
2967,1,[銅牌上不去]llBULY,3372,328,9,7,16,56.2%,7m
2967,1,[러블리걸]까칠한쩡이,3372,42,3,6,9,33.3%,5m
2967,1,[방구함]쓸데없이잘함,3372,42,2,4,6,33.3%,17m
2973,1,[매너플레이어]FINALY,3371,1065,62,47,109,56.9%,8m
2973,1,Gravitation,3371,114,7,2,9,77.8%,20m
2973,1,배추도사,3371,116,4,3,7,57.1%,8m
2976,3,Pandemonium,3370,478,16,31,47,34.0%,15m
2976,1,SouL,3370,436,12,14,26,46.2%,6m
2976,1,[MPJY]Rockpudding,3370,0,0,1,1,0.0%,6m
2976,3,[Mruly]조용카이,3370,0,0,2,2,0.0%,11m
2980,1,[IWYDI]chunyu,3369,42,1,3,4,25.0%,4m
2980,1,風林火山,3369,0,0,1,1,0.0%,15m
2982,1,CLYDA,3368,40,1,3,4,25.0%,7m
2983,1,나한테지면반성해,3367,36,4,3,7,57.1%,20m
2983,1,마티,3367,82,3,2,5,60.0%,8m
2983,1,[BJTU北交]tycoon,3367,0,1,0,1,100.0%,7m
2986,1,[StorM2]AndyYang,3366,959,59,58,117,50.4%,16m
2986,1,[건호짱]꿀벌,3366,400,15,10,25,60.0%,7m
2986,1,불랑서,3366,90,3,3,6,50.0%,6m
2986,1,skdnjsxo,3366,42,2,1,3,66.7%,20m
2986,1,[무리무리팸]메롱,3366,0,2,3,5,40.0%,7m
2991,3,유기농초코우유,3365,1210,45,54,99,45.5%,7m
2991,1,POTKH,3365,412,14,10,24,58.3%,17m
2991,1,[irnman]오시리스,3365,319,12,9,21,57.1%,8m
2991,1,Pietmuis,3365,234,6,10,16,37.5%,5m
2995,3,더로드,3364,1516,108,94,202,53.5%,5m
2995,1,묘야,3364,808,52,43,95,54.7%,16m
2995,3,나비효과,3364,295,13,9,22,59.1%,22m
2995,1,물찌,3364,280,12,9,21,57.1%,20m
2995,1,kobra,3364,97,5,1,6,83.3%,10m
2995,3,GGGGG,3364,0,1,0,1,100.0%,7m
2995,1,아싸,3364,36,1,3,4,25.0%,5m
3002,1,crocodile,3363,1438,69,60,129,53.5%,17m
3002,3,[1E100]Vauxhall,3363,267,18,28,46,39.1%,8m
3002,1,[무한오영종]웅담푸우,3363,355,14,6,20,70.0%,5m
3002,3,daisysult,3363,304,11,20,31,35.5%,5m
3002,1,[ESU]프로토스만할께,3363,146,3,3,6,50.0%,20m
3002,1,火車上有恐龍,3363,74,2,3,5,40.0%,7m
3002,1,llllllllllll,3363,0,0,1,1,0.0%,5m
3009,1,Ctstrphy,3362,1632,578,528,1106,52.3%,20m
3009,1,모르코,3362,736,67,41,108,62.0%,4m
3009,1,[Rush]CannonRush,3362,524,17,15,32,53.1%,16m
3012,1,IlIlIIIlllII,3361,598,21,16,37,56.8%,6m
3012,3,[SpM]CrazyUncle,3361,219,8,1,9,88.9%,5m
3012,1,Viper,3361,0,5,0,5,100.0%,5m
3012,1,[MICH]IIIIIIIIIIII,3361,0,2,4,6,33.3%,5m
3012,1,鐵達尼姑號,3361,0,1,0,1,100.0%,6m
3017,1,[noToss]Warpcraft,3360,438,18,14,32,56.2%,17m
3017,1,十二只探鸡,3360,89,5,1,6,83.3%,5m
3017,1,[참돔]Assaulter,3360,0,0,7,7,0.0%,17m
3020,1,[ELS]피아노치는공대생,3359,351,22,16,38,57.9%,16m
3020,3,lose,3359,121,5,1,6,83.3%,43m
3020,1,레녹스,3359,196,5,4,9,55.6%,5m
3020,1,추적자,3359,108,2,2,4,50.0%,17m
3020,2,진격의뉴비,3359,0,0,1,1,0.0%,17m
3025,1,초글링,3358,0,1,1,2,50.0%,20m
3026,1,Zealot,3357,377,14,8,22,63.6%,7m
3026,2,아미고,3357,142,9,4,13,69.2%,21m
3028,1,[도담이]얼어붙은개,3356,404,12,14,26,46.2%,8m
3028,3,[상한가터치자]하이브리드,3356,0,1,0,1,100.0%,5m
3028,1,Nidhogg,3356,0,0,3,3,0.0%,6m
3031,1,llllllllllll,3355,426,12,14,26,46.2%,4m
3032,1,SpotLight,3354,573,25,23,48,52.1%,17m
3032,3,[16LAB]thehheiv,3354,597,23,29,52,44.2%,19m
3032,2,Circus,3354,178,8,4,12,66.7%,16m
3032,2,[안녕Hi]speedghOst,3354,259,8,5,13,61.5%,7m
3032,1,POScolossus,3354,0,1,1,2,50.0%,16m
3032,2,tvfk,3354,0,0,1,1,0.0%,8m
3038,1,파워상민이,3353,510,14,20,34,41.2%,4m
3038,2,[Worm]용용,3353,0,1,0,1,100.0%,6m
3040,3,기욤한스,3352,1536,182,172,354,51.4%,6m
3040,3,[SGlory]ISoArich,3352,1158,68,77,145,46.9%,17m
3040,1,IIIIIIIIII,3352,114,3,6,9,33.3%,8m
3040,2,IIIIIIIIIIII,3352,0,1,0,1,100.0%,18m
3040,1,Jeawook,3352,0,1,2,3,33.3%,7m
3045,3,[On엔oN]Hisoka,3351,121,6,2,8,75.0%,43m
3045,1,SdragonL,3351,48,4,3,7,57.1%,18m
3045,2,[IWYDI]HermesWYD,3351,58,3,0,3,100.0%,21m
3048,1,구운감자,3350,0,0,2,2,0.0%,17m
3049,3,청새치튀김,3349,332,16,12,28,57.1%,7m
3049,2,One,3349,117,3,8,11,27.3%,42m
3049,1,RevoltTrees,3349,48,1,1,2,50.0%,9m
3049,1,illyasvel,3349,88,1,2,3,33.3%,8m
3053,1,[비트]SadJoker,3348,1039,33,39,72,45.8%,17m
3053,1,진균병신,3348,171,6,6,12,50.0%,7m
3053,1,SONO,3348,0,3,2,5,60.0%,10m
3056,1,[NGameS]NoiD,3347,729,30,33,63,47.6%,7m
3056,2,IIIIIIIIIIII,3347,240,28,13,41,68.3%,16m
3056,2,llllllllllll,3347,465,23,7,30,76.7%,8m
3056,1,[비트]현용이다,3347,434,12,19,31,38.7%,8m
3056,3,Ceraldor,3347,187,8,4,12,66.7%,43m
3061,2,DilysBBG,3345,320,11,10,21,52.4%,17m
3061,1,我們班沒女生,3345,42,1,4,5,20.0%,6m
3063,3,Oracle,3344,324,10,24,34,29.4%,6m
3063,1,kingslove,3344,212,6,5,11,54.5%,5m
3063,2,cdma,3344,96,4,1,5,80.0%,23m
3063,1,광안리스타일,3344,156,4,5,9,44.4%,4m
3063,1,IcEdrAgOn,3344,0,3,2,5,60.0%,9m
3063,2,xZeRaTuLx,3344,64,3,2,5,60.0%,16m
3063,2,Nymphen,3344,0,0,1,1,0.0%,18m
3070,1,자유의날개,3343,475,21,12,33,63.6%,4m
3070,3,삼등못하면만원,3343,121,6,2,8,75.0%,43m
3072,1,그네젖통닌자,3342,1630,93,97,190,48.9%,17m
3072,1,Nevem,3342,877,31,26,57,54.4%,7m
3072,2,휘리아나,3342,816,30,23,53,56.6%,5m
3072,1,제동신,3342,501,17,18,35,48.6%,5m
3072,1,VistA,3342,117,3,2,5,60.0%,4m
3077,1,anrlqrktk,3341,126,3,9,12,25.0%,8m
3077,1,아다폭격기,3341,34,1,3,4,25.0%,17m
3079,3,Mias,3340,1542,91,106,197,46.2%,17m
3079,1,dragonmaster,3340,831,33,31,64,51.6%,8m
3079,1,[내마음을받아]발나우도,3340,78,3,4,7,42.9%,8m
3079,1,HaeGol,3340,0,1,2,3,33.3%,8m
3079,1,AED,3340,88,1,2,3,33.3%,7m
3079,1,BlackStar,3340,0,0,4,4,0.0%,6m
3085,1,Dreamcatcher,3339,74,2,4,6,33.3%,8m
3085,1,vincentboy,3339,40,2,6,8,25.0%,7m
3085,2,[태초마을]나까무라,3339,0,1,0,1,100.0%,16m
3085,2,VXstarfallXV,3339,0,1,1,2,50.0%,15m
3089,1,chelsea,3338,1476,52,50,102,51.0%,5m
3089,1,llllllllllll,3338,0,0,2,2,0.0%,5m
3091,3,dlqqlwwkd,3337,1337,120,119,239,50.2%,16m
3091,3,배고파용흥,3337,1489,113,117,230,49.1%,18m
3091,1,스타드림,3337,905,31,28,59,52.5%,8m
3091,1,동어,3337,874,29,26,55,52.7%,5m
3091,1,ARK,3337,476,14,22,36,38.9%,7m
3091,1,RuinHien,3337,151,10,6,16,62.5%,7m
3091,1,으어어엉,3337,86,3,6,9,33.3%,8m
3098,1,지니,3336,1527,82,59,141,58.2%,7m
3098,1,HEAVEN,3336,802,26,27,53,49.1%,8m
3098,2,전광식,3336,322,12,10,22,54.5%,5m
3098,2,llllllllllll,3336,174,12,11,23,52.2%,3m
3098,2,Exo,3336,266,9,4,13,69.2%,2m
3098,3,Ace,3336,97,2,1,3,66.7%,43m
3098,2,[NLTN]stay,3336,0,1,1,2,50.0%,6m
3105,3,[IHan]피카숭이,3335,1485,239,251,490,48.8%,1m
3105,2,diva,3335,1608,142,118,260,54.6%,16m
3105,1,[CStorM]한국자동화,3335,706,24,23,47,51.1%,8m
3105,2,[VoF]Wyvern,3335,528,23,8,31,74.2%,6m
3105,1,[GK1ng]scpsoul,3335,462,13,17,30,43.3%,18m
3105,1,[KCFL]Lieutenant,3335,310,9,14,23,39.1%,5m
3105,1,Sun,3335,97,5,1,6,83.3%,10m
3105,2,[WDY]스린이테란,3335,30,2,0,2,100.0%,2m
3105,2,비세리온,3335,32,1,1,2,50.0%,6m
3114,1,[1STST]롤신,3334,1354,48,49,97,49.5%,5m
3114,2,AlexiCOB,3334,113,2,3,5,40.0%,42m
3114,1,mustbeirish,3334,0,0,2,2,0.0%,5m
3117,3,MBC,3333,1434,62,69,131,47.3%,2m
3117,2,Classic,3333,128,5,3,8,62.5%,6m
3117,1,Everlasting,3333,232,5,17,22,22.7%,2m
3117,3,[연세대학교]JYP,3333,36,1,4,5,20.0%,43m
3117,3,ApalapA,3333,0,0,1,1,0.0%,5m
3117,2,[두드려]난정말로강력하다,3333,0,0,2,2,0.0%,8m
3123,2,DBD,3332,1266,79,71,150,52.7%,5m
3123,2,IIIIIIIII,3332,422,25,15,40,62.5%,17m
3123,2,여틴구함,3332,364,16,9,25,64.0%,17m
3123,1,rin,3332,312,10,9,19,52.6%,8m
3123,1,[머큐리]Trafford,3332,0,1,1,2,50.0%,10m
3123,1,개촙이에요,3332,0,0,6,6,0.0%,5m
3129,1,[몸종]세르,3331,355,15,7,22,68.2%,17m
3129,3,꽃집아들,3331,140,12,10,22,54.5%,5m
3129,1,[暗夜洌鶇]ICY,3331,332,10,11,21,47.6%,8m
3129,1,비누맛사탕,3331,78,2,6,8,25.0%,5m
3129,2,[두유공신병신]보라,3331,0,0,1,1,0.0%,8m
3134,3,LsIk,3330,772,27,37,64,42.2%,1m
3134,3,꾸레,3330,147,7,3,10,70.0%,11m
3134,1,[영앤리치]Puglin,3330,214,4,14,18,22.2%,8m
3137,1,RapierAE,3329,1376,70,64,134,52.2%,6m
3137,2,프로토스,3329,934,41,31,72,56.9%,2m
3137,1,얅뢇쉛놹뛞왡,3329,0,1,0,1,100.0%,9m
3140,1,냥냥,3328,1118,47,40,87,54.0%,2m
3140,1,DieHarD,3328,332,12,10,22,54.5%,3m
3140,2,Ryeong,3328,32,1,1,2,50.0%,7m
3140,3,pederico,3328,0,0,1,1,0.0%,7m
3140,1,Nikoboko,3328,0,0,3,3,0.0%,40m
3145,1,악마,3327,1702,395,380,775,51.0%,4m
3145,2,SosadQQ,3327,0,2,1,3,66.7%,7m
3145,2,PoorGamer,3327,34,1,1,2,50.0%,2m
3148,1,HiJ,3326,1017,47,41,88,53.4%,8m
3148,2,IIIIIIIIIIII,3326,60,6,2,8,75.0%,3m
3148,1,[Thpj]伪物的妖妖,3326,0,1,1,2,50.0%,41m
3151,3,ewq,3325,1196,46,47,93,49.5%,8m
3151,1,MeatSeller,3325,843,29,29,58,50.0%,3m
3151,2,unicorns,3325,62,2,3,5,40.0%,6m
3151,1,[대나무]대나무빵,3325,0,2,4,6,33.3%,10m
3155,1,[ctrs]Naki,3324,276,8,9,17,47.1%,5m
3155,2,MaydayTW,3324,154,5,6,11,45.5%,6m
3155,2,llllllllllll,3324,34,1,1,2,50.0%,3m
3155,2,Luthior,3324,0,0,1,1,0.0%,1m
3159,1,롤리팝,3323,936,92,76,168,54.8%,6m
3159,1,Rimuru,3323,237,10,6,16,62.5%,3m
3159,1,Cho,3323,213,9,6,15,60.0%,41m
3159,2,[이터널]고구마,3323,186,6,2,8,75.0%,17m
3159,2,Rodo,3323,0,4,1,5,80.0%,3m
3159,2,MAHOROMATIC,3323,0,3,2,5,60.0%,5m
3159,1,저그버프좀,3323,0,0,5,5,0.0%,7m
3166,1,Java,3322,74,2,11,13,15.4%,18m
3166,2,우주최강,3322,0,0,1,1,0.0%,3m
3168,3,llllllllllll,3321,1541,129,122,251,51.4%,2m
3168,1,BlueShrimp,3321,873,30,36,66,45.5%,17m
3168,1,[불스]kingofthesod,3321,212,10,5,15,66.7%,17m
3168,2,鳶一折紙,3321,0,4,1,5,80.0%,2m
3168,1,동크,3321,0,0,3,3,0.0%,7m
3173,3,Plazma,3320,645,35,44,79,44.3%,3m
3173,1,굿바이,3320,464,17,17,34,50.0%,4m
3173,2,Pamanos,3320,90,2,0,2,100.0%,42m
3173,2,[이방CITY]탈북장인하앍태영,3320,0,0,3,3,0.0%,3m
3177,1,mars,3319,1613,299,282,581,51.5%,8m
3177,2,MagicKim,3319,1295,212,184,396,53.5%,2m
3177,1,Skye,3319,513,33,28,61,54.1%,7m
3177,1,wooyoo,3319,775,27,23,50,54.0%,6m
3177,1,[TDT]WingLien,3319,184,6,10,16,37.5%,7m
3177,1,ZErOne,3319,40,1,4,5,20.0%,5m
3177,2,[Angels]엘리시아,3319,0,0,1,1,0.0%,6m
3177,2,[NGameS]땅콩버스,3319,0,0,1,1,0.0%,17m
3177,2,时乃空单推人,3319,0,0,1,1,0.0%,1m
3186,1,SophiA,3318,679,23,29,52,44.2%,6m
3186,1,[GeoJE]roxy,3318,296,10,12,22,45.5%,7m
3186,2,느금마금느,3318,176,7,5,12,58.3%,1m
3186,1,GeeSiX,3318,97,5,0,5,100.0%,11m
3186,2,Aka,3318,148,4,5,9,44.4%,2m
3186,2,메카닉잘하고싶다,3318,0,0,1,1,0.0%,17m
3192,1,청주나타샤,3317,560,21,18,39,53.8%,7m
3192,2,참치배때기,3317,0,1,0,1,100.0%,1m
3192,1,박사장,3317,0,1,2,3,33.3%,8m
3192,2,BINGO,3317,32,1,3,4,25.0%,6m
3196,1,단은랑,3316,754,29,22,51,56.9%,5m
3196,1,Twarenik,3316,179,8,5,13,61.5%,6m
3198,1,GBAD,3315,346,18,11,29,62.1%,3m
3198,2,옥녀,3315,283,14,8,22,63.6%,1m
3198,2,[Master]천사의날개,3315,337,13,9,22,59.1%,16m
3198,2,安安你好小豬,3315,320,11,7,18,61.1%,6m
3198,2,IllUminati,3315,241,9,7,16,56.2%,42m
3198,1,김종욱,3315,0,1,1,2,50.0%,10m
3198,1,ChromaticFox,3315,42,1,4,5,20.0%,5m
3205,3,CannonAndy,3314,1513,523,522,1045,50.0%,3m
3205,1,Raven,3314,1681,262,261,523,50.1%,8m
3205,1,걸리면이빨부터다,3314,1632,198,189,387,51.2%,4m
3205,3,[快樂玩家]LUKEKUANG,3314,1073,49,55,104,47.1%,6m
3205,1,[브리티안]CallofBlood,3314,0,4,1,5,80.0%,10m
3210,3,복수의화신,3313,144,3,2,5,60.0%,43m
3210,2,IIIIIIIIIIII,3313,0,1,1,2,50.0%,6m
3212,1,욤욤이,3312,1494,225,220,445,50.6%,7m
3212,1,서초동꿈나무,3312,102,6,2,8,75.0%,5m
3214,2,PROBE,3311,376,17,10,27,63.0%,6m
3214,3,Ipe,3311,0,5,2,7,71.4%,43m
3216,1,Apdo,3310,197,18,12,30,60.0%,3m
3216,2,엘소드만세다,3310,62,3,0,3,100.0%,6m
3218,2,호날두두마리치킨,3309,773,32,27,59,54.2%,16m
3218,1,glucose,3309,184,20,11,31,64.5%,8m
3218,1,Tiananmen,3309,0,3,2,5,60.0%,10m
3221,2,fug,3308,599,23,17,40,57.5%,3m
3221,2,[문재앙씨발놈]XijinpingSex,3308,260,13,8,21,61.9%,2m
3221,2,영꼳헐헐,3308,147,5,5,10,50.0%,3m
3221,2,야호,3308,0,1,0,1,100.0%,6m
3221,2,Gosel,3308,0,1,1,2,50.0%,8m
3221,2,곰돌이,3308,0,0,1,1,0.0%,6m
3221,2,小米九,3308,0,0,1,1,0.0%,2m
3228,2,llllllllllll,3307,160,10,0,10,100.0%,2m
3228,1,JERRY,3307,264,8,11,19,42.1%,8m
3230,2,llIIlIIIIlIl,3306,226,7,10,17,41.2%,3m
3230,3,우야,3306,96,1,1,2,50.0%,8m
3230,3,daniel,3306,0,0,4,4,0.0%,43m
3233,1,Yoz,3305,1107,41,38,79,51.9%,7m
3233,1,llllllllllll,3305,646,24,27,51,47.1%,7m
3233,2,[XYFANS]WBWB,3305,592,22,14,36,61.1%,6m
3233,1,TCY,3305,462,14,19,33,42.4%,8m
3233,2,KnerveD,3305,348,12,10,22,54.5%,1m
3233,3,[민창렬]Byul,3305,155,9,10,19,47.4%,5m
3239,2,[BFM]EmperOr,3304,260,9,10,19,47.4%,8m
3239,2,Dante,3304,92,3,5,8,37.5%,6m
3241,1,[KN]나이트라션,3303,756,28,31,59,47.5%,7m
3241,1,심심해크크크,3303,97,5,1,6,83.3%,9m
3241,2,[엘클라시코]CHAN,3303,0,0,1,1,0.0%,7m
3244,3,韓國魚吃嬾,3302,173,3,9,12,25.0%,11m
3245,1,셀렌디스,3301,1659,271,268,539,50.3%,18m
3245,3,IIIIIIIIIIII,3301,1488,98,93,191,51.3%,3m
3245,1,무작위이개새,3301,574,20,18,38,52.6%,17m
3245,1,[strong]깨강정,3301,257,9,8,17,52.9%,6m
3245,2,[자양동불빠따]ILoveFly,3301,0,1,1,2,50.0%,42m
3250,2,SuperKFC,3300,392,27,22,49,55.1%,2m
3250,2,탱크조아,3300,530,24,11,35,68.6%,8m
3250,2,MaybeB,3300,0,0,1,1,0.0%,17m
3253,1,Toss,3299,875,72,58,130,55.4%,4m
3253,2,슬픔은일요일까지,3299,118,4,3,7,57.1%,1m
3253,1,星海戰士,3299,72,3,7,10,30.0%,5m
3253,2,Sisu,3299,30,2,1,3,66.7%,6m
3253,2,[Rovic]꼬마자객,3299,32,2,2,4,50.0%,17m
3253,2,Dust,3299,30,1,2,3,33.3%,6m
3259,1,Super,3298,1358,75,58,133,56.4%,7m
3259,2,sudo,3298,183,9,4,13,69.2%,7m
3259,2,스타의왕,3298,158,5,7,12,41.7%,6m
3259,2,Casey,3298,0,1,0,1,100.0%,7m
3263,2,때려주세요,3297,1246,53,40,93,57.0%,7m
3263,1,Branky,3297,36,2,10,12,16.7%,5m
3263,2,波哥,3297,0,0,1,1,0.0%,6m
3266,2,KRdog,3296,845,128,93,221,57.9%,8m
3266,2,HaiYaa,3296,497,19,13,32,59.4%,3m
3266,2,IlIIlIIlIIl,3296,372,18,3,21,85.7%,3m
3266,2,[멩스크개1새]lllllll,3296,251,13,3,16,81.2%,2m
3266,2,Demosthenes,3296,0,4,1,5,80.0%,6m
3266,2,[맛있더라]BABYOUNG,3296,30,1,1,2,50.0%,2m
3272,1,호야쓰삐,3295,1665,721,680,1401,51.5%,2m
3272,3,[海膽王]神族之王,3295,1531,161,152,313,51.4%,6m
3272,1,[라스테이션]쇼부플토,3295,871,110,111,221,49.8%,7m
3272,2,Bass,3295,592,59,56,115,51.3%,17m
3272,2,DDDDD,3295,850,53,40,93,57.0%,16m
3272,1,llllllllllll,3295,623,29,35,64,45.3%,18m
3272,1,리치,3295,494,16,19,35,45.7%,6m
3272,2,IIIIIIIIIIII,3295,30,1,2,3,33.3%,1m
3272,2,ToyoharaBoy,3295,30,1,4,5,20.0%,6m
3272,2,Sprinkle,3295,0,0,2,2,0.0%,2m
3282,3,[온양]아이이이잉,3294,1473,379,374,753,50.3%,3m
3282,2,올피땅,3294,118,5,4,9,55.6%,2m
3282,2,小鍾,3294,0,1,1,2,50.0%,2m
3285,1,JollyPosh,3293,648,38,26,64,59.4%,5m
3285,2,BrOkEn,3293,252,9,9,18,50.0%,7m
3285,2,[KoD]llllllllllll,3293,157,7,3,10,70.0%,16m
3285,3,llllllllllll,3293,0,0,1,1,0.0%,3m
3289,3,gxgih,3292,831,30,35,65,46.2%,2m
3289,1,[일꾼]ProbE,3292,558,20,17,37,54.1%,8m
3289,1,링링링,3292,604,19,26,45,42.2%,8m
3289,1,kctony,3292,168,9,12,21,42.9%,7m
3289,3,훌리건,3292,237,6,16,22,27.3%,5m
3289,1,Nemesis,3292,88,5,2,7,71.4%,3m
3289,1,뽀뽀,3292,145,5,3,8,62.5%,10m
3289,2,[Lab423]TheStar,3292,0,4,1,5,80.0%,6m
3289,2,TONYMONTANA,3292,0,1,0,1,100.0%,16m
3298,1,[KRisEZ]MicroJFox,3291,230,7,12,19,36.8%,4m
3298,1,[육즙가득잔슨]ewigwiederke,3291,174,5,10,15,33.3%,4m
3298,1,iiiiiiiiiiii,3291,160,4,11,15,26.7%,17m
3298,2,genious,3291,30,1,1,2,50.0%,8m
3302,1,이반시아,3290,417,12,13,25,48.0%,4m
3302,2,[여친정예린팬]Faker,3290,178,5,1,6,83.3%,7m
3302,2,Adamantium,3290,0,4,1,5,80.0%,1m
3302,2,[이터널]갯지렁이스파게티,3290,30,1,4,5,20.0%,1m
3306,2,[Momo]threat,3289,1576,98,91,189,51.9%,3m
3306,2,iiiiiiiiiii,3289,0,4,1,5,80.0%,8m
3306,1,니서방,3289,38,1,7,8,12.5%,7m
3309,2,바른생각,3288,1023,152,128,280,54.3%,6m
3309,1,Blade,3288,1191,105,98,203,51.7%,17m
3309,1,Crazy,3288,1210,40,45,85,47.1%,6m
3309,1,끼리코,3288,771,30,33,63,47.6%,17m
3309,2,NTsHunt,3288,327,14,10,24,58.3%,6m
3314,3,상무지구,3286,1154,47,45,92,51.1%,9m
3314,2,암흑기사,3286,88,5,1,6,83.3%,6m
3314,2,농협삼개월입사,3286,88,3,0,3,100.0%,8m
3314,3,[더지니어스]myseif,3286,0,1,0,1,100.0%,11m
3314,2,[AYSM]SCH,3286,99,1,2,3,33.3%,16m
3314,1,나는강하다,3286,0,0,1,1,0.0%,10m
3314,2,Brave,3286,0,0,1,1,0.0%,3m
3314,2,QuasWexExort,3286,0,0,1,1,0.0%,6m
3322,1,[KOSEAL]지옥주교육생,3285,620,25,23,48,52.1%,3m
3322,3,ipv,3285,325,11,8,19,57.9%,3m
3322,1,LetsGarret,3285,257,8,10,18,44.4%,41m
3322,3,[TF]sOsaeggi,3285,0,0,1,1,0.0%,6m
3326,1,멋쟁이섭,3284,1495,57,56,113,50.4%,8m
3326,3,오양맛살,3284,830,37,43,80,46.2%,9m
3326,1,minerva,3284,0,5,0,5,100.0%,10m
3326,2,스타킬러,3284,0,1,2,3,33.3%,16m
3326,2,형님안녕,3284,0,0,2,2,0.0%,1m
3331,2,[正太萬歲]青風,3283,176,6,6,12,50.0%,6m
3331,2,[이터널]GunpoDD,3283,62,2,2,4,50.0%,3m
3331,2,cannonrush,3283,0,0,1,1,0.0%,6m
3334,2,llllllllllll,3282,30,1,2,3,33.3%,3m
3334,2,Satanick,3282,30,1,4,5,20.0%,1m
3336,2,만년실버,3281,411,17,8,25,68.0%,1m
3336,2,Wafer,3281,280,10,5,15,66.7%,6m
3336,1,유수,3281,97,4,2,6,66.7%,9m
3336,1,GooD,3281,0,3,1,4,75.0%,10m
3336,1,[sheep8]나한테지면찌질이,3281,0,1,0,1,100.0%,11m
3341,3,oohlee,3280,224,27,43,70,38.6%,5m
3341,1,shawn,3280,690,24,23,47,51.1%,7m
3341,2,[유즈맵떠돌이]썬더데커던트,3280,314,13,4,17,76.5%,6m
3341,2,MasterEd,3280,0,1,0,1,100.0%,3m
3345,1,Raiders,3279,1337,154,155,309,49.8%,3m
3345,2,[萬花筒寫輪眼]PrimeBEEF,3279,0,0,4,4,0.0%,6m
3347,1,BlackAngel,3278,1237,64,61,125,51.2%,7m
3347,2,Crema,3278,980,41,30,71,57.7%,7m
3347,2,[Nos]Nos,3278,628,30,24,54,55.6%,6m
3347,1,[망할고인물]펭심,3278,125,7,3,10,70.0%,8m
3347,2,IIIIIIIIIIII,3278,0,4,1,5,80.0%,6m
3347,2,我是神,3278,124,3,0,3,100.0%,3m
3353,1,Mumbles,3277,0,2,1,3,66.7%,18m
3354,1,DerpyDoggie,3276,97,5,1,6,83.3%,11m
3354,2,TIKTOK,3276,30,2,1,3,66.7%,3m
3356,1,아칸,3275,824,27,34,61,44.3%,18m
3356,1,[트수Crew]Reaper,3275,438,13,19,32,40.6%,8m
3356,2,IIIIIIIIIIII,3275,0,4,1,5,80.0%,1m
3356,2,지구를지켜라,3275,0,0,2,2,0.0%,7m
3360,1,손주호,3274,835,69,49,118,58.5%,8m
3360,2,llllllllllll,3274,595,22,18,40,55.0%,1m
3360,1,우근이,3274,0,4,1,5,80.0%,10m
3363,1,IIlllIIIIIII,3273,1646,135,115,250,54.0%,17m
3363,2,llllllIIIIIl,3273,195,11,12,23,47.8%,16m
3363,2,[沉默]SiLeNceTiN,3273,60,3,2,5,60.0%,7m
3366,1,피구공,3272,1583,216,208,424,50.9%,17m
3366,2,Metrics,3272,470,19,15,34,55.9%,6m
3366,2,[Lof]도넛집알바생,3272,279,10,3,13,76.9%,7m
3366,2,[밀짚모해적단]RSyfer,3272,210,7,4,11,63.6%,42m
3366,2,AlSYNIA,3272,30,4,4,8,50.0%,7m
3366,1,Tanks,3272,96,2,2,4,50.0%,40m
3366,3,[諸葛世家]Karas,3272,0,0,1,1,0.0%,43m
3373,1,llllllllllll,3271,1404,164,149,313,52.4%,7m
3373,1,Spetznatz,3271,1592,134,118,252,53.2%,17m
3373,1,[WTSC]프롤레타리아,3271,868,32,32,64,50.0%,6m
3373,1,YinGan,3271,620,28,33,61,45.9%,7m
3373,2,PanDa,3271,227,9,8,17,52.9%,17m
3373,1,Brisket,3271,97,5,1,6,83.3%,10m
3373,2,bbeeee,3271,0,0,1,1,0.0%,6m
3380,2,bsone,3270,516,20,14,34,58.8%,17m
3380,2,가을보리,3270,300,12,5,17,70.6%,7m
3380,2,[이시하라사톰]Satom,3270,282,11,5,16,68.8%,6m
3380,3,Irreplaveabl,3270,169,8,4,12,66.7%,12m
3384,1,WufuLulu,3269,439,18,13,31,58.1%,18m
3384,2,[우린호구다]분광사도배달,3269,0,0,2,2,0.0%,6m
3386,1,哈嚕你好嗎,3268,901,38,32,70,54.3%,8m
3386,2,[아임프래쉬]스파이더맨발,3268,318,12,10,22,54.5%,3m
3386,2,도라에몽,3268,0,5,0,5,100.0%,7m
3386,2,mETaPod,3268,50,2,2,4,50.0%,6m
3390,1,부릉,3267,1642,272,255,527,51.6%,2m
3390,1,Kraken,3267,948,32,35,67,47.8%,5m
3390,1,Yowwwn,3267,97,5,1,6,83.3%,10m
3390,2,CollinCobra,3267,0,0,1,1,0.0%,1m
3394,2,[원탑1st]혜윰,3266,70,3,1,4,75.0%,1m
3394,2,[Debug]CandlyDebug,3266,0,1,1,2,50.0%,17m
3394,2,fmgreen,3266,0,0,1,1,0.0%,17m
3397,1,Entus,3265,385,18,15,33,54.5%,8m
3397,2,스투는죽었다,3265,207,10,2,12,83.3%,3m
3397,1,이창현,3265,121,6,2,8,75.0%,10m
3397,1,Smurf,3265,38,6,3,9,66.7%,3m
3401,2,Andreas,3264,1201,51,41,92,55.4%,7m
3401,3,tdiEmperor,3264,209,6,2,8,75.0%,12m
3401,1,전투자극제,3264,210,6,9,15,40.0%,17m
3401,1,diazlike,3264,0,4,1,5,80.0%,9m
3401,2,사일런,3264,30,1,1,2,50.0%,6m
3401,2,fantasystar,3264,0,0,1,1,0.0%,6m
3407,1,Lights,3263,1594,295,264,559,52.8%,2m
3408,1,Paoskie,3262,1638,102,82,184,55.4%,5m
3408,2,Jerry,3262,494,27,21,48,56.2%,17m
3408,2,llllllllllII,3262,447,19,15,34,55.9%,17m
3408,2,TimoBeste,3262,32,5,2,7,71.4%,3m
3412,2,[Blacer]유리살앙,3261,1389,69,64,133,51.9%,16m
3412,2,[모노시발꺼]바밤바,3261,1054,39,39,78,50.0%,17m
3412,2,[너의ol름은]형은세배빠르당,3261,536,19,14,33,57.6%,16m
3412,2,seorihunter,3261,0,1,0,1,100.0%,3m
3412,2,푸른빛하늘,3261,32,1,1,2,50.0%,3m
3417,2,Schrodinger,3260,1578,122,117,239,51.0%,3m
3417,2,[Sergio]뱅듄,3260,1467,116,92,208,55.8%,17m
3417,2,Ahyaneru,3260,278,12,9,21,57.1%,3m
3417,1,너를꿈꾸며,3260,121,6,2,8,75.0%,10m
3417,3,[반콩성반퉁퉁]시즈탕쿠,3260,145,4,0,4,100.0%,43m
3417,1,SSHH,3260,97,4,4,8,50.0%,38m
3423,2,Victorique,3259,156,7,3,10,70.0%,6m
3423,2,바코드개젖병신,3259,90,3,3,6,50.0%,8m
3425,1,WTF,3258,1628,251,234,485,51.8%,3m
3425,1,[SNL]니얼굴이다,3258,1615,197,182,379,52.0%,4m
3425,1,IIIIIIIII,3258,772,43,49,92,46.7%,6m
3425,2,FeanorBeleg,3258,230,8,4,12,66.7%,17m
3425,2,lol,3258,0,1,3,4,25.0%,3m
3430,2,발트하임,3257,434,15,16,31,48.4%,6m
3430,2,[AciNoN]Dimon,3257,0,4,1,5,80.0%,7m
3432,1,[PTc]張景羊,3256,1051,43,35,78,55.1%,8m
3432,1,IIIIIIIII,3256,121,5,2,7,71.4%,10m
3432,2,[Mech]SpyTe,3256,92,4,2,6,66.7%,3m
3432,2,Jazztronik,3256,88,3,20,23,13.0%,1m
3432,1,IIIIIIIIIIII,3256,0,0,1,1,0.0%,10m
3432,2,GuDo,3256,0,0,2,2,0.0%,7m
3438,2,siheon,3255,994,48,31,79,60.8%,3m
3438,1,Roman,3255,1150,45,55,100,45.0%,7m
3438,1,기영이,3255,380,17,15,32,53.1%,7m
3438,2,llllllllllll,3255,406,15,9,24,62.5%,2m
3438,1,므우,3255,384,11,18,29,37.9%,7m
3438,2,[무한오영종]Closer,3255,32,2,5,7,28.6%,1m
3438,2,OrbitsterSir,3255,0,0,2,2,0.0%,42m
3445,2,PaHuaN,3254,996,47,30,77,61.0%,2m
3445,1,[ONCE台灣]CicadaFLY,3254,355,35,30,65,53.8%,7m
3445,1,[GITS]timba,3254,552,33,18,51,64.7%,8m
3445,1,JoE,3254,146,8,4,12,66.7%,5m
3445,2,[D3StaR]AnThoNyDaVis,3254,112,3,0,3,100.0%,7m
3450,1,bisu,3253,820,29,30,59,49.2%,6m
3450,2,물오른오징어,3253,0,4,1,5,80.0%,1m
3450,2,lllllllll,3253,0,0,1,1,0.0%,6m
3450,2,준규욧,3253,73,0,2,2,0.0%,3m
3454,2,yuhsuan,3252,518,36,28,64,56.2%,6m
3454,1,raika,3252,904,31,33,64,48.4%,5m
3454,2,NexLife,3252,114,5,1,6,83.3%,6m
3454,1,zxy,3252,48,3,2,5,60.0%,10m
3454,3,IIIIIIIIII,3252,121,2,4,6,33.3%,43m
3454,2,Tengteng,3252,0,1,0,1,100.0%,3m
3460,2,타지리리님한판만,3251,1414,118,107,225,52.4%,6m
3460,2,잔소리송대리,3251,1086,46,34,80,57.5%,1m
3460,2,Berserk,3251,709,26,29,55,47.3%,6m
3460,2,[FsACN]MattHorner,3251,30,4,2,6,66.7%,7m
3460,2,jack,3251,0,1,2,3,33.3%,6m
3465,1,[무한오영종]시화커플실장,3250,1605,157,158,315,49.8%,2m
3465,2,데모스테네스,3250,462,21,13,34,61.8%,6m
3465,2,IIIllIllIIll,3250,148,5,9,14,35.7%,2m
3465,3,嘎拉咕嚕啦咧,3250,166,5,10,15,33.3%,3m
3465,2,ROKMCPOHANG,3250,62,2,3,5,40.0%,3m
3465,2,컴공이창환,3250,0,0,2,2,0.0%,6m
3471,1,[두루와]현이지,3249,1648,164,143,307,53.4%,5m
3471,1,kariskrid,3249,1629,164,170,334,49.1%,5m
3471,1,qwertyuiop,3249,326,8,36,44,18.2%,8m
3471,2,Bitmex,3249,58,3,0,3,100.0%,3m
3471,2,VerSan,3249,0,1,0,1,100.0%,6m
3471,2,[Queens]가영,3249,0,1,1,2,50.0%,1m
3471,2,zzzzzzzzzzzz,3249,0,0,1,1,0.0%,8m
3478,2,RaEy,3248,813,40,19,59,67.8%,3m
3478,2,[SAZABI]kado,3248,424,18,13,31,58.1%,1m
3478,2,bullybaboon,3248,0,4,1,5,80.0%,17m
3481,1,Sign,3247,930,42,37,79,53.2%,17m
3481,2,[ASTR]ASRAKH,3247,793,36,24,60,60.0%,8m
3481,2,[UN無限]DestoryMax,3247,90,4,4,8,50.0%,17m
3481,1,hyoung,3247,76,4,7,11,36.4%,5m
3481,2,Terotox,3247,118,3,1,4,75.0%,6m
3486,3,[Aqua5]백사,3246,167,7,3,10,70.0%,12m
3486,2,지존,3246,58,3,1,4,75.0%,8m
3486,1,살사킹,3246,120,2,2,4,50.0%,9m
3486,2,Tsuyoshi,3246,0,1,2,3,33.3%,2m
3486,2,[스카이파이터]ChoiKyoEun,3246,0,0,1,1,0.0%,7m
3486,2,두루치기다,3246,0,0,1,1,0.0%,3m
3492,1,IIIIIIIIIIII,3245,726,107,94,201,53.2%,7m
3492,2,효니,3245,922,41,33,74,55.4%,6m
3492,3,민사마,3245,534,19,36,55,34.5%,6m
3492,2,바이킹장인,3245,190,9,6,15,60.0%,43m
3492,2,NovemberXI,3245,165,6,8,14,42.9%,43m
3492,2,BiLunn,3245,129,3,2,5,60.0%,1m
3492,2,[무한오영종]chovy,3245,0,1,1,2,50.0%,3m
3492,2,唐三,3245,0,1,1,2,50.0%,16m
3500,2,LiBeRtY,3244,1362,59,44,103,57.3%,6m
3500,2,Richlmolly,3244,507,29,21,50,58.0%,2m
3500,2,[더붉은공산당]미소,3244,211,10,14,24,41.7%,16m
3500,2,swindow,3244,0,4,1,5,80.0%,17m
3500,3,깜동,3244,72,3,5,8,37.5%,17m
3500,1,FnB,3244,137,3,6,9,33.3%,40m
3500,2,삼방인,3244,0,0,1,1,0.0%,6m
3507,1,undertaker,3243,1599,77,77,154,50.0%,8m
3507,2,섹시잇힝,3243,653,28,20,48,58.3%,8m
3507,2,[래더납치범]스타는너무어려워,3243,361,14,8,22,63.6%,3m
3507,2,protoss,3243,229,10,5,15,66.7%,7m
3507,2,Mint,3243,0,0,2,2,0.0%,1m
3507,2,김기원,3243,0,0,2,2,0.0%,16m
3513,1,neonbeam,3242,772,24,32,56,42.9%,6m
3513,2,키위쨈,3242,0,0,1,1,0.0%,6m
3515,2,pastry,3241,1033,170,163,333,51.1%,7m
3515,2,[璇兮]Eternity,3241,1330,84,76,160,52.5%,6m
3515,2,[일벌레고용주]heNi,3241,812,34,26,60,56.7%,1m
3515,2,[개폭망]maruking,3241,186,7,6,13,53.8%,17m
3515,2,doubleqpc,3241,30,2,0,2,100.0%,2m
3515,2,Belial,3241,88,2,0,2,100.0%,3m
3521,1,Victor,3240,1585,532,518,1050,50.7%,5m
3521,2,Espresso,3240,209,18,20,38,47.4%,3m
3521,2,[엽기전략]광고창작,3240,426,17,11,28,60.7%,6m
3521,2,llllllllllll,3240,317,14,5,19,73.7%,3m
3521,1,Glacage,3240,152,5,11,16,31.2%,5m
3521,2,Koko,3240,58,3,2,5,60.0%,7m
3521,2,llllllllllll,3240,0,1,3,4,25.0%,6m
3521,2,[세일얼짱정근]DARK,3240,0,0,2,2,0.0%,6m
3529,2,[꼴받네]어서오고,3239,131,4,1,5,80.0%,2m
3529,2,Acrow,3239,0,4,1,5,80.0%,2m
3529,2,Kai,3239,0,1,1,2,50.0%,2m
3532,2,IIIIIIIIIIII,3238,734,77,68,145,53.1%,17m
3532,1,[중금속중독자]AKG,3238,1234,50,58,108,46.3%,17m
3532,2,우아한정화자,3238,0,4,1,5,80.0%,1m
3532,2,파이의파이,3238,140,4,3,7,57.1%,3m
3536,1,phoenix,3237,718,28,26,54,51.9%,6m
3536,2,사나,3237,514,23,20,43,53.5%,1m
3536,3,[포세이큰]래더개못하는사람,3237,594,20,36,56,35.7%,3m
3536,2,고르아마신,3237,323,15,7,22,68.2%,6m
3536,1,PoCaRi,3237,145,7,1,8,87.5%,10m
3536,2,hard,3237,0,4,1,5,80.0%,3m
3542,2,RyanJeff,3236,936,110,93,203,54.2%,1m
3542,1,LostAndFound,3236,516,31,27,58,53.4%,8m
3542,2,llllllllllll,3236,394,17,8,25,68.0%,6m
3542,2,큰털보,3236,64,3,3,6,50.0%,6m
3546,2,[快樂玩家]慕晴菲,3235,542,21,14,35,60.0%,6m
3546,2,[에이지티]김소은,3235,228,7,6,13,53.8%,1m
3546,1,된장,3235,128,7,8,15,46.7%,3m
3546,1,[도담이]Marco,3235,277,7,13,20,35.0%,6m
3546,2,니뽕찡,3235,86,4,2,6,66.7%,3m
3551,2,llllllllllll,3234,1545,318,306,624,51.0%,2m
3551,1,馥滉爾隰塵,3234,1450,175,161,336,52.1%,2m
3551,2,시발아이디,3234,422,14,18,32,43.8%,16m
3551,2,HARDCORE,3234,310,12,14,26,46.2%,9m
3551,2,[밥둑밥찰]USAProduct,3234,204,7,4,11,63.6%,7m
3551,2,[OX우승자]gngnl,3234,60,2,4,6,33.3%,6m
3557,1,arrupe,3233,935,51,52,103,49.5%,8m
3557,2,ONGGAMENET,3233,554,20,19,39,51.3%,7m
3557,3,누간,3233,114,3,3,6,50.0%,43m
3560,2,[最後生還者]blong,3232,495,34,12,46,73.9%,6m
3560,2,바위게,3232,251,12,7,19,63.2%,3m
3560,2,styer,3232,212,8,11,19,42.1%,3m
3560,2,킹스카이언,3232,148,6,6,12,50.0%,17m
3560,3,Anf,3232,83,4,8,12,33.3%,5m
3560,2,[东罗马帝国]AqueroN,3232,64,2,4,6,33.3%,16m
3566,2,ImSpecialOne,3231,388,14,12,26,53.8%,2m
3566,2,北條悟史,3231,122,4,8,12,33.3%,6m
3566,2,sesame,3231,58,2,2,4,50.0%,6m
3566,2,JFKIST,3231,0,1,0,1,100.0%,1m
3566,2,Lox,3231,0,1,0,1,100.0%,1m
3566,3,態度,3231,0,0,2,2,0.0%,11m
3566,2,[Rovic]RanDoMRusH,3231,0,0,2,2,0.0%,7m
3573,1,rlawnsghd,3230,1568,59,69,128,46.1%,7m
3573,2,상은이의하루,3230,1129,50,35,85,58.8%,1m
3573,2,최원호,3230,673,49,49,98,50.0%,3m
3573,2,암살자,3230,30,1,1,2,50.0%,1m
3577,2,lllIIIlll,3229,0,1,0,1,100.0%,6m
3577,2,독서기록장,3229,0,1,1,2,50.0%,9m
3579,2,alive,3228,1146,221,208,429,51.5%,6m
3579,2,섬망상태,3228,0,0,1,1,0.0%,6m
3581,1,야매,3227,1638,240,239,479,50.1%,8m
3581,2,Confessions,3227,1260,51,48,99,51.5%,17m
3581,2,[끝장본다]낭만오크,3227,281,10,7,17,58.8%,6m
3581,2,세례요한,3227,205,7,5,12,58.3%,1m
3581,1,llllllllllll,3227,48,5,3,8,62.5%,10m
3581,2,Documan,3227,140,4,1,5,80.0%,6m
3581,2,omgvi,3227,184,4,5,9,44.4%,1m
3581,2,TanguyNdomb,3227,30,2,1,3,66.7%,6m
3581,1,동네곰님,3227,0,2,5,7,28.6%,5m
3590,3,hkkthhkkth,3226,1407,321,319,640,50.2%,8m
3590,1,caznale,3226,1602,307,297,604,50.8%,5m
3590,2,hackertitan,3226,829,56,52,108,51.9%,9m
3590,2,김장김치,3226,334,11,8,19,57.9%,17m
3590,2,keeplaying,3226,128,6,4,10,60.0%,3m
3590,2,판타지크,3226,0,4,2,6,66.7%,2m
3590,2,베이가,3226,32,1,1,2,50.0%,7m
3597,1,[트위치]레드스톰,3225,1619,172,171,343,50.1%,7m
3597,1,cityhunter,3225,1509,60,54,114,52.6%,8m
3597,1,llllllllllll,3225,565,18,23,41,43.9%,8m
3597,1,KJHkara,3225,92,4,4,8,50.0%,2m
3597,2,DepthC,3225,0,0,2,2,0.0%,6m
3602,2,DOMINATOR,3224,392,20,20,40,50.0%,16m
3603,2,assa,3223,538,83,78,161,51.6%,17m
3603,2,[애니멀킹덤]동물왕고양이네코,3223,219,9,3,12,75.0%,3m
3603,1,동위원소,3223,169,5,2,7,71.4%,39m
3603,2,FlameSJ,3223,0,0,1,1,0.0%,1m
3603,3,[靠團]Shiva,3223,0,0,1,1,0.0%,43m
3608,2,김쿵짝,3222,88,1,3,4,25.0%,7m
3609,2,빼빼로스,3221,390,74,70,144,51.4%,6m
3609,2,llllllllllll,3221,637,28,18,46,60.9%,7m
3609,2,타우렌드루이드,3221,360,13,10,23,56.5%,6m
3609,2,[xTMDx]PhoeNix,3221,58,3,2,5,60.0%,6m
3609,2,저그,3221,0,1,1,2,50.0%,2m
3614,2,앙마스크,3220,1539,277,269,546,50.7%,1m
3614,1,피닉스,3220,1136,146,132,278,52.5%,8m
3614,2,Immortal,3220,420,18,10,28,64.3%,6m
3614,2,freexxx,3220,336,17,16,33,51.5%,1m
3614,1,llIIllllllll,3220,369,11,16,27,40.7%,7m
3614,2,냐냔냐냔냐냔냐,3220,88,1,1,2,50.0%,16m
3620,2,김치크루,3219,245,10,7,17,58.8%,8m
3620,2,hAZY,3219,115,6,2,8,75.0%,7m
3620,2,[OsGZ]Euweb,3219,0,4,0,4,100.0%,3m
3620,2,국뽕의아리랑,3219,135,4,1,5,80.0%,16m
3620,1,philosophic,3219,36,1,9,10,10.0%,17m
3625,2,wiseman,3218,1542,284,277,561,50.6%,6m
3625,2,왕갬,3218,1546,215,180,395,54.4%,1m
3625,2,ASDASDADASDA,3218,170,7,6,13,53.8%,3m
3625,2,[청초]ALCA,3218,140,4,4,8,50.0%,9m
3625,2,llllllllllll,3218,102,3,0,3,100.0%,3m
3630,2,地知治世要,3217,455,45,39,84,53.6%,6m
3630,2,Sierra,3217,204,20,6,26,76.9%,6m
3630,2,바른말고운말,3217,237,9,8,17,52.9%,42m
3630,1,MapleSyrup,3217,189,5,10,15,33.3%,3m
3634,2,IIIIIIIIIIII,3216,891,107,71,178,60.1%,7m
3634,1,[DagmBa]공피고아,3216,917,39,37,76,51.3%,8m
3634,1,[이터널]그래도조성주짱,3216,940,32,35,67,47.8%,8m
3634,1,atoa,3216,894,31,39,70,44.3%,18m
3634,1,로멘티시스트,3216,408,19,15,34,55.9%,3m
3634,2,[TheDOH]強勇集團,3216,484,16,21,37,43.2%,6m
3634,1,Vivi,3216,202,7,13,20,35.0%,5m
3634,2,Vica,3216,102,5,3,8,62.5%,6m
3634,2,lIIIIIlllllI,3216,60,3,2,5,60.0%,17m
3634,2,[홍콩행제리바]BOLA,3216,0,1,0,1,100.0%,3m
3634,2,[WTSC]리젖문,3216,0,0,2,2,0.0%,9m
3645,1,Edwin,3215,1500,122,113,235,51.9%,8m
3645,2,Katsu,3215,1508,70,63,133,52.6%,7m
3645,2,Charging,3215,100,4,7,11,36.4%,6m
3645,1,CooooooooooL,3215,97,4,10,14,28.6%,18m
3645,2,익남,3215,88,1,1,2,50.0%,7m
3650,2,星空殺手,3214,1034,44,34,78,56.4%,7m
3650,2,lIllIIlIIl,3214,706,36,19,55,65.5%,3m
3650,1,[教我玩神族o]熊熊,3214,119,6,2,8,75.0%,10m
3650,2,넌디져써,3214,88,5,1,6,83.3%,6m
3650,1,국정원래퍼노무현,3214,203,5,7,12,41.7%,5m
3650,2,Nubium,3214,0,4,1,5,80.0%,7m
3650,2,[WHB]한화우승,3214,126,4,2,6,66.7%,1m
3650,2,끝난겁니까,3214,88,2,0,2,100.0%,6m
3650,2,Viral,3214,0,0,2,2,0.0%,6m
3659,2,ViperRevol,3213,656,59,46,105,56.2%,1m
3659,2,Noispaxen,3213,283,11,12,23,47.8%,9m
3659,2,형사변호사,3213,156,5,7,12,41.7%,6m
3659,2,Javascript,3213,126,4,1,5,80.0%,2m
3659,2,[IIIIII]TyLsheepbean,3213,112,3,1,4,75.0%,6m
3659,2,[NGNLZ]Kirito,3213,32,2,2,4,50.0%,17m
3665,2,[플라메모]HutsNami,3212,513,26,26,52,50.0%,6m
3665,2,lIllIllllIII,3212,484,16,22,38,42.1%,1m
3665,2,Stats,3212,0,4,1,5,80.0%,17m
3668,2,McWolf,3211,1493,313,298,611,51.2%,17m
3668,2,[Hazbin]Alastor,3211,577,57,38,95,60.0%,3m
3668,2,Crylee,3211,92,4,4,8,50.0%,7m
3668,1,aquras,3211,0,1,1,2,50.0%,9m
3668,2,야동남,3211,0,0,1,1,0.0%,7m
3673,2,nikolatesla,3210,1022,83,71,154,53.9%,6m
3673,2,[공허거주]yes,3210,1077,51,30,81,63.0%,3m
3673,2,minami,3210,648,27,20,47,57.4%,6m
3673,2,Yodumick,3210,0,1,1,2,50.0%,6m
3677,2,장동건,3209,1144,44,49,93,47.3%,17m
3677,1,Jiraiya,3209,460,21,24,45,46.7%,5m
3677,2,LuxurySlayer,3209,0,1,0,1,100.0%,16m
3680,2,llllllllllll,3208,435,21,11,32,65.6%,6m
3680,2,Aurateur,3208,176,6,9,15,40.0%,6m
3680,1,[l인성]CapTAin,3208,48,3,5,8,37.5%,11m
3680,2,HazelBess,3208,0,2,3,5,40.0%,3m
3680,2,Realred,3208,30,2,3,5,40.0%,17m
3680,1,광속의날,3208,82,2,15,17,11.8%,5m
3680,2,ACI,3208,0,1,1,2,50.0%,7m
3687,1,정형돈,3207,1612,234,209,443,52.8%,8m
3687,2,ILILILILI,3207,993,44,30,74,59.5%,7m
3687,2,어떠냐,3207,428,16,13,29,55.2%,6m
3687,2,[무한오영종]김치,3207,294,12,6,18,66.7%,6m
3687,2,iiiiiiiii,3207,149,6,8,14,42.9%,42m
3687,2,우리가족,3207,0,1,0,1,100.0%,7m
3687,2,llllllllllll,3207,0,0,1,1,0.0%,1m
3694,2,[CPlay]SlowStartEr,3206,874,48,43,91,52.7%,6m
3694,2,[Old]蹦蹦騎士,3206,575,27,13,40,67.5%,17m
3694,2,[육풍함]IllIIIllIllI,3206,331,14,10,24,58.3%,6m
3694,2,Mangooo,3206,332,12,6,18,66.7%,42m
3694,2,사르트르,3206,88,1,1,2,50.0%,7m
3699,2,우유호랑이,3205,934,88,76,164,53.7%,6m
3699,2,wtmark,3205,970,38,32,70,54.3%,16m
3699,2,[WTSC]KDY,3205,380,20,23,43,46.5%,16m
3699,2,llllllllll,3205,30,2,1,3,66.7%,6m
3703,2,낭만적이다,3204,1513,137,96,233,58.8%,3m
3703,2,하늘나는연,3204,480,17,22,39,43.6%,6m
3703,2,[BJI]PoringZerg,3204,235,10,6,16,62.5%,6m
3703,2,[meobol]moriarty,3204,88,4,4,8,50.0%,3m
3703,2,날빌충,3204,0,1,1,2,50.0%,6m
3703,3,Greentea,3204,96,1,4,5,20.0%,6m
3703,2,Ulrezaj,3204,0,0,1,1,0.0%,17m
3710,2,Naviester,3203,1521,149,118,267,55.8%,3m
3710,2,형님,3203,1030,55,49,104,52.9%,1m
3710,2,winking,3203,1026,41,36,77,53.2%,3m
3710,2,[HINA]Mitsuha,3203,158,7,4,11,63.6%,6m
3710,2,ABC,3203,0,3,1,4,75.0%,8m
3710,2,IIIIIIIIIIII,3203,0,1,1,2,50.0%,7m
3710,2,Sky,3203,0,0,1,1,0.0%,1m
3717,2,KARI,3202,665,27,22,49,55.1%,7m
3717,1,종랴리짱,3202,30,6,3,9,66.7%,3m
3717,2,허영무,3202,0,2,1,3,66.7%,6m
3720,2,[경기도민]돼지세끼,3201,722,42,36,78,53.8%,6m
3720,2,[ErOs]IIIIIIIIIIII,3201,427,20,10,30,66.7%,6m
3720,2,나쁜남자,3201,266,10,11,21,47.6%,9m
3723,1,[ANGG]솔비앙,3200,1400,137,131,268,51.1%,4m
3723,2,[NGNLZ]Mirukusosu,3200,111,9,4,13,69.2%,16m
3723,2,[비트]ShaDow,3200,94,3,8,11,27.3%,6m
3723,2,[偷家狗]ArchiTectWYD,3200,0,0,1,1,0.0%,6m
3723,2,[SofT]헬창,3200,0,0,1,1,0.0%,17m
3728,2,ZeuS,3199,268,10,10,20,50.0%,17m
3728,1,WhowantstoCh,3199,97,5,2,7,71.4%,10m
3728,1,Arven,3199,0,4,2,6,66.7%,9m
3728,1,Cheetah,3199,48,4,4,8,50.0%,18m
3728,3,PrioritY,3199,0,1,0,1,100.0%,16m
3733,2,[ANGG]Whisper,3198,354,25,23,48,52.1%,2m
3733,3,다크쉘,3198,340,16,10,26,61.5%,5m
3733,3,[겨울방어]저그야캐요,3198,0,0,1,1,0.0%,5m
3736,2,Commander,3197,196,9,6,15,60.0%,42m
3736,2,Ruscello,3197,159,5,5,10,50.0%,6m
3736,3,[EERR]llllllllllll,3197,30,2,0,2,100.0%,2m
3736,2,캔디맛사탕,3197,30,1,4,5,20.0%,16m
3736,2,lastbionic,3197,0,0,3,3,0.0%,6m
3741,3,HungSR,3196,158,7,5,12,58.3%,12m
3741,3,SirgamerMore,3196,152,4,3,7,57.1%,6m
3741,2,폭군,3196,112,3,2,5,60.0%,8m
3741,2,루퍼,3196,128,3,3,6,50.0%,3m
3741,3,[무한오영종]KingDomGlorY,3196,30,2,0,2,100.0%,5m
3741,2,김진시재,3196,0,0,3,3,0.0%,6m
3747,2,Crasher,3195,394,16,13,29,55.2%,9m
3747,2,CLaUs,3195,315,12,7,19,63.2%,43m
3747,3,[Jju]CocoChanel,3195,218,9,3,12,75.0%,6m
3747,1,[Ainya]헤이즐,3195,168,7,3,10,70.0%,10m
3747,2,SoraMachi,3195,116,4,1,5,80.0%,6m
3747,3,PoKa,3195,114,3,1,4,75.0%,9m
3747,2,問君能有幾多愁,3195,90,1,2,3,33.3%,42m
3747,1,[Oyster]LuteCL,3195,0,0,1,1,0.0%,10m
3755,2,SSKLive,3194,563,76,61,137,55.5%,6m
3755,2,긴팔원숭이,3194,219,8,2,10,80.0%,6m
3755,2,Nike,3194,143,5,3,8,62.5%,16m
3755,3,[농약]이쑤신장군,3194,0,0,1,1,0.0%,16m
3755,3,Tom,3194,0,0,1,1,0.0%,3m
3760,3,WSC,3193,1477,175,172,347,50.4%,3m
3760,3,레스토랑스,3193,742,38,31,69,55.1%,5m
3760,1,클레오빡돌아,3193,740,30,38,68,44.1%,7m
3760,2,WOZ,3193,318,10,10,20,50.0%,6m
3764,3,JanJan,3192,1513,192,167,359,53.5%,6m
3764,2,戰隊,3192,1532,85,81,166,51.2%,7m
3764,2,[BRSKR]드림머,3192,974,46,28,74,62.2%,1m
3764,2,IIIiiiiIIIIi,3192,588,23,25,48,47.9%,6m
3764,2,centurion,3192,148,6,5,11,54.5%,6m
3764,3,보라매,3192,30,4,3,7,57.1%,6m
3764,3,TTT,3192,126,3,6,9,33.3%,11m
3764,3,마이클색슨,3192,30,2,1,3,66.7%,7m
3772,2,[패자는피를]블랜드,3191,526,20,17,37,54.1%,6m
3772,3,[에반탓]순이아재,3191,212,7,7,14,50.0%,43m
3772,2,삼다수,3191,166,6,3,9,66.7%,17m
3775,2,JerryC,3190,454,18,17,35,51.4%,6m
3775,3,묘야,3190,170,7,7,14,50.0%,8m
3775,3,kimyoungs,3190,30,2,0,2,100.0%,5m
3775,1,UrielKoneho,3190,97,1,2,3,33.3%,10m
3779,1,jaguar,3189,1555,213,220,433,49.2%,8m
3779,2,IIIIIIIIIIII,3189,783,41,38,79,51.9%,16m
3779,3,[蒼龍逆天狂]櫻小路才華,3189,447,21,5,26,80.8%,6m
3779,3,CarlYJQ,3189,235,8,3,11,72.7%,5m
3779,3,피첼로린,3189,114,5,2,7,71.4%,16m
3779,2,IIiiIIiiiiii,3189,92,3,5,8,37.5%,6m
3779,3,나는푸른달빛,3189,0,0,1,1,0.0%,5m
3779,3,올피땅,3189,0,0,1,1,0.0%,16m
3787,2,BlackBox,3188,747,122,102,224,54.5%,1m
3787,2,[중금속중독자]듀얼,3188,186,9,5,14,64.3%,7m
3787,2,빽도,3188,120,4,9,13,30.8%,3m
3787,3,밴딩머신이머지,3188,30,1,1,2,50.0%,17m
3787,3,ShiNe,3188,0,0,1,1,0.0%,9m
3792,2,쇼미더머니,3187,700,26,25,51,51.0%,17m
3793,2,NOOOB,3186,1460,71,65,136,52.2%,9m
3793,1,Rainbow,3186,960,39,37,76,51.3%,5m
3793,2,황현민존잘,3186,496,23,15,38,60.5%,6m
3793,3,[false9]DAYBREAK,3186,247,10,7,17,58.8%,9m
3793,2,[꾸에에엑]GoldenGoose,3186,272,10,13,23,43.5%,3m
3793,2,홍스타,3186,181,7,7,14,50.0%,16m
3793,2,[sc2mc]태양의눈물,3186,0,2,3,5,40.0%,18m
3793,3,Andy,3186,0,2,3,5,40.0%,8m
3793,3,ohlovetaiwan,3186,0,1,0,1,100.0%,5m
3793,3,몽실양,3186,0,1,0,1,100.0%,3m
3793,2,IIIIIIIIII,3186,34,1,7,8,12.5%,9m
3804,2,지금이니,3185,658,47,45,92,51.1%,6m
3804,1,[LINNY]Unogun,3185,190,5,1,6,83.3%,9m
3804,3,theobold,3185,30,1,1,2,50.0%,3m
3807,2,Light,3184,1040,48,49,97,49.5%,17m
3807,2,luckcoo,3184,464,21,13,34,61.8%,8m
3807,2,[미친광전사]가지짱,3184,116,4,1,5,80.0%,3m
3807,3,TheDark,3184,0,0,1,1,0.0%,7m
3807,2,ShocK,3184,0,0,6,6,0.0%,9m
3812,2,[얼음과자]kykisk,3183,134,7,3,10,70.0%,3m
3812,1,[SNFL]태양,3183,0,5,3,8,62.5%,5m
3812,3,KalidraT,3183,0,4,1,5,80.0%,5m
3812,3,nighter,3183,0,4,1,5,80.0%,8m
3812,2,무적의삼중대,3183,30,2,4,6,33.3%,2m
3812,3,[XYFANS]gOb,3183,0,1,0,1,100.0%,3m
3812,2,압둘라,3183,0,0,1,1,0.0%,17m
3819,3,Linker,3182,1529,226,225,451,50.1%,2m
3819,2,llllllII,3182,1376,128,122,250,51.2%,3m
3819,3,change,3182,293,15,12,27,55.6%,9m
3819,3,小冰,3182,292,14,17,31,45.2%,5m
3819,2,[DnD]가나다,3182,90,4,7,11,36.4%,1m
3819,3,JJinha,3182,30,1,1,2,50.0%,8m
3819,1,Simba,3182,83,1,2,3,33.3%,41m
3826,2,nuin,3181,190,5,6,11,45.5%,7m
3826,2,쿠카이헌터,3181,30,2,3,5,40.0%,3m
3828,2,llllllll,3180,114,4,6,10,40.0%,6m
3828,1,grow,3180,97,3,5,8,37.5%,40m
3828,3,망고스,3180,30,1,2,3,33.3%,8m
3828,2,Gate,3180,30,1,5,6,16.7%,16m
3832,3,ellea,3179,932,96,81,177,54.2%,17m
3832,1,[GAL]ABeeE,3179,843,44,43,87,50.6%,9m
3832,2,우리겜방알바예쁨,3179,396,23,17,40,57.5%,17m
3832,2,복가임,3179,174,4,6,10,40.0%,1m
3832,3,llllllllllll,3179,0,0,1,1,0.0%,9m
3837,2,lllllllll,3178,1509,139,125,264,52.7%,3m
3837,2,아르타니스개잘함,3178,305,10,11,21,47.6%,42m
3837,2,Roy,3178,296,10,13,23,43.5%,7m
3837,2,이재우,3178,30,5,3,8,62.5%,16m
3837,2,[세미온TD]팔랑크스,3178,111,4,3,7,57.1%,16m
3837,3,TonyStark,3178,0,0,1,1,0.0%,5m
3843,3,[4TIME4]BizzareCore,3177,309,14,9,23,60.9%,8m
3843,3,legend,3177,142,5,3,8,62.5%,6m
3843,2,검정색,3177,0,4,1,5,80.0%,18m
3843,3,Emptiness,3177,0,0,1,1,0.0%,2m
3847,3,王牌阿肥,3176,204,7,4,11,63.6%,43m
3847,3,Houkes,3176,169,7,10,17,41.2%,9m
3847,2,juice,3176,97,4,2,6,66.7%,17m
3847,3,[DagmBa]귀찮아,3176,0,1,0,1,100.0%,16m
3847,3,msw,3176,97,1,1,2,50.0%,44m
3847,3,Stress,3176,0,0,1,1,0.0%,3m
3853,2,[NGameS]불굴의특급전사,3175,638,23,26,49,46.9%,17m
3853,2,spiraled,3175,343,21,19,40,52.5%,6m
3853,1,omgitsduane,3175,145,6,3,9,66.7%,11m
3853,2,Stab,3175,62,2,6,8,25.0%,3m
3857,1,star,3174,1592,234,233,467,50.1%,18m
3857,3,유늬러브,3174,117,5,1,6,83.3%,8m
3857,2,마법의우엉,3174,154,4,5,9,44.4%,6m
3857,3,YUDI,3174,30,1,2,3,33.3%,2m
3861,2,rusinel,3173,345,15,11,26,57.7%,6m
3861,1,hayul,3173,251,10,10,20,50.0%,40m
3861,3,KIMSEO,3173,148,5,5,10,50.0%,5m
3861,3,아연,3173,30,2,0,2,100.0%,5m
3861,2,Juice,3173,95,2,3,5,40.0%,43m
3861,3,시뎌염,3173,0,0,1,1,0.0%,8m
3867,3,Stalker,3172,140,5,5,10,50.0%,5m
3867,3,Jlyoneygoodz,3172,0,1,1,2,50.0%,5m
3869,2,슈퍼맨짱짱,3171,1594,327,302,629,52.0%,6m
3869,2,llIIllIlIlII,3171,1005,210,188,398,52.8%,1m
3869,3,史上沒救爛,3171,319,12,5,17,70.6%,17m
3869,2,SatanKim,3171,210,9,7,16,56.2%,6m
3869,3,[Ximen]HuJintao,3171,0,0,1,1,0.0%,6m
3869,3,[없지요]IllIllllIllI,3171,0,0,1,1,0.0%,5m
3869,3,선비,3171,0,0,1,1,0.0%,16m
3869,3,[꼴받네]어서오고,3171,0,0,2,2,0.0%,2m
3877,3,amwayking,3170,1226,81,88,169,47.9%,2m
3877,2,Merona,3170,786,33,29,62,53.2%,17m
3877,3,MISSYCLUB,3170,525,21,13,34,61.8%,3m
3877,3,용갈지존,3170,148,6,6,12,50.0%,5m
3877,2,델람,3170,94,4,7,11,36.4%,1m
3877,2,채운,3170,0,1,2,3,33.3%,2m
3883,3,김호두,3169,1245,51,42,93,54.8%,3m
3883,2,초등학생아니에요,3169,276,10,10,20,50.0%,7m
3883,3,[LVO]KisCezyr,3169,30,2,1,3,66.7%,5m
3883,3,[RCK]熊貓戰士強化版,3169,0,0,1,1,0.0%,6m
3887,2,Hawawa,3168,1122,54,45,99,54.5%,6m
3887,2,가좌중훈남,3168,590,21,20,41,51.2%,6m
3887,2,[생존자]왕자,3168,394,14,13,27,51.9%,2m
3887,3,[해병대전우]응급실,3168,30,1,1,2,50.0%,2m
3887,3,strength,3168,0,0,1,1,0.0%,7m
3887,1,NIMIRUR,3168,0,0,2,2,0.0%,9m
3893,1,[한화]周星馳,3167,1321,182,175,357,51.0%,5m
3893,2,[VEVO]YUSEI,3167,594,98,76,174,56.3%,6m
3893,2,Bruse,3167,478,17,16,33,51.5%,1m
3893,3,Bisu,3167,0,0,1,1,0.0%,8m
3897,2,동백꽃필무렵,3166,293,12,8,20,60.0%,42m
3897,2,[POTG]DyuRan,3166,274,10,6,16,62.5%,2m
3897,3,VeryVeryUU,3166,135,7,4,11,63.6%,7m
3897,2,입영열차,3166,118,7,8,15,46.7%,2m
3897,2,IloveU,3166,60,3,6,9,33.3%,8m
3902,2,simba,3165,1156,54,48,102,52.9%,7m
3902,1,歇浩相備,3165,737,26,28,54,48.1%,17m
3902,1,[灭棒敢死队]抗韩奇侠燕又鹰,3165,0,1,1,2,50.0%,11m
3905,2,[DWG]Juter,3164,176,7,9,16,43.8%,7m
3905,3,법정대리인,3164,0,1,0,1,100.0%,16m
3905,3,[송골매]HACKoSpectre,3164,0,1,1,2,50.0%,9m
3908,2,JXXN,3163,1422,61,47,108,56.5%,8m
3908,2,[에고이스타]kaizen,3163,1509,61,56,117,52.1%,2m
3908,2,MithrandiR,3163,698,28,22,50,56.0%,4m
3908,2,Fiction,3163,520,20,20,40,50.0%,16m
3908,1,双葉愛,3163,432,19,18,37,51.4%,7m
3908,2,燕北飞,3163,337,16,12,28,57.1%,2m
3908,2,ZvezdaSevera,3163,0,4,2,6,66.7%,2m
3915,2,gang,3162,1175,204,186,390,52.3%,8m
3915,2,욤뜨,3162,1325,91,77,168,54.2%,7m
3915,3,Seven,3162,898,71,54,125,56.8%,6m
3915,2,starmagezine,3162,840,40,30,70,57.1%,2m
3915,2,주린피치,3162,48,2,0,2,100.0%,9m
3920,1,미친천호동,3161,1322,115,106,221,52.0%,5m
3920,2,Stacy,3161,489,20,12,32,62.5%,4m
3920,3,[Troupe]Notorius,3161,116,5,4,9,55.6%,3m
3923,2,[STSP]Strawberry,3160,668,26,22,48,54.2%,3m
3923,2,마재윤,3160,420,16,13,29,55.2%,7m
3923,3,자러감수고바위,3160,131,6,2,8,75.0%,2m
3923,1,IIIIIIIIIIII,3160,170,5,18,23,21.7%,17m
3927,2,Hitman,3159,1283,165,148,313,52.7%,2m
3927,2,gogo,3159,1542,146,131,277,52.7%,2m
3927,1,[NTW]DemonCaT,3159,1508,134,132,266,50.4%,7m
3927,1,빽다방원조커피짱,3159,910,36,40,76,47.4%,5m
3927,2,ijhijhijhijh,3159,385,15,11,26,57.7%,1m
3927,3,닉쿤,3159,0,3,2,5,60.0%,9m
3927,3,[VimeX]GrievousLady,3159,60,3,3,6,50.0%,2m
3927,2,EventHorizon,3159,0,1,2,3,33.3%,7m
3927,2,聖光守候,3159,88,1,3,4,25.0%,6m
3927,3,Clock,3159,0,0,1,1,0.0%,6m
3927,3,[或帝滅斗]Caelum,3159,0,0,2,2,0.0%,5m
3938,3,LEGOBOX,3158,1270,130,113,243,53.5%,9m
3938,3,SKTIBANKY,3158,446,16,15,31,51.6%,6m
3938,2,SAMclan,3158,390,15,19,34,44.1%,2m
3938,2,Computer,3158,62,2,6,8,25.0%,6m
3938,1,SloppySteven,3158,0,1,1,2,50.0%,10m
3943,2,신형창구,3157,711,62,52,114,54.4%,7m
3943,3,Redeemer,3157,312,28,24,52,53.8%,17m
3943,3,easybot,3157,228,8,8,16,50.0%,6m
3943,2,ming,3157,202,6,5,11,54.5%,7m
3943,2,Lelouch,3157,114,4,8,12,33.3%,17m
3943,3,woowa,3157,60,3,1,4,75.0%,7m
3943,3,THEGHOST,3157,60,2,2,4,50.0%,7m
3943,3,Deadlypants,3157,0,0,1,1,0.0%,9m
3951,1,TheChosenOne,3156,96,5,2,7,71.4%,10m
3952,3,꾸엑꾸,3155,118,4,3,7,57.1%,5m
3952,1,[DDLC]Sayori,3155,38,3,7,10,30.0%,8m
3952,2,KAISER,3155,30,1,8,9,11.1%,8m
3952,3,도라에로몽,3155,0,0,1,1,0.0%,9m
3956,2,Xin,3154,1455,85,72,157,54.1%,3m
3956,2,贏了才打居居,3154,447,18,18,36,50.0%,1m
3956,3,[海膽王]Slime,3154,195,8,7,15,53.3%,11m
3956,2,로우하잇,3154,60,4,6,10,40.0%,2m
3956,3,llllllllllll,3154,30,2,1,3,66.7%,5m
3956,3,예쁜척추,3154,0,2,3,5,40.0%,2m
3956,3,[짭페셜]젤나가의노예,3154,0,1,0,1,100.0%,3m
3963,3,[Aster]TripleS,3153,1542,78,76,154,50.6%,9m
3963,3,아로,3153,1136,53,31,84,63.1%,2m
3963,3,misery,3153,536,21,16,37,56.8%,17m
3966,2,[CIM]주먹,3152,242,8,14,22,36.4%,2m
3966,2,Maru,3152,48,5,2,7,71.4%,17m
3966,1,lKinglKazma,3152,169,5,6,11,45.5%,10m
3966,3,Kdestiny,3152,86,3,2,5,60.0%,3m
3966,3,광개토대장,3152,60,2,5,7,28.6%,8m
3966,3,이진형,3152,0,1,1,2,50.0%,5m
3966,3,Delete,3152,0,0,2,2,0.0%,7m
3973,3,llllllllllll,3151,542,23,11,34,67.6%,16m
3973,2,ETE,3151,120,8,5,13,61.5%,2m
3973,3,Theme,3151,0,1,1,2,50.0%,7m
3973,3,Jacy,3151,30,1,1,2,50.0%,5m
3973,3,[Notice]개굴딱지,3151,0,0,2,2,0.0%,5m
3978,2,[Slash]iii,3150,1545,186,183,369,50.4%,16m
3978,2,져켜켜,3150,1381,121,111,232,52.2%,7m
3978,2,[DagmBa]StarTale,3150,1010,46,32,78,59.0%,4m
3978,2,[efiL]Namuh,3150,986,44,31,75,58.7%,1m
3978,3,puerilesky,3150,302,10,6,16,62.5%,3m
3983,1,[消灭人族暴政]低熵体,3149,569,177,184,361,49.0%,18m
3983,3,bart,3149,323,15,10,25,60.0%,6m
3983,3,[승리하리라]전교일등,3149,58,3,3,6,50.0%,3m
3983,2,sss,3149,0,1,0,1,100.0%,17m
3983,3,ZetaRage,3149,30,1,1,2,50.0%,7m
3983,3,[제일잘생긴]한글,3149,30,1,2,3,33.3%,5m
3989,2,wdwdd,3148,1140,111,87,198,56.1%,1m
3989,3,Takishima,3148,558,23,13,36,63.9%,2m
3989,2,[Old]RealiSe,3148,368,13,19,32,40.6%,3m
3989,1,Quantum,3148,268,11,13,24,45.8%,41m
3989,3,MuMBle,3148,58,5,3,8,62.5%,9m
3989,1,쏘시크,3148,121,5,4,9,55.6%,39m
3989,2,딸기,3148,93,5,6,11,45.5%,3m
3989,3,쥐쥐요,3148,0,1,0,1,100.0%,5m
3989,3,JIN,3148,0,0,1,1,0.0%,5m
3989,3,[怕死的死神]Fucck,3148,0,0,3,3,0.0%,3m
3999,2,사자왕,3147,315,13,8,21,61.9%,42m
3999,2,Alizap,3147,204,7,11,18,38.9%,2m
3999,3,조셉필라모스,3147,202,6,8,14,42.9%,43m
4002,1,PonPig,3146,610,52,60,112,46.4%,18m
4002,2,Luddagi,3146,692,31,19,50,62.0%,2m
4002,2,[BigBro]SamMi,3146,451,23,16,39,59.0%,3m
4002,3,akikiki,3146,198,7,9,16,43.8%,3m
4002,3,[YEN]Yeonny,3146,114,5,2,7,71.4%,7m
4002,2,호호호,3146,144,5,10,15,33.3%,16m
4002,3,Jun,3146,88,3,4,7,42.9%,2m
4009,1,IIIIIIIIIIII,3145,498,16,23,39,41.0%,5m
4009,2,[Bliss]BARCODE,3145,312,12,12,24,50.0%,8m
4009,3,HunterKiller,3145,0,1,0,1,100.0%,6m
4009,3,Hoita,3145,0,1,0,1,100.0%,5m
4013,3,짜응,3144,116,5,1,6,83.3%,3m
4013,2,KraKen,3144,0,4,1,5,80.0%,18m
4013,3,HieuTran,3144,0,0,1,1,0.0%,9m
4016,1,MUYBIEN,3143,1541,307,300,607,50.6%,8m
4016,1,llllllllllll,3143,121,2,2,4,50.0%,11m
4016,3,glhf,3143,0,0,1,1,0.0%,8m
4019,3,BanCoalNow,3142,556,58,46,104,55.8%,9m
4019,3,[萬花筒寫輪眼]不悲不喜不晴不雨,3142,272,11,8,19,57.9%,3m
4019,3,那就爭霸,3142,98,4,2,6,66.7%,5m
4022,3,[패자는피를]깨알컨트롤,3141,1539,92,84,176,52.3%,5m
4022,2,partince,3141,1449,75,68,143,52.4%,6m
4022,3,GOYARD,3141,197,8,1,9,88.9%,5m
4022,3,[MC신동]슥가,3141,96,6,5,11,54.5%,7m
4022,3,[Abysm]한번봐줘,3141,114,5,2,7,71.4%,3m
4022,3,고기만두,3141,0,1,1,2,50.0%,6m
4022,2,[신출귀몰]sunPresso,3141,0,0,2,2,0.0%,3m
4029,2,멩크스,3140,1396,53,57,110,48.2%,17m
4029,3,skyRanson,3140,650,28,14,42,66.7%,6m
4029,3,Squirtle,3140,114,4,3,7,57.1%,3m
4029,3,RottenZerg,3140,86,3,3,6,50.0%,3m
4029,3,Multiply,3140,0,0,1,1,0.0%,3m
4034,2,알아서,3139,229,10,12,22,45.5%,17m
4034,3,[ELS]토르,3139,144,6,2,8,75.0%,9m
4034,2,서연이,3139,166,6,13,19,31.6%,17m
4034,3,[大招失敗秀]IIIIIIIIIIII,3139,58,3,0,3,100.0%,17m
4034,3,IIIIIIIIIIII,3139,30,2,2,4,50.0%,2m
4034,1,[한발이면]Siro,3139,97,1,2,3,33.3%,9m
4040,2,wilson,3138,503,19,18,37,51.4%,17m
4040,3,[NGameS]AiRes,3138,60,3,4,7,42.9%,8m
4040,3,[로마제국]이신형님,3138,0,1,0,1,100.0%,5m
4043,2,[디자이너스]도녀기,3137,678,86,86,172,50.0%,17m
4043,2,Synchronizer,3137,1169,80,69,149,53.7%,6m
4043,3,[무한오영종]blink,3137,1555,78,70,148,52.7%,8m
4043,3,教我玩好嗎,3137,318,16,10,26,61.5%,2m
4043,2,좀비장수후계자,3137,0,4,1,5,80.0%,17m
4043,3,vanz,3137,86,3,3,6,50.0%,8m
4043,3,teioh,3137,30,1,2,3,33.3%,17m
4050,2,구름달,3136,841,48,39,87,55.2%,3m
4051,1,[우유통]왕수박,3135,1442,241,303,544,44.3%,8m
4051,3,DrJin,3135,1589,134,123,257,52.1%,7m
4051,1,chokicoco,3135,840,34,30,64,53.1%,9m
4051,3,Apple,3135,389,31,18,49,63.3%,6m
4051,3,Alejandro,3135,197,9,5,14,64.3%,5m
4051,2,Dorna,3135,58,3,6,9,33.3%,16m
4057,2,[뚜뚜기여워]뚜뚜뚜,3134,574,50,42,92,54.3%,4m
4057,1,망겜잘해서뭐해,3134,1029,39,43,82,47.6%,7m
4057,3,시진핑의스타일기,3134,468,18,14,32,56.2%,6m
4057,3,[UH]llllllllllll,3134,443,17,9,26,65.4%,2m
4057,2,그림자용,3134,355,16,14,30,53.3%,1m
4057,2,LoveYouYL,3134,430,16,14,30,53.3%,9m
4057,3,jimreyner,3134,116,5,3,8,62.5%,9m
4057,3,단꽃,3134,0,1,4,5,20.0%,3m
4065,3,[lZONE]김민주,3133,1565,182,160,342,53.2%,5m
4065,2,[萬花筒寫輪眼]redgun,3133,505,22,22,44,50.0%,6m
4065,2,serg,3133,420,20,15,35,57.1%,2m
4065,2,Integral,3133,258,13,7,20,65.0%,2m
4065,3,지옥으로가,3133,232,8,10,18,44.4%,3m
4065,3,[Ramone]doors,3133,0,1,0,1,100.0%,2m
4065,3,llllllllllll,3133,0,1,0,1,100.0%,6m
4072,3,yayagrou,3132,355,45,37,82,54.9%,3m
4072,2,이게뭐라고,3132,726,34,27,61,55.7%,7m
4072,3,상대우위,3132,633,25,16,41,61.0%,8m
4072,3,똥개,3132,336,13,7,20,65.0%,7m
4072,3,IlIIlllIlIll,3132,30,2,3,5,40.0%,5m
4077,3,llBLASTERll,3131,458,21,14,35,60.0%,2m
4077,2,salitai,3131,0,4,2,6,66.7%,6m
4079,3,art,3130,1351,117,106,223,52.5%,6m
4079,3,뿍스,3130,387,21,13,34,61.8%,9m
4079,3,피자오빠,3130,30,2,4,6,33.3%,8m
4079,2,[SofT]지면서배울까,3130,0,0,2,2,0.0%,2m
4083,2,Apex,3129,505,51,41,92,55.4%,7m
4083,2,DaRkSoLo,3129,368,12,14,26,46.2%,17m
4083,3,뿌링클,3129,0,0,2,2,0.0%,8m
4086,2,니와까아메,3128,1184,75,72,147,51.0%,16m
4086,3,[韩湾土锤搬家]YueChuNexus,3128,326,12,13,25,48.0%,5m
4086,2,IntoTheRain,3128,125,8,11,19,42.1%,16m
4086,3,IIIIIIIII,3128,206,5,7,12,41.7%,12m
4086,3,으왕굳,3128,0,0,1,1,0.0%,7m
4091,3,설리,3127,618,90,74,164,54.9%,6m
4091,3,Extra,3127,1142,49,37,86,57.0%,2m
4091,2,비니,3127,922,43,30,73,58.9%,6m
4091,3,[Att]FelheartKing,3127,235,9,6,15,60.0%,43m
4091,2,llIllIlIlIlI,3127,246,9,13,22,40.9%,9m
4091,3,Ronny,3127,0,3,0,3,100.0%,8m
4091,3,나한국인,3127,58,3,1,4,75.0%,5m
4091,3,JeonMinChan,3127,88,3,7,10,30.0%,7m
4091,2,[BONK]플랑도르스칼렛,3127,30,1,4,5,20.0%,16m
4091,1,신이라불러라,3127,0,1,6,7,14.3%,11m
4101,3,[형님나가신다]SCZone,3126,1424,154,159,313,49.2%,6m
4101,2,안진마,3126,640,22,26,48,45.8%,7m
4101,3,寒風刺骨千年針,3126,276,18,15,33,54.5%,5m
4101,3,조르바,3126,238,9,9,18,50.0%,3m
4101,2,zzzzzz,3126,0,4,2,6,66.7%,7m
4106,2,ChronoCube,3125,1180,45,44,89,50.6%,6m
4106,3,Withfox,3125,479,18,9,27,66.7%,5m
4106,3,[isnous]백합로리,3125,180,7,7,14,50.0%,7m
4106,2,맹독은맹독맹독해,3125,205,6,7,13,46.2%,8m
4106,3,[Aster]빵귀,3125,0,1,0,1,100.0%,9m
4106,2,PHmarines,3125,0,1,0,1,100.0%,18m
4106,1,Impaler,3125,97,1,1,2,50.0%,39m
4106,3,일요일,3125,0,0,1,1,0.0%,3m
4114,1,Pique,3124,1535,127,133,260,48.8%,5m
4114,3,[최강기아]아리지플짱,3124,551,20,17,37,54.1%,8m
4114,2,흠이좋아,3124,515,20,22,42,47.6%,17m
4114,2,adorablechlo,3124,180,7,11,18,38.9%,16m
4114,1,큰누나,3124,221,6,5,11,54.5%,10m
4114,3,CHINANUMONE,3124,0,4,1,5,80.0%,3m
4114,2,PabloSunShyn,3124,0,4,2,6,66.7%,2m
4114,1,[마피아클렌]등짝좀보자,3124,0,1,0,1,100.0%,9m
4114,3,ktm,3124,0,0,1,1,0.0%,9m
4114,3,장균영,3124,0,0,1,1,0.0%,9m
4124,3,GreadShoot,3123,1591,194,174,368,52.7%,6m
4124,2,nakiller,3123,1506,104,102,206,50.5%,7m
4124,2,리페어,3123,710,27,30,57,47.4%,4m
4124,3,SunGet,3123,202,7,6,13,53.8%,17m
4124,3,[Runes]스운,3123,86,4,3,7,57.1%,5m
4124,3,추적자,3123,0,1,0,1,100.0%,3m
4124,3,[록타르오가르]부오오,3123,0,0,1,1,0.0%,9m
4131,3,CosMos,3122,406,17,6,23,73.9%,8m
4131,2,keganto,3122,271,14,10,24,58.3%,8m
4131,3,최고의테란,3122,172,6,6,12,50.0%,7m
4131,3,[으흥기무]드라군,3122,95,5,1,6,83.3%,2m
4131,3,IIIIIIIIIIII,3122,0,0,1,1,0.0%,9m
4131,3,xogus,3122,0,0,2,2,0.0%,3m
4137,2,[멍청한클랜장]전진병영개꿀,3121,798,38,29,67,56.7%,9m
4137,2,[最後生還者]紅羽,3121,410,35,25,60,58.3%,6m
4137,3,[Lotuz]내유닛은말안드뤄,3121,0,0,4,4,0.0%,9m
4140,2,OOXIXOO,3120,1419,120,116,236,50.8%,3m
4140,2,[서울외고]NovaLuna,3120,1517,82,81,163,50.3%,16m
4140,2,revolution,3120,900,30,41,71,42.3%,2m
4140,3,[아라짱]PsychoJpg,3120,271,12,7,19,63.2%,7m
4140,3,ptero,3120,194,6,5,11,54.5%,8m
4145,1,[b바리스타o]maposa,3119,1547,160,161,321,49.8%,8m
4145,1,noche,3119,1253,64,59,123,52.0%,5m
4145,2,CaCaan,3119,689,29,27,56,51.8%,6m
4145,2,NCNalRa,3119,337,14,11,25,56.0%,7m
4145,3,착한곰,3119,228,8,6,14,57.1%,5m
4145,3,차가운바람,3119,30,5,2,7,71.4%,16m
4145,3,[7준생]헤으응,3119,0,1,0,1,100.0%,6m
4145,3,[EBS]소새기,3119,0,1,0,1,100.0%,6m
4145,3,Lemuel,3119,0,0,1,1,0.0%,3m
4154,2,대박이달님이,3118,167,4,7,11,36.4%,6m
4154,3,MMM,3118,0,3,2,5,60.0%,8m
4154,3,유리유리,3118,60,3,3,6,50.0%,5m
4154,3,Creecy,3118,0,1,0,1,100.0%,3m
4158,2,앙빛삼,3117,655,65,53,118,55.1%,4m
4158,1,Thyge,3117,367,13,9,22,59.1%,41m
4158,3,aesthetics,3117,111,3,4,7,42.9%,5m
4158,3,[저바다에누워]大韓民國,3117,30,2,3,5,40.0%,7m
4158,3,[pepper]천공지뢰,3117,0,1,0,1,100.0%,6m
4163,3,ubiquitin,3116,1425,226,231,457,49.5%,6m
4163,2,mlkaruoIove,3116,1484,134,124,258,51.9%,17m
4163,2,GuiltySpark,3116,625,30,28,58,51.7%,3m
4163,3,[Clien]아스날,3116,369,14,8,22,63.6%,3m
4163,3,미친저그,3116,233,12,8,20,60.0%,17m
4163,2,나닼,3116,294,11,13,24,45.8%,7m
4163,3,[개빡고수]Jerry,3116,0,0,3,3,0.0%,3m
4163,2,양복일,3116,0,0,7,7,0.0%,2m
4171,3,Dovahkiin,3115,224,8,6,14,57.1%,11m
4171,2,llladaree,3115,204,7,8,15,46.7%,2m
4171,3,외계인,3115,90,3,5,8,37.5%,8m
4171,3,[바코드군단]llllll,3115,0,1,0,1,100.0%,5m
4171,3,리카르도,3115,30,1,2,3,33.3%,5m
4176,2,Zerg,3114,1327,133,124,257,51.8%,4m
4176,3,AFourIsm,3114,1140,43,41,84,51.2%,7m
4176,2,qTWp,3114,498,17,23,40,42.5%,4m
4176,2,CanCauser,3114,0,4,1,5,80.0%,9m
4176,3,이명재,3114,94,4,2,6,66.7%,2m
4176,3,Zizou,3114,58,3,6,9,33.3%,2m
4176,3,llllllllllll,3114,0,2,4,6,33.3%,5m
4183,2,박상연,3113,457,44,38,82,53.7%,6m
4183,2,不守禮,3113,212,14,7,21,66.7%,42m
4183,3,SupSprdrEvnt,3113,248,14,11,25,56.0%,7m
4183,3,[NGamE2]csomar,3113,116,4,6,10,40.0%,8m
4183,3,우비,3113,0,3,2,5,60.0%,3m
4188,2,Anger,3112,1437,74,57,131,56.5%,6m
4188,1,[오르피아]올피땅,3112,545,30,40,70,42.9%,7m
4188,3,[ELS]llllllllllll,3112,254,10,7,17,58.8%,5m
4191,3,[비트]탱탱탱탱,3111,558,49,40,89,55.1%,2m
4191,3,[Eire]KTStats,3111,458,22,14,36,61.1%,9m
4191,2,저글링,3111,167,9,7,16,56.2%,17m
4191,2,BrianWang,3111,256,9,10,19,47.4%,8m
4191,3,없어요,3111,0,1,0,1,100.0%,5m
4191,3,[Troupe]병아리,3111,0,0,1,1,0.0%,2m
4191,3,ask,3111,0,0,3,3,0.0%,9m
4198,1,soulmate,3110,1551,109,116,225,48.4%,9m
4198,3,[HcW]wjdwodus,3110,458,18,14,32,56.2%,9m
4198,2,Akassia,3110,0,5,0,5,100.0%,17m
4198,3,AceMatch,3110,0,0,1,1,0.0%,2m
4198,2,[GIS]青丞,3110,0,0,1,1,0.0%,18m
4203,1,게임의법칙,3109,1536,69,65,134,51.5%,5m
4203,2,IIIIIIIIIIII,3109,584,30,28,58,51.7%,2m
4203,2,테란시발,3109,670,25,26,51,49.0%,4m
4203,3,[CoCoA]ios,3109,408,15,12,27,55.6%,5m
4203,3,ImMotalVoid,3109,0,0,1,1,0.0%,3m
4208,3,Daniel,3108,432,18,7,25,72.0%,8m
4208,3,프안,3108,475,18,12,30,60.0%,6m
4208,3,[教我合作]Leafwillow,3108,0,0,1,1,0.0%,5m
4211,2,초씨,3107,788,41,38,79,51.9%,4m
4211,3,이승우,3107,324,12,11,23,52.2%,3m
4211,3,LovelyZerg,3107,210,6,2,8,75.0%,9m
4211,3,Siumo,3107,0,4,1,5,80.0%,8m
4211,3,[토가타]미리오,3107,133,2,5,7,28.6%,12m
4211,3,월진,3107,0,1,0,1,100.0%,5m
4211,3,[CHON]Djent,3107,0,1,0,1,100.0%,17m
4211,3,[海膽王]Tim,3107,30,1,2,3,33.3%,6m
4219,1,[MDC]Wanderlust,3106,1562,71,77,148,48.0%,5m
4219,2,[무능한일당들]몰랑찡,3106,380,35,37,72,48.6%,17m
4219,3,消滅,3106,185,14,12,26,53.8%,17m
4219,1,[하얀나비]제로,3106,305,10,15,25,40.0%,41m
4219,3,LGz,3106,86,4,2,6,66.7%,5m
4219,2,herOofAiur,3106,0,1,2,3,33.3%,3m
4225,2,니미,3105,458,17,20,37,45.9%,8m
4225,2,[어택땅]oPsLGDisplay,3105,327,15,22,37,40.5%,16m
4225,2,김뱡가,3105,151,5,15,20,25.0%,17m
4225,3,TooTo,3105,165,4,1,5,80.0%,5m
4225,3,오리굳,3105,0,4,1,5,80.0%,17m
4225,3,鯉雪比,3105,122,3,4,7,42.9%,11m
4225,3,JulzTheBulz,3105,0,1,0,1,100.0%,8m
4232,1,낮은자,3104,1406,198,186,384,51.6%,18m
4232,3,llllllllllll,3104,831,50,38,88,56.8%,6m
4232,3,llllllllllll,3104,424,15,9,24,62.5%,3m
4232,2,[Evil]SargasEvil,3104,62,3,8,11,27.3%,6m
4232,2,SIGMA,3104,0,1,0,1,100.0%,43m
4237,1,tears,3103,372,15,15,30,50.0%,4m
4237,1,eyah,3103,123,6,5,11,54.5%,41m
4237,3,jmf,3103,60,5,4,9,55.6%,6m
4240,2,PitchPine,3102,637,35,39,74,47.3%,6m
4240,3,Krystal,3102,58,3,1,4,75.0%,6m
4240,3,Levi,3102,0,3,2,5,60.0%,17m
4240,3,쇼타임,3102,30,1,1,2,50.0%,6m
4244,2,MstKeaton,3101,960,71,67,138,51.4%,17m
4244,2,[G20]이낙연,3101,756,34,27,61,55.7%,4m
4244,2,렉걸려라얍얍,3101,132,5,11,16,31.2%,42m
4244,3,[好想贏韓國]AKA,3101,0,0,2,2,0.0%,3m
4248,3,힐충전기,3100,316,27,24,51,52.9%,2m
4248,2,이케로,3100,424,16,20,36,44.4%,8m
4248,2,Concept,3100,155,5,7,12,41.7%,16m
4248,2,골뱅이따묵기,3100,130,3,9,12,25.0%,7m
4248,2,IBABE,3100,46,1,2,3,33.3%,9m
4248,3,라이븡,3100,0,0,1,1,0.0%,2m
4254,3,[트위치리피아]리피아,3099,1645,224,194,418,53.6%,3m
4254,2,Frank,3099,1539,203,169,372,54.6%,17m
4254,3,[KPG]funmaker,3099,433,15,18,33,45.5%,8m
4254,3,[메카]제우스,3099,58,3,2,5,60.0%,8m
4254,3,Tim,3099,0,1,0,1,100.0%,5m
4254,3,사도,3099,0,0,1,1,0.0%,9m
4254,3,IIIIIIIIIIII,3099,0,0,1,1,0.0%,9m
4261,3,신우주,3098,60,3,2,5,60.0%,3m
4261,3,Stork,3098,30,1,1,2,50.0%,5m
4261,3,[YCIM]TrAuMa,3098,0,0,1,1,0.0%,17m
4261,3,위로해줄게,3098,0,0,1,1,0.0%,3m
4265,3,[ConFed]superterran,3097,225,29,22,51,56.9%,5m
4265,3,Yolo,3097,178,8,7,15,53.3%,12m
4265,2,genuine,3097,0,5,0,5,100.0%,17m
4268,3,아둔의창,3096,646,24,24,48,50.0%,6m
4268,2,너거미땅거미지뢰,3096,463,21,20,41,51.2%,17m
4268,3,민주,3096,178,7,7,14,50.0%,9m
4268,2,lllIIlIIl,3096,92,4,13,17,23.5%,3m
4268,3,lllllllllll,3096,0,1,0,1,100.0%,2m
4273,2,Obito,3095,507,23,19,42,54.8%,4m
4273,3,김치보이,3095,404,17,11,28,60.7%,9m
4273,3,엘다조기,3095,60,5,4,9,55.6%,9m
4273,3,lIlIlIlIlIlI,3095,30,1,2,3,33.3%,3m
4277,2,설사해욤,3094,1468,158,150,308,51.3%,6m
4277,3,[잘먹고산다]목소리의형태,3094,148,6,7,13,46.2%,5m
4279,2,FioraRush,3093,379,18,14,32,56.2%,2m
4279,3,은해성,3093,280,11,7,18,61.1%,5m
4279,3,puttermaster,3093,207,7,1,8,87.5%,5m
4279,3,WolTuBE,3093,144,6,4,10,60.0%,5m
4279,3,[감자]강차장,3093,92,4,2,6,66.7%,5m
4279,3,Cosmos,3093,144,3,2,5,60.0%,9m
4279,2,老王,3093,88,2,3,5,40.0%,43m
4279,3,fifth,3093,0,0,1,1,0.0%,9m
4287,2,mstothetop,3092,457,41,40,81,50.6%,7m
4287,1,HsiehSF,3092,535,33,37,70,47.1%,17m
4287,3,cozy,3092,220,17,10,27,63.0%,8m
4287,3,uglas,3092,150,6,8,14,42.9%,5m
4287,1,Mii,3092,182,5,2,7,71.4%,11m
4287,3,DraGneeL,3092,121,5,3,8,62.5%,5m
4287,3,AwakinG,3092,0,3,2,5,60.0%,5m
4287,3,Printf,3092,0,0,1,1,0.0%,5m
4295,3,구겨이기,3091,1546,136,128,264,51.5%,5m
4295,2,스나이퍼,3091,1166,90,83,173,52.0%,7m
4295,2,최나얼,3091,584,20,28,48,41.7%,6m
4295,2,박상후,3091,0,1,1,2,50.0%,17m
4299,1,저글링,3090,1485,51,64,115,44.3%,8m
4299,3,Player,3090,694,31,24,55,56.4%,3m
4299,3,릉테,3090,418,19,13,32,59.4%,8m
4299,3,포도맛포카리,3090,0,3,3,6,50.0%,17m
4299,3,[열차강도]USA,3090,0,1,0,1,100.0%,5m
4299,3,[BigBan]Smlife,3090,0,1,1,2,50.0%,9m
4305,3,[반반이요]XelloS,3089,905,58,50,108,53.7%,17m
4305,3,마린,3089,997,42,37,79,53.2%,5m
4305,3,DoubleImpact,3089,726,34,20,54,63.0%,6m
4305,3,[RepOP]Chobolisk,3089,778,31,24,55,56.4%,17m
4305,1,유짱,3089,477,28,40,68,41.2%,8m
4305,3,IAMGROOT,3089,30,2,0,2,100.0%,3m
4305,3,repygo,3089,0,0,2,2,0.0%,6m
4312,3,오로성,3088,210,8,8,16,50.0%,7m
4312,2,스타초보,3088,92,4,9,13,30.8%,2m
4312,3,[Propet]Tempest,3088,0,3,1,4,75.0%,5m
4312,3,[댈람의영광]피닉스,3088,30,2,1,3,66.7%,17m
4312,3,[快樂玩家]檳榔叫出來,3088,30,1,1,2,50.0%,9m
4317,3,아이유,3087,168,5,4,9,55.6%,9m
4318,3,艾奧里亞,3086,1547,81,68,149,54.4%,2m
4318,2,fds,3086,785,54,51,105,51.4%,7m
4318,1,LinhSco,3086,143,7,3,10,70.0%,11m
4318,3,[CfC]Raventhon,3086,174,7,8,15,46.7%,7m
4318,2,Trainbike,3086,226,6,4,10,60.0%,42m
4318,3,[예쁜김다미]니뒤통수에한발,3086,0,0,1,1,0.0%,9m
4324,3,ARKSMI,3085,879,68,68,136,50.0%,3m
4324,3,帥暉,3085,258,9,13,22,40.9%,2m
4324,3,patrick,3085,93,5,1,6,83.3%,6m
4324,3,yooo,3085,58,3,1,4,75.0%,6m
4324,3,ClouDiNine,3085,0,0,1,1,0.0%,3m
4329,2,Tenggu,3084,938,65,66,131,49.6%,3m
4329,2,Ryan,3084,1261,52,44,96,54.2%,6m
4329,1,Balzahide,3084,36,5,4,9,55.6%,10m
4329,3,KaloS,3084,120,4,1,5,80.0%,17m
4329,1,DrainNestea,3084,151,3,6,9,33.3%,41m
4329,3,STONseen,3084,66,3,7,10,30.0%,12m
4329,3,[GITS]SirenK,3084,0,1,0,1,100.0%,43m
4329,3,작은상자,3084,0,0,1,1,0.0%,8m
4329,3,TshCHIA,3084,0,0,1,1,0.0%,6m
4338,3,쌍령동,3083,1536,74,93,167,44.3%,8m
4338,2,星空,3083,922,33,36,69,47.8%,6m
4338,3,minkirago,3083,732,27,26,53,50.9%,8m
4338,3,LINUX,3083,60,3,4,7,42.9%,5m
4338,3,[Koot]저못함,3083,30,2,0,2,100.0%,3m
4338,3,많은사람,3083,0,1,2,3,33.3%,8m
4338,3,Bafdee,3083,0,0,1,1,0.0%,6m
4338,3,llllllllllll,3083,0,0,3,3,0.0%,8m
4346,3,[KTC]허허허허,3082,140,5,5,10,50.0%,5m
4346,2,[RazerG]로프로프로,3082,126,5,11,16,31.2%,7m
4346,3,똥방구쏭다,3082,0,1,0,1,100.0%,7m
4346,3,OHvictory,3082,30,1,5,6,16.7%,7m
4346,3,ertyui,3082,0,0,1,1,0.0%,9m
4346,3,큰형님,3082,0,0,1,1,0.0%,5m
4346,3,[레지스탕스]제패,3082,0,0,2,2,0.0%,3m
4346,3,Revolution,3082,0,0,2,2,0.0%,7m
4346,3,goodgame,3082,0,0,5,5,0.0%,7m
4355,3,TYTY,3081,1056,86,64,150,57.3%,9m
4355,3,Beyou,3081,637,69,48,117,59.0%,8m
4355,3,[NsP]오타쿠,3081,676,25,27,52,48.1%,6m
4355,3,평화주의자,3081,146,5,9,14,35.7%,6m
4355,3,[끄앙벽터지네]아이스레몬,3081,30,1,3,4,25.0%,5m
4360,3,[Apus]ZeroTwo,3080,228,20,18,38,52.6%,8m
4360,3,CheckMate,3080,324,12,10,22,54.5%,9m
4360,2,DURUDURU,3080,0,3,3,6,50.0%,9m
4363,3,[내마음을받아]으뜸이,3079,1375,113,101,214,52.8%,17m
4363,2,Maserati,3079,1552,60,62,122,49.2%,17m
4363,3,달구비,3079,642,38,28,66,57.6%,7m
4363,3,조지아커피의쓴맛,3079,142,5,8,13,38.5%,7m
4363,3,Immortality,3079,30,3,3,6,50.0%,9m
4368,2,현티선생,3078,224,12,8,20,60.0%,7m
4368,3,뻑이가네,3078,288,11,7,18,61.1%,9m
4368,3,르브론제임스,3078,236,9,7,16,56.2%,5m
4368,3,Dddd,3078,0,3,2,5,60.0%,5m
4368,3,DDOS,3078,0,1,0,1,100.0%,5m
4368,3,RaegoN,3078,0,1,2,3,33.3%,8m
4374,3,jayZ,3077,1579,297,283,580,51.2%,5m
4374,2,[클랜같은클랜]danchia,3077,696,23,32,55,41.8%,3m
4374,3,선정성,3077,92,5,1,6,83.3%,17m
4374,3,[只會喝可樂]教我玩蟲族可樂,3077,161,5,1,6,83.3%,12m
4378,3,combative,3076,1023,40,37,77,51.9%,8m
4378,3,aaaaaaaaaaaa,3076,314,14,13,27,51.9%,8m
4378,1,varrucca,3076,305,9,8,17,52.9%,11m
4378,3,전직욕교사,3076,154,6,8,14,42.9%,6m
4378,3,lsy,3076,0,0,1,1,0.0%,9m
4383,3,이글혼,3075,1425,136,127,263,51.7%,8m
4383,3,[하얀나비]오블리비언,3075,223,8,8,16,50.0%,9m
4383,2,NHIHI,3075,0,4,1,5,80.0%,18m
4383,3,[서울의달]kimseonho,3075,92,4,8,12,33.3%,9m
4383,3,베네딕트,3075,60,2,6,8,25.0%,2m
4388,2,MuseRilla,3074,757,46,48,94,48.9%,17m
4388,3,꼬발이,3074,998,43,32,75,57.3%,17m
4388,2,[캬루]AschbrownYO,3074,189,42,42,84,50.0%,16m
4388,3,니싹수,3074,0,1,1,2,50.0%,5m
4388,3,이화유치원,3074,0,0,1,1,0.0%,2m
4393,3,[닭장]spacial,3073,219,13,17,30,43.3%,6m
4393,3,[백석예대]OBeLisk,3073,157,7,7,14,50.0%,44m
4393,3,샹그리젤,3073,168,5,2,7,71.4%,9m
4393,3,MareNostrum,3073,58,3,3,6,50.0%,7m
4393,3,[林以楨超胖]panvincent,3073,0,1,0,1,100.0%,5m
4393,3,달걀,3073,0,0,2,2,0.0%,44m
4399,3,Vayneeeeeeee,3072,239,7,6,13,53.8%,43m
4399,3,심심해서스타세판,3072,187,6,1,7,85.7%,9m
4399,2,ByTheWay,3072,0,4,3,7,57.1%,18m
4399,1,헐랭방구,3072,97,3,5,8,37.5%,42m
4399,1,[6NBK9]allwulong,3072,46,1,6,7,14.3%,11m
4399,3,kwg,3072,0,0,1,1,0.0%,5m
4405,2,IIIIIIIIIIII,3071,1529,145,136,281,51.6%,7m
4405,1,SKungK,3071,1132,82,88,170,48.2%,8m
4405,1,HSTang,3071,996,32,46,78,41.0%,7m
4405,3,foskill,3071,90,4,2,6,66.7%,7m
4405,3,ROOM,3071,92,4,6,10,40.0%,7m
4405,3,[순수]꼬냥이,3071,137,3,2,5,60.0%,6m
4405,3,With,3071,0,1,0,1,100.0%,3m
4405,3,ringskings,3071,0,1,0,1,100.0%,7m
4405,3,pph,3071,0,1,1,2,50.0%,8m
4414,2,마린,3070,1444,99,108,207,47.8%,7m
4414,3,道可道,3070,1238,82,62,144,56.9%,7m
4414,2,Luras,3070,125,6,4,10,60.0%,17m
4414,3,돌아온곰돌,3070,86,3,3,6,50.0%,8m
4414,3,BlueRose,3070,30,2,3,5,40.0%,17m
4414,2,白澤,3070,0,0,1,1,0.0%,43m
4414,3,군필여고생,3070,0,0,1,1,0.0%,7m
4421,3,Commander,3069,266,9,15,24,37.5%,7m
4421,3,[Spades]무등산,3069,178,7,6,13,53.8%,2m
4421,2,운영넘어렵다,3069,160,6,2,8,75.0%,18m
4421,3,[흡혈귀]유라시아,3069,159,4,2,6,66.7%,17m
4421,3,추적자,3069,0,0,2,2,0.0%,2m
4421,3,TOP,3069,0,0,2,2,0.0%,9m
4427,2,Abra,3068,1316,191,195,386,49.5%,17m
4427,2,Klone,3068,0,1,0,1,100.0%,18m
4429,2,곽부성,3067,1517,153,142,295,51.9%,7m
4429,3,구르는천둥,3067,1320,90,86,176,51.1%,6m
4429,2,IlIllllIIIIl,3067,672,34,46,80,42.5%,17m
4429,1,buru,3067,291,10,6,16,62.5%,19m
4429,3,Evolution,3067,30,1,1,2,50.0%,5m
4429,3,KingOfTheSta,3067,0,0,1,1,0.0%,3m
4435,2,banban,3066,1463,119,118,237,50.2%,8m
4435,3,Maru,3066,88,4,6,10,40.0%,5m
4435,3,Byun,3066,100,4,7,11,36.4%,7m
4435,3,CrazyFrog,3066,0,0,1,1,0.0%,3m
4435,3,Hanson,3066,0,0,1,1,0.0%,5m
4440,3,history,3065,490,23,15,38,60.5%,7m
4440,1,DeadMan,3065,233,8,6,14,57.1%,10m
4440,2,lIIIlllIIll,3065,0,4,3,7,57.1%,2m
4440,3,[스텔라]강아지,3065,0,1,1,2,50.0%,9m
4440,3,[유파뤼]쌍화반,3065,0,1,4,5,20.0%,3m
4440,3,프로덕,3065,0,0,2,2,0.0%,17m
4446,3,[Nemian]SUPREMEC,3064,1517,393,369,762,51.6%,6m
4446,2,lovesleep,3064,1443,56,60,116,48.3%,7m
4446,1,마시멜롱,3064,1135,38,52,90,42.2%,18m
4446,2,[평범]초코에몽,3064,0,0,2,2,0.0%,9m
4450,3,THOR,3063,1360,152,137,289,52.6%,5m
4450,2,올킬게이머,3063,714,30,28,58,51.7%,8m
4450,3,兔耳猴猴,3063,550,19,18,37,51.4%,7m
4450,2,[이또한무스비]순대파워,3063,274,9,19,28,32.1%,7m
4450,3,숭태,3063,0,0,1,1,0.0%,9m
4455,3,Gordon,3062,380,13,14,27,48.1%,17m
4455,3,콩아저씨,3062,272,10,11,21,47.6%,7m
4455,3,고기포격기,3062,188,5,4,9,55.6%,3m
4458,3,[WDY]디제이토리,3061,1079,47,39,86,54.7%,9m
4458,3,lllllllllll,3061,839,34,33,67,50.7%,9m
4458,1,XingLH,3061,470,19,20,39,48.7%,5m
4458,3,쫄리,3061,97,2,2,4,50.0%,43m
4458,3,lionmode,3061,30,2,3,5,40.0%,5m
4458,3,DyrakChoLi,3061,0,1,0,1,100.0%,12m
4464,3,magicprotoss,3060,979,41,39,80,51.2%,8m
4464,3,[형님나가신다]vostro,3060,486,20,26,46,43.5%,17m
4464,3,Killer,3060,90,6,6,12,50.0%,6m
4464,3,Space,3060,93,4,2,6,66.7%,6m
4464,3,슈퍼스타,3060,0,1,1,2,50.0%,6m
4464,3,Nori,3060,0,1,4,5,20.0%,2m
4470,3,색종이친다,3059,0,0,2,2,0.0%,3m
4471,3,Rush,3058,455,17,13,30,56.7%,5m
4471,1,WannaStats,3058,211,10,11,21,47.6%,41m
4471,3,완소남,3058,203,7,4,11,63.6%,6m
4471,1,IIIIIIIIIIII,3058,133,7,7,14,50.0%,5m
4471,3,Piao,3058,157,5,0,5,100.0%,9m
4471,3,Uberrific,3058,166,5,2,7,71.4%,8m
4471,1,BlueLabel,3058,0,0,9,9,0.0%,7m
4478,3,arrayofpten,3057,319,19,8,27,70.4%,7m
4478,3,Regz,3057,60,6,3,9,66.7%,5m
4478,3,식이당,3057,162,4,4,8,50.0%,3m
4478,3,[tossed]OILBOOM,3057,86,4,4,8,50.0%,7m
4478,3,[AntiNs]呱呱,3057,0,3,2,5,60.0%,5m
4478,3,[SofT]지혜유,3057,0,0,4,4,0.0%,8m
4484,2,ANS,3056,1407,73,62,135,54.1%,17m
4484,2,KuWeLiau,3056,904,37,33,70,52.9%,8m
4484,3,llIlllllllII,3056,561,24,19,43,55.8%,8m
4484,3,Takao,3056,513,21,20,41,51.2%,7m
4484,3,Dao,3056,227,10,1,11,90.9%,2m
4484,2,[TheDOH]PrinceJared,3056,141,5,3,8,62.5%,18m
4484,3,Clarity,3056,91,4,2,6,66.7%,3m
4484,3,[시럽]핑크버블,3056,136,3,1,4,75.0%,3m
4484,3,[SaNa2]Vortex,3056,0,0,1,1,0.0%,2m
4493,3,정영훈,3055,1539,248,231,479,51.8%,3m
4493,3,[Youth]Strange,3055,999,40,29,69,58.0%,6m
4493,3,Gerxian,3055,671,32,16,48,66.7%,3m
4493,1,레볼루션,3055,326,10,7,17,58.8%,10m
4493,3,[RAID]강승부현이,3055,188,6,3,9,66.7%,8m
4493,3,[ProTT]kakarrot,3055,0,4,1,5,80.0%,3m
4493,3,장그래,3055,93,4,2,6,66.7%,17m
4493,2,Fate,3055,0,3,3,6,50.0%,17m
4501,2,희웅이에요,3054,181,8,3,11,72.7%,17m
4501,1,Quake,3054,163,5,1,6,83.3%,9m
4501,3,과일은딸기,3054,187,5,5,10,50.0%,17m
4501,3,Acalibs,3054,155,4,3,7,57.1%,5m
4501,3,Classic,3054,132,3,2,5,60.0%,8m
4501,2,모게이기러옴,3054,96,1,1,2,50.0%,9m
4501,3,Radiant,3054,0,0,6,6,0.0%,2m
4508,2,슈퍼맨,3053,1517,209,207,416,50.2%,2m
4508,3,프로유인선,3053,1320,67,52,119,56.3%,8m
4508,3,라디드,3053,1308,60,47,107,56.1%,17m
4508,3,Lufs,3053,554,24,16,40,60.0%,5m
4508,3,RaZoR,3053,414,15,16,31,48.4%,9m
4508,3,내목숨을자치령에,3053,103,3,4,7,42.9%,5m
4508,3,보원이덕,3053,0,0,4,4,0.0%,9m
4515,3,레전드,3052,406,22,21,43,51.2%,7m
4515,3,축구왕숏다리,3052,392,14,18,32,43.8%,8m
4515,3,[Rovic]태양,3052,167,7,4,11,63.6%,17m
4515,3,라파엘,3052,58,3,2,5,60.0%,7m
4515,3,흔들리며피는꽃,3052,30,2,2,4,50.0%,9m
4515,3,레베카밍코프,3052,0,0,1,1,0.0%,9m
4515,3,멩스크,3052,0,0,2,2,0.0%,17m
4515,1,XelNaga,3052,0,0,2,2,0.0%,9m
4523,3,[일반인원탑]Zero,3051,442,36,17,53,67.9%,9m
4523,3,카친스키,3051,520,22,14,36,61.1%,17m
4523,3,ADmaster,3051,58,3,8,11,27.3%,6m
4523,3,米普,3051,30,2,4,6,33.3%,7m
4523,3,[LQV]백두산백호,3051,60,2,6,8,25.0%,9m
4523,3,으헝헝,3051,0,0,1,1,0.0%,6m
4529,3,Endless,3050,642,26,24,50,52.0%,9m
4529,3,Luceinaltis,3050,510,20,14,34,58.8%,7m
4529,3,zxfc,3050,223,8,4,12,66.7%,9m
4529,3,UFO,3050,136,4,0,4,100.0%,17m
4529,1,asd,3050,155,4,7,11,36.4%,10m
4534,1,sfdfhdfhdfhf,3049,1514,488,471,959,50.9%,7m
4534,3,[클랜같은클랜]변현우,3049,546,20,25,45,44.4%,6m
4534,3,[伊蕾娜]llllllllllll,3049,243,11,0,11,100.0%,9m
4534,3,스창인생,3049,234,8,10,18,44.4%,8m
4534,2,복우리,3049,118,5,3,8,62.5%,17m
4534,3,King,3049,96,2,1,3,66.7%,9m
4540,2,아르타니스,3048,1487,138,135,273,50.5%,8m
4540,2,[TalenT]STALKER,3048,1435,105,84,189,55.6%,2m
4540,3,llllllllllll,3048,488,95,71,166,57.2%,5m
4540,3,oGre,3048,318,13,16,29,44.8%,3m
4540,3,KEYSTONE,3048,182,9,0,9,100.0%,3m
4540,3,Boom,3048,92,4,6,10,40.0%,6m
4540,3,[MN77]WaterTreeNA,3048,0,1,0,1,100.0%,5m
4540,3,llllllllllll,3048,0,1,2,3,33.3%,9m
4548,3,대한민국,3047,580,26,14,40,65.0%,9m
4548,2,Departure,3047,584,21,31,52,40.4%,9m
4548,3,[NTUeS]KiRin,3047,328,11,15,26,42.3%,8m
4548,3,flawless,3047,206,9,5,14,64.3%,9m
4548,2,KOopa,3047,0,4,3,7,57.1%,2m
4548,3,KoshNaranek,3047,0,0,2,2,0.0%,3m
4554,3,[1408]夏娜,3046,248,11,8,19,57.9%,9m
4554,3,Rilis,3046,164,5,2,7,71.4%,8m
4554,2,에리리,3046,139,5,4,9,55.6%,18m
4554,3,hatechina,3046,124,3,3,6,50.0%,17m
4554,3,神之子,3046,30,2,2,4,50.0%,6m
4559,2,XXXTENTACION,3045,1139,43,43,86,50.0%,6m
4559,3,[순수]샥스핀,3045,421,18,17,35,51.4%,5m
4559,3,AsIFYourLasT,3045,262,10,4,14,71.4%,2m
4559,3,KARAKURT,3045,217,7,8,15,46.7%,9m
4559,3,말상민,3045,60,2,4,6,33.3%,3m
4559,3,[스코델라리오]Dadakung,3045,0,0,4,4,0.0%,12m
4565,2,BBP,3044,1496,354,338,692,51.2%,6m
4565,3,맹공,3044,779,117,99,216,54.2%,6m
4565,3,[GIS]GreyHaTech,3044,1414,54,54,108,50.0%,2m
4565,3,알파몽,3044,781,51,27,78,65.4%,7m
4565,3,旯牙,3044,964,48,44,92,52.2%,2m
4565,3,[삼성동]너구리,3044,1119,46,40,86,53.5%,3m
4565,3,안산천재,3044,685,36,25,61,59.0%,7m
4565,3,전쟁사나이,3044,90,6,6,12,50.0%,7m
4565,3,Kap,3044,0,0,1,1,0.0%,9m
4574,3,Jusjerok,3043,1489,110,90,200,55.0%,9m
4574,3,crescent,3043,984,85,79,164,51.8%,8m
4574,3,lutarez,3043,1005,47,35,82,57.3%,9m
4574,2,[EmPeRo]VoidRay,3043,844,33,36,69,47.8%,7m
4574,3,장미,3043,723,32,20,52,61.5%,6m
4579,2,kirbm,3042,1514,139,132,271,51.3%,2m
4579,3,NightRaven,3042,549,40,20,60,66.7%,5m
4579,3,SeerKen,3042,665,32,17,49,65.3%,2m
4579,3,IIIIIIIIIIII,3042,390,17,13,30,56.7%,2m
4579,3,ZeroNoShogun,3042,119,7,3,10,70.0%,2m
4579,3,Aquarius,3042,177,6,1,7,85.7%,9m
4579,3,llIllllIlIll,3042,64,3,9,12,25.0%,6m
4579,3,blackPeace,3042,95,2,0,2,100.0%,17m
4579,3,wei,3042,0,1,2,3,33.3%,3m
4588,3,스타접은지오래다,3041,414,16,16,32,50.0%,3m
4588,3,[海膽王]羅伯雷斯高敦校長,3041,93,13,6,19,68.4%,7m
4588,3,[SofT]차원공돌이,3041,231,9,4,13,69.2%,5m
4588,3,[CIM]럭쪄뤼보이,3041,0,3,2,5,60.0%,6m
4588,3,[kana]Nalru,3041,92,1,1,2,50.0%,7m
4588,3,[TMAbly]永恆之心,3041,0,0,1,1,0.0%,6m
4594,2,seaphonix,3040,1290,86,86,172,50.0%,7m
4594,3,IIIIIIIIIIII,3040,1483,59,54,113,52.2%,7m
4594,2,용용이,3040,779,54,55,109,49.5%,4m
4594,3,오버워치,3040,646,24,21,45,53.3%,8m
4594,3,쓰레기종족,3040,335,15,10,25,60.0%,6m
4594,3,Timatree,3040,159,8,5,13,61.5%,6m
4594,3,패배하기,3040,152,4,3,7,57.1%,8m
4594,2,SCwinter,3040,48,3,5,8,37.5%,18m
4594,1,kjw,3040,0,1,2,3,33.3%,39m
4603,1,박봉,3039,1533,247,262,509,48.5%,7m
4603,3,viewty,3039,805,37,29,66,56.1%,2m
4603,3,jhs,3039,744,28,29,57,49.1%,6m
4603,3,pitaggi,3039,479,18,17,35,51.4%,5m
4603,2,꼬라바가,3039,229,7,12,19,36.8%,6m
4603,3,TheProcess,3039,60,2,7,9,22.2%,2m
4609,2,Macko,3038,1506,185,181,366,50.5%,17m
4609,3,Flophead,3038,647,24,21,45,53.3%,17m
4609,3,[NANT]TerraNova,3038,253,19,10,29,65.5%,9m
4609,3,백상아리,3038,367,16,13,29,55.2%,3m
4609,3,슈퍼히어로,3038,215,7,4,11,63.6%,6m
4609,3,반다스틱,3038,86,3,4,7,42.9%,7m
4609,3,모퉁이돌,3038,30,2,1,3,66.7%,17m
4609,2,까까퐁,3038,30,1,8,9,11.1%,2m
4609,3,시화강실장,3038,0,0,2,2,0.0%,6m
4618,2,[비트]llllllllllll,3037,853,36,40,76,47.4%,8m
4618,3,Choi,3037,471,27,18,45,60.0%,9m
4618,3,경이이삐공주,3037,362,15,9,24,62.5%,5m
4618,2,[FSTM]FireStar,3037,270,12,10,22,54.5%,4m
4618,1,행복해여난,3037,141,5,5,10,50.0%,19m
4618,2,Hardstem,3037,130,4,3,7,57.1%,8m
4618,1,깡낑꽁,3037,0,0,1,1,0.0%,41m
4625,1,SolidState,3036,1528,349,329,678,51.5%,8m
4625,1,김가문남매,3036,1080,43,29,72,59.7%,39m
4625,3,[경기도양주]Deadpool,3036,613,34,28,62,54.8%,6m
4625,3,bing,3036,119,3,1,4,75.0%,6m
4625,1,Ace,3036,0,3,2,5,60.0%,41m
4625,1,llllllllllll,3036,138,3,4,7,42.9%,42m
4625,2,Finalvalkyri,3036,0,1,0,1,100.0%,17m
4625,3,Brakden,3036,30,1,4,5,20.0%,3m
4633,3,[공허거주]SONG,3035,931,42,22,64,65.6%,9m
4633,3,ChiKO,3035,954,36,37,73,49.3%,5m
4633,3,풍풍전사,3035,547,22,20,42,52.4%,6m
4633,1,BBB,3035,415,15,5,20,75.0%,40m
4633,3,똘액,3035,234,9,10,19,47.4%,6m
4633,3,phm,3035,118,2,3,5,40.0%,17m
4633,3,[Bully]까씨꼬끼,3035,0,1,1,2,50.0%,3m
4633,1,빵상,3035,0,0,1,1,0.0%,10m
4633,1,부쉬대통령,3035,0,0,1,1,0.0%,41m
4642,3,[GIS]吹吹的捏捏,3034,854,35,31,66,53.0%,8m
4642,2,Aeek,3034,326,14,13,27,51.9%,2m
4642,1,이백십육기해병,3034,229,5,1,6,83.3%,41m
4642,3,Leewltn,3034,116,5,6,11,45.5%,5m
4642,3,[SofT]ainch,3034,158,5,11,16,31.2%,5m
4647,2,keyword,3033,1639,466,450,916,50.9%,2m
4647,3,DASDS,3033,735,33,21,54,61.1%,9m
4647,3,ICE,3033,60,2,7,9,22.2%,8m
4650,3,llllllllll,3032,1593,772,795,1567,49.3%,3m
4650,2,[카봇]Joon,3032,1482,70,70,140,50.0%,2m
4650,3,Moni,3032,1277,56,46,102,54.9%,7m
4650,2,집이짱이다,3032,1164,48,50,98,49.0%,8m
4650,3,Son,3032,211,7,3,10,70.0%,9m
4650,3,Beetlesmuglr,3032,147,6,5,11,54.5%,2m
4650,3,SuBaru,3032,0,1,0,1,100.0%,44m
4657,2,방송쿠폰,3031,297,13,9,22,59.1%,43m
4657,3,북진정,3031,300,10,16,26,38.5%,7m
4657,1,성범죄자가될래,3031,91,4,2,6,66.7%,40m
4657,1,ToRi,3031,0,0,1,1,0.0%,42m
4657,3,zeusjr,3031,0,0,3,3,0.0%,9m
4662,2,Duncan,3030,978,104,105,209,49.8%,6m
4662,2,XianRenBBan,3030,1384,53,54,107,49.5%,6m
4662,2,銀色羽翼,3030,414,24,31,55,43.6%,4m
4662,3,루트커즈,3030,636,22,22,44,50.0%,6m
4662,3,IPOS,3030,317,11,13,24,45.8%,3m
4662,2,제라툴,3030,227,8,4,12,66.7%,9m
4662,3,Death,3030,191,8,7,15,53.3%,17m
4662,1,pimadoka,3030,138,6,3,9,66.7%,40m
4662,3,조씨,3030,142,5,9,14,35.7%,6m
4662,1,TyCimU,3030,143,4,4,8,50.0%,39m
4662,1,seoksmile,3030,0,3,2,5,60.0%,39m
4662,1,櫧騔湸,3030,38,1,2,3,33.3%,41m
4674,1,RAIDERS,3029,1701,229,203,432,53.0%,39m
4674,3,GONI,3029,1555,141,130,271,52.0%,5m
4674,3,[SeA]LinG,3029,376,14,15,29,48.3%,5m
4674,3,갓인규,3029,397,13,14,27,48.1%,8m
4674,3,[chak]PokerFace,3029,266,9,7,16,56.2%,7m
4674,3,자이로드지마,3029,228,6,6,12,50.0%,5m
4674,3,[제리뚝배기]ThanaTus,3029,30,1,3,4,25.0%,9m
4674,1,Yalos,3029,0,1,4,5,20.0%,40m
4682,3,[공대지]해처리,3028,727,37,28,65,56.9%,3m
4682,2,Kreyd,3028,802,27,34,61,44.3%,2m
4682,3,IVEN,3028,308,13,11,24,54.2%,9m
4682,1,카레우동,3028,0,1,0,1,100.0%,40m
4682,1,瘋狂假面,3028,0,1,0,1,100.0%,41m
4682,1,박가온,3028,0,0,1,1,0.0%,41m
4682,1,llllllllllll,3028,0,0,1,1,0.0%,41m
4689,3,Artanis,3027,496,19,18,37,51.4%,6m
4689,3,이동골,3027,381,13,15,28,46.4%,7m
4689,3,[Giwawa]IIIIIIIIIIII,3027,198,8,2,10,80.0%,3m
4689,1,Happyperson,3027,0,3,2,5,60.0%,42m
4689,1,Mighty,3027,0,3,2,5,60.0%,41m
4689,3,울쭈폰가게,3027,60,2,7,9,22.2%,12m
4689,3,林漫雪,3027,0,1,0,1,100.0%,16m
4689,1,[미사일뿌수기]ara,3027,0,0,1,1,0.0%,41m
4689,1,EvryNomE,3027,0,0,1,1,0.0%,11m
4698,1,[닭장]버거킹가지말자,3026,452,16,6,22,72.7%,41m
4698,3,독도,3026,258,11,3,14,78.6%,2m
4698,3,[암기]파일럿,3026,322,11,17,28,39.3%,3m
4698,3,bootykong,3026,0,3,2,5,60.0%,16m
4702,3,deyt,3025,924,53,33,86,61.6%,5m
4702,3,벨리,3025,259,9,10,19,47.4%,17m
4702,3,전설의뽀야,3025,148,8,10,18,44.4%,6m
4702,1,[랜타디매니아]으헝헝,3025,40,2,4,6,33.3%,41m
4702,1,늑정,3025,42,1,1,2,50.0%,41m
4707,3,초보탈출하고싶다,3024,965,47,40,87,54.0%,8m
4707,3,llllllllll,3024,134,14,7,21,66.7%,6m
4707,3,storm,3024,133,4,1,5,80.0%,2m
4707,1,[실력의기원]뿡이빵이,3024,66,3,1,4,75.0%,41m
4707,3,鱼塘塘主,3024,0,3,2,5,60.0%,17m
4707,1,NaGaSumi,3024,46,1,2,3,33.3%,41m
4707,3,스트라스블룸,3024,0,1,4,5,20.0%,17m
4707,3,감귤초보,3024,30,1,4,5,20.0%,5m
4707,1,아부해집사,3024,0,0,1,1,0.0%,41m
4707,1,[SPTS]UmeMasterFu,3024,0,0,1,1,0.0%,42m
4717,3,Temo,3023,1231,50,46,96,52.1%,6m
4717,1,alexynui,3023,558,42,33,75,56.0%,41m
4717,2,[DagmBa]아레스,3023,930,39,36,75,52.0%,8m
4717,2,[축구의전설]국민연료,3023,822,27,35,62,43.5%,17m
4717,3,[Mist]냐냐냐,3023,306,13,8,21,61.9%,3m
4717,3,혁제짬냄새,3023,351,13,9,22,59.1%,2m
4717,3,[초보양해부탁]mechanic,3023,95,8,7,15,53.3%,43m
4717,3,sulfur,3023,30,5,2,7,71.4%,3m
4717,2,눌홀릭,3023,60,2,17,19,10.5%,17m
4717,1,IIIIIIIIIIII,3023,0,1,0,1,100.0%,41m
4717,3,마두,3023,0,0,2,2,0.0%,3m
4728,3,Manos,3022,675,41,32,73,56.2%,9m
4728,1,[코코갈비]Snack,3022,165,6,4,10,60.0%,39m
4728,3,NucL,3022,88,4,7,11,36.4%,8m
4728,1,[少女前線]阿里雞,3022,0,1,0,1,100.0%,41m
4732,1,onetable,3021,1526,201,206,407,49.4%,9m
4732,3,[SKTTII]EuPhoRia,3021,1246,54,42,96,56.2%,6m
4732,3,당연아니,3021,139,4,2,6,66.7%,8m
4732,3,llllllllllll,3021,0,3,2,5,60.0%,16m
4732,1,[Insane]후추,3021,0,1,0,1,100.0%,40m
4732,1,checkmate,3021,0,1,0,1,100.0%,40m
4732,1,동네형님,3021,0,1,1,2,50.0%,40m
4732,1,비밀,3021,42,1,2,3,33.3%,41m
4732,3,[ELS]김민주,3021,30,1,6,7,14.3%,6m
4741,3,[GPs]GPsRain,3020,1373,159,149,308,51.6%,2m
4741,1,king,3020,1671,88,80,168,52.4%,40m
4741,3,대두머신,3020,122,5,12,17,29.4%,7m
4741,3,Mellow,3020,30,3,5,8,37.5%,2m
4741,3,epicvoid,3020,113,2,2,4,50.0%,9m
4741,1,Nicellllllll,3020,0,2,3,5,40.0%,39m
4747,3,Llama,3019,1574,123,104,227,54.2%,2m
4747,3,동네형아,3019,239,16,15,31,51.6%,5m
4747,3,[aFake]Maru,3019,62,3,6,9,33.3%,3m
4747,3,[시한부]운비,3019,0,1,1,2,50.0%,2m
4747,1,오홍조,3019,44,1,2,3,33.3%,40m
4747,3,[NsP]KELLAN,3019,0,1,4,5,20.0%,2m
4753,3,CHANEL,3018,1213,208,196,404,51.5%,5m
4753,3,葉業夜燁,3018,342,51,49,100,51.0%,6m
4753,1,[OnePeS]MooN,3018,498,15,14,29,51.7%,42m
4753,1,팡치,3018,242,13,11,24,54.2%,3m
4753,3,[스타리나잇]KBeSing,3018,62,3,7,10,30.0%,9m
4758,1,DeKillO,3017,843,174,167,341,51.0%,5m
4758,2,[스타놀이터]Zera,3017,986,41,37,78,52.6%,6m
4758,2,엔씨끼끼,3017,812,32,37,69,46.4%,17m
4758,1,[NTW]ProtossKing,3017,68,3,0,3,100.0%,41m
4758,3,백스핀블로우,3017,0,3,2,5,60.0%,16m
4758,3,lIlIlIllIl,3017,30,2,6,8,25.0%,5m
4758,1,HellBl,3017,0,0,2,2,0.0%,41m
4765,3,[형님나가신다]불곰,3016,1017,42,41,83,50.6%,9m
4765,3,소울오브프레임,3016,380,14,17,31,45.2%,8m
4765,2,[영훈이]땅굴망사티팬티,3016,266,10,7,17,58.8%,42m
4765,1,띠로링,3016,269,9,4,13,69.2%,39m
4765,2,시진핑암살작전,3016,114,5,2,7,71.4%,19m
4765,3,Respect,3016,0,1,3,4,25.0%,7m
4771,3,malhagi,3015,1543,232,215,447,51.9%,7m
4771,2,科學超電磁砲,3015,1463,77,75,152,50.7%,8m
4771,3,JinTonic,3015,707,40,39,79,50.6%,8m
4771,3,[LQV]모구모구,3015,564,21,24,45,46.7%,5m
4771,3,[3871]Herrscher,3015,94,2,1,3,66.7%,7m
4771,3,Celeste,3015,0,1,0,1,100.0%,15m
4771,3,[프로토스협회]울보도적,3015,0,1,0,1,100.0%,12m
4771,1,미숙가루,3015,40,1,2,3,33.3%,41m
4779,3,모두다링,3014,1501,92,83,175,52.6%,9m
4779,1,IIIIIIIIIIII,3014,1733,82,74,156,52.6%,40m
4779,3,plaguedog,3014,505,29,19,48,60.4%,8m
4779,3,SpyAlien,3014,59,7,10,17,41.2%,8m
4779,1,[썩션판타지]DeepsucktioN,3014,108,4,3,7,57.1%,40m
4779,1,똥꾸,3014,0,1,1,2,50.0%,41m
4779,1,Ice,3014,0,0,1,1,0.0%,40m
4786,3,김은구,3013,1181,178,158,336,53.0%,5m
4786,3,선물,3013,816,51,54,105,48.6%,9m
4786,2,인천의트러블메이,3013,508,46,48,94,48.9%,17m
4786,3,喜年來,3013,439,15,23,38,39.5%,3m
4786,2,Noleft,3013,246,8,4,12,66.7%,18m
4786,3,overcome,3013,138,6,5,11,54.5%,5m
4786,2,GDA,3013,0,0,7,7,0.0%,18m
4793,3,zennnnnn,3012,347,15,8,23,65.2%,44m
4793,3,InDifferent,3012,90,7,5,12,58.3%,6m
4793,1,[再睡十分鐘]妤安,3012,122,4,1,5,80.0%,41m
4793,1,[TNO]likefish,3012,112,4,2,6,66.7%,41m
4793,1,[한타왕]씹던껌,3012,116,3,5,8,37.5%,41m
4793,3,GeneRal,3012,112,2,3,5,40.0%,17m
4793,2,SiRiUS,3012,94,2,9,11,18.2%,17m
4793,2,[ELS]Whale,3012,0,1,0,1,100.0%,43m
4801,3,[HN]은고개트럼프,3011,415,52,46,98,53.1%,3m
4801,3,leon,3011,142,4,4,8,50.0%,9m
4801,1,[ELP]黑暗執政官,3011,0,1,0,1,100.0%,40m
4804,1,시야,3010,110,4,0,4,100.0%,41m
4804,3,Fantomas,3010,141,3,6,9,33.3%,9m
4804,1,초보에요,3010,76,2,1,3,66.7%,41m
4804,1,아구의허리돌리기,3010,88,1,1,2,50.0%,41m
4808,3,단무지,3009,480,17,18,35,48.6%,6m
4808,3,Gladiolus,3009,243,12,8,20,60.0%,44m
4808,1,Potato,3009,118,6,5,11,54.5%,39m
4808,1,왕이될상,3009,108,4,1,5,80.0%,41m
4808,3,Something,3009,86,4,3,7,57.1%,3m
4808,1,InDuForEver,3009,0,1,0,1,100.0%,41m
4808,3,[5E对战平台]luna,3009,0,0,2,2,0.0%,2m
4808,3,KiRaHyuU,3009,0,0,3,3,0.0%,17m
4816,3,sevenblue,3008,950,115,93,208,55.3%,8m
4816,2,국민성,3008,1522,109,110,219,49.8%,4m
4816,1,매력짱짱,3008,176,4,2,6,66.7%,11m
4816,3,[음식점]통스팸구이,3008,0,1,1,2,50.0%,3m
4820,3,타마마,3007,1543,304,275,579,52.5%,2m
4820,1,꼬밍하임,3007,275,21,16,37,56.8%,41m
4820,3,lonegunman,3007,420,15,16,31,48.4%,9m
4820,3,까미,3007,240,7,9,16,43.8%,9m
4820,3,지미,3007,146,4,4,8,50.0%,12m
4820,1,Xuan,3007,0,3,2,5,60.0%,40m
4820,3,SirBotticus,3007,60,3,4,7,42.9%,8m
4820,3,더콰이엇,3007,31,3,8,11,27.3%,8m
4820,3,destroyer,3007,60,2,6,8,25.0%,8m
4820,1,[SC2HK]cycle,3007,0,0,1,1,0.0%,40m
4820,1,hyulch,3007,0,0,1,1,0.0%,10m
4831,3,[TalenT]냄새나,3006,24,4,12,16,25.0%,44m
4831,1,twiceTT,3006,0,3,2,5,60.0%,41m
4831,1,Moom,3006,0,0,2,2,0.0%,40m
4834,3,rotate,3005,1490,84,60,144,58.3%,6m
4834,1,윤구,3005,736,25,39,64,39.1%,8m
4834,1,Orange,3005,462,18,12,30,60.0%,41m
4834,1,lllllllllll,3005,474,13,13,26,50.0%,40m
4834,1,[D3StaR]디스펜서,3005,294,11,4,15,73.3%,40m
4834,1,옆으로디테,3005,198,6,3,9,66.7%,41m
4834,2,DonEnzone,3005,110,5,3,8,62.5%,18m
4834,1,OnGLeaDer,3005,0,3,2,5,60.0%,39m
4834,1,[어윤수님개쩜]말순이,3005,0,3,2,5,60.0%,39m
4834,1,YOYOZergKing,3005,120,2,3,5,40.0%,9m
4844,2,我學電你學店,3004,1564,424,415,839,50.5%,4m
4844,3,글그림,3004,1244,175,157,332,52.7%,3m
4844,3,바퀴충문재인,3004,771,150,120,270,55.6%,8m
4844,1,[ELSII]래툰,3004,1036,35,30,65,53.8%,40m
4844,3,ImTheLimit,3004,682,34,30,64,53.1%,5m
4844,1,LeleJLs,3004,486,16,12,28,57.1%,41m
4844,1,DUTY,3004,154,6,3,9,66.7%,39m
4844,3,이글,3004,60,2,8,10,20.0%,9m
4852,3,[군사정권]이명박,3003,129,5,2,7,71.4%,16m
4852,3,TKO,3003,99,3,4,7,42.9%,6m
4852,1,[스타놀이터]Mife,3003,0,0,1,1,0.0%,40m
4852,3,哈囉你好嗎,3003,0,0,3,3,0.0%,9m
4856,1,IIIIIIIIIIII,3002,625,24,18,42,57.1%,42m
4856,3,김창균,3002,423,23,20,43,53.5%,8m
4856,2,마음,3002,362,16,16,32,50.0%,4m
4856,3,[고급천문대]베어그릴스,3002,272,9,15,24,37.5%,6m
4856,3,Ducktective,3002,220,8,6,14,57.1%,5m
4856,1,핸드폰액정수리,3002,97,4,6,10,40.0%,9m
4856,1,BSil,3002,34,2,1,3,66.7%,42m
4856,1,[잣밥들]테사기너프가시급,3002,0,1,0,1,100.0%,42m
4864,3,[YAD]안심배터,3001,970,37,37,74,50.0%,9m
4864,3,faux,3001,467,19,15,34,55.9%,6m
4864,1,Familyzone,3001,356,13,8,21,61.9%,41m
4864,3,철학왕,3001,194,5,8,13,38.5%,8m
4864,3,[ENT]GdPark,3001,126,5,9,14,35.7%,17m
4864,1,[중금속중독자]TLQKFSHA,3001,0,3,2,5,60.0%,40m
4864,3,Lunalight,3001,0,1,2,3,33.3%,6m
4864,1,冰烤番薯,3001,0,0,1,1,0.0%,39m
4872,2,BaTo,3000,1550,416,371,787,52.9%,3m
4872,3,[Upmeu]Upmeu,3000,575,29,26,55,52.7%,17m
4872,3,패스트리,3000,362,13,10,23,56.5%,9m
4872,1,Sxl,3000,132,6,4,10,60.0%,39m
4872,3,광주광역시박종덕,3000,169,4,1,5,80.0%,44m
4872,1,[莱茵生命]Hamakaze,3000,104,3,3,6,50.0%,39m
4872,1,grrr,3000,34,1,1,2,50.0%,41m
4872,3,naggerguy,3000,0,1,3,4,25.0%,8m
4872,1,LuckyTiger,3000,0,0,1,1,0.0%,40m
4881,1,Astro,2999,584,22,19,41,53.7%,41m
4881,1,lhogl,2999,0,3,2,5,60.0%,40m
4881,3,Akatsuki,2999,30,2,2,4,50.0%,9m
4881,1,Herobrine,2999,0,0,1,1,0.0%,42m
4885,3,[3030]karacini,2998,1511,175,160,335,52.2%,5m
4885,3,lllllllll,2998,1523,161,145,306,52.6%,5m
4885,3,ClayJ,2998,915,48,47,95,50.5%,3m
4885,3,마로형,2998,258,11,9,20,55.0%,12m
4889,1,CounterATK,2997,581,39,53,92,42.4%,9m
4889,3,NaturaLog,2997,498,18,17,35,51.4%,2m
4889,1,早晨,2997,481,13,11,24,54.2%,40m
4889,1,paul,2997,286,8,9,17,47.1%,41m
4889,1,Henryshe,2997,162,3,1,4,75.0%,41m
4889,1,[FlowAr]MarciaFlowAr,2997,30,2,0,2,100.0%,42m
4889,1,서리한,2997,0,0,2,2,0.0%,40m
4889,3,[형님나가신다]SUK,2997,0,0,4,4,0.0%,17m
4897,2,Qoo,2996,678,28,31,59,47.5%,2m
4897,3,법성법성,2996,486,18,16,34,52.9%,8m
4897,3,애구봉봉,2996,171,7,6,13,53.8%,3m
4900,3,SMO,2995,1286,69,59,128,53.9%,9m
4900,1,rabbied,2995,1039,59,52,111,53.2%,41m
4900,3,Warhawk,2995,850,33,35,68,48.5%,8m
4900,3,[킹왕핵고수]아아아아,2995,0,4,2,6,66.7%,9m
4900,1,jointlover,2995,0,3,2,5,60.0%,39m
4900,1,大毛哥,2995,124,2,1,3,66.7%,40m
4900,1,제라제라툴,2995,78,2,5,7,28.6%,41m
4907,2,aaadsadsdad,2994,621,31,34,65,47.7%,6m
4907,1,Marco,2994,558,21,17,38,55.3%,40m
4907,1,아일렌치스,2994,93,4,2,6,66.7%,40m
4910,3,dubbedout,2993,1584,391,375,766,51.0%,5m
4910,1,uwuMarine,2993,645,55,49,104,52.9%,41m
4910,1,[LVARW]海未,2993,184,8,3,11,72.7%,41m
4910,1,카친스키,2993,88,4,2,6,66.7%,40m
4910,3,soO,2993,97,4,2,6,66.7%,16m
4910,2,다솜,2993,93,4,3,7,57.1%,17m
4910,3,DARKiyoo,2993,0,0,4,4,0.0%,5m
4917,3,플루토,2992,148,6,6,12,50.0%,8m
4917,1,[mandoo]눈물젖은달빛,2992,0,3,2,5,60.0%,40m
4917,1,sofiit,2992,0,0,1,1,0.0%,41m
4917,1,[xTMDx]遠藤新人,2992,0,0,1,1,0.0%,41m
4921,3,[NLTN]TonyXwen,2991,1217,114,100,214,53.3%,8m
4921,1,[hl1234]scgreatagain,2991,436,14,11,25,56.0%,41m
4921,1,[HANGEL]ahjassi,2991,144,5,5,10,50.0%,41m
4921,1,leehu,2991,76,3,2,5,60.0%,41m
4921,1,OrcSC,2991,0,0,1,1,0.0%,41m
4921,1,만능오징어,2991,0,0,1,1,0.0%,40m
4927,3,[SofT]김가을,2990,583,40,42,82,48.8%,6m
4927,3,흐뭉,2990,514,21,18,39,53.8%,9m
4927,1,komanic,2990,319,10,7,17,58.8%,40m
4927,3,[뽀뽀잖아혀빼]GrrrrrJi,2990,60,4,7,11,36.4%,3m
4927,1,[NGameS]freehongkong,2990,0,1,0,1,100.0%,41m
4927,1,후니굴,2990,0,0,1,1,0.0%,42m
4933,2,MASTERXENON,2989,1306,63,69,132,47.7%,7m
4933,1,congeal,2989,734,39,24,63,61.9%,39m
4933,1,FApleKeybord,2989,748,25,19,44,56.8%,41m
4933,3,[DreaM]幽冥小樂,2989,442,18,16,34,52.9%,9m
4933,1,[벌떼들]김주보,2989,84,2,4,6,33.3%,41m
4933,1,자룡공명,2989,0,1,0,1,100.0%,41m
4939,1,chololate,2988,292,15,7,22,68.2%,40m
4939,2,Ogedei,2988,118,5,4,9,55.6%,9m
4939,3,해를사랑한구름,2988,60,2,7,9,22.2%,8m
4939,3,[시럽]바코드,2988,30,1,5,6,16.7%,17m
4943,1,쿠쿠루쿠쿠,2987,250,10,8,18,55.6%,40m
4943,3,Kim,2987,246,8,8,16,50.0%,3m
4943,3,paranoid,2987,0,1,3,4,25.0%,16m
4943,1,SAS,2987,0,0,1,1,0.0%,41m
4947,1,[랜타디광]진에어마루은구,2986,176,5,8,13,38.5%,42m
4947,3,핵대중,2986,0,4,1,5,80.0%,16m
4947,1,[500원]앙기모찌요,2986,74,2,3,5,40.0%,41m
4947,1,[冬的小雪夏0]幽雨,2986,97,1,2,3,33.3%,12m
4947,1,[STLIKE]스투라이크,2986,0,0,1,1,0.0%,41m
4947,1,hiimdog,2986,0,0,1,1,0.0%,40m
4953,1,ahskd,2985,1367,53,45,98,54.1%,40m
4953,3,하양물망초,2985,144,3,9,12,25.0%,2m
4953,1,Bondrewd,2985,0,0,1,1,0.0%,42m
4956,1,碧螺春綠茶,2984,281,8,3,11,72.7%,41m
4956,2,lightspeed,2984,138,6,6,12,50.0%,17m
4958,3,BreeMA,2983,1475,238,228,466,51.1%,5m
4958,1,테넷,2983,1685,163,164,327,49.8%,41m
4958,3,질럿,2983,726,30,25,55,54.5%,17m
4958,1,hiimgosu,2983,274,11,8,19,57.9%,40m
4958,3,공부가싫다,2983,121,3,1,4,75.0%,12m
4958,1,RIGHT,2983,118,3,3,6,50.0%,41m
4958,1,[시럽]Reinhard,2983,0,1,0,1,100.0%,41m
4965,3,[한타왕]이달의소녀츄,2982,348,79,70,149,53.0%,3m
4965,1,eluneclassic,2982,852,30,30,60,50.0%,41m
4965,1,kddjj,2982,96,2,2,4,50.0%,10m
4968,1,[너의ol름은]패스에이더,2981,719,28,16,44,63.6%,42m
4968,1,민군,2981,156,4,3,7,57.1%,40m
4968,1,Aeru,2981,0,1,4,5,20.0%,41m
4968,1,Lunaran,2981,0,0,1,1,0.0%,41m
4972,1,[LoteM]jsh,2980,684,26,30,56,46.4%,18m
4972,1,[KRisOK]WEEBRATOR,2980,276,8,8,16,50.0%,41m
4972,2,Jhlee,2980,180,6,19,25,24.0%,6m
4972,1,WhiteCollar,2980,32,1,1,2,50.0%,42m
4976,2,IIIIIIIIIIII,2979,152,5,11,16,31.2%,17m
4976,1,SURPRISER,2979,0,1,0,1,100.0%,41m
4976,1,[갈라파고스]ShySirius,2979,0,0,2,2,0.0%,41m
4979,1,nope,2978,798,31,19,50,62.0%,41m
4979,1,그날의그리움,2978,560,22,15,37,59.5%,41m
4979,2,간뒤,2978,46,6,2,8,75.0%,17m
4979,1,[중얼충]나무토막,2978,200,5,5,10,50.0%,40m
4979,1,Nobel,2978,34,2,2,4,50.0%,41m
4979,1,[무한오영종]Nobody,2978,0,1,0,1,100.0%,41m
4979,3,[Care]HalfNHalf,2978,0,1,4,5,20.0%,17m
4979,1,리모디,2978,0,0,2,2,0.0%,41m
4979,1,[天下布武]織田信長,2978,0,0,2,2,0.0%,41m
4988,3,momo,2977,780,28,33,61,45.9%,8m
4988,1,Crazylimbs,2977,749,27,28,55,49.1%,40m
4988,1,AssKiKa,2977,220,7,6,13,53.8%,40m
4988,1,CUZUMP,2977,224,7,8,15,46.7%,41m
4988,1,구이쁜,2977,147,4,1,5,80.0%,40m
4988,1,WIN,2977,0,1,0,1,100.0%,41m
4988,1,라량,2977,0,1,2,3,33.3%,40m
4995,1,碎羽皇蜂,2976,183,5,0,5,100.0%,40m
4995,1,준서,2976,120,5,5,10,50.0%,40m
4995,3,HaMuTauruS,2976,0,3,2,5,60.0%,32m
4995,3,SSagagi,2976,30,1,9,10,10.0%,8m
4999,1,llllllllllll,2975,954,36,25,61,59.0%,41m
4999,3,[어윤수님개쩜]HwanSangs,2975,398,17,14,31,54.8%,17m
4999,3,새봄이동생광식,2975,446,16,21,37,43.2%,9m
4999,1,주프로,2975,230,6,7,13,46.2%,41m
4999,1,Revvy,2975,30,4,3,7,57.1%,41m
4999,1,욕설,2975,144,4,4,8,50.0%,42m
4999,3,행복,2975,30,4,6,10,40.0%,9m
5006,1,홍익점문가,2974,1517,71,56,127,55.9%,40m
5006,3,Shinewarrior,2974,1201,49,45,94,52.1%,9m
5006,1,태로,2974,170,6,5,11,54.5%,42m
5006,3,mikiya,2974,146,4,4,8,50.0%,17m
5006,1,다쿠매시젼,2974,0,3,2,5,60.0%,40m
5011,3,[조직]동수파파,2973,1054,52,44,96,54.2%,5m
5011,1,IlIIIIllllll,2973,154,7,3,10,70.0%,40m
5011,1,[Super]SuperZodiac,2973,32,2,1,3,66.7%,40m
5014,1,듀란팽,2972,342,11,8,19,57.9%,41m
5014,3,MinGslam,2972,252,8,8,16,50.0%,44m
5014,1,readyforshow,2972,30,1,2,3,33.3%,39m
5014,1,llllllllllll,2972,0,0,2,2,0.0%,41m
5018,3,카나나나나난나,2971,1576,584,551,1135,51.5%,2m
5018,3,可愛到極具殺傷力,2971,365,27,15,42,64.3%,3m
5018,3,HOPE,2971,337,16,14,30,53.3%,3m
5018,3,지존풍류,2971,165,9,9,18,50.0%,8m
5018,1,Rain,2971,184,8,2,10,80.0%,39m
5018,1,ZZZiczzzzi,2971,164,6,2,8,75.0%,40m
5018,3,IIIllIIIIIII,2971,144,5,6,11,45.5%,12m
5018,3,kay,2971,0,3,2,5,60.0%,17m
5026,1,[인격파탄]김성모,2970,1112,41,36,77,53.2%,41m
5026,3,Nightmare,2970,579,25,20,45,55.6%,3m
5026,1,Akatsuki,2970,48,1,1,2,50.0%,11m
5029,3,NIA,2969,1467,116,103,219,53.0%,9m
5029,3,KOA,2969,1425,67,58,125,53.6%,17m
5029,1,[eXoPH]eXo,2969,488,17,10,27,63.0%,39m
5029,1,騎大象瘋狂甩尾,2969,288,9,10,19,47.4%,10m
5029,3,[패자는피를]황야의늑대,2969,246,9,11,20,45.0%,17m
5029,3,[Evouni]zakguo,2969,144,4,5,9,44.4%,3m
5029,3,huirrad,2969,0,3,2,5,60.0%,15m
5029,3,도토리,2969,0,3,3,6,50.0%,3m
5029,3,holy,2969,30,3,5,8,37.5%,7m
5038,3,Lucifertd,2968,1267,51,42,93,54.8%,9m
5038,3,[국방부사서병]하루를즐겁게,2968,234,8,12,20,40.0%,8m
5038,1,아기티아고,2968,206,5,2,7,71.4%,41m
5038,1,BrUtAl,2968,36,2,1,3,66.7%,40m
5042,2,[나혼자산다]CafeMocha,2967,634,22,34,56,39.3%,17m
5042,3,llllllllllll,2967,147,3,3,6,50.0%,12m
5042,2,ChrisGayle,2967,96,2,1,3,66.7%,18m
5045,3,삼다수복용중,2966,230,9,6,15,60.0%,2m
5045,3,knowledge,2966,197,8,8,16,50.0%,9m
5045,3,Amaterasu,2966,221,6,10,16,37.5%,9m
5045,1,천상의유희,2966,123,3,3,6,50.0%,42m
5045,1,avengerses,2966,0,0,1,1,0.0%,40m
5045,1,apsara,2966,0,0,1,1,0.0%,40m
5051,3,[咕咕咕的]呷哇耶癲,2965,537,26,32,58,44.8%,17m
5051,3,TheOssified,2965,629,23,21,44,52.3%,7m
5051,3,[중금속중독자]가을보리,2965,231,8,7,15,53.3%,3m
5051,3,wingsliberty,2965,194,5,3,8,62.5%,44m
5051,1,ZodiacL,2965,92,3,3,6,50.0%,41m
5051,1,말랭이,2965,38,1,2,3,33.3%,41m
5051,3,KORmarine,2965,0,0,1,1,0.0%,16m
5051,1,sincostan,2965,0,0,2,2,0.0%,40m
5059,1,뿱쭭뛁꿝쒉쀩쮥뛹,2964,698,28,23,51,54.9%,42m
5059,1,하함,2964,218,9,4,13,69.2%,40m
5059,1,tpztmarine,2964,211,7,2,9,77.8%,39m
5059,1,토이구,2964,146,4,5,9,44.4%,41m
5063,3,航航,2963,1334,72,71,143,50.3%,8m
5063,1,레바테인,2963,542,18,16,34,52.9%,42m
5063,1,SkyChaos,2963,324,9,7,16,56.2%,42m
5063,3,다은이남편,2963,157,7,5,12,58.3%,5m
5063,1,[TpW]克特,2963,142,5,3,8,62.5%,40m
5063,1,Scott,2963,0,0,1,1,0.0%,41m
5069,3,꼬꼬,2962,1333,52,53,105,49.5%,17m
5069,3,GaGa,2962,664,24,30,54,44.4%,9m
5069,1,冒險者,2962,616,19,19,38,50.0%,41m
5069,3,Atlas,2962,556,19,26,45,42.2%,3m
5073,2,Tester,2961,1200,46,46,92,50.0%,7m
5073,1,whaiko,2961,598,24,22,46,52.2%,39m
5073,1,鄭珉制,2961,446,15,12,27,55.6%,42m
5073,1,[Mist]Tempest,2961,392,10,13,23,43.5%,40m
5073,1,KJH,2961,215,7,5,12,58.3%,41m
5073,3,[隨緣]EternalJyun,2961,0,3,3,6,50.0%,15m
5073,1,마바링아,2961,72,2,6,8,25.0%,40m
5073,1,주인,2961,0,1,0,1,100.0%,40m
5073,3,이채은,2961,0,1,0,1,100.0%,16m
5082,2,배고파,2960,1447,299,280,579,51.6%,3m
5082,3,老頑童,2960,1119,46,40,86,53.5%,2m
5082,3,완소훈남융지,2960,303,12,10,22,54.5%,6m
5082,1,Wolo,2960,287,12,12,24,50.0%,41m
5082,1,[카나데천사]레무링,2960,143,10,13,23,43.5%,40m
5082,2,저그,2960,238,9,3,12,75.0%,17m
5082,1,도이아,2960,212,5,3,8,62.5%,40m
5082,1,[타타타]외계인,2960,124,5,3,8,62.5%,40m
5082,1,IIIIIIIIIIII,2960,128,3,0,3,100.0%,41m
5082,2,Diesel,2960,121,3,1,4,75.0%,18m
5082,1,Kim,2960,40,1,2,3,33.3%,41m
5082,1,[SevenT]준신,2960,0,0,2,2,0.0%,42m
5094,3,SpifFires,2959,1238,64,66,130,49.2%,8m
5094,1,大衛小魔術,2959,0,1,0,1,100.0%,40m
5094,1,산신님마리,2959,0,0,1,1,0.0%,42m
5094,1,OpTiMusPrime,2959,0,0,2,2,0.0%,42m
5094,1,[캬취한다]아이디찾은김웅비,2959,0,0,2,2,0.0%,41m
5099,3,joeliu,2958,298,11,7,18,61.1%,44m
5099,2,我下面比你大,2958,184,7,5,12,58.3%,9m
5099,1,limjeongmin,2958,124,4,5,9,44.4%,40m
5099,1,먹보,2958,0,3,2,5,60.0%,40m
5103,1,kvv,2957,933,138,110,248,55.6%,40m
5103,3,롯데날드,2957,120,5,12,17,29.4%,8m
5103,1,별여름,2957,0,1,0,1,100.0%,41m
5103,1,GomPoo,2957,38,1,1,2,50.0%,42m
5107,3,[우주침략]broker,2956,1520,144,125,269,53.5%,9m
5107,1,lazycom,2956,800,53,52,105,50.5%,41m
5107,1,Crad,2956,38,2,1,3,66.7%,41m
5110,3,Shacky,2955,1356,164,137,301,54.5%,18m
5110,3,RetrO,2955,1029,59,54,113,52.2%,6m
5110,1,rnjswjddnrrn,2955,164,5,2,7,71.4%,40m
5110,1,시계소리,2955,167,4,1,5,80.0%,41m
5114,3,혀고수,2954,795,48,45,93,51.6%,8m
5114,1,TerranMANIA,2954,290,24,12,36,66.7%,40m
5114,1,[경기도]forever,2954,521,20,14,34,58.8%,40m
5114,1,[Weast]인공지능,2954,76,2,3,5,40.0%,40m
5114,3,강미남,2954,0,1,1,2,50.0%,16m
5114,3,맞딱,2954,30,1,6,7,14.3%,44m
5114,1,vOrtEx,2954,0,0,1,1,0.0%,40m
5121,1,ANA,2953,631,31,11,42,73.8%,40m
5121,1,IIIIIIIIIIII,2953,516,16,12,28,57.1%,40m
5121,1,愛拼才會贏,2953,311,11,10,21,52.4%,40m
5121,1,명이,2953,152,4,6,10,40.0%,39m
5121,1,로드타찬카,2953,34,2,1,3,66.7%,42m
5121,1,[isnous]阿爾法,2953,0,1,0,1,100.0%,11m
5121,1,TimTan,2953,0,1,0,1,100.0%,40m
5121,1,Ray,2953,0,1,0,1,100.0%,41m
5121,1,[긴급스섹대]올인안하는사람,2953,38,1,2,3,33.3%,41m
5121,1,샤로의마이너스통,2953,0,0,1,1,0.0%,41m
5131,1,鹽烤異化蟲,2952,1001,52,36,88,59.1%,42m
5131,3,llllllllllll,2952,453,28,34,62,45.2%,8m
5131,1,[GIS]血月已成為傳說,2952,154,6,7,13,46.2%,11m
5131,1,[Sirena]아멘났네,2952,70,3,0,3,100.0%,40m
5131,1,[Rovic]Revolverlady,2952,76,2,2,4,50.0%,41m
5136,3,밥먹고하자고,2951,1530,126,125,251,50.2%,9m
5136,1,마늄게르,2951,1373,60,46,106,56.6%,40m
5136,3,[CnB]고스트썰,2951,0,3,2,5,60.0%,17m
5136,1,rotori,2951,108,3,5,8,37.5%,41m
5136,1,tlqkf,2951,0,2,0,2,100.0%,40m
5136,3,깐지남,2951,44,1,2,3,33.3%,17m
5136,2,오야,2951,42,1,8,9,11.1%,17m
5136,1,[KWU]MPTCP,2951,0,0,1,1,0.0%,11m
5144,1,임동현,2950,1673,139,131,270,51.5%,41m
5144,3,[NABU]aklsdfjlksjf,2950,1493,91,97,188,48.4%,18m
5144,1,vip,2950,1099,52,33,85,61.2%,42m
5144,1,하마다스,2950,390,14,10,24,58.3%,40m
5144,1,samsung,2950,151,4,2,6,66.7%,41m
5144,1,광물일등,2950,78,2,4,6,33.3%,42m
5144,1,Decition,2950,0,1,0,1,100.0%,41m
5151,3,largeanimal,2949,1394,89,74,163,54.6%,9m
5151,3,묵이,2949,472,17,17,34,50.0%,6m
5151,2,PickleRick,2949,247,10,9,19,52.6%,3m
5151,1,Hideki,2949,308,9,6,15,60.0%,42m
5151,3,eiloeilo,2949,62,7,4,11,63.6%,3m
5151,1,Hisk,2949,0,4,1,5,80.0%,40m
5151,3,컴퓨터,2949,111,2,1,3,66.7%,12m
5151,1,호랭이,2949,0,1,0,1,100.0%,41m
5151,2,Zenith,2949,0,0,1,1,0.0%,18m
5160,3,훈식갓,2947,1025,59,52,111,53.2%,3m
5160,1,YGodPoNy,2947,292,8,6,14,57.1%,41m
5160,1,[禿頭肥寶]DreamYiN,2947,140,4,6,10,40.0%,41m
5160,1,[mhdim]히코리따,2947,0,0,1,1,0.0%,40m
5164,1,[shiro]MIKUDANCE,2946,181,7,1,8,87.5%,40m
5164,1,IIlIlIllIlII,2946,36,1,2,3,33.3%,40m
5164,1,pokergosu,2946,0,0,5,5,0.0%,41m
5167,3,[WTSC]위리,2945,247,37,37,74,50.0%,3m
5167,1,MEFQSQ,2945,306,11,8,19,57.9%,41m
5167,3,키즈뱅,2945,258,9,14,23,39.1%,5m
5167,1,아무스,2945,253,7,9,16,43.8%,41m
5167,3,Aliado,2945,0,4,1,5,80.0%,16m
5167,1,pavipollo,2945,0,4,1,5,80.0%,39m
5167,3,Maccactus,2945,145,4,5,9,44.4%,44m
5167,3,[인격파탄]그냥유저,2945,0,2,3,5,40.0%,16m
5175,1,손치호,2944,222,7,8,15,46.7%,41m
5175,1,[VlRUS]REEEEEEEEEEE,2944,183,6,1,7,85.7%,41m
5175,1,재권씨,2944,38,1,1,2,50.0%,41m
5175,1,sksus,2944,0,0,2,2,0.0%,42m
5179,1,[송해손잡고]테사다,2943,1629,65,58,123,52.8%,42m
5179,3,[스카이파이터]멍츄,2943,684,24,29,53,45.3%,4m
5179,2,최욱이,2943,273,11,3,14,78.6%,18m
5179,2,란타인,2943,137,6,5,11,54.5%,18m
5179,1,원빈찡,2943,158,6,5,11,54.5%,40m
5179,3,수락동자,2943,0,4,2,6,66.7%,17m
5179,3,딩코,2943,0,3,2,5,60.0%,16m
5179,3,lllllll,2943,0,3,2,5,60.0%,17m
5179,1,SKY,2943,0,0,1,1,0.0%,40m
5188,1,llwei,2942,1538,62,55,117,53.0%,40m
5188,3,PeterWang,2942,844,53,46,99,53.5%,9m
5188,1,Jarhead,2942,701,21,19,40,52.5%,41m
5188,1,TKingMax,2942,134,6,9,15,40.0%,11m
5188,3,짬타수아,2942,0,3,2,5,60.0%,17m
5193,3,llllllllllll,2941,1529,143,125,268,53.4%,5m
5193,1,부커,2941,105,5,2,7,71.4%,42m
5193,1,[HKTW]InsignFANT,2941,32,2,0,2,100.0%,41m
5196,3,IIIIIlllllII,2940,1538,87,81,168,51.8%,8m
5196,1,dark,2940,859,55,44,99,55.6%,41m
5196,1,darkReunion,2940,355,12,7,19,63.2%,41m
5196,1,Astaroth,2940,283,8,7,15,53.3%,40m
5196,1,놀이터추천부탁,2940,0,1,1,2,50.0%,41m
5201,1,상항까,2939,278,8,11,19,42.1%,41m
5201,3,[더지니어스]Boss,2939,218,7,14,21,33.3%,8m
5201,1,노바,2939,132,2,2,4,50.0%,41m
5201,1,上海打桩机,2939,36,2,3,5,40.0%,40m
5201,1,오딘,2939,0,1,0,1,100.0%,41m
5201,1,Epicmouse,2939,0,1,1,2,50.0%,41m
5207,1,수고링,2938,1122,51,35,86,59.3%,40m
5207,1,조아라인중냄새,2938,1217,46,41,87,52.9%,41m
5207,1,[D3StaR]pgb,2938,408,12,14,26,46.2%,41m
5207,1,누가나보다스타잘,2938,328,10,10,20,50.0%,10m
5207,1,광전사,2938,246,7,9,16,43.8%,41m
5207,1,게준,2938,149,6,1,7,85.7%,10m
5207,1,Clooney,2938,154,5,3,8,62.5%,40m
5207,1,빵빵또로로로,2938,0,0,1,1,0.0%,40m
5215,1,ABANDON,2937,519,18,18,36,50.0%,40m
5215,2,tong,2937,58,3,0,3,100.0%,18m
5215,1,감도순,2937,0,3,2,5,60.0%,40m
5218,1,Areskss,2936,473,22,16,38,57.9%,42m
5218,1,[Equal]ReyNor,2936,191,6,3,9,66.7%,42m
5218,1,Max,2936,131,5,9,14,35.7%,42m
5218,2,개시발스타투,2936,48,1,4,5,20.0%,18m
5222,1,lIlIlIlIllI,2935,1148,439,422,861,51.0%,42m
5222,1,ENTERSPITE,2935,980,36,28,64,56.2%,40m
5222,2,CYS,2935,129,4,6,10,40.0%,18m
5222,3,Hunblee,2935,0,3,2,5,60.0%,16m
5222,1,[MBK]몬스터,2935,0,1,1,2,50.0%,11m
5222,3,[자치령특전단]llllllllllll,2935,0,0,1,1,0.0%,15m
5228,1,nelosy,2934,498,14,16,30,46.7%,41m
5228,1,잠이온다아아아,2934,203,8,7,15,53.3%,39m
5228,3,이소융,2934,101,7,4,11,63.6%,44m
5228,1,[바닷속이야기]테란버프좀,2934,0,4,1,5,80.0%,42m
5228,1,reloco,2934,90,3,4,7,42.9%,41m
5228,1,zears,2934,68,2,3,5,40.0%,41m
5228,1,CloseYou,2934,0,1,1,2,50.0%,11m
5228,1,팔란티어,2934,0,0,1,1,0.0%,41m
5228,1,GNS,2934,0,0,1,1,0.0%,40m
5237,1,[NoMST]ToFu,2933,188,5,7,12,41.7%,41m
5237,3,에렌디라,2933,0,3,2,5,60.0%,16m
5237,3,BamBam,2933,62,2,10,12,16.7%,3m
5240,3,닉뿌,2932,1519,351,340,691,50.8%,9m
5240,1,아무나,2932,214,7,7,14,50.0%,41m
5240,1,TheAbsolute,2932,238,7,9,16,43.8%,41m
5240,1,끼룩끼룩,2932,116,5,4,9,55.6%,40m
5240,1,DarkKnight,2932,123,3,1,4,75.0%,41m
5240,1,[EUNSUL]ZION,2932,76,3,3,6,50.0%,41m
5240,1,WarComplete,2932,64,2,3,5,40.0%,42m
5240,3,顧墜懺遮,2932,0,1,2,3,33.3%,16m
5248,3,Teddy,2931,918,85,74,159,53.5%,9m
5248,2,[스카이파이터]fantasy,2931,350,14,28,42,33.3%,7m
5248,2,Killer,2931,163,12,19,31,38.7%,7m
5248,1,널죽이로왓다,2931,0,3,2,5,60.0%,40m
5248,2,Kumiko,2931,42,3,4,7,42.9%,18m
5248,1,Love,2931,0,1,0,1,100.0%,40m
5248,1,你刘爹,2931,0,1,3,4,25.0%,41m
5248,1,[사이상]사이상,2931,0,0,1,1,0.0%,40m
5256,1,MintChoco,2930,1015,37,34,71,52.1%,40m
5256,1,단팥펭귄,2930,214,8,3,11,72.7%,40m
5256,1,[cAnOp]과연김지훈,2930,202,8,9,17,47.1%,40m
5256,3,Markjaing,2930,64,4,9,13,30.8%,6m
5256,1,[송파]Model,2930,118,3,5,8,37.5%,41m
5256,1,웅루루웅,2930,114,3,6,9,33.3%,42m
5256,1,BuChu,2930,36,2,3,5,40.0%,42m
5256,1,그녀는양학중,2930,30,2,3,5,40.0%,41m
5264,3,KNIGHTS,2929,1516,116,105,221,52.5%,5m
5264,2,Smilyman,2929,1140,69,59,128,53.9%,7m
5264,1,오우짜스,2929,379,10,9,19,52.6%,41m
5264,1,[하찮은]물개,2929,111,6,2,8,75.0%,41m
5264,1,lIlIlIllIIII,2929,158,4,9,13,30.8%,41m
5264,1,전설의코딱지,2929,0,0,1,1,0.0%,39m
5270,2,lllllllllll,2928,1556,309,311,620,49.8%,3m
5270,3,lIIlIIIIIlll,2928,1467,94,84,178,52.8%,3m
5270,2,김형제문철,2928,115,5,4,9,55.6%,19m
5270,1,넌누구니,2928,180,4,2,6,66.7%,12m
5270,1,SpaceArea,2928,0,0,3,3,0.0%,41m
5275,1,lllIIlllIlll,2927,1326,129,134,263,49.0%,41m
5275,1,[GITS]GolongLatte,2927,597,28,15,43,65.1%,40m
5275,1,bee,2927,628,21,18,39,53.8%,40m
5275,1,KIANUREVUS,2927,332,12,9,21,57.1%,40m
5275,1,현지인입니다,2927,307,10,9,19,52.6%,41m
5275,1,비수,2927,234,9,9,18,50.0%,11m
5275,1,스타충호랭이,2927,88,2,0,2,100.0%,41m
5275,1,orehonyah,2927,0,2,3,5,40.0%,41m
5283,2,SioHuKKi,2926,1099,44,48,92,47.8%,2m
5283,1,[시럽]단풍나무,2926,120,2,4,6,33.3%,42m
5283,1,[백합]탈다림,2926,0,0,1,1,0.0%,41m
5286,3,cLeveRWesT,2925,1454,94,87,181,51.9%,8m
5286,1,[노란별마스터]석봉이여자친구구,2925,1679,92,82,174,52.9%,41m
5286,1,janez,2925,1245,81,71,152,53.3%,8m
5286,1,TNSmile,2925,1104,62,47,109,56.9%,40m
5286,1,새빨간사춘기,2925,490,15,15,30,50.0%,42m
5286,2,[IWYDI]SoSoWYD,2925,138,6,10,16,37.5%,7m
5286,1,DimonLimON,2925,48,5,7,12,41.7%,11m
5286,2,SHIBALSEKKI,2925,138,3,11,14,21.4%,18m
5294,3,[이카르스M]이카루스,2924,1383,542,524,1066,50.8%,2m
5294,3,cCane,2924,749,30,31,61,49.2%,3m
5294,1,나는레종멘솔이다,2924,551,20,12,32,62.5%,41m
5294,3,크와앗,2924,455,19,17,36,52.8%,6m
5294,3,[meruwu]ururem,2924,299,10,10,20,50.0%,12m
5294,1,kdhcor,2924,176,7,4,11,63.6%,40m
5294,3,팬더,2924,0,1,0,1,100.0%,15m
5294,1,Moon,2924,0,0,1,1,0.0%,40m
5294,1,[브리티안]희망을등지다,2924,0,0,1,1,0.0%,42m
5303,1,Alcibiades,2923,608,73,59,132,55.3%,41m
5303,1,Spendor,2923,213,8,4,12,66.7%,41m
5303,1,Travis,2923,162,4,2,6,66.7%,42m
5303,3,Luras,2923,0,3,2,5,60.0%,17m
5303,3,블루밍,2923,0,1,4,5,20.0%,17m
5308,3,[TF]TFShadow,2922,734,80,69,149,53.7%,5m
5308,3,xortls,2922,830,32,35,67,47.8%,3m
5308,1,Clash,2922,231,10,8,18,55.6%,39m
5308,3,Tecca,2922,258,8,19,27,29.6%,3m
5308,3,[적군]지롱,2922,0,3,2,5,60.0%,17m
5308,1,[양킥팬클럽]babeejoa,2922,68,2,3,5,40.0%,40m
5308,1,자라초인,2922,34,1,2,3,33.3%,42m
5315,3,PromDi,2921,720,30,33,63,47.6%,8m
5315,1,이순신,2921,403,20,14,34,58.8%,41m
5315,1,Temu,2921,518,15,15,30,50.0%,42m
5315,1,BAEKGu,2921,324,13,11,24,54.2%,42m
5315,1,Seolgi,2921,163,8,3,11,72.7%,40m
5315,1,Cho,2921,88,3,3,6,50.0%,41m
5315,1,대한이,2921,0,0,1,1,0.0%,40m
5322,3,SMyDixk,2920,1060,46,40,86,53.5%,6m
5322,1,[랜타디광]린저씨,2920,447,15,11,26,57.7%,42m
5322,1,[TMR]willy,2920,256,8,6,14,57.1%,41m
5322,1,ChanTiPo,2920,295,7,8,15,46.7%,40m
5322,1,스투코프,2920,48,5,8,13,38.5%,10m
5322,1,포스,2920,141,3,3,6,50.0%,40m
5322,1,[SofT]이미진경기,2920,0,1,1,2,50.0%,41m
5329,3,niefeng,2919,1447,82,77,159,51.6%,9m
5329,3,turtle,2919,1340,53,55,108,49.1%,8m
5329,2,[BX养鸡场]llllllllllll,2919,494,20,8,28,71.4%,43m
5329,3,IIIIIIIIIIII,2919,403,13,19,32,40.6%,17m
5329,1,啊翔,2919,178,7,9,16,43.8%,41m
5329,2,현자타임으로간다,2919,36,4,2,6,66.7%,39m
5329,3,MADNESS,2919,0,2,1,3,66.7%,17m
5336,3,[TalenT]Ethan,2918,436,21,3,24,87.5%,44m
5336,2,대건님,2918,190,7,6,13,53.8%,10m
5336,2,oDiNe,2918,112,4,1,5,80.0%,43m
5336,3,San,2918,96,4,5,9,44.4%,6m
5336,2,Caps,2918,125,2,3,5,40.0%,18m
5336,2,보스학교,2918,0,0,1,1,0.0%,17m
5342,1,flame,2917,293,13,15,28,46.4%,41m
5342,3,Flash,2917,114,5,10,15,33.3%,6m
5342,1,샤샤샤샷,2917,68,3,4,7,42.9%,41m
5342,3,EpicMayo,2917,40,2,3,5,40.0%,16m
5346,1,박보영,2916,557,29,26,55,52.7%,40m
5346,3,DKChen,2916,172,11,8,19,57.9%,6m
5346,1,lIlIlIlIlIll,2916,165,7,8,15,46.7%,11m
5346,2,letitrip,2916,158,4,1,5,80.0%,39m
5350,3,MrDoom,2915,1519,354,364,718,49.3%,9m
5350,1,가보징어,2915,1283,117,101,218,53.7%,42m
5350,1,XiaoSong,2915,498,19,13,32,59.4%,40m
5350,1,MINE,2915,535,16,17,33,48.5%,42m
5350,1,BLCK,2915,424,14,16,30,46.7%,41m
5355,3,llllllllllll,2914,1456,143,148,291,49.1%,8m
5355,1,[날빌카운터]東亞病夫,2914,42,2,4,6,33.3%,42m
5355,1,미리치,2914,0,1,1,2,50.0%,40m
5355,1,HASHTAG,2914,0,1,1,2,50.0%,40m
5355,2,BascH,2914,0,0,1,1,0.0%,39m
5360,2,mint,2913,1492,193,179,372,51.9%,8m
5360,1,비니루,2913,278,9,10,19,47.4%,10m
5360,3,뽀삼가이드,2913,200,6,15,21,28.6%,3m
5360,3,IlIIIllIIIll,2913,116,5,10,15,33.3%,18m
5360,3,KaranesK,2913,0,3,2,5,60.0%,17m
5360,3,박은빈남친입니다,2913,0,3,2,5,60.0%,16m
5360,1,알바추노꾼,2913,90,2,5,7,28.6%,41m
5367,2,bboykid,2912,1529,178,162,340,52.4%,42m
5367,1,리밋학팔,2912,522,32,33,65,49.2%,42m
5367,2,[DoBTeN]發條天竺鼠,2912,340,12,8,20,60.0%,44m
5367,2,cjswoekd,2912,290,8,9,17,47.1%,42m
5367,3,[부관교]망하겠군요,2912,142,4,1,5,80.0%,44m
5367,1,천둥,2912,216,4,7,11,36.4%,11m
5367,3,vague,2912,168,4,10,14,28.6%,6m
5367,2,아나캐쩔어,2912,58,3,3,6,50.0%,39m
5367,1,쏘쿨한보이,2912,127,3,3,6,50.0%,40m
5367,2,앙기모띠,2912,0,0,1,1,0.0%,17m
5377,1,小宇,2911,1083,42,42,84,50.0%,42m
5377,3,ipj,2911,1154,40,51,91,44.0%,3m
5377,1,jackorder,2911,345,12,10,22,54.5%,40m
5377,2,Dyne,2911,175,3,5,8,37.5%,10m
5377,2,Utahime,2911,0,2,2,4,50.0%,19m
5377,2,바다거북,2911,0,2,3,5,40.0%,43m
5377,1,좀쌘캐디,2911,0,1,2,3,33.3%,39m
5384,2,kensinz,2910,252,12,15,27,44.4%,2m
5384,1,흔한레더유저,2910,0,0,4,4,0.0%,42m
5386,3,infily,2909,776,60,43,103,58.3%,7m
5386,2,maiyan,2909,1004,34,48,82,41.5%,7m
5386,1,[NGNLZ]參見賢王,2909,210,7,10,17,41.2%,42m
5386,1,충무로영화인,2909,34,2,2,4,50.0%,42m
5386,2,솔버로드의역습,2909,0,0,1,1,0.0%,43m
5391,2,애봉이,2908,383,14,6,20,70.0%,44m
5391,1,DOOM,2908,424,14,11,25,56.0%,40m
5391,1,zzz,2908,370,11,15,26,42.3%,41m
5391,2,Nnedy,2908,230,10,5,15,66.7%,39m
5391,1,湯尼花,2908,169,6,8,14,42.9%,11m
5391,2,OrcoTMM,2908,96,4,4,8,50.0%,18m
5391,1,iZytm,2908,42,2,3,5,40.0%,40m
5398,1,깐대또까,2907,1046,36,39,75,48.0%,41m
5398,1,꼬지장수,2907,221,7,4,11,63.6%,40m
5398,2,Frost,2907,0,1,0,1,100.0%,42m
5398,3,ILGEM,2907,0,1,0,1,100.0%,44m
5402,1,뭘봐씨뱅아,2906,1605,100,88,188,53.2%,41m
5402,1,SecretPoo,2906,648,34,15,49,69.4%,42m
5402,2,llllllllllll,2906,600,23,14,37,62.2%,43m
5402,1,jimmy,2906,112,8,12,20,40.0%,41m
5402,2,wonjunsea,2906,114,4,1,5,80.0%,43m
5402,2,AKTravel,2906,40,4,3,7,57.1%,39m
5402,3,다댐벼,2906,0,3,2,5,60.0%,15m
5402,2,NightMare,2906,0,1,0,1,100.0%,44m
5410,2,[TMAbly]White,2905,1532,314,312,626,50.2%,17m
5410,1,AlleN,2905,389,16,14,30,53.3%,41m
5410,1,CopterUseles,2905,204,9,3,12,75.0%,41m
5410,2,기정,2905,199,7,3,10,70.0%,44m
5410,2,[Bully]펑커임요환,2905,66,2,1,3,66.7%,43m
5410,2,hiddenguy,2905,0,1,0,1,100.0%,39m
5410,3,쫄랑이,2905,0,1,6,7,14.3%,17m
5417,3,[ELS]SgtPepper,2904,912,33,44,77,42.9%,3m
5417,2,보성녹차,2904,464,18,10,28,64.3%,42m
5417,1,ICYphoenix,2904,269,10,6,16,62.5%,42m
5417,1,UmOhAhYeh,2904,105,3,1,4,75.0%,42m
5417,2,Alexandros,2904,0,3,2,5,60.0%,17m
5417,2,ErrorGG,2904,0,0,1,1,0.0%,43m
5417,2,[어윤수님개쩜]INnoVation,2904,0,0,1,1,0.0%,39m
5424,3,Bear,2903,992,80,69,149,53.7%,6m
5424,1,[시럽]멋쟁이,2903,352,11,10,21,52.4%,41m
5424,2,MIETKS,2903,0,3,2,5,60.0%,43m
5424,2,[광역어그로]보목안먹으면팀킬,2903,0,1,0,1,100.0%,39m
5428,3,테테전사절,2902,1505,199,181,380,52.4%,6m
5428,2,kkkiii,2902,822,122,108,230,53.0%,43m
5428,1,하하하,2902,102,3,1,4,75.0%,40m
5428,2,[귀요미햄스터]세느,2902,0,1,0,1,100.0%,39m
5432,1,早晨,2901,695,28,28,56,50.0%,41m
5432,1,탈옥수흑형,2901,480,20,12,32,62.5%,42m
5432,1,[두피용면도기]nikeshoes,2901,252,8,9,17,47.1%,42m
5432,2,카르페디엠,2901,146,5,4,9,55.6%,43m
5432,2,sas,2901,0,4,1,5,80.0%,43m
5432,1,[비트]개가튼,2901,34,2,2,4,50.0%,41m
5438,1,scatterbrain,2900,1451,348,360,708,49.2%,4m
5438,3,린손훌오로시르뤰,2900,1333,56,51,107,52.3%,9m
5438,1,닭강정,2900,274,9,8,17,52.9%,41m
5438,1,llllllllllll,2900,154,3,4,7,42.9%,41m
5438,2,방뎅이다,2900,30,1,1,2,50.0%,44m
5438,1,ijfiejpop,2900,0,1,1,2,50.0%,42m
5438,1,ALTRENE,2900,0,0,2,2,0.0%,41m
5445,2,기생수,2899,224,7,2,9,77.8%,44m
5445,2,까만도토리,2899,140,4,2,6,66.7%,39m
5445,1,zzzz,2899,183,4,3,7,57.1%,10m
5445,1,핵언더,2899,74,3,3,6,50.0%,41m
5445,2,Solindar,2899,0,2,3,5,40.0%,39m
5450,3,김쫄보,2898,707,28,29,57,49.1%,9m
5450,1,ToyHeart,2898,540,17,16,33,51.5%,40m
5450,1,AsterCali,2898,88,2,1,3,66.7%,41m
5450,3,習近平,2898,0,2,3,5,40.0%,17m
5450,1,맛있는유자,2898,0,1,3,4,25.0%,41m
5450,1,[신사가되자]Cyberdyne,2898,0,1,3,4,25.0%,41m
5450,1,cpu,2898,34,1,3,4,25.0%,42m
5457,1,Chilled,2897,910,100,83,183,54.6%,41m
5457,1,cupidbombs,2897,1412,75,70,145,51.7%,41m
5457,1,超新星,2897,280,9,14,23,39.1%,41m
5457,3,[다잘해요]플토잘해요,2897,136,6,3,9,66.7%,15m
5457,1,Palespartan,2897,100,4,4,8,50.0%,42m
5457,3,[티아]캐리어,2897,32,2,0,2,100.0%,15m
5463,1,하하핳늘,2896,398,18,12,30,60.0%,42m
5463,1,Serendipity,2896,453,17,13,30,56.7%,40m
5463,2,승우아범,2896,420,14,10,24,58.3%,43m
5463,1,[호랑이기운]얌마최완득,2896,258,11,5,16,68.8%,42m
5463,1,IIIIIIIIIIII,2896,316,10,13,23,43.5%,41m
5463,1,qwer,2896,236,9,5,14,64.3%,41m
5463,2,[반콩성반퉁퉁]킹덤스톤,2896,238,8,4,12,66.7%,42m
5463,3,[선남선녀]선남선녀,2896,95,2,0,2,100.0%,44m
5471,1,Terran,2895,1408,95,91,186,51.1%,42m
5471,1,benasking,2895,1385,75,63,138,54.3%,41m
5471,1,스타투,2895,455,17,16,33,51.5%,39m
5471,1,agnya,2895,263,10,8,18,55.6%,10m
5471,3,eden,2895,236,8,6,14,57.1%,12m
5471,1,WYLITS,2895,186,8,6,14,57.1%,40m
5471,2,LIFE,2895,0,3,2,5,60.0%,44m
5471,2,Drain,2895,30,2,1,3,66.7%,43m
5471,2,크롱이,2895,0,0,1,1,0.0%,39m
5471,2,Sum,2895,0,0,1,1,0.0%,39m
5481,3,flynife,2894,1367,143,133,276,51.8%,18m
5481,1,량키,2894,766,29,27,56,51.8%,41m
5481,2,내일도장학관,2894,219,12,5,17,70.6%,43m
5484,1,sasagogo,2893,914,33,34,67,49.3%,41m
5484,1,Alicorn,2893,249,7,8,15,46.7%,42m
5484,3,猛猛的,2893,58,5,8,13,38.5%,4m
5484,2,우가,2893,0,1,3,4,25.0%,39m
5488,1,주병무,2892,1180,47,45,92,51.1%,41m
5488,1,공신,2892,251,23,18,41,56.1%,42m
5488,1,llllllllllll,2892,534,19,15,34,55.9%,42m
5488,3,assso,2892,466,16,26,42,38.1%,6m
5488,3,[WDY]jinioh,2892,44,2,0,2,100.0%,17m
5488,2,닝겐,2892,44,2,2,4,50.0%,18m
5488,2,我是新手,2892,0,0,1,1,0.0%,43m
5488,1,ZWANGFCNG,2892,0,0,4,4,0.0%,41m
5496,2,granty,2891,1452,363,342,705,51.5%,2m
5496,3,명원갓,2891,1496,123,115,238,51.7%,5m
5496,2,은돌이,2891,30,2,0,2,100.0%,39m
5496,1,정종현,2891,0,1,4,5,20.0%,40m
5496,1,Por,2891,0,0,2,2,0.0%,41m
5501,2,[엠생]flameflower,2890,634,60,55,115,52.2%,4m
5501,1,정꼬삼,2890,346,13,12,25,52.0%,41m
5501,1,[0512]최이트,2890,279,9,6,15,60.0%,42m
5501,1,간지상훈,2890,0,1,5,6,16.7%,40m
5501,1,[지리산산적]꺇매력,2890,97,1,7,8,12.5%,40m
5506,1,맛보기,2889,1209,83,70,153,54.2%,41m
5506,3,[노인성듀오]련남동터프쿠키,2889,1277,70,55,125,56.0%,6m
5506,3,殘奘取經,2889,652,34,35,69,49.3%,3m
5506,1,Rukh,2889,955,33,31,64,51.6%,41m
5506,1,過來韓老師這,2889,720,26,24,50,52.0%,41m
5506,2,[Day7]Templar,2889,207,7,7,14,50.0%,18m
5506,2,pulchra,2889,88,2,11,13,15.4%,19m
5506,2,하얀구름,2889,0,1,1,2,50.0%,18m
5506,1,사랑해,2889,0,1,2,3,33.3%,41m
5506,3,llllllllllll,2889,40,1,8,9,11.1%,16m
5506,1,[자지들]샤른호르스트,2889,0,0,1,1,0.0%,11m
5517,3,[WTSC]TossIMBA,2888,212,9,21,30,30.0%,3m
5518,1,[패튼전차]我是韩国人,2887,644,21,24,45,46.7%,40m
5518,3,Powerade,2887,0,1,0,1,100.0%,17m
5520,1,[습격자까마귀]오토모빌,2886,136,4,10,14,28.6%,41m
5521,1,YOHOHO,2885,978,42,33,75,56.0%,40m
5521,1,응기잇얍얍찍,2885,692,27,21,48,56.2%,42m
5521,1,Casper,2885,314,10,11,21,47.6%,41m
5521,3,Demitreat,2885,62,5,7,12,41.7%,2m
5521,1,용석이똥구멍,2885,32,4,4,8,50.0%,42m
5521,2,DeMian,2885,60,3,1,4,75.0%,44m
5521,1,아라블루호,2885,102,2,3,5,40.0%,41m
5521,2,sybsybsyb,2885,0,1,0,1,100.0%,39m
5521,2,핵두루미,2885,0,1,1,2,50.0%,18m
5521,2,lIlIIIlllIII,2885,30,1,2,3,33.3%,43m
5531,1,geek,2884,613,24,22,46,52.2%,39m
5531,1,[노자리]키키키키키키키키,2884,267,8,9,17,47.1%,40m
5531,2,神龍擺尾,2884,0,1,4,5,20.0%,39m
5531,2,RED,2884,0,0,2,2,0.0%,43m
5535,1,Orion,2883,376,15,11,26,57.7%,40m
5535,1,IIIlllIII,2883,345,11,10,21,52.4%,42m
5535,2,monarch,2883,30,1,1,2,50.0%,39m
5538,2,IIIIllIIIllI,2882,456,17,11,28,60.7%,39m
5538,2,Dark,2882,242,10,6,16,62.5%,42m
5538,1,저정말못해요죄송,2882,0,3,3,6,50.0%,40m
5541,1,산이,2881,1003,134,123,257,52.1%,41m
5541,1,IIIIIIIIII,2881,1112,84,73,157,53.5%,42m
5541,2,Planetlovely,2881,1220,55,41,96,57.3%,39m
5541,1,[스타놀이터]둘리,2881,370,14,13,27,51.9%,40m
5541,1,forthefuture,2881,212,9,12,21,42.9%,42m
5541,2,전설,2881,90,4,3,7,57.1%,39m
5541,3,BroodwaR,2881,0,3,3,6,50.0%,16m
5541,2,Yurui,2881,30,1,2,3,33.3%,39m
5541,2,Magare,2881,0,0,1,1,0.0%,43m
5541,2,naver,2881,0,0,1,1,0.0%,43m
5551,1,eric,2880,1085,40,38,78,51.3%,41m
5551,2,[후두리패버림]bangrang,2880,769,32,21,53,60.4%,39m
5551,1,aaaaaaaaaaaa,2880,325,11,11,22,50.0%,41m
5551,1,ClockWise,2880,177,6,4,10,60.0%,41m
5551,2,Batman,2880,162,5,0,5,100.0%,43m
5551,2,시간을달려서,2880,102,4,1,5,80.0%,39m
5551,2,[Mecca]DarkZakal,2880,62,2,1,3,66.7%,43m
5551,2,Slayers,2880,0,0,1,1,0.0%,39m
5551,3,그럼난그만,2880,0,0,1,1,0.0%,16m
5551,2,Pure,2880,0,0,1,1,0.0%,18m
5561,1,[고급]메피스터,2879,530,24,25,49,49.0%,41m
5561,3,카페인홀릭,2879,232,7,22,29,24.1%,3m
5561,2,[달빛암흑기사]에스트,2879,0,1,0,1,100.0%,43m
5564,2,IllIllIllIll,2878,460,37,29,66,56.1%,43m
5564,1,[프로토스협회]Johnist,2878,165,7,7,14,50.0%,41m
5564,3,KangTechnic,2878,141,4,6,10,40.0%,2m
5564,2,소금돼지,2878,88,3,1,4,75.0%,44m
5568,1,[3121]akama,2877,585,51,51,102,50.0%,42m
5568,3,[엘리트]eLiteDragon,2877,273,9,18,27,33.3%,9m
5568,3,qkrehdgns,2877,133,5,3,8,62.5%,16m
5571,2,aram,2876,149,5,4,9,55.6%,18m
5571,2,넘썡,2876,88,3,2,5,60.0%,43m
5571,2,[Lost21]DelicateIX,2876,34,2,2,4,50.0%,42m
5571,2,[해병대]생새우초밥,2876,0,1,1,2,50.0%,43m
5571,2,hojun,2876,0,1,1,2,50.0%,43m
5571,2,[이쿠노]nightdm,2876,0,0,1,1,0.0%,42m
5577,1,lhh,2875,1223,228,214,442,51.6%,41m
5577,1,[Hyeri]killering,2875,314,15,13,28,53.6%,41m
5577,3,캐르나,2875,237,12,11,23,52.2%,12m
5577,1,바구미,2875,189,6,5,11,54.5%,41m
5577,1,청춘의특권,2875,90,4,7,11,36.4%,40m
5577,1,몽골간간징징,2875,0,3,2,5,60.0%,14m
5583,2,hotdog,2874,950,39,34,73,53.4%,39m
5583,2,ellasion,2874,587,24,15,39,61.5%,43m
5583,2,뇨로롱,2874,0,3,2,5,60.0%,39m
5583,1,CYpigking,2874,0,3,2,5,60.0%,15m
5583,3,IIIIIIIIIIII,2874,0,2,4,6,33.3%,16m
5588,1,BoutTo,2873,1074,48,40,88,54.5%,42m
5588,1,하하하하,2873,410,12,14,26,46.2%,41m
5588,3,Wreckedface,2873,262,8,14,22,36.4%,9m
5588,1,[Alps]Black,2873,183,5,7,12,41.7%,40m
5588,2,YWD,2873,88,4,2,6,66.7%,39m
5588,2,lllllllll,2873,153,4,5,9,44.4%,43m
5588,2,[꽃남]메카닉싫엉,2873,58,3,1,4,75.0%,44m
5588,3,[abcabc]llllllllllll,2873,0,3,3,6,50.0%,16m
5588,2,[이교도]죠죠,2873,72,3,4,7,42.9%,42m
5588,1,차추,2873,36,3,5,8,37.5%,42m
5588,2,[비트]LeeJay,2873,62,2,4,6,33.3%,39m
5588,2,똥건,2873,0,1,1,2,50.0%,42m
5588,2,전대토목,2873,36,1,3,4,25.0%,42m
5601,2,BarCode,2872,398,15,12,27,55.6%,39m
5601,2,HAN,2872,94,7,8,15,46.7%,18m
5601,3,RingRing,2872,112,5,5,10,50.0%,18m
5601,3,YJFlash,2872,0,4,3,7,57.1%,3m
5601,3,DAVAL,2872,97,4,3,7,57.1%,17m
5601,2,Best,2872,118,4,5,9,44.4%,43m
5601,2,[세미온TD]스윗한사찰오빠,2872,64,3,0,3,100.0%,43m
5601,3,우치하평타치,2872,0,3,3,6,50.0%,16m
5601,2,[Saber6]Doraion,2872,128,2,3,5,40.0%,39m
5601,1,녕오,2872,0,0,2,2,0.0%,40m
5611,3,Dicboy,2871,1181,111,99,210,52.9%,6m
5611,1,[광역어그로]CIC,2871,411,12,15,27,44.4%,41m
5611,3,iptime,2871,150,9,9,18,50.0%,6m
5611,2,[이기고싶어]vanish,2871,176,7,4,11,63.6%,39m
5611,2,pATCHpROTOSS,2871,155,5,2,7,71.4%,18m
5611,2,[Axiom]싸나이,2871,118,5,3,8,62.5%,43m
5611,2,[25냥이집사]동글동글뜌뗭이,2871,66,3,3,6,50.0%,43m
5611,3,전태양보는사람,2871,36,2,1,3,66.7%,16m
5611,2,[D3StaR]군밤소년,2871,0,0,1,1,0.0%,43m
5620,1,[골드함대]황금함대,2870,1346,174,169,343,50.7%,41m
5620,1,神族最後希望,2870,1418,123,121,244,50.4%,41m
5620,2,jokaraa,2870,709,59,53,112,52.7%,42m
5620,2,llllllllllll,2870,925,36,32,68,52.9%,43m
5620,2,[BlFF]Laffi,2870,126,4,5,9,44.4%,39m
5620,3,아쿠리스포리토,2870,84,4,6,10,40.0%,17m
5620,2,[GnSa]pro,2870,0,0,1,1,0.0%,43m
5620,2,iuyihjkj,2870,0,0,1,1,0.0%,43m
5628,1,azxzc,2869,1649,266,233,499,53.3%,40m
5628,3,붉은감자,2869,1258,62,63,125,49.6%,2m
5628,1,[PP1]柯文哲總統,2869,764,46,51,97,47.4%,42m
5628,1,iiiiiiiiiiii,2869,863,30,33,63,47.6%,41m
5628,2,[好難過好想哭]鈴鈴很可愛,2869,520,20,18,38,52.6%,43m
5628,2,griffin,2869,280,11,10,21,52.4%,43m
5628,2,레드문,2869,77,7,5,12,58.3%,44m
5628,2,[개굴맨]개구리배꼽,2869,92,3,5,8,37.5%,39m
5628,2,러블리킴,2869,0,0,1,1,0.0%,39m
5637,2,kptech,2868,1485,233,238,471,49.5%,4m
5637,3,KingWei,2868,655,28,30,58,48.3%,6m
5637,2,월요일,2868,180,9,7,16,56.2%,39m
5637,2,덕포찐찌버거,2868,145,5,1,6,83.3%,39m
5637,1,베레쉐트,2868,0,1,0,1,100.0%,10m
5637,2,Yusin,2868,0,0,2,2,0.0%,43m
5643,1,llllllllllll,2867,1456,86,79,165,52.1%,41m
5643,2,ENOMUJASHIK,2867,1215,48,42,90,53.3%,43m
5643,2,고척돔우천취소,2867,385,23,18,41,56.1%,43m
5643,3,박제민인성수준,2867,258,12,9,21,57.1%,8m
5643,2,머퉁이,2867,258,11,9,20,55.0%,43m
5643,2,[뭔가거대한]rock,2867,194,6,9,15,40.0%,44m
5643,2,Fate,2867,109,3,2,5,60.0%,19m
5643,3,xen,2867,0,3,3,6,50.0%,17m
5643,2,ALLEN,2867,0,1,1,2,50.0%,43m
5643,2,bensw,2867,0,0,3,3,0.0%,43m
5653,2,ByulsoODark,2866,812,67,60,127,52.8%,43m
5653,1,[GAL]鳴海兔亞,2866,1011,43,36,79,54.4%,40m
5653,1,EterNaL,2866,604,19,21,40,47.5%,42m
5653,1,뢰제의나라,2866,244,9,9,18,50.0%,42m
5653,2,[Spades]Dracun,2866,190,7,5,12,58.3%,43m
5653,2,HiRoShi,2866,144,5,4,9,55.6%,43m
5653,2,lIlIlIlIlIlI,2866,0,3,2,5,60.0%,39m
5653,2,[밀짚모해적단]구구까까,2866,0,1,1,2,50.0%,43m
5653,2,너의탄생,2866,0,0,1,1,0.0%,39m
5662,3,에릭,2865,1195,140,136,276,50.7%,6m
5662,1,MrGlassAnkle,2865,359,33,26,59,55.9%,42m
5662,1,이등병왕사,2865,735,32,20,52,61.5%,41m
5662,2,vector,2865,269,22,12,34,64.7%,43m
5662,2,IIIIIIIIIIII,2865,0,3,2,5,60.0%,39m
5662,2,deepbluesea,2865,0,2,2,4,50.0%,39m
5662,2,Eternity,2865,0,1,0,1,100.0%,43m
5662,2,[이신형제자]케찰코아툴루스,2865,0,1,1,2,50.0%,39m
5670,3,이꽃비,2864,1495,106,114,220,48.2%,6m
5670,1,가리,2864,1591,77,74,151,51.0%,42m
5670,1,Glory,2864,168,6,9,15,40.0%,42m
5670,1,MoonSungJin,2864,0,3,2,5,60.0%,14m
5670,2,똥차,2864,88,3,3,6,50.0%,43m
5670,2,고구마고광진,2864,0,1,0,1,100.0%,43m
5670,3,llllllllllll,2864,42,1,2,3,33.3%,16m
5670,1,테란토스개사기,2864,32,1,5,6,16.7%,41m
5670,1,AXION,2864,0,1,6,7,14.3%,42m
5679,3,[CnB]랜덤끄지라,2863,1489,68,73,141,48.2%,8m
5679,1,DarkDuck,2863,0,0,1,1,0.0%,10m
5679,2,Sunrice,2863,0,0,2,2,0.0%,43m
5682,2,angel,2862,1475,178,187,365,48.8%,17m
5682,1,동동동,2862,1113,93,89,182,51.1%,41m
5682,1,[柒拾伍]曾經滄海難為水,2862,1492,67,69,136,49.3%,42m
5682,1,真紅利亞,2862,1108,40,42,82,48.8%,42m
5682,2,맛있는청국장,2862,828,34,30,64,53.1%,43m
5682,1,okiyo,2862,182,5,9,14,35.7%,42m
5682,2,台灣留岛不留人,2862,143,3,5,8,37.5%,43m
5682,2,진호형이등,2862,0,0,1,1,0.0%,43m
5682,2,진호,2862,0,0,4,4,0.0%,39m
5691,1,DREAM,2861,410,12,13,25,48.0%,41m
5691,2,혜리내사랑,2861,94,2,1,3,66.7%,18m
5691,2,[기냥]퓨처스,2861,0,1,0,1,100.0%,39m
5691,2,Sinspecter,2861,30,1,1,2,50.0%,39m
5695,2,llllllllllll,2860,1599,209,200,409,51.1%,39m
5695,1,IIIIIIIIIIII,2860,201,8,14,22,36.4%,41m
5695,2,BlackArter,2860,178,7,4,11,63.6%,39m
5695,2,홧맨,2860,30,2,0,2,100.0%,43m
5695,3,likewater,2860,0,0,1,1,0.0%,32m
5700,1,짱개는패는개맛,2859,781,32,27,59,54.2%,42m
5700,2,GloryG,2859,645,28,24,52,53.8%,43m
5700,1,[스카이파이터]아구조아,2859,223,6,7,13,46.2%,40m
5700,1,needless,2859,95,2,0,2,100.0%,10m
5700,2,yourdad,2859,44,2,1,3,66.7%,17m
5700,2,staphylo,2859,0,0,2,2,0.0%,43m
5706,1,skyhrg,2858,528,21,18,39,53.8%,39m
5706,1,호잇,2858,551,17,20,37,45.9%,41m
5706,2,WizzleLi,2858,60,2,3,5,40.0%,44m
5706,2,[海膽王]KuasMDEking,2858,60,2,4,6,33.3%,43m
5706,2,Newyork,2858,34,1,4,5,20.0%,39m
5706,2,동빡입니다,2858,0,0,1,1,0.0%,43m
5712,1,llllllllllll,2857,582,19,24,43,44.2%,40m
5712,2,하루일민트,2857,441,17,12,29,58.6%,43m
5712,3,그거해,2857,184,8,12,20,40.0%,12m
5712,2,Leo,2857,0,1,0,1,100.0%,39m
5712,2,[어윤수님개쩜]Lilith,2857,0,0,1,1,0.0%,39m
5712,1,[포비아]뱜뱜,2857,0,0,4,4,0.0%,40m
5712,1,참치,2857,0,0,5,5,0.0%,42m
5719,2,略懂,2856,875,45,46,91,49.5%,43m
5719,1,두통엔파스,2856,473,33,22,55,60.0%,42m
5719,2,인사사령부,2856,576,24,17,41,58.5%,39m
5719,1,Jimbo,2856,241,11,12,23,47.8%,11m
5719,1,[AUE]나루시마,2856,301,9,8,17,52.9%,40m
5719,1,반듯불,2856,190,8,8,16,50.0%,40m
5719,1,theshy,2856,270,8,9,17,47.1%,42m
5719,1,꼬꾸녕엉,2856,0,4,1,5,80.0%,15m
5719,3,IIllIIlllIIl,2856,163,4,6,10,40.0%,6m
5719,1,Kioal,2856,0,3,2,5,60.0%,14m
5719,2,대경이,2856,0,1,2,3,33.3%,43m
5719,2,시박껏,2856,30,1,3,4,25.0%,43m
5719,2,조종관,2856,0,1,3,4,25.0%,43m
5719,2,聽說我是神,2856,0,0,1,1,0.0%,43m
5733,3,IIIIIII,2855,840,197,195,392,50.3%,7m
5733,2,Anpester,2855,1568,69,64,133,51.9%,43m
5733,1,llllIIIlll,2855,495,19,17,36,52.8%,40m
5733,2,speaknow,2855,302,11,10,21,52.4%,43m
5733,3,이다니,2855,0,2,1,3,66.7%,17m
5733,2,리듬엔블루스,2855,0,0,1,1,0.0%,39m
5739,1,jjanggu,2854,466,16,19,35,45.7%,42m
5739,2,꾸엑,2854,0,1,4,5,20.0%,39m
5739,2,ggabuljima,2854,0,0,1,1,0.0%,43m
5742,2,맹자,2853,903,36,28,64,56.2%,39m
5742,1,[짱이다]stormzerg,2853,404,14,16,30,46.7%,41m
5742,2,Legion,2853,266,10,8,18,55.6%,39m
5742,2,[더지니어스]김폰벨,2853,168,7,4,11,63.6%,44m
5742,2,꾸꿀,2853,171,7,7,14,50.0%,39m
5742,1,제라드웨이,2853,94,4,4,8,50.0%,41m
5742,2,ATLAS,2853,0,0,1,1,0.0%,43m
5749,1,[Bully]고수,2852,1233,153,177,330,46.4%,8m
5749,1,[꿀들]특대장어덮밥,2852,542,18,25,43,41.9%,40m
5749,3,Rehol,2852,182,10,11,21,47.6%,3m
5749,2,Mink,2852,90,4,2,6,66.7%,43m
5749,3,CodingHaZa,2852,135,4,2,6,66.7%,17m
5749,3,창고속오함마,2852,0,0,1,1,0.0%,16m
5749,2,알렉세이스투코프,2852,0,0,1,1,0.0%,39m
5756,1,burai,2851,598,55,47,102,53.9%,42m
5756,2,DeepmindSC,2851,262,11,3,14,78.6%,43m
5756,2,noori,2851,60,3,2,5,60.0%,43m
5756,2,[zAWSLz]達達,2851,0,1,1,2,50.0%,43m
5756,2,[이터널]숭늉이,2851,0,1,1,2,50.0%,39m
5761,2,TOMA,2850,278,11,4,15,73.3%,43m
5761,2,돈터치,2850,118,9,4,13,69.2%,43m
5761,2,달린다치타,2850,88,5,5,10,50.0%,39m
5761,2,HyuneeKun,2850,30,2,0,2,100.0%,43m
5761,3,고래,2850,0,0,1,1,0.0%,16m
5761,2,Kway,2850,0,0,2,2,0.0%,43m
5761,2,JIM,2850,0,0,3,3,0.0%,39m
5768,1,十八鄉教畜王鶯群,2849,1093,64,63,127,50.4%,41m
5768,2,[조고최]정갼천재,2849,1134,42,40,82,51.2%,39m
5768,2,학대파,2849,479,19,17,36,52.8%,43m
5768,1,IIIIIIIIIIII,2849,379,15,12,27,55.6%,41m
5768,2,장사장,2849,203,7,6,13,53.8%,19m
5768,3,米寶兒,2849,155,6,4,10,60.0%,17m
5768,1,Raynor,2849,48,3,3,6,50.0%,15m
5768,2,곰토끼,2849,66,3,5,8,37.5%,43m
5768,2,철이와보리,2849,30,2,0,2,100.0%,43m
5768,2,IKELoww,2849,0,1,0,1,100.0%,44m
5768,2,[ELS]테스형,2849,0,0,1,1,0.0%,43m
5779,3,dokyak,2848,1475,246,239,485,50.7%,3m
5779,2,NoName,2848,285,10,8,18,55.6%,18m
5779,2,埤崁子怪,2848,138,7,3,10,70.0%,39m
5779,2,신사,2848,30,2,1,3,66.7%,43m
5779,2,내가내다,2848,0,0,1,1,0.0%,39m
5784,1,꾸드득꾸드득,2847,1537,124,131,255,48.6%,5m
5784,2,단군의얇은단검,2847,1214,102,84,186,54.8%,43m
5784,2,onionkinght,2847,0,0,1,1,0.0%,44m
5784,3,肋骨終結者,2847,0,0,1,1,0.0%,16m
5784,1,IIIIIIIIIIII,2847,0,0,6,6,0.0%,40m
5789,2,네란두스,2846,128,4,1,5,80.0%,39m
5789,1,SEVERE,2846,145,4,8,12,33.3%,40m
5789,1,IIIIIIIIIIII,2846,0,3,2,5,60.0%,14m
5789,1,RyoKo,2846,0,1,2,3,33.3%,42m
5789,2,[Weihai]Kaimera,2846,30,1,3,4,25.0%,43m
5789,2,Thanos,2846,0,0,1,1,0.0%,39m
5795,2,kama,2845,975,41,34,75,54.7%,39m
5795,2,형파이터,2845,1056,37,38,75,49.3%,44m
5795,2,박밝음,2845,594,22,19,41,53.7%,43m
5795,2,liangsun,2845,187,11,7,18,61.1%,43m
5795,2,RilakKuma,2845,0,0,1,1,0.0%,43m
5795,2,Sadistic,2845,0,0,2,2,0.0%,43m
5801,3,[TalenT]IIIIIIIIIIII,2844,1236,83,74,157,52.9%,9m
5801,2,신쿤,2844,88,5,5,10,50.0%,18m
5801,2,바이너스,2844,0,3,2,5,60.0%,39m
5801,3,위드,2844,0,3,3,6,50.0%,16m
5801,2,IIIIIIIIIIII,2844,44,2,2,4,50.0%,18m
5801,2,YGodSoGood,2844,0,1,0,1,100.0%,43m
5801,2,新冠還是武漢肺炎,2844,0,0,3,3,0.0%,43m
5808,2,llllllllIIIl,2843,859,74,70,144,51.4%,43m
5808,2,[마법쓰는]유미,2843,102,5,3,8,62.5%,43m
5808,3,김진효사냥감,2843,135,5,4,9,55.6%,17m
5808,2,allegrissimo,2843,79,4,3,7,57.1%,44m
5808,1,Yona,2843,88,3,4,7,42.9%,39m
5808,3,유도쪼아,2843,0,0,1,1,0.0%,16m
5814,1,나찰,2842,494,15,20,35,42.9%,42m
5814,1,Pollicewoman,2842,157,7,6,13,53.8%,11m
5814,2,하앤미,2842,30,5,3,8,62.5%,39m
5814,2,포항제철,2842,146,5,7,12,41.7%,39m
5814,2,GARRYTANG,2842,30,2,0,2,100.0%,43m
5814,2,그냥영떡,2842,0,1,0,1,100.0%,43m
5814,2,시구나,2842,0,0,1,1,0.0%,39m
5821,2,jung,2841,457,17,13,30,56.7%,43m
5821,2,[SpM]CavalrySaber,2841,300,9,10,19,47.4%,39m
5821,2,pum,2841,140,6,3,9,66.7%,39m
5821,2,Piggy,2841,144,6,5,11,54.5%,39m
5821,3,불타는데하카,2841,97,2,1,3,66.7%,16m
5821,2,[시럽]바코드는벌레,2841,0,0,1,1,0.0%,43m
5821,2,never,2841,0,0,1,1,0.0%,39m
5821,1,빨강색나무,2841,0,0,10,10,0.0%,42m
5829,2,陳幸祥,2840,1506,476,433,909,52.4%,2m
5829,2,[중금속중독자]도도의노예다다,2840,718,26,23,49,53.1%,43m
5829,1,qtgamepoe,2840,140,4,4,8,50.0%,40m
5829,2,[니코틴패스]벤젠,2840,30,2,1,3,66.7%,39m
5829,2,[한조]프로토스,2840,0,0,1,1,0.0%,43m
5834,2,WURCF,2839,893,42,33,75,56.0%,43m
5834,2,[護士小姐讚]體檢時充血,2839,590,26,23,49,53.1%,44m
5834,1,iLLuSioN,2839,368,12,14,26,46.2%,42m
5834,2,LTOracle,2839,221,9,7,16,56.2%,39m
5834,1,[셀레스티아]핑카미나,2839,0,1,4,5,20.0%,15m
5839,3,입체영상,2838,0,3,4,7,42.9%,17m
5839,1,MyLongBow,2838,0,0,6,6,0.0%,40m
5841,1,[머구폐렴]SCHeRoKun,2837,1503,227,210,437,51.9%,39m
5841,2,zerg,2837,311,13,3,16,81.2%,43m
5841,2,담가먹는탕수육,2837,30,2,0,2,100.0%,43m
5841,2,ddochi,2837,0,0,1,1,0.0%,43m
5845,1,Prognathous,2836,1484,94,84,178,52.8%,41m
5845,2,llllllllllll,2836,760,32,19,51,62.7%,39m
5845,2,ABtoYZ,2836,615,24,19,43,55.8%,43m
5845,2,[AFO]칠만육천원,2836,123,3,3,6,50.0%,39m
5845,2,말년만빵,2836,0,1,1,2,50.0%,43m
5850,2,우산장수,2835,1322,53,45,98,54.1%,43m
5850,2,[NGamE2]smelter,2835,295,34,19,53,64.2%,43m
5850,2,열혈남아,2835,348,13,9,22,59.1%,39m
5850,2,쿠폰받아가세요,2835,144,6,5,11,54.5%,43m
5850,2,[예쁜김다미]이쁘다미,2835,138,2,5,7,28.6%,19m
5850,1,IHatePotato,2835,0,1,0,1,100.0%,14m
5850,1,EHOL,2835,0,0,3,3,0.0%,15m
5850,2,Alarak,2835,0,0,3,3,0.0%,39m
5858,2,immortalsho,2834,1401,478,472,950,50.3%,17m
5858,2,CKBlur,2834,956,37,32,69,53.6%,43m
5858,2,dmsqlWKd,2834,240,11,8,19,57.9%,39m
5858,1,Siryon,2834,40,3,6,9,33.3%,42m
5858,3,[TWorld]MARVEL,2834,40,2,7,9,22.2%,16m
5858,2,크리그마리네,2834,95,1,1,2,50.0%,43m
5864,2,[IWYDI]SnowBall,2833,1481,187,191,378,49.5%,7m
5864,3,DearName,2833,842,37,33,70,52.9%,2m
5864,1,lllllllllllI,2833,292,15,8,23,65.2%,42m
5864,1,[설희러버]눈의희열,2833,0,3,5,8,37.5%,40m
5864,1,guardian,2833,30,1,5,6,16.7%,41m
5864,2,dager,2833,0,0,1,1,0.0%,39m
5864,2,可愛小烈子我老婆,2833,0,0,1,1,0.0%,43m
5871,1,ShinyLight,2832,1282,59,57,116,50.9%,41m
5871,2,스카이,2832,948,37,37,74,50.0%,44m
5871,2,Dekomo,2832,668,27,21,48,56.2%,39m
5871,2,contracting,2832,317,12,8,20,60.0%,39m
5871,2,[FSHVM]Ephinephrine,2832,202,9,3,12,75.0%,44m
5871,2,AceTom,2832,0,2,3,5,40.0%,43m
5871,2,Peacewind,2832,0,2,3,5,40.0%,44m
5878,1,ReciProcity,2831,1558,72,60,132,54.5%,40m
5878,1,[여신조희아]홍요환,2831,1473,71,77,148,48.0%,41m
5878,1,매력기,2831,630,21,26,47,44.7%,41m
5878,1,뀨로로,2831,436,16,20,36,44.4%,42m
5878,1,철갑군단장,2831,183,7,6,13,53.8%,41m
5878,3,뽑아보니일꾼,2831,165,4,2,6,66.7%,17m
5878,3,남자답게,2831,0,1,1,2,50.0%,17m
5878,2,끝까지가다,2831,30,1,4,5,20.0%,43m
5886,1,LKK,2830,1473,247,215,462,53.5%,39m
5886,3,풀무원,2830,0,5,2,7,71.4%,16m
5886,2,원준이,2830,102,3,0,3,100.0%,39m
5886,2,威威,2830,0,1,0,1,100.0%,43m
5890,1,기쁨,2829,1571,147,135,282,52.1%,40m
5890,2,NoaH,2829,680,25,26,51,49.0%,44m
5890,2,jkj,2829,160,4,2,6,66.7%,43m
5890,1,[원조할매꿀밤]삼시환,2829,0,3,2,5,60.0%,15m
5890,2,tony,2829,0,3,2,5,60.0%,39m
5890,2,JupiterSW,2829,0,0,1,1,0.0%,44m
5890,2,브리슬,2829,0,0,2,2,0.0%,39m
5897,1,닉네임,2828,1575,216,204,420,51.4%,40m
5897,2,[박보영과사나]헨진만개,2828,1090,48,44,92,52.2%,43m
5897,1,총무,2828,1066,45,35,80,56.2%,40m
5897,1,BeauTiCian,2828,248,9,18,27,33.3%,41m
5897,2,llllllllllll,2828,126,4,0,4,100.0%,44m
5897,2,creamc,2828,116,4,0,4,100.0%,39m
5897,2,win,2828,120,4,6,10,40.0%,43m
5904,1,[어둠의사신단]chldnlska,2827,1612,176,180,356,49.4%,42m
5904,2,knightzz,2827,345,11,18,29,37.9%,43m
5904,2,교토상가,2827,146,6,6,12,50.0%,43m
5904,2,초보,2827,30,2,0,2,100.0%,39m
5904,2,페르미르,2827,0,0,1,1,0.0%,44m
5909,1,우주,2826,1562,221,214,435,50.8%,42m
5909,2,我的小女时代,2826,1537,187,179,366,51.1%,39m
5909,1,Linith,2826,779,65,59,124,52.4%,42m
5909,2,북박북박,2826,1435,59,47,106,55.7%,43m
5909,2,[zAWSLz]SnShadow,2826,751,40,27,67,59.7%,39m
5909,2,[갓세정]김세정,2826,729,34,27,61,55.7%,39m
5909,1,미친존재감,2826,320,20,18,38,52.6%,41m
5909,3,이퀼리브리엄,2826,420,17,19,36,47.2%,6m
5909,2,ken,2826,208,6,5,11,54.5%,43m
5909,2,miguel,2826,105,4,3,7,57.1%,39m
5919,2,Kofv,2825,1235,62,58,120,51.7%,43m
5919,2,喵尼,2825,503,20,16,36,55.6%,43m
5919,2,파이,2825,450,16,17,33,48.5%,44m
5919,2,[習近平]lIlIIlIIlIIl,2825,164,4,5,9,44.4%,39m
5919,3,아리아나브이란데,2825,74,4,5,9,44.4%,17m
5919,2,뮤류,2825,148,4,6,10,40.0%,19m
5919,1,redwine,2825,96,4,8,12,33.3%,40m
5919,2,[버터오징어]MADkiller,2825,58,3,3,6,50.0%,43m
5919,2,Gift,2825,116,2,5,7,28.6%,19m
5919,2,가나다라마바사아,2825,0,1,0,1,100.0%,39m
5919,2,LAN,2825,0,0,3,3,0.0%,43m
5930,1,Libra,2824,1591,115,103,218,52.8%,41m
5930,1,현이,2824,999,45,40,85,52.9%,41m
5930,2,blackswas,2824,623,24,23,47,51.1%,43m
5930,2,LLCLOL,2824,274,10,6,16,62.5%,10m
5930,2,VANHELSING,2824,158,4,3,7,57.1%,43m
5935,1,MuCepHeI,2823,1005,60,53,113,53.1%,42m
5935,2,lllIIIl,2823,1053,41,37,78,52.6%,43m
5935,2,ISAAC,2823,260,10,6,16,62.5%,44m
5935,2,lllllllllll,2823,139,5,5,10,50.0%,18m
5935,2,노대리야끼,2823,140,5,16,21,23.8%,18m
5935,2,Tossgirl,2823,120,3,1,4,75.0%,43m
5935,2,[어둠의사신단]어둠의검신,2823,115,2,2,4,50.0%,39m
5935,2,master,2823,34,2,6,8,25.0%,43m
5935,2,jin,2823,0,1,1,2,50.0%,39m
5935,2,CloudKing,2823,76,1,1,2,50.0%,43m
5935,2,아구찜장인,2823,30,1,2,3,33.3%,43m
5946,3,diffph,2822,1569,170,172,342,49.7%,7m
5946,1,karuma,2822,506,61,53,114,53.5%,42m
5946,2,闇焰風暴,2822,1031,40,38,78,51.3%,43m
5946,2,니조랄,2822,671,30,18,48,62.5%,43m
5946,2,[BHN]IrieCome,2822,456,18,12,30,60.0%,43m
5946,1,Essien,2822,550,18,24,42,42.9%,40m
5946,3,망고맛땅콩,2822,275,9,13,22,40.9%,9m
5946,3,White,2822,40,4,4,8,50.0%,17m
5946,2,Augero,2822,159,4,9,13,30.8%,19m
5946,2,안녕하세요,2822,30,2,1,3,66.7%,43m
5946,1,IMFatOrz,2822,62,2,7,9,22.2%,41m
5946,2,쓸거라,2822,0,1,4,5,20.0%,39m
5946,3,포유,2822,0,0,1,1,0.0%,16m
5946,2,[TeamB]폭군다람쥐,2822,0,0,5,5,0.0%,39m
5960,2,uchiha,2821,1535,70,64,134,52.2%,43m
5960,2,Fkiller,2821,516,24,12,36,66.7%,39m
5960,2,KirCruel,2821,544,20,23,43,46.5%,43m
5960,1,[705666]白奶油,2821,338,12,18,30,40.0%,41m
5960,2,llllllllll,2821,139,6,4,10,60.0%,43m
5960,2,패고보니여친,2821,66,3,2,5,60.0%,43m
5960,2,텍사스불빠따,2821,0,1,0,1,100.0%,18m
5960,2,빵집점장,2821,0,0,1,1,0.0%,43m
5960,2,[더지니어스]SupperStar,2821,0,0,1,1,0.0%,43m
5969,1,lIllllllIIII,2820,1033,39,45,84,46.4%,41m
5969,1,정예신병,2820,985,35,38,73,47.9%,41m
5969,2,safemephit,2820,285,12,9,21,57.1%,43m
5969,2,東山笑笑生,2820,181,8,6,14,57.1%,43m
5969,3,고냥이,2820,121,4,4,8,50.0%,16m
5969,2,baecome,2820,30,2,1,3,66.7%,44m
5969,2,IlIIlllIllII,2820,30,2,1,3,66.7%,43m
5976,1,넘못해난,2819,191,8,12,20,40.0%,12m
5976,2,[너의ol름은]TJRTMD,2819,30,2,5,7,28.6%,43m
5976,1,정빈이,2819,122,2,7,9,22.2%,42m
5976,1,김광필,2819,0,1,2,3,33.3%,40m
5976,2,[협전장인]미세이돈,2819,0,0,1,1,0.0%,44m
5976,2,[시공젛아]몽둥읭망븡,2819,0,0,3,3,0.0%,10m
5982,2,ultra,2818,936,37,30,67,55.2%,43m
5982,2,Eric,2818,253,13,9,22,59.1%,43m
5982,1,SGK,2818,0,3,2,5,60.0%,15m
5982,3,LeToucan,2818,97,1,1,2,50.0%,16m
5982,3,武汉加油中国加油,2818,0,0,1,1,0.0%,17m
5987,2,바키준,2817,376,15,11,26,57.7%,44m
5987,3,[xTMDx]八德腿王,2817,210,7,20,27,25.9%,6m
5987,1,캔수,2817,116,3,8,11,27.3%,41m
5987,2,zhangwei,2817,0,1,0,1,100.0%,43m
5987,2,고철로봇,2817,0,0,1,1,0.0%,43m
5992,3,SniperAbeter,2816,1408,128,132,260,49.2%,7m
5992,1,[sc2mc]살뺄돈없어,2816,1317,97,95,192,50.5%,40m
5992,2,Snuggles,2816,888,34,34,68,50.0%,43m
5992,1,인연,2816,629,30,21,51,58.8%,42m
5992,2,Vonix,2816,404,15,13,28,53.6%,43m
5992,2,xelnaga,2816,66,3,2,5,60.0%,43m
5992,2,Leo,2816,88,1,1,2,50.0%,39m
5999,2,[비트]몽몽몽,2815,1506,266,256,522,51.0%,43m
5999,1,연수,2815,1203,48,46,94,51.1%,42m
5999,2,BATYA,2815,452,29,2,31,93.5%,43m
5999,2,TrendSoDa,2815,476,16,16,32,50.0%,39m
5999,3,大佑池九,2815,97,4,3,7,57.1%,17m
5999,2,세이진,2815,92,3,5,8,37.5%,43m
5999,3,[자유의유산]우민,2815,34,2,0,2,100.0%,16m
6006,3,Errance,2814,1502,107,115,222,48.2%,6m
6006,1,[ProTT]브미브,2814,369,14,13,27,51.9%,40m
6006,2,Yukiphys,2814,180,8,8,16,50.0%,44m
6006,2,[하수처리장]조홀스,2814,0,2,3,5,40.0%,39m
6006,3,고구마장사,2814,0,1,2,3,33.3%,17m
6006,1,개새기,2814,0,0,1,1,0.0%,15m
6012,2,Daehan,2813,142,6,9,15,40.0%,43m
6012,2,NOVA,2813,164,5,3,8,62.5%,39m
6012,2,사물렌즈,2813,30,4,3,7,57.1%,39m
6012,2,QuirkyTurtle,2813,0,2,3,5,40.0%,43m
6012,2,때리,2813,0,1,0,1,100.0%,43m
6012,2,Plays,2813,30,1,3,4,25.0%,39m
6012,2,[不打快攻]晨光伴隨夜曲,2813,30,1,3,4,25.0%,43m
6019,2,Paolord,2812,494,34,22,56,60.7%,44m
6019,2,다현쓰,2812,776,33,25,58,56.9%,43m
6019,2,[민창렬]스타진짜안함,2812,370,13,14,27,48.1%,43m
6019,2,IIIIlllIIllI,2812,198,10,14,24,41.7%,43m
6019,2,noodle,2812,86,4,3,7,57.1%,44m
6019,3,IIIIIIIIlllI,2812,122,4,4,8,50.0%,16m
6019,2,빌리언,2812,0,1,1,2,50.0%,39m
6026,1,jin,2811,479,17,16,33,51.5%,39m
6026,2,초승달유튜브구독,2811,166,6,5,11,54.5%,10m
6026,2,개인기,2811,166,5,3,8,62.5%,43m
6026,2,destinian,2811,93,4,5,9,44.4%,43m
6026,2,[쇼타임]테스형,2811,102,3,0,3,100.0%,39m
6026,2,[무한양승준]Yuraeha,2811,58,3,2,5,60.0%,43m
6026,2,[DoBTeN]Yee,2811,0,0,1,1,0.0%,43m
6033,2,[랜덤광]씽씽,2810,926,35,33,68,51.5%,43m
6033,1,[아르미다]메쿠,2810,142,4,13,17,23.5%,41m
6033,1,일등병,2810,48,3,3,6,50.0%,15m
6033,2,배원찬,2810,93,2,0,2,100.0%,18m
6033,3,Gennaro,2810,0,1,0,1,100.0%,16m
6033,2,[ANGG]저글링날아요츙츙,2810,0,0,1,1,0.0%,39m
6039,2,라라,2809,1341,53,45,98,54.1%,43m
6039,2,[SofT]SKTFaker,2809,387,17,12,29,58.6%,39m
6039,2,[04s]END,2809,0,1,0,1,100.0%,43m
6039,3,IlIlIlllIII,2809,0,0,2,2,0.0%,17m
6039,2,[101010]벌레,2809,0,0,3,3,0.0%,39m
6044,1,Lobster,2808,1573,92,88,180,51.1%,42m
6044,1,KAWASAKI,2808,1221,67,71,138,48.6%,42m
6044,2,keepthepace,2808,1029,50,44,94,53.2%,43m
6044,2,미스터츄,2808,450,21,12,33,63.6%,43m
6044,2,Scored,2808,0,3,2,5,60.0%,43m
6044,2,KikiOG,2808,0,2,3,5,40.0%,39m
6044,1,滿漢全席,2808,0,0,1,1,0.0%,12m
6051,2,이경란넌내꺼,2807,181,7,12,19,36.8%,44m
6051,1,레오루,2807,162,4,5,9,44.4%,40m
6051,2,Eurasian,2807,88,3,1,4,75.0%,43m
6051,3,starno,2807,42,2,0,2,100.0%,17m
6051,2,Bulgogi,2807,0,1,0,1,100.0%,39m
6056,2,[敗人品系列]NoeZues,2806,219,8,3,11,72.7%,18m
6056,2,오상헌,2806,236,7,11,18,38.9%,18m
6056,2,不需要愛,2806,0,1,0,1,100.0%,44m
6056,2,[LaMa]moonstar,2806,92,1,1,2,50.0%,10m
6056,2,ravieoly,2806,0,1,3,4,25.0%,43m
6061,2,showmethemon,2805,936,46,32,78,59.0%,39m
6061,2,Rain,2805,573,31,32,63,49.2%,43m
6061,2,[연패현]조용한아침,2805,434,16,14,30,53.3%,43m
6061,1,Noobsia,2805,306,11,10,21,52.4%,11m
6061,3,DonkeyBandit,2805,185,5,6,11,45.5%,17m
6061,2,준치십새기,2805,136,4,2,6,66.7%,43m
6061,2,스타,2805,30,1,3,4,25.0%,43m
6061,1,앞집여자,2805,0,0,3,3,0.0%,40m
6069,1,타락,2804,1502,179,165,344,52.0%,42m
6069,2,[조직]skywalker,2804,1041,78,69,147,53.1%,43m
6069,3,꾸밈,2804,1347,54,55,109,49.5%,6m
6069,1,sAviOr,2804,739,38,40,78,48.7%,42m
6069,2,Bee,2804,594,32,27,59,54.2%,43m
6069,2,Asterdor,2804,306,12,6,18,66.7%,43m
6069,3,lee,2804,163,6,5,11,54.5%,16m
6069,2,sunhops,2804,176,5,4,9,55.6%,44m
6069,2,니친구,2804,187,5,5,10,50.0%,43m
6069,1,Kornilie,2804,32,4,4,8,50.0%,42m
6069,2,[GIS]負能量肥宅,2804,0,3,2,5,60.0%,39m
6069,2,Patan,2804,0,3,2,5,60.0%,39m
6069,2,StrafeMasta,2804,0,3,2,5,60.0%,39m
6069,2,삶이즐겁습니까,2804,64,2,6,8,25.0%,39m
6083,1,Atsushi,2803,1585,105,88,193,54.4%,42m
6083,2,프통령,2803,518,21,15,36,58.3%,43m
6083,2,Siamese,2803,256,10,9,19,52.6%,43m
6083,1,파도,2803,312,10,17,27,37.0%,42m
6083,3,Tales,2803,0,5,1,6,83.3%,17m
6083,3,pavelskim,2803,38,1,4,5,20.0%,17m
6089,2,lcp,2802,1374,82,78,160,51.2%,43m
6089,2,읭읭읭,2802,447,19,12,31,61.3%,44m
6089,2,Kiw,2802,142,6,6,12,50.0%,19m
6089,2,마린사령관,2802,62,3,3,6,50.0%,43m
6089,1,썬더케리건앰이,2802,0,1,0,1,100.0%,15m
6094,2,[Worm]샴푸의누나요정,2801,1568,108,101,209,51.7%,43m
6094,2,HotSoup,2801,957,62,57,119,52.1%,43m
6094,1,韓國瑜珈教練,2801,590,49,47,96,51.0%,42m
6094,2,Ovaavis,2801,1164,44,48,92,47.8%,39m
6094,2,Xero,2801,1030,43,32,75,57.3%,43m
6094,2,sinnaji,2801,261,18,16,34,52.9%,43m
6094,2,하루,2801,244,11,7,18,61.1%,39m
6094,2,[RAM4GB]KurumiJJing,2801,158,6,5,11,54.5%,43m
6094,2,IIIIIIIIIIII,2801,90,3,6,9,33.3%,39m
6094,2,핫신,2801,0,1,0,1,100.0%,43m
6094,2,Ramalamadam,2801,0,0,1,1,0.0%,39m
6105,2,제로,2800,210,10,7,17,58.8%,44m
6105,2,비광,2800,60,3,5,8,37.5%,43m
6105,3,[캬루]그랜드마스터,2800,93,2,1,3,66.7%,44m
6108,1,한번만,2799,1604,100,90,190,52.6%,40m
6108,2,[근본은말보루]주태양,2799,316,27,26,53,50.9%,43m
6108,2,艾格拉斯,2799,328,12,9,21,57.1%,43m
6108,2,marketwizard,2799,296,10,12,22,45.5%,43m
6108,2,凹凹凸凸的光,2799,174,7,9,16,43.8%,43m
6108,1,블러드테일,2799,198,7,13,20,35.0%,42m
6108,2,khoa,2799,132,6,3,9,66.7%,43m
6108,3,류아이,2799,96,2,0,2,100.0%,44m
6108,2,제로아워,2799,0,2,4,6,33.3%,43m
6108,3,xxxxxxxxxxxx,2799,18,1,1,2,50.0%,39m
6118,3,[얼굴]모선,2798,147,6,5,11,54.5%,16m
6118,2,Coco,2798,150,5,9,14,35.7%,44m
6118,1,asd,2798,114,3,12,15,20.0%,42m
6118,2,[분노조절장애]화나면뒤없는사람,2798,30,1,5,6,16.7%,43m
6122,2,Frog,2797,1201,244,252,496,49.2%,17m
6122,2,Akame,2797,330,14,14,28,50.0%,43m
6122,2,conbin,2797,256,8,8,16,50.0%,44m
6122,2,[쇄국정책]저그족사기너프해,2797,176,7,8,15,46.7%,39m
6122,3,TerranL,2797,142,3,3,6,50.0%,38m
6122,1,mongking,2797,0,2,3,5,40.0%,15m
6122,2,[SS친위대]독일,2797,58,2,4,6,33.3%,43m
6122,2,Yura,2797,0,1,3,4,25.0%,43m
6122,2,llllllllllll,2797,0,0,1,1,0.0%,18m
6122,2,비가,2797,0,0,5,5,0.0%,39m
6132,3,[레더]lIlllIIIllIl,2796,140,6,2,8,75.0%,12m
6132,3,막시무스,2796,0,1,0,1,100.0%,12m
6132,2,RequiemStory,2796,0,1,2,3,33.3%,43m
6132,3,crusader,2796,0,1,2,3,33.3%,32m
6132,2,[진격의에렌]allMiyeon,2796,0,1,3,4,25.0%,39m
6132,3,kjnhugyuftrd,2796,0,0,2,2,0.0%,38m
6138,2,[isnous]Terminater,2795,562,23,20,43,53.5%,44m
6138,2,NOBLE,2795,572,20,19,39,51.3%,43m
6138,2,chaosfuture,2795,242,9,6,15,60.0%,39m
6138,2,다락이네,2795,154,5,12,17,29.4%,43m
6138,2,Mohandar,2795,0,1,1,2,50.0%,39m
6143,1,BGdevilin,2794,172,9,9,18,50.0%,42m
6143,2,[극채색]승건,2794,264,9,11,20,45.0%,44m
6143,2,[인투더]IntoTheGahee,2794,246,8,12,20,40.0%,43m
6143,1,르무엘,2794,168,5,13,18,27.8%,42m
6143,2,카스트,2794,0,0,2,2,0.0%,39m
6148,2,Kasyanov,2793,377,14,13,27,51.9%,39m
6148,1,정인,2793,204,6,5,11,54.5%,10m
6148,1,mooilkshakke,2793,48,3,3,6,50.0%,14m
6148,3,TIDUS,2793,48,2,1,3,66.7%,12m
6148,3,제너럴,2793,0,0,1,1,0.0%,17m
6153,2,[건국]abase,2792,447,104,93,197,52.8%,43m
6153,2,[패자는피를]미르존,2792,608,24,16,40,60.0%,43m
6153,2,乾麵,2792,240,9,7,16,56.2%,43m
6153,3,쇼바,2792,30,5,1,6,83.3%,39m
6153,2,다게임,2792,60,3,6,9,33.3%,43m
6153,2,LovesickGirl,2792,92,3,7,10,30.0%,39m
6159,2,[OZXA1]ozasd,2791,1462,286,262,548,52.2%,44m
6159,2,아르타니스,2791,1234,53,51,104,51.0%,43m
6159,2,stemcell,2791,537,27,23,50,54.0%,43m
6159,1,[너의ol름은]IIIIIIIIIIII,2791,192,6,6,12,50.0%,41m
6159,2,IIIIIIIIIIII,2791,145,5,4,9,55.6%,44m
6159,1,나연니,2791,0,3,3,6,50.0%,40m
6159,1,goodman,2791,48,3,3,6,50.0%,15m
6166,1,llllllllll,2790,248,31,32,63,49.2%,41m
6166,3,역장,2790,170,6,5,11,54.5%,16m
6166,2,lhsong,2790,166,5,4,9,55.6%,44m
6166,3,LWatson,2790,62,4,10,14,28.6%,7m
6170,3,ggppabc,2789,30,2,0,2,100.0%,44m
6170,2,Obama,2789,102,2,2,4,50.0%,43m
6170,1,긴다리,2789,0,0,1,1,0.0%,15m
6170,3,땡칠이,2789,0,0,1,1,0.0%,39m
6174,1,스타충,2788,1583,146,144,290,50.3%,42m
6174,1,IIIIIIIIIIII,2788,1517,100,89,189,52.9%,42m
6174,3,Zap,2788,1028,64,52,116,55.2%,44m
6174,3,欠人谷亭,2788,877,36,29,65,55.4%,39m
6174,2,[064]youevery,2788,318,12,12,24,50.0%,43m
6179,3,호로시키들,2787,1155,101,103,204,49.5%,9m
6179,2,[프리메이슨]찜질방구운김계란,2787,449,18,14,32,56.2%,43m
6179,1,shern,2787,520,16,24,40,40.0%,42m
6179,2,jonester,2787,194,11,9,20,55.0%,44m
6179,2,[fokuri]PylonWizard,2787,166,5,3,8,62.5%,43m
6179,3,Effortless,2787,121,4,4,8,50.0%,16m
6179,3,Gooday,2787,0,3,2,5,60.0%,39m
6179,3,哪裡預見,2787,30,2,0,2,100.0%,39m
6179,3,[LNGf]IIIIIIIIIIII,2787,0,2,3,5,40.0%,39m
6179,2,Avangarde,2787,30,2,5,7,28.6%,43m
6189,2,매력가이,2786,1488,320,296,616,51.9%,43m
6189,1,Tyrr,2786,1597,190,179,369,51.5%,42m
6189,2,TeamA,2786,918,175,165,340,51.5%,43m
6189,2,呆呆,2786,639,43,36,79,54.4%,43m
6189,2,[밀짚모해적단]Woods,2786,713,30,19,49,61.2%,43m
6189,2,Yaooo,2786,341,12,14,26,46.2%,43m
6189,3,llllllllllll,2786,188,7,11,18,38.9%,9m
6189,2,Vic,2786,102,6,2,8,75.0%,39m
6189,3,무무갓,2786,183,4,4,8,50.0%,16m
6189,1,[1학년5반]predator,2786,0,2,1,3,66.7%,14m
6199,2,Gucci,2785,674,25,24,49,51.0%,43m
6199,2,UnicJoker,2785,210,7,7,14,50.0%,18m
6199,1,꽃흔들유라흔들,2785,96,4,3,7,57.1%,15m
6199,1,Rafale,2785,0,3,3,6,50.0%,15m
6199,3,jel,2785,0,0,1,1,0.0%,44m
6204,3,seo,2784,677,24,35,59,40.7%,4m
6204,3,redix,2784,146,5,5,10,50.0%,12m
6204,3,[무한김준현]ableton,2784,0,3,3,6,50.0%,16m
6204,3,MAX,2784,0,1,0,1,100.0%,38m
6208,2,김주원,2783,408,19,8,27,70.4%,43m
6208,1,[GgYy]布丁狗,2783,350,15,13,28,53.6%,40m
6208,2,sILenZe,2783,210,14,17,31,45.2%,43m
6208,3,돌다리,2783,204,6,6,12,50.0%,16m
6208,3,TheViksBack,2783,30,3,3,6,50.0%,44m
6208,3,星芷曜,2783,97,2,0,2,100.0%,17m
6208,2,jimmybomb,2783,114,2,3,5,40.0%,43m
6208,1,soulkick,2783,122,2,9,11,18.2%,40m
6208,3,gdlk,2783,0,1,0,1,100.0%,39m
6217,2,제눈물이증거에요,2782,1370,98,83,181,54.1%,39m
6217,3,[暗夜洌鶇]Firewilling,2782,410,16,4,20,80.0%,44m
6217,2,Foki,2782,175,6,6,12,50.0%,43m
6217,2,NOONE,2782,144,5,12,17,29.4%,43m
6217,3,Max,2782,143,4,5,9,44.4%,39m
6217,3,티모,2782,0,1,0,1,100.0%,13m
6217,1,노날두,2782,0,0,1,1,0.0%,15m
6224,3,cloud,2781,672,26,20,46,56.5%,44m
6224,1,Barcode,2781,78,4,4,8,50.0%,40m
6224,1,RimGa,2781,89,4,4,8,50.0%,40m
6224,2,zzzzz,2781,64,3,4,7,42.9%,44m
6224,3,GREED,2781,97,1,5,6,16.7%,44m
6224,3,[동방]달팽이오빠,2781,0,0,1,1,0.0%,12m
6230,1,수능이문제,2780,478,16,21,37,43.2%,42m
6230,3,Rain,2780,148,7,7,14,50.0%,39m
6230,2,cjjoax,2780,89,4,3,7,57.1%,43m
6230,2,李瑋,2780,132,4,10,14,28.6%,43m
6230,2,토스성애자,2780,93,1,2,3,33.3%,39m
6230,2,kriogeN,2780,0,1,3,4,25.0%,43m
6236,2,NotAvailable,2779,1000,79,68,147,53.7%,43m
6236,1,보드,2779,429,17,19,36,47.2%,42m
6236,3,BrO,2779,114,5,2,7,71.4%,44m
6236,2,Jayden,2779,88,2,1,3,66.7%,43m
6240,1,엔타로테사다르,2778,1163,224,215,439,51.0%,41m
6240,2,[JUNG]아리,2778,1557,98,94,192,51.0%,43m
6240,2,夜空,2778,300,14,14,28,50.0%,44m
6240,3,[hl1234]ppboy,2778,166,7,2,9,77.8%,44m
6240,3,Guruha,2778,135,5,3,8,62.5%,39m
6240,1,asd,2778,0,4,1,5,80.0%,16m
6240,3,쏘나타,2778,58,3,1,4,75.0%,44m
6240,2,Wynan,2778,142,3,5,8,37.5%,43m
6240,3,Apolowik,2778,0,1,4,5,20.0%,13m
6249,1,[Yisc]IllllllllllI,2777,668,24,28,52,46.2%,41m
6249,2,이동헌,2777,560,21,21,42,50.0%,43m
6249,3,기태몬,2777,277,11,12,23,47.8%,44m
6249,3,Himalayan,2777,92,4,3,7,57.1%,12m
6253,1,군단을위하여,2776,1445,67,75,142,47.2%,42m
6253,2,굿굿굿,2776,1542,63,64,127,49.6%,39m
6253,2,ShangLit,2776,438,34,29,63,54.0%,43m
6253,2,HardCode,2776,116,4,2,6,66.7%,43m
6253,2,임진용죽어,2776,30,3,5,8,37.5%,39m
6253,3,BoshPam,2776,30,1,1,2,50.0%,44m
6253,3,찬혁대장,2776,0,0,1,1,0.0%,12m
6260,1,[星辰]North,2775,1481,100,87,187,53.5%,42m
6260,2,이종현,2775,1479,63,62,125,50.4%,43m
6260,2,떼끼에로병기,2775,270,10,12,22,45.5%,39m
6260,2,yim,2775,174,6,2,8,75.0%,39m
6260,2,mrpungone,2775,112,3,2,5,60.0%,44m
6260,3,Bolo,2775,0,3,4,7,42.9%,32m
6260,2,Nyemo,2775,0,1,0,1,100.0%,10m
6267,2,power,2774,1016,39,37,76,51.3%,43m
6267,2,유스리더,2774,857,31,35,66,47.0%,43m
6267,1,Yan,2774,467,17,21,38,44.7%,41m
6267,3,무적이라면,2774,0,4,1,5,80.0%,39m
6267,3,sino,2774,72,4,2,6,66.7%,44m
6267,3,WaStEd,2774,30,3,4,7,42.9%,39m
6267,2,llllllllllll,2774,88,2,3,5,40.0%,39m
6267,3,MoarDeat,2774,0,0,1,1,0.0%,44m
6275,1,미나리파워,2773,1599,182,189,371,49.1%,41m
6275,2,저녁코끼리,2773,1222,57,50,107,53.3%,43m
6275,3,player,2773,1197,45,48,93,48.4%,7m
6275,1,스타크,2773,587,23,23,46,50.0%,42m
6275,3,대마초,2773,58,2,2,4,50.0%,38m
6275,2,rlaqhtjd,2773,34,2,3,5,40.0%,44m
6275,3,llllllllllll,2773,0,0,1,1,0.0%,38m
6275,2,appleeversj,2773,0,0,2,2,0.0%,39m
6283,3,Jacob,2772,174,7,4,11,63.6%,44m
6283,1,[Mist]SunLightProv,2772,117,3,4,7,42.9%,11m
6283,2,카이도우,2772,111,2,1,3,66.7%,10m
6283,3,찰리하우스,2772,0,1,4,5,20.0%,39m
6283,3,Eiushua,2772,0,0,1,1,0.0%,39m
6283,3,llllllll,2772,0,0,7,7,0.0%,16m
6289,3,IlIlIlIlIlIl,2771,194,6,5,11,54.5%,17m
6289,2,할짓없다,2771,106,4,4,8,50.0%,39m
6289,3,GOODMAN,2771,0,0,2,2,0.0%,16m
6289,2,깅강,2771,0,0,2,2,0.0%,39m
6293,3,BLEss,2770,1072,43,41,84,51.2%,7m
6293,3,도라이몽키,2770,715,27,25,52,51.9%,44m
6293,2,도라지캐자,2770,544,22,16,38,57.9%,43m
6293,3,우석칼라,2770,232,8,8,16,50.0%,38m
6293,1,Haruhi,2770,0,1,2,3,33.3%,42m
6298,1,htviva,2769,1505,96,90,186,51.6%,42m
6298,1,SMBH,2769,690,72,77,149,48.3%,42m
6298,3,Malediction,2769,734,39,33,72,54.2%,44m
6298,2,선량한광전사,2769,299,9,10,19,47.4%,18m
6298,2,lonxlee,2769,18,4,4,8,50.0%,39m
6298,3,[llst짱짱]맹수찌순,2769,30,1,1,2,50.0%,13m
6304,1,[H琪]HMQ,2768,1269,87,84,171,50.9%,42m
6304,1,unknowns,2768,1053,41,41,82,50.0%,42m
6304,3,Edge,2768,211,15,15,30,50.0%,44m
6304,2,경맨,2768,225,8,6,14,57.1%,43m
6304,1,HuyNgo,2768,161,4,0,4,100.0%,11m
6304,3,Scythy,2768,146,4,5,9,44.4%,39m
6304,2,騎豬南下,2768,88,3,9,12,25.0%,39m
6304,3,알아서뭐하게,2768,58,2,1,3,66.7%,13m
6304,3,HackersGRD,2768,60,2,2,4,50.0%,45m
6304,3,iNsEURNG,2768,58,2,3,5,40.0%,44m
6314,1,Clifford,2767,1550,72,77,149,48.3%,42m
6314,3,jjj,2767,561,22,29,51,43.1%,3m
6314,3,台灣最後的希望,2767,0,1,1,2,50.0%,13m
6314,3,[AR소대]엠포,2767,0,0,1,1,0.0%,39m
6318,2,포순이야르,2766,114,5,4,9,55.6%,43m
6318,3,걸즈브링,2766,0,1,0,1,100.0%,16m
6320,1,에바,2765,1559,220,220,440,50.0%,42m
6320,2,Cech,2765,281,18,18,36,50.0%,43m
6320,3,Lafe,2765,264,9,5,14,64.3%,12m
6320,3,대성,2765,30,3,3,6,50.0%,13m
6320,3,nevereverlos,2765,97,3,4,7,42.9%,16m
6320,2,astarisk,2765,88,3,4,7,42.9%,39m
6320,3,SinnacleKR,2765,0,1,0,1,100.0%,13m
6320,3,fggfgfdd,2765,0,1,1,2,50.0%,45m
6320,3,[Chest]그란빠따,2765,0,0,1,1,0.0%,39m
6329,3,jonghyun,2764,770,38,32,70,54.3%,44m
6329,1,astro,2764,774,25,34,59,42.4%,42m
6329,2,jerry,2764,350,14,12,26,53.8%,44m
6329,1,이정현존잘,2764,192,7,7,14,50.0%,40m
6333,3,SilverMoon,2763,288,9,5,14,64.3%,12m
6333,3,그거슨헤팝,2763,172,5,6,11,45.5%,39m
6333,3,YMgum,2763,125,5,6,11,45.5%,6m
6333,2,스유대,2763,73,5,8,13,38.5%,44m
6333,3,JingJingE,2763,139,3,1,4,75.0%,44m
6333,3,WuhanVirus,2763,30,2,0,2,100.0%,13m
6333,3,[DearS]HumbleD,2763,0,0,1,1,0.0%,45m
6333,2,BeatGD,2763,0,0,4,4,0.0%,39m
6341,1,저녁설사,2762,823,38,33,71,53.5%,39m
6341,3,[국방부사서병]마린,2762,815,35,24,59,59.3%,39m
6341,2,[ClSt]belloline,2762,482,16,21,37,43.2%,43m
6341,1,나폴레옹,2762,280,11,16,27,40.7%,40m
6341,3,적당히멋쟁이,2762,194,7,4,11,63.6%,44m
6341,2,[눈꽃]팡퀴,2762,30,2,3,5,40.0%,43m
6341,2,IIIIIIIIII,2762,90,1,2,3,33.3%,19m
6341,2,[우리는하나]palradin,2762,34,1,7,8,12.5%,43m
6341,3,[야매가]짱깨,2762,0,0,1,1,0.0%,44m
6350,1,형레전드,2761,600,26,27,53,49.1%,42m
6350,2,베스트제로,2761,373,15,16,31,48.4%,39m
6350,3,brain,2761,330,14,10,24,58.3%,12m
6350,2,이지명,2761,251,10,6,16,62.5%,43m
6350,2,뿔난포로,2761,206,8,9,17,47.1%,18m
6350,2,Nobody,2761,88,3,4,7,42.9%,39m
6350,2,재군,2761,30,2,3,5,40.0%,43m
6357,2,스타사령관,2760,578,46,40,86,53.5%,43m
6357,2,[NTW]DamnLotus,2760,684,29,23,52,55.8%,43m
6357,3,Jezek,2760,611,27,16,43,62.8%,39m
6357,2,aaa,2760,158,11,8,19,57.9%,19m
6357,2,후후후,2760,86,5,5,10,50.0%,44m
6357,3,크레이지애플,2760,0,3,2,5,60.0%,39m
6357,3,LowROAS,2760,50,2,1,3,66.7%,13m
6357,2,RTSbanana,2760,0,2,4,6,33.3%,39m
6357,3,[ash]왕버섯한민성,2760,0,1,0,1,100.0%,44m
6357,3,dsafdfasasdf,2760,30,1,1,2,50.0%,44m
6357,3,광일두두,2760,0,0,1,1,0.0%,13m
6368,1,푸펠,2759,1545,138,141,279,49.5%,40m
6368,3,GENESIS,2759,1248,55,48,103,53.4%,39m
6368,2,JSPREY,2759,346,26,20,46,56.5%,43m
6368,2,[신개미협회]Protoss,2759,539,24,14,38,63.2%,39m
6368,3,Zeratul,2759,382,15,14,29,51.7%,44m
6368,3,[저글링귀여워]정글차이,2759,157,7,3,10,70.0%,32m
6368,2,[200114]lllllllllll,2759,192,7,10,17,41.2%,43m
6368,3,IIIIIIIIIIII,2759,0,3,2,5,60.0%,39m
6368,3,Heaven,2759,30,2,1,3,66.7%,44m
6368,3,[공방깡패]임하우동,2759,0,0,1,1,0.0%,39m
6378,2,雪森,2758,971,111,99,210,52.9%,43m
6378,2,뭐여이거지는,2758,1535,77,79,156,49.4%,43m
6378,2,IlllllIIIIII,2758,792,31,29,60,51.7%,43m
6381,1,ILOVEYOU,2757,1583,252,246,498,50.6%,42m
6381,2,리버트리움,2757,844,167,166,333,50.2%,43m
6381,2,민준아빠,2757,726,32,30,62,51.6%,43m
6381,2,muyayo,2757,398,14,19,33,42.4%,44m
6381,3,我是奇奇,2757,121,3,8,11,27.3%,17m
6381,1,Victory,2757,0,2,3,5,40.0%,15m
6381,2,llIIlIlIlIlI,2757,30,2,4,6,33.3%,39m
6381,3,lllllllllll,2757,0,1,0,1,100.0%,44m
6389,3,[日本]IIIIIIIIIIII,2756,209,7,0,7,100.0%,13m
6390,2,[YJJ]TLqkf,2755,825,65,63,128,50.8%,44m
6390,3,yrzr,2755,651,31,27,58,53.4%,44m
6390,3,[880723]샴챵,2755,497,18,15,33,54.5%,39m
6390,3,sirasu,2755,30,2,0,2,100.0%,44m
6390,3,Yago,2755,0,2,3,5,40.0%,39m
6395,2,[QFE]charles,2754,789,30,40,70,42.9%,2m
6395,3,무등산호랑이,2754,58,3,0,3,100.0%,44m
6395,3,헛깨나무,2754,30,1,4,5,20.0%,44m
6398,3,adjact,2753,715,49,40,89,55.1%,12m
6398,2,슬욱전사,2753,314,11,17,28,39.3%,44m
6398,1,TerranMarine,2753,144,5,2,7,71.4%,15m
6398,2,Tree,2753,88,2,3,5,40.0%,43m
6398,1,[Blade]CHIN,2753,0,1,0,1,100.0%,15m
6398,3,YEE,2753,0,0,1,1,0.0%,44m
6404,2,니팬티보일라,2752,1554,335,324,659,50.8%,8m
6404,1,Wupohsi,2752,964,185,161,346,53.5%,41m
6404,1,임요한,2752,367,15,20,35,42.9%,42m
6404,2,sora,2752,178,6,11,17,35.3%,43m
6404,3,CHUAN,2752,182,5,7,12,41.7%,44m
6404,3,머디,2752,107,3,0,3,100.0%,12m
6404,1,TianPeng,2752,48,3,4,7,42.9%,16m
6404,3,KaSsan,2752,58,2,2,4,50.0%,45m
6404,3,블랙아이드잭,2752,58,2,3,5,40.0%,44m
6404,2,lIlIIIlIIIIl,2752,62,2,6,8,25.0%,43m
6404,2,프레디,2752,0,0,4,4,0.0%,39m
6415,1,스레트스러킬,2751,1292,138,133,271,50.9%,41m
6415,3,[Worm]빠따이,2751,294,17,14,31,54.8%,12m
6415,3,ElSoul,2751,122,4,7,11,36.4%,13m
6415,1,[3맨빌런]까탈레나,2751,0,3,3,6,50.0%,16m
6415,3,Romer,2751,0,1,0,1,100.0%,44m
6420,3,rockid,2749,140,6,3,9,66.7%,13m
6420,3,alexndra,2749,80,5,6,11,45.5%,16m
6420,3,테란,2749,118,4,4,8,50.0%,39m
6420,2,Eli,2749,39,2,9,11,18.2%,43m
6420,3,休閒的小玩家,2749,0,0,1,1,0.0%,45m
6420,3,yuhegao,2749,0,0,2,2,0.0%,12m
6426,2,Laco,2748,929,42,39,81,51.9%,39m
6426,1,[2Z]하네,2748,466,32,22,54,59.3%,42m
6426,1,개코,2748,48,3,3,6,50.0%,16m
6426,3,김학준입니다,2748,0,3,4,7,42.9%,16m
6426,3,wlp,2748,0,2,2,4,50.0%,39m
6431,3,에덴,2747,780,46,43,89,51.7%,44m
6431,3,aaaaaaa,2747,145,4,4,8,50.0%,16m
6431,3,[PGD]바기니,2747,58,3,1,4,75.0%,39m
6431,1,뿌뿌빠뿌,2747,0,3,4,7,42.9%,42m
6431,1,RoboBear,2747,48,1,1,2,50.0%,14m
6431,3,[스타놀이터]진주,2747,0,1,1,2,50.0%,44m
6431,1,llllllllllll,2747,0,1,1,2,50.0%,11m
6438,2,[Lotuz]쟈갈,2746,710,25,30,55,45.5%,44m
6438,3,[F5]YangWenLi,2746,385,13,14,27,48.1%,39m
6438,3,느린치타,2746,244,9,7,16,56.2%,13m
6438,3,Enzo,2746,207,6,6,12,50.0%,44m
6438,1,MOLODES,2746,88,4,4,8,50.0%,40m
6438,1,[Giwawa]IIIIIIIIIIII,2746,0,0,1,1,0.0%,16m
6438,2,별쨩님,2746,0,0,4,4,0.0%,43m
6445,3,ShinEtoss,2745,1515,311,323,634,49.1%,6m
6445,1,[異界的檢察官]XxFkDoYaxX,2745,841,43,44,87,49.4%,40m
6445,2,[93GO]PLAYFUL,2745,585,22,25,47,46.8%,39m
6448,2,홍쉡,2744,357,21,19,40,52.5%,43m
6448,3,[ROKU]졸림곰,2744,289,10,6,16,62.5%,45m
6448,3,dlqldlsgnrhk,2744,214,6,8,14,42.9%,39m
6448,1,Dragon,2744,89,4,6,10,40.0%,40m
6448,3,카카캇,2744,0,3,4,7,42.9%,17m
6448,3,yuppee,2744,46,3,5,8,37.5%,13m
6448,3,혼종마르,2744,97,2,4,6,33.3%,39m
6448,1,미아,2744,0,1,0,1,100.0%,15m
6448,3,[Equal]BYwooricoop,2744,0,0,1,1,0.0%,13m
6448,3,너님맛사탕,2744,0,0,1,1,0.0%,39m
6458,2,[流星]極重巨砲弐式,2743,467,20,12,32,62.5%,43m
6458,3,LastRoad,2743,142,7,7,14,50.0%,44m
6458,1,SKS,2743,48,3,2,5,60.0%,14m
6458,3,fcp,2743,58,2,2,4,50.0%,39m
6462,3,[늙지않아]영광겸댕이,2742,1256,49,47,96,51.0%,44m
6462,1,프로토스제왕,2742,0,0,1,1,0.0%,15m
6464,3,HHHHHH,2741,1526,160,164,324,49.4%,8m
6464,2,haru,2741,1517,63,50,113,55.8%,39m
6464,3,소드마스터베이션,2741,169,3,4,7,42.9%,32m
6464,3,[해병만뽑음]지금은양학중,2741,97,2,2,4,50.0%,32m
6464,3,BUNTUTS,2741,0,1,0,1,100.0%,13m
6469,1,PRPOWORKS,2740,1542,226,215,441,51.2%,40m
6469,1,天煞,2740,376,20,30,50,40.0%,41m
6469,1,[항문브레이커]VanDarkholme,2740,265,11,13,24,45.8%,12m
6469,3,IIIIIIIIIIII,2740,235,8,4,12,66.7%,13m
6469,1,철원소년,2740,122,4,4,8,50.0%,11m
6469,1,OsCeZrCd,2740,145,4,4,8,50.0%,16m
6469,3,Edge,2740,100,4,7,11,36.4%,44m
6469,3,여우비,2740,64,2,2,4,50.0%,17m
6469,2,OptimusPrime,2740,0,2,4,6,33.3%,39m
6469,3,[광막훈련소]熱氣,2740,0,0,1,1,0.0%,12m
6479,3,backgh,2739,1449,57,53,110,51.8%,39m
6479,2,SIRO,2739,223,14,7,21,66.7%,43m
6479,2,xJaymon,2739,187,7,8,15,46.7%,43m
6479,3,jason,2739,122,6,7,13,46.2%,44m
6479,3,SmileMickey,2739,0,3,4,7,42.9%,17m
6479,3,[XKQD]iiiider,2739,0,0,2,2,0.0%,32m
6485,3,[CnB]소중중야,2738,713,28,33,61,45.9%,3m
6485,3,[물고기왕국]물고기왕,2738,325,14,15,29,48.3%,12m
6485,2,[avec]FAMASwp,2738,217,8,8,16,50.0%,18m
6485,3,JSK,2738,58,2,4,6,33.3%,39m
6485,3,화월,2738,0,0,1,1,0.0%,17m
6490,2,여친김태리닮음,2737,1402,243,240,483,50.3%,7m
6490,2,[꽃남]Storm,2737,1575,118,121,239,49.4%,43m
6490,3,coolidaddy,2737,643,26,20,46,56.5%,45m
6490,2,llames,2737,290,12,9,21,57.1%,43m
6490,1,[애니멀킹덤]천사고양이,2737,0,0,1,1,0.0%,15m
6495,1,JoyFul,2736,1308,116,115,231,50.2%,42m
6495,2,[별똥별]성실착실충실,2736,982,41,34,75,54.7%,39m
6495,3,[펩시맨]스타좋아유,2736,318,13,12,25,52.0%,39m
6495,3,SaVotar,2736,58,2,2,4,50.0%,44m
6495,3,외로운검객,2736,97,1,1,2,50.0%,17m
6495,3,Applesbrew,2736,0,0,1,1,0.0%,39m
6495,3,Wasie,2736,0,0,1,1,0.0%,44m
6502,2,김이준,2735,1056,47,42,89,52.8%,44m
6502,3,[게임플레이]dla,2735,618,27,12,39,69.2%,39m
6502,2,YEH,2735,585,22,23,45,48.9%,43m
6502,3,포도맛캔디,2735,418,16,12,28,57.1%,45m
6502,2,Leofrancis,2735,218,7,16,23,30.4%,44m
6502,3,Nicky,2735,0,3,2,5,60.0%,44m
6502,3,금만두,2735,30,2,2,4,50.0%,13m
6502,3,[B猛象黃衫軍]魔方狂人,2735,0,1,1,2,50.0%,44m
6502,3,GIGN,2735,0,0,1,1,0.0%,45m
6511,3,IIIIIIIIIIII,2734,496,17,21,38,44.7%,13m
6511,3,원펀치투깅냉이,2734,112,5,6,11,45.5%,17m
6511,2,뭘봐키키키키,2734,64,2,8,10,20.0%,39m
6511,3,[시럽]SAUCER,2734,30,1,2,3,33.3%,13m
6511,3,[fromBY]프로브뀨저글링뀨,2734,0,1,2,3,33.3%,44m
6511,3,berserk,2734,0,0,3,3,0.0%,12m
6517,1,HHH,2733,1584,321,329,650,49.4%,41m
6517,3,PBC,2733,232,8,10,18,44.4%,44m
6517,3,Jealous,2733,172,6,6,12,50.0%,45m
6517,2,[ptcity]재규어,2733,68,3,5,8,37.5%,44m
6517,3,llllllllllll,2733,0,1,0,1,100.0%,39m
6517,3,쓸어담기주부,2733,0,1,0,1,100.0%,44m
6517,3,영화동놈팽이,2733,0,0,1,1,0.0%,12m
6524,1,yarabu,2732,1471,82,73,155,52.9%,40m
6524,3,維尼肺炎了,2732,154,18,7,25,72.0%,13m
6524,2,누군가,2732,405,18,15,33,54.5%,39m
6524,1,CoWbOyBeeBoP,2732,0,3,4,7,42.9%,40m
6524,2,닥치고처빨아,2732,70,3,5,8,37.5%,10m
6524,3,yangta,2732,30,1,2,3,33.3%,13m
6524,3,내목숨을아이어에,2732,0,0,3,3,0.0%,44m
6531,2,蕎爸,2731,1456,147,151,298,49.3%,7m
6531,2,긔염이,2731,616,26,25,51,51.0%,39m
6531,3,[暗夜洌鶇]醉別瀟湘,2731,282,10,4,14,71.4%,44m
6531,3,코하쿠토,2731,30,4,4,8,50.0%,17m
6531,2,블랙핑크제니,2731,0,0,2,2,0.0%,19m
6531,3,tioon,2731,0,0,2,2,0.0%,17m
6531,2,[Bokdo]청면수,2731,0,0,3,3,0.0%,18m
6538,2,Messi,2730,1481,122,118,240,50.8%,43m
6538,1,[Worm]KDG,2730,1558,62,73,135,45.9%,41m
6538,3,[CIA암살단]overthetop,2730,1075,49,34,83,59.0%,13m
6538,3,역장돌진폭풍,2730,587,47,42,89,52.8%,12m
6538,3,[검무유키나]히메라기유키나,2730,983,34,50,84,40.5%,9m
6538,3,Nivdc,2730,629,26,23,49,53.1%,45m
6538,3,Lotus,2730,178,9,4,13,69.2%,44m
6538,2,yametekudasa,2730,217,8,9,17,47.1%,39m
6538,3,LOLOLOLOLOLO,2730,197,7,5,12,58.3%,17m
6538,3,fnsckdl,2730,0,1,1,2,50.0%,13m
6548,3,트리윈,2729,1070,55,43,98,56.1%,39m
6548,3,[Dusky]mexorcist,2729,401,17,11,28,60.7%,44m
6548,3,Bucket,2729,258,12,8,20,60.0%,39m
6548,2,[공주님]흑왕,2729,310,12,9,21,57.1%,43m
6548,3,준혁,2729,237,7,5,12,58.3%,44m
6548,3,HydraLisk,2729,60,3,2,5,60.0%,13m
6548,3,오로랄,2729,60,3,2,5,60.0%,45m
6548,1,洨醜男,2729,0,3,2,5,60.0%,14m
6548,3,茶裡王,2729,30,2,1,3,66.7%,39m
6548,3,kentxe,2729,60,2,2,4,50.0%,44m
6548,3,Blue,2729,0,1,4,5,20.0%,39m
6559,2,gill,2728,462,31,28,59,52.5%,44m
6559,3,[롱찬]기므동찬,2728,80,4,4,8,50.0%,16m
6559,3,Dddooooing,2728,0,0,2,2,0.0%,13m
6559,2,appleant,2728,0,0,6,6,0.0%,44m
6563,2,Zestria,2727,1249,51,54,105,48.6%,44m
6563,2,휘센,2727,465,18,15,33,54.5%,44m
6563,3,[반란군연합]타이커스,2727,0,1,1,2,50.0%,39m
6563,3,양강칠,2727,0,0,1,1,0.0%,44m
6567,3,유튜브나무칼사부,2726,839,33,34,67,49.3%,44m
6567,3,昨昨,2726,386,13,16,29,44.8%,45m
6567,1,모닝까마귀,2726,0,3,4,7,42.9%,40m
6567,3,바이톤가자간,2726,0,1,0,1,100.0%,44m
6567,1,Oranjishtal,2726,0,1,3,4,25.0%,14m
6567,3,마니,2726,0,0,1,1,0.0%,17m
6573,1,巴斯克維爾,2725,207,8,9,17,47.1%,42m
6573,3,oppott,2725,180,7,8,15,46.7%,12m
6573,2,TRIPORC,2725,58,3,8,11,27.3%,43m
6573,3,[000]Rich,2725,0,2,3,5,40.0%,44m
6573,3,댐비,2725,0,1,1,2,50.0%,44m
6573,3,centurion,2725,0,1,1,2,50.0%,39m
6573,3,오승준,2725,0,0,1,1,0.0%,13m
6580,3,[346P]JUN,2724,1557,94,84,178,52.8%,13m
6580,3,카탄,2724,331,15,10,25,60.0%,12m
6580,3,Malu,2724,328,13,10,23,56.5%,12m
6580,2,BUGGANG,2724,370,13,15,28,46.4%,43m
6580,3,비내리는아침,2724,0,0,3,3,0.0%,44m
6585,2,五福王爺,2723,1469,241,238,479,50.3%,8m
6585,1,IIIIIIIIIIII,2723,855,69,57,126,54.8%,42m
6585,1,십육호,2723,655,26,32,58,44.8%,42m
6585,1,caocao,2723,192,5,4,9,55.6%,15m
6585,1,BeTaStar,2723,97,3,3,6,50.0%,16m
6585,3,GanANe,2723,30,2,1,3,66.7%,12m
6585,3,메라아,2723,0,0,1,1,0.0%,44m
6585,3,암흑집정관,2723,0,0,1,1,0.0%,44m
6593,1,파닥,2722,1172,44,48,92,47.8%,42m
6593,3,[華盟]SANS,2722,538,20,15,35,57.1%,13m
6593,2,개거리,2722,302,10,15,25,40.0%,44m
6593,3,오랫만이당,2722,58,3,1,4,75.0%,13m
6593,3,yhk,2722,146,3,2,5,60.0%,39m
6593,3,RobSui,2722,133,2,1,3,66.7%,16m
6593,3,신의컨트롤,2722,40,1,1,2,50.0%,32m
6600,3,잉여킹,2721,478,18,19,37,48.6%,13m
6600,3,swiss,2721,144,3,1,4,75.0%,39m
6600,3,사신,2721,58,3,2,5,60.0%,13m
6600,3,성혀이,2721,96,3,3,6,50.0%,39m
6600,1,EmeralD,2721,0,2,3,5,40.0%,15m
6600,3,DRSTRANGE,2721,0,1,0,1,100.0%,44m
6606,2,유정현,2720,347,12,12,24,50.0%,39m
6606,3,[밴풀어리피아]질럿장인,2720,272,12,13,25,48.0%,12m
6606,3,海豹球,2720,296,10,12,22,45.5%,39m
6606,2,llIlIIlIIIIl,2720,216,9,9,18,50.0%,43m
6606,3,남극원숭이,2720,81,4,6,10,40.0%,12m
6606,2,人山人海,2720,123,3,1,4,75.0%,10m
6606,2,칸쵸보이,2720,88,3,4,7,42.9%,39m
6606,2,Stella,2720,30,1,8,9,11.1%,39m
6606,3,[저글링죠아]YaED,2720,0,0,3,3,0.0%,45m
6615,3,霹靂貓,2719,307,73,67,140,52.1%,45m
6615,3,졸라맨,2719,200,8,7,15,53.3%,12m
6615,3,NITian,2719,88,7,8,15,46.7%,13m
6615,3,[KrNoob]IIIIIIIIIIII,2719,205,6,2,8,75.0%,44m
6615,3,TerranSea,2719,70,5,6,11,45.5%,16m
6615,1,스블,2719,94,4,4,8,50.0%,16m
6615,2,terran,2719,166,4,5,9,44.4%,39m
6615,1,[Rovic]린킨파크,2719,48,2,6,8,25.0%,15m
6615,1,보라준이취향임,2719,0,1,3,4,25.0%,11m
6615,3,[당근파]프리스트,2719,0,0,1,1,0.0%,12m
6625,3,김깡세요,2718,782,40,38,78,51.3%,44m
6625,1,금연구역,2718,465,18,21,39,46.2%,40m
6625,3,SoNia,2718,364,14,13,27,51.9%,12m
6625,2,트럼프,2718,362,12,14,26,46.2%,44m
6625,3,Mysterious,2718,0,1,0,1,100.0%,13m
6625,3,파란고래,2718,30,1,3,4,25.0%,44m
6625,3,레박,2718,0,0,1,1,0.0%,12m
6632,3,GGOSinon,2717,1353,137,132,269,50.9%,1m
6632,2,오리왕자,2717,1584,110,103,213,51.6%,44m
6632,3,Yuki,2717,271,10,5,15,66.7%,44m
6632,3,나만의롱보우,2717,148,6,5,11,54.5%,45m
6632,3,큰개자리,2717,30,2,0,2,100.0%,45m
6632,3,llllllllllll,2717,0,2,3,5,40.0%,39m
6632,3,banana,2717,0,1,0,1,100.0%,44m
6632,1,토리왕자님,2717,0,0,1,1,0.0%,15m
6632,1,OHGODAZA,2717,0,0,1,1,0.0%,14m
6641,1,rnswls,2716,1493,671,674,1345,49.9%,8m
6641,3,Dez,2716,1016,139,128,267,52.1%,45m
6641,3,세젤예보현잉,2716,1192,53,45,98,54.1%,44m
6641,3,날빌장인,2716,296,12,10,22,54.5%,44m
6641,3,RHCP,2716,54,3,3,6,50.0%,45m
6641,1,비상,2716,97,3,4,7,42.9%,38m
6641,3,내안에마구니있다,2716,0,2,3,5,40.0%,39m
6641,2,[XCOG]이상한그림자,2716,42,1,3,4,25.0%,18m
6641,3,[노바특임대]무슨소리,2716,97,1,3,4,25.0%,16m
6641,3,난못태,2716,0,0,1,1,0.0%,45m
6641,1,愷愷,2716,0,0,2,2,0.0%,15m
6641,3,GamePlay,2716,0,0,3,3,0.0%,44m
6653,3,니조랄,2715,573,31,19,50,62.0%,44m
6653,3,BleuOceane,2715,432,19,10,29,65.5%,39m
6653,3,MALAMUTE,2715,191,6,2,8,75.0%,44m
6656,3,hujim,2714,174,6,6,12,50.0%,39m
6656,2,KeiFromNYC,2714,246,6,16,22,27.3%,43m
6656,3,Awrox,2714,60,2,5,7,28.6%,12m
6656,3,이즈리이얼산스,2714,0,1,1,2,50.0%,44m
6660,3,HenceThu,2713,618,58,51,109,53.2%,12m
6660,1,[타타타]산다는건좋은거지,2713,122,4,4,8,50.0%,11m
6660,3,체코인,2713,30,2,1,3,66.7%,39m
6660,3,EGGs,2713,30,1,4,5,20.0%,13m
6660,3,광개토,2713,0,0,1,1,0.0%,45m
6660,3,정화자박이,2713,0,0,1,1,0.0%,45m
6666,3,Weltmeister,2712,986,38,37,75,50.7%,13m
6666,3,타리우니,2712,30,2,0,2,100.0%,12m
6666,1,Matt,2712,0,2,3,5,40.0%,15m
6666,3,[앟녛핳셓옇]변경기회없다,2712,30,1,1,2,50.0%,44m
6666,3,ivanchen,2712,30,1,3,4,25.0%,45m
6671,1,[IPE]Heides,2711,824,30,34,64,46.9%,40m
6671,2,지구,2711,32,1,2,3,33.3%,19m
6671,3,grrrrrrrrrrr,2711,97,1,2,3,33.3%,16m
6671,2,WYC,2711,0,1,7,8,12.5%,44m
6671,3,DeltaSix,2711,0,0,1,1,0.0%,45m
6671,3,[잡담방]dnjscjf,2711,0,0,1,1,0.0%,13m
6677,3,암흑의두루치기,2710,464,21,9,30,70.0%,13m
6677,3,demetrio,2710,148,6,8,14,42.9%,6m
6677,3,Cloud,2710,97,4,4,8,50.0%,16m
6677,1,Beemo,2710,0,3,2,5,60.0%,16m
6677,3,붐바스틱,2710,0,0,2,2,0.0%,17m
6677,1,PoLaRiS,2710,0,0,3,3,0.0%,11m
6683,1,JeeMoW,2709,1577,835,895,1730,48.3%,40m
6683,3,lIlIlIlIlIlI,2709,1586,453,460,913,49.6%,8m
6683,2,IIIIIIIIIIII,2709,586,35,46,81,43.2%,44m
6683,3,[國家機器]apostle,2709,482,17,18,35,48.6%,44m
6683,3,Goobu,2709,30,2,1,3,66.7%,12m
6683,3,[我們是家人]ZhijieTWLG,2709,0,0,1,1,0.0%,45m
6683,3,jlnsung,2709,0,0,1,1,0.0%,13m
6683,2,ParkGoM,2709,0,0,1,1,0.0%,19m
6683,3,JayLeo,2709,0,0,3,3,0.0%,13m
6692,2,lIlIlIlIlIIl,2708,1478,80,65,145,55.2%,44m
6692,3,ltuhjl,2708,210,8,8,16,50.0%,39m
6692,3,zakso,2708,141,6,7,13,46.2%,32m
6692,3,하누다,2708,0,1,3,4,25.0%,13m
6692,3,[TMR]jason,2708,0,0,1,1,0.0%,44m
6697,2,스타족망겜,2707,323,11,10,21,52.4%,19m
6697,3,iuwqd,2707,147,8,3,11,72.7%,17m
6697,3,redsky,2707,135,6,3,9,66.7%,13m
6697,3,DAVEZEROTYPE,2707,187,6,7,13,46.2%,39m
6697,3,볼보,2707,112,4,4,8,50.0%,39m
6697,1,잘생긴세영이,2707,97,3,3,6,50.0%,16m
6697,3,매너,2707,0,1,0,1,100.0%,44m
6697,3,바지벗고싸쓰킥,2707,0,1,5,6,16.7%,12m
6705,3,TaKer,2706,713,29,22,51,56.9%,45m
6705,3,thunderZeus,2706,172,6,6,12,50.0%,45m
6705,1,CHEN,2706,97,5,1,6,83.3%,38m
6705,1,Stealyomoney,2706,0,1,1,2,50.0%,14m
6705,3,tisuboy,2706,0,0,1,1,0.0%,12m
6705,1,DHDH,2706,0,0,2,2,0.0%,14m
6711,3,게토레이이이이,2705,1493,222,223,445,49.9%,10m
6711,2,[삼국시대]헤헤희수,2705,955,57,65,122,46.7%,43m
6711,2,[아나아]암젖소,2705,692,28,30,58,48.3%,44m
6711,2,[지뢰성애자]청정수,2705,532,25,14,39,64.1%,43m
6711,3,남진오빠,2705,58,3,4,7,42.9%,13m
6711,2,버밀,2705,0,3,4,7,42.9%,44m
6711,3,leofrat,2705,30,1,3,4,25.0%,39m
6711,1,Boots,2705,0,0,1,1,0.0%,16m
6719,2,롤스로이스,2704,415,18,11,29,62.1%,39m
6719,3,서현아사랑해,2704,338,13,13,26,50.0%,13m
6719,3,삿음,2704,97,2,2,4,50.0%,17m
6722,1,Zephty,2703,1569,683,668,1351,50.6%,42m
6722,2,펭펭이,2703,378,17,11,28,60.7%,44m
6722,2,동현,2703,306,13,13,26,50.0%,44m
6722,3,정원용,2703,323,12,7,19,63.2%,39m
6722,3,riun,2703,267,11,13,24,45.8%,45m
6722,3,야목,2703,96,2,0,2,100.0%,39m
6722,1,Unicode,2703,0,2,3,5,40.0%,16m
6729,3,[secx]GloryOfDelam,2702,323,13,9,22,59.1%,12m
6729,1,Ghost,2702,148,4,5,9,44.4%,41m
6729,3,LongChi,2702,0,0,1,1,0.0%,45m
6732,3,willamus,2701,685,95,86,181,52.5%,44m
6732,2,[제국군]스타서포트,2701,1511,73,71,144,50.7%,44m
6732,3,Goraeyong,2701,919,39,38,77,50.6%,13m
6732,3,Haria,2701,731,33,26,59,55.9%,13m
6732,3,치느님,2701,544,22,19,41,53.7%,13m
6732,2,곰보빵,2701,232,11,12,23,47.8%,43m
6732,3,번식의제왕,2701,0,1,3,4,25.0%,17m
6739,2,소나기,2700,1569,182,179,361,50.4%,44m
6739,2,PAN,2700,1277,81,68,149,54.4%,43m
6739,2,鹽烤異化蟲,2700,622,39,35,74,52.7%,43m
6739,3,홍시,2700,767,38,30,68,55.9%,12m
6739,3,[STXE]TCPWrapper,2700,432,17,21,38,44.7%,45m
6739,3,플라이천사,2700,354,14,10,24,58.3%,44m
6739,3,하하하,2700,264,9,6,15,60.0%,12m
6739,2,COVID,2700,197,7,11,18,38.9%,43m
6739,2,이은기,2700,30,4,2,6,66.7%,39m
6739,1,FlutterGuy,2700,96,4,5,9,44.4%,16m
6739,3,멩스크,2700,123,3,8,11,27.3%,17m
6739,3,하현민,2700,119,2,2,4,50.0%,45m
6739,3,whereisKorn,2700,0,2,4,6,33.3%,12m
6739,1,James,2700,0,0,2,2,0.0%,12m
6753,2,qhflqhf,2699,1541,371,366,737,50.3%,44m
6753,3,[미친광전사]NovaTerra,2699,567,26,14,40,65.0%,39m
6753,3,[油脂硬性]黑龍手套,2699,570,23,15,38,60.5%,13m
6753,3,cyove,2699,256,9,11,20,45.0%,39m
6753,3,llllllllllll,2699,118,4,15,19,21.1%,4m
6753,3,DIVELA,2699,0,1,4,5,20.0%,44m
6753,3,[러브라이브]MakiRinPana,2699,0,0,1,1,0.0%,13m
6760,3,ZEDAS,2698,476,53,46,99,53.5%,44m
6760,3,[래더납치범]HMA,2698,256,10,10,20,50.0%,12m
6760,3,[도킹도킹]라플라시오,2698,212,7,10,17,41.2%,45m
6760,2,[히드라119]시간속테란,2698,88,6,6,12,50.0%,39m
6760,3,NamiRai,2698,30,1,6,7,14.3%,13m
6760,3,HSW,2698,0,0,2,2,0.0%,44m
6766,2,maksimus,2697,362,14,10,24,58.3%,39m
6766,3,Ill,2697,337,12,15,27,44.4%,7m
6766,3,[SofT]Delight,2697,180,6,11,17,35.3%,45m
6766,3,SEBIN,2697,118,4,5,9,44.4%,39m
6766,3,[101010]걸레,2697,0,0,1,1,0.0%,44m
6771,3,llllllllllI,2696,705,86,75,161,53.4%,13m
6771,3,Schneider,2696,346,13,15,28,46.4%,13m
6771,3,힐링받음,2696,357,12,12,24,50.0%,44m
6771,1,호모사피엔스,2696,268,11,16,27,40.7%,42m
6771,3,[아비오프로그]metalgeni,2696,79,8,7,15,53.3%,17m
6771,3,uNWinz,2696,0,2,3,5,40.0%,39m
6777,3,[병신들모임]가브리엘라,2695,1557,91,83,174,52.3%,39m
6777,3,VVVVVVVVVVVV,2695,454,37,28,65,56.9%,44m
6777,3,ZEUS,2695,92,4,6,10,40.0%,6m
6777,2,機機,2695,89,3,5,8,37.5%,40m
6777,1,[랜타디줫고수]지훈이희원이버림,2695,0,2,3,5,40.0%,16m
6777,3,기운찬기사,2695,0,2,3,5,40.0%,39m
6777,3,[너의ol름은]솔비,2695,0,1,4,5,20.0%,44m
6777,3,herry,2695,0,1,4,5,20.0%,39m
6777,3,스타크래프트,2695,0,0,4,4,0.0%,12m
6786,2,SurpriseMF,2694,1568,332,337,669,49.6%,43m
6786,2,Carpenteria,2694,936,96,96,192,50.0%,44m
6786,3,[친클]GLHF,2694,90,4,6,10,40.0%,13m
6786,2,jms,2694,144,4,7,11,36.4%,43m
6786,1,inferno,2694,0,3,5,8,37.5%,40m
6786,3,Joe,2694,0,2,3,5,40.0%,44m
6786,2,EIFILI,2694,0,0,1,1,0.0%,19m
6793,3,Fraped,2693,1053,46,35,81,56.8%,39m
6793,1,MountainDew,2693,252,10,13,23,43.5%,40m
6793,3,호동게혜,2693,181,5,2,7,71.4%,39m
6793,3,라이네이돌이,2693,30,4,3,7,57.1%,39m
6793,1,차가,2693,48,1,1,2,50.0%,16m
6793,3,뚱인데여,2693,0,0,2,2,0.0%,45m
6793,3,[허대영]전설의케리건,2693,0,0,4,4,0.0%,13m
6800,2,manticore,2692,1470,67,62,129,51.9%,39m
6800,2,無常,2692,421,15,18,33,45.5%,43m
6800,3,가을하늘,2692,194,6,6,12,50.0%,17m
6800,3,alquimista,2692,112,3,4,7,42.9%,45m
6804,1,KhalNayak,2691,554,18,30,48,37.5%,42m
6804,3,sunman,2691,310,15,22,37,40.5%,44m
6804,3,[深耕C]PrAy,2691,388,14,13,27,51.9%,12m
6804,1,神之門,2691,260,11,13,24,45.8%,10m
6804,3,쥬지스님,2691,88,6,9,15,40.0%,6m
6804,1,AlvisKao,2691,0,2,1,3,66.7%,15m
6804,1,닉스,2691,0,2,3,5,40.0%,15m
6804,3,darknight,2691,60,2,5,7,28.6%,44m
6804,3,Superme,2691,0,0,2,2,0.0%,45m
6813,2,히틀러,2690,1267,95,82,177,53.7%,44m
6813,3,LaCroix,2690,670,27,23,50,54.0%,13m
6813,3,cruelR,2690,383,16,15,31,51.6%,44m
6813,2,[MnS]불붙었어,2690,207,7,11,18,38.9%,19m
6813,3,광대양이,2690,156,6,5,11,54.5%,39m
6813,3,MainStreet,2690,159,4,8,12,33.3%,17m
6813,3,IIIlllIlII,2690,0,1,0,1,100.0%,17m
6820,3,하이닉스사원,2689,1250,56,63,119,47.1%,3m
6820,3,[ECLS]MooN,2689,376,15,11,26,57.7%,39m
6820,3,[TPg]德馬西亞,2689,96,1,2,3,33.3%,39m
6820,1,[우정]럭키스타,2689,0,0,1,1,0.0%,16m
6824,2,ShanYangII,2688,1406,73,59,132,55.3%,44m
6824,3,snowredrotoR,2688,493,19,23,42,45.2%,44m
6824,1,질주,2688,394,11,25,36,30.6%,42m
6824,3,wither,2688,180,5,1,6,83.3%,17m
6824,2,무한불가능,2688,88,4,9,13,30.8%,43m
6824,3,[KoD]xixonawuki,2688,96,3,4,7,42.9%,39m
6824,1,ouou,2688,0,2,3,5,40.0%,16m
6824,3,GLaDOS,2688,30,1,4,5,20.0%,12m
6832,3,soulk,2687,1111,100,88,188,53.2%,44m
6832,2,개돼지,2687,398,17,17,34,50.0%,39m
6832,3,Yungmoney,2687,236,16,9,25,64.0%,13m
6832,3,Vega,2687,303,11,13,24,45.8%,44m
6832,1,DruMMonD,2687,46,3,4,7,42.9%,16m
6832,3,레인메이커,2687,0,0,2,2,0.0%,39m
6838,1,Muboy,2686,1561,146,155,301,48.5%,41m
6838,3,[Rebel]달려달려,2686,727,28,27,55,50.9%,44m
6838,2,똥구,2686,304,25,20,45,55.6%,43m
6838,2,이윤성,2686,463,19,17,36,52.8%,43m
6838,3,lbc,2686,287,12,18,30,40.0%,44m
6838,3,나는공허의힘이다,2686,224,7,7,14,50.0%,39m
6838,3,davidkang,2686,0,1,0,1,100.0%,44m
6838,3,영원,2686,30,1,1,2,50.0%,32m
6838,3,빡머가리사령관,2686,0,1,1,2,50.0%,45m
6847,2,[萬花筒寫輪眼]TomYen,2685,1242,144,142,286,50.3%,43m
6847,2,水靈,2685,675,41,47,88,46.6%,44m
6847,3,lokost,2685,595,26,19,45,57.8%,39m
6847,3,[불곰파]불곰,2685,30,1,2,3,33.3%,44m
6847,2,WhiteSeed,2685,0,1,3,4,25.0%,19m
6847,3,THIRTEENrd,2685,0,0,3,3,0.0%,44m
6853,2,KHANGVN,2684,1515,68,70,138,49.3%,43m
6853,3,BetaStar,2684,270,47,44,91,51.6%,45m
6853,3,민구리밍구리,2684,547,19,18,37,51.4%,12m
6853,2,[옹선생님]민시기입니다,2684,236,12,9,21,57.1%,39m
6853,1,niume,2684,220,9,10,19,47.4%,40m
6853,3,엔타로테사다르,2684,204,8,6,14,57.1%,16m
6853,3,junseok,2684,194,7,7,14,50.0%,39m
6853,3,[마주치면죽어]히포,2684,191,6,4,10,60.0%,39m
6853,1,[別打我會怕]我愛大激排,2684,148,6,7,13,46.2%,40m
6853,3,SEVEN,2684,118,4,6,10,40.0%,44m
6853,3,DestroCHik,2684,0,2,3,5,40.0%,39m
6853,3,설기마루,2684,0,0,1,1,0.0%,12m
6853,1,射命丸文,2684,0,0,1,1,0.0%,14m
6866,3,jackinthebox,2683,717,28,23,51,54.9%,39m
6866,2,DWL,2683,194,9,11,20,45.0%,10m
6866,3,[줄기]Storm,2683,169,7,2,9,77.8%,44m
6866,2,LoveYuki,2683,138,7,2,9,77.8%,18m
6866,3,[SofT]Polarist,2683,172,5,4,9,55.6%,39m
6866,3,[最後生還者]我的本帳在上面,2683,145,4,2,6,66.7%,45m
6866,3,제욱이뿅뿅,2683,0,4,3,7,57.1%,16m
6866,3,你看不到我,2683,0,1,0,1,100.0%,44m
6874,3,베다,2682,241,8,3,11,72.7%,39m
6874,1,Healer,2682,216,7,16,23,30.4%,42m
6874,1,terrablade,2682,155,6,9,15,40.0%,42m
6874,3,킹갓불멸자,2682,96,2,0,2,100.0%,13m
6874,1,lain,2682,0,0,1,1,0.0%,16m
6879,3,Mercurial,2681,1499,154,137,291,52.9%,44m
6879,3,EZreal,2681,475,18,16,34,52.9%,39m
6879,3,[REGENO]앰흑기사,2681,192,6,3,9,66.7%,44m
6879,3,jjang,2681,134,6,9,15,40.0%,13m
6879,1,板本先生,2681,96,4,3,7,57.1%,16m
6879,3,심심이,2681,0,2,3,5,40.0%,39m
6885,3,ogsMC,2680,580,29,29,58,50.0%,39m
6885,2,진씨짜발병인신가,2680,218,7,7,14,50.0%,40m
6885,3,서울남자,2680,86,4,6,10,40.0%,13m
6885,1,verymin,2680,0,2,3,5,40.0%,15m
6885,3,성찬,2680,60,2,5,7,28.6%,44m
6890,3,스타비매니저,2679,562,20,19,39,51.3%,13m
6890,3,CromerBB,2679,404,16,15,31,51.6%,44m
6890,1,인도사이다,2679,462,15,23,38,39.5%,42m
6890,2,[쫄깃함]다리장인뚜기,2679,302,14,11,25,56.0%,40m
6890,1,천하태풍작살,2679,243,7,6,13,53.8%,38m
6890,1,사커겐지,2679,0,3,2,5,60.0%,16m
6896,2,작전사령관,2678,90,6,7,13,46.2%,39m
6896,3,수연사랑,2678,30,1,3,4,25.0%,13m
6898,2,IlIlIlIlIl,2677,1544,74,79,153,48.4%,44m
6898,3,Peterborough,2677,1552,55,74,129,42.6%,7m
6898,3,[FAL]IlIllIIlIlII,2677,867,39,28,67,58.2%,39m
6898,3,新手玩家好爽,2677,236,12,8,20,60.0%,45m
6898,1,Haims,2677,92,3,1,4,75.0%,39m
6898,3,김스타,2677,0,1,3,4,25.0%,39m
6904,2,MTman,2676,323,15,17,32,46.9%,44m
6904,1,Fesser,2676,0,3,4,7,42.9%,14m
6904,1,병앙이,2676,0,1,0,1,100.0%,16m
6904,3,하이염,2676,30,1,3,4,25.0%,13m
6904,1,RuFie,2676,0,0,1,1,0.0%,38m
6909,2,임독사,2675,636,142,133,275,51.6%,43m
6909,1,[센치한용기병]레더초보프교주,2675,1496,57,45,102,55.9%,12m
6909,3,알타리,2675,196,7,6,13,53.8%,13m
6909,2,redbeen,2675,202,6,5,11,54.5%,19m
6909,1,ghr,2675,0,0,1,1,0.0%,38m
6914,3,Mangu,2674,541,34,22,56,60.7%,44m
6914,1,IlllllIlllll,2674,122,3,2,5,60.0%,38m
6914,1,Ashen,2674,42,1,2,3,33.3%,38m
6917,2,[Heat]Libra,2673,280,111,105,216,51.4%,44m
6917,3,스피릿,2673,1066,49,34,83,59.0%,39m
6917,1,아이유뚝배기,2673,920,39,8,47,83.0%,11m
6917,3,한사람,2673,219,8,7,15,53.3%,45m
6917,2,Kardashev,2673,0,3,4,7,42.9%,43m
6917,3,손주아디뜯음,2673,30,2,2,4,50.0%,13m
6917,2,정박군,2673,0,1,1,2,50.0%,19m
6917,1,Destroy,2673,0,1,1,2,50.0%,15m
6917,1,[스친]못난인,2673,0,0,1,1,0.0%,16m
6926,2,[천조국마인드]BBQ,2672,711,72,78,150,48.0%,7m
6926,3,수원고구마,2672,681,38,29,67,56.7%,39m
6926,3,aidrisES,2672,290,14,12,26,53.8%,44m
6926,3,ABN,2672,328,13,12,25,52.0%,45m
6926,3,SekaiNoOwari,2672,286,11,8,19,57.9%,45m
6926,3,개강력,2672,0,0,3,3,0.0%,39m
6932,3,soljun,2671,1560,84,77,161,52.2%,13m
6932,3,[너의ol름은]봄봄,2671,1374,64,60,124,51.6%,44m
6932,3,매일우유,2671,513,21,18,39,53.8%,39m
6932,2,로로,2671,483,17,18,35,48.6%,44m
6932,1,教我玩這遊戲,2671,242,6,3,9,66.7%,38m
6932,1,디오매트,2671,0,2,3,5,40.0%,16m
6932,1,안녀여여여여여,2671,0,1,0,1,100.0%,11m
6932,3,[자유의유산]oxygen,2671,0,0,3,3,0.0%,44m
6940,1,冷冽,2670,291,15,14,29,51.7%,11m
6940,2,섹셜러티,2670,272,9,16,25,36.0%,40m
6940,3,가즈아,2670,174,7,6,13,53.8%,13m
6940,3,쿠우,2670,0,3,3,6,50.0%,44m
6940,1,장삼문,2670,0,2,3,5,40.0%,16m
6945,3,Yera,2669,1495,96,90,186,51.6%,44m
6945,3,마라나타,2669,408,19,20,39,48.7%,44m
6945,3,[Jug]전장의조운,2669,434,16,13,29,55.2%,44m
6945,3,Amvrosios,2669,196,10,4,14,71.4%,39m
6945,2,cannonmaster,2669,118,5,10,15,33.3%,9m
6945,2,[무심천]하수,2669,114,4,7,11,36.4%,39m
6945,1,歆爺,2669,0,0,1,1,0.0%,11m
6945,3,[홍콩행제리바]SynDroMe,2669,0,0,2,2,0.0%,13m
6953,1,솔구름,2668,357,11,2,13,84.6%,38m
6953,3,[IT]rain,2668,223,7,4,11,63.6%,44m
6953,1,violetox,2668,0,3,3,6,50.0%,15m
6956,3,끠슬,2667,836,32,38,70,45.7%,13m
6956,3,[내친구충창]수능쳤음,2667,380,15,12,27,55.6%,39m
6956,2,지지고,2667,238,10,10,20,50.0%,43m
6956,3,送行者,2667,229,8,5,13,61.5%,44m
6956,3,龍蝦丸,2667,146,6,7,13,46.2%,44m
6956,3,제갈량,2667,146,5,10,15,33.3%,45m
6956,1,[정치공학]corea,2667,0,1,0,1,100.0%,11m
6956,1,watchtv,2667,0,1,0,1,100.0%,11m
6956,3,colona,2667,0,1,1,2,50.0%,45m
6956,1,yanni,2667,0,1,3,4,25.0%,11m
6956,1,익성,2667,0,0,1,1,0.0%,11m
6956,3,IntoTheAiur,2667,0,0,3,3,0.0%,44m
6968,3,lili,2666,739,55,42,97,56.7%,39m
6968,3,dkskEjrdlek,2666,218,6,6,12,50.0%,13m
6968,1,유리,2666,0,2,2,4,50.0%,38m
6968,1,방화동총잡이,2666,0,1,0,1,100.0%,10m
6968,1,서울사이버대학교,2666,0,1,0,1,100.0%,38m
6968,3,미니미니,2666,0,1,1,2,50.0%,13m
6974,3,들꽃,2665,1198,188,174,362,51.9%,44m
6974,3,욕구호기심기쁨,2665,1488,167,160,327,51.1%,13m
6974,3,뚝배기깎는노인,2665,639,30,25,55,54.5%,44m
6974,3,BigSpaceGuy,2665,404,21,18,39,53.8%,44m
6978,3,BEETLESCAB,2664,1093,55,39,94,58.5%,39m
6978,3,[中國病毒]TGIIIIIIIITG,2664,994,39,34,73,53.4%,45m
6978,2,벤츠,2664,597,39,43,82,47.6%,43m
6978,1,srs,2664,44,1,1,2,50.0%,10m
6978,3,이카루스,2664,0,1,2,3,33.3%,39m
6983,2,winsman,2663,1544,246,232,478,51.5%,43m
6983,3,화신,2663,657,67,55,122,54.9%,44m
6983,1,MrHydra,2663,341,8,0,8,100.0%,12m
6983,3,상한고등어,2663,151,6,7,13,46.2%,17m
6983,1,WCC,2663,138,3,2,5,60.0%,10m
6983,1,TheDj,2663,0,2,3,5,40.0%,38m
6983,3,[怕死的死神]歐皇界的歐神,2663,58,2,5,7,28.6%,12m
6990,2,Leo,2662,347,26,22,48,54.2%,43m
6990,2,IIIIllllIIII,2662,186,6,14,20,30.0%,44m
6990,3,난쭌이다,2662,0,1,1,2,50.0%,32m
6990,1,agyh,2662,0,1,2,3,33.3%,16m
6994,2,sisonpyh,2661,1541,574,587,1161,49.4%,44m
6994,3,Gatsby,2661,1493,407,395,802,50.7%,6m
6994,3,존시나,2661,264,10,12,22,45.5%,44m
6994,1,닉넴귀찮,2661,62,5,8,13,38.5%,40m
6994,3,Mobit,2661,30,4,4,8,50.0%,39m
6994,1,Kai,2661,0,2,3,5,40.0%,38m
6994,3,[공허거주]대박이야,2661,30,2,5,7,28.6%,45m
7001,1,JoJo,2660,217,8,17,25,32.0%,10m
7002,3,핑구,2659,1493,260,261,521,49.9%,45m
7002,1,赤天痕,2659,1852,110,103,213,51.6%,11m
7002,3,Ymir,2659,425,39,27,66,59.1%,45m
7002,1,tlszla,2659,915,27,26,53,50.9%,10m
7002,1,EZZIGG,2659,496,16,31,47,34.0%,42m
7002,3,[Xbaek]Infinity,2659,148,5,8,13,38.5%,13m
7002,1,agony,2659,144,4,4,8,50.0%,14m
7002,1,海陸賺隊,2659,0,3,2,5,60.0%,38m
7002,1,이게안맞네,2659,90,2,2,4,50.0%,12m
7011,3,冰燄戀痕,2658,813,90,75,165,54.5%,45m
7011,1,Gredo,2658,196,6,4,10,60.0%,38m
7011,1,[298]홀짝장인,2658,167,5,4,9,55.6%,15m
7011,2,아버지,2658,167,4,3,7,57.1%,19m
7011,3,달콤한방구,2658,122,4,9,13,30.8%,13m
7011,2,사카린시럽,2658,0,1,0,1,100.0%,19m
7011,3,llllllllllll,2658,0,0,3,3,0.0%,13m
7018,1,경상도사나이,2657,814,95,94,189,50.3%,42m
7018,3,SheepPalOma,2657,635,22,24,46,47.8%,45m
7018,2,[北U士官學校]황펭귄,2657,150,3,1,4,75.0%,19m
7018,3,Conqueror,2657,0,1,12,13,7.7%,7m
7022,2,COLD,2656,1501,253,262,515,49.1%,44m
7022,3,호색광,2656,529,24,16,40,60.0%,39m
7022,3,째원,2656,447,18,19,37,48.6%,13m
7022,1,[오마이걸승희]흑사선,2656,422,12,8,20,60.0%,12m
7022,1,음표,2656,0,5,0,5,100.0%,38m
7022,1,彘淵,2656,0,1,0,1,100.0%,12m
7022,1,craig,2656,0,1,1,2,50.0%,12m
7022,3,후전드,2656,30,1,12,13,7.7%,7m
7022,1,마시좋아,2656,0,0,2,2,0.0%,16m
7031,3,PoohaBest,2655,114,4,7,11,36.4%,13m
7031,2,서늘한성에꽃이,2655,0,0,1,1,0.0%,10m
7033,1,쪽집개,2654,516,14,10,24,58.3%,11m
7033,3,已完成,2654,239,7,5,12,58.3%,16m
7033,3,IIIIIIII,2654,195,6,7,13,46.2%,17m
7033,1,Kimsanjan,2654,97,3,3,6,50.0%,16m
7033,3,BananaPie,2654,97,3,6,9,33.3%,16m
7038,3,dave,2653,1541,69,61,130,53.1%,39m
7038,3,병아리,2653,563,21,22,43,48.8%,13m
7038,1,제트뭉뭉이,2653,306,9,2,11,81.8%,12m
7038,1,Woojin,2653,304,8,6,14,57.1%,12m
7038,2,Sasin,2653,60,3,10,13,23.1%,43m
7038,1,Arto,2653,0,2,3,5,40.0%,38m
7038,1,배드게임,2653,0,1,1,2,50.0%,38m
7038,1,[뒷세계사람들]IlIlIlIlIlIl,2653,0,0,1,1,0.0%,16m
7046,1,toy,2652,1532,113,117,230,49.1%,40m
7046,3,jinhyeok,2652,1513,89,84,173,51.4%,39m
7046,3,아니이이,2652,1208,47,44,91,51.6%,39m
7046,1,[비트]오버마인드,2652,470,14,9,23,60.9%,11m
7046,2,gotomato,2652,268,9,18,27,33.3%,44m
7046,1,John,2652,182,6,2,8,75.0%,11m
7046,3,hunganh,2652,92,4,5,9,44.4%,45m
7046,1,BemusedRat,2652,138,3,3,6,50.0%,12m
7046,1,Rick,2652,44,3,3,6,50.0%,11m
7046,1,Genie,2652,0,2,3,5,40.0%,15m
7046,2,飄飄影,2652,0,1,0,1,100.0%,19m
7057,1,제라툴,2651,257,7,8,15,46.7%,38m
7057,1,[ForGG]잘못해요,2651,44,2,0,2,100.0%,11m
7059,3,모아이,2650,334,12,11,23,52.2%,13m
7059,3,[국가정보원]마돈나,2650,218,8,8,16,50.0%,39m
7059,2,명백한스린이,2650,148,4,3,7,57.1%,10m
7059,1,저그로적을,2650,96,4,5,9,44.4%,15m
7059,1,Kim,2650,113,4,6,10,40.0%,38m
7059,3,그레이트팍,2650,60,3,3,6,50.0%,45m
7059,3,[어윤수님개쩜]동크만크,2650,95,3,4,7,42.9%,39m
7059,3,alalfrogSoLo,2650,30,2,4,6,33.3%,44m
7067,1,BABA,2649,793,61,79,140,43.6%,42m
7067,2,컴퓨터,2649,272,11,12,23,47.8%,39m
7067,3,djlee,2649,255,10,6,16,62.5%,39m
7067,2,짝뚜는빵떠기,2649,226,6,8,14,42.9%,18m
7067,3,가을스케치,2649,121,2,3,5,40.0%,16m
7067,3,XueHuaPiao,2649,0,2,4,6,33.3%,39m
7067,1,사기꾼,2649,0,1,0,1,100.0%,11m
7067,1,水立杰,2649,0,0,2,2,0.0%,38m
7075,2,sugure,2648,1554,350,347,697,50.2%,43m
7075,2,Skullz,2648,1172,51,45,96,53.1%,39m
7075,2,[자보스]징징키오,2648,635,25,35,60,41.7%,39m
7075,1,abc,2648,223,9,11,20,45.0%,41m
7075,1,Sukhoi,2648,280,8,6,14,57.1%,12m
7075,2,박캐리,2648,116,5,6,11,45.5%,40m
7081,3,이상한돌,2647,1203,55,47,102,53.9%,39m
7081,3,underdog,2647,188,22,24,46,47.8%,44m
7081,2,아이스,2647,346,15,23,38,39.5%,7m
7081,1,MadMax,2647,0,2,3,5,40.0%,15m
7085,1,태영이는은희꺼,2646,1814,95,99,194,49.0%,12m
7085,2,유호성,2646,1420,89,91,180,49.4%,43m
7085,2,Anonymous,2646,260,9,2,11,81.8%,18m
7085,1,붱이,2646,169,4,5,9,44.4%,15m
7085,3,카봇광전사,2646,114,4,9,13,30.8%,44m
7085,1,GoAsRuY,2646,140,3,6,9,33.3%,12m
7085,1,[MCDSTP]靈喵喵,2646,0,2,3,5,40.0%,15m
7085,1,song,2646,0,1,0,1,100.0%,11m
7085,1,쫄지말그라,2646,0,1,0,1,100.0%,11m
7085,1,채이니,2646,0,1,4,5,20.0%,15m
7095,2,[EZboYz]mHIsT,2645,164,7,7,14,50.0%,39m
7095,2,향미씨,2645,88,4,5,9,44.4%,39m
7095,1,RavenADW,2645,176,4,13,17,23.5%,12m
7095,1,악랑,2645,73,0,2,2,0.0%,38m
7099,2,Patrick,2644,1424,109,109,218,50.0%,44m
7099,2,유헌수,2644,500,23,29,52,44.2%,43m
7099,1,yim,2644,278,8,7,15,53.3%,12m
7099,3,꼬북이,2644,208,7,8,15,46.7%,33m
7099,1,아놔시발,2644,0,0,1,1,0.0%,38m
7099,1,PLAYING,2644,0,0,1,1,0.0%,20m
7099,1,Ryzen,2644,0,0,1,1,0.0%,38m
7106,1,llllllllllll,2643,1172,40,41,81,49.4%,12m
7106,3,黑丝红高跟,2643,535,35,20,55,63.6%,44m
7106,3,아쿠아,2643,872,32,35,67,47.8%,13m
7106,2,symftom,2643,361,13,16,29,44.8%,43m
7106,1,[NGamE2]chan,2643,126,4,2,6,66.7%,11m
7106,1,오버로드개꿀맛,2643,88,2,1,3,66.7%,11m
7106,1,자랑충,2643,0,0,1,1,0.0%,14m
7106,1,dhran,2643,0,0,1,1,0.0%,11m
7114,3,하프시코드,2642,1472,105,94,199,52.8%,39m
7114,2,[디시인사이드]준식하무현,2642,210,7,8,15,46.7%,40m
7114,1,GIMIN,2642,0,2,1,3,66.7%,38m
7114,3,[最後生還者]笨笨,2642,30,1,1,2,50.0%,16m
7118,1,[ANGG]DOFE,2641,724,23,9,32,71.9%,12m
7118,3,감사합니다람쥐,2641,363,12,13,25,48.0%,39m
7118,2,show,2641,243,11,9,20,55.0%,40m
7118,1,신용,2641,0,2,3,5,40.0%,15m
7118,1,하정우,2641,121,2,4,6,33.3%,12m
7118,1,뽀삐,2641,0,1,0,1,100.0%,15m
7118,1,짐네이뇬,2641,46,1,5,6,16.7%,38m
7118,1,[C89923]MrTrump,2641,0,0,1,1,0.0%,10m
7118,1,오솔오소롤,2641,0,0,1,1,0.0%,38m
7127,1,[大嘴鳥]海鷗,2640,610,32,45,77,41.6%,42m
7127,3,說好不打臉,2640,766,27,31,58,46.6%,13m
7127,3,내가너이겨,2640,30,4,4,8,50.0%,39m
7127,3,DayWorker,2640,94,3,9,12,25.0%,44m
7127,1,device,2640,0,1,1,2,50.0%,11m
7132,3,月壇,2639,0,6,11,17,35.3%,13m
7132,1,Hazard,2639,0,2,4,6,33.3%,16m
7132,1,찌롱이,2639,0,0,1,1,0.0%,11m
7135,1,Doug,2638,150,4,5,9,44.4%,38m
7135,1,LEESSBEKR,2638,0,3,3,6,50.0%,16m
7137,3,SoundBOX,2637,1223,329,328,657,50.1%,45m
7137,2,[Troupe]지구가식으면,2637,589,23,28,51,45.1%,3m
7137,3,[무한김준현]IIIIIIIIIIII,2637,291,9,8,17,52.9%,13m
7137,1,[누님]kjun,2637,248,9,10,19,47.4%,41m
7137,3,[騎山豬甩尾]神豬爺爺,2637,146,4,5,9,44.4%,45m
7137,1,Perfecto,2637,0,0,1,1,0.0%,16m
7143,2,grafity,2636,342,11,22,33,33.3%,44m
7143,3,[JPMG]밀스,2636,97,9,3,12,75.0%,13m
7143,3,misterjoon,2636,239,8,7,15,53.3%,13m
7143,2,KFC,2636,206,6,6,12,50.0%,19m
7143,3,요다닷,2636,167,4,5,9,44.4%,39m
7143,3,척살,2636,94,4,5,9,44.4%,45m
7143,1,MaxRayne,2636,0,2,3,5,40.0%,38m
7143,3,제주감귤,2636,30,2,4,6,33.3%,44m
7151,2,류대표,2635,1460,545,533,1078,50.6%,43m
7151,1,Rezero,2635,258,7,2,9,77.8%,12m
7151,1,제리,2635,0,0,2,2,0.0%,11m
7151,2,TAYLOR,2635,0,0,8,8,0.0%,44m
7155,3,범고래,2634,400,16,16,32,50.0%,39m
7155,1,덴므,2634,121,1,3,4,25.0%,10m
7155,1,회색마뇨,2634,44,1,3,4,25.0%,11m
7158,3,[국가정보원]푸스로다,2633,1484,113,113,226,50.0%,45m
7158,3,[ClSt]AfreecaTV,2633,124,6,10,16,37.5%,17m
7158,1,gaga,2633,42,3,3,6,50.0%,38m
7158,1,앙기무띠,2633,97,1,1,2,50.0%,15m
7162,2,[무리무리팸]MerCurial,2632,602,22,29,51,43.1%,43m
7162,2,撞到你開花,2632,409,17,15,32,53.1%,44m
7162,2,lucy,2632,287,10,10,20,50.0%,18m
7162,3,RandomName,2632,120,4,8,12,33.3%,13m
7162,1,[꼴받네]어서오고,2632,0,2,3,5,40.0%,16m
7167,3,MIDAS,2631,1486,270,266,536,50.4%,44m
7167,1,Covaena,2631,0,2,3,5,40.0%,16m
7167,1,리바이어,2631,0,2,3,5,40.0%,38m
7170,3,간다간다퐁간다,2630,222,9,11,20,45.0%,39m
7170,1,[머구폐렴]설원기설,2630,194,5,4,9,55.6%,38m
7170,3,별이아부지,2630,94,4,9,13,30.8%,45m
7170,3,제다이,2630,33,2,6,8,25.0%,45m
7170,3,DoubleJH,2630,96,1,2,3,33.3%,39m
7175,1,[Tyler]준호짱,2629,824,28,42,70,40.0%,42m
7175,2,[Yeh]Eric,2629,36,19,17,36,52.8%,44m
7175,3,마한판붙어보자마,2629,362,14,14,28,50.0%,45m
7175,3,대물러버,2629,176,6,10,16,37.5%,13m
7175,3,안면어글,2629,0,3,3,6,50.0%,39m
7175,1,[SClI]고오급히오스,2629,0,0,1,1,0.0%,12m
7181,2,MFourAOne,2628,1529,178,172,350,50.9%,44m
7181,3,llIIIllIIIl,2628,178,7,10,17,41.2%,13m
7181,3,AMAD,2628,90,3,7,10,30.0%,45m
7181,1,Loging,2628,0,2,4,6,33.3%,14m
7181,2,小謙,2628,0,1,1,2,50.0%,10m
7181,1,涼麵與幻櫻,2628,0,0,1,1,0.0%,11m
7187,1,倚天屠龙记,2627,1276,43,37,80,53.8%,38m
7187,1,RankTrooper,2627,152,5,1,6,83.3%,38m
7187,1,Johnny,2627,72,2,3,5,40.0%,11m
7187,1,kevin,2627,0,2,5,7,28.6%,15m
7187,1,[똑띠해라]QuasarStar,2627,0,1,1,2,50.0%,10m
7192,3,bourne,2626,842,65,57,122,53.3%,13m
7192,2,RDo,2626,608,23,25,48,47.9%,44m
7192,2,Alex,2626,424,17,26,43,39.5%,44m
7192,2,IMBOOD,2626,321,12,9,21,57.1%,19m
7192,2,pisknx,2626,180,9,11,20,45.0%,39m
7192,3,[무적함대]saturn,2626,90,3,7,10,30.0%,13m
7192,1,BigFire,2626,0,2,4,6,33.3%,15m
7192,3,Yueeeee,2626,0,2,4,6,33.3%,39m
7200,3,거신,2625,821,35,32,67,52.2%,39m
7200,1,wanttobegold,2625,86,6,9,15,40.0%,41m
7200,2,CandyMan,2625,118,4,6,10,40.0%,18m
7200,1,왕자꽃,2625,0,1,5,6,16.7%,12m
7204,2,llIIlIIIlII,2624,1486,139,136,275,50.5%,43m
7204,1,Morp,2624,664,21,23,44,47.7%,12m
7204,1,키오,2624,427,11,9,20,55.0%,38m
7204,1,웅캬컄,2624,146,5,4,9,55.6%,12m
7204,2,글로드바,2624,0,0,1,1,0.0%,19m
7209,2,Cafiend,2623,1397,200,196,396,50.5%,44m
7209,3,열고,2623,1543,133,130,263,50.6%,39m
7209,1,june,2623,1309,49,37,86,57.0%,38m
7209,1,Tizza,2623,532,14,13,27,51.9%,11m
7209,1,심심한조씨,2623,218,5,4,9,55.6%,16m
7209,1,Anija,2623,44,2,4,6,33.3%,11m
7215,3,허동은,2622,1556,76,64,140,54.3%,39m
7215,3,마오짱짱맨,2622,127,9,14,23,39.1%,45m
7215,2,Secret,2622,131,3,2,5,60.0%,19m
7215,1,Dot,2622,0,2,3,5,40.0%,11m
7215,1,Klevil,2622,0,2,3,5,40.0%,38m
7215,1,yang,2622,0,1,0,1,100.0%,38m
7215,1,뭉치멍멍,2622,73,0,2,2,0.0%,11m
7222,2,MonsterLin,2621,525,21,27,48,43.8%,44m
7222,2,Wrath,2621,325,12,13,25,48.0%,39m
7222,2,영원히비와,2621,90,7,11,18,38.9%,8m
7222,1,대통령,2621,106,4,3,7,57.1%,12m
7222,3,Namotasa,2621,138,4,5,9,44.4%,13m
7222,3,원써겐,2621,62,3,6,9,33.3%,13m
7222,1,[大領主的裙擺]烏木喉,2621,0,2,3,5,40.0%,38m
7222,1,Mirkakoko,2621,0,2,4,6,33.3%,16m
7230,1,동동이,2620,1119,45,52,97,46.4%,41m
7230,3,손민기,2620,560,23,15,38,60.5%,45m
7230,1,BarbieDoll,2620,80,3,2,5,60.0%,10m
7230,3,토사장,2620,30,3,4,7,42.9%,39m
7230,1,hanwoolive,2620,134,3,5,8,37.5%,12m
7230,2,Hinoob,2620,0,2,3,5,40.0%,14m
7230,1,stuck,2620,34,1,3,4,25.0%,11m
7230,3,코코아,2620,0,1,3,4,25.0%,45m
7230,1,시문,2620,0,0,1,1,0.0%,11m
7239,3,BOX,2619,1516,343,346,689,49.8%,39m
7239,1,wonderboy,2619,144,5,5,10,50.0%,15m
7239,1,[0922]ssdia,2619,120,3,1,4,75.0%,13m
7239,1,헤파팍스,2619,124,3,5,8,37.5%,38m
7239,1,Gilgamesh,2619,0,2,3,5,40.0%,38m
7239,1,[5torM]성자초,2619,0,0,2,2,0.0%,16m
7245,1,월탄,2618,326,10,10,20,50.0%,12m
7245,1,성지순례,2618,298,8,9,17,47.1%,11m
7245,3,OKyj,2618,30,2,4,6,33.3%,45m
7245,1,[문화충격]난참차케,2618,0,0,1,1,0.0%,12m
7245,3,어느사람,2618,0,0,2,2,0.0%,45m
7250,2,김밥이,2617,1472,93,100,193,48.2%,44m
7250,1,늑대,2617,878,69,63,132,52.3%,12m
7250,1,PoL,2617,493,16,22,38,42.1%,42m
7250,3,길가던강아지,2617,301,11,13,24,45.8%,39m
7250,3,TMT,2617,128,6,6,12,50.0%,17m
7250,1,Lyn,2617,0,3,2,5,60.0%,39m
7250,1,지방시설주사보,2617,48,3,9,12,25.0%,16m
7250,1,nobodycan,2617,0,2,4,6,33.3%,15m
7250,1,어어우어어어없,2617,0,1,0,1,100.0%,38m
7259,2,예비군홍콩,2616,280,23,33,56,41.1%,44m
7259,2,Eternity,2616,290,11,12,23,47.8%,18m
7259,1,諾諾,2616,257,8,4,12,66.7%,12m
7259,1,llllllllllll,2616,217,4,2,6,66.7%,16m
7263,3,자날,2615,370,27,28,55,49.1%,45m
7263,3,[광막새벽반]콘칩먹고힘내요,2615,204,17,16,33,51.5%,45m
7263,1,마린,2615,0,0,1,1,0.0%,38m
7266,1,[독일국방군]솜콩이,2614,728,22,21,43,51.2%,12m
7266,1,advadv,2614,288,8,8,16,50.0%,11m
7266,3,blackhowling,2614,96,3,4,7,42.9%,39m
7266,1,진영,2614,169,3,6,9,33.3%,39m
7266,1,스타계의염경환씨,2614,40,2,1,3,66.7%,10m
7266,1,창우,2614,44,2,2,4,50.0%,11m
7266,1,[싯가의유산]앤타로아둔,2614,0,0,1,1,0.0%,11m
7266,1,숏다리해병,2614,0,0,3,3,0.0%,39m
7274,1,wheodrl,2613,97,2,5,7,28.6%,38m
7274,2,[테란연맹]감염된심영,2613,0,1,0,1,100.0%,18m
7276,2,burai,2612,0,5,7,12,41.7%,19m
7276,1,llllllllllll,2612,0,1,0,1,100.0%,38m
7276,1,Leo,2612,0,1,0,1,100.0%,38m
7276,1,blood,2612,46,1,1,2,50.0%,13m
7276,1,새로캐릭터,2612,44,1,1,2,50.0%,38m
7276,1,우리엄마,2612,0,0,1,1,0.0%,11m
7282,1,[ZZQFAN]Domennico,2611,478,16,7,23,69.6%,10m
7282,3,슐레이드,2611,250,10,13,23,43.5%,39m
7282,1,[국가정보원]잉옹잉,2611,0,2,3,5,40.0%,15m
7282,1,ejhvery,2611,0,2,3,5,40.0%,38m
7282,1,Azir,2611,0,1,2,3,33.3%,11m
7282,1,寶貝宇,2611,36,1,2,3,33.3%,20m
7282,2,QsmileQ,2611,0,1,4,5,20.0%,14m
7289,3,[nomoon]Socro,2610,233,8,8,16,50.0%,39m
7289,3,[동네노는형들]Mong,2610,214,7,13,20,35.0%,45m
7289,1,Damavand,2610,0,1,0,1,100.0%,38m
7289,3,llllllllllll,2610,0,1,5,6,16.7%,13m
7289,1,아재컨트롤,2610,0,0,2,2,0.0%,38m
7289,1,gginin,2610,0,0,2,2,0.0%,12m
7295,1,로봇자객,2609,438,14,23,37,37.8%,11m
7295,3,[김태웅]KJTTY,2609,251,9,7,16,56.2%,13m
7295,1,[Dullll]Nyuuuuuuu,2609,48,4,4,8,50.0%,15m
7295,3,봉골레파스타,2609,148,3,5,8,37.5%,17m
7295,1,SOHU,2609,0,1,0,1,100.0%,38m
7295,1,[FSHVM]포건맨,2609,0,1,0,1,100.0%,15m
7301,3,덩굴손,2608,879,67,74,141,47.5%,13m
7301,3,babesh,2608,1423,54,55,109,49.5%,13m
7301,1,깨닭파닭,2608,574,20,17,37,54.1%,11m
7301,3,저그,2608,193,15,15,30,50.0%,45m
7301,1,BigBadWolf,2608,48,1,2,3,33.3%,11m
7306,1,날으는펭귄,2607,0,1,2,3,33.3%,13m
7306,1,[마인그룬트]신미양요,2607,34,1,2,3,33.3%,38m
7308,1,[GITS]cavalier,2606,1104,39,27,66,59.1%,11m
7308,1,jiwoong,2606,184,6,1,7,85.7%,12m
7308,1,[망겜장인]호프집누나,2606,121,4,4,8,50.0%,16m
7308,2,[帥氣惡勢力]Kenny,2606,0,1,0,1,100.0%,10m
7308,1,단발,2606,0,0,1,1,0.0%,11m
7308,1,에르지야스,2606,0,0,2,2,0.0%,12m
7314,2,좀비굴,2605,1475,97,88,185,52.4%,40m
7314,3,[Ffly]DHISNEMO,2605,159,12,9,21,57.1%,13m
7314,1,[6Teen]Dysutopia,2605,46,2,1,3,66.7%,38m
7314,1,SSSUKKK,2605,0,1,1,2,50.0%,12m
7318,1,대박집,2604,1327,119,126,245,48.6%,42m
7318,3,Jian,2604,272,9,10,19,47.4%,17m
7318,2,QinXianer,2604,166,6,11,17,35.3%,18m
7318,1,[爆蛋]扬总的好哥哥,2604,231,6,19,25,24.0%,11m
7318,3,tabiseal,2604,162,5,9,14,35.7%,45m
7318,1,바르샤,2604,138,4,21,25,16.0%,20m
7318,2,섭이,2604,94,3,15,18,16.7%,44m
7318,1,박준규,2604,46,1,1,2,50.0%,12m
7318,1,누가좀가르쳐줘,2604,0,0,1,1,0.0%,16m
7327,1,Avalanche,2603,1358,235,226,461,51.0%,42m
7327,1,충무공강감찬,2603,1526,63,58,121,52.1%,11m
7327,1,[맛있는한우]한우판매원,2603,148,6,7,13,46.2%,12m
7327,1,오징오징,2603,0,1,1,2,50.0%,12m
7327,1,sgsgsg,2603,38,1,2,3,33.3%,12m
7332,3,암흑별,2602,341,12,12,24,50.0%,13m
7333,1,[독도비둘기]단쿡도너츠,2601,1376,59,85,144,41.0%,10m
7333,2,Pete,2601,1023,38,44,82,46.3%,39m
7333,3,killerlo,2601,154,6,13,19,31.6%,45m
7333,3,skytheater,2601,48,5,8,13,38.5%,45m
7333,1,[zAWSLz]阿森,2601,86,3,2,5,60.0%,11m
7333,1,deutschland,2601,97,3,4,7,42.9%,16m
7333,1,llllllllllll,2601,34,2,2,4,50.0%,10m
7333,1,jkpxT,2601,70,2,4,6,33.3%,11m
7333,3,프로토스,2601,0,0,2,2,0.0%,17m
7333,1,[神盟]DIZZZZZZZZZY,2601,0,0,2,2,0.0%,38m
7343,2,Docker,2600,1103,44,40,84,52.4%,39m
7343,3,[충북제천시]남훈,2600,0,5,2,7,71.4%,45m
7345,3,Remnant,2599,598,107,106,213,50.2%,45m
7345,3,ldy,2599,1143,48,43,91,52.7%,39m
7345,3,HappenHS,2599,653,27,23,50,54.0%,39m
7345,3,오즈,2599,284,9,14,23,39.1%,45m
7345,3,혁명군,2599,30,2,1,3,66.7%,17m
7345,2,Trasher,2599,0,2,3,5,40.0%,14m
7345,1,NoName,2599,46,2,3,5,40.0%,38m
7345,1,IIIIIIIIIII,2599,48,1,7,8,12.5%,15m
7353,3,[뉴비의똥꼬쇼]zJustaNewbie,2598,431,36,28,64,56.2%,45m
7353,1,서민,2598,339,13,10,23,56.5%,11m
7353,2,dobis,2598,362,13,20,33,39.4%,43m
7353,1,jihugyg,2598,86,3,3,6,50.0%,12m
7353,1,CZMwinter,2598,0,2,4,6,33.3%,16m
7353,2,llllllllllll,2598,0,1,0,1,100.0%,14m
7353,3,짐레이너,2598,0,0,1,1,0.0%,16m
7360,1,김샤코,2597,1514,55,49,104,52.9%,38m
7360,1,[케플러]졸준위원장,2597,686,21,23,44,47.7%,12m
7360,1,雷諾突擊長,2597,346,12,10,22,54.5%,12m
7360,1,RHINE,2597,188,7,8,15,46.7%,11m
7360,1,[스타놀이터]만성피로곰탱이,2597,100,3,3,6,50.0%,12m
7360,2,PedoPanda,2597,48,3,3,6,50.0%,15m
7360,2,Danny,2597,0,2,3,5,40.0%,14m
7367,3,coolaiko,2596,222,8,9,17,47.1%,17m
7367,1,FIREX,2596,203,6,7,13,46.2%,12m
7367,1,[국방부사서병]DeathKnight,2596,42,3,4,7,42.9%,13m
7367,1,도라지탕,2596,0,3,5,8,37.5%,16m
7367,1,대막리지,2596,78,2,2,4,50.0%,39m
7367,1,다잡아먹쟈,2596,44,2,3,5,40.0%,20m
7373,2,상어잡이성하,2595,1226,70,73,143,49.0%,44m
7373,1,iris,2595,724,21,17,38,55.3%,12m
7373,3,llllllllllll,2595,498,20,26,46,43.5%,13m
7373,1,호림,2595,0,0,2,2,0.0%,12m
7377,1,해안,2594,1370,47,45,92,51.1%,10m
7377,1,[JOVi]GGmania,2594,704,20,21,41,48.8%,11m
7377,1,OOpIce,2594,464,13,12,25,52.0%,12m
7377,3,데드크로스,2594,92,4,7,11,36.4%,13m
7377,1,Booty,2594,0,2,5,7,28.6%,16m
7377,3,송현아,2594,0,0,1,1,0.0%,16m
7377,1,[TITOS]Einein,2594,0,0,1,1,0.0%,39m
7377,2,joowoo,2594,0,0,2,2,0.0%,10m
7377,2,[rada]Dral,2594,0,0,2,2,0.0%,19m
7386,1,이아나,2593,1510,50,51,101,49.5%,38m
7386,1,Gajago,2593,1058,33,29,62,53.2%,10m
7386,3,프라이밋,2593,432,15,18,33,45.5%,13m
7386,3,고타조,2593,135,4,9,13,30.8%,16m
7386,3,노진혁,2593,140,3,4,7,42.9%,39m
7386,2,wanwon,2593,0,2,3,5,40.0%,14m
7386,3,조꼬삼,2593,0,2,4,6,33.3%,45m
7386,1,혼란하다혼란해,2593,0,1,4,5,20.0%,38m
7386,1,아놔아나아나아난,2593,0,0,1,1,0.0%,11m
7386,1,ikmsisky,2593,0,0,1,1,0.0%,11m
7386,2,[uruski]우리가족,2593,0,0,1,1,0.0%,20m
7397,3,[국가정보원]kldsjflkjaw,2592,1251,132,143,275,48.0%,13m
7397,1,今晚打老虎,2592,1165,42,34,76,55.3%,38m
7397,1,大毛,2592,198,17,35,52,32.7%,41m
7397,1,影龍,2592,0,2,4,6,33.3%,16m
7401,3,[Worm]IPID,2591,1029,39,45,84,46.4%,45m
7401,1,트롤,2591,348,11,13,24,45.8%,38m
7403,2,我真的不知道,2590,999,106,105,211,50.2%,43m
7403,3,박카스,2590,565,79,71,150,52.7%,13m
7403,2,ironheel,2590,332,15,18,33,45.5%,40m
7403,1,doubleo,2590,320,12,8,20,60.0%,12m
7403,1,NiuDan,2590,368,10,11,21,47.6%,12m
7403,1,인공지능,2590,230,8,0,8,100.0%,11m
7403,1,[김치헤드족]김똘러브,2590,121,4,2,6,66.7%,16m
7403,1,소라카의큰바나나,2590,86,3,1,4,75.0%,38m
7403,1,[정치공학]사이,2590,0,2,4,6,33.3%,16m
7412,3,ozone,2589,1510,119,144,263,45.2%,6m
7412,1,stravvverry,2589,208,5,8,13,38.5%,38m
7412,1,爲了最好最好,2589,46,2,3,5,40.0%,11m
7412,1,[하로야]라이언코리,2589,0,0,2,2,0.0%,39m
7416,3,무요,2588,1156,181,178,359,50.4%,45m
7416,2,이카루스의수호단,2588,1391,179,170,349,51.3%,44m
7416,1,추잡,2588,348,11,10,21,52.4%,11m
7416,1,[VASCO]해랑사,2588,346,9,11,20,45.0%,11m
7416,1,[보니하니수민]chaos,2588,316,8,7,15,53.3%,12m
7416,3,PLANNER,2588,60,5,6,11,45.5%,13m
7416,1,카아진,2588,126,4,1,5,80.0%,12m
7416,3,유노윤호,2588,30,1,5,6,16.7%,18m
7416,1,kenliu,2588,0,0,1,1,0.0%,12m
7425,3,[조선해군]을지문덕,2587,488,22,21,43,51.2%,39m
7425,1,사람입니다,2587,180,5,3,8,62.5%,12m
7425,2,kkppd,2587,0,4,10,14,28.6%,8m
7425,1,반필터,2587,0,1,1,2,50.0%,11m
7425,1,양군,2587,0,1,1,2,50.0%,12m
7425,1,[33250]bumpman,2587,0,1,2,3,33.3%,11m
7425,1,가을의태란,2587,42,1,6,7,14.3%,11m
7425,3,카인네오,2587,0,0,1,1,0.0%,17m
7433,1,墨染樱,2586,514,15,18,33,45.5%,11m
7433,2,lllwrd,2586,0,1,0,1,100.0%,14m
7433,1,ShinJH,2586,0,0,1,1,0.0%,11m
7433,1,moon,2586,0,0,1,1,0.0%,16m
7433,1,gatonegro,2586,0,0,1,1,0.0%,38m
7438,1,mullard,2585,1253,50,48,98,51.0%,12m
7438,3,월아천충,2585,940,33,39,72,45.8%,45m
7438,3,꽐라독,2585,441,17,19,36,47.2%,13m
7438,1,[달빛양념기사]멀린,2585,301,10,7,17,58.8%,38m
7438,2,AHS,2585,192,5,9,14,35.7%,40m
7438,1,doufi,2585,0,1,0,1,100.0%,38m
7444,1,양학,2584,272,9,8,17,52.9%,38m
7444,2,나초보,2584,0,0,1,1,0.0%,15m
7444,1,[礦物]海賊,2584,0,0,1,1,0.0%,12m
7444,1,그냥게임하는사람,2584,0,0,1,1,0.0%,11m
7448,3,밤까마귀,2583,1545,130,135,265,49.1%,13m
7448,3,Fyr,2583,1261,56,51,107,52.3%,39m
7448,2,Kyo,2583,30,4,6,10,40.0%,45m
7448,2,HumbleCat,2583,48,3,3,6,50.0%,14m
7448,2,물렁흑두부,2583,0,2,3,5,40.0%,14m
7448,1,메로나,2583,0,1,1,2,50.0%,12m
7448,1,국산비둘기,2583,0,0,1,1,0.0%,38m
7455,3,노트,2582,514,35,42,77,45.5%,13m
7455,1,Soso,2582,405,14,12,26,53.8%,11m
7455,2,[너의ol름은]핫초코,2582,201,8,11,19,42.1%,43m
7455,3,freex,2582,217,7,8,15,46.7%,17m
7455,1,boram,2582,296,6,3,9,66.7%,38m
7455,1,라메몽,2582,124,4,7,11,36.4%,12m
7455,2,Xenesus,2582,48,3,3,6,50.0%,14m
7455,1,ixigua,2582,48,2,3,5,40.0%,16m
7455,1,[중금속중독자]알게뭐야,2582,96,1,2,3,33.3%,38m
7455,1,MXM,2582,73,0,3,3,0.0%,38m
7465,1,winteriscom,2581,461,19,14,33,57.6%,11m
7465,1,껍똘이아빠,2581,496,14,12,26,53.8%,11m
7465,1,마쵸킹,2581,456,13,18,31,41.9%,12m
7465,2,ares,2581,204,9,11,20,45.0%,18m
7465,1,jclee,2581,186,6,7,13,46.2%,38m
7465,3,KFC,2581,220,6,7,13,46.2%,17m
7465,3,zest,2581,156,6,12,18,33.3%,39m
7465,3,조르지호,2581,30,3,6,9,33.3%,39m
7465,1,와우하다접속,2581,42,1,6,7,14.3%,11m
7465,1,tlsgodbs,2581,0,0,1,1,0.0%,12m
7465,2,예하,2581,0,0,1,1,0.0%,14m
7476,1,광전사,2580,1526,69,62,131,52.7%,12m
7476,1,PUNGSHIN,2580,1119,40,33,73,54.8%,13m
7476,1,알타,2580,352,11,4,15,73.3%,11m
7476,1,我不是好人,2580,281,11,6,17,64.7%,38m
7476,1,청천,2580,194,6,1,7,85.7%,12m
7476,1,IIIIIIIIIlll,2580,122,3,20,23,13.0%,6m
7482,3,도날드,2579,543,19,26,45,42.2%,45m
7482,1,머시라고,2579,486,13,13,26,50.0%,11m
7482,1,[S2inW]DAZIGI,2579,338,10,9,19,52.6%,39m
7482,3,행복,2579,281,8,13,21,38.1%,39m
7482,1,legoatom,2579,76,2,6,8,25.0%,13m
7482,2,[dfg133]폭풍드롭,2579,0,1,3,4,25.0%,14m
7488,1,rogueknight,2578,1515,56,58,114,49.1%,11m
7488,1,땡땡땡,2578,1390,53,39,92,57.6%,11m
7488,1,도리,2578,477,18,17,35,51.4%,12m
7488,3,나는스타다,2578,470,18,25,43,41.9%,13m
7488,3,Noodles,2578,108,15,19,34,44.1%,13m
7488,2,BrandNewSCV,2578,259,9,12,21,42.9%,10m
7488,3,곰알바,2578,201,6,7,13,46.2%,18m
7488,1,BLADE,2578,0,0,2,2,0.0%,38m
7496,3,[무작]자유의날개,2577,886,38,35,73,52.1%,45m
7496,1,HuskyFox,2577,606,19,16,35,54.3%,12m
7496,1,소비에트연방,2577,0,2,5,7,28.6%,15m
7496,1,박선우,2577,74,2,6,8,25.0%,12m
7496,1,onlyonekill,2577,0,1,0,1,100.0%,13m
7496,1,testarosa,2577,0,0,1,1,0.0%,12m
7502,2,모옹옹,2576,1470,356,362,718,49.6%,45m
7502,1,Lily,2576,1579,156,156,312,50.0%,38m
7502,1,광탈자일인자,2576,1483,109,108,217,50.2%,41m
7502,1,까타,2576,808,27,46,73,37.0%,42m
7502,1,Ares,2576,281,9,10,19,47.4%,38m
7502,2,헤이즈,2576,0,3,2,5,60.0%,14m
7502,1,[테란연맹]왕건아우,2576,134,3,2,5,60.0%,38m
7502,3,JasMine,2576,138,3,3,6,50.0%,17m
7502,1,분노의그르르,2576,0,0,1,1,0.0%,15m
7502,1,이방인,2576,0,0,2,2,0.0%,11m
7512,1,[무한김준현]illidan,2575,945,38,47,85,44.7%,41m
7512,1,임오플토,2575,868,30,27,57,52.6%,11m
7512,1,사이코패스,2575,361,13,13,26,50.0%,11m
7512,3,[萬花筒寫輪眼]OOOO,2575,153,4,5,9,44.4%,16m
7512,2,[베스핀가스]peterpark,2575,0,3,4,7,42.9%,39m
7512,2,Artanis,2575,0,0,8,8,0.0%,39m
7518,3,JOON,2574,106,11,15,26,42.3%,45m
7518,1,플로이드,2574,146,5,5,10,50.0%,13m
7520,2,밤날개,2573,1456,176,171,347,50.7%,45m
7520,1,[SC2]를르슈,2573,536,18,13,31,58.1%,38m
7520,1,FASHION,2573,345,16,14,30,53.3%,20m
7520,3,IandYOU,2573,305,10,13,23,43.5%,13m
7520,3,rayooooooon,2573,170,6,7,13,46.2%,39m
7520,1,oftenGGblind,2573,212,5,1,6,83.3%,38m
7520,1,맙소사콩풍함,2573,0,3,4,7,42.9%,16m
7520,2,[코랄lV]RedSunMO,2573,0,3,5,8,37.5%,40m
7528,2,[꿀빠는푸우]gilbert,2572,1113,215,231,446,48.2%,44m
7528,1,Donkeynuts,2572,1697,77,74,151,51.0%,12m
7528,1,더들리페이지언덕,2572,1474,54,64,118,45.8%,41m
7528,1,LEEBACKJANG,2572,787,28,20,48,58.3%,12m
7528,1,[썩션판타지]BDSMer,2572,465,15,15,30,50.0%,12m
7528,1,어린아저씨,2572,349,12,6,18,66.7%,11m
7528,1,듀티,2572,339,10,12,22,45.5%,38m
7528,1,LenienT,2572,46,1,6,7,14.3%,11m
7536,1,가온누리,2571,791,27,27,54,50.0%,12m
7536,1,프로토스,2571,0,1,0,1,100.0%,11m
7536,1,[고물잡]저글링,2571,0,1,1,2,50.0%,38m
7536,1,인성타니스,2571,0,0,4,4,0.0%,38m
7540,3,Arcosiscal,2570,1570,217,232,449,48.3%,45m
7540,1,Aurora,2570,1056,33,33,66,50.0%,20m
7540,1,BMSM,2570,318,9,7,16,56.2%,11m
7540,3,무엘겜국사,2570,145,5,7,12,41.7%,17m
7544,1,JohnnyGroove,2569,886,38,47,85,44.7%,42m
7544,1,Andrew,2569,676,24,24,48,50.0%,11m
7544,2,[WA2000]nagi,2569,167,9,5,14,64.3%,20m
7544,1,김대엽,2569,172,7,7,14,50.0%,38m
7544,1,다시태어나고싶다,2569,232,6,4,10,60.0%,11m
7544,1,AlesHtoo,2569,143,3,5,8,37.5%,16m
7544,1,SIW,2569,46,2,0,2,100.0%,11m
7544,1,초보꼬맹이,2569,0,2,3,5,40.0%,38m
7544,1,LegitVR,2569,0,1,1,2,50.0%,11m
7544,1,maxboy,2569,0,1,4,5,20.0%,11m
7554,2,Master,2568,1140,63,74,137,46.0%,44m
7554,1,HIC,2568,385,11,14,25,44.0%,11m
7554,1,louis,2568,168,5,8,13,38.5%,11m
7554,1,[해병전우회]Loptimist,2568,153,4,7,11,36.4%,11m
7554,1,탱구짱,2568,0,1,0,1,100.0%,13m
7554,1,마스터즈,2568,44,1,4,5,20.0%,12m
7560,3,llllllllllll,2567,182,6,8,14,42.9%,13m
7560,2,Barcode,2567,42,3,4,7,42.9%,15m
7560,1,五宏,2567,0,1,2,3,33.3%,12m
7563,3,generatexaU,2566,436,17,21,38,44.7%,13m
7563,1,VIRUS,2566,318,9,7,16,56.2%,12m
7563,1,KKD,2566,193,7,3,10,70.0%,12m
7563,1,롤하다베틀넷,2566,196,6,6,12,50.0%,15m
7563,1,llllllllllll,2566,34,2,0,2,100.0%,12m
7563,1,cooper,2566,127,2,1,3,66.7%,38m
7563,1,[노벽]핑구,2566,0,0,2,2,0.0%,13m
7570,3,[EoC]xYakko,2565,1481,104,91,195,53.3%,13m
7570,2,soonsu,2565,114,4,7,11,36.4%,40m
7570,1,폭군,2565,0,3,4,7,42.9%,15m
7570,1,신발짝,2565,42,1,3,4,25.0%,12m
7570,1,火雲邪神,2565,0,0,1,1,0.0%,11m
7570,1,칠산대교,2565,0,0,1,1,0.0%,39m
7576,1,[호놀롤로]jangkoon,2564,1070,47,44,91,51.6%,11m
7576,2,[제목이내용]밴드리트,2564,0,3,2,5,60.0%,15m
7576,1,biverse,2564,139,3,5,8,37.5%,39m
7576,1,疯狂的哇哇哇,2564,92,2,3,5,40.0%,11m
7576,1,Kenzyte,2564,0,0,5,5,0.0%,38m
7581,2,명월,2563,1455,82,79,161,50.9%,44m
7581,1,MissA,2563,340,11,11,22,50.0%,38m
7581,1,문곰,2563,224,7,9,16,43.8%,12m
7581,1,뽀찌,2563,210,5,6,11,45.5%,38m
7581,1,moki,2563,0,2,5,7,28.6%,16m
7581,1,[루키]cnb,2563,0,1,1,2,50.0%,11m
7581,1,[맛있더라]아래가달랑,2563,46,1,1,2,50.0%,38m
7581,1,Arcane,2563,0,1,1,2,50.0%,12m
7589,1,일대일갓겜,2562,1668,72,64,136,52.9%,38m
7589,1,XiGinPinkGay,2562,1429,51,56,107,47.7%,11m
7589,1,URmyProtein,2562,651,28,21,49,57.1%,12m
7589,3,영미,2562,609,26,22,48,54.2%,45m
7589,1,Fain,2562,0,2,5,7,28.6%,16m
7594,1,SwarmOfZasz,2561,1341,79,95,174,45.4%,41m
7594,1,[크레타]두부김치,2561,119,5,5,10,50.0%,38m
7594,3,[비트]dsfe,2561,60,3,9,12,25.0%,13m
7594,1,[NDW]hymn,2561,76,2,2,4,50.0%,39m
7594,1,[REGENO]baggio,2561,0,1,0,1,100.0%,13m
7599,1,ALLISWELL,2560,1250,51,43,94,54.3%,38m
7599,1,legendfither,2560,111,4,4,8,50.0%,13m
7599,1,DanteH,2560,44,1,2,3,33.3%,12m
7602,3,ALARAK,2559,566,20,26,46,43.5%,13m
7602,1,Xiaozhe,2559,582,18,15,33,54.5%,12m
7602,2,내가돌아왔다,2559,150,8,10,18,44.4%,40m
7602,1,Ruslan,2559,144,3,5,8,37.5%,15m
7606,2,천안킹카,2558,730,94,98,192,49.0%,43m
7606,1,Taco,2558,48,3,6,9,33.3%,15m
7608,1,EMuMu,2557,993,42,39,81,51.9%,13m
7608,2,pLtototo,2557,298,23,37,60,38.3%,44m
7608,1,Song,2557,487,15,12,27,55.6%,11m
7608,3,Goliath,2557,204,9,7,16,56.2%,39m
7608,1,[GFTD]TempO,2557,48,3,6,9,33.3%,16m
7608,2,Thundercat,2557,0,2,3,5,40.0%,14m
7608,1,Limus,2557,38,2,7,9,22.2%,38m
7615,1,Creozotyeast,2556,460,12,12,24,50.0%,11m
7615,2,[군단파괴단]musicwave,2556,133,3,9,12,25.0%,20m
7615,1,게임잘함,2556,0,1,0,1,100.0%,16m
7615,1,HADES,2556,0,1,1,2,50.0%,38m
7615,1,미미유,2556,30,1,20,21,4.8%,43m
7615,1,NPPC,2556,0,0,2,2,0.0%,38m
7621,3,llllllllllll,2555,533,40,61,101,39.6%,7m
7621,1,weload,2555,823,30,19,49,61.2%,38m
7621,2,이태리수건,2555,356,13,18,31,41.9%,40m
7621,1,skaarf,2555,0,2,3,5,40.0%,38m
7625,3,StormCom,2554,105,19,21,40,47.5%,13m
7625,3,돼지불백이승우,2554,472,16,21,37,43.2%,13m
7625,1,[반란]스투송이,2554,471,13,10,23,56.5%,13m
7625,3,현민이고추,2554,293,11,8,19,57.9%,17m
7625,1,꼬봉마왕,2554,148,5,1,6,83.3%,12m
7625,3,drug,2554,140,4,8,12,33.3%,13m
7625,1,토스가최고,2554,70,3,6,9,33.3%,12m
7625,1,Lecon,2554,0,1,0,1,100.0%,38m
7625,1,garyliu,2554,0,0,2,2,0.0%,12m
7634,3,마왕,2553,1289,132,126,258,51.2%,13m
7634,3,[Dark]無敵小鐵,2553,745,30,35,65,46.2%,45m
7634,3,에스웍스에이토스,2553,396,21,15,36,58.3%,13m
7634,1,[신뢰]오리형아거,2553,330,9,14,23,39.1%,13m
7634,1,IrRa,2553,235,7,7,14,50.0%,11m
7634,1,송병구,2553,255,6,4,10,60.0%,38m
7634,1,Deneb,2553,0,3,2,5,60.0%,38m
7634,2,레이너특공대,2553,0,1,3,4,25.0%,14m
7634,1,대한민국,2553,0,0,2,2,0.0%,12m
7643,3,宇宙無敵好爸,2552,1508,283,279,562,50.4%,45m
7643,3,로보트마징가,2552,998,123,113,236,52.1%,13m
7643,1,熙喜嬉姬,2552,782,28,17,45,62.2%,12m
7643,1,[암기]프로토스장인,2552,317,13,10,23,56.5%,12m
7643,1,BloodyPoopie,2552,48,1,3,4,25.0%,12m
7648,3,ILIKE,2551,631,25,30,55,45.5%,13m
7648,1,misterbasic,2551,520,21,17,38,55.3%,12m
7648,3,intro,2551,534,18,27,45,40.0%,13m
7648,1,니가뭔데,2551,370,10,11,21,47.6%,11m
7648,3,wolfrahm,2551,241,8,10,18,44.4%,18m
7648,1,xswedasd,2551,0,2,4,6,33.3%,38m
7654,1,남군아,2550,600,20,20,40,50.0%,11m
7654,3,BiSu,2550,223,11,15,26,42.3%,45m
7654,1,[귀요미햄스터]lIlIllIIllII,2550,294,8,7,15,53.3%,12m
7654,1,terminate,2550,40,2,2,4,50.0%,38m
7654,1,[블자노예]젋그씨,2550,0,0,1,1,0.0%,39m
7659,1,che,2549,1761,83,86,169,49.1%,11m
7659,1,강뱅구,2549,213,8,18,26,30.8%,11m
7659,1,저그유저,2549,44,3,4,7,42.9%,38m
7659,1,chumdan,2549,0,2,5,7,28.6%,16m
7659,1,유사알파카,2549,97,1,3,4,25.0%,11m
7659,1,김욱따까리,2549,0,0,1,1,0.0%,13m
7665,1,[해양경비대]아르타니스,2548,386,14,6,20,70.0%,12m
7665,2,[서울교대]초등사회과교육과,2548,238,9,13,22,40.9%,19m
7665,1,전쟁광,2548,198,5,1,6,83.3%,13m
7665,1,ajb,2548,0,2,3,5,40.0%,15m
7665,1,Burrito,2548,0,2,3,5,40.0%,38m
7665,1,[겨울방어]jey,2548,0,1,0,1,100.0%,38m
7665,1,[녹즙의남자들]전쟁강림,2548,0,1,0,1,100.0%,16m
7665,1,[HAKSAL]주연,2548,0,0,1,1,0.0%,12m
7665,3,Dragon,2548,0,0,4,4,0.0%,33m
7674,1,바다노을,2547,1797,171,175,346,49.4%,11m
7674,1,daskf,2547,984,57,52,109,52.3%,12m
7674,1,척추사단접기,2547,440,12,15,27,44.4%,12m
7674,1,KillerAnn,2547,289,11,3,14,78.6%,12m
7674,1,lIlIIlllIlll,2547,296,11,12,23,47.8%,39m
7674,1,SlayersBoxer,2547,156,5,8,13,38.5%,11m
7674,1,HeavenDurant,2547,76,2,8,10,20.0%,12m
7674,1,카나리,2547,0,0,1,1,0.0%,38m
7682,3,www,2546,1511,170,167,337,50.4%,45m
7682,1,[南無阿彌陀佛]龜巖許浚,2546,424,16,10,26,61.5%,13m
7682,1,라이엇병신,2546,0,1,0,1,100.0%,15m
7682,2,[싯가의유산]BlueDevil,2546,46,1,1,2,50.0%,14m
7686,1,XenasLee,2545,187,9,8,17,52.9%,38m
7686,3,포토러쉬갑니다,2545,178,6,16,22,27.3%,45m
7688,1,Idaho,2544,805,40,29,69,58.0%,12m
7688,1,푸딩이,2544,473,13,12,25,52.0%,12m
7688,1,NyangHyun,2544,114,3,7,10,30.0%,12m
7688,1,Cuvelia,2544,96,2,4,6,33.3%,38m
7692,1,Leviathan,2543,1535,59,47,106,55.7%,11m
7692,3,[잉융치킹]SongPlay,2543,248,9,10,19,47.4%,17m
7692,2,lllll,2543,180,4,6,10,40.0%,19m
7692,1,海龍王,2543,44,1,5,6,16.7%,11m
7696,1,이브,2542,910,52,47,99,52.5%,13m
7696,2,항작사,2542,269,9,12,21,42.9%,19m
7696,1,TERRY,2542,248,8,3,11,72.7%,11m
7696,1,암욜빠덜,2542,270,8,9,17,47.1%,12m
7696,1,가구긱,2542,166,5,6,11,45.5%,39m
7696,1,DeLivershot,2542,0,2,3,5,40.0%,38m
7696,1,그린필,2542,0,1,3,4,25.0%,12m
7696,1,전설이되다,2542,0,0,3,3,0.0%,11m
7704,3,강서독고다이,2541,1457,236,250,486,48.6%,39m
7704,1,Tomahwk,2541,45,2,2,4,50.0%,15m
7704,2,스토믹,2541,132,2,7,9,22.2%,20m
7704,1,검은안개,2541,0,0,2,2,0.0%,11m
7708,1,GoodDay,2540,1771,161,166,327,49.2%,12m
7708,1,MeteorBlue,2540,1251,61,62,123,49.6%,12m
7708,1,네싱워리,2540,1333,53,40,93,57.0%,11m
7708,3,iSPADE,2540,470,17,20,37,45.9%,45m
7708,1,[國本]BlueTa,2540,398,10,8,18,55.6%,12m
7708,1,스타크래픜트,2540,368,9,8,17,52.9%,11m
7708,1,sunmoon,2540,169,4,5,9,44.4%,15m
7715,1,IlllIIIllIlI,2539,1461,54,49,103,52.4%,13m
7715,1,IIIIIlllIIIl,2539,435,15,17,32,46.9%,11m
7715,1,llllllllllll,2539,64,2,2,4,50.0%,12m
7715,2,fitzhugh,2539,0,0,3,3,0.0%,10m
7719,1,Raiderz,2538,595,55,42,97,56.7%,12m
7719,1,이노오,2538,526,14,16,30,46.7%,39m
7719,1,Toshi,2538,186,6,4,10,60.0%,12m
7719,1,bacura,2538,279,6,6,12,50.0%,12m
7719,1,사라케리건,2538,0,2,3,5,40.0%,38m
7724,1,architectPNU,2537,548,20,24,44,45.5%,11m
7724,1,AsranJARA,2537,576,18,15,33,54.5%,38m
7724,1,[sc2mc]Destiny,2537,386,17,5,22,77.3%,38m
7724,1,Bojangles,2537,266,10,9,19,52.6%,38m
7724,2,roshaTlwpsk,2537,143,7,8,15,46.7%,44m
7724,1,도지마의용,2537,204,6,3,9,66.7%,38m
7724,1,호구호구,2537,123,3,9,12,25.0%,11m
7724,1,KDBwo,2537,0,1,0,1,100.0%,16m
7724,2,잇힝,2537,0,1,0,1,100.0%,15m
7724,1,LucieperY,2537,0,0,1,1,0.0%,16m
7734,1,月夜楓橋,2536,1721,101,96,197,51.3%,39m
7734,1,훈윤,2536,840,34,32,66,51.5%,12m
7734,2,불도저,2536,211,7,12,19,36.8%,20m
7734,1,박성오,2536,124,2,1,3,66.7%,11m
7734,1,MrNeverDie,2536,97,2,5,7,28.6%,16m
7739,1,MeatJP,2535,1532,219,233,452,48.5%,12m
7739,1,[홍콩행제리바]으어어어어어엉,2535,524,17,10,27,63.0%,38m
7739,1,야만용사,2535,90,3,3,6,50.0%,12m
7739,1,홍쟁잉,2535,84,2,2,4,50.0%,11m
7739,1,yolo,2535,0,1,1,2,50.0%,39m
7739,1,aksska,2535,0,1,1,2,50.0%,12m
7739,1,IIIIIIIIIIII,2535,0,0,1,1,0.0%,13m
7739,1,동구밖과수원샷,2535,0,0,2,2,0.0%,12m
7747,1,doctypeDT,2534,355,8,9,17,47.1%,39m
7747,1,IanOuO,2534,254,7,9,16,43.8%,38m
7747,2,silver,2534,0,1,1,2,50.0%,14m
7747,1,[상헌과아이들]폭풍프로토스,2534,0,1,4,5,20.0%,39m
7751,1,너를훔칠래,2533,1781,74,73,147,50.3%,38m
7751,1,IlIlIlIlIlIl,2533,284,7,5,12,58.3%,12m
7751,1,합성함수,2533,40,1,2,3,33.3%,12m
7751,1,꿀이라구,2533,0,1,5,6,16.7%,39m
7755,3,MiniTitan,2532,141,9,10,19,47.4%,17m
7755,3,[개굴맨]PIROTZORO,2532,122,6,9,15,40.0%,39m
7755,1,StevenPark,2532,147,5,5,10,50.0%,38m
7755,1,Snow,2532,97,4,3,7,57.1%,16m
7755,1,Stukovspinoy,2532,40,2,1,3,66.7%,12m
7755,2,ball,2532,0,2,3,5,40.0%,14m
7755,1,yyfyyf,2532,0,2,3,5,40.0%,38m
7755,1,키오니로,2532,46,1,1,2,50.0%,38m
7763,3,KimSHomme,2531,792,28,38,66,42.4%,13m
7763,1,동바리,2531,317,9,6,15,60.0%,13m
7763,1,산성빗방울,2531,123,4,5,9,44.4%,39m
7763,1,[즐겜러]Gert,2531,44,2,0,2,100.0%,38m
7763,1,Scenter,2531,0,1,0,1,100.0%,12m
7763,1,Jimmy,2531,38,1,1,2,50.0%,11m
7763,1,[WILL]피난안내도,2531,0,0,4,4,0.0%,11m
7770,1,킹왕질럿,2530,1579,86,86,172,50.0%,38m
7770,1,lol,2530,143,4,5,9,44.4%,16m
7770,2,bahamoot,2530,0,2,4,6,33.3%,14m
7770,1,GOOD,2530,0,0,1,1,0.0%,16m
7774,3,Dreamstar,2529,634,24,27,51,47.1%,39m
7774,1,신경철,2529,518,19,12,31,61.3%,38m
7774,1,SNOW,2529,467,13,11,24,54.2%,13m
7774,3,york,2529,220,8,9,17,47.1%,17m
7774,2,Vision,2529,88,5,7,12,41.7%,40m
7774,1,lllIIIllIl,2529,110,4,5,9,44.4%,11m
7774,1,leebohyeon,2529,84,3,4,7,42.9%,11m
7774,1,[Jamja]은빛매,2529,133,3,4,7,42.9%,39m
7774,1,Ryze,2529,0,3,5,8,37.5%,16m
7774,2,김현진,2529,88,2,1,3,66.7%,19m
7774,1,osjj,2529,0,1,0,1,100.0%,11m
7774,2,[Mist]비제이사냥꾼,2529,0,0,1,1,0.0%,19m
7786,1,[누후훗]이승,2528,30,2,1,3,66.7%,39m
7786,1,SiaoChou,2528,0,1,1,2,50.0%,12m
7786,1,[art123]紅茶,2528,0,0,1,1,0.0%,11m
7786,1,Dante,2528,0,0,4,4,0.0%,11m
7790,1,[NGameS]게닛츠,2527,1098,44,45,89,49.4%,39m
7790,1,pooh,2527,316,8,10,18,44.4%,12m
7790,1,raihalo,2527,144,4,5,9,44.4%,16m
7793,1,상블,2526,1213,46,38,84,54.8%,38m
7793,1,Bowler,2526,577,41,31,72,56.9%,12m
7793,1,MacLord,2526,906,27,32,59,45.8%,11m
7793,1,Computer,2526,137,4,4,8,50.0%,39m
7793,1,deinhard,2526,44,1,1,2,50.0%,20m
7793,1,BIGCHEeZY,2526,0,0,1,1,0.0%,15m
7799,1,mir,2525,552,42,32,74,56.8%,12m
7799,2,코로나종식기원,2525,790,27,42,69,39.1%,40m
7799,3,smalllake,2525,244,6,15,21,28.6%,45m
7799,1,뿡뿡이,2525,76,5,4,9,55.6%,39m
7799,1,[쫄깃함]엔돌핀,2525,0,3,0,3,100.0%,39m
7799,1,[NICC]음므파탈,2525,78,3,1,4,75.0%,13m
7799,1,니암미,2525,133,3,1,4,75.0%,12m
7799,2,옭로토숙,2525,48,3,3,6,50.0%,15m
7799,2,EZPZ,2525,0,2,3,5,40.0%,14m
7799,2,파란템플러,2525,107,2,4,6,33.3%,19m
7809,1,AUDISTDI,2524,691,26,19,45,57.8%,38m
7809,1,rareavis,2524,666,26,20,46,56.5%,39m
7809,1,today,2524,554,15,21,36,41.7%,38m
7809,1,SprSprdrEvnt,2524,190,7,8,15,46.7%,16m
7809,1,abcde,2524,196,4,8,12,33.3%,16m
7809,2,lllllllll,2524,0,1,0,1,100.0%,14m
7809,1,阿霞在天上飛,2524,0,1,1,2,50.0%,12m
7809,2,연천군흑염룡,2524,0,1,1,2,50.0%,19m
7809,1,MBFSK,2524,0,0,2,2,0.0%,39m
7818,1,난나니,2523,658,23,21,44,52.3%,12m
7818,1,wad,2523,0,2,4,6,33.3%,15m
7818,1,[불멸자]케빈브라운,2523,76,2,6,8,25.0%,12m
7818,1,Red,2523,0,0,1,1,0.0%,11m
7822,1,냉면전사,2522,266,7,11,18,38.9%,38m
7822,1,James,2522,48,5,4,9,55.6%,15m
7822,1,[날빌의달인]레드망고,2522,0,2,3,5,40.0%,39m
7822,1,학교,2522,38,1,4,5,20.0%,11m
7822,1,우주함선,2522,0,1,4,5,20.0%,12m
7822,1,[아케이드러너]잘못함,2522,0,0,1,1,0.0%,38m
7828,1,artipact,2521,187,6,2,8,75.0%,12m
7828,1,뭔코카여펩시지,2521,104,4,8,12,33.3%,12m
7828,1,Woo,2521,48,3,7,10,30.0%,15m
7828,2,강철까마귀,2521,32,2,4,6,33.3%,11m
7828,2,Enkidu,2521,145,2,6,8,25.0%,14m
7833,1,코로사박,2520,856,36,35,71,50.7%,11m
7833,1,운명이다,2520,136,4,0,4,100.0%,11m
7833,2,SUNSHINE,2520,0,3,2,5,60.0%,14m
7833,1,엽기틱한그녀,2520,122,3,7,10,30.0%,11m
7833,3,中二魯肉,2520,0,1,0,1,100.0%,17m
7833,2,lemon,2520,0,1,2,3,33.3%,14m
7833,2,밥많이먹는놈,2520,0,0,2,2,0.0%,14m
7840,3,[갓거킹]김흥국의왕십리턴,2519,899,79,91,170,46.5%,45m
7840,1,[에르디아]아자,2519,1154,38,37,75,50.7%,11m
7840,1,비행소년,2519,423,12,13,25,48.0%,12m
7840,2,굼피,2519,162,4,3,7,57.1%,10m
7840,1,PPGYMPP,2519,66,3,2,5,60.0%,12m
7840,2,[HTP]小帥哥,2519,0,3,2,5,60.0%,14m
7840,2,씌바견,2519,0,2,3,5,40.0%,14m
7840,1,Flash,2519,0,2,5,7,28.6%,16m
7840,1,[SCTW]ZEROS,2519,0,1,0,1,100.0%,39m
7840,1,rara,2519,46,1,6,7,14.3%,39m
7850,3,woofydawgx,2518,510,26,31,57,45.6%,45m
7850,1,만능크리너,2518,155,4,6,10,40.0%,12m
7850,1,IOS,2518,0,1,1,2,50.0%,12m
7853,1,wjdtjsals,2517,1481,123,129,252,48.8%,41m
7853,1,CuNexT,2517,1041,38,39,77,49.4%,11m
7853,1,夜風晚晚吹,2517,38,2,1,3,66.7%,12m
7853,1,llllllllllll,2517,0,0,1,1,0.0%,12m
7857,1,Armas,2516,1016,79,84,163,48.5%,12m
7857,3,煞天飛魚,2516,822,38,40,78,48.7%,39m
7857,1,silent,2516,156,4,5,9,44.4%,39m
7857,2,하얀공포,2516,141,4,8,12,33.3%,44m
7857,1,달빛사냥꾼,2516,36,3,3,6,50.0%,38m
7857,1,wasd,2516,84,2,4,6,33.3%,38m
7857,3,푸른숲,2516,122,2,7,9,22.2%,17m
7857,1,마린보이,2516,0,0,1,1,0.0%,11m
7865,1,方方土雨木木,2515,1273,61,60,121,50.4%,38m
7865,1,jacky,2515,712,29,29,58,50.0%,38m
7865,1,뒤로하는감동,2515,314,16,9,25,64.0%,11m
7865,1,미성년자,2515,47,1,2,3,33.3%,15m
7865,1,icehockey,2515,0,0,1,1,0.0%,39m
7865,2,DZR,2515,0,0,1,1,0.0%,14m
7865,1,egale,2515,0,0,2,2,0.0%,11m
7872,1,max,2514,1109,82,78,160,51.2%,12m
7872,1,Ragnarok,2514,714,20,27,47,42.6%,12m
7872,1,Shiro,2514,443,18,14,32,56.2%,12m
7872,1,게임을못하는사람,2514,314,10,12,22,45.5%,38m
7872,1,星爆氣流之秋,2514,296,8,6,14,57.1%,12m
7872,1,하이에나,2514,240,7,4,11,63.6%,12m
7872,1,[VlTK]STAR,2514,30,4,3,7,57.1%,12m
7872,3,다오,2514,121,3,1,4,75.0%,17m
7872,1,대댕큐,2514,70,3,3,6,50.0%,12m
7872,1,건설벌레준비완료,2514,99,2,2,4,50.0%,11m
7872,1,dexter,2514,46,2,4,6,33.3%,12m
7872,1,[건국]홍님벌쳐,2514,91,1,1,2,50.0%,39m
7884,1,JINOILCIRCLE,2513,1770,158,206,364,43.4%,38m
7884,1,하루타,2513,1245,41,44,85,48.2%,11m
7884,1,water,2513,276,7,12,19,36.8%,12m
7884,1,Novikov,2513,0,2,3,5,40.0%,38m
7884,2,아라한,2513,0,0,1,1,0.0%,14m
7889,1,GOLD,2512,1002,32,34,66,48.5%,12m
7889,1,abussuhail,2512,133,3,4,7,42.9%,20m
7889,1,錢渡有緣人,2512,0,1,2,3,33.3%,12m
7889,1,[rada]Sharky,2512,0,0,1,1,0.0%,16m
7893,3,sdteran,2511,1447,124,119,243,51.0%,39m
7893,1,Churbabel,2511,827,32,33,65,49.2%,13m
7893,1,gdx,2511,364,12,14,26,46.2%,12m
7893,2,[我说的算]Hamsterdam,2511,0,2,3,5,40.0%,14m
7893,1,[TST]뺑덕아범,2511,0,1,0,1,100.0%,16m
7893,1,바으루보이루,2511,0,1,0,1,100.0%,12m
7899,1,IIIIIIIIIIII,2510,80,5,4,9,55.6%,12m
7899,1,Doctoss,2510,90,2,6,8,25.0%,12m
7899,3,lllllllllll,2510,30,1,7,8,12.5%,18m
7902,3,JJang,2509,1490,108,107,215,50.2%,39m
7902,1,난봉꾼,2509,1723,80,78,158,50.6%,12m
7902,1,anednf,2509,654,18,22,40,45.0%,20m
7902,1,문주냉,2509,138,6,7,13,46.2%,38m
7902,1,傳奇,2509,0,0,1,1,0.0%,12m
7907,1,여진철,2508,1303,47,49,96,49.0%,12m
7907,1,맥스,2508,204,6,5,11,54.5%,11m
7907,1,mylifeforier,2508,97,3,5,8,37.5%,16m
7907,2,kim,2508,0,2,3,5,40.0%,14m
7911,1,lililililili,2507,468,16,14,30,53.3%,12m
7911,1,PMA,2507,235,9,9,18,50.0%,12m
7911,1,피파개망겜,2507,282,7,12,19,36.8%,12m
7911,1,kwon,2507,174,4,8,12,33.3%,38m
7915,1,沈家家,2506,1255,114,123,237,48.1%,42m
7915,3,LOVEEJEN,2506,1003,38,45,83,45.8%,39m
7915,1,nishirou,2506,352,10,12,22,45.5%,12m
7915,1,치킨,2506,270,8,9,17,47.1%,12m
7915,1,JunYiXu,2506,133,4,1,5,80.0%,38m
7915,1,테크노마린,2506,88,3,2,5,60.0%,12m
7915,1,shinykknight,2506,97,3,3,6,50.0%,16m
7915,2,llllllllllll,2506,0,2,3,5,40.0%,15m
7915,1,feng,2506,0,1,4,5,20.0%,12m
7915,1,KLARHET,2506,0,0,2,2,0.0%,39m
7925,1,MasterChief,2505,375,10,25,35,28.6%,11m
7925,1,divatemi,2505,206,5,10,15,33.3%,11m
7925,1,[資訊管理科]死亡之音,2505,0,0,1,1,0.0%,39m
7928,1,beulking,2504,447,31,30,61,50.8%,12m
7928,1,DmS,2504,96,4,7,11,36.4%,16m
7928,1,[enl]데오민,2504,0,1,0,1,100.0%,12m
7928,1,gtaroyal,2504,0,1,1,2,50.0%,39m
7928,1,vidar,2504,0,0,2,2,0.0%,12m
7933,1,DameTIme,2503,580,19,23,42,45.2%,20m
7933,1,Saul,2503,516,18,19,37,48.6%,11m
7933,1,권태형,2503,42,5,3,8,62.5%,39m
7933,1,Holysmokes,2503,0,4,2,6,66.7%,12m
7933,1,diaushd,2503,121,4,3,7,57.1%,16m
7933,1,어드레스,2503,0,2,3,5,40.0%,12m
7933,1,나바로,2503,40,2,4,6,33.3%,20m
7933,1,[라이머니]젊음을마셔요,2503,89,1,1,2,50.0%,39m
7933,1,공포의깻잎머리,2503,0,1,4,5,20.0%,38m
7933,1,pfw,2503,0,0,1,1,0.0%,12m
7943,1,BantaiSemua,2502,1052,42,35,77,54.5%,39m
7943,1,루디,2502,931,39,44,83,47.0%,12m
7943,1,이인자,2502,193,4,5,9,44.4%,16m
7943,1,레온,2502,0,1,2,3,33.3%,38m
7943,1,roy,2502,46,1,3,4,25.0%,11m
7943,1,[StarL]ImstupiT,2502,0,0,2,2,0.0%,12m
7949,1,myhun,2501,221,9,7,16,56.2%,12m
7949,1,하니,2501,92,2,0,2,100.0%,39m
7951,1,jackliao,2500,847,26,28,54,48.1%,11m
7951,3,garp,2500,195,7,10,17,41.2%,16m
7951,1,[sc2mc]LilHomies,2500,127,3,3,6,50.0%,38m
7951,1,[WTSC]건치미소,2500,100,3,5,8,37.5%,12m
7951,1,[달맞이꽃]lunaflower,2500,116,2,3,5,40.0%,38m
7956,1,subal,2499,265,9,8,17,52.9%,38m
7956,1,AdoNis,2499,193,5,7,12,41.7%,16m
7956,1,Golf,2499,42,2,1,3,66.7%,13m
7956,1,REALIZE,2499,0,1,0,1,100.0%,39m
7956,1,gkfl,2499,97,1,2,3,33.3%,20m
7956,1,굿럭,2499,0,0,1,1,0.0%,16m
7962,3,[지나간하루]지나간루,2498,797,52,46,98,53.1%,13m
7962,1,MarineBoy,2498,1020,36,32,68,52.9%,11m
7962,1,海豚,2498,525,33,23,56,58.9%,12m
7962,1,kaniji,2498,275,11,10,21,52.4%,12m
7962,1,[卍鷹之團卍]天雷,2498,300,9,9,18,50.0%,11m
7962,1,Kamatayan,2498,108,2,1,3,66.7%,13m
7962,1,SpecEdu,2498,0,1,0,1,100.0%,39m
7962,1,[NGTV]CrissAngel,2498,0,1,4,5,20.0%,38m
7970,1,llllllllllll,2497,885,40,17,57,70.2%,38m
7970,1,루크짱,2497,478,22,27,49,44.9%,12m
7970,1,[도킹도킹]Probe,2497,404,16,17,33,48.5%,39m
7970,1,CSchmoov,2497,169,5,3,8,62.5%,12m
7970,1,cheer,2497,169,5,6,11,45.5%,20m
7970,1,increase,2497,97,3,6,9,33.3%,15m
7970,1,김치제국,2497,94,2,5,7,28.6%,39m
7970,1,iiiiiiiiiiii,2497,0,1,1,2,50.0%,11m
7970,2,llllllllllll,2497,0,0,5,5,0.0%,15m
7979,1,darq,2496,1604,70,64,134,52.2%,39m
7979,1,BloodMarin,2496,269,9,7,16,56.2%,12m
7979,2,丸昊昊,2496,94,4,5,9,44.4%,15m
7979,1,Top,2496,114,3,5,8,37.5%,12m
7979,2,인간,2496,0,1,2,3,33.3%,14m
7979,1,추디,2496,36,1,7,8,12.5%,12m
7985,1,표야,2495,633,22,18,40,55.0%,11m
7985,1,judicaes,2495,166,6,7,13,46.2%,39m
7985,1,parkmos,2495,82,2,5,7,28.6%,12m
7985,1,JungGame,2495,0,1,4,5,20.0%,39m
7989,1,llllllllllll,2494,534,18,21,39,46.2%,38m
7989,1,ndddiiie,2494,526,16,15,31,51.6%,12m
7989,1,[國本]llllllllllll,2494,231,9,12,21,42.9%,39m
7989,1,시발롬,2494,187,5,7,12,41.7%,16m
7989,1,Astrum,2494,116,2,2,4,50.0%,11m
7989,1,[모징]해천솔,2494,0,1,2,3,33.3%,13m
7995,1,CodeREQ,2493,303,12,9,21,57.1%,11m
7995,2,찐투갓,2493,0,2,3,5,40.0%,14m
7995,1,IIIIIIIIIIII,2493,32,1,2,3,33.3%,39m
7995,2,LoSicA,2493,0,0,1,1,0.0%,38m
7999,2,TheLingKing,2492,48,2,4,6,33.3%,14m
7999,3,PASCAL,2492,0,0,1,1,0.0%,17m
7999,2,阿猩,2492,0,0,1,1,0.0%,19m
8002,1,WhixeBear,2491,309,9,15,24,37.5%,12m
8002,1,[광막고]땡칠이의모험,2491,318,8,12,20,40.0%,12m
8002,1,테라몽,2491,159,5,8,13,38.5%,38m
8002,1,LOLPEPPLE,2491,0,2,5,7,28.6%,16m
8006,2,오돌이,2490,639,60,64,124,48.4%,44m
8006,1,[Rebel]매직코스,2490,920,33,30,63,52.4%,11m
8006,1,Nothing,2490,566,19,21,40,47.5%,12m
8006,1,llllllllllll,2490,309,11,8,19,57.9%,38m
8006,1,불타석상,2490,201,6,4,10,60.0%,11m
8006,1,FoFiFu,2490,0,1,4,5,20.0%,12m
8006,1,JAJI,2490,0,0,2,2,0.0%,12m
8013,1,Yuzhe,2489,432,13,11,24,54.2%,12m
8013,2,llllllllllll,2489,172,11,0,11,100.0%,38m
8013,1,Marchmallow,2489,217,6,8,14,42.9%,16m
8013,1,유령,2489,0,3,6,9,33.3%,15m
8013,1,LuxuryKaios,2489,0,2,4,6,33.3%,15m
8013,1,TwoKang,2489,0,2,5,7,28.6%,16m
8019,1,한콩고,2488,881,29,29,58,50.0%,12m
8019,2,[순경3년차]중앙경찰학교,2488,243,11,5,16,68.8%,19m
8019,1,VVV,2488,172,4,8,12,33.3%,39m
8019,2,[SC2HK]LaPuta,2488,0,3,3,6,50.0%,14m
8019,2,위드,2488,0,1,0,1,100.0%,38m
8019,2,민군이,2488,0,0,1,1,0.0%,19m
8019,2,bitant,2488,0,0,1,1,0.0%,19m
8026,3,쁘라빠빰,2487,566,23,26,49,46.9%,39m
8026,2,為何不懂,2487,458,17,16,33,51.5%,19m
8026,1,하인츠구데리안,2487,73,1,3,4,25.0%,12m
8026,2,shwnsgur,2487,0,1,4,5,20.0%,38m
8030,1,cloudapple,2486,188,5,3,8,62.5%,39m
8030,1,KHBIB,2486,78,2,4,6,33.3%,39m
8030,1,black,2486,0,1,1,2,50.0%,39m
8030,2,太陽之子,2486,0,0,1,1,0.0%,19m
8034,1,Crunky,2485,312,9,14,23,39.1%,12m
8034,1,[322235]찰스,2485,164,4,2,6,66.7%,16m
8034,2,Typhlosis,2485,0,2,3,5,40.0%,15m
8034,2,[달빛암흑기사]DzDzDzDzDzDz,2485,30,1,2,3,33.3%,38m
8034,1,전종빈,2485,97,1,4,5,20.0%,38m
8034,2,마재윤,2485,0,0,1,1,0.0%,19m
8034,2,점멸추적자,2485,0,0,1,1,0.0%,38m
8034,1,민주야,2485,0,0,2,2,0.0%,11m
8042,3,개똘애이,2484,379,26,30,56,46.4%,45m
8042,2,SuperHoo,2484,157,4,4,8,50.0%,14m
8042,1,[PGWE]격조,2484,0,2,4,6,33.3%,39m
8042,2,[FBA]이소시아네이트,2484,0,1,0,1,100.0%,11m
8042,1,벌레새키,2484,40,1,4,5,20.0%,39m
8047,3,라온,2483,491,17,25,42,40.5%,13m
8047,1,톡톡이,2483,138,4,6,10,40.0%,12m
8047,2,연근우엉차,2483,0,0,2,2,0.0%,15m
8050,2,마카롱육덕진덩,2482,1131,157,166,323,48.6%,18m
8050,2,beteljuce,2482,774,33,26,59,55.9%,38m
8050,1,Everton,2482,738,24,22,46,52.2%,11m
8050,1,탈주닌자,2482,734,22,24,46,47.8%,12m
8050,1,빛나는헤드,2482,97,1,1,2,50.0%,16m
8050,1,GreatFlag,2482,0,1,4,5,20.0%,39m
8050,1,Onlick,2482,0,0,2,2,0.0%,12m
8057,3,모선,2481,284,9,8,17,52.9%,17m
8057,3,bert,2481,289,9,11,20,45.0%,17m
8057,1,백호선,2481,324,8,9,17,47.1%,11m
8057,2,IlIllIIIllIl,2481,130,5,3,8,62.5%,11m
8057,1,大饅頭,2481,0,1,1,2,50.0%,15m
8057,1,KaRma,2481,30,1,5,6,16.7%,12m
8063,1,퍼스트게임,2480,633,26,22,48,54.2%,38m
8063,3,IAEA,2480,246,26,28,54,48.1%,45m
8063,1,생각중,2480,0,0,2,2,0.0%,11m
8066,1,MOVA,2479,762,26,25,51,51.0%,39m
8066,1,Brotherhood,2479,228,8,11,19,42.1%,39m
8066,2,[낭만고양이]낭만호랑이,2479,148,4,6,10,40.0%,19m
8066,1,kingdie,2479,94,1,2,3,33.3%,12m
8070,1,푸치니,2478,986,33,35,68,48.5%,39m
8070,1,DefinitioN,2478,763,28,20,48,58.3%,12m
8070,2,MDR,2478,152,7,5,12,58.3%,38m
8070,3,sasaikudasai,2478,0,2,5,7,28.6%,39m
8074,1,김옥지,2477,118,4,6,10,40.0%,11m
8074,3,단종,2477,97,4,9,13,30.8%,45m
8074,2,fatcat,2477,0,1,0,1,100.0%,19m
8074,1,天痕,2477,38,1,3,4,25.0%,12m
8074,1,[즐겜러]호크아이,2477,73,0,8,8,0.0%,39m
8079,1,캡틴썬희,2476,1530,92,80,172,53.5%,12m
8079,1,danny,2476,950,31,30,61,50.8%,11m
8079,1,lIlllIlllIIl,2476,160,10,5,15,66.7%,13m
8079,1,[DeFT5]Freddy,2476,355,9,9,18,50.0%,12m
8079,1,VonHelman,2476,296,8,9,17,47.1%,12m
8079,1,KFC,2476,191,5,3,8,62.5%,12m
8079,1,Peanut,2476,144,3,7,10,30.0%,16m
8079,2,empty,2476,0,0,1,1,0.0%,38m
8087,3,kasho,2475,369,13,15,28,46.4%,13m
8087,2,joe,2475,184,9,4,13,69.2%,11m
8087,2,BMW,2475,80,3,2,5,60.0%,15m
8087,1,구백이,2475,136,3,2,5,60.0%,12m
8087,2,[易亨集团]邵东寅,2475,0,1,3,4,25.0%,14m
8092,1,everywheretj,2474,160,5,11,16,31.2%,11m
8092,1,Mist,2474,208,4,5,9,44.4%,39m
8092,2,미키로얄,2474,60,3,1,4,75.0%,19m
8092,2,KFC,2474,30,2,0,2,100.0%,19m
8092,1,Rayking,2474,0,2,4,6,33.3%,39m
8092,1,Heart,2474,0,1,1,2,50.0%,16m
8092,1,테란잦고수,2474,36,1,6,7,14.3%,39m
8099,1,문라이트샤도우,2473,862,30,26,56,53.6%,12m
8099,1,갓문과,2473,471,24,28,52,46.2%,11m
8099,3,좋은단백질원,2473,271,9,10,19,47.4%,17m
8099,2,rAyWinDz,2473,0,1,5,6,16.7%,15m
8099,1,쏘렌토,2473,46,1,10,11,9.1%,39m
8099,2,lllllllllll,2473,0,0,2,2,0.0%,19m
8105,3,wobinich,2472,0,0,1,1,0.0%,18m
8105,1,[KIKIKI]침대,2472,0,0,2,2,0.0%,16m
8105,1,헌터사냥꾼,2472,0,0,3,3,0.0%,39m
8108,1,Dutchie,2471,360,44,36,80,55.0%,12m
8108,1,IIIIIIIIIIII,2471,565,18,23,41,43.9%,12m
8108,2,YUUSHOUKOUHO,2471,234,11,16,27,40.7%,45m
8108,2,ottertw,2471,138,6,1,7,85.7%,11m
8108,1,肌肉猛男,2471,193,5,7,12,41.7%,12m
8108,1,make,2471,48,4,5,9,44.4%,39m
8108,1,王黑樂園,2471,0,1,1,2,50.0%,39m
8108,2,제라툴,2471,0,0,1,1,0.0%,20m
8116,3,박지수,2470,768,27,35,62,43.5%,13m
8116,1,wuian,2470,120,3,4,7,42.9%,12m
8116,2,날개발바닥,2470,0,1,0,1,100.0%,19m
8119,1,록타르오가르,2469,210,6,7,13,46.2%,39m
8119,1,뽀사리우스,2469,206,5,5,10,50.0%,38m
8119,2,hanjs,2469,0,0,1,1,0.0%,15m
8122,1,막떠깡,2468,814,35,35,70,50.0%,11m
8122,1,챔프,2468,30,1,6,7,14.3%,11m
8124,1,diego,2467,652,23,28,51,45.1%,11m
8124,2,[우주소년]빈이끙아,2467,193,5,3,8,62.5%,18m
8124,3,[무한김준현]yolats,2467,95,5,4,9,55.6%,40m
8124,1,그루트,2467,128,3,9,12,25.0%,13m
8124,2,BeanBoy,2467,32,2,1,3,66.7%,11m
8124,2,[뾳읂쨤뿅]꾴쁇빣뚪,2467,38,2,5,7,28.6%,38m
8124,2,ChoLay,2467,48,1,6,7,14.3%,14m
8124,2,[Blade]검은비늘유삼바니,2467,0,0,1,1,0.0%,38m
8132,1,[NGameS]road,2466,38,2,3,5,40.0%,39m
8133,1,인간,2465,291,18,13,31,58.1%,12m
8133,2,[ECLS]TOP,2465,286,9,4,13,69.2%,38m
8133,2,너죽고나살자,2465,30,4,3,7,57.1%,38m
8133,1,stupid,2465,88,1,3,4,25.0%,12m
8137,2,fffkkk,2464,122,4,1,5,80.0%,19m
8137,2,dsig,2464,30,2,4,6,33.3%,38m
8139,1,zxelpha,2463,896,53,53,106,50.0%,11m
8139,2,UnluckyPig,2463,431,18,18,36,50.0%,11m
8139,2,dsad,2463,243,11,5,16,68.8%,19m
8139,1,Abecen,2463,126,3,9,12,25.0%,11m
8139,2,ARISISON,2463,0,2,3,5,40.0%,38m
8139,1,맘스터치,2463,0,1,1,2,50.0%,39m
8139,2,教我玩神族,2463,0,0,2,2,0.0%,19m
8146,3,朝富,2462,1479,232,243,475,48.8%,45m
8146,3,Optixus,2462,844,49,41,90,54.4%,13m
8146,2,제플린,2462,0,0,1,1,0.0%,19m
8146,1,HACW,2462,0,0,5,5,0.0%,39m
8150,2,세수하면원빈,2461,1176,75,67,142,52.8%,11m
8150,1,TIMRUSH,2461,994,42,39,81,51.9%,12m
8150,2,성마파이,2461,199,6,9,15,40.0%,38m
8150,2,eric,2461,44,2,2,4,50.0%,19m
8150,1,jin,2461,0,1,0,1,100.0%,16m
8155,1,스타,2460,1751,273,295,568,48.1%,12m
8155,3,Emperor,2460,615,67,63,130,51.5%,45m
8155,1,[밥둑밥찰]알파제로,2460,892,41,39,80,51.2%,12m
8155,1,푸른하늘,2460,717,31,28,59,52.5%,12m
8155,2,COCO,2460,488,20,9,29,69.0%,19m
8160,1,larve,2459,526,18,18,36,50.0%,39m
8160,1,위니,2459,329,13,14,27,48.1%,13m
8160,1,스파르타귤스,2459,118,1,4,5,20.0%,12m
8160,2,sangdom,2459,0,0,1,1,0.0%,19m
8164,3,Ponytail,2458,1431,413,432,845,48.9%,45m
8164,1,[AZUSA]안인균,2458,0,1,1,2,50.0%,16m
8164,1,pasha,2458,0,0,3,3,0.0%,38m
8167,1,MoonLight,2457,1640,197,216,413,47.7%,39m
8167,2,five,2457,356,13,17,30,43.3%,20m
8167,3,할배후려치기,2457,342,11,18,29,37.9%,45m
8167,2,[hero79]웃음천국,2457,0,1,0,1,100.0%,20m
8171,2,CEASAR,2456,380,14,6,20,70.0%,19m
8171,1,Mayday,2456,0,2,5,7,28.6%,16m
8173,1,ttasfa,2455,1630,110,110,220,50.0%,12m
8173,3,[붉은군단]짐레이너,2455,764,27,32,59,45.8%,13m
8173,1,Woozie,2455,573,21,23,44,47.7%,38m
8173,3,nobless,2455,222,8,12,20,40.0%,17m
8173,1,[CoRe]JKJKss,2455,88,6,11,17,35.3%,41m
8173,2,Nymco,2455,0,0,1,1,0.0%,38m
8173,1,seonghooN,2455,0,0,4,4,0.0%,20m
8180,3,[NLTN]MRKIMJS,2454,1470,55,67,122,45.1%,45m
8180,2,lelpleb,2454,368,13,4,17,76.5%,20m
8180,1,IIIIII,2454,332,10,14,24,41.7%,39m
8180,1,Marine,2454,334,9,14,23,39.1%,12m
8180,2,sukgun,2454,42,2,0,2,100.0%,15m
8180,1,llllilll,2454,0,1,6,7,14.3%,11m
8186,2,般若智,2453,190,6,9,15,40.0%,18m
8186,1,Strider,2453,46,2,4,6,33.3%,39m
8188,2,kokoko,2452,163,4,3,7,57.1%,19m
8188,1,김재영,2452,92,1,5,6,16.7%,12m
8190,1,IIIIIIIII,2451,754,32,34,66,48.5%,39m
8190,3,롤개같다,2451,261,10,11,21,47.6%,17m
8190,2,orrochemalo,2451,234,9,8,17,52.9%,19m
8190,1,WON,2451,48,2,4,6,33.3%,16m
8190,3,다산다,2451,0,0,2,2,0.0%,17m
8195,2,안녕나는포로리얌,2450,1627,134,144,278,48.2%,11m
8195,1,사사키치에,2450,1594,94,85,179,52.5%,12m
8195,1,아이버슨,2450,1448,65,64,129,50.4%,12m
8195,1,황혼,2450,300,8,12,20,40.0%,12m
8195,1,땡길이자지,2450,97,2,0,2,100.0%,16m
8195,2,스타토스,2450,0,1,0,1,100.0%,20m
8201,2,lIlIlIlIlIlI,2449,429,55,50,105,52.4%,11m
8201,1,ShadowKiller,2449,1294,46,52,98,46.9%,38m
8201,3,기몽식,2449,298,11,16,27,40.7%,45m
8201,2,Frozenfire,2449,260,8,8,16,50.0%,20m
8201,2,스티븐,2449,0,2,3,5,40.0%,15m
8201,2,쌍둥이웅,2449,0,0,3,3,0.0%,19m
8207,3,Cain,2448,263,10,10,20,50.0%,33m
8207,2,suny,2448,64,3,0,3,100.0%,19m
8207,2,sonic,2448,90,3,5,8,37.5%,15m
8207,2,Duncam,2448,0,1,4,5,20.0%,15m
8211,1,슈퍼시진핑핑이,2447,1548,64,68,132,48.5%,39m
8211,1,템페스트,2447,936,32,34,66,48.5%,39m
8211,2,bombom,2447,288,9,10,19,47.4%,38m
8211,2,[김정은SC]KimJongUn,2447,96,3,3,6,50.0%,19m
8215,1,[국방부사서병]SEKI,2446,1237,94,90,184,51.1%,12m
8215,1,모지래라,2446,835,32,29,61,52.5%,38m
8215,1,[겨울방어]Extra,2446,223,7,8,15,46.7%,39m
8215,2,뉴비등장,2446,0,2,2,4,50.0%,14m
8215,2,파자안,2446,36,2,4,6,33.3%,38m
8215,1,星海都被韓國人虐,2446,0,2,4,6,33.3%,39m
8215,2,산적,2446,0,1,0,1,100.0%,19m
8215,1,김대환,2446,0,0,3,3,0.0%,39m
8223,3,bqbq,2445,60,5,7,12,41.7%,39m
8223,2,Rabpit,2445,0,0,1,1,0.0%,38m
8225,1,Aegis,2444,1619,80,91,171,46.8%,39m
8225,2,와잠,2444,215,7,4,11,63.6%,38m
8227,1,Paladin,2443,1448,110,122,232,47.4%,11m
8227,1,MaSaO,2443,1735,76,76,152,50.0%,13m
8227,1,[강북도봉구파]사륜안이보고있다,2443,259,7,9,16,43.8%,15m
8230,2,asesome,2442,1585,91,96,187,48.7%,19m
8230,1,lmsgenius,2442,1705,78,84,162,48.1%,39m
8230,2,Barmian,2442,974,40,30,70,57.1%,19m
8230,2,욕정돼지,2442,763,27,24,51,52.9%,19m
8230,2,KurobaKaito,2442,618,20,19,39,51.3%,19m
8230,1,OeieiO,2442,308,9,13,22,40.9%,12m
8230,3,ysangwoong,2442,30,3,7,10,30.0%,40m
8230,2,아리,2442,0,1,0,1,100.0%,14m
8230,1,아따뚜따이,2442,0,1,1,2,50.0%,39m
8230,1,Hgood,2442,88,1,5,6,16.7%,11m
8240,1,angu,2441,948,35,32,67,52.2%,39m
8240,2,Tea,2441,86,12,10,22,54.5%,19m
8240,1,ggyo,2441,129,4,6,10,40.0%,12m
8240,2,lolseestarll,2441,0,1,0,1,100.0%,11m
8240,2,Rick,2441,0,1,0,1,100.0%,20m
8245,1,polarbear,2440,1385,54,53,107,50.5%,11m
8245,1,Zealkhalec,2440,358,15,15,30,50.0%,39m
8245,2,[APinKK]William,2440,119,3,0,3,100.0%,38m
8245,2,littlefat,2440,0,1,0,1,100.0%,15m
8245,2,Gosuram,2440,0,0,1,1,0.0%,15m
8245,1,friendkiller,2440,0,0,3,3,0.0%,39m
8251,2,Eon,2439,298,8,7,15,53.3%,38m
8251,3,만월,2439,90,5,8,13,38.5%,40m
8251,2,시라소니,2439,60,5,9,14,35.7%,40m
8251,1,一切靠運氣,2439,136,4,5,9,44.4%,12m
8255,2,givmeasec,2438,449,16,16,32,50.0%,19m
8255,2,제조상궁,2438,114,7,6,13,53.8%,38m
8255,2,최대영,2438,0,0,1,1,0.0%,19m
8258,1,wwos,2437,1682,105,114,219,47.9%,12m
8258,1,[벽짓고벽뚫고]사령관,2437,483,14,16,30,46.7%,12m
8258,1,kini,2437,96,3,2,5,60.0%,15m
8258,1,김도라지,2437,142,3,4,7,42.9%,12m
8258,2,jsyjoe,2437,0,1,4,5,20.0%,14m
8258,1,Zebra,2437,0,0,8,8,0.0%,12m
8264,1,[BDS]미선아사랑해이기,2436,330,10,18,28,35.7%,39m
8265,1,[국가정보원]IIIIIIIIII,2435,340,12,11,23,52.2%,12m
8265,2,kookoo,2435,182,6,4,10,60.0%,19m
8267,1,FaRan,2434,0,2,4,6,33.3%,39m
8267,1,명진꽝,2434,0,0,3,3,0.0%,39m
8269,1,멍청도사나이,2433,1161,65,65,130,50.0%,12m
8269,2,루퀜스,2433,1028,38,39,77,49.4%,38m
8269,2,짱구,2433,493,21,18,39,53.8%,19m
8269,2,[ElsAna]SHOWyourself,2433,162,5,2,7,71.4%,19m
8269,2,dupadu,2433,80,2,1,3,66.7%,19m
8274,1,jafkiel,2432,928,56,51,107,52.3%,12m
8274,1,[공허거주]뽀로로,2432,1044,39,39,78,50.0%,13m
8274,1,[isnous]Vincent,2432,574,22,23,45,48.9%,13m
8274,1,특공대출신,2432,208,5,9,14,35.7%,39m
8274,2,내목숨을아이어에,2432,0,0,1,1,0.0%,11m
8279,3,Merik,2431,208,8,13,21,38.1%,18m
8279,1,[NGameS]이리꾹,2431,36,2,4,6,33.3%,12m
8279,2,natreivaj,2431,0,1,4,5,20.0%,38m
8279,2,Zero,2431,0,1,5,6,16.7%,14m
8279,2,[시라이시마이]EXO,2431,0,0,1,1,0.0%,19m
8279,2,JMAV,2431,0,0,1,1,0.0%,11m
8285,2,MeKou,2430,409,16,14,30,53.3%,19m
8285,1,lonelyloner,2430,496,16,24,40,40.0%,12m
8285,2,아르르르르르릌,2430,215,6,9,15,40.0%,38m
8285,1,무뇌봉동무,2430,110,4,8,12,33.3%,39m
8289,2,프랑켄,2429,0,1,0,1,100.0%,38m
8290,2,[Arcade]FirstArcade,2428,692,24,26,50,48.0%,38m
8290,2,HufsKal,2428,588,20,21,41,48.8%,18m
8290,1,Jyng,2428,213,6,9,15,40.0%,39m
8290,2,CRAYT,2428,46,3,5,8,37.5%,14m
8290,2,Devourer,2428,0,2,3,5,40.0%,38m
8290,2,戰神,2428,30,1,1,2,50.0%,11m
8296,3,라까뚜찌,2427,840,32,37,69,46.4%,45m
8296,1,우박,2427,302,11,13,24,45.8%,38m
8296,2,꽁치요거트,2427,266,8,2,10,80.0%,38m
8296,2,[할리가이]hallyguy,2427,46,1,7,8,12.5%,15m
8296,1,[적토마]적토마아,2427,0,0,1,1,0.0%,15m
8301,1,아오지탄광,2426,704,62,67,129,48.1%,11m
8301,2,blancwhite,2426,340,12,10,22,54.5%,19m
8301,3,[Chim]침투맨,2426,294,11,9,20,55.0%,17m
8301,2,러블리미소,2426,136,3,2,5,60.0%,15m
8301,2,케리어,2426,0,1,1,2,50.0%,19m
8306,1,살모사,2425,958,42,49,91,46.2%,20m
8306,2,[NoME]문병신치매,2425,420,15,17,32,46.9%,38m
8306,1,yjkim,2425,394,12,22,34,35.3%,11m
8309,2,AIRMAN,2424,152,6,3,9,66.7%,19m
8309,2,[달빛암흑기사]Andy,2424,30,1,2,3,33.3%,19m
8309,2,TTTTTTTT,2424,0,1,4,5,20.0%,14m
8312,2,KarlmarkXX,2423,1462,54,61,115,47.0%,19m
8312,1,어어어어,2423,971,37,42,79,46.8%,39m
8312,1,ksh,2423,591,24,31,55,43.6%,13m
8312,2,OmegaMan,2423,562,21,18,39,53.8%,11m
8312,1,Hendo,2423,518,20,25,45,44.4%,12m
8317,1,[머구폐렴]uchan,2422,868,32,31,63,50.8%,11m
8317,1,DDTLEE,2422,154,4,6,10,40.0%,13m
8317,1,HSIAO,2422,103,3,6,9,33.3%,39m
8320,1,ALaude,2421,771,33,28,61,54.1%,39m
8320,2,timparker,2421,754,30,28,58,51.7%,11m
8320,1,쌈아치,2421,880,29,30,59,49.2%,39m
8320,1,lIllIllIllIl,2421,517,15,19,34,44.1%,38m
8320,2,[즐겜러]군단의심장,2421,0,3,2,5,60.0%,15m
8320,2,lopper,2421,30,3,3,6,50.0%,38m
8320,2,log,2421,0,1,0,1,100.0%,20m
8320,1,솔낭,2421,73,1,5,6,16.7%,11m
8328,1,log,2420,1052,54,58,112,48.2%,11m
8328,2,택이네,2420,332,10,17,27,37.0%,20m
8328,2,흐르는강,2420,60,2,3,5,40.0%,18m
8328,2,이렇게취할때,2420,113,2,5,7,28.6%,15m
8328,1,Shin,2420,46,1,6,7,14.3%,11m
8328,1,만두찐빵,2420,73,0,4,4,0.0%,12m
8334,2,창천항로,2419,150,6,6,12,50.0%,11m
8334,2,[브리티안]슬기체고임,2419,0,2,3,5,40.0%,15m
8334,2,[anime]SAURON,2419,0,0,1,1,0.0%,19m
8337,1,빠이얌,2418,461,15,27,42,35.7%,12m
8337,2,Purrkins,2418,0,1,0,1,100.0%,20m
8337,2,Djinn,2418,0,1,4,5,20.0%,38m
8337,2,star,2418,0,0,1,1,0.0%,38m
8341,2,dabid,2417,967,44,36,80,55.0%,19m
8341,1,콩푸,2417,1057,37,46,83,44.6%,12m
8341,1,조필준,2417,986,30,40,70,42.9%,11m
8341,1,가을,2417,265,10,8,18,55.6%,17m
8341,2,불법아이디,2417,0,1,0,1,100.0%,38m
8341,2,Dante,2417,30,1,2,3,33.3%,38m
8341,2,[ElsAna]니모야,2417,0,0,2,2,0.0%,15m
8348,3,DJGO,2416,903,33,45,78,42.3%,13m
8348,2,kissme,2416,0,2,3,5,40.0%,38m
8348,1,kimjinyoung,2416,0,1,0,1,100.0%,16m
8351,2,gaia,2415,495,21,18,39,53.8%,19m
8351,3,habitboy,2415,151,7,7,14,50.0%,45m
8351,2,누셀넘버,2415,156,5,9,14,35.7%,19m
8351,2,BRAT,2415,144,3,1,4,75.0%,14m
8351,1,빵콩,2415,40,3,7,10,30.0%,12m
8356,2,안녕,2414,144,4,1,5,80.0%,11m
8356,3,으아아아아아아아,2414,60,3,6,9,33.3%,40m
8356,1,프로토스연합,2414,0,2,6,8,25.0%,15m
8356,1,Lioes,2414,40,1,5,6,16.7%,20m
8356,2,[NPE교]Haksaler,2414,0,0,1,1,0.0%,15m
8361,2,rndtkfk,2413,1615,136,141,277,49.1%,18m
8361,1,Tiger,2413,441,18,13,31,58.1%,11m
8361,1,Infernal,2413,267,7,12,19,36.8%,12m
8361,2,kite,2413,74,3,3,6,50.0%,19m
8361,2,psychologic,2413,58,2,3,5,40.0%,20m
8361,2,imgwho,2413,0,1,0,1,100.0%,19m
8367,1,초보입니다봐주셈,2412,374,11,19,30,36.7%,39m
8367,2,IlIIlllIllIl,2412,128,4,7,11,36.4%,19m
8367,2,MasterReaper,2412,62,2,2,4,50.0%,38m
8370,1,살려줘,2411,507,16,19,35,45.7%,12m
8370,1,[中國病毒]ShowMeBeBe,2411,217,15,14,29,51.7%,12m
8370,2,HAN,2411,70,2,2,4,50.0%,38m
8370,2,입술꽉,2411,0,0,1,1,0.0%,19m
8374,3,星鈤,2410,165,4,1,5,80.0%,17m
8374,1,Clockwork,2410,94,4,6,10,40.0%,16m
8376,1,모오올롸,2409,1272,47,52,99,47.5%,12m
8376,1,토수,2409,1114,37,39,76,48.7%,38m
8376,2,신사답게행동해,2409,136,3,5,8,37.5%,14m
8379,2,hoyapret,2408,664,23,25,48,47.9%,19m
8379,1,커피물조절장인,2408,138,3,2,5,60.0%,16m
8379,2,사이버이완용,2408,0,1,1,2,50.0%,19m
8379,2,MizraH,2408,0,1,4,5,20.0%,15m
8383,2,Pressup,2407,296,20,12,32,62.5%,19m
8383,2,destory,2407,348,13,14,27,48.1%,38m
8383,1,Devilfish,2407,155,5,7,12,41.7%,17m
8383,2,낙그네,2407,134,3,3,6,50.0%,11m
8383,2,콩콩콩만잡는다,2407,30,2,1,3,66.7%,18m
8383,2,[망겜장인]봄날벚꽃,2407,0,1,0,1,100.0%,11m
8389,2,개요르꽁,2406,801,45,35,80,56.2%,19m
8389,1,HAJJ,2406,318,9,17,26,34.6%,39m
8389,1,다이버,2406,142,4,9,13,30.8%,11m
8389,1,눈물이추적추적,2406,120,2,3,5,40.0%,15m
8393,1,haha,2405,674,23,26,49,46.9%,38m
8393,2,thomas,2405,314,10,10,20,50.0%,19m
8395,2,沉默風暴,2404,1539,144,149,293,49.1%,19m
8395,1,망가,2404,1218,39,47,86,45.3%,11m
8395,1,kirop,2404,368,11,10,21,52.4%,39m
8395,2,[소드]스티븐스트,2404,0,0,2,2,0.0%,19m
8399,1,[병신들모임]도우너,2403,1015,147,150,297,49.5%,12m
8399,1,스노우스타일,2403,1695,120,134,254,47.2%,12m
8399,2,bbird,2403,1576,75,92,167,44.9%,38m
8399,1,나는짱,2403,0,2,3,5,40.0%,39m
8399,1,[ABCD狗咬]echan,2403,97,1,4,5,20.0%,39m
8399,2,IllIIIIllll,2403,0,0,1,1,0.0%,20m
8405,2,spirit,2402,1339,52,50,102,51.0%,38m
8405,2,만두장,2402,368,14,16,30,46.7%,20m
8405,2,[광전사하키]모텔앞너네엄마,2402,58,3,0,3,100.0%,11m
8405,2,[볼셰비키]레닌,2402,62,3,1,4,75.0%,19m
8405,1,윤상호,2402,0,2,5,7,28.6%,38m
8405,2,[1승]SERU,2402,30,2,6,8,25.0%,19m
8405,2,Gin,2402,0,0,1,1,0.0%,14m
8412,1,[EZboYz]junmc,2401,942,31,40,71,43.7%,12m
8412,1,데칸테,2401,566,19,22,41,46.3%,39m
8412,2,[레이너공격대]짐되는레이너,2401,231,9,10,19,47.4%,38m
8412,2,[zAWSLz]MOOOI,2401,117,7,5,12,58.3%,19m
8412,1,Demon,2401,48,3,8,11,27.3%,15m
8412,2,포도아빠,2401,0,1,4,5,20.0%,14m
8412,2,플토장인캡틴박,2401,0,0,1,1,0.0%,38m
8412,2,고부추랄,2401,0,0,1,1,0.0%,19m
8420,2,StarChen,2400,412,13,18,31,41.9%,19m
8420,2,rlaxorb,2400,176,7,6,13,53.8%,19m
8420,2,admiralwafuh,2400,118,3,5,8,37.5%,19m
8420,2,뽕픨이,2400,40,2,5,7,28.6%,38m
8420,2,BNMEEE,2400,0,0,3,3,0.0%,19m
8425,1,NICKEL,2399,1061,36,47,83,43.4%,39m
8425,1,[스타워리어]프리먼다이슨,2399,96,3,10,13,23.1%,16m
8425,2,LeetPuff,2399,0,1,3,4,25.0%,15m
8425,2,smokingbabe,2399,0,1,4,5,20.0%,15m
8425,1,천연라임향,2399,0,0,1,1,0.0%,15m
8430,3,호준밥호,2398,228,8,12,20,40.0%,18m
8430,1,mastic,2398,163,5,8,13,38.5%,15m
8430,2,NDKMCJEDJE,2398,0,1,0,1,100.0%,18m
8430,2,tak,2398,46,1,4,5,20.0%,20m
8434,2,하유선,2397,1531,85,91,176,48.3%,19m
8434,2,redrum,2397,130,5,12,17,29.4%,19m
8434,3,heavymetal,2397,0,2,7,9,22.2%,39m
8434,2,natansonn,2397,0,1,4,5,20.0%,14m
8438,1,닭크템플라,2396,1445,190,198,388,49.0%,42m
8438,3,Davichmk,2396,223,8,13,21,38.1%,18m
8438,1,추적자,2396,202,7,11,18,38.9%,39m
8438,1,MiloP,2396,73,5,8,13,38.5%,16m
8438,2,BJhome,2396,0,1,0,1,100.0%,19m
8443,1,앙민재띠,2395,434,16,21,37,43.2%,39m
8443,1,플레이어,2395,169,8,9,17,47.1%,16m
8443,2,[JSBJ]rbdd,2395,202,7,6,13,53.8%,20m
8443,2,KNIGHT,2395,30,2,1,3,66.7%,19m
8443,2,[200114]coxycoxy,2395,0,1,0,1,100.0%,19m
8443,2,몬테백작,2395,0,0,1,1,0.0%,14m
8449,2,상남자,2394,1488,84,82,166,50.6%,19m
8449,1,[NLTN]아리송,2394,680,23,31,54,42.6%,11m
8449,1,EvilMorty,2394,448,14,21,35,40.0%,39m
8449,1,IIIIIIIIIIII,2394,246,6,9,15,40.0%,16m
8449,2,Inosensia,2394,97,2,5,7,28.6%,14m
8449,2,하우스지오,2394,0,1,4,5,20.0%,19m
8449,1,박하사탕,2394,0,0,1,1,0.0%,15m
8456,1,shooter,2393,1607,87,97,184,47.3%,11m
8456,1,cloud,2393,1262,57,80,137,41.6%,39m
8456,2,[SS친위대]짱맨,2393,342,12,7,19,63.2%,19m
8456,2,KrypTon,2393,247,8,13,21,38.1%,38m
8456,2,AIR,2393,98,4,5,9,44.4%,19m
8456,1,llllllllllll,2393,0,2,5,7,28.6%,39m
8456,2,꼴두기조림,2393,0,1,4,5,20.0%,14m
8463,1,lIIIlIIlIlII,2392,1219,178,204,382,46.6%,11m
8463,2,Chun,2392,1599,81,93,174,46.6%,19m
8463,1,아무거나,2392,542,19,21,40,47.5%,39m
8463,2,中国电晕派对,2392,270,10,11,21,47.6%,19m
8463,2,BRAIN,2392,30,2,1,3,66.7%,19m
8463,2,[V]ehrwhd,2392,0,0,2,2,0.0%,38m
8469,1,처음과나중,2391,1646,164,176,340,48.2%,11m
8469,2,TYyayayay,2391,146,4,1,5,80.0%,19m
8469,2,IIIIIIIIIIII,2391,36,1,7,8,12.5%,38m
8469,2,SpicaBluenot,2391,0,0,3,3,0.0%,15m
8473,2,alex,2390,481,22,23,45,48.9%,20m
8473,1,jordanbj,2390,102,3,2,5,60.0%,39m
8473,2,mblkms,2390,36,2,2,4,50.0%,20m
8476,2,운좋은바지,2389,1576,128,133,261,49.0%,19m
8476,2,[랜타디광]한번해볼까,2389,654,33,28,61,54.1%,19m
8476,1,IIIIIIIIIIII,2389,524,19,27,46,41.3%,12m
8476,2,[이터널]닥스훈트,2389,274,9,11,20,45.0%,19m
8476,2,lovelydent,2389,62,3,2,5,60.0%,19m
8476,2,[NighT1]ddd,2389,0,1,0,1,100.0%,18m
8482,1,General,2388,903,26,44,70,37.1%,12m
8482,2,주섬주섬,2388,293,10,17,27,37.0%,20m
8482,2,solo,2388,120,5,5,10,50.0%,19m
8482,1,네라스,2388,112,4,5,9,44.4%,12m
8482,2,[예부기]saviorZERO,2388,0,2,2,4,50.0%,14m
8482,2,공륙이,2388,30,1,3,4,25.0%,20m
8482,2,머더샌즈,2388,0,0,1,1,0.0%,15m
8489,1,사관과신사,2387,1698,191,197,388,49.2%,12m
8489,2,IIIIIIIIIII,2387,804,32,32,64,50.0%,19m
8489,2,행식,2387,464,15,17,32,46.9%,11m
8489,1,파닉다트,2387,134,6,8,14,42.9%,39m
8489,2,PelPuska,2387,140,4,4,8,50.0%,11m
8489,2,[cox2p]이세상이모양,2387,0,0,1,1,0.0%,14m
8489,2,레이빛나,2387,0,0,1,1,0.0%,20m
8489,2,stadoll,2387,0,0,3,3,0.0%,19m
8497,2,marin,2386,226,8,5,13,61.5%,18m
8497,2,Zodiac,2386,232,7,12,19,36.8%,20m
8497,2,JMG,2386,60,3,3,6,50.0%,20m
8497,2,IMJerry,2386,84,3,4,7,42.9%,20m
8497,2,Temati,2386,0,1,2,3,33.3%,19m
8497,2,잘하고싶다,2386,0,1,4,5,20.0%,20m
8497,2,마린보이,2386,0,1,4,5,20.0%,14m
8497,2,자도지근,2386,0,0,1,1,0.0%,19m
8497,2,[마계인천]Marrin,2386,0,0,3,3,0.0%,15m
8506,2,기백남,2385,1243,48,53,101,47.5%,20m
8506,2,roro,2385,120,4,2,6,66.7%,11m
8506,2,bdrive,2385,0,1,4,5,20.0%,38m
8509,1,praysy,2384,1037,37,38,75,49.3%,12m
8509,2,蘭陵王,2384,342,10,16,26,38.5%,19m
8509,1,TWforever,2384,34,3,4,7,42.9%,39m
8509,2,평범해,2384,0,2,5,7,28.6%,14m
8509,2,태양이,2384,48,2,6,8,25.0%,15m
8509,2,Grizzly,2384,0,0,1,1,0.0%,19m
8509,2,viaD,2384,0,0,2,2,0.0%,20m
8509,2,尼科斯,2384,0,0,2,2,0.0%,15m
8517,1,ikim,2383,1630,126,134,260,48.5%,11m
8517,2,Naiard,2383,198,7,1,8,87.5%,11m
8517,2,SaB,2383,0,5,8,13,38.5%,40m
8517,2,네오냐,2383,114,4,3,7,57.1%,19m
8517,2,[뉴비다]한조,2383,171,4,6,10,40.0%,19m
8517,2,스타맨,2383,0,1,1,2,50.0%,19m
8517,2,이릭,2383,0,0,1,1,0.0%,15m
8524,2,GINI,2382,520,20,17,37,54.1%,19m
8524,2,sinob,2382,0,2,3,5,40.0%,15m
8524,1,[맢레스토랑스]전체포스,2382,0,1,0,1,100.0%,16m
8527,2,박주완,2381,877,33,32,65,50.8%,19m
8527,2,chasong,2381,152,5,8,13,38.5%,11m
8527,2,WellsFXG,2381,0,0,3,3,0.0%,38m
8530,1,저주의듀라한,2380,342,12,16,28,42.9%,11m
8530,2,봐주셔여,2380,170,5,9,14,35.7%,11m
8530,1,상식결핍,2380,96,3,2,5,60.0%,16m
8530,1,MewMew,2380,0,1,0,1,100.0%,16m
8530,1,Eric,2380,48,1,4,5,20.0%,15m
8535,1,ZackMeliodas,2379,331,13,20,33,39.4%,12m
8536,1,초딩대표조진우,2378,254,12,18,30,40.0%,12m
8536,2,choiyg,2378,148,6,3,9,66.7%,38m
8536,3,붉은요괴,2378,92,6,12,18,33.3%,17m
8536,2,Choojuckhe,2378,32,1,1,2,50.0%,38m
8540,1,[문법나치]ZeraTul,2377,1681,208,225,433,48.0%,12m
8540,2,[최정예]fusroda,2377,97,5,6,11,45.5%,19m
8542,1,kingbike,2376,1645,77,82,159,48.4%,39m
8542,2,Carpem,2376,813,61,64,125,48.8%,19m
8542,2,WEIting,2376,381,15,14,29,51.7%,19m
8542,2,MELAYU,2376,403,14,17,31,45.2%,19m
8542,2,밀인랍형,2376,30,2,4,6,33.3%,11m
8542,2,아주쉬움,2376,0,1,0,1,100.0%,19m
8548,2,Mxcca,2375,144,3,7,10,30.0%,15m
8548,2,Anorld,2375,30,1,2,3,33.3%,38m
8548,2,fhxsa,2375,0,0,2,2,0.0%,38m
8551,2,Ssaulabi,2374,835,83,87,170,48.8%,19m
8551,1,[시럽]킹갓사도,2374,242,8,15,23,34.8%,13m
8551,1,Krabik,2374,256,7,10,17,41.2%,16m
8551,1,[뇨뇨뇨찬양]사도따먹는신관님,2374,30,1,1,2,50.0%,16m
8551,2,soyeom,2374,34,1,4,5,20.0%,19m
8551,2,qhfltn,2374,0,0,4,4,0.0%,15m
8557,2,Hiasen,2373,225,8,14,22,36.4%,38m
8557,2,IlIlllIIlIlI,2373,30,4,2,6,66.7%,11m
8557,1,헬대수학,2373,121,3,5,8,37.5%,17m
8557,1,Kevin,2373,0,2,6,8,25.0%,15m
8561,2,싸울아비,2372,1196,47,41,88,53.4%,38m
8561,2,[Rush]MeTeor,2372,204,10,3,13,76.9%,20m
8561,2,루터킹,2372,30,2,2,4,50.0%,19m
8561,2,Realcircle,2372,32,1,1,2,50.0%,19m
8561,2,joseisamurai,2372,30,1,3,4,25.0%,38m
8561,2,starship,2372,0,0,4,4,0.0%,19m
8567,2,KTFtoIR,2371,514,33,34,67,49.3%,19m
8567,1,프랑,2371,854,26,38,64,40.6%,39m
8567,2,미믹정주,2371,179,5,7,12,41.7%,19m
8567,2,IIIIIIIIIIII,2371,126,4,3,7,57.1%,19m
8567,2,걍한국인,2371,30,1,3,4,25.0%,11m
8567,2,기회를위기로,2371,0,0,3,3,0.0%,38m
8573,2,skematt,2370,1202,50,41,91,54.9%,38m
8573,2,짐레이너,2370,30,2,2,4,50.0%,38m
8573,3,[브리티안]bob,2370,0,1,0,1,100.0%,17m
8573,2,[EZboYz]MhiSt,2370,34,1,5,6,16.7%,19m
8573,2,Wither,2370,0,0,1,1,0.0%,19m
8578,1,NOTE,2369,826,87,92,179,48.6%,11m
8579,2,[쫄깃함]해외야구갤러리,2368,560,20,20,40,50.0%,19m
8579,2,StormForger,2368,0,1,0,1,100.0%,19m
8581,1,blood,2367,0,1,0,1,100.0%,15m
8581,2,[브리티안]lllllllll,2367,30,1,1,2,50.0%,19m
8583,2,지다찬파더,2366,1447,81,89,170,47.6%,19m
8583,1,jefe,2366,704,30,27,57,52.6%,11m
8583,3,규동,2366,572,21,28,49,42.9%,45m
8583,2,WOOF,2366,96,3,5,8,37.5%,19m
8583,2,Red,2366,46,2,2,4,50.0%,15m
8583,2,斯勾以,2366,30,1,2,3,33.3%,19m
8583,2,Kulimi,2366,0,1,4,5,20.0%,38m
8583,2,kis,2366,0,0,1,1,0.0%,19m
8591,1,AbnerHO,2365,298,13,13,26,50.0%,39m
8591,2,Xteg,2365,150,5,7,12,41.7%,19m
8591,2,호진이멋잇어,2365,0,1,0,1,100.0%,38m
8591,2,Phenix,2365,0,1,0,1,100.0%,20m
8591,2,JABAASS,2365,0,0,1,1,0.0%,38m
8596,2,저그연습많이하자,2364,656,25,27,52,48.1%,38m
8596,2,로이존스,2364,445,18,18,36,50.0%,19m
8596,1,[신뢰]blueshark,2364,291,11,11,22,50.0%,39m
8596,2,MrT,2364,118,5,2,7,71.4%,18m
8596,2,Berrycat,2364,58,3,6,9,33.3%,38m
8596,2,[국립대]PETsGOOD,2364,0,1,0,1,100.0%,38m
8596,2,MusaGGun,2364,0,0,1,1,0.0%,11m
8603,1,stork,2363,1142,44,38,82,53.7%,12m
8603,2,ADGOG,2363,759,33,32,65,50.8%,11m
8603,2,Skywalker,2363,892,32,37,69,46.4%,19m
8603,2,공격형,2363,182,6,9,15,40.0%,20m
8603,1,kane,2363,154,5,13,18,27.8%,12m
8603,2,짜잔,2363,116,4,6,10,40.0%,11m
8603,1,HEARTHSTONE,2363,82,2,6,8,25.0%,39m
8603,3,Terran,2363,0,1,4,5,20.0%,14m
8603,2,qkrwlgh,2363,0,1,5,6,16.7%,15m
8603,1,하이,2363,0,0,1,1,0.0%,15m
8603,2,[DIAMOB]로우킥,2363,0,0,1,1,0.0%,19m
8614,2,저그군단,2362,1048,43,35,78,55.1%,38m
8614,1,loserkobe,2362,388,14,12,26,53.8%,39m
8614,1,[패자는피를]드디어올곳이왔군,2362,413,14,16,30,46.7%,12m
8614,2,죽음의신,2362,34,2,3,5,40.0%,19m
8618,1,밤까마귀,2361,1207,59,61,120,49.2%,12m
8618,1,뽀니,2361,1041,32,43,75,42.7%,12m
8618,2,바실리우스,2361,96,4,7,11,36.4%,19m
8618,2,lalalalalala,2361,0,3,2,5,60.0%,19m
8618,2,여여영수,2361,0,0,1,1,0.0%,15m
8623,1,Lieshiet,2360,518,17,26,43,39.5%,39m
8623,3,Ferriby,2360,330,14,21,35,40.0%,40m
8623,2,YMM,2360,438,13,22,35,37.1%,20m
8623,2,강땅크,2360,30,2,6,8,25.0%,11m
8623,2,sjw,2360,0,1,1,2,50.0%,19m
8623,1,AuricTesla,2360,0,1,2,3,33.3%,16m
8623,2,살살좀요,2360,0,0,1,1,0.0%,38m
8630,1,[밀리터리버거]MUSAT,2359,366,30,30,60,50.0%,11m
8630,2,서정욱,2359,295,11,15,26,42.3%,19m
8630,2,울산호토,2359,0,0,1,1,0.0%,19m
8633,2,modickm,2358,254,10,8,18,55.6%,20m
8633,1,미니덴,2358,30,3,6,9,33.3%,39m
8633,2,맛이있는콜라,2358,0,1,5,6,16.7%,38m
8636,1,妳媽下面好臭,2357,526,20,22,42,47.6%,12m
8636,2,니똥꼬삼번출구,2357,310,10,18,28,35.7%,19m
8636,2,[wiz]aviator,2357,94,4,3,7,57.1%,19m
8636,2,Atanis,2357,56,3,4,7,42.9%,19m
8636,2,秋季戀楓,2357,30,2,2,4,50.0%,19m
8636,2,부천의한시민,2357,0,1,5,6,16.7%,19m
8642,3,[머구폐렴]lllllIIllIll,2356,1410,56,68,124,45.2%,13m
8642,2,IlllIIIIllIl,2356,0,0,1,1,0.0%,15m
8644,2,만수,2355,714,30,33,63,47.6%,19m
8644,2,Punch,2355,365,13,16,29,44.8%,20m
8644,2,亂彈琴呆呆,2355,225,6,7,13,46.2%,20m
8644,2,박박,2355,112,4,6,10,40.0%,11m
8644,2,김욱상,2355,86,3,3,6,50.0%,19m
8644,2,hihikaka,2355,0,1,1,2,50.0%,38m
8644,2,Legit,2355,0,0,1,1,0.0%,38m
8651,1,[a8a]Rock,2354,995,67,69,136,49.3%,12m
8651,1,무교훈롤존나못함,2354,176,6,9,15,40.0%,39m
8651,2,어둠의용,2354,64,3,2,5,60.0%,19m
8654,2,chris,2353,1588,118,140,258,45.7%,19m
8654,1,[안티신개미]아빠아빠아들,2353,234,7,14,21,33.3%,15m
8654,1,임장군,2353,163,5,10,15,33.3%,39m
8654,2,Edgar,2353,0,4,3,7,57.1%,15m
8654,2,lteamswordsl,2353,58,3,1,4,75.0%,18m
8654,2,세젤예,2353,115,3,7,10,30.0%,38m
8654,2,[Trivia]ULayGyi,2353,46,2,0,2,100.0%,15m
8654,2,리시빙,2353,0,2,3,5,40.0%,38m
8654,2,기운찬기사,2353,0,0,1,1,0.0%,38m
8663,2,Sasinmu,2352,314,11,18,29,37.9%,20m
8663,1,Holy,2352,0,2,5,7,28.6%,39m
8663,2,MinjinPark,2352,30,1,1,2,50.0%,19m
8663,2,ponps,2352,0,0,1,1,0.0%,15m
8663,2,오마샤리프,2352,0,0,2,2,0.0%,19m
8668,2,kspsss,2351,814,30,35,65,46.2%,19m
8668,2,글램,2351,312,12,15,27,44.4%,19m
8668,1,[볼셰비키]좇커,2351,188,5,7,12,41.7%,15m
8668,2,nigimi,2351,90,3,10,13,23.1%,19m
8668,2,서태웅,2351,122,2,2,4,50.0%,38m
8673,1,[NoME]AjiDeGallina,2350,256,7,13,20,35.0%,39m
8673,1,skwyverns,2350,0,1,0,1,100.0%,17m
8673,2,운명,2350,36,1,1,2,50.0%,19m
8673,2,Jjun,2350,46,1,1,2,50.0%,15m
8673,2,손호영,2350,0,1,2,3,33.3%,11m
8673,2,盛夏蒲公英,2350,30,1,5,6,16.7%,38m
8673,2,IIIIIIIIIIII,2350,0,1,5,6,16.7%,38m
8680,1,[River]맘모스올인,2349,1248,372,409,781,47.6%,12m
8680,1,coco,2349,605,19,25,44,43.2%,11m
8680,2,IIIIIIIIII,2349,360,14,16,30,46.7%,38m
8680,1,DAMES,2349,274,8,14,22,36.4%,12m
8680,2,qmdnp,2349,72,2,6,8,25.0%,11m
8680,1,더글링,2349,0,1,0,1,100.0%,16m
8686,2,[프로토스협회]유비,2348,230,9,4,13,69.2%,38m
8686,2,KTL,2348,167,7,5,12,58.3%,18m
8686,2,alexender,2348,96,1,2,3,33.3%,15m
8686,2,SEOU,2348,0,0,1,1,0.0%,11m
8690,2,[krtag]dragontooth,2347,308,14,17,31,45.2%,18m
8690,3,재민,2347,0,1,4,5,20.0%,33m
8690,2,SingleDad,2347,0,1,4,5,20.0%,38m
8690,1,[글로벌존망껨]danyami,2347,0,1,7,8,12.5%,39m
8694,2,수리수리마하수리,2346,351,15,7,22,68.2%,19m
8694,1,질문왕퀘스쳔,2346,76,4,7,11,36.4%,39m
8694,1,小廢物,2346,120,3,12,15,20.0%,13m
8694,3,deedpool,2346,54,3,16,19,15.8%,13m
8694,2,lwb,2346,30,2,3,5,40.0%,19m
8699,2,FireLion,2345,64,2,8,10,20.0%,18m
8699,2,[원탑1st]꼬미,2345,0,0,1,1,0.0%,11m
8701,2,mher,2344,0,0,2,2,0.0%,19m
8702,1,nathan,2343,1615,117,121,238,49.2%,39m
8702,1,작은악마띠모,2343,1315,103,101,204,50.5%,11m
8702,2,sihyeong,2343,502,18,15,33,54.5%,39m
8702,2,쑤인이다,2343,190,6,9,15,40.0%,19m
8702,2,yuji,2343,48,3,4,7,42.9%,15m
8707,2,나는나다,2342,219,21,21,42,50.0%,11m
8707,1,벨라스케즈,2342,262,7,1,8,87.5%,16m
8707,2,owo,2342,92,4,9,13,30.8%,19m
8707,1,윈드레인저,2342,0,2,5,7,28.6%,16m
8707,2,[달빛양념기사]NaProTos,2342,0,1,1,2,50.0%,20m
8707,3,찹쌀떡,2342,0,1,2,3,33.3%,14m
8707,2,[SKYYY]BigHit,2342,0,0,1,1,0.0%,14m
8714,2,hut,2341,274,9,11,20,45.0%,11m
8714,2,Acau,2341,122,4,6,10,40.0%,19m
8716,2,크리,2340,112,3,1,4,75.0%,19m
8717,2,이찬노엄마,2339,200,7,8,15,46.7%,19m
8717,2,LighT,2339,94,3,8,11,27.3%,15m
8717,2,thweforeon,2339,0,2,6,8,25.0%,15m
8720,2,비싼한돈,2338,30,1,8,9,11.1%,11m
8720,2,Octa,2338,0,0,1,1,0.0%,38m
8722,2,[gg28]ganuul,2337,162,6,6,12,50.0%,19m
8723,2,Hyun,2336,1003,40,41,81,49.4%,11m
8723,1,Bazinga,2336,0,2,6,8,25.0%,39m
8723,2,agfapicasso,2336,0,0,1,1,0.0%,15m
8726,1,ZERG,2335,1070,40,48,88,45.5%,13m
8726,1,poohno,2335,334,11,15,26,42.3%,12m
8726,2,개못하네,2335,138,5,5,10,50.0%,38m
8726,2,TKS,2335,100,4,6,10,40.0%,19m
8730,2,구룸이,2334,438,13,21,34,38.2%,19m
8731,2,[Satada]WEVE,2332,777,31,32,63,49.2%,20m
8731,2,요시노시노,2332,313,12,17,29,41.4%,20m
8731,2,lex,2332,210,6,7,13,46.2%,38m
8731,2,전영배,2332,163,3,2,5,60.0%,15m
8735,1,라디오스타,2331,1211,101,110,211,47.9%,12m
8735,2,萊恩,2331,498,17,22,39,43.6%,19m
8735,2,radasax,2331,441,16,15,31,51.6%,19m
8735,1,EBASHU,2331,230,8,14,22,36.4%,16m
8735,1,놈우연,2331,237,6,10,16,37.5%,15m
8735,2,llllllllllll,2331,138,4,2,6,66.7%,19m
8735,2,PixolDragon,2331,120,4,7,11,36.4%,14m
8735,1,김범준,2331,136,4,16,20,20.0%,11m
8735,2,xomegaxz,2331,156,3,3,6,50.0%,20m
8735,2,[oxox]ZooM,2331,111,3,4,7,42.9%,15m
8735,2,귀찮아죽겠넹,2331,0,1,4,5,20.0%,38m
8746,1,SixS,2330,644,42,51,93,45.2%,12m
8746,2,行走的荷尔蒙,2330,165,7,4,11,63.6%,38m
8746,3,새이름으로입력,2330,0,1,4,5,20.0%,33m
8746,2,gagroshe,2330,0,0,2,2,0.0%,15m
8750,1,내어깨위고양이밥,2329,922,38,40,78,48.7%,12m
8750,2,Vilveq,2329,361,14,17,31,45.2%,38m
8750,2,DsD,2329,258,9,14,23,39.1%,38m
8750,3,Immanuel,2329,0,0,5,5,0.0%,14m
8754,2,Winger,2328,1566,87,104,191,45.5%,39m
8754,2,이강준,2328,222,9,3,12,75.0%,19m
8754,2,[教我玩蟲族l]HsiehDrogan,2328,172,6,7,13,46.2%,11m
8754,2,[인공지능보통]미네랄캐기,2328,72,3,6,9,33.3%,11m
8754,1,[pepsl]불닭볶음면,2328,48,2,1,3,66.7%,17m
8754,2,kimTT,2328,0,2,5,7,28.6%,15m
8754,2,[빙하행성얼코]RomaneeConti,2328,73,1,4,5,20.0%,38m
8761,2,하앙명지,2327,90,4,6,10,40.0%,19m
8761,2,[고아쉐끼]wkssdf,2327,58,3,4,7,42.9%,19m
8761,2,boy,2327,90,3,5,8,37.5%,38m
8761,1,[해양경비대]스타즐겜유저,2327,0,2,7,9,22.2%,16m
8761,2,我愛松鼠,2327,46,1,1,2,50.0%,15m
8766,2,[별똥별]애긔겅듀,2326,1518,54,67,121,44.6%,11m
8766,2,ladlad,2326,319,12,13,25,48.0%,38m
8766,2,Tiphareth,2326,174,5,11,16,31.2%,19m
8766,2,憶雲,2326,30,2,0,2,100.0%,18m
8766,2,윤뽀씨,2326,0,0,1,1,0.0%,19m
8766,2,엠페러나폴레옹,2326,0,0,2,2,0.0%,20m
8772,2,공허의추적자,2325,195,7,2,9,77.8%,19m
8772,2,[스코델라리오]캐리건,2325,169,6,9,15,40.0%,19m
8772,2,딴지맨,2325,137,6,11,17,35.3%,19m
8772,1,로돕벌,2325,202,5,11,16,31.2%,15m
8772,2,쓸쓸한늑대,2325,0,0,1,1,0.0%,19m
8772,2,Carnage,2325,0,0,2,2,0.0%,38m
8778,2,QUYEN,2324,1366,50,55,105,47.6%,20m
8778,2,Stormedge,2324,90,4,4,8,50.0%,19m
8778,1,bmwkks,2324,169,3,5,8,37.5%,17m
8778,2,WTF,2324,42,1,4,5,20.0%,20m
8778,2,[즐겜유저연합]홐춘,2324,0,0,2,2,0.0%,19m
8783,1,ggATM,2323,474,20,27,47,42.6%,39m
8783,2,Fireflies,2323,188,6,11,17,35.3%,20m
8783,3,[RUSHER]ExiumFate,2323,171,6,12,18,33.3%,17m
8783,2,syu,2323,154,4,6,10,40.0%,38m
8783,2,DKREAD,2323,105,3,7,10,30.0%,38m
8783,2,lensherr,2323,0,0,1,1,0.0%,19m
8789,2,짱무서워요,2322,176,6,3,9,66.7%,19m
8789,2,[너의ol름은]towns,2322,86,3,5,8,37.5%,19m
8789,2,iboskore,2322,97,2,2,4,50.0%,14m
8789,2,SoulKaron,2322,88,1,1,2,50.0%,19m
8793,2,[ZagBra]머털도사,2321,410,13,22,35,37.1%,19m
8793,2,wills,2321,0,1,0,1,100.0%,19m
8795,2,PuppyDog,2320,1474,77,82,159,48.4%,11m
8795,1,둠바래,2320,748,50,60,110,45.5%,12m
8795,1,뜅이,2320,617,26,28,54,48.1%,11m
8795,2,happys,2320,244,7,7,14,50.0%,11m
8795,2,斷腳小民,2320,114,4,4,8,50.0%,38m
8795,2,Rbalsdl,2320,0,2,3,5,40.0%,38m
8795,2,Waye,2320,0,1,1,2,50.0%,19m
8795,1,Dasom,2320,0,0,1,1,0.0%,17m
8795,2,안양따개비,2320,0,0,1,1,0.0%,38m
8804,1,커피,2319,526,15,28,43,34.9%,12m
8805,1,쪼코우유,2318,1248,216,255,471,45.9%,12m
8805,2,노무현슨상님,2318,366,13,17,30,43.3%,39m
8805,2,武氏胖胖,2318,0,1,5,6,16.7%,15m
8805,1,닥터형,2318,0,0,2,2,0.0%,16m
8809,2,힛릿카,2317,1548,226,247,473,47.8%,19m
8809,3,AMAzing,2317,1221,62,78,140,44.3%,45m
8809,2,현키,2317,0,1,3,4,25.0%,38m
8809,2,HVMVH,2317,0,0,1,1,0.0%,19m
8813,2,FreezSun,2316,226,14,9,23,60.9%,19m
8813,2,Darrksine,2316,156,5,10,15,33.3%,38m
8813,2,吳榆,2316,30,2,4,6,33.3%,38m
8813,2,[옹선생님]즐겜유저유녕이,2316,0,0,1,1,0.0%,38m
8813,2,흑먹어,2316,0,0,1,1,0.0%,19m
8818,2,[213]나나나,2315,1052,41,43,84,48.8%,19m
8818,2,OwO,2315,414,15,16,31,48.4%,19m
8818,2,skyhoole,2315,120,5,5,10,50.0%,19m
8818,2,smile,2315,48,3,9,12,25.0%,15m
8818,2,DragonOfSea,2315,0,1,5,6,16.7%,15m
8823,2,NicsTan,2314,470,35,46,81,43.2%,20m
8823,2,jinskims,2314,114,7,12,19,36.8%,40m
8823,1,sPln,2314,118,3,7,10,30.0%,15m
8823,2,HyeuN,2314,0,0,1,1,0.0%,11m
8823,2,IIIIIIIIII,2314,0,0,2,2,0.0%,15m
8828,2,정우승,2313,102,3,0,3,100.0%,20m
8828,1,宇宙之力,2313,180,3,6,9,33.3%,15m
8828,2,gkstjsgh,2313,46,1,1,2,50.0%,15m
8831,2,[최고가컨트롤]레바,2312,491,18,22,40,45.0%,19m
8831,2,[華盟]頭號嫩咖,2312,256,14,15,29,48.3%,19m
8831,2,Boss,2312,102,2,1,3,66.7%,19m
8834,2,[너의ol름은]원신,2311,158,4,9,13,30.8%,38m
8834,2,월곡동초보,2311,30,2,4,6,33.3%,19m
8836,2,Requiem,2310,154,4,4,8,50.0%,38m
8836,2,haven,2310,58,3,6,9,33.3%,19m
8836,2,IIIIIIIIIIII,2310,112,2,6,8,25.0%,15m
8839,2,[국방부사서병]NICKX,2309,236,8,11,19,42.1%,38m
8839,2,youngdae,2309,62,2,5,7,28.6%,19m
8839,1,XplooD,2309,0,2,5,7,28.6%,39m
8842,1,오른손,2308,172,5,11,16,31.2%,16m
8842,2,역지사지,2308,0,0,3,3,0.0%,19m
8844,2,페미니스트김형섭,2307,589,24,20,44,54.5%,39m
8844,2,Silencerx,2307,238,8,14,22,36.4%,19m
8844,1,정대봉,2307,0,0,4,4,0.0%,39m
8844,2,Coralreef,2307,0,0,6,6,0.0%,20m
8848,2,EMP,2306,250,10,19,29,34.5%,11m
8848,1,minipig,2306,150,7,13,20,35.0%,17m
8848,2,게맛살,2306,144,6,5,11,54.5%,19m
8851,2,세라장군,2305,214,7,13,20,35.0%,19m
8851,1,MrMore,2305,184,5,10,15,33.3%,16m
8851,2,ORNNMASTER,2305,0,0,2,2,0.0%,19m
8854,1,DarkDeath,2304,217,4,6,10,40.0%,17m
8854,2,reoe,2304,112,2,2,4,50.0%,39m
8854,2,天夜,2304,0,1,5,6,16.7%,38m
8857,1,fortuna,2303,213,7,8,15,46.7%,16m
8857,2,다덤벼,2303,172,5,4,9,55.6%,38m
8857,1,너희어머,2303,121,3,5,8,37.5%,39m
8857,2,Heavyarms,2303,0,0,5,5,0.0%,15m
8861,1,Zernex,2302,476,16,23,39,41.0%,13m
8861,2,victor,2302,88,2,1,3,66.7%,11m
8861,2,roy,2302,0,0,2,2,0.0%,11m
8864,2,LunaTicDream,2301,242,9,19,28,32.1%,20m
8864,2,[sc2mc]본드코리아,2301,239,8,13,21,38.1%,11m
8864,2,Ronin,2301,216,6,7,13,46.2%,19m
8864,3,beeboop,2301,0,1,0,1,100.0%,14m
8868,2,길가다주었다,2300,134,5,8,13,38.5%,15m
8868,1,TaTo,2300,133,3,7,10,30.0%,39m
8868,2,앂새,2300,30,2,1,3,66.7%,18m
8868,3,KyoRyuJin,2300,0,1,0,1,100.0%,18m
8872,2,이천사,2299,1553,125,141,266,47.0%,19m
8872,2,RAINING,2299,633,21,27,48,43.8%,38m
8872,2,[공허거주]CSW,2299,371,14,12,26,53.8%,19m
8872,2,Alwaysaloony,2299,0,1,5,6,16.7%,38m
8876,1,지보,2298,48,2,2,4,50.0%,17m
8877,2,akmnb,2297,986,43,38,81,53.1%,38m
8877,3,재키와이,2297,479,21,18,39,53.8%,18m
8877,2,dfghd,2297,86,4,8,12,33.3%,38m
8877,3,사키르,2297,30,2,0,2,100.0%,18m
8877,3,nuamd,2297,0,1,4,5,20.0%,14m
8877,2,통큰대장부,2297,0,0,3,3,0.0%,19m
8883,1,神影格格,2296,1400,53,57,110,48.2%,39m
8883,2,jmcp,2296,498,21,31,52,40.4%,11m
8883,2,ABLE,2296,318,16,18,34,47.1%,19m
8883,3,SpawningPool,2296,0,1,4,5,20.0%,33m
8887,2,momilibavo,2295,912,36,35,71,50.7%,38m
8887,2,슬픈늑대,2295,582,25,33,58,43.1%,19m
8887,2,[EZboYz]wedfrsik,2295,424,15,26,41,36.6%,19m
8887,3,프로토스,2295,296,10,15,25,40.0%,18m
8887,2,[zAWSLz]暴風之音,2295,30,2,2,4,50.0%,19m
8887,2,Bjakson,2295,0,2,5,7,28.6%,15m
8893,2,우아,2294,313,16,21,37,43.2%,19m
8893,2,redmi,2294,102,2,2,4,50.0%,19m
8893,1,wnteoaos,2294,0,1,8,9,11.1%,17m
8893,3,지나,2294,0,0,1,1,0.0%,17m
8897,2,베스트홍,2293,874,33,36,69,47.8%,20m
8898,3,wakedcrll,2292,1396,51,62,113,45.1%,45m
8898,3,퀴프아크,2292,30,2,1,3,66.7%,18m
8898,3,[ELS]마더러쒸아,2292,0,1,0,1,100.0%,18m
8898,3,Gwrecker,2292,0,1,4,5,20.0%,18m
8902,3,sides,2291,913,57,54,111,51.4%,18m
8902,2,[NoLate]베틀대마왕,2291,1288,49,48,97,50.5%,19m
8904,1,[달빛암흑기사]영희책상철책상,2290,126,5,7,12,41.7%,39m
8904,2,SRGQmangza,2290,0,2,4,6,33.3%,20m
8904,3,ErrdayGames,2290,0,1,4,5,20.0%,17m
8907,3,Steelwing,2289,0,3,2,5,60.0%,33m
8907,2,프리덤,2289,68,3,8,11,27.3%,20m
8907,3,IIIIIIIIIIII,2289,0,0,1,1,0.0%,18m
8910,2,星之耀,2288,371,13,14,27,48.1%,20m
8910,3,[HAKSAL]진화된인간입니다,2288,0,0,5,5,0.0%,14m
8912,3,[Apink2]Apink,2287,710,25,27,52,48.1%,33m
8912,2,mhblshhh,2287,357,19,18,37,51.4%,19m
8912,2,sheton,2287,204,7,6,13,53.8%,20m
8912,3,Arkangel,2287,218,7,12,19,36.8%,38m
8912,3,hongsi,2287,0,0,1,1,0.0%,18m
8912,3,홍어,2287,0,0,1,1,0.0%,18m
8918,2,재윤재윤,2286,164,4,5,9,44.4%,19m
8918,3,sksk,2286,0,1,0,1,100.0%,18m
8918,3,from,2286,0,1,1,2,50.0%,18m
8921,2,llllllllllll,2285,1490,73,64,137,53.3%,19m
8921,2,꼬미,2285,92,4,3,7,57.1%,15m
8921,2,[Tyler]김건임당,2285,102,2,6,8,25.0%,38m
8921,2,TheRocK,2285,0,1,5,6,16.7%,19m
8925,2,어휴뭘또,2284,333,12,10,22,54.5%,39m
8925,1,GRAVES,2284,156,4,20,24,16.7%,20m
8925,2,돈이날지켜준다,2284,90,3,5,8,37.5%,20m
8925,1,구구이형사,2284,30,3,7,10,30.0%,39m
8925,2,Garnet,2284,0,1,1,2,50.0%,15m
8925,1,Ferrari,2284,0,0,1,1,0.0%,16m
8925,3,[123kor]게임도사,2284,0,0,1,1,0.0%,18m
8932,1,네모누룽지,2283,46,3,8,11,27.3%,17m
8932,3,Dolphin,2283,95,1,1,2,50.0%,38m
8932,3,小雞大大,2283,0,0,1,1,0.0%,18m
8935,2,Corw,2282,1051,40,41,81,49.4%,38m
8935,2,chun,2282,0,0,2,2,0.0%,15m
8935,2,MrLee,2282,0,0,5,5,0.0%,19m
8938,1,망고맛완두콩,2281,142,4,1,5,80.0%,15m
8938,2,PARKDEKlNW,2281,120,2,3,5,40.0%,15m
8940,2,[맨소래담]홍따장군,2280,280,10,16,26,38.5%,11m
8940,3,gin,2280,228,9,6,15,60.0%,18m
8940,3,최규익,2280,0,3,2,5,60.0%,18m
8940,2,히어로,2280,90,1,3,4,25.0%,15m
8940,3,김마빡이,2280,0,0,1,1,0.0%,18m
8945,1,손사,2279,1405,47,60,107,43.9%,12m
8946,3,JJDPD,2278,66,2,4,6,33.3%,18m
8947,2,과천피바라기,2277,0,0,1,1,0.0%,15m
8948,1,SUS,2276,1627,135,157,292,46.2%,12m
8948,1,나는못해서진다,2276,96,3,3,6,50.0%,17m
8948,1,靠腰阿如,2276,46,2,6,8,25.0%,17m
8948,3,태스,2276,30,1,3,4,25.0%,18m
8948,3,물똥,2276,0,1,4,5,20.0%,14m
8948,3,딜르,2276,0,1,5,6,16.7%,14m
8954,1,patron,2275,1567,98,116,214,45.8%,11m
8954,1,[뭐야돌려줘요]쌈장,2275,238,7,18,25,28.0%,11m
8954,3,[ElsAna]서부사령관,2275,170,6,7,13,46.2%,18m
8954,2,아쫌걍해,2275,141,2,2,4,50.0%,15m
8954,2,레토제이,2275,46,2,3,5,40.0%,15m
8954,3,jeahoon,2275,0,0,1,1,0.0%,18m
8960,2,틀탁잇몸으로씹음,2274,118,8,6,14,57.1%,39m
8960,2,장도,2274,88,2,6,8,25.0%,19m
8960,3,beginner,2274,0,0,1,1,0.0%,18m
8963,2,아구의엽기전략,2273,470,31,26,57,54.4%,18m
8963,2,ALEXALADON,2273,506,21,22,43,48.8%,38m
8963,3,길리슈트,2273,156,5,2,7,71.4%,17m
8963,3,yourlike,2273,146,5,9,14,35.7%,18m
8963,2,아나,2273,95,2,6,8,25.0%,15m
8963,3,jksa,2273,0,1,1,2,50.0%,18m
8963,3,[프로토스협회]다섯살선생님,2273,0,0,2,2,0.0%,17m
8970,2,大炮,2272,1543,180,212,392,45.9%,18m
8970,2,科科男,2272,1286,52,45,97,53.6%,11m
8970,2,슬럽,2272,133,6,8,14,42.9%,20m
8970,3,Soul,2272,0,1,0,1,100.0%,38m
8970,3,UnluckZucks,2272,0,1,0,1,100.0%,17m
8970,1,Sus,2272,0,0,3,3,0.0%,16m
8976,2,simsime,2271,123,3,2,5,60.0%,19m
8977,3,Sskrineim,2270,0,2,4,6,33.3%,33m
8978,2,橄欖趴,2269,526,19,26,45,42.2%,20m
8979,2,강한유령,2268,1531,88,104,192,45.8%,11m
8979,3,[게임플레이]까비,2268,30,2,0,2,100.0%,14m
8979,3,PPmid,2268,30,2,1,3,66.7%,18m
8979,3,너나사랑해,2268,0,0,1,1,0.0%,18m
8979,3,Risen,2268,0,0,5,5,0.0%,18m
8984,1,사도요한,2267,157,6,9,15,40.0%,39m
8984,2,Continue,2267,0,2,1,3,66.7%,38m
8984,2,Genius,2267,0,0,2,2,0.0%,38m
8987,3,cream,2266,172,11,16,27,40.7%,18m
8987,3,maverickSR,2266,30,1,2,3,33.3%,38m
8987,3,ciaoromano,2266,32,1,3,4,25.0%,33m
8990,2,도토리와다람쥐,2265,596,43,49,92,46.7%,20m
8990,2,스카이워커,2265,445,35,44,79,44.3%,19m
8990,2,superbeginer,2265,142,5,7,12,41.7%,19m
8990,2,곰탱이,2265,173,4,2,6,66.7%,15m
8990,2,왜곡,2265,48,2,4,6,33.3%,15m
8990,3,쭈니아트,2265,0,0,2,2,0.0%,18m
8996,3,KJKMARI,2264,802,30,26,56,53.6%,18m
8996,1,[OldGuy]TritiumS,2264,137,9,7,16,56.2%,15m
8996,2,밀키스,2264,30,2,2,4,50.0%,19m
8999,2,[MRB]belive,2263,739,51,66,117,43.6%,19m
8999,2,아주멋져,2263,154,5,5,10,50.0%,39m
8999,2,오우죽이는데,2263,132,4,11,15,26.7%,11m
8999,2,TheMexican,2263,58,2,5,7,28.6%,20m
8999,3,erfew,2263,0,0,1,1,0.0%,18m
9004,2,윤문섭흑인,2262,259,12,9,21,57.1%,20m
9004,3,[무한김준현]星晴,2262,190,6,9,15,40.0%,17m
9004,3,너희집히로시마,2262,0,0,1,1,0.0%,38m
9007,3,최강지구력,2261,119,3,2,5,60.0%,17m
9007,3,烈火,2261,30,2,2,4,50.0%,18m
9007,3,코시,2261,0,2,8,10,20.0%,45m
9010,2,손자병법인해전술,2260,275,15,22,37,40.5%,19m
9010,2,renzodeee,2260,292,12,9,21,57.1%,19m
9010,2,XxrektxX,2260,254,8,14,22,36.4%,19m
9010,2,intense,2260,231,7,9,16,43.8%,20m
9010,3,파리산공수생수,2260,129,6,3,9,66.7%,18m
9010,2,Siang,2260,223,5,10,15,33.3%,15m
9010,2,[공포는환상]유머인나,2260,113,2,2,4,50.0%,15m
9010,3,무적알핀,2260,58,2,4,6,33.3%,17m
9018,2,[SOTV]Silencer,2259,594,21,25,46,45.7%,20m
9018,2,flora,2259,574,19,28,47,40.4%,19m
9018,3,[플러스울트라]구자카,2259,0,2,3,5,40.0%,14m
9021,2,절대적인힘으로,2258,140,2,4,6,33.3%,15m
9022,3,asd,2256,0,0,2,2,0.0%,17m
9023,2,yjh,2255,1273,61,79,140,43.6%,19m
9023,1,天安門,2255,678,32,44,76,42.1%,11m
9023,2,[히드라119]약물중독자,2255,240,8,16,24,33.3%,39m
9023,2,거대도끼,2255,116,3,7,10,30.0%,15m
9023,3,Berserker,2255,30,2,1,3,66.7%,18m
9023,3,장표,2255,0,0,1,1,0.0%,17m
9029,2,tony,2254,1134,45,45,90,50.0%,20m
9029,1,인공지능,2254,48,2,3,5,40.0%,16m
9029,3,[국방부사서병]merit,2254,0,0,1,1,0.0%,18m
9032,2,팀플레이,2253,235,7,8,15,46.7%,19m
9032,3,IIIIIIIIIIII,2253,88,3,6,9,33.3%,18m
9032,3,[我們是家人]叡爸,2253,30,2,2,4,50.0%,17m
9035,2,Outliers,2252,995,56,66,122,45.9%,11m
9035,2,물개단지,2252,898,33,34,67,49.3%,11m
9035,2,cemafe,2252,635,24,26,50,48.0%,19m
9035,1,[스커즈]은갈치,2252,193,5,13,18,27.8%,16m
9035,1,Aragorn,2252,120,3,5,8,37.5%,16m
9035,1,레이너,2252,0,1,3,4,25.0%,17m
9041,1,robin,2251,833,56,65,121,46.3%,20m
9041,3,rare,2251,314,12,13,25,48.0%,17m
9041,2,개꿀,2251,125,4,9,13,30.8%,38m
9041,2,HeLLeX,2251,84,3,5,8,37.5%,15m
9045,2,닝겐노히페리온,2250,30,2,6,8,25.0%,11m
9046,1,Malfurion,2249,1264,70,90,160,43.8%,13m
9046,2,James,2249,205,6,7,13,46.2%,38m
9046,2,불곰,2249,169,4,3,7,57.1%,15m
9046,3,[디케이드]FakeZero,2249,60,3,1,4,75.0%,18m
9050,1,packard,2248,1591,171,186,357,47.9%,12m
9050,1,Tenza,2248,1503,87,107,194,44.8%,12m
9050,1,LUFFY,2248,162,21,28,49,42.9%,12m
9050,1,유령바지,2248,408,10,14,24,41.7%,15m
9050,3,피바다,2248,0,0,1,1,0.0%,33m
9050,3,EmperorSora,2248,0,0,2,2,0.0%,38m
9050,3,logoutoe,2248,0,0,3,3,0.0%,33m
9050,2,Totodile,2248,0,0,3,3,0.0%,15m
9058,2,Ragnar,2247,1563,107,141,248,43.1%,20m
9058,2,lllllllllll,2247,62,3,7,10,30.0%,19m
9058,1,날빌킬러,2247,0,1,0,1,100.0%,16m
9058,2,[NoME]tomatococo,2247,0,0,11,11,0.0%,20m
9062,2,sxs,2246,415,13,22,35,37.1%,20m
9062,3,임무완료,2246,143,4,11,15,26.7%,18m
9062,1,도장,2246,30,3,8,11,27.3%,12m
9062,1,[더붉은공산당]피플,2246,0,0,1,1,0.0%,16m
9066,1,qlqkdntm,2245,1606,479,530,1009,47.5%,12m
9066,2,초록도시,2245,1077,76,91,167,45.5%,19m
9066,3,Boybitz,2245,353,12,20,32,37.5%,38m
9066,1,takemi,2245,377,9,14,23,39.1%,16m
9066,2,llllllllllll,2245,130,6,5,11,54.5%,15m
9071,3,Helvete,2244,239,13,19,32,40.6%,18m
9071,2,Ling,2244,174,7,10,17,41.2%,19m
9073,3,[NLTN]유니크,2243,0,0,1,1,0.0%,38m
9073,3,CaptainMitt,2243,0,0,1,1,0.0%,38m
9075,3,Alexiodus,2242,883,32,42,74,43.2%,18m
9075,2,브레이브하트,2242,530,25,36,61,41.0%,20m
9075,1,김빠진소맥,2242,106,6,9,15,40.0%,12m
9075,2,WIN,2242,60,4,6,10,40.0%,11m
9075,3,숲속,2242,42,2,6,8,25.0%,14m
9080,1,[13415]JKS,2241,945,36,41,77,46.8%,39m
9080,3,jbomb,2241,146,6,3,9,66.7%,18m
9080,3,자원늬,2241,0,1,4,5,20.0%,38m
9080,3,Flash,2241,0,0,1,1,0.0%,18m
9084,2,뭘봐뭐봐,2240,146,3,6,9,33.3%,20m
9084,3,Legendary,2240,0,1,1,2,50.0%,18m
9084,3,샤키,2240,30,1,1,2,50.0%,17m
9087,3,Twinshadow,2239,261,8,15,23,34.8%,18m
9087,1,지리산,2239,114,5,11,16,31.2%,39m
9087,2,아르곤,2239,0,3,4,7,42.9%,38m
9090,3,Gayyy,2238,60,3,1,4,75.0%,18m
9090,3,[rg3847]DEREK,2238,58,2,1,3,66.7%,18m
9090,3,我就爛,2238,0,1,4,5,20.0%,18m
9090,2,KTIGERS,2238,0,0,3,3,0.0%,15m
9094,3,Prove,2237,912,57,70,127,44.9%,14m
9094,1,Harry,2237,193,5,11,16,31.2%,15m
9094,1,베놈,2237,96,3,6,9,33.3%,16m
9094,3,floscow,2237,68,2,2,4,50.0%,18m
9094,1,wisped,2237,0,1,1,2,50.0%,17m
9094,3,자장면,2237,0,1,1,2,50.0%,18m
9094,3,饕餮帝族,2237,0,0,1,1,0.0%,18m
9101,3,ascyrax,2235,1029,41,59,100,41.0%,17m
9101,2,야린왕자,2235,206,8,15,23,34.8%,19m
9101,1,[알파go]UnknownJay,2235,242,7,15,22,31.8%,12m
9101,2,kamotero,2235,92,4,7,11,36.4%,15m
9101,3,메리원,2235,0,1,4,5,20.0%,18m
9106,2,poison,2234,1319,84,119,203,41.4%,38m
9106,2,DelPhi,2234,1066,34,50,84,40.5%,20m
9106,3,RasslabuhaA,2234,288,13,15,28,46.4%,17m
9106,3,[HDCore]불꽃,2234,0,0,1,1,0.0%,18m
9106,1,herO,2234,0,0,2,2,0.0%,16m
9111,3,Joyoung,2233,204,8,10,18,44.4%,18m
9112,2,옥종승,2232,524,18,29,47,38.3%,38m
9113,2,[머구폐렴]핫독구독구독구,2231,1509,61,66,127,48.0%,38m
9113,3,압도적인힘으로,2231,124,7,6,13,53.8%,17m
9113,2,suning,2231,58,3,5,8,37.5%,39m
9113,2,모이먹자,2231,104,3,9,12,25.0%,19m
9113,2,TrueLondoner,2231,58,2,10,12,16.7%,19m
9118,3,[ParStm]RuBued,2230,30,1,3,4,25.0%,18m
9119,2,제네시스,2229,1480,73,86,159,45.9%,11m
9119,3,SMG,2229,0,2,2,4,50.0%,38m
9119,3,prickface,2229,0,0,6,6,0.0%,18m
9122,2,星海女神,2228,606,68,80,148,45.9%,20m
9122,2,當媽祖愛上耶穌,2228,141,4,7,11,36.4%,15m
9122,2,Gooddaytodie,2228,90,2,6,8,25.0%,15m
9122,2,난죽경없,2228,0,0,1,1,0.0%,15m
9126,2,오드아이펄,2227,466,25,36,61,41.0%,20m
9126,2,JASON,2227,0,1,1,2,50.0%,15m
9126,3,Jodano,2227,30,1,2,3,33.3%,18m
9129,3,[SNH]Reverend,2226,168,6,6,12,50.0%,18m
9129,3,aaaaaaaaaaaa,2226,30,2,0,2,100.0%,18m
9129,3,[모니카]낮도깨비,2226,30,2,2,4,50.0%,18m
9129,3,PSW,2226,27,1,2,3,33.3%,33m
9133,2,[Blacer]무리뉴,2225,304,9,15,24,37.5%,18m
9133,2,blokeman,2225,253,8,15,23,34.8%,20m
9133,1,[OKRAN]아뇨뚱인데요,2225,188,3,5,8,37.5%,17m
9133,2,Hayman,2225,96,2,5,7,28.6%,15m
9133,3,레알밥도둑,2225,0,0,2,2,0.0%,14m
9138,2,고인제라툴,2224,306,10,22,32,31.2%,20m
9138,1,프로지망생김국현,2224,184,7,10,17,41.2%,16m
9138,3,cool,2224,30,3,4,7,42.9%,38m
9141,2,Worthy,2223,272,10,11,21,47.6%,18m
9141,2,만지면뭅니다,2223,224,7,12,19,36.8%,19m
9141,3,인봉,2223,122,5,10,15,33.3%,18m
9141,2,qwe,2223,0,1,5,6,16.7%,38m
9141,2,pelu,2223,0,0,6,6,0.0%,18m
9146,3,qqqq,2222,246,10,7,17,58.8%,17m
9146,3,CanisLupus,2222,0,1,2,3,33.3%,18m
9146,3,whtndnjs,2222,0,0,1,1,0.0%,18m
9149,2,유리,2221,287,10,18,28,35.7%,39m
9149,3,티케이,2221,0,1,4,5,20.0%,33m
9149,2,Joey,2221,0,1,6,7,14.3%,19m
9149,3,칼날여왕,2221,0,0,1,1,0.0%,14m
9153,3,小小郭隨便玩,2220,86,4,3,7,57.1%,18m
9153,3,killerawawaw,2220,116,3,7,10,30.0%,18m
9153,3,하얀이빨늑대,2220,58,2,1,3,66.7%,18m
9156,1,OOOOOOOO,2219,191,4,6,10,40.0%,15m
9156,3,뀨앙입니다만,2219,121,3,3,6,50.0%,18m
9156,1,hallow,2219,48,2,1,3,66.7%,17m
9156,3,ILOVEKIMCHI,2219,0,0,1,1,0.0%,17m
9160,1,OwO,2218,240,6,10,16,37.5%,16m
9160,3,umjetink,2218,0,1,0,1,100.0%,18m
9160,3,you,2218,0,1,4,5,20.0%,15m
9163,3,[RiceMi]米漿,2217,104,3,6,9,33.3%,18m
9163,2,건뿌웅,2217,0,1,1,2,50.0%,15m
9165,2,sisk,2216,103,3,3,6,50.0%,15m
9166,3,syncrodazt,2215,149,3,8,11,27.3%,38m
9167,3,Gravester,2214,256,10,15,25,40.0%,17m
9167,1,Katal,2214,95,1,1,2,50.0%,16m
9169,3,황금성배,2212,30,2,2,4,50.0%,18m
9169,3,[BOB]Fomula,2212,0,0,1,1,0.0%,18m
9171,2,[1324WE]Tofuninja,2211,325,10,18,28,35.7%,39m
9171,2,막걸리옥수수,2211,0,1,1,2,50.0%,15m
9173,1,TPZ,2210,206,10,12,22,45.5%,15m
9173,3,프로토스최고,2210,146,5,8,13,38.5%,18m
9175,3,SAM,2209,86,3,4,7,42.9%,18m
9175,1,星日,2209,0,1,0,1,100.0%,17m
9177,2,Kronos,2208,162,6,13,19,31.6%,19m
9177,2,Crazyangel,2208,0,0,1,1,0.0%,15m
9179,2,ATHENAMORAN,2207,1485,79,92,171,46.2%,39m
9179,1,NotKorean,2207,202,7,10,17,41.2%,39m
9179,3,星神,2207,48,1,1,2,50.0%,14m
9179,3,[너의ol름은]sunki,2207,0,0,1,1,0.0%,38m
9183,2,SKTQUASAR,2206,722,25,32,57,43.9%,39m
9183,3,zasdcasdas,2206,0,0,3,3,0.0%,18m
9185,2,스티븐젓갈,2205,97,1,3,4,25.0%,15m
9186,3,BlueBerryBox,2204,396,15,14,29,51.7%,33m
9186,3,나못함봐주셈,2204,245,14,13,27,51.9%,33m
9188,3,kama,2203,1212,50,69,119,42.0%,17m
9188,3,ajgogo,2203,0,1,0,1,100.0%,38m
9188,1,Suri,2203,0,0,1,1,0.0%,16m
9191,3,Esperer,2202,350,13,7,20,65.0%,18m
9191,3,Clossuares,2202,152,5,7,12,41.7%,38m
9191,2,SSaN,2202,151,5,10,15,33.3%,38m
9194,3,TwlakmanC,2201,1351,53,61,114,46.5%,18m
9194,3,제논라이플,2201,0,2,2,4,50.0%,18m
9194,2,연어초밥,2201,0,1,3,4,25.0%,15m
9194,2,영웅박동훈,2201,89,1,5,6,16.7%,39m
9194,3,별껌이,2201,0,0,4,4,0.0%,18m
9199,2,生化狼太灰,2200,1541,119,172,291,40.9%,11m
9199,2,야승재,2200,92,6,9,15,40.0%,15m
9199,3,jjh,2200,145,4,3,7,57.1%,18m
9199,1,[신개미협회]codenameZero,2200,48,2,2,4,50.0%,15m
9199,2,春安,2200,0,0,1,1,0.0%,15m
9204,3,미친마법사,2199,0,0,1,1,0.0%,18m
9205,2,EmiOne,2198,1205,69,94,163,42.3%,11m
9205,3,小宗,2198,218,9,9,18,50.0%,18m
9205,3,유현이는곧휴가철,2198,114,5,1,6,83.3%,17m
9205,3,dlgurtn,2198,86,3,2,5,60.0%,17m
9205,3,더오브인영이,2198,119,2,4,6,33.3%,38m
9205,3,gun,2198,0,1,5,6,16.7%,33m
9211,3,김첨지,2197,30,1,2,3,33.3%,18m
9212,3,샤넬꾸찌,2196,753,28,28,56,50.0%,17m
9212,3,lybjoy,2196,148,6,6,12,50.0%,17m
9212,1,WonderKitten,2196,46,3,9,12,25.0%,17m
9215,2,rhgkdud,2194,292,7,11,18,38.9%,15m
9215,3,thesola,2194,30,1,5,6,16.7%,17m
9217,1,망고향,2193,150,8,16,24,33.3%,12m
9217,1,LeonLei,2193,0,0,1,1,0.0%,17m
9217,3,jojojau,2193,0,0,1,1,0.0%,18m
9217,3,도전자,2193,0,0,1,1,0.0%,15m
9221,2,wouo,2192,472,18,22,40,45.0%,11m
9221,1,위드,2192,214,6,11,17,35.3%,16m
9221,2,Deneve,2192,96,2,7,9,22.2%,15m
9221,3,伊小小,2192,0,0,5,5,0.0%,15m
9225,2,범준,2191,1147,42,50,92,45.7%,20m
9225,3,[TEGA]나비의연꽃,2191,326,11,6,17,64.7%,18m
9225,2,hgfkhjk,2191,260,9,11,20,45.0%,19m
9225,3,자유의케릭,2191,142,5,3,8,62.5%,18m
9225,3,Zadkiel,2191,0,0,1,1,0.0%,14m
9230,2,playerccm,2190,1367,59,73,132,44.7%,19m
9230,3,Fireghost,2190,0,3,3,6,50.0%,33m
9230,3,[我們是家人]叡哥,2190,0,1,1,2,50.0%,18m
9230,3,soNg,2190,30,1,2,3,33.3%,38m
9234,1,어보미,2189,547,18,33,51,35.3%,12m
9234,2,박서준,2189,0,3,4,7,42.9%,15m
9234,3,llllllIIllII,2189,120,3,5,8,37.5%,38m
9234,3,해피뉴데이,2189,0,1,2,3,33.3%,15m
9234,3,사탄,2189,0,0,1,1,0.0%,18m
9239,3,[PartyZ]조선총잡이,2188,94,3,9,12,25.0%,18m
9240,3,Wexylum,2187,1305,45,53,98,45.9%,17m
9240,2,당근,2187,168,6,13,19,31.6%,20m
9242,3,llllllllllll,2186,0,1,0,1,100.0%,33m
9243,3,sonata,2185,388,12,20,32,37.5%,17m
9243,2,쟈니,2185,88,2,7,9,22.2%,15m
9243,2,[KRIC]protos,2185,30,2,9,11,18.2%,19m
9243,3,퀴욤퀴욤이,2185,0,0,3,3,0.0%,18m
9247,3,palini,2184,478,15,21,36,41.7%,17m
9247,3,Bern,2184,216,6,1,7,85.7%,18m
9247,3,gookHUNTER,2184,145,4,7,11,36.4%,18m
9247,2,Jeba,2184,177,4,10,14,28.6%,15m
9251,2,clemismyhero,2183,827,38,54,92,41.3%,19m
9251,2,눅눅한첵스초코,2183,161,6,7,13,46.2%,15m
9251,3,lllIIIlllIII,2183,96,1,2,3,33.3%,38m
9251,3,fdsgsrtfgreg,2183,0,1,5,6,16.7%,38m
9251,3,kebabfighter,2183,0,0,5,5,0.0%,15m
9256,3,jin,2182,267,9,17,26,34.6%,18m
9257,2,GMooZ,2181,530,18,21,39,46.2%,39m
9257,3,Tortik,2181,90,3,4,7,42.9%,38m
9257,3,ohdugi,2181,117,2,1,3,66.7%,17m
9257,3,[EZDUNK]canfam,2181,0,1,3,4,25.0%,38m
9261,1,killerakira,2180,353,12,19,31,38.7%,20m
9261,3,FlameWizzard,2180,172,6,6,12,50.0%,17m
9261,3,프로즐겜러,2180,0,0,1,1,0.0%,38m
9264,3,안녕디지몬,2179,1217,48,61,109,44.0%,38m
9264,3,프라자,2179,188,9,12,21,42.9%,18m
9264,3,Asav,2179,178,7,9,16,43.8%,17m
9264,3,zZack,2179,30,2,4,6,33.3%,15m
9268,3,stereo,2178,1279,55,58,113,48.7%,18m
9268,3,Terry,2178,1167,45,54,99,45.5%,18m
9268,3,건우짱,2178,802,30,39,69,43.5%,18m
9268,3,Crucible,2178,861,29,43,72,40.3%,40m
9268,3,kaputnik,2178,0,0,5,5,0.0%,14m
9273,3,YenJu,2177,366,12,16,28,42.9%,18m
9273,3,Darkblue,2177,170,4,7,11,36.4%,18m
9273,3,shangus,2177,0,2,2,4,50.0%,18m
9276,2,JoHuiJe,2176,215,7,1,8,87.5%,15m
9276,3,[Blacer]Haksoo,2176,0,0,2,2,0.0%,18m
9278,2,ygji,2175,1536,207,271,478,43.3%,19m
9279,3,Goospery,2174,272,9,14,23,39.1%,18m
9279,3,Louis,2174,30,3,9,12,25.0%,40m
9281,2,들뜬머리카락,2173,0,1,2,3,33.3%,15m
9281,2,Vault,2173,97,1,8,9,11.1%,15m
9281,3,이것은태양을높게,2173,0,0,2,2,0.0%,18m
9284,3,유현종옹지,2172,118,4,8,12,33.3%,18m
9284,2,洛克人,2172,30,2,9,11,18.2%,20m
9286,3,meekking,2171,1023,48,57,105,45.7%,33m
9286,1,제임스,2171,1013,37,47,84,44.0%,40m
9286,3,DOMONG,2171,268,8,12,20,40.0%,17m
9286,2,HwaYuiri,2171,195,6,14,20,30.0%,39m
9286,1,knight,2171,40,3,10,13,23.1%,12m
9291,2,lllIIIllllll,2170,558,18,30,48,37.5%,19m
9291,2,yoyoman,2170,292,10,14,24,41.7%,39m
9291,2,JaeMongRyong,2170,178,7,15,22,31.8%,39m
9294,3,망과이,2169,311,13,7,20,65.0%,33m
9294,3,RONAK,2169,0,0,1,1,0.0%,18m
9296,1,컴페니온스,2168,1535,76,93,169,45.0%,13m
9296,3,Namikaze,2168,607,22,21,43,51.2%,38m
9296,1,NicolasHao,2168,48,3,11,14,21.4%,16m
9296,1,드폰,2168,0,2,7,9,22.2%,13m
9300,3,[조재현동건]angarinda,2167,408,14,21,35,40.0%,38m
9300,3,[게임플레이]Who,2167,266,9,5,14,64.3%,18m
9300,3,dddd,2167,30,1,2,3,33.3%,38m
9303,3,고주형,2166,756,27,29,56,48.2%,17m
9303,3,NangB,2166,595,22,25,47,46.8%,17m
9303,2,그림톰,2166,182,5,10,15,33.3%,15m
9303,3,비빔면만들기,2166,79,3,5,8,37.5%,18m
9307,2,darkwhisper,2165,518,22,29,51,43.1%,19m
9307,3,로그아웃,2165,278,10,17,27,37.0%,17m
9307,3,ScumbagKai,2165,168,4,8,12,33.3%,38m
9310,2,여은향따먹기,2164,586,19,35,54,35.2%,19m
9310,3,한냥이,2164,420,15,25,40,37.5%,18m
9310,3,MST,2164,294,11,16,27,40.7%,18m
9310,3,fgewg,2164,331,11,18,29,37.9%,38m
9310,3,Frostfrozen,2164,0,0,5,5,0.0%,33m
9310,3,박상귕,2164,0,0,5,5,0.0%,18m
9316,3,jjk,2163,632,21,30,51,41.2%,33m
9316,2,강태공참치,2163,64,5,12,17,29.4%,39m
9316,3,小葉,2163,104,4,3,7,57.1%,18m
9316,3,[호박고구마]칠삼오유기,2163,0,0,1,1,0.0%,33m
9320,3,쿠키아빠,2162,60,3,4,7,42.9%,18m
9320,3,안녕하세요,2162,30,2,2,4,50.0%,18m
9320,3,파르티잔,2162,119,2,5,7,28.6%,18m
9323,3,BEARCHAN,2161,812,50,53,103,48.5%,18m
9323,3,캡틴프로,2161,198,8,12,20,40.0%,38m
9323,3,gunjang,2161,34,1,5,6,16.7%,33m
9323,3,잔기수리총,2161,0,0,1,1,0.0%,18m
9323,3,[맢레스토랑스]렙티노,2161,0,0,2,2,0.0%,38m
9323,3,Weiiiiiii,2161,0,0,5,5,0.0%,18m
9329,1,무적함대테란,2160,154,6,12,18,33.3%,12m
9330,3,아크트루스,2159,415,16,16,32,50.0%,38m
9330,3,[비트]ahjahahjah,2159,260,9,10,19,47.4%,33m
9330,2,얼티밋나이트,2159,175,5,9,14,35.7%,19m
9330,2,대한의건아,2159,135,3,10,13,23.1%,15m
9334,3,넘버,2158,282,11,12,23,47.8%,17m
9335,2,재부팅시도중,2157,714,25,39,64,39.1%,19m
9335,3,얼짱민정,2157,36,4,5,9,44.4%,15m
9335,3,[고구려만세]엔마아이,2157,0,0,2,2,0.0%,33m
9338,3,찰리진,2156,496,17,29,46,37.0%,17m
9338,3,KFC,2156,186,6,4,10,60.0%,18m
9338,3,RinI,2156,0,0,1,1,0.0%,17m
9338,2,wjdwodud,2156,0,0,1,1,0.0%,15m
9342,2,guardian,2155,362,12,26,38,31.6%,19m
9342,3,DarkKnight,2155,60,2,5,7,28.6%,18m
9342,3,임준호,2155,30,1,3,4,25.0%,18m
9345,3,kioh,2154,30,1,3,4,25.0%,17m
9346,2,PARADAXGUS,2153,436,15,21,36,41.7%,19m
9346,1,문준호,2153,326,12,17,29,41.4%,39m
9348,3,[DR]DEXTEROUS,2152,60,2,7,9,22.2%,38m
9349,2,考試中,2151,1160,42,60,102,41.2%,20m
9349,2,Achilles,2151,214,9,14,23,39.1%,11m
9349,3,myeunil,2151,60,2,11,13,15.4%,33m
9352,3,任豐,2150,278,10,13,23,43.5%,18m
9352,3,mwkk,2150,216,6,9,15,40.0%,18m
9352,3,에이스메츄리,2150,0,1,4,5,20.0%,38m
9355,1,cjeri,2149,38,1,4,5,20.0%,15m
9355,3,[DESU]theonlyleft,2149,0,0,2,2,0.0%,33m
9357,2,진환,2148,258,11,19,30,36.7%,19m
9357,3,[SlGN]priester,2148,0,1,0,1,100.0%,17m
9357,3,감자감자고구마,2148,95,1,4,5,20.0%,17m
9357,3,oasisgggg,2148,0,0,2,2,0.0%,17m
9357,3,일휘겜즈,2148,0,0,6,6,0.0%,18m
9362,1,jackpotaa,2147,486,18,31,49,36.7%,12m
9363,1,tiom,2146,218,6,13,19,31.6%,12m
9363,2,찬우바라기,2146,106,5,11,16,31.2%,19m
9363,3,근첩학살자,2146,88,4,3,7,57.1%,18m
9363,3,Zorg,2146,0,0,5,5,0.0%,18m
9367,3,qqq,2145,1022,43,51,94,45.7%,17m
9367,2,lTerryKl,2145,567,21,28,49,42.9%,39m
9367,2,frequency,2145,46,3,9,12,25.0%,15m
9367,2,amirhasan,2145,44,1,2,3,33.3%,15m
9367,3,Blake,2145,88,1,5,6,16.7%,18m
9372,3,Mirunamu,2144,192,6,4,10,60.0%,17m
9373,2,zhenxihuaxi,2143,185,6,11,17,35.3%,39m
9373,2,아르타니스,2143,88,2,3,5,40.0%,15m
9373,3,내꿈은타노스,2143,0,0,1,1,0.0%,14m
9373,3,kola,2143,0,0,5,5,0.0%,14m
9377,2,Kirito,2142,531,16,26,42,38.1%,38m
9377,3,얄라이뽕따이,2142,0,1,1,2,50.0%,17m
9377,3,賈斯丁,2142,0,1,2,3,33.3%,17m
9377,2,듀크,2142,0,0,4,4,0.0%,15m
9381,3,그래,2141,264,19,27,46,41.3%,17m
9381,3,존잘남재민,2141,38,2,5,7,28.6%,14m
9381,2,Muns,2141,0,0,1,1,0.0%,15m
9384,3,star,2140,1452,113,173,286,39.5%,18m
9384,3,빌딩마스터,2140,0,2,3,5,40.0%,38m
9386,3,김규민,2139,30,1,8,9,11.1%,18m
9386,3,나는브론즈다,2139,0,0,4,4,0.0%,18m
9388,3,Lewis,2138,130,3,8,11,27.3%,38m
9388,3,슬림즈,2138,0,1,0,1,100.0%,18m
9388,3,dma,2138,0,0,1,1,0.0%,38m
9391,1,디아볼릭,2137,165,10,16,26,38.5%,17m
9391,3,DiamondAnb,2137,182,6,13,19,31.6%,18m
9391,3,Ddeathgun,2137,0,1,5,6,16.7%,18m
9394,3,GrimReaper,2136,96,2,0,2,100.0%,18m
9394,1,llllllllll,2136,0,0,1,1,0.0%,15m
9396,3,그린,2135,0,0,3,3,0.0%,18m
9397,2,Maxxima,2134,1000,37,46,83,44.6%,20m
9397,2,꼭맞아,2134,500,17,28,45,37.8%,19m
9397,3,BINGO,2134,90,3,10,13,23.1%,17m
9397,3,gPike,2134,30,2,6,8,25.0%,18m
9397,3,떡밥,2134,0,0,3,3,0.0%,18m
9402,3,thank,2133,580,20,29,49,40.8%,18m
9402,2,shenyb,2133,128,8,15,23,34.8%,39m
9402,2,심장군,2133,163,4,9,13,30.8%,15m
9405,3,lllllllllll,2132,427,16,29,45,35.6%,19m
9405,3,hohoajum,2132,118,5,6,11,45.5%,17m
9405,3,Vincenthecat,2132,62,2,8,10,20.0%,18m
9405,3,ImForever,2132,0,0,2,2,0.0%,19m
9409,3,뽀뽀뽕,2131,0,1,1,2,50.0%,14m
9410,3,검은곰돌이,2130,583,19,28,47,40.4%,17m
9410,2,하하하하하,2130,138,6,8,14,42.9%,15m
9410,3,Gamemaster,2130,0,1,2,3,33.3%,18m
9410,3,[RELAK]qqq,2130,30,1,2,3,33.3%,18m
9410,3,묵은지활어초밥,2130,0,0,2,2,0.0%,18m
9415,1,dlwy,2129,346,14,29,43,32.6%,41m
9415,3,ehdehddi,2129,362,12,14,26,46.2%,17m
9415,3,REDLITE,2129,0,0,5,5,0.0%,14m
9418,3,매직테란,2128,423,15,24,39,38.5%,18m
9418,3,로얄드래곤,2128,126,6,11,17,35.3%,38m
9418,3,aaaa,2128,0,0,1,1,0.0%,18m
9418,3,체체체첼,2128,0,0,2,2,0.0%,18m
9418,3,Zlleterr,2128,0,0,3,3,0.0%,14m
9423,2,llllllllllll,2127,300,11,18,29,37.9%,38m
9423,3,wayne,2127,30,2,4,6,33.3%,17m
9423,3,침공,2127,0,0,1,1,0.0%,18m
9426,3,파워버섯,2126,285,10,10,20,50.0%,18m
9426,3,KhaliqR,2126,185,6,3,9,66.7%,18m
9426,3,개찐,2126,159,5,2,7,71.4%,18m
9426,3,dnjTmekdandy,2126,145,3,7,10,30.0%,18m
9430,3,roa,2125,191,9,17,26,34.6%,18m
9430,2,저거노트,2125,0,0,1,1,0.0%,15m
9432,2,MADAMADADANE,2124,1487,314,385,699,44.9%,19m
9432,3,jimlayer,2124,633,22,25,47,46.8%,18m
9432,3,cello,2124,502,18,25,43,41.9%,38m
9435,3,Neo,2123,862,34,43,77,44.2%,17m
9435,3,皇軍,2123,317,16,28,44,36.4%,18m
9435,3,Thukiko,2123,0,0,1,1,0.0%,14m
9435,3,Eclipse,2123,0,0,3,3,0.0%,38m
9439,3,johnwalker,2122,820,81,108,189,42.9%,18m
9439,2,JOKER,2122,1070,44,60,104,42.3%,19m
9439,3,무꽃,2122,74,3,3,6,50.0%,15m
9439,3,JDlove,2122,121,2,5,7,28.6%,38m
9439,3,Empire,2122,74,2,8,10,20.0%,33m
9444,3,우주헌터,2120,1088,39,51,90,43.3%,18m
9444,3,건전지사줘,2120,30,2,6,8,25.0%,38m
9444,3,GOTTX,2120,0,0,6,6,0.0%,33m
9447,2,넙치볶음,2119,96,2,9,11,18.2%,15m
9448,2,熱狗指揮官,2118,168,5,13,18,27.8%,15m
9448,3,echan,2118,0,1,5,6,16.7%,14m
9448,3,테란뉴클리얼,2118,0,0,2,2,0.0%,14m
9451,2,krvmswvfwgjd,2117,963,41,40,81,50.6%,20m
9451,3,한국사령부,2117,0,0,1,1,0.0%,14m
9453,3,小民,2116,94,5,8,13,38.5%,17m
9453,3,아바입니다,2116,122,3,2,5,60.0%,17m
9453,3,조은,2116,0,1,6,7,14.3%,14m
9453,1,Yuzz,2116,0,0,1,1,0.0%,16m
9457,2,gyubeom,2115,1480,134,173,307,43.6%,39m
9457,3,illinit,2115,556,20,31,51,39.2%,18m
9457,3,slick,2115,74,5,7,12,41.7%,18m
9457,1,중령진아이유,2115,48,3,11,14,21.4%,17m
9461,3,單純,2114,94,1,7,8,12.5%,17m
9462,3,신흥,2113,440,16,14,30,53.3%,18m
9462,3,Artanis,2113,18,2,3,5,40.0%,33m
9462,1,llllllllllll,2113,0,0,1,1,0.0%,16m
9465,1,lalrivunga,2111,299,7,17,24,29.2%,16m
9465,2,[CIA암살단]필름제트,2111,0,3,7,10,30.0%,19m
9465,3,옥휘찬,2111,0,1,1,2,50.0%,18m
9465,1,Player,2111,44,1,5,6,16.7%,16m
9469,1,asdfqwerghjk,2110,920,31,51,82,37.8%,12m
9469,3,[경찰과도둑]멜리오다스,2110,90,4,8,12,33.3%,18m
9469,1,Juny,2110,0,0,1,1,0.0%,15m
9472,3,[1324WE]SilverKT,2109,1183,48,66,114,42.1%,18m
9472,1,ArFang,2109,94,2,8,10,20.0%,15m
9474,2,Sky,2108,109,2,5,7,28.6%,15m
9475,3,일진,2107,182,7,11,18,38.9%,17m
9475,3,pop,2107,103,4,11,15,26.7%,18m
9475,3,Einar,2107,0,1,4,5,20.0%,14m
9478,3,니콜라테슬라,2106,30,1,9,10,10.0%,18m
9479,3,Spakol,2105,436,19,20,39,48.7%,38m
9479,3,RSP,2105,376,12,27,39,30.8%,18m
9481,1,꾀돌이,2104,1071,34,52,86,39.5%,39m
9481,3,[CIA암살단]생각의질서,2104,316,11,17,28,39.3%,18m
9481,1,로즈아멜리아,2104,234,7,17,24,29.2%,16m
9484,3,dsf,2103,116,5,6,11,45.5%,18m
9484,3,llllllllllll,2103,0,0,1,1,0.0%,15m
9486,1,himinwoo,2102,240,8,17,25,32.0%,15m
9486,3,[NoLate]곰탱이,2102,205,5,6,11,45.5%,18m
9486,2,Shiru,2102,94,2,8,10,20.0%,15m
9486,2,아우토반,2102,0,1,1,2,50.0%,15m
9486,3,아무거나,2102,30,1,6,7,14.3%,17m
9486,3,柚刃,2102,0,0,3,3,0.0%,18m
9492,2,Castiglione,2100,857,49,65,114,43.0%,20m
9492,3,[프로토스협회]손주할머니캐리,2100,641,24,37,61,39.3%,17m
9492,3,BiliBili,2100,267,8,21,29,27.6%,18m
9492,1,용깡,2100,226,6,3,9,66.7%,17m
9492,2,KingOfWar,2100,192,4,4,8,50.0%,15m
9492,1,Bon,2100,0,0,1,1,0.0%,15m
9498,2,Dalls,2099,0,1,2,3,33.3%,15m
9498,1,阿偉,2099,0,0,1,1,0.0%,17m
9498,3,발악의시작,2099,0,0,1,1,0.0%,33m
9498,1,방민수,2099,0,0,1,1,0.0%,16m
9502,1,TpeApple,2098,220,8,7,15,53.3%,17m
9502,3,awdsf,2098,42,1,1,2,50.0%,14m
9502,3,Helmes,2098,0,1,5,6,16.7%,38m
9505,3,XaTuKo,2096,60,3,7,10,30.0%,38m
9505,1,강경자,2096,0,2,3,5,40.0%,16m
9507,2,스타는공부겜,2095,277,9,12,21,42.9%,15m
9507,2,어떡해든됨,2095,139,3,9,12,25.0%,15m
9509,3,[국방부사서병]불고기소스,2094,571,23,23,46,50.0%,18m
9509,3,[별똥별]섹시보이,2094,172,6,10,16,37.5%,40m
9509,3,반짝반짝작은별,2094,186,6,11,17,35.3%,38m
9509,3,짱구,2094,70,2,7,9,22.2%,17m
9509,3,drplain,2094,0,0,1,1,0.0%,14m
9514,3,mapi,2093,348,12,21,33,36.4%,18m
9514,2,[망겜장인]허율호호,2093,157,4,11,15,26.7%,15m
9514,3,Harvest,2093,0,1,0,1,100.0%,14m
9514,3,DDOBAGI,2093,0,0,5,5,0.0%,14m
9518,3,SHIOTA,2091,88,4,6,10,40.0%,34m
9518,3,chad,2091,104,3,9,12,25.0%,14m
9518,3,[曼特雷中隊]SaintXiao,2091,0,0,1,1,0.0%,15m
9521,1,젤리나졸,2090,1530,637,749,1386,46.0%,13m
9521,3,능지부족,2090,88,3,10,13,23.1%,17m
9521,3,AquaMan,2090,0,1,5,6,16.7%,38m
9521,1,아르타니스,2090,0,0,1,1,0.0%,16m
9525,3,nicepooh,2089,1220,189,239,428,44.2%,14m
9525,3,[개복교]ceo,2089,798,58,78,136,42.6%,18m
9525,1,Strikerlay,2089,273,9,17,26,34.6%,16m
9525,1,아이어,2089,0,1,4,5,20.0%,16m
9529,3,모두를위한정의,2088,337,18,25,43,41.9%,18m
9529,2,쥬신,2088,174,3,7,10,30.0%,15m
9531,3,AUSCII,2087,286,21,27,48,43.8%,18m
9532,3,청주시민,2086,167,6,11,17,35.3%,18m
9532,3,BeatalL,2086,62,4,8,12,33.3%,18m
9532,1,Genetic,2086,0,1,0,1,100.0%,17m
9535,3,Milk,2085,164,5,5,10,50.0%,17m
9535,2,Lin,2085,130,3,5,8,37.5%,15m
9537,3,[000]阿布拉瓜,2084,338,12,21,33,36.4%,17m
9537,1,모르는사람,2084,239,6,15,21,28.6%,12m
9537,1,歐拉歐拉歐拉,2084,0,0,1,1,0.0%,16m
9537,3,googlethis,2084,0,0,6,6,0.0%,38m
9541,3,Teddy,2083,0,3,2,5,60.0%,33m
9541,3,인생무상,2083,60,3,10,13,23.1%,38m
9543,3,NSMaru,2081,1114,48,71,119,40.3%,18m
9543,3,Player,2081,178,6,15,21,28.6%,38m
9543,3,[아케더]한서선민,2081,97,2,10,12,16.7%,18m
9543,3,soso,2081,44,1,7,8,12.5%,33m
9547,2,설미호,2080,84,2,3,5,40.0%,15m
9547,2,Snek,2080,0,1,3,4,25.0%,15m
9549,3,스타해야지,2079,250,14,22,36,38.9%,18m
9549,1,스타실버,2079,138,3,6,9,33.3%,16m
9549,3,자낙,2079,0,1,1,2,50.0%,17m
9552,1,홍진원,2078,0,1,0,1,100.0%,17m
9553,2,shawn,2077,462,16,25,41,39.0%,39m
9553,3,신디케이트,2077,348,13,18,31,41.9%,38m
9553,3,싸울아비,2077,246,8,8,16,50.0%,18m
9553,1,atheory,2077,228,8,21,29,27.6%,40m
9553,1,고약한개구리,2077,0,0,1,1,0.0%,17m
9553,3,둥둥이,2077,0,0,1,1,0.0%,33m
9559,3,지을이름없어,2075,309,11,13,24,45.8%,38m
9559,3,snake,2075,0,1,1,2,50.0%,14m
9561,3,마세어,2074,954,38,45,83,45.8%,18m
9562,3,伐伐伐伐伐木工,2073,0,0,1,1,0.0%,14m
9562,3,WombatHouse,2073,0,0,2,2,0.0%,14m
9564,3,RokaCola,2072,30,2,7,9,22.2%,18m
9564,1,JJC,2072,0,0,1,1,0.0%,17m
9564,2,깡따,2072,0,0,6,6,0.0%,19m
9567,3,피볼까,2071,271,8,15,23,34.8%,18m
9567,1,SlipperyFate,2071,233,7,22,29,24.1%,16m
9569,3,[SolaC]국산스타크레프트,2070,308,11,12,23,47.8%,18m
9569,3,[어윤수님개쩜]공의가저죽여요,2070,139,3,8,11,27.3%,38m
9571,2,자아정체성,2069,1439,104,158,262,39.7%,20m
9571,2,LAPHRODITE,2069,1043,50,71,121,41.3%,20m
9573,3,대전이영호,2067,279,9,14,23,39.1%,18m
9573,1,dragun,2067,48,1,4,5,20.0%,17m
9575,1,barton,2066,660,15,21,36,41.7%,17m
9575,3,왕돼지,2066,145,4,13,17,23.5%,18m
9575,3,Eagles,2066,0,0,6,6,0.0%,38m
9578,2,狐媽,2065,1096,44,52,96,45.8%,20m
9578,1,ANA,2065,278,7,3,10,70.0%,16m
9578,3,Drims,2065,142,3,4,7,42.9%,18m
9578,1,ooo,2065,94,2,7,9,22.2%,16m
9582,3,cocoroko,2064,34,2,7,9,22.2%,14m
9583,1,JMoriarty,2063,0,0,1,1,0.0%,17m
9583,1,compalpippen,2063,0,0,5,5,0.0%,16m
9585,3,Egoist,2062,30,2,9,11,18.2%,38m
9586,3,bluemoby,2060,446,16,25,41,39.0%,17m
9586,2,천월패룡,2060,215,7,21,28,25.0%,38m
9586,1,[스2]정광영,2060,159,3,3,6,50.0%,17m
9589,3,hippro,2058,745,30,33,63,47.6%,17m
9589,1,MiRyunGomTan,2058,30,1,3,4,25.0%,17m
9589,1,Vaxus,2058,0,0,2,2,0.0%,16m
9592,2,GussoDDak,2057,62,2,9,11,18.2%,20m
9593,3,캐릭터,2056,279,9,10,19,47.4%,18m
9593,1,salchipapa,2056,0,0,3,3,0.0%,17m
9595,1,원더풀데이즈,2055,236,5,9,14,35.7%,17m
9595,1,GangnamStlye,2055,142,5,17,22,22.7%,17m
9597,1,쌔게해,2054,168,5,12,17,29.4%,12m
9597,1,SUNGD,2054,46,1,1,2,50.0%,16m
9597,3,PrimalManco,2054,0,1,6,7,14.3%,15m
9600,3,jinmyung,2053,0,1,4,5,20.0%,33m
9600,2,xinchao,2053,0,0,2,2,0.0%,15m
9602,3,[國本]현이,2052,1427,62,98,160,38.8%,18m
9602,1,[000]Limulus,2052,366,12,19,31,38.7%,40m
9604,3,힝힝흐엥,2051,286,10,15,25,40.0%,18m
9604,1,staples,2051,188,4,4,8,50.0%,16m
9606,1,전기기능장,2049,88,3,2,5,60.0%,16m
9607,1,ajtwoddl,2048,444,15,41,56,26.8%,12m
9607,1,나는승환,2048,0,3,2,5,60.0%,17m
9607,3,goodchoi,2048,97,1,2,3,33.3%,38m
9610,3,김형준,2047,365,12,17,29,41.4%,38m
9610,1,백호,2047,144,3,8,11,27.3%,17m
9612,3,jackykares,2046,322,13,17,30,43.3%,17m
9612,1,어둠의하이에나,2046,396,10,41,51,19.6%,40m
9612,3,승현,2046,88,2,4,6,33.3%,18m
9615,3,[sc2mc]cat,2045,1262,44,73,117,37.6%,38m
9615,2,wando,2045,1020,37,56,93,39.8%,39m
9617,1,drin,2044,401,11,21,32,34.4%,17m
9617,3,[TalenT]BronzeCat,2044,0,0,5,5,0.0%,14m
9617,2,紅茶,2044,0,0,5,5,0.0%,15m
9620,3,지금은사아,2043,436,16,23,39,41.0%,34m
9620,1,Atom,2043,48,1,4,5,20.0%,16m
9622,1,EMILUMA,2042,296,8,11,19,42.1%,17m
9622,1,평범한전쟁광,2042,214,5,3,8,62.5%,17m
9622,3,sOs,2042,72,2,10,12,16.7%,38m
9625,2,suyden,2041,194,5,7,12,41.7%,15m
9625,1,별천지,2041,0,1,0,1,100.0%,17m
9627,3,[재혁이에용]페실리움,2040,531,19,26,45,42.2%,18m
9627,1,ngothanhtung,2040,88,1,4,5,20.0%,16m
9629,1,해병의기묘한모험,2039,96,2,4,6,33.3%,17m
9630,3,마왕공손찬,2038,62,2,9,11,18.2%,18m
9630,3,DIEHARD,2038,0,0,1,1,0.0%,14m
9630,3,Rick,2038,0,0,3,3,0.0%,14m
9633,1,아이치킨,2037,284,6,8,14,42.9%,15m
9633,3,FlowerPower,2037,44,3,8,11,27.3%,14m
9635,1,[最後生還者]天之囚人,2036,268,6,9,15,40.0%,17m
9636,1,FLJW,2034,744,19,29,48,39.6%,16m
9637,3,deadatnight,2033,0,0,2,2,0.0%,33m
9638,2,Eric,2032,248,6,14,20,30.0%,15m
9639,1,colin,2031,48,1,3,4,25.0%,17m
9640,1,iwillkillyou,2030,1364,47,64,111,42.3%,12m
9641,1,하늘사랑,2029,467,18,15,33,54.5%,17m
9641,3,ISUpWONG,2029,0,1,0,1,100.0%,14m
9643,1,MRW,2028,0,0,5,5,0.0%,16m
9644,1,교회가신스님,2026,48,1,9,10,10.0%,16m
9644,3,[SKYYY]Ben,2026,0,0,1,1,0.0%,14m
9646,3,mrhong,2023,109,2,3,5,40.0%,18m
9646,3,[WYS]AURI,2023,0,0,2,2,0.0%,14m
9648,3,하엽,2022,628,22,38,60,36.7%,18m
9648,1,[NCF]크란이,2022,90,2,7,9,22.2%,17m
9648,1,llllllllllll,2022,73,0,2,2,0.0%,17m
9651,3,asahi,2020,326,10,20,30,33.3%,38m
9651,3,세주니스타,2020,96,1,5,6,16.7%,17m
9651,1,베이맥스,2020,0,0,6,6,0.0%,16m
9654,1,gksdbcks,2019,1190,41,69,110,37.3%,40m
9654,2,[ElsAna]초보입니다,2019,200,5,14,19,26.3%,15m
9654,3,호나우지뉴,2019,0,1,0,1,100.0%,14m
9654,1,봄사랑벚고박고,2019,0,1,4,5,20.0%,17m
9654,1,Vendetta,2019,0,0,1,1,0.0%,17m
9659,1,준스타,2018,114,3,6,9,33.3%,17m
9659,1,도라에몽,2018,0,0,1,1,0.0%,17m
9661,1,막강한엘프,2017,397,9,19,28,32.1%,16m
9661,1,kimhsbs,2017,132,3,10,13,23.1%,17m
9663,2,Hongcah,2014,1399,90,120,210,42.9%,20m
9663,1,LiNN,2014,174,4,4,8,50.0%,16m
9663,1,ZXPro,2014,182,4,4,8,50.0%,17m
9666,1,[REGENO]andidedy,2011,0,0,2,2,0.0%,16m
9667,3,aitan,2009,447,16,29,45,35.6%,34m
9667,2,KeeeeTeeeee,2009,406,13,26,39,33.3%,19m
9667,1,upanddown,2009,200,7,11,18,38.9%,16m
9670,1,Lawracz,2008,688,18,37,55,32.7%,16m
9670,2,Raintwogi,2008,228,9,17,26,34.6%,39m
9670,1,아르타니스,2008,0,0,2,2,0.0%,17m
9673,3,[NGNLZ]seankeke,2007,1085,78,92,170,45.9%,18m
9673,1,[삼국시대]Heder,2007,1192,33,63,96,34.4%,17m
9673,1,rkrkqkswja,2007,0,4,3,7,57.1%,17m
9676,3,NATFA,2006,64,4,6,10,40.0%,33m
9676,3,[그시절의]인체해부학,2006,0,1,0,1,100.0%,14m
9678,1,Rulsan,2005,1614,42,93,135,31.1%,17m
9678,1,llllllllllll,2005,224,5,13,18,27.8%,17m
9678,2,쇼핑,2005,0,0,4,4,0.0%,15m
9681,1,한국사람,2004,654,16,21,37,43.2%,16m
9682,3,Polyko,2003,919,32,60,92,34.8%,17m
9682,1,히든,2003,284,8,16,24,33.3%,15m
9682,3,스타킹님,2003,58,3,9,12,25.0%,38m
9682,1,[별똥별]그기서그기,2003,0,2,11,13,15.4%,17m
9686,3,김도훈,2001,0,1,1,2,50.0%,14m
9687,1,흑마법사,1999,215,8,19,27,29.6%,16m
9687,3,장개구리,1999,190,7,17,24,29.2%,18m
9687,1,Skyrider,1999,262,6,14,20,30.0%,17m
9687,3,好煩,1999,0,0,2,2,0.0%,33m
9687,3,래그,1999,0,0,3,3,0.0%,33m
9692,1,skfnxh,1998,152,4,12,16,25.0%,17m
9693,2,불신,1996,0,1,9,10,10.0%,39m
9693,1,jambo,1996,0,0,2,2,0.0%,17m
9695,1,폭풍의암살자,1993,804,19,31,50,38.0%,17m
9695,1,이시국씨,1993,96,2,3,5,40.0%,17m
9695,3,BLWH,1993,30,1,8,9,11.1%,19m
9695,3,Radical,1993,0,0,3,3,0.0%,14m
9699,3,노틀담의춘향,1992,0,0,6,6,0.0%,14m
9700,3,aaa,1991,546,20,24,44,45.5%,17m
9700,3,[anime]zdgzdgyet,1991,164,4,8,12,33.3%,14m
9700,1,여보세요,1991,48,2,0,2,100.0%,17m
9700,1,GuavaJuice,1991,0,0,2,2,0.0%,16m
9704,3,뱁세오,1990,0,0,6,6,0.0%,14m
9705,1,[2005]사이언스,1989,0,0,2,2,0.0%,17m
9706,3,스피커,1987,30,1,1,2,50.0%,34m
9707,3,[랜타디광]엠생,1986,0,1,4,5,20.0%,14m
9708,1,하푸하푸,1985,170,5,10,15,33.3%,17m
9708,1,sadafsayeed,1985,96,2,5,7,28.6%,17m
9708,3,카일문,1985,30,2,6,8,25.0%,34m
9711,3,Schumakay,1984,0,0,1,1,0.0%,15m
9712,3,KKKK,1982,0,0,4,4,0.0%,15m
9713,1,反正我信了,1981,0,1,0,1,100.0%,17m
9714,1,가람,1979,396,10,12,22,45.5%,17m
9715,1,prc,1978,0,0,1,1,0.0%,16m
9716,1,junsu,1977,1207,167,220,387,43.2%,12m
9716,3,中意,1977,1410,50,81,131,38.2%,39m
9716,1,냉탕상어,1977,691,16,29,45,35.6%,16m
9719,3,rtertertert,1976,1424,69,110,179,38.5%,17m
9719,2,erew,1976,254,8,17,25,32.0%,39m
9719,2,ToTo,1976,96,3,13,16,18.8%,15m
9722,1,GoldApple,1974,90,2,2,4,50.0%,16m
9722,3,SCAVE,1974,0,1,1,2,50.0%,15m
9724,3,Zerg,1972,0,0,6,6,0.0%,14m
9725,2,[싱싱한뉴비]llllllllllll,1971,0,0,2,2,0.0%,15m
9726,1,GOOD,1970,565,15,29,44,34.1%,17m
9726,3,jidh,1970,68,2,6,8,25.0%,34m
9728,1,지존,1969,92,3,6,9,33.3%,17m
9728,1,댕댕,1969,0,0,1,1,0.0%,17m
9730,3,跑得快,1968,1431,212,342,554,38.3%,18m
9730,1,멀꼴아바,1968,1585,46,73,119,38.7%,17m
9730,1,Wolfdreicht,1968,476,12,17,29,41.4%,16m
9730,1,아오성철아모하냐,1968,46,2,2,4,50.0%,17m
9734,1,Todayiswendy,1967,291,8,24,32,25.0%,17m
9735,3,막강한자,1966,166,8,15,23,34.8%,18m
9735,1,왕달팽이,1966,90,2,4,6,33.3%,16m
9737,1,joker,1965,0,0,6,6,0.0%,17m
9738,1,[삼시를살려요]다혈질,1964,514,13,22,35,37.1%,16m
9738,1,cerapina,1964,48,2,4,6,33.3%,17m
9738,1,청월,1964,0,0,2,2,0.0%,17m
9741,1,chlwjdals,1963,128,4,5,9,44.4%,17m
9741,1,카우보이,1963,48,2,0,2,100.0%,17m
9741,1,리시빙해방,1963,0,1,2,3,33.3%,17m
9741,2,Asimoteu,1963,0,1,7,8,12.5%,39m
9745,3,JohnLin,1961,1067,51,77,128,39.8%,18m
9745,1,[싸이클론장인]MARC,1961,0,1,1,2,50.0%,17m
9745,1,[벨튀입니다]야생의은재몬,1961,0,0,2,2,0.0%,17m
9748,3,goldbar,1960,0,1,5,6,16.7%,15m
9749,3,InTheSPACE,1958,0,0,6,6,0.0%,34m
9750,1,천공의화신,1957,826,21,34,55,38.2%,16m
9750,1,셜록겜즈,1957,562,16,32,48,33.3%,17m
9752,3,Alphscan,1956,30,4,5,9,44.4%,14m
9753,1,NEO,1955,1154,31,44,75,41.3%,17m
9753,1,Xall,1955,290,8,13,21,38.1%,17m
9753,3,Jopam,1955,30,3,8,11,27.3%,34m
9753,1,시언,1955,0,0,6,6,0.0%,17m
9757,1,새우유나,1954,48,2,0,2,100.0%,16m
9757,1,청바지,1954,48,1,4,5,20.0%,16m
9759,1,kfhdngxkhvj,1952,88,3,1,4,75.0%,16m
9760,3,buccoar,1950,1382,82,113,195,42.1%,18m
9760,2,그랜드또또,1950,515,16,30,46,34.8%,39m
9760,1,ckcapt,1950,0,0,4,4,0.0%,17m
9763,2,구급공무원,1949,1122,53,96,149,35.6%,45m
9763,3,[000]scopex,1949,585,19,32,51,37.3%,18m
9763,1,瑒瑒,1949,512,12,16,28,42.9%,16m
9766,1,셰프도현,1948,120,2,6,8,25.0%,17m
9767,2,원규밴스,1947,230,9,16,25,36.0%,39m
9767,3,魏小虎,1947,30,3,4,7,42.9%,14m
9767,1,제우스핑,1947,44,1,6,7,14.3%,17m
9770,1,인사안하면우모,1945,42,1,5,6,16.7%,17m
9770,2,용기병,1945,0,1,8,9,11.1%,20m
9772,3,마지노선,1944,1373,44,76,120,36.7%,17m
9772,1,kknd,1944,166,6,14,20,30.0%,16m
9772,3,宏大政明,1944,42,1,9,10,10.0%,15m
9775,2,적토마,1943,376,13,27,40,32.5%,39m
9776,3,머리조심,1942,46,1,4,5,20.0%,14m
9777,3,ALIF,1941,162,5,13,18,27.8%,14m
9778,1,스타초보,1940,329,10,19,29,34.5%,16m
9778,3,cho,1940,0,1,0,1,100.0%,14m
9780,1,왕철이,1939,142,3,4,7,42.9%,17m
9781,1,Anguschen,1937,1734,141,255,396,35.6%,16m
9781,1,[참돔]demonskill,1937,48,3,19,22,13.6%,17m
9781,3,RRoni,1937,0,1,8,9,11.1%,18m
9784,1,AYANASIA,1936,0,0,2,2,0.0%,16m
9785,3,Brotoss,1935,1132,100,163,263,38.0%,18m
9785,1,salesking,1935,458,12,18,30,40.0%,17m
9785,3,[000]十四,1935,225,6,15,21,28.6%,18m
9788,3,周天子,1930,1397,87,130,217,40.1%,18m
9788,1,Jeonwj,1930,44,2,2,4,50.0%,16m
9790,1,프랑스,1929,167,2,8,10,20.0%,17m
9791,3,[Grubby]FlameoN,1927,178,6,12,18,33.3%,18m
9792,3,rIcArD,1923,154,6,16,22,27.3%,18m
9793,3,foonyon,1922,1108,36,69,105,34.3%,18m
9793,3,심하은,1922,97,1,8,9,11.1%,38m
9793,1,KEPO,1922,0,0,1,1,0.0%,17m
9796,2,척후경,1921,0,1,4,5,20.0%,15m
9797,1,안녕,1918,0,0,4,4,0.0%,16m
9798,3,가오,1916,86,5,6,11,45.5%,34m
9799,3,NeptuniaLake,1914,60,2,11,13,15.4%,34m
9799,1,UNDISPUTED,1914,73,0,2,2,0.0%,17m
9801,1,sTarFR,1912,0,1,9,10,10.0%,17m
9802,1,tjaksehd,1911,0,1,6,7,14.3%,17m
9802,1,바람의아들,1911,0,0,1,1,0.0%,16m
9804,3,학문의끝,1909,689,24,46,70,34.3%,18m
9804,3,Kowlskiboss,1909,0,0,7,7,0.0%,14m
9806,1,tessadar,1908,440,16,21,37,43.2%,17m
9806,1,Adrenaline,1908,298,7,10,17,41.2%,16m
9808,1,[NCF]Crankit,1907,1231,45,63,108,41.7%,17m
9808,1,지옥에서온아롬,1907,0,0,1,1,0.0%,17m
9810,3,[龍虎]검호,1905,0,1,1,2,50.0%,14m
9811,1,泰瑞,1904,121,3,0,3,100.0%,16m
9812,2,woojoo,1903,94,2,4,6,33.3%,15m
9813,3,IILHYHL,1902,0,1,9,10,10.0%,15m
9813,3,IlIlIlllIIlI,1902,0,0,2,2,0.0%,14m
9815,3,명냥룡즈,1901,0,0,2,2,0.0%,34m
9816,1,Luna,1898,73,0,8,8,0.0%,17m
9817,3,masterlee,1895,0,1,8,9,11.1%,18m
9818,1,미생완생,1894,46,1,2,3,33.3%,16m
9819,1,LETO,1893,1677,60,85,145,41.4%,17m
9820,3,곰칭이,1892,116,4,11,15,26.7%,14m
9821,1,玉米,1889,351,12,13,25,48.0%,17m
9822,3,스커운,1887,0,0,2,2,0.0%,15m
9823,3,내뒤에사탕,1886,169,5,10,15,33.3%,18m
9823,1,oihiuhi,1886,0,0,1,1,0.0%,17m
9825,3,RickyMY,1885,0,1,10,11,9.1%,38m
9826,3,rickj,1884,1402,152,229,381,39.9%,17m
9826,1,이종원,1884,90,4,3,7,57.1%,16m
9828,3,padman,1880,0,0,1,1,0.0%,14m
9828,1,loloyeeyee,1880,0,0,8,8,0.0%,17m
9830,3,苍天,1878,119,3,9,12,25.0%,18m
9831,1,[아케더]바람,1876,175,4,6,10,40.0%,17m
9832,1,龍魂,1874,73,1,1,2,50.0%,17m
9833,1,카미신,1870,102,3,6,9,33.3%,17m
9834,2,[異界的檢察官]醜海綿,1865,0,0,1,1,0.0%,15m
9835,1,gvfgvjh,1863,73,1,3,4,25.0%,17m
9836,1,섭섭이,1861,0,0,2,2,0.0%,17m
9836,1,스타는어려워,1861,0,0,4,4,0.0%,17m
9838,1,奇犽,1859,758,23,35,58,39.7%,17m
9839,1,kingkong,1857,46,1,5,6,16.7%,16m
9840,2,真命天子,1853,1266,61,128,189,32.3%,19m
9841,2,趙子龍,1852,88,6,18,24,25.0%,39m
9842,1,죠리퐁,1846,0,1,2,3,33.3%,16m
9843,3,마린충,1845,38,1,10,11,9.1%,34m
9843,3,지호아빠,1845,0,0,2,2,0.0%,34m
9845,1,asaf,1844,121,1,9,10,10.0%,16m
9846,3,ASOP,1842,70,3,12,15,20.0%,14m
9846,1,whdqo,1842,0,0,2,2,0.0%,16m
9848,3,포세이돈,1838,1032,83,119,202,41.1%,17m
9849,1,라케리아,1837,1821,69,118,187,36.9%,16m
9850,2,너니너너,1835,0,1,4,5,20.0%,15m
9851,2,wutom,1834,118,3,3,6,50.0%,15m
9852,1,herO,1830,128,2,12,14,14.3%,16m
9852,2,[CIA암살단]ggah,1830,0,0,2,2,0.0%,15m
9854,1,스키드,1829,372,10,25,35,28.6%,16m
9855,1,[이주호다]protossing,1827,42,1,7,8,12.5%,16m
9856,2,ollie,1823,0,0,1,1,0.0%,15m
9857,1,OldGuy,1821,630,16,30,46,34.8%,17m
9858,2,mong,1820,0,0,1,1,0.0%,15m
9859,2,어리러운도적,1818,48,2,5,7,28.6%,15m
9860,2,[銅牌上不去]IIIIIIIIIIII,1811,0,0,1,1,0.0%,15m
9861,3,더킹,1809,785,136,187,323,42.1%,17m
9862,1,patino,1805,90,2,8,10,20.0%,16m
9863,1,앙까까띠,1804,519,14,20,34,41.2%,16m
9864,2,shawn,1798,65,2,7,9,22.2%,15m
9865,2,[sc2mc]엠씨다크맨,1795,0,0,3,3,0.0%,15m
9866,2,djrollroll,1790,219,5,21,26,19.2%,15m
9867,1,[정치공학]carmack,1789,142,3,11,14,21.4%,17m
9868,2,spacer,1786,0,2,4,6,33.3%,16m
9869,2,마우스사왔어요,1785,42,1,10,11,9.1%,15m
9870,1,왕국,1784,162,10,22,32,31.2%,17m
9870,2,할수있다,1784,164,3,12,15,20.0%,15m
9872,2,할할할,1768,0,1,0,1,100.0%,15m
9873,2,사괴수,1765,116,4,11,15,26.7%,15m
9874,2,정오범,1762,0,0,1,1,0.0%,16m
9875,2,피닉스,1759,0,1,5,6,16.7%,16m
9876,2,advick,1757,290,9,20,29,31.0%,15m
9877,3,ZERO,1755,0,0,1,1,0.0%,14m
9878,2,雷小州,1753,48,1,1,2,50.0%,15m
9879,1,[머구폐렴]달선,1748,1046,27,57,84,32.1%,16m
9880,2,PowerMoveR,1743,0,0,5,5,0.0%,15m
9881,1,별의기원을찾아서,1737,44,1,10,11,9.1%,17m
9882,1,Newbie,1735,1368,267,357,624,42.8%,13m
9883,1,天安門事態,1731,1244,85,158,243,35.0%,16m
9883,3,루카엘라,1731,30,2,7,9,22.2%,14m
9885,2,[NighT1]진형,1724,0,0,1,1,0.0%,15m
9886,2,암캐,1713,73,0,5,5,0.0%,15m
9887,1,seongood,1711,1187,34,77,111,30.6%,16m
9888,2,sdett,1710,274,6,18,24,25.0%,16m
9888,3,이강준병신새,1710,30,1,10,11,9.1%,34m
9890,3,[환상향]Mush,1705,0,0,1,1,0.0%,14m
9891,1,dtuioiru,1704,344,12,30,42,28.6%,16m
9892,1,YES,1701,90,3,7,10,30.0%,17m
9893,2,대충지은닉넴,1695,400,9,31,40,22.5%,16m
9894,2,[CIA암살단]석한님,1693,44,1,11,12,8.3%,15m
9895,3,CommanderJj,1692,0,0,6,6,0.0%,15m
9896,2,[너의ol름은]Jady,1690,236,8,20,28,28.6%,15m
9897,1,살짝도른년,1687,1500,47,107,154,30.5%,17m
9897,3,시운디,1687,60,2,8,10,20.0%,34m
9899,2,raulacedo,1686,88,1,13,14,7.1%,15m
9900,2,Izza,1677,562,17,46,63,27.0%,15m
9901,3,[별똥별]드디어성공이다,1674,0,0,1,1,0.0%,34m
9902,2,[우모자공화국]루나공주,1673,0,0,4,4,0.0%,15m
9903,2,Happy,1669,0,1,1,2,50.0%,15m
9904,3,inken,1663,58,2,15,17,11.8%,15m
9905,1,도령님,1661,1721,59,152,211,28.0%,17m
9906,2,MAS,1659,884,26,63,89,29.2%,15m
9907,1,스타세끼,1635,0,0,12,12,0.0%,17m
9908,2,[TTM]kris,1622,44,1,8,9,11.1%,15m
9909,1,jack,1602,94,2,14,16,12.5%,16m
9910,3,[항상준비됐다]레이너특공대,1568,30,1,7,8,12.5%,15m
9911,3,TONG,1567,48,2,2,4,50.0%,34m
9912,2,밥운,1565,480,12,44,56,21.4%,15m
9913,3,starcraf,1559,0,0,1,1,0.0%,14m
9914,2,[krtag]디바왜불러,1553,892,27,72,99,27.3%,15m
9915,2,코네,1531,150,4,11,15,26.7%,15m
9916,3,Joker,1422,0,0,1,1,0.0%,34m
