rank,tier,name,mmr,points,wins,losses,played,winrate,age
1,1,[TeamNV]sOs,6085,1530,41,23,64,64.1%,7m
2,1,[인투더]TYTY,5782,0,0,2,2,0.0%,6m
3,3,[GdAT]GyulzzinG,5656,0,1,0,1,100.0%,11m
4,3,oGsForGG,5593,0,1,1,2,50.0%,8m
5,1,[Rush]黑羽快斗,5515,814,27,28,55,49.1%,3m
6,1,llllllllllll,5508,0,3,2,5,60.0%,5m
7,1,llllllllllll,5505,269,9,7,16,56.2%,7m
8,1,[CIM]데스윙,5464,3111,470,375,845,55.6%,3m
9,1,[KRisEZ]NORTHAMERICA,5410,0,1,0,1,100.0%,7m
10,1,llllllllllII,5354,352,16,12,28,57.1%,7m
11,1,llllllllllll,5332,124,2,9,11,18.2%,5m
12,1,Rex,5324,366,9,9,18,50.0%,3m
13,1,[고외몽메타몽]앵무,5314,179,6,5,11,54.5%,6m
14,3,llllllllllll,5294,195,6,2,8,75.0%,3m
15,2,[푸른장미]llllllllllll,5238,0,0,1,1,0.0%,10m
16,2,Emotion,5232,6,2,0,2,100.0%,10m
17,2,[NCCU]ParalyzeD,5231,0,1,0,1,100.0%,10m
18,2,Moroha,5201,0,3,2,5,60.0%,7m
19,2,[인투더]IntoTheJung,5146,174,10,6,16,62.5%,10m
20,2,[원피스]이준상조오옷,5126,486,33,19,52,63.5%,7m
21,2,[인투더]IntoTheOb,5107,178,11,2,13,84.6%,7m
22,2,llllllllllll,5094,1798,151,143,294,51.4%,10m
23,2,EsC,5068,122,8,10,18,44.4%,7m
24,1,[세미레전드]하니,5041,494,28,38,66,42.4%,3m
25,1,llllllllllll,5030,40,1,15,16,6.2%,5m
26,2,[푸른장미]Skewed,5027,103,4,2,6,66.7%,7m
27,2,lIIlllIlllII,5000,28,2,4,6,33.3%,10m
28,1,안정인,4996,281,10,14,24,41.7%,3m
29,1,llllllllllll,4990,144,5,10,15,33.3%,3m
30,3,[TeamGP]Sandcastle,4954,0,0,1,1,0.0%,8m
31,3,[야근싫어요]llllllllllll,4952,0,1,0,1,100.0%,3m
32,3,llllllllllll,4948,351,13,11,24,54.2%,6m
33,2,llllllllllll,4940,14,4,5,9,44.4%,10m
34,3,[TeamGP]LunaSea,4915,232,20,21,41,48.8%,3m
35,3,[무한오영종]Americano,4893,589,39,7,46,84.8%,9m
36,3,llllllllllll,4892,4,1,3,4,25.0%,8m
37,3,[테란저그토스]포도,4884,0,3,2,5,60.0%,6m
38,3,[Primer]Plan,4882,0,0,1,1,0.0%,3m
39,3,[NGameS]새드엔딩,4872,392,41,33,74,55.4%,8m
40,3,COSMOS,4865,2076,118,121,239,49.4%,8m
41,3,master,4847,297,10,5,15,66.7%,6m
42,3,[TalenT]SuperJGL,4845,445,65,33,98,66.3%,10m
43,3,llllllll,4842,0,3,2,5,60.0%,6m
44,2,[VVDY]llllllllllll,4839,2341,916,868,1784,51.3%,10m
45,3,lIIIlIlIllII,4831,343,16,12,28,57.1%,8m
46,3,[ReV]Con,4788,2,1,1,2,50.0%,3m
47,3,공유기,4785,26,6,6,12,50.0%,11m
48,3,[NsP]HeART,4780,145,3,2,5,60.0%,8m
49,3,SlayersDuker,4779,1314,186,168,354,52.5%,10m
50,1,milkyway,4775,307,8,7,15,53.3%,6m
51,3,IIIlllIIIllI,4770,317,14,7,21,66.7%,8m
52,3,[ELS]안정인,4762,0,3,3,6,50.0%,11m
53,3,[NGameS]조선명기,4740,610,53,38,91,58.2%,11m
54,1,[Dopen]CarGO,4734,164,3,4,7,42.9%,3m
55,1,[TeamGP]EunkOng,4730,378,8,6,14,57.1%,5m
56,1,[무한오영종]한남들의나라,4688,968,21,15,36,58.3%,8m
56,1,llllllllllll,4688,648,16,11,27,59.3%,3m
58,1,magicpants,4666,96,2,5,7,28.6%,8m
59,1,llllllllllll,4665,0,1,0,1,100.0%,9m
60,3,[CyaN]Apfel,4662,115,6,10,16,37.5%,11m
61,2,[NDW]Drima,4660,0,1,0,1,100.0%,4m
62,1,[TeamNV]프로토스,4656,936,21,15,36,58.3%,7m
63,1,[고졸테란]HonMonO,4636,0,1,0,1,100.0%,5m
64,1,speaknow,4618,96,7,3,10,70.0%,5m
65,1,[인투더]IntoTheBest,4617,0,0,1,1,0.0%,4m
66,1,[쇄국정책]Sylvanas,4615,0,4,1,5,80.0%,3m
67,2,LastHerO,4614,0,0,3,3,0.0%,7m
68,2,IIIIlllllIII,4610,116,7,2,9,77.8%,8m
69,1,[무한오영종]Origin,4607,0,1,0,1,100.0%,3m
70,1,IIIlIIllIIII,4603,214,6,6,12,50.0%,5m
71,2,[Old]computer,4602,0,0,3,3,0.0%,7m
72,3,Astharos,4598,440,111,107,218,50.9%,11m
73,1,[낭낭하게]Wade,4596,284,7,4,11,63.6%,6m
73,2,[Yisc]Heavenly,4596,177,5,3,8,62.5%,8m
75,3,IlllllIIIlll,4594,1927,491,495,986,49.8%,10m
76,1,asdfsdf,4593,815,31,6,37,83.8%,4m
77,1,[애니멀킹덤]KIMOCHI,4579,0,1,0,1,100.0%,3m
78,3,[무한오영종]불꽃,4567,1494,83,74,157,52.9%,8m
78,1,[도리]DangRyubi,4567,0,0,1,1,0.0%,4m
80,3,[李至安]이지안,4562,91,48,58,106,45.3%,3m
81,1,Fighter,4540,696,17,11,28,60.7%,7m
82,1,[박용직]박용직,4537,144,4,2,6,66.7%,4m
82,2,[이터널]송병구,4537,38,2,0,2,100.0%,7m
84,1,Ramdom,4531,144,4,2,6,66.7%,4m
85,1,Deneb,4518,476,11,23,34,32.4%,4m
86,1,[무한오영종]남훈이,4517,1296,53,51,104,51.0%,5m
87,1,[ANGG]매실,4512,410,12,17,29,41.4%,6m
88,2,Illlllllllll,4502,0,1,0,1,100.0%,8m
88,1,미친불곰,4502,0,1,1,2,50.0%,4m
90,1,[IWYDI]janyrWYD,4490,474,14,18,32,43.8%,6m
91,1,IIIIIIIIII,4488,1026,25,23,48,52.1%,9m
92,1,[데하카세]데하카세,4484,612,35,32,67,52.2%,5m
93,1,무적엘지,4479,0,1,0,1,100.0%,8m
94,1,[러비]슬기,4471,1520,92,96,188,48.9%,5m
95,1,llllllllllll,4460,1034,24,29,53,45.3%,9m
96,1,말타는희선,4458,1518,63,53,116,54.3%,7m
97,1,항공작전사령부,4442,376,8,10,18,44.4%,3m
97,1,[이터널]RealMadrid,4442,102,2,4,6,33.3%,5m
99,1,Ive,4427,166,4,1,5,80.0%,4m
100,1,[ELS]EunkOng,4423,1948,55,60,115,47.8%,4m
101,1,[WDY]맨날짐,4421,2088,166,180,346,48.0%,4m
102,1,hest,4419,584,14,17,31,45.2%,4m
103,3,사막여우,4414,0,2,0,2,100.0%,3m
104,1,[패자는피를]랜덤,4412,0,0,1,1,0.0%,5m
105,1,[CryANT]성벽,4411,88,2,3,5,40.0%,3m
106,3,甯采臣,4408,58,5,3,8,62.5%,4m
107,1,문재인,4407,1568,68,64,132,51.5%,7m
108,1,[勇敢正义部队]克哈的天黑了,4404,138,4,1,5,80.0%,5m
109,1,llllIlll,4402,452,10,16,26,38.5%,4m
110,1,안영이,4401,242,7,7,14,50.0%,5m
110,1,llllllllllll,4401,46,2,1,3,66.7%,7m
112,1,[잘생긴]동이,4399,352,16,6,22,72.7%,8m
113,1,[정말데단해]딸기냠냠,4395,429,10,9,19,52.6%,7m
113,1,[겨울방어]파워업각성콩벌레,4395,0,1,3,4,25.0%,5m
115,1,Dreamtmicky,4392,0,1,2,3,33.3%,7m
116,1,[무한오영종]건들면뒤진다,4385,1314,52,45,97,53.6%,8m
117,1,lIIIllIlIIl,4384,0,1,0,1,100.0%,5m
118,1,afsd,4383,408,21,5,26,80.8%,4m
119,1,[SofT]멜론화채,4382,0,0,2,2,0.0%,5m
120,1,FlowerRain,4379,0,0,2,2,0.0%,7m
121,1,[GSTCLW]你好,4376,499,23,7,30,76.7%,3m
122,1,Dyun,4374,320,12,8,20,60.0%,7m
123,1,llllllllll,4368,914,23,31,54,42.6%,5m
124,1,NewStar,4367,0,0,1,1,0.0%,5m
125,1,[큐티섹시]미나사나모모쯔위,4366,186,5,4,9,55.6%,9m
126,1,[겨울방어]육식남,4362,321,13,6,19,68.4%,5m
127,1,[Ato]해물비빔소스도둑,4349,474,12,11,23,52.2%,5m
127,1,[원피스]황형,4349,0,1,1,2,50.0%,9m
129,1,[NEX]EverMahA,4343,1946,119,112,231,51.5%,7m
130,1,[프종빨]트웰비엄마,4338,1040,35,33,68,51.5%,3m
130,1,KeNkEn,4338,950,27,28,55,49.1%,4m
132,1,[BrnzeH]Winter,4336,190,5,8,13,38.5%,3m
133,2,[Ato]맨날짐,4330,398,20,4,24,83.3%,4m
134,1,김재규선생님,4315,2001,266,266,532,50.0%,4m
135,3,엄여인,4314,1036,251,255,506,49.6%,6m
135,2,Phive,4314,0,0,3,3,0.0%,7m
137,2,IIIIIIII,4311,416,12,13,25,48.0%,10m
138,2,[공주님문재앙]StarScream,4305,0,1,1,2,50.0%,4m
139,2,[어윤수준우승]누가연속준우승함,4303,42,2,0,2,100.0%,7m
140,2,[CIM]와기,4302,70,3,6,9,33.3%,6m
141,2,[모두하나인숲]집정관,4301,0,1,1,2,50.0%,5m
142,1,[무한오영종]어령렬,4300,1957,188,199,387,48.6%,4m
142,1,[CIM]OptBnKSJ,4300,1126,153,162,315,48.6%,5m
144,2,[NTUeS]Ren,4299,108,3,5,8,37.5%,4m
145,2,IIIIIIIIIIII,4297,38,2,0,2,100.0%,10m
146,2,인공지능,4296,36,4,2,6,66.7%,7m
147,2,Expire,4292,0,1,1,2,50.0%,9m
148,2,llllllllllll,4291,0,1,0,1,100.0%,7m
149,2,Medic,4287,0,0,1,1,0.0%,8m
150,1,IlIllIIlIIll,4283,861,32,38,70,45.7%,7m
151,2,llllllllllll,4280,32,2,0,2,100.0%,8m
152,2,MOPP,4274,0,0,2,2,0.0%,3m
153,1,[유튜브에링스]llllllllllll,4272,239,7,13,20,35.0%,7m
154,2,[리니지폐인]데스나이트,4271,380,13,9,22,59.1%,10m
154,3,MINHTHUHAI,4271,0,1,0,1,100.0%,3m
156,2,[아다치]하루까,4268,132,6,4,10,60.0%,3m
157,1,겸허,4264,404,10,15,25,40.0%,7m
158,2,Mochaholic,4262,0,1,0,1,100.0%,10m
159,2,[Lotuz]Ruid,4259,273,10,10,20,50.0%,6m
160,1,즐겜유저,4257,1927,137,145,282,48.6%,5m
161,2,llllllllllll,4255,70,2,4,6,33.3%,8m
162,1,[애니멀킹덤]원숭이,4253,284,6,10,16,37.5%,4m
163,2,Vertex,4251,200,9,5,14,64.3%,10m
164,3,沉默之星,4237,0,1,0,1,100.0%,4m
165,3,SKYBTT,4236,0,1,0,1,100.0%,9m
165,2,[Rush]BluERush,4236,0,1,3,4,25.0%,3m
165,2,Masamune,4236,0,0,2,2,0.0%,7m
168,1,Creation,4230,1622,109,124,233,46.8%,4m
168,2,[트위치리피아]리피아,4230,0,0,1,1,0.0%,10m
170,2,[RESCUE]모노쿠마,4227,413,15,11,26,57.7%,7m
170,2,[WDY]Maddox,4227,0,0,1,1,0.0%,7m
172,2,ludex,4222,282,10,10,20,50.0%,8m
173,1,[光復香港]時代革命,4214,0,1,1,2,50.0%,8m
174,2,胖王,4213,124,5,3,8,62.5%,6m
175,2,Hermit,4204,0,0,1,1,0.0%,8m
176,2,[Lotuz]짝부랄,4199,116,4,2,6,66.7%,4m
177,2,[여단]페트로시안,4195,1600,77,73,150,51.3%,8m
177,2,[안성짱]안세짱,4195,945,38,33,71,53.5%,7m
179,2,[GAM]LFG,4194,428,16,11,27,59.3%,8m
180,2,Dissa,4189,276,9,13,22,40.9%,3m
181,2,[무한오영종]주종없음,4184,120,4,4,8,50.0%,4m
182,2,IIIIIIIIIIII,4178,1280,50,49,99,50.5%,8m
183,1,[NGameS]Auto,4177,1349,51,57,108,47.2%,9m
184,1,[말뫼FF]말뫼,4176,309,17,17,34,50.0%,9m
185,2,CHICHARITO,4167,66,3,4,7,42.9%,5m
185,2,Mimesis,4167,0,0,1,1,0.0%,10m
187,1,[무한오영종]염전,4165,1769,212,235,447,47.4%,4m
188,1,IllllIlllI,4162,1534,47,57,104,45.2%,5m
189,2,[WDY]Sydney,4157,32,1,1,2,50.0%,10m
190,2,[WTSC]육식남,4156,0,1,0,1,100.0%,10m
191,2,현자,4155,1373,122,122,244,50.0%,3m
191,3,xiyentaiku,4155,249,8,7,15,53.3%,10m
191,2,MVP,4155,140,5,1,6,83.3%,8m
194,2,Jazzer,4154,0,0,4,4,0.0%,8m
195,2,병든햄스터,4153,1575,67,71,138,48.6%,4m
195,2,군번줄,4153,30,2,0,2,100.0%,4m
195,2,LawLiet,4153,0,0,2,2,0.0%,10m
198,3,llllllllllll,4148,30,1,6,7,14.3%,8m
199,2,mothership,4146,0,0,1,1,0.0%,3m
200,2,OBsTiNatE,4141,370,13,14,27,48.1%,5m
201,2,BEN,4140,176,8,2,10,80.0%,10m
202,2,llllllllllll,4137,192,13,22,35,37.1%,10m
203,3,[아다치]터치,4134,122,4,5,9,44.4%,10m
204,2,Zerg,4132,62,2,3,5,40.0%,9m
205,2,USuckS,4127,90,3,4,7,42.9%,8m
205,2,우지한,4127,73,1,6,7,14.3%,10m
207,2,[무한오영종]lIlIlIlIlIlI,4126,114,5,6,11,45.5%,7m
207,2,[CrewGP]반짝이,4126,98,4,1,5,80.0%,10m
207,2,llllllllllll,4126,88,1,2,3,33.3%,5m
210,2,freeny,4125,58,2,2,4,50.0%,6m
211,2,[너의ol름은]IllIIIllllII,4124,0,0,1,1,0.0%,10m
212,2,jhgshaikw,4114,1585,300,295,595,50.4%,5m
212,2,팔십사년생이다,4114,30,1,3,4,25.0%,10m
214,2,[FoIIow]TOPopular,4110,0,1,0,1,100.0%,4m
215,1,llllllll,4109,0,0,1,1,0.0%,5m
216,2,kenosis,4105,247,10,4,14,71.4%,10m
217,2,두루미횡격막,4104,58,2,1,3,66.7%,10m
218,2,IIIIIIIIIIII,4103,30,2,0,2,100.0%,8m
219,2,토스,4102,0,0,1,1,0.0%,4m
219,2,[한발이면]뿔뿔이,4102,0,0,1,1,0.0%,9m
221,2,MyNameAlice,4097,375,15,7,22,68.2%,5m
221,2,TerATo,4097,0,0,1,1,0.0%,5m
223,2,[小妖怪]含羞草,4096,518,17,18,35,48.6%,8m
224,2,KIMMINYOUNG,4094,70,2,2,4,50.0%,3m
225,2,llllllllllll,4093,1566,145,108,253,57.3%,7m
225,2,[CIM]GATTON,4093,92,3,4,7,42.9%,5m
227,2,[Master]마귀,4092,0,1,0,1,100.0%,9m
228,2,TerATo,4087,0,1,0,1,100.0%,5m
229,2,NONstope,4086,518,25,34,59,42.4%,6m
230,2,[PANG]푸른들,4082,0,0,1,1,0.0%,7m
231,2,[WTSC]니가왜거기서나와,4080,1525,410,420,830,49.4%,7m
232,2,eTerNity,4077,0,1,0,1,100.0%,4m
233,2,Lustt,4076,58,2,3,5,40.0%,10m
234,2,Tasty,4075,66,2,2,4,50.0%,5m
235,2,[SofT]무작위,4072,312,12,10,22,54.5%,3m
236,2,ballyFoX,4066,112,2,1,3,66.7%,4m
237,2,절막만지셧잖아요,4064,274,9,12,21,42.9%,10m
237,3,눈사람,4064,30,2,0,2,100.0%,6m
239,2,[Lotuz]클라스차이,4062,86,4,1,5,80.0%,9m
240,2,[oIo]SpecialDra,4060,410,22,29,51,43.1%,6m
241,1,[어짜피제가짐]구왁안되,4058,1078,105,118,223,47.1%,7m
241,2,InnoVatioN,4058,627,25,19,44,56.8%,8m
243,2,[Basic]MaEsTrO,4057,0,1,0,1,100.0%,5m
243,2,[Dopen]Bolloong,4057,0,0,1,1,0.0%,7m
245,1,Mynasty,4052,1638,174,186,360,48.3%,4m
246,2,[oNs7]버로닷,4048,218,8,5,13,61.5%,10m
247,2,IIIIIIIIIIII,4047,0,0,2,2,0.0%,5m
248,2,llllllllllll,4046,978,118,127,245,48.2%,7m
248,2,SHOW,4046,746,28,31,59,47.5%,8m
250,2,[ANGG]Tada,4045,206,5,4,9,55.6%,3m
250,2,전기기술사따자,4045,58,3,1,4,75.0%,7m
252,2,[s2Mc]산소,4044,1555,200,210,410,48.8%,8m
253,1,IIIIIIIIII,4043,1644,129,137,266,48.5%,5m
254,3,[BRNZ]Newbie,4042,170,5,2,7,71.4%,6m
255,2,[허대영]호일,4041,60,2,2,4,50.0%,7m
255,2,llllllllllll,4041,0,0,1,1,0.0%,9m
257,2,llllllllllll,4040,1252,47,46,93,50.5%,4m
258,1,신민아,4036,96,3,2,5,60.0%,8m
258,2,lIIllIIllllI,4036,30,2,0,2,100.0%,6m
260,2,[GIS]Recall,4035,0,1,0,1,100.0%,6m
261,2,Kyuri,4033,1576,269,264,533,50.5%,3m
262,2,KTHopE,4029,1236,48,47,95,50.5%,7m
263,2,CICERoBUST,4028,1320,69,57,126,54.8%,7m
263,2,[sc2mc]arnold,4028,0,0,1,1,0.0%,10m
265,2,Mercury,4027,270,13,7,20,65.0%,7m
266,2,[인투더]IntoTheSHSH,4026,90,4,3,7,57.1%,10m
266,2,llllllllll,4026,0,2,3,5,40.0%,11m
268,2,[SofT]반짝이,4024,303,12,3,15,80.0%,6m
269,2,MarineKing,4021,240,9,12,21,42.9%,3m
270,2,llllllllllll,4012,0,0,3,3,0.0%,9m
270,2,IIlllllllIl,4012,0,0,4,4,0.0%,9m
272,2,Physical,4009,30,1,1,2,50.0%,3m
273,2,[NTUeS]Chino,4007,0,4,1,5,80.0%,7m
274,2,論論,4006,0,1,0,1,100.0%,3m
275,2,[Dopen]RoyaL,4005,0,1,0,1,100.0%,9m
276,2,[前無後無]BIOTECH,4004,0,1,1,2,50.0%,3m
276,3,아이린,4004,0,0,1,1,0.0%,2m
278,2,新心手,4002,30,1,6,7,14.3%,9m
279,2,미친고양이,4001,0,0,1,1,0.0%,4m
280,2,알렉스,4000,1097,103,98,201,51.2%,3m
281,2,GGplay,3997,128,3,6,9,33.3%,6m
281,2,Maru,3997,90,3,11,14,21.4%,8m
283,2,[Lotuz]허리케인최,3995,1535,184,198,382,48.2%,10m
283,3,[NDW]AresRush,3995,0,1,4,5,20.0%,11m
283,2,잭다니엘,3995,0,0,1,1,0.0%,3m
286,2,llllllllll,3993,202,11,4,15,73.3%,5m
287,2,RIPoForEveR,3990,1552,135,133,268,50.4%,8m
287,2,스투리,3990,0,1,3,4,25.0%,10m
289,2,Persona,3989,435,49,46,95,51.6%,10m
289,2,Anais,3989,0,0,1,1,0.0%,11m
291,2,거세송아지,3988,30,1,4,5,20.0%,8m
292,2,자유의심장,3983,1548,98,101,199,49.2%,9m
292,2,머슬몬스터,3983,30,4,4,8,50.0%,3m
294,1,[무한오영종]김치,3981,0,0,1,1,0.0%,7m
295,2,AvglE,3977,377,15,11,26,57.7%,10m
296,2,ONGGAMENET,3975,828,77,69,146,52.7%,8m
297,2,봄비,3974,58,3,1,4,75.0%,4m
298,2,Roke,3971,30,1,2,3,33.3%,6m
299,2,IIIIIII,3963,1499,149,142,291,51.2%,5m
299,2,타우린,3963,0,1,0,1,100.0%,8m
299,2,[얼라이브]Sasin,3963,0,0,1,1,0.0%,7m
299,2,[시럽]LunaK,3963,0,0,1,1,0.0%,6m
299,2,IIIIIIIIIIII,3963,0,0,2,2,0.0%,8m
304,2,SteveIrwin,3957,1178,52,39,91,57.1%,5m
304,2,[트위치리피아]주님한명또갑니다,3957,360,20,6,26,76.9%,5m
306,2,[랜덤한테왜짐]integralidi,3956,0,1,1,2,50.0%,9m
306,2,IIIIIIIIIIII,3956,0,0,3,3,0.0%,7m
308,2,슈퍼초보,3954,230,9,4,13,69.2%,10m
308,2,돈내놔,3954,0,0,1,1,0.0%,7m
310,2,foREVer,3951,0,4,1,5,80.0%,4m
311,2,아빠타,3948,1575,525,483,1008,52.1%,10m
311,2,무밍,3948,0,1,0,1,100.0%,10m
313,2,조땡,3935,419,21,10,31,67.7%,9m
314,3,tada,3927,466,18,5,23,78.3%,3m
315,2,이민호,3926,0,2,4,6,33.3%,8m
316,3,MELLITUS,3923,250,8,2,10,80.0%,4m
317,1,손흥만,3922,1698,585,613,1198,48.8%,3m
317,3,[유레루]무유,3922,30,2,0,2,100.0%,10m
317,2,soulmate,3922,60,2,5,7,28.6%,5m
320,2,상너무님,3921,782,28,41,69,40.6%,7m
320,2,IIIIIIIIIIII,3921,118,5,5,10,50.0%,8m
320,2,TYTY,3921,0,0,2,2,0.0%,4m
323,2,IIIIIIIIIIII,3919,1531,217,207,424,51.2%,5m
324,2,거품이글스,3918,533,29,13,42,69.0%,3m
325,2,인공지능,3917,1545,270,259,529,51.0%,8m
326,2,[프로야근러]할짓없다,3913,0,1,1,2,50.0%,9m
327,2,벨해브,3912,148,5,8,13,38.5%,3m
327,3,[Equal]HeePang,3912,30,1,2,3,33.3%,3m
329,3,똥배,3911,626,24,18,42,57.1%,10m
329,3,김또이,3911,0,1,0,1,100.0%,6m
331,3,허댕,3910,0,0,1,1,0.0%,3m
332,3,[이터널]연겜만한다,3909,327,12,12,24,50.0%,6m
332,3,[CranKy]Aires,3909,30,2,8,10,20.0%,10m
334,2,보헤미안,3907,1578,166,151,317,52.4%,8m
335,2,flksdjgdsklg,3906,0,2,5,7,28.6%,7m
336,3,Chroma,3904,0,0,1,1,0.0%,3m
336,3,[20]PeRcEnT,3904,0,0,2,2,0.0%,7m
338,3,[국가정보원]테스토스테란,3903,0,2,3,5,40.0%,10m
339,2,[Sett]Alarak,3901,778,36,24,60,60.0%,5m
339,3,DynamicGiMiL,3901,333,15,5,20,75.0%,7m
341,2,[Master]Stephanos,3899,1507,247,248,495,49.9%,10m
342,3,Kissmyass,3898,380,14,6,20,70.0%,8m
343,3,Chobo,3897,58,4,3,7,57.1%,3m
344,2,[PKERSe]안양꽁치,3896,1503,173,165,338,51.2%,8m
344,3,[xTMDx]LOTTO,3896,0,4,1,5,80.0%,2m
346,3,개미하루,3893,465,18,19,37,48.6%,10m
347,3,[원빈]원빈처럼고수처럼,3892,0,0,1,1,0.0%,5m
348,2,SKTelecom,3891,558,30,15,45,66.7%,7m
349,3,Jaesung,3887,58,2,1,3,66.7%,10m
350,3,[각종사전]한국어사전,3884,0,1,1,2,50.0%,9m
350,3,[수고하세요]바로완치됬습니다,3884,0,0,1,1,0.0%,3m
352,2,[ELS]question,3883,935,47,58,105,44.8%,10m
352,2,[Aster]손요공,3883,30,1,6,7,14.3%,8m
354,2,[Beast]Antoinette,3881,182,11,2,13,84.6%,5m
355,3,KKooM,3878,244,8,10,18,44.4%,8m
356,3,DAVICHI,3871,118,5,4,9,55.6%,11m
357,3,[國本]BattleCruser,3865,30,4,2,6,66.7%,8m
357,3,[ELS]빵꾸똥꾸,3865,0,1,0,1,100.0%,3m
359,1,다레기는재밌어,3864,96,2,5,7,28.6%,7m
360,2,llllllllllll,3856,948,50,39,89,56.2%,10m
361,3,[프로야근러]TeRRy,3854,0,2,3,5,40.0%,6m
362,3,MrPiccolo,3853,314,12,10,22,54.5%,3m
363,3,[NGameS]MaChine,3851,817,30,25,55,54.5%,9m
363,3,IIIIIIII,3851,97,2,0,2,100.0%,6m
365,3,ahdwja,3850,537,21,11,32,65.6%,9m
365,3,[Mist]phantom,3850,0,1,0,1,100.0%,5m
367,2,[인정]llllllllllll,3849,1403,168,162,330,50.9%,8m
367,3,[프사기박멸중]맹독충버프필수,3849,0,1,0,1,100.0%,5m
369,3,[Ruby]슈드,3848,0,0,1,1,0.0%,6m
370,3,WsS,3847,0,3,2,5,60.0%,8m
370,3,[허수연이루다]Lily,3847,0,1,0,1,100.0%,5m
372,3,쿠에웨에엑,3846,0,0,2,2,0.0%,11m
373,3,와디더,3840,146,7,8,15,46.7%,10m
374,3,[패자는피를]블랜드,3838,30,1,2,3,33.3%,11m
375,3,[Dopen]라르고,3837,0,0,1,1,0.0%,10m
376,2,Felix,3836,0,3,5,8,37.5%,11m
377,2,백령해병,3834,1126,48,55,103,46.6%,6m
378,2,쥐티,3833,1107,235,233,468,50.2%,6m
378,3,SKYSword,3833,0,1,0,1,100.0%,7m
378,3,Pringles,3833,30,1,4,5,20.0%,5m
378,3,[TMAbly]Fox,3833,0,0,1,1,0.0%,6m
382,2,[최희]쿠센이,3832,1555,112,108,220,50.9%,8m
383,3,nowhereman,3829,242,10,4,14,71.4%,3m
384,2,[Tyler]최강가츠,3827,774,32,30,62,51.6%,7m
385,2,[어윤수님개쩜]캡틴티모나루,3825,118,4,16,20,20.0%,5m
385,3,oooooooooo,3825,0,0,1,1,0.0%,3m
387,3,[CIM]구리입니다,3822,140,6,0,6,100.0%,5m
387,3,히소기,3822,30,1,3,4,25.0%,10m
389,2,[教我玩蟲族l]松島楓本人,3821,507,24,32,56,42.9%,6m
389,3,쉬메일,3821,226,12,5,17,70.6%,4m
391,3,비누맛사탕,3818,131,5,3,8,62.5%,5m
391,3,tomorrow,3818,0,0,3,3,0.0%,7m
393,3,wowesr,3817,30,1,1,2,50.0%,2m
394,2,llllllllllll,3816,144,5,7,12,41.7%,9m
395,2,prisiz,3815,1452,166,168,334,49.7%,9m
396,2,너를꿈꾸며,3813,268,12,2,14,85.7%,11m
396,1,Kal,3813,0,0,2,2,0.0%,9m
398,3,llllllllllll,3811,0,0,1,1,0.0%,9m
399,3,드랍해도아낙네,3808,0,4,1,5,80.0%,8m
400,3,BSI,3804,949,120,99,219,54.8%,3m
401,3,[FRSHKR]ilililililil,3800,58,7,0,7,100.0%,3m
402,3,robert,3798,791,68,60,128,53.1%,2m
402,3,DiviNe,3798,0,0,1,1,0.0%,5m
404,3,Kommt,3796,0,0,2,2,0.0%,3m
405,3,llll,3793,30,1,1,2,50.0%,6m
406,3,StripClub,3792,60,2,2,4,50.0%,9m
406,3,llllllllllll,3792,30,1,1,2,50.0%,2m
408,3,딧션,3790,40,6,1,7,85.7%,11m
409,3,Harenix,3789,1480,117,117,234,50.0%,5m
410,3,[SofT]ENE,3788,0,1,0,1,100.0%,9m
411,2,Disaster,3786,239,11,5,16,68.8%,8m
411,3,llllllllllll,3786,0,1,0,1,100.0%,9m
411,3,[무한오영종]chovy,3786,0,0,1,1,0.0%,10m
414,3,브릉이,3785,44,2,1,3,66.7%,8m
414,3,[TITSQ]AprilRyanTT,3785,0,1,0,1,100.0%,10m
416,1,[엔타로연합]미륵관심법궁예,3782,829,120,149,269,44.6%,9m
417,2,MILDEOM,3779,984,39,45,84,46.4%,4m
418,3,[NaNoom]머이카노,3778,62,2,6,8,25.0%,3m
419,2,羅慕路斯,3775,1501,150,166,316,47.5%,7m
419,3,VanDH,3775,952,37,31,68,54.4%,6m
421,1,김종욱,3773,0,4,1,5,80.0%,52m
422,3,Absolute,3772,222,8,9,17,47.1%,9m
423,2,[xIMx]KrisxBell,3771,636,86,72,158,54.4%,10m
423,3,VoidRay,3771,0,0,1,1,0.0%,3m
425,3,Kluivert,3769,261,12,2,14,85.7%,3m
426,3,UrAnus,3766,30,2,1,3,66.7%,3m
426,3,독고탁,3766,0,0,1,1,0.0%,11m
428,3,[조누]조선누룽지,3765,0,0,1,1,0.0%,9m
429,3,[NGNLZ]小周,3761,0,0,2,2,0.0%,2m
430,3,호두고양이,3759,768,31,26,57,54.4%,3m
431,3,대군주가안뽑아져,3758,1353,81,81,162,50.0%,6m
432,3,CooooooooooL,3757,90,4,5,9,44.4%,7m
433,2,무작위,3755,1265,92,78,170,54.1%,9m
434,2,[무한오영종]견과믹스,3754,559,27,42,69,39.1%,11m
435,3,IIIIIIIIIIII,3753,88,4,2,6,66.7%,2m
436,3,[엔타로연합]스투해서인생망침,3752,0,1,0,1,100.0%,4m
437,3,COVIDforever,3750,176,7,6,13,53.8%,7m
438,3,Berserk,3749,0,1,0,1,100.0%,10m
439,3,[얍삽하게]박건용,3748,1141,90,67,157,57.3%,3m
439,3,lIIlIIllIIIl,3748,197,8,7,15,53.3%,11m
441,3,엔젤리,3745,0,4,1,5,80.0%,8m
442,3,[Abyss]NickeL,3744,507,37,28,65,56.9%,5m
443,2,[pepsl]찡찡,3743,398,14,19,33,42.4%,5m
444,3,[엔타로연합]호야고나,3740,0,0,3,3,0.0%,4m
445,2,초짜,3739,777,44,54,98,44.9%,10m
445,3,ZergTP,3739,30,2,0,2,100.0%,11m
447,3,제동신,3738,0,0,2,2,0.0%,9m
448,3,[우유통]왕수박,3736,374,12,28,40,30.0%,9m
449,3,IIIIIo,3734,713,51,50,101,50.5%,3m
449,2,붕여킹,3734,845,40,55,95,42.1%,8m
451,3,[s2Mc]종나인,3733,30,1,4,5,20.0%,10m
452,3,욤욤이,3731,1158,131,122,253,51.8%,5m
453,3,무작위,3730,30,1,3,4,25.0%,10m
454,2,worryburry,3727,1204,394,386,780,50.5%,9m
454,3,Aicoo,3727,114,4,3,7,57.1%,3m
454,3,사숙해,3727,0,0,1,1,0.0%,5m
457,3,부리부리꿀꿀,3723,30,2,0,2,100.0%,7m
458,3,[GIS]Prz,3722,233,7,3,10,70.0%,7m
459,3,Desolator,3721,0,0,1,1,0.0%,10m
460,3,초보,3720,492,25,7,32,78.1%,10m
461,3,구공쌍탄,3718,989,81,82,163,49.7%,8m
461,3,[Lotuz]엠빼롱,3718,0,1,1,2,50.0%,6m
463,3,골대풀,3717,0,0,1,1,0.0%,2m
464,3,기생충마냐,3715,1110,92,74,166,55.4%,6m
464,3,덤벼라세상아,3715,30,1,1,2,50.0%,11m
466,3,[국방부사서병]피터팬,3714,0,2,3,5,40.0%,3m
466,3,저글링,3714,0,0,1,1,0.0%,10m
468,3,llllllllll,3713,668,31,39,70,44.3%,5m
468,3,Thanatos,3713,170,6,13,19,31.6%,3m
468,3,llllllllllll,3713,0,0,1,1,0.0%,11m
471,3,테란,3710,888,34,39,73,46.6%,10m
471,3,CounterATK,3710,0,0,1,1,0.0%,5m
473,3,Sorrow,3708,277,16,10,26,61.5%,10m
473,3,[IWYD2I]HeroKingFIRE,3708,0,0,2,2,0.0%,3m
475,2,[인성터진]Blinker,3707,376,13,30,43,30.2%,8m
476,3,으악디졋으,3706,30,2,3,5,40.0%,6m
477,3,success,3704,30,1,3,4,25.0%,3m
477,3,Nikoboko,3704,30,1,4,5,20.0%,10m
479,3,llllllllllll,3702,58,3,5,8,37.5%,9m
479,3,[시럽]Respect,3702,0,0,1,1,0.0%,10m
481,3,OneofThree,3701,386,17,9,26,65.4%,9m
482,3,엠제이,3700,1132,49,33,82,59.8%,6m
483,3,[인생무상]앰생,3698,0,1,1,2,50.0%,3m
484,3,IIIIIIIIIIII,3697,684,30,20,50,60.0%,8m
484,3,[RMT]Adept,3697,0,1,0,1,100.0%,9m
486,1,무사지심,3695,298,32,67,99,32.3%,4m
487,3,약탈자,3694,0,0,2,2,0.0%,10m
488,3,OLOI,3691,1539,436,396,832,52.4%,9m
488,3,[NEX]PunchLine,3691,90,3,7,10,30.0%,7m
490,3,나루실리,3688,1518,261,258,519,50.3%,3m
490,3,무패신화,3688,1560,197,186,383,51.4%,3m
490,3,무간도,3688,1070,57,34,91,62.6%,10m
493,3,IIIIIIIIIIII,3686,0,0,1,1,0.0%,3m
494,1,WOONGJINvGP,3682,146,4,2,6,66.7%,7m
494,3,saber,3682,0,1,0,1,100.0%,8m
496,3,[GLTeam]粉色珍珠音調,3681,170,13,3,16,81.2%,8m
496,3,곧긔,3681,0,0,1,1,0.0%,10m
498,3,PoohSik,3678,30,1,5,6,16.7%,9m
499,3,돌아누워,3677,58,3,1,4,75.0%,10m
499,3,Inoculated,3677,0,0,1,1,0.0%,3m
501,3,[도담이]과염소산암모늄,3676,209,7,5,12,58.3%,3m
502,3,COCACOLA,3675,397,14,20,34,41.2%,2m
502,3,[부듀]부천시맹독충,3675,0,0,1,1,0.0%,9m
504,3,옥수수화염차,3674,60,3,3,6,50.0%,3m
505,1,허공에이엠피,3673,234,10,7,17,58.8%,7m
506,3,jnprotoss,3672,30,1,1,2,50.0%,7m
507,3,llllllllllll,3668,1211,61,63,124,49.2%,5m
507,3,IIIIIIIIllll,3668,90,3,6,9,33.3%,3m
509,3,[NGameS]NoiD,3666,116,4,7,11,36.4%,5m
509,3,[오영종플레이]오루비루스,3666,90,3,7,10,30.0%,5m
511,3,Seriously,3665,1502,218,210,428,50.9%,2m
511,1,asdf,3665,166,8,1,9,88.9%,51m
513,3,[XYFANS]Tossdaddy,3662,560,80,64,144,55.6%,3m
513,3,ChampionSoo,3662,1423,76,60,136,55.9%,10m
515,1,PostPD,3660,0,0,1,1,0.0%,8m
516,3,[어윤수님개쩜]잉여포격기,3658,0,2,3,5,40.0%,2m
516,3,Liberty,3658,0,1,0,1,100.0%,4m
518,3,llllllllllll,3657,852,69,22,91,75.8%,2m
518,3,IlllIllllllI,3657,0,0,1,1,0.0%,3m
518,3,백승호,3657,0,0,1,1,0.0%,11m
518,3,[G20]푸틴,3657,0,0,1,1,0.0%,9m
522,3,[섹시아재]아빠멩스크,3654,60,3,2,5,60.0%,10m
523,2,llllllllllll,3653,1533,132,131,263,50.2%,5m
523,3,sctrash,3653,952,57,20,77,74.0%,11m
523,3,llllllllllII,3653,148,6,3,9,66.7%,9m
526,3,kdh,3652,0,3,2,5,60.0%,3m
527,3,None,3651,509,19,14,33,57.6%,6m
528,3,[플토쌉극혐]lIlIlIl,3650,30,1,1,2,50.0%,3m
529,2,llllllllllll,3649,0,2,1,3,66.7%,53m
530,2,kjwtenic,3648,0,2,3,5,40.0%,53m
531,3,兔耳猴猴,3647,1222,104,91,195,53.3%,5m
532,3,[WDY]Merry,3646,0,0,1,1,0.0%,10m
533,3,[Cla1st]프로토스,3644,793,230,230,460,50.0%,9m
533,1,[이터널]강백호,3644,97,2,6,8,25.0%,3m
535,3,여섯시내고환,3641,0,3,2,5,60.0%,6m
536,2,[엔에스]남탱이,3639,1528,237,233,470,50.4%,10m
537,3,[아프리카청춘]뾱뾱이,3637,1525,209,205,414,50.5%,10m
538,3,[뿌까]jjtjdwns,3636,1511,326,327,653,49.9%,6m
538,3,[Dopen]공대오지마,3636,256,9,10,19,47.4%,11m
538,3,[우한폐렴]닦가슴살,3636,0,0,1,1,0.0%,5m
541,1,[TalenT]掃地僧,3634,0,0,1,1,0.0%,5m
542,3,IIIIIIIII,3632,153,5,0,5,100.0%,9m
542,1,무작위,3632,0,1,1,2,50.0%,51m
542,3,Minions,3632,0,0,1,1,0.0%,8m
545,3,Queenzbeat,3630,0,5,0,5,100.0%,10m
546,3,IIIIIIIIIIII,3628,1402,79,86,165,47.9%,11m
547,3,탕팡이,3627,913,55,44,99,55.6%,9m
547,3,[WTSC]리젖문,3627,0,0,1,1,0.0%,3m
549,2,똥을먹는다,3625,1320,56,59,115,48.7%,7m
549,3,lllIIIlll,3625,0,1,0,1,100.0%,7m
551,3,치킹,3624,236,9,10,19,47.4%,2m
552,3,정글쥬스,3623,60,3,3,6,50.0%,9m
552,3,강원도,3623,0,1,0,1,100.0%,11m
554,3,IIIIIIIIII,3621,402,15,12,27,55.6%,11m
554,3,검은시소,3621,0,1,0,1,100.0%,5m
554,3,[용강]JOO,3621,0,0,2,2,0.0%,2m
557,3,Envy,3619,0,1,0,1,100.0%,11m
557,3,서울사는여자에요,3619,0,0,5,5,0.0%,3m
559,3,[네임]ZawszeInLove,3615,0,0,1,1,0.0%,10m
560,3,[中国混蛋名单]天安门大屠杀,3614,254,10,9,19,52.6%,5m
561,3,虛無飄渺,3613,30,6,1,7,85.7%,3m
562,3,[LF]BlueBlack,3612,67,3,2,5,60.0%,4m
563,2,동석군,3611,1482,165,161,326,50.6%,7m
564,3,[시럽]Assassin,3609,577,24,13,37,64.9%,10m
564,3,[NGameS]교복소녀티아라,3609,0,1,0,1,100.0%,5m
566,3,CoolLuck,3607,1535,269,257,526,51.1%,2m
566,3,awu,3607,323,12,5,17,70.6%,8m
568,3,푸굽다튀기기,3605,0,0,1,1,0.0%,3m
568,3,사우스파크,3605,0,0,2,2,0.0%,6m
570,3,초코샌드,3603,0,0,1,1,0.0%,3m
571,3,IIIIIIIIIIII,3602,270,13,6,19,68.4%,7m
571,3,IIIIIIIIIIII,3602,316,10,20,30,33.3%,2m
571,3,無可奉告,3602,0,1,0,1,100.0%,3m
571,3,llllllllllll,3602,0,0,1,1,0.0%,3m
575,3,니미,3601,1572,98,82,180,54.4%,9m
575,3,금강불괴,3601,563,23,22,45,51.1%,8m
577,2,Anthony,3597,1247,140,148,288,48.6%,7m
578,3,llllllllllll,3592,96,3,3,6,50.0%,10m
579,3,이지희,3591,480,16,21,37,43.2%,3m
580,3,TireMiLun,3589,0,0,3,3,0.0%,3m
581,3,아름다운우리강산,3587,0,0,2,2,0.0%,9m
582,3,GwANgRaN,3586,118,4,6,10,40.0%,9m
582,3,잭다니엘,3586,58,3,2,5,60.0%,6m
584,3,후라이드,3585,542,61,59,120,50.8%,9m
584,3,lIlIIIllIIIl,3585,94,5,1,6,83.3%,8m
586,3,easybot,3584,0,0,1,1,0.0%,9m
587,2,[환상향]Mush,3583,0,0,1,1,0.0%,52m
588,3,EOEJEOEJ,3581,408,15,12,27,55.6%,9m
589,3,IIIIIIIIIII,3580,660,46,43,89,51.7%,10m
589,3,송군,3580,119,2,1,3,66.7%,9m
589,3,Rose,3580,0,0,1,1,0.0%,8m
592,3,MicroAngelo,3579,346,16,10,26,61.5%,2m
592,3,MinTChoCo,3579,86,4,3,7,57.1%,5m
592,3,[임갓의추종자]무적의임레기,3579,30,2,0,2,100.0%,3m
595,3,[NerfZg]Aguero,3578,90,4,3,7,57.1%,8m
596,3,llllllllllll,3577,422,21,21,42,50.0%,5m
597,3,JUNE,3576,60,2,7,9,22.2%,7m
597,3,SoulKnix,3576,30,1,3,4,25.0%,3m
599,3,[예쁜김다미]스타,3575,1494,175,180,355,49.3%,3m
599,3,Lyon,3575,30,3,5,8,37.5%,9m
601,3,Pandemonium,3573,116,4,4,8,50.0%,8m
601,3,안녕반가워얘들아,3573,0,0,1,1,0.0%,7m
603,3,하루카,3570,0,1,4,5,20.0%,9m
604,3,[청초]ALCA,3568,1242,52,46,98,53.1%,6m
604,3,부랑자다,3568,30,2,4,6,33.3%,9m
606,3,소리없는유오성,3567,349,12,9,21,57.1%,7m
606,3,대략신입,3567,0,0,1,1,0.0%,9m
608,3,iathsdeia,3565,553,20,18,38,52.6%,7m
608,3,北條悟史,3565,0,0,1,1,0.0%,2m
610,3,노재능,3563,578,23,17,40,57.5%,5m
610,3,Gate,3563,434,16,10,26,61.5%,3m
610,3,Akaza,3563,0,2,3,5,40.0%,3m
610,3,lIlIIlIIIIII,3563,0,0,5,5,0.0%,9m
614,3,Cosmos,3561,0,3,2,5,60.0%,3m
614,3,규랜져,3561,30,2,3,5,40.0%,11m
616,3,태기,3559,232,8,13,21,38.1%,11m
617,3,kisling,3557,294,12,10,22,54.5%,3m
618,3,동위원소,3556,219,19,6,25,76.0%,7m
618,3,[투막빌런협회]군단의심장,3556,86,4,2,6,66.7%,9m
620,3,호접몽,3555,1549,414,409,823,50.3%,3m
620,2,doubleqpc,3555,0,1,0,1,100.0%,53m
622,3,IlIlIlIlIlIl,3552,0,1,3,4,25.0%,9m
623,3,없어요,3550,30,2,1,3,66.7%,9m
624,2,Bluey,3549,821,418,445,863,48.4%,3m
624,3,[그시절의]마린허니,3549,30,1,1,2,50.0%,10m
626,3,StorageBox,3548,118,2,6,8,25.0%,3m
626,3,llllllllllll,3548,0,1,0,1,100.0%,9m
626,3,Rahwinia,3548,0,0,1,1,0.0%,10m
626,3,[Equal]BYwooricoop,3548,0,0,1,1,0.0%,7m
626,3,마린,3548,0,0,2,2,0.0%,8m
631,3,[트위치]레드스톰,3547,652,28,32,60,46.7%,3m
632,3,[ELS]강아지왕국,3546,93,2,4,6,33.3%,3m
632,3,firstoffirst,3546,60,2,5,7,28.6%,3m
634,3,IIIIIIIIIIII,3545,1542,154,142,296,52.0%,7m
635,3,이제시작,3544,0,0,1,1,0.0%,3m
636,3,ZeuS,3541,295,11,8,19,57.9%,3m
637,1,절막쳐다봤잖아요,3540,97,6,1,7,85.7%,52m
638,3,불랑서,3539,145,24,11,35,68.6%,3m
638,3,llllllllllll,3539,514,24,14,38,63.2%,3m
638,3,iiiiiiiiiiii,3539,0,0,1,1,0.0%,9m
641,3,[킹왕핵고수]아아아아,3538,112,6,1,7,85.7%,4m
641,3,IIIllllllIIl,3538,0,0,1,1,0.0%,3m
643,3,gud,3537,1537,93,96,189,49.2%,3m
643,3,ctarsraft,3537,630,23,25,48,47.9%,9m
643,3,동학,3537,0,2,3,5,40.0%,9m
643,3,[Lotuz]vividrabbit,3537,0,1,0,1,100.0%,7m
647,3,Dalch,3536,186,7,12,19,36.8%,5m
647,3,불태웠어,3536,120,2,2,4,50.0%,10m
647,3,Water,3536,0,0,1,1,0.0%,10m
647,3,병점고수리부엉이,3536,0,0,2,2,0.0%,10m
651,3,螢雪之功,3535,171,7,3,10,70.0%,5m
651,3,공포,3535,30,1,3,4,25.0%,10m
653,2,dkricm,3534,0,0,1,1,0.0%,53m
654,3,sugo,3531,1204,127,128,255,49.8%,11m
654,3,[Komica]MisterHYC,3531,643,43,28,71,60.6%,6m
654,2,[蜂蜜檸檬]UnLock,3531,0,0,4,4,0.0%,53m
657,3,[D3StaR]AnThoNyDaVis,3530,116,3,1,4,75.0%,3m
658,3,[자지언트]Lard,3527,0,0,4,4,0.0%,7m
659,3,[Rush]MeTeor,3525,754,132,119,251,52.6%,3m
659,3,[BH]DKSOT,3525,232,66,61,127,52.0%,7m
659,3,SFHoLongHun,3525,1163,56,51,107,52.3%,9m
662,3,Tassadar,3524,341,14,5,19,73.7%,10m
662,3,psychopomp,3524,30,2,3,5,40.0%,3m
662,1,MyStyLe,3524,0,0,3,3,0.0%,52m
665,2,하양물망초,3523,166,6,4,10,60.0%,53m
666,3,[NFam]kykiske,3522,0,5,0,5,100.0%,54m
667,3,저그야캐양,3521,301,11,8,19,57.9%,3m
667,3,[비트]SadJoker,3521,0,1,0,1,100.0%,5m
669,1,[Mist]stickgolem,3518,168,4,2,6,66.7%,7m
669,3,[Aster]GslDiamond,3518,117,2,2,4,50.0%,9m
671,3,변함없음,3516,528,23,13,36,63.9%,3m
671,1,星际争霸,3516,268,12,4,16,75.0%,8m
671,3,[입산회]소연애비,3516,218,7,7,14,50.0%,7m
671,3,카카로트,3516,60,2,4,6,33.3%,4m
671,1,boyar,3516,0,0,1,1,0.0%,5m
676,1,HeavenRode,3513,0,5,0,5,100.0%,7m
676,1,科學超電磁砲,3513,0,4,1,5,80.0%,3m
678,3,raika,3512,932,39,30,69,56.5%,4m
678,3,USAChoboUSA,3512,444,19,15,34,55.9%,8m
678,1,타푸,3512,0,0,1,1,0.0%,7m
681,1,[도담이]얼어붙은개,3511,0,1,0,1,100.0%,8m
681,1,아니하,3511,0,0,1,1,0.0%,3m
683,3,[Sugar]도리도리짱,3510,1064,53,62,115,46.1%,7m
684,1,llllllllllll,3508,156,5,0,5,100.0%,10m
685,3,Akassia,3506,233,11,4,15,73.3%,9m
686,3,파워상민이,3505,1051,46,30,76,60.5%,8m
686,3,DinoSaur,3505,136,3,4,7,42.9%,5m
688,3,[뱅초고수모임]코피두잔,3504,356,17,11,28,60.7%,2m
688,1,[상한가터치자]하이브리드,3504,0,0,1,1,0.0%,8m
690,3,돈이최고야,3503,95,1,2,3,33.3%,3m
691,3,Qoohoya,3501,1397,55,49,104,52.9%,11m
692,3,마초킹,3500,256,18,21,39,46.2%,5m
692,3,[애니멀킹덤]동물왕고양이네코,3500,94,3,9,12,25.0%,6m
694,3,TraFalGarLaw,3498,139,4,2,6,66.7%,9m
695,2,lovepp,3496,0,3,3,6,50.0%,53m
695,1,[ELSII]Trust,3496,0,1,0,1,100.0%,9m
697,3,Paradise,3495,296,14,3,17,82.4%,6m
697,1,엠엠크루,3495,138,4,4,8,50.0%,7m
699,1,WhiteRock,3494,0,0,1,1,0.0%,7m
700,3,[견지망월]혜니쭈니,3493,1139,74,68,142,52.1%,9m
700,3,Xayide,3493,162,4,5,9,44.4%,9m
700,3,VIP,3493,30,1,4,5,20.0%,3m
703,3,BrOkEn,3492,203,7,4,11,63.6%,3m
704,3,zerg,3490,944,36,38,74,48.6%,11m
704,1,[GIS]小翔,3490,0,0,2,2,0.0%,8m
706,3,물찌,3489,1513,170,153,323,52.6%,9m
706,3,lllllllllllI,3489,332,12,21,33,36.4%,3m
706,1,스타접은지오래다,3489,88,3,1,4,75.0%,8m
709,1,AgCl,3488,284,8,3,11,72.7%,7m
709,1,[무리무리팸]농후한민달팽이,3488,0,0,2,2,0.0%,8m
711,1,[pepper]천공지뢰,3485,40,2,0,2,100.0%,7m
712,1,Hexer,3484,721,22,22,44,50.0%,8m
713,3,rnalgh,3482,1494,333,318,651,51.2%,10m
713,3,rlawnsghd,3482,408,17,14,31,54.8%,3m
715,1,Seven,3480,852,126,81,207,60.9%,7m
715,3,왕저그,3480,1483,96,85,181,53.0%,6m
715,3,전설,3480,191,6,5,11,54.5%,7m
715,3,땡땡땡,3480,0,2,7,9,22.2%,10m
719,1,구라컴패니,3479,76,3,3,6,50.0%,5m
720,3,더로드,3478,1522,181,167,348,52.0%,6m
720,3,테란개장인,3478,288,14,14,28,50.0%,4m
722,1,JollyPosh,3477,264,8,4,12,66.7%,7m
722,1,KnerveD,3477,0,0,1,1,0.0%,7m
724,3,고소미,3475,1207,78,67,145,53.8%,3m
724,2,윤구,3475,224,8,4,12,66.7%,11m
726,3,aDecay,3474,391,15,12,27,55.6%,6m
727,1,Hiliathim,3473,361,26,9,35,74.3%,8m
728,1,wooyoo,3471,761,23,16,39,59.0%,7m
728,1,[地獄拉麵]多線獸,3471,424,14,6,20,70.0%,10m
728,1,llllllllllll,3471,167,4,2,6,66.7%,52m
731,3,[NaLBIL]삼분토스,3469,359,16,9,25,64.0%,6m
732,1,[Equal]CoMMuNaL,3468,1154,35,38,73,47.9%,7m
733,3,Harlequin,3467,1528,142,131,273,52.0%,9m
733,3,한승연,3467,174,11,9,20,55.0%,7m
733,3,과즙미뿜뿜,3467,0,5,0,5,100.0%,22m
733,1,[디자이너스]권총대,3467,0,1,0,1,100.0%,8m
733,3,DAETTO,3467,0,1,0,1,100.0%,3m
738,3,MagiRA,3466,1574,149,153,302,49.3%,11m
738,3,락지,3466,498,18,23,41,43.9%,4m
740,3,[VSTL]hyoungjuk,3465,1503,725,730,1455,49.8%,7m
741,3,자귀자귀무자귀,3464,486,24,17,41,58.5%,6m
741,1,닉네임,3464,0,1,0,1,100.0%,7m
743,3,[Tsuper]이병팔,3463,1481,64,69,133,48.1%,4m
743,1,[事大主義]中国共産党,3463,414,11,11,22,50.0%,5m
743,1,spTG,3463,228,7,3,10,70.0%,8m
746,1,마재윤,3462,0,0,1,1,0.0%,7m
747,3,[0I터널]Gonzo,3461,244,15,12,27,55.6%,3m
747,1,[형님나가신다]SaVior,3461,124,3,3,6,50.0%,8m
749,3,[매너플레이어]FINALY,3460,912,133,117,250,53.2%,11m
750,3,BoomShakalak,3459,263,20,14,34,58.8%,7m
750,1,불량왕자,3459,361,16,6,22,72.7%,9m
750,1,[Arrest]태후니당,3459,0,1,2,3,33.3%,10m
750,3,[킹왕핵고수]하태핫태,3459,0,1,2,3,33.3%,4m
754,3,만두생각,3458,393,39,47,86,45.3%,6m
754,1,[Paul]Atreides,3458,0,1,0,1,100.0%,9m
756,3,[EERR]llllllllllll,3456,1579,90,100,190,47.4%,11m
756,1,lllIIlIIllIl,3456,206,5,5,10,50.0%,6m
758,1,咖啡,3455,1606,129,118,247,52.2%,6m
758,3,Catty,3455,97,5,1,6,83.3%,54m
758,1,[제주여고]김시시,3455,0,0,1,1,0.0%,52m
761,1,llllllllllll,3453,464,13,7,20,65.0%,9m
761,1,JCK,3453,292,9,7,16,56.2%,7m
763,1,[트수Crew]JellyDey,3452,246,7,4,11,63.6%,5m
764,1,당연히,3451,778,23,22,45,51.1%,5m
765,1,[Weihai]Kaimera,3449,0,0,1,1,0.0%,7m
766,3,[겨울방어]happyday,3448,1367,173,165,338,51.2%,9m
766,3,LsIk,3448,738,26,29,55,47.3%,2m
768,3,불친절해,3446,232,7,8,15,46.7%,3m
768,3,llllllll,3446,30,2,7,9,22.2%,8m
768,1,lastofdevil,3446,0,1,1,2,50.0%,7m
771,3,[5torM]갈아만든배,3443,1469,68,56,124,54.8%,8m
772,3,Archtanis,3442,572,23,24,47,48.9%,9m
772,1,peskiness,3442,0,0,1,1,0.0%,8m
774,1,히어로,3440,44,1,3,4,25.0%,8m
775,3,[사냥꾼]동족전안하는땅크,3439,1571,607,599,1206,50.3%,10m
775,1,tabiseal,3439,0,0,1,1,0.0%,52m
777,1,게임종결자,3438,428,12,12,24,50.0%,8m
778,3,jack,3435,644,24,28,52,46.2%,3m
778,1,DrJ,3435,84,2,5,7,28.6%,8m
780,3,lIllIIlllIII,3433,452,14,18,32,43.8%,3m
780,1,HyL,3433,44,1,2,3,33.3%,3m
782,3,FLORENCIO,3431,452,53,50,103,51.5%,3m
782,1,LINK,3431,134,2,1,3,66.7%,3m
782,1,IlIIlIIlIIl,3431,0,0,1,1,0.0%,8m
785,1,행주,3430,638,19,17,36,52.8%,11m
786,1,[bluedd]達文西種馬,3429,44,2,0,2,100.0%,11m
787,1,MAHOROMATIC,3428,1614,164,141,305,53.8%,5m
787,1,WayTooEZ,3428,94,3,5,8,37.5%,52m
787,2,Discipline,3428,48,2,2,4,50.0%,53m
790,3,맹공,3427,1443,360,328,688,52.3%,9m
790,1,밋밋한돌직구,3427,0,0,2,2,0.0%,11m
792,3,eddie,3425,858,36,41,77,46.8%,10m
792,1,웃지마민병관,3425,638,18,17,35,51.4%,10m
794,1,아케미호무라,3424,0,1,0,1,100.0%,8m
795,1,覺醒力量,3423,0,0,1,1,0.0%,5m
796,3,[캣보이]CarpeDiemCat,3422,0,1,3,4,25.0%,11m
797,1,llllllllllll,3420,1298,120,95,215,55.8%,10m
798,1,[너의ol름은]참새,3419,162,5,2,7,71.4%,7m
798,1,CENSORED,3419,78,3,1,4,75.0%,8m
798,1,코털,3419,0,1,1,2,50.0%,5m
798,1,복길이,3419,0,0,1,1,0.0%,11m
802,1,Kyezer,3418,153,8,2,10,80.0%,11m
802,3,BlueDevil,3418,145,7,2,9,77.8%,54m
802,1,[DNKCFT]FLORENCIO,3418,44,2,4,6,33.3%,4m
805,1,[축구의전설]쿠킹포유,3417,1572,62,44,106,58.5%,9m
805,1,마내무다방인데,3417,144,7,1,8,87.5%,11m
807,1,Jerry,3416,200,6,5,11,54.5%,10m
807,1,응가,3416,42,1,4,5,20.0%,7m
809,3,[AYSM]SCH,3415,751,29,36,65,44.6%,11m
809,3,[TF]sOsaeggi,3415,679,25,29,54,46.3%,9m
809,1,술취한노맹,3415,40,2,2,4,50.0%,8m
809,3,서늘한성에꽃이,3415,122,2,4,6,33.3%,3m
813,1,파파라치,3414,162,5,3,8,62.5%,6m
813,1,安多彬,3414,122,4,5,9,44.4%,11m
815,3,[비트]박동탁,3413,354,13,18,31,41.9%,11m
816,1,[철기클랜]교상한,3412,126,3,6,9,33.3%,8m
817,1,llllllll,3411,0,1,4,5,20.0%,20m
818,3,Meed,3410,567,28,24,52,53.8%,10m
819,1,[偶像型男隊]Grrrr,3409,507,18,12,30,60.0%,7m
819,1,normal,3409,566,16,15,31,51.6%,4m
821,1,김에녹,3408,42,1,7,8,12.5%,8m
821,1,[이신형제자]케찰코아툴루스,3408,0,0,1,1,0.0%,7m
823,1,[비트]토사장임다,3407,1564,160,148,308,51.9%,11m
824,1,지면음료수사온나,3406,1199,46,34,80,57.5%,7m
824,1,임수정,3406,562,18,14,32,56.2%,7m
826,1,[짜다국이]Staystar,3403,88,2,4,6,33.3%,10m
827,3,ssl,3402,1497,139,140,279,49.8%,7m
828,1,[C59646]평택가즈아,3400,0,1,1,2,50.0%,6m
829,3,DRAKEDOG,3399,30,1,2,3,33.3%,6m
830,3,sysarang,3398,356,13,17,30,43.3%,3m
830,1,IIIIIIIIIIII,3398,0,0,2,2,0.0%,6m
832,1,유나야사랑해,3397,0,1,2,3,33.3%,6m
833,3,LTE,3396,1557,66,65,131,50.4%,3m
833,1,PostGrad,3396,531,19,16,35,54.3%,11m
833,1,[여자후쟝킬러]뒷구멍굴착기,3396,42,2,0,2,100.0%,11m
836,1,스닥,3395,84,2,6,8,25.0%,10m
837,3,너를꿈꾸며,3394,97,3,4,7,42.9%,54m
837,1,[메카]제우스,3394,42,2,2,4,50.0%,7m
837,1,[NLTN]짐네이년,3394,0,1,0,1,100.0%,7m
840,1,[무작위짱짱맨]을지,3393,156,5,6,11,45.5%,8m
841,1,[ELSII]OMGitsKorean,3392,168,8,0,8,100.0%,10m
841,1,[기냥]asdf,3392,48,4,2,6,66.7%,21m
843,1,ComeAtMeBro,3391,271,17,9,26,65.4%,8m
843,1,Hack,3391,0,0,1,1,0.0%,7m
845,1,[TDT]ECLipse,3390,1741,623,583,1206,51.7%,6m
846,1,[미남이군]SpecialSTOM,3389,0,1,2,3,33.3%,7m
847,1,[Fu]JJpiano,3387,1154,72,64,136,52.9%,11m
848,1,DarkShadow,3386,158,5,4,9,55.6%,7m
848,1,[한발이면]Siro,3386,0,2,3,5,40.0%,21m
850,3,[Miku39]微風,3385,0,0,1,1,0.0%,54m
851,1,Dark,3383,1721,125,124,249,50.2%,10m
851,1,KEYSTONE,3383,454,16,12,28,57.1%,5m
851,1,GoldenWillow,3383,153,8,4,12,66.7%,7m
854,3,[너의ol름은]형은세배빠르당,3382,494,43,32,75,57.3%,6m
854,1,SparkleHands,3382,364,11,9,20,55.0%,7m
854,1,[경기도민]돼지세끼,3382,0,4,1,5,80.0%,7m
857,1,[Aster]Caesar,3381,0,0,2,2,0.0%,7m
858,3,Love,3380,1493,94,97,191,49.2%,8m
859,1,[SGlory]傑森哥,3379,194,5,9,14,35.7%,10m
860,3,서영웅,3374,97,2,1,3,66.7%,22m
860,1,이순신전략,3374,0,0,2,2,0.0%,10m
862,1,瑋恩咖啡,3373,1299,74,67,141,52.5%,8m
863,1,[sheep8]나한테지면찌질이,3372,0,1,1,2,50.0%,6m
864,1,3371,367,13,12,25,52.0%,10m
865,1,karen,3370,472,24,15,39,61.5%,10m
865,1,보고리아,3370,0,0,2,2,0.0%,6m
867,1,AzrealBrian,3369,1720,110,106,216,50.9%,10m
867,2,旯牙,3369,622,25,35,60,41.7%,5m
869,1,[南無阿彌陀佛]龜巖許浚,3368,36,1,3,4,25.0%,8m
869,1,어디서역장질이야,3368,0,0,1,1,0.0%,9m
871,1,llllllllllll,3367,97,2,4,6,33.3%,52m
872,1,뽑국이,3363,994,37,29,66,56.1%,7m
872,1,[v비광v]InitiaI,3363,0,1,0,1,100.0%,6m
874,1,마시멜롱,3362,42,1,6,7,14.3%,5m
875,3,十年執著,3360,1495,126,125,251,50.2%,8m
876,2,FlameSJ,3359,36,1,2,3,33.3%,5m
877,2,[CIM]時間刺客,3358,68,3,1,4,75.0%,8m
878,1,BlueShrimp,3357,322,9,10,19,47.4%,8m
879,1,짱구김밥,3356,1138,42,40,82,51.2%,10m
880,3,HolyWater,3355,1106,169,188,357,47.3%,9m
880,3,llllllllllll,3355,252,9,8,17,52.9%,7m
882,3,무한의주인,3354,1453,218,206,424,51.4%,7m
882,1,[하더놈]Raper,3354,1690,209,186,395,52.9%,7m
882,3,STURMOVIK,3354,0,1,0,1,100.0%,6m
885,1,DBD,3353,272,9,8,17,52.9%,7m
886,1,Houkes,3352,544,17,16,33,51.5%,10m
887,3,믄근사마,3351,558,22,26,48,45.8%,3m
887,1,小冰,3351,310,10,11,21,47.6%,11m
887,2,ALitS,3351,253,9,5,14,64.3%,53m
890,1,choi,3350,648,20,26,46,43.5%,9m
891,1,서동훈병신,3349,163,7,5,12,58.3%,5m
891,1,전광식,3349,278,7,7,14,50.0%,8m
893,1,조근성,3346,1012,39,31,70,55.7%,7m
894,1,Hyor,3343,0,4,1,5,80.0%,21m
895,2,레스토랑스,3342,0,0,1,1,0.0%,7m
896,3,MonsterCalls,3339,1266,45,59,104,43.3%,3m
896,1,Integral,3339,177,8,4,12,66.7%,5m
896,2,smsik,3339,114,4,4,8,50.0%,8m
896,2,哈嚕你好嗎,3339,0,3,2,5,60.0%,8m
900,1,IIIIIIIIIII,3337,164,5,7,12,41.7%,11m
901,2,Say,3336,64,2,3,5,40.0%,9m
902,2,동경미소년,3335,1109,61,45,106,57.5%,6m
902,1,[세쥔찡]꾸드리,3335,246,8,2,10,80.0%,52m
902,1,스투똥망겜,3335,300,8,10,18,44.4%,10m
905,2,[날강두]타도멕건마,3334,321,17,6,23,73.9%,11m
906,1,스타그만해,3333,1678,155,153,308,50.3%,8m
907,1,소팔다개된년,3330,150,4,6,10,40.0%,7m
908,2,好運哥布林,3329,44,1,1,2,50.0%,53m
909,1,IlIIIlIIllII,3328,1059,71,65,136,52.2%,10m
909,3,호노답,3328,162,5,2,7,71.4%,23m
909,1,GGGGG,3328,0,1,4,5,20.0%,21m
912,2,[엽기전략]광고창작,3327,362,13,9,22,59.1%,6m
913,2,세침떼기,3326,116,5,0,5,100.0%,7m
914,2,checkmate,3325,0,3,2,5,60.0%,6m
914,2,IIIIIIIIIIII,3325,0,1,0,1,100.0%,8m
914,2,DoubleY,3325,0,0,2,2,0.0%,8m
917,2,[BRNZ]李多情,3323,1225,78,69,147,53.1%,11m
917,2,lawmaker,3323,619,35,31,66,53.0%,8m
919,1,아를르캥,3322,235,8,6,14,57.1%,5m
920,1,霹靂油條一鯉麥刻,3321,167,6,0,6,100.0%,20m
920,2,daniel,3321,0,1,0,1,100.0%,6m
920,2,Byun,3321,0,1,0,1,100.0%,3m
923,2,나는야영현,3320,876,38,23,61,62.3%,8m
923,3,Ktoto,3320,606,26,24,50,52.0%,9m
923,2,KKKKKK,3320,0,0,5,5,0.0%,3m
926,2,Siamese,3319,0,3,2,5,60.0%,8m
927,1,[WHB]한화우승,3318,466,15,16,31,48.4%,5m
927,2,Axdv,3318,0,1,1,2,50.0%,5m
929,1,[Neat]Moon,3317,987,40,34,74,54.1%,7m
930,1,식이당,3316,187,5,0,5,100.0%,21m
931,1,밍밍,3315,174,5,8,13,38.5%,5m
931,2,[닭장]버거킹가지말자,3315,0,1,0,1,100.0%,9m
933,1,천상악마,3313,1139,38,42,80,47.5%,5m
934,2,innae,3312,58,2,1,3,66.7%,8m
935,2,Maserati,3311,0,1,0,1,100.0%,53m
936,3,nimiseveral,3309,1117,102,94,196,52.0%,10m
936,1,다게임,3309,0,4,2,6,66.7%,10m
938,2,lllllllllll,3308,0,1,1,2,50.0%,6m
939,1,shino,3307,0,4,1,5,80.0%,21m
939,2,TeAmo,3307,36,1,1,2,50.0%,3m
941,1,만년실버,3306,1438,213,205,418,51.0%,10m
941,3,MonkeyFace,3306,1468,82,83,165,49.7%,11m
941,1,Dogv,3306,134,4,5,9,44.4%,4m
941,2,스윙스,3306,30,1,1,2,50.0%,7m
945,2,CHUAN,3304,584,87,56,143,60.8%,8m
946,2,大毛哥,3303,206,10,4,14,71.4%,8m
946,1,TonFroid,3303,141,8,5,13,61.5%,51m
948,2,[SofT]지면서배울까,3301,0,1,2,3,33.3%,3m
948,1,[진리콩]IIIIIIIIIIII,3301,0,0,1,1,0.0%,29m
950,1,나빌레라,3297,1663,240,240,480,50.0%,11m
950,2,llllllllllll,3297,186,6,2,8,75.0%,5m
952,1,짐레이너,3296,0,4,1,5,80.0%,29m
953,2,blain,3295,0,4,1,5,80.0%,3m
954,2,까로,3294,0,1,0,1,100.0%,7m
955,2,조셉필라모스,3293,58,2,2,4,50.0%,5m
955,2,[차행성줫밥들]차녀기,3293,0,0,1,1,0.0%,5m
957,1,[한화]周星馳,3292,463,21,18,39,53.8%,6m
957,2,Lox,3292,268,10,7,17,58.8%,5m
957,2,[sc2mc]IlIlIlIlIlIl,3292,30,2,5,7,28.6%,8m
960,2,[박살]JinKim,3291,220,7,9,16,43.8%,5m
961,1,NCM,3290,732,43,51,94,45.7%,7m
962,2,cocodor,3289,182,6,6,12,50.0%,5m
963,1,fairplay,3288,496,15,23,38,39.5%,5m
963,2,[건마]멕건마,3288,58,3,0,3,100.0%,11m
963,1,[ThsG]케이원,3288,0,1,2,3,33.3%,21m
966,1,kindlysu,3287,1227,88,91,179,49.2%,8m
967,3,여틴구함,3286,984,102,93,195,52.3%,3m
967,2,StreeTBoxeR,3286,144,3,2,5,60.0%,7m
967,2,JONO,3286,0,0,1,1,0.0%,6m
970,2,[보금자리]미르,3285,0,1,0,1,100.0%,6m
970,1,[긴급스섹대]올인안하는사람,3285,0,0,1,1,0.0%,21m
972,2,llllllllllll,3284,58,2,8,10,20.0%,3m
973,2,lllllllllll,3283,443,19,14,33,57.6%,7m
973,1,IIIIIIIIIlII,3283,428,18,16,34,52.9%,11m
973,2,부릉,3283,121,3,5,8,37.5%,5m
976,2,Hansol,3282,0,0,1,1,0.0%,8m
977,1,세모,3280,0,4,1,5,80.0%,21m
977,2,호잇,3280,0,1,1,2,50.0%,5m
977,2,Jaga,3280,0,0,1,1,0.0%,3m
980,2,[쭌신님]멍멍이,3279,204,8,5,13,61.5%,6m
980,1,Quenyao,3279,232,6,7,13,46.2%,51m
980,2,你媽死了,3279,60,2,3,5,40.0%,6m
983,3,네이글,3278,268,9,22,31,29.0%,10m
983,2,[TheHon]螢幕小鍵盤,3278,88,5,1,6,83.3%,5m
983,2,流浪的終點,3278,0,0,2,2,0.0%,5m
986,2,Sundae,3277,102,6,1,7,85.7%,3m
986,2,MyLongBow,3277,0,1,4,5,20.0%,8m
988,1,[ELS]Dabs,3276,342,10,15,25,40.0%,7m
988,2,QueenSGambit,3276,215,8,3,11,72.7%,6m
988,1,[강북도봉구파]kanghyung,3276,169,7,3,10,70.0%,20m
988,2,거기통닭집이죠,3276,32,1,4,5,20.0%,6m
992,1,해밀턴,3275,88,5,2,7,71.4%,11m
992,2,넌누구니,3275,92,3,5,8,37.5%,6m
992,2,[Away]곤규는짬찌,3275,0,0,2,2,0.0%,3m
995,2,lKinglKazma,3274,1106,42,40,82,51.2%,3m
995,3,cheeseking,3274,310,10,9,19,52.6%,6m
995,2,안녕,3274,167,5,1,6,83.3%,8m
995,1,midnightcorn,3274,0,1,0,1,100.0%,20m
999,2,ILILILILI,3273,589,23,20,43,53.5%,11m
999,2,[快樂玩家]LUKEKUANG,3273,279,15,8,23,65.2%,6m
999,2,자갈치뱃넘,3273,142,5,5,10,50.0%,6m
1002,3,현민이고추,3272,230,11,2,13,84.6%,54m
1003,2,[통수]어둠의지배자,3271,0,1,0,1,100.0%,11m
1003,1,월진,3271,0,0,1,1,0.0%,21m
1005,2,까비,3270,966,35,37,72,48.6%,11m
1005,2,[Ne0n]Rain,3270,172,7,4,11,63.6%,5m
1005,1,시엘수,3270,92,5,3,8,62.5%,7m
1008,1,CycleBreaker,3267,167,4,8,12,33.3%,51m
1009,3,Janz,3266,1476,598,592,1190,50.3%,10m
1009,3,[敗人品系列]Athos,3266,147,6,5,11,54.5%,22m
1011,3,[sc2mc]김리우,3265,1446,132,140,272,48.5%,3m
1011,2,[TeamGP]TheBaRTV,3265,631,25,18,43,58.1%,11m
1011,1,llIIllllllll,3265,523,18,17,35,51.4%,10m
1011,2,Hyper,3265,0,0,2,2,0.0%,9m
1015,2,스타매냐,3264,304,11,8,19,57.9%,7m
1016,2,김센맥주,3263,120,4,4,8,50.0%,6m
1017,2,Ironman,3262,693,36,32,68,52.9%,6m
1017,3,MaDgwool,3262,167,8,3,11,72.7%,22m
1017,2,[트수Crew]바로바로,3262,30,1,1,2,50.0%,9m
1020,1,호날두두마리치킨,3261,579,36,34,70,51.4%,10m
1020,2,LOCKedHEART,3261,553,23,29,52,44.2%,9m
1022,2,llllllllllll,3259,0,4,2,6,66.7%,6m
1023,2,푸른빛하늘,3258,285,11,8,19,57.9%,8m
1023,2,IIIIIIIIIIII,3258,86,4,2,6,66.7%,9m
1025,2,櫧騔湸,3256,0,0,1,1,0.0%,11m
1026,1,Boom,3254,388,15,16,31,48.4%,6m
1026,2,[시럽]space,3254,0,2,3,5,40.0%,20m
1028,2,올킬게이머,3253,148,6,4,10,60.0%,11m
1028,2,星空殺手,3253,0,2,0,2,100.0%,8m
1030,1,[TheDOH]強勇集團,3252,1618,130,131,261,49.8%,5m
1030,3,[무한오영종]llllllllllil,3252,467,35,41,76,46.1%,9m
1030,2,IIIIIIIIIIII,3252,693,33,28,61,54.1%,6m
1030,2,전쟁사나이,3252,92,3,4,7,42.9%,6m
1034,1,novic,3251,1624,74,79,153,48.4%,8m
1035,1,Zantrid,3250,198,5,7,12,41.7%,52m
1035,1,Honeybee,3250,139,3,3,6,50.0%,51m
1037,1,[한타왕]류혜,3248,658,21,29,50,42.0%,5m
1037,2,[SofT]트와이스다현,3248,147,4,2,6,66.7%,5m
1037,2,IIIIIIIIIIII,3248,0,1,2,3,33.3%,3m
1040,2,redwine,3245,30,5,2,7,71.4%,3m
1040,2,llllllllllll,3245,0,3,2,5,60.0%,11m
1040,2,링링링,3245,62,2,3,5,40.0%,8m
1043,2,llllllllllll,3244,170,5,2,7,71.4%,5m
1043,2,IamDerp,3244,0,4,1,5,80.0%,8m
1043,2,호로시키들,3244,0,1,5,6,16.7%,8m
1046,1,설사해욤,3243,1068,66,64,130,50.8%,5m
1046,2,버드깔래,3243,118,4,4,8,50.0%,8m
1046,2,군필여고생,3243,32,2,2,4,50.0%,8m
1049,2,[무한김준현]Bronzeuser,3241,0,1,0,1,100.0%,3m
1050,2,[灭棒敢死队]抗韩奇侠燕又鹰,3240,0,4,1,5,80.0%,28m
1051,2,도토리,3237,0,3,2,5,60.0%,11m
1052,2,[國本]다은사랑주성,3236,633,26,19,45,57.8%,8m
1052,2,Luias,3236,340,14,11,25,56.0%,7m
1052,2,[공대지]해처리,3236,384,13,15,28,46.4%,8m
1052,1,수원혼모노이현성,3236,0,2,5,7,28.6%,22m
1056,1,Kan,3235,892,34,34,68,50.0%,5m
1057,2,재웅이,3234,493,21,12,33,63.6%,6m
1057,2,바삭한치킨,3234,0,4,1,5,80.0%,29m
1059,1,IIIIIIIIIIII,3233,1196,90,81,171,52.6%,10m
1059,2,[항문브레이커]VanDarkholme,3233,118,5,3,8,62.5%,11m
1061,2,ElGringo,3232,307,15,7,22,68.2%,3m
1061,2,pppppp,3232,114,4,4,8,50.0%,8m
1061,2,[Beam]회장님,3232,0,0,1,1,0.0%,8m
1064,1,YBJL,3231,1099,52,59,111,46.8%,5m
1064,2,IlIlIlIlIlIl,3231,764,36,22,58,62.1%,9m
1064,1,현티선생,3231,408,18,15,33,54.5%,11m
1064,2,RUIN,3231,64,3,3,6,50.0%,8m
1068,2,nope,3229,1542,83,57,140,59.3%,7m
1068,2,여유,3229,116,4,5,9,44.4%,6m
1070,1,즐겜러,3228,860,31,37,68,45.6%,8m
1070,3,끄야아앍,3228,260,11,17,28,39.3%,3m
1070,1,이것초보야,3228,58,5,15,20,25.0%,5m
1073,2,달구비,3227,357,16,8,24,66.7%,5m
1074,2,[세미온TD]팔랑크스,3226,265,10,5,15,66.7%,11m
1074,2,AlpHa,3226,58,3,2,5,60.0%,7m
1076,1,Alo,3225,1596,213,207,420,50.7%,5m
1076,2,[초등학생]떡본좌,3225,1480,69,49,118,58.5%,3m
1076,2,baecome,3225,436,17,11,28,60.7%,9m
1076,2,[BESTIM]Ace,3225,116,4,6,10,40.0%,9m
1080,2,라온,3224,1569,107,98,205,52.2%,3m
1081,1,불타는버스,3222,1612,88,97,185,47.6%,10m
1081,2,llllllllllll,3222,88,3,3,6,50.0%,5m
1081,2,Cromoto,3222,0,0,1,1,0.0%,8m
1084,2,히벵크,3221,90,4,3,7,57.1%,9m
1085,2,Nano,3220,343,12,15,27,44.4%,8m
1085,2,쫀득한딕션,3220,244,8,8,16,50.0%,5m
1085,2,IIIIIIIIIIII,3220,0,0,2,2,0.0%,7m
1088,2,오야,3217,174,5,3,8,62.5%,5m
1089,2,[두근두근]울이,3216,0,1,0,1,100.0%,9m
1090,2,서울사이버대학교,3215,192,10,4,14,71.4%,8m
1090,2,PhysiK,3215,88,7,4,11,63.6%,3m
1090,2,MicroMarine,3215,144,7,5,12,58.3%,6m
1090,2,[DPW]JAY,3215,0,1,0,1,100.0%,28m
1094,1,undyinglove,3214,774,28,30,58,48.3%,8m
1094,2,[잘먹고산다]목소리의형태,3214,192,6,6,12,50.0%,6m
1094,1,DearName,3214,48,4,4,8,50.0%,20m
1094,2,[러블리걸]까칠한쩡이,3214,30,3,5,8,37.5%,3m
1094,2,llllllllllll,3214,30,1,3,4,25.0%,3m
1099,1,경산프로토스,3213,480,15,24,39,38.5%,10m
1099,1,[형님나가신다]SCZone,3213,110,4,12,16,25.0%,5m
1101,1,[어윤수님개쩜]JOKER,3212,0,2,5,7,28.6%,10m
1102,1,IIIIIIIIIIII,3211,521,51,52,103,49.5%,6m
1102,2,[G20]이낙연,3211,450,46,31,77,59.7%,3m
1102,2,[선장이필요해]LastStar,3211,156,7,0,7,100.0%,3m
1105,1,MarcoReus,3209,1516,198,202,400,49.5%,8m
1105,1,[kosmos]애국해라,3209,0,1,0,1,100.0%,21m
1107,2,sheva,3208,1585,534,495,1029,51.9%,5m
1107,2,Torres,3208,0,3,0,3,100.0%,28m
1109,2,삼등못하면만원,3207,347,22,18,40,55.0%,6m
1110,2,세례요한,3206,392,16,13,29,55.2%,6m
1111,2,omgvi,3205,94,3,6,9,33.3%,6m
1111,2,[시스테마]아나닉넴정해줘,3205,0,1,0,1,100.0%,9m
1113,2,[strong]세스코,3203,0,0,1,1,0.0%,54m
1114,1,무작위,3202,1579,379,367,746,50.8%,8m
1114,2,遭了是生殖器官,3202,114,4,6,10,40.0%,9m
1114,2,catlover,3202,102,3,0,3,100.0%,6m
1114,2,Boxer,3202,0,1,0,1,100.0%,3m
1118,1,헛짓그만,3201,1577,175,170,345,50.7%,10m
1118,1,[Mist]바다왁스,3201,1538,83,92,175,47.4%,7m
1118,3,[Lab423]TheStar,3201,221,10,12,22,45.5%,6m
1118,2,johnkami,3201,0,1,1,2,50.0%,54m
1122,2,김치만두,3198,1302,114,81,195,58.5%,9m
1123,2,[ClanEP]솔랑,3197,62,2,4,6,33.3%,9m
1123,1,[諸葛世家]Karas,3197,0,0,1,1,0.0%,52m
1125,2,상대는가난하다구,3196,404,13,13,26,50.0%,6m
1125,2,[adios]알아서모하게,3196,0,4,1,5,80.0%,20m
1127,2,DrunkenCrow,3195,506,22,26,48,45.8%,6m
1128,1,나는나,3193,310,13,9,22,59.1%,51m
1128,2,[국방부사서병]조폭너구리당,3193,282,12,12,24,50.0%,3m
1130,3,Tiananmen,3192,0,1,0,1,100.0%,6m
1131,2,[DICET]IIIlIIIlIII,3191,399,18,14,32,56.2%,7m
1131,2,llllllllllll,3191,112,4,4,8,50.0%,8m
1131,3,기사,3191,0,1,0,1,100.0%,6m
1134,1,얼음,3189,0,0,1,1,0.0%,29m
1135,3,애지가니,3188,0,1,0,1,100.0%,54m
1136,2,한글공부,3187,1352,53,48,101,52.5%,8m
1137,2,완소남,3186,1512,69,61,130,53.1%,3m
1137,1,[노무현재단]사람사는세상,3186,341,13,6,19,68.4%,51m
1137,2,박원규,3186,142,3,0,3,100.0%,29m
1140,2,초씨,3185,0,0,4,4,0.0%,5m
1141,1,桑格莉亞,3184,263,6,4,10,60.0%,21m
1142,2,allav,3183,1465,112,93,205,54.6%,7m
1142,2,[Att]XiwAngKwan,3183,605,42,33,75,56.0%,5m
1142,1,hoNey,3183,97,2,1,3,66.7%,20m
1145,2,Ahyaneru,3181,415,21,11,32,65.6%,3m
1145,2,사신토스,3181,158,4,5,9,44.4%,5m
1147,2,MicroMarine,3180,0,0,2,2,0.0%,6m
1148,1,플루토,3179,222,9,9,18,50.0%,6m
1149,1,[WDNMD]Sonic,3178,296,9,20,29,31.0%,8m
1149,2,조르바,3178,62,3,4,7,42.9%,8m
1151,2,[야오이짭짭]이기자얍얍,3175,426,19,14,33,57.6%,7m
1151,2,chololate,3175,330,13,9,22,59.1%,3m
1151,2,사르트르,3175,0,0,3,3,0.0%,11m
1154,2,地知治世要,3174,1186,192,182,374,51.3%,6m
1154,3,Crazy,3174,914,36,29,65,55.4%,6m
1154,2,VelvetSky,3174,676,32,29,61,52.5%,9m
1154,3,spirit,3174,0,1,4,5,20.0%,5m
1158,3,흔들리며피는꽃,3171,0,1,0,1,100.0%,6m
1158,1,DKnight,3171,0,1,5,6,16.7%,22m
1160,3,冰淇淋,3169,1376,168,164,332,50.6%,3m
1160,1,Veder,3169,0,4,2,6,66.7%,21m
1160,3,영감을달라,3169,30,2,0,2,100.0%,10m
1163,3,MayuKamiya,3168,0,4,1,5,80.0%,10m
1164,2,김유진수제자,3167,254,13,18,31,41.9%,5m
1165,3,니엄브론즈,3166,299,13,5,18,72.2%,6m
1166,1,Napoleon,3164,876,27,42,69,39.1%,8m
1166,1,오동통너구리버스,3164,0,4,2,6,66.7%,21m
1166,2,DarkWolf,3164,0,1,2,3,33.3%,28m
1166,3,박상후,3164,0,0,1,1,0.0%,6m
1170,1,[Legend]수원재떨이,3163,97,4,3,7,57.1%,52m
1171,3,저그,3162,0,0,1,1,0.0%,5m
1171,2,살려줘어어,3162,0,0,2,2,0.0%,53m
1173,2,[밀짚모해적단]知愛,3161,0,4,1,5,80.0%,28m
1174,3,[快樂玩家]JIM,3160,86,3,4,7,42.9%,6m
1175,1,테란시발,3159,174,6,9,15,40.0%,10m
1176,3,나팔꽃필무렵,3158,646,29,33,62,46.8%,3m
1176,3,silverkleo,3158,58,5,3,8,62.5%,5m
1176,3,QiNTiQ,3158,0,1,1,2,50.0%,23m
1176,3,광마,3158,0,0,1,1,0.0%,5m
1180,3,Kai,3157,0,3,2,5,60.0%,6m
1181,2,MISSYCLUB,3156,1333,108,99,207,52.2%,11m
1181,3,無常,3156,342,15,11,26,57.7%,10m
1181,3,GomPoo,3156,290,11,10,21,52.4%,8m
1184,1,[그림리퍼]레이너,3155,1557,222,209,431,51.5%,10m
1184,3,[뿌야]틀니압수,3155,133,3,2,5,60.0%,10m
1184,3,꼬마자객,3155,0,0,1,1,0.0%,7m
1187,1,[Joing]Laopidia,3154,1511,72,85,157,45.9%,5m
1187,3,小心,3154,166,7,1,8,87.5%,11m
1187,3,스트라스블룸,3154,0,0,2,2,0.0%,54m
1190,2,Wafer,3153,677,116,95,211,55.0%,5m
1191,1,[CStorM]한국자동화,3152,1294,582,575,1157,50.3%,5m
1191,1,자판기커피,3152,1517,96,89,185,51.9%,7m
1191,2,아이유팬,3152,716,27,29,56,48.2%,9m
1191,3,[ANGG]Geologist,3152,30,2,1,3,66.7%,6m
1195,3,kensinz,3151,1585,144,113,257,56.0%,3m
1195,2,고위기사,3151,476,16,16,32,50.0%,9m
1195,2,[노잼]보라노아바,3151,321,13,17,30,43.3%,11m
1195,3,져켜켜,3151,30,1,2,3,33.3%,9m
1199,1,bluelake,3150,1553,170,169,339,50.1%,6m
1199,3,badModaFuker,3150,0,4,1,5,80.0%,3m
1201,1,XXXTENTACION,3149,1177,43,45,88,48.9%,10m
1202,1,[Queens]가영,3148,676,24,35,59,40.7%,5m
1203,3,구평동레전드,3147,0,1,0,1,100.0%,8m
1204,1,띵똥,3146,0,4,2,6,66.7%,29m
1204,3,[디플]미스한,3146,0,1,0,1,100.0%,6m
1206,2,[CIM]주먹,3145,1198,62,58,120,51.7%,9m
1206,2,[섹지보스]마꼬츄,3145,0,1,1,2,50.0%,9m
1208,3,죄송합니다,3144,114,5,5,10,50.0%,3m
1208,3,심심해서스타세판,3144,0,3,2,5,60.0%,3m
1208,2,Alice,3144,0,3,2,5,60.0%,29m
1211,3,llllllllllll,3143,0,0,3,3,0.0%,6m
1212,3,[Marimo]LonelyHaven,3142,1217,102,89,191,53.4%,8m
1212,1,CUJS,3142,0,1,6,7,14.3%,21m
1214,1,꿀떡,3141,1567,215,202,417,51.6%,6m
1214,3,misery,3141,716,27,22,49,55.1%,6m
1214,3,Withfox,3141,0,1,2,3,33.3%,6m
1217,2,델람,3140,938,84,82,166,50.6%,9m
1217,3,RandomName,3140,377,14,6,20,70.0%,3m
1217,3,Icefire,3140,0,0,1,1,0.0%,6m
1220,2,구름달,3139,276,18,15,33,54.5%,8m
1220,2,메론향빤쓰개발중,3139,219,10,8,18,55.6%,5m
1220,3,카친스키,3139,86,7,1,8,87.5%,3m
1220,2,[快樂玩家]小剪刀,3139,104,3,0,3,100.0%,53m
1224,1,SiRiUS,3137,1047,48,52,100,48.0%,8m
1224,3,Forberg,3137,0,0,1,1,0.0%,3m
1224,3,가오남,3137,0,0,2,2,0.0%,22m
1227,3,불멸왕의영혼,3136,272,10,9,19,52.6%,10m
1228,3,[으엉허엏]iskim,3135,0,0,1,1,0.0%,10m
1229,2,완이,3134,184,4,9,13,30.8%,5m
1230,2,[武漢]肺炎,3133,499,20,16,36,55.6%,5m
1230,3,IIIIIIIIIIII,3133,30,1,4,5,20.0%,3m
1232,1,TTT,3132,120,3,5,8,37.5%,51m
1232,1,genious,3132,0,0,2,2,0.0%,51m
1234,3,[RNH]smallhowhow,3131,0,1,0,1,100.0%,10m
1235,2,[JUNG]아리,3130,30,5,4,9,55.6%,7m
1236,3,유이쨩,3129,1103,52,38,90,57.8%,9m
1236,1,[국방부사서병]하루를즐겁게,3129,48,6,4,10,60.0%,21m
1236,1,wonmon,3129,152,3,7,10,30.0%,52m
1239,2,llwei,3128,0,4,1,5,80.0%,27m
1239,2,컴퓨터,3128,0,1,0,1,100.0%,54m
1241,3,WYD,3127,148,5,6,11,45.5%,9m
1241,3,지미,3127,30,2,2,4,50.0%,7m
1241,3,sherry,3127,30,1,1,2,50.0%,6m
1244,3,Ronaldo,3126,58,2,1,3,66.7%,9m
1244,3,신기루,3126,0,1,4,5,20.0%,10m
1246,2,자룡공명,3125,1042,43,36,79,54.4%,3m
1246,2,lIlIlIllIl,3125,410,16,15,31,51.6%,9m
1248,3,[미쓰에이]초절정꽃미남,3124,1491,162,169,331,48.9%,3m
1249,2,Timeout,3123,1557,205,190,395,51.9%,5m
1250,1,change,3122,257,9,5,14,64.3%,21m
1250,3,[忠勇义和]Houben,3122,0,1,0,1,100.0%,9m
1252,2,aura,3121,1558,94,92,186,50.5%,11m
1252,3,lIllIIIllII,3121,30,2,4,6,33.3%,6m
1254,3,下手,3120,0,1,0,1,100.0%,9m
1255,3,fifth,3119,0,1,2,3,33.3%,8m
1256,2,초보예요살살요,3118,0,4,2,6,66.7%,28m
1257,3,[Lio]Prism,3117,30,2,0,2,100.0%,9m
1258,2,Derosa,3116,928,34,40,74,45.9%,3m
1258,3,IIIIIIIIII,3116,118,2,5,7,28.6%,9m
1260,3,사운공,3115,95,5,1,6,83.3%,10m
1261,2,[나가자]동탄낙무아이짐,3114,1518,59,67,126,46.8%,9m
1262,3,막시무스,3113,0,1,0,1,100.0%,10m
1263,3,llllllllllll,3112,554,19,16,35,54.3%,8m
1263,3,안녕하세요,3112,95,2,0,2,100.0%,3m
1263,3,llllllllllll,3112,0,1,0,1,100.0%,6m
1263,3,메롱이다임마,3112,0,0,1,1,0.0%,10m
1267,2,블루밍,3111,0,1,4,5,20.0%,20m
1268,3,프다코,3110,196,7,6,13,53.8%,11m
1268,1,강뱅구,3110,0,4,5,9,44.4%,20m
1270,3,김대원,3109,338,18,18,36,50.0%,3m
1270,3,배리백,3109,0,0,1,1,0.0%,7m
1272,3,MinamOmega,3108,588,22,21,43,51.2%,8m
1272,2,DEUXIST,3108,294,14,14,28,50.0%,3m
1272,3,참새플레이어,3108,140,5,4,9,55.6%,10m
1272,3,철벽신기,3108,0,1,0,1,100.0%,3m
1276,2,BeSt,3107,1439,99,101,200,49.5%,9m
1276,3,MarxsiM,3107,251,11,6,17,64.7%,23m
1276,3,[KRSC2]초무홈,3107,0,0,1,1,0.0%,8m
1279,2,그저웃지요,3106,30,1,12,13,7.7%,11m
1280,3,[무한오영종]Nobody,3105,58,3,1,4,75.0%,6m
1281,2,[JST]PakKim,3104,1159,52,49,101,51.5%,7m
1281,1,lllIllllllll,3104,193,8,4,12,66.7%,20m
1281,3,[DokJag]Vulture,3104,0,0,1,1,0.0%,11m
1284,2,지영뚜,3103,1433,129,122,251,51.4%,3m
1284,3,북박북박,3103,1075,46,32,78,59.0%,6m
1284,3,Blueberry,3103,316,13,9,22,59.1%,6m
1284,3,wjdtjsals,3103,30,2,2,4,50.0%,6m
1284,3,신의반란,3103,0,0,1,1,0.0%,8m
1289,3,smalllake,3102,221,8,1,9,88.9%,9m
1289,3,Reds,3102,60,3,6,9,33.3%,3m
1289,3,양강칠,3102,0,1,0,1,100.0%,7m
1289,3,[QFE]charles,3102,0,0,1,1,0.0%,11m
1289,3,호궁스,3102,0,0,3,3,0.0%,8m
1294,2,울쭈폰가게,3101,1567,150,150,300,50.0%,3m
1295,3,Marinesnow,3100,0,0,1,1,0.0%,9m
1296,3,학익정준호,3099,857,39,26,65,60.0%,6m
1297,2,Bottchi,3098,0,2,3,5,40.0%,28m
1298,2,[겜동]hddgogogo,3097,919,33,35,68,48.5%,6m
1298,3,아이유,3097,479,19,8,27,70.4%,3m
1298,1,보라매,3097,213,9,9,18,50.0%,10m
1298,2,Kindragon,3097,0,5,1,6,83.3%,8m
1298,2,puerilesky,3097,48,2,5,7,28.6%,29m
1303,3,애플와치,3096,0,0,2,2,0.0%,6m
1304,2,[sc2mc]태양의눈물,3095,1467,73,67,140,52.1%,5m
1305,3,Crylee,3094,1068,53,48,101,52.5%,6m
1305,3,[TNO]likefish,3094,402,16,9,25,64.0%,5m
1307,3,악마,3093,307,13,13,26,50.0%,9m
1308,2,PessoReamer,3092,940,293,284,577,50.8%,3m
1308,2,[패자는피를]미르존,3092,714,29,24,53,54.7%,9m
1308,2,TooTo,3092,266,10,3,13,76.9%,53m
1308,3,[hl1234]scgreatagain,3092,208,8,9,17,47.1%,6m
1308,2,VideoKojima,3092,0,4,2,6,66.7%,29m
1308,3,UsadaPekora,3092,0,1,4,5,20.0%,11m
1308,3,白澤,3092,0,0,1,1,0.0%,10m
1315,3,핫윙,3091,1544,193,189,382,50.5%,7m
1315,2,용용이,3091,648,23,28,51,45.1%,8m
1315,3,예하,3091,144,5,5,10,50.0%,6m
1315,3,[TalenT]紅茄苳,3091,58,3,4,7,42.9%,4m
1315,3,Roy,3091,0,0,5,5,0.0%,8m
1320,2,에덴,3090,468,20,21,41,48.8%,9m
1321,3,[chak]PokerFace,3089,95,1,4,5,20.0%,9m
1322,3,니와까아메,3088,86,4,4,8,50.0%,4m
1322,3,[리더사피엔스]에이스준,3088,30,2,1,3,66.7%,10m
1324,2,Areskss,3087,511,66,55,121,54.5%,6m
1324,3,[스타리나잇]KBeSing,3087,1172,66,62,128,51.6%,10m
1326,3,뭉치멍멍,3085,1549,135,128,263,51.3%,8m
1326,1,예쁜척추,3085,191,6,6,12,50.0%,21m
1326,3,[DagmBa]EpicSaxGuy,3085,0,0,2,2,0.0%,6m
1329,1,[5torM]멀티플레이어,3084,770,28,34,62,45.2%,6m
1330,3,[Tara]OceanBaby,3083,0,0,2,2,0.0%,7m
1331,3,[NsP]오타쿠,3082,110,3,0,3,100.0%,9m
1332,3,Alexandros,3081,0,4,1,5,80.0%,7m
1333,1,형님,3080,238,6,9,15,40.0%,20m
1333,3,하하하하,3080,0,0,1,1,0.0%,10m
1335,3,Prove,3079,153,7,6,13,53.8%,9m
1335,3,한량신사,3079,88,3,9,12,25.0%,10m
1335,3,나르샤,3079,0,0,1,1,0.0%,6m
1338,3,jimmy,3078,122,11,8,19,57.9%,54m
1338,3,[CIA암살단]overthetop,3078,281,9,6,15,60.0%,6m
1338,3,타우렌드루이드,3078,263,9,10,19,47.4%,10m
1341,3,PoohaBest,3077,60,2,4,6,33.3%,10m
1341,3,불나방,3077,0,1,1,2,50.0%,8m
1343,3,stew,3076,562,28,9,37,75.7%,6m
1343,3,[강북멋쨍이]수유리전사,3076,370,16,14,30,53.3%,4m
1343,1,SOOM,3076,0,1,0,1,100.0%,20m
1346,3,꾸드득꾸드득,3075,343,51,44,95,53.7%,10m
1346,3,[DagmBa]StarTale,3075,270,9,12,21,42.9%,3m
1346,3,jodmangZerg,3075,30,2,1,3,66.7%,11m
1349,2,llllllllllll,3073,1572,584,583,1167,50.0%,9m
1349,2,lIlIlIlIlIlI,3073,128,7,6,13,53.8%,8m
1349,2,국정원래퍼노무현,3073,218,7,16,23,30.4%,6m
1352,3,[5E对战平台]luna,3072,0,2,3,5,40.0%,10m
1353,3,BLEss,3071,1064,47,34,81,58.0%,3m
1353,3,[0512]최이트,3071,95,1,1,2,50.0%,10m
1353,3,[lBenzI]illionaire,3071,0,0,1,1,0.0%,54m
1356,2,DrainNestea,3070,1564,168,158,326,51.5%,8m
1356,3,[PP1]柯文哲總統,3070,170,4,4,8,50.0%,7m
1358,3,장사장,3069,1445,209,189,398,52.5%,10m
1358,3,gerdel,3069,668,31,12,43,72.1%,10m
1358,2,TakeOfSoul,3069,96,4,2,6,66.7%,28m
1361,3,granty,3068,692,25,24,49,51.0%,10m
1361,3,애쉬크로프트,3068,230,8,9,17,47.1%,8m
1363,3,혁이아빠,3067,30,6,2,8,75.0%,10m
1363,3,canarensis,3067,0,4,1,5,80.0%,6m
1363,3,[경기도]빠따,3067,94,2,0,2,100.0%,3m
1366,3,[大招失敗秀]IIIIIIIIIIII,3066,321,13,8,21,61.9%,10m
1366,2,[시럽]아리아나동그란데,3066,379,13,26,39,33.3%,6m
1368,3,Malu,3065,30,2,1,3,66.7%,6m
1369,3,ABCD,3064,461,17,14,31,54.8%,3m
1369,3,HmmTroll,3064,108,3,0,3,100.0%,10m
1371,3,스테판커리,3063,430,16,17,33,48.5%,10m
1371,3,MintChoco,3063,30,5,3,8,62.5%,3m
1373,3,개기환,3062,1086,49,33,82,59.8%,3m
1373,3,Revolution,3062,30,1,2,3,33.3%,6m
1373,1,BlackJ,3062,97,1,2,3,33.3%,21m
1373,3,[SHARP]쒸프트끼가빠쪘뗘,3062,0,0,5,5,0.0%,4m
1377,1,혁준이,3061,1023,77,88,165,46.7%,6m
1377,3,[ESS]수미다,3061,435,21,22,43,48.8%,7m
1379,3,[Move]최강꾸드라,3060,30,2,1,3,66.7%,9m
1379,2,[시럽]Coc,3060,0,0,1,1,0.0%,28m
1381,3,외계인,3059,397,15,9,24,62.5%,7m
1381,3,fkd,3059,0,0,5,5,0.0%,10m
1383,3,Maru,3058,766,38,18,56,67.9%,3m
1383,3,DURUDURU,3058,248,9,10,19,47.4%,54m
1385,1,[너의ol름은]히틀러,3057,1094,56,56,112,50.0%,10m
1385,3,싸스는개잘생김,3057,1304,50,43,93,53.8%,3m
1385,3,곽소룡,3057,0,0,1,1,0.0%,7m
1385,3,[strong]앙투아네트,3057,0,0,2,2,0.0%,7m
1389,3,SIGMA,3055,0,0,1,1,0.0%,6m
1390,3,IIIIIIIIIIII,3054,1465,980,977,1957,50.1%,9m
1390,2,GacktSan,3054,1475,135,119,254,53.1%,5m
1390,2,[sc2mc]살뺄돈없어,3054,1522,110,106,216,50.9%,4m
1390,3,DOMINATOR,3054,199,6,3,9,66.7%,6m
1394,3,테란계약자,3053,766,33,24,57,57.9%,10m
1395,1,amelia,3052,219,4,4,8,50.0%,22m
1395,3,[골드킹]천재호랑일님,3052,60,2,4,6,33.3%,4m
1397,3,[시럽]멋쟁이,3050,501,37,28,65,56.9%,3m
1397,2,머순,3050,96,1,1,2,50.0%,27m
1399,2,[TeamNV]박서준,3049,1011,36,42,78,46.2%,8m
1399,3,[studio]박장군,3049,0,2,3,5,40.0%,3m
1401,2,날빌,3048,1203,175,183,358,48.9%,9m
1401,3,ShanaTTan,3048,570,21,23,44,47.7%,4m
1401,3,tpztmarine,3048,122,6,3,9,66.7%,10m
1401,2,이니그마,3048,116,5,3,8,62.5%,28m
1401,3,rnjswjddnrrn,3048,0,1,0,1,100.0%,11m
1401,3,SWINGS,3048,30,1,2,3,33.3%,11m
1407,3,해를사랑한구름,3045,0,0,2,2,0.0%,10m
1408,1,llllIIIlll,3044,319,13,11,24,54.2%,51m
1409,3,내가내다,3043,0,1,0,1,100.0%,10m
1410,3,깅강,3042,128,3,1,4,75.0%,10m
1411,3,Gordon,3041,1255,63,55,118,53.4%,3m
1411,3,구르는천둥,3041,1395,58,48,106,54.7%,3m
1411,3,섹쉬나딸구,3041,146,6,6,12,50.0%,5m
1411,3,iLLuSioN,3041,95,3,4,7,42.9%,5m
1415,3,시진핑의스타일기,3040,119,3,1,4,75.0%,3m
1416,3,마린,3039,1350,72,72,144,50.0%,6m
1417,3,고메넛츠,3037,60,3,4,7,42.9%,3m
1418,2,Luddagi,3036,0,1,2,3,33.3%,20m
1419,1,큰개자리,3034,126,5,1,6,83.3%,50m
1419,3,[김정은SC]KimJongUn,3034,30,2,3,5,40.0%,9m
1419,1,천연기념물티모,3034,0,1,0,1,100.0%,50m
1419,2,hyulch,3034,0,0,1,1,0.0%,29m
1423,2,한글,3033,748,66,62,128,51.6%,9m
1424,3,인연,3032,372,13,15,28,46.4%,6m
1424,3,GGOSinon,3032,30,4,4,8,50.0%,5m
1424,3,Sunday,3032,0,0,2,2,0.0%,6m
1427,2,발리순수보이,3031,1572,212,211,423,50.1%,6m
1427,2,브라우니,3031,1541,197,189,386,51.0%,5m
1427,3,대한민국서울,3031,1391,55,57,112,49.1%,7m
1427,2,[NANT]TerraNova,3031,460,47,39,86,54.7%,6m
1427,3,큰털보,3031,640,26,23,49,53.1%,3m
1427,3,Bucket,3031,150,7,3,10,70.0%,6m
1427,1,이걸지냐,3031,0,3,2,5,60.0%,50m
1434,3,[Nemian]데모닉,3030,978,39,36,75,52.0%,7m
1434,1,Impulse,3030,306,12,8,20,60.0%,50m
1436,2,Computer,3029,210,7,5,12,58.3%,20m
1436,3,[TMR]口加口里,3029,60,4,6,10,40.0%,10m
1436,1,IIiiIIiiiiii,3029,96,3,4,7,42.9%,21m
1439,2,sksus,3028,1437,83,91,174,47.7%,6m
1439,1,안정훈,3028,121,5,3,8,62.5%,51m
1439,1,JIN,3028,48,2,0,2,100.0%,20m
1439,1,Jarhead,3028,118,2,2,4,50.0%,20m
1439,1,[레전드]더스트박스,3028,90,1,1,2,50.0%,52m
1439,1,[SCCM]Hotdog,3028,0,0,1,1,0.0%,52m
1445,3,llladaree,3027,761,35,27,62,56.5%,7m
1445,3,다크쉘,3027,596,28,23,51,54.9%,10m
1445,1,[안녕Hi]speedghOst,3027,243,7,9,16,43.8%,20m
1445,2,许柯,3027,60,6,5,11,54.5%,3m
1445,2,LaCucaracha,3027,88,2,0,2,100.0%,54m
1445,3,[형님나가신다]불곰,3027,94,2,1,3,66.7%,6m
1451,3,MicroMarine,3026,122,4,9,13,30.8%,7m
1451,2,戰隊,3026,0,1,2,3,33.3%,29m
1453,3,troysky,3025,1047,44,36,80,55.0%,6m
1453,3,soso,3025,320,12,9,21,57.1%,6m
1453,3,유수,3025,248,7,8,15,46.7%,54m
1453,1,llllllllllll,3025,122,6,5,11,54.5%,22m
1453,3,Setzer,3025,191,5,5,10,50.0%,5m
1453,3,lllllllll,3025,0,0,6,6,0.0%,6m
1459,3,SAMclan,3024,550,21,25,46,45.7%,6m
1460,1,inkun,3023,1055,39,29,68,57.4%,52m
1461,2,MarineKing,3022,96,1,2,3,33.3%,20m
1462,3,IlIIIllIIIll,3021,1080,46,44,90,51.1%,5m
1463,3,[나잘란클랜]마카다미아,3020,153,6,8,14,42.9%,8m
1463,3,[지져스]자아분열증후군,3020,35,5,6,11,45.5%,7m
1465,1,[아니유]sad,3019,1112,59,7,66,89.4%,50m
1465,2,[에러스테이션]사라져라울트라,3019,183,5,0,5,100.0%,28m
1467,3,피파개망겜,3018,140,7,8,15,46.7%,6m
1467,1,[형님나가신다]다시돌아와,3018,44,1,1,2,50.0%,52m
1469,1,[Saints]세인츠로우,3017,792,33,29,62,53.2%,52m
1469,3,[IWYDI]ChiaHungWYD,3017,153,4,5,9,44.4%,3m
1471,3,TERAGREEN,3016,30,2,2,4,50.0%,7m
1472,1,Bisu,3015,0,0,1,1,0.0%,51m
1473,1,Mogsung,3014,252,8,6,14,57.1%,50m
1474,1,llllllllllll,3013,998,44,59,103,42.7%,5m
1474,3,Lawrence,3013,116,5,9,14,35.7%,5m
1474,1,DesTroyeR,3013,80,3,2,5,60.0%,52m
1474,3,캐주얼플레이어,3013,42,2,5,7,28.6%,7m
1474,2,Trump,3013,0,0,1,1,0.0%,28m
1479,3,한자임요,3012,158,5,3,8,62.5%,10m
1479,3,걸인,3012,0,0,1,1,0.0%,26m
1479,3,loonfactory,3012,0,0,2,2,0.0%,10m
1482,1,후구오,3011,0,0,2,2,0.0%,50m
1483,1,Kino,3010,0,3,2,5,60.0%,50m
1484,3,[예쁜김다미]니뒤통수에한발,3008,1529,132,123,255,51.8%,9m
1484,1,[시럽]강유,3008,271,8,2,10,80.0%,52m
1484,3,lIIlIIIIIlll,3008,88,4,5,9,44.4%,9m
1484,3,광녀,3008,114,2,7,9,22.2%,7m
1488,1,IMissYouGrMA,3006,1055,350,351,701,49.9%,52m
1488,3,SalmoSa,3006,0,1,2,3,33.3%,55m
1488,1,[잠꾸러기]흰색물감,3006,0,0,1,1,0.0%,52m
1491,3,MINE,3005,360,16,12,28,57.1%,9m
1492,2,[히오스부대]듀크뉴켐,3004,476,25,30,55,45.5%,11m
1493,3,EoS,3003,0,1,3,4,25.0%,54m
1494,3,폭풍저그,3002,386,15,16,31,48.4%,7m
1494,1,[실전파]DraKeLivE,3002,0,0,1,1,0.0%,52m
1496,3,BrianWang,3000,1381,68,64,132,51.5%,7m
1496,1,비니루,3000,0,1,1,2,50.0%,52m
1498,2,OOXIXOO,2999,798,30,36,66,45.5%,11m
1498,3,Nieva,2999,172,8,5,13,61.5%,10m
1500,3,Demitreat,2998,986,94,83,177,53.1%,7m
1500,3,[체계지원실]이구칠구,2998,0,0,1,1,0.0%,27m
1502,1,llllllllllll,2997,875,34,22,56,60.7%,50m
1502,3,ChuckLin,2997,300,11,17,28,39.3%,5m
1502,1,기악부,2997,0,3,2,5,60.0%,50m
1505,1,[NODE]gist,2994,1321,49,40,89,55.1%,51m
1505,3,[스투쓰레기]병신게임,2994,240,9,10,19,47.4%,10m
1505,1,[다성단]다성현,2994,40,2,1,3,66.7%,50m
1508,2,WalaWala,2993,1525,177,159,336,52.7%,11m
1508,3,Brakden,2993,250,9,12,21,42.9%,3m
1508,3,llllllllllll,2993,40,3,3,6,50.0%,26m
1508,3,lIlIlIlIlIlI,2993,134,3,4,7,42.9%,7m
1508,1,[PC군단]청담노랭이,2993,40,2,0,2,100.0%,52m
1513,2,조불랙,2992,1466,279,267,546,51.1%,9m
1514,2,[애니멀킹덤]천사고양이,2990,1473,274,271,545,50.3%,3m
1514,2,[오골계]CJML,2990,1290,67,66,133,50.4%,5m
1514,3,akikiki,2990,122,4,10,14,28.6%,6m
1514,1,마이클색슨,2990,0,0,1,1,0.0%,51m
1518,1,KoshNaranek,2989,46,2,2,4,50.0%,52m
1518,1,[조국무죄]군대영장,2989,0,0,3,3,0.0%,51m
1520,2,[NLTN]이름은하나다,2988,1110,69,66,135,51.1%,11m
1520,1,어린아저씨,2988,32,4,3,7,57.1%,52m
1522,2,Diomedes,2987,1062,68,65,133,51.1%,6m
1522,1,IIIIllIIIllI,2987,108,3,2,5,60.0%,50m
1524,3,plaguedog,2986,1495,169,159,328,51.5%,3m
1524,1,[Hyeri]killering,2986,505,20,13,33,60.6%,52m
1524,3,[훈련소]불꽃류진바람,2986,0,0,1,1,0.0%,27m
1527,1,LuXuRy,2985,428,12,12,24,50.0%,52m
1527,1,뿍스,2985,66,4,5,9,44.4%,50m
1527,2,Hoegaarden,2985,46,2,1,3,66.7%,28m
1530,3,Terran,2983,689,148,128,276,53.6%,7m
1531,1,[이터널]김첨지,2982,481,16,14,30,53.3%,52m
1532,3,청천,2981,1549,343,349,692,49.6%,9m
1532,3,藤梓荊,2981,120,30,28,58,51.7%,10m
1532,1,WickedSick,2981,136,7,9,16,43.8%,51m
1535,1,동백꽃필무렵,2980,582,42,38,80,52.5%,52m
1535,3,jade,2980,528,18,18,36,50.0%,10m
1535,1,Ctstrphy,2980,413,16,7,23,69.6%,52m
1535,3,StrongManKR,2980,145,6,5,11,54.5%,3m
1535,2,유사장,2980,94,5,2,7,71.4%,29m
1535,1,[noToss]Warpcraft,2980,96,2,0,2,100.0%,50m
1535,1,[이터널]갯지렁이스파게티,2980,0,1,0,1,100.0%,50m
1535,1,Yalos,2980,0,1,4,5,20.0%,50m
1543,2,BoomBoom,2979,94,3,17,20,15.0%,3m
1544,1,lllllllllll,2978,0,1,0,1,100.0%,52m
1545,2,얼굴이초난감,2977,1507,235,221,456,51.5%,8m
1546,1,IIIIIIIIIIII,2976,0,2,1,3,66.7%,50m
1546,1,정경수,2976,0,0,2,2,0.0%,52m
1548,1,SEBIN,2975,119,3,5,8,37.5%,50m
1548,3,SKTIBANKY,2975,62,3,5,8,37.5%,9m
1548,1,woowa,2975,0,1,0,1,100.0%,22m
1551,1,코로나종식기원,2974,1624,124,104,228,54.4%,50m
1551,1,bdot,2974,268,7,5,12,58.3%,51m
1553,3,[노인성듀오]련남동터프쿠키,2973,93,2,4,6,33.3%,5m
1553,3,InTheClub,2973,0,1,2,3,33.3%,10m
1555,1,IIIIIlllllII,2971,80,3,2,5,60.0%,52m
1555,1,RedMango,2971,82,2,4,6,33.3%,51m
1557,3,니코로빈,2970,346,11,17,28,39.3%,3m
1558,1,신빛,2968,326,9,9,18,50.0%,51m
1558,3,sOs,2968,192,8,11,19,42.1%,6m
1558,3,[목라인]jkljkl,2968,146,4,3,7,57.1%,23m
1561,1,muyayo,2967,0,0,1,1,0.0%,52m
1562,3,가을하늘별,2966,1394,165,164,329,50.2%,6m
1562,3,balanced,2966,309,13,12,25,52.0%,6m
1564,1,더블수,2965,1534,267,274,541,49.4%,10m
1564,3,faithguy,2965,1321,82,79,161,50.9%,7m
1564,3,[MAD용병]사람인,2965,785,33,26,59,55.9%,3m
1567,1,스타강사,2964,1644,130,122,252,51.6%,52m
1567,1,marketwizard,2964,1426,72,59,131,55.0%,50m
1567,3,코파라,2964,435,15,17,32,46.9%,6m
1567,1,我們班沒女生,2964,184,5,5,10,50.0%,52m
1567,3,뭐여시발돌려줘요,2964,0,3,2,5,60.0%,26m
1567,3,凹凹凸凸的光,2964,62,2,5,7,28.6%,6m
1567,1,Super,2964,14,2,5,7,28.6%,50m
1574,1,자러감수고바위,2963,0,3,2,5,60.0%,50m
1575,1,caminim,2962,32,2,2,4,50.0%,50m
1575,1,zandR,2962,38,2,2,4,50.0%,51m
1577,1,라라,2961,0,0,1,1,0.0%,51m
1578,1,Jammie,2960,622,22,17,39,56.4%,52m
1579,1,phm,2959,632,22,19,41,53.7%,51m
1580,3,VANHELSING,2958,1497,82,73,155,52.9%,3m
1580,1,IIIIIIIIIIII,2958,40,1,2,3,33.3%,50m
1582,3,Synthese,2957,1558,287,285,572,50.2%,7m
1582,3,[hanC]hanQ,2957,688,24,28,52,46.2%,10m
1584,3,mint,2956,1495,254,237,491,51.7%,7m
1584,3,꾸벅민이,2956,192,5,9,14,35.7%,7m
1586,1,자유에날개,2955,686,22,22,44,50.0%,51m
1586,1,Edge,2955,275,14,10,24,58.3%,51m
1586,1,레전드,2955,108,3,3,6,50.0%,52m
1586,2,루꽝,2955,0,3,3,6,50.0%,27m
1586,1,GiveMeMerc,2955,0,2,3,5,40.0%,51m
1591,3,[유즈맵떠돌이]썬더데커던트,2954,1751,323,516,839,38.5%,3m
1591,2,[BRNZ]쩌리,2954,0,1,0,1,100.0%,29m
1593,3,llllllllllll,2952,1256,57,49,106,53.8%,7m
1593,1,休閒的小玩家,2952,222,7,6,13,53.8%,50m
1593,2,sss,2952,0,1,0,1,100.0%,28m
1593,1,빨갱이토토로,2952,40,1,3,4,25.0%,52m
1597,1,밥먹고하자고,2951,890,30,29,59,50.8%,51m
1597,3,leon,2951,243,8,10,18,44.4%,7m
1599,1,법정대리인,2950,809,33,24,57,57.9%,52m
1600,1,[SHIPS]Stealth,2949,220,8,2,10,80.0%,50m
1600,1,GoFMidoCN,2949,82,6,3,9,66.7%,52m
1600,3,剛毅木訥,2949,133,5,2,7,71.4%,27m
1600,1,Sushihi,2949,0,0,1,1,0.0%,50m
1604,3,[독도비둘기]xipanda,2948,30,6,0,6,100.0%,27m
1604,1,[KOSEAL]퇴교생,2948,198,5,10,15,33.3%,50m
1606,3,HotSoup,2947,1531,133,128,261,51.0%,7m
1606,1,[CoCoA]ios,2947,146,5,4,9,55.6%,52m
1606,1,멍청한지휘관,2947,78,3,2,5,60.0%,51m
1609,1,Stanley,2946,88,4,2,6,66.7%,52m
1609,1,핫쵸쵸,2946,0,3,2,5,60.0%,50m
1609,1,천하스타,2946,0,1,4,5,20.0%,50m
1609,3,케이트록웰,2946,0,0,1,1,0.0%,27m
1613,1,[WTSC]프롤레타리아,2945,130,5,3,8,62.5%,52m
1614,1,[더지니어스]김폰벨,2944,146,5,5,10,50.0%,52m
1614,1,Tyrr,2944,0,1,0,1,100.0%,52m
1614,3,KAY,2944,0,1,0,1,100.0%,27m
1614,1,cosi,2944,0,1,0,1,100.0%,20m
1614,1,은밀한생,2944,0,0,2,2,0.0%,52m
1614,1,[패튼전차]我是韩国人,2944,0,0,3,3,0.0%,51m
1620,3,황혼,2942,965,43,48,91,47.3%,4m
1620,3,SpyAlien,2942,114,23,24,47,48.9%,8m
1620,1,LastRoad,2942,0,3,2,5,60.0%,50m
1623,3,InSomnia,2941,388,17,20,37,45.9%,4m
1624,1,Ost,2940,217,17,5,22,77.3%,52m
1624,3,Ryan,2940,0,1,1,2,50.0%,27m
1626,3,민준아빠,2939,437,17,18,35,48.6%,9m
1626,1,이진형,2939,0,1,0,1,100.0%,52m
1628,3,오우짜스,2937,168,4,5,9,44.4%,23m
1629,1,Rush,2936,512,18,12,30,60.0%,52m
1629,1,luckcoo,2936,132,5,0,5,100.0%,50m
1631,1,이즈리이얼산스,2935,186,6,2,8,75.0%,50m
1631,3,고냥이,2935,97,4,2,6,66.7%,27m
1631,1,ScIIMobile,2935,88,2,0,2,100.0%,52m
1631,1,피구공,2935,34,2,1,3,66.7%,52m
1631,1,ssangba,2935,0,0,1,1,0.0%,51m
1636,3,[Bliss]BARCODE,2934,989,37,34,71,52.1%,6m
1636,1,[손틈새비치는]아이유참좋다,2934,180,7,2,9,77.8%,52m
1638,1,파란고래,2933,0,1,0,1,100.0%,50m
1639,1,일분일초,2931,130,4,2,6,66.7%,50m
1639,3,[Malsub]ARAGON,2931,0,1,0,1,100.0%,27m
1641,3,Scorpius,2930,1096,47,40,87,54.0%,7m
1642,3,YOHOHO,2929,1554,184,172,356,51.7%,5m
1642,1,[RAID]강승부현이,2929,243,6,5,11,54.5%,51m
1642,1,[저그군락]최강저그,2929,104,3,5,8,37.5%,52m
1645,1,고구마고광진,2928,177,6,2,8,75.0%,52m
1646,1,ltuhjl,2927,88,4,2,6,66.7%,51m
1646,1,독서기록장,2927,0,1,0,1,100.0%,52m
1648,3,렉걸려라얍얍,2926,521,20,21,41,48.8%,6m
1648,1,[비트]개가튼,2926,274,9,10,19,47.4%,52m
1648,2,llllllllllll,2926,94,1,3,4,25.0%,29m
1651,1,komanic,2925,0,0,1,1,0.0%,22m
1651,1,StrikeG,2925,0,0,1,1,0.0%,21m
1653,1,박밝음,2924,1328,122,121,243,50.2%,52m
1653,3,홈런볼,2924,0,0,1,1,0.0%,27m
1655,1,[이터널]김재윤,2923,0,1,0,1,100.0%,52m
1655,3,이도형,2923,0,0,1,1,0.0%,26m
1657,1,철갑군단장,2922,1477,147,159,306,48.0%,10m
1657,1,[M4]IIIIIIIIIIII,2922,891,38,30,68,55.9%,52m
1657,1,qwer,2922,181,7,2,9,77.8%,50m
1657,2,[아기곰의하루]Happy,2922,0,0,1,1,0.0%,29m
1661,1,[바코드군단]llllll,2921,0,0,1,1,0.0%,52m
1661,1,Daniel,2921,0,0,3,3,0.0%,51m
1663,1,정원용,2920,380,12,13,25,48.0%,52m
1663,1,llllllllllll,2920,40,2,1,3,66.7%,52m
1665,2,Car,2919,30,1,1,2,50.0%,54m
1666,1,allalio,2918,625,25,19,44,56.8%,50m
1666,2,[제주녹차라떼]Maxintelly,2918,0,0,1,1,0.0%,49m
1668,2,도라이몽키,2916,0,3,2,5,60.0%,49m
1669,3,서점주인장,2915,746,25,30,55,45.5%,8m
1669,1,왕초보,2915,485,16,16,32,50.0%,52m
1669,1,IIIlllIII,2915,188,5,4,9,55.6%,52m
1669,2,강낭콩,2915,0,0,1,1,0.0%,28m
1673,3,[VASCO]해랑사,2914,557,22,21,43,51.2%,3m
1674,2,holyofangels,2913,0,1,0,1,100.0%,53m
1674,1,Sniper,2913,40,1,4,5,20.0%,50m
1676,1,정자왕프라임,2912,266,8,5,13,61.5%,52m
1676,1,Android,2912,164,5,4,9,55.6%,51m
1676,3,[카봇]Joon,2912,30,4,6,10,40.0%,3m
1676,3,Happyperson,2912,0,1,1,2,50.0%,27m
1680,2,쫘파게티문재인,2911,1230,91,93,184,49.5%,9m
1680,2,[고풍용맹]Bow,2911,30,4,3,7,57.1%,49m
1682,1,CLaUs,2910,235,8,11,19,42.1%,21m
1682,1,상은이의하루,2910,0,1,1,2,50.0%,50m
1682,3,홍진호,2910,0,0,2,2,0.0%,26m
1685,2,Solindar,2909,0,2,3,5,40.0%,49m
1686,2,bangty,2908,1543,425,404,829,51.3%,4m
1686,3,llllllllllll,2908,142,4,10,14,28.6%,7m
1688,1,[진격의]희야,2907,158,5,6,11,45.5%,52m
1688,3,海豹球,2907,0,1,4,5,20.0%,26m
1690,2,내목숨을자치령에,2906,566,24,28,52,46.2%,11m
1690,1,scvskawk,2906,78,3,4,7,42.9%,52m
1692,2,presenT,2905,182,8,6,14,57.1%,28m
1693,1,DeCoy,2904,490,17,18,35,48.6%,52m
1693,1,닥돌,2904,0,1,2,3,33.3%,52m
1695,3,[深耕C]PrAy,2903,1372,57,52,109,52.3%,7m
1695,1,hojun,2903,360,12,11,23,52.2%,52m
1695,2,아리스트스세,2903,94,2,7,9,22.2%,29m
1698,3,IIIIII,2902,330,13,11,24,54.2%,23m
1698,3,[으리군주]DirtyCrow,2902,0,4,1,5,80.0%,26m
1698,1,皮勒斯,2902,0,1,1,2,50.0%,50m
1698,1,한지,2902,0,0,4,4,0.0%,52m
1702,1,[Badman]이유진,2901,159,5,3,8,62.5%,50m
1702,1,ken,2901,90,1,2,3,33.3%,51m
1704,1,황제,2900,36,1,4,5,20.0%,50m
1705,2,잿빛향기,2899,60,3,1,4,75.0%,54m
1705,2,캡틴짱,2899,0,1,0,1,100.0%,29m
1705,3,[이저세계]FoxShio,2899,0,0,3,3,0.0%,27m
1708,3,뽑아보니일꾼,2898,862,40,37,77,51.9%,10m
1708,2,운좋은올빼미,2898,99,1,5,6,16.7%,54m
1708,2,speaknow,2898,0,0,2,2,0.0%,28m
1711,1,bboykid,2897,304,13,9,22,59.1%,50m
1711,1,RedRaccoon,2897,0,2,3,5,40.0%,51m
1713,1,개초보임살살요,2895,1625,182,167,349,52.1%,52m
1713,1,terran,2895,1652,111,91,202,55.0%,52m
1713,3,[붙어라]oajnrtnf,2895,774,75,72,147,51.0%,4m
1713,3,Yoona,2895,1403,64,92,156,41.0%,5m
1713,1,Shinewarrior,2895,207,9,9,18,50.0%,52m
1713,1,武汉加油中国加油,2895,74,3,6,9,33.3%,51m
1713,1,다그바,2895,0,1,0,1,100.0%,20m
1720,1,GoaulD,2894,262,9,6,15,60.0%,52m
1720,1,[무한양승준]Yuraeha,2894,36,2,3,5,40.0%,52m
1722,1,헬로모토,2893,838,40,24,64,62.5%,50m
1722,1,lain,2893,542,29,23,52,55.8%,52m
1722,1,KeiFromNYC,2893,782,29,29,58,50.0%,52m
1722,1,한번만,2893,224,9,7,16,56.2%,21m
1722,2,[습격자까마귀]오토모빌,2893,86,3,1,4,75.0%,54m
1722,3,SoSYang,2893,0,2,4,6,33.3%,27m
1728,1,초보라고놀리지말,2892,456,16,18,34,47.1%,52m
1728,1,MagicKim,2892,323,10,8,18,55.6%,51m
1730,1,[문재앙씨발놈]신안노예출신,2891,1236,97,74,171,56.7%,52m
1730,2,에렌디라,2891,32,1,2,3,33.3%,53m
1732,1,[123iN]일방인,2890,198,7,9,16,43.8%,52m
1732,1,아무나,2890,159,7,10,17,41.2%,52m
1732,3,dairyproduct,2890,0,3,2,5,60.0%,27m
1735,1,ikmsisky,2889,256,10,8,18,55.6%,50m
1735,2,[ZN]SMandH,2889,0,3,2,5,60.0%,49m
1737,2,[자지와보1지]머린,2888,442,17,14,31,54.8%,54m
1737,3,[WINTR]Winter,2888,440,14,25,39,35.9%,9m
1737,2,臭皮出來玩,2888,40,2,1,3,66.7%,53m
1740,2,[조직]동수파파,2887,564,20,16,36,55.6%,53m
1741,1,[조직]skywalker,2885,1501,97,86,183,53.0%,50m
1741,3,[해피투게더]TRoll,2885,694,25,26,51,49.0%,10m
1741,1,[넌없고난있어]애인있거든요,2885,114,3,5,8,37.5%,50m
1744,3,[Insane]후추,2882,1523,93,81,174,53.4%,10m
1744,1,CAT,2882,1017,34,34,68,50.0%,52m
1744,1,BioMan,2882,124,7,2,9,77.8%,50m
1747,2,마린보이,2881,30,1,1,2,50.0%,53m
1748,2,[TMR]yehyi,2880,0,1,1,2,50.0%,53m
1749,3,combative,2879,1060,45,48,93,48.4%,4m
1749,2,殘奘取經,2879,302,11,11,22,50.0%,54m
1749,1,holy,2879,140,6,8,14,42.9%,52m
1749,2,[근본은말보루]주태양,2879,112,3,4,7,42.9%,53m
1749,3,[머구폐렴]설원기설,2879,0,1,0,1,100.0%,27m
1749,2,[공략]라이츄봇,2879,0,1,0,1,100.0%,49m
1749,3,가을스케치,2879,0,0,1,1,0.0%,26m
1756,1,梅梅,2878,867,37,33,70,52.9%,51m
1757,1,接米令,2877,1626,246,256,502,49.0%,50m
1757,1,찾았다휴,2877,1616,101,90,191,52.9%,51m
1757,1,ShadowTroll,2877,90,4,3,7,57.1%,52m
1760,2,Brandeis,2876,180,5,2,7,71.4%,53m
1760,3,Katsu,2876,30,1,5,6,16.7%,3m
1762,2,맛있는청국장,2875,220,8,8,16,50.0%,53m
1763,1,TechnicalKim,2873,454,14,17,31,45.2%,52m
1763,2,토스최고,2873,30,2,0,2,100.0%,53m
1765,3,스타,2872,1157,102,99,201,50.7%,9m
1765,3,닉쿤,2872,390,15,17,32,46.9%,10m
1765,1,vip,2872,292,13,15,28,46.4%,50m
1765,2,闇焰風暴,2872,0,3,2,5,60.0%,54m
1765,2,단팥펭귄,2872,0,1,0,1,100.0%,49m
1765,2,쥬지딴딴넣을게,2872,0,0,1,1,0.0%,49m
1771,2,시끈남,2870,701,31,27,58,53.4%,53m
1771,2,사람사냥꾼,2870,104,3,0,3,100.0%,28m
1773,1,척추사단접기,2868,506,19,20,39,48.7%,52m
1773,2,cozy,2868,257,10,9,19,52.6%,53m
1773,2,kop,2868,317,9,10,19,47.4%,49m
1773,2,박아라,2868,302,9,14,23,39.1%,54m
1777,1,Crema,2867,0,0,2,2,0.0%,21m
1778,1,kwon,2866,204,6,9,15,40.0%,50m
1779,3,마한판붙어보자마,2865,97,4,2,6,66.7%,27m
1779,2,[S0fT]Reet,2865,90,4,3,7,57.1%,53m
1779,2,[비트]lIlIlIlIlIlI,2865,0,0,1,1,0.0%,54m
1782,2,어드레스,2863,88,4,2,6,66.7%,50m
1782,2,sopantalia,2863,58,2,1,3,66.7%,49m
1784,1,Vanishment,2862,1575,58,57,115,50.4%,52m
1784,1,zoon,2862,304,11,10,21,52.4%,50m
1784,2,카레우동,2862,0,0,1,1,0.0%,54m
1787,1,[보스모드]모나크,2860,0,2,3,5,40.0%,26m
1788,3,힘내라우덩재,2859,1448,775,763,1538,50.4%,11m
1789,2,[Rebel]달려달려,2858,0,0,1,1,0.0%,49m
1790,2,비겁한,2857,416,14,13,27,51.9%,54m
1790,2,Mute,2857,136,6,3,9,66.7%,49m
1790,1,dydy,2857,0,3,2,5,60.0%,26m
1793,2,Mist,2856,1104,50,28,78,64.1%,54m
1794,1,eric,2855,551,16,24,40,40.0%,52m
1794,2,zenius,2855,60,3,1,4,75.0%,54m
1796,2,동구밖과수원샷,2854,286,9,8,17,52.9%,53m
1796,2,JIMCHOO,2854,0,0,1,1,0.0%,49m
1798,2,[SC2HK]KiwkofSoLo,2853,30,2,0,2,100.0%,53m
1798,2,호연지기,2853,0,0,3,3,0.0%,53m
1800,2,[한국남자]FreeRun,2852,565,25,23,48,52.1%,54m
1800,2,마스터티어,2852,415,16,9,25,64.0%,53m
1800,2,[Equal]ReyNor,2852,300,11,11,22,50.0%,54m
1800,1,llllllllllll,2852,216,5,8,13,38.5%,52m
1804,1,라디드,2851,234,9,15,24,37.5%,52m
1805,2,[INFNO]芒果乾,2850,60,3,1,4,75.0%,49m
1806,1,그거슨헤팝,2849,1579,111,102,213,52.1%,51m
1807,2,띵똥,2848,762,29,24,53,54.7%,53m
1807,1,OuO,2848,690,20,30,50,40.0%,50m
1809,3,arous,2846,1434,60,60,120,50.0%,8m
1810,1,XiGinPinkGay,2845,578,20,23,43,46.5%,52m
1810,1,오키타안리,2845,93,2,4,6,33.3%,52m
1810,3,마쉬마로,2845,0,1,1,2,50.0%,27m
1810,2,방구는자연의하품,2845,0,1,1,2,50.0%,53m
1814,3,톰토맹,2844,743,72,70,142,50.7%,11m
1814,2,후로게이머,2844,1565,64,49,113,56.6%,54m
1814,2,oDiNe,2844,98,3,8,11,27.3%,54m
1814,2,[유돈해브마미]beeshop,2844,30,1,2,3,33.3%,49m
1818,2,廣風玄石,2843,1520,800,792,1592,50.3%,9m
1818,1,[나가자]Master,2843,1553,55,61,116,47.4%,51m
1820,2,[개미별의부활]나와호랑이님,2842,0,0,1,1,0.0%,49m
1821,2,SoSimple,2841,798,31,22,53,58.5%,50m
1821,2,AFK,2841,0,0,1,1,0.0%,49m
1823,1,[REGENO]baggio,2840,244,7,12,19,36.8%,52m
1823,2,wjik,2840,0,4,1,5,80.0%,49m
1823,2,CitadelOfWar,2840,114,4,4,8,50.0%,53m
1823,2,超新星,2840,0,0,1,1,0.0%,54m
1827,1,람도,2839,1575,93,92,185,50.3%,52m
1827,2,[봉다리]비니루,2839,398,14,19,33,42.4%,54m
1827,2,세종대왕,2839,132,6,6,12,50.0%,28m
1830,1,[음식점]통스팸구이,2838,114,3,11,14,21.4%,52m
1831,2,GHOSTDARKNES,2837,314,11,7,18,61.1%,54m
1831,2,[실력의기원]오줌싸게준이,2837,156,6,3,9,66.7%,54m
1833,1,존페트루치,2835,1515,155,155,310,50.0%,52m
1833,2,태영이는은희꺼,2835,692,25,24,49,51.0%,53m
1833,1,[수사]MarusParty,2835,191,6,4,10,60.0%,22m
1833,2,카페인쿠키,2835,60,2,3,5,40.0%,53m
1833,2,ohmduph,2835,32,1,5,6,16.7%,54m
1838,3,샤샤샤샷,2834,396,13,24,37,35.1%,7m
1838,2,악동,2834,62,2,2,4,50.0%,53m
1840,3,MAX,2833,1451,79,91,170,46.5%,6m
1840,2,MASTERXENON,2833,381,15,9,24,62.5%,53m
1842,3,TnT,2831,1556,374,356,730,51.2%,7m
1842,2,지후아빠,2831,0,0,1,1,0.0%,54m
1844,2,[C89923]MrTrump,2830,0,0,1,1,0.0%,29m
1845,2,[WTSC]건치미소,2829,728,30,19,49,61.2%,50m
1845,2,간바레,2829,204,7,5,12,58.3%,53m
1845,2,Lotus,2829,88,5,1,6,83.3%,49m
1845,2,드래곤,2829,151,5,5,10,50.0%,49m
1849,2,OpTiMusPrime,2828,1051,45,43,88,51.1%,49m
1849,2,[燚燚燚燚燚燚]llllllllllll,2828,1044,43,41,84,51.2%,54m
1849,1,coorsllte,2828,415,14,16,30,46.7%,52m
1849,2,idfgot,2828,88,4,3,7,57.1%,49m
1849,2,쌔게해,2828,88,3,3,6,50.0%,49m
1854,2,台灣留岛不留人,2827,1483,145,139,284,51.1%,9m
1855,2,붉은감자,2826,0,1,0,1,100.0%,20m
1856,2,으흐흐저리가,2825,715,29,24,53,54.7%,49m
1856,2,HeroLeader,2825,222,8,10,18,44.4%,53m
1856,3,[내사랑슬기찡]마게촌빠돌이터미,2825,40,4,4,8,50.0%,27m
1859,2,KDBwo,2824,703,29,19,48,60.4%,53m
1859,2,가을하늘,2824,165,6,5,11,54.5%,29m
1859,1,[넷중에]우리편만뵹쉰유유,2824,0,1,0,1,100.0%,25m
1859,3,RobSui,2824,30,1,1,2,50.0%,27m
1863,2,BGdevilin,2821,377,16,13,29,55.2%,49m
1864,3,[트롤처리반장]중재중재,2820,1127,78,78,156,50.0%,7m
1864,2,achahai,2820,500,26,25,51,51.0%,53m
1864,2,Celeste,2820,0,0,2,2,0.0%,49m
1867,2,BladeOfAiur,2819,0,1,0,1,100.0%,54m
1868,2,[어둠의사신단]어둠의기사,2818,0,1,0,1,100.0%,49m
1869,1,네이머,2817,284,10,17,27,37.0%,52m
1869,2,플로랑로시에르,2817,0,4,1,5,80.0%,49m
1869,2,[ELS]Whale,2817,0,1,1,2,50.0%,53m
1869,2,llllllllllll,2817,0,0,1,1,0.0%,53m
1873,2,[무능한일당들]몰랑찡,2816,130,4,1,5,80.0%,54m
1873,2,siheon,2816,30,3,4,7,42.9%,49m
1875,2,Sam,2815,1550,75,69,144,52.1%,53m
1875,2,DRSTRANGE,2815,102,2,1,3,66.7%,54m
1875,3,둥둥깜,2815,0,0,1,1,0.0%,26m
1878,2,pray,2814,132,5,12,17,29.4%,20m
1878,2,兇兇肥婆,2814,144,3,2,5,60.0%,53m
1880,2,RecycleBin,2813,863,34,28,62,54.8%,53m
1881,3,천사자,2812,1474,75,72,147,51.0%,3m
1881,2,jason,2812,206,7,5,12,58.3%,53m
1881,2,juwon,2812,88,1,1,2,50.0%,53m
1884,2,[MET]화재시대피요령,2811,88,1,1,2,50.0%,54m
1884,3,[찹쌀모찌]크으취한다,2811,40,1,1,2,50.0%,27m
1886,1,[zAWSLz]aaaa,2810,454,25,22,47,53.2%,52m
1886,2,DKOFI,2810,114,4,2,6,66.7%,54m
1888,2,kcawnsgh,2809,172,6,9,15,40.0%,53m
1888,2,변돌군,2809,156,5,4,9,55.6%,54m
1888,2,spionaggio,2809,0,2,4,6,33.3%,49m
1888,3,일리네어,2809,0,0,1,1,0.0%,27m
1892,2,죽음의사신,2808,30,1,2,3,33.3%,53m
1892,2,히페리온준형테란,2808,0,1,2,3,33.3%,53m
1894,2,藍金黃之黃色,2807,954,38,37,75,50.7%,49m
1894,2,IIIIIIIIIIII,2807,485,14,20,34,41.2%,53m
1894,1,eyah,2807,294,11,17,28,39.3%,50m
1894,3,불타는고구마,2807,201,5,3,8,62.5%,42m
1894,1,guttedbro,2807,181,4,5,9,44.4%,20m
1899,2,kkifree,2806,211,9,10,19,47.4%,29m
1900,3,武漢肺炎,2805,147,4,4,8,50.0%,26m
1900,2,jkpxT,2805,88,1,1,2,50.0%,50m
1902,2,치느님,2804,144,6,5,11,54.5%,53m
1903,2,BUNTUTS,2803,0,1,1,2,50.0%,54m
1904,2,llllllllllll,2802,476,20,10,30,66.7%,53m
1904,1,로봇자객,2802,0,2,4,6,33.3%,25m
1906,2,습니다,2801,504,31,21,52,59.6%,53m
1906,3,[잉제링이]llllllllllll,2801,171,9,10,19,47.4%,10m
1906,2,RavenADW,2801,208,6,9,15,40.0%,28m
1909,3,팽민우,2798,419,19,16,35,54.3%,11m
1910,1,IIIIIIIIIIII,2796,116,4,6,10,40.0%,50m
1910,2,나는꼼수다,2796,30,1,5,6,16.7%,54m
1912,2,[Xbaek]Infinity,2795,0,2,3,5,40.0%,54m
1912,2,앙마데,2795,88,1,2,3,33.3%,50m
1912,1,Piao,2795,0,1,4,5,20.0%,24m
1912,1,[어둠의사신단]어둠의검신,2795,0,0,4,4,0.0%,50m
1916,2,세이진,2792,815,78,68,146,53.4%,54m
1916,1,이소융,2792,766,38,43,81,46.9%,52m
1916,3,감사합니다람쥐,2792,391,13,23,36,36.1%,10m
1919,1,burai,2791,0,0,2,2,0.0%,25m
1920,1,정영훈,2790,432,17,25,42,40.5%,52m
1920,1,magicprotoss,2790,96,3,4,7,42.9%,26m
1920,3,yolo,2790,30,2,0,2,100.0%,54m
1923,3,Piggy,2789,197,7,6,13,53.8%,49m
1923,2,zkfkzk,2789,114,4,4,8,50.0%,49m
1923,3,intellect,2789,97,1,1,2,50.0%,27m
1926,2,[DMN]口休口休,2788,416,16,14,30,53.3%,54m
1927,2,CuT,2787,86,4,7,11,36.4%,49m
1927,2,RyoKo,2787,102,2,2,4,50.0%,53m
1929,3,Stephoned,2786,291,18,15,33,54.5%,55m
1929,2,GIANT,2786,226,8,9,17,47.1%,53m
1929,2,Eden,2786,30,2,3,5,40.0%,49m
1932,2,习近平,2785,416,50,54,104,48.1%,54m
1932,2,셰프도현,2785,487,16,19,35,45.7%,50m
1932,2,onlyonekill,2785,0,0,3,3,0.0%,54m
1935,1,군단을위하여,2783,840,31,32,63,49.2%,52m
1935,2,[문재앙씨발놈]호날두가조아,2783,476,19,19,38,50.0%,53m
1935,1,FirstLotus,2783,340,10,20,30,33.3%,52m
1935,2,게으른천재,2783,30,2,3,5,40.0%,50m
1939,1,[스타놀이터]둘리,2781,0,3,4,7,42.9%,52m
1940,1,블뤼자드,2780,1488,356,359,715,49.8%,11m
1940,2,[CnB]소중중야,2780,341,13,10,23,56.5%,54m
1940,2,[sc2mc]Destiny,2780,0,0,1,1,0.0%,28m
1940,2,[케살]dkffdkdkdkdk,2780,0,0,2,2,0.0%,29m
1944,2,[如何]BadGirl,2778,248,28,30,58,48.3%,53m
1945,1,[성원제자]주키코모리,2777,121,3,5,8,37.5%,50m
1945,3,EveryLevel,2777,0,1,1,2,50.0%,23m
1945,3,박핑크,2777,30,1,1,2,50.0%,23m
1948,3,홍진호,2776,506,19,18,37,51.4%,54m
1949,1,Vulcan,2775,193,8,7,15,53.3%,50m
1950,2,Ayao,2773,629,31,15,46,67.4%,53m
1950,2,Chilled,2773,302,13,10,23,56.5%,49m
1950,3,[GnSa]pro,2773,194,8,5,13,61.5%,23m
1950,1,314872968855,2773,0,2,3,5,40.0%,26m
1954,1,stuck,2772,1530,220,216,436,50.5%,50m
1954,2,[Worm]빠따이,2772,437,31,32,63,49.2%,53m
1954,2,Strategist,2772,306,11,14,25,44.0%,54m
1954,2,Arktanis,2772,30,2,2,4,50.0%,54m
1958,3,어허이,2771,422,22,15,37,59.5%,55m
1958,2,rekwonvi,2771,184,6,4,10,60.0%,53m
1958,2,anednf,2771,194,6,6,12,50.0%,53m
1958,3,[超級大雷貓]Sugar,2771,114,5,2,7,71.4%,55m
1962,3,MirKing,2769,364,13,7,20,65.0%,55m
1963,2,프안,2768,142,4,3,7,57.1%,54m
1964,2,오버로드개꿀맛,2767,102,3,3,6,50.0%,53m
1964,3,Velocity,2767,0,0,1,1,0.0%,49m
1964,3,cruelR,2767,0,0,1,1,0.0%,55m
1964,2,Joker,2767,0,0,3,3,0.0%,53m
1968,3,에드롭,2766,183,40,49,89,44.9%,6m
1969,2,RevoltTrees,2765,256,7,13,20,35.0%,54m
1970,2,산이,2764,1023,89,84,173,51.4%,54m
1970,1,IIIIIIIIIII,2764,574,18,28,46,39.1%,52m
1970,2,[무심천]하수,2764,368,14,16,30,46.7%,53m
1973,2,IIIllIlIIlll,2763,1319,231,212,443,52.1%,53m
1973,2,가가라이브,2763,0,3,4,7,42.9%,49m
1975,3,WuhanVirus,2762,96,4,2,6,66.7%,22m
1975,3,nikeSB,2762,30,2,0,2,100.0%,22m
1977,3,GrimReaper,2761,1414,227,221,448,50.7%,23m
1977,2,가나다라마바사아,2761,744,26,31,57,45.6%,54m
1977,1,MAX,2761,241,10,10,20,50.0%,50m
1977,2,[NGameS]DozerO,2761,116,4,7,11,36.4%,50m
1981,1,poison,2760,337,13,14,27,48.1%,53m
1981,3,xxxxxxxxxxxx,2760,83,3,4,7,42.9%,55m
1983,1,연수,2759,1208,48,47,95,50.5%,52m
1983,2,JohnnyGroove,2759,817,47,39,86,54.7%,54m
1983,2,[SofT]SKTFaker,2759,1146,47,43,90,52.2%,54m
1986,2,kirbm,2758,1146,69,63,132,52.3%,53m
1987,2,性福大台中,2757,662,40,35,75,53.3%,53m
1987,2,XiaoSong,2757,636,23,24,47,48.9%,53m
1987,1,게임의법칙,2757,145,4,3,7,57.1%,25m
1990,3,Legit,2756,1578,92,79,171,53.8%,23m
1990,3,RinkoMika,2756,120,5,3,8,62.5%,54m
1992,3,llllllllllll,2755,0,1,0,1,100.0%,23m
1993,3,oftenGGblind,2754,46,3,0,3,100.0%,49m
1993,1,llllllllllll,2754,0,2,3,5,40.0%,24m
1993,2,PROBE,2754,88,1,6,7,14.3%,53m
1996,2,MTman,2753,170,6,3,9,66.7%,49m
1997,3,[리그전]폭주라마,2751,0,1,1,2,50.0%,26m
1997,2,CHRISWATCH,2751,0,0,4,4,0.0%,53m
1999,2,[國本]BlueTa,2749,1521,262,240,502,52.2%,53m
2000,1,끝까지가다,2748,1121,44,42,86,51.2%,52m
2000,3,제라툴,2748,247,9,7,16,56.2%,23m
2002,3,llllllllllll,2747,0,0,2,2,0.0%,23m
2003,2,리밋학팔,2746,693,45,44,89,50.6%,54m
2003,1,오포읍능평리,2746,451,15,23,38,39.5%,52m
2003,1,[얼굴]적아대녀,2746,193,8,14,22,36.4%,21m
2003,2,ThomBrowne,2746,30,3,5,8,37.5%,50m
2007,1,뚱땡이,2745,1571,98,94,192,51.0%,52m
2007,3,WillyTheKid,2745,226,8,6,14,57.1%,55m
2009,3,我真的不知道,2743,28,3,6,9,33.3%,28m
2010,1,케사,2742,518,15,23,38,39.5%,52m
2011,1,IIIIIIIIII,2741,0,3,2,5,60.0%,26m
2011,3,천하태풍작살,2741,0,0,2,2,0.0%,54m
2013,3,무요,2740,1447,96,90,186,51.6%,49m
2013,2,OVERCLOCK,2740,214,7,13,20,35.0%,54m
2015,3,황패의종회김,2739,880,43,35,78,55.1%,55m
2015,3,[TITOS]Einein,2739,174,5,5,10,50.0%,55m
2017,1,Luthan,2738,0,3,4,7,42.9%,50m
2017,3,안녀여여여여여,2738,30,1,3,4,25.0%,23m
2019,2,[OKRAN]운좋은경현,2737,243,7,11,18,38.9%,54m
2019,3,ttasfa,2737,0,0,1,1,0.0%,55m
2021,1,FIREX,2736,1567,108,104,212,50.9%,52m
2021,3,원펀치투깅냉이,2736,67,4,3,7,57.1%,23m
2021,1,[NGameS]이리꾹,2736,0,0,1,1,0.0%,26m
2024,1,똘똘이스머프,2735,162,5,15,20,25.0%,52m
2024,3,shinta,2735,30,2,1,3,66.7%,54m
2026,3,왈카리아,2734,0,0,1,1,0.0%,54m
2027,3,Goliath,2733,952,41,31,72,56.9%,49m
2027,3,WizzleLi,2733,876,36,32,68,52.9%,49m
2027,2,WarComplete,2733,458,18,19,37,48.6%,54m
2027,2,땡땡땡,2733,129,6,3,9,66.7%,54m
2027,3,[겨울방어]잘생긴남자,2733,0,1,2,3,33.3%,54m
2027,3,CrazyZerg,2733,0,0,1,1,0.0%,55m
2027,3,[사철단]UltimatumJ,2733,0,0,1,1,0.0%,54m
2034,3,Foamster,2732,265,9,5,14,64.3%,23m
2034,3,outposts,2732,58,2,2,4,50.0%,23m
2036,1,PokemonXY,2731,604,76,63,139,54.7%,52m
2036,2,theREverse,2731,698,25,26,51,49.0%,53m
2038,1,ogsMC,2730,1588,528,522,1050,50.3%,53m
2038,3,[스카이파이터]멍츄,2730,230,7,2,9,77.8%,23m
2038,2,OversKy,2730,0,3,4,7,42.9%,49m
2041,2,Nick,2729,1529,162,161,323,50.2%,54m
2041,3,언더더씨,2729,0,0,2,2,0.0%,49m
2043,3,진팀장렛츠고,2727,573,24,22,46,52.2%,49m
2043,3,놀지기,2727,252,8,5,13,61.5%,49m
2043,3,수락동자,2727,0,3,4,7,42.9%,27m
2046,3,nunu,2726,522,23,20,43,53.5%,23m
2046,1,나만의롱보우,2726,0,1,2,3,33.3%,25m
2048,1,천안킹카,2725,1535,334,317,651,51.3%,51m
2048,1,스나이퍼,2725,979,53,54,107,49.5%,52m
2050,2,夜空,2724,823,32,36,68,47.1%,54m
2050,1,lonegunman,2724,420,16,20,36,44.4%,50m
2052,3,글그림,2722,984,332,342,674,49.3%,3m
2053,3,아이유,2721,30,1,3,4,25.0%,54m
2054,3,[VimeX]GrievousLady,2720,296,16,2,18,88.9%,49m
2054,3,Punch,2720,182,10,11,21,47.6%,4m
2054,1,DougSluggins,2720,0,4,3,7,57.1%,51m
2054,3,[휴식점수수집]nada,2720,97,2,4,6,33.3%,28m
2054,2,척추사단접기,2720,0,0,2,2,0.0%,28m
2059,3,SungG,2719,869,42,34,76,55.3%,55m
2059,3,GONI,2719,97,2,0,2,100.0%,28m
2061,2,김민폭,2717,158,6,5,11,54.5%,54m
2061,1,DZR,2717,0,0,1,1,0.0%,25m
2061,3,hinohino,2717,0,0,2,2,0.0%,23m
2064,2,StarJiggy,2715,761,32,27,59,54.2%,54m
2064,3,파워버섯,2715,383,16,13,29,55.2%,23m
2064,1,sukgun,2715,145,5,3,8,62.5%,26m
2067,3,Tom,2714,147,4,9,13,30.8%,26m
2068,2,Aiden,2713,1117,135,133,268,50.4%,54m
2068,3,뽀뽀뽕,2713,1030,47,36,83,56.6%,49m
2070,3,낄낄악마,2712,431,16,11,27,59.3%,49m
2070,3,UNO,2712,174,7,8,15,46.7%,49m
2072,2,뻐큐머겅,2710,303,9,12,21,42.9%,29m
2072,3,llllllllllll,2710,174,6,7,13,46.2%,49m
2072,3,킴비트,2710,121,2,2,4,50.0%,23m
2072,3,MaTulki,2710,30,1,1,2,50.0%,54m
2076,1,Apple,2709,0,2,3,5,40.0%,24m
2076,3,LoSicA,2709,0,0,1,1,0.0%,49m
2078,3,rotate,2708,692,29,25,54,53.7%,49m
2078,3,Tenebrae,2708,170,6,5,11,54.5%,49m
2078,3,Dante,2708,0,0,1,1,0.0%,23m
2081,2,Nivdc,2706,301,12,13,25,48.0%,49m
2081,3,엎어치기매치기,2706,0,1,3,4,25.0%,27m
2083,2,스끼다시,2704,0,1,1,2,50.0%,29m
2083,3,[래더납치범]HMA,2704,0,1,4,5,20.0%,54m
2085,1,LofNaun,2703,1541,1197,1307,2504,47.8%,5m
2085,3,벅명수,2703,535,29,22,51,56.9%,23m
2085,3,Optimism,2703,30,1,1,2,50.0%,49m
2088,3,Mangu,2702,441,23,18,41,56.1%,23m
2088,3,수퍼디아이,2702,144,4,1,5,80.0%,23m
2088,3,잘난사람,2702,0,1,2,3,33.3%,55m
2091,2,날라리테란,2701,1510,90,86,176,51.1%,53m
2091,3,masoory,2701,397,14,10,24,58.3%,23m
2091,3,adjact,2701,250,9,5,14,64.3%,54m
2094,3,묻지마날빌,2699,186,6,2,8,75.0%,49m
2094,1,NicsTan,2699,48,3,5,8,37.5%,25m
2096,3,Harrison,2698,857,32,23,55,58.2%,49m
2096,2,박캐리,2698,130,5,6,11,45.5%,50m
2096,3,[공허거주]대박이야,2698,30,2,2,4,50.0%,23m
2099,3,MissA,2697,158,4,4,8,50.0%,23m
2099,3,큰대박,2697,0,1,2,3,33.3%,23m
2101,3,SCA,2696,58,2,3,5,40.0%,23m
2102,3,dobis,2695,848,34,30,64,53.1%,49m
2102,2,blergson,2695,0,3,4,7,42.9%,49m
2104,2,[뿌리]쉬든,2694,236,9,14,23,39.1%,53m
2105,2,MasterChief,2693,592,20,28,48,41.7%,54m
2105,3,[육풍함]IllIIIllIllI,2693,232,7,5,12,58.3%,54m
2105,2,스토믹,2693,120,4,6,10,40.0%,53m
2105,2,LYS,2693,0,0,1,1,0.0%,20m
2109,3,Vikseven,2692,718,36,16,52,69.2%,49m
2109,1,까다로운사냥꾼,2692,0,1,1,2,50.0%,25m
2111,3,크나큰오예,2691,94,1,1,2,50.0%,54m
2112,3,lmsgenius,2690,130,4,4,8,50.0%,49m
2113,1,CromerBB,2689,1562,241,237,478,50.4%,52m
2113,3,[TPg]德馬西亞,2689,30,3,4,7,42.9%,49m
2113,3,홍쉡,2689,122,2,2,4,50.0%,23m
2113,3,Aimer,2689,30,1,4,5,20.0%,23m
2117,3,sevenblue,2688,0,3,3,6,50.0%,23m
2118,3,[日本]IIIIIIIIIIII,2687,236,8,9,17,47.1%,55m
2118,3,하악하악,2687,167,6,6,12,50.0%,23m
2120,1,[DeFT5]Freddy,2686,0,0,2,2,0.0%,21m
2121,3,용대장,2685,495,19,10,29,65.5%,54m
2121,3,테테전사절,2685,271,10,3,13,76.9%,23m
2123,3,jkkim,2684,1020,71,60,131,54.2%,55m
2123,3,손민기,2684,202,7,3,10,70.0%,54m
2123,1,nighter,2684,76,5,8,13,38.5%,51m
2123,3,decimate,2684,30,1,2,3,33.3%,23m
2127,1,grrrrrrrrrrr,2683,193,7,5,12,58.3%,49m
2127,3,fitzhugh,2683,0,0,1,1,0.0%,26m
2129,3,유헌수,2682,662,25,21,46,54.3%,23m
2129,3,[해병만뽑음]지금은양학중,2682,0,1,6,7,14.3%,26m
2129,3,온니성기사,2682,0,0,1,1,0.0%,43m
2132,3,창천항로,2681,95,2,1,3,66.7%,23m
2133,3,lIIIlIIlIlII,2680,509,23,12,35,65.7%,23m
2133,3,옾탱,2680,0,0,2,2,0.0%,55m
2135,3,BleuOceane,2678,1118,57,43,100,57.0%,49m
2135,2,Wrecking,2678,466,32,35,67,47.8%,54m
2137,1,llllllllllll,2677,90,2,1,3,66.7%,48m
2138,3,Newbie,2674,410,15,18,33,45.5%,54m
2139,1,나랑드사이다,2673,0,0,1,1,0.0%,22m
2140,1,바나나준,2671,0,0,1,1,0.0%,22m
2141,2,IlIlIlIl,2670,523,75,71,146,51.4%,53m
2141,1,MaslovoGG,2670,780,20,24,44,45.5%,48m
2141,1,숏다리해병,2670,0,0,1,1,0.0%,49m
2144,2,JANGGURA,2668,738,28,31,59,47.5%,50m
2144,3,bskbio,2668,0,0,2,2,0.0%,54m
2146,2,영혼의날개,2667,1557,163,166,329,49.5%,54m
2146,3,[제주녹차라떼]cccccccccc,2667,1068,67,49,116,57.8%,49m
2146,1,[건전]건전소년,2667,150,6,8,14,42.9%,50m
2146,1,Blackeros,2667,0,0,1,1,0.0%,48m
2150,1,RoachKing,2666,42,2,1,3,66.7%,48m
2151,3,Haria,2665,1092,129,131,260,49.6%,55m
2151,3,지존보스,2665,499,33,31,64,51.6%,54m
2151,3,상언호,2665,111,18,16,34,52.9%,55m
2154,3,[레더]lIlllIIIllIl,2664,230,7,5,12,58.3%,23m
2155,1,pATCHpROTOSS,2663,282,10,9,19,52.6%,22m
2156,3,하프물범,2662,594,27,18,45,60.0%,23m
2156,3,akffkantnRna,2662,290,11,13,24,45.8%,49m
2158,3,세렌케티의개,2661,170,10,14,24,41.7%,23m
2158,3,aeae,2661,208,7,10,17,41.2%,55m
2160,3,SNSD,2660,60,3,6,9,33.3%,23m
2161,1,좋아요돈까스,2659,216,5,5,10,50.0%,21m
2161,1,친구야,2659,40,1,1,2,50.0%,20m
2161,1,[원탑1st]혜윰,2659,0,0,6,6,0.0%,26m
2164,1,Espre,2657,217,7,4,11,63.6%,26m
2164,1,티모,2657,0,0,1,1,0.0%,30m
2166,2,BaristaCafe,2656,705,50,45,95,52.6%,53m
2166,1,Neyriks,2656,826,32,30,62,51.6%,51m
2166,1,Silenthey,2656,0,3,2,5,60.0%,26m
2166,1,하이라드,2656,0,0,1,1,0.0%,21m
2170,1,MountainDew,2653,284,8,8,16,50.0%,48m
2170,1,김옥지,2653,97,2,4,6,33.3%,25m
2172,3,Song,2652,1230,115,104,219,52.5%,23m
2172,3,삼팔광댕,2652,121,3,2,5,60.0%,27m
2172,1,[異化蟲公會]DaiSy,2652,66,2,1,3,66.7%,48m
2172,2,ISurrender,2652,0,1,0,1,100.0%,29m
2172,1,[cox2p]이세상이모양,2652,0,0,1,1,0.0%,25m
2177,2,Dreamstar,2651,808,76,74,150,50.7%,53m
2177,3,Eclips,2651,197,7,7,14,50.0%,27m
2179,2,초보꼬맹이,2650,1222,46,50,96,47.9%,54m
2180,2,[LQV]착한부자,2649,172,5,10,15,33.3%,53m
2180,1,망고향,2649,0,2,3,5,40.0%,22m
2182,1,헛깨나무,2648,128,3,3,6,50.0%,20m
2183,1,올인의정석,2646,1206,38,39,77,49.4%,48m
2183,1,던파카인섭,2646,0,2,4,6,33.3%,25m
2183,2,[초신성]우로보로스,2646,0,0,1,1,0.0%,28m
2186,1,junejune,2643,0,0,2,2,0.0%,22m
2187,1,MarineBoy,2641,160,4,5,9,44.4%,20m
2187,2,Ricky,2641,0,0,7,7,0.0%,54m
2189,3,[유자차]쥬댕이,2640,176,6,9,15,40.0%,23m
2189,1,하이염,2640,44,2,2,4,50.0%,30m
2191,1,면죄,2639,1269,68,72,140,48.6%,52m
2191,3,TheViksBack,2639,60,3,7,10,30.0%,49m
2193,3,쭈니아트,2638,1499,59,64,123,48.0%,55m
2193,1,[ZUZU]斯文猛男,2638,1322,38,40,78,48.7%,48m
2195,3,Ardeshir,2637,447,18,13,31,58.1%,55m
2195,1,[학동PEAK]복남씨,2637,0,0,1,1,0.0%,26m
2197,2,까막까치,2635,488,25,29,54,46.3%,53m
2198,2,[ELS]라우렌시오,2631,1477,208,202,410,50.7%,53m
2198,1,김밥이,2631,1540,92,103,195,47.2%,53m
2198,1,SpicaBluenot,2631,300,8,8,16,50.0%,21m
2201,1,오랫만이당,2630,34,2,3,5,40.0%,21m
2202,1,코토리,2629,235,5,16,21,23.8%,50m
2202,1,llllllllllll,2629,174,4,4,8,50.0%,22m
2204,3,NEXkabOoM,2628,163,6,7,13,46.2%,27m
2204,1,구건모,2628,0,0,1,1,0.0%,25m
2206,1,암흑집정관,2627,0,0,1,1,0.0%,48m
2207,1,비트코인,2626,528,14,11,25,56.0%,21m
2207,1,김이현,2626,48,2,1,3,66.7%,25m
2207,1,[日本]IIIIIIIIIIII,2626,0,0,3,3,0.0%,22m
2210,1,MTEEGZ,2625,426,10,15,25,40.0%,30m
2210,3,임진하짱짱짱,2625,0,1,2,3,33.3%,49m
2210,1,[날빌의달인]레드망고,2625,0,1,5,6,16.7%,49m
2213,3,[달팽이]백의장군,2624,0,1,1,2,50.0%,49m
2214,1,llllllllllll,2623,97,3,3,6,50.0%,26m
2214,1,Leofrancis,2623,0,1,2,3,33.3%,21m
2216,1,SNOW,2621,163,3,5,8,37.5%,48m
2216,1,[국방부사서병]마린,2621,0,0,1,1,0.0%,48m
2218,1,상어잡이성하,2620,265,9,7,16,56.2%,22m
2218,1,호모사피엔스,2620,42,2,5,7,28.6%,22m
2220,3,Onetwo,2619,1504,83,85,168,49.4%,54m
2220,1,저녁코끼리,2619,517,18,16,34,52.9%,22m
2220,3,머시라고,2619,30,2,4,6,33.3%,54m
2220,1,Por,2619,0,1,0,1,100.0%,48m
2220,2,[꽃남]메카닉싫엉,2619,0,1,4,5,20.0%,24m
2225,1,월드대빵,2618,1062,35,32,67,52.2%,22m
2226,3,egale,2617,221,7,6,13,53.8%,55m
2226,1,꽃꽂이실장,2617,0,0,1,1,0.0%,21m
2228,3,NIA,2614,1217,53,48,101,52.5%,55m
2228,2,llllllllllll,2614,228,8,26,34,23.5%,7m
2228,1,IIIIIIIIIIII,2614,130,4,4,8,50.0%,21m
2231,3,Qiubi,2613,97,5,7,12,41.7%,26m
2231,3,legi,2613,0,1,2,3,33.3%,49m
2233,3,kokoko,2611,1474,200,205,405,49.4%,23m
2233,1,[KRisOK]WEEBRATOR,2611,72,2,10,12,16.7%,52m
2235,3,Hurl,2610,888,32,36,68,47.1%,23m
2235,2,dsafdfasasdf,2610,0,1,0,1,100.0%,29m
2237,1,Lex,2609,96,4,5,9,44.4%,26m
2238,1,젤나가맙소사,2607,38,2,2,4,50.0%,48m
2238,2,[동현사랑]신선,2607,0,2,3,5,40.0%,24m
2240,1,내꿈은골드리그,2606,184,5,7,12,41.7%,21m
2240,1,니조랄,2606,161,4,2,6,66.7%,49m
2240,1,[XYFANS]ArnoldA,2606,0,1,0,1,100.0%,22m
2243,3,[게임플레이]dla,2605,0,3,3,6,50.0%,49m
2243,1,LunaTicDream,2605,32,3,4,7,42.9%,22m
2243,1,GDL,2605,0,2,7,9,22.2%,25m
2246,1,AssKiKa,2603,948,35,35,70,50.0%,21m
2246,2,키위,2603,0,1,1,2,50.0%,24m
2248,2,김지수,2602,1463,54,56,110,49.1%,49m
2249,1,가즈아,2601,431,14,8,22,63.6%,22m
2250,1,영광,2600,442,10,7,17,58.8%,22m
2251,2,미니미니,2599,0,1,3,4,25.0%,30m
2251,1,diego,2599,0,1,4,5,20.0%,21m
2253,1,손주아디뜯음,2598,0,1,0,1,100.0%,48m
2254,3,LowSaturaion,2595,334,13,10,23,56.5%,23m
2255,3,치르노,2594,367,15,15,30,50.0%,49m
2255,1,[WhySo]Serious,2594,114,4,3,7,57.1%,48m
2255,1,INNOVATION,2594,58,3,0,3,100.0%,21m
2258,2,malroman,2593,1151,41,55,96,42.7%,54m
2258,2,engon,2593,567,22,25,47,46.8%,50m
2258,2,仁者無敵,2593,304,11,18,29,37.9%,54m
2261,3,SUPERNOVA,2592,190,6,5,11,54.5%,49m
2261,3,세젤예보현잉,2592,0,4,3,7,57.1%,55m
2263,3,플루토,2591,335,12,11,23,52.2%,23m
2264,2,조두현,2590,1262,47,58,105,44.8%,53m
2264,2,exenhorn,2590,128,5,8,13,38.5%,54m
2266,1,참치타우렌해병,2588,48,3,5,8,37.5%,26m
2267,1,Optixus,2587,589,37,27,64,57.8%,21m
2267,3,블랙아이드잭,2587,684,24,29,53,45.3%,23m
2269,2,말굽한대,2584,861,39,38,77,50.6%,49m
2270,3,남군아,2583,1216,74,75,149,49.7%,55m
2270,1,hero,2583,44,2,2,4,50.0%,21m
2272,2,SniperAbeter,2582,1245,54,49,103,52.4%,50m
2272,1,[Atlas7]FlameBird,2582,0,0,1,1,0.0%,22m
2274,3,현아,2581,773,46,49,95,48.4%,23m
2274,1,Hunter,2581,684,22,15,37,59.5%,23m
2274,1,차칸마법사,2581,0,4,3,7,57.1%,26m
2277,3,아쿠리스포리토,2580,372,24,23,47,51.1%,23m
2277,1,니가가라해처리,2580,187,8,7,15,53.3%,22m
2279,1,히어로즈,2579,486,14,14,28,50.0%,22m
2279,3,동이님,2579,121,4,6,10,40.0%,43m
2279,1,sksk,2579,0,0,2,2,0.0%,26m
2279,1,지지지라라라랄,2579,0,0,2,2,0.0%,22m
2283,1,EZZIGG,2578,0,0,2,2,0.0%,21m
2284,3,[공무원합격은]김생잘,2576,680,24,27,51,47.1%,23m
2284,1,MOLODES,2576,0,1,4,5,20.0%,21m
2286,1,바로,2575,48,4,6,10,40.0%,25m
2287,1,notebook,2574,1340,47,45,92,51.1%,21m
2288,1,Orion,2573,0,1,1,2,50.0%,21m
2289,1,NomadRusso,2570,327,45,47,92,48.9%,20m
2289,1,COREA,2570,348,12,16,28,42.9%,21m
2289,3,Frog,2570,118,6,4,10,60.0%,55m
2289,2,llllllllllll,2570,0,1,4,5,20.0%,24m
2293,3,ATLAS,2569,1516,83,83,166,50.0%,55m
2293,1,VVVVVVVVVVVV,2569,115,1,5,6,16.7%,23m
2295,1,swfilm,2568,1048,35,34,69,50.7%,21m
2295,3,곰보빵,2568,88,5,9,14,35.7%,49m
2297,2,NoName,2567,162,6,10,16,37.5%,54m
2297,1,ASAP,2567,0,1,0,1,100.0%,22m
2297,2,굿뜨,2567,48,1,5,6,16.7%,24m
2297,1,Dante,2567,0,0,1,1,0.0%,48m
2301,1,yyfyyf,2566,796,21,37,58,36.2%,49m
2301,1,사사키치에,2566,294,11,10,21,52.4%,21m
2303,3,fork,2565,1516,150,160,310,48.4%,55m
2303,3,Vega,2565,164,6,8,14,42.9%,26m
2305,1,Firepower,2564,258,8,7,15,53.3%,48m
2306,1,한콩고,2562,556,18,12,30,60.0%,23m
2306,1,미아리사장님,2562,291,10,17,27,37.0%,50m
2308,1,[저글링죠아]YaED,2559,399,15,6,21,71.4%,22m
2308,1,저그,2559,121,4,4,8,50.0%,25m
2308,1,ParkGoM,2559,0,0,1,1,0.0%,20m
2311,3,dlqldlsgnrhk,2558,833,42,46,88,47.7%,54m
2311,1,[정화하리라]푸른사신,2558,93,3,3,6,50.0%,48m
2311,1,[神族請迴避]高手剋廢物,2558,0,0,1,1,0.0%,22m
2314,1,muzzneyolove,2557,678,25,24,49,51.0%,22m
2314,3,몰랑이,2557,0,1,0,1,100.0%,26m
2316,1,blackswas,2554,549,33,37,70,47.1%,22m
2317,2,부스터,2553,0,2,3,5,40.0%,24m
2318,1,SmileMickey,2552,0,3,5,8,37.5%,25m
2318,1,XxrektxX,2552,0,2,4,6,33.3%,25m
2320,1,[FBA]이소시아네이트,2551,46,2,5,7,28.6%,22m
2321,1,itfans,2550,82,3,3,6,50.0%,22m
2322,1,[너의ol름은]sunki,2549,1317,52,40,92,56.5%,48m
2322,1,[SCTW]ZEROS,2549,0,0,1,1,0.0%,49m
2324,1,[벽짓고벽뚫고]사령관,2548,162,4,8,12,33.3%,22m
2325,1,肉色巨蟒,2546,129,2,5,7,28.6%,49m
2326,3,iwillkillyou,2545,1129,42,53,95,44.2%,55m
2326,1,[싸이클론장인]MARC,2545,97,5,2,7,71.4%,25m
2328,1,명품,2544,159,6,3,9,66.7%,22m
2329,1,[UniC]immotal,2543,1124,32,33,65,49.2%,22m
2329,3,[국가정보원]kldsjflkjaw,2543,279,9,11,20,45.0%,49m
2331,1,tnqordjr,2542,131,3,4,7,42.9%,48m
2332,1,hyile,2540,88,1,2,3,33.3%,48m
2332,1,aaaaaaaaaaaa,2540,0,0,1,1,0.0%,23m
2334,2,스타사령관,2538,1193,135,149,284,47.5%,53m
2334,3,SlayersBaeka,2538,30,1,10,11,9.1%,54m
2336,1,CrTEN,2537,512,15,17,32,46.9%,22m
2336,1,나쁜자식,2537,0,0,2,2,0.0%,48m
2338,1,Fenrir,2536,0,0,1,1,0.0%,21m
2339,1,lmao,2532,1735,179,172,351,51.0%,21m
2339,1,질럿,2532,444,13,14,27,48.1%,48m
2339,1,[TST]뺑덕아범,2532,0,0,1,1,0.0%,21m
2342,1,whacked,2531,415,25,15,40,62.5%,22m
2342,1,마니,2531,0,0,3,3,0.0%,21m
2344,1,Kaori,2530,0,3,3,6,50.0%,26m
2345,1,짝삼십칠호,2529,334,11,11,22,50.0%,48m
2345,1,[쫄깃함]다리장인뚜기,2529,0,1,4,5,20.0%,49m
2347,2,admiralwafuh,2527,0,0,1,1,0.0%,24m
2348,1,사랑안전,2526,46,3,4,7,42.9%,48m
2349,1,creature,2525,922,29,26,55,52.7%,22m
2350,1,덜덜,2524,86,3,1,4,75.0%,48m
2350,1,weimojay,2524,86,3,4,7,42.9%,22m
2352,1,수성인,2523,125,2,1,3,66.7%,21m
2352,1,[Yisc]다현이,2523,34,2,1,3,66.7%,21m
2354,1,fff,2520,491,16,18,34,47.1%,48m
2354,1,BlitzkrieG,2520,170,7,4,11,63.6%,26m
2354,3,[Blacer]무리뉴,2520,86,7,6,13,53.8%,23m
2354,1,지금은사아,2520,0,3,2,5,60.0%,20m
2354,2,송현아,2520,0,2,3,5,40.0%,24m
2359,1,미믹정주,2519,0,1,2,3,33.3%,30m
2360,3,수원고구마,2518,1166,73,70,143,51.0%,55m
2361,2,[자유의유산]oxygen,2516,0,2,0,2,100.0%,24m
2362,2,Unicode,2514,0,2,4,6,33.3%,24m
2363,1,끠슬,2513,268,10,7,17,58.8%,48m
2363,2,뽕돌이,2513,88,2,6,8,25.0%,28m
2365,1,로돕벌,2511,559,20,21,41,48.8%,21m
2365,1,llllllllllll,2511,150,5,9,14,35.7%,48m
2367,3,aaaagkgk,2510,1052,55,65,120,45.8%,23m
2367,1,poohno,2510,0,1,4,5,20.0%,48m
2369,1,끼미열,2509,217,5,7,12,41.7%,26m
2369,1,Wanax,2509,95,1,2,3,33.3%,48m
2371,1,misterbasic,2508,456,19,16,35,54.3%,22m
2371,1,[FAL]IlIllIIlIlII,2508,256,6,6,12,50.0%,48m
2371,1,문주냉,2508,48,3,6,9,33.3%,26m
2374,1,lifeline,2507,294,8,9,17,47.1%,21m
2374,1,llllllllllll,2507,191,5,0,5,100.0%,25m
2376,1,maxboy,2503,224,9,5,14,64.3%,22m
2376,1,송펭귄,2503,0,2,2,4,50.0%,49m
2378,1,IlIlllIIlIlI,2501,921,106,97,203,52.2%,20m
2379,1,바른양돈,2500,962,52,45,97,53.6%,21m
2379,1,삼각조르기,2500,906,30,32,62,48.4%,48m
2381,1,GOLD,2499,312,9,13,22,40.9%,30m
2382,2,SMERH,2498,0,2,3,5,40.0%,24m
2382,1,skyak,2498,30,2,3,5,40.0%,22m
2384,2,JOKER,2497,92,5,9,14,35.7%,50m
2384,2,[1학년5반]predator,2497,0,1,4,5,20.0%,24m
2386,1,[즐겜유저연합]영웅,2496,377,13,13,26,50.0%,21m
2386,1,xLNx,2496,192,6,8,14,42.9%,23m
2386,1,IIIIIIIIIIII,2496,134,4,11,15,26.7%,30m
2389,1,heavenly,2494,265,10,6,16,62.5%,48m
2389,1,you,2494,193,7,5,12,58.3%,26m
2389,2,게맛살,2494,137,3,2,5,60.0%,24m
2389,1,Tomahwk,2494,120,2,2,4,50.0%,26m
2393,1,Rychmistrz,2493,48,1,4,5,20.0%,26m
2394,1,GaeJal,2489,160,5,1,6,83.3%,25m
2395,3,[BOB]Fomula,2487,0,0,1,1,0.0%,27m
2396,1,개문,2486,192,6,9,15,40.0%,25m
2397,1,힙통령,2485,322,10,14,24,41.7%,21m
2397,2,Pretender,2485,0,3,2,5,60.0%,48m
2399,2,[랜타디줫고수]ComMa,2484,48,3,4,7,42.9%,24m
2400,1,[브리티안]CallofBlood,2483,1058,36,32,68,52.9%,22m
2400,1,加拿大鮪魚堡,2483,587,21,19,40,52.5%,22m
2400,2,원꼬추,2483,30,1,1,2,50.0%,48m
2403,1,skyhoole,2480,750,23,27,50,46.0%,22m
2403,1,llllllllllll,2480,500,15,19,34,44.1%,22m
2405,1,Ponytail,2479,154,4,4,8,50.0%,21m
2405,2,힐링받음,2479,0,1,0,1,100.0%,48m
2407,2,[쫄깃함]엔돌핀,2477,504,16,16,32,50.0%,48m
2408,2,marin,2476,0,1,1,2,50.0%,30m
2408,2,절단,2476,0,0,1,1,0.0%,28m
2410,1,황금잉어,2475,365,13,14,27,48.1%,22m
2410,1,DeadwtDan,2475,96,3,5,8,37.5%,25m
2412,2,동그리,2474,0,1,0,1,100.0%,48m
2413,1,IlIIlllIllIl,2472,971,40,29,69,58.0%,21m
2414,2,[랜타디매니아]GENryu,2468,0,0,1,1,0.0%,28m
2415,3,구봉고,2467,332,13,18,31,41.9%,49m
2415,2,PIDR,2467,163,4,5,9,44.4%,24m
2415,2,solo,2467,94,3,2,5,60.0%,28m
2418,2,송승기,2466,0,1,4,5,20.0%,48m
2419,1,Boston,2465,0,2,6,8,25.0%,26m
2420,2,[아케이드러너]잘못함,2464,0,0,1,1,0.0%,24m
2421,2,[海膽王]麥可弟,2462,0,1,4,5,20.0%,48m
2421,3,[이터널]닥스훈트,2462,0,0,1,1,0.0%,43m
2423,1,Okaka,2461,145,4,2,6,66.7%,25m
2423,3,[개쫄보]산보마스터,2461,0,2,5,7,28.6%,55m
2423,1,gvfgvjh,2461,111,2,5,7,28.6%,48m
2423,2,Ray,2461,0,1,0,1,100.0%,48m
2427,2,[시럽]킹갓사도,2459,272,11,14,25,44.0%,29m
2427,1,[철혈약탈단]이터,2459,108,5,6,11,45.5%,21m
2429,2,존망겜언제섭종,2458,0,1,0,1,100.0%,24m
2430,1,SeoNo,2457,1368,62,68,130,47.7%,22m
2430,3,바퀴충문재인,2457,584,19,34,53,35.8%,55m
2432,2,TheLingKing,2456,0,3,2,5,60.0%,48m
2433,2,[병신들모임]가브리엘라,2454,0,2,3,5,40.0%,48m
2433,1,에스웍스에이토스,2454,0,1,0,1,100.0%,25m
2435,2,GRAVES,2452,97,2,4,6,33.3%,24m
2436,2,바이킹성애자,2451,0,2,3,5,40.0%,24m
2437,1,고니,2449,262,7,12,19,36.8%,21m
2438,1,ziroqoo,2447,232,8,12,20,40.0%,49m
2438,2,스타를글로배웠다,2447,30,1,1,2,50.0%,30m
2440,1,테란잦고수,2446,196,7,7,14,50.0%,48m
2440,1,버스커드레곤,2446,0,2,5,7,28.6%,48m
2442,2,신민아,2443,192,8,3,11,72.7%,29m
2442,2,제럴드,2443,0,0,1,1,0.0%,30m
2444,2,天安門,2438,1444,84,113,197,42.6%,53m
2444,2,JXXN,2438,0,1,6,7,14.3%,24m
2446,1,OneSet,2436,1326,51,54,105,48.6%,21m
2446,1,llllllllllll,2436,471,45,51,96,46.9%,21m
2446,1,rams,2436,96,6,9,15,40.0%,25m
2449,3,星海战神,2435,334,11,18,29,37.9%,55m
2450,2,저그,2434,94,3,6,9,33.3%,24m
2451,1,알사장,2433,568,16,27,43,37.2%,21m
2451,2,llllllllllll,2433,438,15,6,21,71.4%,20m
2453,1,LMDuc,2432,239,8,8,16,50.0%,25m
2453,1,StormzBG,2432,190,5,10,15,33.3%,26m
2455,2,현우짱,2431,96,2,2,4,50.0%,24m
2456,2,llllllllllll,2425,430,13,33,46,28.3%,53m
2457,2,사자부대,2423,0,1,2,3,33.3%,25m
2458,3,수지,2421,199,7,11,18,38.9%,27m
2459,2,[HANCIv]cshhan,2420,1621,205,220,425,48.2%,30m
2459,2,[TalenT]whyjkddfh,2420,46,2,1,3,66.7%,48m
2461,3,[루키]cnb,2418,951,51,69,120,42.5%,55m
2461,2,[바닷속이야기]내뒤에골렘있다,2418,0,0,1,1,0.0%,28m
2463,2,BlueHole,2417,116,4,1,5,80.0%,28m
2463,2,[口多口拉A夢]DoRaEMon,2417,0,0,1,1,0.0%,28m
2465,1,딴지맨,2416,587,28,33,61,45.9%,21m
2465,2,[ELSII]래툰,2416,628,21,26,47,44.7%,29m
2467,1,AAAAA,2414,1365,79,76,155,51.0%,21m
2467,2,서현아사랑해,2414,98,3,5,8,37.5%,29m
2467,2,KJKMARI,2414,92,1,1,2,50.0%,48m
2470,2,Wolfdreicht,2413,240,8,4,12,66.7%,24m
2471,2,武漢肺炎維尼爽歪,2411,96,2,4,6,33.3%,24m
2472,2,一切靠運氣,2410,102,3,8,11,27.3%,29m
2473,2,[STOP]루드김두,2407,0,1,4,5,20.0%,24m
2474,1,Realcircle,2405,209,6,9,15,40.0%,23m
2475,1,[초전자포]태림,2403,527,15,22,37,40.5%,21m
2476,1,Coalescense,2402,286,6,10,16,37.5%,25m
2477,2,飄飄影,2401,114,2,2,4,50.0%,48m
2478,1,zero,2400,759,30,43,73,41.1%,22m
2478,1,Zernex,2400,384,14,16,30,46.7%,21m
2480,2,[망겜장인]봄날벚꽃,2398,0,3,2,5,60.0%,24m
2481,2,BBangDuck,2397,208,6,17,23,26.1%,28m
2482,3,[미친광전사]NovaTerra,2396,307,11,12,23,47.8%,49m
2483,2,Edward,2394,0,1,4,5,20.0%,48m
2484,2,일대일갓겜,2393,30,3,4,7,42.9%,29m
2485,1,Ferrari,2392,0,1,0,1,100.0%,26m
2486,2,qqqq,2391,494,16,15,31,51.6%,29m
2487,2,갈때까지가보자,2389,255,9,3,12,75.0%,48m
2487,1,임병곤,2389,0,0,2,2,0.0%,26m
2489,1,Jackson,2386,1695,91,111,202,45.0%,48m
2489,2,고주형,2386,675,26,21,47,55.3%,29m
2489,1,매직테란,2386,97,4,6,10,40.0%,25m
2492,1,log,2384,819,52,68,120,43.3%,22m
2492,2,kelvin,2384,0,0,1,1,0.0%,24m
2494,2,Taeja,2378,0,1,4,5,20.0%,48m
2494,2,더오브인영이,2378,0,0,2,2,0.0%,28m
2496,2,may,2375,0,1,4,5,20.0%,48m
2497,2,NotKorean,2373,0,3,2,5,60.0%,29m
2497,2,오리,2373,0,1,4,5,20.0%,28m
2499,2,[서울교대]초등사회과교육과,2372,304,12,15,27,44.4%,29m
2499,2,Temati,2372,0,1,0,1,100.0%,24m
2501,2,정마담,2371,462,16,15,31,51.6%,29m
2501,2,IlllllIII,2371,410,14,19,33,42.4%,29m
2501,1,레쓰비,2371,164,7,8,15,46.7%,48m
2504,1,elicthe,2369,955,35,36,71,49.3%,22m
2504,2,티시스,2369,0,0,2,2,0.0%,48m
2506,1,myeunil,2367,497,14,20,34,41.2%,22m
2506,1,SPX,2367,0,1,1,2,50.0%,26m
2506,2,samsung,2367,0,0,1,1,0.0%,48m
2506,3,llllllllllll,2367,0,0,1,1,0.0%,43m
2510,2,[국가정보원]silver,2364,30,2,2,4,50.0%,28m
2511,2,FoFiFu,2363,1008,39,37,76,51.3%,29m
2512,2,[너의ol름은]towns,2362,0,1,0,1,100.0%,29m
2512,2,RuFie,2362,0,0,1,1,0.0%,25m
2512,2,[공허거주]yes,2362,0,0,1,1,0.0%,30m
2515,1,너나알어이넘아,2361,1453,89,98,187,47.6%,22m
2515,2,FreeHongKong,2361,315,12,11,23,52.2%,48m
2515,1,짱개죽이기,2361,92,3,3,6,50.0%,25m
2518,1,[isnous]Vincent,2360,656,74,81,155,47.7%,22m
2518,2,이베리코포풍,2360,779,29,27,56,51.8%,29m
2520,2,[ZagBra]머털도사,2357,0,1,0,1,100.0%,29m
2520,2,[sc2mc]albert,2357,0,0,1,1,0.0%,48m
2522,2,IgnoreTaName,2356,0,0,1,1,0.0%,28m
2523,2,umjetink,2354,0,0,1,1,0.0%,29m
2524,2,[strong]달려,2350,1450,58,66,124,46.8%,28m
2524,2,kiwi,2350,413,13,10,23,56.5%,29m
2524,2,DaiSy,2350,262,8,7,15,53.3%,48m
2527,1,ScumbagKai,2347,150,5,8,13,38.5%,48m
2528,2,lililililili,2344,914,38,41,79,48.1%,29m
2528,2,[강철]황금당근,2344,725,29,29,58,50.0%,48m
2528,2,골드한번가보자,2344,160,5,13,18,27.8%,48m
2528,2,Executioner,2344,88,1,1,2,50.0%,29m
2532,2,[DS9]Tassillio,2343,835,38,21,59,64.4%,29m
2532,2,김마빡이,2343,0,0,1,1,0.0%,48m
2534,2,MIKE,2341,194,6,11,17,35.3%,28m
2535,2,bluedayjjj,2340,30,1,1,2,50.0%,29m
2536,1,StevenPark,2339,188,9,11,20,45.0%,21m
2537,1,Yeh,2337,572,21,33,54,38.9%,22m
2538,2,meekking,2335,195,6,8,14,42.9%,48m
2538,2,유현준,2335,0,3,8,11,27.3%,50m
2540,3,[연쇄살인마들]room,2333,0,0,1,1,0.0%,23m
2541,3,대전이영호,2332,0,1,1,2,50.0%,24m
2542,2,lalrivunga,2329,487,22,24,46,47.8%,48m
2542,2,백호선,2329,242,8,12,20,40.0%,29m
2542,2,Garnet,2329,60,3,8,11,27.3%,30m
2545,1,Noahive,2328,130,4,7,11,36.4%,21m
2546,2,천연라임향,2325,91,2,1,3,66.7%,28m
2547,2,노니,2324,30,2,1,3,66.7%,48m
2548,1,rainJK,2321,416,13,23,36,36.1%,30m
2548,2,[SGlory]櫻桃布丁,2321,167,5,4,9,55.6%,48m
2550,2,[개초보연합]해병,2320,1474,57,58,115,49.6%,48m
2550,2,[초천재]배가고프다,2320,88,1,1,2,50.0%,28m
2552,2,rareavis,2319,0,1,0,1,100.0%,48m
2552,1,갤드,2319,0,0,1,1,0.0%,26m
2554,2,쩌리,2318,552,22,20,42,52.4%,48m
2554,2,[AFM]SifNorniern,2318,0,0,1,1,0.0%,29m
2556,2,행복찾기,2316,0,0,1,1,0.0%,29m
2557,2,제네시스,2315,247,8,8,16,50.0%,28m
2557,2,[REBELS]겐노스케,2315,0,1,4,5,20.0%,48m
2559,2,[호놀롤로]jangkoon,2312,88,1,1,2,50.0%,48m
2559,2,승리자,2312,0,1,2,3,33.3%,48m
2561,2,Verocious,2311,473,20,15,35,57.1%,48m
2561,2,趙子龍,2311,0,1,1,2,50.0%,24m
2563,3,구급공무원,2309,1094,35,51,86,40.7%,55m
2563,2,[sc2mc]LilHomies,2309,0,0,1,1,0.0%,48m
2565,2,대기흉왔다,2308,126,4,7,11,36.4%,20m
2565,3,[Ffly]DHISNEMO,2308,0,1,4,5,20.0%,23m
2567,3,Xteg,2306,0,1,0,1,100.0%,24m
2568,1,SNU,2304,1654,113,141,254,44.5%,49m
2569,2,아잉,2303,140,3,5,8,37.5%,25m
2570,2,KnightSoul,2302,304,29,29,58,50.0%,20m
2571,2,[oxox]ZooM,2301,48,1,4,5,20.0%,24m
2572,2,[밀리터리버거]MUSAT,2300,160,6,5,11,54.5%,48m
2573,3,인공지능,2299,199,5,6,11,45.5%,26m
2573,1,dnjTmekdandy,2299,42,2,12,14,14.3%,21m
2575,2,Fyr,2298,0,2,5,7,28.6%,29m
2575,2,GalaxyBoxS,2298,40,1,6,7,14.3%,48m
2577,1,[異化蟲公會]木質地板,2295,408,31,43,74,41.9%,22m
2578,2,[Cities]혼종,2293,262,9,12,21,42.9%,28m
2579,1,특공대출신,2292,0,2,7,9,22.2%,48m
2580,1,IlIlIlIlIl,2289,1208,209,231,440,47.5%,23m
2580,2,도장,2289,212,7,9,16,43.8%,29m
2582,2,kini,2283,0,0,2,2,0.0%,48m
2583,1,PEACEMAKER,2279,118,3,9,12,25.0%,49m
2584,3,[NCF]Crankit,2276,868,42,40,82,51.2%,27m
2585,3,JoHuiJe,2275,682,26,26,52,50.0%,26m
2585,2,복숭아,2275,338,10,23,33,30.3%,29m
2587,2,[SS친위대]짱맨,2271,30,2,4,6,33.3%,20m
2588,1,QsmileQ,2270,145,3,12,15,20.0%,25m
2589,3,안녕세희,2269,0,0,1,1,0.0%,23m
2590,3,lIlIlIlIlIlI,2268,0,0,1,1,0.0%,23m
2591,3,Hau,2267,0,0,1,1,0.0%,47m
2592,3,[異化蟲公會]bulaya,2266,0,1,0,1,100.0%,47m
2593,3,[브론즈같은]Glraurung,2263,290,10,10,20,50.0%,27m
2593,2,Lan,2263,0,1,3,4,25.0%,29m
2595,1,ljm,2261,1585,71,84,155,45.8%,49m
2595,3,Royal,2261,162,12,10,22,54.5%,27m
2595,3,[유즈맵떠돌이]SteponRed,2261,0,1,5,6,16.7%,24m
2598,3,[OldGuy]TritiumS,2260,0,1,0,1,100.0%,27m
2599,3,저그연습많이하자,2257,0,3,2,5,60.0%,27m
2600,1,lllllllllll,2255,96,3,0,3,100.0%,26m
2601,1,unicon,2253,1102,114,121,235,48.5%,21m
2602,2,[미믹]red,2252,180,5,6,11,45.5%,48m
2603,2,NachoLibro,2251,0,1,1,2,50.0%,28m
2604,3,그루트,2250,0,1,0,1,100.0%,24m
2605,3,[DSA]Omegatherion,2248,86,4,4,8,50.0%,43m
2606,2,배터진푸우,2245,1126,46,45,91,50.5%,29m
2607,2,CptPrice,2242,498,18,18,36,50.0%,28m
2607,2,[日本]IIIIIIIIIIII,2242,332,11,17,28,39.3%,48m
2609,1,농마고박격포,2241,0,0,1,1,0.0%,26m
2610,3,ajtwoddl,2240,174,6,2,8,75.0%,27m
2610,2,벤치프레스,2240,40,2,2,4,50.0%,24m
2612,2,오쌍,2239,638,23,31,54,42.6%,48m
2612,3,htviva,2239,155,4,4,8,50.0%,28m
2612,3,JASON,2239,118,2,3,5,40.0%,27m
2612,3,[천사들의모임]시원한온풍기,2239,0,0,1,1,0.0%,26m
2616,3,Scorpion,2238,0,0,4,4,0.0%,47m
2617,3,잘하고싶다,2236,0,2,3,5,40.0%,43m
2618,3,싸울아비,2235,1498,55,62,117,47.0%,27m
2619,3,가을하늘,2230,202,7,8,15,46.7%,27m
2620,3,Pada,2229,0,0,2,2,0.0%,26m
2621,2,Archangel,2226,90,3,10,13,23.1%,24m
2622,2,달려라끔,2225,143,2,1,3,66.7%,24m
2623,3,oryzasativa,2222,0,1,4,5,20.0%,24m
2624,2,clemismyhero,2221,318,10,21,31,32.3%,29m
2624,3,mher,2221,0,0,1,1,0.0%,27m
2626,1,[캬루]귀여운고양이,2220,223,7,8,15,46.7%,26m
2626,3,공격형,2220,0,0,4,4,0.0%,27m
2628,2,섭섭이,2217,0,0,2,2,0.0%,20m
2629,3,Fireghost,2215,0,2,3,5,40.0%,24m
2630,3,비빔면만들기,2210,365,19,14,33,57.6%,26m
2631,2,슈비,2208,88,4,7,11,36.4%,24m
2632,3,최대영,2204,0,1,0,1,100.0%,47m
2633,3,Newbie,2200,90,5,8,13,38.5%,27m
2634,3,Infernal,2198,0,1,0,1,100.0%,27m
2635,3,Akame,2189,172,6,8,14,42.9%,26m
2636,2,asdfqwerghjk,2188,1128,88,101,189,46.6%,20m
2636,3,Kim,2188,303,11,21,32,34.4%,28m
2638,3,[TheDOH]becomm,2185,0,0,1,1,0.0%,27m
2639,3,MadFlames,2183,0,0,6,6,0.0%,27m
2640,2,한약,2181,1282,180,221,401,44.9%,29m
2641,2,sonata,2179,635,26,35,61,42.6%,29m
2642,3,NERDSamurai,2177,338,11,13,24,45.8%,48m
2643,3,MiniTitan,2172,0,2,2,4,50.0%,24m
2644,3,TYyayayay,2170,0,1,4,5,20.0%,24m
2644,2,호나우지뉴,2170,0,0,1,1,0.0%,25m
2646,3,[독일국방군]백호,2168,86,7,4,11,63.6%,47m
2647,3,[읭읭이]놉놉놉,2162,174,6,6,12,50.0%,28m
2648,2,기절,2159,332,12,22,34,35.3%,48m
2649,3,jbomb,2158,36,2,0,2,100.0%,43m
2650,2,쏘핫,2157,642,22,36,58,37.9%,28m
2651,3,Namikaze,2155,625,24,25,49,49.0%,26m
2652,3,LETO,2151,1492,126,158,284,44.4%,26m
2652,3,[66]클로저스미래방유,2151,0,1,0,1,100.0%,26m
2652,2,Berserker,2151,0,1,3,4,25.0%,25m
2655,3,llllllllll,2150,0,0,1,1,0.0%,43m
2656,3,초보에오,2146,277,12,12,24,50.0%,26m
2657,3,[뭔가거대한]하급군졸,2145,0,0,1,1,0.0%,27m
2658,3,fortuna,2144,333,13,16,29,44.8%,27m
2659,3,CollinCobra,2142,30,1,4,5,20.0%,28m
2660,3,JDlove,2140,0,1,0,1,100.0%,23m
2661,3,밥태담당일진,2137,0,0,1,1,0.0%,27m
2662,1,kama,2136,294,12,18,30,40.0%,48m
2663,2,라비렉스,2135,205,7,15,22,31.8%,48m
2664,3,허리케인비너스,2134,0,0,6,6,0.0%,23m
2665,2,[銅牌上不去]IIIIIIIIIIII,2132,0,1,3,4,25.0%,24m
2666,3,[Apink2]Apink,2128,540,18,32,50,36.0%,43m
2667,2,테라몽,2127,137,3,10,13,23.1%,48m
2668,3,[어윤수님개쩜]공의가저죽여요,2126,0,3,3,6,50.0%,27m
2669,3,뮤탈점추배틀,2124,653,25,27,52,48.1%,47m
2670,3,Skullz,2120,0,1,4,5,20.0%,27m
2671,1,상추카운터배추,2113,144,2,2,4,50.0%,25m
2672,3,阿琪仔,2106,0,0,2,2,0.0%,26m
2673,3,개요르꽁,2101,390,13,21,34,38.2%,27m
2674,3,ohdugi,2099,393,13,15,28,46.4%,26m
2674,1,MVP,2099,44,1,2,3,33.3%,25m
2674,3,구랭킹,2099,30,1,3,4,25.0%,27m
2674,1,胡小胖,2099,0,0,1,1,0.0%,26m
2678,1,시간을달려서,2098,1353,87,159,246,35.4%,7m
2679,3,BIGCHEeZY,2089,0,1,6,7,14.3%,23m
2679,1,[아케더]한서선민,2089,0,0,1,1,0.0%,25m
2681,2,llllllllllll,2083,509,18,28,46,39.1%,29m
2681,1,[밀짚모해적단]BeastYak,2083,0,0,1,1,0.0%,26m
2683,2,chaoswar,2081,307,7,15,22,31.8%,24m
2684,3,[G20]스가,2080,0,0,1,1,0.0%,24m
2684,3,明日方舟,2080,0,0,2,2,0.0%,24m
2686,3,JKimmich,2078,36,1,6,7,14.3%,43m
2687,3,BlueBerryBox,2076,0,0,2,2,0.0%,23m
2688,1,[GITS]cavalier,2073,140,3,3,6,50.0%,26m
2689,1,kioh,2072,96,2,2,4,50.0%,26m
2690,1,Zerg,2070,48,1,3,4,25.0%,26m
2691,3,PLLAR,2068,0,1,7,8,12.5%,28m
2692,3,[개복교]ceo,2057,290,11,20,31,35.5%,27m
2693,1,[HKGA]ckc,2054,0,0,3,3,0.0%,26m
2694,1,Lawracz,2053,1524,69,102,171,40.4%,23m
2695,1,[신뢰]blueshark,2049,0,0,2,2,0.0%,25m
2696,2,danny,2046,494,17,33,50,34.0%,48m
2697,1,[SlGN]priester,2043,142,3,1,4,75.0%,25m
2698,2,LikMijnBalle,2042,150,3,3,6,50.0%,24m
2699,1,[CIA암살단]생각의질서,2038,70,2,2,4,50.0%,26m
2700,3,[비트]ahjahahjah,2036,216,7,18,25,28.0%,43m
2701,3,aitan,2033,443,15,30,45,33.3%,27m
2702,1,holeman,2031,168,4,3,7,57.1%,26m
2703,2,qwer,2030,44,1,4,5,20.0%,25m
2704,1,[電磁學]時曲同學,2028,0,0,1,1,0.0%,26m
2705,3,duy,2024,583,63,80,143,44.1%,27m
2706,1,Dunscout,2021,94,2,4,6,33.3%,26m
2707,3,瑒瑒,2020,205,6,11,17,35.3%,48m
2708,3,BJrhb,2019,568,21,26,47,44.7%,47m
2708,3,JunLPM,2019,0,1,5,6,16.7%,23m
2710,2,llllllllllll,2018,0,3,9,12,25.0%,24m
2711,3,FlameWizzard,2016,0,1,3,4,25.0%,24m
2712,1,대갈공명,2006,0,0,1,1,0.0%,26m
2713,3,서부호준,2002,1153,45,62,107,42.1%,26m
2714,1,PowerMoveR,2000,1384,34,53,87,39.1%,26m
2715,1,스타초보,1997,502,13,14,27,48.1%,26m
2715,3,Edward,1997,40,2,0,2,100.0%,24m
2717,3,Steelwing,1994,374,12,23,35,34.3%,28m
2718,1,십육쩜오센티,1989,0,0,1,1,0.0%,26m
2718,1,natsutea,1989,0,0,4,4,0.0%,26m
2720,1,Unknown,1986,0,1,4,5,20.0%,26m
2721,1,죠리퐁,1984,88,2,4,6,33.3%,26m
2722,3,통큰대장부,1981,844,31,49,80,38.8%,27m
2722,1,Mejkstar,1981,203,6,20,26,23.1%,25m
2724,3,팩토리,1979,0,2,7,9,22.2%,27m
2725,3,망고맛완두콩,1972,0,0,4,4,0.0%,48m
2726,1,너님맛사탕,1969,0,0,1,1,0.0%,26m
2727,2,真命天子,1957,1186,118,174,292,40.4%,29m
2728,1,현키,1956,229,6,7,13,46.2%,26m
2728,3,ZERO,1956,0,1,0,1,100.0%,23m
2730,3,NEO,1955,0,0,1,1,0.0%,24m
2731,2,KALKYdrlord,1950,88,1,3,4,25.0%,24m
2732,1,Harvest,1949,0,1,0,1,100.0%,26m
2733,1,시골농부,1938,1123,34,43,77,44.2%,26m
2733,1,MrKrabs,1938,0,0,5,5,0.0%,26m
2735,1,바주세요,1927,122,2,9,11,18.2%,26m
2735,1,Usopp,1927,0,0,1,1,0.0%,26m
2737,1,ygji,1926,46,2,5,7,28.6%,25m
2738,3,이화유치원,1924,0,0,6,6,0.0%,27m
2739,1,흑단태영,1923,0,0,1,1,0.0%,26m
2739,1,modickm,1923,0,0,5,5,0.0%,25m
2741,1,[Master]NewB,1910,140,3,17,20,15.0%,26m
2742,3,한세빈느,1906,40,1,8,9,11.1%,43m
2743,3,[생각대로]못진남자,1903,58,3,1,4,75.0%,24m
2744,1,Olive,1900,1414,142,252,394,36.0%,25m
2745,1,TaTo,1891,0,0,6,6,0.0%,26m
2746,1,흑마법사,1879,0,2,3,5,40.0%,26m
2747,3,llllllllllll,1876,0,0,1,1,0.0%,24m
2748,3,김민재,1871,70,2,5,7,28.6%,23m
2749,3,해병의기묘한모험,1868,58,6,9,15,40.0%,47m
2750,3,Daddy,1861,95,1,9,10,10.0%,47m
2751,1,릭스,1857,48,2,3,5,40.0%,26m
2752,2,qvo,1849,116,2,3,5,40.0%,24m
2753,2,[NCF]크란이,1844,0,0,5,5,0.0%,24m
2754,3,고추를든남자,1824,380,12,40,52,23.1%,27m
2755,3,superbeginer,1814,0,0,1,1,0.0%,24m
2756,3,kola,1801,76,3,16,19,15.8%,24m
2757,2,이티,1792,42,1,6,7,14.3%,24m
2758,3,FireadeDrago,1783,30,2,13,15,13.3%,43m
2759,2,compalpippen,1749,137,2,17,19,10.5%,24m
2760,3,OopsReach,1746,1112,63,115,178,35.4%,27m
2761,2,아이유뚝배기,1739,128,5,0,5,100.0%,25m
2762,3,[TTM]kris,1708,30,2,2,4,50.0%,24m
2763,2,[krtag]디바왜불러,1642,433,11,29,40,27.5%,24m
2764,2,[중금속중독자]천살성,1618,295,13,23,36,36.1%,24m
2765,2,고속버스,1615,60,2,6,8,25.0%,24m
2766,3,[G20]윤석열,1601,0,0,1,1,0.0%,43m
2767,3,시진핑,1598,0,0,7,7,0.0%,24m
2768,1,사령관,1594,1154,437,483,920,47.5%,26m
2769,1,지존,1552,1135,415,447,862,48.1%,26m
2770,3,[G20]문재인,1532,0,0,1,1,0.0%,43m
2771,2,[教我合作]喵喵,1511,1380,571,657,1228,46.5%,24m
2772,3,starcraf,1505,0,0,1,1,0.0%,23m
2773,3,[G20]마크롱,1434,0,0,1,1,0.0%,43m
2774,3,Amalthea,1407,48,1,45,46,2.2%,43m
