rank,tier,name,mmr,points,wins,losses,played,winrate,age
1,1,llllllllllll,6958,577,22,1,23,95.7%,2m
2,1,[TeamNV]Maru,6857,0,0,1,1,0.0%,2m
3,1,llllllllllll,6838,204,5,1,6,83.3%,8m
4,1,OGAna,6783,192,5,0,5,100.0%,2m
5,1,llllllllllll,6776,864,19,1,20,95.0%,2m
6,1,llllllllllll,6730,121,3,0,3,100.0%,2m
7,1,llllllllllll,6681,409,7,2,9,77.8%,2m
8,1,llllllllllll,6652,4052,147,84,231,63.6%,2m
9,1,llllllllllll,6641,336,8,5,13,61.5%,8m
10,1,[Kaizi]TIME,6629,433,10,1,11,90.9%,2m
11,1,lIlIlIlllIII,6614,222,7,6,13,53.8%,2m
12,1,DPGCure,6613,0,1,0,1,100.0%,6m
13,1,llllllllllll,6603,888,21,6,27,77.8%,2m
14,1,llllllllllll,6582,268,9,3,12,75.0%,2m
15,1,llllllllllll,6575,3616,114,60,174,65.5%,2m
16,1,llllllllllll,6569,3977,213,88,301,70.8%,2m
17,1,IIIIIIIIIIII,6567,3930,429,266,695,61.7%,2m
18,1,[Kaizi]INnoVation,6542,2676,216,113,329,65.7%,2m
19,1,[GGGSC2]Dream,6481,2027,117,66,183,63.9%,2m
20,1,LiquidTaeJa,6428,288,6,4,10,60.0%,6m
21,1,IIIIIIIIIIII,6361,1598,55,45,100,55.0%,2m
22,1,llllllllllll,6350,3860,727,617,1344,54.1%,2m
23,1,llllllllllll,6315,144,4,1,5,80.0%,8m
24,1,[인투더]TYTY,6307,2140,73,60,133,54.9%,2m
25,1,llllllllllll,6301,550,27,3,30,90.0%,2m
26,1,lllllllllIlI,6269,240,5,3,8,62.5%,2m
27,1,llllIIIlllIl,6265,472,14,6,20,70.0%,6m
28,1,wake,6250,1787,196,111,307,63.8%,6m
29,1,llllllllllll,6230,3786,509,446,955,53.3%,2m
30,1,llllllllllll,6221,1611,111,111,222,50.0%,2m
31,1,[인투더]Rookie,6176,144,4,2,6,66.7%,2m
32,1,[Dopen]KeeN,6161,46,2,1,3,66.7%,2m
33,1,llllllllllll,6158,1469,55,58,113,48.7%,8m
34,1,llllllllllll,6137,1745,47,37,84,56.0%,2m
35,1,[TeamNV]Percival,6099,1913,109,97,206,52.9%,8m
36,1,llllllllllll,6063,3588,149,114,263,56.7%,2m
36,1,신의한수,6063,766,104,81,185,56.2%,2m
38,1,llllllllllll,6056,48,3,3,6,50.0%,6m
39,1,llllllllllll,6017,2121,77,57,134,57.5%,2m
40,1,iGCoffeeMs,6013,167,4,1,5,80.0%,2m
41,1,초보입니다,5956,1867,92,79,171,53.8%,6m
42,1,oGsForGG,5940,3327,390,226,616,63.3%,2m
43,1,IIlIlIllIlIl,5921,532,13,15,28,46.4%,2m
43,1,llllllllllll,5921,0,1,0,1,100.0%,2m
45,1,[TeamNV]IntoTheSpear,5920,3428,193,175,368,52.4%,2m
46,1,[Percy]DoveMayo,5918,328,8,2,10,80.0%,2m
47,1,llllllllllll,5908,310,64,15,79,81.0%,2m
48,1,llllllllIIll,5889,543,19,26,45,42.2%,6m
49,1,[GIS]MaoYu,5888,0,0,1,1,0.0%,2m
50,1,llllllllllll,5885,482,18,24,42,42.9%,8m
51,1,爆激動炸裂敗,5884,46,1,1,2,50.0%,2m
52,1,HHs,5871,3022,469,379,848,55.3%,2m
53,1,llllllllllll,5861,1028,47,21,68,69.1%,2m
54,1,[유튜브에링스]llllllllllll,5833,906,332,253,585,56.8%,2m
54,1,[네오]덤벼라세상아,5833,811,26,27,53,49.1%,2m
56,1,[상동T]lIlIIIIllI,5824,3412,181,149,330,54.8%,2m
57,1,[무한오영종]llllllllllll,5813,781,38,8,46,82.6%,2m
58,1,lIlIlIlIlllI,5808,1031,51,0,51,100.0%,2m
59,2,笑鼠人,5791,0,1,1,2,50.0%,5m
60,1,llllllllllll,5784,720,28,46,74,37.8%,2m
61,1,llllllllllll,5724,0,1,0,1,100.0%,8m
62,1,BomBeR,5712,0,0,1,1,0.0%,8m
63,1,SuperNova,5709,1805,74,86,160,46.2%,2m
64,1,llIllIllIlll,5699,1833,54,35,89,60.7%,2m
65,1,[Yisc]Lilpearl,5688,2421,91,65,156,58.3%,2m
66,1,llllllllllll,5668,0,0,2,2,0.0%,8m
67,1,[임윤아예뻐]Byun,5665,910,24,22,46,52.2%,2m
68,1,[XYFANS]Soularium,5656,42,2,1,3,66.7%,8m
69,1,마지막두달,5643,1420,357,226,583,61.2%,8m
70,1,Reaverouo,5641,40,2,6,8,25.0%,6m
71,1,[TeamNV]sOs,5635,0,1,2,3,33.3%,2m
72,1,Stella,5628,180,5,3,8,62.5%,8m
73,1,[ELS]Hwasin,5623,0,1,0,1,100.0%,8m
74,1,[ClanGP]두둥탃,5609,0,0,1,1,0.0%,2m
75,1,IIIIIIllllII,5603,1993,66,51,117,56.4%,2m
76,1,IlIlIlIlIlIl,5597,38,2,2,4,50.0%,2m
77,1,[줄어드는인구]llllllllllll,5591,2062,71,55,126,56.3%,2m
78,1,IIIIIIIIIIII,5589,0,1,0,1,100.0%,8m
79,1,[인투더]SpeCial,5587,118,3,9,12,25.0%,8m
80,1,[Lotuz]長門有希,5568,0,0,1,1,0.0%,8m
81,1,노가다갤러리,5565,694,19,18,37,51.4%,6m
82,1,[트수Crew]DPGDark,5561,48,1,3,4,25.0%,2m
83,1,llllllllllll,5559,216,5,8,13,38.5%,8m
84,1,小坚强,5554,672,19,13,32,59.4%,8m
85,1,llllllllllll,5553,452,14,47,61,23.0%,8m
86,1,[ELS]안정인,5548,814,23,11,34,67.6%,2m
87,1,IIIIIIIIIIII,5543,0,1,0,1,100.0%,6m
88,1,[170720]LinkinPark,5531,623,29,15,44,65.9%,6m
89,1,[지니오육천감]llllllllllll,5523,3163,264,215,479,55.1%,2m
90,1,[ELS]IlIlIlIlIlIl,5518,0,0,1,1,0.0%,2m
91,1,llllllllllII,5512,326,11,5,16,68.8%,2m
92,1,llllllllllll,5510,546,29,29,58,50.0%,2m
93,1,llllllllllll,5507,717,18,7,25,72.0%,2m
94,1,IIIIIIIIII,5503,2972,170,137,307,55.4%,2m
95,1,llllllllllll,5502,0,0,1,1,0.0%,2m
96,1,IIIIIIIIIIII,5498,1704,153,150,303,50.5%,8m
97,1,llllllllllll,5494,0,1,0,1,100.0%,2m
98,1,IlIlIlIlIlIl,5493,0,1,0,1,100.0%,8m
99,1,llllllllllll,5477,200,6,0,6,100.0%,6m
100,1,[인투더]IntoTheJung,5451,648,19,12,31,61.3%,2m
101,1,[무한오영종]인생모잇어,5450,2931,520,399,919,56.6%,2m
102,1,[NGameS]새드엔딩,5448,518,19,7,26,73.1%,6m
103,1,[NsP]아싸가오리,5442,3104,698,591,1289,54.2%,2m
104,1,llllllllllll,5440,224,6,5,11,54.5%,8m
105,1,llllllllllll,5413,1086,60,24,84,71.4%,2m
106,1,[Lotuz]FanTaSy,5399,962,45,29,74,60.8%,6m
107,1,lIlIlIlIlIlI,5387,804,38,41,79,48.1%,2m
108,1,llllllllllll,5377,46,1,1,2,50.0%,2m
109,1,[백수들]일꾼도살자,5373,88,2,6,8,25.0%,6m
110,1,technology,5358,252,9,8,17,52.9%,2m
111,1,lllllllll,5349,344,8,4,12,66.7%,2m
112,1,[KRxd]PracticeX,5348,50,2,1,3,66.7%,6m
113,1,[TeamGP]EunkOng,5344,1279,40,32,72,55.6%,2m
114,1,llllllllllll,5342,609,21,13,34,61.8%,2m
115,3,황국신민,5339,0,1,0,1,100.0%,14m
116,1,[GGGSC2]cyan,5338,0,0,1,1,0.0%,8m
116,1,잠만저진짜초보임,5338,0,0,1,1,0.0%,8m
118,1,llllllllllll,5336,534,19,21,40,47.5%,6m
119,1,IIIIIIIIIII,5335,383,12,11,23,52.2%,2m
120,1,IIIIIIIIIIII,5333,3060,626,530,1156,54.2%,2m
120,1,[Dopen]CarGO,5333,0,1,0,1,100.0%,8m
122,1,[Hyper]새벽택배상하차,5331,0,0,1,1,0.0%,2m
123,1,david,5328,316,36,24,60,60.0%,2m
124,1,IIIIIIII,5327,0,1,0,1,100.0%,7m
125,1,[SofT]씹덕담당일진,5317,504,23,16,39,59.0%,2m
126,1,Salam,5314,492,52,10,62,83.9%,2m
126,1,안정인,5314,48,3,4,7,42.9%,2m
128,1,llllllllllll,5312,142,2,1,3,66.7%,6m
129,1,[SG2021]Hiro,5311,369,26,23,49,53.1%,2m
130,1,[TeamGP]llIlllIlllIl,5309,248,12,1,13,92.3%,2m
130,1,[TeamNV]Creator,5309,0,1,0,1,100.0%,8m
132,1,[푸른장미]llllllllllll,5307,100,4,2,6,66.7%,6m
133,1,lIlIlIlIlIlI,5304,542,26,23,49,53.1%,2m
133,1,[海基王搬哉]MeOwEx,5304,68,3,0,3,100.0%,6m
135,1,[무한오영종]llllllllllll,5303,129,2,1,3,66.7%,2m
136,1,KelMorian,5302,724,41,7,48,85.4%,2m
136,1,[무한오영종]OldDraGoN,5302,406,18,12,30,60.0%,8m
136,1,Anxiety,5302,0,0,1,1,0.0%,2m
139,1,llllllllllll,5301,30,1,2,3,33.3%,6m
140,1,EsC,5300,1161,49,48,97,50.5%,6m
141,1,Perfecto,5296,212,6,6,12,50.0%,6m
142,1,IIIlllIIl,5286,544,20,16,36,55.6%,6m
143,1,[TeamNV]HwaRanG,5280,841,31,16,47,66.0%,2m
144,1,Duke,5278,2019,111,85,196,56.6%,2m
145,1,llllllllllll,5275,134,6,8,14,42.9%,2m
145,1,COSMOS,5275,0,0,2,2,0.0%,8m
147,1,[HAKSAL]Nicemono,5270,764,53,18,71,74.6%,2m
148,2,llllllllllll,5268,214,10,3,13,76.9%,5m
149,2,llllllllllll,5267,284,10,2,12,83.3%,5m
150,1,多線,5259,168,8,7,15,53.3%,2m
151,2,lovely,5257,680,54,9,63,85.7%,2m
152,3,llllllllllll,5254,0,1,0,1,100.0%,5m
153,3,[Elaina]IlllllIIllIl,5248,26,3,2,5,60.0%,14m
154,1,[XYFANS]Starry,5246,1464,64,47,111,57.7%,2m
155,1,IlIlIlIlIlIl,5243,2771,375,325,700,53.6%,2m
156,2,llllllllllll,5242,70,8,3,11,72.7%,5m
157,2,IIIIIIIIIIII,5240,395,20,11,31,64.5%,2m
158,1,[GGGSC2]Patience,5238,960,58,33,91,63.7%,2m
159,1,milkyway,5236,175,8,3,11,72.7%,2m
160,1,[무한오영종]IIIIIIIIIIIl,5233,1748,71,58,129,55.0%,2m
161,2,llllllllllll,5215,0,0,1,1,0.0%,2m
162,1,[AFSC2]Stats,5213,0,0,4,4,0.0%,2m
163,1,[SofT]멜론화채,5211,642,23,12,35,65.7%,2m
164,2,llllllllllll,5210,959,58,19,77,75.3%,5m
164,2,[紅曜石]愛因克洛提德,5210,80,3,2,5,60.0%,5m
166,1,PartinG,5200,789,38,22,60,63.3%,2m
167,1,BIizzard,5199,2723,313,234,547,57.2%,2m
168,1,lllIlllIlllI,5196,928,32,22,54,59.3%,2m
169,1,llllllllllll,5193,2867,476,376,852,55.9%,2m
170,1,MYMY,5191,2589,121,92,213,56.8%,2m
171,2,llllllllllll,5187,0,0,3,3,0.0%,5m
172,1,IIIIIIIIIIII,5184,584,17,11,28,60.7%,2m
173,1,seventheman,5182,382,26,11,37,70.3%,2m
173,1,[sc2mc]llllllllllll,5182,0,0,5,5,0.0%,6m
175,2,[Nazzi]LuftWaffe,5179,1668,133,124,257,51.8%,2m
176,2,IIIIIIIIIIII,5178,213,14,11,25,56.0%,5m
177,1,[SOS団]스즈미야하루히,5175,1661,90,69,159,56.6%,2m
178,2,IIIIIIIIIIII,5174,2006,122,74,196,62.2%,5m
179,2,[NDW]鐵工,5169,1576,84,56,140,60.0%,5m
180,2,thuggerthugg,5167,46,2,1,3,66.7%,2m
181,2,llllllllllll,5166,46,1,1,2,50.0%,5m
182,2,[SOS団]長門有希,5161,8,1,2,3,33.3%,5m
183,2,Goomba,5159,16,1,3,4,25.0%,2m
184,2,Healer,5156,726,45,4,49,91.8%,5m
185,2,[sc2mc]土城棉花糖,5151,276,11,6,17,64.7%,5m
185,2,[NDW]KevinLiu,5151,0,1,0,1,100.0%,2m
187,1,[這人族爛歸爛]但操作還可以,5144,624,20,24,44,45.5%,2m
188,2,shoho,5141,322,16,12,28,57.1%,2m
188,2,LLIILLILI,5141,126,6,4,10,60.0%,5m
190,1,[고외몽메타몽]앵무,5137,1402,67,63,130,51.5%,2m
191,1,[야근싫어요]llllllllllll,5135,0,1,0,1,100.0%,15m
192,1,Outrageous,5129,2905,317,266,583,54.4%,2m
192,2,llllllllllll,5129,326,15,13,28,53.6%,5m
192,2,llIlIlIlllIl,5129,430,13,23,36,36.1%,5m
195,2,IIIIIIIIIIII,5120,0,0,3,3,0.0%,2m
196,2,[테란저그토스]포도,5119,1815,107,87,194,55.2%,5m
197,1,kapterhan,5112,286,10,14,24,41.7%,8m
198,2,[무한오영종]BlackFresh,5109,28,2,9,11,18.2%,5m
199,1,llllllllllll,5102,2536,209,209,418,50.0%,2m
199,2,可愛小烈子我老婆,5102,705,103,50,153,67.3%,2m
201,1,[무한오영종]llllllllllll,5101,1748,78,58,136,57.4%,2m
202,2,llllllllllll,5100,60,2,5,7,28.6%,5m
203,1,[무한양승준]토스좀꺼지세요,5096,887,38,33,71,53.5%,2m
204,2,llllllllllll,5094,262,20,9,29,69.0%,5m
205,1,TrollMaster,5087,728,48,13,61,78.7%,2m
206,2,Magarin,5086,2295,182,162,344,52.9%,2m
207,2,IIIIIIIIIIII,5084,186,12,9,21,57.1%,5m
208,1,[WDY]jinioh,5082,2786,985,887,1872,52.6%,2m
209,2,llllllllllll,5078,515,40,3,43,93.0%,2m
210,1,llllllllllll,5077,192,9,3,12,75.0%,2m
210,2,군신의마지막갈망,5077,48,3,3,6,50.0%,4m
212,2,[快樂玩家]藍教授,5072,1644,132,131,263,50.2%,2m
212,2,[Yisc]Genji,5072,1631,74,69,143,51.7%,2m
214,2,[신대방]곰돌이푸,5069,0,0,2,2,0.0%,5m
215,2,근본없는빌드만씀,5061,6,2,0,2,100.0%,5m
216,2,llllllllllll,5060,70,7,4,11,63.6%,5m
216,2,llllllllllll,5060,0,0,1,1,0.0%,2m
218,2,낙서장인,5059,0,0,1,1,0.0%,5m
219,1,llllllllllll,5057,507,25,22,47,53.2%,2m
220,1,IIIIIIIIIIII,5052,1833,128,116,244,52.5%,2m
221,2,[Froz3N]Science,5051,363,28,14,42,66.7%,5m
222,2,[假奶粉]裂光球,5050,22,1,7,8,12.5%,2m
223,2,[ANGG]GlaDiAtoR,5047,0,1,0,1,100.0%,5m
224,1,Origin,5046,1381,106,89,195,54.4%,2m
224,2,lIlIlIlIlIlI,5046,1410,100,82,182,54.9%,2m
224,2,AmongUsPlx,5046,0,1,1,2,50.0%,5m
227,1,llllllllllll,5043,2535,119,122,241,49.4%,2m
227,2,[3239]한위너,5043,0,0,1,1,0.0%,2m
229,1,[369]DestroyingKR,5042,2097,907,920,1827,49.6%,2m
229,2,테란슛,5042,28,3,2,5,60.0%,2m
231,2,speaknow,5040,239,12,7,19,63.2%,5m
232,2,[얼라이브]Penalty,5039,0,0,1,1,0.0%,5m
233,2,Karl,5038,0,0,1,1,0.0%,5m
233,2,mini,5038,0,0,2,2,0.0%,5m
235,2,[인투더]IntoTheLemon,5037,0,1,0,1,100.0%,2m
236,2,[AFSC2]Armani,5035,217,11,8,19,57.9%,5m
237,2,IIIIIIIIIIII,5032,0,0,1,1,0.0%,5m
238,1,IlllIIlllIlI,5030,467,30,31,61,49.2%,2m
238,2,[ELS]김월터,5030,100,8,0,8,100.0%,5m
240,2,lIlllllllIl,5026,672,42,2,44,95.5%,2m
240,2,[고졸테란]HonMonO,5026,86,3,2,5,60.0%,5m
242,2,[어윤수님개쩜]캡틴티모나루,5025,741,45,32,77,58.4%,2m
242,2,[쇼타임]테스형,5025,0,0,1,1,0.0%,5m
244,2,IIIIIIIIIII,5023,2025,108,97,205,52.7%,2m
245,2,llllllllllll,5021,0,1,0,1,100.0%,5m
246,2,[NDW]AresRush,5016,1716,211,177,388,54.4%,5m
247,2,[ELS]Han,5015,2443,131,114,245,53.5%,5m
248,2,SSS,5014,358,23,18,41,56.1%,5m
249,2,비둘기까마귀,5012,160,8,17,25,32.0%,2m
249,3,发生甚么事了,5012,16,3,1,4,75.0%,14m
251,3,[Yisc]Heavenly,5011,2495,874,819,1693,51.6%,5m
252,3,[오천크스]ZmkA,5009,0,0,1,1,0.0%,9m
253,3,苏州孙一峰,5005,561,61,44,105,58.1%,14m
254,3,BratOK,5004,460,26,1,27,96.3%,5m
255,3,llllllllllll,5003,2530,157,143,300,52.3%,5m
255,3,氫鍵,5003,46,6,4,10,60.0%,5m
257,2,llllllllllll,5002,58,3,8,11,27.3%,5m
258,2,술이야,5001,150,9,9,18,50.0%,2m
259,2,IllIlllIllIl,5000,875,50,32,82,61.0%,5m
259,2,llllllllllll,5000,620,46,27,73,63.0%,5m
259,3,史上沒救爛,5000,142,18,7,25,72.0%,4m
262,3,[무한오영종]Americano,4998,1262,107,60,167,64.1%,4m
262,3,[IRIN]Name,4998,22,4,2,6,66.7%,6m
264,2,Everyday,4996,211,9,9,18,50.0%,5m
265,3,[래더납치범]Christine,4995,0,0,1,1,0.0%,5m
266,2,IIIIIIIIIIII,4993,388,20,18,38,52.6%,5m
267,2,llllllllllll,4991,575,33,26,59,55.9%,2m
268,3,Pain,4988,130,14,10,24,58.3%,5m
269,2,[αX]RAGNAROK,4987,319,19,15,34,55.9%,2m
270,3,[네오]elizae,4982,408,29,26,55,52.7%,9m
271,2,IllIlIlIIllI,4981,142,8,10,18,44.4%,2m
272,3,김치슈퍼맨,4979,0,0,1,1,0.0%,14m
273,3,llllllllllll,4975,651,44,21,65,67.7%,6m
274,3,테란으로어케이김,4974,138,10,11,21,47.6%,5m
275,3,IIIIIIIII,4973,40,9,8,17,52.9%,14m
276,3,[SPTS]香菇藍瘦的熊貓,4969,0,1,0,1,100.0%,5m
277,3,IlIlIlIlIlIl,4962,730,36,33,69,52.2%,5m
278,2,Lefty,4960,750,40,43,83,48.2%,2m
278,3,KeyWorD,4960,0,0,1,1,0.0%,5m
280,2,[무한오영종]등푸른생선,4956,1313,72,63,135,53.3%,2m
280,3,ByuN,4956,115,3,0,3,100.0%,4m
282,3,dumbgame,4951,22,4,3,7,57.1%,5m
283,2,[푸른장미]Skewed,4945,1839,97,86,183,53.0%,5m
283,3,동래굴링,4945,252,19,18,37,51.4%,14m
283,3,건설로봇,4945,0,0,1,1,0.0%,3m
286,3,[TeamGP]LunaSea,4942,1589,109,94,203,53.7%,9m
286,3,llllllllllll,4942,18,3,2,5,60.0%,5m
288,3,llllllllllll,4941,446,38,30,68,55.9%,3m
289,2,IIIIIIIIIIII,4940,0,0,5,5,0.0%,4m
290,3,llllllllllll,4939,2,1,1,2,50.0%,14m
291,3,Shin,4938,14,3,3,6,50.0%,9m
292,3,[XYFANS]llllllllllll,4937,50,7,6,13,53.8%,6m
293,3,llllllllllll,4936,479,75,68,143,52.4%,6m
294,2,[무한오영종]Origin,4934,1183,74,63,137,54.0%,5m
295,3,[프릭업]CluBBerAoi,4933,2,2,0,2,100.0%,5m
296,3,MyOhMind,4929,201,23,7,30,76.7%,6m
297,3,[Crank]llllllllllll,4928,6,1,2,3,33.3%,5m
298,3,llllllllllll,4927,0,1,0,1,100.0%,4m
299,3,llllllllllll,4923,194,24,19,43,55.8%,14m
299,3,KKooM,4923,0,0,1,1,0.0%,3m
301,3,BLuEBooK,4922,0,1,0,1,100.0%,5m
302,3,llllllllllll,4920,36,2,6,8,25.0%,4m
303,2,llllllllllll,4918,2475,564,559,1123,50.2%,5m
303,3,[NDW]Drima,4918,354,17,15,32,53.1%,5m
305,2,llllllllllll,4917,278,12,18,30,40.0%,5m
306,3,IIIlllIIlIIl,4916,2479,333,323,656,50.8%,5m
306,3,lIIlllIlllII,4916,1670,107,96,203,52.7%,9m
306,3,[PsTe]Pilot,4916,0,0,1,1,0.0%,6m
309,3,[닉변하고싶어]문센핥핥,4915,56,9,4,13,69.2%,4m
310,3,[인두더]IntoTheFarmY,4914,0,0,1,1,0.0%,5m
311,3,DDing,4911,38,4,1,5,80.0%,4m
312,2,[인투더]IntoTheiNu,4910,2435,136,139,275,49.5%,2m
312,3,mello,4910,742,72,39,111,64.9%,14m
314,3,[고시원]까꿍,4907,0,0,1,1,0.0%,9m
315,3,厦门孙一峰,4906,2291,186,160,346,53.8%,5m
315,3,[Rush]黑羽快斗,4906,18,4,4,8,50.0%,6m
317,3,llllllllllll,4904,0,0,1,1,0.0%,3m
318,3,llllllllllll,4897,12,2,4,6,33.3%,5m
318,3,남훈이,4897,4,1,1,2,50.0%,6m
320,2,FlaSh,4896,2373,246,215,461,53.4%,2m
321,3,DRAKEDOG,4895,1260,83,60,143,58.0%,6m
322,3,LastHerO,4894,390,28,32,60,46.7%,14m
323,3,[WiT]RunaMoK,4893,1447,80,78,158,50.6%,6m
323,3,llllllllllll,4893,6,2,5,7,28.6%,6m
325,3,[ELS]EunkOng,4891,0,1,0,1,100.0%,5m
325,3,[越南最後希望]欸福特奈提,4891,2,1,1,2,50.0%,6m
325,3,[이터널]입다더요스키,4891,2,1,1,2,50.0%,3m
328,3,[NGameS]초마도사이주찬,4887,4,1,1,2,50.0%,5m
329,3,lIlllIllIlIl,4885,68,9,8,17,52.9%,5m
330,3,[네오]빠워,4879,317,28,22,50,56.0%,6m
331,3,[영앤리치]오마이걸,4878,0,1,0,1,100.0%,3m
332,3,[무한이터널]Doping,4877,186,12,5,17,70.6%,4m
333,3,[NGameS]심심이,4876,287,17,6,23,73.9%,5m
334,3,llllllllllll,4875,22,5,6,11,45.5%,5m
334,3,[Lotuz]Rain,4875,0,1,0,1,100.0%,9m
334,3,Lia,4875,0,0,1,1,0.0%,5m
337,3,Greatbold,4872,43,12,11,23,52.2%,9m
338,3,[EpicTm]llllllllllll,4870,174,23,19,42,54.8%,5m
338,3,Marine,4870,0,0,1,1,0.0%,3m
340,2,[무한오영종]IIIIIIIIIIII,4868,2016,100,103,203,49.3%,2m
340,2,Kevin,4868,1631,94,90,184,51.1%,5m
340,3,Daz,4868,0,1,0,1,100.0%,9m
343,3,lllllllIlIlI,4866,0,1,0,1,100.0%,4m
344,3,[리락쿠마]文在寅拥有国,4864,0,1,1,2,50.0%,4m
345,2,Queen,4863,582,32,33,65,49.2%,5m
345,3,Jun,4863,443,30,26,56,53.6%,4m
345,1,llllllllll,4863,453,9,10,19,47.4%,6m
348,3,JaheeFan,4862,1258,84,39,123,68.3%,4m
349,3,잔혹한라이언,4861,0,0,1,1,0.0%,5m
350,3,llllllllllll,4859,14,2,0,2,100.0%,9m
351,3,[遊戲暫停]蝦機八亂玩,4858,552,47,40,87,54.0%,5m
352,3,[ANGG]UNOBomber,4856,1003,100,94,194,51.5%,9m
353,3,Dreamer,4855,95,2,5,7,28.6%,9m
354,3,너무어려워,4852,512,32,4,36,88.9%,9m
355,2,[XYFANS]IIIIIIIIIIII,4851,1231,66,65,131,50.4%,5m
356,3,[NisCII]UnicMvp,4850,0,0,1,1,0.0%,5m
357,3,[SWlFT]SECOND,4848,8,3,1,4,75.0%,5m
358,3,[firefy]IIIIIIIIIIII,4847,0,0,2,2,0.0%,6m
359,3,IIIIIIIIIIII,4846,0,0,1,1,0.0%,9m
360,3,멸공,4841,24,2,2,4,50.0%,14m
361,3,觀察者,4839,0,0,1,1,0.0%,4m
362,3,[鱷鱷鱷鱷鱷鱷]CieLo,4838,0,1,0,1,100.0%,5m
363,3,llllllllllll,4837,68,11,8,19,57.9%,5m
364,3,[WAZAI]자능이,4835,4,3,4,7,42.9%,5m
365,3,llllllll,4834,0,1,0,1,100.0%,3m
366,3,정석유저,4833,115,5,2,7,71.4%,14m
366,3,Rainbow,4833,8,1,5,6,16.7%,6m
368,3,운명,4832,180,30,26,56,53.6%,3m
368,3,[갓지민]프사기개노답,4832,0,0,1,1,0.0%,9m
370,3,Tachikoma,4830,68,9,12,21,42.9%,9m
371,3,아싸겜,4829,245,42,11,53,79.2%,5m
371,3,[위그드라실]에밀리아,4829,0,0,1,1,0.0%,5m
373,3,JEROS,4828,451,22,8,30,73.3%,5m
373,3,[아르아르]아르키스,4828,256,17,8,25,68.0%,5m
375,3,用点力,4827,164,25,25,50,50.0%,3m
375,3,[GGPlay]SoSorry,4827,0,0,2,2,0.0%,3m
377,3,[Rush3]IIIllllIIlll,4826,0,1,1,2,50.0%,14m
378,3,[최애의아이]AquaMarine,4825,10,2,0,2,100.0%,14m
379,3,lIIIlIlIllII,4822,0,1,4,5,20.0%,5m
379,3,llllllllllll,4822,0,0,1,1,0.0%,6m
381,3,llllllIllllI,4818,2,1,1,2,50.0%,5m
382,3,[뿌야]쌈무요정,4815,0,1,0,1,100.0%,14m
383,3,llllllllllll,4814,64,13,9,22,59.1%,14m
384,3,KoKo,4812,204,21,21,42,50.0%,6m
385,3,[Lotuz]엠빼롱,4809,223,9,1,10,90.0%,6m
385,3,lunatic,4809,0,0,1,1,0.0%,5m
387,3,LateInAutumn,4808,713,40,14,54,74.1%,14m
387,3,IIIIIIIIII,4808,281,40,44,84,47.6%,3m
389,3,[무한오영종]정종현,4807,774,37,17,54,68.5%,4m
389,3,[SofT]LOGO,4807,34,9,8,17,52.9%,3m
391,3,[TeamNV]NightMare,4806,18,4,7,11,36.4%,3m
392,3,CnTMaKinTire,4803,0,1,0,1,100.0%,3m
392,3,보노보노,4803,0,0,1,1,0.0%,3m
394,3,勿敲打可餵食,4801,0,0,3,3,0.0%,14m
395,3,master,4800,378,16,3,19,84.2%,5m
395,3,[SC2HK]Random,4800,0,1,0,1,100.0%,5m
395,3,[SofT]트와이스사나,4800,0,1,0,1,100.0%,14m
398,3,Contemplate,4798,32,3,8,11,27.3%,6m
399,3,[이터널]도딜,4796,0,0,1,1,0.0%,9m
400,3,Daz,4790,290,43,35,78,55.1%,6m
400,3,[네오]HOON,4790,0,1,0,1,100.0%,5m
402,3,NoSweat,4787,129,26,27,53,49.1%,3m
403,3,손목없는테란,4785,695,29,26,55,52.7%,5m
404,3,IIIIIIIIIIII,4784,486,42,36,78,53.8%,9m
404,3,DisReSpeCT,4784,100,2,1,3,66.7%,4m
404,3,llllllllllll,4784,0,1,0,1,100.0%,5m
407,3,쓰레기게임,4783,0,1,0,1,100.0%,3m
407,3,[참치배선원]루돌프,4783,0,0,1,1,0.0%,14m
409,2,[Master]OOOOOOO,4782,0,1,0,1,100.0%,15m
409,3,스투망해라,4782,97,1,1,2,50.0%,5m
411,3,llllllllllll,4781,4,3,2,5,60.0%,4m
412,3,[SofT]트와이스나연,4780,0,0,1,1,0.0%,14m
413,3,[XYFANS]USUCK,4775,20,10,7,17,58.8%,4m
414,3,llllllllllll,4774,1157,155,156,311,49.8%,4m
414,3,골드가고싶다,4774,838,42,51,93,45.2%,4m
414,3,[快樂玩家]FlaSh,4774,311,13,0,13,100.0%,4m
414,3,llllllllllll,4774,20,6,5,11,54.5%,6m
414,3,[테란사기]llllllllllll,4774,97,1,1,2,50.0%,9m
419,3,[CIM]와기,4772,554,67,51,118,56.8%,14m
419,3,llllllllllll,4772,0,0,3,3,0.0%,3m
421,3,lIlIIlIIIIll,4771,1088,49,40,89,55.1%,5m
421,3,我栖息的夏天,4771,118,17,21,38,44.7%,14m
421,3,[시럽]Trinity,4771,0,0,1,1,0.0%,6m
424,3,[PeacEe]IIIIIIIIIIII,4770,1206,66,67,133,49.6%,9m
424,3,llllllll,4770,808,43,44,87,49.4%,5m
426,3,llllllllllll,4769,763,41,1,42,97.6%,5m
426,3,[Old]computer,4769,20,4,5,9,44.4%,3m
428,3,[NGamE2]DOBBY,4767,363,14,6,20,70.0%,6m
428,3,[ELS]영블리프트,4767,18,5,9,14,35.7%,14m
430,3,[On엔oN]머란,4766,1825,152,165,317,47.9%,6m
430,3,둠피스트,4766,201,8,5,13,61.5%,5m
432,3,[ANGG]애플은사과,4765,1285,109,95,204,53.4%,9m
432,3,[NTUeS]Year,4765,0,1,0,1,100.0%,6m
434,3,[SofT]트와이스미나,4764,668,64,52,116,55.2%,14m
434,3,[偶像型男隊]TerranRoy,4764,511,40,33,73,54.8%,14m
434,3,UchihaSasuke,4764,0,0,3,3,0.0%,14m
437,3,IIIIIIIIIIII,4763,623,41,35,76,53.9%,4m
437,3,[정말데단해]딸기냠냠,4763,111,2,2,4,50.0%,3m
437,3,[NGameS]PolaRis,4763,0,0,1,1,0.0%,9m
440,3,[분노조절장애]화나면뒤없는사람,4760,384,14,5,19,73.7%,9m
441,3,Maplestory,4759,228,7,6,13,53.8%,4m
441,3,[s2Mc]글로벌스탠다드,4759,150,6,5,11,54.5%,3m
443,1,[원피스]이준상조오옷,4758,1798,125,126,251,49.8%,15m
443,3,lhy,4758,0,0,2,2,0.0%,6m
445,1,[0I터널]배유빈,4757,0,0,1,1,0.0%,2m
446,3,llIlllIlIlI,4756,8,3,5,8,37.5%,9m
447,3,Kagurra,4753,123,8,6,14,57.1%,5m
448,3,llllllllllll,4752,0,0,2,2,0.0%,4m
449,3,NuLo,4750,636,40,43,83,48.2%,5m
449,1,[Lof]CraZyDraFt,4750,0,0,1,1,0.0%,2m
451,3,UruhaRushia,4749,0,1,2,3,33.3%,5m
452,3,Bark,4748,614,98,91,189,51.9%,9m
453,3,[RuL]신트리,4747,2048,139,133,272,51.1%,3m
454,3,[DPW]llllllllllll,4745,2078,129,127,256,50.4%,14m
454,1,CapPucCinO,4745,48,2,1,3,66.7%,7m
456,3,JOSH,4743,0,0,5,5,0.0%,6m
457,1,[遊戲暫停]被海小英雄,4742,0,1,0,1,100.0%,3m
458,3,llllllllllll,4741,6,3,5,8,37.5%,3m
459,3,[무한오영종]망촐,4740,2047,412,409,821,50.2%,3m
460,3,[디플]GANGTAE,4739,1219,87,75,162,53.7%,6m
461,3,[Dopen]최성훈제자,4735,827,179,156,335,53.4%,14m
462,3,[SofT]universe,4731,1012,73,61,134,54.5%,4m
462,3,[무한오영종]그냥이요,4731,119,7,8,15,46.7%,5m
462,1,IlIlIlIlIlIl,4731,0,1,0,1,100.0%,7m
465,3,[GIS]SsTom,4728,121,2,3,5,40.0%,5m
466,3,llllllllllll,4725,44,12,20,32,37.5%,5m
467,3,scottweiland,4724,123,9,12,21,42.9%,3m
468,2,[NDW]Rimuru,4722,191,10,3,13,76.9%,15m
469,1,[얼라이브]Aphrodite,4721,0,0,2,2,0.0%,7m
470,3,[FIN]Divinesia,4720,192,17,24,41,41.5%,3m
471,1,SommY,4719,48,1,2,3,33.3%,15m
471,2,[인투더]MyuNgSiK,4719,36,1,3,4,25.0%,9m
473,1,루닝,4713,546,13,9,22,59.1%,3m
473,1,[ELS]GGoRong,4713,0,0,1,1,0.0%,3m
475,1,ganahal,4711,48,2,0,2,100.0%,2m
475,1,Osiris,4711,0,1,0,1,100.0%,2m
477,3,[EMTRMT]평양냉면에백두산,4710,733,143,129,272,52.6%,6m
478,3,llllllllllll,4707,390,45,22,67,67.2%,3m
479,1,랑년,4706,332,7,9,16,43.8%,7m
480,1,[통수왕이한희]kapterhan,4705,216,8,3,11,72.7%,7m
481,3,IIlIIlIIl,4702,792,143,140,283,50.5%,9m
482,2,IlIlIIlllI,4701,232,15,32,47,31.9%,5m
483,1,IIIIIIIIIIII,4697,1515,41,30,71,57.7%,8m
483,3,[Lotuz]UprisinG,4697,250,27,31,58,46.6%,14m
483,1,[아직이름없음]DictAtor,4697,240,5,7,12,41.7%,5m
483,1,Eins,4697,96,2,3,5,40.0%,2m
487,3,[ANGG]FlaSh,4695,938,69,78,147,46.9%,3m
487,3,Rex,4695,849,68,64,132,51.5%,14m
489,3,[무한오영종]NeedKing,4691,601,50,39,89,56.2%,3m
490,3,[이터널]넘버원,4690,2033,538,549,1087,49.5%,9m
491,3,ChristmasTna,4687,211,10,9,19,52.6%,5m
491,3,llllllllllll,4687,0,1,5,6,16.7%,3m
493,3,강민경,4683,945,76,68,144,52.8%,14m
493,1,칠삼이,4683,0,0,3,3,0.0%,7m
495,1,lIlIlIIllIIl,4681,1254,30,17,47,63.8%,2m
495,1,asdfasdf,4681,504,12,5,17,70.6%,2m
497,1,[NGameS]열아홉살모솔아다,4680,170,4,7,11,36.4%,7m
498,3,narsha,4679,169,11,14,25,44.0%,5m
499,1,IIIIIIIIIIII,4677,776,17,16,33,51.5%,7m
499,3,llllllllllll,4677,133,13,11,24,54.2%,9m
501,1,nicholashk,4676,424,11,12,23,47.8%,7m
502,3,[WDY]Rikka,4672,1590,231,231,462,50.0%,9m
503,3,[KRisEZ]NORTHAMERICA,4670,668,60,49,109,55.0%,4m
504,1,[教我合作]FatimaKUROI,4668,0,0,1,1,0.0%,5m
505,1,llllllllllll,4667,2180,78,70,148,52.7%,7m
505,3,llllllllllll,4667,479,73,71,144,50.7%,3m
505,1,llllllllllll,4667,48,1,2,3,33.3%,3m
508,3,lllllllllll,4666,962,174,170,344,50.6%,5m
508,1,[ANGG]빌리의북침공,4666,640,21,16,37,56.8%,5m
510,1,學無止境,4665,2215,247,223,470,52.6%,7m
511,1,llllIlIIlI,4664,1428,40,17,57,70.2%,7m
512,1,IIIIIIIIIIII,4663,408,15,10,25,60.0%,15m
513,1,最弱,4662,0,1,1,2,50.0%,2m
514,3,llllllllllll,4660,1730,274,240,514,53.3%,5m
514,1,[SC2HK]Ckong,4660,0,0,2,2,0.0%,7m
516,3,[StorM]新手,4659,40,6,19,25,24.0%,6m
516,1,Won,4659,0,0,1,1,0.0%,7m
518,1,왔쌉맨,4655,0,3,2,5,60.0%,7m
518,1,테란이진리,4655,0,0,1,1,0.0%,8m
518,1,llllllllllll,4655,0,0,1,1,0.0%,7m
521,3,[무한오영종]TYTY,4654,1917,237,217,454,52.2%,3m
522,3,IIIIIIIIIIII,4653,280,27,34,61,44.3%,9m
522,1,IIIIIIIIII,4653,413,14,3,17,82.4%,7m
522,1,[GIS]IMnsetcoffee,4653,0,0,2,2,0.0%,6m
525,1,llllllllllll,4647,192,4,5,9,44.4%,7m
526,1,[네오]unlimited,4645,0,0,1,1,0.0%,8m
527,1,[Dopen]DeepQLearing,4644,48,1,4,5,20.0%,8m
528,1,이승주,4642,880,22,10,32,68.8%,7m
529,1,솔로는축복,4641,1194,27,31,58,46.6%,8m
529,3,IIIIIIIIIIII,4641,38,7,14,21,33.3%,5m
531,1,IIIIIIIIIIII,4640,2180,190,190,380,50.0%,2m
532,1,[Lotuz]ShieldOfAuir,4639,2230,118,114,232,50.9%,15m
532,1,[NGameS]레이너,4639,1652,50,41,91,54.9%,2m
534,3,Guuuuuuuu,4636,28,10,20,30,33.3%,15m
535,1,sroom,4635,0,1,3,4,25.0%,8m
536,2,getaway,4632,395,19,0,19,100.0%,4m
537,1,[퇴물입니다]깜돌이,4630,468,11,5,16,68.8%,7m
537,1,llllllllllll,4630,0,1,3,4,25.0%,6m
539,1,[김준식]lllllllll,4625,192,4,5,9,44.4%,7m
540,1,BoGus,4624,238,6,2,8,75.0%,3m
541,1,llllllllllll,4623,1530,40,33,73,54.8%,5m
542,1,[XYFANS]deadgame,4621,1114,39,32,71,54.9%,15m
543,1,llllllllllll,4620,1140,28,14,42,66.7%,7m
544,3,[DVS]鳳凰水晶,4619,1994,364,398,762,47.8%,6m
545,3,시유쨩,4617,845,211,192,403,52.4%,6m
545,1,IIIIIIIIIIII,4617,521,15,11,26,57.7%,5m
545,1,IIllIlIIIIll,4617,218,8,9,17,47.1%,15m
545,1,LifeForAiur,4617,94,2,1,3,66.7%,2m
549,1,오빠차화염차,4614,190,5,4,9,55.6%,8m
549,1,Phobia,4614,46,2,1,3,66.7%,8m
551,1,OMA,4611,0,0,1,1,0.0%,7m
552,3,llIIlIIllIII,4609,1890,737,728,1465,50.3%,5m
552,1,[s2Mc]SUITBOX,4609,0,0,1,1,0.0%,2m
554,1,Head,4607,238,6,7,13,46.2%,15m
555,3,[맵핵존내많네]llllIIIIllll,4605,1978,765,718,1483,51.6%,9m
556,1,llllllllllll,4604,805,41,11,52,78.8%,8m
556,1,[Ato]스타투아주어려움,4604,48,2,1,3,66.7%,8m
556,1,[씹망겜]노을진언덕,4604,0,0,1,1,0.0%,8m
559,1,[스카이파이터]FireBat,4602,1302,32,29,61,52.5%,5m
559,1,리플,4602,0,0,1,1,0.0%,8m
561,1,MarineKing,4600,0,0,1,1,0.0%,2m
562,1,SlayersDuker,4599,1219,33,34,67,49.3%,2m
562,1,[NGameS]생귤,4599,0,0,2,2,0.0%,3m
564,3,[SofT]트와이스모모,4597,872,61,70,131,46.6%,5m
565,3,스투는프사기,4595,1959,303,307,610,49.7%,3m
566,1,llllllllllll,4594,1349,112,8,120,93.3%,2m
566,1,llllllllllll,4594,48,1,3,4,25.0%,7m
568,1,문제인걸안철수,4593,1869,277,268,545,50.8%,2m
568,1,Fekia,4593,330,7,11,18,38.9%,15m
568,1,가을방학,4593,188,4,9,13,30.8%,7m
568,1,[XYFANS]孤独久了真会累,4593,48,1,1,2,50.0%,8m
568,1,[Primer]Plan,4593,0,0,1,1,0.0%,2m
573,1,[무한엄준식]llllllllllll,4591,192,4,2,6,66.7%,3m
574,1,정확신속고급대리,4589,0,0,1,1,0.0%,3m
575,1,SKTelecom,4588,747,29,7,36,80.6%,7m
576,3,[Hyper]씹덕도살자,4586,1941,198,167,365,54.2%,6m
576,3,llllllllllll,4586,1956,173,165,338,51.2%,3m
576,1,lIIIllIlIl,4586,1274,30,40,70,42.9%,3m
579,1,[NEX]Raynor,4585,962,40,12,52,76.9%,3m
580,1,Gonzo,4583,0,0,1,1,0.0%,2m
581,1,llllllllllll,4582,380,8,8,16,50.0%,7m
582,1,반인반숭이,4581,186,5,5,10,50.0%,8m
582,1,[RPT]Meteor,4581,140,3,6,9,33.3%,8m
582,1,[무한오영종]카구야님은고백받,4581,0,0,1,1,0.0%,7m
585,1,IIIIIIIIIIII,4580,0,1,0,1,100.0%,7m
585,1,llllllllllll,4580,0,0,1,1,0.0%,7m
587,1,Meister,4578,854,19,16,35,54.3%,8m
587,1,llllllllllll,4578,514,12,5,17,70.6%,3m
587,3,llIIllIlIIlI,4578,46,8,22,30,26.7%,9m
590,1,[무한오영종]lIlIlIllIIll,4577,2026,66,63,129,51.2%,2m
591,1,llllllllllll,4576,316,8,4,12,66.7%,2m
591,1,이과황,4576,185,6,8,14,42.9%,2m
591,1,[Rovic]약속,4576,0,0,1,1,0.0%,2m
594,1,[Lancer]Curse,4573,144,4,1,5,80.0%,2m
594,1,SlayLi,4573,48,1,1,2,50.0%,7m
594,1,[真理界心]IIIIIIIIIIII,4573,0,0,1,1,0.0%,7m
597,1,Lorik,4572,786,18,19,37,48.6%,2m
597,1,IIIIIIIIIIII,4572,306,8,0,8,100.0%,3m
597,1,Classic,4572,96,3,2,5,60.0%,3m
600,1,Ive,4571,2158,122,121,243,50.2%,8m
601,1,Bill,4569,2166,356,367,723,49.2%,15m
601,3,古老,4569,1670,216,224,440,49.1%,3m
603,1,댄스왕,4567,1690,50,54,104,48.1%,5m
603,1,Morrison,4567,44,1,1,2,50.0%,15m
603,1,[TeamGP]Gemini,4567,48,1,1,2,50.0%,3m
606,1,Happynaru,4566,48,1,1,2,50.0%,2m
607,1,horang,4565,2155,479,481,960,49.9%,2m
607,3,llllllllllll,4565,1642,228,202,430,53.0%,5m
609,3,AMD,4564,677,156,162,318,49.1%,9m
610,1,IIIIIIII,4563,1363,71,77,148,48.0%,7m
610,1,llIllIlIllll,4563,378,8,12,20,40.0%,2m
612,1,[快樂玩家]哭哭掠奪者,4562,774,26,7,33,78.8%,3m
613,1,IIIIIIIIIIII,4559,518,11,17,28,39.3%,7m
614,1,[ReV]Con,4556,2171,274,290,564,48.6%,15m
614,1,[무한오영종]맹빈이,4556,418,9,8,17,52.9%,3m
616,3,IlIlIlIlIlIl,4555,171,53,63,116,45.7%,3m
616,1,Illlllllllll,4555,416,10,7,17,58.8%,5m
616,1,요츠바랑,4555,0,0,1,1,0.0%,7m
619,1,[원피스]Sanyol,4553,2117,179,159,338,53.0%,8m
619,1,llllllllllll,4553,1470,35,36,71,49.3%,7m
621,1,[StorM]Tng,4552,358,10,9,19,52.6%,2m
622,1,[WAZAI]Lawlet,4551,1916,110,109,219,50.2%,2m
622,1,Wrigglinium,4551,1582,44,50,94,46.8%,5m
622,1,CcrabN,4551,0,0,2,2,0.0%,7m
625,1,NINJAGOKai,4550,1856,148,123,271,54.6%,7m
625,1,[쇄국정책]Sylvanas,4550,2138,92,74,166,55.4%,8m
627,1,IIIIIIIIllll,4548,2120,102,102,204,50.0%,15m
628,1,llllllllllll,4547,236,5,4,9,55.6%,7m
628,1,llllllllllll,4547,46,1,1,2,50.0%,7m
628,1,[메가트윈스]테란슛,4547,0,0,1,1,0.0%,3m
631,1,llllllllllll,4546,48,1,2,3,33.3%,8m
632,1,[시럽]알엠,4545,2162,97,93,190,51.1%,2m
632,3,llllllllllll,4545,1115,73,60,133,54.9%,15m
634,1,IlIIlllI,4543,2134,144,138,282,51.1%,7m
634,1,[쇄국정책]불곰,4543,0,1,0,1,100.0%,8m
636,2,[越南探親希望]超爆爛怪人蟹肉,4541,0,0,5,5,0.0%,4m
637,1,llIIlllIlllI,4540,2110,133,125,258,51.6%,7m
638,3,IIIIIIIIIIII,4538,1804,263,220,483,54.5%,4m
638,1,llllllllllll,4538,272,11,10,21,52.4%,15m
640,1,자유의심장,4536,2129,523,530,1053,49.7%,7m
640,1,[무한오영종]KingDomGlorY,4536,2150,120,119,239,50.2%,5m
642,1,[어윤수님개쩜]IIIIIIIIIIII,4533,2117,166,155,321,51.7%,2m
643,3,[3705]Reality,4532,284,30,38,68,44.1%,15m
643,1,llllllllllll,4532,672,16,11,27,59.3%,2m
643,1,IIIIIIIIIIII,4532,410,9,13,22,40.9%,7m
643,2,MoonJiAe,4532,32,2,3,5,40.0%,7m
647,3,[PLKeeN]darkupgrader,4531,1175,353,415,768,46.0%,9m
647,1,[TeamNV]프로토스,4531,504,11,11,22,50.0%,7m
647,1,외롭다,4531,138,4,1,5,80.0%,7m
647,1,Anais,4531,144,3,8,11,27.3%,7m
651,1,涼宮春姫団長閣下,4530,144,3,6,9,33.3%,8m
652,3,SoloYTmomo,4529,151,83,98,181,45.9%,5m
652,1,IIIIIIIIIIII,4529,1254,64,53,117,54.7%,7m
652,1,[SofT]Battle,4529,514,11,9,20,55.0%,7m
655,1,llllllllllll,4528,2152,122,121,243,50.2%,15m
655,1,llllllllllll,4528,1437,52,39,91,57.1%,8m
655,1,[ENT]Daubechies,4528,740,17,17,34,50.0%,2m
658,1,Vega,4527,145,4,4,8,50.0%,8m
659,1,Horiken,4526,0,1,3,4,25.0%,2m
660,1,[최장기퇴물]COCOA,4522,1954,105,102,207,50.7%,2m
660,1,[5000go]minsu,4522,0,1,4,5,20.0%,7m
662,1,[SeA]helloworld,4521,1427,44,37,81,54.3%,7m
662,1,[NukeKR]Speakthen,4521,426,9,12,21,42.9%,8m
664,1,공유기,4520,1429,94,85,179,52.5%,15m
664,1,TwistedXD,4520,121,2,8,10,20.0%,3m
666,1,[호주hoju]Presence,4518,0,1,0,1,100.0%,2m
667,1,[4계절]쌀쌀한가을,4517,720,17,14,31,54.8%,2m
667,1,lIllIIIlllll,4517,296,7,4,11,63.6%,2m
667,1,llllllllllll,4517,236,6,0,6,100.0%,3m
670,1,IIIIIIIIIIII,4516,1482,37,38,75,49.3%,2m
671,1,[Equal]MPMP,4515,1332,33,29,62,53.2%,7m
671,1,Fausta,4515,555,16,11,27,59.3%,2m
673,1,llllllllllll,4514,1578,45,38,83,54.2%,7m
674,1,llllllllllll,4511,140,4,5,9,44.4%,3m
675,1,테란슛,4510,0,0,2,2,0.0%,3m
676,1,베이비,4508,1429,61,55,116,52.6%,7m
676,1,llllllllllll,4508,1530,39,38,77,50.6%,8m
676,1,해병왕프라임,4508,0,1,0,1,100.0%,3m
679,1,XKID,4507,46,1,1,2,50.0%,7m
680,1,[3연벙]콩콩콩콩까지마,4505,2006,357,373,730,48.9%,7m
680,1,[李至安]이지안,4505,959,77,54,131,58.8%,5m
680,3,llllllllllll,4505,30,2,1,3,66.7%,7m
683,1,[忠明國中]MarineFalSh,4504,190,5,2,7,71.4%,3m
684,1,[네오]Lacazette,4503,727,32,26,58,55.2%,7m
685,1,[인투더]IntoTheBest,4502,48,1,5,6,16.7%,8m
686,1,[DVS]加賴叫過去,4501,1994,127,145,272,46.7%,2m
687,1,[ELSII]武汉肺炎,4500,558,13,13,26,50.0%,2m
688,3,MARS,4498,652,47,61,108,43.5%,4m
688,1,JuNa,4498,0,0,2,2,0.0%,7m
690,1,[아라]llllllllllll,4497,96,3,1,4,75.0%,8m
691,1,llllllllllll,4496,198,5,10,15,33.3%,7m
692,1,今晚打老虎,4495,0,0,2,2,0.0%,7m
693,1,[얼라이브]DoSiRi,4494,1061,32,25,57,56.1%,15m
693,1,[oNs7]버로닷,4494,88,4,2,6,66.7%,3m
695,1,llllllllllll,4491,278,6,21,27,22.2%,2m
695,1,Teneb,4491,0,1,2,3,33.3%,2m
697,1,cho,4490,310,13,3,16,81.2%,7m
698,1,llllllllllll,4489,1232,43,51,94,45.7%,8m
699,1,IlIlIlIlIlIl,4488,526,25,3,28,89.3%,7m
699,1,[어윤수준우승]누가연속준우승함,4488,0,0,1,1,0.0%,7m
701,1,ArkonoM,4487,94,3,4,7,42.9%,2m
701,1,[인투더]IntoTheCHEST,4487,48,1,1,2,50.0%,3m
703,1,[快樂玩家]嗆辣綠茶,4486,1153,54,44,98,55.1%,7m
703,1,탈모지훈,4486,956,23,25,48,47.9%,7m
703,1,[EPEP]떡동,4486,552,13,12,25,52.0%,8m
703,1,[핵노답삼형제]SapphireStar,4486,142,3,3,6,50.0%,7m
707,2,IIIIIIIIIIII,4485,229,9,1,10,90.0%,6m
708,1,[ELS]킬러봉구,4484,958,25,21,46,54.3%,8m
709,1,[HGIM]테프형,4483,420,9,11,20,45.0%,7m
710,1,oooooooooooo,4481,46,1,2,3,33.3%,3m
711,1,Zinger,4480,2065,154,148,302,51.0%,2m
712,1,[Allie]매우공격적인사람,4479,644,14,26,40,35.0%,2m
712,1,Narr,4479,0,1,0,1,100.0%,7m
714,1,Limba,4477,862,21,15,36,58.3%,8m
715,1,llllllllllll,4476,1826,52,55,107,48.6%,7m
715,1,[아직이름없음]llllIlIIlIIl,4476,1168,29,31,60,48.3%,8m
715,1,조유리즈,4476,755,23,13,36,63.9%,7m
715,1,[이터널]Pomme,4476,142,4,1,5,80.0%,2m
715,1,llllllllllll,4476,46,2,1,3,66.7%,7m
720,1,IIIIIIIIIIII,4475,142,3,8,11,27.3%,7m
720,1,Faz,4475,0,0,2,2,0.0%,3m
722,1,[Neko]GoldenSad,4471,48,1,1,2,50.0%,5m
723,1,IIlllIIlll,4470,1213,71,42,113,62.8%,8m
723,1,YanXII,4470,232,6,1,7,85.7%,7m
725,3,태영데시앙,4468,1592,291,293,584,49.8%,3m
726,1,kyum,4467,412,9,7,16,56.2%,8m
726,1,Roke,4467,0,1,0,1,100.0%,2m
726,2,[攘外必先安内]三民主義統一中國,4467,0,1,0,1,100.0%,15m
729,1,[카논]카논사랑해,4464,1757,56,65,121,46.3%,7m
730,3,[나혼자산다]CafeMocha,4463,1857,428,437,865,49.5%,6m
730,1,CopyDog,4463,2022,152,157,309,49.2%,8m
732,1,Saying,4462,1556,49,64,113,43.4%,15m
732,1,llIIlIIllIlI,4462,999,27,19,46,58.7%,7m
734,1,[bx毛赛高]Paradox,4461,190,5,8,13,38.5%,2m
734,1,[패자는피를]iloveoov,4461,0,0,1,1,0.0%,15m
736,1,WeirdOne,4460,0,1,0,1,100.0%,15m
736,1,MythMigro,4460,0,0,2,2,0.0%,2m
738,1,[封弊者]三世,4459,155,5,9,14,35.7%,7m
739,1,lIlIllIIlIlI,4458,1973,128,73,201,63.7%,8m
740,1,봄비,4457,0,1,0,1,100.0%,3m
740,1,불곰성님,4457,0,0,1,1,0.0%,8m
742,1,[NGameS]보급고좀짓자,4456,856,21,19,40,52.5%,7m
743,1,PaulFirelord,4454,1415,67,58,125,53.6%,7m
743,1,환상동화,4454,268,6,4,10,60.0%,8m
745,1,[시럽]NewB,4451,961,76,66,142,53.5%,2m
746,1,llllllllllll,4450,97,1,5,6,16.7%,3m
747,1,[NEX]YoHan,4449,117,5,1,6,83.3%,2m
747,1,[팝콘TV]Butnny,4449,0,0,1,1,0.0%,5m
749,1,[Suisei]Hoshimachi,4448,2092,181,185,366,49.5%,7m
749,1,bufmpg,4448,142,4,0,4,100.0%,7m
749,1,[越南探親希望]夯特叉叉,4448,0,1,1,2,50.0%,3m
752,1,Ramdom,4447,370,9,7,16,56.2%,5m
752,1,[모두하나인숲]젤라가,4447,0,1,0,1,100.0%,7m
754,3,IIIIIIIIIIII,4446,1686,103,132,235,43.8%,15m
754,1,IIIIIIIIIIII,4446,140,3,2,5,60.0%,7m
756,1,tokka,4444,2094,771,763,1534,50.3%,3m
756,1,IlIlIIlIIlIl,4444,1882,52,53,105,49.5%,15m
756,1,IIIIIIIIIIII,4444,515,37,25,62,59.7%,3m
759,1,Inlin,4443,1968,395,393,788,50.1%,3m
760,3,[무한오영종]금은똥,4440,1617,257,270,527,48.8%,9m
761,1,[CIM]hoon,4439,1384,77,91,168,45.8%,8m
761,1,마이웨이,4439,360,13,1,14,92.9%,8m
761,1,vLDiOps,4439,370,9,4,13,69.2%,8m
764,1,jackal,4438,801,37,32,69,53.6%,7m
765,1,[인투더]IntoTheSHSH,4437,1800,51,58,109,46.8%,5m
765,1,DeepLearning,4437,625,17,13,30,56.7%,7m
767,1,Ruui,4436,2083,339,367,706,48.0%,8m
767,1,[TEOTU]Marlene,4436,0,1,0,1,100.0%,2m
769,1,[이터널]송병구,4435,1605,64,37,101,63.4%,8m
769,1,검은마법사,4435,190,7,6,13,53.8%,7m
769,1,spleveryday,4435,262,7,10,17,41.2%,8m
772,1,[DVS]嘟嘟胸前兩顆包子,4434,996,24,36,60,40.0%,2m
772,1,[sheep8]쿤인아저씨,4434,108,4,3,7,57.1%,8m
774,1,[Blacer]Hate,4433,914,23,24,47,48.9%,2m
774,1,CCC,4433,464,10,15,25,40.0%,7m
774,1,llllllllllll,4433,192,5,12,17,29.4%,7m
777,1,llIIllIIlIlI,4431,46,2,4,6,33.3%,8m
778,1,[混元星际]星际指导员,4429,937,22,18,40,55.0%,8m
779,1,llllllllllll,4428,48,2,0,2,100.0%,7m
779,1,[ELS]lllllllllll,4428,0,0,1,1,0.0%,8m
781,1,[이터널]NaDa,4426,0,1,2,3,33.3%,3m
782,1,IIIIIIIIII,4425,2085,111,120,231,48.1%,3m
782,1,[SR]FateSR,4425,0,0,1,1,0.0%,2m
784,1,[ANGG]킹킹킹킹킹,4424,320,8,8,16,50.0%,7m
785,3,[개못하는]초보토스,4423,1529,146,166,312,46.8%,15m
785,1,erudite,4423,1958,55,59,114,48.2%,2m
787,1,KrSkyLake,4422,0,1,0,1,100.0%,3m
788,1,[BlAck1]Negger,4421,104,1,4,5,20.0%,8m
788,1,Percival,4421,0,1,14,15,6.7%,8m
790,1,벨해브,4420,90,3,5,8,37.5%,8m
790,1,學園都市鈔能力者,4420,0,1,0,1,100.0%,8m
792,1,[ELS]고기파전에막걸리,4419,186,5,4,9,55.6%,8m
793,1,教我玩星海,4418,48,2,2,4,50.0%,8m
794,1,llllllllllll,4416,44,1,2,3,33.3%,2m
795,1,涼宮春日団長閣下,4415,1954,138,152,290,47.6%,8m
795,1,[Mini]WISER,4415,1440,40,31,71,56.3%,8m
795,1,Rodo,4415,769,25,21,46,54.3%,15m
795,1,[ANGG]매실,4415,495,15,8,23,65.2%,7m
799,1,IIIIlIIlIIIl,4414,1939,140,154,294,47.6%,2m
799,1,[Dopen]Liberty,4414,134,3,1,4,75.0%,8m
801,1,[무한오영종]Praesentia,4413,2040,345,355,700,49.3%,3m
801,1,llllllllllll,4413,602,19,18,37,51.4%,2m
801,1,Nongsil,4413,0,0,2,2,0.0%,2m
804,1,llllllllllll,4412,46,1,1,2,50.0%,8m
805,1,IllllIlIIlll,4411,2048,683,687,1370,49.9%,7m
805,1,[Rush]BluERush,4411,2066,133,136,269,49.4%,8m
805,1,사우스파크,4411,1108,79,53,132,59.8%,7m
805,1,죽창,4411,0,0,1,1,0.0%,2m
809,1,llllllllllll,4410,280,7,8,15,46.7%,7m
810,1,lIlIlIlIlIlI,4409,1801,60,51,111,54.1%,7m
810,1,[Dopen]RoyaL,4409,812,33,29,62,53.2%,5m
810,1,[청하]피콜로,4409,1086,26,34,60,43.3%,7m
810,1,lightning,4409,554,17,8,25,68.0%,3m
810,1,[이터널]ByuN,4409,30,2,2,4,50.0%,7m
815,1,짐레이너,4407,1995,244,245,489,49.9%,8m
816,1,[무한오영종]SeoHyunJung,4406,752,18,11,29,62.1%,3m
816,1,CoronaChina,4406,184,4,5,9,44.4%,7m
816,1,IIIIIIIIII,4406,0,0,1,1,0.0%,3m
819,1,kimme,4405,2069,193,196,389,49.6%,3m
819,1,雅雅大王,4405,235,5,2,7,71.4%,7m
819,1,Muru,4405,240,5,4,9,55.6%,7m
822,1,Dioxin,4404,0,1,0,1,100.0%,7m
823,1,Messiah,4403,1953,63,65,128,49.2%,15m
824,1,[s2Mc]zeta,4400,2032,108,112,220,49.1%,8m
824,1,IlIlllIIl,4400,184,5,3,8,62.5%,8m
826,1,iiiiiii,4399,2062,203,220,423,48.0%,7m
827,1,라미님,4397,1615,66,57,123,53.7%,8m
827,1,[NEX]Cantabile,4397,954,41,44,85,48.2%,15m
829,1,[엔타로연합]죄송합니다,4396,0,0,2,2,0.0%,3m
829,1,Victor,4396,0,0,2,2,0.0%,7m
831,1,[ELS]날빌쓰면원형탈모,4393,1777,54,45,99,54.5%,8m
831,1,[무한오영종]주종없음,4393,991,32,24,56,57.1%,8m
831,1,[XYFANS]Theresia,4393,110,3,1,4,75.0%,8m
834,1,레오파,4392,585,60,39,99,60.6%,5m
834,1,[TAPC]灬就是馋她身子,4392,779,36,14,50,72.0%,7m
834,1,[WDY]윤디,4392,0,1,0,1,100.0%,7m
837,2,SONYU,4391,149,7,2,9,77.8%,2m
837,1,llllllllllll,4391,96,2,5,7,28.6%,7m
837,1,lIllIllllIIl,4391,0,1,1,2,50.0%,2m
840,3,llllllllllll,4390,30,2,0,2,100.0%,8m
840,1,KobeBryant,4390,0,1,0,1,100.0%,3m
840,1,[海膽王]你好,4390,0,0,2,2,0.0%,7m
843,1,폭발은예술이다,4389,1448,50,39,89,56.2%,7m
844,1,lIIlllIIl,4385,1774,136,151,287,47.4%,8m
845,1,Dreamtmicky,4384,0,0,1,1,0.0%,7m
846,1,GanSINI,4383,1011,81,81,162,50.0%,2m
846,1,[쿡더디자인]훈창원,4383,0,1,2,3,33.3%,2m
848,1,IIIIIIIIIIII,4382,0,1,2,3,33.3%,7m
849,1,IIIIIIIIIIII,4381,318,6,6,12,50.0%,2m
849,1,Yamada,4381,139,2,2,4,50.0%,7m
849,1,[SofT]스투야아프지마,4381,0,0,1,1,0.0%,15m
852,1,[무한오영종]BrokenHeart,4380,2025,193,205,398,48.5%,7m
853,1,lllIlllIIIll,4379,2023,198,204,402,49.3%,7m
853,1,모기퇴치,4379,1151,63,47,110,57.3%,7m
853,1,llIllIllIll,4379,671,41,35,76,53.9%,2m
853,1,IIIIIIIIIIII,4379,653,19,29,48,39.6%,15m
857,1,Everlasting,4377,1984,362,387,749,48.3%,8m
857,3,IlIlIlIlIlIl,4377,30,3,2,5,60.0%,9m
857,1,[Ato]해물비빔소스도둑,4377,94,2,2,4,50.0%,7m
860,1,llIIllllllll,4376,1212,139,95,234,59.4%,7m
860,1,亞歷山德拉,4376,405,24,6,30,80.0%,3m
860,1,myiA,4376,592,13,21,34,38.2%,15m
863,1,llllllllllll,4375,0,0,1,1,0.0%,7m
864,1,[Rush]TopRush,4374,594,13,31,44,29.5%,8m
864,1,CanoyLake,4374,0,0,1,1,0.0%,7m
866,1,AppleGoogji,4373,190,5,8,13,38.5%,7m
867,1,글자를꽉채워보자,4372,294,7,6,13,53.8%,5m
868,1,[이터널]PeinMoDeGY,4371,1050,29,28,57,50.9%,3m
868,1,[엔타로연합]ExAmple,4371,257,7,3,10,70.0%,3m
868,1,[αX]PotatoPleb,4371,0,1,2,3,33.3%,8m
868,1,[시럽]space,4371,0,0,1,1,0.0%,7m
872,1,IIIIIIIIIIII,4370,1607,267,282,549,48.6%,7m
873,1,[S급용병]아들,4369,1527,94,92,186,50.5%,5m
873,1,RIPoForEveR,4369,1878,85,74,159,53.5%,3m
873,1,스웨인,4369,0,0,1,1,0.0%,3m
873,1,[KRisEZ]KimJongAdun,4369,0,0,3,3,0.0%,3m
877,1,llllllllllll,4366,275,19,19,38,50.0%,7m
878,1,[ELS]빵꾸똥꾸,4364,886,39,27,66,59.1%,3m
879,1,Grost,4362,1895,165,147,312,52.9%,7m
879,1,[AhChoo]FlowerKei,4362,272,7,9,16,43.8%,2m
879,1,[NsP]HeART,4362,140,4,4,8,50.0%,7m
882,1,ElFruit,4361,0,0,3,3,0.0%,8m
883,1,Vanish,4360,199,7,4,11,63.6%,3m
884,1,Neko,4359,530,34,38,72,47.2%,7m
884,1,[천천히]SlowlyHazer,4359,0,1,2,3,33.3%,8m
886,1,[NGameS]조선명기,4358,374,8,11,19,42.1%,8m
887,1,[Lotuz]Rum,4357,972,23,28,51,45.1%,7m
888,1,[SC2HK]青銅鮮奶茶,4356,1092,29,31,60,48.3%,15m
888,1,갓고,4356,403,27,13,40,67.5%,2m
888,1,[ChoaDa]중성마녀,4356,466,19,9,28,67.9%,7m
888,1,[UwU]Hushy,4356,125,4,1,5,80.0%,3m
892,1,lIlIllIIllIl,4355,2049,172,157,329,52.3%,15m
892,1,GoodSoul,4355,1575,172,181,353,48.7%,3m
892,1,초보,4355,1628,45,48,93,48.4%,7m
892,1,[Dopen]EkEkDlRtjS,4355,1012,33,33,66,50.0%,5m
896,1,나의컴은북경컴,4354,46,1,2,3,33.3%,7m
896,1,[SofT]골짱인중다이스키,4354,0,0,2,2,0.0%,7m
898,1,IIlIIlIIlIIl,4353,274,19,1,20,95.0%,3m
898,1,[모두하나인숲]집정관,4353,0,1,0,1,100.0%,3m
898,1,Jcollet,4353,0,0,1,1,0.0%,2m
901,1,[WAZAI]GameDay,4352,1592,139,128,267,52.1%,7m
901,1,lllllllll,4352,1352,106,124,230,46.1%,15m
901,1,[eXoPH]eXoBLaZeR,4352,1621,59,53,112,52.7%,5m
901,1,존잘빈,4352,923,57,50,107,53.3%,7m
901,1,[攘外必先安内]黑暗中的片反本,4352,424,26,17,43,60.5%,7m
901,1,Marshmallo,4352,236,6,6,12,50.0%,7m
901,1,Untouchable,4352,0,0,4,4,0.0%,8m
908,1,비지입니당,4351,1860,237,177,414,57.2%,3m
908,2,[우디르]록토저격용,4351,385,17,4,21,81.0%,5m
908,1,MiguelVeloso,4351,88,1,1,2,50.0%,8m
908,3,[SofT]반짝이,4351,0,0,1,1,0.0%,8m
912,1,[래더납치범]Maru,4350,2033,458,482,940,48.7%,8m
912,1,[Lotuz]박진영왜케잘생김,4350,294,7,5,12,58.3%,8m
912,1,SCtrash,4350,0,0,1,1,0.0%,7m
915,1,[무한오영종]BLEU,4349,1785,427,435,862,49.5%,8m
915,1,鮮奶茶二號機,4349,708,30,21,51,58.8%,8m
917,1,lIIIIllIIIII,4347,1399,92,108,200,46.0%,7m
917,1,[勇敢正义部队]克哈的天黑了,4347,1092,29,30,59,49.2%,7m
919,3,chatter,4346,1497,273,295,568,48.1%,5m
919,1,[CIM]OptBnKSJ,4346,96,2,7,9,22.2%,8m
921,2,Kaiser,4345,0,0,1,1,0.0%,2m
922,1,[빨리섭종기원]숙련된노가다의조,4344,1998,246,262,508,48.4%,7m
923,1,SKYBTT,4343,658,16,21,37,43.2%,2m
923,1,[얼라이브]MotoK,4343,238,6,17,23,26.1%,2m
925,1,IIIIIIIIIIII,4342,1873,224,210,434,51.6%,3m
926,1,llllIIIIllll,4341,670,33,20,53,62.3%,7m
926,1,qwerty,4341,925,26,27,53,49.1%,7m
928,1,Moroha,4340,413,22,5,27,81.5%,7m
928,2,[yykw]Akarichan,4340,0,1,0,1,100.0%,3m
928,2,llllllllllll,4340,0,0,1,1,0.0%,4m
931,2,inmyplace,4339,0,3,2,5,60.0%,6m
931,2,SwordKR,4339,58,2,1,3,66.7%,9m
933,1,CUBE,4338,2010,257,258,515,49.9%,8m
933,1,打團,4338,1447,91,83,174,52.3%,7m
933,2,llllllllllll,4338,516,16,12,28,57.1%,5m
933,1,Maru,4338,444,11,14,25,44.0%,8m
933,3,[NGameS]역마,4338,58,3,2,5,60.0%,5m
933,1,SeoMinJu,4338,126,3,2,5,60.0%,8m
939,1,[前無後無]BIOTECH,4336,2022,163,176,339,48.1%,15m
939,1,[坂井泉水]IIIIIIIIIIII,4336,681,31,13,44,70.5%,7m
939,3,LabyRinth,4336,262,13,1,14,92.9%,5m
942,2,두이두잇츄,4335,140,5,2,7,71.4%,15m
942,1,붉은군대,4335,0,0,4,4,0.0%,8m
944,1,llllllllll,4334,469,13,11,24,54.2%,7m
944,1,인생무상,4334,90,3,6,9,33.3%,3m
944,2,[Aster]Fate,4334,0,0,1,1,0.0%,2m
947,1,llllllllllll,4332,316,8,13,21,38.1%,7m
948,2,[NGameS]LShunterS,4331,145,4,3,7,57.1%,6m
948,2,[백수탈출희망]我喜欢民主,4331,0,1,0,1,100.0%,6m
950,2,Darklady,4329,1090,45,29,74,60.8%,8m
950,1,Disaster,4329,531,20,8,28,71.4%,7m
952,1,[Thai]ClsClassiC,4328,268,7,13,20,35.0%,7m
952,1,[ClanGP]preta,4328,0,0,2,2,0.0%,7m
954,1,HongLian,4327,1200,275,281,556,49.5%,2m
954,1,llllllllllll,4327,1682,60,65,125,48.0%,15m
954,2,IlIlIlIIllII,4327,410,27,10,37,73.0%,9m
954,2,llllllllllll,4327,554,19,13,32,59.4%,4m
954,2,인공지능,4327,30,1,2,3,33.3%,3m
959,1,Jombozeus,4326,774,18,25,43,41.9%,8m
960,1,[Old]哈哈是我啦,4324,1508,89,98,187,47.6%,15m
960,2,빡러쉬장인,4324,322,11,7,18,61.1%,3m
960,1,[DCEvn]EmBanGiay,4324,218,8,7,15,53.3%,7m
960,1,[Patek]viNCom,4324,96,2,2,4,50.0%,8m
964,3,동태찌개,4322,147,8,1,9,88.9%,8m
964,2,[마마무솔라]MOvEJin,4322,82,2,1,3,66.7%,4m
966,2,로도갓,4321,74,2,2,4,50.0%,9m
967,1,AgathaParis,4319,1822,65,66,131,49.6%,3m
967,1,[도담이]얼어붙은개,4319,1036,61,44,105,58.1%,7m
967,2,sunknight,4319,1000,42,29,71,59.2%,6m
967,2,Ori,4319,770,28,22,50,56.0%,4m
971,3,[DVS]鋼棍洩師傅,4318,0,1,2,3,33.3%,8m
972,1,BallaDream,4317,1746,52,52,104,50.0%,8m
972,1,llllllllllll,4317,372,9,9,18,50.0%,8m
974,2,llllllllllll,4314,0,0,1,1,0.0%,2m
975,1,IIIIIIIIIII,4313,1926,178,194,372,47.8%,2m
975,2,Assistance,4313,478,15,12,27,55.6%,5m
977,1,[xTMDx]WinS,4312,222,5,7,12,41.7%,3m
978,2,llllllIlllIl,4311,38,1,2,3,33.3%,9m
978,2,IIIIIIIIIII,4311,0,0,2,2,0.0%,15m
980,2,탱료선돌려줘,4310,0,1,0,1,100.0%,15m
981,2,[宗8]ryanchen,4309,132,4,2,6,66.7%,2m
982,1,[雨何时会停]IIIIIIIIIIII,4308,764,28,30,58,48.3%,7m
983,1,llllllllllll,4307,1403,70,70,140,50.0%,3m
984,2,인생무상,4306,30,1,1,2,50.0%,3m
985,1,[MkitRN]FurY,4305,520,13,22,35,37.1%,2m
985,3,[NGameS]교복소녀티아라,4305,0,1,0,1,100.0%,7m
985,2,[코트디부아르]흑인,4305,30,1,1,2,50.0%,6m
988,2,[海膽王]阿嬤下麵給你吃,4304,0,0,1,1,0.0%,7m
989,1,[영앤리치]GoShaQ,4301,0,0,6,6,0.0%,2m
990,1,[ELS]누가봐도소리니,4300,1242,95,100,195,48.7%,3m
990,3,[엔타로연합]Creating,4300,0,2,4,6,33.3%,15m
990,2,llllllllllll,4300,0,1,0,1,100.0%,6m
993,1,[ANGG]SUMMER,4299,938,23,29,52,44.2%,8m
993,1,[맘마통사냥꾼]오리고기,4299,46,1,14,15,6.7%,2m
995,1,qluvanime,4298,1969,286,299,585,48.9%,7m
995,1,LoVE,4298,367,11,12,23,47.8%,7m
995,1,dennis,4298,343,11,16,27,40.7%,2m
998,2,[DVS]拿不到首勝的雷恩,4297,1496,65,58,123,52.8%,7m
998,1,llllllllllll,4297,186,5,9,14,35.7%,7m
1000,2,IlIIIIllllII,4295,752,28,13,41,68.3%,15m
1000,2,노을,4295,168,5,6,11,45.5%,4m
1002,1,[ELS]ShowMaker,4293,1923,99,99,198,50.0%,5m
1002,2,영국흑인래퍼,4293,0,0,1,1,0.0%,7m
1004,1,WallFlower,4292,1957,134,139,273,49.1%,2m
1005,2,[패자는피를]랜덤,4291,34,1,2,3,33.3%,2m
1006,1,electric,4289,265,10,6,16,62.5%,3m
1007,1,쌉벌레,4286,1178,33,41,74,44.6%,15m
1008,1,AAA,4285,1975,510,515,1025,49.8%,3m
1008,1,[ENT]추키청정수,4285,916,23,34,57,40.4%,3m
1010,1,LaON,4284,1629,122,119,241,50.6%,15m
1010,2,명박존박산다라박,4284,0,0,3,3,0.0%,3m
1012,1,息低保密免留車,4282,1109,63,69,132,47.7%,8m
1013,1,Soda,4281,359,14,11,25,56.0%,7m
1013,2,llllllllllll,4281,302,10,5,15,66.7%,3m
1015,1,trusT,4280,0,4,1,5,80.0%,3m
1015,2,ludex,4280,102,4,1,5,80.0%,4m
1017,2,KIMMINYOUNG,4279,948,36,32,68,52.9%,3m
1018,3,llllllllllll,4278,0,1,0,1,100.0%,5m
1019,1,[이터널]기부왕,4277,931,87,81,168,51.8%,2m
1019,1,[노닥노닥]낙지맛게임,4277,578,41,36,77,53.2%,8m
1019,2,유랑,4277,74,2,1,3,66.7%,5m
1022,1,IIIIIIIIIIII,4276,800,38,18,56,67.9%,3m
1022,1,[두피용면도기]IlIlIlllIl,4276,289,7,9,16,43.8%,8m
1024,2,NukaCola,4275,0,0,3,3,0.0%,7m
1025,2,[Hyper]왈왈짖는멍멍개,4272,214,8,10,18,44.4%,6m
1025,2,magician,4272,30,1,2,3,33.3%,3m
1027,1,[SpM]IlIlIlIlIlIl,4271,628,15,23,38,39.5%,2m
1027,2,LawLiet,4271,98,3,6,9,33.3%,4m
1029,2,IIlIIlIIIll,4270,360,12,9,21,57.1%,9m
1030,1,lllIlllIllIl,4268,1779,164,174,338,48.5%,3m
1030,1,[프로야근러]할짓없다,4268,330,9,12,21,42.9%,8m
1030,1,llllllllllll,4268,0,3,2,5,60.0%,7m
1030,2,lIlIllIlIlIl,4268,0,2,4,6,33.3%,4m
1030,2,llllllllllll,4268,0,0,2,2,0.0%,3m
1035,1,IIIIIIIIIIII,4267,821,38,36,74,51.4%,7m
1036,2,리버,4266,172,7,5,12,58.3%,15m
1036,2,[오직모니카만]IIIIIIIIII,4266,0,1,0,1,100.0%,3m
1036,2,BloSSoM,4266,40,1,3,4,25.0%,8m
1039,1,Britz,4265,1496,43,56,99,43.4%,8m
1039,2,llllllllllll,4265,562,20,20,40,50.0%,9m
1039,2,llllllllllll,4265,0,0,1,1,0.0%,2m
1042,1,IIIllIIIll,4264,1946,663,702,1365,48.6%,15m
1042,2,[IMT]VaLue,4264,0,0,1,1,0.0%,8m
1044,1,llllllllllll,4263,1762,146,141,287,50.9%,5m
1045,2,[RESCUE]모노쿠마,4262,486,17,13,30,56.7%,15m
1045,3,Trap,4262,151,3,6,9,33.3%,8m
1047,2,llllllllllll,4261,260,19,20,39,48.7%,2m
1048,1,[Old]RealiSe,4260,1955,98,115,213,46.0%,2m
1048,1,[GAM]LFG,4260,963,25,30,55,45.5%,7m
1050,2,[Yisc]아오키지,4259,0,0,2,2,0.0%,2m
1051,2,InJoong,4258,1648,137,112,249,55.0%,4m
1051,2,[주몽]굉장히엄청난사람,4258,34,2,2,4,50.0%,6m
1051,2,Pontiff,4258,0,1,0,1,100.0%,7m
1054,2,wowesr,4256,1607,65,59,124,52.4%,7m
1054,2,IIIIIIIIIIII,4256,516,17,18,35,48.6%,8m
1056,1,[래더납치범]안단테,4255,1930,213,230,443,48.1%,3m
1056,1,다솜,4255,1091,45,38,83,54.2%,5m
1056,2,타롱,4255,564,20,15,35,57.1%,5m
1056,2,ParaMore,4255,145,5,5,10,50.0%,5m
1056,2,[토나와테테전]SwiftMarine,4255,60,3,0,3,100.0%,7m
1061,2,낄낄,4254,554,20,22,42,47.6%,9m
1062,1,Grace,4253,1134,36,38,74,48.6%,7m
1063,1,관세음보살,4252,901,23,27,50,46.0%,7m
1063,1,KeNkEn,4252,596,17,22,39,43.6%,7m
1065,1,까불지마,4250,1940,182,184,366,49.7%,5m
1066,2,[해병왕]MarineKing,4249,34,1,3,4,25.0%,2m
1067,1,IIIlIIllIIII,4248,1655,70,41,111,63.1%,7m
1067,2,[3대이즈리얼]디알엑스데프트,4248,156,6,2,8,75.0%,6m
1067,2,Automatic,4248,70,3,3,6,50.0%,3m
1070,1,llllllllllll,4247,232,6,9,15,40.0%,3m
1071,2,Phive,4246,0,1,0,1,100.0%,5m
1072,2,llllllllllll,4245,0,0,1,1,0.0%,5m
1073,1,llllllllllll,4244,1931,206,202,408,50.5%,15m
1073,2,불곰롤백좀,4244,102,3,4,7,42.9%,9m
1073,2,Linx,4244,34,1,1,2,50.0%,3m
1073,2,llllllllllll,4244,0,0,1,1,0.0%,7m
1077,1,[Turkk]FallenGodz,4243,289,18,5,23,78.3%,2m
1078,1,기백,4242,1656,73,61,134,54.5%,8m
1078,2,[Rush]Coloseebe,4242,0,1,0,1,100.0%,2m
1080,2,IIIIIIIIIIII,4241,1552,58,61,119,48.7%,5m
1080,2,붕어빵달인김효섭,4241,647,30,12,42,71.4%,7m
1080,2,Mule,4241,242,8,6,14,57.1%,6m
1080,2,[彩虹]December,4241,0,0,1,1,0.0%,9m
1084,2,우크다미,4239,273,14,1,15,93.3%,8m
1084,2,llllllllllll,4239,322,11,4,15,73.3%,8m
1086,2,MisterOops,4236,30,1,4,5,20.0%,9m
1086,2,군번줄,4236,0,0,2,2,0.0%,2m
1088,1,쌈무요정,4235,676,80,49,129,62.0%,3m
1089,2,[프종빨]트웰비엄마,4231,246,8,8,16,50.0%,9m
1090,1,llllllllllll,4230,1931,197,211,408,48.3%,5m
1091,2,[SPTS]CamryPower,4229,86,2,3,5,40.0%,5m
1091,2,[스투는]새벽감성,4229,0,0,1,1,0.0%,2m
1093,1,[WAZAI]JavaStory,4228,1544,180,170,350,51.4%,7m
1093,1,[협동전브론즈]맬찌님,4228,943,46,53,99,46.5%,7m
1093,2,Deneb,4228,0,1,3,4,25.0%,7m
1093,2,미않,4228,0,0,2,2,0.0%,5m
1097,1,Desire,4226,1891,156,165,321,48.6%,2m
1097,1,[송해손잡고]스타투홍보대사,4226,1418,42,51,93,45.2%,3m
1099,3,[아다치]터치,4225,265,12,2,14,85.7%,8m
1100,1,IIIIIIIIIIII,4224,803,80,81,161,49.7%,7m
1101,1,llllllllllll,4223,1886,89,103,192,46.4%,8m
1101,2,[OPT]Khzz,4223,358,13,13,26,50.0%,2m
1103,1,IIIIllI,4222,1940,130,145,275,47.3%,8m
1103,1,llllllllllll,4222,1035,39,51,90,43.3%,2m
1103,2,ELChacaL,4222,110,4,4,8,50.0%,2m
1103,2,Geologist,4222,0,0,1,1,0.0%,9m
1107,3,lIllIlllIlll,4221,392,34,59,93,36.6%,5m
1107,2,llllllllllll,4221,522,22,13,35,62.9%,2m
1107,2,IIIlllIIIlll,4221,300,16,6,22,72.7%,3m
1107,1,[인투더]IntoTheP,4221,502,13,25,38,34.2%,7m
1111,1,Roger,4220,721,22,21,43,51.2%,8m
1112,2,[지비클]섹시큐티박수영,4219,126,4,4,8,50.0%,4m
1112,1,[지비클]EveningSky,4219,144,3,13,16,18.8%,8m
1112,2,[Thai]MateNn,4219,0,0,1,1,0.0%,6m
1112,2,[lessa]Soul,4219,0,0,1,1,0.0%,4m
1116,2,[홍콩행제리바]BOLA,4218,32,2,3,5,40.0%,8m
1117,2,[ANGG]XellOs,4217,1066,44,34,78,56.4%,3m
1117,2,[파밍여단]존버,4217,429,28,23,51,54.9%,6m
1117,2,random,4217,108,4,3,7,57.1%,5m
1117,2,[Rush]TouchRush,4217,30,2,5,7,28.6%,2m
1121,1,밤기사,4216,1918,87,107,194,44.8%,7m
1121,1,llllllllllll,4216,1569,84,78,162,51.9%,8m
1121,2,[진짜왜하냐]핵극혐노잼망겜,4216,257,8,12,20,40.0%,15m
1121,2,[growup]Asuna,4216,60,2,5,7,28.6%,7m
1125,2,[PANG]푸른들,4214,0,0,1,1,0.0%,2m
1126,2,저스트제니스,4213,439,14,20,34,41.2%,6m
1127,2,[Akuma]Aandthestory,4212,64,3,3,6,50.0%,4m
1127,3,IIIIIIIIIIII,4212,60,3,4,7,42.9%,6m
1129,2,무한상사,4211,38,1,4,5,20.0%,8m
1130,1,슛돌이,4210,1862,206,193,399,51.6%,8m
1130,2,[마법의숲]치짱,4210,0,0,1,1,0.0%,5m
1130,2,kunst,4210,0,0,1,1,0.0%,8m
1133,1,[이터널]피로물질,4208,1848,96,111,207,46.4%,8m
1134,2,[이터널]핑크팬더,4206,70,2,1,3,66.7%,4m
1135,1,hest,4205,1138,39,44,83,47.0%,7m
1135,2,Vindicta,4205,221,13,0,13,100.0%,7m
1135,2,[이터널]햇님달님별님,4205,100,3,1,4,75.0%,7m
1135,2,llllllllllll,4205,0,3,1,4,75.0%,5m
1135,1,Iris,4205,0,1,14,15,6.7%,2m
1140,2,Tiff,4204,38,2,1,3,66.7%,9m
1141,1,[Lotuz]Nemshing,4202,1356,85,70,155,54.8%,15m
1141,2,lIlIlIlIIll,4202,186,7,9,16,43.8%,6m
1143,1,[무한오영종]Patrasche,4201,1897,82,94,176,46.6%,7m
1143,2,tengdori,4201,271,10,10,20,50.0%,9m
1145,2,[XYFANS]아랑곳하지않다,4200,341,14,3,17,82.4%,6m
1145,2,[TalenT]奧爾卡,4200,0,3,2,5,60.0%,5m
1147,2,SpArk,4199,204,8,6,14,57.1%,2m
1147,2,[2552]llllllllllll,4199,108,4,3,7,57.1%,4m
1147,2,전태양만세,4199,40,1,4,5,20.0%,5m
1147,2,llllllllllll,4199,0,0,1,1,0.0%,3m
1151,1,IIIIIIIIIIII,4198,1498,204,223,427,47.8%,7m
1151,2,StarTrak,4198,1531,143,147,290,49.3%,5m
1151,2,축복,4198,102,3,9,12,25.0%,7m
1151,2,Tyson,4198,30,1,1,2,50.0%,9m
1151,2,llBansHeell,4198,0,0,1,1,0.0%,9m
1156,1,[Equal]awoy,4196,1879,174,188,362,48.1%,7m
1156,2,[섹시아재]안녕미브리씨,4196,0,0,2,2,0.0%,8m
1156,2,TitaNium,4196,0,0,3,3,0.0%,3m
1159,2,[무한오영종]오마이오신라텐세,4195,30,2,1,3,66.7%,7m
1160,2,llllllllllll,4194,1329,79,78,157,50.3%,5m
1160,2,달이사랑,4194,1276,51,40,91,56.0%,15m
1162,2,FadeAway,4193,967,43,37,80,53.8%,9m
1162,2,Baedibiair,4193,481,30,17,47,63.8%,5m
1162,2,llllllllllll,4193,58,2,5,7,28.6%,4m
1162,2,SCTerran,4193,0,0,2,2,0.0%,8m
1166,2,llllllllllll,4192,1619,403,408,811,49.7%,5m
1166,3,SCIIBoomer,4192,324,16,1,17,94.1%,9m
1166,2,冬瓜檸檬茶,4192,32,2,5,7,28.6%,2m
1169,2,Reality,4191,524,17,20,37,45.9%,5m
1169,2,llllllllllll,4191,136,5,1,6,83.3%,3m
1171,2,[Rush]demonkiller,4189,100,3,5,8,37.5%,7m
1172,2,IlIIlIlIIlIl,4188,682,23,25,48,47.9%,9m
1172,2,Drake,4188,130,5,3,8,62.5%,2m
1174,2,[장인모임]유명한뭬린허리,4187,1412,61,71,132,46.2%,15m
1174,2,whitebird,4187,204,7,6,13,53.8%,2m
1174,2,DraGon,4187,32,1,6,7,14.3%,4m
1174,2,자날불곰롤백좀,4187,0,0,5,5,0.0%,9m
1178,1,[무한오영종]견과믹스,4186,1698,215,193,408,52.7%,8m
1178,2,[蜂蜜檸檬]UnLock,4186,0,1,0,1,100.0%,4m
1180,1,[바로저그야]사방이저그야,4185,1353,148,171,319,46.4%,2m
1180,2,what,4185,518,19,21,40,47.5%,5m
1182,2,Misslavendar,4183,176,7,2,9,77.8%,3m
1182,2,NeVa,4183,30,1,2,3,33.3%,9m
1182,2,[지비클]doldol,4183,0,0,1,1,0.0%,15m
1185,1,lllllllllll,4182,1064,93,94,187,49.7%,3m
1185,2,IIlIllIllIlI,4182,917,50,50,100,50.0%,4m
1187,2,JHJH,4181,1043,50,28,78,64.1%,7m
1188,2,llllllIIIllI,4179,1389,62,65,127,48.8%,3m
1188,2,[무한오영종]불꽃,4179,132,4,6,10,40.0%,3m
1188,2,Deathknight,4179,0,1,0,1,100.0%,2m
1188,2,[KAREL]KAREL,4179,0,0,1,1,0.0%,7m
1192,2,BWBishOp,4178,426,15,17,32,46.9%,9m
1192,2,비비고,4178,58,3,0,3,100.0%,4m
1194,2,[겨울방어]파워업각성콩벌레,4177,1602,72,73,145,49.7%,5m
1194,1,한택,4177,0,1,0,1,100.0%,5m
1194,2,[살피마리]질럿,4177,0,0,4,4,0.0%,4m
1197,2,극한의바이오닉,4176,228,8,10,18,44.4%,4m
1198,2,[CryANT]성벽,4175,30,2,0,2,100.0%,9m
1199,2,[Equal]테란은사랑입니다,4174,32,2,4,6,33.3%,3m
1199,1,[DONKEY]어름사니,4174,90,2,15,17,11.8%,8m
1201,2,[충남대]KulaLA,4173,152,6,3,9,66.7%,7m
1202,1,[Lotuz]Ruid,4172,1407,78,88,166,47.0%,8m
1202,2,llllllllll,4172,48,3,0,3,100.0%,9m
1202,2,[Ex]Inaho,4172,66,2,4,6,33.3%,4m
1202,2,[Tyler]RealPunch,4172,0,0,2,2,0.0%,4m
1206,2,[영앤리치]slayermarine,4171,0,0,1,1,0.0%,15m
1207,2,flowerstory,4170,361,13,9,22,59.1%,2m
1208,1,[IHan]Dash,4169,1362,58,66,124,46.8%,8m
1209,2,[UCKERS]DeathlyJO,4167,60,2,6,8,25.0%,2m
1210,2,CronuS,4166,0,1,0,1,100.0%,15m
1211,2,[이터널]Harley,4165,1260,82,69,151,54.3%,2m
1211,2,[아잉협회]아잉협회장,4165,824,32,24,56,57.1%,15m
1213,2,[NsP]오타쿠,4164,1597,174,165,339,51.3%,2m
1214,1,IIIIIIIIIIII,4163,1863,447,474,921,48.5%,2m
1215,2,그런거없는데,4162,396,14,13,27,51.9%,15m
1216,2,FlowerRain,4161,96,3,5,8,37.5%,7m
1216,2,Escapefrom,4161,0,0,1,1,0.0%,2m
1218,2,llllllllllll,4160,30,1,1,2,50.0%,8m
1218,2,VIVIDIVAVIDI,4160,0,1,4,5,20.0%,6m
1220,2,llllllllllll,4159,0,0,1,1,0.0%,7m
1220,2,만년다이아,4159,0,0,2,2,0.0%,8m
1222,2,[NsP]BigBang,4157,879,52,50,102,51.0%,2m
1223,2,[IWYDI]LeoCronus,4156,1571,185,199,384,48.2%,3m
1223,2,JBJB,4156,1592,132,115,247,53.4%,4m
1223,2,llllllllllll,4156,1000,38,36,74,51.4%,2m
1223,2,[에스파는나야]둘이될수없어,4156,0,0,2,2,0.0%,4m
1227,1,[NGameS]MaChine,4155,1316,74,87,161,46.0%,3m
1227,2,[GIS]Recall,4155,102,4,2,6,66.7%,5m
1229,2,아니하,4154,226,8,9,17,47.1%,6m
1229,2,Leyla,4154,58,3,0,3,100.0%,2m
1229,2,翡翠檸檬茶,4154,30,1,2,3,33.3%,2m
1232,2,[Tyler]Loanna,4153,1580,241,239,480,50.2%,7m
1232,2,[순경3년차]중앙경찰학교,4153,32,1,2,3,33.3%,15m
1232,2,이거무슨게임이지,4153,0,0,1,1,0.0%,3m
1235,2,RainDrops,4152,1442,65,68,133,48.9%,9m
1235,2,bluebear,4152,568,20,22,42,47.6%,4m
1237,2,Overcomer,4151,171,13,13,26,50.0%,7m
1237,2,[西木野真姫]완자와밥상,4151,30,2,1,3,66.7%,5m
1239,2,Life,4150,78,3,5,8,37.5%,7m
1239,2,[UNPF]長安一片月,4150,0,0,6,6,0.0%,6m
1241,2,Mystic,4149,216,8,11,19,42.1%,6m
1241,2,스막,4149,116,5,2,7,71.4%,3m
1241,2,[이터널]아옳옳이,4149,58,2,1,3,66.7%,7m
1244,2,[이시하라사톰]Satom,4148,1502,125,128,253,49.4%,9m
1244,2,[ELS]OnceStork,4148,0,0,5,5,0.0%,3m
1246,2,[CIM]GATTON,4147,1580,120,123,243,49.4%,8m
1246,2,[TalenT]나는야와고인,4147,115,9,10,19,47.4%,6m
1248,1,[달빛암흑기사]슈발리아,4146,1568,51,64,115,44.3%,8m
1248,2,[Clean]llllllllllll,4146,72,3,5,8,37.5%,3m
1250,2,비둘기야밥먹자,4144,30,1,2,3,33.3%,8m
1251,2,[MS]MSTeMPeST,4142,1398,54,54,108,50.0%,4m
1251,2,시발난짱이다,4142,266,10,8,18,55.6%,15m
1251,2,[ArGKR]JusticeSimon,4142,146,4,1,5,80.0%,7m
1251,2,Revolution,4142,0,0,1,1,0.0%,9m
1255,2,[OPT]람쥐썬더,4141,633,29,34,63,46.0%,9m
1255,2,[ELS]이민열,4141,116,5,3,8,62.5%,8m
1255,2,INnoVation,4141,0,0,1,1,0.0%,6m
1258,2,[JPMG]밀스,4140,393,16,10,26,61.5%,15m
1258,2,[Tanga]Curie,4140,147,3,3,6,50.0%,2m
1258,2,권순구님,4140,94,3,3,6,50.0%,7m
1258,2,Hyeonduck,4140,0,0,3,3,0.0%,7m
1262,3,Darkness,4139,261,9,2,11,81.8%,5m
1262,2,urayama,4139,0,0,2,2,0.0%,15m
1264,2,순구씨,4138,0,1,0,1,100.0%,3m
1265,2,[CIM]IZAC,4137,0,1,3,4,25.0%,15m
1265,2,Spynet,4137,0,0,1,1,0.0%,9m
1267,2,[래더납치범]Nash,4136,238,9,13,22,40.9%,4m
1267,2,몽몽귀,4136,122,5,6,11,45.5%,3m
1267,2,[StorM]WidowMine,4136,74,2,9,11,18.2%,2m
1267,2,양세,4136,0,0,2,2,0.0%,3m
1271,1,CapTain,4135,283,11,21,32,34.4%,7m
1272,2,BlackSwan,4134,1540,165,116,281,58.7%,8m
1272,2,llllllllllII,4134,208,7,8,15,46.7%,4m
1274,2,[수학은]현우진,4133,236,9,4,13,69.2%,5m
1275,1,프사기애미챙녀,4132,145,6,2,8,75.0%,6m
1275,1,[我吃萊豬]改革家國動,4132,46,4,8,12,33.3%,8m
1277,2,[제티토도독]제티토도독,4131,610,31,33,64,48.4%,2m
1277,2,SlayersBoxe,4131,214,7,9,16,43.8%,5m
1279,2,IIIIIIIII,4130,1465,97,89,186,52.2%,4m
1279,2,tttt,4130,361,19,8,27,70.4%,5m
1281,2,Mystical,4129,62,3,3,6,50.0%,9m
1282,2,장방울방울,4128,1440,98,113,211,46.4%,3m
1282,2,장딴지이만기,4128,202,7,14,21,33.3%,2m
1282,2,[채널c]남겨드림,4128,0,0,1,1,0.0%,7m
1285,2,RiDe,4127,906,35,34,69,50.7%,9m
1286,2,[ELS]Hinatsuru,4126,328,12,7,19,63.2%,2m
1286,2,[GdAT]CheesyKimbap,4126,90,3,3,6,50.0%,8m
1286,2,MKP,4126,0,1,0,1,100.0%,5m
1286,2,universe,4126,0,0,1,1,0.0%,5m
1290,2,류정우,4125,1275,129,105,234,55.1%,3m
1290,1,[HKKING]占领天安门,4125,136,3,18,21,14.3%,7m
1290,2,fastr,4125,36,2,2,4,50.0%,9m
1293,1,어쿠스틱,4124,0,1,2,3,33.3%,4m
1294,1,[꿀잼]rfrf,4123,1889,355,377,732,48.5%,7m
1294,1,[FTz]Wiskydom,4123,1834,229,244,473,48.4%,7m
1294,2,IIlIllIIlIIl,4123,382,46,21,67,68.7%,2m
1294,2,llllllllllll,4123,486,31,40,71,43.7%,15m
1298,2,ZeroWing,4121,0,0,2,2,0.0%,7m
1299,2,MarineKing,4120,66,3,4,7,42.9%,8m
1299,2,하아,4120,0,0,1,1,0.0%,7m
1301,2,CDMVR,4119,436,17,7,24,70.8%,4m
1301,3,Must,4119,126,10,1,11,90.9%,4m
1301,2,우리엄마,4119,38,1,2,3,33.3%,3m
1301,2,[행복제한]백일지련,4119,0,0,1,1,0.0%,6m
1305,2,sai,4118,1531,136,133,269,50.6%,6m
1306,2,[안성짱]안세짱,4116,0,1,0,1,100.0%,7m
1306,2,llllIIIlllIl,4116,0,0,1,1,0.0%,7m
1306,2,이게워크인가요,4116,0,0,1,1,0.0%,3m
1309,2,GraZer,4114,1033,58,57,115,50.4%,7m
1309,2,[SHIPS]븅신듀크새끼,4114,210,7,16,23,30.4%,15m
1309,2,raeRoRo,4114,62,3,3,6,50.0%,4m
1312,2,lIlIlIll,4113,880,58,17,75,77.3%,3m
1313,2,NaYoNam,4112,1583,75,48,123,61.0%,8m
1313,2,Guilty,4112,540,22,11,33,66.7%,4m
1313,2,Degurechaff,4112,400,19,24,43,44.2%,6m
1313,2,HalMuccilo,4112,422,16,13,29,55.2%,4m
1317,2,cho,4111,1045,46,38,84,54.8%,5m
1317,3,[ReGKr]PrinzEugen,4111,30,1,1,2,50.0%,8m
1317,2,llllllllllll,4111,0,0,1,1,0.0%,3m
1320,2,DDD,4110,0,0,1,1,0.0%,4m
1321,1,Fxckmanner,4109,1839,353,395,748,47.2%,8m
1321,2,CCexjin,4109,120,5,4,9,55.6%,9m
1323,2,[ELSII]KimRaynor,4108,1620,296,287,583,50.8%,9m
1323,2,nuclearpunch,4108,1434,66,43,109,60.6%,4m
1323,2,카나발리즘,4108,62,3,8,11,27.3%,7m
1326,2,[엔타로연합]쩌는놈,4107,186,7,6,13,53.8%,3m
1326,2,익룡,4107,44,2,1,3,66.7%,4m
1326,2,llllllllllll,4107,30,1,3,4,25.0%,4m
1329,2,ImHari,4106,1348,48,54,102,47.1%,2m
1329,2,MarineKing,4106,214,7,14,21,33.3%,6m
1329,2,Aguacate,4106,0,0,1,1,0.0%,9m
1329,1,lime,4106,0,0,1,1,0.0%,2m
1333,2,[Lotuz]클라스차이,4105,202,8,8,16,50.0%,3m
1334,2,안영이,4104,943,38,27,65,58.5%,4m
1334,2,llllllllllll,4104,72,3,1,4,75.0%,3m
1334,2,Slumdog,4104,0,1,2,3,33.3%,4m
1337,2,[YoRha]고냥이,4103,1561,186,199,385,48.3%,3m
1337,2,IlllIlIIlIll,4103,493,38,28,66,57.6%,2m
1337,3,Gonzo,4103,30,1,7,8,12.5%,8m
1340,3,Mysticism,4102,401,18,4,22,81.8%,8m
1340,3,DEVIN,4102,274,10,1,11,90.9%,6m
1340,2,운영연습을해봐요,4102,194,9,18,27,33.3%,2m
1340,2,Einfache,4102,32,2,0,2,100.0%,4m
1340,2,llllllllllll,4102,30,2,0,2,100.0%,15m
1345,2,[산군山君]산군추이,4101,1558,174,158,332,52.4%,5m
1345,2,나잘못해요,4101,1044,42,32,74,56.8%,9m
1345,2,Marineking,4101,340,12,12,24,50.0%,5m
1348,2,통꿍,4100,873,42,36,78,53.8%,4m
1348,2,[네오]보고배워라,4100,60,3,5,8,37.5%,7m
1348,2,Marine,4100,0,0,1,1,0.0%,15m
1351,1,공허의유산,4099,1831,168,152,320,52.5%,7m
1351,2,[무한오영종]InTurN,4099,1070,41,41,82,50.0%,5m
1353,2,[SofT]테란야캐요,4097,366,15,10,25,60.0%,4m
1353,2,[NsP]Oasis,4097,176,6,9,15,40.0%,4m
1355,2,라인바네트,4096,72,2,7,9,22.2%,2m
1355,2,아이유,4096,0,0,1,1,0.0%,2m
1357,2,냅다다앙장,4094,92,3,3,6,50.0%,4m
1357,2,[지비클]LovelyMina,4094,30,1,1,2,50.0%,4m
1359,1,변현우화이팅,4093,968,28,43,71,39.4%,7m
1360,2,revolution,4092,58,2,4,6,33.3%,2m
1360,2,일천,4092,0,0,1,1,0.0%,9m
1362,2,sett,4091,0,0,1,1,0.0%,7m
1363,2,[이터널]그래도조성주짱,4090,1553,64,49,113,56.6%,7m
1363,2,[너의ol름은]IllIIIllllII,4090,0,0,1,1,0.0%,6m
1365,3,Bogus,4089,134,4,1,5,80.0%,8m
1366,2,금강불괴,4088,1360,97,100,197,49.2%,7m
1366,2,IIIIIIIIIIII,4088,482,30,26,56,53.6%,15m
1366,2,[ENT]Best,4088,534,21,14,35,60.0%,7m
1366,2,[KTsemi]Qurater,4088,369,20,7,27,74.1%,2m
1366,2,岩馆摇杏,4088,126,6,0,6,100.0%,7m
1366,2,Futurecore,4088,88,5,2,7,71.4%,6m
1366,2,[SofT]basketball,4088,0,0,4,4,0.0%,4m
1373,2,薊遼督師袁崇煥,4087,216,9,3,12,75.0%,2m
1373,2,llllllllllll,4087,94,4,2,6,66.7%,7m
1373,2,BMRobot,4087,60,2,1,3,66.7%,15m
1376,2,[Dokdo]미분방정식,4086,324,12,8,20,60.0%,6m
1377,2,[Enter]rail,4085,1379,84,60,144,58.3%,9m
1377,2,거세송아지,4085,406,19,4,23,82.6%,4m
1377,1,TYTY,4085,428,11,25,36,30.6%,7m
1380,3,[대단하시네]PureIceDream,4084,0,1,1,2,50.0%,8m
1381,1,너의샘,4083,698,68,76,144,47.2%,7m
1382,2,[서울의달]kimseonho,4082,1601,116,123,239,48.5%,6m
1383,2,복귀유저입니다,4081,362,13,16,29,44.8%,2m
1384,2,llllllllllll,4080,1545,138,136,274,50.4%,15m
1384,2,Pumpkin,4080,798,87,77,164,53.0%,4m
1384,2,MVP,4080,706,28,23,51,54.9%,15m
1384,2,AKUTA,4080,0,0,1,1,0.0%,15m
1384,2,[게임방송국]겜오겜,4080,0,0,1,1,0.0%,15m
1389,2,[무한오영종]llllllllllll,4079,1478,255,270,525,48.6%,7m
1389,2,llllllllllll,4079,394,18,3,21,85.7%,7m
1389,3,lllIIIIllllI,4079,0,1,0,1,100.0%,8m
1389,2,北北,4079,40,1,5,6,16.7%,5m
1389,2,Medivac,4079,0,0,1,1,0.0%,4m
1394,2,허벌창뷰지박사,4078,149,14,20,34,41.2%,3m
1395,2,Apparently,4077,30,2,8,10,20.0%,7m
1396,2,[ELS]question,4075,344,28,31,59,47.5%,7m
1396,2,ItoMarika,4075,292,9,21,30,30.0%,4m
1396,2,LimitryZero,4075,30,1,3,4,25.0%,4m
1399,2,UnicInte,4073,156,6,7,13,46.2%,4m
1399,2,[미래한국당]Life,4073,58,3,2,5,60.0%,2m
1399,2,Aragami,4073,0,1,0,1,100.0%,5m
1402,2,IIIIIIIIIIII,4072,1536,66,71,137,48.2%,9m
1402,2,seal,4072,288,10,13,23,43.5%,5m
1402,2,LEGACY,4072,140,5,5,10,50.0%,4m
1405,1,[쇼타임]Jun,4071,1801,240,228,468,51.3%,7m
1405,2,[ANGG]ashtontontno,4071,64,3,10,13,23.1%,2m
1405,2,자지철,4071,0,0,4,4,0.0%,9m
1408,2,스타테일쇼부왕,4070,318,10,13,23,43.5%,2m
1408,2,뀨뀨,4070,100,4,3,7,57.1%,8m
1410,2,camrypower,4069,229,12,0,12,100.0%,5m
1411,2,파렌양,4068,484,16,28,44,36.4%,15m
1411,2,thijz,4068,270,13,9,22,59.1%,3m
1411,2,히히,4068,160,6,13,19,31.6%,15m
1411,2,[뽕치면뒤진다]Ryu,4068,88,4,6,10,40.0%,9m
1411,2,llllllllllll,4068,0,1,0,1,100.0%,4m
1411,2,[Thai]Arsymer,4068,0,0,1,1,0.0%,7m
1417,2,[CyaN]Apfel,4067,162,5,13,18,27.8%,2m
1417,2,Lemonade,4067,0,0,1,1,0.0%,3m
1419,2,InsAne,4066,678,26,21,47,55.3%,3m
1419,2,[좃카닉버림]Laala,4066,134,20,27,47,42.6%,6m
1419,2,IllllIl,4066,232,9,7,16,56.2%,9m
1422,2,TwiLight,4065,0,2,6,8,25.0%,15m
1423,2,MINHTHUHAI,4064,1358,110,114,224,49.1%,9m
1424,2,NETman,4063,0,1,0,1,100.0%,2m
1424,2,프로미스나인하영,4063,0,0,1,1,0.0%,8m
1424,2,[래더납치범]KimNaYoung,4063,0,0,1,1,0.0%,8m
1424,2,[ALEPH]Sephirah,4063,0,0,2,2,0.0%,8m
1428,2,[Dopen]Crush,4061,58,2,3,5,40.0%,4m
1429,1,[eXoPH]eXo,4060,1775,314,334,648,48.5%,7m
1429,2,[몷루]뷰릇뷰릇헤으응,4060,1265,65,54,119,54.6%,2m
1429,2,ZerO,4060,648,27,16,43,62.8%,7m
1429,2,Fantasystyle,4060,300,11,12,23,47.8%,7m
1429,2,SophiA,4060,254,9,10,19,47.4%,7m
1429,2,NINJAGOJay,4060,0,3,2,5,60.0%,3m
1435,2,GigAbyTE,4057,1547,193,186,379,50.9%,4m
1435,2,[무한오영종]AlphaGo,4057,1094,40,47,87,46.0%,9m
1435,1,IIIIIIIIIIII,4057,686,18,34,52,34.6%,7m
1435,2,lIlIlIlIlIlI,4057,0,1,2,3,33.3%,5m
1439,2,[NsP]파랑,4056,384,15,8,23,65.2%,4m
1439,2,llllllllllll,4056,172,10,11,21,47.6%,9m
1439,2,[무한송준의]비건페미캣맘,4056,156,6,6,12,50.0%,8m
1439,2,gasibe,4056,112,4,3,7,57.1%,2m
1443,2,[최희]쿠센이,4055,1126,50,51,101,49.5%,15m
1443,2,[Dopen]한우진,4055,742,29,25,54,53.7%,8m
1443,2,[EGTL]ThorZaIN,4055,114,5,3,8,62.5%,2m
1443,2,[날씨좋음]NiceWeather,4055,80,4,15,19,21.1%,6m
1447,2,무적군이,4054,226,9,3,12,75.0%,3m
1447,2,[블롹풰퍼]인자,4054,0,0,1,1,0.0%,7m
1449,2,삭쾡이,4053,124,5,7,12,41.7%,3m
1449,2,Bisu,4053,30,2,3,5,40.0%,15m
1451,3,자유와바다,4052,303,15,2,17,88.2%,5m
1452,2,[안응신]ChoiYJ,4051,86,3,1,4,75.0%,6m
1452,2,Crayon,4051,0,1,0,1,100.0%,3m
1454,1,Captain,4050,1787,108,107,215,50.2%,8m
1454,2,[Mruly]조용카이,4050,1034,40,38,78,51.3%,4m
1456,3,llllllllllll,4049,234,12,1,13,92.3%,6m
1456,2,저그상향이필요해,4049,94,7,8,15,46.7%,4m
1458,2,[게임플레이]IIIIllllllII,4048,601,41,35,76,53.9%,7m
1458,2,FlowerMinam,4048,0,0,2,2,0.0%,4m
1460,2,IIIIIIIIIIII,4047,1576,111,84,195,56.9%,8m
1460,2,개미하루,4047,846,32,31,63,50.8%,3m
1462,2,IIIIIIIIIIII,4046,963,47,55,102,46.1%,6m
1463,2,xiyentaiku,4045,644,33,41,74,44.6%,2m
1463,2,말머리유씨가문,4045,824,30,31,61,49.2%,3m
1463,2,solskjaer,4045,290,11,12,23,47.8%,3m
1463,2,아르타니스,4045,354,11,24,35,31.4%,2m
1463,2,[病友會]GoSlow,4045,174,7,4,11,63.6%,3m
1468,2,YuKino,4044,921,60,33,93,64.5%,4m
1468,2,LetsGoMacro,4044,573,41,26,67,61.2%,7m
1468,2,士緯,4044,0,1,0,1,100.0%,5m
1468,3,废铁二号,4044,0,0,1,1,0.0%,9m
1472,3,PAOLO,4043,264,13,2,15,86.7%,6m
1473,2,llllllllllll,4042,798,38,18,56,67.9%,7m
1473,2,llllllllllll,4042,330,17,2,19,89.5%,8m
1473,2,[NLTN]급식충,4042,70,2,3,5,40.0%,2m
1473,2,[ash]TaeGyeom,4042,0,1,0,1,100.0%,2m
1477,2,[망겜장인]카드아민,4041,1288,47,61,108,43.5%,15m
1477,2,[ELS]llllllllllll,4041,880,36,33,69,52.2%,15m
1477,2,도새기,4041,146,6,5,11,54.5%,2m
1477,2,[SOLsc]Calixter,4041,0,0,1,1,0.0%,15m
1481,2,llllllllllll,4040,1296,105,123,228,46.1%,2m
1481,2,족구업,4040,0,0,1,1,0.0%,5m
1483,2,왕콘,4039,1233,55,43,98,56.1%,4m
1483,2,엔에스피위너,4039,0,1,0,1,100.0%,4m
1485,2,General,4038,38,2,3,5,40.0%,7m
1485,2,lIlIlIlIIIIl,4038,30,1,5,6,16.7%,5m
1487,2,테란킹,4037,204,7,1,8,87.5%,3m
1487,2,[애니멀킹덤]강아지왕국,4037,186,7,12,19,36.8%,3m
1487,2,탁구왕김제빵,4037,120,4,3,7,57.1%,4m
1490,2,llllllllllll,4036,690,25,26,51,49.0%,2m
1490,2,[NaNoom]머이카노,4036,0,0,2,2,0.0%,8m
1490,2,Kaka,4036,0,0,2,2,0.0%,9m
1493,2,llllllllllll,4035,1555,490,454,944,51.9%,3m
1493,2,Castilia,4035,1583,141,130,271,52.0%,4m
1493,1,Carte,4035,1107,31,49,80,38.8%,2m
1493,2,[BJTU北交]tycoon,4035,86,4,3,7,57.1%,4m
1493,2,[NGameS]판사님,4035,30,2,1,3,66.7%,7m
1498,2,CPA,4034,466,20,17,37,54.1%,8m
1499,1,프사기프종빨,4033,193,4,8,12,33.3%,4m
1499,2,도도나무,4033,0,1,0,1,100.0%,2m
1501,2,[머큐리]Trafford,4032,166,6,4,10,60.0%,15m
1502,2,lIIlIIllIIIl,4031,220,19,21,40,47.5%,7m
1502,2,Fleuret,4031,254,9,9,18,50.0%,15m
1502,2,unimat,4031,30,2,1,3,66.7%,9m
1502,2,Ready,4031,0,0,1,1,0.0%,5m
1502,2,youngkajinya,4031,0,0,1,1,0.0%,6m
1507,1,이민호,4030,1773,298,316,614,48.5%,7m
1507,2,IIIIIIIIIIII,4030,389,14,9,23,60.9%,3m
1507,2,llllllllllll,4030,30,2,0,2,100.0%,9m
1510,2,컴퓨터,4028,1010,136,142,278,48.9%,2m
1510,2,Kite,4028,125,8,6,14,57.1%,15m
1510,2,[순천시]스타미남,4028,0,1,5,6,16.7%,8m
1513,2,[西恩星际]Herobigfish,4027,585,29,16,45,64.4%,3m
1513,3,[아다치]하루까,4027,56,3,7,10,30.0%,4m
1513,2,아수라발발타,4027,129,2,7,9,22.2%,8m
1516,2,July,4026,0,1,2,3,33.3%,4m
1517,2,[BFM]EmperOr,4025,421,17,10,27,63.0%,9m
1517,1,Miso,4025,138,4,0,4,100.0%,5m
1519,3,인공지능,4024,284,14,2,16,87.5%,7m
1520,2,LiquidClem,4023,304,11,11,22,50.0%,4m
1520,2,llllllllllll,4023,144,4,1,5,80.0%,7m
1520,2,IIIIIIIIIII,4023,0,0,1,1,0.0%,8m
1523,2,[독도비둘기]Spectre,4022,0,1,0,1,100.0%,6m
1524,2,비니,4021,1509,167,179,346,48.3%,2m
1524,2,Truffalo,4021,1345,63,68,131,48.1%,15m
1524,2,PsionicStorm,4021,444,17,20,37,45.9%,9m
1524,2,사과,4021,320,12,18,30,40.0%,5m
1524,2,overlord,4021,0,1,0,1,100.0%,9m
1529,3,너를꿈꾸며,4019,281,14,2,16,87.5%,9m
1529,2,[제5공화국]강신호,4019,341,12,23,35,34.3%,9m
1529,2,HalfRookie,4019,252,10,9,19,52.6%,2m
1529,2,IIIIIIIIIIII,4019,58,2,10,12,16.7%,6m
1533,2,날빌충,4018,842,32,30,62,51.6%,2m
1533,2,llllllllllll,4018,257,13,24,37,35.1%,6m
1533,2,kzm,4018,300,10,15,25,40.0%,9m
1533,2,蜂蜜檸檬茶,4018,114,5,4,9,55.6%,2m
1533,2,[bu1ld]Whun,4018,88,4,5,9,44.4%,2m
1538,2,教父再遇刺,4017,165,11,0,11,100.0%,8m
1538,2,[Master]Infsen,4017,84,5,1,6,83.3%,15m
1538,2,[WDY]오우야의유디,4017,30,1,4,5,20.0%,9m
1538,2,AquaGG,4017,0,0,1,1,0.0%,2m
1538,2,죽순킹,4017,0,0,1,1,0.0%,2m
1543,2,MinasMorgol,4016,180,7,9,16,43.8%,5m
1543,2,메리,4016,0,1,0,1,100.0%,3m
1545,2,ayaya,4015,215,14,1,15,93.3%,8m
1545,2,MicroJackson,4015,118,4,5,9,44.4%,7m
1547,2,[또짐]오동꼬리,4014,0,1,0,1,100.0%,2m
1547,2,[김튜나]자원탑농부,4014,0,0,1,1,0.0%,9m
1549,2,[SofT]OnlyMechanic,4013,552,19,23,42,45.2%,9m
1550,2,타디스,4011,306,12,10,22,54.5%,4m
1550,2,[더지니어스]그림같은홈런,4011,0,1,0,1,100.0%,15m
1552,1,llllllllllll,4010,1318,514,548,1062,48.4%,15m
1552,2,Marko,4010,1073,103,105,208,49.5%,15m
1552,2,kimnoir,4010,441,41,40,81,50.6%,4m
1555,1,IIIIIIIIIIII,4009,1602,1359,1389,2748,49.5%,3m
1555,2,[인투더]IntoTheOpti,4009,30,1,1,2,50.0%,3m
1557,1,flksdjgdsklg,4008,1718,109,131,240,45.4%,3m
1557,2,IIIIIIIIIIII,4008,566,24,13,37,64.9%,5m
1557,3,[하이퍼큐브]Bunker,4008,408,20,1,21,95.2%,6m
1557,2,IllIIlllIllI,4008,98,9,5,14,64.3%,7m
1557,2,RenRen,4008,94,4,6,10,40.0%,8m
1557,2,Summer,4008,0,1,1,2,50.0%,6m
1563,1,[WDY]Rocto,4007,1764,511,542,1053,48.5%,3m
1563,2,전업투자자,4007,289,39,34,73,53.4%,7m
1563,2,DarkCarrot,4007,0,1,1,2,50.0%,6m
1566,2,San,4006,1478,63,76,139,45.3%,4m
1566,2,[래더납치범]Nash,4006,1533,62,72,134,46.3%,4m
1566,2,[Dopen]라르고,4006,418,16,16,32,50.0%,2m
1566,2,[Ato]앙틱,4006,440,16,22,38,42.1%,5m
1566,2,JPARK,4006,347,13,8,21,61.9%,2m
1566,2,[閃電]永恆,4006,206,8,6,14,57.1%,2m
1572,2,[이노리]Robin,4005,1178,104,99,203,51.2%,4m
1573,2,KamijonOthin,4004,1400,87,109,196,44.4%,3m
1573,2,edcwconan,4004,32,9,23,32,28.1%,6m
1575,2,낑깡,4003,382,17,12,29,58.6%,3m
1575,2,[인생노잼]AWESOME,4003,133,2,5,7,28.6%,5m
1577,1,Viole,4002,1662,153,143,296,51.7%,8m
1577,2,Spinel,4002,726,30,20,50,60.0%,5m
1577,2,[海膽王]marucoffee,4002,30,1,3,4,25.0%,7m
1580,2,ZARD,4001,990,65,67,132,49.2%,15m
1580,3,llllllllllll,4001,201,5,14,19,26.3%,9m
1580,2,InsungBoxer,4001,138,4,1,5,80.0%,6m
1583,3,GoGoPlay,4000,1390,135,178,313,43.1%,9m
1583,2,[TalenT]Never,4000,1308,121,115,236,51.3%,3m
1583,2,catel,4000,305,15,9,24,62.5%,4m
1586,2,IlIlIllIllII,3998,1396,55,55,110,50.0%,8m
1586,2,blakcout,3998,30,2,4,6,33.3%,15m
1586,2,게임종결자,3998,0,0,1,1,0.0%,15m
1586,2,빻나나우유,3998,0,0,1,1,0.0%,8m
1590,3,MFIVEX,3997,255,12,6,18,66.7%,15m
1590,2,IIIIIIIIIIII,3997,138,5,4,9,55.6%,9m
1590,2,要來我家喝啤酒嗎,3997,48,2,1,3,66.7%,6m
1590,2,Allonsy,3997,58,2,4,6,33.3%,2m
1594,2,revolution,3996,193,12,2,14,85.7%,9m
1594,2,[break]Dsherlock,3996,124,4,9,13,30.8%,8m
1594,2,냐냔냐냔냐냔냐,3996,0,1,0,1,100.0%,8m
1594,2,[諸葛世家]Karas,3996,0,0,1,1,0.0%,9m
1594,2,[근위대]김태연,3996,0,0,1,1,0.0%,4m
1599,2,그마가고싶어요,3995,1492,135,89,224,60.3%,6m
1599,2,[인투더]IntoTheiZi,3995,1197,84,84,168,50.0%,6m
1599,2,사랑하는엄마,3995,677,53,28,81,65.4%,15m
1599,2,[ANGG]coRn,3995,724,28,26,54,51.9%,3m
1603,2,[ELSII]널빡빡이로만든다,3994,0,0,2,2,0.0%,4m
1604,2,IlIlIlIlIlIl,3993,1499,101,106,207,48.8%,15m
1604,2,Xavier,3993,257,57,24,81,70.4%,4m
1604,2,Clark,3993,566,31,25,56,55.4%,4m
1604,2,IlIlIlIlIlI,3993,612,28,12,40,70.0%,5m
1604,2,[엔타로연합]호야고나,3993,90,3,7,10,30.0%,6m
1609,2,[인투더]IntoTheSWAN,3992,407,51,47,98,52.0%,6m
1610,2,Muu,3991,62,2,6,8,25.0%,4m
1611,2,Dior,3990,30,2,3,5,40.0%,5m
1611,2,sAviOrMaRine,3990,0,0,1,1,0.0%,4m
1613,2,YeongTongGu,3989,1517,99,101,200,49.5%,15m
1613,2,안녕친구들나초보,3989,425,22,9,31,71.0%,9m
1615,2,[鳥東西]llllllllllll,3988,0,1,0,1,100.0%,15m
1616,2,[시럽]Itsme,3987,784,125,105,230,54.3%,4m
1616,2,르노르노,3987,1485,91,100,191,47.6%,9m
1616,2,[TOPEND]가스통은남겨주마,3987,140,7,8,15,46.7%,7m
1616,2,gggl,3987,0,0,5,5,0.0%,2m
1620,2,MasterNova,3986,136,4,2,6,66.7%,5m
1620,2,[SeA]何師宇,3986,0,0,1,1,0.0%,15m
1622,2,jhgshaikw,3985,808,41,41,82,50.0%,9m
1622,2,GarinFairy,3985,64,2,3,5,40.0%,6m
1622,2,Axel,3985,0,0,2,2,0.0%,8m
1625,2,LonelyMan,3984,1446,117,101,218,53.7%,3m
1625,2,[스카이파이터]공허의유산,3984,688,95,99,194,49.0%,2m
1625,2,[너의ol름은]YOLO,3984,1163,56,38,94,59.6%,4m
1628,2,IIIIIIIIIIII,3983,1303,56,42,98,57.1%,9m
1628,2,GLHF,3983,270,15,4,19,78.9%,15m
1628,2,[NCKU]硬梆梆章魚,3983,145,7,14,21,33.3%,9m
1628,2,Kissmyass,3983,124,5,11,16,31.2%,5m
1632,2,[StorM2]Dioxboy,3982,897,42,47,89,47.2%,6m
1632,2,조작은그만,3982,0,0,2,2,0.0%,15m
1634,2,llllllllllll,3981,1015,119,96,215,55.3%,7m
1634,2,Alpaca,3981,828,55,64,119,46.2%,4m
1634,2,包一包回家睡,3981,388,14,18,32,43.8%,4m
1634,2,SCII,3981,30,1,6,7,14.3%,9m
1638,2,ReaperMaster,3980,1558,468,446,914,51.2%,5m
1638,2,[suri]Ascalon,3980,1343,119,121,240,49.6%,4m
1638,2,llllllllllll,3980,1228,42,53,95,44.2%,9m
1641,2,[애국보수]이명박,3979,0,0,2,2,0.0%,9m
1642,2,marinekinG,3978,0,0,9,9,0.0%,3m
1643,2,PgGoodBattle,3977,892,30,42,72,41.7%,8m
1643,2,eSHtoal,3977,0,0,1,1,0.0%,15m
1645,2,Empty,3976,210,7,3,10,70.0%,4m
1645,2,FatalityProS,3976,0,1,1,2,50.0%,8m
1645,2,[엘클라시코]CHAN,3976,30,1,2,3,33.3%,6m
1648,2,회전목마,3975,1394,87,76,163,53.4%,8m
1648,2,[Freeby]우르릉까꿍,3975,1001,64,57,121,52.9%,3m
1648,2,무적권,3975,220,8,18,26,30.8%,3m
1648,2,IlIlIllllllI,3975,60,2,4,6,33.3%,3m
1652,2,[HELPA]헬파,3974,58,3,1,4,75.0%,9m
1652,2,미네랄잇는데,3974,0,0,1,1,0.0%,4m
1654,2,StorageBox,3972,903,111,119,230,48.3%,6m
1654,2,[WTSC]육식남,3972,0,1,0,1,100.0%,2m
1656,2,llllllllllll,3971,1498,233,243,476,48.9%,9m
1656,2,虛無飄渺,3971,293,17,9,26,65.4%,2m
1656,2,[一山不容二虎]二虎,3971,388,14,15,29,48.3%,9m
1656,2,[시트로엥]Venezia,3971,102,3,0,3,100.0%,5m
1660,2,yuttyuy,3970,1282,55,59,114,48.2%,2m
1660,2,[PKERSe]안양꽁치,3970,1055,45,49,94,47.9%,9m
1660,2,此名稱無法更改,3970,994,37,46,83,44.6%,15m
1663,2,[sc2mc]ragenick,3969,452,16,14,30,53.3%,6m
1663,2,[Mist]SlayerSBoxeR,3969,316,14,4,18,77.8%,7m
1663,2,EURO,3969,92,3,6,9,33.3%,2m
1663,2,[청초]ChromaticFox,3969,0,0,1,1,0.0%,8m
1667,2,IIIIIIIIIII,3968,436,16,14,30,53.3%,3m
1667,3,magicTerran,3968,325,12,8,20,60.0%,6m
1667,2,[SofT]난봉꾼,3968,322,12,14,26,46.2%,8m
1667,2,llllllllllll,3968,0,0,1,1,0.0%,9m
1671,2,Fearless,3967,324,19,5,24,79.2%,8m
1671,2,JJH,3967,0,1,0,1,100.0%,4m
1673,2,[OTZ]playerkinght,3966,549,28,24,52,53.8%,4m
1673,2,TheBoy,3966,374,14,13,27,51.9%,8m
1673,2,Narzisse,3966,0,3,2,5,60.0%,3m
1676,2,gOmPlay,3965,1500,380,374,754,50.4%,5m
1676,2,kjw,3965,1572,90,89,179,50.3%,4m
1676,2,HalfCabbage,3965,1116,51,52,103,49.5%,4m
1676,2,Vanvan,3965,420,24,5,29,82.8%,3m
1680,2,[SGlory]rayIII,3964,1541,129,114,243,53.1%,2m
1680,3,GoodDay,3964,329,16,4,20,80.0%,6m
1680,2,[DagmBa]송지은,3964,0,4,1,5,80.0%,7m
1683,2,[Lotuz]짝부랄,3963,1074,46,35,81,56.8%,8m
1684,2,COVIDforever,3962,708,30,20,50,60.0%,8m
1684,2,CosMos,3962,0,0,1,1,0.0%,6m
1686,2,딴딴무지,3961,1473,349,320,669,52.2%,15m
1686,2,Liberty,3961,277,10,7,17,58.8%,7m
1688,2,weqasx,3960,251,7,9,16,43.8%,9m
1688,2,[허대영]호일,3960,30,2,0,2,100.0%,5m
1688,2,REcontrol,3960,30,1,7,8,12.5%,4m
1688,2,기하와벡터,3960,0,0,1,1,0.0%,8m
1692,1,샥바꿔,3959,1410,132,125,257,51.4%,8m
1692,2,[TeamGP]Sandcastle,3959,158,6,14,20,30.0%,9m
1692,2,희제짱,3959,30,1,1,2,50.0%,2m
1695,2,[세미온TD]징니도께비,3958,329,16,5,21,76.2%,4m
1696,2,신현배,3957,128,4,2,6,66.7%,2m
1696,2,아이유,3957,0,0,1,1,0.0%,6m
1698,2,macu,3956,102,4,12,16,25.0%,15m
1698,2,Fox,3956,0,1,0,1,100.0%,9m
1698,2,Sweeper,3956,0,0,3,3,0.0%,9m
1701,2,Synbio,3955,124,18,9,27,66.7%,15m
1701,2,[ELS]KimS,3955,0,0,1,1,0.0%,8m
1701,2,asdads,3955,0,0,2,2,0.0%,4m
1704,2,HgSKKU,3954,1003,149,125,274,54.4%,4m
1704,2,번개테란,3954,102,3,1,4,75.0%,5m
1704,2,temper,3954,0,2,3,5,40.0%,9m
1704,2,[STXE]싸우다죽어라,3954,0,0,1,1,0.0%,6m
1708,2,훌리건,3953,90,3,8,11,27.3%,4m
1708,2,BlueLabel,3953,0,0,2,2,0.0%,4m
1710,2,IsseN,3952,1361,56,50,106,52.8%,7m
1710,2,[FIXXOR]찌봉이,3952,0,0,1,1,0.0%,5m
1710,2,IIIIIIIIIIII,3952,0,0,2,2,0.0%,3m
1713,2,견제좀하자,3951,523,26,16,42,61.9%,15m
1713,2,now,3951,245,15,15,30,50.0%,4m
1713,2,[CrewGP]반짝이,3951,202,6,4,10,60.0%,4m
1713,2,주경야동,3951,112,3,1,4,75.0%,4m
1713,1,[NsP]선우스페셜,3951,0,0,3,3,0.0%,7m
1718,2,[무한오영종]살려주세요,3950,1161,207,190,397,52.1%,3m
1718,2,posh,3950,537,114,109,223,51.1%,4m
1718,2,[loveGG]dar,3950,158,19,11,30,63.3%,4m
1718,2,Macrophage,3950,347,15,16,31,48.4%,8m
1718,2,Klein,3950,257,10,5,15,66.7%,8m
1718,2,[스타놀이터]ULTIMATE,3950,156,6,1,7,85.7%,8m
1718,2,三點一四一五九,3950,0,0,1,1,0.0%,15m
1725,2,[무한오영종]남훈이,3949,639,25,46,71,35.2%,7m
1725,2,bibi,3949,307,15,5,20,75.0%,3m
1725,2,[Serral]박준현,3949,224,8,10,18,44.4%,3m
1728,2,香港玩家,3948,882,139,123,262,53.1%,15m
1728,2,ChunChunMaru,3948,172,6,7,13,46.2%,3m
1728,2,IIIIIIIIIIII,3948,99,3,0,3,100.0%,6m
1728,2,KiMA,3948,88,2,0,2,100.0%,2m
1728,2,llllllllllll,3948,95,1,5,6,16.7%,4m
1728,2,[光復香港]時代革命,3948,0,0,1,1,0.0%,6m
1734,2,Dargel,3947,215,12,3,15,80.0%,4m
1734,2,[파아란]스타로드,3947,30,1,3,4,25.0%,3m
1736,2,yikes,3946,163,9,0,9,100.0%,4m
1736,2,OdoMarine,3946,102,2,1,3,66.7%,2m
1736,2,호우호우쉐쉐,3946,0,1,0,1,100.0%,9m
1736,2,Red,3946,0,1,2,3,33.3%,7m
1736,2,MyStyLe,3946,0,0,1,1,0.0%,3m
1736,2,Aria,3946,0,0,2,2,0.0%,4m
1742,1,반입먹은바퀴벌레,3945,1175,139,152,291,47.8%,5m
1742,2,韓國魚吃嬾,3945,191,7,3,10,70.0%,9m
1744,2,[異界的檢察官]我討厭韓國和狗,3944,1186,43,47,90,47.8%,8m
1744,2,LoL,3944,552,29,12,41,70.7%,9m
1744,2,gogogo,3944,469,24,14,38,63.2%,4m
1744,2,달빛조각사,3944,216,20,22,42,47.6%,8m
1744,2,에어크레인,3944,0,0,1,1,0.0%,4m
1744,2,[스카이파이터]콩성전차,3944,0,0,1,1,0.0%,4m
1750,2,單手讓你,3943,982,177,153,330,53.6%,5m
1751,2,후다닥,3942,462,19,14,33,57.6%,4m
1752,2,[이지훈짱]하오이아하이,3940,1459,103,102,205,50.2%,9m
1752,2,IIIIIIIIII,3940,1224,45,54,99,45.5%,9m
1754,2,flower,3939,1444,123,138,261,47.1%,7m
1754,2,[WDY]사랑그리고죽음,3939,1528,73,71,144,50.7%,8m
1754,2,사랑해,3939,244,9,5,14,64.3%,9m
1754,2,Gosamy,3939,102,2,2,4,50.0%,4m
1758,2,大唐,3938,1356,102,99,201,50.7%,4m
1758,2,[CranKy]Aires,3938,452,16,18,34,47.1%,4m
1758,2,[이터널]강백호,3938,388,13,18,31,41.9%,15m
1758,2,Ernestine,3938,0,0,2,2,0.0%,3m
1762,2,RainYoke,3937,1232,53,41,94,56.4%,4m
1762,2,테란,3937,942,38,33,71,53.5%,8m
1762,2,제임스,3937,437,25,20,45,55.6%,4m
1762,2,HKKIT,3937,230,9,6,15,60.0%,2m
1766,2,[뽕치면뒤진다]약쟁이,3936,269,13,4,17,76.5%,5m
1766,2,[마이리틀포니]형이다기어라잉,3936,92,3,9,12,25.0%,4m
1766,2,父親毛澤東,3936,0,0,1,1,0.0%,7m
1769,2,[快樂玩家]LUKEKUANG,3935,495,25,10,35,71.4%,6m
1769,2,[WDY]스린이테란,3935,206,7,4,11,63.6%,4m
1769,2,[Organs]ForMMR,3935,122,4,5,9,44.4%,8m
1769,2,Maru,3935,58,2,3,5,40.0%,5m
1769,2,티아메르,3935,0,1,0,1,100.0%,9m
1769,2,꼬고곰,3935,0,1,0,1,100.0%,6m
1769,2,asdasdds,3935,88,1,2,3,33.3%,4m
1776,2,霹靂峰寶,3934,88,2,0,2,100.0%,15m
1776,2,사령관,3934,0,0,5,5,0.0%,9m
1778,2,SHOW,3933,1390,140,126,266,52.6%,4m
1778,2,칵퉤,3933,118,4,8,12,33.3%,5m
1780,1,llIllIllIllI,3932,1703,235,261,496,47.4%,8m
1780,3,llllllllllll,3932,192,7,7,14,50.0%,9m
1782,2,LIFESHOCK,3931,1112,65,50,115,56.5%,4m
1782,2,Yui,3931,438,16,16,32,50.0%,8m
1782,3,[Lotuz]ABCbakery,3931,0,0,1,1,0.0%,7m
1785,2,판독기,3930,342,11,27,38,28.9%,4m
1785,2,INnoVation,3930,30,1,2,3,33.3%,4m
1787,2,theghost,3929,687,35,21,56,62.5%,7m
1787,3,BeTaStar,3929,304,15,5,20,75.0%,7m
1787,2,민씽,3929,186,6,15,21,28.6%,15m
1787,3,[UniC]EoBisu,3929,0,2,3,5,40.0%,8m
1787,3,llllllllllll,3929,30,1,1,2,50.0%,8m
1792,3,Medic,3928,0,0,1,1,0.0%,4m
1793,2,[무한오영종]수지백곰,3927,1496,237,221,458,51.7%,3m
1793,2,KameSennin,3927,30,1,3,4,25.0%,8m
1793,3,테란,3927,0,0,1,1,0.0%,8m
1796,2,슬러기,3926,478,38,44,82,46.3%,9m
1796,3,llllllllllll,3926,114,5,1,6,83.3%,6m
1796,2,[씨벅새]나비고기,3926,128,4,1,5,80.0%,8m
1796,3,숑엉잔헝,3926,0,1,2,3,33.3%,7m
1800,2,킴철수,3925,218,6,7,13,46.2%,3m
1800,2,[ELS]hOsys,3925,60,2,12,14,14.3%,3m
1800,3,[원피스]서브마리너,3925,0,1,0,1,100.0%,8m
1800,2,[SofT]ZoDIaC,3925,0,0,2,2,0.0%,15m
1800,2,[IWYDI]HanLin,3925,0,0,3,3,0.0%,4m
1800,2,llllllllllll,3925,0,0,3,3,0.0%,6m
1806,2,[false9]DAYBREAK,3924,1509,109,104,213,51.2%,6m
1806,2,SkyRain,3924,532,20,26,46,43.5%,7m
1806,2,EWBRWE,3924,58,2,5,7,28.6%,6m
1806,3,[Queens]가영,3924,0,1,0,1,100.0%,6m
1806,2,비주얼,3924,30,1,4,5,20.0%,5m
1811,2,[은하]TaeGi,3923,1517,136,129,265,51.3%,9m
1811,3,IlIllIIlIIll,3923,264,10,3,13,76.9%,6m
1811,2,LobeliaRein,3923,190,10,5,15,66.7%,8m
1811,2,daisysult,3923,272,10,17,27,37.0%,4m
1811,2,word,3923,232,9,11,20,45.0%,9m
1816,2,llllllllllll,3922,976,56,23,79,70.9%,5m
1816,3,llllllllllll,3922,1137,48,32,80,60.0%,5m
1818,2,melonsoda,3921,1518,104,114,218,47.7%,15m
1818,2,마스터상륙작전,3921,417,20,9,29,69.0%,9m
1818,1,IIIIIIIIIIII,3921,280,12,4,16,75.0%,4m
1821,2,IIIIIIIIIlll,3920,356,12,19,31,38.7%,4m
1821,3,병든햄스터,3920,0,0,1,1,0.0%,3m
1823,2,NukeWinter,3919,1543,91,96,187,48.7%,4m
1823,2,Ezra,3919,1491,87,92,179,48.6%,3m
1823,2,llllllllllll,3919,175,8,10,18,44.4%,6m
1823,2,First,3919,0,1,1,2,50.0%,6m
1827,2,llllllllllll,3918,555,55,56,111,49.5%,7m
1827,2,[XYFANS]yaoyao,3918,482,16,22,38,42.1%,3m
1827,2,[杞人之優]meister,3918,178,6,4,10,60.0%,7m
1827,3,말마링,3918,0,0,1,1,0.0%,2m
1831,2,[EZDUNK]CHADMARINE,3917,1183,51,47,98,52.0%,8m
1831,2,파워즐겜러,3917,256,9,12,21,42.9%,9m
1831,2,GBB,3917,142,5,8,13,38.5%,8m
1831,3,byunfoot,3917,0,4,1,5,80.0%,7m
1831,2,[Silent]llllllllllll,3917,94,3,11,14,21.4%,4m
1836,2,인간학,3915,1602,212,215,427,49.6%,6m
1836,2,Ment,3915,1323,120,108,228,52.6%,8m
1838,2,Glitch,3914,478,37,25,62,59.7%,6m
1838,2,[Old]出手一定雙線,3914,30,1,6,7,14.3%,4m
1840,2,SNUD,3913,1304,79,76,155,51.0%,3m
1840,2,[인투더]IntoTheKMJ,3913,552,19,24,43,44.2%,7m
1840,3,panda,3913,0,1,0,1,100.0%,6m
1843,2,llllllllllll,3912,1399,73,87,160,45.6%,2m
1843,2,[말뫼FF]말뫼,3912,293,57,58,115,49.6%,9m
1843,3,IIIIIIIIIIII,3912,202,8,5,13,61.5%,6m
1843,2,Jaedolph,3912,0,1,2,3,33.3%,8m
1847,2,Ruvely,3911,122,5,9,14,35.7%,4m
1848,2,llllllllllll,3910,1270,48,53,101,47.5%,4m
1848,3,Devilelf,3910,189,6,11,17,35.3%,8m
1848,2,LoveYouYL,3910,0,1,4,5,20.0%,6m
1848,2,[Prada]Jay,3910,30,1,9,10,10.0%,3m
1852,2,[RS7]llllllllllll,3909,1164,98,96,194,50.5%,9m
1852,2,Nightlord,3909,288,11,15,26,42.3%,6m
1854,2,IllllIlIlIlI,3908,1507,275,280,555,49.5%,9m
1854,2,leonsodrac,3908,1016,178,169,347,51.3%,8m
1854,3,IlIlIlIlIl,3908,769,38,24,62,61.3%,7m
1854,3,Destroy,3908,30,1,2,3,33.3%,15m
1858,2,너츠,3907,1512,63,73,136,46.3%,2m
1858,2,llllllllllll,3907,594,45,58,103,43.7%,8m
1858,3,[NGameS]하문아공부하자,3907,0,0,1,1,0.0%,8m
1861,2,[마젤예]마니가제일예뻐,3906,1498,108,102,210,51.4%,4m
1861,3,[SC2HK]WhiteRa,3906,326,12,2,14,85.7%,3m
1861,2,[RuL]ziOn,3906,62,2,7,9,22.2%,6m
1864,1,[도살장]DefeaTdayZ,3905,119,4,0,4,100.0%,15m
1864,3,갸라도스,3905,0,0,1,1,0.0%,9m
1866,1,[래더납치범]소작농,3904,1136,155,182,337,46.0%,8m
1866,2,히쨩,3904,907,38,41,79,48.1%,7m
1866,2,tvt,3904,924,35,32,67,52.2%,3m
1866,2,[공무원합격은]영웅킬러,3904,326,13,13,26,50.0%,4m
1866,2,kakaru,3904,326,12,17,29,41.4%,6m
1871,2,ScCoNnectioN,3903,1428,252,244,496,50.8%,8m
1871,2,[달콤]바람꽃,3903,705,78,72,150,52.0%,8m
1871,2,HollyCross,3903,340,11,23,34,32.4%,7m
1871,1,Joker,3903,0,3,5,8,37.5%,5m
1871,2,Kkyu,3903,60,2,5,7,28.6%,4m
1871,2,llllllllllll,3903,30,1,7,8,12.5%,15m
1877,2,KJKJ,3902,1248,223,233,456,48.9%,4m
1877,2,[붉은피]llllllllllll,3902,1481,71,66,137,51.8%,8m
1877,2,SSHH,3902,233,14,3,17,82.4%,7m
1877,3,铁观音小凌,3902,362,14,9,23,60.9%,8m
1877,3,UIUC,3902,0,0,1,1,0.0%,9m
1877,2,ChaseDiamond,3902,0,0,5,5,0.0%,6m
1883,3,[우주별망겜]Morozka,3901,30,2,2,4,50.0%,15m
1883,2,llllllllllll,3901,30,2,3,5,40.0%,7m
1883,3,[스타2마피아]루나티카,3901,0,1,0,1,100.0%,6m
1883,3,XiNo,3901,0,1,4,5,20.0%,4m
1887,2,미테미테,3899,1527,249,254,503,49.5%,9m
1887,2,llllIIIIlIl,3899,1213,159,149,308,51.6%,4m
1887,3,[薔薇女子高校]十几岁的女生,3899,766,34,20,54,63.0%,9m
1887,2,마카오갈매기,3899,88,2,2,4,50.0%,4m
1891,3,[우사짝]례설,3897,60,3,3,6,50.0%,7m
1891,2,한놈만팬다,3897,0,1,5,6,16.7%,8m
1893,3,hoon,3896,758,28,25,53,52.8%,8m
1893,2,mckcw,3896,154,5,13,18,27.8%,5m
1893,3,[SofT]Miracle,3896,0,0,2,2,0.0%,6m
1896,3,SimonAJRiley,3895,1138,101,82,183,55.2%,7m
1896,3,Terran,3895,292,11,7,18,61.1%,6m
1898,2,cjswowlgh,3894,284,12,8,20,60.0%,8m
1898,2,[Patek]Rain,3894,204,7,5,12,58.3%,4m
1898,3,Ricaneco,3894,0,0,1,1,0.0%,5m
1901,2,으어어엉,3893,1498,291,312,603,48.3%,6m
1901,3,식빵,3893,116,4,4,8,50.0%,4m
1901,2,Cultizm,3893,30,2,4,6,33.3%,4m
1904,2,기생충마냐,3892,1006,54,47,101,53.5%,3m
1904,2,[SofT]ENE,3892,948,35,35,70,50.0%,8m
1904,3,ATMACHINE,3892,656,32,21,53,60.4%,8m
1904,3,EndMion,3892,189,9,5,14,64.3%,8m
1904,3,[Ato]프로토스,3892,86,6,2,8,75.0%,9m
1904,2,[IWYDI]乂肚皮乂,3892,0,2,4,6,33.3%,3m
1910,2,ZaYo,3891,1517,77,58,135,57.0%,8m
1910,3,sctrash,3891,829,57,23,80,71.2%,9m
1910,3,ForFunDude,3891,259,13,2,15,86.7%,8m
1910,3,그마찍었던사람,3891,240,10,3,13,76.9%,7m
1910,2,Sorrow,3891,254,10,10,20,50.0%,15m
1915,2,Claymore,3890,1008,42,53,95,44.2%,4m
1915,2,누간,3890,58,3,6,9,33.3%,6m
1915,3,GoldenChick,3890,0,1,1,2,50.0%,9m
1918,2,[xIMx]KrisxBell,3889,851,41,51,92,44.6%,15m
1918,2,민트달팽이,3889,190,6,13,19,31.6%,6m
1918,3,TerATo,3889,0,0,1,1,0.0%,6m
1918,3,혼자사는불쌍맨,3889,0,0,1,1,0.0%,6m
1918,3,IAiVeRyEaSyI,3889,0,0,2,2,0.0%,15m
1923,3,로마빠,3888,727,31,19,50,62.0%,5m
1923,2,CDMVR,3888,292,10,15,25,40.0%,4m
1923,3,Nurse,3888,240,9,3,12,75.0%,3m
1923,3,[제니스]동그,3888,258,9,12,21,42.9%,6m
1923,2,FargusAE,3888,113,9,18,27,33.3%,7m
1923,3,[Hyper]달려라거북이,3888,58,2,3,5,40.0%,8m
1929,2,[컴공스투충]Starlett,3887,300,12,16,28,42.9%,8m
1929,3,CooKor,3887,86,3,3,6,50.0%,15m
1931,3,Leta,3885,0,0,2,2,0.0%,3m
1932,2,[게이왕]Manu,3884,1450,226,228,454,49.8%,3m
1932,2,abcd,3884,1374,135,138,273,49.5%,8m
1932,2,FallenAngel,3884,1461,60,73,133,45.1%,3m
1932,3,PEPSI,3884,0,3,2,5,60.0%,9m
1932,3,[NGameS]땅콩버스,3884,0,1,0,1,100.0%,5m
1932,3,장안동오준세,3884,0,0,3,3,0.0%,9m
1938,3,Danny,3883,0,0,1,1,0.0%,8m
1939,2,OBsTiNatE,3882,1227,138,153,291,47.4%,15m
1940,2,[아빠클랜]sweetlassi,3881,1393,141,151,292,48.3%,6m
1940,2,revolution,3881,614,38,36,74,51.4%,3m
1940,2,beyerdynamic,3881,0,0,2,2,0.0%,7m
1943,2,Hello,3880,708,85,84,169,50.3%,3m
1943,2,ddjfj,3880,0,1,0,1,100.0%,6m
1945,3,Blag,3879,1125,51,27,78,65.4%,8m
1945,2,모루,3879,506,19,19,38,50.0%,9m
1945,3,Deep,3879,244,9,6,15,60.0%,8m
1945,3,Blue,3879,114,5,0,5,100.0%,8m
1945,3,Kanra,3879,30,2,0,2,100.0%,15m
1945,2,NotMine,3879,0,1,9,10,10.0%,4m
1951,2,[무한김준현]llllllllllll,3878,1573,415,394,809,51.3%,9m
1951,2,lIlIlIlIlIlI,3878,0,1,4,5,20.0%,9m
1953,2,전투자극제,3877,1274,106,86,192,55.2%,8m
1953,3,트럼프월드마린,3877,930,85,80,165,51.5%,7m
1953,2,FOREST,3877,410,15,16,31,48.4%,7m
1956,2,님매너,3876,1203,91,77,168,54.2%,8m
1956,3,InMY,3876,215,7,7,14,50.0%,9m
1956,2,Felix,3876,58,3,6,9,33.3%,4m
1956,3,ChuckTbone,3876,0,0,1,1,0.0%,9m
1956,3,lllllllllll,3876,0,0,1,1,0.0%,15m
1956,3,싸광남,3876,0,0,3,3,0.0%,7m
1962,2,두루미횡격막,3875,584,20,28,48,41.7%,6m
1962,3,FinalBoss,3875,166,9,0,9,100.0%,5m
1962,3,IIIIIIIIIIII,3875,198,9,7,16,56.2%,3m
1965,3,teioh,3874,524,20,21,41,48.8%,15m
1965,3,더파비,3874,276,10,9,19,52.6%,4m
1965,3,[수원불망맹이]JoKeR,3874,0,0,1,1,0.0%,8m
1968,2,IlIllIlIlIIl,3873,883,32,39,71,45.1%,3m
1969,1,LilianLee,3872,1560,468,506,974,48.0%,8m
1969,1,[한발이면]뿔뿔이,3872,1628,68,92,160,42.5%,7m
1969,3,[TeamTQ]lIIIIllIIll,3872,1550,63,54,117,53.8%,8m
1972,2,RaEy,3871,374,15,12,27,55.6%,4m
1972,3,[엔타로연합]chic,3871,140,5,3,8,62.5%,4m
1972,3,[NGameS]NoiD,3871,0,1,0,1,100.0%,4m
1975,2,물맛이어떠냐,3870,1474,80,58,138,58.0%,7m
1975,2,[xGenGx]TreeStump,3870,176,6,5,11,54.5%,3m
1975,3,eliteslayer,3870,0,0,1,1,0.0%,9m
1978,3,IIIIIIIIII,3869,977,46,44,90,51.1%,4m
1978,2,[Mruly]할리갈리,3869,474,31,39,70,44.3%,15m
1978,3,[ANGG]karaDebiti,3869,302,12,10,22,54.5%,6m
1978,3,뮤탈리스크,3869,30,1,2,3,33.3%,6m
1982,3,[oNs7]슈우웅,3868,1626,356,310,666,53.5%,15m
1982,2,lyssophobia,3868,470,16,20,36,44.4%,3m
1982,2,[OnePeS]GamerSeven,3868,202,8,11,19,42.1%,6m
1982,3,[이유식]IWS,3868,172,6,9,15,40.0%,8m
1982,3,진이,3868,0,0,1,1,0.0%,6m
1987,3,llllllllllll,3867,892,37,25,62,59.7%,6m
1987,2,IIIllIllIIll,3867,628,26,23,49,53.1%,3m
1989,2,다른탱크,3866,1428,61,69,130,46.9%,6m
1990,2,훈수거절,3865,1202,163,130,293,55.6%,9m
1991,2,moonfishie,3863,1208,81,88,169,47.9%,4m
1991,3,Kaiter,3863,103,5,3,8,62.5%,4m
1991,3,NightLappy,3863,30,3,2,5,60.0%,5m
1991,2,Business,3863,62,2,8,10,20.0%,8m
1991,3,[Kyo]Yumeko,3863,0,1,0,1,100.0%,8m
1991,3,만취,3863,30,1,4,5,20.0%,5m
1997,2,[Master]Sanghoon,3862,408,14,21,35,40.0%,3m
1997,3,붕여킹,3862,200,8,8,16,50.0%,6m
1997,3,[Ruby]슈드,3862,0,0,1,1,0.0%,15m
1997,2,[공방깡패]말랑말랑꿍꿍,3862,0,0,7,7,0.0%,9m
2001,2,[무한오영종]Marine,3861,1583,181,178,359,50.4%,9m
2001,3,[Sett]Alarak,3861,570,26,9,35,74.3%,7m
2001,3,llllllllllll,3861,170,7,4,11,63.6%,8m
2004,2,desiredesire,3860,1547,381,397,778,49.0%,15m
2004,3,PokerFace,3860,0,0,2,2,0.0%,9m
2006,3,NOONE,3859,1495,94,63,157,59.9%,7m
2007,2,[Master]Anarchy,3858,1394,126,129,255,49.4%,7m
2007,3,[스2오브옵치]Marzo,3858,1520,83,80,163,50.9%,8m
2007,3,KevinRush,3858,300,13,5,18,72.2%,9m
2007,3,BorisYY,3858,58,3,0,3,100.0%,7m
2007,3,JUNE,3858,0,2,3,5,40.0%,4m
2007,3,TerATo,3858,0,0,1,1,0.0%,7m
2013,3,IIIIIIIIIIII,3857,440,17,19,36,47.2%,15m
2013,3,Revi,3857,346,14,14,28,50.0%,5m
2013,2,Swaying,3857,203,10,1,11,90.9%,6m
2013,2,magicTerran,3857,96,6,2,8,75.0%,6m
2013,3,볼살팡팡,3857,30,1,1,2,50.0%,8m
2018,2,자라초인,3856,1494,191,172,363,52.6%,7m
2018,3,[정령잡이]Anarchy,3856,0,0,1,1,0.0%,4m
2018,3,플랑,3856,0,0,1,1,0.0%,7m
2018,2,Red,3856,0,0,3,3,0.0%,7m
2022,2,IIIIIIIIIIII,3855,542,18,29,47,38.3%,4m
2022,3,[악직숙산]퓨어,3855,58,2,3,5,40.0%,6m
2022,3,enox,3855,0,1,1,2,50.0%,9m
2022,3,지피에스꼬맹왕,3855,0,0,1,1,0.0%,8m
2022,3,[Lotuz]태평양돌핀스,3855,0,0,1,1,0.0%,9m
2027,2,[TalenT]Saint,3854,1456,97,108,205,47.3%,3m
2027,3,snow,3854,168,6,4,10,60.0%,8m
2027,3,zoltar,3854,0,0,1,1,0.0%,15m
2030,2,나어제쉬었다,3853,1487,296,287,583,50.8%,15m
2030,2,worryburry,3853,987,107,93,200,53.5%,4m
2030,3,쿵따리노래방,3853,1088,100,74,174,57.5%,8m
2030,2,ignore,3853,1004,45,40,85,52.9%,9m
2034,2,lllllllllll,3851,377,17,12,29,58.6%,4m
2034,3,타라토노,3851,30,1,2,3,33.3%,4m
2036,3,lIIIlllIllIl,3850,1598,95,87,182,52.2%,3m
2036,3,MyHipYourHip,3850,114,4,2,6,66.7%,9m
2036,3,Flame,3850,30,2,0,2,100.0%,3m
2036,3,lIllIlllllII,3850,0,0,1,1,0.0%,6m
2040,3,자아,3849,44,4,3,7,57.1%,7m
2040,3,[耍廢]Ohayo,3849,38,3,3,6,50.0%,9m
2042,3,비장의한발,3848,351,16,5,21,76.2%,8m
2042,3,[WDY]Maddox,3848,322,11,14,25,44.0%,4m
2042,3,원이삭인쓰,3848,30,1,1,2,50.0%,4m
2045,3,phobic,3847,1414,272,251,523,52.0%,6m
2045,3,RockAllen,3847,403,20,9,29,69.0%,3m
2045,3,llllllllllll,3847,224,8,7,15,53.3%,4m
2045,3,IIIIIIIII,3847,152,6,7,13,46.2%,4m
2045,3,강뒤,3847,0,1,0,1,100.0%,3m
2050,3,HyunG,3846,801,130,99,229,56.8%,4m
2050,3,Nooblet,3846,544,28,18,46,60.9%,15m
2050,3,Pokemon,3846,315,15,9,24,62.5%,4m
2050,3,항공사,3846,192,7,6,13,53.8%,15m
2050,3,IOIGuNDaMIOI,3846,0,0,1,1,0.0%,4m
2055,3,[잉제링이]llllllllllll,3845,985,51,15,66,77.3%,9m
2056,3,[NsP]겜상,3844,0,0,2,2,0.0%,7m
2057,3,레이너,3843,1541,122,111,233,52.4%,7m
2057,2,IIIIIIIIIIII,3843,1267,100,93,193,51.8%,2m
2059,3,llllllllllll,3842,1588,133,122,255,52.2%,3m
2059,3,Leo,3842,1225,98,85,183,53.6%,8m
2059,3,jaws,3842,1404,56,50,106,52.8%,4m
2059,2,[여단]페트로시안,3842,1121,42,47,89,47.2%,8m
2063,3,헤가든제천,3841,1530,190,187,377,50.4%,6m
2063,2,[ladys]dfafsf,3841,1455,147,145,292,50.3%,9m
2063,3,HeavenRode,3841,0,4,1,5,80.0%,8m
2066,2,[무한오영종]Destiny,3840,1545,695,670,1365,50.9%,7m
2066,3,[MRB]FlaSh,3840,618,24,18,42,57.1%,8m
2066,2,Alexi,3840,590,20,28,48,41.7%,7m
2066,3,[캬루]YOLO,3840,140,5,1,6,83.3%,8m
2070,2,[ANGG]아크덕키,3839,891,87,69,156,55.8%,4m
2070,3,더블드래곤,3839,851,37,25,62,59.7%,5m
2072,3,shrkek,3838,909,53,33,86,61.6%,7m
2072,3,[이터널]Starcym,3838,904,38,27,65,58.5%,9m
2072,3,十年執著,3838,0,0,2,2,0.0%,9m
2072,3,好運哥布林,3838,0,0,3,3,0.0%,5m
2076,3,SCImperator,3837,1665,579,552,1131,51.2%,3m
2076,2,뤠이너,3837,706,25,28,53,47.2%,9m
2076,3,Andromedae,3837,200,9,7,16,56.2%,15m
2076,3,SUblobstret,3837,137,6,2,8,75.0%,3m
2076,3,General,3837,43,5,5,10,50.0%,4m
2076,3,MarsOz,3837,30,2,6,8,25.0%,8m
2082,2,전장은나쁜게임,3836,1062,54,57,111,48.6%,3m
2082,2,서초동꿈나무,3836,323,17,9,26,65.4%,6m
2082,3,lIIIllIlIIl,3836,322,12,11,23,52.2%,7m
2082,2,llllllllllll,3836,340,12,22,34,35.3%,15m
2082,3,新心手,3836,30,1,4,5,20.0%,4m
2087,2,Seven,3835,1016,45,48,93,48.4%,6m
2087,3,oneway,3835,768,31,25,56,55.4%,8m
2087,2,[대포폰]JJk,3835,624,30,33,63,47.6%,3m
2087,3,SCV,3835,315,21,14,35,60.0%,8m
2087,3,LADodgers,3835,0,0,1,1,0.0%,4m
2092,2,[마린킹]MisterA,3834,526,93,100,193,48.2%,9m
2092,3,[초현식근동물]육식공룡태혁이,3834,994,42,28,70,60.0%,8m
2092,3,Rudeman,3834,531,21,22,43,48.8%,8m
2095,3,[무한오영종]웅담푸우,3833,1158,62,48,110,56.4%,6m
2095,2,Metapolis,3833,648,45,62,107,42.1%,3m
2095,3,[무한오영종]lIlIlIlIlIlI,3833,86,3,4,7,42.9%,8m
2098,2,더원,3832,1485,138,142,280,49.3%,4m
2098,3,[VASCO]황제테란,3832,443,17,16,33,51.5%,8m
2098,3,아케미호무라,3832,88,4,2,6,66.7%,3m
2098,3,llllllllllll,3832,86,3,1,4,75.0%,7m
2098,3,haPPer,3832,97,2,0,2,100.0%,10m
2103,2,dkricm,3831,1464,109,120,229,47.6%,15m
2104,3,Dyun,3830,398,24,18,42,57.1%,8m
2104,1,연대의대가고싶어,3830,303,13,5,18,72.2%,3m
2104,3,MilkyWay,3830,0,1,0,1,100.0%,6m
2104,3,[ss딱가리들]EAGER,3830,0,1,3,4,25.0%,15m
2108,3,레이너링돌리기,3829,58,3,0,3,100.0%,6m
2108,3,DarkCitadel,3829,0,0,1,1,0.0%,9m
2110,3,[敗人品系列]副官,3828,217,8,6,14,57.1%,6m
2110,3,[miami]DOLPHIN,3828,30,1,3,4,25.0%,4m
2112,1,IlillIlllil,3827,1646,466,489,955,48.8%,5m
2112,2,llIllIllIlIl,3827,62,2,8,10,20.0%,8m
2114,2,llIIlllIIlll,3826,1391,197,200,397,49.6%,4m
2114,2,치츄,3826,1465,196,200,396,49.5%,4m
2114,2,yyystar,3826,1491,107,100,207,51.7%,8m
2114,3,meister,3826,52,2,5,7,28.6%,8m
2114,3,헤타이로이,3826,58,2,8,10,20.0%,8m
2114,3,[AYSM]멘마,3826,0,0,2,2,0.0%,8m
2120,3,llllllllllll,3825,896,43,17,60,71.7%,3m
2120,2,가을보리,3825,342,15,28,43,34.9%,10m
2120,3,[s2Mc]이불덮는약한저그,3825,58,7,0,7,100.0%,7m
2120,2,noooob,3825,136,3,1,4,75.0%,15m
2124,2,SparkleHands,3824,1362,85,90,175,48.6%,3m
2124,2,llllllllllll,3824,693,45,50,95,47.4%,4m
2124,2,Achilleus,3824,96,2,6,8,25.0%,8m
2124,3,blackPeace,3824,0,0,1,1,0.0%,15m
2128,2,[로마제국]포병스타,3823,1376,161,175,336,47.9%,15m
2128,3,하르마게돈,3823,705,32,16,48,66.7%,8m
2128,2,llllllllllll,3823,460,21,19,40,52.5%,7m
2128,2,llllllllllll,3823,58,2,8,10,20.0%,7m
2132,3,[HINA]Mitsuha,3822,463,21,12,33,63.6%,9m
2132,2,[여친정예린팬]Faker,3822,449,16,20,36,44.4%,9m
2132,3,[겨울방어]육식남,3822,390,14,14,28,50.0%,7m
2132,2,innnnovation,3822,154,6,13,19,31.6%,4m
2132,3,[스타놀이터]사진찍는백수,3822,0,0,1,1,0.0%,9m
2137,3,leOn,3821,58,3,1,4,75.0%,7m
2137,3,NCM,3821,30,2,2,4,50.0%,3m
2137,1,모찌론,3821,0,1,1,2,50.0%,4m
2137,3,VoidRay,3821,0,0,1,1,0.0%,8m
2137,3,하루,3821,0,0,2,2,0.0%,8m
2142,2,[Lotuz]HeRitage,3820,946,58,67,125,46.4%,4m
2142,3,[하루살이]학생카드,3820,194,12,15,27,44.4%,7m
2142,3,InNoCentARO,3820,168,7,2,9,77.8%,9m
2142,3,[Hyper]Leo,3820,0,1,0,1,100.0%,6m
2142,3,[Weihai]Kaimera,3820,0,0,1,1,0.0%,8m
2147,3,[어윤수님개쩜]Continue,3819,1556,95,94,189,50.3%,6m
2147,2,[XYFANS]whypsoimba,3819,757,86,93,179,48.0%,8m
2147,3,[Rush]RaynoR,3819,429,23,25,48,47.9%,5m
2147,3,Pomo,3819,423,19,7,26,73.1%,8m
2147,3,[포탑성애자]포탑성애자,3819,0,0,1,1,0.0%,8m
2147,3,[義務警察]llllllllll,3819,0,0,2,2,0.0%,3m
2153,3,[이터널]GunpoDD,3818,547,26,17,43,60.5%,9m
2153,3,llllllllllll,3818,302,11,8,19,57.9%,8m
2153,3,qtd,3818,308,11,9,20,55.0%,4m
2153,3,화가난초보자,3818,144,6,5,11,54.5%,6m
2153,3,[HuIIII]非常強,3818,58,2,2,4,50.0%,15m
2153,3,벤틸러스,3818,0,2,3,5,40.0%,9m
2153,3,[숙련된뉴비]borry,3818,0,0,1,1,0.0%,4m
2153,3,Nuguri,3818,0,0,2,2,0.0%,6m
2161,2,국전리진돗개,3817,1504,189,191,380,49.7%,4m
2161,3,[어윤수님개쩜]대파,3817,1532,83,42,125,66.4%,7m
2161,3,Pinoy,3817,408,18,3,21,85.7%,7m
2164,2,llllllllllll,3816,209,10,2,12,83.3%,6m
2164,3,[Nos]Elvinator,3816,124,4,9,13,30.8%,9m
2164,3,앵교는애니,3816,0,0,1,1,0.0%,8m
2167,3,Physical,3815,728,33,12,45,73.3%,9m
2167,2,[크리에이터]YouTuber,3815,526,22,25,47,46.8%,10m
2167,3,[애니멀킹덤]변현우,3815,384,19,12,31,61.3%,4m
2170,3,[화났음]브루스웨인,3814,30,1,2,3,33.3%,3m
2170,3,[무한오영종]왕의귀환,3814,0,0,1,1,0.0%,6m
2172,3,Belial,3813,639,34,28,62,54.8%,15m
2172,3,[선장이필요해]LastStar,3813,172,7,7,14,50.0%,7m
2172,3,호두고양이,3813,0,0,1,1,0.0%,5m
2175,2,Owin,3812,1546,121,128,249,48.6%,4m
2175,2,Kaiwoo,3812,520,57,48,105,54.3%,4m
2175,2,신사임당,3812,770,51,51,102,50.0%,6m
2175,3,[물지않아요]sidus,3812,340,14,7,21,66.7%,8m
2175,3,파이파스,3812,114,4,2,6,66.7%,8m
2175,3,아진짜귀찮다,3812,0,1,0,1,100.0%,8m
2175,3,게임재밌어,3812,0,0,1,1,0.0%,6m
2182,3,milarepa,3811,1524,231,224,455,50.8%,15m
2182,2,DAzer,3811,1314,70,74,144,48.6%,15m
2182,3,시월영,3811,1078,50,25,75,66.7%,7m
2182,2,IIIIIIIIIIII,3811,343,12,19,31,38.7%,6m
2182,3,IPArTrAsUeI,3811,0,1,0,1,100.0%,8m
2182,3,[릴리]Antares,3811,0,1,4,5,20.0%,5m
2188,3,llllllllllll,3810,374,25,9,34,73.5%,5m
2188,3,USuckS,3810,116,4,3,7,57.1%,9m
2188,3,woorim,3810,0,1,1,2,50.0%,15m
2188,3,[Dopen]공대오지마,3810,0,0,2,2,0.0%,9m
2192,3,[ANGG]화내기싫은사람,3809,1532,62,52,114,54.4%,5m
2192,3,[영웅크래프트]호두의반란,3809,200,8,9,17,47.1%,5m
2192,3,케인인님한판해요,3809,144,6,10,16,37.5%,6m
2195,3,LAN,3808,1001,43,27,70,61.4%,3m
2195,3,[국방부사서병]코로나는사기다,3808,281,11,6,17,64.7%,15m
2195,1,[무한김준현]리뉴얼,3808,177,5,3,8,62.5%,15m
2195,3,[NDW]無料饅頭,3808,60,3,3,6,50.0%,4m
2195,3,제라툴,3808,0,1,0,1,100.0%,7m
2200,3,Forever,3807,771,33,18,51,64.7%,7m
2200,3,IIIIIIIIII,3807,232,10,8,18,55.6%,6m
2200,3,NateHiggers,3807,170,6,3,9,66.7%,7m
2203,3,llllllllllll,3806,0,1,0,1,100.0%,9m
2204,2,[중금속중독자]AKG,3805,1484,358,356,714,50.1%,6m
2204,3,IIIIIIIIIIII,3805,530,22,14,36,61.1%,4m
2204,2,[XYFANS]ADESTINY,3805,469,19,24,43,44.2%,9m
2204,3,[DDLC]Sayori,3805,182,7,10,17,41.2%,9m
2204,3,[KT롤스터]jjk,3805,94,4,5,9,44.4%,4m
2204,3,JollyPosh,3805,0,0,1,1,0.0%,4m
2210,2,AcE,3804,98,3,11,14,21.4%,6m
2211,3,十里山路不換肩,3803,887,57,58,115,49.6%,7m
2211,2,[청초]ALCA,3803,693,45,46,91,49.5%,15m
2211,3,따거,3803,513,43,43,86,50.0%,8m
2211,2,阿寶,3803,166,6,17,23,26.1%,15m
2211,2,[DMN]NotDreaM,3803,140,4,8,12,33.3%,15m
2211,3,[Ato]정대희수제자,3803,0,1,0,1,100.0%,6m
2211,3,IGuNoVoDaMI,3803,0,1,0,1,100.0%,7m
2211,3,llllllllllll,3803,0,0,2,2,0.0%,5m
2219,3,[NGameS]SoulKey,3802,0,1,0,1,100.0%,15m
2220,3,소리없는유오성,3801,647,101,97,198,51.0%,6m
2220,2,Hunter,3801,1332,53,51,104,51.0%,8m
2220,2,Luna,3801,512,16,31,47,34.0%,9m
2220,3,NeoModern,3801,86,4,1,5,80.0%,6m
2220,3,[시럽]아리아나동그란데,3801,0,1,0,1,100.0%,4m
2225,1,paquiao,3799,46,2,6,8,25.0%,3m
2225,3,[TeamGP]Bubble,3799,30,1,5,6,16.7%,15m
2225,3,[89e]Gracewisdom,3799,0,0,1,1,0.0%,3m
2225,3,[테유카]데모,3799,0,0,4,4,0.0%,7m
2229,2,lIlIlIlIlI,3798,1098,122,116,238,51.3%,6m
2230,2,[MDC]IIIIIIIIIIII,3797,891,58,59,117,49.6%,6m
2230,3,cCane,3797,871,48,37,85,56.5%,7m
2230,3,가가가,3797,693,25,22,47,53.2%,6m
2230,3,松浦果南,3797,0,1,0,1,100.0%,9m
2230,3,AvalanChe,3797,0,0,1,1,0.0%,4m
2235,3,[어윤수님개쩜]HwanSangs,3796,1524,73,58,131,55.7%,6m
2235,2,[레인저]blackhabits,3796,953,43,53,96,44.8%,6m
2235,3,windfish,3796,183,26,23,49,53.1%,9m
2235,3,tEayEon,3796,30,2,2,4,50.0%,15m
2239,3,[SGlory]羅霸的領域,3795,1554,249,248,497,50.1%,6m
2239,3,spotlight,3795,524,21,13,34,61.8%,4m
2239,3,스투촞망겜,3795,416,17,16,33,51.5%,6m
2239,3,iamexit,3795,146,8,1,9,88.9%,5m
2239,3,갓겜탐지기,3795,0,0,2,2,0.0%,4m
2244,2,[이터널]김첨지,3794,1555,352,321,673,52.3%,9m
2244,2,[NGameS]soO,3794,840,29,36,65,44.6%,4m
2246,3,Zello,3793,580,21,23,44,47.7%,15m
2246,3,코리안적토마,3793,114,6,0,6,100.0%,5m
2246,3,[돌변쩔좀]공허폭격기성애자,3793,58,2,2,4,50.0%,8m
2249,2,INovation,3791,1518,99,111,210,47.1%,9m
2249,3,lIlIlllIIlIl,3791,0,1,1,2,50.0%,7m
2251,2,젝키라웃,3790,1474,212,239,451,47.0%,15m
2251,3,VinStorM,3790,347,28,21,49,57.1%,5m
2251,3,SFO,3790,293,12,2,14,85.7%,8m
2254,3,HelloKitty,3789,342,17,4,21,81.0%,9m
2254,2,Isaac,3789,0,1,0,1,100.0%,8m
2254,3,BsWtY,3789,0,0,1,1,0.0%,8m
2257,3,Castillo,3788,442,17,13,30,56.7%,8m
2257,3,불곰기동타격대,3788,0,0,2,2,0.0%,7m
2259,3,Janna,3787,833,59,23,82,72.0%,7m
2259,3,rai,3787,752,36,37,73,49.3%,8m
2259,2,lIIIIIllll,3787,492,17,25,42,40.5%,3m
2259,3,헤세드연이,3787,214,13,14,27,48.1%,4m
2259,2,[SWlFT]INCeption,3787,0,0,3,3,0.0%,8m
2264,2,[快樂玩家]傲氣貝果,3786,1410,49,59,108,45.4%,9m
2265,3,[TalenT]iiiiiiii,3785,1482,123,130,253,48.6%,4m
2265,3,[어윤수님개쩜]잉여포격기,3785,721,34,20,54,63.0%,9m
2265,3,[GIS]ReCall,3785,662,28,16,44,63.6%,7m
2265,2,뎀프시롤,3785,519,25,31,56,44.6%,15m
2265,3,KIMCHENER,3785,241,12,3,15,80.0%,4m
2265,3,[영앤리치]VOSSEN,3785,30,1,6,7,14.3%,4m
2271,2,Acromancer,3784,597,45,48,93,48.4%,9m
2272,1,HuatAh,3783,345,15,6,21,71.4%,6m
2272,3,[무리무리팸]마무리무리하네,3783,194,8,7,15,53.3%,9m
2272,3,[XYFANS]llllllllllll,3783,0,1,0,1,100.0%,15m
2275,3,[하연]MarineKing,3782,456,28,24,52,53.8%,4m
2275,3,[중앙대학교]땅거미지뢰로봇,3782,0,1,0,1,100.0%,5m
2277,3,llllllllllll,3781,1255,52,37,89,58.4%,15m
2277,3,철만드는사람,3781,280,11,12,23,47.8%,7m
2277,3,풀메탈패닉,3781,86,3,2,5,60.0%,4m
2280,3,llllllllllll,3780,262,12,4,16,75.0%,15m
2280,3,로온,3780,30,1,6,7,14.3%,4m
2280,3,[생명줄]NONAME,3780,0,0,1,1,0.0%,4m
2283,3,Arrow,3778,352,13,11,24,54.2%,8m
2283,3,기부천수,3778,60,4,4,8,50.0%,4m
2283,3,[犽天組]骚浪贱,3778,0,1,3,4,25.0%,7m
2286,3,LAZY,3777,662,24,29,53,45.3%,9m
2286,2,[지비클]고집불통울트라,3777,446,17,20,37,45.9%,4m
2286,3,Redeemer,3777,214,7,10,17,41.2%,4m
2286,3,[랜덤한테왜짐]integralidi,3777,0,1,0,1,100.0%,15m
2290,3,상너무님,3776,708,26,29,55,47.3%,4m
2290,2,민주,3776,271,12,3,15,80.0%,8m
2290,3,[인투더]IntoTheBLINK,3776,107,8,7,15,53.3%,15m
2293,3,타우린,3774,202,7,7,14,50.0%,8m
2293,3,Very,3774,0,1,0,1,100.0%,7m
2295,3,스투똥망겜,3773,870,36,21,57,63.2%,7m
2295,3,Povidone,3773,137,4,2,6,66.7%,5m
2295,3,llIllIllIIIl,3773,0,1,0,1,100.0%,8m
2298,3,JoHnnY,3772,0,1,1,2,50.0%,9m
2298,3,IIIIIo,3772,0,1,2,3,33.3%,8m
2300,3,VanDH,3771,776,28,29,57,49.1%,4m
2300,3,Fabutaste,3771,216,8,6,14,57.1%,15m
2302,3,Novice,3770,1176,47,44,91,51.6%,5m
2302,3,허접,3770,666,43,36,79,54.4%,8m
2304,3,Silmarillion,3769,441,40,21,61,65.6%,3m
2304,3,입에다샬케,3769,278,11,7,18,61.1%,6m
2304,3,도깨비,3769,0,0,2,2,0.0%,8m
2304,3,CupitO,3769,0,0,2,2,0.0%,6m
2308,2,台灣是個國家,3768,1398,333,329,662,50.3%,4m
2308,3,양민학살,3768,1571,105,83,188,55.9%,8m
2308,3,RociNante,3768,0,0,1,1,0.0%,4m
2311,3,magicY,3767,312,21,15,36,58.3%,6m
2311,3,cryhall,3767,416,15,18,33,45.5%,4m
2311,3,베지트,3767,86,3,1,4,75.0%,7m
2311,3,[혐산당]Choisam,3767,60,3,3,6,50.0%,8m
2311,3,BrowN,3767,0,1,0,1,100.0%,15m
2311,3,VIVA,3767,0,0,1,1,0.0%,8m
2317,3,IlIlIlIlIlIl,3766,400,14,19,33,42.4%,8m
2317,3,Serum,3766,143,8,0,8,100.0%,6m
2317,3,MASHIMARO,3766,62,2,9,11,18.2%,9m
2317,3,[GIS]Lon,3766,0,1,1,2,50.0%,15m
2317,3,[2su]패드리퍼조,3766,0,0,1,1,0.0%,15m
2322,3,Dinktian,3765,666,26,19,45,57.8%,7m
2322,3,[小妖怪]含羞草,3765,514,19,13,32,59.4%,8m
2322,3,앙기무띠,3765,371,18,6,24,75.0%,6m
2322,3,Libertas,3765,0,0,2,2,0.0%,5m
2322,3,황은비,3765,0,0,5,5,0.0%,7m
2327,3,Arondight,3764,1405,59,64,123,48.0%,7m
2327,3,고기사줘,3764,470,53,33,86,61.6%,8m
2327,3,띵동,3764,985,42,29,71,59.2%,7m
2327,3,UED,3764,0,1,4,5,20.0%,5m
2331,3,IIIlllIIllIl,3763,1442,70,69,139,50.4%,7m
2331,3,cyzzpant,3763,422,24,20,44,54.5%,7m
2331,3,IIIIIIIIII,3763,198,7,11,18,38.9%,5m
2331,3,[CIM]HyoJa,3763,114,4,4,8,50.0%,15m
2331,3,DeSTrOYeR,3763,114,4,7,11,36.4%,5m
2331,2,[시발병신토스]SaranG,3763,64,2,19,21,9.5%,3m
2331,3,건설로봇준비완료,3763,0,0,2,2,0.0%,5m
2338,3,[예쁜김다미]이쁘다미,3762,1445,144,114,258,55.8%,5m
2339,3,[Mruly]바코드,3761,914,57,46,103,55.3%,3m
2339,3,궤적,3761,608,29,14,43,67.4%,5m
2339,1,IIIIIIIIIIII,3761,0,5,0,5,100.0%,48m
2339,3,[ODI]Pacom,3761,0,0,1,1,0.0%,5m
2339,3,Money,3761,0,0,1,1,0.0%,9m
2344,1,IIIIIIIIIIII,3760,1624,273,303,576,47.4%,5m
2344,3,AcchanSiriuS,3760,1403,82,81,163,50.3%,8m
2344,3,Conductor,3760,182,7,13,20,35.0%,5m
2347,3,YSJ,3759,429,20,8,28,71.4%,3m
2347,3,ChoiJy,3759,281,15,7,22,68.2%,4m
2347,1,Terran,3759,299,14,6,20,70.0%,5m
2347,3,[NGameS]오두리,3759,0,0,1,1,0.0%,3m
2351,3,llllllllllll,3758,64,2,11,13,15.4%,9m
2352,2,[TalenT]냄새나,3757,1491,183,180,363,50.4%,4m
2352,3,[ELS]스린이입니다,3757,738,53,42,95,55.8%,4m
2352,3,samchoimusic,3757,662,29,24,53,54.7%,6m
2352,3,[무한오영종]chovy,3757,370,15,9,24,62.5%,15m
2352,3,休闲者,3757,97,2,2,4,50.0%,3m
2357,2,RAMBO,3756,790,41,45,86,47.7%,5m
2357,3,단테,3756,136,8,0,8,100.0%,8m
2357,1,[어둠의사신단]어둠의검신,3756,0,3,2,5,60.0%,48m
2360,3,POTKH,3755,1393,55,52,107,51.4%,6m
2360,3,스린이테란,3755,244,9,12,21,42.9%,8m
2360,3,[TpW]尷尬了,3755,30,1,5,6,16.7%,8m
2360,3,[비트]llllllllllll,3755,0,0,1,1,0.0%,6m
2364,3,InverseChoco,3754,918,60,59,119,50.4%,6m
2364,3,천아,3754,0,0,1,1,0.0%,4m
2364,3,[GITS]MaBaO,3754,0,0,2,2,0.0%,8m
2367,3,싸만코,3753,810,28,35,63,44.4%,7m
2368,3,Commander,3752,1528,323,321,644,50.2%,15m
2368,3,[일반인고수]Kay,3752,60,3,3,6,50.0%,9m
2370,3,IIIIIIIIIIII,3751,1108,43,39,82,52.4%,15m
2370,2,메기맨,3751,44,1,1,2,50.0%,3m
2372,2,백두무궁,3750,1486,178,183,361,49.3%,3m
2372,3,나루실리,3750,1388,52,49,101,51.5%,8m
2372,3,AweSome,3750,1006,51,29,80,63.8%,9m
2375,2,문재인,3749,1590,195,195,390,50.0%,4m
2375,3,솜솜이,3749,1554,172,164,336,51.2%,15m
2375,3,llllllllllll,3749,118,4,7,11,36.4%,15m
2375,3,[Ilyes]BroCraftt,3749,30,2,0,2,100.0%,8m
2375,3,lllllllllll,3749,58,2,2,4,50.0%,8m
2375,3,[ProTT]정종현,3749,30,2,5,7,28.6%,8m
2381,3,가을보리,3748,435,21,4,25,84.0%,5m
2381,3,llllllllllll,3748,278,14,4,18,77.8%,5m
2381,3,IlIllIllIlIl,3748,310,11,12,23,47.8%,8m
2381,3,캡틴,3748,300,10,9,19,52.6%,8m
2381,3,[sc2mc]SULFOUR,3748,168,5,1,6,83.3%,4m
2381,3,[PIMBAS]Novel,3748,30,2,3,5,40.0%,7m
2387,3,[나가자]llllllllllll,3747,166,7,3,10,70.0%,6m
2387,3,BRO,3747,86,4,4,8,50.0%,9m
2389,3,상무지구,3746,1597,69,51,120,57.5%,15m
2389,2,[도리]Azure,3746,506,18,26,44,40.9%,4m
2389,3,Imavor,3746,166,7,2,9,77.8%,6m
2389,3,꾸러기닌자토리,3746,30,1,2,3,33.3%,8m
2393,2,Plain,3745,1468,129,143,272,47.4%,3m
2393,1,IIIIIIIIIIII,3745,1492,84,121,205,41.0%,9m
2393,2,YES,3745,1196,44,49,93,47.3%,3m
2393,3,[BH]希兒芙樂艾,3745,547,38,41,79,48.1%,7m
2393,3,ahfatlee,3745,449,30,29,59,50.8%,7m
2393,3,Lune,3745,638,23,24,47,48.9%,3m
2393,3,저그야캐양,3745,116,4,3,7,57.1%,5m
2400,3,AgentPancake,3744,360,42,31,73,57.5%,3m
2400,3,letria,3744,60,6,3,9,66.7%,7m
2402,2,Logick,3743,735,145,151,296,49.0%,7m
2402,2,Predator,3743,1033,43,49,92,46.7%,6m
2402,3,[얼라이브]히읗히읗,3743,850,37,25,62,59.7%,5m
2402,3,clemfans,3743,936,36,34,70,51.4%,7m
2402,3,老輝仔,3743,30,1,4,5,20.0%,9m
2402,3,강아지,3743,0,0,1,1,0.0%,7m
2402,3,LMC,3743,0,0,1,1,0.0%,5m
2409,3,용스터,3742,962,91,79,170,53.5%,9m
2409,3,saber,3742,0,1,0,1,100.0%,4m
2411,3,kansan,3741,1084,57,56,113,50.4%,15m
2411,2,llllllllIlll,3741,258,13,13,26,50.0%,3m
2411,3,Jupiter,3741,143,4,1,5,80.0%,7m
2411,3,겨맘미,3741,58,3,0,3,100.0%,9m
2411,3,LostStars,3741,86,3,1,4,75.0%,7m
2416,3,도토리,3740,256,9,9,18,50.0%,16m
2416,3,llllllllllll,3740,0,2,4,6,33.3%,4m
2416,3,[ALeveL]ShiningStars,3740,0,1,1,2,50.0%,6m
2416,1,[EGTL]뺑이,3740,0,0,1,1,0.0%,48m
2420,3,뉴카폭,3739,30,2,1,3,66.7%,6m
2420,3,CastorPollux,3739,30,1,5,6,16.7%,8m
2422,2,세잎클로버,3738,1540,399,401,800,49.9%,7m
2422,3,[Master]천사의날개,3738,1402,121,117,238,50.8%,7m
2422,3,IIIIIIIIIIII,3738,224,8,6,14,57.1%,9m
2422,3,Zero,3738,0,1,2,3,33.3%,8m
2426,3,IcaRuS,3737,330,13,6,19,68.4%,9m
2426,3,[AeroR]StormShower,3737,0,0,2,2,0.0%,3m
2428,3,[비트]파브레가스,3736,660,25,24,49,51.0%,8m
2429,3,SKungK,3735,1408,98,83,181,54.1%,7m
2429,3,LastMarine,3735,181,9,1,10,90.0%,3m
2429,3,[플토쌉극혐]lIlIlIl,3735,226,9,15,24,37.5%,6m
2429,3,IIIIllllIIll,3735,0,0,1,1,0.0%,16m
2433,3,로멘티시스트,3734,1411,66,61,127,52.0%,9m
2433,3,비둘기,3734,1497,54,62,116,46.6%,7m
2433,3,[마스터테란]lIIIIlIIII,3734,485,31,33,64,48.4%,7m
2433,3,Flash,3734,358,13,13,26,50.0%,3m
2433,3,Artifact,3734,30,1,1,2,50.0%,7m
2438,3,zhuderkov,3733,688,27,29,56,48.2%,8m
2438,3,[KPG]SeleiXi,3733,30,1,1,2,50.0%,6m
2440,3,Catty,3732,199,8,3,11,72.7%,15m
2440,3,나랑께,3732,58,2,8,10,20.0%,6m
2440,3,백령해병,3732,30,1,2,3,33.3%,9m
2440,3,테란정예부대,3732,0,0,1,1,0.0%,7m
2440,3,yOunG,3732,0,0,1,1,0.0%,5m
2445,3,lIlIlIlIlIlI,3731,900,118,107,225,52.4%,5m
2445,3,[래더납치범]Kakaru,3731,367,18,6,24,75.0%,9m
2445,3,Dust,3731,30,2,2,4,50.0%,9m
2445,3,Kamit,3731,60,2,5,7,28.6%,3m
2445,3,[노잼]보라노아바,3731,0,0,1,1,0.0%,9m
2450,3,okidoki,3730,1569,250,249,499,50.1%,9m
2450,2,AvglE,3730,427,17,21,38,44.7%,6m
2450,3,LLLLLLLLLLLL,3730,30,1,2,3,33.3%,15m
2450,3,llllIIIIllII,3730,0,0,1,1,0.0%,15m
2454,2,[IWYDI]janyrWYD,3729,703,65,63,128,50.8%,3m
2454,3,fastr,3729,403,15,11,26,57.7%,5m
2456,3,카라,3728,1559,255,253,508,50.2%,8m
2456,3,[참이슬]demonic,3728,1485,238,240,478,49.8%,7m
2456,3,후라이,3728,454,16,20,36,44.4%,15m
2456,3,Glow,3728,328,11,14,25,44.0%,5m
2456,3,빠에야,3728,122,3,2,5,60.0%,4m
2461,3,mephosto,3726,516,36,32,68,52.9%,8m
2461,1,라온제나,3726,256,14,4,18,77.8%,15m
2461,3,llllllllllll,3726,0,1,0,1,100.0%,9m
2464,2,[보돌]Woo,3725,1491,224,236,460,48.7%,3m
2464,3,DKinSC,3725,1429,211,208,419,50.4%,8m
2464,2,[S0fT]노라드,3725,1516,106,118,224,47.3%,7m
2464,3,[N46]西野七濑一生推,3725,482,41,40,81,50.6%,8m
2464,3,연두부샐러드,3725,0,0,1,1,0.0%,5m
2469,3,SherifofAiur,3724,0,5,0,5,100.0%,3m
2469,3,BEJBEJ,3724,96,1,1,2,50.0%,9m
2471,3,VTNaga,3723,277,15,20,35,42.9%,7m
2471,3,llllllllllll,3723,60,2,2,4,50.0%,16m
2471,3,[모징]해천솔,3723,0,1,0,1,100.0%,4m
2474,3,lisassssssss,3722,120,5,6,11,45.5%,7m
2474,3,Pocketmon,3722,145,3,4,7,42.9%,9m
2474,2,IIIIIIIIIIII,3722,102,3,5,8,37.5%,7m
2474,3,삭풍스탈,3722,30,1,4,5,20.0%,3m
2478,3,glofo,3721,1280,259,238,497,52.1%,8m
2478,3,[대테란자치령]llllllllllll,3721,398,14,16,30,46.7%,9m
2478,3,[NsP]AseSino,3721,74,13,12,25,52.0%,4m
2478,3,TheNemesis,3721,0,1,2,3,33.3%,7m
2478,3,미역,3721,0,0,1,1,0.0%,9m
2483,3,토스최고,3720,362,15,14,29,51.7%,6m
2483,3,무작위나가주거,3720,332,14,11,25,56.0%,4m
2483,3,MarineKing,3720,218,8,8,16,50.0%,9m
2483,3,유령,3720,60,5,3,8,62.5%,6m
2483,3,[문복신]Angolmois,3720,62,2,11,13,15.4%,9m
2483,3,홍파,3720,30,1,1,2,50.0%,7m
2489,3,[NTUeS]yoyo,3719,1503,188,189,377,49.9%,5m
2489,3,Basketball,3719,496,18,19,37,48.6%,9m
2489,2,ZERonimO,3719,201,8,24,32,25.0%,4m
2489,3,Liverpool,3719,30,2,0,2,100.0%,3m
2489,3,[KOSEAL]이근대위,3719,0,1,0,1,100.0%,7m
2489,3,방글땡구,3719,0,1,1,2,50.0%,5m
2489,3,월희,3719,0,1,4,5,20.0%,9m
2489,3,[조누]조선누룽지,3719,0,0,1,1,0.0%,7m
2497,3,DDOS,3718,1118,52,42,94,55.3%,7m
2497,3,speaknow,3718,486,18,18,36,50.0%,16m
2497,3,costheta,3718,198,7,6,13,53.8%,7m
2497,3,[SofT]프로브,3718,30,2,1,3,66.7%,3m
2497,1,herb,3718,0,1,0,1,100.0%,48m
2497,3,IIIIIIIII,3718,0,0,1,1,0.0%,6m
2503,3,IIIIIIIIIIII,3717,206,8,8,16,50.0%,8m
2503,3,[快樂玩家]Phil,3717,118,4,4,8,50.0%,7m
2503,3,FortunE,3717,58,3,0,3,100.0%,7m
2503,3,JAGUAR,3717,0,0,1,1,0.0%,15m
2507,3,STANLELIU,3716,995,253,228,481,52.6%,7m
2507,3,마르코,3716,1565,209,191,400,52.2%,3m
2507,3,[sc2mc]김리우,3716,523,23,16,39,59.0%,7m
2507,3,DoToRi,3716,92,3,6,9,33.3%,7m
2507,1,Hyeri,3716,0,1,0,1,100.0%,48m
2507,3,llllllllll,3716,0,0,1,1,0.0%,9m
2513,3,개비둘기,3715,58,2,4,6,33.3%,5m
2514,3,아무것도하기싫음,3714,1499,125,130,255,49.0%,5m
2514,3,빠루망치,3714,1016,64,63,127,50.4%,7m
2514,3,여친있상준,3714,354,18,15,33,54.5%,9m
2514,1,BLEE,3714,175,4,3,7,57.1%,15m
2514,3,[SofT]ChoNo,3714,0,1,0,1,100.0%,8m
2514,3,[정수수집완료]llllllllllll,3714,0,0,1,1,0.0%,9m
2520,3,ASARIKADA,3713,344,13,17,30,43.3%,10m
2520,3,RyanKim,3713,97,2,0,2,100.0%,5m
2520,3,파워마린,3713,0,0,1,1,0.0%,15m
2523,2,[STARCW]kkiggu,3712,831,48,48,96,50.0%,4m
2523,3,IIII,3712,801,30,36,66,45.5%,6m
2523,1,ZOD,3712,290,15,4,19,78.9%,4m
2523,3,[INHA]SniPer,3712,86,3,3,6,50.0%,6m
2523,3,gxgih,3712,60,2,5,7,28.6%,6m
2523,3,MooNami,3712,0,1,0,1,100.0%,9m
2523,3,LonGiNuS,3712,30,1,1,2,50.0%,7m
2523,3,꺼꺼꺼꺼꺼껑,3712,0,1,4,5,20.0%,6m
2523,3,트코얌,3712,0,1,6,7,14.3%,16m
2532,3,민소리,3711,304,10,16,26,38.5%,5m
2532,3,[투막빌런협회]군단의심장,3711,0,0,1,1,0.0%,5m
2532,3,Affha,3711,0,0,1,1,0.0%,15m
2532,3,llllllllllll,3711,0,0,1,1,0.0%,8m
2532,3,[CIM]Azshara,3711,0,0,2,2,0.0%,7m
2537,3,[쇼부충]IIIIIIIIII,3710,481,22,15,37,59.5%,4m
2537,3,CrazyArms,3710,295,14,5,19,73.7%,15m
2537,3,[스카이파이터]fantasy,3710,322,12,13,25,48.0%,7m
2537,3,DoMsn,3710,30,2,0,2,100.0%,9m
2537,3,Jun,3710,30,1,3,4,25.0%,5m
2537,3,llllllllll,3710,0,0,1,1,0.0%,3m
2537,3,은지누나팬,3710,0,0,1,1,0.0%,9m
2544,3,저그,3709,1529,218,207,425,51.3%,6m
2544,2,kkkkkkkkk,3709,1076,99,108,207,47.8%,5m
2544,3,llllllllllll,3709,630,27,18,45,60.0%,3m
2544,3,Casey,3709,756,27,28,55,49.1%,9m
2544,2,너를꿈꾸며,3709,179,10,3,13,76.9%,7m
2544,3,[Lotuz]병원냄새,3709,30,1,7,8,12.5%,5m
2544,3,[STARK]rifle,3709,0,0,1,1,0.0%,9m
2551,3,Gate,3708,780,30,28,58,51.7%,6m
2551,3,[환상향]Mush,3708,145,8,4,12,66.7%,8m
2551,3,[異界的檢察官]白癡中的職業沙包,3708,0,1,0,1,100.0%,4m
2551,3,라이트닝퓨리,3708,0,1,1,2,50.0%,5m
2555,3,[오직]ShyBoy,3707,1392,58,44,102,56.9%,9m
2555,3,Medivac,3707,400,13,20,33,39.4%,5m
2555,3,llllllllllll,3707,119,7,0,7,100.0%,7m
2555,3,Jacky,3707,148,6,7,13,46.2%,8m
2555,3,히드라리스크,3707,30,1,3,4,25.0%,4m
2555,3,[살인피구]공구,3707,0,0,1,1,0.0%,5m
2555,3,[한타왕]Adol,3707,0,0,2,2,0.0%,3m
2562,2,pczergrocks,3706,1467,343,347,690,49.7%,6m
2562,3,llllllllll,3706,1328,51,48,99,51.5%,4m
2562,3,자유의날개,3706,834,35,24,59,59.3%,7m
2562,3,화팔,3706,0,0,1,1,0.0%,7m
2566,3,DDu,3705,1554,221,210,431,51.3%,8m
2566,3,[EPH]유라에하,3705,315,14,10,24,58.3%,4m
2566,3,GoGoMarine,3705,120,4,8,12,33.3%,5m
2566,3,[자폐아]민젖,3705,30,2,3,5,40.0%,7m
2570,3,[ELS]llllllllllll,3704,1008,39,35,74,52.7%,6m
2570,3,응아,3704,0,0,1,1,0.0%,3m
2572,3,[NGameS]진네,3703,798,78,62,140,55.7%,6m
2572,3,awu,3703,663,29,16,45,64.4%,9m
2572,3,LEOPARD,3703,30,2,1,3,66.7%,5m
2572,3,[625nox]크랭플갱,3703,0,0,1,1,0.0%,6m
2576,3,HyperLibra,3702,1506,131,133,264,49.6%,15m
2576,3,[친클]EIOrZr,3702,992,41,39,80,51.2%,9m
2576,1,showserral,3702,119,7,0,7,100.0%,47m
2576,3,[WDY]Merry,3702,218,7,17,24,29.2%,6m
2576,2,Omyo,3702,156,5,4,9,55.6%,6m
2576,3,Rain,3702,98,3,13,16,18.8%,5m
2576,3,SKETCH,3702,0,0,1,1,0.0%,9m
2583,3,llllllllllll,3701,689,196,185,381,51.4%,5m
2583,3,[광전사하키]목돌아간흑두루미,3701,1506,103,94,197,52.3%,15m
2583,2,분가분가차차차,3701,903,74,63,137,54.0%,3m
2583,3,Reppageki,3701,689,28,16,44,63.6%,8m
2583,3,Cosmos,3701,58,3,0,3,100.0%,5m
2583,3,이수빈넌내꺼야,3701,0,1,0,1,100.0%,7m
2583,3,EnForcer,3701,0,1,0,1,100.0%,3m
2583,3,IIIIIIIIII,3701,0,0,1,1,0.0%,5m
2591,3,IIIIIIIIII,3700,1118,192,152,344,55.8%,9m
2592,3,MONKEYDLUFFY,3699,777,302,298,600,50.3%,4m
2592,3,whiteSUS,3699,869,41,34,75,54.7%,8m
2592,3,[ELS]MajesticMatt,3699,30,2,0,2,100.0%,9m
2592,3,PANIE,3699,0,0,1,1,0.0%,6m
2596,3,[깨령]가인,3698,377,14,11,25,56.0%,6m
2597,3,allshutout,3697,1471,474,472,946,50.1%,8m
2597,2,[게Yee밴d]흑인래퍼간디,3697,929,129,122,251,51.4%,5m
2597,3,imcrazy,3697,1438,91,68,159,57.2%,7m
2597,3,DoubleImpact,3697,1304,51,51,102,50.0%,9m
2597,3,RlZZ,3697,757,33,33,66,50.0%,8m
2597,3,조땡,3697,469,18,14,32,56.2%,9m
2597,2,AgCl,3697,229,5,6,11,45.5%,7m
2597,3,Chobo,3697,0,1,1,2,50.0%,8m
2597,3,[ash]Jinsso,3697,0,0,3,3,0.0%,10m
2606,3,llllllllllll,3696,1303,98,71,169,58.0%,9m
2606,3,YoungChan,3696,685,28,16,44,63.6%,10m
2606,3,[NsP]MarineWave,3696,114,5,2,7,71.4%,5m
2606,3,[남달라]남달라,3696,150,4,3,7,57.1%,5m
2606,2,오크와엘프,3696,44,1,1,2,50.0%,5m
2606,3,[NaGne]통나무,3696,0,0,1,1,0.0%,6m
2606,3,[블롹풰퍼]유키노시타유키노,3696,0,0,1,1,0.0%,5m
2613,2,안녕맨,3695,1498,150,166,316,47.5%,10m
2613,2,난나일뿐이야,3695,1286,72,83,155,46.5%,4m
2613,3,[무력개입]Nirvana,3695,260,10,18,28,35.7%,4m
2613,3,[래더납치범]flash,3695,0,0,1,1,0.0%,3m
2617,3,戰神,3694,1000,40,35,75,53.3%,3m
2617,3,너문제인성있어,3694,740,29,31,60,48.3%,3m
2617,3,[Dopen]swifter,3694,142,6,4,10,60.0%,3m
2617,3,国际巨星胖头鱼,3694,0,5,0,5,100.0%,9m
2617,3,vicO,3694,30,2,1,3,66.7%,7m
2617,3,한곡에오백원,3694,0,0,3,3,0.0%,9m
2623,2,chokdeemak,3693,1549,374,383,757,49.4%,6m
2624,3,[GIS]ReCall,3692,485,25,20,45,55.6%,5m
2624,3,바늘구멍,3692,220,8,5,13,61.5%,15m
2624,3,후라이드,3692,230,8,12,20,40.0%,5m
2624,3,DaffyDuck,3692,86,6,5,11,54.5%,5m
2624,3,llllllllllll,3692,174,6,9,15,40.0%,8m
2624,3,[망치]망치행님,3692,0,1,0,1,100.0%,7m
2624,3,[Fu]Neptune,3692,0,0,2,2,0.0%,4m
2631,3,Glitch,3691,437,21,9,30,70.0%,6m
2631,3,[TwoS]IIIIIIIIIIII,3691,544,18,31,49,36.7%,4m
2631,3,LAMY,3691,306,10,17,27,37.0%,15m
2631,3,Flash,3691,86,3,1,4,75.0%,5m
2631,3,[GITS]小周,3691,0,1,0,1,100.0%,15m
2636,3,IIIIIIIIIIII,3690,1552,146,135,281,52.0%,15m
2636,2,오투,3690,900,40,36,76,52.6%,6m
2636,1,llllllllllll,3690,0,2,0,2,100.0%,47m
2636,3,[이터널]바퀴왕김백희,3690,0,1,0,1,100.0%,5m
2636,3,Darksweem,3690,0,0,2,2,0.0%,5m
2641,3,NoApM,3689,30,1,2,3,33.3%,4m
2641,3,llllllllllll,3689,0,0,1,1,0.0%,5m
2643,3,사건의배후,3688,0,0,1,1,0.0%,9m
2644,2,[Patek]bamboo,3687,1496,335,346,681,49.2%,15m
2644,3,ZeroMarine,3687,168,6,5,11,54.5%,10m
2644,3,짐승토스다망,3687,0,1,0,1,100.0%,4m
2647,1,우와앙,3686,297,13,8,21,61.9%,4m
2648,3,연어판다,3685,1419,66,70,136,48.5%,8m
2648,3,뉴비,3685,1002,38,39,77,49.4%,8m
2650,3,스타장인,3684,116,5,8,13,38.5%,9m
2650,3,Jean,3684,97,4,5,9,44.4%,16m
2650,3,조떄징,3684,0,0,1,1,0.0%,16m
2653,3,강동원,3683,1472,139,119,258,53.9%,9m
2653,3,SilentHell,3683,416,19,10,29,65.5%,4m
2653,3,헤헤헤,3683,444,17,19,36,47.2%,9m
2656,1,개떡상,3682,298,15,6,21,71.4%,6m
2656,3,토리,3682,30,1,2,3,33.3%,15m
2658,3,YOLO,3681,342,123,123,246,50.0%,8m
2658,3,Inovation,3681,478,20,12,32,62.5%,5m
2658,3,[봉갤갤창]진리는나의빛,3681,404,15,11,26,57.7%,5m
2658,3,lllllllllII,3681,271,9,7,16,56.2%,5m
2658,3,Nemo,3681,272,9,17,26,34.6%,9m
2658,3,쿠쿠루쿠쿠,3681,0,5,0,5,100.0%,5m
2658,3,[FLGMs]SmilingPig,3681,96,4,11,15,26.7%,5m
2665,3,[Milles]Frank,3680,462,20,22,42,47.6%,6m
2665,3,HeeSo,3680,446,18,6,24,75.0%,9m
2665,3,[ELS]골드,3680,62,3,8,11,27.3%,8m
2665,3,pulchra,3680,60,2,2,4,50.0%,7m
2665,3,덤벼라세상아,3680,0,1,0,1,100.0%,5m
2670,3,Sarcasm,3679,1157,59,62,121,48.8%,6m
2670,3,페페,3679,142,6,5,11,54.5%,9m
2670,3,llllllllllll,3679,114,4,2,6,66.7%,9m
2670,3,죄송합니다,3679,0,1,0,1,100.0%,3m
2670,3,SOlar,3679,30,1,2,3,33.3%,3m
2675,3,二少,3678,1568,221,213,434,50.9%,15m
2675,3,lllllllllllI,3678,1437,161,148,309,52.1%,8m
2675,3,동키호테,3678,1410,119,117,236,50.4%,8m
2675,3,Tyranids,3678,140,6,0,6,100.0%,7m
2675,3,skywarpcraft,3678,62,2,6,8,25.0%,16m
2675,3,IlIlIlIlIlIl,3678,0,1,0,1,100.0%,5m
2681,3,鋒兄,3677,1526,140,142,282,49.6%,8m
2681,3,[loll]olollozizira,3677,0,1,0,1,100.0%,8m
2681,3,비누맛사탕,3677,0,1,0,1,100.0%,6m
2681,3,[ANGG]크롱,3677,0,0,1,1,0.0%,3m
2685,3,[新体操部]BadGirl,3676,434,19,9,28,67.9%,4m
2685,3,Hack,3676,30,2,0,2,100.0%,5m
2685,3,Witcher,3676,30,2,0,2,100.0%,10m
2685,3,Brain,3676,0,0,1,1,0.0%,9m
2689,3,yangyang,3675,1504,203,203,406,50.0%,4m
2689,3,sungmin,3675,311,11,5,16,68.8%,15m
2689,3,安多彬,3675,30,2,1,3,66.7%,8m
2689,3,哥的下面是巨龍,3675,0,0,1,1,0.0%,9m
2693,2,[IWYDI]Flandre,3674,1479,160,172,332,48.2%,6m
2693,3,[Vetera]Zoterprince,3674,514,20,23,43,46.5%,4m
2693,3,메카닉잘하고싶다,3674,256,10,6,16,62.5%,8m
2693,3,SalmoSa,3674,0,0,1,1,0.0%,9m
2693,3,전차,3674,0,0,1,1,0.0%,7m
2698,3,[연세조]carmankass,3673,38,4,10,14,28.6%,7m
2698,3,[gssrt]Ipheion,3673,30,2,5,7,28.6%,9m
2700,2,darkneo,3672,1583,270,282,552,48.9%,10m
2700,3,[Yisc]다현이,3672,1576,137,120,257,53.3%,7m
2700,3,[GIS]花火,3672,1314,96,81,177,54.2%,16m
2700,3,내이름은김뿌잉,3672,590,50,46,96,52.1%,8m
2700,3,Evilit,3672,250,10,5,15,66.7%,16m
2700,3,llll,3672,190,6,2,8,75.0%,3m
2706,3,Jaesung,3671,1485,66,65,131,50.4%,5m
2706,3,eklee,3671,88,3,4,7,42.9%,9m
2706,3,테란살육도살머신,3671,62,2,8,10,20.0%,10m
2706,3,[Heaven]Rampanda,3671,0,0,1,1,0.0%,5m
2710,3,llllllllllll,3670,792,51,38,89,57.3%,6m
2710,3,[國本]BattleCruser,3670,977,41,33,74,55.4%,9m
2710,3,CycleBreaker,3670,145,3,3,6,50.0%,3m
2710,3,[神之一手]Faker,3670,0,1,0,1,100.0%,8m
2714,3,ARES,3669,1418,131,124,255,51.4%,7m
2714,2,SeCre,3669,1496,98,110,208,47.1%,6m
2714,3,IIIIIIIIIIII,3669,178,9,3,12,75.0%,4m
2714,3,[근육볶음밥]브그미,3669,266,9,4,13,69.2%,5m
2714,3,모아이수주,3669,0,0,2,2,0.0%,6m
2719,3,[Equal]신기통신,3668,903,46,51,97,47.4%,8m
2719,3,Karena,3668,746,33,20,53,62.3%,15m
2719,3,재간둥이,3668,880,33,34,67,49.3%,10m
2719,3,ShaPirO,3668,440,22,11,33,66.7%,9m
2719,3,[尊者]Eikasang,3668,442,18,12,30,60.0%,3m
2719,3,[인투더]IntoTheTwo,3668,236,16,16,32,50.0%,8m
2719,3,Plare,3668,366,13,16,29,44.8%,10m
2719,3,Lyon,3668,252,7,11,18,38.9%,9m
2719,3,[false9]SANS,3668,0,3,2,5,60.0%,8m
2719,3,[브리티안]헤센카셀,3668,0,0,1,1,0.0%,7m
2719,3,참새대표,3668,0,0,3,3,0.0%,5m
2730,3,우주인싸이병렬,3667,1451,87,97,184,47.3%,7m
2730,3,Camel,3667,1038,47,46,93,50.5%,9m
2730,3,ctarsraft,3667,883,37,24,61,60.7%,3m
2730,3,땡겨볼까,3667,610,23,17,40,57.5%,10m
2730,3,인공지능,3667,277,17,9,26,65.4%,3m
2730,3,SmileGuys,3667,267,12,2,14,85.7%,4m
2730,3,[이터널]TenDer,3667,291,11,15,26,42.3%,8m
2730,1,일해라카락스,3667,0,0,1,1,0.0%,48m
2738,3,제라툴,3666,1321,63,45,108,58.3%,6m
2738,2,연서파파,3666,290,13,22,35,37.1%,5m
2738,3,[인트로]llIIIlllIIIl,3666,0,0,3,3,0.0%,10m
2741,3,레몬맛더위사냥,3665,1585,81,61,142,57.0%,8m
2741,3,JimRaynor,3665,333,30,26,56,53.6%,6m
2741,3,llllllllllll,3665,58,3,4,7,42.9%,5m
2741,3,IIIIIIIIIIII,3665,60,2,5,7,28.6%,6m
2741,1,송군,3665,0,1,2,3,33.3%,47m
2746,3,ChampionSoO,3664,525,23,12,35,65.7%,9m
2746,3,슬레이어스박서,3664,0,1,0,1,100.0%,9m
2746,3,llllllllllll,3664,0,1,4,5,20.0%,9m
2749,3,입닥쳐,3663,294,12,7,19,63.2%,9m
2749,3,Templar,3663,118,5,4,9,55.6%,16m
2749,3,[소속없음]llllllllllll,3663,0,1,1,2,50.0%,6m
2749,3,Licemer,3663,0,1,1,2,50.0%,16m
2749,3,은하사령관,3663,0,0,1,1,0.0%,6m
2749,3,[190]Whynot,3663,0,0,3,3,0.0%,5m
2755,3,으악디졋으,3662,749,81,85,166,48.8%,7m
2755,3,IIllIIlIIIIl,3662,843,45,48,93,48.4%,8m
2755,3,Rascal,3662,144,5,7,12,41.7%,10m
2755,3,아이언,3662,0,0,1,1,0.0%,3m
2755,3,[별님]SangSil,3662,0,0,1,1,0.0%,6m
2760,3,IPOS,3661,1496,129,114,243,53.1%,5m
2760,3,tutu,3661,503,45,49,94,47.9%,10m
2760,3,[Claire]Vignette,3661,438,15,19,34,44.1%,9m
2760,3,Ulatec,3661,188,9,1,10,90.0%,10m
2760,3,ULTIMATE,3661,96,1,1,2,50.0%,9m
2765,3,junhol,3660,1055,149,155,304,49.0%,7m
2765,1,NrJinu,3660,342,14,8,22,63.6%,4m
2765,3,[Rovic]Parasite,3660,0,0,1,1,0.0%,15m
2768,3,SouL,3659,695,62,58,120,51.7%,4m
2768,3,krnumberone,3659,221,7,8,15,46.7%,6m
2768,3,인생한번,3659,0,0,1,1,0.0%,5m
2768,3,[ELS]김민주,3659,0,0,1,1,0.0%,7m
2772,3,Thanatos,3658,0,2,3,5,40.0%,5m
2772,3,relax,3658,0,0,1,1,0.0%,3m
2774,3,[비트]dsfe,3657,1306,158,167,325,48.6%,8m
2774,3,pororo,3657,365,13,5,18,72.2%,3m
2774,3,[이터널]오천,3657,146,6,12,18,33.3%,8m
2774,3,조초잡초,3657,0,0,1,1,0.0%,6m
2778,3,[초현식근동물]초현식근동이물,3656,931,40,21,61,65.6%,7m
2779,3,직진남,3655,1578,136,107,243,56.0%,6m
2779,3,쿠로사키이치고,3655,1281,54,40,94,57.4%,5m
2779,3,IlIlIlIlIlIl,3655,0,1,0,1,100.0%,7m
2779,3,JayScarLeT,3655,30,1,3,4,25.0%,8m
2779,3,[NGameS]뀨르,3655,0,0,1,1,0.0%,6m
2784,3,[快樂玩家]Clementine,3654,1466,130,110,240,54.2%,9m
2784,3,Returns,3654,330,14,8,22,63.6%,8m
2784,3,Adriano,3654,296,10,16,26,38.5%,6m
2784,3,포춘형,3654,0,0,2,2,0.0%,10m
2788,3,Auliterrrrr,3653,1081,42,49,91,46.2%,8m
2788,3,[ELS]강아지왕국,3653,574,25,27,52,48.1%,8m
2788,3,Cristiano,3653,234,12,6,18,66.7%,6m
2788,3,[늬들5분컷]Forte,3653,170,6,9,15,40.0%,3m
2788,3,IlIlIlIlIlIl,3653,0,1,0,1,100.0%,6m
2788,3,[럭키]전순장인욧맨,3653,30,1,1,2,50.0%,5m
2788,3,[오소리]나루진,3653,30,1,1,2,50.0%,16m
2795,3,띵구,3652,30,2,5,7,28.6%,9m
2795,3,Fictive,3652,0,1,1,2,50.0%,15m
2795,3,[팀라]ggplayyo,3652,30,1,5,6,16.7%,6m
2795,3,망한게임,3652,0,0,1,1,0.0%,7m
2799,2,IIIIIIIIIIII,3651,1478,81,94,175,46.3%,8m
2799,3,총사령관,3651,88,3,7,10,30.0%,6m
2799,3,[Troupe]디그,3651,0,1,0,1,100.0%,9m
2799,3,Stairway,3651,0,0,2,2,0.0%,16m
2799,3,폭군,3651,0,0,2,2,0.0%,9m
2804,3,물빛보석,3650,0,0,1,1,0.0%,5m
2805,2,[애니멀킹덤]맛춤법재데로써,3649,1186,63,87,150,42.0%,16m
2805,3,[무직자가능]대출문의주쇼,3649,62,3,8,11,27.3%,3m
2805,3,Dreamy,3649,30,2,1,3,66.7%,3m
2805,3,Knoblyblob,3649,0,1,1,2,50.0%,4m
2805,3,기장곰돌이,3649,0,0,3,3,0.0%,7m
2810,3,웃지마민병관,3648,454,16,23,39,41.0%,7m
2810,3,퇴근후놀이터,3648,256,10,13,23,43.5%,4m
2812,2,[Lotuz]내유닛은말안드뤄,3647,1297,122,133,255,47.8%,4m
2812,2,호호호,3647,616,112,116,228,49.1%,8m
2812,3,MOTTAINAI,3647,218,9,3,12,75.0%,6m
2812,3,[ConFed]superterran,3647,118,6,13,19,31.6%,5m
2812,3,돈만챙긴다,3647,182,6,15,21,28.6%,3m
2812,3,[ELS]DarkFuse,3647,140,5,3,8,62.5%,3m
2812,3,동네힘쎈사람,3647,0,0,1,1,0.0%,7m
2812,3,Hihigh,3647,0,0,1,1,0.0%,6m
2820,3,raika,3646,624,22,25,47,46.8%,8m
2820,3,[LF]ChiCkenWinG,3646,318,14,0,14,100.0%,15m
2820,2,이현민바보,3646,278,14,5,19,73.7%,5m
2820,3,llllllllllll,3646,30,6,0,6,100.0%,10m
2820,3,MontBlanc,3646,179,5,0,5,100.0%,6m
2820,3,좌좌갓,3646,0,4,1,5,80.0%,3m
2820,3,llllllllllll,3646,58,3,1,4,75.0%,9m
2820,3,zerglisk,3646,0,0,1,1,0.0%,5m
2828,3,llllllllllll,3645,1608,484,450,934,51.8%,7m
2828,3,[YONSEI]구름거울,3645,0,0,1,1,0.0%,16m
2828,3,MoTo,3645,0,0,3,3,0.0%,7m
2831,3,FalleN,3644,498,22,13,35,62.9%,10m
2831,3,BioBot,3644,114,4,2,6,66.7%,5m
2831,3,Top,3644,94,4,8,12,33.3%,9m
2831,3,[이터널]Pinkkiwi,3644,58,3,4,7,42.9%,5m
2831,3,YSB,3644,0,0,1,1,0.0%,5m
2831,3,llllllll,3644,0,0,3,3,0.0%,7m
2837,3,[MGameS]틀렘,3643,1177,60,46,106,56.6%,6m
2837,3,[이터널]성현,3643,449,19,20,39,48.7%,7m
2837,2,[국방부사서병]피터팬,3643,260,12,11,23,52.2%,10m
2837,3,DOD,3643,284,11,2,13,84.6%,8m
2837,3,[머큐리]YeGurina,3643,140,5,2,7,71.4%,5m
2842,3,Aldar,3642,1234,112,99,211,53.1%,6m
2842,3,Paparazzi,3642,0,1,0,1,100.0%,6m
2842,3,IMBoni,3642,0,0,1,1,0.0%,5m
2842,3,[Arete]Dragonjane,3642,0,0,1,1,0.0%,16m
2846,3,boxer,3641,1459,113,95,208,54.3%,15m
2846,3,[ProTT]얼짱,3641,1439,84,83,167,50.3%,9m
2846,3,[광역어그로]BrownBear,3641,176,9,9,18,50.0%,8m
2846,3,XYFans,3641,140,6,1,7,85.7%,5m
2846,3,똥을먹는다,3641,86,3,2,5,60.0%,7m
2851,3,[KON]Ryan,3640,673,44,51,95,46.3%,8m
2851,3,[WTSC]리젖문,3640,86,4,0,4,100.0%,9m
2851,3,[두부곡행동파]태현,3640,0,1,0,1,100.0%,9m
2854,3,[군용]그랜드맛스타,3639,637,53,26,79,67.1%,7m
2854,3,IIllIIlllIll,3639,320,15,8,23,65.2%,5m
2854,3,HelloKitty,3639,140,6,4,10,60.0%,16m
2854,3,llllllllllll,3639,114,5,1,6,83.3%,5m
2854,3,chobo,3639,0,1,0,1,100.0%,10m
2859,2,Natum,3638,268,13,5,18,72.2%,3m
2859,3,INNOVATION,3638,30,6,0,6,100.0%,10m
2859,3,[Rovic]꼬마자객,3638,120,4,7,11,36.4%,8m
2859,3,예잘알,3638,30,1,5,6,16.7%,7m
2863,3,Nezz,3637,165,9,5,14,64.3%,15m
2864,3,[2su]망겜,3636,114,4,7,11,36.4%,5m
2864,3,Tolaxii,3636,123,2,3,5,40.0%,16m
2866,3,여섯시내고환,3635,179,9,2,11,81.8%,16m
2866,3,[이터널]나르는참새,3635,144,6,4,10,60.0%,7m
2866,3,SevasTra,3635,0,1,0,1,100.0%,8m
2866,3,[ZheJia]longbeya,3635,0,1,2,3,33.3%,10m
2866,3,기빳다,3635,0,0,1,1,0.0%,9m
2871,3,IIIIIIIIIIII,3634,1002,38,39,77,49.4%,15m
2871,3,LittleTuzki,3634,188,9,2,11,81.8%,6m
2871,3,HeuNg,3634,230,8,12,20,40.0%,9m
2874,3,llllllllllll,3633,615,69,32,101,68.3%,5m
2874,3,로우하잇,3633,837,38,25,63,60.3%,10m
2874,3,[만년다이아]김지연,3633,416,15,17,32,46.9%,15m
2874,3,Raven,3633,255,11,3,14,78.6%,10m
2874,3,[UMAI]JennerRay,3633,86,3,1,4,75.0%,5m
2879,3,JQLeE,3632,454,16,18,34,47.1%,9m
2880,3,혜선,3631,405,18,8,26,69.2%,5m
2880,2,Hard,3631,152,9,16,25,36.0%,6m
2880,2,KANYE,3631,44,5,1,6,83.3%,49m
2880,3,섻스킹성민,3631,30,2,3,5,40.0%,3m
2880,3,[유돈해브마미]beeshop,3631,0,0,1,1,0.0%,10m
2885,3,HamBurgerNow,3630,1543,73,60,133,54.9%,9m
2885,3,Daydream,3630,366,13,13,26,50.0%,9m
2885,3,ARCANGEL,3630,162,4,2,6,66.7%,6m
2888,3,RCseed,3629,0,0,1,1,0.0%,6m
2888,3,[동그랗고하얀]오늘은기념일,3629,0,0,1,1,0.0%,9m
2890,3,ASDFGH,3628,1102,41,41,82,50.0%,9m
2890,3,[Mist]바다왁스,3628,956,35,38,73,47.9%,8m
2890,2,[LQV]전술핵미사일,3628,636,22,41,63,34.9%,4m
2890,3,Divi,3628,549,20,15,35,57.1%,9m
2890,3,MeatSpin,3628,88,4,1,5,80.0%,9m
2890,2,크레이즈다어나,3628,0,3,2,5,60.0%,49m
2890,3,[Dopen]마루,3628,30,2,1,3,66.7%,7m
2890,1,BaekYeonhwa,3628,0,0,1,1,0.0%,47m
2898,3,[무한양승준]Yuraeha,3627,1404,108,103,211,51.2%,3m
2898,3,Akaza,3627,90,4,5,9,44.4%,5m
2898,3,바텀다니엘,3627,58,2,3,5,40.0%,16m
2898,2,[NEX]PunchLine,3627,0,1,2,3,33.3%,50m
2898,2,隻狼,3627,0,0,1,1,0.0%,15m
2898,3,llllllllllll,3627,0,0,1,1,0.0%,3m
2898,3,[S0fT]Agentri,3627,0,0,1,1,0.0%,9m
2905,3,RacingDNA,3626,1513,171,178,349,49.0%,9m
2905,3,Thanatos,3626,950,44,33,77,57.1%,5m
2905,3,IlIlIlIlIlIl,3626,343,16,7,23,69.6%,16m
2905,3,MauriceMoss,3626,30,2,0,2,100.0%,10m
2905,3,[SofT]HyperSoar,3626,0,1,0,1,100.0%,6m
2910,3,LovesickGirl,3625,1282,57,53,110,51.8%,7m
2910,3,해피하냐,3625,1242,49,54,103,47.6%,4m
2910,3,서동훈병신,3625,399,19,9,28,67.9%,5m
2910,3,[CIM]바크주크,3625,270,16,7,23,69.6%,9m
2910,3,[애니멀킹덤]동물왕고양이네코,3625,30,2,1,3,66.7%,7m
2910,3,골대풀,3625,0,0,1,1,0.0%,9m
2916,3,Radiant,3623,484,17,19,36,47.2%,5m
2916,3,来找小秘书,3623,521,17,21,38,44.7%,4m
2916,3,FrostNova,3623,448,15,25,40,37.5%,9m
2916,3,KBGBUSB,3623,304,11,14,25,44.0%,16m
2916,3,Keilian,3623,119,7,0,7,100.0%,5m
2916,3,shimakaze,3623,137,3,1,4,75.0%,5m
2916,3,맛있는바나나맛우,3623,0,0,2,2,0.0%,9m
2916,3,chrisJin,3623,0,0,3,3,0.0%,16m
2924,3,[海膽王]香菇綿羊,3622,910,37,38,75,49.3%,9m
2924,3,[인성쓰렉민석]멸치는한영이꼭지,3622,813,33,20,53,62.3%,10m
2924,3,NumberoneS,3622,0,0,1,1,0.0%,3m
2924,3,DOTASUCKS,3622,0,0,1,1,0.0%,6m
2928,2,Exp,3621,1243,167,144,311,53.7%,10m
2928,3,정종현,3621,1526,138,117,255,54.1%,6m
2928,3,PCPLAYER,3621,342,102,80,182,56.0%,7m
2928,3,GGGGG,3621,352,13,13,26,50.0%,6m
2928,3,EOEJEOEJ,3621,144,6,9,15,40.0%,5m
2933,3,KUMA,3620,516,19,21,40,47.5%,5m
2933,3,[크리에이터]IlIllIlIllIl,3620,0,1,0,1,100.0%,5m
2933,3,박재현,3620,0,0,1,1,0.0%,4m
2936,3,chemistry,3619,829,35,25,60,58.3%,5m
2936,3,rechts,3619,133,7,1,8,87.5%,4m
2936,3,Kaiser,3619,58,2,2,4,50.0%,3m
2939,3,[BTU]Qarn,3618,746,28,22,50,56.0%,10m
2939,3,belisarious,3618,310,14,6,20,70.0%,10m
2939,3,TERAMS,3618,58,3,1,4,75.0%,3m
2939,3,삼방인,3618,0,0,1,1,0.0%,5m
2939,3,ProjectL,3618,0,0,2,2,0.0%,16m
2944,3,[NsP]TheAreNa,3617,1478,66,74,140,47.1%,3m
2944,3,FIREKEEPER,3617,698,25,24,49,51.0%,10m
2944,1,lllllllllll,3617,143,3,1,4,75.0%,47m
2944,3,QueeN,3617,0,0,1,1,0.0%,7m
2948,3,GoodLuck,3616,1394,158,131,289,54.7%,4m
2948,1,llllllllllll,3616,120,7,1,8,87.5%,48m
2948,3,BisuYa,3616,166,5,1,6,83.3%,9m
2948,3,[패자는피를]피스타치오,3616,62,2,4,6,33.3%,16m
2948,3,[보스모드]Floria,3616,0,1,0,1,100.0%,8m
2948,3,[영앤리치]OKsavingbank,3616,0,0,1,1,0.0%,10m
2954,3,[베리타스]죽이면히힉,3615,947,98,98,196,50.0%,9m
2954,3,IIIIIIIIIIII,3615,1367,85,22,107,79.4%,5m
2954,3,[EPR]백투더퓨처,3615,693,56,42,98,57.1%,6m
2954,3,pulpo,3615,153,4,2,6,66.7%,5m
2958,3,태연,3614,289,17,10,27,63.0%,6m
2958,3,[수사]MarusParty,3614,366,14,11,25,56.0%,5m
2958,3,배터리사랑,3614,30,2,1,3,66.7%,8m
2958,3,김민재,3614,0,0,1,1,0.0%,5m
2962,3,KCS,3613,1160,50,35,85,58.8%,9m
2962,3,Angrybanana,3613,58,2,2,4,50.0%,5m
2962,3,[PTG]Raven,3613,0,0,1,1,0.0%,7m
2965,2,QwertyMaster,3612,875,223,239,462,48.3%,3m
2965,3,DxT,3612,60,2,2,4,50.0%,7m
2965,3,killer,3612,0,0,1,1,0.0%,10m
2968,3,lIllIlIlllII,3611,1322,61,47,108,56.5%,9m
2968,3,農會理事長,3611,448,27,33,60,45.0%,7m
2968,3,Sorceress,3611,204,11,10,21,52.4%,6m
2968,3,SHine,3611,0,4,1,5,80.0%,9m
2968,3,[방구함]쓸데없이잘함,3611,60,3,1,4,75.0%,3m
2968,3,[異界的檢察官]AMB,3611,0,1,0,1,100.0%,9m
2968,3,PjackLove,3611,0,0,1,1,0.0%,6m
2975,3,RedMoon,3610,60,3,1,4,75.0%,3m
2975,3,IIIIIIIIIIII,3610,0,1,0,1,100.0%,5m
2975,3,Weon,3610,30,1,2,3,33.3%,5m
2978,3,플보,3609,1374,61,41,102,59.8%,3m
2978,3,[한타왕]코너링,3609,1282,45,51,96,46.9%,16m
2978,3,Stork,3609,577,36,33,69,52.2%,7m
2978,3,Kuzma,3609,754,29,31,60,48.3%,5m
2978,3,[Nemian]PaxRomana,3609,119,5,1,6,83.3%,9m
2978,3,[Equal]myeyes,3609,88,3,6,9,33.3%,8m
2984,3,[ELSII]게살,3608,620,57,54,111,51.4%,8m
2984,3,님힐할년,3608,606,26,17,43,60.5%,10m
2984,3,IIIiiiiIIIIi,3608,244,9,11,20,45.0%,9m
2984,3,centurion,3608,86,4,4,8,50.0%,6m
2984,3,파워상민이,3608,60,3,2,5,60.0%,10m
2984,3,뚜따이,3608,60,2,12,14,14.3%,9m
2984,2,llllllllllll,3608,0,0,14,14,0.0%,3m
2991,3,llllllllllll,3607,1227,61,61,122,50.0%,7m
2991,3,MARINKING,3607,96,6,0,6,100.0%,16m
2991,3,[스텔라]강아지,3607,116,5,4,9,55.6%,6m
2991,3,Greenday,3607,0,0,4,4,0.0%,9m
2995,3,lllllllllll,3606,1579,377,344,721,52.3%,9m
2995,3,momo,3606,1599,191,170,361,52.9%,6m
2995,3,[好難過好想哭]starcoffeee,3606,157,40,47,87,46.0%,9m
2995,3,[5E对战平台]luna,3606,289,23,9,32,71.9%,9m
2995,3,IlIlIlIlIlIl,3606,391,16,9,25,64.0%,3m
2995,3,[경기도민]GGangMY,3606,96,3,3,6,50.0%,3m
2995,3,[Suzing]miyor,3606,0,0,1,1,0.0%,10m
2995,3,[맛있더라]llllllllll,3606,0,0,2,2,0.0%,6m
3003,3,마린이,3605,963,147,134,281,52.3%,7m
3003,3,llllllllllll,3605,1330,67,57,124,54.0%,5m
3003,3,광전사가좋아요,3605,86,3,3,6,50.0%,6m
3003,3,HuMbLe,3605,0,0,2,2,0.0%,7m
3003,3,빡깝쳐,3605,0,0,3,3,0.0%,6m
3008,3,허공에이엠피,3604,848,59,48,107,55.1%,16m
3008,3,[KKR]옹통,3604,30,2,3,5,40.0%,10m
3008,3,[14NY]새똥보단소똥,3604,0,1,1,2,50.0%,16m
3008,3,[비밀정원]이용우,3604,0,1,2,3,33.3%,9m
3008,3,Diget,3604,0,0,1,1,0.0%,3m
3013,3,토스만할꼬얌,3603,408,16,9,25,64.0%,6m
3013,3,니네엄마,3603,354,12,15,27,44.4%,5m
3013,1,Sanchez,3603,0,1,3,4,25.0%,3m
3016,3,선택받은떡국,3602,1023,115,105,220,52.3%,9m
3016,3,나만잘하면이긴다,3602,422,17,7,24,70.8%,5m
3016,3,[REGENO]HaWEE,3602,0,1,0,1,100.0%,5m
3016,3,캐간폭,3602,0,0,1,1,0.0%,9m
3020,3,the,3601,88,3,3,6,50.0%,6m
3020,3,갓윽오,3601,0,1,3,4,25.0%,10m
3020,3,Romdeang,3601,0,0,3,3,0.0%,6m
3023,3,[개떡]INnoVation,3600,1532,134,139,273,49.1%,7m
3023,2,[CranKy]Yakuzaku,3600,0,0,1,1,0.0%,9m
3025,2,OddSense,3599,95,6,0,6,100.0%,49m
3025,3,술취한노맹,3599,58,2,1,3,66.7%,6m
3025,3,[겨울방어]한량,3599,0,0,1,1,0.0%,6m
3028,3,제동신,3598,548,20,19,39,51.3%,7m
3028,3,거품이글스,3598,300,11,6,17,64.7%,3m
3028,3,[NGNLZ]小周,3598,316,11,14,25,44.0%,7m
3028,3,[Hyper]Chobo,3598,30,2,2,4,50.0%,9m
3028,3,간지가함께한다,3598,30,1,2,3,33.3%,6m
3028,3,일리아,3598,0,0,1,1,0.0%,5m
3028,3,CoiN,3598,0,0,2,2,0.0%,8m
3035,3,fmgreen,3597,256,12,15,27,44.4%,15m
3035,3,lIIllIIllllI,3597,0,1,0,1,100.0%,7m
3035,3,[zAWSLz]Paul,3597,0,1,0,1,100.0%,9m
3035,3,[StorM]SolQ,3597,0,0,1,1,0.0%,6m
3039,1,효달이짱,3596,142,4,2,6,66.7%,47m
3039,3,테란은쓰레기다,3596,116,4,5,9,44.4%,5m
3039,3,Chtholly,3596,30,2,1,3,66.7%,6m
3039,3,mermaid,3596,30,1,1,2,50.0%,7m
3043,3,JerryC,3595,1529,86,96,182,47.3%,7m
3043,3,테란좀알려주세요,3595,901,38,32,70,54.3%,10m
3043,3,[三民主義]Bunker,3595,388,15,15,30,50.0%,9m
3043,3,사신,3595,210,11,2,13,84.6%,16m
3043,3,AlphaGo,3595,88,3,8,11,27.3%,5m
3043,3,[낭낭하게]Machine,3595,30,2,0,2,100.0%,9m
3043,3,Louis,3595,0,0,1,1,0.0%,9m
3050,3,[무한오영종]Stroke,3594,146,6,7,13,46.2%,9m
3050,3,[졸렬킹]idontknowwhy,3594,116,4,3,7,57.1%,3m
3052,3,잡금혐오를멈춰,3593,340,12,19,31,38.7%,6m
3052,3,[KayOn]琴吹紬,3593,206,7,18,25,28.0%,9m
3052,3,EasyAI,3593,0,1,0,1,100.0%,9m
3055,3,lIlIllIl,3592,178,7,14,21,33.3%,7m
3055,3,[엔타로연합]스투해서인생망침,3592,187,6,6,12,50.0%,9m
3055,3,[시럽]Luke,3592,0,1,0,1,100.0%,5m
3058,3,deadgame,3591,1152,46,38,84,54.8%,9m
3058,3,IlIlIlIlI,3591,812,34,25,59,57.6%,9m
3060,3,psychopomp,3590,1047,59,51,110,53.6%,6m
3060,3,패비터,3590,601,24,16,40,60.0%,6m
3060,2,llllllllllll,3590,0,3,0,3,100.0%,49m
3060,3,[도담이]과염소산암모늄,3590,0,1,0,1,100.0%,8m
3060,3,PlsNoStorm,3590,0,0,1,1,0.0%,3m
3065,2,IIIIIIIIIIII,3589,1454,468,444,912,51.3%,8m
3065,3,Terran,3589,1556,135,104,239,56.5%,10m
3065,3,에픽세븐,3589,600,23,19,42,54.8%,7m
3065,3,지금이니,3589,138,5,5,10,50.0%,8m
3065,3,Smurf,3589,0,3,2,5,60.0%,6m
3065,3,llllllllllll,3589,0,0,2,2,0.0%,6m
3071,3,One,3588,1467,101,110,211,47.9%,9m
3071,3,[DearS]제이와,3588,683,31,14,45,68.9%,9m
3071,3,신의한수,3588,88,4,3,7,57.1%,9m
3071,3,DameDane,3588,0,0,1,1,0.0%,5m
3075,3,[Tyler]달거니,3587,1514,218,223,441,49.4%,15m
3075,3,Leo,3587,1571,83,58,141,58.9%,9m
3075,3,절막만지셧잖아요,3587,152,6,5,11,54.5%,8m
3075,3,소나기,3587,0,0,1,1,0.0%,6m
3079,3,[겨울방어]공허의유자차,3586,1555,126,95,221,57.0%,16m
3079,3,팡치,3586,0,1,0,1,100.0%,9m
3079,3,JIN,3586,30,1,1,2,50.0%,8m
3079,3,아이유팬,3586,0,0,1,1,0.0%,6m
3083,3,이쑤신장군,3585,685,25,21,46,54.3%,6m
3083,3,LofNaun,3585,158,23,0,23,100.0%,5m
3083,3,MapleSyrup,3585,430,16,9,25,64.0%,3m
3083,3,Danbi,3585,30,1,1,2,50.0%,5m
3083,3,[奀貧洞]okdoong,3585,0,0,1,1,0.0%,7m
3088,3,IIIIIIIIIlll,3584,134,11,4,15,73.3%,5m
3088,3,지리산,3584,30,2,2,4,50.0%,6m
3090,3,[KOSEAL]지옥주교육생,3583,982,122,66,188,64.9%,7m
3090,3,[게임알못환영]졸릴때는잡니다,3583,278,13,20,33,39.4%,8m
3090,1,deepsyug,3583,189,7,0,7,100.0%,47m
3090,3,unknown,3583,0,1,0,1,100.0%,8m
3094,3,LTopAz,3582,1646,238,243,481,49.5%,16m
3094,3,현민이고추,3582,638,29,9,38,76.3%,16m
3094,3,RereCon,3582,0,1,0,1,100.0%,9m
3094,2,kwnsgh,3582,0,0,6,6,0.0%,49m
3098,3,Kensei,3581,1245,247,232,479,51.6%,5m
3098,3,크와앗,3581,1366,212,204,416,51.0%,7m
3098,3,[제일잘생긴]세이버,3581,774,46,51,97,47.4%,9m
3098,3,전죄인입니다,3581,30,1,1,2,50.0%,7m
3102,3,동족전안함,3580,880,84,83,167,50.3%,9m
3102,3,llllllllllll,3580,320,10,12,22,45.5%,7m
3102,3,[한강물차가움]샤넬,3580,166,5,0,5,100.0%,16m
3102,3,lol,3580,88,3,5,8,37.5%,16m
3102,3,Dirk,3580,30,1,2,3,33.3%,6m
3102,3,BoOm,3580,0,0,2,2,0.0%,16m
3108,3,[SUBO]SUBO,3579,272,18,12,30,60.0%,6m
3108,3,LINY,3579,490,18,19,37,48.6%,5m
3108,2,ChristmasTD,3579,0,1,4,5,20.0%,49m
3111,3,Irreplaveabl,3578,1009,115,97,212,54.2%,5m
3111,2,KingofHeroes,3578,158,5,5,10,50.0%,8m
3111,3,kaduk,3578,60,2,2,4,50.0%,6m
3114,3,까까퐁,3577,1539,174,152,326,53.4%,5m
3114,3,sudo,3577,786,83,74,157,52.9%,15m
3114,3,chacha,3577,1230,79,78,157,50.3%,15m
3114,3,BABsukidesu,3577,586,24,15,39,61.5%,9m
3114,3,[ELS]마이어,3577,116,5,3,8,62.5%,5m
3114,3,김기원,3577,0,4,1,5,80.0%,5m
3114,3,[ODST]YYB,3577,0,0,2,2,0.0%,5m
3121,3,戀風,3576,82,6,0,6,100.0%,9m
3121,3,힘내서취업하자,3576,174,6,11,17,35.3%,9m
3121,3,[짭페셜]젤나가의노예,3576,58,3,0,3,100.0%,6m
3124,3,Super,3575,1246,188,157,345,54.5%,3m
3124,3,rlawnsghd,3575,1550,114,94,208,54.8%,3m
3124,3,FtAiur,3575,930,42,29,71,59.2%,3m
3124,3,[地獄拉麵]多線獸,3575,366,22,12,34,64.7%,8m
3128,3,MasterTerran,3574,234,8,11,19,42.1%,5m
3128,3,아이어행성,3574,0,0,2,2,0.0%,10m
3130,3,[NerfZg]Aguero,3573,1423,144,123,267,53.9%,6m
3130,3,白门楼,3573,844,32,36,68,47.1%,9m
3130,3,미련,3573,215,11,3,14,78.6%,5m
3130,3,마왕공손찬,3573,198,10,3,13,76.9%,9m
3130,3,StreeTBoxeR,3573,157,6,3,9,66.7%,5m
3130,3,타우렌드루이드,3573,189,5,7,12,41.7%,6m
3130,3,Reds,3573,0,0,1,1,0.0%,3m
3137,3,UrielKoneho,3572,1553,83,71,154,53.9%,16m
3137,3,[자치령특전단]llllllllllll,3572,301,10,5,15,66.7%,7m
3137,3,미소짓는유리,3572,0,1,1,2,50.0%,5m
3140,3,신입유저,3571,1300,123,128,251,49.0%,3m
3140,1,Fairytail,3571,96,6,0,6,100.0%,15m
3140,1,llllllllllll,3571,112,2,3,5,40.0%,4m
3143,3,CarpeDiem,3570,83,19,26,45,42.2%,8m
3144,3,[너의ol름은]형은세배빠르당,3569,1058,180,150,330,54.5%,7m
3144,3,[올드보이]우럭아왜우럭,3569,417,15,10,25,60.0%,7m
3144,3,Meijin,3569,0,5,0,5,100.0%,9m
3147,3,FanTaSy,3568,1429,99,104,203,48.8%,8m
3147,3,이노베이션,3568,293,24,10,34,70.6%,6m
3147,2,젖꼭지,3568,202,7,1,8,87.5%,5m
3150,3,GFRIEND,3567,1544,151,139,290,52.1%,3m
3150,3,순수한,3567,1366,113,92,205,55.1%,16m
3150,3,[AN2]oscar,3567,436,32,16,48,66.7%,6m
3150,3,IlIlIlIlIlIl,3567,113,5,2,7,71.4%,8m
3150,3,[영앤리치]kimleo,3567,86,3,4,7,42.9%,3m
3155,3,장현준,3566,1505,94,83,177,53.1%,9m
3155,3,soulmate,3566,504,18,20,38,47.4%,10m
3155,3,[OnePeS]BeNiBeaR,3566,384,14,20,34,41.2%,8m
3155,3,杀死那个石家庄人,3566,216,6,5,11,54.5%,5m
3155,1,[TGCrew]Dae,3566,97,3,2,5,60.0%,8m
3160,3,lllIlIIIll,3565,985,41,33,74,55.4%,16m
3160,3,Hexer,3565,94,3,8,11,27.3%,9m
3160,3,Esperar,3565,30,2,0,2,100.0%,6m
3160,3,[CBEL]caramel,3565,0,1,0,1,100.0%,10m
3164,3,뒹굴뒹굴,3564,191,20,10,30,66.7%,8m
3164,3,바코드킬러,3564,486,17,22,39,43.6%,9m
3164,3,cladia,3564,58,3,2,5,60.0%,5m
3164,3,[DaFang]EnTaroDragon,3564,30,2,0,2,100.0%,8m
3164,3,killing,3564,0,1,1,2,50.0%,8m
3164,3,ogsMC,3564,0,0,1,1,0.0%,6m
3170,3,묘야,3563,595,27,26,53,50.9%,5m
3170,3,[프사기박멸중]맹독충버프필수,3563,664,23,36,59,39.0%,6m
3170,3,DynamicGiMiL,3563,271,11,8,19,57.9%,6m
3173,3,빼애애애애애애액,3562,243,12,3,15,80.0%,5m
3173,3,국민영웅,3562,234,9,8,17,52.9%,9m
3173,3,[NGameS]MariGold,3562,86,3,2,5,60.0%,16m
3173,3,JCK,3562,0,1,4,5,20.0%,9m
3177,3,바코드아이디,3561,470,18,20,38,47.4%,10m
3177,3,newbieDK,3561,350,12,12,24,50.0%,9m
3177,3,[맛있는치즈]graceR,3561,0,0,1,1,0.0%,16m
3180,3,bokkeum,3559,1289,148,155,303,48.8%,7m
3180,3,박건혜,3559,453,87,78,165,52.7%,9m
3180,3,umbrella,3559,1044,43,35,78,55.1%,6m
3180,3,계피말이,3559,638,25,18,43,58.1%,5m
3180,3,동위원소,3559,268,12,4,16,75.0%,15m
3180,3,IIIIIIIIIII,3559,114,4,3,7,57.1%,5m
3180,3,GrayScene,3559,59,3,2,5,60.0%,9m
3180,3,IIIIIIIIIIII,3559,0,0,1,1,0.0%,6m
3188,3,테란강습삘,3558,1594,370,382,752,49.2%,8m
3188,3,휘센,3558,1349,68,26,94,72.3%,3m
3188,3,맹덕데굴데굴,3558,248,13,14,27,48.1%,8m
3188,3,Wolpung,3558,236,8,11,19,42.1%,8m
3188,3,sesame,3558,94,4,8,12,33.3%,6m
3188,3,오연서,3558,0,0,1,1,0.0%,3m
3194,3,BodomLake,3557,0,5,0,5,100.0%,51m
3194,3,[Hyper]고대병기혐산당,3557,203,5,15,20,25.0%,10m
3196,3,BootyDaddy,3556,512,18,19,37,48.6%,9m
3196,3,[스텔라]강아지,3556,150,6,13,19,31.6%,8m
3196,3,CaucasianNob,3556,0,0,1,1,0.0%,6m
3199,3,나한테지면반성해,3555,260,10,5,15,66.7%,16m
3199,3,[이터널]Gonzo,3555,263,9,5,14,64.3%,6m
3199,3,llllllllllll,3555,195,6,3,9,66.7%,15m
3199,3,AraAra,3555,0,5,0,5,100.0%,10m
3199,3,LoveZNW,3555,86,4,3,7,57.1%,3m
3199,3,jkh,3555,0,0,2,2,0.0%,5m
3205,3,[로무현]llllllllllll,3554,1455,81,40,121,66.9%,3m
3205,3,DIDI,3554,663,40,38,78,51.3%,9m
3205,3,TFReward,3554,234,18,7,25,72.0%,15m
3205,3,lIlIIlIIIIII,3554,0,0,5,5,0.0%,6m
3209,3,[야동왕문재인]Angel,3553,575,97,81,178,54.5%,6m
3209,2,[무한오영종]소민누나,3553,424,86,91,177,48.6%,3m
3209,3,[문재앙씨발놈]XijinpingSex,3553,386,17,8,25,68.0%,16m
3209,3,[JEONG]minamizato,3553,130,5,3,8,62.5%,16m
3213,3,개스레기게임,3552,0,0,2,2,0.0%,10m
3214,3,FAKE,3551,1500,85,95,180,47.2%,7m
3214,3,정신차려할수있어,3551,450,17,16,33,51.5%,7m
3214,3,ParTinG,3551,0,0,1,1,0.0%,16m
3214,3,[isnous]飛龍,3551,0,0,1,1,0.0%,9m
3218,3,llllllllllll,3550,1222,49,45,94,52.1%,7m
3218,3,먹잇감,3550,867,49,59,108,45.4%,8m
3218,3,KillerRyu,3550,458,17,18,35,48.6%,9m
3221,3,한집,3549,723,597,566,1163,51.3%,5m
3221,3,Kiw,3549,565,27,18,45,60.0%,5m
3223,3,newtype,3548,296,166,166,332,50.0%,15m
3223,3,lIllIIlllIII,3548,258,8,5,13,61.5%,16m
3223,3,후아유,3548,0,1,0,1,100.0%,6m
3226,3,리에키,3547,735,30,42,72,41.7%,8m
3227,3,lolol,3546,451,19,11,30,63.3%,6m
3227,3,[DICET]IIIlIIIlIII,3546,322,16,1,17,94.1%,7m
3227,3,CLAXIKA,3546,0,1,0,1,100.0%,16m
3227,1,일상한가지즐거움,3546,0,0,2,2,0.0%,47m
3231,3,집없는북극곰,3545,359,41,40,81,50.6%,8m
3231,3,AVOIR,3545,332,17,9,26,65.4%,6m
3231,3,UsurF,3545,0,5,0,5,100.0%,16m
3231,3,FePumpkin,3545,0,0,1,1,0.0%,5m
3231,3,[ELS]ScanDium,3545,0,0,1,1,0.0%,15m
3231,3,[막강]강력한참새,3545,0,0,1,1,0.0%,9m
3237,3,백승호,3544,242,9,11,20,45.0%,7m
3237,3,전기기술사따자,3544,232,9,18,27,33.3%,5m
3237,3,곰둥이,3544,257,8,7,15,53.3%,5m
3237,3,Envy,3544,0,1,0,1,100.0%,10m
3241,3,[NsP]Makaron,3543,382,73,47,120,60.8%,9m
3241,3,[겨울방어]eoflrmao,3543,1310,67,35,102,65.7%,9m
3241,3,[SAIL]새벽비,3543,337,11,10,21,52.4%,9m
3241,3,[Akuma]MyBoo,3543,118,2,1,3,66.7%,8m
3241,3,IlIIIIIllll,3543,60,2,4,6,33.3%,10m
3246,3,愚蠢的棒子,3542,1243,81,60,141,57.4%,10m
3246,3,TaeJa,3542,229,21,13,34,61.8%,6m
3246,3,[StorM2]IIIIIIIIIIII,3542,191,5,4,9,55.6%,6m
3246,3,Shovel,3542,118,3,0,3,100.0%,7m
3246,3,IlIlIIIlllII,3542,92,3,8,11,27.3%,5m
3246,3,[샌또속]폰팔이,3542,0,1,2,3,33.3%,3m
3246,3,llllllllllll,3542,0,0,1,1,0.0%,50m
3253,3,바코드,3541,1506,122,108,230,53.0%,5m
3253,3,YSYS,3541,122,9,4,13,69.2%,9m
3253,3,FSS,3541,208,6,6,12,50.0%,10m
3253,3,전유찬,3541,0,0,1,1,0.0%,7m
3257,3,ARK,3540,1311,55,41,96,57.3%,9m
3257,3,TakeiEmi,3540,705,36,18,54,66.7%,10m
3257,3,손주호,3540,214,11,4,15,73.3%,7m
3257,3,CyrusII,3540,167,9,3,12,75.0%,9m
3257,3,[태초마을]qwe,3540,0,1,0,1,100.0%,9m
3262,3,[세미온TD]스윗한사찰오빠,3539,670,56,15,71,78.9%,6m
3262,3,[네임]Retaliator,3539,90,8,3,11,72.7%,9m
3264,3,볼텍로터리,3538,660,30,15,45,66.7%,3m
3264,3,[임갓의추종자]무적의임레기,3538,436,16,17,33,48.5%,15m
3264,3,OnGLeaDer,3538,235,12,6,18,66.7%,16m
3264,3,[Nazzi]llllllllllll,3538,94,3,9,12,25.0%,16m
3268,3,aDecay,3537,1404,79,83,162,48.8%,5m
3268,3,BiO,3537,812,37,22,59,62.7%,9m
3268,3,llllllllllll,3537,416,20,7,27,74.1%,10m
3268,3,골드수문장,3537,420,20,10,30,66.7%,5m
3268,3,RandomRich,3537,139,4,1,5,80.0%,6m
3268,2,[LighTe]Medic,3537,95,1,1,2,50.0%,49m
3268,3,유린,3537,0,0,1,1,0.0%,8m
3275,3,JHigh,3535,958,50,40,90,55.6%,10m
3275,3,[SofT]INnOcolOR,3535,329,13,5,18,72.2%,16m
3275,3,[Runes]chiori,3535,104,10,5,15,66.7%,5m
3278,3,[GITS]波霸,3534,1531,150,128,278,54.0%,10m
3278,3,[공허거주]LEVIATHAN,3534,1421,96,50,146,65.8%,9m
3278,3,SiRiUS,3534,1316,60,62,122,49.2%,8m
3278,3,[ELS]엘리자베스,3534,219,8,5,13,61.5%,9m
3278,3,곧긔,3534,0,0,1,1,0.0%,3m
3283,3,뽀로롱,3533,624,32,22,54,59.3%,16m
3283,3,[Saber6]Doraion,3533,561,26,11,37,70.3%,10m
3283,3,Dissnag,3533,183,10,3,13,76.9%,6m
3283,3,[무리무리팸]즐겜유저병신테란,3533,242,8,6,14,57.1%,6m
3283,3,MeGiSolid,3533,208,6,5,11,54.5%,6m
3283,3,lllllllll,3533,95,2,0,2,100.0%,16m
3283,3,곽대갈,3533,30,1,4,5,20.0%,9m
3283,3,TTT,3533,0,0,1,1,0.0%,5m
3291,3,Star,3532,1096,53,31,84,63.1%,10m
3291,2,kali,3532,96,6,1,7,85.7%,50m
3291,3,IIIIIIIIIIII,3532,120,5,5,10,50.0%,10m
3291,3,[D3StaR]창주부,3532,0,1,0,1,100.0%,9m
3291,3,Sai,3532,0,0,1,1,0.0%,9m
3291,3,맥주순수령,3532,0,0,1,1,0.0%,10m
3297,3,zerg,3531,1360,99,82,181,54.7%,3m
3297,3,[IHan]Echoes,3531,195,25,10,35,71.4%,9m
3297,3,[초보입문]미스트칵테일,3531,218,7,4,11,63.6%,9m
3297,3,llllllllllll,3531,183,7,14,21,33.3%,7m
3301,3,[Master]나봉구리,3530,1475,69,84,153,45.1%,7m
3301,3,OBitarpraim,3530,571,25,18,43,58.1%,5m
3301,2,Kjpeans,3530,143,7,1,8,87.5%,50m
3301,3,Dot,3530,0,5,0,5,100.0%,51m
3301,3,문재인,3530,32,3,5,8,37.5%,8m
3301,3,[INFNO]芒果乾,3530,0,0,1,1,0.0%,10m
3307,3,IIIlllliiill,3529,588,22,21,43,51.2%,9m
3307,3,泰瑞,3529,124,7,1,8,87.5%,9m
3307,3,골토부하,3529,0,5,0,5,100.0%,6m
3307,3,음바페,3529,93,2,0,2,100.0%,9m
3311,3,Atlas,3528,1496,371,372,743,49.9%,7m
3311,3,Luvshine,3528,168,11,9,20,55.0%,15m
3311,2,ICEBlue,3528,97,2,2,4,50.0%,49m
3314,3,Jazzer,3527,673,36,9,45,80.0%,5m
3314,3,burnpigg,3527,241,12,5,17,70.6%,5m
3314,3,[Lotuz]바른연애생활탐구,3527,260,10,3,13,76.9%,3m
3314,2,Nano,3527,121,4,4,8,50.0%,49m
3314,3,[TalenT]ReCall,3527,96,2,0,2,100.0%,10m
3319,3,llllllllllll,3526,707,104,94,198,52.5%,5m
3319,3,묘향현령,3526,304,16,6,22,72.7%,10m
3319,3,Nerfme,3526,237,11,1,12,91.7%,6m
3319,2,knightOfSC,3526,190,6,4,10,60.0%,49m
3319,3,카드값줘체리,3526,0,0,1,1,0.0%,5m
3324,3,Sanay,3525,1458,170,165,335,50.7%,9m
3324,3,[얼라이브]Eileen,3525,143,7,3,10,70.0%,16m
3324,3,리레이져,3525,115,6,5,11,54.5%,8m
3324,1,JinjoPapa,3525,121,2,2,4,50.0%,47m
3328,3,[萬花筒寫輪眼]sai,3524,869,38,32,70,54.3%,5m
3328,3,걍이겜재미,3524,525,27,8,35,77.1%,6m
3328,3,HacKing,3524,270,13,3,16,81.2%,6m
3331,3,ballyFoX,3523,1256,89,91,180,49.4%,10m
3331,3,[SWLJ]GalaxyMars,3523,813,39,27,66,59.1%,6m
3331,3,llllllllllll,3523,226,7,6,13,53.8%,9m
3331,3,MyoungJang,3523,119,3,1,4,75.0%,5m
3331,3,tortoise,3523,0,1,2,3,33.3%,10m
3336,3,구름달,3522,1144,48,37,85,56.5%,10m
3336,3,[송골매]HACKoSpectre,3522,970,36,35,71,50.7%,5m
3336,3,Aka,3522,0,5,0,5,100.0%,7m
3336,3,彌勒,3522,0,5,0,5,100.0%,51m
3336,3,[레인저]다음기회에,3522,136,4,0,4,100.0%,10m
3336,3,RainSeeU,3522,0,0,2,2,0.0%,8m
3342,3,noraneko,3521,983,82,66,148,55.4%,6m
3342,3,[벌레냄새]maverick,3521,1198,69,44,113,61.1%,5m
3342,3,[TU]노바,3521,256,13,4,17,76.5%,10m
3342,3,곧휴가철이다,3521,296,10,6,16,62.5%,9m
3342,3,팔정서,3521,145,8,2,10,80.0%,15m
3347,3,김정현프로존잘러,3520,285,14,7,21,66.7%,9m
3347,3,[How]Shim,3520,0,0,1,1,0.0%,15m
3349,3,박상후,3518,463,20,24,44,45.5%,5m
3349,3,비숑사랑,3518,418,15,17,32,46.9%,9m
3349,1,llllllllllll,3518,482,12,25,37,32.4%,6m
3349,3,pikaLGO,3518,171,11,20,31,35.5%,9m
3353,3,[ELS]초보입니닷,3517,172,7,8,15,46.7%,3m
3353,3,예호,3517,176,6,8,14,42.9%,16m
3353,3,wkaks,3517,30,2,2,4,50.0%,3m
3356,1,[LiBts]글로벌무료똥망겜,3516,420,10,10,20,50.0%,8m
3356,1,IIIllllllIIl,3516,0,2,3,5,40.0%,3m
3356,3,IIIIIIIIIIII,3516,30,2,5,7,28.6%,5m
3356,3,긍정,3516,30,1,4,5,20.0%,9m
3360,3,Terran,3515,861,88,61,149,59.1%,7m
3360,1,띨띨이,3515,0,0,1,1,0.0%,6m
3362,3,회장님,3514,1442,119,94,213,55.9%,6m
3362,1,[UH]llllllllllll,3514,550,17,6,23,73.9%,6m
3362,3,[XYFANS]wHy,3514,264,9,7,16,56.2%,6m
3362,3,[가끔씩쩌는애]gud,3514,221,7,9,16,43.8%,6m
3366,3,민군,3513,1563,128,125,253,50.6%,9m
3366,3,llllllllllll,3513,483,52,56,108,48.1%,9m
3366,3,Kangshin,3513,942,46,40,86,53.5%,10m
3366,3,喜歡欺負電腦,3513,486,20,16,36,55.6%,7m
3366,3,비정한인연,3513,427,18,16,34,52.9%,6m
3366,2,용갈햏,3513,143,7,1,8,87.5%,49m
3366,1,lIIIlllIIlll,3513,0,0,1,1,0.0%,10m
3366,1,동해콜택시,3513,0,0,1,1,0.0%,3m
3374,3,daniel,3512,374,13,12,25,52.0%,5m
3374,3,ChanaKiller,3512,0,4,0,4,100.0%,50m
3374,1,슈퍼스타,3512,0,0,1,1,0.0%,3m
3374,3,BOEUN,3512,0,0,2,2,0.0%,10m
3378,1,[육풍함]IllIIIllIllI,3511,344,9,9,18,50.0%,3m
3378,1,IIIIIIIIIIII,3511,213,6,4,10,60.0%,3m
3378,1,SFHoLongHun,3511,169,3,4,7,42.9%,48m
3378,1,테란,3511,0,1,0,1,100.0%,3m
3378,3,회색호랑이,3511,0,1,4,5,20.0%,9m
3383,1,하얀은빛,3510,464,18,10,28,64.3%,3m
3383,1,Hell,3510,0,0,1,1,0.0%,6m
3385,3,[Moons]콜라군,3509,1548,93,104,197,47.2%,8m
3385,1,[萬花筒寫輪眼]OOOO,3509,530,14,9,23,60.9%,6m
3387,3,IMmortalitY,3508,169,5,4,9,55.6%,8m
3387,3,IlllIllIllI,3508,144,4,3,7,57.1%,6m
3389,3,[Goe]Amber,3507,0,0,1,1,0.0%,7m
3390,3,[NGameS]불굴의특급전사,3506,1089,80,70,150,53.3%,10m
3390,1,Brett,3506,668,27,17,44,61.4%,4m
3390,3,[WTSC]UED,3506,356,12,15,27,44.4%,6m
3390,1,여고생,3506,284,8,5,13,61.5%,6m
3390,3,Dooyu,3506,0,0,2,2,0.0%,16m
3395,3,오필리어,3505,932,88,107,195,45.1%,6m
3395,3,땜근이,3505,1094,41,41,82,50.0%,10m
3395,3,알파몽,3505,268,26,19,45,57.8%,6m
3395,1,[MDC]Dior,3505,341,15,12,27,55.6%,3m
3395,1,[CIM]UltraMarine,3505,243,10,4,14,71.4%,4m
3395,2,MyNameJeff,3505,161,6,3,9,66.7%,49m
3395,3,[허대영섹시남]나라라비행기,3505,0,1,1,2,50.0%,9m
3395,1,너굴너굴,3505,44,1,2,3,33.3%,6m
3395,1,狼呆跨民丟災,3505,0,0,1,1,0.0%,4m
3395,3,Boxer,3505,0,0,2,2,0.0%,5m
3395,3,THTHXD,3505,0,0,8,8,0.0%,16m
3406,3,김게임,3504,442,38,47,85,44.7%,8m
3406,3,realroot,3504,293,20,22,42,47.6%,5m
3406,1,StarBase,3504,82,2,1,3,66.7%,6m
3409,3,Toomuch,3503,475,18,14,32,56.2%,6m
3409,3,NiarKlol,3503,30,2,4,6,33.3%,7m
3409,2,장동건,3503,0,1,0,1,100.0%,50m
3412,3,Anarchy,3502,983,45,39,84,53.6%,6m
3412,3,동네곰님,3502,315,15,8,23,65.2%,16m
3412,1,IlIIlllIIl,3502,182,6,0,6,100.0%,3m
3412,3,Craft,3502,236,6,6,12,50.0%,5m
3416,1,[llIll]III,3501,1386,48,36,84,57.1%,10m
3416,3,IIIIIIIIIIII,3501,1112,41,43,84,48.8%,9m
3418,3,형님,3500,1057,101,82,183,55.2%,7m
3418,1,IIIIIIIIIIII,3500,740,24,14,38,63.2%,6m
3418,1,IIIIIIIIIII,3500,44,2,0,2,100.0%,4m
3421,1,IIIIIIIIIIII,3499,423,43,27,70,61.4%,6m
3421,1,[뭔가상큼한]TheMarine,3499,44,2,0,2,100.0%,6m
3421,1,Free,3499,0,0,1,1,0.0%,3m
3424,3,지폭장승,3498,1270,47,51,98,48.0%,7m
3424,1,[고병재]GuMiho,3498,170,5,2,7,71.4%,4m
3424,1,[Swjtu]Whiteshatter,3498,114,5,5,10,50.0%,4m
3424,3,herO,3498,90,3,11,14,21.4%,10m
3424,1,랩퍼상스,3498,44,1,2,3,33.3%,10m
3424,1,바코드,3498,46,1,2,3,33.3%,6m
3430,1,만년실버,3497,1413,65,49,114,57.0%,6m
3430,3,총보다빠른칼질,3497,1330,56,65,121,46.3%,7m
3430,2,BaldEagle,3497,96,6,1,7,85.7%,50m
3430,3,bbilori,3497,117,3,1,4,75.0%,3m
3430,1,[귀요미무혀닝]황인재,3497,40,1,1,2,50.0%,4m
3430,1,[꽁승감사]연결,3497,0,0,1,1,0.0%,3m
3430,1,인생은키리토처럼,3497,0,0,1,1,0.0%,3m
3437,3,초등학생아니에요,3496,170,7,9,16,43.8%,10m
3437,3,OnlyOne,3496,117,3,2,5,60.0%,10m
3437,3,Carmino,3496,97,2,0,2,100.0%,9m
3437,3,[我想玩蟲族]太陽神拉,3496,0,0,1,1,0.0%,51m
3437,3,지상,3496,0,0,2,2,0.0%,10m
3442,1,Amson,3495,446,11,5,16,68.8%,3m
3442,3,IIIIIlIIlIII,3495,119,7,2,9,77.8%,9m
3444,1,원할머니보고쌈,3494,1699,162,113,275,58.9%,7m
3445,1,llllllllllll,3493,1145,82,129,211,38.9%,3m
3445,3,PrsidentMOON,3493,1006,42,42,84,50.0%,3m
3445,3,[空白]imData,3493,148,5,8,13,38.5%,10m
3448,3,peace,3492,95,2,2,4,50.0%,9m
3448,3,Hys,3492,0,1,0,1,100.0%,9m
3450,3,[연필]지우개,3491,94,2,2,4,50.0%,8m
3450,3,SAUP,3491,0,0,4,4,0.0%,10m
3452,3,[DagmBa]공피고아,3490,955,73,87,160,45.6%,9m
3452,3,Emperor,3490,1358,71,61,132,53.8%,6m
3452,1,sulfur,3490,667,26,15,41,63.4%,7m
3452,1,DateGuy,3490,90,2,3,5,40.0%,4m
3452,1,[NGamE2]SHURIMA,3490,0,1,3,4,25.0%,48m
3457,1,tubtinten,3489,312,12,3,15,80.0%,8m
3457,3,하늘나래,3489,275,12,4,16,75.0%,6m
3457,1,[αX]눈의꽃,3489,0,0,1,1,0.0%,3m
3460,1,llllllllllll,3488,902,39,12,51,76.5%,8m
3460,3,探归者夕迁,3488,146,9,6,15,60.0%,9m
3462,3,[ENT]GdPark,3487,1541,78,83,161,48.4%,9m
3462,3,포켓몬스터,3487,0,5,0,5,100.0%,19m
3464,1,evans,3485,981,36,23,59,61.0%,6m
3464,3,조커,3485,311,13,6,19,68.4%,6m
3464,3,타지리리님한판만,3485,0,3,2,5,60.0%,18m
3464,1,[MPC]SKTKIMYUHA,3485,0,0,1,1,0.0%,8m
3468,3,Elvenfris,3484,121,3,1,4,75.0%,19m
3468,1,IIIIIIIII,3484,126,3,4,7,42.9%,7m
3470,3,아거,3483,234,11,6,17,64.7%,10m
3470,3,BarcodeAgain,3483,121,6,1,7,85.7%,50m
3470,3,슥탁큭랙픅특,3483,144,5,8,13,38.5%,6m
3470,1,downhill,3483,82,3,1,4,75.0%,3m
3470,1,즐겜유저장용택,3483,0,1,0,1,100.0%,8m
3475,3,Neptune,3482,316,11,19,30,36.7%,6m
3475,1,[PsTe]Baneling,3482,0,1,1,2,50.0%,4m
3475,1,초코먹고,3482,40,1,2,3,33.3%,16m
3475,3,IIIIIIIIIIII,3482,0,0,5,5,0.0%,9m
3479,3,[aFake]Maru,3481,984,135,117,252,53.6%,7m
3479,1,None,3481,653,20,15,35,57.1%,6m
3481,1,Mason,3480,40,2,0,2,100.0%,4m
3482,3,SoftVegan,3479,0,5,0,5,100.0%,19m
3482,2,WizWiz,3479,144,4,0,4,100.0%,49m
3482,1,[이터널]MorningStar,3479,126,4,3,7,57.1%,10m
3482,1,[GITS]RICHlee,3479,0,0,1,1,0.0%,6m
3482,3,군밤진밤,3479,0,0,5,5,0.0%,5m
3487,3,[돔돔돔]돌돔쎄빵,3478,1476,259,223,482,53.7%,5m
3487,3,BabyThermy,3478,1209,151,166,317,47.6%,9m
3487,3,LeeLeeLee,3478,141,4,3,7,57.1%,9m
3487,3,SimCity,3478,30,2,3,5,40.0%,7m
3491,3,[형님나가신다]SCZone,3477,1300,135,129,264,51.1%,5m
3491,1,IIIIIIIII,3477,0,1,0,1,100.0%,48m
3491,1,[TeamX]brave,3477,0,1,0,1,100.0%,4m
3494,3,[Ato]봊이육림,3476,377,17,19,36,47.2%,9m
3494,1,스타크래프트,3476,362,9,10,19,47.4%,4m
3494,1,[이터널]고인물게임,3476,48,2,9,11,18.2%,48m
3494,2,[CFMOVE]Aya,3476,0,0,2,2,0.0%,49m
3498,1,YUEYUE,3475,1277,47,36,83,56.6%,10m
3498,3,김유진수제자,3475,597,19,32,51,37.3%,9m
3498,1,[스커즈]sryicant,3475,88,3,1,4,75.0%,4m
3501,3,王者歸來,3474,1557,107,108,215,49.8%,9m
3501,3,[옵져버]JeannedArc,3474,1264,86,95,181,47.5%,9m
3501,1,ALKA,3474,196,6,6,12,50.0%,4m
3504,3,ThunderBolt,3473,684,100,99,199,50.3%,7m
3504,3,INnoVation,3473,149,8,3,11,72.7%,9m
3504,1,Roke,3473,146,7,2,9,77.8%,7m
3504,3,파이리,3473,122,2,8,10,20.0%,6m
3504,1,파렙만나고싶다,3473,44,1,1,2,50.0%,3m
3509,3,darksnow,3472,864,63,47,110,57.3%,6m
3509,3,stupor,3472,540,19,28,47,40.4%,3m
3509,3,SOL,3472,318,11,18,29,37.9%,5m
3509,3,끄야아앍,3472,193,8,6,14,57.1%,10m
3513,3,[ProTT]풀먹어,3471,1498,93,96,189,49.2%,8m
3513,3,傲血峰,3471,362,17,12,29,58.6%,6m
3513,3,[KN]주만이,3471,200,5,8,13,38.5%,3m
3513,1,스타첨이욤,3471,42,2,3,5,40.0%,6m
3513,1,[마음의선물]만두,3471,0,0,1,1,0.0%,7m
3518,3,NKAPPLE,3470,319,10,11,21,47.6%,7m
3518,1,[nomoon]llllllllllll,3470,80,3,3,6,50.0%,6m
3518,1,[ProTT]slixe,3470,0,0,1,1,0.0%,6m
3521,3,[인투더]IntoTheSouL,3469,1619,217,211,428,50.7%,9m
3521,1,[如何]BadGirl,3469,725,30,12,42,71.4%,6m
3521,1,[ANGG]Whisper,3469,690,20,19,39,51.3%,4m
3521,1,[너의ol름은]송해손잡고,3469,419,19,0,19,100.0%,3m
3521,1,llllllllllll,3469,42,2,2,4,50.0%,3m
3521,1,HanJuSic,3469,0,0,1,1,0.0%,6m
3527,1,llllllllllll,3468,347,15,7,22,68.2%,3m
3527,2,Sabertooth,3468,97,6,1,7,85.7%,49m
3527,3,테란,3468,121,3,4,7,42.9%,10m
3530,1,엔젤리,3467,814,33,15,48,68.8%,3m
3530,1,놈놈,3467,123,2,6,8,25.0%,6m
3532,1,JasonU,3466,631,22,11,33,66.7%,6m
3532,1,왕수민그는누군가,3466,0,1,1,2,50.0%,6m
3534,1,검은별,3465,44,1,2,3,33.3%,3m
3535,3,[인격파탄]그냥유저,3464,893,109,82,191,57.1%,10m
3535,3,매너건승,3464,360,12,20,32,37.5%,10m
3535,3,[yummy]Sandwich,3464,257,8,8,16,50.0%,7m
3535,3,ECartist,3464,0,5,0,5,100.0%,50m
3535,1,GLHF,3464,0,2,3,5,40.0%,6m
3540,1,llllllllllll,3463,1734,81,61,142,57.0%,8m
3540,3,PerfecT,3463,757,29,27,56,51.8%,3m
3540,3,PatrickYU,3463,59,2,3,5,40.0%,16m
3543,3,kimyoungs,3462,1407,119,111,230,51.7%,5m
3543,1,[양학나가디져]김정은,3462,394,10,9,19,52.6%,6m
3543,3,ZZZZZZZerran,3462,145,7,1,8,87.5%,50m
3543,3,lllIIIlllIIl,3462,140,6,15,21,28.6%,10m
3543,1,지나가는저글링,3462,128,4,2,6,66.7%,5m
3543,1,신민아,3462,0,0,2,2,0.0%,6m
3549,3,[SHIPS]Lancelot,3461,232,9,7,16,56.2%,16m
3549,2,동국대생,3461,127,8,2,10,80.0%,49m
3549,1,[리겔]워필드,3461,0,0,1,1,0.0%,6m
3552,1,[스코델라리오]builder,3460,200,5,4,9,55.6%,4m
3552,3,[무지개검알타]LTOP,3460,93,2,1,3,66.7%,3m
3552,3,솜사탕구름,3460,62,2,6,8,25.0%,10m
3555,3,damago,3459,384,66,58,124,53.2%,5m
3555,3,[Komica]MisterHYC,3459,678,30,37,67,44.8%,7m
3555,1,grow,3459,305,14,7,21,66.7%,10m
3555,3,낫슈,3459,90,3,9,12,25.0%,6m
3555,1,llllllllllll,3459,0,1,0,1,100.0%,6m
3555,1,바람처럼,3459,0,0,1,1,0.0%,4m
3561,1,edwinhyy,3458,1104,65,62,127,51.2%,8m
3561,3,CascabelJim,3458,1498,55,63,118,46.6%,6m
3561,1,북괴,3458,0,1,0,1,100.0%,8m
3561,2,Zenoblade,3458,0,1,1,2,50.0%,49m
3565,3,論論,3457,1522,149,149,298,50.0%,8m
3565,1,IIlllllllIl,3457,332,9,6,15,60.0%,6m
3565,1,[문재앙씨발놈]신안노예출신,3457,207,5,2,7,71.4%,10m
3565,1,[VASCO]pure,3457,0,0,1,1,0.0%,6m
3569,3,llllllllllll,3456,0,5,1,6,83.3%,50m
3570,3,Halla,3455,1535,197,175,372,53.0%,9m
3570,3,사나,3455,1432,64,73,137,46.7%,9m
3570,3,MyLongBow,3455,870,34,35,69,49.3%,7m
3570,1,Clannad,3455,105,4,4,8,50.0%,7m
3570,1,Terran,3455,0,1,0,1,100.0%,8m
3570,1,Blake,3455,0,0,1,1,0.0%,3m
3570,1,LuckyTiger,3455,0,0,1,1,0.0%,8m
3577,3,Kommt,3454,0,1,3,4,25.0%,9m
3578,1,Akua,3453,96,2,0,2,100.0%,47m
3578,1,[Dopen]Bolloong,3453,0,1,2,3,33.3%,6m
3578,1,구녕속자지놀림,3453,0,0,1,1,0.0%,8m
3581,3,Sadistic,3452,1333,397,368,765,51.9%,16m
3581,3,[미남이군]SpecialSTOM,3452,728,28,25,53,52.8%,10m
3581,1,XXLPANTS,3452,866,28,25,53,52.8%,6m
3581,1,왜띄어쓰기못함,3452,621,24,15,39,61.5%,4m
3585,1,BlueShrimp,3451,942,28,26,54,51.9%,10m
3586,1,일베충,3450,471,13,12,25,52.0%,4m
3586,3,[ARDBEG]탄이야놀자,3450,30,2,7,9,22.2%,8m
3588,3,IIIIIIIIIIII,3449,1002,76,75,151,50.3%,3m
3588,3,[ANGG]Magnesium,3449,1261,70,58,128,54.7%,7m
3588,3,[Hyper]AvoCado,3449,251,12,17,29,41.4%,8m
3588,3,[TeamNV]박서준,3449,258,9,17,26,34.6%,6m
3588,2,llllllllllll,3449,143,7,2,9,77.8%,49m
3588,1,monarch,3449,204,5,5,10,50.0%,3m
3588,1,king,3449,42,1,2,3,33.3%,6m
3595,3,봉군,3448,1170,138,149,287,48.1%,9m
3595,3,Ryobis,3448,1334,47,60,107,43.9%,8m
3595,3,Cassis,3448,219,11,5,16,68.8%,3m
3595,3,VoidKing,3448,170,4,7,11,36.4%,7m
3595,1,remind,3448,142,3,1,4,75.0%,10m
3595,2,GAPH,3448,95,2,0,2,100.0%,49m
3601,3,시체매의날개,3447,1530,312,314,626,49.8%,9m
3601,1,덜덜,3447,1773,178,154,332,53.6%,4m
3601,1,잔느,3447,475,28,21,49,57.1%,4m
3601,3,branchFC,3447,175,5,7,12,41.7%,10m
3605,3,VinDiesel,3446,559,20,29,49,40.8%,5m
3605,1,Dao,3446,624,18,13,31,58.1%,8m
3605,2,[TalenT]薯餅紳士,3446,140,4,0,4,100.0%,50m
3605,3,timeout,3446,0,0,1,1,0.0%,18m
3609,1,[메카]제우스,3445,815,26,22,48,54.2%,6m
3609,1,BOSS,3445,82,3,0,3,100.0%,16m
3611,1,[lnCo]GGnoRE,3444,0,5,0,5,100.0%,7m
3611,1,KING,3444,88,3,1,4,75.0%,4m
3611,1,[애니멀킹덤]노스랜드로동로봇,3444,0,2,3,5,40.0%,8m
3611,1,炎炎,3444,73,1,3,4,25.0%,3m
3615,3,자살충동자제,3443,276,10,15,25,40.0%,9m
3615,1,문재인,3443,118,4,1,5,80.0%,3m
3615,3,놀랄만한선박,3443,44,3,2,5,60.0%,50m
3615,2,classicyun,3443,0,3,4,7,42.9%,49m
3619,1,BLEss,3442,1063,84,62,146,57.5%,3m
3619,1,[TalenT]TWstrangner,3442,1523,62,40,102,60.8%,10m
3619,3,波哥,3442,891,42,52,94,44.7%,6m
3619,3,ShocK,3442,580,19,31,50,38.0%,9m
3619,1,KingDavid,3442,138,5,7,12,41.7%,7m
3619,3,InnoVation,3442,148,3,6,9,33.3%,9m
3619,3,llllllllllll,3442,30,1,6,7,14.3%,9m
3619,1,[NMH523]MfcGuru,3442,0,0,1,1,0.0%,16m
3627,3,Light,3441,1106,90,88,178,50.6%,16m
3627,1,백구,3441,337,21,15,36,58.3%,8m
3627,1,jack,3441,160,4,7,11,36.4%,10m
3627,1,[Lotuz]유니크,3441,96,2,1,3,66.7%,10m
3627,1,WinterFox,3441,0,1,0,1,100.0%,6m
3627,1,김사무엘,3441,0,1,0,1,100.0%,6m
3627,1,[잘먹고산다]JUSS,3441,0,0,3,3,0.0%,6m
3634,3,IIIIIIIII,3440,398,13,25,38,34.2%,10m
3634,1,안녕,3440,215,6,2,8,75.0%,8m
3636,3,KSM,3439,890,35,30,65,53.8%,7m
3636,2,troll,3439,304,15,8,23,65.2%,5m
3636,1,[ELS]희짱펀치,3439,364,14,6,20,70.0%,7m
3636,1,초코보숭이,3439,346,9,9,18,50.0%,4m
3636,3,테란개장인,3439,194,6,18,24,25.0%,6m
3636,1,공삼업건설로봇,3439,44,2,4,6,33.3%,6m
3636,1,TIKTOK,3439,0,1,0,1,100.0%,16m
3636,1,[항마쎾]항마는초아입니다,3439,0,0,1,1,0.0%,10m
3644,3,봥솨능의힘으로,3438,1477,141,146,287,49.1%,6m
3644,3,UndecLaredRH,3438,726,40,32,72,55.6%,7m
3644,1,IIIIIIIIII,3438,44,2,1,3,66.7%,3m
3644,1,박명수,3438,80,2,2,4,50.0%,6m
3644,1,[ELS]WhereisDk,3438,44,1,4,5,20.0%,5m
3649,1,카나데,3437,0,0,3,3,0.0%,6m
3650,3,[신나]Guild,3436,1562,113,103,216,52.3%,8m
3650,1,change,3436,455,57,33,90,63.3%,8m
3650,1,풍류,3436,630,21,16,37,56.8%,16m
3650,3,BlackStar,3436,120,11,9,20,55.0%,4m
3650,3,llllllllllll,3436,202,7,8,15,46.7%,3m
3650,1,[XYFANS]野人无敌囡囡鸡,3436,152,5,1,6,83.3%,5m
3656,1,asdsafws,3435,1052,100,89,189,52.9%,8m
3656,3,sangchi,3435,1245,65,50,115,56.5%,6m
3656,3,Purdue,3435,790,49,62,111,44.1%,6m
3656,3,[0I터널]Gonzo,3435,0,5,1,6,83.3%,18m
3656,1,IlIlIlIlIlIl,3435,0,1,0,1,100.0%,8m
3661,3,손정창,3434,516,42,41,83,50.6%,10m
3661,3,BrOkEn,3434,432,16,14,30,53.3%,7m
3661,1,IIIIIIIIIIII,3434,428,12,11,23,52.2%,4m
3661,1,[CIM]내가고자라니,3434,0,0,2,2,0.0%,4m
3665,1,Tentacle,3433,570,23,11,34,67.6%,10m
3665,1,abcb,3433,428,11,11,22,50.0%,4m
3667,3,[Dod]브란도,3432,116,5,8,13,38.5%,6m
3667,1,Borat,3432,0,3,3,6,50.0%,8m
3669,3,땡천할수있을까,3430,831,32,30,62,51.6%,7m
3669,2,dlalscks,3430,97,6,1,7,85.7%,49m
3669,1,TakEloT,3430,0,1,1,2,50.0%,7m
3672,3,[TeamSG]라면및음식,3429,202,8,21,29,27.6%,6m
3672,1,전태양그슬우승,3429,86,3,5,8,37.5%,7m
3674,3,supersecret,3428,1508,213,192,405,52.6%,6m
3674,1,파맛첵스,3428,245,7,8,15,46.7%,16m
3674,1,XingLH,3428,164,5,3,8,62.5%,4m
3674,1,호접몽,3428,78,2,1,3,66.7%,3m
3674,1,Star,3428,0,0,1,1,0.0%,48m
3679,3,분당고재범,3427,334,11,21,32,34.4%,9m
3679,3,[星宿]Nebula,3427,280,9,13,22,40.9%,3m
3679,1,JustBoxeR,3427,42,1,1,2,50.0%,8m
3682,3,IlIlIIlIlIlI,3426,145,7,1,8,87.5%,50m
3682,3,[어짜피제가짐]구왁안되,3426,192,7,17,24,29.2%,10m
3682,1,HunTer,3426,124,4,3,7,57.1%,3m
3682,1,sOmA,3426,86,2,3,5,40.0%,4m
3682,1,일제뒤져버러,3426,0,1,0,1,100.0%,6m
3682,1,selince,3426,38,1,1,2,50.0%,5m
3688,3,기계,3425,159,7,2,9,77.8%,51m
3688,1,하오우,3425,132,4,4,8,50.0%,16m
3688,1,llllllllllll,3425,84,3,1,4,75.0%,4m
3688,1,SilKanoN,3425,0,0,2,2,0.0%,6m
3692,1,Crow,3424,892,29,26,55,52.7%,4m
3692,3,[聽音]HeavyMetal,3424,466,15,27,42,35.7%,10m
3692,1,착한세균맨,3424,0,1,0,1,100.0%,6m
3695,3,stevetank,3423,1541,189,187,376,50.3%,7m
3695,3,nasica,3423,832,30,34,64,46.9%,5m
3695,1,STYLISH,3423,124,4,6,10,40.0%,6m
3695,2,Akai,3423,142,2,9,11,18.2%,49m
3695,1,ZiHyeon,3423,95,1,2,3,33.3%,4m
3695,1,Clock,3423,0,0,1,1,0.0%,4m
3701,3,가을의태란,3422,1534,270,282,552,48.9%,7m
3701,1,사도의유산,3422,810,28,22,50,56.0%,10m
3701,3,黄金脆皮油炸鸡,3422,295,11,10,21,52.4%,16m
3701,1,Noobb,3422,282,9,4,13,69.2%,3m
3701,1,귀신잡는마린,3422,80,2,4,6,33.3%,6m
3701,1,쿠바나입니다,3422,0,0,1,1,0.0%,7m
3707,1,홍이콩이,3421,307,8,7,15,53.3%,8m
3707,3,[무한오영종]llllllllllll,3421,44,1,1,2,50.0%,51m
3707,1,원준님,3421,0,0,3,3,0.0%,4m
3710,1,IlllllIlllll,3420,1465,215,187,402,53.5%,10m
3710,1,stew,3420,384,11,6,17,64.7%,7m
3710,1,IIIIIIIIIII,3420,84,3,3,6,50.0%,3m
3710,1,EVE,3420,42,1,4,5,20.0%,5m
3710,1,ngiru,3420,0,0,1,1,0.0%,7m
3715,3,PowerAnet,3419,1483,124,111,235,52.8%,10m
3715,1,PoTaTo,3419,1081,46,31,77,59.7%,3m
3715,3,ioppp,3419,184,8,16,24,33.3%,7m
3715,1,[iImba]llllllllllll,3419,0,5,0,5,100.0%,18m
3715,1,[爆蛋]扬总的好哥哥,3419,156,4,4,8,50.0%,6m
3715,1,BlackWing,3419,0,0,2,2,0.0%,6m
3721,1,Cbastian,3418,197,7,4,11,63.6%,4m
3721,3,hitomi,3418,0,1,1,2,50.0%,9m
3721,1,IIIIIIIIIIII,3418,0,1,2,3,33.3%,8m
3724,3,boxer,3417,1321,172,168,340,50.6%,8m
3724,3,[Beam]Setter,3417,0,1,0,1,100.0%,19m
3726,1,루비카란,3416,1149,82,68,150,54.7%,10m
3726,3,법성법성,3416,979,68,66,134,50.7%,9m
3726,3,Automaton,3416,488,17,25,42,40.5%,4m
3726,1,IIIIIIIIIIII,3416,358,10,11,21,47.6%,3m
3726,1,leekpil,3416,122,4,4,8,50.0%,16m
3726,1,[초보동맹]떠돌이,3416,0,0,2,2,0.0%,6m
3732,1,Monkjohnny,3415,1464,150,131,281,53.4%,3m
3732,3,[SHARP]쒸프트끼가빠쪘뗘,3415,1475,118,108,226,52.2%,5m
3732,3,기체판금지존,3415,1528,99,113,212,46.7%,9m
3732,1,그림자용,3415,1612,84,67,151,55.6%,3m
3732,3,TOUGH,3415,814,33,38,71,46.5%,9m
3732,1,[보돌]One,3415,114,4,4,8,50.0%,6m
3738,3,[사냥꾼]동족전안하는땅크,3414,705,24,28,52,46.2%,9m
3738,1,lovegame,3414,116,3,4,7,42.9%,6m
3738,1,어락귀,3414,0,1,5,6,16.7%,6m
3741,1,edwin,3413,756,25,23,48,52.1%,6m
3741,3,[CIM]Leece,3413,341,11,16,27,40.7%,16m
3741,1,FANXY,3413,305,8,4,12,66.7%,4m
3741,2,[cS]글로벌흥겜스타투,3413,124,4,19,23,17.4%,6m
3741,1,Jaga,3413,0,1,1,2,50.0%,7m
3746,1,포르쉐,3412,1559,91,60,151,60.3%,6m
3746,3,[M三I人]밀어댕기라,3412,1163,50,56,106,47.2%,9m
3746,1,[pepper]천공지뢰,3412,1256,45,35,80,56.2%,6m
3746,1,dager,3412,158,5,4,9,55.6%,10m
3746,1,DAETTO,3412,110,3,2,5,60.0%,16m
3746,1,UmOhAhYeh,3412,0,0,5,5,0.0%,8m
3752,3,[인투더]IntoTheLiMi,3411,1392,67,60,127,52.8%,16m
3752,3,이순신전략,3411,584,21,35,56,37.5%,5m
3752,2,[겨울방어]happyday,3411,162,4,7,11,36.4%,50m
3752,1,llllllllllll,3411,0,3,1,4,75.0%,3m
3752,3,IIIIIIIIIIII,3411,0,1,1,2,50.0%,9m
3752,1,어부지리,3411,0,0,1,1,0.0%,3m
3758,1,Venis,3410,884,40,16,56,71.4%,8m
3758,1,[협동으로가자]WBYYing,3410,329,11,4,15,73.3%,16m
3758,3,핑크공주님,3410,294,11,8,19,57.9%,6m
3758,2,하양물망초,3410,265,11,13,24,45.8%,5m
3758,1,[TS1998]PVSSY,3410,274,9,6,15,60.0%,6m
3758,1,Skeptical,3410,137,3,2,5,60.0%,48m
3758,3,[5torM]watchNlearn,3410,30,1,9,10,10.0%,10m
3758,1,Jupiter,3410,0,0,1,1,0.0%,6m
3766,3,Rapbar,3409,1521,144,152,296,48.6%,5m
3766,3,[MICH]IIIIIIIIIIII,3409,1056,98,97,195,50.3%,8m
3766,1,통조림,3409,0,0,1,1,0.0%,4m
3766,1,IntoThetoro,3409,73,0,5,5,0.0%,3m
3770,3,ONGGAMENET,3408,270,9,17,26,34.6%,6m
3770,3,LoribleStar,3408,97,2,0,2,100.0%,10m
3772,1,[라이머니]젊음을마셔요,3407,0,0,3,3,0.0%,4m
3773,1,[트위치리피아]주님한명또갑니다,3406,431,24,7,31,77.4%,7m
3773,1,[한타왕]씹던껌,3406,546,16,17,33,48.5%,8m
3773,3,lllllllIIIl,3406,219,10,8,18,55.6%,3m
3773,3,[이도류]부대찌게,3406,143,7,8,15,46.7%,5m
3773,3,Tara,3406,156,6,10,16,37.5%,6m
3773,1,[BHN]Rapier,3406,0,1,0,1,100.0%,6m
3773,1,nolimit,3406,0,0,1,1,0.0%,8m
3780,1,수지니야,3405,1255,52,34,86,60.5%,8m
3780,1,저그개씹사기,3405,814,23,29,52,44.2%,8m
3780,1,tom,3405,491,22,9,31,71.0%,7m
3780,1,Trash,3405,42,2,2,4,50.0%,8m
3780,1,Ladder,3405,0,0,1,1,0.0%,3m
3785,3,청주파,3404,1429,206,187,393,52.4%,6m
3785,1,llllllllll,3404,991,45,37,82,54.9%,4m
3785,1,Eier,3404,1133,38,42,80,47.5%,4m
3785,1,Anastasia,3404,790,28,25,53,52.8%,3m
3785,1,goods,3404,878,26,30,56,46.4%,6m
3785,1,스트라스블룸,3404,0,3,2,5,60.0%,18m
3785,1,llIllIllIllI,3404,0,1,0,1,100.0%,7m
3785,1,whiteghost,3404,0,1,0,1,100.0%,6m
3785,1,[녹두무럭무럭]lIlIlIlIlI,3404,0,1,1,2,50.0%,4m
3785,1,qpwo,3404,0,1,2,3,33.3%,4m
3785,1,LAmpav,3404,0,1,3,4,25.0%,6m
3796,1,llllllllllll,3403,1737,436,426,862,50.6%,8m
3796,3,살사킹,3403,1528,274,254,528,51.9%,10m
3796,1,llllllllllll,3403,307,13,7,20,65.0%,3m
3796,1,Eureka,3403,454,13,13,26,50.0%,7m
3800,3,lllllllll,3402,1507,76,85,161,47.2%,5m
3800,1,Anonymous,3402,1333,50,42,92,54.3%,5m
3800,1,MicroMarine,3402,265,8,4,12,66.7%,6m
3800,1,[반콩성반퉁퉁]시즈탕쿠,3402,274,8,7,15,53.3%,4m
3800,1,Ayac,3402,88,6,0,6,100.0%,16m
3800,1,Starphase,3402,0,4,1,5,80.0%,8m
3800,1,chobo,3402,160,4,8,12,33.3%,4m
3807,3,asd,3401,999,173,164,337,51.3%,7m
3807,3,[아이라잌치킨]HedgeHog,3401,542,17,31,48,35.4%,16m
3807,1,bey,3401,0,0,1,1,0.0%,6m
3810,3,쇼미더머니,3400,1385,55,52,107,51.4%,9m
3810,1,[伊蕾娜]llllllllllll,3400,183,6,0,6,100.0%,16m
3810,1,Tristan,3400,0,0,1,1,0.0%,5m
3813,3,neurobacter,3399,824,87,76,163,53.4%,7m
3813,1,묘야,3399,571,24,17,41,58.5%,3m
3813,1,[Gavin]Gavin,3399,292,9,7,16,56.2%,7m
3813,2,GGurTwoEz,3399,96,6,3,9,66.7%,50m
3813,1,이자성,3399,80,2,2,4,50.0%,4m
3818,1,[고급천문대]베어그릴스,3398,231,8,6,14,57.1%,7m
3818,1,[Reveal]나경주,3398,284,7,9,16,43.8%,6m
3818,1,INnOcEnTly,3398,36,5,2,7,71.4%,6m
3818,1,[mandoo]눈물젖은달빛,3398,0,4,1,5,80.0%,8m
3818,3,llllllllllll,3398,97,2,0,2,100.0%,19m
3823,3,[한클랜]BlueDay,3397,1503,273,280,553,49.4%,5m
3823,1,LYMLYMLYMLYM,3397,632,22,23,45,48.9%,8m
3823,3,BALLMAN,3397,312,11,17,28,39.3%,5m
3823,1,동글이,3397,342,10,6,16,62.5%,4m
3823,1,오길애,3397,290,10,7,17,58.8%,16m
3823,1,Sovietilia,3397,144,9,1,10,90.0%,10m
3829,1,IRISnine,3396,823,26,30,56,46.4%,4m
3829,1,Ilectric,3396,638,24,16,40,60.0%,6m
3831,1,RoYal,3395,262,8,8,16,50.0%,6m
3831,1,台北的春天,3395,44,2,0,2,100.0%,4m
3831,1,[lPZ223]안진마,3395,0,2,3,5,40.0%,18m
3834,1,sos,3394,1254,66,61,127,52.0%,8m
3834,1,CLU,3394,158,7,3,10,70.0%,7m
3834,1,acttyoyo,3394,0,0,1,1,0.0%,7m
3837,1,hansko,3393,248,9,10,19,47.4%,4m
3838,3,jmf,3392,1384,57,50,107,53.3%,10m
3838,1,redwine,3392,117,6,4,10,60.0%,8m
3838,1,IlIlllIIlIlI,3392,264,6,4,10,60.0%,6m
3838,1,螢雪之功,3392,0,3,3,6,50.0%,7m
3838,1,김진평,3392,0,0,1,1,0.0%,3m
3838,1,IIIIIIIIII,3392,0,0,3,3,0.0%,7m
3844,1,LsIk,3391,1363,52,49,101,51.5%,7m
3844,3,[방심과안일함]메뚜기,3391,146,7,2,9,77.8%,51m
3844,1,pjospoul,3391,88,5,1,6,83.3%,5m
3847,1,LiBeRtY,3390,1603,78,59,137,56.9%,7m
3847,3,[무한오영종]넋두리,3390,688,22,44,66,33.3%,9m
3847,1,[l아군l]HydraLisk,3390,410,12,14,26,46.2%,4m
3847,3,Kanpo,3390,100,3,15,18,16.7%,5m
3847,1,Storm,3390,38,1,2,3,33.3%,8m
3852,1,[SaMaGi]Melon,3389,116,4,4,8,50.0%,4m
3852,1,[isnous]SaberJoy,3389,0,0,1,1,0.0%,5m
3854,3,ABC,3388,1505,110,102,212,51.9%,5m
3854,3,Archtanis,3388,1330,55,58,113,48.7%,9m
3854,1,grimZ,3388,399,54,38,92,58.7%,3m
3854,1,Temo,3388,80,3,1,4,75.0%,7m
3854,1,PonnyRain,3388,40,2,2,4,50.0%,3m
3854,1,[NLTN]짐네이년,3388,40,1,2,3,33.3%,4m
3854,1,[Aster]GslDiamond,3388,0,0,1,1,0.0%,7m
3854,1,BrightFuture,3388,0,0,1,1,0.0%,8m
3854,1,Calla,3388,0,0,1,1,0.0%,4m
3863,3,VelvetSky,3387,1481,74,71,145,51.0%,6m
3863,1,lllllIlll,3387,924,27,33,60,45.0%,7m
3863,1,[Lotuz]vividrabbit,3387,590,18,15,33,54.5%,3m
3863,1,[별빛암흑기사]스타원신이다,3387,0,0,1,1,0.0%,6m
3867,1,sic,3386,307,13,7,20,65.0%,8m
3867,3,[확장파]deltA,3386,259,10,9,19,52.6%,16m
3867,1,듀란팽,3386,240,6,12,18,33.3%,16m
3867,1,siro,3386,0,1,0,1,100.0%,4m
3871,3,YOU,3385,1548,149,147,296,50.3%,5m
3871,3,어벤져,3385,1450,85,93,178,47.8%,6m
3871,1,[우유통]왕수박,3385,1074,60,55,115,52.2%,16m
3871,1,AED,3385,686,21,21,42,50.0%,6m
3871,1,Gosaboo,3385,403,11,11,22,50.0%,3m
3871,1,Soul,3385,0,0,1,1,0.0%,10m
3877,3,llllllllllll,3384,1540,221,211,432,51.2%,9m
3877,3,lillillill,3384,774,65,64,129,50.4%,5m
3877,1,[銅牌上不去]llBULY,3384,301,7,7,14,50.0%,16m
3880,1,[Ming]震天火,3383,1110,39,41,80,48.8%,3m
3880,3,해병만뽑는다,3383,901,36,44,80,45.0%,7m
3880,1,windyprotoss,3383,804,24,27,51,47.1%,5m
3880,1,skek,3383,119,6,1,7,85.7%,16m
3880,1,[RvL]hippo,3383,0,1,0,1,100.0%,6m
3885,1,llllllllllll,3382,826,24,28,52,46.2%,3m
3885,1,llllllllllll,3382,0,0,1,1,0.0%,3m
3887,1,IIIIIIIIII,3381,787,36,28,64,56.2%,7m
3887,1,IIIIIIIIIIII,3381,459,19,8,27,70.4%,3m
3887,3,반짝이는영웅,3381,385,17,15,32,53.1%,16m
3887,2,툼바,3381,167,8,4,12,66.7%,50m
3887,1,tong,3381,0,1,0,1,100.0%,5m
3887,1,[넥서스]고등어,3381,0,0,1,1,0.0%,4m
3893,1,텅텅빈내지갑,3380,1495,92,83,175,52.6%,16m
3893,1,Rust,3380,757,29,23,52,55.8%,4m
3895,1,[KRH]BoxeR,3379,1122,37,39,76,48.7%,7m
3895,1,Hellmaster,3379,164,5,5,10,50.0%,8m
3897,1,아너스빌,3378,1411,51,46,97,52.6%,6m
3897,1,TGWall,3378,1038,32,36,68,47.1%,16m
3897,1,Nizoral,3378,143,7,4,11,63.6%,48m
3897,1,[TNC]qhdgusdlqsle,3378,0,0,1,1,0.0%,7m
3901,1,lllllll,3377,1199,102,103,205,49.8%,7m
3901,1,[2029]HisuMi,3377,941,51,35,86,59.3%,3m
3901,1,내가뭘하든알바,3377,370,17,10,27,63.0%,3m
3901,1,버스,3377,382,15,14,29,51.7%,8m
3901,1,저그왕,3377,286,8,14,22,36.4%,7m
3901,1,Dekalkomania,3377,36,2,1,3,66.7%,5m
3907,1,아이언맨,3376,746,49,48,97,50.5%,7m
3907,1,누후훗아빡이에요,3376,361,15,9,24,62.5%,8m
3907,1,ryufgefd,3376,277,13,4,17,76.5%,5m
3907,3,[랜타디광]박사아들,3376,146,7,2,9,77.8%,19m
3907,1,Zero,3376,119,4,6,10,40.0%,3m
3907,1,NameEnZo,3376,106,2,1,3,66.7%,7m
3907,1,저그버프좀,3376,0,0,1,1,0.0%,7m
3914,3,나대면털림,3375,380,26,30,56,46.4%,5m
3914,1,llllllllll,3375,270,7,10,17,41.2%,3m
3914,1,사그패밀리,3375,205,4,4,8,50.0%,10m
3914,2,blueDEVIL,3375,0,0,2,2,0.0%,50m
3918,1,[맢레스토랑스]윤남규,3374,1649,218,206,424,51.4%,16m
3918,3,[Lotuz]WhiteBalance,3374,1160,88,96,184,47.8%,8m
3918,1,SangDoo,3374,1275,67,68,135,49.6%,8m
3918,1,Munyurat,3374,105,2,1,3,66.7%,8m
3918,1,IIIIIIIIIIII,3374,40,2,3,5,40.0%,7m
3923,1,ursula,3373,294,18,8,26,69.2%,5m
3923,1,llllllllllll,3373,398,18,14,32,56.2%,8m
3923,1,아이유,3373,40,1,2,3,33.3%,8m
3923,1,허롤랄라,3373,40,1,5,6,16.7%,7m
3923,3,Eoss,3373,0,0,1,1,0.0%,50m
3923,1,광주광역시박종덕,3373,0,0,1,1,0.0%,5m
3929,1,comm,3372,1691,94,92,186,50.5%,4m
3929,1,ShinyLight,3372,1307,50,51,101,49.5%,7m
3929,1,AirKiller,3372,909,44,17,61,72.1%,3m
3929,3,문학적인이름,3372,302,16,13,29,55.2%,10m
3929,1,[霸圖]LarK,3372,211,7,3,10,70.0%,6m
3929,1,hydrauser,3372,0,4,1,5,80.0%,17m
3929,1,HerO,3372,143,4,2,6,66.7%,6m
3929,1,SneakyTurtle,3372,105,3,0,3,100.0%,6m
3929,1,감자,3372,48,2,0,2,100.0%,17m
3929,1,oGcUss,3372,0,1,0,1,100.0%,18m
3929,1,北條悟史,3372,0,0,2,2,0.0%,4m
3940,1,[매너플레이어]FINALY,3371,1118,75,63,138,54.3%,6m
3940,1,saranghae,3371,676,20,19,39,51.3%,8m
3940,1,[丨SLT丨]BrianMay,3371,132,2,2,4,50.0%,4m
3940,1,[TITSQ]AprilRyanTT,3371,0,0,1,1,0.0%,8m
3944,1,레녹스,3370,1663,71,61,132,53.8%,10m
3944,1,[뽀뽀잖아혀빼]GrrrrrJi,3370,320,13,9,22,59.1%,3m
3944,1,Water,3370,287,9,5,14,64.3%,4m
3944,1,Brasida,3370,88,3,1,4,75.0%,8m
3944,1,namunet,3370,110,2,1,3,66.7%,7m
3944,1,[인투더]IntoTheNero,3370,0,0,1,1,0.0%,17m
3944,3,짝뚜는빵떠기,3370,0,0,2,2,0.0%,50m
3944,1,SryNoob,3370,0,0,3,3,0.0%,5m
3952,1,조커,3369,144,7,2,9,77.8%,3m
3952,1,bleu,3369,88,2,0,2,100.0%,4m
3952,1,간바리마스,3369,40,2,1,3,66.7%,5m
3952,1,BennBeckman,3369,0,0,1,1,0.0%,6m
3956,3,iiiiiiii,3368,1564,344,344,688,50.0%,8m
3956,1,[오인용돼지]이정샛별,3368,580,60,43,103,58.3%,4m
3956,1,[CIM]fidodidoK,3368,378,10,14,24,41.7%,5m
3956,1,야심찬총각,3368,154,4,5,9,44.4%,5m
3956,1,llllllllllll,3368,40,1,2,3,33.3%,6m
3961,1,[승급하면진화]야도란,3367,627,51,44,95,53.7%,7m
3961,1,llllllllllll,3367,376,20,8,28,71.4%,7m
3961,1,FaulteR,3367,0,1,0,1,100.0%,17m
3961,1,[my]mylady,3367,0,0,2,2,0.0%,6m
3965,1,[快樂玩家]南雲忠一,3366,193,6,4,10,60.0%,7m
3965,1,hyoung,3366,198,5,3,8,62.5%,5m
3967,1,여자친구예린,3365,91,2,0,2,100.0%,5m
3967,1,teddybear,3365,0,0,6,6,0.0%,16m
3969,1,Blank,3364,0,4,1,5,80.0%,16m
3970,1,김대훈,3363,0,1,0,1,100.0%,7m
3971,1,[맢레스토랑스]Sivert,3362,1463,110,87,197,55.8%,7m
3971,1,[Notice]즐기자,3362,1712,88,81,169,52.1%,4m
3971,1,곽비누,3362,842,37,31,68,54.4%,6m
3971,1,MtK,3362,626,23,17,40,57.5%,3m
3971,2,[인투더]IntoTheUmi,3362,153,9,5,14,64.3%,50m
3971,1,[sheep8]인턴아저씨,3362,38,1,3,4,25.0%,5m
3971,1,늙어서맵리안됨,3362,0,0,1,1,0.0%,6m
3978,3,llllllllllll,3361,1350,72,53,125,57.6%,5m
3978,3,[ProTT]kakarrot,3361,1264,56,49,105,53.3%,6m
3978,1,[Rush]SKY,3361,838,25,31,56,44.6%,5m
3981,1,Carte,3360,368,11,10,21,52.4%,7m
3981,1,plopzz,3360,245,10,6,16,62.5%,10m
3981,1,정글쥬스,3360,236,6,10,16,37.5%,7m
3981,1,llllllllllll,3360,48,2,2,4,50.0%,48m
3981,2,hunter,3360,0,0,1,1,0.0%,4m
3986,2,[PinkPi]LittlePony,3359,189,8,3,11,72.7%,10m
3986,3,kjwtenic,3359,109,4,10,14,28.6%,16m
3986,2,김도유,3359,0,1,5,6,16.7%,50m
3986,2,닉넴이뻐봤자플레,3359,0,0,1,1,0.0%,5m
3990,1,짐레이너,3358,1248,52,42,94,55.3%,6m
3990,2,Graupel,3358,426,17,9,26,65.4%,7m
3990,1,MHHM,3358,188,8,2,10,80.0%,46m
3990,1,[OIM8]Spectrum,3358,88,2,6,8,25.0%,7m
3990,1,아이린,3358,40,1,4,5,20.0%,7m
3995,1,折磨韩国人,3357,749,41,14,55,74.5%,7m
3995,1,WOZ,3357,739,28,22,50,56.0%,3m
3995,1,[시럽]Hanu,3357,0,1,1,2,50.0%,6m
3995,1,snsahfk,3357,0,0,2,2,0.0%,3m
3999,3,KraftStar,3356,1492,263,253,516,51.0%,9m
3999,2,[3Julia]MambaOut,3356,0,0,1,1,0.0%,4m
3999,2,케리건,3356,0,0,1,1,0.0%,10m
3999,1,한국사람,3356,0,0,2,2,0.0%,7m
4003,1,[Equal]경상도군인,3355,1334,48,45,93,51.6%,7m
4003,3,Only,3355,274,13,10,23,56.5%,9m
4003,1,repygo,3355,0,0,2,2,0.0%,8m
4006,3,[애니멀킹덤]chrollo,3354,551,43,34,77,55.8%,7m
4006,1,hoNey,3354,420,13,15,28,46.4%,5m
4006,1,IIIIIIIIIIII,3354,199,6,3,9,66.7%,8m
4006,2,조류아냐,3354,0,0,1,1,0.0%,5m
4010,1,水鬼,3353,1678,67,53,120,55.8%,8m
4010,1,回歸玩家,3353,0,5,1,6,83.3%,7m
4010,2,[달팽이]짱짱한달팽이,3353,158,5,3,8,62.5%,8m
4010,2,[SQBA]FirstRed,3353,0,0,1,1,0.0%,8m
4014,2,[Kyou9]AnotherBirth,3352,1594,130,124,254,51.2%,8m
4014,3,Velvet,3352,1435,121,112,233,51.9%,4m
4014,1,Noispaxen,3352,263,11,6,17,64.7%,4m
4014,1,김또이,3352,361,10,9,19,52.6%,8m
4014,1,sfdarrr,3352,256,9,15,24,37.5%,16m
4014,1,[스텔라]아싸라비요,3352,121,7,0,7,100.0%,26m
4014,3,llllllllllll,3352,121,7,1,8,87.5%,50m
4014,1,[CA]IIlllllIllll,3352,135,4,2,6,66.7%,5m
4014,1,llllllllllll,3352,102,3,2,5,60.0%,10m
4014,2,[SBD]납짝만두,3352,0,0,1,1,0.0%,7m
4024,3,[NFam]정일현,3351,947,56,51,107,52.3%,8m
4024,1,밍밍,3351,546,18,17,35,51.4%,8m
4024,1,킬러맨의꿈,3351,499,17,16,33,51.5%,6m
4024,1,BigDickEddy,3351,363,16,7,23,69.6%,10m
4024,2,[DVS]陪練機器,3351,34,2,0,2,100.0%,5m
4024,1,Illlllllllll,3351,40,1,3,4,25.0%,16m
4030,3,Sign,3350,696,61,50,111,55.0%,8m
4030,1,[겨울방어]저그야캐요,3350,547,22,14,36,61.1%,8m
4030,2,kamisama,3350,343,18,13,31,58.1%,7m
4030,1,[경기도양주]빠키룰루,3350,197,7,5,12,58.3%,8m
4030,1,Imhere,3350,96,6,2,8,75.0%,17m
4030,2,지면음료수사온나,3350,0,2,3,5,40.0%,9m
4036,1,마음,3349,1160,162,129,291,55.7%,16m
4036,1,[500원]앙기모찌요,3349,268,8,6,14,57.1%,16m
4036,3,VIP,3349,30,4,6,10,40.0%,9m
4036,1,[寄生虫]기생충,3349,0,1,0,1,100.0%,47m
4036,2,근사한컨트롤,3349,0,0,1,1,0.0%,9m
4041,1,시황제,3348,356,15,7,22,68.2%,3m
4042,3,gggggggg,3347,1343,62,60,122,50.8%,9m
4042,2,뎅뎅이,3347,142,3,2,5,60.0%,49m
4042,2,[NsP]InHerIToR,3347,0,1,0,1,100.0%,9m
4042,2,[테란주의보]국내산시멘트,3347,0,1,0,1,100.0%,5m
4042,2,llIIlIlIlIlI,3347,0,1,0,1,100.0%,5m
4047,1,Style,3346,0,0,5,5,0.0%,8m
4048,1,맹공,3345,1489,277,236,513,54.0%,6m
4048,1,Adidas,3345,1501,61,52,113,54.0%,16m
4048,1,llllllllllll,3345,158,5,3,8,62.5%,3m
4048,2,[총검히야아악]Dena,3345,40,2,0,2,100.0%,5m
4048,1,Neugrad,3345,90,2,1,3,66.7%,7m
4048,3,llllllllllll,3345,139,2,3,5,40.0%,51m
4048,2,Obersoldaten,3345,0,0,2,2,0.0%,5m
4055,1,KeiFromNYC,3344,1209,84,83,167,50.3%,4m
4055,3,llIIllllllll,3344,1251,49,53,102,48.0%,5m
4055,1,롤리팝,3344,612,44,31,75,58.7%,16m
4055,1,knightzz,3344,670,21,28,49,42.9%,4m
4055,2,Brave,3344,30,1,1,2,50.0%,9m
4060,2,Sylvanaslyz,3343,168,9,3,12,75.0%,9m
4060,1,[ScoutB]control,3343,82,3,4,7,42.9%,7m
4060,1,kingslove,3343,0,0,6,6,0.0%,3m
4063,3,Moleia,3342,557,91,79,170,53.5%,3m
4063,1,Factory,3342,462,18,12,30,60.0%,7m
4063,2,Silla,3342,58,2,1,3,66.7%,5m
4063,2,lllIIIlll,3342,0,1,0,1,100.0%,4m
4067,3,[대령]대령,3341,1567,831,807,1638,50.7%,16m
4067,1,[ROCno1]louisliao,3341,491,22,12,34,64.7%,6m
4067,1,[Myoui]Minaaarii,3341,245,15,13,28,53.6%,3m
4067,2,IIIIIIIIII,3341,132,7,1,8,87.5%,10m
4067,1,[Detect]ssol,3341,104,2,3,5,40.0%,4m
4067,2,Megumin,3341,0,2,3,5,40.0%,10m
4067,2,IllIlIlIlIll,3341,0,1,0,1,100.0%,5m
4067,1,김지연,3341,42,1,10,11,9.1%,6m
4067,2,IIIIIIIIIlII,3341,0,0,1,1,0.0%,5m
4067,1,ggoo,3341,0,0,2,2,0.0%,7m
4077,2,올웨이즈러블리즈,3340,461,20,11,31,64.5%,9m
4077,1,iiiiiiiiiiii,3340,478,13,17,30,43.3%,3m
4077,2,fffasdfasdfa,3340,239,10,6,16,62.5%,50m
4077,1,[14NY]DarkTempler,3340,254,8,9,17,47.1%,4m
4077,1,[네임]ZawszeInLove,3340,84,2,4,6,33.3%,3m
4077,2,Sri,3340,0,0,1,1,0.0%,9m
4077,2,tanos,3340,0,0,1,1,0.0%,8m
4084,1,[일반인원탑]홍익대학교,3339,867,37,27,64,57.8%,16m
4084,1,killilk,3339,239,9,4,13,69.2%,3m
4084,2,WayTooEZ,3339,140,6,1,7,85.7%,7m
4084,1,[NGameS]Namic,3339,206,6,4,10,60.0%,6m
4084,2,진탱,3339,138,3,0,3,100.0%,50m
4084,2,[해병대]백종규,3339,0,1,0,1,100.0%,10m
4090,1,스페이드,3338,396,19,22,41,46.3%,16m
4090,1,ATHOUSAND,3338,599,18,18,36,50.0%,6m
4090,2,BigDixk,3338,86,3,2,5,60.0%,9m
4090,2,MicroMarine,3338,30,2,0,2,100.0%,5m
4090,1,임전무,3338,0,0,3,3,0.0%,7m
4095,1,[开打星战前夜]SantaMonica,3337,576,43,37,80,53.8%,5m
4095,1,라떼,3337,157,4,4,8,50.0%,8m
4097,1,ETHAN,3336,1544,118,97,215,54.9%,7m
4097,2,김뱡가,3336,92,4,2,6,66.7%,8m
4097,3,엘소드만세다,3336,0,0,1,1,0.0%,6m
4097,1,gagoman,3336,0,0,5,5,0.0%,16m
4101,3,IIIIIIIIIIII,3335,1520,402,405,807,49.8%,7m
4101,1,[섬광]베틀전함,3335,952,29,34,63,46.0%,16m
4101,1,[lI]프로토스노답사기,3335,592,22,21,43,51.2%,6m
4101,1,수앤건,3335,260,8,8,16,50.0%,5m
4101,1,[다이아몬드]사시미,3335,245,6,6,12,50.0%,10m
4106,3,SpotLight,3334,418,59,60,119,49.6%,6m
4106,2,[공살]llllllllllll,3334,169,5,1,6,83.3%,49m
4106,1,BlueRose,3334,120,4,5,9,44.4%,4m
4106,1,Izsha,3334,0,0,1,1,0.0%,16m
4110,1,[IWYDI]NinetyFive,3333,1223,88,80,168,52.4%,6m
4110,1,llllllllllll,3333,433,36,36,72,50.0%,5m
4110,1,DieHarD,3333,748,26,23,49,53.1%,6m
4110,1,[海膽王]夏色祭單推人,3333,220,8,5,13,61.5%,8m
4110,2,MrSpin,3333,122,4,2,6,66.7%,9m
4110,2,SKYterran,3333,0,1,0,1,100.0%,5m
4116,1,[SimpIe]이카루스,3332,694,32,26,58,55.2%,8m
4116,2,셰프도현,3332,490,23,9,32,71.9%,4m
4116,2,두바,3332,254,12,5,17,70.6%,10m
4116,1,쬐뻔깨,3332,89,5,2,7,71.4%,6m
4116,2,[트수Crew]바로바로,3332,0,1,1,2,50.0%,9m
4116,1,[DwArP]ReFReSH,3332,0,0,4,4,0.0%,6m
4122,3,Heaven,3331,795,231,240,471,49.0%,9m
4122,1,[친클]Jacobs,3331,874,39,37,76,51.3%,6m
4122,2,[FoIIow]poxxhub,3331,0,1,0,1,100.0%,4m
4122,1,[YONSEI]DABO,3331,38,1,6,7,14.3%,6m
4122,1,toph,3331,0,0,1,1,0.0%,18m
4127,3,[Care]HalfNHalf,3330,1460,135,127,262,51.5%,16m
4128,1,ILILILILI,3329,1617,120,104,224,53.6%,8m
4128,1,ZeuS,3329,1100,41,32,73,56.2%,3m
4128,2,TimeFans,3329,651,34,22,56,60.7%,8m
4128,2,Wasabi,3329,446,33,22,55,60.0%,5m
4128,1,[Old]RulerChen,3329,223,13,3,16,81.2%,8m
4128,1,[제니스]소주엔삼겹살,3329,97,2,0,2,100.0%,18m
4128,2,阿帕查,3329,34,2,0,2,100.0%,3m
4128,2,신기루,3329,0,0,1,1,0.0%,9m
4128,1,DoDoYND,3329,0,0,4,4,0.0%,5m
4137,1,Fantomas,3328,1647,188,186,374,50.3%,4m
4137,2,[원빈]원빈처럼고수처럼,3328,706,23,52,75,30.7%,3m
4137,2,TheNewTimes,3328,364,16,3,19,84.2%,5m
4137,1,Stone,3328,157,10,7,17,58.8%,3m
4137,2,Banker,3328,145,7,3,10,70.0%,7m
4137,2,얼루기,3328,60,6,2,8,75.0%,10m
4137,2,[무말랭이]울산대머리,3328,188,6,8,14,42.9%,16m
4137,2,[유인나]내루미,3328,30,1,3,4,25.0%,10m
4145,1,AllenK,3327,1136,216,194,410,52.7%,6m
4145,1,Quantum,3327,587,24,18,42,57.1%,6m
4145,1,IlIIlIIlIIl,3327,195,7,5,12,58.3%,8m
4148,2,망령,3326,266,9,8,17,52.9%,9m
4148,1,[BarCO]TinSoldier,3326,180,8,2,10,80.0%,48m
4148,2,llllllllllll,3326,30,5,1,6,83.3%,5m
4148,1,데미져,3326,97,5,1,6,83.3%,16m
4152,1,권형,3325,1675,231,217,448,51.6%,6m
4152,1,레스토랑스,3325,1676,60,60,120,50.0%,16m
4152,1,머슬몬스터,3325,70,2,5,7,28.6%,16m
4152,3,정나름,3325,0,0,3,3,0.0%,5m
4156,1,오버워치,3324,718,32,22,54,59.3%,8m
4156,2,대군주가안뽑아져,3324,30,1,1,2,50.0%,5m
4156,2,Say,3324,0,0,1,1,0.0%,7m
4159,2,활활태워라,3323,698,49,38,87,56.3%,5m
4160,1,Bellaluna,3322,1542,165,175,340,48.5%,7m
4160,1,yoman,3322,1115,98,82,180,54.4%,3m
4160,1,Joeyy,3322,631,75,74,149,50.3%,4m
4160,2,자객섭은낭,3322,119,3,2,5,60.0%,49m
4160,2,Sio,3322,94,2,0,2,100.0%,50m
4160,2,짠소금,3322,0,1,0,1,100.0%,10m
4166,2,DeLorean,3321,0,4,1,5,80.0%,9m
4166,2,Akatsuki,3321,86,4,3,7,57.1%,5m
4166,3,ShowHoPe,3321,120,3,3,6,50.0%,4m
4166,2,자러감수고바위,3321,0,1,4,5,20.0%,9m
4166,2,이리드,3321,0,0,1,1,0.0%,7m
4171,2,[NGameS]해병왕하오,3320,196,7,3,10,70.0%,7m
4171,2,[미술교실]sherlock,3320,0,0,1,1,0.0%,5m
4173,1,Pugeun,3319,786,141,124,265,53.2%,5m
4173,1,Maverick,3319,1542,59,64,123,48.0%,8m
4173,2,[질병]질병관리본부국장,3319,814,30,28,58,51.7%,8m
4173,2,[래핑코빈]코스모스,3319,633,26,16,42,61.9%,3m
4173,1,식이당,3319,797,26,25,51,51.0%,5m
4173,2,BebekGelo,3319,232,9,4,13,69.2%,9m
4173,1,roboEarth,3319,159,7,5,12,58.3%,8m
4173,2,루키포,3319,88,4,2,6,66.7%,10m
4173,2,CooooooooooL,3319,65,3,5,8,37.5%,8m
4173,2,유녕준,3319,0,0,1,1,0.0%,7m
4173,2,llllllIIlllI,3319,0,0,1,1,0.0%,8m
4184,2,[백수라이프]Inverse,3318,700,25,23,48,52.1%,5m
4184,2,uno,3318,0,1,0,1,100.0%,5m
4184,1,Nanyakhae,3318,0,1,2,3,33.3%,4m
4184,2,dskgfl,3318,0,0,1,1,0.0%,4m
4188,2,[NCKU]王小虎,3317,396,21,1,22,95.5%,5m
4188,3,맹밍,3317,186,6,5,11,54.5%,7m
4188,2,Jay,3317,152,5,4,9,55.6%,5m
4188,2,tomorrow,3317,92,3,4,7,42.9%,5m
4192,1,IlIlIIllIlIl,3316,1248,53,39,92,57.6%,8m
4192,1,[대나무]죽창,3316,639,31,29,60,51.7%,8m
4192,2,[TYWay]Bronze,3316,602,25,16,41,61.0%,5m
4192,1,ButterdToast,3316,264,10,6,16,62.5%,5m
4192,1,프로토스,3316,0,5,1,6,83.3%,17m
4192,2,Ace,3316,0,4,1,5,80.0%,5m
4192,1,MephistO,3316,76,3,6,9,33.3%,6m
4192,1,흑인,3316,86,3,9,12,25.0%,8m
4192,2,푸른숨결,3316,0,1,0,1,100.0%,5m
4201,1,맛있는야돈,3315,0,4,1,5,80.0%,18m
4201,1,IamAjin,3315,0,4,2,6,66.7%,8m
4203,2,[OldMen]MacroS,3314,1174,53,38,91,58.2%,10m
4203,2,Rusien,3314,176,6,3,9,66.7%,7m
4203,1,[막강]기사단장,3314,154,5,9,14,35.7%,16m
4203,2,득탁탁득득탁,3314,36,1,3,4,25.0%,5m
4207,1,iris,3313,1690,122,106,228,53.5%,6m
4207,2,[래더납치범]스타는너무어려워,3313,728,26,26,52,50.0%,5m
4207,3,[迷宮]EsCaPewAy,3313,145,3,2,5,60.0%,19m
4207,1,lKinglKazma,3313,0,1,3,4,25.0%,16m
4211,3,거스준,3312,1508,235,222,457,51.4%,16m
4211,2,Saint,3312,368,17,12,29,58.6%,10m
4211,1,[快樂玩家]童汁戀精豎濕,3312,476,16,17,33,48.5%,16m
4211,1,이동골,3312,320,9,13,22,40.9%,6m
4211,1,aesthetics,3312,193,8,4,12,66.7%,47m
4211,1,IIIlIIIIlIII,3312,134,7,3,10,70.0%,3m
4211,2,jeff,3312,119,6,6,12,50.0%,9m
4211,2,[DoBTeN]Yee,3312,0,0,1,1,0.0%,9m
4219,3,[LCMS]CrossFire,3311,1091,212,199,411,51.6%,7m
4219,1,[lZONE]김민주,3311,1548,174,153,327,53.2%,6m
4219,1,파이의파이,3311,491,21,13,34,61.8%,6m
4219,1,나가,3311,292,9,11,20,45.0%,6m
4219,2,Potti,3311,58,5,4,9,55.6%,5m
4219,2,만주찐빵,3311,0,0,1,1,0.0%,5m
4219,2,니가가라하와이,3311,0,0,1,1,0.0%,5m
4226,2,[CatBad]MarsuPilami,3310,1395,65,46,111,58.6%,4m
4226,1,mujuck,3310,562,29,26,55,52.7%,5m
4226,2,[UOS]꼬부기,3310,313,14,6,20,70.0%,10m
4226,2,나홀로스타,3310,0,0,1,1,0.0%,5m
4230,3,Ramadian,3309,1476,245,195,440,55.7%,9m
4230,2,브리부리,3309,1181,60,54,114,52.6%,16m
4230,2,[Divo]cmsandy,3309,196,8,3,11,72.7%,16m
4230,1,WSLnNUclear,3309,208,7,10,17,41.2%,8m
4230,2,[한타왕]건설로봇,3309,124,4,3,7,57.1%,4m
4235,1,fairplay,3307,1194,54,56,110,49.1%,6m
4235,1,[이터널]Navl,3307,187,5,6,11,45.5%,6m
4235,2,Vision,3307,0,4,1,5,80.0%,10m
4235,1,[서초중]우주최강에쓰쒸비,3307,107,2,4,6,33.3%,8m
4235,2,[GIS]我真無聊啊,3307,32,1,3,4,25.0%,8m
4235,1,[ELS]SplashMVP,3307,0,0,4,4,0.0%,16m
4235,3,JWP,3307,0,0,7,7,0.0%,51m
4242,3,[Equal]CoMMuNaL,3306,1482,118,119,237,49.8%,6m
4242,1,OoToRi,3306,1028,40,32,72,55.6%,8m
4242,1,lIlllIlllIIl,3306,269,20,18,38,52.6%,7m
4242,1,Muderer,3306,464,16,15,31,51.6%,6m
4242,1,Peracer,3306,0,1,2,3,33.3%,48m
4242,2,IIIIIIIIIIII,3306,0,0,1,1,0.0%,5m
4248,3,Asterdor,3305,1490,459,457,916,50.1%,8m
4248,2,GoldmanSachs,3305,602,29,21,50,58.0%,8m
4248,3,애지가니,3305,265,11,9,20,55.0%,3m
4248,2,woojack,3305,0,0,1,1,0.0%,8m
4252,3,흑곰,3304,1418,115,126,241,47.7%,5m
4253,2,llllllllllll,3303,1380,119,83,202,58.9%,4m
4253,2,판도리,3303,66,2,4,6,33.3%,8m
4255,2,진격의해병,3302,1232,48,39,87,55.2%,8m
4255,1,KeEpYoUr,3302,91,5,2,7,71.4%,16m
4255,1,LiquidTLO,3302,0,4,1,5,80.0%,17m
4258,1,SuperKIDz,3301,576,24,20,44,54.5%,8m
4258,1,vitamin,3301,289,7,10,17,41.2%,10m
4258,2,똥빵구,3301,124,4,2,6,66.7%,7m
4258,2,[Lotuz]의무관,3301,92,3,5,8,37.5%,5m
4258,2,[통수]어둠의지배자,3301,30,2,3,5,40.0%,7m
4258,2,[JPC]경다왔따,3301,0,0,2,2,0.0%,7m
4264,1,[Pandan]선물이,3300,1412,239,232,471,50.7%,4m
4264,1,[광속천문]一揮掃蕩血染山河,3300,850,29,27,56,51.8%,7m
4264,2,asetisoamil,3300,0,4,1,5,80.0%,10m
4264,1,롤아직함,3300,114,3,4,7,42.9%,7m
4264,2,llllllllllll,3300,0,1,1,2,50.0%,7m
4269,2,TonFroid,3299,702,26,21,47,55.3%,10m
4269,3,leshodel,3299,129,7,3,10,70.0%,51m
4269,2,얅뢇쉛놹뛞왡,3299,219,7,4,11,63.6%,4m
4269,1,폴라리스,3299,0,1,2,3,33.3%,6m
4273,2,Cptpolarbear,3298,263,10,2,12,83.3%,8m
4273,2,맥도날드,3298,290,10,9,19,52.6%,10m
4273,3,아리아나브이란데,3298,123,4,3,7,57.1%,19m
4273,2,스타클럽,3298,86,3,1,4,75.0%,8m
4273,1,홍진호,3298,0,3,3,6,50.0%,18m
4278,1,[나가짐어서]사슴영혼,3297,641,21,22,43,48.8%,4m
4278,2,肺愈清,3297,491,20,13,33,60.6%,5m
4278,1,[두유공신병신]보라,3297,378,17,16,33,51.5%,8m
4278,1,더로드,3297,84,4,6,10,40.0%,16m
4278,2,Keith,3297,58,3,0,3,100.0%,7m
4278,1,TeachME,3297,95,2,0,2,100.0%,48m
4278,2,[gonia]IlIlIIl,3297,0,0,1,1,0.0%,8m
4285,1,[무한오영종]루삥뽕,3296,1089,43,37,80,53.8%,16m
4285,2,CuT,3296,681,31,16,47,66.0%,10m
4285,1,SONO,3296,0,5,0,5,100.0%,18m
4285,2,karen,3296,30,3,3,6,50.0%,5m
4289,2,IIIIIIIIIIII,3295,170,4,3,7,57.1%,49m
4289,2,[개쫄보]모리안,3295,0,3,2,5,60.0%,10m
4291,2,philosophic,3294,264,9,9,18,50.0%,9m
4291,1,[MMDS]Gitanamala,3294,90,5,2,7,71.4%,8m
4291,2,[오버액션토낏]SkyeX,3294,32,2,2,4,50.0%,4m
4294,2,Estella,3293,92,4,4,8,50.0%,8m
4294,1,[Neat]Moon,3293,118,3,8,11,27.3%,3m
4294,1,휴일,3293,48,1,2,3,33.3%,16m
4294,1,Marek,3293,0,0,1,1,0.0%,18m
4294,1,우주최강,3293,0,0,4,4,0.0%,6m
4299,1,llllllllllll,3292,356,10,17,27,37.0%,3m
4299,2,앤디우석,3292,88,4,3,7,57.1%,3m
4299,2,iwanagaharu,3292,94,3,3,6,50.0%,7m
4299,2,趙承煥濟國,3292,0,0,1,1,0.0%,5m
4303,3,垂耳兔不吃萝卜胡,3291,596,86,90,176,48.9%,9m
4303,2,[군사정권]노태우,3291,673,29,25,54,53.7%,16m
4303,1,펜잘,3291,228,18,15,33,54.5%,5m
4303,2,가디가디,3291,352,17,21,38,44.7%,7m
4303,2,[med]CasaiiiNova,3291,204,7,6,13,53.8%,9m
4303,2,[JAYCE]REDDOT,3291,122,4,7,11,36.4%,8m
4303,2,FASTESTMAN,3291,0,0,4,4,0.0%,5m
4310,3,스카이,3290,1122,71,80,151,47.0%,9m
4310,2,DoubleJH,3290,1532,67,47,114,58.8%,4m
4310,1,WhixeBear,3290,436,47,40,87,54.0%,5m
4310,2,Kaito,3290,32,2,0,2,100.0%,50m
4314,1,[잉여톡]데릭로즈,3289,811,43,45,88,48.9%,6m
4314,2,[청성회관]Midori,3289,357,13,13,26,50.0%,8m
4314,1,TopRamen,3289,97,2,2,4,50.0%,17m
4314,2,[라코]coiso,3289,0,1,0,1,100.0%,9m
4314,2,IIIIIIIIIIII,3289,0,0,1,1,0.0%,8m
4314,1,llllllllllll,3289,0,0,1,1,0.0%,17m
4314,2,카앨,3289,0,0,2,2,0.0%,9m
4321,1,小木,3288,720,28,24,52,53.8%,4m
4321,1,Jeep,3288,294,8,10,18,44.4%,7m
4321,2,JERRY,3288,212,6,3,9,66.7%,5m
4321,2,IMBAnana,3288,0,4,1,5,80.0%,10m
4321,1,얼어붙은개,3288,32,2,4,6,33.3%,5m
4321,3,ChampionINno,3288,0,1,0,1,100.0%,4m
4321,2,lIlIIIlllIII,3288,0,0,3,3,0.0%,7m
4328,3,[그림리퍼]레이너,3287,1197,142,131,273,52.0%,7m
4328,1,llllIlllIl,3287,1138,47,47,94,50.0%,8m
4328,2,DLSMIZEL,3287,467,18,10,28,64.3%,5m
4328,2,[ELSII]OMGitsKorean,3287,289,12,5,17,70.6%,8m
4328,1,콩끄레,3287,0,0,2,2,0.0%,18m
4333,1,PanigaleS,3286,1670,463,433,896,51.7%,6m
4333,1,土豆仁,3286,1657,259,248,507,51.1%,6m
4333,2,[TMR]口加口里,3286,1208,178,163,341,52.2%,5m
4333,2,BoM,3286,826,33,26,59,55.9%,9m
4333,1,Nerevar,3286,519,20,14,34,58.8%,7m
4333,2,BlueShark,3286,94,4,6,10,40.0%,8m
4333,2,[TWorld]MARVEL,3286,0,1,0,1,100.0%,7m
4333,2,소고기왕,3286,0,0,1,1,0.0%,5m
4341,1,hara,3285,1618,360,355,715,50.3%,4m
4341,2,Stochast,3285,176,5,1,6,83.3%,6m
4341,2,[SofT]이근,3285,90,3,4,7,42.9%,10m
4344,2,MAHOROMATIC,3284,160,18,12,30,60.0%,8m
4344,2,어둠의지배자,3284,111,12,13,25,48.0%,8m
4344,1,PrinceMarine,3284,166,6,2,8,75.0%,17m
4344,2,騷年無奈打出機機,3284,0,1,2,3,33.3%,16m
4348,2,FUN,3283,726,29,23,52,55.8%,6m
4348,2,[CMD]NOBLESS,3283,266,10,4,14,71.4%,10m
4348,2,[일벌레고용주]AppleBox,3283,264,10,11,21,47.6%,8m
4351,3,foREVer,3282,250,13,14,27,48.1%,16m
4351,2,[b바리스타o]seiko,3282,230,9,9,18,50.0%,5m
4351,2,YSYS,3282,0,4,1,5,80.0%,3m
4351,2,Pesi,3282,0,0,1,1,0.0%,9m
4355,1,Flash,3281,1595,62,59,121,51.2%,6m
4355,2,BachuWYD,3281,160,5,5,10,50.0%,6m
4357,3,국정원래퍼노무현,3280,1494,201,191,392,51.3%,7m
4357,2,[THoS]MiKeTHoS,3280,1199,56,49,105,53.3%,6m
4357,2,야스민,3280,558,20,26,46,43.5%,5m
4357,2,[xTMDx]roboWorld,3280,198,7,10,17,41.2%,16m
4357,1,noobinproud,3280,0,5,1,6,83.3%,7m
4357,1,SyndiKate,3280,142,5,11,16,31.2%,3m
4357,2,호날두두마리치킨,3280,30,2,0,2,100.0%,5m
4357,2,yastrzemski,3280,58,2,2,4,50.0%,5m
4357,2,170757764807,3280,0,0,1,1,0.0%,9m
4366,2,바나나퀵,3279,1571,140,120,260,53.8%,10m
4366,1,[原神]페이몬,3279,234,8,6,14,57.1%,6m
4366,1,一束七,3279,178,5,4,9,55.6%,16m
4366,2,[새축]복숭아맛찌찌,3279,0,4,1,5,80.0%,5m
4366,2,롯데날드,3279,92,4,3,7,57.1%,9m
4366,3,[영훈이]땅굴망사티팬티,3279,122,3,3,6,50.0%,19m
4366,2,막장으로나아가라,3279,0,0,2,2,0.0%,4m
4373,1,SuGaR,3278,1633,90,88,178,50.6%,8m
4373,1,[Bully]고수,3278,246,64,45,109,58.7%,4m
4373,2,별의아이,3278,427,54,46,100,54.0%,16m
4373,1,[5torM]갈아만든배,3278,685,31,25,56,55.4%,8m
4373,2,Xecus,3278,228,8,5,13,61.5%,10m
4373,3,HoBBang,3278,142,4,1,5,80.0%,9m
4373,2,ThisAndThat,3278,30,1,1,2,50.0%,16m
4373,2,Esoo,3278,0,1,1,2,50.0%,8m
4373,2,아리사가터벨트,3278,0,1,1,2,50.0%,5m
4373,2,working,3278,0,0,1,1,0.0%,5m
4373,1,Stimpack,3278,0,0,6,6,0.0%,4m
4384,2,SNK,3277,1496,201,181,382,52.6%,9m
4384,1,TraFalGarLaw,3277,430,13,17,30,43.3%,6m
4384,2,Conkey,3277,292,10,9,19,52.6%,6m
4384,1,lIlIlIlIlIlI,3277,229,5,10,15,33.3%,7m
4388,2,자짱면,3276,1588,166,149,315,52.7%,8m
4388,3,[시럽]Respect,3276,0,0,1,1,0.0%,6m
4388,2,[천운]월라이냐냐,3276,0,0,1,1,0.0%,5m
4391,2,닉쿤,3275,1131,88,62,150,58.7%,9m
4391,2,ToRi,3275,422,15,14,29,51.7%,8m
4391,2,CarlYJQ,3275,112,3,0,3,100.0%,9m
4394,2,enzoul,3274,1620,109,95,204,53.4%,5m
4394,1,[SC2HK]ZeroWhite,3274,1237,51,43,94,54.3%,3m
4394,2,냐음,3274,424,16,10,26,61.5%,4m
4394,2,IMBombat,3274,88,5,1,6,83.3%,9m
4394,1,llllllllllll,3274,0,4,1,5,80.0%,18m
4394,2,똔경뚜,3274,30,1,2,3,33.3%,8m
4400,2,tsukabon,3273,370,21,21,42,50.0%,5m
4400,2,兔耳猴猴,3273,64,3,0,3,100.0%,5m
4400,2,[Mist]Maximus,3273,30,1,1,2,50.0%,6m
4400,2,AThinkinDust,3273,30,1,1,2,50.0%,7m
4400,2,FrozenMarine,3273,36,1,5,6,16.7%,16m
4400,2,CEASAR,3273,0,0,1,1,0.0%,5m
4406,1,[TalenT]Miracle,3272,1630,138,118,256,53.9%,10m
4406,2,시윤이,3272,702,27,23,50,54.0%,7m
4406,2,해병,3272,202,8,1,9,88.9%,6m
4406,2,[KRSC2]치킹이,3272,0,0,1,1,0.0%,3m
4410,2,THP,3271,1115,50,46,96,52.1%,9m
4410,2,니조랄,3271,408,15,10,25,60.0%,9m
4410,2,[Tchamp]빠빠머스,3271,0,1,1,2,50.0%,9m
4410,3,SkyblueOcean,3271,0,0,1,1,0.0%,51m
4410,2,스터양,3271,0,0,4,4,0.0%,6m
4415,2,Uranium,3270,88,7,4,11,63.6%,5m
4415,2,CUJS,3270,0,1,1,2,50.0%,8m
4417,2,싱크탱크,3269,640,23,22,45,51.1%,8m
4417,2,[개빡고수]Sparkle,3269,124,5,4,9,55.6%,6m
4419,1,Mode,3268,1178,81,67,148,54.7%,4m
4419,3,[hl1234]scgreatagain,3268,1207,57,69,126,45.2%,5m
4419,2,짐레이너,3268,418,18,9,27,66.7%,4m
4419,1,Zerg,3268,274,8,13,21,38.1%,10m
4419,1,GFG,3268,0,2,1,3,66.7%,18m
4419,2,[kosmos]테란,3268,0,1,0,1,100.0%,16m
4419,2,[대영제국]체르시아,3268,32,1,2,3,33.3%,8m
4426,3,IIIIIIIIII,3267,1531,269,256,525,51.2%,5m
4426,2,[랜타디매니아]으헝헝,3267,148,10,4,14,71.4%,9m
4426,2,[sheep8]나한테지면찌질이,3267,223,9,1,10,90.0%,9m
4426,2,섹셜러티,3267,214,7,9,16,43.8%,9m
4426,2,TKCloud,3267,0,1,0,1,100.0%,7m
4426,2,일직사령,3267,0,0,1,1,0.0%,5m
4426,2,[달콤]Sadnovel,3267,0,0,3,3,0.0%,4m
4433,3,LEFT,3266,1001,36,53,89,40.4%,7m
4433,2,기태몬,3266,723,34,17,51,66.7%,10m
4433,2,你媽死了,3266,114,5,1,6,83.3%,4m
4433,2,TanguyNdomb,3266,30,1,1,2,50.0%,9m
4433,2,garden,3266,0,0,1,1,0.0%,8m
4433,2,[WTSC]Michael,3266,0,0,1,1,0.0%,10m
4439,1,[스타놀이터]도페,3265,1537,309,289,598,51.7%,16m
4439,1,CLYDA,3265,1183,116,115,231,50.2%,16m
4439,2,Brokensword,3265,304,11,13,24,45.8%,5m
4439,2,동료,3265,122,5,3,8,62.5%,9m
4439,2,ahffktlqkf,3265,0,0,1,1,0.0%,9m
4444,1,[경기도민]ppddaa,3264,936,78,74,152,51.3%,8m
4444,2,皆神空月,3264,979,41,28,69,59.4%,10m
4444,2,[샬롯]프징징혐오자,3264,223,9,8,17,52.9%,8m
4444,2,wyjmomo,3264,88,5,1,6,83.3%,5m
4444,2,스윙스,3264,0,0,3,3,0.0%,16m
4449,1,Cardinals,3263,220,8,13,21,38.1%,3m
4449,3,박상수입니다,3263,0,5,2,7,71.4%,19m
4449,2,[이터널]Bera,3263,136,4,0,4,100.0%,9m
4449,2,윈스턴치토게,3263,30,2,2,4,50.0%,9m
4453,2,테테전사절,3262,1577,302,260,562,53.7%,5m
4453,3,삼십일,3262,1471,146,156,302,48.3%,7m
4453,1,Hank,3262,1360,62,69,131,47.3%,6m
4453,2,[정치공학]스노우코인,3262,1269,56,42,98,57.1%,5m
4453,1,IIIIIIIIIIII,3262,964,34,38,72,47.2%,8m
4453,2,[NGameS]보라돌이,3262,330,13,7,20,65.0%,8m
4453,1,민타,3262,127,7,4,11,63.6%,7m
4453,2,[하이퍼큐브]TaeJaFan,3262,152,6,7,13,46.2%,9m
4453,2,flyinbed,3262,150,5,7,12,41.7%,9m
4453,2,모든지쏜다,3262,30,2,2,4,50.0%,9m
4463,2,jlai,3261,418,15,17,32,46.9%,5m
4464,2,Java,3260,1569,261,241,502,52.0%,10m
4464,2,KSK,3260,1368,154,140,294,52.4%,7m
4464,2,[이터널]고구마,3260,228,9,1,10,90.0%,8m
4464,2,KnerveD,3260,118,4,3,7,57.1%,9m
4464,1,RealKass,3260,136,4,5,9,44.4%,4m
4464,2,[Comp]hard,3260,62,2,7,9,22.2%,5m
4464,2,saetbyeol,3260,0,0,1,1,0.0%,4m
4464,2,rive,3260,0,0,1,1,0.0%,6m
4472,2,우유천사,3259,240,9,4,13,69.2%,5m
4472,2,Aye,3259,0,0,1,1,0.0%,8m
4474,3,Monday,3258,1488,120,132,252,47.6%,9m
4474,2,KDBwo,3258,1428,67,41,108,62.0%,10m
4474,2,시진핑의스타일기,3258,1477,61,50,111,55.0%,9m
4474,1,TshCHIA,3258,640,19,28,47,40.4%,16m
4474,3,Zizou,3258,364,14,20,34,41.2%,10m
4474,2,scalarman,3258,284,10,9,19,52.6%,5m
4474,1,다메다메,3258,314,9,16,25,36.0%,5m
4474,2,Lynx,3258,150,5,6,11,45.5%,5m
4474,2,[용강]JOO,3258,30,2,1,3,66.7%,5m
4474,2,IllIIIlIIl,3258,0,0,1,1,0.0%,9m
4484,2,어떻게하는거여,3257,1576,134,120,254,52.8%,5m
4484,2,EWcreeper,3257,558,19,19,38,50.0%,7m
4484,2,Frost,3257,136,4,0,4,100.0%,5m
4484,2,AKiYaMaMio,3257,0,0,3,3,0.0%,7m
4488,1,계룡병기,3256,1632,341,332,673,50.7%,8m
4488,2,간지상훈,3256,1052,37,43,80,46.2%,7m
4488,1,TXXAN,3256,256,11,8,19,57.9%,48m
4488,1,嘎拉咕嚕啦咧,3256,226,5,9,14,35.7%,4m
4488,2,[나노]FelisCatus,3256,0,4,1,5,80.0%,8m
4488,2,Backkom,3256,116,4,7,11,36.4%,7m
4488,2,zzonkim,3256,75,3,6,9,33.3%,5m
4495,1,배고파용,3255,1629,149,136,285,52.3%,10m
4495,2,pilot,3255,539,27,16,43,62.8%,16m
4495,2,bronzemedal,3255,0,4,1,5,80.0%,5m
4495,2,[GITS]HaoKing,3255,0,1,0,1,100.0%,7m
4495,1,빈하나,3255,0,0,1,1,0.0%,17m
4495,2,jaguar,3255,0,0,2,2,0.0%,5m
4501,3,LWatson,3254,1457,104,103,207,50.2%,9m
4501,1,Berserk,3254,267,11,11,22,50.0%,5m
4501,2,bart,3254,86,6,4,10,60.0%,4m
4501,2,나는야관종잼,3254,0,2,1,3,66.7%,4m
4501,1,Rahwinia,3254,82,2,8,10,20.0%,4m
4501,2,星海戰士,3254,30,1,2,3,33.3%,9m
4501,2,algebra,3254,0,0,1,1,0.0%,10m
4508,2,Feinisys,3253,1528,66,55,121,54.5%,7m
4508,2,SouL,3253,359,15,7,22,68.2%,5m
4508,2,Lancelot,3253,0,4,1,5,80.0%,26m
4508,2,SANMAR,3253,94,4,3,7,57.1%,8m
4508,3,[젗까]초코맛바코드,3253,121,3,2,5,60.0%,19m
4508,2,LoNelyWinD,3253,86,3,4,7,42.9%,6m
4508,2,느항,3253,32,1,2,3,33.3%,4m
4515,2,[Upmeu]Upmeu,3252,1449,83,79,162,51.2%,16m
4515,2,Andy,3252,784,74,69,143,51.7%,5m
4515,2,pcbang,3252,0,2,1,3,66.7%,25m
4515,2,처음처럼,3252,30,2,2,4,50.0%,4m
4519,1,싱싱청과물,3251,1626,261,254,515,50.7%,8m
4519,2,Fractal,3251,1228,54,42,96,56.2%,9m
4519,2,IIIIIIIIIIII,3251,857,35,30,65,53.8%,4m
4519,2,Ruubondis,3251,292,11,7,18,61.1%,50m
4519,2,[NsP]KELLAN,3251,262,9,5,14,64.3%,8m
4519,2,[생존자]왕자,3251,124,5,5,10,50.0%,4m
4519,2,[SPTS]吃我人造燕窩,3251,30,2,0,2,100.0%,5m
4519,2,[촌뜨기]indianBoy,3251,0,0,1,1,0.0%,5m
4519,2,Hina,3251,0,0,1,1,0.0%,6m
4519,2,熊一寶一撥,3251,0,0,1,1,0.0%,9m
4529,2,푸른별,3250,709,44,32,76,57.9%,5m
4529,2,아프로디테,3250,781,30,26,56,53.6%,5m
4529,1,TNSouL,3250,553,15,24,39,38.5%,8m
4529,1,MinGslam,3250,0,0,1,1,0.0%,18m
4533,3,광안리스타일,3249,1192,169,191,360,46.9%,9m
4533,1,lIlIllllIIII,3249,1541,136,129,265,51.3%,6m
4533,2,RisKy,3249,372,15,10,25,60.0%,9m
4533,2,Terran,3249,268,10,10,20,50.0%,9m
4533,2,sugo,3249,60,3,4,7,42.9%,5m
4538,2,iZytm,3248,628,32,20,52,61.5%,7m
4538,2,[나가자]동탄낙무아이짐,3248,0,1,0,1,100.0%,5m
4538,2,Gua,3248,0,0,3,3,0.0%,8m
4541,1,꾸망이,3247,1635,379,374,753,50.3%,5m
4541,1,Libero,3247,1520,61,56,117,52.1%,6m
4541,1,내티셔츠,3247,757,44,40,84,52.4%,6m
4541,2,넘못해난,3247,596,24,17,41,58.5%,10m
4541,2,유리유리,3247,454,19,10,29,65.5%,16m
4541,2,Tiyohn,3247,303,13,7,20,65.0%,6m
4541,2,Bleu,3247,0,5,0,5,100.0%,24m
4541,2,dune,3247,0,4,1,5,80.0%,9m
4541,2,오란씨,3247,30,1,1,2,50.0%,9m
4541,1,OUEI,3247,0,0,1,1,0.0%,18m
4541,2,ggppabc,3247,0,0,3,3,0.0%,8m
4552,1,DBD,3246,395,18,15,33,54.5%,3m
4552,2,[異界的檢察官]醜海綿,3246,215,9,2,11,81.8%,8m
4552,2,aegean,3246,92,3,6,9,33.3%,10m
4552,2,JFKIST,3246,30,1,3,4,25.0%,9m
4552,2,똥꾸,3246,0,0,1,1,0.0%,7m
4552,2,SpecialLunch,3246,0,0,2,2,0.0%,7m
4552,2,Tenggu,3246,0,0,4,4,0.0%,8m
4559,2,[GIS]青丞,3244,494,19,10,29,65.5%,6m
4559,2,[청라충]태양석빠돌이,3244,58,3,3,6,50.0%,6m
4559,2,[협동전콜걸]jsyoon,3244,0,0,1,1,0.0%,8m
4562,3,제로드,3243,1288,188,182,370,50.8%,10m
4562,2,냥냥,3243,1304,141,111,252,56.0%,9m
4562,1,Rise,3243,250,8,13,21,38.1%,8m
4562,2,한국인,3243,60,3,3,6,50.0%,8m
4562,1,[XYFANS]carpediem,3243,0,0,1,1,0.0%,18m
4562,2,[페이크]oops,3243,0,0,2,2,0.0%,9m
4568,2,TIMPOY,3242,58,2,4,6,33.3%,6m
4568,2,hyulch,3242,0,1,1,2,50.0%,4m
4568,2,자판기커피,3242,0,1,2,3,33.3%,5m
4568,2,사일오부정선거,3242,0,0,2,2,0.0%,4m
4572,2,[닭장]버거킹가지말자,3241,1136,66,60,126,52.4%,9m
4572,1,HunterHealer,3241,1570,63,61,124,50.8%,3m
4572,1,StarLord,3241,102,6,3,9,66.7%,8m
4572,2,llllllllllll,3241,0,1,2,3,33.3%,7m
4572,2,[아름다운세상]내가제일젤나가,3241,0,0,2,2,0.0%,4m
4577,1,drama,3240,1600,109,108,217,50.2%,5m
4577,2,[얍삽하게]잠시만요,3240,447,35,32,67,52.2%,8m
4577,2,이매진드래곤스,3240,227,9,5,14,64.3%,49m
4577,2,[퇴물패밀리]번식왕,3240,266,9,9,18,50.0%,8m
4577,2,SIGMA,3240,208,8,8,16,50.0%,6m
4577,2,황윤하,3240,30,2,2,4,50.0%,9m
4577,2,에테리온,3240,0,1,0,1,100.0%,9m
4584,1,code,3239,1568,255,246,501,50.9%,4m
4584,1,save,3239,1530,186,172,358,52.0%,7m
4584,2,[Work]MrsHoHo,3239,1582,121,110,231,52.4%,6m
4584,2,ChinkenGG,3239,727,29,23,52,55.8%,6m
4584,2,AlSYNIA,3239,317,19,11,30,63.3%,8m
4584,1,심심하다,3239,341,9,13,22,40.9%,5m
4584,2,rarriG,3239,30,5,2,7,71.4%,8m
4584,2,아이즈원,3239,88,4,1,5,80.0%,7m
4584,1,당연히,3239,48,1,4,5,20.0%,17m
4584,2,NexLife,3239,0,0,3,3,0.0%,5m
4594,1,十二只探鸡,3238,1641,228,208,436,52.3%,16m
4594,2,봐줘잉,3238,127,5,0,5,100.0%,9m
4594,2,[홍콩행게이바]승완아달려라,3238,138,5,1,6,83.3%,8m
4594,2,아리아스,3238,0,0,1,1,0.0%,7m
4598,1,[怕死的死神]高橋李依,3237,1335,349,356,705,49.5%,7m
4598,2,Mighty,3237,626,25,19,44,56.8%,7m
4598,2,Promise,3237,322,12,13,25,48.0%,9m
4598,2,[맛있더라]스폰지밥,3237,58,2,2,4,50.0%,5m
4598,2,[YONSEI]하등한문과,3237,0,0,4,4,0.0%,8m
4603,3,박장군,3236,1524,286,262,548,52.2%,10m
4603,1,[Equal]Odin,3236,594,24,20,44,54.5%,8m
4603,2,OversKy,3236,0,5,1,6,83.3%,5m
4603,2,[고수들]욕설,3236,0,4,1,5,80.0%,25m
4603,2,[시형]시형쓰,3236,0,3,2,5,60.0%,26m
4608,2,[7Club]Sauvage,3235,1480,110,92,202,54.5%,9m
4608,2,[快樂玩家]小剪刀,3235,456,16,21,37,43.2%,9m
4608,2,kjhkjhkjh,3235,178,6,4,10,60.0%,10m
4608,2,Malu,3235,118,4,8,12,33.3%,8m
4608,3,llllllllllll,3235,126,4,19,23,17.4%,4m
4608,2,Someting,3235,126,3,1,4,75.0%,5m
4608,2,BINGO,3235,0,1,2,3,33.3%,5m
4608,2,캘록켈록캘로그,3235,0,0,1,1,0.0%,5m
4608,2,스닥,3235,0,0,2,2,0.0%,8m
4617,1,phexp,3234,624,83,77,160,51.9%,7m
4617,1,와니,3234,1576,81,81,162,50.0%,4m
4617,2,[겜동]hddgogogo,3234,733,40,29,69,58.0%,9m
4617,1,[D3StaR]SanTaFe,3234,858,35,32,67,52.2%,16m
4617,1,Escapist,3234,330,9,17,26,34.6%,3m
4617,2,Boom,3234,154,5,1,6,83.3%,5m
4617,1,Premium,3234,48,1,2,3,33.3%,18m
4617,2,[김태형엉덩이]김역장,3234,0,0,5,5,0.0%,5m
4625,3,crocodile,3233,1555,98,115,213,46.0%,5m
4625,2,[애니멀킹덤]햄순이,3233,1017,50,41,91,54.9%,6m
4625,2,[농구의신]유인나인나유,3233,396,16,15,31,51.6%,5m
4625,2,ubiquitin,3233,346,12,12,24,50.0%,8m
4625,2,평민,3233,152,8,4,12,66.7%,6m
4625,1,RottenZerg,3233,236,8,13,21,38.1%,4m
4625,2,[SKTT1]sks,3233,128,4,2,6,66.7%,5m
4625,1,Poon,3233,110,2,1,3,66.7%,49m
4633,2,Avalanche,3232,1453,153,177,330,46.4%,5m
4633,2,SioHuKKi,3232,88,6,0,6,100.0%,5m
4633,2,낑깡,3232,0,4,1,5,80.0%,25m
4633,2,llllllllllll,3232,0,4,1,5,80.0%,24m
4633,2,밤까마귀,3232,60,3,1,4,75.0%,5m
4633,2,[무사트]AgentH,3232,90,3,10,13,23.1%,6m
4633,2,고모씨,3232,0,0,2,2,0.0%,9m
4640,1,sAviOr,3231,1270,114,102,216,52.8%,4m
4640,2,LoVe,3231,154,10,3,13,76.9%,4m
4640,2,Teca,3231,118,8,5,13,61.5%,9m
4640,2,MidasElieSe,3231,120,5,5,10,50.0%,5m
4640,2,III,3231,90,4,4,8,50.0%,8m
4640,2,Baxter,3231,0,1,1,2,50.0%,9m
4640,2,[ToAru]Accelerator,3231,0,0,1,1,0.0%,10m
4647,2,Seolgi,3230,1555,160,140,300,53.3%,6m
4647,2,[noToss]Warpcraft,3230,748,31,24,55,56.4%,6m
4647,2,parkmos,3230,366,16,14,30,53.3%,5m
4647,2,[CIM]어마어마한저그,3230,160,6,5,11,54.5%,5m
4647,1,ddd,3230,200,6,10,16,37.5%,6m
4647,1,[SPTS]CHEERHERO,3230,0,1,0,1,100.0%,48m
4647,2,대학은갈수있을까,3230,0,1,1,2,50.0%,4m
4647,2,BearVigny,3230,0,1,1,2,50.0%,6m
4647,2,GreySkies,3230,0,1,4,5,20.0%,24m
4647,2,IIIIIIIIII,3230,0,0,1,1,0.0%,9m
4647,2,IIIIIIIIIIII,3230,0,0,1,1,0.0%,8m
4647,2,Clap,3230,0,0,1,1,0.0%,8m
4659,2,Nayr,3229,1545,176,165,341,51.6%,10m
4659,1,이름짓느라밤샜다,3229,1315,107,99,206,51.9%,7m
4659,2,starmagezine,3229,1297,52,49,101,51.5%,5m
4659,2,NeClan,3229,527,28,17,45,62.2%,9m
4659,1,Miggy,3229,354,12,16,28,42.9%,7m
4659,2,아르젠,3229,212,10,5,15,66.7%,49m
4659,2,ArchersMike,3229,224,7,8,15,46.7%,5m
4659,3,llllllllllll,3229,171,6,6,12,50.0%,51m
4659,2,IcEdrAgOn,3229,0,4,1,5,80.0%,5m
4659,2,포유,3229,30,1,2,3,33.3%,9m
4669,2,Been,3228,931,40,28,68,58.8%,10m
4669,2,SdragonL,3228,322,12,13,25,48.0%,8m
4669,1,달려볼까알비,3228,304,11,12,23,47.8%,16m
4669,2,[야바이데스네]페코린느,3228,60,6,2,8,75.0%,4m
4669,2,loonfactory,3228,0,1,0,1,100.0%,8m
4674,3,유빈찡,3227,1524,587,596,1183,49.6%,16m
4674,2,송수환,3227,1379,105,92,197,53.3%,6m
4674,1,[아구]KING,3227,1172,52,55,107,48.6%,5m
4674,2,[얼굴]적아대녀,3227,1274,49,41,90,54.4%,16m
4674,2,lIIlIIIIllIl,3227,105,5,2,7,71.4%,10m
4674,2,wanttobegold,3227,72,4,7,11,36.4%,10m
4674,2,[평화유지군]라파엘씨,3227,120,2,5,7,28.6%,6m
4674,2,llllllllllll,3227,32,1,5,6,16.7%,5m
4674,2,CodeNYong,3227,0,0,1,1,0.0%,6m
4683,2,플루토,3226,1380,117,110,227,51.5%,6m
4683,1,마시멜롱,3226,1593,115,123,238,48.3%,8m
4683,2,Jodus,3226,284,10,12,22,45.5%,5m
4683,2,Mars,3226,292,10,14,24,41.7%,7m
4683,2,[제목이내용]juster,3226,194,8,6,14,57.1%,9m
4683,2,[별똥별]이석원,3226,142,5,6,11,45.5%,10m
4683,2,SNOWBALL,3226,106,3,3,6,50.0%,49m
4683,2,Top,3226,0,1,2,3,33.3%,8m
4683,1,[Mist]shinciTL,3226,93,1,8,9,11.1%,5m
4683,2,timi,3226,0,0,1,1,0.0%,5m
4683,2,[TDT]Crime,3226,0,0,2,2,0.0%,51m
4694,2,Breeze,3225,162,15,14,29,51.7%,8m
4694,2,[Reeee]Grundle,3225,188,8,5,13,61.5%,5m
4694,2,[중학생임]북괴멀티전라도,3225,0,1,1,2,50.0%,10m
4694,2,HyuneeKun,3225,0,0,1,1,0.0%,8m
4698,1,김치년,3224,206,11,7,18,61.1%,6m
4698,2,Ryo,3224,196,7,7,14,50.0%,5m
4698,2,[엔타로연합]흑태자,3224,60,6,4,10,60.0%,6m
4698,2,[별그마테란]NASA,3224,60,6,4,10,60.0%,6m
4698,2,SadLife,3224,174,6,9,15,40.0%,16m
4698,2,색스킹,3224,0,1,1,2,50.0%,5m
4704,2,[너의ol름은]가느리디,3223,836,150,139,289,51.9%,8m
4704,1,[NoME]모질하고딸리는놈,3223,1536,104,105,209,49.8%,4m
4704,2,김겨울,3223,1130,52,32,84,61.9%,9m
4704,2,지노쓰,3223,228,8,5,13,61.5%,9m
4704,2,NutDealeR,3223,154,6,6,12,50.0%,8m
4704,2,[XYFANS]IIIIIIIIIIII,3223,154,4,3,7,57.1%,4m
4704,2,[잉여로운]하루하루하루룽,3223,112,3,0,3,100.0%,4m
4704,2,카푸소마,3223,0,1,0,1,100.0%,5m
4704,1,IBABE,3223,97,1,1,2,50.0%,17m
4713,1,cnnick,3222,376,56,59,115,48.7%,4m
4713,2,AsterCali,3222,898,41,39,80,51.2%,8m
4713,2,[민창렬]Maxan,3222,334,14,8,22,63.6%,5m
4713,1,케이원에이원,3222,168,6,3,9,66.7%,18m
4713,2,lllllllllll,3222,88,2,0,2,100.0%,10m
4713,2,[ELS]梁淳模,3222,30,2,2,4,50.0%,8m
4719,2,urocyon,3221,617,32,25,57,56.1%,8m
4719,1,[SofT]ainch,3221,572,16,27,43,37.2%,8m
4719,1,Inovation,3221,48,6,3,9,66.7%,18m
4719,2,[l인성]바코드,3221,0,0,2,2,0.0%,8m
4723,1,Dana,3220,1617,240,229,469,51.2%,7m
4723,2,miru,3220,1558,101,89,190,53.2%,9m
4723,3,llllllllllll,3220,491,32,42,74,43.2%,5m
4723,2,spTG,3220,485,19,15,34,55.9%,5m
4723,2,스타크래프트입문,3220,404,15,18,33,45.5%,5m
4723,2,yayagrou,3220,30,2,1,3,66.7%,9m
4723,2,瓦里安烏瑞恩,3220,0,1,0,1,100.0%,6m
4723,2,irene,3220,0,0,1,1,0.0%,7m
4731,3,IIIIIIIIIIII,3219,1432,290,305,595,48.7%,5m
4731,1,IIlllIIIIIII,3219,660,23,24,47,48.9%,6m
4731,1,이즈리이얼산스,3219,303,17,12,29,58.6%,4m
4731,2,ImMorty,3219,183,5,4,9,55.6%,11m
4731,2,[G20]박근혜,3219,88,2,0,2,100.0%,6m
4731,2,권나라수마나라,3219,0,0,1,1,0.0%,7m
4737,2,kindlysu,3218,823,40,23,63,63.5%,9m
4737,2,이니그마,3218,156,8,7,15,53.3%,6m
4737,2,hydra,3218,160,5,3,8,62.5%,5m
4737,2,아침밥,3218,150,5,9,14,35.7%,8m
4737,2,홍치,3218,0,4,1,5,80.0%,24m
4737,2,쨍이,3218,0,4,1,5,80.0%,6m
4737,2,nnkknnnn,3218,32,2,2,4,50.0%,8m
4737,2,[ABCEFG]성난빠따,3218,0,1,0,1,100.0%,7m
4737,2,우유사세요,3218,30,1,3,4,25.0%,8m
4737,2,도키도키시테타,3218,0,0,1,1,0.0%,9m
4747,2,[문재인수호단]무조건민주당,3217,1551,143,134,277,51.6%,4m
4747,2,Pong,3217,234,11,5,16,68.8%,49m
4747,2,전설,3217,174,8,5,13,61.5%,7m
4747,2,Star,3217,141,4,2,6,66.7%,6m
4747,2,아니개오지잖아,3217,0,0,1,1,0.0%,7m
4747,2,llIIlllIlllI,3217,0,0,7,7,0.0%,7m
4753,2,IIIIIIIIII,3216,869,118,83,201,58.7%,5m
4753,2,italysoo,3216,500,22,21,43,51.2%,5m
4753,2,테란만한다,3216,242,9,4,13,69.2%,11m
4753,2,[몸종]세르,3216,122,5,6,11,45.5%,8m
4753,1,[자치령특전단]희산니,3216,48,1,1,2,50.0%,17m
4753,2,Zeratul,3216,95,1,3,4,25.0%,51m
4759,2,maru,3215,1500,144,138,282,51.1%,5m
4759,2,MetisM,3215,1399,114,112,226,50.4%,6m
4759,2,fnsckdl,3215,1498,79,64,143,55.2%,4m
4759,2,아기공룡둘째,3215,270,10,6,16,62.5%,7m
4759,2,[Oasis]Wonderwall,3215,128,3,2,5,60.0%,5m
4759,2,[참돔]Assaulter,3215,58,3,3,6,50.0%,6m
4759,2,[AMA]SanJi,3215,0,1,1,2,50.0%,8m
4759,2,[프로시공러]Potachip,3215,0,0,1,1,0.0%,8m
4759,2,쿨사이클냉동공사,3215,0,0,2,2,0.0%,9m
4768,2,wadu,3214,1543,147,131,278,52.9%,8m
4768,1,Jacy,3214,1192,40,44,84,47.6%,16m
4768,2,위로해줄게,3214,0,1,3,4,25.0%,7m
4768,2,SoulBreaker,3214,0,0,1,1,0.0%,7m
4768,2,OneOthers,3214,0,0,3,3,0.0%,4m
4773,2,강의석,3213,901,36,31,67,53.7%,9m
4773,2,Kirk,3213,353,18,6,24,75.0%,5m
4773,2,[기냥]asdf,3213,446,17,15,32,53.1%,4m
4773,2,[BNT]Scarlet,3213,184,7,3,10,70.0%,6m
4773,2,[GLIFE]Green,3213,0,1,1,2,50.0%,6m
4773,2,mike,3213,0,1,1,2,50.0%,5m
4773,2,[Runes]미르,3213,30,1,3,4,25.0%,5m
4773,2,[패자는피를]달빛어린호수,3213,0,0,1,1,0.0%,8m
4773,2,Simple,3213,0,0,1,1,0.0%,9m
4773,2,할닉넴없넹,3213,0,0,1,1,0.0%,4m
4783,2,사이클론운전병,3212,853,134,135,269,49.8%,8m
4783,2,[4TIME4]BizzareCore,3212,428,17,10,27,63.0%,6m
4783,2,[AIMERH]뽀잉,3212,319,11,9,20,55.0%,5m
4783,2,Vengador,3212,0,4,1,5,80.0%,8m
4783,2,너구리,3212,108,3,1,4,75.0%,51m
4783,1,꽃민규,3212,120,3,1,4,75.0%,18m
4783,2,結城未来,3212,30,2,2,4,50.0%,5m
4783,2,RavenADW,3212,0,1,1,2,50.0%,5m
4783,2,ElacAX,3212,0,0,1,1,0.0%,9m
4792,2,InDifferent,3211,440,19,11,30,63.3%,6m
4792,2,사나이,3211,288,11,10,21,52.4%,6m
4792,2,sirbuddy,3211,209,7,6,13,53.8%,4m
4792,2,Grote,3211,0,4,1,5,80.0%,25m
4792,2,cso,3211,120,4,6,10,40.0%,5m
4792,2,[삼겹살]HatER,3211,88,1,1,2,50.0%,5m
4792,1,GJCaesar,3211,48,1,4,5,20.0%,18m
4792,2,leftypegasus,3211,0,0,1,1,0.0%,8m
4800,1,iiiiiiiiii,3210,1587,97,103,200,48.5%,4m
4800,1,AlexkenWoW,3210,326,12,3,15,80.0%,48m
4800,2,Perky,3210,48,5,1,6,83.3%,25m
4800,2,CYS,3210,0,4,1,5,80.0%,25m
4800,2,천안문공성전차,3210,0,0,4,4,0.0%,4m
4805,2,ggj,3209,369,14,9,23,60.9%,10m
4805,3,류성성,3209,155,4,4,8,50.0%,19m
4805,1,[1STST]Rabbit,3209,134,3,8,11,27.3%,3m
4805,2,오매새보,3209,0,0,1,1,0.0%,5m
4805,2,감성자까,3209,0,0,1,1,0.0%,8m
4810,1,WHYNOT,3208,1591,156,152,308,50.6%,16m
4810,2,[세미레전드]하니,3208,364,23,1,24,95.8%,10m
4810,2,고르아마신,3208,277,13,8,21,61.9%,10m
4810,2,cuzS,3208,288,13,8,21,61.9%,10m
4810,1,Camember,3208,48,5,3,8,62.5%,18m
4810,2,lllllllllll,3208,0,4,1,5,80.0%,17m
4810,2,refishon,3208,0,1,0,1,100.0%,4m
4810,2,[EMSS]개록,3208,0,0,1,1,0.0%,8m
4818,2,GGGGGGGGGGGG,3207,260,11,11,22,50.0%,8m
4818,2,[STMT]RedCross,3207,174,6,7,13,46.2%,10m
4818,2,[Clien]아스날,3207,150,4,3,7,57.1%,8m
4818,2,Smoodi,3207,0,1,0,1,100.0%,4m
4818,2,[무한오영종]llllllllllil,3207,30,1,3,4,25.0%,10m
4823,2,darkReunion,3206,460,16,23,39,41.0%,10m
4823,1,IIIIIIIIIIII,3206,416,14,14,28,50.0%,3m
4823,2,Arendal,3206,141,4,2,6,66.7%,5m
4823,1,武汉加油中国加油,3206,0,0,1,1,0.0%,19m
4827,2,찰스리,3205,1574,249,233,482,51.7%,10m
4827,2,[BBAN]khg,3205,1529,78,63,141,55.3%,5m
4827,2,猛猛的,3205,1263,55,54,109,50.5%,8m
4827,2,lonewolf,3205,461,50,31,81,61.7%,5m
4827,2,jieun,3205,462,19,14,33,57.6%,5m
4827,1,IIIIIIIIII,3205,328,19,19,38,50.0%,5m
4827,2,누가나보다스타잘,3205,367,17,11,28,60.7%,5m
4827,2,Dubstep,3205,102,2,1,3,66.7%,6m
4827,2,llllllllllll,3205,32,1,8,9,11.1%,8m
4836,2,Zzzzzzz,3204,589,27,23,50,54.0%,6m
4836,1,dldldltla,3204,414,13,20,33,39.4%,6m
4836,2,엉큼한오징어,3204,272,9,9,18,50.0%,8m
4836,2,쨍우,3204,168,6,2,8,75.0%,5m
4836,2,섹시한누나,3204,116,6,3,9,66.7%,10m
4836,2,OutSideR,3204,123,3,1,4,75.0%,4m
4842,2,애옹,3203,1383,64,52,116,55.2%,5m
4842,2,액시스콩알탄,3203,1061,59,48,107,55.1%,8m
4842,2,nsz,3203,402,14,12,26,53.8%,16m
4842,2,미디르,3203,0,0,1,1,0.0%,10m
4842,2,[시즈너]펜저,3203,0,0,1,1,0.0%,7m
4842,1,[액션스타]황간지,3203,0,0,4,4,0.0%,17m
4848,3,[TheDOH]마스터오브워쳐,3202,1518,165,172,337,49.0%,5m
4848,2,llllllllllll,3202,351,27,25,52,51.9%,8m
4848,1,니미,3202,704,25,30,55,45.5%,10m
4848,2,mstm,3202,375,24,24,48,50.0%,4m
4848,2,불곰,3202,209,10,6,16,62.5%,6m
4848,2,무한태연교,3202,150,6,7,13,46.2%,10m
4848,1,학대파,3202,0,4,2,6,66.7%,18m
4848,2,llllllllllll,3202,88,1,1,2,50.0%,11m
4856,2,RavioliRavio,3201,297,24,11,35,68.6%,5m
4856,2,[JD]YHJ,3201,278,14,4,18,77.8%,9m
4856,2,abcdefghijk,3201,364,12,11,23,52.2%,8m
4856,2,불곰왕,3201,194,6,4,10,60.0%,7m
4856,2,간밍구,3201,141,5,1,6,83.3%,6m
4856,2,someone,3201,124,5,6,11,45.5%,6m
4856,2,[WDY]llllllllllll,3201,164,4,4,8,50.0%,11m
4856,2,郭紹安,3201,30,1,6,7,14.3%,10m
4864,1,llllllllllll,3200,971,240,218,458,52.4%,6m
4864,2,llllllllllll,3200,1513,135,128,263,51.3%,8m
4864,3,헤피데이,3200,584,25,10,35,71.4%,10m
4864,2,고란빵,3200,573,21,18,39,53.8%,5m
4864,2,나는야짱짱,3200,30,1,8,9,11.1%,9m
4864,2,[아기곰의하루]Happy,3200,0,0,2,2,0.0%,5m
4870,2,INDangeR,3199,1537,97,94,191,50.8%,8m
4870,2,RORO,3199,651,69,65,134,51.5%,10m
4870,2,llllllllllll,3199,416,35,27,62,56.5%,8m
4870,1,오리너구리,3199,980,34,40,74,45.9%,16m
4870,3,니일꾼냠냠맛있당,3199,398,16,8,24,66.7%,4m
4870,2,Jerry,3199,392,13,17,30,43.3%,8m
4870,2,shortstop,3199,194,7,4,11,63.6%,8m
4870,2,대현이똥꼬,3199,179,6,4,10,60.0%,4m
4870,3,tytako,3199,86,3,1,4,75.0%,3m
4870,3,유노미아,3199,0,1,0,1,100.0%,16m
4870,2,Injiklove,3199,0,0,3,3,0.0%,10m
4881,2,xxWELCOMExx,3198,1525,235,215,450,52.2%,6m
4881,2,[國本]llllllllllll,3198,1454,160,146,306,52.3%,9m
4881,1,[SPUR]오빠는연예인,3198,983,100,99,199,50.3%,16m
4881,2,IIIIIIIIIIII,3198,432,20,16,36,55.6%,10m
4881,3,[탈다림군주1]저글링뛰어간다,3198,0,4,0,4,100.0%,16m
4881,2,바나나땅,3198,0,4,1,5,80.0%,25m
4887,2,sklrpxo,3197,1393,179,168,347,51.6%,4m
4887,2,Cebuano,3197,1516,61,53,114,53.5%,11m
4887,2,킁구기,3197,69,13,17,30,43.3%,8m
4887,2,llllllllllll,3197,204,7,5,12,58.3%,4m
4887,2,Kai,3197,0,0,2,2,0.0%,6m
4892,2,yabal,3196,349,48,25,73,65.8%,10m
4892,2,나노미터,3196,146,6,6,12,50.0%,6m
4892,2,TrickyZerg,3196,88,3,4,7,42.9%,5m
4895,3,soskoksos,3195,722,114,114,228,50.0%,10m
4895,3,许柯,3195,242,12,5,17,70.6%,7m
4895,3,zzzzzzzzzzzz,3195,0,5,3,8,62.5%,19m
4895,2,sadaguri,3195,98,3,10,13,23.1%,9m
4895,1,randiss,3195,97,2,5,7,28.6%,19m
4895,3,[Weast]스티비원더,3195,30,1,1,2,50.0%,4m
4901,2,llllllllllll,3194,1513,109,96,205,53.2%,5m
4901,2,WNVSAKULA,3194,1068,70,66,136,51.5%,8m
4901,2,Wafer,3194,1023,65,54,119,54.6%,5m
4901,2,消滅,3194,303,15,9,24,62.5%,10m
4901,2,[GG는칩니다]Ruin,3194,324,12,11,23,52.2%,10m
4901,3,조현,3194,133,7,1,8,87.5%,8m
4901,2,[자치령특전단]IIIIIIIIIIII,3194,142,4,3,7,57.1%,9m
4901,2,[SEAL]노바,3194,114,4,6,10,40.0%,10m
4909,1,brett,3193,1602,250,243,493,50.7%,5m
4909,1,엠엠크루,3193,1597,198,189,387,51.2%,4m
4909,1,[그시절의]마린허니,3193,1277,49,53,102,48.0%,10m
4909,1,[Gray]스완,3193,986,46,55,101,45.5%,4m
4909,2,IIIIIIIIIII,3193,554,21,19,40,52.5%,4m
4909,2,스누피,3193,97,4,2,6,66.7%,25m
4909,2,[제그린]코드머큐리,3193,0,1,4,5,20.0%,26m
4909,2,미나리사랑해,3193,0,0,3,3,0.0%,6m
4917,2,KillerMaster,3192,1417,141,136,277,50.9%,8m
4917,1,llllllllllll,3192,1559,79,81,160,49.4%,4m
4917,3,llllIIIlll,3192,147,5,5,10,50.0%,16m
4917,2,llllllllllll,3192,82,3,4,7,42.9%,8m
4917,3,Inis,3192,97,2,3,5,40.0%,19m
4917,2,SINtthomas,3192,34,1,6,7,14.3%,5m
4917,2,西北,3192,0,0,2,2,0.0%,4m
4917,2,luckyblock,3192,0,0,3,3,0.0%,9m
4925,2,완전초보에요,3191,1546,100,104,204,49.0%,9m
4925,2,개미핧기,3191,1136,44,39,83,53.0%,4m
4925,2,반집승,3191,513,38,24,62,61.3%,7m
4925,2,해병의힘으로,3191,366,14,15,29,48.3%,6m
4925,2,[ANGG]JJUKKUMI,3191,264,11,12,23,47.8%,8m
4925,1,팀플매니아,3191,141,5,3,8,62.5%,19m
4931,2,IIIIIIIIIIII,3190,756,27,27,54,50.0%,16m
4931,2,UOYKCUF,3190,438,19,16,35,54.3%,6m
4931,2,pmLappy,3190,380,15,19,34,44.1%,16m
4931,2,나란사람은,3190,230,10,3,13,76.9%,10m
4931,1,[킹왕핵고수]아아아아,3190,141,8,5,13,61.5%,4m
4931,2,SkyDiveJZ,3190,88,2,1,3,66.7%,5m
4931,1,Xel,3190,0,1,0,1,100.0%,17m
4931,3,양복일,3190,0,0,1,1,0.0%,8m
4939,2,gogogo,3189,1523,151,190,341,44.3%,16m
4939,3,Semper,3189,946,49,34,83,59.0%,5m
4939,2,BlackSilver,3189,284,10,8,18,55.6%,11m
4939,2,asd,3189,154,6,6,12,50.0%,9m
4939,3,MsTea,3189,0,1,0,1,100.0%,5m
4939,3,은둥이와병둥이,3189,0,0,1,1,0.0%,7m
4939,2,FanTa,3189,0,0,2,2,0.0%,5m
4946,2,CORONATRUMP,3188,898,42,26,68,61.8%,5m
4946,1,MzT,3188,1246,41,51,92,44.6%,8m
4946,2,사자왕,3188,712,29,25,54,53.7%,11m
4946,3,William,3188,189,7,6,13,53.8%,19m
4946,3,[Aso]Chenny,3188,142,6,2,8,75.0%,7m
4946,3,KMJ,3188,58,2,3,5,40.0%,10m
4946,3,llllllllllll,3188,0,0,1,1,0.0%,8m
4953,2,알바추노꾼,3187,1507,68,49,117,58.1%,5m
4953,3,永远喜欢伊织萌,3187,186,5,3,8,62.5%,7m
4953,2,llllllllllll,3187,144,5,7,12,41.7%,4m
4953,2,wjwhrhk,3187,0,2,8,10,20.0%,8m
4957,1,[해병대]백이보충대,3186,992,102,91,193,52.8%,7m
4957,2,weload,3186,1539,63,63,126,50.0%,4m
4957,2,[무한오영종]MASTER,3186,0,0,2,2,0.0%,5m
4957,2,[호주에있는]미필도살자,3186,0,0,3,3,0.0%,8m
4961,2,miniP,3185,1304,52,48,100,52.0%,4m
4961,3,Lancelot,3185,230,8,8,16,50.0%,19m
4961,2,[studio]박장군,3185,30,5,3,8,62.5%,5m
4964,3,[SPY4U]Eclair,3184,0,0,1,1,0.0%,8m
4964,2,이거보면나빼고동,3184,0,0,2,2,0.0%,4m
4966,1,sliverhawk,3183,484,13,26,39,33.3%,8m
4966,2,Elysium,3183,247,11,6,17,64.7%,50m
4966,3,isnoSmallGoe,3183,0,1,0,1,100.0%,16m
4969,2,[MDC]Wanderlust,3182,1536,100,81,181,55.2%,10m
4969,2,자라장,3182,888,38,34,72,52.8%,6m
4969,2,[NaGne]강태공,3182,572,25,17,42,59.5%,9m
4969,2,[JPN51]MsT,3182,116,4,9,13,30.8%,16m
4969,3,대장,3182,0,0,1,1,0.0%,9m
4969,2,[Darth]iamtheSwarm,3182,0,0,2,2,0.0%,8m
4975,1,[러블리걸]까칠한쩡이,3181,996,34,43,77,44.2%,16m
4975,2,[異界的檢察官]仙女,3181,192,8,8,16,50.0%,10m
4975,2,JinAirKaLiD,3181,0,4,1,5,80.0%,25m
4975,1,요라요라,3181,97,2,2,4,50.0%,47m
4975,2,발라드꾀꼬리,3181,0,0,3,3,0.0%,8m
4980,3,[isnous]術大招風,3180,1539,620,604,1224,50.7%,7m
4980,2,Gautama,3180,1404,59,53,112,52.7%,9m
4980,1,五月熊,3180,377,33,38,71,46.5%,8m
4980,2,THINK,3180,168,6,5,11,54.5%,8m
4980,2,FlameSJ,3180,128,4,3,7,57.1%,9m
4980,2,[한발이면]Siro,3180,88,3,5,8,37.5%,8m
4980,3,price,3180,30,1,1,2,50.0%,16m
4980,3,Hyper,3180,0,0,1,1,0.0%,3m
4980,3,LovelyZerg,3180,0,0,1,1,0.0%,16m
4980,2,IchTraum,3180,0,0,2,2,0.0%,9m
4990,1,CTwister,3179,1423,94,99,193,48.7%,8m
4990,2,[TheTop]AppNori,3179,910,32,35,67,47.8%,8m
4990,3,[mGG]Kikkoman,3179,697,25,25,50,50.0%,16m
4990,1,[AYSM]SCH,3179,285,9,16,25,36.0%,8m
4990,3,안녕하세요,3179,172,6,6,12,50.0%,6m
4990,3,케리건,3179,0,5,0,5,100.0%,8m
4990,3,peanutDowny,3179,0,4,1,5,80.0%,11m
4990,3,[Tyler]베스핀블로우,3179,30,2,1,3,66.7%,5m
4998,2,불멸자,3178,96,6,5,11,54.5%,50m
4998,2,IIIIIIIIIII,3178,0,1,0,1,100.0%,50m
4998,2,dhkdrjtmzmfn,3178,0,1,2,3,33.3%,9m
5001,2,[사망회귀]AshYoung,3177,731,116,107,223,52.0%,4m
5001,2,XXXTENTACION,3177,1109,56,45,101,55.4%,16m
5001,2,xinzhizhu,3177,164,8,4,12,66.7%,6m
5001,3,어그진,3177,114,5,1,6,83.3%,10m
5001,3,곰돌이허니,3177,118,4,5,9,44.4%,7m
5001,3,[FDSJ]Lifespace,3177,0,0,1,1,0.0%,10m
5007,2,[고등학생연합]전주광역시,3176,230,9,5,14,64.3%,4m
5007,2,Changeo,3176,216,7,6,13,53.8%,8m
5007,3,착한사람입니다,3176,86,4,0,4,100.0%,17m
5007,3,biubiubiu,3176,0,4,1,5,80.0%,10m
5007,3,[걸스데이]llllllllllll,3176,150,3,5,8,37.5%,16m
5012,3,gabuyaro,3175,1485,285,284,569,50.1%,8m
5012,1,이름짓다밤샘,3175,398,17,14,31,54.8%,4m
5012,2,lsnekqvk,3175,254,11,8,19,57.9%,50m
5012,2,[條碼貓]條碼人,3175,248,9,7,16,56.2%,4m
5012,2,리소나,3175,250,7,9,16,43.8%,5m
5012,1,Geekon,3175,86,6,4,10,60.0%,17m
5012,2,[건국]도드폭팔,3175,0,1,1,2,50.0%,50m
5012,2,멩코캬캬,3175,30,1,7,8,12.5%,10m
5012,1,IIIIIIIII,3175,0,0,1,1,0.0%,48m
5021,2,[근본은말보루]주태양,3174,1396,141,120,261,54.0%,4m
5021,2,[NEX]달보그레,3174,1235,48,49,97,49.5%,6m
5021,3,[深耕C]PrAy,3174,463,22,8,30,73.3%,10m
5021,3,Laraku,3174,248,11,7,18,61.1%,11m
5021,2,[모노전투]hera,3174,114,8,6,14,57.1%,5m
5021,2,lIlIlIlIlIlI,3174,30,2,3,5,40.0%,7m
5021,3,ohlovetaiwan,3174,0,1,0,1,100.0%,8m
5021,3,ClouDiNine,3174,0,0,1,1,0.0%,16m
5021,3,뭔데잘생겼냐,3174,0,0,1,1,0.0%,6m
5030,2,[EmPeRo]VoidRay,3173,1111,50,43,93,53.8%,4m
5030,3,문제앙과노무현,3173,392,14,14,28,50.0%,11m
5032,1,자유의군단,3172,1592,314,306,620,50.6%,5m
5032,2,Japox,3172,291,34,35,69,49.3%,8m
5032,2,[겨울방어]똥준이,3172,0,5,1,6,83.3%,9m
5032,3,이소융,3172,166,4,3,7,57.1%,4m
5032,2,피카츄,3172,107,2,2,4,50.0%,4m
5032,3,[Pandan]Geronimo,3172,0,1,0,1,100.0%,17m
5032,3,[LSF]ssjssj,3172,0,0,1,1,0.0%,7m
5032,3,MDU,3172,0,0,1,1,0.0%,4m
5032,3,마린,3172,0,0,2,2,0.0%,16m
5032,2,[시럽]아뇨뚱인데요,3172,0,0,3,3,0.0%,5m
5042,3,HellGate,3171,1136,77,76,153,50.3%,10m
5042,2,Novice,3171,1414,56,55,111,50.5%,8m
5042,2,지우했다,3171,290,9,8,17,52.9%,49m
5042,3,[오르피아]올피땅,3171,206,6,7,13,46.2%,10m
5042,3,김준수,3171,58,2,2,4,50.0%,11m
5042,3,Soda,3171,30,1,2,3,33.3%,8m
5042,3,Zzz,3171,0,0,1,1,0.0%,4m
5042,2,Multiply,3171,0,0,3,3,0.0%,5m
5050,1,아나콘다,3170,1297,178,186,364,48.9%,4m
5050,2,yij,3170,957,37,34,71,52.1%,5m
5050,2,사르카뉴,3170,191,6,6,12,50.0%,9m
5050,1,[예쁜김다미]니뒤통수에한발,3170,191,6,7,13,46.2%,18m
5050,3,DrunkenCrow,3170,0,2,3,5,40.0%,8m
5050,3,Felix,3170,0,0,1,1,0.0%,19m
5050,3,엄준식,3170,0,0,1,1,0.0%,9m
5057,2,Zilla,3169,750,31,31,62,50.0%,8m
5057,3,[무한오영종]김치,3169,668,26,22,48,54.2%,10m
5057,3,MicroMarine,3169,58,3,0,3,100.0%,6m
5057,3,버틸수가없다,3169,30,1,3,4,25.0%,5m
5057,2,HaM,3169,0,0,4,4,0.0%,5m
5062,1,Vita,3168,1589,358,331,689,52.0%,16m
5062,2,만유의아버지,3168,641,88,68,156,56.4%,9m
5062,2,AKiller,3168,1282,50,51,101,49.5%,16m
5062,3,[바보집합소]LaFAn,3168,278,10,7,17,58.8%,51m
5062,3,DearName,3168,169,9,5,14,64.3%,19m
5062,2,dkadd,3168,0,4,1,5,80.0%,24m
5062,3,[TPGPS]ZenonMartin,3168,0,1,3,4,25.0%,19m
5062,2,[악직숙산]창씨개명당함,3168,0,0,2,2,0.0%,9m
5062,2,Saram,3168,0,0,2,2,0.0%,10m
5071,3,Ageless,3167,229,25,17,42,59.5%,5m
5071,3,Astesia,3167,558,21,13,34,61.8%,8m
5071,1,ksinghal,3167,166,7,4,11,63.6%,18m
5071,3,[유즈맵떠돌이]썬더데커던트,3167,114,4,2,6,66.7%,5m
5071,2,PurgaTTory,3167,30,2,3,5,40.0%,4m
5071,3,[SNG]shukiiiii,3167,0,1,0,1,100.0%,6m
5071,3,osma,3167,0,0,1,1,0.0%,7m
5071,3,AngelDan,3167,0,0,1,1,0.0%,7m
5079,3,asr,3166,355,13,11,24,54.2%,16m
5079,2,IloveU,3166,234,9,7,16,56.2%,4m
5079,3,[마리골드]ssamjang,3166,0,0,1,1,0.0%,10m
5079,3,이즈샤,3166,0,0,1,1,0.0%,5m
5083,2,[붉은군단]짐레이너,3165,1500,130,116,246,52.8%,9m
5083,2,科學超電磁砲,3165,1538,61,57,118,51.7%,5m
5083,3,[농약]이쑤신장군,3165,1446,55,54,109,50.5%,4m
5083,2,luckcoo,3165,615,28,26,54,51.9%,5m
5083,3,만두시발,3165,0,1,0,1,100.0%,6m
5083,3,intex,3165,0,1,0,1,100.0%,4m
5083,2,[캬취한다]아이디찾은김웅비,3165,0,1,1,2,50.0%,50m
5083,3,PaRa,3165,0,0,1,1,0.0%,5m
5091,2,NOVA,3164,1560,172,161,333,51.7%,8m
5091,1,AlphaMale,3164,1535,79,94,173,45.7%,8m
5091,2,mrWHY,3164,668,25,25,50,50.0%,5m
5091,3,Battlefield,3164,254,9,7,16,56.2%,17m
5091,2,AsGsigma,3164,227,8,9,17,47.1%,50m
5091,2,spree,3164,215,7,6,13,53.8%,50m
5091,3,미라클,3164,88,3,5,8,37.5%,5m
5091,3,[AR소대]엠포,3164,0,0,1,1,0.0%,8m
5099,2,Jazztronik,3163,1555,177,179,356,49.7%,6m
5099,3,[비트]SadJoker,3163,637,24,17,41,58.5%,6m
5099,1,[Sugar]도리도리짱,3163,604,20,27,47,42.6%,5m
5099,2,[NGameS]Freak,3163,369,18,12,30,60.0%,10m
5099,2,sss,3163,132,5,10,15,33.3%,8m
5099,3,ILOVEYOU,3163,90,3,4,7,42.9%,6m
5099,3,SloppySteven,3163,0,1,0,1,100.0%,11m
5099,3,해병,3163,30,1,2,3,33.3%,11m
5099,3,Deadlypants,3163,0,0,1,1,0.0%,7m
5108,2,ClayJ,3162,959,50,52,102,49.0%,8m
5108,3,공주,3162,445,32,30,62,51.6%,6m
5108,2,[BBF]modere,3162,588,22,23,45,48.9%,9m
5108,3,[인정]llllllllllll,3162,548,19,40,59,32.2%,7m
5108,2,[our방개]니백룡내꺼다요,3162,460,16,19,35,45.7%,9m
5108,3,nitezz,3162,252,10,7,17,58.8%,7m
5108,2,MegaNoob,3162,202,10,11,21,47.6%,16m
5108,3,[Hyper]문익점,3162,30,2,0,2,100.0%,10m
5108,2,柯基犬歪歪,3162,0,0,1,1,0.0%,25m
5108,3,JacKalSlam,3162,0,0,2,2,0.0%,10m
5118,2,[생존자]웅담자룡,3161,1505,208,197,405,51.4%,8m
5118,2,Gordon,3161,1413,201,193,394,51.0%,10m
5118,2,테란시발,3161,420,15,14,29,51.7%,5m
5118,1,Mirkakoko,3161,120,6,3,9,66.7%,17m
5118,3,AVANGARD,3161,0,0,1,1,0.0%,6m
5123,3,lIlIIIlIIIIl,3160,1043,69,60,129,53.5%,11m
5123,2,[XYFANS]IntoTheSaber,3160,58,6,3,9,66.7%,8m
5123,1,리타,3160,0,4,2,6,66.7%,17m
5123,2,[스카이파이터]제임스조심레이너,3160,60,2,8,10,20.0%,5m
5123,2,[엘리트]eLiteDragon,3160,0,0,4,4,0.0%,9m
5128,2,NPPC,3159,636,74,61,135,54.8%,5m
5128,3,southwind,3159,364,18,8,26,69.2%,6m
5128,2,Verse,3159,112,6,3,9,66.7%,9m
5128,2,KuMA,3159,143,5,2,7,71.4%,24m
5128,1,llllllllllll,3159,116,3,15,18,16.7%,4m
5128,1,SCwinter,3159,97,1,2,3,33.3%,18m
5128,3,byKOP,3159,30,1,3,4,25.0%,10m
5128,3,Daniel,3159,30,1,3,4,25.0%,6m
5128,2,[SC2HK]cycle,3159,0,1,3,4,25.0%,4m
5128,3,Lunatic,3159,0,0,1,1,0.0%,17m
5138,2,외국인,3158,314,15,10,25,60.0%,8m
5138,2,[NGameS]LIme,3158,0,1,2,3,33.3%,10m
5138,2,공부가싫다,3158,0,0,4,4,0.0%,6m
5141,2,keith,3157,1573,75,74,149,50.3%,5m
5141,2,[도담이]Marco,3157,962,34,39,73,46.6%,8m
5141,2,으꺙지,3157,630,26,22,48,54.2%,8m
5141,3,LittleSurper,3157,639,24,18,42,57.1%,10m
5141,3,Wrath,3157,515,19,21,40,47.5%,6m
5141,2,Thor,3157,102,5,3,8,62.5%,10m
5141,3,kms,3157,30,2,0,2,100.0%,10m
5141,3,신지혜,3157,0,0,1,1,0.0%,16m
5141,3,마므메,3157,0,0,1,1,0.0%,5m
5141,3,[대빵들]엄잼인,3157,0,0,1,1,0.0%,11m
5151,2,foxmusic,3156,726,216,198,414,52.2%,5m
5151,2,자치령,3156,1413,119,112,231,51.5%,8m
5151,2,SoleiL,3156,1094,95,86,181,52.5%,9m
5151,2,IIIIIIIIIIII,3156,737,44,41,85,51.8%,6m
5151,3,ewq,3156,1048,35,52,87,40.2%,10m
5151,3,Okaka,3156,527,24,3,27,88.9%,16m
5151,3,정열의베렛나루,3156,326,12,13,25,48.0%,7m
5151,3,DeezNutzx,3156,223,10,5,15,66.7%,16m
5151,2,[피비언니]양혜지,3156,58,3,4,7,42.9%,10m
5151,3,[TeamB]폭군다람쥐,3156,0,2,3,5,40.0%,9m
5151,3,[사이상]사이상,3156,0,1,0,1,100.0%,7m
5162,3,llllllllllll,3155,1421,169,152,321,52.6%,7m
5162,2,아워워워,3155,1481,71,59,130,54.6%,5m
5162,2,MsIeKoE,3155,527,32,34,66,48.5%,5m
5162,3,[sc2mc]Hardvision,3155,140,6,0,6,100.0%,16m
5162,3,오빠차화염차,3155,114,4,1,5,80.0%,17m
5162,1,AstroMiC,3155,97,4,1,5,80.0%,19m
5162,2,안녕,3155,0,4,2,6,66.7%,5m
5162,2,김뽀대,3155,130,4,9,13,30.8%,9m
5162,3,미술킹,3155,30,2,1,3,66.7%,6m
5162,3,[pepper]카카로트,3155,0,1,0,1,100.0%,11m
5162,3,아놔시발,3155,0,1,1,2,50.0%,6m
5162,3,qwert,3155,0,0,2,2,0.0%,7m
5174,2,皮皮,3154,1145,443,427,870,50.9%,5m
5174,2,키보드워리어,3154,726,30,26,56,53.6%,5m
5174,3,유키맘,3154,144,6,3,9,66.7%,5m
5174,3,[KTZ]龍劍修羅,3154,116,4,4,8,50.0%,8m
5174,3,[SKTTII]EuPhoRia,3154,114,4,4,8,50.0%,10m
5174,1,[존잘연합]lllllllllll,3154,76,2,13,15,13.3%,8m
5174,3,paranoid,3154,0,1,0,1,100.0%,19m
5174,3,ShiNe,3154,0,1,1,2,50.0%,5m
5174,2,IIlIlIllIlII,3154,0,0,8,8,0.0%,9m
5183,2,llllllllllll,3153,1268,48,44,92,52.2%,9m
5183,2,[ELSII]LaUnCher,3153,181,5,6,11,45.5%,8m
5183,3,[ANGG]Geologist,3153,60,3,3,6,50.0%,5m
5183,3,알아서,3153,17,2,2,4,50.0%,5m
5183,3,Phart,3153,0,0,1,1,0.0%,5m
5183,3,[ANGG]저글링날아요츙츙,3153,0,0,1,1,0.0%,16m
5183,3,[무한오영종]시화커플실장,3153,0,0,1,1,0.0%,4m
5190,3,infily,3152,847,223,232,455,49.0%,8m
5190,2,흥선대장균,3152,562,82,77,159,51.6%,8m
5190,3,힘내라우덩재,3152,1578,73,59,132,55.3%,16m
5190,2,주덕사람,3152,88,3,8,11,27.3%,6m
5190,2,llllllllll,3152,0,2,3,5,40.0%,26m
5190,3,쭉쭉빵빵,3152,0,0,1,1,0.0%,4m
5196,3,[못골]sunny,3151,1500,397,399,796,49.9%,4m
5196,1,[비트]탱탱탱탱,3151,1554,265,244,509,52.1%,5m
5196,1,HazelBess,3151,1132,108,112,220,49.1%,16m
5196,2,Confessions,3151,1527,80,88,168,47.6%,8m
5196,1,Mvp,3151,538,17,27,44,38.6%,5m
5196,3,Crazy,3151,232,8,9,17,47.1%,7m
5196,3,Tomatos,3151,0,4,1,5,80.0%,16m
5196,3,애쉬크로프트,3151,58,3,2,5,60.0%,7m
5196,3,[monix3]손바,3151,0,1,0,1,100.0%,16m
5196,2,BlackJ,3151,0,0,6,6,0.0%,9m
5206,2,[성능좋은응디]테란하는머프님,3150,1269,67,63,130,51.5%,9m
5206,2,Felon,3150,1243,65,66,131,49.6%,6m
5206,2,IlIIlIlIlIlI,3150,324,11,11,22,50.0%,8m
5206,2,쏘쿨한보이,3150,154,5,11,16,31.2%,6m
5206,3,Sun,3150,30,1,3,4,25.0%,11m
5206,3,[독어독문]llllllllllll,3150,0,0,2,2,0.0%,11m
5206,3,Banshee,3150,0,0,2,2,0.0%,9m
5206,2,Optimism,3150,0,0,5,5,0.0%,9m
5214,2,egnrghdw,3149,420,19,15,34,55.9%,8m
5214,3,[ELS]Dabs,3149,395,14,8,22,63.6%,5m
5214,2,[CIM]주먹,3149,198,7,12,19,36.8%,10m
5214,3,당나귀칠기기장님,3149,0,0,1,1,0.0%,9m
5214,3,lllIIIlllIIl,3149,0,0,2,2,0.0%,16m
5219,2,[겨울방어]LEAVE,3148,853,43,34,77,55.8%,6m
5219,1,발트하임,3148,1007,40,39,79,50.6%,5m
5219,3,PurplRainbow,3148,757,33,23,56,58.9%,5m
5219,2,[GIS]Prz,3148,862,33,32,65,50.8%,11m
5219,2,AAA,3148,411,16,15,31,51.6%,9m
5219,2,[NOTVP]Reynor,3148,88,2,6,8,25.0%,9m
5219,3,Stone,3148,30,1,2,3,33.3%,16m
5219,3,익쿤,3148,0,0,1,1,0.0%,17m
5219,3,Helix,3148,0,0,2,2,0.0%,4m
5219,2,낫슈,3148,0,0,4,4,0.0%,8m
5229,3,MAY,3147,356,68,43,111,61.3%,10m
5229,3,Integral,3147,1086,54,47,101,53.5%,5m
5229,3,llllllllllll,3147,58,3,1,4,75.0%,7m
5229,2,박부건,3147,107,3,6,9,33.3%,8m
5229,3,[FEETw]FEETLOVER,3147,58,2,1,3,66.7%,5m
5234,2,sILenZe,3146,295,40,28,68,58.8%,10m
5234,1,[5torM]멀티플레이어,3146,488,19,23,42,45.2%,8m
5234,3,IIIIIIIIIIII,3146,486,17,20,37,45.9%,11m
5234,2,NewBeast,3146,58,3,8,11,27.3%,9m
5234,3,[SGlory]CowBear,3146,0,0,1,1,0.0%,5m
5239,2,GoldionH,3145,30,5,3,8,62.5%,11m
5239,3,YuriToPia,3145,0,0,1,1,0.0%,7m
5241,2,[pepsl]찡찡,3144,1064,50,33,83,60.2%,11m
5241,3,CENSORED,3144,399,16,14,30,53.3%,10m
5241,3,MADAO,3144,168,7,4,11,63.6%,16m
5241,2,zaek,3144,0,4,1,5,80.0%,26m
5241,1,레전드,3144,0,1,2,3,33.3%,18m
5241,3,[롤이더잼]Beyond,3144,0,0,1,1,0.0%,16m
5241,3,없어요,3144,0,0,2,2,0.0%,6m
5241,2,Houkes,3144,0,0,7,7,0.0%,5m
5249,3,icewater,3143,58,3,3,6,50.0%,17m
5249,1,REATER,3143,92,2,2,4,50.0%,48m
5249,3,adjact,3143,0,1,0,1,100.0%,51m
5249,2,玉米濃湯,3143,32,1,10,11,9.1%,6m
5249,3,Deetau,3143,0,0,1,1,0.0%,10m
5249,3,청정수,3143,0,0,1,1,0.0%,6m
5255,1,법조인,3142,1652,86,78,164,52.4%,7m
5255,3,창우,3142,704,49,42,91,53.8%,6m
5255,3,DestinY,3142,278,16,13,29,55.2%,6m
5255,3,SCDatE,3142,213,6,3,9,66.7%,16m
5255,2,仲夏的夜,3142,0,4,2,6,66.7%,25m
5255,3,고기만두,3142,60,2,2,4,50.0%,10m
5255,3,랩터에이스레너드,3142,0,0,1,1,0.0%,16m
5255,3,[다음팟향우회]랄로,3142,0,0,1,1,0.0%,5m
5255,3,ajhskj,3142,0,0,1,1,0.0%,9m
5264,2,BJS,3141,1399,102,99,201,50.7%,6m
5264,3,Newattack,3141,1417,82,73,155,52.9%,17m
5264,2,[이터널]연겜만한다,3141,932,33,39,72,45.8%,5m
5264,3,[트수Crew]테송함니다,3141,633,27,17,44,61.4%,10m
5264,3,llllllllllll,3141,454,20,15,35,57.1%,16m
5264,2,너거미땅거미지뢰,3141,217,10,8,18,55.6%,4m
5264,3,[유진아사랑해]마루그슬핵개오짐,3141,198,8,4,12,66.7%,17m
5264,3,[히오스부대]듀크뉴켐,3141,170,6,3,9,66.7%,11m
5264,3,[PNUBA3]MapleK,3141,111,6,4,10,60.0%,5m
5264,3,噠噠噠碰,3141,86,4,2,6,66.7%,4m
5264,3,송송이,3141,32,1,5,6,16.7%,51m
5275,3,조갯살,3140,1543,89,72,161,55.3%,6m
5275,2,Raf,3140,1384,74,70,144,51.4%,5m
5275,3,[비트]개가튼,3140,500,18,19,37,48.6%,5m
5275,2,[세미온TD]팔랑크스,3140,212,9,5,14,64.3%,8m
5275,3,샤프와샤프심,3140,260,9,9,18,50.0%,4m
5275,3,Ultrarich,3140,232,8,10,18,44.4%,16m
5275,2,트와이스,3140,0,5,0,5,100.0%,25m
5275,2,서리한,3140,156,5,9,14,35.7%,5m
5283,2,Callmebichon,3139,1441,222,216,438,50.7%,6m
5283,1,[트위치]레드스톰,3139,1538,84,93,177,47.5%,5m
5283,2,akders,3139,719,28,28,56,50.0%,9m
5283,3,OOXIXOO,3139,676,25,21,46,54.3%,8m
5283,3,[Rovic]린킨파크,3139,225,11,9,20,55.0%,6m
5283,1,IlIllIlllIll,3139,181,5,4,9,55.6%,48m
5283,3,[암기]파일럿,3139,0,1,0,1,100.0%,8m
5283,3,[ELS]Whale,3139,0,0,1,1,0.0%,5m
5291,2,Spriggan,3138,1502,182,186,368,49.5%,8m
5291,2,해치지않아요,3138,1338,50,52,102,49.0%,8m
5291,3,iiiiiiiiiiii,3138,271,32,28,60,53.3%,6m
5291,3,[Equal]ReyNor,3138,482,18,16,34,52.9%,6m
5291,2,[笹木咲]Masamune,3138,394,17,13,30,56.7%,9m
5291,3,Ahyaneru,3138,302,13,8,21,61.9%,6m
5291,2,깅강,3138,308,11,13,24,45.8%,6m
5291,2,시진핑암살작전,3138,193,8,7,15,53.3%,5m
5291,3,[신관직을]루리웹백레벨,3138,0,1,0,1,100.0%,6m
5291,3,Joker,3138,0,1,3,4,25.0%,5m
5301,2,NOVA,3137,1109,77,60,137,56.2%,5m
5301,3,SSFWL,3137,60,3,4,7,42.9%,10m
5301,3,ggkr,3137,60,2,5,7,28.6%,7m
5301,3,[시스테마]아나닉넴정해줘,3137,0,1,0,1,100.0%,8m
5301,3,rapre,3137,0,0,2,2,0.0%,6m
5306,2,llllllllllll,3136,1523,390,363,753,51.8%,5m
5306,2,ohmduph,3136,1547,165,159,324,50.9%,3m
5306,3,[TF]sOsaeggi,3136,1275,93,109,202,46.0%,6m
5306,2,[중금속중독자]SilVerBV,3136,281,11,10,21,52.4%,4m
5306,2,[스타놀이터]qwerqwer,3136,102,2,4,6,33.3%,5m
5306,3,고추나만질께,3136,0,1,0,1,100.0%,3m
5306,2,[Blacer]유리살앙,3136,30,1,9,10,10.0%,3m
5306,2,YuniQ,3136,0,0,1,1,0.0%,26m
5314,2,llllllIllIll,3135,1340,214,186,400,53.5%,5m
5314,3,shdht,3135,655,27,14,41,65.9%,5m
5314,3,주린버핏,3135,96,5,5,10,50.0%,3m
5314,2,lovepp,3135,138,5,7,12,41.7%,5m
5314,2,llllllllllll,3135,88,3,1,4,75.0%,2m
5314,3,정슈켄타인,3135,0,1,0,1,100.0%,3m
5320,2,Anndroid,3134,793,217,190,407,53.3%,6m
5320,2,세인이,3134,1269,133,113,246,54.1%,3m
5320,2,llllllllllll,3134,1361,77,72,149,51.7%,4m
5320,3,레오나르도다빈치,3134,401,17,13,30,56.7%,5m
5320,2,Tetronus,3134,193,7,6,13,53.8%,4m
5320,3,TifFanYSpC,3134,58,2,3,5,40.0%,5m
5326,2,나이스,3133,1549,905,873,1778,50.9%,8m
5326,2,[Mech]SpyTe,3133,920,34,41,75,45.3%,2m
5326,2,GOZA,3133,672,31,31,62,50.0%,6m
5326,2,청새치튀김,3133,214,10,7,17,58.8%,11m
5330,3,GameThrower,3132,454,17,13,30,56.7%,7m
5330,2,[Epik]PathiZ,3132,390,15,15,30,50.0%,6m
5330,2,[再睡十分鐘]妤安,3132,139,4,0,4,100.0%,50m
5330,3,Ping,3132,0,3,2,5,60.0%,5m
5330,3,공허의저그,3132,30,2,1,3,66.7%,1m
5330,3,[BigBro]박준희,3132,30,1,2,3,33.3%,10m
5330,1,IIIIIIIIIIII,3132,48,1,4,5,20.0%,17m
5337,1,[TheDOH]強勇集團,3131,1408,83,85,168,49.4%,3m
5337,1,MMQ,3131,604,39,48,87,44.8%,5m
5337,2,[SofT]Delight,3131,416,16,20,36,44.4%,1m
5337,3,멋쟁이섭,3131,290,10,11,21,47.6%,6m
5337,3,米普,3131,30,2,1,3,66.7%,5m
5337,1,[isnous]阿爾法,3131,0,1,0,1,100.0%,48m
5343,2,데굴데굴꽈당,3130,789,63,61,124,50.8%,1m
5343,3,짐레이너,3130,321,12,4,16,75.0%,5m
5343,3,겆휴,3130,0,0,1,1,0.0%,5m
5346,2,도토리,3129,837,92,73,165,55.8%,6m
5346,2,마린,3129,747,46,44,90,51.1%,5m
5346,3,[잘먹고산다]목소리의형태,3129,199,25,11,36,69.4%,6m
5346,3,[CA]HeSkyNoyToer,3129,518,20,18,38,52.6%,4m
5346,3,dOnTYaKnOw,3129,206,9,6,15,60.0%,6m
5346,1,Aliado,3129,159,8,2,10,80.0%,19m
5346,3,WEIDAYEE,3129,134,8,11,19,42.1%,3m
5346,2,ABCD,3129,134,4,5,9,44.4%,6m
5346,1,Golt,3129,96,3,3,6,50.0%,18m
5346,2,AyWan,3129,0,2,4,6,33.3%,26m
5346,2,dkdhdfas,3129,46,1,2,3,33.3%,26m
5357,2,Vestnik,3128,0,4,2,6,66.7%,25m
5357,3,[Mist]stickgolem,3128,58,2,2,4,50.0%,5m
5359,3,khm,3127,1583,442,412,854,51.8%,1m
5359,3,ViperRevol,3127,736,78,64,142,54.9%,7m
5359,2,lartov,3127,112,5,2,7,71.4%,25m
5359,2,dlwsn,3127,122,5,8,13,38.5%,3m
5359,3,루돌프강아지,3127,0,0,1,1,0.0%,3m
5359,3,[沉默]SiLeNceTiN,3127,0,0,4,4,0.0%,5m
5359,3,제우스,3127,0,0,5,5,0.0%,3m
5366,3,강원도,3126,473,87,72,159,54.7%,3m
5366,3,전직욕교사,3126,1022,43,27,70,61.4%,6m
5366,3,Bass,3126,694,28,27,55,50.9%,7m
5366,2,[sheep8]덕구아저씨,3126,671,28,32,60,46.7%,3m
5366,2,[LQV]백두산백호,3126,491,21,18,39,53.8%,6m
5366,3,아이아이아이,3126,382,19,15,34,55.9%,6m
5366,2,씩이튼,3126,498,17,22,39,43.6%,6m
5366,3,wooyoo,3126,290,10,9,19,52.6%,3m
5366,3,일요일,3126,0,0,1,1,0.0%,51m
5375,3,[S0fT]내가이영호,3125,1130,122,111,233,52.4%,7m
5375,2,[축구의전설]국민연료,3125,941,86,70,156,55.1%,5m
5375,2,구울즈,3125,425,16,16,32,50.0%,3m
5375,3,[화이트섀도우]요호,3125,354,15,10,25,60.0%,4m
5375,3,시간을달려서,3125,280,10,8,18,55.6%,6m
5375,2,Fiction,3125,181,7,6,13,53.8%,8m
5375,2,習近平,3125,0,4,2,6,66.7%,25m
5375,2,Neyrose,3125,0,4,2,6,66.7%,5m
5375,3,서점주인장,3125,90,3,4,7,42.9%,4m
5375,3,건설로봇,3125,30,2,0,2,100.0%,3m
5375,3,Nevem,3125,0,1,4,5,20.0%,6m
5375,3,[Aslan]Absolute,3125,0,0,2,2,0.0%,7m
5387,2,HIT,3124,924,33,36,69,47.8%,6m
5387,3,[Equal]루이나기,3124,380,13,9,22,59.1%,3m
5387,2,[병신들모임]zlWHAIKlz,3124,30,5,3,8,62.5%,2m
5387,3,[On엔oN]으엉어려,3124,60,3,1,4,75.0%,10m
5387,3,[ASROMA]반민,3124,30,1,2,3,33.3%,6m
5387,3,딴곰,3124,30,1,3,4,25.0%,1m
5387,3,[댕댕단]HotPa,3124,0,0,1,1,0.0%,11m
5387,3,IIIIIIIIIII,3124,0,0,1,1,0.0%,6m
5395,2,IIIIIIIIIIII,3123,1516,242,222,464,52.2%,5m
5395,2,秀謬先生,3123,1478,203,187,390,52.1%,2m
5395,2,[GGD]Regal,3123,962,35,40,75,46.7%,3m
5395,2,llllllllllll,3123,428,18,24,42,42.9%,8m
5395,3,씨알한톨,3123,0,0,1,1,0.0%,5m
5395,2,김질럿,3123,0,0,3,3,0.0%,50m
5401,3,COVID,3122,1342,65,60,125,52.0%,5m
5401,3,나폴레옹,3122,358,13,8,21,61.9%,6m
5401,3,Dlive,3122,249,11,5,16,68.8%,6m
5401,3,전쟁사나이,3122,105,7,5,12,58.3%,5m
5401,3,Hakaris,3122,147,4,2,6,66.7%,6m
5401,3,UED,3122,172,3,13,16,18.8%,1m
5401,3,[조커]smilejoker,3122,0,0,1,1,0.0%,3m
5401,3,IIiiIIiiiiii,3122,0,0,1,1,0.0%,4m
5409,3,[超新星]战巡舰上将,3121,1431,321,301,622,51.6%,4m
5409,3,[ELS]테스형,3121,58,3,2,5,60.0%,4m
5409,2,Trader,3121,116,2,3,5,40.0%,50m
5409,3,LLssMaRi,3121,30,1,1,2,50.0%,4m
5409,3,sah,3121,0,0,1,1,0.0%,1m
5414,2,RED,3120,1536,245,235,480,51.0%,8m
5414,2,NTrC,3120,574,24,23,47,51.1%,5m
5414,2,은해성,3120,120,5,11,16,31.2%,6m
5414,3,ZooDaSa,3120,118,4,7,11,36.4%,7m
5418,1,donotstop,3119,1581,307,309,616,49.8%,4m
5418,2,구이쁜,3119,565,22,21,43,51.2%,3m
5418,1,StarStarStar,3119,309,7,2,9,77.8%,18m
5418,3,[SeA]雷德,3119,148,7,3,10,70.0%,11m
5418,3,神龍擺尾,3119,95,4,2,6,66.7%,6m
5418,3,iiiiiiiii,3119,144,4,3,7,57.1%,51m
5418,3,몽구,3119,160,4,4,8,50.0%,51m
5425,1,ENIG,3118,1356,69,71,140,49.3%,7m
5425,3,lIlIlIlIlIlI,3118,194,8,4,12,66.7%,3m
5425,2,KainPrime,3118,92,4,7,11,36.4%,8m
5425,3,Astro,3118,94,3,3,6,50.0%,7m
5425,2,IIIIIIIIIIII,3118,58,2,6,8,25.0%,5m
5430,2,조강지처가좋더라,3117,1390,177,165,342,51.8%,3m
5430,3,chololate,3117,438,21,14,35,60.0%,4m
5430,2,[두루와]현이지,3117,43,7,5,12,58.3%,3m
5430,3,[7준생]헤으응,3117,116,5,3,8,62.5%,11m
5430,3,[감자에감자]Infestor,3117,0,2,2,4,50.0%,6m
5430,3,킹스카이언,3117,0,0,1,1,0.0%,11m
5430,3,김명찬,3117,0,0,1,1,0.0%,1m
5430,3,[ACD]키라요시카게,3117,0,0,2,2,0.0%,11m
5438,2,투명한영웅,3116,322,12,13,25,48.0%,4m
5438,3,IIIIIIIIIIII,3116,198,9,4,13,69.2%,11m
5438,3,VolumeUp,3116,0,4,1,5,80.0%,11m
5438,3,lIlIlIlIlIlI,3116,93,4,2,6,66.7%,2m
5438,2,박즈타,3116,88,2,2,4,50.0%,2m
5438,3,너의어무이,3116,0,0,1,1,0.0%,6m
5444,3,spiraled,3115,168,15,11,26,57.7%,11m
5444,2,[짱깨는절대악]무쿵현따,3115,354,12,20,32,37.5%,5m
5444,3,SwarmOfZasz,3115,114,5,2,7,71.4%,5m
5444,1,문재인통치하의삶,3115,0,1,1,2,50.0%,18m
5444,3,[ELS]스타끄고공부해라,3115,30,1,4,5,20.0%,3m
5449,2,가가울랄라,3114,1290,324,289,613,52.9%,6m
5449,3,llllllllllll,3114,1263,92,84,176,52.3%,5m
5449,3,없다,3114,403,22,19,41,53.7%,11m
5449,3,닭강정,3114,295,11,3,14,78.6%,11m
5449,1,大大,3114,239,9,5,14,64.3%,18m
5449,2,Han,3114,94,4,10,14,28.6%,8m
5449,3,freewin,3114,0,3,2,5,60.0%,6m
5449,3,군필여고생,3114,0,1,0,1,100.0%,6m
5449,3,Jimranor,3114,30,1,3,4,25.0%,6m
5449,2,대박이달님이,3114,30,1,6,7,14.3%,4m
5449,3,[WHB]한화우승,3114,0,0,1,1,0.0%,7m
5449,3,FlaSh,3114,0,0,1,1,0.0%,6m
5449,3,만능오징어,3114,0,0,4,4,0.0%,3m
5462,2,FAULT,3113,564,25,21,46,54.3%,4m
5462,2,Maru,3113,558,19,27,46,41.3%,3m
5462,2,[WTSC]KDY,3113,182,6,12,18,33.3%,2m
5462,3,武漢肺炎,3113,181,5,3,8,62.5%,8m
5462,2,SAe,3113,46,1,1,2,50.0%,25m
5462,1,TerranBaby,3113,97,1,3,4,25.0%,47m
5462,3,[ESS]수미다,3113,30,1,4,5,20.0%,6m
5469,2,bluin,3112,1541,331,320,651,50.8%,2m
5469,2,[클랜같은클랜]변현우,3112,530,18,26,44,40.9%,3m
5469,3,델람,3112,300,10,15,25,40.0%,3m
5469,2,Strive,3112,60,3,7,10,30.0%,4m
5469,3,[미륵성전]미륵,3112,30,1,1,2,50.0%,4m
5469,3,SimonD,3112,0,0,2,2,0.0%,6m
5475,1,그네젖통닌자,3111,1506,129,136,265,48.7%,3m
5475,2,MrGlassAnkle,3111,174,72,57,129,55.8%,6m
5475,2,[모노시발꺼]바밤바,3111,472,16,26,42,38.1%,3m
5475,3,Orange,3111,0,4,1,5,80.0%,11m
5475,3,[무한오영종]Closer,3111,0,1,1,2,50.0%,4m
5480,2,天美愛心,3110,1530,89,86,175,50.9%,4m
5480,2,OrbitsterSir,3110,1039,84,82,166,50.6%,6m
5480,2,꽃마름셀로나,3110,884,51,58,109,46.8%,5m
5480,2,Crema,3110,1004,39,39,78,50.0%,2m
5480,1,[붉은혁명]KorMarineGW,3110,973,38,39,77,49.4%,7m
5480,2,CHUAN,3110,336,26,21,47,55.3%,5m
5480,3,[챔리와아이들]DoubleJ,3110,182,10,10,20,50.0%,5m
5480,3,[삼삼업]삼삼업불곰,3110,0,4,1,5,80.0%,1m
5480,2,Iris,3110,92,3,9,12,25.0%,5m
5480,1,III,3110,97,1,2,3,33.3%,47m
5480,3,[정말데단해]너검마밀키스,3110,0,0,1,1,0.0%,3m
5480,3,[귀요미햄스터]lIlIllIIllII,3110,0,0,2,2,0.0%,5m
5492,2,tabiseal,3109,943,119,112,231,51.5%,8m
5492,3,해피평창,3109,1421,79,62,141,56.0%,7m
5492,1,中國餃子,3109,1376,62,62,124,50.0%,4m
5492,3,3109,461,60,40,100,60.0%,3m
5492,2,Parre,3109,308,12,10,22,54.5%,50m
5492,3,[NLTN]아킬레스총,3109,232,11,4,15,73.3%,1m
5492,3,Massinggal,3109,0,4,1,5,80.0%,4m
5492,3,HaiYaa,3109,0,2,4,6,33.3%,7m
5500,3,Avangarde,3108,313,10,7,17,58.8%,1m
5500,2,[코코갈비]Snack,3108,0,1,2,3,33.3%,5m
5502,2,앵무쇠,3107,422,32,38,70,45.7%,3m
5502,3,스타접은지오래다,3107,436,16,13,29,55.2%,11m
5502,1,[국가정보원]잉옹잉,3107,304,9,1,10,90.0%,18m
5502,3,자군공,3107,147,4,4,8,50.0%,1m
5502,3,大力,3107,94,4,5,9,44.4%,2m
5502,3,Vanish,3107,145,4,6,10,40.0%,6m
5508,2,[海膽王]KuasMDEking,3106,481,52,53,105,49.5%,3m
5508,3,불랑서,3106,388,16,11,27,59.3%,5m
5508,2,IlIIlIIIIlIl,3106,416,16,13,29,55.2%,2m
5508,3,[트수Crew]행복했꿀벌,3106,322,13,4,17,76.5%,6m
5508,3,천빛,3106,270,9,7,16,56.2%,51m
5508,3,Liberty,3106,254,8,6,14,57.1%,3m
5508,2,llllllllllll,3106,164,6,8,14,42.9%,5m
5508,3,osunnydayo,3106,114,5,3,8,62.5%,3m
5508,3,[옹선생님]모노,3106,0,0,1,1,0.0%,7m
5517,3,vysla,3105,1598,140,120,260,53.8%,7m
5517,3,oryzasativa,3105,979,61,43,104,58.7%,4m
5517,2,IIIIIIIIIIII,3105,1437,59,51,110,53.6%,1m
5517,3,카친스키,3105,698,42,37,79,53.2%,3m
5517,3,llIllIllllll,3105,194,9,3,12,75.0%,1m
5517,3,llllIIlllIIl,3105,30,2,0,2,100.0%,3m
5517,2,llllllllllll,3105,1,2,6,8,25.0%,8m
5517,3,[天下布武]織田信長,3105,0,0,2,2,0.0%,5m
5525,2,[Aster]TripleS,3104,1407,342,388,730,46.8%,8m
5525,2,nosonoso,3104,991,175,160,335,52.2%,8m
5525,1,RuFie,3104,1178,133,134,267,49.8%,7m
5525,3,우산장수,3104,563,58,48,106,54.7%,3m
5525,2,쩌러,3104,188,34,41,75,45.3%,3m
5525,2,초코라테,3104,23,1,8,9,11.1%,3m
5531,2,hge,3103,1311,81,71,152,53.3%,6m
5531,2,Yolo,3103,829,36,34,70,51.4%,8m
5531,3,로도의스타크,3103,681,28,23,51,54.9%,4m
5531,3,한종팔,3103,460,22,12,34,64.7%,3m
5531,3,已完成,3103,182,7,7,14,50.0%,3m
5531,2,[TalenT]Bored,3103,144,6,4,10,60.0%,6m
5531,2,[FsACN]雲南大學,3103,186,6,9,15,40.0%,6m
5531,3,Jyuri,3103,60,2,3,5,40.0%,11m
5531,3,금복주,3103,0,1,1,2,50.0%,11m
5531,3,주먹이웃는다,3103,30,1,5,6,16.7%,5m
5541,2,밥먹고하자고,3102,1503,123,126,249,49.4%,3m
5541,2,[기니피그]열정플레이어,3102,1512,109,110,219,49.8%,5m
5541,3,[CIA암살단]overthetop,3102,1107,53,26,79,67.1%,11m
5541,3,곰돌이하니허니,3102,178,7,8,15,46.7%,7m
5541,3,황제,3102,30,1,2,3,33.3%,3m
5541,3,guttedbro,3102,0,0,1,1,0.0%,7m
5547,3,maverickSR,3101,168,34,17,51,66.7%,7m
5547,3,불타는심장,3101,534,19,17,36,52.8%,5m
5547,3,OASIS,3101,356,12,12,24,50.0%,8m
5547,3,MISSYCLUB,3101,324,11,10,21,52.4%,1m
5547,3,노트르담,3101,223,8,5,13,61.5%,11m
5547,3,lIlIlIllIl,3101,176,7,7,14,50.0%,7m
5547,3,비누줍는말년병장,3101,200,7,8,15,46.7%,7m
5547,3,[에이지티]김소은,3101,88,3,5,8,37.5%,5m
5547,3,[Lotuz]ERP,3101,0,1,0,1,100.0%,3m
5547,3,[보금자리]미르,3101,0,1,0,1,100.0%,6m
5547,3,TERMINATOR,3101,0,1,0,1,100.0%,8m
5547,2,llIIlllIII,3101,0,1,0,1,100.0%,25m
5547,3,zerow,3101,30,1,3,4,25.0%,4m
5560,1,IIIIIIIIIIII,3100,124,23,26,49,46.9%,4m
5560,1,아둔의창,3100,508,17,27,44,38.6%,2m
5560,3,땅거미지뢰,3100,345,16,22,38,42.1%,5m
5560,2,dotasin,3100,360,14,15,29,48.3%,6m
5560,2,[달빛암흑기사]TOD,3100,235,8,2,10,80.0%,51m
5560,3,저학년학생,3100,139,7,4,11,63.6%,1m
5560,3,沉梅,3100,62,3,5,8,37.5%,3m
5560,3,술사,3100,30,2,0,2,100.0%,3m
5560,3,Glorier,3100,30,2,0,2,100.0%,8m
5560,3,Woo,3100,58,2,1,3,66.7%,4m
5560,3,돌격대장방울이,3100,30,1,3,4,25.0%,1m
5560,3,CrownFour,3100,0,0,1,1,0.0%,8m
5560,3,llllllllllll,3100,0,0,1,1,0.0%,6m
5573,3,꾸설,3099,129,6,3,9,66.7%,6m
5573,2,퍼렁별인,3099,128,4,5,9,44.4%,8m
5573,3,Bisu,3099,0,0,1,1,0.0%,4m
5573,3,[文災殃]盧武鉉,3099,0,0,3,3,0.0%,5m
5573,3,比茨比茨,3099,0,0,3,3,0.0%,6m
5578,1,lllllllllllI,3098,1539,120,128,248,48.4%,7m
5578,3,JWA,3098,338,12,12,24,50.0%,2m
5578,3,Blue,3098,0,3,2,5,60.0%,3m
5578,3,유노오빠,3098,58,2,3,5,40.0%,3m
5578,3,[EUNSUL]ZION,3098,30,2,5,7,28.6%,7m
5578,2,나는사람이자,3098,30,2,8,10,20.0%,6m
5584,3,旯牙,3097,901,56,41,97,57.7%,5m
5584,3,泰瑞爾,3097,573,39,34,73,53.4%,3m
5584,3,초코송이맛있어,3097,178,7,8,15,46.7%,6m
5584,2,아디이,3097,91,5,1,6,83.3%,25m
5584,1,자유시간,3097,212,5,11,16,31.2%,48m
5584,3,아연,3097,0,1,0,1,100.0%,6m
5584,3,형민,3097,0,1,0,1,100.0%,7m
5584,3,lllllllllll,3097,0,0,2,2,0.0%,2m
5592,1,피구공,3096,1372,103,102,205,50.2%,7m
5592,3,Song,3096,1270,92,70,162,56.8%,3m
5592,2,Falcon,3096,1346,51,53,104,49.0%,2m
5592,2,홍합짬뽕,3096,347,13,14,27,48.1%,6m
5592,3,超新星,3096,192,7,7,14,50.0%,1m
5592,3,아칸,3096,86,4,2,6,66.7%,3m
5598,1,[SHIPS]샤릭,3095,1513,191,193,384,49.7%,4m
5598,3,IlIlIlIlIlIl,3095,314,12,9,21,57.1%,3m
5598,3,easybot,3095,320,11,6,17,64.7%,7m
5598,1,희웅이에요,3095,279,10,5,15,66.7%,18m
5598,2,무적의삼중대,3095,208,7,14,21,33.3%,8m
5598,2,세라핀,3095,107,3,0,3,100.0%,50m
5604,2,안진마,3094,710,49,51,100,49.0%,3m
5604,3,MolaBeaR,3094,512,19,19,38,50.0%,5m
5604,2,llllllllllll,3094,0,4,3,7,57.1%,11m
5604,3,MinDogi,3094,88,4,4,8,50.0%,4m
5604,3,GymK,3094,90,4,6,10,40.0%,3m
5604,3,전레기,3094,86,3,3,6,50.0%,8m
5604,3,홍춘,3094,44,2,9,11,18.2%,51m
5604,3,[seval]아이리스,3094,0,0,1,1,0.0%,11m
5612,2,尼根,3093,1136,78,69,147,53.1%,1m
5612,3,Zantrid,3093,270,11,12,23,47.8%,11m
5612,3,kcae,3093,99,5,6,11,45.5%,3m
5612,3,[Rvn]KYO,3093,86,4,1,5,80.0%,3m
5612,1,ayiwueio,3093,94,4,2,6,66.7%,46m
5612,3,옥녀,3093,95,2,4,6,33.3%,1m
5612,2,[자폐아]스타투,3093,0,1,0,1,100.0%,26m
5619,3,CCS,3092,1503,104,85,189,55.0%,3m
5619,2,[GIS]BeHappy,3092,742,44,49,93,47.3%,1m
5619,2,Gengar,3092,90,7,6,13,53.8%,1m
5619,3,IMViC,3092,148,7,8,15,46.7%,7m
5619,2,청바지교복,3092,90,4,13,17,23.5%,11m
5619,3,Giri,3092,30,1,1,2,50.0%,8m
5619,1,바츠넬,3092,0,1,1,2,50.0%,17m
5619,3,GroovSoul,3092,0,0,2,2,0.0%,6m
5627,1,해민,3091,1201,566,554,1120,50.5%,4m
5627,3,완소남,3091,259,11,8,19,57.9%,3m
5627,2,llllllllllll,3091,48,5,2,7,71.4%,25m
5627,3,IIIIIIIIIIII,3091,58,3,3,6,50.0%,8m
5631,2,[노인성듀오]련남동터프쿠키,3090,1484,72,73,145,49.7%,2m
5631,3,Garry,3090,945,53,32,85,62.4%,5m
5631,3,정지홍,3090,589,25,20,45,55.6%,3m
5631,2,세침떼기,3090,532,18,23,41,43.9%,4m
5631,3,[Aster]Cheerful,3090,429,17,10,27,63.0%,6m
5631,2,Arifureta,3090,0,4,1,5,80.0%,26m
5631,3,홍시,3090,0,4,1,5,80.0%,4m
5631,3,llllllllllll,3090,92,3,2,5,60.0%,1m
5639,1,[여신조희아]홍요환,3089,1529,288,288,576,50.0%,5m
5639,3,Brokenwings,3089,202,24,3,27,88.9%,11m
5639,2,Joker,3089,534,18,26,44,40.9%,4m
5639,2,hijuneee,3089,88,5,3,8,62.5%,4m
5639,3,DukeWilliam,3089,0,4,1,5,80.0%,1m
5639,1,[IWYDI]YGodLAG,3089,96,2,1,3,66.7%,18m
5645,2,Jacta,3088,1545,272,260,532,51.1%,5m
5645,2,[ash]darha,3088,1243,66,56,122,54.1%,8m
5645,2,IIIIIII,3088,730,33,28,61,54.1%,11m
5645,3,無常,3088,621,26,17,43,60.5%,8m
5645,3,다마츼,3088,409,16,16,32,50.0%,4m
5645,2,ZOTBAB,3088,346,12,22,34,35.3%,2m
5645,3,BabyShark,3088,157,6,3,9,66.7%,7m
5645,2,SDY,3088,30,5,3,8,62.5%,5m
5645,3,[無材]Titan,3088,58,2,3,5,40.0%,11m
5645,3,오야,3088,0,0,1,1,0.0%,6m
5645,3,[어시스트]지지요,3088,0,0,2,2,0.0%,7m
5656,3,Ctstrphy,3087,1531,80,75,155,51.6%,4m
5656,2,쾌남정훈,3087,822,75,64,139,54.0%,3m
5656,3,[DoBTeN]唱跳嘻哈打籃球,3087,146,8,3,11,72.7%,2m
5656,3,저그,3087,178,7,5,12,58.3%,3m
5656,3,DrainNestea,3087,194,7,9,16,43.8%,5m
5656,3,IIIIIIIIIIII,3087,145,3,1,4,75.0%,19m
5662,3,vector,3086,189,8,5,13,61.5%,3m
5662,3,김강일,3086,58,2,1,3,66.7%,6m
5662,3,암살자,3086,0,0,1,1,0.0%,3m
5665,3,StupidJack,3085,838,34,27,61,55.7%,5m
5665,3,Protoss,3085,86,3,4,7,42.9%,7m
5665,3,스투열사의표본,3085,0,0,1,1,0.0%,1m
5668,3,[C59646]평택가즈아,3084,1513,109,107,216,50.5%,5m
5668,3,손오공,3084,1502,67,68,135,49.6%,1m
5668,2,[비트]버블,3084,788,29,32,61,47.5%,5m
5668,3,Mixup,3084,390,14,15,29,48.3%,3m
5668,3,UniCorn,3084,340,12,13,25,48.0%,2m
5668,2,dulldal,3084,117,5,2,7,71.4%,17m
5668,3,넌못생겼어,3084,0,4,1,5,80.0%,11m
5668,3,[고잉메리호]허리디스크,3084,120,4,7,11,36.4%,1m
5668,3,markjimken,3084,58,2,2,4,50.0%,3m
5668,1,SiHyun,3084,90,2,6,8,25.0%,18m
5668,3,[Legend]수원재떨이,3084,30,1,3,4,25.0%,5m
5668,3,[S급]거신,3084,0,0,1,1,0.0%,5m
5680,2,우주날개,3083,1495,377,353,730,51.6%,3m
5680,2,큰털보,3083,976,36,42,78,46.2%,2m
5680,3,lochtext,3083,30,2,1,3,66.7%,1m
5680,3,ShadoW,3083,60,2,3,5,40.0%,11m
5684,2,SURPRISER,3082,1488,149,137,286,52.1%,6m
5684,1,Seriously,3082,769,28,32,60,46.7%,8m
5684,3,착한곰,3082,455,17,19,36,47.2%,7m
5684,2,[무리무리팸]MerCurial,3082,228,7,11,18,38.9%,4m
5684,2,NTA,3082,108,6,7,13,46.2%,3m
5684,2,llllllllllll,3082,186,6,17,23,26.1%,6m
5684,3,[strong]앙투아네트,3082,114,5,4,9,55.6%,4m
5684,3,ICuracaoI,3082,136,3,2,5,60.0%,3m
5684,3,엄마는서포터,3082,30,2,2,4,50.0%,11m
5684,2,얀아낭,3082,0,1,3,4,25.0%,25m
5684,3,jelly,3082,0,0,2,2,0.0%,7m
5695,2,Colossus,3081,767,32,33,65,49.2%,6m
5695,3,拉菲爾,3081,209,9,6,15,60.0%,51m
5695,3,재콩,3081,144,6,4,10,60.0%,3m
5695,3,바코드,3081,94,4,2,6,66.7%,3m
5695,2,Thispain,3081,95,3,2,5,60.0%,25m
5695,3,나빌레라,3081,0,0,1,1,0.0%,3m
5695,3,lIlllIllIIll,3081,0,0,1,1,0.0%,11m
5695,3,시뎌염,3081,0,0,1,1,0.0%,4m
5695,2,possibility,3081,0,0,1,1,0.0%,25m
5704,3,[WTSC]서우,3080,1080,51,50,101,50.5%,3m
5704,3,Gojujang,3080,495,20,16,36,55.6%,3m
5704,3,Jeth,3080,376,17,14,31,54.8%,1m
5704,1,쓸거라,3080,143,6,4,10,60.0%,47m
5704,3,doubleqpc,3080,97,2,0,2,100.0%,51m
5704,3,김광호,3080,0,1,0,1,100.0%,7m
5704,3,FeelSoGood,3080,0,0,3,3,0.0%,5m
5711,2,ROUTNINE,3079,886,97,90,187,51.9%,3m
5711,3,styer,3079,232,9,12,21,42.9%,5m
5711,3,[KRSC2]초무홈,3079,114,5,2,7,71.4%,5m
5711,2,[국가정보원]silver,3079,0,1,0,1,100.0%,25m
5711,3,[Worm]용용,3079,92,1,1,2,50.0%,6m
5711,3,레인,3079,0,0,2,2,0.0%,5m
5717,3,soO,3078,1566,63,59,122,51.6%,7m
5717,1,IIIIIIIIIIII,3078,1350,45,58,103,43.7%,7m
5717,3,머디,3078,294,10,13,23,43.5%,1m
5717,3,[SofT]지면서배울까,3078,86,4,2,6,66.7%,8m
5717,3,[권선]Mark,3078,60,2,3,5,40.0%,5m
5717,1,Smoothster,3078,0,1,2,3,33.3%,48m
5717,3,ImSpecialOne,3078,0,0,2,2,0.0%,4m
5724,3,[스카이파이터]이채연,3077,1420,226,207,433,52.2%,1m
5724,2,광솩이,3077,363,44,35,79,55.7%,6m
5724,2,IlllllIIIIll,3077,435,16,22,38,42.1%,4m
5724,1,이창현,3077,190,7,5,12,58.3%,17m
5724,3,부리부리꿀꿀,3077,0,0,3,3,0.0%,6m
5729,2,woong,3076,948,40,39,79,50.6%,4m
5729,3,baecome,3076,469,17,13,30,56.7%,3m
5729,3,我是狗逼,3076,400,16,10,26,61.5%,3m
5729,3,TonyStark,3076,180,15,12,27,55.6%,3m
5729,3,고니,3076,156,5,0,5,100.0%,3m
5729,3,멀봐,3076,60,2,6,8,25.0%,3m
5729,3,승구,3076,0,1,1,2,50.0%,3m
5736,3,Silvers,3075,905,160,146,306,52.3%,8m
5736,1,IIIIIIIIIIII,3075,682,47,41,88,53.4%,4m
5736,3,[중금속중독자]듀얼,3075,402,27,13,40,67.5%,3m
5736,3,이도형,3075,88,4,2,6,66.7%,7m
5736,3,CAT,3075,0,1,1,2,50.0%,6m
5736,3,[Hppl]sWhirly,3075,0,0,1,1,0.0%,7m
5742,2,Ricky,3074,997,44,42,86,51.2%,8m
5742,2,[GITS]ASxRyan,3074,1040,40,50,90,44.4%,3m
5742,3,마재윤,3074,929,36,31,67,53.7%,3m
5742,3,Justin,3074,677,26,20,46,56.5%,7m
5742,3,[Amani]RapTor,3074,430,25,21,46,54.3%,6m
5742,3,정환,3074,582,22,22,44,50.0%,7m
5742,3,SuDa,3074,466,18,15,33,54.5%,3m
5742,3,Kai,3074,216,9,2,11,81.8%,2m
5742,3,Marquez,3074,0,0,2,2,0.0%,1m
5742,3,Lani,3074,0,0,2,2,0.0%,7m
5752,1,[대부대부]세미터하나,3073,58,6,7,13,46.2%,5m
5752,3,moon,3073,142,5,5,10,50.0%,3m
5752,3,[해병대전우]응급실,3073,58,3,2,5,60.0%,2m
5752,3,[스타놀이터]KLSAM,3073,58,3,5,8,37.5%,5m
5752,3,IlIIIlIIllII,3073,30,2,2,4,50.0%,3m
5752,1,NIMIRUR,3073,97,1,1,2,50.0%,17m
5758,3,Snowtiger,3072,1202,53,38,91,58.2%,2m
5758,2,emg,3072,212,7,20,27,25.9%,11m
5758,3,너네집옆,3072,178,6,7,13,46.2%,3m
5758,3,Darsota,3072,122,4,6,10,40.0%,7m
5758,1,[저거넌트]오레오,3072,48,2,3,5,40.0%,18m
5758,3,PSUP,3072,30,1,2,3,33.3%,3m
5764,2,asura,3071,1414,439,414,853,51.5%,3m
5764,3,skinnerbox,3071,583,23,18,41,56.1%,11m
5764,3,LiveHard,3071,354,13,8,21,61.9%,3m
5764,3,총사령관,3071,120,5,3,8,62.5%,7m
5764,3,omgvi,3071,30,1,2,3,33.3%,3m
5764,3,[쓰르라미]무강이는못하니까,3071,0,0,1,1,0.0%,1m
5770,3,genious,3070,705,41,18,59,69.5%,1m
5770,2,SKTIBANKY,3070,596,20,25,45,44.4%,6m
5770,3,맹독은맹독맹독해,3070,113,2,2,4,50.0%,2m
5770,3,AilluSion,3070,30,1,2,3,33.3%,3m
5770,3,CKBlur,3070,0,1,4,5,20.0%,5m
5770,3,IlIlIIIIlll,3070,0,0,2,2,0.0%,7m
5776,3,머라카노,3069,1511,89,69,158,56.3%,3m
5776,2,innings,3069,967,48,43,91,52.7%,5m
5776,3,pATCHpROTOSS,3069,515,26,22,48,54.2%,5m
5776,3,SHJ,3069,346,13,7,20,65.0%,3m
5776,2,알몸여탕러쉬,3069,314,13,10,23,56.5%,50m
5776,3,GagamelsRage,3069,243,10,4,14,71.4%,7m
5776,2,那就爭霸,3069,48,2,1,3,66.7%,25m
5776,2,[스타2마피아]카코,3069,0,1,0,1,100.0%,50m
5776,3,[33250]조국을위해,3069,0,0,1,1,0.0%,11m
5776,3,여름은아이스커피,3069,0,0,2,2,0.0%,6m
5786,2,uwuMarine,3068,467,50,49,99,50.5%,6m
5786,2,[비트]Fluid,3068,582,30,30,60,50.0%,3m
5786,3,노바,3068,656,28,16,44,63.6%,4m
5786,3,timmuT,3068,292,19,12,31,61.3%,7m
5786,3,blood,3068,270,15,13,28,53.6%,7m
5786,3,맥라이언,3068,168,5,2,7,71.4%,11m
5786,3,[꼴받네]어서오고,3068,167,5,2,7,71.4%,1m
5786,3,TheMarauder,3068,0,4,1,5,80.0%,3m
5786,3,joy,3068,137,3,3,6,50.0%,5m
5786,3,[비트]CooC,3068,30,2,0,2,100.0%,7m
5786,3,Bomdel,3068,0,0,1,1,0.0%,11m
5786,3,[날빌카운터]東亞病夫,3068,0,0,3,3,0.0%,5m
5798,2,digdig,3067,1549,423,424,847,49.9%,5m
5798,3,KimuchiBoy,3067,390,19,12,31,61.3%,1m
5798,3,NarA,3067,240,8,5,13,61.5%,7m
5798,3,Clash,3067,0,3,2,5,60.0%,1m
5798,3,lllllllllll,3067,0,0,1,1,0.0%,1m
5803,1,IIllIIlllIIl,3066,1203,69,84,153,45.1%,4m
5803,3,[삼삼업]삼삼업마린,3066,867,57,53,110,51.8%,3m
5803,3,ZoDiaC,3066,198,6,1,7,85.7%,3m
5803,3,[포세이큰]래더개못하는사람,3066,30,2,6,8,25.0%,11m
5803,3,[POTG]DyuRan,3066,0,1,1,2,50.0%,3m
5803,3,상욱,3066,91,1,6,7,14.3%,6m
5803,3,BeatGD,3066,0,0,5,5,0.0%,3m
5810,3,근육빵빵맨,3065,1126,106,95,201,52.7%,8m
5810,3,[항문브레이커]VanDarkholme,3065,346,15,11,26,57.7%,3m
5810,3,Coach,3065,264,11,6,17,64.7%,1m
5810,3,[HitMaN]Mighty,3065,158,5,1,6,83.3%,1m
5810,1,punisher,3065,97,1,1,2,50.0%,18m
5810,3,Marinesnow,3065,0,0,1,1,0.0%,3m
5816,3,[히드라119]시간속테란,3064,1385,166,150,316,52.5%,3m
5816,2,stranger,3064,508,22,20,42,52.4%,6m
5816,3,세례요한,3064,228,8,9,17,47.1%,4m
5816,3,오우짜스,3064,226,7,4,11,63.6%,7m
5816,3,Soleil,3064,0,3,2,5,60.0%,23m
5816,1,츄칠라,3064,46,1,8,9,11.1%,17m
5816,3,라파엘,3064,0,0,1,1,0.0%,6m
5823,2,大杯冰奶茶不好喝,3063,376,13,20,33,39.4%,5m
5823,3,모르코,3063,195,7,7,14,50.0%,3m
5825,3,[Rovic]Revolverlady,3062,194,8,0,8,100.0%,11m
5825,3,kddjj,3062,0,1,1,2,50.0%,7m
5825,3,Ophiuchus,3062,0,0,1,1,0.0%,3m
5825,3,[역시나]그랑죠,3062,0,0,1,1,0.0%,7m
5825,3,[형님나가신다]SaVior,3062,0,0,2,2,0.0%,5m
5830,3,MAX,3061,1503,288,258,546,52.7%,4m
5830,2,sksus,3061,608,20,27,47,42.6%,5m
5830,2,검은토끼,3061,159,6,3,9,66.7%,25m
5830,2,쾌걸조로리,3061,120,5,13,18,27.8%,6m
5830,3,더럽,3061,0,4,1,5,80.0%,24m
5830,3,jinuk,3061,0,1,0,1,100.0%,5m
5830,3,시공이왜싫어,3061,0,1,0,1,100.0%,2m
5837,3,못말리는흑우,3060,1276,114,96,210,54.3%,4m
5837,3,[돌변쩔좀]오빠거긴앙앙,3060,657,31,18,49,63.3%,1m
5837,3,boxer,3060,430,15,17,32,46.9%,7m
5837,3,[충북제천시]요정,3060,161,6,3,9,66.7%,7m
5837,3,뭐야이건,3060,193,5,5,10,50.0%,7m
5837,3,Famsy,3060,0,0,1,1,0.0%,5m
5837,3,realisshoman,3060,0,0,2,2,0.0%,7m
5844,3,콜티라,3059,928,43,31,74,58.1%,3m
5844,3,dada,3059,420,15,17,32,46.9%,11m
5844,3,우파킹,3059,60,3,2,5,60.0%,6m
5844,3,llllllllllll,3059,0,1,0,1,100.0%,5m
5844,2,[讓我看看]DKMarine,3059,0,0,1,1,0.0%,25m
5844,3,Jaeger,3059,0,0,2,2,0.0%,3m
5844,2,llllllllllll,3059,0,0,2,2,0.0%,50m
5844,3,[자유의닭발]Rue,3059,0,0,3,3,0.0%,4m
5844,3,[Aslan]JeonHyunjin,3059,0,0,4,4,0.0%,5m
5853,3,에디군,3058,1593,253,236,489,51.7%,5m
5853,2,탈흐콧흐,3058,1494,127,119,246,51.6%,2m
5853,1,Pandemonium,3058,772,29,32,61,47.5%,4m
5853,3,김이안,3058,513,22,13,35,62.9%,7m
5853,3,[forz]함정,3058,124,6,3,9,66.7%,3m
5853,3,야마가두개지요,3058,144,3,1,4,75.0%,51m
5859,3,mgjTerran,3057,409,25,21,46,54.3%,3m
5859,3,[쇼부충]갓카,3057,364,16,7,23,69.6%,8m
5859,3,다운힐왕자,3057,306,12,13,25,48.0%,3m
5859,3,저글링졸귀,3057,0,2,2,4,50.0%,3m
5859,3,[니코틴패스]벤젠,3057,115,2,2,4,50.0%,3m
5859,2,[NaLBIL]삼분테란,3057,0,0,1,1,0.0%,26m
5859,3,LMZ,3057,0,0,1,1,0.0%,4m
5859,3,빨치산홍어,3057,0,0,3,3,0.0%,3m
5867,1,[RDPS]eggmoney,3056,1559,155,150,305,50.8%,7m
5867,2,[패자는피를]블랜드,3056,1236,88,85,173,50.9%,8m
5867,2,니와까아메,3056,645,29,33,62,46.8%,3m
5867,3,[뿌야]틀니압수,3056,460,17,19,36,47.2%,3m
5867,3,[EZDUNK]Monkie,3056,397,15,12,27,55.6%,1m
5867,3,[너의ol름은]KOFFICER,3056,295,14,9,23,60.9%,11m
5867,3,llllllllllll,3056,346,13,7,20,65.0%,2m
5867,3,crazy,3056,226,9,8,17,52.9%,4m
5867,2,[김상우]柳東仁,3056,114,4,3,7,57.1%,11m
5867,3,Amur,3056,62,3,3,6,50.0%,3m
5867,2,교복목줄수갑,3056,36,1,5,6,16.7%,50m
5867,3,아이디개없네,3056,0,0,2,2,0.0%,23m
5879,2,zephyr,3055,1505,374,349,723,51.7%,1m
5879,3,IIIIllIIIllI,3055,1366,95,61,156,60.9%,8m
5879,3,[avec]National,3055,616,28,21,49,57.1%,8m
5879,3,간지를추구,3055,601,26,19,45,57.8%,7m
5879,3,이명재,3055,415,19,15,34,55.9%,2m
5879,3,sonnuri,3055,367,14,12,26,53.8%,3m
5879,2,Flash,3055,256,10,16,26,38.5%,5m
5879,3,철자구지,3055,60,6,3,9,66.7%,11m
5879,3,건설로봇,3055,0,5,0,5,100.0%,24m
5879,3,Bramme,3055,30,1,2,3,33.3%,4m
5879,3,[isnous]백합로리,3055,0,0,1,1,0.0%,4m
5890,1,흙형,3054,1294,58,63,121,47.9%,3m
5890,3,alex,3054,334,12,7,19,63.2%,1m
5890,3,빈지빈지,3054,247,9,8,17,52.9%,3m
5890,2,Jwoo,3054,117,5,2,7,71.4%,17m
5890,3,숭태,3054,94,2,0,2,100.0%,11m
5890,3,장동건,3054,30,2,2,4,50.0%,3m
5890,3,스워드,3054,30,2,4,6,33.3%,3m
5890,3,[CSTD]starexergi,3054,30,1,2,3,33.3%,6m
5890,3,일곡동안사장,3054,0,1,3,4,25.0%,11m
5899,2,llllllllllll,3053,931,73,69,142,51.4%,3m
5899,2,[ANGG]KMG,3053,1529,70,74,144,48.6%,5m
5899,1,Doosanapply,3053,802,33,36,69,47.8%,5m
5899,3,[海膽王]新手光榮,3053,583,30,27,57,52.6%,1m
5899,2,PostGrad,3053,404,15,19,34,44.1%,5m
5899,3,[3맨빌런]까탈레나,3053,322,14,4,18,77.8%,4m
5899,1,[cS]cSInfantasy,3053,138,11,13,24,45.8%,48m
5899,3,IIIIIIIIIIII,3053,177,5,5,10,50.0%,11m
5899,3,[날강두]타도멕건마,3053,0,1,0,1,100.0%,7m
5899,3,래구,3053,30,1,2,3,33.3%,4m
5909,1,hary,3052,1492,264,259,523,50.5%,3m
5909,3,DarkLight,3052,1447,180,168,348,51.7%,4m
5909,1,PLU,3052,1530,91,70,161,56.5%,11m
5909,3,Coestberg,3052,615,27,15,42,64.3%,1m
5909,3,MarineKing,3052,627,27,21,48,56.2%,1m
5909,2,한국도깨비,3052,255,20,21,41,48.8%,3m
5909,3,[짱깨는절대악]무쿵현따,3052,194,8,1,9,88.9%,5m
5909,3,[CrapP2]Aries,3052,228,6,6,12,50.0%,4m
5909,3,토끼와거북이,3052,30,1,3,4,25.0%,11m
5918,3,Edwin,3051,496,50,40,90,55.6%,7m
5918,3,Vanishment,3051,448,17,21,38,44.7%,3m
5918,3,Mogsung,3051,422,16,14,30,53.3%,7m
5918,3,유수,3051,335,11,10,21,52.4%,1m
5918,3,Comix,3051,128,4,1,5,80.0%,5m
5918,3,bear,3051,120,4,7,11,36.4%,6m
5918,1,IlIlIlllIIl,3051,96,2,2,4,50.0%,18m
5918,3,[海膽王]Slime,3051,14,2,4,6,33.3%,5m
5918,3,IIIIIIIIIIII,3051,0,1,0,1,100.0%,3m
5918,3,독서기록장,3051,89,1,1,2,50.0%,11m
5928,3,Endless,3050,681,27,19,46,58.7%,3m
5928,3,음식물쓰레기,3050,457,23,13,36,63.9%,6m
5928,3,Akia,3050,564,23,21,44,52.3%,1m
5928,1,Enzo,3050,189,8,6,14,57.1%,18m
5928,3,Livestar,3050,146,7,5,12,58.3%,8m
5928,3,그러는거아니야,3050,248,7,7,14,50.0%,3m
5928,3,lsh,3050,86,4,4,8,50.0%,4m
5928,3,KEYSTONE,3050,93,2,0,2,100.0%,5m
5928,3,Astaroth,3050,0,0,2,2,0.0%,7m
5937,3,DblueMcat,3049,1020,126,115,241,52.3%,3m
5937,2,[SNL]니얼굴이다,3049,1240,97,100,197,49.2%,5m
5937,3,[sc2mc]llllllllllll,3049,508,22,12,34,64.7%,8m
5937,3,마린,3049,141,9,0,9,100.0%,7m
5937,3,[SofT]트와이스다현,3049,188,7,1,8,87.5%,5m
5937,3,[GdAT]Legendk,3049,58,3,3,6,50.0%,5m
5937,3,명이,3049,30,2,2,4,50.0%,4m
5937,3,[N델타메이슨]백도야지,3049,30,2,3,5,40.0%,4m
5937,2,MissMKP,3049,64,2,12,14,14.3%,11m
5946,3,아이유,3048,1440,166,142,308,53.9%,4m
5946,3,동작구물주먹,3048,483,22,17,39,56.4%,8m
5946,3,한부장일꾼킬러,3048,399,16,14,30,53.3%,2m
5946,3,[시럽]강유,3048,204,6,4,10,60.0%,4m
5946,3,[병신들모임]도나도나,3048,93,1,1,2,50.0%,3m
5946,1,VeryVeryUU,3048,0,0,1,1,0.0%,18m
5952,3,TnT,3047,397,37,36,73,50.7%,5m
5952,2,llllllllllll,3047,644,28,28,56,50.0%,3m
5952,3,뽑국이,3047,610,23,20,43,53.5%,7m
5952,3,이차함수,3047,482,21,16,37,56.8%,3m
5952,3,Smart,3047,352,17,3,20,85.0%,4m
5952,3,[NLTN]이름은하나다,3047,287,15,14,29,51.7%,7m
5952,2,Brice,3047,113,4,1,5,80.0%,25m
5952,3,HappyMarine,3047,30,2,2,4,50.0%,5m
5952,3,nmvelli,3047,30,2,5,7,28.6%,3m
5961,3,[캬루]제임스레이너,3046,675,28,22,50,56.0%,2m
5961,1,우왕좌왕,3046,175,11,38,49,22.4%,3m
5961,3,hidehuman,3046,258,8,8,16,50.0%,1m
5961,3,버드전갈,3046,107,7,3,10,70.0%,7m
5961,3,깜디,3046,0,4,1,5,80.0%,7m
5961,3,monhmong,3046,125,3,1,4,75.0%,3m
5967,3,탱크,3045,1068,50,34,84,59.5%,1m
5967,3,Rainee,3045,962,37,32,69,53.6%,4m
5967,3,썬더케리건앰이,3045,502,20,15,35,57.1%,1m
5967,2,ExtrA,3045,440,19,20,39,48.7%,5m
5967,2,손나나,3045,250,8,22,30,26.7%,3m
5967,2,고냥이,3045,181,6,4,10,60.0%,26m
5967,1,KillerQuin,3045,188,5,3,8,62.5%,18m
5967,1,Rain,3045,108,4,15,19,21.1%,7m
5967,3,외계인,3045,133,3,2,5,60.0%,6m
5967,3,SNAKE,3045,0,2,3,5,40.0%,24m
5967,3,[러브라이브]미야와키사쿠라,3045,30,1,5,6,16.7%,5m
5967,3,ToGoWind,3045,0,0,2,2,0.0%,7m
5979,3,FApleKeybord,3044,260,9,11,20,45.0%,5m
5979,3,llllllllllll,3044,203,7,3,10,70.0%,7m
5979,3,geuntae,3044,0,4,2,6,66.7%,7m
5979,2,qianzanqi,3044,96,4,2,6,66.7%,17m
5979,3,TheGenius,3044,143,3,3,6,50.0%,4m
5979,3,LYNNJIWON,3044,91,2,0,2,100.0%,4m
5979,2,프로브,3044,0,0,1,1,0.0%,25m
5986,3,[TGTGTG]ybeei,3043,1497,149,146,295,50.5%,4m
5986,2,[NGameS]감귤설탕,3043,905,41,43,84,48.8%,6m
5986,3,아삭,3043,567,25,20,45,55.6%,5m
5986,3,SpifFires,3043,356,12,16,28,42.9%,7m
5986,3,Shinya,3043,150,7,4,11,63.6%,7m
5986,3,솔벗,3043,184,7,11,18,38.9%,1m
5986,3,흑형의웃음,3043,241,7,11,18,38.9%,11m
5986,2,날빌,3043,203,7,13,20,35.0%,2m
5986,3,히페리온준형테란,3043,188,6,3,9,66.7%,7m
5986,3,[수비수]LGIMVP,3043,150,6,7,13,46.2%,3m
5986,3,Glacage,3043,164,5,3,8,62.5%,8m
5986,3,MPJ,3043,0,3,2,5,60.0%,11m
5986,1,Hypoxia,3043,96,2,0,2,100.0%,18m
5986,2,Computer,3043,139,2,2,4,50.0%,25m
5986,3,폭력,3043,58,2,5,7,28.6%,7m
5986,3,wvwvwvwwwvvw,3043,0,1,0,1,100.0%,6m
6002,2,전썬,3042,1390,73,61,134,54.5%,4m
6002,3,[ELS]피아노치는공대생,3042,1264,55,50,105,52.4%,1m
6002,3,BeginneR,3042,1060,54,45,99,54.5%,3m
6002,2,녹아내리는사랑,3042,191,6,1,7,85.7%,25m
6002,3,크로덴,3042,166,6,3,9,66.7%,7m
6002,3,ChameesulO,3042,146,5,8,13,38.5%,6m
6002,3,manuday,3042,95,1,1,2,50.0%,4m
6009,3,KIANUREVUS,3041,582,25,16,41,61.0%,4m
6009,3,TheGOAT,3041,109,17,19,36,47.2%,7m
6009,3,황제,3041,186,6,4,10,60.0%,6m
6009,1,붐스붐붐,3041,97,4,3,7,57.1%,17m
6009,3,lililililili,3041,114,2,1,3,66.7%,7m
6009,3,WhiteCollar,3041,119,2,3,5,40.0%,7m
6009,3,테크테닉,3041,0,0,1,1,0.0%,3m
6009,2,망고맛땅콩,3041,0,0,1,1,0.0%,25m
6017,2,[더불어공산당]중국몽과함께,3040,1531,168,166,334,50.3%,6m
6017,3,天皇,3040,1117,53,44,97,54.6%,6m
6017,1,PPPP,3040,328,12,11,23,52.2%,49m
6017,2,독고,3040,95,4,2,6,66.7%,25m
6017,3,lIllIlIlIlIl,3040,30,3,4,7,42.9%,4m
6022,2,쿠쿠카카,3039,1513,230,229,459,50.1%,6m
6022,3,Anyccallends,3039,1504,171,160,331,51.7%,7m
6022,3,[나가자]달옹,3039,1575,94,86,180,52.2%,6m
6022,3,청춘의특권,3039,790,38,30,68,55.9%,6m
6022,3,SCV,3039,522,19,17,36,52.8%,6m
6022,3,털릴준비됐니,3039,184,7,8,15,46.7%,4m
6022,3,IntoTheRain,3039,138,5,3,8,62.5%,7m
6022,3,카스트,3039,0,3,2,5,60.0%,23m
6022,3,StarShell,3039,135,3,2,5,60.0%,4m
6022,1,조이만세,3039,0,0,1,1,0.0%,47m
6022,1,슈퍼탱크,3039,0,0,1,1,0.0%,49m
6022,1,흑인,3039,0,0,1,1,0.0%,47m
6034,2,Tester,3038,1396,212,218,430,49.3%,3m
6034,3,기영이,3038,475,27,21,48,56.2%,3m
6034,2,鯊魚辣椒,3038,232,11,17,28,39.3%,5m
6034,2,RapierAE,3038,155,5,4,9,55.6%,25m
6034,3,Silva,3038,30,2,1,3,66.7%,7m
6034,1,[Troupe]Notorius,3038,0,0,1,1,0.0%,49m
6040,1,gjxodud,3037,980,54,41,95,56.8%,49m
6040,3,tkawjdvjfv,3037,435,17,15,32,53.1%,1m
6040,2,[meobol]moriarty,3037,194,5,8,13,38.5%,4m
6040,3,해커스,3037,30,2,5,7,28.6%,7m
6040,3,[帥哥聯盟]認真大帥哥,3037,62,2,9,11,18.2%,7m
6040,1,송현우,3037,38,1,1,2,50.0%,49m
6040,1,[협동프리덤]EEsports,3037,0,0,1,1,0.0%,47m
6047,3,IIIIIIIIIIII,3036,401,17,11,28,60.7%,7m
6047,1,blinkSCV,3036,380,15,7,22,68.2%,47m
6047,3,[B猛象黃衫軍]魔方狂人,3036,294,10,8,18,55.6%,7m
6047,1,옵티머스,3036,48,5,5,10,50.0%,18m
6047,1,Mauritius,3036,82,2,2,4,50.0%,49m
6047,3,김한수,3036,58,2,3,5,40.0%,6m
6047,1,TigerusX,3036,0,0,1,1,0.0%,49m
6047,3,甘霖勞斯,3036,0,0,2,2,0.0%,6m
6047,3,Owl,3036,0,0,3,3,0.0%,5m
6056,1,AcStraker,3035,1478,526,522,1048,50.2%,7m
6056,2,yoo,3035,1173,103,96,199,51.8%,6m
6056,2,뽑아보니일꾼,3035,168,8,7,15,53.3%,8m
6056,3,말린망고,3035,214,7,5,12,58.3%,4m
6056,3,[cAnOp]과연김지훈,3035,182,7,10,17,41.2%,7m
6056,1,[패자는피를]깨알컨트롤,3035,114,2,3,5,40.0%,47m
6056,1,[러브라이브]ZzZ,3035,0,0,1,1,0.0%,49m
6063,3,Ruffn,3034,434,58,49,107,54.2%,6m
6063,3,집이짱이다,3034,628,24,19,43,55.8%,3m
6063,3,육오공,3034,118,4,6,10,40.0%,3m
6063,3,샤샤샤샷,3034,92,3,7,10,30.0%,7m
6067,1,ExeBlizz,3033,1520,183,193,376,48.7%,4m
6067,2,느금시,3033,152,8,7,15,53.3%,5m
6067,3,HunterKiller,3033,166,6,1,7,85.7%,6m
6067,3,IIIllIIlIIIl,3033,217,6,6,12,50.0%,1m
6071,3,[FNL]넌삽됬어임마,3032,1382,69,72,141,48.9%,7m
6071,3,香煎鮪魚烤土司,3032,364,25,19,44,56.8%,3m
6071,3,appleant,3032,423,20,14,34,58.8%,4m
6071,3,[저테가저테요]애옹이집사댜옹,3032,217,7,5,12,58.3%,2m
6071,3,짱개는패는개맛,3032,124,5,9,14,35.7%,4m
6071,3,AzrealBrian,3032,30,2,7,9,22.2%,7m
6071,1,[Equal]BYwooricoop,3032,40,1,2,3,33.3%,49m
6071,3,[WDY]이지탁,3032,30,1,5,6,16.7%,11m
6071,3,다시태어나고싶다,3032,30,1,5,6,16.7%,6m
6080,2,Gandalf,3031,1538,87,84,171,50.9%,6m
6080,2,lIIIlll,3031,564,25,24,49,51.0%,6m
6080,1,[NGameS]ToadKing,3031,0,1,0,1,100.0%,18m
6080,1,EterNaL,3031,0,0,1,1,0.0%,49m
6080,3,[보테가듀오]CaptainAM,3031,0,0,2,2,0.0%,4m
6085,3,흠이좋아,3030,1517,146,143,289,50.5%,7m
6085,3,BeauTiCian,3030,1367,88,75,163,54.0%,4m
6085,3,유령개,3030,422,15,17,32,46.9%,5m
6085,3,링링링,3030,148,5,8,13,38.5%,2m
6085,3,[韩湾土锤搬家]YueChuNexus,3030,88,4,6,10,40.0%,4m
6085,1,드릴께요,3030,121,3,2,5,60.0%,17m
6085,1,ByuN,3030,0,3,2,5,60.0%,47m
6085,1,FIGJAM,3030,0,1,0,1,100.0%,47m
6085,1,SuperRookie,3030,38,1,1,2,50.0%,47m
6085,1,상자,3030,0,0,1,1,0.0%,47m
6085,1,[경기도]빠따,3030,0,0,1,1,0.0%,47m
6096,2,Dolmatt,3029,993,105,86,191,55.0%,5m
6096,3,medimedi,3029,396,16,14,30,53.3%,7m
6096,3,GordonRamsay,3029,88,4,8,12,33.3%,5m
6099,1,브릉이,3028,1524,320,334,654,48.9%,7m
6099,3,[Cla1st]프로토스,3028,1519,117,63,180,65.0%,7m
6099,3,Rush,3028,1490,66,53,119,55.5%,3m
6099,3,멩스크,3028,926,34,37,71,47.9%,3m
6099,2,NikuUdon,3028,296,18,26,44,40.9%,3m
6099,1,초글링,3028,91,5,1,6,83.3%,47m
6099,1,Kakao,3028,165,5,1,6,83.3%,47m
6099,3,[Rovic]태양,3028,86,4,6,10,40.0%,3m
6099,3,GALAXY,3028,30,2,2,4,50.0%,7m
6099,1,스투코프,3028,0,0,1,1,0.0%,47m
6109,3,地知治世要,3027,1562,142,134,276,51.4%,5m
6109,3,SimpleJack,3027,1035,48,28,76,63.2%,2m
6109,2,JuulPhone,3027,141,5,4,9,55.6%,26m
6109,1,PeaceMaker,3027,0,3,2,5,60.0%,49m
6109,1,Guarneri,3027,122,3,3,6,50.0%,48m
6109,1,[TalenT]家可可,3027,0,1,0,1,100.0%,49m
6109,2,TTT,3027,46,1,2,3,33.3%,26m
6116,3,핸드폰액정수리,3026,266,10,12,22,45.5%,4m
6116,3,진구진구,3026,245,8,8,16,50.0%,7m
6116,1,ChoLay,3026,145,6,6,12,50.0%,26m
6116,1,으앙살려줭,3026,92,5,9,14,35.7%,18m
6116,3,WrekxNeffect,3026,0,3,2,5,60.0%,8m
6116,1,Blacktimes,3026,42,2,3,5,40.0%,47m
6116,3,전코로나예요,3026,0,0,2,2,0.0%,7m
6123,3,BBOMBBOM,3025,172,6,3,9,66.7%,7m
6123,2,렉걸려라얍얍,3025,118,4,7,11,36.4%,4m
6125,1,[ACGN]Atlas,3024,248,7,1,8,87.5%,49m
6125,3,은평얼짱,3024,97,5,1,6,83.3%,23m
6125,2,봐줘요형,3024,0,3,5,8,37.5%,11m
6125,1,[Hyper]aerglk,3024,78,2,2,4,50.0%,49m
6129,2,찌릿찌릿,3023,1340,155,143,298,52.0%,11m
6129,3,김윤식,3023,1294,50,48,98,51.0%,4m
6129,3,[얍삽하게]스팸,3023,279,10,3,13,76.9%,20m
6129,3,김치크루,3023,156,5,11,16,31.2%,11m
6129,3,IIIIIII,3023,0,1,2,3,33.3%,24m
6134,3,IIIIIIIIIIII,3022,452,18,17,35,51.4%,3m
6134,3,我是奇奇,3022,257,12,10,22,54.5%,4m
6134,3,Dynamicduo,3022,240,9,7,16,56.2%,7m
6134,2,[찹쌀모찌]브루소,3022,141,4,3,7,57.1%,25m
6138,3,괸카,3021,1223,47,41,88,53.4%,8m
6138,3,qkrehdgns,3021,829,47,42,89,52.8%,1m
6138,3,llllllllllll,3021,228,9,3,12,75.0%,4m
6138,1,EGJD,3021,32,4,2,6,66.7%,47m
6138,3,[SJDB]SweetTy,3021,0,1,4,5,20.0%,5m
6138,1,ChicMagNet,3021,0,0,1,1,0.0%,49m
6144,3,자룡공명,3020,353,31,40,71,43.7%,7m
6144,3,카이저소제,3020,204,7,10,17,41.2%,5m
6144,1,[ELSII]위성락,3020,148,4,2,6,66.7%,49m
6144,1,바이든,3020,40,2,0,2,100.0%,49m
6144,3,[승풍파랑]엄마나똥싸,3020,30,2,3,5,40.0%,4m
6144,1,[YOT]불곰,3020,0,0,1,1,0.0%,49m
6150,2,[옹선생님]방구왕,3019,1201,84,67,151,55.6%,3m
6150,3,[간식촌]진동로라,3019,347,15,13,28,53.6%,7m
6150,2,울트라리스크,3019,253,10,11,21,47.6%,6m
6150,3,hojun,3019,154,5,3,8,62.5%,4m
6150,3,lllllllllI,3019,147,5,9,14,35.7%,7m
6150,3,오징어덮밥,3019,126,4,10,14,28.6%,3m
6150,1,금만두,3019,128,3,2,5,60.0%,49m
6150,1,[DoBTeN]HoLuk,3019,74,2,3,5,40.0%,49m
6150,2,catlover,3019,44,2,6,8,25.0%,25m
6150,3,[Alpha]更派至尊,3019,0,0,2,2,0.0%,7m
6150,3,ddstesz,3019,0,0,3,3,0.0%,7m
6161,2,정영훈,3018,1573,544,526,1070,50.8%,6m
6161,3,[조고최]정갼천재,3018,848,33,34,67,49.3%,6m
6161,1,zzdldl,3018,172,5,0,5,100.0%,49m
6161,1,OOOOh,3018,0,0,1,1,0.0%,49m
6161,3,SEPERATE,3018,0,0,3,3,0.0%,7m
6166,3,Smmm,3017,674,39,34,73,53.4%,5m
6166,3,llllllllllll,3017,596,26,16,42,61.9%,8m
6166,3,[NGameS]슈나이더,3017,90,7,5,12,58.3%,6m
6166,2,[응더러워]BaKa,3017,0,4,3,7,57.1%,25m
6166,1,Sunrice,3017,0,0,1,1,0.0%,49m
6166,1,으잉,3017,0,0,1,1,0.0%,49m
6172,3,MUSAT,3016,1098,112,97,209,53.6%,7m
6172,2,BlackBox,3016,582,57,51,108,52.8%,3m
6172,2,nurimaro,3016,252,8,13,21,38.1%,1m
6172,3,sdfdfffd,3016,60,6,3,9,66.7%,3m
6172,3,冰烤番薯,3016,92,4,7,11,36.4%,3m
6172,3,[여자후쟝킬러]뒷구멍굴착기,3016,122,4,9,13,30.8%,7m
6178,1,Black,3015,452,15,9,24,62.5%,49m
6178,1,뀨릥뀨리잉,3015,466,14,10,24,58.3%,47m
6178,3,[nSis]Chaton,3015,381,14,11,25,56.0%,11m
6178,3,형레전드,3015,238,9,5,14,64.3%,4m
6178,1,[스카이파이터]멍츄,3015,276,8,8,16,50.0%,48m
6178,1,[HNMR]마린친구,3015,40,5,3,8,62.5%,47m
6178,3,사르트르,3015,60,2,4,6,33.3%,11m
6178,3,IIIIIIIIIIII,3015,60,2,4,6,33.3%,6m
6178,1,Rain,3015,0,2,4,6,33.3%,47m
6178,1,pppp,3015,0,0,1,1,0.0%,48m
6188,1,나만의롱보우,3014,1277,286,285,571,50.1%,7m
6188,1,꼬발이,3014,1729,181,164,345,52.5%,49m
6188,2,[ELSII]래툰,3014,1507,163,163,326,50.0%,1m
6188,1,사신토스,3014,703,23,38,61,37.7%,11m
6188,1,asd,3014,321,14,11,25,56.0%,49m
6188,3,FacT,3014,208,8,10,18,44.4%,11m
6188,3,[러브라이브]아일하르크,3014,62,2,8,10,20.0%,6m
6188,1,신사,3014,0,1,0,1,100.0%,49m
6188,3,쿠카이헌터,3014,30,1,3,4,25.0%,2m
6188,3,fds,3014,30,1,4,5,20.0%,7m
6198,2,[시럽]jungs,3013,1341,89,91,180,49.4%,4m
6198,3,Ego,3013,901,44,70,114,38.6%,7m
6198,3,appleeversj,3013,373,14,13,27,51.9%,11m
6198,2,량동초규박종,3013,264,14,15,29,48.3%,3m
6198,1,SoralARaison,3013,0,4,1,5,80.0%,49m
6198,1,[GTX]BattleUseR,3013,91,2,2,4,50.0%,49m
6204,3,동네개간년,3012,0,3,2,5,60.0%,24m
6204,3,바지벗고싸쓰킥,3012,0,3,4,7,42.9%,8m
6204,3,리카르도,3012,62,3,6,9,33.3%,7m
6207,1,효끼를때려잡자,3011,1476,57,70,127,44.9%,7m
6207,3,동어,3011,735,32,22,54,59.3%,11m
6207,3,[비트]LeeJay,3011,747,31,23,54,57.4%,3m
6207,3,조르바,3011,214,7,12,19,36.8%,4m
6207,2,EpicMayo,3011,0,3,4,7,42.9%,26m
6207,1,[귀요미햄스터]세느,3011,34,1,1,2,50.0%,47m
6207,1,IIIIIIIIIIII,3011,0,0,1,1,0.0%,48m
6214,3,Dragon,3010,1599,396,379,775,51.1%,7m
6214,1,rAyWinDz,3010,621,30,22,52,57.7%,49m
6214,3,IlIIIllIIIll,3010,558,25,17,42,59.5%,3m
6214,2,FOrNever,3010,226,10,1,11,90.9%,25m
6214,3,[Dorak]SlayerDoyee,3010,232,8,6,14,57.1%,4m
6214,1,leehu,3010,144,4,5,9,44.4%,49m
6214,1,[aha]aha,3010,156,4,6,10,40.0%,49m
6221,3,TXMNoKiKe,3009,897,45,30,75,60.0%,2m
6221,3,YGodPoNy,3009,391,20,17,37,54.1%,3m
6221,3,뱅이,3009,172,7,8,15,46.7%,7m
6221,1,scv,3009,140,4,3,7,57.1%,49m
6225,3,ASAP,3008,1575,108,109,217,49.8%,7m
6225,2,유헌수,3008,1544,106,94,200,53.0%,6m
6225,3,테스형,3008,559,74,64,138,53.6%,5m
6225,1,Maerad,3008,527,20,15,35,57.1%,49m
6225,1,FullNA,3008,36,3,4,7,42.9%,49m
6225,1,llllllllllll,3008,0,0,1,1,0.0%,47m
6225,1,짬택,3008,0,0,1,1,0.0%,49m
6225,1,llllllllllll,3008,0,0,1,1,0.0%,49m
6225,1,지는게이기는것,3008,0,0,1,1,0.0%,49m
6225,1,coca,3008,0,0,2,2,0.0%,49m
6235,2,Tecca,3007,1499,168,165,333,50.5%,5m
6235,1,달구비,3007,1039,72,54,126,57.1%,49m
6235,3,[DagmBa]아레스,3007,728,30,23,53,56.6%,7m
6235,3,보뿔소,3007,718,28,30,58,48.3%,8m
6235,3,JFCHOU,3007,661,24,26,50,48.0%,11m
6235,3,ZIPPO,3007,86,4,7,11,36.4%,3m
6235,1,Maestro,3007,96,1,3,4,25.0%,18m
6235,1,Donna,3007,0,0,1,1,0.0%,49m
6243,3,Timatree,3006,107,5,3,8,62.5%,11m
6243,2,炸裂陳子豪,3006,44,2,2,4,50.0%,25m
6245,3,[고급]메피스터,3005,428,20,22,42,47.6%,3m
6245,2,뚜우욱배기,3005,0,4,2,6,66.7%,17m
6245,1,갓훈,3005,0,3,0,3,100.0%,47m
6245,1,[最帥小烈]KYuMmT,3005,120,3,1,4,75.0%,49m
6245,1,[저그의유산]항상고민이더라,3005,0,1,0,1,100.0%,48m
6250,2,Larry,3004,759,41,48,89,46.1%,3m
6250,3,[더지니어스]NaCl,3004,457,18,16,34,52.9%,3m
6250,3,[ELS]illusion,3004,307,10,12,22,45.5%,1m
6250,3,jimmy,3004,100,7,5,12,58.3%,3m
6250,1,IIIIIIIIIIII,3004,176,7,23,30,23.3%,49m
6250,1,하이라드,3004,0,0,1,1,0.0%,49m
6256,3,victorymine,3003,1433,57,48,105,54.3%,6m
6256,3,하이에나,3003,1234,54,49,103,52.4%,3m
6256,2,rhoxnd,3003,729,42,46,88,47.7%,3m
6256,2,혀고수,3003,504,18,28,46,39.1%,8m
6256,3,MingKynism,3003,432,15,16,31,48.4%,6m
6256,1,Jackiefer,3003,90,5,1,6,83.3%,47m
6256,3,이런미친,3003,124,4,7,11,36.4%,11m
6256,3,내가찌앙,3003,30,2,4,6,33.3%,7m
6256,1,NightMare,3003,0,1,0,1,100.0%,49m
6265,2,SiMpLeStyLe,3002,653,23,32,55,41.8%,3m
6265,1,[DBLN]Sereu,3002,279,11,9,20,55.0%,48m
6265,1,[KRG]심심한모기,3002,0,1,0,1,100.0%,49m
6265,1,LaGoYo,3002,0,1,1,2,50.0%,48m
6265,2,마니,3002,0,0,1,1,0.0%,26m
6265,3,[유튜버]시작,3002,0,0,2,2,0.0%,7m
6265,3,선비,3002,0,0,3,3,0.0%,5m
6272,3,lemon,3001,206,8,9,17,47.1%,7m
6272,3,인사사령부,3001,127,5,4,9,55.6%,3m
6272,1,구성주의,3001,0,3,2,5,60.0%,49m
6272,3,김쿵짝,3001,58,2,8,10,20.0%,4m
6272,1,[On엔oN]실망한황제,3001,0,0,2,2,0.0%,49m
6277,3,Santiago,3000,459,37,38,75,49.3%,3m
6277,3,풍풍전사,3000,683,30,25,55,54.5%,7m
6277,2,곰팡윤곤,3000,258,8,10,18,44.4%,50m
6277,3,[국가정보원]BrzFourYrAgo,3000,30,4,5,9,44.4%,2m
6277,3,[신개미협회]Protoss,3000,0,3,2,5,60.0%,24m
6277,3,아크튜러스멩스크,3000,0,2,1,3,66.7%,24m
6277,1,Commander,3000,0,0,2,2,0.0%,47m
6284,3,gotomato,2999,1064,83,69,152,54.6%,4m
6284,3,오상헌,2999,647,36,39,75,48.0%,7m
6284,3,Meh,2999,218,9,13,22,40.9%,7m
6284,2,잡초,2999,0,4,3,7,57.1%,25m
6284,1,jjs,2999,0,1,0,1,100.0%,49m
6284,3,jox,2999,0,1,1,2,50.0%,52m
6284,1,IamKing,2999,40,1,2,3,33.3%,49m
6284,3,[Weast]인공지능,2999,0,1,3,4,25.0%,2m
6284,1,Naruto,2999,0,0,1,1,0.0%,47m
6293,3,Winnie,2998,1465,103,94,197,52.3%,3m
6293,3,筷子手攝豹擬,2998,501,24,20,44,54.5%,6m
6293,3,Faker,2998,0,4,1,5,80.0%,24m
6293,2,OpenSF,2998,95,4,3,7,57.1%,25m
6297,3,KangChih,2997,1067,134,109,243,55.1%,6m
6297,2,문죄인사랑해,2997,1388,56,58,114,49.1%,4m
6297,1,GoldenFleet,2997,476,20,13,33,60.6%,49m
6297,3,komanic,2997,374,17,10,27,63.0%,11m
6297,1,원꼬추,2997,104,6,1,7,85.7%,48m
6297,1,Neoteny,2997,122,4,3,7,57.1%,49m
6297,3,으뢋차차,2997,62,4,6,10,40.0%,6m
6297,1,월진,2997,0,1,0,1,100.0%,48m
6305,3,중력,2996,1557,250,226,476,52.5%,7m
6305,1,Maru,2996,739,29,19,48,60.4%,47m
6305,3,[돌연변이전문]팥빵위에부비트렙,2996,528,22,17,39,56.4%,11m
6305,3,[트롤처리반장]중재중재,2996,448,18,19,37,48.6%,3m
6305,3,ORIS,2996,121,6,6,12,50.0%,19m
6305,1,hyoda,2996,114,5,3,8,62.5%,47m
6305,3,Kim,2996,146,5,9,14,35.7%,3m
6305,1,manggame,2996,0,1,0,1,100.0%,49m
6305,1,물냉면,2996,0,1,2,3,33.3%,49m
6305,3,[Bliss]BARCODE,2996,0,0,5,5,0.0%,7m
6315,3,[마주치면죽어]히포,2995,534,24,23,47,51.1%,6m
6315,1,스타스타열,2995,72,3,1,4,75.0%,49m
6315,1,황병장,2995,0,3,2,5,60.0%,47m
6315,1,킁호킁호,2995,0,0,1,1,0.0%,49m
6315,3,llllllllllll,2995,0,0,1,1,0.0%,24m
6320,3,오늘만얼짱,2994,286,28,29,57,49.1%,7m
6320,3,침대위여우,2994,707,24,25,49,49.0%,7m
6320,3,[CPlay]NCube,2994,122,4,12,16,25.0%,4m
6320,3,[ProTT]대군주,2994,73,2,2,4,50.0%,3m
6320,1,GGoom,2994,0,0,2,2,0.0%,49m
6325,3,AnimePsycho,2993,182,7,10,17,41.2%,7m
6325,1,MiRaGe,2993,42,4,3,7,57.1%,49m
6327,3,초씨,2992,1510,192,191,383,50.1%,3m
6327,3,zxfc,2992,226,9,10,19,47.4%,4m
6327,1,[눈물의곡절]하하,2992,80,3,2,5,60.0%,49m
6327,1,르브론제임스,2992,0,1,1,2,50.0%,47m
6331,3,Dracla,2991,1570,219,205,424,51.7%,7m
6331,3,Andreas,2991,971,51,43,94,54.3%,7m
6331,3,我首洺碩比,2991,663,30,36,66,45.5%,7m
6331,3,Kyo,2991,307,13,12,25,52.0%,7m
6331,1,yty,2991,232,7,5,12,58.3%,49m
6336,1,Isaac,2990,1261,287,296,583,49.2%,5m
6336,3,헐랭방구,2990,696,78,72,150,52.0%,4m
6336,3,리케,2990,902,41,36,77,53.2%,6m
6336,3,[너의ol름은]JuStaMAziNg,2990,536,28,25,53,52.8%,7m
6336,3,스페이드,2990,474,19,20,39,48.7%,8m
6336,3,[CStorM]내사랑시후,2990,434,15,16,31,48.4%,6m
6336,3,[건국]해병대,2990,334,11,11,22,50.0%,7m
6336,3,[CStorM]전지전능,2990,155,5,4,9,55.6%,4m
6336,1,배틀신,2990,40,2,1,3,66.7%,49m
6336,1,[응디]금강,2990,0,1,0,1,100.0%,49m
6336,3,[5torM]성자초,2990,0,0,1,1,0.0%,51m
6336,1,SlayersBoxeR,2990,0,0,1,1,0.0%,49m
6336,1,레비아탄,2990,0,0,3,3,0.0%,49m
6349,2,별꽃나무,2989,1525,466,446,912,51.1%,6m
6349,1,행복,2989,1227,47,37,84,56.0%,48m
6349,1,OIOIOIO,2989,415,16,8,24,66.7%,48m
6349,1,현란무답제,2989,410,13,9,22,59.1%,49m
6349,3,마린맨,2989,91,4,3,7,57.1%,5m
6349,1,creamc,2989,84,3,1,4,75.0%,50m
6349,1,파쿠르,2989,106,3,2,5,60.0%,49m
6349,1,테스형,2989,120,3,6,9,33.3%,49m
6357,3,[인격파탄]SSickboy,2988,347,16,12,28,57.1%,6m
6357,3,행주,2988,384,15,16,31,48.4%,7m
6357,3,[이거야]상환이마스터간다,2988,281,13,11,24,54.2%,6m
6357,3,Depression,2988,134,4,3,7,57.1%,5m
6357,3,Overload,2988,120,4,8,12,33.3%,3m
6357,1,[보스모드]모나크,2988,30,2,0,2,100.0%,49m
6357,1,블랑몽,2988,145,2,7,9,22.2%,17m
6357,3,AUG,2988,0,0,3,3,0.0%,51m
6365,2,사에삐,2987,1158,154,148,302,51.0%,6m
6365,3,국산비둘기,2987,572,25,18,43,58.1%,3m
6365,1,KillerAnn,2987,591,20,16,36,55.6%,49m
6365,1,한국어를못해요,2987,134,5,1,6,83.3%,49m
6365,3,siro,2987,30,4,4,8,50.0%,3m
6365,2,[하더놈]Raper,2987,0,3,4,7,42.9%,11m
6365,3,yooo,2987,0,0,4,4,0.0%,6m
6372,3,후전드,2986,1589,107,119,226,47.3%,7m
6372,3,BrianWang,2986,63,5,8,13,38.5%,3m
6372,1,창선,2986,82,3,3,6,50.0%,48m
6372,1,WIN,2986,0,1,0,1,100.0%,49m
6372,1,YoRHa,2986,42,1,2,3,33.3%,49m
6377,3,llllllllllll,2985,1515,94,80,174,54.0%,6m
6377,1,[시나공]윤후바라기,2985,1405,79,71,150,52.7%,49m
6377,3,강하둥이,2985,1335,56,61,117,47.9%,8m
6377,3,[한타왕]매력적인쐐골,2985,835,53,50,103,51.5%,11m
6377,3,박보영,2985,93,4,3,7,57.1%,11m
6377,3,[諧星屋]我只是個諧星,2985,0,1,0,1,100.0%,52m
6377,1,[VSL]네다음테란,2985,0,0,2,2,0.0%,47m
6377,1,[한타왕]이달의소녀츄,2985,0,0,3,3,0.0%,49m
6385,3,김교수,2984,938,55,52,107,51.4%,5m
6385,3,Mars,2984,1337,54,49,103,52.4%,3m
6385,1,무한불가능,2984,1174,45,34,79,57.0%,47m
6385,1,바다거북,2984,101,5,0,5,100.0%,49m
6385,3,세이라스,2984,154,5,11,16,31.2%,2m
6390,3,[품바]IronMaiden,2983,606,26,25,51,51.0%,7m
6390,1,[베이비]빌즈,2983,278,8,3,11,72.7%,19m
6390,1,Monkey,2983,88,4,2,6,66.7%,47m
6390,1,으엑엑,2983,0,1,1,2,50.0%,50m
6394,3,[OId]StarFun,2982,1148,60,47,107,56.1%,2m
6394,1,호푸눙,2982,1002,38,33,71,53.5%,47m
6394,3,판다장군,2982,758,33,25,58,56.9%,3m
6394,3,ZodiacL,2982,0,2,2,4,50.0%,24m
6394,1,[SPTS]Leanne,2982,0,1,0,1,100.0%,49m
6399,3,고기맛소고기,2981,616,33,30,63,52.4%,7m
6399,3,Landmaaler,2981,374,13,15,28,46.4%,4m
6399,3,helljumper,2981,156,4,5,9,44.4%,6m
6399,3,[YBMS]에너자이저,2981,0,3,2,5,60.0%,24m
6399,1,[MBK]몬스터,2981,0,0,1,1,0.0%,49m
6404,3,歇浩相備,2980,1352,51,53,104,49.0%,3m
6404,3,STARBUCKS,2980,614,25,22,47,53.2%,7m
6404,2,원석이에용,2980,307,14,12,26,53.8%,11m
6404,2,나는지금살아있다,2980,190,6,5,11,54.5%,25m
6404,2,동기,2980,114,4,4,8,50.0%,25m
6409,2,드뷔시,2979,1498,848,810,1658,51.1%,6m
6409,2,Tzuyu,2979,814,32,30,62,51.6%,5m
6409,1,[HcW]wjdwodus,2979,418,13,11,24,54.2%,49m
6409,1,[지네여]플토저그,2979,324,10,6,16,62.5%,49m
6409,3,Zero,2979,309,10,11,21,47.6%,5m
6409,3,HyeonSu,2979,159,7,5,12,58.3%,2m
6409,3,뭣이라고라골아곪,2979,0,3,2,5,60.0%,39m
6416,1,HSS,2978,1458,268,278,546,49.1%,7m
6416,1,dsadfab,2978,1355,61,36,97,62.9%,48m
6416,2,oiPAYBACKio,2978,504,23,17,40,57.5%,11m
6416,3,BuTTon,2978,343,15,9,24,62.5%,3m
6416,1,[좀비항문]Ejsner,2978,143,6,4,10,60.0%,47m
6416,1,갸마누,2978,184,5,2,7,71.4%,49m
6416,1,[얼굴]스투개판이네,2978,0,4,1,5,80.0%,48m
6416,1,真男人睡沙發,2978,116,3,3,6,50.0%,49m
6416,1,[같이게임해요]나존나훈녀임,2978,0,0,1,1,0.0%,49m
6425,1,끄앙입니다유유,2977,862,55,75,130,42.3%,5m
6425,1,포도청년,2977,279,18,8,26,69.2%,48m
6425,1,강원도지킴이,2977,185,8,4,12,66.7%,47m
6425,3,전광식,2977,214,8,11,19,42.1%,5m
6425,3,Emirates,2977,186,7,15,22,31.8%,7m
6425,1,黃金鮮奶茶,2977,188,6,5,11,54.5%,49m
6425,3,AutoSys,2977,0,3,2,5,60.0%,23m
6425,1,llllllllllll,2977,0,0,1,1,0.0%,49m
6433,3,미노타우스크루저,2976,344,12,11,23,52.2%,1m
6433,1,도수진,2976,117,5,3,8,62.5%,47m
6433,3,Aqme,2976,44,4,3,7,57.1%,24m
6433,1,리모디,2976,68,2,2,4,50.0%,49m
6433,1,인면어,2976,0,1,0,1,100.0%,50m
6433,2,COMEboyyes,2976,0,1,4,5,20.0%,3m
6433,1,llllllllllll,2976,0,0,1,1,0.0%,49m
6433,1,오홍근병신,2976,0,0,1,1,0.0%,49m
6441,3,uuu,2975,1531,384,367,751,51.1%,4m
6441,1,[테테안함]와사비맛사탕,2975,328,15,8,23,65.2%,49m
6441,1,뚤리랄,2975,145,7,3,10,70.0%,50m
6441,3,iLLuSioN,2975,92,3,9,12,25.0%,1m
6441,1,peperina,2975,40,2,2,4,50.0%,49m
6441,1,팔라우,2975,0,1,2,3,33.3%,49m
6447,3,[dfg133]슈강,2974,1013,118,98,216,54.6%,6m
6447,1,nighter,2974,798,32,27,59,54.2%,47m
6447,1,Paradise,2974,397,15,12,27,55.6%,47m
6447,3,[禿頭肥寶]DreamYiN,2974,238,9,13,22,40.9%,3m
6447,1,xxxxxxxxxxxx,2974,137,8,2,10,80.0%,48m
6447,1,Justin,2974,0,3,2,5,60.0%,48m
6447,2,諾娃,2974,0,1,0,1,100.0%,26m
6447,1,AmeriChobo,2974,38,1,2,3,33.3%,49m
6455,1,Don,2973,1508,78,73,151,51.7%,49m
6455,1,[uNOOBs]DPH,2973,423,18,9,27,66.7%,49m
6455,3,빛나는승리자,2973,394,13,21,34,38.2%,5m
6455,3,한라봉,2973,166,7,6,13,53.8%,2m
6455,1,llllllllllll,2973,106,4,1,5,80.0%,49m
6455,1,jin,2973,40,1,3,4,25.0%,49m
6461,1,NightSky,2972,391,19,12,31,61.3%,49m
6461,2,uRHackers,2972,0,4,3,7,57.1%,26m
6461,3,[cowboy]ava,2972,124,4,7,11,36.4%,7m
6461,1,[TNO]likefish,2972,88,2,1,3,66.7%,47m
6461,1,Kirion,2972,78,2,3,5,40.0%,49m
6461,1,낯선자,2972,38,1,2,3,33.3%,49m
6461,1,[긴급스섹대]올인안하는사람,2972,0,0,1,1,0.0%,49m
6468,2,SACTS,2971,1455,254,253,507,50.1%,3m
6468,2,한자임요,2971,1265,101,104,205,49.3%,2m
6468,1,Phizzler,2971,48,2,5,7,28.6%,18m
6468,1,리경훈,2971,0,1,0,1,100.0%,49m
6472,1,[세미온TD]Heromagician,2970,184,5,5,10,50.0%,49m
6472,1,[건마]멕건마,2970,118,4,4,8,50.0%,49m
6472,3,[너의ol름은]히틀러,2970,0,3,2,5,60.0%,24m
6472,1,llllllllllll,2970,0,3,2,5,60.0%,49m
6472,3,[스커즈]띠띠빵빵,2970,0,3,3,6,50.0%,25m
6472,1,자유,2970,0,0,1,1,0.0%,47m
6478,1,Lissandra,2969,1537,82,78,160,51.2%,49m
6478,1,[蒼龍逆天狂]櫻小路才華,2969,615,28,12,40,70.0%,47m
6478,3,[AYSM]봉식이,2969,542,18,30,48,37.5%,2m
6478,1,DraGneeL,2969,187,9,7,16,56.2%,49m
6478,3,Bett,2969,0,3,2,5,60.0%,24m
6478,1,[네잎클로버]Maladroit,2969,0,1,4,5,20.0%,48m
6484,1,이게뭐라고,2968,1390,51,49,100,51.0%,49m
6484,3,사려깊은,2968,528,45,37,82,54.9%,7m
6484,1,兔仔耳朵蒙面俠,2968,920,31,29,60,51.7%,49m
6484,2,파파무,2968,166,6,3,9,66.7%,17m
6484,1,NdHWyM,2968,96,3,2,5,60.0%,49m
6484,2,HelloAgain,2968,0,0,1,1,0.0%,26m
6484,1,[시럽]looka,2968,0,0,1,1,0.0%,49m
6484,2,Merona,2968,0,0,2,2,0.0%,26m
6492,3,lIIIIIlllllI,2967,412,16,19,35,45.7%,1m
6492,3,ACTARUS,2967,196,5,9,14,35.7%,5m
6492,2,lllllllllll,2967,0,4,3,7,57.1%,3m
6495,1,AliBaba,2966,148,5,5,10,50.0%,47m
6495,1,제로아워,2966,0,4,2,6,66.7%,49m
6495,1,테캉,2966,114,4,4,8,50.0%,49m
6495,1,바코드,2966,0,3,2,5,60.0%,48m
6495,1,llllllllllll,2966,105,2,2,4,50.0%,49m
6495,3,Smoke,2966,36,2,9,11,18.2%,11m
6495,1,NTS,2966,0,0,1,1,0.0%,49m
6495,1,건데기,2966,0,0,2,2,0.0%,49m
6503,3,[李組長]PhilipWen,2965,1518,388,378,766,50.7%,3m
6503,3,여친구함,2965,1018,277,262,539,51.4%,8m
6503,1,llllllllllll,2965,192,8,7,15,53.3%,18m
6503,1,주사위,2965,157,5,1,6,83.3%,49m
6503,1,Sekirei,2965,145,5,5,10,50.0%,27m
6503,1,비니,2965,107,4,3,7,57.1%,47m
6503,3,avengerses,2965,165,4,5,9,44.4%,6m
6510,1,IIIIIIIIIIII,2964,1704,419,405,824,50.8%,48m
6510,1,Desktop,2964,1664,132,111,243,54.3%,49m
6510,1,llllllll,2964,582,19,20,39,48.7%,48m
6510,1,DarkShadow,2964,312,11,11,22,50.0%,50m
6510,2,[울밍이]redsunss,2964,141,5,4,9,55.6%,26m
6515,3,Yungmoney,2963,1094,192,181,373,51.5%,5m
6515,1,[패튼전차]我是韩国人,2963,135,5,4,9,55.6%,49m
6515,3,ParryGuaGua,2963,0,1,5,6,16.7%,4m
6518,1,lllIIIlllIII,2962,269,9,4,13,69.2%,47m
6518,2,llllllllll,2962,86,4,5,9,44.4%,2m
6518,1,LINUX,2962,78,3,2,5,60.0%,49m
6518,3,이도형,2962,0,3,2,5,60.0%,23m
6518,1,sora,2962,40,2,0,2,100.0%,47m
6518,1,WoongGayKing,2962,0,2,3,5,40.0%,48m
6518,1,[tossed]OILBOOM,2962,0,1,1,2,50.0%,49m
6525,3,글그림,2961,1233,126,111,237,53.2%,4m
6525,1,combative,2961,1600,94,64,158,59.5%,48m
6525,3,[유토피아]llllllllllll,2961,694,24,31,55,43.6%,1m
6525,1,[스타리나잇]KBeSing,2961,114,4,4,8,50.0%,48m
6525,3,llllllllllll,2961,60,3,7,10,30.0%,1m
6530,3,IIIIII,2960,0,4,1,5,80.0%,24m
6530,1,[AMA]Asuna,2960,104,4,1,5,80.0%,49m
6530,1,jacobboy,2960,0,1,0,1,100.0%,47m
6530,1,쩌글링네마리,2960,0,1,1,2,50.0%,49m
6534,3,Tree,2959,1474,218,213,431,50.6%,5m
6534,1,리페어,2959,539,25,15,40,62.5%,49m
6534,1,Chogath,2959,433,16,18,34,47.1%,49m
6534,1,oGGMuX,2959,256,7,3,10,70.0%,18m
6534,1,[전국지집협회]IRIS,2959,0,4,1,5,80.0%,48m
6534,1,akikiki,2959,114,3,5,8,37.5%,48m
6534,3,트롤,2959,91,2,1,3,66.7%,3m
6534,3,달용이,2959,0,1,0,1,100.0%,23m
6534,3,[홍콩행제리바]카인의후예,2959,0,0,1,1,0.0%,23m
6543,3,굼뱅이,2958,1581,715,681,1396,51.2%,2m
6543,3,[우한폐렴]HeeGon,2958,628,206,215,421,48.9%,5m
6543,3,[더지니어스]Boss,2958,485,19,19,38,50.0%,7m
6543,3,[YTC]임금돼지,2958,298,14,10,24,58.3%,7m
6543,1,[d타짜b]고광렬,2958,272,9,8,17,52.9%,49m
6543,1,박태화,2958,165,7,6,13,53.8%,18m
6543,1,[스타놀이터]Freude,2958,112,3,4,7,42.9%,49m
6550,2,BloodMarin,2957,1285,105,107,212,49.5%,5m
6550,1,[Amsa]BLEEDKAGA,2957,422,14,11,25,56.0%,47m
6550,3,Jammie,2957,30,2,0,2,100.0%,20m
6550,3,MNP,2957,0,2,1,3,66.7%,24m
6550,1,sayuri,2957,0,1,0,1,100.0%,49m
6550,1,평양,2957,0,0,2,2,0.0%,18m
6556,3,[CStorM]한국자동화,2956,1529,114,113,227,50.2%,2m
6556,2,星空,2956,1095,61,67,128,47.7%,6m
6556,2,말래,2956,411,26,34,60,43.3%,3m
6556,3,overcome,2956,507,22,19,41,53.7%,2m
6556,1,llllllllllll,2956,0,0,1,1,0.0%,49m
6561,1,자축인묘진사오미,2955,1658,79,77,156,50.6%,50m
6561,1,정자왕프라임,2955,458,15,13,28,53.6%,49m
6561,2,[Rush]MeTeor,2955,296,9,6,15,60.0%,26m
6561,1,MusPelHeiM,2955,0,3,2,5,60.0%,47m
6561,2,무심한듯시크하게,2955,118,3,2,5,60.0%,26m
6561,3,[Hyper]유령성애자,2955,0,3,4,7,42.9%,4m
6561,1,minhnghia,2955,36,2,1,3,66.7%,47m
6561,1,[shiro]MIKUDANCE,2955,0,0,1,1,0.0%,47m
6561,1,[OGSMG]제민이마법의왼손,2955,0,0,2,2,0.0%,47m
6570,3,Ryan,2954,1509,110,100,210,52.4%,7m
6570,2,네스퀵,2954,1440,71,66,137,51.8%,2m
6570,1,llllllllllll,2954,123,5,4,9,55.6%,49m
6570,3,사물렌즈,2954,0,3,5,8,37.5%,7m
6570,1,주황버섯,2954,0,1,1,2,50.0%,47m
6575,2,뱅클,2953,501,21,21,42,50.0%,4m
6575,2,[ElsAna]야생뼈다귀,2953,120,5,4,9,55.6%,17m
6577,3,엘리매니아임돠,2952,642,30,26,56,53.6%,7m
6577,1,marin,2952,97,2,1,3,66.7%,18m
6577,1,김굠만입니다,2952,0,0,1,1,0.0%,47m
6577,1,[H2per]SKTLmnO,2952,0,0,5,5,0.0%,49m
6581,1,TRK,2951,164,5,5,10,50.0%,50m
6581,1,llllllll,2951,108,3,5,8,37.5%,49m
6581,1,[브리티안]Noka,2951,121,2,1,3,66.7%,49m
6581,2,크리에이티브,2951,116,2,2,4,50.0%,26m
6581,1,llllllllllll,2951,30,1,1,2,50.0%,49m
6581,1,Vela,2951,36,1,2,3,33.3%,49m
6581,1,shotsgusnw,2951,0,0,2,2,0.0%,47m
6581,1,[04s]END,2951,0,0,3,3,0.0%,49m
6589,1,전봇대사살,2950,96,5,3,8,62.5%,48m
6590,1,shirts,2949,166,7,7,14,50.0%,19m
6590,1,llllllllllll,2949,120,3,4,7,42.9%,49m
6590,1,DRSTRANGE,2949,40,1,1,2,50.0%,49m
6590,1,IIIIIIIIIIII,2949,40,1,2,3,33.3%,48m
6594,1,호모사피엔스,2948,1375,59,49,108,54.6%,48m
6594,1,심해마이충,2948,368,33,22,55,60.0%,48m
6594,3,EMP,2948,242,8,14,22,36.4%,5m
6594,3,Ruscello,2948,176,6,11,17,35.3%,5m
6594,1,freewizard,2948,145,5,6,11,45.5%,19m
6599,3,[DagmBa]StarTale,2947,754,30,36,66,45.5%,1m
6599,1,고등어,2947,189,9,4,13,69.2%,50m
6599,1,TTVragnaeg,2947,0,1,0,1,100.0%,49m
6599,1,Ohto,2947,0,0,2,2,0.0%,49m
6603,1,llllllllllll,2946,722,30,17,47,63.8%,47m
6603,3,minkirago,2946,514,18,23,41,43.9%,4m
6603,1,[NoME]꼬마방장,2946,353,17,7,24,70.8%,47m
6603,1,PoohaBest,2946,318,8,7,15,53.3%,47m
6603,1,GoodTHink,2946,147,6,5,11,54.5%,47m
6603,1,[자세잡고쏴]두다다다다다,2946,142,5,2,7,71.4%,47m
6603,3,[SCmTS]Shiny,2946,92,5,7,12,41.7%,3m
6603,1,kimchipower,2946,70,3,1,4,75.0%,49m
6603,1,끄시끄시,2946,0,3,3,6,50.0%,47m
6603,1,행갱,2946,0,1,1,2,50.0%,47m
6603,2,[HAKSAL]진화된인간입니다,2946,0,0,2,2,0.0%,26m
6614,1,[Worm]TPZ,2945,901,43,34,77,55.8%,48m
6614,2,RMPC,2945,0,4,3,7,57.1%,25m
6614,1,likam,2945,151,4,3,7,57.1%,48m
6614,3,에렌디라,2945,0,3,1,4,75.0%,24m
6614,3,ThisReal,2945,0,3,1,4,75.0%,24m
6614,1,llllllllllll,2945,0,0,1,1,0.0%,49m
6620,1,Luke,2944,1531,303,278,581,52.2%,48m
6620,3,Mist,2944,1526,116,98,214,54.2%,7m
6620,1,kaniji,2944,1554,76,67,143,53.1%,47m
6620,3,[3121]akama,2944,837,60,55,115,52.2%,3m
6620,3,silent,2944,828,36,33,69,52.2%,11m
6620,1,殺神風,2944,467,17,11,28,60.7%,49m
6620,1,꿀꿀단,2944,234,11,8,19,57.9%,48m
6620,3,[Att]ducky,2944,172,5,10,15,33.3%,11m
6620,3,dIRT,2944,109,3,1,4,75.0%,3m
6620,1,뫼띠우스의비,2944,110,3,5,8,37.5%,50m
6620,1,워크,2944,112,3,8,11,27.3%,49m
6620,1,김경건씨,2944,91,2,0,2,100.0%,47m
6632,1,han,2943,265,10,8,18,55.6%,18m
6632,1,[SEAL]앙기모띠,2943,0,4,1,5,80.0%,47m
6632,1,bangsilez,2943,136,3,3,6,50.0%,48m
6632,3,에트랑제,2943,0,0,1,1,0.0%,52m
6636,1,Dolmatt,2942,192,7,7,14,50.0%,48m
6636,1,SAYPLAYER,2942,0,3,2,5,60.0%,48m
6636,1,DOMINATOR,2942,38,2,1,3,66.7%,49m
6636,1,계절,2942,0,1,0,1,100.0%,19m
6640,1,BravemaN,2941,1674,107,94,201,53.2%,47m
6640,1,Himalayan,2941,1163,45,36,81,55.6%,49m
6640,1,슬픈자유인,2941,998,43,29,72,59.7%,47m
6640,1,[PP1]柯文哲總統,2941,708,39,33,72,54.2%,49m
6640,3,Silenthey,2941,376,14,7,21,66.7%,52m
6640,1,심신,2941,146,5,4,9,55.6%,49m
6640,1,[더지니어스]김폰벨,2941,0,1,0,1,100.0%,49m
6647,3,MINE,2940,358,12,19,31,38.7%,6m
6647,1,mori,2940,170,8,8,16,50.0%,18m
6647,3,[MARVEL]ARCADE,2940,109,5,4,9,55.6%,4m
6647,1,sinbido,2940,48,2,7,9,22.2%,18m
6647,3,몬드,2940,0,1,0,1,100.0%,24m
6647,1,[엽기전략]광고창작,2940,30,1,4,5,20.0%,48m
6653,1,사이언스베슬,2939,1048,40,34,74,54.1%,47m
6653,3,JSPREY,2939,181,14,9,23,60.9%,5m
6653,1,[WTSC]프롤레타리아,2939,320,10,6,16,62.5%,49m
6653,1,Sisa,2939,352,10,8,18,55.6%,49m
6653,1,다크나이트,2939,235,10,8,18,55.6%,49m
6653,1,Kaze,2939,199,5,5,10,50.0%,49m
6653,1,[Asky]hamvags,2939,43,3,4,7,42.9%,49m
6660,1,JohnnyGroove,2938,232,9,4,13,69.2%,49m
6660,1,BlueRay,2938,66,3,4,7,42.9%,47m
6660,1,낭만,2938,0,1,1,2,50.0%,48m
6660,3,[유즈맵아이들]티피전사,2938,0,0,1,1,0.0%,23m
6664,1,테란,2937,0,3,2,5,60.0%,48m
6664,1,[정신과]병원,2937,0,0,1,1,0.0%,48m
6664,1,기동성,2937,0,0,2,2,0.0%,49m
6667,1,mongking,2936,756,82,71,153,53.6%,49m
6667,3,NCNalRa,2936,958,35,41,76,46.1%,4m
6667,1,김호두,2936,889,30,28,58,51.7%,49m
6667,3,yim,2936,596,24,20,44,54.5%,5m
6667,3,발리순수보이,2936,262,9,15,24,37.5%,11m
6667,3,IIIIIIIIIIII,2936,97,1,2,3,33.3%,20m
6667,1,Bodhisattva,2936,40,1,3,4,25.0%,49m
6667,1,[NrthKR]SCVUser,2936,42,1,3,4,25.0%,47m
6667,3,엔진소리죽이는데,2936,0,0,1,1,0.0%,24m
6667,1,CloudKing,2936,0,0,1,1,0.0%,47m
6677,3,Flash,2935,1503,662,648,1310,50.5%,11m
6677,1,조바이든,2935,422,13,13,26,50.0%,49m
6677,3,공장,2935,309,12,8,20,60.0%,20m
6677,1,[그곳]이전투,2935,293,10,8,18,55.6%,47m
6677,1,걸리면이빨부터다,2935,240,8,7,15,53.3%,49m
6677,1,[TalenT]長島,2935,130,6,4,10,60.0%,49m
6677,3,시리우스,2935,92,3,10,13,23.1%,4m
6677,1,랑랑이,2935,0,0,2,2,0.0%,49m
6677,3,Gloriel,2935,0,0,6,6,0.0%,11m
6686,3,임포스터,2934,898,51,63,114,44.7%,8m
6686,1,Rin,2934,563,19,16,35,54.3%,47m
6686,2,PRIEst,2934,118,6,4,10,60.0%,26m
6686,1,llllllllllll,2934,32,2,2,4,50.0%,47m
6686,1,OpTiMusPrime,2934,36,2,3,5,40.0%,48m
6686,1,[CL]clgreen,2934,0,0,1,1,0.0%,49m
6692,3,[Blacer]내앞니에응아,2933,982,36,39,75,48.0%,8m
6692,1,kongoyizen,2933,551,19,14,33,57.6%,48m
6692,1,[xTMDx]PhoeNix,2933,147,5,4,9,55.6%,48m
6695,3,나다,2932,1388,74,63,137,54.0%,4m
6695,1,테넷,2932,1672,74,77,151,49.0%,48m
6695,2,[DagmBa]통감자,2932,647,23,33,56,41.1%,3m
6695,1,jimreyner,2932,507,15,14,29,51.7%,47m
6695,1,MOYA,2932,145,6,6,12,50.0%,27m
6695,3,CounterATK,2932,60,2,10,12,16.7%,3m
6695,1,Kim,2932,0,0,3,3,0.0%,49m
6702,1,DDT,2931,424,13,12,25,52.0%,49m
6702,1,ANS,2931,395,12,10,22,54.5%,49m
6702,1,Byun,2931,272,9,8,17,52.9%,49m
6702,1,[AntiNs]呱呱,2931,175,8,9,17,47.1%,47m
6702,1,몽키,2931,74,3,4,7,42.9%,47m
6702,1,[Worm]샴푸의누나요정,2931,0,1,1,2,50.0%,48m
6702,3,[ANG2]llllllllllll,2931,0,0,4,4,0.0%,5m
6709,2,jjillkkm,2930,1535,465,451,916,50.8%,6m
6709,2,arkmin,2930,570,19,32,51,37.3%,6m
6709,3,llllllllllll,2930,526,18,18,36,50.0%,4m
6709,1,와디더,2930,474,16,16,32,50.0%,47m
6709,3,lllllllll,2930,374,12,14,26,46.2%,3m
6709,1,bluemild,2930,0,1,1,2,50.0%,49m
6709,1,김점례,2930,44,1,4,5,20.0%,49m
6709,1,legion,2930,0,0,2,2,0.0%,49m
6709,1,리베,2930,0,0,2,2,0.0%,48m
6718,1,[중금속중독자]도도의노예다다,2929,1617,66,57,123,53.7%,50m
6718,1,oughtozam,2929,423,19,14,33,57.6%,47m
6718,2,좇간지,2929,58,6,6,12,50.0%,2m
6718,1,scv,2929,164,5,4,9,55.6%,18m
6718,3,EZPZ,2929,0,3,2,5,60.0%,24m
6718,1,Fubukisaikou,2929,0,1,1,2,50.0%,49m
6718,1,GangnamFive,2929,0,0,1,1,0.0%,49m
6718,1,[喵喵唷]迷途貓,2929,0,0,1,1,0.0%,49m
6718,1,공허의무산,2929,0,0,2,2,0.0%,47m
6718,3,apsara,2929,0,0,9,9,0.0%,11m
6728,3,[SymoW]Hagalaz,2928,1515,576,565,1141,50.5%,7m
6728,1,안양따개비,2928,1552,127,100,227,55.9%,47m
6728,1,lllllIlllIII,2928,745,42,41,83,50.6%,49m
6728,1,참치팔팔,2928,680,33,20,53,62.3%,49m
6728,3,Huyem,2928,118,4,10,14,28.6%,2m
6728,1,정왕목장,2928,76,3,6,9,33.3%,49m
6728,2,johnkami,2928,0,1,1,2,50.0%,27m
6728,1,Clooney,2928,0,0,4,4,0.0%,18m
6736,1,lIllIIIIlllI,2927,667,157,171,328,47.9%,6m
6736,1,[Spades]TragicComedy,2927,359,14,15,29,48.3%,50m
6736,1,불씨,2927,115,5,4,9,55.6%,50m
6736,1,범블비,2927,32,4,3,7,57.1%,48m
6736,1,무작위,2927,0,1,2,3,33.3%,49m
6741,3,legojw,2926,1236,112,116,228,49.1%,5m
6741,3,rangmople,2926,1046,50,54,104,48.1%,11m
6741,1,llllllllllll,2926,760,31,25,56,55.4%,48m
6741,1,[XYFANS]WBWB,2926,278,9,11,20,45.0%,49m
6741,1,MADNESS,2926,242,8,6,14,57.1%,49m
6741,2,[dfg133]윤종운,2926,201,7,5,12,58.3%,26m
6741,3,NBLeos,2926,184,6,5,11,54.5%,3m
6741,1,[UN無限]spatiager,2926,88,5,1,6,83.3%,48m
6741,1,kodebo,2926,88,2,0,2,100.0%,48m
6741,1,게임러버,2926,0,0,1,1,0.0%,49m
6741,1,성신여대십육학번,2926,0,0,4,4,0.0%,48m
6752,1,블랙핑크로제,2925,1261,177,183,360,49.2%,7m
6752,1,[oUMRo]mlml,2925,354,11,7,18,61.1%,49m
6752,2,maiyan,2925,282,9,21,30,30.0%,2m
6752,1,ChinChang,2925,60,5,4,9,55.6%,48m
6752,3,흰줄박이물돼지,2925,125,3,0,3,100.0%,24m
6752,1,[DagmBa]자연산다금바리,2925,34,2,1,3,66.7%,47m
6752,1,[꿈꾸는]로리제국,2925,40,2,2,4,50.0%,49m
6752,1,배틀스타,2925,0,1,2,3,33.3%,18m
6760,1,닉네임,2924,516,64,51,115,55.7%,49m
6760,1,PHmarines,2924,269,10,4,14,71.4%,47m
6760,1,PRADA,2924,228,10,7,17,58.8%,19m
6760,2,스타,2924,48,2,2,4,50.0%,27m
6764,3,배위에다싸,2923,1532,376,349,725,51.9%,7m
6764,3,[NLTN]유니크,2923,716,25,34,59,42.4%,7m
6764,1,Crush,2923,370,13,10,23,56.5%,48m
6764,1,[Nos]Nos,2923,361,13,12,25,52.0%,48m
6764,1,[isnous]SACRIFICE,2923,151,7,0,7,100.0%,49m
6764,1,naggerguy,2923,210,6,9,15,40.0%,49m
6764,1,IIIIIIIIIIII,2923,124,4,5,9,44.4%,49m
6764,1,Hyung,2923,148,4,6,10,40.0%,49m
6764,3,DrumBass,2923,93,1,4,5,20.0%,7m
6764,1,[시럽]기린,2923,0,0,1,1,0.0%,49m
6774,1,Heavyarms,2922,1089,45,31,76,59.2%,48m
6774,2,작은조각가,2922,214,8,6,14,57.1%,25m
6774,3,llllllllllll,2922,44,4,3,7,57.1%,23m
6774,1,[너의ol름은]TJRTMD,2922,100,4,5,9,44.4%,50m
6774,1,TREE,2922,0,4,6,10,40.0%,18m
6774,1,조재성,2922,88,2,4,6,33.3%,49m
6774,1,[성원제자]주키코모리,2922,0,0,4,4,0.0%,49m
6781,3,쫄지말그라,2921,1520,145,137,282,51.4%,11m
6781,1,[YJJ]미띤짜슥,2921,637,56,49,105,53.3%,49m
6781,1,민석,2921,0,1,1,2,50.0%,49m
6781,3,llllllllllll,2921,0,0,1,1,0.0%,24m
6781,1,bluegiants,2921,0,0,2,2,0.0%,47m
6786,1,저녁코끼리,2920,1681,182,165,347,52.4%,49m
6786,3,Rick,2920,1443,103,88,191,53.9%,2m
6786,2,Beenzino,2920,0,1,1,2,50.0%,26m
6786,3,청와대엠비노믹스,2920,0,0,1,1,0.0%,23m
6786,2,GDA,2920,0,0,8,8,0.0%,27m
6791,3,탁탁천왕하딸딸,2919,0,3,3,6,50.0%,23m
6791,1,earth,2919,74,3,5,8,37.5%,49m
6791,1,dkxltn,2919,0,1,1,2,50.0%,48m
6791,1,딱밤한대맞자,2919,0,0,2,2,0.0%,49m
6791,2,puerilesky,2919,0,0,5,5,0.0%,50m
6796,1,player,2918,1674,82,76,158,51.9%,49m
6796,1,Shinjun,2918,838,38,31,69,55.1%,48m
6796,1,過來韓老師這,2918,558,17,22,39,43.6%,49m
6796,3,Apolowik,2918,308,12,10,22,54.5%,20m
6796,3,SatanKim,2918,30,5,3,8,62.5%,4m
6796,2,김스타,2918,114,4,2,6,66.7%,46m
6796,1,[노원]pppenguin,2918,106,2,2,4,50.0%,49m
6796,2,BARAM,2918,30,1,1,2,50.0%,46m
6796,1,[어케했노]독도는한국땅,2918,0,0,2,2,0.0%,49m
6805,2,wyser,2917,439,18,12,30,60.0%,50m
6805,3,히로우,2917,174,14,14,28,50.0%,7m
6805,3,핵두루미,2917,130,6,9,15,40.0%,11m
6805,1,임무완료,2917,97,4,2,6,66.7%,45m
6805,2,EventHorizon,2917,0,1,0,1,100.0%,50m
6810,2,Siamese,2916,893,130,119,249,52.2%,3m
6810,1,Urab,2916,378,13,9,22,59.1%,47m
6810,1,Atropos,2916,256,8,5,13,61.5%,49m
6810,3,Eroica,2916,218,6,9,15,40.0%,52m
6810,3,[Guri]고추,2916,0,2,0,2,100.0%,23m
6815,1,Flash,2915,493,17,13,30,56.7%,47m
6815,3,allalio,2915,237,9,9,18,50.0%,7m
6815,1,battiebisu,2915,289,8,9,17,47.1%,49m
6815,2,dannydubs,2915,135,5,5,10,50.0%,26m
6815,3,여틴구함,2915,97,4,3,7,57.1%,23m
6815,3,돼지고기두근,2915,0,3,3,6,50.0%,24m
6815,2,정원석,2915,0,1,0,1,100.0%,46m
6822,1,ModernTrash,2914,1374,165,146,311,53.1%,49m
6822,1,llllllllllll,2914,495,22,14,36,61.1%,47m
6822,1,예쁜척추,2914,264,11,11,22,50.0%,48m
6822,2,intoThemacke,2914,134,6,4,10,60.0%,26m
6822,2,[MAMENE]EmPeroRDitY,2914,146,4,1,5,80.0%,46m
6822,1,동서초등학교,2914,94,4,4,8,50.0%,49m
6822,2,[싱싱한뉴비]주용용,2914,0,3,2,5,60.0%,46m
6822,3,[TpW]STarHero,2914,0,1,3,4,25.0%,24m
6830,1,[G20]이낙연,2913,1594,144,128,272,52.9%,49m
6830,2,[Mirage]밴시출격,2913,1481,115,123,238,48.3%,6m
6830,1,TIME,2913,199,7,4,11,63.6%,48m
6830,1,할리킹,2913,147,4,5,9,44.4%,49m
6830,2,[재혁이에용]동쪽의별,2913,64,2,1,3,66.7%,51m
6830,1,IIIIIIIIIII,2913,145,2,2,4,50.0%,18m
6836,1,Timeout,2912,516,28,22,50,56.0%,48m
6836,3,옵티머스,2912,624,23,32,55,41.8%,7m
6836,1,노바,2912,470,18,10,28,64.3%,50m
6836,1,[버터오징어]MADkiller,2912,222,8,6,14,57.1%,49m
6836,2,GeniusDanGuN,2912,94,4,2,6,66.7%,51m
6836,1,[異界的檢察官]Fuses,2912,198,4,4,8,50.0%,49m
6836,3,주아조아,2912,155,4,7,11,36.4%,6m
6836,1,IamKorean,2912,66,3,3,6,50.0%,50m
6836,1,[Micron]Argon,2912,30,1,3,4,25.0%,49m
6836,2,PROBE,2912,0,1,4,5,20.0%,50m
6836,1,centurion,2912,0,0,2,2,0.0%,49m
6847,1,[호랑이기운]얌마최완득,2911,106,4,4,8,50.0%,48m
6847,2,졸린꿈,2911,0,3,2,5,60.0%,47m
6849,2,Grushor,2910,117,6,3,9,66.7%,17m
6849,3,Veyux,2910,30,2,2,4,50.0%,6m
6849,1,[Siro]SeOnA,2910,0,1,1,2,50.0%,49m
6852,1,hunny,2909,572,19,17,36,52.8%,48m
6852,3,IMoGsPrime,2909,121,5,2,7,71.4%,24m
6852,2,kwon,2909,128,5,3,8,62.5%,51m
6852,1,만년골드,2909,0,1,1,2,50.0%,49m
6856,3,[멍청한클랜장]전진병영개꿀,2908,1339,166,164,330,50.3%,7m
6856,3,곡갱이,2908,1502,103,108,211,48.8%,7m
6856,3,Barlog,2908,1151,47,48,95,49.5%,4m
6856,3,Akame,2908,413,18,19,37,48.6%,5m
6856,2,[함대출격]다크오렌지,2908,135,3,1,4,75.0%,26m
6856,2,sunderland,2908,0,1,0,1,100.0%,50m
6856,1,초보의하루,2908,0,1,2,3,33.3%,49m
6856,2,혐동련,2908,0,0,1,1,0.0%,46m
6864,1,[달빛양념기사]만드로,2907,329,111,102,213,52.1%,48m
6864,2,Alope,2907,120,5,3,8,62.5%,50m
6864,3,Daughtry,2907,0,3,3,6,50.0%,24m
6864,1,[하얀나비]제로,2907,44,2,5,7,28.6%,19m
6864,2,FoX,2907,0,1,0,1,100.0%,47m
6864,2,[뭔가거대한]rock,2907,0,1,0,1,100.0%,47m
6864,3,정병화,2907,0,0,9,9,0.0%,2m
6871,3,Theking,2906,1348,50,62,112,44.6%,4m
6871,3,星海老手,2906,664,28,30,58,48.3%,11m
6871,2,싸슐라,2906,0,1,0,1,100.0%,47m
6871,1,[래더납치범]녹녹이,2906,0,0,2,2,0.0%,49m
6875,1,lonegunman,2905,567,20,22,42,47.6%,49m
6875,2,supsupeee,2905,250,9,1,10,90.0%,51m
6875,3,sherlock,2905,219,7,10,17,41.2%,52m
6875,2,Pride,2905,58,5,3,8,62.5%,51m
6875,2,내멋대로야,2905,0,4,1,5,80.0%,46m
6875,1,[海膽王]羅伯雷斯高敦校長,2905,97,4,2,6,66.7%,45m
6875,2,[1408]夏娜,2905,0,3,2,5,60.0%,47m
6875,1,솔로몬,2905,88,1,2,3,33.3%,49m
6883,1,tYPICALAsiaN,2904,764,77,51,128,60.2%,49m
6883,1,Lucid,2904,716,27,23,50,54.0%,49m
6883,1,bluef,2904,478,20,17,37,54.1%,47m
6883,1,맛춥뻡않틀립,2904,124,5,10,15,33.3%,49m
6883,3,Luias,2904,0,1,0,1,100.0%,23m
6883,1,[爆走兄弟]我是台灣人我驕傲,2904,0,1,1,2,50.0%,49m
6883,2,Yalos,2904,0,0,5,5,0.0%,50m
6890,3,GGOSinon,2903,1276,137,122,259,52.9%,7m
6890,1,[YERG]aren,2903,1260,67,55,122,54.9%,50m
6890,3,악마,2903,675,44,36,80,55.0%,4m
6890,1,지눙이,2903,278,12,12,24,50.0%,48m
6890,1,황현민존잘,2903,158,4,7,11,36.4%,48m
6890,2,[AMA]aTtTa,2903,0,1,4,5,20.0%,25m
6896,2,lllili,2902,840,39,24,63,61.9%,50m
6896,3,Roman,2902,747,29,30,59,49.2%,6m
6896,1,Markingstong,2902,238,22,20,42,52.4%,48m
6896,1,sahana,2902,652,21,23,44,47.7%,49m
6896,1,InSomnia,2902,420,13,16,29,44.8%,48m
6896,3,[HCRED]Manny,2902,38,3,4,7,42.9%,24m
6896,2,DonaldTrump,2902,34,2,2,4,50.0%,26m
6896,2,애니북스,2902,58,2,2,4,50.0%,51m
6896,2,BANSHEE,2902,0,0,1,1,0.0%,46m
6905,2,주니치카,2901,1170,167,156,323,51.7%,2m
6905,2,연진,2901,1295,50,64,114,43.9%,6m
6905,1,최태호,2901,1048,44,38,82,53.7%,49m
6905,2,혁고마,2901,0,1,0,1,100.0%,51m
6905,1,[사일로]스타테일레볼루션,2901,36,1,3,4,25.0%,49m
6905,2,[Fenix]레이븐,2901,0,0,1,1,0.0%,50m
6905,2,yol,2901,0,0,1,1,0.0%,51m
6912,2,[ZUZU]丁丁是個人才,2900,1552,703,672,1375,51.1%,7m
6912,3,IIIIIIIIIII,2900,1242,62,58,120,51.7%,7m
6912,1,WickedSick,2900,1090,39,39,78,50.0%,50m
6912,2,Mellow,2900,843,33,35,68,48.5%,2m
6912,3,김치보이,2900,736,30,33,63,47.6%,7m
6912,1,군단을위하여,2900,588,19,23,42,45.2%,49m
6912,2,아프리카펭귄,2900,300,19,30,49,38.8%,6m
6912,3,MarySpensor,2900,115,5,5,10,50.0%,4m
6912,3,llllllllllll,2900,121,4,3,7,57.1%,24m
6912,2,rnjswjddnrrn,2900,30,2,0,2,100.0%,47m
6912,3,RynOr,2900,0,1,1,2,50.0%,24m
6912,2,defender,2900,0,1,1,2,50.0%,50m
6924,2,brooklyn,2899,1166,355,326,681,52.1%,3m
6924,3,llllllllllll,2899,1184,249,248,497,50.1%,2m
6924,1,[Drunk]소주,2899,155,6,5,11,54.5%,50m
6924,2,Jukebox,2899,0,3,2,5,60.0%,47m
6924,1,TalDarim,2899,126,3,2,5,60.0%,48m
6924,2,dksld,2899,98,2,1,3,66.7%,51m
6930,2,Terran,2898,1204,55,53,108,50.9%,6m
6930,2,쭈쭈쭈쭈비,2898,1149,46,60,106,43.4%,4m
6930,1,[UlsanT]Delta,2898,999,43,35,78,55.1%,48m
6930,2,Tony,2898,112,4,3,7,57.1%,51m
6930,2,NewbieBigBoy,2898,0,3,2,5,60.0%,50m
6930,1,오랫만이당,2898,124,3,2,5,60.0%,47m
6930,2,Ionman,2898,0,0,5,5,0.0%,46m
6937,1,[스타놀이터]만성피로곰탱이,2897,978,37,31,68,54.4%,49m
6937,1,창안이,2897,1002,35,31,66,53.0%,49m
6937,2,Coronavirus,2897,253,9,6,15,60.0%,47m
6937,1,opendoor,2897,139,6,3,9,66.7%,19m
6937,3,MrMeepOo,2897,0,3,2,5,60.0%,23m
6937,3,mayden,2897,0,3,2,5,60.0%,23m
6937,2,lllllllllll,2897,0,1,0,1,100.0%,50m
6937,1,음란마귀,2897,0,1,1,2,50.0%,49m
6945,2,왕이될상,2896,1464,122,112,234,52.1%,8m
6945,2,oOooOoOooOo,2896,273,39,33,72,54.2%,52m
6945,3,[消灭人族暴政]低熵体,2896,449,23,23,46,50.0%,7m
6945,2,[HOTFIX]NOVA,2896,386,16,5,21,76.2%,51m
6945,1,CyrusII,2896,38,4,4,8,50.0%,49m
6945,2,Paveto,2896,0,3,2,5,60.0%,51m
6945,3,아쿠리스포리토,2896,0,3,4,7,42.9%,24m
6945,2,白澤,2896,0,0,1,1,0.0%,51m
6945,2,족밥,2896,0,0,1,1,0.0%,47m
6954,1,[똑띠해라]QuasarStar,2895,373,16,9,25,64.0%,49m
6954,1,[너의ol름은]Expert,2895,457,16,17,33,48.5%,47m
6954,3,GimmeSugar,2895,288,9,23,32,28.1%,7m
6954,2,연필,2895,0,4,2,6,66.7%,26m
6954,1,번데기,2895,91,1,3,4,25.0%,49m
6959,3,판다랜부르마스터,2894,1442,164,158,322,50.9%,2m
6959,1,TRIPORC,2894,1153,93,98,191,48.7%,3m
6959,1,[박세환]umbrrow,2894,605,24,24,48,50.0%,49m
6959,2,존망겜언제섭종,2894,362,14,3,17,82.4%,52m
6959,3,한지,2894,158,7,6,13,53.8%,20m
6959,2,diego,2894,132,5,5,10,50.0%,17m
6959,3,Nikthekiller,2894,0,3,2,5,60.0%,23m
6959,3,걸즈브링,2894,97,2,0,2,100.0%,24m
6959,2,낄낄악마,2894,30,2,1,3,66.7%,51m
6959,2,무적함대,2894,0,0,1,1,0.0%,47m
6959,2,[chak]PokerFace,2894,0,0,1,1,0.0%,26m
6970,1,QuiTuCy,2893,517,21,18,39,53.8%,48m
6970,2,jkj,2893,222,11,1,12,91.7%,51m
6970,2,VANHELSING,2893,235,10,9,19,52.6%,47m
6970,2,[어윤수님개쩜]용산연쇄삽입마,2893,256,9,7,16,56.2%,52m
6970,1,Marineking,2893,40,1,7,8,12.5%,50m
6970,2,던킨도넛,2893,0,0,1,1,0.0%,50m
6976,2,탈옥수흑형,2892,984,68,48,116,58.6%,50m
6976,3,초보꼬맹이,2892,843,41,40,81,50.6%,5m
6976,1,[zAWSLz]aaaa,2892,434,18,13,31,58.1%,50m
6976,1,ParaDox,2892,371,13,12,25,52.0%,48m
6976,1,IIIIIIIIIIII,2892,162,8,7,15,53.3%,47m
6976,1,이성련,2892,146,5,6,11,45.5%,49m
6976,2,귀찮아죽겠넹,2892,0,2,3,5,40.0%,47m
6976,2,[무한김준현]DayWalker,2892,34,1,2,3,33.3%,47m
6984,2,[SS친위대]독일,2891,810,33,24,57,57.9%,51m
6984,2,IIIIIIIIIIII,2891,498,18,13,31,58.1%,47m
6984,1,[D3StaR]llllllllllll,2891,216,6,7,13,46.2%,48m
6984,2,Ritho,2891,112,5,4,9,55.6%,26m
6984,3,JinAirSoS,2891,147,4,11,15,26.7%,2m
6984,2,神秘,2891,60,3,3,6,50.0%,50m
6984,2,RookiepeL,2891,0,0,1,1,0.0%,47m
6991,1,IIIIIIIIIIII,2890,605,26,20,46,56.5%,49m
6991,1,[ghost임]클로라이온,2890,594,18,41,59,30.5%,8m
6991,1,[무심천]하수,2890,540,17,20,37,45.9%,48m
6994,2,브라보스,2889,1448,86,96,182,47.3%,4m
6994,2,OldMan,2889,219,14,8,22,63.6%,50m
6994,3,갈치,2889,0,4,1,5,80.0%,23m
6994,2,나한국인,2889,119,3,2,5,60.0%,47m
6994,2,[梭哈]XiaoGe,2889,0,0,1,1,0.0%,47m
6999,1,파인만,2888,1658,170,160,330,51.5%,49m
6999,2,레쓰비,2888,1526,150,127,277,54.2%,51m
6999,1,Caiser,2888,738,25,24,49,51.0%,49m
6999,1,misery,2888,544,17,17,34,50.0%,50m
6999,2,도라에로몽,2888,86,3,1,4,75.0%,51m
6999,1,오즈크로니클,2888,98,3,7,10,30.0%,50m
6999,1,의사양반,2888,0,2,4,6,33.3%,49m
6999,2,[자보스]징징키오,2888,36,1,1,2,50.0%,47m
6999,1,IIIIHHIIII,2888,44,1,7,8,12.5%,49m
7008,3,Javawork,2887,287,116,104,220,52.7%,6m
7008,1,할거없습니다,2887,480,19,19,38,50.0%,49m
7008,2,[bOvOd]VIOLstar,2887,181,7,5,12,58.3%,26m
7008,2,SNSD,2887,102,6,2,8,75.0%,51m
7008,2,Duke,2887,0,4,4,8,50.0%,26m
7008,2,업글합시다,2887,58,3,1,4,75.0%,51m
7008,1,[카나데천사]레무링,2887,36,2,4,6,33.3%,48m
7015,1,[Nos]Prologue,2886,162,6,5,11,54.5%,48m
7015,2,[에반탓]순이아재,2886,76,3,2,5,60.0%,51m
7015,2,군급,2886,0,2,3,5,40.0%,47m
7018,2,oftenGGblind,2885,1223,90,81,171,52.6%,51m
7018,2,laboratory,2885,592,25,13,38,65.8%,50m
7018,1,[시럽]AOBA,2885,296,9,8,17,52.9%,48m
7018,2,[승하호두]맹독충승하,2885,242,8,3,11,72.7%,52m
7018,1,jamesbondtra,2885,209,8,8,16,50.0%,19m
7018,3,천상실프,2885,97,4,3,7,57.1%,24m
7018,2,下手,2885,88,3,3,6,50.0%,46m
7025,2,소나기,2884,1639,202,179,381,53.0%,47m
7025,1,견자희,2884,781,34,29,63,54.0%,49m
7025,1,plaguedog,2884,213,24,17,41,58.5%,50m
7025,2,lllIIlllIlll,2884,492,18,18,36,50.0%,47m
7025,1,[VASCO]해랑사,2884,340,11,12,23,47.8%,47m
7025,2,[무한김준현]그레이색이야,2884,74,2,3,5,40.0%,47m
7025,2,[끼얏]VEGRRA,2884,0,0,1,1,0.0%,47m
7025,2,[SGlory]catcans,2884,0,0,1,1,0.0%,51m
7033,1,금만두,2883,753,29,29,58,50.0%,49m
7033,2,단백질,2883,552,21,14,35,60.0%,50m
7033,1,KatasNiGleg,2883,488,21,15,36,58.3%,48m
7033,1,[시나공]Love,2883,97,6,8,14,42.9%,50m
7033,1,트으으으웨르으안,2883,0,3,3,6,50.0%,48m
7033,2,스티븐제라드,2883,0,3,4,7,42.9%,26m
7033,1,[기니피그]네모툰,2883,38,2,3,5,40.0%,50m
7040,2,HOHO,2882,1472,428,425,853,50.2%,6m
7040,1,IIIIIIIIIIII,2882,1517,82,58,140,58.6%,48m
7040,1,戰隊,2882,1442,77,75,152,50.7%,49m
7040,1,카게러,2882,640,22,25,47,46.8%,49m
7040,1,oppott,2882,504,14,22,36,38.9%,50m
7040,1,Space,2882,372,11,15,26,42.3%,49m
7040,1,Marco,2882,304,10,14,24,41.7%,49m
7040,2,[XnA]IIlIlI,2882,96,6,5,11,54.5%,51m
7040,1,Initial,2882,141,5,2,7,71.4%,47m
7040,1,[하찮은]물개,2882,62,5,4,9,55.6%,49m
7040,1,dddddddddddd,2882,142,5,6,11,45.5%,49m
7040,1,[NANT]TerraNova,2882,96,1,1,2,50.0%,19m
7040,2,[시공해적단]생물,2882,0,0,1,1,0.0%,51m
7040,2,[Jju]CocoChanel,2882,0,0,2,2,0.0%,51m
7054,1,[CNCSPE]가우디,2881,1554,109,96,205,53.2%,49m
7054,2,[IT]rain,2881,1216,47,43,90,52.2%,50m
7054,1,시카마루,2881,432,21,11,32,65.6%,47m
7054,3,까날이,2881,172,7,8,15,46.7%,11m
7054,2,[배당금]KBFinance,2881,30,6,0,6,100.0%,46m
7054,2,[아메리카연방]자코뱅,2881,0,1,0,1,100.0%,50m
7060,3,애플와치,2880,959,33,38,71,46.5%,7m
7060,2,Bucket,2880,143,6,4,10,60.0%,46m
7060,1,FATLOSER,2880,88,4,3,7,57.1%,47m
7060,2,씨오에스그레이트,2880,0,0,1,1,0.0%,47m
7060,2,[행복앙코르]젤나가,2880,0,0,1,1,0.0%,51m
7060,2,Cray,2880,0,0,1,1,0.0%,51m
7066,3,[NDW]zoomyoyo,2879,184,7,17,24,29.2%,11m
7066,3,[제일잘생긴]아이폰,2879,30,5,4,9,55.6%,4m
7066,2,foskill,2879,0,1,0,1,100.0%,51m
7066,1,AlJabr,2879,0,1,2,3,33.3%,50m
7066,1,[SEC1]이영호,2879,0,0,2,2,0.0%,48m
7071,2,Shu,2878,1166,54,25,79,68.4%,46m
7071,2,WOONGJINvGP,2878,450,16,10,26,61.5%,51m
7071,3,NewPlay,2878,408,14,21,35,40.0%,7m
7071,1,폭주기관차,2878,235,8,17,25,32.0%,50m
7071,3,데몬헌터,2878,124,6,11,17,35.3%,5m
7071,2,SpyAlien,2878,58,3,1,4,75.0%,51m
7071,2,음성고추,2878,72,3,2,5,60.0%,51m
7071,2,[UMAI]Lucete,2878,102,3,6,9,33.3%,51m
7071,2,KING,2878,36,2,2,4,50.0%,51m
7071,2,[스타놀이터]진주,2878,30,2,2,4,50.0%,47m
7071,2,[이터널]kilgo,2878,0,1,0,1,100.0%,52m
7071,2,예나야남친흑인,2878,0,0,2,2,0.0%,51m
7083,1,llllllllllll,2877,945,35,37,72,48.6%,49m
7083,2,밤까마귀,2877,0,3,2,5,60.0%,51m
7083,2,Lazarus,2877,0,0,1,1,0.0%,51m
7083,3,연나랑나랑,2877,0,0,1,1,0.0%,24m
7087,1,KaKaRu,2876,484,18,17,35,51.4%,49m
7087,1,turtlehunter,2876,88,4,3,7,57.1%,48m
7087,1,두부집효녀,2876,146,4,9,13,30.8%,50m
7087,3,QsmileQ,2876,97,3,2,5,60.0%,24m
7087,2,ClownJoker,2876,106,3,4,7,42.9%,51m
7087,1,니아,2876,104,2,5,7,28.6%,49m
7087,2,나다,2876,0,1,0,1,100.0%,46m
7087,1,피자오빠,2876,0,0,5,5,0.0%,49m
7095,3,llllllllllll,2875,1004,166,166,332,50.0%,4m
7095,2,adorablechlo,2875,346,14,11,25,56.0%,52m
7095,1,nillus,2875,166,7,4,11,63.6%,50m
7095,2,조로아크최,2875,170,6,4,10,60.0%,51m
7095,3,sosa,2875,121,5,2,7,71.4%,25m
7095,1,슈퍼초보,2875,209,5,6,11,45.5%,50m
7095,2,Lisa,2875,136,3,1,4,75.0%,26m
7095,2,felix,2875,68,3,3,6,50.0%,47m
7095,2,황금체험진혼곡,2875,0,1,0,1,100.0%,47m
7104,1,noahliam,2874,1304,266,265,531,50.1%,49m
7104,1,[형님나가신다]SUK,2874,1301,118,118,236,50.0%,49m
7104,2,[엘리트]게임좀즐겨보자,2874,1429,58,45,103,56.3%,51m
7104,1,ROOM,2874,319,40,34,74,54.1%,48m
7104,3,훈식갓,2874,238,8,22,30,26.7%,4m
7104,2,IIIIIIIIIIII,2874,0,3,2,5,60.0%,47m
7104,1,[없지요]IllIllllIllI,2874,107,3,4,7,42.9%,48m
7104,2,김치훈,2874,0,0,1,1,0.0%,47m
7104,2,llllllllllll,2874,0,0,2,2,0.0%,51m
7113,2,Luceinaltis,2873,429,17,15,32,53.1%,47m
7113,1,IIIIIIIIIII,2873,321,7,12,19,36.8%,18m
7113,3,뭐여시발돌려줘요,2873,97,4,3,7,57.1%,24m
7113,2,아반떼,2873,0,1,0,1,100.0%,50m
7113,2,[승딩이]박익찬,2873,0,1,0,1,100.0%,51m
7113,2,[NH협동조합]우주너머로,2873,0,0,1,1,0.0%,47m
7119,2,현규,2872,1384,57,47,104,54.8%,50m
7119,1,정예신병,2872,1312,52,52,104,50.0%,48m
7119,1,Oversky,2872,1148,39,43,82,47.6%,50m
7119,1,레테퓨,2872,285,27,24,51,52.9%,48m
7119,2,[마법쓰는]유미,2872,514,22,9,31,71.0%,50m
7119,1,[SofT]김가을,2872,442,13,16,29,44.8%,50m
7119,2,[33250]bumpman,2872,191,10,7,17,58.8%,51m
7119,2,나폴레용신관,2872,116,5,3,8,62.5%,50m
7119,2,DeBoY,2872,30,2,1,3,66.7%,46m
7119,2,전장속해병,2872,30,1,1,2,50.0%,50m
7119,2,NightKnight,2872,0,0,1,1,0.0%,52m
7130,1,LeeYong,2871,1348,72,71,143,50.3%,48m
7130,2,[무한오영종]Nobody,2871,30,2,0,2,100.0%,50m
7130,3,방구는자연의하품,2871,0,1,3,4,25.0%,11m
7133,2,Planetlovely,2870,722,33,24,57,57.9%,50m
7133,2,WCE,2870,502,17,18,35,48.6%,52m
7133,2,철갑군단장,2870,267,12,11,23,52.2%,47m
7133,2,Felipe,2870,198,7,6,13,53.8%,51m
7133,2,나도잘할수있어,2870,0,0,2,2,0.0%,51m
7133,2,제갈필립,2870,0,0,2,2,0.0%,51m
7139,1,설사해욤,2869,1453,63,57,120,52.5%,49m
7139,1,라디드,2869,858,56,52,108,51.9%,49m
7139,1,글룸달클리치,2869,1230,44,50,94,46.8%,49m
7139,2,Eclips,2869,553,31,27,58,53.4%,51m
7139,3,urmomsnakama,2869,466,26,35,61,42.6%,5m
7139,1,파라케,2869,550,20,20,40,50.0%,47m
7139,1,승천맥스,2869,272,11,9,20,55.0%,48m
7139,2,LGtheMoon,2869,308,11,11,22,50.0%,47m
7139,2,IIIIIIIIIIII,2869,181,4,3,7,57.1%,50m
7139,2,IntereStinG,2869,32,2,2,4,50.0%,51m
7139,2,짐레이너,2869,0,1,2,3,33.3%,47m
7139,2,LHT,2869,0,1,2,3,33.3%,51m
7139,2,Amon,2869,30,1,2,3,33.3%,51m
7139,2,김옥지,2869,0,0,2,2,0.0%,51m
7139,2,Fresh,2869,0,0,2,2,0.0%,51m
7154,1,rivertak,2868,1606,218,189,407,53.6%,48m
7154,1,비니,2868,1090,38,34,72,52.8%,48m
7154,1,MEFQSQ,2868,396,19,16,35,54.3%,50m
7154,1,꿀광토스,2868,270,8,20,28,28.6%,8m
7154,2,Kona,2868,89,3,3,6,50.0%,47m
7154,2,째원,2868,60,2,1,3,66.7%,51m
7154,2,[국방부사서병]조폭너구리당,2868,141,2,3,5,40.0%,26m
7154,2,小楓,2868,68,2,4,6,33.3%,17m
7154,2,Dak,2868,30,1,3,4,25.0%,51m
7163,1,lIlIlIllIIII,2867,1614,82,74,156,52.6%,49m
7163,1,고구마,2867,328,11,12,23,47.8%,47m
7163,3,Suwan,2867,286,9,19,28,32.1%,4m
7163,2,[출렁출렁]DieBoy,2867,160,6,5,11,54.5%,27m
7163,2,코아랄라라라라라,2867,0,0,1,1,0.0%,50m
7163,2,STALIN,2867,0,0,3,3,0.0%,50m
7169,1,nope,2866,950,38,29,67,56.7%,49m
7169,1,BESTONE,2866,615,25,21,46,54.3%,47m
7169,2,메트로호퍼,2866,206,7,7,14,50.0%,51m
7169,2,General,2866,36,2,1,3,66.7%,50m
7169,2,BSK,2866,46,2,1,3,66.7%,26m
7169,3,[미래한국당]보목안먹으면팀킬,2866,0,1,0,1,100.0%,24m
7169,2,[IWYDI]SuddenSR,2866,30,1,1,2,50.0%,51m
7176,3,gur,2865,1504,113,102,215,52.6%,6m
7176,2,[Worm]KDG,2865,844,32,31,63,50.8%,52m
7176,1,METALJS,2865,251,11,8,19,57.9%,49m
7176,2,[RAM4GB]후라치기,2865,0,0,1,1,0.0%,46m
7180,3,엄준식,2864,575,31,27,58,53.4%,5m
7180,1,doitdo,2864,426,14,14,28,50.0%,49m
7180,1,섭이,2864,342,12,11,23,52.2%,50m
7180,1,[공방깡패]임하우동,2864,188,6,12,18,33.3%,48m
7180,2,행복하게,2864,30,4,3,7,57.1%,47m
7180,1,Withfox,2864,40,1,6,7,14.3%,48m
7186,1,[온양]아이이이잉,2863,1466,60,58,118,50.8%,49m
7186,3,Dreamhack,2863,620,44,46,90,48.9%,11m
7186,1,BUNTUTS,2863,553,23,21,44,52.3%,48m
7186,3,[萬花筒寫輪眼]不悲不喜不晴不雨,2863,576,21,29,50,42.0%,5m
7186,2,상은이의하루,2863,254,10,8,18,55.6%,50m
7186,2,[랜타디장인들]약둥,2863,242,9,9,18,50.0%,51m
7186,1,checkmate,2863,186,7,7,14,50.0%,49m
7186,3,CanCauser,2863,0,3,3,6,50.0%,25m
7186,2,[0512]최이트,2863,30,2,0,2,100.0%,47m
7186,2,dlatjddn,2863,30,2,4,6,33.3%,51m
7186,1,[새하얀]토끼,2863,105,2,6,8,25.0%,48m
7186,2,불투,2863,0,1,0,1,100.0%,51m
7198,1,IIIIIIIIIIII,2862,877,34,27,61,55.7%,49m
7198,1,冰凍紅茶,2862,212,10,8,18,55.6%,20m
7198,1,Insanity,2862,216,5,12,17,29.4%,19m
7198,2,小安安,2862,66,3,0,3,100.0%,52m
7202,1,[겜동]깍두기,2861,1030,48,38,86,55.8%,48m
7202,1,deyt,2861,812,41,27,68,60.3%,48m
7202,3,Rusiorin,2861,60,5,4,9,55.6%,25m
7202,2,[미녀모유농장]레자의은밀한바지,2861,152,5,6,11,45.5%,51m
7202,2,[Briton]옆집구미호,2861,0,1,1,2,50.0%,47m
7202,2,팔란티어,2861,0,0,1,1,0.0%,52m
7208,2,TRIPLEZERO,2860,297,13,1,14,92.9%,47m
7208,2,Eclipse,2860,240,8,9,17,47.1%,51m
7208,2,골드라도,2860,0,3,1,4,75.0%,47m
7208,3,GDL,2860,97,3,3,6,50.0%,24m
7208,2,성준,2860,0,1,0,1,100.0%,51m
7208,2,herry,2860,0,0,1,1,0.0%,47m
7214,3,nightwing,2859,1391,115,111,226,50.9%,4m
7214,1,ssoul,2859,1614,79,72,151,52.3%,50m
7214,2,那家社基大,2859,682,25,22,47,53.2%,47m
7214,1,안양동참붕어,2859,412,13,20,33,39.4%,47m
7214,2,wynihilus,2859,0,0,2,2,0.0%,51m
7219,1,revolution,2858,1217,74,75,149,49.7%,49m
7219,1,잇힝,2858,1341,61,54,115,53.0%,50m
7219,1,내가곧신이다,2858,774,30,28,58,51.7%,49m
7219,1,Raboy,2858,280,8,12,20,40.0%,48m
7219,3,[아임프래쉬]하하하,2858,0,1,0,1,100.0%,25m
7219,2,CloudKing,2858,30,1,4,5,20.0%,47m
7219,2,GLHF,2858,30,1,5,6,16.7%,51m
7219,1,lllllll,2858,34,1,7,8,12.5%,50m
7219,1,llllllllllll,2858,0,0,4,4,0.0%,49m
7228,1,MidasGodHand,2857,0,1,3,4,25.0%,49m
7228,2,koo,2857,0,0,3,3,0.0%,51m
7230,1,MatriKeanEuX,2856,706,29,24,53,54.7%,49m
7230,1,Hellion,2856,362,11,16,27,40.7%,49m
7230,2,Dddooooing,2856,140,4,4,8,50.0%,50m
7230,2,Wombat,2856,0,1,0,1,100.0%,51m
7230,3,개시발스타투,2856,40,1,2,3,33.3%,40m
7230,2,경찰,2856,0,0,1,1,0.0%,51m
7230,2,llllllll,2856,0,0,1,1,0.0%,52m
7230,2,BamBam,2856,0,0,2,2,0.0%,26m
7238,2,LLUPINUS,2855,314,12,11,23,52.2%,51m
7238,2,altrix,2855,86,3,3,6,50.0%,51m
7238,2,온니성기사,2855,0,0,1,1,0.0%,51m
7241,1,풀발귀,2854,959,83,75,158,52.5%,49m
7241,2,新手玩家好爽,2854,1117,62,55,117,53.0%,51m
7241,1,XiaoSong,2854,489,23,20,43,53.5%,50m
7241,2,Nivdc,2854,123,4,5,9,44.4%,46m
7241,2,귀요미,2854,0,0,1,1,0.0%,51m
7241,1,유바다,2854,0,0,5,5,0.0%,48m
7247,2,KANSA,2853,1452,317,304,621,51.0%,6m
7247,1,Computer,2853,519,41,34,75,54.7%,49m
7247,1,배추,2853,1108,39,43,82,47.6%,48m
7247,1,천하무적왕자님,2853,214,7,12,19,36.8%,49m
7247,2,하이,2853,135,6,4,10,60.0%,26m
7247,2,BobRoss,2853,156,6,9,15,40.0%,25m
7247,2,이준구,2853,32,2,0,2,100.0%,51m
7247,1,홍길동,2853,32,2,5,7,28.6%,49m
7247,2,新冠還是武漢肺炎,2853,0,1,0,1,100.0%,51m
7247,2,unicumonly,2853,0,1,1,2,50.0%,47m
7257,1,해병,2852,30,1,5,6,16.7%,49m
7258,2,야만용사,2851,1563,143,120,263,54.4%,47m
7258,2,응애,2851,1553,71,60,131,54.2%,52m
7258,1,你輸好,2851,1106,62,67,129,48.1%,48m
7258,2,HADES,2851,375,15,7,22,68.2%,47m
7258,1,HeavensBox,2851,264,9,10,19,47.4%,49m
7258,2,콤투수,2851,234,7,5,12,58.3%,51m
7258,1,[달빛양념기사]담넘는철부지,2851,218,7,13,20,35.0%,49m
7258,3,Quim,2851,138,4,5,9,44.4%,25m
7258,3,잉여왕,2851,30,3,3,6,50.0%,24m
7258,2,[ELS]토르,2851,150,3,5,8,37.5%,51m
7258,2,Levi,2851,0,2,3,5,40.0%,51m
7258,1,제류,2851,0,1,1,2,50.0%,48m
7258,2,marketwizard,2851,0,0,1,1,0.0%,51m
7271,2,durdell,2850,1411,221,188,409,54.0%,51m
7271,2,wjdtjsals,2850,722,28,23,51,54.9%,50m
7271,1,가나다,2850,497,23,25,48,47.9%,49m
7271,3,모두다링,2850,401,18,23,41,43.9%,5m
7271,2,NitroZeus,2850,170,7,4,11,63.6%,52m
7271,1,뚱인데여,2850,184,6,6,12,50.0%,49m
7271,1,junsu,2850,0,4,1,5,80.0%,22m
7271,2,pavelskim,2850,94,3,4,7,42.9%,51m
7271,1,노날두,2850,70,2,7,9,22.2%,50m
7271,1,삼팔광댕,2850,0,1,0,1,100.0%,23m
7281,2,맥주,2849,1174,78,68,146,53.4%,50m
7281,2,파도,2849,560,21,21,42,50.0%,52m
7281,2,[카봇]Joon,2849,312,12,13,25,48.0%,51m
7281,2,karuma,2849,32,2,1,3,66.7%,51m
7281,2,백아절현,2849,0,1,0,1,100.0%,51m
7281,2,Eiushua,2849,0,1,2,3,33.3%,50m
7281,1,재활용하세요,2849,0,0,1,1,0.0%,19m
7281,2,llllllllllll,2849,0,0,1,1,0.0%,47m
7289,1,경상도사나이,2848,884,123,120,243,50.6%,50m
7289,1,Nature,2848,883,65,63,128,50.8%,49m
7289,1,[大嘴鳥]STARLIGHT,2848,427,24,21,45,53.3%,49m
7289,2,Pheet,2848,291,12,9,21,57.1%,47m
7289,1,[ANGG]솔비앙,2848,263,7,10,17,41.2%,49m
7289,2,용량이두렵찡,2848,144,4,2,6,66.7%,47m
7289,2,yanni,2848,92,4,5,9,44.4%,51m
7289,2,진팀장렛츠고,2848,146,4,6,10,40.0%,47m
7289,2,Luntian,2848,0,3,2,5,60.0%,47m
7289,3,Harvest,2848,0,1,0,1,100.0%,24m
7289,1,arter,2848,0,0,3,3,0.0%,18m
7300,2,슈퍼맨,2847,150,6,3,9,66.7%,51m
7300,1,[군사정권]히틀러,2847,98,5,10,15,33.3%,49m
7300,3,NucL,2847,30,2,9,11,18.2%,4m
7303,2,degaone,2846,1011,100,105,205,48.8%,7m
7303,1,Punch,2846,534,26,24,50,52.0%,48m
7303,1,몽구,2846,95,4,5,9,44.4%,48m
7303,2,REMAINSOFME,2846,126,4,5,9,44.4%,50m
7303,1,PuMa,2846,0,3,4,7,42.9%,48m
7303,2,하니발,2846,60,2,2,4,50.0%,51m
7303,2,[LaMa]moonstar,2846,36,1,2,3,33.3%,51m
7310,1,IllIlllIlll,2845,239,9,5,14,64.3%,48m
7310,1,projectzero,2845,101,4,4,8,50.0%,50m
7310,2,[철새]NaDa,2845,30,2,1,3,66.7%,51m
7310,2,공허의유산,2845,60,2,4,6,33.3%,50m
7310,2,Minboycrash,2845,0,1,0,1,100.0%,52m
7310,1,biverse,2845,89,1,3,4,25.0%,49m
7316,3,mosmos,2844,1520,424,382,806,52.6%,3m
7316,3,아이유내거,2844,1501,69,72,141,48.9%,6m
7316,1,울트라마린,2844,442,17,17,34,50.0%,48m
7316,1,IllIIlIlIlII,2844,462,15,21,36,41.7%,49m
7316,2,aazztech,2844,127,4,0,4,100.0%,26m
7316,2,geek,2844,62,2,2,4,50.0%,47m
7316,2,좀비장수후계자,2844,0,1,2,3,33.3%,26m
7323,3,BreeMA,2843,1351,357,348,705,50.6%,4m
7323,2,큰개자리,2843,560,20,16,36,55.6%,50m
7323,1,솔뫼보안관,2843,120,4,4,8,50.0%,48m
7323,2,LeeSH,2843,58,3,2,5,60.0%,50m
7323,2,unknowns,2843,88,3,3,6,50.0%,47m
7323,2,against,2843,88,2,0,2,100.0%,51m
7323,3,Impaler,2843,0,1,6,7,14.3%,25m
7323,2,바구미,2843,0,0,1,1,0.0%,51m
7331,1,Snutewannabe,2842,993,367,336,703,52.2%,49m
7331,2,MYDirtYHobbY,2842,142,7,4,11,63.6%,50m
7331,2,홍쉡,2842,176,6,7,13,46.2%,51m
7331,3,[앟녛핳셓옇]변경기회없다,2842,121,4,1,5,80.0%,25m
7331,2,낯선하늘,2842,64,2,4,6,33.3%,51m
7331,1,SPY,2842,0,0,1,1,0.0%,23m
7337,1,sapphire,2841,865,46,50,96,47.9%,50m
7337,2,PNINSTY,2841,776,36,19,55,65.5%,51m
7337,2,[환영여단]kingsroad,2841,484,17,19,36,47.2%,47m
7337,2,SCA,2841,282,16,7,23,69.6%,51m
7337,2,fifth,2841,90,3,9,12,25.0%,51m
7337,2,TEXXAN,2841,0,1,0,1,100.0%,50m
7337,2,예일,2841,30,1,1,2,50.0%,51m
7344,1,Scarletto,2840,1640,340,311,651,52.2%,48m
7344,2,[NUSSR]공세갈매,2840,419,17,9,26,65.4%,51m
7344,1,DDDDDDD,2840,250,8,17,25,32.0%,50m
7344,2,[전당포]민이어쳐,2840,79,3,4,7,42.9%,51m
7344,2,막시무스,2840,0,1,0,1,100.0%,51m
7344,1,부러진나무,2840,96,1,2,3,33.3%,19m
7344,2,KBI,2840,0,0,1,1,0.0%,51m
7351,2,kit,2839,264,9,5,14,64.3%,52m
7351,2,[LQV]쌈도리,2839,216,9,6,15,60.0%,47m
7351,2,하누다,2839,64,3,3,6,50.0%,51m
7351,2,Geeman,2839,0,0,1,1,0.0%,51m
7351,2,muzy,2839,0,0,2,2,0.0%,50m
7356,1,mozzaaaa,2838,640,35,35,70,50.0%,49m
7356,2,KKboy,2838,411,17,14,31,54.8%,47m
7356,1,IIIIIlllllII,2838,397,17,15,32,53.1%,48m
7356,2,lIllIIllIlIl,2838,344,14,11,25,56.0%,52m
7356,1,小鍾,2838,227,8,9,17,47.1%,50m
7356,1,FreeDom,2838,180,8,9,17,47.1%,19m
7356,2,assso,2838,170,7,4,11,63.6%,50m
7356,2,뉴비등장,2838,229,7,5,12,58.3%,50m
7356,2,Vex,2838,219,7,7,14,50.0%,25m
7356,2,ATLAS,2838,136,3,1,4,75.0%,51m
7356,1,[GITS]姜太公釣大尾鱸鰻,2838,74,2,10,12,16.7%,49m
7356,2,[공무원합격은]김생잘,2838,0,1,0,1,100.0%,47m
7356,2,[快樂玩家]JIM,2838,0,0,1,1,0.0%,51m
7356,2,[Kisa]Leny,2838,0,0,2,2,0.0%,51m
7370,2,[NGameS]Jokers,2837,84,5,4,9,55.6%,51m
7370,2,사랑안전,2837,144,5,4,9,55.6%,47m
7370,1,SANA,2837,0,3,2,5,60.0%,23m
7370,1,우리겜방알바예쁨,2837,0,2,2,4,50.0%,22m
7370,2,다윗,2837,60,2,2,4,50.0%,47m
7370,2,Evern,2837,68,2,3,5,40.0%,47m
7370,2,Prior,2837,0,1,1,2,50.0%,51m
7370,2,[개복장인]hiperyon,2837,34,1,1,2,50.0%,51m
7370,2,satieco,2837,0,1,1,2,50.0%,51m
7379,3,IIIIIIIIIIII,2836,452,130,126,256,50.8%,6m
7379,1,extermine,2836,1570,87,84,171,50.9%,49m
7379,2,Horangi,2836,927,38,32,70,54.3%,47m
7379,2,Baoro,2836,401,27,19,46,58.7%,50m
7379,1,클비,2836,0,4,3,7,57.1%,48m
7379,2,Crose,2836,62,3,2,5,60.0%,50m
7379,1,Spike,2836,0,1,5,6,16.7%,49m
7379,2,ask,2836,0,0,1,1,0.0%,51m
7387,2,fire,2835,1393,287,269,556,51.6%,2m
7387,2,왈왈이,2835,752,80,70,150,53.3%,51m
7387,2,PEGIEIGHTEEN,2835,527,27,17,44,61.4%,47m
7387,2,[KT롤스터]테란,2835,302,11,10,21,52.4%,51m
7387,2,Legionella,2835,131,6,6,12,50.0%,17m
7387,2,[머구폐렴]설원기설,2835,90,4,4,8,50.0%,51m
7393,2,대장록크,2834,1508,375,360,735,51.0%,5m
7393,2,욤욤이,2834,749,61,82,143,42.7%,7m
7393,2,SlayersALPA,2834,120,5,4,9,55.6%,51m
7393,1,Lufs,2834,48,2,4,6,33.3%,23m
7397,2,아이유뚝배기,2833,442,22,3,25,88.0%,47m
7397,1,walchy,2833,534,20,19,39,51.3%,49m
7397,2,鬼月,2833,97,5,4,9,55.6%,51m
7397,2,[송해손잡고]테사다,2833,66,5,5,10,50.0%,50m
7397,2,AmateSmallR,2833,82,4,9,13,30.8%,26m
7397,2,RainbowSik,2833,30,1,1,2,50.0%,51m
7397,1,진모리,2833,0,1,1,2,50.0%,22m
7397,2,Avatool,2833,30,1,1,2,50.0%,51m
7397,2,뒷치기전문,2833,0,0,1,1,0.0%,51m
7406,3,GiveMeMerc,2832,1411,181,168,349,51.9%,3m
7406,1,llwei,2832,1139,43,48,91,47.3%,49m
7406,1,kwon,2832,201,7,3,10,70.0%,20m
7406,2,ppqq,2832,142,6,3,9,66.7%,51m
7406,3,Kain,2832,141,4,5,9,44.4%,24m
7406,2,Koteika,2832,0,3,2,5,60.0%,47m
7406,2,星際聯盟,2832,58,2,4,6,33.3%,51m
7413,2,헬로빵셔틀,2831,591,24,23,47,51.1%,51m
7413,1,innerpeace,2831,324,9,17,26,34.6%,49m
7413,2,[미사일뿌수기]탱보이,2831,234,8,5,13,61.5%,51m
7413,2,BroccoliPig,2831,205,8,6,14,57.1%,26m
7413,1,ZLiger,2831,191,7,6,13,53.8%,47m
7413,2,최유준,2831,196,7,7,14,50.0%,51m
7413,2,Nova,2831,176,5,3,8,62.5%,51m
7413,2,Lorn,2831,88,2,0,2,100.0%,51m
7413,2,테란,2831,58,2,2,4,50.0%,52m
7413,2,[스벌것]알맞은닉네임,2831,88,2,3,5,40.0%,27m
7423,2,라라,2830,869,35,29,64,54.7%,51m
7423,2,[국방부사서병]마린,2830,500,22,10,32,68.8%,47m
7423,2,그림자,2830,375,15,13,28,53.6%,51m
7423,2,[허대영섹시남]박도진,2830,342,12,9,21,57.1%,50m
7423,2,수면중독,2830,243,9,9,18,50.0%,26m
7423,1,Kenta,2830,0,3,2,5,60.0%,23m
7423,2,Ptolemaeos,2830,0,0,3,3,0.0%,50m
7430,3,Amuro,2829,1586,298,285,583,51.1%,2m
7430,1,Zeus,2829,774,264,258,522,50.6%,49m
7430,2,빅뱅,2829,1358,79,71,150,52.7%,50m
7430,1,kelvin,2829,899,44,49,93,47.3%,49m
7430,2,TerranMarine,2829,399,15,12,27,55.6%,47m
7430,2,lililililili,2829,260,8,5,13,61.5%,51m
7430,3,angel,2829,0,3,4,7,42.9%,24m
7430,2,흰백,2829,0,0,1,1,0.0%,51m
7438,3,很弱的人類,2828,1459,192,187,379,50.7%,5m
7438,1,Bioteran,2828,329,11,11,22,50.0%,18m
7438,2,은돌이,2828,0,1,0,1,100.0%,50m
7438,2,[cau301]씹장,2828,30,1,3,4,25.0%,47m
7442,2,Dissolve,2827,1123,44,38,82,53.7%,47m
7442,2,[pepsl]콜라와초콜릿,2827,280,10,7,17,58.8%,47m
7442,2,JUSTIVE,2827,197,8,8,16,50.0%,51m
7442,2,skyRanson,2827,0,1,0,1,100.0%,47m
7442,2,아기고양이,2827,0,0,2,2,0.0%,51m
7447,2,[달맞이꽃]lunaflower,2826,280,11,5,16,68.8%,50m
7447,2,재아,2826,32,2,6,8,25.0%,51m
7447,2,Daisaku,2826,30,1,5,6,16.7%,50m
7450,1,슬레이어스레카,2825,1514,148,136,284,52.1%,50m
7450,1,바로,2825,1034,140,132,272,51.5%,50m
7450,2,SuperGGT,2825,705,50,46,96,52.1%,50m
7450,2,크리그마리네,2825,848,44,41,85,51.8%,51m
7450,2,[RAID]강승부현이,2825,898,34,32,66,51.5%,51m
7450,1,민준아빠,2825,772,32,26,58,55.2%,50m
7450,2,AceTom,2825,281,19,11,30,63.3%,52m
7450,2,마린,2825,120,5,4,9,55.6%,47m
7450,2,[Master]IPPOO,2825,122,5,8,13,38.5%,51m
7450,2,Neruvius,2825,0,1,0,1,100.0%,26m
7450,3,히페리온,2825,0,0,1,1,0.0%,24m
7461,1,怒海潛將,2824,317,13,19,32,40.6%,49m
7461,3,호굥,2824,122,7,9,16,43.8%,7m
7461,2,알아서뭐하게,2824,66,4,2,6,66.7%,51m
7464,2,[쫄깃함]다리장인뚜기,2823,603,23,21,44,52.3%,51m
7464,2,TakeOfSoul,2823,321,13,12,25,52.0%,47m
7464,2,사신,2823,226,8,12,20,40.0%,51m
7464,2,waltiostias,2823,202,7,3,10,70.0%,51m
7464,2,[비트]ShaDow,2823,30,1,2,3,33.3%,50m
7464,2,[단무지다]paldo,2823,0,0,1,1,0.0%,51m
7464,2,김치왕자,2823,0,0,1,1,0.0%,51m
7464,2,[르노삼성]섹시영규,2823,0,0,3,3,0.0%,51m
7472,2,[패자는피를]미르존,2822,1308,56,48,104,53.8%,51m
7472,2,하이염,2822,1025,39,37,76,51.3%,51m
7472,1,맛있는청국장,2822,605,21,26,47,44.7%,49m
7472,2,marine,2822,560,20,18,38,52.6%,51m
7472,2,[異界的檢察官]XxFkDoYaxX,2822,438,16,13,29,55.2%,51m
7472,2,단팥펭귄,2822,0,3,2,5,60.0%,47m
7472,2,할매야,2822,30,1,2,3,33.3%,51m
7472,2,아이유,2822,0,0,1,1,0.0%,47m
7472,2,[이쿠노]nightdm,2822,0,0,1,1,0.0%,50m
7472,3,IIIIIII,2822,0,0,1,1,0.0%,24m
7482,1,잉낑준,2821,253,11,8,19,57.9%,49m
7482,2,니친구,2821,70,3,5,8,37.5%,52m
7482,2,GeneRal,2821,0,0,2,2,0.0%,52m
7485,2,기타소,2820,410,17,6,23,73.9%,51m
7485,2,짱쥐니,2820,211,8,10,18,44.4%,51m
7485,2,혁제짬냄새,2820,210,7,6,13,53.8%,51m
7485,3,Akino,2820,97,5,2,7,71.4%,23m
7485,2,threeTM,2820,128,4,1,5,80.0%,47m
7485,2,[한화]周星馳,2820,132,4,7,11,36.4%,51m
7485,2,chonis,2820,94,3,8,11,27.3%,47m
7485,2,학살자닝겐,2820,0,1,0,1,100.0%,47m
7493,1,[TalenT]speed,2819,1369,55,54,109,50.5%,49m
7493,2,[어윤수님개쩜]동크만크,2819,142,5,5,10,50.0%,47m
7493,2,ILLuMinaTe,2819,116,4,0,4,100.0%,51m
7493,2,llllllllllll,2819,88,3,3,6,50.0%,51m
7493,3,[민뜨미또파이]Saidia,2819,0,0,1,1,0.0%,25m
7498,1,Something,2818,252,9,7,16,56.2%,48m
7498,2,llllllllllll,2818,130,5,1,6,83.3%,47m
7498,3,[DPW]JAY,2818,80,4,7,11,36.4%,40m
7501,2,[Worm]빠따이,2817,236,11,10,21,52.4%,51m
7501,2,송병구,2817,240,7,7,14,50.0%,52m
7501,1,zzz,2817,186,4,10,14,28.6%,49m
7501,2,[섹시아재]VWWVWVVWVWVV,2817,0,1,1,2,50.0%,51m
7501,2,kMC,2817,32,1,6,7,14.3%,50m
7506,3,[비트]대성고졸업생이십,2816,1520,433,426,859,50.4%,3m
7506,2,Albert,2816,324,12,7,19,63.2%,51m
7506,1,KinGArIMG,2816,196,6,12,18,33.3%,49m
7506,2,하마샤,2816,32,2,3,5,40.0%,51m
7510,1,[ZUZU]RROM,2815,1621,493,470,963,51.2%,50m
7510,3,공복,2815,827,37,50,87,42.5%,7m
7510,1,따발총,2815,171,5,8,13,38.5%,19m
7510,2,Henryshe,2815,0,3,2,5,60.0%,47m
7510,3,Kenzyte,2815,0,3,7,10,30.0%,12m
7510,3,산신님마리,2815,0,1,0,1,100.0%,24m
7510,2,joosj,2815,0,1,0,1,100.0%,47m
7510,2,힘수학문선생님,2815,30,1,3,4,25.0%,47m
7510,2,GrimReaper,2815,0,0,1,1,0.0%,51m
7510,2,궁디팍팍,2815,0,0,2,2,0.0%,51m
7520,1,[護士小姐讚]體檢時充血,2814,730,62,60,122,50.8%,49m
7520,2,지옥으로가,2814,804,29,39,68,42.6%,8m
7520,1,[마계인천]Marrin,2814,263,11,10,21,52.4%,49m
7520,2,뽀삼가이드,2814,282,10,8,18,55.6%,51m
7520,2,[리쉬빙]rakjongpal,2814,160,5,8,13,38.5%,51m
7520,3,막강효효,2814,0,1,0,1,100.0%,25m
7520,2,[섹시아재]아빠멩스크,2814,88,1,1,2,50.0%,51m
7520,2,백호,2814,0,0,1,1,0.0%,51m
7520,2,[광역어그로]멋진곤사마,2814,0,0,4,4,0.0%,51m
7529,1,[로마제국]후리고,2813,1181,82,71,153,53.6%,49m
7529,1,Malfurion,2813,470,16,22,38,42.1%,50m
7529,1,이중건,2813,206,9,10,19,47.4%,19m
7529,1,[CJENM]미친마법사,2813,214,7,14,21,33.3%,50m
7529,2,저그가싫어요,2813,58,3,1,4,75.0%,51m
7529,2,말대꾸하지마,2813,110,3,1,4,75.0%,51m
7529,2,Ace,2813,0,3,3,6,50.0%,26m
7529,2,[문제를푸른중]효구효구,2813,0,0,1,1,0.0%,47m
7537,1,하하하,2812,803,55,57,112,49.1%,49m
7537,2,폭풍저그,2812,347,46,41,87,52.9%,50m
7537,3,[개지고싶다]스오우파블리첸코,2812,84,5,5,10,50.0%,24m
7537,2,[310]Hawke,2812,0,4,1,5,80.0%,47m
7537,2,[중금속중독자]TLQKFSHA,2812,0,1,0,1,100.0%,47m
7537,2,Greenday,2812,32,1,2,3,33.3%,51m
7537,2,rnswls,2812,30,1,4,5,20.0%,47m
7537,3,빠른,2812,0,0,2,2,0.0%,25m
7545,2,tyuij,2811,1359,79,69,148,53.4%,47m
7545,2,광일두두,2811,480,17,19,36,47.2%,51m
7545,1,[快樂玩家]welson,2811,197,7,7,14,50.0%,50m
7545,1,[Bully]펑커임요환,2811,168,5,14,19,26.3%,49m
7545,2,톰토맹,2811,88,2,0,2,100.0%,51m
7545,2,wei,2811,30,1,2,3,33.3%,51m
7545,2,Glare,2811,32,1,3,4,25.0%,51m
7545,2,무한대비율,2811,30,1,3,4,25.0%,50m
7545,2,Toss,2811,88,1,6,7,14.3%,51m
7554,2,RedBear,2810,1569,222,203,425,52.2%,51m
7554,1,llllllllllll,2810,389,16,24,40,40.0%,49m
7554,3,我下面比你大,2810,121,4,5,9,44.4%,24m
7554,2,roscosmos,2810,0,3,1,4,75.0%,51m
7554,1,[개굴맨]개구리배꼽,2810,133,3,6,9,33.3%,48m
7554,1,WHITEWINGS,2810,80,2,6,8,25.0%,47m
7554,2,卡節,2810,30,1,2,3,33.3%,50m
7554,1,CCK,2810,34,1,9,10,10.0%,49m
7562,3,gggrffshhhrt,2809,776,37,44,81,45.7%,7m
7562,1,피닉스,2809,363,23,27,50,46.0%,49m
7562,2,쫄랑이,2809,269,17,10,27,63.0%,50m
7562,2,AEsir,2809,232,9,8,17,52.9%,47m
7562,1,manati,2809,184,8,7,15,53.3%,48m
7562,2,kwon,2809,94,3,7,10,30.0%,51m
7562,2,東風,2809,0,1,1,2,50.0%,51m
7562,2,theshield,2809,0,1,1,2,50.0%,51m
7562,2,Katsu,2809,30,1,3,4,25.0%,47m
7562,1,환란,2809,40,1,3,4,25.0%,19m
7562,3,박승찬사랑해,2809,0,0,1,1,0.0%,24m
7573,2,kisspop,2808,742,31,26,57,54.4%,47m
7573,2,이유비,2808,438,18,16,34,52.9%,47m
7573,2,마자아아룡,2808,240,9,8,17,52.9%,51m
7573,2,llllllllllll,2808,230,9,8,17,52.9%,47m
7573,2,한량,2808,110,3,1,4,75.0%,26m
7573,1,[공허거주]대디,2808,0,3,3,6,50.0%,48m
7573,1,정가휘,2808,0,1,0,1,100.0%,22m
7573,2,[오홍홍]GimmalE,2808,30,1,2,3,33.3%,52m
7581,2,granty,2807,1060,76,77,153,49.7%,51m
7581,2,Karencici,2807,190,8,3,11,72.7%,47m
7581,1,西門彌齋,2807,105,6,10,16,37.5%,49m
7581,2,[레더]lIlllIIIllIl,2807,90,4,4,8,50.0%,51m
7581,2,[정의의]법규,2807,30,1,3,4,25.0%,50m
7581,2,pjwoo,2807,0,1,3,4,25.0%,26m
7587,1,[겨울방어]jey,2806,1604,393,378,771,51.0%,49m
7587,3,Rehol,2806,501,186,177,363,51.2%,4m
7587,1,[Flysky]MOONLight,2806,996,37,43,80,46.2%,49m
7587,2,Areskss,2806,436,33,29,62,53.2%,51m
7587,2,StarcAce,2806,264,10,6,16,62.5%,50m
7587,3,[얼음치즈]힘안찐,2806,135,5,5,10,50.0%,24m
7587,1,아기공룡틀니,2806,200,5,13,18,27.8%,49m
7587,2,[代時洨]Rednuht,2806,136,4,2,6,66.7%,50m
7587,2,네란두스,2806,60,3,2,5,60.0%,51m
7587,2,SayuRang,2806,88,1,1,2,50.0%,47m
7587,2,초보임,2806,0,1,2,3,33.3%,51m
7587,1,트럼프,2806,0,1,6,7,14.3%,49m
7599,2,Discount,2805,1477,554,518,1072,51.7%,3m
7599,2,RyanJK,2805,144,6,9,15,40.0%,51m
7599,1,구운옥수수,2805,185,5,8,13,38.5%,50m
7599,2,Tuf,2805,88,3,3,6,50.0%,47m
7599,2,이지명,2805,0,1,0,1,100.0%,51m
7604,3,[ThsG]Southpaw,2804,768,33,31,64,51.6%,4m
7604,2,Icarus,2804,415,16,12,28,57.1%,51m
7604,2,YinGan,2804,204,9,2,11,81.8%,51m
7604,2,루펀,2804,60,5,4,9,55.6%,47m
7604,2,Computer,2804,0,1,0,1,100.0%,26m
7604,2,你刘爹,2804,0,1,0,1,100.0%,51m
7604,2,반필터,2804,0,1,4,5,20.0%,51m
7604,2,빛공,2804,0,0,1,1,0.0%,51m
7612,1,[sc2mc]rauru,2803,1615,264,251,515,51.3%,48m
7612,1,Leon,2803,1551,146,142,288,50.7%,49m
7612,2,lIIlIIIIIlll,2803,1037,43,37,80,53.8%,50m
7612,2,Idaho,2803,374,26,17,43,60.5%,51m
7612,2,[EMTRMT]IlIlIlIlIlIl,2803,230,9,21,30,30.0%,47m
7612,2,듀티,2803,210,7,5,12,58.3%,51m
7612,2,KirCruel,2803,102,3,0,3,100.0%,51m
7612,2,[최고다사기리]mnch,2803,0,1,1,2,50.0%,50m
7612,2,리플,2803,0,0,1,1,0.0%,51m
7621,2,PipoDope,2802,576,40,34,74,54.1%,51m
7621,2,독립,2802,752,35,27,62,56.5%,52m
7621,1,금속인,2802,615,24,27,51,47.1%,49m
7621,2,iKiRA,2802,317,11,10,21,52.4%,47m
7621,2,TheKhan,2802,146,8,6,14,57.1%,52m
7621,2,DAVEZEROTYPE,2802,120,4,6,10,40.0%,47m
7621,2,[스커즈]살창안,2802,58,2,4,6,33.3%,51m
7621,3,llllllllllll,2802,0,0,3,3,0.0%,25m
7629,1,니암미,2801,1367,78,82,160,48.8%,49m
7629,2,khoa,2801,929,60,54,114,52.6%,51m
7629,2,자유,2801,729,28,25,53,52.8%,51m
7629,2,나는짱,2801,191,7,5,12,58.3%,47m
7629,2,유리가가린,2801,60,3,4,7,42.9%,51m
7629,2,BloodyPoopie,2801,30,1,2,3,33.3%,51m
7629,2,[공주님]chocholate,2801,0,0,1,1,0.0%,51m
7636,2,저글링,2800,171,7,5,12,58.3%,47m
7636,1,상구봉구,2800,140,6,5,11,54.5%,49m
7636,1,hoilc,2800,88,4,4,8,50.0%,47m
7636,3,liliiiilll,2800,121,4,4,8,50.0%,25m
7636,2,빙구박스,2800,60,3,3,6,50.0%,51m
7636,2,산이,2800,90,3,5,8,37.5%,51m
7636,2,Leofrancis,2800,88,2,1,3,66.7%,47m
7636,2,신의컨트롤,2800,0,1,2,3,33.3%,51m
7644,3,재권씨,2799,870,95,74,169,56.2%,52m
7644,2,lIlIlIlIlIll,2799,957,51,52,103,49.5%,51m
7644,2,포복절도,2799,613,26,21,47,55.3%,52m
7644,3,arete,2799,450,22,12,34,64.7%,52m
7644,3,[敗人品系列]NoeZues,2799,144,6,2,8,75.0%,25m
7644,1,TheViksBack,2799,154,6,6,12,50.0%,50m
7644,2,QWEASDZXC,2799,139,4,6,10,40.0%,47m
7644,3,Aimer,2799,30,1,1,2,50.0%,20m
7644,2,타락,2799,0,0,4,4,0.0%,51m
7653,3,bluebird,2798,1504,187,186,373,50.1%,5m
7653,3,天使乂惡魔,2798,1508,89,91,180,49.4%,4m
7653,2,Gladiolus,2798,659,78,70,148,52.7%,50m
7653,3,[OBG]CarpeDiem,2798,327,15,11,26,57.7%,52m
7653,2,Dulche,2798,364,15,13,28,53.6%,51m
7653,2,devsd,2798,300,11,9,20,55.0%,50m
7653,3,DEmoniCfleX,2798,172,6,5,11,54.5%,20m
7653,3,[국립대]학살자,2798,0,2,3,5,40.0%,47m
7653,2,magic,2798,32,2,5,7,28.6%,50m
7662,3,[맛있더라]BABYOUNG,2797,1226,73,66,139,52.5%,7m
7662,1,hoonhoon,2797,1501,67,68,135,49.6%,49m
7662,2,llIiI,2797,691,32,22,54,59.3%,47m
7662,1,星空殺手,2797,616,29,23,52,55.8%,48m
7662,2,ProMeTheus,2797,560,22,24,46,47.8%,51m
7662,3,탱크조아,2797,86,4,2,6,66.7%,20m
7662,1,[로스타]루마니아,2797,102,4,10,14,28.6%,50m
7662,2,Nozawanabe,2797,92,3,7,10,30.0%,51m
7662,2,[우리는하나]palradin,2797,0,0,1,1,0.0%,27m
7671,2,llllllllll,2796,917,37,35,72,51.4%,52m
7671,3,Demitreat,2796,660,26,28,54,48.1%,7m
7671,2,[기생충]감염충,2796,372,16,16,32,50.0%,51m
7671,3,[SEAL]스타초보자,2796,147,5,5,10,50.0%,24m
7671,1,[건국]바람이,2796,0,0,1,1,0.0%,27m
7676,3,bemusick,2795,1432,274,278,552,49.6%,7m
7676,2,Lobster,2795,1464,73,81,154,47.4%,4m
7676,1,NOEX,2795,620,25,23,48,52.1%,48m
7676,3,jin,2795,514,20,15,35,57.1%,46m
7676,2,dentistar,2795,157,5,9,14,35.7%,6m
7676,3,victor,2795,0,3,2,5,60.0%,46m
7682,1,[anime]glycerine,2794,1541,59,61,120,49.2%,50m
7682,2,플토짱짱,2794,145,7,6,13,53.8%,27m
7682,2,BlaCkOut,2794,196,6,12,18,33.3%,52m
7682,3,전소미,2794,30,2,0,2,100.0%,46m
7682,3,군인,2794,0,1,3,4,25.0%,24m
7687,2,Underthetree,2793,484,16,20,36,44.4%,51m
7687,2,철이와보리,2793,282,12,8,20,60.0%,50m
7687,1,JeonBlee,2793,280,11,13,24,45.8%,48m
7687,2,kwg,2793,172,6,9,15,40.0%,51m
7687,2,[샐러드Bar]잡초샐러드,2793,90,4,4,8,50.0%,51m
7687,2,TheKakaru,2793,88,3,5,8,37.5%,47m
7687,2,죽음의사신,2793,60,3,5,8,37.5%,51m
7687,3,gfcftcf,2793,0,0,1,1,0.0%,46m
7687,2,[ForGG]잘못해요,2793,0,0,2,2,0.0%,52m
7687,2,숭댓국밥,2793,0,0,2,2,0.0%,51m
7697,2,mint,2792,1524,261,254,515,50.7%,7m
7697,2,JCJC,2792,788,38,45,83,45.8%,2m
7697,2,Majaja,2792,712,30,22,52,57.7%,47m
7697,3,뿡뿡,2792,270,12,11,23,52.2%,46m
7697,3,[VINYL]namion,2792,0,1,0,1,100.0%,52m
7697,2,RefLecton,2792,0,1,2,3,33.3%,25m
7697,3,[일반인고수]해병,2792,0,0,1,1,0.0%,20m
7704,2,코로나종식기원,2791,1472,242,239,481,50.3%,6m
7704,3,현티선생,2791,236,8,8,16,50.0%,20m
7704,3,rig,2791,119,4,3,7,57.1%,47m
7704,1,神之子,2791,81,4,5,9,44.4%,49m
7704,1,luvhyr,2791,96,2,1,3,66.7%,19m
7704,3,전자포,2791,30,1,2,3,33.3%,52m
7704,3,[IAEA]HWANJANG,2791,30,1,2,3,33.3%,20m
7704,2,gsjgha,2791,0,0,2,2,0.0%,51m
7712,1,[겨울방어]Extra,2790,1586,269,254,523,51.4%,48m
7712,2,Aiden,2790,1522,87,88,175,49.7%,51m
7712,2,[ELS]SgtPepper,2790,1236,48,46,94,51.1%,51m
7712,1,Wiggles,2790,874,30,41,71,42.3%,49m
7712,2,고기먹다들킨스님,2790,246,10,4,14,71.4%,50m
7712,2,전투제독,2790,102,2,2,4,50.0%,51m
7712,2,Delee,2790,30,2,2,4,50.0%,52m
7719,1,ToddPark,2789,827,68,66,134,50.7%,50m
7719,1,[갓세정]김세정,2789,928,39,40,79,49.4%,49m
7719,3,MiracleST,2789,892,35,32,67,52.2%,20m
7719,2,dspecialist,2789,698,26,23,49,53.1%,51m
7719,1,fehygysdjt,2789,532,18,26,44,40.9%,50m
7719,2,까미,2789,128,3,3,6,50.0%,51m
7719,2,스타신입생,2789,0,1,1,2,50.0%,51m
7719,1,[IN]天道自由,2789,0,0,1,1,0.0%,23m
7719,2,빌리언,2789,0,0,3,3,0.0%,47m
7728,1,MTman,2788,1329,102,98,200,51.0%,50m
7728,3,Jarhead,2788,304,11,3,14,78.6%,20m
7728,2,불나방,2788,252,10,8,18,55.6%,51m
7728,2,LEGOBOX,2788,214,9,4,13,69.2%,47m
7728,2,sis,2788,266,9,9,18,50.0%,26m
7728,2,[전투]흰우유,2788,209,8,8,16,50.0%,52m
7728,1,CrazyNoh,2788,188,7,9,16,43.8%,20m
7728,2,[독을풀었다]MaebonG,2788,130,4,4,8,50.0%,51m
7728,1,달망고,2788,48,3,3,6,50.0%,23m
7728,3,[즐겜러]Gert,2788,0,1,0,1,100.0%,46m
7738,2,ToSsMe,2787,1303,84,73,157,53.5%,50m
7738,2,eric,2787,1134,49,47,96,51.0%,47m
7738,2,아라블루호,2787,668,28,21,49,57.1%,51m
7738,2,ZaViEr,2787,202,7,2,9,77.8%,26m
7738,3,대물러버,2787,114,5,2,7,71.4%,52m
7738,1,[적절한]AdelaContrl,2787,118,3,2,5,60.0%,19m
7738,3,멩스크,2787,0,3,4,7,42.9%,25m
7738,3,殘奘取經,2787,137,3,4,7,42.9%,25m
7738,3,Xperiencu,2787,0,2,3,5,40.0%,46m
7738,2,[TheDOH]Havewill,2787,30,1,5,6,16.7%,47m
7748,1,Rain,2786,398,22,20,42,52.4%,49m
7748,2,UNO,2786,292,10,14,24,41.7%,51m
7748,2,bumblebee,2786,156,6,5,11,54.5%,47m
7748,2,[CoCoA]ios,2786,158,5,5,10,50.0%,51m
7748,3,존맥클레인,2786,161,4,5,9,44.4%,24m
7748,3,BarcoDe,2786,97,2,2,4,50.0%,20m
7748,2,ZeUs,2786,30,1,6,7,14.3%,51m
7748,3,김바보,2786,0,0,1,1,0.0%,47m
7748,3,[비상]파도다,2786,0,0,1,1,0.0%,20m
7757,2,하류야,2785,1470,129,106,235,54.9%,50m
7757,2,SamMarine,2785,1465,89,76,165,53.9%,47m
7757,2,TwoKang,2785,461,61,53,114,53.5%,51m
7757,1,동백꽃필무렵,2785,560,32,32,64,50.0%,50m
7757,2,dasdws,2785,580,24,17,41,58.5%,47m
7757,3,묵이,2785,174,7,4,11,63.6%,52m
7757,3,Dusk,2785,60,2,2,4,50.0%,52m
7757,2,드롭,2785,60,2,4,6,33.3%,47m
7757,2,스유대,2785,0,0,4,4,0.0%,50m
7766,2,[광역어그로]보목안먹으면팀킬,2784,342,13,12,25,52.0%,51m
7766,1,Rictus,2784,36,6,8,14,42.9%,27m
7768,1,terran,2783,1514,156,142,298,52.3%,50m
7768,1,[허대영섹시남]힛토,2783,545,20,21,41,48.8%,50m
7768,2,llllllllllll,2783,576,20,25,45,44.4%,51m
7768,2,머더,2783,0,5,3,8,62.5%,26m
7768,3,꾸엑꾸,2783,58,5,6,11,45.5%,12m
7768,1,자연흡기,2783,143,4,5,9,44.4%,48m
7774,3,RequiemStory,2782,564,119,117,236,50.4%,8m
7774,2,llllllllllll,2782,414,17,14,31,54.8%,51m
7774,2,[Number]Two,2782,200,8,7,15,53.3%,51m
7774,2,스펙보통,2782,128,6,5,11,54.5%,47m
7774,2,Ruthenium,2782,30,4,3,7,57.1%,47m
7774,2,차카츠,2782,0,3,3,6,50.0%,47m
7774,1,Sophon,2782,0,2,3,5,40.0%,23m
7774,3,FIREX,2782,0,1,0,1,100.0%,52m
7774,2,랄라놀이,2782,0,0,2,2,0.0%,52m
7783,2,shwnsgur,2781,1544,121,109,230,52.6%,51m
7783,2,[병신들모임]가브리엘라,2781,1471,63,54,117,53.8%,47m
7783,1,구르는천둥,2781,953,40,42,82,48.8%,49m
7783,2,好太王高谈德,2781,640,29,21,50,58.0%,47m
7783,3,마한판붙어보자마,2781,685,27,17,44,61.4%,46m
7783,2,[2494]ace,2781,405,22,21,43,51.2%,51m
7783,2,데드크로스,2781,260,18,14,32,56.2%,50m
7783,3,로솔,2781,190,5,4,9,55.6%,47m
7783,3,청천,2781,86,4,1,5,80.0%,52m
7783,2,[즐겜러]늅이,2781,30,2,3,5,40.0%,51m
7783,3,아라한,2781,40,1,2,3,33.3%,24m
7783,3,WinFestors,2781,0,0,1,1,0.0%,52m
7795,2,[연패현]조용한아침,2780,142,5,2,7,71.4%,51m
7795,2,항공작전사령부,2780,155,4,3,7,57.1%,26m
7795,1,Rookie,2780,0,3,3,6,50.0%,22m
7795,3,min,2780,30,1,1,2,50.0%,46m
7795,1,[호이짜]윤호이짜,2780,0,0,4,4,0.0%,48m
7800,2,KRdog,2779,1011,82,77,159,51.6%,52m
7800,2,타이레놀,2779,1187,60,46,106,56.6%,51m
7800,2,GreatCrash,2779,580,26,20,46,56.5%,51m
7800,2,leejk,2779,199,6,6,12,50.0%,51m
7800,2,tpztmarine,2779,211,6,6,12,50.0%,51m
7800,3,WTF,2779,136,6,8,14,42.9%,12m
7800,3,복상임,2779,115,5,7,12,41.7%,12m
7800,3,김경진,2779,86,3,3,6,50.0%,52m
7800,2,Himura,2779,88,3,4,7,42.9%,47m
7800,3,즐겜유저테란,2779,0,0,1,1,0.0%,20m
7800,3,소주좋아좋아,2779,0,0,1,1,0.0%,52m
7800,2,힐링받음,2779,0,0,6,6,0.0%,51m
7812,1,마라나타,2778,1013,93,92,185,50.3%,50m
7812,3,tanpham,2778,1238,80,60,140,57.1%,52m
7812,1,MintChoco,2778,1071,41,41,82,50.0%,48m
7812,1,hoze,2778,232,18,19,37,48.6%,50m
7812,3,똥방구쏭다,2778,86,4,0,4,100.0%,20m
7812,2,NOOB,2778,0,1,1,2,50.0%,47m
7818,2,Zephty,2777,1563,148,137,285,51.9%,51m
7818,1,개념의길,2777,1589,76,81,157,48.4%,49m
7818,2,point,2777,355,14,10,24,58.3%,51m
7818,2,언젠간,2777,165,7,6,13,53.8%,26m
7818,3,Ating,2777,193,6,6,12,50.0%,24m
7818,2,[일리안]미카엘,2777,88,5,2,7,71.4%,47m
7818,1,NinjaSlayer,2777,0,2,3,5,40.0%,22m
7818,2,Romer,2777,88,1,3,4,25.0%,47m
7818,3,GGWP,2777,0,0,1,1,0.0%,46m
7827,3,바이톤가자간,2776,1016,38,35,73,52.1%,20m
7827,3,BlackBird,2776,140,5,3,8,62.5%,47m
7827,3,[Pinoys]TantanPH,2776,86,4,2,6,66.7%,46m
7827,2,삼호송단,2776,110,4,4,8,50.0%,52m
7827,3,Dyne,2776,135,4,5,9,44.4%,47m
7827,3,[SI]教我上鑽石,2776,0,1,0,1,100.0%,52m
7833,1,광탈자일인자,2775,1585,92,87,179,51.4%,48m
7833,2,ROY,2775,332,13,14,27,48.1%,51m
7833,3,그냥영떡,2775,320,11,11,22,50.0%,20m
7833,2,[악몽스탕스]신손의노예,2775,226,8,6,14,57.1%,47m
7833,2,마이클색슨,2775,197,8,8,16,50.0%,51m
7833,3,magicprotoss,2775,170,6,5,11,54.5%,46m
7833,3,안산천재,2775,116,4,4,8,50.0%,52m
7833,2,[형님나가신다]불곰,2775,116,4,6,10,40.0%,47m
7841,3,양학,2774,1430,100,109,209,47.8%,8m
7841,2,스파키스트,2774,134,6,8,14,42.9%,18m
7841,2,clane,2774,88,2,1,3,66.7%,51m
7841,3,Batman,2774,0,1,4,5,20.0%,20m
7841,2,Thsjy,2774,0,0,5,5,0.0%,26m
7846,1,ChesDale,2773,1597,409,381,790,51.8%,49m
7846,3,[인격파탄]킴승헌혁,2773,472,19,16,35,54.3%,52m
7846,2,alltaget,2773,137,7,6,13,53.8%,27m
7846,2,llllllllll,2773,30,2,4,6,33.3%,51m
7846,2,꼽으면현피하던가,2773,0,1,1,2,50.0%,51m
7846,2,[으흥기무]드라군,2773,0,0,2,2,0.0%,47m
7852,3,muyayo,2772,532,21,13,34,61.8%,47m
7852,2,Crimson,2772,461,21,19,40,52.5%,51m
7852,3,WIK,2772,226,8,4,12,66.7%,25m
7852,3,storken,2772,162,4,3,7,57.1%,24m
7852,3,FateZero,2772,58,4,4,8,50.0%,46m
7852,2,Lemon,2772,124,4,8,12,33.3%,51m
7858,2,김밥이,2771,1192,46,46,92,50.0%,51m
7858,2,daylight,2771,336,13,11,24,54.2%,51m
7858,3,[후두리패버림]bangrang,2771,266,9,9,18,50.0%,52m
7858,1,HiRoShi,2771,96,4,4,8,50.0%,23m
7858,3,토르가왔다,2771,58,2,1,3,66.7%,52m
7858,3,Nobel,2771,0,0,1,1,0.0%,20m
7858,3,symmetry,2771,0,0,1,1,0.0%,52m
7865,2,[6Teen]Dysutopia,2770,894,39,30,69,56.5%,47m
7865,3,腰子卡石頭,2770,58,2,3,5,40.0%,46m
7865,3,聽說我是神,2770,0,1,0,1,100.0%,24m
7865,3,[Yin]Siberi,2770,30,1,2,3,33.3%,52m
7865,3,Thunder,2770,0,0,1,1,0.0%,52m
7865,2,아무나,2770,0,0,3,3,0.0%,51m
7871,2,압살꾼,2769,521,19,19,38,50.0%,51m
7871,2,嚮往尼泊爾之地,2769,396,16,10,26,61.5%,50m
7871,2,해커,2769,186,16,17,33,48.5%,51m
7871,2,에덴,2769,368,16,17,33,48.5%,51m
7871,3,櫧騔湸,2769,30,1,1,2,50.0%,52m
7871,2,[스카이파이터]아구조아,2769,0,1,1,2,50.0%,47m
7871,3,leedaen,2769,0,0,2,2,0.0%,20m
7878,3,오키오키,2768,1175,104,98,202,51.5%,52m
7878,2,거스사카,2768,138,5,6,11,45.5%,47m
7878,3,cSTrapCard,2768,126,4,4,8,50.0%,20m
7878,3,[홍콩행제리바]SynDroMe,2768,79,3,2,5,60.0%,52m
7878,1,slieny,2768,48,3,3,6,50.0%,23m
7878,2,[버거킹킹]망한버거킹,2768,34,3,4,7,42.9%,51m
7878,2,[DokJag]이찬서,2768,88,2,2,4,50.0%,47m
7878,3,Abigdream,2768,58,2,2,4,50.0%,52m
7886,1,[지뢰성애자]청정수,2767,1590,90,75,165,54.5%,49m
7886,3,swiss,2767,686,26,24,50,52.0%,20m
7886,3,hellosw,2767,228,8,7,15,53.3%,46m
7886,3,tabs,2767,159,7,4,11,63.6%,52m
7886,3,삼각산정,2767,121,4,2,6,66.7%,25m
7886,3,icechoco,2767,58,2,1,3,66.7%,20m
7886,2,WengZeng,2767,0,0,5,5,0.0%,47m
7893,1,[ELSII]IlIlIlllIllI,2766,568,26,23,49,53.1%,50m
7893,2,Yakuza,2766,251,9,11,20,45.0%,51m
7893,1,nickim,2766,193,8,10,18,44.4%,18m
7893,3,帥暉,2766,118,4,3,7,57.1%,20m
7893,3,[Worm]플토재미있지,2766,0,0,2,2,0.0%,47m
7898,3,PMA,2765,1562,72,58,130,55.4%,46m
7898,1,[개굴맨]마팔구,2765,1118,45,45,90,50.0%,49m
7898,3,lshfoieii,2765,97,2,0,2,100.0%,24m
7898,3,wish,2765,122,2,2,4,50.0%,25m
7898,3,조짱,2765,60,2,4,6,33.3%,20m
7898,3,어둠의정복자,2765,30,1,3,4,25.0%,20m
7904,3,태어난김에사는중,2764,463,23,21,44,52.3%,52m
7904,2,나난무무,2764,249,10,14,24,41.7%,51m
7904,3,도라이몽키,2764,30,3,3,6,50.0%,47m
7904,3,초보라고놀리지말,2764,30,2,0,2,100.0%,52m
7904,1,ksw,2764,0,2,3,5,40.0%,24m
7904,3,불닭과라면,2764,0,0,1,1,0.0%,52m
7910,3,러브젤교회,2763,168,7,1,8,87.5%,52m
7910,2,유늬러브,2763,133,6,4,10,60.0%,47m
7910,3,[101010]걸레,2763,0,1,0,1,100.0%,52m
7910,3,[DagmBa]귀찮아,2763,0,1,0,1,100.0%,47m
7910,3,다잡아먹쟈,2763,30,1,3,4,25.0%,20m
7910,1,影龍,2763,0,1,5,6,16.7%,23m
7910,2,mikyholee,2763,34,1,6,7,14.3%,47m
7917,1,[조직]동수파파,2762,1579,150,136,286,52.4%,50m
7917,3,호로시키들,2762,1378,101,88,189,53.4%,52m
7917,1,[WTSC]건치미소,2762,863,38,44,82,46.3%,49m
7917,3,Everton,2762,0,1,1,2,50.0%,52m
7921,3,[KOSEAL]퇴교생,2761,862,34,29,63,54.0%,46m
7921,3,JOTKER,2761,193,7,4,11,63.6%,46m
7921,2,[공대지]해처리,2761,188,7,9,16,43.8%,51m
7921,3,apolo,2761,68,5,6,11,45.5%,24m
7921,3,lIlIlIlIlIlI,2761,115,3,2,5,60.0%,52m
7921,3,[SPTS]UmeMasterFu,2761,0,1,0,1,100.0%,52m
7927,3,Saffron,2760,668,54,48,102,52.9%,52m
7927,1,파닉다트,2760,254,11,9,20,55.0%,48m
7927,3,[FSHVM]포건맨,2760,134,5,6,11,45.5%,52m
7927,1,엉큼한바이퍼,2760,42,1,11,12,8.3%,49m
7927,3,안녕하세요,2760,0,0,2,2,0.0%,20m
7932,2,지나가는양반,2759,121,3,1,4,75.0%,26m
7932,3,슈퍼히어로,2759,143,3,1,4,75.0%,52m
7932,2,PrioritY,2759,140,3,5,8,37.5%,47m
7932,2,뭉치멍멍,2759,32,2,5,7,28.6%,51m
7932,3,이육수,2759,0,0,1,1,0.0%,52m
7932,2,주노임돠,2759,0,0,3,3,0.0%,47m
7938,1,[허대영]전설의케리건,2758,1522,66,67,133,49.6%,49m
7938,3,HotShot,2758,558,25,7,32,78.1%,20m
7938,1,[레인저]PeePer,2758,565,22,22,44,50.0%,50m
7938,3,aaadsadsdad,2758,212,10,13,23,43.5%,8m
7938,2,不可思議,2758,234,9,8,17,52.9%,18m
7938,3,[暗夜洌鶇]Firewilling,2758,182,7,6,13,53.8%,20m
7938,2,끝까지가다,2758,32,1,5,6,16.7%,51m
7938,2,KOMS,2758,34,1,7,8,12.5%,52m
7946,3,최주한,2757,896,39,41,80,48.8%,20m
7946,2,HeyJoe,2757,336,14,10,24,58.3%,51m
7946,2,힛걸의매력속으로,2757,312,10,16,26,38.5%,47m
7946,2,[SEDAN]영권이기지박살,2757,60,2,6,8,25.0%,51m
7950,2,shs,2756,742,31,28,59,52.5%,47m
7950,3,Soap,2756,483,22,15,37,59.5%,46m
7950,3,lovely,2756,180,7,5,12,58.3%,20m
7950,3,jhs,2756,34,1,5,6,16.7%,25m
7950,2,[NCFZ]Leny,2756,0,0,5,5,0.0%,51m
7955,1,Allenspider,2755,1402,102,97,199,51.3%,48m
7955,2,theREverse,2755,624,25,22,47,53.2%,47m
7955,2,BBangShuTTle,2755,149,12,6,18,66.7%,51m
7955,2,rara,2755,306,10,18,28,35.7%,47m
7955,3,라모스,2755,90,3,3,6,50.0%,52m
7960,3,winking,2754,752,28,26,54,51.9%,52m
7960,3,[Trivia]ULayGyi,2754,154,8,2,10,80.0%,52m
7960,2,처음처럼,2754,218,8,7,15,53.3%,47m
7960,2,mynametoolon,2754,186,7,10,17,41.2%,51m
7960,3,쿠론,2754,0,1,0,1,100.0%,20m
7960,3,[별똥별]박광덕,2754,0,0,2,2,0.0%,40m
7966,1,wvwvwvwvwvww,2753,1582,102,104,206,49.5%,48m
7966,2,연수,2753,1223,49,47,96,51.0%,51m
7966,3,초딩대표조진우,2753,375,19,5,24,79.2%,20m
7966,3,세트,2753,142,6,6,12,50.0%,52m
7966,3,[Ato]수웅늉,2753,30,1,1,2,50.0%,52m
7966,3,다퓨,2753,0,1,1,2,50.0%,46m
7972,3,[조직]skywalker,2752,1295,66,59,125,52.8%,52m
7972,3,Piggy,2752,849,32,28,60,53.3%,52m
7972,2,yiii,2752,478,18,20,38,47.4%,51m
7972,2,[극채색]승건,2752,206,7,12,19,36.8%,51m
7972,2,popza,2752,88,5,2,7,71.4%,47m
7972,3,magNETar,2752,121,4,4,8,50.0%,24m
7972,3,Gooday,2752,58,3,2,5,60.0%,47m
7972,3,히힣히,2752,0,0,1,1,0.0%,52m
7980,2,[디시인사이드]준식하무현,2751,1488,69,54,123,56.1%,47m
7980,1,익사이팅,2751,494,19,26,45,42.2%,49m
7980,2,탈레반,2751,126,5,10,15,33.3%,51m
7980,1,아르타니스,2751,97,2,1,3,66.7%,46m
7980,3,뜨사자,2751,0,1,1,2,50.0%,20m
7980,3,[sc2mc]LilHomies,2751,0,0,1,1,0.0%,47m
7986,3,난나니,2750,1279,62,57,119,52.1%,52m
7986,2,[자유의유산]oxygen,2750,858,38,35,73,52.1%,51m
7986,3,해를사랑한구름,2750,30,2,1,3,66.7%,47m
7986,2,스타매냐,2750,38,2,7,9,22.2%,51m
7986,1,세도우드레곤,2750,0,1,1,2,50.0%,23m
7986,2,LocraftPrime,2750,30,1,6,7,14.3%,51m
7986,2,EOD,2750,0,0,3,3,0.0%,51m
7993,2,SENZunique,2749,1361,131,116,247,53.0%,51m
7993,2,오늘도,2749,988,39,38,77,50.6%,51m
7993,2,GiantDwarf,2749,458,29,26,55,52.7%,51m
7993,2,정원용,2749,380,14,13,27,51.9%,51m
7993,3,Lotus,2749,136,4,4,8,50.0%,46m
7993,3,damul,2749,58,2,1,3,66.7%,52m
7993,3,IIIIIIIIIIII,2749,0,2,3,5,40.0%,46m
7993,3,Alarak,2749,0,0,1,1,0.0%,46m
8001,1,벤츠,2748,1566,201,189,390,51.5%,47m
8001,2,이아나,2748,1357,142,144,286,49.7%,51m
8001,2,프로유인선,2748,484,22,16,38,57.9%,51m
8001,3,똥옹싸아,2748,532,16,34,50,32.0%,12m
8001,3,Nozirat,2748,170,6,2,8,75.0%,24m
8001,2,개인기,2748,176,6,10,16,37.5%,51m
8001,2,DearName,2748,118,4,8,12,33.3%,47m
8001,2,Goobu,2748,30,2,4,6,33.3%,51m
8001,1,darknight,2748,46,1,3,4,25.0%,18m
8001,3,tlqkf,2748,30,1,4,5,20.0%,20m
8001,3,真犽皇代理總司令,2748,0,0,1,1,0.0%,20m
8012,2,Temu,2747,1317,96,96,192,50.0%,51m
8012,1,올킬게이머,2747,651,25,25,50,50.0%,50m
8012,2,굿럭,2747,0,1,0,1,100.0%,27m
8012,3,민뎅쓰,2747,0,0,1,1,0.0%,20m
8016,3,MineLord,2746,1470,349,341,690,50.6%,11m
8016,3,asdfasdf,2746,1297,116,117,233,49.8%,6m
8016,2,[국가정보원]파인애플피자의신,2746,767,32,28,60,53.3%,51m
8016,2,Daehan,2746,262,8,8,16,50.0%,51m
8016,3,习近平,2746,120,5,2,7,71.4%,52m
8016,3,[Miku39]微風,2746,30,1,1,2,50.0%,52m
8016,3,MstKeaton,2746,0,1,4,5,20.0%,52m
8016,3,sovietanthem,2746,0,0,1,1,0.0%,52m
8024,3,하람이,2745,174,7,8,15,46.7%,52m
8024,3,Zergling,2745,122,5,5,10,50.0%,20m
8024,3,시덕,2745,0,1,1,2,50.0%,20m
8027,2,BHKIM,2744,1544,120,109,229,52.4%,51m
8027,3,[너의ol름은]캐릭터,2744,918,80,67,147,54.4%,21m
8027,3,한도대기중,2744,1270,68,51,119,57.1%,20m
8027,3,[싯가의유산]BlueDevil,2744,547,29,20,49,59.2%,20m
8027,1,Jester,2744,509,21,26,47,44.7%,50m
8027,1,Tom,2744,195,10,19,29,34.5%,50m
8027,3,HmmTroll,2744,90,2,4,6,33.3%,4m
8027,2,[눈꽃]팡퀴,2744,94,1,4,5,20.0%,51m
8027,2,BurgerKink,2744,30,1,7,8,12.5%,51m
8027,2,ssdk,2744,0,0,2,2,0.0%,26m
8027,3,짐레이너,2744,0,0,2,2,0.0%,20m
8038,2,김은구,2743,460,20,19,39,51.3%,51m
8038,3,부릉,2743,287,9,11,20,45.0%,52m
8038,2,짐네이년,2743,117,6,6,12,50.0%,26m
8038,1,[gggl]goodgame,2743,32,4,5,9,44.4%,48m
8038,2,[adidas]불나방,2743,0,3,3,6,50.0%,47m
8038,2,鄭珉制,2743,30,1,8,9,11.1%,47m
8038,3,Onetwo,2743,0,0,2,2,0.0%,21m
8045,2,[국방부사서병]NICKX,2742,383,17,14,31,54.8%,51m
8045,2,马润庆,2742,290,13,12,25,52.0%,47m
8045,3,SEBIN,2742,220,9,6,15,60.0%,46m
8045,3,洗脳日記,2742,147,5,4,9,55.6%,24m
8049,1,[너의ol름은]IIIIIIIIIIII,2741,330,15,16,31,48.4%,48m
8049,3,[IPE]Heides,2741,145,5,5,10,50.0%,24m
8049,3,DZR,2741,179,5,13,18,27.8%,52m
8049,1,Tossgirl,2741,127,3,2,5,60.0%,20m
8049,2,레이너특공대,2741,93,2,2,4,50.0%,18m
8049,3,스피디,2741,0,2,3,5,40.0%,52m
8049,2,[YCIM]TrAuMa,2741,88,1,4,5,20.0%,51m
8049,3,tksdkfl,2741,0,0,2,2,0.0%,52m
8057,2,한번만,2740,1483,138,132,270,51.1%,51m
8057,2,Joker,2740,666,23,27,50,46.0%,51m
8057,3,[이터널]HoSik,2740,88,4,1,5,80.0%,52m
8057,3,ino,2740,0,0,1,1,0.0%,20m
8061,2,piyapong,2739,986,59,55,114,51.8%,51m
8061,1,Dark,2739,1264,57,57,114,50.0%,50m
8061,3,lIlIlIlIlIlI,2739,30,1,2,3,33.3%,46m
8061,3,夜空,2739,0,1,4,5,20.0%,52m
8065,2,wing,2738,1224,50,43,93,53.8%,51m
8065,3,BaristaCafe,2738,480,16,19,35,45.7%,52m
8065,3,YellOw,2738,326,13,12,25,52.0%,52m
8065,3,[케살]dkffdkdkdkdk,2738,285,10,4,14,71.4%,52m
8065,3,지바냥,2738,114,4,3,7,57.1%,52m
8065,3,[습격자까마귀]오토모빌,2738,90,4,6,10,40.0%,52m
8065,3,WarComplete,2738,58,2,2,4,50.0%,20m
8065,3,olo,2738,0,0,1,1,0.0%,21m
8065,3,coorsllte,2738,0,0,2,2,0.0%,52m
8074,3,내이름은김오노,2737,66,6,7,13,46.2%,25m
8074,3,도도,2737,0,0,2,2,0.0%,52m
8074,2,DeadLift,2737,0,0,4,4,0.0%,51m
8077,2,용가리,2736,450,16,22,38,42.1%,51m
8077,2,UTAKATA,2736,140,5,9,14,35.7%,52m
8077,2,아이스초코,2736,124,4,8,12,33.3%,51m
8077,2,soso,2736,0,2,5,7,28.6%,47m
8081,1,타코소스,2735,1242,125,114,239,52.3%,50m
8081,2,OwO,2735,978,47,30,77,61.0%,51m
8081,3,FelixtheCat,2735,328,40,23,63,63.5%,20m
8081,3,동구밖과수원샷,2735,781,39,28,67,58.2%,52m
8081,2,Andy,2735,245,9,10,19,47.4%,51m
8081,3,[테란연맹]감염된심영,2735,147,4,1,5,80.0%,24m
8081,1,record,2735,0,3,3,6,50.0%,22m
8081,1,AroMatic,2735,0,2,4,6,33.3%,23m
8081,2,바코드,2735,0,0,6,6,0.0%,51m
8090,3,까리하노,2734,751,37,36,73,50.7%,20m
8090,3,[BRA]BRA,2734,468,24,19,43,55.8%,52m
8090,2,Saber,2734,499,21,15,36,58.3%,47m
8090,3,[중금속중독자]IJNayanami,2734,121,5,5,10,50.0%,24m
8090,3,wooniYa,2734,0,3,4,7,42.9%,25m
8090,3,연습이요,2734,0,1,1,2,50.0%,52m
8090,3,고려대학교,2734,96,1,1,2,50.0%,47m
8090,3,잘생긴외쿡인,2734,0,0,1,1,0.0%,46m
8098,3,msw,2733,717,40,30,70,57.1%,52m
8098,3,MadFlames,2733,338,16,11,27,59.3%,20m
8098,3,NHYC,2733,440,15,17,32,46.9%,20m
8098,1,천상천하,2733,48,5,9,14,35.7%,19m
8098,3,dontknowwhy,2733,30,1,2,3,33.3%,52m
8098,1,yeap,2733,0,0,2,2,0.0%,20m
8104,3,개스타,2732,144,5,6,11,45.5%,52m
8104,2,[DMN]口休口休,2732,90,3,8,11,27.3%,51m
8104,3,건설벌레준비완료,2732,58,2,2,4,50.0%,52m
8104,3,심심해크크크,2732,0,1,6,7,14.3%,24m
8108,2,빨갱이는소탕,2731,717,38,37,75,50.7%,51m
8108,2,Saul,2731,603,25,27,52,48.1%,52m
8108,3,jun,2731,60,7,3,10,70.0%,20m
8108,3,NOhandsPLAY,2731,121,5,5,10,50.0%,25m
8108,3,클럽다니는목사,2731,86,4,3,7,57.1%,21m
8108,3,ramaprawn,2731,0,3,4,7,42.9%,24m
8108,2,略懂,2731,46,3,6,9,33.3%,52m
8108,3,[트수갓]Mirai,2731,30,2,0,2,100.0%,52m
8108,1,llilililill,2731,0,1,0,1,100.0%,22m
8108,3,[중이병]나이트메어퓨리,2731,0,1,0,1,100.0%,47m
8108,3,죽여라,2731,0,1,1,2,50.0%,47m
8108,2,해와달,2731,0,1,2,3,33.3%,51m
8108,3,불혹,2731,0,0,1,1,0.0%,20m
8108,3,[S0fT]수수꺙,2731,0,0,1,1,0.0%,47m
8122,2,seandcomet,2730,426,16,19,35,45.7%,51m
8122,1,ace,2730,334,12,12,24,50.0%,19m
8122,3,[chiken]云玩毒奶,2730,225,8,0,8,100.0%,47m
8122,2,Tta,2730,215,8,13,21,38.1%,26m
8122,3,banhmi,2730,232,7,7,14,50.0%,24m
8122,3,Behemot,2730,146,6,6,12,50.0%,20m
8122,1,김카닉,2730,0,2,1,3,66.7%,23m
8122,3,kyz,2730,0,1,0,1,100.0%,24m
8122,3,BenAdam,2730,0,0,1,1,0.0%,20m
8131,2,AllenHippo,2729,1583,154,151,305,50.5%,51m
8131,1,LOWEL,2729,610,29,24,53,54.7%,48m
8131,3,dukez,2729,471,27,21,48,56.2%,52m
8131,2,[무한김준현]비누,2729,541,19,21,40,47.5%,47m
8131,3,[D3StaR]디스펜서,2729,438,17,9,26,65.4%,52m
8131,3,blau,2729,297,12,14,26,46.2%,20m
8131,2,필쏘굿,2729,157,11,13,24,45.8%,51m
8131,2,[달빛한모금]왕쪼꼬미,2729,128,3,1,4,75.0%,26m
8131,1,MaTa,2729,0,2,3,5,40.0%,23m
8131,1,ESPADA,2729,0,2,3,5,40.0%,23m
8131,3,[벽린이]화양연화,2729,0,0,1,1,0.0%,20m
8131,3,울트라용갸리,2729,0,0,1,1,0.0%,47m
8131,3,ejhvery,2729,0,0,2,2,0.0%,21m
8144,3,[MCDSTP]asd,2728,773,82,73,155,52.9%,52m
8144,3,WYC,2728,180,6,5,11,54.5%,52m
8144,2,SummerRaiiN,2728,92,4,8,12,33.3%,52m
8144,3,[천룡인]Black,2728,60,2,4,6,33.3%,52m
8144,3,PaperMan,2728,0,1,0,1,100.0%,47m
8144,3,리트리버,2728,0,1,0,1,100.0%,20m
8144,3,네이비씰,2728,30,1,1,2,50.0%,25m
8151,2,[한타왕]아아블랙,2727,672,26,24,50,52.0%,47m
8151,3,파란고래,2727,290,11,10,21,52.4%,20m
8151,3,TCY,2727,236,8,8,16,50.0%,20m
8151,2,DMK,2727,169,6,6,12,50.0%,51m
8151,3,영해서울친구,2727,60,3,1,4,75.0%,47m
8151,3,[즐겜스2]BlackStorm,2727,0,1,0,1,100.0%,20m
8151,1,charliezhu,2727,0,1,3,4,25.0%,24m
8151,3,구하라,2727,0,0,2,2,0.0%,52m
8159,1,Daniel,2726,298,12,18,30,40.0%,48m
8159,3,[OX우승자]Kimchiman,2726,271,11,6,17,64.7%,47m
8159,1,[MLFA]zindols,2726,97,3,3,6,50.0%,23m
8159,3,딸기스페셜,2726,58,2,2,4,50.0%,20m
8159,1,Unicode,2726,0,2,3,5,40.0%,23m
8159,3,내일의아침,2726,0,0,1,1,0.0%,52m
8165,1,TNT,2725,1265,46,52,98,46.9%,48m
8165,2,SURI,2725,753,39,33,72,54.2%,52m
8165,2,[ctrs]Naki,2725,537,22,16,38,57.9%,51m
8165,3,PACMAN,2725,393,14,15,29,48.3%,52m
8165,2,월아천충,2725,387,14,19,33,42.4%,51m
8165,2,fggfgfdd,2725,234,8,5,13,61.5%,26m
8165,3,KTastonish,2725,0,2,3,5,40.0%,52m
8165,1,YUHAJUN,2725,0,2,3,5,40.0%,22m
8165,3,HabKeineAngs,2725,0,1,1,2,50.0%,20m
8165,2,맥스임요환,2725,0,0,5,5,0.0%,47m
8175,3,향미씨,2724,1114,50,42,92,54.3%,52m
8175,2,차부장,2724,126,2,1,3,66.7%,26m
8175,3,[화영총]dark,2724,58,2,2,4,50.0%,20m
8175,3,[MET]화재시대피요령,2724,30,1,2,3,33.3%,20m
8179,2,[C64]PopCon,2723,1496,200,194,394,50.8%,47m
8179,1,sunshadow,2723,1552,147,144,291,50.5%,50m
8179,2,허동은,2723,1557,143,116,259,55.2%,47m
8179,2,shye,2723,1574,62,67,129,48.1%,52m
8179,3,burai,2723,153,6,6,12,50.0%,40m
8179,1,쪼니라벨,2723,48,3,4,7,42.9%,22m
8179,1,LucidDream,2723,0,1,0,1,100.0%,23m
8179,3,plpzero,2723,0,0,2,2,0.0%,20m
8187,1,청주그랜드,2722,1208,190,196,386,49.2%,50m
8187,3,[異界的檢察官]黑暗深邃幻想,2722,233,7,4,11,63.6%,52m
8187,3,[공허거주]뽀로로,2722,144,7,8,15,46.7%,20m
8187,1,TNSmile,2722,196,6,8,14,42.9%,19m
8187,3,이동헌,2722,184,6,9,15,40.0%,20m
8187,1,우주하마,2722,48,3,4,7,42.9%,22m
8187,3,젤나가맙소사,2722,58,2,3,5,40.0%,47m
8194,3,SarcasticMar,2721,1303,70,66,136,51.5%,52m
8194,3,까만도토리,2721,473,18,12,30,60.0%,52m
8194,3,쓸어담기주부,2721,343,13,8,21,61.9%,52m
8194,3,[비트]필라델피아산숭어,2721,144,6,4,10,60.0%,52m
8194,2,joe,2721,150,6,10,16,37.5%,51m
8194,2,onlytofind,2721,60,5,4,9,55.6%,51m
8194,2,김도미,2721,160,4,8,12,33.3%,51m
8194,3,천상의유희,2721,0,0,1,1,0.0%,52m
8202,3,KurobaKaito,2720,1539,258,267,525,49.1%,20m
8202,2,김천시청정물,2720,119,3,3,6,50.0%,47m
8202,3,Thor,2720,30,2,1,3,66.7%,52m
8202,2,하얀구름,2720,0,1,0,1,100.0%,18m
8202,3,박선우,2720,0,1,0,1,100.0%,52m
8202,3,starford,2720,0,0,2,2,0.0%,21m
8208,3,Lalatormenta,2719,374,17,7,24,70.8%,47m
8208,2,나누,2719,244,8,16,24,33.3%,51m
8208,3,ZWANGFCNG,2719,86,4,2,6,66.7%,20m
8208,3,[키야]국뽕에취하는구먼,2719,121,3,2,5,60.0%,24m
8208,1,긁적긁적,2719,97,2,0,2,100.0%,23m
8208,3,[暗影]SmallfishC,2719,0,0,2,2,0.0%,52m
8214,2,poohno,2718,1475,110,106,216,50.9%,47m
8214,1,leeleei,2718,593,23,25,48,47.9%,48m
8214,2,TechnicalKim,2718,222,8,15,23,34.8%,51m
8214,2,양심보호대,2718,44,2,4,6,33.3%,26m
8214,3,XPSam,2718,30,2,5,7,28.6%,24m
8219,1,알카바,2717,749,28,28,56,50.0%,50m
8219,2,chaplin,2717,88,6,7,13,46.2%,27m
8219,3,엄마안티카페,2717,120,2,1,3,66.7%,52m
8219,3,telmeaboutit,2717,0,0,1,1,0.0%,52m
8219,3,[벽짓고벽뚫고]사령관,2717,0,0,1,1,0.0%,52m
8219,3,codeblack,2717,0,0,2,2,0.0%,52m
8225,2,닝겐,2716,547,21,17,38,55.3%,51m
8225,1,威秤,2716,193,5,5,10,50.0%,22m
8225,2,[流星]極重巨砲弐式,2716,86,4,7,11,36.4%,51m
8225,1,koala,2716,134,3,7,10,30.0%,19m
8225,1,Alicorn,2716,154,3,9,12,25.0%,19m
8225,2,Aqua,2716,30,2,3,5,40.0%,47m
8225,3,pil,2716,0,2,3,5,40.0%,20m
8232,3,[고아쉐끼]EzTiMaTeD,2715,502,18,15,33,54.5%,52m
8232,3,Blank,2715,245,9,5,14,64.3%,20m
8232,3,[겨울방어]잘생긴남자,2715,214,7,3,10,70.0%,20m
8232,3,[신뢰]OneTopFlash,2715,58,5,4,9,55.6%,46m
8232,2,JAJI,2715,198,5,9,14,35.7%,51m
8232,3,게릴라버드,2715,92,3,3,6,50.0%,47m
8232,3,이강수천재님,2715,0,1,0,1,100.0%,52m
8239,2,퍼스트게임,2714,1502,126,110,236,53.4%,47m
8239,1,[DagmBa]AuraMonster,2714,870,31,37,68,45.6%,50m
8239,3,Song,2714,425,17,8,25,68.0%,46m
8239,1,騎豬南下,2714,434,13,27,40,32.5%,50m
8239,3,[공허거주]SONG,2714,139,7,3,10,70.0%,47m
8239,3,전라대통령김대중,2714,203,6,6,12,50.0%,47m
8239,3,spooky,2714,89,2,1,3,66.7%,47m
8239,3,Crad,2714,0,0,1,1,0.0%,52m
8239,3,ypt,2714,0,0,1,1,0.0%,47m
8248,2,[lavas]짱구와액션가면,2713,1093,183,184,367,49.9%,51m
8248,1,rlaqhrua,2713,1509,144,132,276,52.2%,48m
8248,2,제나,2713,892,33,34,67,49.3%,51m
8248,1,BarCode,2713,371,18,22,40,45.0%,48m
8248,2,잠이온다아아아,2713,328,14,16,30,46.7%,47m
8248,3,권흐긴,2713,286,12,12,24,50.0%,20m
8248,3,YelloW,2713,263,10,8,18,55.6%,52m
8248,3,NIZORAL,2713,284,10,13,23,43.5%,52m
8248,2,cjswoekd,2713,0,1,1,2,50.0%,47m
8257,2,skyphc,2712,770,31,23,54,57.4%,47m
8257,3,[녹즙의남자들]전쟁강림,2712,267,10,5,15,66.7%,46m
8257,3,행복한유령,2712,229,8,2,10,80.0%,20m
8257,3,Radical,2712,121,3,2,5,60.0%,25m
8257,3,小徐,2712,0,0,1,1,0.0%,52m
8262,2,grita,2711,758,31,30,61,50.8%,47m
8262,2,HBS,2711,612,21,29,50,42.0%,51m
8262,2,주섬주섬,2711,273,9,10,19,47.4%,26m
8262,3,[하수처리장]조홀스,2711,200,8,11,19,42.1%,20m
8262,3,bumper,2711,161,4,1,5,80.0%,20m
8262,1,Sergeant,2711,0,2,3,5,40.0%,22m
8262,1,트롤롤롤,2711,0,1,1,2,50.0%,23m
8262,3,각셀미,2711,0,1,2,3,33.3%,21m
8262,3,[군주]dksrhkdaj,2711,0,0,1,1,0.0%,52m
8271,2,[QFE]charles,2710,1419,108,130,238,45.4%,4m
8271,3,알록달록청포도,2710,288,11,14,25,44.0%,21m
8271,2,StevenPark,2710,0,3,3,6,50.0%,52m
8271,3,[曼特雷中隊]暗爪突擊隊,2710,0,0,3,3,0.0%,21m
8275,3,IIIIIlllIIIl,2709,1036,66,60,126,52.4%,47m
8275,2,[SheWar]Hyalu,2709,615,23,23,46,50.0%,47m
8275,2,김치제국,2709,515,21,19,40,52.5%,47m
8275,3,KFC,2709,97,2,0,2,100.0%,25m
8275,3,오리,2709,0,0,1,1,0.0%,47m
8280,1,MikeTroutS,2708,1512,337,339,676,49.9%,48m
8280,1,[CIM]최강에전사,2708,1294,123,114,237,51.9%,47m
8280,2,mnmnnnmm,2708,768,64,69,133,48.1%,51m
8280,3,JangSh,2708,457,18,28,46,39.1%,5m
8280,1,진정왕자,2708,163,7,8,15,46.7%,48m
8280,3,피파개망겜,2708,118,5,5,10,50.0%,20m
8280,2,초전동나이키,2708,0,3,3,6,50.0%,47m
8280,3,THEN,2708,0,1,0,1,100.0%,47m
8280,3,DRFUTTEREC,2708,0,0,1,1,0.0%,24m
8289,1,SKConcept,2707,995,40,41,81,49.4%,50m
8289,3,동부리,2707,616,24,22,46,52.2%,47m
8289,3,유리,2707,160,6,3,9,66.7%,47m
8289,3,[이교도]죠죠,2707,86,4,4,8,50.0%,20m
8289,3,Lowolfne,2707,114,3,4,7,42.9%,20m
8289,3,DFDF,2707,60,2,4,6,33.3%,47m
8295,1,JoyFul,2706,1528,161,161,322,50.0%,49m
8295,3,DeadlyPants,2706,1407,59,45,104,56.7%,20m
8295,2,冰燄戀痕,2706,616,46,38,84,54.8%,51m
8295,3,llllllllllll,2706,381,15,9,24,62.5%,46m
8295,3,고교스투러,2706,233,8,4,12,66.7%,20m
8300,3,Helmes,2705,378,16,16,32,50.0%,46m
8300,3,뚱이저그파워,2705,42,3,6,9,33.3%,24m
8300,3,soNg,2705,0,1,0,1,100.0%,47m
8300,1,[토끼1]llllllllllll,2705,0,1,4,5,20.0%,23m
8304,2,[ZZQFAN]Domennico,2704,1217,52,44,96,54.2%,52m
8304,1,Leo,2704,470,20,18,38,52.6%,48m
8304,3,악어,2704,237,10,31,41,24.4%,4m
8304,3,강하진,2704,200,8,9,17,47.1%,21m
8304,2,Taco,2704,180,7,10,17,41.2%,26m
8304,3,피루,2704,88,5,6,11,45.5%,47m
8304,1,lIIIlllIIll,2704,30,4,5,9,44.4%,48m
8304,3,체코인,2704,30,2,3,5,40.0%,21m
8304,1,rvn,2704,0,2,3,5,40.0%,23m
8304,3,[정치공학]corea,2704,58,2,6,8,25.0%,20m
8304,3,JeonMinChan,2704,0,1,0,1,100.0%,47m
8304,1,YangCheng,2704,45,1,1,2,50.0%,22m
8304,3,zxonyg,2704,0,0,1,1,0.0%,53m
8304,3,wwvwvwwvwvww,2704,0,0,2,2,0.0%,24m
8304,1,[VASCO]bye,2704,0,0,2,2,0.0%,23m
8319,3,kjongB,2703,624,24,16,40,60.0%,47m
8319,3,참가자미,2703,269,8,8,16,50.0%,20m
8319,3,솔구름,2703,144,4,1,5,80.0%,47m
8319,3,masoory,2703,120,2,1,3,66.7%,52m
8319,1,malse,2703,0,2,3,5,40.0%,22m
8319,3,[GKSTAR]겜방친구,2703,58,2,3,5,40.0%,20m
8319,1,UnseenRogue,2703,0,2,4,6,33.3%,23m
8319,3,프안,2703,0,0,2,2,0.0%,47m
8327,1,슬픈늑대,2702,1593,264,269,533,49.5%,47m
8327,2,llllllllllll,2702,1474,102,100,202,50.5%,51m
8327,2,bonju,2702,428,16,14,30,53.3%,52m
8327,2,Taeja,2702,181,6,9,15,40.0%,18m
8327,1,prollynot,2702,0,3,5,8,37.5%,48m
8327,3,Rhys,2702,0,1,0,1,100.0%,52m
8327,1,cbks,2702,48,1,1,2,50.0%,23m
8334,3,IlllllIIIIII,2701,1142,209,197,406,51.5%,47m
8334,3,아무거나,2701,0,2,3,5,40.0%,52m
8334,1,dydy,2701,0,2,3,5,40.0%,22m
8334,3,angu,2701,0,2,3,5,40.0%,47m
8338,2,MIN,2700,172,5,8,13,38.5%,51m
8338,2,gogoregor,2700,0,1,3,4,25.0%,26m
8338,3,사기꾼,2700,0,0,2,2,0.0%,20m
8341,3,reck,2699,1423,97,106,203,47.8%,6m
8341,3,[잉융치킹]SongPlay,2699,319,9,13,22,40.9%,52m
8341,2,발로하는연습중,2699,25,5,8,13,38.5%,52m
8341,1,[TalenT]vitaschao,2699,48,3,1,4,75.0%,23m
8341,1,jerry,2699,0,1,2,3,33.3%,23m
8341,3,Wesca,2699,0,0,1,1,0.0%,52m
8347,2,겐시로,2698,1521,198,190,388,51.0%,51m
8347,3,HELL,2698,1514,78,74,152,51.3%,52m
8347,1,authority,2698,201,24,26,50,48.0%,50m
8347,3,신발짝,2698,120,3,0,3,100.0%,21m
8347,3,뮠뮠,2698,60,3,3,6,50.0%,53m
8347,2,[양념치킨]군산국제공항,2698,40,2,2,4,50.0%,26m
8347,1,deutschland,2698,0,2,4,6,33.3%,22m
8354,2,홍익점문가,2697,1358,94,81,175,53.7%,51m
8354,3,llllllllllll,2697,177,6,2,8,75.0%,52m
8354,3,달콤한방구,2697,58,3,4,7,42.9%,20m
8354,2,하하하하,2697,119,3,7,10,30.0%,51m
8354,1,Magnolia,2697,0,2,3,5,40.0%,22m
8354,1,향기나는마을,2697,0,2,3,5,40.0%,22m
8354,3,James,2697,0,1,0,1,100.0%,20m
8354,3,samsung,2697,30,1,2,3,33.3%,20m
8362,2,그냥존잘,2696,989,41,36,77,53.2%,51m
8362,3,Yura,2696,288,10,7,17,58.8%,52m
8362,2,뮤류,2696,188,6,6,12,50.0%,47m
8362,3,어드레스,2696,127,5,4,9,55.6%,47m
8362,2,[GIS]負能量肥宅,2696,0,2,4,6,33.3%,47m
8362,3,라메몽,2696,30,1,5,6,16.7%,47m
8362,3,부드럽게해,2696,0,0,1,1,0.0%,21m
8369,3,Raintwogi,2695,1493,107,98,205,52.2%,47m
8369,2,Ropez,2695,243,9,11,20,45.0%,18m
8369,2,[스타놀이터]둘리,2695,178,8,8,16,50.0%,47m
8369,3,저정말못해요죄송,2695,205,7,7,14,50.0%,25m
8369,1,NIEL,2695,193,5,5,10,50.0%,23m
8369,3,jyh,2695,192,5,5,10,50.0%,25m
8369,3,Celeste,2695,147,3,2,5,60.0%,24m
8369,1,이브온라인하다옴,2695,48,3,4,7,42.9%,23m
8369,2,요필,2695,30,1,6,7,14.3%,52m
8369,3,莫梭,2695,0,0,2,2,0.0%,20m
8379,3,gnitro,2694,952,45,52,97,46.4%,20m
8379,3,마짱,2694,391,17,11,28,60.7%,47m
8379,2,혼란하다혼란해,2694,282,11,12,23,47.8%,47m
8379,2,호잇,2694,242,8,16,24,33.3%,51m
8379,1,Hanabi,2694,97,3,3,6,50.0%,18m
8379,2,Sulfite,2694,38,2,5,7,28.6%,25m
8379,1,전두환,2694,0,0,1,1,0.0%,22m
8379,3,나는전설이다,2694,0,0,2,2,0.0%,20m
8387,2,Worthy,2693,1500,229,207,436,52.5%,47m
8387,3,일대일갓겜,2693,1039,82,68,150,54.7%,20m
8387,2,[sc2mc]살뺄돈없어,2693,993,75,73,148,50.7%,51m
8387,1,[eSi]Zombie,2693,1087,52,58,110,47.3%,49m
8387,2,[GAL]ABeeE,2693,334,18,25,43,41.9%,51m
8387,3,max,2693,170,5,2,7,71.4%,20m
8387,1,루에볼,2693,0,2,4,6,33.3%,23m
8394,1,wony,2692,1574,483,499,982,49.2%,49m
8394,1,FirstLotus,2692,1157,53,56,109,48.6%,50m
8394,3,MissA,2692,383,15,12,27,55.6%,52m
8394,3,시발롬,2692,145,5,5,10,50.0%,24m
8394,3,[SCer]Specialist,2692,183,5,8,13,38.5%,53m
8394,3,shern,2692,90,4,4,8,50.0%,52m
8394,3,[000]競哥,2692,0,3,2,5,60.0%,52m
8394,3,[호랑이기운]쮸쮸빔,2692,58,2,3,5,40.0%,52m
8394,3,[林以楨超胖]panvincent,2692,0,1,0,1,100.0%,52m
8394,1,CoreMemory,2692,48,1,1,2,50.0%,23m
8394,2,葉貓子,2692,93,1,3,4,25.0%,27m
8394,1,terran,2692,0,1,9,10,10.0%,48m
8394,3,쿠워니,2692,0,0,3,3,0.0%,47m
8407,1,근초고왕,2691,1582,426,427,853,49.9%,49m
8407,3,Matra,2691,476,21,19,40,52.5%,52m
8407,2,흑선풍,2691,531,19,23,42,45.2%,52m
8407,3,hanwoolive,2691,508,17,14,31,54.8%,52m
8407,3,탱크맨,2691,315,10,18,28,35.7%,4m
8407,1,지지진흐흐호,2691,74,6,8,14,42.9%,48m
8407,3,Solindar,2691,60,3,3,6,50.0%,47m
8407,1,OnGo,2691,0,2,4,6,33.3%,24m
8407,3,쫑식이,2691,0,1,1,2,50.0%,25m
8407,3,장그래,2691,0,1,4,5,20.0%,47m
8407,1,즈그셍,2691,0,0,1,1,0.0%,22m
8418,2,IIIIIIIIIIII,2690,537,58,58,116,50.0%,51m
8418,3,하이닉스사원,2690,1105,46,35,81,56.8%,47m
8418,2,Shinewarrior,2690,906,45,45,90,50.0%,51m
8418,3,風林火山,2690,236,8,12,20,40.0%,52m
8418,2,JINWoo,2690,212,7,11,18,38.9%,47m
8418,2,Erebea,2690,152,6,8,14,42.9%,51m
8418,3,홍찬,2690,118,4,4,8,50.0%,47m
8418,3,[시럽]바코드는벌레,2690,0,1,1,2,50.0%,20m
8418,2,유정현,2690,0,1,2,3,33.3%,47m
8418,2,Ashen,2690,0,1,8,9,11.1%,51m
8418,3,노인정치약도둑,2690,0,0,1,1,0.0%,52m
8429,2,deadgame,2689,946,98,97,195,50.3%,51m
8429,2,[오마이걸승희]흑사선,2689,304,11,14,25,44.0%,51m
8429,3,Shootingstar,2689,264,9,13,22,40.9%,52m
8429,2,GloryG,2689,183,6,11,17,35.3%,18m
8429,3,Mango,2689,38,5,4,9,55.6%,25m
8429,1,사커겐지,2689,97,3,3,6,50.0%,23m
8429,3,[LVARW]海未,2689,58,3,4,7,42.9%,20m
8429,1,그래나이호윤이다,2689,0,1,3,4,25.0%,23m
8429,3,xelnaga,2689,0,0,2,2,0.0%,20m
8438,3,VVVVVVVVVVVV,2688,522,33,27,60,55.0%,20m
8438,2,김빠진소맥,2688,307,12,9,21,57.1%,51m
8438,3,gdflkmefgknm,2688,282,10,7,17,58.8%,53m
8438,3,홍진호,2688,246,7,7,14,50.0%,20m
8438,3,KKD,2688,14,3,6,9,33.3%,21m
8443,3,smalllake,2687,448,20,16,36,55.6%,20m
8443,3,ErrorGG,2687,0,0,1,1,0.0%,47m
8445,3,임오플토,2686,1090,45,37,82,54.9%,47m
8445,3,양칡스,2686,212,10,15,25,40.0%,7m
8445,3,rekwonvi,2686,60,4,5,9,44.4%,47m
8445,3,irOn,2686,58,3,2,5,60.0%,20m
8445,3,[바닷속이야기]테란버프좀,2686,0,1,0,1,100.0%,52m
8445,3,Turning,2686,0,0,1,1,0.0%,52m
8445,2,철구형,2686,0,0,12,12,0.0%,51m
8452,3,앙민재띠,2685,831,36,30,66,54.5%,47m
8452,3,Soso,2685,659,35,18,53,66.0%,52m
8452,3,아이스,2685,795,32,37,69,46.4%,5m
8452,3,Birdwoo,2685,266,8,8,16,50.0%,52m
8452,3,제라툴,2685,290,8,25,33,24.2%,3m
8452,3,[F5]YangWenLi,2685,0,3,3,6,50.0%,47m
8452,3,ZsuShilKa,2685,143,3,3,6,50.0%,52m
8452,1,루피,2685,0,3,4,7,42.9%,23m
8452,3,스타크래프트,2685,0,2,3,5,40.0%,47m
8452,1,문공자,2685,0,0,1,1,0.0%,22m
8462,3,notByuN,2684,798,50,48,98,51.0%,20m
8462,3,행동대장정태풍,2684,0,1,0,1,100.0%,52m
8462,3,야구왕김법규,2684,0,1,2,3,33.3%,47m
8462,3,MASTER,2684,0,0,1,1,0.0%,25m
8466,3,IIIIIIIIII,2683,207,10,6,16,62.5%,52m
8466,3,[강철]근사한바지,2683,180,6,2,8,75.0%,47m
8466,3,여울비,2683,118,3,0,3,100.0%,21m
8466,3,Konichan,2683,58,2,5,7,28.6%,20m
8466,3,하얀곰,2683,30,1,3,4,25.0%,52m
8471,1,앙빛삼,2682,906,89,85,174,51.1%,49m
8471,2,스피릿,2682,1203,81,71,152,53.3%,47m
8471,3,주앤주,2682,94,6,7,13,46.2%,25m
8471,2,DURUDURU,2682,136,5,13,18,27.8%,26m
8471,3,Ipswich,2682,58,2,4,6,33.3%,52m
8471,1,lol,2682,0,1,1,2,50.0%,23m
8471,3,아구,2682,0,1,3,4,25.0%,47m
8471,3,흑돼지삼겹살,2682,0,0,1,1,0.0%,52m
8479,1,무고끼,2681,524,20,24,44,45.5%,48m
8479,3,Beyou,2681,213,8,6,14,57.1%,47m
8479,3,jaesung,2681,0,0,1,1,0.0%,47m
8479,3,[VanDH]Master,2681,0,0,1,1,0.0%,20m
8483,3,[광주]용꼬리아나,2680,1525,91,77,168,54.2%,47m
8483,1,KaRma,2680,288,31,35,66,47.0%,50m
8485,2,응기잇얍얍찍,2679,862,32,35,67,47.8%,51m
8485,2,kire,2679,238,19,17,36,52.8%,51m
8485,3,noche,2679,166,4,3,7,57.1%,52m
8485,3,[베스핀가스]peterpark,2679,88,3,5,8,37.5%,52m
8485,3,재무,2679,120,2,2,4,50.0%,20m
8485,3,[KBG]아자,2679,0,1,1,2,50.0%,25m
8485,3,[자우l나라]사이타마,2679,0,0,1,1,0.0%,25m
8485,3,곰두리,2679,0,0,2,2,0.0%,53m
8493,3,가나다라마바사아,2678,624,28,24,52,53.8%,20m
8493,1,DonkeyBandit,2678,48,2,5,7,28.6%,23m
8493,1,[진잠]전멸한,2678,0,1,0,1,100.0%,27m
8493,3,[KRisOK]WEEBRATOR,2678,30,1,3,4,25.0%,47m
8497,2,BIGCHEeZY,2677,144,34,26,60,56.7%,51m
8497,3,llllllllllll,2677,687,30,18,48,62.5%,47m
8497,3,똥오줌범벅,2677,572,20,20,40,50.0%,20m
8497,3,이반시아,2677,347,14,6,20,70.0%,53m
8497,3,꼬물징어,2677,270,10,10,20,50.0%,21m
8497,2,뚜비두밥,2677,263,8,11,19,42.1%,26m
8497,2,llllllllllll,2677,30,4,5,9,44.4%,47m
8497,2,MataLife,2677,0,1,2,3,33.3%,47m
8497,1,에거,2677,0,0,1,1,0.0%,20m
8497,3,GBM,2677,0,0,3,3,0.0%,47m
8507,3,lllllll,2676,945,125,129,254,49.2%,21m
8507,3,뭬이플수토뤼,2676,263,9,6,15,60.0%,52m
8507,3,이태리수건,2676,226,9,10,19,47.4%,52m
8507,3,DreamTT,2676,185,7,7,14,50.0%,47m
8507,1,도라에몽라이트훅,2676,168,4,4,8,50.0%,23m
8507,3,rusinel,2676,96,2,1,3,66.7%,47m
8507,1,pokey,2676,0,1,2,3,33.3%,23m
8507,3,leeky,2676,0,1,5,6,16.7%,24m
8507,3,lllllllllll,2676,0,0,2,2,0.0%,52m
8507,3,IllIIIIllll,2676,0,0,4,4,0.0%,52m
8517,1,erfew,2675,1069,48,47,95,50.5%,18m
8517,2,[무작]자유의날개,2675,912,31,40,71,43.7%,52m
8517,3,sunset,2675,702,26,26,52,50.0%,47m
8517,3,불곰,2675,137,6,4,10,60.0%,47m
8517,3,LenienT,2675,30,2,3,5,40.0%,20m
8517,1,[뚜삐뚜빠]박태현,2675,0,1,0,1,100.0%,18m
8517,1,이씨,2675,0,1,0,1,100.0%,19m
8524,3,jim,2674,970,66,55,121,54.5%,52m
8524,1,브루드워사장,2674,253,11,13,24,45.8%,19m
8524,3,CopterUseles,2674,86,4,5,9,44.4%,52m
8524,3,Slayers,2674,116,2,3,5,40.0%,47m
8524,3,SIRIUS,2674,0,1,1,2,50.0%,47m
8524,3,인간태풍,2674,0,1,2,3,33.3%,52m
8524,1,[易亨集团]邵东寅,2674,0,0,1,1,0.0%,23m
8524,3,나사렛예수,2674,0,0,1,1,0.0%,24m
8532,3,MBB,2673,1283,78,63,141,55.3%,52m
8532,3,숏다리해병,2673,141,3,3,6,50.0%,53m
8532,1,powerjp,2673,0,2,3,5,40.0%,18m
8532,1,FPSCD,2673,0,1,0,1,100.0%,18m
8532,3,Lockon,2673,30,1,5,6,16.7%,53m
8532,3,[TST]뺑덕아범,2673,0,0,1,1,0.0%,25m
8538,2,orrochemalo,2672,312,11,19,30,36.7%,51m
8538,3,Panda,2672,118,2,2,4,50.0%,21m
8538,1,uduyjhj,2672,0,2,2,4,50.0%,23m
8538,1,[러브라이브]KatoMegumi,2672,0,2,3,5,40.0%,47m
8538,1,까치,2672,96,2,6,8,25.0%,23m
8538,1,BBB,2672,46,1,1,2,50.0%,18m
8538,1,wesley,2672,0,0,1,1,0.0%,19m
8538,1,김선수,2672,0,0,1,1,0.0%,18m
8546,2,달감독,2671,1458,225,216,441,51.0%,47m
8546,2,lllllllll,2671,1515,70,76,146,47.9%,47m
8546,1,Spike,2671,900,48,53,101,47.5%,50m
8546,1,짐레이너,2671,162,4,3,7,57.1%,20m
8546,1,반다크홈,2671,128,3,3,6,50.0%,18m
8546,3,KDH,2671,0,0,2,2,0.0%,52m
8552,2,땡칠이,2670,786,30,32,62,48.4%,47m
8552,3,새로캐릭터,2670,706,25,28,53,47.2%,52m
8552,2,[대구]어린이정식,2670,295,11,9,20,55.0%,18m
8552,3,[最後生還者]凱拉克,2670,148,4,3,7,57.1%,52m
8552,3,[친클]GLHF,2670,118,4,9,13,30.8%,20m
8552,1,忘雨天,2670,0,2,3,5,40.0%,46m
8552,3,클팡,2670,0,1,3,4,25.0%,52m
8559,3,세이진,2669,415,15,18,33,45.5%,20m
8559,3,병우,2669,298,11,12,23,47.8%,52m
8559,1,waveLength,2669,144,5,5,10,50.0%,23m
8559,3,engon,2669,30,4,9,13,30.8%,4m
8559,1,승천하라집값이여,2669,0,2,3,5,40.0%,46m
8559,3,[LGStar]styleman,2669,30,1,3,4,25.0%,52m
8559,3,돌돌이,2669,30,1,3,4,25.0%,53m
8559,3,[해병대]개구리,2669,0,0,1,1,0.0%,24m
8567,2,doriven,2668,1168,98,90,188,52.1%,51m
8567,3,스페셜라이즈,2668,422,73,70,143,51.0%,52m
8567,2,deinhard,2668,948,35,37,72,48.6%,51m
8567,3,마왕,2668,298,12,12,24,50.0%,47m
8567,3,凹凹凸凸的光,2668,180,7,6,13,53.8%,52m
8567,3,Destroy,2668,145,5,5,10,50.0%,25m
8567,1,SeoRHsLaBand,2668,46,3,3,6,50.0%,46m
8567,3,[ClSt]belloline,2668,30,2,2,4,50.0%,52m
8567,1,mamany,2668,0,0,1,1,0.0%,19m
8567,3,레이,2668,0,0,3,3,0.0%,21m
8567,3,changjoon,2668,0,0,6,6,0.0%,52m
8578,2,ellea,2667,248,9,15,24,37.5%,51m
8578,1,스투는죽었다,2667,166,7,33,40,17.5%,9m
8578,1,Gambar,2667,165,5,4,9,55.6%,46m
8578,3,DDDDD,2667,197,5,6,11,45.5%,52m
8578,3,차사장,2667,92,3,7,10,30.0%,20m
8583,3,한콩고,2666,977,41,35,76,53.9%,47m
8583,3,붉은감자,2666,768,29,31,60,48.3%,20m
8583,3,악어와악어새,2666,560,21,19,40,52.5%,21m
8583,2,혁이아빠,2666,380,14,20,34,41.2%,52m
8583,3,llllllllllll,2666,136,6,7,13,46.2%,52m
8583,1,DragonOfSea,2666,0,2,3,5,40.0%,22m
8589,3,떠돌이기사,2665,1512,423,424,847,49.9%,8m
8589,3,지리산,2665,1361,247,235,482,51.2%,21m
8589,1,치느님,2665,676,24,35,59,40.7%,48m
8589,3,Ellen,2665,167,5,6,11,45.5%,25m
8589,3,달걀,2665,0,1,0,1,100.0%,24m
8594,1,파이팅한국,2664,1473,116,113,229,50.7%,48m
8594,3,SoulEater,2664,260,11,10,21,52.4%,52m
8594,3,사실나는인싸였다,2664,145,5,6,11,45.5%,25m
8594,3,월탄,2664,30,4,4,8,50.0%,52m
8594,2,어라,2664,95,4,7,11,36.4%,18m
8594,1,[해피투게더]늅뉴비,2664,0,1,0,1,100.0%,27m
8594,1,llllllllllll,2664,38,1,1,2,50.0%,18m
8594,2,준현,2664,0,1,2,3,33.3%,47m
8602,2,[星辰]North,2663,1473,153,149,302,50.7%,51m
8602,3,awesomeSCV,2663,520,27,27,54,50.0%,52m
8602,3,skycreator,2663,517,26,15,41,63.4%,47m
8602,1,하악하악,2663,447,16,21,37,43.2%,48m
8602,1,simingz,2663,0,1,1,2,50.0%,23m
8607,2,레이너오른팔,2662,1529,114,113,227,50.2%,51m
8607,3,jayar,2662,1124,59,70,129,45.7%,52m
8607,3,GrimReaper,2662,703,29,18,47,61.7%,52m
8607,1,야시리,2662,193,6,2,8,75.0%,23m
8607,3,미스터츄,2662,70,5,9,14,35.7%,52m
8607,3,komand,2662,39,2,4,6,33.3%,40m
8613,1,funkydi,2661,1465,100,110,210,47.6%,50m
8613,2,汪汪隊隊長萊德,2661,1566,90,92,182,49.5%,51m
8613,3,암흑별,2661,876,34,29,63,54.0%,53m
8613,3,최나얼,2661,578,21,21,42,50.0%,52m
8613,1,GoAsRuY,2661,145,7,19,26,26.9%,50m
8613,1,Galca,2661,97,2,3,5,40.0%,23m
8613,3,토르,2661,95,1,2,3,33.3%,47m
8613,1,둔타형,2661,0,1,9,10,10.0%,19m
8613,3,설기마루,2661,0,0,2,2,0.0%,53m
8622,2,中二的狂襲,2660,1329,94,98,192,49.0%,51m
8622,2,TheCross,2660,1309,54,48,102,52.9%,52m
8622,3,Fauwer,2660,624,28,23,51,54.9%,21m
8622,2,iwillkillyou,2660,642,25,27,52,48.1%,51m
8622,1,tlqkfwhwr,2660,667,23,23,46,50.0%,20m
8622,2,TYTY,2660,274,9,18,27,33.3%,52m
8622,3,드드득,2660,186,6,12,18,33.3%,52m
8622,2,Wynan,2660,30,3,6,9,33.3%,52m
8622,1,messi,2660,42,2,1,3,66.7%,46m
8622,1,[행복토끼]기승전기승위,2660,0,1,0,1,100.0%,22m
8622,1,[五漢廢言]蘿莉控大將軍,2660,42,1,2,3,33.3%,18m
8622,1,Octa,2660,0,0,1,1,0.0%,18m
8634,3,[NNMMN]艾倫,2659,947,35,36,71,49.3%,20m
8634,3,ShouHeng,2659,545,20,15,35,57.1%,53m
8634,3,미니미니,2659,514,19,16,35,54.3%,52m
8634,3,달그림자,2659,154,7,8,15,46.7%,47m
8638,3,요망한년,2658,1083,66,59,125,52.8%,20m
8638,3,Orion,2658,294,12,5,17,70.6%,52m
8638,3,kdh,2658,120,5,7,12,41.7%,21m
8638,1,쑝쑝,2658,46,2,2,4,50.0%,19m
8638,1,BoRinG,2658,0,2,3,5,40.0%,23m
8643,1,scientist,2657,798,85,79,164,51.8%,49m
8643,3,BattleBoy,2657,675,79,73,152,52.0%,21m
8643,3,ixigua,2657,1302,70,72,142,49.3%,21m
8643,2,thence,2657,784,29,36,65,44.6%,51m
8643,1,Kevin,2657,140,5,2,7,71.4%,46m
8643,1,kfc,2657,0,2,3,5,40.0%,46m
8643,2,[원피스]kaisarMvP,2657,32,1,10,11,9.1%,51m
8643,2,[TalenT]never,2657,0,0,1,1,0.0%,26m
8651,3,제라툴,2656,1068,117,111,228,51.3%,52m
8651,1,DKREAD,2656,1350,50,62,112,44.6%,50m
8651,1,와똘이,2656,42,2,1,3,66.7%,19m
8651,1,STWM,2656,0,2,3,5,40.0%,23m
8655,1,IIIIlIIIIIll,2655,1586,884,889,1773,49.9%,9m
8655,2,[국가정보원]kldsjflkjaw,2655,1265,102,112,214,47.7%,51m
8655,3,Amaterasu,2655,946,36,38,74,48.6%,21m
8655,3,벨리,2655,260,7,10,17,41.2%,47m
8655,3,[PM2o5]士官長,2655,131,3,2,5,60.0%,52m
8655,3,sirius,2655,30,1,8,9,11.1%,52m
8655,1,키오,2655,0,0,1,1,0.0%,20m
8655,3,테란토스개사기,2655,0,0,3,3,0.0%,20m
8663,1,나못함봐주셈,2654,1847,105,85,190,55.3%,20m
8663,3,꽃흔들유라흔들,2654,382,15,16,31,48.4%,52m
8663,2,sdfhksjfd,2654,342,12,21,33,36.4%,52m
8663,3,점순,2654,114,5,4,9,55.6%,21m
8663,1,송철균,2654,0,3,3,6,50.0%,23m
8663,3,[習近平]lIlIIlIIlIIl,2654,58,3,4,7,42.9%,47m
8663,1,CowOnAPlane,2654,0,1,0,1,100.0%,23m
8663,3,와우하다접속,2654,0,1,1,2,50.0%,52m
8663,3,[中國病毒]一哭二鬧三上悠亞,2654,0,0,1,1,0.0%,40m
8672,3,[xTMDx]rexisbast,2653,510,19,16,35,54.3%,20m
8672,2,상어잡이성하,2653,488,18,22,40,45.0%,51m
8672,1,멋쟁이,2653,0,0,1,1,0.0%,19m
8672,1,빡그리거,2653,0,0,1,1,0.0%,46m
8672,3,lyjuven,2653,0,0,3,3,0.0%,47m
8677,3,물렁흑두부,2652,224,9,9,18,50.0%,25m
8677,1,박웅기,2652,220,5,4,9,55.6%,46m
8677,1,Nooblet,2652,46,2,4,6,33.3%,46m
8680,3,iptime,2651,234,7,9,16,43.8%,52m
8680,1,[SShark]SilenceV,2651,34,2,0,2,100.0%,19m
8680,1,JIN,2651,0,0,1,1,0.0%,23m
8680,2,[별똥별]둘리,2651,0,0,1,1,0.0%,27m
8684,1,ChoJJaYo,2650,654,23,8,31,74.2%,46m
8684,3,하앤미,2650,0,3,3,6,50.0%,52m
8684,1,gohyunsala,2650,97,2,1,3,66.7%,46m
8684,1,BSil,2650,48,2,6,8,25.0%,23m
8684,1,[JST]PakKim,2650,0,1,4,5,20.0%,24m
8684,3,파즈,2650,0,0,4,4,0.0%,52m
8690,2,[뾳읂쨤뿅]꾴쁇빣뚪,2649,1274,100,98,198,50.5%,51m
8690,3,JXXN,2649,285,10,13,23,43.5%,47m
8690,2,고라파터,2649,182,9,10,19,47.4%,51m
8690,1,abc,2649,98,6,9,15,40.0%,48m
8690,3,seaman,2649,90,4,4,8,50.0%,47m
8690,1,Holy,2649,164,4,5,9,44.4%,19m
8690,3,망게임,2649,122,4,7,11,36.4%,25m
8690,2,llllllllllll,2649,88,2,2,4,50.0%,47m
8690,1,Player,2649,0,2,4,6,33.3%,22m
8690,1,[中國病毒]我很弱不要欺負我,2649,44,1,2,3,33.3%,19m
8700,3,Yorih,2648,1394,65,64,129,50.4%,20m
8700,3,Raynor,2648,276,22,15,37,59.5%,21m
8700,3,[해양경비대]왕개구리,2648,414,17,17,34,50.0%,21m
8700,3,레벨이랑데이지랑,2648,339,11,14,25,44.0%,52m
8700,3,김태현,2648,128,3,8,11,27.3%,21m
8700,1,[性關係]호서대,2648,0,2,1,3,66.7%,46m
8700,1,[아리다이스키]supercell,2648,0,2,1,3,66.7%,23m
8700,1,DabulS,2648,44,1,1,2,50.0%,20m
8700,3,maxwell,2648,30,1,6,7,14.3%,21m
8709,3,IIIIIIIIIIII,2647,703,33,21,54,61.1%,47m
8709,2,스타가뭔데십덕아,2647,278,11,12,23,47.8%,47m
8709,2,LunaTicDream,2647,318,11,19,30,36.7%,51m
8709,1,[SQBA]내맘대로,2647,341,10,9,19,52.6%,46m
8709,3,샌푸란시스코,2647,240,10,9,19,52.6%,47m
8709,2,이것은태양을높게,2647,272,9,17,26,34.6%,51m
8709,1,큰털보,2647,300,8,7,15,53.3%,46m
8709,1,[싯가의유산]앤타로아둔,2647,0,2,2,4,50.0%,24m
8709,1,하정우,2647,143,2,3,5,40.0%,19m
8718,3,로데오,2646,1534,81,82,163,49.7%,52m
8718,2,비니루,2646,871,79,74,153,51.6%,51m
8718,3,쥬지스님,2646,1174,55,37,92,59.8%,52m
8718,3,답답하군,2646,839,38,36,74,51.4%,52m
8718,2,SOWINYA,2646,210,9,8,17,52.9%,47m
8718,3,댄나빨라,2646,142,5,5,10,50.0%,21m
8718,1,[FSHVM]Kukulza,2646,0,1,0,1,100.0%,18m
8718,3,천경이,2646,0,1,1,2,50.0%,47m
8718,1,천하스타,2646,0,0,5,5,0.0%,46m
8727,1,Mentat,2645,200,6,4,10,60.0%,20m
8727,3,[SC2HK]好七的戰士,2645,164,4,3,7,57.1%,20m
8727,3,MagicKim,2645,46,3,7,10,30.0%,52m
8727,1,noobless,2645,0,1,0,1,100.0%,19m
8727,1,[Lost21]DelicateIX,2645,0,1,1,2,50.0%,46m
8727,1,[xXYXx]caesar,2645,44,1,1,2,50.0%,46m
8727,3,BossTSENG,2645,0,0,1,1,0.0%,40m
8734,3,HiddenPants,2644,378,15,11,26,57.7%,53m
8734,3,요다닷,2644,266,8,8,16,50.0%,47m
8734,3,나는스타다,2644,200,7,9,16,43.8%,52m
8734,2,hackertitan,2644,142,4,4,8,50.0%,18m
8734,2,[sc2mc]CaTre,2644,30,4,6,10,40.0%,51m
8734,3,한방에주님곁으로,2644,0,3,5,8,37.5%,25m
8740,1,success,2643,1832,86,68,154,55.8%,47m
8740,3,mrkim,2643,239,7,12,19,36.8%,20m
8740,3,llllllllllll,2643,118,3,2,5,60.0%,52m
8740,1,HumanEb,2643,96,3,3,6,50.0%,24m
8740,1,백마탄왕자님,2643,84,2,3,5,40.0%,47m
8745,3,조무래기,2642,788,30,31,61,49.2%,47m
8745,3,jung,2642,362,13,17,30,43.3%,20m
8745,3,mblkms,2642,265,9,10,19,47.4%,53m
8745,3,newbie,2642,254,9,12,21,42.9%,52m
8745,1,저글링,2642,271,8,8,16,50.0%,19m
8745,3,우등버스,2642,226,7,5,12,58.3%,47m
8745,3,[CHZ]재성합니다,2642,123,3,4,7,42.9%,25m
8745,3,Creepuxx,2642,96,3,4,7,42.9%,47m
8745,1,스타크래프트,2642,90,2,1,3,66.7%,19m
8745,3,수박피클,2642,97,2,5,7,28.6%,24m
8745,1,elite,2642,0,0,1,1,0.0%,46m
8745,1,zzzz,2642,0,0,1,1,0.0%,18m
8757,2,진삐진스,2641,1356,172,183,355,48.5%,52m
8757,3,Rezero,2641,1336,96,99,195,49.2%,52m
8757,3,aaaaaaaaaaaa,2641,471,19,21,40,47.5%,52m
8757,3,generatexaU,2641,339,13,17,30,43.3%,53m
8757,1,herO,2641,352,12,13,25,48.0%,48m
8757,1,TYTY,2641,227,7,4,11,63.6%,19m
8757,3,SteeveJK,2641,97,5,4,9,55.6%,25m
8757,3,JunJa,2641,0,1,2,3,33.3%,24m
8765,2,[NO1]undeadlongja,2640,1482,244,239,483,50.5%,52m
8765,2,SRGQmangza,2640,492,21,21,42,50.0%,47m
8765,3,바이킹성애자,2640,445,17,15,32,53.1%,52m
8765,3,品客小鬍子,2640,178,7,9,16,43.8%,21m
8765,1,아뿔싸,2640,40,3,4,7,42.9%,20m
8765,1,[애니멀킹덤]vviw,2640,0,2,4,6,33.3%,46m
8765,1,부엉이,2640,0,1,4,5,20.0%,19m
8765,3,[지는게꿈이다]지고싶다,2640,0,0,3,3,0.0%,47m
8773,2,짱구찬팅,2639,1513,112,109,221,50.7%,51m
8773,2,JLF,2639,94,3,14,17,17.6%,51m
8773,1,대한이,2639,0,0,1,1,0.0%,46m
8773,1,Black,2639,0,0,7,7,0.0%,24m
8777,3,stephan,2638,871,40,41,81,49.4%,21m
8777,1,CUZUMP,2638,478,15,8,23,65.2%,20m
8777,1,도로병장님,2638,321,12,14,26,46.2%,20m
8777,1,쿠크다스,2638,94,2,1,3,66.7%,19m
8777,1,[공포는환상]player,2638,76,2,4,6,33.3%,20m
8777,1,llllllllllll,2638,0,1,0,1,100.0%,20m
8777,3,SpicaBluenot,2638,0,0,1,1,0.0%,25m
8784,3,껍똘이아빠,2637,883,65,67,132,49.2%,52m
8784,1,[국가정보원]IIIIIIIIII,2637,202,5,6,11,45.5%,19m
8784,2,TerranL,2637,145,4,5,9,44.4%,51m
8784,2,zxzxko,2637,30,4,5,9,44.4%,47m
8784,3,noeul,2637,90,4,6,10,40.0%,53m
8789,2,Leviathan,2636,1471,95,103,198,48.0%,51m
8789,3,darkduck,2636,518,21,21,42,50.0%,47m
8789,3,스타첨,2636,388,13,17,30,43.3%,52m
8789,2,[할매순대국밥]솔랭광전사,2636,319,11,10,21,52.4%,27m
8789,3,블러드테일,2636,206,8,9,17,47.1%,52m
8789,2,[보돌]LucidDream,2636,157,5,2,7,71.4%,26m
8789,3,RoachKing,2636,58,3,3,6,50.0%,52m
8789,1,SKT,2636,0,1,1,2,50.0%,24m
8789,1,토니지혜,2636,0,0,1,1,0.0%,19m
8798,2,我真的不會玩人類,2635,1297,319,310,629,50.7%,51m
8798,2,담덕,2635,1553,142,145,287,49.5%,47m
8798,1,노바,2635,84,3,1,4,75.0%,18m
8798,1,[즐겜요]샤인넘버원,2635,0,1,0,1,100.0%,19m
8802,3,밀키스,2634,1272,61,53,114,53.5%,53m
8802,2,김이준,2634,939,38,40,78,48.7%,51m
8802,1,Loging,2634,675,21,22,43,48.8%,20m
8802,2,Clare,2634,451,15,21,36,41.7%,52m
8802,3,bluedayjjj,2634,248,11,8,19,57.9%,20m
8802,1,Aselpis,2634,105,4,5,9,44.4%,46m
8802,1,TixXianZhen,2634,0,3,3,6,50.0%,23m
8802,1,Soraumraker,2634,0,1,1,2,50.0%,19m
8802,1,망가,2634,0,0,2,2,0.0%,46m
8811,1,박아라,2633,188,6,2,8,75.0%,20m
8811,1,llllllllllll,2633,0,2,3,5,40.0%,46m
8811,1,Wordword,2633,42,1,1,2,50.0%,20m
8811,3,BOOMBERMAN,2633,95,1,2,3,33.3%,47m
8811,1,독산동마귀,2633,0,0,2,2,0.0%,19m
8816,2,Debak,2632,1186,49,54,103,47.6%,52m
8816,3,공백기,2632,626,25,20,45,55.6%,21m
8816,3,[트위치리피아]리피아,2632,509,22,16,38,57.9%,47m
8816,1,우아하게,2632,144,6,7,13,46.2%,22m
8816,1,아몰랑,2632,0,3,4,7,42.9%,23m
8816,1,병앙이,2632,0,0,1,1,0.0%,19m
8816,3,我是新手,2632,0,0,3,3,0.0%,53m
8823,1,LowSaturaion,2631,1833,144,146,290,49.7%,18m
8823,3,건축설계,2631,1525,66,61,127,52.0%,20m
8823,2,문흥문흥동,2631,220,7,10,17,41.2%,51m
8823,1,woowa,2631,42,1,1,2,50.0%,20m
8823,3,rkaskan,2631,20,1,6,7,14.3%,21m
8823,3,[무적함대]saturn,2631,0,0,5,5,0.0%,52m
8829,3,瑒瑒,2630,1454,82,77,159,51.6%,53m
8829,3,pisknx,2630,233,7,11,18,38.9%,47m
8829,1,Arcane,2630,186,6,2,8,75.0%,19m
8829,1,lllIIIllIl,2630,194,5,3,8,62.5%,46m
8829,3,DOOM,2630,50,2,6,8,25.0%,21m
8834,2,자다깬오버로드,2629,908,36,39,75,48.0%,47m
8834,2,BWS,2629,418,15,44,59,25.4%,1m
8834,1,[래더납치범]battleboat,2629,180,4,7,11,36.4%,27m
8834,3,송현아,2629,159,4,7,11,36.4%,52m
8834,3,정성규,2629,60,3,5,8,37.5%,53m
8839,2,roshaTlwpsk,2628,518,21,23,44,47.7%,47m
8839,1,xinchao,2628,48,2,2,4,50.0%,20m
8839,1,cozy,2628,84,2,7,9,22.2%,19m
8839,1,chany,2628,0,0,1,1,0.0%,18m
8843,3,glamlush,2627,507,24,21,45,53.3%,47m
8843,1,Laco,2627,0,3,2,5,60.0%,19m
8843,1,IDidItMyWay,2627,119,2,2,4,50.0%,22m
8843,1,Vinging,2627,0,0,1,1,0.0%,18m
8843,1,오야지,2627,0,0,2,2,0.0%,19m
8848,1,forthefuture,2626,1586,328,346,674,48.7%,50m
8848,1,jel,2626,1835,109,106,215,50.7%,20m
8848,1,[바코드군단]llllll,2626,1265,89,88,177,50.3%,50m
8848,2,bsg,2626,141,5,7,12,41.7%,51m
8848,2,nobody,2626,0,2,3,5,40.0%,22m
8848,1,인간,2626,48,1,3,4,25.0%,23m
8848,1,justin,2626,0,0,1,1,0.0%,19m
8855,1,연천군흑염룡,2625,416,13,11,24,54.2%,20m
8855,3,必成火海,2625,266,13,13,26,50.0%,52m
8855,3,DarkKnight,2625,140,4,4,8,50.0%,21m
8855,3,Amigo,2625,93,3,4,7,42.9%,47m
8855,1,jjang,2625,0,1,0,1,100.0%,19m
8855,1,프랑,2625,0,0,1,1,0.0%,46m
8861,2,HitGirl,2624,1532,142,151,293,48.5%,51m
8861,1,tank,2624,1367,137,148,285,48.1%,50m
8861,1,EDEN,2624,870,27,24,51,52.9%,18m
8861,3,슐레이드,2624,528,19,18,37,51.4%,47m
8861,2,귀여운곰,2624,30,4,5,9,44.4%,47m
8861,1,Jezek,2624,174,4,7,11,36.4%,19m
8861,1,[In2p]샤이닝토스,2624,88,3,3,6,50.0%,20m
8861,1,Mun,2624,97,3,3,6,50.0%,23m
8869,1,전쟁광,2623,496,15,32,47,31.9%,50m
8869,2,Forthepeople,2623,152,6,11,17,35.3%,51m
8869,3,그문룡,2623,30,4,5,9,44.4%,52m
8869,3,황씨,2623,121,3,2,5,60.0%,25m
8869,1,변기영,2623,90,2,1,3,66.7%,19m
8869,1,용의전사,2623,80,2,4,6,33.3%,46m
8875,2,filatelia,2622,1359,244,238,482,50.6%,47m
8875,1,Legion,2622,1547,113,128,241,46.9%,50m
8875,3,hey,2622,97,2,1,3,66.7%,47m
8878,2,DOGBIRD,2621,1508,261,265,526,49.6%,52m
8878,2,blackswas,2621,494,19,18,37,51.4%,52m
8878,3,[호놀롤로]jangkoon,2621,483,19,28,47,40.4%,47m
8878,1,윤구우,2621,370,16,16,32,50.0%,50m
8878,3,김지훈,2621,203,7,9,16,43.8%,25m
8878,1,Butsoap,2621,226,5,3,8,62.5%,19m
8878,2,[경기도민]돼지세끼,2621,0,2,3,5,40.0%,22m
8878,1,valytatarus,2621,0,2,4,6,33.3%,24m
8878,2,[krtag]김영훈,2621,0,1,0,1,100.0%,26m
8878,1,[게임플레이]스톰없는고위기사,2621,48,1,2,3,33.3%,23m
8878,1,레온,2621,0,0,1,1,0.0%,46m
8889,3,행복한형욱이,2620,555,23,17,40,57.5%,47m
8889,3,llllilll,2620,390,13,13,26,50.0%,21m
8889,1,쑥쑥,2620,185,5,5,10,50.0%,46m
8889,3,[TCK]진격의하로로,2620,97,2,0,2,100.0%,25m
8889,1,LuckyRasp,2620,0,2,3,5,40.0%,46m
8894,2,캐릭터이름변경,2619,1387,318,340,658,48.3%,1m
8894,1,[KrNoob]IIIIIIIIIIII,2619,484,14,8,22,63.6%,46m
8894,1,Sukhoi,2619,296,8,7,15,53.3%,19m
8894,1,Apostate,2619,0,2,3,5,40.0%,46m
8894,1,나나난,2619,0,0,1,1,0.0%,47m
8894,1,[萬花筒寫輪眼]byuM,2619,0,0,4,4,0.0%,19m
8900,1,lIlIlIlIlIIl,2618,559,19,16,35,54.3%,46m
8900,3,Mikejon,2618,542,19,19,38,50.0%,21m
8900,1,SAUL,2618,602,18,12,30,60.0%,19m
8900,1,ManiMoiMo,2618,88,2,1,3,66.7%,19m
8900,1,[테스형]소크라테스,2618,48,1,1,2,50.0%,22m
8900,1,SIRO,2618,0,0,1,1,0.0%,20m
8906,3,아돌프아이히만,2617,965,42,40,82,51.2%,20m
8906,1,llllllllllll,2617,946,35,23,58,60.3%,46m
8906,2,지존보스,2617,866,34,36,70,48.6%,52m
8906,2,빵빵또로로로,2617,184,5,9,14,35.7%,47m
8906,1,[하얀나비]오블리비언,2617,108,3,6,9,33.3%,24m
8906,1,CAESAR,2617,0,2,3,5,40.0%,46m
8906,2,Noobly,2617,0,1,4,5,20.0%,22m
8906,1,두부,2617,0,0,1,1,0.0%,20m
8914,1,satanas,2616,248,6,9,15,40.0%,20m
8914,3,泡沫塑料,2616,179,4,7,11,36.4%,21m
8914,3,MagicTurtle,2616,0,2,4,6,33.3%,47m
8917,1,SNOW,2615,334,12,9,21,57.1%,20m
8917,1,Nays,2615,174,5,2,7,71.4%,18m
8917,1,카벨바인드컷,2615,78,3,0,3,100.0%,19m
8917,1,aaa,2615,44,1,2,3,33.3%,20m
8917,1,hjh,2615,44,1,3,4,25.0%,20m
8917,1,Marine,2615,0,0,1,1,0.0%,46m
8923,2,유스리더,2614,1574,217,224,441,49.2%,52m
8923,1,코로나,2614,616,20,18,38,52.6%,19m
8923,3,gill,2614,349,15,18,33,45.5%,21m
8923,1,llllllllllll,2614,226,6,7,13,46.2%,19m
8923,1,명백한스린이,2614,172,5,5,10,50.0%,20m
8923,1,墨染樱,2614,173,5,5,10,50.0%,19m
8923,3,비싼한돈,2614,121,3,4,7,42.9%,52m
8923,1,llllllllllll,2614,46,1,1,2,50.0%,19m
8923,1,그녀의일침,2614,0,0,1,1,0.0%,24m
8932,2,Tenka,2613,317,11,9,20,55.0%,26m
8932,1,llllllllllll,2613,175,4,5,9,44.4%,20m
8932,1,Untitled,2613,96,2,3,5,40.0%,24m
8932,1,룬트슈텐트,2613,0,0,2,2,0.0%,46m
8936,1,Ragnarok,2612,370,13,5,18,72.2%,46m
8936,3,Woojin,2612,122,3,5,8,37.5%,47m
8936,1,Tyrr,2612,73,1,1,2,50.0%,19m
8936,1,할까말까쌀까,2612,0,0,3,3,0.0%,19m
8940,1,스타를글로배웠다,2611,1822,214,221,435,49.2%,19m
8940,1,Claude,2611,626,19,15,34,55.9%,28m
8940,3,myeong,2611,299,10,11,21,47.6%,21m
8940,3,kangbin,2611,121,2,1,3,66.7%,24m
8940,1,Ghost,2611,80,2,5,7,28.6%,46m
8940,2,JamesPang,2611,0,0,1,1,0.0%,22m
8940,1,RoB,2611,0,0,4,4,0.0%,18m
8940,1,셔틀,2611,0,0,4,4,0.0%,19m
8940,3,[불멸자]케빈브라운,2611,0,0,6,6,0.0%,21m
8949,3,[문법나치]ZeraTul,2610,1520,226,229,455,49.7%,52m
8949,3,[ELS]Evankel,2610,1393,58,54,112,51.8%,52m
8949,1,상추,2610,824,25,20,45,55.6%,28m
8949,1,Skye,2610,373,9,17,26,34.6%,18m
8949,1,전장의영웅,2610,332,9,24,33,27.3%,48m
8949,1,벌꿀함대,2610,192,6,3,9,66.7%,19m
8949,3,DASDS,2610,0,4,4,8,50.0%,26m
8949,3,Barcode,2610,123,3,7,10,30.0%,47m
8949,1,wescraft,2610,0,2,5,7,28.6%,22m
8949,1,머엽찡,2610,42,1,5,6,16.7%,18m
8949,1,[YAD]어허띡그러면안되,2610,0,0,1,1,0.0%,20m
8960,1,IlIlIlIlIlIl,2609,856,66,56,122,54.1%,18m
8960,1,OuO,2609,331,7,3,10,70.0%,46m
8960,3,ClaWarrior,2609,46,7,11,18,38.9%,21m
8960,2,星海战神,2609,130,5,9,14,35.7%,51m
8960,3,[ROKU]졸림곰,2609,58,2,7,9,22.2%,53m
8960,1,스투리머,2609,0,0,1,1,0.0%,46m
8966,3,가즈아,2608,466,17,21,38,44.7%,21m
8966,1,SunKwiKim,2608,456,12,11,23,52.2%,19m
8966,1,Gajago,2608,124,4,1,5,80.0%,19m
8966,1,NET,2608,0,2,4,6,33.3%,20m
8966,1,dyserser,2608,97,2,4,6,33.3%,23m
8966,3,[해병대]IlIlIlIlIlIl,2608,0,2,4,6,33.3%,53m
8966,3,leebohyeon,2608,0,1,4,5,20.0%,20m
8973,3,존시나,2607,1380,54,48,102,52.9%,21m
8973,3,머시기를,2607,867,37,40,77,48.1%,53m
8973,1,shsambarri,2607,332,9,11,20,45.0%,19m
8973,1,[빠무의황제]teddy,2607,265,6,5,11,54.5%,46m
8973,3,lemon,2607,32,2,2,4,50.0%,25m
8973,1,숲을나는새,2607,94,2,4,6,33.3%,46m
8973,1,[超級大雷貓]Sugar,2607,0,1,0,1,100.0%,19m
8973,1,CHamp,2607,0,1,1,2,50.0%,46m
8981,1,Codet,2606,1444,114,115,229,49.8%,20m
8981,1,니팬티보일라,2606,1508,101,102,203,49.8%,50m
8981,1,lIlIIllIIllI,2606,76,5,8,13,38.5%,50m
8981,1,oribal,2606,44,2,3,5,40.0%,19m
8981,1,[서중씹게이들]자연산물범,2606,0,2,4,6,33.3%,23m
8981,1,TaKer,2606,44,1,2,3,33.3%,19m
8987,1,llllllllllll,2605,891,41,28,69,59.4%,19m
8987,1,수원고구마,2605,808,36,22,58,62.1%,20m
8987,1,[광막고]땡칠이의모험,2605,1028,33,30,63,52.4%,19m
8987,2,하하하,2605,577,27,29,56,48.2%,52m
8987,2,gwpioneer,2605,734,24,33,57,42.1%,52m
8987,1,[CnB]소중중야,2605,97,2,0,2,100.0%,24m
8987,1,ssong,2605,30,2,3,5,40.0%,19m
8994,3,미미,2604,670,25,25,50,50.0%,52m
8994,1,Yanori,2604,675,21,23,44,47.7%,46m
8994,1,[南無阿彌陀佛]龜巖許浚,2604,407,17,5,22,77.3%,20m
8994,2,삼겹살,2604,0,2,2,4,50.0%,22m
8994,1,kptech,2604,0,0,1,1,0.0%,20m
8999,2,jrs,2603,1538,87,93,180,48.3%,51m
8999,1,안녕,2603,126,3,1,4,75.0%,46m
8999,1,Jealous,2603,92,1,1,2,50.0%,46m
9002,1,[Encore]네임쿤,2602,252,10,5,15,66.7%,20m
9002,1,[열차강도]USA,2602,350,10,7,17,58.8%,19m
9002,3,Nicko,2602,205,6,5,11,54.5%,24m
9002,1,야승재,2602,97,4,2,6,66.7%,23m
9002,3,인공지능,2602,34,1,1,2,50.0%,24m
9002,1,더글링,2602,0,0,1,1,0.0%,20m
9008,1,[래더납치범]HMA,2601,440,12,8,20,60.0%,19m
9008,3,hyile,2601,180,6,10,16,37.5%,21m
9010,1,StarRush,2600,820,30,19,49,61.2%,46m
9010,3,새봄이동생광식,2600,472,22,42,64,34.4%,8m
9010,2,대성,2600,116,6,8,14,42.9%,48m
9010,1,황새롬과김도겸,2600,48,2,2,4,50.0%,22m
9010,1,qudtls,2600,0,2,3,5,40.0%,46m
9010,1,천상왕,2600,0,2,4,6,33.3%,46m
9010,1,lain,2600,0,1,0,1,100.0%,20m
9010,1,theboss,2600,36,1,2,3,33.3%,19m
9010,1,showmemoney,2600,0,0,2,2,0.0%,19m
9019,1,이방인,2599,500,15,9,24,62.5%,20m
9019,3,아메리카노할래,2599,97,5,5,10,50.0%,26m
9019,3,[도킹도킹]라플라시오,2599,154,5,13,18,27.8%,53m
9019,3,[EZboYz]junmc,2599,177,4,10,14,28.6%,52m
9019,2,Nazym,2599,0,2,5,7,28.6%,47m
9019,1,[Rebel]느그집보일러,2599,0,0,3,3,0.0%,46m
9019,2,sunflower,2599,0,0,5,5,0.0%,22m
9026,3,산이,2598,1143,181,182,363,49.9%,53m
9026,3,EXPDTSN,2598,344,13,16,29,44.8%,47m
9026,2,뙇뙇뙇뙇,2598,260,11,12,23,47.8%,26m
9026,1,GreenRiver,2598,179,7,5,12,58.3%,46m
9026,3,lIlIlIlIlIlI,2598,60,2,5,7,28.6%,21m
9026,1,IMReturns,2598,0,0,7,7,0.0%,19m
9032,3,ozsealoz,2597,548,55,53,108,50.9%,47m
9032,2,llllllllllll,2597,649,41,41,82,50.0%,52m
9032,1,limsujo,2597,1070,32,31,63,50.8%,46m
9032,1,MrT,2597,503,17,14,31,54.8%,19m
9032,1,Casper,2597,600,16,16,32,50.0%,28m
9032,1,vega,2597,141,4,5,9,44.4%,46m
9032,1,yckiller,2597,103,3,2,5,60.0%,20m
9032,1,[헬로히어로]뱅글이,2597,0,3,4,7,42.9%,22m
9032,2,Woo,2597,0,2,3,5,40.0%,22m
9032,1,[카토]카토메구미,2597,0,1,0,1,100.0%,19m
9032,1,아니었따,2597,32,1,2,3,33.3%,19m
9043,1,llllllllllll,2596,494,20,17,37,54.1%,19m
9043,3,저그,2596,150,4,5,9,44.4%,52m
9043,1,피카소친구,2596,84,3,0,3,100.0%,18m
9043,3,bob,2596,0,2,4,6,33.3%,21m
9043,1,dark,2596,0,1,4,5,20.0%,24m
9048,1,코코아,2595,754,22,25,47,46.8%,19m
9048,2,loTHEGODol,2595,334,15,15,30,50.0%,47m
9048,3,[망겜장인]Heihachi,2595,30,3,6,9,33.3%,47m
9048,1,옴마니반메훔,2595,0,0,1,1,0.0%,20m
9052,1,즐겜러,2594,279,9,8,17,52.9%,20m
9052,1,katkiuks,2594,0,3,2,5,60.0%,46m
9052,1,[해병만뽑음]지금은양학중,2594,44,2,4,6,33.3%,19m
9052,1,[독일국방군]원유,2594,0,1,1,2,50.0%,47m
9052,1,iiiiiiiiiiii,2594,44,1,2,3,33.3%,19m
9057,1,벌레새키,2593,639,21,11,32,65.6%,19m
9057,1,Sardinas,2593,664,20,13,33,60.6%,19m
9057,3,[BEJ2]멜키지덱,2593,373,16,16,32,50.0%,53m
9057,2,kirito,2593,30,4,6,10,40.0%,51m
9057,1,Mackro,2593,96,3,2,5,60.0%,24m
9057,3,mikiya,2593,142,3,4,7,42.9%,47m
9057,1,doolyman,2593,0,1,1,2,50.0%,19m
9057,1,Por,2593,0,0,1,1,0.0%,20m
9057,3,[정치공학]레이드,2593,0,0,5,5,0.0%,52m
9066,2,JSsong,2592,1541,293,291,584,50.2%,52m
9066,3,SeconSeason,2592,1378,88,89,177,49.7%,53m
9066,1,JayD,2592,1493,58,52,110,52.7%,46m
9066,3,완소훈남융지,2592,613,24,27,51,47.1%,47m
9066,1,동내철공소,2592,530,21,30,51,41.2%,48m
9066,1,다그바,2592,392,10,5,15,66.7%,20m
9066,1,[마리사]키리사메마리사,2592,48,3,5,8,37.5%,22m
9066,1,[CKR]혁돌이,2592,0,0,1,1,0.0%,24m
9074,2,[NLTN]asjglsd,2591,1264,88,86,174,50.6%,51m
9074,1,GONI,2591,654,19,13,32,59.4%,19m
9074,3,burai,2591,323,11,16,27,40.7%,53m
9074,3,Sam,2591,232,8,16,24,33.3%,52m
9074,1,[더블M]님이가시는길,2591,44,1,5,6,16.7%,19m
9079,3,THEODORE,2590,1139,45,44,89,50.6%,52m
9079,3,말굽한대,2590,0,2,4,6,33.3%,47m
9079,1,곧휴가철이다,2590,0,0,1,1,0.0%,28m
9079,1,ISAAC,2590,0,0,1,1,0.0%,19m
9079,1,HydraLisk,2590,0,0,1,1,0.0%,20m
9084,1,급하다,2589,484,14,13,27,51.9%,19m
9084,3,[CDGIN]Sschoularz,2589,166,5,4,9,55.6%,47m
9084,1,craft,2589,42,3,5,8,37.5%,46m
9084,1,Wolo,2589,80,2,3,5,40.0%,19m
9084,1,[호묘묘]포로링,2589,0,2,4,6,33.3%,23m
9084,1,춘자냇,2589,38,1,3,4,25.0%,19m
9084,1,[SPY4U]올로,2589,0,0,1,1,0.0%,20m
9084,2,[FZero]러드,2589,0,0,1,1,0.0%,22m
9092,3,letmego,2588,965,36,32,68,52.9%,47m
9092,2,[JUNG]아리,2588,784,29,32,61,47.5%,52m
9092,2,[리또속]대전유성구짱돌,2588,350,13,16,29,44.8%,51m
9092,2,하이퍼레이너,2588,157,4,5,9,44.4%,27m
9092,3,Yera,2588,0,1,6,7,14.3%,47m
9092,1,정화자,2588,0,0,1,1,0.0%,19m
9092,2,오퍼,2588,0,0,2,2,0.0%,27m
9099,2,superman,2587,1276,53,47,100,53.0%,47m
9099,1,설마,2587,1134,51,48,99,51.5%,18m
9099,2,아앗거긴안돼,2587,679,29,33,62,46.8%,52m
9099,1,블랙,2587,88,3,4,7,42.9%,18m
9099,3,뽀로로는로로뽀,2587,90,3,12,15,20.0%,52m
9099,1,FrayD,2587,88,2,4,6,33.3%,20m
9105,1,cube,2586,0,3,2,5,60.0%,47m
9105,3,BigBadWolf,2586,0,0,1,1,0.0%,25m
9107,1,[군주]스투코프,2585,273,12,10,22,54.5%,18m
9107,1,闇焰風暴,2585,341,11,12,23,47.8%,46m
9107,1,[동네노는형들]Mong,2585,314,8,8,16,50.0%,19m
9107,1,pasha,2585,290,7,12,19,36.8%,19m
9107,1,WeltherSnow,2585,136,3,7,10,30.0%,46m
9107,1,Classic,2585,0,0,1,1,0.0%,46m
9113,3,HwangShin,2584,541,22,18,40,55.0%,53m
9113,1,kwok,2584,126,4,3,7,57.1%,19m
9113,1,Patan,2584,82,2,5,7,28.6%,18m
9113,1,[밀짚모해적단]jjang,2584,0,1,1,2,50.0%,20m
9113,1,master,2584,0,0,1,1,0.0%,46m
9113,1,[맛있더라]아래가달랑,2584,0,0,1,1,0.0%,46m
9113,1,얄루봉봉,2584,0,0,1,1,0.0%,20m
9120,2,AghanimShard,2583,1508,630,627,1257,50.1%,52m
9120,1,땡땡땡,2583,306,10,7,17,58.8%,46m
9120,1,수도방위사령부,2583,186,8,6,14,57.1%,20m
9120,1,엄준식,2583,0,1,1,2,50.0%,46m
9124,1,flynife,2582,721,25,32,57,43.9%,50m
9124,1,[dfg133]폭풍드롭,2582,239,5,4,9,55.6%,23m
9124,1,lIlIlIlIlIlI,2582,170,4,6,10,40.0%,19m
9124,1,스고이데스,2582,44,1,6,7,14.3%,19m
9128,3,bboykid,2581,457,19,23,42,45.2%,21m
9128,1,Revolution,2581,134,4,3,7,57.1%,20m
9128,1,비광,2581,117,3,4,7,42.9%,18m
9131,1,vMCFCv,2580,1505,87,89,176,49.4%,50m
9131,3,블리잗으직원,2580,552,21,23,44,47.7%,21m
9131,3,토레타,2580,416,15,16,31,48.4%,47m
9131,3,雪森,2580,246,10,9,19,52.6%,25m
9131,1,kimnnp,2580,126,4,3,7,57.1%,19m
9131,1,RobSui,2580,0,1,0,1,100.0%,24m
9137,3,갤럭시,2579,1520,76,74,150,50.7%,52m
9137,1,KreCy,2579,458,13,11,24,54.2%,19m
9137,1,택중충야,2579,230,8,11,19,42.1%,46m
9137,1,Rattini,2579,30,3,4,7,42.9%,46m
9137,1,[灭棒敢死队]抗韩奇侠燕又鹰,2579,96,2,5,7,28.6%,23m
9137,2,[진성현]Apper,2579,0,1,2,3,33.3%,22m
9143,1,HuNTinG,2578,1030,33,34,67,49.3%,46m
9143,1,eScSWeet,2578,416,13,12,25,52.0%,20m
9143,2,스타는오승환,2578,210,9,9,18,50.0%,47m
9143,3,잉여는잉여다,2578,242,9,13,22,40.9%,52m
9143,2,[팡캐월령전]할래류야,2578,144,5,3,8,62.5%,27m
9143,1,[루키]cnb,2578,78,3,1,4,75.0%,19m
9143,1,fams,2578,42,1,4,5,20.0%,19m
9143,1,김마빡이,2578,0,0,1,1,0.0%,46m
9143,1,승재,2578,0,0,2,2,0.0%,19m
9143,1,플라이천사,2578,0,0,4,4,0.0%,19m
9153,3,Newsky,2577,490,22,27,49,44.9%,21m
9153,1,pure,2577,321,19,17,36,52.8%,19m
9153,3,[TPg]德馬西亞,2577,216,7,5,12,58.3%,47m
9153,1,그거슨헤팝,2577,205,6,9,15,40.0%,19m
9153,1,TheXanadu,2577,128,5,6,11,45.5%,46m
9153,1,[NighT1]ddd,2577,216,5,9,14,35.7%,19m
9153,1,마주작,2577,97,3,3,6,50.0%,23m
9153,1,Boom,2577,0,0,2,2,0.0%,19m
9161,1,[sc2mc]Flaxen,2576,1778,75,68,143,52.4%,46m
9161,1,土雞,2576,44,3,5,8,37.5%,46m
9163,1,IIIIllllIIII,2575,418,13,11,24,54.2%,20m
9163,1,ShadowKiller,2575,86,4,4,8,50.0%,47m
9163,2,[세미온챌린저]하나,2575,0,2,1,3,66.7%,22m
9163,1,SpaceArea,2575,38,2,2,4,50.0%,19m
9163,2,Asuiea,2575,0,1,1,2,50.0%,22m
9168,1,남군아,2574,634,17,20,37,45.9%,19m
9168,1,dtfactory,2574,165,3,5,8,37.5%,46m
9168,3,김경한,2574,96,3,5,8,37.5%,52m
9171,1,llllllllllll,2573,1791,121,111,232,52.2%,46m
9171,1,Boxer,2573,288,7,7,14,50.0%,28m
9171,2,나다,2573,173,4,3,7,57.1%,27m
9171,1,StormForger,2573,131,3,2,5,60.0%,46m
9171,1,HongDan,2573,42,2,1,3,66.7%,18m
9171,2,CLARETA,2573,0,2,3,5,40.0%,22m
9177,2,존스칼지,2572,1449,160,173,333,48.0%,52m
9177,1,CommanderK,2572,201,10,3,13,76.9%,20m
9177,1,SoSYang,2572,316,9,6,15,60.0%,19m
9177,2,Zapperjack,2572,0,2,3,5,40.0%,22m
9177,1,[정통파투수]dlwjddn,2572,90,2,4,6,33.3%,18m
9177,1,取名子真難,2572,90,2,4,6,33.3%,46m
9177,2,테란계약자,2572,0,1,3,4,25.0%,27m
9184,1,ArusH,2571,128,5,9,14,35.7%,49m
9184,1,BrandNewSCV,2571,97,4,4,8,50.0%,23m
9184,2,Alex,2571,95,4,8,12,33.3%,27m
9184,1,[C89923]MrTrump,2571,86,2,6,8,25.0%,28m
9184,1,corey,2571,0,1,0,1,100.0%,46m
9189,1,[ACGN]sizemorDreaM,2570,751,27,25,52,51.9%,20m
9189,1,감진고래,2570,482,13,13,26,50.0%,20m
9189,1,Tsu,2570,116,3,2,5,60.0%,20m
9189,1,sveryost,2570,46,2,0,2,100.0%,20m
9189,1,cexmaster,2570,36,2,3,5,40.0%,20m
9189,1,[진인호]DogFly,2570,0,1,0,1,100.0%,47m
9189,1,komashiro,2570,0,1,2,3,33.3%,19m
9196,1,EurekaSeveN,2569,1660,67,66,133,50.4%,19m
9196,3,ReciProcity,2569,733,29,32,61,47.5%,52m
9196,2,블루밍,2569,505,24,27,51,47.1%,51m
9196,1,[제목이내용]밴드리트,2569,514,13,15,28,46.4%,19m
9196,2,태을,2569,209,6,4,10,60.0%,26m
9196,3,미키로얄,2569,179,6,8,14,42.9%,47m
9196,1,Sonba,2569,156,5,2,7,71.4%,46m
9196,1,Jayden,2569,145,4,2,6,66.7%,23m
9196,1,맘스터치,2569,172,4,10,14,28.6%,46m
9196,3,Nima,2569,0,2,4,6,33.3%,53m
9196,1,[Libera]마루노우치,2569,30,1,1,2,50.0%,46m
9207,3,진달래,2568,1251,55,52,107,51.4%,47m
9207,1,돼지맛캔디,2568,145,4,6,10,40.0%,24m
9207,1,왕개구리,2568,124,4,6,10,40.0%,46m
9207,1,아주멋져,2568,118,3,5,8,37.5%,47m
9207,2,Aki,2568,34,1,1,2,50.0%,26m
9207,3,제국의장수,2568,0,1,2,3,33.3%,47m
9207,1,[골드함대]황금함대,2568,0,1,4,5,20.0%,19m
9207,1,적당히멋쟁이,2568,0,0,1,1,0.0%,23m
9215,3,시원한꼬츄,2567,1503,68,72,140,48.6%,52m
9215,1,kiss,2567,1496,68,87,155,43.9%,50m
9215,1,[충북제천시]남훈,2567,971,34,28,62,54.8%,20m
9215,3,rabbit,2567,859,32,34,66,48.5%,21m
9215,3,오징어에콜라,2567,699,28,27,55,50.9%,53m
9215,2,RUST,2567,262,10,12,22,45.5%,47m
9215,3,SUGA,2567,229,7,10,17,41.2%,25m
9215,3,Ray,2567,30,3,5,8,37.5%,47m
9223,3,[십분뒤고자들]Commander,2566,1511,225,226,451,49.9%,47m
9223,1,William,2566,1006,32,35,67,47.8%,20m
9223,1,MAX,2566,278,6,4,10,60.0%,19m
9223,1,[D3StaR]울트라가조트라,2566,48,4,5,9,44.4%,24m
9223,1,jkpxT,2566,0,1,0,1,100.0%,47m
9223,1,Santh,2566,48,1,2,3,33.3%,24m
9223,1,위드,2566,0,0,1,1,0.0%,20m
9230,1,BLACKHATSXD,2565,1706,90,88,178,50.6%,46m
9230,1,엄마,2565,363,13,10,23,56.5%,19m
9230,1,hotdog,2565,431,13,17,30,43.3%,19m
9230,1,basuraman,2565,168,4,5,9,44.4%,19m
9230,1,[간도특설대]수지내꺼,2565,42,2,2,4,50.0%,19m
9230,1,kloud,2565,0,0,1,1,0.0%,20m
9230,1,신서유기,2565,0,0,1,1,0.0%,19m
9237,2,MVP,2564,1279,197,191,388,50.8%,48m
9237,1,BronzeKing,2564,1760,74,82,156,47.4%,19m
9237,1,Fkiller,2564,818,25,22,47,53.2%,47m
9237,1,zerg,2564,566,18,16,34,52.9%,20m
9237,1,서늘한성에꽃이,2564,198,5,10,15,33.3%,20m
9237,2,Zerg,2564,96,5,12,17,29.4%,48m
9237,1,프로토스연합,2564,0,3,4,7,42.9%,23m
9237,2,[시럽]Ferro,2564,0,2,3,5,40.0%,22m
9237,1,nbf,2564,0,2,3,5,40.0%,46m
9237,3,[資訊管理科]死亡之音,2564,58,2,8,10,20.0%,21m
9237,1,다비드비야,2564,0,0,1,1,0.0%,18m
9237,2,[공허거주]인성,2564,0,0,1,1,0.0%,22m
9249,2,대추나무사람걸렸,2563,1103,81,72,153,52.9%,51m
9249,3,[064]youevery,2563,444,16,21,37,43.2%,21m
9249,3,lIlIlIlIlIlI,2563,193,6,6,12,50.0%,25m
9249,1,dsafdfasasdf,2563,185,5,0,5,100.0%,20m
9249,1,[익명]용기병슬레이어,2563,150,5,8,13,38.5%,28m
9249,1,도라지캐자,2563,145,3,2,5,60.0%,22m
9249,3,[Xbaek]Infinity,2563,0,2,5,7,28.6%,47m
9256,1,뢰제의나라,2562,1038,34,36,70,48.6%,46m
9256,1,라라랄라,2562,0,0,3,3,0.0%,20m
9258,1,Rosario,2561,636,18,21,39,46.2%,20m
9258,3,[AUE]나루시마,2561,248,9,14,23,39.1%,21m
9258,1,아바투르,2561,142,3,5,8,37.5%,23m
9258,1,max,2561,46,2,0,2,100.0%,19m
9262,3,manduck,2560,1482,355,356,711,49.9%,47m
9262,1,꾸밈,2560,663,18,23,41,43.9%,19m
9262,1,똥가루,2560,252,8,9,17,47.1%,46m
9262,1,KGT,2560,114,3,5,8,37.5%,19m
9262,1,lambdasquad,2560,0,2,4,6,33.3%,46m
9262,1,준치십새기,2560,0,1,0,1,100.0%,24m
9268,3,llllllllll,2559,1456,310,308,618,50.2%,53m
9268,3,마린보이,2559,1179,80,85,165,48.5%,21m
9268,3,neoforce,2559,1243,55,53,108,50.9%,53m
9268,1,loolman,2559,500,16,17,33,48.5%,19m
9268,2,[무작]chaoscao,2559,154,5,18,23,21.7%,51m
9268,1,Still,2559,0,1,0,1,100.0%,24m
9268,1,[만물의조화]나바타,2559,32,1,1,2,50.0%,46m
9268,1,UnitTosh,2559,0,1,4,5,20.0%,19m
9276,1,Schrodinger,2558,1784,144,154,298,48.3%,19m
9276,1,창천항로,2558,1577,71,77,148,48.0%,20m
9276,3,[000]Chia,2558,952,38,44,82,46.3%,21m
9276,1,[homes]Kimjeongho,2558,1021,32,31,63,50.8%,20m
9276,3,어린아저씨,2558,417,15,18,33,45.5%,47m
9276,1,초보사령관,2558,40,3,4,7,42.9%,46m
9276,1,뀨로로,2558,0,0,1,1,0.0%,18m
9283,3,ksh,2557,1485,68,72,140,48.6%,47m
9283,3,[머구폐렴]lllllIIllIll,2557,1583,59,62,121,48.8%,21m
9283,2,AssKiKa,2557,1265,56,63,119,47.1%,51m
9283,2,阿霞在天上飛,2557,510,17,30,47,36.2%,51m
9283,1,갓난태아,2557,509,16,14,30,53.3%,20m
9283,1,슈발베,2557,214,11,11,22,50.0%,48m
9283,1,abc,2557,196,7,8,15,46.7%,46m
9283,1,修蛋幾哩,2557,0,1,0,1,100.0%,24m
9283,1,星神,2557,0,0,2,2,0.0%,24m
9292,1,[미도리고마워]니들이물알어,2556,1774,55,58,113,48.7%,20m
9292,3,Unknown,2556,430,18,28,46,39.1%,53m
9292,1,parksooyoung,2556,321,15,4,19,78.9%,46m
9292,1,호야쓰삐,2556,0,3,4,7,42.9%,24m
9292,1,누가좀가르쳐줘,2556,0,1,2,3,33.3%,19m
9292,1,빼빼로,2556,0,1,2,3,33.3%,19m
9292,1,ywdyddnr,2556,42,1,5,6,16.7%,19m
9292,1,테라,2556,40,1,7,8,12.5%,19m
9292,1,이럼나가린데,2556,0,0,1,1,0.0%,23m
9292,1,ijfiejpop,2556,73,0,2,2,0.0%,46m
9292,1,[sc2mc]전수혁,2556,0,0,3,3,0.0%,24m
9303,3,strom,2555,1325,101,93,194,52.1%,53m
9303,3,[국방부사서병]SEKI,2555,1302,67,62,129,51.9%,21m
9303,1,Rckt,2555,1040,40,34,74,54.1%,19m
9303,1,pusi,2555,338,10,11,21,47.6%,28m
9303,1,하이바,2555,122,3,5,8,37.5%,20m
9303,1,Sivraj,2555,0,1,0,1,100.0%,47m
9303,1,andrewshin,2555,0,0,1,1,0.0%,19m
9310,1,미믹정주,2554,848,27,31,58,46.6%,19m
9310,1,소마,2554,254,6,11,17,35.3%,19m
9310,1,[누후훗]Stardust,2554,118,3,2,5,60.0%,46m
9310,1,바퀴,2554,126,3,3,6,50.0%,46m
9310,1,[스투열사]Bakgalyang,2554,97,3,4,7,42.9%,23m
9310,1,DSFW,2554,48,2,0,2,100.0%,28m
9310,1,캐리건,2554,0,2,4,6,33.3%,23m
9310,1,dubistcool,2554,0,1,0,1,100.0%,23m
9310,1,zeusjr,2554,48,1,2,3,33.3%,47m
9310,3,[pepsl]불닭볶음면,2554,0,0,1,1,0.0%,25m
9310,1,LIPPS,2554,0,0,2,2,0.0%,20m
9321,1,[해병대]줌머홀릭,2553,1485,319,324,643,49.6%,50m
9321,3,장기전만한다,2553,750,41,38,79,51.9%,21m
9321,3,其实我很菜,2553,1048,40,46,86,46.5%,53m
9321,3,[Celpix]chkondanger,2553,231,10,16,26,38.5%,21m
9321,3,샤인,2553,199,7,11,18,38.9%,25m
9321,1,[건국]홍님벌쳐,2553,118,3,3,6,50.0%,47m
9321,1,기운찬기사,2553,42,1,2,3,33.3%,46m
9321,1,불타는데하카,2553,0,1,2,3,33.3%,24m
9329,1,ian,2552,706,23,20,43,53.5%,19m
9329,3,wdwdd,2552,404,17,19,36,47.2%,53m
9329,1,CrowBar,2552,465,12,15,27,44.4%,20m
9329,2,[아게모니아]랑아,2552,239,11,11,22,50.0%,28m
9329,3,HONG,2552,150,7,11,18,38.9%,47m
9329,1,歐克咖啡,2552,97,2,0,2,100.0%,46m
9329,1,snowredrotoR,2552,0,2,5,7,28.6%,24m
9329,1,DHJIN,2552,88,1,3,4,25.0%,47m
9329,1,[Sergio]뱅듄,2552,0,1,5,6,16.7%,46m
9329,1,[래핑코빈]gggee,2552,0,0,1,1,0.0%,24m
9329,1,Bryan,2552,0,0,1,1,0.0%,19m
9340,3,PICKLERAIN,2551,1434,87,85,172,50.6%,47m
9340,1,lili,2551,154,7,4,11,63.6%,19m
9340,1,KHBIB,2551,92,3,2,5,60.0%,47m
9340,2,봉골레파스타,2551,143,3,2,5,60.0%,22m
9340,1,용가리,2551,0,0,1,1,0.0%,46m
9345,2,뇌없는드라군,2550,88,4,5,9,44.4%,48m
9345,1,Imposter,2550,0,0,1,1,0.0%,19m
9347,1,해물맛짱,2549,250,10,13,23,43.5%,46m
9347,3,[PM2o5]纸片人,2549,4,7,16,23,30.4%,21m
9347,3,뭘바욤,2549,192,6,17,23,26.1%,52m
9347,1,앞집여자,2549,194,5,6,11,45.5%,47m
9347,1,[阿修羅]Richard,2549,48,4,5,9,44.4%,24m
9347,3,DoriDoriEnma,2549,0,0,1,1,0.0%,25m
9347,1,[저글링죠아]YaED,2549,0,0,1,1,0.0%,20m
9354,2,뜨거운강자,2548,1508,318,315,633,50.2%,48m
9354,1,soulk,2548,1390,102,96,198,51.5%,19m
9354,1,MinThant,2548,803,26,25,51,51.0%,19m
9354,1,[SCTW]ZEROS,2548,438,13,13,26,50.0%,18m
9354,3,cruelR,2548,246,8,16,24,33.3%,53m
9359,3,KoshNaranek,2547,1261,72,93,165,43.6%,53m
9359,1,ORNNMASTER,2547,1688,61,57,118,51.7%,18m
9359,2,Pioneer,2547,235,10,11,21,47.6%,26m
9359,3,KiwiLionNZK,2547,259,9,10,19,47.4%,26m
9359,3,양유강,2547,30,4,6,10,40.0%,53m
9359,1,bumsoo,2547,44,2,3,5,40.0%,20m
9359,2,[qazwsx]Misha,2547,0,1,4,5,20.0%,22m
9359,1,레탕,2547,0,0,3,3,0.0%,46m
9367,3,Tonestarcraf,2546,1550,399,445,844,47.3%,21m
9367,1,肥豬寶,2546,1555,124,123,247,50.2%,46m
9367,1,Newskoollee,2546,684,19,28,47,40.4%,46m
9367,1,aker,2546,226,9,12,21,42.9%,48m
9367,3,나는,2546,194,8,7,15,53.3%,25m
9367,1,RainRines,2546,0,2,3,5,40.0%,19m
9373,1,ksy,2545,1640,131,136,267,49.1%,21m
9373,2,SniperAbeter,2545,1491,70,84,154,45.5%,52m
9373,1,scorpion,2545,810,39,40,79,49.4%,28m
9373,1,먹던이,2545,466,13,14,27,48.1%,18m
9373,1,카인일병,2545,74,2,4,6,33.3%,19m
9373,1,[뉴비다]한조,2545,73,1,1,2,50.0%,46m
9373,1,妳媽下面好臭,2545,0,1,2,3,33.3%,19m
9380,3,워런,2544,867,39,41,80,48.8%,53m
9380,1,Haria,2544,555,17,17,34,50.0%,46m
9380,3,lIllIIlIIl,2544,356,15,18,33,45.5%,47m
9380,1,yyfyyf,2544,372,14,15,29,48.3%,19m
9380,1,제이플라,2544,170,6,8,14,42.9%,47m
9380,1,음파는노래를타고,2544,48,4,5,9,44.4%,23m
9380,3,kissme,2544,0,2,4,6,33.3%,47m
9380,1,lunaremily,2544,0,2,4,6,33.3%,46m
9380,1,의열단의이름으로,2544,0,2,5,7,28.6%,24m
9380,1,Marineking,2544,0,1,2,3,33.3%,46m
9380,1,Yan,2544,0,0,6,6,0.0%,19m
9391,1,Onlick,2543,0,0,1,1,0.0%,20m
9392,2,jocomes,2542,1464,394,395,789,49.9%,51m
9392,3,Amos,2542,209,7,8,15,46.7%,53m
9392,3,박캐리,2542,218,7,11,18,38.9%,21m
9392,1,銀色羽翼,2542,140,4,0,4,100.0%,24m
9392,3,[무한오영종]blink,2542,0,1,1,2,50.0%,26m
9392,1,관창,2542,0,0,1,1,0.0%,19m
9398,3,kirop,2541,1080,41,46,87,47.1%,53m
9398,2,AuToWarGamer,2541,228,39,38,77,50.6%,51m
9398,1,ICEWOLFICE,2541,446,11,11,22,50.0%,18m
9398,1,jiwoong,2541,108,4,4,8,50.0%,21m
9398,1,SlayersBaeka,2541,48,1,4,5,20.0%,24m
9398,1,RuinSpeed,2541,0,0,1,1,0.0%,20m
9398,1,MiniTitan,2541,0,0,1,1,0.0%,20m
9405,1,AAAAA,2540,1250,63,69,132,47.7%,19m
9405,1,[國本]BlueTa,2540,610,23,14,37,62.2%,20m
9405,1,[망겜장인]fdsagsyg,2540,382,21,17,38,55.3%,28m
9405,3,모구리,2540,326,10,17,27,37.0%,21m
9405,1,[Newbe1]干饭人,2540,127,5,0,5,100.0%,46m
9405,1,뿡뿡이,2540,120,3,5,8,37.5%,47m
9405,1,HojuelaDMaiz,2540,121,3,6,9,33.3%,23m
9405,1,스타크래픜트,2540,112,3,7,10,30.0%,20m
9405,2,Forsaken,2540,42,2,5,7,28.6%,22m
9405,1,버스커드레곤,2540,0,0,1,1,0.0%,19m
9405,1,EpicTroll,2540,0,0,2,2,0.0%,20m
9405,1,김의민,2540,0,0,2,2,0.0%,20m
9417,3,mlkaruoIove,2539,1519,161,165,326,49.4%,21m
9417,1,Scorpion,2539,1472,91,89,180,50.6%,20m
9417,1,skyhoole,2539,248,7,5,12,58.3%,20m
9417,1,송가인이어라,2539,198,7,7,14,50.0%,20m
9417,1,[맢레스토랑스]Shyunpay,2539,126,4,5,9,44.4%,46m
9417,1,IIIIIIIIlllI,2539,142,4,5,9,44.4%,24m
9417,3,궯뚨쯿쏷뾁,2539,30,3,5,8,37.5%,47m
9417,1,Rex,2539,70,2,2,4,50.0%,46m
9417,1,익성,2539,36,1,2,3,33.3%,20m
9426,3,eve,2538,659,97,102,199,48.7%,21m
9426,1,청소년이용불가,2538,1536,56,56,112,50.0%,21m
9426,1,manshsjs,2538,568,15,21,36,41.7%,20m
9426,3,BLANK,2538,251,9,10,19,47.4%,47m
9426,1,[미친광전사]NovaTerra,2538,140,3,8,11,27.3%,20m
9426,1,니서방,2538,0,1,0,1,100.0%,20m
9432,1,MGJterran,2537,614,19,15,34,55.9%,46m
9432,1,낭중지추,2537,436,11,17,28,39.3%,21m
9432,1,[오키오키]shark,2537,268,8,6,14,57.1%,20m
9432,1,whatdoido,2537,313,8,7,15,53.3%,19m
9432,2,ltuhjl,2537,60,5,10,15,33.3%,48m
9432,1,슈퍼수건,2537,0,0,1,1,0.0%,46m
9438,1,Terran,2536,524,14,12,26,53.8%,21m
9438,1,전투거북,2536,174,5,6,11,45.5%,19m
9438,2,domiante,2536,144,5,8,13,38.5%,48m
9438,1,[삼국시대]Bulbasaur,2536,84,4,7,11,36.4%,24m
9438,1,현수당,2536,48,2,4,6,33.3%,24m
9438,2,[순콜로니]rupang,2536,48,2,4,6,33.3%,22m
9438,1,[진격의에렌]allMiyeon,2536,0,0,1,1,0.0%,47m
9438,2,uigkj,2536,0,0,1,1,0.0%,22m
9438,1,Rules,2536,0,0,1,1,0.0%,19m
9438,1,theobold,2536,0,0,1,1,0.0%,24m
9438,1,[포탑ADV]은채야,2536,0,0,2,2,0.0%,19m
9449,1,젤리,2535,820,25,23,48,52.1%,20m
9449,1,老爺不要夫人在看,2535,73,1,1,2,50.0%,20m
9449,1,인성타니스,2535,0,0,1,1,0.0%,46m
9449,1,사쿠라치요,2535,0,0,2,2,0.0%,46m
9453,3,hajun,2534,470,15,19,34,44.1%,53m
9453,1,이종현,2534,364,10,9,19,52.6%,21m
9453,1,멋진놈이다,2534,276,8,5,13,61.5%,20m
9453,1,치킨,2534,262,7,6,13,53.8%,20m
9453,1,PandaLad,2534,286,7,11,18,38.9%,47m
9453,1,ljk,2534,236,6,6,12,50.0%,24m
9453,1,miku,2534,144,3,2,5,60.0%,24m
9453,1,Terran,2534,0,1,1,2,50.0%,20m
9461,3,davidliin,2533,1213,193,192,385,50.1%,21m
9461,1,Dake,2533,1483,96,94,190,50.5%,19m
9461,1,배틀머신,2533,1328,56,50,106,52.8%,18m
9461,1,blk,2533,582,18,20,38,47.4%,18m
9461,2,Kochito,2533,88,2,1,3,66.7%,18m
9461,1,nboy,2533,73,1,9,10,10.0%,20m
9467,1,밤날개,2532,1042,31,30,61,50.8%,20m
9467,3,[설희러버]눈의희열,2532,562,25,25,50,50.0%,47m
9467,1,[별똥별]pakalove,2532,66,4,5,9,44.4%,47m
9467,1,ItalianKing,2532,189,4,7,11,36.4%,23m
9467,1,[트위치TV]원거리라이더,2532,32,1,2,3,33.3%,19m
9467,1,Speed,2532,0,0,1,1,0.0%,46m
9467,1,스타초보,2532,0,0,2,2,0.0%,46m
9474,3,新手多指教,2531,1088,83,76,159,52.2%,21m
9474,1,퀴프아크,2531,1758,79,82,161,49.1%,20m
9474,2,시원,2531,706,24,35,59,40.7%,52m
9474,1,dashali,2531,238,7,7,14,50.0%,21m
9474,1,Notryanho,2531,176,5,4,9,55.6%,47m
9474,1,daxus,2531,164,4,5,9,44.4%,47m
9474,1,titanium,2531,0,1,3,4,25.0%,46m
9474,1,짐레이너,2531,0,1,3,4,25.0%,24m
9474,2,SlayerBoxer,2531,0,1,4,5,20.0%,48m
9474,2,huiguo,2531,0,0,7,7,0.0%,22m
9484,1,jimmyspa,2530,1235,43,42,85,50.6%,20m
9484,3,니조랄,2530,536,22,28,50,44.0%,21m
9484,1,사냥꾼,2530,330,9,6,15,60.0%,46m
9484,1,쌔게해,2530,175,6,7,13,46.2%,46m
9484,1,[FP]gamtu,2530,40,2,1,3,66.7%,46m
9489,1,Optixus,2529,1476,67,60,127,52.8%,46m
9489,1,마스터즈,2529,368,15,18,33,45.5%,28m
9489,1,naruyng,2529,345,12,15,27,44.4%,47m
9489,1,Dicboy,2529,274,8,10,18,44.4%,46m
9489,1,라이언누나구하기,2529,0,2,4,6,33.3%,46m
9489,1,gkfl,2529,0,1,1,2,50.0%,28m
9489,1,닭고기,2529,0,1,2,3,33.3%,28m
9496,3,HotSoup,2528,1288,155,158,313,49.5%,21m
9496,1,MSTEAMent,2528,222,7,7,14,50.0%,19m
9496,1,Brandeis,2528,144,3,10,13,23.1%,24m
9496,1,[신뢰]오리형아거,2528,0,1,2,3,33.3%,20m
9496,1,[지이잉]주예지이잉레이너,2528,48,1,2,3,33.3%,24m
9501,1,janggun,2527,1052,36,30,66,54.5%,19m
9501,1,[늙지않아]영광겸댕이,2527,118,3,5,8,37.5%,46m
9503,3,[DeFT5]Freddy,2526,1365,159,163,322,49.4%,47m
9503,1,JENN,2526,928,33,30,63,52.4%,47m
9503,3,雪千尋,2526,709,29,36,65,44.6%,21m
9503,1,멍멍,2526,516,16,16,32,50.0%,47m
9503,1,Chilled,2526,379,14,10,24,58.3%,19m
9503,1,형님나가신다,2526,97,1,1,2,50.0%,23m
9503,1,흐르는강,2526,38,1,2,3,33.3%,19m
9503,1,JulzTheBulz,2526,0,0,1,1,0.0%,20m
9503,1,giltae,2526,0,0,1,1,0.0%,47m
9512,3,soju,2525,1014,148,155,303,48.8%,21m
9512,3,backgh,2525,658,24,26,50,48.0%,21m
9512,1,Halo,2525,0,0,1,1,0.0%,28m
9512,1,fiqqun,2525,0,0,4,4,0.0%,46m
9516,1,율곡용사,2524,234,14,18,32,43.8%,19m
9516,1,tak,2524,125,2,1,3,66.7%,20m
9516,2,찬란한마법사,2524,46,2,4,6,33.3%,22m
9516,1,파란템플러,2524,0,0,1,1,0.0%,19m
9516,1,무뇌봉동무,2524,0,0,3,3,0.0%,19m
9521,3,안졸리나오빠,2523,1425,91,83,174,52.3%,47m
9521,1,ImmanuelKant,2523,525,17,19,36,47.2%,46m
9521,3,[쎆쓰]이게임재밋나,2523,412,12,34,46,26.1%,8m
9521,1,BOOREUNG,2523,254,8,7,15,53.3%,20m
9521,1,비비고좀비비고,2523,187,6,6,12,50.0%,24m
9521,1,DeLivershot,2523,0,2,3,5,40.0%,46m
9521,1,tajja,2523,44,1,2,3,33.3%,20m
9528,1,국민성,2522,238,8,5,13,61.5%,19m
9528,1,lhs,2522,96,5,8,13,38.5%,24m
9528,1,차승원,2522,103,3,1,4,75.0%,47m
9528,1,AstraDrail,2522,97,3,4,7,42.9%,20m
9532,1,llIIlll,2521,1617,145,145,290,50.0%,46m
9532,1,woong,2521,311,8,8,16,50.0%,24m
9532,1,스타일러,2521,144,4,4,8,50.0%,47m
9532,1,Dalls,2521,138,3,2,5,60.0%,46m
9532,1,사라앙,2521,0,3,3,6,50.0%,46m
9532,1,[WTSC]위리,2521,145,2,3,5,40.0%,23m
9532,2,kijoo,2521,48,1,2,3,33.3%,22m
9539,2,감사합니다람쥐,2520,1297,49,61,110,44.5%,52m
9539,1,sin,2520,688,23,30,53,43.4%,19m
9539,1,클랜헌터,2520,332,9,6,15,60.0%,19m
9539,1,바른양돈,2520,221,8,9,17,47.1%,46m
9539,1,llllllllllll,2520,238,7,4,11,63.6%,46m
9539,1,Monika,2520,196,4,3,7,57.1%,46m
9539,1,上班族,2520,48,3,5,8,37.5%,46m
9539,1,ImGodkkkk,2520,32,2,1,3,66.7%,46m
9539,3,오즈,2520,121,2,4,6,33.3%,25m
9539,2,우엉우엉우엉이,2520,0,0,1,1,0.0%,22m
9539,1,llllllllllll,2520,0,0,1,1,0.0%,46m
9550,1,dobis,2519,541,19,22,41,46.3%,47m
9550,1,진영수,2519,0,0,1,1,0.0%,19m
9552,1,[3연벙]cexzazibozi,2518,1362,95,95,190,50.0%,46m
9552,1,DrKing,2518,1508,66,68,134,49.3%,20m
9552,1,슬기로운다슬기,2518,911,52,51,103,50.5%,20m
9552,1,과일은딸기,2518,992,29,36,65,44.6%,20m
9552,3,영원히비와,2518,122,6,18,24,25.0%,21m
9552,1,SquareRobin,2518,164,5,3,8,62.5%,24m
9552,1,MOLcasker,2518,130,4,7,11,36.4%,20m
9552,3,쌔드레이서,2518,97,2,3,5,40.0%,25m
9560,1,misterbasic,2517,593,26,20,46,56.5%,20m
9560,1,qmdnp,2517,184,5,6,11,45.5%,19m
9560,1,서태지,2517,86,2,9,11,18.2%,20m
9560,1,홍어,2517,0,0,1,1,0.0%,23m
9564,1,금빛강자,2516,1067,97,97,194,50.0%,19m
9565,1,goodtime,2515,973,36,33,69,52.2%,20m
9565,2,토지대장,2515,280,12,11,23,52.2%,27m
9565,2,hiahiahia,2515,198,5,5,10,50.0%,27m
9565,1,세모네모동동,2515,118,3,1,4,75.0%,46m
9565,1,傳奇,2515,134,3,6,9,33.3%,19m
9565,1,소심한마술사,2515,84,3,7,10,30.0%,20m
9571,1,betonamu,2514,694,82,76,158,51.9%,20m
9571,1,치킨왕맛초킹,2514,950,29,33,62,46.8%,21m
9571,1,[노벽]핑구,2514,292,13,12,25,52.0%,21m
9571,1,[김밥과라면]lIlIlIlIlIlI,2514,230,7,9,16,43.8%,24m
9571,1,[즐겜러]중립,2514,202,5,3,8,62.5%,20m
9571,3,개구리루시우,2514,0,1,1,2,50.0%,24m
9571,1,Nick,2514,0,1,5,6,16.7%,46m
9578,3,hasamasa,2513,1528,175,186,361,48.5%,53m
9578,1,탱구,2513,217,6,7,13,46.2%,24m
9578,1,유사알파카,2513,166,4,4,8,50.0%,19m
9578,1,Kotgoin,2513,0,1,1,2,50.0%,20m
9578,1,주와니,2513,42,1,1,2,50.0%,23m
9583,1,트리윈,2512,1702,76,70,146,52.1%,20m
9583,1,STALKER,2512,142,4,4,8,50.0%,47m
9583,1,김국비,2512,120,3,3,6,50.0%,19m
9583,1,juwon,2512,107,2,1,3,66.7%,46m
9583,2,[액티브]패시브,2512,48,2,5,7,28.6%,22m
9583,2,HelloKitty,2512,0,1,4,5,20.0%,22m
9583,1,nada,2512,0,1,4,5,20.0%,19m
9590,1,lokost,2511,1265,155,155,310,50.0%,19m
9590,1,Dros,2511,1749,104,98,202,51.5%,20m
9590,1,여진철,2511,1042,39,33,72,54.2%,20m
9590,1,Scv,2511,936,33,35,68,48.5%,46m
9590,2,대박,2511,826,31,35,66,47.0%,48m
9590,1,早晨,2511,399,13,16,29,44.8%,19m
9590,1,Andrew,2511,232,8,11,19,42.1%,46m
9590,3,[TalenT]STALKER,2511,112,3,3,6,50.0%,47m
9590,1,김치워리어,2511,86,2,4,6,33.3%,47m
9590,1,TORY,2511,0,0,1,1,0.0%,46m
9600,1,후로게이머,2510,444,16,15,31,51.6%,46m
9600,1,째마리,2510,566,16,20,36,44.4%,19m
9600,2,IllusiveMan,2510,146,9,9,18,50.0%,26m
9600,1,[日本]IIIIIIIIIIII,2510,219,8,2,10,80.0%,20m
9600,3,로가세,2510,190,8,13,21,38.1%,25m
9600,1,다리는다뤼다뤼,2510,145,4,5,9,44.4%,23m
9600,1,앙기모띠,2510,74,3,3,6,50.0%,20m
9600,1,길가다주었다,2510,97,3,4,7,42.9%,46m
9600,3,이준우,2510,0,3,7,10,30.0%,26m
9600,1,무시무시한쥐,2510,0,0,1,1,0.0%,20m
9610,1,dlqldlsgnrhk,2509,1758,79,77,156,50.6%,20m
9610,1,로봇자객,2509,1082,38,37,75,50.7%,20m
9610,3,陳幸祥,2509,759,31,35,66,47.0%,53m
9610,1,nullda,2509,656,30,34,64,46.9%,19m
9610,1,anjo,2509,48,4,7,11,36.4%,24m
9610,3,FinSh,2509,0,0,5,5,0.0%,41m
9616,1,[NoME]tomatococo,2508,1073,37,35,72,51.4%,47m
9616,3,일꾼종결자,2508,290,10,12,22,45.5%,47m
9616,1,battleRoyal,2508,76,3,8,11,27.3%,19m
9616,1,火雲邪神,2508,0,2,3,5,40.0%,19m
9616,1,TheWarlord,2508,0,1,4,5,20.0%,46m
9616,3,onionkinght,2508,0,0,1,1,0.0%,24m
9622,1,점검전,2507,840,31,29,60,51.7%,19m
9622,1,Marcos,2507,91,2,1,3,66.7%,20m
9624,1,demonixc,2506,603,19,18,37,51.4%,19m
9624,1,치르노,2506,636,19,24,43,44.2%,47m
9624,1,[맛있더라]ForEveR,2506,436,12,10,22,54.5%,46m
9624,3,[아무나들어와]yullyous,2506,145,6,5,11,54.5%,25m
9624,1,애봉이,2506,281,6,9,15,40.0%,20m
9624,1,Hazard,2506,133,4,7,11,36.4%,46m
9624,2,IntoTheAiur,2506,0,2,3,5,40.0%,22m
9624,2,십육호,2506,97,2,4,6,33.3%,22m
9624,1,찬란한역사,2506,0,2,4,6,33.3%,46m
9624,1,waver,2506,30,1,2,3,33.3%,20m
9634,1,NiceGuy,2505,1717,154,150,304,50.7%,19m
9634,1,레박,2505,122,3,1,4,75.0%,19m
9634,1,mrSEO,2505,152,3,2,5,60.0%,20m
9634,1,尼科斯,2505,42,3,2,5,60.0%,46m
9634,2,Alligator,2505,48,2,5,7,28.6%,22m
9634,1,스팀펙쪽쪽,2505,0,1,1,2,50.0%,20m
9640,1,베다,2504,231,9,2,11,81.8%,46m
9640,1,타리우니,2504,125,4,2,6,66.7%,20m
9640,1,[우연]박종웅,2504,0,1,2,3,33.3%,24m
9640,2,[Nyaa]HUAWEI,2504,0,0,2,2,0.0%,22m
9644,3,ALILU,2503,96,3,6,9,33.3%,53m
9644,1,부엉이성애자,2503,0,2,2,4,50.0%,19m
9644,1,고준희,2503,0,2,4,6,33.3%,24m
9644,1,왱알앵알,2503,0,2,6,8,25.0%,23m
9644,1,호놀룰루,2503,0,1,4,5,20.0%,46m
9644,1,MrMore,2503,0,1,4,5,20.0%,19m
9650,1,Star,2502,1237,119,113,232,51.3%,20m
9650,3,[ReFocs]박봄,2502,478,29,42,71,40.8%,5m
9650,1,짜잔,2502,207,8,5,13,61.5%,19m
9650,1,StarJiggy,2502,194,5,6,11,45.5%,24m
9654,3,라온,2501,1457,71,83,154,46.1%,53m
9654,1,길리슈트,2501,1231,65,63,128,50.8%,20m
9654,1,keepthepace,2501,1355,49,54,103,47.6%,20m
9654,1,winteriscom,2501,944,39,38,77,50.6%,20m
9654,1,뭘봐뭐봐,2501,878,30,28,58,51.7%,20m
9654,1,[코드ASS]니콜워터슨,2501,440,13,11,24,54.2%,20m
9654,1,qwer,2501,138,4,5,9,44.4%,46m
9654,1,백병원수석환자,2501,48,1,2,3,33.3%,24m
9654,1,[26990]mooo,2501,34,1,5,6,16.7%,19m
9654,3,[RAON모여]쑥나물,2501,0,0,1,1,0.0%,24m
9664,2,Derosa,2500,1214,113,126,239,47.3%,52m
9664,2,[국가정보원]푸스로다,2500,1200,71,74,145,49.0%,53m
9664,1,darq,2500,868,29,34,63,46.0%,46m
9664,1,카탄,2500,561,21,20,41,51.2%,47m
9664,1,[공허거주]대박이야,2500,88,2,0,2,100.0%,21m
9664,1,[Xtreme]zywoo,2500,0,1,0,1,100.0%,19m
9664,2,용대장,2500,48,1,3,4,25.0%,22m
9664,1,esql,2500,0,0,1,1,0.0%,46m
9664,1,[呼叫贱队]AlphaStarfan,2500,0,0,1,1,0.0%,19m
9673,1,dritz,2499,1780,115,116,231,49.8%,47m
9673,1,bjj,2499,1717,101,110,211,47.9%,21m
9673,1,Bear,2499,382,21,24,45,46.7%,19m
9673,1,雷諾突擊長,2499,507,19,19,38,50.0%,46m
9673,1,솔낭,2499,130,5,3,8,62.5%,46m
9673,2,자킨,2499,96,2,4,6,33.3%,22m
9673,1,[日本]IIIIIIIIIIII,2499,0,1,0,1,100.0%,19m
9673,1,CAREN,2499,0,1,5,6,16.7%,20m
9681,1,Jekang,2498,260,20,18,38,52.6%,20m
9681,1,WLL,2498,405,12,11,23,52.2%,19m
9681,2,DPKH,2498,88,3,4,7,42.9%,47m
9681,3,Firepower,2498,45,3,6,9,33.3%,25m
9681,1,[SofT]SKTFaker,2498,0,2,3,5,40.0%,46m
9686,1,원잠프스매싱,2497,791,31,31,62,50.0%,46m
9686,2,민기민기몬,2497,0,2,3,5,40.0%,23m
9688,1,dsad,2496,316,11,12,23,47.8%,19m
9688,1,매운설탕,2496,303,8,7,15,53.3%,47m
9688,1,LMDuc,2496,40,1,4,5,20.0%,46m
9688,2,zakaroo,2496,0,1,4,5,20.0%,22m
9688,1,[好難過好想哭]鈴鈴很可愛,2496,0,0,1,1,0.0%,19m
9693,3,stuck,2495,1207,145,151,296,49.0%,21m
9693,1,[어둠의사신단]chldnlska,2495,1530,86,97,183,47.0%,46m
9693,1,꼬봉마왕,2495,849,29,29,58,50.0%,19m
9693,1,[Aoueja]이원빈,2495,274,8,9,17,47.1%,28m
9693,1,ShinyHero,2495,147,3,5,8,37.5%,46m
9693,1,[EEG]Maverick,2495,0,1,0,1,100.0%,20m
9693,1,[krtag]handsome,2495,0,1,3,4,25.0%,20m
9700,1,BraveMarine,2494,1440,119,129,248,48.0%,20m
9700,1,llllllllllll,2494,384,22,14,36,61.1%,19m
9700,1,稀饭,2494,463,19,23,42,45.2%,20m
9700,1,키레트키,2494,375,10,13,23,43.5%,19m
9700,1,woddj,2494,36,1,5,6,16.7%,46m
9705,1,chan,2493,1758,447,473,920,48.6%,20m
9705,1,water,2493,373,13,10,23,56.5%,46m
9705,1,DouBleNi,2493,340,12,14,26,46.2%,46m
9705,1,lonxlee,2493,131,4,6,10,40.0%,46m
9705,1,[유즈맵아이들]kdh,2493,34,2,2,4,50.0%,21m
9705,1,[요사키클랜]연타맨,2493,0,1,4,5,20.0%,46m
9711,1,[mary]KAY,2492,226,7,11,18,38.9%,20m
9711,1,청개구리,2492,30,3,4,7,42.9%,47m
9711,1,로로,2492,0,2,4,6,33.3%,47m
9711,2,스카보우,2492,0,1,0,1,100.0%,27m
9711,1,Takao,2492,0,1,1,2,50.0%,20m
9711,1,발광하는매미,2492,46,1,7,8,12.5%,47m
9711,2,짐레이너가간다,2492,0,0,1,1,0.0%,22m
9711,1,YuudachiKai,2492,0,0,1,1,0.0%,24m
9719,1,log,2491,1383,63,66,129,48.8%,20m
9719,1,joseisamurai,2491,919,32,31,63,50.8%,46m
9719,1,IIIIIIIIIII,2491,324,15,17,32,46.9%,46m
9719,1,탁마에,2491,40,3,5,8,37.5%,47m
9719,2,레어닉네임,2491,96,3,6,9,33.3%,23m
9719,2,짐레이너,2491,32,2,4,6,33.3%,46m
9719,2,드라군그자체,2491,0,1,0,1,100.0%,46m
9719,1,RelaxZerg,2491,0,0,2,2,0.0%,19m
9719,1,silentsword,2491,0,0,3,3,0.0%,21m
9728,3,태영이는은희꺼,2490,1447,314,366,680,46.2%,21m
9728,1,막시무스,2490,196,5,13,18,27.8%,20m
9728,2,shemin,2490,0,0,1,1,0.0%,46m
9731,1,신화가된임황제,2489,1735,185,200,385,48.1%,46m
9731,1,Jack,2489,1746,72,75,147,49.0%,21m
9731,1,jimie,2489,516,14,14,28,50.0%,46m
9731,1,Scenter,2489,374,11,9,20,55.0%,19m
9731,1,vision,2489,163,4,4,8,50.0%,46m
9731,1,Nolan,2489,0,0,2,2,0.0%,20m
9737,1,SeoNo,2488,164,7,8,15,46.7%,20m
9737,1,날빌장인,2488,184,6,2,8,75.0%,20m
9737,1,bert,2488,153,5,8,13,38.5%,46m
9737,2,Sirienna,2488,92,4,5,9,44.4%,46m
9737,1,Mercury,2488,96,4,8,12,33.3%,24m
9737,2,nakiller,2488,0,1,1,2,50.0%,22m
9737,1,Heart,2488,34,1,3,4,25.0%,19m
9744,1,할리와스타투맨,2487,796,106,104,210,50.5%,20m
9744,1,lttlboy,2487,1570,94,89,183,51.4%,19m
9744,1,captainlordz,2487,718,63,51,114,55.3%,19m
9744,2,[OKRAN]아뇨뚱인데요,2487,366,13,6,19,68.4%,26m
9744,1,rovfl,2487,137,3,2,5,60.0%,20m
9749,3,뭐여이거지는,2486,792,26,39,65,40.0%,21m
9749,1,sevenblue,2486,516,18,18,36,50.0%,20m
9749,3,Silkworm,2486,421,15,20,35,42.9%,47m
9749,2,뽀뽀뽕,2486,210,6,2,8,75.0%,27m
9749,1,아이유,2486,0,3,7,10,30.0%,50m
9754,2,사쿠라스,2485,1002,37,32,69,53.6%,27m
9754,1,[옹선생님]민시기입니다,2485,357,11,10,21,52.4%,19m
9754,1,다크왕,2485,213,9,9,18,50.0%,46m
9754,2,Smilyman,2485,58,6,1,7,85.7%,46m
9754,1,AJMT,2485,103,3,2,5,60.0%,19m
9754,1,이름,2485,107,2,2,4,50.0%,47m
9754,1,ElSoul,2485,0,1,4,5,20.0%,46m
9754,2,craig,2485,0,0,1,1,0.0%,26m
9754,2,[비트]太空來的鴨子,2485,0,0,1,1,0.0%,27m
9763,1,lIIllIlllIll,2484,171,6,4,10,60.0%,20m
9763,1,망고향,2484,102,5,7,12,41.7%,46m
9763,1,echakz,2484,0,1,2,3,33.3%,47m
9763,2,사랑은,2484,0,0,1,1,0.0%,18m
9763,2,[GITS]timba,2484,0,0,1,1,0.0%,27m
9768,1,ngothanhtung,2483,1738,187,185,372,50.3%,19m
9768,1,뉴메타충,2483,1713,71,77,148,48.0%,20m
9768,1,Spiral,2483,340,10,15,25,40.0%,20m
9768,1,DIO,2483,97,3,4,7,42.9%,19m
9768,2,asdf,2483,141,3,5,8,37.5%,22m
9773,1,ddaya,2482,1664,160,163,323,49.5%,20m
9773,3,Stmaker,2482,705,27,32,59,45.8%,21m
9773,2,musuri,2482,350,12,6,18,66.7%,18m
9773,2,[중금속중독자]알게뭐야,2482,168,6,2,8,75.0%,28m
9773,1,청소년이용불가,2482,210,4,13,17,23.5%,46m
9773,3,벤렌,2482,30,2,0,2,100.0%,26m
9773,2,데미소다,2482,0,2,2,4,50.0%,23m
9773,2,잘생긴너의생김새,2482,0,2,3,5,40.0%,46m
9773,1,Goxellot,2482,0,2,4,6,33.3%,46m
9773,2,화끈하게,2482,0,0,1,1,0.0%,22m
9783,1,[zAWSLz]阿森,2481,246,7,5,12,58.3%,20m
9783,1,Continue,2481,200,5,8,13,38.5%,47m
9783,2,NaYa,2481,0,0,1,1,0.0%,27m
9783,2,트래버,2481,0,0,1,1,0.0%,27m
9787,3,[怕死的死神]歐皇界的歐神,2480,194,6,5,11,54.5%,26m
9787,1,그런건없다,2480,60,5,9,14,35.7%,49m
9787,2,IMBOOD,2480,48,3,4,7,42.9%,22m
9790,1,강철주먹김준우,2479,1675,226,244,470,48.1%,19m
9790,1,회오리날개아빠,2479,282,8,8,16,50.0%,20m
9790,1,못말리는전사,2479,191,6,6,12,50.0%,24m
9790,1,遁電,2479,164,5,7,12,41.7%,46m
9790,1,Pure,2479,162,4,4,8,50.0%,47m
9790,2,태훈장군,2479,0,2,3,5,40.0%,18m
9790,1,IIIIIIIIIIII,2479,0,0,2,2,0.0%,19m
9797,1,Zernex,2478,1747,67,66,133,50.4%,19m
9797,2,행식,2478,1517,63,56,119,52.9%,18m
9797,1,BadCorona,2478,418,11,18,29,37.9%,46m
9797,2,[禿頭肥寶]keithL,2478,0,3,2,5,60.0%,23m
9797,2,llllllllllll,2478,0,0,1,1,0.0%,26m
9797,1,라이네이돌이,2478,0,0,2,2,0.0%,20m
9803,1,Fyr,2477,1719,96,91,187,51.3%,21m
9803,3,부득이,2477,1048,75,71,146,51.4%,21m
9803,3,wildpuppy,2477,661,51,56,107,47.7%,21m
9803,3,크릴새우꺽기,2477,275,9,12,21,42.9%,25m
9803,1,[호박고구마]칠삼오유기,2477,211,7,4,11,63.6%,47m
9803,1,하늘,2477,96,5,8,13,38.5%,23m
9803,1,aksska,2477,182,5,11,16,31.2%,20m
9803,1,탈영병,2477,114,4,10,14,28.6%,47m
9803,1,lifeline,2477,78,3,5,8,37.5%,19m
9803,1,저거노트,2477,0,0,1,1,0.0%,24m
9803,1,kkkkkkkkkkkk,2477,0,0,9,9,0.0%,47m
9814,3,JGWOLF,2476,1465,237,236,473,50.1%,21m
9814,1,porknuckles,2476,1735,173,189,362,47.8%,20m
9814,1,PUNGSHIN,2476,388,13,12,25,52.0%,20m
9814,1,GreNade,2476,287,7,8,15,46.7%,23m
9814,2,Queen,2476,110,4,2,6,66.7%,26m
9814,1,boxer,2476,32,2,4,6,33.3%,20m
9814,1,시카유리,2476,73,0,4,4,0.0%,19m
9821,1,전차승원,2475,533,21,22,43,48.8%,21m
9821,1,노무현짱,2475,401,10,17,27,37.0%,46m
9821,1,블랙,2475,44,1,4,5,20.0%,20m
9824,3,야임마가짜,2474,234,10,13,23,43.5%,47m
9824,3,Scrpixel,2474,273,10,14,24,41.7%,25m
9824,3,사도요한,2474,222,8,10,18,44.4%,21m
9824,2,[엉돈PD]AugustusHD,2474,138,5,1,6,83.3%,46m
9824,3,gagroshe,2474,147,4,7,11,36.4%,25m
9824,1,초딩킬러,2474,84,3,4,7,42.9%,19m
9824,2,Caliburan,2474,0,2,3,5,40.0%,22m
9824,3,[구미호부대]나랑께예들아,2474,0,1,0,1,100.0%,25m
9824,1,배코,2474,0,1,3,4,25.0%,20m
9833,1,식혜,2473,823,24,28,52,46.2%,19m
9833,2,[원탑1st]꼬미,2473,262,10,4,14,71.4%,27m
9833,1,SpecialForce,2473,255,9,17,26,34.6%,20m
9833,1,IIIIIIIIIIII,2473,74,2,7,9,22.2%,19m
9833,2,skuLlz,2473,0,1,0,1,100.0%,22m
9833,2,[신개미협회]사칭,2473,44,1,1,2,50.0%,46m
9833,2,밀인랍형,2473,0,0,1,1,0.0%,22m
9833,2,칠산대교,2473,0,0,1,1,0.0%,46m
9833,1,sgh,2473,0,0,2,2,0.0%,24m
9842,3,명월,2472,1367,95,92,187,50.8%,21m
9842,2,ThomBrowne,2472,597,26,42,68,38.2%,48m
9842,1,TOFU,2472,409,18,22,40,45.0%,28m
9842,2,소드마스터베이션,2472,0,2,3,5,40.0%,23m
9842,2,chan,2472,0,1,1,2,50.0%,22m
9842,1,BoutTo,2472,0,1,5,6,16.7%,46m
9842,1,[중금속중독자]세용이,2472,0,0,3,3,0.0%,47m
9849,2,AsranJARA,2471,929,50,54,104,48.1%,52m
9849,1,NguyenDepZai,2471,1034,40,47,87,46.0%,20m
9849,1,너희어머,2471,612,19,18,37,51.4%,20m
9849,1,medccm,2471,566,15,19,34,44.1%,19m
9849,2,busansana,2471,378,12,13,25,48.0%,19m
9849,1,thinkingcell,2471,289,7,9,16,43.8%,19m
9849,1,InnerPeace,2471,82,2,6,8,25.0%,19m
9849,1,푸른별,2471,0,0,2,2,0.0%,19m
9857,1,KINGKONG,2470,830,31,27,58,53.4%,20m
9857,1,읭읭읭,2470,572,17,18,35,48.6%,19m
9857,2,asasasas,2470,0,2,1,3,66.7%,23m
9860,1,ero,2469,1741,94,86,180,52.2%,47m
9860,2,삼각조르기,2469,564,22,19,41,53.7%,46m
9860,1,[Arcade]FirstArcade,2469,144,5,6,11,45.5%,19m
9860,1,Mikely,2469,84,3,3,6,50.0%,20m
9860,2,김범석,2469,0,1,0,1,100.0%,26m
9860,2,[뒷세계사람들]blackmine,2469,0,1,0,1,100.0%,27m
9866,1,[sc2mc]albert,2468,707,27,22,49,55.1%,46m
9866,1,피볼까,2468,678,23,28,51,45.1%,28m
9866,1,끠슬,2468,329,8,12,20,40.0%,47m
9866,2,토리,2468,138,3,5,8,37.5%,22m
9866,2,Mayara,2468,32,1,1,2,50.0%,28m
9866,2,frolRU,2468,0,1,4,5,20.0%,27m
9872,1,ljseon,2467,1552,61,75,136,44.9%,20m
9872,3,[SClI]고오급히오스,2467,590,26,34,60,43.3%,53m
9872,1,이시국,2467,589,17,28,45,37.8%,19m
9872,1,yourlike,2467,436,12,15,27,44.4%,19m
9872,2,량키,2467,116,5,7,12,41.7%,47m
9872,1,mercywolf,2467,36,1,8,9,11.1%,19m
9872,2,Haims,2467,0,0,1,1,0.0%,46m
9872,2,Kareltjie,2467,0,0,1,1,0.0%,22m
9880,1,IAEA,2466,878,181,186,367,49.3%,21m
9880,2,사도,2466,610,27,22,49,55.1%,28m
9880,2,夜行者,2466,179,10,9,19,52.6%,26m
9880,1,우주함선,2466,138,5,9,14,35.7%,19m
9880,3,WeonShi,2466,30,4,5,9,44.4%,47m
9880,2,무꽃,2466,46,2,0,2,100.0%,22m
9880,2,dexjoke,2466,62,2,4,6,33.3%,27m
9880,1,vam,2466,0,0,1,1,0.0%,24m
9880,1,[거긴안돼]김태연,2466,0,0,3,3,0.0%,46m
9880,1,장아담이오셨다,2466,0,0,5,5,0.0%,19m
9890,1,빠쌰,2465,1688,132,129,261,50.6%,20m
9890,1,끼룩끼룩,2465,1188,42,53,95,44.2%,50m
9890,1,PartyBro,2465,494,20,23,43,46.5%,19m
9890,1,[콩나물]꼬미,2465,331,12,9,21,57.1%,46m
9890,1,艾格拉斯,2465,251,8,11,19,42.1%,19m
9890,3,gentleboy,2465,230,8,17,25,32.0%,47m
9890,1,mobzilla,2465,204,5,6,11,45.5%,46m
9890,2,제갈공명,2465,152,4,5,9,44.4%,46m
9890,1,컴퓨터,2465,122,3,7,10,30.0%,20m
9890,2,폭군,2465,0,1,1,2,50.0%,18m
9890,1,매너좋은상디씨,2465,32,1,6,7,14.3%,46m
9901,1,[적토마]적토마아,2464,802,25,29,54,46.3%,20m
9901,1,[ECLS]여우비가오던봄,2464,318,12,10,22,54.5%,47m
9901,2,WIN,2464,143,3,2,5,60.0%,46m
9901,1,[Mist]SunLightProv,2464,88,2,1,3,66.7%,47m
9901,2,Schneider,2464,0,1,4,5,20.0%,27m
9901,2,레알이니,2464,0,0,1,1,0.0%,22m
9907,3,[NCSI]MoM,2463,782,25,40,65,38.5%,53m
9907,3,[특수수색대]llllllllllll,2463,520,17,35,52,32.7%,47m
9907,2,[싱싱한뉴비]llllllllllll,2463,0,1,0,1,100.0%,27m
9907,2,Mitch,2463,44,1,1,2,50.0%,22m
9907,1,WhySoSerious,2463,0,0,3,3,0.0%,24m
9912,1,돼지불백이승우,2462,531,17,17,34,50.0%,20m
9912,1,Void,2462,149,6,6,12,50.0%,20m
9912,2,fff,2462,94,5,5,10,50.0%,22m
9912,2,김대환,2462,0,1,1,2,50.0%,46m
9916,3,tien,2461,1398,194,198,392,49.5%,21m
9916,1,jamesoppa,2461,657,25,31,56,44.6%,28m
9916,2,choiyg,2461,404,14,10,24,58.3%,46m
9916,3,[비트]오버마인드,2461,255,9,2,11,81.8%,25m
9916,1,Shiro,2461,269,9,11,20,45.0%,46m
9916,2,[NLTN]이슬로즈,2461,42,2,1,3,66.7%,27m
9916,1,kiss,2461,46,2,3,5,40.0%,24m
9916,1,[IGD]갓승훈,2461,105,2,4,6,33.3%,46m
9916,2,[죽데]죽음의데스,2461,0,1,0,1,100.0%,23m
9916,2,IIIIIIIIIIII,2461,0,1,4,5,20.0%,46m
9926,1,mgltur,2460,1732,73,84,157,46.5%,20m
9926,2,김욱상,2460,140,5,3,8,62.5%,27m
9926,2,kangtaemin,2460,126,5,3,8,62.5%,26m
9926,1,blood,2460,164,4,3,7,57.1%,19m
9926,1,Amai,2460,116,4,9,13,30.8%,47m
9926,2,무버지,2460,0,1,4,5,20.0%,23m
9926,1,HHHZM,2460,0,0,2,2,0.0%,23m
9933,1,지보,2459,305,15,15,30,50.0%,19m
9933,3,ysangwoong,2459,60,5,7,12,41.7%,21m
9933,2,Equinox,2459,0,2,4,6,33.3%,23m
9936,2,부왘,2458,1585,248,277,525,47.2%,26m
9936,2,无关阿达温柔,2458,1054,38,48,86,44.2%,52m
9936,1,[SC2CPP]TGP,2458,630,17,25,42,40.5%,20m
9936,1,푸틴,2458,128,6,11,17,35.3%,46m
9936,1,찬샘,2458,155,4,7,11,36.4%,46m
9936,2,정력가,2458,0,1,1,2,50.0%,26m
9936,2,youngdae,2458,30,1,1,2,50.0%,27m
9936,1,KiraYamato,2458,0,1,5,6,16.7%,46m
9944,2,할배후려치기,2457,316,10,11,21,47.6%,27m
9944,2,iNsEURNG,2457,70,3,2,5,60.0%,27m
9944,2,城牆,2457,30,2,0,2,100.0%,27m
9947,1,llllllllllll,2456,272,56,57,113,49.6%,20m
9947,1,[협동으로가자]장난치나주글래,2456,1035,44,41,85,51.8%,46m
9947,2,BleuOceane,2456,88,6,3,9,66.7%,46m
9947,1,light,2456,119,3,0,3,100.0%,24m
9947,2,탁동경,2456,86,3,2,5,60.0%,27m
9947,1,PAVSI,2456,0,2,5,7,28.6%,46m
9947,2,훈윤,2456,46,1,3,4,25.0%,22m
9954,1,RedKing,2455,793,46,42,88,52.3%,21m
9954,1,伝說之夢,2455,509,34,26,60,56.7%,20m
9954,1,안뇽,2455,185,8,9,17,47.1%,46m
9954,1,hackmozzi,2455,227,7,10,17,41.2%,20m
9954,2,lutarez,2455,160,6,2,8,75.0%,19m
9954,1,OCT,2455,116,4,6,10,40.0%,21m
9954,2,문지기,2455,0,2,4,6,33.3%,23m
9954,2,배만월,2455,0,1,5,6,16.7%,22m
9954,1,남블님,2455,38,1,8,9,11.1%,20m
9954,2,니어머니이윤진,2455,0,0,1,1,0.0%,27m
9964,3,FURY,2454,462,17,26,43,39.5%,53m
9964,1,저그,2454,172,6,8,14,42.9%,46m
9964,2,[SevenT]호롤롤로,2454,58,5,2,7,71.4%,46m
9964,2,Leo,2454,30,1,1,2,50.0%,46m
9964,2,MrWirds,2454,0,1,4,5,20.0%,23m
9969,3,我的小女时代,2453,1448,63,69,132,47.7%,47m
9969,1,마이티보이,2453,239,20,18,38,52.6%,20m
9969,1,Fenrir,2453,253,9,7,16,56.2%,19m
9969,1,고리대금업자,2453,0,2,5,7,28.6%,24m
9969,2,MASTERXENON,2453,38,1,1,2,50.0%,26m
9969,1,[김정은SC]KimJongUn,2453,0,1,7,8,12.5%,19m
9969,1,Zestria,2453,0,0,5,5,0.0%,20m
9976,2,킹맨,2452,1296,49,43,92,53.3%,27m
9976,1,aqctotoytgas,2452,253,7,7,14,50.0%,20m
9976,1,딜러,2452,97,3,2,5,60.0%,24m
9976,3,Brotoss,2452,34,1,9,10,10.0%,24m
9976,2,파란만장,2452,0,0,2,2,0.0%,27m
9981,3,NIA,2451,1468,62,71,133,46.6%,21m
9981,2,SoulxJY,2451,124,4,5,9,44.4%,27m
9981,2,namron,2451,138,3,5,8,37.5%,22m
9984,1,모지래라,2450,1199,53,51,104,51.0%,20m
9984,3,WhiteSeed,2450,264,9,6,15,60.0%,25m
9984,1,[뭔가상큼한]GIGABYTE,2450,218,6,8,14,42.9%,20m
9984,2,존아여친,2450,48,2,5,7,28.6%,23m
9984,2,[sj3124]드래곤,2450,0,0,2,2,0.0%,27m
9989,3,jumptosky,2449,1225,67,74,141,47.5%,53m
9989,1,suning,2449,885,29,30,59,49.2%,19m
9989,3,Chaochi,2449,643,23,31,54,42.6%,21m
9989,1,viaD,2449,232,7,9,16,43.8%,20m
9993,2,Xero,2448,380,12,16,28,42.9%,27m
9993,1,hyukijang,2448,169,6,7,13,46.2%,47m
9993,1,top,2448,100,3,13,16,18.8%,20m
9993,2,[댕청]sHiaRin,2448,0,1,0,1,100.0%,27m
9993,2,하지,2448,0,0,1,1,0.0%,27m
9998,2,잘하고싶다,2447,0,2,3,5,40.0%,23m
9998,2,미칸,2447,0,1,0,1,100.0%,28m
9998,2,이코이,2447,0,0,1,1,0.0%,46m
10001,1,쩡이바라기,2446,1722,493,548,1041,47.4%,19m
10001,2,소리없는폭풍,2446,1616,86,84,170,50.6%,18m
10001,1,MoonLight,2446,488,71,78,149,47.7%,20m
10001,3,OTOPRU,2446,1051,34,49,83,41.0%,21m
10001,1,해리팍,2446,756,28,36,64,43.8%,49m
10001,2,Infernal,2446,516,18,14,32,56.2%,27m
10001,2,김정웅,2446,0,1,2,3,33.3%,22m
10008,1,dnjTmekdandy,2445,1688,251,264,515,48.7%,19m
10008,1,Booster,2445,590,23,22,45,51.1%,20m
10008,2,hEnOtAibOi,2445,356,13,7,20,65.0%,27m
10008,1,찰리진,2445,374,12,16,28,42.9%,47m
10008,1,NOBLE,2445,412,11,18,29,37.9%,19m
10008,1,동바리,2445,277,9,13,22,40.9%,47m
10008,1,[해양경비대]스타즐겜유저,2445,279,7,10,17,41.2%,23m
10008,2,[당근파]wkdsksdlfrjf,2445,72,2,4,6,33.3%,27m
10008,1,black,2445,0,1,3,4,25.0%,46m
10008,2,OneSet,2445,0,0,1,1,0.0%,27m
10008,2,어멋살려줘,2445,0,0,1,1,0.0%,23m
10019,1,[krtag]LTiger,2444,1470,134,135,269,49.8%,50m
10019,1,llllllllllll,2444,450,13,16,29,44.8%,47m
10019,2,[JOVi]포풍같은러쉬,2444,30,2,2,4,50.0%,46m
10022,1,[너의ol름은]봄봄,2443,1272,52,56,108,48.1%,46m
10022,3,IamTerran,2443,174,6,15,21,28.6%,48m
10022,1,황혼파괴,2443,60,5,9,14,35.7%,49m
10022,2,섹시우뇨니행님,2443,90,4,3,7,57.1%,27m
10022,1,클루츠,2443,193,4,3,7,57.1%,24m
10022,2,[TGOG]wchurjen,2443,138,3,2,5,60.0%,27m
10022,1,[AFO]칠만육천원,2443,114,3,11,14,21.4%,20m
10022,2,아버지,2443,0,0,1,1,0.0%,22m
10022,2,AVATAR,2443,0,0,2,2,0.0%,27m
10031,3,[sc2mc]본드코리아,2442,1477,203,196,399,50.9%,21m
10031,2,spirit,2442,414,17,17,34,50.0%,46m
10031,2,주작작주작작,2442,286,12,18,30,40.0%,52m
10031,2,에프킬라무향,2442,242,9,5,14,64.3%,27m
10031,1,Nilz,2442,114,3,6,9,33.3%,46m
10036,1,지금은사아,2441,1349,92,103,195,47.2%,47m
10036,3,HJstyle,2441,148,7,10,17,41.2%,47m
10036,3,[무한김준현]INnoVation,2441,90,5,10,15,33.3%,21m
10036,1,코난친구,2441,114,4,8,12,33.3%,19m
10040,1,當媽祖愛上耶穌,2440,913,43,42,85,50.6%,28m
10040,1,듀크,2440,498,22,13,35,62.9%,19m
10040,2,GEES,2440,247,10,10,20,50.0%,28m
10040,1,우박,2440,198,7,10,17,41.2%,28m
10040,2,윤뽀씨,2440,40,2,2,4,50.0%,26m
10040,1,llllllllllll,2440,30,2,4,6,33.3%,20m
10040,2,[WTSC]MillA,2440,0,0,1,1,0.0%,46m
10040,2,망사망사막강,2440,0,0,1,1,0.0%,27m
10048,3,NDeySU,2439,657,53,74,127,41.7%,53m
10048,2,SecretPoo,2439,443,17,11,28,60.7%,27m
10048,1,lllllllllIl,2439,460,17,26,43,39.5%,49m
10048,1,ZwePleb,2439,220,6,12,18,33.3%,19m
10048,2,llllllllllll,2439,92,4,3,7,57.1%,27m
10048,1,민혁이는바보입니,2439,0,0,1,1,0.0%,24m
10048,2,不存在的定義,2439,0,0,1,1,0.0%,18m
10055,1,Kosmos,2438,1559,62,65,127,48.8%,46m
10055,2,Loin,2438,359,16,13,29,55.2%,27m
10055,3,권태민,2438,211,7,18,25,28.0%,7m
10055,2,[FAL]IlIllIIlIlII,2438,42,2,1,3,66.7%,27m
10055,2,twice,2438,0,1,0,1,100.0%,46m
10055,1,chun,2438,0,1,1,2,50.0%,24m
10061,1,[ELSII]가벼워진,2437,810,26,26,52,50.0%,46m
10061,2,공륙이,2437,554,20,21,41,48.8%,27m
10061,2,비빔면만들기,2437,280,17,8,25,68.0%,27m
10061,1,OGG,2437,74,4,7,11,36.4%,19m
10061,3,ltjdgur,2437,121,4,8,12,33.3%,25m
10061,2,TimESavE,2437,110,3,6,9,33.3%,28m
10061,1,[異化蟲公會]木質地板,2437,0,1,0,1,100.0%,23m
10061,2,스토믹,2437,0,1,4,5,20.0%,27m
10061,3,[SKYYY]BigHit,2437,0,0,1,1,0.0%,26m
10070,2,RaphaeL,2436,1140,49,40,89,55.1%,27m
10070,2,wuian,2436,83,3,4,7,42.9%,27m
10070,2,ddddddddd,2436,0,1,0,1,100.0%,26m
10070,2,Aurora,2436,0,0,1,1,0.0%,22m
10074,1,doctypeDT,2435,648,20,23,43,46.5%,28m
10074,1,Gcrown,2435,402,14,15,29,48.3%,47m
10074,1,[엄청잘생긴놈]원파스,2435,240,12,15,27,44.4%,20m
10074,2,버림당한여포,2435,294,9,5,14,64.3%,27m
10074,2,Zero,2435,168,7,8,15,46.7%,46m
10074,1,샌드롭,2435,180,4,6,10,40.0%,20m
10074,2,llllllllllll,2435,38,2,4,6,33.3%,26m
10074,2,다시내일,2435,0,1,3,4,25.0%,28m
10074,2,리나,2435,44,1,4,5,20.0%,18m
10074,2,Azo,2435,0,0,2,2,0.0%,27m
10084,2,LilByuN,2434,714,46,45,91,50.5%,27m
10084,2,XiGinPinkGay,2434,86,4,4,8,50.0%,46m
10084,2,onlystar,2434,30,2,0,2,100.0%,27m
10084,2,[우주하마]우주도마뱀,2434,0,0,1,1,0.0%,27m
10084,1,SpecEdu,2434,0,0,2,2,0.0%,23m
10084,1,라이숑,2434,0,0,2,2,0.0%,24m
10090,2,[CnB]랜덤끄지라,2433,1174,39,58,97,40.2%,51m
10090,1,grassjewel,2433,796,25,38,63,39.7%,20m
10090,1,메이저리그,2433,254,8,13,21,38.1%,19m
10090,1,王凱凱凱,2433,86,3,6,9,33.3%,19m
10090,3,써니,2433,30,1,13,14,7.1%,53m
10090,2,[갓모토팸]꽃따려오시오,2433,0,0,1,1,0.0%,27m
10096,2,희선공주님,2432,1142,45,45,90,50.0%,27m
10096,2,UltraOPlayer,2432,412,16,9,25,64.0%,46m
10096,1,我就爛,2432,122,4,10,14,28.6%,20m
10096,1,아카시아,2432,88,2,5,7,28.6%,28m
10096,2,Colombus,2432,0,0,1,1,0.0%,27m
10101,2,[조직]알코미,2431,1560,121,121,242,50.0%,26m
10101,3,말하고싶어,2431,275,10,14,24,41.7%,48m
10101,1,DOKKAEBI,2431,192,6,11,17,35.3%,24m
10101,1,pilot,2431,76,3,5,8,37.5%,20m
10101,2,skt,2431,36,2,2,4,50.0%,27m
10101,2,Cash,2431,40,1,4,5,20.0%,27m
10107,2,미친테란,2430,1136,45,34,79,57.0%,27m
10107,2,skynet,2430,938,32,38,70,45.7%,27m
10107,2,백호선,2430,228,8,8,16,50.0%,28m
10107,2,박상곤,2430,202,6,3,9,66.7%,27m
10107,2,SINON,2430,58,3,1,4,75.0%,27m
10112,1,lalrivunga,2429,903,41,42,83,49.4%,20m
10112,2,MST,2429,116,6,1,7,85.7%,46m
10112,1,ApekWick,2429,206,5,7,12,41.7%,19m
10112,2,llllllllllll,2429,0,1,0,1,100.0%,26m
10112,2,에르지야스,2429,0,0,1,1,0.0%,27m
10112,2,마재윤,2429,0,0,2,2,0.0%,27m
10118,2,스타족망겜,2428,68,4,4,8,50.0%,27m
10118,2,한발짝먼저,2428,0,1,2,3,33.3%,27m
10118,2,KeiKei,2428,0,1,4,5,20.0%,22m
10121,1,[안티신개미]아빠아빠아들,2427,428,15,20,35,42.9%,20m
10121,1,세젤예보현잉,2427,411,12,13,25,48.0%,46m
10121,1,Kellog,2427,388,11,18,29,37.9%,46m
10121,2,한스리,2427,76,2,1,3,66.7%,46m
10121,2,[반란]스투송이,2427,0,0,1,1,0.0%,27m
10121,2,yheeeyee,2427,0,0,1,1,0.0%,27m
10121,2,[저수지]stealth,2427,0,0,2,2,0.0%,28m
10128,1,DelPhi,2426,1488,54,61,115,47.0%,47m
10128,1,[Rebel]매직코스,2426,544,17,16,33,51.5%,19m
10128,1,인맥,2426,206,6,6,12,50.0%,19m
10128,2,수아연아,2426,74,3,3,6,50.0%,46m
10128,2,zoromerit,2426,30,2,1,3,66.7%,19m
10128,2,서울사이버대학교,2426,0,1,0,1,100.0%,19m
10128,2,deadatnight,2426,0,0,1,1,0.0%,22m
10135,1,하유선,2425,747,32,29,61,52.5%,46m
10135,2,Winger,2425,416,15,15,30,50.0%,19m
10135,2,집에가자,2425,122,5,3,8,62.5%,27m
10135,1,[NsP]우연,2425,115,4,10,14,28.6%,46m
10139,1,태권,2424,780,26,32,58,44.8%,19m
10139,1,Vulcan,2424,141,4,3,7,57.1%,47m
10139,2,wonderboy,2424,92,2,2,4,50.0%,23m
10139,1,[Apus]ZeroTwo,2424,0,1,2,3,33.3%,21m
10139,2,[내친구충창]수능쳤음,2424,0,0,1,1,0.0%,27m
10139,2,[DING]dingding,2424,0,0,1,1,0.0%,27m
10145,2,habitboy,2423,1512,78,89,167,46.7%,46m
10145,1,ICEDLeader,2423,850,34,35,69,49.3%,47m
10145,1,cclife,2423,232,6,11,17,35.3%,46m
10148,2,IIIIIIIIII,2422,403,17,10,27,63.0%,27m
10148,2,stuka,2422,0,1,4,5,20.0%,22m
10148,2,PelPuska,2422,0,0,1,1,0.0%,22m
10151,1,알비,2421,1505,1087,1197,2284,47.6%,51m
10151,1,무요,2421,1653,67,68,135,49.6%,21m
10151,2,Leesy,2421,589,28,33,61,45.9%,27m
10151,1,sxs,2421,36,5,3,8,62.5%,21m
10151,2,[스타놀이터]Goldenman,2421,144,5,5,10,50.0%,27m
10151,1,youmother,2421,0,3,6,9,33.3%,23m
10151,1,jepoyzters,2421,48,3,8,11,27.3%,24m
10151,2,오징오징,2421,0,1,1,2,50.0%,19m
10151,2,Legion,2421,0,0,2,2,0.0%,23m
10151,1,Doablesole,2421,0,0,2,2,0.0%,46m
10161,2,入伍生,2420,214,8,4,12,66.7%,46m
10161,1,BlastySpice,2420,267,7,9,16,43.8%,23m
10161,1,STAR,2420,142,4,5,9,44.4%,19m
10161,1,오뉴얼나,2420,0,1,1,2,50.0%,21m
10165,1,이국주팬티스타킹,2419,1568,92,82,174,52.9%,46m
10165,2,naraka,2419,952,36,38,74,48.6%,19m
10165,2,발전하다,2419,114,4,7,11,36.4%,28m
10165,1,뽀니,2419,0,2,4,6,33.3%,23m
10165,2,魏小虎,2419,0,2,4,6,33.3%,23m
10165,2,ErwinRommel,2419,0,1,1,2,50.0%,19m
10165,2,Happyperson,2419,0,1,1,2,50.0%,26m
10165,2,팽창,2419,0,0,2,2,0.0%,23m
10173,1,kokoko,2418,1429,56,53,109,51.4%,47m
10173,1,막강한자,2418,782,33,25,58,56.9%,46m
10173,2,구건모,2418,186,7,7,14,50.0%,27m
10173,1,[반항소대]마린,2418,30,4,10,14,28.6%,49m
10173,3,그림톰,2418,58,3,8,11,27.3%,26m
10173,2,Ghost,2418,68,2,2,4,50.0%,28m
10179,2,LiCo,2417,444,19,11,30,63.3%,46m
10179,1,대한의건아,2417,362,16,19,35,45.7%,20m
10179,1,스타사령관,2417,294,8,14,22,36.4%,20m
10179,1,poormary,2417,265,8,18,26,30.8%,19m
10179,2,류대표,2417,30,2,1,3,66.7%,27m
10179,2,라잇나웃,2417,0,0,2,2,0.0%,22m
10185,1,너를훔칠래,2416,1324,52,46,98,53.1%,46m
10185,1,小之大余,2416,881,35,42,77,45.5%,20m
10185,1,수연사랑,2416,660,23,29,52,44.2%,19m
10185,1,옥휘찬,2416,159,6,4,10,60.0%,24m
10185,1,시소타기,2416,150,5,6,11,45.5%,24m
10185,2,jkkim,2416,112,3,0,3,100.0%,46m
10185,2,몽둥이,2416,32,2,2,4,50.0%,27m
10185,3,QiNTiQ,2416,0,0,14,14,0.0%,25m
10193,3,LogicWisdom,2415,1175,221,239,460,48.0%,8m
10193,2,Mirunamu,2415,1636,67,66,133,50.4%,27m
10193,2,KUKULULU,2415,320,9,14,23,39.1%,27m
10193,2,구름은하얀색,2415,0,3,4,7,42.9%,23m
10197,1,chasong,2414,1067,47,46,93,50.5%,47m
10197,2,ROYAL,2414,930,35,41,76,46.1%,48m
10197,2,세라장군,2414,372,12,12,24,50.0%,27m
10197,2,HotS,2414,95,2,4,6,33.3%,22m
10197,2,살살좀요,2414,0,0,2,2,0.0%,46m
10202,1,miguel,2413,856,28,34,62,45.2%,47m
10202,2,강뱅구,2413,592,20,28,48,41.7%,27m
10202,1,Astrology,2413,188,4,7,11,36.4%,20m
10202,2,Tizza,2413,86,3,5,8,37.5%,28m
10202,2,[OzZiE]kerrigan,2413,0,1,4,5,20.0%,46m
10202,2,조르지호,2413,0,1,4,5,20.0%,27m
10202,2,GanANe,2413,0,0,1,1,0.0%,23m
10209,1,ndddiiie,2412,556,16,19,35,45.7%,21m
10209,2,jelly,2412,145,2,8,10,20.0%,46m
10209,2,[오버유]Leopard,2412,0,0,1,1,0.0%,19m
10209,2,부카니스탄,2412,0,0,2,2,0.0%,27m
10213,1,Jack,2411,1695,158,173,331,47.7%,20m
10213,1,[anime]zdgzdgyet,2411,664,57,57,114,50.0%,28m
10213,1,橄欖趴,2411,238,7,11,18,38.9%,24m
10213,1,Andy,2411,144,5,9,14,35.7%,23m
10213,1,Niko,2411,32,3,5,8,37.5%,47m
10213,2,ArchoN,2411,0,1,0,1,100.0%,46m
10213,2,FATCRAB,2411,0,0,1,1,0.0%,46m
10220,1,유후유뱀육수,2410,1560,107,103,210,51.0%,46m
10220,1,맛나는치킨,2410,909,60,64,124,48.4%,21m
10220,2,ponpon,2410,424,15,14,29,51.7%,46m
10220,1,whhud,2410,421,15,16,31,48.4%,46m
10220,3,지가브,2410,236,7,11,18,38.9%,25m
10220,1,[LQV]강갱이,2410,214,6,11,17,35.3%,21m
10220,2,anomysg,2410,62,3,2,5,60.0%,27m
10227,2,anseodang,2409,402,16,15,31,51.6%,46m
10227,2,까투리소주,2409,0,1,2,3,33.3%,27m
10227,2,Hexe,2409,0,0,1,1,0.0%,19m
10230,2,marin,2408,448,17,19,36,47.2%,19m
10230,1,빡머가리사령관,2408,213,14,10,24,58.3%,21m
10230,2,맥도날드,2408,160,5,6,11,45.5%,46m
10230,2,[中國病毒]Kelifu,2408,64,3,3,6,50.0%,27m
10234,1,아스타티스,2407,786,31,34,65,47.7%,49m
10234,2,Remark,2407,116,7,13,20,35.0%,27m
10234,1,혹도,2407,126,5,8,13,38.5%,24m
10234,2,[0922]ssdia,2407,157,3,2,5,60.0%,22m
10234,2,봄봄봄,2407,60,3,3,6,50.0%,27m
10239,1,GOLD,2406,1158,56,55,111,50.5%,28m
10239,1,아니이이,2406,982,35,34,69,50.7%,47m
10239,2,RickyH,2406,366,12,12,24,50.0%,27m
10239,2,TAYLOR,2406,142,4,8,12,33.3%,27m
10239,2,안면어글,2406,0,3,2,5,60.0%,46m
10239,2,GALACTiC,2406,46,3,5,8,37.5%,22m
10239,1,[机智的犀牛]妈个鸡泰伦,2406,96,2,1,3,66.7%,24m
10239,2,[IGOM]파란가을비,2406,0,1,0,1,100.0%,26m
10239,2,윤문섭흑인,2406,0,1,4,5,20.0%,23m
10239,2,HakunaMatata,2406,0,1,4,5,20.0%,22m
10249,1,Owlbbame,2405,448,14,18,32,43.8%,46m
10249,2,[凸凸凸凸凸]choieunseok,2405,186,7,4,11,63.6%,28m
10249,2,AIR,2405,30,1,2,3,33.3%,26m
10249,1,NURUNURU,2405,48,1,3,4,25.0%,23m
10249,2,xymzi,2405,0,0,1,1,0.0%,22m
10254,2,미련곰탱이,2404,1604,108,110,218,49.5%,46m
10254,2,lllllllll,2404,1240,38,79,117,32.5%,5m
10254,2,배틀콩루져,2404,361,11,16,27,40.7%,27m
10254,2,Myccoll,2404,162,8,6,14,57.1%,46m
10254,1,ACEROLAORION,2404,196,5,12,17,29.4%,19m
10254,2,날뱀,2404,30,1,2,3,33.3%,46m
10254,2,닭한마리,2404,30,1,2,3,33.3%,26m
10254,2,wanderer,2404,0,1,3,4,25.0%,46m
10254,1,[플러스울트라]구자카,2404,0,1,3,4,25.0%,23m
10254,2,이기적인유전자,2404,0,1,4,5,20.0%,46m
10254,2,MRLIU,2404,0,0,1,1,0.0%,19m
10265,2,GGlover,2403,198,9,7,16,56.2%,46m
10265,2,킹윤팡,2403,70,4,5,9,44.4%,46m
10265,2,Gilen,2403,112,3,4,7,42.9%,46m
10265,2,내가내다,2403,30,2,0,2,100.0%,27m
10269,1,초록도시,2402,1250,89,90,179,49.7%,19m
10269,2,해안,2402,246,8,10,18,44.4%,46m
10269,3,[동현사랑]샌즈,2402,256,8,12,20,40.0%,25m
10269,2,SEEU,2402,132,4,6,10,40.0%,46m
10269,1,jkcove,2402,0,2,6,8,25.0%,24m
10269,2,미끄래곤,2402,0,1,3,4,25.0%,46m
10269,2,jabala,2402,0,1,4,5,20.0%,22m
10276,1,天安門,2401,1092,93,103,196,47.4%,19m
10276,2,알테어,2401,242,8,7,15,53.3%,27m
10276,2,성량,2401,180,7,8,15,46.7%,27m
10276,2,KNIGHT,2401,86,4,1,5,80.0%,27m
10276,2,민재승빈,2401,30,2,6,8,25.0%,46m
10281,1,COBHC,2400,1024,63,64,127,49.6%,28m
10281,1,arnonreyes,2400,762,55,60,115,47.8%,28m
10281,2,[고아쉐끼]wkssdf,2400,1225,44,44,88,50.0%,27m
10281,1,WVWVWVWVWVWV,2400,178,27,23,50,54.0%,21m
10281,2,낭만족제비,2400,91,2,3,5,40.0%,23m
10281,2,lteamswordsl,2400,0,1,0,1,100.0%,19m
10281,2,toaae,2400,0,1,4,5,20.0%,22m
10281,2,tlszla,2400,0,0,1,1,0.0%,46m
10281,2,호세피나,2400,0,0,3,3,0.0%,27m
10290,1,페미니스트김형섭,2399,1533,58,57,115,50.4%,47m
10290,2,이쁜은실이,2399,771,29,27,56,51.8%,26m
10290,2,[애니멀킹덤]불곰,2399,483,18,23,41,43.9%,27m
10290,2,BLACKPINK,2399,290,9,15,24,37.5%,27m
10290,2,[KRSC2]슈딩이,2399,90,5,11,16,31.2%,52m
10290,1,카봇저글링,2399,0,1,2,3,33.3%,24m
10290,2,킵업,2399,0,1,4,5,20.0%,22m
10290,2,gordonma,2399,30,1,5,6,16.7%,27m
10290,2,[디시인사이드]육군사관학교수석,2399,0,0,3,3,0.0%,27m
10299,2,[봉다리]비니루,2398,310,13,4,17,76.5%,27m
10299,1,[NODE]gaka,2398,175,5,4,9,55.6%,46m
10299,2,kit,2398,30,3,5,8,37.5%,46m
10299,2,민보스,2398,36,2,2,4,50.0%,19m
10299,2,홍마족,2398,0,1,0,1,100.0%,46m
10304,1,규동,2397,1086,34,44,78,43.6%,19m
10304,1,[WYS]AURI,2397,602,21,24,45,46.7%,20m
10304,1,mmmmm,2397,478,15,23,38,39.5%,20m
10304,2,Sky,2397,130,4,7,11,36.4%,46m
10304,1,광대양이,2397,38,3,6,9,33.3%,19m
10304,2,幸福教主刮哥,2397,0,1,0,1,100.0%,27m
10304,2,나나나나솨나나솨,2397,0,1,0,1,100.0%,27m
10311,1,TonnyKid,2396,427,13,15,28,46.4%,21m
10311,2,potadoguy,2396,120,5,5,10,50.0%,46m
10311,2,심심해서스타세판,2396,136,4,6,10,40.0%,28m
10311,2,봐주셔여,2396,134,4,7,11,36.4%,27m
10315,2,윤상호,2395,208,6,9,15,40.0%,46m
10315,1,zotslv,2395,128,4,6,10,40.0%,20m
10317,3,김질럿,2394,313,10,10,20,50.0%,26m
10317,2,규형서,2394,200,9,10,19,47.4%,19m
10317,3,飄飄影,2394,0,0,1,1,0.0%,41m
10320,2,anednf,2393,942,43,36,79,54.4%,26m
10320,2,뜅이,2393,1122,43,48,91,47.3%,28m
10320,1,songgoun,2393,854,32,37,69,46.4%,20m
10320,2,후니훈,2393,616,20,23,43,46.5%,27m
10320,1,닉정하기어렵네,2393,560,15,22,37,40.5%,20m
10320,1,[아임프래쉬]오징어집,2393,382,14,18,32,43.8%,20m
10320,1,[破曉一戰]旅人,2393,0,2,5,7,28.6%,47m
10320,2,굴라임,2393,34,1,5,6,16.7%,27m
10320,2,legoatom,2393,0,0,2,2,0.0%,46m
10329,1,린손훌오로시르뤰,2392,744,33,37,70,47.1%,19m
10329,2,맥돌,2392,602,20,25,45,44.4%,26m
10329,1,Pizza,2392,296,9,12,21,42.9%,46m
10329,1,catox,2392,48,3,6,9,33.3%,24m
10329,1,Crush,2392,167,3,10,13,23.1%,21m
10329,2,베이븓,2392,48,1,1,2,50.0%,23m
10335,2,zukamaka,2391,166,6,3,9,66.7%,27m
10335,2,[BigBro]불꽃남자이정훈,2391,141,5,3,8,62.5%,22m
10335,2,순백의화이트,2391,58,3,1,4,75.0%,27m
10335,2,CakeMaster,2391,0,1,0,1,100.0%,27m
10335,2,Outbalz,2391,0,1,4,5,20.0%,23m
10340,1,재윤재윤,2390,670,107,102,209,51.2%,20m
10340,1,clemismyhero,2390,1350,58,69,127,45.7%,20m
10340,2,피뭍은난닝구,2390,564,21,20,41,51.2%,26m
10340,2,싸니텐,2390,0,2,3,5,40.0%,23m
10340,2,roy,2390,62,2,7,9,22.2%,19m
10340,2,최대영,2390,0,1,0,1,100.0%,27m
10340,2,Khai,2390,0,1,4,5,20.0%,46m
10340,1,Shin,2390,0,0,2,2,0.0%,47m
10348,2,madblock,2389,447,17,13,30,56.7%,19m
10348,2,miffey,2389,334,12,10,22,54.5%,27m
10348,2,지니,2389,92,4,3,7,57.1%,27m
10348,2,엠페러나폴레옹,2389,58,3,3,6,50.0%,28m
10348,2,Rabbit,2389,82,2,5,7,28.6%,27m
10348,2,insecure,2389,0,1,3,4,25.0%,46m
10348,2,미로여행,2389,0,1,4,5,20.0%,46m
10355,1,皮一下儿,2388,1210,42,50,92,45.7%,19m
10355,2,닉노이,2388,532,19,15,34,55.9%,27m
10355,2,[EZDUNK]canfam,2388,406,16,12,28,57.1%,46m
10355,2,IIIIIIIIIIII,2388,331,11,11,22,50.0%,19m
10355,2,Honk,2388,92,4,7,11,36.4%,46m
10355,2,Jacksgc,2388,138,3,4,7,42.9%,23m
10355,2,Vega,2388,48,2,6,8,25.0%,23m
10355,2,슴규,2388,0,1,1,2,50.0%,22m
10355,2,[GIS]血月已成為傳說,2388,42,1,2,3,33.3%,27m
10355,2,MeteorBlue,2388,30,1,4,5,20.0%,27m
10365,2,[sc2mc]asdfg,2387,1597,312,366,678,46.0%,19m
10365,2,NaCl,2387,462,14,22,36,38.9%,27m
10365,2,엠파이브,2387,334,12,13,25,48.0%,27m
10365,1,JINs,2387,270,7,11,18,38.9%,21m
10369,1,[랜타디광]엠생,2386,1135,104,109,213,48.8%,20m
10369,3,阿古撒拉斯,2386,898,91,107,198,46.0%,53m
10369,1,쪼코우유,2386,1625,81,91,172,47.1%,20m
10369,2,기럭이아빠,2386,371,13,15,28,46.4%,28m
10369,3,Paolord,2386,331,11,29,40,27.5%,53m
10369,2,[미사일뿌수기]효마니,2386,300,10,15,25,40.0%,27m
10369,2,라팀,2386,98,7,3,10,70.0%,46m
10369,3,아임그루트,2386,229,7,14,21,33.3%,25m
10369,2,Mini,2386,192,5,4,9,55.6%,46m
10369,1,Louis,2386,132,3,7,10,30.0%,47m
10369,1,NESHY,2386,0,2,6,8,25.0%,24m
10369,2,이라,2386,0,1,6,7,14.3%,22m
10381,1,[통수통수통수]주멘,2385,482,22,26,48,45.8%,19m
10381,2,TPZ,2385,304,12,18,30,40.0%,27m
10381,1,[센치한용기병]레더초보프교주,2385,358,11,16,27,40.7%,19m
10381,3,nameinsrt,2385,317,10,19,29,34.5%,48m
10381,2,baba,2385,262,9,4,13,69.2%,19m
10381,2,baronis,2385,0,0,1,1,0.0%,19m
10387,2,llllllllllll,2384,844,32,27,59,54.2%,46m
10387,2,Rick,2384,202,16,17,33,48.5%,19m
10387,2,리리,2384,244,8,12,20,40.0%,27m
10387,1,skykdh,2384,130,6,6,12,50.0%,47m
10387,1,NavyFox,2384,183,6,7,13,46.2%,24m
10387,2,Orgulthar,2384,34,2,5,7,28.6%,46m
10387,2,한호리,2384,129,2,6,8,25.0%,26m
10387,2,내꿈은프로게이머,2384,0,1,4,5,20.0%,46m
10395,2,zoozoo,2383,541,15,22,37,40.5%,27m
10395,2,서탁구,2383,393,13,14,27,48.1%,27m
10395,2,Naiard,2383,74,3,2,5,60.0%,19m
10395,2,[YJJ]다운핵딲빰,2383,0,2,3,5,40.0%,22m
10395,2,난쟁이똥자루,2383,0,1,4,5,20.0%,27m
10395,2,OutLINE,2383,0,0,1,1,0.0%,27m
10395,1,중딩,2383,0,0,1,1,0.0%,23m
10402,2,수리수리마하수리,2382,688,25,21,46,54.3%,27m
10402,1,Jakra,2382,544,17,29,46,37.0%,20m
10402,2,Garnet,2382,202,8,9,17,47.1%,19m
10402,1,HAPPYMAN,2382,30,3,6,9,33.3%,46m
10402,2,rorschach,2382,0,2,4,6,33.3%,22m
10402,2,레이더스,2382,62,2,5,7,28.6%,46m
10402,2,[NCF]IIIIIIIIIIII,2382,0,1,0,1,100.0%,27m
10409,3,하니,2381,980,33,50,83,39.8%,53m
10409,1,[달빛암흑기사]BLUE,2381,490,14,19,33,42.4%,47m
10409,2,에스웍스에이토스,2381,310,12,8,20,60.0%,28m
10409,1,레오나르도,2381,278,11,20,31,35.5%,21m
10409,3,stair,2381,58,4,9,13,30.8%,21m
10409,2,[龍虎]검호,2381,0,0,1,1,0.0%,27m
10415,1,mjchoi,2380,1619,162,166,328,49.4%,47m
10415,2,그래도좋아,2380,1569,101,117,218,46.3%,46m
10415,2,소소미,2380,1172,51,45,96,53.1%,28m
10415,2,매일우유,2380,892,35,26,61,57.4%,46m
10415,1,[지나간하루]지나간루,2380,630,24,19,43,55.8%,20m
10415,2,judicaes,2380,520,20,26,46,43.5%,46m
10415,2,아이어,2380,58,3,5,8,37.5%,46m
10415,2,Lawracz,2380,0,1,4,5,20.0%,22m
10415,2,우리엄마,2380,0,0,1,1,0.0%,19m
10415,1,Hgood,2380,0,0,1,1,0.0%,23m
10415,2,신천치,2380,0,0,2,2,0.0%,22m
10415,2,NachoLibro,2380,0,0,5,5,0.0%,27m
10427,1,killerakira,2379,1087,38,39,77,49.4%,19m
10427,1,[GAL]uts,2379,752,28,36,64,43.8%,19m
10427,2,sjw,2379,74,2,4,6,33.3%,19m
10427,1,리시빙,2379,48,1,3,4,25.0%,24m
10427,2,Tales,2379,0,1,5,6,16.7%,22m
10432,2,GIGABYTE,2378,877,35,27,62,56.5%,46m
10432,2,테라몽,2378,259,8,7,15,53.3%,19m
10432,1,Special,2378,176,5,9,14,35.7%,47m
10432,2,이게임대충본다,2378,96,3,7,10,30.0%,23m
10432,3,admiralwafuh,2378,127,3,7,10,30.0%,25m
10432,2,보이루,2378,0,0,1,1,0.0%,27m
10432,2,kimCeNu,2378,0,0,1,1,0.0%,19m
10439,2,蘭陵王,2377,354,15,19,34,44.1%,27m
10439,2,Darkeye,2377,310,9,9,18,50.0%,46m
10439,3,nature,2377,30,4,11,15,26.7%,25m
10439,2,손주아디뜯음,2377,30,2,3,5,40.0%,27m
10439,2,HotGun,2377,0,1,4,5,20.0%,23m
10439,2,SaMzZ,2377,0,0,2,2,0.0%,19m
10445,1,Maverick,2376,201,9,19,28,32.1%,20m
10445,2,Portuga,2376,0,0,1,1,0.0%,27m
10445,2,테란이다,2376,0,0,1,1,0.0%,27m
10448,2,심심한조씨,2375,492,35,35,70,50.0%,19m
10448,1,Dreamstar,2375,326,9,19,28,32.1%,20m
10448,1,Azimo,2375,311,7,12,19,36.8%,24m
10448,2,Vietnamese,2375,30,5,3,8,62.5%,46m
10448,2,FoFiFu,2375,94,4,7,11,36.4%,27m
10448,2,[FlowAr]MarciaFlowAr,2375,98,3,2,5,60.0%,28m
10448,2,Bla,2375,0,1,0,1,100.0%,27m
10448,2,chun,2375,0,1,4,5,20.0%,23m
10456,2,[스2]정광영,2373,1586,148,170,318,46.5%,27m
10456,2,JoHuiJe,2373,1151,54,54,108,50.0%,27m
10456,2,llllllIIllII,2373,961,36,35,71,50.7%,46m
10456,1,joe,2373,463,21,25,46,45.7%,21m
10456,1,mkcks,2373,70,2,9,11,18.2%,19m
10456,3,[똥겜믈리에]Patapon,2373,0,1,4,5,20.0%,41m
10456,2,thomasKuo,2373,0,0,1,1,0.0%,19m
10463,2,kth,2372,1441,73,70,143,51.0%,46m
10463,2,[213]나나나,2372,360,13,13,26,50.0%,27m
10463,2,pLayerBiOnIc,2372,151,4,6,10,40.0%,27m
10463,2,CaptainNemo,2372,62,3,3,6,50.0%,19m
10463,1,sdett,2372,145,3,10,13,23.1%,24m
10463,2,쏘렌토,2372,0,2,4,6,33.3%,46m
10463,2,Realcircle,2372,30,1,1,2,50.0%,27m
10463,2,BLUEtopaz,2372,0,0,2,2,0.0%,27m
10471,1,[게임플레이]까비,2371,583,20,25,45,44.4%,20m
10471,2,나찰,2371,572,19,25,44,43.2%,19m
10471,1,Liang,2371,88,3,5,8,37.5%,19m
10471,2,karson,2371,58,2,2,4,50.0%,27m
10471,2,다게임,2371,95,2,3,5,40.0%,23m
10476,2,movidic,2370,588,24,15,39,61.5%,46m
10476,2,Garreh,2370,397,14,20,34,41.2%,27m
10476,2,riun,2370,259,7,12,19,36.8%,46m
10476,2,타우렌,2370,90,3,4,7,42.9%,27m
10476,2,MaloaD,2370,89,2,4,6,33.3%,23m
10476,2,외눈박이,2370,48,1,4,5,20.0%,23m
10476,2,llllllllllll,2370,0,0,1,1,0.0%,22m
10483,2,네네,2369,1567,109,113,222,49.1%,27m
10483,2,favoriteblue,2369,964,34,40,74,45.9%,27m
10483,2,예비군홍콩,2369,303,26,32,58,44.8%,27m
10483,2,[해양경비대]아르타니스,2369,292,10,17,27,37.0%,27m
10483,1,NightMareKOR,2369,46,3,6,9,33.3%,23m
10483,2,thunderZeus,2369,0,1,1,2,50.0%,27m
10483,2,pusakal,2369,0,0,1,1,0.0%,27m
10490,2,Rbalsdl,2368,314,11,6,17,64.7%,26m
10490,2,Hyun,2368,278,9,7,16,56.2%,27m
10490,2,RIESEN,2368,226,9,9,18,50.0%,46m
10490,2,jumper,2368,264,9,13,22,40.9%,27m
10490,2,maninbunker,2368,146,5,6,11,45.5%,27m
10490,2,행성요새,2368,98,4,1,5,80.0%,27m
10490,2,Milda,2368,60,4,5,9,44.4%,46m
10490,2,turbo,2368,0,1,4,5,20.0%,46m
10490,2,sawan,2368,0,0,1,1,0.0%,27m
10499,2,Lachimus,2367,96,3,8,11,27.3%,23m
10499,2,[NoMST]ToFu,2367,36,1,4,5,20.0%,27m
10499,2,캐빈코스트,2367,0,0,1,1,0.0%,27m
10502,2,[고구려만세]엔마아이,2366,409,14,11,25,56.0%,28m
10502,2,PARADAXGUS,2366,386,13,18,31,41.9%,27m
10502,2,PLLAR,2366,0,3,2,5,60.0%,46m
10502,2,[밥둑밥찰]알파제로,2366,48,3,7,10,30.0%,22m
10502,1,[정화하리라]푸른사신,2366,157,3,9,12,25.0%,47m
10502,3,박승짱,2366,0,1,3,4,25.0%,22m
10502,2,HighG,2366,0,0,1,1,0.0%,27m
10509,2,maxboy,2365,90,3,3,6,50.0%,28m
10509,2,디스뽕,2365,58,3,3,6,50.0%,27m
10509,2,[슬레이어스]LeGendBoXer,2365,32,1,4,5,20.0%,27m
10512,1,Legit,2364,904,34,35,69,49.3%,47m
10512,2,KGO,2364,319,11,15,26,42.3%,26m
10512,1,legendfither,2364,106,6,8,14,42.9%,47m
10512,1,Namil,2364,160,4,11,15,26.7%,20m
10512,1,rainbowlife,2364,130,4,13,17,23.5%,21m
10512,1,표경전문의사,2364,105,3,6,9,33.3%,47m
10518,2,劉哲銘,2363,824,38,27,65,58.5%,46m
10518,1,최규익,2363,710,23,35,58,39.7%,20m
10518,3,CamoAsia,2363,104,6,12,18,33.3%,26m
10518,2,大毛哥,2363,190,5,4,9,55.6%,27m
10518,2,Skywalker,2363,177,4,3,7,57.1%,23m
10523,2,Elros,2362,1565,181,215,396,45.7%,28m
10523,2,[讓我玩神族]aasa,2362,910,52,45,97,53.6%,46m
10523,1,lonelyloner,2362,270,7,14,21,33.3%,20m
10523,2,[Mist]비제이사냥꾼,2362,102,3,3,6,50.0%,27m
10523,1,[캬루]AschbrownYO,2362,144,3,4,7,42.9%,24m
10523,2,SPX,2362,0,0,1,1,0.0%,27m
10523,2,티피엔쥐,2362,0,0,1,1,0.0%,28m
10530,1,짐네이뇬,2361,1165,115,123,238,48.3%,19m
10530,2,MaslovoGG,2361,540,18,21,39,46.2%,27m
10530,2,[정말데단해]스타신,2361,0,2,4,6,33.3%,46m
10530,3,베놈,2361,0,0,1,1,0.0%,26m
10534,3,Superme,2360,680,24,45,69,34.8%,21m
10534,2,캡틴썬희,2360,469,19,17,36,52.8%,27m
10534,2,손자병법인해전술,2360,355,14,17,31,45.2%,27m
10534,2,[我心已打烊]Topgeon,2360,456,13,16,29,44.8%,27m
10534,1,[미친광전사]jhik,2360,302,10,17,27,37.0%,19m
10534,2,wing,2360,0,1,2,3,33.3%,19m
10534,2,[김신재병신]wooseong,2360,0,0,1,1,0.0%,27m
10541,2,Starry,2359,903,36,39,75,48.0%,46m
10541,2,[GITS]cavalier,2359,724,32,16,48,66.7%,27m
10541,2,EZZIGG,2359,503,15,20,35,42.9%,27m
10541,2,귀여운개벌래,2359,102,2,5,7,28.6%,46m
10541,2,[cox2p]이세상이모양,2359,0,1,0,1,100.0%,27m
10541,2,[망겜장인]나쁜향균맨,2359,0,1,1,2,50.0%,27m
10541,3,박부욱,2359,0,1,4,5,20.0%,22m
10541,2,[DRMS]아둔,2359,0,0,1,1,0.0%,27m
10541,2,레나사부족,2359,0,0,3,3,0.0%,27m
10541,2,svolota,2359,0,0,4,4,0.0%,27m
10551,2,카나나나나난나,2358,489,15,22,37,40.5%,27m
10551,2,개미왕,2358,162,5,11,16,31.2%,27m
10551,1,zele,2358,146,4,16,20,20.0%,19m
10551,2,星雨,2358,30,2,0,2,100.0%,28m
10551,3,배부르다,2358,0,0,1,1,0.0%,41m
10551,2,[미피트롤]신관태사다르,2358,0,0,2,2,0.0%,23m
10557,2,DRuis,2357,721,115,127,242,47.5%,27m
10557,2,Pinkink,2357,500,17,30,47,36.2%,27m
10557,1,ElePlan,2357,215,14,23,37,37.8%,20m
10557,2,[教我玩3族]台灣皇帝,2357,0,0,1,1,0.0%,28m
10557,1,HakunaMatata,2357,0,0,4,4,0.0%,24m
10562,2,땈따구리,2356,334,12,14,26,46.2%,27m
10562,2,llllllllllll,2356,340,12,16,28,42.9%,46m
10562,3,사령관,2356,97,2,0,2,100.0%,25m
10562,2,캐스터뮤즈,2356,131,2,2,4,50.0%,22m
10562,2,박하사탕,2356,30,1,2,3,33.3%,27m
10562,3,[BSK]USAG,2356,0,1,4,5,20.0%,22m
10562,2,푸딩이,2356,30,1,4,5,20.0%,27m
10562,2,Xiongba,2356,0,1,5,6,16.7%,23m
10562,2,사탄,2356,0,0,1,1,0.0%,19m
10562,1,RyoKo,2356,0,0,1,1,0.0%,24m
10572,2,HODALA,2355,1037,80,91,171,46.8%,46m
10572,2,[독일국방군]인성탕면,2355,1400,73,74,147,49.7%,27m
10572,1,머시라고,2355,930,32,34,66,48.5%,20m
10572,2,blacksheep,2355,243,8,4,12,66.7%,46m
10572,2,GoGoGo,2355,30,2,1,3,66.7%,46m
10577,1,Wimpykid,2354,1541,81,89,170,47.6%,20m
10577,1,Vince,2354,356,11,20,31,35.5%,19m
10577,2,Bee,2354,326,10,18,28,35.7%,26m
10577,3,kamotero,2354,0,1,4,5,20.0%,22m
10577,2,rotori,2354,0,0,1,1,0.0%,46m
10582,2,zzzz,2353,384,14,12,26,53.8%,28m
10582,1,챔프,2353,399,14,18,32,43.8%,20m
10582,3,괴정의악동,2353,169,7,13,20,35.0%,25m
10582,2,왜뭐뭐,2353,104,6,7,13,46.2%,27m
10582,2,King,2353,30,2,0,2,100.0%,27m
10582,2,戰火,2353,0,2,2,4,50.0%,46m
10582,2,Green,2353,0,0,1,1,0.0%,27m
10589,2,도리,2352,236,9,14,23,39.1%,46m
10589,2,네오냐,2352,204,7,11,18,38.9%,27m
10589,2,king,2352,193,5,8,13,38.5%,22m
10589,2,ANS,2352,60,3,1,4,75.0%,27m
10589,2,MiniNinja,2352,60,3,6,9,33.3%,46m
10589,2,재영,2352,0,1,5,6,16.7%,22m
10589,2,REZNOR,2352,73,0,4,4,0.0%,28m
10596,1,YANG,2351,0,2,5,7,28.6%,20m
10596,2,[BNGWHL]大亨堡,2351,0,1,1,2,50.0%,23m
10596,3,Yhve,2351,0,1,1,2,50.0%,41m
10596,2,VERGIL,2351,0,0,3,3,0.0%,23m
10600,1,DORK,2350,1653,655,709,1364,48.0%,19m
10600,2,릭스,2350,738,35,25,60,58.3%,27m
10600,2,꾀돌이,2350,342,10,14,24,41.7%,46m
10600,2,누셀넘버,2350,58,3,2,5,60.0%,27m
10600,2,조우형,2350,0,0,1,1,0.0%,19m
10600,1,파리산공수생수,2350,0,0,2,2,0.0%,23m
10600,1,Centurion,2350,0,0,4,4,0.0%,23m
10607,1,Fire,2349,1667,133,137,270,49.3%,47m
10607,2,PaulA,2349,1543,127,143,270,47.0%,46m
10607,1,cjswodh,2349,1530,111,118,229,48.5%,20m
10607,1,Successor,2349,682,27,29,56,48.2%,46m
10607,2,Whammy,2349,558,20,23,43,46.5%,19m
10607,1,[시럽]킹갓사도,2349,510,19,26,45,42.2%,21m
10607,2,llllllllllll,2349,380,16,7,23,69.6%,46m
10607,2,YOON,2349,213,7,3,10,70.0%,28m
10607,1,llllllllllll,2349,174,7,10,17,41.2%,21m
10607,1,mountainG,2349,141,4,7,11,36.4%,23m
10617,2,손민기,2348,554,21,20,41,51.2%,28m
10617,2,씨드,2348,30,2,1,3,66.7%,27m
10617,3,앵커맨,2348,0,1,1,2,50.0%,25m
10617,2,VIRUS,2348,30,1,4,5,20.0%,26m
10617,2,seric,2348,0,0,3,3,0.0%,23m
10622,1,台灣留岛不留人,2347,1523,114,114,228,50.0%,20m
10622,2,Hoa,2347,682,24,29,53,45.3%,19m
10622,3,모오올롸,2347,603,23,28,51,45.1%,48m
10622,2,장개구리,2347,0,1,4,5,20.0%,27m
10622,2,정유라년,2347,0,0,2,2,0.0%,46m
10622,2,우유,2347,0,0,4,4,0.0%,27m
10628,2,[참돔]구천일심,2346,1228,52,58,110,47.3%,19m
10628,2,서경복,2346,860,30,37,67,44.8%,27m
10628,2,PEACE,2346,682,28,28,56,50.0%,27m
10628,3,zzzzz,2346,97,2,3,5,40.0%,25m
10628,2,JohnnyV,2346,0,1,1,2,50.0%,27m
10628,2,llllllllllll,2346,0,1,3,4,25.0%,27m
10628,1,MrLee,2346,0,1,13,14,7.1%,21m
10635,1,오브틴,2345,782,25,36,61,41.0%,20m
10635,2,[바닷물]나나는한나,2345,58,2,3,5,40.0%,27m
10635,2,RedChick,2345,0,0,1,1,0.0%,46m
10635,1,KJH,2345,0,0,4,4,0.0%,47m
10639,2,lllllllllll,2344,823,55,66,121,45.5%,27m
10639,1,[실장권법]조국수호검찰개혁,2344,953,49,54,103,47.6%,20m
10639,2,PARKDEKlNW,2344,952,36,34,70,51.4%,27m
10639,1,케이공일,2344,704,30,38,68,44.1%,20m
10639,2,commando,2344,94,5,8,13,38.5%,27m
10639,1,Rashabh,2344,78,3,9,12,25.0%,20m
10639,2,[싱싱한뉴비]dose,2344,46,2,1,3,66.7%,23m
10646,2,Minh,2343,501,26,19,45,57.8%,27m
10646,2,amazingkiss,2343,185,6,11,17,35.3%,46m
10646,2,안녕하세요,2343,0,1,1,2,50.0%,23m
10649,2,ALEXALADON,2342,109,4,5,9,44.4%,27m
10649,1,生化狼太灰,2342,0,2,6,8,25.0%,24m
10649,3,일분,2342,0,1,4,5,20.0%,41m
10652,2,rotate,2341,927,34,34,68,50.0%,46m
10652,2,딸치자,2341,0,0,1,1,0.0%,46m
10652,2,푸딩서,2341,0,0,3,3,0.0%,46m
10655,1,뜨거운수박,2340,167,5,10,15,33.3%,23m
10655,2,AOA,2340,30,2,5,7,28.6%,28m
10655,2,엘카의전설,2340,0,1,0,1,100.0%,46m
10655,2,asdf,2340,0,0,1,1,0.0%,23m
10655,2,Backstab,2340,0,0,1,1,0.0%,27m
10660,2,야이새꺄,2339,284,10,11,21,47.6%,19m
10660,2,아포칼립스,2339,0,0,1,1,0.0%,22m
10660,2,과천피바라기,2339,0,0,1,1,0.0%,19m
10663,2,무적알핀,2338,1467,75,86,161,46.6%,27m
10663,2,lIlIllIIIllI,2338,0,1,3,4,25.0%,26m
10665,2,전영배,2337,563,21,25,46,45.7%,19m
10665,1,天照,2337,593,18,33,51,35.3%,20m
10665,2,[異化蟲公會]DaiSy,2337,86,4,1,5,80.0%,28m
10665,2,유호성,2337,30,2,7,9,22.2%,46m
10665,2,gkstjsgh,2337,0,0,1,1,0.0%,27m
10665,2,[별똥별]니목숨을아이어에,2337,0,0,1,1,0.0%,19m
10665,2,[Jamja]은빛매,2337,0,0,3,3,0.0%,27m
10672,2,zzz,2336,1525,67,81,148,45.3%,27m
10672,2,Starman,2336,418,22,24,46,47.8%,27m
10672,1,IIIIIIIIIIII,2336,292,10,28,38,26.3%,20m
10672,1,EIFILI,2336,60,2,9,11,18.2%,20m
10672,2,이어폰,2336,0,0,1,1,0.0%,27m
10672,2,고맙고맙,2336,0,0,1,1,0.0%,46m
10678,2,송승민,2335,416,18,22,40,45.0%,27m
10678,2,Killer,2335,262,9,9,18,50.0%,27m
10678,1,killerschool,2335,97,2,6,8,25.0%,46m
10678,3,차니,2335,0,1,4,5,20.0%,22m
10682,2,Lan,2334,204,8,7,15,53.3%,27m
10682,2,[DIAMOB]로우킥,2334,191,7,4,11,63.6%,27m
10682,2,도지마의용,2334,90,3,3,6,50.0%,46m
10685,1,[SOTV]Silencer,2333,1085,45,51,96,46.9%,20m
10685,2,swfilm,2333,1052,42,47,89,47.2%,28m
10685,2,robinim,2333,917,34,33,67,50.7%,27m
10685,2,[게임플레이]Who,2333,495,20,19,39,51.3%,27m
10685,2,Master,2333,104,3,6,9,33.3%,27m
10685,2,작은리소스,2333,48,2,5,7,28.6%,23m
10685,2,로스,2333,0,1,4,5,20.0%,46m
10692,2,qazwsx,2332,1457,125,140,265,47.2%,27m
10692,2,아구의엽기전략,2332,478,43,45,88,48.9%,26m
10692,1,[BDS]미선아사랑해이기,2332,890,33,36,69,47.8%,20m
10692,2,쿡흐다스,2332,448,16,19,35,45.7%,26m
10692,1,Xutain,2332,202,6,11,17,35.3%,20m
10692,2,MinQUI,2332,92,3,2,5,60.0%,23m
10692,2,저글링귀엽다,2332,88,1,1,2,50.0%,28m
10692,2,speedchen,2332,34,1,2,3,33.3%,46m
10692,2,solo,2332,0,0,1,1,0.0%,28m
10692,2,[ZagBra]머털도사,2332,0,0,5,5,0.0%,27m
10702,2,Vic,2331,168,5,3,8,62.5%,46m
10702,2,JDlove,2331,118,4,8,12,33.3%,19m
10704,2,hell,2330,515,19,20,39,48.7%,46m
10704,1,핵폭탄관리자,2330,0,1,1,2,50.0%,24m
10706,2,woofydawgx,2329,1474,56,66,122,45.9%,27m
10706,2,jinmyung,2329,1362,53,61,114,46.5%,28m
10706,1,희망이,2329,880,27,41,68,39.7%,47m
10706,2,깝사,2329,611,25,25,50,50.0%,26m
10706,1,플레이어,2329,323,10,11,21,47.6%,24m
10706,2,헤파팍스,2329,221,8,5,13,61.5%,27m
10706,2,Skullz,2329,88,3,3,6,50.0%,19m
10706,2,NoName,2329,58,3,4,7,42.9%,46m
10706,2,drunkenronin,2329,0,3,5,8,37.5%,23m
10706,2,Zest,2329,0,0,1,1,0.0%,19m
10706,2,IgnoreTaName,2329,0,0,1,1,0.0%,27m
10706,2,입술꽉,2329,0,0,1,1,0.0%,23m
10718,1,Asimoteu,2328,114,3,5,8,37.5%,47m
10718,2,Marine,2328,0,2,3,5,40.0%,23m
10718,2,[프랑스제국]검암동,2328,36,2,6,8,25.0%,46m
10718,1,Dante,2328,0,1,0,1,100.0%,23m
10718,3,noodlesprout,2328,0,0,1,1,0.0%,22m
10723,1,MeKou,2327,1209,64,80,144,44.4%,20m
10723,2,세종대왕,2327,1003,56,62,118,47.5%,27m
10723,2,PhobosX,2327,1469,55,61,116,47.4%,27m
10723,1,YunaQueen,2327,332,24,37,61,39.3%,19m
10723,2,Mustard,2327,124,2,6,8,25.0%,27m
10723,2,you,2327,0,1,0,1,100.0%,27m
10723,2,곤양이,2327,0,0,1,1,0.0%,19m
10730,2,[강철]황금당근,2326,438,17,16,33,51.5%,46m
10730,2,[신뢰]blueshark,2326,427,17,18,35,48.6%,46m
10730,2,상식결핍,2326,0,2,2,4,50.0%,46m
10733,1,Bogart,2325,1091,50,59,109,45.9%,21m
10733,2,꽃피는청춘,2325,90,4,6,10,40.0%,46m
10733,2,호날도,2325,60,2,4,6,33.3%,46m
10733,2,크래마암,2325,0,1,0,1,100.0%,27m
10733,2,buru,2325,94,1,6,7,14.3%,23m
10733,2,taenorn,2325,42,1,7,8,12.5%,23m
10739,2,HEARTHSTONE,2324,169,6,6,12,50.0%,46m
10739,1,류니에쉴리영,2324,195,6,10,16,37.5%,21m
10739,2,CHINZILLA,2324,92,4,7,11,36.4%,22m
10739,2,soyeom,2324,0,0,1,1,0.0%,19m
10743,2,Berserker,2323,217,10,4,14,71.4%,27m
10743,2,신디케이트,2323,102,2,6,8,25.0%,46m
10743,2,Ddeathgun,2323,36,2,8,10,20.0%,27m
10743,2,루피,2323,0,0,1,1,0.0%,27m
10743,2,[우린호구다]여눠,2323,0,0,2,2,0.0%,27m
10748,2,HyeuN,2322,514,21,14,35,60.0%,27m
10748,2,[달맞이꽃]ShiroeTLord,2322,46,1,3,4,25.0%,23m
10748,2,청월,2322,0,0,1,1,0.0%,27m
10748,2,Alsgur,2322,0,0,2,2,0.0%,27m
10752,1,xiexienihao,2321,359,17,23,40,42.5%,20m
10752,2,Zodiac,2321,262,9,9,18,50.0%,46m
10752,2,Toilet,2321,149,8,3,11,72.7%,27m
10752,1,신들의의안,2321,243,8,12,20,40.0%,47m
10752,2,오동통통너꾸리,2321,0,0,1,1,0.0%,23m
10757,1,Zef,2320,564,17,23,40,42.5%,20m
10757,2,ShifuKiller,2320,390,11,19,30,36.7%,27m
10757,2,놈우연,2320,48,4,5,9,44.4%,23m
10757,1,Kachinsky,2320,60,4,11,15,26.7%,47m
10757,2,키오니로,2320,60,3,5,8,37.5%,46m
10757,2,흑단태영,2320,0,0,1,1,0.0%,19m
10763,1,IlllIIIllIlI,2319,1078,34,45,79,43.0%,20m
10763,2,서정욱,2319,34,2,5,7,28.6%,27m
10763,2,단군의얇은단검,2319,0,2,6,8,25.0%,23m
10766,1,bogital,2318,1275,70,83,153,45.8%,47m
10766,2,INZE,2318,143,12,18,30,40.0%,27m
10766,2,sisk,2318,112,3,4,7,42.9%,23m
10766,2,JOKER,2318,58,3,7,10,30.0%,46m
10766,2,[싸이클론장인]MARC,2318,30,2,2,4,50.0%,46m
10771,2,CYH,2317,1566,184,225,409,45.0%,27m
10771,2,Optimize,2317,698,25,30,55,45.5%,46m
10771,2,lucasim,2317,544,19,26,45,42.2%,27m
10771,1,Octopus,2317,250,6,19,25,24.0%,19m
10771,2,SingleMalt,2317,120,5,4,9,55.6%,46m
10771,2,바삭한치킨,2317,46,2,6,8,25.0%,23m
10771,2,쿨이얌,2317,0,1,2,3,33.3%,27m
10778,3,[즐겜러]천공의쏙독새,2316,260,10,5,15,66.7%,25m
10778,2,SMERH,2316,0,2,5,7,28.6%,23m
10778,2,瘋狂郵差,2316,91,1,1,2,50.0%,23m
10781,2,mirru,2315,362,12,17,29,41.4%,19m
10781,2,Yang,2315,0,1,4,5,20.0%,46m
10783,2,aldksgo,2314,1532,87,93,180,48.3%,27m
10783,2,YGdragon,2314,436,17,21,38,44.7%,27m
10783,2,Kscv,2314,246,13,11,24,54.2%,46m
10783,3,공기밥하나추가요,2314,0,1,3,4,25.0%,22m
10787,3,tion,2313,429,14,22,36,38.9%,53m
10787,2,LAZER,2313,166,5,11,16,31.2%,28m
10787,3,송현우,2313,0,1,4,5,20.0%,22m
10787,2,배원찬,2313,94,1,6,7,14.3%,46m
10787,3,진격의거인,2313,0,0,1,1,0.0%,22m
10792,2,[SS친위대]짱맨,2312,316,11,10,21,52.4%,26m
10792,2,아프리카두페,2312,306,10,12,22,45.5%,28m
10792,2,loserkobe,2312,130,5,0,5,100.0%,46m
10792,2,tiger,2312,30,2,1,3,66.7%,28m
10792,2,cgchaucer,2312,30,1,2,3,33.3%,46m
10792,2,Sniper,2312,0,0,1,1,0.0%,23m
10798,1,실수는없다,2311,193,5,10,15,33.3%,23m
10798,2,IlIlIlllIIlI,2311,106,4,8,12,33.3%,26m
10798,2,제우스,2311,112,3,1,4,75.0%,28m
10798,2,kingcamel,2311,30,2,2,4,50.0%,46m
10798,3,Steelwing,2311,0,1,2,3,33.3%,22m
10798,2,ingan,2311,30,1,4,5,20.0%,27m
10798,2,王黑樂園,2311,0,0,2,2,0.0%,28m
10805,2,一切靠運氣,2310,180,5,6,11,45.5%,27m
10805,2,zits,2310,111,4,5,9,44.4%,23m
10805,2,InstantFTh,2310,58,2,3,5,40.0%,27m
10808,1,quangpham,2309,1611,112,141,253,44.3%,20m
10808,1,Ponytail,2309,851,29,35,64,45.3%,20m
10808,2,ToPic,2309,150,6,11,17,35.3%,27m
10808,2,fortuna,2309,0,3,3,6,50.0%,23m
10812,2,TeamA,2308,832,26,38,64,40.6%,27m
10812,2,WON,2308,328,12,7,19,63.2%,27m
10812,2,dallas,2308,154,4,3,7,57.1%,19m
10812,2,레이너특공대,2308,136,3,3,6,50.0%,27m
10812,2,기다려,2308,0,1,0,1,100.0%,46m
10812,2,[너의ol름은]sunki,2308,0,0,2,2,0.0%,28m
10812,1,[ANGG]DOFE,2308,0,0,3,3,0.0%,24m
10819,2,WizzleLi,2307,993,54,61,115,47.0%,19m
10819,2,[Cross]James,2307,189,11,6,17,64.7%,28m
10819,2,TONYAN,2307,80,3,6,9,33.3%,27m
10819,2,인성,2307,0,0,3,3,0.0%,46m
10823,3,별여름,2306,878,29,42,71,40.8%,48m
10823,2,평범한전쟁광,2306,281,13,11,24,54.2%,27m
10823,1,Ande,2306,142,5,8,13,38.5%,24m
10823,2,[SC2HK]LaPuta,2306,93,2,4,6,33.3%,22m
10823,3,ddangyoung,2306,0,0,1,1,0.0%,46m
10823,3,[판터전차]uaysk,2306,0,0,1,1,0.0%,26m
10829,2,무교훈롤존나못함,2305,60,3,6,9,33.3%,28m
10829,2,Noname,2305,92,2,3,5,40.0%,23m
10829,2,RuHeSoulFox,2305,30,1,3,4,25.0%,46m
10832,2,Dos,2304,90,4,4,8,50.0%,27m
10832,2,star,2304,160,3,8,11,27.3%,27m
10832,3,llllllllllll,2304,0,1,0,1,100.0%,22m
10835,2,파란구름,2303,1499,227,249,476,47.7%,27m
10835,2,ddoctor,2303,0,1,1,2,50.0%,27m
10837,1,gatton,2302,1583,85,102,187,45.5%,47m
10838,2,유현종옹지,2301,216,8,10,18,44.4%,27m
10838,2,PocariXX,2301,42,4,4,8,50.0%,23m
10838,3,김결,2301,60,3,1,4,75.0%,26m
10841,2,홍어,2300,282,12,7,19,63.2%,28m
10841,2,알씨준,2300,187,7,3,10,70.0%,46m
10841,3,망고맛완두콩,2300,147,3,4,7,42.9%,26m
10841,2,IlIIlllIllIl,2300,96,3,7,10,30.0%,27m
10841,3,스꼴충,2300,0,2,3,5,40.0%,41m
10841,2,HairyEwok,2300,114,2,6,8,25.0%,46m
10841,3,Dutchie,2300,0,1,0,1,100.0%,26m
10841,2,IlllllIIIIll,2300,44,1,2,3,33.3%,23m
10841,2,bmwkks,2300,0,1,2,3,33.3%,28m
10850,1,정건축,2299,164,13,16,29,44.8%,20m
10850,2,[아앙세미띠]FIzzyElf,2299,188,6,12,18,33.3%,19m
10850,3,최루피,2299,58,3,1,4,75.0%,46m
10853,2,첫경험,2298,557,23,18,41,56.1%,19m
10853,2,부메랑,2298,482,22,21,43,51.2%,27m
10853,2,도뇨니,2298,329,22,34,56,39.3%,27m
10853,3,[NoME]피스메이커,2298,347,11,6,17,64.7%,26m
10853,1,SergeAbitbol,2298,0,2,6,8,25.0%,25m
10853,2,DocAgta,2298,0,1,1,2,50.0%,23m
10859,1,llIIlIIIlII,2297,1612,151,171,322,46.9%,47m
10859,1,[짱이다]stormzerg,2297,1058,35,49,84,41.7%,20m
10859,2,FXXKUP,2297,557,29,27,56,51.8%,19m
10859,3,SneakyTurtle,2297,305,12,19,31,38.7%,26m
10859,3,ADADADADAD,2297,30,2,0,2,100.0%,25m
10859,3,도영리,2297,0,1,2,3,33.3%,22m
10859,3,IIIIIIIIIIII,2297,30,1,5,6,16.7%,26m
10859,2,라이곤,2297,0,0,2,2,0.0%,26m
10867,2,화신,2296,424,17,16,33,51.5%,46m
10867,2,Red,2296,346,11,14,25,44.0%,27m
10867,3,ArLeg,2296,137,4,11,15,26.7%,48m
10870,2,tien,2295,624,26,30,56,46.4%,19m
10870,2,soma,2295,0,1,1,2,50.0%,19m
10870,3,김반장나빠요,2295,0,0,1,1,0.0%,26m
10873,3,IlIllIIIllIl,2294,1426,154,177,331,46.5%,53m
10873,2,LMA,2294,500,19,19,38,50.0%,27m
10873,3,Junwei,2294,30,2,1,3,66.7%,26m
10873,3,고대고라니,2294,0,1,4,5,20.0%,26m
10873,2,케이지,2294,0,1,5,6,16.7%,46m
10873,2,저글링,2294,0,0,2,2,0.0%,27m
10879,2,스타노바,2293,1506,175,180,355,49.3%,19m
10879,2,제네시스,2293,1528,68,69,137,49.6%,27m
10879,1,ONEDAY,2293,555,19,26,45,42.2%,19m
10879,2,baekcueho,2293,300,12,16,28,42.9%,27m
10883,1,WolfzGang,2292,750,23,35,58,39.7%,20m
10883,2,FatBatman,2292,513,20,22,42,47.6%,28m
10883,3,小小郭隨便玩,2292,64,3,2,5,60.0%,26m
10883,1,drkim,2292,32,3,7,10,30.0%,47m
10883,3,llllllllll,2292,0,1,0,1,100.0%,26m
10888,3,Muboy,2291,1495,166,184,350,47.4%,53m
10888,1,[Blacer]무리뉴,2291,818,154,156,310,49.7%,19m
10888,2,hoa,2291,1163,84,94,178,47.2%,27m
10888,1,라이너,2291,151,4,4,8,50.0%,24m
10888,2,Aegis,2291,119,3,4,7,42.9%,23m
10888,2,Wizard,2291,92,3,5,8,37.5%,27m
10888,3,묵은지활어초밥,2291,0,0,1,1,0.0%,26m
10888,3,고릴라의요정,2291,0,0,1,1,0.0%,46m
10896,2,크리티컬포인트,2290,0,1,2,3,33.3%,19m
10896,2,ParkGoM,2290,46,1,4,5,20.0%,27m
10898,2,빛나는헤드,2289,172,4,5,9,44.4%,27m
10898,3,[SlGN]priester,2289,0,1,0,1,100.0%,25m
10898,2,maro,2289,88,1,2,3,33.3%,27m
10901,2,[갓거킹]김흥국의왕십리턴,2288,712,31,32,63,49.2%,28m
10901,2,Paladin,2288,635,26,27,53,49.1%,28m
10901,2,everywheretj,2288,122,4,6,10,40.0%,47m
10901,2,CPO,2288,30,2,2,4,50.0%,19m
10901,3,매너,2288,38,1,2,3,33.3%,26m
10901,3,상솔,2288,30,1,2,3,33.3%,26m
10907,2,[건담]junsik,2287,192,6,6,12,50.0%,46m
10907,2,엉덩이에총있다,2287,0,1,5,6,16.7%,23m
10907,2,쫑알이,2287,0,0,3,3,0.0%,27m
10907,3,클라이언파이터,2287,0,0,5,5,0.0%,25m
10911,2,Zersfa,2286,407,47,57,104,45.2%,28m
10911,2,hoyapret,2286,554,21,25,46,45.7%,19m
10911,3,zergdragon,2286,0,1,2,3,33.3%,22m
10914,2,헉허크,2285,0,3,2,5,60.0%,47m
10914,2,[자유의유산]우민,2285,44,2,2,4,50.0%,23m
10914,2,AlvinioJ,2285,30,2,7,9,22.2%,46m
10914,2,KDH,2285,0,0,4,4,0.0%,23m
10918,1,菜頭仁,2284,195,5,4,9,55.6%,24m
10918,1,KIH,2284,141,4,7,11,36.4%,25m
10918,3,이렇게취할때,2284,76,2,5,7,28.6%,22m
10918,2,곰돌으리,2284,0,1,0,1,100.0%,22m
10918,3,[NCF]크란이,2284,88,1,5,6,16.7%,46m
10918,2,baseboy,2284,0,1,5,6,16.7%,23m
10918,3,공격형,2284,0,0,1,1,0.0%,26m
10918,2,LEVIVARI,2284,0,0,4,4,0.0%,27m
10926,2,qkrwlgh,2283,1520,132,143,275,48.0%,28m
10926,2,[ElsAna]초보입니다,2283,540,27,27,54,50.0%,19m
10926,2,kebabfighter,2283,113,4,6,10,40.0%,23m
10926,2,Rumos,2283,0,1,0,1,100.0%,22m
10926,3,SuRiYaDeV,2283,0,1,3,4,25.0%,41m
10931,2,OzdeguLat,2282,1443,55,68,123,44.7%,27m
10931,2,[레이너공격대]짐되는레이너,2282,900,34,44,78,43.6%,47m
10931,2,이상한돌,2282,150,7,6,13,53.8%,27m
10931,3,ScumbagKai,2282,190,5,5,10,50.0%,46m
10931,3,호롤로,2282,58,3,0,3,100.0%,26m
10931,3,NamelessOne,2282,0,0,1,1,0.0%,46m
10937,2,Rhinoceros,2281,207,16,12,28,57.1%,27m
10937,1,sniper,2281,315,11,13,24,45.8%,23m
10937,2,천연라임향,2281,60,3,5,8,37.5%,27m
10937,2,달린다치타,2281,30,2,6,8,25.0%,46m
10937,3,명란젖젖,2281,0,0,1,1,0.0%,22m
10942,3,킹갓불멸자,2280,150,6,1,7,85.7%,26m
10942,1,탈조센이답이다,2280,48,3,8,11,27.3%,23m
10942,2,five,2280,40,2,6,8,25.0%,22m
10945,2,박서준,2279,1564,104,114,218,47.7%,26m
10945,2,JackAwo,2279,398,14,16,30,46.7%,28m
10945,1,이슬람무장돼지,2279,306,11,18,29,37.9%,47m
10945,2,Coolman,2279,242,9,16,25,36.0%,46m
10945,2,[Anne]에밀리아,2279,130,4,3,7,57.1%,27m
10945,3,Maximus,2279,0,0,1,1,0.0%,25m
10945,1,스타,2279,0,0,2,2,0.0%,23m
10952,3,베르세루크,2278,255,10,15,25,40.0%,25m
10952,2,JASON,2278,120,2,3,5,40.0%,46m
10954,3,DireTzo,2277,453,28,29,57,49.1%,26m
10954,2,니가뭔데,2277,386,15,22,37,40.5%,27m
10954,2,Cain,2277,211,5,9,14,35.7%,23m
10954,2,mher,2277,62,3,7,10,30.0%,27m
10954,3,작은마린이맵다,2277,96,2,1,3,66.7%,25m
10959,2,Mokalulu,2276,1284,53,62,115,46.1%,46m
10959,2,fgsfe,2276,345,15,13,28,53.6%,27m
10959,2,kangkang,2276,184,5,7,12,41.7%,23m
10962,2,어어어어,2275,196,8,7,15,53.3%,26m
10962,2,emflqcnd,2275,60,3,6,9,33.3%,27m
10964,2,Tortik,2274,1011,66,70,136,48.5%,19m
10964,3,매직테란,2274,826,32,38,70,45.7%,25m
10964,2,sskmon,2274,332,11,16,27,40.7%,26m
10964,2,首領荷夫,2274,185,4,8,12,33.3%,23m
10964,3,gkwlstm,2274,0,0,1,1,0.0%,46m
10969,2,[이터널]닥스훈트,2273,962,36,44,80,45.0%,19m
10969,3,redmi,2273,30,2,3,5,40.0%,25m
10969,1,Luddagi,2273,0,1,2,3,33.3%,24m
10969,3,LoSicA,2273,0,0,1,1,0.0%,26m
10973,2,lIIIlIIlIlII,2272,753,27,37,64,42.2%,46m
10973,2,[Blade]alexl,2272,266,10,12,22,45.5%,19m
10973,3,유현이는곧휴가철,2272,86,4,2,6,66.7%,25m
10973,2,꼬마라그,2272,93,2,5,7,28.6%,23m
10973,3,vidar,2272,0,0,1,1,0.0%,41m
10978,2,許凱崴,2271,1008,39,40,79,49.4%,28m
10978,3,Storm,2271,878,32,46,78,41.0%,48m
10978,2,Tabsany,2271,412,14,17,31,45.2%,46m
10978,2,[빙하행성얼코]RomaneeConti,2271,200,6,7,13,46.2%,46m
10978,3,[ZUZU]NOTHING,2271,30,2,0,2,100.0%,26m
10978,3,東山笑笑生,2271,0,1,1,2,50.0%,26m
10984,2,밤비치,2270,1524,70,81,151,46.4%,28m
10984,2,robin,2270,850,33,32,65,50.8%,28m
10984,3,[게임플레이]민긋인데요,2270,58,3,1,4,75.0%,26m
10984,2,퍼즈리,2270,0,2,5,7,28.6%,22m
10984,3,umjetink,2270,0,1,0,1,100.0%,25m
10984,1,[북괴정벌]곱등이곱창,2270,48,1,5,6,16.7%,24m
10984,3,호두래,2270,30,1,5,6,16.7%,46m
10984,3,amarteur,2270,0,0,2,2,0.0%,25m
10992,2,eagleye,2269,305,18,16,34,52.9%,26m
10992,2,또심이,2269,424,18,17,35,51.4%,47m
10992,3,플로우지,2269,60,3,2,5,60.0%,26m
10992,3,LEKSLL,2269,90,3,3,6,50.0%,26m
10992,3,[디케이드]FakeZero,2269,38,1,1,2,50.0%,26m
10992,3,Trident,2269,0,1,4,5,20.0%,22m
10992,2,llllllllllll,2269,0,0,3,3,0.0%,22m
10999,2,stereo,2268,579,21,21,42,50.0%,47m
10999,2,MarsChang,2268,186,6,7,13,46.2%,28m
10999,3,도전자,2268,97,1,3,4,25.0%,26m
11002,2,루카엘라,2267,1505,70,62,132,53.0%,46m
11002,2,Eric,2267,1496,67,72,139,48.2%,28m
11002,1,Nothing,2267,377,17,19,36,47.2%,47m
11002,3,핸콕,2267,30,4,11,15,26.7%,26m
11006,2,King,2266,588,20,25,45,44.4%,46m
11006,2,紫羽,2266,116,3,8,11,27.3%,28m
11006,3,ekfzhazjvl,2266,0,0,1,1,0.0%,26m
11009,3,사사키치에,2265,279,10,8,18,55.6%,46m
11009,2,海龍王,2265,280,9,18,27,33.3%,26m
11009,3,kimdotexe,2265,30,1,3,4,25.0%,26m
11009,3,Dreep,2265,0,1,3,4,25.0%,22m
11009,3,[여친]Alchemist,2265,0,1,3,4,25.0%,26m
11009,2,프라이밋,2265,30,1,10,11,9.1%,46m
11009,3,diaushd,2265,0,0,5,5,0.0%,41m
11016,2,SCAVE,2264,467,29,40,69,42.0%,27m
11016,2,[패자는피를]드디어올곳이왔군,2264,212,8,11,19,42.1%,27m
11016,3,pbjkiss,2264,0,1,5,6,16.7%,22m
11016,3,떡부가자,2264,0,0,1,1,0.0%,25m
11020,2,confuse,2263,1437,405,435,840,48.2%,53m
11020,2,BeatalL,2263,518,20,27,47,42.6%,27m
11020,1,enigma,2263,311,12,21,33,36.4%,48m
11020,2,KPas,2263,200,6,12,18,33.3%,47m
11020,3,ASDASD,2263,0,2,3,5,40.0%,25m
11025,3,iNoyoka,2262,165,13,15,28,46.4%,26m
11025,3,chris,2262,195,6,5,11,54.5%,46m
11025,3,[게임플레이]dla,2262,144,4,1,5,80.0%,26m
11028,3,KTNhiagia,2261,190,7,3,10,70.0%,25m
11028,2,이베아,2261,60,2,6,8,25.0%,27m
11028,3,[달빛암흑기사]Andy,2261,0,1,0,1,100.0%,25m
11028,3,Blessing,2261,30,1,6,7,14.3%,21m
11032,2,Zwitter,2260,162,6,9,15,40.0%,27m
11032,2,Neo,2260,64,4,6,10,40.0%,46m
11032,3,SuperStar,2260,66,3,2,5,60.0%,26m
11032,2,[스코델라리오]캐리건,2260,112,3,5,8,37.5%,27m
11032,2,[최정예]fusroda,2260,0,0,2,2,0.0%,27m
11032,3,Siron,2260,0,0,3,3,0.0%,25m
11038,2,Flash,2259,182,6,4,10,60.0%,27m
11038,2,모르글,2259,159,5,7,12,41.7%,19m
11038,2,좋은단백질원,2259,197,5,9,14,35.7%,23m
11038,3,thesola,2259,30,2,1,3,66.7%,25m
11038,3,스타맨,2259,60,2,5,7,28.6%,25m
11038,2,[무한김준현]teayehegg,2259,68,2,9,11,18.2%,46m
11044,2,SKTQUASAR,2258,675,30,25,55,54.5%,46m
11044,2,KeeeeTeeeee,2258,780,28,41,69,40.6%,46m
11044,2,Jonseun,2258,720,27,36,63,42.9%,27m
11044,3,Outlooker,2258,208,8,8,16,50.0%,25m
11044,1,IIIIIIIIII,2258,145,4,9,13,30.8%,25m
11044,3,RONAK,2258,32,2,1,3,66.7%,26m
11050,1,habaik,2257,498,16,24,40,40.0%,19m
11050,2,Kevin,2257,93,4,6,10,40.0%,23m
11050,3,[별똥별]성실착실충실,2257,120,3,5,8,37.5%,25m
11050,2,특공대출신,2257,115,3,7,10,30.0%,46m
11050,3,Bacillus,2257,0,0,1,1,0.0%,25m
11055,2,과외의일상,2256,46,3,7,10,30.0%,23m
11055,2,TWforever,2256,0,1,4,5,20.0%,46m
11057,3,BlackBB,2255,554,21,22,43,48.8%,26m
11057,3,Pressup,2255,116,4,7,11,36.4%,26m
11057,2,JadePalace,2255,0,1,6,7,14.3%,23m
11057,2,kookoo,2255,0,0,4,4,0.0%,27m
11061,3,[PMC0]lllIlllIllll,2254,385,15,17,32,46.9%,26m
11061,2,METALMARO,2254,92,3,9,12,25.0%,19m
11061,2,막걸리옥수수,2254,0,1,3,4,25.0%,28m
11061,3,DarkMarin,2254,0,0,1,1,0.0%,26m
11061,3,[삽전사]파괴자,2254,0,0,1,1,0.0%,26m
11066,2,김형준,2253,1477,135,158,293,46.1%,47m
11066,3,하하하하하,2253,0,1,3,4,25.0%,22m
11066,3,민트초코오오,2253,0,0,1,1,0.0%,46m
11069,3,기몽식,2252,248,12,11,23,52.2%,46m
11069,2,Dez,2252,181,6,9,15,40.0%,19m
11069,2,DarthVader,2252,0,1,7,8,12.5%,46m
11072,3,我是誰,2251,144,3,3,6,50.0%,26m
11072,3,색스킹,2251,58,3,3,6,50.0%,26m
11072,3,ZJJJJ,2251,44,1,5,6,16.7%,22m
11075,3,vcw,2250,116,5,2,7,71.4%,26m
11075,1,떠돌이,2250,0,1,0,1,100.0%,23m
11077,2,llll,2249,610,20,30,50,40.0%,46m
11077,2,MINIMINI,2249,240,8,11,19,42.1%,46m
11077,2,레헬른,2249,146,6,14,20,30.0%,46m
11077,3,Tom,2249,0,0,3,3,0.0%,26m
11081,3,SEVEN,2248,526,20,10,30,66.7%,26m
11081,2,Silencerx,2248,448,15,20,35,42.9%,28m
11081,2,뭔코카여펩시지,2248,378,13,11,24,54.2%,19m
11084,2,Peanut,2247,339,14,15,29,48.3%,26m
11084,2,wando,2247,176,9,14,23,39.1%,53m
11084,3,오우죽이는데,2247,66,2,2,4,50.0%,26m
11084,3,[재혁이에용]페실리움,2247,122,2,5,7,28.6%,26m
11088,2,한판해보자,2246,748,27,33,60,45.0%,27m
11088,2,넙치볶음,2246,240,10,8,18,55.6%,27m
11088,2,lllIIIllllll,2246,102,4,11,15,26.7%,26m
11088,3,Jodano,2246,32,3,3,6,50.0%,26m
11088,1,jasonng,2246,0,0,6,6,0.0%,23m
11093,3,XLZXPY,2245,140,3,2,5,60.0%,26m
11094,3,[프로토스협회]손주할머니캐리,2244,614,20,33,53,37.7%,46m
11094,3,月飛神,2244,158,5,9,14,35.7%,26m
11094,3,[게임플레이]망나나니,2244,116,4,3,7,57.1%,26m
11094,2,timbobimbo,2244,165,4,8,12,33.3%,23m
11094,3,[ARDBEG]데저트스트라이크,2244,30,2,2,4,50.0%,26m
11094,2,[NICC]음므파탈,2244,0,0,4,4,0.0%,27m
11100,3,LOVEOFTEARS,2243,874,32,37,69,46.4%,26m
11100,3,gohonggo,2243,821,31,35,66,47.0%,41m
11100,3,그냥게임하는사람,2243,58,3,2,5,60.0%,26m
11100,3,Einar,2243,40,1,1,2,50.0%,22m
11104,2,야린왕자,2242,214,18,23,41,43.9%,28m
11105,2,tonhom,2241,805,54,62,116,46.6%,27m
11105,1,Vilveq,2241,310,9,15,24,37.5%,24m
11105,3,ksh,2241,92,3,7,10,30.0%,26m
11105,3,체체체첼,2241,30,2,3,5,40.0%,26m
11105,2,[정치공학]carmack,2241,0,0,1,1,0.0%,23m
11110,2,RokaCola,2240,365,13,22,35,37.1%,28m
11110,2,아이치킨,2240,236,11,16,27,40.7%,26m
11110,2,RykerCassius,2240,60,3,6,9,33.3%,27m
11110,3,praysy,2240,0,0,1,1,0.0%,26m
11114,3,깡이,2239,0,1,2,3,33.3%,22m
11115,3,YuraUA,2238,1510,61,84,145,42.1%,26m
11115,2,kimTT,2238,676,28,42,70,40.0%,28m
11115,1,Achilles,2238,613,21,30,51,41.2%,47m
11115,2,Telex,2238,199,7,14,21,33.3%,19m
11115,2,gdx,2238,136,4,11,15,26.7%,27m
11115,3,狐媽,2238,30,3,4,7,42.9%,25m
11115,2,눈날엔,2238,30,2,6,8,25.0%,28m
11115,3,청소년이용불가,2238,0,1,4,5,20.0%,26m
11115,3,[HDCore]불꽃,2238,0,0,2,2,0.0%,26m
11124,3,BoyNextDoor,2237,494,17,17,34,50.0%,25m
11124,3,[KONFA]Bym,2237,414,14,15,29,48.3%,26m
11124,3,dddd,2237,114,4,3,7,57.1%,46m
11124,1,장표,2237,0,0,1,1,0.0%,23m
11128,2,특이한녀석,2236,1431,111,128,239,46.4%,27m
11128,3,boy,2236,118,4,5,9,44.4%,26m
11128,3,moon,2236,38,2,0,2,100.0%,41m
11131,2,타키온,2235,1131,179,217,396,45.2%,28m
11131,2,하늘사랑,2235,815,80,86,166,48.2%,27m
11131,3,발렌시아,2235,1462,53,60,113,46.9%,26m
11131,3,Drims,2235,382,13,19,32,40.6%,26m
11131,3,HotlineLing,2235,0,3,2,5,60.0%,46m
11131,3,[볼셰비키]다크로드,2235,0,1,0,1,100.0%,26m
11131,3,[NDW]hymn,2235,0,0,1,1,0.0%,46m
11131,2,스타왕,2235,0,0,7,7,0.0%,46m
11139,2,LEEGUHYEONG,2234,1456,68,86,154,44.2%,52m
11139,3,평생막고있을거,2234,941,35,49,84,41.7%,48m
11139,3,[Green]MKLee,2234,424,15,24,39,38.5%,26m
11139,3,장군이세,2234,114,4,2,6,66.7%,25m
11139,3,연어초밥,2234,30,1,4,5,20.0%,26m
11144,2,봉구선수,2233,938,35,44,79,44.3%,28m
11144,2,靜謐哈桑,2233,391,14,22,36,38.9%,19m
11144,3,[ElsAna]서부사령관,2233,237,8,3,11,72.7%,26m
11144,3,stone,2233,0,1,0,1,100.0%,46m
11144,2,okasian,2233,0,1,4,5,20.0%,47m
11149,2,八爪魚,2232,1033,47,54,101,46.5%,27m
11150,1,말랑사탕,2231,1529,150,155,305,49.2%,20m
11150,3,[너의ol름은]KimchiRamyon,2231,1055,38,52,90,42.2%,26m
11150,2,ImForever,2231,914,30,43,73,41.1%,27m
11150,3,skwyverns,2231,142,4,1,5,80.0%,26m
11154,2,kyaw,2230,1488,60,73,133,45.1%,27m
11154,2,구룸이,2230,894,36,37,73,49.3%,27m
11154,2,azxzc,2230,623,22,31,53,41.5%,19m
11154,3,하하히히,2230,402,14,19,33,42.4%,26m
11154,3,dsf,2230,184,8,4,12,66.7%,25m
11154,2,MarineBoy,2230,184,7,13,20,35.0%,27m
11154,3,JoshJames,2230,0,2,2,4,50.0%,22m
11154,3,BunRieuCua,2230,0,1,4,5,20.0%,22m
11154,2,안녕하신가,2230,0,1,5,6,16.7%,46m
11154,2,Jino,2230,0,1,6,7,14.3%,23m
11164,2,kimyunhoe,2229,439,14,22,36,38.9%,46m
11164,2,Huwawee,2229,204,13,12,25,52.0%,28m
11164,2,치킨나라피자공주,2229,295,11,13,24,45.8%,27m
11164,2,執筆下墨,2229,167,7,7,14,50.0%,23m
11164,2,서현아사랑해,2229,116,3,7,10,30.0%,46m
11164,2,HyeuN,2229,92,3,10,13,23.1%,26m
11164,3,DodG,2229,0,1,0,1,100.0%,46m
11164,3,뽀통령,2229,0,1,5,6,16.7%,46m
11172,2,로즈아멜리아,2228,180,4,10,14,28.6%,23m
11172,3,WFblackPsych,2228,30,2,0,2,100.0%,26m
11172,2,Onetwo,2228,88,2,4,6,33.3%,46m
11172,3,파워똥파리,2228,0,1,1,2,50.0%,26m
11176,2,Yasuo,2227,481,20,19,39,51.3%,46m
11176,3,阿偉,2227,60,2,6,8,25.0%,26m
11178,1,노대리야끼,2226,1382,102,132,234,43.6%,51m
11178,2,[뉴비의똥꼬쇼]zJustaNewbie,2226,489,35,44,79,44.3%,28m
11178,3,레이스,2226,0,1,0,1,100.0%,46m
11181,3,kmhkmw,2225,1356,112,122,234,47.9%,53m
11181,3,초보에요,2225,30,1,1,2,50.0%,26m
11181,3,천동이,2225,0,0,3,3,0.0%,25m
11184,2,johnwalker,2224,837,80,87,167,47.9%,28m
11184,2,DefinitioN,2224,722,26,32,58,44.8%,19m
11184,2,[OldGuy]TritiumS,2224,50,9,12,21,42.9%,28m
11184,3,llllllllllll,2224,60,3,4,7,42.9%,26m
11184,3,빼액,2224,0,1,0,1,100.0%,25m
11184,3,무니,2224,0,1,1,2,50.0%,26m
11184,3,[고물잡]저글링,2224,0,0,2,2,0.0%,25m
11191,2,lTerryKl,2223,358,13,15,28,46.4%,46m
11191,2,[HTI]ShizukaRin,2223,0,2,3,5,40.0%,23m
11191,3,hideaki,2223,0,1,4,5,20.0%,22m
11191,3,zxelpha,2223,0,0,5,5,0.0%,25m
11195,3,모냐모냐,2222,361,19,27,46,41.3%,41m
11196,3,Winter,2221,136,12,14,26,46.2%,26m
11196,3,asahi,2221,226,9,11,20,45.0%,46m
11196,3,aaaaaaaaaaaa,2221,58,3,1,4,75.0%,25m
11196,2,하늘정원,2221,90,1,2,3,33.3%,23m
11200,3,Ticonderoga,2220,170,10,9,19,52.6%,46m
11200,3,URmyProtein,2220,134,5,6,11,45.5%,25m
11200,3,[쫄깃함]엔돌핀,2220,118,3,5,8,37.5%,41m
11200,3,프로즐겜러,2220,0,0,1,1,0.0%,46m
11200,2,Misty,2220,0,0,1,1,0.0%,23m
11205,3,당근,2219,532,18,24,42,42.9%,26m
11205,2,rhgkdud,2219,292,6,11,17,35.3%,23m
11205,3,[대한제국]Manking,2219,146,5,4,9,55.6%,26m
11205,3,patron,2219,0,1,5,6,16.7%,46m
11205,3,나는못해서진다,2219,0,0,3,3,0.0%,26m
11210,2,paputh,2218,474,17,23,40,42.5%,27m
11210,2,seeker,2218,150,6,11,17,35.3%,27m
11210,3,Owen,2218,125,3,9,12,25.0%,25m
11210,3,[oxox]ZooM,2218,46,1,6,7,14.3%,41m
11210,3,Zergology,2218,0,0,5,5,0.0%,26m
11215,2,[달빛암흑기사]DzDzDzDzDzDz,2217,0,1,3,4,25.0%,47m
11216,3,[테저프]원붕,2216,120,4,6,10,40.0%,25m
11216,3,칼의신화,2216,58,2,4,6,33.3%,26m
11218,2,kundi,2215,1462,131,143,274,47.8%,26m
11218,2,slick,2215,183,33,32,65,50.8%,28m
11218,3,DevilJin,2215,32,2,4,6,33.3%,26m
11218,2,Roverwing,2215,0,1,0,1,100.0%,23m
11218,1,퍼즐,2215,0,0,1,1,0.0%,25m
11223,2,ladlad,2214,198,5,9,14,35.7%,23m
11223,3,太史楚雲,2214,0,1,2,3,33.3%,23m
11223,3,아씨봐랑,2214,0,1,5,6,16.7%,23m
11223,2,aZbZcZ,2214,0,1,6,7,14.3%,27m
11223,2,sksk,2214,0,0,1,1,0.0%,23m
11223,3,쩡세,2214,0,0,2,2,0.0%,25m
11229,3,RwalkeR,2213,1466,53,72,125,42.4%,26m
11229,3,색시왜가리,2213,224,8,8,16,50.0%,26m
11229,2,[할리가이]hallyguy,2213,138,4,8,12,33.3%,23m
11229,3,KillerTerran,2213,61,3,5,8,37.5%,26m
11229,3,BABY,2213,90,3,7,10,30.0%,26m
11229,3,나는박삼수,2213,0,1,5,6,16.7%,41m
11229,3,Wanax,2213,0,0,2,2,0.0%,26m
11236,3,GOODMAN,2212,373,13,21,34,38.2%,26m
11236,2,곰보빵,2212,242,10,21,31,32.3%,48m
11236,2,너희집히로시마,2212,168,5,11,16,31.2%,47m
11236,3,냥이,2212,145,4,5,9,44.4%,25m
11240,3,小熊維尼哥,2211,425,16,22,38,42.1%,26m
11240,3,쏘핫,2211,213,8,12,20,40.0%,26m
11240,3,[효환이]이원준,2211,120,5,9,14,35.7%,25m
11240,3,수원킹카,2211,58,4,7,11,36.4%,26m
11240,3,한수가부족하다,2211,60,3,2,5,60.0%,46m
11240,1,wandius,2211,126,3,13,16,18.8%,24m
11240,3,[인공지능보통]미네랄캐기,2211,0,0,2,2,0.0%,25m
11247,2,자낙,2210,1537,73,79,152,48.0%,26m
11247,3,개요르꽁,2210,615,22,22,44,50.0%,26m
11247,1,도장,2210,310,12,12,24,50.0%,24m
11247,1,Mandu,2210,194,4,5,9,44.4%,24m
11247,3,Stwzx,2210,116,3,1,4,75.0%,46m
11247,1,포도리,2210,93,2,7,9,22.2%,47m
11247,3,Dodger,2210,0,1,4,5,20.0%,25m
11254,3,許祐儒,2209,1479,79,96,175,45.1%,25m
11254,1,BiggieSmalls,2209,1593,79,106,185,42.7%,48m
11254,3,Lieshiet,2209,640,27,26,53,50.9%,26m
11254,3,[달빛양념기사]안산스완유저,2209,144,6,5,11,54.5%,46m
11254,3,DELTA,2209,0,1,6,7,14.3%,23m
11254,3,[별똥별]드디어성공이다,2209,0,0,1,1,0.0%,41m
11254,1,COCO,2209,0,0,2,2,0.0%,23m
11254,3,jaybus,2209,0,0,3,3,0.0%,22m
11262,3,ygji,2208,62,2,4,6,33.3%,26m
11262,2,[모험단D]고속신발,2208,0,1,2,3,33.3%,23m
11262,3,jkjkjk,2208,0,1,5,6,16.7%,41m
11262,2,게임잘함,2208,0,0,1,1,0.0%,23m
11266,3,스타초보,2207,857,36,42,78,46.2%,46m
11266,1,명서동효도르,2207,84,15,32,47,31.9%,19m
11266,3,nuvisa,2207,72,2,6,8,25.0%,22m
11266,3,Viagran,2207,0,1,4,5,20.0%,22m
11270,3,oasisgggg,2206,116,5,4,9,55.6%,26m
11270,3,[NGameS]이리꾹,2206,88,4,5,9,44.4%,25m
11270,3,htviva,2206,167,4,5,9,44.4%,46m
11270,3,발란쉐,2206,88,3,5,8,37.5%,26m
11270,2,라떼는말이야,2206,0,2,6,8,25.0%,23m
11270,3,lwb,2206,0,1,0,1,100.0%,26m
11270,3,Ariuka,2206,0,0,1,1,0.0%,22m
11270,3,lllllllll,2206,0,0,2,2,0.0%,26m
11278,3,HiJ,2204,1518,106,129,235,45.1%,26m
11278,2,싸울아비,2204,1122,42,48,90,46.7%,47m
11278,3,이화유치원,2204,186,5,2,7,71.4%,25m
11278,3,slappy,2204,0,0,6,6,0.0%,22m
11282,2,암욜빠덜,2203,230,7,11,18,38.9%,27m
11282,3,rlaxorb,2203,192,6,2,8,75.0%,26m
11282,2,시월의전사,2203,178,6,17,23,26.1%,27m
11282,3,goodgirl,2203,58,3,1,4,75.0%,26m
11282,2,딴지맨,2203,48,2,3,5,40.0%,23m
11282,3,Lyn,2203,0,0,1,1,0.0%,26m
11288,3,Holysmokes,2202,60,2,5,7,28.6%,25m
11288,3,테호,2202,0,0,1,1,0.0%,41m
11290,3,[트런들]퐈이터창키,2201,221,15,11,26,57.7%,26m
11290,3,qqqq,2201,317,12,13,25,48.0%,26m
11290,2,일진,2201,270,10,10,20,50.0%,28m
11290,3,[너의ol름은]towns,2201,60,2,5,7,28.6%,41m
11290,3,저그유저임,2201,32,1,6,7,14.3%,22m
11295,1,RinI,2200,1433,115,134,249,46.2%,19m
11295,1,[Bliss]무리,2200,606,23,32,55,41.8%,21m
11295,2,임날동,2200,139,3,7,10,30.0%,23m
11298,2,garagarago,2199,571,24,27,51,47.1%,28m
11298,3,[우한폐렴]cjihun,2199,410,16,16,32,50.0%,26m
11298,3,BlackOwl,2199,269,12,9,21,57.1%,26m
11298,2,께천,2199,228,8,19,27,29.6%,27m
11298,3,Goospery,2199,30,2,2,4,50.0%,26m
11298,3,KRterran,2199,0,1,5,6,16.7%,23m
11304,2,[NGameS]Meister,2198,1095,42,47,89,47.2%,47m
11304,2,WIZDOM,2198,466,17,22,39,43.6%,47m
11304,3,[별똥별]애긔겅듀,2198,250,8,14,22,36.4%,26m
11307,2,왕돼지,2197,799,27,38,65,41.5%,47m
11307,3,[프로토스협회]다섯살선생님,2197,0,1,0,1,100.0%,26m
11307,2,captiancake,2197,0,0,1,1,0.0%,23m
11307,3,ItsKimmed,2197,0,0,5,5,0.0%,22m
11311,2,아오지탄광,2196,334,23,34,57,40.4%,28m
11311,2,HotHatch,2196,404,14,20,34,41.2%,47m
11311,2,TOP,2196,214,9,15,24,37.5%,28m
11311,3,더오브인영이,2196,126,4,8,12,33.3%,25m
11311,3,DooWee,2196,0,1,4,5,20.0%,46m
11311,3,다오,2196,0,0,5,5,0.0%,26m
11317,3,wiwiw,2195,148,6,9,15,40.0%,26m
11317,3,초심,2195,0,2,4,6,33.3%,22m
11317,2,Hunter,2195,0,1,7,8,12.5%,47m
11317,3,MaxPonce,2195,0,0,2,2,0.0%,25m
11321,2,Castiglione,2194,1428,128,148,276,46.4%,47m
11321,2,개못하네,2194,381,13,18,31,41.9%,46m
11321,3,난죽경없,2194,350,13,20,33,39.4%,41m
11321,2,호색광,2194,140,6,11,17,35.3%,28m
11321,3,난죽경없,2194,86,3,1,4,75.0%,26m
11321,3,가을,2194,0,0,2,2,0.0%,22m
11321,3,안녕하스으,2194,0,0,4,4,0.0%,25m
11328,2,Lantern,2193,1541,394,468,862,45.7%,27m
11328,3,[중금속중독자]대영제국,2193,134,6,6,12,50.0%,26m
11328,2,HyeBingGoo,2193,0,2,5,7,28.6%,46m
11328,3,hercules,2193,0,0,1,1,0.0%,46m
11332,1,IIIIIIIIIIII,2192,249,8,14,22,36.4%,24m
11332,3,쌉벌레왕자,2192,0,0,1,1,0.0%,22m
11332,2,황혼의땅콩마스터,2192,0,0,3,3,0.0%,23m
11335,2,stadoll,2191,644,19,37,56,33.9%,28m
11335,3,스테이꾸,2191,0,0,1,1,0.0%,25m
11335,3,StOrY,2191,0,0,5,5,0.0%,22m
11338,3,캐릭터,2190,288,11,10,21,52.4%,26m
11338,1,llllllllll,2190,0,0,1,1,0.0%,23m
11340,3,아랍석유부자,2189,271,11,17,28,39.3%,25m
11340,3,Sniper,2189,99,5,10,15,33.3%,26m
11340,3,KEPO,2189,97,2,2,4,50.0%,25m
11340,3,Qiubi,2189,0,1,4,5,20.0%,41m
11344,3,눈감고공격,2188,0,1,5,6,16.7%,26m
11345,2,물곰,2187,840,29,39,68,42.6%,27m
11345,3,woojoo,2187,258,8,14,22,36.4%,25m
11345,3,tiom,2187,0,2,3,5,40.0%,26m
11345,2,suion,2187,42,1,3,4,25.0%,23m
11345,2,[DMW요원]lgkh,2187,0,1,7,8,12.5%,23m
11345,3,Ianys,2187,0,0,6,6,0.0%,41m
11351,2,나야나야,2186,1495,324,375,699,46.4%,28m
11351,1,VVIP,2186,1466,51,77,128,39.8%,20m
11351,3,stanvoke,2186,322,12,16,28,42.9%,26m
11351,3,一葉之秋,2186,202,8,8,16,50.0%,46m
11351,2,나는브론즈다,2186,203,7,14,21,33.3%,46m
11351,2,스키드로우,2186,158,3,7,10,30.0%,19m
11351,1,nathan,2186,30,3,8,11,27.3%,47m
11351,1,도환,2186,144,2,4,6,33.3%,25m
11351,2,jbomb,2186,91,1,2,3,33.3%,23m
11351,3,민슥이,2186,0,0,5,5,0.0%,23m
11361,1,ffffffffffff,2185,939,52,75,127,40.9%,20m
11361,3,fdffddf,2185,0,0,1,1,0.0%,26m
11363,1,IIIIIIIIIIII,2184,1545,120,150,270,44.4%,19m
11363,3,MAS,2184,616,22,18,40,55.0%,46m
11363,3,beginner,2184,240,9,15,24,37.5%,26m
11366,3,cityplanner,2183,519,17,28,45,37.8%,25m
11366,3,yeeee,2183,426,15,19,34,44.1%,26m
11366,3,lIlIlIlIlIlI,2183,172,6,9,15,40.0%,26m
11369,1,Hard,2182,1364,151,224,375,40.3%,20m
11369,2,Clockwork,2182,456,16,27,43,37.2%,28m
11369,3,ZERO,2182,0,1,0,1,100.0%,41m
11369,3,BST,2182,0,1,3,4,25.0%,26m
11369,1,NakanoMiku,2182,0,1,7,8,12.5%,47m
11369,3,Chiaki,2182,0,0,1,1,0.0%,26m
11375,3,윤짱,2181,636,25,19,44,56.8%,26m
11375,2,sdteran,2181,625,22,25,47,46.8%,28m
11375,2,미미즈쿠류,2181,48,1,6,7,14.3%,23m
11375,3,星之耀,2181,0,0,1,1,0.0%,26m
11379,2,leedg,2180,1123,75,92,167,44.9%,26m
11379,3,Ponyo,2180,230,9,11,20,45.0%,26m
11379,3,[푸른하늘]min,2180,0,1,1,2,50.0%,41m
11379,3,[KRSC2]BookBox,2180,0,0,3,3,0.0%,41m
11383,3,yjh,2179,979,78,99,177,44.1%,41m
11383,3,[밀짚모해적단]저그충,2179,86,3,2,5,60.0%,26m
11383,2,HIC,2179,0,1,0,1,100.0%,23m
11383,2,beaver,2179,0,1,6,7,14.3%,46m
11383,3,보성이,2179,0,0,1,1,0.0%,25m
11383,3,태란트롤,2179,0,0,5,5,0.0%,22m
11389,3,rjdmldbtshfd,2178,1161,42,48,90,46.7%,26m
11389,2,EOD,2178,370,33,46,79,41.8%,27m
11389,3,blitzz,2178,577,22,31,53,41.5%,26m
11389,3,qerdf,2178,474,17,16,33,51.5%,25m
11389,3,피바다,2178,200,8,14,22,36.4%,26m
11389,2,HSIN,2178,274,8,15,23,34.8%,28m
11389,3,닉네임,2178,30,2,6,8,25.0%,26m
11396,2,사람입니다,2177,30,2,8,10,20.0%,19m
11397,2,옥종승,2176,1449,56,66,122,45.9%,26m
11397,2,다산다,2176,130,5,14,19,26.3%,28m
11397,3,IIIIIII,2176,0,1,1,2,50.0%,22m
11400,2,BossMan,2175,751,27,37,64,42.2%,26m
11400,3,我不是好人,2175,705,26,38,64,40.6%,26m
11400,3,PAPIRRIN,2175,0,0,5,5,0.0%,46m
11403,1,Mathew,2174,718,25,35,60,41.7%,47m
11403,2,superbeginer,2174,332,13,16,29,44.8%,28m
11403,2,갓기성,2174,30,5,6,11,45.5%,46m
11406,3,gyubeom,2173,1237,115,148,263,43.7%,26m
11406,3,어떡해든됨,2173,374,11,21,32,34.4%,26m
11406,3,[zafron]mhdi,2173,194,5,12,17,29.4%,26m
11406,3,만렙전사,2173,118,4,8,12,33.3%,26m
11406,3,Enjoy,2173,97,2,4,6,33.3%,46m
11406,2,가자고,2173,0,2,8,10,20.0%,23m
11406,3,[초천재]배가고프다,2173,0,1,0,1,100.0%,22m
11413,3,막강한엘프,2172,870,38,57,95,40.0%,26m
11413,3,샤넬꾸찌,2172,30,2,3,5,40.0%,46m
11413,3,공룡고기,2172,58,2,4,6,33.3%,26m
11413,2,이지안,2172,0,1,6,7,14.3%,23m
11413,3,[ElsAna]니모야,2172,0,0,2,2,0.0%,22m
11418,3,Pasta,2171,1539,81,102,183,44.3%,54m
11418,2,LeonLei,2171,1354,53,66,119,44.5%,19m
11418,2,하방,2171,132,4,11,15,26.7%,27m
11421,3,[축구의전설]용맹한레이너,2170,114,4,6,10,40.0%,25m
11421,3,Stukovspinoy,2170,0,1,0,1,100.0%,46m
11421,1,GoldApple,2170,0,1,0,1,100.0%,24m
11421,2,간지지노,2170,0,1,6,7,14.3%,23m
11425,2,[AZUSA]안인균,2169,0,0,1,1,0.0%,23m
11425,3,tsaiyinwen,2169,0,0,5,5,0.0%,25m
11427,3,Anija,2168,1144,53,67,120,44.2%,26m
11428,3,meekking,2167,686,24,25,49,49.0%,26m
11428,3,브라우니,2167,140,5,3,8,62.5%,26m
11430,1,육감적인남자,2166,727,32,52,84,38.1%,21m
11430,3,사랑,2166,145,4,1,5,80.0%,26m
11430,3,科科男,2166,30,2,1,3,66.7%,26m
11430,2,MrTwister,2166,97,2,4,6,33.3%,23m
11434,3,rangu,2165,809,33,56,89,37.1%,26m
11434,3,antivirus,2165,121,4,11,15,26.7%,48m
11434,3,jwae,2165,30,1,4,5,20.0%,26m
11437,2,謝老闆之我愛台灣,2164,1552,155,166,321,48.3%,27m
11437,3,heybro,2164,394,15,14,29,51.7%,26m
11437,3,Hanzo,2164,144,3,3,6,50.0%,26m
11437,3,rkwk,2164,0,0,1,1,0.0%,25m
11437,2,[더붉은공산당]피플,2164,0,0,1,1,0.0%,23m
11442,2,RedHiLL,2163,414,15,22,37,40.5%,28m
11442,3,KnightSoul,2163,231,8,11,19,42.1%,26m
11442,2,멍청도사나이,2163,60,5,6,11,45.5%,28m
11442,3,테란,2163,0,0,1,1,0.0%,25m
11446,3,Thermalster,2162,1071,48,48,96,50.0%,26m
11446,3,roro,2162,0,1,2,3,33.3%,26m
11446,3,임쓸,2162,0,0,1,1,0.0%,26m
11449,3,kkt,2161,342,13,12,25,52.0%,25m
11449,2,pica,2161,266,10,13,23,43.5%,27m
11449,2,JokeR,2161,0,1,6,7,14.3%,46m
11449,3,메르시,2161,0,0,1,1,0.0%,22m
11453,2,Zero,2160,180,8,10,18,44.4%,46m
11453,3,Unknown,2160,117,2,2,4,50.0%,26m
11453,3,LikMijnBalle,2160,76,2,6,8,25.0%,22m
11453,3,WPFWPROPS,2160,0,1,0,1,100.0%,22m
11453,3,cjeri,2160,30,1,2,3,33.3%,41m
11453,1,simsime,2160,0,0,4,4,0.0%,25m
11459,3,[Aoueja]송장벌레,2159,121,2,1,3,66.7%,26m
11459,3,도엽아울지마,2159,0,0,1,1,0.0%,25m
11461,1,www,2158,1292,57,68,125,45.6%,20m
11461,3,히오스는로딩중,2158,315,11,7,18,61.1%,26m
11461,1,[존못들]cliem,2158,210,6,13,19,31.6%,21m
11461,2,najjangda,2158,44,2,8,10,20.0%,23m
11461,3,IlIlIlIlIlIl,2158,48,2,9,11,18.2%,22m
11461,3,[얼굴]참치,2158,30,1,1,2,50.0%,26m
11461,3,Devil,2158,0,0,3,3,0.0%,26m
11461,3,[땅거미지뢰]llllllllllll,2158,0,0,5,5,0.0%,46m
11469,3,fdgfdxgfdsgf,2157,288,10,11,21,47.6%,26m
11469,3,HeLLion,2157,90,3,6,9,33.3%,26m
11469,2,[망겜장인]봄날벚꽃,2157,124,2,3,5,40.0%,23m
11472,3,빠무환영,2156,464,18,21,39,46.2%,25m
11472,3,혈풍우,2156,351,12,17,29,41.4%,25m
11472,3,KingOfWar,2156,0,0,1,1,0.0%,25m
11472,3,민서병신,2156,0,0,1,1,0.0%,26m
11472,3,choko,2156,0,0,2,2,0.0%,26m
11472,3,대박이엄마,2156,0,0,3,3,0.0%,41m
11478,3,Cnstellation,2155,1550,180,226,406,44.3%,26m
11478,2,[이주호다]protossing,2155,0,2,5,7,28.6%,47m
11478,3,구백이,2155,0,0,1,1,0.0%,46m
11481,2,ajtwoddl,2154,1082,64,84,148,43.2%,27m
11481,3,ljsk,2154,1141,62,79,141,44.0%,26m
11481,3,Corw,2154,567,20,22,42,47.6%,26m
11481,3,andy,2154,432,15,19,34,44.1%,26m
11481,3,호로로롤,2154,30,2,2,4,50.0%,46m
11481,3,[TERAN]자기야이리와,2154,0,1,1,2,50.0%,46m
11481,3,lllllllllll,2154,0,1,3,4,25.0%,26m
11481,3,[브리티안]슬기체고임,2154,0,1,6,7,14.3%,41m
11489,3,chanresankag,2153,116,4,6,10,40.0%,26m
11489,2,마법사,2153,133,3,13,16,18.8%,19m
11489,3,hounho,2153,30,2,1,3,66.7%,26m
11492,2,김민재,2152,212,20,30,50,40.0%,28m
11492,2,mldben,2152,328,12,20,32,37.5%,47m
11492,3,marty,2152,62,4,5,9,44.4%,23m
11492,2,[APinKK]William,2152,109,2,3,5,40.0%,23m
11492,3,ohno,2152,97,1,1,2,50.0%,25m
11492,3,개꿀,2152,0,1,4,5,20.0%,41m
11492,1,와니,2152,0,0,4,4,0.0%,25m
11499,3,게맛살,2151,411,13,13,26,50.0%,25m
11499,3,[달빛암흑기사]영희책상철책상,2151,0,0,1,1,0.0%,26m
11499,3,개찐,2151,0,0,2,2,0.0%,26m
11499,3,[디플]미스한,2151,0,0,3,3,0.0%,46m
11503,3,真命天子,2150,1300,89,119,208,42.8%,26m
11503,3,신흥,2150,541,20,22,42,47.6%,46m
11503,3,하늘구름,2150,522,18,24,42,42.9%,25m
11503,3,박상귕,2150,406,13,21,34,38.2%,26m
11503,3,[비율실화냐]IRENE,2150,230,6,12,18,33.3%,25m
11503,3,Legend,2150,0,0,4,4,0.0%,25m
11509,1,purelycash,2149,274,10,15,25,40.0%,23m
11509,3,다크패이스,2149,166,8,7,15,53.3%,41m
11509,3,johnny,2149,90,3,10,13,23.1%,46m
11509,2,reds,2149,0,1,7,8,12.5%,23m
11509,3,lee,2149,0,0,2,2,0.0%,46m
11514,3,myeunil,2148,465,17,17,34,50.0%,26m
11514,3,Stormedge,2148,126,5,5,10,50.0%,26m
11514,2,자원늬,2148,30,2,7,9,22.2%,47m
11517,3,lililililili,2147,418,16,22,38,42.1%,26m
11517,2,MINKU,2147,0,1,2,3,33.3%,23m
11519,3,TomCat,2146,273,8,10,18,44.4%,26m
11519,3,[이카르스M]이카루스,2146,0,2,2,4,50.0%,22m
11519,3,저녁노을,2146,30,1,2,3,33.3%,26m
11522,3,파괴자,2145,122,6,9,15,40.0%,46m
11522,2,sheton,2145,0,1,0,1,100.0%,23m
11524,3,Zorg,2144,0,2,4,6,33.3%,46m
11524,3,늅늅이,2144,0,0,3,3,0.0%,26m
11524,3,sonam,2144,0,0,5,5,0.0%,22m
11527,3,권준,2143,58,4,6,10,40.0%,46m
11527,1,할수있다,2143,0,2,9,11,18.2%,24m
11527,3,keo,2143,0,1,0,1,100.0%,46m
11527,2,albert,2143,46,1,1,2,50.0%,23m
11527,3,ddkfs,2143,30,1,6,7,14.3%,41m
11527,3,[맨소래담]츠연,2143,0,0,4,4,0.0%,23m
11533,3,글램,2142,199,6,11,17,35.3%,46m
11533,1,전다의전설,2142,189,5,8,13,38.5%,23m
11533,2,KSY,2142,58,2,15,17,11.8%,27m
11533,3,陳明照,2142,0,1,0,1,100.0%,26m
11533,2,기리보이,2142,0,1,5,6,16.7%,47m
11538,3,good,2141,269,11,11,22,50.0%,26m
11538,3,AuricTesla,2141,72,5,4,9,55.6%,26m
11538,3,marineboy,2141,0,0,1,1,0.0%,26m
11541,2,dadada,2140,1468,66,76,142,46.5%,28m
11541,3,무적함대테란,2140,1529,57,62,119,47.9%,25m
11541,3,얼짱민정,2140,116,2,8,10,20.0%,26m
11544,3,내어깨위고양이밥,2139,979,35,62,97,36.1%,53m
11544,3,聖誕老公公,2139,469,30,30,60,50.0%,26m
11544,3,[Apink2]Apink,2139,810,29,38,67,43.3%,41m
11544,2,TYyayayay,2139,172,16,27,43,37.2%,28m
11544,3,[독일국방군]솜콩이,2139,229,7,11,18,38.9%,25m
11544,3,윤똥그리,2139,40,2,2,4,50.0%,41m
11550,3,vicboy,2138,1333,49,64,113,43.4%,25m
11550,2,[부산의심장]스타머신,2138,748,25,39,64,39.1%,27m
11550,3,MizraH,2138,351,12,21,33,36.4%,26m
11550,2,쿠쿠,2138,0,2,7,9,22.2%,23m
11554,3,Heute,2137,126,4,5,9,44.4%,26m
11554,3,[어윤수님개쩜]공의가저죽여요,2137,88,4,8,12,33.3%,26m
11554,3,玄天魂帝,2137,58,3,10,13,23.1%,26m
11554,3,군단의심장이다,2137,0,0,6,6,0.0%,22m
11558,3,松島楓,2135,1511,108,159,267,40.4%,26m
11558,3,AkiraTJ,2135,710,27,37,64,42.2%,26m
11558,3,[기니피그]바람청풍,2135,202,8,7,15,53.3%,26m
11561,2,NSMaru,2134,1429,141,190,331,42.6%,19m
11561,3,kfhdngxkhvj,2134,577,22,19,41,53.7%,26m
11561,1,테란컨트롤러,2134,289,9,20,29,31.0%,47m
11561,3,풋고추풋잡,2134,0,0,2,2,0.0%,25m
11561,3,파워버섯,2134,0,0,5,5,0.0%,46m
11561,3,wai,2134,0,0,5,5,0.0%,46m
11567,3,CodeREQ,2133,296,11,17,28,39.3%,25m
11567,3,[그시절의]인체해부학,2133,0,1,0,1,100.0%,25m
11567,2,[BOB]Fomula,2133,0,0,1,1,0.0%,23m
11567,3,Roon,2133,0,0,1,1,0.0%,22m
11567,3,태현유,2133,0,0,5,5,0.0%,26m
11572,3,goodchoi,2132,0,0,1,1,0.0%,46m
11572,3,쭈니아트,2132,0,0,3,3,0.0%,26m
11574,3,hgfkhjk,2131,661,26,23,49,53.1%,26m
11574,3,힝힝흐엥,2131,97,2,3,5,40.0%,26m
11574,3,mrhong,2131,30,2,4,6,33.3%,41m
11574,3,TinyMarine,2131,0,0,1,1,0.0%,26m
11578,2,SAS,2130,88,1,1,2,50.0%,23m
11579,2,starsoldier,2129,1478,84,105,189,44.4%,19m
11579,3,TeNteN,2129,610,29,37,66,43.9%,25m
11579,3,SeNtrY,2129,0,1,0,1,100.0%,22m
11579,3,조윤호짱짱맨,2129,30,1,4,5,20.0%,26m
11579,3,lowfi,2129,0,0,5,5,0.0%,41m
11584,3,小廢物,2128,1177,109,133,242,45.0%,25m
11584,3,JABAASS,2128,97,1,2,3,33.3%,25m
11586,2,cello,2127,268,12,15,27,44.4%,28m
11586,3,아무거나,2127,194,5,4,9,55.6%,27m
11586,3,[경찰과밥둑]ojeezSCV,2127,85,4,7,11,36.4%,22m
11586,3,Kum,2127,97,3,0,3,100.0%,25m
11586,3,[간절히원하면]Sunnyrise,2127,30,1,2,3,33.3%,26m
11591,3,soulkick,2126,336,12,20,32,37.5%,26m
11592,2,NOTE,2125,204,5,11,16,31.2%,23m
11592,3,RONA,2125,122,4,8,12,33.3%,26m
11592,3,이정주,2125,0,0,1,1,0.0%,26m
11592,3,[엔더짱]uzmaki,2125,0,0,7,7,0.0%,27m
11596,2,[CIA암살단]ggah,2124,189,8,3,11,72.7%,27m
11596,3,[트롤처리반장]유즈맵하는보병,2124,219,6,5,11,54.5%,25m
11596,3,resibing,2124,0,1,1,2,50.0%,46m
11596,3,원이네,2124,0,0,3,3,0.0%,23m
11600,3,syu,2123,121,2,7,9,22.2%,26m
11601,3,cont,2122,243,11,5,16,68.8%,46m
11601,3,awdsf,2122,168,4,4,8,50.0%,25m
11601,2,SinAmzi,2122,111,2,2,4,50.0%,23m
11604,2,danny,2121,411,14,23,37,37.8%,27m
11604,2,lsr,2121,183,8,12,20,40.0%,47m
11604,3,thank,2121,237,6,8,14,42.9%,26m
11604,3,中二魯肉,2121,0,0,1,1,0.0%,22m
11608,2,뿝빠바밥,2120,182,7,5,12,58.3%,46m
11608,2,우영짱짱맨,2120,102,2,2,4,50.0%,23m
11608,1,Crazyangel,2120,0,1,1,2,50.0%,24m
11608,3,정지원입니다,2120,0,0,5,5,0.0%,41m
11612,3,풍운,2119,218,7,12,19,36.8%,25m
11612,1,레전드오브김씨,2119,97,2,6,8,25.0%,24m
11614,3,세수하며쓔컹쓔컹,2118,0,1,2,3,33.3%,26m
11614,2,rhtlkasdlf,2118,0,0,1,1,0.0%,23m
11614,3,Polyko,2118,0,0,1,1,0.0%,22m
11617,3,김동철,2117,638,22,21,43,51.2%,26m
11617,2,StarWars,2117,233,6,13,19,31.6%,23m
11617,2,주횽,2117,92,4,6,10,40.0%,47m
11617,2,JinSeo,2117,90,2,6,8,25.0%,23m
11617,3,scer,2117,0,1,1,2,50.0%,26m
11622,3,[대한민국육군]야전수송교육단,2116,1004,46,50,96,47.9%,26m
11622,3,LUFFY,2116,360,35,58,93,37.6%,26m
11624,3,[NCF]Crankit,2115,1354,62,86,148,41.9%,26m
11624,3,spacer,2115,594,21,24,45,46.7%,26m
11624,3,byj,2115,88,4,4,8,50.0%,26m
11624,1,Happy,2115,0,1,0,1,100.0%,25m
11628,3,[해병대]생새우초밥,2114,670,24,28,52,46.2%,26m
11628,3,[OARAY]라우라라,2114,118,5,7,12,41.7%,41m
11628,3,GMooZ,2114,177,4,13,17,23.5%,46m
11628,2,[NTW]DamnLotus,2114,90,2,9,11,18.2%,23m
11628,1,starship,2114,0,0,1,1,0.0%,25m
11628,3,JJC,2114,0,0,1,1,0.0%,22m
11634,2,[國本]POLARIS,2113,1256,64,79,143,44.8%,27m
11634,3,otrans,2113,62,2,8,10,20.0%,25m
11636,3,청바지,2112,447,30,35,65,46.2%,25m
11636,1,슈팅스타,2112,44,1,1,2,50.0%,23m
11638,2,[클랜마크전용]엄청난파괴력,2111,1446,112,149,261,42.9%,28m
11638,3,루피,2111,0,1,6,7,14.3%,46m
11640,3,tyler,2110,454,14,28,42,33.3%,26m
11640,1,spdchandon,2110,0,0,1,1,0.0%,24m
11642,2,빛갚프리오,2109,114,4,10,14,28.6%,23m
11642,3,불곰,2109,58,2,7,9,22.2%,26m
11644,3,[000]阿布拉瓜,2108,0,1,4,5,20.0%,23m
11645,3,김명자낙지마당,2107,293,12,12,24,50.0%,46m
11645,1,qwer,2107,263,8,10,18,44.4%,25m
11645,3,시라소니,2107,180,7,15,22,31.8%,46m
11645,2,커피물조절장인,2107,0,1,1,2,50.0%,23m
11645,3,[아아아옷치]아아아아아옷치,2107,22,1,4,5,20.0%,26m
11650,3,스타해야지,2106,301,11,12,23,47.8%,26m
11650,2,ALLISWELL,2106,114,5,8,13,38.5%,47m
11650,3,베스트제로,2106,34,1,9,10,10.0%,41m
11653,2,그레이트하우스,2105,875,146,177,323,45.2%,28m
11653,3,도라에몽,2105,1471,135,164,299,45.2%,41m
11653,3,말랑카우,2105,114,4,8,12,33.3%,26m
11656,3,BINGO,2104,60,2,10,12,16.7%,26m
11656,3,[스웨덴제국]먼길돌라시,2104,32,1,6,7,14.3%,46m
11656,2,AquaMan,2104,0,1,7,8,12.5%,47m
11659,3,멀꼴아바,2103,1257,154,207,361,42.7%,25m
11659,3,sTarFR,2103,957,40,63,103,38.8%,26m
11659,3,성민이는발기부전,2103,426,14,26,40,35.0%,26m
11659,2,이노티아,2103,112,3,7,10,30.0%,23m
11659,3,인생무상,2103,0,2,4,6,33.3%,46m
11659,1,사팔팔공점넷,2103,0,0,1,1,0.0%,25m
11665,2,hahach,2102,918,64,79,143,44.8%,28m
11665,1,skwavans,2102,154,5,3,8,62.5%,24m
11665,3,[FXUXG]engengeng,2102,98,3,15,18,16.7%,26m
11665,1,xHemmax,2102,48,1,2,3,33.3%,25m
11665,3,crystaly,2102,30,1,3,4,25.0%,46m
11670,1,BLEST,2101,590,15,5,20,75.0%,25m
11670,2,askman,2101,0,0,1,1,0.0%,23m
11672,1,황혼,2100,1018,39,61,100,39.0%,21m
11672,3,cao,2100,0,2,4,6,33.3%,46m
11672,2,넌내게빠져,2100,46,2,9,11,18.2%,23m
11672,1,pro,2100,0,0,2,2,0.0%,25m
11672,3,젝스장인,2100,0,0,7,7,0.0%,23m
11677,3,이강준,2099,952,33,49,82,40.2%,26m
11677,2,반다크홈,2099,214,6,9,15,40.0%,23m
11677,3,IIIIIIIIIIII,2099,32,1,8,9,11.1%,26m
11677,3,shadve,2099,0,0,1,1,0.0%,22m
11677,3,lllllllllll,2099,0,0,1,1,0.0%,41m
11677,3,잼민이,2099,0,0,5,5,0.0%,23m
11677,3,CAPTAIN,2099,0,0,6,6,0.0%,41m
11677,2,이름변경,2099,0,0,8,8,0.0%,27m
11685,2,靈魂小大人,2098,44,2,1,3,66.7%,23m
11685,3,MiRyunGomTan,2098,58,2,5,7,28.6%,25m
11687,1,Dolphin,2097,399,11,12,23,47.8%,23m
11687,1,JonSnow,2097,48,2,0,2,100.0%,23m
11687,1,KIM,2097,0,0,1,1,0.0%,25m
11690,3,김첨지,2096,105,7,2,9,77.8%,26m
11690,3,ShnitzelOps,2096,196,5,5,10,50.0%,25m
11690,3,[국가정보원]닭다리백수,2096,0,1,0,1,100.0%,23m
11693,1,서민,2095,94,3,1,4,75.0%,25m
11694,3,RAMD,2093,229,6,7,13,46.2%,26m
11694,2,Sasule,2093,148,6,13,19,31.6%,46m
11694,1,junseok,2093,139,2,9,11,18.2%,24m
11697,3,[isnous]Vincent,2092,386,15,7,22,68.2%,26m
11698,3,TROY,2091,264,13,20,33,39.4%,25m
11698,2,천안킹카,2091,66,3,9,12,25.0%,23m
11698,1,[달빛양념기사]CHINABLUE,2091,38,2,0,2,100.0%,25m
11698,1,날라다니는전차들,2091,96,2,3,5,40.0%,25m
11698,1,낑깡,2091,0,0,1,1,0.0%,25m
11698,1,어어어어,2091,0,0,1,1,0.0%,25m
11704,3,Lily,2090,666,25,31,56,44.6%,26m
11704,2,내뒤에사탕,2090,259,8,20,28,28.6%,47m
11704,3,GRAVES,2090,44,2,3,5,40.0%,22m
11704,3,duukan,2090,0,1,2,3,33.3%,46m
11704,3,Kata,2090,0,0,1,1,0.0%,41m
11709,2,로얄드래곤,2089,310,10,18,28,35.7%,47m
11709,3,이찬노엄마,2089,30,2,4,6,33.3%,26m
11709,1,llllllllll,2089,48,1,4,5,20.0%,24m
11712,2,upanddown,2088,235,7,13,20,35.0%,23m
11712,1,StefanOPS,2088,68,5,12,17,29.4%,47m
11712,3,[프로토스협회]유비,2088,125,2,5,7,28.6%,26m
11712,1,[군주]NirvanaShin,2088,0,0,1,1,0.0%,25m
11716,3,kaisersoss,2087,1377,96,130,226,42.5%,26m
11717,3,TerranKing,2086,356,13,24,37,35.1%,26m
11717,3,renzodeee,2086,0,1,3,4,25.0%,26m
11719,3,knight,2085,1409,105,133,238,44.1%,26m
11719,3,roa,2085,841,37,42,79,46.8%,26m
11719,3,대전이영호,2085,760,29,26,55,52.7%,26m
11719,1,[펭수crew]WannagohomE,2085,0,0,5,5,0.0%,25m
11723,3,[원탑1st]혜윰,2084,1126,41,58,99,41.4%,26m
11723,1,사자부대,2084,236,5,7,12,41.7%,25m
11725,3,[공포는환상]baexi,2083,902,33,45,78,42.3%,26m
11725,3,Pheroic,2083,0,1,6,7,14.3%,41m
11727,2,ichiya,2082,1497,54,73,127,42.5%,47m
11727,3,我誰,2082,94,3,9,12,25.0%,42m
11727,1,minhoo,2082,0,1,0,1,100.0%,25m
11727,1,스타크래프트,2082,48,1,6,7,14.3%,25m
11731,3,羊群歸主阿門,2081,30,1,3,4,25.0%,46m
11732,3,kkj,2080,862,60,71,131,45.8%,26m
11732,3,yoki,2080,601,23,36,59,39.0%,26m
11732,3,아스가르드,2080,488,16,22,38,42.1%,27m
11735,3,TheMexican,2079,282,9,17,26,34.6%,26m
11735,3,心理戰術大師,2079,164,5,13,18,27.8%,25m
11735,3,[ZUZU]SDnew,2079,0,0,5,5,0.0%,22m
11738,3,로이존스,2078,359,14,17,31,45.2%,25m
11738,1,萧张,2078,192,6,17,23,26.1%,24m
11738,3,김태일,2078,36,2,7,9,22.2%,41m
11738,1,BJhome,2078,0,1,0,1,100.0%,23m
11738,1,장뚱어,2078,48,1,3,4,25.0%,24m
11738,3,XxrektxX,2078,0,1,6,7,14.3%,26m
11738,2,TemPesT,2078,0,1,8,9,11.1%,47m
11738,1,flasher,2078,0,0,2,2,0.0%,24m
11746,1,tomklm,2077,253,9,15,24,37.5%,24m
11747,3,ASOP,2076,377,15,18,33,45.5%,26m
11747,3,뿌뿌빠뿌,2076,306,13,8,21,61.9%,26m
11747,3,탱크맨,2076,287,8,20,28,28.6%,26m
11750,3,darkwhisper,2075,416,17,24,41,41.5%,26m
11750,3,보노보노,2075,261,7,15,22,31.8%,46m
11750,3,너거미,2075,72,2,8,10,20.0%,23m
11750,3,Fireghost,2075,80,2,9,11,18.2%,23m
11754,3,[비트]ahjahahjah,2074,1414,91,119,210,43.3%,42m
11754,2,Benito,2074,197,5,9,14,35.7%,23m
11754,3,가람,2074,90,3,9,12,25.0%,46m
11754,3,IllIlIlIIIlI,2074,148,3,10,13,23.1%,25m
11758,1,KaizerG,2073,42,2,0,2,100.0%,23m
11759,3,pop,2072,662,22,36,58,37.9%,26m
11759,2,Entropy,2072,359,13,22,35,37.1%,27m
11759,1,민속놀이뉴비,2072,48,1,1,2,50.0%,24m
11759,1,라단,2072,48,1,2,3,33.3%,25m
11759,1,YTlanke,2072,0,0,1,1,0.0%,25m
11764,3,dsdasdwe,2071,721,30,43,73,41.1%,25m
11764,1,modickm,2071,333,8,9,17,47.1%,25m
11766,3,아무거나,2070,176,6,11,17,35.3%,46m
11767,2,ThePritz,2069,214,5,13,18,27.8%,23m
11767,1,chaplin,2069,136,4,2,6,66.7%,24m
11769,3,llllllllll,2068,320,13,24,37,35.1%,26m
11769,3,tty,2068,222,8,16,24,33.3%,26m
11769,3,fgewg,2068,200,7,19,26,26.9%,42m
11769,1,bodori,2068,168,3,10,13,23.1%,24m
11769,1,라까뚜찌,2068,78,2,7,9,22.2%,25m
11769,1,HandyRobot,2068,0,1,0,1,100.0%,24m
11769,3,임지훈,2068,0,0,1,1,0.0%,22m
11769,1,[RELAK]qqq,2068,0,0,2,2,0.0%,25m
11777,1,[용암니]고다이반,2067,142,5,16,21,23.8%,47m
11778,3,Christine,2066,629,21,29,50,42.0%,26m
11778,1,너니너너,2066,315,7,12,19,36.8%,25m
11780,3,KTL,2065,0,0,2,2,0.0%,22m
11781,3,chang,2063,1502,178,219,397,44.8%,42m
11781,3,남도,2063,1270,61,76,137,44.5%,25m
11781,3,mano,2063,365,12,21,33,36.4%,46m
11781,1,asesome,2063,0,1,4,5,20.0%,25m
11781,3,Joyoung,2063,0,0,4,4,0.0%,26m
11786,3,barton,2062,920,37,42,79,46.8%,26m
11786,1,WhiteHoke,2062,0,0,1,1,0.0%,24m
11786,2,[EoC]xYakko,2062,0,0,2,2,0.0%,23m
11786,3,Ryne,2062,0,0,6,6,0.0%,26m
11790,3,IMeeE,2061,504,18,33,51,35.3%,48m
11790,1,suzukialu,2061,603,13,18,31,41.9%,24m
11790,3,별의사람,2061,30,1,2,3,33.3%,23m
11790,1,kioh,2061,0,0,1,1,0.0%,25m
11794,1,IIIIIIIIIIII,2060,0,0,4,4,0.0%,25m
11795,1,llllllllllll,2059,237,4,7,11,36.4%,25m
11795,3,jordanbj,2059,0,0,3,3,0.0%,46m
11797,1,흑마법사,2058,1422,41,59,100,41.0%,24m
11797,3,배부른소크라테스,2058,60,3,4,7,42.9%,46m
11797,1,terranbony,2058,0,1,0,1,100.0%,24m
11797,1,아오성철아모하냐,2058,48,1,3,4,25.0%,25m
11797,3,탐존,2058,0,0,2,2,0.0%,46m
11802,2,캬쩐다,2057,1189,75,92,167,44.9%,27m
11802,1,카와이너구리,2057,140,6,4,10,60.0%,24m
11804,3,우공,2056,462,21,25,46,45.7%,26m
11804,2,백호,2056,58,3,7,10,30.0%,28m
11804,2,작은악마띠모,2056,0,2,7,9,22.2%,47m
11804,3,AdVance,2056,0,0,5,5,0.0%,41m
11808,2,한녀보단서양녀,2054,193,5,12,17,29.4%,23m
11808,3,이강준장애,2054,0,1,6,7,14.3%,41m
11808,3,ASSCLOWN,2054,0,0,6,6,0.0%,25m
11811,3,violetox,2053,0,1,7,8,12.5%,22m
11812,3,aaa,2052,729,33,46,79,41.8%,26m
11812,1,NicsTan,2052,316,8,22,30,26.7%,25m
11812,1,Exdust,2052,48,2,1,3,66.7%,25m
11815,3,LioN,2051,1135,39,57,96,40.6%,26m
11815,3,파시피스타,2051,154,6,13,19,31.6%,26m
11815,3,액션소년,2051,0,1,6,7,14.3%,22m
11818,3,SHAO,2050,112,2,3,5,40.0%,26m
11819,3,kxyze,2049,396,16,18,34,47.1%,26m
11820,3,밤의살모사,2048,0,0,2,2,0.0%,23m
11821,3,[스카이파이터]트수,2047,551,18,25,43,41.9%,25m
11821,1,VivaFidel,2047,200,9,19,28,32.1%,20m
11821,3,奇犽,2047,212,8,20,28,28.6%,54m
11821,3,ToTo,2047,0,1,7,8,12.5%,22m
11821,1,루시난,2047,0,0,5,5,0.0%,25m
11826,3,Terran,2046,408,14,24,38,36.8%,26m
11827,3,[망겜장인]비켜주세요,2045,486,19,30,49,38.8%,26m
11827,1,randy,2045,178,5,6,11,45.5%,25m
11827,1,히든,2045,174,4,4,8,50.0%,25m
11830,1,Alpha,2044,184,4,6,10,40.0%,25m
11830,3,TgKim,2044,0,1,6,7,14.3%,26m
11830,1,ROKAF,2044,0,0,5,5,0.0%,25m
11833,1,倚天屠龙记,2043,0,0,3,3,0.0%,25m
11834,3,angryfish,2042,1448,183,272,455,40.2%,26m
11834,3,귀연다캉시,2042,364,18,22,40,45.0%,26m
11834,2,신사,2042,372,11,35,46,23.9%,28m
11837,3,sonata,2041,438,17,19,36,47.2%,27m
11837,1,Bainmote,2041,413,13,25,38,34.2%,24m
11837,3,Storm,2041,172,5,7,12,41.7%,46m
11840,1,카우보이,2040,0,0,4,4,0.0%,25m
11841,3,MrJacket,2039,1304,69,96,165,41.8%,26m
11841,3,[삼시를살려요]다혈질,2039,465,16,23,39,41.0%,26m
11843,3,[즐겜러]호크아이,2038,223,6,12,18,33.3%,46m
11844,3,유부,2037,664,24,49,73,32.9%,26m
11844,1,머리조심,2037,192,12,7,19,63.2%,25m
11846,1,봄사랑벚고박고,2036,952,36,49,85,42.4%,47m
11846,1,owo,2036,48,1,4,5,20.0%,25m
11848,3,靠腰阿如,2035,120,2,8,10,20.0%,25m
11849,1,너구리,2034,176,5,5,10,50.0%,25m
11849,1,TOM,2034,216,5,8,13,38.5%,25m
11849,1,미니미니,2034,0,1,0,1,100.0%,25m
11849,2,Yuir,2034,0,1,6,7,14.3%,27m
11849,2,CYRANO,2034,0,1,8,9,11.1%,47m
11854,2,광물이부족합니다,2033,105,3,10,13,23.1%,23m
11854,2,[DR]DEXTEROUS,2033,66,3,11,14,21.4%,19m
11856,3,모르는사람,2032,716,23,36,59,39.0%,26m
11856,1,jyj,2032,176,5,6,11,45.5%,25m
11856,3,[AUT]llllllllllll,2032,36,1,7,8,12.5%,22m
11856,2,[공허거주]CSW,2032,0,0,2,2,0.0%,23m
11860,2,Barn,2030,98,4,13,17,23.5%,27m
11861,3,마초,2029,1299,104,148,252,41.3%,25m
11861,1,강철장군,2029,844,20,27,47,42.6%,24m
11863,3,foonyon,2028,1025,37,52,89,41.6%,26m
11863,1,고약한개구리,2028,0,0,1,1,0.0%,23m
11865,2,대충지은닉넴,2027,460,14,24,38,36.8%,27m
11865,1,icehockey,2027,0,1,1,2,50.0%,24m
11865,3,빈이들,2027,0,1,5,6,16.7%,27m
11868,1,[밀리터리버거]MUSAT,2026,496,13,17,30,43.3%,25m
11869,1,advick,2025,722,17,18,35,48.6%,25m
11869,3,MightyOwl,2025,0,0,7,7,0.0%,22m
11871,1,단테,2024,614,14,18,32,43.8%,25m
11872,1,sky,2023,933,30,21,51,58.8%,24m
11872,1,건우짱,2023,815,24,39,63,38.1%,25m
11874,3,BlueBerryBox,2022,1304,47,61,108,43.5%,26m
11874,1,Edward,2022,758,20,17,37,54.1%,24m
11874,3,xcvzkjlhcdhk,2022,0,3,4,7,42.9%,22m
11877,3,고주형,2021,631,25,34,59,42.4%,25m
11877,1,김민석,2021,127,3,4,7,42.9%,25m
11877,2,OldGuy,2021,30,2,10,12,16.7%,19m
11880,3,NeWinday,2020,30,2,7,9,22.2%,41m
11881,2,GussoDDak,2019,218,8,14,22,36.4%,27m
11881,3,오계절,2019,0,1,8,9,11.1%,41m
11881,1,박성진,2019,0,0,5,5,0.0%,25m
11884,1,꿀빵,2018,122,3,5,8,37.5%,23m
11884,1,조아조아,2018,0,0,1,1,0.0%,25m
11886,1,[아케더]한서선민,2017,614,14,20,34,41.2%,23m
11886,3,블러드,2017,154,6,16,22,27.3%,26m
11886,1,너나사랑해,2017,0,0,2,2,0.0%,25m
11889,2,[Jug]전장의조운,2016,173,4,8,12,33.3%,23m
11889,2,공허의심장,2016,106,2,2,4,50.0%,23m
11891,1,raulacedo,2015,360,10,18,28,35.7%,24m
11892,3,Maxxima,2014,296,9,22,31,29.0%,26m
11892,1,처키형님,2014,212,5,11,16,31.2%,24m
11894,1,별천지,2013,0,0,1,1,0.0%,25m
11894,3,Ying,2013,0,0,7,7,0.0%,26m
11896,1,Atom,2012,434,11,16,27,40.7%,24m
11896,1,ckstn,2012,222,5,8,13,38.5%,24m
11896,3,[김태웅]KJTTY,2012,184,5,9,14,35.7%,46m
11896,2,그린,2012,72,2,5,7,28.6%,23m
11900,1,스카웃파이터,2011,244,6,7,13,46.2%,25m
11900,3,강철까마귀,2011,58,3,8,11,27.3%,27m
11900,2,히로,2011,0,0,2,2,0.0%,23m
11903,1,오드아이,2010,834,20,28,48,41.7%,25m
11903,1,[포방부]광주맹스크,2010,140,4,1,5,80.0%,25m
11903,3,overwatch,2010,0,0,1,1,0.0%,42m
11903,3,MarcoPremier,2010,0,0,1,1,0.0%,23m
11903,3,스타,2010,0,0,1,1,0.0%,42m
11908,1,QUYEN,2009,0,0,3,3,0.0%,25m
11909,3,MukaMo,2008,38,8,19,27,29.6%,27m
11909,1,jinlaynor,2008,0,4,2,6,66.7%,24m
11911,2,기회를위기로,2007,140,3,9,12,25.0%,47m
11912,1,[코랄공산당]김정은,2006,0,0,1,1,0.0%,25m
11913,1,holeman,2005,96,2,3,5,40.0%,25m
11913,2,isykim,2005,88,2,8,10,20.0%,23m
11915,3,IIIIIIIIIIII,2003,292,17,30,47,36.2%,26m
11916,3,[000]yaya,2002,364,12,23,35,34.3%,25m
11917,1,[얍삽하게]심심한사람,2001,174,5,16,21,23.8%,25m
11917,3,everpocket,2001,0,0,5,5,0.0%,22m
11919,3,제이빅라이언,2000,938,35,56,91,38.5%,25m
11919,1,hujundagu,2000,115,2,3,5,40.0%,24m
11919,1,접니다,2000,48,1,2,3,33.3%,25m
11919,1,Gamemaster,2000,0,0,2,2,0.0%,24m
11923,3,RheeMacs,1999,1161,59,84,143,41.3%,25m
11923,3,HwaYuiri,1999,149,3,10,13,23.1%,46m
11923,3,ahatake,1999,0,0,2,2,0.0%,41m
11926,1,Wolfdreicht,1998,86,3,4,7,42.9%,24m
11926,1,[zAWSLz]MOOOI,1998,0,1,0,1,100.0%,25m
11926,1,지주,1998,42,1,1,2,50.0%,25m
11929,2,Guardian,1997,173,5,12,17,29.4%,23m
11929,3,cristian,1997,92,3,15,18,16.7%,46m
11931,1,오빠믿고누워,1996,1012,27,37,64,42.2%,25m
11931,3,중국옂먹어,1996,184,4,13,17,23.5%,26m
11931,2,뉴비사냥꾼,1996,0,1,8,9,11.1%,27m
11934,3,clound,1995,434,14,25,39,35.9%,26m
11934,1,小葉,1995,230,6,13,19,31.6%,24m
11934,1,공허의추적자,1995,46,1,2,3,33.3%,24m
11934,3,꿀맛나는돼지,1995,0,0,2,2,0.0%,22m
11938,3,Dot,1994,1381,119,142,261,45.6%,25m
11938,1,BattlePants,1994,294,8,9,17,47.1%,25m
11938,1,스픈,1994,263,7,17,24,29.2%,24m
11938,2,[원탑1st]Cedrick,1994,117,2,10,12,16.7%,23m
11942,1,motorcraft,1993,572,17,32,49,34.7%,25m
11943,1,얼티밋나이트,1992,367,11,13,24,45.8%,24m
11943,1,jefe,1992,300,8,11,19,42.1%,25m
11943,3,明日方舟,1992,0,1,0,1,100.0%,22m
11943,2,해피뉴데이,1992,30,1,3,4,25.0%,23m
11947,3,꼭맞아,1991,30,2,10,12,16.7%,26m
11947,3,[ElsAna]SHOWyourself,1991,0,1,1,2,50.0%,23m
11949,1,불굴의의지,1989,1958,100,162,262,38.2%,24m
11949,3,핫썬,1989,0,0,3,3,0.0%,23m
11951,3,LSH,1988,418,12,29,41,29.3%,26m
11951,1,inken,1988,274,10,19,29,34.5%,25m
11953,3,셜록겜즈,1987,1056,85,114,199,42.7%,27m
11953,1,진환,1987,390,9,20,29,31.0%,25m
11953,2,Putnik,1987,164,4,15,19,21.1%,23m
11953,1,lee,1987,0,0,1,1,0.0%,25m
11957,3,SpecialK,1986,387,13,22,35,37.1%,25m
11957,1,주식천재,1986,268,6,8,14,42.9%,24m
11957,1,tre,1986,0,0,2,2,0.0%,24m
11960,3,[000]Whitebear,1985,274,10,15,25,40.0%,25m
11960,3,[사나이클럽]성장한김소현,1985,30,1,8,9,11.1%,41m
11960,3,llllllllllll,1985,0,0,1,1,0.0%,22m
11963,3,[개복교]ceo,1984,951,88,112,200,44.0%,27m
11963,1,아무거나,1984,1672,51,75,126,40.5%,24m
11963,1,HoshiyomiSVD,1984,0,0,1,1,0.0%,24m
11966,3,임준호,1983,760,27,50,77,35.1%,26m
11966,1,hippro,1983,180,4,12,16,25.0%,25m
11966,1,Xenomorph,1983,90,3,10,13,23.1%,24m
11966,1,청춘이라,1983,96,2,3,5,40.0%,24m
11970,1,Tenza,1982,962,29,35,64,45.3%,24m
11971,1,JohnLin,1981,1372,38,68,106,35.8%,25m
11971,2,냉탕상어,1981,64,5,11,16,31.2%,47m
11971,1,막강한올빼미,1981,94,3,2,5,60.0%,25m
11971,1,joseph,1981,48,1,5,6,16.7%,24m
11975,3,Jimvlad,1979,78,18,49,67,26.9%,26m
11975,1,tjdrb,1979,138,4,9,13,30.8%,25m
11975,1,ohdugi,1979,0,1,0,1,100.0%,24m
11975,3,IIIIIIIIIIII,1979,0,0,1,1,0.0%,23m
11979,1,강원토박이,1977,744,22,31,53,41.5%,25m
11979,1,마세어,1977,387,9,6,15,60.0%,25m
11979,3,intense,1977,58,2,7,9,22.2%,42m
11979,1,[我們是家人]叡哥,1977,0,1,5,6,16.7%,25m
11979,1,존시나,1977,0,0,1,1,0.0%,25m
11979,3,[고구려만세]나무,1977,0,0,1,1,0.0%,22m
11985,1,start,1975,1800,56,85,141,39.7%,24m
11986,1,starlegend,1973,1689,54,82,136,39.7%,25m
11986,1,sjmountain,1973,90,2,3,5,40.0%,25m
11986,3,NewBand,1973,0,1,6,7,14.3%,26m
11989,3,아그나로크,1972,94,4,11,15,26.7%,26m
11990,1,밥운,1971,1107,38,52,90,42.2%,25m
11990,1,Twinshadow,1971,346,12,14,26,46.2%,25m
11990,1,와일드포스,1971,92,3,4,7,42.9%,25m
11993,1,兒以時帶五以,1969,1813,53,79,132,40.2%,24m
11993,1,YIPRICHIE,1969,272,8,21,29,27.6%,24m
11995,3,시골농부,1968,1316,77,111,188,41.0%,25m
11996,1,일품해장국,1967,126,3,5,8,37.5%,25m
11997,1,STRIKER,1965,0,0,1,1,0.0%,25m
11997,3,薔薇,1965,0,0,1,1,0.0%,42m
11999,1,김도훈,1964,254,6,5,11,54.5%,25m
12000,3,IMOK,1963,277,9,16,25,36.0%,46m
12000,3,shain,1963,30,1,9,10,10.0%,47m
12002,1,coffeeZONE,1962,0,0,1,1,0.0%,25m
12002,2,바꿧다이름,1962,0,0,8,8,0.0%,47m
12004,2,玉面阿修罗,1960,93,1,1,2,50.0%,23m
12005,1,마지노선,1959,48,2,5,7,28.6%,25m
12006,1,TunderJakob,1958,0,1,3,4,25.0%,25m
12007,1,고대저그,1956,0,0,2,2,0.0%,25m
12007,3,Futere,1956,0,0,2,2,0.0%,22m
12007,3,熊小二,1956,0,0,7,7,0.0%,22m
12010,1,NangB,1955,769,21,39,60,35.0%,25m
12010,3,Mike,1955,495,17,39,56,30.4%,27m
12010,1,白海馬,1955,266,7,1,8,87.5%,24m
12010,3,DreAmsNvEnd,1955,172,4,9,13,30.8%,46m
12014,1,Asav,1954,436,12,4,16,75.0%,25m
12015,1,[NGNLZ]seankeke,1953,860,26,44,70,37.1%,24m
12015,1,지을이름없어,1953,940,25,50,75,33.3%,25m
12015,1,MIT,1953,280,8,9,17,47.1%,24m
12018,1,천월패룡,1952,383,8,22,30,26.7%,25m
12019,1,[국립대]PETsGOOD,1951,48,1,5,6,16.7%,25m
12019,1,[우한폐렴]Zeratoss,1951,0,0,1,1,0.0%,25m
12019,3,jerking,1951,0,0,7,7,0.0%,22m
12022,3,물개단지,1949,34,4,7,11,36.4%,26m
12022,1,미생완생,1949,48,1,4,5,20.0%,25m
12024,3,라록계,1948,0,0,3,3,0.0%,23m
12025,1,himinwoo,1947,129,3,11,14,21.4%,25m
12026,1,Escanor,1946,790,23,38,61,37.7%,25m
12026,3,하츠르기,1946,38,1,3,4,25.0%,23m
12028,3,[NTW]EdwardKO,1945,1255,109,166,275,39.6%,25m
12028,1,척후경,1945,92,3,6,9,33.3%,24m
12028,2,mrblue,1945,0,1,9,10,10.0%,28m
12028,1,nam,1945,0,0,1,1,0.0%,25m
12032,2,[NoLate]베틀대마왕,1944,1434,134,187,321,41.7%,47m
12032,1,여보세요,1944,48,1,4,5,20.0%,24m
12034,1,푸치니,1943,0,0,5,5,0.0%,25m
12035,1,ZHAN,1939,969,31,75,106,29.2%,24m
12035,2,바퀴벌레육즙,1939,378,14,29,43,32.6%,27m
12035,1,해병의기묘한모험,1939,436,12,22,34,35.3%,25m
12035,3,maru,1939,260,7,18,25,28.0%,26m
12039,1,胡小胖,1937,772,25,33,58,43.1%,24m
12040,3,불의화신,1936,129,2,13,15,13.3%,47m
12040,1,제레미,1936,46,1,2,3,33.3%,25m
12040,1,스노우스타일,1936,0,0,1,1,0.0%,24m
12043,3,djatmdgh,1935,0,0,6,6,0.0%,22m
12044,1,갑돌이,1934,192,8,22,30,26.7%,24m
12044,3,바실리우스,1934,30,3,13,16,18.8%,27m
12044,1,OZZORAGO,1934,0,0,8,8,0.0%,24m
12047,1,FortyTwo,1933,0,0,1,1,0.0%,25m
12047,1,KJKMARI,1933,0,0,1,1,0.0%,25m
12049,1,pyroxene,1931,516,13,20,33,39.4%,25m
12049,3,herO,1931,218,6,17,23,26.1%,47m
12049,1,LiTTleTAHI,1931,0,1,7,8,12.5%,25m
12052,1,Namikaze,1930,387,15,22,37,40.5%,24m
12052,1,ArvinKuo,1930,450,12,20,32,37.5%,25m
12052,3,제임스,1930,306,10,17,27,37.0%,26m
12055,1,rtertertert,1929,1843,59,95,154,38.3%,24m
12056,1,[경찰과도둑]멜리오다스,1928,145,3,7,10,30.0%,24m
12056,3,[너의ol름은]Synonym,1928,36,2,8,10,20.0%,42m
12056,3,[TNO]影杯,1928,30,1,8,9,11.1%,42m
12059,1,사신,1927,0,1,2,3,33.3%,24m
12060,1,이종원,1926,187,5,5,10,50.0%,24m
12060,1,[별똥별]그기서그기,1926,175,5,12,17,29.4%,24m
12060,3,호나우지뉴,1926,0,1,0,1,100.0%,22m
12063,1,mathie,1924,509,15,32,47,31.9%,25m
12063,1,RONG,1924,414,10,15,25,40.0%,25m
12063,1,네모누룽지,1924,139,4,13,17,23.5%,25m
12066,2,betong,1923,330,12,32,44,27.3%,47m
12066,1,ELTORO,1923,38,1,7,8,12.5%,24m
12066,3,REDLITE,1923,0,0,5,5,0.0%,23m
12069,1,BEARCHAN,1922,1216,34,54,88,38.6%,25m
12069,3,BJrhb,1922,0,1,0,1,100.0%,42m
12069,1,덤비끄랑,1922,73,1,4,5,20.0%,25m
12069,1,byongmin,1922,0,0,1,1,0.0%,25m
12069,3,tag,1922,0,0,2,2,0.0%,22m
12074,1,더운여름,1920,530,16,30,46,34.8%,25m
12074,3,임효진내꺼얌,1920,0,0,4,4,0.0%,42m
12076,3,블랙핑크제니,1917,325,27,79,106,25.5%,54m
12077,3,veccan,1916,0,0,8,8,0.0%,42m
12078,2,Isshoman,1915,1472,155,241,396,39.1%,27m
12078,3,chlwjdals,1915,272,9,32,41,22.0%,26m
12078,1,willly,1915,44,1,2,3,33.3%,24m
12081,3,GAGA,1914,68,3,10,13,23.1%,42m
12082,1,소리없는잔소리,1913,0,1,0,1,100.0%,24m
12083,2,ttasfa,1912,1465,53,94,147,36.1%,27m
12084,1,학문의끝,1911,537,15,31,46,32.6%,24m
12084,2,gksdbcks,1911,346,12,27,39,30.8%,19m
12084,1,용규스타,1911,222,5,9,14,35.7%,25m
12087,1,LETO,1910,1865,62,107,169,36.7%,25m
12088,2,재키와이,1909,172,4,13,17,23.5%,23m
12089,1,뉴페이스,1907,96,2,5,7,28.6%,24m
12090,1,언제나즐거운젤리,1906,722,18,30,48,37.5%,25m
12090,1,[벨튀입니다]야생의은재몬,1906,0,0,2,2,0.0%,24m
12092,3,코네,1905,0,1,6,7,14.3%,23m
12093,3,redhelmet,1904,1375,143,229,372,38.4%,26m
12093,1,mjklsk,1904,42,1,3,4,25.0%,25m
12095,2,노무현슨상님,1902,280,10,27,37,27.0%,47m
12096,1,platinus,1901,881,24,41,65,36.9%,24m
12097,1,joe,1900,343,9,12,21,42.9%,25m
12097,1,[망겜장인]허율호호,1900,181,5,15,20,25.0%,20m
12097,3,지호아빠,1900,124,3,5,8,37.5%,42m
12100,3,포카,1898,699,23,38,61,37.7%,26m
12101,1,job,1897,0,0,1,1,0.0%,25m
12102,1,카미신,1894,469,14,22,36,38.9%,25m
12102,1,stifle,1894,244,9,15,24,37.5%,25m
12102,1,ALIF,1894,226,7,24,31,22.6%,24m
12102,1,우한폐렴,1894,0,0,5,5,0.0%,25m
12106,3,샤인,1893,1368,114,173,287,39.7%,27m
12107,1,덕슨,1892,40,1,7,8,12.5%,25m
12108,1,skfnxh,1890,140,4,5,9,44.4%,25m
12108,3,RHTN,1890,0,0,8,8,0.0%,23m
12110,1,cerapina,1888,0,0,4,4,0.0%,25m
12111,1,NEO,1887,112,4,9,13,30.8%,25m
12112,1,park,1886,0,0,4,4,0.0%,25m
12113,1,[건국]번듯한불곰,1884,0,1,5,6,16.7%,25m
12114,1,컴퓨터,1882,1789,61,76,137,44.5%,25m
12115,3,뱁세오,1881,0,2,3,5,40.0%,23m
12116,1,뮤탈점추배틀,1879,92,2,10,12,16.7%,25m
12116,3,Adrenaline,1879,0,1,1,2,50.0%,22m
12118,1,Tiphareth,1878,126,3,11,14,21.4%,25m
12119,1,완두콩,1877,46,1,10,11,9.1%,25m
12120,1,쇠캉,1874,0,1,5,6,16.7%,24m
12121,1,AMC,1873,0,1,8,9,11.1%,25m
12122,1,[머구폐렴]달선,1872,188,4,10,14,28.6%,25m
12123,3,keks,1871,60,2,24,26,7.7%,25m
12124,1,리버보이,1870,719,20,49,69,29.0%,47m
12124,1,[TEGA]나비의연꽃,1870,0,0,2,2,0.0%,25m
12126,1,[킹론즈]그랜드브론즈,1869,96,2,0,2,100.0%,25m
12126,1,captain,1869,73,1,9,10,10.0%,25m
12128,1,[AIRBUS]이승만,1867,0,0,2,2,0.0%,25m
12129,1,victorpang,1866,763,19,35,54,35.2%,25m
12129,3,夜旭,1866,0,3,9,12,25.0%,26m
12131,1,[너의ol름은]Jady,1864,846,25,46,71,35.2%,25m
12131,2,섭섭이,1864,73,0,2,2,0.0%,23m
12133,3,상어,1863,42,1,3,4,25.0%,23m
12134,2,[아케더]바람,1861,165,4,7,11,36.4%,23m
12134,1,Lucifer,1861,0,0,2,2,0.0%,25m
12134,1,RRoni,1861,0,0,2,2,0.0%,25m
12134,1,mickey,1861,0,0,7,7,0.0%,25m
12138,1,asf,1860,48,1,17,18,5.6%,25m
12138,2,김태현,1860,0,0,1,1,0.0%,23m
12140,3,adadad,1858,1390,292,373,665,43.9%,26m
12140,1,hahamaster,1858,0,0,7,7,0.0%,25m
12142,1,죠리퐁,1857,168,4,9,13,30.8%,25m
12143,1,아바입니다,1854,102,2,7,9,22.2%,24m
12144,1,안성탕,1853,229,6,18,24,25.0%,25m
12145,3,오토오아시스,1850,0,0,1,1,0.0%,22m
12146,2,이수근의이두근,1847,0,0,3,3,0.0%,24m
12147,1,[국방부사서병]불고기소스,1846,0,0,4,4,0.0%,24m
12147,3,OverlordUA,1846,0,0,12,12,0.0%,26m
12149,3,rapaboni,1845,58,2,7,9,22.2%,22m
12149,3,tzf,1845,0,0,3,3,0.0%,22m
12151,3,Teru,1842,0,0,8,8,0.0%,23m
12152,2,원규밴스,1840,92,4,16,20,20.0%,47m
12153,2,llllllllllll,1839,324,8,13,21,38.1%,23m
12154,1,buccoar,1838,1677,56,81,137,40.9%,25m
12155,1,봉황,1837,0,0,7,7,0.0%,25m
12156,3,nawawi,1834,0,0,7,7,0.0%,23m
12157,3,nymeria,1832,44,1,11,12,8.3%,22m
12158,1,그랜드또또,1829,172,5,18,23,21.7%,25m
12158,2,惡劣之王,1829,92,3,1,4,75.0%,23m
12160,1,페이트그랜드오더,1828,390,9,18,27,33.3%,24m
12160,3,Couth,1828,40,1,2,3,33.3%,22m
12162,3,가오,1827,0,0,5,5,0.0%,42m
12163,1,니들이스타를알아,1826,886,23,49,72,31.9%,25m
12164,1,준스타,1824,1449,56,87,143,39.2%,25m
12165,2,과아아앙후우우운,1823,0,0,1,1,0.0%,23m
12166,2,영웅박동훈,1822,137,2,7,9,22.2%,23m
12167,1,Anguschen,1821,1416,63,131,194,32.5%,25m
12168,1,챙구리,1819,238,7,28,35,20.0%,25m
12169,3,youngbuffalo,1817,30,2,6,8,25.0%,23m
12170,2,CaffineOP,1816,46,1,6,7,14.3%,24m
12171,3,RonaldPogi,1815,876,32,63,95,33.7%,47m
12172,1,[銅牌上不去]IIIIIIIIIIII,1814,1538,98,167,265,37.0%,24m
12173,2,하뎅구리,1813,596,15,35,50,30.0%,23m
12174,3,[rada]ebbisaya,1812,32,1,12,13,7.7%,42m
12175,2,스키드,1811,0,0,2,2,0.0%,23m
12176,2,그럼좋아,1810,90,4,4,8,50.0%,24m
12176,1,RayDan,1810,133,2,9,11,18.2%,25m
12176,2,PowerMoveR,1810,0,1,4,5,20.0%,24m
12179,1,포세이돈,1809,1540,70,95,165,42.4%,25m
12180,2,[sc2mc]엠씨다크맨,1808,124,5,3,8,62.5%,23m
12181,3,ANITO,1807,1371,211,340,551,38.3%,27m
12181,1,WALLE,1807,934,26,35,61,42.6%,25m
12183,3,워노보노,1805,0,0,7,7,0.0%,42m
12184,3,RADIO,1804,1368,537,947,1484,36.2%,26m
12185,2,인공지능,1801,0,0,2,2,0.0%,23m
12186,2,멘쓰리,1794,291,7,17,24,29.2%,23m
12186,2,Alphscan,1794,72,2,3,5,40.0%,24m
12186,2,할할할,1794,48,1,4,5,20.0%,23m
12189,2,hyde,1793,94,3,15,18,16.7%,47m
12190,3,春安,1788,0,0,1,1,0.0%,23m
12190,3,Bosk,1788,0,0,1,1,0.0%,23m
12192,1,天安門事態,1786,1822,187,328,515,36.3%,25m
12192,2,살짝도른년,1786,717,33,34,67,49.3%,23m
12192,3,palini,1786,157,4,15,19,21.1%,47m
12195,2,리챠즈,1780,0,0,1,1,0.0%,23m
12196,2,simple,1779,124,2,5,7,28.6%,23m
12197,2,폭주아트,1778,372,16,49,65,24.6%,23m
12198,3,[燚燚燚燚燚燚]중복아니죠,1777,0,1,0,1,100.0%,23m
12198,2,Grace,1777,0,0,9,9,0.0%,23m
12200,1,스타,1775,1703,72,135,207,34.8%,25m
12200,2,망고다이녀석들아,1775,0,0,1,1,0.0%,24m
12202,2,rendezvous,1774,78,2,5,7,28.6%,23m
12203,1,whalsdn,1767,428,10,33,43,23.3%,24m
12203,2,래그,1767,0,1,12,13,7.7%,23m
12205,2,[생각대로]못진남자,1761,0,0,3,3,0.0%,23m
12206,3,나라경쟁,1756,0,0,1,1,0.0%,23m
12207,2,boomboom,1745,0,0,1,1,0.0%,23m
12208,2,pool,1743,565,16,41,57,28.1%,23m
12208,2,[CIA암살단]생각의질서,1743,0,0,1,1,0.0%,23m
12210,3,Prove,1741,902,98,173,271,36.2%,22m
12210,2,ChogosuSc,1741,241,5,5,10,50.0%,24m
12212,2,도령님,1739,1189,40,111,151,26.5%,23m
12213,2,베이비팬더,1736,202,5,12,17,29.4%,23m
12214,1,리시빙해방,1734,128,4,14,18,22.2%,25m
12214,2,Rambo,1734,0,1,1,2,50.0%,24m
12216,2,TONG,1729,0,0,3,3,0.0%,23m
12217,1,smdgml,1727,1282,36,88,124,29.0%,25m
12218,2,Jopam,1726,112,3,22,25,12.0%,23m
12218,3,어지러운도적,1726,0,0,1,1,0.0%,23m
12220,2,Luke,1724,0,0,3,3,0.0%,23m
12221,2,[1324WE]SilverKT,1715,90,2,3,5,40.0%,23m
12222,3,방바라방,1708,200,7,25,32,21.9%,26m
12223,3,UEDFRUR,1707,0,0,1,1,0.0%,23m
12224,2,멘처스,1703,114,3,7,10,30.0%,24m
12225,2,전쟁의신,1695,364,7,27,34,20.6%,23m
12226,1,시즈,1681,92,2,4,6,33.3%,24m
12227,2,dlftn,1674,1324,46,92,138,33.3%,24m
12228,3,starcraf,1671,0,0,1,1,0.0%,22m
12228,2,接米令,1671,0,0,1,1,0.0%,23m
12230,2,퓨오옹,1663,338,10,28,38,26.3%,24m
12231,3,huggie,1650,0,0,11,11,0.0%,42m
12232,1,라케리아,1648,583,17,39,56,30.4%,25m
12233,1,wfk,1646,303,9,22,31,29.0%,24m
12234,1,YEOUIDODJ,1643,1436,55,117,172,32.0%,24m
12235,3,Ferrari,1640,0,0,1,1,0.0%,23m
12236,2,라송,1636,73,0,4,4,0.0%,23m
12237,1,Cygnus,1630,73,0,10,10,0.0%,25m
12238,2,[萬花筒寫輪眼]鄭駿翔,1622,0,0,1,1,0.0%,23m
12239,2,방구석여포메타,1619,46,1,12,13,7.7%,23m
12240,3,Joker,1608,0,0,1,1,0.0%,42m
12240,3,아니요,1608,0,0,3,3,0.0%,23m
12242,3,KFC,1602,130,5,14,19,26.3%,42m
12243,3,戰神,1596,0,0,3,3,0.0%,23m
12244,3,동진보살,1577,0,0,4,4,0.0%,23m
12245,2,[기니피그]goodlove,1558,96,1,9,10,10.0%,23m
12246,3,[TTM]kris,1542,72,2,8,10,20.0%,23m
12247,2,salesking,1534,198,5,22,27,18.5%,23m
12248,1,퐁듀,1513,319,7,29,36,19.4%,25m
12249,2,[krtag]디바왜불러,1511,486,14,53,67,20.9%,23m
12250,2,[우모자공화국]루나공주,1490,752,26,101,127,20.5%,24m
12251,3,삼백,1439,0,1,5,6,16.7%,23m
12252,3,기맹수,1369,0,1,22,23,4.3%,23m
12253,3,子猫征服者,231,0,0,374,374,0.0%,22m
