rank,tier,name,mmr,points,wins,losses,played,winrate,age
1,1,llllllllllll,6875,0,1,0,1,100.0%,11m
2,1,lllllllllll,6872,0,0,1,1,0.0%,3m
3,1,llllllllllll,6862,3448,89,43,132,67.4%,3m
4,1,llllllllllll,6850,0,1,0,1,100.0%,11m
5,1,llllllllllll,6819,144,4,0,4,100.0%,10m
6,1,llllllllllll,6808,240,6,3,9,66.7%,3m
7,1,부산세랄,6725,96,3,1,4,75.0%,10m
8,1,[αX]RAGNAROK,6717,3726,189,88,277,68.2%,3m
9,1,llllllllllll,6701,96,3,2,5,60.0%,3m
10,1,lIlIlIlIlIlI,6695,1025,35,9,44,79.5%,3m
11,1,llllllllllll,6679,3125,82,33,115,71.3%,3m
12,1,[Kaizi]Solar,6663,2100,47,16,63,74.6%,3m
13,1,[트수Crew]DPGDark,6640,946,20,11,31,64.5%,5m
14,1,llllllllllll,6629,3224,87,48,135,64.4%,3m
15,1,llllllllllll,6614,2106,50,16,66,75.8%,3m
16,1,마지막불꽃,6600,96,2,2,4,50.0%,10m
17,1,llllllllllll,6591,1817,73,32,105,69.5%,10m
18,1,lIlIlIIIllIl,6582,1391,30,12,42,71.4%,3m
19,1,Shin,6552,1448,87,43,130,66.9%,3m
20,1,lllllllllll,6526,3819,333,192,525,63.4%,3m
21,1,llllllllllll,6519,3452,139,81,220,63.2%,3m
22,1,[AFSC2]Armani,6414,336,7,12,19,36.8%,5m
23,1,lIlllIllllll,6268,169,5,0,5,100.0%,5m
24,1,lIIlllIIlIll,6260,3811,312,274,586,53.2%,3m
25,1,llllllllllll,6223,0,1,0,1,100.0%,5m
26,1,IIIIIIIIIIII,6094,92,2,2,4,50.0%,3m
27,1,llllllllllll,5988,0,1,3,4,25.0%,11m
28,1,PharahMercy,5954,3543,475,464,939,50.6%,3m
29,1,IIIIIIIIIIII,5923,1823,73,65,138,52.9%,3m
30,1,llllllllll,5914,16,2,1,3,66.7%,10m
31,1,[PSISTM]True,5911,366,9,11,20,45.0%,10m
32,1,Rex,5899,3506,423,428,851,49.7%,3m
33,1,llllllllllll,5888,1863,83,84,167,49.7%,3m
34,1,TonyFerguson,5872,168,4,3,7,57.1%,3m
35,1,[2015FW]NeVeRLosEs,5858,915,154,148,302,51.0%,5m
36,1,[教我玩蟲族]Sen,5840,0,1,1,2,50.0%,3m
37,1,llllllllllll,5830,651,117,70,187,62.6%,11m
38,1,Toodming,5826,0,1,0,1,100.0%,5m
39,1,[eQ]Carol,5820,0,0,1,1,0.0%,10m
40,1,lllllllllll,5804,807,101,86,187,54.0%,11m
41,2,[GGGSC2]Dream,5803,0,1,0,1,100.0%,7m
42,2,wake,5790,0,1,0,1,100.0%,7m
43,1,[神族是我爹]IIIIIIIIIIII,5780,770,35,21,56,62.5%,3m
44,1,Restart,5770,464,12,5,17,70.6%,10m
45,1,[TeamNV]sOs,5763,30,2,0,2,100.0%,11m
46,1,Hukuro,5725,1227,176,117,293,60.1%,5m
47,1,llllllllllll,5719,1853,308,252,560,55.0%,3m
47,1,IlIIlllIIIII,5719,0,0,1,1,0.0%,5m
49,1,[NDW]MysteryMan,5716,0,0,1,1,0.0%,5m
50,1,llllllllll,5694,0,0,1,1,0.0%,5m
51,1,동래굴링,5692,94,2,1,3,66.7%,3m
52,1,[TeamNV]Mondo,5688,44,2,1,3,66.7%,5m
53,1,[인투더]IntoThemuri,5687,959,42,36,78,53.8%,3m
54,1,Silky,5681,1802,69,58,127,54.3%,3m
54,1,[인투더]SpeCial,5681,118,3,3,6,50.0%,5m
56,1,군신의마지막갈망,5675,226,6,3,9,66.7%,5m
57,1,[越南探親希望]超爆爛怪人蟹肉,5667,42,1,3,4,25.0%,3m
58,1,llllllllllll,5640,293,30,20,50,60.0%,11m
59,1,IIIIIIIIIIII,5635,3121,156,137,293,53.2%,3m
60,1,[Kaizi]TIME,5625,1066,34,22,56,60.7%,11m
61,1,[Rush]TopRush,5575,0,0,1,1,0.0%,5m
62,1,[混元星际]星际指导员,5573,2220,336,306,642,52.3%,3m
63,1,BuonVaiCaLoz,5564,238,7,6,13,53.8%,5m
64,1,[越南探親希望]夯特叉叉,5558,2959,168,147,315,53.3%,3m
65,1,llllllllllll,5556,660,33,9,42,78.6%,11m
65,1,雅雅大王,5556,281,5,1,6,83.3%,10m
67,1,[순수]미친듯이파이팅,5538,84,2,2,4,50.0%,3m
68,1,Filipino,5530,966,42,34,76,55.3%,10m
69,1,[인투더]TYTY,5522,787,24,28,52,46.2%,11m
70,1,원이삭인쓰,5516,0,0,1,1,0.0%,3m
71,1,llllllllllll,5511,0,1,0,1,100.0%,5m
72,1,[Rush]黑羽快斗,5509,2933,183,144,327,56.0%,3m
73,1,llllllllllll,5486,32,2,0,2,100.0%,11m
74,1,llllllllll,5476,834,36,25,61,59.0%,3m
75,1,Zugzwang,5474,237,9,10,19,47.4%,3m
76,1,[StorM]Tng,5464,48,1,3,4,25.0%,11m
77,1,夕立糊涂,5458,218,7,7,14,50.0%,10m
78,1,llllllllllll,5444,1880,84,64,148,56.8%,3m
79,1,[낭낭하게]Wade,5425,0,1,0,1,100.0%,10m
80,1,llllllllllll,5400,1255,179,152,331,54.1%,3m
81,1,[丨SLT丨]BrianMay,5398,2915,262,216,478,54.8%,3m
82,1,Airlines,5390,1204,50,32,82,61.0%,3m
83,1,llllllllllll,5389,501,15,5,20,75.0%,10m
84,1,[NGameS]모찌모찌아큽냥이,5372,1601,168,143,311,54.0%,5m
85,1,llllllllllll,5368,3090,610,452,1062,57.4%,3m
86,1,[Dopen]장그래,5365,0,1,0,1,100.0%,11m
87,1,[Equal]PeNoMeCo,5363,533,27,17,44,61.4%,3m
88,1,llllllllllll,5345,48,1,2,3,33.3%,5m
89,1,IIIIIIIIIIII,5343,3062,336,301,637,52.7%,3m
90,1,llllllllllll,5339,752,33,28,61,54.1%,11m
91,1,aeontech,5321,0,0,2,2,0.0%,3m
92,1,IIIIIIIIIIIl,5312,827,148,129,277,53.4%,10m
92,1,IIIIIIIIIIII,5312,878,29,33,62,46.8%,3m
94,1,[AFSC2]Stats,5311,419,18,11,29,62.1%,3m
95,1,llllllllllll,5310,416,13,9,22,59.1%,3m
96,1,lllllllllll,5307,46,1,6,7,14.3%,5m
97,1,[攘外必先安内]三民主義統一中國,5305,0,1,0,1,100.0%,10m
98,1,[네오]Ruke,5302,0,1,3,4,25.0%,5m
99,1,llllllllllll,5295,0,1,0,1,100.0%,5m
100,1,master,5292,0,1,0,1,100.0%,11m
101,1,[MFSC2]Chasey,5290,0,1,0,1,100.0%,3m
102,1,llllllllllll,5289,434,12,16,28,42.9%,5m
103,1,착한사람입니다,5288,124,3,1,4,75.0%,11m
104,1,IIIIIIIIIIII,5285,2095,127,104,231,55.0%,3m
105,1,[DVS]XiaoBai,5284,125,4,1,5,80.0%,3m
106,1,IIIIIIIIIIII,5283,442,15,11,26,57.7%,5m
107,1,llllllllllll,5280,520,27,22,49,55.1%,10m
108,1,[TeamNV]Artist,5272,2722,185,159,344,53.8%,3m
109,1,IIIIIIIIII,5267,88,3,4,7,42.9%,10m
110,1,[李至安]이지안,5266,1347,62,43,105,59.0%,5m
111,2,llllllllllll,5259,544,34,2,36,94.4%,10m
112,1,llllllllllll,5254,2867,179,161,340,52.6%,3m
113,1,IIIIIIIIIIII,5248,0,0,2,2,0.0%,10m
114,2,김동현,5244,497,32,16,48,66.7%,7m
115,2,[NGamE2]ForgetMeNot,5241,0,0,1,1,0.0%,7m
116,2,[TeamNV]Creator,5240,28,2,1,3,66.7%,7m
116,2,[越南探親希望]ImReady,5240,0,0,1,1,0.0%,7m
118,1,[이터널]DEPEE,5236,1598,81,56,137,59.1%,3m
119,2,IIIIIIIIIII,5235,0,1,1,2,50.0%,7m
120,2,쓱쓱싹싹,5231,860,56,46,102,54.9%,7m
121,2,紅魂獸霸,5220,0,1,0,1,100.0%,7m
121,2,废铁二号,5220,0,0,1,1,0.0%,7m
123,1,llllllllllll,5206,179,5,7,12,41.7%,10m
124,1,llllllllllll,5200,2602,102,96,198,51.5%,3m
125,2,[混元星际]MagicTerran,5196,415,31,26,57,54.4%,7m
126,2,[NsP]HeART,5195,935,44,33,77,57.1%,7m
127,2,Has,5191,0,1,0,1,100.0%,7m
128,2,IIIIIIIIIIII,5186,0,0,1,1,0.0%,10m
129,1,llllllllllll,5185,548,22,28,50,44.0%,3m
130,1,llllllllllll,5183,351,18,16,34,52.9%,10m
131,1,IIIIIIIIIIII,5182,963,33,25,58,56.9%,3m
132,2,IIIIllIIIIII,5180,364,20,17,37,54.1%,7m
132,2,[250MS]임나영,5180,0,0,5,5,0.0%,7m
134,1,IIIIIIIIIIII,5177,129,5,2,7,71.4%,3m
134,2,초보입니다,5177,62,3,3,6,50.0%,7m
136,2,lIlIlIlIlIlI,5175,0,1,0,1,100.0%,10m
137,1,[Kid]NXZ,5156,795,26,30,56,46.4%,3m
138,1,안정인,5155,54,4,7,11,36.4%,11m
139,2,[NEX]Spirit,5148,0,0,1,1,0.0%,7m
140,2,GraZer,5143,283,22,9,31,71.0%,10m
140,2,IlIllllIIIII,5143,64,3,2,5,60.0%,7m
142,1,[Lotuz]lIllllIlllll,5133,715,25,20,45,55.6%,3m
142,2,[무한오영종]lIIIIIIIllII,5133,146,6,4,10,60.0%,10m
144,2,llllllllllll,5126,42,2,1,3,66.7%,10m
145,2,LiquidTaeJa,5125,86,4,10,14,28.6%,7m
146,2,llllllllllll,5124,0,0,1,1,0.0%,10m
147,2,[MFSC2]MightyKiwi,5114,64,4,7,11,36.4%,10m
148,2,[Dopen]티아코스모스,5113,235,15,5,20,75.0%,7m
149,2,인간실격,5108,0,0,1,1,0.0%,7m
150,1,[겨울방어]lIIIIIllllIl,5107,2014,97,72,169,57.4%,3m
151,1,[TeamNV]incapacitate,5098,2581,226,200,426,53.1%,3m
152,2,IIIIIIIIII,5097,34,3,0,3,100.0%,7m
153,1,[GdAT]CheesyKimbap,5090,716,34,27,61,55.7%,3m
154,1,wujiang,5089,73,1,5,6,16.7%,3m
155,2,[ROOT]neuro,5086,60,5,5,10,50.0%,7m
156,1,llllllllllll,5083,167,3,7,10,30.0%,11m
157,2,DokoTack,5078,1232,77,46,123,62.6%,7m
158,2,[ELS]llllllllllll,5070,22,3,0,3,100.0%,7m
158,2,[인투더]IntoTheP,5070,0,1,0,1,100.0%,7m
160,2,[ELS]DDoaH,5069,0,0,2,2,0.0%,7m
161,2,[KRisEZ]LANDOFDAFREE,5067,4,2,1,3,66.7%,7m
162,1,[무한오영종]Bird,5066,264,24,21,45,53.3%,3m
163,2,[αX]hiohu,5065,16,2,0,2,100.0%,10m
164,2,[NCCU]ParalyzeD,5061,36,1,1,2,50.0%,7m
164,2,IIIIIIIIIIII,5061,0,1,1,2,50.0%,7m
166,2,llllllllllll,5060,40,2,3,5,40.0%,7m
167,2,llllllllllll,5057,249,33,8,41,80.5%,10m
168,2,[무한오영종]카구야님은고백받,5056,0,0,1,1,0.0%,10m
169,3,llllllllllll,5052,276,9,1,10,90.0%,11m
170,2,[NsP]BigBang,5051,0,1,0,1,100.0%,7m
171,1,llllllllllll,5047,2399,127,104,231,55.0%,3m
171,2,IIIIIIIIIIII,5047,430,24,24,48,50.0%,10m
171,2,운영연습을해봐요,5047,0,0,2,2,0.0%,7m
174,1,llllllllllll,5041,157,8,5,13,61.5%,3m
174,2,llllllllllll,5041,34,5,1,6,83.3%,7m
174,1,llllllllllll,5041,73,1,1,2,50.0%,3m
177,2,[ROOT]ViBE,5038,102,5,12,17,29.4%,7m
178,2,[IDFI]llllllllllll,5033,122,4,2,6,66.7%,10m
179,1,Charlie,5032,585,37,4,41,90.2%,3m
180,2,IlIllllIlllI,5031,0,0,3,3,0.0%,7m
181,2,BlackSwan,5030,603,30,11,41,73.2%,10m
182,2,[1dC]Wilo,5026,168,8,9,17,47.1%,7m
183,2,PLKing,5025,997,49,50,99,49.5%,7m
183,2,[WTZ]Faint,5025,0,1,0,1,100.0%,7m
185,2,llllllllllll,5021,578,31,31,62,50.0%,7m
186,2,AmazingBirth,5019,198,12,9,21,57.1%,7m
186,2,[NGameS]조선명기,5019,0,0,2,2,0.0%,7m
188,2,Alpha,5017,258,24,7,31,77.4%,7m
189,2,[WAZAI]자능이,5016,656,57,43,100,57.0%,7m
190,2,llllllllllll,5015,216,11,7,18,61.1%,7m
191,2,llIIIllIlIIl,5014,561,37,18,55,67.3%,10m
192,3,SuperNova,5012,0,0,1,1,0.0%,7m
193,3,Ori,5010,2417,287,255,542,53.0%,7m
194,3,IIIIIIIIIIII,5009,0,0,1,1,0.0%,11m
195,3,llllllllllll,5008,918,142,111,253,56.1%,8m
195,2,EON,5008,110,10,9,19,52.6%,7m
197,3,我携苏苏揽星河,5006,0,0,1,1,0.0%,8m
198,3,[인투더]IntoTheJung,5004,0,1,0,1,100.0%,8m
199,3,llllllllllll,5000,1596,356,352,708,50.3%,8m
199,2,[αX]Ravage,5000,1011,84,69,153,54.9%,10m
199,3,lllllllll,5000,2,2,0,2,100.0%,9m
202,3,HuaCheng,4992,630,58,55,113,51.3%,11m
202,3,[NDW]Smile,4992,0,1,1,2,50.0%,9m
204,2,Percival,4985,115,6,3,9,66.7%,10m
204,1,[야근싫어요]llllllllllll,4985,0,1,0,1,100.0%,12m
206,2,llllllllllll,4982,2075,167,142,309,54.0%,7m
207,3,Jensen,4980,594,36,35,71,50.7%,9m
208,3,고라니,4979,1086,60,25,85,70.6%,8m
208,2,llllllllllll,4979,170,9,12,21,42.9%,10m
210,2,llllllllllll,4978,36,5,7,12,41.7%,10m
211,3,llll,4977,1655,82,80,162,50.6%,8m
212,2,llllllllllll,4971,746,45,49,94,47.9%,10m
213,1,llllllllllll,4968,0,0,1,1,0.0%,5m
214,2,[원피스]이준상조오옷,4966,1315,85,74,159,53.5%,7m
215,3,[우리티어]린세인,4958,700,48,23,71,67.6%,7m
216,3,[教我玩蟲族]史戀,4954,4,1,4,5,20.0%,7m
217,2,IIIIIlllIIII,4953,133,10,7,17,58.8%,7m
218,2,[Ato]가짐어서,4952,2454,133,128,261,51.0%,10m
219,3,llllllllllll,4946,8,5,2,7,71.4%,7m
220,2,llllllIIIIII,4936,118,8,8,16,50.0%,10m
220,3,IIIIIIII,4936,44,7,1,8,87.5%,9m
222,3,[무한오영종]Rose,4934,784,53,19,72,73.6%,5m
223,2,llllllllllll,4930,2046,135,120,255,52.9%,10m
223,2,IIIIIIIIIIII,4930,1916,91,100,191,47.6%,10m
225,3,잔혹한라이언,4928,0,0,2,2,0.0%,8m
226,2,Hyeok,4927,1925,98,99,197,49.7%,7m
227,2,[ELS]llllllllllll,4925,305,15,20,35,42.9%,7m
228,3,llllllllllll,4918,2176,280,260,540,51.9%,7m
229,2,IIIIIIIIIIII,4917,156,7,15,22,31.8%,7m
230,2,[yOsyOs]njustdsm,4915,1295,66,59,125,52.8%,10m
231,2,lllllIlIlIlI,4911,72,6,12,18,33.3%,7m
232,3,이지금,4908,20,2,1,3,66.7%,7m
232,1,llllllllllll,4908,0,0,1,1,0.0%,8m
234,3,llllllllllll,4907,12,2,1,3,66.7%,7m
235,2,SeibasAhoge,4905,777,34,44,78,43.6%,7m
236,3,[이터널]한판하게,4902,82,10,5,15,66.7%,9m
237,3,电竞教父黄旭东,4901,497,39,11,50,78.0%,8m
238,3,[산군山君]산군추이,4899,373,80,66,146,54.8%,5m
239,3,Delta,4898,569,36,12,48,75.0%,7m
240,3,MAsTeRCooP,4893,0,0,1,1,0.0%,9m
241,2,llllllllllll,4891,104,5,14,19,26.3%,10m
241,3,[클랜구해요]맹덕이,4891,0,0,1,1,0.0%,11m
243,3,Hood,4883,380,42,31,73,57.5%,5m
244,3,Automatic,4880,20,3,3,6,50.0%,7m
244,3,컴온잭,4880,0,1,0,1,100.0%,5m
246,3,llllllllllll,4876,0,1,0,1,100.0%,5m
247,2,llllllllllll,4868,236,15,20,35,42.9%,10m
248,3,SlayersDuker,4866,761,63,59,122,51.6%,5m
249,3,뚱뚱한곰,4863,0,0,1,1,0.0%,3m
250,3,[통수왕이한희]kapterhan,4862,8,3,0,3,100.0%,9m
251,3,[메가트윈스]테란슛,4854,86,16,11,27,59.3%,8m
251,3,llllllllllll,4854,0,1,0,1,100.0%,11m
253,3,llllllllllll,4845,0,1,1,2,50.0%,3m
254,3,절막만지셧잖아요,4839,0,0,1,1,0.0%,5m
255,3,Apocalypto,4833,2029,154,158,312,49.4%,3m
256,3,llllllllllll,4832,815,66,39,105,62.9%,7m
257,3,IllIIIllIlIl,4831,485,30,6,36,83.3%,11m
258,3,IIIIIIIII,4830,8,2,5,7,28.6%,8m
259,3,llllllllllll,4829,12,3,1,4,75.0%,5m
260,3,[SGlory]Fsix,4827,0,0,1,1,0.0%,7m
261,3,[NsP]TrueLife,4823,250,26,13,39,66.7%,7m
262,3,[무한오영종]BlackFresh,4822,26,7,8,15,46.7%,8m
263,3,[SGlory]dream,4821,0,0,4,4,0.0%,3m
264,3,llllllllllll,4820,0,0,1,1,0.0%,8m
265,3,딴곰,4818,0,1,0,1,100.0%,5m
266,3,[Hyper]아키에이지하러감,4817,4,2,3,5,40.0%,3m
266,3,[WDY]dbdbdbdb,4817,0,0,2,2,0.0%,7m
268,3,노바,4816,0,0,1,1,0.0%,8m
269,3,[WAZAI]GameDay,4813,400,34,31,65,52.3%,7m
270,3,장안동오준세,4811,0,0,1,1,0.0%,7m
271,3,lIIIlIlIllII,4810,1887,131,131,262,50.0%,7m
271,3,EsC,4810,4,1,2,3,33.3%,3m
273,3,[Dopen]ZergIsLoser,4807,0,0,1,1,0.0%,5m
274,3,[SofT]수박화채,4804,236,19,21,40,47.5%,5m
274,3,BubbaGump,4804,0,1,0,1,100.0%,9m
276,3,llllllllllll,4801,754,49,44,93,52.7%,8m
276,3,Clore,4801,0,0,1,1,0.0%,7m
278,3,llllllllllll,4800,2133,246,224,470,52.3%,3m
278,3,TheAuthentic,4800,750,74,77,151,49.0%,5m
280,3,llllllllllll,4799,407,21,5,26,80.8%,11m
281,3,Bravo,4797,440,26,0,26,100.0%,8m
282,3,[Toss]TakamiChika,4792,0,1,0,1,100.0%,8m
283,3,[迷宮]장훈이,4790,0,1,0,1,100.0%,9m
284,3,llllllllllll,4785,99,2,3,5,40.0%,3m
285,3,OTAoLo,4784,0,0,1,1,0.0%,9m
286,3,Echo,4781,381,22,1,23,95.7%,7m
286,3,universe,4781,119,11,4,15,73.3%,9m
288,3,llllllllllll,4780,1011,90,83,173,52.0%,8m
288,3,llllllll,4780,509,39,17,56,69.6%,11m
288,3,[LoteM]예리남자친구,4780,0,0,1,1,0.0%,11m
291,3,[AN3]IUCuteBaby,4779,56,11,18,29,37.9%,3m
292,3,llllllllllll,4778,831,57,59,116,49.1%,11m
293,3,[SAIL]새벽비,4777,893,138,132,270,51.1%,11m
293,3,[Ato]lllllIIlIIlI,4777,1189,98,102,200,49.0%,11m
293,3,라미님,4777,130,20,21,41,48.8%,9m
296,3,kenosis,4775,0,0,1,1,0.0%,5m
297,3,[CekS]MACHINE,4774,0,0,1,1,0.0%,3m
298,3,[0I터널]배유빈,4772,558,48,19,67,71.6%,11m
298,3,[무한오영종]넋두리,4772,346,28,37,65,43.1%,8m
298,3,llllllllllll,4772,0,1,1,2,50.0%,3m
301,3,SpArk,4769,30,6,12,18,33.3%,3m
301,2,llllllllllll,4769,0,0,1,1,0.0%,5m
303,3,打團,4768,1035,61,45,106,57.5%,9m
304,3,[땅거미지뢰]최초의벵광루,4767,621,52,33,85,61.2%,11m
304,3,[IWYDI]janyrWYD,4767,158,15,12,27,55.6%,9m
306,3,펜릴,4766,723,133,107,240,55.4%,11m
306,3,[큐티섹시]미나사나모모쯔위,4766,1132,82,84,166,49.4%,11m
308,3,Celestial,4765,1398,324,291,615,52.7%,7m
308,3,[Lotuz]FanTaSy,4765,0,0,1,1,0.0%,5m
308,3,저그,4765,0,0,1,1,0.0%,3m
311,3,[中國獨立]韓國瑜,4764,121,3,1,4,75.0%,7m
311,3,Lino,4764,144,3,2,5,60.0%,11m
313,3,[ANGG]SUMMER,4763,1256,80,74,154,51.9%,7m
313,3,[CIM]이제동,4763,0,0,1,1,0.0%,3m
315,3,llllllllllll,4762,852,37,24,61,60.7%,7m
315,3,Foxtrot,4762,493,24,3,27,88.9%,7m
315,3,llllllllllll,4762,315,10,5,15,66.7%,9m
315,3,[ELS]XEONS,4762,6,2,3,5,40.0%,7m
319,1,장딴지이만기,4757,0,0,1,1,0.0%,10m
320,3,Integral,4756,6,4,14,18,22.2%,11m
320,3,lllllllllll,4756,20,3,5,8,37.5%,7m
322,3,llllllllllll,4751,50,8,9,17,47.1%,9m
323,1,士緯,4749,472,11,2,13,84.6%,8m
324,3,[래더납치범]망고,4745,2002,163,165,328,49.7%,11m
325,3,[SC2HK]Random,4743,151,4,3,7,57.1%,9m
326,3,llllllllllll,4739,2062,215,206,421,51.1%,3m
326,3,Yanni,4739,24,3,7,10,30.0%,7m
328,1,[Rush]Teras,4737,0,0,2,2,0.0%,10m
329,3,[SpM]FeelSoGoodAN,4734,475,81,81,162,50.0%,5m
330,2,[이게게임이냐]고위기사사기,4731,82,3,0,3,100.0%,6m
331,3,사월나라라,4728,408,34,40,74,45.9%,7m
332,1,llllllllllll,4727,48,2,1,3,66.7%,4m
332,1,[입대4일남은]오르카즘,4727,0,1,1,2,50.0%,3m
334,3,llllllllllll,4725,4,2,4,6,33.3%,7m
335,1,llllllllllll,4722,602,13,4,17,76.5%,4m
336,3,WaterBear,4720,1249,75,29,104,72.1%,7m
337,1,ALoNeLeaf,4713,96,2,4,6,33.3%,12m
337,1,你人族我喔虧,4713,0,0,1,1,0.0%,8m
339,1,[VVDY]llllllllllll,4710,190,5,4,9,55.6%,3m
340,3,llllllllllll,4706,16,49,58,107,45.8%,9m
341,3,OverMind,4701,1471,219,225,444,49.3%,7m
342,3,Escanor,4699,605,75,47,122,61.5%,7m
343,3,鸢一折纸,4698,258,111,101,212,52.4%,7m
343,1,[이터널]입다더요스키,4698,218,5,2,7,71.4%,3m
345,3,[Dopen]진출타이밍,4697,2025,181,180,361,50.1%,9m
345,2,[0I터널]배유빈,4697,0,1,1,2,50.0%,3m
347,2,[Old]BlueDiamond,4689,46,2,2,4,50.0%,9m
348,1,[인투더]IntoTheA,4688,606,14,3,17,82.4%,4m
349,1,쓸대없이운영만함,4687,832,20,11,31,64.5%,9m
350,1,[시공의기사]진파치,4686,0,0,1,1,0.0%,3m
351,1,LifeForAiur,4685,2139,72,41,113,63.7%,9m
352,3,채새,4680,1556,156,124,280,55.7%,7m
353,1,[프로씹덕러]뮤탈,4676,144,4,0,4,100.0%,4m
354,3,imMortal,4675,0,6,11,17,35.3%,5m
354,1,llllllllllll,4675,96,2,2,4,50.0%,5m
356,3,[ANGG]좀비수집상,4672,1978,239,226,465,51.4%,9m
357,3,IntoTheQueen,4668,26,4,7,11,36.4%,3m
358,3,IIIIIIIIIIII,4666,2018,283,269,552,51.3%,7m
359,3,[NGamE2]PhoeNix,4664,1185,90,83,173,52.0%,3m
360,3,[ALeveL]ShiningStars,4663,1972,368,392,760,48.4%,5m
361,1,Rapha,4660,0,0,2,2,0.0%,4m
362,3,[Ato]프로토스,4656,1401,83,53,136,61.0%,3m
363,3,[번식]정자왕,4655,161,11,17,28,39.3%,3m
363,3,[삼시종결자]왜란종결자,4655,8,3,10,13,23.1%,7m
365,1,[GGGSC2]Patience,4653,0,0,2,2,0.0%,3m
366,3,[무한오영종]Hidn,4652,2022,421,428,849,49.6%,11m
366,3,[SirenP]AbsoluteZUNO,4652,1969,267,265,532,50.2%,5m
366,1,IIIIIIIIIIII,4652,426,22,1,23,95.7%,5m
369,1,IIIIIIIIIIII,4649,48,1,2,3,33.3%,4m
370,1,[스타놀이터]쫀쫀한저그,4646,2200,208,196,404,51.5%,10m
371,2,[TeamNV]IntoTheSpear,4645,38,1,2,3,33.3%,5m
372,1,[KRisEZ]FloridaMan,4640,562,14,15,29,48.3%,4m
373,1,[ReX]ColorfuL,4639,0,0,1,1,0.0%,9m
374,1,IIIIIIIII,4637,0,0,1,1,0.0%,3m
375,1,[XYFANS]llllllllllll,4636,144,4,1,5,80.0%,5m
376,1,[쇄국정책]Sylvanas,4634,1225,33,22,55,60.0%,4m
377,3,Decadon,4632,1976,199,203,402,49.5%,9m
378,1,[좀봐줘]꼬질꼬질,4631,1312,31,27,58,53.4%,3m
379,1,Victor,4628,96,3,0,3,100.0%,4m
380,3,[ENT]Woo,4620,1764,153,163,316,48.4%,5m
380,3,IlIlIlIlIlIl,4620,0,1,0,1,100.0%,3m
382,1,Attila,4615,280,6,6,12,50.0%,8m
383,3,[Lotuz]머니저그,4613,559,79,73,152,52.0%,3m
383,1,[KRisEZ]NORTHAMERICA,4613,1218,30,37,67,44.8%,8m
385,3,Steeb,4610,767,209,200,409,51.1%,11m
386,3,[인투더]IntoTheBest,4608,316,12,14,26,46.2%,11m
387,1,IlIIIlllIIl,4601,48,2,2,4,50.0%,3m
388,3,[GdAT]ruba,4600,1832,249,251,500,49.8%,11m
388,1,[Mini]Rooster,4600,0,0,1,1,0.0%,4m
390,1,llllllllll,4599,620,13,19,32,40.6%,10m
390,2,인생무상,4599,214,6,3,9,66.7%,10m
392,3,[ANGG]매실,4598,391,29,37,66,43.9%,7m
392,1,llllllllllll,4598,192,4,10,14,28.6%,4m
394,1,Classic,4596,96,4,4,8,50.0%,9m
395,1,IIIIIIIIII,4589,48,2,1,3,66.7%,4m
395,1,Zerg,4589,0,1,0,1,100.0%,5m
397,1,llllllllll,4588,238,6,7,13,46.2%,4m
398,1,[bu1ld]Whun,4585,544,12,15,27,44.4%,8m
398,1,lllllIIlIllI,4585,186,5,1,6,83.3%,4m
400,1,IIIIIIIIIIII,4584,284,7,4,11,63.6%,5m
401,1,[Sergio]그림자폭풍,4583,0,1,0,1,100.0%,10m
402,1,[겨울방어]파워업각성콩벌레,4582,92,3,9,12,25.0%,3m
403,1,IIIlllllllll,4580,1064,106,94,200,53.0%,8m
403,1,lllllllllll,4580,0,1,0,1,100.0%,10m
405,1,[흑인사랑]곰팡이,4579,0,0,1,1,0.0%,4m
406,1,[ANGG]킹킹킹킹킹,4576,278,7,7,14,50.0%,4m
407,1,朝比奈響子,4575,0,1,0,1,100.0%,9m
408,1,[NsP]우리함께우주여행,4574,0,0,1,1,0.0%,3m
409,1,lllllllllll,4573,647,44,13,57,77.2%,4m
409,1,[Primer]Plan,4573,0,1,0,1,100.0%,10m
411,1,ProtectSR,4572,1680,53,52,105,50.5%,8m
412,1,Astharos,4570,1096,58,33,91,63.7%,12m
413,1,IIIIIIIIIIII,4569,738,18,5,23,78.3%,4m
414,1,shinobu,4564,264,6,15,21,28.6%,4m
415,1,[트수Crew]얼마나길게쓸수있,4563,770,19,11,30,63.3%,5m
415,1,Pontifff,4563,464,10,7,17,58.8%,4m
415,1,Soulkey,4563,334,8,3,11,72.7%,8m
418,1,whiteSUS,4562,2110,270,285,555,48.6%,12m
418,3,llllllllll,4562,160,26,44,70,37.1%,9m
418,1,han,4562,0,0,5,5,0.0%,5m
421,1,[ENT]Best,4561,1556,41,35,76,53.9%,5m
422,1,[Nazzi]LuftWaffe,4559,312,7,2,9,77.8%,4m
423,1,[TeamNV]HwaRanG,4558,280,7,6,13,53.8%,10m
424,1,llllllllllll,4557,348,13,11,24,54.2%,12m
424,1,[αX]Anansi,4557,48,1,2,3,33.3%,4m
426,1,IIIlIIIIIIII,4556,1797,78,82,160,48.8%,12m
426,1,[이터널]바퀴왕김백희,4556,820,19,12,31,61.3%,4m
428,3,[ANGG]오늘의찌질이,4555,1925,289,302,591,48.9%,11m
428,1,Fabutaste,4555,1612,56,57,113,49.6%,4m
430,1,Thinking,4554,48,1,5,6,16.7%,5m
431,1,llllllllllll,4552,0,1,0,1,100.0%,4m
432,1,[SpM]阿凡達,4551,2125,224,229,453,49.4%,3m
433,1,[StorM]WidowMine,4546,731,35,36,71,49.3%,4m
433,3,money,4546,184,23,36,59,39.0%,9m
435,1,IIIIIIIIIIII,4542,776,22,6,28,78.6%,5m
436,1,lIlIlIlIlIlI,4541,0,1,1,2,50.0%,4m
437,3,무슨일이죠,4539,1908,216,213,429,50.3%,9m
438,1,[Ato]너무떨려,4537,2048,71,60,131,54.2%,5m
439,1,IIIIIIIIIIII,4536,898,96,81,177,54.2%,4m
439,1,[저는초보입니]IIIIIIIIII,4536,48,2,4,6,33.3%,4m
441,1,[NGameS]soO,4532,876,20,22,42,47.6%,8m
442,1,살흰애추억,4531,0,1,1,2,50.0%,4m
442,1,흑형의소울,4531,0,0,1,1,0.0%,11m
444,1,왔쌉맨,4530,96,2,4,6,33.3%,12m
445,3,[SHIPS]븅신듀크새끼,4529,630,139,115,254,54.7%,5m
445,1,lIIIIllIIIII,4529,1211,34,32,66,51.5%,4m
447,1,JoelVanesco,4527,786,18,18,36,50.0%,4m
447,1,[4계절]쌀쌀한가을,4527,0,0,2,2,0.0%,8m
449,1,KanyeBest,4525,1544,53,32,85,62.4%,3m
450,3,IIIIIIIIIIII,4523,1559,123,116,239,51.5%,8m
451,1,IIIIIIIIIIII,4521,92,3,1,4,75.0%,4m
452,3,LaRva,4520,1894,318,349,667,47.7%,3m
452,3,[무한오영종]Stroke,4520,908,73,88,161,45.3%,7m
454,1,qwerty,4518,1487,38,50,88,43.2%,5m
455,3,[무한오영종]Origin,4515,0,1,1,2,50.0%,11m
456,3,[ANGG]더크루,4514,1895,123,133,256,48.0%,9m
456,1,FUTURAMA,4514,1618,53,51,104,51.0%,8m
456,1,[Panda]Zomma,4514,48,2,1,3,66.7%,12m
456,1,IIIIIIIIIII,4514,0,1,0,1,100.0%,4m
460,1,bluebear,4513,96,3,2,5,60.0%,8m
461,1,[Equal]저그개어렵,4507,1996,62,54,116,53.4%,4m
461,1,awu,4507,1549,55,65,120,45.8%,12m
463,1,나의컴은북경컴,4505,94,3,0,3,100.0%,11m
463,1,[Allie]쫄깃해,4505,48,1,3,4,25.0%,9m
465,3,llllllllllll,4503,1366,328,331,659,49.8%,7m
466,1,HuIIIIIIIIII,4502,516,11,18,29,37.9%,4m
466,3,llllllllllll,4502,65,4,0,4,100.0%,3m
468,1,NEET,4499,2005,116,129,245,47.3%,12m
469,1,lIlIlIlIlIlI,4498,2143,213,201,414,51.4%,3m
470,1,afreecaTV,4497,440,23,7,30,76.7%,4m
470,1,llllllllllll,4497,48,2,12,14,14.3%,5m
472,1,llllllllllll,4496,395,19,1,20,95.0%,4m
473,3,[RS7]llllllllllll,4495,1223,154,150,304,50.7%,7m
473,1,[ELS]안정인,4495,1960,64,53,117,54.7%,10m
475,1,[김대일]검은사막,4494,0,0,2,2,0.0%,8m
476,1,[인투더]IntoTheKMJ,4488,330,8,6,14,57.1%,4m
477,1,AMD,4487,46,1,1,2,50.0%,4m
478,1,[NGameS]차차농,4481,1962,97,100,197,49.2%,3m
478,1,lllIIIlllIIl,4481,680,28,6,34,82.4%,12m
480,1,[우리저그끼리]Absol,4480,188,5,1,6,83.3%,10m
481,1,HotTea,4479,186,5,7,12,41.7%,10m
481,1,[스린이울어요]IIIIIIlIIIIl,4479,0,0,1,1,0.0%,4m
483,1,Dangerous,4478,1145,29,27,56,51.8%,3m
484,1,llllllllllll,4477,1421,41,43,84,48.8%,10m
485,1,[NDW]AresRush,4475,0,1,0,1,100.0%,10m
486,1,[배달의민족]고창류리,4471,94,2,3,5,40.0%,11m
486,1,大杯冰奶茶不好喝,4471,0,0,2,2,0.0%,3m
488,1,EJEJ,4469,94,3,3,6,50.0%,4m
489,1,[BlAck1]Negger,4468,384,13,21,34,38.2%,4m
490,1,[CryANT]성벽,4467,1094,28,35,63,44.4%,3m
491,1,llllllllllll,4465,987,28,17,45,62.2%,12m
491,1,수능대박,4465,340,7,2,9,77.8%,4m
491,1,[TeamGP]Gemini,4465,0,0,2,2,0.0%,9m
494,1,Heleve,4463,372,8,8,16,50.0%,3m
495,1,[SeA]何師宇,4462,0,0,1,1,0.0%,4m
496,1,lIIlllIlllII,4461,648,15,12,27,55.6%,12m
496,1,[이터널]송병구,4461,234,6,9,15,40.0%,12m
498,1,[광주는폭똥]tabaco,4459,328,8,12,20,40.0%,4m
499,2,albino,4457,137,5,0,5,100.0%,7m
500,1,저그상향이필요해,4456,931,43,29,72,59.7%,5m
500,1,[西毒]欧阳锋,4456,118,3,1,4,75.0%,5m
502,1,서늘한성에꽃이,4454,0,0,1,1,0.0%,5m
503,1,[CyaN]Apfel,4453,1840,67,66,133,50.4%,11m
503,1,[快樂玩家]JEx,4453,1552,42,55,97,43.3%,4m
505,1,lllllllllll,4451,732,30,16,46,65.2%,5m
505,1,[Old]狂泉,4451,48,1,2,3,33.3%,4m
507,1,[무한오영종]불꽃,4450,790,20,15,35,57.1%,8m
508,1,[ANGG]다소리,4449,960,24,16,40,60.0%,3m
508,1,[해피투게더]스완무시하지마라,4449,0,1,0,1,100.0%,10m
510,1,[BZT]Taxis,4448,535,45,24,69,65.2%,10m
511,1,저그,4446,2081,598,624,1222,48.9%,4m
511,1,Rainbow,4446,903,29,35,64,45.3%,12m
511,1,맹덕,4446,46,1,3,4,25.0%,8m
514,1,[Ato]정대희수제자,4445,0,0,2,2,0.0%,9m
515,1,Hegel,4444,686,24,14,38,63.2%,3m
515,2,沉默之星,4444,72,3,0,3,100.0%,3m
517,1,[더붉은공산당]저그대저그,4443,0,1,0,1,100.0%,5m
518,1,개못해,4442,2100,226,237,463,48.8%,3m
519,1,[달팽이]newGG,4439,365,9,13,22,40.9%,4m
519,1,[WDY]PaniC,4439,45,1,10,11,9.1%,12m
521,1,Anarchy,4435,1182,101,65,166,60.8%,4m
521,1,구육,4435,0,0,1,1,0.0%,12m
523,1,짹이,4434,0,0,4,4,0.0%,8m
524,1,welcometona,4430,604,27,11,38,71.1%,5m
524,1,舞姬,4430,0,1,0,1,100.0%,8m
524,1,KeyWorD,4430,0,0,1,1,0.0%,3m
527,1,[ENT]추키청정수,4428,48,2,1,3,66.7%,3m
528,1,王者歸來,4425,2031,217,224,441,49.2%,12m
529,1,MECE,4424,96,3,6,9,33.3%,3m
530,1,삭쾡이,4423,0,0,4,4,0.0%,11m
531,1,風黯沁,4422,2067,115,112,227,50.7%,4m
531,3,MrPiccolo,4422,371,54,56,110,49.1%,7m
531,1,[이터널]Pomme,4422,0,0,1,1,0.0%,4m
531,1,教我玩星海,4422,0,0,3,3,0.0%,5m
535,1,취익취익,4421,48,2,1,3,66.7%,5m
536,1,[무한오영종]Closer,4420,2075,740,755,1495,49.5%,3m
537,2,OddSense,4419,311,15,5,20,75.0%,10m
538,3,Evan,4416,1741,161,169,330,48.8%,7m
539,1,[BAKUGO]Katsuki,4414,0,0,2,2,0.0%,3m
540,1,[Cla1st]프로토스,4409,1212,129,123,252,51.2%,10m
541,1,우왕좌왕,4406,1333,169,165,334,50.6%,5m
541,1,hhmantou,4406,464,28,15,43,65.1%,11m
543,1,jumppigeon,4405,1990,229,259,488,46.9%,10m
543,1,LittleBaby,4405,741,36,42,78,46.2%,11m
543,1,[Yisc]메리설아,4405,318,8,4,12,66.7%,4m
546,1,llllllllllll,4404,280,7,10,17,41.2%,3m
546,1,Medic,4404,0,0,1,1,0.0%,4m
548,1,[NTUeS]小栩爸爸真偉大,4402,98,3,9,12,25.0%,4m
549,1,[WAZAI]JavaStory,4400,0,0,1,1,0.0%,5m
550,3,DerekRush,4398,1829,398,458,856,46.5%,7m
551,1,[쿵디팡팡]심쿵,4393,2033,124,132,256,48.4%,12m
551,1,IIIIIIII,4393,436,27,13,40,67.5%,4m
553,1,MegaXyloN,4392,750,20,16,36,55.6%,3m
554,1,Ramdom,4391,0,1,0,1,100.0%,9m
555,1,easybot,4390,377,11,7,18,61.1%,4m
555,1,CruelAngel,4390,48,1,4,5,20.0%,4m
557,1,[어짜피제가짐]구왁안되,4389,1720,47,61,108,43.5%,4m
558,1,Demon,4388,0,1,0,1,100.0%,4m
558,1,IMBarcode,4388,0,0,1,1,0.0%,10m
560,1,[푸른장미]Skewed,4387,1902,56,69,125,44.8%,4m
561,1,[Dopen]CarGO,4385,304,8,8,16,50.0%,11m
561,1,[IWYDI]KudySoLo,4385,0,0,1,1,0.0%,12m
563,1,[ANGG]karaDebiti,4382,1966,78,80,158,49.4%,11m
564,1,llllllllllll,4381,2036,221,221,442,50.0%,10m
564,1,KEBOP,4381,1695,53,52,105,50.5%,11m
566,1,[Tanga]Curie,4380,140,3,4,7,42.9%,3m
566,1,IIIIIIIII,4380,0,1,0,1,100.0%,4m
568,1,인생사새옹,4379,2028,303,304,607,49.9%,3m
568,1,llllllllllll,4379,1932,247,258,505,48.9%,12m
568,1,BEJBEJ,4379,138,3,6,9,33.3%,5m
568,1,두발자유,4379,0,1,0,1,100.0%,10m
572,1,llllllllllll,4378,2051,345,344,689,50.1%,8m
572,1,PASS,4378,999,26,38,64,40.6%,4m
574,3,ooOOoo,4376,1790,276,309,585,47.2%,11m
574,1,AcchanSiriuS,4376,993,31,23,54,57.4%,4m
574,1,[인투더]IntoTheSHSH,4376,405,25,9,34,73.5%,11m
574,1,Hordwin,4376,734,18,19,37,48.6%,10m
578,1,[Lotuz]클라스차이,4375,48,1,3,4,25.0%,11m
579,1,[무한오영종]신쫄이,4374,1070,139,109,248,56.0%,4m
580,1,벨제뷔트,4373,0,0,1,1,0.0%,3m
581,1,Cheoklate,4372,874,22,24,46,47.8%,10m
581,1,SKYBTT,4372,0,0,1,1,0.0%,3m
583,1,Nek,4367,911,41,53,94,43.6%,12m
583,1,[영앤리치]통곡의믹키,4367,633,15,15,30,50.0%,9m
585,1,[꺼이시]RedBroodling,4366,0,0,1,1,0.0%,8m
586,1,[ReV]Con,4365,900,26,24,50,52.0%,8m
586,1,[래더납치범]Nash,4365,0,1,0,1,100.0%,11m
586,1,lIIllIIllllI,4365,0,0,1,1,0.0%,4m
589,1,DarkMinions,4364,498,19,11,30,63.3%,4m
590,1,tumbling,4363,712,49,17,66,74.2%,8m
591,1,IlIlIlIlIl,4361,665,56,44,100,56.0%,4m
591,1,[Dopen]한우진,4361,1579,44,53,97,45.4%,3m
593,1,llllllllllll,4360,1086,29,25,54,53.7%,5m
593,1,[Lotuz]태평양돌핀스,4360,192,4,14,18,22.2%,4m
595,1,[병신들모임]맹덕뽕떡,4359,2000,89,104,193,46.1%,10m
595,1,round,4359,517,16,14,30,53.3%,8m
595,3,[快樂玩家]藍教授,4359,0,1,5,6,16.7%,3m
598,1,[인투더]IntoTheDrone,4357,0,0,1,1,0.0%,8m
599,1,IIIIIIIIIIII,4354,92,1,5,6,16.7%,4m
600,1,느개비뭐하시노,4353,88,1,1,2,50.0%,4m
601,1,Jane,4350,2010,493,522,1015,48.6%,11m
601,1,[아르아르]아르키스,4350,1225,60,36,96,62.5%,9m
603,1,[UNPF]大王椰子樹,4348,92,1,2,3,33.3%,8m
603,1,[Rush]DavenRush,4348,0,0,1,1,0.0%,12m
605,1,맹호중대행보관,4347,430,9,10,19,47.4%,3m
605,1,llllllllllll,4347,0,0,1,1,0.0%,11m
607,3,[Hyper]범이네대장간,4345,1754,158,176,334,47.3%,9m
607,2,Lunatic,4345,0,0,1,1,0.0%,10m
609,1,멋쟁이,4343,267,16,10,26,61.5%,4m
609,3,[건강]韋翔咖啡,4343,0,0,1,1,0.0%,6m
611,1,그종족프읍읍읍,4342,134,4,4,8,50.0%,5m
612,1,유현의난,4340,439,41,32,73,56.2%,11m
612,1,Augenzahn,4340,418,9,12,21,42.9%,3m
612,2,Affirmation,4340,0,0,1,1,0.0%,10m
615,1,Gray,4339,1143,36,35,71,50.7%,10m
615,1,[ArGKR]JusticeSimon,4339,278,7,8,15,46.7%,4m
617,1,freeny,4338,1042,83,91,174,47.7%,10m
617,1,VmelOdy,4338,46,1,5,6,16.7%,4m
619,2,[무한오영종]NeedKing,4337,0,0,1,1,0.0%,9m
620,3,[Ygan]양민,4336,0,1,0,1,100.0%,8m
621,2,llllllllllll,4335,259,15,1,16,93.8%,9m
622,1,매실차,4334,0,1,1,2,50.0%,11m
623,1,[ANGG]ashtontontno,4332,1978,627,657,1284,48.8%,3m
624,1,llllllllllll,4331,276,6,14,20,30.0%,10m
625,1,LordOfWoe,4330,562,14,22,36,38.9%,4m
625,1,[GIS]傳統戰神,4330,178,5,6,11,45.5%,11m
625,1,llllllllllll,4330,234,5,14,19,26.3%,5m
625,1,[영앤리치]Blue,4330,129,3,2,5,60.0%,9m
629,2,[GITS]UnDefined,4329,0,0,1,1,0.0%,3m
630,1,연서파파,4328,779,66,37,103,64.1%,12m
630,2,EWBRWE,4328,76,2,1,3,66.7%,7m
630,2,[1산]주엽팔미아구찜,4328,0,0,1,1,0.0%,4m
633,1,[애니멀킹덤]맛춤법재데로써,4325,0,0,5,5,0.0%,5m
634,1,[TalenT]KaworuWYD,4324,1978,323,314,637,50.7%,3m
634,1,IIIIIII,4324,1177,64,53,117,54.7%,5m
634,1,Clazzi,4324,88,4,6,10,40.0%,10m
634,1,찡이,4324,142,3,6,9,33.3%,8m
638,1,BruceLee,4323,1854,353,381,734,48.1%,8m
639,1,llIIlIIllIlI,4322,666,18,16,34,52.9%,4m
640,1,IIlllIIIlllI,4320,1528,231,223,454,50.9%,9m
640,2,llllllllllll,4320,140,8,1,9,88.9%,3m
642,1,shoho,4319,96,2,2,4,50.0%,3m
642,2,[시간을달려서]최유나,4319,0,1,0,1,100.0%,4m
644,2,IIIIIIIIII,4318,1658,73,67,140,52.1%,9m
644,2,Sourdough,4318,832,37,15,52,71.2%,9m
646,1,llllllllllll,4315,0,0,4,4,0.0%,4m
647,2,llllllllllll,4314,108,3,1,4,75.0%,6m
648,1,Aegis,4313,348,8,13,21,38.1%,3m
649,1,거제저그,4312,409,13,7,20,65.0%,4m
650,2,뮤탈리스크,4310,102,3,3,6,50.0%,7m
651,2,[Hyper]파닭츄,4309,374,12,14,26,46.2%,11m
651,2,llllllllllll,4309,40,1,2,3,33.3%,6m
653,1,Nurse,4308,927,45,44,89,50.6%,10m
653,1,lllllllllll,4308,439,23,7,30,76.7%,5m
653,3,lIlIlIIllIIl,4308,0,1,0,1,100.0%,8m
656,1,Symphony,4307,1945,281,310,591,47.5%,10m
657,1,[Tsuper]휠릴리,4305,1998,212,216,428,49.5%,4m
657,1,llllllllllll,4305,350,10,11,21,47.6%,10m
659,1,Kaiman,4304,1802,52,59,111,46.8%,10m
660,1,[리더쓰]즐겜유저,4303,1152,29,37,66,43.9%,10m
660,1,[엔에스]링링,4303,48,2,6,8,25.0%,4m
660,2,GGplay,4303,30,1,1,2,50.0%,10m
663,1,IIIIIIIIIIII,4300,1873,244,254,498,49.0%,4m
663,2,IIIIIIIIIIII,4300,1656,63,65,128,49.2%,10m
665,3,Magarin,4298,0,1,6,7,14.3%,6m
666,1,[NTUeS]RYang,4297,1460,82,89,171,48.0%,8m
666,1,IIIIIIIIIIII,4297,553,19,19,38,50.0%,9m
668,2,IIIIIIIIIIII,4296,38,1,4,5,20.0%,11m
668,1,llllllllllll,4296,0,0,4,4,0.0%,4m
670,1,Noispaxen,4295,353,9,20,29,31.0%,8m
670,2,IIIIIIIII,4295,0,1,1,2,50.0%,10m
672,2,Zerg,4294,0,0,1,1,0.0%,11m
672,2,이병렬,4294,0,0,1,1,0.0%,4m
674,1,[민법의맥]이영호짱짱맨,4291,586,14,24,38,36.8%,3m
674,2,[Lotuz]ShieldOfAuir,4291,0,0,1,1,0.0%,9m
676,2,llllllllllll,4290,1540,69,48,117,59.0%,3m
676,2,nelle,4290,0,0,1,1,0.0%,6m
678,1,[이터널]강백호,4289,1969,118,115,233,50.6%,11m
678,2,lllllllll,4289,106,4,5,9,44.4%,3m
680,1,프사기프종빨,4286,1964,64,72,136,47.1%,4m
681,2,[PANG]푸른들,4285,0,0,1,1,0.0%,10m
682,1,YoungChan,4284,1278,158,166,324,48.8%,12m
682,2,llllllllllll,4284,0,0,5,5,0.0%,4m
684,2,[COTE]loser,4283,1232,77,56,133,57.9%,10m
684,2,다이아지박령,4283,632,25,20,45,55.6%,3m
686,1,갓보기,4282,153,3,6,9,33.3%,5m
687,1,UnicInte,4281,1052,37,49,86,43.0%,4m
687,2,[이터널]PeinMoDeGY,4281,38,2,1,3,66.7%,10m
689,1,IIIIIIIIIIII,4280,1710,48,61,109,44.0%,4m
690,1,IIIIlllllIII,4279,298,15,6,21,71.4%,5m
691,1,아이어행성,4278,1097,35,42,77,45.5%,10m
691,3,[Best12]JerrodCole,4278,30,1,2,3,33.3%,8m
693,1,[NGamE2]csomar,4277,1593,176,181,357,49.3%,8m
693,2,llllllllllll,4277,44,2,1,3,66.7%,11m
695,1,WaPpWYD,4276,1100,52,52,104,50.0%,11m
695,2,나무의숲,4276,0,1,0,1,100.0%,9m
697,2,BlackMamba,4273,1292,48,43,91,52.7%,9m
698,1,[쫄깃함]KnopFler,4272,1182,100,90,190,52.6%,4m
699,2,[고1저그원탑]최지민,4271,206,6,3,9,66.7%,9m
700,2,HotDog,4265,1680,564,580,1144,49.3%,3m
700,2,[나땐말이여]도둑꾼,4265,0,1,0,1,100.0%,10m
702,1,렌더린,4263,1945,340,362,702,48.4%,12m
702,1,Jansang,4263,646,15,19,34,44.1%,4m
704,1,[래더납치범]칼립스,4261,1930,397,407,804,49.4%,10m
705,2,트간지,4259,952,34,42,76,44.7%,9m
706,1,javier,4258,1921,499,482,981,50.9%,5m
706,2,[深耕C]sliverwolf,4258,0,1,0,1,100.0%,9m
708,1,IIIIIIIIIIII,4256,1941,326,321,647,50.4%,10m
709,1,[Rush]BluERush,4255,1939,165,179,344,48.0%,10m
710,2,llllllllllll,4254,828,42,15,57,73.7%,6m
711,2,frontwards,4253,1648,254,270,524,48.5%,9m
712,1,선비노,4251,1589,216,250,466,46.4%,10m
713,2,[무한오영종]쫄깃,4250,516,18,16,34,52.9%,4m
714,2,iris,4249,1661,442,385,827,53.4%,10m
714,2,[Ato]명군,4249,106,4,0,4,100.0%,4m
714,2,TheMon,4249,0,0,4,4,0.0%,10m
717,2,부리부리꿀꿀,4248,450,70,65,135,51.9%,7m
717,2,문재인,4248,62,2,6,8,25.0%,9m
719,2,IlIlIlIlI,4242,1638,329,299,628,52.4%,4m
719,1,Terran,4242,1899,157,159,316,49.7%,4m
721,2,Object,4241,1162,41,40,81,50.6%,7m
722,2,[이터널]Gesture,4240,410,38,15,53,71.7%,4m
723,1,hest,4238,1160,30,45,75,40.0%,3m
724,1,[0I터널]Gonzo,4237,893,91,71,162,56.2%,8m
725,1,[Lotuz]Rain,4236,90,2,14,16,12.5%,10m
726,2,CapTain,4235,48,2,1,3,66.7%,11m
727,2,해동,4234,0,1,2,3,33.3%,7m
728,2,Kap,4231,34,1,2,3,33.3%,4m
728,2,에일리,4231,0,0,3,3,0.0%,3m
730,2,[보로루리]Bororuri,4230,1467,75,60,135,55.6%,10m
730,2,[ELS]ShowMaker,4230,148,6,8,14,42.9%,4m
730,2,[3000元]毛豆新车网,4230,0,0,1,1,0.0%,6m
733,2,llllllllllll,4229,118,5,2,7,71.4%,4m
733,2,망겜,4229,34,1,2,3,33.3%,6m
735,2,[Lotuz]박진영왜케잘생김,4227,0,1,2,3,33.3%,4m
736,2,[포방부]버프효과,4226,0,1,0,1,100.0%,7m
736,2,[GIS]DraCula,4226,0,0,1,1,0.0%,4m
738,1,IIIIIIIIIIII,4224,787,27,37,64,42.2%,5m
739,2,[Equal]아르테미스,4223,0,0,1,1,0.0%,9m
740,2,오토리,4222,274,10,6,16,62.5%,7m
741,2,[도리]SunNYHilL,4221,130,4,2,6,66.7%,11m
742,2,[겨울방어]어윤수우승있다,4220,30,1,2,3,33.3%,10m
742,2,영원히충격파,4220,0,0,5,5,0.0%,9m
744,1,IIIIIIIIIIII,4219,1888,253,268,521,48.6%,4m
744,2,[Yisc]MRKM,4219,1613,159,140,299,53.2%,4m
744,2,Ackerman,4219,462,15,18,33,45.5%,9m
747,1,[Yisc]아오키지,4215,400,9,30,39,23.1%,5m
748,2,IlIlIlIlIlIl,4213,662,25,18,43,58.1%,9m
748,2,llllllllllll,4213,0,0,5,5,0.0%,7m
750,1,[Old]capyrossi,4212,1910,298,330,628,47.5%,8m
750,2,[CIM]OptBnKSJ,4212,0,1,0,1,100.0%,7m
750,2,NaDa,4212,0,1,0,1,100.0%,9m
753,2,[CIM]EyeTERRORIST,4211,0,1,3,4,25.0%,9m
754,1,[무한오영종]스투는흥겜이다,4210,1895,244,261,505,48.3%,3m
754,2,[UNPF]長安一片月,4210,0,0,4,4,0.0%,3m
756,2,十四歲的老婆,4207,0,0,1,1,0.0%,3m
757,2,小薇,4206,373,57,61,118,48.3%,10m
758,2,oGsForGG,4204,460,16,21,37,43.2%,9m
758,2,AppleDealer,4204,154,6,4,10,60.0%,9m
760,2,SHOW,4202,395,20,3,23,87.0%,9m
761,2,Think,4201,0,0,1,1,0.0%,3m
762,2,[偶像型男隊]Grrrr,4200,120,4,0,4,100.0%,7m
762,3,Dreamtmicky,4200,30,1,2,3,33.3%,4m
762,2,싸이코쇼커,4200,0,0,1,1,0.0%,7m
765,2,은메달염소자리,4199,140,5,3,8,62.5%,11m
765,2,[Lotuz]루테르,4199,38,2,1,3,66.7%,3m
765,2,MARS,4199,0,1,5,6,16.7%,9m
765,2,[CIM]박재형,4199,40,1,5,6,16.7%,4m
769,2,[ANGG]UNOBomber,4197,0,0,1,1,0.0%,4m
770,2,주황신발,4196,1602,116,82,198,58.6%,9m
770,1,[어윤수님개쩜]MintChoCo,4196,0,4,1,5,80.0%,11m
772,2,llllllllllll,4193,450,17,10,27,63.0%,9m
772,2,Bogus,4193,130,5,0,5,100.0%,9m
774,2,[ANGG]GlaDiAtoR,4191,58,2,1,3,66.7%,6m
774,2,lIIIllIllIll,4191,58,2,5,7,28.6%,10m
776,1,THTHXD,4190,1147,37,36,73,50.7%,5m
776,2,히드라,4190,46,1,1,2,50.0%,9m
778,2,[CDG]NewRun,4189,937,49,61,110,44.5%,9m
779,2,ASDFGH,4188,0,1,3,4,25.0%,9m
779,2,Casber,4188,0,0,1,1,0.0%,9m
781,2,[Master]OverMind,4186,1596,235,230,465,50.5%,9m
781,2,[StorM2]阿羅拉,4186,0,1,2,3,33.3%,7m
783,2,lllllIIIllIl,4185,1530,84,84,168,50.0%,3m
783,2,[유튜브에링스]llllllllllll,4185,0,1,1,2,50.0%,9m
785,2,TiaoMaRen,4184,1488,106,100,206,51.5%,10m
785,2,[BHN]llllIIIIIlll,4184,68,2,4,6,33.3%,9m
787,2,낄낄,4183,751,70,68,138,50.7%,6m
788,2,[Dopen]설화,4181,356,23,13,36,63.9%,10m
789,2,검은마법사,4180,220,11,6,17,64.7%,4m
790,2,IIIIIIIIIII,4179,217,13,0,13,100.0%,7m
791,2,lllllllllll,4178,1620,262,275,537,48.8%,3m
791,2,Ernestine,4178,0,0,1,1,0.0%,4m
791,2,[뒷세계사람들]Another,4178,0,0,1,1,0.0%,9m
794,2,[KH258]世紀初始之音,4177,906,34,29,63,54.0%,4m
794,2,[Aster]elitegold,4177,0,0,1,1,0.0%,7m
796,2,Zeratul,4176,66,3,0,3,100.0%,10m
797,3,仇敌三千,4174,332,18,4,22,81.8%,10m
797,2,LoveYouYL,4174,0,0,1,1,0.0%,7m
799,2,응수야빵사와,4172,0,0,4,4,0.0%,3m
800,2,[꾸루꾸루]꾸루꾸루,4171,30,1,3,4,25.0%,10m
801,2,[事大主義]中国共産党,4170,0,1,0,1,100.0%,4m
802,2,르노르노,4169,1585,218,226,444,49.1%,7m
802,2,조는아이,4169,30,2,3,5,40.0%,7m
804,2,MADNESS,4168,0,1,0,1,100.0%,12m
804,2,영혼,4168,0,0,1,1,0.0%,4m
806,2,권창근,4167,826,32,41,73,43.8%,6m
806,2,[SofT]INnOcolOR,4167,496,18,15,33,54.5%,6m
808,2,insurrectiOn,4166,0,0,2,2,0.0%,9m
809,1,[Lotuz]Nemshing,4165,1456,46,52,98,46.9%,4m
809,2,[용주골]분당거지,4165,672,28,17,45,62.2%,4m
809,2,[CIM]홍익대학교요트부,4165,312,10,15,25,40.0%,9m
812,2,IIIIIIIIIIII,4164,1388,56,50,106,52.8%,11m
812,2,jsm,4164,0,1,0,1,100.0%,12m
814,2,머슬몬스터,4162,1451,192,199,391,49.1%,12m
814,1,llllllllllll,4162,1841,114,123,237,48.1%,4m
816,2,피터,4161,1392,52,58,110,47.3%,11m
816,2,공허의저그,4161,0,0,2,2,0.0%,9m
816,2,Kairos,4161,0,0,3,3,0.0%,9m
819,2,NexLife,4160,826,31,29,60,51.7%,6m
819,2,[모두하나인숲]집정관,4160,30,1,1,2,50.0%,10m
821,1,[돌변쩔좀]공허폭격기성애자,4159,892,59,62,121,48.8%,5m
822,2,SnowProject,4158,0,0,1,1,0.0%,8m
822,2,oliver,4158,0,0,3,3,0.0%,9m
824,2,포돌이,4156,983,66,29,95,69.5%,9m
824,1,정확신속고급대리,4156,664,19,26,45,42.2%,4m
824,3,沧海客,4156,213,11,0,11,100.0%,4m
827,2,MrLasti,4155,1543,450,436,886,50.8%,6m
827,1,Deneb,4155,383,9,17,26,34.6%,5m
827,2,GREED,4155,186,6,1,7,85.7%,4m
830,2,[이터널]Winners,4154,0,1,2,3,33.3%,10m
831,2,[Member]MadMax,4151,1097,189,202,391,48.3%,3m
831,2,[ELS]영블리프트,4151,288,9,10,19,47.4%,9m
833,2,[겨울방어]Viento,4150,1618,291,295,586,49.7%,7m
834,1,甯采臣,4149,0,0,1,1,0.0%,11m
835,2,MaDgwool,4147,426,27,9,36,75.0%,11m
835,2,[break]Dsherlock,4147,36,1,2,3,33.3%,3m
837,2,[phan]tomgogo,4146,1561,265,255,520,51.0%,4m
837,1,[Lotuz]Ruid,4146,1777,174,200,374,46.5%,4m
839,2,어쿠스틱,4144,522,19,16,35,54.3%,6m
840,2,BloSSoM,4143,60,3,2,5,60.0%,4m
840,3,eJeJeJ,4143,0,1,0,1,100.0%,6m
842,2,llllllllllll,4142,806,38,14,52,73.1%,10m
843,2,IIIIIIII,4141,1206,67,67,134,50.0%,6m
843,2,Life,4141,226,8,4,12,66.7%,6m
845,2,llllllllllll,4139,374,15,9,24,62.5%,9m
846,2,OiLTowN,4138,90,3,2,5,60.0%,7m
847,2,불사조,4137,66,5,7,12,41.7%,3m
848,2,[두피용면도기]IlIlIlllIl,4136,30,1,4,5,20.0%,4m
849,2,[s2Mc]이안,4135,512,104,56,160,65.0%,11m
850,1,[Hyper]군단,4134,610,34,50,84,40.5%,12m
851,2,aclg,4132,654,87,69,156,55.8%,10m
851,2,FlashCn,4132,893,38,33,71,53.5%,9m
853,2,문참새,4130,1422,89,88,177,50.3%,3m
853,2,[Pandan]빵키의빵,4130,408,16,9,25,64.0%,4m
855,2,[SpM]MinDen,4127,290,8,25,33,24.2%,3m
855,2,[NDW]Hunter,4127,0,0,2,2,0.0%,3m
857,2,벼루,4126,118,5,1,6,83.3%,6m
858,2,wisdom,4125,90,4,2,6,66.7%,10m
858,2,Kukulza,4125,0,0,1,1,0.0%,10m
860,2,맛춥뻡않틀립,4124,1296,47,53,100,47.0%,11m
860,2,[Scar]Dcru,4124,70,3,3,6,50.0%,8m
860,2,qweasd,4124,68,2,8,10,20.0%,10m
863,1,[SeA]教主,4122,1825,324,355,679,47.7%,11m
863,2,tokka,4122,238,9,15,24,37.5%,9m
863,2,[前無後無]BIOTECH,4122,30,1,5,6,16.7%,6m
866,2,HunterKiller,4120,1578,216,208,424,50.9%,11m
866,2,[TeamNV]박서준,4120,158,6,2,8,75.0%,10m
866,2,MyEyes,4120,124,5,3,8,62.5%,10m
866,2,Ajax,4120,30,1,2,3,33.3%,7m
866,2,FlowerRain,4120,0,1,3,4,25.0%,3m
871,2,응꿈도꾸지마,4119,468,18,12,30,60.0%,4m
872,2,팔비트,4118,1309,185,177,362,51.1%,9m
872,2,lIllIIIllIll,4118,111,6,3,9,66.7%,10m
874,2,[TalenT]ReCall,4117,66,3,1,4,75.0%,9m
874,2,[오직모니카만]IIIIIIIIII,4117,60,2,5,7,28.6%,9m
876,2,아끼라,4116,1395,65,44,109,59.6%,9m
876,1,[NGameS]교복소녀티아라,4116,0,1,0,1,100.0%,3m
878,3,[oNs7]버로닷,4115,197,6,9,15,40.0%,3m
879,2,[Ygan]Reverie,4114,0,0,1,1,0.0%,10m
880,2,llllllllllll,4113,196,12,1,13,92.3%,3m
881,1,찜닭,4112,1560,62,67,129,48.1%,3m
881,2,싸이커,4112,0,0,1,1,0.0%,3m
883,2,[패자는피를]Logic,4111,588,21,25,46,45.7%,10m
883,2,[Yisc]IIIIIIIIIIII,4111,196,10,4,14,71.4%,3m
885,2,Akai,4110,392,16,9,25,64.0%,4m
885,2,[NADE]일본어가능한렉키,4110,0,1,0,1,100.0%,4m
887,2,세삐이,4109,967,69,48,117,59.0%,10m
887,2,TamodishWyt,4109,772,30,27,57,52.6%,11m
887,2,GTS,4109,0,1,0,1,100.0%,6m
887,2,[UNPF]RichardWang,4109,36,1,1,2,50.0%,7m
891,2,[s2Mc]SUITBOX,4107,402,16,14,30,53.3%,11m
891,2,그런거없는데,4107,88,4,5,9,44.4%,9m
891,2,AchoooJian,4107,30,1,3,4,25.0%,6m
891,2,이산확률변수,4107,0,0,1,1,0.0%,4m
891,2,楓棠,4107,0,0,2,2,0.0%,9m
896,2,엔에스피위너,4106,0,1,0,1,100.0%,8m
896,2,[투막빌런협회]군단의심장,4106,0,1,0,1,100.0%,6m
898,2,IIIlIIllIIII,4104,160,6,6,12,50.0%,10m
898,1,[sc2mc]llllllllllll,4104,96,2,16,18,11.1%,4m
900,2,Fox,4101,102,4,6,10,40.0%,6m
900,2,[NGameS]LostStars,4101,0,1,0,1,100.0%,6m
902,2,[fromBY]nobody,4100,904,34,34,68,50.0%,6m
902,2,[SpM]anjesWYD,4100,41,3,6,9,33.3%,12m
904,2,[SGlory]befuns,4099,285,10,13,23,43.5%,10m
905,2,[Old]imnoob,4098,206,7,13,20,35.0%,6m
905,2,Zapx,4098,0,0,4,4,0.0%,8m
907,2,김굠만입니다,4097,604,114,101,215,53.0%,12m
907,2,[快樂玩家]嗆辣綠茶,4097,0,0,1,1,0.0%,6m
909,2,[鳥東西]llllllllllll,4096,84,3,7,10,30.0%,6m
910,2,GuerrilaZerg,4095,100,4,3,7,57.1%,10m
911,2,[인투더]IntoTheSouL,4094,1548,276,259,535,51.6%,3m
911,2,IIIIIIIIIIII,4094,856,32,37,69,46.4%,4m
911,2,SoFinn,4094,495,21,29,50,42.0%,7m
911,3,Sinatra,4094,0,0,1,1,0.0%,5m
915,2,AcE,4093,58,2,4,6,33.3%,4m
915,2,[9999ms]llllllllllll,4093,30,1,3,4,25.0%,10m
915,3,[ROKU]Muse,4093,0,0,1,1,0.0%,5m
918,3,쉬메일,4092,192,14,7,21,66.7%,3m
918,1,[NAOP]미국사람,4092,97,6,0,6,100.0%,9m
918,2,shigatsu,4092,98,4,2,6,66.7%,4m
921,3,IIIIIIIIIIII,4091,30,1,2,3,33.3%,4m
922,1,스파이다,4090,1820,203,230,433,46.9%,10m
923,2,[YONSEI]DABO,4088,70,3,4,7,42.9%,6m
923,2,DaYdrEAm,4088,0,1,0,1,100.0%,11m
925,1,분당남이다,4085,1780,294,313,607,48.4%,4m
925,2,[SMA]stahy,4085,62,2,8,10,20.0%,10m
927,2,[1ll1l1]LUNA,4084,1204,200,168,368,54.3%,8m
928,2,[무한오영종]소민누나,4082,252,8,10,18,44.4%,8m
929,2,[어윤수준우승]누가연속준우승함,4081,0,1,0,1,100.0%,7m
930,2,레이너링돌리기,4080,1508,359,364,723,49.7%,11m
930,2,DotDot,4080,458,29,19,48,60.4%,12m
930,2,llllllllllll,4080,241,11,5,16,68.8%,9m
930,2,LAN,4080,60,3,1,4,75.0%,4m
934,2,[ELS]빵꾸똥꾸,4078,30,1,2,3,33.3%,10m
934,2,MIDnight,4078,0,0,1,1,0.0%,12m
936,2,[ELS]이민열,4077,58,4,3,7,57.1%,4m
937,2,[ladys]dfafsf,4076,1062,38,43,81,46.9%,9m
937,2,핑크공주님,4076,545,28,9,37,75.7%,8m
937,2,catel,4076,166,7,5,12,58.3%,3m
937,2,[낭낭하게]HIIO,4076,0,0,1,1,0.0%,11m
937,2,[나가자]기권정본,4076,0,0,3,3,0.0%,11m
942,1,IIIIIIIIIII,4075,1828,96,134,230,41.7%,3m
943,2,헤타이로이,4074,0,1,0,1,100.0%,9m
944,1,leekkang,4073,1824,582,564,1146,50.8%,8m
944,2,llllllllllll,4073,0,0,2,2,0.0%,8m
946,2,Bogen,4072,1611,208,204,412,50.5%,3m
946,2,[민창렬]HuntingTiger,4072,494,82,75,157,52.2%,11m
946,2,Dawn,4072,128,5,5,10,50.0%,9m
946,3,Stella,4072,30,1,3,4,25.0%,7m
950,2,공밍팔푸,4071,58,3,2,5,60.0%,8m
951,2,[아니유]sad,4070,0,0,1,1,0.0%,4m
952,3,zerz,4069,0,0,1,1,0.0%,6m
953,2,Rush,4068,0,1,3,4,25.0%,9m
954,1,IIIIIIIIIIII,4067,1442,81,92,173,46.8%,8m
954,2,[NsP]MarKus,4067,58,2,1,3,66.7%,6m
956,2,[무력개입]재활훈련,4066,1533,300,287,587,51.1%,6m
957,2,CodeForYou,4065,0,1,0,1,100.0%,9m
958,2,YouDingSin,4064,174,7,8,15,46.7%,10m
958,2,상남동강아지,4064,0,0,1,1,0.0%,3m
960,2,휘센,4063,601,26,17,43,60.5%,4m
960,2,jaeyoongz,4063,114,5,4,9,55.6%,9m
960,2,[Rush]HGP,4063,30,1,4,5,20.0%,9m
963,2,桑格莉亞,4062,334,16,10,26,61.5%,8m
963,2,llllllllllll,4062,30,1,5,6,16.7%,9m
965,2,Sweeper,4060,100,3,7,10,30.0%,7m
965,2,FutureWorld,4060,30,1,2,3,33.3%,9m
965,2,[TalenT]BotAccount,4060,0,0,1,1,0.0%,3m
968,2,[Yisc]Heavenly,4059,744,33,44,77,42.9%,12m
968,2,[엔타로연합]스투해서인생망침,4059,0,4,1,5,80.0%,8m
970,2,[무한오영종]Empire,4056,1482,213,184,397,53.7%,8m
970,2,[SofT]지면서배울까,4056,146,6,3,9,66.7%,8m
970,2,LawLiet,4056,0,0,1,1,0.0%,9m
973,2,KuoCY,4055,1526,251,261,512,49.0%,3m
973,2,random,4055,118,5,2,7,71.4%,6m
973,2,롤충쉐리,4055,58,2,2,4,50.0%,8m
973,2,꽈뚜룹,4055,0,0,2,2,0.0%,8m
977,2,ReaperMaster,4054,0,1,1,2,50.0%,11m
977,2,LifeisGood,4054,30,1,2,3,33.3%,4m
977,2,Lefty,4054,30,1,3,4,25.0%,10m
980,2,[IWYDI]LeoCronus,4053,819,76,81,157,48.4%,12m
981,2,아우레,4050,0,0,2,2,0.0%,9m
981,2,llllllllllll,4050,0,0,15,15,0.0%,10m
983,2,Arche,4049,794,126,128,254,49.6%,10m
984,2,Limba,4048,0,0,1,1,0.0%,4m
985,2,lscab,4047,1509,564,545,1109,50.9%,9m
986,2,제주무농장,4044,1207,44,46,90,48.9%,12m
987,2,[래더납치범]미카엘,4043,386,75,81,156,48.1%,7m
987,2,[지비클]Stellar,4043,1118,49,42,91,53.8%,9m
987,2,DaffyDuck,4043,727,33,20,53,62.3%,11m
987,2,Red,4043,239,20,25,45,44.4%,10m
987,2,[연세조]carmankass,4043,81,4,4,8,50.0%,3m
992,2,MEMENTO,4042,0,0,1,1,0.0%,12m
993,2,Zai,4041,1529,157,165,322,48.8%,12m
993,2,王英俊,4041,241,9,3,12,75.0%,4m
993,1,[3연벙]콩콩콩콩까지마,4041,0,3,3,6,50.0%,11m
996,2,pepi,4040,1544,59,65,124,47.6%,4m
997,2,SaBiJustice,4039,480,18,18,36,50.0%,6m
997,2,星海戰士,4039,258,10,5,15,66.7%,4m
997,2,[Lotuz]맹덕충,4039,140,6,3,9,66.7%,4m
997,2,[신출귀몰]아오씐나,4039,30,1,1,2,50.0%,3m
1001,1,llllllllllll,4038,1782,424,479,903,47.0%,5m
1002,2,Gimli,4037,379,27,36,63,42.9%,11m
1002,2,Phive,4037,94,4,4,8,50.0%,10m
1004,2,ANNA,4036,1584,63,66,129,48.8%,11m
1004,2,liawan,4036,1068,40,39,79,50.6%,10m
1006,2,[ELS]CAMP,4035,1508,77,50,127,60.6%,11m
1006,2,천지옥,4035,32,2,0,2,100.0%,4m
1006,2,terros,4035,30,2,1,3,66.7%,4m
1006,2,[ELS]FromE,4035,0,0,2,2,0.0%,9m
1010,2,[Dopen]Nako,4034,274,10,13,23,43.5%,10m
1011,2,두더지맨,4033,1267,86,90,176,48.9%,12m
1011,2,[NDW]Drima,4033,654,23,28,51,45.1%,9m
1011,3,Space,4033,281,14,1,15,93.3%,6m
1014,2,[더지니어스]그림같은홈런,4031,0,0,1,1,0.0%,3m
1014,2,llllllllllll,4031,0,0,1,1,0.0%,12m
1016,2,tutu,4030,560,39,25,64,60.9%,9m
1016,2,Garry,4030,892,34,31,65,52.3%,10m
1016,2,XThRall,4030,200,9,8,17,52.9%,6m
1019,1,HistGemini,4029,257,12,1,13,92.3%,10m
1020,2,자귀자귀무자귀,4028,443,79,64,143,55.2%,3m
1020,2,IMTalJaeSi,4028,90,4,6,10,40.0%,12m
1022,1,Joker,4027,196,12,1,13,92.3%,11m
1023,1,[s2Mc]종나인,4026,97,5,2,7,71.4%,11m
1023,2,[이터널]고인물게임,4026,60,3,1,4,75.0%,9m
1023,2,llllllllllll,4026,30,2,2,4,50.0%,9m
1026,2,[GIS]MoNaLiSa,4025,442,17,11,28,60.7%,9m
1026,2,ItoMarika,4025,419,15,10,25,60.0%,9m
1028,3,NOFY,4024,431,92,107,199,46.2%,6m
1028,2,Carebara,4024,320,11,11,22,50.0%,11m
1028,2,Miaha,4024,0,1,0,1,100.0%,11m
1031,2,VanDH,4021,1068,39,51,90,43.3%,8m
1031,2,herb,4021,444,25,19,44,56.8%,6m
1033,2,IIIIlIIlIIIl,4019,211,8,9,17,47.1%,8m
1033,2,[고졸테란]HonMonO,4019,34,1,6,7,14.3%,6m
1035,2,Yun,4018,233,7,10,17,41.2%,9m
1035,2,상큼한스피드,4018,108,4,10,14,28.6%,11m
1035,3,[艾爾]心比冰更冷,4018,0,0,1,1,0.0%,10m
1038,2,castelu,4017,0,0,1,1,0.0%,6m
1039,1,ONGGAMENET,4016,1095,79,91,170,46.5%,5m
1039,2,[Ato]제주바밤바사냥개,4016,118,4,7,11,36.4%,10m
1039,2,DPRKSUPERIOR,4016,0,0,1,1,0.0%,3m
1042,2,llllllllllll,4015,30,1,2,3,33.3%,10m
1043,2,DooHan,4013,1419,86,80,166,51.8%,6m
1043,2,llllllllllll,4013,321,11,12,23,47.8%,7m
1043,2,Bellaluna,4013,262,8,21,29,27.6%,8m
1043,2,죽은시점,4013,30,2,4,6,33.3%,8m
1043,2,Sanity,4013,0,1,2,3,33.3%,9m
1048,2,[勇敢正义部队]克哈的天黑了,4012,1210,47,40,87,54.0%,10m
1049,2,[5torM]watchNlearn,4011,1444,317,319,636,49.8%,12m
1049,2,IIIIIIIIIIII,4011,60,3,8,11,27.3%,8m
1049,2,[이터널]연겜만한다,4011,0,0,1,1,0.0%,10m
1049,2,[너의ol름은]IllIIIllllII,4011,0,0,1,1,0.0%,11m
1053,2,[아직이름없음]DictAtor,4010,120,5,4,9,55.6%,9m
1054,2,[WTSC]니가왜거기서나와,4009,1493,63,62,125,50.4%,6m
1055,2,IIIIIII,4008,792,49,60,109,45.0%,11m
1056,2,Leo,4007,1426,58,53,111,52.3%,8m
1057,2,Monday,4006,1080,41,40,81,50.6%,11m
1057,2,showserral,4006,401,19,5,24,79.2%,4m
1057,2,DonCarlo,4006,114,5,4,9,55.6%,9m
1057,2,팔십사년생이다,4006,78,4,3,7,57.1%,7m
1057,2,Pure,4006,0,0,1,1,0.0%,10m
1062,2,SojuZerg,4005,702,21,40,61,34.4%,9m
1062,1,afsd,4005,141,8,1,9,88.9%,11m
1062,3,llllllllllll,4005,0,0,1,1,0.0%,9m
1062,2,CVISE,4005,0,0,9,9,0.0%,10m
1066,2,IIIIIIIIII,4004,396,14,15,29,48.3%,9m
1067,2,Felix,4003,0,0,1,1,0.0%,9m
1068,2,LibraBoy,4002,228,8,4,12,66.7%,10m
1068,2,[怕死的死神]衣形幻影,4002,58,3,2,5,60.0%,11m
1068,3,IIIIIIIlllII,4002,0,1,0,1,100.0%,7m
1071,2,[NGameS]SaYA,4000,60,3,4,7,42.9%,10m
1072,2,[도도]깨비,3999,30,2,2,4,50.0%,8m
1073,2,초보,3997,90,4,7,11,36.4%,4m
1074,2,Senpuden,3996,123,3,2,5,60.0%,6m
1075,2,[SofT]무작위,3995,0,0,1,1,0.0%,9m
1076,1,LegendaryLea,3994,48,2,4,6,33.3%,3m
1077,2,[ELS]llllllllllll,3992,30,2,2,4,50.0%,11m
1078,2,Stevetsai,3991,760,32,27,59,54.2%,11m
1079,2,IntoThetoro,3990,1545,158,169,327,48.3%,10m
1079,2,UmBi,3990,86,3,2,5,60.0%,8m
1081,2,[pepsl]찡찡,3989,1517,166,170,336,49.4%,6m
1081,2,[NTW]dove,3989,206,6,5,11,54.5%,8m
1083,2,KIMMINYOUNG,3988,90,4,3,7,57.1%,8m
1083,3,llllllllllll,3988,0,1,0,1,100.0%,3m
1083,2,파워즐겜러,3988,0,0,3,3,0.0%,3m
1086,2,[Ruby]슈드,3987,0,0,1,1,0.0%,11m
1087,2,SimSooN,3986,0,1,0,1,100.0%,11m
1087,2,ChunChunMaru,3986,0,0,1,1,0.0%,11m
1087,3,원샷원킬,3986,0,0,1,1,0.0%,5m
1090,2,입닥쳐,3984,432,13,26,39,33.3%,3m
1090,2,[ABCEFG]SmokingKiss,3984,186,6,3,9,66.7%,10m
1090,2,[IWYDI]owenWYD,3984,124,5,8,13,38.5%,12m
1093,2,[s2Mc]Closer,3983,591,43,40,83,51.8%,6m
1093,2,호우호우쉐쉐,3983,0,1,6,7,14.3%,3m
1095,1,llllllllllll,3982,97,2,6,8,25.0%,8m
1095,2,아이린,3982,0,0,1,1,0.0%,12m
1097,2,haha,3981,1516,264,275,539,49.0%,7m
1097,2,OBsTiNatE,3981,416,15,12,27,55.6%,11m
1097,2,[옹선생님]모노,3981,246,8,13,21,38.1%,10m
1097,2,째똥먹는다지금,3981,0,0,1,1,0.0%,6m
1097,2,Royche,3981,0,0,1,1,0.0%,6m
1102,2,IIIIIIIII,3980,1534,173,184,357,48.5%,11m
1102,2,Hoppipolla,3980,1557,92,84,176,52.3%,4m
1102,2,llllllllllll,3980,0,1,0,1,100.0%,3m
1102,2,llllllllllll,3980,0,0,2,2,0.0%,4m
1106,3,gggl,3979,146,4,5,9,44.4%,5m
1106,2,울트라리스크,3979,0,0,1,1,0.0%,3m
1108,2,[너의ol름은]FLY,3978,0,0,2,2,0.0%,9m
1109,2,BenchPress,3977,498,24,11,35,68.6%,4m
1110,2,꺼꺼꺼꺼꺼껑,3975,1512,73,62,135,54.1%,11m
1110,2,IIIIIIIIIIII,3975,60,5,4,9,55.6%,3m
1110,2,llllllllllll,3975,30,1,1,2,50.0%,9m
1113,2,哥的下面是巨龍,3974,700,25,28,53,47.2%,11m
1114,2,Greyhair,3973,289,11,13,24,45.8%,3m
1114,2,IIIIIIIIIIII,3973,58,3,2,5,60.0%,9m
1114,2,[EMTRMT]평양냉면에백두산,3973,0,0,2,2,0.0%,6m
1117,2,IntoTheBoiCa,3972,1033,61,40,101,60.4%,12m
1117,2,[영앤리치]사촌간볼빨기,3972,60,2,4,6,33.3%,10m
1119,2,Mirror,3971,743,43,33,76,56.6%,9m
1119,2,AvglE,3971,118,4,3,7,57.1%,10m
1119,2,Chrono,3971,30,2,4,6,33.3%,6m
1122,2,[촌뜨기]llllllllllll,3970,1046,43,51,94,45.7%,6m
1123,2,탱구리,3969,1493,101,114,215,47.0%,3m
1123,2,한림대얼짱김정현,3969,112,2,1,3,66.7%,8m
1125,1,노대리야끼,3968,1486,258,249,507,50.9%,5m
1125,2,lllIlllIIIll,3968,86,3,4,7,42.9%,4m
1127,2,[NoTalk]希恩,3967,855,38,25,63,60.3%,4m
1127,2,[존치령주민]홍우상,3967,30,2,3,5,40.0%,8m
1129,2,IIIIIIIIIIII,3966,984,109,88,197,55.3%,9m
1130,2,boxhead,3964,1524,164,155,319,51.4%,6m
1130,2,고기사줘,3964,30,2,1,3,66.7%,6m
1132,2,ColdSeadling,3963,328,15,6,21,71.4%,3m
1132,2,[navel]Asahi,3963,0,1,6,7,14.3%,6m
1134,2,llllllllll,3962,130,5,9,14,35.7%,6m
1134,2,초짜,3962,0,3,4,7,42.9%,9m
1134,2,하늘과바람과별,3962,30,1,4,5,20.0%,9m
1137,2,저그야캐양,3961,703,43,32,75,57.3%,11m
1137,2,llllllllllll,3961,272,25,28,53,47.2%,10m
1137,2,RAGNAR,3961,372,16,8,24,66.7%,4m
1137,2,신희범제자,3961,294,10,18,28,35.7%,4m
1137,2,[ELS]토르,3961,0,0,1,1,0.0%,4m
1137,2,Ice,3961,0,0,1,1,0.0%,12m
1143,2,MicroJackson,3960,565,27,14,41,65.9%,3m
1143,2,[MRB]FlaSh,3960,86,3,4,7,42.9%,9m
1145,2,lIIIllIlIIl,3959,176,6,9,15,40.0%,6m
1146,1,쓰레기종족,3957,1424,81,85,166,48.8%,4m
1146,2,무적권,3957,88,1,1,2,50.0%,9m
1146,2,Realize,3957,0,0,3,3,0.0%,4m
1149,2,llllllllllll,3956,549,27,14,41,65.9%,4m
1149,2,RisK,3956,100,4,7,11,36.4%,4m
1149,2,윤은석,3956,88,4,10,14,28.6%,9m
1152,2,[여단]페트로시안,3955,1511,60,58,118,50.8%,8m
1152,2,Aspen,3955,622,21,29,50,42.0%,10m
1152,2,홍시야,3955,0,1,1,2,50.0%,6m
1152,2,llllllllllll,3955,88,1,1,2,50.0%,10m
1156,2,咲良,3954,495,31,20,51,60.8%,4m
1156,2,[華盟]臭臭的蛙,3954,0,1,0,1,100.0%,10m
1158,2,[겨울방어]XdriVe,3953,1550,95,77,172,55.2%,6m
1158,2,자가라,3953,262,10,14,24,41.7%,10m
1158,2,[무한오영종]노인와사바리,3953,116,6,1,7,85.7%,3m
1161,2,MHNFPUPM,3952,559,46,38,84,54.8%,6m
1161,2,슈퍼초보,3952,218,8,14,22,36.4%,10m
1161,2,PgGoodBattle,3952,0,2,1,3,66.7%,4m
1161,2,왕저그,3952,0,0,1,1,0.0%,4m
1165,2,horang,3950,1008,38,36,74,51.4%,9m
1166,1,[TwoS]Creation,3948,191,7,5,12,58.3%,8m
1166,2,Luna,3948,167,6,4,10,60.0%,4m
1166,2,MarineKing,3948,30,1,4,5,20.0%,3m
1169,2,llllllllllll,3947,390,13,16,29,44.8%,12m
1169,2,[UMAI]JennerRay,3947,102,3,1,4,75.0%,8m
1169,2,전기기술사따자,3947,0,0,1,1,0.0%,11m
1172,2,[시럽]아뇨뚱인데요,3944,0,0,3,3,0.0%,9m
1173,2,MOPP,3943,0,1,4,5,20.0%,6m
1173,2,한택,3943,0,0,1,1,0.0%,4m
1175,2,Joker,3942,60,3,5,8,37.5%,9m
1176,2,[萬花筒寫輪眼]中二太郎,3941,1089,44,43,87,50.6%,6m
1176,2,[밀짚모해적단]불꽃해적강백호,3941,0,0,1,1,0.0%,6m
1178,2,llllllllllll,3939,1291,306,298,604,50.7%,9m
1178,2,분열기버프가시급,3939,372,14,17,31,45.2%,11m
1178,2,폰노이만,3939,0,1,0,1,100.0%,9m
1178,2,[얼라이브]ParkinsonLaw,3939,30,1,10,11,9.1%,12m
1182,2,흑화된유저,3938,1256,80,35,115,69.6%,4m
1182,2,lllllll,3938,153,8,12,20,40.0%,11m
1182,2,요시현,3938,0,0,1,1,0.0%,6m
1185,2,SoS,3937,1517,203,176,379,53.6%,4m
1185,2,Seriously,3937,1311,59,45,104,56.7%,4m
1185,2,Kaiser,3937,112,3,1,4,75.0%,9m
1185,2,캥거루,3937,30,1,5,6,16.7%,4m
1185,2,[KOSEAL]지옥주교육생,3937,30,1,8,9,11.1%,4m
1185,2,옹홍옹홍,3937,0,0,1,1,0.0%,10m
1191,2,ZerosugarCC,3936,0,0,3,3,0.0%,3m
1192,2,[문재인지지자]여자한테안져,3935,1483,427,448,875,48.8%,6m
1192,2,llllllllllll,3935,0,1,0,1,100.0%,3m
1194,2,psychosocial,3934,531,27,19,46,58.7%,9m
1194,2,테란은쓰레기다,3934,30,1,2,3,33.3%,9m
1196,2,추격자,3933,18,1,2,3,33.3%,6m
1197,2,해외사건,3932,0,1,2,3,33.3%,10m
1197,2,[VGL]킬타임,3932,0,0,2,2,0.0%,4m
1199,2,[광전사하키]Korona,3931,804,30,27,57,52.6%,4m
1199,2,쑈박스,3931,0,1,1,2,50.0%,9m
1201,2,[ELS]김월터,3930,764,27,32,59,45.8%,9m
1201,3,Eikichi,3930,0,0,1,1,0.0%,12m
1203,3,Mojoadam,3929,1216,60,53,113,53.1%,8m
1203,2,[싸갈쓰들]똥마려운변비,3929,430,24,15,39,61.5%,10m
1203,2,DrawingHyeon,3929,280,11,8,19,57.9%,10m
1206,2,상너무님,3926,0,0,4,4,0.0%,9m
1207,3,풍류,3924,486,19,13,32,59.4%,3m
1207,1,gogogo,3924,277,9,5,14,64.3%,7m
1207,3,llllllllllll,3924,30,1,1,2,50.0%,5m
1210,1,Narzisse,3923,180,7,3,10,70.0%,10m
1211,2,뚜와호우,3920,480,17,23,40,42.5%,8m
1211,2,개미하루,3920,30,1,3,4,25.0%,9m
1213,2,약탈자,3918,1503,206,193,399,51.6%,3m
1213,1,놀랄만한선박,3918,142,4,2,6,66.7%,11m
1213,2,[애니멀킹덤]동물왕고양이네코,3918,0,0,1,1,0.0%,3m
1216,3,Zachary,3916,0,0,1,1,0.0%,3m
1217,2,fastr,3915,142,4,3,7,57.1%,6m
1218,2,[나가자]WannaBe,3914,115,5,2,7,71.4%,4m
1218,2,[겨울방어]육식남,3914,0,0,2,2,0.0%,10m
1220,2,llllllllllll,3913,817,31,31,62,50.0%,6m
1220,3,IlIlIIlIIlIl,3913,355,15,12,27,55.6%,5m
1222,2,IIIIIIIIIIII,3912,1401,504,510,1014,49.7%,3m
1222,2,용용소,3912,762,27,34,61,44.3%,12m
1222,3,lIllIllIlIlI,3912,278,11,7,18,61.1%,4m
1222,2,[反暴雪]鳥王有夠鳥,3912,212,7,6,13,53.8%,12m
1222,2,CollinCobra,3912,128,4,2,6,66.7%,4m
1222,2,날빌러,3912,114,2,4,6,33.3%,12m
1228,2,eurra,3911,866,30,41,71,42.3%,12m
1229,2,나란사람은,3910,1550,242,232,474,51.1%,7m
1229,2,프사기애미챙녀,3910,598,70,63,133,52.6%,10m
1229,2,lllllIllll,3910,784,31,28,59,52.5%,12m
1229,2,Isaac,3910,281,11,14,25,44.0%,12m
1229,2,stakeout,3910,236,9,14,23,39.1%,3m
1229,3,[REGENO]HaWEE,3910,0,0,1,1,0.0%,8m
1229,2,llllllllllll,3910,0,0,5,5,0.0%,7m
1236,2,끝판대장,3909,617,20,41,61,32.8%,3m
1236,3,胖王,3909,46,4,2,6,66.7%,6m
1238,2,빨리하고끝내자,3907,1004,39,38,77,50.6%,8m
1238,3,말머리유씨가문,3907,0,2,3,5,40.0%,9m
1240,2,spArk,3904,165,9,0,9,100.0%,10m
1240,3,Nadie,3904,30,1,1,2,50.0%,9m
1240,2,pakYou,3904,0,0,6,6,0.0%,9m
1243,3,볼빨간아저씨,3902,0,0,1,1,0.0%,6m
1244,2,EOEJEOEJ,3901,30,1,4,5,20.0%,6m
1244,2,나하나쯤이야,3901,0,0,4,4,0.0%,12m
1246,3,sett,3900,0,0,1,1,0.0%,5m
1247,3,[WTSC]육식남,3898,0,1,0,1,100.0%,9m
1248,2,lllllllllll,3897,1489,458,453,911,50.3%,11m
1248,2,[인투더]IntoTheSWAN,3897,217,8,9,17,47.1%,3m
1248,3,接米令,3897,30,2,0,2,100.0%,3m
1251,2,세침떼기,3896,326,14,9,23,60.9%,8m
1251,3,NobleVIP,3896,388,14,17,31,45.2%,3m
1251,3,[게임플레이]IIIIllllllII,3896,0,1,1,2,50.0%,3m
1254,3,[伯剌西爾]RedAka,3895,0,1,0,1,100.0%,12m
1255,2,IIIIIIIIIIII,3894,354,24,16,40,60.0%,11m
1256,3,新心手,3893,406,16,6,22,72.7%,4m
1256,2,SHSX,3893,60,3,5,8,37.5%,6m
1258,2,YKR,3892,229,11,5,16,68.8%,4m
1258,3,NeoModern,3892,0,0,1,1,0.0%,7m
1260,2,[영웅크래프트]호두의반란,3891,94,3,10,13,23.1%,12m
1260,3,조라삐,3891,30,1,4,5,20.0%,9m
1262,2,BelluCci,3890,1417,204,217,421,48.5%,6m
1262,2,로로로롤롤,3890,62,2,12,14,14.3%,9m
1262,3,[이터널]TenDer,3890,0,0,1,1,0.0%,3m
1265,3,ddfactory,3889,1619,228,206,434,52.5%,3m
1265,3,Hairy,3889,565,60,48,108,55.6%,6m
1267,2,[도리]모슈네,3887,816,63,79,142,44.4%,11m
1267,2,[NREC]DayBreak,3887,986,44,41,85,51.8%,12m
1267,2,ghostface,3887,251,10,11,21,47.6%,12m
1270,3,[찹도의신]찹도웅앵,3886,231,12,0,12,100.0%,5m
1270,3,Scuderia,3886,30,1,3,4,25.0%,5m
1270,3,[SNUST]Ivory,3886,0,0,1,1,0.0%,9m
1273,3,MILDEOM,3885,88,3,6,9,33.3%,5m
1273,3,JWP,3885,0,2,3,5,40.0%,9m
1273,3,虛無飄渺,3885,0,0,1,1,0.0%,12m
1273,3,[GIS]此雍非彼雍,3885,0,0,1,1,0.0%,9m
1277,3,[NGameS]HappyRyeol,3884,438,22,14,36,61.1%,3m
1277,3,[국민MC]유재석,3884,382,15,8,23,65.2%,8m
1279,3,lol,3881,1305,115,94,209,55.0%,3m
1279,3,청룡병장공태풍,3881,324,11,11,22,50.0%,5m
1279,3,휘리아나,3881,0,0,1,1,0.0%,3m
1282,3,AppleGoogji,3880,0,1,0,1,100.0%,8m
1282,3,이발사,3880,30,1,1,2,50.0%,9m
1284,2,[네오]에네크,3879,276,9,13,22,40.9%,8m
1284,2,[Zhakul]SaNitiZer,3879,206,8,9,17,47.1%,4m
1284,3,승트라슈,3879,58,2,4,6,33.3%,6m
1284,3,라이트닝퓨리,3879,0,0,1,1,0.0%,8m
1284,2,Metalisk,3879,0,0,5,5,0.0%,11m
1289,2,늙어서맵리안됨,3877,1543,58,59,117,49.6%,9m
1289,2,wizardlizard,3877,416,24,11,35,68.6%,8m
1289,3,lllllll,3877,0,0,3,3,0.0%,6m
1292,2,jsthayabusa,3876,1563,250,212,462,54.1%,10m
1292,2,[TalenT]芒果冰沙,3876,1494,98,99,197,49.7%,9m
1292,3,SnowFlake,3876,0,0,1,1,0.0%,8m
1292,3,프로토스,3876,0,0,1,1,0.0%,5m
1296,2,GGplay,3875,1556,100,101,201,49.8%,4m
1296,3,MonsterCalls,3875,230,8,8,16,50.0%,7m
1296,2,lisassssssss,3875,146,6,8,14,42.9%,11m
1296,3,챠우람,3875,30,2,2,4,50.0%,4m
1300,3,[래더납치범]얌얌이,3873,88,3,5,8,37.5%,7m
1301,3,[InfNA]Melody,3872,0,1,0,1,100.0%,8m
1301,3,[어윤수님개쩜]rAbBit,3872,0,0,1,1,0.0%,5m
1303,2,Ive,3869,412,15,21,36,41.7%,12m
1303,3,[군주]Phantom,3869,0,0,2,2,0.0%,7m
1305,3,[SC2HK]KiwkofSoLo,3868,0,1,0,1,100.0%,12m
1306,2,sarion,3866,1015,257,262,519,49.5%,10m
1307,3,PaIN,3865,30,2,1,3,66.7%,6m
1307,3,[SofT]반짝이,3865,97,2,2,4,50.0%,6m
1307,3,[존잘러구찌]Color,3865,0,0,1,1,0.0%,9m
1307,3,[Equal]저사기,3865,0,0,2,2,0.0%,6m
1311,3,[PRS]Phrygian,3863,1580,248,237,485,51.1%,4m
1311,3,환상퍼즐,3863,168,9,1,10,90.0%,3m
1313,3,dennis,3862,58,3,0,3,100.0%,11m
1314,3,[유즈맵떠돌이]썬더데커던트,3861,809,35,22,57,61.4%,8m
1314,3,정예신병,3861,60,3,1,4,75.0%,7m
1314,3,Soysauce,3861,0,0,2,2,0.0%,5m
1317,3,[keroq]水上由岐,3860,989,45,14,59,76.3%,8m
1317,3,Anomal,3860,295,18,11,29,62.1%,6m
1317,2,[아다치]하루까,3860,122,7,11,18,38.9%,3m
1317,3,[컴공스투충]Starlett,3860,0,1,0,1,100.0%,9m
1321,3,미남쫑,3859,0,1,0,1,100.0%,7m
1322,2,[xTMDx]Rigo,3858,1348,80,86,166,48.2%,7m
1322,3,[프로야근러]꽉찬오렌지,3858,704,62,55,117,53.0%,8m
1322,3,IIIllIIIll,3858,281,15,15,30,50.0%,4m
1325,3,[래더납치범]녹녹이,3856,970,41,27,68,60.3%,7m
1326,3,[무사트]AgentH,3855,0,1,0,1,100.0%,11m
1326,2,decal,3855,0,1,9,10,10.0%,3m
1328,2,아이스아메리카노,3854,1180,190,181,371,51.2%,6m
1329,3,[협동전브론즈]맬찌님,3853,229,7,13,20,35.0%,6m
1329,3,물만두,3853,0,1,0,1,100.0%,7m
1331,3,SJZ,3852,88,4,3,7,57.1%,9m
1331,3,[Tpz]반도인,3852,60,2,4,6,33.3%,5m
1333,3,Destiny,3851,590,21,25,46,45.7%,4m
1334,3,무작위,3850,1590,178,161,339,52.5%,7m
1334,2,[柯昱夆]Convenience,3850,1478,98,95,193,50.8%,4m
1334,3,골드한번가보자,3850,142,5,8,13,38.5%,4m
1334,2,[NsP]NASA,3850,62,2,14,16,12.5%,8m
1334,3,말보루,3850,0,1,1,2,50.0%,11m
1334,3,병점고수리부엉이,3850,0,0,2,2,0.0%,8m
1340,3,TimQ,3849,268,11,5,16,68.8%,11m
1340,3,[Master]junedalup,3849,0,0,1,1,0.0%,8m
1342,3,LoveSupreme,3848,744,75,63,138,54.3%,6m
1342,3,bbangkyu,3848,86,3,3,6,50.0%,6m
1344,2,[Fu]Neptune,3847,898,34,33,67,50.7%,10m
1344,2,saewon,3847,54,11,29,40,27.5%,3m
1344,3,[艾爾]赦生靈兒,3847,0,1,0,1,100.0%,10m
1347,2,泣斬馬謖,3846,967,38,41,79,48.1%,12m
1347,2,戰鬥工兵士,3846,652,22,35,57,38.6%,8m
1347,3,IIIIIIIIIIII,3846,116,4,4,8,50.0%,12m
1347,3,zerglisk,3846,88,3,4,7,42.9%,8m
1347,3,[테란저그토스]포도,3846,30,2,1,3,66.7%,9m
1347,3,김인욱쓰레기새키,3846,0,0,1,1,0.0%,9m
1353,2,IRISnine,3845,831,91,99,190,47.9%,12m
1353,2,IIIIIIIIIIII,3845,320,16,12,28,57.1%,11m
1353,3,[어이둘리]도우너어서오고,3845,349,13,14,27,48.1%,9m
1353,3,[NGameS]생귤,3845,224,11,10,21,52.4%,9m
1353,2,ZzisPa,3845,128,4,16,20,20.0%,9m
1353,2,DaLanPa,3845,0,0,8,8,0.0%,8m
1359,1,구더기,3844,48,2,4,6,33.3%,8m
1359,3,은채,3844,0,0,1,1,0.0%,4m
1361,3,하루카,3842,910,37,25,62,59.7%,4m
1361,3,[TFlame]AodemiYuki,3842,547,37,25,62,59.7%,7m
1363,3,[Dopen]CYH,3841,58,2,3,5,40.0%,8m
1363,3,솔로는축복,3841,30,1,2,3,33.3%,5m
1365,3,[Kant]지렁이한마리,3840,192,12,1,13,92.3%,9m
1365,1,동태찌개,3840,216,9,6,15,60.0%,11m
1365,2,눈사람,3840,0,5,2,7,71.4%,3m
1365,2,NEWoobie,3840,62,2,14,16,12.5%,11m
1369,2,AppleFox,3839,616,67,72,139,48.2%,11m
1370,3,論論,3838,58,2,3,5,40.0%,4m
1370,3,[섹시아재]아빠멩스크,3838,0,0,1,1,0.0%,8m
1372,3,IIIIIIIIIIII,3837,97,2,0,2,100.0%,10m
1373,3,저그,3836,1179,119,88,207,57.5%,3m
1373,2,Dyun,3836,527,45,37,82,54.9%,10m
1375,2,[성천사]IIIIIIIIIIII,3835,160,5,1,6,83.3%,10m
1375,3,eklee,3835,0,1,1,2,50.0%,8m
1377,2,[WDY]사랑그리고죽음,3834,967,35,37,72,48.6%,9m
1377,3,闪耀偶像芭芭拉,3834,0,0,1,1,0.0%,9m
1379,2,SCV,3833,184,6,15,21,28.6%,3m
1379,3,[원빈]원빈처럼고수처럼,3833,86,3,2,5,60.0%,5m
1381,3,[패자는피를]블랜드,3832,870,37,30,67,55.2%,8m
1381,2,flower,3832,446,14,24,38,36.8%,11m
1381,3,Tezcatlipoca,3832,118,4,6,10,40.0%,5m
1381,2,[RuL]Grow,3832,90,4,9,13,30.8%,8m
1381,3,[카논]카논사랑해,3832,30,1,1,2,50.0%,9m
1381,3,밋밋한돌직구,3832,0,0,2,2,0.0%,11m
1387,2,Wolke,3831,1315,82,95,177,46.3%,3m
1387,3,[eNix]XETERUS,3831,0,0,1,1,0.0%,9m
1389,3,[XDream]WoPao,3830,0,3,2,5,60.0%,6m
1389,3,Crystal,3830,58,3,3,6,50.0%,9m
1389,2,[寄生虫]기생충,3830,0,1,0,1,100.0%,12m
1392,3,[MMGD]ozkk,3829,1160,50,38,88,56.8%,9m
1392,3,NosAres,3829,679,32,15,47,68.1%,5m
1392,2,그리앤다몽,3829,214,8,14,22,36.4%,11m
1392,2,[TpW]STarHero,3829,0,0,6,6,0.0%,7m
1396,3,[CIM]어마어마한저그,3828,264,9,11,20,45.0%,7m
1396,3,llllllllllll,3828,90,3,4,7,42.9%,5m
1396,3,Aesonge,3828,0,0,2,2,0.0%,11m
1399,3,도망자,3827,116,4,5,9,44.4%,5m
1399,3,봉사활동마스터,3827,0,1,4,5,20.0%,8m
1401,2,IIIIIIII,3826,1452,262,278,540,48.5%,12m
1401,3,나빌레라,3826,1355,63,51,114,55.3%,11m
1401,2,vip,3826,226,14,5,19,73.7%,7m
1401,3,부모님의유산,3826,0,1,0,1,100.0%,9m
1405,3,llllllllllll,3825,348,14,12,26,53.8%,6m
1405,3,[快樂玩家]Clementine,3825,0,1,0,1,100.0%,9m
1407,3,lIIIIIIIIIIl,3824,154,5,8,13,38.5%,10m
1408,3,llllllllllll,3823,446,18,11,29,62.1%,7m
1408,3,조땡,3823,290,11,4,15,73.3%,5m
1408,3,Rescue,3823,238,8,10,18,44.4%,7m
1408,3,llllllllllll,3823,0,1,0,1,100.0%,5m
1412,2,[하루살이]학생카드,3822,164,5,5,10,50.0%,9m
1413,3,IIllIIllIIll,3821,121,3,0,3,100.0%,8m
1414,2,[빨간달]Seowal,3820,356,17,15,32,53.1%,8m
1414,3,ZRZR,3820,120,3,0,3,100.0%,12m
1414,3,코런건없어용,3820,0,0,2,2,0.0%,6m
1417,2,[TITSQ]AprilRyanTT,3819,282,8,14,22,36.4%,6m
1417,3,[Rapid]Chaser,3819,0,1,0,1,100.0%,6m
1417,3,[GKFC]NAMUH,3819,0,1,0,1,100.0%,3m
1417,3,달그림자,3819,0,0,1,1,0.0%,3m
1421,3,SonOKong,3818,0,0,1,1,0.0%,4m
1422,2,IIIIIIIIIII,3816,1519,135,147,282,47.9%,10m
1422,2,Hareru,3816,917,46,32,78,59.0%,8m
1422,3,PHmarines,3816,354,14,9,23,60.9%,9m
1422,3,Sakura,3816,366,13,12,25,52.0%,8m
1422,2,fastr,3816,243,7,9,16,43.8%,8m
1427,3,이새롬,3814,1464,55,56,111,49.5%,6m
1427,3,[GIS]ReCall,3814,30,2,0,2,100.0%,5m
1429,3,[아다치]터치,3813,415,27,24,51,52.9%,11m
1429,3,llllllllllll,3813,58,3,2,5,60.0%,8m
1431,3,PanDa,3812,531,20,23,43,46.5%,4m
1431,3,아나스타샤,3812,30,1,2,3,33.3%,9m
1433,2,다이아갱플,3811,932,41,49,90,45.6%,6m
1434,3,나랑할사람,3810,121,7,0,7,100.0%,12m
1434,3,정글쥬스,3810,30,1,3,4,25.0%,5m
1436,3,[공대지]해처리,3809,889,64,66,130,49.2%,11m
1436,2,IIIIIIIIII,3809,539,27,34,61,44.3%,11m
1436,3,TerATo,3809,0,1,0,1,100.0%,4m
1436,3,[이터널]MorningStar,3809,0,0,1,1,0.0%,5m
1436,3,IIIIIIIIIIII,3809,0,0,1,1,0.0%,7m
1441,3,[문재앙씨발놈]신안노예출신,3808,825,35,20,55,63.6%,8m
1441,3,[초등학교]zerg,3808,202,7,8,15,46.7%,12m
1441,3,Zero,3808,0,0,1,1,0.0%,5m
1444,3,[Hyper]AvoCado,3807,245,29,23,52,55.8%,8m
1445,3,넬라판타시아,3806,1242,113,86,199,56.8%,7m
1445,3,Refield,3806,30,1,1,2,50.0%,7m
1447,3,DYNa,3805,367,23,13,36,63.9%,9m
1447,3,양세,3805,114,4,2,6,66.7%,6m
1447,3,[Milles]Frank,3805,0,0,1,1,0.0%,4m
1447,3,IIIIIIIII,3805,0,0,1,1,0.0%,12m
1451,3,무적군이,3804,88,3,3,6,50.0%,6m
1451,3,[국방부사서병]피터팬,3804,0,3,3,6,50.0%,6m
1451,3,Jaxter,3804,0,0,1,1,0.0%,8m
1451,3,초코먹고,3804,0,0,1,1,0.0%,11m
1455,1,toph,3803,272,13,7,20,65.0%,8m
1455,3,gameman,3803,140,6,0,6,100.0%,11m
1455,3,sugo,3803,0,0,3,3,0.0%,12m
1458,3,[GIS]Recall,3802,147,8,8,16,50.0%,11m
1459,3,Drowsy,3801,1586,144,131,275,52.4%,9m
1459,3,TwilighT,3801,30,1,3,4,25.0%,9m
1461,3,KEKW,3799,697,34,24,58,58.6%,10m
1461,3,Fillipovic,3799,252,10,14,24,41.7%,6m
1461,3,IIIIIIIIIIII,3799,0,0,2,2,0.0%,7m
1464,3,王董,3798,245,9,13,22,40.9%,3m
1464,3,YuJeong,3798,0,0,1,1,0.0%,10m
1464,3,CooKor,3798,0,0,1,1,0.0%,5m
1467,2,[모노전투]가가각견,3797,472,19,19,38,50.0%,10m
1467,3,[IWYDI]NinetyFive,3797,60,3,3,6,50.0%,3m
1467,3,[페미니스트]IIIIIIIIIIII,3797,0,0,1,1,0.0%,4m
1467,3,llIIIlIllIlI,3797,0,0,1,1,0.0%,8m
1471,3,llllllllllll,3796,377,13,8,21,61.9%,6m
1472,2,[비트]SadJoker,3795,1445,135,145,280,48.2%,7m
1472,3,belief,3795,0,0,1,1,0.0%,6m
1474,3,얼짱컨트롤,3793,0,0,1,1,0.0%,3m
1474,3,Tyrant,3793,0,0,2,2,0.0%,5m
1476,3,ForGG,3792,309,16,7,23,69.6%,7m
1476,2,Fizz,3792,45,1,4,5,20.0%,3m
1478,3,ALLover,3791,1357,191,185,376,50.8%,5m
1478,3,llllllllllll,3791,86,3,4,7,42.9%,9m
1478,3,[達蘭]亞坦尼斯,3791,0,0,1,1,0.0%,10m
1481,2,[어둠순찰자]Minerva,3790,92,3,13,16,18.8%,11m
1481,3,[IWYDI]DreamWYD,3790,0,0,1,1,0.0%,5m
1481,3,[Eire]Nova,3790,0,0,1,1,0.0%,8m
1481,3,SIXpooler,3790,0,0,6,6,0.0%,11m
1485,1,AnnDemeule,3789,1606,277,284,561,49.4%,10m
1485,3,[PKERSe]안양꽁치,3789,982,36,38,74,48.6%,5m
1485,3,[TalenT]藍天,3789,352,24,28,52,46.2%,8m
1485,3,[비트]jun,3789,30,1,2,3,33.3%,9m
1485,3,이쪽이닷,3789,0,0,1,1,0.0%,8m
1490,2,여긴응디시티,3788,191,10,2,12,83.3%,10m
1490,2,Paniczerg,3788,128,3,9,12,25.0%,6m
1492,3,[ACGN]Atlas,3787,1449,94,97,191,49.2%,3m
1492,2,Real,3787,274,11,13,24,45.8%,8m
1494,3,TigerChili,3786,496,19,14,33,57.6%,7m
1494,3,TOHKA,3786,222,18,15,33,54.5%,3m
1494,3,llllllllllll,3786,0,0,1,1,0.0%,7m
1494,3,[순경3년차]중앙경찰학교,3786,0,0,1,1,0.0%,8m
1498,2,Millionaire,3785,265,13,3,16,81.2%,9m
1498,3,[BRSKR]Simplynick,3785,59,2,4,6,33.3%,5m
1498,3,[Gudr]Danberg,3785,0,1,0,1,100.0%,10m
1498,3,[NGameS]SoulKey,3785,0,0,1,1,0.0%,12m
1498,3,ayun,3785,0,0,1,1,0.0%,12m
1503,3,몽키,3784,30,2,1,3,66.7%,8m
1503,3,Sakiz,3784,30,1,1,2,50.0%,10m
1503,3,[KRSC2]SoftHyeoK,3784,0,0,1,1,0.0%,4m
1506,3,llllllllllll,3782,241,12,1,13,92.3%,6m
1506,3,[오영종플레이]오루비루스,3782,288,10,17,27,37.0%,11m
1506,3,[Rush]AeolianRush,3782,114,4,5,9,44.4%,11m
1509,2,낭만루시퍼,3781,88,4,10,14,28.6%,8m
1509,3,[국가정보원]테스토스테란,3781,30,3,6,9,33.3%,5m
1509,3,oSlReka,3781,0,1,1,2,50.0%,9m
1509,3,amoke,3781,0,0,2,2,0.0%,6m
1509,3,금충초,3781,0,0,2,2,0.0%,7m
1514,2,happypants,3780,1498,178,200,378,47.1%,6m
1514,3,[地獄拉麵]地獄使者,3780,330,13,4,17,76.5%,11m
1516,3,[무한오영종]드시우스케빈,3779,30,2,0,2,100.0%,12m
1516,2,[TeamNV]프로토스,3779,30,2,5,7,28.6%,8m
1516,3,[大嘉義啟社]HsinHong,3779,0,0,1,1,0.0%,6m
1516,3,노라조,3779,0,0,2,2,0.0%,7m
1520,3,[GITS]MaBaO,3777,86,3,7,10,30.0%,11m
1520,3,newtype,3777,0,1,1,2,50.0%,8m
1522,2,IIIIIIIIIIII,3776,1581,454,435,889,51.1%,7m
1522,3,dldldltla,3776,0,1,3,4,25.0%,7m
1524,3,[네임]ZawszeInLove,3775,670,24,30,54,44.4%,8m
1524,3,[겨울방어]백상아리청산가리,3775,0,0,1,1,0.0%,5m
1526,2,rooky,3774,1472,390,346,736,53.0%,4m
1527,2,monkeyan,3773,1485,277,277,554,50.0%,9m
1527,3,郭紹安,3773,88,4,3,7,57.1%,3m
1527,3,김지,3773,30,1,1,2,50.0%,6m
1527,3,llllllllllll,3773,30,1,2,3,33.3%,3m
1527,3,임포스터,3773,0,0,1,1,0.0%,8m
1532,3,Heavenly,3772,772,102,94,196,52.0%,4m
1532,3,[동방예의지국]IIIIIIIIlIII,3772,282,11,9,20,55.0%,5m
1532,3,제발바코드하지마,3772,216,7,12,19,36.8%,7m
1535,2,llllllllllll,3771,1293,124,128,252,49.2%,9m
1535,3,현자,3771,0,1,0,1,100.0%,3m
1535,3,아옳옳옳,3771,0,0,4,4,0.0%,7m
1538,3,[래더납치범]질럿킴,3770,0,1,0,1,100.0%,9m
1539,3,OnsaeMiro,3769,0,0,1,1,0.0%,8m
1540,3,IIIIIIIII,3768,457,33,36,69,47.8%,9m
1540,3,개코말코,3768,0,0,2,2,0.0%,9m
1542,3,llllllllllll,3767,212,11,2,13,84.6%,8m
1543,3,mdream,3766,674,42,47,89,47.2%,7m
1543,3,[SPTS]UmeMasterFu,3766,718,27,29,56,48.2%,9m
1545,3,[7052부활]대성욱,3765,0,1,0,1,100.0%,5m
1546,2,[이터널]기부왕,3764,293,35,44,79,44.3%,11m
1547,3,에이스,3763,0,0,3,3,0.0%,4m
1548,3,[비트]파브레가스,3762,470,18,14,32,56.2%,9m
1548,2,[李組長]Yamin,3762,458,14,22,36,38.9%,9m
1550,3,[이터널]나르는참새,3761,872,37,29,66,56.1%,4m
1550,3,saview,3761,30,2,1,3,66.7%,5m
1552,2,유샤멘,3760,489,23,17,40,57.5%,4m
1552,3,leo,3760,454,18,5,23,78.3%,5m
1552,3,RaEy,3760,116,5,1,6,83.3%,10m
1552,2,훌리건,3760,116,2,10,12,16.7%,10m
1552,3,낫투데이,3760,0,0,1,1,0.0%,7m
1552,3,Baron,3760,0,0,1,1,0.0%,9m
1558,3,[ELS]강아지왕국,3759,701,26,28,54,48.1%,5m
1558,3,운영넘어렵다,3759,217,17,9,26,65.4%,3m
1558,3,[인생무상]앰생,3759,212,8,11,19,42.1%,5m
1558,3,[선장이필요해]LastStar,3759,166,6,1,7,85.7%,6m
1562,2,Novice,3758,1263,45,53,98,45.9%,9m
1562,3,[군사정권]노태우,3758,246,14,3,17,82.4%,8m
1562,3,morning,3758,58,3,0,3,100.0%,5m
1562,3,[공략]아르타니스,3758,0,0,2,2,0.0%,8m
1566,3,[영앤리치]JinRyong,3757,1538,78,84,162,48.1%,7m
1566,3,[어윤수님개쩜]rhodes,3757,0,2,3,5,40.0%,9m
1568,3,[크리에이터]YouTuber,3756,830,34,26,60,56.7%,6m
1569,3,[시럽]Respect,3755,1156,60,52,112,53.6%,9m
1569,3,[d타짜b]고니,3755,858,36,35,71,50.7%,9m
1569,2,[Rush]Kirito,3755,180,6,12,18,33.3%,9m
1569,3,Claymore,3755,150,5,5,10,50.0%,3m
1569,3,이수빈넌내꺼야,3755,0,0,1,1,0.0%,9m
1574,3,ckaye,3754,1311,56,47,103,54.4%,11m
1574,3,Nelson,3754,1396,55,49,104,52.9%,5m
1576,3,[WDY]Merry,3752,344,13,11,24,54.2%,7m
1576,3,[Dopen]RoyaL,3752,118,4,8,12,33.3%,3m
1576,3,feichang,3752,0,0,1,1,0.0%,11m
1579,3,[GITS]老頭,3751,90,3,5,8,37.5%,8m
1580,3,april,3750,247,8,7,15,53.3%,6m
1581,3,NICECLAUP,3749,743,35,33,68,51.5%,5m
1581,3,불쌍맨,3749,562,24,13,37,64.9%,8m
1581,3,[일꾼]ProbE,3749,284,9,8,17,52.9%,5m
1581,3,Kkyu,3749,58,3,2,5,60.0%,5m
1581,3,[오소리]나루진,3749,0,1,2,3,33.3%,9m
1586,3,Auliterrrrr,3748,1213,52,51,103,50.5%,8m
1586,3,[遊戲暫停]被海小英雄,3748,0,1,0,1,100.0%,9m
1588,2,Premium,3747,142,4,0,4,100.0%,10m
1588,3,llllllllllll,3747,58,2,3,5,40.0%,5m
1588,3,IIIIIIIIIIII,3747,30,1,4,5,20.0%,5m
1588,3,Crows,3747,0,0,3,3,0.0%,9m
1592,3,마지막희망,3746,0,1,4,5,20.0%,4m
1593,3,SyndiKate,3745,836,36,21,57,63.2%,7m
1593,3,재백이,3745,135,4,2,6,66.7%,12m
1593,3,[Lotuz]짝부랄,3745,88,3,3,6,50.0%,6m
1593,3,YoungGooMan,3745,0,0,2,2,0.0%,11m
1597,3,[Ramone]doors,3744,1420,57,55,112,50.9%,11m
1597,3,[마구니]대미륵관심법궁예,3744,86,3,2,5,60.0%,5m
1597,3,HeuNg,3744,30,1,2,3,33.3%,7m
1597,3,[StarC]LEO,3744,30,1,2,3,33.3%,5m
1597,3,Sealand,3744,30,1,2,3,33.3%,6m
1602,2,Bell,3743,758,26,35,61,42.6%,9m
1603,2,maumau,3742,1503,166,190,356,46.6%,9m
1603,3,인페르보라토,3742,339,20,18,38,52.6%,4m
1605,3,파워,3741,476,39,29,68,57.4%,5m
1605,3,IlIllIIlIIll,3741,341,18,10,28,64.3%,9m
1605,3,곰돌이하니허니,3741,252,9,9,18,50.0%,5m
1605,3,Rechange,3741,86,3,1,4,75.0%,9m
1609,3,KillTime,3740,1559,96,93,189,50.8%,3m
1609,3,쿠로사키이치고,3740,998,41,32,73,56.2%,6m
1609,3,jack,3740,0,1,0,1,100.0%,8m
1612,3,[트수Crew]Fascinable,3739,90,4,4,8,50.0%,8m
1612,3,Jebe,3739,0,1,0,1,100.0%,9m
1614,3,AweSome,3738,1174,44,42,86,51.2%,5m
1614,3,[얼라이브]히읗히읗,3738,60,3,3,6,50.0%,8m
1614,1,[앙기모링]헬카이저료,3738,91,2,4,6,33.3%,4m
1617,2,llllllllllll,3737,1511,252,261,513,49.1%,10m
1617,3,lIlIlIIlIlII,3737,0,0,1,1,0.0%,4m
1619,3,[FSL]Pantalaimon,3736,142,8,0,8,100.0%,9m
1619,3,虛無飄渺,3736,143,5,1,6,83.3%,9m
1619,3,ALKA,3736,0,1,0,1,100.0%,8m
1622,3,chan,3735,116,5,5,10,50.0%,7m
1622,3,fisher,3735,0,0,3,3,0.0%,3m
1624,3,[쿡더디자인]훈창원,3734,1529,186,179,365,51.0%,12m
1624,3,westside,3734,60,2,3,5,40.0%,11m
1624,3,TopPlus,3734,0,0,1,1,0.0%,6m
1624,3,기백,3734,0,0,2,2,0.0%,3m
1628,2,[무한오영종]루삥뽕,3733,1305,117,123,240,48.8%,10m
1628,3,Rebirth,3733,165,7,5,12,58.3%,5m
1628,3,Inovation,3733,0,4,1,5,80.0%,9m
1628,3,AbovOrdinary,3733,124,4,8,12,33.3%,8m
1632,3,242967641893,3732,10,2,6,8,25.0%,3m
1633,2,Magneto,3731,1534,444,455,899,49.4%,9m
1633,3,대가원,3731,832,32,33,65,49.2%,4m
1635,3,IIIIIIIIIIII,3730,244,9,1,10,90.0%,6m
1635,3,[살피마리]질럿,3730,0,1,3,4,25.0%,12m
1637,3,용팔,3729,470,17,19,36,47.2%,9m
1637,1,仙履奇緣,3729,0,1,0,1,100.0%,43m
1637,3,SOlar,3729,0,1,1,2,50.0%,12m
1637,3,[TalenT]家可可,3729,0,0,1,1,0.0%,5m
1637,3,lllllllllIIl,3729,0,0,2,2,0.0%,6m
1642,2,ballyFoX,3728,560,70,88,158,44.3%,9m
1642,3,IlIIlIIlIIl,3728,252,9,9,18,50.0%,4m
1642,3,지는게이기는것,3728,0,0,1,1,0.0%,5m
1645,3,허접,3727,256,10,8,18,55.6%,4m
1645,3,맹독맹독,3727,86,3,4,7,42.9%,4m
1647,2,darkReunion,3726,1571,216,211,427,50.6%,11m
1647,2,[KRSC2]안녕하세요,3726,344,10,20,30,33.3%,7m
1647,3,DarkShadow,3726,0,1,0,1,100.0%,12m
1650,3,Roger,3725,544,25,16,41,61.0%,9m
1650,3,주동우,3725,62,3,5,8,37.5%,5m
1650,3,kachew,3725,0,0,1,1,0.0%,9m
1653,3,AkiHata,3723,1610,547,530,1077,50.8%,8m
1653,3,KatasNiGleg,3723,931,36,28,64,56.2%,7m
1653,3,HITMAN,3723,290,12,4,16,75.0%,3m
1653,3,너문제인성있어,3723,255,8,11,19,42.1%,6m
1653,3,[아프리카청춘]뾱뾱이,3723,0,0,1,1,0.0%,8m
1658,3,IllllIlllllI,3722,114,8,8,16,50.0%,4m
1658,3,지나가는아베요,3722,58,2,4,6,33.3%,11m
1658,3,아니하,3722,0,0,2,2,0.0%,6m
1661,3,[ANGG]JJUKKUMI,3721,1520,267,240,507,52.7%,11m
1661,3,Suzy,3721,60,3,6,9,33.3%,5m
1661,3,Gatsby,3721,30,1,1,2,50.0%,9m
1664,2,RvnJiRuParK,3720,1005,68,73,141,48.2%,9m
1664,3,[삼국시대]러브썸,3720,509,40,26,66,60.6%,8m
1666,3,Anf,3719,1560,245,232,477,51.4%,9m
1666,3,[인투더]IntoTheNote,3719,612,21,29,50,42.0%,5m
1666,3,[Mist]stickgolem,3719,172,6,6,12,50.0%,3m
1666,3,Houkes,3719,0,4,2,6,66.7%,8m
1666,3,彭德怀,3719,58,3,6,9,33.3%,6m
1666,3,[과갈라]gwal,3719,0,1,0,1,100.0%,9m
1672,3,沉梅,3718,0,0,2,2,0.0%,8m
1673,3,Kjpeans,3717,524,23,4,27,85.2%,11m
1673,3,김밥몬,3717,0,1,0,1,100.0%,7m
1673,3,JerryYu,3717,0,1,0,1,100.0%,11m
1673,3,버스,3717,0,0,1,1,0.0%,8m
1677,3,shiMnn,3716,302,12,9,21,57.1%,6m
1677,3,[ELS]누가봐도소리니,3716,358,11,16,27,40.7%,7m
1677,3,KOLIN,3716,75,4,4,8,50.0%,9m
1677,3,플랑,3716,0,0,1,1,0.0%,3m
1681,2,[랜덤한테왜짐]integralidi,3715,1056,39,55,94,41.5%,10m
1681,2,[IWYDI]乂肚皮乂,3715,129,5,9,14,35.7%,9m
1683,3,그마찍었던사람,3714,58,3,3,6,50.0%,8m
1684,3,마테다,3713,1575,201,191,392,51.3%,8m
1684,3,llllllllllll,3713,484,23,13,36,63.9%,8m
1684,3,Papapanda,3713,172,6,5,11,54.5%,5m
1684,3,[만살롱]호오이,3713,0,1,0,1,100.0%,8m
1688,3,windyprotoss,3712,0,1,1,2,50.0%,8m
1689,3,[Ato]맨날짐,3711,248,12,3,15,80.0%,8m
1689,3,[민초당근]토끼,3711,0,0,1,1,0.0%,5m
1691,3,참치야,3710,851,178,163,341,52.2%,5m
1691,3,農會理事長,3710,1479,66,63,129,51.2%,8m
1691,2,[med]CasaiiiNova,3710,856,32,35,67,47.8%,11m
1691,3,llllllllllll,3710,343,14,7,21,66.7%,9m
1691,3,[SC2HK]DogFight,3710,0,1,0,1,100.0%,11m
1691,3,IIIIllllIIll,3710,0,1,0,1,100.0%,12m
1691,3,Infestor,3710,0,0,1,1,0.0%,5m
1691,3,고따먹,3710,0,0,2,2,0.0%,6m
1691,3,칸케르,3710,0,0,4,4,0.0%,8m
1700,2,왕승균,3709,1548,861,864,1725,49.9%,3m
1700,2,TAPEt,3709,1044,69,71,140,49.3%,10m
1700,3,몬스터킬러,3709,0,0,1,1,0.0%,11m
1700,3,teddybear,3709,0,0,4,4,0.0%,5m
1704,1,[은하]TaeGi,3708,0,0,3,3,0.0%,44m
1705,3,kyoh,3707,388,18,18,36,50.0%,5m
1705,3,[혼또니]EasyZerg,3707,174,7,4,11,63.6%,5m
1707,3,[Lotuz]ERP,3706,1548,106,101,207,51.2%,5m
1708,3,[異界的檢察官]我討厭韓國和狗,3705,761,29,28,57,50.9%,6m
1708,3,[Old]HappyLucky,3705,58,2,2,4,50.0%,5m
1708,3,swed,3705,95,1,4,5,20.0%,5m
1711,2,DynamicGiMiL,3704,1482,273,272,545,50.1%,6m
1711,3,[oki]아이고의미없다,3704,313,23,17,40,57.5%,5m
1711,2,llllllllllll,3704,250,11,5,16,68.8%,9m
1711,3,HowDareYou,3704,0,0,2,2,0.0%,9m
1715,3,Summer,3703,166,6,2,8,75.0%,11m
1715,1,llllllllllll,3703,0,1,0,1,100.0%,11m
1715,3,llllllllllll,3703,0,1,2,3,33.3%,3m
1718,2,eViLr,3702,1470,129,143,272,47.4%,6m
1718,3,목포,3702,1019,60,51,111,54.1%,5m
1718,3,Jean,3702,142,8,1,9,88.9%,10m
1718,3,녕녕이,3702,0,1,0,1,100.0%,7m
1718,3,청소년이용불가,3702,0,0,2,2,0.0%,11m
1723,3,Unknown,3701,58,2,3,5,40.0%,7m
1723,3,[Tsuper]백원국,3701,0,0,1,1,0.0%,11m
1725,3,[애니멀킹덤]강아지왕국,3700,457,16,15,31,51.6%,3m
1726,3,[백수딱]의무병,3699,30,2,6,8,25.0%,6m
1726,3,천년묵은구미호,3699,0,1,0,1,100.0%,12m
1728,2,[한타왕]담배한모금,3698,519,56,65,121,46.3%,12m
1729,3,JYPassion,3697,1477,69,75,144,47.9%,5m
1729,3,[무한오영종]카텐자,3697,498,22,14,36,61.1%,4m
1729,3,Quaaaq,3697,86,3,3,6,50.0%,5m
1729,3,[明日方舟]MihoLN,3697,0,0,1,1,0.0%,11m
1733,3,LaDiDa,3696,1147,80,39,119,67.2%,12m
1733,3,Devilelf,3696,380,15,18,33,45.5%,11m
1733,3,DrainNestea,3696,0,0,1,1,0.0%,8m
1736,3,여고생,3695,951,65,58,123,52.8%,6m
1736,1,정글링,3695,378,16,7,23,69.6%,8m
1738,2,[확장파]뿌찌빵,3694,142,5,6,11,45.5%,4m
1738,1,Harenix,3694,226,5,8,13,38.5%,9m
1740,2,[NerfZg]Aguero,3693,1431,147,144,291,50.5%,10m
1740,3,Christino,3693,412,30,14,44,68.2%,8m
1740,3,llllllllllll,3693,0,0,1,1,0.0%,12m
1743,3,눈사이먼도미,3692,462,62,50,112,55.4%,8m
1743,3,[縱貫線]Yuhung,3692,638,24,19,43,55.8%,3m
1743,3,[GIS]RichBear,3692,589,22,29,51,43.1%,5m
1743,3,[xTMDx]把球傳給誰,3692,60,2,2,4,50.0%,3m
1743,3,[S급용병]아들,3692,0,2,3,5,40.0%,12m
1743,3,WhiteCat,3692,0,0,1,1,0.0%,12m
1749,3,[Att]搖滾客,3691,0,0,1,1,0.0%,8m
1749,3,[APM28]kirito,3691,0,0,1,1,0.0%,9m
1751,2,망나녕,3690,992,45,50,95,47.4%,9m
1751,3,hotdog,3690,0,0,1,1,0.0%,11m
1751,3,TerATo,3690,0,0,1,1,0.0%,4m
1754,3,llllllllllll,3689,1574,68,51,119,57.1%,6m
1754,3,小涛歌,3689,909,42,26,68,61.8%,8m
1756,1,Easy,3688,119,7,0,7,100.0%,44m
1756,3,Special,3688,0,0,1,1,0.0%,8m
1758,3,iiiiiiiiii,3687,1474,258,261,519,49.7%,12m
1758,1,[Blacer]LeMahaaadeel,3687,204,11,6,17,64.7%,10m
1758,1,원탑저그김세랄,3687,120,6,1,7,85.7%,44m
1758,3,SOS,3687,146,6,2,8,75.0%,5m
1758,3,[네오]보고배워라,3687,128,5,15,20,25.0%,7m
1758,3,[CrewGP]반짝이,3687,30,1,2,3,33.3%,9m
1758,3,[SC2IB]CoreValues,3687,30,1,4,5,20.0%,11m
1765,3,[Rush]MeTeor,3686,543,34,30,64,53.1%,4m
1765,3,[CranKy]Aires,3686,656,24,29,53,45.3%,5m
1765,3,IIIIIIIIIII,3686,30,1,2,3,33.3%,9m
1765,3,IIIIIIIIIIII,3686,0,0,7,7,0.0%,6m
1769,3,소리없는유오성,3685,434,16,7,23,69.6%,6m
1769,3,RIP,3685,210,7,8,15,46.7%,11m
1771,1,AresRabbit,3684,470,19,5,24,79.2%,11m
1772,3,으악디졋으,3683,192,7,5,12,58.3%,8m
1772,3,로켓포병,3683,116,5,2,7,71.4%,6m
1772,3,Zenith,3683,0,1,1,2,50.0%,8m
1775,3,[사냥꾼]동족전안하는땅크,3680,840,30,31,61,49.2%,3m
1776,3,코이,3679,1353,57,44,101,56.4%,5m
1776,3,BLlZZARD,3679,0,1,0,1,100.0%,7m
1778,3,[教我合作]卑彌呼,3678,1163,50,42,92,54.3%,12m
1778,3,노숙자,3678,608,27,15,42,64.3%,3m
1780,3,입그마에열,3677,86,3,3,6,50.0%,11m
1780,3,형사변호사,3677,0,0,2,2,0.0%,8m
1782,3,lawmaker,3676,731,30,24,54,55.6%,7m
1782,3,chololate,3676,434,24,9,33,72.7%,9m
1782,3,SophiA,3676,0,0,1,1,0.0%,3m
1782,3,土豆仁,3676,0,0,2,2,0.0%,8m
1786,3,Terran,3675,466,21,14,35,60.0%,6m
1787,3,Dunbar,3674,1099,49,38,87,56.3%,6m
1787,3,[SkAL]GeneralJones,3674,316,11,16,27,40.7%,8m
1787,3,Dissa,3674,95,1,3,4,25.0%,6m
1787,3,[백수들]이방원,3674,0,0,1,1,0.0%,9m
1787,3,[DagmBa]송지은,3674,0,0,1,1,0.0%,5m
1787,3,[어윤수님개쩜]IIIIIIIIIIII,3674,0,0,7,7,0.0%,6m
1793,3,LIFESHOCK,3673,1511,101,89,190,53.2%,12m
1793,3,llllllllllll,3673,0,1,0,1,100.0%,5m
1793,3,[NDW]Xier,3673,0,1,1,2,50.0%,8m
1796,3,GwANgRaN,3672,114,5,5,10,50.0%,12m
1796,3,YellowDog,3672,114,4,4,8,50.0%,6m
1796,3,llllllllllll,3672,30,2,0,2,100.0%,6m
1799,2,llllllllllll,3670,1383,178,172,350,50.9%,9m
1800,3,Olivia,3669,766,27,32,59,45.8%,8m
1800,3,[ZheJia]longbeya,3669,442,17,13,30,56.7%,8m
1800,3,llIIlllIIlll,3669,60,3,3,6,50.0%,8m
1803,3,Mercury,3668,167,9,2,11,81.8%,6m
1803,3,jochi,3668,0,5,0,5,100.0%,5m
1803,3,도토리,3668,92,4,7,11,36.4%,8m
1806,3,Zarvar,3667,146,5,4,9,55.6%,5m
1806,3,[SpM]Smile,3667,88,3,8,11,27.3%,9m
1806,3,이카루스,3667,0,0,2,2,0.0%,6m
1809,3,구출,3666,0,0,1,1,0.0%,9m
1810,3,lemonardo,3665,476,17,18,35,48.6%,8m
1810,3,llllllllllll,3665,191,6,8,14,42.9%,5m
1812,3,[스카이파이터]dullboy,3664,1506,203,209,412,49.3%,9m
1812,3,[절대악]맹독충,3664,288,14,5,19,73.7%,12m
1812,3,[이터널]Pinkkiwi,3664,0,0,1,1,0.0%,9m
1815,3,Jaesung,3663,1444,88,80,168,52.4%,5m
1816,3,[영앤리치]Puglin,3662,0,1,4,5,20.0%,12m
1817,2,jirohsu,3661,1153,160,158,318,50.3%,6m
1817,3,wacko,3661,1477,81,79,160,50.6%,5m
1817,3,[Fu]JJpiano,3661,86,3,1,4,75.0%,5m
1817,3,Bingha,3661,80,3,1,4,75.0%,5m
1817,3,MVPLegend,3661,0,1,0,1,100.0%,6m
1822,2,RiskTaker,3660,1398,101,81,182,55.5%,10m
1822,3,SKungK,3660,498,19,17,36,52.8%,5m
1822,3,vicO,3660,30,2,0,2,100.0%,4m
1825,3,Joee,3659,1011,41,33,74,55.4%,6m
1826,3,llllllllllll,3658,1563,77,37,114,67.5%,11m
1826,2,계란,3658,239,9,2,11,81.8%,9m
1826,3,[플토쌉극혐]lIlIlIl,3658,30,1,6,7,14.3%,8m
1829,3,[친클]EIOrZr,3657,1558,95,92,187,50.8%,5m
1829,3,Fly,3657,88,4,3,7,57.1%,8m
1829,3,[IRS]showmetheway,3657,30,2,0,2,100.0%,4m
1829,3,自由戰士,3657,60,2,4,6,33.3%,5m
1833,3,Coldplay,3656,623,23,20,43,53.5%,6m
1834,3,[청하]베지타,3655,455,18,13,31,58.1%,5m
1834,3,San,3655,146,5,7,12,41.7%,8m
1834,3,[DearS]HumbleD,3655,0,0,1,1,0.0%,5m
1834,2,Felix,3655,0,0,1,1,0.0%,9m
1838,3,llllllllllll,3654,1241,82,83,165,49.7%,9m
1838,3,크레이지도그,3654,548,23,15,38,60.5%,3m
1838,3,[RESCUE]모노쿠마,3654,140,6,4,10,60.0%,12m
1841,3,llllllllll,3653,1521,1255,1243,2498,50.2%,6m
1841,3,[SofT]ENE,3653,872,32,32,64,50.0%,5m
1841,3,Value,3653,603,30,36,66,45.5%,6m
1841,3,HyeonWoo,3653,414,15,25,40,37.5%,6m
1841,3,MBCgame,3653,30,1,1,2,50.0%,6m
1841,3,Emptiness,3653,0,0,1,1,0.0%,5m
1841,3,TireMiLun,3653,0,0,3,3,0.0%,8m
1848,3,Lyon,3652,30,2,3,5,40.0%,9m
1849,3,JayScarLeT,3650,166,6,6,12,50.0%,5m
1849,3,llllllll,3650,114,4,2,6,66.7%,12m
1849,3,암흑게이기사,3650,58,3,2,5,60.0%,9m
1849,3,[흐긴]용산고마틴루터킹,3650,30,2,9,11,18.2%,6m
1853,3,Carol,3649,456,18,15,33,54.5%,8m
1853,3,일베충,3649,60,3,3,6,50.0%,3m
1855,3,jolly,3648,1525,146,150,296,49.3%,9m
1855,3,iiiiiiiiiiii,3648,270,9,14,23,39.1%,4m
1855,3,[Dopen]공대오지마,3648,0,1,0,1,100.0%,8m
1858,3,[독도비둘기]DoKdoGuarDKR,3647,0,0,1,1,0.0%,3m
1858,3,ilhjw,3647,0,0,1,1,0.0%,6m
1860,3,lllllllll,3646,184,6,14,20,30.0%,12m
1860,3,끄야아앍,3646,0,3,2,5,60.0%,6m
1860,3,[CStorM]SOEASY,3646,0,0,1,1,0.0%,3m
1860,3,정글갈게요,3646,0,0,1,1,0.0%,12m
1864,3,[일반인원탑]내래한마디하갔어,3645,120,6,8,14,42.9%,8m
1864,3,WhiteRock,3645,0,0,2,2,0.0%,7m
1866,3,MrCasanova,3644,140,6,3,9,66.7%,9m
1866,3,찬란한풀,3644,88,6,6,12,50.0%,11m
1866,3,[偷家狗]ArchiTectWYD,3644,0,0,1,1,0.0%,5m
1869,3,[ELS]테스형,3643,306,12,14,26,46.2%,3m
1869,3,llllllllllll,3643,263,8,4,12,66.7%,4m
1869,1,[오리단]JiWon,3643,0,1,0,1,100.0%,11m
1872,3,Soma,3642,995,38,30,68,55.9%,8m
1872,3,바이올린,3642,650,25,17,42,59.5%,9m
1874,3,daniel,3641,202,8,6,14,57.1%,5m
1874,3,[NsP]Serral,3641,162,8,19,27,29.6%,5m
1874,3,YellowFox,3641,96,6,0,6,100.0%,6m
1874,2,NaViSlaViK,3641,0,1,0,1,100.0%,45m
1874,3,tyson,3641,0,1,2,3,33.3%,7m
1874,3,이모티콘으로대화,3641,0,0,1,1,0.0%,8m
1874,3,테니스,3641,0,0,2,2,0.0%,11m
1881,3,인카,3640,1555,117,94,211,55.5%,5m
1881,3,LKnature,3640,30,2,0,2,100.0%,8m
1883,3,[기윤짱빵]호랑이기윤이쑥쑥,3639,0,0,1,1,0.0%,7m
1883,3,SoGoGi,3639,0,0,4,4,0.0%,9m
1883,3,[도담이]하이메이,3639,0,0,7,7,0.0%,12m
1886,2,JUNE,3638,1432,57,62,119,47.9%,5m
1886,3,Liberty,3638,504,18,17,35,51.4%,4m
1886,3,llllllllllll,3638,0,0,1,1,0.0%,3m
1889,3,[Mist]TAKAZAWA,3637,399,18,13,31,58.1%,7m
1889,3,llllllllllll,3637,30,1,2,3,33.3%,8m
1889,3,白澤,3637,0,0,1,1,0.0%,3m
1892,2,문재인,3636,1554,268,288,556,48.2%,4m
1892,3,ssanda,3636,834,62,27,89,69.7%,9m
1892,3,ctarsraft,3636,572,22,18,40,55.0%,4m
1892,2,llllllllllll,3636,442,17,32,49,34.7%,6m
1892,3,[국가정보원]Fudpdp,3636,0,1,1,2,50.0%,7m
1892,3,QRC,3636,0,0,2,2,0.0%,8m
1892,3,[Lotuz]엠빼롱,3636,0,0,2,2,0.0%,3m
1892,3,llllllllllll,3636,0,0,2,2,0.0%,9m
1900,3,Amp,3635,850,32,32,64,50.0%,5m
1900,3,Daka,3635,552,21,20,41,51.2%,4m
1900,3,[무한오영종]lIlIlIlIlIlI,3635,90,4,3,7,57.1%,4m
1900,3,IntereStinG,3635,30,2,2,4,50.0%,9m
1900,3,[Shield]Kruskal,3635,0,0,1,1,0.0%,5m
1900,3,파란,3635,0,0,2,2,0.0%,8m
1906,3,박코드아이디,3634,1531,216,203,419,51.6%,8m
1906,3,[최희]쿠센이,3634,1209,92,65,157,58.6%,8m
1906,3,IllIllllll,3634,0,1,0,1,100.0%,5m
1906,3,llllllllllll,3634,0,1,0,1,100.0%,11m
1910,2,Leviathan,3633,373,18,16,34,52.9%,4m
1910,2,新資料夾,3633,140,12,5,17,70.6%,3m
1910,2,hoNey,3633,225,11,6,17,64.7%,9m
1913,3,래지,3632,1407,286,259,545,52.5%,9m
1913,3,[래더납치범]Maru,3632,1476,74,67,141,52.5%,6m
1913,3,딥마인드,3632,0,1,3,4,25.0%,12m
1916,3,키보드워리어,3631,257,9,3,12,75.0%,6m
1916,3,모루,3631,144,5,9,14,35.7%,4m
1918,3,[뱅치프레스]아바타,3630,1506,99,100,199,49.7%,8m
1918,3,복권맨,3630,88,4,1,5,80.0%,5m
1918,3,cudag,3630,98,3,18,21,14.3%,4m
1918,3,도원호,3630,0,0,1,1,0.0%,6m
1922,2,Cybergames,3629,1263,56,83,139,40.3%,11m
1922,3,Sol,3629,0,1,0,1,100.0%,3m
1924,3,StEzekiel,3628,1528,74,58,132,56.1%,3m
1924,3,april,3628,729,29,28,57,50.9%,4m
1924,3,야훼,3628,0,0,1,1,0.0%,9m
1927,3,[SC2HK]ZeroWhite,3627,1432,75,63,138,54.3%,11m
1927,3,ZetaRage,3627,0,1,0,1,100.0%,9m
1927,3,MaxiBane,3627,0,0,1,1,0.0%,6m
1930,3,라잉토,3626,1561,136,113,249,54.6%,6m
1930,3,llllllllllll,3626,1521,105,110,215,48.8%,3m
1932,2,[꿀잼]rfrf,3625,805,46,53,99,46.5%,9m
1932,3,Veritas,3625,38,2,6,8,25.0%,5m
1934,3,[secrct]快得跟鬼一樣狐狸,3624,0,1,0,1,100.0%,6m
1934,3,[SoDa]iceSoDa,3624,0,0,1,1,0.0%,8m
1936,3,llllllllllll,3623,671,36,20,56,64.3%,9m
1936,3,BigDickEddy,3623,798,30,32,62,48.4%,5m
1936,3,Thyme,3623,0,0,2,2,0.0%,9m
1939,3,llllllllllll,3622,753,33,20,53,62.3%,9m
1939,3,[릴리]Antares,3622,208,7,15,22,31.8%,6m
1939,3,[彩虹]갓동자,3622,0,1,0,1,100.0%,12m
1939,3,llllllllllll,3622,0,1,1,2,50.0%,5m
1939,3,스닥,3622,30,1,3,4,25.0%,7m
1944,3,llllllllllll,3621,279,13,6,19,68.4%,12m
1944,3,grimZ,3621,196,9,10,19,47.4%,11m
1944,3,mYYa,3621,60,2,3,5,40.0%,7m
1947,3,그녕이,3620,30,1,3,4,25.0%,12m
1948,3,Sanguinario,3619,114,4,4,8,50.0%,4m
1948,3,군번줄,3619,0,0,1,1,0.0%,8m
1950,3,BabyRage,3618,1036,395,373,768,51.4%,6m
1950,3,[CIM]와기,3618,592,21,20,41,51.2%,6m
1950,3,admiration,3618,30,2,1,3,66.7%,5m
1953,3,MINHTHUHAI,3617,669,33,19,52,63.5%,8m
1953,3,BlueFang,3617,0,1,0,1,100.0%,9m
1953,3,뽀래팅이,3617,0,1,0,1,100.0%,8m
1953,3,주인공,3617,30,1,1,2,50.0%,3m
1953,2,[인투더]IntoTheNero,3617,0,0,1,1,0.0%,5m
1958,2,예림이그패봐봐,3616,1400,361,371,732,49.3%,5m
1958,3,솜사탕구름,3616,332,13,10,23,56.5%,8m
1958,3,[Ato]착한눈사람,3616,116,6,1,7,85.7%,11m
1958,3,트코얌,3616,30,2,4,6,33.3%,5m
1958,3,[NsP]Laonzena,3616,0,1,1,2,50.0%,7m
1963,3,Ordin,3615,362,18,8,26,69.2%,5m
1964,3,[false9]DAYBREAK,3614,58,2,15,17,11.8%,4m
1964,3,panda,3614,0,0,2,2,0.0%,3m
1966,3,행주,3613,1209,52,59,111,46.8%,12m
1966,3,NeoN,3613,314,15,9,24,62.5%,6m
1966,3,[로켓배송]쿠팡,3613,58,3,2,5,60.0%,5m
1966,3,Rain,3613,60,2,2,4,50.0%,7m
1966,3,특수경찰,3613,0,1,4,5,20.0%,11m
1966,3,Rahwinia,3613,0,0,5,5,0.0%,7m
1972,2,IIIIIIIIIIII,3612,1556,818,826,1644,49.8%,9m
1972,3,HideOnBush,3612,0,1,0,1,100.0%,4m
1972,3,[KH258]米分舌甘,3612,0,0,1,1,0.0%,9m
1975,3,zifibac,3611,804,31,28,59,52.5%,11m
1975,3,쇠돌옹,3611,86,4,0,4,100.0%,12m
1975,3,[필승해군]HongKongFree,3611,0,1,0,1,100.0%,7m
1978,3,Gate,3610,816,41,37,78,52.6%,5m
1978,3,IllllIlIlIlI,3610,908,33,36,69,47.8%,9m
1978,3,IIIIIIIIIlII,3610,30,1,2,3,33.3%,11m
1978,3,똥을먹는다,3610,38,1,2,3,33.3%,9m
1978,3,[짜다국이]Staystar,3610,0,1,3,4,25.0%,6m
1983,3,금강불괴,3608,288,11,10,21,52.4%,3m
1983,1,llllllllllll,3608,168,4,2,6,66.7%,44m
1983,1,버틸수가없다,3608,121,3,5,8,37.5%,11m
1983,3,[DVS]拿不到首勝的雷恩,3608,86,3,6,9,33.3%,8m
1983,3,[겨울방어]저그야캐요,3608,60,2,7,9,22.2%,5m
1983,3,IloveU,3608,0,1,3,4,25.0%,9m
1983,3,콩밥,3608,0,0,1,1,0.0%,5m
1990,3,재권씨,3607,674,61,36,97,62.9%,8m
1990,3,김또이,3607,899,34,26,60,56.7%,12m
1992,1,[인생은실전]마스터리거,3606,119,3,4,7,42.9%,44m
1992,3,[Rovic]태양,3606,0,1,0,1,100.0%,8m
1992,3,[PRICE]IIIIIIIIIIII,3606,30,1,2,3,33.3%,9m
1992,3,llllllllllll,3606,30,1,2,3,33.3%,9m
1996,3,아이디아이,3605,30,5,3,8,62.5%,12m
1996,3,마초킹,3605,0,1,0,1,100.0%,6m
1996,3,곰돌이허니,3605,30,1,1,2,50.0%,9m
1996,3,llIIlIllIllI,3605,0,0,3,3,0.0%,3m
1996,3,GDA,3605,0,0,6,6,0.0%,7m
2001,3,이백,3604,1401,94,85,179,52.5%,3m
2001,3,Daniel,3604,922,32,40,72,44.4%,4m
2001,3,파이리,3604,207,11,5,16,68.8%,12m
2004,3,Gerapt,3603,1517,240,235,475,50.5%,4m
2004,2,[도살장]DefeaTdayZ,3603,287,11,4,15,73.3%,9m
2004,3,[xGenGx]OneBaseThor,3603,211,7,1,8,87.5%,11m
2007,3,BoyNextDoor,3602,135,5,6,11,45.5%,3m
2007,3,[ladys]코구르박,3602,0,0,1,1,0.0%,6m
2007,3,lllIIIlll,3602,0,0,1,1,0.0%,3m
2007,3,PCE,3602,0,0,2,2,0.0%,5m
2011,3,츄칠라,3601,140,14,23,37,37.8%,4m
2011,2,undyinglove,3601,0,4,1,5,80.0%,45m
2011,3,[Dopen]라르고,3601,90,3,9,12,25.0%,5m
2011,3,Yeonsu,3601,0,1,0,1,100.0%,5m
2011,1,빵빵레파,3601,48,1,4,5,20.0%,43m
2016,3,수색짬,3600,1552,75,73,148,50.7%,5m
2016,3,IIIIIIIIIIII,3600,0,3,2,5,60.0%,11m
2018,3,[경기도민]돼지세끼,3599,866,217,166,383,56.7%,7m
2018,3,vssd,3599,811,47,34,81,58.0%,12m
2018,3,nettiger,3599,996,37,39,76,48.7%,8m
2018,3,kdh,3599,408,16,13,29,55.2%,12m
2018,3,[怕死的死神]米米米,3599,0,0,1,1,0.0%,5m
2023,3,[Neat]FoTh,3598,410,16,16,32,50.0%,3m
2023,3,chinavirus,3598,226,9,6,15,60.0%,5m
2023,3,[IWB]lmg,3598,58,2,2,4,50.0%,8m
2023,3,[Ato]수웅늉,3598,0,0,1,1,0.0%,3m
2023,3,llllllllllll,3598,0,0,1,1,0.0%,12m
2028,3,Millionaire,3597,877,49,50,99,49.5%,9m
2028,3,drakebird,3597,403,21,11,32,65.6%,5m
2030,3,KevinRush,3596,735,47,39,86,54.7%,6m
2030,2,[대단하시네]PureIceDream,3596,200,5,3,8,62.5%,5m
2030,2,FlamingTrash,3596,96,3,1,4,75.0%,46m
2030,3,kimnoir,3596,0,1,6,7,14.3%,8m
2034,3,[NGameS]DozerO,3595,210,8,9,17,47.1%,5m
2034,3,JyO,3595,0,1,1,2,50.0%,11m
2034,3,백승호,3595,0,1,1,2,50.0%,3m
2034,3,llllllllllll,3595,97,1,4,5,20.0%,10m
2034,3,DUNHILL,3595,0,0,6,6,0.0%,11m
2039,3,Mengju,3594,58,2,4,6,33.3%,8m
2039,1,레전드,3594,48,2,4,6,33.3%,44m
2039,3,대중무현크로스,3594,30,1,3,4,25.0%,11m
2042,3,[트수Crew]테사기프징징,3593,798,39,37,76,51.3%,5m
2042,3,[YONSEI]하등한문과,3593,116,4,9,13,30.8%,6m
2042,3,revolution,3593,30,2,5,7,28.6%,5m
2042,3,zxzx,3593,0,1,0,1,100.0%,6m
2046,3,flksdjgdsklg,3592,0,1,0,1,100.0%,8m
2047,3,此名稱無法更改,3591,172,7,5,12,58.3%,5m
2048,3,프로스트,3590,446,27,18,45,60.0%,8m
2048,3,我栖息的夏天,3590,30,2,3,5,40.0%,4m
2050,3,ufc,3589,701,72,71,143,50.3%,8m
2050,3,Darwin,3589,1140,50,35,85,58.8%,5m
2050,3,IIIIIIIIIIII,3589,1108,45,40,85,52.9%,3m
2050,3,HacKBomB,3589,262,12,8,20,60.0%,9m
2050,3,Ceraldor,3589,0,3,2,5,60.0%,6m
2050,3,SplinterS,3589,0,0,2,2,0.0%,11m
2050,3,MEANCO,3589,0,0,3,3,0.0%,9m
2057,3,[쇼부충]llllllllllll,3588,720,34,27,61,55.7%,5m
2057,3,Edwin,3588,166,7,4,11,63.6%,9m
2057,3,스투똥망겜,3588,0,1,0,1,100.0%,3m
2057,3,우주최강,3588,0,0,1,1,0.0%,8m
2057,3,[옹선생님]Hydra,3588,0,0,1,1,0.0%,5m
2062,3,[我想玩蟲族]太陽神拉,3587,845,55,54,109,50.5%,5m
2062,3,IIIllIllIIll,3587,1138,42,46,88,47.7%,9m
2062,3,Flash,3587,90,4,4,8,50.0%,6m
2062,3,[D3StaR]AnThoNyDaVis,3587,0,2,0,2,100.0%,12m
2062,3,StarXRaft,3587,30,1,6,7,14.3%,12m
2067,3,델람,3586,498,20,13,33,60.6%,9m
2067,3,울트라끄뜨기,3586,0,1,0,1,100.0%,9m
2067,3,StorM,3586,30,1,2,3,33.3%,5m
2070,3,傲血峰,3585,344,17,8,25,68.0%,6m
2070,3,[래더납치범]악마,3585,114,5,3,8,62.5%,8m
2070,3,[IWYD2I]肥蛹菌,3585,86,3,5,8,37.5%,5m
2070,3,[EBS]소새기,3585,58,2,4,6,33.3%,5m
2070,3,Aicoo,3585,30,1,4,5,20.0%,9m
2075,3,DDBDB,3584,190,5,2,7,71.4%,3m
2076,3,[ELS]해머딘,3583,1531,127,113,240,52.9%,6m
2076,3,음성,3583,0,0,1,1,0.0%,6m
2078,3,마운틴듀,3581,183,7,5,12,58.3%,3m
2078,1,Click,3581,120,3,1,4,75.0%,45m
2080,3,HULK,3580,1527,105,104,209,50.2%,12m
2080,3,CLYDA,3580,582,23,27,50,46.0%,8m
2082,3,Scandal,3579,1498,132,111,243,54.3%,9m
2082,3,presenT,3579,1354,91,71,162,56.2%,8m
2082,3,[고물상]Chikorita,3579,685,35,13,48,72.9%,8m
2082,3,[네오]HOON,3579,30,1,9,10,10.0%,11m
2082,3,인공지능칸,3579,0,0,1,1,0.0%,9m
2082,3,내가그린기린그림,3579,0,0,1,1,0.0%,3m
2088,3,IIIIIIIIIIII,3578,624,37,35,72,51.4%,8m
2088,3,[메카]Cocacola,3578,308,12,8,20,60.0%,5m
2088,3,호구방망이,3578,196,10,4,14,71.4%,5m
2088,3,Ment,3578,64,3,9,12,25.0%,7m
2088,3,조근성,3578,30,2,5,7,28.6%,6m
2088,3,daisysult,3578,0,0,5,5,0.0%,8m
2088,3,[인투더]IntoTheJay,3578,0,0,6,6,0.0%,12m
2095,2,ballas,3577,1544,141,153,294,48.0%,11m
2095,3,[아는사람만와]berserk,3577,422,102,94,196,52.0%,8m
2095,3,런다운,3577,868,83,59,142,58.5%,9m
2095,3,[프사기박멸중]맹독충버프필수,3577,795,29,34,63,46.0%,8m
2095,3,Chico,3577,546,19,21,40,47.5%,9m
2095,3,jaws,3577,448,16,18,34,47.1%,9m
2095,3,[시럽]NewB,3577,30,2,4,6,33.3%,4m
2095,3,Juining,3577,0,0,1,1,0.0%,5m
2103,3,[Bully]고수,3576,416,21,18,39,53.8%,8m
2103,3,Gosu,3576,145,3,10,13,23.1%,10m
2103,3,[잘먹고산다]목소리의형태,3576,0,1,1,2,50.0%,3m
2103,3,요도분출,3576,0,0,1,1,0.0%,11m
2103,3,대한이,3576,0,0,1,1,0.0%,3m
2103,3,HandsomeBOY,3576,0,0,2,2,0.0%,3m
2109,3,[Rovic]PLATIINA,3575,0,0,1,1,0.0%,7m
2109,3,일벌레,3575,0,0,2,2,0.0%,3m
2109,3,[異界的檢察官]linkalwei,3575,0,0,2,2,0.0%,8m
2112,3,김뱡가,3574,106,4,7,11,36.4%,3m
2112,3,부쉬대통령,3574,0,1,0,1,100.0%,9m
2112,3,OrcSC,3574,0,0,1,1,0.0%,12m
2112,3,[ProTT]정종현,3574,0,0,4,4,0.0%,8m
2116,3,KALNALQUEEN,3573,30,1,4,5,20.0%,5m
2117,3,llllllllllll,3572,1253,60,36,96,62.5%,9m
2117,3,Attacker,3572,589,22,18,40,55.0%,5m
2117,3,[진호짱]스타천재,3572,640,22,34,56,39.3%,8m
2117,3,Fusion,3572,407,13,13,26,50.0%,3m
2117,1,SupplyBlock,3572,168,6,0,6,100.0%,44m
2117,1,RenRen,3572,135,4,4,8,50.0%,8m
2117,3,llllllllllll,3572,0,0,1,1,0.0%,4m
2124,3,[Mini]CheongWoo,3571,704,24,31,55,43.6%,5m
2124,3,[shiro]MIKUDANCE,3571,592,21,22,43,48.8%,8m
2124,3,[Super]Alx,3571,0,1,0,1,100.0%,9m
2124,3,洞五三洞部隊起床,3571,0,0,1,1,0.0%,8m
2128,3,[TheDOH]Ofen,3570,1250,154,149,303,50.8%,12m
2128,3,Massinggal,3570,626,28,20,48,58.3%,9m
2128,3,[무한오영종]견과믹스,3570,481,22,11,33,66.7%,9m
2128,3,TyphoonWYD,3570,150,5,8,13,38.5%,12m
2128,3,Cosine,3570,119,4,10,14,28.6%,12m
2128,3,제동신,3570,30,2,4,6,33.3%,5m
2128,3,MaSCotHMF,3570,0,0,1,1,0.0%,5m
2128,3,lIlIIlIIIIII,3570,0,0,5,5,0.0%,8m
2136,3,IIlIllIIlIIl,3569,115,12,21,33,36.4%,3m
2136,3,카인,3569,0,1,0,1,100.0%,11m
2136,3,날빌만칩니다,3569,0,0,1,1,0.0%,8m
2139,2,[超級大雷貓]Sugar,3568,403,18,40,58,31.0%,6m
2139,3,[BTU]Qarn,3568,378,15,12,27,55.6%,3m
2139,3,[DoDori]도도리탕,3568,262,8,6,14,57.1%,8m
2139,1,PlsGimmeCoke,3568,145,4,4,8,50.0%,12m
2139,3,[國本]BattleCruser,3568,95,3,3,6,50.0%,5m
2139,3,[이터널]llllllllllll,3568,0,1,0,1,100.0%,8m
2139,3,[마이리틀포니]제너럴공국,3568,0,0,1,1,0.0%,8m
2139,3,[물다이아]엄준식,3568,0,0,1,1,0.0%,7m
2147,3,ZziPa,3567,30,2,2,4,50.0%,6m
2148,2,유기농초코우유,3566,1513,217,218,435,49.9%,5m
2148,3,Conkey,3566,200,8,5,13,61.5%,4m
2148,3,bassowl,3566,174,6,9,15,40.0%,7m
2148,3,IIIIIIIIII,3566,150,6,12,18,33.3%,3m
2148,3,고두치,3566,30,2,3,5,40.0%,11m
2148,3,OverLord,3566,0,1,0,1,100.0%,9m
2154,3,IlIIIllllIII,3565,1487,188,196,384,49.0%,12m
2154,2,마음이,3565,1389,57,67,124,46.0%,9m
2154,3,大包哥哥,3565,58,2,2,4,50.0%,9m
2154,3,쩌글링네마리,3565,30,1,1,2,50.0%,9m
2158,3,IIIIIIIIIIII,3564,95,5,10,15,33.3%,5m
2158,3,robot,3564,141,3,2,5,60.0%,6m
2158,3,[SC2HK]青銅鮮奶茶,3564,30,2,1,3,66.7%,11m
2158,3,ckacl,3564,30,1,3,4,25.0%,7m
2158,3,asdasdds,3564,0,0,2,2,0.0%,6m
2163,3,StorageBox,3563,1417,275,286,561,49.0%,8m
2163,3,竹本日青,3563,1541,246,239,485,50.7%,6m
2163,3,Leo,3563,1337,57,53,110,51.8%,9m
2163,3,Automaton,3563,450,16,16,32,50.0%,12m
2163,3,nutflush,3563,236,8,12,20,40.0%,8m
2163,3,[Evil]JaCkpOt,3563,148,5,7,12,41.7%,6m
2163,3,IMBoni,3563,0,0,1,1,0.0%,6m
2170,3,복상임,3562,119,6,2,8,75.0%,9m
2170,3,AlphaGo,3562,120,4,10,14,28.6%,9m
2170,3,[일반인고수]흙은흙흙하고울지,3562,0,0,1,1,0.0%,6m
2173,3,qtd,3561,572,21,25,46,45.7%,4m
2173,3,HoMe,3561,30,2,4,6,33.3%,8m
2173,3,OuO,3561,30,1,2,3,33.3%,5m
2176,3,San,3560,1541,143,135,278,51.4%,12m
2176,3,DraGneeL,3560,246,12,5,17,70.6%,6m
2176,1,오야,3560,30,1,1,2,50.0%,44m
2179,3,[JD]YHJ,3559,498,20,13,33,60.6%,3m
2179,3,llllllllllll,3559,40,3,1,4,75.0%,3m
2179,3,[GIS]studpj,3559,0,0,1,1,0.0%,5m
2179,3,llllllllllll,3559,0,0,1,1,0.0%,5m
2179,3,[NsP]TheAreNa,3559,0,0,4,4,0.0%,5m
2184,3,[미생물과파지]kiruru,3558,208,8,7,15,53.3%,8m
2184,3,이민호,3558,30,2,3,5,40.0%,12m
2186,3,Seankalizzle,3557,437,51,43,94,54.3%,5m
2186,3,[FaDe]PressureTest,3557,740,26,31,57,45.6%,5m
2186,3,[링컨]노후대책없다,3557,410,23,30,53,43.4%,12m
2186,3,Lorthiras,3557,214,9,3,12,75.0%,9m
2186,3,결승전어윤수,3557,62,2,9,11,18.2%,9m
2191,3,[最帥小烈]葉禪,3556,0,1,0,1,100.0%,8m
2191,2,lllllllllll,3556,0,1,1,2,50.0%,46m
2193,3,BeTaStar,3555,374,17,9,26,65.4%,6m
2193,1,SAOJamesDPW,3555,115,2,3,5,40.0%,8m
2193,3,테란살육도살머신,3555,60,2,9,11,18.2%,6m
2196,3,[조누]조선누룽지,3554,0,0,1,1,0.0%,11m
2197,3,ARK,3553,1444,53,54,107,49.5%,5m
2197,3,단백질,3553,328,31,19,50,62.0%,5m
2197,3,FlameSJ,3553,217,6,5,11,54.5%,6m
2197,3,Ghaja,3553,58,3,6,9,33.3%,7m
2197,1,Luvian,3553,0,1,0,1,100.0%,44m
2197,3,알파몽,3553,0,0,2,2,0.0%,5m
2197,3,cyzzpant,3553,0,0,4,4,0.0%,12m
2204,3,Pontiff,3552,107,4,3,7,57.1%,12m
2204,3,[Troupe]Notorius,3552,0,0,1,1,0.0%,11m
2206,3,포그,3551,954,56,54,110,50.9%,9m
2206,3,llllllllllll,3551,895,43,29,72,59.7%,5m
2206,3,[WTSC]리젖문,3551,227,13,7,20,65.0%,5m
2206,3,[6NBK9]allwulong,3551,93,1,1,2,50.0%,5m
2206,3,Jazzer,3551,0,1,2,3,33.3%,9m
2211,3,GOLDSTAR,3550,463,17,12,29,58.6%,6m
2211,3,liKSil,3550,0,0,1,1,0.0%,12m
2213,3,[무한오영종]llllllllllil,3549,553,21,19,40,52.5%,12m
2213,3,SFHoLongHun,3549,373,20,16,36,55.6%,11m
2213,3,丫头骗子,3549,0,5,0,5,100.0%,10m
2213,3,CANNONBALL,3549,0,1,0,1,100.0%,12m
2213,3,[SofT]Miracle,3549,0,1,1,2,50.0%,8m
2213,3,[뭔가거대한]Noname,3549,0,0,1,1,0.0%,9m
2219,3,애쉬크로프트,3548,0,1,0,1,100.0%,5m
2220,3,[매너플레이어]FINALY,3547,30,2,0,2,100.0%,8m
2221,3,XXXTENTACION,3546,1203,46,43,89,51.7%,5m
2221,3,[Equal]HeePang,3546,218,6,4,10,60.0%,9m
2221,3,IIIIIIIIIIII,3546,0,4,1,5,80.0%,15m
2221,3,[77rDr귀]저장소다버림,3546,58,3,1,4,75.0%,5m
2221,3,[陽光超人烘培]巴戈耶魯,3546,30,2,1,3,66.7%,9m
2221,3,Confessions,3546,30,2,4,6,33.3%,4m
2227,3,IIIlllllllll,3545,614,57,46,103,55.3%,5m
2227,3,[燚燚燚燚燚燚]ZAR,3545,265,12,4,16,75.0%,10m
2227,3,[GIS]Lon,3545,191,5,4,9,55.6%,8m
2230,3,小兵,3544,1450,85,85,170,50.0%,5m
2230,3,ByungWoo,3544,1015,49,31,80,61.2%,8m
2230,3,zestman,3544,256,10,12,22,45.5%,5m
2230,3,WOZ,3544,30,1,3,4,25.0%,7m
2230,3,[DagmBa]아무꺼나합세,3544,0,0,3,3,0.0%,9m
2235,3,한국인,3543,178,6,8,14,42.9%,12m
2235,3,은교,3543,116,2,2,4,50.0%,7m
2235,3,Amaterasu,3543,94,1,1,2,50.0%,3m
2238,3,糕餅,3542,1549,289,281,570,50.7%,8m
2238,3,채운,3542,481,17,17,34,50.0%,5m
2238,3,Earl,3542,210,11,4,15,73.3%,6m
2238,3,대략신입,3542,0,0,1,1,0.0%,11m
2238,3,크르륵크륵,3542,0,0,3,3,0.0%,7m
2243,3,모선핵,3541,302,13,24,37,35.1%,8m
2243,3,GoodDay,3541,0,1,4,5,20.0%,15m
2243,3,[무서운]초코비,3541,0,0,2,2,0.0%,10m
2243,3,홍춘,3541,0,0,4,4,0.0%,3m
2247,3,존예은,3540,1398,160,116,276,58.0%,8m
2247,3,HyuneeKun,3540,779,89,77,166,53.6%,8m
2247,3,GCD,3540,458,22,9,31,71.0%,12m
2250,2,kisyhan,3539,1493,244,247,491,49.7%,5m
2250,2,IIIIIIIIIIII,3539,1531,170,176,346,49.1%,6m
2250,3,GGoom,3539,1202,71,68,139,51.1%,5m
2250,3,알잘딱깔센,3539,179,6,1,7,85.7%,5m
2250,3,IPOS,3539,0,4,1,5,80.0%,5m
2250,3,[무한오영종]AlphaGo,3539,0,0,4,4,0.0%,9m
2256,3,[농구의신]프사기는과학이다,3538,1396,73,47,120,60.8%,12m
2256,3,llllllllll,3538,781,48,39,87,55.2%,11m
2256,3,baM,3538,317,24,21,45,53.3%,8m
2256,3,[聽音]HeavyMetal,3538,368,14,13,27,51.9%,8m
2256,3,[문재앙씨발놈]호날두가조아,3538,266,9,4,13,69.2%,5m
2256,3,IIIIIIIIIIII,3538,146,6,7,13,46.2%,8m
2256,3,홍합짬뽕,3538,118,4,6,10,40.0%,8m
2256,3,저그유저,3538,62,2,6,8,25.0%,8m
2256,3,[Looser]rusiaEU,3538,0,1,0,1,100.0%,9m
2265,3,Yolo,3537,1543,104,99,203,51.2%,6m
2265,3,쪼알,3537,1445,90,85,175,51.4%,5m
2265,3,KOSIWOO,3537,456,16,28,44,36.4%,5m
2265,3,쥐티,3537,418,14,26,40,35.0%,3m
2265,3,llllllllllll,3537,321,12,4,16,75.0%,12m
2265,3,IIIIIIIIIIII,3537,252,10,9,19,52.6%,9m
2265,3,[Old]命運好好玩,3537,0,1,0,1,100.0%,6m
2265,3,[s2Mc]Khan,3537,0,0,3,3,0.0%,7m
2273,3,[大嘉義啟社]Hxmot,3536,294,9,22,31,29.0%,3m
2273,2,Roy,3536,0,1,0,1,100.0%,3m
2273,3,[자지언트]Lard,3536,0,0,2,2,0.0%,6m
2276,3,안기영,3535,1170,58,56,114,50.9%,12m
2276,3,[밀짚모해적단]知愛,3535,380,17,11,28,60.7%,12m
2276,3,TraFalGarLaw,3535,159,4,2,6,66.7%,9m
2276,3,[混元]VioletCode,3535,30,2,1,3,66.7%,3m
2276,3,[CIM]IIIlllllIIII,3535,0,1,0,1,100.0%,5m
2281,3,피노키오루,3534,1094,66,58,124,53.2%,8m
2281,3,inscrutable,3534,344,13,16,29,44.8%,12m
2283,3,Uriver,3533,426,14,22,36,38.9%,7m
2283,3,OBSIDIAN,3533,0,5,0,5,100.0%,4m
2283,3,TaeJa,3533,143,4,2,6,66.7%,8m
2283,3,희망,3533,0,1,1,2,50.0%,7m
2283,3,[무직자가능]대출문의주쇼,3533,0,0,1,1,0.0%,5m
2288,3,고기반찬,3532,236,8,15,23,34.8%,4m
2289,3,지옥의메커니컬,3531,1288,109,96,205,53.2%,9m
2289,3,[KON]Ryan,3531,806,29,32,61,47.5%,5m
2289,3,Darkness,3531,516,21,14,35,60.0%,5m
2289,3,Zalaxus,3531,0,0,1,1,0.0%,3m
2293,3,DinoSaur,3530,949,38,42,80,47.5%,5m
2293,3,[CIM]맛집저그,3530,670,23,29,52,44.2%,5m
2293,3,리밋학팔,3530,256,8,6,14,57.1%,6m
2293,3,Ashiro,3530,30,6,2,8,75.0%,5m
2293,3,IlIlIlIlIlIl,3530,96,2,0,2,100.0%,8m
2293,3,트럭악마,3530,0,1,2,3,33.3%,9m
2293,3,악당방구,3530,30,1,3,4,25.0%,9m
2300,3,態度,3529,242,7,7,14,50.0%,9m
2300,3,SnapCast,3529,60,3,10,13,23.1%,5m
2300,3,브론,3529,0,0,1,1,0.0%,12m
2303,3,[TDT]WingLien,3528,214,8,9,17,47.1%,7m
2303,3,IIIIIIIIIIII,3528,94,2,0,2,100.0%,5m
2305,3,Cheetah,3527,1503,100,86,186,53.8%,6m
2305,3,IIIIIIIIIIII,3527,327,11,9,20,55.0%,11m
2305,2,[ProTT]대군주,3527,110,5,2,7,71.4%,4m
2305,3,Olleh,3527,118,3,1,4,75.0%,3m
2305,3,일천,3527,0,0,2,2,0.0%,8m
2310,3,[ZES]번식의제왕,3526,1240,91,96,187,48.7%,4m
2310,3,[NFam]다예쩌러,3526,888,47,39,86,54.7%,11m
2310,3,BoomShakalak,3526,754,33,31,64,51.6%,3m
2310,3,llllllllllll,3526,524,18,16,34,52.9%,12m
2310,3,letria,3526,0,5,0,5,100.0%,10m
2315,3,aDecay,3525,1495,72,60,132,54.5%,12m
2315,3,아메리카노,3525,213,7,5,12,58.3%,5m
2315,3,합성오렌지향,3525,119,3,1,4,75.0%,3m
2315,3,消波塊,3525,0,0,1,1,0.0%,6m
2319,3,김샤크,3524,1547,354,345,699,50.6%,8m
2319,3,[해병대]백이보충대,3524,1068,70,67,137,51.1%,9m
2319,3,aegean,3524,1483,68,70,138,49.3%,8m
2322,3,[그시절의]마린허니,3523,484,18,28,46,39.1%,7m
2322,3,홍성철,3523,145,3,6,9,33.3%,11m
2322,3,[Kaltra]hotkii,3523,118,2,2,4,50.0%,12m
2325,3,[TeamGP]TheBaRTV,3522,407,16,10,26,61.5%,8m
2325,3,[異界的檢察官]yamedekutasa,3522,349,15,7,22,68.2%,9m
2325,3,kwg,3522,100,4,0,4,100.0%,9m
2325,3,별꿈,3522,95,1,1,2,50.0%,6m
2329,3,[NGamE2]chan,3521,514,61,42,103,59.2%,8m
2329,3,DoMsn,3521,417,23,2,25,92.0%,6m
2331,3,[ONCE台灣]CicadaFLY,3520,769,28,27,55,50.9%,5m
2331,3,烏歸歸歸頭,3520,240,8,7,15,53.3%,9m
2331,3,nature,3520,114,5,4,9,55.6%,4m
2334,3,愚蠢的棒子,3519,1111,99,78,177,55.9%,10m
2334,3,llllllllllll,3519,873,74,79,153,48.4%,3m
2334,3,Sorceress,3519,1269,59,57,116,50.9%,8m
2334,3,人生阿,3519,30,2,1,3,66.7%,6m
2334,2,모찌론,3519,0,0,1,1,0.0%,5m
2334,3,IIIIIIIIIII,3519,0,0,2,2,0.0%,15m
2340,1,Squi,3518,1189,54,34,88,61.4%,8m
2340,1,구운치킨짱짱,3518,73,0,2,2,0.0%,11m
2342,3,저그,3517,792,28,37,65,43.1%,3m
2342,3,[KRSC2]hArmOnyzErG,3517,426,13,26,39,33.3%,8m
2342,3,길현,3517,296,11,11,22,50.0%,12m
2342,3,wantcomitdie,3517,148,10,9,19,52.6%,4m
2342,3,불친절해,3517,222,6,6,12,50.0%,3m
2342,3,[PSS2]체리튀김,3517,30,1,4,5,20.0%,5m
2348,1,HalfRookie,3516,0,0,1,1,0.0%,11m
2349,3,[BJI]PoringZerg,3515,224,28,27,55,50.9%,5m
2349,1,Candy,3515,0,0,1,1,0.0%,4m
2351,3,황윤하,3514,1344,51,51,102,50.0%,6m
2351,3,으여갓,3514,1093,44,42,86,51.2%,9m
2351,1,Zerged,3514,130,4,2,6,66.7%,10m
2354,3,NoGreenPlz,3513,1552,183,166,349,52.4%,9m
2354,3,skipper,3513,288,12,6,18,66.7%,5m
2354,1,IIIIIIIIIIII,3513,146,5,7,12,41.7%,44m
2354,1,Jeju,3513,0,0,1,1,0.0%,8m
2354,1,[DDLC]Sayori,3513,0,0,1,1,0.0%,12m
2359,3,soulmate,3512,1325,77,86,163,47.2%,8m
2359,3,[Equal]awoy,3512,1186,40,56,96,41.7%,9m
2359,3,llllllllllll,3512,327,15,12,27,55.6%,4m
2359,3,난폭군,3512,359,15,15,30,50.0%,3m
2359,3,microsoft,3512,30,1,3,4,25.0%,9m
2359,3,GUNDAM,3512,30,1,3,4,25.0%,8m
2365,3,[NGNLZ]小周,3511,0,1,1,2,50.0%,5m
2366,3,백귀,3510,343,13,11,24,54.2%,11m
2366,3,IlIlIlIlIl,3510,58,3,3,6,50.0%,11m
2366,1,그네타는순실,3510,0,0,1,1,0.0%,8m
2366,1,NaroZilla,3510,0,0,1,1,0.0%,3m
2370,3,Eurytos,3509,58,2,6,8,25.0%,8m
2370,3,Barcode,3509,95,1,6,7,14.3%,5m
2372,3,KreCy,3508,369,18,23,41,43.9%,5m
2372,3,[真腥鎮]llllllll,3508,110,13,14,27,48.1%,12m
2372,3,화력,3508,292,12,4,16,75.0%,6m
2372,3,Lighthouse,3508,230,12,5,17,70.6%,5m
2376,3,SiMpLeStyLe,3507,1554,166,155,321,51.7%,9m
2376,3,philosophic,3507,174,7,8,15,46.7%,5m
2376,3,lIlIlIlIlIlI,3507,0,0,5,5,0.0%,6m
2379,3,cocobutter,3506,950,49,52,101,48.5%,8m
2379,3,Tsukuba,3506,301,20,24,44,45.5%,8m
2379,1,Vanish,3506,318,10,4,14,71.4%,11m
2379,3,MoonChildE,3506,30,1,6,7,14.3%,6m
2383,2,ssdjssdj,3505,1451,311,327,638,48.7%,5m
2383,3,[엉덩엉덩]길막대장울트라,3505,374,13,16,29,44.8%,3m
2383,2,llllllllllll,3505,0,5,1,6,83.3%,45m
2383,3,MitBit,3505,0,0,3,3,0.0%,8m
2387,3,watanabe,3504,1472,274,270,544,50.4%,8m
2387,3,NwKaKa,3504,1038,218,201,419,52.0%,6m
2387,3,욤욤이,3504,1535,124,132,256,48.4%,6m
2387,1,[銅牌上不去]llBULY,3504,0,1,0,1,100.0%,3m
2391,3,[무리무리팸]greencloud,3503,1483,145,144,289,50.2%,6m
2392,3,[Dark]QueenDark,3502,85,6,3,9,66.7%,5m
2393,3,[YJJ]bloodwar,3501,531,65,49,114,57.0%,11m
2393,3,[무작]자유의날개,3501,449,22,19,41,53.7%,9m
2393,3,MONKEYDLUFFY,3501,136,3,2,5,60.0%,12m
2396,3,마음,3500,1189,125,88,213,58.7%,4m
2396,3,저그버프좀,3500,116,5,5,10,50.0%,9m
2398,3,[최강기아]아리지플짱,3499,136,4,1,5,80.0%,7m
2399,3,DRWELLS,3498,750,123,127,250,49.2%,5m
2399,3,magnon,3498,801,74,66,140,52.9%,11m
2399,1,cHrIsO,3498,155,6,3,9,66.7%,8m
2399,1,Ricky,3498,128,3,3,6,50.0%,8m
2403,3,[Lotuz]LarS,3497,682,25,24,49,51.0%,8m
2403,3,Anthony,3497,330,11,18,29,37.9%,12m
2403,3,리소나,3497,180,6,9,15,40.0%,11m
2403,3,lllllllllll,3497,142,4,1,5,80.0%,10m
2403,1,[Freeby]우르릉까꿍,3497,86,2,1,3,66.7%,8m
2403,3,아기공룡둘째,3497,30,1,3,4,25.0%,8m
2409,3,Achoo,3496,1551,359,351,710,50.6%,8m
2409,3,[도담이]얼어붙은개,3496,888,34,35,69,49.3%,6m
2409,3,LsIk,3496,118,2,4,6,33.3%,12m
2412,3,파워상민이,3495,306,10,10,20,50.0%,4m
2412,3,[푸른하늘]GINZA,3495,167,5,4,9,55.6%,12m
2414,3,초등학생아니에요,3494,674,24,26,50,48.0%,5m
2414,3,llllllllllll,3494,352,14,7,21,66.7%,9m
2414,3,ddd,3494,223,9,10,19,47.4%,5m
2414,1,[노인성듀오]치즈피자탕수육,3494,122,4,1,5,80.0%,8m
2414,1,YakJeng,3494,191,4,9,13,30.8%,45m
2414,1,[PANG]좋은저그,3494,0,1,0,1,100.0%,11m
2420,3,[OnePeS]kaede,3493,601,61,44,105,58.1%,6m
2420,3,몬드,3493,1485,58,60,118,49.2%,12m
2420,1,청새치튀김,3493,516,21,11,32,65.6%,3m
2423,3,KameSennin,3492,158,9,14,23,39.1%,5m
2423,1,IIIllllllIIl,3492,0,2,3,5,40.0%,11m
2425,3,떡실신,3491,1496,559,542,1101,50.8%,12m
2425,1,신체상해,3491,138,7,1,8,87.5%,6m
2425,1,lIlIIIllIIIl,3491,0,2,3,5,40.0%,4m
2425,1,IIIIIIIIIIII,3491,0,0,1,1,0.0%,11m
2425,1,[CNCSPE]영상팔이소년,3491,0,0,1,1,0.0%,8m
2430,3,[비트]나이뽕,3490,541,20,15,35,57.1%,5m
2430,3,kingslove,3490,230,8,10,18,44.4%,5m
2430,1,Ashiro,3490,0,5,0,5,100.0%,11m
2430,1,不闪不避全凭内力,3490,86,3,0,3,100.0%,8m
2430,1,아구찜장인,3490,0,1,0,1,100.0%,8m
2430,1,법정대리인,3490,0,0,1,1,0.0%,11m
2430,1,[SofT]석화,3490,0,0,1,1,0.0%,11m
2437,3,[시럽]내멋에산다,3489,995,101,79,180,56.1%,12m
2437,1,llllllllllll,3489,233,11,1,12,91.7%,44m
2437,1,NCM,3489,172,5,1,6,83.3%,12m
2437,1,evanann,3489,0,0,1,1,0.0%,4m
2441,2,[ELS]kyotohusband,3488,1462,213,210,423,50.4%,6m
2441,3,빈대똑,3488,1413,70,56,126,55.6%,11m
2441,3,MaOrO,3488,598,29,18,47,61.7%,10m
2441,1,Lego,3488,0,5,0,5,100.0%,8m
2445,3,IIIIIIIIIIII,3487,920,35,28,63,55.6%,5m
2445,3,고등어,3487,671,34,29,63,54.0%,5m
2445,3,StreeTBoxeR,3487,200,11,9,20,55.0%,12m
2445,1,[GIS]小翔,3487,0,1,0,1,100.0%,11m
2449,3,[무한오영종]Marine,3486,0,0,5,5,0.0%,5m
2450,3,[TW尖矛艦隊]百戰天蟲,3485,1511,153,146,299,51.2%,9m
2450,1,패배하기,3485,253,7,8,15,46.7%,11m
2450,1,TaGere,3485,80,3,1,4,75.0%,11m
2450,2,바퀴벌레,3485,0,0,1,1,0.0%,46m
2454,3,DavidC,3484,1373,101,119,220,45.9%,6m
2455,3,兔耳猴猴,3483,1509,102,92,194,52.6%,9m
2455,1,dinoahn,3483,42,1,2,3,33.3%,8m
2457,1,llllllll,3482,572,34,30,64,53.1%,4m
2457,3,VERSEZ,3482,577,25,17,42,59.5%,12m
2459,3,liliiilili,3481,1531,304,292,596,51.0%,9m
2459,3,[초코칩]태양,3481,30,2,3,5,40.0%,5m
2461,1,Soul,3480,780,130,123,253,51.4%,11m
2461,3,TyChang,3480,1014,36,40,76,47.4%,3m
2461,3,IIIIIIIIIIII,3480,0,0,1,1,0.0%,12m
2464,3,llllllllllll,3479,948,37,36,73,50.7%,4m
2464,1,Yossarian,3479,190,19,11,30,63.3%,3m
2464,3,dkricm,3479,371,16,12,28,57.1%,5m
2464,1,뮤링링,3479,0,0,1,1,0.0%,4m
2464,1,폭풍저그,3479,0,0,2,2,0.0%,4m
2469,1,Goges,3478,40,2,2,4,50.0%,3m
2469,1,[Mazest]winwin,3478,42,1,2,3,33.3%,11m
2469,3,밸런스패치가망침,3478,0,0,8,8,0.0%,4m
2472,1,GeniusDanGuN,3477,348,12,7,19,63.2%,11m
2472,3,[릿카]frozencall,3477,88,3,8,11,27.3%,7m
2472,1,소나기,3477,0,1,0,1,100.0%,11m
2475,1,llllllllllll,3476,1791,192,182,374,51.3%,4m
2475,3,[스갤러]Fruitseller,3476,1454,182,206,388,46.9%,4m
2475,3,Loin,3476,470,18,16,34,52.9%,4m
2475,1,[NLTN]짐네이년,3476,0,1,1,2,50.0%,3m
2475,1,llllllllllll,3476,0,0,1,1,0.0%,8m
2475,3,[KMirai]미래비행,3476,0,0,4,4,0.0%,15m
2481,1,llllllllllll,3475,308,12,6,18,66.7%,11m
2481,3,[제일잘생긴]세이버,3475,250,10,12,22,45.5%,7m
2481,1,링링링,3475,42,2,3,5,40.0%,8m
2481,1,암살자,3475,0,1,1,2,50.0%,10m
2481,1,전직욕교사,3475,0,0,1,1,0.0%,11m
2486,3,[패자는피를]Iova,3474,552,21,26,47,44.7%,8m
2486,3,IIIIIIIIIIII,3474,261,11,15,26,42.3%,11m
2486,1,III,3474,130,4,2,6,66.7%,3m
2486,1,jack,3474,0,2,3,5,40.0%,3m
2486,1,Hundekuchen,3474,0,0,1,1,0.0%,10m
2486,1,zzz,3474,0,0,1,1,0.0%,11m
2492,1,ButterdToast,3473,426,12,7,19,63.2%,8m
2492,1,TKor,3473,366,10,7,17,58.8%,3m
2492,3,웃지마민병관,3473,62,2,6,8,25.0%,6m
2492,1,RandyOrtoN,3473,0,0,1,1,0.0%,11m
2492,1,매콤한과자,3473,0,0,1,1,0.0%,11m
2492,1,니코마키반자이,3473,0,0,2,2,0.0%,11m
2498,3,애지가니,3472,326,11,9,20,55.0%,8m
2498,3,IIIIIIIIIIII,3472,180,7,13,20,35.0%,7m
2498,1,IIIIIIIIIII,3472,96,2,0,2,100.0%,44m
2501,1,Ragnarok,3471,0,0,1,1,0.0%,11m
2502,1,둥둥,3470,1719,113,95,208,54.3%,9m
2502,1,IIIIIIIIII,3470,566,46,29,75,61.3%,8m
2502,1,검은고양이,3470,286,8,8,16,50.0%,10m
2502,2,TinoXI,3470,140,4,1,5,80.0%,3m
2502,1,Kaiser,3470,82,3,1,4,75.0%,10m
2502,1,東山李榮浩,3470,0,0,1,1,0.0%,10m
2508,3,마포구등갈비,3469,1494,132,122,254,52.0%,5m
2508,2,lIIIIIIIIIII,3469,46,1,2,3,33.3%,46m
2510,3,[Tyler]zzixx,3468,1517,232,209,441,52.6%,6m
2510,1,[靠團]阿湯,3468,301,14,5,19,73.7%,11m
2510,3,iloveyuki,3468,148,5,16,21,23.8%,3m
2510,1,그레고리펙,3468,86,2,3,5,40.0%,11m
2510,3,깐종,3468,0,0,4,4,0.0%,6m
2515,3,[마케마케]커피믹스,3467,350,12,22,34,35.3%,6m
2515,1,Reppageki,3467,358,11,8,19,57.9%,11m
2515,1,[NDW]鐵工,3467,144,4,0,4,100.0%,11m
2515,2,MrKIET,3467,0,2,5,7,28.6%,46m
2519,3,[충북제천시]요정,3466,343,14,8,22,63.6%,8m
2520,3,[TalenT]Bored,3465,658,36,38,74,48.6%,9m
2520,3,IIIIIIIIIIII,3465,440,15,21,36,41.7%,3m
2520,3,새로운시작,3465,121,6,1,7,85.7%,47m
2520,1,[我吃萊豬]改革家國動,3465,185,3,13,16,18.8%,11m
2520,1,군필여고생,3465,0,0,1,1,0.0%,11m
2525,3,역장돌진폭풍,3464,1447,140,125,265,52.8%,4m
2525,1,ZARD,3464,124,3,2,5,60.0%,11m
2525,1,[군주]KoOdrA,3464,127,2,6,8,25.0%,10m
2525,3,MoMo,3464,30,1,9,10,10.0%,5m
2525,3,크오억퉷,3464,0,0,2,2,0.0%,47m
2525,3,[HKKING]占领天安门,3464,0,0,7,7,0.0%,5m
2531,3,감시탑,3463,1210,139,123,262,53.1%,6m
2531,3,[별똥별]KillersBom,3463,1235,90,72,162,55.6%,4m
2531,3,Always,3463,466,34,25,59,57.6%,11m
2531,3,[Sugar]도리도리짱,3463,408,15,21,36,41.7%,6m
2531,3,BlueSkyRUTIN,3463,170,11,8,19,57.9%,11m
2531,2,[스카이파이터]fantasy,3463,96,2,6,8,25.0%,45m
2531,1,llllllllllll,3463,0,0,1,1,0.0%,8m
2538,1,IIlllIIIIIII,3462,1450,54,41,95,56.8%,11m
2538,3,Departure,3462,97,1,4,5,20.0%,5m
2540,1,IndraRinne,3461,777,66,44,110,60.0%,4m
2540,3,보고리아,3461,1017,42,39,81,51.9%,11m
2540,1,[시럽]기린,3461,302,9,4,13,69.2%,11m
2540,1,냐옹,3461,40,1,4,5,20.0%,10m
2540,1,김에녹,3461,0,0,1,1,0.0%,11m
2545,1,LeToucan,3460,174,5,4,9,55.6%,8m
2546,3,[SofT]ainch,3459,1324,65,64,129,50.4%,9m
2546,3,Zerg,3459,380,13,18,31,41.9%,4m
2546,1,ActuaryCPA,3459,84,2,4,6,33.3%,10m
2546,1,[ELS]초보입니닷,3459,0,1,0,1,100.0%,8m
2546,1,비누맛사탕,3459,0,0,1,1,0.0%,44m
2546,1,[액션스타]황간지,3459,0,0,2,2,0.0%,4m
2552,3,Winterwind,3458,556,27,21,48,56.2%,5m
2552,3,[엘리트]eLiteDragon,3458,331,10,12,22,45.5%,5m
2552,1,효니,3458,159,8,1,9,88.9%,43m
2552,3,흑인,3458,86,4,12,16,25.0%,5m
2552,1,Potential,3458,0,1,0,1,100.0%,6m
2552,3,[브리티안]헤센카셀,3458,93,1,4,5,20.0%,8m
2552,1,서리한,3458,0,0,1,1,0.0%,11m
2559,1,[낭낭하게]Machine,3457,194,6,2,8,75.0%,3m
2559,1,[GITS]HaoKing,3457,0,1,1,2,50.0%,44m
2561,1,yew,3456,1775,234,216,450,52.0%,8m
2561,1,[군사정권]이명박,3456,1642,111,80,191,58.1%,4m
2561,3,[맛있더라]BABYOUNG,3456,417,30,25,55,54.5%,10m
2561,1,Pocketmon,3456,234,7,1,8,87.5%,3m
2561,3,OuO,3456,0,1,0,1,100.0%,6m
2566,3,[엔타로연합]으라차차,3455,1273,69,49,118,58.5%,6m
2566,3,Mykal,3455,158,7,9,16,43.8%,5m
2566,3,[TpW]TpWGluttony,3455,60,2,10,12,16.7%,5m
2569,3,[WHB]한화우승,3454,827,33,29,62,53.2%,7m
2569,3,VIP,3454,461,16,16,32,50.0%,11m
2571,3,[겨울방어]잘생긴남자,3453,1536,192,158,350,54.9%,4m
2571,3,pasta,3453,891,168,186,354,47.5%,9m
2571,1,[이터널]GunpoDD,3453,893,29,28,57,50.9%,8m
2571,3,[박살]shamo,3453,471,29,34,63,46.0%,3m
2571,3,ZeuS,3453,367,13,12,25,52.0%,6m
2571,3,LetsPlay,3453,0,5,0,5,100.0%,46m
2571,1,바키준,3453,196,5,8,13,38.5%,12m
2571,1,[五嶽劍派]泰山派玉磯子,3453,44,2,3,5,40.0%,9m
2571,1,llllllllllll,3453,0,0,1,1,0.0%,8m
2580,3,[평범]Harooo,3452,1376,168,157,325,51.7%,6m
2580,1,GoodGuyGreg,3452,0,0,2,2,0.0%,10m
2580,1,llllllllllll,3452,0,0,3,3,0.0%,4m
2583,3,엠엠크루,3451,1361,63,64,127,49.6%,11m
2583,3,[SC2HK]OMGSJXD,3451,568,19,37,56,33.9%,12m
2583,2,얅뢇쉛놹뛞왡,3451,148,5,1,6,83.3%,3m
2583,1,KJKJ,3451,88,3,3,6,50.0%,10m
2583,1,Misakkung,3451,0,1,0,1,100.0%,3m
2588,1,불랑서,3450,617,26,17,43,60.5%,10m
2588,1,earth,3450,179,6,5,11,54.5%,4m
2590,3,푸른빛하늘,3449,1042,89,101,190,46.8%,3m
2590,1,IIIIIIIIIIII,3449,584,18,10,28,64.3%,6m
2590,1,Aqua,3449,94,2,0,2,100.0%,6m
2590,2,[美麗的大石頭]卐雄中仔卍,3449,0,1,0,1,100.0%,10m
2590,1,GLaDOS,3449,0,0,1,1,0.0%,3m
2595,3,[αX]SniperSC,3448,0,1,7,8,12.5%,8m
2595,2,갈마송충이,3448,0,0,1,1,0.0%,46m
2597,3,노스황나스,3447,1494,134,125,259,51.7%,8m
2597,3,Tsia,3447,1384,125,112,237,52.7%,6m
2597,3,유니씨,3447,704,73,74,147,49.7%,5m
2597,1,[Rovic]Parasite,3447,338,12,6,18,66.7%,8m
2597,3,[V4]닌지,3447,60,3,7,10,30.0%,5m
2597,3,서재빈,3447,0,0,1,1,0.0%,47m
2597,1,IIIlllllIIlI,3447,0,0,1,1,0.0%,11m
2597,1,작은맹덕,3447,0,0,4,4,0.0%,11m
2605,1,Paradise,3446,456,18,9,27,66.7%,8m
2605,1,[공허거주]LEVIATHAN,3446,236,7,0,7,100.0%,3m
2605,1,Allllx,3446,244,7,6,13,53.8%,8m
2605,1,[pepper]천공지뢰,3446,46,1,4,5,20.0%,4m
2609,3,Valhalla,3445,1424,142,151,293,48.5%,5m
2609,1,김종욱,3445,97,2,1,3,66.7%,43m
2609,1,Zoom,3445,0,1,0,1,100.0%,4m
2612,3,Aspiration,3444,1316,130,128,258,50.4%,11m
2612,1,SshaDow,3444,82,2,2,4,50.0%,11m
2612,1,efdwefw,3444,0,1,0,1,100.0%,45m
2612,1,[WTSC]UED,3444,0,0,1,1,0.0%,11m
2616,1,발트하임,3443,0,1,0,1,100.0%,4m
2616,1,JCK,3443,0,1,1,2,50.0%,11m
2618,1,llIllllIlIll,3442,928,28,29,57,49.1%,3m
2618,3,憂鬱幻境,3442,401,28,39,67,41.8%,3m
2618,1,Conqueror,3442,204,6,5,11,54.5%,12m
2618,1,꿀떡,3442,200,5,8,13,38.5%,3m
2618,1,[달팽이]보호대상자,3442,0,0,1,1,0.0%,8m
2618,1,jyj,3442,0,0,3,3,0.0%,10m
2624,3,DAETTO,3441,60,3,13,16,18.8%,4m
2625,1,Sabada,3440,135,8,1,9,88.9%,11m
2625,3,Astro,3440,160,5,17,22,22.7%,5m
2625,1,IlIIllIlll,3440,139,4,1,5,80.0%,44m
2625,1,aswell,3440,80,2,5,7,28.6%,10m
2625,1,경조,3440,0,1,3,4,25.0%,11m
2630,3,[XYFANS]IIIIIIIIIIII,3439,1499,186,183,369,50.4%,3m
2630,1,VoyagerOne,3439,414,12,8,20,60.0%,11m
2630,1,Aldar,3439,91,3,3,6,50.0%,8m
2630,3,[코트디부아르]흑인,3439,0,1,12,13,7.7%,9m
2634,1,llllllllllll,3438,0,1,0,1,100.0%,8m
2634,1,[LF]스투망겜,3438,0,0,3,3,0.0%,9m
2636,3,김박살,3437,294,15,8,23,65.2%,5m
2636,1,xiyentaiku,3437,319,9,20,29,31.0%,8m
2636,2,Rescue,3437,144,7,2,9,77.8%,45m
2636,1,sinken,3437,0,1,0,1,100.0%,11m
2640,3,IIIIIIIIIIII,3436,587,27,21,48,56.2%,11m
2640,3,llllllllll,3436,519,21,27,48,43.8%,6m
2640,1,SoupCatcher,3436,374,14,10,24,58.3%,8m
2640,1,DoDoYND,3436,280,7,10,17,41.2%,11m
2640,1,[WDY]Sydney,3436,80,2,2,4,50.0%,8m
2640,1,두부멘탈,3436,0,0,2,2,0.0%,8m
2646,1,누가나보다스타잘,3435,378,16,9,25,64.0%,9m
2646,1,[캬루]Kzone,3435,298,8,8,16,50.0%,4m
2646,1,[차행성줫밥들]차녀기,3435,0,1,0,1,100.0%,4m
2649,3,[인간태풍]Truman,3434,569,110,104,214,51.4%,5m
2649,3,[도담이]과염소산암모늄,3434,245,7,6,13,53.8%,8m
2651,1,XinCAST,3433,0,1,0,1,100.0%,10m
2652,1,Jeth,3432,637,26,16,42,61.9%,9m
2652,3,lIIIlllIllIl,3432,788,26,37,63,41.3%,11m
2654,1,llllllllllll,3431,156,5,3,8,62.5%,12m
2654,1,기영이,3431,0,1,1,2,50.0%,3m
2654,1,그대와함께라면,3431,0,1,2,3,33.3%,6m
2654,3,[尊者]Eikasang,3431,30,1,9,10,10.0%,12m
2654,1,[CA]IIlllllIllll,3431,0,0,1,1,0.0%,10m
2654,1,MoMoTaiRo,3431,0,0,1,1,0.0%,12m
2660,3,[ELSII]LaUnCher,3430,1506,149,153,302,49.3%,3m
2660,1,[한타왕]크아아아아아앙,3430,262,8,4,12,66.7%,3m
2660,1,ggbkiiio,3430,154,4,2,6,66.7%,3m
2660,1,복가임,3430,80,2,7,9,22.2%,8m
2660,1,[WDY]Fascio,3430,0,1,0,1,100.0%,8m
2665,1,와디더,3429,1230,80,62,142,56.3%,12m
2665,1,QwertyMaster,3429,663,26,21,47,55.3%,4m
2665,1,catlover,3429,754,22,23,45,48.9%,11m
2665,1,[건마]멕건마,3429,210,6,6,12,50.0%,3m
2669,3,[트위치]레드스톰,3428,1471,143,157,300,47.7%,11m
2669,1,IMLegend,3428,1007,34,23,57,59.6%,4m
2669,3,SWARM,3428,304,13,5,18,72.2%,9m
2669,3,BTS,3428,290,13,8,21,61.9%,8m
2669,1,llIIlIlIlIlI,3428,0,3,2,5,60.0%,4m
2674,1,스투는죽었다,3427,773,25,20,45,55.6%,11m
2674,1,카라,3427,250,6,8,14,42.9%,10m
2674,1,날부르지마,3427,145,2,10,12,16.7%,45m
2677,1,wooyoo,3426,300,9,4,13,69.2%,10m
2677,1,삼방인,3426,42,1,2,3,33.3%,6m
2677,1,눌홀릭,3426,0,0,2,2,0.0%,12m
2680,3,[ANGG]SpOnSoR,3425,573,24,18,42,57.1%,11m
2680,1,[삼국시대]Poo,3425,0,1,0,1,100.0%,8m
2680,1,[Goe]Amber,3425,0,1,0,1,100.0%,45m
2683,3,[TwoS]夢幻乂龍,3424,739,34,45,79,43.0%,9m
2683,3,희웅이에요,3424,290,12,8,20,60.0%,8m
2685,1,Bear,3423,1368,326,293,619,52.7%,11m
2685,1,IIIIIIIII,3423,1713,178,167,345,51.6%,11m
2685,1,dream,3423,293,12,6,18,66.7%,12m
2685,1,jieun,3423,146,5,3,8,62.5%,44m
2685,1,IIIIIIIIIIII,3423,0,1,0,1,100.0%,11m
2685,1,TOP,3423,0,1,0,1,100.0%,11m
2685,2,[14NY]DarkTempler,3423,0,0,1,1,0.0%,46m
2692,1,JillyKing,3422,163,8,4,12,66.7%,9m
2692,3,후라이드,3422,146,8,15,23,34.8%,3m
2692,1,SANMAR,3422,0,1,0,1,100.0%,11m
2692,1,[손가락장인]Torture,3422,0,0,1,1,0.0%,4m
2696,3,llllllllllll,3421,1507,493,483,976,50.5%,5m
2696,3,llllllllllll,3421,1555,399,401,800,49.9%,8m
2696,1,ChampionINno,3421,243,6,5,11,54.5%,45m
2699,3,IIIIIIIIIIII,3420,1529,84,50,134,62.7%,11m
2699,3,[ANGG]애플은사과,3420,470,16,22,38,42.1%,8m
2699,1,[21483]NEST,3420,0,1,0,1,100.0%,8m
2702,1,Buffon,3419,44,1,4,5,20.0%,12m
2702,1,잠자는공주의숲속,3419,0,0,2,2,0.0%,12m
2704,3,[Sett]Alarak,3418,278,11,18,29,37.9%,4m
2704,1,Yaphsog,3418,0,1,3,4,25.0%,8m
2706,2,[StorM2]IIIIIIIIIIII,3417,0,0,1,1,0.0%,45m
2706,1,[硬漢]ToughguyMars,3417,0,0,3,3,0.0%,12m
2708,1,그네젖통닌자,3416,1104,47,51,98,48.0%,4m
2708,1,저하늘의,3416,288,8,7,15,53.3%,11m
2708,1,lIllIIlIllI,3416,0,4,1,5,80.0%,8m
2708,1,리자몽,3416,42,1,4,5,20.0%,12m
2712,3,[TMR]Taiwanrice,3415,928,71,84,155,45.8%,10m
2712,1,[우걀걀]힘세고강한화력,3415,1012,33,33,66,50.0%,4m
2712,1,assso,3415,478,14,13,27,51.9%,11m
2712,3,FrozenMarine,3415,121,7,7,14,50.0%,10m
2712,1,아바투르,3415,128,4,2,6,66.7%,11m
2712,1,[찬큾]JeGi,3415,38,2,3,5,40.0%,12m
2712,1,[직장인들]짐레이너,3415,44,1,4,5,20.0%,11m
2719,1,순대도소금,3414,1762,248,237,485,51.1%,11m
2720,1,spiraled,3413,523,23,16,39,59.0%,4m
2720,2,맑은오줌,3413,141,3,2,5,60.0%,46m
2720,1,IMFatOrz,3413,0,0,1,1,0.0%,10m
2720,1,IIIIIIIIIIII,3413,0,0,1,1,0.0%,3m
2724,1,ProPirks,3412,241,12,6,18,66.7%,3m
2724,1,이순신전략,3412,0,0,1,1,0.0%,3m
2726,1,세나,3411,430,20,13,33,60.6%,8m
2726,1,sMoke,3411,542,16,18,34,47.1%,11m
2726,1,[665포병]TheKing,3411,42,2,3,5,40.0%,11m
2729,1,[아름다운세상]내가제일젤나가,3410,150,4,5,9,44.4%,6m
2729,1,lIlIlIlIlIlI,3410,48,3,1,4,75.0%,14m
2729,1,[5torM]멀티플레이어,3410,91,2,4,6,33.3%,4m
2729,1,[갈라파고스]ShySirius,3410,76,2,5,7,28.6%,12m
2733,1,롤리팝,3409,1588,147,112,259,56.8%,8m
2733,1,[어윤수님개쩜]HwanSangs,3409,735,21,20,41,51.2%,9m
2733,1,KnerveD,3409,556,16,17,33,48.5%,11m
2736,3,SuperKIDz,3408,1358,99,101,200,49.5%,3m
2736,3,Anyccallends,3408,790,34,36,70,48.6%,4m
2736,3,yuhsuan,3408,58,3,9,12,25.0%,5m
2739,1,lllllllllllI,3407,504,14,18,32,43.8%,11m
2739,1,Vanvan,3407,190,6,2,8,75.0%,10m
2741,3,으꺙지,3406,640,26,27,53,49.1%,8m
2741,3,우주의황제,3406,222,8,23,31,25.8%,4m
2741,3,MyAss,3406,97,1,2,3,33.3%,47m
2741,1,GTR,3406,0,0,2,2,0.0%,8m
2745,1,GameOver,3405,479,15,11,26,57.7%,6m
2745,1,星海爭媽,3405,48,5,1,6,83.3%,14m
2745,1,SteveIrwin,3405,0,1,3,4,25.0%,3m
2745,1,七億總統水扁,3405,0,0,4,4,0.0%,11m
2749,3,IlIlIlIlIl,3404,597,62,63,125,49.6%,11m
2749,3,이런미친,3404,1014,36,44,80,45.0%,9m
2749,1,lIlIlIlIlIlI,3404,40,1,2,3,33.3%,11m
2749,1,[환상향]Mush,3404,0,0,1,1,0.0%,43m
2753,3,Sarcasm,3403,1037,78,82,160,48.8%,3m
2753,3,minkirago,3403,1079,73,62,135,54.1%,8m
2753,1,쥐대기공룡,3403,309,12,4,16,75.0%,10m
2753,1,MooNami,3403,0,1,1,2,50.0%,6m
2753,1,MonkeyDLuffy,3403,0,0,1,1,0.0%,11m
2753,1,전광식,3403,0,0,1,1,0.0%,11m
2759,1,Kainz,3402,702,26,19,45,57.8%,8m
2759,3,로우하잇,3402,88,6,9,15,40.0%,12m
2759,1,[DVS]OAOIII,3402,42,2,0,2,100.0%,11m
2759,1,우산장수,3402,82,2,2,4,50.0%,12m
2759,1,WairRain,3402,0,1,0,1,100.0%,11m
2759,1,[CIM]바크주크,3402,95,1,1,2,50.0%,3m
2765,3,[농약]이쑤신장군,3401,1473,200,199,399,50.1%,4m
2765,1,용갈햏,3401,0,3,2,5,60.0%,14m
2765,1,IIlllllllIl,3401,88,2,8,10,20.0%,8m
2768,1,노상훈,3400,310,10,3,13,76.9%,3m
2768,1,llllllllllll,3400,173,4,1,5,80.0%,11m
2768,1,[프로토스협회]Johnist,3400,80,3,1,4,75.0%,11m
2768,2,김종모,3400,95,2,1,3,66.7%,45m
2772,2,[무한오영종]브이푸드,3399,1331,131,138,269,48.7%,5m
2772,1,雷西十斯洛特道茲,3399,797,36,33,69,52.2%,11m
2772,1,[暗夜洌鶇]ICY,3399,526,15,14,29,51.7%,12m
2775,3,[WDY]llllllllllll,3398,331,73,77,150,48.7%,5m
2775,3,[XYFANS]Jerrymiao,3398,1074,42,45,87,48.3%,4m
2775,3,경비원,3398,30,1,3,4,25.0%,9m
2775,1,공허폭격기,3398,0,0,3,3,0.0%,4m
2779,1,[너의ol름은]NiaJr,3397,1503,61,47,108,56.5%,8m
2779,1,puerilesky,3397,382,17,9,26,65.4%,8m
2779,1,dcare,3397,197,10,4,14,71.4%,6m
2779,3,[어윤수님개쩜]캡틴티모나루,3397,236,8,14,22,36.4%,6m
2779,1,북괴,3397,0,0,1,1,0.0%,4m
2784,3,Blue,3396,1016,142,148,290,49.0%,3m
2784,1,마그네슘,3396,1648,84,79,163,51.5%,11m
2784,1,저그의신,3396,605,72,59,131,55.0%,11m
2784,3,dabala,3396,561,23,33,56,41.1%,4m
2784,1,Jerry,3396,416,14,12,26,53.8%,4m
2784,1,IGNIS,3396,84,2,7,9,22.2%,8m
2784,1,ICE,3396,0,1,0,1,100.0%,3m
2784,1,겨울,3396,0,1,5,6,16.7%,6m
2792,1,벨리,3395,425,14,11,25,56.0%,11m
2792,1,zParkg,3395,162,5,2,7,71.4%,8m
2792,3,QiNTiQ,3395,125,5,14,19,26.3%,3m
2795,1,IMViC,3394,1704,121,121,242,50.0%,8m
2795,1,Icarus,3394,706,21,27,48,43.8%,8m
2795,1,[BFM]EmperOr,3394,203,4,3,7,57.1%,11m
2798,3,내가하면하향,3393,1536,246,237,483,50.9%,5m
2798,1,milkfish,3393,1666,212,201,413,51.3%,3m
2798,3,sto,3393,977,136,133,269,50.6%,5m
2798,3,[暗夜洌鶇]大爆氣,3393,835,45,47,92,48.9%,5m
2798,1,Asya,3393,124,6,9,15,40.0%,11m
2798,1,[QFE]charles,3393,0,1,2,3,33.3%,12m
2798,1,IIIIIIIIIIII,3393,0,0,1,1,0.0%,6m
2798,1,MsoK,3393,0,0,5,5,0.0%,11m
2806,1,Dakku,3392,1678,175,167,342,51.2%,8m
2806,3,Yohane,3392,164,4,10,14,28.6%,10m
2806,1,[도담이]epqlf,3392,122,3,3,6,50.0%,8m
2806,1,Rose,3392,40,3,4,7,42.9%,6m
2806,1,Mode,3392,40,2,0,2,100.0%,6m
2806,1,[TDT]MrDM,3392,0,0,1,1,0.0%,4m
2812,3,tomcy,3391,276,22,23,45,48.9%,4m
2812,3,시종남,3391,0,5,1,6,83.3%,15m
2814,1,캔수,3390,321,10,5,15,66.7%,10m
2814,1,[地獄拉麵]多線獸,3390,208,6,6,12,50.0%,11m
2816,3,ZhuFu,3389,1210,801,788,1589,50.4%,4m
2816,1,Assassin,3389,419,19,9,28,67.9%,11m
2816,1,[꿀들]특대장어덮밥,3389,376,10,12,22,45.5%,12m
2816,1,StrongManKR,3389,121,7,1,8,87.5%,12m
2816,1,선비저그,3389,0,1,1,2,50.0%,11m
2816,1,숏컷여자,3389,44,1,6,7,14.3%,4m
2822,1,IIIIIIIIIIII,3388,38,2,1,3,66.7%,3m
2822,1,[ACGN]Jatml,3388,0,0,1,1,0.0%,11m
2824,1,신지혜,3387,74,3,4,7,42.9%,10m
2824,1,[TalenT]Dream,3387,48,2,3,5,40.0%,13m
2824,2,SeDow,3387,0,1,2,3,33.3%,46m
2827,1,[Lotuz]스투하는실버블렛,3386,116,4,2,6,66.7%,11m
2827,1,큐안잡혀서왔어요,3386,141,3,4,7,42.9%,45m
2829,3,[국방부사서병]코로나는사기다,3385,437,17,23,40,42.5%,5m
2829,1,Dooyu,3385,393,14,14,28,50.0%,3m
2829,1,고라니,3385,130,3,11,14,21.4%,12m
2829,1,제주요망소년,3385,0,1,0,1,100.0%,12m
2829,1,참치회덮밥,3385,0,0,3,3,0.0%,11m
2834,3,Pseudomonas,3384,94,3,11,14,21.4%,10m
2834,1,[재영]Lule,3384,42,2,4,6,33.3%,11m
2834,1,티벳,3384,0,0,1,1,0.0%,11m
2837,3,ParryGuaGua,3383,926,182,158,340,53.5%,9m
2837,1,打不过就是不够多,3383,860,28,32,60,46.7%,4m
2839,1,[네잎클로버]Maladroit,3382,1236,48,38,86,55.8%,11m
2839,1,WOONGJINvGP,3382,894,28,27,55,50.9%,11m
2839,3,[서울의달]kimseonho,3382,352,11,25,36,30.6%,9m
2842,3,멋진놈이다,3381,1526,163,155,318,51.3%,5m
2843,3,[CL]clgreen,3380,1497,303,290,593,51.1%,9m
2843,1,[Komica]MisterHYC,3380,1362,57,42,99,57.6%,3m
2843,1,[ABCD狗咬]PrimeBlue,3380,814,26,28,54,48.1%,12m
2846,3,IdrAge,3378,1473,85,94,179,47.5%,6m
2846,3,[CIM]지학철민,3378,314,14,9,23,60.9%,5m
2846,1,IIIIIIIIIIII,3378,374,10,9,19,52.6%,6m
2846,3,백마탄사나이,3378,144,7,2,9,77.8%,15m
2846,1,llllllllllll,3378,0,1,1,2,50.0%,44m
2846,3,[星际争霸王]用户一,3378,0,0,5,5,0.0%,9m
2852,3,llllllllllll,3377,1553,258,266,524,49.2%,12m
2852,3,Super,3377,821,34,35,69,49.3%,6m
2852,1,소팔다개된년,3377,44,2,5,7,28.6%,11m
2852,3,midnightcorn,3377,89,1,1,2,50.0%,15m
2856,3,치킨먹고싶다,3376,1543,283,292,575,49.2%,10m
2856,1,llllllllll,3376,1045,65,58,123,52.8%,10m
2856,3,[겨울방어]happyday,3376,0,2,3,5,40.0%,15m
2859,3,키시모토,3375,184,6,16,22,27.3%,11m
2859,1,IlIlIlIlIlIl,3375,89,2,0,2,100.0%,4m
2859,1,페이스다운,3375,0,0,1,1,0.0%,3m
2859,1,lIlIIIllIllI,3375,0,0,1,1,0.0%,11m
2859,1,StarFan,3375,0,0,1,1,0.0%,8m
2864,3,[isnous]BaristaH,3374,1482,237,238,475,49.9%,9m
2864,1,지폭장승,3374,1028,33,34,67,49.3%,9m
2864,1,[6Teen]Dysutopia,3374,356,14,10,24,58.3%,8m
2864,1,호날두두마리치킨,3374,103,5,7,12,41.7%,11m
2864,3,[教我玩狙擊]Kun,3374,160,5,17,22,22.7%,5m
2869,1,[Notice]즐기자,3373,1272,45,46,91,49.5%,3m
2869,1,Bandit,3373,580,31,16,47,66.0%,9m
2869,1,北條悟史,3373,103,2,1,3,66.7%,11m
2869,3,토스만할꼬얌,3373,0,1,0,1,100.0%,47m
2869,1,無常,3373,0,1,0,1,100.0%,8m
2869,1,[VASCO]YSZZZZZZZZZZ,3373,0,0,2,2,0.0%,9m
2875,3,Jazztronik,3372,845,121,127,248,48.8%,5m
2875,1,미끄러,3372,642,59,51,110,53.6%,11m
2875,1,IIIIIIIIIIII,3372,362,19,5,24,79.2%,4m
2875,3,DayDream,3372,271,11,11,22,50.0%,10m
2879,3,[Spades]무등산,3371,1375,72,58,130,55.4%,9m
2879,3,[무한오영종]Nobody,3371,1405,51,60,111,45.9%,12m
2879,1,미친벌레,3371,451,20,12,32,62.5%,8m
2879,3,小丁宝,3371,312,12,10,22,54.5%,6m
2883,1,설사해욤,3370,1161,42,43,85,49.4%,4m
2883,1,omgvi,3370,314,8,12,20,40.0%,4m
2883,1,[대지뇨속]PaperDragon,3370,152,5,4,9,55.6%,8m
2886,1,[5torM]갈아만든배,3369,244,9,9,18,50.0%,12m
2886,1,llllllllllll,3369,156,4,2,6,66.7%,9m
2888,3,Divino,3368,1180,44,53,97,45.4%,12m
2888,1,[수사]MarusParty,3368,627,25,22,47,53.2%,11m
2888,1,[Fenix]레이븐,3368,585,21,17,38,55.3%,3m
2888,1,불꽃너구리,3368,390,10,14,24,41.7%,12m
2888,3,ALitS,3368,0,0,1,1,0.0%,15m
2888,1,춤추고노래해,3368,0,0,1,1,0.0%,11m
2888,3,gogogo,3368,0,0,7,7,0.0%,15m
2895,3,엄태혁,3367,167,11,4,15,73.3%,6m
2895,1,Scotch,3367,40,1,2,3,33.3%,10m
2897,1,llllllllllll,3366,947,101,81,182,55.5%,11m
2897,3,[7HOI]NuclearApple,3366,121,3,3,6,50.0%,15m
2897,3,점순,3366,60,2,11,13,15.4%,11m
2897,1,[AMA]SanJi,3366,0,1,0,1,100.0%,11m
2897,1,AgCl,3366,0,0,2,2,0.0%,12m
2902,3,nonamewind,3365,1540,293,281,574,51.0%,5m
2902,1,[lI]프로토스노답사기,3365,638,26,29,55,47.3%,11m
2902,2,[C84138]Ruin,3365,112,3,4,7,42.9%,10m
2902,1,kms,3365,80,2,8,10,20.0%,12m
2902,1,dkdhdfas,3365,0,1,0,1,100.0%,8m
2902,1,Melon,3365,40,1,4,5,20.0%,11m
2908,3,cheiga,3364,1086,149,154,303,49.2%,5m
2908,3,IIIIIIIIIIII,3364,699,26,32,58,44.8%,6m
2908,1,신민아,3364,82,2,4,6,33.3%,4m
2908,1,gyeonGJun,3364,0,0,1,1,0.0%,6m
2912,3,[패자는피를]쿠니아빠,3363,1185,191,194,385,49.6%,4m
2912,1,Duke,3363,238,10,4,14,71.4%,3m
2912,1,llll,3363,0,0,1,1,0.0%,13m
2915,1,SayfT,3362,715,25,26,51,49.0%,10m
2915,1,[FSHVM]ClimbGoldy,3362,90,3,0,3,100.0%,4m
2917,3,세츠나,3361,588,108,112,220,49.1%,7m
2917,1,카카로트,3361,1125,41,39,80,51.2%,3m
2917,1,IIIIIIIII,3361,0,5,1,6,83.3%,8m
2917,1,끄라스,3361,141,3,2,5,60.0%,10m
2917,1,베이가,3361,90,2,0,2,100.0%,6m
2917,1,엔젤리,3361,0,0,1,1,0.0%,12m
2923,3,히뱀히뱀,3360,575,36,43,79,45.6%,9m
2923,1,AmateSmallR,3360,461,14,13,27,51.9%,10m
2923,1,OverLoading,3360,0,0,1,1,0.0%,12m
2923,2,IIIIIIIIIIII,3360,0,0,1,1,0.0%,45m
2927,3,아칸,3359,1166,89,109,198,44.9%,5m
2927,3,장동건,3359,687,67,74,141,47.5%,5m
2927,3,foREVer,3359,267,12,10,22,54.5%,6m
2927,2,IIIIIllllllI,3359,72,3,1,4,75.0%,4m
2927,2,[HuIIII]Moose,3359,93,1,1,2,50.0%,45m
2927,2,[SCTW]EzpAlpha,3359,0,0,1,1,0.0%,10m
2933,3,llllllll,3358,1408,159,158,317,50.2%,12m
2933,1,Borat,3358,1151,47,33,80,58.8%,6m
2933,1,Thanatos,3358,383,16,13,29,55.2%,8m
2933,1,김한수,3358,406,12,9,21,57.1%,4m
2933,1,trekking,3358,352,10,16,26,38.5%,4m
2933,1,ShoeLugs,3358,0,1,2,3,33.3%,12m
2933,2,Tim,3358,0,0,1,1,0.0%,4m
2940,1,旯牙,3357,1360,159,133,292,54.5%,11m
2940,1,ILILILILI,3357,1405,53,45,98,54.1%,6m
2940,1,StRiker,3357,0,1,1,2,50.0%,10m
2940,1,[ELS]초월,3357,0,0,3,3,0.0%,6m
2944,3,Beaver,3356,519,30,52,82,36.6%,4m
2944,1,TooTo,3356,307,10,12,22,45.5%,9m
2944,3,요실금아재,3356,147,7,3,10,70.0%,47m
2944,1,[제5공화국]느금마문타리,3356,0,0,2,2,0.0%,6m
2948,1,Daniel,3355,701,92,76,168,54.8%,11m
2948,1,[Old]小異形,3355,547,73,63,136,53.7%,11m
2948,1,IlllIllIllI,3355,428,19,15,34,55.9%,3m
2948,3,PBXintAgliO,3355,180,6,1,7,85.7%,8m
2948,3,CUJS,3355,126,4,15,19,21.1%,4m
2948,2,llllllllll,3355,0,1,0,1,100.0%,10m
2948,1,[SI]教我上鑽石,3355,0,1,1,2,50.0%,3m
2955,1,POTKH,3354,729,26,20,46,56.5%,11m
2955,2,[멘탈hub]멘탈붕괴,3354,175,6,7,13,46.2%,5m
2955,2,[Snacks]홈런볼,3354,30,2,0,2,100.0%,6m
2955,2,[즐겜유저연합]Jukchang,3354,30,2,0,2,100.0%,6m
2955,1,BravoSix,3354,90,1,2,3,33.3%,11m
2960,3,김수현,3353,1515,180,175,355,50.7%,10m
2960,2,IronY,3353,0,1,0,1,100.0%,6m
2960,1,KONG,3353,42,1,6,7,14.3%,11m
2963,1,바코드,3351,490,22,10,32,68.8%,12m
2963,3,DURUDURU,3351,345,16,8,24,66.7%,4m
2963,1,rlawogks,3351,462,13,17,30,43.3%,12m
2963,1,Apple,3351,0,5,0,5,100.0%,14m
2967,1,omgitsduane,3350,540,24,13,37,64.9%,8m
2967,1,夜露死苦,3350,664,19,25,44,43.2%,9m
2967,1,躺著比你坐著高,3350,266,6,7,13,46.2%,10m
2967,2,김지혜,3350,147,5,3,8,62.5%,11m
2967,3,[무리무리팸]IIlIIlllIIll,3350,145,4,4,8,50.0%,5m
2972,1,llllllllllll,3349,230,6,9,15,40.0%,8m
2973,1,llllllllllll,3348,1082,55,38,93,59.1%,12m
2973,1,DarkWolf,3348,48,3,2,5,60.0%,22m
2973,1,SoS,3348,0,1,1,2,50.0%,12m
2976,1,Encounter,3347,614,25,20,45,55.6%,9m
2976,2,KnowOne,3347,387,17,9,26,65.4%,6m
2976,1,오빠차화염차,3347,173,7,2,9,77.8%,12m
2976,1,skinnerbox,3347,28,1,3,4,25.0%,11m
2980,2,타우렌드루이드,3346,367,14,13,27,51.9%,5m
2980,2,[향기로운]깔루아향기,3346,109,7,4,11,63.6%,4m
2980,1,유기농딸기우유,3346,48,5,1,6,83.3%,14m
2980,3,[TheDOH]BadBug,3346,0,1,0,1,100.0%,5m
2980,1,YUK,3346,0,1,1,2,50.0%,4m
2985,1,IIIIIIIIIIII,3345,569,16,16,32,50.0%,9m
2985,1,DEXTER,3345,0,2,4,6,33.3%,13m
2985,2,ktm,3345,0,0,1,1,0.0%,9m
2988,1,GHaywardBOS,3344,1545,185,176,361,51.2%,4m
2988,2,한글공부,3344,0,1,0,1,100.0%,6m
2988,2,llllllllllll,3344,0,0,1,1,0.0%,11m
2991,1,김쿵짝,3343,1659,94,89,183,51.4%,12m
2991,1,저그매,3343,621,33,27,60,55.0%,10m
2991,1,BoM,3343,268,8,7,15,53.3%,11m
2991,2,llllllllll,3343,0,1,0,1,100.0%,5m
2991,3,uno,3343,0,1,0,1,100.0%,12m
2991,2,[육즙가득잔슨]ewigwiederke,3343,30,1,1,2,50.0%,6m
2991,1,김민규,3343,48,1,5,6,16.7%,44m
2998,1,마시멜롱,3342,1651,115,109,224,51.3%,11m
2998,1,[Kyou9]AnotherBirth,3342,1148,44,39,83,53.0%,11m
2998,1,Ronaldo,3342,728,28,25,53,52.8%,8m
2998,1,상묵이오빠,3342,368,11,13,24,45.8%,8m
2998,1,[니코틴패스]벤젠,3342,137,5,1,6,83.3%,3m
2998,2,NucL,3342,96,4,5,9,44.4%,6m
3004,2,솔지늬,3341,126,4,3,7,57.1%,12m
3004,1,Sri,3341,126,3,2,5,60.0%,12m
3006,3,Pcikilo,3339,731,128,132,260,49.2%,8m
3006,1,복수의화신,3339,380,13,12,25,52.0%,11m
3006,3,dlwsn,3339,58,3,11,14,21.4%,9m
3006,2,[저징징TT]저그가무슨죄냐,3339,0,0,2,2,0.0%,11m
3006,1,Elkeson,3339,0,0,7,7,0.0%,11m
3011,2,xxproxy,3338,0,1,0,1,100.0%,6m
3011,1,RoYal,3338,0,1,4,5,20.0%,13m
3011,1,[일반인원탑]aafs,3338,0,0,5,5,0.0%,8m
3014,1,SoulAngel,3337,1558,130,121,251,51.8%,4m
3014,3,amwayking,3337,806,46,51,97,47.4%,9m
3014,2,Yalos,3337,0,4,1,5,80.0%,9m
3017,2,순수한,3336,874,34,30,64,53.1%,9m
3017,1,kimyoungs,3336,211,7,6,13,53.8%,9m
3017,1,MaoLeengs,3336,30,1,6,7,14.3%,12m
3020,3,주율,3335,1136,39,57,96,40.6%,6m
3020,1,TKingMax,3335,869,35,29,64,54.7%,9m
3020,2,BlueShrimp,3335,444,17,12,29,58.6%,10m
3020,1,얀아낭,3335,141,4,3,7,57.1%,10m
3020,2,김성태,3335,34,1,1,2,50.0%,9m
3020,1,NukeWinter,3335,0,0,6,6,0.0%,4m
3026,1,One,3334,722,41,41,82,50.0%,10m
3026,1,[패자는피를]깨알컨트롤,3334,1000,32,36,68,47.1%,4m
3026,1,IIIIIIIIIIII,3334,314,12,6,18,66.7%,11m
3026,1,IIIIIIIIIII,3334,392,11,16,27,40.7%,4m
3026,1,Qoo,3334,97,4,2,6,66.7%,13m
3026,1,[한타왕]Adol,3334,76,2,7,9,22.2%,11m
3032,1,[선인장]선인장,3333,730,25,21,46,54.3%,9m
3032,2,Kraw,3333,0,1,0,1,100.0%,7m
3034,2,MASeraTyO,3332,598,26,17,43,60.5%,12m
3034,1,대박이달님이,3332,128,4,5,9,44.4%,4m
3034,2,prosyoung,3332,32,1,3,4,25.0%,4m
3034,2,武漢肺炎中國製造,3332,0,0,1,1,0.0%,9m
3034,2,sesame,3332,0,0,1,1,0.0%,4m
3039,3,Shark,3331,918,32,40,72,44.4%,9m
3039,3,[예쁜김다미]니뒤통수에한발,3331,96,1,2,3,33.3%,9m
3039,1,[SofT]이미진경기,3331,36,1,4,5,20.0%,11m
3039,2,Madoka,3331,0,0,2,2,0.0%,6m
3043,3,[원자폭탄]YELO,3330,702,24,32,56,42.9%,8m
3043,2,Rainlow,3330,262,11,8,19,57.9%,11m
3043,2,ElGatoRaul,3330,30,5,1,6,83.3%,5m
3043,3,Lemuel,3330,126,4,15,19,21.1%,5m
3043,2,櫧騔湸,3330,0,1,0,1,100.0%,4m
3048,2,Rask,3329,558,22,16,38,57.9%,6m
3048,2,FanTa,3329,0,1,0,1,100.0%,11m
3048,2,리덕제,3329,32,1,2,3,33.3%,11m
3051,1,Matryoshka,3328,213,10,4,14,71.4%,12m
3051,2,TooLazy,3328,143,6,3,9,66.7%,47m
3051,1,외계인,3328,150,4,11,15,26.7%,8m
3054,2,SparkleHands,3327,182,5,4,9,55.6%,46m
3054,2,kwceo,3327,0,1,0,1,100.0%,10m
3054,2,[협동전콜걸]jsyoon,3327,0,1,0,1,100.0%,4m
3054,1,llllllll,3327,42,1,6,7,14.3%,12m
3054,2,좀비복어,3327,0,0,1,1,0.0%,5m
3059,1,[快樂玩家]LUKEKUANG,3326,1069,38,35,73,52.1%,10m
3059,2,Oak,3326,30,1,2,3,33.3%,11m
3061,3,데몬헌터,3325,1428,100,91,191,52.4%,5m
3061,1,MareNostrum,3325,634,25,25,50,50.0%,12m
3061,1,Affha,3325,218,7,2,9,77.8%,44m
3061,1,[원자폭탄]게으름뱅이,3325,162,3,4,7,42.9%,4m
3061,2,없어요,3325,32,2,1,3,66.7%,11m
3061,2,TCY,3325,0,1,0,1,100.0%,5m
3061,1,[TheDOH]強勇集團,3325,88,1,3,4,25.0%,11m
3061,2,모든지쏜다,3325,0,0,2,2,0.0%,5m
3069,1,aiteno,3324,831,96,96,192,50.0%,11m
3069,2,아니이이,3324,665,28,15,43,65.1%,12m
3071,3,yamaoka,3323,1469,217,222,439,49.4%,3m
3071,1,쿠워니,3323,1345,47,50,97,48.5%,11m
3071,1,[HINA]Mitsuha,3323,228,11,5,16,68.8%,12m
3071,2,pilot,3323,268,9,4,13,69.2%,9m
3071,2,NEXtaesung,3323,0,0,2,2,0.0%,12m
3076,1,AVOIR,3322,268,14,6,20,70.0%,9m
3076,2,[TalenT]iiiiiiii,3322,0,0,1,1,0.0%,3m
3078,1,Gin,3321,1162,83,60,143,58.0%,12m
3078,1,[sc2mc]Baekje,3321,114,3,6,9,33.3%,11m
3080,1,skead,3320,1633,59,55,114,51.8%,10m
3080,1,[래핑코빈]코스모스,3320,105,3,2,5,60.0%,12m
3080,2,[붉은혁명]KorMarineGW,3320,0,0,1,1,0.0%,4m
3083,3,[Equal]CoMMuNaL,3319,1543,182,176,358,50.8%,4m
3083,1,CooooooooooL,3319,198,9,13,22,40.9%,4m
3083,2,WoletarZero,3319,141,7,4,11,63.6%,46m
3083,3,TopRamen,3319,30,2,1,3,66.7%,9m
3087,3,[TalenT]Virus,3318,1565,639,623,1262,50.6%,4m
3087,1,咩咩咩代書,3318,1651,176,176,352,50.0%,11m
3087,1,LEFT,3318,886,35,36,71,49.3%,12m
3090,2,완소남,3317,187,6,1,7,85.7%,6m
3090,2,JERRY,3317,118,4,4,8,50.0%,10m
3090,2,Rusien,3317,0,1,0,1,100.0%,7m
3090,1,BlueShark,3317,0,0,6,6,0.0%,8m
3094,1,卡哇伊,3316,366,45,35,80,56.2%,12m
3094,1,sapphire,3316,514,15,16,31,48.4%,9m
3094,2,llllllllll,3316,234,8,3,11,72.7%,10m
3094,3,[몷루]뷰릇뷰릇헤으응,3316,114,5,13,18,27.8%,5m
3094,1,비정한인연,3316,48,4,3,7,57.1%,14m
3094,2,이겜망겜,3316,0,0,1,1,0.0%,6m
3094,3,사우스파크,3316,0,0,2,2,0.0%,47m
3094,2,[캬취한다]아이디찾은김웅비,3316,0,0,2,2,0.0%,10m
3102,1,987001604181,3315,149,21,20,41,51.2%,11m
3102,1,스투망해라,3315,283,9,8,17,52.9%,6m
3102,1,Koi,3315,159,5,1,6,83.3%,45m
3102,1,얼큰하구만,3315,140,4,7,11,36.4%,12m
3102,1,[ANSW2R]Life,3315,162,3,6,9,33.3%,8m
3102,2,lIlIlIlIlIlI,3315,0,1,0,1,100.0%,4m
3108,3,일루미,3314,342,12,24,36,33.3%,10m
3108,2,[걸스데이]llllllllllll,3314,192,5,4,9,55.6%,11m
3108,1,zzzzzz,3314,0,4,1,5,80.0%,14m
3108,2,[여자친구으나]윤덕,3314,0,0,1,1,0.0%,12m
3112,2,짜빈,3313,146,6,2,8,75.0%,11m
3112,2,BigFungus,3313,124,5,4,9,55.6%,4m
3112,2,[크리에이터]Twitch,3313,0,1,1,2,50.0%,6m
3115,1,글그림,3312,1272,77,56,133,57.9%,12m
3115,1,Ricky,3312,686,33,20,53,62.3%,9m
3115,3,[NTUeS]Year,3312,738,25,34,59,42.4%,6m
3115,2,ALTENA,3312,534,20,13,33,60.6%,4m
3115,1,Nori,3312,169,5,6,11,45.5%,6m
3115,2,[맹독충기여어]changE,3312,46,1,1,2,50.0%,46m
3115,2,apple,3312,30,1,3,4,25.0%,9m
3122,3,강동원,3311,1430,259,242,501,51.7%,12m
3122,1,끝판왕또치,3311,1697,250,245,495,50.5%,4m
3122,2,식이당,3311,210,7,5,12,58.3%,3m
3122,1,IIIIIIIIIIII,3311,27,2,6,8,25.0%,4m
3122,2,devsd,3311,32,1,2,3,33.3%,11m
3122,1,붉은망토,3311,38,1,5,6,16.7%,4m
3128,2,[대테란자치령]llllllllllll,3310,338,11,14,25,44.0%,4m
3128,2,[ANGG]사과는애플,3310,174,7,3,10,70.0%,3m
3128,1,공포의맞춤법,3310,220,7,10,17,41.2%,10m
3128,2,[뿌야]틀니압수,3310,60,3,0,3,100.0%,10m
3128,2,잡금혐오를멈춰,3310,62,3,2,5,60.0%,6m
3128,2,[500원]앙기모찌요,3310,0,1,0,1,100.0%,11m
3134,3,DoTheCreep,3309,171,8,3,11,72.7%,15m
3134,2,llllllllllll,3309,128,4,3,7,57.1%,4m
3134,2,MarGarita,3309,58,3,1,4,75.0%,6m
3134,2,PINENOVA,3309,36,2,3,5,40.0%,3m
3134,1,binIKbin,3309,40,2,3,5,40.0%,4m
3134,2,螢雪之功,3309,58,2,5,7,28.6%,7m
3140,1,호접몽,3308,117,9,8,17,52.9%,4m
3140,1,nurimaro,3308,72,2,7,9,22.2%,9m
3140,2,Say,3308,0,0,2,2,0.0%,9m
3143,2,[갯벌]면빨,3307,321,14,6,20,70.0%,7m
3143,2,[Aslan]Absolute,3307,0,0,1,1,0.0%,10m
3143,2,[이터널]고구마,3307,0,0,1,1,0.0%,4m
3146,1,대풍이,3306,933,29,31,60,48.3%,11m
3146,1,llllllllllll,3306,0,1,1,2,50.0%,12m
3148,1,장동건,3305,222,7,6,13,53.8%,8m
3148,2,BrUtAl,3305,58,3,1,4,75.0%,4m
3148,2,IIIIIIIIII,3305,36,2,3,5,40.0%,4m
3148,2,이게게임이냐,3305,0,1,1,2,50.0%,4m
3152,1,끼룩끼룩,3304,1618,343,315,658,52.1%,6m
3152,3,Falling,3304,234,6,11,17,35.3%,6m
3152,2,sword,3304,30,2,0,2,100.0%,10m
3152,1,[15GG]우헬헬,3304,40,1,5,6,16.7%,4m
3156,1,Austen,3303,708,35,22,57,61.4%,3m
3156,3,lIlIlIlllIlI,3303,58,13,25,38,34.2%,4m
3156,3,두루미횡격막,3303,246,9,22,31,29.0%,12m
3156,1,흑염소,3303,0,1,7,8,12.5%,11m
3156,2,[꼰머]whaudrl,3303,0,0,1,1,0.0%,9m
3156,2,Jaga,3303,0,0,1,1,0.0%,9m
3156,2,재머슈,3303,0,0,1,1,0.0%,11m
3163,2,逆命,3302,384,22,4,26,84.6%,11m
3163,2,주노임돠,3302,366,14,11,25,56.0%,6m
3163,2,Bottchi,3302,200,7,6,13,53.8%,4m
3163,1,멀쳐다봐,3302,183,6,2,8,75.0%,14m
3163,1,Bezerger,3302,48,5,2,7,71.4%,22m
3163,2,LJS,3302,0,1,0,1,100.0%,4m
3163,2,케로그,3302,0,1,2,3,33.3%,4m
3163,2,SSFWL,3302,0,0,1,1,0.0%,6m
3163,1,FerrariCodeK,3302,0,0,1,1,0.0%,14m
3172,3,worryburry,3301,1527,286,287,573,49.9%,4m
3172,1,혁준이,3301,0,3,2,5,60.0%,13m
3174,2,農村武裝青年,3300,1584,173,142,315,54.9%,11m
3174,2,llllllllllII,3300,580,22,19,41,53.7%,4m
3174,1,JimVarney,3300,82,2,8,10,20.0%,4m
3174,2,[김튜나]참치,3300,0,1,0,1,100.0%,12m
3178,2,Ogedei,3299,558,132,111,243,54.3%,4m
3178,3,소녀시대윤아,3299,876,39,50,89,43.8%,10m
3178,3,AliceOU,3299,159,3,10,13,23.1%,15m
3178,2,EterNaL,3299,0,0,2,2,0.0%,5m
3178,2,IlIlIlIlIlIl,3299,0,0,3,3,0.0%,46m
3183,1,RandomBOX,3298,586,23,16,39,59.0%,12m
3183,2,[비트]lIlIlIlIlIlI,3298,520,18,17,35,51.4%,9m
3183,2,Jingyu,3298,88,5,1,6,83.3%,9m
3186,1,Nabitgaru,3297,1453,69,54,123,56.1%,6m
3186,2,MingKynism,3297,729,30,19,49,61.2%,7m
3186,1,glhf,3297,298,14,9,23,60.9%,4m
3186,2,Megumin,3297,336,13,10,23,56.5%,6m
3186,2,Yurui,3297,0,1,0,1,100.0%,7m
3186,2,[ABCDE]StormWind,3297,0,0,1,1,0.0%,46m
3186,2,Stress,3297,0,0,2,2,0.0%,6m
3193,2,[Old]RealiSe,3296,684,24,25,49,49.0%,11m
3193,2,경산프로토스,3296,30,2,0,2,100.0%,5m
3193,2,[찹쌀모찌]츄릅츄릅,3296,0,0,2,2,0.0%,4m
3196,2,Ruscello,3295,66,3,2,5,60.0%,10m
3196,1,PowerTemplar,3295,0,0,1,1,0.0%,13m
3198,1,KTKMAN,3294,1610,297,286,583,50.9%,11m
3198,3,[무한오영종]동부의빛,3294,1467,184,191,375,49.1%,5m
3198,3,KazSeok,3294,1248,75,71,146,51.4%,6m
3198,3,dogsas,3294,718,25,41,66,37.9%,8m
3198,2,[GIS]我真無聊啊,3294,30,2,3,5,40.0%,6m
3203,1,Shinewarrior,3293,659,20,26,46,43.5%,4m
3203,1,IIIIIIIIIII,3293,337,16,14,30,53.3%,5m
3203,2,IIIIIIIIIIII,3293,32,1,3,4,25.0%,4m
3203,2,Yue,3293,0,0,1,1,0.0%,5m
3207,1,SwarmOfZasz,3292,984,35,34,69,50.7%,10m
3207,2,[1129]jacky,3292,0,1,0,1,100.0%,10m
3209,1,Schrodinger,3290,1664,170,165,335,50.7%,12m
3209,3,llllllllllll,3290,97,5,3,8,62.5%,47m
3209,2,신이라불러라,3290,64,2,4,6,33.3%,4m
3209,2,fmgreen,3290,0,1,0,1,100.0%,4m
3209,2,Calegon,3290,30,1,2,3,33.3%,4m
3209,2,알래스카,3290,0,1,8,9,11.1%,46m
3215,3,[시스테마]날개뜯자,3289,1497,102,115,217,47.0%,4m
3215,2,MRguyman,3289,800,34,24,58,58.6%,4m
3215,1,SirBlahDBlah,3289,343,15,13,28,53.6%,12m
3215,3,[灭棒敢死队]抗韩奇侠燕又鹰,3289,97,2,2,4,50.0%,47m
3215,2,니미,3289,30,1,1,2,50.0%,11m
3220,1,Ironbull,3288,481,78,79,157,49.7%,5m
3220,2,llIIlIIIIlIl,3288,252,8,8,16,50.0%,9m
3220,2,[快樂玩家]Phil,3288,34,2,0,2,100.0%,6m
3223,1,KARAKURT,3287,371,10,13,23,43.5%,9m
3224,3,우유사세요,3286,236,8,7,15,53.3%,10m
3224,1,[LoteM]jsh,3286,76,2,7,9,22.2%,8m
3226,2,SaSaSin,3285,30,1,3,4,25.0%,12m
3226,2,亞特奇恩,3285,0,0,1,1,0.0%,4m
3228,2,알비노과배금용,3284,0,1,0,1,100.0%,5m
3228,3,[어둠의사신단]어둠의검신,3284,0,1,7,8,12.5%,15m
3230,1,심신,3283,569,21,22,43,48.8%,11m
3230,2,[보돌]Woo,3283,176,6,8,14,42.9%,4m
3230,2,KelsierOrz,3283,0,0,1,1,0.0%,12m
3233,1,[로스타]루마니아,3282,699,35,36,71,49.3%,12m
3233,2,hero,3282,372,23,13,36,63.9%,9m
3233,2,고르아마신,3282,328,10,15,25,40.0%,10m
3236,1,붕여킹,3281,851,37,41,78,47.4%,11m
3236,2,Cosmos,3281,392,13,10,23,56.5%,9m
3236,1,IIIIIIIIIIII,3281,170,5,1,6,83.3%,43m
3236,2,[러블리걸]까칠한쩡이,3281,58,4,4,8,50.0%,11m
3236,1,Grim,3281,144,4,8,12,33.3%,11m
3236,2,아이돌백과사전,3281,0,1,1,2,50.0%,4m
3236,1,[래더납치범]sukima,3281,0,1,4,5,20.0%,11m
3243,1,MinGslam,3280,765,26,25,51,51.0%,5m
3244,2,[MDC]Wanderlust,3279,1577,107,87,194,55.2%,11m
3244,2,Loke,3279,522,21,12,33,63.6%,11m
3244,1,쿠쿨자의어머니,3279,200,9,6,15,60.0%,6m
3244,1,DZR,3279,177,4,6,10,40.0%,8m
3244,2,[BIDEN]JoeBiden,3279,60,3,3,6,50.0%,5m
3244,2,[프통령]개츠비,3279,30,1,2,3,33.3%,11m
3250,1,사무엘,3278,1642,87,74,161,54.0%,10m
3250,2,[xTMDx]rexisbast,3278,1177,82,59,141,58.2%,5m
3250,2,payson,3278,526,19,10,29,65.5%,10m
3250,2,somesso,3278,0,0,1,1,0.0%,6m
3254,2,Pepsi,3277,42,2,2,4,50.0%,46m
3254,1,AreYouOk,3277,0,0,2,2,0.0%,14m
3256,1,[xTMDx]Nick,3276,861,71,79,150,47.3%,12m
3256,1,[초보동맹]Kim,3276,416,17,18,35,48.6%,4m
3256,2,IMViPSpC,3276,166,5,2,7,71.4%,5m
3256,2,[캬루]유다이,3276,32,2,3,5,40.0%,4m
3260,2,SCnavi,3275,222,17,10,27,63.0%,5m
3260,2,aaaaaaaaaaaa,3275,426,15,16,31,48.4%,9m
3260,2,[WDY]스린이테란,3275,292,10,6,16,62.5%,5m
3260,1,멸자는사기라구욧,3275,276,8,11,19,42.1%,11m
3264,2,[禿頭肥寶]FISHXDXDXD,3274,52,6,7,13,46.2%,4m
3264,2,舒克,3274,0,1,0,1,100.0%,10m
3266,2,WickedSick,3273,884,38,29,67,56.7%,10m
3266,1,예쁜척추,3273,268,10,9,19,52.6%,12m
3266,2,KingStar,3273,211,8,6,14,57.1%,11m
3269,1,Max,3271,752,28,25,53,52.8%,12m
3269,2,Akassia,3271,229,10,4,14,71.4%,6m
3269,2,[meruwu]ururem,3271,0,0,3,3,0.0%,11m
3272,1,IIIlIIIlllII,3270,1443,51,54,105,48.6%,12m
3272,2,WYC,3270,240,9,7,16,56.2%,3m
3272,2,묘야,3270,204,7,7,14,50.0%,10m
3272,2,IIIIIIIIIIII,3270,118,5,3,8,62.5%,4m
3276,1,[TNO]likefish,3269,1036,40,37,77,51.9%,11m
3276,1,Neeb,3269,578,23,21,44,52.3%,9m
3276,1,SmackDonkey,3269,176,5,16,21,23.8%,10m
3276,2,[홍콩행제리바]cpp,3269,58,3,1,4,75.0%,12m
3280,3,fug,3268,1450,373,370,743,50.2%,12m
3280,3,상무지구,3268,1129,40,52,92,43.5%,5m
3280,2,llllllllllll,3268,184,5,2,7,71.4%,3m
3280,2,rekuna,3268,94,4,2,6,66.7%,6m
3280,2,GLHF,3268,0,3,3,6,50.0%,6m
3280,2,你媽死了,3268,0,1,0,1,100.0%,11m
3280,2,Gazelle,3268,32,1,1,2,50.0%,10m
3280,2,[달빛양념기사]GetaHu,3268,0,0,1,1,0.0%,4m
3280,2,STYLISH,3268,0,0,2,2,0.0%,4m
3289,2,[D3StaR]llllllllllll,3267,464,22,7,29,75.9%,7m
3289,3,[무리무리팸]메롱,3267,374,12,26,38,31.6%,10m
3289,1,[클랜같은클랜]변현우,3267,122,3,10,13,23.1%,5m
3292,2,REVER,3266,30,2,0,2,100.0%,4m
3292,2,온니성기사,3266,0,0,1,1,0.0%,46m
3294,1,StarsALot,3265,300,11,10,21,52.4%,44m
3294,2,IIiiIIiiiiii,3265,88,3,4,7,42.9%,4m
3294,2,[ELSII]위성락,3265,0,1,1,2,50.0%,4m
3294,2,chayongjun,3265,0,1,4,5,20.0%,12m
3294,1,살사킹,3265,0,0,3,3,0.0%,14m
3299,1,llllllllllll,3264,1568,87,69,156,55.8%,4m
3299,2,Kumiko,3264,670,27,20,47,57.4%,12m
3299,1,[RCK]熊貓戰士強化版,3264,743,26,27,53,49.1%,12m
3299,3,[Lotuz]vividrabbit,3264,624,19,37,56,33.9%,3m
3299,1,Macrophage,3264,124,4,11,15,26.7%,4m
3299,2,김신곤,3264,119,3,3,6,50.0%,4m
3299,1,BrOkEn,3264,48,3,5,8,37.5%,14m
3299,2,[探測機公會]愛過了才知道痛,3264,0,1,0,1,100.0%,11m
3307,3,[독일국방군]BrandnewTG,3263,339,15,9,24,62.5%,1m
3307,2,[深耕C]silverfox,3263,350,14,7,21,66.7%,11m
3307,2,ImPosSiblE,3263,192,6,2,8,75.0%,4m
3307,1,icantwin,3263,97,5,2,7,71.4%,14m
3307,2,Berserk,3263,60,2,4,6,33.3%,6m
3307,2,[노잼]보라노아바,3263,0,1,0,1,100.0%,4m
3307,1,rlaalsrlek,3263,0,1,0,1,100.0%,13m
3307,2,[게이왕]Manu,3263,0,0,2,2,0.0%,46m
3315,2,우치하상타치,3262,58,3,3,6,50.0%,2m
3315,2,SHADOW,3262,0,0,1,1,0.0%,7m
3315,2,Players,3262,0,0,2,2,0.0%,5m
3315,2,boocolli,3262,0,0,2,2,0.0%,12m
3319,1,漢力克,3261,1599,149,130,279,53.4%,4m
3319,2,miraclian,3261,1088,41,42,83,49.4%,4m
3319,2,GangnamStyle,3261,921,38,30,68,55.9%,5m
3319,3,FairyTale,3261,163,13,9,22,59.1%,6m
3319,1,boogeyman,3261,283,12,7,19,63.2%,45m
3319,1,[ER]ErSmallTwo,3261,378,11,15,26,42.3%,11m
3319,2,테란만,3261,0,1,4,5,20.0%,4m
3319,2,[피비언니]양혜지,3261,0,0,1,1,0.0%,4m
3327,1,jude,3260,886,28,37,65,43.1%,3m
3327,2,silk,3260,273,15,14,29,51.7%,1m
3327,1,[여친정예린팬]Faker,3260,244,6,9,15,40.0%,4m
3327,1,Lambda,3260,0,4,1,5,80.0%,14m
3327,1,나기,3260,134,4,7,11,36.4%,5m
3327,2,예비군홍콩,3260,72,3,5,8,37.5%,4m
3327,2,MVPLegend,3260,30,2,0,2,100.0%,1m
3327,2,섹쉬나딸구,3260,0,0,1,1,0.0%,6m
3335,1,인사안받아줌,3259,531,43,21,64,67.2%,3m
3335,2,YSYS,3259,0,2,4,6,33.3%,12m
3335,2,chemistry,3259,0,1,1,2,50.0%,11m
3335,3,Punch,3259,92,1,3,4,25.0%,15m
3339,1,막시무스,3258,398,31,22,53,58.5%,1m
3339,1,고위기사,3258,535,16,22,38,42.1%,2m
3339,1,DNA,3258,288,15,10,25,60.0%,4m
3339,2,[sc2mc]qst,3258,343,12,8,20,60.0%,11m
3339,2,테스형,3258,0,1,1,2,50.0%,5m
3344,2,전설의뽀야,3257,1524,80,71,151,53.0%,2m
3344,2,UTAKATA,3257,415,21,14,35,60.0%,7m
3344,2,MyStyLe,3257,114,4,2,6,66.7%,5m
3344,2,HardCode,3257,92,4,3,7,57.1%,12m
3348,1,Tenggu,3256,1601,123,110,233,52.8%,12m
3348,2,IIllIIlllIIl,3256,1345,82,63,145,56.6%,5m
3348,1,rlawnsghd,3256,1431,55,50,105,52.4%,12m
3348,2,ALT,3256,418,18,13,31,58.1%,1m
3348,1,[krtag]llllllllllll,3256,198,10,6,16,62.5%,11m
3348,2,PLU,3256,234,7,5,12,58.3%,4m
3348,2,[짭페셜]젤나가의노예,3256,116,3,0,3,100.0%,2m
3348,2,[말랑말랑]애긔븝미,3256,0,1,1,2,50.0%,4m
3348,2,Vortix,3256,0,0,3,3,0.0%,5m
3357,1,Giskya,3254,975,59,66,125,47.2%,11m
3357,2,[팝팝팝]TossSagi,3254,890,34,28,62,54.8%,1m
3357,1,알아서,3254,432,16,19,35,45.7%,3m
3357,2,[只會喝可樂]教我玩蟲族可樂,3254,279,14,11,25,56.0%,4m
3357,1,LetsGarret,3254,204,5,8,13,38.5%,3m
3357,2,Hunta,3254,0,3,1,4,75.0%,21m
3363,1,Kangshin,3253,1645,162,166,328,49.4%,5m
3363,3,DEUX,3253,144,4,1,5,80.0%,47m
3363,2,prettydt,3253,30,2,3,5,40.0%,6m
3363,2,[SRNs]요쩨비,3253,0,0,1,1,0.0%,1m
3367,1,[TF]sOsaeggi,3252,350,11,17,28,39.3%,1m
3367,2,LongChi,3252,30,1,2,3,33.3%,4m
3367,2,fsdssdaaaa,3252,32,1,5,6,16.7%,4m
3370,3,[한타왕]류혜,3251,808,49,56,105,46.7%,3m
3370,2,퀴지니에,3251,416,15,13,28,53.6%,4m
3370,2,OnGLeaDer,3251,158,8,4,12,66.7%,12m
3370,2,[낭낭하게]GoRaeDa,3251,58,3,0,3,100.0%,2m
3374,1,산적,3250,1549,339,319,658,51.5%,4m
3374,3,[TalenT]又做壞事好賤喔,3250,455,120,113,233,51.5%,5m
3374,2,신중한어텍,3250,793,40,40,80,50.0%,4m
3374,2,lIlIlIlIllII,3250,0,1,0,1,100.0%,5m
3378,2,Roman,3249,1153,138,131,269,51.3%,4m
3378,1,SangDoo,3249,474,18,27,45,40.0%,4m
3378,2,[SofT]트와이스다현,3249,140,4,1,5,80.0%,4m
3378,2,[천방지축]짱구,3249,122,4,6,10,40.0%,11m
3382,2,Mayshowgunmo,3248,248,8,12,20,40.0%,2m
3382,2,[CIM]내가고자라니,3248,34,1,3,4,25.0%,1m
3382,2,Altas,3248,0,0,1,1,0.0%,4m
3385,3,GKEY,3247,1544,322,327,649,49.6%,1m
3385,3,flowerstory,3247,241,10,11,21,47.6%,12m
3385,2,[구체적날빌]둥둥,3247,0,2,0,2,100.0%,21m
3385,1,[마린드랍]니알빠없자나,3247,80,2,9,11,18.2%,3m
3385,2,[깜냥깜냥]계란빵,3247,0,0,1,1,0.0%,1m
3390,1,Merona,3246,456,21,26,47,44.7%,5m
3390,2,연미트,3246,276,10,9,19,52.6%,2m
3390,2,군단의매장,3246,0,4,1,5,80.0%,21m
3390,2,Sibyl,3246,76,3,2,5,60.0%,4m
3390,2,SecretWeapon,3246,0,0,1,1,0.0%,4m
3395,2,ClayJ,3245,152,6,4,10,60.0%,2m
3396,2,Karena,3244,756,36,27,63,57.1%,5m
3396,1,None,3244,472,17,17,34,50.0%,12m
3396,2,AzrealBrian,3244,133,6,3,9,66.7%,4m
3396,2,[3RAres]저글링엄마,3244,166,4,4,8,50.0%,12m
3396,2,crocodile,3244,0,1,2,3,33.3%,4m
3396,2,갈매기,3244,0,0,2,2,0.0%,11m
3396,2,[갓보]내가바로돌짭새,3244,0,0,3,3,0.0%,11m
3403,2,Queenzbeat,3243,1528,287,272,559,51.3%,4m
3403,2,[아르아르]lllIIllllII,3243,482,18,13,31,58.1%,2m
3403,2,RWQ,3243,102,3,0,3,100.0%,7m
3403,2,Amson,3243,62,3,6,9,33.3%,5m
3403,2,[록타르오가르]부오오,3243,0,0,1,1,0.0%,11m
3408,2,큰털보,3242,726,26,24,50,52.0%,5m
3408,2,[섬광]베틀전함,3242,144,4,2,6,66.7%,4m
3408,2,[원자폭탄]전사삼,3242,136,3,1,4,75.0%,6m
3408,2,NvrGoFurther,3242,0,1,0,1,100.0%,6m
3412,1,Mystylestorm,3241,1617,65,72,137,47.4%,12m
3412,1,MOON,3241,266,13,8,21,61.9%,12m
3412,2,OopsReach,3241,211,5,13,18,27.8%,5m
3412,2,BeatGD,3241,118,4,7,11,36.4%,2m
3412,2,[무리무리팸]MerCurial,3241,30,1,3,4,25.0%,11m
3412,2,ShocK,3241,0,0,3,3,0.0%,2m
3418,1,[한화]周星馳,3240,1207,71,70,141,50.4%,3m
3418,1,침대위여우,3240,753,23,33,56,41.1%,3m
3418,2,Galaxy,3240,0,4,1,5,80.0%,6m
3421,2,超新星,3239,1493,435,410,845,51.5%,1m
3421,1,RUN,3239,638,19,28,47,40.4%,3m
3421,1,Aether,3239,533,18,21,39,46.2%,2m
3421,2,대한민국서울,3239,172,6,7,13,46.2%,2m
3421,2,RED,3239,120,5,5,10,50.0%,4m
3421,1,Eroica,3239,140,3,9,12,25.0%,5m
3427,2,[SoDa]KiritoSoDa,3238,30,1,8,9,11.1%,1m
3428,3,Glacage,3237,1383,56,64,120,46.7%,6m
3428,1,Tarvek,3237,276,13,10,23,56.5%,44m
3428,2,선물공룡디보,3237,0,4,1,5,80.0%,5m
3428,2,[디플]미스한,3237,116,4,5,9,44.4%,1m
3428,2,[무리무리팸]누구냐,3237,0,0,1,1,0.0%,7m
3433,2,얼음덕후노메,3236,918,34,32,66,51.5%,1m
3433,1,김돌균,3236,812,33,41,74,44.6%,12m
3433,2,eXt,3236,146,9,5,14,64.3%,2m
3433,1,DiamondDuck,3236,119,5,2,7,71.4%,13m
3433,2,AutoSys,3236,0,4,1,5,80.0%,13m
3433,2,JFKIST,3236,0,0,1,1,0.0%,5m
3439,1,hipen,3235,1241,161,145,306,52.6%,1m
3439,2,llllllllll,3235,190,6,7,13,46.2%,4m
3439,1,[sheep8]나한테지면찌질이,3235,0,1,0,1,100.0%,45m
3439,2,vysla,3235,0,0,1,1,0.0%,1m
3443,2,Markingstong,3234,158,9,13,22,40.9%,6m
3443,3,[MSxD]HunterKiller,3234,0,5,3,8,62.5%,13m
3443,2,Deviljho,3234,0,0,2,2,0.0%,21m
3446,2,[TalenT]never,3233,864,81,69,150,54.0%,4m
3446,2,zero,3233,706,32,27,59,54.2%,12m
3446,2,JeffreyTW,3233,92,3,4,7,42.9%,12m
3449,2,[NGameS]AiRes,3232,554,21,18,39,53.8%,2m
3449,1,Jagoff,3232,44,2,3,5,40.0%,45m
3449,2,illyasvel,3232,58,2,4,6,33.3%,6m
3449,2,용스터,3232,0,1,4,5,20.0%,4m
3453,2,[JSF]陰險詭詐,3231,771,29,20,49,59.2%,4m
3453,2,[SpM]Valkyrus,3231,66,2,7,9,22.2%,2m
3453,2,임산부,3231,0,1,0,1,100.0%,1m
3453,2,[C84138]JHC,3231,0,0,1,1,0.0%,4m
3457,2,llllllllllll,3230,30,2,1,3,66.7%,12m
3457,1,JWA,3230,60,2,10,12,16.7%,3m
3457,2,ina,3230,0,0,1,1,0.0%,1m
3460,2,耗子尾汁,3229,0,1,0,1,100.0%,2m
3460,1,IIIIIIIIIIII,3229,0,1,0,1,100.0%,13m
3462,1,Kerrgan,3228,207,8,2,10,80.0%,14m
3462,2,아일렌치스,3228,0,4,1,5,80.0%,4m
3462,2,늘보,3228,0,0,1,1,0.0%,2m
3465,1,kewei,3227,1611,199,191,390,51.0%,1m
3465,2,iLoveGfriend,3227,665,113,96,209,54.1%,11m
3465,1,쇼미더머니,3227,1568,78,80,158,49.4%,2m
3465,2,달구비,3227,865,46,41,87,52.9%,4m
3465,2,하이파이브,3227,996,41,30,71,57.7%,4m
3465,2,[공방깡패]ULTRAzerg,3227,325,13,16,29,44.8%,4m
3465,1,장범준팬,3227,289,8,17,25,32.0%,11m
3465,2,gogo,3227,94,3,7,10,30.0%,5m
3473,2,UED,3226,304,8,13,21,38.1%,2m
3473,2,박춘배의포도밭,3226,0,4,1,5,80.0%,21m
3473,1,울셉션,3226,183,4,10,14,28.6%,12m
3473,2,김강일,3226,0,0,2,2,0.0%,4m
3477,2,Aiden,3225,1541,145,131,276,52.5%,11m
3477,1,[R2K]starwars,3225,1618,117,124,241,48.5%,5m
3477,1,Winner,3225,1397,93,100,193,48.2%,4m
3477,2,털릴준비됐니,3225,196,6,6,12,50.0%,2m
3477,2,[NavyHQ]잠수함사령관,3225,119,5,3,8,62.5%,5m
3477,2,Setzer,3225,88,2,0,2,100.0%,7m
3477,2,[정경두꺼비]lIlIlIIlllll,3225,0,1,2,3,33.3%,22m
3477,2,늘낙지,3225,0,0,2,2,0.0%,6m
3485,2,VANHELSING,3224,877,43,37,80,53.8%,1m
3485,1,llllllllllll,3224,786,25,33,58,43.1%,4m
3485,2,madumlao,3224,166,7,4,11,63.6%,7m
3485,2,ReBLSRinIVAS,3224,119,4,1,5,80.0%,2m
3485,2,[TeamB]폭군다람쥐,3224,0,2,3,5,40.0%,12m
3485,2,[도봉구]배달,3224,0,1,0,1,100.0%,5m
3485,2,dkxltn,3224,36,1,4,5,20.0%,2m
3492,3,마린,3223,433,19,38,57,33.3%,1m
3492,2,심해탈출넘버원,3223,58,3,1,4,75.0%,6m
3492,2,Synn,3223,40,2,0,2,100.0%,46m
3495,2,뭬이플수토뤼,3222,473,22,10,32,68.8%,1m
3495,3,我只想贏一場,3222,668,22,50,72,30.6%,4m
3495,2,星空殺手,3222,0,3,2,5,60.0%,1m
3495,2,Envy,3222,0,0,1,1,0.0%,6m
3499,2,[축구의전설]국민연료,3221,981,80,71,151,53.0%,1m
3499,2,Prior,3221,186,5,5,10,50.0%,4m
3499,2,[도술]조퓨,3221,0,0,2,2,0.0%,12m
3502,2,MasterShio,3220,771,99,85,184,53.8%,4m
3502,3,kandora,3220,121,6,3,9,66.7%,47m
3502,2,IlIlIIIlllII,3220,0,1,0,1,100.0%,1m
3505,2,Pilot,3219,1160,50,36,86,58.1%,5m
3505,2,llllllllllll,3219,866,30,69,99,30.3%,13m
3505,2,[이터널]의정부꿀주먹,3219,165,4,4,8,50.0%,46m
3505,2,철자구지,3219,92,4,4,8,50.0%,1m
3505,3,[우유통]왕수박,3219,92,3,13,16,18.8%,47m
3505,2,[ConFed]raincoat,3219,112,2,1,3,66.7%,4m
3505,2,옴팡,3219,58,2,3,5,40.0%,6m
3505,2,[H琪]HMQ,3219,0,1,1,2,50.0%,1m
3505,2,Soleil,3219,0,0,1,1,0.0%,1m
3505,2,llllllllllll,3219,0,0,1,1,0.0%,4m
3515,2,[Lotuz]도덕왕,3218,1424,86,82,168,51.2%,12m
3515,2,Subang,3218,661,29,19,48,60.4%,7m
3515,2,llllllllllll,3218,278,11,10,21,52.4%,2m
3515,1,참치,3218,354,11,17,28,39.3%,1m
3515,2,Amon,3218,264,10,13,23,43.5%,4m
3515,2,IlIlIlIlIlIl,3218,102,3,0,3,100.0%,2m
3515,2,[南無阿彌陀佛]龜巖許浚,3218,102,3,1,4,75.0%,5m
3515,2,[두피용면도기]맹실맹실,3218,88,1,1,2,50.0%,2m
3515,2,linetek,3218,30,1,2,3,33.3%,4m
3515,2,[ash]BushMan,3218,0,0,1,1,0.0%,11m
3525,1,구찌성,3217,302,13,9,22,59.1%,44m
3525,2,[GITS]彩彩日菜伊芙千聖,3217,193,8,1,9,88.9%,12m
3525,2,[IWYDI]SuddenSR,3217,142,5,1,6,83.3%,4m
3525,2,IIIIIIIIIIII,3217,80,4,4,8,50.0%,4m
3525,2,JiNyoGi,3217,91,2,2,4,50.0%,47m
3525,2,장밋빛인생,3217,0,1,0,1,100.0%,1m
3525,2,llllllllll,3217,0,0,1,1,0.0%,5m
3532,1,checkmate,3216,1615,285,269,554,51.4%,12m
3532,2,[브론즈같은]마너,3216,964,44,32,76,57.9%,5m
3532,2,[Jug]전장의조운,3216,731,34,22,56,60.7%,1m
3532,2,Flash,3216,765,32,23,55,58.2%,2m
3532,2,경화니,3216,335,13,12,25,52.0%,4m
3532,2,炸裂陳子豪,3216,258,12,15,27,44.4%,4m
3532,1,NoobZerg,3216,117,5,2,7,71.4%,13m
3532,2,[Worm]용용,3216,0,2,0,2,100.0%,2m
3532,2,Dreamhack,3216,58,2,3,5,40.0%,4m
3532,2,월진,3216,0,1,0,1,100.0%,4m
3532,2,strength,3216,0,1,0,1,100.0%,4m
3532,2,Very,3216,0,0,1,1,0.0%,1m
3544,2,[ELS]Lineage,3215,1552,154,136,290,53.1%,11m
3544,3,투문,3215,1435,129,135,264,48.9%,6m
3544,2,zergDaDa,3215,298,14,9,23,60.9%,7m
3544,2,Astesia,3215,292,11,6,17,64.7%,6m
3544,2,Silent,3215,161,5,2,7,71.4%,12m
3544,2,YGodPoNy,3215,79,5,6,11,45.5%,4m
3544,2,ShiNe,3215,60,3,3,6,50.0%,4m
3544,2,intex,3215,0,1,0,1,100.0%,12m
3544,2,수천의밤을가는달,3215,0,0,2,2,0.0%,7m
3544,2,sinjoe,3215,0,0,3,3,0.0%,5m
3554,2,歇浩相備,3214,1483,85,71,156,54.5%,1m
3554,2,[NsP]오타쿠,3214,404,14,16,30,46.7%,1m
3554,3,殺人事件,3214,0,1,0,1,100.0%,47m
3554,2,스타저그프로임,3214,0,1,0,1,100.0%,2m
3554,2,[TalenT]poisonJJ,3214,0,0,4,4,0.0%,11m
3559,1,[sc2mc]살뺄돈없어,3213,1459,232,215,447,51.9%,1m
3559,2,change,3213,262,20,12,32,62.5%,1m
3559,2,[무한민태홍]문재인,3213,0,0,1,1,0.0%,11m
3562,1,jack,3212,642,21,26,47,44.7%,1m
3562,1,古琴,3212,658,21,29,50,42.0%,5m
3562,1,[이시하라사톰]Satom,3212,534,20,27,47,42.6%,6m
3562,2,komanic,3212,243,10,4,14,71.4%,4m
3562,2,Thraundil,3212,142,5,5,10,50.0%,4m
3562,2,농산야후,3212,30,2,1,3,66.7%,1m
3562,2,최태호,3212,30,2,3,5,40.0%,4m
3562,1,BlackEyE,3212,118,2,5,7,28.6%,45m
3562,2,[반콩성반퉁퉁]시즈탕쿠,3212,0,0,1,1,0.0%,2m
3571,2,KimuchiBoy,3211,429,22,11,33,66.7%,2m
3571,2,피구공,3211,492,19,18,37,51.4%,4m
3571,3,긍서허싱,3211,36,2,0,2,100.0%,47m
3571,2,[韩湾土锤搬家]YueChuNexus,3211,18,2,3,5,40.0%,4m
3575,2,[CStorM]한국자동화,3210,328,15,6,21,71.4%,2m
3575,2,호호호,3210,92,4,3,7,57.1%,4m
3577,2,llllllllllll,3209,382,15,15,30,50.0%,4m
3577,1,雲下,3209,133,6,3,9,66.7%,14m
3577,2,[Jju]CocoChanel,3209,0,1,1,2,50.0%,2m
3580,2,igunasu,3208,369,17,11,28,60.7%,5m
3580,2,피자오빠,3208,142,5,1,6,83.3%,7m
3582,1,아노띵띵,3207,1345,54,57,111,48.6%,12m
3582,2,Roke,3207,165,8,5,13,61.5%,46m
3582,2,pleanty,3207,58,3,2,5,60.0%,11m
3582,2,Water,3207,30,2,1,3,66.7%,4m
3582,2,[유즈맵정복]저글링,3207,0,0,2,2,0.0%,4m
3587,2,IlllllIlllll,3206,1540,182,159,341,53.4%,5m
3587,2,Illlllllll,3206,1499,107,95,202,53.0%,7m
3587,1,kimSaBoO,3206,677,27,32,59,45.8%,11m
3587,2,Pinoy,3206,583,23,17,40,57.5%,1m
3587,2,llllllllllll,3206,172,10,5,15,66.7%,6m
3587,2,사울알바레즈,3206,187,9,4,13,69.2%,7m
3593,2,망초,3205,0,0,1,1,0.0%,11m
3594,2,아갈위,3204,0,1,2,3,33.3%,2m
3594,2,상한가쏴리질러,3204,0,0,1,1,0.0%,4m
3596,2,SimCity,3203,1585,174,167,341,51.0%,2m
3596,2,glue,3203,957,94,75,169,55.6%,5m
3596,2,DarkSlayers,3203,326,12,14,26,46.2%,1m
3596,2,雷星風暴,3203,146,6,5,11,54.5%,5m
3596,2,슬레이어스,3203,144,6,6,12,50.0%,2m
3596,1,왕본좌,3203,88,4,4,8,50.0%,11m
3596,2,[消灭人族暴政]低熵体,3203,140,3,3,6,50.0%,2m
3596,2,나한테지면반성해,3203,0,2,3,5,40.0%,12m
3596,2,JiaYu,3203,0,0,1,1,0.0%,6m
3605,1,꼬까꼴라,3202,1245,57,56,113,50.4%,1m
3605,2,져켜켜,3202,868,54,50,104,51.9%,4m
3605,2,psychopomp,3202,58,3,2,5,60.0%,4m
3608,2,MoS,3201,391,60,53,113,53.1%,6m
3608,2,최고의테란,3201,1252,56,54,110,50.9%,4m
3608,2,저글링,3201,1050,42,41,83,50.6%,11m
3608,2,[송해손잡고]BluePsycho,3201,171,9,4,13,69.2%,7m
3608,1,최원호,3201,0,1,0,1,100.0%,13m
3608,2,[옵져버]JeannedArc,3201,0,1,1,2,50.0%,2m
3608,2,lIIIIIlllllI,3201,30,1,3,4,25.0%,4m
3615,2,브릉이,3200,298,17,20,37,45.9%,4m
3615,2,킬러빵,3200,262,9,10,19,47.4%,4m
3615,1,감염된해병,3200,150,4,13,17,23.5%,3m
3615,3,삼십일,3200,60,2,1,3,66.7%,7m
3615,2,[kosmos]개초보,3200,114,2,2,4,50.0%,1m
3615,3,고마워미도리,3200,0,0,1,1,0.0%,2m
3621,2,choi,3198,909,35,34,69,50.7%,1m
3621,2,iuyihjkj,3198,606,33,32,65,50.8%,12m
3621,1,crazy,3198,548,15,26,41,36.6%,12m
3621,1,[Bliss]BARCODE,3198,350,10,20,30,33.3%,1m
3621,3,세례요한,3198,168,7,2,9,77.8%,6m
3626,2,알리핫,3197,897,36,34,70,51.4%,6m
3626,1,毒奶色,3197,160,7,4,11,63.6%,14m
3626,2,[黑快]Code,3197,168,7,7,14,50.0%,2m
3626,2,사골매니아,3197,32,1,3,4,25.0%,2m
3630,2,KNIGHTS,3196,1568,104,96,200,52.0%,6m
3630,2,플루토,3196,399,15,14,29,51.7%,11m
3630,2,SKTIBANKY,3196,286,12,3,15,80.0%,4m
3630,2,[붉은제국]아바투르,3196,112,3,2,5,60.0%,11m
3634,1,IArtADragon,3195,608,55,41,96,57.3%,1m
3634,2,holy,3195,994,51,44,95,53.7%,2m
3634,2,CENSORED,3195,413,22,21,43,51.2%,5m
3634,2,돌베기,3195,0,1,7,8,12.5%,4m
3638,3,sctrash,3194,533,25,5,30,83.3%,2m
3638,2,[돌변쩔좀]오빠거긴앙앙,3194,407,17,14,31,54.8%,7m
3638,3,styer,3194,278,13,15,28,46.4%,6m
3638,2,凌晨夜哥,3194,186,9,5,14,64.3%,4m
3638,2,흑곰,3194,0,0,2,2,0.0%,4m
3643,1,jakejump,3193,1560,120,119,239,50.2%,3m
3643,3,[正太萬歲]青風,3193,0,1,0,1,100.0%,7m
3645,2,IIIIIIIIIIII,3192,1521,76,67,143,53.1%,7m
3645,2,[닭장]버거킹가지말자,3192,1159,71,50,121,58.7%,6m
3645,3,천재양민,3192,352,14,10,24,58.3%,3m
3645,1,[트수Crew]트수평균,3192,30,5,4,9,55.6%,11m
3645,2,저그,3192,60,3,3,6,50.0%,4m
3645,3,Kideokgeun,3192,0,0,1,1,0.0%,4m
3651,2,[이터널]뭉령,3191,439,26,19,45,57.8%,11m
3651,2,[스카이파이터]죽순군주,3191,314,12,13,25,48.0%,4m
3651,3,[ThsG]JACOB,3191,217,9,6,15,60.0%,2m
3651,2,Zeus,3191,0,5,0,5,100.0%,20m
3651,2,歆爺,3191,30,2,2,4,50.0%,5m
3651,3,건삼,3191,0,0,1,1,0.0%,6m
3657,1,Lox,3190,1306,55,43,98,56.1%,4m
3657,2,king,3190,524,20,19,39,51.3%,2m
3657,2,Underclass,3190,280,12,6,18,66.7%,6m
3657,3,Aka,3190,118,2,5,7,28.6%,2m
3657,3,Rodo,3190,30,1,1,2,50.0%,2m
3657,3,Hypoxia,3190,92,1,2,3,33.3%,5m
3657,3,뽑아보니일꾼,3190,0,0,1,1,0.0%,13m
3664,1,llllllllllll,3189,368,11,22,33,33.3%,1m
3664,3,JulianHow,3189,0,4,1,5,80.0%,5m
3664,2,dager,3189,30,1,4,5,20.0%,1m
3667,2,지옥으로가,3188,170,6,8,14,42.9%,4m
3667,2,PoohaBest,3188,30,1,3,4,25.0%,5m
3669,1,ADLIAO,3187,1299,50,58,108,46.3%,5m
3669,2,[Myoui]Minaaarii,3187,757,33,25,58,56.9%,12m
3669,3,可愛到極具殺傷力,3187,58,5,2,7,71.4%,7m
3669,2,DourJob,3187,160,4,5,9,44.4%,7m
3669,1,nsz,3187,74,3,13,16,18.8%,11m
3669,2,LukeWang,3187,30,1,3,4,25.0%,4m
3669,3,기재핑,3187,0,0,1,1,0.0%,2m
3676,2,그마가고싶어요,3186,1511,88,86,174,50.6%,1m
3676,2,Joker,3186,1564,86,91,177,48.6%,6m
3676,2,[친클]GLHF,3186,768,28,32,60,46.7%,1m
3676,2,Tubes,3186,281,15,11,26,57.7%,11m
3680,1,꾸설,3185,0,4,4,8,50.0%,1m
3680,1,히쨩,3185,0,0,4,4,0.0%,14m
3682,2,노루,3184,274,12,6,18,66.7%,46m
3682,2,몽봉뽕퐁,3184,0,4,2,6,66.7%,2m
3682,2,조류아냐,3184,34,4,5,9,44.4%,4m
3682,2,천상의유희,3184,0,0,2,2,0.0%,7m
3686,1,[너의ol름은]고깅사줘,3183,1196,57,64,121,47.1%,4m
3686,2,된장,3183,1030,40,32,72,55.6%,1m
3686,1,[sc2mc]김리우,3183,244,8,19,27,29.6%,3m
3686,2,창넘,3183,102,3,1,4,75.0%,4m
3686,3,JONO,3183,30,3,1,4,75.0%,2m
3686,3,[그날이오면]마귀,3183,30,1,1,2,50.0%,6m
3692,1,九喇嘛,3182,797,27,34,61,44.3%,11m
3692,2,저그,3182,140,5,3,8,62.5%,5m
3692,3,cjswoekd,3182,132,4,3,7,57.1%,7m
3692,2,Darksweem,3182,106,2,2,4,50.0%,2m
3692,2,[감자에감자]Infestor,3182,30,1,5,6,16.7%,1m
3692,2,[SPTS]CHEERHERO,3182,0,0,1,1,0.0%,46m
3692,2,[인성쓰렉민석]멸치는한영이꼭지,3182,0,0,2,2,0.0%,2m
3699,2,[READ]낭천화,3181,156,7,2,9,77.8%,2m
3699,3,White,3181,86,4,0,4,100.0%,3m
3699,3,마린,3181,30,1,1,2,50.0%,12m
3699,3,Cruel,3181,0,0,1,1,0.0%,3m
3703,1,TonFroid,3180,500,20,20,40,50.0%,12m
3703,3,[레지스탕스]제패,3180,0,3,2,5,60.0%,11m
3703,2,AED,3180,114,3,3,6,50.0%,1m
3703,3,텅텅빈내지갑,3180,30,1,1,2,50.0%,2m
3703,1,[MOA]악마,3180,0,0,1,1,0.0%,45m
3708,1,Integral,3179,1606,87,92,179,48.6%,4m
3708,2,아이유팬,3179,256,9,7,16,56.2%,4m
3708,2,瑋恩咖啡,3179,48,5,2,7,71.4%,22m
3708,3,llllllllllll,3179,0,3,2,5,60.0%,2m
3708,2,Zealot,3179,0,1,0,1,100.0%,21m
3713,2,llllllllllll,3178,367,17,10,27,63.0%,5m
3713,2,컴디장인어른,3178,225,11,2,13,84.6%,4m
3713,3,히히,3178,0,1,0,1,100.0%,6m
3716,2,[예쁜김다미]이쁘다미,3177,335,11,9,20,55.0%,2m
3716,3,Deoxy,3177,0,0,1,1,0.0%,12m
3718,2,十八鄉教畜王鶯群,3176,621,28,27,55,50.9%,4m
3718,1,비니,3176,427,15,18,33,45.5%,11m
3718,2,PoLaRiS,3176,82,4,4,8,50.0%,4m
3718,2,JoJo,3176,92,3,5,8,37.5%,6m
3722,1,호돌이,3175,1589,375,361,736,51.0%,3m
3722,2,FIash,3175,1543,77,59,136,56.6%,7m
3722,3,마재윤,3175,974,39,30,69,56.5%,3m
3722,2,IIIIIIIIIIII,3175,206,8,12,20,40.0%,4m
3722,1,육마,3175,97,5,2,7,71.4%,15m
3722,3,PoTaTo,3175,30,2,1,3,66.7%,12m
3728,2,amelia,3174,1593,457,429,886,51.6%,4m
3729,3,스바라시양뽝님,3173,739,34,50,84,40.5%,4m
3729,2,Impaler,3173,110,3,1,4,75.0%,1m
3729,2,[CIM]주먹,3173,90,3,6,9,33.3%,6m
3729,3,[DagmBa]자연산다금바리,3173,30,2,1,3,66.7%,2m
3733,2,[기냥]asdf,3172,0,1,2,3,33.3%,7m
3734,3,atoa,3171,86,3,2,5,60.0%,3m
3734,3,한대성,3171,95,1,1,2,50.0%,7m
3736,1,monsball,3170,1558,253,252,505,50.1%,12m
3736,1,Galford,3170,945,53,41,94,56.4%,4m
3736,2,顆顆,3170,962,39,36,75,52.0%,7m
3736,1,더블윙,3170,81,5,16,21,23.8%,12m
3736,3,llllllllllll,3170,30,1,2,3,33.3%,1m
3741,2,soO,3169,1237,61,49,110,55.5%,4m
3741,3,[Lotuz]Coding,3169,268,9,10,19,47.4%,3m
3741,2,HurkaDerka,3169,0,4,1,5,80.0%,21m
3741,3,원준이,3169,0,1,0,1,100.0%,4m
3745,3,EWcreeper,3167,278,11,6,17,64.7%,12m
3745,3,zzzzzz,3167,30,5,1,6,83.3%,6m
3745,3,[아랫반송로]Marauder,3167,0,0,1,1,0.0%,4m
3748,2,고독독,3166,934,60,63,123,48.8%,1m
3748,2,Aliz,3166,216,7,12,19,36.8%,4m
3750,3,IIlIlIlIIlIl,3165,1486,699,693,1392,50.2%,2m
3750,2,IIIIIIIIII,3165,1179,180,157,337,53.4%,2m
3750,3,[OId]小異形,3165,1065,171,122,293,58.4%,3m
3750,1,개나리,3165,921,87,95,182,47.8%,11m
3750,2,[TMR]禁區,3165,496,19,18,37,51.4%,1m
3750,2,[쇄국정책]저그족사기너프해,3165,212,7,12,19,36.8%,7m
3750,3,timi,3165,136,4,1,5,80.0%,12m
3750,3,QuirkyOrc,3165,0,4,1,5,80.0%,13m
3750,1,차또치,3165,0,4,2,6,66.7%,14m
3750,3,AAA,3165,114,4,4,8,50.0%,1m
3750,3,Civilian,3165,0,2,3,5,40.0%,3m
3761,2,[오영종영빡이]llllllllllll,3164,529,23,20,43,53.5%,1m
3761,1,RALF,3164,376,10,25,35,28.6%,4m
3761,2,괴물,3164,116,8,6,14,57.1%,7m
3761,2,[Neat]Moon,3164,128,7,4,11,63.6%,47m
3761,1,지상최고남,3164,198,6,9,15,40.0%,42m
3761,1,Makuto,3164,158,5,6,11,45.5%,12m
3761,3,뭉치멍멍,3164,0,1,0,1,100.0%,7m
3768,3,ddim,3163,0,4,1,5,80.0%,12m
3768,3,GSU,3163,0,1,0,1,100.0%,5m
3768,3,simba,3163,30,1,1,2,50.0%,13m
3771,2,배틀스타,3162,1227,55,52,107,51.4%,4m
3771,1,[요시]박지성,3162,197,8,23,31,25.8%,5m
3771,3,ProA,3162,0,0,1,1,0.0%,12m
3774,3,[PPSK]AlphaSlow,3161,1115,70,68,138,50.7%,11m
3774,3,Renile,3161,58,2,1,3,66.7%,7m
3774,3,MAHOROMATIC,3161,0,2,3,5,40.0%,12m
3774,3,zoltar,3161,93,1,2,3,33.3%,4m
3778,1,하나뿐인지구,3160,702,23,35,58,39.7%,3m
3778,3,안녕하세요,3160,270,12,6,18,66.7%,7m
3778,2,싸광남,3160,48,1,1,2,50.0%,22m
3778,3,llllllllllll,3160,30,1,1,2,50.0%,1m
3778,3,Brain,3160,0,1,4,5,20.0%,3m
3778,3,우리엄마,3160,0,0,1,1,0.0%,2m
3784,2,Destroy,3159,1048,52,44,96,54.2%,11m
3784,3,[올드보이]우럭아왜우럭,3159,799,28,43,71,39.4%,6m
3784,2,Chrisp,3159,343,18,17,35,51.4%,11m
3784,3,[이터널]kilgo,3159,30,2,1,3,66.7%,4m
3784,2,KAISER,3159,88,2,2,4,50.0%,7m
3784,3,[만두]OHBass,3159,0,1,0,1,100.0%,4m
3784,3,승구,3159,0,0,2,2,0.0%,3m
3784,1,형민,3159,0,0,3,3,0.0%,14m
3792,2,심슨,3158,1519,160,155,315,50.8%,2m
3792,2,James,3158,547,26,19,45,57.8%,5m
3792,2,BrianWang,3158,241,17,17,34,50.0%,4m
3792,3,저글링,3158,0,0,1,1,0.0%,12m
3796,2,Fanat,3157,925,303,277,580,52.2%,4m
3796,2,pyc,3157,1467,131,121,252,52.0%,6m
3796,1,[나혼자산다]CafeMocha,3157,1493,58,68,126,46.0%,3m
3796,3,GoldenWillow,3157,1075,48,34,82,58.5%,2m
3796,2,Zero,3157,116,3,3,6,50.0%,2m
3796,3,으에으어,3157,0,0,1,1,0.0%,6m
3802,3,집이짱이다,3156,1026,46,28,74,62.2%,2m
3802,1,JamArcher,3156,97,5,2,7,71.4%,45m
3802,3,Skarloey,3156,0,4,1,5,80.0%,1m
3802,3,LEO,3156,0,1,0,1,100.0%,7m
3802,3,llllllllllll,3156,0,0,1,1,0.0%,3m
3807,1,호동이이쁘지,3155,1597,170,181,351,48.4%,1m
3807,3,Apex,3155,367,17,7,24,70.8%,1m
3807,3,조진다,3155,383,16,13,29,55.2%,11m
3807,2,icone,3155,310,11,17,28,39.3%,2m
3807,3,Josese,3155,30,1,1,2,50.0%,1m
3807,3,[상훈찡]테란마스터프라이,3155,0,0,2,2,0.0%,12m
3813,2,jjs,3154,1532,77,84,161,47.8%,4m
3813,3,Kalkiorc,3154,0,4,1,5,80.0%,6m
3813,1,jkj,3154,145,3,0,3,100.0%,13m
3813,3,[Rovic]HatsuneMiku,3154,0,0,1,1,0.0%,11m
3817,2,BananaPie,3153,240,11,8,19,57.9%,47m
3817,3,bart,3153,0,2,3,5,40.0%,6m
3817,3,[스2죧망겜]Chalcosoma,3153,30,1,2,3,33.3%,4m
3820,3,알반,3152,1317,63,45,108,58.3%,6m
3820,2,DoubleJH,3152,885,36,35,71,50.7%,2m
3820,1,[DagmBa]공피고아,3152,1030,36,47,83,43.4%,12m
3820,3,Seven,3152,576,27,15,42,64.3%,13m
3820,2,[Blac]wldnjs,3152,96,4,2,6,66.7%,13m
3820,3,[JEONG]leeryan,3152,0,3,2,5,60.0%,12m
3826,3,테란토스개사기,3151,999,119,118,237,50.2%,6m
3826,2,레전드잦자,3151,1565,118,103,221,53.4%,4m
3826,2,황제,3151,148,6,8,14,42.9%,4m
3826,2,Xiros,3151,0,2,3,5,40.0%,21m
3826,3,[SC2IB]초장부터발라,3151,0,1,0,1,100.0%,6m
3826,1,돼지우리,3151,0,1,0,1,100.0%,14m
3826,3,아바투르,3151,30,1,1,2,50.0%,2m
3826,3,스투코프,3151,0,0,1,1,0.0%,3m
3834,2,星空,3150,492,17,19,36,47.2%,4m
3834,2,권나라수마나라,3150,96,4,9,13,30.8%,4m
3836,1,[릅택똥]로똥,3149,1485,88,90,178,49.4%,3m
3836,3,[무한오영종]KingDomGlorY,3149,0,0,1,1,0.0%,3m
3838,2,RevoltTrees,3148,1028,43,36,79,54.4%,4m
3838,2,馬扁,3148,116,4,5,9,44.4%,4m
3838,2,[경기도민]GGangMY,3148,0,1,5,6,16.7%,5m
3838,3,SpecialLunch,3148,0,0,1,1,0.0%,7m
3838,3,똥꾸,3148,0,0,1,1,0.0%,3m
3843,2,Cfen,3147,977,99,107,206,48.1%,6m
3843,2,CACAO,3147,991,71,67,138,51.4%,2m
3843,2,lakeciel,3147,667,28,28,56,50.0%,4m
3843,2,[TalenT]TWstrangner,3147,589,26,17,43,60.5%,7m
3843,2,으뢋차차,3147,665,25,24,49,51.0%,2m
3843,3,llIIllllllll,3147,146,6,3,9,66.7%,6m
3843,1,프로토스가싫어요,3147,110,6,5,11,54.5%,12m
3843,2,ant,3147,0,4,2,6,66.7%,7m
3843,3,[메카]제우스,3147,140,3,2,5,60.0%,13m
3843,2,무적의삼중대,3147,0,1,6,7,14.3%,4m
3853,2,이도경,3146,0,0,4,4,0.0%,12m
3853,1,[베리타스]죽이면히힉,3146,0,0,6,6,0.0%,12m
3855,1,Kenzyte,3145,344,15,12,27,55.6%,5m
3855,3,yokubari,3145,0,0,1,1,0.0%,13m
3855,3,[새슬막]갠지,3145,0,0,1,1,0.0%,7m
3858,2,momomga,3144,460,19,17,36,52.8%,6m
3858,2,MTman,3144,442,18,16,34,52.9%,4m
3858,2,luku,3144,282,10,14,24,41.7%,2m
3858,2,[NaLBIL]삼분토스,3144,102,3,2,5,60.0%,2m
3858,3,cyborg,3144,0,0,1,1,0.0%,12m
3858,2,[NLTN]이름은하나다,3144,0,0,1,1,0.0%,21m
3864,2,훈이,3143,0,4,1,5,80.0%,21m
3864,3,Kuruku,3143,112,4,3,7,57.1%,12m
3864,3,Still,3143,0,1,1,2,50.0%,3m
3867,1,심형래,3142,1329,71,61,132,53.8%,12m
3867,2,Woojung,3142,519,34,35,69,49.3%,4m
3867,3,일상한가지즐거움,3142,0,4,1,5,80.0%,6m
3867,3,angel,3142,0,0,2,2,0.0%,3m
3871,3,raVen,3141,326,17,13,30,56.7%,12m
3871,2,[GAL]ABeeE,3141,238,16,15,31,51.6%,4m
3871,2,[Toss]ScHolarAGeNt,3141,411,15,17,32,46.9%,11m
3871,3,[EPH]유라에하,3141,58,2,4,6,33.3%,12m
3875,2,Griker,3140,143,7,4,11,63.6%,1m
3875,2,기무기훈,3140,117,6,3,9,66.7%,13m
3875,3,익성,3140,58,3,1,4,75.0%,6m
3875,2,개떡,3140,97,2,1,3,66.7%,21m
3879,3,3139,450,45,34,79,57.0%,7m
3879,2,llllllllllll,3139,871,38,30,68,55.9%,12m
3879,3,Stella,3139,616,24,24,48,50.0%,1m
3879,3,IIIIIIIIIIII,3139,456,17,11,28,60.7%,6m
3879,3,[정신나감]대저택저글링,3139,415,17,11,28,60.7%,2m
3879,1,[스카이파이터]HodooMaru,3139,156,7,7,14,50.0%,7m
3879,3,classic,3139,30,2,2,4,50.0%,1m
3879,3,aaaagkgk,3139,0,1,1,2,50.0%,13m
3879,3,Seeyouagain,3139,0,0,1,1,0.0%,12m
3888,1,BLADE,3138,145,6,3,9,66.7%,14m
3888,3,miku,3138,93,1,1,2,50.0%,3m
3890,2,calon,3137,1517,70,58,128,54.7%,11m
3890,1,可樂,3137,1209,69,63,132,52.3%,3m
3890,2,IIIIIIIIII,3137,0,4,1,5,80.0%,21m
3890,3,[Rkkk]adickpiece,3137,88,4,2,6,66.7%,4m
3890,3,[밤탄소년단]Devil,3137,30,2,1,3,66.7%,1m
3890,3,scv,3137,0,0,1,1,0.0%,12m
3896,2,덜덜,3136,1535,111,95,206,53.9%,2m
3896,3,사자왕,3136,1468,84,68,152,55.3%,4m
3896,2,방탄사랑해,3136,805,38,40,78,48.7%,1m
3896,3,인사사령부,3136,661,27,22,49,55.1%,11m
3896,3,llllllllllll,3136,534,23,18,41,56.1%,1m
3896,3,Kent,3136,300,11,7,18,61.1%,6m
3896,1,hackertitan,3136,97,2,1,3,66.7%,14m
3896,3,펭귄행진곡,3136,0,1,1,2,50.0%,47m
3896,3,[nRTeaM]WaTTeRDeMoN,3136,0,0,1,1,0.0%,3m
3896,1,notfatnice,3136,0,0,1,1,0.0%,14m
3906,2,탱크맨,3135,1555,81,76,157,51.6%,4m
3906,3,你刘爹,3135,404,15,9,24,62.5%,7m
3906,1,King,3135,440,14,27,41,34.1%,3m
3906,1,[Equal]경상도군인,3135,440,12,28,40,30.0%,5m
3906,2,Jepoy,3135,152,6,8,14,42.9%,7m
3906,2,Daniel,3135,114,4,8,12,33.3%,7m
3906,2,FacT,3135,0,3,2,5,60.0%,22m
3906,2,Usopp,3135,46,3,3,6,50.0%,22m
3914,2,[Lotuz]llllllllllll,3134,1560,80,75,155,51.6%,4m
3914,3,이유비,3134,892,46,17,63,73.0%,3m
3914,3,ROOM,3134,264,28,23,51,54.9%,1m
3914,2,wony,3134,404,14,18,32,43.8%,6m
3914,2,[ELS]성비니,3134,287,11,9,20,55.0%,7m
3914,3,기사처넘버원,3134,0,0,1,1,0.0%,3m
3920,3,에덴,3133,1216,98,80,178,55.1%,12m
3920,1,국정원래퍼노무현,3133,326,12,14,26,46.2%,4m
3920,3,토토도사,3133,0,1,2,3,33.3%,7m
3920,3,이제시작,3133,30,1,2,3,33.3%,3m
3924,1,폭발직전,3132,193,8,5,13,61.5%,14m
3924,3,[시형]시형쓰,3132,196,7,8,15,46.7%,7m
3924,3,Schneider,3132,111,6,2,8,75.0%,1m
3924,2,GRIEZMANN,3132,0,1,8,9,11.1%,4m
3924,3,WIN,3132,0,0,1,1,0.0%,1m
3929,1,vanilla,3131,738,27,28,55,49.1%,12m
3929,3,Ledtear,3131,88,3,6,9,33.3%,13m
3929,2,SONO,3131,0,2,4,6,33.3%,13m
3929,3,皮勒斯,3131,0,0,1,1,0.0%,4m
3933,2,ImSpecialOne,3130,687,24,21,45,53.3%,12m
3933,3,buru,3130,446,23,7,30,76.7%,13m
3933,3,어윤수,3130,0,2,2,4,50.0%,12m
3933,2,가이핑,3130,141,2,6,8,25.0%,46m
3933,3,[도담이]Marco,3130,0,0,1,1,0.0%,12m
3938,2,[G20]이낙연,3129,1273,75,67,142,52.8%,2m
3938,2,iPig,3129,545,23,26,49,46.9%,11m
3938,3,듀란팽,3129,184,7,3,10,70.0%,12m
3938,2,magame,3129,228,5,15,20,25.0%,13m
3938,3,ace,3129,30,2,1,3,66.7%,6m
3943,2,아수라발발타,3128,130,6,13,19,31.6%,13m
3943,3,sddddddd,3128,58,3,0,3,100.0%,3m
3943,1,왜살아,3128,123,3,3,6,50.0%,44m
3943,3,마린,3128,0,0,4,4,0.0%,3m
3947,2,[SC2HK]megabouda,3127,1030,38,41,79,48.1%,11m
3947,2,redwine,3127,30,3,5,8,37.5%,13m
3947,3,甲面騎士,3127,0,1,0,1,100.0%,3m
3950,3,[이터널]마이너스이온,3126,58,2,1,3,66.7%,12m
3950,3,개스타,3126,0,0,1,1,0.0%,4m
3952,3,[DMN]口休口休,3125,30,1,5,6,16.7%,12m
3952,3,[무한오영종]김치,3125,0,0,1,1,0.0%,7m
3952,3,SIRU,3125,0,0,1,1,0.0%,2m
3952,2,척추사단접기,3125,0,0,3,3,0.0%,4m
3952,3,[미친광전사]가지짱,3125,0,0,3,3,0.0%,2m
3957,3,CnlSanders,3124,1557,89,88,177,50.3%,13m
3957,2,띱겹둥이,3124,830,46,50,96,47.9%,4m
3957,3,Yan,3124,613,37,18,55,67.3%,3m
3957,3,위시아,3124,551,23,15,38,60.5%,6m
3957,2,[영훈이]땅굴망사티팬티,3124,402,14,17,31,45.2%,2m
3957,1,karajin,3124,144,7,6,13,53.8%,15m
3957,2,[커여운대군주]쏘대장,3124,0,4,3,7,57.1%,5m
3957,2,蘿莉特,3124,144,3,5,8,37.5%,13m
3965,3,아마긴,3123,142,3,1,4,75.0%,3m
3966,2,TshCHIA,3122,1548,80,83,163,49.1%,6m
3966,3,히드라,3122,177,7,3,10,70.0%,12m
3966,1,[N델타메이슨]난죄가없어,3122,164,7,4,11,63.6%,14m
3966,2,골드수문장,3122,0,2,4,6,33.3%,21m
3966,3,[ANGG]저글링날아요츙츙,3122,30,1,3,4,25.0%,3m
3966,3,FoodDeuK,3122,0,0,2,2,0.0%,7m
3966,2,Shine,3122,0,0,4,4,0.0%,13m
3966,2,[무한양승준]Yuraeha,3122,0,0,6,6,0.0%,11m
3974,3,RaZoR,3121,853,45,49,94,47.9%,4m
3974,3,TerranMarine,3121,940,39,32,71,54.9%,3m
3974,1,날으는슈,3121,588,19,28,47,40.4%,3m
3974,3,푸르미르,3121,360,13,7,20,65.0%,3m
3974,3,fhjg,3121,0,1,1,2,50.0%,12m
3974,3,곽비누,3121,0,1,2,3,33.3%,2m
3974,2,[ANGG]솔비앙,3121,0,0,2,2,0.0%,21m
3981,1,narientas,3120,1442,141,141,282,50.0%,5m
3981,2,dns,3120,338,11,11,22,50.0%,4m
3981,1,좌좌갓,3120,240,10,8,18,55.6%,7m
3981,2,Moonbyul,3120,92,6,3,9,66.7%,21m
3981,3,Chocree,3120,86,4,2,6,66.7%,12m
3981,3,흑백선전,3120,0,0,1,1,0.0%,3m
3981,3,OMGJY,3120,0,0,2,2,0.0%,12m
3988,2,KaraHerja,3119,114,6,4,10,60.0%,7m
3988,3,[겁쟁이]밀킹이,3119,58,3,2,5,60.0%,6m
3988,3,황혼,3119,0,1,2,3,33.3%,7m
3991,3,hellfire,3118,396,13,14,27,48.1%,1m
3992,3,RealPolitik,3117,1557,95,77,172,55.2%,6m
3992,1,llllllllllll,3117,688,28,36,64,43.8%,7m
3992,2,liveviliveev,3117,60,6,5,11,54.5%,7m
3992,3,오리,3117,0,1,0,1,100.0%,13m
3996,2,한고릴라,3116,485,19,14,33,57.6%,5m
3996,3,月夜瀧雪,3116,30,1,3,4,25.0%,7m
3998,2,숭태,3115,254,15,15,30,50.0%,1m
3998,2,기도남,3115,317,14,20,34,41.2%,4m
3998,3,王涂淑麗,3115,30,2,2,4,50.0%,6m
4001,3,어쩐지저녁,3114,1569,127,111,238,53.4%,6m
4001,2,매콤한켄디,3114,0,4,2,6,66.7%,12m
4001,3,산신님마리,3114,0,0,1,1,0.0%,3m
4001,3,初雪,3114,0,0,1,1,0.0%,15m
4005,3,Anduril,3113,965,39,30,69,56.5%,3m
4005,2,정원석,3113,512,18,21,39,46.2%,5m
4005,3,[ELSII]KimRaynor,3113,469,17,29,46,37.0%,7m
4005,3,위고로리스,3113,30,2,2,4,50.0%,12m
4005,2,맹밍,3113,0,1,0,1,100.0%,21m
4005,3,BILICHXXV,3113,0,1,0,1,100.0%,13m
4011,2,DrunkenCrow,3112,1312,263,248,511,51.5%,6m
4011,1,[DagmBa]통감자,3112,1502,109,116,225,48.4%,12m
4011,3,철갑군단장,3112,1260,63,47,110,57.3%,1m
4011,3,sirasu,3112,234,21,8,29,72.4%,3m
4011,3,ghostprince,3112,168,19,14,33,57.6%,11m
4011,3,이백십육기해병,3112,348,12,14,26,46.2%,12m
4011,3,pjchiu,3112,254,11,10,21,52.4%,7m
4011,1,[삶이란무엇인]토스트주세요,3112,247,9,5,14,64.3%,14m
4011,2,JuicyJByun,3112,0,4,2,6,66.7%,7m
4011,3,조로아크최,3112,0,1,0,1,100.0%,12m
4011,3,lllllllllll,3112,0,1,0,1,100.0%,6m
4011,1,Golt,3112,0,1,1,2,50.0%,14m
4023,2,이승우,3111,550,22,28,50,44.0%,6m
4023,2,THEKINGJAJI,3111,242,11,7,18,61.1%,6m
4023,1,Maligo,3111,190,8,5,13,61.5%,14m
4023,3,orehonyah,3111,206,8,8,16,50.0%,1m
4023,1,따끄,3111,189,7,4,11,63.6%,15m
4023,2,[浙江工商大学]MagicRandom,3111,0,4,1,5,80.0%,21m
4023,3,[MBK]몬스터,3111,58,3,2,5,60.0%,13m
4023,3,나는나야,3111,0,1,1,2,50.0%,4m
4023,2,[스투좇망겜]밍재,3111,91,1,5,6,16.7%,47m
4032,3,[패자는피를]흑질,3110,1590,68,53,121,56.2%,12m
4032,3,꼬발이,3110,711,29,19,48,60.4%,6m
4032,3,acetate,3110,196,7,0,7,100.0%,4m
4032,3,OhPoo,3110,118,5,5,10,50.0%,6m
4032,2,성혼님,3110,0,4,3,7,57.1%,7m
4037,1,Nicellllllll,3109,1552,111,113,224,49.6%,1m
4037,2,Luddagi,3109,372,13,17,30,43.3%,6m
4037,3,llllIIlIlIll,3109,224,10,5,15,66.7%,6m
4037,2,[랭커]아시아랭커,3109,30,5,3,8,62.5%,2m
4037,3,한약,3109,0,0,1,1,0.0%,11m
4037,3,working,3109,0,0,1,1,0.0%,11m
4043,2,MstrExploder,3108,1259,99,100,199,49.7%,4m
4043,2,TRIPORC,3108,1352,72,73,145,49.7%,6m
4043,3,serral,3108,667,25,20,45,55.6%,1m
4043,1,killilk,3108,0,1,0,1,100.0%,14m
4047,2,[근본은말보루]Burral,3107,1247,100,81,181,55.2%,6m
4047,3,ToastProxy,3107,791,35,25,60,58.3%,2m
4047,3,[DagmBa]Baeksse,3107,165,8,3,11,72.7%,2m
4047,3,[How]Shim,3107,0,1,0,1,100.0%,3m
4047,1,야행성인간,3107,48,1,2,3,33.3%,14m
4052,3,PPAPP,3106,300,12,10,22,54.5%,2m
4052,3,끔찍,3106,183,8,4,12,66.7%,6m
4052,1,재범이긔,3106,113,6,1,7,85.7%,45m
4052,3,水果贩子,3106,168,6,9,15,40.0%,3m
4052,1,DinoZerg,3106,97,1,1,2,50.0%,13m
4052,3,RaiseOD,3106,0,0,1,1,0.0%,3m
4058,3,[이터널]그래도조성주짱,3105,973,37,32,69,53.6%,3m
4058,2,애큐어스배터리,3105,745,34,24,58,58.6%,2m
4058,3,yamamotsu,3105,473,22,14,36,61.1%,7m
4058,3,AnK,3105,206,18,14,32,56.2%,3m
4058,3,니서방,3105,114,5,3,8,62.5%,3m
4058,2,hydrauser,3105,0,3,2,5,60.0%,21m
4058,3,몽환,3105,0,1,0,1,100.0%,12m
4065,2,[GITS]cavalier,3104,1457,202,175,377,53.6%,7m
4065,2,[비트]필라델피아산숭어,3104,458,17,20,37,45.9%,4m
4065,3,팀플러,3104,173,7,4,11,63.6%,2m
4065,3,[백수라이프]Inverse,3104,148,5,7,12,41.7%,4m
4065,3,Mercicrusa,3104,30,1,4,5,20.0%,2m
4070,1,NION,3103,962,71,83,154,46.1%,12m
4070,3,[포비아]뱜뱜,3103,118,5,3,8,62.5%,7m
4070,2,Special,3103,92,4,9,13,30.8%,2m
4070,3,theREverse,3103,30,2,0,2,100.0%,4m
4070,3,[옹선생님]방구왕,3103,30,2,0,2,100.0%,12m
4070,3,탱크조아,3103,0,1,0,1,100.0%,6m
4076,2,Hundlaus,3102,0,3,2,5,60.0%,22m
4076,3,Prozzerg,3102,0,0,2,2,0.0%,16m
4078,2,[손틈새비치는]아이유참좋다,3101,1490,96,97,193,49.7%,11m
4078,2,steven,3101,848,38,28,66,57.6%,5m
4078,3,비광,3101,58,3,0,3,100.0%,1m
4078,3,[TWorld]MARVEL,3101,0,0,1,1,0.0%,3m
4078,3,[어윤수님개쩜]Lilith,3101,0,0,1,1,0.0%,4m
4083,1,나닼,3100,1392,182,184,366,49.7%,1m
4083,1,[RAON모여]쑥나물,3100,1292,52,55,107,48.6%,3m
4083,3,천하무적왕자님,3100,234,11,2,13,84.6%,4m
4083,2,[인천토끼파]ChoiTaei,3100,30,1,7,8,12.5%,13m
4087,3,BeatMan,3098,0,0,1,1,0.0%,3m
4088,3,[강북멋쨍이]수유리전사,3097,752,30,23,53,56.6%,12m
4088,3,앨런,3097,218,10,6,16,62.5%,4m
4088,3,llllllllllll,3097,264,9,12,21,42.9%,13m
4088,3,avengerses,3097,176,6,8,14,42.9%,12m
4088,3,StyLeK,3097,132,5,3,8,62.5%,7m
4088,2,林漫雪,3097,159,4,1,5,80.0%,21m
4088,2,[M8]DarthVader,3097,0,4,1,5,80.0%,13m
4088,3,exePriMe,3097,0,4,1,5,80.0%,3m
4088,1,INZI,3097,114,2,2,4,50.0%,45m
4088,3,lllllllllll,3097,0,2,4,6,33.3%,3m
4088,3,SIGMA,3097,0,1,1,2,50.0%,4m
4099,3,코칵,3096,1571,83,69,152,54.6%,6m
4099,1,voNUra,3096,167,3,2,5,60.0%,13m
4099,3,Surion,3096,30,2,0,2,100.0%,7m
4099,2,SNOWBALL,3096,0,2,4,6,33.3%,21m
4103,2,너를꿈꾸며,3095,158,6,3,9,66.7%,22m
4103,2,xca,3095,0,5,0,5,100.0%,22m
4103,3,카르페디엠,3095,142,5,4,9,55.6%,7m
4103,2,Sign,3095,0,1,0,1,100.0%,22m
4103,3,저그,3095,0,0,1,1,0.0%,6m
4108,3,MintChoco,3094,179,8,4,12,66.7%,3m
4108,3,Persian,3094,172,6,6,12,50.0%,13m
4110,1,[어윤수님개쩜]동크만크,3093,1495,229,202,431,53.1%,13m
4110,2,infily,3093,930,209,195,404,51.7%,5m
4110,1,[갈라파고스]건들면터진다,3093,191,7,4,11,63.6%,15m
4110,3,[국가정보원]dsaojihf,3093,60,3,3,6,50.0%,3m
4110,2,Sicboy,3093,0,0,2,2,0.0%,21m
4110,3,신진대사,3093,0,0,6,6,0.0%,7m
4116,3,BlueCitron,3092,574,26,18,44,59.1%,4m
4116,3,Banker,3092,461,24,17,41,58.5%,12m
4116,3,[Darth]iamtheSwarm,3092,232,8,8,16,50.0%,2m
4116,3,수능이문제,3092,116,5,3,8,62.5%,13m
4116,3,Kim,3092,0,1,1,2,50.0%,3m
4121,3,Clash,3091,158,7,4,11,63.6%,11m
4121,3,Zergling,3091,215,7,6,13,53.8%,3m
4121,3,lsh,3091,30,1,2,3,33.3%,4m
4124,3,Ctstrphy,3090,1576,286,254,540,53.0%,13m
4124,2,KGT,3090,614,21,31,52,40.4%,4m
4124,3,llllllllllll,3090,428,15,15,30,50.0%,7m
4124,3,[공룡아빠]ywj,3090,185,8,6,14,57.1%,15m
4124,3,[해병대전우]응급실,3090,0,1,0,1,100.0%,6m
4124,3,邦邦和尼尼,3090,0,1,1,2,50.0%,3m
4124,3,小呆,3090,30,1,1,2,50.0%,2m
4124,3,Silva,3090,0,0,1,1,0.0%,2m
4132,3,miro,3089,419,19,13,32,59.4%,3m
4132,3,[LVARW]海未,3089,448,17,11,28,60.7%,3m
4132,2,통영통영,3089,94,4,2,6,66.7%,21m
4132,3,연인의,3089,0,1,0,1,100.0%,12m
4132,3,llllllllllll,3089,0,1,0,1,100.0%,13m
4132,2,엘다조기,3089,0,0,2,2,0.0%,21m
4138,3,현티선생,3088,1540,155,132,287,54.0%,4m
4138,3,momo,3088,309,11,8,19,57.9%,3m
4138,3,[MelonN]ItsukaNaros,3088,167,5,1,6,83.3%,2m
4138,3,엄마가어디갔지,3088,60,3,2,5,60.0%,4m
4138,3,sasddasf,3088,0,1,1,2,50.0%,47m
4143,2,lonelywolf,3087,1503,89,85,174,51.1%,7m
4143,2,Gordon,3087,1368,86,78,164,52.4%,12m
4143,2,eric,3087,674,26,32,58,44.8%,13m
4143,3,야균이,3087,142,7,6,13,53.8%,12m
4143,3,[NoME]모질하고딸리는놈,3087,0,1,2,3,33.3%,13m
4143,3,[tossed]OILBOOM,3087,30,1,2,3,33.3%,2m
4143,2,인비아빠,3087,30,1,9,10,10.0%,5m
4143,3,으헝헝,3087,0,0,1,1,0.0%,3m
4143,3,하하하하,3087,0,0,1,1,0.0%,3m
4152,1,[ConFed]Junsung,3086,1283,56,73,129,43.4%,4m
4152,3,[快樂玩家]火炎燚,3086,400,14,16,30,46.7%,13m
4152,3,불끈맨,3086,268,9,11,20,45.0%,4m
4152,3,[이터널]갯지렁이스파게티,3086,230,7,4,11,63.6%,12m
4152,3,오리카,3086,0,1,1,2,50.0%,12m
4152,3,AlexiCOB,3086,0,1,1,2,50.0%,13m
4152,3,[마인그룬트]신미양요,3086,0,0,1,1,0.0%,12m
4159,2,전두환장군,3085,1510,67,53,120,55.8%,1m
4159,3,아이언맨,3085,86,4,6,10,40.0%,4m
4159,3,김지수,3085,0,0,1,1,0.0%,4m
4162,3,IIIIIIIIII,3084,742,26,34,60,43.3%,2m
4162,3,ddksj,3084,62,3,6,9,33.3%,4m
4164,2,SecretPoo,3083,628,108,82,190,56.8%,4m
4164,3,TyCimU,3083,193,9,5,14,64.3%,4m
4164,3,[ELS]김민주,3083,150,5,8,13,38.5%,13m
4164,2,강남사는저글링,3083,0,4,1,5,80.0%,22m
4164,2,[NGameS]해병왕하오,3083,163,3,1,4,75.0%,22m
4164,2,유수,3083,0,3,3,6,50.0%,21m
4164,3,[제리뚝배기]ThanaTus,3083,58,2,2,4,50.0%,3m
4164,3,[noToss]Warpcraft,3083,0,1,0,1,100.0%,16m
4172,3,JohnLee,3082,219,7,3,10,70.0%,3m
4172,3,비니루,3082,241,7,7,14,50.0%,12m
4172,3,SCV,3082,0,0,1,1,0.0%,3m
4172,3,[IWYDI]SoSoWYD,3082,0,0,3,3,0.0%,48m
4176,2,銀色羽翼,3081,507,81,66,147,55.1%,2m
4176,3,[한타왕]아아블랙,3081,1378,52,54,106,49.1%,3m
4176,3,LiBeRtY,3081,966,41,30,71,57.7%,2m
4176,3,홍당무,3081,178,7,8,15,46.7%,7m
4176,2,AsuZoa,3081,0,4,2,6,66.7%,22m
4176,3,[KSK]Zaki,3081,0,0,1,1,0.0%,7m
4182,2,JoeHo,3080,1558,291,277,568,51.2%,7m
4182,3,濕瘩瘩,3080,244,9,8,17,52.9%,7m
4182,1,shdht,3080,267,8,7,15,53.3%,14m
4182,3,끼리코,3080,0,4,1,5,80.0%,12m
4182,3,VicTory,3080,30,2,0,2,100.0%,12m
4182,2,하망동,3080,48,2,1,3,66.7%,21m
4182,3,[청초]ALCA,3080,0,0,2,2,0.0%,3m
4189,3,MISSYCLUB,3079,257,7,7,14,50.0%,2m
4189,3,물대신커피,3079,118,5,3,8,62.5%,4m
4189,3,Withfox,3079,114,4,4,8,50.0%,2m
4189,3,Crad,3079,0,1,0,1,100.0%,12m
4193,2,Celeste,3078,0,0,1,1,0.0%,21m
4193,3,[5torM]성자초,3078,0,0,2,2,0.0%,2m
4195,3,Astro,3077,774,55,42,97,56.7%,7m
4195,3,llllllllllll,3077,1067,48,35,83,57.8%,12m
4195,3,吳怡農,3077,898,34,28,62,54.8%,4m
4195,2,[姆咪]巴蔡叔叔,3077,815,34,32,66,51.5%,12m
4195,1,Furen,3077,874,29,39,68,42.6%,4m
4195,3,슈퍼히어로,3077,60,3,1,4,75.0%,13m
4195,3,jkpxT,3077,86,3,3,6,50.0%,2m
4195,2,[라캐찐]Perlite,3077,0,1,0,1,100.0%,46m
4203,3,[옹선생님]요그,3076,747,55,34,89,61.8%,3m
4203,2,[AMA]aTtTa,3076,196,6,9,15,40.0%,6m
4203,3,[Noex]Houston,3076,58,2,8,10,20.0%,13m
4206,3,RiverCKC,3075,268,12,7,19,63.2%,13m
4206,3,misery,3075,254,9,7,16,56.2%,4m
4206,3,Brannty,3075,209,8,3,11,72.7%,13m
4206,3,[Equal]BYwooricoop,3075,216,6,5,11,54.5%,4m
4206,3,Player,3075,30,4,3,7,57.1%,13m
4206,3,NOOB,3075,116,3,0,3,100.0%,7m
4206,3,[CNCSPE]코드블랙,3075,58,2,8,10,20.0%,3m
4206,3,[Weihai]Kaimera,3075,0,1,0,1,100.0%,11m
4214,3,김기백,3074,30,1,4,5,20.0%,4m
4214,3,Twinkies,3074,0,0,1,1,0.0%,6m
4216,2,optimus,3073,0,4,1,5,80.0%,13m
4216,3,[자폐아]스타투,3073,58,3,1,4,75.0%,3m
4218,1,GloriaEhre,3072,1531,62,81,143,43.4%,11m
4218,3,[开打星战前夜]SantaMonica,3072,228,9,6,15,60.0%,7m
4218,2,Batman,3072,144,3,10,13,23.1%,2m
4218,3,바코드,3072,0,2,3,5,40.0%,2m
4222,2,llllllllllll,3071,1014,36,43,79,45.6%,6m
4222,3,IIIIllIIIllI,3071,541,26,11,37,70.3%,3m
4222,3,CUZUMP,3071,412,16,13,29,55.2%,6m
4222,3,llllllllllll,3071,343,15,3,18,83.3%,13m
4222,2,[그림그린]miku,3071,248,9,12,21,42.9%,6m
4222,2,回歸玩家,3071,30,5,4,9,55.6%,7m
4222,3,KIKKOUMASTER,3071,58,3,4,7,42.9%,12m
4222,3,송현우,3071,0,0,2,2,0.0%,13m
4222,3,[Teri]雷炫,3071,0,0,2,2,0.0%,3m
4222,3,Obama,3071,0,0,2,2,0.0%,12m
4232,3,Vic,3070,829,138,128,266,51.9%,12m
4232,2,[HN]은고개트럼프,3070,1511,121,106,227,53.3%,1m
4232,3,xeno,3070,140,5,7,12,41.7%,12m
4232,2,Bruse,3070,122,5,8,13,38.5%,46m
4232,2,[찬뿅원뿅]배뚱이,3070,0,3,2,5,60.0%,13m
4237,3,[Ato]오중기마지막유산,3069,1535,91,63,154,59.1%,12m
4237,2,SlimMusician,3069,1118,39,50,89,43.8%,11m
4237,2,lllllIlll,3069,512,18,26,44,40.9%,4m
4237,3,cozy,3069,423,17,10,27,63.0%,3m
4237,3,HolyShxt,3069,208,8,10,18,44.4%,12m
4237,3,ZPCI,3069,199,7,3,10,70.0%,11m
4237,3,[Trivia]ULayGyi,3069,118,4,8,12,33.3%,13m
4237,2,nacchinko,3069,64,2,8,10,20.0%,2m
4245,3,goozi,3068,1298,50,46,96,52.1%,7m
4245,3,[TMR]星塵爆裂,3068,788,30,31,61,49.2%,7m
4245,3,EJParz,3068,111,2,1,3,66.7%,12m
4245,3,Kasyanov,3068,0,1,0,1,100.0%,13m
4245,3,HeavensBox,3068,30,1,3,4,25.0%,7m
4245,3,[KRSC2]초무홈,3068,0,0,1,1,0.0%,1m
4251,2,[얼음치즈]힘안찐,3067,183,15,14,29,51.7%,2m
4251,3,흠이좋아,3067,438,15,20,35,42.9%,13m
4251,2,BullseyeJack,3067,160,6,3,9,66.7%,21m
4251,3,유리유리,3067,0,1,0,1,100.0%,12m
4251,3,Geralt,3067,0,1,0,1,100.0%,4m
4251,3,[RiceMi]薩科斯,3067,0,0,1,1,0.0%,12m
4251,2,Chanze,3067,0,0,2,2,0.0%,47m
4258,3,大家大便,3066,1183,217,205,422,51.4%,12m
4258,3,[너의ol름은]Expert,3066,972,45,32,77,58.4%,6m
4258,3,[Equal]루이나기,3066,30,1,2,3,33.3%,5m
4258,3,[SeA]LinG,3066,30,1,3,4,25.0%,3m
4262,3,LIS,3065,1188,54,43,97,55.7%,3m
4262,2,[겜동]hddgogogo,3065,943,43,42,85,50.6%,2m
4262,2,아둔의창,3065,0,3,4,7,42.9%,7m
4262,3,[에러스테이션]Egizaaaa,3065,30,2,0,2,100.0%,2m
4262,3,[봉다리]비니루,3065,30,1,4,5,20.0%,6m
4262,3,반도의미니콤,3065,0,0,3,3,0.0%,3m
4268,3,moodis,3064,1388,70,74,144,48.6%,3m
4268,1,甘蔗汁,3064,1080,38,51,89,42.7%,3m
4268,1,BilboBaggins,3064,217,5,3,8,62.5%,13m
4268,3,Masterick,3064,0,3,2,5,60.0%,6m
4268,3,[ZUZU]jack,3064,0,0,1,1,0.0%,4m
4273,3,르브론제임스,3063,296,13,6,19,68.4%,6m
4273,3,JinJo,3063,310,11,12,23,47.8%,2m
4273,1,lllllll,3063,197,6,12,18,33.3%,11m
4273,3,POLMIT,3063,30,2,2,4,50.0%,12m
4273,1,스타매냐,3063,0,1,1,2,50.0%,13m
4278,3,Tta,3062,866,51,38,89,57.3%,4m
4278,3,[OFA]NMinh,3062,406,15,18,33,45.5%,3m
4278,3,Zaki,3062,301,9,15,24,37.5%,13m
4278,3,eyah,3062,176,7,10,17,41.2%,12m
4278,3,[軟Q]老揚,3062,133,4,1,5,80.0%,12m
4278,3,Toshee,3062,86,4,3,7,57.1%,7m
4278,3,박새벽,3062,96,1,1,2,50.0%,6m
4278,3,저그마스터,3062,0,0,1,1,0.0%,7m
4286,2,Extravaganza,3061,1210,73,69,142,51.4%,2m
4286,3,HotSoup,3061,1206,70,65,135,51.9%,7m
4286,3,김호두,3061,1603,68,55,123,55.3%,2m
4286,3,granty,3061,627,32,23,55,58.2%,13m
4286,3,최나얼,3061,0,1,2,3,33.3%,6m
4286,3,Kynos,3061,30,1,7,8,12.5%,13m
4292,3,strom,3060,581,36,28,64,56.2%,3m
4292,3,다잡아먹쟈,3060,298,11,12,23,47.8%,5m
4292,1,조강지처가좋더라,3060,188,8,5,13,61.5%,14m
4292,3,서견,3060,0,3,2,5,60.0%,20m
4292,3,FungHan,3060,0,3,2,5,60.0%,20m
4292,3,marionetter,3060,0,0,1,1,0.0%,6m
4298,2,嘿嘿嘿,3059,1380,201,197,398,50.5%,4m
4298,3,마스터티어,3059,126,4,0,4,100.0%,3m
4298,3,치명타,3059,30,2,1,3,66.7%,6m
4298,3,[Sirena]아멘났네,3059,0,0,1,1,0.0%,3m
4298,3,강뱅구,3059,0,0,1,1,0.0%,13m
4303,3,안진마,3058,1397,181,165,346,52.3%,3m
4303,1,Java,3058,1229,78,86,164,47.6%,1m
4303,1,아이어,3058,688,30,27,57,52.6%,3m
4303,2,왕좌의게임,3058,113,5,3,8,62.5%,21m
4307,3,PrincRainier,3056,1433,105,87,192,54.7%,3m
4307,3,oDiNe,3056,239,8,7,15,53.3%,13m
4307,2,[AUE]나루시마,3056,216,7,7,14,50.0%,2m
4307,3,세엑수,3056,0,3,2,5,60.0%,20m
4307,3,LUCETE,3056,0,1,2,3,33.3%,6m
4312,3,[JUNG]아리,3055,1355,116,104,220,52.7%,3m
4312,3,Daehan,3055,344,15,7,22,68.2%,7m
4312,3,llllllllllll,3055,142,3,7,10,30.0%,13m
4312,3,[촌뜨기]indianBoy,3055,88,1,1,2,50.0%,3m
4312,3,[Poki]NARUIE,3055,0,0,1,1,0.0%,3m
4317,3,DearName,3054,1000,41,33,74,55.4%,3m
4317,3,Zephyr,3054,827,34,31,65,52.3%,2m
4317,2,[삼삼업]삼삼업바퀴,3054,489,22,27,49,44.9%,13m
4317,3,다게임,3054,152,15,10,25,60.0%,13m
4317,3,TaKoDarK,3054,30,4,3,7,57.1%,7m
4317,3,[자보스]징징키오,3054,30,2,6,8,25.0%,6m
4323,2,[RMB]yomate,3053,1564,744,720,1464,50.8%,4m
4323,3,처음,3053,733,40,34,74,54.1%,4m
4323,3,[411414]Grimmjo,3053,341,16,19,35,45.7%,12m
4323,3,sihyeong,3053,434,15,19,34,44.1%,11m
4323,3,저그개씹사기,3053,381,13,24,37,35.1%,3m
4323,3,꾸무리이,3053,170,6,2,8,75.0%,11m
4323,3,[시럽]바코드는벌레,3053,148,6,9,15,40.0%,2m
4323,3,KeiFromNYC,3053,0,1,0,1,100.0%,3m
4323,3,life,3053,95,1,1,2,50.0%,2m
4323,2,iZytm,3053,30,1,9,10,10.0%,2m
4333,3,[深耕C]PrAy,3052,928,41,33,74,55.4%,3m
4333,2,아마테라스,3052,517,22,16,38,57.9%,7m
4333,3,EggROG,3052,0,3,2,5,60.0%,2m
4333,3,下手,3052,58,3,3,6,50.0%,3m
4333,3,lIllIIIllII,3052,0,2,1,3,66.7%,35m
4333,3,Stork,3052,93,1,1,2,50.0%,3m
4333,3,wilson,3052,0,0,1,1,0.0%,11m
4333,3,习近平,3052,0,0,1,1,0.0%,7m
4341,2,이게뭐라고,3051,1236,46,54,100,46.0%,5m
4341,3,[ProTT]khalsolame,3051,113,3,0,3,100.0%,13m
4341,3,KORN,3051,0,0,1,1,0.0%,13m
4341,3,스타매니아,3051,0,0,1,1,0.0%,2m
4341,3,컴퓨터,3051,0,0,3,3,0.0%,16m
4346,3,신사무엘,3050,712,89,75,164,54.3%,3m
4346,2,Hades,3050,1539,64,70,134,47.8%,6m
4346,3,llllllllllll,3050,1197,60,52,112,53.6%,6m
4346,3,FePumpkin,3050,609,27,15,42,64.3%,12m
4346,2,[xTMDx]hondofish,3050,676,23,26,49,46.9%,13m
4346,3,큰개자리,3050,143,19,9,28,67.9%,11m
4346,3,taenorn,3050,329,13,7,20,65.0%,48m
4346,3,yumedoko,3050,30,2,3,5,40.0%,3m
4354,3,[krtag]TheBohemian,3049,185,5,5,10,50.0%,6m
4354,2,通通有獎,3049,95,4,2,6,66.7%,21m
4354,2,Hong,3049,88,4,4,8,50.0%,7m
4354,3,IIIIIIIIIIII,3049,0,1,1,2,50.0%,2m
4354,3,BamBam,3049,30,1,3,4,25.0%,2m
4359,3,gotomato,3048,172,7,7,14,50.0%,3m
4359,3,[BDS]미선아사랑해이기,3048,0,5,0,5,100.0%,4m
4359,1,IlIlIlIlIlIl,3048,96,5,2,7,71.4%,43m
4359,3,경맨,3048,120,4,5,9,44.4%,5m
4359,3,Eureka,3048,0,1,2,3,33.3%,7m
4359,3,[快樂玩家]白狐璃,3048,0,0,1,1,0.0%,3m
4359,3,kwangs,3048,0,0,2,2,0.0%,4m
4366,3,[S0fT]내가이영호,3047,962,48,44,92,52.2%,13m
4366,3,spTG,3047,410,42,47,89,47.2%,13m
4366,2,BeefKing,3047,381,16,17,33,48.5%,12m
4366,3,[教我合作]呼延覺羅延,3047,256,9,5,14,64.3%,3m
4366,3,HydrAlisk,3047,178,6,9,15,40.0%,3m
4366,3,[에러스테이션]사라져라울트라,3047,112,3,1,4,75.0%,3m
4366,3,[승딩이]GGS,3047,0,3,2,5,60.0%,19m
4366,3,[셀레스티아]핑카미나,3047,0,2,3,5,40.0%,20m
4374,2,세스코,3046,1560,238,216,454,52.4%,5m
4374,3,sessnpy,3046,668,25,20,45,55.6%,12m
4374,1,테사기,3046,169,6,6,12,50.0%,14m
4377,3,iptime,3045,1215,63,49,112,56.2%,12m
4377,3,adamantium,3045,1509,63,56,119,52.9%,13m
4377,2,hoonhoon,3045,1131,45,49,94,47.9%,4m
4377,3,PrPrPr,3045,536,30,18,48,62.5%,7m
4377,3,[OKRAN]운좋은경현,3045,606,24,18,42,57.1%,4m
4377,3,mod,3045,276,11,7,18,61.1%,47m
4377,3,Merit,3045,199,11,7,18,61.1%,47m
4377,3,yayagrou,3045,274,10,9,19,52.6%,6m
4377,3,錢渡有緣人,3045,272,10,11,21,47.6%,3m
4377,3,[개굴맨]개구리배꼽,3045,188,7,11,18,38.9%,12m
4377,3,大魔王先生,3045,94,5,1,6,83.3%,6m
4377,1,Rigzer,3045,200,5,3,8,62.5%,13m
4377,3,香煎鮪魚烤土司,3045,99,3,0,3,100.0%,3m
4377,2,스트라스블룸,3045,95,2,5,7,28.6%,21m
4377,3,LWatson,3045,30,1,3,4,25.0%,13m
4392,3,유스리더,3044,1559,112,103,215,52.1%,3m
4392,3,Enmare,3044,624,23,21,44,52.3%,3m
4392,3,단팥펭귄,3044,136,4,1,5,80.0%,4m
4392,3,lucy,3044,94,4,7,11,36.4%,7m
4392,3,KinGGOdBro,3044,0,3,0,3,100.0%,6m
4392,3,이름따위필요없다,3044,0,1,0,1,100.0%,2m
4398,3,[UN無限]SodaWater,3043,1519,63,64,127,49.6%,2m
4398,2,[형님나가신다]SCZone,3043,1069,53,53,106,50.0%,2m
4398,3,마스키,3043,424,18,13,31,58.1%,3m
4398,3,[개쫄보]산보마스터,3043,256,14,6,20,70.0%,2m
4398,3,llllllllllll,3043,277,12,5,17,70.6%,6m
4398,3,Zantrid,3043,0,1,1,2,50.0%,7m
4398,3,자러감수고바위,3043,0,1,4,5,20.0%,6m
4405,3,Company,3042,1404,229,209,438,52.3%,11m
4405,3,TheViksBack,3042,1471,128,108,236,54.2%,13m
4405,3,[빡빡대머리]CUBANITO,3042,819,34,27,61,55.7%,6m
4405,3,KEYSTONE,3042,587,29,13,42,69.0%,7m
4405,3,개초보입니다,3042,169,7,5,12,58.3%,7m
4405,3,[코코갈비]Snack,3042,134,3,3,6,50.0%,13m
4405,3,[Away]aby,3042,0,0,1,1,0.0%,6m
4405,2,DiBli,3042,0,0,1,1,0.0%,47m
4413,3,MHS,3041,956,64,56,120,53.3%,12m
4413,3,cilantro,3041,951,42,33,75,56.0%,6m
4413,3,띵규박사,3041,422,27,18,45,60.0%,4m
4413,3,Duke,3041,341,13,6,19,68.4%,48m
4413,1,overcome,3041,95,4,2,6,66.7%,43m
4413,3,꼬소꼬소,3041,92,4,2,6,66.7%,12m
4413,3,Essien,3041,62,3,7,10,30.0%,2m
4413,3,국산비둘기,3041,91,1,3,4,25.0%,7m
4413,3,ROuGGy,3041,0,0,2,2,0.0%,5m
4422,3,다이야다,3040,956,41,33,74,55.4%,7m
4422,3,원할머니보고쌈,3040,960,35,35,70,50.0%,3m
4422,3,달린다치타,3040,184,10,4,14,71.4%,6m
4422,3,JIE,3040,234,7,10,17,41.2%,5m
4422,3,LoVe,3040,0,3,3,6,50.0%,3m
4422,1,saber,3040,0,1,0,1,100.0%,45m
4422,1,Superxo,3040,0,0,1,1,0.0%,44m
4422,3,LookWhat,3040,0,0,1,1,0.0%,12m
4430,3,MMM,3039,784,106,81,187,56.7%,13m
4430,2,원할머니보고쌈,3039,1368,49,60,109,45.0%,4m
4430,3,페라리,3039,148,6,9,15,40.0%,3m
4430,3,[習近平]lIlIIlIIlIIl,3039,62,2,8,10,20.0%,12m
4434,3,초코보숭이,3038,241,7,6,13,53.8%,7m
4434,3,암해사,3038,0,4,2,6,66.7%,12m
4434,3,걸리면이빨부터다,3038,86,4,4,8,50.0%,5m
4434,3,blastar,3038,86,3,4,7,42.9%,6m
4434,1,BEELZ,3038,30,1,1,2,50.0%,45m
4434,1,[비트]ShaDow,3038,44,1,1,2,50.0%,45m
4434,1,기생수,3038,0,0,1,1,0.0%,45m
4441,3,나누,3037,1183,60,55,115,52.2%,3m
4441,1,Kushinda,3037,134,5,3,8,62.5%,44m
4441,3,[버거킹킹]망한버거킹,3037,0,0,2,2,0.0%,12m
4444,2,[트위치TV]원거리라이더,3036,1089,241,226,467,51.6%,2m
4444,3,개죽이주께기다려,3036,60,3,2,5,60.0%,6m
4444,3,구리구리,3036,30,2,2,4,50.0%,6m
4444,3,[쇼타임]테스형,3036,0,1,1,2,50.0%,13m
4448,3,[3맨빌런]까탈레나,3035,217,11,7,18,61.1%,13m
4448,3,IIIIIlllllII,3035,218,11,9,20,55.0%,13m
4448,2,DDDDD,3035,140,6,6,12,50.0%,21m
4448,3,우아,3035,0,3,1,4,75.0%,20m
4448,1,[Saints]세인츠로우,3035,0,2,3,5,40.0%,43m
4448,3,noraneko,3035,30,2,4,6,33.3%,5m
4448,1,꽃을버리다,3035,0,1,0,1,100.0%,45m
4448,1,slipslip,3035,0,1,0,1,100.0%,44m
4448,3,Avatool,3035,30,1,3,4,25.0%,2m
4448,1,끝까지가다,3035,0,0,1,1,0.0%,45m
4458,3,kkkkkk,3034,568,30,29,59,50.8%,13m
4458,1,IllIllll,3034,145,6,5,11,54.5%,13m
4458,3,llllllllllll,3034,0,4,1,5,80.0%,20m
4458,3,초코쿠키제조,3034,88,3,6,9,33.3%,1m
4458,1,지지고,3034,122,2,3,5,40.0%,43m
4458,1,사라케리건,3034,0,0,1,1,0.0%,43m
4464,3,꾸밈,3033,227,7,6,13,53.8%,6m
4464,3,[ElsAna]민짱구,3033,214,7,11,18,38.9%,11m
4464,3,장수용짱,3033,0,0,4,4,0.0%,11m
4467,3,[카봇]Joon,3032,367,16,13,29,55.2%,7m
4467,3,knightzz,3032,361,14,13,27,51.9%,2m
4467,3,불량감자아뵤,3032,178,6,9,15,40.0%,2m
4467,1,[CoCoA]ios,3032,112,4,2,6,66.7%,45m
4467,3,mujuk,3032,93,2,1,3,66.7%,13m
4467,1,[건호짱]꿀벌,3032,73,1,3,4,25.0%,43m
4467,1,[한발이면]Siro,3032,0,0,3,3,0.0%,14m
4474,3,SecretSouL,3031,515,22,19,41,53.7%,6m
4474,3,jerry,3031,389,17,11,28,60.7%,3m
4474,3,[vFlow]LYcoS,3031,127,6,4,10,60.0%,12m
4477,3,조르바,3030,428,15,19,34,44.1%,12m
4477,2,llllllllllll,3030,30,4,6,10,40.0%,1m
4477,3,스시김초밥,3030,0,0,2,2,0.0%,13m
4480,1,구이쁜,3029,278,7,6,13,53.8%,45m
4480,3,TGOK,3029,60,2,3,5,40.0%,6m
4480,2,붕어빵달인김효섭,3029,117,2,3,5,40.0%,13m
4480,1,GaNiNa,3029,0,1,0,1,100.0%,45m
4480,3,lll,3029,89,1,2,3,33.3%,6m
4480,3,Greentea,3029,0,1,3,4,25.0%,19m
4486,3,연산동호래이,3028,407,13,13,26,50.0%,12m
4486,1,Aeek,3028,296,11,7,18,61.1%,43m
4486,3,[인정]llllllllllll,3028,140,6,9,15,40.0%,13m
4486,1,고려대학교,3028,30,2,0,2,100.0%,44m
4486,3,최종병기,3028,0,1,2,3,33.3%,3m
4491,3,nyo,3027,444,18,17,35,51.4%,13m
4491,3,빙의화,3027,94,3,9,12,25.0%,11m
4491,3,염죄,3027,0,1,1,2,50.0%,3m
4491,3,Ossan,3027,0,1,1,2,50.0%,20m
4491,2,sss,3027,0,0,1,1,0.0%,21m
4496,3,shsmsrj,3026,1513,153,145,298,51.3%,11m
4496,3,hotsooo,3026,964,64,47,111,57.7%,3m
4496,3,Younotalone,3026,293,14,11,25,56.0%,2m
4496,2,龍華欽,3026,0,4,2,6,66.7%,21m
4496,1,ANNU,3026,38,2,1,3,66.7%,45m
4501,3,JeffVeda,3025,1521,311,275,586,53.1%,13m
4501,3,알렉산드로,3025,165,5,3,8,62.5%,13m
4501,2,Lafe,3025,96,2,0,2,100.0%,22m
4504,2,서빈이,3024,1520,120,122,242,49.6%,12m
4504,2,[비트]dsfe,3024,1240,53,52,105,50.5%,2m
4504,3,차추,3024,364,27,14,41,65.9%,7m
4504,2,크리에이티브,3024,48,4,4,8,50.0%,21m
4504,1,Kim,3024,0,2,2,4,50.0%,44m
4509,3,[중금속중독자]AKG,3023,982,44,39,83,53.0%,13m
4509,3,FOodLiOn,3023,367,16,10,26,61.5%,2m
4509,3,스타접은지오래다,3023,436,15,18,33,45.5%,7m
4509,3,풍풍전사,3023,260,10,12,22,45.5%,3m
4509,1,llllIIllIll,3023,0,3,2,5,60.0%,44m
4509,1,아일루,3023,0,0,1,1,0.0%,43m
4509,1,FeedMeZorg,3023,0,0,1,1,0.0%,43m
4516,3,我是奇奇,3022,251,11,6,17,64.7%,13m
4516,1,DonkeyBandit,3022,178,9,5,14,64.3%,22m
4516,3,[세미레전드]하니,3022,237,7,7,14,50.0%,13m
4516,1,Oldhead,3022,121,6,5,11,54.5%,14m
4516,3,[DeFT5]Freddy,3022,0,0,1,1,0.0%,16m
4521,3,메이저리그,3021,1183,46,40,86,53.5%,12m
4521,1,TTT,3021,159,4,4,8,50.0%,14m
4521,2,MXM,3021,140,4,5,9,44.4%,13m
4521,1,[天下布武]織田信長,3021,118,3,1,4,75.0%,45m
4521,1,reloco,3021,0,1,0,1,100.0%,43m
4521,3,[비트]개가튼,3021,96,1,2,3,33.3%,2m
4521,1,Flowers,3021,73,0,2,2,0.0%,46m
4528,1,Torb,3020,163,8,6,14,57.1%,15m
4528,1,KJH,3020,0,2,2,4,50.0%,46m
4528,3,FourKneeKate,3020,58,2,3,5,40.0%,13m
4528,1,FIREX,3020,0,0,1,1,0.0%,45m
4528,1,백만송이장미,3020,0,0,1,1,0.0%,43m
4533,3,[럭키]llllllllllll,3019,480,44,37,81,54.3%,13m
4533,1,[VASCO]해랑사,3019,256,7,6,13,53.8%,45m
4533,1,[청라충]태양석빠돌이,3019,104,3,1,4,75.0%,43m
4533,3,[eXoPH]eXo,3019,93,2,2,4,50.0%,11m
4533,2,맹독은맹독맹독해,3019,46,1,3,4,25.0%,21m
4538,3,mori,3018,1508,113,99,212,53.3%,13m
4538,3,HakunaMatata,3018,1144,73,65,138,52.9%,13m
4538,3,꼬마자객,3018,263,12,4,16,75.0%,3m
4538,1,tpztmarine,3018,168,7,5,12,58.3%,43m
4538,1,许柯,3018,0,2,3,5,40.0%,43m
4538,3,사람,3018,0,1,1,2,50.0%,12m
4544,3,[Newbe1]干饭人,3017,792,39,30,69,56.5%,13m
4544,2,[CnB]랜덤끄지라,3017,896,30,41,71,42.3%,6m
4544,2,[cAnOp]과연김지훈,3017,705,26,34,60,43.3%,6m
4544,3,당나귀칠기기장님,3017,650,23,28,51,45.1%,4m
4544,3,[없지요]IllIllllIllI,3017,30,2,3,5,40.0%,3m
4544,3,iiiiiiiiiiii,3017,0,0,2,2,0.0%,6m
4550,3,cokiki,3016,1489,95,67,162,58.6%,6m
4550,3,Nietzsche,3016,591,46,37,83,55.4%,7m
4550,2,Killer,3016,739,31,29,60,51.7%,4m
4550,3,맹구,3016,157,3,7,10,30.0%,6m
4550,1,stark,3016,0,1,0,1,100.0%,45m
4550,1,리그위너,3016,0,1,0,1,100.0%,45m
4550,1,[북극펭귄]펭굴,3016,42,1,1,2,50.0%,45m
4557,3,HumbleCat,3015,215,12,6,18,66.7%,2m
4557,3,저글링싫음,3015,254,8,5,13,61.5%,47m
4557,1,kOy,3015,0,1,0,1,100.0%,44m
4560,2,나나나나솨나나솨,3014,859,85,97,182,46.7%,2m
4560,3,AwakinG,3014,815,37,26,63,58.7%,2m
4560,3,Player,3014,606,21,26,47,44.7%,13m
4560,3,Andy,3014,288,8,11,19,42.1%,13m
4560,3,sopantalia,3014,192,7,13,20,35.0%,6m
4560,3,오상헌,3014,118,5,5,10,50.0%,3m
4560,2,리치,3014,128,5,14,19,26.3%,6m
4560,1,Final,3014,40,2,0,2,100.0%,44m
4560,1,나나하아,3014,72,2,2,4,50.0%,46m
4569,1,lIllIIIIlllI,3013,1200,241,249,490,49.2%,4m
4569,3,COCOCOCOCO,3013,1252,51,46,97,52.6%,4m
4569,2,Proboarder,3013,167,6,3,9,66.7%,22m
4569,3,MIS,3013,135,6,4,10,60.0%,13m
4569,2,Viper,3013,30,5,4,9,55.6%,6m
4569,3,Kronuts,3013,120,3,2,5,60.0%,15m
4569,1,Ptolemaeos,3013,0,0,1,1,0.0%,45m
4576,2,Areskss,3012,473,36,39,75,48.0%,13m
4576,3,IIII,3012,154,4,4,8,50.0%,13m
4578,3,OOXIXOO,3011,1534,315,293,608,51.8%,11m
4578,1,라라,3011,923,40,30,70,57.1%,45m
4578,3,Dark,3011,243,15,10,25,60.0%,3m
4578,2,needless,3011,142,5,1,6,83.3%,13m
4578,2,사람사는세상,3011,0,0,1,1,0.0%,22m
4583,2,[굿잡]로우,3010,1482,219,215,434,50.5%,1m
4583,3,바퀴충문재인,3010,681,109,91,200,54.5%,11m
4583,3,MainStreet,3010,960,79,72,151,52.3%,12m
4583,3,Beyou,3010,961,42,35,77,54.5%,7m
4583,1,deyt,3010,961,39,27,66,59.1%,45m
4583,1,[확산파티]Gunner,3010,292,11,5,16,68.8%,13m
4583,1,Eagleton,3010,24,6,6,12,50.0%,3m
4583,2,CFour,3010,188,6,17,23,26.1%,2m
4583,2,[ELSII]maNa,3010,88,4,6,10,40.0%,2m
4583,2,장애인,3010,161,3,4,7,42.9%,22m
4583,1,구랭킹,3010,78,2,1,3,66.7%,45m
4583,1,HunterHealer,3010,0,0,1,1,0.0%,45m
4595,1,송골매,3009,1697,220,213,433,50.8%,44m
4595,3,Simple,3009,222,8,8,16,50.0%,3m
4595,2,[두당60원]plough,3009,44,5,3,8,62.5%,22m
4595,1,싫어바이바,3009,44,2,0,2,100.0%,43m
4595,3,[삼국시대]헤헤희수,3009,58,2,5,7,28.6%,3m
4595,3,밍밍,3009,0,0,2,2,0.0%,48m
4601,3,RunYouOver,3008,523,21,16,37,56.8%,12m
4601,3,AnKH,3008,127,6,4,10,60.0%,3m
4601,1,Phosphoid,3008,0,3,2,5,60.0%,45m
4601,3,老爺不要夫人在看,3008,0,1,2,3,33.3%,7m
4605,1,Edge,3007,359,13,12,25,52.0%,45m
4605,3,레알너구리,3007,263,11,11,22,50.0%,13m
4605,2,농민봉기,3007,143,7,9,16,43.8%,46m
4605,3,용깡,3007,144,6,7,13,46.2%,3m
4605,3,doubleqpc,3007,187,5,2,7,71.4%,16m
4605,3,nope,3007,145,4,2,6,66.7%,47m
4605,3,米普,3007,121,2,2,4,50.0%,48m
4605,1,CLAP,3007,40,2,2,4,50.0%,45m
4605,3,TakeOfSoul,3007,0,2,3,5,40.0%,20m
4605,1,[귀요미햄스터]세느,3007,40,1,1,2,50.0%,43m
4605,3,[핑핑이]castlebin,3007,18,1,4,5,20.0%,3m
4616,2,리베르탱,3006,240,12,9,21,57.1%,6m
4616,1,우리이쁜승희,3006,230,7,6,13,53.8%,44m
4616,2,으앙살려줭,3006,158,6,4,10,60.0%,21m
4616,3,GoGoDreaM,3006,123,4,1,5,80.0%,20m
4620,3,[MN77]WaterTreeNA,3005,458,20,17,37,54.1%,6m
4620,1,[알파go]UnknownGyo,3005,288,12,14,26,46.2%,3m
4620,3,[GIS]血月已成為傳說,3005,263,12,15,27,44.4%,3m
4620,2,니엄마다,3005,131,7,6,13,53.8%,6m
4624,1,[RedSky]Methodman,3004,74,2,4,6,33.3%,43m
4624,1,[시럽]강유,3004,0,1,0,1,100.0%,45m
4624,3,Eiushua,3004,30,1,5,6,16.7%,3m
4627,1,gOmPlay,3003,1495,67,80,147,45.6%,12m
4627,1,Elvis,3003,474,25,21,46,54.3%,45m
4627,3,[JST]PakKim,3003,338,14,13,27,51.9%,6m
4627,3,Majaja,3003,219,6,7,13,46.2%,7m
4627,1,Jviator,3003,72,3,0,3,100.0%,43m
4632,3,EoS,3002,1526,184,187,371,49.6%,13m
4632,3,저그왕,3002,773,55,60,115,47.8%,12m
4632,3,[NGameS]불굴의특급전사,3002,581,20,23,43,46.5%,13m
4632,1,llllllllllll,3002,494,13,10,23,56.5%,46m
4632,1,화랑,3002,30,4,2,6,66.7%,44m
4632,2,GeorgCa,3002,112,4,3,7,57.1%,22m
4632,1,Dark,3002,0,2,3,5,40.0%,43m
4632,3,Sie,3002,30,2,4,6,33.3%,3m
4640,3,[dfg133]폭풍드롭,3001,646,46,35,81,56.8%,12m
4640,3,llwei,3001,440,16,15,31,51.6%,6m
4640,3,cSTrapCard,3001,325,15,9,24,62.5%,2m
4640,1,호야쓰삐,3001,0,1,4,5,20.0%,46m
4644,2,橄欖趴,3000,943,57,44,101,56.4%,4m
4644,1,SilenceRiver,3000,991,40,27,67,59.7%,43m
4644,3,ZerGnLoAthNG,3000,352,14,9,23,60.9%,3m
4644,1,[국가정보원]필승해군,3000,402,12,11,23,52.2%,45m
4644,3,Bluefire,3000,93,4,2,6,66.7%,13m
4649,3,서브마리너,2999,533,29,37,66,43.9%,1m
4649,2,[STLIKE]스투라이크,2999,143,4,3,7,57.1%,22m
4649,1,samsung,2999,0,0,2,2,0.0%,45m
4649,1,uglas,2999,0,0,3,3,0.0%,45m
4653,3,JLS,2998,830,35,25,60,58.3%,4m
4653,1,유노오빠,2998,327,10,10,20,50.0%,45m
4653,1,Non,2998,152,5,5,10,50.0%,45m
4653,1,알록달록청포도,2998,0,4,1,5,80.0%,45m
4653,1,크림스프,2998,0,0,1,1,0.0%,45m
4658,3,[TITOS]Einein,2997,1176,143,131,274,52.2%,2m
4658,1,[快樂玩家]LanceBlank,2997,292,12,6,18,66.7%,23m
4658,1,KOKOK,2997,270,11,5,16,68.8%,15m
4658,3,Tamamo,2997,119,3,3,6,50.0%,3m
4658,1,Sian,2997,0,1,1,2,50.0%,44m
4658,2,윤구,2997,0,0,2,2,0.0%,22m
4664,3,철사마,2996,1142,49,37,86,57.0%,6m
4664,1,해를사랑한구름,2996,184,6,5,11,54.5%,45m
4664,3,MAX,2996,168,6,10,16,37.5%,3m
4664,2,[제26충격군]샤를,2996,186,5,9,14,35.7%,11m
4664,3,김원진죽인다,2996,62,2,5,7,28.6%,7m
4669,3,休閒的小玩家,2995,498,19,17,36,52.8%,13m
4669,1,[護士小姐讚]體檢時充血,2995,224,7,5,12,58.3%,45m
4669,3,choil,2995,162,5,3,8,62.5%,3m
4669,3,[fpsk]똥규스,2995,119,3,3,6,50.0%,2m
4669,3,[Brings]명훈삼촌,2995,30,1,5,6,16.7%,6m
4669,1,CAT,2995,0,0,1,1,0.0%,44m
4675,1,URmyProtein,2994,1601,109,98,207,52.7%,45m
4675,3,rhinoceros,2994,305,12,8,20,60.0%,3m
4675,2,IIIIIIIII,2994,48,5,4,9,55.6%,22m
4675,3,테란시발,2994,30,3,5,8,37.5%,13m
4679,1,[카악퉤]조옷고수,2993,520,27,0,27,100.0%,43m
4679,1,邊個扔刀柄,2993,625,23,18,41,56.1%,44m
4679,2,[AftWar]박살공주,2993,96,4,3,7,57.1%,21m
4679,3,[무한오영종]chovy,2993,116,3,3,6,50.0%,6m
4679,1,[레더]lIlllIIIllIl,2993,40,2,1,3,66.7%,44m
4679,3,나르샤,2993,114,2,4,6,33.3%,6m
4679,1,묵이,2993,0,0,2,2,0.0%,45m
4686,3,挖鼻屎,2992,1508,161,145,306,52.6%,7m
4686,3,Macaron,2992,180,6,13,19,31.6%,6m
4686,3,星空幻境,2992,0,3,2,5,60.0%,20m
4686,1,NewTigor,2992,0,1,0,1,100.0%,43m
4686,1,vitamin,2992,93,1,1,2,50.0%,45m
4686,1,[저바다에누워]大韓民國,2992,0,0,2,2,0.0%,44m
4692,1,Shadow,2991,0,0,1,1,0.0%,45m
4693,2,[ARDBEG]이긴걸로하자,2990,671,44,53,97,45.4%,4m
4693,2,rechts,2990,122,8,7,15,53.3%,2m
4693,3,Jammie,2990,92,2,2,4,50.0%,13m
4696,1,아이가타고있어요,2989,1648,79,75,154,51.3%,45m
4696,1,BlackBox,2989,535,18,14,32,56.2%,44m
4696,1,atmosphere,2989,414,15,12,27,55.6%,43m
4696,1,dualin,2989,298,9,4,13,69.2%,44m
4696,1,사악한곰,2989,82,2,4,6,33.3%,45m
4696,1,루시퍼,2989,0,0,1,1,0.0%,45m
4696,3,[빨간달]Frost,2989,0,0,5,5,0.0%,3m
4703,1,카친스키,2988,482,18,15,33,54.5%,45m
4703,1,[엔타로앞마당]십팔케이,2988,272,7,13,20,35.0%,44m
4703,1,whoami,2988,30,1,1,2,50.0%,46m
4703,1,Bob,2988,0,0,1,1,0.0%,45m
4707,1,[TwoS]Ray,2987,89,4,3,7,57.1%,45m
4707,1,rlaqhtjd,2987,82,3,1,4,75.0%,45m
4707,1,Hanson,2987,0,3,2,5,60.0%,43m
4707,1,RequiemStory,2987,118,3,3,6,50.0%,45m
4707,3,앤시,2987,60,2,7,9,22.2%,13m
4712,3,빅뱅,2986,941,69,70,139,49.6%,1m
4712,1,FenixoP,2986,74,3,0,3,100.0%,45m
4714,3,AcidRain,2985,459,41,41,82,50.0%,3m
4714,2,짐레이너,2985,205,6,6,12,50.0%,21m
4714,1,Dao,2985,0,1,0,1,100.0%,46m
4714,3,HydraLisk,2985,30,1,5,6,16.7%,3m
4718,1,[isnous]Terminater,2984,975,45,37,82,54.9%,45m
4718,2,우주최고,2984,116,5,3,8,62.5%,22m
4718,1,[Worm]jung,2984,104,3,2,5,60.0%,45m
4718,1,Barcode,2984,0,3,2,5,60.0%,43m
4722,2,영광의재인,2983,824,68,58,126,54.0%,2m
4722,1,mint,2983,720,32,20,52,61.5%,43m
4722,1,한지,2983,301,21,11,32,65.6%,44m
4722,3,Lcritic,2983,562,21,23,44,47.7%,13m
4722,1,투신,2983,104,4,1,5,80.0%,45m
4727,1,[ATM]RushB,2982,1291,57,53,110,51.8%,44m
4727,1,TIME,2982,297,13,2,15,86.7%,46m
4727,2,GTO,2982,268,9,16,25,36.0%,6m
4727,1,[irnman]오시리스,2982,183,7,6,13,53.8%,15m
4727,1,플랑,2982,0,3,2,5,60.0%,43m
4727,3,[이쿠노]nightdm,2982,62,3,9,12,25.0%,1m
4733,1,전장은나쁜게임,2981,341,11,7,18,61.1%,45m
4733,1,MarlbororRED,2981,0,0,1,1,0.0%,45m
4733,1,LeleJLs,2981,0,0,1,1,0.0%,45m
4736,3,뀨햄스터,2980,480,17,24,41,41.5%,2m
4736,2,adjact,2980,117,3,4,7,42.9%,21m
4736,3,Ilectric,2980,0,1,1,2,50.0%,6m
4739,3,Lucky,2979,299,11,11,22,50.0%,3m
4740,3,酷冰,2977,844,31,32,63,49.2%,13m
4740,2,렉걸려라얍얍,2977,95,4,11,15,26.7%,47m
4740,3,[Lp]IrOnAnGeL,2977,0,3,1,4,75.0%,19m
4740,1,Initial,2977,143,3,2,5,60.0%,45m
4744,2,개념원리,2976,525,39,48,87,44.8%,6m
4744,1,팔리아멘트,2976,241,7,5,12,58.3%,14m
4744,1,[중금속중독자]TLQKFSHA,2976,201,5,4,9,55.6%,45m
4744,3,스타드림,2976,0,0,2,2,0.0%,5m
4748,2,protole,2975,0,1,2,3,33.3%,21m
4749,2,地知治世要,2974,1578,69,78,147,46.9%,12m
4749,3,무무히,2974,872,43,30,73,58.9%,7m
4749,3,Jealous,2974,539,23,18,41,56.1%,2m
4749,1,Colossus,2974,70,4,5,9,44.4%,44m
4749,3,ASAP,2974,0,3,1,4,75.0%,20m
4749,3,SteeveJK,2974,0,3,2,5,60.0%,20m
4749,1,[머구폐렴]kickyourass,2974,40,2,1,3,66.7%,45m
4749,1,llIIlllIIIlI,2974,0,0,2,2,0.0%,44m
4757,3,combative,2973,1463,60,64,124,48.4%,12m
4757,1,Newforces,2973,854,46,41,87,52.9%,44m
4757,1,Andreas,2973,88,1,1,2,50.0%,43m
4757,3,우주날개,2973,0,1,8,9,11.1%,1m
4761,2,[비트]LeeJay,2972,1302,54,53,107,50.5%,4m
4761,1,蹦蹦騎士,2972,696,24,18,42,57.1%,43m
4761,1,Okaka,2972,317,10,3,13,76.9%,45m
4761,3,[NANT]TerraNova,2972,0,1,0,1,100.0%,20m
4765,3,lIllllllIIII,2971,962,34,41,75,45.3%,2m
4765,3,KingDavid,2971,518,21,23,44,47.7%,12m
4765,3,Phizzler,2971,260,10,6,16,62.5%,16m
4765,1,BiO,2971,292,8,9,17,47.1%,45m
4765,1,Romer,2971,216,7,4,11,63.6%,45m
4765,3,StupidJack,2971,150,6,11,17,35.3%,3m
4765,1,SevenCutter,2971,128,4,3,7,57.1%,45m
4765,3,[엽기전략]광고창작,2971,86,4,9,13,30.8%,3m
4765,3,[밀짚모해적단]채소장수,2971,0,2,3,5,40.0%,20m
4774,1,[D3StaR]디스펜서,2970,902,50,35,85,58.8%,45m
4774,1,how,2970,572,30,19,49,61.2%,46m
4774,1,Minuk,2970,40,2,0,2,100.0%,44m
4774,2,来找小秘书,2970,96,2,1,3,66.7%,21m
4774,1,홍진호,2970,70,2,4,6,33.3%,45m
4774,1,WenliYang,2970,107,1,2,3,33.3%,44m
4774,3,[비상천]무한강화,2970,0,1,2,3,33.3%,19m
4774,1,포풍저그콩진호,2970,0,0,1,1,0.0%,43m
4774,3,[월야]할룽,2970,0,0,7,7,0.0%,12m
4783,3,sukide,2969,1367,92,86,178,51.7%,6m
4783,1,[형님나가신다]불곰,2969,1139,48,34,82,58.5%,43m
4783,3,아버지,2969,335,14,5,19,73.7%,4m
4783,3,曹操蹲完夏侯惇,2969,220,7,17,24,29.2%,2m
4783,1,[긴급스섹대]올인안하는사람,2969,32,2,1,3,66.7%,45m
4783,1,monarch,2969,0,1,1,2,50.0%,43m
4789,3,讓我好不好,2968,755,61,47,108,56.5%,13m
4789,1,Indious,2968,220,8,7,15,53.3%,44m
4789,2,[EmPeRo]VoidRay,2968,118,6,11,17,35.3%,2m
4789,1,MagicKim,2968,0,3,2,5,60.0%,44m
4793,3,[민창렬]mms,2967,265,11,10,21,52.4%,48m
4793,1,oopsoops,2967,269,8,4,12,66.7%,45m
4793,3,anwin,2967,156,7,5,12,58.3%,3m
4793,1,rpdlagkek,2967,218,6,3,9,66.7%,43m
4793,3,llllllllllll,2967,32,4,2,6,66.7%,20m
4793,1,[도사]미믹냠,2967,120,3,3,6,50.0%,45m
4793,3,[스덕스창]AUO,2967,0,1,5,6,16.7%,19m
4793,1,비싼한돈,2967,0,0,1,1,0.0%,45m
4801,3,슈슈버거,2966,1576,146,135,281,52.0%,12m
4801,3,Blue,2966,626,27,24,51,52.9%,13m
4801,3,Novice,2966,540,20,22,42,47.6%,12m
4801,3,Lightning,2966,282,12,10,22,54.5%,16m
4801,1,lastbionic,2966,34,1,2,3,33.3%,45m
4801,1,[고등학생연합]전주광역시,2966,0,0,2,2,0.0%,45m
4807,1,AssamMilkTea,2965,1015,35,48,83,42.2%,4m
4807,3,lIIlllIIl,2965,222,8,5,13,61.5%,6m
4807,3,IIIIIIIIIIII,2965,94,1,5,6,16.7%,7m
4807,1,SuBaru,2965,0,0,1,1,0.0%,15m
4811,1,[ELSII]래툰,2964,1115,59,46,105,56.2%,46m
4811,3,ChameesulO,2964,394,14,18,32,43.8%,13m
4811,3,臭皮出來玩,2964,0,3,2,5,60.0%,20m
4811,1,착한곰,2964,70,2,4,6,33.3%,45m
4811,1,[GK1ng]scpsoul,2964,0,0,1,1,0.0%,45m
4811,1,Cube,2964,0,0,1,1,0.0%,44m
4817,1,FatherOmeara,2963,283,11,8,19,57.9%,15m
4817,1,Ivan,2963,280,10,8,18,55.6%,43m
4817,1,[해운대고]MiracleK,2963,0,2,1,3,66.7%,43m
4817,1,[Accoun]클루,2963,0,1,0,1,100.0%,45m
4817,1,노군,2963,0,1,0,1,100.0%,45m
4817,1,[FoIIow]poxxhub,2963,0,1,1,2,50.0%,45m
4817,1,Naruto,2963,0,0,2,2,0.0%,45m
4824,1,EasyKaTkA,2962,253,10,7,17,58.8%,13m
4824,1,[국방부사서병]DawnAir,2962,88,4,2,6,66.7%,43m
4826,3,肆贰玖,2961,0,3,2,5,60.0%,20m
4826,1,[Epik]PathiZ,2961,36,2,0,2,100.0%,45m
4826,2,Alicorn,2961,64,2,12,14,14.3%,4m
4826,1,Chiuouo,2961,40,1,1,2,50.0%,45m
4826,1,가쿠,2961,0,0,1,1,0.0%,45m
4831,3,스나이퍼,2960,957,67,70,137,48.9%,2m
4831,1,destroyer,2960,70,2,4,6,33.3%,44m
4831,1,llllIIIllllI,2960,97,1,4,5,20.0%,43m
4834,1,嫩煎牛小排佐松露,2959,64,3,1,4,75.0%,45m
4834,1,Venis,2959,0,1,4,5,20.0%,44m
4834,1,매직빤쓰,2959,0,0,2,2,0.0%,45m
4837,3,march,2958,1552,109,97,206,52.9%,6m
4837,2,[RoYaLs]Outsider,2958,938,51,54,105,48.6%,4m
4837,1,hoon,2958,512,18,14,32,56.2%,44m
4837,1,这游戏没办法玩了,2958,336,13,13,26,50.0%,45m
4837,1,건설로봇,2958,145,7,4,11,63.6%,14m
4837,1,TinyLittlDot,2958,147,4,1,5,80.0%,44m
4837,1,bear,2958,108,4,3,7,57.1%,45m
4844,3,Commissar,2957,408,22,12,34,64.7%,6m
4844,3,starmagezine,2957,335,14,10,24,58.3%,2m
4844,1,인간태풍,2957,138,6,3,9,66.7%,45m
4844,1,Rooxy,2957,30,1,2,3,33.3%,45m
4848,3,Atlas,2956,254,10,8,18,55.6%,3m
4848,1,마션임파서블,2956,184,8,5,13,61.5%,45m
4848,1,igna,2956,152,4,4,8,50.0%,45m
4848,1,Tuna,2956,36,2,1,3,66.7%,43m
4848,2,Dath,2956,30,1,10,11,9.1%,4m
4853,3,SiRiUS,2955,711,63,67,130,48.5%,3m
4853,1,똥맹이,2955,542,17,15,32,53.1%,44m
4853,1,밀도,2955,36,2,0,2,100.0%,45m
4853,1,[패자는피를]악어나초,2955,0,1,0,1,100.0%,45m
4853,1,전략적지휘자제리,2955,42,1,2,3,33.3%,45m
4853,1,Malu,2955,32,1,2,3,33.3%,45m
4853,1,[larva]바퀴,2955,0,0,1,1,0.0%,14m
4860,2,FirstLotus,2954,791,138,138,276,50.0%,4m
4860,3,左腿政治,2954,1194,44,46,90,48.9%,6m
4860,2,llllllllllll,2954,117,5,4,9,55.6%,22m
4860,1,Apolowik,2954,0,4,3,7,57.1%,45m
4860,1,Ashley,2954,36,2,2,4,50.0%,45m
4860,1,BUNTUTS,2954,40,1,3,4,25.0%,45m
4866,3,감진고래,2953,1265,93,88,181,51.4%,3m
4866,1,Bruce,2953,168,10,4,14,71.4%,44m
4866,1,맴매정현이,2953,0,3,1,4,75.0%,43m
4866,3,niewiadom,2953,0,3,2,5,60.0%,20m
4866,1,ABC,2953,0,0,1,1,0.0%,45m
4871,3,Lucifertd,2952,1393,93,83,176,52.8%,7m
4871,1,곶감먹으러곶감,2952,213,8,6,14,57.1%,43m
4871,3,[갯벌]Disco,2952,208,8,15,23,34.8%,3m
4871,1,[HYBUFF]버프천사,2952,100,4,3,7,57.1%,46m
4871,1,Nobel,2952,0,0,1,1,0.0%,45m
4876,1,[OGSMG]제민이마법의왼손,2951,716,28,16,44,63.6%,44m
4876,3,BoHater,2951,397,18,14,32,56.2%,6m
4876,3,Lufs,2951,462,17,22,39,43.6%,12m
4876,1,[KKKKKK]숙주갓글링,2951,0,4,1,5,80.0%,44m
4880,3,akjk,2950,1473,271,269,540,50.2%,2m
4880,1,Xiaozhe,2950,376,22,11,33,66.7%,45m
4880,1,[블랙핑크리사]리조랄,2950,0,1,1,2,50.0%,44m
4880,1,Koala,2950,0,0,1,1,0.0%,44m
4884,1,[2494]ace,2949,1251,194,174,368,52.7%,45m
4884,3,choil,2949,786,28,27,55,50.9%,2m
4884,3,fitzhugh,2949,504,19,20,39,48.7%,1m
4884,1,김꽃두레,2949,556,16,18,34,47.1%,43m
4884,1,[아이유야]하늘씨앗,2949,48,2,1,3,66.7%,14m
4884,1,DUTY,2949,0,1,1,2,50.0%,44m
4884,1,ksb,2949,0,0,1,1,0.0%,43m
4891,2,BoutTo,2948,1334,62,56,118,52.5%,4m
4891,3,필쏘굿,2948,711,39,40,79,49.4%,3m
4891,1,keretapir,2948,529,21,19,40,52.5%,46m
4891,1,꽐라독,2948,432,17,13,30,56.7%,43m
4891,3,이어폰브레이커,2948,300,10,17,27,37.0%,3m
4891,3,치승아,2948,245,8,8,16,50.0%,4m
4891,1,HulkOrz,2948,30,2,2,4,50.0%,45m
4898,3,하류야,2947,171,13,15,28,46.4%,3m
4898,3,Noram,2947,123,7,9,16,43.8%,4m
4898,1,우리겜방알바예쁨,2947,167,5,5,10,50.0%,45m
4898,1,RottenZerg,2947,0,1,1,2,50.0%,46m
4898,1,찬혁대장,2947,0,0,1,1,0.0%,45m
4903,1,나는,2946,164,4,5,9,44.4%,45m
4903,1,[ctrs]Naki,2946,34,1,1,2,50.0%,44m
4903,2,Havox,2946,0,0,2,2,0.0%,22m
4903,1,저징징,2946,0,0,4,4,0.0%,45m
4907,1,smalllake,2945,1545,103,82,185,55.7%,44m
4907,2,Aqua,2945,122,7,7,14,50.0%,21m
4907,1,MJH,2945,137,4,0,4,100.0%,45m
4907,1,[생존자]왕자,2945,147,4,2,6,66.7%,44m
4907,2,lovepp,2945,46,2,8,10,20.0%,21m
4907,1,[어케했노]독도는한국땅,2945,0,1,0,1,100.0%,45m
4907,2,Disk,2945,46,1,4,5,20.0%,22m
4907,3,[호랑이기운]얌마최완득,2945,30,1,7,8,12.5%,3m
4907,1,[DagmBa]CrowN,2945,0,0,1,1,0.0%,45m
4916,3,먼솔이,2944,706,28,26,54,51.9%,13m
4916,2,한창호,2944,398,18,17,35,51.4%,2m
4916,3,호잇,2944,546,18,25,43,41.9%,12m
4916,1,baabaa,2944,355,16,13,29,55.2%,43m
4916,1,[彩虹]WelshCorgi,2944,0,1,0,1,100.0%,46m
4916,1,[허대영섹시남]박도진,2944,0,0,2,2,0.0%,45m
4922,1,zerg,2943,212,8,6,14,57.1%,15m
4922,1,sybsybsyb,2943,146,7,3,10,70.0%,44m
4922,1,커플부대,2943,0,0,1,1,0.0%,43m
4922,1,Nia,2943,0,0,1,1,0.0%,44m
4926,2,台灣留岛不留人,2942,1549,193,189,382,50.5%,12m
4926,1,humbug,2942,366,11,12,23,47.8%,43m
4926,3,데드크로스,2942,112,7,11,18,38.9%,12m
4926,1,무심한듯시크하게,2942,34,1,1,2,50.0%,45m
4926,2,Tingjie,2942,96,1,2,3,33.3%,22m
4931,1,노베이스따뚜땡,2941,496,26,27,53,49.1%,45m
4931,3,leehu,2941,90,4,8,12,33.3%,12m
4931,1,대성,2941,0,3,2,5,60.0%,45m
4931,1,Zerg,2941,93,2,0,2,100.0%,45m
4931,1,[ash]왕버섯한민성,2941,0,0,2,2,0.0%,45m
4936,3,나닉변했음,2940,1275,76,78,154,49.4%,3m
4936,1,Murderinc,2940,121,3,1,4,75.0%,44m
4936,3,곤즈,2940,96,3,11,14,21.4%,4m
4936,1,critic,2940,0,1,1,2,50.0%,45m
4936,1,RUIN,2940,0,0,1,1,0.0%,45m
4936,1,RedSwaRM,2940,0,0,2,2,0.0%,45m
4942,1,Alien,2939,1570,75,63,138,54.3%,45m
4942,3,아이유,2939,223,10,11,21,47.6%,1m
4942,1,논공저그,2939,286,9,6,15,60.0%,44m
4942,2,[테테안함]와사비맛사탕,2939,232,6,2,8,75.0%,21m
4942,1,찾았다휴,2939,122,3,4,7,42.9%,15m
4942,1,카무이칸나,2939,30,2,0,2,100.0%,45m
4942,1,soskoksos,2939,74,2,4,6,33.3%,46m
4942,1,With,2939,0,1,1,2,50.0%,45m
4942,1,dehet,2939,88,1,4,5,20.0%,43m
4942,1,냐음,2939,0,0,1,1,0.0%,44m
4942,1,메라아,2939,0,0,2,2,0.0%,43m
4953,3,jagcace,2938,1517,516,493,1009,51.1%,3m
4953,2,[DagmBa]StarTale,2938,1320,148,153,301,49.2%,12m
4953,3,lllllllll,2938,272,10,11,21,47.6%,3m
4953,3,Find,2938,0,4,2,6,66.7%,20m
4953,1,연습생,2938,106,4,3,7,57.1%,46m
4953,1,龍崎十郎,2938,0,3,2,5,60.0%,43m
4959,1,록타르오가르,2937,732,31,24,55,56.4%,45m
4959,3,Smilyman,2937,341,14,18,32,43.8%,2m
4959,3,프라이밋,2937,211,6,8,14,42.9%,7m
4959,1,mjii,2937,0,0,1,1,0.0%,46m
4963,3,응기잇얍얍찍,2936,1471,81,86,167,48.5%,3m
4963,3,손정창,2936,539,21,20,41,51.2%,3m
4965,2,이꽃비,2935,1352,141,135,276,51.1%,6m
4965,3,MasterChief,2935,916,109,102,211,51.7%,3m
4965,3,Dlle,2935,1384,49,55,104,47.1%,3m
4965,3,IlIIIllIIIll,2935,324,11,20,31,35.5%,5m
4965,1,MEFQSQ,2935,282,9,9,18,50.0%,14m
4965,3,크로덴,2935,135,4,6,10,40.0%,13m
4965,1,[유토피아]llllllllllll,2935,0,3,3,6,50.0%,45m
4965,1,[승풍파랑]엄마나똥싸,2935,118,3,3,6,50.0%,15m
4965,3,Gladiolus,2935,135,3,5,8,37.5%,20m
4974,3,Jin,2934,544,71,63,134,53.0%,6m
4974,1,Bee,2934,863,30,25,55,54.5%,45m
4974,1,뽀지엔맹독충,2934,690,23,21,44,52.3%,46m
4974,1,[CupCup]Quintero,2934,0,3,2,5,60.0%,46m
4974,1,브론즈가자,2934,0,0,1,1,0.0%,15m
4979,2,rlawncks,2933,163,6,4,10,60.0%,22m
4979,1,kddjj,2933,40,1,2,3,33.3%,45m
4979,3,MyLongBow,2933,0,1,6,7,14.3%,6m
4982,3,subal,2932,1421,174,158,332,52.4%,3m
4982,3,INsectWORM,2932,950,157,148,305,51.5%,13m
4982,3,Rampage,2932,940,37,39,76,48.7%,3m
4982,2,Taco,2932,253,8,7,15,53.3%,21m
4982,1,광안리스타일,2932,142,3,1,4,75.0%,14m
4982,1,SCA,2932,82,3,3,6,50.0%,45m
4982,1,[SS친위대]독일,2932,74,3,3,6,50.0%,45m
4982,1,[TpW]克特,2932,46,1,2,3,33.3%,15m
4982,1,[5E对战平台]luna,2932,0,1,4,5,20.0%,43m
4982,3,일요일,2932,0,0,1,1,0.0%,47m
4992,1,춤추는악어,2931,1125,54,46,100,54.0%,44m
4992,1,[CSO]Krytos,2931,122,3,1,4,75.0%,45m
4992,1,onionkinght,2931,30,1,2,3,33.3%,45m
4992,1,ggppabc,2931,30,1,2,3,33.3%,45m
4992,1,[보금자리]미르,2931,38,1,4,5,20.0%,44m
4997,3,upanddown,2930,1437,403,373,776,51.9%,6m
4997,1,[어윤수님개쩜]휄뤄우,2930,542,20,19,39,51.3%,44m
4997,1,모델,2930,149,8,3,11,72.7%,45m
4997,2,흑풍,2930,158,6,5,11,54.5%,22m
4997,3,Solindar,2930,95,2,3,5,40.0%,3m
4997,1,공복,2930,68,2,4,6,33.3%,46m
4997,1,ByTheWay,2930,0,1,0,1,100.0%,44m
4997,3,필사즉생,2930,0,0,4,4,0.0%,48m
5005,1,RavenADW,2929,1252,52,53,105,49.5%,45m
5005,1,약한저그,2929,104,3,8,11,27.3%,45m
5005,3,스타,2929,0,1,0,1,100.0%,21m
5005,1,만년골드,2929,0,0,1,1,0.0%,45m
5009,3,ROI,2928,1525,304,287,591,51.4%,3m
5009,1,도라이몽키,2928,687,28,21,49,57.1%,44m
5009,3,Junviga,2928,97,4,2,6,66.7%,21m
5009,1,PSY,2928,0,0,2,2,0.0%,46m
5013,1,nada,2927,1331,213,199,412,51.7%,45m
5013,1,孤影獨舞,2927,576,23,15,38,60.5%,43m
5013,1,Dynamic,2927,100,5,2,7,71.4%,43m
5013,3,Murano,2927,0,3,2,5,60.0%,20m
5013,1,[콩나물]꼬미,2927,125,2,2,4,50.0%,44m
5013,3,[CHZ]재성합니다,2927,0,0,2,2,0.0%,20m
5019,3,인희혜지,2926,1423,250,231,481,52.0%,12m
5019,1,[小妖怪]含羞草,2926,424,15,9,24,62.5%,44m
5019,1,andy,2926,426,14,14,28,50.0%,44m
5019,1,오버워치,2926,279,10,5,15,66.7%,45m
5019,2,斬業,2926,92,8,4,12,66.7%,22m
5019,1,TheOssified,2926,209,6,6,12,50.0%,44m
5019,3,스투망겜,2926,0,3,2,5,60.0%,21m
5019,1,WhiteCollar,2926,0,1,1,2,50.0%,45m
5019,1,멋쟁이섭,2926,30,1,3,4,25.0%,44m
5019,1,llllllllllll,2926,130,1,10,11,9.1%,46m
5029,3,[DPW]Eathen,2925,468,16,22,38,42.1%,12m
5029,1,붉은용가리,2925,192,10,10,20,50.0%,14m
5029,1,Something,2925,114,3,6,9,33.3%,43m
5032,3,iiiiiiiiiiii,2924,637,23,25,48,47.9%,7m
5032,1,[패자는피를]미르존,2924,500,22,11,33,66.7%,44m
5032,1,Piggy,2924,129,5,4,9,55.6%,44m
5032,1,Boom,2924,0,0,1,1,0.0%,44m
5036,3,이름변경,2923,1492,149,133,282,52.8%,7m
5036,1,baabaa,2923,1086,39,37,76,51.3%,44m
5036,1,Computer,2923,879,31,31,62,50.0%,45m
5036,3,[Ex]JusticeEx,2923,314,20,16,36,55.6%,6m
5036,1,승우아범,2923,230,7,5,12,58.3%,46m
5036,3,그문룡,2923,92,7,6,13,53.8%,2m
5036,1,Lofan,2923,0,3,2,5,60.0%,44m
5036,1,OldGreyFace,2923,0,0,3,3,0.0%,45m
5044,1,jin,2922,233,9,3,12,75.0%,44m
5044,1,YUYUYU,2922,187,7,7,14,50.0%,14m
5044,2,DivineDust,2922,95,4,4,8,50.0%,22m
5047,3,Stolt,2921,1485,70,78,148,47.3%,12m
5047,3,kladdkaka,2921,1056,40,41,81,49.4%,6m
5047,1,[홍련꽃12]아기곤듀,2921,208,6,8,14,42.9%,45m
5047,1,프로트,2921,0,0,1,1,0.0%,45m
5051,3,AvariCE,2920,1236,102,99,201,50.7%,13m
5051,1,哪裡預見,2920,513,19,15,34,55.9%,45m
5051,1,eldottore,2920,328,14,13,27,51.9%,46m
5051,2,DeadZone,2920,131,7,6,13,53.8%,4m
5051,2,YoonWoo,2920,0,1,1,2,50.0%,21m
5051,1,bdot,2920,0,0,1,1,0.0%,45m
5057,2,월탄,2919,1499,580,549,1129,51.4%,5m
5057,2,테테전사절,2919,1587,160,144,304,52.6%,47m
5057,3,Collen,2919,156,7,6,13,53.8%,6m
5057,1,JUNLEE,2919,133,3,2,5,60.0%,44m
5057,2,네오,2919,30,2,0,2,100.0%,42m
5062,1,손민기,2918,774,28,22,50,56.0%,45m
5062,2,사람이면사람,2918,0,4,3,7,57.1%,22m
5062,2,IIIIIIIIIII,2918,136,2,3,5,40.0%,22m
5062,2,哈嚕你好嗎,2918,0,1,4,5,20.0%,43m
5062,3,니친구,2918,0,0,1,1,0.0%,20m
5067,1,JAJI,2917,1343,57,50,107,53.3%,45m
5067,2,不會玩喔,2917,621,28,14,42,66.7%,47m
5067,2,해병여친,2917,0,1,0,1,100.0%,47m
5067,2,[최고다사기리]mnch,2917,0,1,0,1,100.0%,47m
5071,2,IIIIIIIIIIII,2916,1007,42,27,69,60.9%,42m
5072,1,lllIIlllIlll,2915,1327,57,59,116,49.1%,45m
5072,1,[WTSC]프롤레타리아,2915,325,12,7,19,63.2%,45m
5072,3,yukico,2915,0,0,1,1,0.0%,36m
5075,2,astro,2914,159,5,5,10,50.0%,22m
5075,1,Smmm,2914,34,2,2,4,50.0%,45m
5077,1,Demon,2913,653,28,21,49,57.1%,45m
5077,2,HomeDogG,2913,90,5,6,11,45.5%,23m
5077,1,포도주스즙,2913,63,3,3,6,50.0%,45m
5077,2,[머구폐렴]설원기설,2913,0,1,2,3,33.3%,21m
5077,3,Lucas,2913,0,0,1,1,0.0%,20m
5082,1,coolroom,2912,1509,96,65,161,59.6%,44m
5082,2,대물러버,2912,440,15,8,23,65.2%,43m
5082,1,[M4]IIIIIIIIIIII,2912,138,6,5,11,54.5%,45m
5082,1,강땅크,2912,0,3,3,6,50.0%,45m
5082,1,양금모변호인,2912,0,1,1,2,50.0%,45m
5082,1,세도우드레곤,2912,0,1,2,3,33.3%,44m
5082,2,아톰,2912,0,0,1,1,0.0%,13m
5082,1,[정말데단해]너검마밀키스,2912,0,0,2,2,0.0%,43m
5082,1,[FlowAr]MarciaFlowAr,2912,0,0,4,4,0.0%,45m
5091,3,Blake,2911,1057,65,60,125,52.0%,6m
5091,2,llllllllllll,2911,141,15,28,43,34.9%,5m
5091,3,[LODs]darknessle,2911,124,3,7,10,30.0%,16m
5091,1,Rafiki,2911,0,1,1,2,50.0%,43m
5095,1,ATJATJ,2910,1582,96,83,179,53.6%,43m
5095,2,[트롤처리반장]중재중재,2910,282,9,4,13,69.2%,43m
5095,2,RealPark,2910,60,3,0,3,100.0%,42m
5095,1,Koziivka,2910,104,3,8,11,27.3%,45m
5095,1,안산천재,2910,68,2,6,8,25.0%,45m
5095,2,마티,2910,0,1,0,1,100.0%,22m
5095,2,fsdfdsdf,2910,0,0,1,1,0.0%,46m
5102,3,Naviester,2909,1462,68,50,118,57.6%,5m
5102,3,켉캭퉥,2909,386,21,25,46,45.7%,7m
5102,3,[13분]Metamorph,2909,273,9,13,22,40.9%,5m
5102,3,맥선장,2909,172,8,7,15,53.3%,3m
5102,1,XPSam,2909,154,7,9,16,43.8%,44m
5102,2,헬로빵셔틀,2909,0,1,2,3,33.3%,21m
5102,1,[내마음을받아]데몬,2909,0,1,2,3,33.3%,45m
5102,2,llIIIllIIIl,2909,38,1,2,3,33.3%,47m
5110,1,[快樂玩家]童汁戀精豎濕,2908,300,10,5,15,66.7%,45m
5111,3,Applejack,2907,1528,631,631,1262,50.0%,5m
5111,3,CromerBB,2907,234,11,9,20,55.0%,12m
5111,3,우비,2907,227,10,10,20,50.0%,6m
5111,1,[겨울방어]eoflrmao,2907,224,6,10,16,37.5%,44m
5111,2,[진격의에렌]allMiyeon,2907,130,4,2,6,66.7%,46m
5111,2,[얼굴]스투개판이네,2907,0,3,2,5,60.0%,43m
5111,2,Gcrown,2907,0,0,1,1,0.0%,43m
5118,3,정영훈,2906,1554,159,152,311,51.1%,13m
5118,3,Panglois,2906,1211,71,73,144,49.3%,2m
5118,3,우주방랑자,2906,294,14,11,25,56.0%,7m
5118,2,Caesium,2906,58,2,1,3,66.7%,47m
5118,1,체코인,2906,0,0,2,2,0.0%,44m
5123,2,[GITS]timba,2905,656,43,15,58,74.1%,47m
5123,1,[貓咪大公國]Rain,2905,538,28,20,48,58.3%,44m
5123,1,참치,2905,722,28,25,53,52.8%,45m
5123,1,젤나가맙소사,2905,415,16,12,28,57.1%,45m
5123,1,Levi,2905,32,5,2,7,71.4%,44m
5123,2,맛트리리,2905,0,0,1,1,0.0%,47m
5129,1,[어둠의사신단]chldnlska,2904,1660,195,172,367,53.1%,46m
5129,1,라디드,2904,737,31,28,59,52.5%,44m
5129,2,히히히,2904,470,17,14,31,54.8%,47m
5129,1,WhiteSeed,2904,406,13,17,30,43.3%,45m
5129,1,예인느님,2904,132,7,6,13,53.8%,45m
5129,2,미로속환상,2904,0,0,1,1,0.0%,42m
5135,2,Piney,2903,30,2,0,2,100.0%,47m
5135,2,[林以楨超胖]panvincent,2903,0,0,1,1,0.0%,21m
5137,2,過來韓老師這,2902,588,26,11,37,70.3%,46m
5137,1,[NLTN]유니크,2902,616,21,22,43,48.8%,46m
5137,3,Light,2902,574,20,24,44,45.5%,12m
5137,1,시혀니,2902,68,2,6,8,25.0%,45m
5137,1,shaVo,2902,0,1,1,2,50.0%,45m
5142,3,noobmaster,2901,1290,225,224,449,50.1%,2m
5142,2,WhixeBear,2901,267,7,5,12,58.3%,22m
5142,2,jaydik,2901,165,6,5,11,54.5%,13m
5142,3,착해순진해,2901,0,3,3,6,50.0%,20m
5142,2,[Divo]로리,2901,0,1,0,1,100.0%,47m
5147,1,함무봐야알지,2900,639,39,27,66,59.1%,45m
5147,1,파파무,2900,276,7,8,15,46.7%,14m
5147,3,저녁코끼리,2900,167,7,10,17,41.2%,3m
5147,1,[팀의체력을]인간성기사뿌뿌뿡,2900,66,2,6,8,25.0%,44m
5147,1,escape,2900,72,2,8,10,20.0%,45m
5147,2,[프리마슬로]노인성기,2900,40,1,1,2,50.0%,46m
5147,2,Izsha,2900,0,0,4,4,0.0%,42m
5154,1,星海战神,2899,0,3,3,6,50.0%,44m
5154,2,낑깡,2899,0,3,4,7,42.9%,13m
5156,1,그래봤자제이녹스,2898,1646,78,73,151,51.7%,45m
5156,3,[SSHAHA]ShameOnYou,2898,1262,70,64,134,52.2%,2m
5156,2,只會農的臭蟲,2898,437,19,20,39,48.7%,7m
5156,3,실험체,2898,0,3,3,6,50.0%,36m
5156,2,빌라스틱저그유저,2898,0,2,0,2,100.0%,42m
5156,2,[AR소대]엠포,2898,0,1,0,1,100.0%,43m
5156,2,SKT,2898,30,1,2,3,33.3%,47m
5156,3,Halcyon,2898,0,0,1,1,0.0%,20m
5164,2,lorth,2897,1599,147,129,276,53.3%,42m
5164,3,바보군대,2897,717,31,28,59,52.5%,6m
5164,1,[하수처리장]조홀스,2897,596,19,22,41,46.3%,45m
5164,3,[마리사]키리사메마리사,2897,0,3,1,4,75.0%,20m
5164,3,그대와의첫날밤,2897,97,2,0,2,100.0%,21m
5164,2,Antonf,2897,36,2,2,4,50.0%,42m
5164,1,NISS,2897,30,2,4,6,33.3%,46m
5164,2,[TMR]neroBBQ,2897,40,1,2,3,33.3%,46m
5164,1,[다대져]gsl,2897,0,0,4,4,0.0%,45m
5173,1,초씨,2896,484,16,16,32,50.0%,44m
5173,1,MKLblactea,2896,177,9,7,16,56.2%,45m
5173,1,SNSD,2896,189,8,5,13,61.5%,45m
5173,1,[SuP]onesuna,2896,283,7,8,15,46.7%,43m
5173,1,랍스타,2896,93,4,3,7,57.1%,46m
5173,3,겜창인생,2896,0,1,2,3,33.3%,20m
5173,2,[NsP]KELLAN,2896,34,1,2,3,33.3%,47m
5173,1,[YTC]임금돼지,2896,97,1,3,4,25.0%,43m
5181,1,ManChoi,2895,966,37,35,72,51.4%,45m
5181,1,의사양반,2895,92,2,2,4,50.0%,45m
5181,3,썩은개념,2895,0,0,1,1,0.0%,19m
5181,3,[나치정권]광전사,2895,0,0,1,1,0.0%,19m
5181,2,키보드로맞기,2895,0,0,2,2,0.0%,47m
5186,1,[CStorM]전지전능,2894,221,7,5,12,58.3%,45m
5186,2,tveiv,2894,0,4,1,5,80.0%,43m
5186,1,[SGlory]catcans,2894,112,4,4,8,50.0%,45m
5186,1,tlqkf,2894,98,4,6,10,40.0%,45m
5190,3,Ronda,2893,1474,57,61,118,48.3%,7m
5190,2,playerchoi,2893,270,9,8,17,52.9%,46m
5190,2,적당히멋쟁이,2893,200,6,7,13,46.2%,46m
5190,3,loliscythe,2893,80,4,5,9,44.4%,21m
5190,3,小主宰,2893,0,3,2,5,60.0%,20m
5190,2,승천하라집값이여,2893,34,2,4,6,33.3%,43m
5190,2,[04s]END,2893,0,1,4,5,20.0%,13m
5190,3,IIIIIIIIIIII,2893,0,0,8,8,0.0%,7m
5198,1,NCNalRa,2892,1482,63,63,126,50.0%,45m
5198,1,[HANCIv]SkFantasty,2892,1011,38,42,80,47.5%,45m
5198,1,나와라데이지,2892,914,31,35,66,47.0%,46m
5198,1,牛皮,2892,618,25,19,44,56.8%,45m
5198,3,dentistar,2892,444,18,17,35,51.4%,12m
5198,1,우유천사,2892,300,11,6,17,64.7%,44m
5198,1,[래더납치범]스타는너무어려워,2892,352,11,9,20,55.0%,46m
5198,2,DonQQ,2892,243,10,8,18,55.6%,46m
5198,1,sumtingwong,2892,197,9,8,17,52.9%,15m
5198,2,도토리,2892,191,8,5,13,61.5%,46m
5198,2,nighter,2892,0,3,2,5,60.0%,43m
5198,1,Vanishment,2892,0,1,2,3,33.3%,46m
5198,1,OwNaGe,2892,91,1,6,7,14.3%,44m
5211,1,도날드,2891,778,43,30,73,58.9%,45m
5211,2,아이유뚝배기,2891,681,36,5,41,87.8%,47m
5211,1,kwon,2891,226,14,11,25,56.0%,46m
5211,1,gcap,2891,68,4,4,8,50.0%,45m
5215,2,혼란하다혼란해,2890,1592,131,113,244,53.7%,48m
5215,1,영각,2890,756,58,59,117,49.6%,45m
5215,2,[中國病毒]一哭二鬧三上悠亞,2890,477,20,18,38,52.6%,47m
5215,2,잠이온다아아아,2890,245,11,10,21,52.4%,43m
5215,1,스타계의염경환씨,2890,243,9,8,17,52.9%,45m
5215,2,小心,2890,112,3,1,4,75.0%,21m
5215,2,녕오,2890,60,2,3,5,40.0%,42m
5215,1,akikiki,2890,30,1,4,5,20.0%,45m
5223,3,[Der]湯馬士,2889,1490,225,227,452,49.8%,12m
5223,1,Heavyarms,2889,882,34,31,65,52.3%,46m
5223,2,명백한스린이,2889,410,16,8,24,66.7%,47m
5223,3,Eintrag,2889,145,5,4,9,55.6%,21m
5223,1,[돌과바닷물]다운,2889,0,3,3,6,50.0%,44m
5223,2,[7511]스타크인더스트리,2889,0,0,1,1,0.0%,47m
5229,3,CreepyCrawly,2888,1245,72,71,143,50.3%,13m
5229,2,lain,2888,248,8,10,18,44.4%,48m
5229,2,JOON,2888,234,7,3,10,70.0%,47m
5232,1,루에볼,2887,1001,44,43,87,50.6%,44m
5232,3,[바코드군단]llllll,2887,1004,36,43,79,45.6%,6m
5232,2,IllusiveMan,2887,175,9,12,21,42.9%,47m
5232,3,[에이스만들어]NumberOneAce,2887,0,3,2,5,60.0%,21m
5232,1,Hoarito,2887,110,3,6,9,33.3%,43m
5232,2,[새하얀]토끼,2887,0,1,0,1,100.0%,48m
5238,2,오성똥광이,2886,0,2,3,5,40.0%,47m
5238,3,수호랑,2886,30,1,3,4,25.0%,20m
5238,1,[레스토랑]PanTzRun,2886,0,1,4,5,20.0%,45m
5238,2,[단무지다]paldo,2886,0,0,1,1,0.0%,47m
5242,3,ImTheSwarm,2885,426,18,17,35,51.4%,3m
5242,1,Xeon,2885,91,2,2,4,50.0%,45m
5242,2,rara,2885,30,1,1,2,50.0%,47m
5242,2,레스토랑스,2885,0,0,1,1,0.0%,43m
5246,2,야야야야,2884,1470,212,221,433,49.0%,5m
5246,2,짐레이너,2884,698,28,20,48,58.3%,43m
5246,2,RedScorch,2884,545,21,15,36,58.3%,47m
5246,2,BlackStar,2884,235,20,18,38,52.6%,47m
5246,2,jjanggu,2884,314,11,9,20,55.0%,47m
5246,1,Viga,2884,286,9,3,12,75.0%,15m
5246,2,szcz,2884,132,3,1,4,75.0%,22m
5246,2,매너,2884,0,1,0,1,100.0%,46m
5246,3,UrielKoneho,2884,0,0,3,3,0.0%,20m
5255,2,먹는코뿔소,2883,652,50,36,86,58.1%,46m
5255,2,starwoldpro,2883,593,22,20,42,52.4%,48m
5257,1,evildrone,2882,1350,52,48,100,52.0%,45m
5257,3,喬巴超人,2882,940,40,38,78,51.3%,13m
5257,1,닭꼬치,2882,723,25,24,49,51.0%,45m
5257,2,Scorpius,2882,464,20,26,46,43.5%,6m
5257,3,[감염]뭘날려버릴까요,2882,148,5,17,22,22.7%,13m
5257,2,boubou,2882,34,2,1,3,66.7%,42m
5257,1,[ClSt]belloline,2882,0,0,8,8,0.0%,45m
5264,1,[노잼]아바노바준,2881,1558,72,60,132,54.5%,44m
5264,1,Bulauk,2881,361,18,15,33,54.5%,44m
5264,1,[Audi]iseeyou,2881,86,6,8,14,42.9%,14m
5264,1,Paul,2881,102,4,5,9,44.4%,46m
5264,2,一條真白,2881,30,1,1,2,50.0%,47m
5264,1,SuperMarine,2881,0,1,3,4,25.0%,45m
5270,2,시나브로,2880,922,63,47,110,57.3%,47m
5270,1,싸곰,2880,207,14,15,29,48.3%,45m
5270,2,llllllllllll,2880,215,12,9,21,57.1%,47m
5270,2,whitebelt,2880,222,9,5,14,64.3%,43m
5270,2,蘇欸,2880,114,5,5,10,50.0%,21m
5270,3,[ELS]llllllllllll,2880,166,4,7,11,36.4%,5m
5270,3,[IXL]lllllllll,2880,145,3,4,7,42.9%,21m
5270,1,SURPRISER,2880,147,3,8,11,27.3%,43m
5278,1,phoenix,2879,390,12,13,25,48.0%,45m
5278,2,dktam,2879,100,3,5,8,37.5%,47m
5278,1,lllllllllll,2879,0,1,2,3,33.3%,45m
5281,1,감사합니다람쥐,2878,176,6,9,15,40.0%,45m
5281,3,SOLDIER,2878,0,3,3,6,50.0%,21m
5281,1,purpleclouds,2878,0,2,1,3,66.7%,44m
5284,1,[ACGN]sizemorDreaM,2877,664,29,21,50,58.0%,43m
5284,1,Unicode,2877,0,3,2,5,60.0%,19m
5284,2,Kilo,2877,0,3,2,5,60.0%,43m
5284,2,www,2877,34,2,0,2,100.0%,47m
5284,1,bucketzxm,2877,0,1,2,3,33.3%,44m
5289,2,亮用兵以奇著稱,2876,0,3,1,4,75.0%,42m
5289,1,페이커팬티도둑,2876,120,3,7,10,30.0%,45m
5289,2,[GITS]Wei,2876,0,0,1,1,0.0%,42m
5289,2,Aqua,2876,0,0,1,1,0.0%,47m
5293,3,베스트제로,2875,1407,450,435,885,50.8%,3m
5293,1,loser,2875,1663,167,149,316,52.8%,46m
5293,1,하정우,2875,1500,80,69,149,53.7%,45m
5293,1,muyayo,2875,502,18,17,35,51.4%,44m
5293,2,MadeOn,2875,320,11,9,20,55.0%,42m
5293,3,Pim,2875,179,7,7,14,50.0%,13m
5293,2,onlyonekill,2875,102,3,4,7,42.9%,47m
5300,1,OptimusPrime,2874,1250,49,41,90,54.4%,43m
5300,1,兔仔耳朵蒙面俠,2874,735,28,25,53,52.8%,45m
5300,3,소울오브프레임,2874,484,18,29,47,38.3%,6m
5300,2,현이,2874,402,16,17,33,48.5%,47m
5300,3,invisiblesim,2874,222,9,13,22,40.9%,2m
5300,3,泰瑞爾,2874,168,6,8,14,42.9%,7m
5300,2,Wheein,2874,152,5,3,8,62.5%,43m
5300,2,[저징징]Irist,2874,0,0,3,3,0.0%,47m
5308,2,빌리브,2873,1480,681,682,1363,50.0%,2m
5309,1,[짱이다]stormzerg,2872,1474,53,54,107,49.5%,45m
5309,1,구봉고,2872,1001,42,38,80,52.5%,44m
5309,3,至死不渝的愛,2872,862,31,37,68,45.6%,2m
5309,1,GagamelsRage,2872,214,10,8,18,55.6%,44m
5309,3,Stacy,2872,133,7,1,8,87.5%,21m
5309,1,뽀삼가이드,2872,218,7,11,18,38.9%,46m
5309,1,뿌링클,2872,36,5,3,8,62.5%,44m
5309,1,MorinoSeika,2872,163,5,5,10,50.0%,45m
5309,2,Trainee,2872,0,1,1,2,50.0%,46m
5309,2,craig,2872,0,0,1,1,0.0%,46m
5309,2,badonkadonk,2872,0,0,1,1,0.0%,47m
5320,1,TnT,2871,405,22,26,48,45.8%,45m
5320,1,中玩的悲哀,2871,90,4,3,7,57.1%,44m
5320,1,달용,2871,106,3,9,12,25.0%,46m
5320,1,물똥,2871,113,2,2,4,50.0%,14m
5320,1,RIGHT,2871,0,2,3,5,40.0%,19m
5320,2,반필터,2871,0,1,1,2,50.0%,47m
5326,2,박밝음,2870,202,7,8,15,46.7%,42m
5326,2,Pandafetus,2870,108,4,3,7,57.1%,43m
5326,2,이노베이터,2870,58,3,2,5,60.0%,47m
5326,2,Chuill,2870,30,1,2,3,33.3%,46m
5330,3,[萬花筒寫輪眼]CURRY,2869,598,63,60,123,51.2%,3m
5330,1,gkstjsgh,2869,793,43,33,76,56.6%,44m
5330,1,rotate,2869,901,39,40,79,49.4%,44m
5330,2,PlayerName,2869,490,32,27,59,54.2%,46m
5330,1,COVID,2869,294,10,13,23,43.5%,45m
5330,2,[공허거주]대박이야,2869,240,9,3,12,75.0%,47m
5330,1,BLEss,2869,308,9,20,29,31.0%,43m
5330,2,[광전사하키]벽짓살장인,2869,58,2,2,4,50.0%,48m
5330,2,IllIIIIllll,2869,0,0,1,1,0.0%,46m
5339,1,IIIIIIIIIIII,2868,1643,156,157,313,49.8%,45m
5339,2,plaguedog,2868,468,17,13,30,56.7%,42m
5339,2,IIIIIIIIIIII,2868,86,3,3,6,50.0%,43m
5339,1,mozzaaaa,2868,0,3,3,6,50.0%,45m
5339,2,[자치령특전단]llllllllllll,2868,64,2,2,4,50.0%,47m
5339,2,[엔타로연합]ASDFG,2868,0,1,0,1,100.0%,42m
5339,2,hgh,2868,30,1,2,3,33.3%,47m
5346,2,JohnnyGroove,2867,497,23,18,41,56.1%,47m
5346,3,PUODE,2867,122,5,3,8,62.5%,19m
5346,2,버물리,2867,58,2,1,3,66.7%,46m
5349,3,tlszla,2866,1465,198,204,402,49.3%,2m
5349,2,巴斯克維爾,2866,1306,49,48,97,50.5%,48m
5349,2,ANS,2866,266,9,8,17,52.9%,48m
5349,1,BabyShark,2866,122,5,4,9,55.6%,44m
5349,2,Bulba,2866,122,5,5,10,50.0%,22m
5349,3,우리가족,2866,0,1,0,1,100.0%,48m
5349,2,말년만빵,2866,30,1,1,2,50.0%,46m
5349,2,[유즈맵아이들]티피전사,2866,30,1,1,2,50.0%,47m
5357,1,CToh,2865,1535,68,70,138,49.3%,45m
5357,1,ZTARCRAFT,2865,656,29,24,53,54.7%,44m
5357,1,타리우니,2865,373,13,12,25,52.0%,45m
5357,1,묭군,2865,296,9,10,19,47.4%,44m
5357,2,전쟁사나이,2865,34,1,3,4,25.0%,47m
5357,2,IIIIIIIIIIII,2865,30,1,5,6,16.7%,43m
5363,2,차차차모터스,2864,1423,166,159,325,51.1%,12m
5363,1,소심한마술사,2864,611,153,142,295,51.9%,45m
5363,2,silent,2864,1177,90,64,154,58.4%,48m
5363,2,[PP1]柯文哲總統,2864,466,17,15,32,53.1%,46m
5363,1,BUGGANG,2864,222,10,9,19,52.6%,44m
5363,1,LeeJY,2864,0,0,1,1,0.0%,14m
5369,1,我首洺碩比,2863,582,18,23,41,43.9%,46m
5369,2,빵상,2863,231,7,4,11,63.6%,43m
5371,2,Xeonixe,2862,311,22,19,41,53.7%,47m
5371,1,잉여는잉여다,2862,644,22,23,45,48.9%,45m
5371,2,Tsunami,2862,210,9,9,18,50.0%,43m
5371,3,llllIlllIl,2862,0,0,1,1,0.0%,20m
5375,2,깐지남,2861,780,33,27,60,55.0%,47m
5375,1,김쫄보,2861,230,9,9,18,50.0%,44m
5375,2,bee,2861,204,7,5,12,58.3%,48m
5375,2,못된원숭이,2861,142,6,5,11,54.5%,48m
5375,3,Popeye,2861,143,5,9,14,35.7%,3m
5375,3,KIMSEO,2861,60,2,7,9,22.2%,3m
5375,2,테사기,2861,0,0,1,1,0.0%,43m
5382,1,Fischi,2860,473,18,16,34,52.9%,44m
5382,1,rAyWinDz,2860,284,10,9,19,52.6%,14m
5382,2,HardCore,2860,88,6,4,10,60.0%,43m
5382,1,[DRMS]우주자연인,2860,188,4,6,10,40.0%,46m
5382,2,JeonMinChan,2860,0,1,0,1,100.0%,47m
5382,2,COVIDforever,2860,0,1,0,1,100.0%,47m
5382,2,Pornotraktar,2860,0,1,1,2,50.0%,46m
5382,2,김첨지의럭키데이,2860,0,0,1,1,0.0%,47m
5382,2,초보라고놀리지말,2860,0,0,1,1,0.0%,46m
5391,2,Mrcord,2859,511,20,17,37,54.1%,43m
5391,2,지금이니,2859,348,13,10,23,56.5%,43m
5391,2,jimmy,2859,161,12,4,16,75.0%,48m
5391,2,tabiseal,2859,224,7,4,11,63.6%,47m
5391,1,DougSluggins,2859,0,4,2,6,66.7%,44m
5391,1,choboda,2859,110,4,8,12,33.3%,44m
5391,2,[NLTN]AtlaS,2859,82,2,2,4,50.0%,47m
5398,2,hyum,2858,81,3,3,6,50.0%,47m
5398,2,[60APM]STAN,2858,0,0,1,1,0.0%,47m
5398,2,카제티즈,2858,0,0,2,2,0.0%,47m
5401,1,[챈코크]해병,2857,296,10,9,19,52.6%,23m
5401,2,니가가라챔스,2857,58,3,5,8,37.5%,43m
5401,2,연마,2857,30,2,0,2,100.0%,42m
5401,2,[천룡인]Black,2857,0,0,2,2,0.0%,46m
5405,2,swiss,2856,371,13,9,22,59.1%,47m
5405,2,llllllllllll,2856,90,3,3,6,50.0%,47m
5405,3,lIllIIlIIl,2856,0,3,5,8,37.5%,13m
5405,3,이인자,2856,0,0,2,2,0.0%,20m
5409,2,굼피,2855,1497,82,64,146,56.2%,43m
5409,2,WindHero,2855,1573,82,68,150,54.7%,43m
5409,1,스페이드,2855,249,8,11,19,42.1%,14m
5409,2,사람입니다,2855,253,7,4,11,63.6%,22m
5409,1,lllllllllll,2855,246,7,13,20,35.0%,45m
5409,2,유리가가린,2855,152,6,6,12,50.0%,46m
5409,2,모래,2855,104,5,4,9,55.6%,47m
5409,1,IIIIII,2855,0,2,3,5,40.0%,19m
5409,3,Elias,2855,0,1,0,1,100.0%,21m
5409,2,캐리건,2855,0,1,1,2,50.0%,46m
5409,1,[한타왕]이달의소녀츄,2855,0,0,3,3,0.0%,46m
5409,1,msw,2855,0,0,3,3,0.0%,46m
5421,1,[sc2mc]Destiny,2854,189,7,6,13,53.8%,46m
5421,1,Andy,2854,128,5,5,10,50.0%,44m
5421,2,안주,2854,86,4,4,8,50.0%,46m
5421,1,가몬,2854,0,3,2,5,60.0%,19m
5421,2,Krolic,2854,139,3,3,6,50.0%,22m
5421,2,[VE]OVERMIND,2854,0,1,0,1,100.0%,23m
5427,3,제로아워,2853,596,41,46,87,47.1%,13m
5427,1,라라앙,2853,861,39,32,71,54.9%,44m
5427,1,[ENT]GdPark,2853,528,17,23,40,42.5%,46m
5427,3,Genesis,2853,258,8,19,27,29.6%,7m
5427,2,고정사정,2853,0,0,1,1,0.0%,43m
5427,2,나는공주,2853,0,0,1,1,0.0%,47m
5433,2,GloryG,2852,154,5,7,12,41.7%,47m
5433,3,라떼는말이야,2852,0,4,3,7,57.1%,20m
5433,2,러쉬맨,2852,0,0,1,1,0.0%,48m
5433,2,아연,2852,0,0,1,1,0.0%,43m
5437,1,[조직]동수파파,2851,1591,64,64,128,50.0%,46m
5437,2,ShouHeng,2851,831,33,28,61,54.1%,46m
5437,2,Ridden,2851,116,5,3,8,62.5%,47m
5437,1,[300ms]Lagger,2851,0,3,3,6,50.0%,46m
5437,2,biverse,2851,38,1,3,4,25.0%,46m
5442,1,pssyckh,2850,1049,38,39,77,49.4%,45m
5442,1,Nivdc,2850,532,19,18,37,51.4%,44m
5442,1,사커겐지,2850,322,10,11,21,47.6%,16m
5442,1,MountainDew,2850,0,4,3,7,57.1%,46m
5442,2,KimTong,2850,30,1,1,2,50.0%,43m
5442,1,소마,2850,95,1,3,4,25.0%,44m
5448,3,Veritas,2849,1564,569,517,1086,52.4%,3m
5448,2,문주냉,2849,1134,89,78,167,53.3%,48m
5448,2,[김정은SC]KimJongUn,2849,903,57,67,124,46.0%,3m
5448,3,llllllllllll,2849,751,31,30,61,50.8%,6m
5448,2,CommA,2849,168,6,0,6,100.0%,46m
5448,3,spionaggio,2849,198,6,9,15,40.0%,13m
5454,2,[LaMa]moonstar,2848,178,5,5,10,50.0%,21m
5454,3,HappyToture,2848,122,4,4,8,50.0%,21m
5454,2,KRdog,2848,0,3,2,5,60.0%,48m
5454,2,奇犽,2848,88,3,3,6,50.0%,43m
5454,2,RyoKo,2848,0,1,3,4,25.0%,21m
5459,2,bluecomeback,2847,1298,55,40,95,57.9%,42m
5459,2,Departure,2847,634,25,17,42,59.5%,46m
5459,2,치느님,2847,509,20,13,33,60.6%,46m
5459,2,대표미남,2847,181,7,6,13,53.8%,23m
5459,2,쓸싹쓸싹,2847,0,0,1,1,0.0%,43m
5464,1,Malfurion,2846,1131,85,92,177,48.0%,45m
5464,1,[NOSAMO]노무현,2846,944,37,35,72,51.4%,46m
5464,1,新冠還是武漢肺炎,2846,296,9,15,24,37.5%,46m
5467,1,ROY,2845,804,28,32,60,46.7%,46m
5467,1,LastRoad,2845,235,10,13,23,43.5%,46m
5467,2,DarkDuck,2845,0,0,1,1,0.0%,47m
5470,2,심심해서스타세판,2844,968,40,28,68,58.8%,47m
5470,2,꾸엑꾸,2844,150,5,6,11,45.5%,43m
5470,3,aktehdtks,2844,97,4,3,7,57.1%,20m
5470,1,위드,2844,0,2,2,4,50.0%,19m
5470,2,psyoppa,2844,0,1,0,1,100.0%,43m
5475,2,연수,2843,1261,65,55,120,54.2%,47m
5475,1,Rouman,2843,1236,44,52,96,45.8%,46m
5475,2,lllll,2843,308,12,6,18,66.7%,47m
5475,3,Andariel,2843,231,9,8,17,52.9%,7m
5475,1,2843,0,3,2,5,60.0%,18m
5475,1,닭강정,2843,74,2,8,10,20.0%,45m
5475,3,Markeep,2843,73,1,6,7,14.3%,21m
5482,1,[너의ol름은]봄봄,2842,1436,89,79,168,53.0%,44m
5482,1,hordru,2842,291,64,69,133,48.1%,45m
5482,3,brianyang,2842,121,4,2,6,66.7%,21m
5482,2,[실력의기원]오줌싸게준이,2842,136,3,2,5,60.0%,47m
5482,2,아름다운별빛,2842,0,0,3,3,0.0%,47m
5487,2,Rush,2841,420,15,12,27,55.6%,47m
5487,2,雞母蟲,2841,294,13,12,25,52.0%,46m
5487,2,sILenZe,2841,227,8,7,15,53.3%,21m
5487,2,noregret,2841,258,8,10,18,44.4%,22m
5487,2,우리집세시방향,2841,118,7,6,13,53.8%,43m
5487,2,천국의사자,2841,142,5,5,10,50.0%,43m
5487,2,동구밖과수원샷,2841,133,3,1,4,75.0%,14m
5487,2,조마루,2841,30,1,2,3,33.3%,47m
5495,1,돌다리,2840,1437,129,131,260,49.6%,45m
5495,2,XxiaoO,2840,603,42,31,73,57.5%,46m
5495,1,캐리건,2840,675,29,22,51,56.9%,46m
5495,1,RuFie,2840,681,26,25,51,51.0%,45m
5495,2,RoachKing,2840,464,18,13,31,58.1%,43m
5495,2,스타크래프트,2840,0,1,2,3,33.3%,47m
5501,1,맹공,2839,1552,265,246,511,51.9%,4m
5501,1,카레찜닭,2839,673,21,23,44,47.7%,45m
5501,1,[Mist]비제이사냥꾼,2839,604,21,24,45,46.7%,45m
5504,3,오곡님,2838,520,133,127,260,51.2%,12m
5504,2,[스타리나잇]KBeSing,2838,1325,57,49,106,53.8%,48m
5504,3,박규원,2838,97,4,3,7,57.1%,19m
5504,1,악마,2838,0,3,2,5,60.0%,19m
5504,2,llllllllllll,2838,120,2,1,3,66.7%,46m
5504,2,정원용,2838,0,2,3,5,40.0%,43m
5504,1,jhs,2838,36,2,9,11,18.2%,46m
5504,2,ViperRevol,2838,94,1,1,2,50.0%,22m
5504,1,세콤,2838,0,0,3,3,0.0%,14m
5513,2,LuvNK,2837,1060,45,36,81,55.6%,46m
5513,2,이종현,2837,450,16,19,35,45.7%,48m
5513,2,DoomMD,2837,314,13,8,21,61.9%,43m
5513,2,badmonkeyman,2837,291,11,5,16,68.8%,47m
5513,2,karakis,2837,176,6,5,11,54.5%,43m
5513,1,[Hyena]IIIIIIIIIIII,2837,0,3,2,5,60.0%,19m
5513,3,레박,2837,0,1,0,1,100.0%,21m
5513,2,송현아,2837,0,1,0,1,100.0%,21m
5521,1,타코소스,2836,1610,104,100,204,51.0%,45m
5521,1,AllenKuo,2836,1451,85,74,159,53.5%,45m
5521,1,악마,2836,778,34,29,63,54.0%,46m
5521,3,너거미땅거미지뢰,2836,221,10,10,20,50.0%,13m
5521,1,신결희,2836,58,5,4,9,55.6%,44m
5521,3,Viola,2836,0,3,3,6,50.0%,21m
5521,3,Lennon,2836,93,2,4,6,33.3%,3m
5528,1,BreeMA,2835,1236,82,85,167,49.1%,45m
5528,1,asdfghjkl,2835,938,34,35,69,49.3%,45m
5528,2,[冬的小雪夏0]幽雨,2835,286,10,9,19,52.6%,47m
5531,1,근댕,2834,552,20,23,43,46.5%,46m
5531,1,정병화,2834,88,3,5,8,37.5%,44m
5531,2,[Bully]펑커임요환,2834,0,1,0,1,100.0%,47m
5531,2,사기꾼,2834,0,0,2,2,0.0%,47m
5535,3,UFO,2833,1491,117,104,221,52.9%,6m
5535,2,kms,2833,296,21,24,45,46.7%,48m
5535,2,[Wang]바퀴왕,2833,253,9,7,16,56.2%,22m
5535,2,[G丨S]Urz,2833,199,8,6,14,57.1%,47m
5535,2,gggg,2833,0,3,2,5,60.0%,43m
5535,1,knowledge,2833,0,3,3,6,50.0%,44m
5535,2,팔란티어,2833,0,1,0,1,100.0%,47m
5535,2,쫄지말그라,2833,0,1,1,2,50.0%,47m
5543,2,Adrenaline,2832,227,8,7,15,53.3%,22m
5543,2,Mohandar,2832,114,5,3,8,62.5%,43m
5543,2,Covaena,2832,141,4,2,6,66.7%,22m
5543,1,[해피투게더]늅뉴비,2832,0,1,0,1,100.0%,23m
5543,2,굿뜨,2832,0,0,2,2,0.0%,22m
5543,2,곰종,2832,0,0,2,2,0.0%,21m
5549,2,[겨울방어]똥준이,2831,1554,89,73,162,54.9%,43m
5549,3,바구미,2831,1478,70,70,140,50.0%,6m
5549,1,YangCheng,2831,316,30,27,57,52.6%,45m
5549,2,[똥튀]똥따까리,2831,226,9,7,16,56.2%,47m
5549,2,김치보이,2831,94,4,7,11,36.4%,43m
5549,2,솔벗,2831,58,2,2,4,50.0%,46m
5549,2,[Flysky]MOONLight,2831,30,1,3,4,25.0%,43m
5556,2,자유의날개,2830,1420,55,51,106,51.9%,46m
5556,2,Cho,2830,762,35,29,64,54.7%,47m
5556,2,luckcoo,2830,404,15,14,29,51.7%,48m
5556,3,BrandNewSCV,2830,146,6,3,9,66.7%,21m
5556,2,오마이갓,2830,138,5,5,10,50.0%,22m
5556,3,bisso,2830,0,1,0,1,100.0%,21m
5556,2,느금마,2830,0,1,2,3,33.3%,47m
5556,2,성은옥씨이름은민,2830,30,1,3,4,25.0%,46m
5564,3,스타워즈,2829,1556,260,245,505,51.5%,3m
5564,1,아이러브진순펩시,2829,947,38,36,74,51.4%,44m
5564,3,matyunya,2829,355,28,35,63,44.4%,3m
5564,2,Attila,2829,390,18,15,33,54.5%,43m
5564,1,Yago,2829,344,16,15,31,51.6%,46m
5564,2,pisknx,2829,152,5,4,9,55.6%,43m
5564,2,[래더납치범]HMA,2829,30,1,3,4,25.0%,46m
5571,2,만만한상대,2828,508,18,18,36,50.0%,47m
5571,2,천하스타,2828,0,2,3,5,40.0%,43m
5571,3,Marquez,2828,0,0,1,1,0.0%,19m
5574,2,fnsckdl,2827,112,2,1,3,66.7%,43m
5575,1,[얼굴]적아대녀,2826,898,34,29,63,54.0%,46m
5575,2,히드라,2826,362,17,8,25,68.0%,43m
5575,2,[Worm]KDG,2826,142,6,4,10,60.0%,47m
5575,2,Yura,2826,30,2,2,4,50.0%,46m
5575,2,폭군,2826,30,1,1,2,50.0%,47m
5575,1,[즐겜러]호크아이,2826,97,1,4,5,20.0%,42m
5581,1,[2494]grain,2825,1463,92,85,177,52.0%,46m
5581,2,주니치카,2825,326,12,13,25,48.0%,47m
5581,1,Mercury,2825,145,7,5,12,58.3%,43m
5581,2,민승이,2825,141,5,6,11,45.5%,21m
5581,1,BoWHnTR,2825,115,2,6,8,25.0%,46m
5581,2,베다,2825,0,1,0,1,100.0%,47m
5581,2,[快樂玩家]JIM,2825,30,1,3,4,25.0%,47m
5588,2,[버터오징어]MADkiller,2824,234,8,5,13,61.5%,47m
5588,2,기태몬,2824,196,6,7,13,46.2%,47m
5588,2,UsagiSix,2824,0,3,2,5,60.0%,47m
5588,2,HHC,2824,0,1,0,1,100.0%,47m
5588,2,[썸썸편의점]아델라프로하스카,2824,0,0,1,1,0.0%,47m
5593,2,Boxer,2823,1592,151,135,286,52.8%,48m
5593,2,[NGameS]LIme,2823,348,12,10,22,54.5%,46m
5593,2,무한불가능,2823,249,8,8,16,50.0%,43m
5593,2,YOHOHO,2823,148,6,5,11,54.5%,43m
5593,2,고교스투러,2823,130,5,1,6,83.3%,46m
5598,2,Earth,2822,1039,85,74,159,53.5%,46m
5598,3,[SHIPS]베로니카,2822,157,6,5,11,54.5%,20m
5598,1,프로유인선,2822,159,5,5,10,50.0%,45m
5601,2,Optixus,2821,1596,184,174,358,51.4%,47m
5601,3,Zergman,2821,911,35,33,68,51.5%,7m
5601,2,gerdel,2821,181,8,1,9,88.9%,48m
5601,2,astro,2821,230,8,9,17,47.1%,47m
5601,2,[고급]메피스터,2821,174,6,7,13,46.2%,22m
5601,2,파란고래,2821,0,0,1,1,0.0%,43m
5607,2,Leo,2820,390,18,12,30,60.0%,43m
5607,2,[연패현]조용한아침,2820,250,13,12,25,52.0%,47m
5607,3,백련곰,2820,388,13,26,39,33.3%,2m
5607,2,llllllllllll,2820,327,11,15,26,42.3%,46m
5607,2,要自由吃美猪,2820,88,2,0,2,100.0%,47m
5607,1,marketwizard,2820,0,2,3,5,40.0%,19m
5607,2,[더지니어스]김폰벨,2820,0,1,0,1,100.0%,43m
5607,2,심심한대학생,2820,0,1,0,1,100.0%,46m
5615,2,[FZero]러드,2819,143,6,4,10,60.0%,14m
5615,2,vvvvvwvwvwvw,2819,128,3,3,6,50.0%,47m
5615,3,llllllllllll,2819,0,2,2,4,50.0%,20m
5615,2,그레이트팍,2819,30,2,3,5,40.0%,47m
5615,2,타우렌,2819,0,1,0,1,100.0%,47m
5615,2,회색마뇨,2819,0,1,2,3,33.3%,47m
5615,2,[BNGWHL]大亨堡,2819,30,1,3,4,25.0%,47m
5622,2,娜娜莉,2818,615,268,233,501,53.5%,47m
5622,2,无关阿达温柔,2818,889,50,52,102,49.0%,47m
5622,2,malver,2818,423,28,22,50,56.0%,47m
5622,2,baecome,2818,540,26,10,36,72.2%,43m
5622,1,Koziivka,2818,171,5,7,12,41.7%,41m
5622,2,냠냠,2818,0,3,2,5,60.0%,43m
5622,2,ask,2818,0,2,2,4,50.0%,43m
5622,2,동바리,2818,0,1,0,1,100.0%,43m
5622,2,늑정,2818,0,0,1,1,0.0%,43m
5631,1,꽃흔들유라흔들,2817,1205,69,67,136,50.7%,45m
5631,2,[갓세정]김세정,2817,376,15,12,27,55.6%,43m
5631,1,taemin,2817,260,8,12,20,40.0%,46m
5631,2,winking,2817,218,7,4,11,63.6%,46m
5631,2,Nesourati,2817,58,2,3,5,40.0%,46m
5631,2,Computer,2817,30,1,1,2,50.0%,47m
5631,3,怪怪的怪怪的,2817,0,1,1,2,50.0%,21m
5631,2,도라지캐자,2817,0,0,2,2,0.0%,47m
5639,2,따듯,2816,1237,53,40,93,57.0%,47m
5639,2,武藤華,2816,290,10,8,18,55.6%,22m
5639,2,seric,2816,274,9,12,21,42.9%,47m
5639,2,[줄기]Storm,2816,88,2,0,2,100.0%,47m
5639,1,twitchBilich,2816,0,2,3,5,40.0%,19m
5639,2,얄루봉봉,2816,0,0,1,1,0.0%,46m
5645,1,llllllllllll,2815,876,39,31,70,55.7%,44m
5645,2,Datengu,2815,154,6,4,10,60.0%,43m
5645,2,flynife,2815,167,6,7,13,46.2%,48m
5645,2,하악하악,2815,183,5,3,8,62.5%,46m
5645,3,까만도토리,2815,97,4,3,7,57.1%,20m
5645,1,Vares,2815,48,3,3,6,50.0%,19m
5645,2,WinFestors,2815,30,2,1,3,66.7%,47m
5645,2,안녕하세요,2815,0,1,1,2,50.0%,43m
5645,2,썸타는드래곤,2815,0,1,2,3,33.3%,47m
5645,2,watchtv,2815,0,0,3,3,0.0%,48m
5655,1,Dark,2814,1550,248,225,473,52.4%,44m
5655,2,grimreaper,2814,1585,66,55,121,54.5%,43m
5655,2,[나이스]나이스,2814,1161,54,44,98,55.1%,43m
5655,2,aclikK,2814,330,14,12,26,53.8%,43m
5655,2,VIRUS,2814,290,10,11,21,47.6%,48m
5655,1,Vincent,2814,0,3,4,7,42.9%,44m
5661,2,[미친광전사]NovaTerra,2813,213,9,4,13,69.2%,43m
5661,2,Raynor,2813,218,8,7,15,53.3%,47m
5661,2,[실빵구]banggucha,2813,167,6,6,12,50.0%,47m
5661,1,상어잡이성하,2813,32,4,4,8,50.0%,46m
5661,3,워니잉,2813,131,3,1,4,75.0%,36m
5661,2,Nova,2813,0,0,1,1,0.0%,48m
5661,2,[101010]벌레,2813,0,0,2,2,0.0%,43m
5668,2,부릉,2812,1413,148,144,292,50.7%,6m
5668,1,mlkaruoIove,2812,1510,57,58,115,49.6%,46m
5668,1,wonderboy,2812,588,26,20,46,56.5%,45m
5668,2,하프물범,2812,173,6,1,7,85.7%,43m
5668,1,존망겜언제섭종,2812,186,3,11,14,21.4%,14m
5668,1,Yoshi,2812,0,2,3,5,40.0%,18m
5668,1,NIGHT,2812,40,2,7,9,22.2%,45m
5668,1,Presso,2812,96,1,3,4,25.0%,44m
5668,2,[경기도]빠따,2812,0,0,1,1,0.0%,43m
5677,2,鬼魅殤滅,2811,564,30,33,63,47.6%,47m
5677,2,騎大象瘋狂甩尾,2811,542,22,23,45,48.9%,47m
5677,3,[누님]깜닭,2811,180,10,11,21,47.6%,3m
5677,2,Motihuan,2811,191,8,5,13,61.5%,46m
5677,3,[PeTGe]wolvesr,2811,0,3,3,6,50.0%,20m
5677,2,고니,2811,88,1,1,2,50.0%,47m
5677,2,GangMin,2811,0,1,3,4,25.0%,43m
5684,2,lIlIlIlIllI,2810,483,72,59,131,55.0%,47m
5684,3,[lZONE]김민주,2810,585,32,42,74,43.2%,7m
5684,1,길가던강아지,2810,89,5,3,8,62.5%,44m
5684,2,[hl1234]scgreatagain,2810,0,0,1,1,0.0%,47m
5688,2,Slayers,2809,0,0,1,1,0.0%,43m
5688,2,IRIS,2809,0,0,2,2,0.0%,46m
5690,1,삿음,2808,48,3,4,7,42.9%,19m
5690,2,히페리온준형테란,2808,0,0,1,1,0.0%,47m
5690,2,콜라맛사이다,2808,0,0,1,1,0.0%,22m
5693,2,Dante,2807,1080,42,37,79,53.2%,43m
5693,1,추디,2807,751,29,25,54,53.7%,44m
5693,2,marin,2807,216,8,5,13,61.5%,22m
5693,1,zGodGodz,2807,0,3,3,6,50.0%,44m
5693,2,아이유,2807,0,1,0,1,100.0%,23m
5693,2,flameCT,2807,0,1,0,1,100.0%,43m
5693,2,zzzzz,2807,0,0,3,3,0.0%,47m
5693,2,[H2Z]BrianxXx,2807,0,0,5,5,0.0%,47m
5701,1,독먹은히드라,2806,1125,78,67,145,53.8%,44m
5701,1,도로병장님,2806,497,23,24,47,48.9%,46m
5701,2,nakiller,2806,245,10,2,12,83.3%,43m
5701,2,DIEoHARDER,2806,144,5,5,10,50.0%,47m
5701,2,[曼巴蛇]CoolKleist,2806,138,3,2,5,60.0%,47m
5701,2,마이클색슨,2806,62,2,4,6,33.3%,47m
5701,2,다시태어나고싶다,2806,0,1,0,1,100.0%,46m
5701,2,IllIllIIIll,2806,0,1,0,1,100.0%,48m
5701,1,河道肥揪吉,2806,0,1,2,3,33.3%,19m
5701,2,토르,2806,0,0,1,1,0.0%,47m
5711,1,Planetlovely,2805,679,36,33,69,52.2%,45m
5711,1,Cannot,2805,193,7,9,16,43.8%,14m
5711,3,Mori,2805,129,2,3,5,40.0%,20m
5711,2,[저그군락]최강저그,2805,0,0,1,1,0.0%,47m
5711,2,[백합]탈다림,2805,0,0,1,1,0.0%,47m
5716,2,Zwitter,2804,506,44,8,52,84.6%,48m
5716,2,Payie,2804,240,7,8,15,46.7%,43m
5716,2,낄낄악마,2804,112,2,2,4,50.0%,47m
5716,2,[IWYDI]ChiaHungWYD,2804,0,0,1,1,0.0%,48m
5720,2,stormzerg,2803,424,16,12,28,57.1%,47m
5720,2,문제앙과노무현,2803,102,2,1,3,66.7%,46m
5720,3,HaMuTauruS,2803,0,0,1,1,0.0%,36m
5720,2,꼬부기,2803,0,0,2,2,0.0%,47m
5724,2,[GAL]鳴海兔亞,2802,597,24,18,42,57.1%,43m
5724,2,大常,2802,364,15,16,31,48.4%,47m
5724,2,쿠스카타두토,2802,140,4,4,8,50.0%,47m
5724,2,miston,2802,0,1,1,2,50.0%,47m
5724,2,KBI,2802,0,0,1,1,0.0%,47m
5729,2,스타사령관,2801,690,30,19,49,61.2%,47m
5729,2,xxJeep,2801,330,12,10,22,54.5%,48m
5729,2,lonegunman,2801,280,9,15,24,37.5%,2m
5729,1,[GnSa]pro,2801,132,5,13,18,27.8%,46m
5729,1,소프,2801,34,4,4,8,50.0%,44m
5729,2,hunter,2801,138,3,3,6,50.0%,43m
5729,3,Changeo,2801,0,1,2,3,33.3%,20m
5729,2,내가좀짱임,2801,0,0,1,1,0.0%,47m
5737,2,DsD,2800,164,12,12,24,50.0%,46m
5737,1,쓸거라,2800,72,4,7,11,36.4%,44m
5737,1,[핵졸귀]HUNYEONG,2800,0,1,1,2,50.0%,19m
5737,2,[B猛象黃衫軍]魔方狂人,2800,32,1,3,4,25.0%,47m
5737,3,인공지능,2800,0,0,1,1,0.0%,16m
5742,1,[SheWar]Hyalu,2799,1585,91,81,172,52.9%,43m
5742,2,요다닷,2799,192,6,5,11,54.5%,47m
5744,1,enzoul,2798,445,18,19,37,48.6%,45m
5744,3,byunnim,2798,0,1,0,1,100.0%,48m
5744,2,피파개망겜,2798,30,1,4,5,20.0%,47m
5747,3,[SGlory]蝱蟲,2797,86,8,0,8,100.0%,48m
5747,2,밥먹고하자고,2797,214,7,12,19,36.8%,47m
5747,2,PoisonLai,2797,194,6,12,18,33.3%,47m
5747,2,KillerAnn,2797,88,2,1,3,66.7%,47m
5747,2,아들겜좀그만해,2797,0,1,4,5,20.0%,47m
5747,3,[통삼겹살]아크엔마스터,2797,0,0,1,1,0.0%,48m
5747,3,이소융,2797,0,0,2,2,0.0%,19m
5754,2,[3121]akama,2796,457,50,51,101,49.5%,47m
5754,1,쌈장이기석,2796,1346,46,57,103,44.7%,46m
5754,2,[공방깡패]임하우동,2796,390,14,17,31,45.2%,47m
5754,3,Returns,2796,177,7,9,16,43.8%,16m
5754,2,[XKQD]iiiider,2796,220,7,10,17,41.2%,47m
5754,3,[해병대]개구리,2796,140,3,3,6,50.0%,16m
5754,2,[zAWSLz]aaaa,2796,80,3,6,9,33.3%,22m
5754,3,SPOON,2796,0,0,1,1,0.0%,42m
5762,3,xinchao,2795,872,44,36,80,55.0%,16m
5762,2,dugie,2795,286,9,12,21,42.9%,47m
5762,3,LPthirtyCM,2795,204,7,5,12,58.3%,20m
5762,3,EBASHU,2795,121,4,4,8,50.0%,21m
5762,3,losue,2795,30,2,0,2,100.0%,48m
5762,2,GNIMAD,2795,30,1,5,6,16.7%,43m
5762,3,SoSYang,2795,0,0,1,1,0.0%,48m
5769,2,테란,2794,1108,62,55,117,53.0%,47m
5769,1,[萬花筒寫輪眼]不悲不喜不晴不雨,2794,1134,48,54,102,47.1%,45m
5769,1,Holy,2794,1202,45,57,102,44.1%,44m
5769,2,Leo,2794,496,19,15,34,55.9%,48m
5769,2,서울사이버대학교,2794,118,5,6,11,45.5%,47m
5774,3,[SNL]니얼굴이다,2793,438,15,22,37,40.5%,4m
5774,2,DAVEZEROTYPE,2793,116,5,5,10,50.0%,43m
5774,3,구완,2793,36,4,5,9,44.4%,21m
5774,3,[크이유튭]zerg,2793,0,1,0,1,100.0%,48m
5778,1,CLWinTer,2792,476,17,24,41,41.5%,45m
5778,1,Sadie,2792,96,3,9,12,25.0%,44m
5778,1,Keyzx,2792,0,0,1,1,0.0%,18m
5781,3,kaniji,2791,483,18,12,30,60.0%,48m
5781,2,알씨준,2791,288,11,11,22,50.0%,47m
5781,2,Crush,2791,193,8,6,14,57.1%,23m
5781,1,컴퓨터,2791,140,3,0,3,100.0%,14m
5781,2,[Worm]플토재미있지,2791,40,2,6,8,25.0%,46m
5781,3,마니,2791,0,0,1,1,0.0%,16m
5781,1,CarlYJQ,2791,0,0,3,3,0.0%,44m
5788,3,나는탱구,2790,97,1,1,2,50.0%,20m
5789,1,IIIIIIIIIIII,2789,1597,136,141,277,49.1%,45m
5789,2,當時的我害怕極了,2789,455,36,19,55,65.5%,48m
5789,2,smile,2789,758,30,23,53,56.6%,48m
5789,3,[세미온각]화나면짖는개,2789,88,5,4,9,55.6%,36m
5789,3,SmileeFace,2789,141,5,4,9,55.6%,42m
5789,2,HelloBanana,2789,134,5,5,10,50.0%,43m
5789,2,[EUNSUL]ZION,2789,118,4,6,10,40.0%,48m
5789,3,[VEVO]YUSEI,2789,30,2,0,2,100.0%,48m
5789,1,배원찬,2789,0,0,3,3,0.0%,15m
5789,2,[이신형제자]케찰코아툴루스,2789,0,0,4,4,0.0%,47m
5799,3,애벌레두,2788,40,4,4,8,50.0%,20m
5799,2,울산저그,2788,58,3,3,6,50.0%,43m
5799,3,ChinkenGG,2788,0,1,0,1,100.0%,48m
5799,1,KoshNaranek,2788,0,1,4,5,20.0%,19m
5799,3,[Spades]Dracun,2788,0,0,1,1,0.0%,16m
5804,1,말티즈보미,2787,1526,73,79,152,48.0%,45m
5804,1,김빨무,2787,548,47,44,91,51.6%,46m
5804,3,shsambarri,2787,230,9,5,14,64.3%,43m
5804,2,밤날개,2787,264,9,7,16,56.2%,47m
5804,2,[bOvOd]VIOLstar,2787,132,6,4,10,60.0%,14m
5804,1,[오문창]BinZema,2787,48,2,1,3,66.7%,19m
5804,3,教我玩這遊戲,2787,0,0,1,1,0.0%,48m
5811,2,Daughtry,2786,446,19,15,34,55.9%,47m
5811,1,세이진,2786,130,5,10,15,33.3%,46m
5811,2,lazyghst,2786,0,1,2,3,33.3%,47m
5814,1,뭐여이거지는,2785,1448,71,65,136,52.2%,46m
5814,2,지녕아달려,2785,813,34,29,63,54.0%,43m
5814,2,hatechina,2785,60,2,4,6,33.3%,47m
5814,3,[지는게꿈이다]지고싶다,2785,0,0,1,1,0.0%,48m
5814,3,sweetpotato,2785,0,0,1,1,0.0%,48m
5819,1,甲種水電,2784,1158,47,41,88,53.4%,45m
5819,2,서현아사랑해,2784,570,24,18,42,57.1%,43m
5819,2,lIlIlIlIlIlI,2784,116,4,1,5,80.0%,43m
5819,2,앙기모띠,2784,60,3,3,6,50.0%,47m
5819,2,Eli,2784,30,2,5,7,28.6%,47m
5819,3,[萬花筒寫輪眼]OOOO,2784,0,1,0,1,100.0%,48m
5819,2,readyforshow,2784,0,0,3,3,0.0%,47m
5826,2,boxer,2783,136,4,2,6,66.7%,22m
5826,2,[Yisc]다현이,2783,140,4,5,9,44.4%,43m
5826,2,레드벨벳슬기,2783,88,1,2,3,33.3%,47m
5826,2,Ocean,2783,0,0,2,2,0.0%,22m
5830,2,[송해손잡고]Snare,2782,713,36,25,61,59.0%,43m
5830,3,[UN無限]spatiager,2782,797,33,36,69,47.8%,13m
5830,1,청춘의특권,2782,758,28,34,62,45.2%,44m
5830,2,GIMIN,2782,60,3,2,5,60.0%,43m
5830,3,[PUD]김태희,2782,30,2,0,2,100.0%,16m
5835,2,[神族好強]date,2781,347,15,8,23,65.2%,47m
5835,2,changeover,2781,220,10,10,20,50.0%,22m
5835,1,BiliBili,2781,0,2,3,5,40.0%,19m
5835,2,윤짱,2781,0,0,2,2,0.0%,43m
5839,3,Ghost,2780,970,44,24,68,64.7%,42m
5839,3,ZWANGFCNG,2780,330,13,7,20,65.0%,16m
5839,2,PIKA,2780,222,9,13,22,40.9%,7m
5839,1,[2Z]하다,2780,231,8,9,17,47.1%,15m
5839,2,트로트,2780,208,8,11,19,42.1%,47m
5839,2,FoxeR,2780,210,5,13,18,27.8%,21m
5839,3,[meobol]moriarty,2780,0,3,2,5,60.0%,43m
5846,3,skyhrg,2779,245,9,9,18,50.0%,42m
5846,1,[스타2마피아]아믹,2779,134,3,9,12,25.0%,45m
5848,2,blackswas,2778,257,9,10,19,47.4%,14m
5848,2,[KrNoob]IIIIIIIIIIII,2778,130,5,2,7,71.4%,43m
5848,3,Sreta,2778,0,3,3,6,50.0%,20m
5851,2,[cuckoo]yychen,2777,221,11,16,27,40.7%,48m
5851,1,[SBD]납짝만두,2777,252,7,15,22,31.8%,14m
5851,2,adorablechlo,2777,174,5,5,10,50.0%,47m
5851,3,llllllllllll,2777,122,3,1,4,75.0%,21m
5851,1,유설아,2777,94,2,8,10,20.0%,15m
5851,2,스워드,2777,0,1,1,2,50.0%,43m
5851,3,KORgurapa,2777,0,1,1,2,50.0%,16m
5851,3,[어깨뼈갈비뼈]칼날왕자,2777,0,0,1,1,0.0%,16m
5851,3,Revolution,2777,0,0,1,1,0.0%,48m
5851,2,帥暉,2777,0,0,2,2,0.0%,47m
5861,3,Nozawanabe,2776,172,7,2,9,77.8%,48m
5861,3,TerranL,2776,132,3,2,5,60.0%,42m
5861,3,Amai,2776,60,2,2,4,50.0%,42m
5861,3,[4호]Flakpanzer,2776,0,0,1,1,0.0%,16m
5865,2,iam,2775,878,30,47,77,39.0%,13m
5865,1,한번만,2775,414,15,19,34,44.1%,44m
5865,1,암흑의두루치기,2775,48,3,4,7,42.9%,18m
5865,2,람스,2775,0,0,2,2,0.0%,43m
5869,3,VERGIL,2774,337,38,28,66,57.6%,48m
5869,1,[랜타디광]진에어마루은구,2774,522,16,22,38,42.1%,46m
5869,2,[Xbaek]Infinity,2774,398,15,13,28,53.6%,47m
5869,2,[異界的檢察官]XxFkDoYaxX,2774,194,6,6,12,50.0%,43m
5869,1,에렌디라,2774,0,2,3,5,40.0%,19m
5869,1,Zestria,2774,95,1,4,5,20.0%,23m
5869,3,도이아,2774,0,0,1,1,0.0%,16m
5869,3,MVP,2774,0,0,1,1,0.0%,42m
5869,2,dokuhevi,2774,0,0,5,5,0.0%,47m
5878,2,[정치공학]corea,2773,142,4,4,8,50.0%,43m
5878,3,이즈리이얼산스,2773,58,3,0,3,100.0%,48m
5878,2,Rachmaninoff,2773,42,2,6,8,25.0%,47m
5878,3,[NDW]hymn,2773,30,1,2,3,33.3%,48m
5882,2,戰隊,2772,519,22,15,37,59.5%,47m
5882,2,SEONBAE,2772,543,22,17,39,56.4%,43m
5882,3,[D3StaR]용왕,2772,144,5,5,10,50.0%,48m
5882,3,[NoMST]ToFu,2772,0,1,0,1,100.0%,48m
5886,1,승리예감만땅,2771,1213,184,171,355,51.8%,45m
5886,2,읭바,2771,430,17,14,31,54.8%,47m
5886,1,Wei,2771,236,9,12,21,42.9%,15m
5886,3,sAviOr,2771,0,0,1,1,0.0%,16m
5886,1,[베이비]빌즈,2771,0,0,3,3,0.0%,15m
5891,2,XiGinPinkGay,2770,1542,161,151,312,51.6%,43m
5891,3,어린아저씨,2770,1222,138,133,271,50.9%,2m
5891,2,oook,2770,0,4,2,6,66.7%,47m
5891,1,[아구]KING,2770,30,2,5,7,28.6%,43m
5891,3,[rada]SpunkyMaxy,2770,0,1,0,1,100.0%,48m
5891,3,[실력의기원]뿡이빵이,2770,0,1,2,3,33.3%,42m
5891,3,SuperRed,2770,30,1,3,4,25.0%,16m
5898,3,LogicWisdom,2769,361,15,11,26,57.7%,48m
5898,2,서양의무법자,2769,0,4,4,8,50.0%,22m
5898,2,張嘉文,2769,30,4,5,9,44.4%,43m
5898,1,Harvest,2769,48,2,1,3,66.7%,19m
5898,3,[스타놀이터]진주,2769,0,2,2,4,50.0%,42m
5903,1,발라크공작,2768,1334,119,117,236,50.4%,45m
5903,2,피닉스,2768,315,10,13,23,43.5%,47m
5903,3,풀하우스,2768,30,1,1,2,50.0%,48m
5906,1,광탈자일인자,2767,1540,118,125,243,48.6%,44m
5906,2,Ryan,2767,177,10,9,19,52.6%,48m
5906,1,공균호,2767,192,8,8,16,50.0%,46m
5906,3,BondiolaKing,2767,140,6,5,11,54.5%,16m
5906,1,카르,2767,150,6,6,12,50.0%,44m
5906,3,PoCaRi,2767,121,4,4,8,50.0%,21m
5906,1,저글링발톱,2767,48,3,3,6,50.0%,19m
5906,3,leedaen,2767,0,0,1,1,0.0%,42m
5906,2,구름은하얀색,2767,0,0,4,4,0.0%,47m
5915,2,더들리페이지언덕,2766,1433,246,235,481,51.1%,47m
5915,1,Octopus,2766,514,18,20,38,47.4%,45m
5915,3,Kagary,2766,148,5,7,12,41.7%,48m
5915,3,쌍쓰리이루타,2766,88,3,3,6,50.0%,48m
5915,1,IlIlIlIlIlIl,2766,97,3,3,6,50.0%,14m
5915,3,이쁜이,2766,0,1,0,1,100.0%,48m
5915,1,Forsaken,2766,48,1,3,4,25.0%,19m
5922,1,군단,2765,1491,77,81,158,48.7%,43m
5922,2,한콩고,2765,1417,71,62,133,53.4%,43m
5922,2,이동헌,2765,263,10,7,17,58.8%,43m
5922,3,bETONG,2765,0,1,0,1,100.0%,16m
5922,1,paranoid,2765,0,1,0,1,100.0%,19m
5922,2,CYH,2765,0,1,2,3,33.3%,43m
5922,3,Batman,2765,0,0,1,1,0.0%,48m
5929,2,[비트]오버마인드,2764,711,31,19,50,62.0%,48m
5929,2,[000]蘇維埃共產軍隊,2764,758,30,22,52,57.7%,43m
5929,3,스토믹,2764,97,4,2,6,66.7%,48m
5929,3,tlqkfsha,2764,0,1,1,2,50.0%,48m
5933,2,Kgomm,2763,430,14,19,33,42.4%,43m
5933,2,[POTG]DyuRan,2763,189,6,4,10,60.0%,43m
5933,1,herO,2763,142,5,6,11,45.5%,44m
5933,2,TerKey,2763,0,0,2,2,0.0%,43m
5937,2,[국방부사서병]NICKX,2762,30,4,4,8,50.0%,43m
5937,2,[GIS]負能量肥宅,2762,88,2,1,3,66.7%,43m
5937,3,soulkick,2762,60,2,3,5,40.0%,48m
5937,3,Dopa,2762,0,0,1,1,0.0%,16m
5937,3,selince,2762,0,0,2,2,0.0%,20m
5942,3,[막강]기사단장,2761,142,5,5,10,50.0%,16m
5942,1,irOn,2761,166,4,3,7,57.1%,14m
5942,1,BluRjr,2761,97,4,4,8,50.0%,41m
5942,3,안보이는질주,2761,0,0,1,1,0.0%,20m
5946,2,YOU,2760,1417,243,251,494,49.2%,5m
5946,2,water,2760,698,25,32,57,43.9%,46m
5946,1,xdddddddd,2760,538,22,20,42,52.4%,45m
5946,3,저정말못해요죄송,2760,228,9,7,16,56.2%,48m
5946,3,회장님,2760,196,8,6,14,57.1%,48m
5946,3,ogsMC,2760,30,1,1,2,50.0%,48m
5946,2,Apdo,2760,0,1,1,2,50.0%,22m
5953,1,EvaGreen,2759,846,33,34,67,49.3%,44m
5953,2,[베스핀가스]peterpark,2759,542,20,22,42,47.6%,48m
5953,3,소크리더,2759,216,8,7,15,53.3%,42m
5953,3,[승하호두]맹독충승하,2759,118,4,4,8,50.0%,48m
5953,1,CloudMaker,2759,117,3,1,4,75.0%,14m
5953,3,kumo,2759,97,3,4,7,42.9%,21m
5953,1,[Rovic]Revolverlady,2759,97,2,1,3,66.7%,42m
5953,3,도라지탕,2759,0,2,3,5,40.0%,48m
5953,3,전기코,2759,0,1,0,1,100.0%,42m
5953,2,[PartyZ]IIIIIIIIIIII,2759,30,1,6,7,14.3%,48m
5953,3,[러브라이브]MakiRinPana,2759,0,0,1,1,0.0%,20m
5953,3,쿠쿠루쿠쿠,2759,0,0,5,5,0.0%,16m
5965,1,니팬티보일라,2758,1472,87,89,176,49.4%,46m
5965,2,나만의롱보우,2758,206,8,9,17,47.1%,46m
5965,3,[스카이파이터]멍츄,2758,176,6,6,12,50.0%,48m
5965,2,KunfuPanda,2758,121,3,3,6,50.0%,22m
5965,1,JasonGhang,2758,0,2,3,5,40.0%,19m
5965,3,해병,2758,0,1,0,1,100.0%,42m
5965,3,blood,2758,0,1,0,1,100.0%,48m
5965,3,StephenChou,2758,0,0,1,1,0.0%,16m
5973,2,열혈남아,2757,526,24,21,45,53.3%,47m
5973,1,Ashen,2757,30,2,0,2,100.0%,14m
5973,3,꽃등심,2757,58,2,2,4,50.0%,48m
5976,2,李瑋,2756,440,19,17,36,52.8%,48m
5976,1,Aziz,2756,530,18,23,41,43.9%,46m
5976,3,탈옥수흑형,2756,200,10,14,24,41.7%,12m
5976,3,Eurasian,2756,218,6,5,11,54.5%,48m
5976,3,Mixup,2756,179,5,9,14,35.7%,36m
5976,3,[동양]ryuk,2756,94,2,1,3,66.7%,43m
5976,1,Pakmen,2756,0,0,1,1,0.0%,16m
5983,3,[징징갓]장징징이,2755,399,16,13,29,55.2%,16m
5983,1,ANGELGO,2755,48,4,3,7,57.1%,19m
5983,2,PULSE,2755,92,3,9,12,25.0%,47m
5983,3,fastbreak,2755,0,2,3,5,40.0%,16m
5987,1,Crazy,2754,374,11,22,33,33.3%,44m
5987,3,뿡뿡이,2754,152,5,5,10,50.0%,48m
5987,1,[Eire]KTStats,2754,48,4,3,7,57.1%,18m
5987,2,니똥,2754,149,4,6,10,40.0%,46m
5987,3,[식구파]tauran,2754,30,1,3,4,25.0%,16m
5992,2,myo,2753,872,31,37,68,45.6%,47m
5992,1,ChanTiPo,2753,356,13,14,27,48.1%,44m
5992,3,強投豪打陽耀勳,2753,318,12,9,21,57.1%,16m
5992,3,二小,2753,0,0,2,2,0.0%,42m
5996,2,sosuke,2752,738,28,28,56,50.0%,47m
5996,3,ARKSMI,2752,342,21,19,40,52.5%,48m
5996,3,케리건언니,2752,164,6,5,11,54.5%,48m
5996,2,게릴라버드,2752,114,5,4,9,55.6%,43m
5996,1,꼴초마린,2752,48,2,1,3,66.7%,19m
5996,1,[물고기왕국]물고기왕,2752,0,2,3,5,40.0%,18m
6002,3,[ZUZU]斯文猛男,2751,202,8,7,15,53.3%,16m
6002,2,ems,2751,120,6,3,9,66.7%,43m
6002,3,joosj,2751,114,5,2,7,71.4%,43m
6002,3,진정왕자,2751,115,4,3,7,57.1%,16m
6002,3,저그왕,2751,126,4,3,7,57.1%,16m
6002,1,飄飄影,2751,0,1,0,1,100.0%,14m
6002,3,[우린이겨]SEVENTEEN,2751,0,0,1,1,0.0%,16m
6009,2,[TSDeu]smile,2750,1348,58,58,116,50.0%,48m
6009,2,GanANe,2750,407,43,39,82,52.4%,47m
6009,1,제갈량,2750,252,7,13,20,35.0%,45m
6009,1,NiMHaKIN,2750,145,3,1,4,75.0%,18m
6009,3,草莓哥哥,2750,0,3,2,5,60.0%,16m
6014,1,wjdtjsals,2749,1581,81,76,157,51.6%,46m
6014,3,구르는천둥,2749,392,15,15,30,50.0%,16m
6014,3,채운나라공주,2749,310,12,11,23,52.2%,48m
6014,3,FinalMVP,2749,213,7,6,13,53.8%,20m
6014,1,Borlatsky,2749,168,4,5,9,44.4%,19m
6019,3,루피,2748,1467,104,88,192,54.2%,48m
6019,2,ruler,2748,692,25,31,56,44.6%,43m
6019,1,헐대박,2748,426,14,21,35,40.0%,44m
6019,3,呆鼻,2748,220,8,6,14,57.1%,20m
6019,3,렝겜,2748,30,1,3,4,25.0%,21m
6024,2,HwaYuiri,2747,158,6,8,14,42.9%,14m
6024,2,[ANGG]Geologist,2747,144,6,10,16,37.5%,21m
6024,3,WizzleLi,2747,98,4,2,6,66.7%,48m
6024,3,산타마리야,2747,118,4,3,7,57.1%,48m
6024,3,Brakden,2747,0,0,1,1,0.0%,43m
6024,3,리베,2747,0,0,2,2,0.0%,48m
6030,2,올킬게이머,2746,760,28,28,56,50.0%,47m
6030,2,ken,2746,268,16,21,37,43.2%,47m
6030,3,Virkaholic,2746,178,6,7,13,46.2%,21m
6030,3,짜증나는사람,2746,0,1,0,1,100.0%,43m
6030,2,별여름,2746,0,0,2,2,0.0%,43m
6030,3,NotAvailable,2746,0,0,2,2,0.0%,48m
6036,3,Bisu,2745,0,0,1,1,0.0%,16m
6037,2,DEMON,2744,1357,60,49,109,55.0%,43m
6037,2,doesnotexist,2744,376,13,17,30,43.3%,47m
6037,3,[Worm]빠따이,2744,200,7,6,13,53.8%,16m
6037,2,호모사피엔스,2744,120,6,9,15,40.0%,48m
6037,3,국외산한우,2744,0,3,2,5,60.0%,42m
6037,2,홍쉡,2744,86,3,5,8,37.5%,22m
6037,1,GameOfDrones,2744,94,2,2,4,50.0%,15m
6044,3,SAe,2743,30,2,1,3,66.7%,20m
6045,2,loozhok,2742,600,24,24,48,50.0%,47m
6045,2,누바인칠,2742,575,24,29,53,45.3%,47m
6045,2,김진호,2742,359,15,12,27,55.6%,47m
6045,2,WhySoSerious,2742,214,8,12,20,40.0%,47m
6045,3,나찰,2742,0,1,2,3,33.3%,21m
6045,3,라이너스,2742,0,1,3,4,25.0%,48m
6045,3,잠만보,2742,0,0,1,1,0.0%,48m
6045,3,[해병만뽑음]지금은양학중,2742,0,0,1,1,0.0%,42m
6045,1,빡머가리사령관,2742,0,0,1,1,0.0%,19m
6054,2,CrazyDog,2741,898,37,33,70,52.9%,43m
6054,2,맛있는청국장,2741,435,15,18,33,45.5%,47m
6054,3,MataLife,2741,287,9,6,15,60.0%,16m
6054,3,들이대해자,2741,30,1,2,3,33.3%,16m
6058,2,[무한김준현]Sphinx,2740,1558,88,82,170,51.8%,43m
6058,1,武漢肺炎維尼爽歪,2740,233,9,13,22,40.9%,15m
6058,1,SKY,2740,96,4,4,8,50.0%,19m
6061,1,Cobain,2739,1581,130,112,242,53.7%,46m
6061,3,BeauTiCian,2739,1404,76,83,159,47.8%,5m
6061,3,임요한,2739,273,13,14,27,48.1%,16m
6061,2,rockid,2739,140,5,5,10,50.0%,47m
6061,3,我是新手,2739,32,2,1,3,66.7%,21m
6061,1,Azazel,2739,0,2,3,5,40.0%,19m
6061,3,LoSicA,2739,0,1,0,1,100.0%,16m
6068,2,[TMR]可布,2738,1136,81,72,153,52.9%,47m
6068,2,세트,2738,364,12,9,21,57.1%,22m
6068,3,ZeusBandit,2738,95,3,3,6,50.0%,42m
6068,3,포르쉐,2738,131,3,8,11,27.3%,20m
6068,3,[딱대]HappyNaru,2738,0,1,0,1,100.0%,16m
6073,1,llllllllllll,2737,1202,526,515,1041,50.5%,44m
6073,3,[조직]skywalker,2737,330,13,10,23,56.5%,48m
6073,3,[Miku39]微風,2737,147,3,4,7,42.9%,42m
6073,3,Endless,2737,30,1,3,4,25.0%,16m
6073,3,Katsu,2737,0,0,1,1,0.0%,48m
6078,1,금빛강자,2736,1597,132,117,249,53.0%,45m
6078,3,맛좋은뮬,2736,416,16,16,32,50.0%,42m
6078,2,혁명군,2736,197,8,9,17,47.1%,47m
6078,3,바이톤가자간,2736,144,4,0,4,100.0%,48m
6078,3,[SPTS]Leanne,2736,116,2,2,4,50.0%,48m
6078,1,EIFILI,2736,95,1,2,3,33.3%,15m
6078,3,울트라리스크,2736,0,0,1,1,0.0%,16m
6078,3,Marinesnow,2736,0,0,2,2,0.0%,48m
6086,1,계몽군주정은킴,2735,1482,96,108,204,47.1%,44m
6086,3,조꼬삼,2735,1249,55,40,95,57.9%,16m
6086,3,[지뢰성애자]청정수,2735,114,5,3,8,62.5%,16m
6086,3,Loompa,2735,121,4,4,8,50.0%,20m
6086,2,llllllllllll,2735,0,1,4,5,20.0%,43m
6091,3,ALADIN,2734,163,6,12,18,33.3%,13m
6091,3,[암레기]저글링과친구들,2734,140,5,7,12,41.7%,42m
6091,2,김대환,2734,91,2,2,4,50.0%,47m
6094,1,도장,2733,835,99,87,186,53.2%,46m
6094,1,ttasfa,2733,1014,60,60,120,50.0%,45m
6094,2,개뼈,2733,821,31,31,62,50.0%,43m
6094,2,[근본은말보루]주태양,2733,58,4,7,11,36.4%,47m
6094,1,SChunter,2733,30,2,5,7,28.6%,44m
6094,3,cocoro,2733,0,0,1,1,0.0%,16m
6094,3,Simian,2733,0,0,3,3,0.0%,16m
6101,3,일대일갓겜,2732,976,73,61,134,54.5%,48m
6101,1,헐랭방구,2732,640,67,70,137,48.9%,46m
6101,3,[리녹신추종자]로이조,2732,301,11,7,18,61.1%,48m
6101,1,[넌우모난울트]내옆자리첫신우모,2732,0,2,3,5,40.0%,19m
6101,3,BloodMarin,2732,60,2,5,7,28.6%,48m
6101,1,[SKRFAN]阴间神族必胜,2732,97,1,1,2,50.0%,42m
6107,2,욕정돼지,2731,1470,66,64,130,50.8%,47m
6107,3,IIIIIIIIII,2731,538,23,12,35,65.7%,48m
6107,1,略懂,2731,307,13,22,35,37.1%,46m
6107,3,新手路過,2731,292,11,12,23,47.8%,48m
6107,3,명란젖젖,2731,88,3,5,8,37.5%,16m
6107,1,별다방에이스,2731,145,2,1,3,66.7%,19m
6113,3,바다,2730,238,9,10,19,47.4%,48m
6113,3,Harry,2730,157,6,6,12,50.0%,20m
6113,1,하앤미,2730,110,6,7,13,46.2%,44m
6113,2,Crimson,2730,140,5,6,11,45.5%,47m
6113,3,danny,2730,0,4,1,5,80.0%,42m
6113,1,BaumKuchen,2730,97,3,3,6,50.0%,19m
6113,3,오메,2730,58,2,4,6,33.3%,48m
6113,3,난정해인이좋아,2730,0,1,3,4,25.0%,48m
6113,3,ryan,2730,0,0,1,1,0.0%,48m
6122,1,llllllllllll,2729,1541,122,131,253,48.2%,43m
6122,2,우주함선,2729,893,38,36,74,51.4%,47m
6122,3,Raldduggi,2729,391,19,7,26,73.1%,43m
6122,1,손주호,2729,163,8,10,18,44.4%,16m
6122,2,[RAID]강승부현이,2729,190,6,14,20,30.0%,47m
6122,1,존잘남재민,2729,0,3,3,6,50.0%,19m
6122,1,[aFake]Maru,2729,145,2,1,3,66.7%,18m
6122,3,WarComplete,2729,60,2,2,4,50.0%,16m
6122,3,[諸葛世家]Karas,2729,0,1,0,1,100.0%,48m
6122,3,Bryan,2729,0,1,2,3,33.3%,16m
6122,3,[Epic7]수원특산물구승모,2729,0,0,1,1,0.0%,16m
6133,2,HeaL,2728,625,41,42,83,49.4%,47m
6133,3,호로록,2728,146,6,3,9,66.7%,48m
6133,1,[국가정보원]AsiValeri,2728,48,4,4,8,50.0%,18m
6133,2,Dark,2728,60,2,11,13,15.4%,47m
6133,3,sjw,2728,0,0,1,1,0.0%,42m
6138,3,StarCore,2727,758,31,22,53,58.5%,16m
6138,3,JeeMoW,2727,465,22,11,33,66.7%,48m
6138,3,소나기,2727,114,4,5,9,44.4%,48m
6138,2,[LezLox]MrLez,2727,0,3,2,5,60.0%,43m
6138,3,WhiteCrafter,2727,0,2,3,5,40.0%,16m
6138,3,lovely,2727,30,1,3,4,25.0%,16m
6144,3,Leviathan,2726,1561,82,75,157,52.2%,42m
6144,1,마한판붙어보자마,2726,96,2,2,4,50.0%,19m
6144,3,박승찬사랑해,2726,60,2,5,7,28.6%,48m
6144,3,불타는흑염룡,2726,0,1,0,1,100.0%,48m
6144,3,primeyang,2726,0,0,4,4,0.0%,48m
6149,2,징어잘생김,2725,1227,58,60,118,49.2%,47m
6149,1,agileahn,2725,210,9,9,18,50.0%,15m
6149,3,水立杰,2725,0,1,1,2,50.0%,48m
6149,3,llllllllllll,2725,0,0,2,2,0.0%,43m
6153,3,riothed,2724,974,43,41,84,51.2%,48m
6153,2,keepthepace,2724,797,39,34,73,53.4%,47m
6153,2,闇焰風暴,2724,168,7,7,14,50.0%,43m
6153,1,톨스토이,2724,0,3,2,5,60.0%,19m
6153,1,[SKTT2]lIlIlIllllII,2724,145,2,1,3,66.7%,19m
6153,3,[랜타디개초보]암교,2724,0,1,1,2,50.0%,48m
6153,1,llllllllllll,2724,0,1,4,5,20.0%,19m
6153,2,dsafdfasasdf,2724,0,0,1,1,0.0%,22m
6153,3,풀발귀,2724,0,0,2,2,0.0%,43m
6162,2,Trance,2723,998,42,44,86,48.8%,47m
6162,2,WhoKid,2723,593,23,26,49,46.9%,48m
6162,1,아쿠리스포리토,2723,165,4,12,16,25.0%,46m
6162,2,吸血夜魔,2723,82,3,3,6,50.0%,22m
6162,3,Player,2723,0,2,3,5,40.0%,42m
6162,3,백곰돌,2723,0,1,2,3,33.3%,48m
6168,3,durdell,2722,1419,367,340,707,51.9%,2m
6168,2,riun,2722,712,26,31,57,45.6%,43m
6168,3,夢之雪,2722,145,4,1,5,80.0%,16m
6168,3,[철기클랜]교상한,2722,80,3,11,14,21.4%,20m
6168,2,우우끼끼,2722,42,1,3,4,25.0%,22m
6168,3,[부관교]망하겠군요,2722,0,0,1,1,0.0%,16m
6174,2,NavyFox,2721,763,31,27,58,53.4%,47m
6174,3,저글링,2721,347,14,13,27,51.9%,48m
6174,3,llllllllll,2721,302,13,14,27,48.1%,48m
6174,2,김치제국,2721,186,7,8,15,46.7%,43m
6178,2,제라툴,2720,473,18,18,36,50.0%,43m
6178,3,YUEYUE,2720,0,2,3,5,40.0%,48m
6178,3,[너의ol름은]TJRTMD,2720,0,0,1,1,0.0%,42m
6181,3,[경기도민]ToeicMaster,2719,305,14,12,26,53.8%,48m
6181,2,AriASouL,2719,283,12,18,30,40.0%,48m
6181,3,[教我玩蟲族吧]Gama,2719,30,2,0,2,100.0%,48m
6181,3,[팡캐월령전]hunter,2719,32,2,1,3,66.7%,21m
6181,3,武汉加油中国加油,2719,0,1,1,2,50.0%,16m
6181,2,[LQV]케리건,2719,0,1,2,3,33.3%,47m
6181,3,goco,2719,0,1,2,3,33.3%,16m
6181,3,DIDI,2719,0,0,7,7,0.0%,16m
6189,3,솔낭,2718,1464,137,126,263,52.1%,48m
6189,2,夜行者,2718,249,29,19,48,60.4%,47m
6189,3,준강,2718,488,20,20,40,50.0%,16m
6189,2,科學超電磁砲,2718,434,17,20,37,45.9%,43m
6189,1,선캄브리아시대,2718,0,4,6,10,40.0%,18m
6189,3,wybyeon,2718,0,3,2,5,60.0%,42m
6189,3,[SofT]Delight,2718,90,3,6,9,33.3%,48m
6189,1,상디,2718,0,2,3,5,40.0%,19m
6197,2,Rain,2717,88,4,7,11,36.4%,47m
6197,3,RDo,2717,78,3,5,8,37.5%,21m
6197,3,[llst짱짱]맹수찌순,2717,0,0,2,2,0.0%,16m
6197,3,레이너특공대,2717,0,0,3,3,0.0%,48m
6201,2,[SofT]김가을,2716,176,6,11,17,35.3%,47m
6201,3,[전투]흰우유,2716,114,5,4,9,55.6%,43m
6201,3,ppgd,2716,58,2,4,6,33.3%,16m
6201,3,Sasha,2716,0,2,4,6,33.3%,42m
6205,3,숏다리해병,2715,30,1,1,2,50.0%,48m
6206,1,케리건의눈물,2714,1315,138,131,269,51.3%,46m
6206,2,Wrath,2714,167,7,10,17,41.2%,47m
6206,3,mercywolf,2714,163,5,2,7,71.4%,16m
6206,3,수리수리마하수리,2714,121,3,1,4,75.0%,20m
6206,2,caffeine,2714,0,1,4,5,20.0%,48m
6211,2,로베르토우진,2713,381,32,24,56,57.1%,47m
6211,2,crispymm,2713,298,20,21,41,48.8%,47m
6211,3,Ace,2713,94,2,0,2,100.0%,43m
6214,2,[705666]白奶油,2712,253,8,10,18,44.4%,43m
6214,3,팽민우,2712,0,0,1,1,0.0%,20m
6214,3,[Equal]FunnyGames,2712,0,0,1,1,0.0%,42m
6217,2,저그,2711,1214,71,59,130,54.6%,43m
6217,3,[시나공]윤후바라기,2711,1130,55,58,113,48.7%,3m
6217,1,icebin,2711,772,31,34,65,47.7%,43m
6217,3,Xavi,2711,278,10,13,23,43.5%,16m
6217,3,[C89923]MrTrump,2711,169,5,2,7,71.4%,48m
6217,2,개병이,2711,30,4,4,8,50.0%,47m
6223,2,Submarin,2710,1418,60,55,115,52.2%,43m
6223,3,엘리온,2710,364,13,14,27,48.1%,42m
6223,2,김정은,2710,234,8,9,17,47.1%,43m
6223,2,그거해,2710,95,5,6,11,45.5%,22m
6223,3,[DoBTeN]Yee,2710,0,0,1,1,0.0%,48m
6228,1,Shion,2709,170,44,44,88,50.0%,46m
6228,3,나허가,2709,599,27,24,51,52.9%,48m
6228,2,EpicMayo,2709,174,5,8,13,38.5%,23m
6228,3,broukmoute,2709,176,4,6,10,40.0%,16m
6228,3,Everton,2709,30,2,0,2,100.0%,16m
6228,1,트닉,2709,0,2,3,5,40.0%,19m
6228,3,KNIGHT,2709,40,1,5,6,16.7%,20m
6228,2,[長榮星海幫]吳豪豬,2709,30,1,11,12,8.3%,47m
6236,2,Temu,2708,1518,83,78,161,51.6%,43m
6236,2,suber,2708,401,18,16,34,52.9%,47m
6236,3,Squid,2708,177,5,2,7,71.4%,48m
6236,3,slamdunk,2708,86,3,3,6,50.0%,48m
6236,3,ManongJed,2708,0,0,1,1,0.0%,16m
6241,3,Skullz,2707,338,15,8,23,65.2%,43m
6241,3,수원고구마,2707,210,7,4,11,63.6%,43m
6241,3,Lotus,2707,148,6,3,9,66.7%,48m
6241,1,이경란넌내꺼,2707,114,2,3,5,40.0%,15m
6241,3,bangty,2707,95,1,1,2,50.0%,48m
6241,3,원고지,2707,0,0,3,3,0.0%,48m
6247,3,시진핑의스타일기,2706,388,15,7,22,68.2%,42m
6247,3,kial,2706,277,11,12,23,47.8%,16m
6247,2,IIIIHHIIII,2706,186,7,12,19,36.8%,47m
6247,1,우유라닛,2706,121,4,2,6,66.7%,19m
6247,3,토키사키쿠루미,2706,30,2,2,4,50.0%,48m
6247,1,CloseYou,2706,0,1,0,1,100.0%,19m
6247,3,국민척탄병,2706,0,1,0,1,100.0%,48m
6254,3,밀키스,2705,793,30,27,57,52.6%,43m
6254,3,[육풍함]IllIIIllIllI,2705,399,16,6,22,72.7%,16m
6254,3,soNg,2705,378,13,25,38,34.2%,3m
6254,3,parkmos,2705,30,2,1,3,66.7%,16m
6254,1,chicken,2705,0,2,3,5,40.0%,19m
6254,3,lllIllIIlIll,2705,0,0,2,2,0.0%,48m
6260,3,ducksu,2704,150,5,9,14,35.7%,48m
6260,3,공포의쓴맛,2704,92,3,5,8,37.5%,48m
6260,3,[strong]Tomsee,2704,62,2,5,7,28.6%,42m
6263,1,스창인생,2703,741,26,34,60,43.3%,44m
6263,2,TNSmile,2703,572,20,20,40,50.0%,47m
6263,2,서점주인장,2703,586,20,28,48,41.7%,47m
6263,3,여긴어디나는누구,2703,444,16,17,33,48.5%,16m
6263,3,June,2703,154,5,8,13,38.5%,48m
6263,3,Prey,2703,0,2,3,5,40.0%,43m
6269,2,KNH,2702,1448,95,90,185,51.4%,48m
6269,3,[국방부사서병]마린,2702,139,3,1,4,75.0%,16m
6269,3,IZONE,2702,103,3,2,5,60.0%,21m
6269,3,Zephty,2702,30,2,5,7,28.6%,48m
6273,2,NaOPKRnoob,2701,1073,75,68,143,52.4%,47m
6273,3,yametekudasa,2701,358,14,22,36,38.9%,17m
6273,2,MoJJI,2701,272,10,10,20,50.0%,43m
6273,3,jkcove,2701,146,7,3,10,70.0%,20m
6273,1,[CHOSUN]soohana,2701,213,5,5,10,50.0%,18m
6273,3,허리케인비너스,2701,125,4,5,9,44.4%,16m
6273,2,애구봉봉,2701,0,3,4,7,42.9%,47m
6273,3,Arcane,2701,0,1,0,1,100.0%,48m
6273,1,BanCoalNow,2701,0,1,2,3,33.3%,19m
6273,3,[브리티안2군]벽돌에이지,2701,0,0,1,1,0.0%,48m
6273,1,Rain,2701,0,0,1,1,0.0%,19m
6284,2,pathway,2700,1226,168,160,328,51.2%,48m
6284,3,JDlove,2700,1229,52,37,89,58.4%,17m
6284,2,[AFO]칠만육천원,2700,1268,48,49,97,49.5%,47m
6284,2,Eric,2700,86,3,14,17,17.6%,47m
6284,1,PyWind,2700,30,2,2,4,50.0%,44m
6284,1,QsmileQ,2700,0,1,4,5,20.0%,18m
6290,3,외부입력,2699,1133,52,45,97,53.6%,42m
6290,2,Sca,2699,640,32,25,57,56.1%,47m
6290,2,sAviOr,2699,683,28,29,57,49.1%,47m
6290,3,Aurora,2699,646,23,21,44,52.3%,48m
6290,3,已完成,2699,326,14,6,20,70.0%,42m
6290,3,lllIIIlllIII,2699,191,5,4,9,55.6%,16m
6290,3,김저그,2699,97,4,5,9,44.4%,21m
6290,3,IIIIIIIIIIII,2699,0,1,1,2,50.0%,16m
6290,3,YouRang,2699,0,0,1,1,0.0%,43m
6299,2,yellowstorm,2698,1323,72,74,146,49.3%,48m
6299,3,공륙이,2698,1085,46,38,84,54.8%,48m
6299,1,SKTiloveoov,2698,255,10,13,23,43.5%,15m
6299,3,[누후훗]이승,2698,90,3,4,7,42.9%,48m
6299,3,마닐라바,2698,0,1,1,2,50.0%,36m
6304,3,Newbie,2697,322,36,30,66,54.5%,48m
6304,2,Vulcan,2697,587,22,21,43,51.2%,47m
6304,2,남바원줠그,2697,150,6,5,11,54.5%,43m
6304,3,bensw,2697,136,4,0,4,100.0%,48m
6304,1,Master,2697,48,2,1,3,66.7%,18m
6304,3,OpTiMusPrime,2697,58,2,4,6,33.3%,16m
6304,3,무등산꽃뱀,2697,0,1,2,3,33.3%,48m
6304,2,바코드,2697,0,0,2,2,0.0%,14m
6304,2,Ake,2697,0,0,2,2,0.0%,22m
6313,1,Ghostshadow,2696,1516,204,201,405,50.4%,46m
6313,3,才才,2696,209,7,9,16,43.8%,20m
6313,3,고냥이,2696,172,5,7,12,41.7%,20m
6313,3,阿猩,2696,116,2,1,3,66.7%,48m
6313,1,태풍민,2696,0,0,1,1,0.0%,19m
6318,3,wnteoaos,2695,1516,133,112,245,54.3%,16m
6318,1,시간을달려서,2695,480,13,28,41,31.7%,46m
6318,1,Random,2695,330,12,13,25,48.0%,45m
6318,3,dlehgns,2695,170,4,5,9,44.4%,48m
6318,3,Adam,2695,119,3,1,4,75.0%,42m
6318,3,IIIIIIIIIIII,2695,114,2,2,4,50.0%,42m
6318,3,ERI,2695,0,1,1,2,50.0%,48m
6325,3,[통수]어둠의지배자,2694,191,5,8,13,38.5%,43m
6325,3,Jang,2694,145,4,4,8,50.0%,20m
6325,2,dfdfd,2694,0,3,4,7,42.9%,47m
6325,1,JOYDIVISION,2694,0,2,3,5,40.0%,19m
6325,1,[데네브]긔러긔,2694,0,0,5,5,0.0%,19m
6330,3,Mango,2693,164,7,9,16,43.8%,21m
6330,2,노바,2693,30,2,2,4,50.0%,43m
6330,3,Top,2693,30,1,3,4,25.0%,16m
6330,3,GoAsRuY,2693,0,0,1,1,0.0%,16m
6334,2,DAMES,2692,412,15,22,37,40.5%,48m
6334,2,DOMINATOR,2692,248,7,8,15,46.7%,22m
6334,3,zxelpha,2692,119,4,4,8,50.0%,43m
6334,3,LunaTicDream,2692,0,3,3,6,50.0%,16m
6334,2,뉴비,2692,48,2,3,5,40.0%,22m
6334,2,Dante,2692,0,1,0,1,100.0%,22m
6340,3,짱개는패는개맛,2691,422,14,12,26,53.8%,48m
6340,3,그림자용,2691,122,4,5,9,44.4%,43m
6340,3,UnitTosh,2691,0,2,3,5,40.0%,43m
6340,3,OutLINE,2691,0,1,0,1,100.0%,16m
6340,3,다그바,2691,0,1,1,2,50.0%,43m
6340,1,superman,2691,0,0,2,2,0.0%,20m
6346,3,saminem,2690,187,6,7,13,46.2%,20m
6346,3,凹凹凸凸的光,2690,30,2,3,5,40.0%,48m
6346,3,암내,2690,30,1,2,3,33.3%,16m
6346,3,이삽살,2690,0,0,1,1,0.0%,48m
6350,2,LuKaModriC,2689,206,7,15,22,31.8%,47m
6350,3,鄭珉制,2689,30,1,3,4,25.0%,43m
6350,3,Dddooooing,2689,0,0,1,1,0.0%,20m
6353,3,SAM,2688,1377,63,55,118,53.4%,43m
6353,3,BigDaddy,2688,321,14,1,15,93.3%,43m
6353,3,[유진아사랑해]마루그슬핵개오짐,2688,186,6,0,6,100.0%,42m
6353,1,인하아리스타,2688,48,3,3,6,50.0%,19m
6353,1,sparkster,2688,48,2,0,2,100.0%,20m
6353,3,옥종승,2688,0,2,3,5,40.0%,43m
6353,3,[Play1]毒蟲,2688,0,0,1,1,0.0%,36m
6360,3,maiyan,2687,1495,76,90,166,45.8%,6m
6360,3,[영남도우회]영남식육식당,2687,279,12,2,14,85.7%,43m
6360,1,Anastasia,2687,258,8,20,28,28.6%,46m
6360,1,Reg,2687,215,5,5,10,50.0%,19m
6360,3,ACoNaTic,2687,0,2,3,5,40.0%,43m
6360,3,VIP,2687,96,1,1,2,50.0%,43m
6360,3,MorrosDark,2687,0,0,1,1,0.0%,16m
6360,1,공명,2687,0,0,5,5,0.0%,18m
6368,3,ezidan,2686,704,25,21,46,54.3%,16m
6369,2,아기공룡틀니,2685,180,6,14,20,30.0%,47m
6369,3,泰瑞,2685,110,4,3,7,57.1%,43m
6369,1,Clock,2685,97,3,3,6,50.0%,19m
6369,3,[IIIl]IlIlIlIlIlIl,2685,0,1,0,1,100.0%,48m
6373,2,천상왕,2684,1439,100,104,204,49.0%,47m
6373,3,stargraft,2684,154,4,3,7,57.1%,21m
6373,3,전문가,2684,30,1,2,3,33.3%,17m
6373,2,NoMads,2684,0,0,1,1,0.0%,22m
6377,2,철님,2683,1493,1080,1063,2143,50.4%,5m
6377,3,IlllllIIIIII,2683,1219,60,47,107,56.1%,43m
6377,2,[국가정보원]kldsjflkjaw,2683,435,17,16,33,51.5%,47m
6377,3,Zilch,2683,395,15,12,27,55.6%,16m
6377,3,LuckyCat,2683,170,6,3,9,66.7%,48m
6377,3,[기니피그]소년시대,2683,90,4,3,7,57.1%,48m
6377,3,십육호,2683,30,4,4,8,50.0%,48m
6384,3,BRAT,2682,318,60,52,112,53.6%,48m
6384,1,눈누난나,2682,265,12,11,23,52.2%,44m
6384,3,자연산민물장어,2682,0,2,3,5,40.0%,42m
6387,2,김밥이,2681,1167,76,77,153,49.7%,48m
6387,3,파란템플러,2681,444,18,9,27,66.7%,17m
6387,3,니가뭔데,2681,411,15,11,26,57.7%,16m
6387,3,MoarDeat,2681,0,0,2,2,0.0%,43m
6391,3,곰알바,2680,219,6,4,10,60.0%,21m
6391,3,개찐,2680,142,3,3,6,50.0%,48m
6391,3,나랑드사이다,2680,0,1,0,1,100.0%,17m
6391,3,안녕하세요,2680,0,0,2,2,0.0%,43m
6395,2,LOVE,2679,1549,125,119,244,51.2%,47m
6395,1,남자,2679,125,5,7,12,41.7%,44m
6395,2,소소소파라,2679,142,4,5,9,44.4%,47m
6395,3,닭크템플라,2679,0,0,2,2,0.0%,43m
6399,2,코로나종식기원,2678,1565,97,92,189,51.3%,43m
6399,1,[ZZQFAN]Domennico,2678,1294,39,32,71,54.9%,15m
6399,3,ellea,2678,524,19,25,44,43.2%,17m
6399,2,[두피용면도기]아가,2678,305,12,13,25,48.0%,47m
6399,3,新手玩家好爽,2678,146,5,7,12,41.7%,16m
6399,3,일진바이러스,2678,58,3,2,5,60.0%,43m
6399,1,Jacy,2678,44,2,5,7,28.6%,15m
6406,3,backgh,2677,940,37,32,69,53.6%,48m
6406,2,withon,2677,496,26,32,58,44.8%,47m
6406,3,혁제짬냄새,2677,332,14,5,19,73.7%,48m
6406,3,Marco,2677,390,13,18,31,41.9%,16m
6406,3,ThomBrowne,2677,0,2,4,6,33.3%,43m
6406,1,ToRi,2677,0,0,1,1,0.0%,14m
6406,3,[TheTop]AppNori,2677,0,0,2,2,0.0%,48m
6413,1,변돌군,2676,537,20,26,46,43.5%,46m
6413,3,이시국,2676,264,9,13,22,40.9%,48m
6413,1,[DagmBa]아레스,2676,44,1,2,3,33.3%,16m
6413,3,fams,2676,30,1,3,4,25.0%,17m
6413,1,카이엔,2676,0,0,1,1,0.0%,15m
6413,1,[애니멀킹덤]햄순이,2676,0,0,1,1,0.0%,15m
6413,1,[망겜장인]셀렌디스,2676,0,0,1,1,0.0%,19m
6413,3,FrayD,2676,0,0,2,2,0.0%,16m
6421,2,완소훈남융지,2675,389,15,18,33,45.5%,43m
6421,2,정발산,2675,196,9,10,19,47.4%,43m
6423,1,바삭한치킨,2674,97,3,3,6,50.0%,18m
6423,2,[군주]dksrhkdaj,2674,30,2,9,11,18.2%,47m
6423,1,나한국인,2674,0,0,2,2,0.0%,19m
6426,1,lIIlIIIIIlll,2673,1404,51,58,109,46.8%,44m
6426,2,[SofT]SKTFaker,2673,339,14,12,26,53.8%,47m
6426,3,양손흥민,2673,291,13,18,31,41.9%,13m
6426,1,lyjuven,2673,0,2,3,5,40.0%,16m
6430,3,kpjian,2672,399,22,21,43,51.2%,17m
6430,2,죽눈다,2672,534,20,27,47,42.6%,47m
6432,3,스피릿,2671,408,16,14,30,53.3%,48m
6432,1,[LGHS]BTOChurros,2671,118,7,9,16,43.8%,44m
6432,3,[好想贏韓國]AKA,2671,96,1,2,3,33.3%,48m
6432,1,Chiaki,2671,0,0,1,1,0.0%,14m
6432,3,[벽린이]화양연화,2671,0,0,2,2,0.0%,17m
6437,3,PeNiZHiT,2670,858,66,59,125,52.8%,17m
6437,3,별의기원을찾아서,2670,661,29,23,52,55.8%,43m
6437,2,ltuhjl,2670,414,19,17,36,52.8%,43m
6437,3,GGOSinon,2670,414,15,12,27,55.6%,48m
6437,3,ZingyFAN,2670,121,3,3,6,50.0%,21m
6437,2,군급,2670,0,3,3,6,50.0%,43m
6437,1,뉘이이,2670,48,3,3,6,50.0%,42m
6437,1,Darwin,2670,48,3,4,7,42.9%,19m
6437,1,불타는데하카,2670,48,2,1,3,66.7%,18m
6437,1,NwTRA,2670,0,2,3,5,40.0%,42m
6437,1,空空攏咚咚,2670,0,0,1,1,0.0%,14m
6448,2,[GGROCK]故事,2669,548,19,26,45,42.2%,47m
6448,2,기타소,2669,296,10,9,19,52.6%,22m
6448,3,fzqll,2669,97,4,5,9,44.4%,20m
6448,3,JKTH,2669,60,2,5,7,28.6%,48m
6448,3,PostGrad,2669,0,0,2,2,0.0%,20m
6453,3,Oink,2668,502,19,14,33,57.6%,16m
6453,3,sosolazy,2668,316,12,13,25,48.0%,48m
6453,2,raihalo,2668,272,10,9,19,52.6%,22m
6453,3,적돌,2668,248,8,8,16,50.0%,20m
6453,3,쓸어담기주부,2668,215,7,4,11,63.6%,48m
6453,1,DeLivershot,2668,0,2,3,5,40.0%,15m
6453,1,still,2668,0,1,0,1,100.0%,18m
6460,3,MikJho,2667,520,50,43,93,53.8%,16m
6460,2,fordds,2667,204,9,12,21,42.9%,47m
6460,1,llllllllllll,2667,126,4,1,5,80.0%,14m
6460,3,NarrowGate,2667,112,4,5,9,44.4%,48m
6460,3,김아인,2667,0,1,0,1,100.0%,20m
6460,1,단무지,2667,0,1,1,2,50.0%,15m
6460,2,쿠큐데대,2667,0,0,7,7,0.0%,48m
6467,2,홍춘제자선호짱짱,2666,1312,60,64,124,48.4%,12m
6467,3,[ELS]피아노치는공대생,2666,386,15,13,28,53.6%,43m
6467,3,PrOGress,2666,225,6,8,14,42.9%,20m
6470,1,방자한놈,2665,134,4,2,6,66.7%,15m
6470,3,KURA,2665,58,2,4,6,33.3%,16m
6472,1,JetFire,2664,1465,75,84,159,47.2%,46m
6472,3,[ELS]SgtPepper,2664,387,13,11,24,54.2%,16m
6472,3,kijoo,2664,244,8,6,14,57.1%,48m
6472,1,잠수좋아요,2664,0,0,1,1,0.0%,42m
6476,2,[국가정보원]푸스로다,2663,708,30,26,56,53.6%,47m
6476,3,疯狂的哇哇哇,2663,411,15,11,26,57.7%,42m
6476,2,꿈꾸는사람,2663,167,9,16,25,36.0%,48m
6476,3,HuangBH,2663,189,7,8,15,46.7%,43m
6476,3,핸드폰액정수리,2663,0,1,5,6,16.7%,43m
6476,3,[ARCHph]TasbuShorT,2663,0,0,2,2,0.0%,48m
6482,2,허브큐,2662,1560,70,78,148,47.3%,47m
6482,3,arjun,2662,351,34,37,71,47.9%,48m
6482,3,[DIAMOB]로우킥,2662,368,14,11,25,56.0%,48m
6482,3,제주감귤,2662,237,13,13,26,50.0%,16m
6482,1,VicTorYtosS,2662,0,0,1,1,0.0%,19m
6482,1,[머중이]niummada,2662,0,0,1,1,0.0%,19m
6488,2,malhagi,2661,227,7,13,20,35.0%,47m
6488,3,[SClI]고오급히오스,2661,113,3,2,5,60.0%,48m
6488,1,삼등못하면만원,2661,0,3,3,6,50.0%,19m
6488,1,GBM,2661,0,0,1,1,0.0%,42m
6492,3,[krtag]Zergamoto,2660,697,30,20,50,60.0%,16m
6492,2,[7LUCK]르네상스,2660,260,10,10,20,50.0%,22m
6492,3,frogician,2660,90,4,6,10,40.0%,7m
6492,1,TheJangler,2660,123,3,3,6,50.0%,42m
6496,1,소드마스터베이션,2659,121,3,1,4,75.0%,19m
6496,2,[설희러버]눈의희열,2659,0,2,5,7,28.6%,43m
6498,3,欧俊弟,2658,392,62,53,115,53.9%,48m
6498,2,질풍가도,2658,940,33,42,75,44.0%,47m
6498,1,띠로링,2658,169,5,9,14,35.7%,45m
6498,1,이태리수건,2658,0,2,3,5,40.0%,42m
6502,3,Faker,2657,250,18,21,39,46.2%,48m
6502,1,YOYOZergKing,2657,0,2,0,2,100.0%,19m
6502,1,장콘,2657,0,1,0,1,100.0%,19m
6505,2,llllllllllll,2656,1045,45,42,87,51.7%,43m
6505,1,이화유치원,2656,270,7,5,12,58.3%,14m
6505,1,고대수호천사,2656,0,2,1,3,66.7%,42m
6505,1,Ryzen,2656,0,1,0,1,100.0%,19m
6509,3,공따이수,2655,471,21,25,46,45.7%,17m
6509,3,Scenter,2655,0,4,4,8,50.0%,20m
6509,1,Lunaran,2655,82,3,1,4,75.0%,42m
6509,3,sig,2655,97,2,2,4,50.0%,21m
6513,3,GoldenArrow,2654,114,4,9,13,30.8%,48m
6513,1,스타,2654,138,3,4,7,42.9%,42m
6513,3,영감앙,2654,30,1,6,7,14.3%,49m
6516,2,캐르나,2653,396,14,19,33,42.4%,47m
6516,3,로터,2653,256,7,9,16,43.8%,48m
6516,1,파도,2653,128,5,9,14,35.7%,46m
6516,1,Hank,2653,0,2,3,5,40.0%,42m
6516,1,자이가드,2653,0,0,1,1,0.0%,19m
6516,3,zuvie,2653,0,0,2,2,0.0%,17m
6522,2,[문법나치]ZeraTul,2652,1516,177,185,362,48.9%,48m
6522,1,diego,2652,253,8,11,19,42.1%,15m
6522,3,황씨,2652,172,5,5,10,50.0%,48m
6522,3,MIKEJANG,2652,97,3,4,7,42.9%,21m
6522,1,IIIIIIIIIIII,2652,0,1,1,2,50.0%,16m
6522,1,asdfasdf,2652,0,0,1,1,0.0%,14m
6522,1,엘케이,2652,0,0,2,2,0.0%,18m
6522,3,털보,2652,0,0,4,4,0.0%,43m
6530,3,Wynan,2651,88,3,7,10,30.0%,16m
6530,1,블루밍,2651,0,0,6,6,0.0%,20m
6532,3,SEBIN,2650,262,9,6,15,60.0%,49m
6532,1,[플러스울트라]구자카,2650,241,5,5,10,50.0%,19m
6532,2,[머큐리]Trafford,2650,148,3,12,15,20.0%,43m
6535,3,SNOW,2648,703,31,31,62,50.0%,48m
6535,1,Nept,2648,92,2,2,4,50.0%,42m
6535,3,쩐주,2648,0,0,1,1,0.0%,20m
6538,1,Sardinas,2647,1230,41,57,98,41.8%,45m
6538,3,구름달,2647,866,32,31,63,50.8%,48m
6538,2,[oNs7]슈우웅,2647,260,13,15,28,46.4%,43m
6538,1,[건국]해병대,2647,0,2,6,8,25.0%,18m
6538,1,우영짱짱맨,2647,0,1,0,1,100.0%,19m
6538,1,아왜그래돌려줘요,2647,0,1,0,1,100.0%,18m
6538,2,ChaPlaiN,2647,0,1,0,1,100.0%,22m
6545,2,ArFang,2646,1318,51,53,104,49.0%,43m
6545,1,일월팔일,2646,48,5,3,8,62.5%,19m
6547,1,Dutchie,2645,396,12,13,25,48.0%,15m
6547,3,PROBE,2645,0,3,5,8,37.5%,20m
6547,1,schwert,2645,0,2,3,5,40.0%,18m
6547,3,snow,2645,30,1,4,5,20.0%,16m
6551,3,부엉이,2644,580,23,27,50,46.0%,48m
6551,3,NukeOn,2644,180,7,7,14,50.0%,43m
6551,1,최일,2644,30,3,3,6,50.0%,15m
6551,1,layalaya,2644,0,2,3,5,40.0%,19m
6551,1,[C67652]scv,2644,0,0,1,1,0.0%,15m
6556,3,태권,2643,1177,63,56,119,52.9%,48m
6556,3,IIIIII,2643,150,6,9,15,40.0%,49m
6556,1,졸라짱쎈투명드래,2643,0,2,3,5,40.0%,42m
6559,3,AllenHippo,2642,1503,204,203,407,50.1%,43m
6559,3,[064]youevery,2642,356,15,10,25,60.0%,17m
6559,3,자랑충,2642,115,4,3,7,57.1%,21m
6559,1,[Equal]ReyNor,2642,40,2,0,2,100.0%,14m
6559,1,해엄돔,2642,97,1,1,2,50.0%,19m
6564,3,닉정하기어렵네,2641,528,18,25,43,41.9%,43m
6564,3,juuuuuuuuu,2641,0,3,4,7,42.9%,21m
6564,1,Paladin,2641,0,2,1,3,66.7%,42m
6564,2,[리쉬빙]rakjongpal,2641,0,0,1,1,0.0%,23m
6564,1,[WTSC]위리,2641,0,0,2,2,0.0%,14m
6564,3,아놔아나아나아난,2641,0,0,4,4,0.0%,16m
6570,3,난나니,2640,916,37,36,73,50.7%,16m
6570,2,군단을위하여,2640,1094,37,49,86,43.0%,47m
6570,3,차레이져,2640,900,31,39,70,44.3%,16m
6570,2,[엄청잘생긴놈]원파스,2640,203,9,8,17,52.9%,48m
6570,1,[Weast]인공지능,2640,178,5,5,10,50.0%,14m
6570,2,기백남,2640,0,3,5,8,37.5%,43m
6570,2,코토리,2640,114,3,8,11,27.3%,48m
6570,1,aaaaaaaaaaaa,2640,0,1,5,6,16.7%,20m
6578,3,IkeSkywalker,2639,726,31,20,51,60.8%,48m
6578,1,카봇저글링,2639,0,1,0,1,100.0%,20m
6580,3,쫑소리,2638,53,4,6,10,40.0%,48m
6580,3,DistrictDEAD,2638,0,1,2,3,33.3%,21m
6582,1,kingoffking,2637,1510,120,126,246,48.8%,46m
6582,3,WOOF,2637,194,6,5,11,54.5%,49m
6582,3,hanwoolive,2637,0,0,3,3,0.0%,16m
6585,3,[무작]chaoscao,2636,408,13,19,32,40.6%,43m
6585,3,임오플토,2636,296,11,14,25,44.0%,48m
6585,3,LikMijnBalle,2636,145,4,0,4,100.0%,20m
6588,2,randomNAME,2635,244,11,10,21,52.4%,43m
6589,1,[트위치리피아]리피아,2634,365,11,46,57,19.3%,46m
6589,3,StarTyrant,2634,149,7,10,17,41.2%,13m
6591,2,lllIIIllIl,2633,96,3,14,17,17.6%,47m
6591,1,용대장,2633,0,1,0,1,100.0%,18m
6593,1,NIA,2632,719,24,19,43,55.8%,14m
6593,1,yyfyyf,2632,634,19,20,39,48.7%,42m
6593,1,墨染樱,2632,311,7,10,17,41.2%,14m
6593,1,[요사키클랜]사이오닉스톰,2632,86,3,1,4,75.0%,15m
6593,1,[BRIGHT]superkarma,2632,0,1,0,1,100.0%,15m
6593,1,[신개미협회]맟춤벞긐혐,2632,39,1,1,2,50.0%,14m
6599,2,[Slash]뀰뀰,2631,1406,306,317,623,49.1%,47m
6599,3,idonteat,2631,1525,145,146,291,49.8%,48m
6599,1,海龍王,2631,1594,60,50,110,54.5%,14m
6599,1,헤이즈,2631,144,5,4,9,55.6%,19m
6599,1,리플,2631,114,3,4,7,42.9%,42m
6599,1,[最後生還者]紅羽,2631,0,2,1,3,66.7%,42m
6605,1,SaB,2630,1530,88,106,194,45.4%,46m
6605,1,CrazyDog,2630,447,15,15,30,50.0%,15m
6605,1,[N델타메이슨]제너럴리,2630,320,9,7,16,56.2%,15m
6605,1,오우짜스,2630,120,4,3,7,57.1%,23m
6605,3,ring,2630,0,2,4,6,33.3%,43m
6605,1,Mavekashi,2630,0,0,1,1,0.0%,15m
6605,1,씨목재,2630,0,0,1,1,0.0%,19m
6612,1,asp,2629,1540,473,470,943,50.2%,46m
6612,3,태영이는은희꺼,2629,1388,96,93,189,50.8%,48m
6612,3,[프리메이슨]찜질방구운김계란,2629,1002,44,40,84,52.4%,48m
6612,1,[Active]난다찌찌찌,2629,673,18,13,31,58.1%,15m
6616,1,bert,2628,203,8,11,19,42.1%,15m
6616,2,셰프도현,2628,214,7,5,12,58.3%,22m
6616,1,[이기고싶어]vanish,2628,46,2,1,3,66.7%,15m
6616,3,[DOHC]CamryPower,2628,0,1,0,1,100.0%,21m
6616,1,황새롬과김도겸,2628,44,1,1,2,50.0%,16m
6621,1,石門宇,2627,362,10,8,18,55.6%,42m
6621,3,Yato,2627,260,10,8,18,55.6%,43m
6621,1,프로,2627,196,5,3,8,62.5%,15m
6621,1,죽이고싶당,2627,86,2,2,4,50.0%,14m
6621,1,seojin,2627,0,0,2,2,0.0%,15m
6626,3,BeginneR,2626,408,14,19,33,42.4%,16m
6626,2,Racer,2626,140,4,1,5,80.0%,22m
6626,1,KKD,2626,74,2,2,4,50.0%,14m
6626,1,Carpenteria,2626,0,2,3,5,40.0%,15m
6626,1,엠파이브,2626,0,1,0,1,100.0%,15m
6631,1,BadCorona,2625,1632,54,49,103,52.4%,15m
6631,3,LoveEtc,2625,157,11,15,26,42.3%,48m
6631,1,[트런들]퐈이터창키,2625,222,5,5,10,50.0%,15m
6631,2,썬더케리건앰이,2625,0,2,2,4,50.0%,18m
6635,2,이루마,2624,1528,98,91,189,51.9%,47m
6635,3,Mxang,2624,346,22,22,44,50.0%,49m
6635,1,뽀스타,2624,622,21,16,37,56.8%,15m
6635,3,JoyFul,2624,329,12,10,22,54.5%,48m
6635,3,diaushd,2624,160,6,7,13,46.2%,21m
6635,1,月之國,2624,94,2,1,3,66.7%,18m
6641,3,Vega,2623,261,14,12,26,53.8%,16m
6641,3,GalaxyBoxS,2623,175,4,3,7,57.1%,21m
6643,1,我真的不知道,2622,198,10,11,21,47.6%,44m
6643,1,Frigedo,2622,0,2,3,5,40.0%,42m
6643,3,[망겜장인]호프집누나,2622,30,2,3,5,40.0%,36m
6643,1,[브리티안]CallofBlood,2622,0,2,4,6,33.3%,20m
6643,1,KenshinX,2622,0,2,4,6,33.3%,19m
6643,1,[이터널]닥스훈트,2622,0,0,4,4,0.0%,15m
6649,1,[무라좀가자]김바위,2621,673,27,25,52,51.9%,14m
6649,1,용량이두렵찡,2621,501,19,22,41,46.3%,44m
6649,1,DonaldTrump,2621,145,4,4,8,50.0%,20m
6649,1,꼬봉마왕,2621,164,4,6,10,40.0%,23m
6653,1,StevenPark,2620,1114,37,35,72,51.4%,15m
6653,3,Huyem,2620,30,2,6,8,25.0%,48m
6653,3,이은기,2620,0,1,1,2,50.0%,16m
6653,1,[大韓帝國]LakShir,2620,0,1,1,2,50.0%,23m
6657,1,[Flysky]안드로,2619,1181,139,139,278,50.0%,45m
6657,2,민준아빠,2619,458,15,21,36,41.7%,47m
6657,3,뒷골목오야붕,2619,232,7,7,14,50.0%,20m
6657,1,Rum,2619,125,3,3,6,50.0%,14m
6657,1,Gasi,2619,0,1,4,5,20.0%,19m
6662,1,니와까아메,2618,670,23,28,51,45.1%,44m
6663,1,snake,2617,994,58,72,130,44.6%,46m
6663,1,그거슨헤팝,2617,323,11,13,24,45.8%,15m
6663,3,RyanKL,2617,124,5,8,13,38.5%,48m
6663,2,[l암살단l]hyuk,2617,93,4,6,10,40.0%,43m
6663,1,뽀니,2617,73,1,3,4,25.0%,15m
6663,2,용돈이저그냐,2617,0,0,1,1,0.0%,14m
6669,3,GtG,2616,391,13,15,28,46.4%,16m
6669,3,[한타왕]kkcksgh,2616,238,8,15,23,34.8%,48m
6671,3,[무적함대]saturn,2615,160,5,4,9,55.6%,43m
6671,2,Kummel,2615,30,5,5,10,50.0%,43m
6671,2,jun,2615,94,4,8,12,33.3%,23m
6671,1,홍익점문가,2615,89,2,1,3,66.7%,42m
6671,1,흑불팸,2615,46,1,2,3,33.3%,14m
6671,1,[마주치면죽어]히포,2615,46,1,2,3,33.3%,42m
6677,1,Lemonit,2614,282,14,10,24,58.3%,23m
6677,1,IntoTheFire,2614,48,2,1,3,66.7%,15m
6677,1,abc,2614,0,2,3,5,40.0%,42m
6677,1,[TPg]德馬西亞,2614,0,0,1,1,0.0%,42m
6681,3,CrowBar,2613,145,3,4,7,42.9%,21m
6682,1,Supervisor,2612,311,12,11,23,52.2%,42m
6682,1,GONI,2612,338,9,7,16,56.2%,15m
6682,3,kit,2612,64,2,9,11,18.2%,17m
6685,3,llllllllllll,2611,1318,53,54,107,49.5%,17m
6685,1,Razgut,2611,186,6,0,6,100.0%,42m
6685,3,TechMaster,2611,0,2,4,6,33.3%,48m
6685,1,Gajago,2611,32,1,2,3,33.3%,15m
6689,1,얼굴천재홍윤석,2610,354,16,16,32,50.0%,23m
6689,1,로로,2610,97,4,5,9,44.4%,42m
6689,1,IlIlIlIl,2610,44,2,0,2,100.0%,15m
6689,1,[싸우다죽어라]내목숨을아이언맨,2610,0,1,0,1,100.0%,15m
6693,1,tank,2609,727,225,228,453,49.7%,46m
6693,1,[꽃남]메카닉싫엉,2609,1519,76,83,159,47.8%,46m
6693,3,NirO,2609,145,5,6,11,45.5%,43m
6693,1,ICYphoenix,2609,97,2,5,7,28.6%,18m
6697,3,여진철,2608,1409,68,61,129,52.7%,48m
6697,1,은해성,2608,252,6,6,12,50.0%,15m
6697,1,IIIIIIIIIIII,2608,102,3,2,5,60.0%,14m
6697,1,MGMS,2608,126,3,4,7,42.9%,14m
6701,3,Shinigami,2607,73,5,12,17,29.4%,49m
6701,1,어그로끌지마,2607,48,4,4,8,50.0%,20m
6701,1,[hero79]웃음천국,2607,0,1,0,1,100.0%,18m
6701,1,뀨로로,2607,40,1,1,2,50.0%,15m
6701,1,구름달,2607,0,1,1,2,50.0%,19m
6706,3,NEWguy,2606,1450,204,224,428,47.7%,43m
6706,1,KAWASAKI,2606,933,40,39,79,50.6%,16m
6706,3,雪森,2606,196,6,7,13,46.2%,21m
6706,1,정자왕프라임,2606,115,1,3,4,25.0%,14m
6710,2,더블폴트,2605,1473,173,177,350,49.4%,47m
6710,2,레이더힐,2605,464,17,23,40,42.5%,43m
6710,1,과천피바라기,2605,186,7,3,10,70.0%,16m
6710,1,NKII,2605,156,5,5,10,50.0%,42m
6710,1,말파이투,2605,0,1,4,5,20.0%,42m
6715,1,Legit,2604,1357,56,56,112,50.0%,14m
6715,2,강민호짱짱짱짱짱,2604,242,12,12,24,50.0%,23m
6715,1,chix,2604,164,6,6,12,50.0%,15m
6715,1,theshield,2604,0,0,2,2,0.0%,43m
6719,1,저그의눈물,2603,34,2,2,4,50.0%,15m
6719,1,책먹던여우,2603,0,2,4,6,33.3%,18m
6721,2,llIIlIIIlII,2602,1539,169,174,343,49.3%,47m
6721,1,퍼스트게임,2602,34,4,1,5,80.0%,42m
6723,3,[國本]BlueTa,2601,512,18,20,38,47.4%,17m
6723,3,greengimp,2601,126,7,8,15,46.7%,20m
6725,1,azxzc,2600,504,17,14,31,54.8%,15m
6725,1,Realcircle,2600,154,3,1,4,75.0%,42m
6725,1,kanazawakyu,2600,0,1,4,5,20.0%,18m
6728,1,Rex,2599,1494,170,172,342,49.7%,46m
6728,1,ShadowKiller,2599,916,28,25,53,52.8%,42m
6730,3,폭풍저그,2598,1563,57,62,119,47.9%,17m
6730,3,agony,2598,102,6,8,14,42.9%,20m
6730,1,DeepmindSC,2598,30,1,1,2,50.0%,23m
6730,1,치킨,2598,0,0,1,1,0.0%,15m
6734,1,초보,2597,90,5,2,7,71.4%,42m
6734,3,ouou,2597,68,5,9,14,35.7%,20m
6734,1,DimonLimON,2597,0,3,2,5,60.0%,14m
6734,1,백스핀블로우,2597,48,2,7,9,22.2%,19m
6734,1,MagicLeaf,2597,48,1,2,3,33.3%,18m
6739,1,안녕,2596,1197,41,39,80,51.2%,15m
6739,3,자킨,2596,30,4,6,10,40.0%,20m
6739,1,사신,2596,42,2,5,7,28.6%,15m
6742,2,쪽집개,2595,686,24,34,58,41.4%,47m
6742,1,버스커드레곤,2595,0,0,3,3,0.0%,16m
6744,3,Emperor,2594,555,117,122,239,49.0%,48m
6744,3,미니미니,2594,196,5,6,11,45.5%,21m
6744,1,[KRSC2]슈딩이,2594,202,5,7,12,41.7%,16m
6744,2,[BEJ2]사라케리건,2594,0,2,3,5,40.0%,18m
6744,1,PwROvRwLmNg,2594,0,2,3,5,40.0%,42m
6744,1,Sirius,2594,0,2,3,5,40.0%,15m
6744,1,[동네노는형들]Mong,2594,0,0,4,4,0.0%,16m
6751,2,[패자는피를]드디어올곳이왔군,2593,1255,144,156,300,48.0%,47m
6751,3,LwL,2593,1131,48,47,95,50.5%,48m
6751,1,misterbasic,2593,477,19,13,32,59.4%,15m
6751,1,로봇자객,2593,349,14,12,26,53.8%,42m
6751,1,[好難過好想哭]鈴鈴很可愛,2593,486,13,10,23,56.5%,42m
6751,1,llllllililii,2593,0,4,3,7,57.1%,18m
6757,3,불타석상,2592,1484,78,72,150,52.0%,43m
6757,2,GOLD,2592,945,54,57,111,48.6%,47m
6757,1,llllllllllll,2592,722,29,32,61,47.5%,44m
6757,1,BIG,2592,124,3,2,5,60.0%,15m
6757,1,칠산대교,2592,0,1,0,1,100.0%,42m
6762,3,인성문제있어,2591,530,21,23,44,47.7%,49m
6762,1,lIlIlIlIlIlI,2591,0,1,0,1,100.0%,19m
6764,3,잇힝,2590,1388,51,57,108,47.2%,16m
6764,1,랑게르한,2590,0,1,0,1,100.0%,42m
6764,1,[체인소맨]저승사자,2590,0,1,1,2,50.0%,16m
6764,1,빼빼로,2590,0,0,1,1,0.0%,42m
6768,1,[ANGG]DOFE,2589,1233,48,49,97,49.5%,15m
6768,1,루크짱,2589,1072,36,34,70,51.4%,42m
6768,1,nauki,2589,530,15,16,31,48.4%,15m
6768,3,Kai,2589,130,6,5,11,54.5%,43m
6768,1,MASTERXENON,2589,116,4,0,4,100.0%,15m
6768,1,SnowBall,2589,141,4,4,8,50.0%,18m
6768,3,섹셜러티,2589,88,4,7,11,36.4%,16m
6768,1,[오마이걸]용가리,2589,0,2,3,5,40.0%,16m
6768,1,genious,2589,0,1,0,1,100.0%,16m
6777,1,llllllllllll,2588,438,14,5,19,73.7%,42m
6778,2,gichan,2587,1272,115,117,232,49.6%,48m
6778,3,ZERG,2587,1139,69,64,133,51.9%,16m
6778,1,따순한맹독충,2587,194,5,0,5,100.0%,15m
6778,1,jiwoong,2587,46,2,4,6,33.3%,16m
6782,1,빅불,2586,1454,53,48,101,52.5%,42m
6782,3,swfilm,2586,785,30,29,59,50.8%,16m
6782,1,[NTW]DamnLotus,2586,284,7,8,15,46.7%,15m
6782,1,돌고래,2586,254,6,9,15,40.0%,15m
6782,1,NekoTyan,2586,174,4,6,10,40.0%,42m
6782,3,ShinyLight,2586,90,3,7,10,30.0%,43m
6782,1,화끈하게,2586,0,0,1,1,0.0%,42m
6789,3,angrywombat,2585,1228,50,47,97,51.5%,43m
6789,1,流離尋岸的花,2585,38,2,2,4,50.0%,16m
6789,1,艾格拉斯,2585,72,2,3,5,40.0%,15m
6789,1,레알이니,2585,48,2,3,5,40.0%,20m
6789,1,pryme,2585,0,1,0,1,100.0%,15m
6789,1,Katal,2585,0,0,2,2,0.0%,15m
6795,1,Red,2584,573,19,16,35,54.3%,16m
6795,3,쏘핫,2584,118,4,12,16,25.0%,48m
6795,1,스즈키상,2584,126,3,3,6,50.0%,42m
6795,1,사탄,2584,0,0,1,1,0.0%,19m
6799,3,Happy,2583,1034,36,41,77,46.8%,48m
6799,3,EsueMeat,2583,62,3,12,15,20.0%,16m
6801,1,우박,2582,1250,43,42,85,50.6%,16m
6801,1,블러드테일,2582,322,9,9,18,50.0%,16m
6801,1,붉은감자,2582,272,7,5,12,58.3%,15m
6804,1,RinI,2581,208,6,7,13,46.2%,15m
6804,1,속임금눈놈,2581,36,1,4,5,20.0%,42m
6804,1,성종,2581,0,0,2,2,0.0%,16m
6807,1,[뉴비의똥꼬쇼]zJustaNewbie,2580,505,19,18,37,51.4%,15m
6807,1,나는제시카,2580,0,3,3,6,50.0%,19m
6807,1,티모,2580,0,0,1,1,0.0%,14m
6807,1,瘋狂假面,2580,0,0,1,1,0.0%,23m
6807,2,llIIlllIII,2580,0,0,1,1,0.0%,18m
6812,1,mick,2579,94,4,5,9,44.4%,19m
6812,1,TYTY,2579,76,3,5,8,37.5%,15m
6814,1,저녁설사,2578,498,13,14,27,48.1%,42m
6814,1,[습격자까마귀]오토모빌,2578,130,4,5,9,44.4%,15m
6814,1,TPZ,2578,121,3,1,4,75.0%,19m
6814,2,캬또,2578,0,2,3,5,40.0%,18m
6814,1,epicvoid,2578,0,0,1,1,0.0%,42m
6819,3,어지러운기사,2577,109,3,2,5,60.0%,48m
6820,1,Kotgoin,2576,1154,36,34,70,51.4%,15m
6820,1,Blast,2576,641,24,20,44,54.5%,15m
6822,3,kirop,2575,1174,51,51,102,50.0%,17m
6822,1,anfrhrl,2575,395,12,13,25,48.0%,15m
6822,1,코코아,2575,296,8,8,16,50.0%,16m
6822,1,총무,2575,0,1,0,1,100.0%,42m
6822,1,Tititmi,2575,0,0,1,1,0.0%,42m
6827,3,마라나타,2574,292,14,17,31,45.2%,49m
6827,1,MaRin,2574,314,10,4,14,71.4%,16m
6827,1,阿暄仔,2574,44,2,0,2,100.0%,14m
6827,1,lyoo,2574,0,1,0,1,100.0%,15m
6831,1,scuffle,2573,1787,91,90,181,50.3%,15m
6831,1,wiwiw,2573,1242,48,41,89,53.9%,15m
6831,1,구룸이,2573,794,38,44,82,46.3%,46m
6831,2,날랜자,2573,404,14,25,39,35.9%,47m
6831,2,씌바견,2573,0,1,4,5,20.0%,18m
6836,1,[참돔]구천일심,2572,1460,208,214,422,49.3%,44m
6836,1,burai,2572,719,25,22,47,53.2%,15m
6836,3,TNTERER,2572,183,7,8,15,46.7%,16m
6836,1,[우연]박종웅,2572,84,3,2,5,60.0%,23m
6836,1,XiaoSong,2572,0,2,1,3,66.7%,42m
6836,1,kidd,2572,46,2,4,6,33.3%,16m
6836,3,Jarhead,2572,95,1,7,8,12.5%,16m
6836,3,통조림,2572,0,0,10,10,0.0%,20m
6844,1,듀즐리,2571,120,4,3,7,57.1%,14m
6845,1,[조국수호]Wolf,2570,489,19,20,39,48.7%,14m
6845,1,EMuMu,2570,399,10,6,16,62.5%,15m
6845,1,[蒼龍逆天狂]櫻小路才華,2570,121,3,0,3,100.0%,42m
6845,1,殘奘取經,2570,46,2,0,2,100.0%,15m
6845,1,아킬스,2570,0,0,1,1,0.0%,15m
6845,1,[더지니어스]Boss,2570,0,0,2,2,0.0%,42m
6851,1,Ryan,2569,38,2,0,2,100.0%,16m
6851,3,xxxxxxxxxxxx,2569,0,1,6,7,14.3%,43m
6851,1,KHBIB,2569,0,0,1,1,0.0%,43m
6854,1,DemonPrince,2568,1711,246,267,513,48.0%,42m
6854,1,ijgi,2568,557,24,20,44,54.5%,15m
6854,3,[디시인사이드]준식하무현,2568,406,16,16,32,50.0%,16m
6854,1,llllllllllll,2568,396,12,7,19,63.2%,16m
6854,2,GrimReaper,2568,157,5,1,6,83.3%,23m
6854,2,[맵핵]athers,2568,48,3,3,6,50.0%,18m
6854,1,Corvo,2568,44,3,4,7,42.9%,42m
6854,3,BUMPYTPOT,2568,30,3,6,9,33.3%,48m
6854,1,[볼셰비키]다크로드,2568,0,0,1,1,0.0%,42m
6863,1,SolNectAryne,2567,184,5,4,9,55.6%,16m
6863,2,해병군인,2567,0,1,4,5,20.0%,18m
6865,1,JASON,2566,119,2,1,3,66.7%,20m
6866,3,ALLISWELL,2565,198,10,4,14,71.4%,43m
6867,2,천안킹카,2563,1020,55,60,115,47.8%,47m
6867,3,啤酒好吃,2563,216,6,8,14,42.9%,43m
6867,1,[alol]hgdfgsdg,2563,121,5,4,9,55.6%,42m
6867,1,[반란]스투송이,2563,0,1,0,1,100.0%,15m
6867,1,watrio,2563,0,0,1,1,0.0%,19m
6867,1,코로나바이러스,2563,0,0,1,1,0.0%,43m
6867,1,[DagmBa]귀찮아,2563,0,0,1,1,0.0%,43m
6874,1,[NoME]꼬마방장,2562,841,29,26,55,52.7%,14m
6874,3,magicprotoss,2562,366,15,19,34,44.1%,17m
6874,1,www,2562,290,7,8,15,46.7%,23m
6874,1,[SymoW]Hagalaz,2562,0,1,5,6,16.7%,43m
6874,1,공허의유산,2562,0,0,2,2,0.0%,42m
6879,2,medimedi,2561,273,9,12,21,42.9%,23m
6879,3,[華人宣言]只剩豆漿,2561,195,7,9,16,43.8%,43m
6879,2,AkeTJ,2561,90,4,5,9,44.4%,43m
6879,1,[SCTW]ZEROS,2561,0,0,1,1,0.0%,43m
6883,2,[TMR]梅爾斯,2559,1488,178,183,361,49.3%,47m
6883,1,Anpanman,2559,44,2,2,4,50.0%,16m
6883,3,겐조,2559,0,0,2,2,0.0%,20m
6886,1,VenomLord,2558,1814,84,99,183,45.9%,42m
6886,3,AHS,2558,93,2,2,4,50.0%,43m
6886,1,BasketCoach,2558,30,1,1,2,50.0%,15m
6886,1,[異界的檢察官]黑暗深邃幻想,2558,0,0,1,1,0.0%,42m
6890,1,ScumbagKai,2557,148,6,4,10,60.0%,42m
6890,1,赤逸,2557,0,0,1,1,0.0%,42m
6890,2,[Tesla]진하,2557,0,0,1,1,0.0%,18m
6893,1,BiSu,2556,1714,121,119,240,50.4%,15m
6893,1,[ClanSD]SatamaN,2556,0,2,4,6,33.3%,15m
6893,1,pendragon,2556,0,0,1,1,0.0%,42m
6896,3,Allenspider,2555,1373,103,97,200,51.5%,17m
6896,1,RMoLSW,2555,521,18,13,31,58.1%,15m
6896,1,보드라디스크,2555,83,5,5,10,50.0%,18m
6896,1,근현하트은빈,2555,200,5,7,12,41.7%,16m
6896,1,SpicaBluenot,2555,38,1,1,2,50.0%,15m
6896,1,roy,2555,0,0,1,1,0.0%,42m
6902,1,lhs,2554,252,8,10,18,44.4%,16m
6902,1,秀謬先生,2554,0,1,2,3,33.3%,14m
6904,1,짱무서워요,2553,982,30,32,62,48.4%,23m
6904,1,FunkHyuk,2553,398,10,13,23,43.5%,15m
6906,1,라케시스,2552,624,19,21,40,47.5%,42m
6906,1,[요사키클랜]연타맨,2552,0,0,1,1,0.0%,42m
6908,2,KYJLOVE,2551,1488,146,154,300,48.7%,43m
6908,3,Lobster,2551,790,27,35,62,43.5%,17m
6908,1,[브리티안]슈퍼메가어메이징,2551,239,5,6,11,45.5%,42m
6911,3,무요,2550,1446,119,113,232,51.3%,43m
6911,3,todoing,2550,484,69,68,137,50.4%,49m
6913,1,[KOSEAL]퇴교생,2549,373,13,11,24,54.2%,42m
6913,2,OneDay,2549,80,4,3,7,57.1%,18m
6913,1,LoveGiraffe,2549,0,0,1,1,0.0%,15m
6916,1,천웅이랑,2548,97,3,4,7,42.9%,43m
6917,1,째쯔찍쯔,2547,1660,61,56,117,52.1%,16m
6917,1,옾탱,2547,46,3,2,5,60.0%,42m
6917,3,[sc2mc]전수혁,2547,60,3,2,5,60.0%,21m
6920,1,철거박사,2545,80,2,1,3,66.7%,15m
6921,3,보리,2544,1571,89,85,174,51.1%,43m
6921,1,emllen,2544,315,13,17,30,43.3%,44m
6921,1,TWforever,2544,0,2,4,6,33.3%,42m
6921,1,wuian,2544,0,0,2,2,0.0%,15m
6925,3,남군아,2543,579,21,25,46,45.7%,17m
6925,1,미믹정주,2543,308,8,8,16,50.0%,15m
6925,1,jackorder,2543,208,7,9,16,43.8%,42m
6925,3,IllusiveMan,2543,186,7,17,24,29.2%,43m
6929,2,IAEA,2542,1485,320,322,642,49.8%,47m
6929,1,RasslabuhaA,2542,578,38,21,59,64.4%,23m
6929,1,[중금속중독자]듀얼,2542,237,6,4,10,60.0%,16m
6929,2,[secx]GloryOfDelam,2542,0,2,3,5,40.0%,18m
6929,1,IKELoww,2542,109,1,6,7,14.3%,42m
6934,1,[IT]rain,2541,506,15,14,29,51.7%,23m
6934,1,거지공작,2541,190,5,2,7,71.4%,42m
6934,1,Astrology,2541,88,3,1,4,75.0%,14m
6934,1,ATHOUSAND,2541,88,3,3,6,50.0%,43m
6938,1,아리랑,2540,970,32,32,64,50.0%,16m
6938,3,장문복,2540,546,26,27,53,49.1%,17m
6938,1,楓蜜綠茶,2540,599,18,15,33,54.5%,16m
6938,1,kane,2540,124,3,7,10,30.0%,42m
6942,1,killerakira,2539,1140,79,79,158,50.0%,14m
6942,1,MrTob,2539,68,3,2,5,60.0%,16m
6942,1,CowboyOrange,2539,48,3,5,8,37.5%,18m
6942,1,野蠻便便,2539,82,2,5,7,28.6%,15m
6946,1,IIIIIIIIIII,2538,1121,42,38,80,52.5%,15m
6946,3,[머구폐렴]lllllIIllIll,2538,363,13,15,28,46.4%,48m
6948,3,TsTs,2537,999,57,67,124,46.0%,16m
6948,1,[ATe]Snorlax,2537,96,4,6,10,40.0%,19m
6950,3,아빠투르,2536,1481,76,76,152,50.0%,43m
6950,3,sigami,2536,348,25,33,58,43.1%,16m
6950,1,[HunttS]desnake,2536,562,19,22,41,46.3%,42m
6950,1,주작,2536,312,7,6,13,53.8%,15m
6954,2,파라케,2535,796,30,32,62,48.4%,47m
6954,1,밤까마귀,2535,44,1,2,3,33.3%,15m
6956,1,tommyfrank,2534,346,9,12,21,42.9%,15m
6956,1,손주아디뜯음,2534,42,1,1,2,50.0%,16m
6958,3,Lenny,2533,1407,72,77,149,48.3%,49m
6958,3,kama,2533,209,8,11,19,42.1%,20m
6958,1,lIlIlIlIlIlI,2533,117,3,1,4,75.0%,16m
6958,1,[CDGIN]Sschoularz,2533,32,2,2,4,50.0%,14m
6962,1,아이스버그,2532,1442,267,263,530,50.4%,46m
6962,1,HAPPYMAN,2532,370,14,11,25,56.0%,42m
6962,2,Mangu,2532,230,7,14,21,33.3%,22m
6962,1,[일인자]화이트와인,2532,195,6,2,8,75.0%,42m
6962,1,으흐흐저리가,2532,0,2,3,5,40.0%,16m
6967,1,LONGLIVEASAP,2531,244,7,9,16,43.8%,18m
6967,1,Rax,2531,166,6,3,9,66.7%,16m
6967,2,[해양경비대]스타즐겜유저,2531,0,2,3,5,40.0%,18m
6967,1,느금마브금좋네,2531,0,2,3,5,40.0%,42m
6967,1,望紀川內依,2531,86,2,4,6,33.3%,16m
6967,1,PurplRainbow,2531,42,1,7,8,12.5%,15m
6967,1,노날두,2531,0,0,1,1,0.0%,20m
6967,1,쫘스기,2531,0,0,5,5,0.0%,16m
6975,1,Tolaxii,2530,644,38,31,69,55.1%,15m
6975,1,딸기맛젤리,2530,522,18,19,37,48.6%,15m
6975,2,Shin,2530,228,9,12,21,42.9%,47m
6975,1,[Arcade]FirstArcade,2530,252,7,11,18,38.9%,15m
6979,1,산이,2529,1172,143,142,285,50.2%,14m
6979,3,[노인성듀오]련남동터프쿠키,2529,572,55,63,118,46.6%,17m
6979,1,미친고양이,2529,894,29,29,58,50.0%,15m
6979,1,StreetEdge,2529,609,19,13,32,59.4%,15m
6979,3,pasha,2529,193,5,6,11,45.5%,43m
6984,1,Woojin,2528,352,9,6,15,60.0%,16m
6984,1,借道滅虢,2528,0,1,0,1,100.0%,15m
6986,1,llllllllllll,2527,132,4,3,7,57.1%,42m
6987,1,[즐겜러]Gert,2526,166,8,2,10,80.0%,43m
6987,1,조르지호,2526,0,2,4,6,33.3%,42m
6987,1,傳奇,2526,0,0,1,1,0.0%,16m
6990,1,아무거나,2525,0,1,1,2,50.0%,20m
6991,1,[DICET]IIIlIIIlIII,2524,162,6,0,6,100.0%,42m
6991,1,크와앗,2524,46,1,2,3,33.3%,43m
6991,1,[HcW]wjdwodus,2524,88,1,2,3,33.3%,42m
6994,1,mblkms,2523,151,5,0,5,100.0%,15m
6994,1,개꿀,2523,0,3,6,9,33.3%,19m
6994,1,仙豆哥哥,2523,121,3,6,9,33.3%,20m
6994,1,[홍콩행제리바]SynDroMe,2523,44,2,1,3,66.7%,15m
6998,1,byongmin,2522,80,3,3,6,50.0%,42m
6998,1,데하크아,2522,0,2,5,7,28.6%,42m
7000,3,저그유저,2521,967,38,40,78,48.7%,17m
7000,2,뽀찌,2521,270,11,14,25,44.0%,43m
7000,3,韓國瑜珈教練,2521,0,0,4,4,0.0%,49m
7003,1,PARADAXGUS,2520,377,11,13,24,45.8%,16m
7003,1,不要叫我證明,2520,168,7,10,17,41.2%,45m
7003,1,[벽짓고벽뚫고]사령관,2520,97,3,4,7,42.9%,15m
7003,1,eleven,2520,90,2,4,6,33.3%,15m
7007,1,不明的,2519,264,7,9,16,43.8%,18m
7007,1,[개복교]내찡찡,2519,186,6,7,13,46.2%,18m
7007,1,기절,2519,42,5,2,7,71.4%,14m
7007,1,아이아이아이,2519,48,3,6,9,33.3%,18m
7011,1,힙통령,2517,1051,92,96,188,48.9%,15m
7011,1,히드라,2517,900,26,34,60,43.3%,42m
7011,1,중국면,2517,184,5,6,11,45.5%,15m
7014,2,저금마,2516,0,2,4,6,33.3%,18m
7014,3,[정치공학]역사선생님,2516,0,1,0,1,100.0%,21m
7014,1,까치,2516,97,1,1,2,50.0%,20m
7017,1,시나브로자라난털,2515,432,14,14,28,50.0%,16m
7017,2,KangChoo,2515,0,4,8,12,33.3%,22m
7019,1,yolo,2514,720,25,25,50,50.0%,16m
7019,1,Xero,2514,726,22,22,44,50.0%,15m
7019,1,오늘하루가길다,2514,486,21,16,37,56.8%,14m
7019,1,YongJa,2514,288,8,12,20,40.0%,14m
7019,1,Player,2514,213,6,8,14,42.9%,42m
7019,1,YenJu,2514,214,5,7,12,41.7%,14m
7019,1,Esteban,2514,90,2,0,2,100.0%,42m
7019,1,llllllllllll,2514,0,1,0,1,100.0%,19m
7019,1,미쁘다,2514,0,0,7,7,0.0%,15m
7028,1,sdteran,2513,713,28,23,51,54.9%,15m
7028,1,newnus,2513,180,6,4,10,60.0%,15m
7028,1,Hero,2513,164,4,7,11,36.4%,23m
7028,1,헉헉짱,2513,97,3,3,6,50.0%,19m
7028,1,박선우,2513,42,2,2,4,50.0%,15m
7033,1,마세어,2512,1486,156,147,303,51.5%,42m
7033,1,make,2512,443,13,11,24,54.2%,14m
7033,1,罐頭阮,2512,162,5,6,11,45.5%,15m
7033,1,albert,2512,88,3,3,6,50.0%,15m
7033,2,Kimchi,2512,0,2,4,6,33.3%,18m
7033,1,[DSCRY]MINID,2512,0,0,1,1,0.0%,42m
7039,3,Kael,2511,278,10,14,24,41.7%,17m
7039,1,Justin,2511,0,0,1,1,0.0%,19m
7041,1,shangus,2510,568,19,15,34,55.9%,16m
7041,1,pilgyu,2510,510,15,19,34,44.1%,14m
7041,1,디리링,2510,339,9,8,17,52.9%,16m
7041,1,돈이날지켜준다,2510,0,0,3,3,0.0%,23m
7045,2,coronationst,2509,551,217,225,442,49.1%,48m
7045,2,boragnal,2509,407,15,28,43,34.9%,48m
7045,1,[아무나들어와]yullyous,2509,247,9,8,17,52.9%,14m
7045,1,jksa,2509,127,3,1,4,75.0%,43m
7045,1,skyhoole,2509,82,2,9,11,18.2%,14m
7045,1,Pspherakire,2509,0,1,1,2,50.0%,42m
7051,2,우엉이,2508,0,0,2,2,0.0%,18m
7052,2,gaga,2507,1107,41,50,91,45.1%,43m
7052,1,llllllllllll,2507,1046,33,36,69,47.8%,14m
7052,1,[펩시맨]Maesher,2507,595,19,22,41,46.3%,42m
7052,3,LikeGame,2507,468,16,27,43,37.2%,48m
7052,3,잿빛구름,2507,170,4,7,11,36.4%,21m
7052,2,작은악마정욱빠,2507,0,1,0,1,100.0%,18m
7052,1,유정현,2507,42,1,2,3,33.3%,42m
7052,1,potadoguy,2507,0,1,3,4,25.0%,14m
7052,3,아메리카노할래,2507,0,0,2,2,0.0%,21m
7061,3,dlqldlsgnrhk,2506,1489,141,150,291,48.5%,48m
7061,1,만수,2506,1235,42,42,84,50.0%,42m
7063,2,LeoIsMe,2505,1405,146,148,294,49.7%,47m
7063,1,IIIIIllIIIII,2505,464,23,27,50,46.0%,16m
7063,1,[브리티안]cumputer,2505,385,14,10,24,58.3%,42m
7063,3,ElsaOuO,2505,200,7,12,19,36.8%,43m
7063,1,[OlyM]sss,2505,212,6,4,10,60.0%,15m
7063,1,[고구려만세]나무,2505,0,1,0,1,100.0%,42m
7063,1,[TST]뺑덕아범,2505,0,0,1,1,0.0%,19m
7070,3,Sswagh,2504,1465,88,87,175,50.3%,43m
7070,2,[Blacer]IronMen,2504,1224,42,56,98,42.9%,47m
7070,1,foqxjfhs,2504,369,18,12,30,60.0%,16m
7073,1,noche,2503,135,5,0,5,100.0%,42m
7073,1,NoName,2503,222,5,6,11,45.5%,42m
7073,1,maxboy,2503,30,2,1,3,66.7%,14m
7073,1,설기마루,2503,0,1,1,2,50.0%,19m
7073,2,데하칽,2503,0,0,1,1,0.0%,18m
7078,1,orrochemalo,2502,320,10,12,22,45.5%,15m
7078,3,[고아쉐끼]EzTiMaTeD,2502,291,9,10,19,47.4%,21m
7078,1,IIIIIIIIlllI,2502,234,6,9,15,40.0%,19m
7078,1,Qiubi,2502,165,4,6,10,40.0%,19m
7078,3,임동현,2502,133,4,7,11,36.4%,43m
7078,1,[게임플레이]dla,2502,72,3,2,5,60.0%,15m
7084,1,kkppd,2501,1617,89,81,170,52.4%,42m
7084,1,개미,2501,167,4,3,7,57.1%,15m
7084,1,[눈꽃]팡퀴,2501,0,2,4,6,33.3%,42m
7084,1,나는레종멘솔이다,2501,73,1,5,6,16.7%,15m
7088,1,Dabiuteef,2500,1663,73,66,139,52.5%,15m
7088,1,표수헌,2500,919,39,28,67,58.2%,42m
7088,1,뭔코카여펩시지,2500,182,7,3,10,70.0%,16m
7088,1,[Jamja]은빛매,2500,251,6,5,11,54.5%,23m
7088,1,발로하는중,2500,0,2,3,5,40.0%,15m
7088,1,송병구,2500,97,1,5,6,16.7%,15m
7088,1,지보,2500,0,0,1,1,0.0%,42m
7088,1,騎豬南下,2500,0,0,4,4,0.0%,42m
7096,1,과외의일상,2499,341,15,14,29,51.7%,15m
7096,1,[BONES]Ocean,2499,396,14,19,33,42.4%,15m
7096,1,[건국]홍님벌쳐,2499,138,3,1,4,75.0%,43m
7099,2,Adabuu,2498,0,3,4,7,42.9%,18m
7099,2,TYyayayay,2498,46,1,2,3,33.3%,18m
7099,1,diffph,2498,0,1,5,6,16.7%,15m
7099,1,[바닷속이야기]JGComet,2498,0,0,1,1,0.0%,15m
7103,1,sugure,2497,1138,43,51,94,45.7%,24m
7103,1,하이염,2497,242,6,6,12,50.0%,42m
7103,1,카마카,2497,0,0,1,1,0.0%,15m
7106,1,NOBLE,2496,848,26,33,59,44.1%,15m
7106,1,MeteorBlue,2496,718,24,26,50,48.0%,14m
7106,1,[SC2HK]好七的戰士,2496,442,15,12,27,55.6%,42m
7106,1,암흑별,2496,330,9,8,17,52.9%,14m
7106,3,너희어머,2496,97,4,5,9,44.4%,49m
7106,1,Lawracz,2496,121,3,5,8,37.5%,19m
7112,3,everywheretj,2495,462,15,22,37,40.5%,48m
7112,1,슈퍼테란,2495,178,5,3,8,62.5%,42m
7112,2,Joker,2495,0,0,4,4,0.0%,18m
7115,1,EDEN,2494,727,28,26,54,51.9%,42m
7115,1,Monkey,2494,126,14,9,23,60.9%,15m
7117,1,버머씨,2493,234,7,9,16,43.8%,24m
7117,3,呆龍哥,2493,125,5,7,12,41.7%,43m
7117,2,GUITAR,2493,0,1,0,1,100.0%,22m
7120,1,vulak,2492,234,8,8,16,50.0%,20m
7120,2,IIIIIIIIII,2492,58,3,4,7,42.9%,42m
7120,1,정무문,2492,110,3,5,8,37.5%,15m
7123,1,[Master]IPPOO,2491,128,4,4,8,50.0%,16m
7123,3,광대양이,2491,0,3,4,7,42.9%,43m
7123,1,KFC,2491,36,1,5,6,16.7%,16m
7126,1,빛나는헤드,2490,145,5,4,9,55.6%,20m
7126,3,simsime,2490,30,2,3,5,40.0%,20m
7128,1,Alsgur,2489,30,2,2,4,50.0%,15m
7128,1,viaD,2489,30,1,2,3,33.3%,16m
7130,1,IIIIIIIIIIII,2488,0,4,2,6,66.7%,15m
7130,1,Mayara,2488,92,2,8,10,20.0%,15m
7132,1,초록도시,2487,1074,39,41,80,48.8%,15m
7133,2,yourlike,2486,0,3,4,7,42.9%,18m
7133,1,DJtwentyone,2486,40,2,5,7,28.6%,14m
7133,2,[IPE]Heides,2486,0,1,4,5,20.0%,42m
7133,2,폭시,2486,0,0,1,1,0.0%,42m
7137,1,dsad,2485,502,15,16,31,48.4%,14m
7137,1,마재윤,2485,242,7,5,12,58.3%,16m
7137,1,김대엽,2485,206,5,8,13,38.5%,16m
7137,3,없는사람,2485,0,3,7,10,30.0%,21m
7137,1,[Aoueja]이원빈,2485,44,1,3,4,25.0%,15m
7142,1,BrianG,2484,1636,64,67,131,48.9%,15m
7142,1,노틀담의춘향,2484,583,27,32,59,45.8%,15m
7142,2,口香糖,2484,623,26,25,51,51.0%,41m
7142,3,짜잔,2484,135,7,9,16,43.8%,21m
7142,1,James,2484,170,4,6,10,40.0%,19m
7142,3,change,2484,120,2,2,4,50.0%,21m
7142,2,szn,2484,46,2,4,6,33.3%,18m
7142,2,woowa,2484,0,1,0,1,100.0%,14m
7142,2,Moose,2484,0,0,1,1,0.0%,18m
7151,1,AssKiKa,2483,1169,47,52,99,47.5%,15m
7151,1,Crazyangel,2483,0,1,1,2,50.0%,19m
7151,1,Lan,2483,0,0,4,4,0.0%,20m
7154,1,sisk,2482,48,1,3,4,25.0%,20m
7155,1,제네시스,2481,1708,67,67,134,50.0%,15m
7155,1,asdfqwerghjk,2481,614,19,20,39,48.7%,15m
7155,1,저그멀록왕,2481,367,13,17,30,43.3%,16m
7155,1,김민재,2481,0,4,3,7,57.1%,15m
7155,2,Dutnee,2481,0,1,4,5,20.0%,42m
7160,1,치르노,2480,0,3,3,6,50.0%,42m
7160,1,Ssion,2480,36,1,4,5,20.0%,42m
7162,1,dobis,2479,955,32,31,63,50.8%,16m
7162,2,왜뭐뭐,2479,0,0,1,1,0.0%,18m
7162,1,ddoking,2479,0,0,3,3,0.0%,20m
7165,2,Eon,2478,100,5,4,9,55.6%,42m
7165,1,Jun,2478,40,2,3,5,40.0%,16m
7167,2,포도아빠,2477,738,29,30,59,49.2%,14m
7167,3,KFC,2477,155,4,7,11,36.4%,21m
7167,2,옴마니반메훔,2477,0,1,0,1,100.0%,22m
7167,2,flystax,2477,0,0,1,1,0.0%,22m
7167,2,오징오징,2477,0,0,1,1,0.0%,23m
7172,3,Muboy,2476,1299,75,82,157,47.8%,49m
7172,1,AsranJARA,2476,212,4,10,14,28.6%,42m
7174,1,[황금로마제국]카이사르,2475,207,5,4,9,55.6%,15m
7174,2,수지니야,2475,30,2,4,6,33.3%,42m
7174,2,엘카의전설,2475,0,0,1,1,0.0%,23m
7177,1,[제국군]스타서포트,2473,516,19,29,48,39.6%,45m
7177,1,one,2473,470,14,16,30,46.7%,15m
7177,3,스타원유저입니다,2473,117,6,9,15,40.0%,21m
7177,2,naruyng,2473,0,3,2,5,60.0%,18m
7177,1,Kyo,2473,0,2,5,7,28.6%,43m
7177,1,노진혁,2473,0,0,2,2,0.0%,42m
7183,1,Song,2472,461,14,18,32,43.8%,15m
7183,1,job,2472,432,12,18,30,40.0%,16m
7183,2,적해,2472,0,1,0,1,100.0%,18m
7186,2,허동은,2471,1149,46,41,87,52.9%,23m
7186,2,블레,2471,923,45,53,98,45.9%,48m
7186,1,BossTSENG,2471,0,0,3,3,0.0%,20m
7189,1,marin,2470,458,12,14,26,46.2%,15m
7189,2,좌의어기,2470,141,5,3,8,62.5%,18m
7191,1,我的小女时代,2469,1701,62,68,130,47.7%,42m
7191,1,뀨릥뀨리잉,2469,400,22,22,44,50.0%,15m
7191,1,방가르,2469,472,15,16,31,48.4%,15m
7191,1,KTL,2469,213,8,14,22,36.4%,14m
7191,2,hoytoy,2469,164,5,6,11,45.5%,42m
7191,1,我愛松鼠,2469,97,1,2,3,33.3%,20m
7197,1,ksh,2468,1037,62,55,117,53.0%,15m
7197,1,지니누나,2468,384,12,13,25,48.0%,42m
7197,2,[異化蟲公會]DaiSy,2468,58,2,1,3,66.7%,14m
7197,2,napapu,2468,0,0,2,2,0.0%,18m
7201,1,Tiphareth,2467,593,23,22,45,51.1%,42m
7201,1,spirit,2467,391,14,16,30,46.7%,42m
7201,2,陳幸祥,2467,0,1,5,6,16.7%,23m
7201,1,[DagmBa]Core,2467,0,0,2,2,0.0%,24m
7205,1,CodeREQ,2466,441,20,23,43,46.5%,14m
7205,1,[NighT1]ddd,2466,302,8,12,20,40.0%,15m
7205,2,KnightSoul,2466,174,6,3,9,66.7%,23m
7205,2,pATCHpROTOSS,2466,34,2,1,3,66.7%,22m
7209,2,Winger,2465,884,33,32,65,50.8%,14m
7209,1,뽀뽀뽕,2465,182,5,3,8,62.5%,20m
7209,1,skyak,2465,94,5,6,11,45.5%,20m
7209,1,[잉융치킹]SongPlay,2465,193,4,8,12,33.3%,20m
7209,2,원인어밀리언,2465,0,0,1,1,0.0%,22m
7214,1,꾸꾸,2464,148,5,2,7,71.4%,42m
7214,1,양학,2464,168,5,9,14,35.7%,16m
7214,2,choiyg,2464,30,2,0,2,100.0%,42m
7214,1,[공허거주]뽀로로,2464,0,2,5,7,28.6%,42m
7218,2,aaa,2463,865,67,83,150,44.7%,48m
7218,1,준배미,2463,602,23,32,55,41.8%,45m
7218,2,jacksong,2463,116,5,4,9,55.6%,42m
7218,1,JackFrostKP,2463,180,5,13,18,27.8%,14m
7218,2,에베베베베,2463,0,1,0,1,100.0%,41m
7218,2,[보니하니수민]chaos,2463,0,1,1,2,50.0%,42m
7224,1,SamMarine,2462,0,2,4,6,33.3%,42m
7225,1,LowLifeFeels,2461,523,19,18,37,51.4%,14m
7225,1,Rictus,2461,97,3,6,9,33.3%,19m
7225,1,[0922]ssdia,2461,0,1,0,1,100.0%,19m
7228,1,스타족망겜,2460,692,29,35,64,45.3%,16m
7228,2,Azamantes,2460,192,5,3,8,62.5%,23m
7228,1,폭풍우,2460,48,4,8,12,33.3%,19m
7228,1,Tenka,2460,0,1,2,3,33.3%,18m
7232,2,저그유저임,2459,0,1,4,5,20.0%,18m
7232,2,ChickenWing,2459,0,1,4,5,20.0%,42m
7232,2,ssedom,2459,0,0,1,1,0.0%,18m
7235,3,리시빙,2458,138,6,6,12,50.0%,48m
7235,2,동합군대,2458,0,2,3,5,40.0%,18m
7237,1,VVVVVVVVVVVV,2457,720,27,25,52,51.9%,15m
7237,1,IIIIIIIIIIII,2457,229,8,8,16,50.0%,15m
7237,1,Heart,2457,193,4,4,8,50.0%,19m
7237,2,hey,2457,0,2,1,3,66.7%,42m
7237,1,읔엨따,2457,0,2,4,6,33.3%,42m
7237,2,Scook,2457,0,0,2,2,0.0%,42m
7243,2,렛츠고게이바,2456,252,9,12,21,42.9%,42m
7243,2,[루키]cnb,2456,176,6,6,12,50.0%,23m
7243,2,고완영,2456,0,0,1,1,0.0%,22m
7246,3,FUUP,2455,1484,115,125,240,47.9%,48m
7246,1,吃我雞,2455,188,6,9,15,40.0%,20m
7246,2,호두니아,2455,48,3,5,8,37.5%,18m
7246,2,destory,2455,0,2,4,6,33.3%,18m
7246,2,김욱상,2455,0,0,1,1,0.0%,22m
7251,1,[大嘴鳥]一一一,2454,1286,53,52,105,50.5%,14m
7251,1,llamabrah,2454,556,33,37,70,47.1%,16m
7251,3,호두래,2454,592,22,26,48,45.8%,43m
7251,3,DeeDee,2454,148,7,10,17,41.2%,20m
7251,3,[國本]llllllllllll,2454,30,3,8,11,27.3%,49m
7251,2,怎麼打勒,2454,62,2,3,5,40.0%,23m
7257,1,lllIIIllllll,2453,1412,52,45,97,53.6%,15m
7257,2,탁마에,2453,60,4,10,14,28.6%,43m
7257,2,정력가,2453,104,3,4,7,42.9%,22m
7257,2,인간,2453,0,1,2,3,33.3%,18m
7261,2,Woojae,2452,644,26,16,42,61.9%,42m
7261,1,LowSaturaion,2452,459,21,24,45,46.7%,42m
7261,1,KurobaKaito,2452,618,18,23,41,43.9%,16m
7261,1,wwwstorjo,2452,264,7,10,17,41.2%,15m
7261,2,[겨울방어]Extra,2452,30,4,6,10,40.0%,43m
7261,3,BarCode,2452,30,3,8,11,27.3%,49m
7267,2,[센치한용기병]레더초보프교주,2451,426,17,12,29,58.6%,22m
7267,1,Vavalo,2451,84,4,6,10,40.0%,42m
7267,2,섹시우뇨니행님,2451,42,1,1,2,50.0%,23m
7270,3,개코,2449,0,3,7,10,30.0%,20m
7271,1,Ray,2448,1048,33,38,71,46.5%,16m
7271,1,할배후려치기,2448,424,13,15,28,46.4%,16m
7271,1,히오스,2448,170,5,10,15,33.3%,42m
7274,1,ZackMeliodas,2447,1245,47,52,99,47.5%,16m
7274,1,머시라고,2447,444,16,16,32,50.0%,42m
7274,1,바른양돈,2447,95,3,4,7,42.9%,42m
7274,3,DarkDeath,2447,145,3,4,7,42.9%,22m
7274,1,bash,2447,120,3,5,8,37.5%,20m
7274,2,[FAL]IlIllIIlIlII,2447,30,2,1,3,66.7%,42m
7280,1,Wizbeez,2446,939,34,42,76,44.7%,15m
7280,2,毛泽东,2446,0,1,0,1,100.0%,18m
7282,2,유후유뱀육수,2445,144,6,1,7,85.7%,41m
7282,3,minipig,2445,104,5,10,15,33.3%,21m
7282,1,hope,2445,88,1,5,6,16.7%,42m
7282,2,껍똘이아빠,2445,0,0,1,1,0.0%,22m
7286,2,라스트오리진,2444,126,4,3,7,57.1%,14m
7286,1,AustinSmith,2444,86,3,7,10,30.0%,16m
7286,2,FeelgoodMD,2444,130,3,7,10,30.0%,41m
7289,1,Merlin,2443,428,13,17,30,43.3%,16m
7289,1,DeadSnape,2443,157,4,7,11,36.4%,42m
7289,2,인덕원털보,2443,145,3,7,10,30.0%,18m
7292,1,[팡캐월령전]할래류야,2442,181,4,6,10,40.0%,16m
7292,2,zongeruge,2442,135,3,5,8,37.5%,18m
7292,2,小學弟,2442,0,1,0,1,100.0%,23m
7292,1,판다곰,2442,0,0,1,1,0.0%,18m
7296,1,마인중수,2441,687,63,67,130,48.5%,15m
7296,1,kkksky,2441,802,24,33,57,42.1%,16m
7296,1,jacky,2441,333,14,13,27,51.9%,42m
7299,2,앙기무띠,2440,0,2,3,5,40.0%,18m
7300,2,윤문섭흑인,2439,142,3,4,7,42.9%,18m
7300,1,레전드오브마린,2439,44,3,5,8,37.5%,42m
7302,1,sipp,2438,300,10,10,20,50.0%,42m
7302,1,하니,2438,192,4,7,11,36.4%,15m
7302,2,쿠크다스,2438,30,1,1,2,50.0%,23m
7302,2,willywu,2438,73,0,2,2,0.0%,22m
7306,3,isaacsu,2437,112,4,7,11,36.4%,17m
7306,2,[옹선생님]민시기입니다,2437,62,2,4,6,33.3%,22m
7306,2,레테퓨,2437,0,0,1,1,0.0%,18m
7309,2,[Aster]TripleS,2436,1546,63,111,174,36.2%,42m
7309,2,써노,2436,38,2,3,5,40.0%,22m
7309,2,EagleEye,2436,0,1,4,5,20.0%,18m
7312,2,하츠르기,2435,242,7,8,15,46.7%,23m
7312,1,Ceder,2435,0,1,0,1,100.0%,19m
7312,2,Matt,2435,0,0,1,1,0.0%,23m
7315,1,llllilll,2434,893,32,37,69,46.4%,15m
7315,2,[김태웅]KJTTY,2434,607,22,16,38,57.9%,22m
7315,1,곰보빵,2434,202,7,11,18,38.9%,42m
7318,1,HitGirl,2433,1114,41,41,82,50.0%,16m
7318,1,newone,2433,925,31,33,64,48.4%,16m
7318,2,IIIIIIIIIIII,2433,374,15,6,21,71.4%,42m
7318,2,[EZboYz]junmc,2433,255,8,12,20,40.0%,14m
7318,1,marlz,2433,30,1,6,7,14.3%,42m
7323,2,IlllIIIllIlI,2432,830,31,25,56,55.4%,42m
7323,1,海豚,2432,146,4,7,11,36.4%,15m
7323,2,zdhmrh,2432,0,1,0,1,100.0%,22m
7326,1,사행습성,2431,232,7,9,16,43.8%,42m
7326,1,Silverdeer,2431,223,7,12,19,36.8%,15m
7326,2,KDBwo,2431,68,3,2,5,60.0%,23m
7326,2,antonioluna,2431,34,1,3,4,25.0%,23m
7330,1,pjw,2429,263,7,9,16,43.8%,42m
7330,1,세수하면원빈,2429,112,4,5,9,44.4%,15m
7330,1,lelpleb,2429,142,3,3,6,50.0%,18m
7330,2,이것은태양을높게,2429,98,3,5,8,37.5%,23m
7330,1,lIlllIlllIIl,2429,96,2,2,4,50.0%,19m
7330,2,Wanax,2429,0,0,1,1,0.0%,42m
7336,3,제로센,2428,1143,45,55,100,45.0%,48m
7336,2,kola,2428,0,2,3,5,40.0%,18m
7336,1,차칸마법사,2428,48,1,2,3,33.3%,19m
7339,3,Sivraj,2427,0,1,0,1,100.0%,21m
7340,2,Haria,2426,352,12,12,24,50.0%,22m
7340,2,내가내다,2426,68,2,5,7,28.6%,42m
7340,1,이겜어떻게함,2426,0,1,3,4,25.0%,15m
7343,1,lalrivunga,2425,895,39,44,83,47.0%,15m
7343,1,매직테란,2425,579,20,24,44,45.5%,42m
7343,1,Ponytail,2425,424,15,12,27,55.6%,42m
7343,1,Dot,2425,179,5,7,12,41.7%,16m
7343,2,ReciProcity,2425,138,4,1,5,80.0%,14m
7343,2,kenki,2425,0,2,4,6,33.3%,18m
7343,2,스타하고싶은스타,2425,0,0,1,1,0.0%,18m
7350,2,웁님조아,2424,66,3,1,4,75.0%,42m
7350,1,롤스로이스,2424,0,3,4,7,42.9%,42m
7350,2,HaiYaa,2424,0,1,5,6,16.7%,42m
7350,2,[경기도양주]Deadpool,2424,32,1,7,8,12.5%,14m
7354,3,foxkyo,2423,1120,44,48,92,47.8%,43m
7354,2,[油脂硬性]黑龍手套,2423,468,18,18,36,50.0%,24m
7354,1,수도방위사령부,2423,221,16,17,33,48.5%,14m
7354,1,[자유의유산]oxygen,2423,70,2,9,11,18.2%,16m
7354,2,삶의힘,2423,0,0,2,2,0.0%,24m
7359,1,임무완료,2422,756,27,31,58,46.6%,15m
7359,2,一切靠運氣,2422,199,6,2,8,75.0%,23m
7359,2,소라카의큰바나나,2422,0,0,1,1,0.0%,42m
7359,2,삼국시대,2422,0,0,1,1,0.0%,42m
7363,2,Glitchie,2421,0,1,4,5,20.0%,18m
7363,2,[龍虎]검호,2421,0,0,1,1,0.0%,22m
7363,1,wowsugar,2421,0,0,4,4,0.0%,16m
7366,1,llllllIIllII,2420,1141,78,77,155,50.3%,16m
7366,1,딴지맨,2420,358,24,23,47,51.1%,16m
7366,1,최유준,2420,122,3,7,10,30.0%,20m
7366,2,카이지,2420,0,1,1,2,50.0%,22m
7366,2,소로,2420,0,1,4,5,20.0%,42m
7371,1,owo,2419,90,2,9,11,18.2%,16m
7372,2,모지래라,2418,570,20,25,45,44.4%,23m
7372,2,하악하악,2418,560,19,22,41,46.3%,22m
7372,1,mynameis,2418,346,14,21,35,40.0%,15m
7372,2,왕이예요,2418,278,9,10,19,47.4%,14m
7372,1,망고향,2418,70,4,7,11,36.4%,16m
7372,2,IssacPoster,2418,0,1,0,1,100.0%,23m
7372,1,Limus,2418,0,0,6,6,0.0%,42m
7379,2,小廢物,2417,946,40,36,76,52.6%,24m
7379,2,[CSO]BloodRayne,2417,0,1,4,5,20.0%,42m
7381,3,ErrdayGames,2416,468,15,23,38,39.5%,17m
7382,1,Juny,2415,539,19,22,41,46.3%,15m
7383,1,임날동,2414,116,4,6,10,40.0%,19m
7384,2,[我們是家人]叡哥,2413,0,0,1,1,0.0%,23m
7384,2,ToSsMe,2413,0,0,4,4,0.0%,22m
7386,2,cool,2411,844,32,35,67,47.8%,42m
7386,2,[ElsAna]초보입니다,2411,359,17,18,35,48.6%,22m
7386,1,괴물,2411,368,14,20,34,41.2%,15m
7386,2,[OlyM]Smarto,2411,0,0,1,1,0.0%,22m
7390,1,세젤예보현잉,2410,940,34,35,69,49.3%,14m
7390,3,[서울교대]초등사회과교육과,2410,182,7,11,18,38.9%,49m
7390,2,sdjcomender,2410,96,3,2,5,60.0%,18m
7390,2,Pretender,2410,0,1,3,4,25.0%,42m
7394,2,서정욱,2409,304,11,11,22,50.0%,23m
7394,2,[디시인사이드]Help,2409,64,3,2,5,60.0%,42m
7396,1,유헌수,2408,590,18,26,44,40.9%,15m
7396,2,JunLPM,2408,198,13,9,22,59.1%,14m
7396,2,KaRma,2408,148,6,5,11,54.5%,14m
7396,2,MissA,2408,149,4,5,9,44.4%,14m
7396,1,[독일국방군]솜콩이,2408,142,4,7,11,36.4%,42m
7401,1,lonerogue,2407,143,4,8,12,33.3%,19m
7401,1,[유즈맵떠돌이]SteponRed,2407,0,2,6,8,25.0%,20m
7401,2,[한대맞고]죽어라,2407,0,0,1,1,0.0%,14m
7404,2,鹽烤異化蟲,2406,104,3,4,7,42.9%,22m
7404,2,보원이덕,2406,0,0,1,1,0.0%,18m
7406,1,고주형,2405,670,29,20,49,59.2%,15m
7407,2,뮤탈점추배틀,2404,162,6,3,9,66.7%,23m
7407,2,NeoSoEpic,2404,57,2,3,5,40.0%,14m
7407,2,미니,2404,0,1,0,1,100.0%,42m
7410,2,[SS친위대]짱맨,2402,468,15,13,28,53.6%,23m
7410,2,volitic,2402,330,12,15,27,44.4%,42m
7410,2,저글링황제,2402,172,6,4,10,60.0%,14m
7410,2,[異化蟲公會]WAHAHA,2402,118,4,3,7,57.1%,42m
7410,1,lllllllllll,2402,0,2,5,7,28.6%,19m
7410,2,[싯가의유산]BlueDevil,2402,0,0,2,2,0.0%,22m
7416,3,akmnb,2401,1176,90,92,182,49.5%,17m
7416,2,세라장군,2401,86,4,1,5,80.0%,22m
7416,2,mher,2401,153,4,5,9,44.4%,22m
7416,2,내가군단이다,2401,97,2,5,7,28.6%,18m
7416,1,KABLI,2401,91,2,6,8,25.0%,16m
7421,1,Frog,2400,384,11,15,26,42.3%,15m
7421,2,zerg,2400,104,3,8,11,27.3%,23m
7421,1,AJaweed,2400,0,2,6,8,25.0%,19m
7424,2,apple,2399,92,3,6,9,33.3%,23m
7424,2,송승기,2399,0,2,4,6,33.3%,42m
7424,2,고등어,2399,0,1,5,6,16.7%,22m
7424,1,Borodino,2399,42,1,9,10,10.0%,15m
7424,2,골골,2399,0,0,1,1,0.0%,23m
7429,2,살려주세요,2398,174,6,8,14,42.9%,22m
7429,2,뚱이저그파워,2398,92,3,7,10,30.0%,18m
7429,2,미나리인권위원회,2398,0,0,1,1,0.0%,14m
7429,3,푸른눈의희대,2398,0,0,1,1,0.0%,20m
7433,1,haha,2397,1374,43,55,98,43.9%,16m
7433,1,腦洞大開,2397,538,20,17,37,54.1%,14m
7433,2,이베리코포풍,2397,533,18,16,34,52.9%,23m
7433,1,KoaTVGuo,2397,346,9,11,20,45.0%,20m
7433,2,EJUShaoShuai,2397,0,2,5,7,28.6%,18m
7433,2,SeoNo,2397,0,0,1,1,0.0%,22m
7439,2,Fiqren,2396,370,13,18,31,41.9%,22m
7439,2,llllllllllll,2396,0,1,3,4,25.0%,22m
7441,2,CheeseMao,2395,274,9,8,17,52.9%,42m
7441,1,TheLingKing,2395,92,4,10,14,28.6%,42m
7441,1,kuyog,2395,89,2,1,3,66.7%,42m
7441,2,Nightwish,2395,34,1,6,7,14.3%,24m
7445,2,MeKou,2394,595,31,35,66,47.0%,23m
7445,2,Galaxy,2394,290,10,9,19,52.6%,22m
7445,2,막걸리옥수수,2394,0,0,1,1,0.0%,18m
7445,2,[NODE]gaka,2394,0,0,3,3,0.0%,18m
7449,2,[SOTV]Silencer,2393,1090,80,85,165,48.5%,24m
7449,1,인생은커피맛,2393,193,5,7,12,41.7%,20m
7449,2,llllllllllll,2393,0,0,6,6,0.0%,18m
7452,3,[APinKK]William,2392,647,23,28,51,45.1%,49m
7452,2,테란,2392,0,0,1,1,0.0%,14m
7454,1,Pressup,2391,179,5,1,6,83.3%,20m
7454,2,챔프,2391,116,4,4,8,50.0%,23m
7454,2,장애우,2391,0,1,0,1,100.0%,18m
7457,2,[이교도]죠죠,2390,0,0,1,1,0.0%,22m
7458,2,아프리카두페,2389,628,24,23,47,51.1%,23m
7458,1,[미친광전사]jhik,2389,511,16,23,39,41.0%,45m
7460,2,tessadar,2386,1573,128,142,270,47.4%,42m
7460,2,oftenGGblind,2386,182,6,9,15,40.0%,42m
7460,2,데메투스,2386,0,0,1,1,0.0%,23m
7463,2,벌레새키,2385,241,8,13,21,38.1%,22m
7463,2,djlee,2385,0,1,4,5,20.0%,42m
7463,2,기본,2385,0,0,1,1,0.0%,42m
7463,2,fff,2385,0,0,2,2,0.0%,18m
7467,1,노무현슨상님,2384,184,9,10,19,47.4%,15m
7467,2,Jenloke,2384,185,5,8,13,38.5%,42m
7467,2,starship,2384,160,4,1,5,80.0%,42m
7467,3,eric,2384,96,1,1,2,50.0%,21m
7471,1,근혜수령님,2383,327,8,11,19,42.1%,20m
7471,2,[zAWSLz]阿森,2383,157,5,2,7,71.4%,23m
7471,2,瘋狂大進擊,2383,134,5,5,10,50.0%,14m
7471,2,Devilfish,2383,0,3,2,5,60.0%,18m
7471,2,[얼굴]minjjang,2383,30,2,1,3,66.7%,42m
7471,2,태사다르,2383,30,1,3,4,25.0%,23m
7477,1,[지약캐]나는누구일까요,2382,96,4,9,13,30.8%,15m
7477,2,땡땡땡,2382,110,3,3,6,50.0%,23m
7477,2,[cox2p]이세상이모양,2382,0,0,1,1,0.0%,18m
7480,3,Dora,2381,946,36,43,79,45.6%,43m
7480,2,푸딩이,2381,923,34,33,67,50.7%,23m
7480,2,[쫄깃함]엔돌핀,2381,148,6,5,11,54.5%,42m
7480,2,junls,2381,0,0,2,2,0.0%,42m
7484,2,아이치킨,2380,244,10,5,15,66.7%,23m
7484,2,vision,2380,204,7,8,15,46.7%,22m
7484,2,wolfrahm,2380,44,3,4,7,42.9%,18m
7484,1,임준호,2380,96,2,6,8,25.0%,14m
7488,2,[IFK]syakunetsu,2379,114,4,3,7,57.1%,14m
7488,2,서민,2379,112,3,1,4,75.0%,42m
7488,2,gkfl,2379,0,1,0,1,100.0%,14m
7491,2,여여영수,2378,0,2,3,5,40.0%,18m
7491,2,Takao,2378,0,1,0,1,100.0%,18m
7491,2,선비,2378,0,0,1,1,0.0%,42m
7494,2,수환아빠,2377,225,8,3,11,72.7%,42m
7494,2,mjb,2377,0,1,1,2,50.0%,23m
7496,2,BlessedG,2376,30,1,6,7,14.3%,22m
7496,2,kwakpo,2376,0,0,1,1,0.0%,14m
7498,2,Honggiltong,2375,1049,53,62,115,46.1%,23m
7498,2,고길동,2375,166,3,6,9,33.3%,18m
7500,3,gookenstein,2374,556,25,36,61,41.0%,17m
7500,1,鼓手打爆妳,2374,216,6,9,15,40.0%,20m
7502,2,robin,2373,44,5,3,8,62.5%,18m
7502,2,DujekOnearm,2373,131,3,5,8,37.5%,18m
7502,2,힐링받음,2373,66,2,5,7,28.6%,24m
7502,2,한도대기중,2373,0,0,1,1,0.0%,42m
7506,2,Raiderz,2372,383,22,24,46,47.8%,24m
7506,1,[해병대]생새우초밥,2372,96,2,9,11,18.2%,19m
7506,2,DonFecalio,2372,93,1,5,6,16.7%,18m
7509,1,Despair,2371,277,11,20,31,35.5%,42m
7509,2,gaia,2371,262,7,6,13,53.8%,23m
7509,2,[sc2mc]MrHung,2371,0,1,4,5,20.0%,42m
7509,2,날빌장인,2371,0,0,1,1,0.0%,23m
7513,2,aries,2370,408,16,9,25,64.0%,23m
7513,2,紅茶,2370,375,14,17,31,45.2%,22m
7513,1,kimjinyoung,2370,108,6,11,17,35.3%,15m
7516,2,준위,2369,471,15,19,34,44.1%,22m
7516,1,Stefanenkov,2369,142,5,10,15,33.3%,19m
7516,2,lybjoy,2369,60,2,5,7,28.6%,23m
7519,1,asesome,2368,1188,43,45,88,48.9%,14m
7519,1,天安門,2368,731,23,36,59,39.0%,14m
7519,1,HighNite,2368,136,6,9,15,40.0%,20m
7519,1,KFC,2368,148,4,6,10,40.0%,20m
7519,3,crazystone,2368,0,1,4,5,20.0%,17m
7524,1,llllllllllll,2367,1308,215,244,459,46.8%,16m
7524,2,kasho,2367,308,11,14,25,44.0%,42m
7524,1,tjrdud,2367,293,10,8,18,55.6%,16m
7524,2,그냥게임하는사람,2367,270,9,6,15,60.0%,22m
7524,2,저그장인,2367,0,1,0,1,100.0%,42m
7529,1,하유선,2366,1580,67,70,137,48.9%,42m
7529,2,설미호,2366,263,8,10,18,44.4%,42m
7529,2,LEGOBOX,2366,164,5,1,6,83.3%,14m
7529,1,[존못들]지방대학교,2366,147,5,11,16,31.2%,15m
7529,2,Naiard,2366,0,1,3,4,25.0%,14m
7534,2,리틀썬,2365,630,22,21,43,51.2%,23m
7534,1,[스토리메이커]컴컴컴,2365,60,4,7,11,36.4%,42m
7534,2,[한클랜]Gonghyeonuk,2365,0,1,1,2,50.0%,22m
7537,1,tyomintz,2364,246,10,12,22,45.5%,42m
7537,2,Pleng,2364,158,4,1,5,80.0%,22m
7537,2,고대저그,2364,48,2,2,4,50.0%,18m
7540,1,바꿧다이름,2363,1655,171,182,353,48.4%,16m
7540,3,박쥐대부엉이,2363,0,2,3,5,40.0%,17m
7540,2,Peanut,2363,0,0,2,2,0.0%,18m
7543,1,쪼코우유,2360,904,30,43,73,41.1%,16m
7543,2,샌드롭,2360,134,6,6,12,50.0%,18m
7543,2,[33업찍고감]별똥별,2360,150,5,9,14,35.7%,22m
7543,2,길리슈트,2360,116,3,1,4,75.0%,14m
7543,1,Bane,2360,96,2,4,6,33.3%,19m
7543,1,[공주님]흑왕,2360,60,2,9,11,18.2%,15m
7549,1,GRAVES,2359,460,23,28,51,45.1%,15m
7549,2,게맛살,2359,228,11,1,12,91.7%,42m
7549,2,이방인,2359,62,2,2,4,50.0%,22m
7549,2,무뇌봉동무,2359,30,1,3,4,25.0%,42m
7549,1,llllllllllll,2359,0,0,1,1,0.0%,19m
7554,2,일등강쥐,2358,0,0,2,2,0.0%,18m
7555,2,lIIIlIIlIlII,2357,1183,80,99,179,44.7%,23m
7555,1,NightWish,2357,427,16,26,42,38.1%,15m
7555,2,llllllllllll,2357,0,1,0,1,100.0%,23m
7555,2,MAX,2357,0,0,1,1,0.0%,42m
7555,2,awdsf,2357,0,0,1,1,0.0%,18m
7560,1,Killer,2356,360,13,21,34,38.2%,15m
7561,1,나못함봐주셈,2355,1643,104,109,213,48.8%,14m
7561,2,꾀돌이,2355,424,17,17,34,50.0%,22m
7561,2,boss,2355,219,7,6,13,53.8%,14m
7561,2,굴라임,2355,96,1,2,3,33.3%,42m
7561,2,IlIlIlIlIlIl,2355,0,0,1,1,0.0%,18m
7566,1,임회장,2354,365,14,14,28,50.0%,24m
7566,2,chris,2354,180,9,5,14,64.3%,42m
7566,2,너죽고나살자,2354,262,9,17,26,34.6%,43m
7566,2,[싱싱한뉴비]장의사,2354,88,2,3,5,40.0%,42m
7570,3,TotalPenguin,2353,286,10,13,23,43.5%,21m
7570,2,[병신들모임]가브리엘라,2353,252,8,12,20,40.0%,42m
7570,2,Garnet,2353,132,4,6,10,40.0%,14m
7570,2,누셀넘버,2353,70,2,6,8,25.0%,22m
7570,2,[KRSC2]BookBox,2353,0,0,1,1,0.0%,22m
7575,1,[SEAL]스타초보자,2352,168,4,10,14,28.6%,19m
7576,1,IIIIIIIIIIII,2351,1547,85,86,171,49.7%,15m
7576,2,Infernal,2351,712,23,31,54,42.6%,23m
7576,1,김은구,2351,261,6,9,15,40.0%,19m
7576,1,[먹이사슬]한재진,2351,46,2,7,9,22.2%,42m
7580,3,앵커맨,2350,1438,312,337,649,48.1%,43m
7580,1,FellElephant,2350,1533,75,86,161,46.6%,15m
7580,2,[ROKU]졸림곰,2350,0,0,1,1,0.0%,22m
7583,2,momilibavo,2349,0,3,2,5,60.0%,42m
7584,2,협곡에정령,2348,0,1,4,5,20.0%,42m
7584,2,지화니,2348,0,0,1,1,0.0%,22m
7586,2,Frank,2347,62,2,6,8,25.0%,24m
7586,3,황진영,2347,0,2,7,9,22.2%,43m
7586,3,[프로토스협회]아바투로,2347,0,0,1,1,0.0%,18m
7589,2,오쌍,2346,154,6,5,11,54.5%,23m
7589,3,IDEA,2346,0,0,1,1,0.0%,17m
7591,2,똥쾌한짜씩,2345,403,15,9,24,62.5%,23m
7591,2,[이카르스M]이카루스,2345,124,3,3,6,50.0%,42m
7591,2,洨醜男,2345,68,3,3,6,50.0%,22m
7594,1,[뭐야돌려줘요]쌈장,2344,1049,33,40,73,45.2%,42m
7594,2,정무아빠감스트,2344,30,2,2,4,50.0%,14m
7594,2,루터킹,2344,99,1,3,4,25.0%,22m
7597,2,Daddy,2343,234,8,13,21,38.1%,42m
7597,2,ORNNMASTER,2343,0,0,2,2,0.0%,14m
7599,3,JOKER,2342,1428,282,294,576,49.0%,43m
7599,2,[비트]ahjahahjah,2342,582,24,19,43,55.8%,42m
7599,2,ChesDale,2342,146,3,2,5,60.0%,14m
7599,2,sai,2342,30,2,1,3,66.7%,22m
7599,2,Huwawee,2342,0,2,3,5,40.0%,23m
7604,2,ohdugi,2340,504,19,16,35,54.3%,42m
7605,2,어떡해든됨,2338,325,13,9,22,59.1%,24m
7605,2,[異化蟲公會]木質地板,2338,49,5,6,11,45.5%,23m
7605,3,[ElsAna]SHOWyourself,2338,0,0,1,1,0.0%,18m
7608,2,lIlIlIlIlIlI,2337,297,11,10,21,52.4%,22m
7608,2,누군가,2337,30,2,5,7,28.6%,42m
7608,1,CaptHusky,2337,0,2,5,7,28.6%,16m
7611,1,cruelR,2336,1655,81,86,167,48.5%,16m
7611,2,SUNGD,2336,166,5,3,8,62.5%,22m
7611,2,놀장강,2336,0,0,1,1,0.0%,22m
7614,2,감자감자고구마,2335,578,23,20,43,53.5%,42m
7614,2,[ZagBra]머털도사,2335,62,3,3,6,50.0%,23m
7614,2,chw,2335,0,2,5,7,28.6%,18m
7617,1,퀴프아크,2334,1040,36,44,80,45.0%,15m
7617,2,ForbiddenUSB,2334,191,6,3,9,66.7%,42m
7619,1,Special,2333,344,11,16,27,40.7%,42m
7619,2,Prank,2333,198,10,9,19,52.6%,22m
7619,2,준스준스빵빵이,2333,168,7,14,21,33.3%,14m
7619,1,[CIA암살단]overthetop,2333,264,7,16,23,30.4%,42m
7619,1,OwO,2333,214,6,14,20,30.0%,17m
7619,2,돼지불백이승우,2333,88,1,2,3,33.3%,42m
7625,2,[SC2]를르슈,2332,0,1,4,5,20.0%,24m
7625,2,Gamebler,2332,0,0,1,1,0.0%,24m
7627,2,Nothing,2331,152,7,8,15,46.7%,42m
7628,1,[凸凸凸凸凸]choieunseok,2330,1440,272,277,549,49.5%,45m
7628,2,[BOB]Fomula,2330,672,31,35,66,47.0%,23m
7628,1,[df233]vegetable,2330,654,21,31,52,40.4%,16m
7631,2,Lily,2329,987,62,68,130,47.7%,23m
7631,2,soyeom,2329,0,0,1,1,0.0%,14m
7633,2,Holysmokes,2328,116,2,5,7,28.6%,19m
7633,2,ksw,2328,0,0,3,3,0.0%,23m
7635,2,매일우유,2327,601,22,21,43,51.2%,24m
7635,2,WON,2327,220,5,6,11,45.5%,18m
7635,2,퍼즐,2327,0,0,1,1,0.0%,23m
7635,2,전사,2327,0,0,1,1,0.0%,18m
7639,2,헤파팍스,2325,146,4,8,12,33.3%,42m
7639,2,zoozoo,2325,0,0,1,1,0.0%,42m
7641,2,THE,2324,187,7,5,12,58.3%,23m
7642,3,제임스,2323,1310,168,184,352,47.7%,49m
7642,2,PuzsyCat,2323,185,4,7,11,36.4%,18m
7644,2,lililililili,2322,270,9,11,20,45.0%,22m
7644,2,maksimus,2322,325,8,15,23,34.8%,22m
7644,2,admiralwafuh,2322,319,8,16,24,33.3%,14m
7644,2,Ariaseverdin,2322,148,6,7,13,46.2%,14m
7644,2,ShinYeh,2322,164,6,15,21,28.6%,23m
7644,2,yhk,2322,182,5,5,10,50.0%,42m
7644,2,허밍버드,2322,0,1,4,5,20.0%,42m
7651,2,MikeTroutS,2320,0,1,2,3,33.3%,42m
7652,2,dwig,2319,88,1,2,3,33.3%,42m
7653,1,khoa,2318,187,6,10,16,37.5%,20m
7653,2,사도요한,2318,0,2,4,6,33.3%,22m
7653,2,[디케이드]FakeZero,2318,88,1,1,2,50.0%,14m
7656,2,Computer,2317,153,3,6,9,33.3%,42m
7656,2,역사선구자,2317,88,1,1,2,50.0%,23m
7658,3,Yeh,2316,292,11,12,23,47.8%,21m
7659,2,iksseiii,2314,0,1,4,5,20.0%,42m
7660,1,Gekko,2313,220,8,12,20,40.0%,42m
7660,2,aviation,2313,148,5,12,17,29.4%,23m
7660,1,캐장군,2313,96,3,2,5,60.0%,20m
7663,1,월아천충,2312,138,6,11,17,35.3%,42m
7663,2,umjetink,2312,163,5,4,9,55.6%,23m
7663,2,[우린호구다]여눠,2312,0,1,0,1,100.0%,14m
7663,2,[정말데단해]스타신,2312,0,1,4,5,20.0%,42m
7663,2,Ymir,2312,0,1,6,7,14.3%,23m
7668,2,[원피스]kaisarMvP,2311,721,86,101,187,46.0%,24m
7668,1,IIIIIIIIIIII,2311,386,15,15,30,50.0%,42m
7668,2,[DPW]JAY,2311,96,2,4,6,33.3%,23m
7668,2,TrashPitbull,2311,0,2,5,7,28.6%,18m
7668,2,ZergForever,2311,0,1,4,5,20.0%,22m
7668,2,천연라임향,2311,0,0,2,2,0.0%,22m
7674,2,IIIIIIIIIIII,2310,121,3,6,9,33.3%,42m
7674,2,영서꺼,2310,0,1,4,5,20.0%,42m
7676,2,[똑띠해라]WorldAffairs,2309,662,51,49,100,51.0%,14m
7676,2,MrT,2309,593,35,38,73,47.9%,22m
7676,2,개못하네,2309,257,8,9,17,47.1%,42m
7676,2,Serral,2309,0,1,5,6,16.7%,18m
7680,2,내어깨위고양이밥,2308,939,33,49,82,40.2%,48m
7680,2,[oxox]ZooM,2308,127,3,4,7,42.9%,18m
7680,2,[정화하리라]푸른사신,2308,137,3,7,10,30.0%,42m
7680,2,최대영,2308,0,1,0,1,100.0%,22m
7680,2,[SlGN]priester,2308,0,0,1,1,0.0%,23m
7685,2,아이스,2307,384,14,19,33,42.4%,24m
7685,2,시골농부,2307,268,10,17,27,37.0%,42m
7687,2,[ECLS]yoonddo,2306,708,28,25,53,52.8%,42m
7688,2,[고구려만세]엔마아이,2305,333,14,8,22,63.6%,42m
7688,3,星神,2305,0,0,1,1,0.0%,17m
7690,1,부메랑,2304,1629,293,325,618,47.4%,15m
7690,2,llllllllllll,2304,34,3,4,7,42.9%,22m
7690,3,BIGCHEeZY,2304,0,2,3,5,40.0%,22m
7690,2,MarineBoy,2304,58,2,5,7,28.6%,23m
7690,1,Genetic,2304,0,0,1,1,0.0%,20m
7695,2,캡틴썬희,2303,989,58,61,119,48.7%,23m
7695,3,강건,2303,0,1,4,5,20.0%,41m
7697,2,麻糬愛搗蛋,2302,1531,235,259,494,47.6%,14m
7697,2,bigdaddy,2302,370,14,12,26,53.8%,24m
7697,3,apple,2302,192,7,12,19,36.8%,43m
7697,2,돌구킹,2302,48,2,6,8,25.0%,18m
7697,2,Malamute,2302,0,1,5,6,16.7%,42m
7702,2,llIIlll,2301,178,7,10,17,41.2%,22m
7702,1,상추카운터배추,2301,0,1,1,2,50.0%,20m
7704,1,무적함대테란,2300,954,82,90,172,47.7%,16m
7704,2,Silencerx,2300,30,2,8,10,20.0%,24m
7704,2,얼짱민정,2300,36,1,5,6,16.7%,42m
7704,1,Ferrari,2300,0,0,1,1,0.0%,20m
7704,3,allen,2300,0,0,1,1,0.0%,20m
7704,2,카재,2300,0,0,2,2,0.0%,22m
7710,3,GIGABYTE,2299,747,31,21,52,59.6%,22m
7710,2,Asura,2299,88,2,1,3,66.7%,42m
7710,2,[IGD]갓승훈,2299,0,2,4,6,33.3%,42m
7713,3,MetalSlug,2298,0,0,1,1,0.0%,37m
7714,2,PMA,2297,319,16,14,30,53.3%,42m
7714,2,전제현,2297,0,1,5,6,16.7%,42m
7714,3,bokunopico,2297,0,0,1,1,0.0%,20m
7714,2,을문지덕,2297,0,0,3,3,0.0%,14m
7718,2,小民,2296,1451,114,139,253,45.1%,24m
7718,1,DJGO,2296,1634,61,73,134,45.5%,42m
7720,1,런처,2295,982,95,106,201,47.3%,16m
7720,2,TheEnigma,2295,30,4,2,6,66.7%,42m
7720,1,KFC,2295,96,3,8,11,27.3%,20m
7720,2,[NGameS]이리꾹,2295,121,2,2,4,50.0%,24m
7720,3,[고아쉐끼]wkssdf,2295,0,0,1,1,0.0%,18m
7725,1,미소,2294,215,7,13,20,35.0%,19m
7725,2,dAgger,2294,130,2,2,4,50.0%,18m
7725,3,ChogosuSc,2294,0,1,0,1,100.0%,22m
7725,2,NuClearSKY,2294,0,1,1,2,50.0%,23m
7729,2,ToTo,2293,92,6,15,21,28.6%,14m
7729,2,[인공지능보통]미네랄캐기,2293,30,1,4,5,20.0%,14m
7731,2,[ECLS]여우비가오던봄,2292,326,11,11,22,50.0%,42m
7731,3,안성탕,2292,188,9,5,14,64.3%,20m
7731,2,심판,2292,0,1,6,7,14.3%,18m
7731,3,이지안,2292,0,0,3,3,0.0%,41m
7735,2,스타고양이,2291,30,1,4,5,20.0%,42m
7735,2,물방개,2291,0,0,2,2,0.0%,24m
7735,1,[즐겜러]군단의심장,2291,0,0,3,3,0.0%,20m
7738,1,뽀통령,2290,245,6,12,18,33.3%,42m
7738,3,llllllllllll,2290,30,2,2,4,50.0%,21m
7738,1,為何不懂,2290,0,0,2,2,0.0%,20m
7741,2,Regoria,2289,106,4,6,10,40.0%,22m
7742,2,葉老盃,2287,259,9,9,18,50.0%,24m
7742,2,Skyline,2287,0,1,1,2,50.0%,18m
7742,3,[WOLI]낚인참치,2287,30,1,1,2,50.0%,21m
7745,2,방사능고등어,2286,839,50,52,102,49.0%,14m
7745,2,Fenrir,2286,30,2,2,4,50.0%,23m
7745,2,kingdie,2286,0,1,1,2,50.0%,23m
7748,1,das,2285,1540,117,121,238,49.2%,42m
7748,1,GreatDaddy,2285,353,9,14,23,39.1%,19m
7748,2,Zella,2285,214,6,11,17,35.3%,23m
7748,2,호우호우,2285,144,4,4,8,50.0%,23m
7748,2,Honk,2285,0,1,5,6,16.7%,42m
7753,2,좋은단백질원,2284,815,29,32,61,47.5%,23m
7753,2,머리조심,2284,495,19,22,41,46.3%,23m
7755,2,[星辰]North,2283,506,16,24,40,40.0%,24m
7755,3,둔타형,2283,216,7,11,18,38.9%,22m
7755,2,COCO,2283,0,0,1,1,0.0%,18m
7758,2,샤넬꾸찌,2282,168,6,4,10,60.0%,42m
7758,1,봐주셔여,2282,0,0,2,2,0.0%,20m
7760,3,야시리,2281,0,0,1,1,0.0%,41m
7760,2,서태웅,2281,0,0,1,1,0.0%,18m
7760,3,Fain,2281,0,0,5,5,0.0%,17m
7763,2,아스널,2280,116,4,3,7,57.1%,23m
7763,3,VroomVroom,2280,0,0,3,3,0.0%,17m
7765,2,demonixc,2279,88,2,2,4,50.0%,19m
7766,2,[Grubby]FlameoN,2278,592,21,37,58,36.2%,42m
7766,3,thank,2278,176,7,5,12,58.3%,21m
7766,1,pakachu,2278,138,6,12,18,33.3%,42m
7766,1,태풍,2278,172,5,10,15,33.3%,43m
7766,2,SEVEN,2278,30,1,5,6,16.7%,24m
7766,2,말파이트,2278,0,0,2,2,0.0%,18m
7772,3,김현진,2277,0,1,2,3,33.3%,17m
7772,3,將軍,2277,0,0,3,3,0.0%,17m
7774,2,[더붉은공산당]lllllllllll,2276,0,0,2,2,0.0%,18m
7775,3,닉네임뭐하지,2275,0,0,5,5,0.0%,20m
7776,3,빈이들,2274,118,5,4,9,55.6%,22m
7776,2,Marcos,2274,0,0,4,4,0.0%,42m
7778,2,asdf,2273,125,10,13,23,43.5%,23m
7779,2,soulk,2272,342,12,15,27,44.4%,22m
7780,2,매인,2271,1545,160,199,359,44.6%,22m
7780,3,myeunil,2271,198,7,6,13,53.8%,21m
7780,3,Sam,2271,140,5,2,7,71.4%,22m
7783,2,[생마린]hwang,2270,143,3,8,11,27.3%,18m
7783,3,커피물조절장인,2270,0,0,1,1,0.0%,21m
7785,2,MAS,2269,1539,52,68,120,43.3%,42m
7786,2,효퇘지암살작전,2267,102,6,7,13,46.2%,42m
7787,2,살려줘,2266,384,14,16,30,46.7%,22m
7787,3,창천항로,2266,108,4,5,9,44.4%,21m
7787,2,亂彈琴呆呆,2266,0,1,1,2,50.0%,18m
7787,3,rareavis,2266,0,0,1,1,0.0%,37m
7791,1,기몽식,2265,604,21,27,48,43.8%,42m
7791,3,doonder,2265,0,1,5,6,16.7%,37m
7793,3,공격형,2264,200,8,4,12,66.7%,21m
7793,2,iwillkillyou,2264,254,8,13,21,38.1%,22m
7793,2,abcde,2264,190,7,10,17,41.2%,42m
7796,3,BleuOceane,2263,166,7,6,13,53.8%,42m
7796,1,[OKRAN]아뇨뚱인데요,2263,160,7,9,16,43.8%,42m
7796,2,KingOfWar,2263,0,1,3,4,25.0%,23m
7796,2,[WYS]AURI,2263,0,0,1,1,0.0%,18m
7796,2,dsa,2263,0,0,1,1,0.0%,19m
7801,2,Xteg,2262,390,14,16,30,46.7%,23m
7801,1,ASHPLAYER,2262,403,13,20,33,39.4%,43m
7801,1,[군단병]카이바코퍼레이션,2262,0,0,1,1,0.0%,20m
7804,3,TEHlerVtN,2261,86,8,7,15,53.3%,21m
7804,1,Behemot,2261,188,4,7,11,36.4%,20m
7804,2,小小,2261,146,3,7,10,30.0%,23m
7804,3,KJKMARI,2261,30,2,0,2,100.0%,21m
7804,2,Proy,2261,0,2,7,9,22.2%,18m
7809,3,레이너특공대,2260,58,3,1,4,75.0%,22m
7810,2,johnwalker,2259,709,106,136,242,43.8%,14m
7810,3,[해양경비대]아르타니스,2259,198,7,11,18,38.9%,21m
7810,1,kky,2259,0,4,4,8,50.0%,42m
7810,3,[RELAK]qqq,2259,0,0,2,2,0.0%,21m
7814,2,[유파광]PIXIED,2258,435,18,23,41,43.9%,23m
7814,2,Asinori,2258,0,0,1,1,0.0%,19m
7816,3,bill,2257,30,1,5,6,16.7%,21m
7817,1,Continue,2256,86,5,9,14,35.7%,42m
7817,3,Pacificgamer,2256,86,3,3,6,50.0%,21m
7817,3,빼액,2256,0,2,0,2,100.0%,18m
7817,3,markman,2256,0,1,1,2,50.0%,41m
7821,1,libik,2255,30,3,7,10,30.0%,42m
7821,3,야린왕자,2255,62,2,4,6,33.3%,21m
7821,2,케리건,2255,0,1,5,6,16.7%,22m
7824,2,유현종옹지,2254,158,5,9,14,35.7%,22m
7824,3,Berserker,2254,58,3,0,3,100.0%,21m
7826,3,[지나간하루]지나간루,2253,58,3,3,6,50.0%,21m
7826,3,manseok,2253,60,2,5,7,28.6%,22m
7826,2,찰리진,2253,0,1,7,8,12.5%,18m
7829,2,htviva,2252,113,3,2,5,60.0%,42m
7830,2,Stormedge,2250,379,25,22,47,53.2%,23m
7830,2,반지아,2250,118,5,7,12,41.7%,14m
7830,2,[비율실화냐]IRENE,2250,102,4,4,8,50.0%,14m
7830,3,[ECLS]MooN,2250,0,1,1,2,50.0%,42m
7830,2,RobSui,2250,0,0,1,1,0.0%,19m
7835,2,Kareltjie,2249,242,11,18,29,37.9%,23m
7835,2,[sc2mc]hymenbuster,2249,0,1,5,6,16.7%,42m
7837,3,rangshi,2248,142,6,2,8,75.0%,22m
7838,2,渡渣,2247,1518,305,350,655,46.6%,23m
7838,2,[日本]IIIIIIIIIIII,2247,91,1,3,4,25.0%,19m
7838,1,쵸우찡,2247,96,1,4,5,20.0%,19m
7841,2,PARKDEKlNW,2246,778,30,32,62,48.4%,23m
7842,2,스노우스타일,2245,150,5,13,18,27.8%,22m
7842,1,RAINING,2245,36,3,8,11,27.3%,42m
7842,3,백호선,2245,0,0,1,1,0.0%,42m
7845,2,탐존,2244,88,2,1,3,66.7%,42m
7846,3,[Aoueja]송장벌레,2243,30,2,0,2,100.0%,21m
7846,2,WTF,2243,0,1,5,6,16.7%,24m
7846,2,[Mist]까악,2243,0,0,5,5,0.0%,23m
7849,2,[조직]알코미,2242,1066,41,46,87,47.1%,23m
7849,3,범이올시다,2242,465,18,22,40,45.0%,21m
7849,3,Drims,2242,189,5,5,10,50.0%,22m
7849,2,TeamA,2242,0,0,1,1,0.0%,18m
7849,3,[教我玩3族]萬軍之督,2242,0,0,3,3,0.0%,21m
7854,2,Morp,2241,131,3,7,10,30.0%,19m
7854,2,[독일국방군]백호,2241,0,1,5,6,16.7%,24m
7856,3,Azazoth,2240,0,1,6,7,14.3%,37m
7857,1,닉넴없음,2239,48,4,8,12,33.3%,19m
7857,2,naters,2239,113,3,8,11,27.3%,18m
7857,3,hippro,2239,0,0,2,2,0.0%,18m
7860,3,Yera,2238,393,13,9,22,59.1%,21m
7860,3,Alpha,2238,88,3,3,6,50.0%,21m
7860,3,Leo,2238,0,1,0,1,100.0%,42m
7860,3,PelPuska,2238,30,1,4,5,20.0%,21m
7860,2,한빈쓰,2238,0,1,5,6,16.7%,42m
7865,2,[NoME]tomatococo,2237,989,35,42,77,45.5%,42m
7866,3,[sc2mc]힐리온,2236,1150,52,57,109,47.7%,21m
7866,3,devank,2236,1051,43,50,93,46.2%,21m
7866,2,이강준,2236,193,4,9,13,30.8%,23m
7866,3,miguel,2236,90,3,3,6,50.0%,22m
7866,3,스타맨,2236,0,0,2,2,0.0%,21m
7871,2,Espoir,2234,90,2,7,9,22.2%,18m
7872,3,[공포는환상]유머인나,2233,0,1,0,1,100.0%,22m
7873,3,[포방부]광주맹스크,2232,30,2,1,3,66.7%,41m
7874,2,Asav,2231,1525,108,131,239,45.2%,14m
7874,2,찬우바라기,2231,114,3,6,9,33.3%,14m
7874,2,[맛있더라]ForEveR,2231,0,1,3,4,25.0%,42m
7877,3,kspsss,2230,88,4,4,8,50.0%,20m
7878,2,엠페러나폴레옹,2229,419,25,24,49,51.0%,22m
7878,2,DelPhi,2229,240,9,11,20,45.0%,23m
7878,2,熱狗指揮官,2229,134,5,4,9,55.6%,19m
7881,2,Santiago,2228,490,18,20,38,47.4%,23m
7882,3,[電磁學]時曲同學,2227,0,0,1,1,0.0%,37m
7883,1,焉焉,2226,662,20,33,53,37.7%,16m
7883,2,阿震,2226,58,3,8,11,27.3%,42m
7883,2,푸딩서,2226,0,0,2,2,0.0%,42m
7886,3,맛이있는콜라,2225,121,3,4,7,42.9%,21m
7886,3,PUNGSHIN,2225,60,2,3,5,40.0%,21m
7886,3,joseisamurai,2225,0,1,4,5,20.0%,21m
7889,3,키레트키,2224,90,3,3,6,50.0%,21m
7889,3,nathan,2224,0,3,3,6,50.0%,42m
7889,2,IIIIIIIIIIII,2224,30,2,6,8,25.0%,42m
7892,3,스타접수하러옴,2223,0,1,1,2,50.0%,22m
7892,3,글로드바,2223,42,1,1,2,50.0%,17m
7894,3,피바다,2222,0,0,4,4,0.0%,21m
7895,2,星海都被韓國人虐,2221,88,3,6,9,33.3%,42m
7896,3,[어윤수님개쩜]공의가저죽여요,2220,319,14,8,22,63.6%,42m
7897,1,꼬미,2217,210,7,13,20,35.0%,20m
7897,3,lIIllIllllIl,2217,0,1,1,2,50.0%,21m
7899,1,어어어어,2216,60,4,10,14,28.6%,42m
7899,3,PaulA,2216,0,2,3,5,40.0%,37m
7899,3,어지러운도적,2216,0,0,1,1,0.0%,18m
7899,3,통큰대장부,2216,0,0,2,2,0.0%,21m
7899,2,촉촉하게만들쥐,2216,0,0,3,3,0.0%,18m
7904,2,테란컨트롤러,2215,570,22,25,47,46.8%,42m
7904,2,망고맛완두콩,2215,300,9,15,24,37.5%,14m
7904,1,woofydawgx,2215,227,5,5,10,50.0%,20m
7907,2,Xinyiu,2214,855,31,47,78,39.7%,42m
7907,3,rlaxorb,2214,243,7,11,18,38.9%,21m
7907,3,dddd,2214,0,1,0,1,100.0%,42m
7907,3,CanisLupus,2214,0,1,1,2,50.0%,22m
7907,2,[l암살단l]Silence,2214,0,1,7,8,12.5%,42m
7912,2,린손훌오로시르뤰,2213,1531,193,220,413,46.7%,47m
7912,3,페미니스트김형섭,2213,544,21,26,47,44.7%,22m
7914,3,[너의ol름은]sunki,2212,377,14,12,26,53.8%,22m
7914,2,[안티신개미]아빠아빠아들,2212,141,3,9,12,25.0%,18m
7916,1,[쫄깃함]다리장인뚜기,2211,88,3,7,10,30.0%,42m
7916,3,지능피자,2211,0,1,0,1,100.0%,22m
7916,3,ErwinRommel,2211,0,0,1,1,0.0%,21m
7919,2,아랑승민,2210,615,22,33,55,40.0%,15m
7919,3,JoHuiJe,2210,380,14,18,32,43.8%,22m
7919,3,[호놀롤로]jangkoon,2210,176,8,6,14,57.1%,37m
7919,3,RONAK,2210,0,0,1,1,0.0%,21m
7923,3,티케이,2209,795,34,41,75,45.3%,21m
7923,1,[sc2mc]Flaxen,2209,536,18,28,46,39.1%,42m
7925,3,전기기능장,2208,178,7,6,13,53.8%,21m
7925,3,DAGULI,2208,0,1,5,6,16.7%,21m
7927,2,데미소다,2207,198,5,6,11,45.5%,19m
7928,1,장기전만한다,2206,950,46,56,102,45.1%,16m
7928,2,아크펠로우마트,2206,196,6,16,22,27.3%,22m
7928,3,김종섭,2206,30,2,0,2,100.0%,21m
7931,1,[무한김준현]Landen,2204,1294,48,63,111,43.2%,42m
7931,2,Couth,2204,0,1,0,1,100.0%,18m
7931,3,Luke,2204,0,1,4,5,20.0%,41m
7931,2,Gargantua,2204,0,1,6,7,14.3%,42m
7931,3,구백이,2204,0,0,1,1,0.0%,21m
7936,2,lmsgenius,2203,1540,108,153,261,41.4%,44m
7936,3,스타랭,2203,96,3,8,11,27.3%,21m
7936,3,[브리티안]lllllllll,2203,30,2,2,4,50.0%,22m
7939,2,space,2201,412,14,24,38,36.8%,15m
7939,2,lllIIIl,2201,136,4,7,11,36.4%,18m
7939,3,나는못해서진다,2201,30,2,0,2,100.0%,18m
7942,2,바실리우스,2199,394,13,19,32,40.6%,42m
7942,2,qkrwlgh,2199,92,3,6,9,33.3%,18m
7942,3,TheMexican,2199,30,2,4,6,33.3%,20m
7945,3,[HDCore]불꽃,2198,287,9,14,23,39.1%,21m
7945,3,亼巨卜乙,2198,0,0,5,5,0.0%,41m
7947,2,[게임플레이]Who,2197,190,7,13,20,35.0%,24m
7948,3,SyLAR,2196,58,2,2,4,50.0%,21m
7949,1,[스타크]iiOvOii,2195,96,3,2,5,60.0%,20m
7949,1,[테저프]원붕,2195,92,2,3,5,40.0%,19m
7949,3,BantaiSemua,2195,0,2,4,6,33.3%,21m
7949,3,earthless,2195,0,0,1,1,0.0%,22m
7949,3,마루밑먼지,2195,0,0,2,2,0.0%,21m
7954,2,poohno,2194,248,9,11,20,45.0%,42m
7954,3,이지,2194,30,2,1,3,66.7%,21m
7954,3,Ddeathgun,2194,0,1,4,5,20.0%,21m
7954,3,Shiro,2194,0,1,5,6,16.7%,20m
7958,2,FLJW,2193,524,20,19,39,51.3%,23m
7958,3,maktup,2193,118,5,8,13,38.5%,21m
7958,3,농마고박격포,2193,36,2,0,2,100.0%,18m
7958,3,마무도날막지못해,2193,44,2,5,7,28.6%,41m
7958,2,시운디,2193,0,1,6,7,14.3%,19m
7963,2,용짱,2192,46,2,5,7,28.6%,18m
7963,2,Alex,2192,0,0,1,1,0.0%,18m
7965,3,sevenblue,2191,508,19,18,37,51.4%,20m
7966,3,Aurore,2190,618,64,78,142,45.1%,20m
7966,2,Fyr,2190,433,15,18,33,45.5%,24m
7966,1,미미즈쿠류,2190,230,8,12,20,40.0%,42m
7969,3,EZZIGG,2189,578,18,45,63,28.6%,20m
7969,3,ajtwoddl,2189,250,8,14,22,36.4%,21m
7971,3,rtertertert,2188,1535,84,111,195,43.1%,37m
7971,3,쑤인이다,2188,794,29,34,63,46.0%,22m
7971,3,NiceGuy,2188,260,9,12,21,42.9%,41m
7971,3,작은마린이맵다,2188,30,1,1,2,50.0%,21m
7971,2,Asimoteu,2188,0,1,6,7,14.3%,42m
7976,2,별껌이,2187,166,7,12,19,36.8%,23m
7976,3,llllllllllll,2187,0,1,0,1,100.0%,37m
7976,3,BonelessBone,2187,0,1,0,1,100.0%,21m
7979,1,lTerryKl,2185,283,10,19,29,34.5%,15m
7979,3,송송이,2185,140,5,6,11,45.5%,21m
7979,3,TgKim,2185,92,3,6,9,33.3%,22m
7982,3,asahi,2184,1174,49,48,97,50.5%,42m
7982,3,[삼시를살려요]다혈질,2184,578,22,25,47,46.8%,21m
7982,2,강경자,2184,456,14,27,41,34.1%,23m
7982,3,힝힝흐엥,2184,375,12,13,25,48.0%,22m
7986,1,[래더납치범]battleboat,2183,151,5,9,14,35.7%,42m
7987,2,ascyrax,2182,46,1,3,4,25.0%,18m
7988,3,NineteenCM,2181,349,33,44,77,42.9%,21m
7988,3,카레파이터,2181,279,8,19,27,29.6%,42m
7988,2,호나우지뉴,2181,0,1,0,1,100.0%,19m
7991,3,김도훈,2180,0,1,1,2,50.0%,22m
7992,2,문라이트샤도우,2179,182,8,20,28,28.6%,23m
7992,3,Kyouhei,2179,97,4,2,6,66.7%,20m
7994,2,BJrhb,2177,1325,56,63,119,47.1%,42m
7995,3,sadad,2174,0,0,1,1,0.0%,41m
7996,3,싸울아비,2173,690,24,32,56,42.9%,20m
7996,2,손자병법인해전술,2173,171,4,9,13,30.8%,22m
7996,3,[스코델라리오]캐리건,2173,30,2,0,2,100.0%,37m
7996,3,안단티노,2173,0,0,1,1,0.0%,37m
7996,3,heyrelax,2173,0,0,5,5,0.0%,18m
8001,3,CUCKROACH,2172,0,0,1,1,0.0%,37m
8002,3,[enl]데오민,2171,0,0,1,1,0.0%,41m
8003,2,[FXUXG]engengeng,2170,302,21,28,49,42.9%,14m
8004,3,DefinitioN,2169,376,12,15,27,44.4%,21m
8004,1,SemPO,2169,132,6,8,14,42.9%,42m
8006,1,amazingkiss,2168,164,7,10,17,41.2%,19m
8006,2,에스웍스에이토스,2168,0,0,2,2,0.0%,18m
8008,3,[개복교]ceo,2167,1413,151,206,357,42.3%,37m
8008,1,너도양심이없구나,2167,0,3,9,12,25.0%,20m
8010,3,도지마의용,2165,121,2,2,4,50.0%,37m
8011,3,[SS친위대]homosipience,2164,267,9,7,16,56.2%,22m
8011,3,저그조아,2164,0,1,2,3,33.3%,21m
8013,3,솔구름,2162,123,3,1,4,75.0%,21m
8014,3,[너의ol름은]towns,2161,0,0,3,3,0.0%,37m
8014,3,lonxlee,2161,0,0,5,5,0.0%,41m
8016,1,Devastator,2160,189,5,11,16,31.2%,19m
8017,3,마멸,2159,36,2,7,9,22.2%,18m
8018,3,레이너,2158,0,3,2,5,60.0%,17m
8018,3,슈비,2158,0,1,4,5,20.0%,18m
8020,3,CrTEN,2157,402,13,13,26,50.0%,21m
8020,3,염라대왕,2157,0,1,5,6,16.7%,42m
8022,3,superbeginer,2156,266,9,10,19,47.4%,41m
8022,3,[NoLate]베틀대마왕,2156,122,4,5,9,44.4%,22m
8022,3,마법사,2156,0,0,2,2,0.0%,21m
8025,3,안티스파이럴,2155,233,8,5,13,61.5%,22m
8026,2,winteriscom,2154,490,16,29,45,35.6%,23m
8026,3,MADAMADADANE,2154,150,6,13,19,31.6%,22m
8028,3,잘하고싶다,2153,97,1,7,8,12.5%,20m
8029,3,크레용파파,2152,604,23,31,54,42.6%,21m
8030,3,kim,2149,0,1,6,7,14.3%,18m
8031,3,kioh,2147,0,1,1,2,50.0%,22m
8031,3,김이준,2147,0,0,6,6,0.0%,21m
8033,3,[213]나나나,2143,190,7,16,23,30.4%,21m
8033,2,[333111]ifyoucloseye,2143,130,4,9,13,30.8%,19m
8033,3,성장한김아현,2143,64,2,7,9,22.2%,18m
8036,3,shin,2140,30,1,1,2,50.0%,17m
8037,3,파워버섯,2139,95,1,5,6,16.7%,20m
8038,3,dsf,2138,302,11,7,18,61.1%,20m
8038,2,베놈,2138,0,0,1,1,0.0%,19m
8040,3,cocoroko,2136,1128,48,70,118,40.7%,37m
8040,3,야만용사,2136,92,4,5,9,44.4%,37m
8040,3,신흥,2136,114,4,7,11,36.4%,20m
8040,3,Hgood,2136,0,0,1,1,0.0%,21m
8044,2,[브론즈같은]zerg,2135,386,14,21,35,40.0%,42m
8044,2,광촉똘끼,2135,0,1,7,8,12.5%,42m
8046,3,박지수,2134,152,5,13,18,27.8%,21m
8046,3,[건국]youni,2134,30,1,5,6,16.7%,42m
8048,2,生化狼太灰,2132,564,19,38,57,33.3%,23m
8048,3,IIIIIIIIIIII,2132,42,1,7,8,12.5%,18m
8050,2,hoyapret,2131,30,3,7,10,30.0%,14m
8050,1,xymzi,2131,0,0,2,2,0.0%,20m
8050,3,[TWKKA]費雪帥賓,2131,0,0,5,5,0.0%,18m
8053,3,스타돌이,2130,527,17,33,50,34.0%,42m
8054,1,냉탕상어,2128,621,22,29,51,43.1%,42m
8054,3,qwer,2128,116,2,3,5,40.0%,42m
8054,3,Stabler,2128,0,1,5,6,16.7%,37m
8057,2,막강한엘프,2127,331,11,22,33,33.3%,23m
8057,3,rhgkdud,2127,201,6,11,17,35.3%,21m
8057,1,Thispain,2127,96,2,10,12,16.7%,20m
8060,3,[제일잘생긴]아몰랑,2126,0,1,2,3,33.3%,21m
8061,3,Jockling,2125,97,2,5,7,28.6%,41m
8062,2,jackykares,2123,96,4,5,9,44.4%,18m
8062,3,rendezvous,2123,97,2,1,3,66.7%,21m
8062,2,XxrektxX,2123,112,2,4,6,33.3%,18m
8062,3,Steelwing,2123,0,1,4,5,20.0%,37m
8066,3,테란뉴클리얼,2122,30,2,0,2,100.0%,37m
8067,2,真命天子,2121,1518,539,806,1345,40.1%,23m
8067,3,pop,2121,1475,61,79,140,43.6%,21m
8067,2,Leesy,2121,179,7,9,16,43.8%,18m
8067,3,로얄드래곤,2121,209,5,15,20,25.0%,41m
8071,2,BondDavid,2116,886,41,61,102,40.2%,23m
8071,2,대전이영호,2116,730,27,34,61,44.3%,23m
8071,3,사사키치에,2116,400,15,17,32,46.9%,21m
8071,3,한셀,2116,34,2,7,9,22.2%,18m
8075,3,Philosopher,2113,148,6,6,12,50.0%,21m
8075,1,aaaaaaaaaaaa,2113,0,1,0,1,100.0%,20m
8077,1,진환,2112,73,1,3,4,25.0%,20m
8077,1,new,2112,48,1,5,6,16.7%,20m
8079,2,cao,2110,118,7,11,18,38.9%,42m
8079,3,KFC,2110,40,3,3,6,50.0%,37m
8079,1,solo,2110,0,0,1,1,0.0%,20m
8082,3,foonyon,2109,562,22,28,50,44.0%,42m
8082,3,QUYEN,2109,30,2,2,4,50.0%,21m
8084,1,[SevenT]호롤롤로,2108,0,0,5,5,0.0%,19m
8085,3,woojoo,2107,193,6,7,13,46.2%,20m
8085,3,ranezu,2107,213,6,11,17,35.3%,21m
8087,3,IlIlllIIlIlI,2104,58,3,9,12,25.0%,21m
8087,3,[SClI]아오이소람,2104,0,0,1,1,0.0%,17m
8089,3,리시빙해방,2103,190,6,15,21,28.6%,21m
8090,3,캐릭터,2101,457,14,18,32,43.8%,21m
8091,3,DarkWookie,2100,0,0,5,5,0.0%,37m
8092,3,공장,2099,0,1,4,5,20.0%,18m
8093,3,난죽경없,2098,36,1,2,3,33.3%,18m
8093,2,llllllllll,2098,0,0,1,1,0.0%,19m
8095,2,밤의살모사,2095,410,19,33,52,36.5%,22m
8095,2,Nash,2095,158,3,5,8,37.5%,19m
8095,3,아주멋져,2095,30,1,4,5,20.0%,42m
8095,1,템페스트,2095,0,0,3,3,0.0%,19m
8099,1,연어초밥,2094,46,1,3,4,25.0%,20m
8100,3,쓰레기청소부,2093,0,0,2,2,0.0%,18m
8101,3,lokost,2091,227,7,14,21,33.3%,22m
8101,3,qweasd,2091,202,6,13,19,31.6%,42m
8101,3,Granatych,2091,0,0,6,6,0.0%,37m
8104,3,[광역어그로]BrownBear,2089,236,19,17,36,52.8%,21m
8104,1,Duffenzag,2089,44,1,5,6,16.7%,20m
8104,3,[日本]IIIIIIIIIIII,2089,0,0,5,5,0.0%,18m
8107,3,해병의기묘한모험,2088,804,32,38,70,45.7%,22m
8107,2,enpdqjf,2088,742,27,47,74,36.5%,42m
8107,3,HOANG,2088,0,0,3,3,0.0%,18m
8110,2,불곰,2087,0,1,2,3,33.3%,18m
8110,3,neocraft,2087,0,1,3,4,25.0%,18m
8110,3,그랜드또또,2087,0,0,3,3,0.0%,22m
8113,3,짐네이뇬,2081,512,19,21,40,47.5%,21m
8114,3,pta,2080,567,19,23,42,45.2%,21m
8114,3,테넷,2080,60,2,5,7,28.6%,18m
8116,3,hercules,2079,251,8,11,19,42.1%,21m
8117,3,히드라의똥침,2077,685,41,51,92,44.6%,37m
8117,1,[너의ol름은]저그,2077,486,14,12,26,53.8%,20m
8117,2,BINGO,2077,138,4,4,8,50.0%,18m
8117,3,Mirunamu,2077,147,3,4,7,42.9%,22m
8121,3,clemismyhero,2075,205,6,13,19,31.6%,37m
8121,2,프로지망생김국현,2075,128,4,14,18,22.2%,18m
8121,1,modickm,2075,162,4,14,18,22.2%,16m
8124,1,sionangel,2072,1107,112,138,250,44.8%,47m
8125,1,[大鯢反抗軍]Oliver,2071,142,4,6,10,40.0%,20m
8125,1,[CoRe]JKJKss,2071,144,3,8,11,27.3%,20m
8125,3,Habrehkhala,2071,30,1,6,7,14.3%,21m
8128,3,아오지탄광,2070,0,1,7,8,12.5%,18m
8129,2,Westjin,2069,30,2,9,11,18.2%,22m
8129,1,뜅이,2069,46,1,2,3,33.3%,20m
8131,1,Outlooker,2068,524,13,19,32,40.6%,20m
8131,1,joe,2068,121,3,4,7,42.9%,20m
8131,3,lllllllllll,2068,0,2,3,5,40.0%,18m
8131,2,Arashi,2068,30,2,9,11,18.2%,42m
8131,1,llllllllllll,2068,0,0,2,2,0.0%,20m
8136,1,JASON,2067,92,2,3,5,40.0%,20m
8137,1,Jodano,2065,1532,52,82,134,38.8%,20m
8138,3,아바입니다,2063,0,0,2,2,0.0%,18m
8139,3,ekdh,2062,0,0,1,1,0.0%,37m
8139,1,꼭맞아,2062,0,0,2,2,0.0%,19m
8141,1,[뉴비다]한조,2061,0,0,1,1,0.0%,20m
8142,2,blessing,2060,125,3,4,7,42.9%,18m
8142,3,왕돼지,2060,142,3,7,10,30.0%,21m
8144,1,얼티밋나이트,2059,73,0,3,3,0.0%,19m
8145,1,다산다,2057,266,7,17,24,29.2%,20m
8145,1,배트맨쉴드,2057,0,2,3,5,40.0%,20m
8145,1,jordanbj,2057,0,1,4,5,20.0%,19m
8145,3,NATFA,2057,0,0,7,7,0.0%,37m
8149,1,qqqq,2056,227,6,10,16,37.5%,20m
8149,1,Milk,2056,136,3,8,11,27.3%,20m
8149,3,[NCF]IIIIIIIIIIII,2056,0,0,2,2,0.0%,37m
8152,1,DKREAD,2055,211,5,7,12,41.7%,20m
8153,2,[아케더]한서선민,2052,90,3,8,11,27.3%,19m
8153,3,고더람호,2052,58,2,9,11,18.2%,21m
8155,2,slappy,2051,151,5,11,16,31.2%,19m
8156,2,dnjTmekdandy,2050,0,0,1,1,0.0%,18m
8157,1,Castiglione,2049,168,3,3,6,50.0%,20m
8158,3,[Apink2]Apink,2046,534,17,34,51,33.3%,37m
8158,1,Edward,2046,604,15,17,32,46.9%,19m
8158,2,帥周,2046,36,1,4,5,20.0%,18m
8161,1,[밀리터리버거]MUSAT,2044,403,12,18,30,40.0%,20m
8161,3,katakori,2044,148,5,14,19,26.3%,20m
8161,2,sidelviajero,2044,130,4,10,14,28.6%,19m
8161,1,공허의추적자,2044,138,3,4,7,42.9%,20m
8161,3,reach,2044,30,1,7,8,12.5%,18m
8166,1,라이너,2043,44,1,2,3,33.3%,20m
8167,3,[Blacer]무리뉴,2041,355,18,37,55,32.7%,37m
8167,1,킹갓불멸자,2041,0,0,1,1,0.0%,20m
8169,1,메뚜기,2040,34,1,4,5,20.0%,20m
8170,1,기맹수,2039,0,0,1,1,0.0%,20m
8170,3,백범,2039,0,0,2,2,0.0%,18m
8170,3,you,2039,0,0,5,5,0.0%,37m
8173,1,Namikaze,2038,757,21,32,53,39.6%,20m
8174,1,[그시절의]인체해부학,2037,95,1,1,2,50.0%,20m
8174,3,rainJK,2037,0,1,4,5,20.0%,18m
8176,3,[다현다현]llllllllllll,2036,30,1,7,8,12.5%,21m
8176,1,sutuekopu,2036,0,0,2,2,0.0%,19m
8178,3,zele,2034,92,2,9,11,18.2%,18m
8179,1,meekking,2033,1020,35,39,74,47.3%,20m
8179,3,Tenza,2033,0,0,2,2,0.0%,37m
8181,3,[즐겜러]거꾸,2031,95,1,8,9,11.1%,37m
8182,2,RAYNG,2030,1434,89,106,195,45.6%,42m
8182,3,당근,2030,146,4,8,12,33.3%,41m
8182,1,AHDZLD,2030,0,0,1,1,0.0%,19m
8185,3,斷腳小民,2029,0,1,7,8,12.5%,41m
8186,1,[별똥별]그기서그기,2028,1111,44,55,99,44.4%,20m
8186,1,jkkim,2028,73,0,2,2,0.0%,19m
8188,1,lonelyloner,2027,279,7,18,25,28.0%,20m
8188,1,죠리퐁,2027,218,5,9,14,35.7%,20m
8190,1,LiNSupSantos,2024,0,1,0,1,100.0%,19m
8190,2,저그연습많이하자,2024,0,1,9,10,10.0%,14m
8190,1,스테일,2024,0,0,1,1,0.0%,20m
8193,1,天安門事態,2022,1818,58,80,138,42.0%,19m
8194,2,opsd,2021,158,4,10,14,28.6%,23m
8194,1,Ying,2021,48,2,6,8,25.0%,19m
8194,3,thweforeon,2021,0,0,5,5,0.0%,37m
8197,3,[허대영섹시남]백스핀블러스트,2020,1498,296,449,745,39.7%,37m
8197,3,蘭陵王,2020,0,2,4,6,33.3%,37m
8199,3,shinji,2019,0,0,1,1,0.0%,37m
8200,3,신들의의안,2014,30,1,8,9,11.1%,22m
8200,1,로데오,2014,73,0,2,2,0.0%,20m
8202,1,너나사랑해,2011,73,1,1,2,50.0%,20m
8203,1,aaa,2008,936,24,32,56,42.9%,20m
8203,1,스타해야지,2008,198,8,14,22,36.4%,20m
8203,1,모르가나,2008,240,6,10,16,37.5%,20m
8206,3,[경찰과도둑]멜리오다스,2007,92,1,6,7,14.3%,42m
8206,2,AMF,2007,0,0,5,5,0.0%,19m
8208,2,kriay,2006,0,0,2,2,0.0%,18m
8209,1,그린,2002,166,4,7,11,36.4%,19m
8210,3,[달맞이꽃]lunaflower,2001,0,0,1,1,0.0%,18m
8211,1,sonata,2000,901,26,34,60,43.3%,19m
8211,1,slick,2000,82,2,3,5,40.0%,19m
8213,2,Bliss,1999,892,109,149,258,42.2%,23m
8214,1,jbomb,1998,122,2,5,7,28.6%,19m
8215,1,ooo,1989,0,1,2,3,33.3%,20m
8216,1,[ElsAna]서부사령관,1988,140,4,0,4,100.0%,20m
8217,1,youngdae,1987,238,4,4,8,50.0%,20m
8218,1,셜록겜즈,1986,562,16,27,43,37.2%,19m
8219,3,NSMaru,1984,275,10,19,29,34.5%,22m
8220,2,HVMVH,1983,0,0,1,1,0.0%,18m
8221,3,yjh,1980,1000,55,80,135,40.7%,37m
8221,1,래그,1980,73,1,7,8,12.5%,20m
8223,1,BlueBerryBox,1978,48,1,5,6,16.7%,19m
8224,1,lwb,1976,0,0,4,4,0.0%,20m
8225,2,크루,1974,1436,99,128,227,43.6%,15m
8225,2,[암기]프로토스장인,1974,0,1,2,3,33.3%,19m
8225,1,MrMore,1974,0,1,4,5,20.0%,20m
8228,3,sjp,1972,0,1,7,8,12.5%,42m
8229,3,마지노선,1971,1160,39,57,96,40.6%,21m
8230,3,EGHuk,1967,0,0,7,7,0.0%,18m
8231,1,[패튼]카니니카,1966,0,1,2,3,33.3%,20m
8232,1,DireTzo,1965,293,8,16,24,33.3%,20m
8233,1,WinterShoc,1964,48,1,2,3,33.3%,19m
8234,1,kfhdngxkhvj,1963,0,0,2,2,0.0%,20m
8235,3,메밀꽃필무렵,1962,910,32,51,83,38.6%,21m
8236,3,암캐,1961,342,12,23,35,34.3%,22m
8237,1,Stinger,1960,44,1,4,5,20.0%,20m
8238,1,천월패룡,1957,221,5,13,18,27.8%,20m
8239,1,[CIA암살단]생각의질서,1952,312,8,8,16,50.0%,20m
8240,2,[국방부사서병]SEKI,1950,122,4,18,22,18.2%,42m
8240,3,魏小虎,1950,40,2,9,11,18.2%,18m
8242,1,저그,1946,0,0,5,5,0.0%,20m
8243,1,Eyemsi,1945,218,6,10,16,37.5%,20m
8243,1,스티븐젓갈,1945,0,0,4,4,0.0%,20m
8245,1,닭한마리,1943,44,1,2,3,33.3%,20m
8246,2,재키와이,1940,84,2,5,7,28.6%,19m
8246,3,정지원입니다,1940,0,0,6,6,0.0%,18m
8248,3,herO,1935,123,2,10,12,16.7%,42m
8249,3,[아케더]바람,1934,365,13,23,36,36.1%,21m
8250,1,아구의엽기전략,1933,40,1,4,5,20.0%,20m
8251,1,SKTQUASAR,1932,130,4,10,14,28.6%,20m
8252,3,Fireghost,1931,114,5,9,14,35.7%,37m
8253,1,[별똥별]드디어성공이다,1929,73,0,2,2,0.0%,20m
8254,1,colin,1928,0,0,2,2,0.0%,20m
8255,3,할수있다,1925,30,3,6,9,33.3%,37m
8255,1,padman,1925,48,2,3,5,40.0%,20m
8257,1,[sc2mc]엠씨다크맨,1924,46,2,5,7,28.6%,20m
8258,3,무적알핀,1920,0,0,1,1,0.0%,37m
8259,3,GoldApple,1917,0,0,1,1,0.0%,18m
8260,1,Jopam,1915,1884,82,134,216,38.0%,20m
8261,1,[삼국시대]Heder,1914,136,3,11,14,21.4%,20m
8262,1,[국방부사서병]불고기소스,1909,132,3,9,12,25.0%,19m
8262,1,payday,1909,0,0,1,1,0.0%,20m
8264,1,딩초,1907,0,0,5,5,0.0%,20m
8265,1,cerapina,1901,0,0,5,5,0.0%,19m
8266,1,Twinshadow,1898,426,15,19,34,44.1%,20m
8267,1,roa,1897,0,0,7,7,0.0%,20m
8268,1,일진,1892,48,1,4,5,20.0%,20m
8269,1,mong,1891,276,6,10,16,37.5%,20m
8270,2,Luna,1889,245,7,16,23,30.4%,18m
8271,1,지금은사아,1885,976,22,45,67,32.8%,20m
8272,3,靠腰阿如,1883,0,1,5,6,16.7%,21m
8272,1,쌉저그,1883,0,0,1,1,0.0%,20m
8272,3,captiancake,1883,0,0,2,2,0.0%,18m
8275,1,Maxxima,1880,0,0,9,9,0.0%,20m
8276,1,[zafron]mhdi,1878,163,3,17,20,15.0%,20m
8277,3,Caelestis,1871,150,5,8,13,38.5%,18m
8277,1,물개단지,1871,0,0,5,5,0.0%,20m
8279,3,pavelskim,1869,0,0,6,6,0.0%,18m
8280,2,Virdisia,1867,142,6,16,22,27.3%,42m
8280,3,야승재,1867,76,2,11,13,15.4%,18m
8282,1,sdett,1863,104,3,12,15,20.0%,20m
8283,2,[NCF]Crankit,1861,1466,109,131,240,45.4%,42m
8284,3,clound,1859,0,1,10,11,9.1%,37m
8285,1,chlwjdals,1857,270,7,17,24,29.2%,20m
8285,3,Chun,1857,148,5,15,20,25.0%,18m
8287,2,건우짱,1854,34,3,14,17,17.6%,18m
8288,1,[EZDUNK]canfam,1850,282,10,11,21,47.6%,20m
8289,1,밥운,1846,332,8,18,26,30.8%,20m
8290,3,갓기성,1845,678,20,49,69,29.0%,41m
8290,3,[망겜장인]봄날벚꽃,1845,0,0,1,1,0.0%,18m
8292,1,Habaladasher,1843,90,2,10,12,16.7%,20m
8292,3,llllllllllll,1843,0,0,4,4,0.0%,18m
8294,2,승리자,1842,105,2,3,5,40.0%,18m
8295,2,별천지,1839,0,0,1,1,0.0%,18m
8296,2,lll,1838,0,0,2,2,0.0%,18m
8297,1,다겁즐겁다,1837,90,2,13,15,13.3%,19m
8298,3,Aoi,1823,564,21,46,67,31.3%,49m
8298,2,리아카리,1823,0,4,3,7,57.1%,18m
8298,2,PowerMoveR,1823,65,2,5,7,28.6%,19m
8301,1,[우모자공화국]루나공주,1821,30,1,8,9,11.1%,20m
8302,1,[프로토스협회]손주할머니캐리,1815,202,5,18,23,21.7%,20m
8303,1,못해요,1795,1828,132,254,386,34.2%,19m
8304,2,Wolfdreicht,1793,38,1,1,2,50.0%,18m
8305,2,ZERO,1792,0,0,1,1,0.0%,19m
8306,3,로즈아멜리아,1790,80,3,15,18,16.7%,18m
8307,3,가보리도,1789,0,1,2,3,33.3%,18m
8308,1,LETO,1788,1268,42,78,120,35.0%,20m
8308,1,학문의끝,1788,1308,33,77,110,30.0%,20m
8310,1,我是阿宅,1786,372,15,14,29,51.7%,19m
8310,2,금빛투구게,1786,0,0,1,1,0.0%,18m
8312,2,[머구폐렴]달선,1772,146,3,12,15,20.0%,19m
8313,1,NEO,1757,44,1,13,14,7.1%,19m
8314,1,아오성철아모하냐,1747,238,6,16,22,27.3%,19m
8314,3,freewizard,1747,86,3,10,13,23.1%,37m
8316,1,사괴수,1745,450,14,36,50,28.0%,20m
8317,3,저글링은귀요워,1744,30,1,11,12,8.3%,18m
8318,2,할할할,1738,66,2,11,13,15.4%,18m
8319,2,IllIlIlIIIlI,1735,1292,335,463,798,42.0%,23m
8320,3,inken,1732,80,2,11,13,15.4%,18m
8321,2,Jamesclock,1728,30,1,2,3,33.3%,19m
8322,2,SCAVE,1718,161,4,3,7,57.1%,19m
8323,2,하푸하푸,1714,73,2,7,9,22.2%,18m
8324,3,[너의ol름은]Jady,1713,30,1,11,12,8.3%,18m
8325,3,[빙하행성얼코]RomaneeConti,1707,0,0,6,6,0.0%,37m
8326,2,브레이브하트,1703,1349,521,730,1251,41.6%,23m
8327,2,[신뢰]blueshark,1702,0,0,6,6,0.0%,18m
8328,1,[NCF]크란이,1699,231,5,14,19,26.3%,19m
8329,3,코타로,1694,0,1,3,4,25.0%,18m
8330,3,starcraf,1685,0,0,1,1,0.0%,18m
8331,3,사자부대,1678,30,1,2,3,33.3%,37m
8332,2,Deepblue,1666,0,0,1,1,0.0%,19m
8333,2,[벨튀입니다]야생의은재몬,1659,0,1,0,1,100.0%,18m
8333,2,이티,1659,0,0,7,7,0.0%,18m
8335,2,freesun,1643,0,0,1,1,0.0%,18m
8336,1,살짝도른년,1631,1463,51,95,146,34.9%,20m
8337,3,Joker,1510,0,0,1,1,0.0%,37m
8338,3,[krtag]디바왜불러,1483,454,14,44,58,24.1%,18m
8339,3,인공지능,1476,0,0,2,2,0.0%,37m
8340,3,부리부리,1350,0,0,10,10,0.0%,37m
8341,3,달빛,1341,0,0,5,5,0.0%,37m
